contig	position	variantID	refAllele	altAllele	refCount	altCount	totalCount	lowMAPQDepth	lowBaseQDepth	rawDepth	otherBases	improperPairs
1	20128	.	C	T	1	7	8	0	0	8	0	0
1	208564	.	T	C	12	7	19	0	2	21	0	0
1	474273	.	C	G	3	6	9	0	0	9	0	0
1	474286	.	T	A	5	4	9	0	1	10	0	0
1	504696	.	A	G	9	0	9	0	14	23	0	0
1	504977	.	A	G	11	5	16	0	2	18	0	0
1	524713	.	T	G	2	1	3	0	2	5	0	0
1	618671	.	T	C	31	6	37	0	4	41	0	0
1	4151838	.	G	A	3	1	4	0	1	5	0	0
1	4152562	.	C	T	6	5	11	0	0	11	0	0
1	4152724	.	T	C	3	6	9	0	0	9	0	0
1	4152967	.	A	G	2	0	2	0	4	6	0	0
1	4153840	.	C	T	2	4	6	0	0	6	0	0
1	4153903	.	G	A	1	6	7	0	7	14	0	0
1	4154070	.	C	T	5	6	11	0	1	12	0	0
1	5273808	.	A	G	6	4	10	0	3	13	0	0
1	5273826	.	G	A	6	5	11	0	0	11	0	0
1	5273889	.	C	A	5	3	8	0	0	8	0	0
1	5276257	.	T	C	7	6	13	0	1	14	0	0
1	5276343	.	G	A	7	10	17	0	1	18	0	0
1	5276982	.	A	G	10	0	10	0	8	18	0	0
1	5277218	.	G	A	21	11	32	0	2	34	0	0
1	5354765	.	C	A	21	21	42	0	1	43	0	0
1	5354768	.	A	G	20	21	41	0	1	42	0	0
1	5354864	.	A	G	16	21	37	0	3	40	0	0
1	5354970	.	C	T	13	19	32	0	2	34	0	0
1	5355024	.	G	T	13	21	34	0	1	35	0	0
1	5355154	.	A	T	17	18	35	0	3	38	0	0
1	5355262	.	T	A	28	40	68	1	4	73	0	0
1	5355334	.	G	A	23	35	58	0	6	64	0	0
1	5355435	.	C	T	4	11	15	0	39	54	0	0
1	5355514	.	G	A	30	35	65	0	3	68	0	0
1	5355804	.	C	T	2	27	29	1	27	57	0	0
1	5357055	.	T	C	16	8	24	0	1	25	0	0
1	5357059	.	T	C	17	8	25	0	1	26	0	0
1	5357203	.	G	A	18	15	33	0	1	34	0	0
1	5357405	.	T	C	10	20	30	0	1	31	0	0
1	5358792	.	C	A	9	20	29	0	1	30	0	0
1	5365332	.	A	G	12	21	33	0	2	35	0	0
1	5365350	.	G	A	11	19	30	0	0	30	0	0
1	5365368	.	C	T	13	19	32	0	1	33	0	0
1	5365762	.	A	G	13	15	28	0	3	31	0	0
1	5369394	.	A	G	9	10	19	0	1	20	0	0
1	5375285	.	C	T	11	15	26	0	3	29	0	0
1	5375351	.	A	T	11	9	20	1	1	22	0	0
1	5375352	.	C	T	3	9	12	1	9	22	0	0
1	5375403	.	T	C	9	8	17	1	1	19	0	0
1	5394687	.	T	A	11	13	24	0	2	26	0	0
1	5402567	.	A	G	13	9	22	0	0	22	0	0
1	5415859	.	T	C	10	13	23	0	0	23	0	0
1	5418305	.	T	C	21	20	41	0	2	43	0	0
1	5418332	.	T	C	21	16	37	0	1	38	0	0
1	5418506	.	T	C	21	15	36	0	1	37	0	0
1	5418530	.	C	G	24	16	40	0	1	41	0	0
1	5418731	.	A	G	20	14	34	0	1	35	0	0
1	5418815	.	A	G	27	16	43	0	0	43	0	0
1	5430945	.	G	T	1	6	7	0	4	11	0	0
1	5433709	.	C	T	5	8	13	0	1	14	0	0
1	5433712	.	T	C	6	8	14	0	0	14	0	0
1	5433836	.	G	T	5	5	10	0	0	10	0	0
1	5500848	.	C	T	2	3	5	0	0	5	0	0
1	5500852	.	G	A	1	3	4	0	1	5	0	0
1	5500892	.	T	A	2	2	4	0	0	4	0	0
1	5502069	.	T	C	6	3	9	0	0	9	0	0
1	5503528	.	T	G	15	3	18	1	1	20	0	0
1	5503574	.	C	A	10	6	16	0	0	16	0	0
1	5503587	.	C	T	7	7	14	0	1	15	0	0
1	5503641	.	A	T	7	4	11	0	1	12	0	0
1	5503642	.	C	T	8	4	12	0	0	12	0	0
1	5503751	.	G	T	2	2	4	0	0	4	0	0
1	5503809	.	T	C	9	5	14	0	0	14	0	0
1	5503961	.	A	T	4	3	7	0	0	7	0	0
1	5503969	.	A	T	4	3	7	0	0	7	0	0
1	5504002	.	T	G	2	3	5	0	0	5	0	0
1	5504032	.	C	G	3	2	5	0	0	5	0	0
1	5504245	.	C	T	0	2	2	0	2	4	0	0
1	5504438	.	A	G	2	3	5	0	0	5	0	0
1	5504557	.	G	C	4	3	7	0	0	7	0	0
1	5504574	.	C	G	0	3	3	0	3	6	0	0
1	5504915	.	C	G	0	2	2	0	5	7	0	0
1	5504937	.	A	C	4	2	6	0	0	6	0	0
1	5607230	.	T	C	2	5	7	0	0	7	0	0
1	5607241	.	A	T	2	6	8	0	0	8	0	0
1	5607276	.	C	T	2	2	4	0	0	4	0	0
1	5607349	.	T	A	6	2	8	0	0	8	0	0
1	5607351	.	C	T	6	2	8	0	0	8	0	0
1	5607496	.	G	A	5	7	12	0	0	12	0	0
1	5607755	.	T	G	9	13	22	0	0	22	0	0
1	5607929	.	C	A	7	9	16	0	0	16	0	0
1	5607970	.	T	C	2	11	13	0	0	13	0	0
1	5608215	.	G	T	8	9	17	0	0	17	0	0
1	5608491	.	A	G	7	6	13	0	0	13	0	0
1	5627426	.	G	A	5	4	9	0	0	9	0	0
1	5631374	.	A	G	5	3	8	0	1	9	0	0
1	5631389	.	T	A	7	4	11	0	0	11	0	0
1	5632031	.	A	G	1	5	6	0	1	7	0	0
1	5638713	.	G	A	1	7	8	0	0	8	0	0
1	5641049	.	G	A	8	3	11	0	1	12	0	0
1	5653026	.	A	G	3	3	6	0	0	6	0	0
1	5653046	.	T	C	1	2	3	0	0	3	0	0
1	5653117	.	A	G	2	4	6	0	0	6	0	0
1	5671728	.	G	T	1	3	4	0	0	4	0	0
1	5681042	.	C	T	1	3	4	0	2	6	0	0
1	5681072	.	G	A	5	4	9	0	0	9	0	0
1	5707082	.	G	A	1	2	3	0	0	3	0	0
1	5745396	.	C	G	4	2	6	0	0	6	0	0
1	5745886	.	T	C	1	0	1	0	1	2	0	0
1	5745905	.	A	G	1	2	3	0	0	3	0	0
1	6153251	.	T	C	3	4	7	0	0	7	0	0
1	6153397	.	A	G	3	0	3	0	5	8	0	0
1	6153451	.	G	A	3	3	6	0	0	6	0	0
1	6158360	.	G	T	2	6	8	0	4	12	0	0
1	6158557	.	T	G	1	4	5	0	0	5	0	0
1	6165213	.	C	T	9	7	16	0	0	16	0	0
1	6165318	.	A	C	7	8	15	0	1	16	0	0
1	6166479	.	G	T	0	7	7	0	6	13	0	0
1	6167421	.	A	G	2	0	2	0	9	11	0	0
1	6168264	.	G	A	9	13	22	0	1	23	0	0
1	6168346	.	T	A	10	14	24	0	1	25	0	0
1	6168411	.	G	C	16	7	23	0	0	23	0	0
1	6168417	.	G	T	0	6	6	0	16	22	0	0
1	6168568	.	C	G	8	5	13	0	0	13	0	0
1	6168858	.	A	G	10	0	10	0	12	22	0	0
1	6168875	.	G	A	13	10	23	0	0	23	0	0
1	6168925	.	T	C	12	4	16	0	1	17	0	0
1	6169155	.	C	T	11	8	19	0	0	19	0	0
1	6169208	.	C	T	11	9	20	0	1	21	0	0
1	6169232	.	T	C	12	7	19	0	1	20	0	0
1	6169279	.	G	A	7	11	18	0	1	19	0	0
1	6169317	.	C	T	5	11	16	0	0	16	0	0
1	6169378	.	C	T	6	7	13	0	1	14	0	0
1	6169387	.	G	C	9	10	19	0	1	20	0	0
1	6169462	.	T	C	13	16	29	0	0	29	0	0
1	6169494	.	A	G	13	0	13	0	7	20	0	0
1	6169542	.	T	C	9	4	13	0	0	13	0	0
1	6169688	.	A	T	7	5	12	0	1	13	0	0
1	6169691	.	C	T	7	5	12	0	0	12	0	0
1	6175280	.	G	A	0	5	5	0	1	6	0	0
1	6185218	.	A	G	14	10	24	0	1	25	0	0
1	6185236	.	T	G	11	12	23	0	1	24	0	0
1	6185259	.	T	G	13	11	24	0	2	26	0	0
1	6185280	.	T	A	15	9	24	0	2	26	0	0
1	6185320	.	T	A	16	6	22	0	1	23	0	0
1	6185411	.	C	T	4	4	8	0	0	8	0	0
1	6190003	.	A	G	2	2	4	0	0	4	0	0
1	6190127	.	A	G	1	4	5	0	0	5	0	0
1	6199003	.	T	C	5	4	9	0	0	9	0	0
1	6201976	.	C	T	3	6	9	0	1	10	0	0
1	6206978	.	C	T	4	6	10	0	2	12	0	0
1	6209632	.	G	A	0	8	8	0	7	15	0	0
1	6209662	.	T	G	5	9	14	0	3	17	0	0
1	6209743	.	A	T	11	7	18	0	2	20	0	0
1	6209746	.	G	A	3	8	11	0	9	20	0	0
1	6210190	.	T	G	5	0	5	0	5	10	0	0
1	6210243	.	T	C	8	8	16	0	0	16	0	0
1	6210471	.	T	C	4	7	11	0	1	12	0	0
1	6210567	.	C	T	9	4	13	0	0	13	0	0
1	6225909	.	A	C	3	2	5	0	0	5	0	0
1	6225919	.	G	A	4	3	7	0	0	7	0	0
1	6226200	.	C	G	1	0	1	0	2	3	0	0
1	6226345	.	T	G	3	5	8	0	1	9	0	0
1	6226347	.	T	A	4	4	8	0	1	9	0	0
1	6226388	.	A	G	2	0	2	0	7	9	0	0
1	6231058	.	G	A	0	2	2	0	2	4	0	0
1	6240444	.	T	G	3	5	8	0	0	9	1	0
1	6240474	.	A	C	5	7	12	0	0	12	0	0
1	6241427	.	T	G	6	3	9	0	2	11	0	0
1	6243620	.	T	C	4	7	11	0	1	12	0	0
1	6243626	.	A	C	4	7	11	0	0	11	0	0
1	6243962	.	C	T	1	2	3	0	0	3	0	0
1	6244044	.	C	T	1	2	3	0	0	3	0	0
1	6247104	.	C	T	2	5	7	1	1	9	0	0
1	6247156	.	G	T	1	3	4	0	1	5	0	0
1	6248059	.	C	T	1	2	3	0	0	3	0	0
1	6252839	.	T	C	1	2	3	0	0	3	0	0
1	6252869	.	A	G	2	0	2	0	4	6	0	0
1	6252887	.	T	C	2	4	6	0	0	6	0	0
1	6257010	.	A	C	4	3	7	0	0	7	0	0
1	6261467	.	A	T	3	4	7	0	0	7	0	0
1	6262800	.	G	C	0	6	6	0	4	10	0	0
1	6262842	.	G	A	1	2	3	0	3	6	0	0
1	6265054	.	G	A	4	3	7	0	1	8	0	0
1	6271712	.	T	C	5	6	11	0	1	12	0	0
1	7539205	.	A	G	17	10	27	0	2	29	0	0
1	7662167	.	C	T	18	15	33	0	0	33	0	0
1	7662169	.	G	A	17	14	31	0	2	33	0	0
1	7662305	.	A	G	22	18	40	0	1	41	0	0
1	7662383	.	G	A	21	17	38	0	3	41	0	0
1	7662840	.	A	C	24	23	47	0	1	48	0	0
1	7668211	.	A	G	22	14	36	0	0	36	0	0
1	7673206	.	C	T	15	18	33	0	0	33	0	0
1	7853375	.	T	G	6	6	12	0	2	14	0	0
1	7853399	.	G	A	8	4	12	0	0	12	0	0
1	7853465	.	C	A	7	4	11	0	0	11	0	0
1	7859852	.	G	A	1	2	3	0	0	3	0	0
1	7864579	.	A	G	2	4	6	0	0	6	0	0
1	7864780	.	A	G	1	2	3	0	1	4	0	0
1	7874566	.	G	T	1	2	3	0	0	3	0	0
1	7889281	.	G	A	1	2	3	0	0	3	0	0
1	7893727	.	G	T	2	3	5	0	0	5	0	0
1	7893861	.	T	C	1	0	1	0	2	3	0	0
1	8022503	.	T	A	11	11	22	0	3	25	0	0
1	8022505	.	T	C	13	11	24	0	2	26	0	0
1	8022817	.	T	A	17	17	34	0	8	42	0	0
1	8023245	.	G	A	8	20	28	0	0	28	0	0
1	8023433	.	C	T	15	9	24	0	0	24	0	0
1	8023471	.	A	T	14	9	23	0	2	25	0	0
1	8023490	.	A	C	13	9	22	0	1	23	0	0
1	8023559	.	A	T	11	14	25	0	1	27	1	0
1	8023639	.	C	A	19	14	33	1	1	35	0	0
1	8025986	.	G	A	8	20	28	0	1	29	0	0
1	8026148	.	T	G	11	18	29	0	2	31	0	0
1	8026404	.	T	A	18	11	29	1	3	33	0	0
1	8026521	.	C	A	2	17	19	0	16	35	0	0
1	8026565	.	C	T	20	13	33	0	1	34	0	0
1	8026898	.	C	A	13	9	22	0	1	23	0	0
1	8026975	.	T	C	15	5	20	0	0	20	0	0
1	8027245	.	T	G	6	7	13	0	0	13	0	0
1	8028177	.	T	A	8	17	25	0	1	26	0	0
1	8028256	.	C	G	3	10	13	0	0	13	0	0
1	8028696	.	G	T	8	14	22	0	1	23	0	0
1	8028727	.	G	A	13	16	29	0	1	30	0	0
1	8028912	.	G	C	12	8	20	0	0	20	0	0
1	8028925	.	C	A	9	8	17	0	0	17	0	0
1	8028979	.	G	A	10	7	17	0	0	17	0	0
1	8029002	.	T	A	4	7	11	0	1	13	1	0
1	8032848	.	C	T	5	6	11	0	0	11	0	0
1	8032950	.	T	A	7	7	14	0	2	16	0	0
1	8032956	.	G	C	7	8	15	0	0	15	0	0
1	8051513	.	G	A	7	5	12	0	0	12	0	0
1	8051528	.	C	T	0	5	5	0	5	10	0	0
1	8055927	.	T	C	4	0	4	0	7	11	0	0
1	8058041	.	G	A	4	8	12	0	0	12	0	0
1	8128710	.	G	A	1	2	3	0	0	3	0	0
1	8128981	.	G	A	2	2	4	0	0	4	0	0
1	8165484	.	C	T	3	4	7	0	0	7	0	0
1	8165486	.	T	A	3	4	7	0	0	7	0	0
1	8165802	.	C	T	3	2	5	0	0	5	0	0
1	8165937	.	G	A	8	5	13	0	3	16	0	0
1	8165947	.	C	T	6	5	11	0	2	13	0	0
1	8166066	.	G	T	1	2	3	0	0	3	0	0
1	8166788	.	A	T	7	7	14	0	0	14	0	0
1	8167383	.	G	A	6	5	11	0	0	11	0	0
1	8167801	.	G	C	6	7	13	0	2	15	0	0
1	8185072	.	G	A	10	7	17	0	0	17	0	0
1	8189518	.	G	T	6	10	16	0	2	18	0	0
1	8401133	.	T	A	2	2	4	0	0	4	0	0
1	8401383	.	G	T	2	3	5	0	0	5	0	0
1	8403331	.	C	T	3	2	5	0	0	5	0	0
1	8403535	.	C	A	2	3	5	0	0	5	0	0
1	8415994	.	C	G	1	2	3	0	1	4	0	0
1	8416165	.	T	C	33	3	36	1	26	63	0	0
1	8416340	.	A	T	33	17	50	0	2	52	0	0
1	8416534	.	A	T	29	22	51	0	1	52	0	0
1	8416565	.	T	A	29	31	60	0	0	60	0	0
1	8416770	.	G	C	13	10	23	0	4	27	0	0
1	8416820	.	C	T	7	7	14	0	1	15	0	0
1	8416967	.	C	T	1	13	14	0	15	29	0	0
1	8417064	.	T	C	26	15	41	0	1	42	0	0
1	8417106	.	G	T	13	19	32	0	1	33	0	0
1	8417109	.	T	G	14	21	35	0	0	35	0	0
1	8417191	.	T	A	21	30	51	0	7	59	1	0
1	8417336	.	A	T	12	7	19	1	0	20	0	0
1	8417340	.	A	T	12	3	15	1	2	18	0	0
1	8417901	.	T	C	21	21	42	0	1	43	0	0
1	8417983	.	G	T	8	15	23	0	1	24	0	0
1	8418058	.	T	A	6	11	17	0	0	17	0	0
1	8418118	.	C	G	10	11	21	0	0	21	0	0
1	8418373	.	C	T	1	22	23	0	9	32	0	0
1	8418503	.	G	T	26	21	47	0	0	47	0	0
1	8418514	.	G	A	27	23	50	0	0	50	0	0
1	8418571	.	A	T	28	26	54	0	4	58	0	0
1	8424705	.	G	A	12	20	32	1	4	37	0	0
1	8424725	.	C	T	1	23	24	0	14	38	0	0
1	8424804	.	C	T	23	9	32	0	2	34	0	0
1	8424813	.	A	G	22	10	32	0	0	32	0	0
1	8428730	.	T	C	9	0	9	0	7	16	0	0
1	8428739	.	C	G	7	3	10	0	0	10	0	0
1	8508755	.	G	A	1	7	8	0	10	18	0	0
1	8509463	.	C	T	10	7	17	0	1	18	0	0
1	8509571	.	G	A	5	7	12	0	1	13	0	0
1	8511602	.	C	T	11	11	22	0	1	23	0	0
1	8511778	.	G	T	1	16	17	0	13	30	0	0
1	8516587	.	C	T	8	7	15	0	0	15	0	0
1	8527086	.	G	A	0	1	1	0	2	3	0	0
1	8527148	.	C	T	3	3	6	0	0	6	0	0
1	8530417	.	T	A	1	5	6	0	0	6	0	0
1	8530788	.	A	G	2	3	5	0	0	5	0	0
1	8530898	.	T	C	1	3	4	0	0	4	0	0
1	8530928	.	C	T	6	3	9	0	0	9	0	0
1	8531577	.	C	T	9	7	16	0	0	16	0	0
1	8531824	.	G	A	1	3	4	0	1	5	0	0
1	8532003	.	G	C	1	3	4	1	0	5	0	0
1	8539301	.	A	G	1	5	6	0	1	7	0	0
1	8539878	.	A	T	2	3	5	0	0	5	0	0
1	8543769	.	G	C	2	2	4	0	1	5	0	0
1	8545259	.	T	C	1	0	1	0	4	5	0	0
1	8546703	.	A	G	1	5	6	0	0	6	0	0
1	8550003	.	T	C	1	3	4	0	0	4	0	0
1	8550062	.	A	G	3	2	5	0	0	5	0	0
1	8550116	.	C	T	2	2	4	0	0	4	0	0
1	8557075	.	G	A	6	6	12	0	0	12	0	0
1	8557156	.	C	T	0	10	10	0	3	13	0	0
1	8557159	.	T	A	9	3	12	0	2	14	0	0
1	8559271	.	T	C	11	0	11	0	4	15	0	0
1	8559295	.	C	T	9	5	14	0	1	15	0	0
1	8559337	.	G	A	7	6	13	0	0	13	0	0
1	8559750	.	C	T	1	5	6	0	0	6	0	0
1	8560007	.	C	T	2	2	4	0	0	4	0	0
1	8560072	.	A	G	4	3	7	0	0	7	0	0
1	8560208	.	G	A	3	5	8	0	0	8	0	0
1	8560289	.	C	T	3	6	9	0	0	9	0	0
1	8562005	.	G	C	5	4	9	0	1	10	0	0
1	8563728	.	C	T	3	3	6	0	0	6	0	0
1	8563755	.	A	G	3	5	8	0	0	8	0	0
1	8566188	.	T	G	4	2	6	0	0	6	0	0
1	8566387	.	A	T	1	2	3	0	0	3	0	0
1	8601971	.	A	T	11	8	19	0	0	19	0	0
1	8601990	.	A	T	12	8	20	0	0	20	0	0
1	8606632	.	C	T	4	6	10	0	0	10	0	0
1	8606644	.	G	A	6	6	12	0	0	12	0	0
1	8606677	.	C	G	6	5	11	0	0	11	0	0
1	8608186	.	A	G	5	1	6	0	7	13	0	0
1	8608300	.	C	T	7	6	13	0	0	13	0	0
1	8639847	.	C	T	1	5	6	0	4	10	0	0
1	8639883	.	G	A	3	5	8	0	0	8	0	0
1	8642800	.	C	T	4	5	9	0	2	11	0	0
1	8642824	.	A	T	4	4	8	0	0	8	0	0
1	8643272	.	C	T	2	5	7	0	1	8	0	0
1	8643348	.	C	G	2	3	5	0	0	5	0	0
1	8643442	.	G	A	2	3	5	0	0	5	0	0
1	8643446	.	C	A	0	3	3	0	2	5	0	0
1	8643534	.	C	A	4	1	5	0	1	6	0	0
1	8646843	.	C	T	3	3	6	0	0	6	0	0
1	8646855	.	A	T	2	4	6	0	1	7	0	0
1	8649726	.	A	G	45	47	92	1	1	94	0	0
1	8649865	.	C	T	44	29	73	0	2	75	0	0
1	8649994	.	A	T	35	38	73	0	3	76	0	0
1	8650149	.	A	G	35	26	61	0	7	68	0	0
1	8650203	.	G	A	33	26	59	0	3	62	0	0
1	8650245	.	G	A	32	27	59	0	1	60	0	0
1	8650290	.	C	T	4	32	36	0	27	63	0	0
1	8650317	.	G	A	24	34	58	0	3	61	0	0
1	8650371	.	C	T	27	34	61	0	2	63	0	0
1	8650979	.	A	G	29	29	58	0	3	61	0	0
1	8651060	.	T	C	32	30	62	0	0	62	0	0
1	8663018	.	G	A	11	18	29	0	1	30	0	0
1	8663048	.	G	A	2	22	24	0	11	35	0	0
1	8663087	.	C	A	24	13	37	0	3	40	0	0
1	8663165	.	C	T	18	16	34	0	1	35	0	0
1	8663295	.	T	C	17	17	34	0	1	35	0	0
1	8667377	.	G	A	23	20	43	0	0	43	0	0
1	8667606	.	C	T	10	23	33	0	0	33	0	0
1	8668166	.	T	C	24	31	55	0	2	57	0	0
1	8668238	.	G	T	31	14	45	0	2	47	0	0
1	8668930	.	A	T	1	6	7	0	0	7	0	0
1	8669543	.	A	G	11	7	18	0	1	19	0	0
1	8669669	.	A	G	14	15	29	0	0	29	0	0
1	8669717	.	T	G	18	13	31	0	2	33	0	0
1	8669718	.	T	C	19	14	33	0	0	33	0	0
1	8669847	.	G	T	25	24	49	0	2	51	0	0
1	8670031	.	T	C	36	31	67	0	2	69	0	0
1	8670032	.	G	T	3	33	36	0	34	70	0	0
1	8670402	.	G	A	17	14	31	0	1	32	0	0
1	8670460	.	A	G	2	3	5	0	0	5	0	0
1	8698799	.	C	T	16	17	33	0	3	36	0	0
1	8701623	.	C	T	23	24	47	0	1	48	0	0
1	8701747	.	G	A	22	18	40	3	1	44	0	0
1	8702158	.	G	A	21	8	29	2	2	33	0	0
1	8702160	.	G	A	19	5	24	2	4	30	0	0
1	8702400	.	T	C	25	27	52	0	1	53	0	0
1	8763824	.	A	G	4	4	8	0	0	8	0	0
1	8763832	.	A	C	5	0	5	0	4	9	0	0
1	8764612	.	T	C	10	0	10	0	7	17	0	0
1	8764661	.	T	A	16	13	29	0	0	29	0	0
1	8764729	.	C	T	18	12	30	0	1	31	0	0
1	8764734	.	C	T	16	11	27	0	2	29	0	0
1	8764811	.	C	T	0	19	19	0	12	31	0	0
1	8765028	.	G	A	10	17	27	0	0	27	0	0
1	8765315	.	A	G	21	21	42	0	1	43	0	0
1	8765422	.	G	A	15	15	30	0	1	31	0	0
1	8765491	.	T	A	18	10	28	0	1	29	0	0
1	8765493	.	G	T	14	10	24	0	1	26	1	0
1	8765713	.	A	C	21	25	46	0	2	48	0	0
1	8765724	.	A	G	20	29	49	0	2	51	0	0
1	8766023	.	C	T	18	8	26	0	1	27	0	0
1	8766267	.	T	C	9	1	10	0	17	27	0	0
1	8766903	.	G	C	13	10	23	0	0	23	0	0
1	8767002	.	C	T	7	10	17	0	3	20	0	0
1	8767080	.	G	A	10	8	18	0	0	18	0	0
1	8767155	.	C	T	9	9	18	0	5	23	0	0
1	8767464	.	G	T	13	6	19	0	1	20	0	0
1	8767518	.	G	A	11	3	14	0	1	15	0	0
1	8767536	.	T	C	8	0	8	0	6	14	0	0
1	8767725	.	T	C	9	7	16	0	1	18	1	0
1	8768307	.	A	G	7	8	15	0	1	16	0	0
1	8773383	.	A	G	3	5	8	0	1	9	0	0
1	8810701	.	T	G	4	2	6	0	0	6	0	0
1	8974695	.	A	T	3	9	12	0	1	13	0	0
1	9004942	.	T	C	6	6	12	0	0	12	0	0
1	9044313	.	A	G	1	0	1	0	2	3	0	0
1	9056045	.	T	G	9	11	20	0	2	22	0	0
1	9056886	.	T	C	18	18	36	0	0	36	0	0
1	9064611	.	T	C	3	13	16	0	0	16	0	0
1	9064781	.	T	G	6	4	10	0	0	10	0	0
1	9064864	.	T	C	4	4	8	0	1	9	0	0
1	9074335	.	C	T	15	9	24	0	0	24	0	0
1	9074440	.	T	C	22	8	30	0	4	34	0	0
1	9123262	.	A	G	17	18	35	1	0	36	0	0
1	9123289	.	C	G	12	19	31	1	1	33	0	0
1	9145260	.	C	T	4	2	6	0	0	6	0	0
1	9214551	.	T	G	1	1	2	0	4	6	0	0
1	9261903	.	A	C	12	0	12	1	12	25	0	0
1	9261930	.	G	A	13	13	26	1	0	27	0	0
1	9262173	.	G	A	16	11	27	0	1	28	0	0
1	9262221	.	A	G	11	8	19	0	0	19	0	0
1	9270198	.	T	C	7	6	13	0	0	13	0	0
1	9270933	.	C	T	4	6	10	0	0	10	0	0
1	9273011	.	C	T	11	5	16	0	1	17	0	0
1	9273037	.	A	G	9	6	15	0	1	16	0	0
1	9276360	.	T	C	9	1	10	0	8	18	0	0
1	9277858	.	T	C	9	7	16	0	0	16	0	0
1	9290319	.	A	G	2	7	9	0	0	9	0	0
1	9292975	.	A	T	7	4	11	0	1	12	0	0
1	9293002	.	T	C	8	7	15	0	1	16	0	0
1	9293041	.	C	T	9	12	21	0	1	22	0	0
1	9293117	.	G	A	1	5	6	0	11	17	0	0
1	9293156	.	G	A	4	9	13	0	2	15	0	0
1	9293185	.	T	C	8	9	17	0	0	17	0	0
1	9293215	.	G	A	7	8	15	0	0	15	0	0
1	9293580	.	C	T	10	12	22	0	1	23	0	0
1	9293740	.	T	C	6	10	16	0	1	17	0	0
1	9293889	.	C	A	2	2	4	0	0	4	0	0
1	9500699	.	T	C	3	3	6	0	0	6	0	0
1	9500700	.	T	C	3	0	3	0	3	6	0	0
1	9500765	.	T	C	3	5	8	0	2	10	0	0
1	9500766	.	T	C	5	4	9	0	1	10	0	0
1	9709872	.	T	C	6	2	8	0	0	8	0	0
1	10223203	.	A	G	2	0	2	0	2	4	0	0
1	10738177	.	A	G	25	11	36	1	0	37	0	0
1	11783388	.	T	C	15	25	40	0	2	42	0	0
1	11783410	.	T	C	24	11	35	0	1	36	0	0
1	11783504	.	T	C	24	15	39	0	2	41	0	0
1	11783650	.	T	C	21	22	43	0	0	43	0	0
1	11784609	.	T	C	18	14	32	0	3	35	0	0
1	11784679	.	T	C	18	30	48	0	1	49	0	0
1	15138708	.	A	C	1	7	8	0	0	9	1	0
1	15139336	.	T	C	1	2	3	0	0	3	0	0
1	15142631	.	T	C	11	8	19	0	3	22	0	0
1	15200277	.	T	C	25	11	36	0	0	36	0	0
1	15200440	.	A	G	15	1	16	0	21	37	0	0
1	15200517	.	A	T	15	19	34	0	1	35	0	0
1	15200595	.	A	G	9	27	36	0	1	37	0	0
1	15200730	.	G	C	0	21	21	0	16	37	0	0
1	15200777	.	T	C	15	16	31	0	2	33	0	0
1	15201264	.	A	C	8	21	29	0	1	30	0	0
1	15201491	.	A	G	22	18	40	0	1	41	0	0
1	15201603	.	C	T	15	17	32	0	0	32	0	0
1	15201732	.	T	G	13	19	32	0	1	34	1	0
1	15201889	.	G	T	1	15	16	0	16	32	0	0
1	15201931	.	A	T	17	18	35	0	0	35	0	0
1	15202287	.	G	A	17	26	43	0	4	47	0	0
1	15202716	.	G	T	21	18	39	0	1	40	0	0
1	15203038	.	T	C	21	13	34	0	4	38	0	0
1	15203056	.	T	C	20	19	39	0	2	41	0	0
1	15230428	.	C	G	5	2	7	0	1	8	0	0
1	15240166	.	C	T	1	2	3	0	0	3	0	0
1	15242916	.	C	T	9	3	12	0	0	12	0	0
1	15253705	.	A	G	3	9	12	0	0	12	0	0
1	15253732	.	T	G	4	7	11	0	1	12	0	0
1	15254249	.	A	G	7	0	7	0	5	12	0	0
1	15254351	.	T	G	7	11	18	0	1	19	0	0
1	15254468	.	T	C	5	4	9	0	2	11	0	0
1	15254866	.	G	A	0	7	7	0	12	19	0	0
1	15254973	.	A	T	5	3	8	0	0	8	0	0
1	15255308	.	C	T	9	5	14	0	0	14	0	0
1	15255411	.	T	C	4	12	16	0	0	16	0	0
1	15255424	.	A	G	4	0	4	0	14	18	0	0
1	15255468	.	G	A	5	8	13	1	0	15	1	0
1	15255597	.	A	T	11	9	20	0	1	21	0	0
1	15255699	.	T	A	6	11	17	0	0	17	0	0
1	15255703	.	T	C	5	11	16	0	1	17	0	0
1	15255799	.	G	A	2	4	6	0	0	6	0	0
1	15255877	.	A	C	3	6	9	0	2	11	0	0
1	15259036	.	G	A	3	6	9	0	1	10	0	0
1	15259178	.	C	A	1	3	4	0	1	5	0	0
1	15284984	.	T	C	5	6	11	0	1	12	0	0
1	15293547	.	G	T	6	8	14	0	0	14	0	0
1	15294701	.	C	T	1	10	11	0	10	21	0	0
1	15297504	.	C	T	0	10	10	0	6	16	0	0
1	15306233	.	G	A	2	3	5	0	0	5	0	0
1	15306320	.	T	C	2	2	4	0	1	5	0	0
1	15311846	.	A	G	1	3	4	0	1	5	0	0
1	15312410	.	C	T	5	6	11	0	0	11	0	0
1	15712307	.	G	A	2	3	5	0	1	6	0	0
1	15712356	.	G	T	2	5	7	0	0	7	0	0
1	15764411	.	C	A	1	1	2	0	3	5	0	0
1	16127926	.	C	T	17	16	33	0	2	35	0	0
1	16127962	.	G	A	18	18	36	0	3	39	0	0
1	16152840	.	G	A	1	27	28	1	10	39	0	0
1	16153607	.	G	A	19	15	34	0	0	34	0	0
1	16548908	.	C	T	1	5	6	0	0	6	0	0
1	16559904	.	T	C	0	3	3	0	0	3	0	0
1	16559907	.	T	C	2	2	4	0	0	4	0	0
1	16574059	.	G	T	1	8	9	0	5	14	0	0
1	16574149	.	C	T	2	1	3	0	1	4	0	0
1	16574154	.	T	C	2	2	4	0	0	4	0	0
1	16574214	.	G	T	4	2	6	0	0	6	0	0
1	16574417	.	G	A	8	7	15	0	1	16	0	0
1	16609231	.	C	T	10	13	23	0	3	26	0	0
1	16614590	.	T	C	12	16	28	0	1	29	0	0
1	16616881	.	A	T	29	17	46	0	0	46	0	0
1	16617296	.	T	C	6	8	14	0	0	14	0	0
1	16633611	.	T	A	5	4	9	0	0	9	0	0
1	16633629	.	C	T	4	4	8	1	0	9	0	0
1	16633665	.	T	C	4	2	6	1	0	7	0	0
1	16634129	.	C	T	2	3	5	0	1	6	0	0
1	16635013	.	C	T	1	5	6	0	0	6	0	0
1	16635341	.	T	C	5	3	8	0	0	8	0	0
1	16635596	.	C	T	4	5	9	0	0	9	0	0
1	16637853	.	G	A	7	5	12	0	0	12	0	0
1	16637955	.	T	C	4	3	7	0	1	8	0	0
1	16638189	.	G	A	6	3	9	1	0	10	0	0
1	16638464	.	T	C	2	4	6	0	1	7	0	0
1	16638575	.	C	T	5	6	11	0	0	11	0	0
1	16639396	.	A	G	8	5	13	0	0	13	0	0
1	16639501	.	T	C	7	10	17	0	2	19	0	0
1	16639732	.	C	T	7	10	17	0	1	18	0	0
1	16640081	.	G	T	7	13	20	0	2	22	0	0
1	16640138	.	A	G	8	0	8	0	15	23	0	0
1	16640277	.	T	C	6	5	11	0	0	11	0	0
1	16642684	.	T	C	10	4	14	0	1	15	0	0
1	16642770	.	G	A	7	4	11	0	0	11	0	0
1	16646269	.	A	G	8	4	12	0	0	12	0	0
1	16646372	.	G	A	3	9	12	0	0	12	0	0
1	16646405	.	C	T	4	8	12	0	1	13	0	0
1	16646499	.	C	T	12	5	17	0	0	17	0	0
1	16646833	.	C	G	14	0	14	0	11	25	0	0
1	16646848	.	T	A	12	13	25	0	2	27	0	0
1	16647928	.	G	T	7	12	19	0	3	22	0	0
1	16650067	.	T	A	15	13	28	0	2	30	0	0
1	16650350	.	T	A	14	7	21	0	0	21	0	0
1	16650433	.	G	A	13	10	23	0	0	23	0	0
1	16650463	.	C	T	13	15	28	0	4	32	0	0
1	16653552	.	A	T	10	5	15	0	0	15	0	0
1	16653655	.	C	T	11	14	25	0	2	27	0	0
1	16653923	.	T	C	7	10	17	0	0	17	0	0
1	16653991	.	G	C	12	14	26	0	2	28	0	0
1	16654145	.	C	G	1	3	4	0	0	4	0	0
1	16654487	.	T	A	7	8	15	0	3	18	0	0
1	16654572	.	A	G	8	6	14	0	0	14	0	0
1	16654657	.	T	G	4	7	11	0	0	11	0	0
1	16654898	.	A	G	6	8	14	0	0	14	0	0
1	16654910	.	G	A	4	9	13	0	1	14	0	0
1	16655077	.	C	T	6	6	12	0	0	12	0	0
1	16655134	.	G	A	14	8	22	0	0	22	0	0
1	16656053	.	A	G	10	8	18	0	0	18	0	0
1	16656828	.	C	T	4	6	10	0	0	10	0	0
1	16675255	.	G	T	13	6	19	0	0	19	0	0
1	16675293	.	A	G	13	4	17	0	1	18	0	0
1	16675380	.	A	T	7	10	17	0	1	18	0	0
1	16675407	.	T	C	7	0	7	0	4	11	0	0
1	16675493	.	C	T	7	2	9	0	1	10	0	0
1	16675564	.	T	A	5	5	10	0	0	10	0	0
1	16675615	.	T	C	6	0	6	0	9	15	0	0
1	16679950	.	G	T	10	5	15	0	2	17	0	0
1	16679956	.	A	T	8	8	16	0	1	17	0	0
1	16688911	.	G	T	3	5	8	0	1	9	0	0
1	17481349	.	A	T	2	2	4	0	0	4	0	0
1	17484383	.	A	C	2	3	5	0	0	5	0	0
1	17484724	.	A	G	3	4	7	0	0	7	0	0
1	17487170	.	A	G	2	0	2	0	5	7	0	0
1	17496233	.	C	A	3	4	7	0	0	7	0	0
1	17496245	.	T	C	3	6	9	0	0	9	0	0
1	17496394	.	C	T	3	6	9	0	1	10	0	0
1	17496506	.	A	G	4	7	11	0	0	11	0	0
1	17497479	.	C	T	5	5	10	0	1	11	0	0
1	17500257	.	T	C	5	5	10	0	0	10	0	0
1	17500275	.	A	G	5	0	5	0	4	9	0	0
1	17505138	.	T	C	5	14	19	0	1	20	0	0
1	17505676	.	A	G	5	9	14	0	0	14	0	0
1	17505759	.	T	C	7	4	11	0	0	11	0	0
1	17509715	.	C	T	6	9	15	0	2	17	0	0
1	17509754	.	T	C	7	13	20	0	1	21	0	0
1	17509861	.	A	G	6	8	14	0	0	14	0	0
1	17510038	.	T	C	5	12	17	0	0	17	0	0
1	17513463	.	C	T	14	13	27	0	1	28	0	0
1	17513496	.	T	C	18	17	35	0	1	36	0	0
1	17513562	.	A	G	18	1	19	0	14	33	0	0
1	17513574	.	T	A	19	15	34	0	2	36	0	0
1	17515145	.	G	C	9	6	15	0	1	16	0	0
1	17522001	.	C	A	18	19	37	0	3	40	0	0
1	17522031	.	T	C	22	21	43	0	2	45	0	0
1	17522098	.	T	A	27	14	41	0	3	44	0	0
1	17522107	.	T	C	30	18	48	0	1	49	0	0
1	17522249	.	G	T	23	24	47	0	10	57	0	0
1	17522313	.	C	T	17	11	28	0	2	30	0	0
1	17522647	.	C	T	12	14	26	0	0	26	0	0
1	17522755	.	C	T	15	12	27	1	3	31	0	0
1	17522868	.	A	G	13	0	13	0	27	40	0	0
1	17522923	.	C	T	15	20	35	0	5	40	0	0
1	17523080	.	T	C	17	18	35	0	2	37	0	0
1	17523119	.	T	A	24	16	40	0	2	42	0	0
1	17523170	.	A	G	24	11	35	0	2	37	0	0
1	17523350	.	T	C	14	7	21	0	0	21	0	0
1	17523592	.	G	C	7	6	13	0	1	14	0	0
1	17523603	.	A	G	12	5	17	0	1	18	0	0
1	17523891	.	G	A	16	21	37	0	3	40	0	0
1	17523971	.	G	C	12	10	22	0	1	23	0	0
1	17523976	.	A	G	9	17	26	0	0	26	0	0
1	17524150	.	A	T	14	20	34	0	4	38	0	0
1	17524401	.	T	A	3	5	8	0	0	8	0	0
1	17524452	.	G	A	0	6	6	0	12	18	0	0
1	17524508	.	G	C	13	6	19	0	1	20	0	0
1	17524562	.	T	C	13	22	35	0	4	39	0	0
1	17531731	.	C	A	2	3	5	0	1	6	0	0
1	17531762	.	T	A	2	5	7	0	0	7	0	0
1	17534533	.	T	A	2	2	4	0	0	4	0	0
1	17534734	.	C	T	5	2	7	0	0	7	0	0
1	17534870	.	G	A	0	6	6	0	7	13	0	0
1	17534892	.	A	T	5	7	12	0	0	12	0	0
1	17534952	.	T	G	3	4	7	0	0	7	0	0
1	17534962	.	G	A	3	5	8	0	1	9	0	0
1	17535015	.	G	A	5	6	11	0	2	13	0	0
1	17535021	.	G	A	5	8	13	0	0	13	0	0
1	17535150	.	G	T	4	4	8	0	1	9	0	0
1	17535245	.	T	C	3	3	6	0	0	6	0	0
1	17535334	.	G	A	1	9	10	0	4	14	0	0
1	17535349	.	C	T	5	9	14	0	1	15	0	0
1	17535442	.	G	A	5	6	11	0	1	12	0	0
1	17535461	.	T	G	5	5	10	0	1	11	0	0
1	17535493	.	G	A	2	7	9	0	5	14	0	0
1	17535858	.	A	G	4	0	4	0	5	9	0	0
1	17535859	.	A	G	2	7	9	0	0	9	0	0
1	17537709	.	A	G	6	11	17	0	0	17	0	0
1	17537731	.	T	C	9	10	19	0	0	19	0	0
1	17538164	.	A	G	7	4	11	3	1	15	0	0
1	17538751	.	T	C	14	0	14	0	12	26	0	0
1	17538823	.	A	G	8	6	14	0	3	17	0	0
1	17538852	.	A	G	11	9	20	0	0	20	0	0
1	17539011	.	T	G	9	4	13	0	0	13	0	0
1	17539171	.	T	A	5	8	13	0	3	16	0	0
1	17539212	.	G	A	11	5	16	0	0	16	0	0
1	17542951	.	A	G	3	5	8	0	0	8	0	0
1	17546586	.	A	T	6	5	11	0	0	11	0	0
1	17546827	.	C	T	7	4	11	0	0	11	0	0
1	17554050	.	A	G	3	8	11	0	0	11	0	0
1	17555209	.	T	C	3	5	8	0	0	8	0	0
1	17555218	.	C	T	3	4	7	0	0	7	0	0
1	17565727	.	G	A	2	3	5	0	0	5	0	0
1	17565736	.	A	G	3	3	6	0	0	6	0	0
1	17565893	.	G	A	2	3	5	0	0	5	0	0
1	17618500	.	C	T	1	2	3	0	2	5	0	0
1	17681203	.	G	A	1	2	3	0	0	3	0	0
1	17681429	.	T	C	2	2	4	0	0	4	0	0
1	17681508	.	T	C	2	7	9	0	0	9	0	0
1	17683203	.	A	T	8	9	17	0	1	18	0	0
1	17688762	.	A	G	9	6	15	0	1	16	0	0
1	17688868	.	A	C	6	8	14	0	0	14	0	0
1	17689083	.	C	G	0	10	10	0	8	18	0	0
1	17689173	.	T	C	7	6	13	0	2	15	0	0
1	17689182	.	T	C	9	0	9	0	8	17	0	0
1	17693082	.	G	C	7	3	10	0	0	10	0	0
1	17693156	.	A	T	2	5	7	0	0	7	0	0
1	17693218	.	C	T	2	2	4	0	0	4	0	0
1	17698210	.	G	A	3	2	5	0	0	5	0	0
1	17699529	.	T	A	1	6	7	0	0	7	0	0
1	17699534	.	A	G	0	6	6	0	1	7	0	0
1	17699650	.	A	G	15	4	19	0	0	19	0	0
1	17701890	.	T	G	11	9	20	0	1	21	0	0
1	17702512	.	T	A	8	8	16	0	2	18	0	0
1	17704125	.	C	T	8	4	12	0	1	13	0	0
1	17704155	.	A	G	9	6	15	0	1	16	0	0
1	17708635	.	G	A	10	11	21	0	0	21	0	0
1	17710831	.	T	C	6	7	13	0	0	13	0	0
1	17711097	.	G	T	5	9	14	0	1	15	0	0
1	17711346	.	G	A	10	3	13	0	0	13	0	0
1	17711596	.	T	A	10	7	17	0	0	17	0	0
1	17711623	.	C	T	7	5	12	0	0	12	0	0
1	17747841	.	G	C	6	4	10	0	0	10	0	0
1	17747849	.	T	A	7	3	10	0	0	10	0	0
1	17761911	.	A	G	1	3	4	0	1	5	0	0
1	17786115	.	A	G	1	2	3	0	0	3	0	0
1	18251852	.	G	A	1	2	3	0	0	3	0	0
1	18363861	.	C	T	3	2	5	0	2	7	0	0
1	18363880	.	A	C	2	1	3	0	2	5	0	0
1	18363913	.	C	T	0	3	3	0	3	6	0	0
1	18373398	.	G	T	1	2	3	0	0	3	0	0
1	18375662	.	T	A	1	3	4	0	1	5	0	0
1	18446152	.	G	A	3	2	5	0	0	5	0	0
1	18576621	.	C	A	7	4	11	0	0	11	0	0
1	18576650	.	C	T	7	7	14	0	0	14	0	0
1	18578259	.	C	T	4	4	8	0	0	8	0	0
1	18578425	.	A	G	3	4	7	0	0	7	0	0
1	18581127	.	T	C	6	3	9	0	0	9	0	0
1	18587418	.	C	A	7	4	11	0	0	11	0	0
1	18587426	.	A	G	7	4	11	0	0	11	0	0
1	18965961	.	A	T	4	2	6	0	1	7	0	0
1	19872269	.	C	T	5	2	7	0	0	7	0	0
1	19872320	.	G	A	0	4	4	0	2	6	0	0
1	19874549	.	A	G	3	3	6	0	0	6	0	0
1	19874550	.	G	A	3	3	6	0	0	6	0	0
1	19879890	.	A	T	4	3	7	0	0	7	0	0
1	19882538	.	C	A	4	5	9	0	0	9	0	0
1	19885849	.	A	C	7	4	11	0	1	12	0	0
1	19886336	.	G	A	1	5	6	0	4	10	0	0
1	19936673	.	A	G	3	2	5	0	0	5	0	0
1	19950478	.	A	T	5	7	12	0	1	13	0	0
1	19950737	.	C	A	10	7	17	0	1	18	0	0
1	19966416	.	C	T	13	9	22	0	0	22	0	0
1	19978049	.	A	G	4	0	4	0	4	8	0	0
1	19978118	.	T	C	9	9	18	0	0	18	0	0
1	19978445	.	A	C	7	9	16	0	0	16	0	0
1	19984448	.	C	T	10	10	20	1	0	21	0	0
1	19989354	.	C	T	14	5	19	0	0	19	0	0
1	19989404	.	G	A	7	5	12	0	3	15	0	0
1	20063843	.	C	A	0	3	3	0	3	6	0	0
1	20068075	.	A	C	3	2	5	0	0	6	1	0
1	20068092	.	T	A	4	2	6	0	0	6	0	0
1	20084537	.	A	G	5	5	10	0	0	10	0	0
1	20094234	.	G	A	5	4	9	0	1	10	0	0
1	20094327	.	G	T	4	4	8	0	0	8	0	0
1	20095274	.	A	G	3	4	7	0	0	7	0	0
1	20112454	.	C	T	2	2	4	6	0	10	0	0
1	20117596	.	T	C	3	4	7	0	0	7	0	0
1	20129516	.	G	A	5	4	9	0	0	9	0	0
1	20129652	.	T	C	10	3	13	0	0	13	0	0
1	20138983	.	C	G	5	3	8	0	0	8	0	0
1	20138993	.	C	T	5	3	8	0	0	8	0	0
1	20141572	.	G	A	1	12	13	0	17	30	0	0
1	20141661	.	A	C	7	14	21	0	1	22	0	0
1	20147248	.	T	A	9	6	15	0	1	16	0	0
1	20160882	.	T	A	13	12	25	0	3	28	0	0
1	20166536	.	C	A	15	12	27	0	2	29	0	0
1	20194118	.	C	T	8	8	16	0	0	16	0	0
1	20212284	.	C	T	6	8	14	0	0	14	0	0
1	20270779	.	G	T	7	6	13	0	0	13	0	0
1	20273071	.	T	C	2	2	4	0	0	4	0	0
1	20273088	.	G	A	2	3	5	0	0	5	0	0
1	20273198	.	C	A	0	3	3	0	1	4	0	0
1	20556916	.	G	T	3	12	15	0	3	18	0	0
1	20557447	.	G	A	18	15	33	0	3	36	0	0
1	20557467	.	G	A	14	22	36	0	0	36	0	0
1	20557625	.	A	C	7	0	7	0	6	13	0	0
1	20557650	.	C	T	7	3	10	0	3	13	0	0
1	20557662	.	G	T	6	4	10	0	2	12	0	0
1	20558311	.	G	C	3	4	7	0	1	8	0	0
1	20558523	.	G	A	3	3	6	0	0	6	0	0
1	20558691	.	A	C	4	2	6	0	0	6	0	0
1	20558902	.	A	G	3	4	7	0	0	7	0	0
1	20559214	.	T	A	6	5	11	0	2	13	0	0
1	20559321	.	T	C	4	0	4	0	6	10	0	0
1	20559427	.	C	T	3	3	6	0	0	6	0	0
1	20559442	.	C	T	4	2	6	0	0	6	0	0
1	20559538	.	G	A	11	4	15	0	0	15	0	0
1	20559830	.	G	A	3	4	7	0	0	7	0	0
1	20564770	.	T	G	2	5	7	0	1	8	0	0
1	20635419	.	C	T	29	24	53	0	1	54	0	0
1	20694955	.	A	G	24	23	47	0	1	48	0	0
1	20698009	.	C	T	32	23	55	0	1	56	0	0
1	20705237	.	C	T	20	22	42	0	3	45	0	0
1	20866958	.	A	G	23	27	50	0	1	51	0	0
1	20867057	.	A	T	29	30	59	0	4	63	0	0
1	20867321	.	C	T	4	22	26	0	24	50	0	0
1	20867345	.	C	T	34	20	54	0	1	55	0	0
1	20867359	.	C	T	36	15	51	0	4	55	0	0
1	20867478	.	T	C	16	41	57	0	7	64	0	0
1	20867611	.	T	C	33	39	72	0	1	73	0	0
1	20867623	.	T	C	37	34	71	0	1	72	0	0
1	20867650	.	G	A	33	31	64	0	5	69	0	0
1	20867887	.	T	C	25	40	65	0	5	70	0	0
1	20867901	.	C	G	6	25	31	0	39	71	1	0
1	20867933	.	T	C	40	2	42	1	29	72	0	0
1	20868301	.	A	G	27	38	65	0	5	70	0	0
1	20868338	.	G	T	34	28	62	0	4	66	0	0
1	20868467	.	C	T	39	22	61	0	0	61	0	0
1	20868525	.	G	C	35	27	62	1	3	66	0	0
1	20868762	.	C	A	25	15	40	7	3	50	0	0
1	20868765	.	C	G	2	14	16	7	26	49	0	0
1	20868997	.	C	T	4	24	28	0	26	54	0	0
1	20870219	.	T	G	19	20	39	0	1	42	2	0
1	20870601	.	A	G	40	18	58	5	2	65	0	0
1	20870774	.	G	A	30	33	63	0	4	67	0	0
1	20870808	.	C	T	0	24	24	1	40	65	0	0
1	20870846	.	C	T	28	33	61	1	0	62	0	0
1	20870876	.	C	T	33	24	57	0	3	60	0	0
1	20871210	.	G	A	29	29	58	1	1	60	0	0
1	20878946	.	C	T	20	28	48	0	1	49	0	0
1	20878994	.	G	A	36	22	58	0	1	59	0	0
1	20886924	.	G	A	35	24	59	0	2	61	0	0
1	20886936	.	G	A	29	27	56	0	3	59	0	0
1	20910967	.	A	G	23	29	52	0	4	56	0	0
1	20911156	.	T	G	32	26	58	0	3	61	0	0
1	20916898	.	G	A	4	2	6	0	0	6	0	0
1	20925532	.	G	A	2	3	5	0	0	5	0	0
1	20925544	.	G	T	2	3	5	0	0	5	0	0
1	20941806	.	T	A	11	8	19	0	0	19	0	0
1	20946897	.	A	G	6	6	12	0	0	12	0	0
1	20959028	.	T	C	3	2	5	1	0	6	0	0
1	20966059	.	T	C	3	5	8	0	0	8	0	0
1	20970109	.	G	T	4	2	6	0	0	6	0	0
1	21138623	.	T	C	3	4	7	0	0	7	0	0
1	21139108	.	A	G	7	6	13	0	0	13	0	0
1	21139355	.	G	A	5	3	8	0	0	8	0	0
1	21139367	.	G	A	5	3	8	0	1	9	0	0
1	21139456	.	G	C	12	8	20	0	0	20	0	0
1	21141701	.	A	G	9	5	14	0	1	15	0	0
1	21141869	.	T	G	4	6	10	0	1	11	0	0
1	21141894	.	C	T	0	6	6	0	4	10	0	0
1	21141999	.	G	A	5	8	13	0	2	15	0	0
1	21142029	.	A	G	7	8	15	0	0	15	0	0
1	21148609	.	A	T	1	6	7	0	0	7	0	0
1	21151784	.	A	G	4	2	6	0	1	7	0	0
1	21160853	.	G	A	3	2	5	0	0	5	0	0
1	21312085	.	G	A	18	12	30	0	1	31	0	0
1	21312112	.	C	T	12	15	27	0	3	30	0	0
1	21312145	.	A	G	11	10	21	0	1	22	0	0
1	21312318	.	A	T	3	2	5	0	0	5	0	0
1	21333205	.	C	G	1	20	21	0	22	43	0	0
1	21341577	.	T	C	8	30	38	2	3	43	0	0
1	21346051	.	C	T	20	10	30	0	1	31	0	0
1	21352529	.	A	G	17	10	27	0	0	27	0	0
1	21368014	.	C	A	23	13	36	0	0	36	0	0
1	21368074	.	C	A	12	14	26	0	1	27	0	0
1	21409358	.	G	T	9	7	16	0	1	17	0	0
1	21423756	.	A	G	11	17	28	0	2	30	0	0
1	21439453	.	G	A	12	14	26	0	1	27	0	0
1	21447843	.	C	T	14	8	22	0	1	23	0	0
1	21473134	.	G	A	6	3	9	0	0	9	0	0
1	21473155	.	G	A	7	3	10	0	0	10	0	0
1	21473248	.	T	C	5	0	5	0	3	8	0	0
1	21495980	.	T	C	1	2	3	0	0	3	0	0
1	21500209	.	T	A	8	5	13	0	2	15	0	0
1	21505670	.	G	A	8	5	13	0	0	13	0	0
1	21505702	.	G	T	7	6	13	0	0	13	0	0
1	21513826	.	G	A	6	7	13	0	0	13	0	0
1	21515880	.	G	A	5	3	8	0	0	8	0	0
1	21515903	.	G	T	6	5	11	0	0	11	0	0
1	21518503	.	G	A	2	3	5	0	1	6	0	0
1	21522253	.	G	A	2	3	5	0	0	5	0	0
1	21525823	.	C	T	0	6	6	0	2	8	0	0
1	21529367	.	G	A	2	4	6	0	0	6	0	0
1	21537546	.	T	A	2	2	4	0	0	4	0	0
1	21537554	.	G	A	2	3	5	0	0	5	0	0
1	21576828	.	C	A	0	2	2	0	0	2	0	0
1	21576835	.	G	T	1	2	3	0	0	3	0	0
1	21576919	.	G	A	3	3	6	0	0	6	0	0
1	21610651	.	A	G	5	3	8	0	0	8	0	0
1	21610678	.	G	T	3	4	7	0	0	7	0	0
1	21611043	.	T	C	3	2	5	0	1	6	0	0
1	21611109	.	A	T	5	5	10	0	0	10	0	0
1	21611128	.	T	C	4	0	4	0	4	8	0	0
1	21612268	.	A	C	5	2	7	0	0	7	0	0
1	21612400	.	G	A	10	4	14	0	0	14	0	0
1	21612418	.	G	C	8	4	12	0	0	12	0	0
1	21648917	.	T	A	1	2	3	0	0	3	0	0
1	21709447	.	T	C	3	4	7	0	0	7	0	0
1	21941031	.	C	A	3	2	5	0	0	5	0	0
1	21944731	.	C	T	2	2	4	0	0	4	0	0
1	21947233	.	A	T	2	2	4	0	0	4	0	0
1	21949907	.	A	C	2	3	5	0	0	5	0	0
1	21949910	.	G	A	3	3	6	0	0	6	0	0
1	21949996	.	C	T	6	4	10	0	2	12	0	0
1	21950179	.	C	T	2	3	5	0	0	5	0	0
1	21950621	.	G	A	2	6	8	0	3	11	0	0
1	21950650	.	T	C	4	6	10	0	1	11	0	0
1	21950824	.	C	A	3	4	7	0	0	7	0	0
1	21950841	.	G	A	0	4	4	0	4	8	0	0
1	21950896	.	G	A	1	4	5	0	7	12	0	0
1	21951119	.	G	A	1	3	4	0	1	5	0	0
1	21951309	.	T	G	3	9	12	0	0	12	0	0
1	21951411	.	G	A	3	3	6	0	0	6	0	0
1	21951431	.	T	C	4	3	7	0	0	7	0	0
1	21954946	.	G	A	2	3	5	0	5	10	0	0
1	21954974	.	C	T	5	3	8	0	0	8	0	0
1	21957122	.	T	G	10	9	19	0	1	20	0	0
1	21957124	.	T	C	9	9	18	0	1	19	0	0
1	21961364	.	G	T	0	4	4	0	6	10	0	0
1	21961430	.	T	C	6	10	16	0	0	16	0	0
1	22236891	.	A	T	6	2	8	0	0	8	0	0
1	22236990	.	G	A	2	4	6	0	0	6	0	0
1	22388955	.	C	T	1	3	4	0	0	4	0	0
1	22389122	.	C	T	4	6	10	0	1	11	0	0
1	22389246	.	C	T	0	4	4	0	7	11	0	0
1	22389264	.	T	A	9	7	16	0	1	17	0	0
1	22389395	.	T	C	16	11	27	0	0	27	0	0
1	22401851	.	A	G	7	4	11	0	0	11	0	0
1	22411760	.	A	G	9	6	15	0	0	15	0	0
1	22482490	.	C	T	4	14	18	0	0	18	0	0
1	22482494	.	A	T	14	8	22	0	1	23	0	0
1	22482560	.	G	T	12	15	27	2	0	29	0	0
1	22482575	.	A	G	12	8	20	2	0	22	0	0
1	22482810	.	T	C	4	3	7	4	0	11	0	0
1	22483076	.	T	C	3	3	6	0	0	6	0	0
1	22483098	.	G	T	3	1	4	0	1	5	0	0
1	22483594	.	C	A	1	4	5	0	0	5	0	0
1	22483676	.	A	C	1	5	6	0	0	6	0	0
1	22483835	.	C	A	3	8	11	0	0	11	0	0
1	22483955	.	A	G	3	4	7	0	0	7	0	0
1	22484015	.	A	T	4	2	6	0	0	6	0	0
1	22484152	.	A	T	2	3	5	0	1	6	0	0
1	22484156	.	T	G	1	3	4	0	0	4	0	0
1	22484544	.	C	A	8	3	11	0	1	12	0	0
1	22490234	.	C	A	2	7	9	0	0	9	0	0
1	22490402	.	C	T	3	6	9	0	0	9	0	0
1	22490565	.	C	T	0	4	4	0	6	10	0	0
1	22490660	.	G	A	4	5	9	0	1	10	0	0
1	22490795	.	C	T	1	4	5	0	4	9	0	0
1	22490897	.	G	A	5	2	7	0	0	7	0	0
1	22546729	.	G	A	2	2	4	0	0	4	0	0
1	22647772	.	T	C	2	4	6	0	5	11	0	0
1	22647844	.	C	A	24	15	39	0	1	40	0	0
1	22647852	.	T	A	26	9	35	0	3	38	0	0
1	22664852	.	T	G	2	3	5	0	0	5	0	0
1	22806156	.	T	C	11	11	22	0	1	23	0	0
1	23283065	.	G	C	8	6	14	0	0	14	0	0
1	23283287	.	A	T	3	3	6	0	0	6	0	0
1	23283295	.	G	A	3	2	5	0	0	5	0	0
1	23297750	.	A	G	3	3	6	0	1	7	0	0
1	23298010	.	A	T	3	4	7	0	1	8	0	0
1	23298081	.	G	A	3	2	5	0	1	6	0	0
1	23298494	.	T	C	7	9	16	0	0	16	0	0
1	23301687	.	A	T	9	4	13	0	1	14	0	0
1	23311756	.	T	A	3	3	6	0	0	6	0	0
1	23311959	.	A	G	5	0	5	0	3	8	0	0
1	23312029	.	G	A	11	14	25	0	0	25	0	0
1	23321770	.	G	T	13	13	26	0	0	26	0	0
1	23322076	.	T	C	8	12	20	1	1	22	0	0
1	23322442	.	C	T	27	14	41	0	0	41	0	0
1	23322473	.	T	C	20	18	38	0	1	39	0	0
1	23322501	.	C	T	17	16	33	0	3	36	0	0
1	23322602	.	T	A	16	7	23	0	0	23	0	0
1	23322659	.	T	A	12	15	27	0	3	30	0	0
1	23322937	.	G	A	1	5	6	0	8	14	0	0
1	23323611	.	T	C	8	0	8	2	3	13	0	0
1	23323622	.	T	G	10	8	18	2	0	21	1	0
1	23330118	.	A	G	9	16	25	0	1	26	0	0
1	23332456	.	T	C	3	8	11	0	0	11	0	0
1	23332462	.	C	T	3	7	10	0	1	11	0	0
1	23337716	.	A	G	1	6	7	0	1	8	0	0
1	23341207	.	T	C	5	0	5	0	2	7	0	0
1	23343024	.	A	G	2	2	4	0	0	4	0	0
1	23343744	.	C	T	0	2	2	0	1	3	0	0
1	23343866	.	A	G	1	2	3	0	1	4	0	0
1	23373581	.	G	A	2	3	5	0	0	5	0	0
1	23376721	.	G	T	1	2	3	0	0	3	0	0
1	23376825	.	A	T	1	2	3	0	0	3	0	0
1	23377676	.	C	T	2	2	4	0	0	4	0	0
1	23388325	.	C	T	4	4	8	0	0	8	0	0
1	23390453	.	C	T	2	2	4	0	0	4	0	0
1	23393317	.	T	A	1	2	3	0	0	3	0	0
1	23395760	.	T	A	1	2	3	0	0	3	0	0
1	23506660	.	C	A	12	11	23	0	0	23	0	0
1	23506674	.	C	T	10	12	22	0	0	22	0	0
1	23506711	.	A	T	6	8	14	1	4	19	0	0
1	23506865	.	C	A	24	19	43	0	1	44	0	0
1	23515748	.	T	G	18	25	43	0	1	44	0	0
1	23521634	.	G	T	21	18	39	0	1	40	0	0
1	23522528	.	C	T	14	14	28	0	2	30	0	0
1	23573760	.	C	T	10	6	16	0	0	16	0	0
1	23573814	.	A	C	7	11	18	0	0	18	0	0
1	23573823	.	A	T	9	10	19	0	0	19	0	0
1	23573921	.	G	A	4	5	9	0	1	10	0	0
1	23574003	.	C	A	2	3	5	0	0	5	0	0
1	23578157	.	C	T	2	5	7	0	0	7	0	0
1	23578196	.	A	T	6	4	10	0	1	11	0	0
1	23578514	.	C	T	2	2	4	0	0	4	0	0
1	23578651	.	C	T	1	4	5	0	0	5	0	0
1	23578839	.	A	C	1	5	6	0	0	6	0	0
1	23579438	.	T	C	2	4	6	0	0	6	0	0
1	23579592	.	T	G	1	2	3	0	0	3	0	0
1	23580700	.	G	A	1	3	4	0	0	4	0	0
1	23581097	.	T	A	2	2	4	0	0	4	0	0
1	23581198	.	C	T	2	3	5	0	0	5	0	0
1	23581960	.	T	G	2	2	4	0	0	4	0	0
1	23585190	.	C	A	5	2	7	0	0	7	0	0
1	23585338	.	G	A	2	2	4	0	0	4	0	0
1	23585802	.	C	A	1	6	7	0	6	13	0	0
1	23586133	.	A	G	4	4	8	0	0	8	0	0
1	23586581	.	G	A	5	5	10	0	0	10	0	0
1	23898014	.	G	A	2	4	6	0	1	7	0	0
1	23902973	.	G	A	4	6	10	0	0	10	0	0
1	23909090	.	A	G	14	10	24	0	0	24	0	0
1	23909522	.	A	C	5	7	12	0	0	13	1	0
1	23921071	.	A	T	12	13	25	0	2	27	0	0
1	23921166	.	C	A	9	12	21	0	2	23	0	0
1	23921171	.	G	A	7	14	21	0	2	23	0	0
1	23921284	.	T	C	6	6	12	0	0	12	0	0
1	23921427	.	T	C	5	0	5	0	5	10	0	0
1	23921564	.	T	A	10	3	13	0	0	13	0	0
1	23936154	.	C	T	7	6	13	0	0	13	0	0
1	23943609	.	A	T	8	9	17	0	0	17	0	0
1	23975387	.	G	T	2	2	4	0	1	5	0	0
1	24023560	.	T	C	4	2	6	0	0	6	0	0
1	24045920	.	G	T	1	4	5	0	1	6	0	0
1	24045977	.	T	G	3	5	8	0	0	8	0	0
1	24076445	.	T	C	5	5	10	0	0	10	0	0
1	24076890	.	A	G	3	14	17	0	1	18	0	0
1	24077274	.	A	G	18	2	20	0	11	31	0	0
1	24077517	.	C	T	13	19	32	0	3	35	0	0
1	24077791	.	G	A	2	16	18	1	16	35	0	0
1	24081190	.	G	C	2	3	5	0	1	6	0	0
1	24227870	.	G	T	2	2	4	0	0	4	0	0
1	24227872	.	C	T	1	2	3	0	1	4	0	0
1	24356734	.	T	C	34	23	57	0	0	57	0	0
1	24357931	.	C	T	38	31	69	0	6	75	0	0
1	24503620	.	G	T	0	2	2	0	1	3	0	0
1	24513955	.	T	C	2	3	5	0	1	6	0	0
1	24520592	.	A	G	4	2	6	0	0	6	0	0
1	24520614	.	T	G	3	2	5	0	0	5	0	0
1	24520759	.	T	C	3	2	5	0	0	5	0	0
1	24520818	.	G	A	3	3	6	0	0	6	0	0
1	24520823	.	T	C	2	4	6	0	0	6	0	0
1	24521032	.	C	T	2	3	5	0	0	5	0	0
1	24557605	.	A	G	11	4	15	0	2	17	0	0
1	24558336	.	C	G	3	4	7	0	0	7	0	0
1	24558368	.	G	A	7	3	10	0	0	10	0	0
1	24558375	.	G	A	10	3	13	0	0	13	0	0
1	24558410	.	T	A	3	9	12	0	0	12	0	0
1	24902778	.	T	C	5	0	5	0	3	8	0	0
1	25024060	.	T	C	3	0	3	0	5	8	0	0
1	25144290	.	A	C	1	0	1	0	7	8	0	0
1	25296797	.	C	T	7	10	17	0	0	17	0	0
1	25296831	.	C	T	7	6	13	0	3	16	0	0
1	25305290	.	A	T	8	5	13	0	3	16	0	0
1	25305446	.	T	G	8	1	9	0	8	17	0	0
1	25310899	.	C	A	12	6	18	0	0	18	0	0
1	25310912	.	T	A	7	8	15	0	2	17	0	0
1	25313056	.	C	T	10	15	25	0	1	26	0	0
1	25313261	.	T	C	17	13	30	0	2	32	0	0
1	25313300	.	G	A	1	10	11	0	19	30	0	0
1	25313482	.	T	A	18	11	29	0	3	32	0	0
1	25322572	.	T	A	2	3	5	0	1	6	0	0
1	25327231	.	A	G	4	5	9	0	0	9	0	0
1	25331494	.	C	T	2	2	4	0	0	4	0	0
1	25336507	.	C	A	1	2	3	0	0	3	0	0
1	25399528	.	A	C	2	3	5	0	1	6	0	0
1	25399556	.	G	A	1	4	5	0	0	5	0	0
1	25399617	.	T	A	2	3	5	0	0	5	0	0
1	25399621	.	A	T	2	3	5	0	0	5	0	0
1	25399652	.	T	C	1	2	3	0	0	3	0	0
1	25400017	.	A	G	6	6	12	0	1	13	0	0
1	25400032	.	C	T	1	4	5	0	6	11	0	0
1	25400247	.	C	T	4	1	5	0	2	7	0	0
1	25401181	.	G	A	4	5	9	0	0	9	0	0
1	25401635	.	G	A	5	3	8	0	0	8	0	0
1	25401638	.	T	A	3	5	8	0	0	8	0	0
1	25401756	.	A	G	3	8	11	0	0	11	0	0
1	25401984	.	T	C	3	7	10	0	0	10	0	0
1	25402044	.	T	A	5	5	10	0	0	10	0	0
1	25402229	.	T	C	3	2	5	0	0	5	0	0
1	25402260	.	A	G	2	2	4	0	0	4	0	0
1	25402695	.	C	T	1	3	4	0	0	4	0	0
1	25403289	.	T	C	2	4	6	0	0	6	0	0
1	25438705	.	G	A	1	2	3	0	0	3	0	0
1	25654630	.	C	A	2	2	4	0	0	4	0	0
1	25660719	.	C	T	2	5	7	0	1	8	0	0
1	25666097	.	G	T	0	4	4	0	0	4	0	0
1	25666109	.	C	T	2	3	5	0	1	6	0	0
1	25743046	.	G	C	2	2	4	0	0	4	0	0
1	25798792	.	T	A	10	3	13	0	0	13	0	0
1	25798863	.	G	C	4	9	13	0	0	13	0	0
1	25798983	.	A	C	3	3	6	0	0	6	0	0
1	25803617	.	C	T	2	2	4	0	0	4	0	0
1	25811411	.	T	C	4	3	7	0	1	8	0	0
1	25812658	.	C	T	4	7	11	0	0	11	0	0
1	25863530	.	G	A	9	4	13	0	1	14	0	0
1	25863638	.	A	T	7	10	17	0	0	17	0	0
1	26012748	.	G	T	2	2	4	0	0	4	0	0
1	26012755	.	G	A	1	2	3	0	0	3	0	0
1	26012936	.	C	T	6	3	9	0	0	9	0	0
1	26046950	.	T	A	8	8	16	1	1	18	0	0
1	26095428	.	G	T	4	2	6	0	2	8	0	0
1	26096318	.	A	T	6	1	7	0	0	7	0	0
1	26096488	.	G	C	11	6	17	0	0	17	0	0
1	26106888	.	G	A	1	3	4	0	0	4	0	0
1	26108222	.	G	A	1	2	3	0	0	3	0	0
1	26127856	.	A	T	12	19	31	0	1	32	0	0
1	26252153	.	A	T	1	3	4	0	0	4	0	0
1	26252215	.	T	C	7	4	11	0	0	11	0	0
1	26252308	.	G	C	1	4	5	0	1	6	0	0
1	26252477	.	G	A	3	7	10	0	2	12	0	0
1	26252877	.	G	A	6	2	8	0	0	8	0	0
1	26252931	.	A	T	4	4	8	0	1	9	0	0
1	26293167	.	C	T	0	5	5	0	1	6	0	0
1	26374612	.	A	T	5	3	8	0	0	8	0	0
1	26375497	.	G	T	7	7	14	0	0	14	0	0
1	26375733	.	G	A	1	5	6	0	3	9	0	0
1	26377694	.	C	T	4	2	6	0	0	6	0	0
1	26382852	.	C	T	6	14	20	0	1	21	0	0
1	26382853	.	C	T	7	14	21	0	1	22	0	0
1	26383281	.	G	T	0	9	9	0	5	14	0	0
1	26383553	.	T	G	4	13	17	0	3	20	0	0
1	26384721	.	A	G	5	6	11	0	0	11	0	0
1	26384779	.	C	A	4	5	9	0	0	9	0	0
1	26385222	.	C	G	5	7	12	0	0	12	0	0
1	26385939	.	A	G	8	9	17	0	0	17	0	0
1	26391698	.	A	G	2	5	7	0	2	9	0	0
1	26391720	.	A	G	1	4	5	0	0	5	0	0
1	26438684	.	C	T	2	3	5	0	1	6	0	0
1	26438749	.	G	T	4	4	8	0	0	8	0	0
1	26438894	.	C	T	1	6	7	0	10	17	0	0
1	26438909	.	A	G	9	7	16	0	0	16	0	0
1	26439131	.	T	C	9	0	9	0	4	13	0	0
1	26453698	.	C	G	8	4	12	0	0	12	0	0
1	26463208	.	C	G	15	6	21	0	0	21	0	0
1	26463263	.	G	A	1	11	12	0	5	17	0	0
1	26463488	.	T	G	5	0	5	0	5	10	0	0
1	26463552	.	A	G	9	1	10	0	3	13	0	0
1	26463692	.	C	T	9	7	16	0	0	16	0	0
1	26463878	.	C	A	5	7	12	0	0	12	0	0
1	26464003	.	C	T	11	7	18	1	5	24	0	0
1	26464175	.	G	A	5	2	7	0	1	8	0	0
1	26464259	.	C	T	6	2	8	3	1	12	0	0
1	26464446	.	G	A	11	5	16	0	2	18	0	0
1	26465047	.	A	C	11	7	18	0	2	20	0	0
1	26465218	.	G	T	1	8	9	0	12	21	0	0
1	26467953	.	A	C	3	3	6	0	0	6	0	0
1	26476553	.	T	A	2	4	6	0	0	6	0	0
1	26480970	.	G	C	0	8	8	0	3	11	0	0
1	26489854	.	G	A	3	7	10	0	1	11	0	0
1	26498400	.	C	T	11	11	22	0	0	22	0	0
1	26498657	.	G	A	1	11	12	0	10	22	0	0
1	26507270	.	A	C	13	6	19	0	1	20	0	0
1	26507356	.	G	A	4	16	20	0	0	20	0	0
1	26507582	.	G	A	10	8	18	0	1	19	0	0
1	26649095	.	A	T	4	5	9	0	0	9	0	0
1	26654154	.	A	T	2	2	4	0	0	4	0	0
1	26660660	.	C	T	0	12	12	0	10	22	0	0
1	26661084	.	G	A	24	17	41	1	1	43	0	0
1	26661516	.	G	A	15	16	31	0	1	32	0	0
1	26663204	.	C	T	0	7	7	0	0	7	0	0
1	26663278	.	C	T	1	2	3	0	0	3	0	0
1	26671975	.	G	A	1	3	4	0	0	4	0	0
1	26671976	.	T	A	0	3	3	0	0	3	0	0
1	26698440	.	C	T	5	2	7	0	0	7	0	0
1	26740966	.	T	C	26	28	54	1	2	57	0	0
1	26741410	.	C	T	29	18	47	0	2	49	0	0
1	27207986	.	A	G	13	0	13	0	10	23	0	0
1	27208553	.	T	A	6	7	13	0	1	14	0	0
1	27209628	.	A	C	4	5	9	0	0	9	0	0
1	27209904	.	T	G	6	11	17	0	0	17	0	0
1	27210057	.	T	C	6	7	13	0	1	14	0	0
1	27210073	.	T	C	6	3	9	0	0	9	0	0
1	27210578	.	G	A	7	5	12	0	0	12	0	0
1	27210929	.	C	T	13	14	27	0	0	27	0	0
1	27211573	.	G	A	2	2	4	0	0	4	0	0
1	27809162	.	T	C	6	6	12	0	2	14	0	0
1	27809198	.	T	A	6	6	12	0	1	13	0	0
1	27809381	.	C	T	9	5	14	0	0	14	0	0
1	27842373	.	G	A	2	16	18	0	15	33	0	0
1	27860743	.	T	A	6	10	16	0	0	16	0	0
1	27868306	.	T	C	1	4	5	0	0	5	0	0
1	27893097	.	T	C	14	6	20	0	1	21	0	0
1	27893139	.	C	A	5	10	15	0	0	15	0	0
1	27893237	.	C	A	4	2	6	0	0	6	0	0
1	27993191	.	A	G	8	0	8	0	9	17	0	0
1	27995605	.	C	T	13	12	25	0	1	26	0	0
1	28018806	.	C	T	20	12	32	0	2	34	0	0
1	28018988	.	T	A	4	5	9	0	0	9	0	0
1	28035786	.	C	T	1	5	6	0	0	6	0	0
1	28046218	.	T	C	14	18	32	0	0	32	0	0
1	28046224	.	A	G	17	2	19	0	17	36	0	0
1	28046717	.	T	A	1	2	3	0	0	3	0	0
1	28081318	.	C	T	4	6	10	0	0	10	0	0
1	28089545	.	G	A	7	5	12	0	0	12	0	0
1	28391882	.	C	G	8	7	15	0	0	15	0	0
1	28391914	.	C	T	2	7	9	0	3	12	0	0
1	28422549	.	G	T	11	4	15	0	3	18	0	0
1	28422569	.	C	T	4	8	12	0	2	15	1	0
1	28428603	.	A	G	3	6	9	0	0	9	0	0
1	28724010	.	G	T	2	2	4	0	0	4	0	0
1	28808541	.	T	C	2	5	7	0	0	7	0	0
1	28831835	.	A	G	1	2	3	0	0	3	0	0
1	28835669	.	T	C	2	8	10	0	0	10	0	0
1	28847677	.	C	T	1	12	13	0	9	22	0	0
1	28860619	.	G	A	13	9	22	0	0	22	0	0
1	28860730	.	A	T	6	12	18	0	0	18	0	0
1	28861096	.	T	G	9	7	16	0	0	16	0	0
1	28874819	.	C	T	5	4	9	0	0	9	0	0
1	28899350	.	G	A	6	2	8	0	0	8	0	0
1	28899483	.	G	A	2	2	4	0	0	4	0	0
1	28900661	.	A	G	2	2	4	0	0	4	0	0
1	28961846	.	C	T	36	20	56	0	5	61	0	0
1	28962332	.	G	C	5	0	5	0	10	15	0	0
1	28962501	.	C	T	3	21	24	0	31	55	0	0
1	28962545	.	A	G	34	12	46	1	3	50	0	0
1	28962556	.	A	C	36	8	44	1	1	46	0	0
1	28962598	.	C	T	29	17	46	0	3	49	0	0
1	28962966	.	G	A	28	29	57	0	3	60	0	0
1	28986486	.	C	T	8	8	16	0	0	16	0	0
1	28986532	.	G	A	10	6	16	0	1	17	0	0
1	29045226	.	G	A	12	9	21	0	3	24	0	0
1	29141285	.	C	T	2	2	4	0	0	4	0	0
1	29162589	.	A	G	9	4	13	0	1	14	0	0
1	29163687	.	G	A	4	7	11	0	1	12	0	0
1	29163737	.	C	T	7	4	11	0	0	11	0	0
1	29163941	.	G	T	2	2	4	0	0	4	0	0
1	29184190	.	A	G	3	2	5	0	0	5	0	0
1	29184205	.	A	G	3	3	6	0	0	6	0	0
1	29190408	.	C	T	4	3	7	0	0	7	0	0
1	29201933	.	G	C	8	9	17	1	0	18	0	0
1	29202110	.	T	C	8	9	17	0	0	17	0	0
1	29202368	.	G	A	3	10	13	0	0	13	0	0
1	29202379	.	A	G	2	1	3	0	7	10	0	0
1	29211636	.	T	C	4	2	6	0	0	6	0	0
1	29212341	.	G	A	2	3	5	0	0	5	0	0
1	29227642	.	T	A	12	6	18	0	1	19	0	0
1	29228390	.	A	T	8	3	11	0	1	12	0	0
1	29270934	.	A	C	0	3	3	0	0	3	0	0
1	29270942	.	C	T	2	1	3	0	1	4	0	0
1	29281974	.	C	G	3	4	7	0	0	7	0	0
1	29282145	.	C	T	2	2	4	0	1	5	0	0
1	29282175	.	A	C	3	2	5	0	1	6	0	0
1	29608207	.	G	A	2	3	5	0	0	5	0	0
1	29608704	.	G	T	2	2	4	0	0	4	0	0
1	29731965	.	T	G	4	5	9	0	0	9	0	0
1	29737972	.	A	C	1	2	3	0	0	3	0	0
1	29739670	.	T	A	4	6	10	0	0	10	0	0
1	29741054	.	C	T	8	9	17	0	0	17	0	0
1	29741193	.	T	A	9	4	13	0	1	14	0	0
1	29741447	.	C	T	7	8	15	0	1	16	0	0
1	29741952	.	C	T	12	13	25	0	1	26	0	0
1	29741967	.	A	G	11	12	23	0	5	28	0	0
1	29742036	.	C	T	12	12	24	0	1	25	0	0
1	29742368	.	T	C	9	6	15	0	2	17	0	0
1	29742487	.	T	C	5	6	11	0	0	11	0	0
1	29742791	.	A	T	12	8	20	1	0	21	0	0
1	29742796	.	A	G	14	0	14	1	10	25	0	0
1	29743087	.	G	A	10	10	20	0	1	21	0	0
1	29743165	.	A	G	10	13	23	0	1	24	0	0
1	29743178	.	T	C	10	13	23	0	1	24	0	0
1	29743281	.	T	C	11	10	21	0	0	21	0	0
1	29743423	.	T	G	8	15	23	0	1	24	0	0
1	29743505	.	A	G	5	8	13	0	0	13	0	0
1	29743710	.	A	C	3	2	5	0	1	6	0	0
1	29743727	.	G	T	3	2	5	0	0	5	0	0
1	29743814	.	A	T	1	3	4	0	0	4	0	0
1	29743878	.	G	A	4	4	8	0	0	8	0	0
1	29751529	.	T	G	2	6	8	0	0	8	0	0
1	29752319	.	T	C	8	4	12	0	1	13	0	0
1	29752421	.	A	G	9	4	13	0	0	13	0	0
1	29754673	.	A	G	3	7	10	0	0	10	0	0
1	29758042	.	G	A	5	5	10	0	0	10	0	0
1	29770360	.	T	A	5	4	9	0	3	12	0	0
1	29770748	.	A	C	2	3	5	0	0	5	0	0
1	29772751	.	G	T	8	4	12	0	1	13	0	0
1	29775664	.	C	A	8	3	11	0	2	13	0	0
1	29779300	.	G	C	10	4	14	0	0	14	0	0
1	29779402	.	G	A	0	5	5	0	4	9	0	0
1	29781462	.	G	A	16	8	24	0	1	25	0	0
1	29786407	.	G	C	0	7	7	0	11	18	0	0
1	29787262	.	T	C	9	11	20	0	0	20	0	0
1	29790030	.	A	T	17	17	34	0	3	37	0	0
1	29795692	.	G	A	16	9	25	0	1	26	0	0
1	29797191	.	T	C	14	13	27	0	1	28	0	0
1	29797387	.	A	C	12	10	22	0	0	22	0	0
1	29797674	.	G	A	7	3	10	0	0	10	0	0
1	29804658	.	A	T	5	3	8	0	0	8	0	0
1	29804682	.	A	G	3	4	7	0	1	8	0	0
1	29813246	.	C	A	9	7	16	0	1	17	0	0
1	29813276	.	C	T	13	4	17	0	2	19	0	0
1	29817451	.	C	A	11	11	22	0	1	23	0	0
1	29820831	.	C	T	15	24	39	0	1	40	0	0
1	29823603	.	T	C	10	18	28	0	2	30	0	0
1	29823604	.	G	A	10	19	29	0	1	30	0	0
1	29823701	.	A	G	14	24	38	0	7	45	0	0
1	29858127	.	G	T	1	2	3	0	0	3	0	0
1	30978469	.	T	C	5	2	7	0	0	7	0	0
1	32385419	.	T	A	7	2	9	0	0	9	0	0
1	32385420	.	T	A	3	4	7	0	2	9	0	0
1	33282249	.	A	G	2	2	4	0	0	4	0	0
1	33569139	.	C	T	1	6	7	0	0	7	0	0
1	33569143	.	G	A	0	5	5	0	1	6	0	0
1	33662869	.	G	A	5	6	11	0	2	13	0	0
1	33662872	.	T	A	8	1	9	0	0	9	0	0
1	34233301	.	A	G	7	0	7	0	6	13	0	0
1	35484297	.	C	T	1	7	8	0	2	10	0	0
1	35484844	.	A	G	1	5	6	0	0	6	0	0
1	36020092	.	A	T	2	8	10	0	4	14	0	0
1	36740427	.	A	G	3	0	3	0	2	5	0	0
1	37083876	.	G	A	1	4	5	0	1	6	0	0
1	37195941	.	T	A	2	2	4	0	1	5	0	0
1	37195950	.	G	A	2	3	5	0	0	5	0	0
1	37196220	.	T	A	4	2	6	0	0	6	0	0
1	37196228	.	A	G	2	3	5	0	0	5	0	0
1	37284382	.	C	T	6	6	12	0	0	12	0	0
1	37287291	.	A	T	14	9	23	0	2	25	0	0
1	37287294	.	G	A	12	8	20	0	4	24	0	0
1	37291884	.	A	C	8	8	16	0	0	16	0	0
1	37304354	.	C	A	12	14	26	0	1	27	0	0
1	37304439	.	C	T	13	12	25	0	0	25	0	0
1	37304494	.	T	A	17	15	32	0	1	33	0	0
1	37304510	.	T	G	21	12	33	0	3	36	0	0
1	37304536	.	G	A	17	14	31	0	0	31	0	0
1	37304929	.	G	A	5	9	14	0	3	17	0	0
1	37305148	.	C	T	7	6	13	0	1	14	0	0
1	37306726	.	G	T	2	17	19	0	16	35	0	0
1	37306913	.	T	A	15	15	30	0	0	30	0	0
1	37306942	.	A	C	11	17	28	0	1	29	0	0
1	37339689	.	T	C	2	3	5	0	0	5	0	0
1	37339817	.	G	T	2	3	5	0	0	5	0	0
1	37344832	.	T	C	5	5	10	1	0	11	0	0
1	37350473	.	T	A	4	2	6	0	2	8	0	0
1	37355606	.	C	T	2	5	7	0	1	8	0	0
1	37359071	.	C	T	5	5	10	0	0	10	0	0
1	37359221	.	G	C	6	7	13	0	0	13	0	0
1	37359352	.	A	G	5	5	10	0	1	11	0	0
1	37361554	.	A	G	8	4	12	0	0	12	0	0
1	37361759	.	C	T	15	7	22	0	3	25	0	0
1	37361919	.	T	C	4	4	8	0	1	9	0	0
1	37361960	.	C	T	2	6	8	0	0	8	0	0
1	37752392	.	A	G	3	0	3	0	3	6	0	0
1	37752478	.	G	C	1	3	4	0	0	4	0	0
1	37753024	.	G	A	5	5	10	0	0	10	0	0
1	38125431	.	C	A	9	14	23	0	1	24	0	0
1	38125684	.	T	C	9	19	28	0	1	29	0	0
1	38131058	.	C	T	19	12	31	0	1	32	0	0
1	38131073	.	T	C	11	15	26	0	0	26	0	0
1	38131094	.	G	A	17	8	25	0	0	25	0	0
1	38131288	.	G	A	24	12	36	0	2	38	0	0
1	38131360	.	G	A	22	27	49	0	0	49	0	0
1	38131486	.	G	A	18	15	33	1	1	35	0	0
1	38131812	.	T	C	3	3	6	0	1	7	0	0
1	38146192	.	G	T	8	2	10	0	0	10	0	0
1	38150605	.	A	C	7	6	13	0	1	14	0	0
1	38163017	.	C	T	20	17	37	0	1	38	0	0
1	38163132	.	G	A	23	17	40	0	3	43	0	0
1	38166009	.	G	C	7	5	12	0	1	13	0	0
1	38166268	.	A	C	17	19	36	0	2	38	0	0
1	38166429	.	T	C	23	19	42	0	2	44	0	0
1	38166431	.	T	G	25	20	45	0	0	45	0	0
1	38166520	.	A	G	15	20	35	0	1	36	0	0
1	38169771	.	T	A	9	2	11	0	3	14	0	0
1	38169972	.	T	G	20	12	32	0	0	32	0	0
1	38170553	.	G	A	14	16	30	0	0	30	0	0
1	38346162	.	C	T	0	5	5	4	6	16	1	0
1	38346578	.	G	T	3	5	8	0	0	8	0	0
1	38346649	.	C	T	0	4	4	0	4	8	0	0
1	38346739	.	G	A	6	6	12	0	0	12	0	0
1	38354049	.	G	A	6	4	10	0	0	10	0	0
1	38416352	.	G	C	4	3	7	0	0	7	0	0
1	38416477	.	G	A	7	4	11	0	0	11	0	0
1	38416536	.	A	G	4	5	9	1	0	10	0	0
1	38417116	.	A	T	4	3	7	0	0	7	0	0
1	38417229	.	G	A	5	10	15	0	1	16	0	0
1	38417268	.	A	T	17	7	24	0	1	25	0	0
1	38417332	.	A	G	6	11	17	0	0	17	0	0
1	38417370	.	G	A	9	9	18	0	0	18	0	0
1	38417531	.	G	T	7	5	12	0	1	13	0	0
1	38417588	.	T	G	6	6	12	0	1	13	0	0
1	38417617	.	A	T	7	4	11	0	0	11	0	0
1	38417625	.	A	T	6	5	11	0	1	12	0	0
1	38417680	.	T	A	4	2	6	0	0	6	0	0
1	38418087	.	C	T	3	5	8	0	1	9	0	0
1	38418243	.	A	G	8	6	14	0	0	15	1	0
1	38418294	.	G	T	8	8	16	0	0	16	0	0
1	38466714	.	G	A	1	5	6	0	0	6	0	0
1	38649340	.	A	G	45	26	71	0	2	73	0	0
1	38649947	.	G	A	40	31	71	0	1	72	0	0
1	38650132	.	G	T	40	26	66	0	0	66	0	0
1	38650298	.	G	A	25	30	55	0	1	56	0	0
1	38650382	.	G	C	28	34	62	0	5	67	0	0
1	38650467	.	A	G	30	32	62	0	3	65	0	0
1	38650545	.	T	C	38	36	74	0	2	76	0	0
1	38651063	.	G	T	49	22	71	0	1	72	0	0
1	38651065	.	T	A	49	21	70	0	2	73	1	0
1	38651361	.	C	T	11	19	30	0	1	31	0	0
1	38651370	.	G	A	10	21	31	0	3	34	0	0
1	38651469	.	C	A	15	26	41	0	1	42	0	0
1	38651822	.	G	A	12	10	22	0	0	22	0	0
1	38655522	.	C	T	3	21	24	2	39	65	0	0
1	38657689	.	G	A	37	23	60	0	2	62	0	0
1	38660240	.	T	C	37	1	38	0	21	59	0	0
1	38660252	.	A	G	33	27	60	0	0	60	0	0
1	38660369	.	G	A	26	23	49	0	2	51	0	0
1	38709351	.	A	C	9	0	9	1	3	13	0	0
1	38709381	.	G	C	9	5	14	1	0	15	0	0
1	38709480	.	G	A	4	6	10	0	2	12	0	0
1	38709535	.	T	A	5	7	12	0	0	12	0	0
1	38787039	.	C	T	2	2	4	0	0	4	0	0
1	38791569	.	C	T	10	11	21	0	0	21	0	0
1	38793983	.	G	A	9	3	12	0	0	12	0	0
1	38797663	.	A	C	12	11	23	0	0	23	0	0
1	38799513	.	G	A	8	13	21	0	2	23	0	0
1	38799585	.	A	G	17	10	27	0	2	29	0	0
1	38799588	.	T	A	11	13	24	0	3	27	0	0
1	38802537	.	G	A	7	17	24	0	0	24	0	0
1	38802703	.	A	G	12	17	29	0	0	29	0	0
1	38802718	.	G	A	20	9	29	0	2	31	0	0
1	38802747	.	A	G	16	1	17	0	10	27	0	0
1	38802855	.	C	A	6	11	17	0	0	17	0	0
1	38803033	.	T	C	11	3	14	0	0	14	0	0
1	38803042	.	A	C	10	3	13	0	1	14	0	0
1	38803092	.	C	T	8	3	11	2	0	13	0	0
1	38803127	.	C	T	10	8	18	2	0	20	0	0
1	38803154	.	T	A	12	8	20	0	2	22	0	0
1	38803205	.	A	T	13	7	20	0	1	21	0	0
1	38803404	.	A	G	11	10	21	0	1	22	0	0
1	38805128	.	G	T	5	5	10	0	2	12	0	0
1	38805135	.	C	T	7	3	10	0	2	12	0	0
1	38805439	.	G	A	11	17	28	0	1	29	0	0
1	38805450	.	A	G	14	11	25	0	3	28	0	0
1	38805506	.	G	A	11	20	31	0	0	31	0	0
1	38807255	.	G	C	13	8	21	0	1	22	0	0
1	38808259	.	C	A	9	9	18	0	1	19	0	0
1	38808379	.	C	T	0	5	5	0	7	12	0	0
1	38808723	.	T	A	7	7	14	0	0	14	0	0
1	38810061	.	T	G	5	5	10	0	0	10	0	0
1	38820219	.	G	A	0	5	5	0	11	16	0	0
1	38822092	.	A	T	5	7	12	0	0	12	0	0
1	38851111	.	C	T	0	3	3	0	3	6	0	0
1	39680794	.	C	A	1	3	4	0	0	4	0	0
1	39724761	.	G	A	2	3	5	0	0	5	0	0
1	39732544	.	C	T	3	1	4	0	1	5	0	0
1	39735491	.	T	C	2	7	9	0	1	10	0	0
1	39770416	.	C	T	6	8	14	0	0	14	0	0
1	39771429	.	T	A	10	8	18	0	0	18	0	0
1	39772010	.	T	C	5	8	13	0	0	13	0	0
1	39772042	.	A	G	9	5	14	0	0	14	0	0
1	39772135	.	C	A	8	12	20	0	0	20	0	0
1	39772225	.	C	T	11	13	24	0	1	25	0	0
1	39774096	.	C	T	7	6	13	0	0	13	0	0
1	39774225	.	C	T	8	14	22	0	0	22	0	0
1	39774363	.	G	A	7	8	15	0	0	15	0	0
1	39774618	.	A	G	14	4	18	0	0	18	0	0
1	39774690	.	A	G	7	6	13	0	2	15	0	0
1	39774727	.	C	A	8	7	15	0	3	18	0	0
1	39774891	.	C	T	17	8	25	0	0	25	0	0
1	39774915	.	G	A	8	16	24	0	2	26	0	0
1	39775089	.	C	T	8	8	16	0	1	17	0	0
1	39775227	.	C	T	8	14	22	0	1	23	0	0
1	39776356	.	A	C	16	22	38	0	0	38	0	0
1	39777089	.	G	A	17	9	26	0	2	28	0	0
1	39777836	.	G	A	0	11	11	0	16	27	0	0
1	39777975	.	A	T	18	8	26	0	1	27	0	0
1	39778047	.	A	G	12	2	14	0	14	28	0	0
1	39778075	.	T	G	20	13	33	0	0	33	0	0
1	39778332	.	G	C	28	23	51	0	0	51	0	0
1	39778661	.	G	A	15	12	27	0	2	29	0	0
1	39778663	.	G	A	16	12	28	0	0	28	0	0
1	39778949	.	G	C	19	19	38	0	1	39	0	0
1	39779225	.	G	C	7	8	15	0	1	16	0	0
1	39779468	.	A	T	6	7	13	0	1	14	0	0
1	39869860	.	T	A	3	2	5	1	0	6	0	0
1	39869974	.	G	A	4	2	6	0	0	6	0	0
1	39870008	.	T	C	3	3	6	0	0	6	0	0
1	39879560	.	T	C	2	3	5	0	0	5	0	0
1	39882764	.	A	T	3	4	7	0	0	7	0	0
1	39882899	.	A	G	5	6	11	0	0	11	0	0
1	39882906	.	T	A	7	5	12	0	0	12	0	0
1	39891915	.	G	A	1	2	3	0	0	3	0	0
1	39899477	.	G	C	17	19	36	0	0	36	0	0
1	39899494	.	A	G	26	16	42	0	1	43	0	0
1	39899663	.	G	A	24	20	44	0	3	47	0	0
1	39900056	.	G	A	15	34	49	0	0	49	0	0
1	39900129	.	G	A	27	26	53	0	2	55	0	0
1	39900137	.	G	T	26	26	52	0	0	52	0	0
1	39900360	.	G	A	16	12	28	0	3	31	0	0
1	39900432	.	C	T	2	21	23	0	8	31	0	0
1	39900750	.	C	T	2	13	15	0	8	23	0	0
1	39901269	.	G	A	5	8	13	0	1	14	0	0
1	39901378	.	T	A	7	11	18	0	0	18	0	0
1	39901500	.	T	C	4	9	13	0	0	13	0	0
1	39901501	.	G	A	4	9	13	0	0	13	0	0
1	39901729	.	T	C	20	0	20	0	16	36	0	0
1	39907291	.	A	C	6	8	14	0	0	14	0	0
1	39907492	.	T	C	24	0	24	0	13	37	0	0
1	39907611	.	C	T	1	9	10	0	5	15	0	0
1	39908047	.	G	A	11	11	22	0	2	24	0	0
1	39908680	.	C	T	9	6	15	0	0	15	0	0
1	39908854	.	A	G	12	13	25	0	1	26	0	0
1	39908881	.	C	T	8	12	20	0	0	20	0	0
1	39908926	.	A	G	7	9	16	0	1	17	0	0
1	39909003	.	A	T	11	13	24	0	4	28	0	0
1	39909247	.	A	T	15	12	27	0	1	28	0	0
1	39909274	.	A	T	16	12	28	0	2	30	0	0
1	39995100	.	C	T	10	9	19	0	0	19	0	0
1	39998875	.	G	A	7	9	16	0	1	17	0	0
1	40001853	.	A	T	12	10	22	0	1	23	0	0
1	40001873	.	C	A	11	6	17	0	4	21	0	0
1	40002113	.	G	A	10	10	20	0	0	20	0	0
1	40002148	.	C	G	15	9	24	0	0	24	0	0
1	40008905	.	T	C	18	20	38	0	1	39	0	0
1	40008906	.	G	A	18	21	39	0	0	39	0	0
1	40009227	.	T	A	17	18	35	0	0	35	0	0
1	40009258	.	C	T	15	14	29	0	2	31	0	0
1	40009291	.	A	G	13	16	29	0	1	30	0	0
1	40009382	.	G	A	19	16	35	0	0	35	0	0
1	40009526	.	T	C	9	7	16	0	0	16	0	0
1	40009625	.	T	C	6	4	10	0	0	10	0	0
1	40009671	.	C	A	12	5	17	0	0	17	0	0
1	40009697	.	C	T	11	5	16	0	0	16	0	0
1	40015189	.	A	G	5	8	13	0	0	13	0	0
1	40015219	.	C	T	5	11	16	0	0	16	0	0
1	40015265	.	C	T	0	10	10	0	7	17	0	0
1	40015553	.	A	G	2	6	8	0	1	9	0	0
1	40015697	.	A	G	10	5	15	0	0	15	0	0
1	40023692	.	T	C	4	4	8	0	0	8	0	0
1	40028208	.	C	A	3	3	6	0	0	6	0	0
1	40028424	.	C	T	9	3	12	0	1	13	0	0
1	40028508	.	C	T	9	5	14	0	2	16	0	0
1	40028568	.	G	T	4	5	9	0	0	9	0	0
1	40028613	.	G	A	6	7	13	0	0	13	0	0
1	40028637	.	C	T	5	5	10	0	1	11	0	0
1	40028680	.	G	A	6	4	10	0	0	10	0	0
1	40041528	.	C	T	6	9	15	0	1	16	0	0
1	40044175	.	G	C	5	2	7	0	1	8	0	0
1	40044562	.	G	A	8	5	13	0	0	13	0	0
1	40044578	.	C	T	7	5	12	0	0	12	0	0
1	40046859	.	G	A	7	7	14	0	0	14	0	0
1	40047070	.	T	A	5	9	14	0	1	15	0	0
1	40051918	.	T	C	5	11	16	0	0	16	0	0
1	40051923	.	G	C	5	10	15	0	1	16	0	0
1	40051988	.	G	C	2	15	17	0	10	27	0	0
1	40052033	.	A	G	9	13	22	0	0	22	0	0
1	40052066	.	G	C	12	4	16	0	1	17	0	0
1	40052083	.	G	A	14	5	19	0	2	21	0	0
1	40052481	.	A	C	9	6	15	0	1	16	0	0
1	40052550	.	A	C	7	10	17	0	1	18	0	0
1	40052562	.	A	G	7	6	13	0	0	13	0	0
1	40057483	.	C	T	4	9	13	0	0	13	0	0
1	40057604	.	A	G	1	5	6	0	0	6	0	0
1	40057655	.	C	T	4	2	6	0	0	6	0	0
1	40057805	.	C	T	5	7	12	0	1	13	0	0
1	40060836	.	T	A	3	2	5	0	0	5	0	0
1	40060860	.	T	C	1	4	5	0	0	5	0	0
1	40060968	.	A	C	6	7	13	0	0	13	0	0
1	40060992	.	C	T	0	4	4	0	6	10	0	0
1	40061061	.	C	T	0	4	4	0	3	7	0	0
1	40061169	.	G	A	8	4	12	0	2	14	0	0
1	40061285	.	C	T	5	6	11	0	1	12	0	0
1	40062593	.	T	G	1	3	4	0	0	4	0	0
1	40066299	.	G	A	4	7	11	0	0	11	0	0
1	40107874	.	T	G	7	5	12	0	0	12	0	0
1	40107961	.	C	T	5	4	9	0	1	10	0	0
1	40111679	.	C	G	15	20	35	0	1	36	0	0
1	40111702	.	T	G	17	15	32	0	3	35	0	0
1	40111737	.	A	C	16	6	22	0	3	25	0	0
1	40111738	.	G	A	18	6	24	0	1	25	0	0
1	40111776	.	C	T	6	6	12	0	2	14	0	0
1	40112206	.	T	C	8	5	13	0	6	19	0	0
1	40112347	.	C	T	9	6	15	0	1	16	0	0
1	40112410	.	C	T	6	6	12	0	6	18	0	0
1	40112760	.	T	A	5	10	15	0	1	16	0	0
1	40112822	.	A	T	13	8	21	1	6	28	0	0
1	40112837	.	C	T	11	13	24	1	2	27	0	0
1	40112869	.	C	T	12	15	27	1	1	29	0	0
1	40112879	.	A	G	8	14	22	1	1	24	0	0
1	40112938	.	G	C	8	7	15	0	0	15	0	0
1	40113008	.	A	T	3	3	6	0	0	6	0	0
1	40113374	.	T	A	2	4	6	0	0	6	0	0
1	40114155	.	T	A	1	2	3	0	0	3	0	0
1	40114326	.	C	T	2	2	4	1	0	5	0	0
1	40114527	.	T	A	5	2	7	0	0	7	0	0
1	40115018	.	A	T	2	5	7	0	0	7	0	0
1	40115065	.	T	C	1	4	5	0	1	6	0	0
1	40116648	.	A	G	3	5	8	0	0	8	0	0
1	40116747	.	G	A	7	6	13	0	1	14	0	0
1	40116823	.	C	T	1	4	5	0	1	6	0	0
1	40116946	.	C	T	2	2	4	0	6	10	0	0
1	40117345	.	G	A	11	13	24	0	1	25	0	0
1	40123964	.	C	T	2	7	9	0	9	18	0	0
1	40126279	.	T	C	6	5	11	0	4	15	0	0
1	40126281	.	T	G	10	6	16	0	0	16	0	0
1	40210865	.	G	T	13	15	28	0	0	28	0	0
1	40211048	.	C	T	0	8	8	0	5	13	0	0
1	40211065	.	T	C	6	6	12	0	0	12	0	0
1	40211217	.	A	C	9	5	14	0	0	14	0	0
1	40211465	.	T	C	12	0	12	0	8	20	0	0
1	40211645	.	C	G	0	8	8	0	14	22	0	0
1	40212065	.	C	T	5	16	21	0	1	22	0	0
1	40212084	.	C	A	1	14	15	0	9	24	0	0
1	40212305	.	C	T	9	14	23	0	2	25	0	0
1	40221359	.	A	G	4	12	16	0	1	17	0	0
1	40221458	.	A	T	7	5	12	0	0	12	0	0
1	40226289	.	G	A	7	4	11	0	0	11	0	0
1	40226292	.	G	C	4	7	11	0	0	11	0	0
1	40227029	.	T	G	8	4	12	0	0	12	0	0
1	40242922	.	C	A	1	3	4	0	0	4	0	0
1	40248173	.	C	T	2	2	4	0	0	4	0	0
1	40248383	.	C	T	5	3	8	0	0	8	0	0
1	40252219	.	T	A	17	8	25	0	1	26	0	0
1	40257568	.	C	T	0	25	25	0	0	25	0	0
1	40257631	.	C	T	11	7	18	0	2	20	0	0
1	40257751	.	C	T	12	7	19	0	1	20	0	0
1	40257834	.	T	G	11	0	11	0	6	17	0	0
1	40263675	.	C	A	3	7	10	0	0	10	0	0
1	40269724	.	C	G	1	3	4	0	0	4	0	0
1	40270054	.	C	T	34	27	61	0	2	63	0	0
1	40270094	.	G	A	3	25	28	0	31	59	0	0
1	40270095	.	G	A	34	25	59	0	1	60	0	0
1	40336234	.	C	G	6	5	11	0	0	11	0	0
1	40336396	.	A	C	1	0	1	0	3	4	0	0
1	40336789	.	G	A	5	2	7	0	0	7	0	0
1	40337314	.	C	T	7	9	16	0	0	16	0	0
1	40337464	.	C	A	1	5	6	0	9	15	0	0
1	40340571	.	C	T	7	3	10	0	1	11	0	0
1	40340598	.	C	T	9	5	14	0	0	14	0	0
1	40410839	.	A	T	6	8	14	0	1	15	0	0
1	40410908	.	C	T	2	8	10	0	1	11	0	0
1	40411091	.	T	A	6	6	12	0	0	12	0	0
1	40411928	.	T	C	3	2	5	0	0	5	0	0
1	40567094	.	G	A	7	8	15	0	0	15	0	0
1	40568601	.	G	A	6	17	23	0	1	24	0	0
1	40568707	.	A	G	9	0	9	0	11	20	0	0
1	40568883	.	G	A	2	14	16	0	15	32	1	0
1	40568990	.	A	G	12	17	29	0	1	30	0	0
1	40569231	.	G	A	12	7	19	0	0	19	0	0
1	40569295	.	A	T	10	9	19	0	0	19	0	0
1	40569386	.	T	A	12	7	19	6	1	26	0	0
1	40569466	.	A	T	13	14	27	0	0	27	0	0
1	40569538	.	G	A	16	5	21	0	1	22	0	0
1	40569548	.	T	C	15	5	20	0	3	23	0	0
1	40573703	.	G	T	17	21	38	0	2	40	0	0
1	40590967	.	T	G	19	21	40	0	2	42	0	0
1	40591262	.	T	C	24	22	46	0	3	49	0	0
1	40591272	.	T	C	24	18	42	0	1	43	0	0
1	40594373	.	C	T	14	17	31	0	0	31	0	0
1	40594415	.	C	T	1	13	14	1	10	25	0	0
1	40594517	.	T	C	21	0	21	1	15	37	0	0
1	40594526	.	G	A	23	13	36	1	0	37	0	0
1	40597332	.	A	C	13	0	13	0	19	32	0	0
1	40600992	.	A	T	6	5	11	0	1	12	0	0
1	40601547	.	G	A	11	9	20	0	1	21	0	0
1	40601595	.	G	C	10	0	10	0	4	14	0	0
1	40627291	.	G	A	6	3	9	0	0	9	0	0
1	40638246	.	A	T	5	5	10	0	0	10	0	0
1	40796779	.	G	T	3	4	7	0	1	8	0	0
1	40796791	.	G	A	4	3	7	0	1	8	0	0
1	40796942	.	C	T	2	2	4	0	0	4	0	0
1	40796977	.	C	T	2	2	4	0	0	4	0	0
1	40796985	.	A	T	1	2	3	0	0	3	0	0
1	40797178	.	C	T	3	2	5	0	0	5	0	0
1	40799617	.	A	T	1	2	3	0	0	3	0	0
1	40910379	.	T	C	2	3	5	0	0	5	0	0
1	40992716	.	T	A	6	9	15	1	0	16	0	0
1	40992823	.	A	G	7	11	18	0	0	18	0	0
1	40992878	.	C	G	7	5	12	0	0	12	0	0
1	40993349	.	C	T	3	9	12	0	9	21	0	0
1	40993714	.	G	A	4	2	6	0	0	6	0	0
1	40994068	.	T	A	3	2	5	0	0	5	0	0
1	41131608	.	C	T	14	9	23	0	1	24	0	0
1	41133944	.	G	A	7	7	14	0	1	15	0	0
1	41136245	.	T	C	16	13	29	0	0	29	0	0
1	41138638	.	A	G	12	15	27	0	2	29	0	0
1	41138641	.	C	T	16	12	28	0	4	32	0	0
1	41140465	.	T	C	14	13	27	0	1	28	0	0
1	41140640	.	C	T	10	17	27	0	0	27	0	0
1	41215289	.	T	A	12	11	23	0	4	27	0	0
1	41215312	.	T	G	18	11	29	0	0	29	0	0
1	41215547	.	G	A	8	13	21	0	1	22	0	0
1	41215746	.	T	A	12	8	20	0	2	22	0	0
1	41215868	.	T	G	8	11	19	0	2	21	0	0
1	41215869	.	G	T	12	8	20	0	1	21	0	0
1	41215998	.	T	C	8	6	14	0	1	15	0	0
1	41222341	.	T	C	2	3	5	0	0	5	0	0
1	41230927	.	C	T	2	5	7	0	1	8	0	0
1	41294719	.	A	G	9	16	25	0	1	26	0	0
1	41294760	.	T	C	6	15	21	0	0	21	0	0
1	41294790	.	G	T	6	8	14	0	0	14	0	0
1	41297453	.	C	T	1	8	9	0	10	19	0	0
1	41297495	.	G	A	10	12	22	0	2	24	0	0
1	41297561	.	C	T	14	6	20	0	1	21	0	0
1	41297564	.	A	T	7	13	20	0	0	20	0	0
1	41300133	.	C	T	5	8	13	0	0	13	0	0
1	41309208	.	C	G	4	5	9	0	1	10	0	0
1	41310074	.	A	G	3	8	11	0	1	12	0	0
1	41312210	.	G	A	3	9	12	0	0	12	0	0
1	41318203	.	T	G	4	4	8	0	0	8	0	0
1	41320781	.	A	G	1	4	5	0	0	5	0	0
1	41324327	.	C	T	1	2	3	0	1	4	0	0
1	41327484	.	A	T	3	4	7	0	0	7	0	0
1	41330594	.	G	C	2	3	5	0	0	5	0	0
1	41331692	.	G	A	2	2	4	0	0	4	0	0
1	41332989	.	T	C	1	0	1	0	2	3	0	0
1	41333321	.	A	G	4	3	7	0	0	7	0	0
1	41470524	.	T	C	19	34	53	0	2	55	0	0
1	41471529	.	T	C	29	21	50	0	3	53	0	0
1	41487811	.	C	T	5	2	7	0	0	7	0	0
1	41487960	.	A	T	1	3	4	0	0	4	0	0
1	41487973	.	T	C	2	2	4	0	0	4	0	0
1	41489068	.	C	T	3	3	6	0	1	7	0	0
1	41489343	.	G	A	1	2	3	0	1	4	0	0
1	41491990	.	G	T	3	2	5	0	0	5	0	0
1	41492026	.	A	G	1	2	3	0	0	3	0	0
1	41492032	.	A	G	0	0	0	0	3	3	0	0
1	41513497	.	G	A	6	2	8	0	1	9	0	0
1	41530370	.	C	T	2	2	4	0	0	4	0	0
1	41596182	.	A	G	2	4	6	0	0	6	0	0
1	41596199	.	A	G	3	4	7	0	1	8	0	0
1	41596291	.	C	T	1	8	9	0	0	9	0	0
1	41600339	.	T	C	4	2	6	0	0	6	0	0
1	41604931	.	C	G	4	0	4	0	5	9	0	0
1	41604934	.	C	G	3	1	4	0	5	9	0	0
1	41604985	.	G	A	0	6	6	0	6	12	0	0
1	41605011	.	T	C	3	7	10	0	0	10	0	0
1	41605149	.	T	C	4	4	8	0	0	8	0	0
1	41605203	.	C	T	7	4	11	0	0	11	0	0
1	41605675	.	G	A	3	3	6	0	0	6	0	0
1	41609925	.	C	T	1	2	3	0	0	3	0	0
1	41615874	.	C	T	1	5	6	0	1	7	0	0
1	41615949	.	T	C	2	9	11	0	0	11	0	0
1	41616081	.	T	G	4	5	9	0	0	9	0	0
1	41616186	.	A	C	7	7	14	0	2	16	0	0
1	41616867	.	T	A	4	2	6	0	1	7	0	0
1	41690506	.	C	T	3	8	11	0	0	11	0	0
1	41730609	.	C	T	9	13	22	0	1	23	0	0
1	41730669	.	G	A	13	13	26	0	0	26	0	0
1	41744103	.	C	T	11	4	15	0	0	15	0	0
1	41755157	.	C	T	13	12	25	0	0	25	0	0
1	41755158	.	A	T	13	12	25	0	0	25	0	0
1	41755195	.	C	T	15	9	24	1	2	27	0	0
1	41770847	.	T	A	7	9	16	0	0	16	0	0
1	41770872	.	T	C	7	7	14	0	1	15	0	0
1	41770959	.	T	C	10	12	22	0	0	22	0	0
1	41817556	.	G	A	2	3	5	0	0	5	0	0
1	41817574	.	T	C	1	5	6	0	1	7	0	0
1	41817678	.	C	T	4	3	7	0	0	7	0	0
1	41849293	.	A	G	5	9	14	0	0	14	0	0
1	41849310	.	A	G	2	11	13	0	0	13	0	0
1	41865471	.	C	T	31	23	54	0	3	57	0	0
1	41950085	.	T	A	1	2	3	0	0	3	0	0
1	41959067	.	T	C	1	0	1	0	2	3	0	0
1	42375005	.	C	A	7	7	14	0	0	14	0	0
1	42375071	.	C	T	8	7	15	0	1	16	0	0
1	42386349	.	T	C	5	5	10	0	0	10	0	0
1	42386364	.	C	A	4	3	7	0	1	8	0	0
1	42391172	.	T	C	3	4	7	0	0	7	0	0
1	42391194	.	T	C	2	3	5	0	0	5	0	0
1	42391214	.	G	A	3	4	7	0	0	7	0	0
1	42776652	.	T	C	26	23	49	0	0	49	0	0
1	42776787	.	C	T	3	18	21	0	27	48	0	0
1	42776806	.	A	T	28	17	45	0	2	48	1	0
1	42776853	.	T	C	21	18	39	0	2	41	0	0
1	42776906	.	A	G	25	15	40	0	0	40	0	0
1	42777116	.	G	A	13	21	34	0	0	34	0	0
1	42777146	.	C	G	0	16	16	0	14	30	0	0
1	42777383	.	A	G	15	19	34	0	3	37	0	0
1	42777593	.	T	G	16	11	27	0	2	29	0	0
1	42777674	.	G	A	10	9	19	0	1	20	0	0
1	42882955	.	C	T	8	3	11	1	0	12	0	0
1	43023630	.	G	A	13	15	28	0	0	28	0	0
1	43034947	.	C	T	22	12	34	0	2	36	0	0
1	43035178	.	T	C	15	20	35	0	1	36	0	0
1	43035546	.	T	A	8	12	20	0	1	21	0	0
1	43659248	.	C	T	2	23	25	0	35	60	0	0
1	43670083	.	A	G	24	24	48	0	2	50	0	0
1	43670378	.	C	T	0	22	22	0	8	30	0	0
1	43682472	.	C	A	14	25	39	0	2	41	0	0
1	43684513	.	A	G	9	8	17	0	0	17	0	0
1	43688164	.	G	A	2	2	4	0	0	4	0	0
1	43688197	.	G	A	1	2	3	0	1	4	0	0
1	43720168	.	A	G	2	3	5	0	0	5	0	0
1	43974433	.	A	T	4	3	7	0	0	7	0	0
1	43981187	.	C	T	1	2	3	0	0	3	0	0
1	43981194	.	G	A	1	2	3	0	0	3	0	0
1	43989063	.	G	A	6	3	9	0	1	10	0	0
1	43989064	.	C	A	7	3	10	0	0	10	0	0
1	43989132	.	T	A	6	4	10	0	0	10	0	0
1	43989134	.	C	A	6	4	10	0	0	10	0	0
1	43994103	.	A	G	9	4	13	0	0	13	0	0
1	43994382	.	G	C	3	4	7	0	0	7	0	0
1	43994447	.	A	C	3	3	6	0	0	6	0	0
1	43994567	.	G	A	5	3	8	0	1	9	0	0
1	43994777	.	G	T	0	5	5	0	0	5	0	0
1	43994796	.	T	G	3	3	6	0	0	6	0	0
1	43994840	.	T	A	2	4	6	1	0	7	0	0
1	43994948	.	C	A	2	5	7	0	0	7	0	0
1	43997679	.	C	T	1	6	7	0	0	7	0	0
1	44021800	.	G	T	2	2	4	0	0	4	0	0
1	44021837	.	A	C	3	0	3	0	2	5	0	0
1	44022017	.	C	G	10	6	16	0	0	16	0	0
1	44027709	.	T	G	1	3	4	0	0	4	0	0
1	44034439	.	G	T	2	2	4	0	0	4	0	0
1	44036924	.	T	C	1	2	3	0	0	3	0	0
1	44040659	.	T	C	1	4	5	0	0	5	0	0
1	44040854	.	T	C	4	8	12	0	1	13	0	0
1	44041079	.	G	A	6	5	11	0	2	13	0	0
1	44041350	.	G	A	5	8	13	0	0	13	0	0
1	44048179	.	C	T	1	4	5	0	4	9	0	0
1	44048263	.	C	T	3	6	9	0	0	9	0	0
1	44048446	.	C	A	1	2	3	0	0	3	0	0
1	44205523	.	C	A	5	1	6	0	2	8	0	0
1	44205649	.	A	T	6	3	9	0	0	9	0	0
1	44205679	.	G	A	0	7	7	0	5	12	0	0
1	44216738	.	A	C	4	8	12	0	0	12	0	0
1	44227346	.	C	T	7	4	11	0	1	12	0	0
1	44227764	.	G	T	9	10	19	0	5	24	0	0
1	44228020	.	T	A	4	5	9	0	1	10	0	0
1	44228033	.	G	A	0	6	6	0	6	12	0	0
1	44228081	.	A	G	6	5	11	0	0	11	0	0
1	44228243	.	T	G	13	5	18	0	2	20	0	0
1	44228705	.	C	T	11	3	14	0	2	16	0	0
1	44390558	.	A	G	19	17	36	0	2	38	0	0
1	44393977	.	T	C	24	18	42	0	2	44	0	0
1	44394276	.	A	T	4	6	10	0	0	10	0	0
1	44422030	.	A	T	1	4	5	0	0	5	0	0
1	44422062	.	C	A	4	5	9	0	0	9	0	0
1	44422071	.	T	G	4	3	7	0	0	7	0	0
1	44422113	.	G	A	2	3	5	0	0	5	0	0
1	44422131	.	A	G	1	2	3	0	0	3	0	0
1	44427141	.	A	G	1	2	3	0	0	3	0	0
1	44427153	.	T	C	1	4	5	0	0	5	0	0
1	44491134	.	A	T	8	17	25	0	0	25	0	0
1	44492030	.	C	A	18	14	32	0	1	33	0	0
1	44492413	.	C	T	18	16	34	0	1	35	0	0
1	44492476	.	C	T	18	26	44	0	2	46	0	0
1	44492626	.	A	C	24	20	44	0	3	47	0	0
1	44492791	.	C	T	25	22	47	0	2	49	0	0
1	44492842	.	G	T	19	22	41	0	2	43	0	0
1	44492875	.	A	T	17	19	36	0	2	38	0	0
1	44492908	.	G	A	4	23	27	0	23	50	0	0
1	44493085	.	C	T	24	19	43	0	1	44	0	0
1	44493498	.	A	T	30	14	44	0	3	47	0	0
1	44493575	.	C	A	29	13	42	0	0	42	0	0
1	44493952	.	G	A	3	19	22	0	28	50	0	0
1	44493971	.	G	A	28	17	45	0	3	48	0	0
1	44494090	.	G	A	2	31	33	0	32	65	0	0
1	44494153	.	C	T	34	27	61	0	2	63	0	0
1	44494371	.	G	T	2	23	25	0	15	40	0	0
1	44494506	.	G	T	19	12	31	0	2	33	0	0
1	44494654	.	A	G	2	2	4	1	0	5	0	0
1	44495258	.	C	T	33	20	53	0	3	56	0	0
1	44548800	.	T	C	1	6	7	0	0	7	0	0
1	44559553	.	A	C	1	0	1	0	18	19	0	0
1	44564983	.	C	T	19	10	29	0	0	29	0	0
1	44565022	.	T	C	19	9	28	0	0	28	0	0
1	44565025	.	C	T	10	15	25	0	1	26	0	0
1	44565084	.	C	T	10	14	24	0	2	26	0	0
1	44565138	.	T	C	8	12	20	0	0	20	0	0
1	44565188	.	C	A	8	9	17	0	0	17	0	0
1	44565288	.	A	T	14	11	25	0	0	25	0	0
1	44566038	.	A	C	10	12	22	0	0	22	0	0
1	44566084	.	C	T	13	16	29	0	1	30	0	0
1	44566133	.	C	A	14	14	28	0	0	28	0	0
1	44566193	.	G	T	0	19	19	0	16	35	0	0
1	44566355	.	C	T	2	6	8	1	0	9	0	0
1	44566373	.	T	A	1	3	4	1	0	5	0	0
1	44569458	.	G	A	14	10	24	0	0	24	0	0
1	44569717	.	C	T	2	7	9	0	19	28	0	0
1	44569822	.	G	A	13	9	22	0	0	22	0	0
1	44569907	.	A	C	4	7	11	0	0	11	0	0
1	44570740	.	C	T	15	12	27	0	4	31	0	0
1	44571077	.	A	G	3	4	7	0	0	7	0	0
1	44571370	.	C	T	1	7	8	0	9	17	0	0
1	44571420	.	G	T	11	10	21	0	1	22	0	0
1	44571480	.	G	T	11	15	26	0	0	26	0	0
1	44571672	.	C	T	1	5	6	1	13	20	0	0
1	44581710	.	C	T	1	8	9	0	5	14	0	0
1	44582513	.	C	T	14	15	29	0	1	30	0	0
1	44582576	.	G	A	1	18	19	0	15	34	0	0
1	44582657	.	G	A	10	12	22	0	0	22	0	0
1	44591232	.	C	A	8	7	15	0	0	15	0	0
1	44652498	.	A	G	19	30	49	0	2	51	0	0
1	44652511	.	A	C	17	27	44	0	3	47	0	0
1	44652599	.	T	C	17	0	17	0	14	31	0	0
1	44652916	.	T	A	17	20	37	1	0	38	0	0
1	44653014	.	C	T	21	32	53	0	3	56	0	0
1	44653076	.	A	T	30	19	49	0	3	52	0	0
1	44653135	.	T	A	20	17	37	0	3	40	0	0
1	44653150	.	T	A	21	18	39	0	2	41	0	0
1	44653171	.	A	G	21	21	42	0	2	44	0	0
1	44658849	.	T	C	23	0	23	0	21	44	0	0
1	44664964	.	T	A	10	11	21	0	1	22	0	0
1	44669970	.	G	T	6	5	11	0	0	11	0	0
1	44672271	.	G	A	9	6	15	0	2	17	0	0
1	44672571	.	G	A	4	7	11	0	2	13	0	0
1	44678037	.	A	G	7	3	10	0	1	11	0	0
1	44683393	.	G	A	5	8	13	0	0	13	0	0
1	44696138	.	G	A	2	2	4	0	1	5	0	0
1	44703761	.	G	T	9	3	12	0	0	12	0	0
1	44729413	.	C	T	6	13	19	0	1	20	0	0
1	44729449	.	G	C	7	17	24	0	2	26	0	0
1	44729479	.	C	G	9	11	20	0	2	22	0	0
1	44737473	.	G	A	0	13	13	0	10	23	0	0
1	44737588	.	A	T	6	5	11	0	1	12	0	0
1	44737598	.	T	A	7	4	11	0	2	13	0	0
1	44737653	.	A	T	10	13	23	0	1	24	0	0
1	44737750	.	T	A	9	6	15	0	0	15	0	0
1	44816363	.	A	G	18	0	18	0	22	40	0	0
1	44816380	.	G	A	21	13	34	0	2	36	0	0
1	44818992	.	A	G	19	0	19	0	18	37	0	0
1	44828931	.	C	A	1	2	3	0	0	3	0	0
1	44846997	.	G	A	5	5	10	0	0	10	0	0
1	44849126	.	C	T	2	2	4	0	1	5	0	0
1	44852503	.	T	C	6	5	11	0	0	11	0	0
1	44852737	.	G	C	1	5	6	0	0	6	0	0
1	44852817	.	G	A	7	3	10	0	0	10	0	0
1	44855409	.	T	C	7	4	11	0	0	11	0	0
1	44861744	.	C	T	14	5	19	1	0	20	0	0
1	44861954	.	A	T	14	13	27	0	1	29	1	0
1	44862005	.	C	T	18	7	25	3	2	30	0	0
1	44862011	.	T	C	21	5	26	3	0	29	0	0
1	44862092	.	C	G	22	10	32	0	2	34	0	0
1	44862707	.	C	T	7	8	15	0	2	17	0	0
1	44862725	.	G	A	12	10	22	0	1	23	0	0
1	44869115	.	C	T	23	11	34	2	1	37	0	0
1	44869173	.	A	T	10	10	20	0	2	22	0	0
1	44869174	.	C	T	12	10	22	0	0	22	0	0
1	44869216	.	G	A	14	13	27	0	0	27	0	0
1	44869621	.	G	A	9	15	24	0	3	27	0	0
1	44869638	.	A	G	15	7	22	0	2	24	0	0
1	44869666	.	C	A	18	8	26	0	0	26	0	0
1	44869810	.	T	C	6	8	14	0	0	14	0	0
1	44872586	.	A	G	4	10	14	0	0	14	0	0
1	44872726	.	A	T	3	4	7	0	0	7	0	0
1	44872735	.	C	T	3	3	6	0	0	6	0	0
1	44872817	.	A	G	3	2	5	0	0	5	0	0
1	44893456	.	T	C	1	2	3	0	0	3	0	0
1	44893894	.	G	T	4	8	12	0	0	12	0	0
1	44893921	.	T	A	1	4	5	0	1	6	0	0
1	44919749	.	G	A	1	2	3	0	1	4	0	0
1	44922512	.	G	A	1	2	3	0	0	3	0	0
1	44923565	.	C	T	3	3	6	0	0	6	0	0
1	44923661	.	T	C	4	4	8	0	0	8	0	0
1	44923723	.	C	T	5	3	8	0	0	8	0	0
1	44925956	.	C	T	2	2	4	0	0	4	0	0
1	44925977	.	G	A	3	4	7	0	1	8	0	0
1	44940802	.	T	A	2	2	4	0	1	5	0	0
1	44950079	.	G	T	1	2	3	0	0	3	0	0
1	44959343	.	C	G	11	7	18	0	1	19	0	0
1	44959347	.	C	A	13	7	20	0	1	21	0	0
1	44959408	.	C	A	10	6	16	0	4	20	0	0
1	44959538	.	C	T	2	10	12	2	1	15	0	0
1	44960204	.	T	A	5	6	11	0	0	11	0	0
1	44960252	.	A	G	2	9	11	0	1	12	0	0
1	44960279	.	G	A	9	4	13	0	0	13	0	0
1	44960898	.	G	A	8	8	16	0	0	16	0	0
1	44961143	.	A	C	4	4	8	1	0	9	0	0
1	44961245	.	C	A	4	11	15	0	0	15	0	0
1	44961285	.	C	T	6	8	14	0	1	15	0	0
1	44961347	.	T	A	5	5	10	0	0	10	0	0
1	44961387	.	G	A	0	5	5	0	5	10	0	0
1	44961406	.	A	G	6	0	6	0	3	9	0	0
1	44961612	.	A	T	9	6	15	0	0	15	0	0
1	44961698	.	A	G	8	0	8	0	10	18	0	0
1	44962036	.	T	A	19	6	25	0	4	29	0	0
1	45003075	.	G	T	11	10	21	0	1	22	0	0
1	45008646	.	T	C	5	4	9	0	0	9	0	0
1	45011637	.	A	G	9	8	17	0	1	18	0	0
1	45013571	.	G	A	14	8	22	0	1	23	0	0
1	45013760	.	A	G	4	0	4	1	3	8	0	0
1	45013775	.	T	C	5	4	9	1	1	11	0	0
1	45013894	.	G	A	5	3	8	0	0	8	0	0
1	45013904	.	G	A	7	3	10	0	0	10	0	0
1	45014176	.	G	A	7	16	23	0	0	23	0	0
1	45014263	.	A	G	10	8	18	0	0	18	0	0
1	45014361	.	C	A	4	3	7	0	0	7	0	0
1	45014976	.	C	G	16	11	27	0	0	27	0	0
1	45015095	.	A	T	17	11	28	0	1	29	0	0
1	45015310	.	T	C	9	3	12	0	0	12	0	0
1	45015586	.	G	A	4	7	11	0	0	11	0	0
1	45015654	.	T	C	5	4	9	0	5	14	0	0
1	45015687	.	T	C	7	10	17	0	3	20	0	0
1	45015693	.	C	T	9	11	20	0	1	21	0	0
1	45015809	.	A	G	4	5	9	0	1	10	0	0
1	45015827	.	G	C	3	3	6	0	0	6	0	0
1	45016070	.	C	T	11	11	22	0	1	23	0	0
1	45016216	.	G	A	6	3	9	0	0	9	0	0
1	45016502	.	T	A	16	15	31	0	1	32	0	0
1	45019745	.	C	T	34	23	57	1	0	58	0	0
1	45022069	.	C	T	1	19	20	1	23	44	0	0
1	45022114	.	G	A	13	24	37	3	0	40	0	0
1	45022156	.	C	T	12	23	35	2	0	37	0	0
1	45038781	.	G	A	11	5	16	0	0	16	0	0
1	45038963	.	A	C	8	13	21	0	1	22	0	0
1	45038966	.	T	C	12	8	20	0	1	21	0	0
1	45039608	.	T	C	8	11	19	0	0	19	0	0
1	45041107	.	T	C	2	9	11	0	1	12	0	0
1	45041116	.	A	C	1	9	10	0	0	10	0	0
1	45041152	.	C	T	1	11	12	0	4	16	0	0
1	45041257	.	G	A	21	8	29	0	3	32	0	0
1	45044236	.	A	G	33	39	72	0	1	73	0	0
1	45045401	.	A	G	38	25	63	0	9	72	0	0
1	45085242	.	T	C	13	23	36	0	2	38	0	0
1	45085261	.	C	G	18	0	18	0	26	44	0	0
1	45086369	.	T	C	29	21	50	0	2	52	0	0
1	45086405	.	G	A	30	15	45	0	2	47	0	0
1	45087729	.	G	A	25	26	51	0	1	52	0	0
1	45087810	.	A	T	17	25	42	0	1	43	0	0
1	45093732	.	A	C	22	24	46	0	0	46	0	0
1	45093762	.	A	G	30	16	46	0	3	49	0	0
1	45093769	.	A	T	30	18	48	0	0	48	0	0
1	45094157	.	C	T	26	24	50	0	0	50	0	0
1	45094226	.	T	G	20	21	41	0	2	43	0	0
1	45094235	.	G	A	19	24	43	0	0	43	0	0
1	45094317	.	A	T	13	27	40	1	0	41	0	0
1	45095150	.	C	A	3	5	8	0	3	11	0	0
1	45095157	.	G	A	0	8	8	0	3	11	0	0
1	45095197	.	G	A	3	2	5	0	0	5	0	0
1	45206076	.	G	A	7	12	19	0	0	19	0	0
1	45208096	.	G	A	15	12	27	0	0	27	0	0
1	45208396	.	C	T	1	10	11	0	12	23	0	0
1	45208771	.	C	A	12	11	23	0	1	24	0	0
1	45211431	.	G	A	11	12	23	0	0	23	0	0
1	45211599	.	C	T	8	5	13	0	1	14	0	0
1	45211602	.	G	A	5	7	12	0	1	13	0	0
1	45213290	.	G	A	11	7	18	0	0	18	0	0
1	45262384	.	A	T	1	3	4	0	0	4	0	0
1	45330064	.	G	A	15	14	29	0	0	29	0	0
1	45330165	.	A	C	15	26	41	0	1	42	0	0
1	45330174	.	C	T	16	27	43	0	1	44	0	0
1	45330207	.	C	T	21	18	39	0	1	40	0	0
1	45330386	.	T	G	13	1	14	0	13	27	0	0
1	45332721	.	C	T	1	3	4	0	1	5	0	0
1	45332801	.	T	G	5	3	8	0	0	8	0	0
1	45335160	.	G	A	12	12	24	0	1	25	0	0
1	45335187	.	G	A	13	7	20	0	0	20	0	0
1	45337115	.	G	A	9	11	20	0	0	20	0	0
1	45340851	.	G	A	7	10	17	0	0	17	0	0
1	45351969	.	A	G	2	2	4	0	1	5	0	0
1	45352030	.	C	T	3	7	10	0	1	11	0	0
1	45355709	.	C	T	3	5	8	0	0	8	0	0
1	45366004	.	A	G	9	12	21	0	1	22	0	0
1	45366096	.	G	A	0	12	12	0	9	21	0	0
1	45366137	.	A	T	10	5	15	0	3	18	0	0
1	45366338	.	C	T	7	3	10	0	0	10	0	0
1	45366386	.	C	A	2	4	6	0	0	6	0	0
1	45373247	.	A	G	15	17	32	0	2	34	0	0
1	45373517	.	C	A	17	21	38	0	1	39	0	0
1	45373665	.	G	A	23	11	34	0	1	35	0	0
1	45373666	.	T	C	18	11	29	0	5	34	0	0
1	45373795	.	A	G	21	20	41	0	1	42	0	0
1	45374657	.	T	A	13	9	22	0	1	23	0	0
1	45375065	.	G	A	8	11	19	0	2	21	0	0
1	45375271	.	C	T	6	7	13	1	0	14	0	0
1	45375573	.	A	T	12	5	17	0	0	17	0	0
1	45375666	.	G	A	7	7	14	0	1	15	0	0
1	45375790	.	C	A	11	5	16	0	0	16	0	0
1	45376352	.	T	C	16	15	31	0	0	31	0	0
1	45376413	.	G	A	16	14	30	0	1	31	0	0
1	45378546	.	G	A	10	8	18	0	0	18	0	0
1	45383598	.	C	T	1	3	4	0	1	5	0	0
1	45383646	.	G	A	6	3	9	0	0	9	0	0
1	45526241	.	G	A	3	2	5	0	0	5	0	0
1	45526247	.	C	G	1	2	3	0	2	5	0	0
1	45526337	.	C	A	0	6	6	0	4	10	0	0
1	45526418	.	T	G	9	3	12	0	0	12	0	0
1	45526439	.	G	A	2	5	7	0	1	8	0	0
1	45570224	.	T	A	13	11	24	1	6	31	0	0
1	45570225	.	T	A	15	14	29	1	2	32	0	0
1	45570384	.	T	A	19	16	35	0	1	36	0	0
1	45570876	.	G	A	25	24	49	0	2	51	0	0
1	45570909	.	C	A	1	25	26	0	30	56	0	0
1	45573418	.	A	G	20	18	38	0	0	38	0	0
1	45574320	.	C	T	2	13	15	0	19	34	0	0
1	45574347	.	T	C	15	0	15	0	16	31	0	0
1	45574478	.	T	A	7	8	15	0	3	18	0	0
1	45574560	.	T	C	7	13	20	0	0	20	0	0
1	45575610	.	G	T	13	19	32	0	0	32	0	0
1	45575613	.	T	C	12	16	28	0	2	30	0	0
1	45576094	.	T	C	13	6	19	0	0	19	0	0
1	45576107	.	A	G	9	6	15	0	1	16	0	0
1	45577570	.	A	G	11	8	19	0	0	19	0	0
1	45577899	.	A	G	14	8	22	0	0	23	1	0
1	45616925	.	G	A	22	17	39	0	2	42	1	0
1	45617163	.	G	A	21	22	43	0	1	44	0	0
1	45617226	.	C	A	24	14	38	0	2	40	0	0
1	45617239	.	A	G	25	15	40	1	0	41	0	0
1	45617300	.	G	A	15	16	31	1	1	33	0	0
1	45617436	.	C	T	25	26	51	0	0	51	0	0
1	45617457	.	C	G	30	20	50	0	0	50	0	0
1	45617478	.	T	A	21	24	45	0	4	49	0	0
1	45617577	.	T	A	27	20	47	0	2	49	0	0
1	45617657	.	A	T	21	21	42	0	1	43	0	0
1	45617743	.	C	T	13	23	36	0	0	37	1	0
1	45619758	.	T	C	20	26	46	0	2	48	0	0
1	45631275	.	T	C	9	0	9	0	11	20	0	0
1	45631469	.	G	A	12	12	24	0	0	24	0	0
1	45663834	.	T	C	10	6	16	0	0	16	0	0
1	45663869	.	C	T	6	3	9	0	0	9	0	0
1	45663883	.	T	G	6	2	8	0	0	8	0	0
1	45663968	.	A	G	0	0	0	0	6	6	0	0
1	45663975	.	G	A	2	4	6	0	0	6	0	0
1	45664224	.	C	T	9	19	28	0	1	29	0	0
1	45664260	.	G	A	22	10	32	0	3	35	0	0
1	45668754	.	C	T	11	5	16	0	0	16	0	0
1	45669273	.	A	C	1	3	4	0	1	5	0	0
1	45694005	.	T	C	3	4	7	0	0	7	0	0
1	45697972	.	A	G	2	4	6	0	1	7	0	0
1	45699714	.	C	A	3	2	5	0	0	5	0	0
1	45699752	.	A	G	3	4	7	0	0	7	0	0
1	45699993	.	C	T	1	2	3	0	0	3	0	0
1	45700116	.	T	C	2	3	5	0	0	5	0	0
1	45700320	.	G	A	2	3	5	0	0	5	0	0
1	45700325	.	T	G	3	0	3	0	3	6	0	0
1	45727918	.	A	G	3	0	3	0	2	5	0	0
1	45727928	.	A	G	2	0	2	0	2	4	0	0
1	45730896	.	A	T	7	4	11	0	1	12	0	0
1	45730905	.	T	C	4	7	11	0	0	11	0	0
1	45735695	.	T	C	3	4	7	0	0	7	0	0
1	45735704	.	A	G	4	2	6	0	0	6	0	0
1	45735817	.	G	A	5	5	10	0	0	10	0	0
1	45735990	.	G	A	0	4	4	0	4	8	0	0
1	45736045	.	T	A	4	3	7	0	1	8	0	0
1	45736171	.	A	G	1	0	1	0	3	4	0	0
1	45736412	.	A	C	2	5	7	0	0	7	0	0
1	45736517	.	A	C	1	3	4	0	0	4	0	0
1	45736528	.	G	A	1	3	4	0	0	4	0	0
1	45736686	.	C	A	3	3	6	0	0	6	0	0
1	45737067	.	T	G	4	6	10	0	1	11	0	0
1	45737202	.	G	A	3	7	10	0	0	10	0	0
1	45737271	.	G	A	3	3	6	0	1	7	0	0
1	45737442	.	C	T	6	7	13	0	2	15	0	0
1	45737590	.	C	A	13	5	18	0	1	19	0	0
1	45741134	.	C	A	2	4	6	0	0	6	0	0
1	45741220	.	A	G	6	0	6	0	4	10	0	0
1	45741514	.	T	A	1	2	3	0	0	3	0	0
1	45742298	.	G	A	1	3	4	0	0	4	0	0
1	45742481	.	A	T	1	2	3	0	0	3	0	0
1	45742596	.	A	G	1	0	1	0	2	3	0	0
1	45742599	.	C	A	1	1	2	0	1	3	0	0
1	45742640	.	T	C	2	4	6	0	0	6	0	0
1	45742715	.	T	G	3	4	7	0	0	7	0	0
1	45742865	.	G	C	2	4	6	0	0	6	0	0
1	45742866	.	G	T	2	4	6	0	0	6	0	0
1	45744091	.	C	T	5	3	8	0	0	8	0	0
1	45744643	.	A	C	1	4	5	0	0	5	0	0
1	45831446	.	G	A	2	2	4	0	1	5	0	0
1	45833011	.	T	A	1	4	5	0	0	5	0	0
1	45833165	.	A	T	1	3	4	0	0	4	0	0
1	45833471	.	T	C	3	3	6	1	0	7	0	0
1	45833472	.	T	C	3	3	6	1	0	7	0	0
1	45833580	.	A	G	2	3	5	0	0	5	0	0
1	45833589	.	T	C	0	4	4	0	0	4	0	0
1	45833900	.	G	A	1	3	4	0	0	4	0	0
1	45834001	.	C	T	1	2	3	0	1	4	0	0
1	45834022	.	G	A	0	2	2	0	2	4	0	0
1	45834444	.	A	G	2	0	2	0	2	4	0	0
1	45834543	.	C	T	2	11	13	0	1	14	0	0
1	45834549	.	C	T	2	10	12	0	1	13	0	0
1	45835269	.	G	A	1	2	3	0	7	10	0	0
1	45835298	.	C	T	4	3	7	0	2	9	0	0
1	45835389	.	G	A	4	12	16	0	0	16	0	0
1	45835455	.	A	T	3	4	7	0	2	9	0	0
1	45835486	.	G	A	7	4	11	0	0	11	0	0
1	45835499	.	C	G	3	5	8	0	1	9	0	0
1	45835521	.	T	C	3	5	8	0	0	8	0	0
1	45835542	.	A	C	2	2	4	0	0	4	0	0
1	45835815	.	G	A	8	4	12	0	0	12	0	0
1	45835870	.	T	G	4	3	7	0	1	8	0	0
1	45840013	.	T	C	3	3	6	0	0	6	0	0
1	45848680	.	G	T	0	3	3	0	1	4	0	0
1	45867414	.	G	T	9	10	19	0	4	23	0	0
1	45867759	.	C	T	19	18	37	0	1	39	1	0
1	45867830	.	A	G	17	18	35	0	2	37	0	0
1	45867834	.	C	T	20	16	36	0	1	37	0	0
1	45868007	.	C	T	2	16	18	1	36	55	0	0
1	45868178	.	C	T	23	9	32	33	0	65	0	0
1	45868730	.	T	A	2	8	10	0	0	10	0	0
1	45869326	.	C	T	17	17	34	0	1	35	0	0
1	45869447	.	C	A	15	18	33	0	0	33	0	0
1	45869588	.	A	C	8	14	22	0	1	23	0	0
1	45869923	.	T	C	4	8	12	0	2	14	0	0
1	45870044	.	G	A	5	9	14	0	0	14	0	0
1	45870046	.	G	T	9	4	13	0	1	14	0	0
1	45870253	.	A	G	4	15	19	0	1	20	0	0
1	45870438	.	C	T	12	9	21	0	1	22	0	0
1	45870644	.	A	G	12	12	24	0	3	27	0	0
1	45871331	.	T	C	11	7	18	0	1	19	0	0
1	45879827	.	G	A	6	3	9	0	0	9	0	0
1	45889009	.	T	C	3	2	5	0	1	6	0	0
1	45892097	.	G	A	15	4	19	0	0	19	0	0
1	45892469	.	C	G	2	4	6	0	0	6	0	0
1	45892556	.	G	A	2	5	7	0	2	9	0	0
1	45894103	.	C	T	0	2	2	0	2	4	0	0
1	45894827	.	G	T	3	2	5	0	0	5	0	0
1	45897988	.	C	T	0	5	5	0	1	6	0	0
1	45898011	.	G	A	3	4	7	0	0	7	0	0
1	45901870	.	A	G	2	4	6	0	0	6	0	0
1	45902230	.	A	G	3	6	9	0	0	9	0	0
1	45902233	.	G	T	2	6	8	0	1	9	0	0
1	45905957	.	G	T	3	4	7	0	0	7	0	0
1	45906186	.	A	G	1	2	3	0	0	3	0	0
1	45935510	.	G	A	7	7	14	0	2	16	0	0
1	45935642	.	T	C	6	6	12	0	1	13	0	0
1	45935753	.	A	G	5	7	12	0	1	13	0	0
1	45935849	.	G	A	9	3	12	0	0	12	0	0
1	45937624	.	T	C	2	2	4	0	0	4	0	0
1	45937639	.	A	G	1	2	3	0	0	3	0	0
1	45937693	.	A	G	4	0	4	0	10	14	0	0
1	45941557	.	G	A	7	7	14	0	2	16	0	0
1	45944033	.	C	T	4	4	8	0	0	8	0	0
1	45944239	.	A	G	4	4	8	0	0	8	0	0
1	45944475	.	G	A	4	7	11	0	2	13	0	0
1	45946739	.	C	T	5	2	7	0	1	8	0	0
1	45947875	.	G	T	3	9	12	0	1	13	0	0
1	45948157	.	G	A	7	2	9	0	0	9	0	0
1	45952797	.	C	T	12	5	17	0	1	18	0	0
1	45952994	.	T	C	7	6	13	0	1	14	0	0
1	45953009	.	C	T	8	10	18	0	0	18	0	0
1	45953066	.	G	A	11	6	17	0	2	19	0	0
1	45953087	.	C	T	10	5	15	0	1	16	0	0
1	45955771	.	A	C	11	14	25	0	0	25	0	0
1	45956046	.	G	A	13	14	27	0	0	27	0	0
1	45956166	.	G	T	15	8	23	0	0	23	0	0
1	45956231	.	A	G	11	8	19	0	0	19	0	0
1	45956332	.	A	G	4	4	8	0	0	8	0	0
1	46010323	.	T	C	1	7	8	0	1	9	0	0
1	46616684	.	T	C	3	24	27	0	1	28	0	0
1	46831357	.	G	A	5	8	13	0	0	13	0	0
1	47120622	.	G	C	4	8	12	3	1	16	0	0
1	47120627	.	C	T	3	9	12	3	0	15	0	0
1	47500084	.	G	A	4	2	6	0	0	6	0	0
1	47703141	.	G	A	1	5	6	0	0	6	0	0
1	47969835	.	G	A	2	2	4	0	0	4	0	0
1	48486803	.	C	T	2	3	5	0	0	5	0	0
1	48487671	.	G	A	2	2	4	0	0	4	0	0
1	48487729	.	T	A	3	2	5	0	0	5	0	0
1	48488243	.	T	G	7	3	10	0	2	12	0	0
1	48488496	.	C	T	1	4	5	0	0	5	0	0
1	48488619	.	A	C	2	4	6	0	0	6	0	0
1	48488637	.	A	G	2	3	5	0	0	5	0	0
1	48581919	.	C	T	9	6	15	0	2	17	0	0
1	48582091	.	T	C	4	4	8	0	0	8	0	0
1	48583000	.	T	C	7	7	14	0	0	14	0	0
1	48583098	.	C	G	2	4	6	0	1	7	0	0
1	48583521	.	A	C	9	4	13	0	1	14	0	0
1	48583528	.	C	T	10	5	15	0	0	15	0	0
1	48587725	.	T	A	7	12	19	0	0	19	0	0
1	48607361	.	A	G	3	2	5	0	1	6	0	0
1	49289663	.	G	A	3	24	27	0	26	53	0	0
1	49289729	.	C	G	34	0	34	0	33	68	1	0
1	49293733	.	C	T	36	19	55	0	2	57	0	0
1	49293891	.	G	A	16	26	42	0	0	42	0	0
1	49294727	.	G	C	19	7	26	0	0	26	0	0
1	49294765	.	T	C	17	21	38	0	1	39	0	0
1	49420026	.	T	C	2	7	9	0	0	9	0	0
1	49420044	.	G	A	2	9	11	0	0	11	0	0
1	49420637	.	G	A	2	6	8	0	0	8	0	0
1	49420658	.	A	G	4	7	11	0	0	11	0	0
1	49423200	.	G	A	5	4	9	1	0	10	0	0
1	49424516	.	G	A	0	2	2	0	2	4	0	0
1	49425668	.	C	T	4	7	11	0	0	11	0	0
1	49427972	.	G	C	0	7	7	0	7	14	0	0
1	49429878	.	G	A	1	10	11	0	9	20	0	0
1	49429917	.	C	A	6	12	18	0	1	19	0	0
1	49429944	.	T	A	7	6	13	0	1	14	0	0
1	49457751	.	G	A	3	3	6	0	0	6	0	0
1	49466190	.	G	A	3	3	6	0	0	6	0	0
1	49473716	.	G	T	3	3	6	0	0	6	0	0
1	49474079	.	G	A	1	3	4	0	5	9	0	0
1	49474993	.	T	C	6	4	10	0	1	11	0	0
1	49474995	.	C	T	7	4	11	0	0	11	0	0
1	49475714	.	C	T	8	4	12	0	0	12	0	0
1	49480825	.	T	G	5	7	12	0	0	12	0	0
1	49481007	.	A	T	2	3	5	0	1	6	0	0
1	49481546	.	T	A	18	13	31	0	0	31	0	0
1	49481567	.	T	G	18	13	31	0	1	32	0	0
1	49481649	.	T	C	10	12	22	0	5	27	0	0
1	49481787	.	A	G	15	23	38	0	0	38	0	0
1	49481866	.	T	G	19	22	41	0	3	44	0	0
1	49481886	.	A	T	14	17	31	0	0	31	0	0
1	49482755	.	C	T	16	9	25	0	0	25	0	0
1	49482984	.	T	A	10	8	18	0	0	18	0	0
1	49483217	.	C	G	6	3	9	0	0	9	0	0
1	49483270	.	C	T	4	5	9	0	0	9	0	0
1	49483300	.	A	G	4	7	11	0	0	11	0	0
1	49483555	.	T	C	11	8	19	0	2	21	0	0
1	49483559	.	T	C	14	5	19	0	2	21	0	0
1	49483679	.	G	A	12	12	24	0	1	25	0	0
1	49483721	.	T	G	12	12	24	0	1	26	1	0
1	49483901	.	T	A	22	16	38	0	3	41	0	0
1	49484002	.	A	T	22	20	42	0	1	43	0	0
1	49484096	.	G	T	24	18	42	0	3	45	0	0
1	49484146	.	G	A	23	19	42	0	1	43	0	0
1	49492396	.	G	A	10	14	24	0	1	25	0	0
1	49497590	.	T	G	6	5	11	0	1	13	1	0
1	49606801	.	A	G	3	5	8	0	0	8	0	0
1	49607102	.	A	T	2	5	7	0	0	7	0	0
1	49607156	.	T	G	1	4	5	0	0	5	0	0
1	49607223	.	T	A	2	2	4	0	0	4	0	0
1	49607251	.	T	C	2	3	5	0	0	5	0	0
1	49607370	.	G	A	1	7	8	0	0	8	0	0
1	49607806	.	A	G	1	4	5	0	0	5	0	0
1	49607835	.	A	T	2	6	8	0	0	8	0	0
1	49607861	.	A	G	4	7	11	0	0	11	0	0
1	49608014	.	T	C	7	5	12	0	1	13	0	0
1	49608027	.	T	C	6	0	6	0	6	12	0	0
1	49609011	.	C	T	3	3	6	0	0	6	0	0
1	49609024	.	C	T	0	2	2	0	3	5	0	0
1	49609048	.	A	G	2	2	4	0	0	4	0	0
1	49609191	.	G	A	5	2	7	0	0	7	0	0
1	49609247	.	G	A	8	4	12	0	1	13	0	0
1	49622992	.	T	C	2	3	5	0	1	6	0	0
1	49633402	.	T	G	1	2	3	0	0	3	0	0
1	49694765	.	T	A	1	2	3	0	0	3	0	0
1	49694773	.	T	C	1	2	3	0	0	3	0	0
1	49814674	.	T	C	12	11	23	0	0	23	0	0
1	49902787	.	C	T	7	5	12	1	1	14	0	0
1	49909911	.	A	C	3	7	10	0	0	10	0	0
1	49912665	.	C	T	6	8	14	0	1	15	0	0
1	49912827	.	A	G	8	10	18	0	1	19	0	0
1	49912841	.	C	A	1	10	11	0	8	19	0	0
1	49912866	.	C	T	0	10	10	0	9	19	0	0
1	49912990	.	T	C	6	13	19	0	0	19	0	0
1	49913062	.	A	G	5	15	20	0	1	21	0	0
1	49913071	.	G	A	4	12	16	0	4	20	0	0
1	49913101	.	T	G	3	16	19	0	0	19	0	0
1	49915208	.	G	A	6	10	16	0	0	16	0	0
1	49915231	.	C	T	5	8	13	0	1	14	0	0
1	49915598	.	C	T	4	8	12	0	0	12	0	0
1	49918779	.	T	C	1	7	8	0	0	8	0	0
1	49929693	.	T	C	1	2	3	0	0	3	0	0
1	49960657	.	A	T	2	2	4	0	0	4	0	0
1	49980651	.	G	A	1	2	3	0	0	3	0	0
1	50051814	.	C	A	4	3	7	0	0	7	0	0
1	50061614	.	C	A	3	2	5	0	0	5	0	0
1	50065290	.	A	G	2	2	4	0	0	4	0	0
1	50065304	.	T	A	3	1	4	0	0	4	0	0
1	50065325	.	T	A	2	2	4	0	0	4	0	0
1	50111654	.	C	T	2	2	4	0	0	4	0	0
1	50171219	.	T	C	3	4	7	0	0	7	0	0
1	50172815	.	A	G	5	8	13	0	0	13	0	0
1	50178829	.	C	A	8	8	16	0	1	17	0	0
1	50178988	.	A	G	8	0	8	0	5	13	0	0
1	50183822	.	C	A	4	5	9	0	0	9	0	0
1	50185244	.	G	A	0	11	11	0	8	19	0	0
1	50187688	.	A	G	5	6	11	0	0	11	0	0
1	50187836	.	T	G	2	2	4	0	1	5	0	0
1	50187866	.	A	G	2	0	2	0	3	5	0	0
1	50198792	.	T	C	6	3	9	0	1	10	0	0
1	50198815	.	C	T	1	4	5	0	6	11	0	0
1	50199365	.	A	T	15	8	23	0	0	23	0	0
1	50199368	.	G	A	13	8	21	0	1	22	0	0
1	50245894	.	G	C	5	5	10	0	0	10	0	0
1	50261274	.	A	G	4	2	6	0	0	6	0	0
1	50266593	.	G	A	2	2	4	0	0	4	0	0
1	50266704	.	C	G	3	2	5	0	0	5	0	0
1	50273133	.	G	A	3	5	8	0	0	8	0	0
1	50293876	.	A	G	2	3	5	0	0	5	0	0
1	50301833	.	A	G	7	4	11	0	3	14	0	0
1	50303989	.	G	A	0	9	9	0	13	22	0	0
1	50487649	.	G	T	10	12	22	0	2	24	0	0
1	50487837	.	C	A	8	7	15	0	1	16	0	0
1	50487844	.	G	A	9	8	17	0	0	17	0	0
1	50487895	.	T	C	11	0	11	0	7	18	0	0
1	50487938	.	A	C	13	3	16	0	1	17	0	0
1	50488002	.	A	G	10	5	15	1	1	17	0	0
1	50496598	.	A	G	8	7	15	0	1	16	0	0
1	50502852	.	C	T	0	7	7	0	1	8	0	0
1	50519961	.	T	C	1	3	4	0	0	4	0	0
1	50521871	.	G	T	3	2	5	0	0	5	0	0
1	50554597	.	C	T	1	2	3	0	0	3	0	0
1	50594217	.	T	C	16	16	32	0	2	34	0	0
1	50594318	.	T	G	8	11	19	0	3	22	0	0
1	50594346	.	A	G	9	10	19	0	0	19	0	0
1	50594421	.	G	A	4	3	7	1	1	9	0	0
1	50594424	.	C	T	5	3	8	1	0	9	0	0
1	50594647	.	G	A	10	7	17	0	2	19	0	0
1	50594670	.	A	T	9	12	21	0	2	23	0	0
1	50594986	.	T	C	9	0	9	0	16	25	0	0
1	50595288	.	T	C	13	20	33	0	0	33	0	0
1	50595289	.	G	A	12	20	32	0	1	33	0	0
1	50595476	.	G	A	10	13	23	1	0	24	0	0
1	50595608	.	G	C	13	10	23	0	0	23	0	0
1	50595748	.	T	C	12	12	24	0	0	24	0	0
1	50595805	.	G	A	15	13	28	0	0	28	0	0
1	50595809	.	T	A	14	13	27	0	0	27	0	0
1	50596694	.	A	G	6	20	26	0	3	29	0	0
1	50598848	.	G	A	6	23	29	0	1	30	0	0
1	50598872	.	A	G	5	19	24	0	3	27	0	0
1	50608232	.	T	C	7	13	20	0	0	20	0	0
1	50608373	.	G	A	12	8	20	0	2	22	0	0
1	50608691	.	A	T	4	3	7	0	0	7	0	0
1	50608692	.	T	C	4	3	7	0	0	7	0	0
1	50611013	.	G	A	3	2	5	0	0	5	0	0
1	50657063	.	T	G	1	3	4	0	1	5	0	0
1	50657093	.	T	C	1	4	5	0	0	5	0	0
1	50657117	.	C	A	1	5	6	0	0	6	0	0
1	50666916	.	C	T	3	4	7	0	0	7	0	0
1	50666985	.	T	A	1	5	6	0	0	6	0	0
1	50668883	.	C	T	5	5	10	0	0	10	0	0
1	50668915	.	C	T	5	6	11	0	0	11	0	0
1	50670799	.	T	C	4	3	7	0	0	7	0	0
1	50673407	.	T	C	3	2	5	0	0	5	0	0
1	50673749	.	G	A	0	7	7	0	3	10	0	0
1	50688646	.	A	G	2	0	2	0	4	6	0	0
1	50688682	.	A	T	4	3	7	0	0	7	0	0
1	50702736	.	C	T	5	9	14	0	0	14	0	0
1	50703007	.	A	G	5	3	8	0	1	9	0	0
1	50703021	.	C	T	8	2	10	0	0	10	0	0
1	50847905	.	T	C	3	6	9	0	0	9	0	0
1	50848106	.	A	G	10	8	18	0	1	19	0	0
1	50848115	.	A	G	11	6	17	0	2	19	0	0
1	50848206	.	A	C	18	11	29	0	1	30	0	0
1	50848504	.	C	T	22	11	33	0	2	35	0	0
1	50848532	.	G	A	15	10	25	0	9	34	0	0
1	50848555	.	A	G	19	7	26	0	1	27	0	0
1	50848595	.	T	C	15	14	29	0	6	35	0	0
1	50848609	.	A	C	13	11	24	0	7	31	0	0
1	50848647	.	C	T	0	14	14	0	19	33	0	0
1	50848659	.	A	G	21	11	32	0	2	34	0	0
1	50848815	.	A	G	13	8	21	0	6	27	0	0
1	50848911	.	A	G	11	13	24	0	0	24	0	0
1	50848961	.	C	T	12	14	26	0	1	27	0	0
1	50849055	.	T	C	18	0	18	0	19	37	0	0
1	50849125	.	T	C	19	18	37	0	1	38	0	0
1	50849157	.	C	T	2	17	19	0	14	33	0	0
1	50849199	.	T	C	13	1	14	0	16	30	0	0
1	50849282	.	A	G	8	17	25	0	0	25	0	0
1	50849331	.	G	A	7	15	22	0	1	23	0	0
1	50849456	.	G	A	9	8	17	0	1	18	0	0
1	50849670	.	A	C	7	0	7	0	10	17	0	0
1	50849697	.	T	C	8	0	8	0	8	16	0	0
1	50849705	.	C	G	7	11	18	0	1	19	0	0
1	50850041	.	T	A	10	9	19	0	1	20	0	0
1	50850170	.	C	T	15	6	21	0	1	22	0	0
1	50858891	.	A	T	1	3	4	0	0	4	0	0
1	50929032	.	C	A	2	2	4	0	0	4	0	0
1	50929056	.	T	G	2	2	4	0	0	4	0	0
1	50969207	.	G	A	1	9	10	0	13	23	0	0
1	50977089	.	C	T	9	18	27	0	1	28	0	0
1	50977569	.	A	C	5	2	7	0	0	7	0	0
1	50977707	.	G	A	4	55	59	0	46	105	0	0
1	50979925	.	T	C	22	32	54	4	0	58	0	0
1	50985169	.	C	T	29	35	64	0	4	68	0	0
1	50986092	.	T	C	28	37	65	0	5	70	0	0
1	50986110	.	A	G	26	39	65	0	3	68	0	0
1	50986197	.	C	T	38	27	65	0	2	67	0	0
1	50987507	.	A	C	36	43	79	0	4	83	0	0
1	50990593	.	A	G	32	2	34	0	30	64	0	0
1	50990698	.	A	T	35	28	63	1	3	67	0	0
1	50990815	.	G	A	29	16	45	0	3	48	0	0
1	51021701	.	A	G	3	3	6	0	0	6	0	0
1	51021731	.	G	A	4	2	6	1	0	7	0	0
1	51024992	.	A	G	9	4	13	0	0	13	0	0
1	51029529	.	A	G	3	4	7	0	0	7	0	0
1	51038546	.	T	G	1	2	3	0	0	3	0	0
1	51038570	.	A	G	2	1	3	0	0	3	0	0
1	51039604	.	A	T	4	2	6	0	0	6	0	0
1	51041255	.	T	G	21	2	23	0	14	37	0	0
1	51041363	.	G	A	2	10	12	0	20	32	0	0
1	51042228	.	G	A	1	11	12	0	8	20	0	0
1	51049131	.	A	G	2	2	4	0	0	4	0	0
1	51052276	.	C	T	4	6	10	0	0	10	0	0
1	51052279	.	T	C	3	6	9	0	0	9	0	0
1	51053333	.	G	C	1	7	8	0	1	9	0	0
1	51055896	.	G	C	3	4	7	0	0	7	0	0
1	51058146	.	A	C	5	0	5	0	4	9	0	0
1	51229889	.	T	C	12	0	12	0	3	15	0	0
1	51230098	.	T	C	10	8	18	0	0	18	0	0
1	51230106	.	T	C	5	11	16	0	0	16	0	0
1	51230275	.	T	C	6	4	10	0	1	11	0	0
1	51230615	.	T	C	3	3	6	0	1	7	0	0
1	51230687	.	T	C	4	2	6	0	0	6	0	0
1	51371165	.	T	C	2	4	6	0	0	6	0	0
1	51371166	.	A	C	2	4	6	0	0	6	0	0
1	51372951	.	C	T	3	2	5	0	0	5	0	0
1	51373730	.	A	C	3	2	5	0	0	5	0	0
1	51373808	.	C	T	3	6	9	0	0	9	0	0
1	51373904	.	A	G	2	10	12	0	1	13	0	0
1	51373952	.	A	C	2	7	9	0	0	9	0	0
1	51375006	.	C	G	7	6	13	0	0	13	0	0
1	51375301	.	A	G	3	2	5	0	0	5	0	0
1	51377708	.	C	A	7	9	16	0	1	17	0	0
1	51377757	.	C	T	8	6	14	0	1	15	0	0
1	51377781	.	A	C	7	5	12	0	1	13	0	0
1	51377798	.	G	A	1	5	6	0	7	13	0	0
1	51386764	.	C	G	1	4	5	0	1	6	0	0
1	51395384	.	A	G	2	3	5	0	1	6	0	0
1	51397646	.	C	T	3	3	6	0	0	6	0	0
1	51397677	.	G	A	4	4	8	0	0	8	0	0
1	51397713	.	C	A	4	3	7	0	0	7	0	0
1	51397730	.	T	C	3	5	8	0	0	8	0	0
1	51398373	.	T	C	7	11	18	0	0	18	0	0
1	51400205	.	T	C	2	7	9	0	1	10	0	0
1	51403088	.	C	T	7	7	14	0	1	15	0	0
1	51403599	.	T	A	9	4	13	0	1	14	0	0
1	51403756	.	T	A	6	5	11	0	0	11	0	0
1	51403785	.	C	T	5	4	9	0	0	9	0	0
1	51403872	.	T	C	3	5	8	0	0	8	0	0
1	51405039	.	T	G	7	5	12	0	0	12	0	0
1	51405087	.	C	T	7	2	9	0	2	11	0	0
1	51405323	.	C	A	2	9	11	0	4	15	0	0
1	51405986	.	G	T	13	11	24	0	0	24	0	0
1	51406191	.	G	A	1	8	9	0	8	17	0	0
1	51406341	.	T	A	8	9	17	0	0	17	0	0
1	51406346	.	G	A	7	8	15	0	0	15	0	0
1	51406425	.	A	C	5	3	8	0	0	8	0	0
1	51406450	.	G	A	6	5	11	0	0	11	0	0
1	51413315	.	T	C	11	10	21	0	1	22	0	0
1	51425221	.	G	T	2	11	13	0	4	17	0	0
1	51425476	.	T	A	2	3	5	0	0	5	0	0
1	51426859	.	C	A	1	3	4	0	0	4	0	0
1	51426896	.	A	G	1	6	7	0	0	7	0	0
1	51426956	.	T	C	4	2	6	0	0	6	0	0
1	51427779	.	T	C	11	13	24	0	1	25	0	0
1	51427837	.	A	C	13	14	27	0	0	27	0	0
1	51444718	.	G	A	11	5	16	0	2	18	0	0
1	51445120	.	A	T	11	18	29	0	3	32	0	0
1	51445140	.	T	G	11	13	24	0	0	24	0	0
1	51445217	.	A	T	6	6	12	0	1	13	0	0
1	51445325	.	T	C	5	7	12	0	2	14	0	0
1	51445673	.	T	G	13	8	21	0	0	21	0	0
1	51445697	.	T	C	14	2	16	0	13	29	0	0
1	51445732	.	A	G	16	16	32	0	1	33	0	0
1	51445777	.	T	A	13	5	18	0	1	19	0	0
1	51446004	.	G	A	8	3	11	0	1	12	0	0
1	51446195	.	T	C	5	0	5	0	4	9	0	0
1	51446366	.	T	C	2	5	7	0	0	7	0	0
1	51446462	.	C	T	9	3	12	0	0	12	0	0
1	51446511	.	G	A	4	4	8	0	0	8	0	0
1	51446597	.	A	T	4	4	8	0	1	9	0	0
1	51446962	.	C	T	5	5	10	0	0	10	0	0
1	51446969	.	A	C	4	4	8	1	1	10	0	0
1	51447506	.	T	C	5	3	8	0	1	9	0	0
1	51447543	.	T	G	3	4	7	0	0	7	0	0
1	51447573	.	C	T	4	9	13	0	0	13	0	0
1	51447680	.	T	A	4	3	7	0	0	7	0	0
1	51447693	.	G	T	4	3	7	0	1	8	0	0
1	51447884	.	T	G	5	2	7	0	0	7	0	0
1	51447914	.	G	T	5	4	9	0	0	9	0	0
1	51447919	.	T	C	5	0	5	0	4	9	0	0
1	51448249	.	C	A	6	8	14	0	0	14	0	0
1	51448367	.	A	G	4	4	8	0	2	10	0	0
1	51448517	.	C	T	10	6	16	0	1	17	0	0
1	51448696	.	C	A	3	2	5	0	1	6	0	0
1	51448781	.	A	G	4	5	9	0	1	10	0	0
1	51448807	.	C	T	1	4	5	0	0	5	0	0
1	51448829	.	T	G	1	3	4	0	0	4	0	0
1	51449298	.	T	C	10	5	15	0	0	15	0	0
1	51449354	.	G	A	1	2	3	0	0	3	0	0
1	51449673	.	G	C	5	3	8	0	0	8	0	0
1	51449895	.	T	C	5	3	8	0	0	8	0	0
1	51450752	.	G	A	10	4	14	0	0	14	0	0
1	51524650	.	A	G	3	1	4	0	1	5	0	0
1	51557903	.	C	T	2	18	20	0	16	36	0	0
1	51558008	.	T	C	18	18	36	0	4	40	0	0
1	51558036	.	G	A	21	14	35	0	1	36	0	0
1	51558133	.	G	T	19	12	31	0	0	31	0	0
1	51558150	.	A	T	12	11	23	0	1	24	0	0
1	51558604	.	C	T	24	23	47	0	3	50	0	0
1	51558897	.	T	A	18	29	47	0	2	49	0	0
1	51559060	.	C	G	23	26	49	0	3	52	0	0
1	51559269	.	G	C	17	19	36	0	1	37	0	0
1	51559815	.	C	T	23	16	39	0	2	41	0	0
1	51562800	.	A	G	12	27	39	0	0	39	0	0
1	51562803	.	T	C	13	25	38	0	0	38	0	0
1	51567367	.	A	G	17	26	43	0	0	43	0	0
1	51591352	.	A	G	23	16	39	0	1	40	0	0
1	51591427	.	G	A	5	2	7	0	0	7	0	0
1	51593925	.	A	C	6	4	10	0	0	10	0	0
1	51593926	.	C	T	2	4	6	0	4	10	0	0
1	51594058	.	A	T	9	8	17	0	0	17	0	0
1	51594447	.	A	G	21	20	41	0	5	46	0	0
1	51594485	.	A	C	21	19	40	0	1	41	0	0
1	51594690	.	C	G	4	20	24	0	20	44	0	0
1	51594701	.	C	T	2	23	25	0	19	44	0	0
1	51606302	.	C	G	20	26	46	0	3	49	0	0
1	51608801	.	A	T	3	3	6	0	0	6	0	0
1	51608887	.	T	C	5	0	5	1	3	9	0	0
1	51609002	.	A	T	21	16	37	0	3	40	0	0
1	51615436	.	G	T	2	5	7	0	0	7	0	0
1	51684281	.	G	A	1	2	3	0	0	3	0	0
1	51702154	.	A	G	5	3	8	0	0	8	0	0
1	51702188	.	T	A	6	3	9	0	2	11	0	0
1	51702204	.	A	T	5	3	8	0	1	9	0	0
1	51702374	.	C	T	0	5	5	0	4	9	0	0
1	51709481	.	G	A	7	4	11	0	0	11	0	0
1	51710007	.	C	T	9	4	13	0	1	14	0	0
1	51719037	.	A	C	7	0	7	0	3	10	0	0
1	51723440	.	T	C	16	20	36	0	0	36	0	0
1	51723461	.	A	T	18	21	39	0	0	39	0	0
1	51729506	.	C	T	26	27	53	0	1	54	0	0
1	51729572	.	A	G	24	0	24	0	17	41	0	0
1	51729645	.	A	C	13	12	25	0	1	26	0	0
1	51729687	.	C	T	21	11	32	0	2	34	0	0
1	51729697	.	C	A	22	12	34	0	2	36	0	0
1	51729735	.	C	A	21	5	26	0	0	26	0	0
1	51729750	.	C	A	18	8	26	0	0	26	0	0
1	51729798	.	A	C	9	6	15	0	0	15	0	0
1	51734087	.	T	C	19	16	35	0	3	38	0	0
1	51734449	.	C	T	0	6	6	0	14	20	0	0
1	51961020	.	T	C	4	3	7	0	2	9	0	0
1	52073807	.	C	G	11	6	17	0	0	17	0	0
1	52111494	.	C	T	18	15	33	0	2	35	0	0
1	52113251	.	G	A	6	4	10	0	1	11	0	0
1	52115814	.	G	A	8	9	17	0	1	18	0	0
1	52115862	.	C	T	3	6	9	0	6	15	0	0
1	52117112	.	C	G	7	7	14	0	0	14	0	0
1	52121404	.	C	T	8	9	17	0	1	18	0	0
1	52121405	.	T	G	7	10	17	0	0	17	0	0
1	52124240	.	C	T	0	7	7	0	6	13	0	0
1	52128305	.	T	G	5	8	13	0	1	14	0	0
1	52130225	.	A	T	11	11	22	0	1	23	0	0
1	52130431	.	G	A	13	10	23	0	2	25	0	0
1	52135185	.	T	C	14	15	29	0	0	29	0	0
1	52135384	.	T	C	5	11	16	0	0	16	0	0
1	52135513	.	G	A	3	11	14	1	1	16	0	0
1	52135572	.	G	T	9	5	14	1	1	16	0	0
1	52135840	.	C	A	17	8	25	0	0	25	0	0
1	52135862	.	A	G	10	13	23	0	1	24	0	0
1	52135928	.	G	C	15	7	22	0	0	22	0	0
1	52136027	.	T	C	15	12	27	0	0	27	0	0
1	52136117	.	A	C	13	17	30	0	1	31	0	0
1	52136190	.	G	A	9	12	21	0	1	22	0	0
1	52136294	.	T	C	1	7	8	0	1	9	0	0
1	52136323	.	G	A	13	5	18	0	1	19	0	0
1	52136379	.	T	A	13	8	21	0	1	22	0	0
1	52136641	.	A	G	8	6	14	0	0	14	0	0
1	52136759	.	A	T	17	13	30	0	2	32	0	0
1	52136868	.	A	G	10	11	21	0	0	21	0	0
1	52136894	.	T	C	13	11	24	0	0	24	0	0
1	52136974	.	T	A	15	18	33	0	1	34	0	0
1	52137591	.	T	C	1	3	4	0	0	4	0	0
1	52139909	.	T	A	13	13	26	0	0	26	0	0
1	52149554	.	A	T	18	18	36	0	5	41	0	0
1	52149619	.	A	C	19	10	29	0	1	30	0	0
1	52149794	.	A	G	11	12	23	0	0	23	0	0
1	52149977	.	T	A	9	8	17	0	1	18	0	0
1	52150152	.	G	A	14	11	25	0	0	25	0	0
1	52150182	.	G	T	2	16	18	0	13	31	0	0
1	52150231	.	C	T	15	20	35	0	1	36	0	0
1	52150400	.	A	G	13	8	21	1	0	22	0	0
1	52150900	.	G	T	4	11	15	0	0	15	0	0
1	52150974	.	A	G	6	5	11	0	0	11	0	0
1	52151649	.	A	G	20	7	27	0	0	27	0	0
1	52151865	.	T	C	16	6	22	1	1	24	0	0
1	52151985	.	A	G	2	8	10	0	0	10	0	0
1	52152043	.	A	G	6	5	11	0	1	12	0	0
1	52152046	.	A	G	9	3	12	0	1	13	0	0
1	52152121	.	A	G	10	13	23	0	1	24	0	0
1	52152300	.	A	T	10	14	24	0	1	25	0	0
1	52152365	.	A	G	18	7	25	0	3	28	0	0
1	52152488	.	A	G	15	14	29	0	2	31	0	0
1	52152617	.	C	T	25	18	43	0	0	43	0	0
1	52178926	.	G	A	7	4	11	0	0	11	0	0
1	52179039	.	G	T	7	8	15	0	1	16	0	0
1	52179066	.	C	T	0	7	7	0	9	16	0	0
1	52198224	.	T	C	1	3	4	0	0	4	0	0
1	52198239	.	G	A	4	2	6	0	1	7	0	0
1	52452197	.	G	A	9	9	18	0	1	19	0	0
1	52452275	.	G	T	6	12	18	0	2	20	0	0
1	52455885	.	C	G	14	10	24	0	0	24	0	0
1	52455908	.	G	A	10	12	22	0	0	22	0	0
1	52455960	.	C	T	11	9	20	0	0	20	0	0
1	52456002	.	G	A	15	11	26	0	1	27	0	0
1	52460737	.	C	T	8	6	14	0	2	16	0	0
1	52460739	.	T	C	8	6	14	0	2	16	0	0
1	52460906	.	T	C	10	9	19	1	1	21	0	0
1	52460944	.	G	T	9	7	16	1	0	17	0	0
1	52461114	.	A	G	6	9	15	0	0	15	0	0
1	52461183	.	C	T	3	6	9	0	0	9	0	0
1	52461195	.	G	A	5	3	8	0	0	8	0	0
1	52475840	.	A	G	3	0	3	0	4	7	0	0
1	52475955	.	C	T	7	3	10	0	0	10	0	0
1	52478355	.	C	T	2	6	8	0	1	9	0	0
1	52478381	.	C	T	3	2	5	0	0	5	0	0
1	52478413	.	G	A	0	2	2	0	3	5	0	0
1	52478452	.	T	C	1	6	7	0	1	8	0	0
1	52478513	.	C	T	2	8	10	0	0	10	0	0
1	52478538	.	G	A	0	5	5	0	2	7	0	0
1	52478560	.	T	A	4	2	6	0	0	6	0	0
1	52478600	.	A	T	1	2	3	0	0	3	0	0
1	52486445	.	A	G	4	2	6	0	1	7	0	0
1	52489974	.	G	A	1	2	3	0	1	4	0	0
1	52501213	.	A	C	7	0	7	0	4	11	0	0
1	52501745	.	A	T	3	2	5	0	0	5	0	0
1	52505216	.	G	A	3	4	7	0	0	7	0	0
1	52535674	.	C	T	1	2	3	0	0	3	0	0
1	52538330	.	A	G	2	5	7	0	0	7	0	0
1	52538393	.	T	C	2	4	6	0	0	6	0	0
1	52606865	.	C	T	2	6	8	0	0	8	0	0
1	52609347	.	C	T	6	4	10	0	0	10	0	0
1	52609392	.	C	T	6	3	9	0	0	9	0	0
1	52610788	.	G	A	3	2	5	0	0	5	0	0
1	52611963	.	A	G	5	4	9	0	0	9	0	0
1	52612987	.	T	C	8	2	10	0	1	11	0	0
1	52613216	.	G	T	3	11	14	0	1	15	0	0
1	52614377	.	C	T	6	6	12	0	0	12	0	0
1	52614926	.	T	A	4	2	6	0	1	7	0	0
1	52615824	.	C	T	3	4	7	0	0	7	0	0
1	52618405	.	C	T	5	11	16	0	0	16	0	0
1	52625747	.	C	G	9	0	9	0	11	20	0	0
1	52625804	.	T	C	7	7	14	5	0	19	0	0
1	52626360	.	T	A	13	7	20	0	0	20	0	0
1	52626826	.	T	A	6	4	10	0	0	10	0	0
1	52626923	.	C	T	4	5	9	0	2	11	0	0
1	52627290	.	C	T	10	8	18	2	1	21	0	0
1	52627572	.	G	A	2	19	21	0	23	44	0	0
1	52627609	.	A	T	17	25	42	0	1	43	0	0
1	52627678	.	A	T	18	19	37	0	2	39	0	0
1	52627679	.	C	T	18	17	35	0	3	38	0	0
1	52628253	.	G	T	9	15	24	0	0	24	0	0
1	52628305	.	T	C	10	9	19	0	0	19	0	0
1	52648944	.	G	C	2	2	4	0	0	4	0	0
1	52649141	.	T	C	2	2	4	0	0	4	0	0
1	52653899	.	T	C	2	3	5	0	1	6	0	0
1	52656201	.	C	A	1	3	4	0	1	5	0	0
1	52656219	.	T	C	3	3	6	0	0	6	0	0
1	52657799	.	T	G	2	4	6	0	1	7	0	0
1	52676495	.	G	A	1	3	4	0	0	4	0	0
1	52681296	.	C	A	4	5	9	0	0	9	0	0
1	52682910	.	C	T	8	5	13	0	1	14	0	0
1	52685099	.	G	A	1	4	5	0	3	8	0	0
1	52688151	.	C	T	6	6	12	0	1	13	0	0
1	52688274	.	G	A	9	4	13	0	1	14	0	0
1	52688286	.	T	C	7	4	11	0	0	11	0	0
1	52698944	.	G	T	10	9	19	0	1	20	0	0
1	52698955	.	C	T	14	9	23	0	1	24	0	0
1	52764824	.	A	T	5	10	15	0	1	16	0	0
1	52764914	.	C	T	13	15	28	0	0	28	0	0
1	52773239	.	G	A	14	12	26	0	1	27	0	0
1	52773311	.	A	G	9	11	20	0	2	22	0	0
1	52775619	.	A	C	13	11	24	0	3	27	0	0
1	52779785	.	G	A	13	10	23	0	1	24	0	0
1	52782161	.	G	A	13	14	27	0	0	27	0	0
1	52782220	.	G	T	13	8	21	0	1	22	0	0
1	52784549	.	A	T	4	8	12	0	1	13	0	0
1	52784624	.	T	A	6	4	10	0	0	10	0	0
1	52792476	.	C	A	6	7	13	0	0	13	0	0
1	53865858	.	A	T	2	2	4	0	0	4	0	0
1	53865870	.	C	A	1	2	3	0	0	3	0	0
1	53865898	.	A	T	1	3	4	0	0	4	0	0
1	53865958	.	T	C	1	0	1	0	2	3	0	0
1	53866020	.	T	C	6	5	11	0	0	11	0	0
1	53866041	.	T	C	9	6	15	0	1	16	0	0
1	53866075	.	C	T	10	7	17	0	1	18	0	0
1	53866120	.	A	T	6	9	15	0	0	15	0	0
1	53866128	.	T	C	5	7	12	0	1	13	0	0
1	53866319	.	C	T	1	6	7	0	9	16	0	0
1	53871326	.	T	A	7	6	13	0	1	14	0	0
1	53871416	.	C	A	2	9	11	0	0	12	1	0
1	53872031	.	C	A	9	10	19	0	0	19	0	0
1	53872061	.	C	T	9	9	18	0	0	18	0	0
1	53872067	.	T	C	8	0	8	0	9	17	0	0
1	53873112	.	T	C	4	0	4	0	8	12	0	0
1	53873173	.	C	T	0	5	5	0	9	14	0	0
1	53873177	.	T	C	9	0	9	0	6	15	0	0
1	53879314	.	T	A	4	3	7	0	2	9	0	0
1	53879353	.	C	T	0	5	5	0	5	10	0	0
1	53879397	.	C	T	3	6	9	0	0	9	0	0
1	53879731	.	T	C	3	0	3	0	5	8	0	0
1	53879767	.	G	A	1	3	4	0	0	4	0	0
1	53912019	.	G	A	2	2	4	0	0	4	0	0
1	53912148	.	A	G	3	4	7	0	1	8	0	0
1	53912307	.	A	G	1	2	3	0	0	3	0	0
1	53912607	.	T	C	3	0	3	0	8	11	0	0
1	53912670	.	A	G	2	3	5	0	0	5	0	0
1	53912691	.	A	G	1	2	3	0	0	3	0	0
1	53913130	.	G	A	1	3	4	0	0	4	0	0
1	53916931	.	T	A	1	3	4	0	0	4	0	0
1	53918671	.	C	T	0	2	2	0	1	3	0	0
1	53919219	.	C	G	2	3	5	0	0	5	0	0
1	53919228	.	G	T	1	3	4	0	0	4	0	0
1	53926940	.	G	T	3	4	7	0	0	7	0	0
1	53929298	.	A	G	1	2	3	0	0	3	0	0
1	53930468	.	T	C	4	3	7	0	1	8	0	0
1	53932271	.	A	G	4	4	8	0	1	9	0	0
1	53934495	.	C	A	6	2	8	0	0	8	0	0
1	53935236	.	G	A	8	3	11	0	0	11	0	0
1	53935248	.	G	T	1	3	4	0	9	13	0	0
1	53935287	.	A	G	10	0	10	0	5	15	0	0
1	53935314	.	T	C	9	7	16	0	0	16	0	0
1	53935335	.	C	T	7	7	14	0	1	15	0	0
1	53937423	.	C	T	8	5	13	0	0	13	0	0
1	53939430	.	A	G	3	7	10	0	0	10	0	0
1	53939604	.	C	T	4	5	9	0	1	10	0	0
1	53953276	.	G	T	5	2	7	0	0	7	0	0
1	53954314	.	G	A	1	3	4	0	9	13	0	0
1	53954361	.	C	A	9	7	16	0	0	16	0	0
1	53954385	.	A	C	10	5	15	0	0	15	0	0
1	53955055	.	G	A	7	11	18	0	1	19	0	0
1	53958136	.	G	A	0	7	7	0	17	24	0	0
1	53958263	.	C	T	20	11	31	0	1	32	0	0
1	53962227	.	A	T	21	10	31	0	1	32	0	0
1	53962264	.	T	C	15	10	25	0	2	27	0	0
1	53962490	.	T	G	15	6	21	0	0	21	0	0
1	53962606	.	T	A	4	6	10	0	1	11	0	0
1	53962860	.	G	A	0	11	11	0	13	24	0	0
1	53962863	.	C	T	12	10	22	0	2	24	0	0
1	53962900	.	T	A	16	7	23	0	1	24	0	0
1	53963108	.	C	A	16	6	22	0	1	23	0	0
1	53963159	.	C	T	14	10	24	0	2	26	0	0
1	53963782	.	A	G	3	6	9	0	0	9	0	0
1	53980283	.	A	G	2	4	6	0	0	6	0	0
1	53980293	.	A	G	2	5	7	0	0	7	0	0
1	53980327	.	T	C	1	3	4	0	0	4	0	0
1	53982990	.	C	T	4	4	8	0	0	8	0	0
1	53987670	.	A	G	2	3	5	0	0	5	0	0
1	53987682	.	T	G	1	2	3	0	0	3	0	0
1	54025424	.	C	T	4	2	6	0	0	6	0	0
1	54025468	.	T	A	2	2	4	0	0	4	0	0
1	54048786	.	G	A	2	5	7	0	1	8	0	0
1	54061812	.	C	T	5	3	8	0	0	8	0	0
1	54061824	.	C	T	4	3	7	0	0	7	0	0
1	54062754	.	G	A	17	18	35	2	4	41	0	0
1	54062858	.	A	G	15	11	26	0	3	29	0	0
1	54063478	.	C	T	1	3	4	0	0	4	0	0
1	54069513	.	G	T	3	2	5	0	0	5	0	0
1	54069515	.	C	A	3	2	5	0	0	5	0	0
1	54077472	.	T	C	4	2	6	0	0	6	0	0
1	54080067	.	A	T	1	4	5	0	0	5	0	0
1	54080098	.	T	C	1	4	5	0	0	5	0	0
1	54080189	.	T	G	3	1	4	0	2	6	0	0
1	54080253	.	G	C	6	4	10	0	0	10	0	0
1	54080261	.	C	T	6	4	10	0	0	10	0	0
1	54080361	.	T	G	2	3	5	0	0	5	0	0
1	54080516	.	T	C	5	4	9	0	0	9	0	0
1	54080550	.	T	G	2	0	2	0	6	8	0	0
1	54137238	.	A	G	0	6	6	0	2	8	0	0
1	54140472	.	A	T	4	5	9	0	0	9	0	0
1	54142097	.	T	C	8	7	15	0	1	16	0	0
1	54142130	.	G	T	1	10	11	0	7	18	0	0
1	54144024	.	T	G	6	5	11	0	2	13	0	0
1	54146383	.	C	T	14	9	23	0	0	23	0	0
1	54146416	.	T	C	13	9	22	0	2	24	0	0
1	54154371	.	T	C	3	0	3	0	5	8	0	0
1	54154383	.	T	G	4	4	8	0	1	9	0	0
1	54167496	.	A	C	2	3	5	0	0	5	0	0
1	54167551	.	T	C	1	0	1	0	4	5	0	0
1	54167596	.	G	T	2	2	4	0	0	4	0	0
1	54182416	.	T	A	5	1	6	0	0	6	0	0
1	54182419	.	A	G	4	2	6	0	0	6	0	0
1	54184468	.	C	T	7	5	12	0	0	12	0	0
1	54189017	.	T	C	1	0	1	0	3	4	0	0
1	54190585	.	T	A	4	2	6	0	0	6	0	0
1	54197431	.	G	A	2	2	4	0	0	4	0	0
1	54219462	.	A	G	3	0	3	0	4	7	0	0
1	54221930	.	T	C	2	2	4	1	0	5	0	0
1	54221936	.	T	C	2	2	4	1	0	5	0	0
1	54244041	.	T	C	2	5	7	0	0	7	0	0
1	54244432	.	T	C	2	5	7	0	1	8	0	0
1	54245914	.	G	A	7	4	11	0	0	11	0	0
1	54248366	.	A	C	7	6	13	0	0	13	0	0
1	54253768	.	G	A	1	10	11	0	6	17	0	0
1	54255651	.	C	T	6	10	16	0	2	18	0	0
1	54262843	.	G	A	5	5	10	0	1	11	0	0
1	54274554	.	A	G	8	7	15	0	0	15	0	0
1	54614057	.	A	G	1	2	3	0	0	3	0	0
1	54621763	.	G	T	1	3	4	0	1	5	0	0
1	54621776	.	A	T	1	3	4	0	1	5	0	0
1	54674388	.	A	G	5	3	8	0	1	9	0	0
1	54674430	.	A	G	5	0	5	0	7	12	0	0
1	54677238	.	A	G	1	0	1	0	11	12	0	0
1	54683743	.	C	T	12	10	22	0	0	22	0	0
1	54685468	.	T	A	9	3	12	0	0	12	0	0
1	54685559	.	C	G	7	5	12	0	2	14	0	0
1	54685590	.	A	G	3	6	9	1	0	10	0	0
1	54685610	.	T	C	4	5	9	1	1	11	0	0
1	54687580	.	C	T	3	8	11	0	0	11	0	0
1	54687649	.	G	T	6	10	16	0	0	16	0	0
1	54687715	.	C	A	5	9	14	1	0	15	0	0
1	54687756	.	A	C	6	11	17	1	0	18	0	0
1	54687766	.	A	C	6	7	13	1	1	15	0	0
1	54687798	.	A	C	9	11	20	0	0	20	0	0
1	54687981	.	A	G	7	4	11	0	1	12	0	0
1	54689329	.	T	C	7	8	15	0	1	16	0	0
1	54693953	.	C	A	5	2	7	0	0	7	0	0
1	54701201	.	C	G	2	6	8	0	5	13	0	0
1	54701231	.	G	A	5	5	10	0	0	10	0	0
1	54703424	.	A	C	7	4	11	0	0	11	0	0
1	54703469	.	C	T	0	5	5	0	11	16	0	0
1	54707977	.	G	A	29	37	66	0	1	67	0	0
1	54708098	.	G	T	43	23	66	0	2	68	0	0
1	54708191	.	C	A	31	22	53	0	4	57	0	0
1	54708253	.	G	A	29	34	63	0	7	70	0	0
1	54708281	.	A	T	32	33	65	0	3	68	0	0
1	54708301	.	A	C	42	28	70	0	1	71	0	0
1	54708317	.	C	T	38	26	64	0	4	68	0	0
1	54708359	.	C	T	32	27	59	0	2	61	0	0
1	54708780	.	T	C	16	8	24	0	1	25	0	0
1	54708942	.	T	C	20	0	20	0	8	28	0	0
1	54708946	.	T	C	13	10	23	0	0	23	0	0
1	54708989	.	T	C	4	13	17	1	1	19	0	0
1	54709071	.	T	C	10	0	10	0	9	19	0	0
1	54709110	.	T	A	10	6	16	0	0	16	0	0
1	54709112	.	A	G	9	5	14	0	2	16	0	0
1	54709334	.	G	A	31	23	54	0	3	57	0	0
1	54731890	.	A	C	1	2	3	0	0	3	0	0
1	54737684	.	A	G	4	1	5	0	3	8	0	0
1	54747720	.	T	C	3	4	7	0	0	7	0	0
1	54747729	.	A	G	2	0	2	0	4	6	0	0
1	54747786	.	A	C	3	2	5	0	0	5	0	0
1	54748062	.	T	G	1	0	1	0	2	3	0	0
1	54750104	.	A	G	4	0	4	0	4	8	0	0
1	54750254	.	A	G	2	0	2	0	5	7	0	0
1	54750500	.	G	A	0	2	2	0	3	5	0	0
1	54753095	.	T	G	3	0	3	1	8	12	0	0
1	54753101	.	T	C	4	6	10	1	0	11	0	0
1	54753167	.	A	G	7	6	13	0	1	14	0	0
1	54753173	.	G	C	0	7	7	0	8	15	0	0
1	54753615	.	G	A	3	3	6	0	0	6	0	0
1	54753623	.	T	G	3	3	6	0	0	6	0	0
1	54753654	.	A	C	1	3	4	0	0	4	0	0
1	54753918	.	C	A	6	2	8	2	1	11	0	0
1	54754356	.	C	T	12	8	20	0	0	20	0	0
1	54754482	.	T	G	6	8	14	0	0	14	0	0
1	54754503	.	G	A	6	5	11	0	0	11	0	0
1	54754744	.	C	T	7	2	9	0	1	10	0	0
1	54754754	.	T	C	6	8	14	0	1	15	0	0
1	54758624	.	A	T	5	6	11	0	0	11	0	0
1	54758725	.	C	T	2	8	10	0	23	33	0	0
1	54758810	.	C	T	12	16	28	0	0	28	0	0
1	54758975	.	T	C	21	12	33	0	0	33	0	0
1	54759065	.	G	A	13	22	35	1	1	37	0	0
1	54762947	.	G	A	20	17	37	0	1	38	0	0
1	54762997	.	G	T	17	13	30	0	0	30	0	0
1	54763022	.	G	C	12	14	26	0	0	26	0	0
1	54763070	.	C	G	1	16	17	0	7	24	0	0
1	54763106	.	A	G	6	12	18	0	0	18	0	0
1	54763133	.	T	C	4	8	12	0	1	13	0	0
1	54763182	.	A	G	11	11	22	0	1	23	0	0
1	54763187	.	G	A	13	14	27	0	0	27	0	0
1	54763298	.	G	A	14	12	26	0	0	26	0	0
1	54765216	.	A	C	22	0	22	0	20	42	0	0
1	54765218	.	C	T	0	15	15	0	26	41	0	0
1	54773988	.	G	C	1	3	4	0	0	4	0	0
1	54774007	.	A	G	1	4	5	0	0	5	0	0
1	54777359	.	C	A	3	3	6	1	0	7	0	0
1	54889912	.	G	C	2	2	4	0	0	4	0	0
1	54893126	.	C	G	2	4	6	0	1	7	0	0
1	54893140	.	G	A	0	3	3	0	3	6	0	0
1	54897256	.	C	T	4	4	8	0	0	8	0	0
1	54898178	.	G	A	0	3	3	0	3	6	0	0
1	54906069	.	T	C	13	5	18	0	0	18	0	0
1	54906162	.	G	A	1	4	5	0	5	10	0	0
1	54906192	.	T	C	6	4	10	0	0	10	0	0
1	54906476	.	G	C	0	8	8	0	2	10	0	0
1	54906619	.	T	A	5	6	11	0	1	12	0	0
1	54907021	.	G	A	4	4	8	0	1	9	0	0
1	54907074	.	G	A	5	2	7	0	0	7	0	0
1	54907077	.	T	A	5	2	7	0	0	7	0	0
1	54907367	.	T	G	4	5	9	0	0	9	0	0
1	54907502	.	A	G	7	5	12	0	0	12	0	0
1	54907549	.	T	C	10	10	20	0	0	20	0	0
1	54907585	.	G	C	15	5	20	0	0	20	0	0
1	54907600	.	A	T	14	7	21	0	1	22	0	0
1	54907622	.	T	C	16	6	22	0	0	22	0	0
1	54907698	.	G	T	5	5	10	0	0	10	0	0
1	54907707	.	C	T	4	5	9	0	1	10	0	0
1	54909104	.	C	G	1	0	1	0	3	4	0	0
1	54927198	.	T	C	18	8	26	0	3	29	0	0
1	54929168	.	G	A	10	16	26	3	0	29	0	0
1	54929256	.	T	C	6	11	17	0	1	18	0	0
1	54929281	.	G	A	0	12	12	0	8	20	0	0
1	54929293	.	C	T	9	13	22	0	2	24	0	0
1	54929373	.	C	G	7	3	10	0	1	11	0	0
1	54929994	.	T	C	10	6	16	0	0	16	0	0
1	54930428	.	T	A	8	7	15	0	2	17	0	0
1	54930486	.	G	A	13	7	20	1	1	22	0	0
1	54930598	.	A	G	8	15	23	0	1	24	0	0
1	54930626	.	A	C	6	12	18	0	2	20	0	0
1	54930693	.	T	C	10	13	23	0	1	24	0	0
1	54930711	.	G	A	9	11	20	0	0	20	0	0
1	54930776	.	A	G	5	15	20	0	1	21	0	0
1	54930868	.	C	A	13	3	16	0	1	18	1	0
1	54931111	.	T	C	8	13	21	0	0	21	0	0
1	54931122	.	G	A	0	13	13	0	7	20	0	0
1	54931211	.	A	T	10	11	21	0	1	22	0	0
1	54931230	.	T	A	13	8	21	0	3	24	0	0
1	54931791	.	G	C	4	11	15	0	13	28	0	0
1	54934658	.	T	G	1	2	3	0	0	3	0	0
1	54934690	.	T	C	1	4	5	0	0	5	0	0
1	54934694	.	G	T	1	4	5	0	1	6	0	0
1	54936235	.	G	T	12	20	32	0	3	35	0	0
1	54936471	.	T	C	17	1	18	0	18	36	0	0
1	54938274	.	T	C	7	17	24	1	0	25	0	0
1	54939536	.	A	T	5	14	19	0	2	21	0	0
1	54941036	.	G	A	7	8	15	0	0	15	0	0
1	54943139	.	G	A	2	4	6	0	1	7	0	0
1	54943160	.	A	G	4	6	10	0	0	10	0	0
1	54943178	.	G	A	4	7	11	0	1	12	0	0
1	54945039	.	A	G	1	5	6	0	0	6	0	0
1	54950534	.	T	C	9	10	19	0	1	20	0	0
1	54950572	.	G	A	8	7	15	0	4	19	0	0
1	54950661	.	G	A	15	9	24	0	0	24	0	0
1	54950745	.	G	T	6	8	14	0	0	14	0	0
1	54950801	.	A	G	6	9	15	0	0	15	0	0
1	54955207	.	G	A	10	9	19	0	0	19	0	0
1	54955234	.	A	G	8	11	19	0	4	23	0	0
1	54960328	.	A	G	8	8	16	0	0	16	0	0
1	54960368	.	T	G	15	12	27	0	1	28	0	0
1	54960416	.	A	C	22	17	39	0	1	40	0	0
1	54960563	.	T	A	19	19	38	0	4	42	0	0
1	54960881	.	A	G	16	24	40	0	3	43	0	0
1	54962466	.	A	G	21	21	42	0	2	44	0	0
1	54963314	.	A	G	17	18	35	0	2	37	0	0
1	54964724	.	A	G	11	18	29	0	0	29	0	0
1	54968253	.	A	T	9	6	15	0	1	16	0	0
1	54974321	.	C	T	1	3	4	0	1	5	0	0
1	54974437	.	C	A	8	7	15	0	0	15	0	0
1	54974438	.	A	G	8	7	15	0	0	15	0	0
1	54974477	.	G	A	7	5	12	0	1	13	0	0
1	54974500	.	T	A	8	6	14	0	0	14	0	0
1	54974538	.	A	G	11	6	17	0	1	18	0	0
1	54974660	.	T	C	4	6	10	1	1	12	0	0
1	54974774	.	G	A	7	9	16	0	1	17	0	0
1	54974810	.	G	T	8	7	15	0	3	18	0	0
1	54975136	.	A	T	9	6	15	3	1	19	0	0
1	54975284	.	C	G	5	2	7	0	0	7	0	0
1	54975286	.	C	T	4	1	5	0	1	6	0	0
1	54975431	.	C	T	7	2	9	0	3	12	0	0
1	54975484	.	G	T	9	9	18	0	0	18	0	0
1	54975519	.	C	T	11	10	21	0	0	21	0	0
1	54975636	.	C	T	8	9	17	0	0	17	0	0
1	54975658	.	A	G	5	6	11	0	2	13	0	0
1	54975762	.	A	T	8	9	17	0	1	18	0	0
1	54975884	.	A	G	4	10	14	1	0	15	0	0
1	54975911	.	G	A	3	5	8	0	1	9	0	0
1	54976026	.	T	A	3	9	12	0	0	12	0	0
1	54976035	.	T	A	3	11	14	0	0	14	0	0
1	54976104	.	G	A	1	4	5	0	1	6	0	0
1	54976178	.	T	C	7	0	7	0	6	13	0	0
1	54976249	.	T	A	7	14	21	0	0	21	0	0
1	54976256	.	C	T	7	15	22	0	0	22	0	0
1	54976731	.	C	T	5	4	9	0	0	9	0	0
1	54976732	.	A	G	5	4	9	0	0	9	0	0
1	54976827	.	T	C	4	3	7	0	0	7	0	0
1	54976835	.	C	T	3	3	6	0	0	6	0	0
1	54977363	.	T	C	5	0	5	0	4	9	0	0
1	54977375	.	T	C	6	4	10	0	0	10	0	0
1	54977572	.	G	A	3	3	6	0	0	6	0	0
1	54977697	.	G	A	4	5	9	0	1	10	0	0
1	54977719	.	T	A	5	3	8	0	1	9	0	0
1	54977767	.	A	T	5	2	7	0	3	10	0	0
1	54977781	.	A	G	5	5	10	0	0	10	0	0
1	54977842	.	C	A	1	2	3	0	0	3	0	0
1	54978022	.	T	G	8	7	15	0	0	15	0	0
1	54978023	.	C	T	1	6	7	0	8	15	0	0
1	54978478	.	T	C	1	3	4	0	0	4	0	0
1	54981628	.	G	A	3	3	6	0	0	6	0	0
1	54984172	.	A	G	3	2	5	0	1	6	0	0
1	54984587	.	C	T	7	5	12	0	0	12	0	0
1	54985320	.	C	T	4	5	9	0	0	9	0	0
1	54987539	.	A	G	4	4	8	0	0	8	0	0
1	54988190	.	T	G	4	3	7	0	0	7	0	0
1	54988259	.	G	A	2	4	6	0	0	6	0	0
1	54997275	.	T	C	6	1	7	0	4	11	0	0
1	54997327	.	T	C	6	2	8	0	2	10	0	0
1	55008322	.	A	G	13	6	19	0	2	21	0	0
1	55008382	.	C	T	19	8	27	0	1	28	0	0
1	55008405	.	G	A	17	7	24	0	0	24	0	0
1	55008594	.	A	T	14	8	22	0	3	25	0	0
1	55008772	.	T	C	16	17	33	0	3	36	0	0
1	55009618	.	A	G	10	3	13	0	2	15	0	0
1	55011101	.	T	A	5	4	9	0	1	10	0	0
1	55011117	.	T	C	7	4	11	0	0	11	0	0
1	55011353	.	G	C	1	7	8	0	0	8	0	0
1	55011514	.	C	T	7	7	14	0	0	14	0	0
1	55011539	.	A	T	11	7	18	0	0	18	0	0
1	55011550	.	G	A	10	7	17	0	1	18	0	0
1	55011692	.	C	T	2	9	11	0	4	15	0	0
1	55018538	.	G	A	5	3	8	0	0	8	0	0
1	55018914	.	A	G	3	3	6	0	0	6	0	0
1	55018941	.	A	G	2	4	6	0	0	6	0	0
1	55021862	.	A	T	1	3	4	0	0	4	0	0
1	55021886	.	G	A	1	1	2	0	1	3	0	0
1	55022162	.	T	A	2	4	6	0	1	7	0	0
1	55032657	.	A	G	0	3	3	0	1	4	0	0
1	55033734	.	A	G	1	2	3	0	0	3	0	0
1	55037612	.	C	T	4	2	6	0	0	6	0	0
1	55037627	.	T	G	3	2	5	0	0	5	0	0
1	55038186	.	G	A	6	3	9	0	0	9	0	0
1	55038249	.	A	G	2	2	4	0	0	4	0	0
1	55046494	.	G	A	1	3	4	0	0	4	0	0
1	55046509	.	G	A	1	3	4	0	1	5	0	0
1	55046541	.	A	G	1	7	8	0	0	8	0	0
1	55049427	.	C	A	0	2	2	0	1	3	0	0
1	55049456	.	T	C	1	0	1	0	3	4	0	0
1	55056240	.	C	T	1	2	3	0	0	3	0	0
1	55080893	.	G	C	2	5	7	0	0	7	0	0
1	55080905	.	A	G	2	5	7	0	0	7	0	0
1	55084464	.	G	A	2	3	5	0	0	5	0	0
1	55085830	.	A	T	3	4	7	0	1	8	0	0
1	55087742	.	T	C	1	4	5	0	0	5	0	0
1	55087823	.	G	C	2	3	5	0	0	5	0	0
1	55088467	.	T	A	6	2	8	0	1	9	0	0
1	55089078	.	T	A	3	6	9	2	0	11	0	0
1	55089115	.	G	T	0	1	1	2	3	6	0	0
1	55089120	.	G	T	1	2	3	2	1	6	0	0
1	55089152	.	C	G	1	2	3	0	0	3	0	0
1	55089316	.	G	A	0	5	5	1	7	13	0	0
1	55089328	.	G	A	5	7	12	0	0	12	0	0
1	55089396	.	C	T	3	8	11	0	1	12	0	0
1	55099139	.	T	C	4	6	10	0	0	10	0	0
1	55099214	.	A	C	8	6	14	0	0	14	0	0
1	55099472	.	T	C	7	7	14	0	0	14	0	0
1	55099772	.	C	T	6	7	13	0	0	13	0	0
1	55099880	.	C	G	3	10	13	0	0	13	0	0
1	55099952	.	C	T	4	11	15	0	1	16	0	0
1	55100018	.	T	C	5	12	17	0	0	17	0	0
1	55100378	.	G	A	0	8	8	0	12	20	0	0
1	55100422	.	T	A	10	13	23	0	0	23	0	0
1	55100456	.	T	C	7	12	19	0	0	19	0	0
1	55101322	.	G	T	10	10	20	0	2	22	0	0
1	55101358	.	C	T	11	13	24	0	2	26	0	0
1	55101439	.	C	A	8	11	19	0	1	20	0	0
1	55101445	.	C	G	10	12	22	0	0	22	0	0
1	55103160	.	A	G	15	18	33	0	1	34	0	0
1	55105727	.	T	C	10	4	14	0	2	16	0	0
1	55108059	.	A	T	10	6	16	0	1	17	0	0
1	55108065	.	T	C	12	6	18	0	1	19	0	0
1	55109717	.	A	T	6	10	16	0	0	16	0	0
1	55126626	.	A	C	5	0	5	0	10	15	0	0
1	55129864	.	A	C	5	0	5	0	13	18	0	0
1	55144350	.	A	G	2	1	3	0	0	3	0	0
1	55144357	.	A	G	2	0	2	0	2	4	0	0
1	55161252	.	T	C	7	0	7	0	2	9	0	0
1	55161257	.	A	T	6	2	8	0	0	8	0	0
1	55161431	.	A	G	3	9	12	0	0	12	0	0
1	55161440	.	A	G	2	7	9	0	1	10	0	0
1	55161467	.	C	G	3	8	11	0	0	11	0	0
1	55169349	.	G	C	6	8	14	0	1	15	0	0
1	55169658	.	T	A	12	10	22	0	1	23	0	0
1	55169662	.	A	G	12	9	21	0	0	21	0	0
1	55169699	.	T	A	18	2	20	0	0	20	0	0
1	55169713	.	A	T	18	3	21	0	0	21	0	0
1	55169756	.	A	G	15	4	19	0	2	21	0	0
1	55169839	.	G	C	11	4	15	0	3	18	0	0
1	55169961	.	T	C	12	0	12	3	10	25	0	0
1	55169980	.	A	G	10	9	19	3	0	22	0	0
1	55169999	.	C	T	9	9	18	0	1	19	0	0
1	55170056	.	G	T	10	7	17	0	2	19	0	0
1	55170264	.	C	T	15	6	21	0	0	21	0	0
1	55170804	.	T	C	8	11	19	0	0	19	0	0
1	55171249	.	G	A	17	14	31	0	0	31	0	0
1	55176698	.	A	G	4	11	15	0	1	16	0	0
1	55178808	.	A	G	8	4	12	0	0	12	0	0
1	55179434	.	C	T	4	8	12	0	0	12	0	0
1	55179470	.	C	T	5	2	7	0	0	7	0	0
1	55180229	.	A	G	8	4	12	0	0	12	0	0
1	55180278	.	G	C	8	1	9	0	6	15	0	0
1	55182626	.	G	T	3	5	8	0	1	9	0	0
1	55182656	.	T	C	5	5	10	0	0	10	0	0
1	55182685	.	T	C	5	5	10	0	0	10	0	0
1	55182720	.	T	C	6	10	16	0	0	16	0	0
1	55182743	.	C	T	5	9	14	0	1	15	0	0
1	55182811	.	A	G	5	5	10	0	0	10	0	0
1	55182876	.	A	T	6	6	12	0	1	13	0	0
1	55191219	.	T	A	4	2	6	0	0	6	0	0
1	55191256	.	A	T	4	3	7	0	0	7	0	0
1	55191467	.	C	T	0	4	4	0	8	12	0	0
1	55191471	.	T	C	9	0	9	0	4	13	0	0
1	55195309	.	T	C	8	0	8	0	6	14	0	0
1	55195384	.	G	T	10	8	18	0	0	18	0	0
1	55195414	.	G	A	7	8	15	0	2	17	0	0
1	55195952	.	T	G	5	10	15	0	1	16	0	0
1	55196024	.	G	T	7	8	15	0	0	15	0	0
1	55196045	.	T	C	7	0	7	0	6	13	0	0
1	55197805	.	T	C	8	4	12	0	0	12	0	0
1	55223213	.	C	T	3	5	8	0	0	8	0	0
1	55223241	.	G	C	7	6	13	0	0	13	0	0
1	55226931	.	T	C	3	5	8	0	0	8	0	0
1	55228575	.	C	T	2	3	5	0	0	5	0	0
1	55228601	.	C	T	0	3	3	0	2	5	0	0
1	55229456	.	A	G	3	4	7	0	2	9	0	0
1	55229531	.	T	A	1	2	3	0	0	3	0	0
1	55229767	.	T	C	5	4	9	0	0	9	0	0
1	55233436	.	C	T	3	3	6	0	0	6	0	0
1	55233824	.	G	A	2	3	5	0	0	5	0	0
1	55233833	.	C	T	3	3	6	0	0	6	0	0
1	55234161	.	A	G	1	3	4	0	0	4	0	0
1	55235177	.	G	A	1	2	3	0	0	3	0	0
1	55235195	.	G	A	1	2	3	0	0	3	0	0
1	55235276	.	A	G	2	2	4	0	0	4	0	0
1	55264135	.	T	C	5	4	9	0	1	10	0	0
1	55264187	.	G	C	4	9	13	0	0	13	0	0
1	55264191	.	A	C	4	8	12	0	0	12	0	0
1	55264225	.	C	T	4	4	8	0	0	8	0	0
1	55264366	.	C	T	6	6	12	0	0	12	0	0
1	55264575	.	T	A	14	15	29	0	2	31	0	0
1	55297885	.	C	T	2	2	4	0	0	4	0	0
1	55748355	.	C	T	1	2	3	0	2	5	0	0
1	55762664	.	C	A	10	10	20	1	2	23	0	0
1	55772026	.	C	T	17	18	35	0	2	37	0	0
1	55776813	.	G	A	7	24	31	0	21	52	0	0
1	55776858	.	G	A	4	15	19	0	25	44	0	0
1	55776909	.	A	C	14	7	21	0	2	28	5	0
1	55776962	.	T	A	23	19	42	0	0	43	1	0
1	55777008	.	A	T	21	20	41	0	2	43	0	0
1	55783978	.	T	C	33	28	61	0	2	63	0	0
1	55785527	.	C	A	5	31	36	0	25	61	0	0
1	55785577	.	A	G	37	31	68	0	2	70	0	0
1	55785596	.	T	C	21	24	45	0	5	50	0	0
1	55785654	.	C	T	13	22	35	0	0	35	0	0
1	55785697	.	C	T	8	7	15	0	0	15	0	0
1	55787173	.	A	G	4	3	7	0	0	7	0	0
1	55787300	.	C	T	0	2	2	0	5	7	0	0
1	55789456	.	C	T	7	4	11	0	2	13	0	0
1	55789504	.	A	C	3	0	3	0	3	6	0	0
1	55789549	.	C	A	6	3	9	0	2	11	0	0
1	55799444	.	A	G	2	2	4	0	0	4	0	0
1	55817728	.	C	T	6	4	10	0	0	10	0	0
1	55817753	.	G	A	7	5	12	0	0	12	0	0
1	55824892	.	C	G	6	3	9	0	0	9	0	0
1	55833139	.	G	C	2	4	6	0	0	6	0	0
1	55833276	.	C	T	3	5	8	0	0	8	0	0
1	55833281	.	C	T	3	4	7	0	0	7	0	0
1	55840017	.	T	C	3	4	7	0	0	7	0	0
1	55843902	.	C	T	15	20	35	0	0	35	0	0
1	55843968	.	G	A	17	21	38	0	2	40	0	0
1	55844044	.	T	A	10	18	28	0	1	29	0	0
1	55844143	.	T	G	14	18	32	0	2	34	0	0
1	55851968	.	T	C	9	0	9	0	20	29	0	0
1	55853320	.	G	A	14	9	23	0	1	24	0	0
1	55872892	.	C	G	10	11	21	0	0	21	0	0
1	55873073	.	C	T	8	8	16	0	0	16	0	0
1	55878257	.	T	A	5	4	9	0	0	9	0	0
1	55878342	.	T	A	3	3	6	0	0	6	0	0
1	55878431	.	T	A	7	8	15	0	1	16	0	0
1	55878457	.	C	T	5	10	15	0	1	16	0	0
1	55878496	.	T	C	6	0	6	0	9	15	0	0
1	55878558	.	G	A	8	12	20	0	3	23	0	0
1	55878624	.	T	A	8	7	15	0	0	15	0	0
1	55878626	.	A	C	5	6	11	0	4	15	0	0
1	55885938	.	A	T	5	5	10	0	0	10	0	0
1	55888442	.	A	G	5	3	8	0	0	8	0	0
1	55888852	.	A	C	2	3	5	0	0	5	0	0
1	55888857	.	A	C	3	0	3	0	3	6	0	0
1	55888892	.	A	G	2	3	5	0	0	5	0	0
1	56217457	.	G	A	6	13	19	0	0	19	0	0
1	56217510	.	A	G	21	24	45	0	1	46	0	0
1	56217925	.	G	A	32	36	68	0	3	71	0	0
1	56218189	.	C	T	5	36	41	0	30	71	0	0
1	56218258	.	A	C	37	35	72	0	1	73	0	0
1	56220668	.	A	G	25	27	52	0	1	53	0	0
1	56422781	.	T	A	4	4	8	0	1	9	0	0
1	56422962	.	A	T	10	10	20	0	1	21	0	0
1	56422967	.	T	C	9	10	19	0	1	20	0	0
1	56423002	.	T	G	9	8	17	0	1	18	0	0
1	56423641	.	T	A	4	6	10	0	1	11	0	0
1	56423664	.	T	C	5	0	5	0	7	12	0	0
1	56423678	.	T	A	6	5	11	0	0	11	0	0
1	56425228	.	G	C	3	0	3	0	6	9	0	0
1	56425243	.	A	G	3	6	9	0	1	10	0	0
1	56425843	.	T	C	6	0	6	0	4	10	0	0
1	56425864	.	C	T	6	4	10	0	0	10	0	0
1	56428320	.	G	A	7	11	18	0	0	18	0	0
1	57278215	.	G	C	7	13	20	0	0	20	0	0
1	57278405	.	A	T	4	6	10	0	0	10	0	0
1	57278610	.	T	G	10	7	17	0	0	17	0	0
1	57278669	.	A	G	5	5	10	0	0	10	0	0
1	57278690	.	G	A	6	5	11	0	0	11	0	0
1	57278753	.	T	C	4	9	13	0	1	14	0	0
1	57278783	.	T	C	6	10	16	0	1	17	0	0
1	57278915	.	G	A	8	8	16	0	1	17	0	0
1	57278979	.	G	A	8	8	16	0	0	16	0	0
1	57279073	.	T	C	5	0	5	0	5	10	0	0
1	57280108	.	G	A	5	8	13	0	0	13	0	0
1	57280454	.	A	T	4	6	10	0	0	10	0	0
1	57280502	.	T	C	9	3	12	0	0	12	0	0
1	57306378	.	A	T	2	1	3	0	2	5	0	0
1	57317615	.	C	T	3	2	5	0	0	5	0	0
1	57317644	.	A	G	2	3	5	0	0	5	0	0
1	57332495	.	A	T	2	2	4	0	0	4	0	0
1	57332657	.	G	A	0	3	3	0	5	8	0	0
1	57332744	.	C	T	2	3	5	0	0	5	0	0
1	57337050	.	A	G	4	3	7	0	1	8	0	0
1	57338143	.	C	T	2	4	6	0	0	6	0	0
1	57338226	.	G	A	1	3	4	0	3	7	0	0
1	57340049	.	T	C	9	4	13	0	0	13	0	0
1	57340108	.	C	T	2	3	5	0	0	5	0	0
1	57340164	.	T	A	5	2	7	0	1	8	0	0
1	57363299	.	A	C	2	3	5	0	0	5	0	0
1	58013096	.	A	G	8	2	10	0	2	12	0	0
1	58013102	.	A	T	8	3	11	0	0	11	0	0
1	58013308	.	C	A	5	7	12	0	0	12	0	0
1	58013309	.	A	G	5	7	12	0	0	12	0	0
1	58013423	.	C	T	1	9	10	0	11	21	0	0
1	58013474	.	T	C	5	0	5	1	5	11	0	0
1	58013486	.	C	T	4	4	8	2	0	10	0	0
1	58013554	.	G	A	4	4	8	0	0	8	0	0
1	58014013	.	A	G	11	6	17	0	1	18	0	0
1	58014867	.	T	C	11	4	15	0	2	17	0	0
1	58014933	.	T	C	10	0	10	0	7	17	0	0
1	58015053	.	A	G	6	5	11	0	0	11	0	0
1	58015448	.	G	T	6	3	9	0	0	9	0	0
1	58015511	.	A	G	6	3	9	0	0	9	0	0
1	58015532	.	T	G	7	5	12	0	0	12	0	0
1	58015556	.	T	C	8	1	9	0	3	12	0	0
1	58015580	.	T	C	6	0	6	0	4	10	0	0
1	58017188	.	C	T	2	3	5	0	0	5	0	0
1	58018622	.	G	A	2	6	8	0	0	8	0	0
1	58018679	.	T	G	1	5	6	0	0	6	0	0
1	58018790	.	C	T	2	2	4	0	0	4	0	0
1	58019805	.	A	G	2	2	4	0	1	5	0	0
1	58020767	.	T	C	6	0	6	0	6	12	0	0
1	58020797	.	A	G	4	2	6	0	1	7	0	0
1	58020829	.	A	G	2	2	4	0	0	4	0	0
1	58020842	.	A	G	4	2	6	0	0	6	0	0
1	58036300	.	G	T	2	1	3	0	1	4	0	0
1	58036450	.	G	A	3	3	6	0	0	6	0	0
1	58036467	.	G	T	2	3	5	0	1	6	0	0
1	58039759	.	T	C	1	2	3	0	0	3	0	0
1	58048913	.	A	G	1	0	1	0	2	3	0	0
1	58544868	.	A	T	1	2	3	0	0	3	0	0
1	58545499	.	A	G	4	3	7	0	1	8	0	0
1	58545734	.	C	G	9	7	16	0	1	17	0	0
1	58547354	.	C	A	7	5	12	0	0	12	0	0
1	58547783	.	T	C	4	8	12	0	1	13	0	0
1	58548428	.	T	C	9	10	19	0	0	19	0	0
1	58548491	.	T	C	9	11	20	0	1	21	0	0
1	58559454	.	C	T	0	2	2	0	2	4	0	0
1	58559484	.	T	C	2	0	2	0	2	4	0	0
1	58570735	.	C	G	2	2	4	0	0	4	0	0
1	58593490	.	C	G	2	2	4	0	0	4	0	0
1	58593494	.	T	A	2	2	4	0	0	4	0	0
1	58593731	.	G	A	4	2	6	0	0	6	0	0
1	58593768	.	T	G	6	4	10	0	1	11	0	0
1	58593833	.	C	A	9	6	15	0	0	15	0	0
1	58593835	.	T	C	9	5	14	0	1	15	0	0
1	58593912	.	C	T	5	5	10	0	0	10	0	0
1	58594066	.	T	C	4	0	4	0	4	8	0	0
1	58594143	.	A	C	6	5	11	0	0	11	0	0
1	58594144	.	G	A	6	5	11	0	0	11	0	0
1	58594188	.	T	C	5	2	7	0	0	7	0	0
1	58594241	.	T	C	11	2	13	0	0	13	0	0
1	58594269	.	T	C	8	6	14	0	1	15	0	0
1	58594292	.	T	C	7	4	11	0	0	11	0	0
1	58594611	.	T	G	3	5	8	0	0	8	0	0
1	58595018	.	C	T	10	13	23	0	1	24	0	0
1	58595198	.	A	G	3	9	12	0	1	13	0	0
1	58595386	.	G	A	3	5	8	0	0	8	0	0
1	58595455	.	G	A	4	4	8	0	0	8	0	0
1	58595545	.	T	C	6	4	10	0	0	10	0	0
1	58598830	.	A	T	2	6	8	0	0	8	0	0
1	58601615	.	G	A	4	8	12	0	0	12	0	0
1	58601620	.	T	C	4	5	9	0	3	12	0	0
1	58605338	.	G	A	2	3	5	1	0	6	0	0
1	58606051	.	G	A	1	2	3	6	6	15	0	0
1	58610294	.	A	G	2	3	5	7	0	12	0	0
1	58612519	.	T	C	3	3	6	0	0	6	0	0
1	58612762	.	A	G	1	2	3	0	0	3	0	0
1	58613008	.	T	C	4	2	6	0	0	6	0	0
1	58613027	.	A	G	3	4	7	0	0	7	0	0
1	58613091	.	A	C	3	2	5	0	0	5	0	0
1	58617987	.	T	C	6	2	8	2	1	11	0	0
1	58618411	.	A	G	1	7	8	2	0	10	0	0
1	58618437	.	A	C	1	3	4	4	0	8	0	0
1	58618688	.	T	A	1	3	4	0	0	4	0	0
1	58618755	.	A	T	2	2	4	0	0	4	0	0
1	58618769	.	G	A	2	2	4	0	0	4	0	0
1	58618792	.	T	G	1	2	3	0	0	3	0	0
1	58631261	.	C	T	1	3	4	0	0	4	0	0
1	58631374	.	A	G	1	2	3	0	0	3	0	0
1	58631609	.	C	T	1	3	4	0	1	5	0	0
1	58631695	.	A	T	1	5	6	0	0	6	0	0
1	58677839	.	T	C	7	10	17	0	0	17	0	0
1	58677856	.	C	T	2	7	9	0	2	11	0	0
1	58677993	.	A	G	6	3	9	0	2	11	0	0
1	58678017	.	T	C	5	4	9	0	0	9	0	0
1	58680499	.	C	A	6	14	20	0	1	21	0	0
1	58680708	.	T	C	7	16	23	0	0	23	0	0
1	58680718	.	C	G	7	16	23	0	0	23	0	0
1	58680792	.	T	C	8	9	17	0	0	17	0	0
1	58680913	.	T	C	8	10	18	0	2	21	1	0
1	58681068	.	C	T	4	8	12	0	0	12	0	0
1	58681419	.	A	T	5	8	13	0	3	18	2	0
1	58681468	.	G	C	2	6	8	0	9	17	0	0
1	58681491	.	T	C	9	2	11	0	3	14	0	0
1	58762985	.	T	G	7	6	13	0	0	13	0	0
1	58763444	.	T	C	3	0	3	0	4	7	0	0
1	58846670	.	C	A	2	5	7	0	0	7	0	0
1	58846938	.	A	G	1	3	4	0	0	4	0	0
1	58850622	.	T	C	2	2	4	1	1	6	0	0
1	58857688	.	C	G	2	2	4	0	1	5	0	0
1	58982147	.	G	A	0	9	9	0	6	15	0	0
1	58982195	.	C	G	6	6	12	0	0	12	0	0
1	58984368	.	G	A	2	6	8	0	3	11	0	0
1	58984478	.	T	C	5	6	11	0	0	11	0	0
1	58984640	.	C	T	4	9	13	0	0	13	0	0
1	58985530	.	G	A	3	16	19	0	1	20	0	0
1	58985579	.	T	G	8	10	18	0	1	19	0	0
1	58985730	.	C	A	9	4	13	0	0	13	0	0
1	58985857	.	A	G	1	2	3	0	0	3	0	0
1	58993039	.	T	G	2	4	6	0	0	6	0	0
1	58998061	.	T	G	4	0	4	0	5	9	0	0
1	58999960	.	T	A	4	3	7	0	0	7	0	0
1	59009732	.	A	G	27	1	28	0	19	48	1	0
1	59010618	.	G	A	23	18	41	0	2	43	0	0
1	59015569	.	C	T	0	6	6	0	6	13	1	0
1	59015592	.	C	G	5	9	14	0	0	14	0	0
1	59015647	.	C	T	0	14	14	0	8	22	0	0
1	59018886	.	C	T	2	5	7	0	9	16	0	0
1	59019006	.	C	G	5	6	11	0	0	11	0	0
1	59019084	.	T	A	4	4	8	0	1	9	0	0
1	59019093	.	A	G	7	5	12	0	0	12	0	0
1	59062665	.	T	C	25	31	56	0	2	58	0	0
1	59065889	.	G	A	4	14	18	0	14	32	0	0
1	59141550	.	T	C	3	2	5	0	0	5	0	0
1	59141556	.	G	C	3	2	5	0	0	5	0	0
1	59142891	.	A	G	3	1	4	0	7	11	0	0
1	59143004	.	T	C	5	3	8	0	0	8	0	0
1	59143499	.	T	A	1	2	3	0	0	3	0	0
1	59143503	.	A	G	1	2	3	0	0	3	0	0
1	59146790	.	A	G	5	8	13	0	1	14	0	0
1	59148260	.	T	C	2	8	10	0	0	10	0	0
1	59148341	.	T	C	3	8	11	0	0	11	0	0
1	59149117	.	C	T	9	13	22	0	2	24	0	0
1	59149968	.	T	C	17	14	31	0	0	31	0	0
1	59150450	.	A	G	8	10	18	0	1	19	0	0
1	59150482	.	G	T	7	7	14	0	1	15	0	0
1	59150518	.	T	C	7	12	19	0	1	20	0	0
1	59150559	.	T	G	9	17	26	0	0	26	0	0
1	59150583	.	T	A	9	20	29	0	1	30	0	0
1	59150683	.	T	C	8	11	19	0	0	19	0	0
1	59150737	.	T	C	9	17	26	0	0	26	0	0
1	59150762	.	G	T	11	15	26	0	1	27	0	0
1	59150781	.	T	C	11	17	28	0	0	28	0	0
1	59156827	.	T	G	7	5	12	0	1	13	0	0
1	59157536	.	T	C	8	4	12	0	0	13	1	0
1	59157856	.	T	A	8	11	19	0	2	21	0	0
1	59157888	.	T	C	10	12	22	0	0	22	0	0
1	59157977	.	A	C	9	16	25	0	3	28	0	0
1	59158035	.	C	A	12	13	25	0	0	26	1	0
1	59158062	.	A	T	11	16	27	0	2	29	0	0
1	59158070	.	G	A	13	17	30	0	1	31	0	0
1	59172876	.	A	G	17	12	29	0	3	32	0	0
1	59172900	.	A	G	18	17	35	0	5	40	0	0
1	59172969	.	G	A	17	15	32	0	1	33	0	0
1	59173358	.	G	T	15	11	26	0	2	28	0	0
1	59173563	.	C	T	15	17	32	0	2	34	0	0
1	59173701	.	G	T	17	13	30	0	2	32	0	0
1	59173758	.	A	G	10	14	24	0	3	27	0	0
1	59173866	.	T	G	7	13	20	0	8	28	0	0
1	59173896	.	T	C	15	2	17	0	14	31	0	0
1	59174387	.	A	G	12	10	22	0	0	22	0	0
1	59174408	.	G	A	8	5	13	0	0	13	0	0
1	59174492	.	T	G	6	9	15	0	1	16	0	0
1	59174525	.	A	C	7	5	12	0	2	14	0	0
1	59174576	.	C	T	6	9	15	0	0	15	0	0
1	59174645	.	G	A	14	11	25	0	0	25	0	0
1	59174797	.	A	C	13	15	28	0	2	30	0	0
1	59174962	.	T	C	11	17	28	0	3	31	0	0
1	59175511	.	T	C	7	9	16	0	1	17	0	0
1	59175572	.	A	G	10	5	15	0	0	15	0	0
1	59175626	.	G	A	5	5	10	0	1	11	0	0
1	59175635	.	G	A	4	8	12	0	0	12	0	0
1	59175740	.	G	T	9	6	15	0	0	15	0	0
1	59175983	.	T	C	7	5	12	0	1	13	0	0
1	59175989	.	A	G	6	5	11	0	1	12	0	0
1	59176636	.	C	T	6	5	11	0	0	11	0	0
1	59176887	.	G	T	6	10	16	1	2	19	0	0
1	59176935	.	A	C	7	0	7	1	11	19	0	0
1	59218477	.	C	G	0	2	2	2	5	9	0	0
1	59218594	.	A	G	8	11	19	0	2	21	0	0
1	59226049	.	T	C	18	33	51	0	5	56	0	0
1	59226052	.	A	G	19	33	52	0	4	57	1	0
1	59226374	.	A	G	33	19	52	0	1	53	0	0
1	59228311	.	G	A	30	21	51	0	5	56	0	0
1	59228322	.	C	T	32	27	59	0	2	61	0	0
1	59228569	.	A	C	27	0	27	0	25	52	0	0
1	59229211	.	G	A	7	7	14	0	0	14	0	0
1	59232206	.	A	G	12	19	31	0	1	32	0	0
1	59232358	.	T	G	2	2	4	0	0	4	0	0
1	59232509	.	G	A	12	17	29	1	3	33	0	0
1	59235016	.	T	G	13	18	31	0	1	32	0	0
1	59237932	.	G	A	5	1	6	0	1	7	0	0
1	59237935	.	T	C	4	1	5	0	1	6	0	0
1	59238037	.	T	C	1	2	3	0	0	3	0	0
1	59238038	.	A	C	1	2	3	0	0	3	0	0
1	59244312	.	A	G	11	6	17	0	1	18	0	0
1	59244635	.	A	T	15	18	33	0	0	33	0	0
1	59244916	.	T	A	36	16	52	1	3	56	0	0
1	59244928	.	C	T	30	20	50	1	4	55	0	0
1	59245142	.	C	G	27	26	53	0	4	57	0	0
1	59245658	.	G	A	17	11	28	0	1	29	0	0
1	59245873	.	T	C	10	14	24	0	3	27	0	0
1	59245900	.	C	T	19	11	30	0	1	31	0	0
1	59246189	.	T	C	18	0	18	0	14	32	0	0
1	59246318	.	A	G	0	5	5	0	1	6	0	0
1	59246320	.	G	A	1	5	6	0	0	6	0	0
1	59246363	.	A	T	2	5	7	0	1	8	0	0
1	59247893	.	T	G	14	12	26	0	1	27	0	0
1	59247944	.	C	T	15	11	26	0	0	26	0	0
1	59248138	.	T	A	13	7	20	0	2	22	0	0
1	59251658	.	C	G	20	8	28	0	1	29	0	0
1	59251839	.	T	C	7	0	7	0	10	17	0	0
1	59293937	.	T	C	1	3	4	0	0	4	0	0
1	59293966	.	A	G	3	4	7	0	1	8	0	0
1	59297464	.	T	G	1	3	4	0	0	4	0	0
1	59297937	.	C	T	1	2	3	0	0	3	0	0
1	59298069	.	T	C	1	3	4	0	0	4	0	0
1	59298207	.	C	T	1	5	6	0	0	6	0	0
1	59298261	.	T	G	1	5	6	0	0	6	0	0
1	59302210	.	G	A	0	7	7	0	3	10	0	0
1	59302276	.	C	T	5	13	18	0	0	18	0	0
1	59302372	.	T	G	7	11	18	0	1	19	0	0
1	59303024	.	C	A	3	7	10	0	1	11	0	0
1	59303149	.	A	C	4	3	7	0	0	7	0	0
1	59304427	.	T	C	4	1	5	0	0	5	0	0
1	59305059	.	A	C	6	0	6	0	11	17	0	0
1	59305116	.	T	C	5	0	5	0	9	14	0	0
1	59305200	.	T	C	5	5	10	0	1	11	0	0
1	59305895	.	C	T	3	6	9	0	0	9	0	0
1	59314966	.	A	G	8	9	17	0	0	17	0	0
1	59318769	.	A	G	5	8	13	0	0	13	0	0
1	59318771	.	C	A	6	6	12	0	2	14	0	0
1	59318886	.	A	G	3	1	4	0	5	9	0	0
1	59321447	.	A	G	9	0	9	0	18	27	0	0
1	59324067	.	T	C	20	19	39	0	3	42	0	0
1	59328287	.	C	T	6	6	12	0	0	12	0	0
1	59328486	.	C	T	5	5	10	0	1	11	0	0
1	59329950	.	A	G	6	7	13	0	1	14	0	0
1	59329957	.	T	C	7	7	14	0	0	14	0	0
1	59330135	.	T	C	6	5	11	0	0	11	0	0
1	59330169	.	C	T	5	6	11	0	0	11	0	0
1	59406389	.	A	T	5	15	20	0	0	20	0	0
1	59407248	.	G	C	1	6	7	0	0	7	0	0
1	59409266	.	G	A	1	8	9	0	0	9	0	0
1	59409321	.	C	G	2	11	13	0	0	13	0	0
1	59414615	.	A	G	1	4	5	0	0	5	0	0
1	59415710	.	A	G	2	4	6	0	1	7	0	0
1	59542739	.	A	T	2	5	7	0	1	8	0	0
1	59565427	.	A	C	1	4	5	0	0	5	0	0
10	18509	.	A	G	2	11	13	0	2	15	0	0
10	18533	.	T	C	6	13	19	0	1	20	0	0
10	19217	.	G	A	5	4	9	0	0	9	0	0
10	22333	.	C	G	12	6	18	0	0	18	0	0
10	22434	.	G	T	0	6	6	0	12	18	0	0
10	22435	.	G	T	12	6	18	0	0	18	0	0
10	22507	.	A	G	12	6	18	1	0	19	0	0
10	24733	.	G	A	5	5	10	0	2	12	0	0
10	27021	.	C	T	4	4	8	0	0	8	0	0
10	27787	.	G	T	0	4	4	0	9	13	0	0
10	32978	.	T	C	4	0	4	0	9	13	0	0
10	32998	.	G	T	6	8	14	0	0	14	0	0
10	33237	.	T	C	7	5	12	0	0	12	0	0
10	33287	.	G	C	6	6	12	0	0	12	0	0
10	33441	.	A	G	7	11	18	0	2	20	0	0
10	33630	.	A	G	3	8	11	0	1	12	0	0
10	33634	.	G	T	4	7	11	0	1	12	0	0
10	33665	.	T	C	2	8	10	0	1	11	0	0
10	33986	.	G	T	9	7	16	0	0	16	0	0
10	34028	.	C	T	9	3	12	0	1	13	0	0
10	34206	.	A	C	4	7	11	0	1	12	0	0
10	34233	.	G	A	2	4	6	0	0	6	0	0
10	34302	.	G	T	5	5	10	0	1	11	0	0
10	34325	.	C	T	0	3	3	0	4	7	0	0
10	34725	.	G	A	6	8	14	0	5	19	0	0
10	34727	.	A	T	8	11	19	0	0	19	0	0
10	34839	.	G	C	7	11	18	0	1	19	0	0
10	38922	.	A	G	1	5	6	0	0	6	0	0
10	38924	.	A	G	1	5	6	0	0	6	0	0
10	53815	.	T	C	9	10	19	0	0	19	0	0
10	53816	.	G	A	9	10	19	0	0	19	0	0
10	53930	.	T	G	10	9	19	0	1	20	0	0
10	55594	.	G	A	5	7	12	0	0	12	0	0
10	55627	.	C	T	1	9	10	0	6	16	0	0
10	55665	.	A	C	10	10	20	0	0	20	0	0
10	55666	.	G	C	9	0	9	0	11	20	0	0
10	62459	.	A	C	23	0	23	0	19	42	0	0
10	62468	.	C	G	23	20	43	0	2	45	0	0
10	63587	.	A	G	19	16	35	0	5	40	0	0
10	64855	.	G	A	20	5	25	0	1	26	0	0
10	65086	.	A	G	6	6	12	0	0	12	0	0
10	67063	.	T	C	9	10	19	0	0	19	0	0
10	72381	.	A	G	8	5	13	0	1	14	0	0
10	78461	.	G	C	1	14	15	0	15	30	0	0
10	81285	.	C	T	17	20	37	1	4	42	0	0
10	81348	.	C	T	29	8	37	0	0	37	0	0
10	81508	.	A	G	10	2	12	0	17	29	0	0
10	82220	.	A	C	27	7	34	0	5	39	0	0
10	82227	.	A	G	27	9	36	0	3	39	0	0
10	82336	.	A	G	25	13	38	0	3	41	0	0
10	85353	.	A	G	8	7	15	0	1	16	0	0
10	85404	.	G	A	16	5	21	0	1	22	0	0
10	85419	.	C	T	1	3	4	0	16	21	1	0
10	85571	.	G	C	14	11	25	0	0	25	0	0
10	85585	.	C	T	13	11	24	0	1	25	0	0
10	85927	.	A	G	9	11	20	0	0	20	0	0
10	85948	.	G	C	12	11	23	0	1	24	0	0
10	87353	.	G	A	13	8	21	0	0	21	0	0
10	87417	.	G	A	9	8	17	0	2	19	0	0
10	87426	.	T	C	11	10	21	0	1	22	0	0
10	87606	.	G	A	9	10	19	0	0	19	0	0
10	89893	.	T	C	6	0	6	0	5	11	0	0
10	104062	.	T	G	3	2	5	0	0	5	0	0
10	110895	.	G	A	1	8	9	0	0	9	0	0
10	114066	.	A	G	7	16	23	0	3	26	0	0
10	115088	.	G	A	3	12	15	0	1	16	0	0
10	115136	.	T	C	6	15	21	0	1	22	0	0
10	115578	.	T	C	1	9	10	0	0	10	0	0
10	115773	.	A	G	4	9	13	0	0	13	0	0
10	115820	.	T	C	4	8	12	0	0	12	0	0
10	115982	.	T	C	1	8	9	0	0	9	0	0
10	116015	.	T	G	1	3	4	0	0	4	0	0
10	117229	.	G	A	4	2	6	0	0	6	0	0
10	134809	.	G	A	22	16	38	1	2	41	0	0
10	188357	.	A	C	3	6	9	0	0	9	0	0
10	188366	.	A	G	3	4	7	0	0	7	0	0
10	193726	.	A	G	9	15	24	0	3	27	0	0
10	193853	.	G	A	13	10	23	0	5	28	0	0
10	194316	.	A	G	13	7	20	0	0	20	0	0
10	195321	.	T	C	17	10	27	0	2	29	0	0
10	195327	.	T	C	16	13	29	0	0	29	0	0
10	196054	.	C	T	9	9	18	0	1	19	0	0
10	196307	.	C	T	12	7	19	0	1	20	0	0
10	196342	.	C	G	9	10	19	0	2	21	0	0
10	196670	.	G	A	23	13	36	0	2	38	0	0
10	196693	.	T	A	25	13	38	0	1	39	0	0
10	196773	.	T	C	2	2	4	0	1	5	0	0
10	207258	.	C	T	10	20	30	0	0	30	0	0
10	207259	.	C	A	1	20	21	0	8	29	0	0
10	207992	.	T	C	14	0	14	0	12	26	0	0
10	207994	.	T	C	14	0	14	0	12	26	0	0
10	208034	.	A	T	13	13	26	0	0	26	0	0
10	210568	.	A	G	7	13	20	0	0	20	0	0
10	210598	.	T	C	6	14	20	0	0	20	0	0
10	216122	.	T	C	6	3	9	0	2	11	0	0
10	286788	.	T	C	6	0	6	0	18	24	0	0
10	292655	.	C	T	0	5	5	0	4	9	0	0
10	292667	.	A	G	2	8	10	0	0	10	0	0
10	294113	.	G	A	7	5	12	0	0	12	0	0
10	294653	.	A	G	7	8	15	0	2	17	0	0
10	295070	.	A	G	3	6	9	0	0	9	0	0
10	295202	.	T	C	2	16	18	0	0	18	0	0
10	297823	.	C	T	4	6	10	0	0	10	0	0
10	306096	.	A	C	2	8	10	0	1	11	0	0
10	307976	.	G	T	14	5	19	0	1	20	0	0
10	307985	.	T	C	12	0	12	0	6	18	0	0
10	308288	.	T	C	8	3	11	0	0	11	0	0
10	311901	.	A	G	3	6	9	0	1	10	0	0
10	313332	.	T	C	3	10	13	0	0	13	0	0
10	315540	.	G	A	1	5	6	5	0	11	0	0
10	320142	.	C	A	4	3	7	0	0	7	0	0
10	474834	.	T	C	13	17	30	0	0	30	0	0
10	474896	.	T	C	12	13	25	0	0	25	0	0
10	478304	.	T	G	18	18	36	0	0	36	0	0
10	478388	.	G	A	3	15	18	0	18	36	0	0
10	478508	.	T	C	23	10	33	0	2	35	0	0
10	478661	.	C	T	20	14	34	0	2	36	0	0
10	478724	.	G	A	17	19	36	0	0	36	0	0
10	478742	.	C	T	14	18	32	0	0	32	0	0
10	479063	.	A	G	15	15	30	0	2	32	0	0
10	482335	.	G	A	20	11	31	1	2	34	0	0
10	482371	.	T	G	19	14	33	1	1	35	0	0
10	486146	.	G	A	20	16	36	0	1	37	0	0
10	486153	.	T	C	17	15	32	0	5	37	0	0
10	500114	.	A	G	28	1	29	0	18	47	0	0
10	500168	.	G	A	2	26	28	0	21	49	0	0
10	500423	.	A	G	19	0	19	0	23	42	0	0
10	500473	.	T	C	20	29	49	0	0	49	0	0
10	501833	.	C	T	17	28	45	0	0	45	0	0
10	501899	.	G	C	16	24	40	0	0	40	0	0
10	505282	.	A	G	16	22	38	0	1	39	0	0
10	505316	.	G	A	4	26	30	0	19	49	0	0
10	573770	.	A	G	2	0	2	0	5	7	0	0
10	573789	.	T	A	3	3	6	0	1	7	0	0
10	573806	.	G	A	5	2	7	0	0	7	0	0
10	576060	.	A	G	3	4	7	0	0	7	0	0
10	577791	.	G	C	3	3	6	0	1	7	0	0
10	579989	.	A	G	5	0	5	0	10	15	0	0
10	580088	.	G	T	1	10	11	0	7	18	0	0
10	580092	.	G	A	8	8	16	0	1	17	0	0
10	586563	.	C	A	4	4	8	0	1	9	0	0
10	589487	.	G	A	6	5	11	0	0	11	0	0
10	589655	.	T	C	1	5	6	0	0	6	0	0
10	589789	.	G	A	0	4	4	0	6	10	0	0
10	589810	.	A	T	5	4	9	0	0	9	0	0
10	589875	.	T	C	7	3	10	0	0	10	0	0
10	590067	.	A	C	5	5	10	0	1	11	0	0
10	590087	.	A	G	6	4	10	0	1	11	0	0
10	590273	.	A	C	7	7	14	0	5	19	0	0
10	590343	.	A	G	8	4	12	0	1	13	0	0
10	590956	.	A	T	8	5	13	1	1	15	0	0
10	590957	.	A	G	8	5	13	1	0	14	0	0
10	591017	.	T	C	10	5	15	1	1	17	0	0
10	591219	.	T	G	13	0	13	1	6	20	0	0
10	591220	.	C	T	13	6	19	1	0	20	0	0
10	591434	.	G	A	5	8	13	0	0	13	0	0
10	591476	.	A	G	6	0	6	0	11	17	0	0
10	591567	.	T	A	9	11	20	0	2	22	0	0
10	591634	.	T	G	19	8	27	0	0	27	0	0
10	591716	.	C	G	5	2	7	0	0	7	0	0
10	591720	.	G	A	2	3	5	0	4	9	0	0
10	600448	.	T	C	4	6	10	1	0	11	0	0
10	600450	.	T	C	5	6	11	1	0	12	0	0
10	600584	.	G	A	6	8	14	0	0	14	0	0
10	608795	.	A	G	1	2	3	0	0	3	0	0
10	609654	.	C	T	6	3	9	0	1	10	0	0
10	650148	.	A	T	1	4	5	0	0	5	0	0
10	650153	.	C	T	0	4	4	0	1	5	0	0
10	676379	.	C	T	1	2	3	0	0	3	0	0
10	676509	.	T	G	2	4	6	0	0	6	0	0
10	1052692	.	A	G	5	0	5	0	3	8	0	0
10	1056227	.	A	G	4	6	10	0	0	10	0	0
10	1056409	.	A	G	8	5	13	0	1	14	0	0
10	1056460	.	T	C	6	8	14	0	0	14	0	0
10	1076251	.	T	C	4	3	7	0	0	7	0	0
10	1082985	.	T	G	4	5	9	0	0	9	0	0
10	1083030	.	T	A	4	7	11	0	0	11	0	0
10	1084628	.	A	G	1	3	4	0	0	4	0	0
10	1091694	.	A	G	1	4	5	0	0	5	0	0
10	1105953	.	C	T	13	10	23	0	0	23	0	0
10	1107460	.	C	T	17	11	28	1	0	29	0	0
10	1133195	.	G	A	1	4	5	0	0	5	0	0
10	1436596	.	C	G	1	16	17	0	5	22	0	0
10	1450286	.	G	A	11	6	17	0	0	17	0	0
10	1515816	.	C	T	5	9	14	0	0	14	0	0
10	1541411	.	G	A	3	16	19	0	2	21	0	0
10	1541492	.	C	T	4	28	32	0	2	34	0	0
10	1549013	.	C	A	2	9	11	0	4	15	0	0
10	1549088	.	C	T	0	8	8	0	6	14	0	0
10	1549179	.	A	G	20	4	24	0	1	25	0	0
10	1549189	.	A	G	21	3	24	0	3	27	0	0
10	1549409	.	T	C	3	0	3	0	9	12	0	0
10	1549494	.	G	A	2	12	14	1	5	20	0	0
10	1549714	.	G	A	2	12	14	0	0	14	0	0
10	1597332	.	A	G	7	10	17	0	0	17	0	0
10	1597396	.	G	A	14	7	21	0	1	22	0	0
10	1603967	.	T	C	2	3	5	0	2	7	0	0
10	1619723	.	G	A	1	5	6	0	0	6	0	0
10	1652260	.	G	C	0	2	2	0	3	5	0	0
10	1656257	.	C	T	4	2	6	0	0	6	0	0
10	1658184	.	T	C	5	5	10	0	0	10	0	0
10	1663101	.	T	C	6	3	9	0	0	9	0	0
10	1666500	.	A	G	4	0	4	0	3	7	0	0
10	1666525	.	G	A	0	2	2	0	5	7	0	0
10	1668159	.	C	T	16	12	28	0	0	28	0	0
10	1671442	.	A	T	3	13	16	0	3	19	0	0
10	1674291	.	C	T	13	12	25	0	0	25	0	0
10	1681712	.	A	T	7	6	13	0	0	13	0	0
10	1684563	.	T	G	9	8	17	0	1	18	0	0
10	1687094	.	C	T	7	3	10	0	0	10	0	0
10	1687547	.	C	T	18	26	44	0	1	45	0	0
10	1694456	.	T	A	13	11	24	1	0	25	0	0
10	1708197	.	T	A	17	19	36	0	1	37	0	0
10	1708230	.	T	C	18	19	37	0	1	38	0	0
10	1708239	.	A	T	19	16	35	0	1	36	0	0
10	1708412	.	A	T	29	22	51	0	2	53	0	0
10	1709165	.	T	A	25	25	50	0	1	51	0	0
10	1709331	.	T	G	27	24	51	0	3	56	2	0
10	1709731	.	G	A	29	25	54	0	1	55	0	0
10	1709783	.	G	A	31	27	58	0	0	58	0	0
10	1709836	.	T	G	19	22	41	0	4	45	0	0
10	1709855	.	C	T	22	24	46	0	0	46	0	0
10	1709871	.	G	A	16	23	39	0	3	42	0	0
10	1710270	.	A	G	34	18	52	2	1	55	0	0
10	1710358	.	C	T	16	9	25	0	4	29	0	0
10	1711061	.	T	C	13	0	13	0	17	30	0	0
10	1711136	.	T	C	30	18	48	0	0	48	0	0
10	1711188	.	T	A	24	12	36	0	4	40	0	0
10	1711211	.	C	T	21	12	33	0	2	35	0	0
10	1711599	.	T	C	7	1	8	1	19	28	0	0
10	1711623	.	G	A	13	16	29	1	1	31	0	0
10	1711711	.	G	A	17	16	33	0	0	33	0	0
10	1711780	.	C	T	3	13	16	0	10	26	0	0
10	1712091	.	G	A	4	8	12	0	0	12	0	0
10	1712100	.	T	A	3	9	12	0	1	13	0	0
10	1712306	.	G	A	9	14	23	0	5	28	0	0
10	1712316	.	C	T	9	15	24	0	1	25	0	0
10	1712658	.	G	A	23	12	35	0	2	37	0	0
10	1712757	.	A	G	16	14	30	0	1	31	0	0
10	1712899	.	A	T	25	22	47	0	1	49	1	0
10	1712964	.	T	G	36	1	37	0	0	37	0	0
10	1713418	.	T	C	10	14	24	0	6	30	0	0
10	1718294	.	C	A	17	18	35	0	1	36	0	0
10	1745541	.	A	T	1	4	5	0	0	5	0	0
10	1745738	.	T	A	10	5	15	0	0	15	0	0
10	1776112	.	G	A	3	3	6	0	0	6	0	0
10	1782953	.	C	T	0	3	3	0	5	8	0	0
10	1782968	.	C	G	4	5	9	0	0	9	0	0
10	1866818	.	G	A	3	3	6	0	0	6	0	0
10	1869266	.	G	A	7	6	13	0	1	14	0	0
10	1869313	.	G	T	5	6	11	0	1	12	0	0
10	1869328	.	C	T	4	3	7	0	1	8	0	0
10	1871634	.	G	T	1	2	3	0	2	5	0	0
10	1880470	.	A	G	6	6	12	0	0	12	0	0
10	1880734	.	C	T	5	3	8	0	0	8	0	0
10	1885891	.	A	C	4	3	7	0	0	7	0	0
10	1886113	.	G	A	0	5	5	0	3	8	0	0
10	1886119	.	T	G	5	3	8	0	0	8	0	0
10	1886182	.	C	T	5	2	7	0	0	7	0	0
10	1886587	.	T	C	4	7	11	0	1	12	0	0
10	1886590	.	T	A	4	9	13	0	1	14	0	0
10	1886764	.	T	C	9	13	22	0	1	23	0	0
10	1887238	.	C	T	9	12	21	0	0	21	0	0
10	1887364	.	C	T	8	5	13	0	1	14	0	0
10	1887496	.	A	G	7	0	7	0	8	15	0	0
10	1887811	.	A	G	7	7	14	0	2	16	0	0
10	1888135	.	G	C	8	12	20	0	1	21	0	0
10	1888222	.	C	T	3	11	14	0	0	14	0	0
10	1888225	.	G	A	3	10	13	0	0	13	0	0
10	1888303	.	C	T	12	11	23	0	0	23	0	0
10	1888414	.	T	C	11	8	19	0	1	20	0	0
10	1888438	.	C	T	9	14	23	0	2	25	0	0
10	1888487	.	T	C	11	16	27	0	0	27	0	0
10	1888515	.	C	T	16	13	29	0	0	29	0	0
10	1888824	.	C	T	13	9	22	0	0	22	0	0
10	1888893	.	C	T	16	14	30	0	0	30	0	0
10	1889171	.	G	T	17	9	26	0	1	27	0	0
10	1889179	.	A	G	13	0	13	0	10	23	0	0
10	1889255	.	C	T	13	12	25	0	0	25	0	0
10	1889296	.	C	T	9	16	25	0	0	25	0	0
10	1889882	.	A	C	10	16	26	0	1	27	0	0
10	1890313	.	A	G	22	16	38	0	1	39	0	0
10	1890949	.	T	C	22	14	36	0	0	36	0	0
10	1890961	.	G	A	20	18	38	0	0	38	0	0
10	1891018	.	G	A	2	25	27	0	11	38	0	0
10	1891660	.	G	C	19	23	42	0	0	42	0	0
10	1891724	.	G	C	25	26	51	0	2	53	0	0
10	1892516	.	G	A	25	10	35	0	3	38	0	0
10	2234379	.	C	T	1	4	5	0	0	5	0	0
10	2283925	.	C	T	1	3	4	0	0	4	0	0
10	2286689	.	G	A	4	2	6	0	0	6	0	0
10	2288974	.	A	G	3	2	5	0	0	5	0	0
10	2292380	.	G	T	4	4	8	0	0	8	0	0
10	2294325	.	G	A	5	6	11	0	0	11	0	0
10	2328740	.	C	A	3	2	5	0	0	5	0	0
10	2339274	.	C	T	9	5	14	2	2	18	0	0
10	2354973	.	C	A	7	4	11	0	0	11	0	0
10	2367762	.	C	T	7	8	15	0	1	16	0	0
10	2393715	.	G	A	19	15	34	0	0	34	0	0
10	2393763	.	G	C	16	20	36	0	1	37	0	0
10	2504174	.	G	T	13	21	34	0	1	35	0	0
10	2504210	.	C	T	0	27	27	0	6	33	0	0
10	2506081	.	G	A	12	19	31	0	2	33	0	0
10	2508347	.	T	C	10	1	11	0	11	22	0	0
10	2510397	.	C	G	1	5	6	0	9	15	0	0
10	2515351	.	T	G	7	11	18	0	2	20	0	0
10	2515447	.	T	C	7	1	8	0	9	17	0	0
10	2526413	.	A	G	13	5	18	0	0	18	0	0
10	2533537	.	T	C	2	2	4	0	0	4	0	0
10	2547615	.	C	A	4	2	6	0	0	6	0	0
10	2547663	.	A	G	1	2	3	0	1	4	0	0
10	2575204	.	A	G	9	0	9	0	8	17	0	0
10	2575369	.	T	C	7	8	15	0	1	16	0	0
10	2645850	.	T	G	3	3	6	0	0	6	0	0
10	2658611	.	C	T	3	3	6	0	0	6	0	0
10	2666322	.	C	T	5	2	7	0	0	7	0	0
10	2666324	.	C	T	4	2	6	0	1	7	0	0
10	2666537	.	A	C	3	3	6	0	0	6	0	0
10	2681622	.	C	T	5	4	9	0	0	9	0	0
10	2681771	.	G	A	3	6	9	0	1	10	0	0
10	2681800	.	C	T	0	11	11	0	5	16	0	0
10	2697449	.	C	T	0	3	3	0	2	5	0	0
10	2700572	.	G	A	3	3	6	0	1	7	0	0
10	2704653	.	C	T	5	5	10	0	0	10	0	0
10	2704752	.	G	T	7	5	12	0	1	13	0	0
10	2759276	.	G	A	15	12	27	0	0	27	0	0
10	2759329	.	T	G	12	11	23	0	0	23	0	0
10	2759381	.	G	C	16	13	29	0	2	31	0	0
10	2759391	.	A	T	18	15	33	0	2	35	0	0
10	2772036	.	G	A	9	8	17	1	0	18	0	0
10	2772057	.	G	A	12	7	19	1	0	20	0	0
10	2778444	.	G	A	10	4	14	0	0	14	0	0
10	2782761	.	G	A	4	6	10	0	1	11	0	0
10	2788649	.	A	T	5	6	11	0	0	11	0	0
10	2837696	.	A	G	1	2	3	1	0	4	0	0
10	2837706	.	A	G	1	2	3	1	0	4	0	0
10	2850652	.	A	G	7	3	10	0	0	10	0	0
10	2888166	.	C	A	8	9	17	0	2	19	0	0
10	2891905	.	G	A	12	9	21	0	0	21	0	0
10	2894148	.	G	C	7	7	14	1	0	15	0	0
10	2894193	.	T	G	5	0	5	0	8	13	0	0
10	2894545	.	C	T	13	8	21	0	0	21	0	0
10	2897110	.	A	C	12	8	20	0	0	20	0	0
10	2897720	.	T	A	16	7	23	0	0	23	0	0
10	2897817	.	T	G	8	1	9	0	8	17	0	0
10	2898087	.	T	C	3	3	6	0	0	6	0	0
10	2898269	.	C	T	3	3	6	0	0	6	0	0
10	2898346	.	T	A	3	4	7	0	0	7	0	0
10	2898390	.	A	T	2	5	7	0	0	7	0	0
10	2904581	.	T	C	1	2	3	0	0	3	0	0
10	2904794	.	C	T	3	4	7	0	0	7	0	0
10	2910591	.	G	T	4	2	6	0	0	6	0	0
10	2915399	.	G	A	8	3	11	0	0	11	0	0
10	2915412	.	A	G	6	3	9	0	0	9	0	0
10	2915462	.	G	A	1	3	4	0	3	7	0	0
10	2915495	.	C	T	4	6	10	0	1	11	0	0
10	2916931	.	A	T	4	5	9	0	0	9	0	0
10	2920032	.	C	T	2	6	8	0	1	9	0	0
10	2983997	.	C	T	2	2	4	0	0	4	0	0
10	2984035	.	T	C	2	2	4	0	0	4	0	0
10	2984311	.	C	T	2	2	4	0	0	4	0	0
10	2985032	.	G	T	0	3	3	0	2	5	0	0
10	3007051	.	A	C	4	4	8	0	0	8	0	0
10	3016263	.	T	C	6	4	10	0	2	12	0	0
10	3024637	.	C	G	3	8	11	0	0	11	0	0
10	3024706	.	C	T	6	8	14	0	1	15	0	0
10	3026264	.	A	C	11	7	18	0	1	19	0	0
10	3026376	.	A	G	6	5	11	0	0	11	0	0
10	3031670	.	T	C	8	0	8	0	4	12	0	0
10	3031760	.	A	G	4	2	6	0	0	6	0	0
10	3032072	.	C	T	3	3	6	0	1	7	0	0
10	3032353	.	T	A	4	2	6	0	0	6	0	0
10	3033247	.	A	G	2	1	3	0	1	4	0	0
10	3308482	.	G	A	0	3	3	0	1	4	0	0
10	3311737	.	T	G	8	7	15	0	2	17	0	0
10	3311845	.	G	A	4	6	10	0	0	10	0	0
10	3314596	.	T	C	15	9	24	0	0	24	0	0
10	3317976	.	G	A	3	7	10	0	7	17	0	0
10	3318005	.	G	C	1	6	7	0	9	16	0	0
10	3318060	.	G	A	4	9	13	0	0	13	0	0
10	3318265	.	C	A	3	2	5	0	1	6	0	0
10	3318295	.	G	T	4	3	7	0	0	7	0	0
10	3318581	.	G	A	1	2	3	0	0	3	0	0
10	3319873	.	A	G	9	0	9	0	11	20	0	0
10	3319890	.	G	T	1	15	16	0	8	24	0	0
10	3319938	.	C	T	13	11	24	0	1	25	0	0
10	3320007	.	C	G	14	13	27	0	1	28	0	0
10	3320015	.	T	C	15	14	29	0	1	30	0	0
10	3320151	.	A	G	16	10	26	0	2	28	0	0
10	3320194	.	G	A	14	14	28	0	3	31	0	0
10	3320229	.	G	A	17	12	29	0	1	30	0	0
10	3320287	.	T	G	19	14	33	0	2	35	0	0
10	3320465	.	C	G	16	6	22	0	0	22	0	0
10	3320495	.	A	T	11	11	22	0	1	23	0	0
10	3320506	.	C	T	9	11	20	0	2	22	0	0
10	3320705	.	G	A	17	13	30	0	1	31	0	0
10	3320776	.	C	T	18	18	36	0	1	37	0	0
10	3320850	.	C	T	14	10	24	0	3	27	0	0
10	3320887	.	G	A	15	10	25	0	0	25	0	0
10	3320890	.	A	G	3	18	21	0	3	24	0	0
10	3321416	.	T	G	9	10	19	0	0	19	0	0
10	3336838	.	C	T	4	2	6	0	0	6	0	0
10	3336846	.	T	A	5	3	8	0	0	8	0	0
10	3341412	.	C	T	6	4	10	0	1	11	0	0
10	3353607	.	C	T	9	5	14	0	1	15	0	0
10	3353622	.	A	G	11	7	18	0	0	18	0	0
10	3354048	.	A	G	10	11	21	0	0	21	0	0
10	3358897	.	A	T	12	9	21	0	0	21	0	0
10	3364772	.	A	T	8	5	13	0	0	13	0	0
10	3365063	.	C	T	2	9	11	1	12	24	0	0
10	3365312	.	T	C	5	7	12	0	0	12	0	0
10	3365726	.	A	C	23	0	23	1	1	25	0	0
10	3365834	.	A	T	8	12	20	0	0	20	0	0
10	3366095	.	C	T	0	12	12	0	15	27	0	0
10	3366199	.	C	T	1	7	8	0	7	15	0	0
10	3370680	.	G	A	5	3	8	0	0	8	0	0
10	3377087	.	G	A	4	2	6	0	0	6	0	0
10	3377195	.	G	A	2	4	6	0	0	6	0	0
10	3381744	.	A	G	1	2	3	0	0	3	0	0
10	3388200	.	T	G	3	6	9	0	0	9	0	0
10	3398215	.	G	T	1	3	4	0	0	4	0	0
10	3400093	.	T	C	7	8	15	0	0	15	0	0
10	3400126	.	A	T	7	6	13	0	1	14	0	0
10	3400216	.	C	T	2	3	5	0	0	5	0	0
10	3400225	.	T	C	5	3	8	0	1	9	0	0
10	3400351	.	A	T	8	4	12	0	1	13	0	0
10	3403764	.	C	T	1	3	4	0	4	8	0	0
10	3408009	.	G	A	2	2	4	0	0	4	0	0
10	3420097	.	A	T	21	14	35	0	0	35	0	0
10	3426363	.	G	A	16	21	37	0	0	37	0	0
10	3428230	.	G	C	2	5	7	0	0	7	0	0
10	3430894	.	C	G	4	3	7	0	0	7	0	0
10	3434883	.	C	T	6	3	9	0	0	9	0	0
10	3436370	.	C	T	5	4	9	0	0	9	0	0
10	3438991	.	T	C	2	3	5	0	0	5	0	0
10	3439018	.	A	G	2	4	6	0	0	6	0	0
10	3441973	.	T	C	2	5	7	0	0	7	0	0
10	3442030	.	T	C	6	3	9	0	0	9	0	0
10	3445818	.	C	T	8	6	14	0	2	16	0	0
10	3450861	.	A	G	8	7	15	0	1	16	0	0
10	3451091	.	G	A	5	4	9	0	1	10	0	0
10	3451429	.	G	A	1	11	12	0	8	20	0	0
10	3451672	.	A	G	6	2	8	0	0	8	0	0
10	3451688	.	C	T	2	5	7	0	0	7	0	0
10	3451848	.	G	A	0	8	8	0	6	14	0	0
10	3451864	.	C	T	7	8	15	0	0	15	0	0
10	3452045	.	G	A	5	5	10	0	1	11	0	0
10	3452073	.	A	G	8	9	17	0	1	18	0	0
10	3452124	.	A	G	11	7	18	0	2	20	0	0
10	3452183	.	G	A	7	12	19	0	0	19	0	0
10	3452185	.	T	A	6	12	18	0	1	19	0	0
10	3969491	.	G	T	1	3	4	0	1	5	0	0
10	3979870	.	G	A	1	7	8	0	1	9	0	0
10	3979876	.	C	A	2	5	7	0	1	8	0	0
10	4010345	.	G	T	0	4	4	0	1	5	0	0
10	4016017	.	G	A	7	6	13	0	1	14	0	0
10	4029634	.	A	G	2	3	5	0	0	5	0	0
10	4030211	.	A	T	2	2	4	0	0	4	0	0
10	4030349	.	C	T	5	5	10	0	0	10	0	0
10	4030352	.	C	A	4	5	9	0	1	10	0	0
10	4032623	.	C	T	4	3	7	0	0	7	0	0
10	4037287	.	G	A	5	2	7	0	1	8	0	0
10	4038772	.	G	A	10	12	22	0	3	25	0	0
10	4038898	.	A	G	13	7	20	0	0	20	0	0
10	4039123	.	C	T	21	13	34	0	2	36	0	0
10	4039129	.	C	T	17	13	30	0	3	33	0	0
10	4060322	.	T	C	1	4	5	0	0	5	0	0
10	4240887	.	T	C	14	13	27	0	1	28	0	0
10	4240899	.	C	T	15	10	25	0	1	26	0	0
10	4279695	.	T	C	3	2	5	0	0	5	0	0
10	4284081	.	A	G	2	3	5	0	0	5	0	0
10	4501609	.	C	T	6	3	9	0	0	9	0	0
10	4501817	.	A	G	9	4	13	0	0	13	0	0
10	4503291	.	G	T	8	8	16	0	2	18	0	0
10	4503736	.	C	T	14	10	24	0	0	24	0	0
10	4503901	.	C	G	13	7	20	0	2	22	0	0
10	4505886	.	T	A	14	18	32	0	1	33	0	0
10	4505887	.	T	A	13	18	31	0	2	33	0	0
10	4508492	.	T	A	15	11	26	0	1	27	0	0
10	4508518	.	G	T	4	11	15	0	16	31	0	0
10	4808047	.	G	A	1	2	3	0	0	3	0	0
10	4808105	.	A	G	2	2	4	0	0	4	0	0
10	4888387	.	C	A	1	3	4	0	0	4	0	0
10	4888457	.	A	G	3	4	7	0	0	7	0	0
10	4888582	.	A	G	5	0	5	0	4	9	0	0
10	4888808	.	C	T	1	2	3	0	0	3	0	0
10	4889228	.	C	T	0	3	3	0	0	3	0	0
10	4889248	.	T	C	4	3	7	0	0	7	0	0
10	4889302	.	C	A	5	2	7	0	0	7	0	0
10	4889704	.	A	G	2	4	6	1	0	7	0	0
10	4889923	.	A	G	2	0	2	0	4	6	0	0
10	4896742	.	G	A	2	5	7	0	0	7	0	0
10	4896766	.	G	A	3	7	10	0	0	10	0	0
10	4941113	.	A	G	10	8	18	0	2	20	0	0
10	4941421	.	T	G	9	7	16	0	0	16	0	0
10	4950824	.	G	T	11	11	22	0	1	23	0	0
10	4956906	.	C	T	4	3	7	0	0	7	0	0
10	4956966	.	G	A	4	4	8	0	0	8	0	0
10	4968900	.	G	C	9	9	18	0	0	18	0	0
10	4969014	.	T	A	9	10	19	0	2	21	0	0
10	4969036	.	T	G	8	0	8	0	6	14	0	0
10	4969069	.	C	A	8	5	13	0	0	13	0	0
10	5000719	.	C	T	1	13	14	2	16	32	0	0
10	5000753	.	C	T	2	15	17	0	17	34	0	0
10	5004215	.	C	T	7	4	11	0	0	11	0	0
10	5010287	.	G	A	20	23	43	0	0	43	0	0
10	5010344	.	T	G	21	22	43	0	1	44	0	0
10	5010407	.	G	A	25	18	43	0	2	45	0	0
10	5016797	.	G	A	24	27	51	0	3	54	0	0
10	5016917	.	C	G	26	22	48	0	1	49	0	0
10	5016922	.	A	G	24	22	46	0	3	49	0	0
10	5020320	.	G	A	36	32	68	0	0	68	0	0
10	5020326	.	T	C	34	35	69	0	1	70	0	0
10	5024410	.	C	T	32	26	58	0	2	60	0	0
10	5025848	.	C	A	7	9	16	0	0	16	0	0
10	5026058	.	C	T	9	6	15	0	1	16	0	0
10	5028877	.	A	G	12	7	19	0	1	20	0	0
10	5031869	.	T	C	7	14	21	0	0	21	0	0
10	5036521	.	G	A	1	12	13	0	13	26	0	0
10	5036522	.	A	G	13	13	26	0	0	26	0	0
10	5036729	.	C	T	11	9	20	0	0	20	0	0
10	5036881	.	A	G	5	1	6	0	3	9	0	0
10	5037119	.	T	A	12	12	24	0	0	24	0	0
10	5037147	.	C	T	13	11	24	0	2	26	0	0
10	5037181	.	T	G	11	7	18	0	0	18	0	0
10	5037372	.	A	T	11	6	17	0	1	18	0	0
10	5042034	.	A	C	2	3	5	0	0	5	0	0
10	5042113	.	C	T	4	9	13	0	0	13	0	0
10	5042217	.	A	G	4	6	10	0	0	10	0	0
10	5042239	.	G	A	4	4	8	0	0	8	0	0
10	5042469	.	G	A	12	7	19	0	0	19	0	0
10	5047452	.	A	G	5	6	11	0	2	13	0	0
10	5053518	.	C	G	4	3	7	0	0	7	0	0
10	5053556	.	T	C	1	4	5	0	0	5	0	0
10	5058715	.	C	T	0	4	4	0	4	8	0	0
10	5092764	.	T	C	7	5	12	2	0	14	0	0
10	5092772	.	A	G	7	4	11	3	0	14	0	0
10	5093157	.	T	C	5	11	16	0	1	17	0	0
10	5093222	.	A	G	10	11	21	0	2	23	0	0
10	5093240	.	C	A	7	10	17	0	1	18	0	0
10	5093274	.	A	G	7	4	11	0	1	12	0	0
10	5093295	.	T	A	3	4	7	0	0	7	0	0
10	5093592	.	G	C	4	3	7	0	1	8	0	0
10	5093615	.	G	A	3	2	5	0	1	6	0	0
10	5094649	.	C	A	3	9	12	0	0	12	0	0
10	5094778	.	G	T	4	6	10	0	0	10	0	0
10	5097478	.	G	A	3	9	12	0	0	12	0	0
10	5097520	.	A	G	5	8	13	0	1	14	0	0
10	5110656	.	T	C	4	4	8	0	0	8	0	0
10	5110761	.	A	G	2	1	3	0	1	4	0	0
10	5110777	.	G	A	3	3	6	0	0	6	0	0
10	5146488	.	G	A	0	14	14	0	2	16	0	0
10	5147130	.	A	G	3	5	8	0	0	8	0	0
10	5203569	.	G	A	6	5	11	0	1	12	0	0
10	5216249	.	A	G	6	4	10	0	0	10	0	0
10	5220608	.	C	T	10	6	16	0	0	16	0	0
10	5220835	.	G	A	1	3	4	1	4	9	0	0
10	5220940	.	T	A	3	5	8	0	0	8	0	0
10	5220997	.	C	A	1	4	5	0	1	6	0	0
10	5221039	.	G	A	6	3	9	0	0	9	0	0
10	5221238	.	C	A	5	10	15	0	1	16	0	0
10	5221292	.	C	A	6	4	10	0	1	11	0	0
10	5221297	.	T	G	9	4	13	0	0	13	0	0
10	5221336	.	G	C	5	6	11	0	1	12	0	0
10	5237199	.	C	A	1	3	4	0	0	4	0	0
10	5239838	.	G	A	0	4	4	0	3	7	0	0
10	5245194	.	C	G	1	0	1	0	6	7	0	0
10	5248247	.	T	C	3	2	5	0	0	5	0	0
10	5258914	.	T	A	11	4	15	0	1	16	0	0
10	5264280	.	A	G	17	8	25	0	0	25	0	0
10	5264310	.	G	A	14	3	17	0	2	19	0	0
10	5264458	.	G	A	7	9	16	0	0	16	0	0
10	5264534	.	C	A	2	5	7	0	0	7	0	0
10	5414339	.	C	T	2	2	4	0	0	4	0	0
10	5417669	.	T	A	2	2	4	0	0	4	0	0
10	5418569	.	C	T	3	5	8	0	0	8	0	0
10	5429905	.	G	A	1	5	6	0	7	13	0	0
10	5432576	.	T	C	7	3	10	0	1	11	0	0
10	5461988	.	C	A	11	7	18	0	1	19	0	0
10	5461994	.	T	A	11	6	17	0	0	17	0	0
10	5475206	.	G	C	12	4	16	0	0	16	0	0
10	5475214	.	T	G	10	4	14	0	0	14	0	0
10	5475406	.	A	T	4	2	6	0	3	9	0	0
10	5475526	.	T	C	5	3	8	0	0	8	0	0
10	5534369	.	T	A	1	5	6	0	0	6	0	0
10	5534483	.	T	C	4	9	13	0	0	13	0	0
10	5534487	.	C	T	1	9	10	0	3	13	0	0
10	5534527	.	G	T	5	11	16	0	1	17	0	0
10	5534539	.	G	A	7	8	15	0	1	16	0	0
10	5534611	.	C	T	8	4	12	0	0	12	0	0
10	5534612	.	A	G	7	4	11	0	1	12	0	0
10	5534646	.	A	G	9	9	18	0	0	18	0	0
10	5534878	.	C	T	15	11	26	0	0	26	0	0
10	5534946	.	A	G	12	11	23	0	0	23	0	0
10	5534950	.	A	T	10	11	21	0	0	21	0	0
10	5535359	.	A	T	8	8	16	0	0	16	0	0
10	5535368	.	T	A	6	6	12	0	0	12	0	0
10	5535436	.	C	T	6	4	10	0	0	10	0	0
10	5535445	.	T	C	6	3	9	0	2	11	0	0
10	5535483	.	A	T	11	8	19	0	0	19	0	0
10	5535540	.	T	G	8	12	20	0	0	20	0	0
10	5535561	.	T	A	3	13	16	0	0	16	0	0
10	5536182	.	A	C	1	2	3	0	0	3	0	0
10	5536240	.	T	C	4	4	8	0	0	8	0	0
10	5536256	.	G	A	3	4	7	0	2	9	0	0
10	5536534	.	T	A	3	3	6	0	0	6	0	0
10	5536636	.	A	C	1	3	4	0	1	5	0	0
10	5536831	.	G	T	1	2	3	0	0	3	0	0
10	5537048	.	G	T	2	7	9	0	0	9	0	0
10	5538302	.	T	G	10	6	16	0	0	16	0	0
10	5542152	.	T	C	7	6	13	0	0	13	0	0
10	5545438	.	C	T	8	7	15	0	2	17	0	0
10	5545465	.	T	C	8	7	15	0	1	16	0	0
10	5568155	.	T	G	3	3	6	0	1	7	0	0
10	5568212	.	G	A	6	3	9	0	0	9	0	0
10	5568319	.	A	C	5	4	9	0	1	10	0	0
10	5568329	.	A	G	9	3	12	0	0	12	0	0
10	5667467	.	T	A	2	3	5	0	1	6	0	0
10	5667504	.	G	A	5	4	9	0	0	10	1	0
10	5667605	.	C	T	5	2	7	0	0	7	0	0
10	5668024	.	C	T	1	3	4	0	0	4	0	0
10	5668103	.	C	T	5	6	11	0	0	11	0	0
10	5668135	.	G	A	5	6	11	0	0	11	0	0
10	5668218	.	G	C	5	8	13	0	0	13	0	0
10	5676520	.	T	A	1	4	5	0	0	5	0	0
10	5724020	.	T	C	5	8	13	0	0	13	0	0
10	5724095	.	T	C	11	9	20	0	0	20	0	0
10	5737757	.	G	A	9	9	18	0	1	19	0	0
10	5744934	.	C	T	17	10	27	0	0	27	0	0
10	5745015	.	C	A	14	12	26	0	0	26	0	0
10	5745290	.	T	C	10	7	17	3	1	21	0	0
10	5745299	.	C	T	6	10	16	3	3	22	0	0
10	5760455	.	T	C	10	8	18	0	2	20	0	0
10	5760461	.	A	G	12	9	21	0	0	21	0	0
10	5766958	.	A	G	21	14	35	0	1	36	0	0
10	5769541	.	G	T	23	16	39	0	0	39	0	0
10	5772568	.	A	G	23	25	48	0	3	51	0	0
10	5782337	.	C	T	33	31	64	0	2	66	0	0
10	5788755	.	A	C	10	6	16	0	0	16	0	0
10	5788806	.	G	A	8	9	17	0	0	17	0	0
10	5788877	.	G	A	5	7	12	0	0	12	0	0
10	5789155	.	G	T	12	6	18	0	0	18	0	0
10	5789241	.	T	C	11	3	14	0	0	14	0	0
10	5789415	.	A	G	3	3	6	0	1	7	0	0
10	5789417	.	G	C	4	3	7	0	0	7	0	0
10	5789758	.	G	T	7	9	16	0	2	18	0	0
10	5789806	.	C	T	13	3	16	0	0	16	0	0
10	5789834	.	T	G	12	3	15	0	0	15	0	0
10	5790080	.	A	G	6	8	14	0	2	16	0	0
10	5790097	.	G	A	6	5	11	1	0	12	0	0
10	5790135	.	T	C	4	2	6	5	0	11	0	0
10	5790210	.	C	T	2	15	17	1	1	19	0	0
10	5790278	.	G	T	8	8	16	2	0	18	0	0
10	5790570	.	A	C	4	6	10	0	1	11	0	0
10	5790640	.	T	G	6	2	8	0	1	9	0	0
10	5790866	.	A	C	8	5	13	0	0	13	0	0
10	5790913	.	A	C	4	5	9	0	1	10	0	0
10	5790922	.	C	A	5	4	9	0	1	10	0	0
10	5790956	.	C	G	3	5	8	0	7	15	0	0
10	5791030	.	A	G	8	10	18	0	0	18	0	0
10	5791044	.	C	T	1	8	9	0	9	18	0	0
10	5791184	.	G	A	4	9	13	0	1	14	0	0
10	5791238	.	A	G	3	5	8	0	0	8	0	0
10	5791377	.	A	T	8	7	15	0	1	16	0	0
10	5791387	.	G	A	7	9	16	0	1	17	0	0
10	5791417	.	C	T	0	13	13	0	8	21	0	0
10	5791454	.	T	A	10	9	19	0	1	20	0	0
10	5791459	.	C	A	9	9	18	0	0	18	0	0
10	5791852	.	A	G	2	2	4	0	0	4	0	0
10	5792512	.	A	T	2	11	13	0	1	14	0	0
10	5792533	.	A	T	5	8	13	0	1	14	0	0
10	5792573	.	G	A	8	6	14	0	0	14	0	0
10	5792584	.	A	G	8	6	14	0	0	14	0	0
10	5792615	.	A	G	5	7	12	0	0	12	0	0
10	5792667	.	G	A	5	6	11	0	0	11	0	0
10	5792722	.	T	C	5	1	6	0	11	17	0	0
10	5792757	.	A	G	5	10	15	0	1	16	0	0
10	5793568	.	T	A	1	2	3	0	0	3	0	0
10	5793827	.	A	C	2	3	5	0	0	5	0	0
10	5793863	.	A	G	3	3	6	0	0	6	0	0
10	5794423	.	C	G	3	6	9	0	0	9	0	0
10	5796929	.	C	T	0	4	4	0	4	8	0	0
10	5797664	.	A	G	5	2	7	0	0	7	0	0
10	5804114	.	C	A	2	3	5	0	0	5	0	0
10	5810738	.	C	G	1	2	3	0	0	3	0	0
10	5810739	.	T	G	1	2	3	0	0	3	0	0
10	5810940	.	A	G	2	2	4	0	0	4	0	0
10	5828645	.	A	G	8	8	16	0	0	16	0	0
10	5828660	.	A	G	12	9	21	0	1	22	0	0
10	5828704	.	C	A	0	11	11	0	15	26	0	0
10	5828840	.	A	G	7	8	15	0	1	16	0	0
10	5828945	.	A	G	5	3	8	0	0	8	0	0
10	5833462	.	C	A	3	2	5	0	0	5	0	0
10	5833474	.	G	A	3	2	5	0	0	5	0	0
10	5834171	.	C	T	6	5	11	0	0	11	0	0
10	5834242	.	G	A	4	3	7	0	1	8	0	0
10	5837337	.	G	A	3	4	7	0	0	7	0	0
10	5844718	.	G	A	3	4	7	0	0	7	0	0
10	5847731	.	A	T	3	3	6	0	0	6	0	0
10	5847821	.	G	T	2	4	6	0	0	6	0	0
10	6016545	.	G	T	2	2	4	0	2	6	0	0
10	6023750	.	A	G	5	2	7	0	0	7	0	0
10	6023946	.	T	C	3	2	5	0	0	5	0	0
10	6023958	.	G	A	2	4	6	0	1	7	0	0
10	6032880	.	A	G	6	0	6	0	5	11	0	0
10	6032886	.	G	A	7	4	11	0	0	11	0	0
10	6033452	.	T	C	2	4	6	0	0	6	0	0
10	6033469	.	A	C	3	6	9	0	0	9	0	0
10	6033627	.	A	T	10	4	14	0	0	14	0	0
10	6275517	.	G	A	1	5	6	0	0	6	0	0
10	6275577	.	C	T	2	3	5	0	0	5	0	0
10	6281946	.	A	G	1	0	1	0	4	5	0	0
10	6301828	.	C	T	4	6	10	0	0	10	0	0
10	6301930	.	C	T	10	7	17	0	0	17	0	0
10	6312954	.	A	T	9	5	14	0	0	14	0	0
10	6313643	.	C	T	6	2	8	0	0	8	0	0
10	6348571	.	C	A	5	5	10	2	1	13	0	0
10	6372501	.	C	T	14	14	28	0	1	29	0	0
10	6372915	.	G	A	8	10	18	0	0	18	0	0
10	6372964	.	T	C	6	12	18	0	1	19	0	0
10	6373003	.	T	C	3	6	9	0	0	9	0	0
10	6373011	.	G	A	0	4	4	0	2	6	0	0
10	6373079	.	C	G	4	3	7	0	0	7	0	0
10	6373332	.	A	T	6	6	12	0	0	12	0	0
10	6373336	.	C	G	6	5	11	0	1	12	0	0
10	6373472	.	T	A	5	3	8	0	1	9	0	0
10	6373522	.	A	G	1	4	5	0	2	8	1	0
10	6373524	.	A	G	3	5	8	0	0	8	0	0
10	6373679	.	A	G	12	6	18	0	1	19	0	0
10	6373758	.	A	C	13	9	22	0	1	23	0	0
10	6373794	.	A	G	13	7	20	0	0	20	0	0
10	6374017	.	A	G	9	9	18	0	0	18	0	0
10	6374041	.	A	T	10	10	20	0	1	21	0	0
10	6374068	.	G	T	11	10	21	0	1	22	0	0
10	6374235	.	T	C	15	16	31	0	0	31	0	0
10	6374279	.	G	A	0	18	18	0	12	30	0	0
10	6374352	.	C	T	23	9	32	0	0	32	0	0
10	6402213	.	T	A	2	2	4	0	1	5	0	0
10	6404358	.	T	A	1	2	3	0	0	3	0	0
10	6404899	.	G	T	3	2	5	0	0	5	0	0
10	6404900	.	G	T	3	2	5	0	0	5	0	0
10	6405321	.	A	G	1	3	4	0	0	4	0	0
10	6406142	.	T	A	1	4	5	0	0	5	0	0
10	6406549	.	G	T	0	2	2	0	2	4	0	0
10	6406677	.	A	G	1	2	3	0	1	4	0	0
10	6407247	.	A	C	1	2	3	0	0	3	0	0
10	6407257	.	A	G	1	0	1	0	2	3	0	0
10	6407449	.	C	T	2	4	6	0	0	6	0	0
10	6407475	.	G	A	0	3	3	0	5	8	0	0
10	6407559	.	A	T	5	6	11	0	1	12	0	0
10	6407605	.	C	A	4	4	8	0	0	8	0	0
10	6407732	.	A	G	4	2	6	1	1	8	0	0
10	6407764	.	C	A	3	4	7	1	0	8	0	0
10	6407833	.	T	C	3	7	10	1	1	12	0	0
10	6407871	.	A	G	4	8	12	1	0	13	0	0
10	6407904	.	C	T	10	5	15	0	0	15	0	0
10	6408986	.	A	G	11	6	17	0	0	17	0	0
10	6409095	.	G	A	0	3	3	0	11	14	0	0
10	6409120	.	G	A	10	3	13	0	0	13	0	0
10	6409145	.	G	C	8	3	11	0	0	11	0	0
10	6409267	.	C	A	3	5	8	0	0	8	0	0
10	6409448	.	C	T	7	5	12	0	0	12	0	0
10	6409455	.	T	A	4	7	11	0	1	12	0	0
10	6409506	.	A	G	8	11	19	0	0	19	0	0
10	6409583	.	C	T	3	4	7	0	1	8	0	0
10	6473544	.	T	C	13	14	27	0	3	30	0	0
10	6473685	.	T	C	11	14	25	0	0	25	0	0
10	6473704	.	C	G	12	13	25	0	0	25	0	0
10	6473851	.	A	G	18	14	32	0	0	32	0	0
10	6473862	.	C	T	2	12	14	0	17	31	0	0
10	6473908	.	A	G	16	11	27	0	1	28	0	0
10	6473996	.	T	C	11	8	19	0	0	19	0	0
10	6474057	.	T	A	6	11	17	0	0	17	0	0
10	6479444	.	T	C	18	0	18	0	9	27	0	0
10	6479471	.	C	T	2	8	10	0	14	24	0	0
10	6510756	.	T	C	21	26	47	0	2	49	0	0
10	6510786	.	T	G	21	23	44	0	4	48	0	0
10	6510825	.	T	C	24	24	48	0	4	52	0	0
10	6517593	.	T	A	26	29	55	0	1	56	0	0
10	6517663	.	A	G	21	0	21	0	26	47	0	0
10	6517726	.	C	T	17	16	33	0	1	34	0	0
10	6517959	.	A	G	21	9	30	0	3	33	0	0
10	6522267	.	A	T	3	8	11	0	0	11	0	0
10	6531002	.	A	G	2	7	9	0	0	9	0	0
10	6531297	.	T	C	3	7	10	0	0	10	0	0
10	6533850	.	T	A	3	6	9	0	1	10	0	0
10	6546851	.	A	G	6	3	9	0	0	9	0	0
10	6546929	.	C	A	0	4	4	0	4	8	0	0
10	6549360	.	C	T	1	4	5	0	0	5	0	0
10	6781239	.	G	A	6	8	14	0	0	14	0	0
10	6781278	.	T	A	8	19	27	1	2	30	0	0
10	6781286	.	G	T	11	19	30	1	1	32	0	0
10	6781362	.	G	A	16	13	29	0	0	29	0	0
10	6781372	.	T	A	17	12	29	0	6	35	0	0
10	6781450	.	T	C	18	9	27	0	2	29	0	0
10	6781506	.	A	T	12	16	28	0	0	28	0	0
10	6781664	.	A	T	14	21	35	0	0	35	0	0
10	6781742	.	G	T	4	9	13	0	0	13	0	0
10	6781786	.	A	T	7	7	14	0	0	14	0	0
10	6781867	.	C	A	5	10	15	0	3	18	0	0
10	6781903	.	T	G	8	12	20	0	0	20	0	0
10	6781918	.	A	T	11	12	23	0	1	25	1	0
10	6782020	.	G	C	9	10	19	0	0	19	0	0
10	6782036	.	T	C	12	0	12	0	5	17	0	0
10	6782163	.	T	C	16	6	22	0	2	24	0	0
10	6782220	.	A	G	8	7	15	2	1	18	0	0
10	6782267	.	T	A	6	6	12	4	0	16	0	0
10	6782279	.	A	C	3	6	9	3	2	14	0	0
10	6782454	.	C	G	10	21	31	0	1	32	0	0
10	6782489	.	T	G	11	20	31	0	0	31	0	0
10	6782624	.	A	G	12	23	35	0	2	37	0	0
10	6782636	.	T	A	10	27	37	0	2	39	0	0
10	6782664	.	A	G	14	26	40	0	1	41	0	0
10	6786326	.	C	T	2	27	29	0	12	41	0	0
10	6786564	.	A	G	19	18	37	0	1	38	0	0
10	6804756	.	T	C	7	0	7	0	7	14	0	0
10	6824761	.	A	C	10	12	22	0	2	24	0	0
10	6824845	.	A	T	11	5	16	0	0	16	0	0
10	6824877	.	T	G	6	10	16	0	1	17	0	0
10	6831446	.	T	C	3	5	8	0	0	8	0	0
10	6834065	.	A	T	6	7	13	0	0	13	0	0
10	6834341	.	G	A	11	10	21	0	0	21	0	0
10	6834380	.	C	A	2	8	10	0	6	16	0	0
10	6851184	.	C	A	5	3	8	0	1	9	0	0
10	7210001	.	G	A	3	27	30	0	22	52	0	0
10	7221810	.	A	G	18	12	30	0	0	30	0	0
10	7222213	.	T	C	18	16	34	0	1	35	0	0
10	7224964	.	A	G	22	22	44	0	3	47	0	0
10	7231728	.	T	C	22	21	43	0	0	43	0	0
10	7231821	.	T	A	21	23	44	0	2	46	0	0
10	7231964	.	G	C	26	19	45	0	1	46	0	0
10	7232043	.	T	A	18	17	35	0	4	39	0	0
10	7232058	.	G	T	3	19	22	0	17	39	0	0
10	7232104	.	A	T	18	14	32	0	0	32	0	0
10	7232309	.	C	T	7	6	13	0	0	13	0	0
10	7232416	.	T	C	17	14	31	0	2	33	0	0
10	7232420	.	T	C	19	14	33	0	1	34	0	0
10	7233038	.	T	C	25	15	40	0	3	43	0	0
10	7233218	.	A	G	28	11	39	0	5	44	0	0
10	7233440	.	A	T	31	28	59	0	6	65	0	0
10	7233457	.	C	G	34	30	64	0	2	66	0	0
10	7233518	.	T	C	21	24	45	0	4	49	0	0
10	7233854	.	A	T	15	22	37	0	3	40	0	0
10	7233939	.	C	T	4	7	11	0	1	12	0	0
10	7284182	.	T	A	6	9	15	0	1	16	0	0
10	7284403	.	C	T	12	5	17	0	0	17	0	0
10	7284520	.	A	G	7	4	11	0	0	11	0	0
10	7284556	.	T	A	7	3	10	1	1	12	0	0
10	7284629	.	T	C	7	6	13	0	2	15	0	0
10	7311979	.	G	A	6	3	9	1	0	10	0	0
10	7311997	.	T	G	5	3	8	1	0	9	0	0
10	7312057	.	A	G	4	4	8	0	1	9	0	0
10	7483649	.	G	C	2	0	2	0	2	4	0	0
10	7512359	.	G	C	3	2	5	0	0	5	0	0
10	7519459	.	G	T	1	3	4	0	0	5	1	0
10	7564294	.	C	T	6	5	11	0	3	14	0	0
10	7593246	.	A	T	6	7	13	0	1	14	0	0
10	7593349	.	C	A	6	11	17	0	1	18	0	0
10	7617113	.	A	T	34	22	56	0	4	60	0	0
10	7617126	.	T	C	37	27	64	0	1	65	0	0
10	7617242	.	G	A	30	27	57	0	2	59	0	0
10	7617327	.	A	C	24	17	41	0	16	57	0	0
10	7617350	.	A	T	26	32	58	0	11	69	0	0
10	7617636	.	A	G	19	0	19	0	24	43	0	0
10	7624174	.	T	C	4	0	4	0	3	7	0	0
10	7635687	.	G	A	1	3	4	1	0	5	0	0
10	7640501	.	C	T	16	28	44	0	3	47	0	0
10	7640676	.	G	A	16	23	39	0	0	39	0	0
10	7671368	.	T	C	3	7	10	0	1	11	0	0
10	7671425	.	G	A	4	12	16	0	1	17	0	0
10	7672832	.	A	C	11	6	17	0	1	18	0	0
10	7672853	.	G	A	12	7	19	0	0	19	0	0
10	7673819	.	C	G	4	6	10	0	0	10	0	0
10	7673849	.	A	G	3	4	7	0	0	7	0	0
10	7674079	.	T	G	4	6	10	0	0	10	0	0
10	7674136	.	C	T	3	6	9	0	0	9	0	0
10	7674393	.	C	T	2	5	7	0	0	7	0	0
10	7674471	.	A	G	4	5	9	0	1	10	0	0
10	7674506	.	A	G	7	7	14	0	1	15	0	0
10	7678121	.	T	C	10	14	24	0	2	26	0	0
10	7678154	.	C	T	1	13	14	0	6	20	0	0
10	7678525	.	C	T	0	10	10	0	11	21	0	0
10	7696900	.	G	A	2	6	8	0	0	8	0	0
10	7700615	.	A	G	4	6	10	0	1	11	0	0
10	7700676	.	G	A	6	7	13	0	0	13	0	0
10	7701852	.	A	C	5	1	6	0	6	12	0	0
10	7705560	.	G	A	0	3	3	0	2	5	0	0
10	7709761	.	T	C	6	8	14	0	2	16	0	0
10	7709975	.	A	G	5	4	9	0	0	9	0	0
10	7709978	.	T	C	5	4	9	0	0	9	0	0
10	7712180	.	T	A	6	9	15	0	0	15	0	0
10	7712206	.	G	A	8	8	16	0	0	16	0	0
10	7712228	.	C	T	6	6	12	0	1	13	0	0
10	7713924	.	A	G	7	0	7	0	7	14	0	0
10	7721459	.	A	G	8	6	14	0	0	14	0	0
10	7721746	.	G	A	8	9	17	0	0	17	0	0
10	7722595	.	A	G	2	6	8	0	3	11	0	0
10	7723004	.	T	C	2	9	11	1	0	12	0	0
10	7723157	.	A	G	10	15	25	0	1	26	0	0
10	7723218	.	T	C	7	21	28	0	0	28	0	0
10	7723275	.	C	A	9	21	30	0	0	30	0	0
10	7723337	.	C	G	9	7	16	0	1	17	0	0
10	7727393	.	T	C	1	6	7	0	0	7	0	0
10	7727505	.	T	A	4	4	8	0	0	8	0	0
10	7727598	.	A	T	2	5	7	0	0	7	0	0
10	7727704	.	T	A	2	3	5	0	0	5	0	0
10	7734401	.	G	A	2	2	4	0	0	4	0	0
10	7734465	.	C	T	4	2	6	0	1	7	0	0
10	7770111	.	G	A	1	4	5	0	0	5	0	0
10	7770200	.	A	G	1	4	5	0	0	5	0	0
10	7770201	.	G	A	1	4	5	0	0	5	0	0
10	7770425	.	T	C	1	0	1	0	4	5	0	0
10	7770467	.	C	T	0	5	5	0	1	6	0	0
10	7771634	.	T	A	3	4	7	0	1	8	0	0
10	7771735	.	A	C	4	4	8	0	0	8	0	0
10	7771769	.	C	T	6	6	12	0	0	12	0	0
10	7771778	.	G	A	7	5	12	0	0	12	0	0
10	7772012	.	T	G	5	4	9	0	1	10	0	0
10	7772272	.	C	T	4	2	6	0	0	6	0	0
10	7772394	.	C	T	0	3	3	0	1	4	0	0
10	7804460	.	T	C	1	2	3	0	0	3	0	0
10	7804461	.	T	C	1	2	3	0	0	3	0	0
10	7810461	.	A	T	23	23	46	0	1	47	0	0
10	7810565	.	G	A	19	21	40	0	1	41	0	0
10	7811062	.	T	A	7	5	12	0	0	12	0	0
10	7811075	.	T	C	5	5	10	0	0	10	0	0
10	7811935	.	A	G	17	8	25	0	1	26	0	0
10	7812420	.	A	G	12	16	28	0	2	30	0	0
10	7812430	.	A	G	15	16	31	0	1	32	0	0
10	7815118	.	G	A	14	9	23	0	1	24	0	0
10	7815187	.	G	A	15	8	23	0	2	25	0	0
10	7831879	.	C	T	10	6	16	1	1	18	0	0
10	7843465	.	A	G	3	2	5	0	0	5	0	0
10	7901065	.	T	G	1	4	5	0	0	5	0	0
10	7901760	.	A	T	1	2	3	0	0	3	0	0
10	7902045	.	T	G	3	5	8	0	0	8	0	0
10	7909269	.	C	A	1	3	4	0	0	4	0	0
10	7909665	.	T	A	2	2	4	0	0	4	0	0
10	7916836	.	A	C	10	9	19	0	1	20	0	0
10	7916930	.	C	A	10	14	24	0	1	25	0	0
10	7917036	.	A	T	8	20	28	0	2	30	0	0
10	7917114	.	T	C	18	11	29	0	3	32	0	0
10	7917411	.	C	A	0	10	10	0	10	20	0	0
10	7917483	.	C	A	4	11	15	0	1	16	0	0
10	7917551	.	A	G	15	15	30	0	1	31	0	0
10	7917592	.	T	C	21	16	37	0	1	38	0	0
10	7917686	.	T	C	13	20	33	0	1	34	0	0
10	7917690	.	A	T	14	18	32	0	2	34	0	0
10	7920910	.	T	G	16	19	35	0	2	37	0	0
10	7920913	.	C	T	17	17	34	0	4	38	0	0
10	7922210	.	G	T	10	13	23	0	2	25	0	0
10	7922294	.	C	A	6	10	16	0	1	17	0	0
10	7926899	.	A	G	15	14	29	0	2	31	0	0
10	7929647	.	T	C	14	1	15	0	8	23	0	0
10	7936283	.	T	G	9	14	23	0	2	25	0	0
10	7938629	.	C	T	9	9	18	0	3	21	0	0
10	7938659	.	A	G	9	7	16	0	2	18	0	0
10	7938683	.	T	C	10	6	16	0	0	16	0	0
10	7959655	.	T	A	7	8	15	0	1	16	0	0
10	7968160	.	G	T	4	6	10	0	0	10	0	0
10	7968274	.	G	T	4	4	8	0	0	8	0	0
10	7984677	.	A	T	14	20	34	0	1	35	0	0
10	7986217	.	T	C	13	8	21	0	3	24	0	0
10	7986307	.	C	T	0	14	14	0	22	36	0	0
10	7986432	.	C	T	2	13	15	0	24	39	0	0
10	7989000	.	C	T	8	5	13	0	2	15	0	0
10	7989162	.	T	G	5	6	11	0	0	11	0	0
10	7989237	.	G	A	3	9	12	0	0	12	0	0
10	7989287	.	G	A	8	16	24	0	0	24	0	0
10	7989348	.	C	T	13	14	27	0	1	28	0	0
10	7989576	.	C	T	10	18	28	0	1	29	0	0
10	7992197	.	T	C	11	14	25	0	1	26	0	0
10	7996021	.	G	A	4	5	9	0	2	11	0	0
10	8001365	.	A	G	4	11	15	0	1	16	0	0
10	8005785	.	T	A	1	4	5	0	0	5	0	0
10	8005845	.	C	A	1	4	5	0	2	7	0	0
10	8009996	.	A	C	2	4	6	0	0	6	0	0
10	8010064	.	A	G	2	6	8	0	0	8	0	0
10	8036884	.	C	T	0	2	2	1	1	4	0	0
10	8037156	.	A	G	2	4	6	0	0	6	0	0
10	8037258	.	C	T	6	2	8	0	0	8	0	0
10	8037301	.	A	T	6	4	10	1	1	12	0	0
10	8037519	.	G	T	1	5	6	0	0	6	0	0
10	8037752	.	T	C	1	3	4	0	0	4	0	0
10	8037797	.	T	C	4	2	6	0	0	6	0	0
10	8040536	.	T	C	2	3	5	0	0	5	0	0
10	8041837	.	C	A	1	3	4	0	0	4	0	0
10	8091212	.	G	A	19	27	46	0	0	46	0	0
10	8097929	.	C	G	18	15	33	0	1	34	0	0
10	8160813	.	T	G	6	4	10	0	1	11	0	0
10	8160888	.	G	A	4	3	7	0	0	7	0	0
10	8160891	.	T	C	4	0	4	0	3	7	0	0
10	8163440	.	G	A	7	4	11	0	1	12	0	0
10	8164925	.	C	T	4	2	6	0	2	8	0	0
10	8170269	.	A	G	3	4	7	0	0	7	0	0
10	8174712	.	A	C	4	0	4	0	3	7	0	0
10	8177559	.	C	T	1	3	4	0	3	7	0	0
10	8188485	.	C	T	0	3	3	0	3	6	0	0
10	8188503	.	G	A	1	2	3	0	1	4	0	0
10	8202517	.	C	T	1	2	3	0	0	3	0	0
10	8202523	.	C	T	1	2	3	0	0	3	0	0
10	8208610	.	G	A	4	2	6	0	0	6	0	0
10	8236048	.	T	C	4	2	6	0	0	6	0	0
10	8236775	.	T	C	5	3	8	0	0	8	0	0
10	8265917	.	A	T	7	5	12	0	0	12	0	0
10	8265922	.	T	C	6	2	8	0	3	11	0	0
10	8266248	.	C	T	1	20	21	0	20	41	0	0
10	8266383	.	A	G	15	21	36	0	0	36	0	0
10	8269224	.	G	A	18	18	36	0	0	36	0	0
10	8269377	.	G	A	13	13	26	0	0	26	0	0
10	8278160	.	T	C	11	6	17	0	0	17	0	0
10	8278214	.	A	G	5	9	14	0	0	14	0	0
10	8288983	.	A	G	5	2	7	0	0	7	0	0
10	8295026	.	C	T	1	4	5	0	4	9	0	0
10	8295196	.	T	G	6	4	10	0	0	10	0	0
10	8295295	.	C	A	0	8	8	0	4	12	0	0
10	8335402	.	A	G	1	3	4	0	0	4	0	0
10	8408411	.	A	G	1	2	3	0	0	3	0	0
10	8418671	.	A	G	3	3	6	0	0	6	0	0
10	8434520	.	G	T	3	2	5	0	0	5	0	0
10	8434530	.	T	A	3	2	5	0	0	5	0	0
10	8437947	.	T	C	1	4	5	0	0	5	0	0
10	8468942	.	A	C	5	2	7	0	0	7	0	0
10	8537882	.	G	A	0	2	2	0	1	3	0	0
10	8629847	.	A	G	3	0	3	0	3	6	0	0
10	8630402	.	G	T	2	7	9	0	12	21	0	0
10	8630428	.	A	G	13	5	18	0	1	19	0	0
10	8630452	.	G	T	13	6	19	0	1	20	0	0
10	8630527	.	G	A	9	7	16	0	0	16	0	0
10	8630618	.	C	T	7	5	12	0	3	15	0	0
10	8630631	.	T	C	9	8	17	0	1	18	0	0
10	8630702	.	T	C	6	5	11	2	1	14	0	0
10	8631135	.	A	G	9	5	14	0	1	15	0	0
10	8631152	.	A	T	6	6	12	0	1	13	0	0
10	8660722	.	C	T	18	9	27	0	1	28	0	0
10	8670139	.	G	A	7	10	17	0	0	17	0	0
10	8686996	.	T	A	1	2	3	0	0	3	0	0
10	8838092	.	C	A	3	4	7	0	0	7	0	0
10	8950022	.	T	C	3	0	3	0	6	9	0	0
10	8950055	.	G	A	5	6	11	0	0	11	0	0
10	8950108	.	A	G	5	4	9	0	0	9	0	0
10	8952018	.	T	C	3	6	9	0	0	9	0	0
10	8952601	.	A	G	7	4	11	0	0	11	0	0
10	8955356	.	C	A	4	2	6	0	0	6	0	0
10	8974772	.	G	A	0	2	2	0	3	5	0	0
10	8976311	.	T	G	3	2	5	0	0	5	0	0
10	8976417	.	G	A	4	2	6	0	0	6	0	0
10	9006634	.	T	C	12	14	26	0	0	26	0	0
10	9089524	.	A	C	6	0	6	0	5	11	0	0
10	9089569	.	T	A	6	10	16	0	3	19	0	0
10	9089602	.	T	C	3	0	3	0	9	12	0	0
10	9164807	.	T	C	8	5	13	0	1	14	0	0
10	9165056	.	T	C	5	3	8	0	0	8	0	0
10	9168991	.	C	T	9	6	15	0	0	15	0	0
10	9177363	.	T	C	7	10	17	0	0	17	0	0
10	9181508	.	T	A	12	5	17	0	4	21	0	0
10	9184326	.	T	A	4	6	10	0	2	12	0	0
10	9184533	.	C	T	10	7	17	0	0	17	0	0
10	9209311	.	A	T	3	3	6	0	0	6	0	0
10	9219645	.	G	A	0	2	2	0	3	5	0	0
10	9234056	.	T	A	1	2	3	0	0	3	0	0
10	9234236	.	T	C	2	2	4	0	0	4	0	0
10	9234573	.	G	T	10	3	13	0	0	13	0	0
10	9234742	.	G	A	0	4	4	0	4	8	0	0
10	9255670	.	G	A	2	13	15	0	1	16	0	0
10	9264765	.	G	C	1	3	4	0	0	4	0	0
10	9265007	.	C	A	5	3	8	0	1	9	0	0
10	9268272	.	T	G	1	5	6	0	0	6	0	0
10	9269228	.	G	A	4	6	10	0	1	11	0	0
10	9305277	.	G	A	6	5	11	0	0	11	0	0
10	9305433	.	A	G	8	8	16	0	1	17	0	0
10	9305534	.	A	C	6	4	10	0	0	10	0	0
10	9305543	.	C	T	7	3	10	1	0	11	0	0
10	9308057	.	C	T	10	3	13	0	0	13	0	0
10	9308092	.	G	A	3	5	8	0	0	8	0	0
10	9308133	.	G	A	3	2	5	0	1	6	0	0
10	9346253	.	T	A	3	3	6	0	2	8	0	0
10	9347928	.	C	G	2	0	2	0	5	7	0	0
10	9361037	.	C	T	3	5	8	0	0	8	0	0
10	9361891	.	G	A	3	11	14	0	0	14	0	0
10	9369466	.	A	G	3	3	6	0	0	6	0	0
10	9370274	.	G	A	7	7	14	0	0	14	0	0
10	9370755	.	A	G	4	5	9	0	0	9	0	0
10	9390726	.	C	T	5	3	8	0	0	8	0	0
10	9395012	.	C	T	5	2	7	0	0	7	0	0
10	9419821	.	G	A	13	11	24	0	2	26	0	0
10	9419901	.	T	A	8	16	24	0	0	24	0	0
10	9419902	.	A	G	8	16	24	0	0	24	0	0
10	9595693	.	C	T	4	3	7	0	0	7	0	0
10	9601813	.	T	C	3	2	5	0	0	5	0	0
10	9612572	.	T	A	1	5	6	0	0	6	0	0
10	9618055	.	G	A	1	3	4	0	2	6	0	0
10	9618271	.	T	G	0	3	3	0	0	3	0	0
10	9618295	.	G	A	3	3	6	0	0	6	0	0
10	9632265	.	G	A	0	4	4	0	6	10	0	0
10	9632336	.	A	G	6	0	6	0	4	10	0	0
10	9638888	.	A	G	5	4	9	0	0	9	0	0
10	9639172	.	T	C	3	6	9	0	0	9	0	0
10	9642674	.	T	A	6	3	9	0	0	9	0	0
10	9644669	.	T	C	3	3	6	3	1	10	0	0
10	9697243	.	C	A	6	3	9	0	1	10	0	0
10	9697270	.	A	T	4	3	7	0	0	7	0	0
10	9701905	.	C	T	8	5	13	0	0	13	0	0
10	9714771	.	T	C	9	12	21	0	3	24	0	0
10	9714801	.	C	T	12	7	19	0	1	20	0	0
10	9714819	.	A	G	9	9	18	0	1	19	0	0
10	9729611	.	G	A	1	9	10	0	10	20	0	0
10	9776699	.	C	T	11	13	24	0	1	25	0	0
10	9781455	.	G	A	16	17	33	0	3	36	0	0
10	9781509	.	G	A	25	13	38	0	0	38	0	0
10	9784087	.	C	T	20	10	30	0	1	31	0	0
10	9784238	.	G	A	1	20	21	0	10	31	0	0
10	9789262	.	C	T	17	18	35	0	2	37	0	0
10	9800719	.	G	T	16	23	39	1	0	40	0	0
10	9802771	.	T	C	22	17	39	0	1	40	0	0
10	9802804	.	C	T	14	16	30	0	2	32	0	0
10	9806731	.	A	G	16	1	17	0	23	40	0	0
10	9807014	.	T	G	17	18	35	1	4	40	0	0
10	9807203	.	G	A	26	11	37	0	1	38	0	0
10	9836752	.	C	T	1	2	3	0	0	3	0	0
10	9836809	.	G	T	1	2	3	0	2	5	0	0
10	9837100	.	T	C	4	4	8	0	0	8	0	0
10	9837191	.	A	G	5	5	10	0	0	10	0	0
10	9846240	.	A	G	10	12	22	0	4	26	0	0
10	9846261	.	G	A	12	9	21	0	2	23	0	0
10	9846285	.	T	G	8	6	14	0	3	17	0	0
10	9846602	.	C	G	0	5	5	0	10	15	0	0
10	9856350	.	T	C	9	0	9	0	4	13	0	0
10	9856390	.	T	C	4	0	4	0	9	13	0	0
10	9861038	.	A	T	2	5	7	0	0	7	0	0
10	9861103	.	G	T	2	6	8	0	0	8	0	0
10	9895348	.	G	A	4	6	10	0	0	10	0	0
10	9899215	.	G	T	7	3	10	0	0	10	0	0
10	9899302	.	G	A	7	4	11	0	0	11	0	0
10	9899308	.	G	A	4	7	11	0	0	11	0	0
10	9961471	.	A	T	5	3	8	0	2	10	0	0
10	10254913	.	G	A	1	1	2	0	4	6	0	0
10	10261887	.	G	C	8	8	16	0	0	16	0	0
10	10261893	.	C	A	10	8	18	0	1	19	0	0
10	10262013	.	T	C	4	5	9	0	0	9	0	0
10	10262157	.	A	G	5	5	10	0	0	10	0	0
10	10269930	.	T	C	9	5	14	0	1	15	0	0
10	10317392	.	A	T	7	7	14	0	2	16	0	0
10	10325451	.	T	C	3	4	7	0	1	8	0	0
10	10379918	.	T	C	1	3	4	0	0	4	0	0
10	10380074	.	G	A	1	2	3	0	0	3	0	0
10	10535877	.	C	T	3	3	6	0	0	6	0	0
10	10535884	.	C	A	3	3	6	0	0	6	0	0
10	10561657	.	G	T	1	2	3	0	0	3	0	0
10	10567262	.	A	G	4	3	7	0	0	7	0	0
10	10636799	.	C	A	5	2	7	0	1	9	1	0
10	10636896	.	G	A	0	2	2	0	6	8	0	0
10	10636946	.	A	G	3	3	6	0	2	8	0	0
10	10997792	.	G	A	1	2	3	0	0	3	0	0
10	11276479	.	C	T	2	4	6	0	0	6	0	0
10	11279555	.	G	A	13	8	21	0	0	21	0	0
10	11280118	.	C	T	11	9	20	0	2	22	0	0
10	11280146	.	C	T	13	13	26	0	0	26	0	0
10	11280749	.	T	A	3	3	6	0	0	6	0	0
10	11280834	.	A	C	3	3	6	0	0	6	0	0
10	11280839	.	G	C	2	3	5	0	0	5	0	0
10	11280878	.	A	G	2	4	6	0	0	6	0	0
10	11280942	.	A	G	1	0	1	0	3	4	0	0
10	11280999	.	A	G	1	2	3	0	0	3	0	0
10	11281005	.	T	C	1	2	3	0	0	3	0	0
10	11281492	.	G	A	2	6	8	0	0	8	0	0
10	11281800	.	A	G	1	2	3	0	0	3	0	0
10	11282072	.	G	A	4	4	8	0	1	9	0	0
10	11282099	.	A	G	4	4	8	0	0	8	0	0
10	11282194	.	A	G	8	2	10	0	1	11	0	0
10	11282933	.	T	A	8	11	19	0	0	19	0	0
10	11286830	.	C	T	3	5	8	0	0	8	0	0
10	11287343	.	A	G	3	1	4	0	4	8	0	0
10	11298651	.	G	A	1	4	5	0	0	5	0	0
10	11298652	.	A	C	1	4	5	0	0	5	0	0
10	11298852	.	G	A	3	2	5	0	0	5	0	0
10	11298864	.	A	G	3	2	5	0	0	5	0	0
10	11300848	.	C	T	2	3	5	0	0	5	0	0
10	11309859	.	C	G	4	1	5	0	7	12	0	0
10	11310041	.	G	A	3	10	13	0	0	13	0	0
10	11310500	.	G	A	7	3	10	0	1	11	0	0
10	11310501	.	C	A	7	4	11	0	0	11	0	0
10	11310618	.	A	C	5	5	10	0	0	10	0	0
10	11310648	.	G	A	5	7	12	0	1	13	0	0
10	11310682	.	G	A	3	7	10	0	1	11	0	0
10	11311700	.	T	C	2	2	4	0	0	4	0	0
10	11322985	.	T	C	3	10	13	0	3	16	0	0
10	11323032	.	G	A	6	8	14	0	1	15	0	0
10	11323092	.	G	A	6	10	16	0	1	17	0	0
10	11325271	.	T	G	0	1	1	0	1	2	0	0
10	11327429	.	G	A	6	4	10	0	1	11	0	0
10	11327466	.	G	A	9	4	13	0	0	13	0	0
10	11327484	.	C	T	0	6	6	0	10	16	0	0
10	11327703	.	C	T	5	6	11	0	0	11	0	0
10	11328246	.	G	C	5	5	10	0	0	10	0	0
10	11328263	.	G	A	6	5	11	0	0	11	0	0
10	11331922	.	C	T	1	5	6	0	3	9	0	0
10	11332206	.	A	G	2	4	6	0	0	6	0	0
10	11334415	.	C	A	0	3	3	0	5	8	0	0
10	11334547	.	A	G	4	9	13	0	0	13	0	0
10	11339235	.	G	A	12	5	17	0	1	18	0	0
10	11343169	.	C	T	9	4	13	0	2	15	0	0
10	11359991	.	A	G	5	0	5	0	9	14	0	0
10	11362275	.	C	T	22	26	48	0	1	49	0	0
10	11368116	.	G	T	11	8	19	0	0	19	0	0
10	11398168	.	T	G	3	0	3	0	5	8	0	0
10	11399574	.	C	T	2	5	7	0	1	8	0	0
10	11403954	.	T	C	2	4	6	0	0	6	0	0
10	11501181	.	C	A	4	4	8	0	0	8	0	0
10	11790947	.	T	C	7	15	22	0	0	22	0	0
10	11805601	.	T	C	3	7	10	0	0	10	0	0
10	12616396	.	A	G	3	3	6	0	0	6	0	0
10	12729361	.	C	T	1	1	2	0	1	3	0	0
10	12730352	.	T	C	2	5	7	0	0	7	0	0
10	13063752	.	A	G	2	0	2	0	3	5	0	0
10	13063759	.	A	G	1	0	1	0	2	3	0	0
10	13283660	.	C	A	4	4	8	0	0	8	0	0
10	13286472	.	T	C	5	4	9	0	1	10	0	0
10	13286677	.	A	G	3	6	9	0	1	10	0	0
10	13286778	.	G	A	0	2	2	0	4	6	0	0
10	13460337	.	C	A	1	5	6	0	0	6	0	0
10	13460494	.	A	C	6	10	16	0	2	18	0	0
10	13460671	.	G	A	14	13	27	0	0	27	0	0
10	13460691	.	T	C	15	12	27	0	4	31	0	0
10	13460745	.	C	A	2	13	15	0	18	33	0	0
10	13460765	.	C	T	18	14	32	0	2	34	0	0
10	13460814	.	A	T	25	13	38	0	0	38	0	0
10	13461080	.	T	C	19	0	19	0	16	35	0	0
10	13476010	.	A	G	18	16	34	0	4	38	0	0
10	13529250	.	C	G	10	17	27	0	1	28	0	0
10	13529270	.	T	C	10	19	29	0	2	31	0	0
10	13536790	.	T	C	9	0	9	0	9	18	0	0
10	14263832	.	G	A	1	4	5	0	0	5	0	0
10	14491139	.	C	T	12	10	22	0	1	23	0	0
10	14526640	.	A	C	2	3	5	0	0	5	0	0
10	14532271	.	T	C	5	5	10	0	2	12	0	0
10	14532398	.	T	C	5	0	5	0	10	15	0	0
10	14533352	.	A	G	7	10	17	0	0	17	0	0
10	14536393	.	G	A	5	3	8	0	1	9	0	0
10	14545572	.	A	G	13	14	27	0	0	27	0	0
10	14871245	.	T	A	13	4	17	0	6	23	0	0
10	14871758	.	C	G	19	7	26	0	3	29	0	0
10	14871768	.	A	G	20	10	30	0	0	30	0	0
10	14871801	.	A	C	13	18	31	0	0	31	0	0
10	14873175	.	T	G	17	12	29	0	2	31	0	0
10	14873220	.	A	G	21	13	34	0	0	34	0	0
10	14878863	.	C	G	15	9	24	0	0	24	0	0
10	14878890	.	T	C	13	0	13	0	9	22	0	0
10	14879027	.	G	A	14	8	22	0	0	22	0	0
10	14885337	.	A	G	7	7	14	0	0	14	0	0
10	14885957	.	C	A	2	7	9	0	11	20	0	0
10	14892211	.	C	T	3	9	12	0	14	26	0	0
10	14920909	.	G	A	9	5	14	0	1	15	0	0
10	14920912	.	T	C	9	0	9	0	6	15	0	0
10	14920988	.	T	G	6	2	8	0	0	8	0	0
10	14921002	.	G	A	4	2	6	0	1	7	0	0
10	14921053	.	G	C	3	0	3	0	5	8	0	0
10	14921086	.	A	C	6	0	6	0	7	13	0	0
10	15073043	.	C	T	2	3	5	0	0	5	0	0
10	15277481	.	T	C	8	10	18	0	2	20	0	0
10	15285696	.	C	T	10	14	24	0	0	24	0	0
10	15287463	.	T	C	8	9	17	0	1	18	0	0
10	15287883	.	C	A	13	5	18	0	4	22	0	0
10	15287933	.	C	T	13	17	30	0	0	30	0	0
10	15291157	.	G	A	1	16	17	0	16	33	0	0
10	15295913	.	T	C	13	15	28	0	0	28	0	0
10	15296219	.	G	A	1	12	13	0	14	27	0	0
10	15298458	.	G	C	14	14	28	0	1	29	0	0
10	15298518	.	G	A	11	27	38	0	0	38	0	0
10	15303975	.	A	T	30	22	52	0	1	53	0	0
10	15304167	.	A	G	4	10	14	0	0	14	0	0
10	15304331	.	C	A	19	11	30	0	0	30	0	0
10	15304782	.	A	G	17	16	33	1	1	35	0	0
10	15372708	.	G	T	15	10	25	0	0	25	0	0
10	15372726	.	G	A	17	13	30	0	0	30	0	0
10	15372889	.	G	A	18	12	30	0	2	32	0	0
10	15381782	.	C	G	4	3	7	0	2	9	0	0
10	15381784	.	A	C	4	5	9	0	0	9	0	0
10	15382352	.	A	G	19	11	30	0	2	32	0	0
10	15382546	.	A	G	14	25	39	0	0	39	0	0
10	15382669	.	G	A	20	14	34	0	0	34	0	0
10	15382681	.	A	T	22	14	36	0	1	37	0	0
10	15400027	.	G	A	19	18	37	0	4	42	1	0
10	15400692	.	T	G	17	18	35	0	2	37	0	0
10	15434330	.	T	C	1	2	3	0	1	4	0	0
10	15438451	.	G	A	1	3	4	0	0	4	0	0
10	15444583	.	C	T	1	3	4	0	0	4	0	0
10	15511974	.	C	T	1	2	3	0	0	3	0	0
10	15533107	.	T	C	1	4	5	0	0	5	0	0
10	15551496	.	G	A	1	3	4	0	1	5	0	0
10	15569027	.	G	A	0	4	4	0	3	7	0	0
10	15575364	.	C	T	3	2	5	0	1	6	0	0
10	15575627	.	T	C	2	5	7	0	0	7	0	0
10	15575633	.	C	T	2	5	7	0	0	7	0	0
10	15581078	.	G	A	4	2	6	0	0	6	0	0
10	15582371	.	C	G	4	3	7	0	0	7	0	0
10	15582744	.	A	C	9	4	13	0	2	15	0	0
10	15582746	.	A	T	9	4	13	0	2	15	0	0
10	15582799	.	C	T	9	7	16	0	2	18	0	0
10	15582906	.	C	T	11	11	22	0	0	22	0	0
10	15583060	.	C	T	5	7	12	0	0	12	0	0
10	15583105	.	C	T	6	7	13	0	0	13	0	0
10	15583153	.	G	C	8	4	12	0	0	12	0	0
10	15596503	.	A	C	9	4	13	0	0	13	0	0
10	15596752	.	C	T	2	8	10	0	1	11	0	0
10	15596767	.	C	G	6	7	13	0	1	14	0	0
10	15596958	.	G	C	7	6	13	0	0	13	0	0
10	15596995	.	C	T	6	8	14	0	0	14	0	0
10	15597103	.	T	A	4	5	9	0	1	10	0	0
10	15597662	.	G	C	4	7	11	0	0	11	0	0
10	15597822	.	G	A	5	5	10	0	1	11	0	0
10	15597834	.	A	T	5	3	8	0	1	9	0	0
10	15597927	.	T	A	1	4	5	0	0	5	0	0
10	15597942	.	T	C	1	3	4	0	0	4	0	0
10	15598303	.	A	T	3	6	9	0	1	10	0	0
10	15598358	.	T	G	5	12	17	0	2	19	0	0
10	15598412	.	T	C	15	7	22	0	0	22	0	0
10	15598598	.	T	G	4	4	8	0	1	9	0	0
10	15598681	.	G	A	1	9	10	0	12	22	0	0
10	15608373	.	T	C	8	10	18	0	0	18	0	0
10	15608756	.	T	C	12	20	32	0	1	33	0	0
10	15612238	.	C	T	14	17	31	0	2	33	0	0
10	15612602	.	G	A	16	13	29	2	5	36	0	0
10	15612675	.	T	A	25	13	38	0	3	41	0	0
10	15612705	.	C	T	23	20	43	0	1	44	0	0
10	15612758	.	G	A	21	16	37	0	2	39	0	0
10	15612859	.	G	T	1	19	20	1	11	32	0	0
10	15613076	.	G	A	0	6	6	0	9	15	0	0
10	15613174	.	A	C	9	7	16	0	0	16	0	0
10	15618411	.	A	G	3	7	10	0	1	11	0	0
10	15618606	.	A	G	2	7	9	0	0	9	0	0
10	15621499	.	A	G	6	3	9	0	0	9	0	0
10	15621529	.	C	T	0	4	4	0	8	12	0	0
10	15623124	.	T	C	5	4	9	0	1	10	0	0
10	15629349	.	C	T	2	4	6	0	0	6	0	0
10	15637494	.	T	C	2	2	4	0	0	4	0	0
10	15637563	.	T	C	4	3	7	0	0	7	0	0
10	15637753	.	T	G	1	3	4	0	0	4	0	0
10	15637860	.	G	A	2	5	7	0	0	7	0	0
10	15644841	.	A	C	1	3	4	0	0	4	0	0
10	15783637	.	A	G	13	0	13	1	13	27	0	0
10	15783721	.	A	G	10	11	21	0	0	21	0	0
10	15783777	.	G	A	5	14	19	0	0	19	0	0
10	15783934	.	T	C	8	7	15	0	0	15	0	0
10	15784613	.	G	A	0	10	10	0	8	18	0	0
10	15788562	.	A	T	14	14	28	0	0	28	0	0
10	15795197	.	A	G	11	1	12	0	15	27	0	0
10	15809215	.	C	T	10	12	22	0	2	24	0	0
10	15812950	.	A	G	15	0	15	0	18	33	0	0
10	15815984	.	A	T	1	4	5	0	0	5	0	0
10	15816029	.	T	A	2	3	5	0	0	5	0	0
10	15816852	.	C	G	0	4	4	0	8	12	0	0
10	15816879	.	G	A	7	4	11	0	1	12	0	0
10	15823021	.	C	T	8	6	14	0	3	17	0	0
10	15824645	.	A	G	6	5	11	0	1	12	0	0
10	15824648	.	A	G	7	5	12	0	0	12	0	0
10	15824684	.	C	A	1	4	5	0	5	10	0	0
10	15826604	.	T	G	2	4	6	0	0	6	0	0
10	15826749	.	G	A	1	5	6	0	0	6	0	0
10	15827390	.	A	G	2	3	5	0	0	5	0	0
10	15829290	.	C	A	4	2	6	0	0	6	0	0
10	15829362	.	A	G	1	3	4	0	0	4	0	0
10	15881431	.	T	C	3	3	6	0	0	6	0	0
10	15881732	.	G	T	5	2	7	0	1	8	0	0
10	15881819	.	T	G	11	8	19	0	0	19	0	0
10	15884833	.	G	A	10	9	19	0	3	23	1	0
10	15884872	.	T	C	16	0	16	0	11	27	0	0
10	15885056	.	C	G	10	9	19	0	0	19	0	0
10	15893297	.	A	T	1	4	5	0	0	5	0	0
10	15893347	.	G	A	2	5	7	0	0	7	0	0
10	15893372	.	G	T	3	7	10	0	0	10	0	0
10	15919753	.	T	A	5	7	12	0	0	12	0	0
10	15937655	.	G	C	6	2	8	0	0	8	0	0
10	15937799	.	C	T	1	4	5	0	0	5	0	0
10	15960967	.	T	A	8	4	12	0	1	13	0	0
10	15967713	.	T	A	6	2	8	0	1	9	0	0
10	15967715	.	G	A	6	3	9	0	0	9	0	0
10	15975308	.	G	A	1	7	8	0	8	16	0	0
10	15980805	.	A	T	11	4	15	0	0	15	0	0
10	15984366	.	C	T	2	4	6	0	0	6	0	0
10	15992664	.	G	A	10	4	14	0	0	14	0	0
10	15992712	.	T	A	11	7	18	0	0	18	0	0
10	15992731	.	A	T	7	7	14	0	2	16	0	0
10	15992968	.	A	C	13	15	28	0	0	28	0	0
10	15997600	.	A	G	7	1	8	0	8	16	0	0
10	15997729	.	C	T	10	8	18	0	1	19	0	0
10	15997804	.	G	A	1	5	6	0	7	13	0	0
10	16015332	.	G	A	11	13	24	0	0	24	0	0
10	16015509	.	C	A	0	9	9	0	8	17	0	0
10	16017676	.	A	T	11	16	27	0	0	27	0	0
10	16019482	.	G	A	10	9	19	0	0	19	0	0
10	16019881	.	A	G	6	8	14	0	1	15	0	0
10	16019902	.	C	T	8	5	13	0	0	13	0	0
10	16020028	.	T	C	3	7	10	0	0	10	0	0
10	16031378	.	T	C	6	6	12	0	2	14	0	0
10	16031555	.	C	T	6	12	18	0	0	18	0	0
10	16031648	.	C	G	9	7	16	0	1	17	0	0
10	16031690	.	A	G	12	7	19	0	0	19	0	0
10	16034782	.	A	G	6	5	11	0	0	11	0	0
10	16034796	.	C	T	9	5	14	0	0	14	0	0
10	16034887	.	G	A	3	4	7	0	1	8	0	0
10	16034901	.	A	C	4	5	9	0	1	10	0	0
10	16036615	.	T	C	5	4	9	0	0	9	0	0
10	16036728	.	T	A	3	3	6	0	0	6	0	0
10	16036818	.	C	T	4	4	8	0	0	8	0	0
10	16043700	.	A	G	9	0	9	0	8	17	0	0
10	16049522	.	T	C	9	7	16	0	0	16	0	0
10	16052536	.	T	C	10	10	20	0	1	21	0	0
10	16055878	.	C	T	10	6	16	0	0	16	0	0
10	16055906	.	C	T	9	8	17	0	0	17	0	0
10	16056137	.	T	A	1	2	3	0	0	3	0	0
10	16056145	.	A	G	2	2	4	0	0	4	0	0
10	16056181	.	T	A	6	4	10	0	1	11	0	0
10	16056511	.	T	C	12	10	22	0	0	22	0	0
10	16056739	.	A	G	7	5	12	0	0	12	0	0
10	16065144	.	C	A	3	3	6	0	0	6	0	0
10	16173552	.	G	A	3	4	7	0	1	8	0	0
10	16176685	.	G	A	1	3	4	0	0	4	0	0
10	16176720	.	C	T	4	6	10	0	0	10	0	0
10	16176906	.	G	A	6	8	14	0	0	14	0	0
10	16176915	.	G	A	6	8	14	0	0	14	0	0
10	16181904	.	T	C	3	5	8	0	0	8	0	0
10	16185500	.	T	C	9	11	20	0	0	20	0	0
10	16185611	.	A	G	8	0	8	0	12	20	0	0
10	16185685	.	A	G	9	9	18	0	0	18	0	0
10	16185915	.	T	G	6	4	10	0	0	10	0	0
10	16185927	.	C	G	7	4	11	0	1	12	0	0
10	16185984	.	T	G	7	9	16	0	0	16	0	0
10	16186158	.	T	C	8	3	11	0	0	11	0	0
10	16186405	.	T	A	8	5	13	0	1	14	0	0
10	16192385	.	G	A	6	8	14	0	3	17	0	0
10	16225603	.	A	T	5	0	5	0	0	5	0	0
10	16225872	.	C	T	3	2	5	0	0	5	0	0
10	16226250	.	A	C	3	5	8	0	1	9	0	0
10	16273683	.	C	T	4	3	7	0	1	8	0	0
10	16303060	.	A	T	12	12	24	0	0	24	0	0
10	16307128	.	A	G	2	0	2	0	3	5	0	0
10	16307651	.	T	A	9	14	23	0	0	23	0	0
10	16307679	.	T	A	8	11	19	0	1	20	0	0
10	16307952	.	A	G	8	10	18	0	0	19	1	0
10	16307979	.	A	T	4	9	13	0	1	14	0	0
10	16308206	.	T	C	6	3	9	0	1	10	0	0
10	16308272	.	A	G	10	6	16	0	0	16	0	0
10	16308643	.	G	A	0	12	12	0	8	20	0	0
10	16308648	.	G	T	1	12	13	0	7	20	0	0
10	16308923	.	G	A	1	13	14	0	15	29	0	0
10	16309001	.	T	A	17	9	26	2	1	29	0	0
10	16309017	.	G	A	13	5	18	3	3	24	0	0
10	16309167	.	T	C	13	11	24	0	2	26	0	0
10	16309364	.	A	G	5	3	8	0	1	9	0	0
10	16309498	.	C	T	8	6	14	0	7	21	0	0
10	16476742	.	A	T	4	5	9	0	0	9	0	0
10	16477049	.	T	C	1	0	1	0	3	4	0	0
10	16477202	.	A	G	2	4	6	0	1	7	0	0
10	16477230	.	T	C	1	3	4	0	0	4	0	0
10	16477575	.	T	C	3	2	5	0	0	5	0	0
10	16480353	.	G	A	1	2	3	0	0	3	0	0
10	16563035	.	A	C	3	4	7	0	1	8	0	0
10	16746334	.	A	G	3	2	5	0	0	5	0	0
10	16746706	.	C	A	2	4	6	0	0	6	0	0
10	16746790	.	C	T	6	4	10	0	0	10	0	0
10	16747280	.	T	C	1	6	7	0	0	7	0	0
10	16747281	.	A	C	1	6	7	0	0	7	0	0
10	16747465	.	A	C	3	6	9	0	1	10	0	0
10	16867505	.	G	T	4	3	7	0	0	7	0	0
10	17102971	.	C	T	30	28	58	0	3	61	0	0
10	17132501	.	C	T	10	40	50	0	2	52	0	0
10	17166889	.	C	T	1	18	19	0	21	40	0	0
10	17166955	.	A	G	18	16	34	0	0	34	0	0
10	17166982	.	A	G	17	22	39	0	0	39	0	0
10	17167637	.	A	G	34	24	58	0	0	58	0	0
10	17167733	.	T	C	34	31	65	0	0	65	0	0
10	17167757	.	G	A	25	32	57	0	6	63	0	0
10	17168039	.	C	T	27	23	50	0	4	54	0	0
10	17168096	.	A	G	31	28	59	0	1	60	0	0
10	17169948	.	C	G	20	27	47	0	0	47	0	0
10	17174687	.	C	T	3	4	7	0	0	7	0	0
10	17179400	.	G	A	4	2	6	0	0	6	0	0
10	17179557	.	C	T	5	5	10	0	0	10	0	0
10	17183147	.	T	A	4	3	7	0	1	8	0	0
10	17205669	.	G	A	3	3	6	0	0	6	0	0
10	17282810	.	C	G	2	9	11	0	2	13	0	0
10	17282903	.	G	A	6	5	11	0	0	11	0	0
10	17283170	.	A	G	5	7	12	0	1	13	0	0
10	17283386	.	A	G	9	9	18	0	2	20	0	0
10	17283720	.	T	A	11	7	18	0	1	19	0	0
10	17283905	.	A	G	6	3	9	0	0	9	0	0
10	17283955	.	G	A	4	5	9	0	0	9	0	0
10	17372187	.	G	A	0	6	6	0	6	12	0	0
10	17552889	.	A	T	5	7	12	0	0	12	0	0
10	17552976	.	T	C	4	3	7	0	0	7	0	0
10	17552994	.	T	C	6	3	9	0	0	9	0	0
10	17553184	.	T	C	2	4	6	0	0	6	0	0
10	17553271	.	G	A	12	8	20	0	0	20	0	0
10	17560030	.	G	A	7	5	12	0	0	12	0	0
10	17562978	.	G	C	6	6	12	0	1	13	0	0
10	17563180	.	A	G	8	5	13	0	0	13	0	0
10	17563279	.	C	T	9	5	14	0	1	15	0	0
10	17568855	.	T	C	6	3	9	0	0	9	0	0
10	17568878	.	C	T	6	4	10	0	0	10	0	0
10	17572784	.	C	A	3	3	6	0	0	6	0	0
10	17572866	.	C	A	1	3	4	0	4	8	0	0
10	17577348	.	T	C	2	3	5	0	0	5	0	0
10	17579465	.	C	T	0	2	2	0	6	8	0	0
10	17579715	.	A	C	2	8	10	0	0	10	0	0
10	17579948	.	T	A	5	4	9	0	0	9	0	0
10	17583426	.	T	C	3	1	4	0	4	8	0	0
10	17587553	.	G	A	2	4	6	0	0	6	0	0
10	17587628	.	A	T	3	3	6	0	0	6	0	0
10	17587742	.	G	A	2	5	7	0	0	7	0	0
10	17587789	.	G	A	1	7	8	0	0	8	0	0
10	17587795	.	T	C	1	0	1	0	7	8	0	0
10	17638977	.	T	C	1	2	3	0	0	3	0	0
10	17681174	.	A	T	4	7	11	0	0	11	0	0
10	17681183	.	T	A	6	9	15	0	0	16	1	0
10	17681252	.	G	A	8	4	12	0	0	12	0	0
10	17684736	.	C	T	8	9	17	0	1	18	0	0
10	17684739	.	C	T	8	9	17	0	1	18	0	0
10	17686174	.	T	C	7	14	21	0	2	23	0	0
10	17686216	.	T	C	9	16	25	0	2	27	0	0
10	17690998	.	C	T	3	7	10	0	1	11	0	0
10	17691127	.	T	G	6	6	12	0	0	12	0	0
10	17700237	.	T	C	7	1	8	0	3	11	0	0
10	17700365	.	A	T	5	7	12	0	2	14	0	0
10	17700458	.	T	C	9	13	22	0	0	22	0	0
10	17700484	.	A	T	9	13	22	0	0	22	0	0
10	17700753	.	C	A	5	5	10	0	0	10	0	0
10	17700775	.	G	A	3	3	6	0	0	6	0	0
10	17701002	.	C	G	10	6	16	0	1	17	0	0
10	17701003	.	C	A	2	6	8	0	9	17	0	0
10	17701222	.	C	T	1	5	6	0	13	19	0	0
10	17851033	.	T	G	6	6	12	0	0	12	0	0
10	17876862	.	A	G	8	0	8	0	7	15	0	0
10	17890850	.	G	A	22	12	34	1	0	35	0	0
10	17911220	.	C	T	10	9	19	0	0	19	0	0
10	17913424	.	A	C	5	10	15	0	2	17	0	0
10	17922444	.	A	G	15	21	36	1	1	38	0	0
10	17922540	.	A	T	18	22	40	0	5	45	0	0
10	17922582	.	C	T	18	21	39	0	1	40	0	0
10	17922651	.	G	C	17	15	32	0	0	32	0	0
10	17922718	.	C	T	13	13	26	0	0	26	0	0
10	17922807	.	A	G	8	0	8	0	13	21	0	0
10	17922894	.	T	G	13	15	28	0	0	28	0	0
10	17922955	.	A	T	8	8	16	0	0	16	0	0
10	17922973	.	T	C	12	7	19	0	0	19	0	0
10	17923490	.	A	T	10	16	26	0	1	27	0	0
10	17924398	.	A	C	5	9	14	0	3	17	0	0
10	17924420	.	T	C	3	9	12	0	2	14	0	0
10	17924585	.	A	G	1	18	19	0	1	20	0	0
10	17924606	.	A	G	15	7	22	0	0	22	0	0
10	17924740	.	T	G	16	10	26	0	2	28	0	0
10	17924779	.	G	A	16	6	22	0	0	22	0	0
10	17924836	.	T	A	11	13	24	0	2	26	0	0
10	17925146	.	T	C	17	25	42	0	1	43	0	0
10	17925301	.	T	A	8	11	19	0	0	19	0	0
10	17925302	.	G	T	8	11	19	0	0	19	0	0
10	17940303	.	G	A	4	12	16	0	34	50	0	0
10	17940352	.	G	A	30	32	62	0	0	62	0	0
10	17940356	.	A	G	30	28	58	0	3	61	0	0
10	17943696	.	G	A	28	28	56	0	1	57	0	0
10	17943714	.	T	C	30	32	62	0	1	63	0	0
10	17944017	.	C	T	27	20	47	0	0	47	0	0
10	17945447	.	A	G	19	20	39	0	7	46	0	0
10	17945513	.	A	G	26	10	36	4	1	41	0	0
10	17945522	.	C	T	18	15	33	4	2	39	0	0
10	17945581	.	G	T	20	21	41	0	6	47	0	0
10	17945629	.	T	C	35	19	54	0	1	55	0	0
10	17945725	.	A	G	32	21	53	0	0	53	0	0
10	17945738	.	T	A	34	16	50	0	0	50	0	0
10	17945779	.	T	A	25	8	33	0	0	33	0	0
10	17946030	.	A	T	8	4	12	0	0	12	0	0
10	18292010	.	C	A	0	3	3	0	1	4	0	0
10	18887816	.	C	T	7	5	12	0	2	14	0	0
10	18896228	.	A	C	6	15	21	0	0	22	1	0
10	18924407	.	C	G	8	10	18	0	1	19	0	0
10	18927910	.	C	T	10	9	19	0	2	21	0	0
10	18930403	.	T	C	7	13	20	0	0	20	0	0
10	18934119	.	A	T	6	7	13	0	2	15	0	0
10	18934291	.	T	C	11	12	23	0	1	24	0	0
10	18934393	.	T	G	9	0	9	0	5	14	0	0
10	18934409	.	T	A	10	3	13	0	1	14	0	0
10	18934590	.	A	C	5	15	20	0	2	22	0	0
10	18934683	.	T	C	9	19	28	0	0	28	0	0
10	18934963	.	G	A	0	3	3	0	9	12	0	0
10	18935271	.	C	T	16	16	32	0	0	32	0	0
10	18935874	.	T	A	4	5	9	0	0	9	0	0
10	18973124	.	A	G	6	0	6	0	4	10	0	0
10	18983512	.	C	A	14	15	29	0	1	30	0	0
10	18989018	.	C	G	14	16	30	0	1	31	0	0
10	18989047	.	T	C	15	14	29	0	1	30	0	0
10	19020475	.	A	G	10	8	18	0	1	19	0	0
10	19020879	.	G	A	2	2	4	0	2	6	0	0
10	19021032	.	C	A	6	5	11	0	3	14	0	0
10	19021102	.	C	G	17	14	31	0	1	32	0	0
10	19021192	.	A	G	4	9	13	0	0	13	0	0
10	19021243	.	G	A	4	2	6	0	1	7	0	0
10	19338827	.	C	T	2	3	5	0	0	5	0	0
10	19338839	.	T	C	2	2	4	0	0	4	0	0
10	19338938	.	T	G	2	3	5	0	0	5	0	0
10	19339364	.	G	A	0	3	3	0	2	5	0	0
10	19339367	.	T	C	2	3	5	0	0	5	0	0
10	19339538	.	G	C	0	8	8	0	9	17	0	0
10	19339647	.	C	T	7	5	12	0	2	14	0	0
10	19339859	.	C	G	6	5	11	0	0	11	0	0
10	19428509	.	T	C	2	3	5	0	0	5	0	0
10	19428743	.	T	A	6	2	8	0	1	9	0	0
10	19428830	.	A	C	1	4	5	0	0	5	0	0
10	19428835	.	C	A	0	4	4	0	1	5	0	0
10	19428894	.	A	T	6	3	9	0	0	9	0	0
10	19429634	.	A	T	2	3	5	0	0	5	0	0
10	19429759	.	A	G	2	2	4	0	0	4	0	0
10	19431643	.	T	A	1	2	3	0	0	3	0	0
10	19554673	.	A	T	12	11	23	0	0	23	0	0
10	19558489	.	C	A	18	21	39	0	1	40	0	0
10	19558558	.	T	A	9	21	30	0	1	31	0	0
10	19559235	.	A	G	10	11	21	0	2	23	0	0
10	19562006	.	T	G	28	19	47	0	1	48	0	0
10	19562015	.	A	T	31	17	48	0	3	51	0	0
10	19562945	.	C	T	23	31	54	0	2	56	0	0
10	19565704	.	A	T	20	24	44	3	3	50	0	0
10	19565771	.	T	C	30	24	54	0	2	56	0	0
10	19565782	.	A	C	28	24	52	0	0	52	0	0
10	19566400	.	T	A	14	15	29	0	0	29	0	0
10	19566445	.	T	C	8	6	14	0	1	15	0	0
10	19801808	.	A	G	4	2	6	0	0	6	0	0
10	20083200	.	C	T	4	2	6	0	0	6	0	0
10	20087260	.	A	G	1	5	6	0	0	6	0	0
10	20087263	.	C	T	1	5	6	0	0	6	0	0
10	20087388	.	T	C	1	4	5	0	0	5	0	0
10	20093368	.	C	T	6	8	14	0	0	14	0	0
10	20093914	.	C	T	9	10	19	0	1	20	0	0
10	20093959	.	A	G	8	8	16	0	0	16	0	0
10	20103168	.	G	A	2	2	4	0	0	4	0	0
10	20103198	.	T	A	2	3	5	0	0	5	0	0
10	20103429	.	A	T	6	8	14	0	2	16	0	0
10	20103448	.	A	G	6	6	12	0	1	13	0	0
10	20103601	.	G	T	6	6	12	0	0	12	0	0
10	20103639	.	A	G	6	5	11	0	0	11	0	0
10	20103662	.	C	T	4	4	8	0	0	8	0	0
10	20103731	.	C	T	8	7	15	0	0	15	0	0
10	20105347	.	A	G	12	20	32	0	3	35	0	0
10	20108575	.	T	A	13	17	30	0	1	31	0	0
10	20136107	.	T	C	16	16	32	0	0	32	0	0
10	20137862	.	A	G	9	12	21	0	0	21	0	0
10	20140930	.	T	A	2	2	4	0	0	4	0	0
10	20140951	.	T	C	1	2	3	0	0	3	0	0
10	20143850	.	T	A	3	8	11	0	1	12	0	0
10	20147452	.	A	G	8	0	8	0	11	19	0	0
10	20159197	.	C	T	5	2	7	0	0	7	0	0
10	20159531	.	G	A	1	2	3	0	0	3	0	0
10	20218342	.	C	G	11	11	22	0	1	23	0	0
10	20221281	.	C	T	14	12	26	1	0	27	0	0
10	20256640	.	C	G	2	2	4	0	0	4	0	0
10	20287188	.	A	G	4	2	6	0	1	7	0	0
10	20339024	.	C	T	5	3	8	0	1	9	0	0
10	20351756	.	C	T	0	2	2	0	3	5	0	0
10	20351785	.	C	G	2	3	5	0	0	5	0	0
10	20351824	.	C	T	4	3	7	0	0	7	0	0
10	20351846	.	T	A	4	2	6	0	0	6	0	0
10	20351978	.	A	G	2	2	4	0	0	4	0	0
10	20356812	.	G	A	2	3	5	0	0	5	0	0
10	20356822	.	G	T	2	2	4	0	0	4	0	0
10	20364395	.	T	G	3	2	5	0	0	5	0	0
10	20368883	.	C	T	11	12	23	0	2	25	0	0
10	20371675	.	A	T	15	16	31	0	3	34	0	0
10	20371715	.	T	C	16	6	22	0	0	22	0	0
10	20371723	.	A	C	12	7	19	0	0	19	0	0
10	20371827	.	C	T	14	14	28	0	0	28	0	0
10	20393164	.	C	T	2	3	5	0	0	5	0	0
10	20395629	.	T	C	3	6	9	0	0	9	0	0
10	20401813	.	A	G	4	2	6	0	0	6	0	0
10	20401984	.	G	T	2	3	5	0	0	5	0	0
10	20419728	.	G	T	0	2	2	0	1	3	0	0
10	20462884	.	G	A	20	12	32	0	0	32	0	0
10	20463890	.	G	A	12	16	28	0	2	30	0	0
10	20464238	.	A	G	13	15	28	0	1	29	0	0
10	20464245	.	A	G	12	15	27	0	0	27	0	0
10	20468868	.	T	C	11	0	11	0	9	20	0	0
10	20468952	.	G	A	10	9	19	0	0	19	0	0
10	20472600	.	G	T	7	5	12	0	0	12	0	0
10	20473517	.	G	T	6	5	11	0	1	12	0	0
10	20481740	.	T	C	3	6	9	0	1	10	0	0
10	20505261	.	G	A	3	2	5	0	0	5	0	0
10	20519543	.	T	C	6	5	11	0	0	11	0	0
10	20519549	.	T	C	6	0	6	0	4	10	0	0
10	20521939	.	C	T	2	2	4	0	1	5	0	0
10	20527438	.	T	A	1	2	3	0	0	3	0	0
10	20527571	.	C	T	4	3	7	0	0	7	0	0
10	20527639	.	G	A	8	6	14	0	0	14	0	0
10	20527653	.	C	T	9	6	15	0	1	16	0	0
10	20529384	.	G	A	15	11	26	0	2	28	0	0
10	20529389	.	G	T	13	12	25	0	2	27	0	0
10	20529450	.	T	C	11	0	11	0	8	19	0	0
10	20543294	.	T	C	3	0	3	0	6	9	0	0
10	20543336	.	G	A	8	7	15	0	1	16	0	0
10	20546548	.	C	T	5	5	10	0	0	10	0	0
10	20563086	.	T	C	4	5	9	0	1	10	0	0
10	20565260	.	C	T	0	4	4	0	5	9	0	0
10	20583799	.	C	T	3	5	8	0	0	8	0	0
10	20586463	.	A	T	1	4	5	0	0	5	0	0
10	20596178	.	C	G	11	11	22	0	1	23	0	0
10	20598345	.	C	G	9	6	15	11	0	26	0	0
10	20604555	.	T	C	22	14	36	0	0	36	0	0
10	20605150	.	C	T	11	13	24	0	1	25	0	0
10	20636027	.	C	T	7	10	17	0	1	18	0	0
10	20636072	.	A	C	8	11	19	0	1	20	0	0
10	20636082	.	C	T	11	11	22	0	1	23	0	0
10	20636168	.	A	T	12	8	20	0	1	21	0	0
10	20636177	.	G	T	10	8	18	0	0	18	0	0
10	20636211	.	G	A	10	7	17	0	2	19	0	0
10	20636262	.	T	A	14	8	22	0	1	23	0	0
10	20636273	.	T	C	13	0	13	0	9	22	0	0
10	20636346	.	T	C	9	7	16	2	1	19	0	0
10	20636479	.	T	C	4	4	8	0	0	8	0	0
10	20636480	.	T	C	1	7	8	0	0	8	0	0
10	20637069	.	C	T	14	17	31	0	1	32	0	0
10	20643576	.	A	G	1	3	4	0	0	4	0	0
10	20643844	.	T	A	3	2	5	0	0	5	0	0
10	20660387	.	G	A	4	9	13	0	2	15	0	0
10	20661288	.	A	G	8	7	15	0	0	15	0	0
10	20696449	.	A	G	4	3	7	0	0	7	0	0
10	20920664	.	A	G	10	9	19	0	0	19	0	0
10	20971685	.	A	G	11	18	29	0	1	30	0	0
10	21043461	.	G	A	16	10	26	0	1	27	0	0
10	21043902	.	G	A	6	3	9	0	0	9	0	0
10	21043934	.	A	G	4	3	7	0	0	7	0	0
10	21043944	.	A	G	7	3	10	0	1	11	0	0
10	21044037	.	G	A	3	5	8	0	0	8	0	0
10	21044094	.	T	A	2	9	11	0	0	11	0	0
10	21044136	.	G	A	3	9	12	0	1	13	0	0
10	21044193	.	A	G	6	5	11	0	0	11	0	0
10	21044235	.	A	C	5	4	9	0	1	10	0	0
10	21044316	.	A	G	4	3	7	0	1	8	0	0
10	21044964	.	T	A	6	5	11	0	0	11	0	0
10	21436810	.	T	C	6	7	13	0	0	13	0	0
10	21437255	.	A	G	8	0	8	0	13	21	0	0
10	21440173	.	T	C	8	10	18	0	1	19	0	0
10	21440486	.	T	A	9	10	19	0	1	20	0	0
10	21440786	.	A	G	14	7	21	0	0	21	0	0
10	21441305	.	C	T	8	14	22	0	3	25	0	0
10	21442229	.	T	C	12	18	30	0	2	32	0	0
10	21442994	.	T	A	24	24	48	0	0	48	0	0
10	21443476	.	T	C	17	20	37	0	1	38	0	0
10	21451996	.	C	T	11	11	22	0	0	22	0	0
10	21452340	.	T	C	8	12	20	0	0	20	0	0
10	21456498	.	T	C	9	12	21	0	0	21	0	0
10	21459403	.	G	A	2	17	19	0	11	30	0	0
10	21459439	.	G	A	11	18	29	0	0	29	0	0
10	21462585	.	A	G	15	10	25	0	3	28	0	0
10	21469977	.	G	A	3	25	28	0	16	44	0	0
10	21469997	.	A	C	15	28	43	0	0	43	0	0
10	21514191	.	T	C	1	4	5	0	0	5	0	0
10	21523014	.	C	T	1	6	7	0	0	7	0	0
10	21523578	.	C	A	3	2	5	0	0	5	0	0
10	21523624	.	A	C	4	2	6	0	0	6	0	0
10	21523639	.	C	T	4	2	6	0	0	6	0	0
10	21523720	.	T	C	1	4	5	0	0	5	0	0
10	21523827	.	A	G	2	2	4	0	1	5	0	0
10	21524121	.	A	T	6	3	9	0	0	9	0	0
10	21524244	.	C	A	4	5	9	0	1	10	0	0
10	21524319	.	G	T	6	4	10	0	0	10	0	0
10	21524337	.	C	T	7	5	12	0	0	12	0	0
10	21524472	.	C	T	10	6	16	0	1	17	0	0
10	21524682	.	G	A	12	10	22	0	0	22	0	0
10	21524805	.	T	C	4	6	10	0	1	11	0	0
10	21524811	.	A	C	4	6	10	0	0	10	0	0
10	21622317	.	G	A	40	20	60	6	3	69	0	0
10	21645994	.	G	A	24	28	52	0	4	56	0	0
10	21646033	.	C	T	21	26	47	0	0	47	0	0
10	21646216	.	T	C	28	10	38	0	1	39	0	0
10	21646225	.	G	A	31	14	45	0	0	45	0	0
10	21646400	.	C	G	38	23	61	0	2	63	0	0
10	21646844	.	A	G	25	24	49	0	1	50	0	0
10	21646848	.	A	G	23	23	46	0	2	48	0	0
10	21646908	.	C	A	20	26	46	0	1	47	0	0
10	21647008	.	A	C	27	19	46	0	0	46	0	0
10	21647200	.	C	T	33	22	55	0	4	59	0	0
10	21647241	.	T	G	28	22	50	0	0	51	1	0
10	21647291	.	G	A	2	31	33	0	23	56	0	0
10	21647539	.	T	C	39	30	69	0	5	74	0	0
10	21647582	.	C	A	34	38	72	0	2	74	0	0
10	21647614	.	A	C	27	35	62	0	1	63	0	0
10	21647898	.	C	T	31	30	61	0	3	64	0	0
10	21702544	.	T	C	3	2	5	0	0	5	0	0
10	21703056	.	C	A	3	2	5	0	0	5	0	0
10	21720833	.	A	G	2	5	7	0	1	8	0	0
10	21720867	.	G	A	0	6	6	0	4	11	1	0
10	21723742	.	G	A	1	3	4	0	0	4	0	0
10	21724901	.	T	C	5	4	9	0	0	9	0	0
10	21738068	.	C	T	1	3	4	0	0	4	0	0
10	21776952	.	T	C	4	2	6	0	0	6	0	0
10	21777141	.	T	G	2	2	4	0	0	4	0	0
10	21777623	.	C	A	5	2	7	0	0	7	0	0
10	21778089	.	C	A	4	3	7	0	0	7	0	0
10	21778098	.	C	G	4	2	6	0	1	7	0	0
10	21778575	.	T	C	2	2	4	0	0	4	0	0
10	21778578	.	G	A	1	2	3	0	0	3	0	0
10	21778980	.	C	T	5	3	8	6	0	14	0	0
10	21778997	.	T	C	3	4	7	2	0	9	0	0
10	21779022	.	A	C	3	5	8	0	0	8	0	0
10	21779067	.	C	T	1	3	4	0	0	4	0	0
10	21779073	.	T	A	1	3	4	0	0	4	0	0
10	21779145	.	A	G	7	3	10	0	0	10	0	0
10	21779151	.	T	C	7	3	10	0	1	11	0	0
10	21780258	.	T	C	6	13	19	0	0	19	0	0
10	21780288	.	G	T	4	10	14	0	0	14	0	0
10	21780405	.	C	G	10	4	14	6	0	20	0	0
10	21780571	.	A	G	8	3	11	0	0	11	0	0
10	21780579	.	C	T	11	3	14	0	0	14	0	0
10	21781185	.	C	A	14	11	25	0	0	25	0	0
10	21781308	.	A	G	12	0	12	6	7	25	0	0
10	21781313	.	C	T	10	7	17	8	1	26	0	0
10	21781722	.	G	T	10	6	16	1	1	23	5	0
10	21783523	.	A	G	10	3	13	0	0	13	0	0
10	21783525	.	A	G	10	6	16	5	0	21	0	0
10	21783560	.	C	A	12	10	22	3	0	25	0	0
10	21783733	.	T	C	15	2	17	0	0	17	0	0
10	21784186	.	A	G	14	4	18	0	1	19	0	0
10	21790076	.	A	C	7	4	11	0	0	11	0	0
10	21790648	.	T	C	5	4	9	0	0	9	0	0
10	21790769	.	A	G	8	0	8	0	6	14	0	0
10	21790775	.	A	C	7	4	11	0	1	12	0	0
10	21790934	.	T	C	9	6	15	0	0	15	0	0
10	21791090	.	G	A	6	5	11	0	2	13	0	0
10	21791690	.	G	A	1	6	7	15	9	31	0	0
10	21791699	.	T	C	11	7	18	14	0	32	0	0
10	21791745	.	G	A	9	9	18	2	0	20	0	0
10	21791927	.	A	T	5	3	8	5	2	15	0	0
10	21792332	.	C	T	14	4	18	31	3	52	0	0
10	21797266	.	C	T	7	3	10	0	1	11	0	0
10	21797665	.	C	T	3	2	5	0	0	5	0	0
10	21797704	.	A	G	3	4	7	0	0	7	0	0
10	21797769	.	T	G	4	2	6	0	0	6	0	0
10	21798150	.	A	G	4	0	4	0	2	6	0	0
10	21798157	.	C	T	4	2	6	0	0	6	0	0
10	21798215	.	C	A	3	5	8	2	0	10	0	0
10	21798975	.	C	T	6	5	11	3	0	14	0	0
10	21798987	.	T	A	4	4	8	11	1	20	0	0
10	21799343	.	T	A	7	2	9	2	0	11	0	0
10	21799374	.	T	A	10	4	14	2	0	16	0	0
10	21799408	.	T	A	9	4	13	13	1	27	0	0
10	21801256	.	C	G	2	3	5	1	0	6	0	0
10	21801267	.	C	T	3	5	8	1	0	9	0	0
10	21801339	.	T	G	7	0	7	0	8	15	0	0
10	21801352	.	T	C	7	9	16	0	0	16	0	0
10	21801573	.	C	T	7	3	10	0	0	10	0	0
10	21801590	.	A	C	7	2	9	0	0	9	0	0
10	21801611	.	G	T	5	2	7	0	0	7	0	0
10	21801718	.	G	A	0	4	4	0	12	16	0	0
10	21802057	.	A	G	4	2	6	0	2	8	0	0
10	21802291	.	C	T	7	2	9	0	1	10	0	0
10	21802355	.	C	A	7	5	12	0	0	13	1	0
10	21802380	.	G	A	1	7	8	0	7	15	0	0
10	21802530	.	A	T	4	4	8	0	0	8	0	0
10	21802539	.	C	T	5	7	12	0	0	12	0	0
10	21802566	.	T	C	5	6	11	0	1	12	0	0
10	21802661	.	C	T	12	11	23	0	0	23	0	0
10	21802701	.	A	T	12	5	17	1	2	20	0	0
10	21802962	.	G	A	10	4	14	13	0	27	0	0
10	21803031	.	G	A	13	6	19	0	1	20	0	0
10	21804785	.	G	T	0	3	3	0	1	4	0	0
10	21804786	.	G	T	1	3	4	0	0	4	0	0
10	21805019	.	A	T	1	3	4	0	0	4	0	0
10	21805020	.	A	C	1	3	4	0	0	4	0	0
10	21805251	.	T	G	2	4	6	0	0	6	0	0
10	21805447	.	G	A	5	2	7	0	0	7	0	0
10	21805762	.	C	T	5	2	7	0	1	8	0	0
10	21805942	.	G	T	0	3	3	0	3	6	0	0
10	21806060	.	G	A	2	3	5	0	0	5	0	0
10	21806984	.	T	A	4	2	6	8	0	14	0	0
10	21818522	.	C	T	50	32	82	2	0	84	0	0
10	21818595	.	T	G	41	31	72	0	2	74	0	0
10	21818762	.	A	C	25	28	53	0	4	57	0	0
10	21818978	.	G	T	30	36	66	0	1	67	0	0
10	21819577	.	C	T	32	34	66	0	9	75	0	0
10	21819772	.	T	C	33	34	67	1	4	72	0	0
10	21872639	.	A	G	1	3	4	0	0	4	0	0
10	21943591	.	T	A	1	2	3	0	0	3	0	0
10	21943611	.	G	T	1	2	3	0	0	3	0	0
10	21944787	.	T	C	2	3	5	1	0	6	0	0
10	21944941	.	C	T	2	4	6	0	0	6	0	0
10	22003847	.	T	C	23	14	37	0	0	37	0	0
10	22003874	.	A	G	15	14	29	0	0	29	0	0
10	22030827	.	G	A	16	24	40	0	4	44	0	0
10	22030881	.	A	T	21	27	48	0	4	52	0	0
10	22030887	.	T	G	19	31	50	0	2	52	0	0
10	22030985	.	T	C	24	23	47	0	0	47	0	0
10	22030986	.	C	T	23	22	45	0	1	46	0	0
10	22031034	.	C	T	19	24	43	0	1	44	0	0
10	22031493	.	G	A	28	18	46	0	1	47	0	0
10	22031572	.	A	G	28	21	49	0	1	50	0	0
10	22031635	.	A	G	16	24	40	0	3	43	0	0
10	22031666	.	A	G	22	23	45	0	2	47	0	0
10	22031755	.	T	C	17	13	30	0	3	33	0	0
10	22031759	.	T	C	19	14	33	0	0	33	0	0
10	22031805	.	G	C	17	13	30	0	1	31	0	0
10	22031806	.	G	A	19	13	32	0	0	32	0	0
10	22036033	.	A	G	9	0	9	0	5	14	0	0
10	22041529	.	G	A	8	5	13	0	0	13	0	0
10	22041546	.	C	T	7	9	16	0	0	16	0	0
10	22044921	.	T	G	3	4	7	0	2	9	0	0
10	22051195	.	A	T	2	3	5	0	0	5	0	0
10	22051201	.	A	T	2	3	5	0	0	5	0	0
10	22051465	.	G	C	2	2	4	0	0	4	0	0
10	22051933	.	A	G	2	3	5	0	0	5	0	0
10	22052133	.	T	C	3	4	7	0	0	7	0	0
10	22052361	.	C	T	0	3	3	0	1	4	0	0
10	22134695	.	G	A	3	2	5	0	0	5	0	0
10	22137372	.	C	A	2	5	7	0	0	7	0	0
10	22137374	.	C	A	2	5	7	0	0	7	0	0
10	22162187	.	T	C	19	0	19	0	15	34	0	0
10	22162576	.	A	G	7	10	17	0	2	19	0	0
10	22162673	.	T	G	5	6	11	0	0	11	0	0
10	22163144	.	A	T	7	4	11	0	0	11	0	0
10	22163165	.	A	G	7	3	10	0	0	10	0	0
10	22163235	.	C	T	0	6	6	0	6	12	0	0
10	22163244	.	C	G	5	6	11	0	0	11	0	0
10	22163660	.	C	T	8	7	15	0	0	15	0	0
10	22163801	.	A	T	13	5	18	0	0	18	0	0
10	22163867	.	T	C	8	9	17	0	0	17	0	0
10	22163928	.	C	A	5	8	13	0	0	13	0	0
10	22164144	.	A	T	6	5	11	0	1	12	0	0
10	22164276	.	T	C	2	5	7	0	0	7	0	0
10	22164421	.	T	A	10	5	15	0	1	16	0	0
10	22164621	.	T	G	2	3	5	0	0	5	0	0
10	22164622	.	G	A	2	3	5	0	0	5	0	0
10	22164672	.	G	A	7	3	10	0	0	10	0	0
10	22164686	.	A	T	8	3	11	0	0	11	0	0
10	22164756	.	T	C	3	8	11	0	0	11	0	0
10	22165383	.	C	G	4	4	8	0	2	10	0	0
10	22165607	.	T	G	3	2	5	0	1	6	0	0
10	22165644	.	T	C	4	3	7	0	0	7	0	0
10	22165709	.	G	A	1	4	5	0	0	5	0	0
10	22165719	.	C	A	0	4	4	0	2	6	0	0
10	22165768	.	T	A	3	5	8	0	1	9	0	0
10	22165879	.	T	A	4	5	9	0	0	9	0	0
10	22165880	.	T	C	4	5	9	0	0	9	0	0
10	22165953	.	C	T	6	4	10	0	1	11	0	0
10	22166010	.	T	A	4	3	7	0	0	7	0	0
10	22166128	.	C	T	4	9	13	0	2	15	0	0
10	22166504	.	C	T	7	2	9	0	4	13	0	0
10	22205038	.	G	A	6	3	9	0	0	9	0	0
10	22381847	.	A	G	5	5	10	0	0	10	0	0
10	22381897	.	C	G	6	3	9	0	0	9	0	0
10	22381984	.	A	T	1	3	4	0	1	5	0	0
10	22475736	.	G	A	7	6	13	0	2	15	0	0
10	22475799	.	G	A	1	10	11	0	9	20	0	0
10	22476535	.	C	T	12	5	17	0	1	18	0	0
10	22477229	.	A	G	13	7	20	0	0	20	0	0
10	22477580	.	C	T	5	7	12	0	1	13	0	0
10	22477610	.	A	G	5	0	5	0	10	15	0	0
10	22477661	.	C	T	8	5	13	0	0	13	0	0
10	22510550	.	C	A	2	6	8	0	0	8	0	0
10	22516643	.	C	G	6	12	18	0	0	18	0	0
10	22516903	.	A	G	6	6	12	0	0	12	0	0
10	22516957	.	T	C	2	5	7	0	0	7	0	0
10	22518293	.	C	T	8	7	15	0	3	18	0	0
10	22518294	.	C	T	10	7	17	0	1	18	0	0
10	22519668	.	A	T	7	10	17	0	1	18	0	0
10	22519737	.	C	T	1	8	9	0	2	11	0	0
10	22519749	.	G	C	2	9	11	0	0	11	0	0
10	22519931	.	C	T	5	4	9	0	0	9	0	0
10	22530058	.	A	C	7	9	16	0	2	18	0	0
10	22530728	.	T	G	7	2	9	0	0	9	0	0
10	22531906	.	A	C	15	10	25	0	0	25	0	0
10	22531946	.	T	G	10	10	20	0	2	22	0	0
10	22532139	.	C	T	11	8	19	0	1	20	0	0
10	22532211	.	G	A	8	11	19	0	0	19	0	0
10	22532547	.	T	A	14	13	27	0	1	28	0	0
10	22532817	.	C	G	21	16	37	0	0	37	0	0
10	24326236	.	C	T	17	15	32	0	1	33	0	0
10	24334810	.	G	A	20	19	39	0	0	39	0	0
10	24335002	.	C	T	13	20	33	0	1	34	0	0
10	24335402	.	C	T	11	10	21	0	1	22	0	0
10	24373125	.	C	T	1	6	7	0	0	7	0	0
10	24373429	.	T	A	3	5	8	0	0	8	0	0
10	24373647	.	C	T	3	3	6	0	4	10	0	0
10	24373657	.	A	C	4	4	8	0	0	8	0	0
10	24373963	.	C	T	2	2	4	0	0	4	0	0
10	24422052	.	C	T	14	5	19	0	0	19	0	0
10	24422205	.	G	A	13	9	22	0	1	23	0	0
10	24422236	.	C	T	13	6	19	0	0	19	0	0
10	24422311	.	G	A	5	6	11	0	1	12	0	0
10	24424363	.	G	C	0	9	9	0	3	12	0	0
10	24425653	.	A	G	13	8	21	0	0	21	0	0
10	24426038	.	A	T	7	7	14	0	1	15	0	0
10	24429357	.	T	C	8	8	16	0	1	17	0	0
10	24431762	.	C	T	11	11	22	0	0	22	0	0
10	24435656	.	G	T	17	14	31	0	2	33	0	0
10	24435662	.	A	G	16	2	18	0	12	30	0	0
10	24442466	.	C	T	4	7	11	0	1	12	0	0
10	24442490	.	A	G	3	0	3	0	7	10	0	0
10	24563892	.	T	G	5	5	10	0	0	10	0	0
10	24564904	.	G	A	0	5	5	0	7	12	0	0
10	24564935	.	C	A	5	6	11	0	0	11	0	0
10	24565366	.	A	T	4	15	19	0	0	19	0	0
10	24565424	.	G	A	8	7	15	0	1	16	0	0
10	24565435	.	G	T	1	6	7	0	10	17	0	0
10	24565587	.	C	A	6	3	9	0	1	10	0	0
10	24566124	.	T	C	4	3	7	0	0	7	0	0
10	24573740	.	G	A	0	10	10	0	11	21	0	0
10	24600128	.	A	G	11	13	24	0	1	25	0	0
10	24605406	.	A	C	10	8	18	0	0	18	0	0
10	24609362	.	C	A	5	6	11	0	0	11	0	0
10	24614505	.	A	T	7	11	18	0	1	19	0	0
10	24614636	.	A	G	7	0	7	0	9	16	0	0
10	24621354	.	A	G	10	15	25	0	0	25	0	0
10	24621543	.	G	A	15	14	29	0	1	30	0	0
10	24621687	.	G	A	5	4	9	0	1	10	0	0
10	24621730	.	A	T	2	3	5	0	1	6	0	0
10	24621757	.	T	A	3	4	7	0	0	7	0	0
10	24622100	.	C	T	2	3	5	0	0	5	0	0
10	24640712	.	C	A	2	2	4	0	0	4	0	0
10	24649813	.	T	G	5	5	10	0	0	10	0	0
10	24650192	.	A	G	3	6	9	0	0	9	0	0
10	24650668	.	A	G	3	6	9	0	1	10	0	0
10	24650696	.	C	A	4	7	11	0	1	12	0	0
10	24650769	.	T	C	2	0	2	0	5	7	0	0
10	24650889	.	T	A	5	7	12	0	1	13	0	0
10	24654501	.	C	T	0	6	6	0	8	14	0	0
10	24654607	.	A	T	3	5	8	0	0	8	0	0
10	24654765	.	C	T	4	3	7	0	1	8	0	0
10	24655146	.	A	T	7	5	12	0	2	14	0	0
10	24655977	.	T	G	1	0	1	0	8	9	0	0
10	24655984	.	C	T	4	4	8	0	1	9	0	0
10	24656449	.	T	A	7	7	14	0	1	15	0	0
10	24659461	.	C	T	3	2	5	0	0	5	0	0
10	24659732	.	A	G	2	2	4	0	0	4	0	0
10	24660215	.	T	G	6	5	11	0	0	11	0	0
10	24660629	.	T	A	3	3	6	0	0	6	0	0
10	24666069	.	A	C	1	4	5	0	0	5	0	0
10	24668820	.	T	A	4	2	6	0	0	6	0	0
10	24677091	.	T	G	2	0	2	0	5	7	0	0
10	24677227	.	G	A	3	2	5	0	0	5	0	0
10	24677867	.	C	T	1	2	3	0	0	3	0	0
10	24677886	.	A	G	1	2	3	0	0	3	0	0
10	24686104	.	A	T	2	2	4	0	0	4	0	0
10	24686158	.	G	A	2	2	4	0	0	4	0	0
10	24688527	.	T	C	1	2	3	0	0	3	0	0
10	24697803	.	G	C	2	2	4	0	0	4	0	0
10	24710507	.	T	C	6	1	7	0	1	8	0	0
10	24710771	.	C	G	1	2	3	0	1	4	0	0
10	24710777	.	G	T	3	2	5	0	0	5	0	0
10	24710825	.	T	C	3	2	5	0	0	5	0	0
10	24710938	.	T	G	2	3	5	0	1	6	0	0
10	24710981	.	T	G	3	4	7	0	0	7	0	0
10	24725357	.	G	A	2	2	4	0	0	4	0	0
10	24725358	.	A	C	2	2	4	0	0	4	0	0
10	24725724	.	G	A	3	2	5	0	0	5	0	0
10	24726264	.	G	A	2	7	9	0	0	9	0	0
10	24726302	.	A	G	3	6	9	0	0	9	0	0
10	24726440	.	A	G	5	2	7	0	1	8	0	0
10	24726453	.	G	A	3	3	6	0	0	6	0	0
10	24726809	.	A	G	5	3	8	0	0	8	0	0
10	24762377	.	G	A	4	2	6	0	0	6	0	0
10	24762462	.	T	C	3	2	5	0	6	11	0	0
10	24762510	.	A	G	7	7	14	0	1	15	0	0
10	24762723	.	A	G	7	10	17	0	0	17	0	0
10	24765589	.	A	C	8	5	13	0	0	13	0	0
10	24765893	.	A	G	3	6	9	1	1	11	0	0
10	25068718	.	G	A	3	2	5	0	0	5	0	0
10	25109156	.	T	G	2	3	5	0	0	5	0	0
10	25109225	.	A	C	3	5	8	0	0	8	0	0
10	25205354	.	A	C	9	5	14	0	0	14	0	0
10	25212215	.	C	G	17	0	17	0	17	34	0	0
10	25219804	.	A	C	7	5	12	0	0	12	0	0
10	25219805	.	A	G	7	0	7	0	5	12	0	0
10	25252426	.	G	A	5	3	8	0	0	8	0	0
10	25252474	.	C	T	5	2	7	0	0	7	0	0
10	25252591	.	A	G	4	4	8	0	0	8	0	0
10	25261968	.	A	C	7	3	10	0	1	11	0	0
10	25262150	.	T	A	10	4	14	0	0	14	0	0
10	25262336	.	C	T	15	8	23	0	4	27	0	0
10	25267829	.	A	T	13	19	32	0	7	39	0	0
10	25267863	.	C	T	12	18	30	0	4	34	0	0
10	25267952	.	T	C	10	13	23	0	2	25	0	0
10	25268389	.	T	C	13	11	24	0	1	25	0	0
10	25268827	.	C	T	1	2	3	0	0	3	0	0
10	25269148	.	G	A	6	2	8	0	0	8	0	0
10	25269170	.	C	A	5	6	11	0	0	11	0	0
10	25269245	.	C	T	15	8	23	1	2	26	0	0
10	25269413	.	A	G	23	13	36	0	1	37	0	0
10	25269504	.	A	G	30	8	38	1	2	41	0	0
10	25269592	.	A	G	29	0	29	1	18	48	0	0
10	25269599	.	C	T	31	16	47	0	1	48	0	0
10	25269747	.	T	A	25	10	35	0	1	37	1	0
10	25270044	.	C	A	15	21	36	2	4	42	0	0
10	25270096	.	T	C	22	12	34	0	2	36	0	0
10	25270166	.	A	G	39	7	46	0	4	50	0	0
10	25270432	.	A	G	11	14	25	1	3	29	0	0
10	25270470	.	A	G	12	10	22	0	4	26	0	0
10	25270618	.	C	G	20	19	39	0	6	45	0	0
10	25270643	.	A	G	30	13	43	0	3	46	0	0
10	25270942	.	G	C	12	21	33	0	0	34	1	0
10	25270958	.	C	T	15	23	38	0	1	39	0	0
10	25271051	.	T	A	10	13	23	0	0	23	0	0
10	25271338	.	T	C	12	15	27	1	3	31	0	0
10	25312733	.	T	G	8	10	18	0	0	18	0	0
10	25312889	.	T	A	4	5	9	0	1	10	0	0
10	25313204	.	G	A	11	3	14	0	0	14	0	0
10	25317306	.	A	G	3	8	11	0	0	11	0	0
10	25321269	.	T	C	6	0	6	0	4	10	0	0
10	25325361	.	A	G	2	2	4	0	0	4	0	0
10	25329811	.	C	A	3	26	29	0	31	60	0	0
10	25333961	.	C	T	2	21	23	0	29	52	0	0
10	25334178	.	T	C	18	19	37	0	3	40	0	0
10	25342889	.	A	G	18	16	34	0	1	35	0	0
10	25381190	.	C	G	2	1	3	0	2	5	0	0
10	25382829	.	T	A	1	1	2	0	0	2	0	0
10	25383930	.	C	T	5	3	8	0	0	8	0	0
10	25383998	.	C	A	2	2	4	0	0	4	0	0
10	25403139	.	G	A	1	2	3	0	0	3	0	0
10	25403153	.	C	T	0	3	3	0	2	5	0	0
10	25403280	.	C	G	1	8	9	0	3	12	0	0
10	25410276	.	T	C	4	0	4	0	7	11	0	0
10	25410288	.	A	G	6	5	11	0	2	13	0	0
10	25426586	.	C	T	2	4	6	0	0	6	0	0
10	25435194	.	A	G	4	4	8	0	0	8	0	0
10	25435335	.	G	C	6	0	6	0	8	14	0	0
10	25436518	.	C	A	5	4	9	0	0	9	0	0
10	25462325	.	A	T	1	3	4	0	1	5	0	0
10	25573333	.	G	A	13	8	21	0	1	22	0	0
10	25573393	.	T	C	9	1	10	0	9	19	0	0
10	25573410	.	T	C	9	7	16	0	0	16	0	0
10	25573436	.	C	G	8	9	17	0	2	19	0	0
10	25574092	.	T	C	4	0	4	0	10	14	0	0
10	25574127	.	T	A	6	8	14	0	0	14	0	0
10	25574159	.	T	C	8	6	14	0	0	14	0	0
10	25574171	.	A	G	8	6	14	0	0	14	0	0
10	25581999	.	G	A	5	3	8	0	1	9	0	0
10	25582029	.	A	G	5	6	11	0	1	12	0	0
10	25582101	.	G	A	6	5	11	0	0	11	0	0
10	25582689	.	G	A	2	3	5	0	0	5	0	0
10	25582854	.	G	A	1	4	5	0	0	5	0	0
10	25582920	.	T	C	3	5	8	0	0	8	0	0
10	25585179	.	A	G	4	3	7	0	0	7	0	0
10	25601711	.	A	G	2	3	5	0	0	5	0	0
10	25601838	.	G	A	5	2	7	0	0	7	0	0
10	25694637	.	G	A	26	23	49	0	0	49	0	0
10	25694844	.	G	A	29	24	53	0	2	55	0	0
10	25694848	.	C	T	30	26	56	0	1	57	0	0
10	25700984	.	G	A	1	2	3	0	2	5	0	0
10	25701036	.	G	A	1	3	4	0	1	5	0	0
10	25701659	.	G	C	14	13	27	0	0	27	0	0
10	25701928	.	T	C	5	1	6	0	4	10	0	0
10	25704345	.	C	T	5	4	9	0	2	11	0	0
10	25706228	.	G	A	2	4	6	0	0	6	0	0
10	25709721	.	A	C	2	5	7	0	0	7	0	0
10	25709764	.	T	A	2	5	7	0	0	7	0	0
10	25712724	.	C	T	1	3	4	0	4	8	0	0
10	25712820	.	G	A	2	3	5	0	2	7	0	0
10	25831924	.	A	G	2	5	7	0	0	7	0	0
10	25834684	.	A	G	1	3	4	0	0	4	0	0
10	26114624	.	A	G	5	2	7	0	0	7	0	0
10	26225398	.	T	C	2	0	2	0	6	8	0	0
10	26225479	.	T	C	4	0	4	0	3	7	0	0
10	26269180	.	C	G	1	2	3	0	0	3	0	0
10	26269186	.	A	G	1	2	3	0	0	3	0	0
10	26269728	.	G	A	3	4	7	0	0	7	0	0
10	26269842	.	T	C	3	4	7	0	1	8	0	0
10	26270847	.	T	C	10	0	10	0	10	20	0	0
10	26271522	.	T	C	6	6	12	0	3	15	0	0
10	26271672	.	G	C	6	4	10	0	0	10	0	0
10	26271852	.	C	T	2	2	4	0	0	4	0	0
10	26271855	.	T	C	2	2	4	0	0	4	0	0
10	26272338	.	C	G	0	2	2	0	1	3	0	0
10	26272756	.	T	C	3	0	3	0	2	5	0	0
10	26272941	.	A	T	3	4	7	0	0	7	0	0
10	26276019	.	C	T	0	2	2	0	2	4	0	0
10	26282195	.	C	A	0	4	4	0	1	5	0	0
10	26282196	.	G	A	1	2	3	0	2	5	0	0
10	26285271	.	G	T	1	2	3	0	0	3	0	0
10	26285280	.	C	T	1	2	3	0	0	3	0	0
10	26508775	.	A	C	1	0	1	0	2	3	0	0
10	26512284	.	A	G	4	2	6	0	1	7	0	0
10	26517207	.	A	T	4	2	6	0	1	7	0	0
10	26517214	.	C	T	4	3	7	0	0	7	0	0
10	26540432	.	A	G	4	5	9	0	0	9	0	0
10	26541145	.	G	A	8	5	13	0	0	13	0	0
10	26551191	.	T	A	13	11	24	0	0	24	0	0
10	26551492	.	A	G	11	22	33	0	6	39	0	0
10	26558704	.	C	T	26	17	43	0	2	45	0	0
10	26560166	.	T	C	23	12	35	0	4	39	0	0
10	26560366	.	G	A	2	15	17	3	28	48	0	0
10	26560392	.	C	A	22	24	46	2	3	51	0	0
10	26565704	.	T	C	27	32	59	0	1	60	0	0
10	26565760	.	G	A	1	28	29	0	24	53	0	0
10	26566054	.	G	C	5	21	26	0	22	48	0	0
10	26566267	.	T	C	18	21	39	0	5	44	0	0
10	26566354	.	A	T	15	13	28	0	1	29	0	0
10	26566369	.	A	T	13	7	20	0	1	21	0	0
10	26566715	.	T	A	13	11	24	0	0	24	0	0
10	26566749	.	G	A	11	9	20	0	1	21	0	0
10	26566785	.	T	A	16	13	29	0	0	29	0	0
10	26566787	.	A	T	16	13	29	0	0	29	0	0
10	26566855	.	A	G	22	2	24	0	14	38	0	0
10	26566970	.	T	G	14	1	15	0	20	35	0	0
10	26567127	.	G	A	0	21	21	0	11	32	0	0
10	26567238	.	A	G	18	19	37	0	3	40	0	0
10	26567337	.	C	T	13	32	45	0	1	46	0	0
10	26567376	.	C	G	7	27	34	0	2	36	0	0
10	26567500	.	C	T	18	24	42	0	2	44	0	0
10	26567656	.	G	C	21	10	31	0	2	33	0	0
10	26567889	.	T	A	17	4	21	0	1	22	0	0
10	26567958	.	T	A	13	6	19	0	1	20	0	0
10	26568154	.	A	T	21	15	36	0	4	40	0	0
10	26568166	.	C	T	19	14	33	0	2	35	0	0
10	26568201	.	A	G	11	12	23	0	3	26	0	0
10	26568239	.	C	T	14	8	22	0	0	22	0	0
10	26568429	.	A	C	16	25	41	0	0	41	0	0
10	26568498	.	T	C	17	36	53	0	0	53	0	0
10	26568523	.	G	T	14	39	53	0	3	56	0	0
10	26568726	.	A	G	28	18	46	0	3	49	0	0
10	26569098	.	A	G	13	0	13	0	25	38	0	0
10	26569099	.	A	C	15	22	37	0	1	38	0	0
10	26569248	.	C	A	12	14	26	0	6	32	0	0
10	26583978	.	C	G	9	11	20	0	1	21	0	0
10	26589072	.	C	T	17	17	34	0	0	34	0	0
10	26596020	.	T	A	37	13	50	0	3	53	0	0
10	26596075	.	C	T	24	21	45	0	4	49	0	0
10	26596080	.	T	C	25	20	45	0	1	46	0	0
10	26596268	.	A	G	4	3	7	0	0	7	0	0
10	26656135	.	A	C	8	11	19	0	0	19	0	0
10	26656240	.	C	T	12	8	20	0	0	20	0	0
10	26656500	.	G	A	11	15	26	0	0	26	0	0
10	26656527	.	A	G	12	18	30	0	1	31	0	0
10	26659245	.	C	T	20	15	35	0	0	35	0	0
10	26661469	.	T	C	13	11	24	0	2	26	0	0
10	26662046	.	G	A	17	10	27	0	0	27	0	0
10	26666823	.	C	T	17	17	34	1	2	37	0	0
10	26666839	.	T	C	17	16	33	1	2	36	0	0
10	26692303	.	C	T	3	3	6	0	0	6	0	0
10	26692309	.	A	G	3	1	4	0	2	6	0	0
10	26717156	.	T	A	18	14	32	0	0	32	0	0
10	26717246	.	G	A	11	15	26	0	0	26	0	0
10	26717740	.	A	G	15	13	28	0	0	28	0	0
10	26717963	.	G	A	11	8	19	0	0	19	0	0
10	26729687	.	T	C	7	13	20	0	2	22	0	0
10	26744012	.	A	G	4	5	9	0	1	10	0	0
10	26762841	.	C	A	6	10	16	0	0	16	0	0
10	26765526	.	T	C	6	20	26	0	0	26	0	0
10	26766154	.	C	T	6	5	11	0	0	11	0	0
10	26774709	.	T	G	3	10	13	0	1	14	0	0
10	26774943	.	G	A	6	4	10	0	0	10	0	0
10	26777572	.	A	G	2	4	6	0	0	6	0	0
10	26777774	.	T	C	4	5	9	0	1	10	0	0
10	26780983	.	T	C	6	3	9	0	0	9	0	0
10	26781140	.	T	C	3	2	5	0	0	5	0	0
10	26781419	.	T	C	2	0	2	0	3	5	0	0
10	26783968	.	C	T	4	5	9	0	0	9	0	0
10	26788593	.	C	A	2	7	9	0	0	9	0	0
10	26790603	.	G	A	2	5	7	0	1	8	0	0
10	26791027	.	G	A	4	3	7	0	0	7	0	0
10	26831965	.	G	T	7	3	10	0	0	10	0	0
10	26832002	.	T	C	2	3	5	0	0	5	0	0
10	26832007	.	A	C	3	3	6	0	0	6	0	0
10	26835004	.	G	A	4	12	16	0	1	17	0	0
10	26835024	.	T	C	4	10	14	0	1	15	0	0
10	26835066	.	A	C	4	8	12	0	1	13	0	0
10	26835081	.	T	A	5	3	8	0	0	8	0	0
10	26835172	.	T	C	1	5	6	1	0	7	0	0
10	26835299	.	G	A	4	14	18	0	1	19	0	0
10	26835595	.	G	A	2	15	17	0	5	22	0	0
10	26836990	.	G	A	8	26	34	0	1	35	0	0
10	26922450	.	T	C	2	4	6	0	1	7	0	0
10	26924729	.	A	G	4	2	6	0	0	6	0	0
10	26925040	.	G	A	0	2	2	0	1	3	0	0
10	26929291	.	A	T	14	17	31	0	1	32	0	0
10	26929459	.	C	T	19	17	36	0	0	36	0	0
10	26930061	.	C	A	19	18	37	0	2	39	0	0
10	26932632	.	C	T	16	17	33	0	0	33	0	0
10	26933324	.	T	G	2	3	5	0	1	6	0	0
10	26933346	.	G	C	1	3	4	0	0	4	0	0
10	26958093	.	A	G	3	8	11	0	0	11	0	0
10	26958150	.	G	C	5	6	11	0	0	11	0	0
10	26958321	.	T	G	4	0	4	0	3	7	0	0
10	26958457	.	A	G	5	5	10	0	0	10	0	0
10	26958470	.	G	C	4	3	7	0	0	7	0	0
10	26958642	.	G	A	5	3	8	0	0	8	0	0
10	26959523	.	T	G	4	5	9	0	0	9	0	0
10	26959528	.	T	C	3	5	8	0	0	8	0	0
10	26959662	.	T	G	5	6	11	2	0	13	0	0
10	26959744	.	G	A	3	3	6	0	0	6	0	0
10	26959811	.	A	G	5	5	10	0	0	10	0	0
10	26959894	.	C	A	5	5	10	0	0	10	0	0
10	26960015	.	C	T	6	4	10	0	0	10	0	0
10	26960212	.	A	T	6	6	12	0	1	13	0	0
10	26960281	.	A	G	3	4	7	0	0	7	0	0
10	26960333	.	T	A	2	2	4	0	0	4	0	0
10	26960397	.	A	G	1	5	6	0	0	6	0	0
10	26963839	.	T	A	3	2	5	0	0	5	0	0
10	26965668	.	C	G	4	4	8	0	0	8	0	0
10	26966130	.	T	C	1	3	4	0	0	4	0	0
10	26966316	.	A	G	4	3	7	0	0	7	0	0
10	26971782	.	C	T	8	8	16	0	0	16	0	0
10	26972064	.	T	C	9	8	17	0	1	18	0	0
10	26972152	.	T	C	7	13	20	0	2	22	0	0
10	26972364	.	T	C	6	6	12	0	0	12	0	0
10	26972409	.	G	A	3	5	8	0	0	8	0	0
10	26972429	.	A	T	2	5	7	0	0	7	0	0
10	26974414	.	T	C	4	2	6	0	0	6	0	0
10	26976990	.	G	A	4	3	7	0	0	7	0	0
10	26978271	.	C	T	3	2	5	0	0	5	0	0
10	26983671	.	C	A	5	4	9	0	0	9	0	0
10	26987399	.	T	C	14	0	14	0	11	25	0	0
10	26989818	.	A	T	14	10	24	0	1	26	1	0
10	26989843	.	A	T	11	6	17	0	0	17	0	0
10	26990173	.	C	T	12	4	16	0	1	17	0	0
10	26990287	.	C	T	12	3	15	0	2	17	0	0
10	26991487	.	T	C	16	14	30	0	0	30	0	0
10	26991514	.	C	T	11	14	25	0	0	25	0	0
10	26991556	.	C	T	8	9	17	0	1	18	0	0
10	26991785	.	C	G	5	2	7	0	0	7	0	0
10	26991811	.	G	A	3	3	6	0	0	6	0	0
10	26991835	.	G	T	2	3	5	0	1	6	0	0
10	26991875	.	A	T	4	6	10	0	2	12	0	0
10	26991876	.	C	G	5	7	12	0	0	12	0	0
10	26997218	.	G	A	15	7	22	0	0	22	0	0
10	26997222	.	A	T	14	7	21	0	1	22	0	0
10	26999165	.	T	C	9	2	11	0	22	33	0	0
10	27006367	.	A	G	17	11	28	0	4	32	0	0
10	27006386	.	G	A	17	16	33	0	0	33	0	0
10	27006413	.	A	C	14	14	28	0	2	30	0	0
10	27006447	.	T	C	14	9	23	0	0	23	0	0
10	27006490	.	A	G	17	13	30	0	2	32	0	0
10	27006721	.	T	C	18	31	49	0	4	53	0	0
10	28473577	.	C	G	1	3	4	0	0	4	0	0
10	28483319	.	C	T	2	1	3	0	1	4	0	0
10	28691024	.	C	T	4	2	6	0	1	7	0	0
10	28696000	.	A	G	4	0	4	0	8	12	0	0
10	28696336	.	C	A	2	4	6	0	1	7	0	0
10	28724220	.	G	A	7	4	11	0	1	12	0	0
10	28727265	.	C	T	5	2	7	0	0	7	0	0
10	28727461	.	C	T	6	4	10	0	0	10	0	0
10	28730216	.	C	T	7	3	10	0	0	10	0	0
10	28730249	.	C	T	3	5	8	0	0	8	0	0
10	28730345	.	T	A	11	6	17	0	0	17	0	0
10	28730446	.	A	C	5	7	12	0	0	12	0	0
10	28730647	.	T	G	1	4	5	0	0	5	0	0
10	28730880	.	T	A	8	4	12	0	0	12	0	0
10	28730913	.	G	A	8	11	19	0	0	19	0	0
10	28731001	.	C	T	8	10	18	0	1	19	0	0
10	28731072	.	C	T	10	10	20	0	2	22	0	0
10	28731155	.	A	T	8	10	18	0	2	20	0	0
10	28731289	.	T	C	12	5	17	0	2	19	0	0
10	28731333	.	C	T	5	7	12	0	1	13	0	0
10	28731372	.	G	A	2	5	7	0	4	11	0	0
10	28732003	.	C	A	20	16	36	0	1	37	0	0
10	28732104	.	T	C	11	14	25	0	1	26	0	0
10	28732601	.	C	T	5	15	20	0	18	38	0	0
10	28732785	.	T	C	17	13	30	0	6	36	0	0
10	28733067	.	G	T	26	11	37	0	4	41	0	0
10	28743800	.	T	A	15	8	23	0	1	24	0	0
10	28745833	.	G	A	7	11	18	0	0	18	0	0
10	28748741	.	C	T	2	6	8	0	7	15	0	0
10	28749053	.	A	G	5	7	12	0	1	13	0	0
10	28761022	.	C	T	6	3	9	0	2	11	0	0
10	28761049	.	C	T	2	8	10	0	0	10	0	0
10	28761094	.	G	A	6	4	10	0	0	10	0	0
10	28761100	.	G	A	5	4	9	0	0	9	0	0
10	28835635	.	C	G	3	3	6	0	0	6	0	0
10	28835655	.	G	A	2	3	5	0	0	5	0	0
10	29166445	.	A	G	4	5	9	0	0	9	0	0
10	29185800	.	C	G	10	0	10	0	22	32	0	0
10	29185863	.	T	A	18	11	29	0	0	29	0	0
10	29187908	.	C	T	16	11	27	1	0	28	0	0
10	29201671	.	C	T	9	6	15	0	2	17	0	0
10	29205655	.	A	T	17	20	37	0	1	38	0	0
10	29205679	.	G	T	3	22	25	0	17	42	0	0
10	29224484	.	G	A	16	17	33	0	1	34	0	0
10	29224598	.	A	T	17	16	33	0	1	34	0	0
10	29224651	.	C	A	17	10	27	0	3	30	0	0
10	29225032	.	A	G	10	1	11	0	5	17	1	0
10	29233832	.	C	T	1	3	4	0	0	4	0	0
10	29236413	.	A	G	2	3	5	0	1	6	0	0
10	29266376	.	C	T	20	23	43	0	1	44	0	0
10	29268521	.	T	A	3	5	8	0	0	8	0	0
10	29270225	.	C	T	6	4	10	0	0	10	0	0
10	29270291	.	T	C	6	7	13	0	0	13	0	0
10	29271915	.	C	T	6	6	12	0	0	12	0	0
10	29271980	.	A	C	6	0	6	0	6	12	0	0
10	29272693	.	C	T	6	13	19	0	1	20	0	0
10	29575542	.	C	T	6	3	9	0	1	10	0	0
10	29578478	.	C	T	7	9	16	0	2	18	0	0
10	29578738	.	C	T	4	5	9	0	0	9	0	0
10	29578756	.	G	T	3	4	7	0	1	8	0	0
10	29678313	.	G	A	12	7	19	0	1	20	0	0
10	29701347	.	C	T	10	10	20	0	0	20	0	0
10	29701405	.	G	A	1	11	12	0	12	24	0	0
10	29702103	.	G	A	10	7	17	0	1	18	0	0
10	29708080	.	C	T	13	8	21	0	1	22	0	0
10	29708095	.	T	A	15	8	23	0	3	26	0	0
10	29708154	.	A	G	24	1	25	0	11	36	0	0
10	29736255	.	G	C	1	4	5	0	0	5	0	0
10	29736736	.	T	C	11	0	11	0	9	20	0	0
10	29736895	.	T	A	7	10	17	0	0	17	0	0
10	29738555	.	C	T	11	6	17	0	2	19	0	0
10	29742656	.	C	T	5	8	13	0	1	14	0	0
10	29742795	.	T	C	12	5	17	0	1	18	0	0
10	29751221	.	T	C	9	0	9	0	7	16	0	0
10	29751638	.	G	T	11	14	25	0	1	26	0	0
10	29754464	.	G	T	6	6	12	0	0	12	0	0
10	29759186	.	A	G	15	10	25	0	1	26	0	0
10	29761405	.	C	T	5	7	12	0	0	12	0	0
10	29763146	.	A	G	6	3	9	0	0	9	0	0
10	29767566	.	C	A	2	3	5	0	0	5	0	0
10	29772167	.	A	G	5	3	8	0	0	8	0	0
10	29778375	.	A	G	3	0	3	0	5	8	0	0
10	29778396	.	C	T	4	6	10	0	2	12	0	0
10	29785682	.	C	A	5	3	8	0	0	8	0	0
10	29820495	.	G	A	7	4	11	0	0	11	0	0
10	29823484	.	G	A	9	11	20	0	0	20	0	0
10	29828696	.	T	G	5	4	9	0	0	9	0	0
10	29831556	.	G	A	5	3	8	0	0	8	0	0
10	29853684	.	A	G	11	10	21	1	14	36	0	0
10	29882732	.	G	A	1	4	5	0	0	5	0	0
10	29892283	.	C	T	0	3	3	0	1	4	0	0
10	29892382	.	C	T	1	1	2	0	1	3	0	0
10	30540800	.	C	T	5	4	9	0	0	9	0	0
10	30576004	.	T	C	9	6	15	0	0	15	0	0
10	30618121	.	C	T	4	3	7	0	0	7	0	0
10	30623408	.	G	A	6	7	13	0	0	13	0	0
10	30627092	.	A	T	5	5	10	0	0	10	0	0
10	31020810	.	A	G	7	5	12	0	0	12	0	0
10	31021450	.	C	T	9	5	14	0	0	14	0	0
10	31021553	.	G	A	14	11	25	0	1	26	0	0
10	31021611	.	C	T	17	8	25	0	0	25	0	0
10	31021676	.	G	A	9	11	20	0	0	21	1	0
10	31023824	.	C	T	16	14	30	0	0	30	0	0
10	31031543	.	C	T	0	5	5	0	9	14	0	0
10	31032043	.	T	C	5	8	13	0	1	14	0	0
10	31034999	.	C	T	2	5	7	0	7	14	0	0
10	31035030	.	G	A	4	7	11	0	0	11	0	0
10	31035129	.	C	T	4	7	11	0	3	14	0	0
10	31270495	.	G	T	0	2	2	0	2	4	0	0
10	31275451	.	C	G	1	0	1	0	5	6	0	0
10	31276808	.	T	C	6	2	8	0	0	8	0	0
10	31280159	.	C	G	3	0	3	0	2	5	0	0
10	31280293	.	G	A	3	4	7	0	0	7	0	0
10	31280980	.	A	T	1	4	5	0	0	5	0	0
10	31306727	.	C	T	2	7	9	0	25	34	0	0
10	31306956	.	C	G	3	11	14	0	18	32	0	0
10	31315631	.	C	T	2	13	15	0	11	26	0	0
10	31317976	.	T	C	11	16	27	0	1	28	0	0
10	31317978	.	A	G	11	16	27	0	1	28	0	0
10	31325248	.	C	A	12	7	19	0	0	19	0	0
10	31326235	.	T	C	3	0	3	0	5	8	0	0
10	31328373	.	A	T	8	8	16	0	1	17	0	0
10	31328531	.	C	T	6	13	19	0	0	19	0	0
10	31328609	.	G	A	5	5	10	0	0	10	0	0
10	31328612	.	A	C	5	4	9	0	0	9	0	0
10	31337822	.	G	A	5	4	9	0	1	10	0	0
10	31354096	.	A	G	5	5	10	0	0	10	0	0
10	31624750	.	G	A	3	2	5	0	0	5	0	0
10	31628325	.	A	C	3	2	5	0	0	5	0	0
10	31632313	.	G	C	5	8	13	0	0	13	0	0
10	31632691	.	G	A	7	6	13	0	1	14	0	0
10	31632758	.	A	T	6	3	9	0	1	10	0	0
10	31632829	.	A	G	4	7	11	0	0	11	0	0
10	31632838	.	C	T	8	3	11	0	0	11	0	0
10	31632945	.	C	T	4	6	10	0	0	10	0	0
10	31633424	.	A	G	2	3	5	0	1	6	0	0
10	31633438	.	T	A	3	4	7	0	0	7	0	0
10	31633640	.	G	A	3	4	7	0	0	7	0	0
10	31646096	.	G	A	2	2	4	0	0	4	0	0
10	31646132	.	C	A	2	2	4	0	0	4	0	0
10	31725697	.	C	T	3	6	9	0	2	11	0	0
10	31725736	.	T	C	5	5	10	0	1	11	0	0
10	31738616	.	A	G	7	8	15	0	0	15	0	0
10	31739346	.	G	T	30	34	64	0	2	66	0	0
10	31757307	.	C	T	30	20	50	0	2	52	0	0
10	31772112	.	A	G	21	23	44	1	0	45	0	0
10	31800313	.	A	G	12	7	19	0	0	19	0	0
10	31803651	.	G	A	6	3	9	0	0	9	0	0
10	31805648	.	C	T	4	4	8	0	0	8	0	0
10	31805736	.	G	A	3	3	6	0	0	6	0	0
10	31951383	.	G	A	2	2	4	0	0	4	0	0
10	31951489	.	G	T	1	2	3	0	0	3	0	0
10	31953565	.	A	G	1	4	5	0	0	5	0	0
10	31953627	.	T	C	2	2	4	0	0	4	0	0
10	31953744	.	C	A	5	5	10	0	0	10	0	0
10	32036978	.	G	A	2	4	6	0	0	6	0	0
10	32037355	.	C	T	2	4	6	0	1	7	0	0
10	32037373	.	T	C	4	4	8	0	0	8	0	0
10	32062657	.	G	A	2	2	4	0	0	4	0	0
10	32063401	.	C	T	5	2	7	0	0	7	0	0
10	32063752	.	G	A	5	3	8	0	1	9	0	0
10	32063809	.	A	G	5	5	10	0	0	10	0	0
10	32064138	.	C	T	3	7	10	0	0	10	0	0
10	32106223	.	G	A	0	3	3	0	1	4	0	0
10	32106288	.	C	T	1	2	3	0	0	3	0	0
10	32122727	.	T	C	1	4	5	0	0	5	0	0
10	32561392	.	A	T	5	7	12	0	1	13	0	0
10	32561398	.	G	A	0	5	5	0	8	13	0	0
10	32561427	.	A	C	10	4	14	0	0	14	0	0
10	32561437	.	T	A	9	6	15	0	0	15	0	0
10	32561615	.	C	G	14	5	19	0	0	19	0	0
10	32562267	.	C	T	13	19	32	0	0	32	0	0
10	32577621	.	G	A	12	14	26	0	1	27	0	0
10	32581221	.	G	A	14	13	27	0	0	27	0	0
10	32600809	.	A	G	10	0	10	0	5	15	0	0
10	32600810	.	T	C	10	5	15	0	0	15	0	0
10	32600927	.	C	T	22	20	42	0	0	42	0	0
10	32648649	.	C	T	1	2	3	0	0	3	0	0
10	32657586	.	A	G	4	1	5	0	1	6	0	0
10	32657591	.	C	A	3	4	7	0	0	7	0	0
10	32657893	.	G	A	15	12	27	0	0	27	0	0
10	32657980	.	A	G	17	11	28	0	1	29	0	0
10	32660658	.	A	C	3	4	7	0	0	7	0	0
10	32780271	.	A	C	4	4	8	0	0	8	0	0
10	32783974	.	A	C	8	6	14	0	0	14	0	0
10	32787910	.	C	T	9	4	13	0	0	13	0	0
10	32788457	.	A	T	5	6	11	0	1	12	0	0
10	32788504	.	A	T	6	6	12	0	2	14	0	0
10	32788633	.	T	C	8	17	25	0	0	25	0	0
10	32788663	.	T	C	12	18	30	0	1	31	0	0
10	32809986	.	G	C	16	13	29	0	0	29	0	0
10	32810279	.	T	A	7	9	16	0	4	20	0	0
10	32810340	.	A	T	21	8	29	0	1	30	0	0
10	32810579	.	T	C	7	0	7	0	9	16	0	0
10	32810593	.	A	T	6	4	10	0	1	11	0	0
10	32811010	.	C	T	1	5	6	0	7	13	0	0
10	32811102	.	T	A	4	7	11	0	1	12	0	0
10	32817924	.	C	A	1	9	10	0	9	19	0	0
10	32820412	.	A	G	13	7	20	0	0	20	0	0
10	32820426	.	T	A	12	4	16	0	0	16	0	0
10	32820451	.	G	T	11	2	13	0	2	15	0	0
10	32820577	.	T	C	9	0	9	0	8	17	0	0
10	32823131	.	C	T	3	13	16	0	1	17	0	0
10	32831245	.	T	C	0	0	0	0	10	10	0	0
10	32831269	.	G	A	9	5	14	0	0	14	0	0
10	32831671	.	T	C	5	0	5	0	5	10	0	0
10	32831683	.	C	G	5	4	9	0	0	9	0	0
10	32840835	.	C	T	2	5	7	0	8	15	0	0
10	32843827	.	C	G	5	2	7	0	0	7	0	0
10	32857382	.	T	C	23	0	23	0	11	34	0	0
10	32857386	.	C	T	6	27	33	0	1	34	0	0
10	32857557	.	T	C	11	12	23	0	0	23	0	0
10	32857738	.	A	G	10	13	23	0	1	24	0	0
10	32857746	.	A	T	14	9	23	0	0	23	0	0
10	32857898	.	C	T	10	10	20	0	0	20	0	0
10	32857948	.	T	G	8	4	12	0	2	14	0	0
10	32858107	.	A	G	12	10	22	1	1	24	0	0
10	32858132	.	T	C	16	0	16	1	13	30	0	0
10	32858158	.	C	G	14	14	28	1	2	31	0	0
10	32858215	.	T	A	18	11	29	0	0	29	0	0
10	32858361	.	T	C	15	15	30	0	2	32	0	0
10	32858425	.	G	C	12	17	29	0	0	29	0	0
10	32858607	.	C	T	15	9	24	0	1	25	0	0
10	32858612	.	T	A	8	17	25	0	0	25	0	0
10	32858642	.	G	C	10	12	22	0	2	24	0	0
10	32861106	.	G	A	10	11	21	0	0	21	0	0
10	32861118	.	T	G	11	10	21	0	1	22	0	0
10	32874849	.	G	A	16	9	25	0	0	25	0	0
10	32881787	.	C	T	1	8	9	0	16	25	0	0
10	32881823	.	G	A	19	9	28	0	1	29	0	0
10	32881884	.	C	T	15	15	30	0	1	31	0	0
10	32881904	.	A	G	17	15	32	0	0	32	0	0
10	32882022	.	A	G	4	2	6	0	0	6	0	0
10	32882056	.	G	A	10	3	13	0	0	13	0	0
10	32882080	.	A	T	14	8	22	0	0	22	0	0
10	32882156	.	T	G	16	18	34	0	1	35	0	0
10	32882495	.	T	C	5	9	14	0	0	14	0	0
10	32882515	.	C	T	3	7	10	0	1	11	0	0
10	32882683	.	G	T	4	15	19	0	0	19	0	0
10	32882686	.	A	T	4	15	19	0	1	20	0	0
10	32882732	.	C	A	8	15	23	0	1	24	0	0
10	32882977	.	C	A	2	9	11	0	9	20	0	0
10	32890201	.	C	T	0	13	13	0	9	22	0	0
10	32899276	.	T	A	9	6	15	1	0	16	0	0
10	32899807	.	T	C	11	3	14	4	1	19	0	0
10	32899986	.	T	G	12	10	22	0	0	22	0	0
10	32899988	.	T	C	12	0	12	0	10	22	0	0
10	32900021	.	T	C	10	4	14	0	1	15	0	0
10	32900469	.	T	G	5	9	14	0	1	15	0	0
10	32900642	.	A	T	9	10	19	0	0	19	0	0
10	32902159	.	T	C	5	0	5	0	7	12	0	0
10	32902481	.	G	C	4	4	8	0	1	9	0	0
10	32903589	.	C	T	1	5	6	0	4	10	0	0
10	32907193	.	G	T	2	6	8	2	1	11	0	0
10	32912847	.	T	G	5	7	12	0	0	12	0	0
10	32920415	.	A	G	3	4	7	0	0	7	0	0
10	32920529	.	C	A	1	2	3	0	1	4	0	0
10	32920574	.	G	T	1	2	3	0	0	3	0	0
10	32920649	.	A	G	2	3	5	0	1	6	0	0
10	32939399	.	C	T	0	2	2	0	5	7	0	0
10	32939426	.	G	A	3	3	6	0	1	7	0	0
10	32939516	.	C	T	4	2	6	0	0	6	0	0
10	32955561	.	C	T	2	3	5	0	0	5	0	0
10	32963501	.	C	T	0	3	3	0	4	7	0	0
10	32963546	.	A	G	3	4	7	0	0	7	0	0
10	32963555	.	T	C	3	3	6	0	1	7	0	0
10	32963960	.	C	G	4	2	6	0	0	6	0	0
10	32964089	.	C	T	0	4	4	0	4	8	0	0
10	33244529	.	C	T	0	3	3	0	1	4	0	0
10	33244534	.	T	C	2	3	5	0	0	5	0	0
10	33254930	.	G	A	7	6	13	0	1	14	0	0
10	33255113	.	G	A	6	4	10	0	0	10	0	0
10	33265240	.	T	C	4	0	4	0	3	7	0	0
10	33274974	.	C	T	1	3	4	0	0	4	0	0
10	33314237	.	T	A	2	3	5	0	0	5	0	0
10	33325241	.	T	C	3	3	6	0	1	7	0	0
10	33342292	.	T	C	1	2	3	0	0	3	0	0
10	33369973	.	C	A	10	10	20	0	1	21	0	0
10	33373568	.	C	G	1	12	13	0	10	23	0	0
10	33375478	.	C	T	21	6	27	0	3	30	0	0
10	33385363	.	G	A	33	18	51	0	3	54	0	0
10	33389469	.	A	G	26	0	26	0	18	44	0	0
10	33391844	.	G	A	23	33	56	0	1	57	0	0
10	33391930	.	G	A	29	14	43	0	8	51	0	0
10	33392071	.	T	C	17	16	33	1	2	36	0	0
10	33392103	.	G	A	17	17	34	1	3	38	0	0
10	33392199	.	A	G	6	16	22	0	2	24	0	0
10	33392263	.	A	G	15	19	34	1	1	36	0	0
10	33392264	.	C	T	20	14	34	1	0	35	0	0
10	33392370	.	T	C	19	19	38	1	1	40	0	0
10	33393021	.	C	A	3	2	5	0	0	5	0	0
10	33402255	.	A	T	1	2	3	0	0	3	0	0
10	33402315	.	A	G	1	0	1	0	2	3	0	0
10	33538997	.	T	C	1	3	4	0	0	4	0	0
10	33573861	.	A	T	3	3	6	0	0	6	0	0
10	33573866	.	A	T	3	3	6	0	0	6	0	0
10	33574250	.	T	G	6	0	6	0	7	13	0	0
10	33576509	.	T	C	6	3	9	0	0	9	0	0
10	33576518	.	T	C	6	3	9	0	0	9	0	0
10	33576551	.	T	C	6	2	8	0	0	8	0	0
10	33578816	.	T	A	6	5	11	0	2	13	0	0
10	33580759	.	G	A	3	2	5	0	0	5	0	0
10	33614545	.	G	A	3	2	5	0	0	5	0	0
10	33616266	.	A	G	5	2	7	0	0	7	0	0
10	33626475	.	A	G	2	2	4	0	0	4	0	0
10	33698487	.	G	C	1	2	3	0	0	3	0	0
10	33863568	.	G	A	7	3	10	0	0	10	0	0
10	33867032	.	G	A	8	4	12	0	0	12	0	0
10	33867365	.	C	T	8	6	14	0	1	15	0	0
10	33867394	.	G	A	5	7	12	0	1	13	0	0
10	33921928	.	A	G	1	3	4	0	0	4	0	0
10	33921934	.	T	C	1	3	4	0	0	4	0	0
10	33930780	.	T	G	1	3	4	0	0	4	0	0
10	33942210	.	C	T	4	4	8	0	0	8	0	0
10	33956690	.	G	A	0	5	5	0	3	8	0	0
10	33957780	.	C	T	9	8	17	0	1	18	0	0
10	33958750	.	T	C	6	6	12	0	0	12	0	0
10	33958813	.	T	C	7	4	11	0	1	12	0	0
10	33960943	.	C	T	5	16	21	0	2	23	0	0
10	33961048	.	G	A	0	9	9	0	11	20	0	0
10	33961093	.	A	T	5	2	7	0	2	9	0	0
10	33982165	.	G	A	13	22	35	0	0	35	0	0
10	33983870	.	A	G	12	15	27	0	7	34	0	0
10	33989820	.	G	A	11	13	24	1	2	27	0	0
10	33994424	.	A	G	23	21	44	0	1	45	0	0
10	33994445	.	A	G	22	20	42	0	1	44	1	0
10	33994475	.	C	T	22	15	37	0	0	37	0	0
10	34023916	.	G	T	1	2	3	0	0	3	0	0
10	34025077	.	T	C	3	2	5	0	0	5	0	0
10	34025104	.	C	T	3	4	7	0	0	7	0	0
10	34383783	.	A	T	1	4	5	0	0	5	0	0
10	34388882	.	T	G	7	5	12	0	0	12	0	0
10	34388888	.	G	A	8	3	11	0	1	12	0	0
10	34394653	.	G	A	6	3	9	0	0	9	0	0
10	34396026	.	G	A	6	7	13	0	0	13	0	0
10	34402874	.	T	C	4	4	8	0	0	8	0	0
10	34403615	.	A	G	5	8	13	0	0	13	0	0
10	34403668	.	A	T	6	10	16	0	0	16	0	0
10	34403965	.	A	T	11	2	13	0	2	15	0	0
10	34403980	.	A	G	13	0	13	0	3	16	0	0
10	34404015	.	G	A	9	4	13	0	0	13	0	0
10	34404028	.	T	G	8	4	12	0	0	12	0	0
10	34404593	.	T	C	4	3	7	0	0	7	0	0
10	34588872	.	C	T	4	2	6	0	0	6	0	0
10	34588881	.	C	T	3	4	7	0	1	8	0	0
10	34606549	.	T	C	2	3	5	0	0	5	0	0
10	34657676	.	C	T	9	7	16	0	0	16	0	0
10	34661857	.	A	G	1	4	5	0	0	5	0	0
10	34661869	.	C	T	4	2	6	0	0	6	0	0
10	34662223	.	C	A	2	2	4	0	0	4	0	0
10	34664906	.	G	A	1	2	3	0	0	3	0	0
10	34673597	.	C	T	7	9	16	0	1	17	0	0
10	34676338	.	C	T	2	4	6	0	0	6	0	0
10	34677614	.	C	A	7	4	11	0	1	12	0	0
10	34699238	.	C	T	7	5	12	0	0	12	0	0
10	34703742	.	G	A	6	6	12	0	3	15	0	0
10	34709708	.	G	C	7	6	13	0	1	14	0	0
10	34709940	.	C	T	19	9	28	0	0	28	0	0
10	34714789	.	C	T	10	12	22	0	1	23	0	0
10	34724906	.	C	T	18	17	35	0	1	36	0	0
10	34729552	.	G	A	12	24	36	0	3	39	0	0
10	34729693	.	C	T	15	17	32	0	6	38	0	0
10	34733566	.	A	G	34	18	52	0	0	52	0	0
10	34733661	.	C	T	13	20	33	0	9	42	0	0
10	34733883	.	A	T	16	23	39	0	1	40	0	0
10	34734714	.	A	T	22	22	44	0	10	54	0	0
10	34734743	.	T	G	19	27	46	0	0	46	0	0
10	34734785	.	G	T	18	18	36	1	2	39	0	0
10	34737919	.	T	C	25	20	45	0	2	47	0	0
10	34738213	.	C	T	7	17	24	0	38	62	0	0
10	34754660	.	C	T	21	17	38	0	1	39	0	0
10	34813299	.	T	C	7	4	11	0	0	11	0	0
10	34867466	.	C	T	8	4	12	0	0	12	0	0
10	34870579	.	C	T	12	3	15	0	1	16	0	0
10	34913407	.	G	A	2	2	4	0	0	4	0	0
10	34951192	.	C	T	2	3	5	0	0	5	0	0
10	34961244	.	G	T	21	6	27	0	0	27	0	0
10	34961309	.	A	G	19	11	30	0	1	31	0	0
10	34961311	.	T	C	18	11	29	0	1	30	0	0
10	34961403	.	T	C	7	3	10	0	2	12	0	0
10	34961405	.	C	T	7	3	10	0	1	11	0	0
10	34961480	.	C	A	7	5	12	0	0	12	0	0
10	34961520	.	T	C	6	4	10	0	0	10	0	0
10	34961669	.	A	G	5	8	13	0	4	17	0	0
10	34962074	.	G	T	1	2	3	0	0	3	0	0
10	34962155	.	G	A	3	3	6	0	1	7	0	0
10	34989149	.	T	C	10	0	10	0	17	27	0	0
10	34992565	.	A	G	13	10	23	0	2	25	0	0
10	35002653	.	C	A	5	4	9	0	0	9	0	0
10	35002655	.	T	A	4	4	8	0	1	9	0	0
10	35006385	.	C	T	11	5	16	0	2	18	0	0
10	35008963	.	C	T	5	10	15	0	0	15	0	0
10	35011337	.	A	G	6	4	10	0	1	11	0	0
10	35025832	.	G	C	3	4	7	0	1	8	0	0
10	35029067	.	T	C	2	0	2	0	3	5	0	0
10	35029172	.	G	A	5	4	9	0	1	10	0	0
10	35032792	.	A	G	2	4	6	0	2	8	0	0
10	35059919	.	C	A	0	2	2	0	2	4	0	0
10	35059928	.	T	G	0	3	3	0	0	3	0	0
10	35063944	.	C	T	1	7	8	0	1	9	0	0
10	35108561	.	A	G	2	3	5	0	1	6	0	0
10	35153051	.	G	T	4	3	7	0	1	8	0	0
10	35163358	.	T	A	10	6	16	0	1	17	0	0
10	35163406	.	G	A	10	5	15	0	1	16	0	0
10	35163492	.	T	C	2	2	4	0	0	4	0	0
10	35169884	.	T	C	5	7	12	0	0	12	0	0
10	35170265	.	A	G	3	4	7	0	0	7	0	0
10	35177270	.	A	T	3	2	5	0	0	5	0	0
10	35177324	.	A	G	10	5	15	0	1	16	0	0
10	35177357	.	G	A	8	6	14	0	1	15	0	0
10	35177375	.	G	C	9	0	9	0	10	19	0	0
10	35177537	.	G	A	4	7	11	0	0	11	0	0
10	35178440	.	A	T	7	8	15	0	2	17	0	0
10	35178518	.	A	T	6	7	13	0	3	16	0	0
10	35180253	.	G	C	4	3	7	0	1	8	0	0
10	35180627	.	C	T	1	7	8	0	5	13	0	0
10	35182580	.	A	T	2	2	4	0	1	5	0	0
10	35236801	.	T	G	6	3	9	0	0	9	0	0
10	35241646	.	A	T	5	3	8	0	0	8	0	0
10	35242113	.	C	G	7	4	11	0	0	11	0	0
10	35245939	.	T	A	6	3	9	0	1	10	0	0
10	35245951	.	C	T	4	3	7	0	2	9	0	0
10	35247905	.	G	A	3	2	5	0	0	5	0	0
10	35247980	.	G	C	3	1	4	0	2	6	0	0
10	35248433	.	G	A	3	2	5	0	1	6	0	0
10	35250755	.	T	A	1	2	3	0	0	3	0	0
10	35265206	.	T	A	1	3	4	0	0	4	0	0
10	35266720	.	G	A	0	2	2	1	1	4	0	0
10	35267852	.	A	G	1	3	4	0	0	4	0	0
10	35292112	.	G	A	1	3	4	0	0	4	0	0
10	35298732	.	A	G	2	4	6	0	1	7	0	0
10	35304002	.	G	A	3	6	9	0	1	10	0	0
10	35304014	.	C	T	3	6	9	0	1	10	0	0
10	35307579	.	C	T	5	6	11	0	1	12	0	0
10	35311926	.	C	G	12	17	29	0	2	31	0	0
10	35312682	.	C	G	5	3	8	0	0	8	0	0
10	35316465	.	G	A	1	2	3	0	2	5	0	0
10	35590076	.	T	A	8	11	19	0	0	19	0	0
10	35592817	.	A	G	4	6	10	0	1	11	0	0
10	35592830	.	G	A	6	8	14	0	0	14	0	0
10	35595653	.	C	T	3	10	13	0	1	14	0	0
10	35595669	.	T	A	8	8	16	0	1	17	0	0
10	35600397	.	T	C	7	5	12	0	0	12	0	0
10	35600529	.	G	T	2	7	9	0	0	9	0	0
10	35602535	.	G	T	5	3	8	0	0	8	0	0
10	35602756	.	T	C	4	6	10	0	0	10	0	0
10	35603179	.	G	T	4	5	9	0	0	9	0	0
10	35603212	.	A	G	3	3	6	0	0	6	0	0
10	35603233	.	A	G	1	4	5	0	0	5	0	0
10	35606506	.	C	A	4	6	10	0	0	10	0	0
10	35609468	.	T	C	3	2	5	0	0	5	0	0
10	35664575	.	C	A	3	2	5	0	0	5	0	0
10	35953425	.	A	C	4	2	6	0	1	7	0	0
10	35959133	.	C	A	6	5	11	0	0	11	0	0
10	35959163	.	T	C	6	7	13	0	0	13	0	0
10	35959223	.	T	C	4	3	7	0	0	7	0	0
10	35959400	.	T	C	7	5	12	0	0	12	0	0
10	36029893	.	T	C	47	23	70	0	1	71	0	0
10	36031316	.	C	A	2	4	6	0	0	6	0	0
10	36040404	.	T	C	2	4	6	0	0	6	0	0
10	36049738	.	G	A	4	6	10	0	0	10	0	0
10	36054226	.	C	T	5	5	10	0	1	11	0	0
10	36063020	.	G	A	1	4	5	0	0	5	0	0
10	36095725	.	T	A	1	5	6	0	0	6	0	0
10	36096022	.	T	A	4	3	7	0	0	7	0	0
10	36097946	.	C	T	3	3	6	0	0	6	0	0
10	36101022	.	A	G	2	0	2	0	3	5	0	0
10	36156369	.	G	A	2	2	4	0	0	4	0	0
10	36159159	.	A	T	5	3	8	0	0	8	0	0
10	36159166	.	G	A	5	4	9	0	0	9	0	0
10	36159219	.	G	A	2	2	4	0	0	4	0	0
10	36159432	.	G	C	2	3	5	0	0	5	0	0
10	36159502	.	G	A	5	2	7	0	0	7	0	0
10	36160027	.	C	T	4	3	7	0	0	7	0	0
10	36160041	.	G	A	3	2	5	0	0	5	0	0
10	36363557	.	A	G	14	12	26	0	0	26	0	0
10	36363611	.	C	T	18	15	33	0	1	34	0	0
10	36363818	.	G	T	12	15	27	0	4	31	0	0
10	36363937	.	G	A	18	21	39	0	0	39	0	0
10	36363971	.	C	T	2	18	20	0	14	34	0	0
10	36364172	.	A	G	16	17	33	0	1	34	0	0
10	36405921	.	C	T	25	13	38	0	2	40	0	0
10	36406039	.	G	T	12	16	28	0	1	29	0	0
10	36406106	.	T	A	7	6	13	0	1	14	0	0
10	36406210	.	G	A	15	9	24	0	0	24	0	0
10	36443018	.	T	C	6	16	22	0	1	23	0	0
10	36443541	.	T	C	11	13	24	0	2	26	0	0
10	36443676	.	G	A	1	9	10	0	6	16	0	0
10	36443714	.	G	A	6	9	15	0	0	15	0	0
10	36443818	.	T	G	7	0	7	0	8	15	0	0
10	36446799	.	A	T	7	8	15	0	0	15	0	0
10	36451615	.	T	C	14	23	37	0	0	37	0	0
10	36451661	.	G	A	17	25	42	0	1	43	0	0
10	36454567	.	C	A	13	18	31	0	2	33	0	0
10	36454649	.	A	G	16	0	16	0	31	47	0	0
10	36454650	.	C	A	19	23	42	0	5	47	0	0
10	36454902	.	G	T	13	19	32	0	2	34	0	0
10	36455146	.	C	T	18	16	34	0	1	35	0	0
10	36455215	.	T	C	11	20	31	0	1	32	0	0
10	36455229	.	C	G	12	23	35	0	0	35	0	0
10	36455344	.	A	G	13	14	27	0	2	29	0	0
10	36455847	.	G	A	3	7	10	0	11	21	0	0
10	36476481	.	C	T	4	11	15	0	21	36	0	0
10	36476529	.	C	T	7	19	26	0	4	30	0	0
10	36476639	.	C	T	1	12	13	0	15	28	0	0
10	36476717	.	A	G	18	15	33	0	2	35	0	0
10	36476834	.	G	A	16	19	35	0	1	36	0	0
10	36476852	.	A	G	17	19	36	0	1	37	0	0
10	36476922	.	C	T	12	15	27	0	1	28	0	0
10	36481915	.	A	C	21	17	38	0	2	40	0	0
10	36482588	.	G	A	18	11	29	0	2	31	0	0
10	36487530	.	G	A	7	6	13	0	0	13	0	0
10	36489882	.	A	G	4	12	16	0	0	16	0	0
10	36489893	.	A	G	5	10	15	0	1	16	0	0
10	36492091	.	C	T	6	3	9	0	1	10	0	0
10	36494336	.	G	A	3	4	7	0	0	7	0	0
10	36494590	.	C	G	4	6	10	0	0	10	0	0
10	36495580	.	T	G	4	4	8	0	1	9	0	0
10	36496544	.	A	G	9	9	18	0	1	19	0	0
10	36496595	.	G	A	8	9	17	0	0	17	0	0
10	36498379	.	C	T	0	8	8	0	6	14	0	0
10	36498397	.	G	A	3	7	10	0	2	12	0	0
10	36500674	.	G	A	3	4	7	0	0	7	0	0
10	36506103	.	G	A	1	1	2	0	2	4	0	0
10	36506290	.	C	T	0	4	4	0	10	14	0	0
10	36518643	.	C	T	3	4	7	0	0	7	0	0
10	36519788	.	T	C	2	5	7	0	1	8	0	0
10	36520003	.	C	T	0	3	3	0	2	5	0	0
10	36520711	.	G	A	4	6	10	0	1	11	0	0
10	36520945	.	A	G	5	4	9	0	1	10	0	0
10	36522713	.	A	C	1	0	1	0	3	4	0	0
10	36558839	.	A	G	3	5	8	0	2	10	0	0
10	36558895	.	G	A	3	6	9	0	0	9	0	0
10	36570469	.	A	G	4	6	10	0	0	10	0	0
10	36572622	.	G	A	2	3	5	0	1	6	0	0
10	36572814	.	A	T	2	3	5	0	0	5	0	0
10	36613095	.	T	C	12	4	16	0	1	17	0	0
10	36613145	.	G	T	14	9	23	0	0	23	0	0
10	36613164	.	C	T	1	8	9	0	11	20	0	0
10	36613276	.	C	T	14	6	20	0	0	20	0	0
10	36615367	.	G	A	8	12	20	0	1	21	0	0
10	36615907	.	C	A	10	4	14	0	1	15	0	0
10	36618435	.	C	T	0	3	3	0	15	18	0	0
10	36618787	.	C	T	14	13	27	0	0	27	0	0
10	36625258	.	C	A	3	7	10	0	6	16	0	0
10	36625534	.	G	A	3	7	10	0	1	11	0	0
10	36625761	.	T	A	8	6	14	0	2	16	0	0
10	36627314	.	C	T	6	0	6	1	2	9	0	0
10	36627327	.	T	C	5	2	7	1	0	8	0	0
10	36627517	.	C	T	4	4	8	0	0	8	0	0
10	36628569	.	C	T	0	7	7	0	5	12	0	0
10	36670106	.	T	C	2	4	6	0	0	6	0	0
10	36673237	.	G	T	1	3	4	0	0	4	0	0
10	36679577	.	C	A	0	4	4	0	2	6	0	0
10	36688455	.	C	T	5	5	10	0	0	10	0	0
10	36689850	.	G	T	4	7	11	0	0	11	0	0
10	36689893	.	A	G	4	10	14	0	0	14	0	0
10	36691372	.	C	A	1	7	8	0	4	12	0	0
10	36695781	.	G	C	8	11	19	0	0	19	0	0
10	36695785	.	C	T	5	11	16	0	0	16	0	0
10	36704842	.	A	G	12	17	29	5	1	35	0	0
10	36706217	.	T	A	10	19	29	0	1	30	0	0
10	36708401	.	A	G	12	0	12	0	24	36	0	0
10	36708453	.	C	T	17	12	29	0	1	30	0	0
10	36710559	.	A	C	16	11	27	0	3	30	0	0
10	36710599	.	C	T	13	18	31	0	2	33	0	0
10	36710871	.	G	A	1	15	16	0	24	40	0	0
10	36710893	.	G	T	2	21	23	0	19	42	0	0
10	36711260	.	T	A	9	5	14	0	2	16	0	0
10	36711329	.	T	A	8	10	18	0	2	20	0	0
10	36711613	.	C	T	8	13	21	0	0	21	0	0
10	36778293	.	C	T	4	3	7	0	0	7	0	0
10	36778302	.	C	A	4	4	8	0	0	8	0	0
10	36778469	.	A	G	1	2	3	0	0	3	0	0
10	36796083	.	A	G	1	2	3	0	0	3	0	0
10	36796131	.	T	A	2	4	6	0	1	7	0	0
10	36800465	.	G	A	5	8	13	0	0	13	0	0
10	36800518	.	C	T	8	7	15	0	1	16	0	0
10	36800600	.	G	A	3	9	12	0	1	13	0	0
10	36800642	.	A	G	3	3	6	0	0	6	0	0
10	36808032	.	G	A	5	3	8	0	0	8	0	0
10	36811815	.	A	G	12	6	18	0	1	19	0	0
10	36812214	.	A	C	10	10	20	0	0	20	0	0
10	36814912	.	G	A	11	9	20	0	0	20	0	0
10	36815330	.	T	C	9	0	9	0	3	12	0	0
10	36817197	.	A	C	6	4	10	0	0	10	0	0
10	36817355	.	C	T	1	2	3	0	3	6	0	0
10	36817530	.	C	T	8	9	17	0	2	19	0	0
10	36817940	.	T	C	10	5	15	0	0	15	0	0
10	36817979	.	T	G	4	7	11	0	1	12	0	0
10	36819664	.	G	T	11	3	14	0	0	14	0	0
10	36819671	.	C	T	4	8	12	0	0	12	0	0
10	36820601	.	C	T	0	2	2	0	6	8	0	0
10	36820611	.	A	G	2	6	8	0	0	8	0	0
10	36820664	.	C	T	4	5	9	0	2	11	0	0
10	36820688	.	C	G	1	6	7	0	9	16	0	0
10	36820736	.	G	A	7	7	14	0	1	15	0	0
10	36820769	.	T	A	0	5	5	0	4	9	0	0
10	36820892	.	G	A	2	4	6	0	0	6	0	0
10	36825650	.	C	T	1	2	3	0	1	4	0	0
10	36825818	.	T	C	3	2	5	0	0	5	0	0
10	36825880	.	G	A	5	2	7	0	0	7	0	0
10	36828227	.	T	C	6	10	16	0	0	16	0	0
10	36828265	.	G	A	10	6	16	0	0	16	0	0
10	36828295	.	G	T	9	8	17	0	1	18	0	0
10	36828469	.	T	C	10	0	10	0	7	17	0	0
10	36828475	.	C	T	9	11	20	0	0	20	0	0
10	36835641	.	A	T	2	2	4	0	2	6	0	0
10	36835740	.	G	A	6	3	9	0	2	11	0	0
10	36838768	.	C	T	8	3	11	0	1	12	0	0
10	36841230	.	G	T	5	3	8	0	0	8	0	0
10	36848938	.	A	G	2	4	6	0	0	6	0	0
10	36850674	.	C	T	1	5	6	0	2	8	0	0
10	36850752	.	A	G	3	5	8	0	1	9	0	0
10	36878568	.	C	T	5	3	8	0	0	8	0	0
10	36878638	.	T	C	2	0	2	0	3	5	0	0
10	36950935	.	A	T	5	6	11	0	1	12	0	0
10	36951044	.	A	T	8	4	12	0	0	12	0	0
10	36951076	.	G	C	8	4	12	0	1	13	0	0
10	36951223	.	A	C	7	15	22	0	0	22	0	0
10	36951378	.	A	G	4	7	11	0	0	11	0	0
10	36951582	.	C	G	11	12	23	0	0	23	0	0
10	36951660	.	T	A	3	13	16	1	1	18	0	0
10	36953783	.	G	A	3	3	6	0	0	6	0	0
10	36963456	.	G	A	5	8	13	0	0	13	0	0
10	36967206	.	T	C	16	7	23	0	1	24	0	0
10	36969510	.	T	C	7	7	14	0	0	14	0	0
10	36969519	.	A	G	6	5	11	0	0	11	0	0
10	36974901	.	G	A	4	6	10	0	0	10	0	0
10	36976271	.	C	T	0	5	5	0	6	11	0	0
10	36976318	.	G	A	9	4	13	0	1	14	0	0
10	36987831	.	T	G	6	5	11	0	0	11	0	0
10	37011570	.	G	T	3	3	6	0	0	6	0	0
10	37126295	.	C	T	5	3	8	0	0	8	0	0
10	37126307	.	C	T	5	3	8	0	0	8	0	0
10	37137549	.	G	A	1	4	5	0	13	18	0	0
10	37145044	.	C	T	7	3	10	0	0	10	0	0
10	37145178	.	G	A	10	9	19	0	1	20	0	0
10	37152081	.	G	A	18	17	35	0	2	37	0	0
10	37152105	.	A	G	18	1	19	0	21	40	0	0
10	37163252	.	C	A	14	12	26	0	0	26	0	0
10	37167151	.	G	C	12	7	19	0	0	19	0	0
10	37227524	.	C	T	9	3	12	0	1	13	0	0
10	37234093	.	A	G	4	1	5	0	5	10	0	0
10	37236672	.	T	G	1	0	1	0	6	7	0	0
10	37239229	.	G	A	3	4	7	0	0	7	0	0
10	37252054	.	G	A	0	6	6	0	1	7	0	0
10	37253986	.	A	G	8	7	15	0	3	18	0	0
10	37334291	.	G	T	3	3	6	0	0	6	0	0
10	37361681	.	G	A	1	2	3	0	2	5	0	0
10	37367451	.	T	C	2	3	5	0	0	5	0	0
10	37384943	.	G	A	1	3	4	0	2	6	0	0
10	37385317	.	T	C	2	1	3	0	1	4	0	0
10	37389654	.	G	A	0	3	3	0	6	9	0	0
10	37394478	.	G	A	10	5	15	0	2	17	0	0
10	37394486	.	G	A	10	4	14	0	3	18	1	0
10	37394535	.	C	T	6	5	11	0	1	12	0	0
10	37394809	.	A	G	1	2	3	0	0	3	0	0
10	37764473	.	C	T	15	9	24	0	0	24	0	0
10	37779765	.	A	C	13	8	21	0	2	23	0	0
10	37779778	.	T	A	14	10	24	0	2	26	0	0
10	37783114	.	A	G	7	9	16	0	1	17	0	0
10	37783179	.	A	G	20	0	20	0	13	33	0	0
10	37783323	.	A	G	9	8	17	0	0	17	0	0
10	37783558	.	T	C	5	3	8	2	0	10	0	0
10	37783669	.	C	A	6	2	8	0	0	8	0	0
10	37992653	.	C	T	3	3	6	0	0	6	0	0
10	37992679	.	G	A	0	2	2	0	5	7	0	0
10	37992839	.	A	T	8	3	11	0	0	11	0	0
10	37994630	.	C	T	10	4	14	0	0	14	0	0
10	37997567	.	C	G	4	8	12	0	2	14	0	0
10	38000082	.	C	G	4	3	7	0	1	8	0	0
10	38000084	.	G	T	0	4	4	0	4	8	0	0
10	38003011	.	A	G	9	8	17	0	1	18	0	0
10	38005466	.	A	C	5	3	8	0	0	8	0	0
10	38040372	.	A	G	12	7	19	0	0	19	0	0
10	38040378	.	A	G	9	10	19	0	1	20	0	0
10	38041451	.	G	A	5	13	18	1	0	19	0	0
10	38074570	.	G	T	3	10	13	0	0	13	0	0
10	38149713	.	C	A	0	3	3	0	1	4	0	0
10	38149715	.	A	G	1	3	4	0	0	4	0	0
10	38170573	.	G	A	4	3	7	0	0	7	0	0
10	38170574	.	A	G	3	4	7	0	0	7	0	0
10	38170737	.	G	A	6	11	17	0	1	18	0	0
10	38171149	.	G	C	8	0	8	0	7	15	0	0
10	38171196	.	G	A	7	7	14	0	2	16	0	0
10	38171207	.	C	A	7	10	17	0	2	19	0	0
10	38171356	.	A	T	11	13	24	1	1	26	0	0
10	38171490	.	T	A	13	11	24	0	0	24	0	0
10	38173383	.	C	A	1	10	11	0	16	27	0	0
10	38177999	.	C	T	0	11	11	0	12	23	0	0
10	38178357	.	G	A	7	8	15	0	3	18	0	0
10	38180732	.	A	T	9	5	14	0	0	14	0	0
10	38189023	.	T	C	2	0	2	0	4	6	0	0
10	38199097	.	G	A	4	6	10	0	0	10	0	0
10	38199169	.	T	C	5	7	12	0	0	12	0	0
10	38201513	.	G	A	4	4	8	0	0	8	0	0
10	38205149	.	T	C	6	0	6	0	6	12	0	0
10	38218990	.	C	T	1	2	3	0	6	9	0	0
10	38231165	.	C	T	1	5	6	0	6	12	0	0
10	38235957	.	G	C	2	8	10	0	0	10	0	0
10	38243543	.	G	A	1	2	3	0	0	3	0	0
10	38256804	.	A	C	2	1	3	0	1	4	0	0
10	38257295	.	G	A	8	3	11	0	3	14	0	0
10	38257327	.	T	A	3	6	9	0	1	10	0	0
10	38257509	.	C	G	0	10	10	0	9	19	0	0
10	38257558	.	C	T	9	10	19	0	1	20	0	0
10	38257870	.	T	C	12	16	28	0	2	30	0	0
10	38258729	.	C	G	20	13	33	0	0	33	0	0
10	38259033	.	C	T	10	2	12	0	1	13	0	0
10	38259034	.	A	G	9	3	12	0	1	13	0	0
10	38259204	.	G	A	6	8	14	0	2	16	0	0
10	38259217	.	A	G	7	8	15	0	0	15	0	0
10	38259268	.	G	C	7	3	10	2	0	12	0	0
10	38259276	.	A	G	4	4	8	2	1	11	0	0
10	38259339	.	A	T	4	3	7	1	1	9	0	0
10	38259449	.	A	C	7	0	7	0	6	13	0	0
10	38259451	.	A	G	7	6	13	0	0	13	0	0
10	38259900	.	T	C	6	0	6	0	4	10	0	0
10	38260002	.	G	A	10	5	15	0	1	16	0	0
10	38260626	.	A	T	6	4	10	0	1	11	0	0
10	38261453	.	G	A	5	4	9	0	0	9	0	0
10	38665994	.	C	T	15	13	28	0	2	30	0	0
10	38666063	.	T	C	11	8	19	0	0	19	0	0
10	38686126	.	T	C	12	11	23	0	1	25	1	0
10	38695152	.	A	C	25	14	39	0	2	41	0	0
10	38695510	.	A	G	24	11	35	0	1	36	0	0
10	38695656	.	A	G	13	9	22	0	0	22	0	0
10	38695877	.	C	T	11	6	17	0	0	17	0	0
10	38695888	.	C	T	11	5	16	0	0	16	0	0
10	38712403	.	A	G	1	1	2	0	5	7	0	0
10	38712431	.	C	T	3	5	8	0	0	8	0	0
10	38723539	.	T	C	3	3	6	0	0	6	0	0
10	38775780	.	C	G	1	4	5	0	0	5	0	0
10	38891454	.	C	A	5	3	8	0	0	8	0	0
10	38922043	.	G	A	0	8	8	0	5	13	0	0
10	38924557	.	C	T	5	7	12	0	2	14	0	0
10	38924560	.	T	C	6	6	12	0	2	14	0	0
10	38934391	.	A	G	5	10	15	0	0	15	0	0
10	38940232	.	A	G	5	6	11	0	2	13	0	0
10	38943265	.	C	G	8	8	16	0	0	16	0	0
10	38950115	.	T	C	10	5	15	0	0	15	0	0
10	38950430	.	G	A	0	11	11	0	10	21	0	0
10	38950484	.	A	G	11	19	30	0	2	32	0	0
10	38950538	.	T	C	21	17	38	0	3	41	0	0
10	38954126	.	C	T	21	10	31	0	5	36	0	0
10	38954141	.	T	C	22	11	33	0	2	35	0	0
10	38954798	.	T	C	13	14	27	0	0	27	0	0
10	38954801	.	C	T	13	16	29	0	0	29	0	0
10	38957061	.	T	C	19	11	30	0	0	30	0	0
10	38957127	.	G	A	1	14	15	0	15	30	0	0
10	38957193	.	C	T	14	16	30	0	2	32	0	0
10	38957748	.	A	C	12	11	23	0	0	23	0	0
10	38957754	.	A	C	12	12	24	0	0	24	0	0
10	38969552	.	A	C	30	15	45	0	5	50	0	0
10	38969598	.	A	C	22	23	45	0	2	47	0	0
10	38969629	.	C	T	23	19	42	0	3	45	0	0
10	38969685	.	A	G	21	21	42	0	6	48	0	0
10	38969778	.	C	T	22	16	38	1	2	41	0	0
10	39011484	.	C	T	13	21	34	0	1	35	0	0
10	39086382	.	C	T	45	21	66	0	1	67	0	0
10	39086981	.	G	A	33	22	55	0	1	56	0	0
10	39087391	.	A	G	36	1	37	2	27	66	0	0
10	39087625	.	T	A	35	25	60	0	2	62	0	0
10	39087659	.	T	A	22	28	50	0	3	53	0	0
10	39102672	.	G	C	8	3	11	0	1	12	0	0
10	39102776	.	T	C	10	5	15	0	1	16	0	0
10	39110452	.	G	C	4	6	10	0	0	10	0	0
10	39115595	.	G	T	7	8	15	0	0	15	0	0
10	39115596	.	T	C	7	7	14	0	1	15	0	0
10	39120132	.	T	C	10	13	23	0	0	23	0	0
10	39130460	.	C	T	40	29	69	0	4	73	0	0
10	39140741	.	T	C	5	3	8	0	1	9	0	0
10	39170798	.	A	C	3	2	5	0	0	5	0	0
10	39175139	.	T	C	3	3	6	0	0	6	0	0
10	39175418	.	T	C	1	4	5	0	0	5	0	0
10	39175452	.	C	T	2	4	6	0	0	6	0	0
10	39175475	.	G	A	1	3	4	0	3	7	0	0
10	39177816	.	T	C	4	4	8	0	0	8	0	0
10	39179992	.	G	C	7	4	11	0	1	12	0	0
10	39182173	.	A	G	9	4	13	0	0	13	0	0
10	39182310	.	C	A	9	5	14	0	1	15	0	0
10	39182342	.	A	T	9	5	14	0	0	14	0	0
10	39182401	.	C	A	7	5	12	0	0	12	0	0
10	39182497	.	C	T	9	7	16	0	2	18	0	0
10	39182602	.	G	A	3	6	9	0	6	15	0	0
10	39182640	.	T	A	7	4	11	0	1	12	0	0
10	39182659	.	G	T	6	2	8	0	1	9	0	0
10	39199639	.	G	A	0	2	2	0	2	4	0	0
10	39205021	.	C	T	1	7	8	0	0	8	0	0
10	39205256	.	C	G	3	7	10	0	0	10	0	0
10	39206945	.	A	G	7	3	10	0	0	11	1	0
10	39206990	.	A	T	9	2	11	0	0	11	0	0
10	39207104	.	C	A	1	4	5	0	0	5	0	0
10	39207114	.	C	A	2	3	5	0	0	5	0	0
10	39207708	.	A	T	1	2	3	0	1	4	0	0
10	39216625	.	C	T	8	6	14	0	0	14	0	0
10	39219390	.	T	C	11	5	16	0	2	18	0	0
10	39219540	.	T	A	17	9	26	0	1	27	0	0
10	39222134	.	A	C	16	10	26	0	1	27	0	0
10	39222182	.	A	G	15	14	29	0	1	30	0	0
10	39225504	.	A	C	13	9	22	0	1	23	0	0
10	39225555	.	T	C	13	14	27	0	3	30	0	0
10	39231387	.	G	A	20	18	38	0	0	38	0	0
10	39259976	.	G	A	0	2	2	0	2	4	0	0
10	39265766	.	G	A	2	2	4	0	0	4	0	0
10	39266350	.	G	T	0	3	3	0	2	5	0	0
10	39266422	.	C	T	1	1	2	0	1	3	0	0
10	39266702	.	A	G	6	0	6	0	4	10	0	0
10	39277087	.	C	G	2	3	5	0	0	5	0	0
10	39284032	.	A	G	1	3	4	0	0	4	0	0
10	39284092	.	T	G	2	0	2	0	2	4	0	0
10	39284104	.	C	G	1	0	1	0	3	4	0	0
10	39286967	.	C	T	1	4	5	0	0	5	0	0
10	39287100	.	C	T	4	5	9	0	0	9	0	0
10	39289006	.	A	G	3	1	4	1	3	8	0	0
10	39289036	.	A	C	4	3	7	0	0	7	0	0
10	39293705	.	A	G	2	5	7	0	0	7	0	0
10	39293707	.	A	T	2	5	7	0	0	7	0	0
10	39304424	.	A	G	1	2	3	0	0	3	0	0
10	39306709	.	G	A	2	2	4	0	0	4	0	0
10	39306745	.	G	T	2	2	4	0	0	4	0	0
10	39904774	.	G	A	2	6	8	0	9	17	0	0
10	39904780	.	C	T	8	7	15	0	1	16	0	0
10	39904851	.	A	T	6	9	15	0	0	15	0	0
10	39904915	.	A	G	11	10	21	0	0	21	0	0
10	39904966	.	T	C	4	8	12	0	1	13	0	0
10	39905085	.	A	T	7	3	10	0	2	12	0	0
10	39905089	.	T	G	4	5	9	0	1	10	0	0
10	40086093	.	A	G	1	0	1	0	1	2	0	0
10	40086099	.	G	A	1	2	3	0	0	3	0	0
10	40089829	.	C	A	1	2	3	0	0	3	0	0
10	40089838	.	C	T	1	1	2	0	1	3	0	0
10	40089941	.	T	C	2	2	4	0	0	4	0	0
10	40097252	.	C	A	3	2	5	0	0	5	0	0
10	40109378	.	C	T	4	2	6	0	0	6	0	0
10	40109439	.	G	A	1	3	4	0	4	8	0	0
10	40110599	.	G	A	0	2	2	0	2	4	0	0
10	40110616	.	G	T	3	2	5	0	0	5	0	0
10	40110666	.	T	A	4	2	6	0	0	6	0	0
10	40110714	.	C	T	6	3	9	0	0	9	0	0
10	40110726	.	C	A	6	3	9	0	0	9	0	0
10	40111412	.	G	A	4	3	7	0	0	7	0	0
10	40111549	.	T	C	6	2	8	0	0	8	0	0
10	40111732	.	C	T	3	3	6	0	0	6	0	0
10	40111809	.	C	T	5	2	7	0	0	7	0	0
10	40111904	.	G	T	3	3	6	0	0	6	0	0
10	40111952	.	C	T	2	2	4	0	0	4	0	0
10	40111964	.	C	A	3	2	5	0	1	6	0	0
10	40112096	.	C	A	3	4	7	0	1	8	0	0
10	40112121	.	A	G	4	2	6	0	0	6	0	0
10	40112157	.	G	A	3	8	11	0	0	11	0	0
10	40112159	.	T	A	3	8	11	0	0	11	0	0
10	40112347	.	A	T	4	7	11	0	2	13	0	0
10	40112476	.	T	A	3	3	6	0	0	6	0	0
10	40112638	.	C	T	4	7	11	0	1	12	0	0
10	40112708	.	A	G	5	2	7	0	0	7	0	0
10	40113032	.	T	A	1	5	6	0	1	7	0	0
10	40113045	.	A	G	1	2	3	0	1	4	0	0
10	40113113	.	C	G	3	4	7	0	1	8	0	0
10	40113161	.	C	A	5	4	9	0	0	9	0	0
10	40113197	.	G	A	0	5	5	0	3	8	0	0
10	40113408	.	A	G	4	6	10	0	0	10	0	0
10	40113446	.	T	C	3	4	7	0	0	7	0	0
10	40113508	.	A	T	5	2	7	0	0	7	0	0
10	40113592	.	G	A	3	3	6	0	0	6	0	0
10	40113713	.	A	G	1	2	3	0	0	3	0	0
10	40204845	.	G	A	0	2	2	0	1	3	0	0
10	40236068	.	A	G	3	0	3	0	8	11	0	0
10	40262052	.	T	C	3	2	5	0	0	5	0	0
10	40266160	.	A	G	3	4	7	0	0	7	0	0
10	40266259	.	A	C	2	4	6	0	0	6	0	0
10	40274411	.	G	A	3	5	8	0	0	8	0	0
10	40274541	.	G	A	1	6	7	0	6	13	0	0
10	40274963	.	A	C	2	3	5	0	1	6	0	0
10	40275055	.	G	C	0	4	4	0	3	7	0	0
10	40275070	.	T	G	3	3	6	0	0	6	0	0
10	40275158	.	G	A	0	4	4	0	3	7	0	0
10	40303924	.	G	C	7	3	10	0	0	10	0	0
10	40303980	.	A	G	2	3	5	0	1	6	0	0
10	40307553	.	T	C	3	3	6	0	0	6	0	0
10	40307622	.	C	T	2	2	4	0	0	4	0	0
10	40314175	.	A	C	4	7	11	0	0	11	0	0
10	40314177	.	A	C	5	7	12	0	0	12	0	0
10	40316791	.	G	T	0	3	3	0	3	6	0	0
10	40317095	.	G	T	9	3	12	0	1	13	0	0
10	40317190	.	T	G	6	2	8	0	0	8	0	0
10	40317192	.	G	T	4	2	6	0	1	7	0	0
10	40317285	.	A	T	4	3	7	0	0	7	0	0
10	40317323	.	A	G	1	0	1	0	3	4	0	0
10	40822252	.	C	T	1	9	10	0	12	22	0	0
10	40825192	.	T	C	11	9	20	0	0	20	0	0
10	40826436	.	A	G	4	2	6	0	1	7	0	0
10	40826494	.	A	G	2	2	4	0	0	4	0	0
10	40826516	.	A	G	5	4	9	0	0	9	0	0
10	40826589	.	C	T	13	7	20	0	0	20	0	0
10	40826590	.	A	G	12	7	19	0	0	19	0	0
10	40859633	.	C	T	6	2	8	0	0	8	0	0
10	40859647	.	A	C	2	3	5	0	1	6	0	0
10	40859722	.	A	G	3	2	5	0	1	6	0	0
10	40859885	.	A	G	9	5	14	0	0	14	0	0
10	40859968	.	T	C	6	7	13	0	2	15	0	0
10	40861563	.	C	A	7	6	13	0	0	13	0	0
10	40861701	.	G	T	5	3	8	0	1	9	0	0
10	40861785	.	G	A	3	2	5	0	0	5	0	0
10	40866244	.	T	C	2	0	2	0	5	7	0	0
10	40872771	.	G	A	2	2	4	0	0	4	0	0
10	40872816	.	A	G	1	2	3	0	0	3	0	0
10	41089380	.	A	G	11	7	18	0	4	22	0	0
10	41099458	.	A	G	6	3	9	0	0	9	0	0
10	41107066	.	A	T	6	8	14	0	1	15	0	0
10	41111804	.	C	A	5	4	9	0	1	10	0	0
10	41111851	.	C	T	0	4	4	0	3	7	0	0
10	41111877	.	G	A	3	4	7	0	0	7	0	0
10	41111975	.	T	C	3	7	10	0	0	10	0	0
10	41111993	.	C	T	0	5	5	0	1	6	0	0
10	41115360	.	C	A	5	3	8	0	0	8	0	0
10	41121590	.	C	A	5	3	8	0	1	9	0	0
10	41136356	.	G	A	1	3	4	0	0	4	0	0
10	41136365	.	G	A	1	4	5	0	0	5	0	0
10	41192623	.	C	A	4	8	12	0	0	12	0	0
10	41192675	.	C	T	1	4	5	0	0	5	0	0
10	41260558	.	T	C	2	2	4	0	0	4	0	0
10	41279962	.	T	C	3	6	9	0	0	9	0	0
10	41362763	.	C	G	18	16	34	0	0	34	0	0
10	41362839	.	A	G	12	19	31	1	1	33	0	0
10	41362986	.	T	A	13	20	33	0	4	37	0	0
10	41368569	.	G	A	11	16	27	0	0	27	0	0
10	41368626	.	C	T	1	16	17	0	13	30	0	0
10	41373231	.	G	A	9	6	15	0	0	15	0	0
10	41376895	.	G	A	5	5	10	0	0	10	0	0
10	41379918	.	G	C	11	8	19	0	3	22	0	0
10	41379992	.	G	A	7	7	14	0	1	15	0	0
10	41380079	.	G	C	12	0	12	0	12	24	0	0
10	41397380	.	G	T	7	7	14	0	1	15	0	0
10	41397404	.	G	A	5	8	13	0	2	15	0	0
10	41397443	.	G	A	6	7	13	0	0	13	0	0
10	41397533	.	A	G	5	8	13	0	0	13	0	0
10	41397712	.	A	G	4	3	7	0	0	7	0	0
10	41399919	.	G	A	9	10	19	0	0	19	0	0
10	41399968	.	G	T	8	14	22	0	0	22	0	0
10	41409470	.	T	A	3	2	5	0	0	5	0	0
10	41409578	.	T	A	2	2	4	0	0	4	0	0
10	41409781	.	C	T	1	1	2	0	1	3	0	0
10	41419075	.	C	T	2	3	5	0	0	5	0	0
10	41450176	.	A	T	2	2	4	0	0	4	0	0
10	41605886	.	C	T	2	2	4	0	0	4	0	0
10	41607357	.	C	T	6	2	8	0	0	8	0	0
10	41607492	.	A	G	2	0	2	0	5	7	0	0
10	41607787	.	A	C	4	2	6	0	0	6	0	0
10	41607939	.	C	A	11	6	17	0	0	17	0	0
10	41607966	.	T	C	6	5	11	0	0	11	0	0
10	41608254	.	A	C	2	3	5	1	2	8	0	0
10	41608320	.	T	C	4	4	8	1	1	10	0	0
10	41608379	.	G	C	4	2	6	0	0	6	0	0
10	41608410	.	A	C	3	3	6	0	0	6	0	0
10	41608425	.	T	A	2	4	6	0	1	7	0	0
10	41608479	.	G	A	7	6	13	0	2	15	0	0
10	41608513	.	A	G	6	1	7	0	7	14	0	0
10	41608561	.	A	T	7	6	13	0	0	13	0	0
10	41765973	.	C	T	4	4	8	0	0	8	0	0
10	41766022	.	A	G	6	0	6	0	5	11	0	0
10	41816988	.	C	T	3	5	8	0	1	9	0	0
10	41816991	.	G	A	4	5	9	0	0	9	0	0
10	41817054	.	T	C	3	5	8	0	0	8	0	0
10	41817094	.	C	A	5	2	7	0	0	7	0	0
10	41830403	.	G	A	15	15	30	0	0	30	0	0
10	41830435	.	C	T	17	19	36	0	2	38	0	0
10	41832092	.	C	A	6	10	16	0	0	16	0	0
10	41834276	.	G	T	13	13	26	0	2	28	0	0
10	41834300	.	C	T	12	11	23	0	1	24	0	0
10	41835199	.	C	T	9	5	14	0	1	15	0	0
10	41835283	.	G	T	10	7	17	0	0	17	0	0
10	41841119	.	G	A	9	11	20	1	3	24	0	0
10	41841178	.	G	T	8	11	19	0	0	19	0	0
10	41841214	.	G	C	10	9	19	0	1	20	0	0
10	41846770	.	A	G	4	4	8	0	0	8	0	0
10	41865722	.	G	A	5	7	12	0	1	13	0	0
10	41921298	.	G	T	1	1	2	0	1	3	0	0
10	41921320	.	A	T	1	3	4	0	0	4	0	0
10	41983482	.	A	C	3	4	7	0	0	7	0	0
10	41984865	.	G	C	2	3	5	0	0	5	0	0
10	41984966	.	G	A	1	2	3	0	0	3	0	0
10	41988149	.	C	A	1	1	2	0	1	3	0	0
10	41995506	.	G	C	1	3	4	0	0	4	0	0
10	41995555	.	C	T	2	2	4	0	1	5	0	0
10	41995573	.	C	T	2	4	6	0	1	7	0	0
10	41995624	.	A	G	2	2	4	0	0	4	0	0
10	42002429	.	G	A	0	3	3	0	5	8	0	0
10	42006930	.	C	A	1	2	3	0	0	3	0	0
10	42010719	.	A	T	2	5	7	0	0	7	0	0
10	42011054	.	T	C	3	1	4	0	0	4	0	0
10	42011060	.	G	T	4	2	6	0	0	6	0	0
10	42011128	.	T	C	4	2	6	0	0	6	0	0
10	42011197	.	G	A	0	2	2	0	4	6	0	0
10	42017620	.	C	T	3	6	9	0	0	9	0	0
10	42019966	.	A	C	5	3	8	0	1	9	0	0
10	42020205	.	T	A	4	8	12	0	1	13	0	0
10	42020451	.	C	T	9	4	13	0	0	13	0	0
10	42020565	.	C	T	9	6	15	0	0	15	0	0
10	42020592	.	G	T	3	7	10	0	1	11	0	0
10	42021194	.	A	G	1	6	7	0	0	7	0	0
10	42021279	.	A	G	8	4	12	0	0	12	0	0
10	42021321	.	G	A	5	6	11	0	0	11	0	0
10	42021384	.	T	C	9	5	14	0	1	15	0	0
10	42021485	.	A	T	5	6	11	0	3	14	0	0
10	42021611	.	C	A	6	5	11	0	1	12	0	0
10	42022425	.	A	G	7	1	8	0	3	11	0	0
10	42030956	.	C	T	5	4	9	0	0	9	0	0
10	42031279	.	C	T	0	2	2	0	4	6	0	0
10	42036689	.	G	T	3	2	5	0	0	5	0	0
10	42039072	.	A	C	2	4	6	0	0	6	0	0
10	42044272	.	C	T	1	3	4	0	1	5	0	0
10	42044278	.	A	G	2	2	4	0	2	6	0	0
10	42044409	.	A	G	9	14	23	0	2	25	0	0
10	42044480	.	G	A	17	16	33	0	2	35	0	0
10	42044859	.	G	A	22	10	32	1	2	35	0	0
10	42045041	.	G	C	17	16	33	0	0	33	0	0
10	42045254	.	C	T	0	8	8	0	7	15	0	0
10	42045300	.	G	C	9	8	17	0	0	17	0	0
10	42045370	.	G	A	5	11	16	0	0	16	0	0
10	42045578	.	C	T	2	3	5	0	2	7	0	0
10	42050758	.	C	T	2	2	4	0	0	4	0	0
10	42090214	.	A	G	7	15	22	0	0	22	0	0
10	42090222	.	A	G	9	15	24	0	1	25	0	0
10	42090315	.	T	C	15	9	24	0	2	26	0	0
10	42093928	.	A	G	11	14	25	0	1	26	0	0
10	42101122	.	A	G	4	6	10	0	0	10	0	0
10	42104371	.	C	T	1	5	6	0	5	11	0	0
10	42105921	.	C	T	5	3	8	0	0	8	0	0
10	42107853	.	C	T	2	2	4	0	0	4	0	0
10	42107884	.	C	T	0	2	2	0	1	3	0	0
10	42108029	.	G	A	2	2	4	0	0	4	0	0
10	42108077	.	T	A	2	2	4	0	0	4	0	0
10	42111610	.	A	T	3	5	8	0	2	10	0	0
10	42111669	.	C	A	12	7	19	0	2	21	0	0
10	42111673	.	G	A	12	8	20	0	0	20	0	0
10	42111883	.	C	T	1	2	3	0	1	4	0	0
10	42111955	.	G	A	4	6	10	0	0	10	0	0
10	42112010	.	A	G	1	3	4	0	2	6	0	0
10	42112019	.	A	T	2	4	6	0	0	6	0	0
10	42112227	.	G	T	15	7	22	0	0	22	0	0
10	42114366	.	G	A	15	5	20	0	1	21	0	0
10	42119810	.	C	T	3	6	9	0	1	10	0	0
10	42119816	.	A	G	6	3	9	0	0	9	0	0
10	42123309	.	C	G	2	6	8	0	0	8	0	0
10	42123334	.	T	C	1	0	1	0	11	12	0	0
10	42123388	.	A	G	7	4	11	0	0	11	0	0
10	42125549	.	C	T	4	8	12	0	0	12	0	0
10	42131297	.	A	T	8	7	15	0	0	15	0	0
10	42134629	.	C	T	4	4	8	0	0	8	0	0
10	42134662	.	T	A	3	3	6	0	0	6	0	0
10	42134962	.	C	T	1	2	3	0	0	3	0	0
10	42135035	.	C	T	3	4	7	0	1	8	0	0
10	42135216	.	T	C	2	2	4	0	0	4	0	0
10	42135296	.	A	G	4	8	12	0	0	12	0	0
10	42135339	.	G	C	4	3	7	0	0	7	0	0
10	42136645	.	C	T	0	3	3	0	1	4	0	0
10	42136663	.	T	C	2	0	2	0	3	5	0	0
10	42137050	.	G	C	1	5	6	0	0	6	0	0
10	42137252	.	T	C	3	4	7	0	0	7	0	0
10	42143434	.	T	A	1	2	3	0	0	3	0	0
10	42196374	.	C	T	0	2	2	0	13	15	0	0
10	42196404	.	T	C	8	0	8	0	9	17	0	0
10	42196524	.	A	G	11	9	20	0	0	20	0	0
10	42199981	.	C	T	2	3	5	0	1	6	0	0
10	42378334	.	A	T	39	32	71	0	3	74	0	0
10	42501067	.	A	G	14	7	21	0	0	21	0	0
10	42501175	.	T	A	13	7	20	0	0	20	0	0
10	42501365	.	A	G	13	21	34	0	1	35	0	0
10	42505845	.	T	C	10	10	20	0	0	20	0	0
10	42507081	.	T	C	12	10	22	0	2	24	0	0
10	42507120	.	T	C	8	8	16	0	0	16	0	0
10	42507141	.	A	G	4	5	9	0	2	11	0	0
10	42519641	.	C	T	7	14	21	0	1	23	1	0
10	42522016	.	T	C	12	7	19	0	0	19	0	0
10	42526213	.	C	T	13	9	22	0	1	23	0	0
10	42531713	.	C	T	15	11	26	0	1	27	0	0
10	42539630	.	C	T	30	31	61	0	0	61	0	0
10	42539849	.	C	T	22	17	39	0	2	41	0	0
10	42539955	.	T	C	19	16	35	2	0	37	0	0
10	42540132	.	A	T	24	11	35	0	0	35	0	0
10	42540172	.	A	C	15	18	33	0	0	33	0	0
10	42540726	.	A	G	12	3	15	0	0	15	0	0
10	42542568	.	A	C	3	5	8	0	0	8	0	0
10	42542883	.	C	T	7	9	16	0	1	17	0	0
10	42548171	.	T	G	11	0	11	0	6	17	0	0
10	42548210	.	A	T	7	6	13	0	1	14	0	0
10	42548213	.	A	G	8	0	8	0	7	15	0	0
10	42549515	.	A	G	6	0	6	0	5	11	0	0
10	42550828	.	C	T	4	3	7	0	0	7	0	0
10	42555504	.	A	G	3	0	3	0	4	7	0	0
10	42555543	.	G	A	0	5	5	0	5	10	0	0
10	42555577	.	C	A	6	2	8	0	0	8	0	0
10	42555578	.	G	A	0	2	2	0	6	8	0	0
10	42555728	.	G	A	2	3	5	0	5	10	0	0
10	42555732	.	G	T	5	3	8	0	2	10	0	0
10	42656885	.	A	G	2	2	4	0	0	4	0	0
10	42694552	.	C	A	5	8	13	0	2	15	0	0
10	42700932	.	C	T	7	4	11	0	0	11	0	0
10	42701129	.	A	G	2	0	2	0	7	9	0	0
10	42701216	.	C	T	5	7	12	0	0	12	0	0
10	42704608	.	T	G	10	5	15	0	0	15	0	0
10	42704622	.	A	T	11	7	18	0	0	18	0	0
10	42704848	.	T	C	6	6	12	0	0	12	0	0
10	42704929	.	C	T	4	5	9	0	1	10	0	0
10	42708132	.	C	T	7	2	9	0	0	9	0	0
10	42709610	.	T	C	7	5	12	0	0	12	0	0
10	42709634	.	T	C	6	4	10	0	1	11	0	0
10	42715679	.	C	T	4	15	19	6	13	39	1	0
10	42715688	.	T	C	5	20	25	8	7	40	0	0
10	42716271	.	T	C	5	4	9	0	0	9	0	0
10	42716278	.	T	G	6	0	6	0	4	10	0	0
10	42716398	.	G	C	0	3	3	0	1	4	0	0
10	42733678	.	A	G	6	5	11	0	0	11	0	0
10	42738132	.	T	A	7	4	11	0	0	11	0	0
10	42739938	.	C	T	3	9	12	2	1	15	0	0
10	42740302	.	T	A	17	17	34	0	0	34	0	0
10	42741347	.	T	G	17	14	31	0	9	40	0	0
10	42741417	.	T	A	18	22	40	0	3	43	0	0
10	42741519	.	G	T	28	26	54	0	2	56	0	0
10	42741528	.	G	T	26	22	48	0	4	52	0	0
10	42741840	.	T	A	23	24	47	1	3	51	0	0
10	42741872	.	A	G	18	21	39	0	3	42	0	0
10	42741918	.	C	T	23	14	37	0	2	39	0	0
10	42741938	.	A	C	13	0	13	0	27	40	0	0
10	42742140	.	T	A	4	5	9	0	2	11	0	0
10	42742198	.	G	A	2	2	4	0	0	4	0	0
10	42742318	.	T	A	14	2	16	0	1	17	0	0
10	42742472	.	C	G	18	9	27	2	0	29	0	0
10	42742544	.	T	C	9	11	20	0	1	21	0	0
10	42742560	.	T	C	16	9	25	0	1	26	0	0
10	42742835	.	C	T	12	4	16	0	1	17	0	0
10	42742891	.	G	A	4	2	6	0	1	7	0	0
10	42743666	.	G	T	6	5	11	29	1	41	0	0
10	42744720	.	G	C	9	10	19	0	0	19	0	0
10	42745018	.	T	A	1	4	5	0	0	5	0	0
10	42745151	.	C	T	10	7	17	0	2	19	0	0
10	42748084	.	A	T	15	9	24	0	0	24	0	0
10	42748096	.	A	G	9	9	18	0	1	19	0	0
10	42748120	.	A	G	11	6	17	0	0	17	0	0
10	42775877	.	A	C	5	0	5	0	5	10	0	0
10	42775891	.	C	A	6	5	11	0	1	12	0	0
10	42876681	.	C	T	0	3	3	0	3	6	0	0
10	42899020	.	C	T	2	6	8	0	1	9	0	0
10	42901228	.	C	A	2	3	5	0	0	5	0	0
10	42930776	.	T	C	7	0	7	0	7	14	0	0
10	42930781	.	T	C	8	1	9	0	7	16	0	0
10	42930814	.	T	C	12	8	20	0	0	20	0	0
10	42930828	.	T	C	6	17	23	0	0	23	0	0
10	42930933	.	T	C	4	7	11	0	0	11	0	0
10	42931087	.	A	G	8	4	12	0	1	13	0	0
10	42931140	.	T	C	4	5	9	0	0	9	0	0
10	42931218	.	T	C	4	3	7	0	1	8	0	0
10	42931315	.	T	A	9	3	12	0	0	12	0	0
10	42935346	.	C	T	0	12	12	0	7	19	0	0
10	42992877	.	T	C	2	3	5	0	1	6	0	0
10	42992977	.	T	C	5	0	5	0	3	8	0	0
10	43044188	.	G	T	1	5	6	0	0	6	0	0
10	43057598	.	C	T	1	2	3	0	0	3	0	0
10	43073044	.	C	T	4	2	6	0	0	6	0	0
10	43073049	.	C	T	2	4	6	0	1	7	0	0
10	43126994	.	T	C	4	2	6	0	0	6	0	0
10	43127066	.	T	G	6	0	6	0	3	9	0	0
10	43151516	.	G	A	1	2	3	0	4	7	0	0
10	43157401	.	C	G	4	7	11	0	1	12	0	0
10	43183798	.	A	T	2	3	5	0	0	5	0	0
10	43231139	.	G	A	1	2	3	0	0	3	0	0
10	43231972	.	G	A	0	1	1	0	4	5	0	0
10	43232065	.	A	T	2	3	5	0	0	5	0	0
10	43232272	.	C	T	2	2	4	0	0	4	0	0
10	43232315	.	A	C	3	3	6	0	0	6	0	0
10	43232668	.	A	C	1	2	3	0	0	3	0	0
10	43232829	.	A	G	1	2	3	0	1	4	0	0
10	43259766	.	C	T	2	3	5	1	0	6	0	0
10	43270445	.	G	A	3	2	5	0	0	5	0	0
10	43372493	.	G	A	4	4	8	0	0	8	0	0
10	43375407	.	T	A	1	4	5	0	0	5	0	0
10	43375468	.	G	A	4	2	6	0	0	6	0	0
10	43395095	.	T	C	2	0	2	0	4	6	0	0
10	43450144	.	C	T	3	3	6	0	0	6	0	0
10	43450145	.	T	C	3	3	6	0	0	6	0	0
10	43545434	.	G	C	11	8	19	0	2	21	0	0
10	43545446	.	T	A	12	10	22	0	0	22	0	0
10	43545577	.	C	A	1	9	10	0	2	13	1	0
10	43546593	.	C	T	4	4	8	3	2	13	0	0
10	43547763	.	G	A	4	2	6	0	0	6	0	0
10	43547905	.	G	A	4	2	6	1	0	7	0	0
10	43547937	.	A	G	5	2	7	1	0	8	0	0
10	43548297	.	G	A	3	3	6	0	0	6	0	0
10	43548344	.	T	C	1	5	6	0	0	6	0	0
10	43548352	.	C	T	1	5	6	0	0	6	0	0
10	43548745	.	T	C	2	4	6	0	0	6	0	0
10	43548839	.	G	A	2	2	4	0	0	4	0	0
10	43549502	.	A	C	1	0	1	0	3	4	0	0
10	43549559	.	G	C	1	4	5	0	0	5	0	0
10	43549798	.	G	A	1	2	3	0	0	3	0	0
10	43999640	.	G	T	2	5	7	0	0	7	0	0
10	43999718	.	T	A	5	4	9	0	2	11	0	0
10	44002836	.	G	A	13	12	25	0	2	27	0	0
10	44146313	.	C	T	7	8	15	0	0	15	0	0
10	44155428	.	C	T	7	9	16	0	0	16	0	0
10	44170593	.	G	T	14	9	23	0	1	24	0	0
10	44180299	.	C	T	18	10	28	0	1	29	0	0
10	44189322	.	G	A	13	13	26	0	3	29	0	0
10	44269577	.	T	G	2	2	4	0	0	4	0	0
10	44314569	.	C	T	8	7	15	0	0	15	0	0
10	44314579	.	A	G	11	7	18	0	0	18	0	0
10	44320823	.	G	C	7	6	13	0	0	13	0	0
10	44337487	.	C	G	2	5	7	0	0	7	0	0
10	44340944	.	C	T	4	5	9	0	1	10	0	0
10	44345005	.	C	T	0	3	3	0	3	6	0	0
10	44348351	.	G	A	1	5	6	0	0	6	0	0
10	44353914	.	G	A	4	4	8	0	0	8	0	0
10	44354053	.	G	C	1	3	4	0	2	6	0	0
10	44363242	.	G	T	6	5	11	0	1	12	0	0
10	44364604	.	A	T	14	7	21	0	1	22	0	0
10	44364610	.	C	T	15	7	22	0	1	23	0	0
10	44371710	.	G	T	1	12	13	0	13	26	0	0
10	44373367	.	T	C	1	4	5	0	0	5	0	0
10	44375785	.	G	A	0	8	8	0	6	14	0	0
10	44410082	.	C	T	4	2	6	0	1	7	0	0
10	44410088	.	G	A	1	5	6	0	1	7	0	0
10	44437145	.	T	C	18	15	33	0	0	33	0	0
10	44465477	.	C	T	0	9	9	0	2	11	0	0
10	44466844	.	G	A	3	2	5	0	1	6	0	0
10	44506313	.	C	T	0	3	3	0	1	4	0	0
10	44513270	.	T	C	2	1	3	0	5	8	0	0
10	44513307	.	T	C	6	5	11	0	0	11	0	0
10	44513402	.	T	C	4	0	4	0	9	13	0	0
10	44513421	.	C	T	0	7	7	0	5	12	0	0
10	44515927	.	T	C	3	3	6	0	1	7	0	0
10	44516001	.	C	T	1	3	4	0	7	11	0	0
10	44516270	.	G	T	1	4	5	0	0	5	0	0
10	44516907	.	G	T	3	2	5	0	0	5	0	0
10	44516908	.	T	C	4	0	4	0	2	6	0	0
10	44516955	.	C	T	5	4	9	0	0	9	0	0
10	44517092	.	G	A	2	2	4	0	0	4	0	0
10	44581983	.	C	G	5	3	8	0	0	8	0	0
10	44640688	.	A	C	4	4	8	0	0	8	0	0
10	44640700	.	C	T	3	4	7	0	0	7	0	0
10	44640725	.	C	A	3	3	6	0	0	6	0	0
10	44640742	.	G	A	0	3	3	0	4	7	0	0
10	44641025	.	G	A	2	4	6	0	1	7	0	0
10	44648115	.	G	T	1	3	4	0	5	9	0	0
10	44650913	.	G	A	0	6	6	0	11	17	0	0
10	44652561	.	G	A	1	7	8	0	9	17	0	0
10	44656821	.	C	G	12	10	22	0	1	23	0	0
10	44656863	.	C	T	9	10	19	0	0	19	0	0
10	44656926	.	C	T	9	7	16	0	2	18	0	0
10	44659668	.	A	G	7	8	15	0	0	15	0	0
10	44663082	.	A	G	9	13	22	1	2	25	0	0
10	44665345	.	G	T	0	11	11	0	11	22	0	0
10	44665536	.	A	T	9	8	17	0	0	17	0	0
10	44665620	.	C	T	11	12	23	0	0	23	0	0
10	44667125	.	T	C	22	9	31	0	0	31	0	0
10	44669263	.	G	A	10	16	26	0	0	26	0	0
10	44669497	.	A	G	6	12	18	0	0	18	0	0
10	44670437	.	A	G	11	12	23	0	0	23	0	0
10	44671799	.	G	A	0	10	10	0	17	27	0	0
10	44671818	.	A	C	13	17	30	0	0	30	0	0
10	44672036	.	T	A	27	23	50	0	0	50	0	0
10	44672228	.	G	A	15	8	23	0	0	23	0	0
10	44692308	.	A	T	8	16	24	0	0	24	0	0
10	44692314	.	C	A	12	16	28	0	2	30	0	0
10	44693397	.	G	A	2	2	4	34	2	40	0	0
10	44693523	.	T	G	48	0	48	2	18	69	1	0
10	44693556	.	C	T	19	9	28	6	3	37	0	0
10	44693688	.	T	G	37	5	42	0	2	44	0	0
10	44693706	.	C	T	37	10	47	0	6	53	0	0
10	44693769	.	C	T	43	21	64	29	13	106	0	0
10	44693868	.	G	A	26	9	35	15	1	51	0	0
10	44694354	.	G	A	45	17	62	17	2	81	0	0
10	44738221	.	G	A	0	5	5	0	2	7	0	0
10	44738290	.	C	T	2	3	5	0	0	5	0	0
10	44900198	.	C	G	4	2	6	0	0	6	0	0
10	44900254	.	G	A	5	6	11	0	0	11	0	0
10	44900279	.	G	A	6	3	9	0	1	10	0	0
10	44900294	.	T	A	0	8	8	0	1	9	0	0
10	44900578	.	A	G	0	5	5	0	1	6	0	0
10	44900592	.	G	A	3	4	7	0	0	7	0	0
10	44900856	.	C	T	4	4	8	0	0	8	0	0
10	44900901	.	T	G	4	8	12	0	0	12	0	0
10	44905224	.	A	G	6	5	11	0	1	12	0	0
10	44914623	.	A	G	9	0	9	0	6	15	0	0
10	44914685	.	G	T	9	8	17	0	0	17	0	0
10	44914761	.	T	A	6	7	13	0	1	14	0	0
10	44941051	.	C	T	1	2	3	0	0	3	0	0
10	44979593	.	A	T	3	7	10	0	0	10	0	0
10	44979767	.	A	G	3	2	5	0	0	5	0	0
10	44979792	.	T	C	5	3	8	0	0	8	0	0
10	44980379	.	T	C	1	2	3	0	1	4	0	0
10	44980913	.	C	T	2	3	5	0	1	6	0	0
10	44989378	.	C	T	23	28	51	1	1	53	0	0
10	44989384	.	T	C	23	26	49	1	4	54	0	0
10	44990917	.	C	T	21	26	47	0	0	47	0	0
10	45055879	.	G	A	13	12	25	0	0	25	0	0
10	45055948	.	G	A	7	8	15	0	1	16	0	0
10	45059822	.	C	T	3	4	7	0	1	8	0	0
10	45064957	.	C	T	16	8	24	0	3	27	0	0
10	45099498	.	T	C	4	3	7	0	0	7	0	0
10	45099522	.	T	C	4	2	6	0	1	7	0	0
10	45105244	.	T	C	3	2	5	0	1	6	0	0
10	45170325	.	C	A	2	2	4	0	1	5	0	0
10	45179688	.	A	C	4	4	8	0	0	8	0	0
10	45180294	.	C	T	3	4	7	0	0	7	0	0
10	45180335	.	C	T	3	3	6	0	0	6	0	0
10	45203109	.	T	C	11	8	19	0	1	20	0	0
10	45203154	.	A	G	8	6	14	0	1	15	0	0
10	45203271	.	T	A	5	7	12	0	2	14	0	0
10	45203385	.	T	A	3	6	9	0	1	10	0	0
10	45203684	.	A	G	3	2	5	0	0	5	0	0
10	45203793	.	G	A	0	5	5	0	2	7	0	0
10	45203856	.	G	A	4	5	9	1	0	10	0	0
10	45204024	.	A	G	6	2	8	0	1	9	0	0
10	45204029	.	A	T	6	4	10	0	0	10	0	0
10	45204185	.	T	C	5	2	7	0	0	7	0	0
10	45204527	.	A	G	4	3	7	0	0	7	0	0
10	45204568	.	G	T	1	2	3	0	0	3	0	0
10	45204576	.	A	T	2	2	4	0	0	4	0	0
10	45204769	.	T	A	2	3	5	0	1	6	0	0
10	45204786	.	A	C	1	5	6	0	0	6	0	0
10	45205166	.	A	C	11	11	22	1	2	25	0	0
10	45205175	.	A	G	11	0	11	1	12	24	0	0
10	45205226	.	A	G	8	0	8	0	13	21	0	0
10	45205237	.	C	G	9	0	9	0	12	21	0	0
10	45205284	.	A	C	7	10	17	0	4	21	0	0
10	45205295	.	A	G	10	1	11	0	10	21	0	0
10	45205400	.	C	A	4	7	11	0	0	11	0	0
10	45205506	.	A	C	5	5	10	0	0	10	0	0
10	45205518	.	T	G	3	5	8	0	0	8	0	0
10	45205757	.	C	A	4	8	12	0	0	12	0	0
10	45205758	.	A	G	3	8	11	0	1	12	0	0
10	45206103	.	C	G	4	5	9	0	0	11	2	0
10	45206182	.	G	A	5	7	12	0	1	13	0	0
10	45206199	.	A	C	6	0	6	0	7	13	0	0
10	45206217	.	C	A	7	2	9	0	1	10	0	0
10	45206241	.	T	A	10	6	16	0	1	17	0	0
10	45206289	.	G	C	10	1	11	0	5	16	0	0
10	45206326	.	G	T	8	3	11	0	0	11	0	0
10	45206450	.	T	C	12	0	12	0	11	23	0	0
10	45206478	.	G	T	18	4	22	1	2	25	0	0
10	45208153	.	A	G	11	9	20	0	1	21	0	0
10	45208667	.	C	T	1	7	8	0	11	19	0	0
10	45208875	.	G	A	4	9	13	0	0	13	0	0
10	45208899	.	C	A	4	10	14	0	0	14	0	0
10	45213798	.	C	T	0	6	6	0	3	9	0	0
10	45248638	.	G	A	3	3	6	0	0	6	0	0
10	45313560	.	C	T	2	6	8	0	1	9	0	0
10	45313623	.	G	A	0	3	3	0	4	7	0	0
10	45313671	.	C	T	3	5	8	0	0	8	0	0
10	45322668	.	A	G	5	0	5	0	8	13	0	0
10	45325302	.	G	A	0	3	3	0	9	12	0	0
10	45334688	.	C	T	2	4	6	0	0	6	0	0
10	45336565	.	T	C	7	13	20	0	3	23	0	0
10	45340105	.	G	T	0	9	9	0	4	14	1	0
10	45340625	.	A	C	1	3	4	4	0	8	0	0
10	45340654	.	A	G	1	4	5	0	0	5	0	0
10	45340835	.	G	C	4	9	13	0	0	13	0	0
10	45340930	.	G	T	7	4	11	0	0	11	0	0
10	45341210	.	T	A	5	5	10	0	2	12	0	0
10	45341403	.	A	G	6	8	14	0	0	14	0	0
10	45341410	.	A	G	6	0	6	0	9	15	0	0
10	45341452	.	T	G	4	11	15	0	0	15	0	0
10	45341537	.	A	C	10	12	22	0	0	22	0	0
10	45341546	.	A	C	9	11	20	0	1	21	0	0
10	45341572	.	G	C	0	13	13	0	10	23	0	0
10	45341596	.	C	T	8	9	17	0	1	18	0	0
10	45341762	.	A	T	4	7	11	0	3	14	0	0
10	45351037	.	C	T	31	39	70	0	5	75	0	0
10	45352231	.	C	T	15	15	30	0	8	38	0	0
10	45375714	.	G	T	18	6	24	0	2	26	0	0
10	45375732	.	C	T	16	6	22	0	1	23	0	0
11	126334	.	G	A	23	14	37	0	2	39	0	0
11	126595	.	A	T	14	21	35	0	4	39	0	0
11	127139	.	G	A	15	15	30	0	0	30	0	0
11	158688	.	C	T	1	4	5	0	0	5	0	0
11	185396	.	C	T	0	2	2	0	9	11	0	0
11	185624	.	T	A	16	21	37	0	0	37	0	0
11	185678	.	G	A	13	15	28	0	0	28	0	0
11	185775	.	C	T	1	23	24	0	12	36	0	0
11	185890	.	A	G	12	22	34	0	0	34	0	0
11	185902	.	A	G	15	18	33	0	1	34	0	0
11	186235	.	G	A	10	11	21	0	0	21	0	0
11	186526	.	A	T	3	8	11	0	0	11	0	0
11	186580	.	G	A	14	5	19	0	1	20	0	0
11	186745	.	G	T	8	14	22	0	0	22	0	0
11	186798	.	T	G	9	18	27	0	0	27	0	0
11	186939	.	A	G	5	23	28	0	2	30	0	0
11	187022	.	C	A	7	17	24	0	2	26	0	0
11	187104	.	T	A	13	20	33	0	2	35	0	0
11	187399	.	A	C	13	13	26	0	1	27	0	0
11	221929	.	T	C	28	0	28	0	12	40	0	0
11	222488	.	C	G	13	7	20	0	0	21	1	0
11	222722	.	C	T	1	5	6	0	14	20	0	0
11	222729	.	C	T	0	7	7	0	12	19	0	0
11	222776	.	C	T	11	7	18	0	0	18	0	0
11	222787	.	A	G	9	7	16	0	1	17	0	0
11	223319	.	G	A	8	9	17	0	1	18	0	0
11	223806	.	A	G	15	15	30	0	0	30	0	0
11	233672	.	A	T	12	5	17	0	0	17	0	0
11	233674	.	G	A	12	4	16	0	1	17	0	0
11	236437	.	C	T	5	5	10	0	2	12	0	0
11	236515	.	T	C	1	6	7	0	4	11	0	0
11	236551	.	G	A	5	5	10	0	0	10	0	0
11	236602	.	A	C	5	0	5	0	5	10	0	0
11	260909	.	G	A	16	3	19	1	8	28	0	0
11	265097	.	T	G	11	15	26	0	1	27	0	0
11	265404	.	G	A	11	24	35	0	1	36	0	0
11	265497	.	C	T	3	12	15	0	13	28	0	0
11	265506	.	G	C	12	14	26	0	1	27	0	0
11	268887	.	G	A	3	8	11	0	0	11	0	0
11	270090	.	A	G	11	6	17	0	0	17	0	0
11	281887	.	A	T	4	5	9	0	1	10	0	0
11	281961	.	A	G	2	5	7	0	0	7	0	0
11	282193	.	T	G	5	7	12	0	0	12	0	0
11	282279	.	A	T	15	15	30	0	0	30	0	0
11	282362	.	T	C	7	3	10	0	0	10	0	0
11	282546	.	G	T	11	7	18	0	0	18	0	0
11	282553	.	A	G	10	7	17	0	2	19	0	0
11	282602	.	T	G	9	6	15	0	0	15	0	0
11	284424	.	G	T	9	8	17	0	0	17	0	0
11	296453	.	T	A	9	4	13	0	1	14	0	0
11	304015	.	C	T	13	5	18	6	1	25	0	0
11	322076	.	G	A	0	10	10	0	5	15	0	0
11	539573	.	A	C	2	7	9	0	3	12	0	0
11	675382	.	G	C	32	24	56	0	2	58	0	0
11	676856	.	T	C	28	22	50	0	3	53	0	0
11	677100	.	A	G	14	10	24	0	4	28	0	0
11	677264	.	T	C	27	30	57	0	9	66	0	0
11	677341	.	T	C	25	21	46	0	4	50	0	0
11	682905	.	C	T	24	18	42	0	1	43	0	0
11	682926	.	A	G	26	18	44	0	0	44	0	0
11	682943	.	G	A	22	15	37	0	3	40	0	0
11	687501	.	G	A	31	9	40	0	0	40	0	0
11	718214	.	G	A	19	8	27	0	2	29	0	0
11	718404	.	A	C	8	10	18	0	0	18	0	0
11	762445	.	A	G	9	7	16	0	2	18	0	0
11	779785	.	C	A	6	4	10	0	0	10	0	0
11	780405	.	T	A	2	4	6	0	1	7	0	0
11	781714	.	G	A	1	6	7	0	5	12	0	0
11	813851	.	T	C	4	1	5	0	3	8	0	0
11	1095064	.	G	A	3	5	8	0	1	9	0	0
11	1118700	.	A	G	1	2	3	0	0	3	0	0
11	1148869	.	G	A	15	25	40	0	1	41	0	0
11	1148889	.	G	A	24	13	37	0	0	37	0	0
11	1149105	.	C	T	30	19	49	0	0	49	0	0
11	1149593	.	A	G	37	14	51	5	0	56	0	0
11	1149812	.	C	T	8	34	42	1	31	74	0	0
11	1163295	.	C	T	32	27	59	0	3	62	0	0
11	1165993	.	G	A	38	25	63	0	2	65	0	0
11	1166326	.	G	C	17	0	17	0	26	44	1	0
11	1177389	.	C	A	7	12	19	0	19	38	0	0
11	1183007	.	G	A	23	14	37	0	2	39	0	0
11	1183602	.	C	T	2	16	18	0	24	42	0	0
11	1183739	.	G	T	11	22	33	0	1	34	0	0
11	1198390	.	G	C	17	18	35	0	1	36	0	0
11	1198419	.	G	A	20	12	32	0	4	36	0	0
11	1198450	.	G	A	13	20	33	0	2	35	0	0
11	1198507	.	G	T	15	15	30	0	6	36	0	0
11	1203619	.	G	A	10	19	29	0	0	29	0	0
11	1221865	.	A	G	17	15	32	0	0	32	0	0
11	1222025	.	T	G	12	17	29	0	0	29	0	0
11	1337621	.	C	G	3	2	5	0	0	5	0	0
11	1339419	.	C	T	1	7	8	0	4	12	0	0
11	1341695	.	A	G	5	3	8	0	0	8	0	0
11	1342778	.	G	A	7	7	14	0	0	14	0	0
11	1342826	.	A	G	9	5	14	0	2	16	0	0
11	1348596	.	A	G	10	8	18	0	1	19	0	0
11	1348821	.	A	C	5	6	11	0	0	11	0	0
11	1351542	.	C	T	1	5	6	0	4	10	0	0
11	1351563	.	T	G	3	10	13	0	0	13	0	0
11	1351611	.	A	G	2	5	7	0	0	7	0	0
11	1356637	.	A	G	5	5	10	0	2	12	0	0
11	1356640	.	A	G	5	4	9	0	1	10	0	0
11	1359391	.	G	T	3	4	7	0	0	7	0	0
11	1389712	.	A	G	1	3	4	0	0	4	0	0
11	1396343	.	T	C	18	12	30	0	1	31	0	0
11	1403797	.	T	C	5	0	5	0	7	12	0	0
11	1403821	.	A	C	6	4	10	0	1	11	0	0
11	1403921	.	A	C	3	7	10	0	0	10	0	0
11	1403969	.	G	A	4	4	8	0	1	9	0	0
11	1404031	.	A	C	3	3	6	0	0	6	0	0
11	1404165	.	C	T	1	2	3	0	0	3	0	0
11	1404481	.	C	A	7	8	15	0	0	15	0	0
11	1404640	.	T	C	2	0	2	0	7	9	0	0
11	1404642	.	A	G	3	7	10	0	0	10	0	0
11	1406012	.	T	C	2	4	6	0	0	6	0	0
11	1407178	.	A	C	3	4	7	0	1	8	0	0
11	1408791	.	G	T	3	4	7	0	1	8	0	0
11	1408802	.	G	T	3	5	8	0	0	8	0	0
11	1427981	.	T	C	14	0	14	0	12	26	0	0
11	1467114	.	T	C	10	0	10	0	11	21	0	0
11	1467130	.	C	A	0	11	11	0	12	23	0	0
11	1469842	.	C	T	9	10	19	0	1	20	0	0
11	1469859	.	A	G	11	11	22	0	1	23	0	0
11	1469895	.	A	G	7	10	17	0	3	20	0	0
11	1470503	.	G	A	16	12	28	0	1	29	0	0
11	1470535	.	G	C	11	11	22	0	1	23	0	0
11	1470574	.	T	C	9	13	22	0	1	23	0	0
11	1474629	.	C	T	12	8	20	0	0	20	0	0
11	1512660	.	A	T	1	2	3	0	0	3	0	0
11	1516755	.	T	G	4	2	6	0	0	6	0	0
11	1517289	.	C	A	2	2	4	0	3	7	0	0
11	1520436	.	A	G	1	2	3	0	0	3	0	0
11	1520693	.	G	A	1	3	4	0	1	5	0	0
11	1520797	.	A	G	2	3	5	0	0	5	0	0
11	1522194	.	C	G	17	0	17	0	22	39	0	0
11	1522205	.	G	T	18	22	40	0	3	43	0	0
11	1522291	.	T	C	14	11	25	0	2	27	0	0
11	1523846	.	T	C	6	8	14	0	0	14	0	0
11	1523912	.	T	C	1	2	3	0	0	3	0	0
11	1524079	.	T	C	3	11	14	0	1	15	0	0
11	1524108	.	C	T	7	10	17	0	1	18	0	0
11	1525081	.	G	C	13	12	25	0	0	25	0	0
11	1525389	.	G	T	24	21	45	0	2	47	0	0
11	1525416	.	T	A	25	16	41	0	5	46	0	0
11	1526749	.	A	G	20	18	38	0	3	41	0	0
11	1529260	.	A	G	21	17	38	0	1	39	0	0
11	1529526	.	G	A	12	18	30	0	1	31	0	0
11	1529743	.	G	A	23	7	30	0	2	32	0	0
11	1529789	.	A	C	17	11	28	0	0	28	0	0
11	1529796	.	A	T	13	12	25	0	2	27	0	0
11	1529838	.	A	G	6	17	23	0	1	24	0	0
11	1529852	.	A	G	14	6	20	0	1	21	0	0
11	1530027	.	G	A	10	11	21	0	0	21	0	0
11	1530295	.	A	C	16	20	36	0	2	38	0	0
11	1530363	.	A	G	22	13	35	0	2	37	0	0
11	1530489	.	A	G	11	0	11	0	16	27	0	0
11	1530541	.	A	G	14	13	27	0	1	28	0	0
11	1530584	.	G	A	1	16	17	0	16	33	0	0
11	1530593	.	G	T	14	18	32	0	2	34	0	0
11	1530642	.	G	A	8	9	17	0	4	21	0	0
11	1535427	.	C	A	4	3	7	0	0	7	0	0
11	1535471	.	T	C	1	1	2	0	1	3	0	0
11	1542605	.	A	G	11	0	11	0	8	19	0	0
11	1545883	.	A	C	1	5	6	0	0	6	0	0
11	1751589	.	T	A	2	2	4	0	0	4	0	0
11	1754419	.	G	C	3	3	6	0	0	6	0	0
11	1764381	.	C	T	2	1	3	0	1	4	0	0
11	1764415	.	A	G	2	4	6	0	0	6	0	0
11	1764731	.	C	T	2	5	7	0	0	7	0	0
11	1776672	.	G	A	1	2	3	0	0	3	0	0
11	1786312	.	C	T	3	2	5	0	0	5	0	0
11	1796482	.	C	T	3	2	5	0	0	5	0	0
11	1799763	.	G	A	0	6	6	0	1	7	0	0
11	1799778	.	C	T	1	4	5	0	1	6	0	0
11	1799838	.	C	T	7	6	13	0	0	13	0	0
11	1805726	.	G	T	1	3	4	1	2	7	0	0
11	1805810	.	T	C	5	4	9	0	0	9	0	0
11	1810104	.	C	T	9	4	13	0	0	13	0	0
11	1812288	.	A	G	3	0	3	0	3	6	0	0
11	1812951	.	T	A	4	2	6	0	0	6	0	0
11	1812961	.	C	T	3	4	7	0	0	7	0	0
11	1813240	.	A	G	8	11	19	0	0	19	0	0
11	1815978	.	C	T	9	8	17	0	0	17	0	0
11	1816953	.	G	A	1	11	12	0	5	17	0	0
11	1818005	.	C	T	8	8	16	0	1	17	0	0
11	1823329	.	T	G	7	0	7	0	13	20	0	0
11	1830621	.	T	C	6	5	11	0	0	11	0	0
11	1834124	.	T	C	6	9	15	0	2	17	0	0
11	1836100	.	C	A	10	7	17	0	3	20	0	0
11	1836995	.	C	G	12	1	13	0	10	23	0	0
11	1838725	.	G	C	0	13	13	0	9	22	0	0
11	1841961	.	G	C	9	6	15	0	2	17	0	0
11	1843339	.	G	T	16	5	21	0	4	25	0	0
11	1843771	.	C	A	19	9	28	0	1	29	0	0
11	1843812	.	A	G	17	0	17	0	5	22	0	0
11	1843818	.	G	A	17	3	20	0	0	20	0	0
11	1863846	.	T	G	20	23	43	0	0	43	0	0
11	1864095	.	C	A	20	14	34	0	3	37	0	0
11	1864216	.	C	T	13	16	29	0	0	29	0	0
11	1918503	.	A	C	4	2	6	0	0	6	0	0
11	1919016	.	T	A	3	4	7	0	0	7	0	0
11	1919054	.	T	G	6	0	6	0	4	10	0	0
11	1919876	.	C	T	4	9	13	0	0	13	0	0
11	1920069	.	A	T	7	2	9	0	0	9	0	0
11	1945034	.	T	A	11	15	26	0	0	26	0	0
11	1945036	.	C	T	11	15	26	0	0	26	0	0
11	1945229	.	C	T	8	20	28	0	2	30	0	0
11	1947965	.	A	G	7	7	14	0	0	14	0	0
11	1948373	.	A	T	9	8	17	0	0	17	0	0
11	1967076	.	C	A	5	4	9	0	0	9	0	0
11	1967111	.	T	A	4	5	9	0	1	10	0	0
11	1967187	.	T	C	1	2	3	0	0	3	0	0
11	2112267	.	C	T	1	2	3	0	0	3	0	0
11	2112554	.	A	G	1	2	3	0	0	3	0	0
11	2117043	.	A	G	1	2	3	0	0	3	0	0
11	2123604	.	G	A	1	2	3	0	0	3	0	0
11	2217510	.	T	C	3	2	5	0	0	5	0	0
11	2240120	.	A	C	13	12	25	0	2	27	0	0
11	2244532	.	T	A	1	5	6	0	0	6	0	0
11	2249884	.	A	G	26	29	55	0	2	57	0	0
11	2249920	.	C	T	19	34	53	0	3	56	0	0
11	2253154	.	G	A	8	3	11	0	2	13	0	0
11	2254326	.	T	C	8	2	10	0	1	11	0	0
11	2255025	.	T	G	10	8	18	1	2	21	0	0
11	2255027	.	T	G	13	8	21	1	0	22	0	0
11	2263484	.	T	G	4	3	7	0	0	7	0	0
11	2283929	.	T	C	1	0	1	0	6	7	0	0
11	2292997	.	G	A	4	3	7	0	0	7	0	0
11	2295604	.	A	G	2	3	5	0	0	5	0	0
11	2458362	.	A	G	0	0	0	0	4	4	0	0
11	2458371	.	T	G	2	3	5	0	0	5	0	0
11	2462623	.	T	C	2	2	4	0	0	4	0	0
11	2462625	.	C	A	2	2	4	0	0	4	0	0
11	2462733	.	A	G	7	0	7	0	3	10	0	0
11	2462734	.	A	G	6	3	9	0	1	10	0	0
11	2462791	.	A	G	6	3	9	0	0	9	0	0
11	2506878	.	C	T	1	4	5	0	0	5	0	0
11	2507001	.	G	A	1	4	5	0	3	8	0	0
11	2507529	.	C	G	2	3	5	0	0	5	0	0
11	2507539	.	C	T	4	3	7	0	0	7	0	0
11	2541797	.	T	C	3	7	10	0	0	10	0	0
11	2542391	.	C	T	4	5	9	0	0	9	0	0
11	2543188	.	A	C	1	0	1	0	2	3	0	0
11	2545462	.	C	G	3	6	9	0	1	10	0	0
11	2545487	.	G	A	5	2	7	0	1	8	0	0
11	2554897	.	G	A	1	2	3	0	0	3	0	0
11	2566191	.	C	T	2	5	7	0	0	7	0	0
11	2571562	.	T	A	1	2	3	0	0	3	0	0
11	2571635	.	A	G	4	7	11	0	0	11	0	0
11	2584328	.	C	T	1	3	4	0	0	4	0	0
11	2585371	.	T	C	3	5	8	0	0	8	0	0
11	2587205	.	T	C	5	5	10	0	0	10	0	0
11	2597009	.	G	A	2	3	5	0	0	5	0	0
11	2597028	.	T	G	1	0	1	0	3	4	0	0
11	2600746	.	A	G	1	3	4	0	0	4	0	0
11	2605763	.	G	A	0	3	3	0	2	5	0	0
11	2615742	.	T	C	2	4	6	0	1	7	0	0
11	2616956	.	T	C	11	10	21	0	1	22	0	0
11	2617031	.	T	A	13	11	24	0	2	26	0	0
11	2617072	.	A	G	8	6	14	0	5	19	0	0
11	2617179	.	A	G	17	7	24	0	0	24	0	0
11	2618114	.	C	A	6	3	9	0	1	10	0	0
11	2618653	.	C	A	10	6	16	0	0	16	0	0
11	2618916	.	C	A	1	3	4	0	0	4	0	0
11	2619089	.	G	A	9	7	16	0	1	17	0	0
11	2619129	.	C	A	10	7	17	0	3	20	0	0
11	2619515	.	T	A	9	9	18	0	0	18	0	0
11	2619538	.	T	A	12	6	18	0	0	18	0	0
11	2619588	.	G	C	6	1	7	0	6	13	0	0
11	2621839	.	G	A	3	7	10	0	0	10	0	0
11	2625178	.	G	A	7	7	14	0	0	14	0	0
11	2628038	.	T	G	4	2	6	0	1	7	0	0
11	2650018	.	T	G	1	8	9	0	0	9	0	0
11	2655957	.	G	C	0	2	2	0	6	8	0	0
11	2656062	.	C	G	3	3	6	0	0	6	0	0
11	2660602	.	T	C	1	6	7	0	0	7	0	0
11	2664585	.	A	C	3	4	7	0	1	8	0	0
11	2665236	.	T	A	5	9	14	0	1	15	0	0
11	2673624	.	T	C	5	4	9	0	3	12	0	0
11	2675447	.	C	A	10	9	19	0	1	20	0	0
11	2675454	.	A	C	8	10	18	0	2	20	0	0
11	2677377	.	G	C	3	7	10	0	1	11	0	0
11	2677404	.	G	A	0	7	7	0	5	12	0	0
11	2677428	.	A	G	7	7	14	0	1	15	0	0
11	2677440	.	C	T	8	6	14	0	0	14	0	0
11	2677538	.	C	T	2	11	13	0	1	14	0	0
11	2678064	.	G	A	10	9	19	0	0	19	0	0
11	2678088	.	G	A	11	8	19	0	1	20	0	0
11	2680570	.	G	A	1	4	5	0	1	6	0	0
11	2680747	.	C	T	7	12	19	0	3	22	0	0
11	2680797	.	G	C	4	8	12	0	0	12	0	0
11	2681121	.	C	A	2	3	5	1	0	6	0	0
11	2681133	.	T	A	3	3	6	1	0	7	0	0
11	2681432	.	A	G	2	2	4	0	0	4	0	0
11	2682157	.	A	G	2	2	4	0	0	4	0	0
11	2682257	.	T	A	1	2	3	1	0	4	0	0
11	2682313	.	G	T	4	4	8	0	0	8	0	0
11	2682361	.	T	C	3	3	6	0	0	6	0	0
11	2682414	.	A	G	2	3	5	1	0	6	0	0
11	2682441	.	A	T	4	4	8	0	0	8	0	0
11	2682470	.	A	T	4	6	10	0	0	10	0	0
11	2682483	.	T	C	6	3	9	0	0	9	0	0
11	2682644	.	A	T	4	2	6	0	0	7	1	0
11	2682664	.	T	A	3	3	6	0	0	7	1	0
11	2682693	.	A	C	3	5	8	0	1	9	0	0
11	2682866	.	T	C	6	5	11	0	1	12	0	0
11	2683038	.	G	T	3	3	6	0	1	7	0	0
11	2683084	.	G	T	3	2	5	0	0	5	0	0
11	2683092	.	A	C	2	3	5	0	0	5	0	0
11	2683509	.	T	C	11	20	31	0	0	31	0	0
11	2687421	.	C	T	6	4	10	0	0	10	0	0
11	2687472	.	C	T	3	5	8	0	0	8	0	0
11	2687526	.	G	A	3	12	15	0	0	15	0	0
11	2687550	.	A	C	6	14	20	0	0	20	0	0
11	2688119	.	G	A	8	6	14	0	0	14	0	0
11	2688582	.	A	C	2	4	6	0	0	6	0	0
11	2688916	.	G	C	3	7	10	0	0	10	0	0
11	2689336	.	G	A	3	3	6	0	0	6	0	0
11	2689337	.	G	A	3	2	5	0	1	6	0	0
11	2689404	.	A	G	2	3	5	0	0	5	0	0
11	2690303	.	G	C	11	7	18	0	1	19	0	0
11	2690445	.	G	T	6	13	19	1	2	22	0	0
11	2690499	.	C	T	10	4	14	0	0	14	0	0
11	2690564	.	G	T	6	4	10	0	0	10	0	0
11	2690612	.	A	C	7	4	11	0	0	11	0	0
11	2690869	.	C	A	5	2	7	0	0	7	0	0
11	2690873	.	G	A	1	1	2	0	3	5	0	0
11	2692109	.	A	C	5	2	7	0	0	7	0	0
11	2692180	.	C	T	1	4	5	0	0	5	0	0
11	2692579	.	T	G	2	0	2	0	2	4	0	0
11	2702718	.	T	C	5	8	13	0	1	14	0	0
11	2702766	.	C	T	10	5	15	0	0	15	0	0
11	2702808	.	T	C	17	6	23	0	0	23	0	0
11	2705206	.	C	T	9	10	19	0	0	19	0	0
11	2705215	.	G	T	1	10	11	0	11	22	0	0
11	2705273	.	A	G	10	0	10	0	6	16	0	0
11	2705325	.	G	A	6	8	14	0	0	14	0	0
11	2705355	.	T	A	4	5	9	0	2	11	0	0
11	2706517	.	T	G	7	11	18	0	0	18	0	0
11	2706734	.	T	C	11	8	19	0	3	22	0	0
11	2706838	.	A	G	6	7	13	0	0	13	0	0
11	2706988	.	C	A	0	2	2	0	1	3	0	0
11	2710611	.	A	T	10	4	14	0	0	14	0	0
11	2710642	.	G	A	5	5	10	0	0	10	0	0
11	2710770	.	A	T	4	4	8	0	0	8	0	0
11	2745110	.	A	T	5	3	8	1	1	10	0	0
11	2745128	.	C	T	3	3	6	1	1	8	0	0
11	2755120	.	A	T	11	6	17	0	0	17	0	0
11	2757582	.	T	C	6	9	15	0	0	15	0	0
11	2757611	.	T	A	4	4	8	0	0	8	0	0
11	2757622	.	T	A	0	7	7	0	0	7	0	0
11	2758204	.	C	T	12	14	26	0	0	26	0	0
11	2759043	.	A	T	7	10	17	2	0	19	0	0
11	2759461	.	T	C	7	6	13	3	0	16	0	0
11	2759475	.	G	T	7	9	16	6	0	22	0	0
11	2759498	.	G	A	13	13	26	3	0	29	0	0
11	2759833	.	G	A	1	13	14	0	15	29	0	0
11	2759843	.	G	A	1	13	14	0	14	28	0	0
11	2759901	.	T	G	15	13	28	0	0	28	0	0
11	2759903	.	A	T	14	13	27	0	1	28	0	0
11	2759938	.	A	G	10	14	24	0	2	26	0	0
11	2760240	.	C	T	9	3	12	0	1	13	0	0
11	2805410	.	C	A	11	6	17	0	0	17	0	0
11	2809744	.	C	T	17	5	22	0	2	24	0	0
11	2809777	.	A	G	14	0	14	0	7	21	0	0
11	2809804	.	A	G	14	10	24	0	1	25	0	0
11	2813856	.	G	C	17	11	28	0	1	29	0	0
11	2815790	.	C	G	20	19	39	0	0	39	0	0
11	2815845	.	C	T	19	19	38	0	0	38	0	0
11	2820876	.	T	G	16	23	39	0	0	39	0	0
11	2820900	.	A	C	12	12	24	0	6	30	0	0
11	2821427	.	T	C	12	14	26	0	0	26	0	0
11	2821430	.	C	G	12	1	13	0	14	27	0	0
11	2826184	.	T	C	21	19	40	1	1	42	0	0
11	2826338	.	G	T	20	17	37	0	1	38	0	0
11	2826485	.	C	A	15	7	22	0	2	24	0	0
11	2827557	.	A	T	15	5	20	0	2	22	0	0
11	2828133	.	A	G	22	11	33	1	0	34	0	0
11	2828276	.	C	A	11	10	21	0	0	21	0	0
11	2828388	.	G	A	22	11	33	0	1	34	0	0
11	2911513	.	C	T	1	3	4	1	0	5	0	0
11	3170359	.	A	G	1	0	1	0	2	3	0	0
11	3217970	.	C	T	1	3	4	0	0	4	0	0
11	3221014	.	C	T	1	4	5	0	1	6	0	0
11	3222083	.	A	G	1	4	5	0	0	5	0	0
11	3222192	.	T	C	1	3	4	0	0	4	0	0
11	3227302	.	A	T	1	2	3	0	1	4	0	0
11	3227451	.	C	T	2	3	5	0	0	5	0	0
11	3230284	.	G	A	3	3	6	0	0	6	0	0
11	3238484	.	A	G	10	5	15	0	1	16	0	0
11	3238651	.	C	T	5	3	8	0	2	10	0	0
11	3238720	.	T	C	7	11	18	0	0	18	0	0
11	3240457	.	G	A	0	8	8	0	12	20	0	0
11	3243124	.	A	G	11	0	11	0	6	17	0	0
11	3246120	.	A	G	9	5	14	0	0	14	0	0
11	3246133	.	A	G	9	5	14	0	0	14	0	0
11	3246590	.	A	C	5	5	10	16	0	26	0	0
11	3249253	.	C	T	8	4	12	0	0	12	0	0
11	3249346	.	C	T	6	6	12	0	0	12	0	0
11	3249370	.	A	G	6	0	6	0	4	10	0	0
11	3317226	.	T	C	11	10	21	0	1	22	0	0
11	3317229	.	G	T	10	10	20	0	2	22	0	0
11	3317389	.	A	T	17	16	33	0	1	34	0	0
11	3323377	.	G	T	7	5	12	0	1	14	1	0
11	3327451	.	G	A	3	4	7	0	0	7	0	0
11	3336700	.	T	G	25	29	54	0	0	54	0	0
11	3336793	.	C	T	34	33	67	0	2	70	1	0
11	3337038	.	A	G	33	33	66	0	6	72	0	0
11	3337253	.	A	G	32	35	67	0	1	68	0	0
11	3337256	.	T	C	33	0	33	0	37	70	0	0
11	3337481	.	T	G	29	30	59	0	4	63	0	0
11	3337482	.	A	T	25	29	54	0	7	63	2	0
11	3337718	.	G	C	28	22	50	0	1	51	0	0
11	3338060	.	C	G	30	16	46	0	2	48	0	0
11	3338144	.	T	C	35	22	57	0	4	61	0	0
11	3338236	.	T	C	29	1	30	1	33	64	0	0
11	3338288	.	T	A	37	24	61	2	1	65	1	0
11	3338299	.	T	G	33	19	52	2	4	58	0	0
11	3338420	.	A	T	34	16	50	0	5	55	0	0
11	3338431	.	C	T	3	21	24	0	29	53	0	0
11	3338491	.	G	A	23	26	49	0	1	51	1	0
11	3338514	.	C	A	36	19	55	0	1	56	0	0
11	3338618	.	T	C	37	19	56	0	4	60	0	0
11	3338638	.	A	G	32	18	50	0	3	53	0	0
11	3338933	.	A	G	27	23	50	0	4	54	0	0
11	3339098	.	T	C	20	0	20	0	22	42	0	0
11	3339152	.	C	T	18	10	28	0	2	30	0	0
11	3341296	.	G	A	20	24	44	0	1	45	0	0
11	3345676	.	A	G	2	6	8	0	0	8	0	0
11	3345779	.	T	C	3	2	5	0	0	5	0	0
11	3345952	.	T	C	5	2	7	0	0	7	0	0
11	3346128	.	T	G	7	4	11	0	1	12	0	0
11	3367601	.	C	A	1	2	3	0	0	3	0	0
11	3367789	.	T	C	5	0	5	0	5	10	0	0
11	3367924	.	G	C	7	13	20	0	2	22	0	0
11	3367937	.	T	C	8	8	16	0	0	16	0	0
11	3373418	.	A	G	7	10	17	0	1	18	0	0
11	3373448	.	G	A	9	12	21	0	1	22	0	0
11	3373996	.	C	T	1	7	8	0	5	13	0	0
11	3377127	.	T	C	2	0	2	0	5	7	0	0
11	3379999	.	G	T	6	4	10	0	1	11	0	0
11	3380012	.	C	G	7	4	11	0	0	11	0	0
11	3380135	.	A	G	5	6	11	0	0	11	0	0
11	3381261	.	C	A	4	4	8	0	0	8	0	0
11	3395069	.	G	A	17	12	29	0	1	30	0	0
11	3395070	.	A	T	18	12	30	0	1	31	0	0
11	3395303	.	G	A	15	8	23	0	1	24	0	0
11	3395324	.	C	T	15	14	29	0	0	29	0	0
11	3395501	.	A	G	10	3	13	0	1	14	0	0
11	3395693	.	A	T	1	7	8	0	0	8	0	0
11	3395699	.	G	A	1	7	8	0	1	9	0	0
11	3398738	.	A	C	10	0	10	0	5	15	0	0
11	3401899	.	C	A	5	4	9	0	0	9	0	0
11	3422086	.	T	C	4	2	6	0	0	6	0	0
11	3425175	.	G	A	3	4	7	0	0	7	0	0
11	3425579	.	C	T	6	4	10	0	0	10	0	0
11	3494891	.	A	G	3	7	10	0	0	10	0	0
11	3494930	.	T	A	2	2	4	0	0	4	0	0
11	3514154	.	T	C	4	6	10	0	0	10	0	0
11	3523724	.	A	G	5	15	20	0	2	22	0	0
11	3523826	.	G	A	8	7	15	0	0	15	0	0
11	3523976	.	A	C	9	0	9	0	9	18	0	0
11	3523991	.	C	T	7	8	15	0	3	19	1	0
11	3524064	.	G	T	7	6	13	0	1	14	0	0
11	3524111	.	G	A	11	8	19	0	1	20	0	0
11	3524121	.	A	G	15	7	22	0	1	23	0	0
11	3524236	.	C	T	17	10	27	0	1	28	0	0
11	3524397	.	T	C	8	5	13	0	0	13	0	0
11	3524462	.	C	T	7	13	20	0	0	20	0	0
11	3524541	.	A	T	10	7	17	0	0	17	0	0
11	3524724	.	T	A	4	7	11	0	1	12	0	0
11	3524849	.	G	A	10	14	24	0	1	25	0	0
11	3526521	.	A	G	9	8	17	0	0	17	0	0
11	3526605	.	C	G	16	11	27	0	1	28	0	0
11	3528320	.	A	T	6	12	18	0	4	22	0	0
11	3530791	.	C	G	1	3	4	0	1	5	0	0
11	3530991	.	T	C	4	0	4	0	2	6	0	0
11	3533330	.	T	C	3	0	3	0	2	5	0	0
11	3533345	.	T	C	2	0	2	0	2	4	0	0
11	3535326	.	A	G	5	3	8	0	0	8	0	0
11	3535431	.	T	C	2	2	4	0	0	4	0	0
11	3535434	.	A	G	2	2	4	0	0	4	0	0
11	3550448	.	A	G	8	4	12	0	0	12	0	0
11	3550454	.	T	A	9	6	15	0	1	16	0	0
11	3550588	.	T	C	20	0	20	0	22	42	0	0
11	3551309	.	A	G	24	30	54	0	1	55	0	0
11	3551944	.	G	A	27	24	51	0	3	54	0	0
11	3563644	.	C	T	0	2	2	0	1	3	0	0
11	3563647	.	G	A	1	3	4	0	0	4	0	0
11	3593309	.	T	C	2	7	9	0	0	9	0	0
11	3593490	.	A	C	7	7	14	0	1	15	0	0
11	3593748	.	A	G	8	14	22	0	1	23	0	0
11	3593988	.	G	T	6	14	20	0	1	21	0	0
11	3594029	.	T	C	10	10	20	0	2	22	0	0
11	3594217	.	G	T	14	10	24	0	1	25	0	0
11	3594277	.	T	G	14	7	21	0	3	24	0	0
11	3594321	.	T	C	13	1	14	0	13	27	0	0
11	3594327	.	T	A	14	12	26	0	1	27	0	0
11	3594366	.	A	G	5	16	21	0	3	24	0	0
11	3594419	.	A	G	5	14	19	0	2	21	0	0
11	3594452	.	T	G	6	3	9	3	6	18	0	0
11	3594828	.	T	C	7	0	7	0	4	11	0	0
11	3595308	.	G	A	5	9	14	0	0	14	0	0
11	3595579	.	A	G	9	7	16	0	1	17	0	0
11	3602382	.	T	C	6	5	11	0	1	12	0	0
11	3603392	.	A	G	4	2	6	0	1	7	0	0
11	3603434	.	T	C	3	2	5	0	0	5	0	0
11	3606914	.	T	C	5	0	5	0	4	9	0	0
11	3606957	.	C	T	4	8	12	0	0	12	0	0
11	3609427	.	A	G	3	3	6	0	0	6	0	0
11	3609448	.	A	T	1	3	4	0	2	6	0	0
11	3630875	.	G	A	1	1	2	0	1	3	0	0
11	3631100	.	A	G	2	2	4	0	1	5	0	0
11	3632267	.	G	A	4	2	6	0	0	6	0	0
11	3632272	.	G	A	3	2	5	0	0	5	0	0
11	3848283	.	G	A	18	15	33	0	3	36	0	0
11	3848323	.	C	T	2	17	19	0	16	35	0	0
11	3848656	.	C	T	6	20	26	0	1	27	0	0
11	3860159	.	A	T	3	3	6	0	1	7	0	0
11	3893635	.	C	T	18	17	35	0	0	35	0	0
11	3893636	.	T	G	18	16	34	0	1	35	0	0
11	3893918	.	G	A	19	24	43	0	0	43	0	0
11	3893928	.	G	C	17	22	39	0	2	41	0	0
11	3894023	.	T	C	16	33	49	0	0	49	0	0
11	3898730	.	C	A	2	13	15	0	18	33	0	0
11	3898736	.	A	G	18	14	32	0	0	32	0	0
11	3899066	.	C	A	2	9	11	0	15	26	0	0
11	3899117	.	G	A	12	8	20	0	0	20	0	0
11	3901733	.	C	G	3	10	13	0	15	28	0	0
11	3904469	.	A	G	10	11	21	0	2	23	0	0
11	3904517	.	C	G	1	16	17	0	7	24	0	0
11	3904564	.	C	T	7	19	26	0	0	26	0	0
11	3904666	.	A	G	9	9	18	0	3	21	0	0
11	3904674	.	T	G	10	7	17	0	2	19	0	0
11	3905928	.	A	G	8	16	24	0	0	24	0	0
11	3917723	.	A	G	20	9	29	0	1	30	0	0
11	3921491	.	A	G	26	10	36	0	2	38	0	0
11	3921563	.	T	A	21	16	37	0	0	37	0	0
11	3922983	.	G	A	12	15	27	0	1	28	0	0
11	3925822	.	T	C	5	2	7	0	16	23	0	0
11	3925906	.	A	G	9	12	21	0	1	22	0	0
11	3925939	.	T	C	7	13	20	0	0	20	0	0
11	3928044	.	A	T	7	4	11	0	4	15	0	0
11	3928168	.	T	C	5	6	11	0	0	11	0	0
11	3931773	.	C	T	9	9	18	0	0	18	0	0
11	3933807	.	G	A	7	6	13	0	0	13	0	0
11	3934190	.	A	G	6	5	11	0	1	12	0	0
11	3934319	.	T	G	9	4	13	0	0	13	0	0
11	3936378	.	T	A	9	6	15	0	0	15	0	0
11	3939291	.	C	G	1	5	6	0	4	10	0	0
11	3941180	.	C	T	2	2	4	0	1	5	0	0
11	3963581	.	C	T	2	5	7	0	1	8	0	0
11	3963608	.	G	T	4	6	10	0	0	10	0	0
11	3963639	.	T	A	5	4	9	0	2	11	0	0
11	3965837	.	G	A	2	5	7	0	0	7	0	0
11	3965867	.	C	T	3	6	9	0	0	9	0	0
11	3965984	.	T	A	3	7	10	0	2	13	1	0
11	3966031	.	T	C	8	6	14	0	0	14	0	0
11	3966360	.	G	C	1	6	7	0	8	15	0	0
11	3967408	.	A	G	2	0	2	0	8	10	0	0
11	3967445	.	A	G	2	4	6	0	0	6	0	0
11	3968866	.	T	C	4	9	13	0	0	13	0	0
11	3968877	.	G	A	4	7	11	0	1	12	0	0
11	3968915	.	T	G	6	7	13	0	1	14	0	0
11	3968930	.	A	G	8	0	8	0	8	16	0	0
11	3971943	.	T	A	3	3	6	0	0	6	0	0
11	3972248	.	C	T	0	2	2	0	1	3	0	0
11	3976563	.	G	A	3	2	5	0	0	5	0	0
11	3993452	.	G	A	0	6	6	0	8	14	0	0
11	3993470	.	A	T	5	5	10	0	0	10	0	0
11	3995459	.	G	A	6	4	10	0	0	10	0	0
11	3995479	.	G	T	8	3	11	0	1	12	0	0
11	3997023	.	T	C	3	1	4	0	7	11	0	0
11	3997029	.	C	A	0	9	9	0	3	12	0	0
11	4004042	.	G	C	4	3	7	0	0	7	0	0
11	4006956	.	C	T	5	5	10	0	0	10	0	0
11	4010895	.	C	T	5	5	10	0	0	10	0	0
11	4014458	.	A	G	5	6	11	0	0	11	0	0
11	4014737	.	C	T	2	2	4	0	0	4	0	0
11	4014758	.	T	C	1	0	1	0	2	3	0	0
11	4023804	.	G	A	1	2	3	0	1	4	0	0
11	4023813	.	T	G	3	1	4	0	1	5	0	0
11	4023875	.	T	C	5	0	5	0	4	9	0	0
11	4026308	.	C	T	2	7	9	0	0	9	0	0
11	4113825	.	G	A	1	5	6	0	0	6	0	0
11	4128836	.	A	T	6	12	18	0	3	21	0	0
11	4130901	.	T	G	2	3	5	0	0	5	0	0
11	4131300	.	A	T	9	5	14	0	0	14	0	0
11	4131423	.	T	A	11	11	22	0	0	22	0	0
11	4132110	.	G	T	19	10	29	0	0	29	0	0
11	4132296	.	A	C	27	21	48	0	3	51	0	0
11	4132378	.	G	C	14	10	24	0	2	26	0	0
11	4132440	.	A	G	12	14	26	0	0	26	0	0
11	4132599	.	T	C	6	6	12	0	1	13	0	0
11	5397240	.	A	G	3	3	6	0	0	6	0	0
11	5397262	.	T	A	2	5	7	0	0	7	0	0
11	5397485	.	A	G	1	4	5	0	0	5	0	0
11	5472564	.	G	A	0	3	3	0	4	7	0	0
11	5474384	.	T	G	2	0	2	0	4	6	0	0
11	5477441	.	C	T	4	3	7	0	0	7	0	0
11	5477453	.	T	C	3	4	7	0	1	8	0	0
11	5479102	.	A	G	3	7	10	0	0	10	0	0
11	5479489	.	A	G	7	0	7	0	17	24	0	0
11	5479555	.	T	C	7	12	19	0	2	21	0	0
11	5484288	.	G	C	1	6	7	0	12	19	0	0
11	5484294	.	T	C	11	7	18	0	0	18	0	0
11	5489221	.	A	G	15	8	23	0	1	24	0	0
11	5489356	.	C	T	15	14	29	0	1	30	0	0
11	5489634	.	A	T	19	8	27	1	2	30	0	0
11	5489688	.	T	C	14	13	27	0	0	27	0	0
11	5489689	.	T	C	13	13	26	0	1	27	0	0
11	5489769	.	C	G	13	17	30	0	0	30	0	0
11	5489781	.	G	A	17	13	30	0	0	30	0	0
11	5489835	.	A	C	7	13	20	0	0	20	0	0
11	5489973	.	A	G	2	0	2	0	4	6	0	0
11	5489974	.	A	G	2	4	6	0	0	6	0	0
11	5499912	.	G	C	0	6	6	0	2	8	0	0
11	5506066	.	T	C	7	2	9	0	0	9	0	0
11	5506075	.	C	T	7	2	9	0	0	9	0	0
11	5506111	.	C	T	5	6	11	0	1	12	0	0
11	5509526	.	C	T	10	9	19	0	1	20	0	0
11	5512128	.	A	G	3	0	3	0	9	12	0	0
11	5512436	.	A	T	6	6	12	0	2	14	0	0
11	5512468	.	C	T	7	8	15	0	0	15	0	0
11	5512520	.	C	T	4	6	10	0	0	10	0	0
11	5512921	.	A	G	11	0	11	0	8	19	0	0
11	5512947	.	T	G	11	6	17	0	0	17	0	0
11	5513181	.	A	C	12	5	17	0	0	17	0	0
11	5513210	.	G	A	6	3	9	0	1	10	0	0
11	5513220	.	A	C	6	2	8	0	0	8	0	0
11	5513352	.	C	T	6	2	8	0	2	10	0	0
11	5513381	.	T	A	5	3	8	0	0	9	1	0
11	5513812	.	T	C	5	2	7	0	0	7	0	0
11	5513830	.	A	T	5	3	8	0	1	9	0	0
11	5514254	.	G	A	1	5	6	0	12	18	0	0
11	5514259	.	C	T	8	8	16	0	0	16	0	0
11	5514677	.	C	T	16	11	27	0	5	32	0	0
11	5515016	.	G	C	10	7	17	1	2	20	0	0
11	5646331	.	C	T	1	4	5	0	0	5	0	0
11	5654226	.	T	C	3	4	7	0	1	8	0	0
11	5658587	.	T	A	9	8	17	0	0	17	0	0
11	5658941	.	A	G	5	3	8	0	1	9	0	0
11	5659026	.	C	T	4	4	8	0	1	9	0	0
11	5659054	.	C	G	3	5	8	0	0	8	0	0
11	5659097	.	G	A	2	5	7	0	0	7	0	0
11	5666471	.	A	G	6	3	9	0	0	9	0	0
11	5669671	.	T	C	5	2	7	0	0	7	0	0
11	5669917	.	A	T	8	3	11	0	0	11	0	0
11	5669950	.	T	C	5	2	7	0	0	7	0	0
11	5674704	.	C	T	10	11	21	0	0	21	0	0
11	5674779	.	G	A	1	4	5	0	5	10	0	0
11	5674809	.	C	T	6	3	9	0	0	9	0	0
11	5817283	.	T	A	4	6	10	0	0	10	0	0
11	5817307	.	G	C	4	10	14	0	0	14	0	0
11	5817472	.	C	A	4	11	15	0	2	17	0	0
11	5821084	.	G	T	16	4	20	0	1	21	0	0
11	5825415	.	C	T	9	5	14	0	2	16	0	0
11	5825477	.	T	C	8	7	15	0	1	16	0	0
11	5825620	.	A	G	17	9	26	1	0	27	0	0
11	5836012	.	G	A	5	15	20	0	0	20	0	0
11	5836049	.	A	C	15	6	21	0	1	22	0	0
11	5843388	.	T	C	26	23	49	0	2	51	0	0
11	5844303	.	T	A	22	25	47	0	4	51	0	0
11	5844333	.	T	C	22	19	41	0	3	44	0	0
11	5852424	.	G	T	6	25	31	1	24	56	0	0
11	5888504	.	C	T	10	6	16	0	0	16	0	0
11	5965302	.	T	C	1	2	3	0	0	3	0	0
11	5971427	.	A	G	3	2	5	0	0	5	0	0
11	6010247	.	A	T	1	2	3	0	0	3	0	0
11	6034421	.	G	A	1	2	3	0	5	8	0	0
11	6046585	.	C	T	1	3	4	0	0	4	0	0
11	6051477	.	G	A	11	5	16	0	0	16	0	0
11	6051481	.	T	C	13	4	17	0	1	18	0	0
11	6051557	.	A	T	10	11	21	0	0	21	0	0
11	6051717	.	G	A	13	4	17	0	0	17	0	0
11	6052011	.	T	A	10	10	20	0	0	20	0	0
11	6052211	.	G	A	11	7	18	0	0	18	0	0
11	6057335	.	G	A	10	6	16	2	0	18	0	0
11	6062107	.	T	A	4	7	11	0	0	11	0	0
11	6064144	.	C	T	0	4	4	0	4	8	0	0
11	6064147	.	C	T	4	4	8	0	0	8	0	0
11	6065129	.	C	G	0	7	7	0	9	16	0	0
11	6065150	.	C	T	1	9	10	0	7	17	0	0
11	6072084	.	A	G	2	3	5	0	0	5	0	0
11	6072096	.	A	T	2	3	5	0	0	5	0	0
11	6072558	.	A	G	1	2	3	0	0	3	0	0
11	6073710	.	A	T	1	2	3	0	1	4	0	0
11	6073736	.	C	T	2	2	4	0	0	4	0	0
11	6074110	.	T	G	3	2	5	0	0	5	0	0
11	6124807	.	C	T	7	4	11	0	0	11	0	0
11	6132985	.	T	G	3	4	7	0	0	7	0	0
11	6133293	.	G	C	4	7	11	0	0	11	0	0
11	6133335	.	G	A	3	2	5	0	0	5	0	0
11	6139323	.	A	G	3	3	6	0	0	6	0	0
11	6144355	.	A	C	2	2	4	0	0	4	0	0
11	6167971	.	C	T	2	2	4	0	0	4	0	0
11	6167981	.	C	T	1	2	3	0	1	4	0	0
11	6168007	.	C	T	2	2	4	0	0	4	0	0
11	6168047	.	C	T	1	2	3	0	0	3	0	0
11	6168071	.	T	C	1	2	3	0	0	3	0	0
11	6170596	.	C	A	1	2	3	0	0	3	0	0
11	6170662	.	T	C	5	2	7	0	0	7	0	0
11	6172327	.	G	A	2	6	8	0	0	8	0	0
11	6172366	.	T	G	2	7	9	0	0	9	0	0
11	6183030	.	T	C	22	18	40	0	1	41	0	0
11	6187412	.	C	G	1	14	15	0	8	23	0	0
11	6197446	.	A	T	5	2	7	0	1	8	0	0
11	6197495	.	C	T	1	8	9	0	10	19	0	0
11	6199637	.	G	A	1	2	3	0	0	3	0	0
11	6199643	.	C	A	1	2	3	0	0	3	0	0
11	6262189	.	T	C	1	6	7	0	0	7	0	0
11	6290039	.	C	T	1	3	4	0	0	4	0	0
11	6303371	.	T	A	1	2	3	0	0	3	0	0
11	6428893	.	G	T	20	11	31	0	0	31	0	0
11	6450624	.	G	A	1	2	3	0	0	3	0	0
11	6819052	.	G	T	3	3	6	0	0	6	0	0
11	6819093	.	G	A	15	11	26	0	0	26	0	0
11	6850576	.	A	G	27	22	49	2	1	52	0	0
11	6859934	.	A	G	2	3	5	0	0	5	0	0
11	6859935	.	T	C	2	0	2	0	3	5	0	0
11	6860020	.	A	G	8	16	24	0	1	25	0	0
11	6860050	.	T	C	11	20	31	0	0	31	0	0
11	6865051	.	C	T	14	15	29	0	5	34	0	0
11	6868156	.	G	T	18	15	33	0	1	34	0	0
11	6869685	.	A	G	6	5	11	0	1	12	0	0
11	6870794	.	C	T	1	6	7	0	10	17	0	0
11	6874110	.	T	C	6	4	10	0	0	10	0	0
11	6877970	.	A	G	1	3	4	0	0	4	0	0
11	6880665	.	T	C	2	0	2	0	3	5	0	0
11	6889957	.	G	C	1	5	6	0	0	6	0	0
11	6890283	.	A	G	5	2	7	0	0	7	0	0
11	6921467	.	T	C	1	2	3	0	0	3	0	0
11	6921503	.	A	G	2	0	2	0	3	5	0	0
11	6921995	.	C	A	4	5	9	0	0	9	0	0
11	6925032	.	C	G	3	4	7	0	0	7	0	0
11	6925125	.	C	T	4	4	8	0	1	9	0	0
11	6925146	.	C	A	2	2	4	0	1	5	0	0
11	6925398	.	C	A	1	2	3	0	0	3	0	0
11	6928892	.	A	G	3	2	5	0	0	5	0	0
11	6934453	.	G	A	0	3	3	0	3	6	0	0
11	6934486	.	C	T	4	2	6	0	0	6	0	0
11	6941654	.	T	G	7	10	17	0	1	18	0	0
11	6941987	.	C	T	9	7	16	0	0	16	0	0
11	6942040	.	G	A	11	11	22	0	1	24	1	0
11	6942797	.	T	C	14	7	21	0	1	22	0	0
11	6942977	.	A	G	16	5	21	0	3	24	0	0
11	6943013	.	C	T	15	9	24	0	1	25	0	0
11	6943048	.	A	G	11	1	12	0	6	18	0	0
11	6943055	.	T	G	11	6	17	0	1	18	0	0
11	6943214	.	G	T	4	6	10	0	0	10	0	0
11	6943317	.	A	C	3	3	6	0	1	7	0	0
11	6943326	.	T	A	3	4	7	0	0	7	0	0
11	6943462	.	T	A	7	10	17	0	1	18	0	0
11	6943715	.	G	A	1	17	18	0	11	29	0	0
11	6944143	.	T	A	12	10	22	0	0	22	0	0
11	6944205	.	A	G	2	8	10	0	0	10	0	0
11	6980178	.	A	C	1	4	5	0	0	5	0	0
11	6980997	.	G	T	2	3	5	1	0	6	0	0
11	6981032	.	G	C	2	2	4	1	0	5	0	0
11	6983784	.	G	A	3	5	8	0	2	10	0	0
11	6983788	.	T	G	4	6	10	0	0	10	0	0
11	6985280	.	G	A	3	4	7	0	0	7	0	0
11	6985284	.	C	A	0	4	4	0	2	6	0	0
11	6985335	.	T	C	1	3	4	0	0	4	0	0
11	6987213	.	C	T	1	2	3	0	0	3	0	0
11	7040973	.	T	A	2	4	6	0	0	6	0	0
11	7041002	.	A	G	3	6	9	0	0	9	0	0
11	7041291	.	T	C	7	13	20	0	0	20	0	0
11	7041300	.	A	G	8	12	20	0	0	20	0	0
11	7041475	.	C	G	3	7	10	0	0	10	0	0
11	7041476	.	T	C	3	0	3	0	7	10	0	0
11	7041527	.	T	C	7	4	11	0	0	11	0	0
11	7041528	.	G	C	7	4	11	0	0	11	0	0
11	7041580	.	T	C	6	14	20	0	0	20	0	0
11	7041598	.	A	C	5	13	18	0	0	18	0	0
11	7041690	.	A	G	8	12	20	0	0	20	0	0
11	7041732	.	C	T	0	7	7	0	6	13	0	0
11	7041915	.	T	A	11	4	15	0	0	15	0	0
11	7041940	.	A	C	11	3	14	0	0	14	0	0
11	7042042	.	G	A	8	2	10	0	1	11	0	0
11	7042149	.	C	T	6	6	12	0	1	13	0	0
11	7042209	.	T	A	12	3	15	0	2	17	0	0
11	7042210	.	T	C	12	0	12	0	5	17	0	0
11	7042513	.	T	A	3	9	12	0	0	12	0	0
11	7042956	.	A	G	2	3	5	0	0	5	0	0
11	7043003	.	C	T	2	2	4	0	0	4	0	0
11	7043023	.	C	A	2	3	5	0	0	5	0	0
11	7078282	.	G	T	3	3	6	0	0	6	0	0
11	7101280	.	G	A	2	2	4	0	0	4	0	0
11	7102978	.	G	A	0	4	4	0	5	9	0	0
11	7103010	.	A	T	1	2	3	0	0	3	0	0
11	7103054	.	A	C	3	2	5	0	0	5	0	0
11	7103064	.	C	T	3	4	7	0	0	7	0	0
11	7103099	.	G	A	0	4	4	0	1	5	0	0
11	7149937	.	T	G	12	4	16	0	1	17	0	0
11	7150189	.	T	C	9	6	15	0	2	17	0	0
11	7151773	.	G	T	8	27	35	0	1	36	0	0
11	7151806	.	C	A	0	39	39	0	14	53	0	0
11	7151842	.	G	T	20	23	43	0	2	45	0	0
11	7151860	.	A	T	27	10	37	0	1	38	0	0
11	7151910	.	G	A	11	10	21	1	2	24	0	0
11	7152056	.	T	C	22	6	28	0	1	29	0	0
11	7152102	.	G	A	15	13	28	0	1	29	0	0
11	7152274	.	G	A	8	21	29	0	0	29	0	0
11	7152426	.	A	T	7	17	24	2	0	26	0	0
11	7152428	.	A	G	7	17	24	1	0	25	0	0
11	7152594	.	C	T	10	12	22	0	1	23	0	0
11	7152609	.	C	T	7	17	24	0	0	24	0	0
11	7152639	.	C	A	2	18	20	0	4	24	0	0
11	7156630	.	T	C	3	3	6	0	0	6	0	0
11	7156639	.	T	C	2	2	4	0	0	4	0	0
11	7175215	.	G	C	1	11	12	0	11	23	0	0
11	7178941	.	G	C	0	6	6	0	10	16	0	0
11	7179018	.	C	T	5	11	16	0	0	16	0	0
11	7179259	.	T	C	5	2	7	0	1	8	0	0
11	7192840	.	T	G	1	0	1	0	9	10	0	0
11	7198484	.	G	A	4	9	13	0	1	14	0	0
11	7198517	.	A	G	5	11	16	0	2	18	0	0
11	7198607	.	G	A	4	3	7	0	1	8	0	0
11	7198724	.	G	A	4	4	8	0	0	8	0	0
11	7201648	.	T	C	11	8	19	0	0	19	0	0
11	7201654	.	C	T	11	9	20	0	0	20	0	0
11	7202315	.	C	T	7	6	13	0	0	13	0	0
11	7202321	.	G	A	1	9	10	0	9	19	0	0
11	7211908	.	A	G	19	7	26	0	3	29	0	0
11	7212029	.	A	G	2	7	9	0	0	9	0	0
11	7277061	.	A	G	10	5	15	0	0	15	0	0
11	7277310	.	T	C	19	16	35	0	2	37	0	0
11	7277315	.	T	C	20	16	36	0	2	38	0	0
11	7279587	.	G	A	8	6	14	1	0	15	0	0
11	7282499	.	C	T	10	9	19	0	0	19	0	0
11	7283033	.	G	T	11	9	20	0	0	20	0	0
11	7283138	.	A	T	6	6	12	0	2	14	0	0
11	7283444	.	C	T	0	4	4	0	8	12	0	0
11	7283525	.	A	G	6	7	13	0	0	13	0	0
11	7283888	.	G	T	5	6	11	0	0	11	0	0
11	7283900	.	G	A	4	6	10	0	0	10	0	0
11	7284488	.	G	A	6	6	12	0	0	12	0	0
11	7284520	.	A	T	4	6	10	0	0	10	0	0
11	7284603	.	G	T	3	5	8	0	0	8	0	0
11	7284692	.	T	C	6	0	6	0	3	9	0	0
11	7284697	.	T	G	5	3	8	0	0	8	0	0
11	7285109	.	C	T	4	8	12	0	1	13	0	0
11	7285163	.	T	A	5	3	8	0	0	8	0	0
11	7285487	.	T	C	5	4	9	0	0	9	0	0
11	7285732	.	G	A	3	3	6	0	1	7	0	0
11	7285801	.	G	A	2	2	4	0	0	4	0	0
11	7299005	.	A	T	2	1	3	0	0	3	0	0
11	7299022	.	C	T	3	2	5	0	0	5	0	0
11	7299040	.	A	G	2	2	4	0	1	5	0	0
11	7305923	.	G	A	4	2	6	0	0	6	0	0
11	7340143	.	A	G	28	25	53	0	2	55	0	0
11	7341031	.	G	A	30	28	58	0	1	59	0	0
11	7528955	.	T	G	2	4	6	0	0	6	0	0
11	7529109	.	C	T	4	2	6	0	0	6	0	0
11	7580158	.	C	T	2	2	4	0	0	4	0	0
11	7628282	.	T	C	5	2	7	0	0	7	0	0
11	7628285	.	T	C	6	2	8	0	0	8	0	0
11	7692036	.	T	C	5	5	10	0	0	10	0	0
11	7696584	.	G	T	5	4	9	0	1	10	0	0
11	7734898	.	A	G	9	0	9	0	13	22	0	0
11	7735869	.	C	G	25	13	38	0	1	39	0	0
11	7735905	.	T	A	25	14	39	0	1	40	0	0
11	7735937	.	T	A	20	13	33	0	0	33	0	0
11	7736482	.	T	G	9	0	9	0	3	12	0	0
11	7736576	.	G	A	17	22	39	0	1	40	0	0
11	7736589	.	G	T	20	21	41	0	0	41	0	0
11	7981303	.	A	C	6	7	13	0	1	14	0	0
11	7981427	.	C	T	4	8	12	0	0	12	0	0
11	7981613	.	T	C	17	20	37	0	0	37	0	0
11	7981912	.	T	C	13	0	13	0	13	26	0	0
11	7981915	.	T	A	13	12	25	0	2	27	0	0
11	7982114	.	C	T	11	4	15	0	0	15	0	0
11	7982122	.	T	A	9	6	15	0	2	17	0	0
11	7982205	.	T	C	6	0	6	0	9	15	0	0
11	7982263	.	T	G	4	6	10	0	0	10	0	0
11	7982321	.	T	A	7	4	11	0	0	11	0	0
11	7982566	.	T	A	3	8	11	0	5	16	0	0
11	7982774	.	T	A	11	12	23	0	1	24	0	0
11	7982791	.	C	T	9	15	24	0	2	26	0	0
11	7982835	.	C	T	7	13	20	0	0	20	0	0
11	7982869	.	C	T	7	8	15	0	0	15	0	0
11	7983236	.	T	A	8	6	14	0	0	14	0	0
11	7983270	.	T	G	9	11	20	0	1	21	0	0
11	7983348	.	C	A	17	12	29	0	0	29	0	0
11	7983631	.	C	T	1	11	12	0	16	28	0	0
11	7983709	.	T	A	9	8	17	0	3	20	0	0
11	7983734	.	A	G	9	9	18	0	0	18	0	0
11	7983757	.	A	T	7	8	15	0	0	15	0	0
11	7983877	.	C	A	2	2	4	0	0	4	0	0
11	7984165	.	T	C	7	8	15	0	1	16	0	0
11	7984181	.	A	T	8	7	15	0	1	16	0	0
11	7984264	.	A	T	5	8	13	0	0	13	0	0
11	7984350	.	A	T	6	4	10	0	0	10	0	0
11	7984666	.	T	A	7	11	18	0	0	18	0	0
11	8003638	.	A	G	3	3	6	0	0	6	0	0
11	8012466	.	T	A	10	9	19	0	2	21	0	0
11	8012535	.	A	G	2	4	6	0	1	7	0	0
11	8097547	.	A	G	3	5	8	0	0	8	0	0
11	8104328	.	A	G	1	2	3	0	2	5	0	0
11	8104334	.	T	A	1	3	4	0	0	4	0	0
11	8104375	.	G	A	2	3	5	0	0	5	0	0
11	8153771	.	C	T	7	4	11	0	1	12	0	0
11	8156967	.	C	T	6	7	13	0	0	13	0	0
11	8156972	.	C	T	7	7	14	0	0	14	0	0
11	8157002	.	C	G	8	7	15	0	0	15	0	0
11	8305425	.	A	G	2	1	3	0	0	3	0	0
11	8305435	.	G	T	3	2	5	0	0	5	0	0
11	8662864	.	G	A	0	11	11	0	6	17	0	0
11	8672749	.	A	C	12	6	18	0	2	20	0	0
11	8672992	.	G	T	1	3	4	0	21	25	0	0
11	8673002	.	T	C	18	5	23	0	2	25	0	0
11	8681619	.	G	T	18	17	35	0	2	37	0	0
11	8681714	.	T	C	17	14	31	0	1	32	0	0
11	8681750	.	G	A	12	7	19	0	3	22	0	0
11	8682248	.	T	A	8	4	12	0	1	13	0	0
11	8682273	.	G	A	5	4	9	0	3	12	0	0
11	8682331	.	T	C	5	3	8	0	1	9	0	0
11	8697347	.	A	G	3	4	7	0	0	7	0	0
11	8697422	.	A	G	5	3	8	0	0	8	0	0
11	8697428	.	C	A	7	2	9	0	1	10	0	0
11	9564746	.	G	A	2	7	9	0	0	9	0	0
11	9565728	.	A	G	1	2	3	0	0	3	0	0
11	9566277	.	C	T	1	2	3	0	0	3	0	0
11	10389284	.	A	G	6	6	12	0	0	12	0	0
11	10402081	.	G	A	4	6	10	0	0	10	0	0
11	10468569	.	C	T	1	2	3	0	3	6	0	0
11	10468756	.	T	C	1	3	4	0	0	4	0	0
11	10468772	.	T	A	1	1	2	0	1	3	0	0
11	10669933	.	G	T	26	33	59	0	3	62	0	0
11	10670112	.	T	A	14	25	39	0	2	41	0	0
11	10670394	.	C	T	33	19	52	0	0	52	0	0
11	10671525	.	A	G	18	25	43	0	3	46	0	0
11	10671546	.	A	G	23	19	42	0	2	44	0	0
11	10671578	.	A	T	20	21	41	0	1	42	0	0
11	10671636	.	C	T	2	20	22	0	7	29	0	0
11	10671831	.	T	C	17	8	25	0	3	28	0	0
11	10671836	.	T	C	12	12	24	0	5	29	0	0
11	10672087	.	T	C	32	9	41	0	3	44	0	0
11	10672250	.	T	C	4	0	4	0	6	10	0	0
11	10672707	.	T	G	16	12	28	0	2	30	0	0
11	10672726	.	T	A	16	20	36	0	2	38	0	0
11	10672750	.	T	C	17	20	37	0	1	38	0	0
11	10713757	.	G	A	6	7	13	0	0	13	0	0
11	10713796	.	C	T	6	9	15	0	0	15	0	0
11	10720178	.	C	T	4	6	10	0	0	10	0	0
11	10720232	.	G	C	3	5	8	0	0	8	0	0
11	10720271	.	C	T	0	7	7	0	2	9	0	0
11	10720295	.	A	G	1	5	6	0	0	6	0	0
11	10725775	.	G	A	6	7	13	0	0	13	0	0
11	10832957	.	G	T	10	19	29	0	0	29	0	0
11	10835571	.	T	C	13	1	14	0	17	31	0	0
11	10842537	.	T	C	15	0	15	0	9	24	0	0
11	10842714	.	A	C	14	0	14	0	11	25	0	0
11	10909461	.	G	A	0	9	9	0	4	13	0	0
11	10958321	.	A	G	11	0	11	0	7	18	0	0
11	10959499	.	T	A	8	6	14	0	0	14	0	0
11	11154884	.	A	T	2	2	4	0	0	4	0	0
11	11171320	.	T	G	3	3	6	0	0	6	0	0
11	11171351	.	A	G	2	3	5	0	0	5	0	0
11	11171613	.	C	T	2	2	4	0	0	4	0	0
11	11177387	.	T	C	9	10	19	0	1	20	0	0
11	11177406	.	C	T	7	11	18	0	1	19	0	0
11	11177436	.	T	C	4	12	16	0	0	16	0	0
11	11177481	.	A	G	2	4	6	0	1	7	0	0
11	11181955	.	G	A	1	3	4	0	8	12	0	0
11	11181978	.	C	T	6	6	12	0	0	12	0	0
11	11182072	.	C	T	7	6	13	0	0	13	0	0
11	11184707	.	C	T	8	7	15	0	1	16	0	0
11	11184743	.	A	C	8	12	20	0	0	20	0	0
11	11184818	.	T	C	6	4	10	0	0	10	0	0
11	11185053	.	G	A	5	8	13	0	0	13	0	0
11	11185074	.	G	C	8	9	17	0	0	17	0	0
11	11185175	.	G	C	6	5	11	0	0	11	0	0
11	11186248	.	G	C	3	11	14	0	1	15	0	0
11	11191840	.	C	T	17	15	32	0	3	35	0	0
11	11191845	.	C	T	16	14	30	0	6	36	0	0
11	11191995	.	T	C	17	23	40	0	1	41	0	0
11	11192053	.	C	T	20	16	36	0	1	37	0	0
11	11192170	.	T	A	9	6	15	0	3	18	0	0
11	11192276	.	G	A	12	24	36	0	0	36	0	0
11	11192342	.	T	G	6	14	20	0	1	21	0	0
11	11192724	.	T	C	10	19	29	0	0	29	0	0
11	11193030	.	C	T	6	2	8	0	0	8	0	0
11	11272134	.	A	G	0	0	0	0	3	3	0	0
11	11274615	.	A	T	27	19	46	0	0	46	0	0
11	11319180	.	A	G	3	2	5	0	0	5	0	0
11	11324286	.	T	G	11	10	21	0	0	21	0	0
11	11324295	.	T	G	11	7	18	0	0	18	0	0
11	11325486	.	G	A	10	13	23	0	0	23	0	0
11	11325570	.	T	A	13	15	28	0	1	29	0	0
11	11326502	.	A	G	6	13	19	0	1	20	0	0
11	11326671	.	G	A	10	15	25	0	0	25	0	0
11	11326968	.	C	A	1	9	10	0	6	16	0	0
11	11333116	.	C	A	2	2	4	0	1	5	0	0
11	11333661	.	T	G	5	2	7	0	0	7	0	0
11	11333670	.	T	G	6	3	9	0	0	9	0	0
11	11468756	.	T	G	12	15	27	0	0	27	0	0
11	11469128	.	C	T	12	11	23	0	2	25	0	0
11	11469143	.	C	T	12	8	20	0	2	22	0	0
11	11469203	.	G	A	12	4	16	1	1	18	0	0
11	11469215	.	C	T	10	8	18	1	0	19	0	0
11	11469632	.	G	A	9	10	19	1	2	22	0	0
11	11469968	.	C	T	9	6	15	0	1	16	0	0
11	11470678	.	A	C	7	6	13	0	0	13	0	0
11	11470994	.	T	C	6	5	11	0	0	11	0	0
11	11471147	.	C	A	6	5	11	0	0	11	0	0
11	11471372	.	A	C	5	0	5	0	3	8	0	0
11	11471434	.	T	A	2	8	10	0	0	10	0	0
11	11516245	.	T	G	8	11	19	0	1	20	0	0
11	11516279	.	T	C	8	0	8	0	11	19	0	0
11	11518343	.	A	G	3	4	7	0	1	8	0	0
11	11597120	.	A	T	2	2	4	0	0	4	0	0
11	11597401	.	C	A	12	7	19	0	1	20	0	0
11	11597523	.	A	G	8	9	17	0	6	23	0	0
11	11597679	.	G	C	10	11	21	0	1	22	0	0
11	11597798	.	A	T	16	11	27	0	1	28	0	0
11	11598334	.	G	C	8	12	20	0	1	21	0	0
11	11602628	.	G	A	5	12	17	0	1	19	1	0
11	11605172	.	T	C	11	1	12	0	19	31	0	0
11	11605744	.	C	T	3	14	17	0	9	26	0	0
11	11607579	.	A	C	7	0	7	0	6	14	1	0
11	11607594	.	G	A	7	15	22	0	0	22	0	0
11	11612715	.	G	A	2	3	5	0	0	5	0	0
11	11612758	.	A	G	3	3	6	0	0	6	0	0
11	11612773	.	C	T	4	4	8	0	0	8	0	0
11	11614914	.	A	T	4	11	15	0	1	16	0	0
11	11614927	.	T	A	6	9	15	0	1	16	0	0
11	11616542	.	G	A	5	5	10	0	2	12	0	0
11	11619931	.	A	G	6	4	10	0	0	10	0	0
11	11624939	.	T	C	3	4	7	0	0	7	0	0
11	11625066	.	C	G	3	3	6	0	0	6	0	0
11	11625153	.	T	C	8	0	8	0	7	15	0	0
11	11625169	.	C	G	6	7	13	0	1	15	1	0
11	11625229	.	T	A	2	5	7	0	0	7	0	0
11	11625259	.	C	T	2	2	4	0	0	4	0	0
11	11780496	.	A	G	5	2	7	0	0	7	0	0
11	11780863	.	A	G	4	0	4	0	4	8	0	0
11	11780935	.	T	C	6	5	11	0	0	11	0	0
11	11866481	.	G	A	3	2	5	0	0	5	0	0
11	11868985	.	C	T	1	3	4	0	0	4	0	0
11	11875610	.	T	C	1	5	6	0	0	6	0	0
11	11875892	.	G	A	2	3	5	0	1	6	0	0
11	11893225	.	C	T	0	2	2	0	2	4	0	0
11	11895981	.	T	C	1	0	1	0	2	3	0	0
11	11911622	.	T	C	5	0	5	0	4	9	0	0
11	11918607	.	A	C	2	3	5	0	0	5	0	0
11	11918712	.	T	G	3	4	7	0	0	7	0	0
11	11922424	.	G	C	3	5	8	0	0	8	0	0
11	11922512	.	A	G	3	2	5	0	0	5	0	0
11	11929271	.	C	G	4	3	7	0	0	7	0	0
11	11932998	.	A	G	1	3	4	0	0	4	0	0
11	11942072	.	A	G	1	2	3	0	0	4	1	0
11	11942111	.	G	A	1	4	5	0	1	6	0	0
11	11942129	.	C	T	2	4	6	0	1	7	0	0
11	11979494	.	A	G	3	3	6	0	0	6	0	0
11	11979495	.	C	T	0	3	3	0	3	6	0	0
11	11983868	.	C	T	0	8	8	1	9	18	0	0
11	11984227	.	G	A	4	10	14	0	0	14	0	0
11	11984408	.	A	C	17	14	31	0	1	32	0	0
11	11984409	.	G	C	16	13	29	0	2	31	0	0
11	11984480	.	T	C	7	0	7	0	7	14	0	0
11	11984501	.	A	T	9	3	12	0	0	12	0	0
11	11984548	.	C	T	12	6	18	0	0	18	0	0
11	12004070	.	A	G	9	3	12	0	1	13	0	0
11	12004652	.	A	G	8	7	15	0	0	15	0	0
11	12010688	.	C	T	0	0	0	0	1	1	0	0
11	12010716	.	A	C	1	2	3	0	0	3	0	0
11	12011325	.	G	A	5	5	10	0	0	10	0	0
11	12016638	.	A	G	15	8	23	0	3	26	0	0
11	12016650	.	G	A	13	8	21	0	2	23	0	0
11	12096578	.	C	T	10	7	17	0	0	17	0	0
11	12096593	.	G	A	10	7	17	0	0	17	0	0
11	12108486	.	T	C	11	10	21	0	0	21	0	0
11	12108725	.	G	A	13	14	27	0	0	27	0	0
11	12108822	.	C	A	14	6	20	0	2	22	0	0
11	12118079	.	C	T	13	14	27	0	2	29	0	0
11	12118097	.	T	A	11	14	25	0	4	29	0	0
11	12130708	.	A	G	5	6	11	0	0	11	0	0
11	12131044	.	T	G	5	12	17	0	1	18	0	0
11	12145328	.	G	A	3	3	6	0	1	7	0	0
11	12146303	.	G	A	1	3	4	0	0	4	0	0
11	12732569	.	C	T	3	10	13	0	0	13	0	0
11	12732980	.	T	C	3	6	9	0	1	10	0	0
11	12783620	.	T	A	1	2	3	0	0	3	0	0
11	13282016	.	T	C	13	6	19	1	0	20	0	0
11	13282346	.	T	C	7	3	10	0	0	10	0	0
11	13505247	.	A	T	1	5	6	0	0	6	0	0
11	14073241	.	T	C	3	3	6	0	2	8	0	0
11	14073242	.	T	C	5	4	9	0	0	9	0	0
11	14073309	.	T	C	3	6	9	0	0	9	0	0
11	14160464	.	A	C	11	1	12	0	32	44	0	0
11	16006030	.	C	T	8	4	12	0	0	12	0	0
11	16011052	.	A	G	2	5	7	0	1	8	0	0
11	16011079	.	A	G	2	2	4	0	2	6	0	0
11	16012829	.	G	T	15	17	32	0	0	32	0	0
11	16095020	.	T	C	6	10	16	0	0	16	0	0
11	16095042	.	C	G	4	11	15	0	0	15	0	0
11	16099700	.	G	A	6	6	12	0	0	12	0	0
11	16104175	.	T	C	7	8	15	0	0	15	0	0
11	16115692	.	C	T	9	7	16	0	0	16	0	0
11	16143740	.	G	A	31	17	48	0	1	49	0	0
11	16143781	.	T	C	16	24	40	0	1	41	0	0
11	16153368	.	G	A	1	11	12	0	7	19	0	0
11	16158555	.	G	A	15	6	21	0	1	22	0	0
11	16159101	.	C	T	5	8	13	0	0	13	0	0
11	16159316	.	C	T	6	6	12	0	1	13	0	0
11	16159875	.	T	C	5	11	16	0	1	17	0	0
11	16159903	.	C	T	6	14	20	0	0	20	0	0
11	16159926	.	C	T	13	6	19	0	1	20	0	0
11	16160074	.	C	T	9	9	18	0	2	20	0	0
11	16165233	.	A	G	8	11	19	0	4	23	0	0
11	16165395	.	G	A	8	12	20	0	1	21	0	0
11	16172352	.	C	A	5	4	9	0	0	9	0	0
11	16177158	.	G	A	1	5	6	0	3	9	0	0
11	16179830	.	T	A	22	20	42	0	1	43	0	0
11	16179882	.	T	A	21	23	44	0	4	48	0	0
11	16184865	.	A	T	17	13	30	1	6	37	0	0
11	16192224	.	G	A	13	13	26	0	0	26	0	0
11	16214941	.	G	A	17	9	26	0	1	27	0	0
11	16238173	.	C	T	5	2	7	0	1	8	0	0
11	16281796	.	C	T	2	5	7	0	1	8	0	0
11	16329862	.	G	T	1	2	3	0	1	4	0	0
11	16329929	.	T	C	4	3	7	0	0	7	0	0
11	16330072	.	A	C	6	3	9	0	0	9	0	0
11	16330300	.	C	A	10	5	15	0	0	15	0	0
11	16330585	.	A	G	5	5	10	0	1	11	0	0
11	16330686	.	T	G	7	6	13	0	0	13	0	0
11	16330720	.	G	A	11	8	19	0	0	19	0	0
11	16331143	.	T	A	4	5	9	0	0	9	0	0
11	16331219	.	T	C	3	3	6	0	0	6	0	0
11	16331308	.	G	A	2	2	4	0	1	5	0	0
11	16331312	.	A	C	2	3	5	0	1	6	0	0
11	16331363	.	A	G	2	4	6	0	1	7	0	0
11	16331375	.	G	T	1	6	7	0	1	8	0	0
11	16331414	.	G	A	1	5	6	0	0	6	0	0
11	16331474	.	G	T	5	4	9	0	0	9	0	0
11	16331901	.	A	G	1	2	3	0	0	3	0	0
11	16331940	.	T	C	2	2	4	0	0	4	0	0
11	16583904	.	C	T	2	2	4	0	0	4	0	0
11	16583916	.	A	G	2	0	2	0	2	4	0	0
11	16583988	.	T	C	1	6	7	0	1	8	0	0
11	16584222	.	T	C	2	3	5	0	0	5	0	0
11	16584470	.	A	T	6	2	8	0	0	8	0	0
11	16584603	.	G	T	2	1	3	0	1	4	0	0
11	16584623	.	C	T	2	2	4	0	0	4	0	0
11	16585484	.	G	A	3	2	5	0	0	5	0	0
11	16585501	.	C	A	2	3	5	0	0	5	0	0
11	16585592	.	A	T	3	2	5	0	0	5	0	0
11	16585598	.	G	T	3	1	4	0	0	4	0	0
11	16586033	.	A	G	5	3	8	0	0	8	0	0
11	16586711	.	G	T	5	3	8	0	0	8	0	0
11	16586722	.	A	G	4	3	7	0	1	8	0	0
11	16586925	.	T	C	2	2	4	0	1	5	0	0
11	16587682	.	A	C	7	8	15	0	0	15	0	0
11	16587782	.	C	T	2	5	7	0	1	8	0	0
11	16587873	.	A	T	1	6	7	0	0	7	0	0
11	16739064	.	A	G	14	5	19	0	0	19	0	0
11	16849887	.	T	G	1	3	4	0	0	4	0	0
11	16849896	.	G	A	1	3	4	0	0	4	0	0
11	17096389	.	C	T	1	2	3	0	7	10	0	0
11	17512289	.	T	C	15	9	24	0	4	28	0	0
11	17512522	.	C	A	2	2	4	0	0	4	0	0
11	17513083	.	C	G	1	3	4	0	0	4	0	0
11	17597224	.	G	A	2	2	4	0	1	5	0	0
11	17597225	.	T	G	3	2	5	0	0	5	0	0
11	17597541	.	G	A	2	5	7	0	0	7	0	0
11	17597564	.	T	C	1	0	1	0	5	6	0	0
11	17608441	.	G	A	7	5	12	0	0	12	0	0
11	17713672	.	T	C	4	3	7	0	0	7	0	0
11	17757623	.	G	T	13	8	21	0	1	22	0	0
11	17757624	.	A	G	15	8	23	0	0	23	0	0
11	17757772	.	G	A	14	8	22	0	1	23	0	0
11	17763904	.	C	T	9	10	19	0	0	19	0	0
11	17763928	.	C	T	11	7	18	0	2	20	0	0
11	17765182	.	C	A	8	5	13	0	1	14	0	0
11	17765281	.	T	C	13	0	13	0	11	24	0	0
11	17765293	.	C	T	14	7	21	0	2	23	0	0
11	17765489	.	G	A	12	8	20	0	0	20	0	0
11	17765585	.	T	C	5	0	5	0	12	17	0	0
11	17765618	.	T	C	6	0	6	0	11	17	0	0
11	17769200	.	C	T	8	9	17	0	0	17	0	0
11	17769236	.	T	C	14	1	15	0	9	24	0	0
11	17769238	.	C	T	14	10	24	0	0	24	0	0
11	17769711	.	C	T	11	15	26	0	0	27	1	0
11	17770627	.	T	C	3	7	10	0	1	11	0	0
11	17771185	.	T	C	7	8	15	0	1	16	0	0
11	17778528	.	T	C	2	0	2	0	5	7	0	0
11	17778565	.	T	C	5	2	7	0	0	7	0	0
11	17778618	.	T	G	2	6	8	0	0	8	0	0
11	17778639	.	C	T	0	7	7	0	3	10	0	0
11	17779159	.	A	G	3	4	7	0	0	7	0	0
11	17779231	.	G	A	3	4	7	0	1	8	0	0
11	17779316	.	A	G	4	4	8	0	0	8	0	0
11	17779402	.	A	G	5	7	12	0	0	12	0	0
11	17779599	.	A	C	3	0	3	0	5	8	0	0
11	17782529	.	A	C	4	0	4	0	6	10	0	0
11	17782669	.	G	C	2	4	6	0	0	6	0	0
11	17782817	.	G	A	4	6	10	0	0	10	0	0
11	17782832	.	C	T	4	5	9	0	0	9	0	0
11	17785428	.	T	C	21	12	33	1	0	34	0	0
11	17789104	.	C	T	0	17	17	0	13	30	0	0
11	17789243	.	G	A	21	8	29	0	2	31	0	0
11	17797072	.	T	C	9	0	9	0	7	16	0	0
11	17984405	.	G	A	0	4	4	0	5	9	0	0
11	17984503	.	A	G	2	4	6	0	0	6	0	0
11	17987007	.	A	G	2	4	6	0	0	6	0	0
11	17987038	.	A	T	1	4	5	0	0	5	0	0
11	17994250	.	A	G	2	2	4	0	0	4	0	0
11	17994251	.	C	T	2	2	4	0	0	4	0	0
11	18010235	.	G	A	5	4	9	0	0	9	0	0
11	18205868	.	A	C	3	3	6	0	0	6	0	0
11	18216527	.	G	T	4	3	7	0	0	7	0	0
11	18216643	.	G	A	5	5	10	0	0	10	0	0
11	18223337	.	C	T	8	11	19	0	1	20	0	0
11	18223365	.	T	C	6	11	17	0	0	17	0	0
11	18223383	.	C	T	9	5	14	0	0	14	0	0
11	18237862	.	G	A	7	12	19	0	1	20	0	0
11	18238076	.	C	T	11	16	27	0	0	27	0	0
11	18238171	.	T	C	11	12	23	0	2	25	0	0
11	18243966	.	A	G	12	6	18	0	0	18	0	0
11	18244388	.	T	C	10	8	18	0	6	24	0	0
11	18252912	.	C	T	1	2	3	0	0	3	0	0
11	18271303	.	G	A	6	10	16	0	0	16	0	0
11	18277370	.	C	T	1	7	8	0	4	12	0	0
11	18277388	.	G	A	2	8	10	0	0	10	0	0
11	18283126	.	C	T	3	3	6	0	0	6	0	0
11	18283525	.	T	C	3	0	3	0	5	8	0	0
11	18287316	.	G	A	6	10	16	0	0	16	0	0
11	18287378	.	C	T	1	16	17	0	6	23	0	0
11	18287506	.	A	G	3	4	7	0	0	7	0	0
11	18287687	.	T	A	10	5	15	0	0	15	0	0
11	18287779	.	G	A	9	4	13	0	0	13	0	0
11	18287895	.	T	G	5	6	11	0	0	11	0	0
11	18287940	.	A	T	4	5	9	0	2	11	0	0
11	18288275	.	C	A	0	4	4	0	8	12	0	0
11	18288347	.	G	A	6	13	19	0	0	19	0	0
11	18289356	.	C	T	6	4	10	0	1	11	0	0
11	18290095	.	G	A	5	5	10	0	0	10	0	0
11	18291853	.	T	A	13	9	22	0	0	22	0	0
11	18291943	.	C	T	4	4	8	0	3	11	0	0
11	18292675	.	C	T	11	6	17	0	0	17	0	0
11	18294911	.	A	G	2	8	10	0	0	10	0	0
11	18295057	.	T	C	4	3	7	0	0	7	0	0
11	18304255	.	T	A	3	6	9	0	0	9	0	0
11	18305804	.	C	G	3	3	6	0	0	6	0	0
11	18315955	.	C	T	1	2	3	0	0	3	0	0
11	18345635	.	G	A	3	2	5	0	0	5	0	0
11	18345719	.	T	G	3	3	6	0	0	6	0	0
11	18346002	.	T	C	1	2	3	0	0	3	0	0
11	18347224	.	G	A	2	2	4	0	0	4	0	0
11	18398392	.	C	G	1	3	4	0	0	4	0	0
11	18398555	.	T	G	3	2	5	0	0	5	0	0
11	18398578	.	T	G	3	2	5	0	0	5	0	0
11	18465321	.	A	T	1	2	3	0	0	3	0	0
11	18465322	.	A	C	1	2	3	0	0	3	0	0
11	18536769	.	G	A	11	16	27	0	0	27	0	0
11	18536800	.	C	T	1	11	12	0	16	28	0	0
11	18536864	.	G	T	17	13	30	1	0	31	0	0
11	18536866	.	G	A	15	11	26	1	2	29	0	0
11	18537180	.	A	G	10	9	19	0	1	20	0	0
11	18537244	.	G	A	11	6	17	0	4	21	0	0
11	18537447	.	T	C	9	7	16	0	0	16	0	0
11	18537636	.	T	A	8	13	21	0	0	21	0	0
11	18537649	.	G	A	7	14	21	0	2	23	0	0
11	18538122	.	A	T	8	11	19	0	1	20	0	0
11	18538336	.	A	C	12	0	12	0	13	25	0	0
11	18538362	.	T	C	14	0	14	0	13	27	0	0
11	18538910	.	C	T	4	4	8	0	1	9	0	0
11	18539155	.	G	C	5	6	11	0	1	12	0	0
11	18539616	.	C	A	3	3	6	0	2	8	0	0
11	18541017	.	T	A	4	3	7	0	0	7	0	0
11	18542168	.	T	C	1	5	6	0	1	7	0	0
11	18542585	.	A	G	5	5	10	0	0	10	0	0
11	18543543	.	T	A	3	3	6	0	0	6	0	0
11	18543558	.	T	C	2	0	2	0	4	6	0	0
11	18543870	.	A	G	4	4	8	0	1	9	0	0
11	18546276	.	T	A	5	4	9	0	0	9	0	0
11	18546357	.	T	A	5	6	11	0	2	13	0	0
11	18547125	.	A	G	13	12	25	0	2	27	0	0
11	18551089	.	G	A	2	4	6	1	1	8	0	0
11	18551120	.	C	T	1	7	8	0	2	10	0	0
11	18561144	.	T	C	5	2	7	0	0	7	0	0
11	18561432	.	C	G	5	3	8	0	0	8	0	0
11	18561477	.	T	G	4	2	6	0	0	6	0	0
11	18561538	.	C	T	3	3	6	0	0	6	0	0
11	18561590	.	G	A	10	6	16	0	0	16	0	0
11	18561635	.	T	A	13	6	19	0	2	21	0	0
11	18561674	.	C	T	10	6	16	0	1	17	0	0
11	18561792	.	T	C	20	0	20	0	9	29	0	0
11	18561816	.	A	G	17	4	21	0	0	21	0	0
11	18562059	.	T	G	10	10	20	0	0	20	0	0
11	18562132	.	G	T	4	5	9	0	1	10	0	0
11	18562213	.	A	T	3	3	6	0	0	6	0	0
11	18562303	.	T	C	4	6	10	0	0	10	0	0
11	18562420	.	G	T	8	5	13	0	2	15	0	0
11	18562448	.	T	C	10	0	10	0	9	19	0	0
11	18562655	.	T	C	7	0	7	0	6	13	0	0
11	18562730	.	G	T	12	5	17	0	1	18	0	0
11	18569158	.	A	T	11	12	23	0	0	23	0	0
11	18569298	.	G	A	13	10	23	0	0	23	0	0
11	18569379	.	A	G	9	17	26	0	2	28	0	0
11	18572364	.	T	C	12	1	13	0	14	27	0	0
11	18572586	.	C	T	8	13	21	0	1	22	0	0
11	18572640	.	T	G	14	6	20	0	1	21	0	0
11	18572648	.	G	A	14	9	23	0	0	23	0	0
11	18575031	.	G	C	7	4	11	0	0	11	0	0
11	18575148	.	C	T	11	4	15	0	1	16	0	0
11	18575299	.	A	G	6	7	13	0	0	13	0	0
11	18577262	.	T	C	3	3	6	0	1	7	0	0
11	18577787	.	A	G	7	5	12	0	1	13	0	0
11	18579868	.	G	A	4	14	18	0	2	20	0	0
11	18579912	.	A	G	6	13	19	0	1	20	0	0
11	18580170	.	T	C	1	0	1	0	3	4	0	0
11	18586264	.	T	C	4	0	4	0	8	12	0	0
11	18586445	.	T	C	3	5	8	0	1	9	0	0
11	18586759	.	A	G	3	4	7	0	0	7	0	0
11	18589439	.	C	T	3	3	6	0	0	6	0	0
11	18681086	.	C	G	2	3	5	0	0	5	0	0
11	18681103	.	G	A	0	4	4	0	2	6	0	0
11	18681298	.	C	T	2	2	4	0	0	4	0	0
11	18681382	.	A	G	3	0	3	0	4	7	0	0
11	18681547	.	A	G	1	0	1	0	2	3	0	0
11	18681631	.	G	T	0	6	6	0	4	10	0	0
11	18682694	.	A	G	4	9	13	0	0	13	0	0
11	18682826	.	T	C	1	2	3	0	0	3	0	0
11	18686477	.	A	C	3	4	7	0	0	7	0	0
11	18686492	.	G	A	4	4	8	0	1	9	0	0
11	18686513	.	C	T	7	4	11	0	0	11	0	0
11	18686528	.	T	C	7	4	11	0	0	11	0	0
11	18688956	.	T	C	4	10	14	0	3	17	0	0
11	18697817	.	T	G	14	8	22	0	0	22	0	0
11	18698138	.	A	G	5	1	6	0	3	9	0	0
11	18698256	.	G	T	3	2	5	0	0	5	0	0
11	18698526	.	G	A	5	6	11	0	0	11	0	0
11	18698767	.	A	T	3	5	8	0	1	9	0	0
11	18699104	.	T	C	9	13	22	0	0	22	0	0
11	18704378	.	G	C	12	0	12	0	3	15	0	0
11	18704383	.	T	A	12	3	15	0	1	16	0	0
11	18704500	.	G	A	23	13	36	0	1	37	0	0
11	18704620	.	C	T	5	20	25	0	20	45	0	0
11	18705108	.	A	G	24	20	44	0	0	44	0	0
11	18784949	.	A	T	16	6	22	0	0	22	0	0
11	18784975	.	C	A	19	9	28	0	1	29	0	0
11	18785019	.	G	A	15	17	32	0	0	32	0	0
11	18785022	.	G	A	15	17	32	0	1	33	0	0
11	18785159	.	G	T	21	16	37	0	1	38	0	0
11	18785214	.	T	C	19	25	44	0	3	47	0	0
11	18785309	.	G	A	18	9	27	0	6	33	0	0
11	18785410	.	G	A	12	16	28	0	1	29	0	0
11	18785421	.	A	G	14	15	29	0	0	29	0	0
11	18785749	.	C	G	5	7	12	0	0	12	0	0
11	18785854	.	A	G	8	7	15	0	1	16	0	0
11	18786085	.	A	T	7	13	20	0	1	21	0	0
11	18794073	.	T	A	9	9	18	0	2	20	0	0
11	18794157	.	C	A	1	7	8	0	7	15	0	0
11	18794329	.	A	G	4	8	12	0	0	12	0	0
11	18794627	.	T	A	8	5	13	0	1	14	0	0
11	18799832	.	A	T	1	8	9	0	0	9	0	0
11	18799841	.	C	G	2	7	9	0	0	9	0	0
11	18802570	.	T	C	1	3	4	0	0	4	0	0
11	18803095	.	C	T	1	6	7	0	7	14	0	0
11	18803621	.	A	G	5	3	8	0	1	9	0	0
11	19013597	.	C	T	8	5	13	0	0	13	0	0
11	19041852	.	C	T	6	5	11	0	1	12	0	0
11	19042020	.	T	C	8	9	17	0	0	17	0	0
11	19042026	.	A	G	6	10	16	0	1	17	0	0
11	19042092	.	T	C	2	10	12	0	0	12	0	0
11	19042212	.	T	C	12	5	17	0	0	17	0	0
11	19072566	.	A	T	22	14	36	0	3	39	0	0
11	19072695	.	G	A	22	15	37	0	0	37	0	0
11	19072728	.	G	A	0	19	19	0	19	38	0	0
11	19072746	.	A	T	16	24	40	0	0	40	0	0
11	19085099	.	G	A	8	8	16	0	0	16	0	0
11	19089724	.	T	C	19	27	46	0	3	49	0	0
11	19090455	.	C	T	23	22	45	0	3	48	0	0
11	19090597	.	A	G	36	21	57	0	0	57	0	0
11	19434095	.	A	C	3	5	8	0	2	10	0	0
11	19434132	.	T	C	3	6	9	0	0	9	0	0
11	19434239	.	T	C	8	5	13	0	0	13	0	0
11	19434279	.	T	C	6	5	11	0	0	11	0	0
11	19434290	.	T	C	3	4	7	0	1	8	0	0
11	19456886	.	C	T	1	1	2	0	1	3	0	0
11	19464759	.	C	G	5	5	10	0	1	11	0	0
11	19464837	.	C	T	6	6	12	0	1	13	0	0
11	19465029	.	T	C	13	7	20	0	3	23	0	0
11	19465080	.	T	C	11	6	17	0	3	20	0	0
11	19465149	.	T	C	10	13	23	0	0	23	0	0
11	19465174	.	C	T	9	12	21	0	1	22	0	0
11	19465269	.	T	C	13	11	24	0	0	24	0	0
11	19465302	.	A	T	11	8	19	0	1	20	0	0
11	19467673	.	G	A	12	8	20	2	2	25	1	0
11	19467838	.	C	T	18	14	32	1	1	34	0	0
11	19468104	.	C	T	17	22	39	0	1	40	0	0
11	19468123	.	T	C	17	22	39	0	2	41	0	0
11	19468147	.	C	T	24	15	39	0	2	42	1	0
11	19468301	.	A	G	16	2	18	0	14	32	0	0
11	19468330	.	A	G	17	0	17	0	21	38	0	0
11	19468547	.	C	A	11	23	34	0	0	34	0	0
11	19468697	.	G	T	11	13	24	0	2	26	0	0
11	19468718	.	A	G	17	13	30	0	1	31	0	0
11	19502479	.	T	C	13	17	30	0	5	35	0	0
11	19503920	.	T	A	17	10	27	0	2	29	0	0
11	19505967	.	T	C	13	22	35	0	1	36	0	0
11	19506155	.	A	G	10	15	25	0	2	27	0	0
11	19509643	.	T	C	18	12	30	0	3	33	0	0
11	19511392	.	G	A	13	17	30	1	0	31	0	0
11	19511922	.	A	C	1	3	4	0	0	4	0	0
11	19511983	.	G	A	2	6	8	0	1	9	0	0
11	19512469	.	C	T	5	3	8	0	0	8	0	0
11	19512482	.	A	G	6	2	8	0	0	8	0	0
11	19512749	.	T	C	2	4	6	0	0	6	0	0
11	19512947	.	A	T	3	3	6	0	1	7	0	0
11	19513179	.	T	A	1	2	3	0	0	3	0	0
11	19513188	.	T	G	0	2	2	0	0	2	0	0
11	19513245	.	C	T	1	5	6	0	0	6	0	0
11	19513395	.	A	G	0	3	3	0	1	4	0	0
11	19513484	.	G	A	1	2	3	0	0	3	0	0
11	19513500	.	A	G	1	2	3	0	0	3	0	0
11	19514511	.	A	C	3	2	5	0	0	5	0	0
11	19606676	.	T	C	9	7	16	0	0	16	0	0
11	19607131	.	T	C	14	12	26	0	0	26	0	0
11	19611215	.	C	T	6	5	11	0	1	12	0	0
11	19624552	.	C	T	3	2	5	0	0	5	0	0
11	19624616	.	A	T	3	12	15	1	0	16	0	0
11	19624730	.	T	G	4	10	14	0	1	15	0	0
11	19625524	.	C	T	1	5	6	1	16	23	0	0
11	19625535	.	C	T	16	5	21	1	0	22	0	0
11	19625617	.	A	T	8	6	14	0	2	16	0	0
11	19625621	.	G	A	2	2	4	0	4	15	7	0
11	19625673	.	A	T	4	10	14	0	0	14	0	0
11	19625732	.	A	G	3	13	16	0	0	16	0	0
11	19625790	.	C	T	8	3	11	0	0	11	0	0
11	19625804	.	C	T	2	9	11	0	0	11	0	0
11	19625840	.	G	T	1	7	8	0	1	9	0	0
11	19626274	.	A	G	1	1	2	0	0	2	0	0
11	19626393	.	A	G	1	4	5	0	0	5	0	0
11	19626720	.	G	A	1	2	3	0	0	3	0	0
11	19626959	.	A	G	1	4	5	0	0	5	0	0
11	19627157	.	T	A	2	7	9	0	0	9	0	0
11	19627169	.	A	T	3	5	8	0	2	10	0	0
11	19627277	.	A	T	2	5	7	0	0	7	0	0
11	19627378	.	G	A	1	3	4	0	0	4	0	0
11	19627452	.	T	C	2	2	4	0	0	4	0	0
11	19639197	.	C	T	0	3	3	0	1	4	0	0
11	19729842	.	A	T	2	2	4	0	0	4	0	0
11	19729925	.	G	A	3	8	11	0	1	12	0	0
11	19729965	.	T	A	10	8	18	0	0	18	0	0
11	19730001	.	A	C	8	0	8	0	8	16	0	0
11	19733160	.	A	G	3	8	11	0	0	11	0	0
11	19743060	.	C	T	2	2	4	0	0	4	0	0
11	19836147	.	T	C	2	2	4	0	0	4	0	0
11	19951119	.	G	A	1	4	5	0	0	5	0	0
11	19986297	.	C	T	3	2	5	0	0	5	0	0
11	20017793	.	A	G	10	3	13	0	0	13	0	0
11	20017802	.	A	G	4	10	14	0	0	14	0	0
11	20036591	.	G	A	11	12	23	0	1	24	0	0
11	20039868	.	G	C	4	7	11	0	0	11	0	0
11	20039877	.	G	A	3	5	8	0	1	9	0	0
11	20039979	.	T	C	5	2	7	0	0	7	0	0
11	20040014	.	T	A	6	7	13	0	0	13	0	0
11	20040145	.	T	G	8	0	8	0	14	22	0	0
11	20636107	.	C	A	1	2	3	0	0	3	0	0
11	20787999	.	C	T	9	5	14	0	0	14	0	0
11	20788014	.	G	A	2	4	6	0	7	13	0	0
11	20794150	.	T	C	9	7	16	0	0	16	0	0
11	20815757	.	A	G	7	0	7	0	9	16	0	0
11	20826358	.	T	C	14	17	31	0	1	32	0	0
11	21154747	.	A	T	5	5	10	0	0	10	0	0
11	21154786	.	A	C	6	5	11	0	0	11	0	0
11	21155290	.	G	A	14	9	23	0	0	23	0	0
11	21155829	.	A	G	4	5	9	0	1	10	0	0
11	21156278	.	G	A	3	9	12	0	0	12	0	0
11	21156372	.	G	A	5	6	11	0	0	11	0	0
11	21158423	.	C	A	0	5	5	0	6	11	0	0
11	21158774	.	A	G	5	3	8	0	0	8	0	0
11	21158792	.	G	A	4	4	8	0	0	8	0	0
11	21158858	.	G	A	3	5	8	0	0	8	0	0
11	21218070	.	G	A	1	4	5	0	0	5	0	0
11	21259665	.	T	A	3	9	12	0	0	12	0	0
11	21259968	.	A	G	1	2	3	0	2	5	0	0
11	21260060	.	C	T	2	4	6	0	0	6	0	0
11	21260092	.	T	C	3	0	3	0	5	8	0	0
11	21279025	.	G	A	14	12	26	0	2	28	0	0
11	21279827	.	T	C	2	7	9	0	2	11	0	0
11	21279861	.	T	G	5	17	22	0	0	22	0	0
11	21279885	.	A	G	4	19	23	0	2	25	0	0
11	21280003	.	T	C	0	4	4	0	0	4	0	0
11	21280149	.	G	T	16	11	27	0	1	28	0	0
11	21280202	.	A	T	11	13	24	0	0	24	0	0
11	21280236	.	C	A	11	9	20	0	2	22	0	0
11	21280284	.	T	A	11	9	20	0	0	21	1	0
11	21280347	.	C	T	9	8	17	0	0	17	0	0
11	21280349	.	G	A	8	7	15	0	2	17	0	0
11	21280636	.	T	A	3	6	9	0	1	10	0	0
11	21280638	.	A	T	4	7	11	0	0	11	0	0
11	21280690	.	T	C	8	5	13	0	0	13	0	0
11	21280848	.	T	A	16	2	18	0	0	18	0	0
11	21280864	.	A	G	11	3	14	0	1	15	0	0
11	21280926	.	T	C	5	5	10	0	0	10	0	0
11	21281017	.	A	T	4	6	10	1	0	11	0	0
11	21281110	.	G	A	16	21	37	0	0	37	0	0
11	21281138	.	G	A	16	14	30	0	1	31	0	0
11	21281148	.	G	A	16	12	28	0	1	29	0	0
11	21281311	.	A	T	12	7	19	0	0	20	1	0
11	21281328	.	C	T	10	4	14	0	0	14	0	0
11	21281516	.	G	A	7	7	14	0	2	16	0	0
11	21281599	.	T	C	6	9	15	0	0	15	0	0
11	21281657	.	T	C	18	10	28	0	1	29	0	0
11	21281658	.	T	C	20	10	30	0	0	30	0	0
11	21281876	.	T	C	3	7	10	0	0	10	0	0
11	21281951	.	A	G	2	3	5	0	0	5	0	0
11	21282191	.	C	T	0	2	2	0	1	3	0	0
11	21282208	.	T	C	1	3	4	0	0	4	0	0
11	21282302	.	A	C	2	0	2	0	4	6	0	0
11	21282355	.	G	A	10	5	15	0	2	17	0	0
11	21282673	.	G	T	11	9	20	0	0	21	1	0
11	21282809	.	A	T	5	3	8	0	1	9	0	0
11	21283211	.	G	A	11	7	18	0	1	19	0	0
11	21284400	.	A	T	10	7	17	0	2	19	0	0
11	21363171	.	C	T	5	3	8	0	0	8	0	0
11	21363271	.	A	C	2	2	4	0	0	4	0	0
11	21407073	.	C	A	1	18	19	0	11	30	0	0
11	21407091	.	T	C	7	0	7	0	17	24	0	0
11	21407500	.	G	A	9	7	16	0	1	17	0	0
11	21407540	.	A	G	16	8	24	0	0	24	0	0
11	21407591	.	G	A	16	7	23	0	1	24	0	0
11	21407692	.	C	G	11	11	22	0	1	23	0	0
11	21407782	.	G	T	17	10	27	0	2	29	0	0
11	21407843	.	C	T	6	8	14	0	0	14	0	0
11	21407862	.	A	T	7	5	12	0	1	13	0	0
11	21407895	.	C	G	10	4	14	0	0	14	0	0
11	21407901	.	T	C	8	3	11	0	1	12	0	0
11	21408103	.	G	T	5	5	10	0	0	10	0	0
11	21408201	.	T	A	13	8	21	1	0	22	0	0
11	21408202	.	T	C	13	8	21	1	0	22	0	0
11	21408242	.	C	T	15	7	22	1	1	24	0	0
11	21408243	.	T	C	15	6	21	1	1	23	0	0
11	21408423	.	T	A	1	2	3	0	0	3	0	0
11	21408525	.	A	G	5	11	16	0	0	16	0	0
11	21408590	.	A	G	6	5	11	0	0	11	0	0
11	21409037	.	A	T	3	2	5	0	1	6	0	0
11	21409236	.	A	T	9	3	12	0	0	12	0	0
11	21409251	.	A	G	11	3	14	0	0	14	0	0
11	21409289	.	T	G	14	4	18	0	0	18	0	0
11	21409471	.	C	T	8	6	14	1	4	19	0	0
11	21409690	.	A	G	17	6	23	0	0	23	0	0
11	21409981	.	C	A	8	11	19	0	0	19	0	0
11	21410009	.	A	G	6	7	13	0	2	15	0	0
11	21410542	.	T	C	10	0	10	0	15	25	0	0
11	21410584	.	G	A	10	12	22	0	0	22	0	0
11	21413929	.	C	T	6	8	14	0	1	15	0	0
11	21414067	.	T	C	3	0	3	0	5	8	0	0
11	21419325	.	G	A	7	12	19	0	0	19	0	0
11	21419637	.	A	C	9	4	13	0	0	13	0	0
11	21427219	.	T	C	6	6	12	0	0	12	0	0
11	21434465	.	G	A	2	2	4	0	0	4	0	0
11	21457875	.	C	T	2	5	7	0	0	7	0	0
11	21457932	.	A	G	3	3	6	0	0	6	0	0
11	21594510	.	C	T	1	3	4	0	0	4	0	0
11	21595351	.	G	A	0	4	4	0	2	6	0	0
11	21596865	.	A	T	2	3	5	0	0	5	0	0
11	21596926	.	T	A	3	2	5	1	1	7	0	0
11	21596994	.	T	G	2	3	5	0	0	5	0	0
11	21597584	.	T	C	5	6	11	0	1	12	0	0
11	21597742	.	T	A	6	4	10	0	0	10	0	0
11	21597988	.	C	T	3	5	8	0	0	8	0	0
11	21598121	.	G	A	0	4	4	0	7	11	0	0
11	22070621	.	C	T	4	7	11	0	1	12	0	0
11	22089476	.	A	C	5	3	8	0	1	9	0	0
11	22089477	.	T	A	6	3	9	0	0	9	0	0
11	22089697	.	C	T	5	4	9	0	0	9	0	0
11	22089738	.	C	T	1	3	4	0	1	5	0	0
11	22090203	.	C	T	5	6	11	0	0	11	0	0
11	22090277	.	G	T	3	7	10	0	2	12	0	0
11	22090279	.	T	C	4	5	9	0	3	12	0	0
11	22090445	.	C	G	6	5	11	0	0	11	0	0
11	22090903	.	C	T	1	6	7	0	0	7	0	0
11	22091149	.	T	A	1	3	4	0	0	4	0	0
11	22091956	.	C	A	14	13	27	0	3	30	0	0
11	22092158	.	G	A	15	18	33	0	1	34	0	0
11	22092181	.	A	T	18	12	30	0	2	32	0	0
11	22092244	.	A	T	18	8	26	0	0	26	0	0
11	22093634	.	G	A	20	19	39	0	0	39	0	0
11	22167813	.	A	T	2	2	4	0	0	4	0	0
11	22288188	.	G	A	2	4	6	0	0	6	0	0
11	22289862	.	C	T	2	2	4	0	0	4	0	0
11	22363768	.	A	T	10	5	15	0	0	15	0	0
11	22366703	.	C	T	2	12	14	0	14	28	0	0
11	22366709	.	G	T	13	12	25	0	2	27	0	0
11	22369922	.	G	A	8	7	15	0	1	16	0	0
11	22369932	.	G	A	6	7	13	0	0	13	0	0
11	22370049	.	G	A	11	10	21	0	1	22	0	0
11	22371990	.	T	G	6	4	10	0	0	10	0	0
11	22374871	.	G	A	2	4	6	0	0	6	0	0
11	22505058	.	T	C	7	2	9	1	0	10	0	0
11	22521220	.	G	A	8	3	11	0	0	11	0	0
11	22560018	.	T	C	4	5	9	0	0	9	0	0
11	22571657	.	G	A	6	8	14	1	0	15	0	0
11	22578767	.	G	A	1	8	9	0	5	14	0	0
11	22578779	.	C	A	6	7	13	0	2	15	0	0
11	22582573	.	C	A	2	3	5	0	1	6	0	0
11	22582607	.	T	C	6	3	9	0	1	10	0	0
11	22582634	.	C	A	6	5	11	0	0	11	0	0
11	22582706	.	T	C	2	7	9	0	2	11	0	0
11	22582739	.	A	T	3	7	10	0	1	11	0	0
11	22582773	.	G	A	0	5	5	0	5	10	0	0
11	22582830	.	T	C	10	4	14	0	0	14	0	0
11	22582878	.	A	G	6	4	10	0	0	10	0	0
11	22582891	.	G	A	4	2	6	0	0	6	0	0
11	22582923	.	C	T	3	3	6	0	0	6	0	0
11	22583023	.	A	T	6	4	10	0	0	10	0	0
11	22583150	.	G	A	0	4	4	0	6	10	0	0
11	22583372	.	C	G	3	4	7	0	1	8	0	0
11	22583424	.	G	T	6	8	14	0	1	15	0	0
11	22583514	.	G	A	9	9	18	0	1	19	0	0
11	22583656	.	T	G	6	6	12	0	1	13	0	0
11	22583665	.	G	T	7	4	11	0	0	11	0	0
11	22583701	.	A	C	8	5	13	0	0	13	0	0
11	22583807	.	T	C	11	8	19	0	0	19	0	0
11	22583884	.	G	T	7	9	16	0	0	16	0	0
11	22624467	.	C	T	4	2	6	0	1	7	0	0
11	22629148	.	C	A	7	4	11	0	0	11	0	0
11	22629761	.	A	G	2	0	2	0	2	4	0	0
11	22630168	.	G	A	3	4	7	0	0	7	0	0
11	22630252	.	G	T	5	2	7	0	0	7	0	0
11	22891251	.	T	C	14	14	28	0	0	28	0	0
11	22891477	.	G	A	12	15	27	0	1	28	0	0
11	22891490	.	A	C	12	14	26	0	1	27	0	0
11	22891624	.	C	T	16	13	29	1	0	30	0	0
11	22891683	.	G	A	28	15	43	0	1	44	0	0
11	22891890	.	C	A	22	7	29	0	1	30	0	0
11	22891979	.	A	T	8	17	25	0	1	26	0	0
11	22892028	.	C	T	16	13	29	0	2	31	0	0
11	22892092	.	G	A	15	15	30	0	1	31	0	0
11	22892205	.	A	G	18	29	47	0	1	49	1	0
11	22892345	.	C	A	3	13	16	0	11	27	0	0
11	22892395	.	G	A	18	15	33	0	0	33	0	0
11	22892432	.	C	T	17	10	27	0	1	28	0	0
11	22892573	.	G	A	19	5	24	0	0	24	0	0
11	22892859	.	A	T	19	20	39	0	2	41	0	0
11	22905743	.	T	G	12	16	28	0	0	28	0	0
11	22906133	.	T	G	14	14	28	0	0	28	0	0
11	22906383	.	T	C	11	13	24	0	1	25	0	0
11	22915951	.	T	A	9	5	14	0	0	14	0	0
11	22916528	.	G	T	8	5	13	0	0	13	0	0
11	22916540	.	C	A	9	5	14	0	0	14	0	0
11	22916573	.	G	T	7	3	10	0	0	10	0	0
11	22916576	.	A	G	5	3	8	0	1	9	0	0
11	22920796	.	T	A	9	16	25	0	0	25	0	0
11	22921048	.	T	G	27	17	44	0	10	54	0	0
11	22921168	.	C	T	32	28	60	0	1	61	0	0
11	22921326	.	G	A	18	28	46	0	4	50	0	0
11	22922115	.	A	T	22	25	47	0	0	47	0	0
11	22922392	.	G	C	23	24	47	0	3	50	0	0
11	22922645	.	G	A	21	25	46	0	1	47	0	0
11	22922784	.	G	A	22	18	40	0	1	41	0	0
11	22923168	.	G	A	15	23	38	0	6	44	0	0
11	22923410	.	T	C	13	0	13	0	15	28	0	0
11	22923485	.	G	T	23	28	51	0	0	51	0	0
11	22925901	.	G	A	19	21	40	0	0	40	0	0
11	22925902	.	A	C	20	21	41	0	0	41	0	0
11	22925966	.	A	T	19	17	36	0	3	39	0	0
11	22926213	.	A	C	16	0	16	0	13	29	0	0
11	22926309	.	T	C	8	4	12	0	0	12	0	0
11	22950984	.	C	T	19	17	36	0	1	37	0	0
11	22964006	.	G	T	17	15	32	0	2	34	0	0
11	22970283	.	G	A	11	9	20	0	2	22	0	0
11	22984008	.	G	A	2	2	4	2	0	6	0	0
11	22997294	.	C	A	1	2	3	0	1	4	0	0
11	22997402	.	C	T	0	2	2	0	1	3	0	0
11	22997467	.	A	C	1	3	4	0	0	4	0	0
11	23312245	.	A	C	1	4	5	0	0	5	0	0
11	23312543	.	G	A	4	6	10	0	0	10	0	0
11	23313911	.	G	A	4	6	10	0	0	10	0	0
11	23313928	.	T	C	7	5	12	0	1	13	0	0
11	23343154	.	A	G	8	4	12	0	0	12	0	0
11	23343231	.	G	A	6	7	13	0	1	14	0	0
11	23343594	.	T	A	11	11	22	0	0	22	0	0
11	23343775	.	A	G	9	8	17	0	1	18	0	0
11	23343842	.	A	T	13	4	17	0	2	19	0	0
11	23344109	.	G	A	13	14	27	0	1	28	0	0
11	23344348	.	C	T	1	8	9	0	10	19	0	0
11	23344421	.	G	C	8	15	23	0	2	25	0	0
11	23344608	.	A	C	16	5	21	0	1	22	0	0
11	23344790	.	T	A	15	11	26	0	1	27	0	0
11	23345040	.	G	A	8	9	17	0	0	17	0	0
11	23352194	.	C	T	9	13	22	0	0	22	0	0
11	23352639	.	T	G	6	5	11	0	1	12	0	0
11	23353706	.	C	T	9	5	14	0	1	15	0	0
11	23365025	.	A	G	7	3	10	0	0	10	0	0
11	23379332	.	T	G	4	6	10	0	0	10	0	0
11	23422470	.	C	T	1	4	5	0	0	5	0	0
11	23595627	.	C	T	7	7	14	0	0	14	0	0
11	23596264	.	G	A	10	8	18	0	1	19	0	0
11	23596700	.	A	G	10	5	15	0	1	16	0	0
11	23596918	.	T	C	11	5	16	0	1	17	0	0
11	23596978	.	G	A	10	2	12	0	1	13	0	0
11	23597098	.	T	C	9	7	16	0	0	16	0	0
11	23597099	.	A	T	9	7	16	0	0	16	0	0
11	23597248	.	T	A	3	2	5	0	3	8	0	0
11	23597262	.	G	A	5	5	10	0	0	10	0	0
11	23597365	.	T	G	5	7	12	0	0	12	0	0
11	23597372	.	T	G	7	7	14	0	0	14	0	0
11	23597522	.	C	T	1	3	4	0	9	13	0	0
11	23597537	.	T	C	7	0	7	0	4	11	0	0
11	23606964	.	A	T	3	8	11	0	1	12	0	0
11	23609617	.	T	G	2	4	6	0	0	6	0	0
11	23609702	.	T	C	4	3	7	0	1	8	0	0
11	23826524	.	C	T	2	3	5	0	0	5	0	0
11	23834884	.	A	G	3	4	7	0	0	7	0	0
11	23843362	.	A	G	3	5	8	0	0	8	0	0
11	23856440	.	A	G	3	5	8	0	0	8	0	0
11	23856499	.	A	G	5	0	5	0	4	9	0	0
11	23879521	.	C	T	12	15	27	0	0	27	0	0
11	23879825	.	A	T	12	13	25	0	1	26	0	0
11	23880084	.	T	C	11	13	24	0	0	24	0	0
11	23880429	.	A	T	20	2	22	0	0	22	0	0
11	23880476	.	T	G	3	8	11	0	0	11	0	0
11	23880607	.	C	T	7	12	19	1	0	20	0	0
11	23880698	.	C	T	9	10	19	0	0	19	0	0
11	23880878	.	T	A	9	5	14	0	0	14	0	0
11	23880941	.	C	T	6	10	16	0	0	16	0	0
11	23882646	.	A	T	13	22	35	0	0	36	1	0
11	23882655	.	C	T	23	11	34	0	1	35	0	0
11	23882836	.	A	G	14	13	27	0	4	31	0	0
11	23883340	.	C	T	11	12	23	0	1	24	0	0
11	23883466	.	C	G	25	14	39	0	1	40	0	0
11	23883699	.	A	T	12	9	21	0	2	23	0	0
11	23883725	.	G	A	20	9	29	0	2	31	0	0
11	23883747	.	C	T	16	20	36	0	1	37	0	0
11	23883810	.	T	A	11	18	29	0	1	30	0	0
11	23884419	.	T	A	18	27	45	0	3	48	0	0
11	23884805	.	A	C	3	2	5	0	0	5	0	0
11	23933206	.	C	T	3	2	5	0	0	5	0	0
11	23976169	.	C	T	7	8	15	0	1	16	0	0
11	23979519	.	C	T	7	13	20	0	0	20	0	0
11	23987655	.	C	T	5	4	9	0	0	9	0	0
11	24035841	.	G	T	3	6	9	0	8	17	0	0
11	24036035	.	C	T	7	7	14	0	1	15	0	0
11	24038115	.	A	G	7	11	18	0	1	19	0	0
11	24038795	.	T	G	11	10	21	0	0	21	0	0
11	24039086	.	A	G	16	11	27	0	2	29	0	0
11	24039241	.	A	G	16	1	17	0	18	35	0	0
11	24039246	.	T	G	18	16	34	0	2	36	0	0
11	24039728	.	G	A	18	18	36	0	1	37	0	0
11	24039732	.	C	T	20	19	39	0	2	41	0	0
11	24039773	.	A	C	22	18	40	0	1	41	0	0
11	24039791	.	A	C	21	17	38	0	2	40	0	0
11	24039912	.	T	C	17	19	36	0	1	37	0	0
11	24039949	.	C	A	16	17	33	0	1	34	0	0
11	24043500	.	C	T	17	8	25	0	0	25	0	0
11	24044318	.	G	T	13	12	25	0	1	26	0	0
11	24044351	.	C	T	12	11	23	0	0	23	0	0
11	24044413	.	T	A	8	10	18	0	2	20	0	0
11	24046235	.	C	T	5	6	11	0	1	12	0	0
11	24050607	.	G	A	13	4	17	0	1	18	0	0
11	24054807	.	C	A	4	5	9	0	0	9	0	0
11	24055699	.	A	T	8	15	23	0	0	23	0	0
11	24055884	.	A	G	9	0	9	0	10	19	0	0
11	24056205	.	C	T	24	7	31	0	1	32	0	0
11	24056377	.	G	C	14	15	29	0	6	35	0	0
11	24058749	.	G	A	11	6	17	0	0	17	0	0
11	24058963	.	G	A	5	6	11	0	1	12	0	0
11	24059005	.	A	C	2	5	7	1	0	8	0	0
11	24059236	.	T	A	8	4	12	0	0	12	0	0
11	24059268	.	G	A	3	8	11	0	1	12	0	0
11	24059630	.	C	A	5	6	11	0	0	11	0	0
11	24059933	.	G	A	3	3	6	0	2	8	0	0
11	24059963	.	G	A	2	4	6	0	1	7	0	0
11	24060014	.	C	G	4	2	6	0	0	6	0	0
11	24187748	.	A	G	10	3	13	0	0	13	0	0
11	24188088	.	G	T	11	11	22	0	1	23	0	0
11	24188221	.	C	T	0	8	8	0	8	16	0	0
11	24188227	.	G	T	7	8	15	0	0	15	0	0
11	24188385	.	T	A	11	6	17	0	0	17	0	0
11	24188436	.	T	A	9	9	18	0	1	19	0	0
11	24188437	.	G	T	9	10	19	0	0	19	0	0
11	24188884	.	C	T	2	9	11	0	3	14	0	0
11	24189765	.	G	A	5	6	11	0	0	11	0	0
11	24189786	.	C	T	1	6	7	0	7	14	0	0
11	24189811	.	G	C	7	6	13	0	0	13	0	0
11	24190606	.	C	T	5	4	9	0	0	9	0	0
11	24190821	.	G	A	5	2	7	0	0	7	0	0
11	24190989	.	A	T	6	2	8	0	0	8	0	0
11	24191019	.	G	A	4	3	7	0	1	8	0	0
11	24327288	.	A	G	1	2	3	0	0	3	0	0
11	24339459	.	C	T	9	13	22	0	0	22	0	0
11	24340251	.	T	C	2	3	5	0	0	5	0	0
11	24340807	.	A	G	10	5	15	0	0	15	0	0
11	24340931	.	G	A	11	4	15	0	0	15	0	0
11	24341085	.	T	A	14	12	26	0	0	26	0	0
11	24343437	.	C	A	23	16	39	0	3	42	0	0
11	24343537	.	T	C	19	24	43	0	2	45	0	0
11	24344284	.	C	T	27	22	49	0	1	50	0	0
11	24344490	.	G	A	25	24	49	0	3	52	0	0
11	24344902	.	A	C	19	25	44	0	1	45	0	0
11	24345221	.	C	T	10	7	17	0	1	18	0	0
11	24360966	.	A	G	8	5	13	0	1	14	0	0
11	24369586	.	A	G	2	2	4	0	1	5	0	0
11	24382604	.	T	C	2	3	5	0	0	5	0	0
11	24430156	.	A	G	4	2	6	0	0	6	0	0
11	24430323	.	T	A	5	2	7	0	0	7	0	0
11	24431934	.	T	C	1	2	3	0	0	3	0	0
11	24465598	.	A	C	2	1	3	0	0	3	0	0
11	24465967	.	A	G	6	3	9	0	1	10	0	0
11	24471280	.	G	C	3	5	8	0	0	8	0	0
11	24471483	.	G	A	8	4	12	0	1	13	0	0
11	24471540	.	G	A	8	6	14	0	0	14	0	0
11	24471563	.	C	T	0	6	6	0	6	12	0	0
11	24471583	.	C	T	0	5	5	0	6	11	0	0
11	24472065	.	A	G	2	3	5	0	0	5	0	0
11	24472176	.	A	G	3	4	7	0	0	7	0	0
11	24474181	.	G	A	7	3	10	0	0	10	0	0
11	24480781	.	C	T	4	2	6	0	0	6	0	0
11	24481382	.	G	A	2	7	9	0	1	10	0	0
11	24643194	.	G	A	0	3	3	0	2	5	0	0
11	24645880	.	T	C	3	4	7	0	0	7	0	0
11	24645890	.	A	G	3	2	5	0	0	5	0	0
11	24658606	.	G	A	1	6	7	0	7	14	0	0
11	24658696	.	C	T	10	4	14	0	0	14	0	0
11	24662859	.	T	A	8	6	14	0	0	14	0	0
11	24662898	.	C	A	6	8	14	0	1	15	0	0
11	24663349	.	C	G	3	5	8	0	0	8	0	0
11	24663426	.	T	G	2	2	4	0	0	4	0	0
11	24663564	.	G	A	2	2	4	0	0	4	0	0
11	24663768	.	G	A	2	2	4	0	0	4	0	0
11	24663808	.	T	C	4	4	8	0	0	8	0	0
11	24672154	.	G	T	5	3	8	0	0	8	0	0
11	24672193	.	G	T	4	2	6	0	0	6	0	0
11	24672703	.	C	T	2	2	4	0	0	4	0	0
11	24747871	.	G	A	2	2	4	0	0	4	0	0
11	24778759	.	C	A	1	2	3	0	0	3	0	0
11	24780351	.	A	G	2	0	2	0	5	7	0	0
11	24782271	.	G	A	0	3	3	0	3	6	0	0
11	24782499	.	G	A	5	2	7	0	0	7	0	0
11	24789357	.	C	G	8	6	14	0	0	14	0	0
11	24792201	.	G	A	13	6	19	0	3	22	0	0
11	24792460	.	T	C	11	25	36	0	2	38	0	0
11	24799378	.	G	A	22	6	28	0	1	29	0	0
11	24799408	.	G	A	2	4	6	0	11	17	0	0
11	24799495	.	T	A	5	4	9	0	1	10	0	0
11	24810510	.	C	A	14	20	34	0	1	35	0	0
11	24813128	.	C	T	23	17	40	0	1	41	0	0
11	24813378	.	C	T	14	18	32	0	0	32	0	0
11	24813500	.	C	A	12	12	24	0	2	26	0	0
11	24813651	.	G	A	17	7	24	0	1	25	0	0
11	24813855	.	C	T	20	18	38	0	1	39	0	0
11	24814110	.	G	T	26	17	43	0	2	45	0	0
11	24816326	.	A	T	2	4	6	0	0	6	0	0
11	24816471	.	C	T	5	3	8	0	0	8	0	0
11	24816472	.	C	T	5	3	8	0	0	8	0	0
11	24817054	.	T	A	9	7	16	0	0	16	0	0
11	24817247	.	A	G	5	8	13	0	1	14	0	0
11	24817304	.	C	A	3	6	9	0	0	9	0	0
11	24823323	.	G	A	0	7	7	0	6	13	0	0
11	24825435	.	A	C	1	7	8	0	1	9	0	0
11	24825549	.	C	T	8	4	12	0	0	12	0	0
11	24825583	.	G	A	6	4	10	0	0	10	0	0
11	24825598	.	C	T	6	4	10	0	1	11	0	0
11	24835762	.	A	C	12	10	22	0	0	22	0	0
11	24835764	.	A	G	12	10	22	0	0	22	0	0
11	24836384	.	C	T	12	15	27	0	0	27	0	0
11	24843031	.	C	A	8	8	16	1	1	18	0	0
11	24843058	.	G	A	1	9	10	0	4	14	0	0
11	24843079	.	A	G	4	0	4	0	10	14	0	0
11	24843154	.	G	A	1	8	9	0	9	18	0	0
11	24848409	.	G	T	14	22	36	0	0	36	0	0
11	24851182	.	A	T	4	9	13	0	3	16	0	0
11	24851804	.	T	C	2	4	6	0	0	6	0	0
11	24858813	.	C	T	2	2	4	0	0	4	0	0
11	24862737	.	C	T	1	2	3	0	0	3	0	0
11	24867468	.	C	T	5	4	9	0	0	9	0	0
11	24874841	.	A	G	3	2	5	0	1	6	0	0
11	24874960	.	C	A	8	1	9	0	10	19	0	0
11	24875331	.	T	C	5	10	15	0	0	15	0	0
11	24875382	.	G	C	2	5	7	0	0	7	0	0
11	24876382	.	A	T	1	2	3	0	0	3	0	0
11	24878011	.	C	T	7	4	11	0	1	12	0	0
11	24880785	.	T	C	5	8	13	0	1	14	0	0
11	24882864	.	G	A	11	12	23	0	0	23	0	0
11	24885128	.	C	T	10	12	22	0	1	23	0	0
11	24885384	.	C	T	6	5	11	0	1	12	0	0
11	24885598	.	C	A	9	2	11	0	1	12	0	0
11	24886152	.	C	A	26	16	42	1	1	44	0	0
11	24886273	.	G	A	2	12	14	0	17	31	0	0
11	24886672	.	T	C	11	17	28	0	1	29	0	0
11	24886847	.	C	T	24	17	41	0	1	42	0	0
11	24887321	.	T	C	18	20	38	0	3	41	0	0
11	24887523	.	A	G	19	7	26	0	1	27	0	0
11	24887524	.	A	G	20	6	26	0	0	26	0	0
11	24887703	.	C	T	9	8	17	0	5	22	0	0
11	24887803	.	A	C	19	16	35	0	1	36	0	0
11	24888186	.	C	T	8	4	12	0	0	13	1	0
11	24888379	.	C	A	18	16	34	0	1	35	0	0
11	24888560	.	A	T	3	6	9	0	0	9	0	0
11	24902157	.	A	T	23	25	48	0	2	50	0	0
11	24903143	.	G	T	25	22	47	0	4	51	0	0
11	24904588	.	T	C	20	22	42	0	2	44	0	0
11	24905817	.	G	A	18	18	36	0	1	37	0	0
11	24905831	.	G	A	20	21	41	0	2	43	0	0
11	24905985	.	G	T	9	10	19	0	2	21	0	0
11	24906069	.	C	T	12	19	31	0	0	31	0	0
11	24906125	.	A	G	13	11	24	0	2	26	0	0
11	24906128	.	T	A	13	10	23	0	3	26	0	0
11	24966224	.	C	T	3	2	5	0	0	5	0	0
11	24972294	.	C	T	2	7	9	0	0	9	0	0
11	24973616	.	A	G	1	2	3	0	0	3	0	0
11	24975594	.	G	T	4	4	8	0	0	8	0	0
11	24975936	.	C	T	2	3	5	0	0	5	0	0
11	24978617	.	A	C	3	3	6	0	1	7	0	0
11	24981190	.	A	T	6	3	9	0	1	10	0	0
11	24992298	.	A	G	10	9	19	0	1	20	0	0
11	24992559	.	C	A	8	7	15	0	1	16	0	0
11	24992560	.	A	G	4	7	11	0	5	16	0	0
11	24992928	.	G	A	10	4	14	0	1	15	0	0
11	24993109	.	G	A	1	5	6	0	3	9	0	0
11	24993171	.	G	T	2	2	4	0	0	4	0	0
11	24994833	.	A	C	6	6	12	0	0	12	0	0
11	25010619	.	A	C	4	4	8	0	1	9	0	0
11	25010873	.	A	G	8	1	9	0	7	16	0	0
11	25025783	.	T	G	11	9	20	0	0	20	0	0
11	25026004	.	C	G	6	5	11	0	0	11	0	0
11	25026437	.	A	G	3	10	13	0	1	14	0	0
11	25026450	.	A	T	3	11	14	0	1	15	0	0
11	25031272	.	A	C	8	16	24	0	2	26	0	0
11	25031362	.	C	T	11	7	18	0	1	19	0	0
11	25031527	.	G	A	16	8	24	0	1	25	0	0
11	25035439	.	C	T	6	16	22	0	0	22	0	0
11	25036942	.	C	T	15	8	23	0	0	23	0	0
11	25037017	.	C	T	16	7	23	0	0	23	0	0
11	25038572	.	T	C	12	10	22	0	0	22	0	0
11	25038625	.	G	C	13	8	21	0	0	21	0	0
11	25038652	.	G	A	3	9	12	0	8	20	0	0
11	25040729	.	A	G	6	7	13	0	0	13	0	0
11	25040857	.	C	T	12	11	23	1	1	25	0	0
11	25041190	.	A	T	11	9	20	0	2	22	0	0
11	25041204	.	C	T	15	11	26	0	0	26	0	0
11	25041464	.	T	C	20	8	28	0	0	28	0	0
11	25041607	.	G	C	1	17	18	0	11	29	0	0
11	25041737	.	T	A	2	1	3	0	1	4	0	0
11	25050617	.	G	A	2	3	5	0	1	6	0	0
11	25050621	.	G	C	2	3	5	0	1	6	0	0
11	25053094	.	C	A	2	3	5	0	0	5	0	0
11	25053952	.	G	A	3	6	9	0	0	9	0	0
11	25058993	.	A	C	1	2	3	0	0	3	0	0
11	25061104	.	G	A	4	3	7	0	1	8	0	0
11	25062949	.	A	C	1	2	3	0	0	3	0	0
11	25062973	.	T	G	1	3	4	0	0	4	0	0
11	25063291	.	A	T	2	2	4	0	0	4	0	0
11	25063293	.	T	C	2	2	4	0	0	4	0	0
11	25064623	.	C	G	21	21	42	0	0	42	0	0
11	25129232	.	C	G	31	1	32	0	28	60	0	0
11	25132510	.	T	C	40	35	75	0	2	77	0	0
11	25138485	.	A	C	21	41	62	0	10	72	0	0
11	25138656	.	T	C	40	36	76	0	5	81	0	0
11	25138673	.	T	A	44	33	77	0	4	81	0	0
11	25138845	.	C	T	36	37	73	0	1	74	0	0
11	25166824	.	G	A	4	3	7	0	0	7	0	0
11	25169680	.	G	A	6	3	9	0	0	9	0	0
11	25169704	.	T	C	1	7	8	0	0	8	0	0
11	25169749	.	G	A	0	3	3	0	1	4	0	0
11	25178862	.	C	T	9	8	17	0	0	17	0	0
11	25178865	.	T	A	7	7	14	0	2	16	0	0
11	25179014	.	C	T	9	10	19	0	0	19	0	0
11	25179057	.	A	C	10	5	15	0	2	17	0	0
11	25179069	.	A	G	9	8	17	0	1	18	0	0
11	25179099	.	C	T	10	10	20	0	0	20	0	0
11	25179383	.	C	T	2	9	11	0	0	11	0	0
11	25179430	.	T	A	4	5	9	0	1	10	0	0
11	25179641	.	C	T	10	14	24	0	0	24	0	0
11	25179659	.	A	T	10	11	21	0	0	21	0	0
11	25180225	.	C	T	6	5	11	0	0	11	0	0
11	25180243	.	A	G	4	4	8	0	0	8	0	0
11	25260136	.	G	T	6	5	11	0	0	11	0	0
11	25260142	.	T	G	6	7	13	0	0	13	0	0
11	25260206	.	T	A	8	5	13	0	0	13	0	0
11	25261665	.	C	T	7	5	12	0	0	12	0	0
11	25261753	.	G	A	1	8	9	0	7	16	0	0
11	25265867	.	A	T	11	14	25	0	0	25	0	0
11	25265980	.	A	G	6	15	21	0	1	22	0	0
11	25302183	.	C	T	4	10	14	0	1	15	0	0
11	25303887	.	T	C	11	14	25	0	0	25	0	0
11	25306433	.	T	C	7	10	17	0	1	18	0	0
11	25306445	.	G	A	10	10	20	0	0	20	0	0
11	25307009	.	C	T	20	15	35	0	1	36	0	0
11	25307234	.	G	A	8	13	21	0	0	21	0	0
11	25310859	.	A	T	18	7	25	0	3	28	0	0
11	25311099	.	T	A	10	13	23	0	2	25	0	0
11	25311268	.	C	G	14	3	17	1	1	25	6	0
11	25313952	.	G	A	2	2	4	1	2	7	0	0
11	25315658	.	T	C	12	7	19	0	1	20	0	0
11	25315701	.	T	A	9	12	21	0	0	21	0	0
11	25315762	.	A	C	7	15	22	0	1	23	0	0
11	25315828	.	A	G	12	9	21	0	0	21	0	0
11	25315894	.	G	A	7	13	20	0	1	21	0	0
11	25316150	.	G	A	4	6	10	0	1	11	0	0
11	25316216	.	T	C	10	10	20	0	1	21	0	0
11	25316351	.	T	A	13	5	18	0	0	18	0	0
11	25316368	.	G	C	10	4	14	0	1	15	0	0
11	25316963	.	G	T	1	3	4	0	0	4	0	0
11	25317362	.	T	C	3	0	3	0	7	10	0	0
11	25317607	.	C	G	4	2	6	0	0	6	0	0
11	25324377	.	T	A	1	5	6	0	0	6	0	0
11	25383186	.	C	T	1	2	3	0	1	4	0	0
11	25383187	.	C	T	0	3	3	0	1	4	0	0
11	25383221	.	C	T	3	2	5	0	0	5	0	0
11	25383350	.	C	G	2	4	6	0	0	6	0	0
11	25383488	.	G	T	3	3	6	0	0	6	0	0
11	25383995	.	A	T	1	2	3	0	0	3	0	0
11	25384098	.	C	T	1	2	3	0	0	3	0	0
11	25384132	.	C	T	1	2	3	0	0	3	0	0
11	25384137	.	C	T	0	1	1	0	2	3	0	0
11	25405772	.	C	T	4	3	7	0	0	7	0	0
11	25405901	.	C	T	7	5	12	0	0	12	0	0
11	25405910	.	C	T	5	7	12	0	0	12	0	0
11	25406186	.	T	C	11	6	17	0	0	17	0	0
11	25406343	.	A	G	9	9	18	0	1	19	0	0
11	25406366	.	T	G	11	0	11	0	8	19	0	0
11	25406381	.	C	T	11	6	17	0	0	17	0	0
11	25406534	.	C	T	6	2	8	0	1	9	0	0
11	25407014	.	G	A	4	4	8	0	1	9	0	0
11	25407380	.	C	T	5	11	16	0	2	18	0	0
11	25407626	.	T	C	9	8	17	0	0	17	0	0
11	25407987	.	A	T	4	6	10	0	1	11	0	0
11	25408022	.	G	T	7	13	20	0	1	21	0	0
11	25408139	.	C	T	18	14	32	0	2	34	0	0
11	25408283	.	C	G	10	6	16	0	0	16	0	0
11	25408352	.	T	C	4	8	12	0	0	12	0	0
11	25436686	.	C	A	4	4	8	0	1	9	0	0
11	25437501	.	C	T	16	11	27	0	2	29	0	0
11	25441009	.	G	A	7	5	12	0	0	12	0	0
11	25449437	.	T	A	4	7	11	0	2	13	0	0
11	25487521	.	T	C	4	5	9	0	0	9	0	0
11	25487730	.	G	A	1	4	5	0	0	5	0	0
11	25490257	.	G	A	1	3	4	0	0	4	0	0
11	25499577	.	A	C	12	7	19	0	0	19	0	0
11	25500587	.	C	T	4	13	17	0	1	18	0	0
11	25500843	.	A	G	5	1	6	0	8	14	0	0
11	25501962	.	C	T	4	8	12	0	0	12	0	0
11	25502058	.	C	T	8	15	23	0	0	23	0	0
11	25502319	.	T	C	4	2	6	0	0	6	0	0
11	25502368	.	C	T	3	2	5	0	0	5	0	0
11	25519352	.	C	T	1	4	5	0	0	5	0	0
11	25540583	.	G	A	0	4	4	0	5	9	0	0
11	25542320	.	A	T	5	3	8	0	1	9	0	0
11	25542399	.	G	A	3	6	9	0	2	11	0	0
11	25548172	.	G	A	6	9	15	0	0	15	0	0
11	25548190	.	C	T	5	6	11	0	1	12	0	0
11	25548305	.	A	C	6	6	12	0	0	12	0	0
11	25549953	.	C	G	6	11	17	0	0	17	0	0
11	25572090	.	G	A	3	4	7	0	1	8	0	0
11	25572627	.	T	G	4	0	4	0	7	11	0	0
11	25573888	.	T	A	6	6	12	0	1	13	0	0
11	25573921	.	T	A	7	7	14	0	0	14	0	0
11	25575100	.	T	C	8	8	16	0	0	16	0	0
11	25575139	.	A	G	12	8	20	0	1	21	0	0
11	25575365	.	C	T	4	5	9	0	1	10	0	0
11	25575725	.	A	T	9	3	12	0	1	13	0	0
11	25575872	.	A	G	7	1	8	0	9	17	0	0
11	25612719	.	A	G	8	0	8	0	10	18	0	0
11	25612824	.	C	T	7	11	18	0	1	19	0	0
11	25615018	.	C	A	4	3	7	0	0	7	0	0
11	25615049	.	G	A	1	6	7	0	0	7	0	0
11	25615429	.	C	T	2	2	4	0	0	4	0	0
11	25615943	.	T	G	2	5	7	0	0	7	0	0
11	25616465	.	A	C	6	7	13	0	0	13	0	0
11	25616642	.	T	C	5	6	11	0	0	11	0	0
11	25616679	.	T	A	9	7	16	0	0	16	0	0
11	25616691	.	A	G	6	0	6	0	9	15	0	0
11	25616719	.	G	A	7	7	14	0	0	14	0	0
11	25617023	.	T	A	9	6	15	0	1	16	0	0
11	25617027	.	C	A	9	5	14	0	1	15	0	0
11	25617096	.	T	C	4	2	6	0	1	7	0	0
11	25617118	.	A	G	3	4	7	0	1	8	0	0
11	25618037	.	T	C	7	5	12	0	0	12	0	0
11	25618094	.	G	A	1	8	9	0	8	17	0	0
11	25618127	.	T	C	9	5	14	0	1	15	0	0
11	25618218	.	C	T	4	7	11	0	0	11	0	0
11	25618297	.	A	C	5	3	8	0	0	8	0	0
11	25618408	.	C	T	3	2	5	0	0	5	0	0
11	25630660	.	C	T	5	2	7	0	0	7	0	0
11	25671502	.	A	G	2	8	10	0	0	10	0	0
11	25671523	.	C	T	2	6	8	0	0	8	0	0
11	25675599	.	A	G	3	4	7	0	0	7	0	0
11	25678397	.	T	C	4	4	8	0	1	9	0	0
11	25678670	.	C	T	5	4	9	0	0	9	0	0
11	25679010	.	A	T	4	2	6	0	2	8	0	0
11	25681439	.	T	C	6	7	13	0	0	13	0	0
11	25681659	.	G	A	1	4	5	0	8	13	0	0
11	25681677	.	G	A	1	6	7	0	5	12	0	0
11	25681855	.	A	T	2	8	10	0	1	11	0	0
11	25681863	.	C	T	2	8	10	0	0	10	0	0
11	25682883	.	G	A	1	5	6	0	7	13	0	0
11	25684562	.	C	A	8	4	12	0	0	12	0	0
11	25689209	.	T	G	14	1	15	0	11	26	0	0
11	25689551	.	T	C	8	4	12	0	0	12	0	0
11	25693909	.	T	C	2	2	4	0	0	4	0	0
11	25695509	.	G	A	1	3	4	0	3	7	0	0
11	25695565	.	T	C	2	8	10	0	1	11	0	0
11	25695760	.	G	A	1	4	5	0	6	11	0	0
11	25698866	.	T	C	5	2	7	0	1	8	0	0
11	25698869	.	G	C	0	2	2	0	6	8	0	0
11	25698917	.	C	T	3	3	6	0	0	6	0	0
11	25698926	.	G	A	3	3	6	0	0	6	0	0
11	25699406	.	G	A	1	5	6	0	5	11	0	0
11	25707869	.	G	T	1	6	7	0	5	12	0	0
11	25708008	.	A	G	3	2	5	0	1	6	0	0
11	25708134	.	G	T	2	3	5	0	0	5	0	0
11	25708156	.	T	C	1	2	3	0	0	3	0	0
11	25708678	.	G	C	2	3	5	0	1	6	0	0
11	25712952	.	T	G	6	10	16	0	0	16	0	0
11	25713028	.	A	G	6	9	15	0	1	16	0	0
11	25713340	.	T	G	6	3	9	0	0	9	0	0
11	25713842	.	T	A	5	9	14	0	1	15	0	0
11	25714148	.	G	A	9	5	14	0	1	15	0	0
11	25714425	.	G	T	9	6	15	0	1	16	0	0
11	25718054	.	C	T	0	15	15	0	6	21	0	0
11	25718179	.	C	T	8	4	12	0	0	12	0	0
11	25718438	.	T	G	10	12	22	0	0	22	0	0
11	25723425	.	C	T	2	10	12	0	6	18	0	0
11	25723434	.	G	A	7	10	17	0	0	17	0	0
11	25726770	.	C	A	0	2	2	0	5	7	0	0
11	25729136	.	C	A	0	4	4	0	3	7	0	0
11	25729190	.	G	T	2	3	5	0	1	6	0	0
11	25729268	.	C	T	0	5	5	0	7	12	0	0
11	25730224	.	G	T	4	5	9	0	0	9	0	0
11	25730440	.	G	T	1	2	3	0	0	3	0	0
11	25730463	.	A	C	1	3	4	0	0	4	0	0
11	25743158	.	C	T	5	6	11	0	0	11	0	0
11	25743414	.	G	A	11	6	17	0	0	17	0	0
11	25743465	.	G	A	0	5	5	0	7	12	0	0
11	25743531	.	G	A	0	5	5	0	11	16	0	0
11	25748876	.	A	G	7	11	18	0	0	18	0	0
11	25749736	.	G	A	8	25	33	0	1	34	0	0
11	25783353	.	T	A	6	5	11	0	0	11	0	0
11	25783432	.	G	A	4	14	18	0	1	19	0	0
11	25783435	.	T	G	4	14	18	0	1	19	0	0
11	25783704	.	C	T	12	14	26	0	0	26	0	0
11	25789211	.	C	G	4	7	11	0	1	12	0	0
11	25789218	.	A	G	3	9	12	0	1	13	0	0
11	25858116	.	T	A	6	3	9	0	0	9	0	0
11	25866443	.	A	T	8	9	17	0	0	17	0	0
11	25868801	.	C	T	7	9	16	0	0	16	0	0
11	25871408	.	G	A	8	8	16	0	0	16	0	0
11	25887514	.	G	A	9	12	21	0	0	21	0	0
11	25894003	.	T	C	8	12	20	0	1	21	0	0
11	25944661	.	A	C	6	10	16	0	0	16	0	0
11	26180338	.	A	G	1	2	3	0	0	3	0	0
11	26180460	.	G	A	10	4	14	0	4	18	0	0
11	26190562	.	A	T	3	7	10	0	0	10	0	0
11	26190763	.	C	T	6	13	19	0	3	22	0	0
11	26190876	.	C	A	8	5	13	0	0	13	0	0
11	26191029	.	G	A	7	6	13	0	0	13	0	0
11	26191478	.	T	A	16	10	26	0	1	27	0	0
11	26191661	.	T	A	7	20	27	2	0	29	0	0
11	26191667	.	C	T	7	17	24	2	2	28	0	0
11	26194061	.	T	G	5	9	14	0	0	14	0	0
11	26194237	.	G	T	6	3	9	0	1	10	0	0
11	26194838	.	C	T	5	3	8	0	0	8	0	0
11	26194843	.	G	T	5	3	8	0	0	8	0	0
11	26194873	.	T	C	4	3	7	0	0	7	0	0
11	26195411	.	T	A	2	2	4	0	0	4	0	0
11	26197496	.	C	T	0	2	2	0	2	4	0	0
11	26229093	.	G	A	11	18	29	0	1	30	0	0
11	26229464	.	C	A	17	19	36	0	1	37	0	0
11	26229801	.	G	A	8	13	21	0	2	23	0	0
11	26229900	.	C	T	3	14	17	0	20	37	0	0
11	26230302	.	G	A	10	15	25	0	3	28	0	0
11	26230425	.	G	C	9	13	22	0	3	25	0	0
11	26230551	.	A	T	1	3	4	1	1	6	0	0
11	26230644	.	G	A	4	5	9	0	0	9	0	0
11	26230756	.	T	G	4	7	11	0	0	11	0	0
11	26230774	.	T	A	4	5	9	0	0	9	0	0
11	26230847	.	C	T	9	6	15	0	1	16	0	0
11	26231119	.	A	T	4	3	7	1	0	8	0	0
11	26231804	.	T	C	8	6	14	0	2	16	0	0
11	26231890	.	G	A	11	7	18	0	0	18	0	0
11	26231971	.	T	C	9	3	12	0	0	12	0	0
11	26232038	.	A	T	7	5	12	0	1	13	0	0
11	26232311	.	C	T	1	2	3	0	0	3	0	0
11	26233509	.	C	T	0	6	6	0	1	7	0	0
11	26233515	.	A	G	10	0	10	0	1	11	0	0
11	26239092	.	A	G	5	5	10	0	0	10	0	0
11	26242650	.	G	T	6	6	12	0	0	12	0	0
11	26363534	.	G	A	2	3	5	0	0	5	0	0
11	26367058	.	T	G	2	2	4	0	1	5	0	0
11	26367201	.	C	T	5	4	9	0	0	9	0	0
11	26369132	.	G	A	4	3	7	0	0	7	0	0
11	26369402	.	A	T	1	2	3	0	0	3	0	0
11	26369416	.	A	G	1	3	4	0	0	4	0	0
11	26369464	.	G	C	1	2	3	0	0	3	0	0
11	26369465	.	C	A	0	2	2	0	1	3	0	0
11	26370720	.	A	T	4	3	7	0	0	7	0	0
11	26372296	.	C	T	1	10	11	0	6	17	0	0
11	26373641	.	G	A	2	2	4	0	0	4	0	0
11	26374108	.	A	G	6	2	8	0	0	8	0	0
11	26376034	.	G	T	4	10	14	0	0	14	0	0
11	26381908	.	G	A	4	5	9	0	1	10	0	0
11	26382551	.	A	G	7	0	7	0	7	14	0	0
11	26382578	.	T	A	6	5	11	0	1	12	0	0
11	26396076	.	G	A	0	5	5	0	4	9	0	0
11	26396408	.	T	C	9	7	16	0	2	18	0	0
11	26397833	.	A	G	13	1	14	0	14	28	0	0
11	26398012	.	T	C	8	6	14	0	0	14	0	0
11	26398057	.	T	A	10	5	15	0	0	15	0	0
11	26400503	.	G	A	12	15	27	0	0	27	0	0
11	26400782	.	G	C	7	5	12	0	0	12	0	0
11	26400796	.	C	T	9	8	17	0	0	17	0	0
11	26400817	.	G	T	10	7	17	0	1	18	0	0
11	26401407	.	C	T	12	8	20	0	1	21	0	0
11	26540451	.	A	G	2	3	5	0	0	5	0	0
11	26545685	.	G	A	3	3	6	0	0	6	0	0
11	26545746	.	A	G	1	2	3	0	0	3	0	0
11	26545779	.	A	G	2	2	4	0	0	4	0	0
11	26545819	.	A	G	3	2	5	0	1	6	0	0
11	26550317	.	G	A	5	4	9	0	0	9	0	0
11	26551165	.	G	A	0	3	3	0	2	5	0	0
11	26561119	.	G	A	4	3	7	0	3	10	0	0
11	26561301	.	T	G	3	4	7	0	0	7	0	0
11	26562253	.	G	A	3	3	6	0	0	6	0	0
11	26614552	.	G	C	6	30	36	0	28	64	0	0
11	26614615	.	T	A	28	28	56	0	3	59	0	0
11	26614713	.	C	A	33	18	51	0	0	51	0	0
11	26614718	.	G	A	5	10	15	0	33	48	0	0
11	26614755	.	C	A	17	15	32	0	2	34	0	0
11	26614910	.	C	T	19	29	48	0	3	51	0	0
11	26615201	.	A	G	17	30	47	0	2	50	1	0
11	26615294	.	G	A	24	10	34	0	2	36	0	0
11	26615425	.	T	C	19	23	42	0	3	45	0	0
11	26683200	.	C	A	5	3	8	0	0	8	0	0
11	26683692	.	A	T	8	6	14	0	0	14	0	0
11	26686150	.	T	C	2	2	4	0	0	4	0	0
11	26695838	.	G	A	3	3	6	0	0	6	0	0
11	26698136	.	G	T	3	2	5	0	0	5	0	0
11	26701432	.	T	C	1	4	5	0	0	5	0	0
11	26704347	.	C	A	2	15	17	1	23	41	0	0
11	26704960	.	A	T	8	13	21	0	4	25	0	0
11	26705105	.	T	C	16	13	29	0	1	30	0	0
11	26705111	.	G	A	16	13	29	0	0	29	0	0
11	26705196	.	C	T	17	17	34	0	0	34	0	0
11	26705540	.	G	A	11	7	18	0	1	19	0	0
11	26705851	.	C	A	1	13	14	0	12	26	0	0
11	26705898	.	T	C	12	10	22	0	0	22	0	0
11	26705995	.	C	A	11	8	19	8	0	27	0	0
11	26706124	.	A	T	10	12	22	0	1	23	0	0
11	26706522	.	A	G	10	14	24	0	1	25	0	0
11	26706572	.	C	T	0	9	9	0	14	23	0	0
11	26706789	.	C	T	9	10	19	0	0	19	0	0
11	26707110	.	T	C	12	12	24	0	1	25	0	0
11	26707152	.	A	C	10	0	10	0	9	19	0	0
11	26707162	.	G	A	8	9	17	0	2	19	0	0
11	26707367	.	C	A	3	12	15	0	27	42	0	0
11	26707634	.	A	G	19	17	36	0	8	44	0	0
11	26707679	.	G	A	20	18	38	0	2	40	0	0
11	26707733	.	A	G	22	15	37	0	2	39	0	0
11	26714379	.	C	T	9	12	21	0	1	22	0	0
11	26722167	.	A	G	10	5	15	0	1	16	0	0
11	26722188	.	G	A	4	6	10	0	1	11	0	0
11	26740022	.	T	C	8	9	17	0	0	17	0	0
11	26740223	.	C	T	4	4	8	0	0	8	0	0
11	26740279	.	G	T	7	6	13	0	0	13	0	0
11	26740393	.	T	C	4	4	8	0	0	8	0	0
11	26740751	.	T	C	3	0	3	0	5	8	0	0
11	26741797	.	G	A	2	2	4	0	0	4	0	0
11	27136614	.	C	T	2	4	6	0	0	6	0	0
11	27143555	.	C	T	6	3	9	0	1	10	0	0
11	27486825	.	C	T	4	8	12	0	1	13	0	0
11	27487346	.	T	C	3	3	6	0	3	9	0	0
11	27487689	.	T	C	10	3	13	0	0	13	0	0
11	27487904	.	T	A	6	2	8	0	0	8	0	0
11	27488085	.	T	C	7	3	10	0	0	10	0	0
11	27488158	.	C	T	5	7	12	0	1	13	0	0
11	27488600	.	T	C	6	8	14	0	0	14	0	0
11	27495512	.	G	A	2	4	6	0	0	6	0	0
11	27495632	.	C	T	5	4	9	0	0	9	0	0
11	27499016	.	G	T	2	3	5	0	0	5	0	0
11	27502734	.	T	C	2	1	3	0	3	6	0	0
11	27516630	.	T	G	4	3	7	0	1	8	0	0
11	27516662	.	G	A	7	2	9	0	0	9	0	0
11	27516768	.	G	C	3	3	6	0	1	7	0	0
11	27516861	.	C	T	0	2	2	0	3	5	0	0
11	27517115	.	G	A	5	4	9	0	2	11	0	0
11	27517122	.	T	G	4	6	10	0	0	10	0	0
11	27517157	.	G	A	3	4	7	0	1	8	0	0
11	27517238	.	C	T	0	4	4	0	5	9	0	0
11	27517635	.	C	T	0	3	3	0	3	6	0	0
11	27517653	.	C	T	4	2	6	0	0	6	0	0
11	27517671	.	C	T	4	3	7	0	1	8	0	0
11	27517728	.	C	T	2	4	6	0	0	6	0	0
11	27517734	.	G	C	1	0	1	0	3	4	0	0
11	27517776	.	G	T	4	3	7	0	0	7	0	0
11	27537552	.	C	T	0	2	2	0	7	9	0	0
11	27645097	.	T	C	8	2	10	0	1	11	0	0
11	27645316	.	T	C	2	3	5	0	0	5	0	0
11	27645871	.	G	A	2	2	4	0	0	4	0	0
11	27645935	.	C	T	4	2	6	0	0	6	0	0
11	27646063	.	T	A	15	5	20	1	3	25	1	0
11	27646115	.	G	T	10	3	13	1	0	14	0	0
11	27646681	.	C	T	10	7	17	0	1	18	0	0
11	27649454	.	G	A	11	19	30	0	2	32	0	0
11	27649527	.	G	A	19	10	29	0	1	30	0	0
11	27652623	.	C	T	2	4	6	0	14	20	0	0
11	27652641	.	G	A	16	8	24	0	1	25	0	0
11	27655855	.	T	A	11	11	22	0	0	22	0	0
11	27661241	.	C	T	0	7	7	0	9	16	0	0
11	27668314	.	A	G	8	7	15	0	2	17	0	0
11	27669744	.	G	C	3	4	7	0	2	9	0	0
11	27671163	.	C	T	4	6	10	0	0	10	0	0
11	27671251	.	G	A	5	7	12	0	0	12	0	0
11	27677815	.	C	T	0	3	3	0	5	8	0	0
11	27677939	.	T	G	4	4	8	0	0	8	0	0
11	27677948	.	G	A	3	4	7	0	0	7	0	0
11	27679924	.	A	G	1	3	4	0	0	4	0	0
11	27705165	.	G	A	9	6	15	0	1	16	0	0
11	27705219	.	G	T	10	9	19	0	1	20	0	0
11	27705308	.	G	A	17	12	29	0	0	29	0	0
11	27705660	.	C	A	18	9	27	0	0	27	0	0
11	27705762	.	C	T	10	10	20	0	1	21	0	0
11	27705960	.	G	A	15	15	30	0	0	30	0	0
11	27706060	.	G	A	17	11	28	0	2	30	0	0
11	27706277	.	G	C	3	7	10	0	1	11	0	0
11	27706308	.	G	A	7	4	11	0	0	11	0	0
11	27706434	.	T	A	2	3	5	0	1	6	0	0
11	27706741	.	T	A	4	8	12	0	2	14	0	0
11	27706742	.	A	C	6	8	14	0	0	14	0	0
11	27708665	.	A	C	12	9	21	0	1	22	0	0
11	27710381	.	G	T	6	5	11	0	3	14	0	0
11	27710443	.	C	T	15	13	28	0	0	28	0	0
11	27713527	.	C	T	3	9	12	0	11	23	0	0
11	27713556	.	G	T	7	9	16	0	1	17	0	0
11	27713663	.	C	T	4	6	10	0	1	11	0	0
11	27715924	.	A	G	6	5	11	0	1	12	0	0
11	27719956	.	G	T	3	4	7	0	0	7	0	0
11	27721515	.	T	G	4	4	8	1	1	10	0	0
11	27727550	.	C	T	0	5	5	0	9	14	0	0
11	27738319	.	A	G	3	3	6	0	0	6	0	0
11	27738331	.	A	G	3	4	7	0	0	7	0	0
11	27738569	.	G	C	2	3	5	0	0	5	0	0
11	27743644	.	C	A	1	3	4	0	0	4	0	0
11	27745621	.	T	A	2	2	4	1	1	6	0	0
11	27745863	.	G	A	1	2	3	0	0	3	0	0
11	27745922	.	G	T	2	2	4	0	0	4	0	0
11	27745976	.	C	A	1	2	3	0	0	3	0	0
11	27746279	.	T	G	2	4	6	0	2	8	0	0
11	27746445	.	T	G	1	2	3	0	0	3	0	0
11	27750214	.	G	A	1	2	3	0	0	3	0	0
11	27817856	.	C	A	1	3	4	0	0	4	0	0
11	27817871	.	C	T	0	3	3	0	1	4	0	0
11	27818117	.	A	G	1	2	3	0	0	3	0	0
11	27818188	.	G	C	1	4	5	0	1	6	0	0
11	27818521	.	C	A	7	8	15	0	0	16	1	0
11	27818722	.	T	C	14	15	29	0	1	30	0	0
11	27820431	.	T	G	2	4	6	0	1	7	0	0
11	27820698	.	C	G	11	3	14	0	1	15	0	0
11	27821715	.	A	C	4	0	4	0	5	9	0	0
11	27828919	.	A	T	13	8	21	0	1	22	0	0
11	27828950	.	T	A	13	13	26	0	0	26	0	0
11	27829089	.	C	T	1	16	17	0	19	36	0	0
11	27829157	.	T	C	23	14	37	0	0	37	0	0
11	27829201	.	A	G	26	14	40	1	0	41	0	0
11	27829222	.	C	T	3	11	14	1	26	41	0	0
11	27829264	.	G	A	20	9	29	1	0	30	0	0
11	27829555	.	G	A	8	5	13	0	1	14	0	0
11	27829700	.	T	C	16	0	16	0	14	30	0	0
11	27829772	.	G	A	16	6	22	0	1	23	0	0
11	27829928	.	G	A	18	14	32	0	0	32	0	0
11	27834702	.	C	T	2	3	5	0	0	5	0	0
11	27835073	.	T	C	10	9	19	0	0	19	0	0
11	27836045	.	T	C	9	8	17	0	1	18	0	0
11	27838670	.	C	T	7	12	19	0	2	21	0	0
11	27842815	.	G	A	12	5	17	0	0	17	0	0
11	27843024	.	A	G	9	7	16	0	0	16	0	0
11	27847409	.	C	T	9	16	25	0	1	26	0	0
11	27857373	.	C	T	6	7	13	0	0	13	0	0
11	27857379	.	A	G	7	6	13	0	1	14	0	0
11	27861878	.	A	T	2	5	7	0	0	7	0	0
11	27864719	.	T	C	5	6	11	0	1	12	0	0
11	27864720	.	G	T	6	6	12	0	0	12	0	0
11	27864782	.	C	A	0	6	6	0	7	13	0	0
11	27864809	.	T	G	5	4	9	0	2	11	0	0
11	27866144	.	G	T	5	6	11	0	0	11	0	0
11	27866392	.	T	C	2	5	7	0	1	8	0	0
11	28005245	.	C	T	3	2	5	0	0	5	0	0
11	28005344	.	C	T	2	3	5	0	0	5	0	0
11	28005535	.	C	T	5	3	8	0	0	8	0	0
11	28009832	.	A	G	4	0	4	0	6	10	0	0
11	28009874	.	C	T	5	6	11	0	0	11	0	0
11	28009889	.	T	C	4	4	8	0	1	9	0	0
11	28010115	.	A	T	4	3	7	2	0	9	0	0
11	28123548	.	T	A	2	2	4	0	0	4	0	0
11	28123550	.	G	A	2	2	4	0	0	4	0	0
11	28124052	.	T	A	2	5	7	0	0	7	0	0
11	28124061	.	A	T	1	4	5	0	0	5	0	0
11	28124161	.	G	C	1	2	3	0	0	3	0	0
11	28124712	.	T	A	4	4	8	0	0	8	0	0
11	28124715	.	C	A	3	3	6	0	1	7	0	0
11	28125578	.	A	T	3	3	6	0	0	6	0	0
11	28404161	.	G	A	1	3	4	0	0	4	0	0
11	28404299	.	C	G	1	5	6	0	0	6	0	0
11	28409862	.	T	C	4	5	9	0	0	9	0	0
11	28410154	.	C	T	4	4	8	0	1	9	0	0
11	28410157	.	T	C	3	4	7	0	2	9	0	0
11	28412858	.	C	T	3	7	10	0	0	10	0	0
11	28412868	.	A	C	2	6	8	0	0	8	0	0
11	28419255	.	A	G	6	0	6	0	6	12	0	0
11	28419351	.	G	A	0	1	1	0	5	6	0	0
11	28419651	.	C	T	7	6	13	0	0	13	0	0
11	28419658	.	C	T	6	5	11	0	0	11	0	0
11	28419948	.	C	T	1	6	7	0	3	10	0	0
11	28420051	.	A	G	4	0	4	0	3	7	0	0
11	28420600	.	G	A	1	3	4	0	5	9	0	0
11	28422160	.	A	C	10	5	15	0	1	16	0	0
11	28422263	.	T	C	8	7	15	0	3	18	0	0
11	28422662	.	C	A	13	6	19	0	0	19	0	0
11	28422836	.	G	T	5	7	12	0	6	18	0	0
11	28422854	.	G	A	3	6	9	0	9	18	0	0
11	28422892	.	C	A	4	4	8	0	3	12	1	0
11	28422929	.	T	G	5	0	5	0	9	14	0	0
11	28423061	.	C	T	5	8	13	0	0	13	0	0
11	28423064	.	T	A	6	9	15	0	0	15	0	0
11	28423147	.	T	A	8	9	17	0	1	18	0	0
11	28423457	.	T	C	7	9	16	0	2	18	0	0
11	28423497	.	G	T	13	8	21	0	1	22	0	0
11	28424012	.	C	T	5	3	8	0	4	12	0	0
11	28477137	.	C	T	1	3	4	0	0	4	0	0
11	28477338	.	T	C	11	5	16	0	1	17	0	0
11	28477697	.	T	C	3	2	5	0	0	5	0	0
11	28477720	.	T	A	1	2	3	0	0	3	0	0
11	28514053	.	G	A	8	9	17	0	1	18	0	0
11	28514058	.	G	T	10	9	19	0	1	20	0	0
11	28514803	.	T	C	4	8	12	0	0	12	0	0
11	28590985	.	G	C	2	3	5	0	1	6	0	0
11	28597526	.	G	A	4	5	9	0	0	9	0	0
11	28643064	.	G	T	26	16	42	0	3	45	0	0
11	28643155	.	G	A	24	21	45	0	0	45	0	0
11	28643281	.	A	T	21	20	41	0	1	42	0	0
11	28643890	.	G	C	14	27	41	0	0	41	0	0
11	28644087	.	A	C	29	22	51	0	4	55	0	0
11	28644110	.	T	C	26	1	27	1	26	54	0	0
11	28789260	.	C	T	13	16	29	0	1	30	0	0
11	28808965	.	G	A	11	8	19	0	0	19	0	0
11	28911158	.	T	C	15	11	26	0	0	26	0	0
11	29331270	.	C	T	2	2	4	0	0	4	0	0
11	29331915	.	T	A	6	6	12	0	1	13	0	0
11	29332113	.	T	G	11	7	18	0	0	18	0	0
11	29332454	.	C	A	1	5	6	0	0	6	0	0
11	29332591	.	G	A	7	6	13	0	2	15	0	0
11	29332600	.	A	G	6	7	13	0	1	14	0	0
11	29332761	.	C	A	5	6	11	0	0	11	0	0
11	29332831	.	A	C	2	2	4	0	0	4	0	0
11	29332982	.	T	C	3	2	5	0	0	5	0	0
11	29333807	.	A	G	1	3	4	0	0	4	0	0
11	29384426	.	G	A	1	2	3	0	0	3	0	0
11	29384446	.	G	T	1	2	3	0	0	3	0	0
11	29451096	.	G	A	0	2	2	0	1	3	0	0
11	29551879	.	C	A	1	3	4	0	0	4	0	0
11	29575177	.	T	A	19	13	32	1	1	34	0	0
11	29575429	.	G	T	13	25	38	0	5	43	0	0
11	29575527	.	C	T	23	20	43	0	2	45	0	0
11	29575736	.	C	A	19	21	40	0	3	43	0	0
11	29575897	.	C	T	17	18	35	0	1	36	0	0
11	29575964	.	G	A	14	13	27	0	2	29	0	0
11	29576272	.	G	T	15	3	18	0	1	19	0	0
11	29576275	.	C	T	15	4	19	0	0	19	0	0
11	29576523	.	C	T	7	4	11	0	0	11	0	0
11	29576525	.	A	C	5	5	10	0	0	10	0	0
11	29577163	.	C	T	4	12	16	0	1	17	0	0
11	29577198	.	T	A	17	6	23	0	1	24	0	0
11	29577651	.	A	T	13	12	25	0	0	25	0	0
11	29577762	.	C	A	7	9	16	0	0	16	0	0
11	29577849	.	T	A	4	16	20	1	2	23	0	0
11	29577890	.	G	A	10	7	17	0	2	19	0	0
11	29577927	.	T	G	7	4	11	0	0	11	0	0
11	29578091	.	C	T	21	12	33	0	1	34	0	0
11	29578217	.	G	T	10	9	19	0	3	22	0	0
11	29584517	.	G	A	19	9	28	0	0	28	0	0
11	29587927	.	T	C	15	7	22	0	1	23	0	0
11	29587963	.	C	T	13	12	25	0	2	27	0	0
11	29588525	.	G	A	7	14	21	0	0	22	1	0
11	29589186	.	T	A	12	15	27	0	0	28	1	0
11	29589199	.	T	C	18	12	30	0	2	32	0	0
11	29589512	.	T	G	7	9	16	0	5	21	0	0
11	29589578	.	T	C	11	0	11	0	9	20	0	0
11	29589602	.	T	A	11	10	21	0	0	21	0	0
11	29601936	.	T	C	4	7	11	0	1	12	0	0
11	29602407	.	T	A	5	7	12	1	0	13	0	0
11	29607633	.	A	G	5	5	10	0	0	10	0	0
11	29609844	.	G	A	3	3	6	0	0	6	0	0
11	29612576	.	A	G	4	2	6	0	0	6	0	0
11	29614556	.	T	C	6	3	9	1	1	11	0	0
11	29614569	.	T	C	5	3	8	1	0	9	0	0
11	29614592	.	G	A	6	3	9	1	0	10	0	0
11	29617749	.	T	G	2	4	6	0	0	6	0	0
11	29618162	.	G	A	3	3	6	0	0	6	0	0
11	29650797	.	G	C	2	3	5	0	0	5	0	0
11	29650805	.	G	A	2	2	4	0	0	4	0	0
11	29652586	.	C	A	4	2	6	0	0	6	0	0
11	29652838	.	T	C	21	28	49	0	2	51	0	0
11	29655418	.	C	T	31	30	61	0	1	62	0	0
11	29685328	.	C	T	4	2	6	0	0	6	0	0
11	29685577	.	C	T	6	2	8	0	0	8	0	0
11	29757636	.	A	C	7	16	23	0	0	23	0	0
11	29760548	.	C	T	2	16	18	0	14	32	0	0
11	29760659	.	A	G	15	9	24	0	1	25	0	0
11	29760674	.	A	G	13	9	22	0	0	22	0	0
11	29764554	.	A	G	7	14	21	0	0	21	0	0
11	29771557	.	C	T	3	2	5	0	0	5	0	0
11	29771602	.	A	G	0	2	2	0	1	3	0	0
11	29781081	.	G	T	1	2	3	0	2	5	0	0
11	29781082	.	T	C	3	2	5	0	0	5	0	0
11	29781528	.	T	C	4	3	7	0	1	8	0	0
11	29784212	.	A	G	2	2	4	0	0	4	0	0
11	29785019	.	C	T	1	4	5	0	0	5	0	0
11	29785034	.	G	A	2	2	4	0	1	5	0	0
11	29785097	.	C	T	3	2	5	0	0	5	0	0
11	29785586	.	T	A	4	3	7	0	0	7	0	0
11	29785611	.	A	G	6	0	6	0	2	8	0	0
11	29785731	.	A	G	4	2	6	0	1	7	0	0
11	29785844	.	C	G	7	5	12	0	0	12	0	0
11	29786164	.	G	A	1	3	4	0	0	4	0	0
11	29786459	.	C	T	3	6	9	0	1	10	0	0
11	29788042	.	G	A	8	6	14	0	0	14	0	0
11	29789405	.	A	C	8	3	11	0	0	11	0	0
11	29789776	.	T	A	3	5	8	0	0	8	0	0
11	29791911	.	C	A	22	20	42	0	1	43	0	0
11	29793547	.	T	C	28	20	48	0	2	50	0	0
11	29793553	.	T	C	28	21	49	0	2	51	0	0
11	29793694	.	A	C	8	16	24	0	1	25	0	0
11	29793726	.	C	A	9	15	24	0	0	24	0	0
11	29794009	.	A	G	23	13	36	0	0	36	0	0
11	29796270	.	A	C	11	1	12	0	6	18	0	0
11	29796512	.	A	C	1	0	1	0	4	5	0	0
11	29796650	.	T	G	1	3	4	0	1	5	0	0
11	29803049	.	C	G	1	4	5	0	0	5	0	0
11	29818491	.	C	A	3	3	6	0	0	6	0	0
11	29863872	.	A	T	3	3	6	0	0	6	0	0
11	29876974	.	C	A	6	4	10	0	2	12	0	0
11	29877077	.	A	G	5	4	9	0	0	9	0	0
11	29917814	.	G	T	1	3	4	0	1	5	0	0
11	29917851	.	G	T	1	2	3	0	0	3	0	0
11	29918069	.	T	C	4	5	9	1	1	11	0	0
11	29918168	.	T	C	4	5	9	0	1	10	0	0
11	29918294	.	G	T	5	2	7	0	0	7	0	0
11	29936156	.	G	A	3	4	7	1	0	8	0	0
11	29936168	.	T	C	2	6	8	1	0	9	0	0
11	30082218	.	A	G	2	0	2	0	2	4	0	0
11	30082769	.	G	A	3	4	7	0	0	7	0	0
11	30083525	.	A	G	2	3	5	0	0	5	0	0
11	30083603	.	C	A	4	4	8	0	0	8	0	0
11	30083795	.	C	T	8	6	14	0	0	14	0	0
11	30084212	.	C	T	4	7	11	0	0	11	0	0
11	30086845	.	A	C	4	6	10	0	1	11	0	0
11	30087007	.	C	T	11	11	22	0	0	22	0	0
11	30087147	.	T	G	3	1	4	0	7	11	0	0
11	30087271	.	A	G	4	2	6	0	1	7	0	0
11	30087274	.	T	C	4	3	7	0	0	7	0	0
11	30087312	.	A	T	2	4	6	0	0	6	0	0
11	30087429	.	G	A	11	11	22	0	0	22	0	0
11	30087885	.	C	T	4	7	11	0	1	12	0	0
11	30088392	.	A	T	15	7	22	0	3	25	0	0
11	30088427	.	G	A	12	7	19	0	0	19	0	0
11	30088560	.	G	T	4	12	16	0	1	17	0	0
11	30089649	.	A	G	15	10	25	0	0	25	0	0
11	30089671	.	G	A	10	6	16	0	2	18	0	0
11	30106429	.	C	T	5	2	7	0	1	8	0	0
11	30106790	.	A	C	1	7	8	0	0	8	0	0
11	30107224	.	G	T	5	3	8	0	0	8	0	0
11	30107299	.	T	G	6	7	13	0	2	15	0	0
11	30107366	.	A	G	4	8	12	0	0	12	0	0
11	30107405	.	T	C	2	7	9	0	0	9	0	0
11	30107417	.	C	T	3	6	9	0	0	9	0	0
11	30113047	.	C	T	0	4	4	0	4	8	0	0
11	30118871	.	T	C	6	1	7	0	3	10	0	0
11	30118970	.	A	G	3	7	10	0	1	11	0	0
11	30122741	.	G	A	4	4	8	0	0	8	0	0
11	30123439	.	G	A	1	3	4	0	0	4	0	0
11	30148024	.	G	A	1	2	3	0	0	3	0	0
11	30149775	.	C	A	2	3	5	0	0	5	0	0
11	30205707	.	C	A	6	6	12	0	0	12	0	0
11	30205713	.	C	T	5	3	8	0	3	11	0	0
11	30219477	.	G	A	0	10	10	0	7	17	0	0
11	30219663	.	T	C	17	16	33	0	1	34	0	0
11	30221173	.	A	G	13	0	13	0	21	34	0	0
11	30221188	.	A	G	12	17	29	0	2	31	0	0
11	30222942	.	G	A	12	14	26	0	1	27	0	0
11	30231104	.	C	T	25	21	46	2	2	50	0	0
11	30231269	.	A	G	25	18	43	0	1	44	0	0
11	30231416	.	T	A	11	12	23	0	3	26	0	0
11	30251411	.	G	A	3	2	5	0	0	5	0	0
11	30258167	.	T	G	1	3	4	0	0	4	0	0
11	30366944	.	G	A	2	3	5	0	0	5	0	0
11	30367024	.	T	A	2	2	4	0	0	4	0	0
11	30642164	.	A	G	4	2	6	0	1	7	0	0
11	31024887	.	A	G	7	5	12	0	1	13	0	0
11	31668751	.	A	G	2	4	6	0	0	6	0	0
11	31668752	.	A	G	4	2	6	0	0	6	0	0
11	33545012	.	G	A	4	2	6	0	0	6	0	0
11	33598851	.	G	C	2	2	4	0	3	7	0	0
11	33846497	.	T	C	8	4	12	0	2	14	0	0
11	33846519	.	T	C	9	5	14	0	0	14	0	0
11	33846566	.	T	C	4	7	11	0	0	11	0	0
11	33997605	.	T	C	2	3	5	0	0	5	0	0
11	33998890	.	T	A	2	2	4	0	0	4	0	0
11	34911229	.	G	A	4	17	21	1	0	22	0	0
11	35184479	.	T	A	2	3	5	0	1	6	0	0
11	36042551	.	G	A	1	2	3	0	1	4	0	0
11	36158379	.	A	C	3	2	5	0	0	5	0	0
11	36180612	.	C	T	3	6	9	0	0	9	0	0
11	36180831	.	G	T	1	3	4	0	3	7	0	0
11	36205992	.	C	T	2	6	8	0	0	8	0	0
11	36206090	.	C	T	6	3	9	0	0	9	0	0
11	36208199	.	G	A	10	9	19	0	0	19	0	0
11	36208328	.	G	A	0	6	6	0	10	16	0	0
11	36214517	.	C	T	24	17	41	0	1	42	0	0
11	36214815	.	G	A	2	16	18	0	12	30	0	0
11	36214859	.	C	T	14	15	29	0	0	29	0	0
11	36214955	.	A	T	11	14	25	0	0	25	0	0
11	36215346	.	G	A	5	11	16	0	4	20	0	0
11	36215399	.	A	G	17	14	31	0	2	33	0	0
11	36222707	.	G	A	2	1	3	0	1	4	0	0
11	36224573	.	G	A	2	3	5	0	0	5	0	0
11	36224767	.	G	A	6	2	8	0	0	8	0	0
11	36224780	.	T	C	3	0	3	0	4	7	0	0
11	36227589	.	C	G	0	5	5	0	2	7	0	0
11	36228124	.	G	A	1	4	5	0	0	5	0	0
11	36230101	.	G	A	4	2	6	0	0	6	0	0
11	36236950	.	G	A	0	3	3	0	1	4	0	0
11	36237094	.	C	T	1	4	5	0	0	5	0	0
11	36237421	.	T	C	2	5	7	0	0	7	0	0
11	36269682	.	G	A	6	4	10	0	1	11	0	0
11	36269768	.	A	G	10	5	15	0	1	16	0	0
11	36269788	.	A	G	10	7	17	0	1	18	0	0
11	36281939	.	T	G	5	6	11	2	0	13	0	0
11	36281943	.	G	A	5	5	10	2	1	13	0	0
11	36282259	.	A	T	6	4	10	0	0	10	0	0
11	36282417	.	G	T	7	6	13	0	1	14	0	0
11	36282450	.	G	T	6	5	11	0	4	15	0	0
11	36282494	.	G	T	9	3	12	0	0	12	0	0
11	36282501	.	C	T	9	4	13	0	1	14	0	0
11	36282534	.	A	G	10	3	13	0	0	13	0	0
11	36282961	.	G	A	2	3	5	0	4	9	0	0
11	36283728	.	A	G	8	5	13	0	1	14	0	0
11	36291207	.	G	A	4	4	8	0	0	8	0	0
11	36291208	.	T	C	4	4	8	0	0	8	0	0
11	36343167	.	G	C	15	13	28	0	1	29	0	0
11	36343339	.	A	T	15	9	24	0	0	24	0	0
11	36346578	.	A	T	7	8	15	0	3	18	0	0
11	36372937	.	A	G	2	2	4	0	0	4	0	0
11	36373645	.	G	A	0	2	2	2	1	5	0	0
11	36373685	.	G	A	2	2	4	1	0	5	0	0
11	36373738	.	T	C	1	3	4	2	0	6	0	0
11	36373746	.	T	C	1	3	4	2	0	6	0	0
11	36374944	.	T	G	3	7	10	0	1	11	0	0
11	36374958	.	T	C	4	6	10	0	2	12	0	0
11	36374993	.	G	T	5	4	9	0	0	9	0	0
11	36375120	.	T	G	4	6	10	4	0	14	0	0
11	36375293	.	G	A	4	4	8	0	0	8	0	0
11	36375367	.	T	C	3	4	7	0	0	7	0	0
11	36375671	.	C	T	5	9	14	0	2	16	0	0
11	36375708	.	A	G	8	5	13	0	2	15	0	0
11	36375774	.	A	T	8	8	16	0	1	17	0	0
11	36375852	.	T	G	5	9	14	0	0	14	0	0
11	36388511	.	A	C	3	2	5	0	0	5	0	0
11	36393111	.	A	G	7	1	8	0	4	12	0	0
11	36393150	.	T	A	7	3	10	0	0	10	0	0
11	36395136	.	A	T	2	5	7	0	1	8	0	0
11	36395728	.	T	C	6	7	13	0	2	15	0	0
11	36398192	.	G	A	1	7	8	0	2	10	0	0
11	36398531	.	A	G	5	0	5	0	5	10	0	0
11	36398558	.	T	A	3	8	11	0	0	11	0	0
11	36398624	.	C	T	5	8	13	0	0	13	0	0
11	36434704	.	G	A	1	3	4	0	0	4	0	0
11	36452372	.	G	A	1	4	5	0	0	5	0	0
11	36452453	.	C	A	1	4	5	0	0	5	0	0
11	36452688	.	A	G	10	5	15	0	0	15	0	0
11	36456011	.	C	T	0	3	3	0	7	10	0	0
11	36456056	.	T	C	5	7	12	0	0	12	0	0
11	36456058	.	T	G	5	7	12	0	0	12	0	0
11	36456101	.	T	A	3	7	10	0	3	13	0	0
11	36456125	.	A	C	2	0	2	0	11	13	0	0
11	36460829	.	G	A	6	12	18	0	0	18	0	0
11	36460988	.	A	G	6	7	13	0	0	13	0	0
11	36463965	.	T	C	9	7	16	0	0	16	0	0
11	36464396	.	T	C	2	0	2	0	6	8	0	0
11	36464541	.	T	A	8	3	11	0	0	11	0	0
11	36464565	.	G	C	6	3	9	0	0	9	0	0
11	36467948	.	C	T	2	7	9	0	0	9	0	0
11	36468047	.	G	A	8	5	13	0	0	13	0	0
11	36470493	.	C	T	0	5	5	0	1	6	0	0
11	36470651	.	G	A	10	4	14	0	0	14	0	0
11	36472383	.	G	A	2	4	6	0	0	6	0	0
11	36472395	.	C	T	2	3	5	0	0	5	0	0
11	36477626	.	G	A	7	2	9	0	1	10	0	0
11	36477777	.	C	T	4	3	7	0	1	8	0	0
11	36477803	.	C	T	3	5	8	0	0	8	0	0
11	36482269	.	A	G	2	5	7	0	4	11	0	0
11	36482311	.	C	T	5	8	13	0	1	14	0	0
11	36484836	.	G	A	8	4	12	0	1	13	0	0
11	36485042	.	A	G	6	0	6	0	6	12	0	0
11	36489169	.	G	C	6	5	11	0	0	11	0	0
11	36489205	.	T	C	7	5	12	0	0	12	0	0
11	36489428	.	A	T	1	6	7	0	0	7	0	0
11	36489584	.	T	G	4	6	10	0	0	10	0	0
11	36489706	.	T	C	2	3	5	0	0	5	0	0
11	36689425	.	T	C	5	8	13	0	1	14	0	0
11	36689486	.	A	G	8	8	16	0	0	16	0	0
11	36695094	.	A	G	7	6	13	0	2	15	0	0
11	36695103	.	G	A	8	7	15	0	0	15	0	0
11	36712859	.	C	A	1	2	3	0	0	3	0	0
11	36712878	.	G	T	1	3	4	0	0	4	0	0
11	36793697	.	G	T	9	8	17	0	0	17	0	0
11	36793859	.	G	A	4	2	6	0	2	8	0	0
11	36795564	.	G	T	8	7	15	0	0	15	0	0
11	36797149	.	C	T	0	5	5	0	9	14	0	0
11	36801796	.	G	A	12	9	21	0	1	22	0	0
11	36806296	.	A	G	12	10	22	0	1	23	0	0
11	36816163	.	T	C	5	3	8	0	0	8	0	0
11	36816171	.	T	C	3	4	7	0	0	7	0	0
11	36818820	.	A	T	8	5	13	0	1	14	0	0
11	36819529	.	C	T	3	7	10	0	1	11	0	0
11	36995485	.	A	G	2	3	5	0	0	5	0	0
11	36995494	.	A	G	1	3	4	0	0	4	0	0
11	37001740	.	C	T	3	3	6	0	0	6	0	0
11	37002607	.	C	T	4	4	8	0	0	8	0	0
11	37002616	.	G	A	4	4	8	0	0	8	0	0
11	37004670	.	C	T	6	4	10	0	1	11	0	0
11	37015956	.	C	T	3	4	7	0	0	7	0	0
11	37015968	.	T	C	3	4	7	0	0	7	0	0
11	37020723	.	C	T	6	5	11	0	0	11	0	0
11	37031950	.	C	T	17	5	22	0	0	22	0	0
11	37032055	.	G	A	10	7	17	0	1	18	0	0
11	37032454	.	T	C	2	3	5	0	0	5	0	0
11	37032546	.	C	T	8	2	10	0	0	10	0	0
11	37032739	.	C	T	6	4	10	0	0	10	0	0
11	37032740	.	A	T	6	4	10	0	0	10	0	0
11	37032854	.	C	A	8	3	11	0	0	11	0	0
11	37033333	.	A	C	16	6	22	0	1	23	0	0
11	37033348	.	C	A	15	6	21	0	0	21	0	0
11	37033373	.	C	T	11	7	18	0	0	18	0	0
11	37033603	.	T	A	4	3	7	0	0	7	0	0
11	37033676	.	C	T	9	10	19	0	0	19	0	0
11	37033767	.	C	T	5	2	7	0	0	7	0	0
11	37033813	.	C	G	10	6	16	0	0	16	0	0
11	37033846	.	G	C	11	6	17	0	0	17	0	0
11	37033855	.	T	A	11	5	16	0	0	16	0	0
11	37034474	.	A	T	3	1	4	0	1	5	0	0
11	37034962	.	A	G	7	3	10	0	1	11	0	0
11	37035240	.	T	A	4	7	11	0	3	14	0	0
11	37035454	.	A	G	16	0	16	0	10	26	0	0
11	37049469	.	A	T	2	3	5	1	0	6	0	0
11	37070236	.	C	T	2	2	4	0	0	4	0	0
11	37080550	.	C	T	1	2	3	0	0	3	0	0
11	37080880	.	C	G	2	2	4	0	1	5	0	0
11	37081040	.	T	G	1	0	1	0	2	3	0	0
11	37081058	.	T	C	1	3	4	0	0	4	0	0
11	37081112	.	A	G	2	2	4	0	0	4	0	0
11	37084157	.	T	C	7	3	10	0	0	10	0	0
11	37088448	.	G	A	1	3	4	0	0	4	0	0
11	37096571	.	T	A	1	3	4	0	0	4	0	0
11	37100327	.	T	C	3	2	5	0	0	5	0	0
11	37109243	.	A	G	1	2	3	0	0	3	0	0
11	37137762	.	A	T	3	3	6	0	0	6	0	0
11	37137768	.	A	G	2	3	5	0	0	5	0	0
11	37144633	.	C	A	1	6	7	0	0	7	0	0
11	37152410	.	T	G	3	0	3	0	3	6	0	0
11	37153681	.	C	T	4	4	8	0	1	9	0	0
11	37153687	.	T	C	4	4	8	0	0	8	0	0
11	37155247	.	A	T	6	4	10	0	1	11	0	0
11	37155353	.	A	G	3	0	3	0	6	9	0	0
11	37155394	.	A	G	3	8	11	0	1	12	0	0
11	37155400	.	T	A	9	4	13	0	0	13	0	0
11	37159490	.	C	T	8	8	16	0	1	17	0	0
11	37159902	.	G	A	4	2	6	0	1	7	0	0
11	37159994	.	T	A	4	0	4	0	0	4	0	0
11	37161822	.	G	A	1	5	6	0	7	13	0	0
11	37162310	.	A	G	4	5	9	0	0	9	0	0
11	37162529	.	G	A	5	7	12	0	0	12	0	0
11	37163874	.	A	G	6	9	15	0	1	16	0	0
11	37164191	.	G	C	4	7	11	0	0	11	0	0
11	37164510	.	T	C	9	9	18	0	0	18	0	0
11	37167289	.	A	G	8	8	16	0	1	17	0	0
11	37167402	.	A	G	8	0	8	0	11	19	0	0
11	37167669	.	C	T	10	4	14	0	0	14	0	0
11	37167955	.	G	A	7	5	12	0	1	13	0	0
11	37167991	.	T	C	7	6	13	0	1	14	0	0
11	37168147	.	T	C	4	12	16	0	0	16	0	0
11	37168162	.	T	A	6	14	20	0	0	20	0	0
11	37169108	.	A	G	10	14	24	0	4	28	0	0
11	37169144	.	G	A	6	13	19	0	0	19	0	0
11	37169269	.	G	A	17	15	32	0	5	37	0	0
11	37169931	.	T	C	2	2	4	0	0	4	0	0
11	37169958	.	C	T	1	3	4	0	0	4	0	0
11	37170409	.	A	G	17	0	17	0	20	37	0	0
11	37297811	.	A	T	27	23	50	0	0	50	0	0
11	37297951	.	T	C	26	19	45	0	0	45	0	0
11	37298028	.	T	A	13	9	22	1	3	26	0	0
11	37298718	.	G	A	17	18	35	0	0	35	0	0
11	37298796	.	G	A	15	8	23	0	0	23	0	0
11	37313177	.	C	T	4	6	10	0	4	14	0	0
11	37337444	.	G	A	1	5	6	0	0	6	0	0
11	37337450	.	C	G	1	5	6	0	2	8	0	0
11	37359387	.	C	T	0	2	2	0	1	3	0	0
11	37411007	.	C	G	2	3	5	0	0	5	0	0
11	37431722	.	C	T	2	3	5	0	0	5	0	0
11	37431953	.	C	T	30	25	55	1	2	58	0	0
11	37434618	.	C	T	17	20	37	0	2	39	0	0
11	37441257	.	T	G	29	17	46	0	4	50	0	0
11	37442557	.	G	A	9	14	23	0	1	24	0	0
11	37442772	.	G	T	7	9	16	0	0	16	0	0
11	37445084	.	G	A	15	14	29	0	0	29	0	0
11	37445680	.	C	T	9	10	19	0	1	20	0	0
11	37445825	.	G	A	10	13	23	0	1	24	0	0
11	37446107	.	G	A	2	3	5	0	0	5	0	0
11	37446173	.	T	A	2	2	4	0	3	7	0	0
11	37446224	.	G	C	7	0	7	0	4	11	0	0
11	37446700	.	C	T	10	6	16	0	1	17	0	0
11	37446736	.	C	G	11	5	16	0	0	16	0	0
11	37447754	.	C	T	0	2	2	0	5	7	0	0
11	37448264	.	G	A	3	6	9	0	0	9	0	0
11	37448396	.	T	C	1	5	6	0	1	7	0	0
11	37449089	.	C	T	0	2	2	0	3	5	0	0
11	37449098	.	G	T	2	3	5	0	0	5	0	0
11	37548381	.	C	T	2	2	4	0	0	4	0	0
11	37548618	.	A	T	1	3	4	0	0	4	0	0
11	37613577	.	G	A	12	15	27	0	2	29	0	0
11	37628230	.	C	T	33	23	56	0	4	60	0	0
11	37628595	.	T	C	22	12	34	0	0	34	0	0
11	37628816	.	T	C	16	22	38	0	3	41	0	0
11	37628831	.	C	T	17	21	38	0	2	40	0	0
11	37628863	.	T	A	17	25	42	0	0	42	0	0
11	37629046	.	G	A	32	13	45	0	1	46	0	0
11	37709031	.	A	C	9	3	12	0	0	12	0	0
11	37709033	.	A	G	8	3	11	0	0	11	0	0
11	37709133	.	G	A	9	4	13	2	0	15	0	0
11	37709303	.	C	A	9	8	17	0	2	19	0	0
11	37709334	.	T	C	9	11	20	0	4	24	0	0
11	37709450	.	T	C	4	0	4	0	9	13	0	0
11	37709475	.	C	A	3	10	13	0	1	14	0	0
11	37709542	.	T	C	8	6	14	0	3	17	0	0
11	37709545	.	G	A	11	7	18	0	0	18	0	0
11	37709677	.	A	G	8	6	14	0	0	14	0	0
11	37709998	.	A	C	2	2	4	0	0	4	0	0
11	37710026	.	T	A	1	2	3	0	0	3	0	0
11	37710089	.	C	T	2	2	4	0	0	4	0	0
11	37710096	.	C	T	3	3	6	0	0	6	0	0
11	37710164	.	G	A	4	1	5	0	1	6	0	0
11	37710172	.	C	T	0	1	1	0	4	5	0	0
11	37710272	.	G	A	3	5	8	0	2	10	0	0
11	37710680	.	A	G	4	7	11	0	0	11	0	0
11	37710709	.	T	C	8	0	8	0	7	15	0	0
11	37710790	.	G	A	2	4	6	0	0	6	0	0
11	37710960	.	A	G	8	5	13	0	0	13	0	0
11	37710962	.	A	G	9	5	14	0	0	14	0	0
11	37711005	.	G	A	5	7	12	0	1	13	0	0
11	37711498	.	G	A	4	2	6	0	0	6	0	0
11	37711507	.	A	G	3	3	6	0	0	6	0	0
11	37711540	.	T	C	3	2	5	0	0	5	0	0
11	37717543	.	C	T	0	2	2	0	5	7	0	0
11	37720622	.	C	A	19	14	33	0	2	35	0	0
11	37720658	.	G	A	19	22	41	0	5	46	0	0
11	37720671	.	A	G	19	17	36	0	1	37	0	0
11	37722445	.	G	A	30	15	45	0	0	45	0	0
11	37725854	.	C	T	16	12	28	0	2	30	0	0
11	37816436	.	A	G	1	3	4	0	0	4	0	0
11	37828624	.	T	A	1	2	3	0	0	3	0	0
11	37828740	.	A	C	2	3	5	0	0	5	0	0
11	37829168	.	A	C	4	4	8	0	0	8	0	0
11	37829325	.	C	T	2	3	5	0	0	5	0	0
11	37829740	.	C	T	1	4	5	0	1	6	0	0
11	37830890	.	A	T	3	3	6	0	1	7	0	0
11	37831082	.	T	G	5	5	10	0	1	11	0	0
11	37831111	.	A	C	2	2	4	0	2	6	0	0
11	37831346	.	G	A	2	1	3	0	0	3	0	0
11	37848961	.	G	A	3	2	5	0	0	5	0	0
11	37949654	.	G	C	1	0	1	0	2	3	0	0
11	38807888	.	A	G	7	1	8	0	1	9	0	0
11	38807933	.	T	C	3	8	11	0	0	11	0	0
11	38807987	.	C	T	5	8	13	0	0	13	0	0
11	38844445	.	G	C	14	9	23	0	0	23	0	0
11	38844481	.	T	C	10	12	22	0	1	23	0	0
11	38846017	.	G	A	0	13	13	0	9	22	0	0
11	38846316	.	T	A	11	9	20	0	1	21	0	0
11	38846361	.	G	A	8	8	16	0	1	17	0	0
11	38850244	.	G	A	1	6	7	0	8	15	0	0
11	38865710	.	A	G	19	15	34	0	1	35	0	0
11	38875221	.	A	G	19	10	29	0	0	29	0	0
11	38875283	.	A	T	20	10	30	0	3	33	0	0
11	38875352	.	G	A	27	20	47	0	0	47	0	0
11	38875397	.	T	G	18	18	36	0	1	37	0	0
11	38875484	.	A	C	16	13	29	0	0	29	0	0
11	38875660	.	T	C	16	17	33	0	0	33	0	0
11	38875867	.	T	C	5	11	16	0	0	16	0	0
11	39044412	.	T	C	2	2	4	0	1	5	0	0
11	39075661	.	G	T	1	1	2	0	0	2	0	0
11	39075679	.	C	T	0	2	2	0	1	3	0	0
11	39076002	.	T	A	2	4	6	0	0	6	0	0
11	39109555	.	C	T	5	9	14	0	0	14	0	0
11	39109968	.	C	T	7	6	13	0	1	14	0	0
11	39110046	.	C	T	11	9	20	0	0	20	0	0
11	39112035	.	A	G	6	5	11	1	0	12	0	0
11	39112957	.	G	A	3	4	7	0	0	7	0	0
11	39113067	.	G	T	3	4	7	0	0	7	0	0
11	39113219	.	T	A	0	3	3	0	1	4	0	0
11	39113224	.	C	T	1	3	4	0	0	4	0	0
11	39113423	.	C	G	3	4	7	0	0	7	0	0
11	39113449	.	G	T	2	5	7	0	0	7	0	0
11	39114164	.	C	G	1	4	5	0	0	5	0	0
11	39114195	.	C	A	1	2	3	0	1	4	0	0
11	39114764	.	T	C	4	1	5	0	2	7	0	0
11	39135160	.	T	A	19	27	46	0	0	46	0	0
11	39135834	.	C	G	18	30	48	0	3	51	0	0
11	39141536	.	A	C	27	22	49	0	4	53	0	0
11	39141732	.	T	G	16	11	27	1	2	30	0	0
11	39922714	.	A	C	15	15	30	0	2	32	0	0
11	40644440	.	G	T	4	3	7	0	0	7	0	0
11	40644458	.	A	G	3	3	6	0	0	6	0	0
11	40647099	.	T	C	5	0	5	0	2	7	0	0
11	40647123	.	A	C	6	4	10	0	1	11	0	0
11	40655819	.	T	C	7	8	15	0	2	17	0	0
11	40658079	.	A	C	14	10	24	0	1	25	0	0
11	40658091	.	A	T	14	8	22	0	1	23	0	0
11	40658154	.	C	G	16	0	16	0	9	25	0	0
11	40658232	.	C	T	13	8	21	0	0	21	0	0
11	40658352	.	G	A	2	7	9	0	8	17	0	0
11	40658455	.	T	C	10	10	20	0	0	20	0	0
11	40661378	.	T	C	10	9	19	0	0	19	0	0
11	40665545	.	T	C	16	14	30	1	1	32	0	0
11	40665602	.	G	T	1	15	16	0	18	34	0	0
11	40673797	.	C	T	14	18	32	0	0	32	0	0
11	40673877	.	A	G	11	14	25	0	0	25	0	0
11	40677891	.	A	T	24	23	47	0	0	47	0	0
11	40677967	.	T	C	36	16	52	0	4	56	0	0
11	40678385	.	T	G	36	26	62	0	4	66	0	0
11	40678445	.	A	C	34	0	34	0	31	65	0	0
11	40680890	.	A	G	42	23	65	0	2	67	0	0
11	40714898	.	A	G	2	3	5	0	0	5	0	0
11	40714899	.	A	C	2	3	5	0	0	5	0	0
11	40831754	.	A	G	3	1	4	0	7	11	0	0
11	40840238	.	T	C	7	3	10	0	0	10	0	0
11	40840407	.	T	C	7	5	12	0	0	12	0	0
11	40843208	.	T	C	4	4	8	0	0	8	0	0
11	40843814	.	T	C	4	7	11	0	1	12	0	0
11	40844162	.	T	C	10	8	18	0	0	18	0	0
11	40844195	.	A	T	7	5	12	0	4	16	0	0
11	40845515	.	T	C	4	7	11	0	0	11	0	0
11	41066190	.	T	G	16	0	16	0	13	29	0	0
11	41066765	.	T	G	23	6	29	0	1	30	0	0
11	41066871	.	C	T	17	10	27	0	0	27	0	0
11	41066888	.	C	T	17	10	27	0	1	28	0	0
11	41066950	.	A	G	8	19	27	0	2	29	0	0
11	41067275	.	G	A	4	17	21	1	0	22	0	0
11	41067430	.	A	T	3	11	14	0	0	14	0	0
11	41067442	.	C	T	2	17	19	0	0	19	0	0
11	41078522	.	C	A	5	5	10	0	1	11	0	0
11	41078578	.	A	T	11	7	18	0	0	18	0	0
11	41078762	.	A	T	18	17	35	0	0	35	0	0
11	41084325	.	T	G	20	19	39	0	1	40	0	0
11	41089579	.	T	C	1	2	3	0	0	3	0	0
11	41089631	.	G	T	3	5	8	0	0	8	0	0
11	41089641	.	T	C	4	5	9	0	0	9	0	0
11	41101666	.	A	G	10	7	17	0	1	18	0	0
11	41101760	.	A	T	2	3	5	0	0	5	0	0
11	41101783	.	C	T	4	1	5	0	0	5	0	0
11	41101800	.	T	A	2	3	5	0	0	5	0	0
11	41101866	.	C	T	9	6	15	0	0	15	0	0
11	41101910	.	G	A	7	5	12	0	0	12	0	0
11	41101918	.	C	T	8	4	12	0	0	12	0	0
11	41101948	.	A	G	6	1	7	0	3	10	0	0
11	41102205	.	A	G	4	4	8	0	0	8	0	0
11	41104549	.	A	G	6	7	13	0	0	13	0	0
11	41104934	.	G	A	4	7	11	0	0	11	0	0
11	41104954	.	C	T	5	9	14	0	1	15	0	0
11	41105030	.	G	A	0	4	4	0	8	12	0	0
11	41105144	.	T	G	4	0	4	0	8	12	0	0
11	41111301	.	A	G	11	9	20	0	1	21	0	0
11	41111334	.	T	C	6	10	16	0	1	17	0	0
11	41111370	.	C	T	6	12	18	0	0	18	0	0
11	41111422	.	A	G	8	7	15	0	1	16	0	0
11	41111431	.	A	C	6	7	13	0	0	13	0	0
11	41111603	.	T	A	3	3	6	0	0	6	0	0
11	41111735	.	G	A	3	6	9	0	0	9	0	0
11	41113412	.	C	T	3	3	6	0	0	6	0	0
11	41114055	.	C	T	0	4	4	0	3	7	0	0
11	41114090	.	G	T	3	7	10	0	1	11	0	0
11	41114186	.	A	C	3	6	9	0	0	9	0	0
11	41125040	.	A	G	3	2	5	0	0	5	0	0
11	41132195	.	A	G	5	3	8	0	1	9	0	0
11	41216254	.	C	G	0	2	2	0	3	5	0	0
11	41216315	.	C	T	0	8	8	0	3	11	0	0
11	41216395	.	A	G	1	7	8	0	0	8	0	0
11	41216413	.	C	A	1	6	7	0	0	7	0	0
11	41216455	.	T	C	2	0	2	0	9	11	0	0
11	41216505	.	G	C	4	15	19	0	0	19	0	0
11	41220596	.	G	A	8	10	18	0	0	18	0	0
11	41220613	.	C	T	1	6	7	0	10	17	0	0
11	41220683	.	T	A	11	13	24	0	1	25	0	0
11	41222940	.	A	G	11	10	21	0	0	21	0	0
11	41244604	.	T	G	3	3	6	0	0	6	0	0
11	41244709	.	G	A	0	2	2	0	3	5	0	0
11	41284921	.	C	T	2	6	8	0	1	9	0	0
11	41306035	.	G	A	0	8	8	0	5	13	0	0
11	41307691	.	T	C	7	11	18	0	0	18	0	0
11	41307733	.	A	G	5	11	16	0	0	16	0	0
11	41307844	.	T	C	10	5	15	0	1	16	0	0
11	41363778	.	G	A	1	6	7	0	10	17	0	0
11	41372906	.	G	T	0	3	3	0	2	5	0	0
11	41459981	.	G	C	0	25	25	0	15	40	0	0
11	41461417	.	C	G	18	27	45	0	1	46	0	0
11	41463534	.	C	G	19	20	39	3	3	45	0	0
11	41468791	.	C	T	13	23	36	1	0	37	0	0
11	41473980	.	G	T	10	12	22	0	3	25	0	0
11	41474041	.	T	A	9	9	18	0	1	19	0	0
11	41474042	.	G	T	9	9	18	0	1	19	0	0
11	41660756	.	G	A	1	2	3	0	1	4	0	0
11	41669291	.	C	T	1	2	3	0	0	3	0	0
11	41838873	.	G	A	7	5	12	0	0	12	0	0
11	41838878	.	G	C	7	5	12	0	0	12	0	0
11	41838930	.	T	A	4	4	8	0	1	9	0	0
11	41838933	.	C	A	6	4	10	0	0	10	0	0
11	41838991	.	T	G	4	0	4	0	5	9	0	0
11	41838999	.	G	T	4	4	8	0	1	9	0	0
11	41840493	.	T	C	4	4	8	0	0	8	0	0
11	41840601	.	A	T	6	6	12	0	0	12	0	0
11	41842313	.	C	T	5	5	10	0	0	10	0	0
11	41844192	.	C	A	11	9	20	0	1	21	0	0
11	41845852	.	A	T	7	1	8	0	0	8	0	0
11	41845887	.	A	T	5	3	8	0	0	8	0	0
11	41846123	.	A	C	3	0	3	0	5	8	0	0
11	41846699	.	C	T	9	7	16	0	0	16	0	0
11	41859518	.	G	A	1	2	3	0	0	3	0	0
11	41859542	.	G	A	1	2	3	0	0	3	0	0
11	42128561	.	G	A	4	3	7	0	1	8	0	0
11	42131413	.	T	C	3	0	3	0	9	12	0	0
11	42457358	.	G	A	4	3	7	0	0	7	0	0
11	42608394	.	T	C	3	2	5	0	1	6	0	0
11	42610466	.	C	T	5	5	10	0	0	10	0	0
11	42618675	.	A	G	11	0	11	0	8	19	0	0
11	42618720	.	A	G	8	3	11	0	1	12	0	0
11	42618726	.	C	T	7	4	11	0	0	11	0	0
11	42719113	.	G	A	2	2	4	0	0	4	0	0
11	42730657	.	A	G	23	7	30	0	2	32	0	0
11	42730895	.	C	T	17	17	34	0	2	36	0	0
11	42730974	.	T	G	19	1	20	0	11	31	0	0
11	42730982	.	T	C	20	13	33	0	1	34	0	0
11	42731172	.	G	T	24	11	35	0	1	36	0	0
11	42732358	.	T	C	20	8	28	0	0	28	0	0
11	42732575	.	A	G	1	3	4	0	0	4	0	0
11	42753520	.	G	A	1	3	4	0	1	5	0	0
11	42753540	.	A	C	1	3	4	0	0	4	0	0
11	42755170	.	T	G	1	2	3	0	0	3	0	0
11	42766053	.	A	G	2	4	6	0	0	6	0	0
11	42783922	.	G	A	0	3	3	0	6	9	0	0
11	42783955	.	G	C	4	4	8	0	0	8	0	0
11	42793640	.	T	A	3	3	6	0	0	6	0	0
11	42801508	.	T	A	4	6	10	0	3	13	0	0
11	42809233	.	A	G	3	4	7	0	1	8	0	0
11	42809438	.	G	C	6	5	11	4	1	16	0	0
11	42809717	.	G	A	0	8	8	0	6	14	0	0
11	42811938	.	G	A	0	6	6	0	5	11	0	0
11	42814979	.	C	A	5	3	8	1	2	11	0	0
11	42814985	.	C	A	5	2	7	1	1	9	0	0
11	42815925	.	A	G	2	3	5	0	0	5	0	0
11	42816352	.	C	G	9	8	17	0	0	17	0	0
11	42816372	.	T	C	7	8	15	0	1	16	0	0
11	42816496	.	A	G	10	3	13	0	0	13	0	0
11	42816617	.	G	T	15	7	22	0	0	22	0	0
11	42816803	.	T	A	9	3	12	0	0	12	0	0
11	42816815	.	T	C	8	4	12	0	1	13	0	0
11	42816841	.	G	T	4	5	9	0	0	9	0	0
11	42816859	.	C	T	2	6	8	0	0	8	0	0
11	42816897	.	T	C	2	3	5	0	1	6	0	0
11	42816985	.	T	C	1	8	9	0	0	9	0	0
11	42817001	.	A	T	1	6	7	0	0	7	0	0
11	42817067	.	A	G	1	6	7	0	0	7	0	0
11	42817075	.	T	G	2	0	2	0	6	8	0	0
11	42817257	.	T	A	1	6	7	0	2	9	0	0
11	42817299	.	C	T	7	4	11	0	0	11	0	0
11	42817300	.	C	T	7	4	11	0	0	11	0	0
11	42817359	.	A	T	7	5	12	0	1	13	0	0
11	42817411	.	T	C	10	4	14	0	0	14	0	0
11	42817598	.	A	G	5	0	5	0	7	12	0	0
11	42817604	.	G	T	5	6	11	0	0	11	0	0
11	42913020	.	A	G	5	2	7	0	1	8	0	0
11	42913021	.	C	T	0	2	2	0	6	8	0	0
11	42916130	.	T	C	2	2	4	0	0	4	0	0
11	42917357	.	G	T	1	2	3	0	0	3	0	0
11	42917366	.	G	A	1	2	3	0	0	3	0	0
11	42933019	.	A	G	2	4	6	0	0	6	0	0
11	42933432	.	C	T	2	2	4	0	1	5	0	0
11	42933696	.	A	G	7	9	16	0	0	16	0	0
11	42933703	.	T	C	6	8	14	0	0	14	0	0
11	42933780	.	G	A	13	8	21	0	1	22	0	0
11	42939803	.	T	C	11	8	19	0	1	20	0	0
11	42940748	.	C	T	5	6	11	0	0	11	0	0
11	42942921	.	C	T	0	5	5	0	5	10	0	0
11	42942930	.	G	A	3	5	8	0	0	8	0	0
11	43159295	.	T	C	17	0	17	0	25	42	0	0
11	43164302	.	G	T	9	13	22	0	1	23	0	0
11	43167677	.	A	T	18	13	31	0	3	34	0	0
11	43170792	.	A	C	21	0	21	0	17	38	0	0
11	43170804	.	G	A	22	16	38	0	1	39	0	0
11	43170924	.	A	G	19	14	33	0	2	35	0	0
11	43171230	.	T	A	11	8	19	0	2	21	0	0
11	43171281	.	A	G	11	12	23	0	3	26	0	0
11	43179006	.	G	C	12	12	24	0	0	24	0	0
11	43179639	.	G	A	11	7	18	0	0	18	0	0
11	43179651	.	A	G	10	9	19	0	0	19	0	0
11	43187495	.	T	C	14	12	26	0	0	26	0	0
11	43189275	.	T	G	7	8	15	0	2	17	0	0
11	43190846	.	G	A	11	8	19	0	1	20	0	0
11	43470332	.	T	C	6	2	8	0	0	8	0	0
11	43470337	.	T	C	5	2	7	0	2	9	0	0
11	43678113	.	G	A	1	2	3	0	0	3	0	0
11	43711700	.	C	A	1	2	3	0	0	3	0	0
11	43712829	.	T	C	1	2	3	0	0	3	0	0
11	43713102	.	A	G	1	0	1	0	3	4	0	0
11	44019868	.	A	G	10	7	17	0	0	17	0	0
11	44021999	.	T	G	8	5	13	0	0	13	0	0
11	44023934	.	C	T	3	4	7	0	1	8	0	0
11	44024006	.	C	T	1	5	6	0	9	15	0	0
11	44144697	.	T	C	2	3	5	0	1	6	0	0
11	44144928	.	G	A	25	26	51	0	3	54	0	0
11	44144958	.	T	G	30	30	60	0	6	66	0	0
11	44148453	.	A	G	25	21	46	0	1	47	0	0
11	44152579	.	C	T	24	17	41	0	2	43	0	0
11	44152693	.	T	G	22	20	42	0	1	43	0	0
11	44152795	.	T	C	28	24	52	0	2	54	0	0
11	44153038	.	G	A	12	15	27	0	1	28	0	0
11	44155422	.	G	A	12	9	21	3	1	25	0	0
11	44155479	.	T	C	9	0	9	0	11	20	0	0
11	44155485	.	T	C	9	0	9	0	11	20	0	0
11	44155706	.	C	T	1	11	12	0	10	22	0	0
11	44157752	.	G	A	13	9	22	0	0	22	0	0
11	44159320	.	G	C	7	10	17	0	1	18	0	0
11	44163064	.	G	T	12	11	23	0	2	25	0	0
11	44180439	.	C	A	2	2	4	0	0	4	0	0
11	44180442	.	T	A	2	2	4	0	0	4	0	0
11	44180484	.	T	A	1	3	4	0	1	5	0	0
11	44180486	.	T	G	2	2	4	0	1	5	0	0
11	44184074	.	A	G	1	3	4	0	0	4	0	0
11	44226545	.	G	T	0	4	4	0	3	7	0	0
11	44236394	.	A	G	6	5	11	0	0	11	0	0
11	44244880	.	T	C	4	6	10	0	0	10	0	0
11	44244895	.	T	C	5	4	9	0	1	10	0	0
11	44304360	.	G	A	0	14	14	0	10	24	0	0
11	44324817	.	C	T	5	7	12	14	0	26	0	0
11	44329208	.	G	A	22	14	36	0	1	37	0	0
11	44334915	.	C	T	22	18	40	0	4	44	0	0
11	44337497	.	A	G	1	5	6	0	0	6	0	0
11	44356772	.	T	A	7	14	21	0	1	22	0	0
11	44356791	.	A	G	6	17	23	0	0	23	0	0
11	44358904	.	C	T	20	5	25	0	1	26	0	0
11	44442425	.	C	T	4	6	10	0	0	10	0	0
11	44442494	.	C	T	6	10	16	0	0	16	0	0
11	44445095	.	T	A	12	8	20	0	0	20	0	0
11	44445655	.	A	G	13	3	16	0	0	16	0	0
11	44445678	.	C	A	13	2	15	0	3	18	0	0
11	44445778	.	C	T	9	9	18	0	2	20	0	0
11	44445828	.	T	C	5	5	10	0	1	11	0	0
11	44452668	.	G	A	8	8	16	0	1	17	0	0
11	44452732	.	T	C	7	13	20	0	0	20	0	0
11	44452790	.	T	C	10	1	11	0	11	22	0	0
11	44452797	.	C	T	1	7	8	0	12	20	0	0
11	44452886	.	A	G	9	13	22	1	2	25	0	0
11	44455901	.	C	T	15	17	32	0	0	32	0	0
11	44457239	.	G	A	15	12	27	0	3	30	0	0
11	44457254	.	A	G	15	10	25	0	2	27	0	0
11	44461386	.	G	C	12	13	25	0	1	26	0	0
11	44461458	.	G	A	15	16	31	0	1	32	0	0
11	44468838	.	G	A	3	14	17	0	0	17	0	0
11	44468842	.	T	C	4	12	16	0	1	17	0	0
11	44474394	.	G	T	2	2	4	0	0	4	0	0
11	44474403	.	G	T	3	2	5	0	0	5	0	0
11	44478403	.	T	C	5	5	10	1	0	11	0	0
11	44481079	.	A	C	2	0	2	0	5	7	0	0
11	44502464	.	G	A	3	2	5	0	0	5	0	0
11	44502660	.	C	T	5	2	7	0	0	7	0	0
11	44522002	.	C	G	10	7	17	0	0	17	0	0
11	44522119	.	C	T	5	5	10	0	0	10	0	0
11	44522158	.	G	T	3	2	5	0	1	6	0	0
11	44523348	.	A	G	5	4	9	0	0	9	0	0
11	44523420	.	C	A	10	5	15	0	0	15	0	0
11	44524164	.	A	G	6	0	6	0	7	13	0	0
11	44524391	.	G	A	9	2	11	0	0	11	0	0
11	44524423	.	T	G	3	7	10	0	0	10	0	0
11	44524448	.	G	A	1	5	6	0	7	13	0	0
11	44524583	.	T	C	4	7	11	2	1	14	0	0
11	44524631	.	T	C	6	4	10	0	0	10	0	0
11	44524673	.	T	C	3	7	10	0	0	10	0	0
11	44524834	.	G	T	2	14	16	0	6	22	0	0
11	44527053	.	G	A	8	2	10	1	1	12	0	0
11	44527087	.	G	T	15	7	22	1	1	24	0	0
11	44527115	.	T	A	16	10	26	0	0	26	0	0
11	44527134	.	G	C	19	13	32	0	0	32	0	0
11	44527183	.	T	C	18	1	19	0	17	36	0	0
11	44527367	.	G	A	27	9	36	0	1	37	0	0
11	44527744	.	G	A	25	8	33	0	1	34	0	0
11	44528307	.	C	T	24	11	35	0	1	36	0	0
11	44528311	.	C	T	2	10	12	0	24	36	0	0
11	44528351	.	A	C	8	25	33	0	2	35	0	0
11	44528405	.	G	A	18	13	31	0	1	32	0	0
11	44528481	.	A	G	14	20	34	0	2	36	0	0
11	44528539	.	A	G	12	14	26	0	1	27	0	0
11	44528694	.	A	G	15	4	19	0	0	19	0	0
11	44528877	.	A	T	16	23	39	0	0	39	0	0
11	44528927	.	G	T	17	12	29	1	0	30	0	0
11	44529149	.	G	A	7	4	11	0	1	12	0	0
11	44529193	.	T	C	2	10	12	0	0	12	0	0
11	44529719	.	G	A	15	25	40	0	1	41	0	0
11	44530262	.	T	C	11	0	11	0	14	25	0	0
11	44533253	.	T	C	9	0	9	0	8	18	1	0
11	44542958	.	T	A	6	4	10	0	1	11	0	0
11	44606861	.	C	T	13	6	19	0	0	19	0	0
11	44606883	.	G	C	9	5	14	0	1	15	0	0
11	44606908	.	T	G	6	2	8	0	0	8	0	0
11	44607291	.	T	A	8	9	17	0	1	18	0	0
11	44607303	.	A	T	8	9	17	0	1	18	0	0
11	44612357	.	A	G	7	7	14	0	0	14	0	0
11	44614918	.	G	A	8	5	13	0	2	15	0	0
11	44614945	.	C	G	0	5	5	0	4	9	0	0
11	44614960	.	C	T	3	4	7	0	1	8	0	0
11	44622565	.	G	A	6	2	8	0	0	8	0	0
11	44622594	.	C	T	3	4	7	0	0	7	0	0
11	44624714	.	C	T	3	6	9	0	0	9	0	0
11	44624723	.	A	C	6	2	8	0	0	8	0	0
11	44628707	.	G	A	0	4	4	0	3	7	0	0
11	44632351	.	A	G	2	10	12	0	0	12	0	0
11	44634802	.	A	C	6	6	12	0	1	13	0	0
11	44634828	.	C	A	7	7	14	0	2	16	0	0
11	44634965	.	G	A	1	2	3	0	1	4	0	0
11	44637569	.	T	A	4	4	8	0	0	8	0	0
11	44637704	.	C	T	3	7	10	0	19	29	0	0
11	44637714	.	T	C	21	0	21	0	7	28	0	0
11	44637802	.	G	A	14	18	32	0	2	34	0	0
11	44637950	.	A	G	23	31	54	1	3	58	0	0
11	44637953	.	G	T	35	24	59	1	3	63	0	0
11	44638006	.	G	A	30	26	56	1	7	64	0	0
11	44643882	.	C	T	19	22	41	0	1	42	0	0
11	44723130	.	C	G	10	14	24	0	0	24	0	0
11	44723353	.	G	A	1	14	15	0	21	36	0	0
11	44723500	.	C	T	20	18	38	0	0	38	0	0
11	44723746	.	A	G	18	28	46	0	3	49	0	0
11	44725376	.	C	T	20	23	43	0	1	44	0	0
11	44726119	.	C	T	16	12	28	0	5	33	0	0
11	44805464	.	G	C	1	8	9	0	3	12	0	0
11	44805701	.	G	A	3	5	8	0	0	8	0	0
11	44836755	.	A	G	3	0	3	0	4	7	0	0
11	44843706	.	A	G	4	0	4	0	4	8	0	0
11	44848783	.	A	G	2	0	2	0	6	8	0	0
11	44848876	.	A	T	7	4	11	0	0	11	0	0
11	44852756	.	A	T	3	4	7	0	0	7	0	0
11	44852988	.	T	A	1	3	4	0	0	4	0	0
11	44853044	.	A	G	3	4	7	0	1	8	0	0
11	44853073	.	A	T	2	5	7	0	0	7	0	0
11	44853115	.	A	T	2	2	4	0	0	4	0	0
11	44853156	.	T	A	4	2	6	0	0	6	0	0
11	44853172	.	C	A	2	5	7	0	0	7	0	0
11	44853282	.	T	C	3	4	7	0	1	8	0	0
11	44853325	.	T	C	4	5	9	0	1	10	0	0
11	44853344	.	A	G	5	2	7	0	0	7	0	0
11	44853670	.	C	T	2	2	4	0	0	4	0	0
11	44854560	.	A	T	7	5	12	0	1	13	0	0
11	44854631	.	C	T	5	5	10	0	1	11	0	0
11	44854636	.	G	T	6	5	11	0	0	11	0	0
11	44854692	.	A	C	1	8	9	0	0	9	0	0
11	44854735	.	A	G	1	0	1	0	6	7	0	0
11	44854759	.	C	T	1	4	5	0	0	5	0	0
11	44854847	.	A	G	6	10	16	0	1	17	0	0
11	44854850	.	T	C	6	11	17	0	0	17	0	0
11	44854996	.	T	C	10	9	19	0	0	19	0	0
11	44855027	.	G	A	0	12	12	0	11	23	0	0
11	44880288	.	A	G	13	11	24	0	3	27	0	0
11	44880291	.	T	A	11	11	22	0	5	27	0	0
11	44880332	.	G	A	15	15	30	0	1	31	0	0
11	44880345	.	C	G	15	14	29	0	0	29	0	0
11	44887200	.	G	A	21	27	48	0	1	49	0	0
11	44887224	.	T	C	26	2	28	0	23	51	0	0
11	44887612	.	G	T	20	17	37	0	4	41	0	0
11	44891507	.	G	A	17	18	35	0	4	39	0	0
11	44892859	.	T	A	21	13	34	0	2	36	0	0
11	44892883	.	G	A	20	12	32	0	4	36	0	0
11	44892943	.	G	A	18	11	29	0	0	29	0	0
11	44892979	.	T	A	10	11	21	0	0	21	0	0
11	44894409	.	T	C	6	0	6	1	17	24	0	0
11	44897584	.	C	T	13	10	23	0	0	23	0	0
11	44897647	.	A	C	6	12	18	0	1	19	0	0
11	44901315	.	C	T	2	10	12	0	8	20	0	0
11	44901373	.	C	A	36	32	68	0	0	68	0	0
11	44910758	.	T	G	11	14	25	0	2	27	0	0
11	44912485	.	C	A	2	5	7	0	3	10	0	0
11	44912992	.	C	T	0	7	7	0	7	14	0	0
11	44913176	.	C	A	0	10	10	0	7	17	0	0
11	44921573	.	T	C	4	0	4	0	7	11	0	0
11	44922524	.	T	G	4	9	13	0	0	13	0	0
11	44927159	.	C	A	1	6	7	0	0	7	0	0
11	44927833	.	G	T	3	5	8	0	0	8	0	0
11	44935861	.	G	C	6	14	20	0	0	20	0	0
11	44953880	.	G	T	8	4	12	0	1	14	1	0
11	44954090	.	G	A	10	10	20	0	1	21	0	0
11	44960620	.	G	A	3	3	6	0	0	6	0	0
11	44964284	.	C	T	0	4	4	0	5	9	0	0
11	45097734	.	C	A	2	2	4	0	0	4	0	0
11	45120566	.	C	T	3	2	5	0	0	5	0	0
11	45120586	.	G	A	2	4	6	0	1	7	0	0
11	45122701	.	C	T	1	3	4	0	0	4	0	0
11	45123715	.	T	A	1	6	7	0	1	8	0	0
11	45124499	.	C	G	1	3	4	0	0	4	0	0
11	45125829	.	C	T	8	5	13	0	1	14	0	0
11	45125831	.	A	T	9	5	14	0	0	14	0	0
11	45126658	.	C	T	0	14	14	0	13	27	0	0
11	45126730	.	C	A	2	7	9	0	0	9	0	0
11	45126772	.	G	A	5	4	9	0	0	9	0	0
11	45127266	.	A	G	8	9	17	0	1	18	0	0
11	45127329	.	G	A	11	7	18	0	1	19	0	0
11	45127352	.	C	G	6	7	13	0	0	13	0	0
11	45129347	.	C	A	7	7	14	0	1	15	0	0
11	45130676	.	A	G	6	3	9	0	1	10	0	0
11	45130874	.	C	A	1	5	6	0	6	12	0	0
11	45130909	.	G	A	5	4	9	0	0	9	0	0
11	45138768	.	C	A	1	6	7	0	9	16	0	0
11	45139797	.	A	C	1	0	1	0	4	5	0	0
11	45140001	.	A	T	5	3	8	1	1	10	0	0
11	45141271	.	G	A	5	13	18	0	1	19	0	0
11	45143417	.	G	T	7	10	17	0	0	17	0	0
11	45161336	.	C	T	2	2	4	0	0	4	0	0
11	45161844	.	C	T	7	3	10	0	0	10	0	0
11	45161878	.	T	C	2	4	6	0	0	6	0	0
11	45162241	.	A	T	12	7	19	0	2	21	0	0
11	45171032	.	G	C	4	5	9	3	0	12	0	0
11	45171184	.	G	C	5	2	7	0	0	7	0	0
11	45227084	.	G	T	0	2	2	0	5	7	0	0
11	45227128	.	T	C	3	2	5	0	0	5	0	0
11	45238803	.	C	T	2	3	5	0	0	5	0	0
11	45243089	.	A	C	11	4	15	0	0	15	0	0
11	45243092	.	A	C	12	4	16	0	0	16	0	0
11	45244481	.	C	T	1	4	5	0	0	5	0	0
11	45244942	.	G	A	1	3	4	0	0	4	0	0
11	45245103	.	T	C	1	4	5	0	0	5	0	0
11	45245913	.	A	G	5	6	11	0	0	11	0	0
11	45245925	.	A	T	6	4	10	0	1	11	0	0
11	45262178	.	C	T	8	9	17	0	0	17	0	0
11	45262186	.	G	A	1	7	8	0	7	15	0	0
11	45262342	.	C	T	10	13	23	0	0	23	0	0
11	45265829	.	G	A	0	13	13	0	7	21	1	0
11	45265859	.	G	C	16	5	21	0	0	21	0	0
11	45265898	.	C	T	2	8	10	0	1	11	0	0
11	45290463	.	A	G	4	13	17	0	0	17	0	0
11	45290839	.	A	G	6	1	7	1	7	15	0	0
11	45290869	.	C	T	6	3	9	1	0	10	0	0
11	45290884	.	C	A	6	5	11	1	1	13	0	0
11	45290989	.	A	C	5	7	12	0	0	12	0	0
11	45291944	.	G	A	7	9	16	0	2	18	0	0
11	45294389	.	C	T	15	6	21	1	1	23	0	0
11	45294489	.	C	T	11	14	25	0	0	25	0	0
11	45294553	.	C	A	7	7	14	0	1	15	0	0
11	45294825	.	T	C	2	2	4	1	0	5	0	0
11	45327813	.	C	T	2	3	5	0	0	5	0	0
11	45327958	.	G	A	6	2	8	0	0	8	0	0
11	45328046	.	C	T	3	5	8	0	0	8	0	0
11	45328145	.	G	A	3	5	8	0	0	8	0	0
11	45328166	.	C	T	4	3	7	0	0	7	0	0
11	45328238	.	C	G	3	2	5	0	0	5	0	0
11	45342757	.	A	G	7	4	11	0	0	11	0	0
11	45342823	.	G	A	6	2	8	0	1	9	0	0
11	45343045	.	C	G	1	2	3	0	0	3	0	0
11	45343389	.	G	A	3	4	7	0	0	7	0	0
11	45348490	.	G	A	1	5	6	0	5	11	0	0
11	45351698	.	A	G	6	0	6	0	3	9	0	0
11	45355011	.	C	T	1	13	14	0	9	23	0	0
11	45355022	.	C	G	10	13	23	0	2	25	0	0
11	45355436	.	C	G	19	13	32	0	0	32	0	0
11	45355606	.	G	C	10	16	26	0	1	27	0	0
11	45356114	.	G	A	5	14	19	0	5	24	0	0
11	45356296	.	C	T	1	5	6	0	9	15	0	0
11	45356352	.	G	A	7	7	14	0	0	14	0	0
11	45356355	.	C	T	2	6	8	0	8	16	0	0
11	45356666	.	A	G	22	12	34	0	0	34	0	0
11	45359173	.	G	A	12	19	31	0	3	34	0	0
11	45359923	.	A	G	11	4	15	0	1	16	0	0
11	45359980	.	G	A	10	7	17	0	0	17	0	0
11	45362862	.	T	C	7	9	16	0	1	17	0	0
11	45366720	.	C	T	8	3	11	0	0	11	0	0
11	45366798	.	T	A	3	2	5	0	0	5	0	0
11	45370259	.	G	A	5	5	10	0	0	10	0	0
11	45370529	.	G	A	4	4	8	0	0	8	0	0
11	45371380	.	C	G	9	3	12	0	0	12	0	0
11	45371438	.	A	C	4	1	5	0	3	8	0	0
11	45371444	.	G	A	4	4	8	0	0	8	0	0
11	45371474	.	C	A	5	3	8	0	1	9	0	0
11	45371831	.	A	G	3	4	7	0	0	7	0	0
11	45372123	.	C	T	1	4	5	0	3	8	0	0
11	45375266	.	G	T	3	3	6	0	0	6	0	0
11	45385555	.	C	T	1	2	3	0	0	3	0	0
11	45388197	.	G	A	1	2	3	0	0	3	0	0
11	45389961	.	A	T	7	6	13	1	1	15	0	0
11	45389981	.	G	A	5	9	14	0	1	15	0	0
11	45390057	.	G	A	3	6	9	0	1	10	0	0
11	45391400	.	C	T	24	14	38	0	3	41	0	0
11	45391430	.	G	T	10	6	16	0	1	17	0	0
11	45391725	.	A	G	13	9	22	0	1	23	0	0
11	45391727	.	T	C	11	8	19	0	2	21	0	0
11	45391788	.	C	T	7	9	16	0	1	17	0	0
11	45393395	.	C	T	19	20	39	0	5	44	0	0
11	45393468	.	G	T	35	44	79	0	9	88	0	0
11	45393522	.	A	C	11	2	13	0	53	66	0	0
11	45397372	.	C	T	34	24	58	0	1	59	0	0
11	45399389	.	A	G	31	37	68	0	2	70	0	0
11	45399491	.	C	T	26	27	53	0	5	58	0	0
11	45399589	.	A	G	29	23	52	0	2	54	0	0
11	45402861	.	G	A	20	11	31	0	0	31	0	0
11	45403209	.	A	T	18	21	39	0	2	41	0	0
11	45403712	.	G	A	22	12	34	0	1	35	0	0
11	45403782	.	T	C	21	2	23	0	14	37	0	0
11	45403866	.	G	A	16	17	33	0	0	33	0	0
11	45403914	.	C	T	1	13	14	0	23	37	0	0
11	45410613	.	A	G	14	19	33	0	1	34	0	0
11	45412505	.	C	T	3	9	12	0	17	29	0	0
11	45428466	.	A	T	3	4	7	0	0	7	0	0
11	45429190	.	A	T	2	2	4	0	0	4	0	0
11	45430139	.	C	T	1	3	4	0	0	4	0	0
11	45439842	.	G	A	0	5	5	0	2	7	0	0
11	45439858	.	C	A	4	2	6	0	0	6	0	0
11	45439899	.	G	A	2	5	7	0	0	7	0	0
11	45448187	.	G	A	1	4	5	0	0	5	0	0
11	45452786	.	G	A	0	3	3	0	3	6	0	0
11	45454748	.	C	A	8	3	11	0	1	12	0	0
11	45460337	.	G	A	8	4	12	0	2	14	0	0
11	45461318	.	G	A	1	6	7	0	21	28	0	0
11	45461498	.	G	A	1	11	12	0	7	19	0	0
11	45463352	.	T	C	17	12	29	0	1	30	0	0
11	45463490	.	G	T	3	13	16	0	31	47	0	0
11	45464817	.	T	G	11	7	18	0	0	18	0	0
11	45464880	.	C	T	12	7	19	0	1	20	0	0
11	45465080	.	T	A	14	6	20	0	1	21	0	0
11	45468899	.	C	T	1	2	3	0	3	6	0	0
11	45468906	.	T	A	2	2	4	0	0	4	0	0
11	45468951	.	C	T	3	6	9	0	1	10	0	0
11	45469020	.	G	A	4	2	6	0	0	6	0	0
11	45469739	.	G	A	5	5	10	0	2	12	0	0
11	45469969	.	C	T	11	6	17	0	0	17	0	0
11	45470010	.	G	A	5	4	9	0	3	12	0	0
11	45470243	.	C	T	4	10	14	0	7	21	0	0
11	45470277	.	C	T	8	5	13	0	4	17	0	0
11	45470279	.	C	A	1	8	9	0	6	15	0	0
12	576271	.	C	T	1	3	4	0	0	4	0	0
12	630495	.	G	A	1	5	6	0	0	6	0	0
12	1206154	.	T	C	20	15	35	0	2	37	0	0
12	1387902	.	T	C	1	3	4	0	0	4	0	0
12	1388305	.	A	T	1	5	6	0	0	6	0	0
12	1388344	.	C	T	1	4	5	0	1	6	0	0
12	1398661	.	T	A	19	12	31	0	0	31	0	0
12	1947596	.	T	C	4	0	4	0	10	14	0	0
12	1947645	.	G	A	2	6	8	0	1	9	0	0
12	1947656	.	A	T	3	4	7	0	0	7	0	0
12	1947822	.	A	G	2	3	5	0	0	5	0	0
12	1947999	.	G	A	7	11	18	0	0	18	0	0
12	2488237	.	C	T	3	2	5	0	0	5	0	0
12	2488542	.	C	G	3	2	5	0	0	5	0	0
12	2488770	.	C	T	4	3	7	0	0	7	0	0
12	2488808	.	C	T	4	3	7	0	0	7	0	0
12	2488815	.	T	C	3	3	6	0	0	6	0	0
12	2488938	.	G	A	4	3	7	0	0	7	0	0
12	2492423	.	G	T	0	4	4	0	9	13	0	0
12	2505557	.	T	G	5	11	16	0	2	18	0	0
12	2505614	.	G	A	12	15	27	0	0	27	0	0
12	2505921	.	G	C	6	0	6	0	7	13	0	0
12	2507295	.	G	A	1	4	5	0	0	5	0	0
12	2507585	.	C	T	0	3	3	0	7	10	0	0
12	2507988	.	T	C	4	0	4	0	6	10	0	0
12	2508051	.	T	C	5	0	5	0	4	9	0	0
12	2509851	.	C	G	2	4	6	0	0	6	0	0
12	2515271	.	T	G	2	4	6	0	0	6	0	0
12	2518220	.	G	A	2	2	4	0	0	4	0	0
12	2639688	.	G	A	1	2	3	0	0	3	0	0
12	2743281	.	C	A	3	2	5	0	0	5	0	0
12	2743315	.	A	C	4	2	6	0	0	6	0	0
12	2743327	.	G	T	2	6	8	0	0	8	0	0
12	2743350	.	A	C	1	5	6	0	0	6	0	0
12	2743594	.	T	A	3	3	6	0	0	6	0	0
12	2743795	.	A	G	1	2	3	0	0	3	0	0
12	2743902	.	T	G	1	3	4	0	0	4	0	0
12	2743988	.	A	C	6	5	11	0	0	11	0	0
12	2833488	.	C	A	4	5	9	0	0	9	0	0
12	2834053	.	A	G	3	0	3	0	3	6	0	0
12	2845677	.	G	A	3	3	6	0	2	8	0	0
12	2845700	.	T	C	3	3	6	0	1	7	0	0
12	2846164	.	G	C	4	5	9	0	0	9	0	0
12	2849908	.	G	A	1	2	3	0	3	6	0	0
12	2850096	.	C	T	6	4	10	0	0	10	0	0
12	2850569	.	T	C	1	3	4	0	0	4	0	0
12	2850623	.	G	A	6	3	9	0	2	11	0	0
12	2850637	.	G	A	9	4	13	0	0	13	0	0
12	2850816	.	T	C	5	0	5	0	5	10	0	0
12	2851126	.	C	T	2	6	8	0	0	8	0	0
12	2851251	.	G	A	3	2	5	0	1	6	0	0
12	2851355	.	C	T	3	2	5	0	0	5	0	0
12	2856829	.	A	G	3	2	5	0	0	5	0	0
12	2869479	.	T	C	1	3	4	0	0	4	0	0
12	2870708	.	G	A	1	2	3	0	0	3	0	0
12	2870733	.	G	A	0	5	5	0	3	8	0	0
12	2876544	.	C	T	1	6	7	0	0	7	0	0
12	2893006	.	G	A	1	6	7	0	6	13	0	0
12	2895248	.	T	C	8	12	20	0	2	22	0	0
12	2895264	.	G	T	2	7	9	0	13	22	0	0
12	2895344	.	G	A	0	5	5	0	5	10	0	0
12	2993557	.	A	C	2	2	4	0	0	4	0	0
12	2996070	.	A	G	2	0	2	0	4	6	0	0
12	3001893	.	A	C	4	4	8	0	0	8	0	0
12	3003904	.	T	C	3	3	6	0	0	6	0	0
12	3006358	.	C	T	2	5	7	0	0	7	0	0
12	3010427	.	G	A	2	4	6	0	0	6	0	0
12	3019634	.	T	C	2	2	4	0	0	4	0	0
12	3022947	.	C	A	17	21	38	0	0	38	0	0
12	3033166	.	G	A	16	17	33	1	2	36	0	0
12	3033199	.	A	G	27	0	27	1	15	43	0	0
12	3033357	.	T	C	29	24	53	1	2	56	0	0
12	3033360	.	A	C	28	23	51	1	1	53	0	0
12	3038920	.	G	A	3	22	25	0	24	49	0	0
12	3038929	.	A	G	21	1	22	0	20	42	0	0
12	3039078	.	G	C	2	23	25	0	15	40	0	0
12	3039210	.	C	T	30	10	40	0	4	44	0	0
12	3039283	.	T	A	8	19	27	0	2	29	0	0
12	3039311	.	T	C	7	18	25	0	0	25	0	0
12	3039321	.	A	G	9	16	25	0	0	25	0	0
12	3039423	.	G	A	1	8	9	0	13	22	0	0
12	3039522	.	T	C	10	18	28	0	3	31	0	0
12	3039652	.	T	C	17	40	57	0	1	58	0	0
12	3039682	.	A	C	16	32	48	2	1	51	0	0
12	3039738	.	A	T	29	6	35	0	4	39	0	0
12	3039940	.	A	G	12	21	33	0	3	36	0	0
12	3040158	.	A	T	18	12	30	0	1	31	0	0
12	3040178	.	T	C	16	12	28	0	3	31	0	0
12	3040329	.	A	G	16	17	33	0	2	35	0	0
12	3040370	.	G	A	2	12	14	0	15	29	0	0
12	3040819	.	T	A	12	20	32	0	2	34	0	0
12	3041087	.	C	A	8	10	18	0	3	21	0	0
12	3041088	.	G	T	2	10	12	0	9	21	0	0
12	3041179	.	T	A	17	15	32	0	0	33	1	0
12	3041390	.	A	T	17	13	30	0	3	33	0	0
12	3041497	.	G	A	1	17	18	0	18	36	0	0
12	3041587	.	A	T	25	20	45	0	1	46	0	0
12	3041606	.	A	T	30	17	47	0	1	48	0	0
12	3041721	.	G	A	5	20	25	0	33	58	0	0
12	3041871	.	C	T	22	32	54	0	5	59	0	0
12	3041905	.	C	A	18	23	41	0	1	42	0	0
12	3050314	.	T	A	3	2	5	0	0	5	0	0
12	3059979	.	C	A	5	2	7	0	0	7	0	0
12	3060003	.	C	T	7	3	10	0	0	10	0	0
12	3060441	.	G	A	5	2	7	0	0	7	0	0
12	3062952	.	T	C	5	0	5	0	2	7	0	0
12	3062958	.	A	G	4	1	5	0	1	6	0	0
12	3072841	.	T	C	0	0	0	0	3	3	0	0
12	3072846	.	T	G	1	2	3	0	0	3	0	0
12	3077296	.	C	G	1	1	2	0	0	2	0	0
12	3092724	.	G	A	5	3	8	0	0	8	0	0
12	3092739	.	A	G	3	2	5	0	0	5	0	0
12	3092826	.	G	C	2	2	4	0	0	4	0	0
12	3095811	.	T	A	1	2	3	0	0	3	0	0
12	3095831	.	T	G	1	2	3	0	0	3	0	0
12	3271391	.	A	G	1	8	9	0	0	9	0	0
12	3271526	.	G	A	1	7	8	0	0	8	0	0
12	3271553	.	G	A	3	2	5	0	1	6	0	0
12	3271809	.	A	G	6	4	10	0	0	10	0	0
12	3272111	.	A	C	3	3	6	0	0	6	0	0
12	3272114	.	A	G	3	3	6	0	0	6	0	0
12	3272421	.	A	G	5	8	13	0	2	15	0	0
12	3574348	.	G	A	10	11	21	0	1	22	0	0
12	3574398	.	C	G	10	9	19	0	0	19	0	0
12	3714934	.	T	C	5	12	17	0	0	17	0	0
12	3714977	.	T	C	3	0	3	0	14	17	0	0
12	3715082	.	T	C	3	0	3	0	4	7	0	0
12	3715201	.	T	C	8	3	11	0	0	11	0	0
12	3715261	.	A	T	7	9	16	0	1	17	0	0
12	3715292	.	T	G	9	7	16	0	0	16	0	0
12	3715327	.	C	A	4	7	11	0	0	11	0	0
12	3715329	.	C	G	4	6	10	0	1	11	0	0
12	3715365	.	T	C	3	4	7	0	0	7	0	0
12	3715393	.	T	C	5	2	7	1	0	8	0	0
12	3715544	.	T	C	2	3	5	0	1	6	0	0
12	3715585	.	T	C	4	4	8	0	0	8	0	0
12	3716621	.	G	C	7	7	14	0	0	14	0	0
12	3719297	.	T	G	7	9	16	0	0	16	0	0
12	3719312	.	T	C	8	1	9	0	10	19	0	0
12	3723786	.	C	G	13	10	23	0	0	23	0	0
12	3723963	.	G	A	0	8	8	0	13	21	0	0
12	3731590	.	G	A	0	10	10	0	16	26	0	0
12	3731602	.	C	A	10	15	25	0	0	25	0	0
12	3740724	.	T	A	15	8	23	0	0	23	0	0
12	3740735	.	A	T	17	6	23	0	1	24	0	0
12	3740784	.	C	T	11	11	22	0	0	22	0	0
12	3740803	.	G	A	13	10	23	0	0	23	0	0
12	3747652	.	G	C	8	10	18	0	0	18	0	0
12	3749505	.	C	T	0	6	6	0	2	8	0	0
12	3753166	.	C	T	1	7	8	0	7	15	0	0
12	3756229	.	G	T	6	4	10	0	2	12	0	0
12	3756237	.	C	T	7	4	11	0	0	11	0	0
12	3756303	.	C	T	0	9	9	0	3	12	0	0
12	3767321	.	G	T	3	5	8	0	0	8	0	0
12	3789463	.	T	C	2	3	5	0	0	5	0	0
12	3791925	.	C	A	3	2	5	0	0	5	0	0
12	4622884	.	G	A	1	5	6	0	0	6	0	0
12	6465617	.	G	C	1	2	3	0	0	3	0	0
12	6465792	.	C	A	1	3	4	0	0	4	0	0
12	6465982	.	C	T	3	2	5	0	0	5	0	0
12	6467294	.	A	G	3	0	3	0	2	5	0	0
12	6543123	.	T	C	2	4	6	0	0	6	0	0
12	6543350	.	G	A	1	3	4	0	0	4	0	0
12	6543458	.	C	G	3	6	9	0	1	10	0	0
12	6545491	.	T	C	1	0	1	0	2	3	0	0
12	6547163	.	C	T	0	10	10	0	9	19	0	0
12	6547214	.	A	G	6	6	12	0	1	13	0	0
12	6549689	.	A	G	3	6	9	0	0	9	0	0
12	6576130	.	A	T	8	2	10	0	1	11	0	0
12	6587222	.	T	C	6	0	6	0	4	10	0	0
12	6701444	.	G	A	2	2	4	0	0	4	0	0
12	6713949	.	G	A	3	4	7	0	0	7	0	0
12	6742562	.	A	G	4	2	6	0	0	6	0	0
12	7193865	.	C	T	2	6	8	0	0	8	0	0
12	7193874	.	A	G	3	6	9	0	1	10	0	0
12	7194410	.	A	G	11	10	21	0	3	24	0	0
12	7194505	.	T	C	12	5	17	0	2	19	0	0
12	7194522	.	T	C	14	6	20	0	1	21	0	0
12	7194677	.	G	C	4	3	7	0	0	7	0	0
12	7194843	.	C	A	5	4	9	0	0	9	0	0
12	7195081	.	G	T	9	8	17	0	3	20	0	0
12	7195139	.	A	T	14	6	20	0	1	22	1	0
12	7195365	.	T	C	12	9	21	0	0	21	0	0
12	7195454	.	T	A	10	11	21	0	2	23	0	0
12	7195524	.	G	T	11	11	22	2	3	27	0	0
12	7195588	.	G	A	10	11	21	4	1	26	0	0
12	7195600	.	T	C	12	6	18	0	3	21	0	0
12	7195676	.	C	T	2	11	13	0	12	25	0	0
12	7195816	.	C	A	5	2	7	0	1	8	0	0
12	7195888	.	T	C	2	4	6	0	0	6	0	0
12	7195951	.	T	C	10	1	11	0	2	13	0	0
12	7196059	.	G	A	13	9	22	0	0	22	0	0
12	7196114	.	G	A	10	8	18	0	0	18	0	0
12	7196125	.	A	G	6	8	14	0	0	14	0	0
12	7196175	.	G	A	9	7	16	0	1	17	0	0
12	7196201	.	G	A	11	7	18	0	0	18	0	0
12	7196249	.	G	T	10	7	17	0	0	17	0	0
12	7197407	.	T	C	3	5	8	0	0	8	0	0
12	7197777	.	G	A	2	2	4	0	0	4	0	0
12	7197782	.	T	G	2	2	4	0	0	4	0	0
12	7198135	.	T	A	5	4	9	0	0	9	0	0
12	7198142	.	T	C	4	0	4	0	5	9	0	0
12	7198255	.	T	A	4	5	9	0	0	9	0	0
12	7198295	.	G	T	5	4	9	0	0	9	0	0
12	7198409	.	G	A	4	6	10	0	0	10	0	0
12	7198882	.	G	A	1	3	4	0	0	4	0	0
12	7199447	.	C	T	2	4	6	0	0	6	0	0
12	7234692	.	G	A	5	5	10	0	0	10	0	0
12	7234790	.	G	A	4	4	8	0	1	9	0	0
12	7235030	.	G	A	3	4	7	0	0	7	0	0
12	7263657	.	G	T	0	4	4	0	3	7	0	0
12	7263665	.	G	T	0	5	5	0	3	8	0	0
12	7269679	.	A	C	5	0	5	0	5	10	0	0
12	7280057	.	C	T	4	3	7	0	1	8	0	0
12	7280160	.	G	T	5	7	12	0	0	12	0	0
12	7454704	.	C	T	6	5	11	0	2	13	0	0
12	7512347	.	T	C	3	10	13	0	0	13	0	0
12	7512469	.	C	T	9	13	22	0	0	22	0	0
12	7512641	.	T	A	7	18	25	0	0	25	0	0
12	7512675	.	G	A	7	11	18	0	0	18	0	0
12	7512682	.	A	G	7	9	16	0	0	16	0	0
12	7512921	.	A	G	7	5	12	0	0	12	0	0
12	7512965	.	C	A	5	4	9	0	0	9	0	0
12	7513106	.	C	A	3	5	8	0	0	8	0	0
12	7513446	.	T	A	7	10	17	0	0	17	0	0
12	7513480	.	C	T	5	10	15	0	0	15	0	0
12	7513555	.	G	A	10	12	22	0	1	23	0	0
12	7513613	.	G	A	1	11	12	0	4	16	0	0
12	7513685	.	C	A	7	7	14	0	1	15	0	0
12	7589579	.	G	A	4	2	6	0	1	7	0	0
12	7589581	.	T	G	5	2	7	0	0	7	0	0
12	7589795	.	A	G	8	6	14	0	0	14	0	0
12	7589816	.	A	G	12	5	17	0	0	17	0	0
12	7589845	.	C	A	9	5	14	0	0	14	0	0
12	7589917	.	C	G	2	5	7	0	0	7	0	0
12	7590024	.	C	A	2	2	4	0	0	4	0	0
12	7595179	.	C	T	4	9	13	0	0	13	0	0
12	7595204	.	G	A	3	7	10	0	0	10	0	0
12	7595726	.	C	A	7	6	13	0	0	13	0	0
12	7597751	.	T	C	2	2	4	0	0	4	0	0
12	7610033	.	A	G	4	2	6	0	0	6	0	0
12	7610236	.	A	T	12	2	14	0	2	16	0	0
12	7610354	.	C	T	2	3	5	0	0	5	0	0
12	7610478	.	T	A	9	5	14	0	0	14	0	0
12	7610532	.	T	G	5	7	12	0	0	12	0	0
12	7610663	.	T	C	4	1	5	0	6	11	0	0
12	7610740	.	T	C	10	11	21	0	4	25	0	0
12	7610969	.	T	C	6	9	15	0	0	15	0	0
12	7611081	.	G	C	3	0	3	0	5	8	0	0
12	7611188	.	T	C	9	4	13	0	1	14	0	0
12	7611205	.	T	C	14	3	17	0	1	18	0	0
12	7611286	.	T	C	1	5	6	0	0	6	0	0
12	7611359	.	T	C	2	0	2	0	1	3	0	0
12	7611510	.	C	T	9	2	11	0	0	11	0	0
12	7611514	.	C	T	8	2	10	0	0	10	0	0
12	7611595	.	A	G	6	6	12	0	0	12	0	0
12	7611625	.	G	T	3	8	11	0	0	11	0	0
12	7611751	.	A	C	5	7	12	0	0	12	0	0
12	7611849	.	T	A	2	2	4	0	0	4	0	0
12	7612117	.	G	A	6	4	10	0	0	10	0	0
12	7612305	.	T	C	2	7	9	0	0	9	0	0
12	7612406	.	T	A	4	3	7	0	0	7	0	0
12	7612796	.	C	A	4	3	7	0	0	7	0	0
12	7612815	.	G	A	5	3	8	0	0	8	0	0
12	7620242	.	G	T	5	2	7	0	0	7	0	0
12	7629226	.	T	C	8	4	12	0	0	12	0	0
12	7655149	.	G	A	2	2	4	0	0	4	0	0
12	7710552	.	C	T	0	3	3	0	5	8	0	0
12	7785502	.	C	A	5	3	8	0	1	9	0	0
12	8019307	.	T	C	1	4	5	0	0	5	0	0
12	8019511	.	T	C	6	1	7	0	0	7	0	0
12	8019518	.	C	T	6	2	8	0	0	8	0	0
12	8033554	.	C	T	1	3	4	0	0	4	0	0
12	8227145	.	G	C	4	2	6	0	0	6	0	0
12	8301915	.	G	A	2	2	4	0	0	4	0	0
12	8307569	.	G	A	1	2	3	0	5	8	0	0
12	8307734	.	A	C	2	5	7	0	0	7	0	0
12	8656201	.	C	T	2	2	4	0	0	4	0	0
12	8822961	.	T	C	6	2	8	0	0	8	0	0
12	8863240	.	A	T	3	9	12	0	0	12	0	0
12	8866077	.	A	G	2	7	9	0	2	11	0	0
12	8877343	.	A	C	7	4	11	0	1	12	0	0
12	8877412	.	T	C	9	8	17	0	1	18	0	0
12	8881469	.	G	A	5	5	10	0	0	10	0	0
12	8881470	.	C	G	5	5	10	0	0	10	0	0
12	8881575	.	C	T	6	11	17	0	1	18	0	0
12	8882062	.	G	T	6	2	8	0	0	8	0	0
12	8955284	.	C	T	0	2	2	0	3	5	0	0
12	8968456	.	T	A	6	11	17	0	1	18	0	0
12	8968487	.	T	A	10	8	18	0	1	19	0	0
12	8968512	.	T	G	9	7	16	0	1	17	0	0
12	8968721	.	A	G	14	11	25	0	1	26	0	0
12	8968979	.	C	A	8	11	19	0	1	20	0	0
12	8969084	.	T	C	19	15	34	0	0	34	0	0
12	8969102	.	C	T	1	20	21	0	16	37	0	0
12	8969155	.	C	G	16	9	25	0	0	25	0	0
12	8969426	.	T	C	8	9	17	1	0	18	0	0
12	8969485	.	T	C	18	12	30	0	1	31	0	0
12	8969499	.	G	A	17	18	35	0	1	36	0	0
12	8987502	.	T	C	16	14	30	0	1	31	0	0
12	8997654	.	A	G	13	9	22	0	1	23	0	0
12	9010979	.	G	A	14	12	26	0	1	27	0	0
12	9010988	.	C	T	0	14	14	0	12	26	0	0
12	9039610	.	G	A	6	6	12	0	1	13	0	0
12	9049343	.	C	T	6	3	9	0	0	9	0	0
12	9064504	.	G	A	6	6	12	0	1	13	0	0
12	9084590	.	T	C	8	5	13	0	0	13	0	0
12	9183720	.	T	C	3	2	5	0	0	5	0	0
12	9190882	.	T	C	3	2	5	0	2	7	0	0
12	9200402	.	C	T	3	4	7	0	0	7	0	0
12	9206038	.	T	C	6	3	9	0	1	10	0	0
12	9206044	.	C	T	5	3	8	0	0	8	0	0
12	9208468	.	T	G	8	0	8	0	9	17	0	0
12	9210441	.	G	A	9	10	19	0	0	19	0	0
12	9210489	.	T	C	9	6	15	0	0	15	0	0
12	9210504	.	A	G	9	6	15	0	1	16	0	0
12	9210528	.	C	T	6	9	15	0	3	18	0	0
12	9218054	.	T	C	8	10	18	0	1	19	0	0
12	9218095	.	A	T	6	5	11	0	1	12	0	0
12	9218098	.	T	C	7	6	13	0	1	14	0	0
12	9218142	.	A	G	4	2	6	0	1	7	0	0
12	9218176	.	T	C	1	4	5	0	0	5	0	0
12	9218183	.	G	A	1	5	6	0	0	6	0	0
12	9452838	.	T	C	2	0	2	0	3	5	0	0
12	9452880	.	G	C	1	4	5	0	0	5	0	0
12	9463660	.	G	A	5	5	10	0	0	10	0	0
12	9463678	.	T	C	5	4	9	0	0	9	0	0
12	9468373	.	C	T	3	3	6	0	2	8	0	0
12	9468440	.	G	A	2	3	5	0	1	6	0	0
12	9585593	.	A	G	1	1	2	0	2	4	0	0
12	9623751	.	T	C	8	4	12	0	1	13	0	0
12	9626057	.	A	C	3	4	7	0	0	7	0	0
12	9627980	.	A	G	3	5	8	0	0	8	0	0
12	9630730	.	G	A	7	2	9	1	1	11	0	0
12	9630745	.	G	A	2	10	12	1	1	14	0	0
12	9633827	.	G	A	8	13	21	0	0	21	0	0
12	9636532	.	A	C	0	3	3	0	1	4	0	0
12	9636616	.	A	G	10	7	17	0	0	17	0	0
12	9636967	.	C	A	1	5	6	0	3	9	0	0
12	9640309	.	C	T	2	5	7	0	0	7	0	0
12	9642671	.	A	G	3	3	6	0	0	6	0	0
12	9654155	.	C	G	1	3	4	0	2	6	0	0
12	9660129	.	G	A	3	1	4	0	1	5	0	0
12	9660133	.	T	C	3	0	3	0	1	4	0	0
12	9660365	.	A	G	2	6	8	0	0	8	0	0
12	9660389	.	A	G	2	6	8	0	0	8	0	0
12	9663488	.	C	T	1	2	3	0	0	3	0	0
12	9674442	.	C	T	2	1	3	0	1	4	0	0
12	9703260	.	C	T	5	3	8	0	1	9	0	0
12	9703831	.	C	T	11	6	17	0	0	17	0	0
12	9703843	.	A	G	5	10	15	0	4	19	0	0
12	9704233	.	T	C	4	6	10	0	0	10	0	0
12	9704254	.	G	T	4	11	15	0	1	16	0	0
12	9704431	.	C	T	4	9	13	0	0	13	0	0
12	9704443	.	G	T	1	9	10	1	5	16	0	0
12	9744544	.	C	T	8	6	14	0	0	14	0	0
12	9749830	.	A	G	10	12	22	0	0	22	0	0
12	9755833	.	C	T	12	12	24	0	1	25	0	0
12	9755869	.	A	G	9	10	19	0	3	22	0	0
12	9761792	.	C	T	10	15	25	0	0	25	0	0
12	9769880	.	A	T	7	10	17	0	4	21	0	0
12	9773157	.	G	A	7	3	10	0	1	11	0	0
12	9773281	.	C	T	6	3	9	0	0	9	0	0
12	9773308	.	G	A	2	5	7	0	0	7	0	0
12	9773465	.	G	A	0	7	7	4	10	21	0	0
12	9781701	.	T	G	3	6	9	0	0	9	0	0
12	9782041	.	G	A	9	3	12	0	0	12	0	0
12	9782230	.	C	T	3	6	9	0	0	9	0	0
12	9782404	.	G	A	4	3	7	0	1	8	0	0
12	9782428	.	T	C	5	4	9	0	0	9	0	0
12	9783058	.	C	T	2	2	4	0	0	4	0	0
12	9783061	.	C	T	0	2	2	0	2	4	0	0
12	9789291	.	A	G	1	2	3	0	0	3	0	0
12	9789351	.	C	T	2	3	5	0	0	5	0	0
12	9789371	.	G	A	2	3	5	0	0	5	0	0
12	9817737	.	A	T	17	15	32	0	2	34	0	0
12	9817771	.	C	T	14	16	30	0	0	30	0	0
12	9817883	.	T	A	18	13	31	0	3	34	0	0
12	9824735	.	C	T	23	14	37	0	2	39	0	0
12	9824762	.	C	A	11	25	36	0	2	38	0	0
12	9824807	.	C	A	16	23	39	0	2	41	0	0
12	9829697	.	C	T	20	13	33	0	3	36	0	0
12	9830983	.	G	A	23	26	49	0	2	51	0	0
12	9830986	.	G	A	29	19	48	0	1	49	0	0
12	9883526	.	G	A	27	35	62	1	5	68	0	0
12	9883849	.	C	T	27	43	70	0	2	72	0	0
12	9883944	.	C	T	41	26	67	0	3	70	0	0
12	9884248	.	A	T	3	6	9	0	0	9	0	0
12	9884259	.	T	A	3	2	5	0	0	5	0	0
12	10116016	.	G	T	10	3	13	0	0	13	0	0
12	10117236	.	G	A	6	7	13	0	0	13	0	0
12	10117329	.	C	T	5	2	7	0	0	7	0	0
12	10124691	.	G	T	7	8	15	0	1	16	0	0
12	10124815	.	T	G	8	11	19	0	0	19	0	0
12	10124819	.	C	T	6	10	16	0	0	16	0	0
12	10124976	.	C	T	4	5	9	0	1	10	0	0
12	10125030	.	G	T	0	6	6	0	3	9	0	0
12	10125031	.	C	A	3	6	9	0	0	9	0	0
12	10125479	.	T	A	2	5	7	0	1	8	0	0
12	10167070	.	A	G	17	10	27	0	1	28	0	0
12	10169521	.	T	C	14	10	24	0	1	25	0	0
12	10169614	.	G	A	12	11	23	0	1	24	0	0
12	10169884	.	G	T	17	18	35	0	1	36	0	0
12	10175161	.	C	T	17	20	37	0	1	38	0	0
12	10199695	.	A	G	16	15	31	0	1	32	0	0
12	10199760	.	A	T	23	13	36	0	1	37	0	0
12	10199869	.	C	T	7	17	24	0	16	40	0	0
12	10200028	.	A	G	19	23	42	0	1	43	0	0
12	10209431	.	A	G	29	11	40	0	1	41	0	0
12	10209452	.	T	A	11	27	38	0	0	38	0	0
12	10217660	.	C	T	18	20	38	0	0	38	0	0
12	10217708	.	C	T	17	16	33	0	2	35	0	0
12	10220000	.	G	T	15	13	28	0	0	28	0	0
12	10220117	.	A	G	18	10	28	0	1	29	0	0
12	10243911	.	C	T	8	9	17	0	2	19	0	0
12	10243926	.	C	T	5	16	21	0	1	22	0	0
12	10243971	.	A	C	12	9	21	0	2	23	0	0
12	10304660	.	T	A	4	6	10	0	3	13	0	0
12	10304706	.	G	A	1	6	7	0	2	9	0	0
12	10313241	.	G	A	11	6	17	0	1	18	0	0
12	10354776	.	A	G	2	2	4	0	0	4	0	0
12	10368969	.	T	C	1	0	1	0	5	6	0	0
12	10368978	.	A	G	2	5	7	0	0	7	0	0
12	10382220	.	C	T	7	3	10	0	0	10	0	0
12	10384982	.	G	A	9	12	21	0	1	22	0	0
12	10387071	.	A	G	6	7	13	0	1	14	0	0
12	10391883	.	C	T	12	3	15	1	0	16	0	0
12	10393538	.	G	T	8	3	11	0	1	12	0	0
12	10398820	.	A	G	4	3	7	0	0	7	0	0
12	10399471	.	G	A	4	3	7	0	0	7	0	0
12	10399766	.	T	C	1	3	4	0	0	4	0	0
12	10409838	.	G	A	5	4	9	0	0	9	0	0
12	10409848	.	G	A	5	6	11	0	0	11	0	0
12	10412190	.	C	G	1	2	3	1	2	6	0	0
12	10424741	.	C	G	1	13	14	0	8	22	0	0
12	10425346	.	T	C	22	17	39	0	1	40	0	0
12	10425465	.	C	T	19	16	35	0	4	39	0	0
12	10425586	.	G	T	22	22	44	0	2	46	0	0
12	10425630	.	A	T	26	16	42	0	2	44	0	0
12	10429054	.	G	A	19	26	45	0	2	47	0	0
12	10429105	.	C	A	24	22	46	0	3	49	0	0
12	10430611	.	G	A	18	14	32	0	2	34	0	0
12	10439619	.	C	A	7	11	18	0	0	18	0	0
12	10439641	.	T	G	11	10	21	0	2	23	0	0
12	10439662	.	G	A	8	16	24	0	3	27	0	0
12	10439686	.	T	C	16	14	30	0	0	30	0	0
12	10443916	.	G	T	6	8	14	0	1	15	0	0
12	10443923	.	T	C	5	7	12	0	1	13	0	0
12	10444321	.	A	T	9	6	15	0	1	16	0	0
12	10465000	.	A	C	8	9	17	0	0	17	0	0
12	10465182	.	A	C	6	9	15	0	1	16	0	0
12	10471105	.	A	G	7	7	14	0	2	16	0	0
12	10471120	.	T	C	12	1	13	0	7	20	0	0
12	10471159	.	G	A	5	12	17	1	0	18	0	0
12	10475310	.	G	A	7	7	14	0	0	14	0	0
12	10478804	.	C	A	0	3	3	0	5	8	0	0
12	10478857	.	T	C	5	2	7	0	0	7	0	0
12	10478961	.	G	T	6	3	9	0	0	9	0	0
12	10482230	.	C	A	3	6	9	0	1	10	0	0
12	10482792	.	T	G	2	3	5	0	0	5	0	0
12	10487620	.	G	T	2	2	4	0	0	4	0	0
12	10495534	.	G	A	2	2	4	0	0	4	0	0
12	10495673	.	C	G	1	2	3	0	0	3	0	0
12	10608908	.	C	T	1	2	3	0	0	3	0	0
12	10646482	.	A	T	11	8	19	0	0	19	0	0
12	10651761	.	A	G	4	3	7	0	0	7	0	0
12	10658483	.	C	T	3	2	5	0	1	6	0	0
12	10679153	.	G	A	2	3	5	0	0	5	0	0
12	10679279	.	T	G	11	11	22	0	0	22	0	0
12	10679289	.	G	A	12	10	22	0	0	22	0	0
12	10682392	.	A	G	14	13	27	0	0	27	0	0
12	10685867	.	C	T	6	7	13	0	0	13	0	0
12	10688640	.	C	T	6	8	14	0	1	15	0	0
12	10688704	.	G	A	9	9	18	0	1	19	0	0
12	10688890	.	G	A	7	11	18	0	2	20	0	0
12	10705765	.	T	A	10	10	20	0	0	20	0	0
12	10705775	.	C	G	8	10	18	0	1	19	0	0
12	10723340	.	C	T	1	2	3	0	0	3	0	0
12	10723349	.	G	A	1	2	3	0	0	3	0	0
12	10733464	.	C	T	1	2	3	0	1	4	0	0
12	10734228	.	C	T	1	3	4	0	0	4	0	0
12	11389857	.	T	C	4	0	4	0	2	6	0	0
12	11390306	.	T	C	8	6	14	0	0	14	0	0
12	11390365	.	T	C	6	6	12	0	1	13	0	0
12	11762849	.	A	T	9	7	16	0	0	16	0	0
12	13473142	.	A	G	1	2	3	0	0	3	0	0
12	13474461	.	A	G	13	9	22	0	0	22	0	0
12	16407127	.	T	C	1	3	4	0	0	4	0	0
12	18787205	.	C	T	1	7	8	0	0	8	0	0
12	18787293	.	G	A	2	2	4	0	0	4	0	0
12	18913503	.	A	G	4	2	6	0	0	6	0	0
12	18913602	.	A	G	10	6	16	0	0	16	0	0
12	18913906	.	A	G	11	7	18	0	1	19	0	0
12	18913938	.	A	G	13	8	21	0	1	22	0	0
12	19008420	.	A	G	5	2	7	0	1	8	0	0
12	19144930	.	G	A	5	2	7	0	0	7	0	0
12	19318412	.	G	T	8	2	10	0	1	11	0	0
12	19353700	.	G	A	14	3	17	0	0	17	0	0
12	19430150	.	A	G	6	7	13	0	0	13	0	0
12	19430154	.	A	G	8	5	13	0	1	14	0	0
12	20045101	.	A	G	3	2	5	0	0	5	0	0
12	22450863	.	T	C	10	4	14	0	0	14	0	0
12	22529182	.	T	C	15	9	24	0	1	25	0	0
12	22529456	.	T	G	20	21	41	0	2	44	1	0
12	22529457	.	A	C	19	24	43	0	1	44	0	0
12	22529952	.	T	C	6	3	9	0	0	9	0	0
12	22531505	.	A	T	16	12	28	0	2	30	0	0
12	22532595	.	G	A	28	14	42	0	2	44	0	0
12	22533054	.	G	A	18	13	31	0	0	31	0	0
12	22533806	.	C	T	1	17	18	0	14	32	0	0
12	22533884	.	A	T	14	7	21	0	1	22	0	0
12	22533908	.	G	A	11	8	19	0	1	20	0	0
12	22534383	.	A	G	9	11	20	0	1	21	0	0
12	22534794	.	C	T	10	12	22	0	0	22	0	0
12	22535121	.	C	G	3	9	12	0	1	13	0	0
12	22535186	.	C	T	9	13	22	0	1	23	0	0
12	22535197	.	A	G	9	17	26	0	1	27	0	0
12	22535546	.	A	T	5	11	16	0	0	16	0	0
12	22535567	.	T	C	2	14	16	0	0	16	0	0
12	22535631	.	T	G	6	5	11	0	0	11	0	0
12	22535640	.	G	A	8	3	11	0	2	13	0	0
12	22536188	.	C	T	1	6	7	0	5	12	0	0
12	22536609	.	T	G	12	11	23	0	1	24	0	0
12	22536621	.	G	C	15	11	26	0	0	26	0	0
12	22537244	.	T	C	8	4	12	0	2	14	0	0
12	22537485	.	G	A	7	2	9	0	0	9	0	0
12	22561961	.	G	A	2	2	4	0	0	4	0	0
12	22563882	.	T	C	1	3	4	0	0	4	0	0
12	22563891	.	G	T	1	2	3	0	0	3	0	0
12	22565764	.	A	G	2	3	5	0	0	5	0	0
12	22568263	.	T	C	2	6	8	0	0	8	0	0
12	22570379	.	A	T	17	14	31	0	3	34	0	0
12	22570499	.	T	C	15	11	26	0	1	27	0	0
12	22570814	.	T	C	17	12	29	0	4	33	0	0
12	22571592	.	A	T	8	5	13	0	0	13	0	0
12	22571628	.	G	A	8	3	11	0	0	11	0	0
12	22572199	.	C	G	14	12	26	0	2	28	0	0
12	22572287	.	A	C	14	14	28	0	1	29	0	0
12	22572528	.	T	G	6	19	25	0	1	26	0	0
12	22572738	.	C	T	7	16	23	0	0	23	0	0
12	22572814	.	A	G	5	0	5	0	12	17	0	0
12	22573080	.	T	A	16	19	35	0	0	35	0	0
12	22573239	.	A	C	2	4	6	0	0	6	0	0
12	22628731	.	G	T	0	2	2	0	1	3	0	0
12	22628983	.	G	A	2	4	6	0	0	6	0	0
12	22630471	.	G	A	2	3	5	0	0	5	0	0
12	22634817	.	C	T	2	4	6	0	0	6	0	0
12	22640923	.	T	C	2	8	10	0	2	12	0	0
12	22643556	.	C	G	8	7	15	0	0	15	0	0
12	22644114	.	T	A	3	2	5	0	0	5	0	0
12	22644118	.	C	T	3	2	5	0	0	5	0	0
12	22644202	.	T	G	3	4	7	0	0	7	0	0
12	22644209	.	T	C	3	4	7	0	2	9	0	0
12	22644281	.	T	C	4	7	11	0	0	11	0	0
12	22644576	.	A	G	2	0	2	0	6	8	0	0
12	22644634	.	T	C	5	5	10	0	0	10	0	0
12	22644687	.	T	G	11	4	15	0	0	15	0	0
12	22644852	.	C	T	3	1	4	0	1	5	0	0
12	22652631	.	C	T	2	2	4	0	0	4	0	0
12	22656921	.	T	A	2	2	4	0	0	4	0	0
12	22680247	.	T	C	5	3	8	0	0	8	0	0
12	22680255	.	T	C	4	2	6	0	0	6	0	0
12	22680285	.	C	G	2	2	4	0	0	4	0	0
12	22768372	.	G	A	2	3	5	0	0	5	0	0
12	22780905	.	G	A	1	3	4	0	0	4	0	0
12	22785874	.	G	A	0	5	5	0	3	8	0	0
12	22788151	.	A	C	1	6	7	0	0	7	0	0
12	22803813	.	C	T	6	3	9	0	1	10	0	0
12	22814990	.	T	C	5	11	16	0	1	17	0	0
12	22814994	.	A	G	7	10	17	0	0	17	0	0
12	22815203	.	G	A	4	7	11	0	0	11	0	0
12	22815365	.	C	T	9	6	15	0	0	15	0	0
12	22815724	.	G	T	6	2	8	0	0	8	0	0
12	22905430	.	T	C	2	2	4	0	0	4	0	0
12	22915831	.	A	G	1	0	1	0	3	4	0	0
12	22921525	.	T	A	2	6	8	0	0	8	0	0
12	22927981	.	T	C	22	10	32	0	0	32	0	0
12	22932087	.	C	T	16	7	23	0	2	25	0	0
12	22932090	.	G	C	16	7	23	0	0	23	0	0
12	22932148	.	G	A	11	6	17	0	1	18	0	0
12	22932160	.	A	C	16	6	22	0	0	22	0	0
12	22932737	.	A	G	15	0	15	0	8	23	0	0
12	22932852	.	G	T	0	13	13	0	14	27	0	0
12	22932875	.	G	T	15	15	30	0	1	31	0	0
12	22962211	.	A	T	4	3	7	0	0	7	0	0
12	22962555	.	C	A	1	4	5	0	0	5	0	0
12	22962764	.	T	C	6	7	13	1	0	14	0	0
12	22962781	.	G	A	7	5	12	1	0	13	0	0
12	22962911	.	C	A	4	4	8	0	0	8	0	0
12	22963197	.	G	A	3	5	8	0	1	9	0	0
12	22963242	.	G	A	3	2	5	0	0	5	0	0
12	22963667	.	C	G	5	8	13	0	1	14	0	0
12	23008283	.	T	G	1	4	5	0	1	6	0	0
12	23008540	.	C	A	3	4	7	0	1	8	0	0
12	23009275	.	C	T	3	4	7	0	0	7	0	0
12	23027019	.	A	T	2	2	4	0	0	4	0	0
12	23027027	.	C	G	2	2	4	0	0	4	0	0
12	23176128	.	G	A	1	3	4	0	0	4	0	0
12	23176129	.	A	G	1	3	4	0	0	4	0	0
12	23389675	.	G	A	9	7	16	0	0	16	0	0
12	23400392	.	C	T	17	11	28	0	4	32	0	0
12	23400469	.	C	T	15	10	25	0	2	27	0	0
12	23403091	.	T	C	10	18	28	0	2	30	0	0
12	23403149	.	T	C	12	22	34	0	0	34	0	0
12	23406439	.	A	G	20	19	39	0	0	39	0	0
12	23411287	.	C	T	14	5	19	0	1	20	0	0
12	23415280	.	C	T	29	9	38	0	2	40	0	0
12	23415370	.	C	T	22	17	39	1	4	44	0	0
12	23415662	.	G	A	24	11	35	0	2	37	0	0
12	23415715	.	T	C	19	17	36	0	1	37	0	0
12	23415897	.	A	T	15	2	17	0	7	24	0	0
12	23424190	.	C	T	6	2	8	0	1	9	0	0
12	23427149	.	T	C	1	2	3	0	0	3	0	0
12	23429917	.	A	G	5	0	5	0	5	10	0	0
12	23430003	.	C	A	1	4	5	0	1	6	0	0
12	23430091	.	G	A	1	4	5	0	0	5	0	0
12	23430092	.	T	A	1	4	5	0	0	5	0	0
12	23674146	.	T	C	2	1	3	0	0	3	0	0
12	23674165	.	A	T	4	2	6	0	0	6	0	0
12	23674331	.	T	A	1	4	5	0	0	5	0	0
12	23674354	.	T	C	3	10	13	0	1	14	0	0
12	23674468	.	C	T	4	2	6	0	0	6	0	0
12	23784201	.	C	G	2	2	4	0	0	4	0	0
12	23787826	.	G	T	3	3	6	0	1	7	0	0
12	23787904	.	A	T	1	5	6	0	1	7	0	0
12	23788528	.	G	A	3	5	8	0	0	8	0	0
12	23788649	.	C	A	5	2	7	0	0	7	0	0
12	23788682	.	G	A	4	4	8	0	1	9	0	0
12	23789838	.	A	C	4	4	8	0	0	8	0	0
12	23790148	.	A	T	6	4	10	0	0	10	0	0
12	23793990	.	A	T	2	3	5	0	1	6	0	0
12	23794034	.	G	A	0	3	3	0	2	5	0	0
12	23794148	.	A	T	3	3	6	0	0	6	0	0
12	23794848	.	A	T	6	2	8	0	0	8	0	0
12	23795221	.	C	G	2	2	4	0	0	4	0	0
12	23795268	.	T	A	2	2	4	0	0	4	0	0
12	23795285	.	A	G	2	4	6	0	0	6	0	0
12	23795325	.	T	C	1	3	4	0	0	4	0	0
12	23904642	.	C	T	2	4	6	0	0	6	0	0
12	23912037	.	A	G	2	2	4	0	0	4	0	0
12	23913566	.	T	C	2	2	4	0	0	4	0	0
12	23913587	.	G	A	1	4	5	0	1	6	0	0
12	23916491	.	A	G	1	6	7	0	1	8	0	0
12	23917156	.	T	G	1	0	1	0	3	4	0	0
12	23917160	.	T	G	1	3	4	0	0	4	0	0
12	23917279	.	T	C	2	2	4	0	0	4	0	0
12	23920090	.	G	A	4	5	9	0	0	9	0	0
12	23923434	.	G	A	7	9	16	0	0	16	0	0
12	23932067	.	T	G	14	10	24	0	0	24	0	0
12	24022843	.	T	C	2	2	4	0	0	4	0	0
12	24023704	.	T	A	1	3	4	0	0	4	0	0
12	24027041	.	G	A	3	5	8	0	0	8	0	0
12	24030458	.	G	A	3	2	5	0	0	5	0	0
12	24036870	.	T	C	7	3	10	0	0	10	0	0
12	24038339	.	A	C	4	4	8	0	1	9	0	0
12	24038517	.	A	G	8	6	14	0	0	14	0	0
12	24038542	.	T	C	6	7	13	0	0	13	0	0
12	24041169	.	A	G	7	0	7	0	8	15	0	0
12	24041253	.	G	T	8	4	12	0	0	12	0	0
12	24041254	.	T	A	8	4	12	0	0	12	0	0
12	24041561	.	T	C	2	2	4	0	0	4	0	0
12	24043679	.	A	G	2	0	2	0	6	8	0	0
12	24043730	.	A	G	6	9	15	0	1	16	0	0
12	24051755	.	T	A	6	7	13	0	0	13	0	0
12	24052133	.	A	G	4	1	5	0	2	7	0	0
12	24052219	.	A	C	7	2	9	0	2	11	0	0
12	24052256	.	G	C	8	5	13	0	0	13	0	0
12	24052288	.	T	C	4	3	7	0	0	7	0	0
12	24052303	.	T	A	6	1	7	0	1	8	0	0
12	24052578	.	C	T	12	5	17	0	2	19	0	0
12	24052684	.	G	A	11	7	18	0	0	18	0	0
12	24056003	.	T	G	4	0	4	0	0	4	0	0
12	24056007	.	T	G	3	0	3	0	0	3	0	0
12	24056300	.	G	A	3	2	5	0	0	5	0	0
12	24056322	.	G	A	2	2	4	0	0	4	0	0
12	24056484	.	A	T	1	4	5	0	0	5	0	0
12	24056716	.	G	T	2	3	5	0	1	6	0	0
12	24056738	.	G	A	3	4	7	0	1	8	0	0
12	24056755	.	T	A	3	5	8	0	0	8	0	0
12	24067592	.	T	A	2	3	5	0	1	6	0	0
12	24067610	.	C	T	3	4	7	0	1	8	0	0
12	24072946	.	A	G	2	6	8	0	0	8	0	0
12	24342531	.	G	A	2	4	6	0	0	6	0	0
12	24345339	.	T	C	3	2	5	0	1	6	0	0
12	24447515	.	G	A	1	4	5	0	7	12	0	0
12	24465541	.	C	T	12	13	25	0	0	25	0	0
12	24465607	.	C	T	11	11	22	0	2	24	0	0
12	24465712	.	T	C	15	9	24	0	1	25	0	0
12	24465875	.	A	C	14	10	24	0	3	27	0	0
12	24484083	.	A	C	9	8	17	1	1	19	0	0
12	24484084	.	C	T	10	8	18	1	0	19	0	0
12	24562338	.	C	T	4	2	6	0	0	6	0	0
12	24562365	.	A	G	3	0	3	0	2	5	0	0
12	24562909	.	C	T	3	7	10	0	0	10	0	0
12	24607140	.	G	A	0	26	26	0	35	61	0	0
12	24607215	.	G	A	30	24	54	0	9	63	0	0
12	24636997	.	T	G	25	26	51	0	1	52	0	0
12	24797119	.	G	A	4	10	14	0	14	28	0	0
12	24797413	.	C	T	13	17	30	0	1	31	0	0
12	24797999	.	G	C	9	8	17	0	0	17	0	0
12	24798235	.	A	G	8	8	16	0	3	19	0	0
12	24798237	.	T	G	8	9	17	0	1	18	0	0
12	24811441	.	C	A	4	8	12	0	1	13	0	0
12	24811468	.	G	A	3	6	9	0	0	9	0	0
12	24811489	.	A	G	3	5	8	0	0	8	0	0
12	24841940	.	C	A	9	7	16	0	1	17	0	0
12	24841945	.	A	G	10	8	18	0	2	20	0	0
12	24842119	.	A	G	9	17	26	0	3	29	0	0
12	24842121	.	G	A	9	19	28	0	1	29	0	0
12	24842597	.	C	T	0	5	5	0	3	8	0	0
12	24843424	.	T	C	19	0	19	0	23	42	0	0
12	24843451	.	C	T	16	13	29	0	1	30	0	0
12	24847330	.	T	G	16	11	27	0	0	27	0	0
12	24848399	.	G	A	6	6	12	0	0	12	0	0
12	24848651	.	C	T	1	7	8	0	0	8	0	0
12	24848765	.	T	C	4	13	17	0	1	18	0	0
12	24851264	.	G	A	9	9	18	0	0	18	0	0
12	24851297	.	G	A	8	8	16	0	2	18	0	0
12	24854643	.	T	G	0	7	7	0	1	8	0	0
12	24857814	.	T	C	7	3	10	0	2	12	0	0
12	24904842	.	T	C	9	4	13	0	1	14	0	0
12	24906618	.	T	C	4	7	11	0	0	11	0	0
12	24910206	.	A	G	3	6	9	0	1	10	0	0
12	24910222	.	C	G	3	7	10	0	0	10	0	0
12	24910546	.	T	A	1	5	6	0	1	7	0	0
12	24913535	.	G	C	4	5	9	0	1	10	0	0
12	24913609	.	C	A	3	2	5	0	0	5	0	0
12	24917917	.	C	A	2	4	6	0	0	6	0	0
12	24918747	.	C	A	1	1	2	0	1	4	1	0
12	24922646	.	A	T	2	2	4	0	0	4	0	0
12	24953532	.	C	G	12	10	22	0	0	22	0	0
12	24957267	.	A	G	42	33	75	0	3	78	0	0
12	24957416	.	T	C	49	36	85	0	12	97	0	0
12	24957806	.	A	G	36	41	77	0	5	82	0	0
12	25043221	.	A	G	6	6	12	0	1	13	0	0
12	25043324	.	C	T	2	5	7	0	5	12	0	0
12	25043594	.	C	T	3	3	6	0	0	6	0	0
12	25044516	.	A	G	5	6	11	0	1	12	0	0
12	25044540	.	C	T	4	6	10	0	0	10	0	0
12	25044786	.	T	G	7	6	13	0	1	14	0	0
12	25045074	.	T	C	5	4	9	0	0	9	0	0
12	25045174	.	C	T	2	2	4	0	0	4	0	0
12	25045315	.	C	T	0	2	2	0	4	6	0	0
12	25065680	.	A	G	4	3	7	0	1	8	0	0
12	25092501	.	C	A	1	2	3	0	0	3	0	0
12	25094107	.	T	G	12	13	25	0	4	29	0	0
12	25094200	.	T	C	11	5	16	0	1	17	0	0
12	25094201	.	T	C	8	9	17	0	0	17	0	0
12	25094300	.	T	C	5	4	9	0	1	10	0	0
12	25094304	.	T	C	5	0	5	0	5	10	0	0
12	25094359	.	T	C	4	9	13	0	0	13	0	0
12	25094401	.	C	T	14	9	23	0	0	23	0	0
12	25094522	.	T	C	11	6	17	0	0	17	0	0
12	25149179	.	C	G	5	6	11	0	1	12	0	0
12	25149203	.	G	A	2	3	5	0	1	6	0	0
12	25205542	.	A	T	2	4	6	0	0	6	0	0
12	25209924	.	A	C	1	2	3	0	1	4	0	0
12	25230976	.	A	G	7	4	11	0	1	12	0	0
12	25254891	.	T	C	5	5	10	0	0	10	0	0
12	25271404	.	T	G	6	8	14	0	1	15	0	0
12	25271409	.	C	A	9	8	17	0	0	17	0	0
12	25271598	.	C	T	7	9	16	0	0	16	0	0
12	25284375	.	G	A	12	9	21	0	0	21	0	0
12	25284414	.	T	C	10	17	27	0	1	28	0	0
12	25284423	.	G	A	10	16	26	0	0	26	0	0
12	25377318	.	A	C	6	0	6	0	4	10	0	0
12	25377690	.	T	A	5	4	9	0	0	9	0	0
12	25377797	.	A	T	6	8	14	0	1	15	0	0
12	25377817	.	C	G	8	2	10	1	0	11	0	0
12	25378351	.	G	A	11	8	19	0	1	20	0	0
12	25378354	.	C	T	2	7	9	0	11	20	0	0
12	25378420	.	A	G	11	13	24	0	1	25	0	0
12	25378475	.	G	A	9	14	23	0	1	24	0	0
12	25378506	.	C	A	1	12	13	0	14	27	0	0
12	25378555	.	T	C	12	7	19	0	0	19	0	0
12	25378848	.	G	T	2	7	9	0	0	9	0	0
12	25378882	.	G	T	5	3	8	0	0	8	0	0
12	25467742	.	C	T	9	9	18	0	2	20	0	0
12	25467823	.	T	C	8	7	15	0	1	16	0	0
12	25467887	.	T	C	6	5	11	0	0	11	0	0
12	25468312	.	C	T	13	15	28	0	0	28	0	0
12	25472281	.	C	T	20	21	41	0	2	43	0	0
12	25472290	.	A	G	18	0	18	0	24	42	0	0
12	25484586	.	G	A	24	16	40	0	4	44	0	0
12	25484676	.	T	G	18	15	33	0	2	35	0	0
12	25485203	.	C	T	12	9	21	0	3	24	0	0
12	25486118	.	T	G	2	2	4	0	0	4	0	0
12	25600834	.	A	G	5	2	7	0	1	8	0	0
12	25602616	.	T	A	4	14	18	0	1	19	0	0
12	25602820	.	T	A	12	14	26	0	0	26	0	0
12	25602828	.	T	A	13	13	26	0	0	26	0	0
12	25703490	.	A	G	9	0	9	0	8	17	0	0
12	25705600	.	G	A	8	8	16	0	0	16	0	0
12	25713629	.	G	C	7	10	17	0	2	19	0	0
12	25714409	.	T	C	8	6	14	0	0	14	0	0
12	25714480	.	T	G	3	9	12	0	1	13	0	0
12	25754150	.	C	T	6	10	16	1	0	17	0	0
12	25754225	.	C	T	13	11	24	0	0	24	0	0
12	25768096	.	C	T	27	20	47	0	1	48	0	0
12	25768326	.	T	A	19	25	44	0	2	46	0	0
12	25768384	.	A	T	21	5	26	0	0	26	0	0
12	25768393	.	A	C	14	11	25	0	1	26	0	0
12	25768580	.	G	A	1	19	20	0	21	41	0	0
12	25768660	.	A	T	6	6	12	0	0	12	0	0
12	25768830	.	T	C	2	7	9	0	2	11	0	0
12	25769012	.	G	A	20	18	38	0	0	38	0	0
12	25769177	.	A	T	14	14	28	0	7	35	0	0
12	25769752	.	G	A	22	24	46	0	5	51	0	0
12	25769889	.	G	A	7	12	19	1	1	21	0	0
12	25828308	.	C	T	1	4	5	0	0	5	0	0
12	25828718	.	C	A	2	4	6	0	0	6	0	0
12	25828721	.	T	C	2	4	6	0	0	6	0	0
12	25829025	.	G	A	3	4	7	0	0	7	0	0
12	25829046	.	T	C	3	3	6	0	0	6	0	0
12	25829105	.	T	C	3	3	6	0	0	6	0	0
12	25829168	.	A	G	3	7	10	0	0	10	0	0
12	25846021	.	T	C	11	16	27	0	1	28	0	0
12	25856178	.	T	A	9	12	21	0	3	24	0	0
12	25861006	.	T	C	10	16	26	0	0	26	0	0
12	25866543	.	G	A	11	11	22	0	0	22	0	0
12	25872834	.	C	A	19	13	32	0	0	32	0	0
12	25872933	.	C	T	17	13	30	0	2	32	0	0
12	25872938	.	C	A	16	15	31	0	1	32	0	0
12	25873241	.	C	T	10	15	25	0	4	29	0	0
12	25873289	.	C	T	16	13	29	0	2	31	0	0
12	25881185	.	G	C	2	24	26	0	14	40	0	0
12	25881254	.	A	C	13	19	32	0	1	33	0	0
12	25881778	.	T	C	17	18	35	0	0	35	0	0
12	25886309	.	G	T	4	2	6	0	0	6	0	0
12	25951057	.	A	G	8	4	12	0	0	12	0	0
12	25951101	.	C	T	7	6	13	0	1	14	0	0
12	25951761	.	C	T	1	3	4	0	6	10	0	0
12	25951781	.	C	A	7	3	10	0	1	11	0	0
12	25952026	.	A	G	2	7	9	0	1	10	0	0
12	25952027	.	C	G	2	8	10	0	0	10	0	0
12	25953817	.	T	C	4	3	7	0	0	7	0	0
12	25982664	.	A	T	2	3	5	0	0	5	0	0
12	26203891	.	C	T	1	9	10	0	5	15	0	0
12	26203900	.	A	T	5	9	14	0	0	14	0	0
12	26226655	.	C	G	1	4	5	0	5	10	0	0
12	26227042	.	C	T	5	7	12	0	0	12	0	0
12	26249908	.	G	A	1	3	4	0	0	4	0	0
12	26318515	.	A	G	6	3	9	0	1	10	0	0
12	26409797	.	C	A	6	7	13	0	0	13	0	0
12	26410014	.	C	T	2	1	3	0	1	4	0	0
12	26410697	.	T	A	1	5	6	0	0	6	0	0
12	26410856	.	T	C	2	0	2	0	6	8	0	0
12	26411633	.	T	C	3	8	11	0	0	11	0	0
12	26411667	.	T	A	2	6	8	0	0	8	0	0
12	26412498	.	A	G	1	3	4	0	0	4	0	0
12	26412511	.	G	C	1	3	4	0	0	4	0	0
12	26412554	.	T	G	1	2	3	0	0	3	0	0
12	26412689	.	C	A	0	3	3	1	1	5	0	0
12	26412694	.	T	C	1	2	3	0	1	4	0	0
12	26412787	.	T	C	2	3	5	0	0	5	0	0
12	26476093	.	C	G	4	11	15	0	0	15	0	0
12	26476319	.	A	G	10	12	22	0	1	23	0	0
12	26476424	.	A	G	9	5	14	0	1	15	0	0
12	26486421	.	C	G	20	30	50	0	2	52	0	0
12	26486446	.	A	C	17	28	45	0	1	46	0	0
12	26486580	.	T	C	11	11	22	0	1	23	0	0
12	26486753	.	T	C	7	11	18	0	1	19	0	0
12	26486934	.	T	A	9	12	21	0	5	26	0	0
12	26487002	.	A	T	13	12	25	0	0	25	0	0
12	26487044	.	G	A	12	7	19	0	1	20	0	0
12	26487292	.	T	G	4	4	8	0	0	8	0	0
12	26489766	.	A	T	8	2	10	0	0	10	0	0
12	26493734	.	T	C	4	4	8	0	0	8	0	0
12	26493755	.	G	A	0	4	4	0	4	8	0	0
12	26493806	.	C	T	4	4	8	0	0	8	0	0
12	26493836	.	G	A	0	4	4	0	5	9	0	0
12	26493870	.	G	T	4	2	6	0	0	6	0	0
12	26494036	.	G	A	1	3	4	0	0	4	0	0
12	26525242	.	A	T	1	3	4	0	0	4	0	0
12	26525245	.	G	T	1	3	4	0	0	4	0	0
12	26545121	.	A	G	2	3	5	0	0	5	0	0
12	26546502	.	A	G	1	2	3	0	0	3	0	0
12	26546965	.	A	G	4	4	8	0	0	8	0	0
12	26546966	.	A	G	6	3	9	0	0	9	0	0
12	26547261	.	A	C	6	0	6	0	4	10	0	0
12	26547276	.	A	C	6	4	10	0	0	10	0	0
12	26547397	.	C	T	5	5	10	0	1	11	0	0
12	26547631	.	C	T	5	2	7	0	0	7	0	0
12	26549505	.	G	T	6	2	8	0	0	8	0	0
12	26587065	.	T	C	4	2	6	0	1	7	0	0
12	26587216	.	G	A	3	3	6	0	0	6	0	0
12	26594216	.	G	A	10	5	15	0	0	15	0	0
12	26597512	.	C	T	0	8	8	0	3	11	0	0
12	26608882	.	C	T	1	4	5	0	1	6	0	0
12	26611673	.	A	T	6	2	8	0	1	9	0	0
12	26612038	.	A	G	5	12	17	0	0	17	0	0
12	26612188	.	T	C	9	0	9	0	8	17	0	0
12	26612225	.	C	G	5	8	13	0	1	14	0	0
12	26612390	.	G	C	8	6	14	0	0	14	0	0
12	26617621	.	C	A	3	5	8	0	1	9	0	0
12	26617882	.	G	A	2	3	5	0	2	7	0	0
12	26620426	.	A	G	3	2	5	0	0	5	0	0
12	26638166	.	G	A	5	2	7	0	0	7	0	0
12	26638274	.	G	A	5	2	7	0	0	7	0	0
12	26704300	.	C	T	4	5	9	0	0	9	0	0
12	26724285	.	A	T	13	7	20	0	0	20	0	0
12	26724327	.	C	A	8	5	13	0	0	13	0	0
12	26724762	.	A	G	14	1	15	0	8	23	0	0
12	26724975	.	A	G	12	0	12	0	11	23	0	0
12	26724984	.	A	T	13	11	24	0	0	24	0	0
12	26725079	.	C	A	13	6	19	0	0	19	0	0
12	26725402	.	A	G	18	9	27	0	0	27	0	0
12	26750431	.	G	A	2	7	9	0	1	10	0	0
12	26750619	.	A	G	19	14	33	0	4	37	0	0
12	26750924	.	A	C	3	3	6	0	0	6	0	0
12	26750966	.	C	A	3	2	5	0	0	5	0	0
12	26751414	.	G	A	11	18	29	0	1	30	0	0
12	26751489	.	A	G	10	12	22	0	0	22	0	0
12	26752074	.	A	C	5	2	7	0	0	7	0	0
12	26752391	.	T	C	9	0	9	0	7	16	0	0
12	26752400	.	C	T	9	7	16	0	1	17	0	0
12	26752528	.	C	T	11	8	19	0	1	20	0	0
12	26752730	.	C	T	0	16	16	0	5	21	0	0
12	26752778	.	G	C	11	11	22	0	0	22	0	0
12	26752871	.	G	A	4	10	14	0	1	15	0	0
12	26752946	.	G	A	7	6	13	0	0	13	0	0
12	26758251	.	A	G	11	3	14	0	2	16	0	0
12	26758521	.	A	G	5	5	10	0	0	10	0	0
12	26758710	.	A	C	3	4	7	0	1	8	0	0
12	26758722	.	T	C	3	4	7	0	0	7	0	0
12	26758793	.	G	T	7	4	11	0	0	11	0	0
12	26761017	.	G	A	7	3	10	0	0	10	0	0
12	26764416	.	C	T	0	2	2	0	2	4	0	0
12	26774720	.	A	G	4	5	9	0	1	10	0	0
12	26895173	.	G	C	3	2	5	2	0	7	0	0
12	26960964	.	A	C	1	4	5	0	0	5	0	0
12	27023301	.	C	T	2	4	6	0	0	6	0	0
12	27023677	.	C	T	10	6	16	0	0	16	0	0
12	27024941	.	A	G	10	6	16	0	0	16	0	0
12	27025481	.	C	T	7	14	21	0	0	21	0	0
12	27026528	.	A	C	7	5	12	0	1	14	1	0
12	27029347	.	T	C	8	0	8	0	14	22	0	0
12	27029648	.	C	T	19	15	34	0	1	35	0	0
12	27030917	.	T	C	9	0	9	0	14	23	0	0
12	27036570	.	A	C	1	3	4	0	0	4	0	0
12	27037804	.	C	T	3	5	8	0	0	8	0	0
12	27037813	.	C	T	4	4	8	0	0	8	0	0
12	27050766	.	A	G	3	6	9	0	1	10	0	0
12	27059070	.	A	G	9	11	20	0	7	27	0	0
12	27059581	.	T	C	13	13	26	0	0	26	0	0
12	27059901	.	A	T	29	10	39	0	3	42	0	0
12	27059910	.	A	T	27	10	37	0	2	39	0	0
12	27060018	.	C	T	12	7	19	0	0	19	0	0
12	27060087	.	C	A	6	9	15	0	2	17	0	0
12	27060572	.	G	A	8	6	14	0	0	14	0	0
12	27068513	.	C	A	2	5	7	0	0	7	0	0
12	27073135	.	T	C	2	2	4	0	0	4	0	0
12	27078324	.	A	T	6	3	9	0	2	11	0	0
12	27086658	.	C	T	9	3	12	0	0	12	0	0
12	27086943	.	T	C	8	10	18	0	1	19	0	0
12	27086958	.	C	T	6	10	16	0	0	16	0	0
12	27087235	.	T	G	1	3	4	0	0	4	0	0
12	27087342	.	C	A	2	2	4	0	0	4	0	0
12	27087375	.	T	C	4	3	7	0	0	7	0	0
12	27087570	.	A	T	16	7	23	0	2	25	0	0
12	27087635	.	T	C	9	7	16	0	1	17	0	0
12	27087844	.	G	A	5	13	18	0	2	20	0	0
12	27088199	.	T	C	14	7	21	0	2	23	0	0
12	27088286	.	G	T	13	11	24	0	2	26	0	0
12	27088304	.	T	C	10	10	20	0	0	20	0	0
12	27088357	.	C	T	12	3	15	0	0	15	0	0
12	27088383	.	A	C	14	8	22	0	2	24	0	0
12	27088646	.	T	A	9	16	25	0	0	25	0	0
12	27088758	.	A	C	5	11	16	0	1	17	0	0
12	27088767	.	G	A	4	11	15	0	0	15	0	0
12	27088821	.	A	G	8	0	8	0	10	18	0	0
12	27088836	.	T	C	6	7	13	0	2	15	0	0
12	27089531	.	G	C	12	14	26	0	1	27	0	0
12	27089857	.	T	C	18	12	30	0	1	31	0	0
12	27090630	.	A	C	14	14	28	0	2	30	0	0
12	27090663	.	G	A	1	14	15	0	10	25	0	0
12	27090696	.	A	T	9	12	21	0	3	24	0	0
12	27090756	.	A	G	14	12	26	0	1	27	0	0
12	27090824	.	T	G	14	9	23	0	0	23	0	0
12	27090856	.	A	T	12	10	22	0	1	23	0	0
12	27090864	.	G	C	12	12	24	0	0	24	0	0
12	27090918	.	G	A	16	9	25	0	1	26	0	0
12	27091163	.	C	A	6	8	14	0	1	15	0	0
12	27091305	.	T	C	12	12	24	0	1	25	0	0
12	27128299	.	T	A	3	3	6	0	2	8	0	0
12	27128305	.	A	G	2	4	6	0	2	8	0	0
12	27130237	.	G	A	1	11	12	0	5	17	0	0
12	27141915	.	C	T	1	2	3	0	0	3	0	0
12	27142089	.	T	A	1	0	1	0	2	3	0	0
12	27207050	.	T	G	11	6	17	0	2	19	0	0
12	27207053	.	C	T	13	6	19	0	0	19	0	0
12	27207130	.	G	A	6	3	9	0	0	9	0	0
12	27207466	.	T	C	16	18	34	0	2	36	0	0
12	27218781	.	C	T	6	8	14	1	1	16	0	0
12	27219143	.	C	T	13	8	21	0	1	22	0	0
12	27219450	.	T	C	3	4	7	0	0	7	0	0
12	27219761	.	T	A	6	8	14	0	1	15	0	0
12	27219818	.	G	A	0	8	8	0	8	16	0	0
12	27220582	.	T	C	9	14	23	0	0	23	0	0
12	27221491	.	G	A	19	14	33	0	0	33	0	0
12	27221505	.	A	T	16	18	34	0	0	34	0	0
12	27224057	.	G	A	8	7	15	0	1	16	0	0
12	27224090	.	C	G	8	0	8	0	7	15	0	0
12	27224727	.	T	C	10	8	18	0	1	19	0	0
12	27229216	.	T	A	20	9	29	0	0	29	0	0
12	27229438	.	T	G	5	11	16	0	3	19	0	0
12	27229545	.	G	A	1	11	12	0	13	25	0	0
12	27236496	.	C	A	3	2	5	0	0	5	0	0
12	27236500	.	A	T	2	2	4	0	0	4	0	0
12	27241657	.	A	G	5	6	11	0	1	12	0	0
12	27242416	.	G	A	4	6	10	0	1	11	0	0
12	27243208	.	A	G	11	8	19	0	1	20	0	0
12	27243236	.	T	C	17	8	25	0	0	25	0	0
12	27303000	.	A	G	1	4	5	0	0	5	0	0
12	27303211	.	C	T	8	6	14	0	0	14	0	0
12	27303288	.	C	T	4	4	8	0	1	9	0	0
12	27303295	.	A	C	3	7	10	0	0	10	0	0
12	27303328	.	T	C	7	6	13	0	0	13	0	0
12	27303486	.	A	T	11	10	21	0	0	21	0	0
12	27303496	.	T	C	10	10	20	0	0	20	0	0
12	27303521	.	C	T	11	11	22	0	1	23	0	0
12	27304064	.	C	T	9	4	13	0	1	14	0	0
12	27304215	.	G	A	1	3	4	0	5	9	0	0
12	27304316	.	A	T	5	9	14	0	3	17	0	0
12	27304596	.	T	A	12	8	20	0	0	20	0	0
12	27304650	.	A	G	14	0	14	0	6	21	1	0
12	27304704	.	A	C	7	8	15	0	0	15	0	0
12	27305054	.	G	A	12	10	22	0	0	22	0	0
12	27305495	.	C	A	3	9	12	0	2	14	0	0
12	27305503	.	A	G	3	11	14	0	0	14	0	0
12	27334024	.	A	G	1	0	1	0	2	3	0	0
12	27335408	.	T	A	2	2	4	0	1	5	0	0
12	27335434	.	G	A	0	3	3	0	3	6	0	0
12	27557809	.	C	T	3	3	6	0	0	6	0	0
12	27558619	.	G	C	2	3	5	0	1	6	0	0
12	27558705	.	G	T	5	6	11	0	0	11	0	0
12	27563459	.	C	T	1	3	4	0	0	4	0	0
12	27566659	.	T	C	2	4	6	0	1	7	0	0
12	27568288	.	T	A	6	7	13	0	1	14	0	0
12	27570675	.	A	G	7	4	11	0	1	12	0	0
12	27570725	.	T	A	10	6	16	0	1	17	0	0
12	27570759	.	T	G	11	7	18	0	0	18	0	0
12	27570838	.	C	G	6	9	15	0	0	15	0	0
12	27570869	.	A	T	2	9	11	0	2	13	0	0
12	27570964	.	G	A	5	2	7	0	0	7	0	0
12	27570998	.	T	A	2	2	4	0	0	4	0	0
12	27571015	.	A	G	2	3	5	0	0	5	0	0
12	27571076	.	C	A	5	6	11	0	1	12	0	0
12	27571142	.	A	C	5	4	9	0	0	9	0	0
12	27571151	.	A	T	5	3	8	0	0	8	0	0
12	27571625	.	G	A	10	12	22	0	3	25	0	0
12	27573030	.	G	A	8	6	14	0	1	15	0	0
12	27573072	.	G	A	7	9	16	0	1	17	0	0
12	27575444	.	T	C	9	5	14	0	1	15	0	0
12	27584590	.	A	T	3	6	9	0	0	9	0	0
12	27584827	.	C	T	0	5	5	0	8	13	0	0
12	27586719	.	G	A	1	3	4	0	0	4	0	0
12	27593678	.	T	C	5	3	8	0	0	8	0	0
12	27593856	.	G	A	0	4	4	0	5	9	0	0
12	27593868	.	A	C	6	6	12	0	0	12	0	0
12	27593892	.	C	T	5	5	10	0	0	10	0	0
12	27593922	.	T	G	3	4	7	0	0	7	0	0
12	27595297	.	T	A	4	2	6	0	2	8	0	0
12	27622254	.	C	T	13	6	19	0	0	19	0	0
12	27622321	.	G	A	3	3	6	0	0	6	0	0
12	27622336	.	C	A	5	3	8	0	0	8	0	0
12	27627528	.	G	C	8	11	19	0	2	21	0	0
12	27665035	.	T	C	22	17	39	0	1	40	0	0
12	27665289	.	G	C	11	12	23	0	1	24	0	0
12	27665502	.	T	A	2	8	10	0	0	10	0	0
12	27665539	.	T	C	2	3	5	0	0	5	0	0
12	27902711	.	A	C	1	4	5	0	0	5	0	0
12	27926674	.	T	C	1	4	5	0	0	5	0	0
12	27943009	.	T	C	1	3	4	0	0	4	0	0
12	28003340	.	C	T	5	3	8	0	2	10	0	0
12	28003358	.	C	T	4	2	6	0	0	6	0	0
12	28033169	.	C	T	5	2	7	0	0	7	0	0
12	28049096	.	G	A	6	11	17	0	0	17	0	0
12	28177649	.	A	G	3	0	3	0	2	5	0	0
12	28178204	.	T	A	1	2	3	0	0	3	0	0
12	28180122	.	C	G	3	2	5	0	0	5	0	0
12	28180193	.	A	G	3	0	3	0	3	6	0	0
12	28350566	.	A	G	16	5	21	0	4	25	0	0
12	28351160	.	G	C	7	7	14	0	2	16	0	0
12	28355486	.	G	A	12	5	17	0	0	17	0	0
12	28359161	.	G	A	6	4	10	0	1	11	0	0
12	28367757	.	T	A	10	10	20	0	1	21	0	0
12	28369391	.	G	A	3	11	14	0	20	34	0	0
12	28369412	.	G	T	26	13	39	0	0	39	0	0
12	28369540	.	C	A	20	18	38	0	0	38	0	0
12	28369615	.	G	C	3	14	17	0	21	38	0	0
12	28369909	.	G	T	3	20	23	0	21	44	0	0
12	28369981	.	C	T	18	16	34	0	1	35	0	0
12	28370062	.	G	C	3	20	23	0	16	39	0	0
12	28370335	.	A	C	19	26	45	0	6	51	0	0
12	28370474	.	T	G	19	0	19	0	17	36	0	0
12	28377796	.	A	G	2	4	6	0	0	6	0	0
12	28377797	.	G	C	2	4	6	0	0	6	0	0
12	28377909	.	T	A	6	4	10	0	1	11	0	0
12	28377976	.	G	A	5	3	8	0	2	10	0	0
12	28377990	.	G	A	5	2	7	0	0	7	0	0
12	28378012	.	T	A	6	2	8	0	0	8	0	0
12	28378139	.	G	A	4	7	11	0	0	11	0	0
12	28378200	.	T	G	2	5	7	0	0	7	0	0
12	28378237	.	A	C	2	4	6	0	0	6	0	0
12	28378342	.	T	C	4	5	9	0	1	10	0	0
12	28378394	.	C	A	0	9	9	0	4	13	0	0
12	28378418	.	G	A	3	8	11	0	1	12	0	0
12	28378645	.	C	T	2	5	7	0	0	7	0	0
12	28378788	.	C	T	2	6	8	0	0	8	0	0
12	28378958	.	C	T	3	3	6	0	0	6	0	0
12	28379042	.	T	C	2	2	4	0	0	4	0	0
12	28379215	.	C	T	3	3	6	0	3	9	0	0
12	28379218	.	C	T	3	4	7	0	2	9	0	0
12	28379471	.	A	C	3	0	3	0	5	8	0	0
12	28379473	.	G	T	3	5	8	0	0	8	0	0
12	28379646	.	T	C	3	3	6	0	1	7	0	0
12	28379647	.	G	A	3	4	7	0	0	7	0	0
12	28379860	.	C	T	2	2	4	0	0	4	0	0
12	28380082	.	G	T	1	2	3	0	0	3	0	0
12	28380086	.	G	A	1	2	3	0	0	3	0	0
12	28559939	.	T	C	8	7	15	0	2	17	0	0
12	28559973	.	A	C	7	2	9	0	0	9	0	0
12	28560370	.	G	T	4	2	6	0	0	6	0	0
12	28560494	.	T	C	5	3	8	0	1	9	0	0
12	28560734	.	T	C	4	8	12	0	1	13	0	0
12	28560990	.	T	C	10	4	14	0	0	14	0	0
12	28561253	.	G	A	2	4	6	0	0	6	0	0
12	28561420	.	C	T	1	4	5	0	2	7	0	0
12	28561723	.	C	A	7	2	9	0	0	9	0	0
12	28561778	.	A	T	3	6	9	0	0	9	0	0
12	28566224	.	T	C	1	3	4	0	0	4	0	0
12	28568138	.	T	A	2	2	4	0	0	4	0	0
12	28570908	.	G	A	3	2	5	0	0	5	0	0
12	28668713	.	A	T	15	16	31	0	0	31	0	0
12	28676131	.	C	T	14	16	30	0	0	30	0	0
12	28676551	.	A	G	12	0	12	0	15	27	0	0
12	28676844	.	A	T	10	6	16	0	2	18	0	0
12	28677202	.	C	T	15	6	21	0	0	21	0	0
12	28677314	.	A	G	12	16	28	0	1	29	0	0
12	28677413	.	T	C	9	11	20	0	2	22	0	0
12	28677576	.	A	T	11	13	24	1	1	26	0	0
12	28797777	.	T	C	3	5	8	0	1	9	0	0
12	28799604	.	G	C	1	6	7	0	0	7	0	0
12	28800029	.	A	G	3	5	8	0	0	8	0	0
12	28801271	.	A	G	7	0	7	0	4	11	0	0
12	28802016	.	T	C	10	16	26	0	0	26	0	0
12	28806022	.	G	A	2	9	11	0	6	17	0	0
12	28806062	.	C	T	11	5	16	0	1	17	0	0
12	28806220	.	G	T	10	7	17	0	0	17	0	0
12	28806241	.	T	G	11	6	17	0	0	17	0	0
12	28806285	.	G	A	12	5	17	0	0	17	0	0
12	28806459	.	A	T	18	6	24	0	1	25	0	0
12	28806494	.	G	A	16	7	23	0	0	23	0	0
12	28806530	.	G	C	14	6	20	0	0	20	0	0
12	28806584	.	T	G	16	6	22	0	1	23	0	0
12	28806586	.	A	T	15	6	21	0	0	21	0	0
12	28826191	.	T	C	3	5	8	0	1	9	0	0
12	28827553	.	T	A	4	2	6	0	0	6	0	0
12	28827899	.	A	G	6	0	6	0	4	10	0	0
12	28828016	.	A	C	7	4	11	0	0	11	0	0
12	28828207	.	A	T	2	12	14	0	1	15	0	0
12	28828234	.	T	C	3	8	11	0	1	12	0	0
12	28828358	.	G	A	1	5	6	0	0	6	0	0
12	28830363	.	A	G	6	11	17	0	2	19	0	0
12	28844171	.	T	C	5	7	12	0	1	13	0	0
12	28847439	.	A	C	8	4	12	0	0	12	0	0
12	28863046	.	A	T	12	9	21	0	3	24	0	0
12	28863086	.	T	A	8	10	18	0	0	18	0	0
12	28863101	.	T	C	6	9	15	0	0	15	0	0
12	28863582	.	A	G	12	11	23	0	1	24	0	0
12	28863783	.	A	C	14	7	21	0	1	22	0	0
12	28863811	.	T	C	12	10	22	0	0	22	0	0
12	28864217	.	T	C	7	9	16	0	0	16	0	0
12	28864575	.	T	G	19	2	21	0	7	28	0	0
12	28864719	.	G	C	15	12	27	0	1	28	0	0
12	28864778	.	C	G	18	9	27	0	1	28	0	0
12	28864792	.	A	C	17	10	27	0	2	29	0	0
12	28864847	.	T	C	23	7	30	0	0	30	0	0
12	28865106	.	G	T	12	15	27	0	1	28	0	0
12	28865298	.	T	A	23	19	42	0	0	42	0	0
12	28865668	.	T	G	17	15	32	0	3	35	0	0
12	28865679	.	G	A	21	18	39	0	0	39	0	0
12	28865805	.	A	C	14	10	24	0	0	24	0	0
12	28870626	.	T	C	10	12	22	0	0	22	0	0
12	28870797	.	T	C	17	0	17	0	20	38	1	0
12	28870801	.	T	A	21	13	34	0	2	36	0	0
12	28870912	.	C	A	16	19	35	0	0	35	0	0
12	28871068	.	G	T	23	15	38	0	1	39	0	0
12	28871433	.	C	A	1	20	21	1	21	43	0	0
12	28878343	.	C	T	20	18	38	0	2	40	0	0
12	28889149	.	A	G	2	3	5	0	0	5	0	0
12	28899989	.	C	A	2	2	4	0	1	5	0	0
12	28900607	.	A	G	1	2	3	0	2	5	0	0
12	28901049	.	A	G	1	3	4	0	0	5	1	0
12	28918699	.	G	A	6	9	15	0	0	15	0	0
12	28924363	.	G	A	10	7	17	0	0	17	0	0
12	28927051	.	G	A	5	2	7	0	2	9	0	0
12	28930455	.	T	C	9	6	15	0	0	15	0	0
12	28932389	.	C	T	3	6	9	0	0	9	0	0
12	28932428	.	C	T	6	2	8	0	0	8	0	0
12	28932571	.	G	A	12	8	20	0	0	20	0	0
12	28932581	.	T	A	15	4	19	0	1	20	0	0
12	28948117	.	T	C	6	4	10	0	0	10	0	0
12	28949067	.	A	G	6	4	10	0	0	10	0	0
12	28949112	.	C	A	7	3	10	0	0	10	0	0
12	28950009	.	T	C	4	0	4	0	3	7	0	0
12	28950678	.	G	T	2	3	5	0	0	5	0	0
12	28956566	.	T	C	2	2	4	0	1	5	0	0
12	28959943	.	G	T	4	2	6	0	0	6	0	0
12	28960284	.	T	C	5	9	14	0	0	14	0	0
12	28960321	.	G	A	8	5	13	0	0	13	0	0
12	28960357	.	G	A	0	2	2	0	7	9	0	0
12	28960441	.	C	T	1	2	3	0	0	3	0	0
12	29063346	.	G	A	3	8	11	0	0	11	0	0
12	29102585	.	T	C	12	14	26	0	1	27	0	0
12	29103004	.	T	C	2	6	8	0	0	8	0	0
12	29103041	.	T	A	7	4	11	0	0	11	0	0
12	29207101	.	T	C	2	2	4	0	0	4	0	0
12	29207473	.	G	A	0	4	4	0	5	9	0	0
12	29207533	.	T	C	3	4	7	0	0	7	0	0
12	29207590	.	G	A	1	7	8	0	4	12	0	0
12	29207683	.	G	T	8	6	14	0	0	14	0	0
12	29208099	.	T	G	2	2	4	0	0	4	0	0
12	29209947	.	T	G	5	5	10	0	0	10	0	0
12	29210371	.	C	A	10	13	23	0	0	23	0	0
12	29210435	.	C	G	14	8	22	0	0	22	0	0
12	29210600	.	C	T	14	10	24	0	2	26	0	0
12	29210719	.	T	A	10	11	21	0	0	21	0	0
12	29210873	.	T	A	6	5	11	0	0	11	0	0
12	29210917	.	T	C	8	5	13	0	1	14	0	0
12	29211017	.	C	T	3	5	8	0	0	8	0	0
12	29211082	.	G	A	7	4	11	0	1	12	0	0
12	29211195	.	T	A	8	10	18	0	0	18	0	0
12	29211232	.	G	A	1	12	13	0	15	28	0	0
12	29211289	.	T	A	24	13	37	0	1	38	0	0
12	29211292	.	A	G	14	12	26	0	10	36	0	0
12	29223612	.	T	G	5	4	9	0	0	9	0	0
12	29223689	.	G	A	3	4	7	0	0	7	0	0
12	29223751	.	G	C	3	2	5	0	0	5	0	0
12	29223921	.	G	A	5	4	9	0	0	9	0	0
12	29223969	.	A	T	2	3	5	0	0	5	0	0
12	29224250	.	T	G	1	3	4	0	0	4	0	0
12	29224310	.	A	G	2	3	5	0	0	5	0	0
12	29224521	.	A	T	4	5	9	0	0	9	0	0
12	29224655	.	T	C	1	2	3	0	0	3	0	0
12	29224687	.	C	T	1	2	3	0	0	3	0	0
12	29226152	.	T	C	5	2	7	0	0	7	0	0
12	29227014	.	T	G	4	2	6	0	0	6	0	0
12	29227044	.	G	A	2	3	5	0	0	5	0	0
12	29251385	.	A	G	3	2	5	0	0	5	0	0
12	29251408	.	T	C	3	3	6	0	0	6	0	0
12	29251446	.	T	C	1	3	4	1	0	5	0	0
12	29251520	.	A	G	2	4	6	0	0	6	0	0
12	29258629	.	G	T	2	2	4	1	1	6	0	0
12	29262564	.	A	G	1	0	1	0	4	5	0	0
12	29266917	.	T	C	4	7	11	0	0	11	0	0
12	29269576	.	C	A	1	6	7	0	1	8	0	0
12	29269689	.	G	A	2	11	13	0	0	13	0	0
12	29269695	.	A	G	2	0	2	0	10	12	0	0
12	29269770	.	G	T	0	3	3	0	5	8	0	0
12	29269774	.	T	G	5	3	8	0	0	8	0	0
12	29351320	.	A	G	13	14	27	0	1	28	0	0
12	29351810	.	A	G	21	13	34	0	0	34	0	0
12	29358277	.	T	C	12	15	27	1	2	30	0	0
12	29358370	.	G	C	8	1	9	0	14	23	0	0
12	29358384	.	A	G	10	13	23	0	2	25	0	0
12	29358418	.	A	G	6	11	17	0	0	17	0	0
12	29624017	.	G	A	9	11	20	0	0	20	0	0
12	29624611	.	T	C	2	0	2	0	2	4	0	0
12	29801179	.	T	C	2	2	4	0	0	4	0	0
12	29806358	.	C	G	3	0	3	0	4	7	0	0
12	29806411	.	G	C	2	4	6	0	0	6	0	0
12	29811009	.	A	G	3	0	3	0	3	6	0	0
12	29843460	.	A	G	11	15	26	0	1	27	0	0
12	29844434	.	T	C	7	11	18	0	2	20	0	0
12	29873273	.	C	G	7	12	19	1	0	20	0	0
12	29921114	.	T	G	12	7	19	0	0	19	0	0
12	29947132	.	A	G	6	6	12	0	0	12	0	0
12	29947147	.	C	A	8	5	13	0	0	13	0	0
12	29957074	.	C	T	5	5	10	0	0	10	0	0
12	29957164	.	C	T	3	7	10	0	1	11	0	0
12	29965724	.	G	A	4	3	7	0	0	7	0	0
12	29965928	.	C	T	4	2	6	0	0	6	0	0
12	29965967	.	G	A	1	4	5	0	0	5	0	0
12	29966048	.	T	C	1	0	1	0	4	5	0	0
12	29968087	.	T	C	3	0	3	0	8	11	0	0
12	29976936	.	G	A	1	2	3	0	0	3	0	0
12	30036873	.	G	A	4	2	6	0	0	6	0	0
12	30129351	.	C	T	3	4	7	0	0	7	0	0
12	30192526	.	A	T	5	3	8	0	1	9	0	0
12	30200741	.	C	T	6	9	15	0	1	16	0	0
12	30207912	.	G	A	9	8	17	0	1	18	0	0
12	30208905	.	T	C	5	3	8	0	0	8	0	0
12	30211165	.	T	A	6	6	12	0	1	13	0	0
12	30216090	.	G	T	4	4	8	0	0	8	0	0
12	30216248	.	C	T	4	7	11	0	2	13	0	0
12	30216436	.	T	C	7	5	12	0	0	12	0	0
12	30216490	.	T	C	5	7	12	0	0	12	0	0
12	30216693	.	C	T	3	6	9	0	0	9	0	0
12	30216697	.	G	A	2	6	8	0	2	10	0	0
12	30217589	.	A	T	9	3	12	0	0	12	0	0
12	30217705	.	G	A	2	5	7	0	5	12	0	0
12	30217747	.	C	T	3	7	10	0	0	10	0	0
12	30217782	.	T	G	2	8	10	0	0	10	0	0
12	30217893	.	C	A	2	8	10	0	0	10	0	0
12	30217898	.	T	A	2	7	9	0	1	10	0	0
12	30217966	.	G	A	5	9	14	0	2	16	0	0
12	30217986	.	C	T	8	5	13	0	0	13	0	0
12	30218135	.	C	A	8	4	12	0	0	12	0	0
12	30218150	.	G	A	7	9	16	0	0	16	0	0
12	30218173	.	C	T	9	8	17	0	1	18	0	0
12	30219306	.	A	T	19	20	39	0	3	42	0	0
12	30219687	.	T	A	12	10	22	0	1	23	0	0
12	30219694	.	A	T	6	11	17	0	3	20	0	0
12	30219739	.	G	A	11	5	16	0	2	18	0	0
12	30219804	.	C	T	16	12	28	2	1	31	0	0
12	30272647	.	T	C	2	8	10	0	0	10	0	0
12	30299073	.	C	T	1	5	6	0	1	7	0	0
12	30303081	.	C	A	2	3	5	0	1	6	0	0
12	30305983	.	T	C	2	12	14	0	1	15	0	0
12	30307010	.	C	T	2	12	14	0	0	14	0	0
12	30307913	.	G	T	4	14	18	0	0	18	0	0
12	30372763	.	G	A	4	4	8	0	0	8	0	0
12	30382341	.	C	T	5	2	7	0	0	7	0	0
12	30382705	.	G	A	1	3	4	0	3	7	0	0
12	30383960	.	G	A	1	6	7	0	3	10	0	0
12	30385562	.	C	T	9	7	16	0	0	16	0	0
12	30391136	.	G	A	3	6	9	0	0	9	0	0
12	30418108	.	T	C	9	5	14	0	0	14	0	0
12	30418513	.	C	G	8	5	13	0	0	13	0	0
12	30419123	.	A	T	8	6	14	0	1	15	0	0
12	30419134	.	C	A	6	8	14	0	0	14	0	0
12	30419260	.	T	G	16	8	24	1	0	25	0	0
12	30419646	.	T	C	7	6	13	0	2	15	0	0
12	30419655	.	T	C	8	5	13	0	0	13	0	0
12	30419695	.	T	C	6	5	11	0	1	12	0	0
12	30419727	.	A	G	5	4	9	0	0	9	0	0
12	30442406	.	C	A	9	6	15	0	0	15	0	0
12	30442783	.	G	A	5	7	12	0	1	13	0	0
12	30443462	.	T	C	1	4	5	0	0	5	0	0
12	30460474	.	G	C	2	1	3	0	1	4	0	0
12	30460610	.	C	T	7	2	9	0	0	9	0	0
12	30460644	.	C	T	6	2	8	0	0	8	0	0
12	30460656	.	T	A	4	4	8	0	0	8	0	0
12	30461218	.	G	A	4	3	7	0	0	7	0	0
12	30461332	.	G	A	1	2	3	0	0	3	0	0
12	30497808	.	G	A	1	2	3	0	0	3	0	0
12	30712031	.	T	G	3	3	6	0	0	6	0	0
12	30712099	.	T	A	3	2	5	0	0	5	0	0
12	30737025	.	T	C	2	4	6	0	0	6	0	0
12	30740917	.	C	T	1	1	2	0	1	3	0	0
12	30744091	.	C	T	0	2	2	0	1	3	0	0
12	30788993	.	G	A	1	3	4	0	0	4	0	0
12	30793107	.	C	T	4	4	8	0	0	8	0	0
12	30796306	.	C	T	3	2	5	0	1	6	0	0
12	30796322	.	C	A	4	3	7	0	0	7	0	0
12	30796345	.	C	T	5	3	8	0	0	8	0	0
12	30798079	.	G	A	5	5	10	0	0	10	0	0
12	30798085	.	A	T	5	5	10	0	0	10	0	0
12	30803166	.	G	A	0	6	6	0	3	9	0	0
12	30803196	.	T	C	3	10	13	0	0	13	0	0
12	30803629	.	A	G	8	5	13	0	1	14	0	0
12	30805335	.	T	C	4	3	7	0	0	7	0	0
12	30805359	.	T	C	5	3	8	0	0	8	0	0
12	30805455	.	C	T	4	3	7	0	1	8	0	0
12	30806928	.	G	T	1	5	6	0	5	11	0	0
12	30807038	.	A	G	8	10	18	0	2	20	0	0
12	30807245	.	A	G	1	3	4	0	0	4	0	0
12	30807330	.	T	A	2	2	4	0	1	5	0	0
12	30807458	.	C	T	7	3	10	0	0	10	0	0
12	30807494	.	G	A	3	7	10	0	1	11	0	0
12	30807504	.	A	C	4	10	14	0	1	15	0	0
12	30807714	.	A	G	15	4	19	0	0	19	0	0
12	30807871	.	A	G	5	2	7	0	0	7	0	0
12	30808094	.	C	T	7	6	13	0	2	15	0	0
12	30808150	.	T	A	9	6	15	0	1	16	0	0
12	30808531	.	G	C	4	8	12	0	0	12	0	0
12	30808766	.	C	T	4	9	13	0	0	13	0	0
12	30808812	.	A	G	5	0	5	0	3	8	0	0
12	30808817	.	T	G	3	4	7	0	0	7	0	0
12	30979815	.	A	C	12	10	22	0	1	23	0	0
12	30979923	.	T	A	14	4	18	0	1	19	0	0
12	30980566	.	G	A	31	24	55	0	0	55	0	0
12	30981795	.	G	A	29	26	55	0	1	56	0	0
12	30986452	.	G	A	33	19	52	1	1	54	0	0
12	31012667	.	C	T	3	4	7	0	0	7	0	0
12	31012687	.	C	A	3	3	6	0	0	6	0	0
12	31102981	.	A	G	7	7	14	0	0	14	0	0
12	31435977	.	T	A	10	8	18	0	0	18	0	0
12	31438056	.	G	T	5	11	16	0	1	17	0	0
12	31438283	.	A	G	5	2	7	0	0	7	0	0
12	31438352	.	A	T	4	3	7	0	0	7	0	0
12	31509602	.	A	T	2	3	5	0	0	5	0	0
12	31520603	.	T	C	1	2	3	0	0	3	0	0
12	31520814	.	T	A	2	2	4	0	0	4	0	0
12	31520850	.	C	T	2	2	4	0	0	4	0	0
12	31523203	.	T	C	4	2	6	0	0	6	0	0
12	31528169	.	G	C	0	2	2	0	1	3	0	0
12	31532577	.	T	C	7	6	13	0	0	13	0	0
12	31532638	.	A	C	5	6	11	0	0	11	0	0
12	31532715	.	T	C	3	4	7	0	0	7	0	0
12	31629611	.	C	T	6	3	9	0	0	9	0	0
12	31630829	.	G	A	1	6	7	0	6	13	0	0
12	31631116	.	A	T	3	3	6	0	0	6	0	0
12	31631124	.	A	T	2	2	4	0	0	4	0	0
12	31631190	.	G	T	0	3	3	0	1	4	0	0
12	31664770	.	T	A	3	3	6	0	0	6	0	0
12	31664846	.	A	T	2	2	4	0	0	4	0	0
12	31665007	.	G	A	1	2	3	0	0	3	0	0
12	31704077	.	A	C	1	7	8	0	0	8	0	0
12	31704485	.	A	G	4	0	4	0	3	7	0	0
12	31704548	.	T	C	3	7	10	0	0	10	0	0
12	31704641	.	A	G	3	0	3	0	2	5	0	0
12	31704647	.	G	T	0	2	2	0	3	5	0	0
12	31708020	.	C	T	6	3	9	0	0	9	0	0
12	31708025	.	G	A	6	3	9	0	0	9	0	0
12	31708082	.	G	A	3	7	10	0	0	10	0	0
12	31708125	.	C	A	3	5	8	0	0	8	0	0
12	31709964	.	G	T	3	3	6	0	1	7	0	0
12	31720799	.	C	T	16	16	32	0	4	36	0	0
12	31721486	.	G	A	14	7	21	0	2	23	0	0
12	31722593	.	G	T	13	9	22	0	3	25	0	0
12	31722811	.	G	T	12	10	22	0	1	23	0	0
12	31722875	.	A	C	19	2	21	0	17	38	0	0
12	31724245	.	A	C	21	28	49	0	1	50	0	0
12	31724252	.	C	T	22	30	52	0	2	54	0	0
12	31729236	.	G	A	8	2	10	0	2	12	0	0
12	31729441	.	A	C	4	5	9	0	0	9	0	0
12	31729455	.	G	T	4	4	8	0	0	8	0	0
12	31740822	.	C	T	3	5	8	0	0	8	0	0
12	31741463	.	C	T	9	6	15	0	0	15	0	0
12	31743995	.	C	T	3	2	5	0	0	5	0	0
12	31753752	.	C	T	9	8	17	0	1	18	0	0
12	31753755	.	C	T	9	8	17	0	0	17	0	0
12	31764523	.	T	C	13	8	21	0	3	24	0	0
12	31764526	.	C	A	13	10	23	0	0	23	0	0
12	31765407	.	G	A	20	10	30	0	2	32	0	0
12	31765485	.	G	A	8	6	14	0	1	15	0	0
12	31765517	.	T	C	11	4	15	0	1	16	0	0
12	31765540	.	T	G	11	4	15	0	1	16	0	0
12	31785314	.	C	T	2	3	5	0	0	5	0	0
12	31789799	.	C	T	14	17	31	0	0	31	0	0
12	31794655	.	G	A	12	13	25	0	0	25	0	0
12	31909921	.	T	C	1	5	6	0	0	6	0	0
12	31909926	.	T	C	3	3	6	0	0	6	0	0
12	31911406	.	A	G	3	3	6	0	0	6	0	0
12	32039443	.	C	T	2	10	12	0	7	19	0	0
12	32039527	.	A	G	12	12	24	0	2	26	0	0
12	32039546	.	G	A	14	12	26	0	1	27	0	0
12	32039635	.	A	C	15	22	37	0	3	40	0	0
12	32039678	.	C	T	23	26	49	0	1	50	0	0
12	32039937	.	G	A	18	18	36	0	6	42	0	0
12	32039958	.	T	C	22	2	24	0	21	45	0	0
12	32040093	.	G	A	21	16	37	0	2	39	0	0
12	32045155	.	G	A	12	18	30	0	1	31	0	0
12	32045212	.	T	C	13	0	13	0	18	31	0	0
12	32051434	.	C	A	15	12	27	0	0	27	0	0
12	32051488	.	G	A	23	12	35	0	3	38	0	0
12	32066061	.	C	A	9	8	17	0	1	18	0	0
12	32068487	.	A	G	3	4	7	0	0	7	0	0
12	32068700	.	A	T	5	4	9	0	1	10	0	0
12	33351440	.	T	A	1	8	9	0	0	9	0	0
12	33434997	.	A	G	1	0	1	0	6	7	0	0
12	33604491	.	A	C	1	5	6	0	0	6	0	0
12	33629708	.	T	C	2	2	4	0	1	5	0	0
12	33738703	.	T	A	5	2	7	0	1	8	0	0
12	33967029	.	T	C	19	12	31	0	3	34	0	0
12	33991622	.	T	C	21	14	35	0	3	38	0	0
12	34953641	.	G	T	1	3	4	0	6	10	0	0
12	35008681	.	A	G	15	11	26	0	3	29	0	0
12	35012040	.	C	T	15	11	26	0	0	26	0	0
12	35012127	.	T	C	14	15	29	1	1	31	0	0
12	35014147	.	C	A	4	4	8	0	1	9	0	0
12	35014151	.	C	A	4	3	7	0	1	8	0	0
12	35018127	.	C	T	19	17	36	0	0	36	0	0
12	35046821	.	A	G	11	20	31	0	3	34	0	0
12	35046875	.	C	T	7	17	24	0	1	25	0	0
12	35046900	.	G	A	9	14	23	0	3	26	0	0
12	35046928	.	T	C	7	12	19	0	2	21	0	0
12	35046956	.	T	G	14	11	25	0	0	25	0	0
12	35046965	.	G	T	16	12	28	0	0	28	0	0
12	35047014	.	A	G	11	5	16	0	6	22	0	0
12	35051250	.	A	G	12	15	27	0	1	28	0	0
12	35099430	.	G	A	0	3	3	0	0	3	0	0
12	35099509	.	C	T	0	2	2	0	6	8	0	0
12	35099532	.	G	T	1	6	7	0	0	7	0	0
12	35099571	.	G	A	3	2	5	0	0	5	0	0
12	35099601	.	C	T	3	3	6	0	0	6	0	0
12	35099805	.	G	A	4	4	8	0	0	8	0	0
12	35103405	.	A	G	1	2	3	0	0	3	0	0
12	35103606	.	T	C	4	0	4	0	5	9	0	0
12	35103665	.	C	T	5	3	8	0	0	8	0	0
12	35103710	.	G	C	4	3	7	0	0	7	0	0
12	35105596	.	G	C	5	4	9	0	0	9	0	0
12	35149868	.	G	A	3	5	8	0	1	9	0	0
12	35158344	.	C	T	6	4	10	0	0	10	0	0
12	35167333	.	A	G	4	11	15	0	0	15	0	0
12	35178914	.	G	A	10	6	16	0	0	16	0	0
12	35189264	.	G	T	8	3	11	0	0	11	0	0
12	35189295	.	C	T	11	4	15	0	0	15	0	0
12	35189306	.	A	G	9	4	13	0	1	14	0	0
12	35189402	.	A	G	3	1	4	0	12	16	0	0
12	35189471	.	T	A	9	8	17	0	0	17	0	0
12	35191080	.	A	T	13	14	27	0	0	27	0	0
12	35191856	.	C	T	14	12	26	0	0	26	0	0
12	35203251	.	G	T	0	4	4	0	2	6	0	0
12	35270573	.	G	A	0	2	2	0	1	3	0	0
12	35317147	.	G	A	1	7	8	0	0	8	0	0
12	35317520	.	C	A	7	2	9	0	0	9	0	0
12	35317609	.	C	T	4	1	5	0	1	6	0	0
12	35317654	.	C	T	2	3	5	0	1	6	0	0
12	35328139	.	C	T	5	5	10	0	1	11	0	0
12	35330107	.	C	T	8	4	12	0	0	12	0	0
12	35332283	.	T	A	1	6	7	0	0	7	0	0
12	35334652	.	C	G	3	8	11	0	0	11	0	0
12	35339212	.	A	G	4	4	8	0	0	8	0	0
12	35339263	.	A	T	4	5	9	0	2	11	0	0
12	35339395	.	C	T	5	3	8	0	0	8	0	0
12	35346498	.	G	A	27	21	48	0	2	50	0	0
12	35346597	.	A	T	36	27	63	0	3	66	0	0
12	35346842	.	T	C	27	17	44	0	3	47	0	0
12	35346873	.	C	T	31	27	58	0	0	58	0	0
12	35347002	.	A	T	20	29	49	0	3	52	0	0
12	35347078	.	G	A	25	31	56	0	3	59	0	0
12	35347084	.	C	T	5	24	29	0	31	60	0	0
12	35347318	.	C	T	24	23	47	0	2	49	0	0
12	35347485	.	T	G	22	23	45	0	3	48	0	0
12	35347795	.	C	T	0	6	6	0	7	13	0	0
12	35347951	.	A	G	36	18	54	0	0	54	0	0
12	35350686	.	G	A	20	18	38	0	2	40	0	0
12	35351392	.	G	T	19	19	38	1	2	41	0	0
12	35381726	.	T	C	16	1	17	0	12	29	0	0
12	35381729	.	T	C	6	1	7	0	18	25	0	0
12	35386919	.	A	G	13	16	29	0	1	30	0	0
12	35543736	.	T	G	6	16	22	0	1	23	0	0
12	35543971	.	T	G	17	10	27	0	1	28	0	0
12	35544320	.	T	G	10	8	18	0	2	20	0	0
12	35544460	.	A	G	7	8	15	0	0	15	0	0
12	35544596	.	C	A	5	6	11	0	0	11	0	0
12	35544968	.	A	G	10	19	29	0	0	29	0	0
12	35556821	.	G	C	3	2	5	0	0	5	0	0
12	35559614	.	T	G	3	5	8	0	0	8	0	0
12	35568231	.	G	A	3	5	8	0	3	11	0	0
12	35568249	.	C	T	2	3	5	0	5	10	0	0
12	35568270	.	T	A	2	4	6	0	1	7	0	0
12	35568303	.	C	G	4	5	9	0	0	9	0	0
12	35568691	.	A	G	5	4	9	0	0	9	0	0
12	35593188	.	C	T	23	13	36	0	3	39	0	0
12	35593469	.	T	A	9	9	18	0	1	19	0	0
12	35593729	.	A	G	7	0	7	0	8	15	0	0
12	35594069	.	T	A	17	21	38	0	0	38	0	0
12	35594154	.	C	T	15	9	24	0	1	25	0	0
12	35594169	.	C	T	14	9	23	0	1	24	0	0
12	35594436	.	C	T	24	8	32	0	0	32	0	0
12	35594474	.	A	G	24	7	31	0	0	31	0	0
12	35594495	.	G	A	3	6	9	0	23	32	0	0
12	35594512	.	T	C	26	8	34	0	0	34	0	0
12	35594541	.	C	A	25	8	33	0	1	34	0	0
12	35594605	.	C	T	22	16	38	0	3	41	0	0
12	35594623	.	T	A	20	17	37	0	2	39	0	0
12	35674952	.	G	A	11	13	24	0	1	25	0	0
12	35689209	.	C	T	12	12	24	0	0	24	0	0
12	35689210	.	A	G	11	12	23	0	1	24	0	0
12	35704426	.	G	T	31	15	46	0	3	49	0	0
12	35704435	.	G	T	32	18	50	0	1	51	0	0
12	35704735	.	A	G	18	9	27	0	0	27	0	0
12	35704852	.	G	A	20	13	33	0	0	33	0	0
12	35704921	.	A	C	18	9	27	0	2	29	0	0
12	35704996	.	T	G	21	13	34	0	2	36	0	0
12	35705131	.	C	T	20	17	37	0	5	42	0	0
12	35705140	.	A	C	22	0	22	0	18	40	0	0
12	35705224	.	A	G	18	12	30	0	2	32	0	0
12	35705252	.	T	G	19	18	37	0	1	38	0	0
12	35705323	.	G	A	21	11	32	0	1	33	0	0
12	35705367	.	C	T	1	13	14	0	22	36	0	0
12	35705565	.	C	T	1	16	17	0	13	30	0	0
12	35705606	.	A	T	12	12	24	0	0	24	0	0
12	35705661	.	T	C	14	10	24	0	0	24	0	0
12	35705926	.	C	T	16	20	36	0	2	38	0	0
12	35706091	.	C	T	13	12	25	0	0	25	0	0
12	35706124	.	A	G	17	7	24	1	0	25	0	0
12	35706253	.	A	T	8	14	22	0	0	22	0	0
12	35706304	.	A	G	12	12	24	0	1	25	0	0
12	35706524	.	G	A	12	16	28	0	0	28	0	0
12	35706568	.	C	T	10	14	24	0	0	24	0	0
12	35706859	.	C	T	2	16	18	0	6	24	0	0
12	35706970	.	G	T	11	11	22	0	3	25	0	0
12	35707155	.	C	T	9	5	14	0	1	15	0	0
12	35707171	.	T	C	8	6	14	0	0	14	0	0
12	35707225	.	G	A	10	9	19	0	0	19	0	0
12	35707537	.	A	G	7	9	16	0	0	16	0	0
12	35707660	.	A	C	5	3	8	0	0	8	0	0
12	35707747	.	A	G	9	5	14	0	0	14	0	0
12	35707963	.	T	C	7	1	8	0	8	16	0	0
12	35707987	.	G	A	10	4	14	0	0	14	0	0
12	35708139	.	T	G	5	15	20	0	1	21	0	0
12	35708235	.	A	G	9	10	19	0	3	22	0	0
12	35708272	.	C	T	10	5	15	0	3	18	0	0
12	35708950	.	G	A	6	7	13	0	0	13	0	0
12	35709007	.	G	A	7	8	15	0	0	15	0	0
12	35709028	.	A	G	2	9	11	0	0	11	0	0
12	35710837	.	T	C	6	6	12	0	1	13	0	0
12	35715339	.	A	G	4	5	9	0	0	9	0	0
12	35716116	.	T	G	2	5	7	0	0	7	0	0
12	35837354	.	C	T	2	3	5	1	8	14	0	0
12	35837425	.	T	A	8	4	12	0	0	12	0	0
12	35837468	.	C	A	7	3	10	0	0	10	0	0
12	35837499	.	G	C	7	5	12	0	0	12	0	0
12	35837503	.	T	G	6	5	11	0	1	12	0	0
12	35837751	.	G	A	3	10	13	0	0	13	0	0
12	35837842	.	G	A	10	3	13	0	0	13	0	0
12	35838537	.	G	C	2	2	4	0	0	4	0	0
12	35838542	.	A	C	2	2	4	0	0	4	0	0
12	35838882	.	A	C	4	4	8	0	0	8	0	0
12	35839063	.	A	T	7	4	11	0	0	11	0	0
12	35839090	.	C	T	0	2	2	0	6	8	0	0
12	35839159	.	C	T	4	3	7	0	1	8	0	0
12	35839165	.	C	G	4	3	7	0	0	7	0	0
12	35839261	.	C	A	6	7	13	0	0	13	0	0
12	35839680	.	G	A	6	4	10	0	0	10	0	0
12	35839879	.	C	A	0	4	4	0	9	13	0	0
12	35839919	.	C	G	1	1	2	0	6	8	0	0
12	35839942	.	C	T	2	3	5	0	0	5	0	0
12	35840003	.	T	C	4	0	4	0	4	8	0	0
12	35840008	.	C	A	4	5	9	0	0	9	0	0
12	35840483	.	G	A	4	5	9	0	0	9	0	0
12	35840543	.	A	C	8	5	13	1	0	14	0	0
12	35840717	.	A	G	3	5	8	0	0	8	0	0
12	35841438	.	G	A	4	2	6	0	0	6	0	0
12	35841457	.	G	A	7	3	10	0	0	10	0	0
12	35847493	.	A	T	5	2	7	0	0	7	0	0
12	35847535	.	T	C	4	4	8	0	1	9	0	0
12	35847538	.	C	T	6	4	10	0	0	10	0	0
12	35853678	.	A	G	3	2	5	0	2	7	0	0
12	35853693	.	T	C	4	2	6	0	2	8	0	0
12	35864581	.	T	A	3	3	6	0	0	6	0	0
12	35875766	.	A	G	2	2	4	0	0	4	0	0
12	35963575	.	T	C	9	5	14	0	1	15	0	0
12	35976771	.	C	A	2	4	6	0	0	6	0	0
12	35980632	.	T	C	6	3	9	0	0	9	0	0
12	35980758	.	C	T	4	10	14	0	0	14	0	0
12	35980764	.	T	C	4	10	14	0	0	14	0	0
12	35980817	.	T	A	7	4	11	0	0	11	0	0
12	35980917	.	T	G	6	7	13	0	1	14	0	0
12	35981206	.	T	C	7	0	7	0	10	17	0	0
12	35981260	.	T	A	6	6	12	0	2	14	0	0
12	35981303	.	T	G	2	4	6	0	0	6	0	0
12	35981304	.	G	C	2	4	6	0	0	6	0	0
12	35981478	.	A	G	4	5	9	1	0	10	0	0
12	35981627	.	C	T	5	12	17	0	2	19	0	0
12	35981713	.	C	T	2	11	13	0	2	15	0	0
12	35981795	.	T	A	3	12	15	0	1	16	0	0
12	35981832	.	A	G	3	8	11	0	1	12	0	0
12	35988544	.	A	G	8	16	24	0	1	25	0	0
12	35988553	.	G	A	6	10	16	0	2	19	1	0
12	36105341	.	A	G	2	2	4	0	0	4	0	0
12	36105410	.	G	T	6	2	8	0	0	8	0	0
12	36135764	.	C	T	5	5	10	0	2	12	0	0
12	36158056	.	A	C	19	15	34	0	0	34	0	0
12	36158098	.	G	C	18	13	31	0	0	31	0	0
12	36158099	.	T	C	17	13	30	0	1	31	0	0
12	36158225	.	T	C	7	23	30	0	1	31	0	0
12	36158349	.	G	A	0	20	20	0	16	36	0	0
12	36158538	.	C	T	4	11	15	0	1	16	0	0
12	36159597	.	C	G	10	8	18	1	1	20	0	0
12	36413894	.	G	T	6	3	9	0	0	9	0	0
12	36413937	.	A	T	3	6	9	0	1	10	0	0
12	36416669	.	T	C	5	4	9	0	0	9	0	0
12	36416675	.	T	C	4	4	8	0	0	8	0	0
12	36416732	.	G	C	4	2	6	0	0	6	0	0
12	36420420	.	G	A	4	4	8	0	0	8	0	0
12	36422537	.	A	G	4	5	9	0	0	9	0	0
12	36422555	.	G	A	2	3	5	0	1	6	0	0
12	36422573	.	T	C	2	4	6	0	0	6	0	0
12	36424613	.	G	A	8	9	17	0	0	17	0	0
12	36424618	.	G	A	9	7	16	0	0	16	0	0
12	36452363	.	T	C	3	2	5	0	0	5	0	0
12	36462038	.	G	A	3	1	4	0	1	5	0	0
12	36471149	.	A	C	3	2	5	0	0	5	0	0
12	36671145	.	A	G	2	3	5	0	0	5	0	0
12	36891583	.	C	T	2	4	6	0	0	6	0	0
12	36895025	.	A	G	5	7	12	0	0	12	0	0
12	36895057	.	T	C	3	6	9	0	0	9	0	0
12	36895067	.	G	A	2	5	7	0	0	7	0	0
12	36952648	.	T	G	5	0	5	1	4	10	0	0
12	36952744	.	C	T	6	5	11	0	0	11	0	0
12	36960197	.	T	C	2	8	10	0	1	11	0	0
12	36960200	.	A	T	1	9	10	0	0	10	0	0
12	37001843	.	C	T	1	2	3	1	0	4	0	0
12	37003282	.	C	T	2	4	6	0	0	6	0	0
12	37003291	.	A	G	2	4	6	0	0	6	0	0
12	37003332	.	A	G	2	2	4	0	0	4	0	0
12	37003460	.	T	C	2	2	4	0	0	4	0	0
12	37004991	.	A	G	1	2	3	0	1	4	0	0
12	37005586	.	A	G	5	0	5	0	4	9	0	0
12	37275712	.	A	T	2	2	4	0	0	4	0	0
12	37275719	.	G	T	2	2	4	0	1	5	0	0
12	37277295	.	C	T	5	2	7	0	0	7	0	0
12	37407249	.	G	T	5	4	9	0	0	9	0	0
12	37407392	.	T	A	12	6	18	0	1	19	0	0
12	37407477	.	T	C	7	5	12	0	1	13	0	0
12	37407524	.	C	A	6	5	11	0	1	12	0	0
12	37407632	.	T	A	4	9	13	0	1	14	0	0
12	37407813	.	C	T	6	8	14	0	1	15	0	0
12	37408206	.	A	G	4	8	12	0	0	12	0	0
12	37408232	.	T	A	7	7	14	0	1	15	0	0
12	37408442	.	G	C	1	8	9	0	0	9	0	0
12	37409037	.	C	T	2	4	6	0	0	6	0	0
12	37409269	.	C	T	6	5	11	0	0	11	0	0
12	37409315	.	C	T	0	5	5	0	4	9	0	0
12	37409436	.	C	A	0	3	3	0	1	4	0	0
12	37409481	.	G	A	1	2	3	0	0	3	0	0
12	37409611	.	A	G	3	2	5	0	1	6	0	0
12	37409802	.	C	T	6	6	12	0	1	13	0	0
12	37409836	.	T	G	5	7	12	0	0	12	0	0
12	37410018	.	T	C	3	0	3	0	5	8	0	0
12	37410034	.	C	T	5	3	8	0	0	8	0	0
12	37410111	.	T	C	1	2	3	0	0	3	0	0
12	37410519	.	C	T	2	2	4	0	0	4	0	0
12	37410546	.	T	C	1	0	1	0	3	4	0	0
12	37410966	.	T	C	2	2	4	0	0	4	0	0
12	37411041	.	T	C	1	0	1	0	3	4	0	0
12	37449270	.	C	A	1	3	4	0	0	4	0	0
12	37449271	.	T	A	1	3	4	0	0	4	0	0
12	37463606	.	T	C	9	2	11	0	7	18	0	0
12	37490224	.	G	T	4	3	7	0	1	8	0	0
12	37497149	.	G	A	6	2	8	0	0	8	0	0
12	37503881	.	G	A	5	5	10	0	0	10	0	0
12	37515112	.	T	C	2	0	2	0	4	6	0	0
12	37530784	.	G	A	3	3	6	0	1	7	0	0
12	37531008	.	G	A	3	1	4	0	0	4	0	0
12	37531014	.	A	G	3	1	4	0	1	5	0	0
12	38561258	.	C	A	10	10	20	0	4	24	0	0
12	38676664	.	C	T	3	2	5	0	0	5	0	0
12	38677076	.	C	T	2	4	6	0	0	6	0	0
12	38687957	.	G	T	4	2	6	0	0	6	0	0
12	38782119	.	A	T	1	3	4	0	2	6	0	0
12	38787630	.	G	A	3	2	5	0	0	5	0	0
12	38796212	.	A	G	2	0	2	0	2	4	0	0
12	38799627	.	C	T	2	3	5	0	0	5	0	0
12	38799678	.	C	G	4	4	8	0	0	8	0	0
12	38799732	.	G	A	5	5	10	0	1	11	0	0
12	38799759	.	C	T	3	3	6	0	0	6	0	0
12	38799822	.	A	C	5	6	11	0	0	11	0	0
12	38802875	.	T	C	6	6	12	0	1	13	0	0
12	38803148	.	T	A	2	3	5	0	0	5	0	0
12	38803411	.	A	G	5	0	5	0	8	13	0	0
12	38803633	.	C	T	1	6	7	0	1	8	0	0
12	38803649	.	G	C	1	3	4	0	2	6	0	0
12	38803747	.	T	A	1	3	4	3	0	7	0	0
12	38804305	.	A	G	3	5	8	0	2	10	0	0
12	38804314	.	C	T	5	5	10	0	0	10	0	0
12	38804350	.	G	A	6	5	11	0	0	11	0	0
12	38804466	.	G	A	3	7	10	0	0	10	0	0
12	38804538	.	A	C	2	6	8	0	1	9	0	0
12	38828655	.	C	A	2	2	4	0	0	4	0	0
12	38847925	.	C	T	1	4	5	0	0	5	0	0
12	38849546	.	C	A	3	4	7	0	1	8	0	0
12	38850285	.	T	A	2	3	5	0	1	6	0	0
12	38850889	.	C	T	4	4	8	0	0	8	0	0
12	38854919	.	G	T	1	3	4	0	7	11	0	0
12	38855015	.	A	T	1	4	5	0	0	5	0	0
12	38855049	.	G	A	0	5	5	0	5	10	0	0
12	38855255	.	T	C	6	4	10	0	1	11	0	0
12	38855344	.	G	A	0	6	6	0	12	18	0	0
12	38855596	.	T	G	5	0	5	0	9	14	0	0
12	38855601	.	G	A	8	4	12	0	0	12	0	0
12	39744954	.	G	C	1	8	9	0	6	15	0	0
12	40398718	.	C	T	0	2	2	0	1	3	0	0
12	40497143	.	T	C	1	2	3	0	0	3	0	0
12	40518043	.	T	C	12	14	26	0	0	26	0	0
12	40518088	.	C	T	11	10	21	0	1	22	0	0
12	40518094	.	T	C	11	9	20	0	0	20	0	0
12	40905599	.	G	A	0	4	4	0	6	10	0	0
12	40945980	.	C	T	8	5	13	0	0	13	0	0
12	41000900	.	G	A	0	9	9	0	2	11	0	0
12	41000969	.	A	G	3	1	4	1	5	10	0	0
12	41000993	.	A	C	3	4	7	1	0	8	0	0
12	41028550	.	A	G	7	6	13	0	0	13	0	0
12	41028626	.	G	A	2	7	9	0	9	18	0	0
12	41037024	.	A	C	11	13	24	0	1	25	0	0
12	41071775	.	T	C	11	12	23	0	0	23	0	0
12	41071841	.	T	C	12	7	19	0	1	20	0	0
12	41112962	.	C	T	13	6	19	0	0	19	0	0
12	41113007	.	T	C	12	9	21	0	0	21	0	0
12	41113040	.	G	A	9	15	24	0	0	24	0	0
12	41113049	.	C	A	16	10	26	0	0	26	0	0
12	41113313	.	A	T	8	14	22	0	4	26	0	0
12	41113489	.	G	T	3	7	10	0	6	16	0	0
12	41437046	.	G	A	8	13	21	0	1	22	0	0
12	41449931	.	C	T	9	10	19	0	1	20	0	0
12	41455861	.	T	C	4	6	10	0	0	10	0	0
12	41458264	.	G	A	4	4	8	0	0	8	0	0
12	41461321	.	A	T	7	8	15	0	1	16	0	0
12	41530095	.	T	C	2	8	10	0	0	10	0	0
12	41530191	.	C	T	6	4	10	0	0	10	0	0
12	41535844	.	C	T	6	11	17	0	0	17	0	0
12	41535886	.	A	C	12	7	19	0	1	20	0	0
12	41535898	.	C	T	11	7	18	0	0	18	0	0
12	41535937	.	T	A	7	11	18	0	0	18	0	0
12	41539161	.	C	T	12	9	21	0	0	21	0	0
12	41541259	.	C	T	14	10	24	0	1	25	0	0
12	41547505	.	A	G	7	14	21	0	2	23	0	0
12	41549214	.	G	A	1	14	15	0	14	29	0	0
12	41549404	.	C	G	17	14	31	0	1	32	0	0
12	41549413	.	G	T	15	18	33	0	0	33	0	0
12	41549476	.	T	C	18	16	34	0	0	34	0	0
12	41581092	.	A	G	5	5	10	0	1	11	0	0
12	41581257	.	A	T	14	5	19	1	1	21	0	0
12	41593093	.	T	A	6	8	14	0	1	15	0	0
12	41606683	.	T	C	2	0	2	0	4	6	0	0
12	41606686	.	G	T	2	4	6	0	0	6	0	0
12	41612061	.	A	G	6	8	14	0	1	15	0	0
12	41631703	.	A	T	7	4	11	0	0	11	0	0
12	41632117	.	A	G	17	31	48	0	0	48	0	0
12	41633644	.	C	A	3	24	27	0	12	39	0	0
12	41636655	.	C	T	21	5	26	0	3	29	0	0
12	41636658	.	G	T	22	6	28	0	0	28	0	0
12	41643177	.	T	A	5	20	25	0	1	26	0	0
12	41643178	.	C	T	5	21	26	0	0	26	0	0
12	41643214	.	C	T	6	18	24	0	2	26	0	0
12	41643217	.	G	A	8	17	25	0	2	27	0	0
12	41647273	.	T	C	8	12	20	0	2	22	0	0
12	41647312	.	C	T	5	10	15	0	3	18	0	0
12	41653151	.	G	A	11	9	20	1	1	22	0	0
12	41656554	.	G	A	7	11	18	0	0	18	0	0
12	41661349	.	C	T	4	2	6	0	0	6	0	0
12	41684634	.	G	A	6	12	18	0	1	19	0	0
12	41698056	.	G	A	17	16	33	0	1	34	0	0
12	41702044	.	A	C	27	17	44	0	4	48	0	0
12	41723148	.	T	A	9	9	18	0	0	18	0	0
12	41723189	.	G	A	8	2	10	0	1	11	0	0
12	41723310	.	C	T	0	14	14	0	6	20	0	0
12	41723457	.	G	A	11	9	20	0	1	21	0	0
12	41723477	.	C	T	5	7	12	0	2	14	0	0
12	41723608	.	T	A	9	16	25	0	0	25	0	0
12	41723747	.	C	T	14	13	27	0	0	27	0	0
12	41731908	.	G	A	8	11	19	0	0	19	0	0
12	41735790	.	T	C	3	9	12	0	2	14	0	0
12	41739297	.	G	T	7	6	13	0	1	14	0	0
12	41739345	.	C	G	1	10	11	0	7	18	0	0
12	41759621	.	A	C	12	0	12	0	16	28	0	0
12	41759669	.	C	T	1	6	7	0	12	19	0	0
12	41991744	.	T	G	1	5	6	0	0	6	0	0
12	41991796	.	A	C	4	2	6	0	0	6	0	0
12	41991797	.	C	T	4	2	6	0	0	6	0	0
12	41992005	.	A	C	1	5	6	1	0	7	0	0
12	41992094	.	G	A	4	2	6	0	0	6	0	0
12	41992971	.	A	T	2	5	7	0	2	9	0	0
12	42007693	.	A	G	7	0	7	0	5	12	0	0
12	42153216	.	A	G	9	3	12	1	0	13	0	0
12	42182963	.	G	A	5	5	10	0	0	10	0	0
12	42186478	.	A	G	16	7	23	0	0	23	0	0
12	42195697	.	A	T	8	11	19	0	0	19	0	0
12	42196571	.	T	A	3	5	8	0	0	8	0	0
12	42196924	.	A	G	6	4	10	0	0	10	0	0
12	42196933	.	T	G	5	6	11	0	0	11	0	0
12	42364556	.	G	C	2	0	2	0	2	4	0	0
12	42364840	.	G	T	2	2	4	0	0	4	0	0
12	42365061	.	G	A	1	2	3	0	0	3	0	0
12	42366016	.	G	A	1	2	3	0	0	3	0	0
12	42366395	.	T	C	2	2	4	0	0	4	0	0
12	42366402	.	C	T	2	2	4	0	0	4	0	0
12	42369685	.	C	T	0	12	12	0	7	19	0	0
12	42369848	.	G	A	6	15	21	0	1	22	0	0
12	42369912	.	A	G	8	15	23	0	1	24	0	0
12	42384900	.	G	T	9	10	19	0	0	19	0	0
12	42384924	.	T	C	3	0	3	0	3	6	0	0
12	42396909	.	T	C	4	0	4	0	3	7	0	0
12	42404830	.	A	T	3	3	6	0	0	6	0	0
12	42406178	.	C	T	5	2	7	0	1	8	0	0
12	42406857	.	G	T	2	2	4	0	0	4	0	0
12	42406922	.	C	T	1	2	3	0	0	3	0	0
12	42576815	.	C	T	24	13	37	0	4	41	0	0
12	42577187	.	C	T	23	16	39	0	5	44	0	0
12	42578117	.	A	T	13	9	22	0	1	23	0	0
12	42578505	.	A	T	21	27	48	0	2	50	0	0
12	42578698	.	A	G	7	0	7	0	14	21	0	0
12	42578958	.	A	G	6	13	19	0	2	22	1	0
12	42578996	.	T	A	20	11	31	0	4	35	0	0
12	43376709	.	C	T	2	5	7	0	10	17	0	0
12	43376960	.	A	T	5	10	15	0	0	15	0	0
12	43377049	.	G	T	3	4	7	0	1	8	0	0
12	43377281	.	G	C	7	13	20	0	1	21	0	0
12	43377505	.	A	T	12	8	20	1	2	23	0	0
12	43377558	.	T	C	1	6	7	0	0	7	0	0
12	43384898	.	G	T	8	6	14	0	2	16	0	0
12	43384921	.	G	A	7	6	13	0	1	14	0	0
12	43395597	.	G	A	3	5	8	0	1	9	0	0
12	43395955	.	A	G	1	3	4	0	0	4	0	0
12	43415173	.	T	A	3	3	6	0	0	6	0	0
12	43426072	.	A	G	2	4	6	0	1	7	0	0
12	44368836	.	C	G	4	8	12	0	0	12	0	0
12	44372784	.	C	T	3	6	9	0	0	9	0	0
12	44378608	.	T	G	3	5	8	0	0	8	0	0
12	44416254	.	A	G	2	2	4	0	0	4	0	0
12	44416269	.	A	G	2	2	4	0	0	4	0	0
12	44611138	.	A	G	3	0	3	0	2	5	0	0
12	44611771	.	C	T	5	3	8	0	0	8	0	0
12	44611963	.	G	A	0	4	4	0	2	6	0	0
12	44635123	.	C	A	1	3	4	0	0	4	0	0
12	45216701	.	A	T	7	44	51	0	0	51	0	0
12	46608873	.	T	C	1	6	7	0	0	7	0	0
12	46835938	.	A	G	0	2	2	0	1	3	0	0
12	47282104	.	G	A	0	6	6	0	5	11	0	0
12	47283506	.	C	T	1	5	6	0	1	7	0	0
12	47283514	.	A	G	0	5	5	0	1	6	0	0
12	47283544	.	G	C	2	4	6	0	1	7	0	0
12	47291529	.	G	C	0	4	4	0	6	10	0	0
12	47291703	.	G	A	11	10	21	0	0	21	0	0
12	47295523	.	C	T	5	6	11	0	0	11	0	0
12	47295939	.	C	T	14	9	23	0	0	23	0	0
12	47302828	.	C	T	6	9	15	0	0	15	0	0
12	47302831	.	G	A	7	9	16	0	0	16	0	0
12	47331864	.	C	T	12	9	21	0	1	22	0	0
12	47332185	.	A	G	14	15	29	0	0	29	0	0
12	47332326	.	C	A	14	15	29	0	1	30	0	0
12	47332389	.	G	A	13	12	25	0	0	25	0	0
12	47332575	.	A	G	12	17	29	0	1	30	0	0
12	47332635	.	G	A	17	17	34	0	0	34	0	0
12	47332827	.	C	T	19	16	35	0	0	35	0	0
12	47335257	.	C	T	15	17	32	0	1	33	0	0
12	47335472	.	C	T	11	14	25	0	0	25	0	0
12	47344423	.	T	C	23	25	48	0	1	49	0	0
12	47347875	.	C	T	12	6	18	3	0	21	0	0
12	47355358	.	T	G	28	23	51	0	3	54	0	0
12	47448986	.	C	T	10	7	17	0	2	19	0	0
12	47449121	.	G	A	1	3	4	0	6	10	0	0
12	47449481	.	C	T	9	6	15	0	2	17	0	0
12	47449784	.	A	G	6	0	6	0	3	9	0	0
12	47449886	.	T	C	11	6	17	0	1	18	0	0
12	47449997	.	G	A	9	9	18	0	0	18	0	0
12	47461255	.	G	A	5	14	19	0	1	20	0	0
12	47469850	.	G	C	7	7	14	0	1	15	0	0
12	47480299	.	A	C	11	13	24	0	0	24	0	0
12	47480404	.	G	A	7	7	14	0	0	14	0	0
12	47480434	.	A	G	7	0	7	0	8	15	0	0
12	47480469	.	A	T	7	6	13	0	3	16	0	0
12	47480536	.	A	C	11	5	16	0	2	18	0	0
12	47480565	.	T	A	12	7	19	0	2	21	0	0
12	47480728	.	A	G	11	0	11	0	23	34	0	0
12	47480731	.	T	A	13	9	22	0	9	31	0	0
12	47481112	.	T	G	11	13	24	0	2	26	0	0
12	47481229	.	G	C	1	15	16	0	10	26	0	0
12	47481611	.	G	A	10	7	17	0	1	18	0	0
12	47505208	.	G	A	11	10	21	0	0	21	0	0
12	47523795	.	A	C	16	17	33	0	0	33	0	0
12	47540933	.	T	C	14	31	45	0	1	46	0	0
12	47540934	.	C	T	13	32	45	0	0	45	0	0
12	47540999	.	A	C	13	21	34	0	2	36	0	0
12	47541265	.	G	A	1	2	3	0	0	3	0	0
12	47544222	.	T	C	1	0	1	0	7	8	0	0
12	47589212	.	C	T	1	3	4	0	4	8	0	0
12	47862041	.	C	T	4	4	8	0	0	8	0	0
12	47862047	.	T	C	4	4	8	0	0	8	0	0
12	47918804	.	G	A	1	3	4	0	0	4	0	0
12	47919665	.	C	T	8	3	11	0	1	12	0	0
12	47922396	.	C	T	3	10	13	0	0	13	0	0
12	47922414	.	G	A	6	7	13	0	1	14	0	0
12	48118165	.	G	A	2	3	5	0	0	5	0	0
12	48118581	.	T	C	2	4	6	0	0	6	0	0
12	48118598	.	A	T	4	4	8	0	0	8	0	0
12	48118981	.	G	A	6	2	8	0	0	8	0	0
12	48119048	.	G	A	1	2	3	0	1	4	0	0
12	48119855	.	C	T	0	3	3	0	3	6	0	0
12	48120309	.	T	A	1	2	3	0	0	3	0	0
12	48121504	.	G	A	2	2	4	0	0	4	0	0
12	48122232	.	C	T	4	5	9	0	0	9	0	0
12	48137949	.	G	A	4	6	10	0	0	10	0	0
12	48138307	.	A	G	7	5	12	0	0	12	0	0
12	48143336	.	G	A	4	4	8	0	1	9	0	0
12	48143427	.	C	T	4	6	10	0	0	10	0	0
12	48146371	.	C	T	2	6	8	0	0	8	0	0
12	48146841	.	C	T	2	4	6	0	2	8	0	0
12	48146880	.	C	T	1	2	3	0	5	8	0	0
12	48157135	.	G	A	8	3	11	0	1	12	0	0
12	48161625	.	C	T	1	4	5	0	0	5	0	0
12	48162225	.	G	A	3	1	4	0	0	4	0	0
12	48162237	.	G	A	3	2	5	0	0	5	0	0
12	48168094	.	G	A	3	5	8	0	1	9	0	0
12	48211906	.	T	C	4	3	7	0	0	7	0	0
12	48216789	.	A	T	3	4	7	0	2	9	0	0
12	48220624	.	C	G	6	13	19	0	0	19	0	0
12	48228265	.	A	C	8	5	13	0	3	16	0	0
12	48231039	.	G	A	1	8	9	0	6	15	0	0
12	48231108	.	G	T	9	5	14	0	3	17	0	0
12	48239927	.	C	T	4	2	6	0	1	7	0	0
12	48240061	.	A	C	2	2	4	0	2	6	0	0
12	48312526	.	G	A	2	1	3	0	1	4	0	0
12	48312530	.	G	A	3	2	5	0	0	5	0	0
12	48319235	.	A	T	5	4	9	0	0	9	0	0
12	48327550	.	T	G	6	6	12	0	0	12	0	0
12	48340578	.	G	A	14	8	22	0	2	24	0	0
12	48341936	.	G	A	0	11	11	1	9	21	0	0
12	48346807	.	C	T	3	12	15	0	0	15	0	0
12	48349836	.	C	T	4	7	11	0	12	23	0	0
12	48367360	.	C	T	1	10	11	0	8	19	0	0
12	48367442	.	T	G	9	10	19	0	1	20	0	0
12	48419281	.	G	C	4	4	8	0	0	8	0	0
12	48419433	.	T	C	5	2	7	0	0	7	0	0
12	48419507	.	C	T	5	3	8	0	0	8	0	0
12	48419520	.	T	A	4	3	7	0	0	7	0	0
12	48419867	.	C	T	0	4	4	0	5	9	0	0
12	48432078	.	C	T	1	5	6	0	7	13	0	0
12	48432716	.	G	T	7	7	14	0	1	15	0	0
12	48436863	.	T	C	4	0	4	0	4	8	0	0
12	48440328	.	A	G	3	2	5	0	0	5	0	0
12	48440345	.	A	G	2	3	5	0	0	5	0	0
12	48469825	.	C	T	21	13	34	0	1	35	0	0
12	48476965	.	A	T	29	17	46	0	2	48	0	0
12	48476995	.	T	C	14	0	14	0	9	23	0	0
12	48480740	.	G	A	2	4	6	0	0	6	0	0
12	48525046	.	G	A	3	5	8	0	0	8	0	0
12	48528736	.	G	A	4	7	11	0	0	11	0	0
12	48529757	.	C	T	5	9	14	0	1	15	0	0
12	48532581	.	A	G	2	8	10	0	5	15	0	0
12	48623416	.	A	T	1	1	2	0	1	3	0	0
12	48626469	.	T	C	1	2	3	0	0	3	0	0
12	48680110	.	C	G	3	13	16	0	1	17	0	0
12	48680163	.	A	T	4	6	10	0	0	10	0	0
12	48681826	.	A	T	9	8	17	0	2	19	0	0
12	48681827	.	T	A	9	8	17	0	1	19	1	0
12	48682002	.	A	G	3	4	7	0	0	7	0	0
12	48682089	.	G	T	9	3	12	0	0	12	0	0
12	48682317	.	A	G	12	3	15	0	0	15	0	0
12	48682530	.	G	C	5	9	14	0	0	14	0	0
12	48682701	.	C	T	1	2	3	0	0	3	0	0
12	48682730	.	G	A	1	2	3	0	0	3	0	0
12	48789831	.	C	T	1	2	3	0	0	3	0	0
12	48792426	.	G	A	1	2	3	0	0	3	0	0
12	48796993	.	T	C	3	10	13	0	2	15	0	0
12	48799261	.	C	T	4	15	19	1	2	22	0	0
12	48800725	.	G	A	2	8	10	0	0	10	0	0
12	48803126	.	G	C	10	10	20	0	1	21	0	0
12	48804074	.	G	C	4	11	15	0	1	16	0	0
12	48810338	.	C	T	19	10	29	0	2	31	0	0
12	48810557	.	G	T	1	17	18	0	13	31	0	0
12	48810558	.	C	T	14	17	31	0	0	31	0	0
12	48810865	.	C	T	4	5	9	0	0	9	0	0
12	48811035	.	T	C	12	6	18	0	1	19	0	0
12	48816218	.	A	G	11	0	11	0	11	22	0	0
12	48826364	.	C	T	16	14	30	0	1	31	0	0
12	48826626	.	G	A	5	11	16	0	1	17	0	0
12	48828194	.	G	T	5	6	11	0	0	11	0	0
12	48828350	.	C	T	6	6	12	0	0	12	0	0
12	48828356	.	C	G	6	6	12	0	0	12	0	0
12	48828431	.	G	A	0	5	5	0	10	15	0	0
12	48828467	.	G	A	1	10	11	0	3	14	0	0
12	48829379	.	T	C	9	9	18	0	3	21	0	0
12	48829397	.	T	C	9	8	17	0	2	19	0	0
12	48832417	.	C	A	5	6	11	0	3	14	0	0
12	48833090	.	T	C	12	8	20	0	0	20	0	0
12	48833165	.	C	T	10	11	21	0	0	21	0	0
12	48836348	.	A	G	12	11	23	0	0	23	0	0
12	48836482	.	G	A	15	17	32	0	2	34	0	0
12	48864536	.	A	G	1	0	1	0	2	3	0	0
12	48871942	.	G	C	1	2	3	0	0	3	0	0
12	48873718	.	A	G	0	3	3	0	2	5	0	0
12	48881833	.	C	T	1	1	2	4	1	7	0	0
12	48902278	.	T	C	2	0	2	0	4	6	0	0
12	48943420	.	C	T	0	2	2	0	1	3	0	0
12	48959630	.	G	A	4	5	9	0	0	9	0	0
12	48974901	.	T	C	2	4	6	0	0	6	0	0
12	48979161	.	T	C	3	1	4	0	4	8	0	0
12	48979219	.	T	C	1	0	1	0	8	9	0	0
12	48979362	.	A	C	8	0	8	0	9	17	0	0
12	48979609	.	C	T	0	5	5	0	11	16	0	0
12	48979648	.	C	T	5	6	11	0	2	13	0	0
12	48982536	.	T	C	5	0	5	0	8	13	0	0
12	48982539	.	C	T	1	6	7	0	5	12	0	0
12	49004058	.	C	T	2	16	18	0	10	28	0	0
12	49004071	.	C	T	1	13	14	0	13	27	0	0
12	49005119	.	G	T	13	11	24	2	3	29	0	0
12	49005150	.	T	C	17	12	29	2	2	33	0	0
12	49010732	.	C	T	4	3	7	0	0	7	0	0
12	49034603	.	C	T	8	5	13	0	0	13	0	0
12	49035182	.	G	A	0	8	8	0	3	11	0	0
12	49035269	.	C	T	8	3	11	0	1	12	0	0
12	49037439	.	C	A	2	5	7	0	0	7	0	0
12	49037523	.	G	C	0	6	6	0	0	6	0	0
12	49037568	.	G	A	2	5	7	0	3	10	0	0
12	49038250	.	G	T	2	2	4	0	0	4	0	0
12	49114550	.	G	T	2	13	15	0	7	22	0	0
12	49125898	.	C	T	2	7	9	0	0	9	0	0
12	49125949	.	A	G	1	2	3	0	1	4	0	0
12	49148399	.	A	G	15	9	24	0	1	25	0	0
12	49149457	.	C	T	1	11	12	0	4	16	0	0
12	49149664	.	C	T	1	2	3	18	3	24	0	0
12	49158990	.	G	A	19	17	36	2	1	39	0	0
12	49159802	.	A	G	14	12	26	19	1	46	0	0
12	49160120	.	G	A	9	16	25	7	3	35	0	0
12	49161825	.	A	G	1	3	4	30	0	34	0	0
12	49161860	.	T	C	13	15	28	16	1	45	0	0
12	49166926	.	C	T	7	6	13	0	1	14	0	0
13	216407	.	T	C	2	0	2	0	13	15	0	0
13	343581	.	C	G	0	5	5	0	1	6	0	0
13	353406	.	T	C	2	2	4	0	0	4	0	0
13	462838	.	T	G	1	5	6	0	1	7	0	0
13	473551	.	A	G	4	2	6	0	0	6	0	0
13	808361	.	A	G	7	6	13	0	1	15	1	0
13	809779	.	A	G	13	6	19	0	1	20	0	0
13	1120353	.	C	T	1	2	3	1	0	43	39	0
13	1168824	.	G	A	1	4	5	0	1	6	0	0
13	2255417	.	A	G	3	2	5	0	0	5	0	0
13	2262104	.	G	A	4	3	7	0	0	7	0	0
13	2262128	.	C	A	3	3	6	0	0	6	0	0
13	2358026	.	A	T	8	8	16	0	0	16	0	0
13	2370556	.	G	T	0	7	7	0	5	12	0	0
13	2382376	.	A	G	3	0	3	0	7	10	0	0
13	2385782	.	G	T	4	10	14	0	4	18	0	0
13	2391803	.	A	G	23	0	23	0	11	34	0	0
13	2391818	.	A	G	21	14	35	0	1	36	0	0
13	2391948	.	G	A	3	14	17	0	13	30	0	0
13	2392397	.	G	A	11	3	14	0	2	16	0	0
13	2392434	.	G	A	5	5	10	0	1	11	0	0
13	2417235	.	C	T	6	4	10	2	0	12	0	0
13	2417251	.	C	T	6	3	9	3	1	13	0	0
13	2417331	.	A	T	2	2	4	0	0	4	0	0
13	2427251	.	T	A	3	5	8	0	0	8	0	0
13	2427255	.	G	T	3	4	7	0	0	7	0	0
13	2427331	.	T	C	5	2	7	0	0	7	0	0
13	2427569	.	T	C	16	2	18	0	15	33	0	0
13	2427702	.	T	C	24	5	29	0	27	56	0	0
13	2429080	.	C	A	25	20	45	0	4	49	0	0
13	2429300	.	A	G	15	24	39	0	0	39	0	0
13	2434335	.	G	T	26	14	40	0	1	41	0	0
13	2436227	.	T	A	18	18	36	0	2	38	0	0
13	2439886	.	C	T	16	24	40	0	2	42	0	0
13	2468007	.	G	C	1	1	2	0	1	3	0	0
13	2468013	.	C	T	1	2	3	0	0	3	0	0
13	2468112	.	G	A	4	2	6	0	0	6	0	0
13	2746311	.	A	C	6	8	14	0	0	14	0	0
13	2746350	.	A	G	9	0	9	0	6	15	0	0
13	2766946	.	A	G	3	0	3	0	4	7	0	0
13	2767003	.	T	C	5	2	7	0	0	7	0	0
13	2769810	.	T	C	10	8	18	0	1	19	0	0
13	2807099	.	A	C	6	6	12	0	1	13	0	0
13	2814352	.	G	A	5	8	13	0	1	14	0	0
13	2814421	.	T	C	21	7	28	0	3	31	0	0
13	2819432	.	C	T	14	13	27	0	0	27	0	0
13	2820601	.	C	G	11	0	11	0	14	25	0	0
13	2824513	.	T	C	17	17	34	0	0	34	0	0
13	2826324	.	A	G	21	0	21	0	19	40	0	0
13	2826397	.	T	C	15	12	27	0	1	28	0	0
13	2826445	.	G	C	3	7	10	0	13	23	0	0
13	2826473	.	T	A	19	10	29	0	0	29	0	0
13	2826790	.	C	T	20	4	24	1	1	26	0	0
13	2827560	.	A	C	15	10	25	0	1	26	0	0
13	2827578	.	C	A	11	13	24	0	0	24	0	0
13	2827605	.	G	T	14	16	30	0	1	31	0	0
13	2827700	.	G	C	19	22	41	0	1	42	0	0
13	2827808	.	A	G	29	8	37	0	1	38	0	0
13	2827867	.	A	G	17	18	35	1	4	40	0	0
13	2827918	.	A	T	9	9	18	1	1	20	0	0
13	2827998	.	G	A	18	17	35	0	0	35	0	0
13	2828028	.	T	C	18	16	34	0	3	37	0	0
13	2897475	.	T	A	2	5	7	0	0	7	0	0
13	2899483	.	G	A	7	5	12	0	0	12	0	0
13	2913844	.	T	C	9	8	17	0	3	20	0	0
13	2927778	.	G	A	9	13	22	0	0	22	0	0
13	2927832	.	T	A	8	11	19	0	4	23	0	0
13	3874815	.	T	C	5	1	6	0	2	8	0	0
13	3874831	.	T	C	4	4	8	0	1	9	0	0
13	3874903	.	C	A	1	2	3	0	3	6	0	0
13	3875113	.	C	G	1	2	3	0	0	3	0	0
13	3881204	.	T	C	1	3	4	0	0	4	0	0
13	3881208	.	G	T	1	2	3	0	1	4	0	0
13	3887163	.	A	G	2	0	2	0	8	10	0	0
13	3915333	.	A	G	8	4	12	0	0	12	0	0
13	3915383	.	C	A	5	5	10	0	3	13	0	0
13	3915476	.	A	C	13	14	27	0	1	28	0	0
13	3915644	.	A	C	19	6	25	0	1	26	0	0
13	3919353	.	T	G	7	14	21	0	2	23	0	0
13	3919632	.	A	G	11	13	24	0	2	26	0	0
13	3919672	.	T	G	11	12	23	0	1	24	0	0
13	3919686	.	G	A	10	11	21	0	0	21	0	0
13	3920727	.	A	G	5	6	11	0	1	12	0	0
13	3920759	.	C	T	1	4	5	0	11	16	0	0
13	3922791	.	T	C	9	4	13	0	1	14	0	0
13	3926166	.	C	T	7	3	10	0	0	10	0	0
13	3927916	.	T	C	4	4	8	0	0	8	0	0
13	3927931	.	T	C	6	5	11	0	0	11	0	0
13	3927975	.	T	A	4	4	8	0	0	8	0	0
13	3942055	.	G	A	0	7	7	0	12	19	0	0
13	3945643	.	C	T	14	8	22	0	0	22	0	0
13	3950007	.	G	A	11	11	22	0	0	24	2	0
13	3950044	.	A	G	12	15	27	0	0	27	0	0
13	3950307	.	A	G	6	9	15	0	2	17	0	0
13	3950577	.	C	G	12	13	25	0	0	25	0	0
13	3950669	.	T	A	9	6	15	0	2	17	0	0
13	3954695	.	G	T	7	6	13	0	1	14	0	0
13	3958913	.	A	G	8	4	12	0	0	12	0	0
13	3960979	.	A	C	5	3	8	0	1	9	0	0
13	3962569	.	C	T	7	3	10	0	1	11	0	0
13	3962812	.	T	C	2	5	7	0	0	7	0	0
13	3962853	.	A	G	7	0	7	0	5	12	0	0
13	3965910	.	T	C	16	7	23	0	2	25	0	0
13	3966055	.	T	A	8	7	15	0	1	16	0	0
13	3980349	.	C	T	1	7	8	0	5	13	0	0
13	3980947	.	T	C	18	0	18	0	11	29	0	0
13	3980962	.	G	A	17	7	24	0	0	24	0	0
13	3980993	.	C	T	1	9	10	0	15	25	0	0
13	3981471	.	A	G	1	3	4	0	0	4	0	0
13	3981579	.	G	T	3	10	13	0	0	13	0	0
13	3981738	.	T	G	2	3	5	0	0	5	0	0
13	3981808	.	T	C	2	7	9	0	0	9	0	0
13	3981832	.	T	A	1	6	7	0	1	8	0	0
13	3983205	.	A	T	2	2	4	0	1	5	0	0
13	4213477	.	C	A	5	3	8	0	0	8	0	0
13	4213594	.	G	T	3	1	4	0	1	5	0	0
13	4213598	.	C	T	4	2	6	0	0	6	0	0
13	4213861	.	T	C	13	13	26	0	3	29	0	0
13	4226678	.	C	A	20	12	32	0	1	33	0	0
13	4231368	.	G	T	1	18	19	0	20	39	0	0
13	4231396	.	C	T	20	19	39	0	0	39	0	0
13	4231438	.	T	A	8	19	27	0	1	28	0	0
13	4231787	.	A	G	9	9	18	0	1	19	0	0
13	4231819	.	G	A	13	9	22	0	0	22	0	0
13	4232014	.	T	A	6	9	15	0	1	17	1	0
13	4232016	.	G	A	0	10	10	0	8	18	0	0
13	4232054	.	A	T	14	4	18	0	0	18	0	0
13	4232112	.	A	G	14	11	25	0	1	26	0	0
13	4232171	.	C	T	13	20	33	0	0	33	0	0
13	4232396	.	G	A	33	2	35	0	3	38	0	0
13	4232737	.	A	G	15	12	27	0	0	27	0	0
13	4233030	.	C	T	1	20	21	0	16	37	0	0
13	4233033	.	G	A	20	16	36	0	1	37	0	0
13	4233361	.	G	T	12	14	26	0	0	26	0	0
13	4233365	.	G	A	15	9	24	0	0	24	0	0
13	4233625	.	T	A	10	9	19	0	0	19	0	0
13	4233779	.	G	A	18	11	29	0	1	30	0	0
13	4233889	.	G	A	11	8	19	0	1	20	0	0
13	4233911	.	G	C	16	8	24	0	2	26	0	0
13	4233970	.	A	G	15	10	25	0	0	25	0	0
13	4234139	.	A	T	12	9	21	2	0	23	0	0
13	4234337	.	G	A	13	11	24	0	1	25	0	0
13	4234349	.	G	T	9	11	20	0	2	22	0	0
13	4234402	.	A	T	13	7	20	0	1	21	0	0
13	4238449	.	T	C	9	4	13	0	5	18	0	0
13	4247007	.	G	A	9	6	15	0	0	15	0	0
13	4249120	.	T	C	3	3	6	0	0	6	0	0
13	4256617	.	A	G	7	6	13	0	0	14	1	0
13	4302690	.	A	T	8	5	13	0	0	13	0	0
13	4307782	.	C	T	16	10	26	0	1	27	0	0
13	4308714	.	C	A	15	11	26	0	1	27	0	0
13	4308948	.	C	T	13	10	23	0	1	24	0	0
13	4308983	.	G	C	9	1	10	0	16	26	0	0
13	4309166	.	T	G	11	13	24	0	2	26	0	0
13	4309607	.	T	C	17	6	23	0	1	24	0	0
13	4309746	.	A	G	7	12	19	0	1	20	0	0
13	4309778	.	T	A	8	10	18	0	2	20	0	0
13	4309866	.	T	C	10	6	16	0	0	16	0	0
13	4310247	.	G	A	9	13	22	0	0	22	0	0
13	4310349	.	T	A	14	10	24	0	5	29	0	0
13	4310367	.	C	G	0	19	19	0	16	35	0	0
13	4310511	.	C	T	1	12	13	0	31	44	0	0
13	4310565	.	G	A	21	13	34	0	1	35	0	0
13	4310610	.	C	T	15	19	34	0	0	34	0	0
13	4311114	.	A	G	8	10	18	0	2	20	0	0
13	4311912	.	C	T	11	7	18	0	1	19	0	0
13	4314226	.	T	G	10	3	13	0	0	13	0	0
13	4314227	.	C	T	10	3	13	0	0	13	0	0
13	4317721	.	T	C	4	7	11	0	0	11	0	0
13	4320781	.	G	C	2	5	7	0	1	8	0	0
13	4325371	.	T	C	4	3	7	0	0	7	0	0
13	4325443	.	C	G	4	2	6	0	0	6	0	0
13	4332851	.	T	G	0	1	1	0	2	3	0	0
13	4333087	.	T	G	5	2	7	0	0	7	0	0
13	4339638	.	T	C	5	0	5	0	15	20	0	0
13	4343183	.	C	T	0	4	4	0	9	13	0	0
13	4343437	.	C	T	1	8	9	0	16	25	0	0
13	4343468	.	T	A	16	8	24	0	2	26	0	0
13	4343490	.	G	A	16	6	22	0	0	22	0	0
13	4344159	.	C	G	5	3	8	0	0	8	0	0
13	4344378	.	A	T	6	8	14	0	0	14	0	0
13	4344938	.	T	C	7	6	13	0	0	13	0	0
13	4354649	.	T	C	1	0	1	0	2	3	0	0
13	4399171	.	A	G	1	2	3	0	0	3	0	0
13	4608140	.	C	T	5	2	7	0	0	7	0	0
13	4608482	.	C	T	6	3	9	0	0	9	0	0
13	4615130	.	G	T	4	6	10	0	0	10	0	0
13	4615169	.	T	C	9	5	14	0	0	14	0	0
13	4951747	.	T	C	13	15	28	0	1	29	0	0
13	4956118	.	G	A	12	12	24	0	3	27	0	0
13	4956151	.	C	T	13	16	29	0	0	29	0	0
13	4968421	.	A	G	21	16	37	0	1	38	0	0
13	4968583	.	T	A	15	11	26	0	0	26	0	0
13	4968849	.	A	G	11	11	22	0	5	27	0	0
13	4968890	.	T	C	22	14	36	0	0	36	0	0
13	4968905	.	T	C	19	19	38	0	1	39	0	0
13	4973701	.	T	A	9	4	13	2	0	15	0	0
13	4973775	.	C	A	7	5	12	0	1	13	0	0
13	4973856	.	C	T	0	8	8	0	3	11	0	0
13	4973979	.	A	G	7	7	14	0	0	14	0	0
13	4977950	.	C	T	1	9	10	0	12	22	0	0
13	4977962	.	A	G	11	11	22	0	1	23	0	0
13	4978620	.	G	A	11	9	20	0	2	22	0	0
13	4978680	.	A	G	12	13	25	0	1	26	0	0
13	4978821	.	T	C	17	0	17	0	12	29	0	0
13	4979150	.	C	T	11	5	16	0	1	17	0	0
13	4979163	.	A	T	10	4	14	0	0	14	0	0
13	4979190	.	T	C	8	4	12	0	1	13	0	0
13	4979550	.	A	G	16	7	23	0	1	24	0	0
13	4979754	.	A	G	9	9	18	0	0	18	0	0
13	4982091	.	C	T	1	3	4	0	5	9	0	0
13	4982336	.	T	C	3	3	6	0	0	6	0	0
13	4986361	.	C	T	1	5	6	0	0	6	0	0
13	4986386	.	A	G	1	4	5	0	0	5	0	0
13	4995638	.	G	T	3	16	19	0	13	32	0	0
13	4995902	.	A	G	20	7	27	0	1	28	0	0
13	4995916	.	T	A	15	9	24	0	1	25	0	0
13	5000490	.	G	A	4	7	11	0	13	24	0	0
13	5000606	.	G	A	3	3	6	0	0	6	0	0
13	5000615	.	T	A	2	3	5	0	0	5	0	0
13	5013813	.	T	C	10	14	24	0	2	26	0	0
13	5013999	.	A	G	14	7	21	1	2	24	0	0
13	5017657	.	A	G	20	19	39	0	0	39	0	0
13	5017699	.	G	A	18	16	34	0	3	37	0	0
13	5017866	.	T	C	20	17	37	0	2	39	0	0
13	5245583	.	T	C	1	2	3	0	1	4	0	0
13	5246065	.	T	C	2	2	4	0	0	4	0	0
13	5246241	.	G	A	1	3	4	0	1	5	0	0
13	5491234	.	G	A	27	25	52	0	0	52	0	0
13	5531709	.	A	G	24	24	48	0	0	48	0	0
13	5568993	.	G	A	8	13	21	0	2	23	0	0
13	5569344	.	C	T	5	7	12	0	2	14	0	0
13	5572367	.	C	T	4	2	6	0	1	7	0	0
13	5870703	.	C	G	3	2	5	0	0	5	0	0
13	5871321	.	G	A	3	3	6	0	0	6	0	0
13	5871340	.	G	C	3	2	5	0	0	5	0	0
13	5871445	.	G	A	1	1	2	0	1	3	0	0
13	5871757	.	C	G	2	3	5	0	1	6	0	0
13	5871834	.	C	T	0	3	3	0	2	5	0	0
13	5872300	.	G	A	1	2	3	0	0	3	0	0
13	5897408	.	G	A	3	2	5	0	0	5	0	0
13	5936945	.	T	G	2	7	9	0	0	10	1	0
13	5959654	.	T	C	7	6	13	0	0	13	0	0
13	5978865	.	T	C	3	5	8	0	0	8	0	0
13	6091985	.	T	C	3	2	5	0	0	5	0	0
13	6092064	.	G	A	3	3	6	0	0	6	0	0
13	6092065	.	A	C	4	3	7	0	0	7	0	0
13	6092108	.	C	G	4	4	8	0	0	8	0	0
13	6095996	.	A	C	4	4	8	0	0	8	0	0
13	6096001	.	T	C	5	4	9	0	0	9	0	0
13	6119843	.	A	G	3	4	7	0	0	7	0	0
13	6119865	.	C	T	4	5	9	0	0	9	0	0
13	6125154	.	T	C	3	6	9	0	0	9	0	0
13	6125207	.	A	T	3	3	6	0	2	8	0	0
13	6125217	.	G	A	0	5	5	0	4	9	0	0
13	6189925	.	T	G	3	0	3	0	6	9	0	0
13	6191523	.	C	A	6	5	11	0	0	11	0	0
13	6192433	.	C	A	8	7	15	0	0	15	0	0
13	6194867	.	T	A	5	10	15	0	1	16	0	0
13	6195043	.	T	G	10	0	10	0	8	18	0	0
13	6195055	.	A	T	5	7	12	0	1	13	0	0
13	6199336	.	G	A	0	6	6	0	5	11	0	0
13	6199375	.	T	C	5	3	8	0	1	9	0	0
13	6204583	.	G	A	14	6	20	0	1	21	0	0
13	6204957	.	T	C	8	9	17	1	2	20	0	0
13	6205311	.	G	A	8	3	11	0	1	12	0	0
13	6226012	.	G	C	4	4	8	0	0	8	0	0
13	6233482	.	A	C	5	2	7	0	0	7	0	0
13	6236772	.	G	A	4	12	16	0	0	16	0	0
13	6236796	.	C	T	14	5	19	0	0	19	0	0
13	6236901	.	G	A	8	5	13	0	0	13	0	0
13	6238204	.	G	A	9	8	17	0	1	18	0	0
13	6238466	.	T	C	16	14	30	0	2	32	0	0
13	6238658	.	G	T	3	16	19	0	6	25	0	0
13	6238883	.	A	G	12	10	22	0	1	23	0	0
13	6238972	.	G	A	10	4	14	0	2	16	0	0
13	6239091	.	A	T	6	7	13	0	1	14	0	0
13	6239112	.	A	G	8	4	12	0	0	12	0	0
13	6259813	.	C	T	0	2	2	0	2	4	0	0
13	6270984	.	C	T	6	3	9	0	0	9	0	0
13	6271263	.	C	T	6	2	8	0	0	8	0	0
13	6961186	.	A	G	2	3	5	0	0	5	0	0
13	7049325	.	A	T	2	2	4	0	0	4	0	0
13	7049337	.	C	T	3	2	5	0	0	5	0	0
13	7054454	.	G	A	4	3	7	0	0	7	0	0
13	7061380	.	C	T	1	3	4	0	0	4	0	0
13	7061687	.	G	A	2	2	4	0	3	7	0	0
13	7129881	.	C	T	1	2	3	0	0	3	0	0
13	7156984	.	A	G	2	0	2	0	3	5	0	0
13	7156987	.	A	G	3	0	3	0	3	6	0	0
13	7170250	.	C	T	2	3	5	0	0	5	0	0
13	7243048	.	G	A	0	5	5	0	4	9	0	0
13	7243397	.	T	C	4	3	7	0	0	7	0	0
13	7243431	.	A	G	3	5	8	0	1	9	0	0
13	7243484	.	C	T	2	15	17	0	0	17	0	0
13	7255659	.	T	C	12	6	18	1	1	20	0	0
13	7255664	.	G	A	11	6	17	1	1	19	0	0
13	7305556	.	C	T	2	3	5	0	0	5	0	0
13	7305568	.	T	A	2	3	5	0	0	5	0	0
13	7305601	.	G	A	0	3	3	0	2	5	0	0
13	7305625	.	T	A	1	3	4	0	1	5	0	0
13	7305637	.	T	A	1	4	5	0	0	5	0	0
13	7306994	.	T	A	4	5	9	0	0	9	0	0
13	7309392	.	C	T	2	7	9	0	1	10	0	0
13	7309710	.	A	G	3	6	9	0	0	9	0	0
13	7309721	.	T	C	4	4	8	0	1	9	0	0
13	7310386	.	C	A	2	4	6	0	0	6	0	0
13	7310428	.	G	A	1	2	3	0	0	3	0	0
13	7310628	.	A	C	2	2	4	0	0	4	0	0
13	7310986	.	C	T	2	3	5	0	0	5	0	0
13	7311218	.	A	G	4	4	8	0	1	9	0	0
13	7311324	.	T	G	7	4	11	0	1	12	0	0
13	7311420	.	C	A	8	2	10	0	2	12	0	0
13	7311476	.	C	T	6	6	12	0	0	12	0	0
13	7311849	.	C	T	4	2	6	0	0	6	0	0
13	7311986	.	A	C	7	8	15	0	0	15	0	0
13	7312015	.	T	A	6	11	17	0	0	17	0	0
13	7312170	.	C	T	5	3	8	0	0	8	0	0
13	7312201	.	T	A	8	5	13	0	0	13	0	0
13	7312225	.	G	C	8	6	14	0	0	14	0	0
13	7312323	.	A	T	3	3	6	0	0	6	0	0
13	7312325	.	G	A	4	3	7	0	0	7	0	0
13	7312527	.	G	A	1	6	7	0	8	15	0	0
13	7312585	.	T	C	11	5	16	0	0	16	0	0
13	7312713	.	T	A	8	4	12	0	1	13	0	0
13	7312991	.	T	C	12	10	22	0	1	23	0	0
13	7313020	.	G	A	2	9	11	0	8	19	0	0
13	7313066	.	T	G	9	8	17	0	1	18	0	0
13	7313185	.	T	C	6	7	13	0	0	13	0	0
13	7313304	.	A	G	7	9	16	0	0	16	0	0
13	7313324	.	T	A	10	6	16	0	1	17	0	0
13	7313436	.	T	C	4	4	8	0	0	8	0	0
13	7313546	.	A	G	6	6	12	0	0	12	0	0
13	7313613	.	C	T	6	13	19	0	0	19	0	0
13	7313641	.	C	A	11	13	24	0	0	24	0	0
13	7313703	.	C	T	12	16	28	0	1	29	0	0
13	7313827	.	C	T	11	9	20	0	0	20	0	0
13	7314049	.	T	C	11	8	19	0	0	19	0	0
13	7314222	.	A	T	10	10	20	0	0	20	0	0
13	7314300	.	T	C	10	12	22	0	1	23	0	0
13	7314567	.	C	A	12	11	23	0	1	24	0	0
13	7314568	.	T	G	12	11	23	0	1	24	0	0
13	7314736	.	A	C	24	8	32	0	0	32	0	0
13	7315123	.	C	T	20	15	35	0	0	35	0	0
13	7315174	.	C	A	21	13	34	0	2	36	0	0
13	7315197	.	A	G	25	0	25	0	9	34	0	0
13	7315234	.	A	G	26	11	37	0	0	37	0	0
13	7315597	.	A	G	18	1	19	0	11	30	0	0
13	7316042	.	C	A	14	11	25	0	1	26	0	0
13	7316157	.	G	T	20	16	36	0	1	37	0	0
13	7316207	.	C	T	14	8	22	1	1	24	0	0
13	7316463	.	G	A	13	6	19	0	1	20	0	0
13	7316484	.	A	T	12	6	18	0	2	20	0	0
13	7316532	.	C	A	8	8	16	0	3	19	0	0
13	7316537	.	A	C	7	9	16	0	2	18	0	0
13	7316784	.	G	A	12	11	23	0	0	23	0	0
13	7316830	.	C	G	10	6	16	0	0	16	0	0
13	7322524	.	C	T	5	4	9	0	0	9	0	0
13	7340136	.	A	G	1	1	2	0	1	3	0	0
13	7340151	.	T	A	1	2	3	0	0	3	0	0
13	7340264	.	C	G	2	4	6	0	0	6	0	0
13	7340289	.	A	C	2	3	5	0	0	5	0	0
13	7340306	.	A	G	3	1	4	0	1	5	0	0
13	7346655	.	C	A	14	4	18	2	0	20	0	0
13	7346683	.	A	G	20	9	29	1	0	30	0	0
13	7346798	.	A	G	20	13	33	0	2	35	0	0
13	7347026	.	A	G	13	13	26	0	3	29	0	0
13	7347060	.	G	T	8	13	21	0	0	21	0	0
13	7347061	.	A	T	8	13	21	0	0	21	0	0
13	7347125	.	G	A	9	4	13	0	2	15	0	0
13	7687786	.	T	C	1	3	4	0	0	4	0	0
13	7718996	.	A	G	1	2	3	0	0	3	0	0
13	7737020	.	G	A	0	2	2	0	6	8	0	0
13	7737101	.	G	A	1	4	5	0	2	7	0	0
13	7744319	.	A	G	9	7	16	0	0	16	0	0
13	7744443	.	G	A	13	13	26	0	1	27	0	0
13	7745463	.	C	G	7	6	13	0	5	18	0	0
13	7745544	.	C	T	11	5	16	0	0	16	0	0
13	7745814	.	C	A	7	5	12	0	0	12	0	0
13	7747299	.	A	G	1	2	3	0	0	3	0	0
13	7747338	.	A	G	4	0	4	0	3	7	0	0
13	7747513	.	C	G	5	3	8	0	2	10	0	0
13	7747738	.	T	C	9	11	20	0	0	20	0	0
13	7747760	.	T	C	10	12	22	0	0	22	0	0
13	7748021	.	G	T	14	6	20	0	1	21	0	0
13	7748424	.	T	C	8	6	14	0	0	14	0	0
13	7748497	.	T	G	7	3	10	0	1	11	0	0
13	7748533	.	T	G	11	8	19	0	4	23	0	0
13	7748794	.	G	A	0	13	13	0	14	27	0	0
13	7748882	.	A	T	15	11	26	0	0	26	0	0
13	7748995	.	T	A	10	6	16	0	2	18	0	0
13	7749000	.	G	C	10	8	18	0	0	18	0	0
13	7753123	.	T	C	3	1	4	0	4	8	0	0
13	7755764	.	A	C	21	1	22	0	28	50	0	0
13	7755875	.	T	C	24	0	24	0	21	45	0	0
13	7759403	.	T	C	18	26	44	0	0	44	0	0
13	7763810	.	A	G	23	19	42	0	1	43	0	0
13	7766936	.	C	T	2	14	16	0	14	30	0	0
13	7767013	.	C	T	4	2	6	0	0	6	0	0
13	8142558	.	A	G	3	3	6	0	0	6	0	0
13	8152771	.	T	C	2	2	4	0	1	5	0	0
13	8169457	.	G	T	1	3	4	0	0	4	0	0
13	8169785	.	A	T	1	2	3	0	0	3	0	0
13	8277667	.	A	G	1	3	4	0	0	4	0	0
13	8281717	.	C	G	4	2	6	0	0	6	0	0
13	8281828	.	G	A	2	3	5	0	0	5	0	0
13	8285256	.	T	A	2	6	8	0	1	9	0	0
13	8285430	.	G	A	3	2	5	0	0	5	0	0
13	8318090	.	C	A	1	2	3	0	0	3	0	0
13	8318141	.	T	C	1	2	3	0	0	3	0	0
13	8320852	.	C	G	5	2	7	0	0	7	0	0
13	8320855	.	C	G	6	1	7	0	0	7	0	0
13	8326274	.	T	C	2	13	15	0	0	15	0	0
13	8330568	.	G	A	2	6	8	0	1	9	0	0
13	8333864	.	G	A	4	3	7	0	0	7	0	0
13	8348077	.	T	A	2	2	4	0	0	4	0	0
13	8352188	.	A	C	1	0	1	0	3	4	0	0
13	8353124	.	T	C	3	3	6	0	0	6	0	0
13	8375857	.	T	C	5	1	6	0	7	13	0	0
13	8375932	.	A	T	16	15	31	0	2	33	0	0
13	8375935	.	C	A	16	15	31	0	3	34	0	0
13	8375981	.	A	G	24	17	41	0	3	44	0	0
13	8376064	.	A	G	17	11	28	0	2	30	0	0
13	8376077	.	C	G	20	11	31	0	0	31	0	0
13	8376184	.	C	T	7	8	15	0	1	16	0	0
13	8376187	.	G	A	7	10	17	0	0	17	0	0
13	8376301	.	A	T	9	6	15	0	0	15	0	0
13	8376317	.	T	A	11	7	18	0	0	18	0	0
13	8376355	.	C	T	11	4	15	0	0	15	0	0
13	8376613	.	T	G	6	7	13	0	0	13	0	0
13	8376675	.	C	A	0	4	4	0	7	11	0	0
13	8376845	.	A	G	9	6	15	0	0	15	0	0
13	8376882	.	C	T	1	5	6	0	9	15	0	0
13	8376896	.	T	C	7	5	12	0	0	12	0	0
13	8376972	.	G	A	2	5	7	0	1	8	0	0
13	8377056	.	A	T	1	2	3	0	0	3	0	0
13	8377058	.	A	G	1	2	3	0	0	3	0	0
13	8377327	.	A	G	4	2	6	0	0	6	0	0
13	8377334	.	A	G	4	2	6	0	0	6	0	0
13	8377767	.	C	G	1	2	3	0	0	3	0	0
13	8378280	.	C	T	0	4	4	0	1	5	0	0
13	8379079	.	A	C	4	0	4	0	6	10	0	0
13	8379096	.	T	G	4	5	9	0	1	10	0	0
13	8379119	.	C	T	3	4	7	0	1	8	0	0
13	8379171	.	A	T	2	4	6	0	0	6	0	0
13	8380477	.	T	C	4	2	6	0	0	6	0	0
13	8453571	.	T	A	2	4	6	0	0	6	0	0
13	8465007	.	G	T	1	2	3	0	0	3	0	0
13	8600487	.	T	C	1	1	2	0	3	5	0	0
13	8622084	.	A	G	1	3	4	0	1	5	0	0
13	8623517	.	A	C	1	5	6	0	0	6	0	0
13	8624658	.	T	C	1	4	5	0	0	5	0	0
13	8624659	.	G	T	1	4	5	0	0	5	0	0
13	8625102	.	T	C	3	3	6	0	0	6	0	0
13	8625106	.	T	A	3	3	6	0	0	6	0	0
13	8625167	.	T	C	5	5	10	0	3	13	0	0
13	8625210	.	C	G	5	4	9	0	0	9	0	0
13	8625247	.	T	C	1	2	3	0	0	3	0	0
13	8625973	.	A	T	2	2	4	0	0	4	0	0
13	8625980	.	C	G	2	2	4	0	0	4	0	0
13	8626628	.	A	T	2	5	7	1	2	10	0	0
13	8626645	.	T	A	3	5	8	0	0	8	0	0
13	8626699	.	C	T	4	6	10	0	0	10	0	0
13	8626841	.	C	T	7	6	13	0	0	13	0	0
13	8627056	.	T	C	5	6	11	0	0	11	0	0
13	8627178	.	T	A	3	6	9	0	0	9	0	0
13	8627179	.	A	T	3	6	9	0	0	9	0	0
13	8627222	.	C	T	2	5	7	0	0	7	0	0
13	8627302	.	C	A	7	3	10	0	0	10	0	0
13	8627445	.	A	G	3	3	6	0	0	6	0	0
13	8627521	.	G	A	0	3	3	0	5	8	0	0
13	8627532	.	G	A	3	5	8	0	0	8	0	0
13	8627586	.	G	T	2	4	6	0	0	6	0	0
13	8627634	.	T	A	9	7	16	0	0	16	0	0
13	8627748	.	T	C	5	4	9	0	0	9	0	0
13	8627819	.	T	C	3	4	7	0	0	7	0	0
13	8627947	.	C	T	2	2	4	0	0	4	0	0
13	8683753	.	A	C	1	2	3	0	0	3	0	0
13	8684134	.	A	G	2	4	6	0	1	7	0	0
13	8684175	.	C	T	4	4	8	0	0	8	0	0
13	8684608	.	G	A	3	6	9	0	0	9	0	0
13	8684705	.	A	G	8	6	14	0	0	14	0	0
13	8685051	.	C	T	0	10	10	0	7	17	0	0
13	8685176	.	C	T	1	2	3	0	1	4	0	0
13	8685278	.	C	A	4	4	8	0	1	9	0	0
13	8685417	.	G	A	9	6	15	0	0	15	0	0
13	8685496	.	A	T	6	10	16	0	2	18	0	0
13	8685542	.	G	A	4	9	13	0	1	14	0	0
13	8692306	.	C	T	6	7	13	0	0	13	0	0
13	8692395	.	A	G	8	9	17	0	0	17	0	0
13	8692776	.	T	G	10	13	23	0	0	23	0	0
13	8777701	.	G	A	21	8	29	0	2	31	0	0
13	8777724	.	T	C	17	11	28	0	0	28	0	0
13	8778490	.	G	A	34	31	65	0	1	66	0	0
13	8778501	.	G	T	35	31	66	0	2	68	0	0
13	8778548	.	G	A	45	25	70	0	4	74	0	0
13	8781118	.	T	A	4	1	5	0	0	5	0	0
13	8781119	.	A	T	2	2	4	0	1	5	0	0
13	8781222	.	T	C	2	10	12	0	0	12	0	0
13	8781577	.	A	G	32	33	65	0	3	68	0	0
13	8781786	.	C	T	31	30	61	0	4	65	0	0
13	8781789	.	A	C	32	30	62	0	3	65	0	0
13	8785294	.	C	G	21	14	35	0	1	36	0	0
13	8923996	.	G	T	1	2	3	0	0	3	0	0
13	8933559	.	T	C	2	2	4	0	0	4	0	0
13	8937373	.	G	A	1	2	3	0	0	3	0	0
13	8945365	.	C	T	4	2	6	0	1	7	0	0
13	8945646	.	T	G	4	2	6	0	0	6	0	0
13	8946981	.	T	C	2	2	4	0	0	4	0	0
13	8947046	.	G	A	2	3	5	0	0	5	0	0
13	8947095	.	C	T	3	5	8	0	0	8	0	0
13	8950686	.	G	A	5	3	8	0	0	8	0	0
13	8950783	.	C	G	5	3	8	0	0	8	0	0
13	8950795	.	C	A	2	4	6	0	0	6	0	0
13	9307202	.	C	T	1	13	14	0	11	25	0	0
13	9307646	.	T	C	17	10	27	0	2	29	0	0
13	9311011	.	G	T	12	10	22	0	2	24	0	0
13	9314040	.	T	A	47	27	74	0	2	76	0	0
13	9314104	.	C	T	1	34	35	0	31	66	0	0
13	9314322	.	G	A	35	38	73	0	0	73	0	0
13	9314340	.	C	T	38	43	81	0	0	81	0	0
13	9314532	.	T	C	31	3	34	0	39	74	1	0
13	9314657	.	C	T	36	35	71	0	2	73	0	0
13	9314680	.	G	A	36	42	78	0	2	80	0	0
13	9314800	.	T	C	35	49	84	0	1	85	0	0
13	9314935	.	G	A	34	42	76	0	7	83	0	0
13	9315004	.	C	T	30	51	81	0	4	85	0	0
13	9315019	.	T	C	28	53	81	0	1	82	0	0
13	9315178	.	T	C	44	29	73	0	1	74	0	0
13	9315192	.	T	C	32	42	74	0	3	77	0	0
13	9315321	.	G	T	44	51	95	0	0	95	0	0
13	9317915	.	T	C	44	35	79	0	2	81	0	0
13	9318491	.	G	C	41	47	88	0	0	88	0	0
13	9318638	.	G	C	32	1	33	0	37	70	0	0
13	9318644	.	T	C	30	35	65	0	4	69	0	0
13	9318682	.	T	C	18	2	20	0	51	71	0	0
13	9318699	.	A	T	28	39	67	0	6	73	0	0
13	9340093	.	C	T	0	8	8	0	7	15	0	0
13	9340199	.	T	C	5	8	13	0	0	13	0	0
13	9340527	.	C	T	14	7	21	2	1	24	0	0
13	9340609	.	C	A	0	8	8	0	7	15	0	0
13	9340671	.	G	A	11	4	15	0	0	15	0	0
13	9343329	.	T	C	9	16	25	0	0	25	0	0
13	9344878	.	A	T	14	13	27	0	0	27	0	0
13	9345182	.	A	C	8	7	15	0	1	17	1	0
13	9351194	.	T	C	14	15	29	0	0	29	0	0
13	9358449	.	C	T	14	8	22	0	1	23	0	0
13	9361825	.	T	C	4	10	14	0	1	15	0	0
13	9362035	.	T	A	3	4	7	0	0	7	0	0
13	9367117	.	G	T	7	8	15	0	1	16	0	0
13	9367537	.	A	G	13	8	21	0	0	21	0	0
13	9367562	.	T	A	9	9	18	0	1	19	0	0
13	9367600	.	G	T	4	4	8	0	0	8	0	0
13	9374113	.	C	T	2	3	5	0	0	5	0	0
13	9374140	.	G	A	1	2	3	0	0	3	0	0
13	9374827	.	C	G	1	2	3	0	0	3	0	0
13	9655947	.	C	A	4	2	6	0	0	6	0	0
13	9655952	.	C	G	4	1	5	0	0	5	0	0
13	9656223	.	A	C	1	3	4	0	1	5	0	0
13	9656237	.	C	T	2	3	5	0	0	5	0	0
13	9760828	.	A	G	1	3	4	0	0	4	0	0
13	9828568	.	A	T	3	7	10	0	0	10	0	0
13	9828572	.	G	A	0	7	7	0	2	9	0	0
13	9828933	.	G	T	8	7	15	0	1	16	0	0
13	9829007	.	A	G	4	2	6	0	0	6	0	0
13	9829013	.	C	T	2	4	6	0	0	6	0	0
13	9829232	.	T	C	3	4	7	0	1	8	0	0
13	9829274	.	C	A	5	4	9	0	0	9	0	0
13	9829289	.	T	C	6	4	10	0	0	10	0	0
13	9829406	.	A	C	1	3	4	0	0	4	0	0
13	9829408	.	G	A	1	3	4	0	0	4	0	0
13	9829722	.	T	G	2	0	2	0	5	7	0	0
13	9829855	.	C	T	4	5	9	0	1	10	0	0
13	9830089	.	T	C	3	8	11	0	0	11	0	0
13	9830147	.	A	T	3	3	6	0	0	6	0	0
13	9830148	.	C	G	3	3	6	0	0	6	0	0
13	9830518	.	A	T	4	7	11	0	0	11	0	0
13	9830521	.	A	C	5	7	12	0	0	12	0	0
13	9830554	.	A	G	6	7	13	0	1	14	0	0
13	9830597	.	C	A	7	4	11	0	2	13	0	0
13	9830686	.	A	T	2	2	4	0	0	4	0	0
13	9831056	.	G	C	1	3	4	0	0	4	0	0
13	9831116	.	A	G	5	6	11	0	0	11	0	0
13	9839813	.	G	A	7	4	11	0	1	12	0	0
13	9840152	.	G	A	1	6	7	0	1	8	0	0
13	9841702	.	T	A	4	10	14	0	2	16	0	0
13	9844527	.	A	G	14	0	14	0	18	32	0	0
13	9844746	.	T	C	22	15	37	0	2	39	0	0
13	9855508	.	G	T	6	9	15	0	0	15	0	0
13	9855874	.	G	A	13	21	34	0	2	36	0	0
13	9856143	.	G	A	11	6	17	0	2	19	0	0
13	9856192	.	A	G	10	12	22	0	5	27	0	0
13	9856493	.	A	T	25	15	40	0	2	42	0	0
13	9856816	.	G	A	13	11	24	0	1	25	0	0
13	9866857	.	G	A	3	3	6	0	0	6	0	0
13	9952641	.	T	C	1	5	6	0	0	6	0	0
13	10004081	.	T	A	2	3	5	1	1	7	0	0
13	10004092	.	A	G	3	3	6	1	0	7	0	0
13	10004132	.	C	T	4	2	6	0	0	6	0	0
13	10895731	.	T	G	12	11	23	0	1	24	0	0
13	10906719	.	G	A	18	14	32	0	0	32	0	0
13	10906817	.	T	C	21	9	30	0	0	30	0	0
13	10910423	.	G	T	1	13	14	0	23	37	0	0
13	10922497	.	T	G	2	8	10	0	2	12	0	0
13	10922536	.	C	T	2	7	9	0	1	10	0	0
13	10922568	.	T	C	2	7	9	0	1	10	0	0
13	10922578	.	C	T	3	11	14	0	0	14	0	0
13	10922613	.	A	T	7	9	16	0	1	17	0	0
13	10922660	.	G	A	6	7	13	0	0	13	0	0
13	10970732	.	G	T	2	2	4	0	0	4	0	0
13	10975980	.	G	A	1	5	6	0	0	6	0	0
13	10978589	.	A	T	2	4	6	0	0	6	0	0
13	10981896	.	T	A	5	2	7	0	1	8	0	0
13	10982404	.	C	T	19	11	30	0	0	30	0	0
13	10982444	.	G	A	16	9	25	0	0	25	0	0
13	10982472	.	T	G	13	8	21	0	1	22	0	0
13	10982966	.	A	T	11	15	26	0	0	26	0	0
13	10983139	.	C	T	6	6	12	0	0	12	0	0
13	10983231	.	G	A	6	5	11	0	0	11	0	0
13	10983421	.	C	A	16	6	22	0	0	22	0	0
13	10983482	.	T	A	13	4	17	0	0	17	0	0
13	10983788	.	T	C	7	13	20	0	0	20	0	0
13	10983821	.	G	T	9	7	16	0	2	18	0	0
13	10984205	.	G	A	18	19	37	0	1	38	0	0
13	10990959	.	G	A	4	5	9	0	0	9	0	0
13	10990973	.	T	C	4	0	4	0	7	11	0	0
13	10994107	.	A	G	7	17	24	0	0	24	0	0
13	10997566	.	A	G	7	6	13	0	3	16	0	0
13	11002052	.	A	G	7	8	15	0	0	15	0	0
13	11002234	.	C	T	1	8	9	0	7	16	0	0
13	11002247	.	G	A	5	7	12	0	1	13	0	0
13	11002541	.	A	G	5	5	10	0	0	10	0	0
13	11002697	.	A	G	7	7	14	0	2	16	0	0
13	11002778	.	T	C	8	9	17	0	2	19	0	0
13	11002922	.	C	T	6	5	11	0	0	11	0	0
13	11002970	.	T	C	5	3	8	0	0	8	0	0
13	11003297	.	C	T	0	6	6	0	3	9	0	0
13	11007087	.	G	A	1	3	4	0	0	4	0	0
13	11012312	.	G	T	6	6	12	1	1	14	0	0
13	11012349	.	C	T	7	6	13	0	1	14	0	0
13	11012469	.	T	C	6	5	11	0	1	12	0	0
13	11020257	.	C	T	1	5	6	0	0	6	0	0
13	11029585	.	G	T	4	5	9	0	1	10	0	0
13	11035253	.	C	G	5	2	7	0	0	7	0	0
13	11035406	.	A	G	1	3	4	0	0	4	0	0
13	11035409	.	G	A	1	3	4	0	0	4	0	0
13	11077921	.	G	A	5	4	9	0	0	9	0	0
13	11086319	.	C	G	1	0	1	0	6	7	0	0
13	11119837	.	A	G	5	4	9	0	2	11	0	0
13	11166435	.	G	A	2	5	7	0	1	8	0	0
13	11166467	.	A	G	1	4	5	0	1	6	0	0
13	11166508	.	A	G	2	3	5	0	0	5	0	0
13	11166524	.	A	T	2	3	5	0	1	6	0	0
13	11175605	.	G	A	1	4	5	0	0	5	0	0
13	11184784	.	G	A	5	5	10	0	0	10	0	0
13	11233520	.	G	C	1	2	3	0	0	3	0	0
13	11441080	.	T	A	12	14	26	0	3	29	0	0
13	11442090	.	A	T	15	13	28	0	0	28	0	0
13	11443349	.	C	G	7	0	7	0	18	28	3	0
13	11443457	.	T	A	19	26	45	0	1	46	0	0
13	11443881	.	C	T	19	15	34	0	2	36	0	0
13	11444022	.	A	T	15	12	27	0	0	27	0	0
13	11444263	.	G	A	0	20	20	0	24	44	0	0
13	11444295	.	C	T	28	24	52	0	1	53	0	0
13	11444801	.	T	A	16	8	24	0	1	25	0	0
13	11489965	.	T	C	12	6	18	0	1	19	0	0
13	11489999	.	C	A	13	10	23	0	1	24	0	0
13	11490035	.	A	G	15	8	23	0	1	24	0	0
13	11490084	.	G	A	8	5	13	0	2	15	0	0
13	11490300	.	G	T	3	4	7	0	0	7	0	0
13	11490626	.	G	A	7	6	13	1	0	14	0	0
13	11500299	.	T	C	10	1	11	0	6	17	0	0
13	11503682	.	G	A	4	3	7	0	0	7	0	0
13	11536901	.	T	A	5	7	12	0	0	12	0	0
13	11550734	.	G	T	0	5	5	0	7	12	0	0
13	11550741	.	T	C	7	4	11	0	0	11	0	0
13	11675148	.	G	A	7	4	11	0	0	11	0	0
13	11675185	.	A	G	8	2	10	0	0	10	0	0
13	11675343	.	C	G	4	7	11	1	0	12	0	0
13	11675378	.	T	C	3	6	9	0	0	9	0	0
13	11675464	.	A	G	2	3	5	0	0	5	0	0
13	11675584	.	C	T	6	4	10	0	0	10	0	0
13	11675855	.	T	G	4	6	10	0	0	10	0	0
13	11675912	.	A	T	7	6	13	0	0	13	0	0
13	11675951	.	G	A	6	5	11	0	0	11	0	0
13	11676330	.	A	G	3	2	5	0	0	5	0	0
13	11676337	.	G	A	4	2	6	0	0	6	0	0
13	11676403	.	C	T	4	5	9	0	0	9	0	0
13	11676472	.	A	G	4	2	6	0	1	7	0	0
13	11676639	.	G	A	2	2	4	0	0	4	0	0
13	11677606	.	A	G	1	3	4	0	0	4	0	0
13	11678485	.	T	C	3	0	3	0	2	5	0	0
13	11746459	.	C	A	19	16	35	0	0	35	0	0
13	11751402	.	G	A	13	11	24	0	1	25	0	0
13	11767651	.	T	C	7	3	10	0	0	10	0	0
13	11767768	.	A	G	7	3	10	0	1	11	0	0
13	11775095	.	G	A	1	6	7	0	1	8	0	0
13	11781751	.	C	T	0	4	4	0	3	7	0	0
13	11781769	.	A	G	2	2	4	0	0	4	0	0
13	11829109	.	C	A	1	4	5	0	0	5	0	0
13	11829112	.	T	A	1	3	4	0	1	5	0	0
13	11829158	.	T	A	5	4	9	0	1	10	0	0
13	11836187	.	C	T	1	2	3	0	0	3	0	0
13	11852302	.	C	T	2	2	4	0	0	4	0	0
13	11860525	.	T	C	3	5	8	0	0	8	0	0
13	11868812	.	A	G	3	2	5	0	1	6	0	0
13	11869049	.	G	T	9	4	13	0	2	15	0	0
13	11869127	.	C	T	7	5	12	0	1	13	0	0
13	11869143	.	T	C	8	5	13	0	0	13	0	0
13	11869219	.	G	T	2	3	5	0	0	5	0	0
13	11869220	.	G	T	2	3	5	0	0	5	0	0
13	11869357	.	G	T	3	5	8	0	0	8	0	0
13	11869539	.	T	C	2	3	5	0	1	6	0	0
13	11876698	.	T	G	3	3	6	0	1	7	0	0
13	11876841	.	G	A	3	4	7	0	1	8	0	0
13	11876850	.	G	A	3	5	8	0	0	8	0	0
13	11921417	.	C	T	9	3	12	0	0	12	0	0
13	11921432	.	G	A	9	2	11	0	0	11	0	0
13	11921543	.	T	C	3	4	7	0	0	7	0	0
13	11923834	.	G	C	6	9	15	0	1	16	0	0
13	11926692	.	C	G	10	7	17	0	1	18	0	0
13	11927341	.	C	G	13	12	25	0	1	26	0	0
13	11927347	.	T	A	11	11	22	0	2	24	0	0
13	11927491	.	T	C	7	8	15	0	0	15	0	0
13	11927603	.	A	G	4	7	11	0	0	11	0	0
13	11927735	.	T	C	6	4	10	0	0	10	0	0
13	11927829	.	A	T	4	11	15	0	3	18	0	0
13	11927830	.	T	G	7	10	17	0	1	18	0	0
13	11967334	.	T	A	1	2	3	0	0	10	7	0
13	11977394	.	A	T	1	7	8	0	0	8	0	0
13	11984768	.	A	C	7	10	17	0	0	17	0	0
13	11989171	.	G	C	2	3	5	0	8	14	1	0
13	11989357	.	T	C	17	19	36	0	4	40	0	0
13	11989468	.	A	C	19	12	31	0	1	32	0	0
13	11989554	.	A	G	18	25	43	0	1	44	0	0
13	11989629	.	C	T	19	18	37	0	1	39	1	0
13	11989633	.	T	C	21	19	40	0	0	40	0	0
13	11989698	.	C	T	19	22	41	0	1	42	0	0
13	11990118	.	G	A	21	8	29	0	3	32	0	0
13	11990175	.	T	C	20	1	21	0	14	35	0	0
13	11990294	.	A	G	15	13	28	0	4	32	0	0
13	11990329	.	T	G	18	18	36	0	1	37	0	0
13	11990389	.	G	T	20	15	35	0	3	38	0	0
13	11993451	.	A	T	19	15	34	0	0	34	0	0
13	12000699	.	T	C	7	4	11	0	0	11	0	0
13	12000700	.	G	C	7	4	11	0	0	11	0	0
13	12000906	.	T	A	9	6	15	0	0	15	0	0
13	12001110	.	T	C	8	4	12	0	0	12	0	0
13	12001254	.	A	G	9	3	12	0	1	13	0	0
13	12003230	.	A	G	5	2	7	0	0	7	0	0
13	12003905	.	T	C	2	0	2	0	2	4	0	0
13	12005859	.	T	A	4	4	8	0	0	8	0	0
13	12010610	.	G	A	1	2	3	0	0	3	0	0
13	12012634	.	T	C	2	2	4	0	0	4	0	0
13	12087528	.	G	A	1	14	15	0	20	35	0	0
13	12088223	.	C	G	24	11	35	0	0	35	0	0
13	12088255	.	A	G	20	5	25	0	2	27	0	0
13	12088327	.	A	G	15	11	26	0	2	28	0	0
13	12088406	.	T	C	12	9	21	0	2	23	0	0
13	12088795	.	T	C	2	5	7	0	0	7	0	0
13	12141929	.	A	G	1	2	3	0	0	3	0	0
13	12142001	.	G	A	4	3	7	0	1	8	0	0
13	12142007	.	T	C	6	3	9	0	0	9	0	0
13	12150892	.	C	T	3	4	7	0	0	7	0	0
13	12201923	.	C	G	2	3	5	0	1	6	0	0
13	12202096	.	A	T	1	1	2	0	1	3	0	0
13	12207170	.	A	T	8	8	16	0	0	16	0	0
13	12207583	.	G	T	9	4	13	0	0	13	0	0
13	12207591	.	A	T	9	5	14	0	0	14	0	0
13	12207656	.	C	T	4	3	7	0	0	7	0	0
13	12370737	.	T	A	2	4	6	0	0	6	0	0
13	12371184	.	T	C	2	2	4	0	0	4	0	0
13	12371541	.	T	C	4	2	6	0	0	6	0	0
13	12371559	.	A	G	2	0	2	0	3	5	0	0
13	12372247	.	T	C	4	2	6	0	0	6	0	0
13	12372501	.	C	A	6	8	14	0	1	15	0	0
13	12372552	.	C	A	4	5	9	0	3	12	0	0
13	12372596	.	C	G	5	7	12	0	1	13	0	0
13	12372609	.	C	G	4	5	9	0	1	10	0	0
13	12373059	.	T	C	10	5	15	0	0	15	0	0
13	12373093	.	A	T	9	6	15	0	1	16	0	0
13	12373126	.	T	G	5	7	12	0	0	12	0	0
13	12373153	.	T	C	3	2	5	0	0	5	0	0
13	12373262	.	C	T	4	8	12	0	0	12	0	0
13	12373274	.	A	T	3	7	10	0	1	11	0	0
13	12373430	.	T	A	9	7	16	2	0	18	0	0
13	12373460	.	A	G	13	7	20	0	0	20	0	0
13	12373572	.	C	T	3	5	8	0	1	9	0	0
13	12373679	.	T	C	8	4	12	0	0	12	0	0
13	12374414	.	A	G	3	13	16	0	0	16	0	0
13	12374585	.	T	G	3	4	7	0	0	7	0	0
13	12374710	.	A	G	8	0	8	0	6	14	0	0
13	12374771	.	A	G	9	5	14	0	0	14	0	0
13	12374775	.	T	G	9	6	15	0	0	15	0	0
13	12374901	.	C	A	9	5	14	0	0	14	0	0
13	12374910	.	G	A	2	5	7	0	8	15	0	0
13	12374954	.	A	C	8	5	13	0	1	14	0	0
13	12375198	.	A	G	16	12	28	0	0	28	0	0
13	12375348	.	C	A	5	6	11	0	0	11	0	0
13	12375389	.	A	G	4	10	14	0	0	14	0	0
13	12378315	.	T	A	8	6	14	0	0	14	0	0
13	12378356	.	T	G	9	10	19	0	1	20	0	0
13	12378407	.	T	C	8	9	17	0	0	17	0	0
13	12385182	.	A	G	5	11	16	0	1	17	0	0
13	12385538	.	G	T	8	14	22	0	0	22	0	0
13	12387658	.	G	A	8	13	21	0	2	23	0	0
13	12419787	.	C	T	3	2	5	0	0	5	0	0
13	12426645	.	C	G	4	3	7	0	0	7	0	0
13	12443656	.	C	T	3	2	5	0	0	5	0	0
13	12443951	.	C	T	2	4	6	0	0	6	0	0
13	12444014	.	T	C	3	3	6	0	0	6	0	0
13	12447952	.	T	C	4	5	9	0	0	9	0	0
13	12447961	.	A	C	5	4	9	0	0	9	0	0
13	12479382	.	C	A	7	4	11	0	0	11	0	0
13	12479490	.	G	A	10	17	27	0	1	28	0	0
13	12482650	.	A	C	11	10	21	0	0	21	0	0
13	12485035	.	G	A	11	13	24	0	0	25	1	0
13	12489232	.	G	A	2	6	8	0	1	9	0	0
13	12489360	.	A	G	3	9	12	0	1	13	0	0
13	12489553	.	T	A	4	5	9	0	0	9	0	0
13	12494069	.	C	T	3	2	5	0	0	5	0	0
13	12494400	.	T	C	2	0	2	0	4	6	0	0
13	12624860	.	C	T	9	7	16	0	0	16	0	0
13	12628901	.	C	T	21	12	33	0	1	34	0	0
13	12632260	.	A	G	13	0	13	0	14	27	0	0
13	12632946	.	T	A	6	5	11	0	0	11	0	0
13	12632967	.	T	C	6	4	10	0	0	10	0	0
13	12633014	.	C	G	5	4	9	0	1	10	0	0
13	12635858	.	T	A	2	3	5	0	0	5	0	0
13	12635862	.	C	A	3	2	5	0	0	5	0	0
13	12654880	.	T	A	6	2	8	0	0	8	0	0
13	12665126	.	A	G	5	6	11	1	1	13	0	0
13	12665227	.	C	A	2	5	7	0	1	8	0	0
13	12665328	.	C	A	2	5	7	0	0	7	0	0
13	12665546	.	T	C	5	6	11	0	0	11	0	0
13	12665587	.	C	T	1	12	13	0	8	21	0	0
13	12665678	.	T	A	6	4	10	0	2	12	0	0
13	12665704	.	T	C	4	7	11	0	0	11	0	0
13	12665863	.	C	T	0	3	3	0	6	9	0	0
13	12665945	.	A	C	2	8	10	0	0	10	0	0
13	12665963	.	A	G	2	7	9	0	0	9	0	0
13	12666038	.	G	A	3	6	9	0	0	9	0	0
13	12666182	.	C	T	0	5	5	0	6	11	0	0
13	12666362	.	A	G	7	5	12	0	1	13	0	0
13	12675939	.	A	G	1	5	6	0	0	6	0	0
13	12681150	.	T	C	4	6	10	0	0	10	0	0
13	12681188	.	C	A	4	5	9	0	0	9	0	0
13	12739630	.	C	G	3	0	3	0	3	6	0	0
13	12739939	.	C	T	3	3	6	0	1	7	0	0
13	12740092	.	G	T	1	6	7	0	6	13	0	0
13	12740129	.	C	T	9	6	15	0	0	15	0	0
13	12740236	.	A	G	8	10	18	0	1	19	0	0
13	12740263	.	T	G	7	1	8	0	11	19	0	0
13	12740674	.	G	A	6	7	13	0	4	17	0	0
13	12765738	.	T	G	5	10	15	0	0	15	0	0
13	12769323	.	T	C	3	4	7	0	0	7	0	0
13	12778142	.	T	C	3	2	5	0	0	5	0	0
13	12778170	.	T	C	3	2	5	0	0	5	0	0
13	12778247	.	T	G	3	6	9	0	0	9	0	0
13	12778653	.	A	C	4	2	6	0	1	7	0	0
13	12778731	.	G	T	5	7	12	0	0	12	0	0
13	12778733	.	C	A	5	7	12	0	0	12	0	0
13	12874309	.	A	T	1	2	3	0	0	3	0	0
13	12883634	.	C	T	3	3	6	0	0	6	0	0
13	12883652	.	C	T	4	2	6	0	0	6	0	0
13	12891860	.	A	G	1	5	6	0	0	6	0	0
13	12891881	.	A	G	2	5	7	0	0	7	0	0
13	12899310	.	G	C	2	2	4	0	0	4	0	0
13	12899383	.	C	T	3	2	5	0	0	5	0	0
13	12899413	.	A	C	1	4	5	0	0	5	0	0
13	12902958	.	C	T	4	4	8	0	1	9	0	0
13	12904675	.	G	C	5	4	9	0	0	9	0	0
13	12904726	.	G	A	4	8	12	0	2	14	0	0
13	12904840	.	C	A	4	2	6	0	0	6	0	0
13	12906773	.	T	C	2	3	5	0	0	5	0	0
13	12911146	.	A	C	3	3	6	0	1	7	0	0
13	12915909	.	T	C	5	4	9	0	0	9	0	0
13	12915927	.	A	T	8	4	12	0	0	12	0	0
13	12917364	.	G	C	3	4	7	0	2	9	0	0
13	12917424	.	G	A	4	5	9	0	1	10	0	0
13	12917427	.	T	C	4	4	8	0	1	9	0	0
13	12918227	.	G	C	2	3	5	0	0	5	0	0
13	12919196	.	C	T	4	4	8	0	0	8	0	0
13	12920645	.	A	C	3	2	5	0	0	5	0	0
13	12920651	.	A	T	5	4	9	0	0	9	0	0
13	12920837	.	T	C	9	4	13	0	0	13	0	0
13	12920924	.	C	T	6	4	10	0	0	10	0	0
13	12940084	.	C	T	4	4	8	0	0	8	0	0
13	12940138	.	C	T	8	6	14	0	0	14	0	0
13	12943630	.	G	A	4	9	13	0	0	13	0	0
13	12946108	.	G	A	7	4	11	0	1	12	0	0
13	12946267	.	T	A	4	0	4	0	2	6	0	0
13	12949644	.	A	G	3	0	3	0	6	9	0	0
13	12949674	.	T	G	5	4	9	0	0	9	0	0
13	12955278	.	T	C	6	8	14	0	1	15	0	0
13	12955335	.	C	T	5	5	10	0	0	10	0	0
13	12955377	.	C	T	6	8	14	0	0	14	0	0
13	12955549	.	C	T	7	12	19	0	0	19	0	0
13	12955615	.	T	C	9	6	15	0	0	15	0	0
13	12957817	.	G	A	10	11	21	0	2	23	0	0
13	12961141	.	C	T	17	8	25	0	5	30	0	0
13	12963052	.	C	T	12	13	25	0	1	26	0	0
13	12971757	.	A	C	11	14	25	0	0	25	0	0
13	12971763	.	A	G	11	1	12	0	14	26	0	0
13	12974602	.	A	G	20	23	43	0	0	43	0	0
13	12985253	.	G	A	2	16	18	0	20	38	0	0
13	12985291	.	G	A	21	15	36	0	3	39	0	0
13	12985539	.	T	C	17	17	34	0	0	34	0	0
13	12985540	.	A	G	18	0	18	0	17	35	0	0
13	12994364	.	A	G	8	9	17	0	0	17	0	0
13	12994395	.	A	G	8	7	15	0	0	15	0	0
13	12994738	.	A	T	14	7	21	0	0	21	0	0
13	12994801	.	A	G	9	13	22	0	1	23	0	0
13	12994802	.	G	T	9	13	22	0	1	23	0	0
13	12997845	.	C	T	8	6	14	0	0	14	0	0
13	12997966	.	A	G	6	4	10	0	0	10	0	0
13	13008910	.	C	T	3	2	5	0	0	5	0	0
13	13011804	.	A	G	2	2	4	0	0	4	0	0
13	13012030	.	G	C	2	2	4	0	0	4	0	0
13	13019277	.	C	G	3	2	5	0	0	5	0	0
13	13052481	.	A	C	4	5	9	0	1	10	0	0
13	13075034	.	T	C	2	3	5	0	0	5	0	0
13	13091046	.	C	A	7	5	12	0	0	12	0	0
13	13091079	.	T	C	7	8	15	0	0	15	0	0
13	13094050	.	T	A	4	6	10	0	0	10	0	0
13	13214412	.	G	A	13	11	24	0	4	28	0	0
13	13214462	.	T	A	12	14	26	0	2	28	0	0
13	13215426	.	T	G	1	2	3	0	1	4	0	0
13	13215664	.	T	C	8	2	10	0	0	10	0	0
13	13215675	.	T	C	3	4	7	0	2	9	0	0
13	13215937	.	A	G	4	3	7	0	3	10	0	0
13	13215942	.	G	A	5	4	9	0	0	9	0	0
13	13215984	.	T	C	5	6	11	0	1	12	0	0
13	13216092	.	G	A	11	8	19	0	0	19	0	0
13	13216251	.	G	A	11	4	15	0	1	16	0	0
13	13216381	.	T	A	5	2	7	0	2	9	0	0
13	13221451	.	G	A	3	5	8	0	1	9	0	0
13	13221482	.	C	T	1	5	6	0	0	6	0	0
13	13693742	.	C	T	2	2	4	0	0	4	0	0
13	13693781	.	A	T	12	12	24	0	0	24	0	0
13	13697957	.	G	A	0	8	8	0	14	22	0	0
13	13698411	.	T	C	15	8	23	0	1	24	0	0
13	13698433	.	T	C	14	10	24	0	2	26	0	0
13	13700335	.	A	C	12	8	20	0	0	20	0	0
13	13704011	.	T	G	16	9	25	0	0	25	0	0
13	13713106	.	C	G	18	8	26	0	0	26	0	0
13	13724919	.	T	A	14	9	23	0	0	23	0	0
13	13737474	.	G	C	25	22	47	0	2	49	0	0
13	13737514	.	A	G	31	1	32	0	21	53	0	0
13	13737524	.	G	A	33	24	57	0	1	58	0	0
13	13737612	.	G	C	4	16	20	0	33	53	0	0
13	13796754	.	A	C	9	8	17	0	0	18	1	0
13	13824580	.	A	G	2	2	4	0	0	4	0	0
13	13913140	.	G	C	1	6	7	0	10	17	0	0
13	13917976	.	C	T	11	3	14	0	1	15	0	0
13	13942449	.	C	T	3	2	5	0	2	7	0	0
13	13942565	.	G	T	3	2	5	0	1	6	0	0
13	13943372	.	C	A	4	3	7	0	0	7	0	0
13	13943788	.	T	C	5	2	7	0	0	7	0	0
13	13943959	.	T	C	6	7	13	0	1	14	0	0
13	13943983	.	A	G	5	9	14	0	0	14	0	0
13	13944064	.	A	G	5	4	9	0	0	9	0	0
13	13997101	.	C	T	3	2	5	0	0	5	0	0
13	13997299	.	C	T	1	5	6	0	0	6	0	0
13	13997481	.	T	C	2	3	5	0	0	5	0	0
13	13997536	.	T	C	1	2	3	0	0	3	0	0
13	13997545	.	G	A	1	2	3	0	0	3	0	0
13	13999037	.	A	T	1	4	5	0	1	6	0	0
13	14002979	.	G	T	7	4	11	0	0	11	0	0
13	14003099	.	A	G	9	8	17	0	0	17	0	0
13	14004161	.	T	C	6	4	10	0	1	11	0	0
13	14004209	.	C	T	8	2	10	0	1	11	0	0
13	14004276	.	C	T	5	4	9	0	0	9	0	0
13	14087004	.	A	G	3	1	4	0	4	8	0	0
13	14092489	.	C	T	2	4	6	0	0	6	0	0
13	14092573	.	G	A	5	3	8	0	0	8	0	0
13	14094441	.	G	A	2	2	4	0	0	4	0	0
13	14098156	.	T	C	2	4	6	0	1	7	0	0
13	14104076	.	T	C	5	6	11	0	2	13	0	0
13	14137061	.	C	T	6	3	9	0	2	11	0	0
13	14181750	.	C	T	17	9	26	0	2	28	0	0
13	14181952	.	T	C	7	9	16	0	0	16	0	0
13	14190780	.	C	T	1	17	18	0	18	36	0	0
13	14191033	.	T	C	16	14	30	0	0	30	0	0
13	14191045	.	G	C	13	15	28	0	0	28	0	0
13	14191724	.	G	A	21	9	30	0	4	34	0	0
13	14191769	.	T	C	32	11	43	1	0	44	0	0
13	14191797	.	A	G	29	9	38	0	2	40	0	0
13	14192110	.	T	C	9	11	20	0	0	20	0	0
13	14192131	.	G	A	8	9	17	0	0	17	0	0
13	14192178	.	A	T	7	11	18	0	1	19	0	0
13	14192414	.	A	G	6	7	13	0	0	13	0	0
13	14192448	.	A	C	4	9	13	0	2	15	0	0
13	14192506	.	G	A	6	9	15	0	1	16	0	0
13	14192511	.	A	T	6	7	13	0	0	13	0	0
13	14192561	.	G	T	1	5	6	0	0	6	0	0
13	14194055	.	C	G	7	6	13	0	5	18	0	0
13	14194241	.	C	G	0	8	8	0	4	12	0	0
13	14194256	.	A	G	4	13	17	0	0	17	0	0
13	14194484	.	C	T	8	6	14	0	2	16	0	0
13	14194571	.	G	A	7	5	12	0	0	12	0	0
13	14194573	.	C	A	7	4	11	0	1	12	0	0
13	14194611	.	T	G	3	12	15	0	0	15	0	0
13	14194660	.	G	A	5	6	11	0	0	11	0	0
13	14194904	.	T	C	7	4	11	0	0	11	0	0
13	14199190	.	A	G	6	11	17	0	1	18	0	0
13	14220900	.	G	A	5	9	14	0	0	14	0	0
13	16759638	.	A	G	1	5	6	0	0	6	0	0
13	17752932	.	A	T	6	9	15	0	0	15	0	0
13	17752993	.	C	A	8	5	13	0	0	13	0	0
13	17753104	.	C	T	4	3	7	0	0	7	0	0
13	17754466	.	C	T	3	4	7	0	1	8	0	0
13	17754571	.	C	G	2	6	8	2	0	10	0	0
13	17755618	.	T	C	10	8	18	0	0	18	0	0
13	17755743	.	G	A	8	11	19	0	0	19	0	0
13	17755898	.	G	A	3	5	8	0	0	8	0	0
13	17755980	.	G	A	3	8	11	0	0	11	0	0
13	17756043	.	G	A	4	2	6	0	0	6	0	0
13	17800661	.	T	C	5	0	5	0	3	8	0	0
13	17943175	.	G	T	4	2	6	0	0	6	0	0
13	18011158	.	G	T	1	2	3	0	1	4	0	0
13	18019724	.	T	C	3	2	5	0	0	5	0	0
13	18019758	.	C	T	0	2	2	0	4	6	0	0
13	18032872	.	C	T	0	8	8	0	7	15	0	0
13	18032941	.	A	G	5	6	11	0	0	11	0	0
13	18032960	.	G	A	5	4	9	0	0	9	0	0
13	18033053	.	A	G	3	3	6	0	0	6	0	0
13	18033405	.	T	C	2	4	6	0	1	7	0	0
13	18069311	.	C	A	0	6	6	0	2	8	0	0
13	18069338	.	C	A	4	6	10	0	0	10	0	0
13	18073433	.	A	G	11	13	24	0	1	25	0	0
13	18073460	.	C	T	12	12	24	0	3	27	0	0
13	18073557	.	C	A	7	13	20	0	0	20	0	0
13	18073706	.	G	A	14	8	22	0	1	23	0	0
13	18076710	.	T	G	12	14	26	0	2	28	0	0
13	18076722	.	G	T	14	17	31	0	0	31	0	0
13	18076818	.	G	A	9	14	23	0	1	24	0	0
13	18077056	.	G	T	14	14	28	0	3	31	0	0
13	18077116	.	G	A	14	10	24	0	2	26	0	0
13	18077206	.	C	T	17	10	27	0	2	29	0	0
13	18083210	.	G	T	11	10	21	0	1	22	0	0
13	18083415	.	G	A	11	7	18	0	1	19	0	0
13	18087918	.	G	A	11	5	16	0	1	17	0	0
13	18088276	.	T	G	14	11	25	0	0	25	0	0
13	18088283	.	C	T	0	12	12	0	11	23	0	0
13	18092062	.	G	T	2	6	8	0	1	9	0	0
13	18102984	.	A	G	3	5	8	0	0	8	0	0
13	18104890	.	C	T	4	5	9	0	0	9	0	0
13	18105007	.	A	G	5	5	10	0	0	10	0	0
13	18105023	.	T	G	5	4	9	0	0	9	0	0
13	18105136	.	C	A	0	3	3	0	6	9	0	0
13	18105175	.	G	A	4	3	7	0	0	7	0	0
13	18105382	.	A	G	6	6	12	0	0	12	0	0
13	18107562	.	C	T	1	2	3	0	1	4	0	0
13	18109897	.	T	C	3	0	3	0	3	6	0	0
13	18110003	.	T	C	8	0	8	0	7	15	0	0
13	18113387	.	G	T	2	4	6	0	0	6	0	0
13	18119378	.	C	G	4	4	8	0	0	8	0	0
13	18179151	.	C	A	6	6	12	0	0	12	0	0
13	18179500	.	G	C	5	3	8	0	0	8	0	0
13	18179733	.	T	A	14	9	23	0	2	25	0	0
13	18179859	.	C	A	11	18	29	0	2	31	0	0
13	18195926	.	G	A	2	4	6	0	0	6	0	0
13	18274914	.	A	C	3	2	5	0	0	5	0	0
13	18275320	.	G	A	2	2	4	0	0	4	0	0
13	18276387	.	T	G	2	2	4	0	0	4	0	0
13	18295212	.	C	T	1	5	6	0	1	7	0	0
13	18295608	.	G	A	1	3	4	0	3	7	0	0
13	18295680	.	T	C	1	2	3	0	0	3	0	0
13	18295835	.	C	A	2	2	4	0	0	4	0	0
13	18321156	.	T	C	13	11	24	0	1	25	0	0
13	18323595	.	G	A	3	10	13	0	17	30	0	0
13	18323653	.	A	G	18	0	18	0	9	27	0	0
13	18323787	.	T	A	14	7	21	0	1	22	0	0
13	18358680	.	G	A	21	9	30	0	0	30	0	0
13	18358890	.	G	C	17	12	29	0	1	30	0	0
13	18359112	.	G	C	9	18	27	0	1	28	0	0
13	18359176	.	C	A	21	10	31	0	2	33	0	0
13	18359202	.	C	T	16	6	22	0	3	25	0	0
13	18359507	.	A	T	10	14	24	0	2	26	0	0
13	18359551	.	T	C	6	7	13	0	1	14	0	0
13	18359554	.	A	G	7	6	13	0	0	13	0	0
13	18375465	.	C	A	6	4	10	0	2	12	0	0
13	18375512	.	T	A	6	4	10	0	1	11	0	0
13	18379281	.	A	T	0	3	3	0	2	5	0	0
13	18382192	.	T	C	2	3	5	0	0	5	0	0
13	18385497	.	C	T	1	4	5	0	0	5	0	0
13	18385749	.	G	A	0	3	3	0	3	6	0	0
13	18394755	.	T	A	8	7	15	0	5	20	0	0
13	18397416	.	G	C	2	4	6	0	0	6	0	0
13	18401308	.	C	T	5	4	9	0	0	9	0	0
13	18409776	.	T	A	5	2	7	0	1	8	0	0
13	18410799	.	G	C	0	2	2	0	6	8	0	0
13	18418390	.	C	T	12	5	17	0	0	17	0	0
13	18418528	.	G	A	12	12	24	0	0	24	0	0
13	18428103	.	A	G	8	18	26	0	0	26	0	0
13	18431301	.	C	T	5	11	16	0	0	16	0	0
13	18431430	.	C	T	9	8	17	0	2	19	0	0
13	18434075	.	A	G	4	0	4	0	3	7	0	0
13	18434085	.	C	T	5	3	8	0	0	8	0	0
13	18434150	.	T	C	5	7	12	0	1	13	0	0
13	18434229	.	A	T	4	3	7	0	0	7	0	0
13	18434275	.	T	C	6	6	12	0	0	12	0	0
13	18434307	.	C	G	7	4	11	0	0	11	0	0
13	18434326	.	A	C	7	4	11	0	0	11	0	0
13	18434427	.	C	T	8	12	20	0	1	21	0	0
13	18434519	.	C	A	7	9	16	0	1	17	0	0
13	18434520	.	G	C	2	10	12	0	5	17	0	0
13	18434570	.	C	G	11	12	23	0	0	23	0	0
13	18434615	.	A	G	19	0	19	0	12	31	0	0
13	18434794	.	C	A	11	7	18	0	0	18	0	0
13	18434902	.	C	T	7	5	12	0	0	12	0	0
13	18434957	.	G	A	9	4	13	0	0	13	0	0
13	18434962	.	A	G	8	3	11	0	0	11	0	0
13	18435012	.	A	T	3	5	8	0	0	9	1	0
13	18435020	.	A	T	4	0	4	0	2	6	0	0
13	18498907	.	T	C	1	2	3	0	0	3	0	0
13	18499660	.	C	T	5	2	7	0	0	7	0	0
13	18499773	.	A	T	2	4	6	0	0	6	0	0
13	18499864	.	C	T	1	5	6	0	0	6	0	0
13	18507715	.	A	C	7	7	14	0	0	14	0	0
13	18509592	.	G	A	0	11	11	0	9	20	0	0
13	18510033	.	C	G	12	0	12	0	6	18	0	0
13	18510204	.	T	C	13	8	21	0	1	22	0	0
13	18510324	.	A	G	8	8	16	0	2	18	0	0
13	18511023	.	C	T	15	9	24	0	0	24	0	0
13	18511140	.	A	G	21	1	22	0	8	30	0	0
13	18511637	.	A	C	4	11	15	0	0	15	0	0
13	18512082	.	C	G	17	12	29	0	0	29	0	0
13	18663103	.	G	A	5	7	12	0	0	12	0	0
13	18663156	.	G	A	1	1	2	0	5	7	0	0
13	18669200	.	G	T	14	19	33	0	1	34	0	0
13	18677437	.	T	C	4	5	9	0	1	10	0	0
13	18677442	.	T	C	5	3	8	0	2	10	0	0
13	18678392	.	G	A	2	4	6	0	0	6	0	0
13	18680027	.	G	A	2	7	9	0	0	9	0	0
13	18685673	.	G	A	6	8	14	1	2	17	0	0
13	18689043	.	C	T	8	9	17	0	2	19	0	0
13	18801566	.	G	A	2	5	7	0	0	7	0	0
13	18801615	.	G	A	4	2	6	0	1	7	0	0
13	19304688	.	A	G	21	18	39	0	1	40	0	0
13	19316930	.	G	C	14	16	30	0	2	32	0	0
13	19317016	.	T	A	7	9	16	0	0	16	0	0
13	19317018	.	C	G	8	9	17	0	0	17	0	0
13	19317051	.	T	G	7	5	12	0	0	12	0	0
13	19317499	.	G	C	6	5	11	0	0	11	0	0
13	19610625	.	C	T	1	2	3	0	3	6	0	0
13	19610772	.	C	T	0	2	2	0	4	6	0	0
13	19627150	.	A	G	6	4	10	0	1	11	0	0
13	19627266	.	A	C	4	3	7	0	2	9	0	0
13	19629032	.	G	T	2	5	7	0	1	8	0	0
13	19629266	.	C	G	5	5	10	0	0	10	0	0
13	19639198	.	A	G	4	3	7	0	0	7	0	0
13	19639205	.	G	A	4	3	7	0	0	7	0	0
13	19639238	.	T	C	5	2	7	0	0	7	0	0
13	19768396	.	G	T	8	14	22	2	1	25	0	0
13	19799192	.	A	G	9	11	20	0	0	20	0	0
13	19799467	.	G	A	8	13	21	0	1	22	0	0
13	19799611	.	C	A	1	14	15	0	7	22	0	0
13	19799623	.	T	C	15	8	23	0	4	27	0	0
13	19799646	.	C	A	1	8	9	0	16	25	0	0
13	20392670	.	G	C	14	1	15	0	9	24	0	0
13	20392704	.	G	A	15	11	26	0	1	27	0	0
13	20392714	.	G	T	18	10	28	0	1	29	0	0
13	20392752	.	G	A	22	8	30	0	1	31	0	0
13	20392788	.	A	G	24	8	32	0	5	37	0	0
13	20401263	.	C	A	2	18	20	0	9	30	1	0
13	20401267	.	T	C	18	9	27	0	5	32	0	0
13	20401392	.	C	T	11	14	25	0	1	26	0	0
13	20425191	.	A	G	5	8	13	0	0	13	0	0
13	20425396	.	C	T	0	4	4	0	6	10	0	0
13	20518608	.	A	T	7	2	9	0	0	9	0	0
13	21638955	.	C	A	5	2	7	0	0	7	0	0
13	21639011	.	G	C	4	5	9	0	0	9	0	0
13	21674509	.	T	C	2	2	4	0	0	4	0	0
13	21677961	.	G	A	8	5	13	0	0	13	0	0
13	21680844	.	A	T	3	2	5	0	0	5	0	0
13	21683546	.	C	T	12	16	28	0	0	28	0	0
13	21683636	.	G	A	18	17	35	0	3	38	0	0
13	21683762	.	C	T	1	11	12	0	15	27	0	0
13	21683928	.	G	A	15	21	36	0	1	37	0	0
13	21689530	.	A	T	14	5	19	0	0	19	0	0
13	21689883	.	T	G	8	11	19	0	0	19	0	0
13	21689982	.	G	A	5	5	10	0	0	10	0	0
13	21690053	.	T	A	1	3	4	0	0	4	0	0
13	21690104	.	C	T	2	3	5	0	9	14	0	0
13	21690229	.	A	C	4	6	10	1	1	12	0	0
13	21690507	.	T	A	12	13	25	0	1	26	0	0
13	21690636	.	T	C	13	6	19	0	4	23	0	0
13	21690877	.	A	C	10	0	10	0	7	17	0	0
13	21691324	.	G	A	6	2	8	1	0	9	0	0
13	21691671	.	G	A	2	6	8	0	0	8	0	0
13	21691695	.	T	A	5	4	9	0	0	9	0	0
13	21691787	.	C	G	4	16	20	0	1	21	0	0
13	21691843	.	G	A	10	10	20	0	1	21	0	0
13	21691935	.	A	G	6	3	9	0	2	11	0	0
13	21692084	.	T	A	2	3	5	0	0	5	0	0
13	21692085	.	C	A	2	3	5	0	0	5	0	0
13	21692328	.	C	A	14	6	20	0	0	20	0	0
13	21692338	.	C	T	14	7	21	0	1	22	0	0
13	21712507	.	G	A	10	19	29	0	2	31	0	0
13	21712526	.	G	A	10	20	30	0	1	31	0	0
13	21712755	.	G	C	9	14	23	0	1	24	0	0
13	21716581	.	T	C	6	13	19	0	0	19	0	0
13	21722470	.	G	A	7	12	19	0	1	20	0	0
13	21723323	.	G	A	5	12	17	0	0	17	0	0
13	21723514	.	G	C	14	4	18	0	0	18	0	0
13	21725526	.	T	C	8	3	11	0	0	11	0	0
13	21727796	.	T	A	3	6	9	0	0	10	1	0
13	21735278	.	C	T	4	4	8	0	1	9	0	0
13	21776082	.	A	G	4	0	4	0	4	8	0	0
13	21817852	.	G	A	0	2	2	0	1	3	0	0
13	21817872	.	G	A	0	2	2	0	2	4	0	0
13	21818812	.	C	T	3	2	5	0	0	5	0	0
13	21818930	.	G	A	2	2	4	0	0	4	0	0
13	21818944	.	A	G	2	2	4	0	0	4	0	0
13	21819857	.	T	A	2	3	5	0	0	5	0	0
13	21821393	.	A	C	3	3	6	0	0	6	0	0
13	21826470	.	G	A	0	1	1	0	2	3	0	0
13	21852008	.	G	A	0	3	3	0	2	5	0	0
13	21856576	.	A	T	5	2	7	0	0	7	0	0
13	21856849	.	G	A	1	5	6	0	3	9	0	0
13	21861775	.	A	C	7	2	9	0	0	9	0	0
13	21861777	.	G	A	7	2	9	0	0	9	0	0
13	21862288	.	T	A	11	7	18	0	2	20	0	0
13	21866052	.	C	T	7	3	10	0	1	11	0	0
13	21866324	.	C	T	3	11	14	0	0	14	0	0
13	21866357	.	A	C	5	7	12	0	1	13	0	0
13	21870319	.	G	C	9	9	18	0	0	18	0	0
13	21870323	.	T	C	8	9	17	0	0	17	0	0
13	21870374	.	G	A	2	10	12	0	12	24	0	0
13	21870467	.	G	C	2	14	16	0	12	28	0	0
13	21870575	.	A	G	14	1	15	0	15	30	0	0
13	21870608	.	A	T	11	11	22	0	2	24	0	0
13	21870629	.	C	T	10	11	21	0	2	23	0	0
13	21874107	.	C	T	15	11	26	0	2	28	0	0
13	21874128	.	G	T	14	16	30	0	3	33	0	0
13	21874149	.	G	T	1	9	10	0	21	31	0	0
13	21884298	.	C	T	15	18	33	0	2	35	0	0
13	21884407	.	T	C	10	18	28	0	2	30	0	0
13	21884408	.	C	T	11	19	30	0	0	30	0	0
13	21884467	.	C	T	9	13	22	0	0	22	0	0
13	21884979	.	T	C	9	10	19	0	0	19	0	0
13	21884980	.	C	T	7	10	17	0	2	19	0	0
13	21885250	.	C	T	17	23	40	0	2	42	0	0
13	21888285	.	T	A	2	1	3	0	1	4	0	0
13	21888292	.	A	T	2	2	4	0	0	4	0	0
13	22065089	.	G	A	1	2	3	0	0	3	0	0
13	22065148	.	G	A	0	4	4	0	2	6	0	0
13	22065631	.	A	G	2	3	5	0	1	6	0	0
13	22065904	.	T	G	1	3	4	0	0	4	0	0
13	22084034	.	C	T	8	8	16	0	0	16	0	0
13	22087988	.	C	T	10	10	20	0	1	21	0	0
13	22088061	.	T	G	5	0	5	0	7	12	0	0
13	22088105	.	G	A	8	12	20	0	2	22	0	0
13	22094800	.	T	C	8	19	27	0	1	28	0	0
13	22094871	.	T	G	8	18	26	0	2	28	0	0
13	22095340	.	C	T	7	12	19	0	0	19	0	0
13	22095589	.	G	A	2	9	11	0	0	11	0	0
13	22095594	.	T	A	1	8	9	0	1	10	0	0
13	22119935	.	T	C	15	11	26	1	1	28	0	0
13	22206667	.	A	T	15	13	28	0	1	29	0	0
13	22238209	.	T	C	18	18	36	0	0	36	0	0
13	22238233	.	G	A	20	14	34	0	1	35	0	0
13	22241027	.	G	A	20	20	40	0	3	43	0	0
13	22241123	.	G	T	1	9	10	0	22	33	1	0
13	22241374	.	A	C	22	21	43	0	5	48	0	0
13	22241482	.	G	C	14	9	23	0	4	27	0	0
13	22241648	.	T	G	24	20	44	0	1	45	0	0
13	22241821	.	T	C	36	5	41	0	3	44	0	0
13	22242394	.	C	G	21	29	50	0	0	50	0	0
13	22242837	.	T	G	23	21	44	0	0	44	0	0
13	22316792	.	A	G	2	0	2	0	3	5	0	0
13	22317136	.	A	T	4	2	6	0	1	7	0	0
13	22340444	.	C	T	1	5	6	0	0	6	0	0
13	22340456	.	G	A	2	4	6	0	1	7	0	0
13	22347506	.	C	T	4	4	8	0	1	9	0	0
13	22351910	.	A	G	4	5	9	0	1	10	0	0
13	22355859	.	T	C	5	3	8	0	0	8	0	0
13	22357105	.	C	A	9	5	14	0	0	14	0	0
13	22357236	.	T	G	3	4	7	0	0	7	0	0
13	22357823	.	C	T	6	5	11	0	0	11	0	0
13	22358021	.	A	G	4	4	8	0	2	10	0	0
13	22358174	.	G	A	1	3	4	0	3	7	0	0
13	22361332	.	G	A	8	8	16	0	0	16	0	0
13	22361718	.	A	C	10	7	17	0	0	17	0	0
13	22364908	.	T	C	11	16	27	0	2	29	0	0
13	22365016	.	C	T	11	16	27	0	1	28	0	0
13	22365404	.	C	T	17	14	31	0	1	32	0	0
13	22365461	.	A	G	17	10	27	0	2	29	0	0
13	22367600	.	C	A	19	19	38	0	2	40	0	0
13	22369295	.	T	C	12	10	22	0	0	22	0	0
13	22372075	.	T	C	20	21	41	0	0	41	0	0
13	22372154	.	T	C	17	18	35	0	3	38	0	0
13	22372175	.	A	G	21	18	39	0	2	41	0	0
13	22372205	.	A	G	20	18	38	0	2	40	0	0
13	22372737	.	C	T	7	8	15	0	1	16	0	0
13	22373241	.	G	A	2	18	20	0	12	32	0	0
13	22373336	.	C	A	15	6	21	0	1	23	1	0
13	22373761	.	G	A	14	4	18	0	1	19	0	0
13	22373931	.	C	T	10	9	19	0	2	21	0	0
13	22373940	.	A	G	11	9	20	0	1	21	0	0
13	22614888	.	C	G	2	1	3	0	2	5	0	0
13	22617941	.	G	A	2	2	4	0	0	4	0	0
13	22618393	.	T	A	4	3	7	0	0	7	0	0
13	22618452	.	T	A	2	1	3	0	0	3	0	0
13	22659195	.	C	G	14	0	14	0	28	42	0	0
13	22672354	.	A	T	27	24	51	0	1	52	0	0
13	22672952	.	G	A	5	10	15	0	0	15	0	0
13	22673006	.	A	C	2	10	12	0	0	12	0	0
13	22673068	.	A	T	4	9	13	0	0	13	0	0
13	22677464	.	A	T	2	3	5	0	2	7	0	0
13	22679306	.	G	A	2	2	4	0	0	4	0	0
13	22679537	.	C	G	1	2	3	0	0	3	0	0
13	22679837	.	G	A	3	3	6	0	0	6	0	0
13	22694363	.	C	T	2	3	5	0	0	5	0	0
13	22705172	.	G	C	1	3	4	0	0	4	0	0
13	22719820	.	T	A	3	2	5	0	0	5	0	0
13	22725613	.	C	T	2	2	4	0	0	4	0	0
13	22731465	.	C	T	1	6	7	0	0	7	0	0
13	22735063	.	T	C	7	6	13	0	0	13	0	0
13	22735139	.	A	G	15	9	24	0	1	25	0	0
13	22742791	.	G	A	6	6	12	0	2	14	0	0
13	22744359	.	A	G	9	7	16	0	0	16	0	0
13	22867888	.	G	A	1	6	7	1	11	19	0	0
13	22867910	.	A	G	8	7	15	1	1	17	0	0
13	22867953	.	G	T	8	6	14	0	0	14	0	0
13	22868447	.	G	A	1	3	4	0	4	8	0	0
13	22868456	.	T	C	5	3	8	0	0	8	0	0
13	22871989	.	A	G	5	2	7	0	1	8	0	0
13	22872817	.	C	T	6	3	9	0	0	9	0	0
13	22872862	.	A	G	4	2	6	0	0	6	0	0
13	22873022	.	C	T	2	2	4	0	0	4	0	0
13	22876576	.	T	C	5	0	5	0	7	12	0	0
13	22876623	.	G	A	12	9	21	0	0	21	0	0
13	22876678	.	A	T	14	9	23	0	1	24	0	0
13	22877076	.	C	T	12	17	29	0	2	31	0	0
13	22877130	.	G	T	21	14	35	0	1	36	0	0
13	22878754	.	G	A	24	13	37	0	3	40	0	0
13	22879149	.	A	T	18	12	30	0	0	30	0	0
13	22890835	.	A	C	26	1	27	0	18	45	0	0
13	22898042	.	A	G	16	14	30	0	2	32	0	0
13	22900733	.	G	A	6	14	20	0	1	21	0	0
13	22900742	.	A	T	7	15	22	0	1	23	0	0
13	22902882	.	A	C	8	4	12	0	0	12	0	0
13	22902987	.	G	A	14	12	26	0	0	26	0	0
13	22925970	.	A	G	1	2	3	0	0	3	0	0
13	22970688	.	T	C	1	2	3	0	0	3	0	0
13	22970750	.	T	C	2	2	4	0	0	4	0	0
13	22970816	.	T	G	3	3	6	0	0	6	0	0
13	22973314	.	A	G	16	41	57	0	1	58	0	0
13	22973348	.	A	G	20	32	52	0	2	54	0	0
13	22973531	.	T	C	25	2	27	0	19	46	0	0
13	22973895	.	A	G	35	12	47	0	3	50	0	0
13	22974033	.	A	G	20	25	45	0	0	45	0	0
13	22974108	.	C	T	17	23	40	0	1	41	0	0
13	22976067	.	C	A	23	19	42	0	1	43	0	0
13	22976070	.	G	A	20	19	39	0	2	41	0	0
13	22976383	.	T	C	19	0	19	0	15	34	0	0
13	22977283	.	G	A	27	14	41	0	1	42	0	0
13	22977319	.	A	G	21	19	40	0	0	40	0	0
13	22977343	.	A	G	20	14	34	0	0	34	0	0
13	22978059	.	T	C	28	0	28	0	11	39	0	0
13	22978062	.	G	A	28	9	37	0	2	39	0	0
13	22983106	.	A	G	6	11	17	0	0	17	0	0
13	22983109	.	A	G	5	12	17	0	0	17	0	0
13	23002697	.	G	A	5	5	10	0	1	11	0	0
13	23017637	.	G	A	2	3	5	0	0	5	0	0
13	23037831	.	C	A	5	6	11	0	0	11	0	0
13	23042321	.	A	G	6	4	10	0	1	11	0	0
13	23042387	.	C	G	4	6	10	0	1	11	0	0
13	23042676	.	A	G	7	7	14	0	0	14	0	0
13	23042745	.	G	A	9	6	15	0	1	16	0	0
13	23042929	.	G	T	6	7	13	0	0	13	0	0
13	23043112	.	T	C	4	4	8	0	0	8	0	0
13	23043117	.	A	G	6	4	10	0	0	10	0	0
13	23058975	.	G	A	3	3	6	0	8	14	0	0
13	23064735	.	T	C	4	4	8	0	1	9	0	0
13	23070787	.	C	T	2	3	5	0	0	5	0	0
13	23070895	.	T	C	6	11	17	0	1	18	0	0
13	23071125	.	A	G	2	2	4	0	0	4	0	0
13	23084177	.	C	G	17	15	32	1	0	33	0	0
13	23084841	.	G	C	9	13	22	0	0	22	0	0
13	23090190	.	A	C	13	13	26	0	1	27	0	0
13	23094356	.	T	C	7	1	8	0	12	20	0	0
13	23094895	.	G	T	7	9	16	0	2	18	0	0
13	23166988	.	T	A	1	2	3	0	0	3	0	0
13	23169172	.	G	T	1	2	3	0	1	4	0	0
13	23196207	.	C	T	2	3	5	0	1	6	0	0
13	23204849	.	A	C	4	4	8	0	1	9	0	0
13	23211195	.	A	T	11	6	17	0	0	17	0	0
13	23222899	.	A	T	5	6	11	0	1	12	0	0
13	23223122	.	A	G	5	5	10	0	0	10	0	0
13	23223469	.	T	A	14	8	22	0	0	22	0	0
13	23223486	.	C	T	11	7	18	0	1	19	0	0
13	23223567	.	C	T	8	6	14	0	1	15	0	0
13	23223572	.	C	T	8	6	14	0	1	15	0	0
13	23224087	.	G	A	6	6	12	0	0	12	0	0
13	23224113	.	A	T	3	6	9	0	0	9	0	0
13	23224360	.	A	G	7	7	14	0	0	14	0	0
13	23224363	.	T	G	7	6	13	0	0	13	0	0
13	23224427	.	C	T	10	13	23	0	0	23	0	0
13	23224470	.	G	A	12	11	23	0	0	23	0	0
13	23224605	.	G	T	11	6	17	0	3	20	0	0
13	23224727	.	C	T	10	10	20	0	1	21	0	0
13	23224735	.	A	G	10	10	20	0	0	20	0	0
13	23224821	.	T	A	8	13	21	0	1	22	0	0
13	23224860	.	T	A	10	7	17	0	3	20	0	0
13	23225541	.	T	C	10	10	20	0	1	21	0	0
13	23225776	.	T	A	13	3	16	0	1	17	0	0
13	23226114	.	G	A	1	14	15	0	9	24	0	0
13	23226213	.	A	C	11	9	20	0	0	20	0	0
13	23234675	.	C	A	2	2	4	0	0	4	0	0
13	23234680	.	C	T	2	2	4	0	0	4	0	0
13	23234869	.	A	G	1	2	3	0	0	3	0	0
13	23241260	.	A	G	3	2	5	0	0	5	0	0
13	23314904	.	T	G	10	9	19	0	2	21	0	0
13	23382393	.	G	A	17	12	29	0	0	29	0	0
13	23382572	.	T	C	23	17	40	0	1	41	0	0
13	23387252	.	T	C	7	3	10	0	0	10	0	0
13	23387337	.	C	T	6	2	8	0	0	8	0	0
13	23499434	.	G	T	2	6	8	0	0	8	0	0
13	23669773	.	C	T	11	3	14	0	0	14	0	0
13	23669870	.	T	G	2	4	6	0	0	6	0	0
13	23675183	.	C	T	2	5	7	0	1	8	0	0
13	23675510	.	T	C	6	4	10	0	0	10	0	0
13	23675892	.	G	C	1	2	3	0	8	11	0	0
13	23676913	.	C	A	7	2	9	0	2	11	0	0
13	23678001	.	G	A	0	3	3	0	4	7	0	0
13	23679546	.	G	A	0	5	5	0	3	8	0	0
13	23679888	.	G	A	6	4	10	0	0	10	0	0
13	23685075	.	G	A	2	2	4	0	0	4	0	0
13	23685301	.	G	A	6	6	12	0	0	12	0	0
13	23685361	.	T	G	4	0	4	0	5	9	0	0
13	23692515	.	C	T	10	9	19	0	1	20	0	0
13	23692572	.	C	T	16	10	26	0	1	27	0	0
13	23703048	.	G	C	14	10	24	0	0	24	0	0
13	23703053	.	T	C	13	9	22	0	0	22	0	0
13	23709532	.	C	T	13	11	24	0	1	25	0	0
13	23709562	.	T	C	15	17	32	0	1	33	0	0
13	23709592	.	A	G	21	17	38	0	1	39	0	0
13	23711937	.	G	A	18	23	41	0	2	43	0	0
13	23728490	.	T	A	4	7	11	0	0	11	0	0
13	23730801	.	G	A	7	5	12	0	0	12	0	0
13	23731944	.	C	A	4	2	6	0	0	6	0	0
13	23731988	.	T	A	1	2	3	0	0	3	0	0
13	23876784	.	C	T	2	2	4	0	0	4	0	0
13	23882615	.	T	C	3	5	8	0	0	8	0	0
13	23882629	.	T	C	5	4	9	0	0	9	0	0
13	23882686	.	C	T	4	4	8	0	0	8	0	0
13	23882946	.	A	G	2	2	4	0	0	4	0	0
13	23898015	.	A	T	14	6	20	0	1	21	0	0
13	23898045	.	T	G	12	16	28	0	3	31	0	0
13	23901334	.	C	T	10	13	23	0	4	27	0	0
13	23901349	.	T	C	10	12	22	0	3	25	0	0
13	23901502	.	A	G	7	11	18	0	0	18	0	0
13	23920791	.	A	G	11	11	22	0	1	23	0	0
13	23931192	.	T	C	7	0	7	0	8	15	0	0
13	23940708	.	T	C	8	0	8	0	9	17	0	0
13	23940754	.	C	A	5	7	12	0	0	12	0	0
13	23943040	.	T	G	7	10	17	0	0	18	1	0
13	23990054	.	C	A	1	3	4	0	0	4	0	0
13	23996192	.	G	A	7	4	11	0	0	11	0	0
13	23999129	.	G	A	4	5	9	0	0	9	0	0
13	23999264	.	G	C	3	3	6	0	0	6	0	0
13	23999274	.	T	A	1	3	4	0	0	4	0	0
13	24000394	.	G	A	3	5	8	0	0	8	0	0
13	24010630	.	C	T	4	3	7	0	0	7	0	0
13	24010663	.	A	G	5	2	7	0	1	8	0	0
13	24014578	.	T	C	2	2	4	0	0	4	0	0
13	24034158	.	A	G	1	6	7	0	0	7	0	0
13	24034206	.	A	G	6	5	11	0	0	11	0	0
13	24034215	.	G	A	6	5	11	0	0	11	0	0
13	24046953	.	G	A	1	6	7	0	4	11	0	0
13	24056221	.	C	T	6	15	21	0	0	21	0	0
13	24068790	.	C	T	1	6	7	0	13	20	0	0
13	24069624	.	C	A	13	10	23	0	1	24	0	0
13	24069902	.	A	T	10	12	22	0	2	24	0	0
13	24070242	.	C	T	2	10	12	0	11	23	0	0
13	24070578	.	G	A	8	3	11	1	0	12	0	0
13	24070730	.	C	T	9	4	13	0	2	15	0	0
13	24096437	.	G	T	5	8	13	0	0	13	0	0
13	24234815	.	C	A	2	2	4	0	0	4	0	0
13	24241436	.	A	G	3	2	5	0	0	5	0	0
13	24275663	.	G	A	1	4	5	0	3	8	0	0
13	24276128	.	T	A	3	2	5	0	0	5	0	0
13	24292398	.	G	A	11	4	15	0	0	15	0	0
13	24292419	.	G	A	6	8	14	0	0	14	0	0
13	24292796	.	T	A	12	12	24	0	2	26	0	0
13	24292800	.	A	T	12	13	25	0	0	25	0	0
13	24292866	.	C	A	2	9	11	0	16	27	0	0
13	24293162	.	C	A	11	23	34	0	0	34	0	0
13	24293218	.	T	A	19	17	36	0	2	38	0	0
13	24293220	.	G	C	19	18	37	0	2	39	0	0
13	24293465	.	C	T	4	19	23	0	18	41	0	0
13	24293615	.	G	A	14	17	31	0	7	38	0	0
13	24293691	.	G	A	13	20	33	0	3	36	0	0
13	24293698	.	C	T	24	11	35	0	0	35	0	0
13	24293940	.	G	A	10	13	23	0	0	23	0	0
13	24294046	.	A	G	7	12	19	0	0	19	0	0
13	24295999	.	T	C	0	4	4	0	0	4	0	0
13	24296013	.	C	T	3	4	7	0	0	7	0	0
13	24296215	.	C	T	1	2	3	0	3	6	0	0
13	24296430	.	C	A	4	4	8	0	0	8	0	0
13	24303667	.	C	A	11	9	20	0	1	21	0	0
13	24305975	.	T	G	8	13	21	0	0	21	0	0
13	24309321	.	A	T	4	6	10	0	2	12	0	0
13	24372095	.	G	T	6	6	12	0	0	12	0	0
13	24372197	.	C	T	4	2	6	0	0	6	0	0
13	24372640	.	C	T	0	3	3	0	5	8	0	0
13	24372764	.	T	C	2	0	2	0	5	7	0	0
13	24372771	.	C	T	3	3	6	0	1	7	0	0
13	24372874	.	T	A	2	1	3	0	1	4	0	0
13	24373003	.	G	A	1	3	4	0	0	4	0	0
13	24378740	.	C	T	1	3	4	0	0	4	0	0
13	24378833	.	C	A	1	3	4	0	1	5	0	0
13	24378834	.	G	T	1	3	4	0	0	4	0	0
13	24380376	.	T	A	3	2	5	0	0	5	0	0
13	24381336	.	A	T	2	2	4	0	1	5	0	0
13	24382510	.	C	A	4	4	8	0	0	8	0	0
13	24382539	.	T	C	4	3	7	0	0	7	0	0
13	24382578	.	G	A	3	6	9	0	2	11	0	0
13	24383528	.	T	G	3	1	4	0	3	7	0	0
13	24384282	.	G	C	5	3	8	0	0	8	0	0
13	24384425	.	A	T	11	8	19	0	0	19	0	0
13	24384807	.	G	A	6	4	10	0	2	12	0	0
13	24387484	.	G	T	11	6	17	0	0	17	0	0
13	24395373	.	G	A	2	3	5	0	0	5	0	0
13	24401618	.	A	G	3	3	6	0	0	6	0	0
13	24401626	.	G	C	1	3	4	0	5	9	0	0
13	24401663	.	C	A	3	3	6	0	0	6	0	0
13	24401825	.	T	C	3	2	5	0	0	5	0	0
13	24402490	.	G	A	0	11	11	0	10	21	0	0
13	24402560	.	T	C	8	10	18	0	0	18	0	0
13	24411553	.	T	C	16	14	30	0	0	30	0	0
13	24424014	.	C	T	5	3	8	0	1	9	0	0
13	24424216	.	A	T	1	3	4	0	0	4	0	0
13	24424217	.	A	C	2	2	4	0	1	5	0	0
13	24424260	.	A	T	1	2	3	0	0	3	0	0
13	24424511	.	A	C	3	0	3	0	7	10	0	0
13	24424724	.	T	C	3	2	5	0	0	5	0	0
13	24425019	.	G	A	2	3	5	0	0	5	0	0
13	24425112	.	T	C	3	0	3	0	2	5	0	0
13	24431365	.	T	G	3	5	8	0	0	8	0	0
13	24431651	.	C	G	15	3	18	1	1	20	0	0
13	24431784	.	T	G	12	17	29	0	2	31	0	0
13	24432162	.	G	C	7	7	14	0	0	14	0	0
13	24432212	.	T	C	9	0	9	0	10	19	0	0
13	24432350	.	C	T	1	16	17	0	13	30	0	0
13	24436054	.	G	A	9	8	17	0	2	19	0	0
13	24437225	.	G	A	5	4	9	0	0	9	0	0
13	24522570	.	G	T	1	5	6	0	0	6	0	0
13	24523321	.	G	A	6	4	10	0	2	12	0	0
13	24523425	.	A	G	6	3	9	0	0	9	0	0
13	24523637	.	T	G	1	3	4	0	0	4	0	0
13	24523731	.	A	G	1	4	5	0	0	5	0	0
13	24524206	.	G	A	3	6	9	0	0	9	0	0
13	24579187	.	A	T	15	11	26	0	0	26	0	0
13	24580372	.	G	A	17	14	31	0	2	33	0	0
13	24580411	.	G	A	18	16	34	0	5	39	0	0
13	24580441	.	A	G	13	0	13	0	17	30	0	0
13	24580705	.	C	T	14	13	27	0	2	29	0	0
13	24580869	.	T	C	11	13	24	0	3	27	0	0
13	24580941	.	T	C	17	12	29	0	1	30	0	0
13	24581274	.	G	A	15	18	33	0	3	36	0	0
13	24581316	.	C	A	20	16	36	0	0	36	0	0
13	24581334	.	G	C	16	15	31	0	1	32	0	0
13	24581358	.	T	C	21	16	37	0	0	37	0	0
13	24581748	.	A	C	14	10	24	0	2	26	0	0
13	24581798	.	T	A	13	8	21	0	0	21	0	0
13	24581840	.	T	G	17	7	24	0	2	26	0	0
13	24581854	.	C	T	20	9	29	0	3	32	0	0
13	24581982	.	G	A	1	15	16	0	10	26	0	0
13	24582047	.	A	G	13	9	22	0	0	22	0	0
13	24582110	.	C	T	10	6	16	0	4	20	0	0
13	24582122	.	T	C	12	5	17	0	0	17	0	0
13	24582211	.	C	T	6	3	9	0	0	9	0	0
13	24663222	.	G	C	0	2	2	0	2	4	0	0
13	24665407	.	C	T	4	4	8	0	0	8	0	0
13	24665869	.	C	T	5	3	8	0	1	9	0	0
13	24702092	.	C	T	5	9	14	0	2	16	0	0
13	24702275	.	C	T	1	7	8	0	0	8	0	0
13	24702383	.	G	A	6	8	14	0	0	14	0	0
13	24702415	.	T	C	5	7	12	0	0	12	0	0
13	24702743	.	C	T	8	9	17	0	0	17	0	0
13	24702822	.	A	C	9	9	18	0	1	19	0	0
13	24702883	.	A	T	10	11	21	0	2	23	0	0
13	24702974	.	T	C	9	11	20	0	0	20	0	0
13	24702996	.	G	A	8	10	18	0	0	18	0	0
13	24703319	.	C	T	5	3	8	0	0	8	0	0
13	24703325	.	A	T	4	3	7	0	0	7	0	0
13	24703354	.	C	A	4	3	7	0	0	7	0	0
13	24703362	.	C	A	3	2	5	0	0	5	0	0
13	24703473	.	G	T	5	4	9	0	2	11	0	0
13	24703490	.	G	A	3	2	5	0	2	7	0	0
13	24704032	.	A	G	8	5	13	0	1	14	0	0
13	24704102	.	C	A	5	10	15	0	0	15	0	0
13	24704191	.	A	T	6	4	10	0	2	12	0	0
13	24716363	.	T	C	5	3	8	0	1	9	0	0
13	24716375	.	A	T	5	6	11	0	0	11	0	0
13	24737151	.	T	C	1	2	3	0	0	3	0	0
13	24740703	.	C	A	4	3	7	0	0	7	0	0
13	24742835	.	G	A	2	5	7	0	0	7	0	0
13	24742836	.	T	A	2	5	7	0	0	7	0	0
13	24745024	.	T	C	1	1	2	0	1	3	0	0
13	24745169	.	A	G	2	1	3	0	0	3	0	0
13	24781605	.	T	C	16	13	29	0	0	29	0	0
13	24785591	.	C	A	21	12	33	0	0	33	0	0
13	24791020	.	A	G	3	2	5	0	0	5	0	0
13	24804386	.	T	C	9	3	12	0	0	12	0	0
13	24804387	.	C	T	0	3	3	0	9	12	0	0
13	24804765	.	C	T	3	3	6	0	0	6	0	0
13	24805068	.	A	C	3	6	9	0	1	10	0	0
13	24805148	.	A	C	2	4	6	0	0	6	0	0
13	24805257	.	T	C	2	0	2	0	2	4	0	0
13	24806423	.	T	C	3	0	3	0	4	7	0	0
13	24834358	.	A	G	14	10	24	0	0	24	0	0
13	24836958	.	C	T	12	5	17	0	1	18	0	0
13	24837392	.	A	G	14	18	32	0	0	32	0	0
13	24837407	.	T	A	17	17	34	0	0	34	0	0
13	24837876	.	T	C	4	5	9	0	0	9	0	0
13	24871485	.	C	T	13	15	28	1	1	30	0	0
13	24872733	.	G	A	6	4	10	0	1	11	0	0
13	24873141	.	C	A	1	12	13	0	15	28	0	0
13	24873186	.	A	T	10	9	19	0	0	19	0	0
13	24873267	.	G	A	11	15	26	0	0	26	0	0
13	24873480	.	A	G	11	13	24	0	0	24	0	0
13	24873579	.	C	T	7	9	16	0	0	16	0	0
13	24873597	.	G	T	10	7	17	0	0	17	0	0
13	24873990	.	A	G	8	5	13	0	0	13	0	0
13	24873995	.	T	G	6	4	10	0	1	11	0	0
13	24874837	.	A	G	6	11	17	0	0	17	0	0
13	24874894	.	T	A	11	6	17	0	0	17	0	0
13	24874934	.	A	G	10	6	16	0	1	17	0	0
13	24877934	.	C	A	6	3	9	0	1	10	0	0
13	24906196	.	A	T	2	4	6	0	1	7	0	0
13	24919399	.	T	A	3	4	7	0	0	7	0	0
13	24919428	.	G	A	3	7	10	0	0	10	0	0
13	24919518	.	T	C	3	2	5	0	0	5	0	0
13	24919774	.	C	A	3	2	5	0	0	5	0	0
13	24986203	.	G	A	8	4	12	0	1	13	0	0
13	24986238	.	G	T	10	10	20	0	0	20	0	0
13	24986272	.	T	C	7	0	7	0	9	16	0	0
13	25207368	.	A	G	4	6	10	0	0	10	0	0
13	25208276	.	A	G	1	3	4	0	0	4	0	0
13	25208321	.	G	T	2	3	5	0	0	5	0	0
13	25208501	.	G	T	2	3	5	0	1	6	0	0
13	25208605	.	A	T	1	2	3	0	0	3	0	0
13	25221190	.	G	C	4	3	7	0	0	7	0	0
13	25242602	.	C	T	1	4	5	0	0	5	0	0
13	25251849	.	G	A	2	3	5	0	0	5	0	0
13	25284140	.	C	A	1	2	3	0	0	3	0	0
13	25364846	.	T	A	4	3	7	0	0	7	0	0
13	25364915	.	A	T	1	4	5	0	1	6	0	0
13	25366749	.	T	A	5	6	11	0	0	11	0	0
13	25369165	.	C	T	6	7	13	0	0	13	0	0
13	25369449	.	C	T	9	6	15	0	1	16	0	0
13	25371436	.	A	G	6	8	14	0	2	16	0	0
13	25372806	.	G	A	18	16	34	0	1	35	0	0
13	25378590	.	G	A	2	12	14	0	15	29	0	0
13	25378924	.	T	G	11	12	23	0	0	24	1	0
13	25379263	.	A	T	21	13	34	0	3	37	0	0
13	25379304	.	A	G	11	0	11	0	20	31	0	0
13	25379352	.	A	C	7	12	19	0	4	23	0	0
13	25383915	.	C	T	5	6	11	0	1	12	0	0
13	25384145	.	A	G	7	5	12	0	3	15	0	0
13	25384223	.	A	G	4	13	17	0	1	18	0	0
13	25386904	.	C	T	7	8	15	0	1	16	0	0
13	25388389	.	G	A	2	6	8	0	1	9	0	0
13	25388644	.	T	C	4	7	11	0	0	11	0	0
13	25388658	.	T	A	4	7	11	0	0	11	0	0
13	25403790	.	C	A	0	2	2	0	1	3	0	0
13	25428952	.	C	G	11	15	26	0	1	27	0	0
13	25429048	.	T	A	8	8	16	0	0	16	0	0
13	25429079	.	C	T	9	4	13	0	0	13	0	0
13	25429145	.	G	A	6	5	11	0	0	11	0	0
13	25436336	.	A	T	13	7	20	0	0	20	0	0
13	25436360	.	A	T	9	7	16	0	0	16	0	0
13	25436381	.	G	A	6	8	14	0	0	14	0	0
13	25449688	.	A	C	2	4	6	0	0	6	0	0
13	25470770	.	A	G	3	2	5	0	0	5	0	0
13	25470962	.	G	A	0	3	3	0	1	4	0	0
13	25472735	.	G	A	14	18	32	0	2	34	0	0
13	25472756	.	T	C	16	14	30	0	4	34	0	0
13	25472859	.	G	A	23	11	34	0	2	36	0	0
13	25473039	.	C	T	30	17	47	0	0	47	0	0
13	25473325	.	G	A	21	15	36	0	0	36	0	0
13	25475889	.	C	T	11	14	25	0	0	25	0	0
13	25475904	.	A	G	12	14	26	0	1	27	0	0
13	25477249	.	G	A	15	10	25	0	1	26	0	0
13	25478749	.	A	T	2	2	4	0	1	5	0	0
13	25484638	.	G	T	8	15	23	0	2	25	0	0
13	25492923	.	A	T	8	7	15	0	1	16	0	0
13	25492992	.	C	G	8	5	13	0	1	14	0	0
13	25497320	.	A	G	11	0	11	0	10	21	0	0
13	25497575	.	T	C	7	6	13	0	0	13	0	0
13	25497581	.	C	T	6	6	12	0	1	13	0	0
13	25497700	.	G	C	12	6	18	0	1	19	0	0
13	25497880	.	T	C	11	9	20	0	0	20	0	0
13	25516204	.	T	C	1	5	6	0	0	6	0	0
13	25519063	.	G	A	0	3	3	0	3	6	0	0
13	25523629	.	T	C	0	4	4	0	1	5	0	0
13	25523677	.	G	A	0	8	8	0	4	12	0	0
13	25530063	.	C	T	6	4	10	0	0	10	0	0
13	25532352	.	C	T	15	11	26	0	0	26	0	0
13	25532509	.	T	A	11	13	24	0	1	25	0	0
13	25532574	.	C	A	15	12	27	0	0	27	0	0
13	25532706	.	T	C	2	11	13	0	0	13	0	0
13	25533175	.	T	C	18	19	37	0	0	37	0	0
13	25533233	.	G	A	12	16	28	0	1	29	0	0
13	25533258	.	T	A	13	10	23	0	4	28	1	0
13	25533588	.	C	T	0	7	7	0	1	8	0	0
13	25533657	.	C	G	10	1	11	0	9	20	0	0
13	25534165	.	T	C	8	10	18	0	1	19	0	0
13	25534407	.	C	T	21	10	31	0	1	32	0	0
13	25535405	.	G	A	2	3	5	0	0	5	0	0
13	25551722	.	A	G	2	0	2	0	3	5	0	0
13	25551781	.	C	A	4	3	7	0	1	8	0	0
13	25551865	.	T	C	5	2	7	1	1	9	0	0
13	25554553	.	T	G	3	0	3	0	2	5	0	0
13	25559610	.	G	A	4	10	14	0	1	15	0	0
13	25560416	.	C	T	3	4	7	0	1	8	0	0
13	25563221	.	C	A	6	5	11	0	0	11	0	0
13	25565379	.	T	C	10	16	26	0	1	27	0	0
13	25566205	.	A	T	4	3	7	0	0	7	0	0
13	25566222	.	C	T	4	3	7	0	0	7	0	0
13	25569865	.	A	G	9	8	17	0	1	18	0	0
13	25569874	.	A	G	8	9	17	0	1	18	0	0
13	25569940	.	A	C	7	7	14	0	0	14	0	0
13	25570008	.	T	C	4	6	10	0	0	10	0	0
13	25570013	.	C	T	2	4	6	0	2	8	0	0
13	25570104	.	C	T	4	4	8	0	1	9	0	0
13	25570108	.	T	A	5	4	9	0	0	9	0	0
13	25570341	.	T	C	6	0	6	0	5	11	0	0
13	25570427	.	T	A	14	7	21	0	0	21	0	0
13	25570561	.	A	C	5	4	9	0	2	11	0	0
13	25570842	.	A	T	9	6	15	0	0	15	0	0
13	25571038	.	T	C	7	4	11	0	1	12	0	0
13	25571113	.	A	T	4	7	11	0	0	11	0	0
13	25571274	.	C	T	12	6	18	0	0	18	0	0
13	25573189	.	G	A	5	4	9	0	0	9	0	0
13	25573397	.	C	T	6	4	10	0	0	10	0	0
13	25575396	.	C	T	10	8	18	0	1	19	0	0
13	25575411	.	A	C	8	10	18	0	0	18	0	0
13	25575453	.	G	A	9	7	16	0	1	17	0	0
13	25581121	.	T	C	2	5	7	0	0	7	0	0
13	25584993	.	A	T	6	3	9	0	0	9	0	0
13	25589241	.	G	A	4	7	11	0	0	11	0	0
13	25590777	.	G	A	1	3	4	0	0	4	0	0
13	25593832	.	T	C	2	2	4	0	0	4	0	0
13	25724747	.	G	A	7	9	16	0	1	17	0	0
13	25726378	.	C	G	3	4	7	0	0	7	0	0
13	25728037	.	G	A	3	3	6	0	0	6	0	0
13	25728453	.	A	C	4	8	12	0	0	12	0	0
13	25728606	.	A	T	3	3	6	0	1	7	0	0
13	25728738	.	A	C	2	3	5	0	0	5	0	0
13	25728747	.	A	G	2	4	6	0	0	6	0	0
13	25728836	.	T	C	1	3	4	0	0	4	0	0
13	25729440	.	G	A	6	5	11	0	0	11	0	0
13	25730774	.	C	T	1	3	4	0	0	4	0	0
13	25824616	.	T	A	11	10	21	0	3	24	0	0
13	25824718	.	C	T	14	20	34	0	0	34	0	0
13	25825016	.	G	A	18	19	37	0	1	38	0	0
13	25825263	.	A	T	4	8	12	0	0	12	0	0
13	25826362	.	T	C	13	0	13	0	17	30	0	0
13	25827129	.	T	G	13	17	30	0	3	33	0	0
13	25827421	.	G	A	14	17	31	0	1	32	0	0
13	25846994	.	C	A	14	14	28	0	1	29	0	0
13	25847136	.	T	A	5	14	19	0	1	20	0	0
13	25847144	.	G	T	5	11	16	0	0	16	0	0
13	25847176	.	G	A	6	8	14	0	0	14	0	0
13	25847226	.	T	G	8	4	12	0	0	12	0	0
13	25847297	.	T	A	8	3	11	0	1	12	0	0
13	25847973	.	G	T	3	7	10	0	0	10	0	0
13	25848093	.	T	C	9	5	14	0	1	15	0	0
13	25849102	.	T	C	1	0	1	0	5	6	0	0
13	25849123	.	A	G	0	5	5	0	0	5	0	0
13	25849149	.	T	A	5	4	9	0	0	9	0	0
13	25849294	.	T	G	7	7	14	0	0	14	0	0
13	25849511	.	T	C	1	0	1	0	3	4	0	0
13	25849572	.	G	A	1	3	4	0	0	4	0	0
13	25849992	.	A	T	2	3	5	0	0	5	0	0
13	25850874	.	G	A	8	4	12	0	1	13	0	0
13	25851321	.	G	A	3	2	5	0	0	5	0	0
13	25851332	.	T	A	2	2	4	0	0	4	0	0
13	25851412	.	C	G	3	6	9	0	0	10	1	0
13	25851753	.	C	T	4	2	6	0	0	6	0	0
13	25851883	.	G	A	4	3	7	0	0	7	0	0
13	25852787	.	A	G	6	1	7	1	1	9	0	0
13	27036660	.	T	C	3	12	15	0	1	16	0	0
13	28650731	.	A	C	1	0	1	0	16	18	1	0
13	28744141	.	A	T	10	3	13	0	2	15	0	0
13	29773249	.	T	C	5	2	7	0	0	7	0	0
13	30520925	.	T	C	1	2	3	0	1	4	0	0
13	30917683	.	C	T	1	2	3	0	0	3	0	0
13	32446278	.	G	A	9	5	14	0	0	14	0	0
13	32452924	.	G	T	3	6	9	0	0	9	0	0
13	32453281	.	C	T	2	3	5	0	0	5	0	0
13	32453362	.	T	G	6	4	10	0	0	10	0	0
13	32453661	.	G	T	2	4	6	0	0	6	0	0
13	32453721	.	A	C	4	3	7	0	0	7	0	0
13	32453730	.	C	T	5	3	8	0	0	8	0	0
13	32454546	.	A	G	6	0	6	0	7	13	0	0
13	32454617	.	G	A	1	6	7	0	2	9	0	0
13	32455739	.	C	A	7	7	14	0	1	15	0	0
13	32455754	.	C	T	9	5	14	0	0	14	0	0
13	32456350	.	G	A	5	4	9	0	0	9	0	0
13	32456624	.	C	T	2	3	5	0	0	5	0	0
13	32576853	.	T	C	2	2	4	0	0	4	0	0
13	32580572	.	A	C	6	5	11	0	0	11	0	0
13	32580616	.	G	A	7	9	16	0	0	16	0	0
13	32580618	.	C	G	7	9	16	0	0	16	0	0
13	32583864	.	C	T	4	10	14	0	0	14	0	0
13	32583915	.	G	A	13	6	19	0	1	20	0	0
13	32595257	.	C	T	12	4	16	0	0	16	0	0
13	32630241	.	C	G	2	2	4	0	0	4	0	0
13	32638668	.	C	T	11	5	16	0	0	16	0	0
13	32641146	.	A	T	3	4	7	0	2	9	0	0
13	32641767	.	T	G	2	4	6	0	0	6	0	0
13	32642185	.	A	G	2	3	5	0	0	5	0	0
13	32642215	.	A	G	4	3	7	0	1	8	0	0
13	32642251	.	G	A	8	9	17	0	0	17	0	0
13	32642293	.	A	G	8	4	12	0	1	13	0	0
13	32642369	.	T	C	5	5	10	0	1	11	0	0
13	32642410	.	G	T	10	7	17	0	2	19	0	0
13	32642528	.	A	T	7	13	20	0	2	22	0	0
13	32642568	.	A	T	8	6	14	0	3	17	0	0
13	32642618	.	T	A	3	4	7	0	0	7	0	0
13	32642690	.	T	C	3	4	7	0	0	7	0	0
13	32642964	.	C	T	7	3	10	0	0	10	0	0
13	32643143	.	G	A	1	3	4	0	0	4	0	0
13	32643366	.	G	A	4	3	7	0	0	7	0	0
13	32643840	.	A	G	5	2	7	0	0	7	0	0
13	32643891	.	G	A	4	2	6	0	1	7	0	0
13	32644425	.	C	T	0	2	2	0	3	5	0	0
13	32645082	.	T	G	2	3	5	0	0	5	0	0
13	32648327	.	A	G	1	4	5	0	0	5	0	0
13	32660782	.	G	A	2	3	5	0	0	5	0	0
13	32754282	.	C	T	1	3	4	0	0	4	0	0
13	32754291	.	T	C	2	2	4	0	1	5	0	0
13	32794025	.	T	G	1	0	1	0	7	8	0	0
13	32794214	.	G	A	4	2	6	0	0	6	0	0
13	32794999	.	C	T	3	5	8	0	2	10	0	0
13	32795387	.	T	C	2	4	6	0	1	7	0	0
13	32807491	.	C	T	3	2	5	0	0	5	0	0
13	32807497	.	T	G	2	1	3	0	2	5	0	0
13	32812168	.	G	A	1	3	4	0	0	4	0	0
13	32812332	.	A	G	3	3	6	0	0	6	0	0
13	32812788	.	A	C	4	2	6	0	1	7	0	0
13	32815668	.	G	A	6	8	14	0	0	14	0	0
13	32815884	.	T	C	9	8	17	0	1	18	0	0
13	32815981	.	A	T	15	11	26	0	0	26	0	0
13	32816055	.	G	C	10	8	18	0	1	19	0	0
13	32816128	.	T	G	18	15	33	0	0	33	0	0
13	32816338	.	C	G	15	5	20	0	2	22	0	0
13	32825503	.	A	G	14	7	21	0	2	23	0	0
13	32826966	.	T	C	6	9	15	0	1	16	0	0
13	32826978	.	A	G	8	7	15	0	1	16	0	0
13	32830255	.	G	T	9	7	16	0	0	16	0	0
13	32831770	.	C	T	7	2	9	0	0	9	0	0
13	32831965	.	T	C	7	10	17	0	1	18	0	0
13	32831971	.	T	C	6	9	15	0	1	16	0	0
13	32832055	.	A	G	12	7	19	0	0	19	0	0
13	32832058	.	T	A	10	7	17	0	1	18	0	0
13	32833326	.	T	C	7	8	15	0	0	15	0	0
13	32833359	.	A	G	6	10	16	0	0	16	0	0
13	32833364	.	A	C	6	8	14	0	2	16	0	0
13	32834925	.	T	C	5	9	14	0	1	15	0	0
13	32838241	.	C	A	6	3	9	0	2	11	0	0
13	32844777	.	C	T	0	5	5	0	4	9	0	0
13	32993962	.	C	T	0	7	7	0	16	23	0	0
13	32994526	.	T	C	14	14	28	0	0	28	0	0
13	32994565	.	T	A	8	9	17	0	1	18	0	0
13	32994697	.	G	T	5	8	13	0	0	13	0	0
13	32994736	.	A	G	3	9	12	0	0	12	0	0
13	32994841	.	A	G	7	6	13	0	1	14	0	0
13	32997196	.	A	T	9	10	19	0	1	21	1	0
13	32997224	.	C	A	9	20	29	0	2	31	0	0
13	32997260	.	T	C	6	12	18	0	0	18	0	0
13	32997424	.	G	T	11	12	23	3	0	26	0	0
13	32997517	.	T	A	8	18	26	2	5	33	0	0
13	33000574	.	C	T	1	19	20	0	14	34	0	0
13	33000586	.	T	C	13	19	32	0	2	34	0	0
13	33005284	.	T	C	12	33	45	0	0	45	0	0
13	33005346	.	G	A	9	45	54	0	0	54	0	0
13	33007766	.	C	T	14	32	46	1	5	52	0	0
13	33020054	.	T	C	2	1	3	0	6	9	0	0
13	33021814	.	G	T	5	5	10	0	1	11	0	0
13	33024599	.	C	A	2	4	6	0	0	6	0	0
13	33024743	.	A	C	3	3	6	0	1	7	0	0
13	33024789	.	G	C	12	12	24	0	0	24	0	0
13	33028797	.	A	G	18	14	32	0	1	33	0	0
13	33029576	.	A	T	21	15	36	0	1	37	0	0
13	33029594	.	G	A	1	9	10	0	22	32	0	0
13	33033330	.	C	T	19	17	36	0	0	36	0	0
13	33033688	.	T	C	22	25	47	0	2	49	0	0
13	33040593	.	A	G	1	4	5	0	1	6	0	0
13	33041118	.	C	A	2	2	4	0	0	4	0	0
13	33041157	.	T	G	4	3	7	0	0	7	0	0
13	33041354	.	A	C	3	5	8	0	0	8	0	0
13	33048096	.	G	A	8	8	16	0	0	16	0	0
13	33059179	.	C	T	14	4	18	0	0	18	0	0
13	33059182	.	C	T	6	15	21	0	0	21	0	0
13	33062367	.	C	T	16	12	28	0	0	28	0	0
13	33065670	.	G	A	6	13	19	0	2	21	0	0
13	33067622	.	T	C	1	4	5	0	0	5	0	0
13	33070366	.	G	A	1	2	3	0	0	3	0	0
13	33078885	.	C	A	1	3	4	0	3	7	0	0
13	33079542	.	T	G	3	2	5	0	0	5	0	0
13	33081822	.	G	T	2	2	4	0	0	4	0	0
13	33093724	.	G	T	1	2	3	0	1	4	0	0
13	33122120	.	G	A	3	9	12	0	0	12	0	0
13	33122312	.	C	A	9	8	17	0	1	18	0	0
13	33122586	.	G	A	4	7	11	0	0	11	0	0
13	33122594	.	G	A	3	9	12	0	0	12	0	0
13	33122847	.	T	G	13	0	13	0	9	22	0	0
13	33122853	.	C	A	13	9	22	0	1	23	0	0
13	33122941	.	C	T	17	12	29	0	2	31	0	0
13	33122949	.	G	C	17	8	25	0	1	26	0	0
13	33123031	.	T	A	11	12	23	0	0	23	0	0
13	33123154	.	C	A	6	11	17	0	0	17	0	0
13	33174415	.	A	T	3	6	9	0	1	10	0	0
13	33174533	.	G	A	9	5	14	0	0	14	0	0
13	33174681	.	G	A	9	3	12	0	0	12	0	0
13	33174732	.	A	G	7	7	14	0	0	14	0	0
13	33174759	.	G	A	10	6	16	0	0	16	0	0
13	33174964	.	T	C	6	0	6	0	5	11	0	0
13	33175126	.	C	A	3	4	7	0	0	7	0	0
13	33175314	.	A	G	3	5	8	0	1	9	0	0
13	33177637	.	A	G	9	6	15	0	1	16	0	0
13	33187199	.	G	A	4	6	10	0	2	12	0	0
13	33187760	.	G	A	1	6	7	0	1	8	0	0
13	33190239	.	G	C	3	0	3	0	5	8	0	0
13	33190245	.	A	G	5	3	8	0	0	8	0	0
13	33194242	.	C	T	4	4	8	0	1	9	0	0
13	33194245	.	A	G	4	3	7	0	1	8	0	0
13	33194458	.	G	A	5	4	9	0	0	9	0	0
13	33195115	.	C	T	5	5	10	0	0	10	0	0
13	33197959	.	G	C	2	5	7	0	0	7	0	0
13	33198000	.	C	T	4	2	6	0	0	6	0	0
13	33200432	.	A	G	1	2	3	0	0	3	0	0
13	33211397	.	T	A	6	9	15	0	1	17	1	0
13	33214492	.	T	C	8	11	19	0	2	21	0	0
13	33214804	.	G	A	13	14	27	0	3	30	0	0
13	33214985	.	C	T	15	6	21	1	0	22	0	0
13	33224678	.	G	A	8	2	10	0	2	12	0	0
13	33224706	.	T	G	7	2	9	0	6	15	0	0
13	33224716	.	G	A	12	8	20	0	1	21	0	0
13	33224932	.	C	T	1	9	10	0	8	18	0	0
13	33225029	.	G	A	2	5	7	0	0	7	0	0
13	33225049	.	A	G	9	4	13	0	1	14	0	0
13	33227271	.	G	C	7	9	16	0	1	17	0	0
13	33230436	.	C	A	14	16	30	1	0	31	0	0
13	33234522	.	C	T	0	11	11	0	23	34	0	0
13	33236691	.	A	G	14	15	29	0	2	31	0	0
13	33236902	.	C	T	12	10	22	0	0	22	0	0
13	33238954	.	A	G	10	15	25	0	2	27	0	0
13	33238960	.	G	A	10	17	27	0	0	27	0	0
13	33239219	.	G	A	14	9	23	0	0	23	0	0
13	33239237	.	T	C	8	0	8	0	10	18	0	0
13	33246934	.	A	C	2	3	5	0	0	5	0	0
13	33248351	.	C	T	12	7	19	0	0	19	0	0
13	33248443	.	T	C	8	8	16	0	2	18	0	0
13	33248677	.	T	A	8	14	22	0	3	25	0	0
13	33261228	.	C	T	15	27	42	0	0	42	0	0
13	33261303	.	A	T	28	30	58	0	1	59	0	0
13	33261326	.	A	T	30	23	53	0	0	53	0	0
13	33261340	.	C	T	28	23	51	0	2	53	0	0
13	33261389	.	T	G	33	20	53	0	1	54	0	0
13	33261577	.	C	G	31	18	49	0	0	49	0	0
13	33261889	.	C	T	27	22	49	0	0	49	0	0
13	33262044	.	C	A	28	27	55	0	2	57	0	0
13	33262721	.	A	T	21	9	30	0	0	30	0	0
13	33262749	.	A	C	19	17	36	0	2	38	0	0
13	33262956	.	C	A	18	16	34	0	2	36	0	0
13	33262997	.	A	G	18	23	41	0	0	41	0	0
13	33263203	.	C	T	0	5	5	0	4	9	0	0
13	33263213	.	G	A	2	6	8	0	0	8	0	0
13	33263385	.	G	A	7	3	10	1	0	11	0	0
13	33263503	.	G	T	20	16	36	0	4	40	0	0
13	33263568	.	G	A	21	19	40	0	1	41	0	0
13	33263940	.	T	C	21	10	31	0	2	33	0	0
13	33264315	.	T	C	10	20	30	0	5	35	0	0
13	33264318	.	C	T	16	17	33	0	5	38	0	0
13	33264470	.	A	G	14	20	34	0	1	35	0	0
13	33265061	.	G	T	19	10	29	0	1	30	0	0
13	33265062	.	G	T	20	11	31	0	0	31	0	0
13	33265323	.	A	C	18	8	26	0	3	29	0	0
13	33265364	.	G	T	20	16	36	0	0	36	0	0
13	33268757	.	A	T	3	5	8	0	2	10	0	0
13	33268791	.	T	C	2	4	6	0	0	6	0	0
13	33273081	.	C	A	3	2	5	0	0	5	0	0
13	33276011	.	G	A	1	3	4	0	0	4	0	0
13	33276106	.	T	C	2	5	7	0	0	7	0	0
13	33276156	.	T	C	1	3	4	0	0	4	0	0
13	33280769	.	C	A	2	2	4	0	1	5	0	0
13	33281138	.	G	T	0	8	8	0	3	11	0	0
13	33281218	.	G	A	0	3	3	0	4	7	0	0
13	33282130	.	G	A	3	5	8	0	1	9	0	0
13	33282138	.	G	T	0	4	4	0	6	10	0	0
13	33282227	.	G	A	7	7	14	0	0	14	0	0
13	33282236	.	A	G	6	4	10	0	1	11	0	0
13	33298859	.	G	C	1	3	4	0	0	4	0	0
13	33311074	.	G	A	2	3	5	0	0	5	0	0
13	33314521	.	C	T	5	5	10	0	1	11	0	0
13	33314733	.	A	T	0	3	3	0	0	4	1	0
13	33314756	.	A	C	1	0	1	0	2	3	0	0
13	33315099	.	T	C	5	0	5	0	8	13	0	0
13	33368549	.	T	A	1	3	4	0	1	5	0	0
13	33368577	.	C	G	3	3	6	0	0	6	0	0
13	33394159	.	A	T	4	2	6	0	0	6	0	0
13	33396343	.	C	T	5	5	10	0	17	27	0	0
13	33398445	.	C	A	3	18	21	0	19	40	0	0
13	33398668	.	C	A	7	3	10	0	0	10	0	0
13	33445288	.	C	T	4	4	8	0	0	8	0	0
13	33447088	.	C	G	5	4	9	0	0	9	0	0
13	33447137	.	A	G	1	2	3	0	0	3	0	0
13	33447260	.	C	T	3	2	5	0	0	5	0	0
13	33447281	.	A	G	1	3	4	0	0	4	0	0
13	33448057	.	T	G	1	6	7	0	0	7	0	0
13	33448063	.	T	A	1	5	6	0	0	6	0	0
13	33448134	.	A	G	2	4	6	0	0	6	0	0
13	33609129	.	T	C	3	5	8	0	0	8	0	0
13	33612347	.	C	T	7	5	12	0	2	14	0	0
13	33614712	.	C	A	9	14	23	0	1	24	0	0
13	33614751	.	T	C	9	9	18	0	2	20	0	0
13	33616880	.	T	C	4	0	4	0	4	8	0	0
13	33617129	.	T	A	8	4	12	0	0	12	0	0
13	33622486	.	A	G	7	5	12	0	1	13	0	0
13	33622519	.	T	C	3	3	6	0	1	7	0	0
13	33624713	.	C	G	5	6	11	0	0	11	0	0
13	33631381	.	T	A	2	4	6	0	0	6	0	0
13	33633303	.	A	C	6	3	9	0	0	9	0	0
13	33633313	.	T	C	5	3	8	0	0	8	0	0
13	33633344	.	G	A	3	3	6	0	0	6	0	0
13	33636034	.	A	G	4	2	6	0	1	7	0	0
13	33636073	.	G	T	2	5	7	0	0	7	0	0
13	33636505	.	T	G	5	3	8	0	0	8	0	0
13	33636597	.	G	A	3	3	6	0	1	7	0	0
13	33636814	.	G	A	3	5	8	0	0	8	0	0
13	33645567	.	C	T	5	9	14	0	2	16	0	0
13	33645569	.	C	T	11	6	17	0	1	18	0	0
13	33645649	.	A	T	7	5	12	0	1	13	0	0
13	33645754	.	T	C	2	5	7	0	0	7	0	0
13	33645838	.	A	C	6	2	8	0	0	8	0	0
13	33645839	.	A	T	6	2	8	0	0	8	0	0
13	33645892	.	C	T	2	4	6	0	0	6	0	0
13	33645922	.	C	T	2	2	4	0	0	4	0	0
13	33646063	.	C	G	7	4	11	0	0	11	0	0
13	33646123	.	T	A	3	10	13	0	0	13	0	0
13	33646132	.	A	T	2	9	11	0	0	11	0	0
13	33646615	.	G	A	7	3	10	0	0	10	0	0
13	33650091	.	T	A	5	2	7	0	0	7	0	0
13	33655460	.	C	A	1	3	4	0	0	4	0	0
13	33655493	.	T	A	1	3	4	0	0	4	0	0
13	33655947	.	T	C	3	1	4	0	0	4	0	0
13	33655957	.	A	T	1	2	3	0	0	3	0	0
13	33658653	.	T	A	2	3	5	0	0	5	0	0
13	33658722	.	A	G	2	3	5	0	0	5	0	0
13	33665483	.	G	T	3	2	5	0	0	5	0	0
13	33682216	.	C	T	17	20	37	1	2	40	0	0
13	33682217	.	A	T	18	17	35	1	4	40	0	0
13	33682379	.	C	A	19	11	30	0	2	32	0	0
13	33682474	.	T	G	2	6	8	0	0	8	0	0
13	33682482	.	A	T	2	6	8	0	0	8	0	0
13	33682541	.	G	A	5	2	7	0	2	9	0	0
13	33682617	.	T	C	7	5	12	0	2	14	0	0
13	33682682	.	G	A	25	24	49	0	2	51	0	0
13	33683609	.	T	C	24	39	63	0	4	67	0	0
13	33683696	.	A	G	35	29	64	0	1	65	0	0
13	33683701	.	G	C	34	29	63	0	1	64	0	0
13	33692400	.	G	C	2	2	4	0	0	4	0	0
13	33695290	.	T	C	3	2	5	0	0	5	0	0
13	33813452	.	T	G	11	10	21	0	0	21	0	0
13	33813792	.	C	T	8	9	17	0	0	17	0	0
13	33814644	.	A	C	8	6	14	0	0	14	0	0
13	33814647	.	T	A	7	6	13	0	1	14	0	0
13	33814773	.	C	T	8	8	16	0	2	18	0	0
13	33815863	.	C	A	6	8	14	0	1	15	0	0
13	33815992	.	C	T	4	4	8	0	0	8	0	0
13	33816442	.	C	T	5	3	8	0	0	8	0	0
13	33968509	.	C	T	7	10	17	0	1	18	0	0
13	34217398	.	C	T	12	10	22	0	3	25	0	0
13	34483567	.	G	A	1	12	13	0	14	27	0	0
13	34488737	.	T	G	13	7	20	0	0	21	1	0
13	34523224	.	G	A	19	13	32	0	0	32	0	0
13	34554179	.	C	T	20	14	34	0	0	34	0	0
13	34703994	.	T	C	2	3	5	0	0	5	0	0
13	34745959	.	C	T	1	2	3	0	0	3	0	0
13	34746671	.	G	A	3	4	7	0	0	7	0	0
13	34746674	.	A	G	5	0	5	0	2	7	0	0
13	34746713	.	C	G	3	0	3	0	3	6	0	0
13	34746847	.	A	G	3	4	7	0	1	8	0	0
13	34746980	.	A	G	5	3	8	0	0	8	0	0
13	34747073	.	G	T	2	2	4	0	0	4	0	0
13	34747819	.	A	T	3	4	7	0	1	8	0	0
13	34748062	.	A	T	6	7	13	0	0	13	0	0
13	34748199	.	C	A	9	3	12	0	0	12	0	0
13	34748362	.	C	T	2	2	4	0	0	4	0	0
13	34748516	.	C	T	7	7	14	0	1	15	0	0
13	34748527	.	G	A	9	7	16	0	0	16	0	0
13	34748570	.	C	A	4	6	10	0	1	11	0	0
13	34748642	.	T	A	3	6	9	0	1	10	0	0
13	34748791	.	G	T	2	4	6	0	1	7	0	0
13	34748959	.	A	T	3	9	12	0	1	13	0	0
13	34748990	.	T	A	1	7	8	0	0	8	0	0
13	34749240	.	G	A	1	2	3	0	0	3	0	0
13	34749241	.	T	A	1	2	3	0	0	3	0	0
13	34749405	.	A	C	4	3	7	0	0	7	0	0
13	34749530	.	G	T	3	3	6	0	7	13	0	0
13	34749542	.	A	G	7	4	11	0	1	12	0	0
13	34749616	.	C	T	8	5	13	0	1	14	0	0
13	34749693	.	C	T	7	3	10	0	1	11	0	0
13	34749743	.	G	T	4	7	11	0	2	13	0	0
13	34749786	.	A	C	9	6	15	0	0	15	0	0
13	34750212	.	A	T	2	1	3	0	1	4	0	0
13	34765346	.	T	G	2	5	7	0	0	7	0	0
13	34765639	.	G	A	5	2	7	0	0	7	0	0
13	34766034	.	C	A	0	5	5	0	4	9	0	0
13	34766238	.	G	A	6	2	8	0	0	8	0	0
13	35042138	.	C	T	22	21	43	0	0	43	0	0
13	35042237	.	G	A	17	11	28	0	1	29	0	0
13	35042279	.	G	A	17	15	32	0	0	32	0	0
13	35042354	.	G	T	17	15	32	0	0	32	0	0
13	35051624	.	C	T	0	9	9	0	16	25	0	0
13	35051786	.	T	C	5	16	21	0	0	21	0	0
13	35051880	.	G	A	5	7	12	0	1	13	0	0
13	35389195	.	A	G	1	3	4	0	0	4	0	0
13	35389670	.	C	T	2	3	5	0	0	5	0	0
13	35474854	.	G	A	2	2	4	0	0	4	0	0
13	35475021	.	G	A	1	3	4	0	0	4	0	0
13	35510945	.	T	C	6	7	13	0	1	14	0	0
13	35511339	.	A	G	5	6	11	0	0	11	0	0
13	35511612	.	C	T	3	7	10	0	1	11	0	0
13	35522132	.	A	G	3	5	8	0	1	9	0	0
13	35718639	.	T	G	1	2	3	0	0	3	0	0
13	35719007	.	A	C	1	2	3	0	0	3	0	0
13	35720987	.	C	T	2	3	5	0	0	5	0	0
13	35723453	.	G	A	1	2	3	0	0	3	0	0
13	35726735	.	G	C	3	3	6	0	0	6	0	0
13	35744431	.	T	A	2	3	5	0	1	6	0	0
13	35744630	.	A	T	2	2	4	0	0	4	0	0
13	35745686	.	T	C	9	7	16	0	1	17	0	0
13	35746343	.	A	G	5	1	6	0	8	14	0	0
13	35746637	.	C	T	8	7	15	0	0	15	0	0
13	35746775	.	T	C	6	8	14	0	1	15	0	0
13	35747177	.	T	G	15	12	27	0	4	31	0	0
13	35747420	.	T	C	10	9	19	0	0	19	0	0
13	35747510	.	G	A	16	13	29	0	1	30	0	0
13	35747564	.	A	G	10	19	29	0	2	31	0	0
13	35748109	.	C	G	20	12	32	0	1	33	0	0
13	35748144	.	A	G	20	11	31	0	1	32	0	0
13	35748238	.	T	A	14	22	36	0	1	37	0	0
13	35748249	.	G	A	24	12	36	0	1	37	0	0
13	35748412	.	A	C	17	15	32	0	1	34	1	0
13	35748541	.	G	A	4	3	7	0	0	7	0	0
13	35750836	.	G	A	7	8	15	0	1	16	0	0
13	35751162	.	T	A	10	14	24	0	1	25	0	0
13	35753242	.	G	A	9	7	16	0	0	16	0	0
13	35757260	.	G	A	8	5	13	0	0	13	0	0
13	35758093	.	T	C	6	0	6	0	7	13	0	0
13	35758111	.	G	T	5	6	11	0	0	11	0	0
13	35758223	.	G	A	5	8	13	1	2	16	0	0
13	35759904	.	G	A	8	9	17	0	1	18	0	0
13	35787680	.	G	T	6	2	8	0	0	8	0	0
13	35788128	.	G	T	13	14	27	0	1	28	0	0
13	35788222	.	G	A	8	11	19	0	0	19	0	0
13	35788302	.	A	C	7	14	21	0	1	22	0	0
13	35788313	.	T	C	8	14	22	0	0	22	0	0
13	35791455	.	A	G	16	8	24	0	1	25	0	0
13	35796882	.	C	T	11	8	19	0	1	20	0	0
13	35796894	.	G	A	13	9	22	0	0	22	0	0
13	35796924	.	C	T	0	5	5	0	15	20	0	0
13	35798960	.	T	C	3	12	15	0	1	16	0	0
13	35798966	.	G	C	3	11	14	0	0	14	0	0
13	35801258	.	G	A	3	10	13	0	1	14	0	0
13	35803109	.	T	C	4	0	4	0	14	18	0	0
13	35808197	.	G	T	10	7	17	0	2	19	0	0
13	35811852	.	C	G	5	3	8	0	0	8	0	0
13	35813549	.	A	G	7	5	12	0	0	12	0	0
13	35813666	.	C	T	0	6	6	0	7	13	0	0
13	35814762	.	A	T	3	4	7	0	0	7	0	0
13	35821652	.	T	A	2	3	5	0	0	5	0	0
13	35821781	.	G	A	2	2	4	0	1	5	0	0
13	35824278	.	A	G	3	3	6	0	0	6	0	0
13	35824488	.	G	C	1	4	5	0	0	5	0	0
13	35824599	.	A	G	1	5	6	0	0	6	0	0
13	35824806	.	A	G	1	2	3	0	0	3	0	0
13	35825145	.	A	G	2	3	5	0	0	5	0	0
13	35856539	.	G	T	1	2	3	0	0	3	0	0
13	35866465	.	G	C	3	3	6	0	0	6	0	0
13	35866561	.	G	T	6	3	9	0	0	9	0	0
13	35866675	.	T	G	2	3	5	0	0	5	0	0
13	35871825	.	C	T	8	6	14	0	0	14	0	0
13	35872125	.	A	T	6	5	11	0	0	11	0	0
13	35872207	.	C	T	6	4	10	0	0	10	0	0
13	35904775	.	C	G	1	2	3	0	1	4	0	0
13	35905265	.	A	G	4	6	10	0	0	10	0	0
13	35907167	.	G	A	3	1	4	0	0	4	0	0
13	35907171	.	A	C	3	2	5	0	0	5	0	0
13	35925490	.	A	T	1	2	3	0	0	3	0	0
13	35931116	.	G	A	0	2	2	0	1	3	0	0
13	35941320	.	G	C	0	2	2	0	1	3	0	0
13	35950720	.	G	A	5	3	8	0	0	8	0	0
13	35950753	.	C	A	8	11	19	0	1	20	0	0
13	35953558	.	G	A	5	5	10	0	0	10	0	0
13	36039807	.	T	C	17	8	25	0	1	26	0	0
13	36039828	.	T	C	16	0	16	0	10	26	0	0
13	36039938	.	G	A	31	21	52	0	3	55	0	0
13	36040278	.	T	C	16	1	17	0	22	39	0	0
13	36040429	.	C	T	12	11	23	0	1	24	0	0
13	36040611	.	C	T	1	8	9	3	12	24	0	0
13	36042020	.	T	A	20	14	34	0	3	37	0	0
13	36042057	.	C	T	20	14	34	0	1	35	0	0
13	36042091	.	G	C	18	13	31	0	1	32	0	0
13	36043781	.	T	A	18	16	34	0	1	35	0	0
13	36043796	.	T	C	18	2	20	0	16	36	0	0
13	36043820	.	T	C	15	0	15	0	15	30	0	0
13	36044370	.	C	T	7	10	17	0	0	17	0	0
13	36045705	.	G	A	13	16	29	0	0	29	0	0
13	36048658	.	A	C	11	6	17	0	0	17	0	0
13	36048931	.	A	G	5	6	11	0	0	11	0	0
13	36048981	.	C	T	7	10	17	0	1	18	0	0
13	36054289	.	A	G	7	9	16	0	0	16	0	0
13	36054432	.	A	C	3	3	6	0	0	6	0	0
13	36057124	.	C	T	12	9	21	1	2	24	0	0
13	36060640	.	G	A	21	8	29	0	1	30	0	0
13	36060679	.	T	G	13	10	23	0	4	27	0	0
13	36062661	.	T	A	11	7	18	0	1	19	0	0
13	36067938	.	A	G	4	5	9	0	0	9	0	0
13	36072451	.	C	T	1	5	6	0	6	12	0	0
13	36074085	.	T	C	5	0	5	0	8	13	0	0
13	36083861	.	G	A	2	3	5	0	0	5	0	0
13	36084138	.	C	A	0	2	2	0	3	5	0	0
13	36084169	.	C	G	2	4	6	0	0	6	0	0
13	36086415	.	G	A	3	5	8	0	0	8	0	0
13	36086466	.	T	C	7	4	11	0	0	11	0	0
13	36098884	.	G	A	3	2	5	0	0	5	0	0
13	36098899	.	C	A	3	2	5	0	0	5	0	0
13	36102706	.	C	T	0	3	3	0	5	8	0	0
13	36102785	.	T	C	2	4	6	0	0	6	0	0
13	36103082	.	A	G	2	3	5	0	0	5	0	0
13	36103461	.	C	T	2	6	8	0	0	8	0	0
13	36103688	.	A	G	1	2	3	0	0	3	0	0
13	36138360	.	G	A	12	18	30	0	2	32	0	0
13	36139749	.	T	C	4	0	4	0	13	17	0	0
13	36151234	.	G	A	0	13	13	0	9	22	0	0
13	36151407	.	G	C	6	6	12	0	1	13	0	0
13	36151636	.	C	T	13	12	25	0	2	27	0	0
13	36151858	.	G	C	16	19	35	0	2	37	0	0
13	36151868	.	A	G	15	18	33	0	0	33	0	0
13	36152030	.	C	A	16	23	39	0	0	40	1	0
13	36152069	.	A	C	27	19	46	0	0	46	0	0
13	36152102	.	T	A	27	16	43	0	5	48	0	0
13	36152108	.	T	C	33	14	47	0	0	47	0	0
13	36152202	.	T	C	25	16	41	0	1	42	0	0
13	36152269	.	T	G	23	14	37	0	4	41	0	0
13	36152758	.	C	T	11	8	19	0	1	20	0	0
13	36153013	.	C	T	2	3	5	0	1	6	0	0
13	36153021	.	T	G	2	3	5	0	0	5	0	0
13	36164668	.	G	A	4	6	10	0	1	11	0	0
13	36168740	.	G	A	1	7	8	0	1	9	0	0
13	36168846	.	T	C	2	0	2	0	3	5	0	0
13	36168861	.	G	T	3	3	6	0	0	6	0	0
13	36170636	.	A	G	5	3	8	0	0	8	0	0
13	36175915	.	A	G	6	7	13	0	0	13	0	0
13	36530629	.	A	G	34	29	63	0	1	64	0	0
13	36531957	.	A	G	36	33	69	0	1	70	0	0
13	36532607	.	G	T	35	25	60	0	3	63	0	0
13	36532752	.	G	A	33	21	54	5	3	62	0	0
13	36533174	.	C	T	23	23	46	1	4	51	0	0
13	36534273	.	T	C	29	27	56	0	1	57	0	0
13	36537510	.	T	A	12	8	20	0	2	22	0	0
13	36558152	.	C	T	11	3	14	0	2	16	0	0
13	36560808	.	G	A	6	4	10	0	0	10	0	0
13	36568867	.	A	G	15	10	25	0	2	27	0	0
13	36568897	.	G	A	17	9	26	0	2	28	0	0
13	36569020	.	A	T	23	9	32	0	4	36	0	0
13	36569330	.	G	A	22	20	42	0	4	46	0	0
13	36579281	.	G	A	18	11	29	0	0	29	0	0
13	36579356	.	G	C	20	14	34	0	0	34	0	0
13	36589020	.	G	A	22	20	42	0	4	46	0	0
13	36589365	.	C	T	21	17	38	0	0	38	0	0
13	36589401	.	A	G	20	13	33	0	3	36	0	0
13	36589556	.	A	G	17	16	33	0	1	34	0	0
13	36592521	.	A	G	26	1	27	0	22	49	0	0
13	36592619	.	G	T	19	16	35	0	0	35	0	0
13	36592732	.	T	C	11	19	30	0	1	31	0	0
13	36592952	.	A	G	21	14	35	0	0	35	0	0
13	36592969	.	T	C	25	16	41	0	1	42	0	0
13	36593052	.	G	A	23	10	33	0	2	35	0	0
13	36593121	.	C	T	21	10	31	0	0	31	0	0
13	36593278	.	T	C	18	28	46	0	3	49	0	0
13	36593478	.	C	A	8	13	21	0	1	22	0	0
13	36605649	.	G	A	0	13	13	0	14	27	0	0
13	36605682	.	T	C	13	19	32	0	1	33	0	0
13	36605851	.	G	A	5	7	12	0	12	24	0	0
13	36606012	.	C	T	7	7	14	0	1	15	0	0
13	36606023	.	T	C	7	5	12	0	1	13	0	0
13	36606073	.	C	A	12	12	24	0	0	25	1	0
13	36606422	.	C	T	15	11	26	0	1	27	0	0
13	36606576	.	A	G	9	3	12	0	0	12	0	0
13	36606632	.	A	T	10	5	15	0	1	16	0	0
13	36606657	.	C	T	13	8	21	0	1	22	0	0
13	36606724	.	C	A	16	10	26	0	0	26	0	0
13	36606725	.	A	G	16	8	24	0	2	26	0	0
13	36625784	.	T	C	7	8	15	0	0	15	0	0
13	36625821	.	G	A	10	7	17	0	0	17	0	0
13	36636464	.	A	G	18	0	18	0	20	38	0	0
13	36636491	.	C	T	18	22	40	0	0	40	0	0
13	36638783	.	C	T	17	12	29	0	1	30	0	0
13	36638906	.	C	A	2	7	9	0	0	9	0	0
13	36639424	.	A	G	7	14	21	0	0	21	0	0
13	36639598	.	C	T	9	12	21	0	0	21	0	0
13	36640032	.	A	G	16	10	26	0	0	26	0	0
13	36640063	.	G	C	9	8	17	0	1	18	0	0
13	36640555	.	T	G	11	9	20	0	8	28	0	0
13	36647159	.	T	C	5	2	7	0	1	8	0	0
13	36647553	.	C	T	3	4	7	0	1	8	0	0
13	36652625	.	T	G	1	3	4	0	0	4	0	0
13	36655240	.	C	T	4	5	9	0	0	9	0	0
13	36655258	.	T	C	5	3	8	0	0	8	0	0
13	36680611	.	G	A	1	11	12	0	7	19	0	0
13	36683911	.	C	T	7	8	15	0	1	16	0	0
13	36691543	.	T	C	11	15	26	0	0	26	0	0
13	36705895	.	G	A	4	3	7	0	1	8	0	0
13	36706013	.	T	G	8	6	14	0	0	14	0	0
13	36713450	.	T	C	1	6	7	0	0	7	0	0
13	36715699	.	C	A	2	2	4	0	0	4	0	0
13	36717012	.	A	G	3	5	8	2	1	11	0	0
13	36725167	.	G	A	2	1	3	0	1	4	0	0
13	36737056	.	C	T	2	2	4	0	0	4	0	0
13	36761234	.	A	G	1	2	3	0	0	3	0	0
13	36764791	.	C	T	9	24	33	0	1	34	0	0
13	36764838	.	C	G	9	15	24	0	0	24	0	0
13	36771815	.	G	A	10	10	20	0	0	20	0	0
13	36781068	.	G	C	0	16	16	0	11	27	0	0
13	36781407	.	A	G	32	0	32	0	19	51	0	0
13	36783998	.	G	A	5	19	24	0	22	46	0	0
13	36784262	.	G	A	0	11	11	0	13	24	0	0
13	36787607	.	C	G	1	2	3	0	0	3	0	0
13	36795509	.	T	C	3	0	3	0	3	6	0	0
13	36795684	.	G	A	1	2	3	0	0	3	0	0
13	36800799	.	C	T	6	4	10	0	0	10	0	0
13	36801219	.	T	G	1	2	3	0	0	3	0	0
13	36854330	.	C	T	1	2	3	0	0	3	0	0
13	36868564	.	G	A	20	12	32	0	1	33	0	0
13	36868635	.	T	G	22	13	35	0	3	38	0	0
13	36868938	.	C	A	26	22	48	1	4	53	0	0
13	36869639	.	C	T	4	23	27	1	34	62	0	0
13	36872777	.	A	G	28	16	44	0	2	46	0	0
13	36872814	.	A	C	24	0	24	0	20	44	0	0
13	36879965	.	T	C	16	0	16	0	14	30	0	0
13	36879983	.	G	A	11	13	24	0	0	24	0	0
13	36880028	.	A	C	5	0	5	0	15	20	0	0
13	36887746	.	C	A	1	13	14	1	13	28	0	0
13	36887779	.	G	A	13	14	27	1	4	32	0	0
13	36898229	.	G	A	13	14	27	0	0	27	0	0
13	36910378	.	G	A	17	7	24	0	1	25	0	0
13	36910387	.	C	T	14	5	19	0	2	21	0	0
13	36910591	.	A	G	11	7	18	0	1	19	0	0
13	36910729	.	G	C	14	15	29	0	3	32	0	0
13	36911037	.	T	C	16	1	17	0	11	28	0	0
13	36923217	.	A	C	5	3	8	0	1	9	0	0
13	36923228	.	G	C	5	3	8	0	0	8	0	0
13	36932023	.	C	T	10	10	20	0	0	20	0	0
13	36932289	.	G	A	5	6	11	0	0	11	0	0
13	36932907	.	G	A	4	2	6	0	1	7	0	0
13	36932912	.	A	G	4	3	7	0	0	7	0	0
13	36932970	.	T	G	3	2	5	0	1	6	0	0
13	36933206	.	C	T	4	4	8	0	0	8	0	0
13	36979267	.	T	C	1	2	3	0	0	3	0	0
13	36994954	.	T	G	5	5	10	0	0	10	0	0
13	36995344	.	A	G	5	2	7	0	0	7	0	0
13	36995363	.	C	G	4	4	8	1	1	10	0	0
13	36995757	.	T	G	2	2	4	0	0	4	0	0
13	36995832	.	G	A	4	3	7	0	0	7	0	0
13	36995873	.	G	T	4	2	6	0	0	6	0	0
13	36995874	.	A	G	3	2	5	0	1	6	0	0
13	36996247	.	T	C	1	2	3	0	0	3	0	0
13	36996681	.	C	T	3	1	4	0	0	4	0	0
13	36997170	.	G	T	5	3	8	1	0	9	0	0
13	36997459	.	G	A	0	7	7	0	6	13	0	0
13	37041045	.	A	C	2	2	4	0	0	4	0	0
13	37071638	.	A	G	2	2	4	0	0	4	0	0
13	37071768	.	G	A	2	5	7	0	0	7	0	0
13	37071841	.	A	G	2	6	8	0	0	8	0	0
13	37072365	.	G	T	1	2	3	0	0	3	0	0
13	37075528	.	T	A	6	2	8	0	0	8	0	0
13	37075547	.	T	A	7	2	9	0	0	9	0	0
13	37075970	.	A	G	6	5	11	0	1	12	0	0
13	37075986	.	C	G	7	3	10	0	0	10	0	0
13	37076093	.	A	T	7	8	15	0	0	15	0	0
13	37076152	.	A	G	1	7	8	0	0	8	0	0
13	37076269	.	T	C	17	5	22	0	1	23	0	0
13	37076373	.	T	G	15	9	24	0	0	25	1	0
13	37076382	.	C	T	1	10	11	0	12	23	0	0
13	37076415	.	T	C	9	5	14	0	0	14	0	0
13	37076710	.	C	T	4	7	11	0	0	11	0	0
13	37076934	.	C	T	5	8	13	0	0	13	0	0
13	37076960	.	A	C	3	9	12	0	0	12	0	0
13	37077127	.	T	C	4	3	7	0	1	8	0	0
13	37077550	.	A	T	2	1	3	0	0	3	0	0
13	37077629	.	T	C	1	4	5	0	0	5	0	0
13	37077829	.	C	A	1	5	6	0	1	7	0	0
13	37077844	.	G	A	2	6	8	0	0	8	0	0
13	37077903	.	A	G	6	4	10	0	3	13	0	0
13	37077961	.	C	T	0	5	5	0	9	14	0	0
13	37090658	.	A	G	6	4	10	0	0	10	0	0
13	37093387	.	C	T	0	4	4	0	2	6	0	0
13	37103094	.	A	G	3	2	5	0	0	5	0	0
13	37103148	.	C	G	0	1	1	0	2	3	0	0
13	37103178	.	G	T	2	2	4	0	0	4	0	0
13	37105799	.	A	T	1	3	4	0	1	5	0	0
13	37108099	.	T	C	2	4	6	0	0	6	0	0
13	37303235	.	A	G	3	2	5	0	0	5	0	0
13	37303316	.	C	T	0	8	8	0	2	10	0	0
13	37303499	.	G	A	2	3	5	0	1	6	0	0
13	37303535	.	T	C	3	2	5	0	0	5	0	0
13	37421509	.	C	T	0	12	12	0	3	15	0	0
13	37421604	.	A	C	10	14	24	0	1	25	0	0
13	37422417	.	C	T	1	17	18	1	19	38	0	0
13	37425730	.	G	A	7	9	16	0	0	16	0	0
13	37426052	.	A	G	6	4	10	0	1	11	0	0
13	37429222	.	C	T	1	7	8	0	0	8	0	0
13	37429469	.	G	A	1	2	3	0	0	3	0	0
13	37432564	.	A	G	2	6	8	0	1	9	0	0
13	37432570	.	A	G	1	7	8	0	0	8	0	0
13	37469340	.	C	G	1	2	3	0	0	3	0	0
13	37469488	.	G	C	3	2	5	0	0	5	0	0
13	37470737	.	C	T	1	3	4	0	2	6	0	0
13	37470777	.	C	A	1	2	3	0	0	3	0	0
13	37528544	.	T	C	3	5	8	0	0	8	0	0
13	37528612	.	T	A	3	4	7	0	0	7	0	0
13	37528624	.	T	C	2	0	2	0	5	7	0	0
13	37528793	.	T	G	8	8	16	0	0	16	0	0
13	37532764	.	G	T	2	3	5	0	0	5	0	0
13	37545366	.	A	C	4	2	6	0	1	7	0	0
13	37545372	.	T	C	4	2	6	0	1	7	0	0
13	37545464	.	T	C	1	0	1	0	3	4	0	0
13	37594485	.	T	C	2	2	4	0	0	4	0	0
13	37605954	.	G	C	1	2	3	0	0	3	0	0
13	37607838	.	T	C	1	0	1	0	2	3	0	0
13	37623591	.	C	T	1	7	8	0	0	8	0	0
13	37623613	.	A	G	2	3	5	0	0	5	0	0
13	37623631	.	C	G	2	2	4	0	0	4	0	0
13	37646372	.	A	G	7	2	9	0	0	9	0	0
13	37651177	.	T	A	14	5	19	0	0	19	0	0
13	37658546	.	T	C	1	2	3	1	0	4	0	0
13	37659570	.	C	T	2	3	5	0	0	5	0	0
13	37661698	.	A	G	1	5	6	0	1	7	0	0
13	37666322	.	C	T	5	2	7	0	0	7	0	0
13	37671948	.	T	C	10	4	14	0	0	14	0	0
13	37671949	.	T	C	10	3	13	0	1	14	0	0
13	37672082	.	T	G	8	11	19	0	1	20	0	0
13	37672087	.	A	C	7	11	18	0	0	18	0	0
13	37672129	.	G	A	0	9	9	0	9	18	0	0
13	37672133	.	G	A	8	12	20	0	0	20	0	0
13	37672716	.	C	T	8	12	20	0	1	21	0	0
13	37672777	.	A	G	8	15	23	0	1	24	0	0
13	37673230	.	A	T	1	4	5	0	0	5	0	0
13	38304688	.	G	A	3	6	9	0	0	9	0	0
13	38304739	.	C	A	6	8	14	0	1	15	0	0
13	38304791	.	C	A	3	3	6	0	3	9	0	0
13	39114793	.	A	G	2	2	4	0	1	5	0	0
13	39218060	.	T	C	1	8	9	0	0	9	0	0
13	39349619	.	T	C	1	2	3	0	1	4	0	0
13	39360613	.	C	T	0	2	2	0	1	3	0	0
13	39657068	.	A	G	6	6	12	0	1	13	0	0
13	39657140	.	C	T	1	3	4	0	5	9	0	0
13	39657285	.	T	C	5	3	8	0	0	8	0	0
13	39657625	.	A	C	6	4	10	0	0	10	0	0
13	39657652	.	A	G	3	5	8	0	0	8	0	0
13	39830658	.	C	G	4	2	6	0	0	6	0	0
13	40352476	.	A	G	8	10	18	0	2	20	0	0
13	41933139	.	A	G	3	2	5	0	0	5	0	0
13	42400473	.	C	T	6	5	11	0	0	11	0	0
13	42407618	.	A	C	1	3	4	0	0	4	0	0
13	42467430	.	T	C	5	3	8	0	0	8	0	0
13	42469651	.	C	T	1	3	4	0	0	4	0	0
13	42471895	.	T	C	8	3	11	0	0	11	0	0
13	42481256	.	A	G	7	15	22	0	4	26	0	0
13	42481575	.	T	C	14	13	27	0	1	28	0	0
13	42485110	.	G	A	11	7	18	0	2	20	0	0
13	42487319	.	T	C	15	8	23	1	1	25	0	0
13	42490775	.	C	T	7	9	16	0	0	17	1	0
13	42496518	.	G	A	4	2	6	0	0	6	0	0
13	42500513	.	A	T	3	4	7	0	0	7	0	0
13	42502659	.	T	A	2	3	5	0	0	5	0	0
13	42502713	.	T	C	1	2	3	0	0	3	0	0
13	42507075	.	C	T	5	3	8	0	1	9	0	0
13	42513589	.	T	G	1	6	7	0	0	7	0	0
13	42513607	.	G	A	1	5	6	0	1	7	0	0
13	42516915	.	C	G	0	3	3	0	6	9	0	0
13	42521407	.	T	C	1	0	1	0	4	6	1	0
13	42523951	.	A	G	3	4	7	0	0	7	0	0
13	42523969	.	G	C	1	4	5	0	0	5	0	0
13	42524107	.	C	T	1	1	2	0	1	3	0	0
13	42606895	.	G	T	1	2	3	0	0	3	0	0
13	42610840	.	A	G	2	0	2	0	2	4	0	0
13	42610900	.	C	T	4	2	6	0	0	6	0	0
13	42610961	.	A	T	4	2	6	0	2	8	0	0
13	42611052	.	C	T	3	3	6	0	0	6	0	0
13	42615073	.	T	G	7	4	11	0	0	11	0	0
13	42616301	.	A	C	5	3	8	0	0	8	0	0
13	42616527	.	C	A	1	5	6	0	0	6	0	0
13	42626622	.	C	T	0	7	7	0	7	14	0	0
13	42630536	.	C	T	0	5	5	0	2	7	0	0
13	42672885	.	T	G	4	6	10	0	0	10	0	0
13	42676262	.	T	A	10	15	25	0	1	26	0	0
13	42676516	.	C	A	13	15	28	0	0	28	0	0
13	42678806	.	C	T	12	9	21	0	3	24	0	0
13	42681514	.	G	A	1	4	5	0	0	5	0	0
13	42681759	.	G	T	10	12	22	0	1	23	0	0
13	42682255	.	T	A	15	13	28	0	0	28	0	0
13	42682282	.	T	C	15	9	24	0	0	24	0	0
13	42691626	.	A	G	7	11	18	0	0	18	0	0
13	42691644	.	G	A	7	9	16	0	1	17	0	0
13	42693028	.	C	T	1	6	7	0	6	13	0	0
13	42693030	.	G	A	6	6	12	0	0	12	0	0
13	42726614	.	T	C	3	0	3	0	4	7	0	0
13	43223722	.	T	G	21	18	39	0	3	42	0	0
13	43223961	.	G	A	20	18	38	0	1	39	0	0
13	43226429	.	C	T	4	14	18	0	13	31	0	0
13	43229923	.	G	A	14	16	30	0	0	30	0	0
13	43232179	.	A	G	5	10	15	0	0	15	0	0
13	43232266	.	G	A	10	10	20	0	3	23	0	0
13	43237120	.	A	G	8	7	15	0	1	16	0	0
13	43237153	.	G	A	6	5	11	0	0	11	0	0
13	43300346	.	C	T	1	4	5	0	0	5	0	0
13	43300391	.	T	C	2	2	4	0	0	4	0	0
13	43507468	.	T	C	8	0	8	0	7	15	0	0
13	43507470	.	A	G	8	7	15	0	0	15	0	0
13	43507520	.	A	G	3	5	8	0	0	8	0	0
13	43507541	.	A	G	3	7	10	0	1	11	0	0
13	43507711	.	A	T	6	8	14	0	0	14	0	0
13	43507747	.	A	G	4	4	8	0	0	8	0	0
13	43507797	.	A	C	3	4	7	0	1	8	0	0
13	43507889	.	G	A	9	14	23	0	1	24	0	0
13	43508674	.	A	T	12	12	24	0	2	26	0	0
13	43508696	.	A	G	8	12	20	0	2	22	0	0
13	43508868	.	G	A	12	14	26	0	0	26	0	0
13	43508986	.	A	G	6	11	17	0	0	17	0	0
13	43508987	.	T	A	6	11	17	0	0	17	0	0
13	43509318	.	G	A	14	14	28	0	0	28	0	0
13	43509386	.	G	A	20	12	32	0	2	34	0	0
13	43509443	.	A	T	8	17	25	0	1	26	0	0
13	43509537	.	A	G	17	14	31	0	1	32	0	0
13	43509600	.	T	A	10	15	25	0	2	27	0	0
13	43512320	.	C	T	1	6	7	0	7	14	0	0
13	43512546	.	G	A	9	5	14	0	0	14	0	0
13	43512915	.	T	C	9	4	13	0	0	13	0	0
13	43515153	.	G	A	6	7	13	0	0	13	0	0
13	43515168	.	T	A	6	8	14	0	1	15	0	0
13	43633291	.	G	A	2	3	5	0	0	5	0	0
13	43637067	.	T	C	3	3	6	0	0	6	0	0
13	43637079	.	A	G	3	4	7	0	0	7	0	0
13	43647035	.	T	C	10	6	16	0	0	16	0	0
13	43650627	.	A	T	8	6	14	0	0	14	0	0
13	43658881	.	G	A	16	17	33	0	0	33	0	0
13	43659018	.	C	T	12	15	27	0	4	31	0	0
13	43659107	.	G	A	1	14	15	0	16	31	0	0
13	43659357	.	G	T	8	12	20	0	0	20	0	0
13	44629339	.	G	A	1	3	4	0	0	4	0	0
13	44702469	.	T	C	10	0	10	0	17	27	0	0
13	44715290	.	G	A	13	13	26	0	2	28	0	0
13	44738328	.	G	A	16	9	25	0	1	26	0	0
13	44767765	.	T	C	12	9	21	0	1	22	0	0
13	44772073	.	A	G	7	7	14	0	0	14	0	0
13	44775714	.	G	A	5	2	7	0	0	7	0	0
13	44775895	.	C	T	0	3	3	0	1	4	0	0
13	44779071	.	A	G	4	5	9	0	0	9	0	0
13	44779083	.	A	G	5	4	9	0	1	10	0	0
13	44779107	.	C	T	3	2	5	0	0	5	0	0
13	44782267	.	T	C	1	3	4	0	0	4	0	0
13	44788217	.	C	T	10	5	15	0	0	15	0	0
13	44788358	.	G	A	6	3	9	0	1	10	0	0
13	44788361	.	T	A	7	3	10	0	0	10	0	0
13	44788539	.	G	A	6	6	12	0	2	14	0	0
13	44788815	.	C	T	16	12	28	0	1	29	0	0
13	44788827	.	A	C	14	11	25	0	3	28	0	0
13	44808582	.	A	C	12	0	12	0	6	18	0	0
13	44841248	.	T	C	1	2	3	0	0	3	0	0
13	44842810	.	G	T	2	2	4	0	0	4	0	0
13	44842832	.	C	A	1	2	3	0	1	4	0	0
13	44857163	.	T	C	2	3	5	9	0	14	0	0
13	44860837	.	T	A	5	8	13	0	1	14	0	0
13	44869386	.	G	T	5	6	11	0	1	12	0	0
13	44888309	.	A	C	4	6	10	0	3	13	0	0
13	44888511	.	A	T	1	3	4	0	0	4	0	0
13	45010064	.	A	G	14	10	24	1	2	27	0	0
13	45012835	.	A	T	20	38	58	0	2	60	0	0
13	45015355	.	A	T	21	20	41	0	1	42	0	0
13	45015655	.	T	G	18	19	37	0	5	42	0	0
13	45015776	.	T	C	29	41	70	0	2	72	0	0
13	45016119	.	G	A	36	28	64	0	1	65	0	0
13	45035991	.	A	G	10	6	16	0	0	16	0	0
13	45039294	.	G	A	7	6	13	0	1	14	0	0
13	45039330	.	T	A	4	7	11	0	2	13	0	0
13	45049177	.	A	G	7	4	11	1	0	12	0	0
13	45432170	.	A	G	21	9	30	0	2	32	0	0
13	45434952	.	T	G	21	15	36	0	0	36	0	0
13	45436554	.	A	G	32	8	40	0	1	41	0	0
13	45436561	.	G	T	30	12	42	0	0	42	0	0
13	45468567	.	A	T	16	38	54	3	0	57	0	0
13	45468827	.	G	C	35	4	39	0	41	80	0	0
13	45470601	.	A	G	36	21	57	2	5	64	0	0
13	45470815	.	A	T	26	29	55	0	2	57	0	0
13	45470926	.	G	C	17	19	36	2	3	41	0	0
13	45470983	.	A	G	15	14	29	0	1	30	0	0
13	45471048	.	A	G	7	18	25	0	2	27	0	0
13	45471052	.	A	G	7	21	28	0	0	28	0	0
13	45471243	.	G	A	35	17	52	0	2	54	0	0
13	45471367	.	A	T	24	21	45	0	2	47	0	0
13	45471475	.	C	A	20	23	43	0	1	44	0	0
13	45471669	.	C	T	32	29	61	0	2	63	0	0
13	45471888	.	C	T	0	19	19	0	25	44	0	0
13	45472124	.	T	G	9	10	19	0	0	19	0	0
13	45472215	.	G	C	30	21	51	0	1	52	0	0
13	45472653	.	G	A	35	35	70	0	3	73	0	0
13	45472924	.	G	A	49	37	86	0	1	87	0	0
13	45472954	.	G	A	43	45	88	0	0	88	0	0
13	45476711	.	C	T	18	18	36	0	2	38	0	0
13	45476731	.	A	T	20	20	40	0	0	40	0	0
13	45481475	.	G	A	16	10	26	0	2	28	0	0
13	45481703	.	G	T	13	10	23	0	0	23	0	0
13	45481792	.	A	G	2	5	7	0	1	8	0	0
13	45494912	.	G	C	26	19	45	0	3	48	0	0
13	45495227	.	C	A	21	21	42	0	4	46	0	0
13	45495442	.	G	T	6	2	8	0	0	8	0	0
13	45553072	.	G	A	6	7	13	0	0	13	0	0
13	45553168	.	G	A	7	4	11	0	0	11	0	0
13	45565508	.	C	T	15	12	27	0	0	27	0	0
13	45565637	.	G	A	10	10	20	0	1	21	0	0
13	45565646	.	G	A	0	10	10	0	12	22	0	0
13	45570300	.	A	C	5	8	13	0	0	14	1	0
13	45624693	.	G	T	1	3	4	0	0	4	0	0
13	45794475	.	C	T	3	2	5	0	0	5	0	0
13	45991772	.	T	C	25	24	49	0	1	50	0	0
13	45991801	.	C	T	23	23	46	0	3	49	0	0
13	45999530	.	G	A	3	23	26	0	9	35	0	0
13	45999723	.	C	T	19	16	35	0	2	37	0	0
13	46179340	.	C	T	39	22	61	0	4	65	0	0
13	46179387	.	C	T	48	23	71	0	0	71	0	0
13	46179392	.	G	A	48	19	67	0	2	69	0	0
13	46179806	.	T	A	36	27	63	0	1	64	0	0
13	46179814	.	A	G	37	26	63	0	2	65	0	0
13	46298734	.	G	A	10	8	18	0	3	21	0	0
13	46298973	.	T	C	1	4	5	0	1	6	0	0
13	46299677	.	G	T	4	5	9	0	0	9	0	0
13	46299812	.	C	T	0	12	12	0	6	18	0	0
13	46299827	.	A	G	5	9	14	0	0	14	0	0
13	46299873	.	T	A	2	7	9	0	0	9	0	0
13	46299875	.	T	G	2	7	9	0	0	9	0	0
13	46299934	.	G	A	7	4	11	0	1	12	0	0
13	46300224	.	T	A	9	8	17	0	1	18	0	0
13	46300247	.	A	T	9	8	17	0	0	17	0	0
13	46300259	.	T	G	7	8	15	0	2	17	0	0
13	46300421	.	C	T	7	10	17	0	0	17	0	0
13	46300450	.	C	T	8	7	15	0	0	15	0	0
13	46300694	.	T	A	3	7	10	0	1	11	0	0
13	46300737	.	G	A	11	11	22	0	3	25	0	0
13	46321988	.	C	T	2	4	6	0	4	10	0	0
13	46343432	.	T	C	5	0	5	0	7	12	0	0
13	46343471	.	G	A	4	6	10	0	0	10	0	0
13	46343486	.	G	A	3	4	7	0	0	7	0	0
13	46343525	.	G	A	4	2	6	0	0	6	0	0
13	46520818	.	G	A	1	2	3	0	0	3	0	0
13	46520845	.	T	C	1	4	5	0	0	5	0	0
13	46520924	.	T	C	6	7	13	0	1	14	0	0
13	46521542	.	C	T	0	5	5	0	1	6	0	0
13	46521633	.	G	A	7	10	17	0	2	19	0	0
13	46521664	.	C	A	8	7	15	0	1	16	0	0
13	46521762	.	T	A	8	7	15	0	2	17	0	0
13	46674815	.	A	G	2	3	5	0	2	7	0	0
13	46687037	.	G	T	2	2	4	1	0	5	0	0
13	46687086	.	G	A	1	3	4	1	0	5	0	0
13	46795515	.	G	A	0	5	5	0	9	14	0	0
13	46804064	.	G	T	2	2	4	0	0	4	0	0
13	46804112	.	G	A	2	4	6	0	0	6	0	0
13	46804202	.	G	A	1	2	3	0	0	3	0	0
13	46831698	.	C	T	1	3	4	0	2	6	0	0
13	46831831	.	A	T	3	7	10	0	0	10	0	0
13	46832084	.	A	G	7	4	11	0	0	11	0	0
13	46832104	.	A	G	3	2	5	0	0	5	0	0
13	46832315	.	T	C	5	0	5	2	7	14	0	0
13	46832371	.	A	C	11	6	17	2	0	19	0	0
13	46832374	.	T	C	11	6	17	2	0	19	0	0
13	46832449	.	A	T	11	4	15	0	0	15	0	0
13	46832471	.	A	C	12	6	18	0	1	19	0	0
13	46832724	.	C	A	1	9	10	0	4	14	0	0
13	46833050	.	C	G	8	4	12	0	0	12	0	0
13	46833064	.	C	T	9	3	12	0	0	12	0	0
13	46833197	.	A	G	6	6	12	0	0	12	0	0
13	46833924	.	T	C	4	5	9	0	0	9	0	0
13	46834815	.	C	T	3	5	8	0	0	8	0	0
13	46834860	.	T	A	3	4	7	0	0	7	0	0
13	46844205	.	G	A	4	3	7	0	0	7	0	0
13	46857629	.	A	T	3	2	5	0	0	5	0	0
13	46935014	.	T	G	5	4	9	0	0	9	0	0
13	46935089	.	C	T	9	4	13	0	0	13	0	0
13	46988299	.	C	T	17	13	30	0	0	30	0	0
13	46988390	.	T	C	16	1	17	0	14	31	0	0
13	46988457	.	C	A	2	12	14	0	21	35	0	0
13	46988561	.	A	G	17	16	33	0	1	34	0	0
13	46988588	.	A	G	13	24	37	0	3	40	0	0
13	46988638	.	T	G	15	19	34	0	1	35	0	0
13	46989607	.	C	T	2	24	26	0	14	40	0	0
13	47099738	.	C	T	1	2	3	0	0	3	0	0
13	47099834	.	A	G	3	2	5	0	0	5	0	0
13	47130927	.	A	G	5	0	5	0	3	8	0	0
13	47135882	.	C	T	4	2	6	0	0	6	0	0
13	47135885	.	G	A	1	2	3	0	3	6	0	0
13	47146860	.	C	T	3	3	6	0	0	6	0	0
13	47163748	.	A	G	6	0	6	1	3	10	0	0
13	47684293	.	T	C	1	2	3	0	0	3	0	0
13	47689220	.	C	T	2	3	5	0	0	5	0	0
13	47690160	.	C	T	1	2	3	0	0	3	0	0
13	47690180	.	C	T	3	3	6	0	1	7	0	0
13	47690269	.	A	T	4	7	11	0	0	11	0	0
13	47690300	.	A	T	6	5	11	0	0	12	1	0
13	47690383	.	C	G	5	4	9	0	0	9	0	0
13	47690496	.	T	A	2	2	4	0	0	4	0	0
13	47690766	.	T	C	8	3	11	0	0	11	0	0
13	47690779	.	G	A	1	4	5	0	8	13	0	0
13	47690826	.	A	G	7	5	12	0	0	12	0	0
13	47723765	.	C	T	1	2	3	0	1	4	0	0
13	47723778	.	A	G	3	0	3	0	2	5	0	0
13	47751214	.	A	T	2	2	4	0	0	4	0	0
13	47831531	.	T	C	1	2	3	0	0	3	0	0
13	47834276	.	C	A	2	3	5	0	0	5	0	0
13	47835638	.	G	T	1	3	4	0	0	4	0	0
13	47838024	.	G	A	5	7	12	0	0	12	0	0
13	47838052	.	G	A	1	7	8	0	5	13	0	0
13	47838650	.	G	C	3	7	10	0	0	10	0	0
13	47839071	.	C	T	4	7	11	0	2	13	0	0
13	47839119	.	A	T	4	6	10	0	2	12	0	0
13	48549008	.	C	T	2	2	4	0	0	4	0	0
13	48747719	.	T	C	7	3	10	0	0	10	0	0
13	48751921	.	A	G	6	4	10	0	0	10	0	0
13	48755035	.	A	G	4	4	8	0	1	9	0	0
13	48755122	.	T	C	4	8	12	0	2	14	0	0
13	48758680	.	C	T	1	3	4	0	1	5	0	0
13	48760071	.	G	T	2	2	4	0	0	4	0	0
13	48760177	.	C	A	2	2	4	0	0	4	0	0
13	48760180	.	T	C	2	1	3	0	0	3	0	0
13	48760279	.	C	T	0	3	3	0	1	4	0	0
13	48766270	.	C	T	2	5	7	0	0	7	0	0
13	49153904	.	T	C	5	8	13	0	0	13	0	0
13	49153938	.	G	A	12	5	17	0	0	17	0	0
13	49153953	.	A	G	12	4	16	0	0	16	0	0
13	49154048	.	G	A	8	9	17	0	2	19	0	0
13	49154249	.	C	T	8	4	12	0	0	12	0	0
13	49154257	.	G	A	8	5	13	0	0	13	0	0
13	49154631	.	T	C	13	0	13	0	14	27	0	0
13	49158734	.	G	A	8	6	14	1	1	16	0	0
13	49167185	.	T	G	8	3	11	0	2	13	0	0
13	49167195	.	C	T	9	4	13	0	2	15	0	0
13	49169071	.	A	T	9	5	14	0	0	14	0	0
13	49169121	.	G	C	5	5	10	0	0	10	0	0
13	49176294	.	C	T	1	3	4	0	0	4	0	0
13	49443721	.	C	T	21	28	49	0	0	49	0	0
13	49443868	.	T	C	26	0	26	0	22	48	0	0
13	49444090	.	C	T	20	16	36	0	0	36	0	0
13	49444177	.	C	A	3	28	31	0	16	47	0	0
13	49444224	.	G	A	19	18	37	0	1	38	0	0
13	49444446	.	C	A	15	15	30	0	2	32	0	0
13	49543334	.	C	T	1	3	4	0	0	4	0	0
13	49544509	.	C	T	1	7	8	0	1	9	0	0
13	49544700	.	T	C	1	2	3	0	0	3	0	0
13	49544833	.	C	T	8	23	31	0	2	33	0	0
13	49544873	.	T	A	10	19	29	0	3	32	0	0
13	49544973	.	G	T	21	15	36	0	1	37	0	0
13	49545039	.	A	G	23	20	43	1	2	46	0	0
13	49583976	.	A	G	20	21	41	0	2	43	0	0
13	49585341	.	T	A	21	18	39	2	1	42	0	0
13	49585344	.	A	T	17	18	35	2	3	40	0	0
13	49585384	.	T	G	6	6	12	2	0	14	0	0
13	49597297	.	C	T	0	2	2	0	10	12	0	0
13	49599521	.	G	A	4	3	7	0	0	7	0	0
13	49605897	.	T	C	1	0	1	0	4	5	0	0
13	49605904	.	A	G	2	4	6	0	0	6	0	0
13	49608888	.	T	C	2	4	6	0	0	6	0	0
13	49609268	.	C	T	4	3	7	0	0	7	0	0
13	49633362	.	G	T	2	2	4	0	0	4	0	0
13	49636240	.	C	T	4	0	4	0	2	6	0	0
13	49642805	.	G	T	0	4	4	0	1	5	0	0
13	49660026	.	A	G	1	2	3	0	0	3	0	0
13	49666565	.	T	C	1	3	4	0	0	4	0	0
13	49765806	.	C	T	5	2	7	0	0	7	0	0
13	49765815	.	G	T	0	2	2	0	5	7	0	0
13	49765896	.	T	C	4	3	7	0	0	7	0	0
13	49766022	.	T	C	5	3	8	0	0	8	0	0
13	49766268	.	G	A	1	9	10	0	8	18	0	0
13	49767539	.	A	G	9	9	18	0	0	18	0	0
13	49767570	.	G	A	13	10	23	0	0	23	0	0
13	49767736	.	T	G	4	7	11	0	1	12	0	0
13	49767806	.	T	A	6	2	8	0	0	8	0	0
13	49767807	.	G	T	6	2	8	0	0	8	0	0
13	49767953	.	T	A	7	7	14	0	2	16	0	0
13	49768095	.	A	G	16	10	26	0	1	27	0	0
13	49768207	.	C	T	11	8	19	0	1	20	0	0
13	49768401	.	C	T	11	15	26	0	0	26	0	0
13	49768402	.	A	C	11	15	26	0	0	26	0	0
13	49768646	.	A	G	4	5	9	0	0	9	0	0
13	49768917	.	T	A	4	6	10	0	0	10	0	0
13	49769060	.	C	T	12	7	19	0	0	19	0	0
13	49769141	.	G	C	2	11	13	0	0	13	0	0
13	49769274	.	G	A	0	5	5	0	8	13	0	0
13	49774860	.	A	C	2	0	2	0	5	7	0	0
13	49774893	.	G	T	3	6	9	0	0	9	0	0
13	49775018	.	T	G	5	6	11	0	0	11	0	0
13	49775075	.	T	G	7	3	10	0	1	11	0	0
13	49785412	.	C	T	6	6	12	0	0	12	0	0
13	49785417	.	T	C	6	6	12	0	1	13	0	0
13	49785455	.	C	G	9	7	16	0	0	16	0	0
13	49785456	.	A	G	9	7	16	0	0	16	0	0
13	49786114	.	A	G	11	8	19	0	1	20	0	0
13	49788102	.	A	T	11	6	17	0	0	17	0	0
13	49802010	.	C	A	7	4	11	0	1	12	0	0
13	49802025	.	T	G	7	5	12	0	0	12	0	0
13	49898458	.	G	T	3	4	7	0	0	7	0	0
13	49907480	.	A	G	4	8	12	0	1	13	0	0
13	49907549	.	C	T	2	2	4	0	0	4	0	0
13	49915484	.	C	A	4	3	7	0	0	7	0	0
13	49917748	.	T	C	4	3	7	0	1	8	0	0
13	49922904	.	A	G	2	4	6	0	0	6	0	0
13	49922970	.	C	T	1	2	3	0	4	7	0	0
13	49923176	.	T	C	2	2	4	0	0	4	0	0
13	49923570	.	G	T	1	4	5	0	0	5	0	0
13	49923678	.	C	A	5	2	7	0	0	7	0	0
13	49931689	.	C	T	4	3	7	1	0	8	0	0
13	50169004	.	C	T	9	8	17	1	3	21	0	0
13	50670792	.	C	T	1	2	3	0	7	10	0	0
13	50670846	.	A	T	15	7	22	0	0	22	0	0
13	50670911	.	G	C	6	6	12	1	1	14	0	0
13	50672297	.	T	C	6	1	7	0	10	17	0	0
13	50712125	.	A	G	4	2	6	0	0	6	0	0
13	50715205	.	A	G	2	5	7	0	0	7	0	0
13	51140665	.	A	G	17	5	22	0	2	24	0	0
13	51140782	.	A	G	12	15	27	0	0	27	0	0
13	51145614	.	T	G	27	7	34	0	3	38	1	0
13	51147152	.	G	A	12	11	23	0	2	25	0	0
13	51147164	.	A	G	13	10	23	0	0	23	0	0
13	51147736	.	G	A	13	8	21	0	1	22	0	0
13	51147778	.	A	G	13	10	23	0	0	23	0	0
13	51162561	.	A	G	11	4	15	0	1	16	0	0
13	51162579	.	T	G	9	4	13	0	1	14	0	0
13	51169874	.	C	G	9	3	12	1	0	13	0	0
13	51963030	.	A	G	3	0	3	0	5	8	0	0
14	1391620	.	C	T	1	8	9	0	0	9	0	0
14	1956470	.	C	T	7	2	9	0	0	9	0	0
14	2351565	.	A	T	2	2	4	0	0	4	0	0
14	2351566	.	G	T	2	2	4	0	0	4	0	0
14	2360116	.	T	A	4	5	9	1	0	10	0	0
14	2398264	.	A	G	5	2	7	0	0	7	0	0
14	3576057	.	T	C	14	2	16	8	1	41	16	0
14	3576058	.	A	T	13	14	27	9	1	43	6	0
14	4183633	.	A	G	1	2	3	1	1	5	0	0
14	4183641	.	A	G	1	4	5	1	0	6	0	0
14	4184100	.	A	G	9	3	12	0	1	13	0	0
14	4291556	.	A	G	4	5	9	0	0	9	0	0
14	4292127	.	A	G	11	2	13	0	0	13	0	0
14	4292128	.	A	G	9	4	13	0	0	13	0	0
14	4556887	.	T	C	3	2	5	0	0	5	0	0
14	4813124	.	A	G	4	3	7	0	0	7	0	0
14	4813497	.	T	A	4	5	9	0	1	10	0	0
14	6000428	.	A	G	3	2	5	0	0	5	0	0
14	6003556	.	A	G	1	0	1	2	2	5	0	0
14	6332872	.	T	C	9	3	12	1	3	17	1	0
14	6333022	.	T	C	6	8	14	2	0	16	0	0
14	6624558	.	A	G	15	1	16	0	9	25	0	0
14	6624569	.	A	G	20	7	27	0	1	28	0	0
14	6624621	.	A	G	11	19	30	0	2	32	0	0
14	6625002	.	A	C	31	13	44	4	3	51	0	0
14	6625336	.	T	A	34	11	45	8	3	56	0	0
14	6625521	.	G	C	25	27	52	4	7	63	0	0
14	6967009	.	A	G	3	2	5	0	0	5	0	0
14	7170558	.	T	C	4	16	20	0	2	22	0	0
14	7170559	.	T	C	3	19	22	0	0	22	0	0
14	8270798	.	A	G	1	2	3	0	2	5	0	0
14	8495668	.	A	T	5	4	9	3	1	13	0	0
14	8571537	.	G	A	2	12	14	0	0	14	0	0
14	8770425	.	A	G	4	4	8	0	0	8	0	0
14	8770436	.	A	C	7	4	11	0	0	11	0	0
14	8770589	.	C	T	5	7	12	0	0	12	0	0
14	8770931	.	T	A	3	9	12	0	2	14	0	0
14	8773080	.	A	G	2	3	5	0	0	5	0	0
14	8806587	.	A	C	5	0	5	0	3	8	0	0
14	8806590	.	A	G	5	4	9	0	0	9	0	0
14	8806680	.	T	C	13	7	20	0	0	20	0	0
14	8806722	.	A	G	14	8	22	0	1	23	0	0
14	8806730	.	G	T	14	9	23	0	1	24	0	0
14	8809693	.	A	G	10	8	18	1	7	26	0	0
14	8816113	.	T	C	6	7	13	0	1	14	0	0
14	8816135	.	A	T	7	7	14	0	1	15	0	0
14	8816194	.	C	T	9	9	18	0	1	19	0	0
14	8816261	.	G	A	10	5	15	0	0	15	0	0
14	8816283	.	T	G	9	6	15	0	0	15	0	0
14	8816339	.	A	G	6	9	15	0	1	16	0	0
14	8816457	.	A	G	3	9	12	0	0	12	0	0
14	8816482	.	A	T	4	8	12	0	0	12	0	0
14	8816695	.	C	G	4	6	10	0	0	10	0	0
14	8816755	.	A	C	7	0	7	0	8	15	0	0
14	8816782	.	G	A	9	8	17	0	0	17	0	0
14	8816848	.	A	G	12	4	16	2	1	19	0	0
14	8816877	.	C	A	2	11	13	2	10	25	0	0
14	8819082	.	T	C	9	0	9	0	5	14	0	0
14	8821677	.	G	A	7	9	16	0	0	16	0	0
14	8830236	.	G	T	6	3	9	0	0	9	0	0
14	8830302	.	C	T	0	4	4	0	7	11	0	0
14	8832736	.	A	C	4	2	6	0	0	6	0	0
14	8836160	.	G	A	6	5	11	0	1	12	0	0
14	8836298	.	T	C	5	5	10	0	0	10	0	0
14	8841352	.	A	T	5	9	14	0	0	14	0	0
14	8844045	.	G	A	3	7	10	0	0	10	0	0
14	8862221	.	G	T	1	3	4	0	0	4	0	0
14	8947464	.	A	T	13	5	18	0	0	18	0	0
14	8947497	.	C	A	13	6	19	0	0	19	0	0
14	8982390	.	C	T	10	14	24	0	1	25	0	0
14	8991718	.	A	T	10	22	32	0	2	35	1	0
14	8991823	.	T	C	11	21	32	0	0	32	0	0
14	9001411	.	G	A	24	11	35	0	0	35	0	0
14	9001426	.	C	T	25	14	39	0	1	40	0	0
14	9001752	.	C	G	11	1	12	0	16	28	0	0
14	9001875	.	T	C	17	17	34	0	0	34	0	0
14	9033783	.	G	A	5	4	9	0	1	10	0	0
14	9034114	.	A	G	4	5	9	0	0	9	0	0
14	9034128	.	T	G	5	4	9	0	0	9	0	0
14	9034161	.	C	T	6	2	8	0	0	8	0	0
14	9034307	.	G	A	5	6	11	0	0	11	0	0
14	9034430	.	T	C	12	10	22	0	1	23	0	0
14	9034544	.	T	C	3	0	3	0	10	13	0	0
14	9034591	.	G	T	6	9	15	0	0	15	0	0
14	9034701	.	C	T	1	6	7	1	6	14	0	0
14	9034742	.	C	T	8	4	12	0	3	15	0	0
14	9034743	.	T	C	7	0	7	0	7	14	0	0
14	9034932	.	A	G	12	6	18	0	0	18	0	0
14	9035051	.	C	G	13	4	17	0	0	17	0	0
14	9035100	.	C	T	8	12	20	0	0	20	0	0
14	9035110	.	C	T	0	9	9	0	16	25	0	0
14	9035175	.	G	A	7	7	14	0	0	14	0	0
14	9035249	.	G	T	5	5	10	0	0	10	0	0
14	9035740	.	A	G	4	10	14	0	0	14	0	0
14	9035866	.	A	G	13	6	19	0	0	19	0	0
14	9035873	.	T	C	13	7	20	0	0	20	0	0
14	9036255	.	T	C	1	3	4	0	0	4	0	0
14	9036480	.	C	T	4	4	8	0	0	8	0	0
14	9036530	.	C	T	3	8	11	0	0	11	0	0
14	9036624	.	C	T	6	5	11	0	1	12	0	0
14	9040928	.	C	A	7	5	12	0	1	13	0	0
14	9142412	.	A	T	7	11	18	0	1	19	0	0
14	9142602	.	A	T	23	17	40	0	4	44	0	0
14	9142795	.	T	C	16	16	32	0	1	33	0	0
14	9142893	.	T	C	19	0	19	0	19	38	0	0
14	9142911	.	T	C	17	1	18	0	17	35	0	0
14	9142952	.	C	T	5	14	19	0	22	41	0	0
14	9143081	.	G	C	36	0	36	0	20	57	1	0
14	9143179	.	C	T	0	9	9	2	33	44	0	0
14	9143427	.	A	T	25	15	40	0	2	42	0	0
14	9143446	.	T	C	22	0	22	0	10	32	0	0
14	9143878	.	T	C	18	13	31	0	2	33	0	0
14	9144099	.	T	C	25	17	42	0	1	43	0	0
14	9144191	.	A	G	16	16	32	0	2	34	0	0
14	9144248	.	A	G	13	8	21	0	1	22	0	0
14	9144361	.	A	G	9	11	20	0	0	20	0	0
14	9144658	.	A	G	6	15	21	0	1	22	0	0
14	9145050	.	G	A	20	19	39	2	0	41	0	0
14	9157880	.	T	A	13	20	33	1	0	34	0	0
14	9159845	.	A	G	11	16	27	0	1	28	0	0
14	9159860	.	G	C	8	1	9	0	14	23	0	0
14	9163286	.	G	A	12	17	29	0	1	30	0	0
14	9173909	.	C	T	14	14	28	0	0	28	0	0
14	9177619	.	G	A	17	10	27	0	1	28	0	0
14	9344247	.	G	A	3	6	9	0	0	9	0	0
14	9344250	.	C	T	3	7	10	0	1	11	0	0
14	9344366	.	T	G	11	3	14	0	1	15	0	0
14	9405383	.	T	C	1	3	4	0	1	5	0	0
14	9405728	.	G	C	4	0	4	0	10	14	0	0
14	9405760	.	T	C	7	8	15	0	0	15	0	0
14	9405927	.	C	T	5	5	10	0	1	11	0	0
14	9405940	.	A	C	3	4	7	0	0	8	1	0
14	9406320	.	T	C	9	0	9	0	8	17	0	0
14	9406453	.	A	T	9	7	16	0	0	16	0	0
14	9406485	.	A	G	9	12	21	0	0	21	0	0
14	9406509	.	T	C	6	11	17	0	2	19	0	0
14	9406607	.	T	C	2	7	9	0	0	9	0	0
14	9406773	.	T	A	6	4	10	0	1	11	0	0
14	9406791	.	A	G	6	5	11	0	1	12	0	0
14	9407707	.	C	T	4	4	8	0	0	8	0	0
14	9407763	.	A	G	3	4	7	0	0	7	0	0
14	9407791	.	G	A	3	2	5	0	0	5	0	0
14	9408260	.	C	G	9	5	14	0	1	15	0	0
14	9408320	.	T	G	8	6	14	0	0	14	0	0
14	9420810	.	G	A	3	4	7	0	1	8	0	0
14	9420871	.	C	A	5	3	8	0	0	8	0	0
14	9421768	.	C	A	1	5	6	0	0	6	0	0
14	9422443	.	G	A	1	2	3	0	0	3	0	0
14	9467879	.	G	A	2	1	3	0	1	4	0	0
14	9467883	.	T	C	3	2	5	0	0	5	0	0
14	9469559	.	T	C	3	2	5	0	0	5	0	0
14	9469615	.	A	G	3	2	5	0	0	5	0	0
14	9475796	.	T	A	1	2	3	0	0	3	0	0
14	9481518	.	C	T	4	1	5	0	1	6	0	0
14	9481647	.	C	A	5	2	7	0	0	7	0	0
14	9481924	.	C	T	3	2	5	0	0	5	0	0
14	9481926	.	G	T	3	2	5	0	0	5	0	0
14	9485121	.	A	T	4	4	8	0	0	8	0	0
14	9485366	.	T	A	6	4	10	0	0	10	0	0
14	9494939	.	A	G	6	0	6	0	5	11	0	0
14	9495107	.	G	A	0	11	11	0	6	17	0	0
14	9498163	.	C	T	8	11	19	0	0	19	0	0
14	9498308	.	G	A	8	6	14	0	0	14	0	0
14	9498570	.	C	T	12	5	17	0	0	17	0	0
14	9498728	.	A	T	6	2	8	0	0	8	0	0
14	9498841	.	C	G	11	9	20	0	0	20	0	0
14	9498879	.	T	A	12	13	25	0	1	26	0	0
14	9499048	.	G	T	10	5	15	0	0	15	0	0
14	9507489	.	T	C	1	2	3	0	0	3	0	0
14	9522159	.	A	T	1	2	3	0	0	3	0	0
14	9583914	.	T	C	3	3	6	0	0	6	0	0
14	9587735	.	C	T	2	4	6	0	0	6	0	0
14	9587770	.	C	T	1	2	3	0	0	3	0	0
14	9588102	.	T	A	3	3	6	0	0	6	0	0
14	9588145	.	G	A	4	4	8	0	0	8	0	0
14	9588210	.	G	A	1	1	2	0	3	5	0	0
14	9588221	.	G	C	3	0	3	0	1	4	0	0
14	9589719	.	G	A	0	3	3	0	0	3	0	0
14	9589731	.	G	T	1	3	4	0	0	4	0	0
14	9591567	.	T	C	2	2	4	0	0	4	0	0
14	9593309	.	T	A	6	3	9	0	0	9	0	0
14	9593505	.	A	G	26	14	40	0	3	43	0	0
14	9593610	.	T	A	24	10	34	1	1	36	0	0
14	9593622	.	A	T	22	11	33	1	1	35	0	0
14	9593974	.	C	T	22	16	38	0	3	41	0	0
14	9594466	.	G	A	3	9	12	0	0	12	0	0
14	9594577	.	C	T	10	3	13	0	2	15	0	0
14	9594578	.	A	G	12	2	14	0	1	15	0	0
14	9594623	.	C	T	13	4	17	0	2	19	0	0
14	9594677	.	G	C	9	10	19	0	1	20	0	0
14	9595086	.	A	C	16	5	21	0	1	22	0	0
14	9595119	.	G	A	8	14	22	0	0	22	0	0
14	9595221	.	T	C	5	14	19	0	0	19	0	0
14	9595231	.	T	C	5	0	5	0	12	17	0	0
14	9595330	.	T	C	10	12	22	0	1	23	0	0
14	9595401	.	A	G	9	8	17	0	0	17	0	0
14	9595493	.	G	T	4	12	16	0	1	17	0	0
14	9595524	.	T	C	5	8	13	0	1	14	0	0
14	9595593	.	T	G	5	4	9	0	0	9	0	0
14	9595890	.	C	T	10	5	15	0	0	15	0	0
14	9595992	.	C	A	13	13	26	0	0	26	0	0
14	9596338	.	C	T	15	8	23	0	0	23	0	0
14	9717978	.	C	A	2	9	11	0	8	19	0	0
14	9821794	.	C	T	0	6	6	1	3	10	0	0
14	10321729	.	A	G	1	3	4	0	0	4	0	0
14	10338763	.	G	T	2	2	4	0	0	4	0	0
14	10338942	.	A	G	4	3	7	0	0	7	0	0
14	10339032	.	G	A	3	5	8	0	0	8	0	0
14	10339081	.	T	G	8	4	12	0	1	13	0	0
14	10339325	.	T	G	5	3	8	0	1	9	0	0
14	10339333	.	T	G	7	3	10	0	0	10	0	0
14	10339883	.	A	C	19	16	35	0	2	37	0	0
14	10339943	.	A	G	18	11	29	0	0	29	0	0
14	10340068	.	G	A	10	11	21	0	0	21	0	0
14	10340096	.	G	A	9	9	18	0	2	20	0	0
14	10340189	.	T	A	10	3	13	0	3	16	0	0
14	10340193	.	C	G	15	3	18	0	0	18	0	0
14	10340250	.	A	T	11	6	17	0	1	18	0	0
14	10340288	.	C	A	7	9	16	0	0	16	0	0
14	10340358	.	G	A	7	11	18	0	1	19	0	0
14	10340606	.	A	G	16	6	22	0	2	24	0	0
14	10340840	.	C	A	15	6	21	0	2	23	0	0
14	10341076	.	T	C	5	5	10	0	0	10	0	0
14	10341237	.	A	T	9	6	15	0	0	15	0	0
14	10341586	.	C	T	2	9	11	0	9	20	0	0
14	10341627	.	A	T	13	11	24	0	0	24	0	0
14	10341690	.	G	T	4	11	15	0	0	15	0	0
14	10341703	.	T	C	5	0	5	0	11	16	0	0
14	10341966	.	A	C	14	8	22	0	1	23	0	0
14	10342246	.	G	T	6	5	11	0	0	11	0	0
14	10342379	.	A	C	5	0	5	0	7	12	0	0
14	10342825	.	G	C	5	5	10	0	1	11	0	0
14	10342843	.	C	T	1	6	7	0	7	14	0	0
14	10342926	.	G	A	10	1	11	0	1	12	0	0
14	10342929	.	T	A	8	2	10	0	0	10	0	0
14	10342971	.	G	T	6	6	12	0	1	13	0	0
14	10343050	.	C	T	5	4	9	0	0	9	0	0
14	10343052	.	C	G	5	4	9	0	0	9	0	0
14	10343112	.	C	T	1	5	6	0	0	6	0	0
14	10343304	.	G	A	3	2	5	0	0	5	0	0
14	10343308	.	C	G	2	2	4	0	0	4	0	0
14	10343678	.	A	T	7	8	15	0	0	15	0	0
14	10343686	.	T	C	6	0	6	0	9	15	0	0
14	10343866	.	G	A	10	6	16	0	0	16	0	0
14	10344032	.	A	C	7	4	11	0	0	11	0	0
14	10344075	.	C	A	6	5	11	0	0	11	0	0
14	10344218	.	G	A	3	3	6	0	0	6	0	0
14	10344451	.	C	T	8	3	11	0	0	11	0	0
14	10348091	.	T	C	3	3	6	0	1	7	0	0
14	10356522	.	A	G	6	3	9	0	0	9	0	0
14	10365369	.	A	T	3	3	6	0	0	6	0	0
14	10365510	.	T	C	5	5	10	0	0	10	0	0
14	10379652	.	G	A	6	3	9	0	1	10	0	0
14	10987761	.	C	A	1	2	3	0	0	3	0	0
14	11022903	.	T	A	2	4	6	0	0	6	0	0
14	11053934	.	G	C	6	8	14	0	1	15	0	0
14	11069560	.	C	T	7	14	21	0	0	21	0	0
14	11069593	.	C	T	5	10	15	0	0	15	0	0
14	11069774	.	G	A	5	6	11	0	1	12	0	0
14	11262084	.	T	C	6	4	10	0	0	10	0	0
14	11262765	.	C	A	3	5	8	0	1	9	0	0
14	11263017	.	A	G	1	0	1	0	2	3	0	0
14	11263084	.	C	G	3	3	6	0	0	6	0	0
14	11263096	.	C	A	3	3	6	0	0	6	0	0
14	11263147	.	G	A	1	2	3	0	1	4	0	0
14	11263479	.	T	A	8	5	13	0	2	15	0	0
14	11263899	.	A	G	4	0	4	0	5	9	0	0
14	11264058	.	C	T	5	3	8	0	1	9	0	0
14	11264726	.	A	T	4	11	15	0	1	16	0	0
14	11265567	.	C	T	6	4	10	0	0	10	0	0
14	11265966	.	A	G	1	3	4	0	1	5	0	0
14	11266153	.	C	T	3	7	10	0	0	10	0	0
14	11266644	.	A	T	12	7	19	0	1	20	0	0
14	11267900	.	A	T	13	14	27	0	1	28	0	0
14	11268224	.	A	T	2	2	4	0	0	4	0	0
14	11290986	.	T	C	2	3	5	0	0	5	0	0
14	11299563	.	G	A	1	2	3	0	3	6	0	0
14	11300058	.	T	C	6	4	10	0	0	10	0	0
14	11300154	.	G	A	3	4	7	0	0	7	0	0
14	11300179	.	T	G	2	6	8	0	0	8	0	0
14	11300238	.	G	A	5	5	10	0	0	10	0	0
14	11300298	.	C	T	5	4	9	0	0	9	0	0
14	11301027	.	G	A	10	11	21	0	0	21	0	0
14	11301069	.	A	G	17	0	17	0	10	27	0	0
14	11302190	.	C	A	16	8	24	0	0	24	0	0
14	11302392	.	G	A	1	4	5	0	0	5	0	0
14	11302427	.	T	G	1	0	1	0	3	4	0	0
14	11302492	.	G	A	2	2	4	0	2	6	0	0
14	11302518	.	A	G	3	2	5	0	0	5	0	0
14	11302565	.	T	A	3	4	7	0	0	7	0	0
14	11302662	.	C	A	3	2	5	0	0	5	0	0
14	11303025	.	A	G	3	0	3	0	4	7	0	0
14	11303157	.	A	C	7	6	13	0	0	13	0	0
14	11303231	.	T	C	2	2	4	0	0	4	0	0
14	11303973	.	C	T	2	1	3	0	1	4	0	0
14	11983251	.	C	A	0	2	2	0	1	3	0	0
14	12021308	.	C	G	2	7	9	0	0	9	0	0
14	12021550	.	T	C	2	5	7	0	0	7	0	0
14	12021610	.	T	G	1	3	4	0	0	4	0	0
14	12021926	.	A	T	9	9	18	0	1	19	0	0
14	12022056	.	C	T	9	7	16	0	1	17	0	0
14	12036538	.	C	G	3	15	18	0	0	18	0	0
14	12036768	.	A	C	4	0	4	0	4	8	0	0
14	12050868	.	A	C	2	0	2	0	3	5	0	0
14	12069754	.	C	T	18	20	38	1	1	40	0	0
14	12071446	.	A	G	14	6	20	0	0	20	0	0
14	12077109	.	C	T	8	4	12	0	2	14	0	0
14	12085165	.	T	C	9	10	19	0	0	19	0	0
14	12085267	.	G	A	6	3	9	0	0	9	0	0
14	12089512	.	G	T	4	6	10	0	0	10	0	0
14	12099566	.	G	T	2	3	5	0	0	5	0	0
14	12099605	.	T	G	1	3	4	0	0	4	0	0
14	12109674	.	G	A	1	2	3	0	0	3	0	0
14	12109698	.	T	C	1	2	3	0	0	3	0	0
14	12110493	.	A	G	2	3	5	0	0	5	0	0
14	12110550	.	A	G	2	0	2	0	2	4	0	0
14	12111019	.	C	T	1	4	5	0	1	6	0	0
14	12111100	.	A	T	4	2	6	0	0	6	0	0
14	12111109	.	G	A	5	3	8	0	0	8	0	0
14	12157456	.	C	T	12	8	20	0	1	21	0	0
14	12159384	.	C	G	17	15	32	0	3	35	0	0
14	12162692	.	C	T	16	20	36	0	0	36	0	0
14	12162731	.	A	C	18	17	35	0	0	35	0	0
14	12164364	.	C	A	30	31	61	0	2	63	0	0
14	12166656	.	A	G	20	22	42	0	2	44	0	0
14	12166956	.	C	T	19	20	39	0	1	40	0	0
14	12166974	.	A	G	19	21	40	0	1	41	0	0
14	12167321	.	T	A	22	22	44	0	1	45	0	0
14	12167615	.	G	A	1	9	10	0	17	27	0	0
14	12167670	.	C	T	11	4	15	0	5	20	0	0
14	12167679	.	A	T	15	4	19	0	0	19	0	0
14	12179114	.	T	C	4	3	7	0	0	7	0	0
14	12179124	.	T	A	2	3	5	0	0	5	0	0
14	12189019	.	T	C	6	5	11	0	0	11	0	0
14	12189856	.	C	T	6	7	13	0	0	13	0	0
14	12191579	.	T	A	7	4	11	0	0	11	0	0
14	12191615	.	A	G	7	0	7	0	4	11	0	0
14	12195119	.	T	A	11	5	16	0	0	16	0	0
14	12205329	.	T	C	9	9	18	0	0	18	0	0
14	12205521	.	C	T	13	5	18	0	3	26	5	0
14	12205566	.	T	C	16	5	21	0	0	21	0	0
14	12370570	.	A	G	3	3	6	0	1	7	0	0
14	12428324	.	G	T	7	5	12	0	0	12	0	0
14	12429901	.	A	G	1	3	4	0	0	4	0	0
14	12436410	.	G	A	6	4	10	0	1	11	0	0
14	12452477	.	C	T	2	8	10	0	0	10	0	0
14	12452516	.	G	A	1	5	6	0	4	10	0	0
14	12465519	.	C	A	14	15	29	0	0	29	0	0
14	12472233	.	C	T	13	14	27	0	1	28	0	0
14	12473599	.	T	A	4	3	7	0	4	11	0	0
14	12473932	.	T	C	3	10	13	0	1	14	0	0
14	12473992	.	A	T	1	4	5	0	1	6	0	0
14	12474159	.	T	C	8	9	17	0	0	17	0	0
14	12481591	.	C	T	4	6	10	0	0	10	0	0
14	12481600	.	T	C	2	6	8	0	1	9	0	0
14	12535403	.	T	G	25	19	44	0	1	46	1	0
14	12535622	.	G	T	29	18	47	0	5	52	0	0
14	12535775	.	G	T	18	12	30	0	2	32	0	0
14	12535901	.	A	G	8	6	14	0	0	14	0	0
14	12536420	.	T	G	23	25	48	0	3	51	0	0
14	12636012	.	A	T	3	3	6	0	0	6	0	0
14	12837003	.	C	T	2	2	4	0	0	4	0	0
14	12837079	.	A	G	5	5	10	0	0	10	0	0
14	13524092	.	A	G	6	2	8	0	1	9	0	0
14	13525082	.	A	G	6	8	14	0	1	15	0	0
14	14094032	.	C	T	3	4	7	0	0	7	0	0
14	14502450	.	C	T	3	8	11	0	1	12	0	0
14	14502708	.	T	C	9	10	19	0	1	20	0	0
14	14502846	.	C	T	3	5	8	0	0	8	0	0
14	14502885	.	C	T	4	6	10	0	0	10	0	0
14	14532450	.	T	C	16	20	36	0	0	36	0	0
14	14532696	.	T	G	17	13	30	0	4	34	0	0
14	14532831	.	A	G	10	9	19	0	2	21	0	0
14	14534219	.	G	A	11	12	23	0	1	24	0	0
14	14566166	.	C	T	2	4	6	0	0	6	0	0
14	14593109	.	T	C	4	2	6	0	0	6	0	0
14	14593175	.	T	C	2	5	7	0	2	9	0	0
14	14593889	.	G	A	7	6	13	0	0	13	0	0
14	14594910	.	G	T	2	2	4	0	0	4	0	0
14	14595535	.	A	G	3	6	9	0	0	9	0	0
14	14595576	.	T	G	5	3	8	0	0	8	0	0
14	14595695	.	A	C	5	3	8	0	3	11	0	0
14	14595734	.	C	G	10	7	17	0	0	17	0	0
14	14596121	.	T	G	10	5	15	0	1	16	0	0
14	14596176	.	T	C	5	3	8	0	0	8	0	0
14	14662597	.	A	T	21	15	36	0	5	41	0	0
14	14662606	.	A	G	19	18	37	0	4	41	0	0
14	14662663	.	C	T	22	8	30	0	2	32	0	0
14	14662684	.	C	T	20	11	31	0	1	32	0	0
14	14664974	.	T	C	9	11	20	0	0	20	0	0
14	14664998	.	G	A	10	9	19	0	1	20	0	0
14	14665175	.	T	C	11	17	28	0	2	30	0	0
14	14665229	.	A	G	10	10	20	0	1	21	0	0
14	14665270	.	T	G	3	9	12	0	0	12	0	0
14	14665432	.	A	G	5	3	8	0	1	9	0	0
14	14665502	.	C	G	14	5	19	0	0	19	0	0
14	14666173	.	A	T	10	8	18	0	0	18	0	0
14	14666394	.	G	A	13	11	24	0	0	24	0	0
14	14666437	.	A	T	10	4	14	0	0	14	0	0
14	14690710	.	G	T	11	13	24	4	1	29	0	0
14	14690831	.	C	A	8	11	19	36	2	57	0	0
14	14690837	.	G	A	9	11	20	40	1	61	0	0
14	14694930	.	A	G	21	24	45	0	1	46	0	0
14	14695136	.	A	G	18	28	46	0	1	47	0	0
14	14695181	.	A	G	16	24	40	0	3	43	0	0
14	14695428	.	C	T	2	6	8	2	23	33	0	0
14	14695864	.	T	C	17	0	17	0	20	37	0	0
14	14722530	.	A	T	12	8	20	0	0	20	0	0
14	14722556	.	T	C	11	10	21	0	0	21	0	0
14	14722929	.	G	A	7	5	12	0	1	13	0	0
14	14723381	.	A	T	8	6	14	0	0	14	0	0
14	14723410	.	G	T	7	5	12	0	0	12	0	0
14	14724026	.	C	T	2	5	7	0	0	7	0	0
14	14724951	.	G	A	32	27	59	0	5	64	0	0
14	14724953	.	A	G	36	24	60	0	5	65	0	0
14	14724987	.	G	A	29	27	56	0	4	60	0	0
14	14725132	.	A	T	28	12	40	0	10	50	0	0
14	14725314	.	G	A	39	24	63	0	4	67	0	0
14	14728192	.	G	T	17	14	31	29	1	61	0	0
14	14729069	.	G	A	27	31	58	2	2	62	0	0
14	14739116	.	T	C	9	13	22	0	0	22	0	0
14	14836656	.	T	C	6	2	8	0	0	8	0	0
14	14837051	.	A	G	3	2	5	0	0	5	0	0
14	14837588	.	T	A	1	2	3	0	0	3	0	0
14	14837693	.	T	C	4	6	10	0	2	12	0	0
14	14844529	.	A	G	2	5	7	0	1	8	0	0
14	14844658	.	T	G	3	5	8	0	0	8	0	0
14	14845532	.	G	A	0	5	5	0	1	6	0	0
14	14855017	.	T	C	5	7	12	0	0	12	0	0
14	14855057	.	C	T	5	6	11	0	0	11	0	0
14	14855139	.	T	A	5	5	10	0	0	10	0	0
14	14855456	.	C	T	7	5	12	0	0	12	0	0
14	14864897	.	A	G	3	1	4	0	1	5	0	0
14	15070912	.	A	G	6	2	8	0	0	8	0	0
14	15071502	.	C	T	3	2	5	0	1	6	0	0
14	15086220	.	G	A	5	9	14	0	0	14	0	0
14	15130235	.	G	A	1	2	3	0	0	3	0	0
14	15155866	.	C	T	7	3	10	0	0	10	0	0
14	15155901	.	A	G	5	0	5	0	7	12	0	0
14	15155955	.	T	G	1	3	4	0	1	5	0	0
14	15662731	.	G	A	6	5	11	0	0	11	0	0
14	15662795	.	G	C	4	6	10	0	0	10	0	0
14	15662836	.	A	T	4	5	9	0	0	9	0	0
14	15663014	.	C	T	7	9	16	0	3	19	0	0
14	15663053	.	T	A	5	3	8	0	1	9	0	0
14	15663175	.	T	C	5	4	9	0	0	9	0	0
14	15663184	.	T	C	5	3	8	0	0	8	0	0
14	15663237	.	T	C	7	5	12	0	0	12	0	0
14	15663766	.	T	A	7	2	9	0	0	9	0	0
14	15663883	.	G	A	3	3	6	0	0	6	0	0
14	15664251	.	T	A	5	9	14	0	2	16	0	0
14	15664263	.	T	C	4	10	14	0	0	14	0	0
14	15664288	.	C	T	6	5	11	0	0	11	0	0
14	15677790	.	C	T	0	4	4	0	2	6	0	0
14	15677831	.	G	A	2	3	5	0	1	6	0	0
14	15677882	.	C	T	1	4	5	0	0	5	0	0
14	15677907	.	A	G	1	3	4	0	0	4	0	0
14	15678291	.	A	G	5	3	8	0	0	8	0	0
14	15678362	.	G	A	5	2	7	0	1	8	0	0
14	15678444	.	A	G	6	4	10	0	0	10	0	0
14	15678447	.	A	T	6	4	10	0	0	10	0	0
14	15760375	.	A	C	3	2	5	0	0	5	0	0
14	15812577	.	A	G	3	7	10	0	0	10	0	0
14	15812685	.	C	T	5	5	10	0	0	10	0	0
14	15812857	.	T	C	1	2	3	0	0	3	0	0
14	15812870	.	C	T	2	2	4	0	0	4	0	0
14	15813702	.	G	T	8	5	13	0	0	13	0	0
14	15814084	.	T	G	1	2	3	0	1	4	0	0
14	15814770	.	C	T	4	4	8	0	0	8	0	0
14	15972435	.	C	A	13	4	17	0	0	17	0	0
14	15972597	.	G	A	4	5	9	0	0	9	0	0
14	15972666	.	G	A	7	8	15	0	0	15	0	0
14	15973920	.	G	A	4	6	10	0	0	10	0	0
14	15973981	.	C	A	1	5	6	0	0	6	0	0
14	15974188	.	T	A	3	4	7	0	3	10	0	0
14	15974232	.	G	A	2	3	5	0	1	6	0	0
14	15974370	.	T	C	1	8	9	0	0	9	0	0
14	15980828	.	T	A	3	2	5	0	0	5	0	0
14	15983590	.	T	C	3	3	6	0	0	6	0	0
14	16042530	.	C	A	5	3	8	0	1	9	0	0
14	16069264	.	A	C	2	3	5	0	1	6	0	0
14	16069449	.	T	A	5	3	8	0	0	8	0	0
14	16084339	.	C	T	7	2	9	0	1	10	0	0
14	16090261	.	C	T	7	4	11	0	2	13	0	0
14	16090764	.	T	C	8	8	16	0	2	18	0	0
14	16090939	.	A	C	13	11	24	0	0	24	0	0
14	16091586	.	T	A	6	12	18	0	4	23	1	0
14	16091709	.	T	G	11	5	16	0	0	16	0	0
14	16091765	.	T	C	5	4	9	0	0	9	0	0
14	16093926	.	G	T	1	2	3	0	0	3	0	0
14	16093983	.	G	A	15	8	23	0	3	26	0	0
14	16097204	.	T	A	9	8	17	0	0	17	0	0
14	16115353	.	A	G	11	11	22	0	1	23	0	0
14	16122866	.	T	C	14	22	36	0	0	36	0	0
14	16122913	.	G	A	2	17	19	0	16	35	0	0
14	16127308	.	C	T	5	6	11	0	1	12	0	0
14	16127346	.	G	T	11	8	19	0	1	20	0	0
14	16127362	.	C	A	0	10	10	0	11	21	0	0
14	16130167	.	C	G	18	18	36	0	0	36	0	0
14	16208059	.	T	G	5	3	8	0	0	8	0	0
14	16384226	.	A	G	2	2	4	0	0	4	0	0
14	16435150	.	G	A	23	24	47	0	1	48	0	0
14	16484577	.	G	A	7	4	11	0	0	11	0	0
14	16484713	.	A	G	4	5	9	0	0	9	0	0
14	16484763	.	C	T	1	7	8	0	5	13	0	0
14	16485222	.	C	T	1	7	8	0	3	11	0	0
14	16606649	.	C	A	1	6	7	0	6	13	0	0
14	16754060	.	C	T	0	5	5	1	5	11	0	0
14	16769067	.	A	G	14	14	28	0	3	31	0	0
14	16769109	.	T	C	16	13	29	0	0	29	0	0
14	16769189	.	C	T	12	10	22	0	1	23	0	0
14	16769246	.	C	T	13	20	33	0	1	34	0	0
14	16769550	.	A	G	17	2	19	0	12	32	1	0
14	16770338	.	T	A	12	17	29	0	0	29	0	0
14	16770646	.	C	A	18	18	36	0	1	37	0	0
14	16770847	.	C	T	15	20	35	0	2	37	0	0
14	16770959	.	T	A	14	13	27	0	0	27	0	0
14	16771194	.	A	T	6	2	8	0	0	8	0	0
14	16771265	.	A	T	7	8	15	0	0	15	0	0
14	16771339	.	T	C	11	4	15	0	0	15	0	0
14	16771340	.	A	G	11	0	11	0	4	15	0	0
14	16777673	.	T	C	3	0	3	0	2	5	0	0
14	16777677	.	A	C	3	1	4	0	1	5	0	0
14	16778086	.	G	A	4	5	9	0	1	10	0	0
14	16968302	.	T	C	4	4	8	0	0	8	0	0
14	16996869	.	T	C	2	5	7	0	0	7	0	0
14	16996870	.	G	A	3	5	8	0	0	8	0	0
14	17003333	.	G	A	5	9	14	0	4	18	0	0
14	17003628	.	G	A	3	5	8	0	1	9	0	0
14	17016521	.	G	A	10	11	21	0	1	22	0	0
14	17016650	.	C	T	10	8	18	0	1	19	0	0
14	17025109	.	A	T	21	5	26	0	1	27	0	0
14	17025116	.	G	A	22	5	27	0	3	30	0	0
14	17025472	.	T	A	4	4	8	0	0	8	0	0
14	17025574	.	A	G	5	6	11	0	0	11	0	0
14	17025586	.	C	T	5	6	11	0	0	11	0	0
14	17025807	.	T	C	5	6	11	0	2	13	0	0
14	17026001	.	A	G	4	3	7	0	1	8	0	0
14	17026103	.	G	A	5	3	8	0	1	9	0	0
14	17026534	.	G	A	12	5	17	0	1	18	0	0
14	17026550	.	C	T	14	8	22	0	1	23	0	0
14	17026724	.	T	C	11	17	28	0	2	30	0	0
14	17026840	.	T	C	12	6	18	0	1	19	0	0
14	17066253	.	T	C	4	4	8	0	0	8	0	0
14	17197240	.	A	C	6	8	14	0	0	14	0	0
14	17198928	.	A	G	11	6	17	0	0	17	0	0
14	17198988	.	T	G	9	5	14	0	3	17	0	0
14	17199349	.	C	T	10	16	26	0	0	26	0	0
14	17199990	.	A	G	27	18	45	0	1	46	0	0
14	17200159	.	C	T	8	14	22	0	0	22	0	0
14	17200174	.	G	T	2	11	13	0	12	25	0	0
14	17200407	.	C	A	8	14	22	0	0	23	1	0
14	17200482	.	T	C	12	10	22	0	0	22	0	0
14	17200653	.	A	C	18	15	33	0	4	37	0	0
14	17230601	.	A	G	8	9	17	0	0	17	0	0
14	17233541	.	C	T	16	13	29	0	0	29	0	0
14	17266013	.	A	T	15	12	27	0	1	28	0	0
14	17275609	.	T	A	7	12	19	0	0	19	0	0
14	17275708	.	C	G	12	9	21	0	0	21	0	0
14	17278972	.	C	T	8	7	15	0	0	15	0	0
14	17279197	.	G	A	2	3	5	0	0	5	0	0
14	17279305	.	T	C	8	6	14	0	0	14	0	0
14	17281713	.	G	A	5	3	8	0	0	8	0	0
14	17281727	.	C	G	7	6	13	0	1	14	0	0
14	17281818	.	T	C	4	2	6	0	1	7	0	0
14	17281831	.	G	A	5	4	9	0	1	10	0	0
14	17282058	.	G	A	6	6	12	0	0	12	0	0
14	17282061	.	C	T	6	5	11	0	1	12	0	0
14	17282095	.	C	G	4	5	9	0	0	9	0	0
14	17282100	.	C	T	1	3	4	0	4	8	0	0
14	17282160	.	C	T	4	3	7	0	0	7	0	0
14	17348286	.	T	C	4	2	6	0	0	6	0	0
14	17349104	.	G	T	5	3	8	0	0	8	0	0
14	17349171	.	T	G	4	4	8	0	1	9	0	0
14	17349464	.	T	C	12	3	15	0	0	15	0	0
14	17349472	.	C	T	11	3	14	0	1	15	0	0
14	17349639	.	T	C	11	5	16	0	1	17	0	0
14	17349656	.	T	C	10	5	15	0	1	16	0	0
14	17349757	.	C	T	7	2	9	0	0	9	0	0
14	17349821	.	A	G	3	2	5	0	1	6	0	0
14	17349924	.	C	T	8	3	11	1	0	12	0	0
14	17349931	.	T	C	6	5	11	1	1	13	0	0
14	17444047	.	A	C	1	2	3	0	0	3	0	0
14	17568072	.	T	A	6	8	14	0	0	14	0	0
14	17568099	.	A	G	7	6	13	0	1	14	0	0
14	17572743	.	T	C	3	9	12	0	0	12	0	0
14	17575834	.	C	G	5	12	17	0	0	17	0	0
14	17575868	.	G	A	8	7	15	0	2	17	0	0
14	17575872	.	C	T	7	7	14	0	2	16	0	0
14	17580662	.	G	A	13	9	22	0	0	22	0	0
14	17580917	.	G	A	31	18	49	0	2	51	0	0
14	17580922	.	C	A	31	18	49	0	3	52	0	0
14	17581036	.	C	A	27	15	42	0	2	44	0	0
14	17586527	.	A	G	18	10	28	0	2	30	0	0
14	17586693	.	G	A	13	24	37	0	1	38	0	0
14	17588131	.	G	T	14	6	20	1	1	23	1	0
14	17593767	.	A	T	16	11	27	0	0	27	0	0
14	17593783	.	T	A	14	11	25	0	0	25	0	0
14	17593803	.	A	T	17	9	26	0	2	28	0	0
14	17593823	.	A	T	17	13	30	0	0	30	0	0
14	17593992	.	T	A	10	6	16	0	1	17	0	0
14	17594137	.	G	A	6	3	9	0	4	13	0	0
14	17594556	.	C	T	8	3	11	0	0	11	0	0
14	17595170	.	C	A	4	2	6	0	0	6	0	0
14	17595192	.	A	T	4	3	7	0	1	8	0	0
14	18667559	.	T	C	19	15	34	0	0	34	0	0
14	18667852	.	T	C	15	16	31	0	3	34	0	0
14	18668731	.	A	G	3	5	8	0	0	8	0	0
14	18669481	.	C	A	10	20	30	0	4	34	0	0
14	18670446	.	C	T	14	10	24	0	0	24	0	0
14	18670582	.	T	A	12	8	20	0	1	21	0	0
14	18670665	.	A	G	8	4	12	1	0	13	0	0
14	18671011	.	A	T	10	4	14	0	1	15	0	0
14	18672233	.	G	A	5	1	6	0	0	6	0	0
14	18672491	.	C	T	3	5	8	0	1	9	0	0
14	19258995	.	C	T	2	12	14	0	1	15	0	0
14	19259292	.	A	G	4	9	13	0	3	16	0	0
14	19260261	.	A	G	7	12	19	0	2	21	0	0
14	19261044	.	C	T	16	15	31	2	0	33	0	0
14	20159151	.	T	C	3	7	10	0	1	11	0	0
14	20188941	.	G	A	1	10	11	0	11	22	0	0
14	20189180	.	T	C	16	12	28	0	1	29	0	0
14	20189188	.	G	A	19	13	32	0	0	32	0	0
14	20189339	.	T	A	8	5	13	0	2	15	0	0
14	20190023	.	A	C	10	13	23	0	1	24	0	0
14	20190297	.	C	G	22	19	41	0	2	43	0	0
14	20190494	.	G	T	2	16	18	0	19	37	0	0
14	20190532	.	G	A	20	14	34	0	2	36	0	0
14	20694640	.	A	C	2	2	4	0	0	4	0	0
14	20695409	.	A	C	5	3	8	0	0	8	0	0
14	20728633	.	A	G	5	3	8	0	0	8	0	0
14	20730179	.	A	C	2	2	4	0	0	4	0	0
14	20730182	.	G	A	2	2	4	0	0	4	0	0
14	20731633	.	A	T	6	3	9	0	0	9	0	0
14	20731656	.	T	A	5	5	10	0	0	10	0	0
14	20731675	.	A	T	4	3	7	0	0	7	0	0
14	20731756	.	G	A	2	6	8	0	0	8	0	0
14	20731797	.	C	T	3	11	14	0	0	14	0	0
14	20731904	.	T	C	1	4	5	0	1	6	0	0
14	20732426	.	T	C	2	4	6	0	0	6	0	0
14	20732457	.	T	C	3	5	8	0	0	8	0	0
14	20732474	.	G	C	0	5	5	0	2	7	0	0
14	20732546	.	G	C	5	2	7	0	0	7	0	0
14	20732793	.	A	T	1	2	3	0	0	3	0	0
14	20733016	.	A	G	1	6	7	0	0	7	0	0
14	20733078	.	A	G	4	2	6	0	0	6	0	0
14	20734167	.	T	A	4	4	8	0	0	8	0	0
14	20734382	.	T	G	1	2	3	0	0	3	0	0
14	20734823	.	A	G	2	2	4	0	0	4	0	0
14	20734827	.	G	A	2	2	4	0	0	4	0	0
14	20735388	.	T	G	10	18	28	0	1	29	0	0
14	20735481	.	T	C	14	12	26	2	1	29	0	0
14	20735525	.	T	A	9	2	11	2	2	15	0	0
14	20735585	.	G	T	1	2	3	0	0	3	0	0
14	20735626	.	G	T	7	3	10	0	0	10	0	0
14	20735841	.	A	G	16	0	16	0	9	25	0	0
14	20736251	.	A	G	14	11	25	0	2	27	0	0
14	20869833	.	G	A	1	4	5	0	0	5	0	0
14	20869866	.	C	A	2	3	5	0	0	5	0	0
14	20869943	.	T	C	6	1	7	0	6	13	0	0
14	20869949	.	G	A	6	8	14	0	0	14	0	0
14	20870141	.	G	T	6	8	14	0	1	15	0	0
14	20870153	.	A	G	7	8	15	0	2	17	0	0
14	20870257	.	A	G	6	11	17	0	2	19	0	0
14	20870321	.	G	T	6	3	9	0	0	9	0	0
14	20879947	.	T	G	3	3	6	0	3	9	0	0
14	20881464	.	C	A	2	3	5	0	0	5	0	0
14	20881493	.	C	T	4	2	6	0	0	6	0	0
14	20973364	.	T	C	2	2	4	0	0	4	0	0
14	20988209	.	T	C	3	4	7	0	0	7	0	0
14	20994005	.	T	C	1	4	5	0	0	5	0	0
14	20994047	.	A	G	3	0	3	0	3	6	0	0
14	20994051	.	G	A	0	4	4	0	3	7	0	0
14	20994527	.	T	A	1	3	4	0	0	4	0	0
14	20994556	.	G	A	3	2	5	0	0	5	0	0
14	20994695	.	G	A	3	4	7	0	0	7	0	0
14	20994967	.	T	C	4	7	11	0	0	11	0	0
14	20996393	.	C	T	9	4	13	0	0	13	0	0
14	20996394	.	A	T	9	3	12	0	2	14	0	0
14	20999918	.	C	T	2	2	4	0	0	4	0	0
14	21000170	.	C	G	6	9	15	1	0	16	0	0
14	21000193	.	T	C	9	7	16	0	3	19	0	0
14	21000256	.	C	A	5	5	10	0	0	10	0	0
14	21000257	.	A	G	5	5	10	0	0	10	0	0
14	21067935	.	A	G	8	10	18	0	1	19	0	0
14	21067938	.	T	C	7	10	17	0	0	17	0	0
14	21071965	.	T	C	12	5	17	0	2	19	0	0
14	21072037	.	G	A	6	12	18	0	1	19	0	0
14	21072729	.	A	G	12	19	31	0	2	33	0	0
14	21072792	.	C	T	9	13	22	0	1	23	0	0
14	21072834	.	C	T	5	6	11	0	0	11	0	0
14	21072852	.	G	A	4	7	11	0	1	12	0	0
14	21078274	.	G	A	3	2	5	0	1	6	0	0
14	21078277	.	T	C	3	2	5	0	0	5	0	0
14	21079937	.	G	C	6	0	6	0	6	12	0	0
14	21079991	.	A	T	3	4	7	0	1	8	0	0
14	21087521	.	C	A	4	2	6	0	0	6	0	0
14	21090848	.	A	C	2	0	2	0	7	9	0	0
14	21098305	.	A	G	5	5	10	0	0	10	0	0
14	21098316	.	A	C	5	2	7	0	0	7	0	0
14	21114988	.	A	C	2	2	4	0	0	4	0	0
14	21114989	.	G	T	2	2	4	0	0	4	0	0
14	21124321	.	T	C	8	6	14	0	2	16	0	0
14	21124360	.	G	T	7	10	17	0	1	18	0	0
14	21124469	.	A	G	4	5	9	0	1	10	0	0
14	21129362	.	T	G	8	14	22	0	3	25	0	0
14	21129629	.	G	T	8	8	16	0	2	18	0	0
14	21132180	.	G	A	6	8	14	0	0	14	0	0
14	21159943	.	T	G	8	0	8	0	12	20	0	0
14	21159949	.	A	T	9	9	18	0	3	21	0	0
14	21183865	.	G	A	8	16	24	0	0	24	0	0
14	21183910	.	A	G	10	10	20	0	0	20	0	0
14	21187563	.	C	T	20	11	31	0	1	32	0	0
14	21187631	.	C	T	18	11	29	0	0	29	0	0
14	21195795	.	C	T	17	18	35	0	0	35	0	0
14	21198328	.	A	C	21	21	42	1	0	43	0	0
14	21198349	.	T	A	18	9	27	1	2	30	0	0
14	21198391	.	A	C	9	12	21	0	1	22	0	0
14	21198403	.	T	C	14	16	30	0	2	32	0	0
14	21198689	.	T	A	13	17	30	0	3	33	0	0
14	21198818	.	C	T	15	20	35	0	0	35	0	0
14	21199092	.	G	T	10	9	19	0	3	22	0	0
14	21204542	.	G	A	5	5	10	0	0	10	0	0
14	21204553	.	T	A	4	6	10	0	1	11	0	0
14	21204814	.	T	A	4	7	11	0	1	12	0	0
14	21205297	.	T	C	4	7	11	0	0	11	0	0
14	21205429	.	T	C	17	0	17	0	13	30	0	0
14	21205471	.	G	A	19	9	28	0	2	30	0	0
14	21205623	.	G	T	7	12	19	0	2	21	0	0
14	21211802	.	A	C	7	6	13	0	0	13	0	0
14	21211859	.	T	A	6	9	15	0	0	15	0	0
14	21219450	.	A	G	2	7	9	0	1	10	0	0
14	21237952	.	A	G	2	3	5	0	0	5	0	0
14	21237963	.	T	C	0	3	3	0	1	4	0	0
14	21238759	.	T	C	10	8	18	0	1	19	0	0
14	21238782	.	T	A	6	12	18	0	2	20	0	0
14	21241695	.	G	A	0	19	19	0	16	35	0	0
14	21241870	.	T	A	12	6	18	0	0	18	0	0
14	21241899	.	A	G	7	8	15	0	0	15	0	0
14	21242082	.	T	A	8	9	17	2	0	19	0	0
14	21242148	.	C	T	8	7	15	0	1	16	0	0
14	21245050	.	T	G	5	6	11	0	1	12	0	0
14	21245315	.	G	T	5	5	10	1	0	11	0	0
14	21332964	.	G	A	25	36	61	0	4	65	0	0
14	21333795	.	G	A	31	37	68	0	5	73	0	0
14	21333867	.	C	A	6	28	34	0	43	77	0	0
14	21333957	.	G	A	42	42	84	0	7	91	0	0
14	21334257	.	G	T	41	22	63	0	2	66	1	0
14	21334338	.	A	G	28	34	62	0	5	67	0	0
14	21334840	.	G	C	31	34	65	0	7	72	0	0
14	21334968	.	G	A	27	30	57	0	0	57	0	0
14	21334985	.	G	T	31	24	55	0	3	58	0	0
14	21597044	.	A	G	21	16	37	0	2	39	0	0
14	21597140	.	C	A	25	15	40	1	12	53	0	0
14	21597264	.	G	A	21	16	37	0	0	37	0	0
14	21597363	.	A	G	22	11	33	0	3	36	0	0
14	21597451	.	T	C	9	8	17	0	1	18	0	0
14	21597469	.	T	C	9	5	14	0	1	15	0	0
14	21597671	.	T	C	12	12	24	0	2	26	0	0
14	21597730	.	C	T	17	19	36	0	1	37	0	0
14	21597755	.	T	A	19	14	33	2	0	35	0	0
14	21597814	.	C	T	14	17	31	2	0	33	0	0
14	21598035	.	C	T	13	15	28	1	5	34	0	0
14	21598354	.	T	C	23	0	23	0	19	42	0	0
14	21598372	.	G	A	22	13	35	0	3	38	0	0
14	21598402	.	C	A	16	13	29	0	0	29	0	0
14	21598488	.	C	T	19	13	32	0	1	33	0	0
14	21598724	.	T	G	24	12	36	0	1	37	0	0
14	21598831	.	G	T	28	17	45	0	3	48	0	0
14	21603294	.	G	C	24	18	42	0	0	42	0	0
14	21603335	.	A	G	32	15	47	0	1	48	0	0
14	21609707	.	A	G	22	13	35	0	1	36	0	0
14	21609733	.	A	G	21	17	38	0	2	40	0	0
14	21616066	.	T	C	6	4	10	2	0	12	0	0
14	21617939	.	G	A	8	11	19	0	1	20	0	0
14	21617947	.	G	C	8	10	18	0	0	18	0	0
14	21623128	.	A	T	9	16	25	0	0	25	0	0
14	21623324	.	C	T	7	10	17	0	1	18	0	0
14	21630153	.	A	G	7	19	26	0	0	26	0	0
14	21636953	.	G	A	15	14	29	0	1	30	0	0
14	21636965	.	A	G	14	15	29	0	2	31	0	0
14	21639583	.	A	G	7	10	17	0	0	17	0	0
14	21643647	.	T	A	3	6	9	0	2	11	0	0
14	21646110	.	G	A	10	7	17	0	1	18	0	0
14	21652399	.	G	T	6	4	10	0	0	10	0	0
14	21652864	.	C	T	4	5	9	0	0	9	0	0
14	21654600	.	G	A	5	4	9	0	0	9	0	0
14	21654808	.	A	G	3	4	7	0	1	8	0	0
14	21655086	.	C	T	0	2	2	0	3	5	0	0
14	21655177	.	T	C	2	3	5	0	0	5	0	0
14	21655533	.	T	C	4	3	7	0	0	7	0	0
14	21656452	.	C	G	1	4	5	0	0	5	0	0
14	21660213	.	T	C	1	3	4	0	0	4	0	0
14	21689852	.	C	T	26	23	49	0	3	52	0	0
14	21693251	.	G	A	38	33	71	0	3	74	0	0
14	21693584	.	T	G	21	31	52	0	0	52	0	0
14	21745871	.	C	A	5	5	10	0	0	10	0	0
14	21745879	.	A	T	5	5	10	0	0	10	0	0
14	21745917	.	G	C	4	4	8	0	0	8	0	0
14	21746076	.	C	T	3	3	6	0	1	7	0	0
14	21746096	.	A	T	4	3	7	0	0	7	0	0
14	21746255	.	G	C	2	2	4	0	0	4	0	0
14	21750970	.	C	T	2	6	8	0	0	8	0	0
14	21766410	.	C	T	3	2	5	0	1	6	0	0
14	21766428	.	A	G	4	4	8	0	0	8	0	0
14	21768244	.	G	A	0	4	4	0	6	10	0	0
14	21771915	.	G	A	6	5	11	0	1	12	0	0
14	21772412	.	C	T	6	5	11	0	0	11	0	0
14	21779102	.	C	T	7	8	15	0	0	15	0	0
14	21779141	.	G	A	3	4	7	1	6	14	0	0
14	21779241	.	G	A	7	11	18	0	0	18	0	0
14	21779518	.	C	T	6	3	9	0	2	11	0	0
14	21779551	.	A	G	7	3	10	0	0	10	0	0
14	21779633	.	T	C	5	5	10	0	0	10	0	0
14	21779975	.	C	A	8	3	11	0	0	11	0	0
14	21779977	.	G	A	3	7	10	0	0	10	0	0
14	21780155	.	C	G	10	5	15	0	0	15	0	0
14	21780206	.	A	G	10	12	22	0	0	22	0	0
14	21780274	.	A	C	5	12	17	0	1	19	1	0
14	21780321	.	T	C	5	8	13	0	1	14	0	0
14	21790748	.	C	T	5	9	14	1	0	15	0	0
14	21801383	.	G	A	9	11	20	0	0	20	0	0
14	21804912	.	T	C	16	14	30	0	0	30	0	0
14	21806190	.	C	T	13	11	24	0	0	24	0	0
14	21806196	.	G	C	2	9	11	0	13	24	0	0
14	21813696	.	G	A	25	20	45	0	4	49	0	0
14	21816388	.	T	C	14	19	33	0	0	33	0	0
14	21834912	.	C	T	8	7	15	0	0	15	0	0
14	21838379	.	T	C	10	9	19	3	4	26	0	0
14	21840858	.	A	G	6	0	6	0	8	14	0	0
14	21842804	.	T	C	13	17	30	0	3	33	0	0
14	21843726	.	G	A	2	12	14	0	10	24	0	0
14	21844187	.	T	A	18	11	29	0	2	31	0	0
14	21844486	.	C	T	8	8	16	0	0	16	0	0
14	21924273	.	A	G	2	9	11	0	0	11	0	0
14	21924382	.	A	G	6	5	11	0	3	14	0	0
14	21924547	.	G	A	4	2	6	0	0	6	0	0
14	21925565	.	G	A	1	2	3	0	0	3	0	0
14	21925571	.	A	C	0	0	0	0	3	3	0	0
14	21928614	.	A	G	3	2	5	0	0	5	0	0
14	21928788	.	C	A	0	2	2	0	2	4	0	0
14	21999177	.	C	T	5	6	11	0	0	11	0	0
14	22104906	.	T	C	12	14	26	0	1	27	0	0
14	22104948	.	G	A	10	23	33	0	2	35	0	0
14	22108215	.	C	T	11	11	22	0	1	23	0	0
14	22132510	.	A	T	15	14	29	0	5	34	0	0
14	22132536	.	A	T	17	17	34	0	2	36	0	0
14	22134069	.	G	A	20	11	31	0	1	32	0	0
14	22139160	.	T	C	22	20	42	0	2	44	0	0
14	22139194	.	C	T	28	21	49	0	2	51	0	0
14	22139254	.	G	A	29	26	55	0	0	55	0	0
14	22139308	.	C	T	17	33	50	0	4	54	0	0
14	22139358	.	G	A	28	24	52	0	1	53	0	0
14	22139392	.	G	T	22	24	46	0	0	47	1	0
14	22139668	.	G	A	5	22	27	0	30	57	0	0
14	22139816	.	G	A	7	21	28	0	24	52	0	0
14	22140150	.	G	A	6	4	10	0	2	12	0	0
14	22140158	.	T	C	5	5	10	0	0	10	0	0
14	22140417	.	T	C	12	6	18	0	1	19	0	0
14	22140542	.	G	A	6	9	15	0	2	17	0	0
14	22145661	.	G	C	7	1	8	0	13	21	0	0
14	22151827	.	A	T	11	9	20	0	0	20	0	0
14	22151913	.	C	T	13	11	24	0	0	24	0	0
14	22151958	.	T	A	10	12	22	0	1	24	1	0
14	22151966	.	A	C	10	14	24	0	0	24	0	0
14	22152004	.	T	G	3	3	6	0	0	7	1	0
14	22172138	.	C	T	10	15	25	0	1	26	0	0
14	22249344	.	G	A	11	9	20	0	1	21	0	0
14	22254184	.	T	C	18	22	40	0	2	42	0	0
14	22272340	.	G	A	27	16	43	0	0	43	0	0
14	22272351	.	G	A	27	17	44	0	0	44	0	0
14	22272749	.	A	G	20	0	20	0	22	42	0	0
14	22362613	.	G	A	0	3	3	0	1	4	0	0
14	22362618	.	C	T	1	3	4	0	0	4	0	0
14	22368699	.	C	T	2	2	4	0	0	4	0	0
14	22371556	.	G	T	1	2	3	0	0	3	0	0
14	22434336	.	G	C	0	4	4	0	3	7	0	0
14	22434387	.	C	T	4	5	9	0	0	9	0	0
14	22437413	.	G	T	5	10	15	0	1	16	0	0
14	22438924	.	A	G	5	4	9	0	0	9	0	0
14	22439183	.	C	G	1	6	7	0	0	7	0	0
14	22439210	.	G	T	1	5	6	0	1	7	0	0
14	22439955	.	T	A	4	4	8	0	0	8	0	0
14	22440004	.	G	T	0	3	3	0	2	5	0	0
14	22440022	.	A	G	2	2	4	0	0	4	0	0
14	22441000	.	G	C	1	4	5	0	0	5	0	0
14	22441057	.	T	C	3	6	9	0	0	9	0	0
14	22441110	.	G	A	3	2	5	0	0	5	0	0
14	22441532	.	T	C	4	10	14	0	0	14	0	0
14	22441581	.	C	A	6	5	11	0	0	11	0	0
14	22441793	.	G	A	1	7	8	0	2	10	0	0
14	22441873	.	T	C	4	5	9	0	1	10	0	0
14	22441929	.	C	T	5	6	11	0	0	11	0	0
14	22452886	.	A	C	1	2	3	1	0	4	0	0
14	22454028	.	G	A	2	2	4	0	0	4	0	0
14	22467923	.	C	A	2	1	3	0	0	3	0	0
14	22467933	.	C	T	3	2	5	0	0	5	0	0
14	22467967	.	G	A	2	2	4	0	0	4	0	0
14	22469807	.	C	T	1	2	3	0	0	3	0	0
14	22469887	.	C	G	4	3	7	0	0	7	0	0
14	22469900	.	C	T	2	2	4	0	1	5	0	0
14	22469954	.	C	A	4	2	6	0	0	6	0	0
14	22469978	.	A	G	3	2	5	0	0	5	0	0
14	22470154	.	T	C	3	3	6	0	0	6	0	0
14	22470213	.	T	C	1	1	2	0	1	3	0	0
14	22478454	.	C	T	3	6	9	0	3	12	0	0
14	22478511	.	G	C	1	6	7	0	0	7	0	0
14	22479368	.	T	C	3	3	6	0	0	6	0	0
14	22479381	.	T	A	1	3	4	0	1	5	0	0
14	22479451	.	T	A	1	2	3	0	1	4	0	0
14	22509843	.	C	A	4	3	7	0	0	7	0	0
14	22515896	.	C	T	6	3	9	0	0	9	0	0
14	22523476	.	A	G	12	5	17	0	0	17	0	0
14	22523524	.	C	G	11	11	22	0	0	22	0	0
14	22523584	.	A	G	7	5	12	0	1	13	0	0
14	22708325	.	A	G	2	5	7	0	5	12	0	0
14	22708389	.	C	T	8	4	12	0	1	13	0	0
14	22708401	.	C	A	9	3	12	0	0	12	0	0
14	22708446	.	C	T	10	4	14	0	0	14	0	0
14	23076277	.	G	A	1	2	3	0	0	3	0	0
14	23409971	.	A	G	4	2	6	0	2	8	0	0
14	23411619	.	C	G	9	0	9	0	6	15	0	0
14	23411712	.	G	T	0	8	8	0	5	13	0	0
14	23455989	.	G	A	12	6	18	0	0	18	0	0
14	23463681	.	G	A	0	5	5	0	5	10	0	0
14	23463708	.	A	G	4	7	11	0	0	11	0	0
14	23463717	.	A	G	3	2	5	0	4	9	0	0
14	23463760	.	C	A	7	7	14	0	1	15	0	0
14	23478997	.	G	C	7	8	15	0	1	16	0	0
14	23609814	.	C	T	1	4	5	0	0	5	0	0
14	23615480	.	G	A	6	2	8	0	2	10	0	0
14	23628158	.	C	T	2	6	8	0	0	8	0	0
14	23663911	.	G	C	7	6	13	0	0	13	0	0
14	23664063	.	T	G	6	6	12	0	1	13	0	0
14	23665987	.	G	A	6	6	12	0	0	12	0	0
14	23666002	.	C	T	5	7	12	0	1	13	0	0
14	23666203	.	T	C	11	7	18	0	3	21	0	0
14	23666227	.	G	A	3	9	12	0	12	24	0	0
14	23666266	.	C	A	10	17	27	0	0	28	1	0
14	23666431	.	G	A	16	8	24	0	0	24	0	0
14	23666451	.	A	G	14	7	21	0	1	22	0	0
14	23666491	.	G	A	3	6	9	0	10	19	0	0
14	23666625	.	C	T	8	11	19	0	1	21	1	0
14	23668714	.	T	C	8	3	11	0	1	12	0	0
14	23668724	.	C	A	9	3	12	0	3	15	0	0
14	23671197	.	A	G	6	2	8	0	17	25	0	0
14	23671248	.	T	C	12	10	22	0	0	22	0	0
14	23671361	.	C	G	13	19	32	0	3	35	0	0
14	23673373	.	G	A	4	17	21	0	24	45	0	0
14	23675378	.	G	A	10	2	12	0	1	13	0	0
14	23675751	.	C	T	9	8	17	0	1	18	0	0
14	23679671	.	G	A	1	4	5	0	0	5	0	0
14	23679674	.	T	G	1	4	5	0	0	5	0	0
14	23680031	.	C	T	3	3	6	0	0	6	0	0
14	23680344	.	T	C	2	3	5	0	0	5	0	0
14	23680405	.	T	C	1	0	1	0	3	4	0	0
14	23687872	.	G	C	6	5	11	0	0	11	0	0
14	23689974	.	A	T	6	2	8	0	0	8	0	0
14	23700121	.	T	C	17	20	37	0	0	37	0	0
14	23700142	.	G	T	15	22	37	0	0	37	0	0
14	23702730	.	G	A	20	14	34	0	0	34	0	0
14	23707976	.	A	G	12	11	23	0	0	23	0	0
14	23717277	.	A	T	14	14	28	0	4	32	0	0
14	23717289	.	A	T	14	18	32	0	1	33	0	0
14	23720196	.	A	T	24	20	44	0	0	44	0	0
14	23725824	.	T	A	6	13	19	0	0	19	0	0
14	23726124	.	G	T	32	15	47	0	2	49	0	0
14	23726413	.	G	A	41	28	69	1	2	72	0	0
14	23726547	.	C	T	17	36	53	0	6	59	0	0
14	23732056	.	C	A	4	10	14	0	0	14	0	0
14	23732117	.	T	C	4	11	15	0	0	15	0	0
14	23732134	.	C	T	2	11	13	0	1	14	0	0
14	23732167	.	C	A	4	10	14	0	0	14	0	0
14	23732299	.	C	T	0	9	9	0	10	19	0	0
14	23732324	.	T	C	10	0	10	0	12	22	0	0
14	23732368	.	C	A	1	9	10	0	9	19	0	0
14	23732396	.	A	G	11	9	20	0	0	20	0	0
14	23732444	.	G	T	12	18	30	0	1	31	0	0
14	23732497	.	C	A	17	15	32	0	0	32	0	0
14	23732547	.	T	A	10	9	19	0	1	20	0	0
14	23732639	.	G	A	3	5	8	0	0	8	0	0
14	23732718	.	A	G	6	8	14	0	1	15	0	0
14	23732734	.	G	A	6	7	13	0	0	13	0	0
14	23732916	.	C	T	2	6	8	0	0	8	0	0
14	23732929	.	T	G	1	5	6	0	0	6	0	0
14	23733097	.	A	G	9	8	17	0	0	17	0	0
14	23733220	.	G	A	10	9	19	0	1	20	0	0
14	23737569	.	A	T	11	12	23	1	1	25	0	0
14	23737655	.	G	A	1	2	3	0	1	4	0	0
14	23748436	.	G	A	14	7	21	0	2	23	0	0
14	23748654	.	A	G	14	11	25	0	2	27	0	0
14	23756637	.	A	G	11	6	17	0	0	17	0	0
14	23756680	.	A	G	7	6	13	0	1	14	0	0
14	23756752	.	T	G	9	10	19	0	0	19	0	0
14	23756809	.	G	T	11	15	26	0	1	27	0	0
14	23765748	.	T	C	8	8	16	0	0	16	0	0
14	23798649	.	C	G	5	5	10	0	3	13	0	0
14	23798675	.	G	C	5	5	10	0	1	11	0	0
14	23798699	.	A	C	5	6	11	0	1	12	0	0
14	23799076	.	G	T	4	3	7	0	0	7	0	0
14	23799095	.	G	T	3	5	8	0	0	8	0	0
14	23811956	.	T	C	3	2	5	0	0	5	0	0
14	23812581	.	C	T	2	4	6	0	1	7	0	0
14	23947550	.	A	G	2	1	3	0	1	4	0	0
14	23967522	.	C	T	1	1	2	0	1	3	0	0
14	23967524	.	T	C	1	2	3	0	0	3	0	0
14	23968042	.	C	T	1	2	3	0	0	3	0	0
14	23968348	.	C	T	2	2	4	0	0	4	0	0
14	23968612	.	A	T	2	5	7	0	0	7	0	0
14	23968619	.	T	A	2	5	7	0	0	7	0	0
14	23968678	.	T	G	10	4	14	0	1	15	0	0
14	23968743	.	C	T	10	11	21	0	0	21	0	0
14	23968774	.	T	C	7	9	16	0	0	16	0	0
14	23968781	.	C	A	6	7	13	0	2	15	0	0
14	23968815	.	A	G	3	4	7	0	0	7	0	0
14	23969154	.	T	C	4	5	9	0	0	9	0	0
14	23969374	.	A	C	3	10	13	0	1	14	0	0
14	23969378	.	G	A	3	12	15	0	0	15	0	0
14	23969443	.	G	C	4	4	8	0	0	8	0	0
14	23969446	.	T	C	6	5	11	0	0	11	0	0
14	23969485	.	G	A	10	4	14	0	1	15	0	0
14	23969779	.	C	G	6	3	9	0	0	9	0	0
14	23970887	.	T	C	14	14	28	0	1	29	0	0
14	23972572	.	G	A	7	4	11	0	4	15	0	0
14	23972587	.	C	T	8	8	16	0	1	17	0	0
14	23976245	.	C	T	13	5	18	0	2	20	0	0
14	23981999	.	T	C	16	15	31	0	0	31	0	0
14	23982623	.	A	T	19	19	38	0	4	42	0	0
14	23991507	.	C	T	23	22	45	0	1	46	0	0
14	23991588	.	G	A	23	20	43	0	0	43	0	0
14	23993952	.	A	G	25	26	51	0	1	52	0	0
14	23993958	.	G	A	26	20	46	0	3	50	1	0
14	23999002	.	G	C	17	16	33	0	1	34	0	0
14	23999086	.	G	A	26	14	40	0	3	43	0	0
14	23999112	.	A	G	26	16	42	0	0	42	0	0
14	23999225	.	A	G	23	19	42	0	1	43	0	0
14	23999239	.	G	C	5	20	25	0	18	43	0	0
14	23999466	.	C	A	4	9	13	0	2	15	0	0
14	24221104	.	C	A	4	6	10	0	0	10	0	0
14	24316809	.	A	T	8	3	11	0	1	12	0	0
14	24317301	.	G	T	30	32	62	0	1	63	0	0
14	24317314	.	T	C	33	30	63	0	2	65	0	0
14	24317508	.	T	C	26	29	55	0	2	57	0	0
14	24317685	.	T	A	31	22	53	0	4	57	0	0
14	24317717	.	T	A	30	22	52	0	1	54	1	0
14	24318087	.	A	T	25	24	49	0	1	50	0	0
14	24318102	.	A	T	25	23	48	0	1	49	0	0
14	24318160	.	T	G	17	15	32	3	2	37	0	0
14	24318196	.	G	A	10	21	31	2	1	34	0	0
14	24318232	.	G	C	18	16	34	4	2	40	0	0
14	24318335	.	G	T	19	17	36	0	1	37	0	0
14	24318479	.	A	T	22	28	50	0	0	50	0	0
14	24318631	.	C	T	20	20	40	0	2	42	0	0
14	24318652	.	G	A	20	22	42	0	3	45	0	0
14	24318709	.	A	T	15	18	33	0	3	36	0	0
14	24318723	.	T	C	15	20	35	0	2	37	0	0
14	24318868	.	T	C	25	27	52	0	1	53	0	0
14	24325537	.	T	C	31	23	54	0	2	56	0	0
14	24326042	.	C	A	3	3	6	0	0	6	0	0
14	24332817	.	A	T	16	21	37	0	0	37	0	0
14	24333761	.	A	G	13	21	34	0	0	34	0	0
14	24391361	.	A	G	9	15	24	0	3	27	0	0
14	24391397	.	G	A	12	6	18	0	1	19	0	0
14	24401077	.	C	T	0	10	10	0	12	22	0	0
14	24401209	.	T	G	13	15	28	0	0	28	0	0
14	24401393	.	A	G	7	14	21	0	0	21	0	0
14	24401700	.	C	A	1	20	21	0	21	42	0	0
14	24401844	.	T	A	12	15	27	0	2	29	0	0
14	24410373	.	G	A	9	16	25	0	1	26	0	0
14	24410384	.	T	C	11	1	12	0	16	28	0	0
14	24410553	.	C	A	14	9	23	0	3	26	0	0
14	24410556	.	T	C	10	15	25	0	0	25	0	0
14	24492051	.	G	C	5	8	13	0	0	13	0	0
14	24492225	.	G	A	7	5	12	0	0	12	0	0
14	24492666	.	C	A	3	4	7	0	0	7	0	0
14	24492667	.	T	A	3	4	7	0	0	7	0	0
14	24492792	.	A	G	4	2	6	0	0	6	0	0
14	24497904	.	T	C	4	0	4	0	7	11	0	0
14	24512823	.	G	A	1	4	5	0	0	5	0	0
14	24515458	.	C	T	3	2	5	0	0	5	0	0
14	24544362	.	A	T	1	3	4	0	0	4	0	0
14	24550671	.	G	A	1	3	4	0	0	4	0	0
14	24550674	.	A	G	1	3	4	0	0	4	0	0
14	24550751	.	A	G	2	2	4	0	0	4	0	0
14	24840805	.	T	C	1	4	5	0	0	5	0	0
14	24840837	.	C	A	1	2	3	0	1	4	0	0
14	24978975	.	T	C	5	2	7	0	0	7	0	0
14	24984979	.	T	C	4	7	11	0	1	12	0	0
14	24984997	.	C	T	1	6	7	0	2	9	0	0
14	24985324	.	A	G	5	3	8	0	1	9	0	0
14	24987643	.	G	T	8	11	19	0	0	19	0	0
14	24990795	.	A	G	4	5	9	0	0	9	0	0
14	24994819	.	G	A	0	3	3	0	2	5	0	0
14	24997871	.	C	T	5	3	8	0	1	9	0	0
14	24998002	.	T	C	9	6	15	0	0	15	0	0
14	24998019	.	A	T	10	6	16	0	2	18	0	0
14	24998076	.	A	G	15	0	15	0	8	23	0	0
14	24998345	.	C	A	5	8	13	0	1	14	0	0
14	24998395	.	C	T	12	12	24	0	0	24	0	0
14	24998430	.	G	A	0	10	10	0	12	22	0	0
14	24998565	.	T	C	15	9	24	0	0	24	0	0
14	24998616	.	A	C	16	7	23	0	0	23	0	0
14	24998737	.	A	C	9	8	17	0	2	19	0	0
14	24998804	.	A	G	7	0	7	0	6	13	0	0
14	24999546	.	T	A	10	13	23	0	2	25	0	0
14	24999722	.	T	C	11	10	21	0	0	22	1	0
14	25000623	.	A	C	11	15	26	0	2	28	0	0
14	25000686	.	T	A	8	11	19	0	0	19	0	0
14	25000803	.	T	G	13	11	24	0	0	24	0	0
14	25063617	.	A	G	14	8	22	0	0	22	0	0
14	25066002	.	C	A	2	17	19	0	24	43	0	0
14	25066010	.	T	A	26	15	41	0	0	41	0	0
14	25066722	.	T	A	23	15	38	0	1	39	0	0
14	25067471	.	C	T	16	12	28	1	2	31	0	0
14	25067665	.	C	T	28	13	41	0	2	43	0	0
14	25067700	.	C	A	19	13	32	0	4	36	0	0
14	25067857	.	G	A	16	9	25	0	2	27	0	0
14	25067862	.	A	C	17	9	26	0	0	26	0	0
14	25067984	.	C	T	22	11	33	0	0	33	0	0
14	25068007	.	G	C	21	6	27	0	0	27	0	0
14	25068206	.	G	T	18	17	35	0	0	35	0	0
14	25068215	.	T	G	20	20	40	0	1	41	0	0
14	25071338	.	C	T	5	12	17	0	24	41	0	0
14	25072307	.	G	T	11	22	33	0	0	33	0	0
14	25072351	.	C	T	17	23	40	0	0	40	0	0
14	25072843	.	A	T	14	9	23	0	0	23	0	0
14	25073511	.	C	T	14	5	19	0	3	22	0	0
14	25075173	.	G	A	2	11	13	0	1	14	0	0
14	25075992	.	C	T	5	4	9	0	0	9	0	0
14	25076609	.	A	T	8	3	11	0	2	13	0	0
14	25076628	.	C	A	9	4	13	0	1	14	0	0
14	25079821	.	C	A	4	2	6	0	0	6	0	0
14	25080035	.	A	G	22	18	40	0	2	42	0	0
14	25084872	.	A	G	29	13	42	0	1	43	0	0
14	25090031	.	C	T	17	13	30	0	1	32	1	0
14	25091043	.	C	G	18	16	34	0	1	35	0	0
14	25091063	.	A	G	17	15	32	0	2	34	0	0
14	25091453	.	C	T	13	14	27	0	1	28	0	0
14	25091467	.	C	T	11	14	25	0	2	27	0	0
14	25092940	.	A	C	9	10	19	0	2	21	0	0
14	25101097	.	T	C	1	0	1	0	4	5	0	0
14	25101126	.	A	G	1	2	3	0	0	3	0	0
14	25101832	.	G	A	1	1	2	0	1	3	0	0
14	25102078	.	G	A	1	2	3	1	0	4	0	0
14	25199830	.	G	T	3	2	5	0	0	5	0	0
14	25199866	.	G	A	1	2	3	0	0	3	0	0
14	25480153	.	T	C	2	3	5	0	0	5	0	0
14	25480219	.	C	T	3	2	5	0	0	5	0	0
14	25482568	.	T	G	2	5	7	0	1	8	0	0
14	25496045	.	A	T	8	3	11	0	0	11	0	0
14	25496052	.	G	C	8	2	10	0	0	10	0	0
14	25501462	.	C	T	10	3	13	0	1	14	0	0
14	25501772	.	C	T	8	7	15	0	2	17	0	0
14	25501870	.	C	A	10	13	23	0	2	25	0	0
14	25510803	.	A	G	3	4	7	0	0	7	0	0
14	25534862	.	G	T	19	7	26	0	0	26	0	0
14	25535003	.	C	T	0	11	11	0	8	19	0	0
14	25535005	.	T	C	7	12	19	0	0	19	0	0
14	25535067	.	A	T	6	16	22	0	0	22	0	0
14	25535167	.	T	G	8	11	19	0	1	20	0	0
14	25535607	.	G	A	19	22	41	0	0	41	0	0
14	25535706	.	G	T	20	28	48	0	0	48	0	0
14	25535742	.	T	A	12	21	33	1	1	35	0	0
14	25535768	.	G	T	17	10	27	1	1	29	0	0
14	25535820	.	C	T	2	7	9	0	16	25	0	0
14	25535947	.	A	T	2	4	6	0	1	7	0	0
14	25536132	.	T	C	22	10	32	1	1	34	0	0
14	25536148	.	G	A	19	11	30	1	2	33	0	0
14	25536187	.	G	T	20	6	26	0	1	27	0	0
14	25536198	.	A	G	21	3	24	0	2	26	0	0
14	25536422	.	A	G	13	8	21	0	1	22	0	0
14	25536531	.	T	G	22	10	32	0	5	37	0	0
14	25536577	.	G	C	22	18	40	0	0	40	0	0
14	25536619	.	A	G	21	21	42	0	2	44	0	0
14	25536657	.	A	C	24	19	43	0	1	44	0	0
14	25536770	.	A	T	20	19	39	0	2	41	0	0
14	25536782	.	C	T	2	18	20	0	20	40	0	0
14	25537019	.	C	A	16	15	31	0	2	33	0	0
14	25537068	.	G	A	12	15	27	0	1	28	0	0
14	25537136	.	T	C	15	15	30	0	0	30	0	0
14	25537145	.	G	A	17	16	33	0	0	33	0	0
14	25537189	.	A	T	11	20	31	0	1	32	0	0
14	25537200	.	C	T	12	21	33	0	0	33	0	0
14	25537231	.	T	C	24	7	31	0	0	31	0	0
14	25537307	.	A	T	10	12	22	0	1	23	0	0
14	25537332	.	T	A	9	14	23	0	2	25	0	0
14	25537345	.	A	G	10	12	22	0	0	22	0	0
14	25537405	.	A	G	10	14	24	0	0	24	0	0
14	25537700	.	C	T	0	9	9	0	13	22	0	0
14	25537975	.	G	T	17	13	30	0	0	30	0	0
14	25538121	.	T	C	17	17	34	0	1	35	0	0
14	25538402	.	G	A	12	14	26	0	1	27	0	0
14	25538433	.	T	A	8	13	21	0	1	22	0	0
14	25538546	.	C	T	9	6	15	0	0	15	0	0
14	25538618	.	T	A	8	6	14	0	0	14	0	0
14	25538803	.	T	A	5	9	14	0	3	17	0	0
14	25539423	.	C	T	2	18	20	0	7	27	0	0
14	25591134	.	A	G	11	5	16	0	0	16	0	0
14	25591176	.	T	G	7	6	13	0	1	14	0	0
14	25591182	.	C	T	2	7	9	0	5	14	0	0
14	25817556	.	T	C	5	3	8	0	1	9	0	0
14	25865208	.	T	C	2	2	4	0	0	4	0	0
14	25904781	.	C	T	4	5	9	0	0	9	0	0
14	25904868	.	C	T	9	9	18	0	0	18	0	0
14	25905091	.	C	T	4	9	13	1	0	14	0	0
14	25905584	.	G	T	5	3	8	0	0	8	0	0
14	25906074	.	A	G	4	7	11	0	2	13	0	0
14	25906135	.	G	A	3	3	6	0	0	6	0	0
14	25906242	.	T	A	1	3	4	0	0	4	0	0
14	25906315	.	T	G	2	2	4	0	0	4	0	0
14	25906344	.	T	A	3	6	9	0	0	9	0	0
14	25906350	.	T	A	3	6	9	0	0	9	0	0
14	25906517	.	C	T	5	5	10	0	1	11	0	0
14	25906652	.	G	T	8	4	12	0	0	12	0	0
14	25906891	.	C	T	3	9	12	0	0	12	0	0
14	25906981	.	T	C	13	8	21	0	1	22	0	0
14	25907081	.	T	A	11	5	16	0	3	19	0	0
14	25907170	.	G	C	13	7	20	0	0	20	0	0
14	25907194	.	A	G	13	0	13	0	5	18	0	0
14	25907335	.	A	G	4	3	7	0	1	8	0	0
14	25907610	.	A	G	4	7	11	0	0	11	0	0
14	25907704	.	T	C	5	6	11	0	1	12	0	0
14	25907737	.	T	C	3	8	11	0	1	12	0	0
14	25907893	.	G	A	0	8	8	0	5	13	0	0
14	25908030	.	A	G	7	7	14	0	0	14	0	0
14	25908113	.	A	C	2	3	5	0	0	5	0	0
14	25908335	.	T	A	3	3	6	0	0	6	0	0
14	25908659	.	G	C	5	6	11	0	0	11	0	0
14	25908680	.	A	T	6	5	11	0	1	12	0	0
14	25908753	.	A	C	6	4	10	0	3	13	0	0
14	25909047	.	T	A	4	10	14	0	1	15	0	0
14	25909048	.	A	T	5	10	15	0	0	15	0	0
14	25909103	.	C	A	4	3	7	0	2	10	1	0
14	25909213	.	C	T	10	13	23	0	2	25	0	0
14	25909258	.	T	G	10	13	23	0	1	24	0	0
14	25909260	.	C	T	11	12	23	0	2	25	0	0
14	25909587	.	A	T	2	2	4	0	0	4	0	0
14	25909656	.	A	G	1	2	3	0	0	3	0	0
14	25909699	.	G	T	1	6	7	0	0	7	0	0
14	25910106	.	C	A	6	2	8	0	0	8	0	0
14	25910126	.	T	A	1	5	6	0	0	6	0	0
14	25910186	.	C	A	7	6	13	0	0	13	0	0
14	25910249	.	G	A	16	10	26	0	1	27	0	0
14	25910276	.	C	T	18	10	28	0	1	29	0	0
14	25910296	.	A	G	20	9	29	1	1	31	0	0
14	25910373	.	T	C	12	11	23	0	2	25	0	0
14	25910407	.	A	G	13	12	25	0	2	27	0	0
14	25910414	.	C	G	15	10	25	0	1	27	1	0
14	25910542	.	C	T	20	11	31	0	0	31	0	0
14	25910715	.	T	C	13	13	26	0	0	26	0	0
14	25910747	.	C	T	17	11	28	0	0	28	0	0
14	25910834	.	T	A	22	18	40	0	2	42	0	0
14	25911097	.	C	T	17	16	33	0	1	34	0	0
14	25923458	.	T	A	1	5	6	0	0	6	0	0
14	25923729	.	T	A	5	6	11	0	0	11	0	0
14	25923745	.	G	A	4	5	9	0	1	10	0	0
14	25923771	.	A	G	2	7	9	0	0	9	0	0
14	25923829	.	C	T	1	5	6	0	0	6	0	0
14	25923844	.	T	G	2	4	6	0	0	7	1	0
14	25923971	.	T	A	2	2	4	0	1	5	0	0
14	25924218	.	C	T	0	4	4	0	1	5	0	0
14	25924240	.	A	G	1	5	6	0	0	6	0	0
14	25924369	.	T	A	1	11	12	0	1	13	0	0
14	25924384	.	A	G	4	10	14	0	0	14	0	0
14	25924429	.	C	T	0	5	5	0	5	10	0	0
14	25924475	.	A	T	4	3	7	0	0	7	0	0
14	25924495	.	A	C	3	2	5	0	1	6	0	0
14	25924625	.	A	T	1	4	5	0	0	5	0	0
14	25924764	.	A	T	4	7	11	0	0	11	0	0
14	25924928	.	T	A	2	11	13	0	0	13	0	0
14	25924931	.	G	A	2	9	11	0	0	11	0	0
14	25925081	.	G	T	5	1	6	0	0	6	0	0
14	25925154	.	C	T	4	2	6	0	0	6	0	0
14	25925552	.	C	A	3	2	5	0	0	5	0	0
14	25926041	.	G	A	13	13	26	0	0	27	1	0
14	25926048	.	C	T	2	13	15	0	13	28	0	0
14	25926195	.	G	A	15	10	25	0	0	25	0	0
14	25926351	.	G	A	19	14	33	0	1	34	0	0
14	25939358	.	A	C	8	8	16	0	1	17	0	0
14	25939360	.	C	A	8	8	16	0	1	17	0	0
14	25939493	.	T	C	12	9	21	0	1	22	0	0
14	25939622	.	G	A	7	25	32	0	1	33	0	0
14	25983160	.	G	A	11	5	16	0	1	17	0	0
14	25983210	.	T	A	23	12	35	0	1	36	0	0
14	25985448	.	A	C	10	18	28	0	0	29	1	0
14	25993160	.	G	A	2	2	4	0	0	4	0	0
14	25997985	.	A	G	1	2	3	0	0	3	0	0
14	26008943	.	A	G	2	0	2	0	3	5	0	0
14	26008951	.	G	A	2	3	5	0	1	6	0	0
14	26009136	.	A	G	5	5	10	0	0	10	0	0
14	26009147	.	C	G	3	5	8	0	0	8	0	0
14	26009201	.	T	C	2	3	5	0	1	6	0	0
14	26009202	.	C	T	1	2	3	0	2	6	1	0
14	26009267	.	G	A	0	6	6	0	2	8	0	0
14	26011987	.	G	A	0	4	4	0	4	8	0	0
14	26012017	.	G	A	5	4	9	0	0	9	0	0
14	26064953	.	T	C	3	4	7	0	0	7	0	0
14	26064971	.	G	C	4	7	11	0	0	11	0	0
14	26065321	.	T	C	2	6	8	0	0	8	0	0
14	26065391	.	G	A	5	10	15	0	1	16	0	0
14	26065490	.	G	A	6	3	9	0	1	10	0	0
14	26066663	.	A	T	3	3	6	0	0	6	0	0
14	26066760	.	A	T	4	5	9	0	0	9	0	0
14	26066763	.	G	A	3	5	8	0	1	9	0	0
14	26067366	.	G	A	1	2	3	0	0	3	0	0
14	26067410	.	T	C	1	2	3	0	0	3	0	0
14	26067628	.	A	G	5	4	9	0	0	9	0	0
14	26067632	.	C	T	4	6	10	0	1	11	0	0
14	26067685	.	G	T	4	5	9	0	1	10	0	0
14	26067697	.	G	A	3	5	8	0	2	10	0	0
14	26067757	.	T	A	4	8	12	0	1	13	0	0
14	26103511	.	T	G	4	8	12	0	0	12	0	0
14	26103547	.	T	A	3	13	16	0	1	17	0	0
14	26104293	.	G	A	14	12	26	0	0	26	0	0
14	26104299	.	A	G	11	10	21	0	3	25	1	0
14	26104350	.	C	A	3	13	16	0	6	22	0	0
14	26104442	.	C	T	12	13	25	0	2	27	0	0
14	26104503	.	C	T	11	12	23	0	1	24	0	0
14	26104674	.	A	T	2	8	10	0	0	10	0	0
14	26104679	.	A	C	2	0	2	0	10	12	0	0
14	26104710	.	G	T	3	10	13	0	1	14	0	0
14	26104801	.	C	A	4	5	9	0	1	10	0	0
14	26104854	.	C	T	7	4	11	0	1	12	0	0
14	26105074	.	A	C	9	10	19	0	0	19	0	0
14	26105086	.	A	C	10	12	22	0	0	22	0	0
14	26105136	.	G	A	14	8	22	0	1	23	0	0
14	26105164	.	C	A	14	8	22	0	0	23	1	0
14	26105183	.	G	T	12	6	18	0	0	18	0	0
14	26105220	.	A	T	10	8	18	0	0	18	0	0
14	26105439	.	C	G	8	4	12	0	0	12	0	0
14	26105488	.	G	A	11	6	17	0	0	17	0	0
14	26105492	.	T	A	11	6	17	0	0	17	0	0
14	26105699	.	T	A	5	4	9	0	1	10	0	0
14	26105762	.	A	T	4	9	13	0	0	13	0	0
14	26106163	.	G	T	11	13	24	0	0	24	0	0
14	26106500	.	C	A	17	13	30	0	0	30	0	0
14	26106892	.	A	G	13	21	34	0	1	35	0	0
14	26108958	.	T	G	16	10	26	0	2	28	0	0
14	26109353	.	T	G	5	7	12	0	0	12	0	0
14	26109356	.	G	A	5	5	10	0	1	11	0	0
14	26109430	.	A	G	7	6	13	0	0	13	0	0
14	26114037	.	A	T	6	12	18	0	1	19	0	0
14	26114044	.	A	C	6	13	19	0	0	19	0	0
14	26114200	.	G	A	6	6	12	0	1	13	0	0
14	26114277	.	G	A	5	9	14	0	1	15	0	0
14	26127373	.	G	A	6	9	15	0	0	15	0	0
14	26127375	.	T	A	5	9	14	0	1	15	0	0
14	26127561	.	G	A	7	11	18	0	0	18	0	0
14	26127754	.	T	A	3	2	5	0	0	5	0	0
14	26135846	.	T	A	5	4	9	0	0	9	0	0
14	26147181	.	A	G	4	7	11	0	0	11	0	0
14	26149915	.	G	T	2	3	5	0	1	6	0	0
14	26152543	.	A	C	3	3	6	0	0	6	0	0
14	26152550	.	T	C	3	3	6	0	0	6	0	0
14	26153285	.	T	A	3	3	6	0	0	6	0	0
14	26153604	.	A	G	3	2	5	0	0	5	0	0
14	26154095	.	A	G	4	3	7	0	0	7	0	0
14	26224731	.	A	G	1	5	6	0	0	6	0	0
14	26227681	.	G	A	2	3	5	0	1	6	0	0
14	26227843	.	G	C	4	2	6	0	0	6	0	0
14	26364506	.	A	T	1	2	3	0	0	3	0	0
14	26364523	.	T	C	0	2	2	0	1	3	0	0
14	26385496	.	G	A	4	2	6	0	0	6	0	0
14	26385978	.	A	G	1	5	6	0	0	6	0	0
14	26386005	.	A	G	2	3	5	0	0	5	0	0
14	26386109	.	A	G	2	3	5	0	0	5	0	0
14	26391855	.	C	A	2	2	4	0	0	4	0	0
14	26405027	.	G	A	9	7	16	0	2	18	0	0
14	26405077	.	G	A	8	10	18	0	1	19	0	0
14	26405153	.	A	G	8	11	19	0	0	19	0	0
14	26405205	.	A	G	6	5	11	0	0	11	0	0
14	26405269	.	T	A	2	10	12	0	1	13	0	0
14	26405457	.	G	A	10	10	20	3	0	23	0	0
14	26405686	.	A	C	18	16	34	0	2	36	0	0
14	26405861	.	C	T	12	7	19	0	1	20	0	0
14	26411104	.	T	C	9	7	16	0	0	16	0	0
14	26411688	.	G	A	6	5	11	0	0	11	0	0
14	26413617	.	A	T	13	6	19	0	1	20	0	0
14	26413636	.	G	T	16	4	20	0	0	20	0	0
14	26413681	.	A	C	21	8	29	0	1	30	0	0
14	26413771	.	C	T	8	16	24	0	1	25	0	0
14	26413800	.	G	T	13	16	29	0	1	30	0	0
14	26413895	.	T	C	6	10	16	0	1	17	0	0
14	26413896	.	T	A	7	10	17	0	0	17	0	0
14	26414115	.	C	A	19	14	33	0	2	35	0	0
14	26414157	.	C	T	23	14	37	0	1	38	0	0
14	26414205	.	G	T	17	8	25	0	1	26	0	0
14	26414226	.	C	G	13	5	18	0	3	22	1	0
14	26414692	.	C	T	13	13	26	0	1	27	0	0
14	26415876	.	G	C	10	13	23	1	0	24	0	0
14	26427161	.	C	T	2	5	7	0	0	7	0	0
14	26427363	.	C	A	4	5	9	0	0	9	0	0
14	26427836	.	T	A	3	5	8	0	0	8	0	0
14	26428078	.	T	C	2	3	5	0	0	5	0	0
14	26435288	.	A	G	3	2	5	0	0	5	0	0
14	26435311	.	C	T	4	2	6	0	0	6	0	0
14	26436046	.	T	C	1	2	3	0	0	3	0	0
14	26440149	.	T	A	3	2	5	0	0	5	0	0
14	26453167	.	G	C	11	7	18	0	0	18	0	0
14	26453375	.	C	T	15	8	23	0	0	23	0	0
14	26456225	.	A	G	9	7	16	0	1	17	0	0
14	26456274	.	T	C	9	9	18	0	2	20	0	0
14	26456379	.	G	A	11	7	18	0	2	20	0	0
14	26458019	.	C	T	11	6	17	0	0	17	0	0
14	26458040	.	A	G	10	7	17	0	1	18	0	0
14	26460891	.	A	G	2	2	4	0	0	4	0	0
14	26462793	.	T	C	1	2	3	0	0	3	0	0
14	26467621	.	C	A	1	3	4	0	1	5	0	0
14	26467657	.	G	T	3	3	6	0	0	6	0	0
14	26467886	.	A	G	3	2	5	0	0	5	0	0
14	26472017	.	A	G	2	4	6	0	0	6	0	0
14	26472020	.	T	C	2	4	6	0	0	6	0	0
14	26511360	.	A	C	5	5	10	0	0	11	1	0
14	26511605	.	G	A	8	8	16	0	0	16	0	0
14	26511798	.	G	A	4	2	6	0	0	6	0	0
14	26512055	.	A	G	3	2	5	0	0	5	0	0
14	26561007	.	T	G	3	2	5	0	0	5	0	0
14	26625379	.	A	G	2	2	4	0	0	4	0	0
14	26715764	.	C	T	3	5	8	0	0	8	0	0
14	26716118	.	T	A	10	5	15	0	1	16	0	0
14	26716139	.	T	C	9	4	13	0	2	15	0	0
14	26718313	.	T	C	10	4	14	0	0	14	0	0
14	26718332	.	T	A	15	3	18	0	0	18	0	0
14	26718737	.	A	G	13	0	13	0	9	22	0	0
14	26718753	.	T	G	14	9	23	0	0	23	0	0
14	26729141	.	C	A	19	21	40	0	0	40	0	0
14	26794058	.	G	T	3	1	4	0	1	5	0	0
14	26794997	.	T	C	3	7	10	0	0	10	0	0
14	26795013	.	C	A	4	2	6	0	0	6	0	0
14	26796049	.	G	T	7	4	11	0	0	11	0	0
14	26805963	.	C	A	9	5	14	0	0	14	0	0
14	26836144	.	T	G	7	0	7	0	3	10	0	0
14	26995454	.	T	C	13	8	21	0	1	22	0	0
14	26995551	.	T	A	14	5	19	0	1	20	0	0
14	26995773	.	G	A	11	11	22	0	3	25	0	0
14	26995988	.	G	T	8	3	11	0	2	13	0	0
14	26996096	.	T	G	6	4	10	0	2	12	0	0
14	26996299	.	C	A	7	9	16	0	0	16	0	0
14	26996301	.	A	T	7	9	16	0	0	16	0	0
14	26996543	.	A	C	1	6	7	0	1	8	0	0
14	26996709	.	C	T	6	2	8	0	0	8	0	0
14	26996851	.	A	T	9	10	19	0	0	19	0	0
14	26996926	.	T	A	9	3	12	0	0	12	0	0
14	26996954	.	G	C	10	4	14	0	0	14	0	0
14	26996974	.	A	C	8	7	15	0	2	17	0	0
14	26997003	.	G	A	7	9	16	0	0	16	0	0
14	26997143	.	C	A	5	3	8	0	0	8	0	0
14	26997192	.	A	T	11	7	18	1	0	19	0	0
14	26997208	.	A	G	13	7	20	1	0	21	0	0
14	26997387	.	C	T	3	3	6	0	0	6	0	0
14	26997660	.	C	A	2	2	4	0	0	4	0	0
14	26998140	.	G	A	3	2	5	0	0	5	0	0
14	26998507	.	G	A	5	5	10	0	1	11	0	0
14	26998520	.	G	A	4	6	10	0	0	10	0	0
14	26998605	.	C	T	1	9	10	0	7	17	0	0
14	26998828	.	A	T	3	5	8	0	1	9	0	0
14	26998961	.	T	G	6	7	13	0	0	13	0	0
14	27000158	.	T	C	3	0	3	0	2	5	0	0
14	27000602	.	A	G	2	10	12	0	1	13	0	0
14	27121666	.	C	T	2	8	10	0	0	10	0	0
14	27121690	.	C	T	2	8	10	0	0	10	0	0
14	27121711	.	G	T	2	3	5	0	1	6	0	0
14	27121828	.	G	A	4	4	8	0	0	8	0	0
14	27282829	.	A	C	5	0	5	0	4	9	0	0
14	27282913	.	A	G	4	2	6	0	0	6	0	0
14	27282961	.	G	A	2	2	4	0	0	4	0	0
14	27283114	.	G	A	2	5	7	0	0	7	0	0
14	27283150	.	C	T	2	2	4	0	0	4	0	0
14	27998933	.	T	A	28	14	42	1	0	43	0	0
14	27999422	.	G	T	33	19	52	1	1	54	0	0
14	27999471	.	C	T	26	9	35	1	7	43	0	0
14	27999591	.	G	A	22	23	45	0	0	45	0	0
14	28001696	.	G	A	21	17	38	0	0	38	0	0
14	28052187	.	G	A	4	2	6	0	0	6	0	0
14	28282150	.	G	A	0	3	3	0	3	6	0	0
14	28282528	.	A	G	4	6	10	0	0	10	0	0
14	28351739	.	C	T	12	4	16	0	0	16	0	0
14	28351793	.	C	T	6	5	11	0	1	12	0	0
14	28366021	.	A	G	7	9	16	0	2	18	0	0
14	28433011	.	T	C	15	14	29	0	2	31	0	0
14	28437306	.	A	G	5	6	11	0	0	11	0	0
14	28437309	.	T	C	5	6	11	0	0	11	0	0
14	28448811	.	A	T	4	5	9	0	0	9	0	0
14	28453158	.	T	C	8	9	17	0	0	17	0	0
14	28453257	.	A	C	5	4	9	0	2	11	0	0
14	28453269	.	C	T	7	5	12	0	1	13	0	0
14	28454613	.	A	T	13	14	27	0	3	30	0	0
14	28457968	.	G	A	1	14	15	0	20	35	0	0
14	28458175	.	G	A	23	9	32	0	2	34	0	0
14	28458270	.	T	C	9	17	26	0	0	26	0	0
14	28458345	.	G	A	0	13	13	0	12	25	0	0
14	28458456	.	C	A	11	10	21	0	1	22	0	0
14	28459292	.	G	C	2	10	12	0	13	25	0	0
14	28459324	.	T	A	14	11	25	0	0	25	0	0
14	28459613	.	T	A	4	2	6	0	1	7	0	0
14	28459664	.	A	G	6	9	15	0	0	15	0	0
14	28459703	.	C	A	1	4	5	0	5	10	0	0
14	28463466	.	G	A	3	4	7	0	2	9	0	0
14	28463598	.	C	A	2	8	10	0	6	16	0	0
14	28464889	.	A	G	0	3	3	0	0	3	0	0
14	28464895	.	T	A	1	2	3	0	0	3	0	0
14	28473556	.	C	T	1	2	3	0	1	4	0	0
14	28476731	.	C	A	5	4	9	0	0	9	0	0
14	28476977	.	C	T	7	5	12	0	0	12	0	0
14	28477018	.	A	G	4	3	7	0	0	7	0	0
14	28477115	.	A	G	5	7	12	0	3	15	0	0
14	28477384	.	C	T	10	6	16	0	1	17	0	0
14	28477400	.	A	G	9	0	9	0	7	16	0	0
14	28480476	.	A	G	9	5	14	0	2	16	0	0
14	28481362	.	C	T	7	7	14	0	1	15	0	0
14	28482808	.	C	T	10	14	24	0	0	24	0	0
14	28482883	.	G	A	5	3	8	0	1	9	0	0
14	28482920	.	G	A	5	6	11	0	1	12	0	0
14	28483148	.	A	T	3	2	5	0	1	6	0	0
14	28486356	.	T	G	3	4	7	0	1	8	0	0
14	28486357	.	C	T	4	4	8	0	0	8	0	0
14	28492984	.	C	T	7	5	12	0	1	13	0	0
14	28497490	.	C	T	2	5	7	0	0	7	0	0
14	28497705	.	C	T	6	3	9	0	0	9	0	0
14	28502502	.	G	A	3	5	8	0	0	8	0	0
14	28502783	.	C	T	3	4	7	0	0	7	0	0
14	28512717	.	C	T	5	9	14	0	0	14	0	0
14	28515941	.	C	T	12	12	24	0	3	27	0	0
14	28518305	.	G	A	3	10	13	0	26	39	0	0
14	28525002	.	A	C	7	10	17	0	0	17	0	0
14	28525353	.	C	T	12	13	25	0	1	26	0	0
14	28525367	.	G	A	14	13	27	0	2	29	0	0
14	28525948	.	C	T	10	5	15	0	0	15	0	0
14	28525969	.	A	G	12	8	20	0	0	20	0	0
14	28526046	.	C	T	19	15	34	0	1	35	0	0
14	28526815	.	G	T	10	11	21	0	1	22	0	0
14	28527130	.	T	G	6	19	25	0	2	27	0	0
14	28558949	.	C	A	1	3	4	0	1	5	0	0
14	28561127	.	G	A	2	2	4	0	0	4	0	0
14	28561192	.	C	T	2	2	4	0	0	4	0	0
14	29729456	.	G	A	0	3	3	0	2	5	0	0
14	29746323	.	T	C	1	4	5	0	1	6	0	0
14	29746362	.	T	C	1	4	5	0	0	5	0	0
14	29746497	.	A	G	1	2	3	0	2	5	0	0
14	29746533	.	A	G	2	4	6	0	1	7	0	0
14	29746716	.	T	C	5	4	9	0	0	9	0	0
14	29746740	.	G	A	0	3	3	0	4	7	0	0
14	29746987	.	A	C	3	5	8	0	0	8	0	0
14	29750758	.	C	T	2	3	5	0	0	5	0	0
14	29752254	.	G	A	3	5	8	0	0	8	0	0
14	29754477	.	C	A	6	5	11	0	1	12	0	0
14	29754762	.	C	A	9	5	14	0	0	14	0	0
14	29757958	.	A	T	14	17	31	0	0	31	0	0
14	29758103	.	C	T	16	12	28	0	1	29	0	0
14	29758333	.	G	A	4	11	15	0	16	31	0	0
14	29758526	.	T	C	11	19	30	0	0	30	0	0
14	29759382	.	G	T	5	2	7	0	1	8	0	0
14	29759439	.	A	T	5	2	7	0	1	8	0	0
14	29759522	.	G	T	4	2	6	0	0	6	0	0
14	29759570	.	A	T	6	7	13	0	0	13	0	0
14	29780697	.	T	A	3	2	5	0	0	5	0	0
14	29782745	.	T	A	1	2	3	0	0	3	0	0
14	29807562	.	T	C	6	6	12	0	0	12	0	0
14	29808086	.	C	T	12	7	19	0	0	19	0	0
14	29808109	.	C	A	9	8	17	0	0	17	0	0
14	29808195	.	G	A	12	4	16	0	0	16	0	0
14	29808222	.	G	A	12	6	18	0	0	18	0	0
14	29808251	.	C	A	14	6	20	0	0	20	0	0
14	29808436	.	T	C	5	5	10	0	0	10	0	0
14	29808473	.	C	T	4	6	10	0	0	10	0	0
14	29808743	.	C	T	2	6	8	0	10	18	0	0
14	29808785	.	C	A	0	8	8	0	10	18	0	0
14	29808812	.	T	C	11	12	23	0	0	23	0	0
14	29810430	.	C	T	4	12	16	0	1	17	0	0
14	29821164	.	G	A	8	5	13	0	1	14	0	0
14	29822513	.	T	A	6	6	12	0	0	12	0	0
14	29823306	.	C	T	5	3	8	0	0	8	0	0
14	29825100	.	A	G	5	2	7	0	0	7	0	0
14	29825136	.	C	T	0	2	2	0	4	6	0	0
14	29825265	.	T	C	4	8	12	0	1	13	0	0
14	29825412	.	C	T	3	3	6	0	1	7	0	0
14	29825421	.	T	A	3	4	7	0	0	7	0	0
14	29825706	.	T	G	3	2	5	0	0	5	0	0
14	29826029	.	C	T	7	9	16	0	0	16	0	0
14	29826552	.	G	T	5	3	8	0	0	8	0	0
14	29827271	.	A	G	3	5	8	0	0	8	0	0
14	29836412	.	G	C	4	0	4	0	10	14	0	0
14	29841085	.	T	C	3	0	3	0	3	6	0	0
14	29841103	.	T	C	4	4	8	0	0	8	0	0
14	29843189	.	C	G	0	3	3	0	3	6	0	0
14	29883233	.	C	T	0	2	2	0	1	3	0	0
14	30107841	.	T	C	2	2	4	0	0	4	0	0
14	30108474	.	T	A	2	1	3	0	1	4	0	0
14	30156718	.	A	T	2	2	4	0	0	4	0	0
14	30156943	.	T	A	5	3	8	0	0	8	0	0
14	30157026	.	G	A	3	4	7	0	0	7	0	0
14	30157030	.	A	T	4	3	7	0	0	7	0	0
14	30158138	.	C	T	4	4	8	0	0	8	0	0
14	30158168	.	C	T	0	4	4	0	6	10	0	0
14	30158174	.	C	T	6	4	10	0	0	10	0	0
14	30158528	.	T	C	1	3	4	0	0	4	0	0
14	30159101	.	T	C	1	4	5	0	0	5	0	0
14	30159105	.	T	C	1	4	5	0	0	5	0	0
14	30159210	.	T	C	3	4	7	0	0	7	0	0
14	30159285	.	A	G	1	2	3	0	0	3	0	0
14	30159536	.	C	T	5	3	8	0	0	8	0	0
14	30163273	.	A	G	1	2	3	0	0	3	0	0
14	30164041	.	C	T	4	3	7	0	0	7	0	0
14	30164324	.	T	A	2	3	5	0	0	5	0	0
14	30164325	.	A	C	2	3	5	0	0	5	0	0
14	30272965	.	C	A	1	3	4	0	1	5	0	0
14	30274044	.	A	C	1	3	4	0	0	4	0	0
14	30274051	.	A	T	2	3	5	0	0	5	0	0
14	30274548	.	G	T	2	2	4	0	3	7	0	0
14	30274656	.	A	T	4	3	7	0	0	7	0	0
14	30274662	.	A	G	3	3	6	0	1	7	0	0
14	30276522	.	A	G	4	0	4	0	4	8	0	0
14	30356183	.	G	A	1	2	3	0	0	3	0	0
14	30356616	.	A	T	1	3	4	0	0	4	0	0
14	30356794	.	A	G	0	3	3	0	0	3	0	0
14	30356811	.	T	A	3	2	5	0	0	5	0	0
14	30357204	.	C	T	3	4	7	0	2	9	0	0
14	30359224	.	G	A	2	2	4	0	0	4	0	0
14	30359276	.	C	T	1	3	4	0	0	4	0	0
14	30360991	.	G	A	4	2	6	0	0	6	0	0
14	30361051	.	A	G	1	5	6	0	0	6	0	0
14	30361057	.	C	T	1	4	5	0	0	5	0	0
14	30363022	.	C	G	2	2	4	0	0	4	0	0
14	30387373	.	T	C	1	2	3	0	0	3	0	0
14	30398618	.	G	A	6	6	12	0	1	13	0	0
14	30398723	.	G	A	1	3	4	0	1	5	0	0
14	30399386	.	G	T	1	5	6	0	0	6	0	0
14	30401100	.	C	T	5	5	10	0	0	10	0	0
14	30403613	.	T	C	9	8	17	0	0	17	0	0
14	30403716	.	T	C	7	10	17	0	0	17	0	0
14	30407577	.	G	C	2	5	7	0	4	11	0	0
14	30407638	.	C	A	14	10	24	0	0	24	0	0
14	30409289	.	C	T	8	10	18	0	1	19	0	0
14	30410882	.	G	A	0	14	14	0	4	18	0	0
14	30410911	.	G	A	8	12	20	0	0	20	0	0
14	30411143	.	C	T	10	6	16	0	0	16	0	0
14	30411292	.	T	C	15	9	24	0	1	25	0	0
14	30411707	.	C	T	3	2	5	0	0	5	0	0
14	30411724	.	T	C	3	4	7	0	1	8	0	0
14	30411774	.	G	A	8	5	13	2	0	15	0	0
14	30411825	.	G	A	9	9	18	0	2	20	0	0
14	30411895	.	T	A	1	3	4	0	1	5	0	0
14	30411937	.	A	G	1	3	4	0	0	4	0	0
14	30423734	.	A	G	3	3	6	0	0	6	0	0
14	30423953	.	T	A	3	3	6	0	1	7	0	0
14	30424213	.	C	A	1	3	4	0	0	4	0	0
14	30427682	.	T	C	3	2	5	0	0	5	0	0
14	30427688	.	A	G	2	1	3	0	1	4	0	0
14	30427834	.	G	A	3	4	7	0	0	7	0	0
14	30428031	.	C	T	3	6	9	0	1	10	0	0
14	30428319	.	A	G	7	6	13	0	0	13	0	0
14	30428322	.	A	G	6	5	11	0	0	11	0	0
14	30452140	.	G	T	3	3	6	0	1	7	0	0
14	30454254	.	G	A	3	4	7	0	0	7	0	0
14	30454260	.	G	A	3	5	8	0	0	8	0	0
14	30454312	.	T	A	0	5	5	0	2	7	0	0
14	30454372	.	T	A	2	2	4	0	0	4	0	0
14	30454527	.	C	T	0	5	5	0	5	10	0	0
14	30454651	.	T	A	5	3	8	0	3	11	0	0
14	30454731	.	T	C	6	6	12	1	1	14	0	0
14	30454917	.	C	T	1	7	8	0	8	16	0	0
14	30455029	.	C	A	3	3	6	0	0	7	1	0
14	30455121	.	C	T	6	4	10	0	1	11	0	0
14	30455134	.	T	A	7	4	11	0	0	11	0	0
14	30455640	.	A	T	1	3	4	0	0	4	0	0
14	30456201	.	A	T	1	5	6	0	0	6	0	0
14	30456243	.	G	A	6	3	9	0	0	9	0	0
14	30456373	.	T	G	3	13	16	1	1	18	0	0
14	30551452	.	A	T	10	8	18	0	1	19	0	0
14	30551488	.	C	T	5	12	17	0	2	19	0	0
14	30580906	.	A	G	5	12	17	0	0	17	0	0
14	30581000	.	A	C	9	0	9	0	4	13	0	0
14	30581152	.	G	A	7	6	13	0	0	13	0	0
14	30581245	.	A	T	7	10	17	0	0	17	0	0
14	30581308	.	C	T	1	3	4	0	4	8	0	0
14	30581329	.	C	A	6	4	10	0	1	11	0	0
14	30581485	.	C	T	1	3	4	0	8	12	0	0
14	30588022	.	C	A	2	8	10	0	0	10	0	0
14	30613469	.	C	A	13	14	27	0	1	28	0	0
14	30637988	.	C	T	4	21	25	0	30	55	0	0
14	30638071	.	G	A	28	13	41	0	5	46	0	0
14	30638087	.	G	A	30	17	47	0	2	49	0	0
14	30639165	.	A	G	26	28	54	0	3	57	0	0
14	30641256	.	G	A	16	15	31	0	2	33	0	0
14	30641872	.	A	G	15	22	37	0	2	39	0	0
14	30642594	.	T	G	9	11	20	0	1	21	0	0
14	30642618	.	G	A	13	12	25	0	0	25	0	0
14	30713964	.	T	C	25	25	50	0	0	50	0	0
14	30717305	.	T	C	14	7	21	0	1	22	0	0
14	30720073	.	T	C	6	0	6	0	11	17	0	0
14	30720354	.	C	T	0	10	10	0	13	23	0	0
14	30720399	.	C	T	2	12	14	0	10	24	0	0
14	30731175	.	G	T	2	11	13	0	9	22	0	0
14	30731849	.	A	C	5	6	11	0	1	12	0	0
14	30732064	.	C	G	14	12	26	0	0	26	0	0
14	30732136	.	C	G	9	11	20	0	0	20	0	0
14	30732229	.	T	C	20	12	32	0	0	32	0	0
14	30732899	.	C	T	7	12	19	0	1	20	0	0
14	30733237	.	T	G	20	1	21	0	18	39	0	0
14	30733279	.	C	A	14	13	27	0	0	27	0	0
14	30733411	.	A	G	22	6	28	0	1	29	0	0
14	30733779	.	G	A	3	13	16	0	13	29	0	0
14	30733990	.	T	C	17	16	33	0	2	35	0	0
14	30734215	.	A	T	18	18	36	0	1	37	0	0
14	30734221	.	A	G	15	1	16	0	21	37	0	0
14	30734295	.	A	G	17	18	35	0	4	39	0	0
14	30734347	.	A	G	27	11	38	0	6	44	0	0
14	30734389	.	A	T	24	15	39	0	2	41	0	0
14	30734390	.	T	A	26	15	41	0	0	41	0	0
14	30734516	.	T	C	22	18	40	0	2	42	0	0
14	30739687	.	T	C	1	2	3	0	0	3	0	0
14	30742071	.	G	A	2	3	5	0	0	5	0	0
14	30757309	.	C	T	2	7	9	0	0	9	0	0
14	30792931	.	A	T	2	6	8	0	0	8	0	0
14	30793048	.	A	C	2	2	4	0	0	4	0	0
14	30793472	.	C	T	4	5	9	0	1	10	0	0
14	30795633	.	T	C	25	26	51	0	0	51	0	0
14	30799000	.	T	C	25	32	57	0	3	60	0	0
14	30800809	.	A	C	34	24	58	0	3	61	0	0
14	30801043	.	C	A	36	32	68	0	3	72	1	0
14	30802892	.	T	C	5	4	9	0	1	10	0	0
14	30802958	.	G	A	3	4	7	0	1	8	0	0
14	30803026	.	G	A	5	4	9	0	0	9	0	0
14	30803058	.	C	A	1	4	5	0	5	10	0	0
14	30803072	.	A	G	5	3	8	0	0	8	0	0
14	30803247	.	T	G	5	3	8	0	0	8	0	0
14	30803950	.	G	A	2	2	4	0	0	4	0	0
14	30854710	.	A	T	23	19	42	0	2	44	0	0
14	30854808	.	G	A	22	2	24	0	4	28	0	0
14	30854828	.	A	G	23	7	30	0	3	33	0	0
14	30855117	.	A	C	28	26	54	0	1	55	0	0
14	30855218	.	A	G	16	20	36	0	0	36	0	0
14	30855303	.	C	T	2	17	19	0	20	39	0	0
14	30855668	.	A	T	31	20	51	0	0	51	0	0
14	30855973	.	T	G	17	6	23	3	1	27	0	0
14	30876422	.	A	C	7	15	22	0	2	24	0	0
14	30878587	.	G	A	2	5	7	0	0	7	0	0
14	30878604	.	C	T	1	1	2	0	1	3	0	0
14	30879257	.	T	C	4	0	4	0	3	7	0	0
14	30879274	.	T	G	2	3	5	0	1	6	0	0
14	30879324	.	G	A	2	2	4	0	0	4	0	0
14	30879343	.	C	T	3	2	5	0	0	5	0	0
14	30879389	.	T	C	2	2	4	0	0	4	0	0
14	30879392	.	A	G	2	2	4	0	0	4	0	0
14	30879736	.	T	C	6	3	9	0	1	10	0	0
14	30879932	.	T	A	4	4	8	0	0	8	0	0
14	30880035	.	G	A	2	2	4	0	0	4	0	0
14	30880055	.	A	G	1	3	4	0	0	4	0	0
14	30880248	.	T	G	8	4	12	0	0	12	0	0
14	30880361	.	A	G	8	5	13	0	0	13	0	0
14	30880534	.	A	G	4	4	8	0	0	8	0	0
14	30880645	.	A	G	2	9	11	0	1	12	0	0
14	30880817	.	A	G	4	2	6	0	0	6	0	0
14	30880846	.	T	C	4	3	7	0	1	8	0	0
14	30880916	.	T	C	3	0	3	0	3	6	0	0
14	30880918	.	A	G	2	2	4	0	2	6	0	0
14	30880973	.	G	A	3	2	5	0	1	6	0	0
14	30891369	.	T	G	1	2	3	0	0	3	0	0
14	30912058	.	T	C	2	6	8	0	1	9	0	0
14	30912925	.	C	T	1	4	5	0	1	6	0	0
14	30913330	.	T	C	2	8	10	0	0	10	0	0
14	30913423	.	G	A	5	2	7	0	0	7	0	0
14	30915608	.	T	A	3	7	10	0	0	10	0	0
14	30915627	.	G	T	0	5	5	0	4	9	0	0
14	30916113	.	A	G	5	0	5	0	5	10	0	0
14	30922349	.	T	C	4	3	7	0	0	7	0	0
14	30927355	.	C	G	6	2	8	0	0	8	0	0
14	30929846	.	T	A	2	2	4	0	1	5	0	0
14	30967732	.	C	T	0	4	4	0	2	6	0	0
14	30970834	.	A	C	1	7	8	0	0	8	0	0
14	30975367	.	A	G	13	3	16	1	1	18	0	0
14	30978589	.	G	T	14	18	32	0	1	33	0	0
14	30978700	.	T	C	13	12	25	0	5	30	0	0
14	30978706	.	G	A	16	16	32	0	1	33	0	0
14	30982248	.	T	C	25	1	26	0	12	38	0	0
14	30987702	.	T	A	20	18	38	0	0	38	0	0
14	30987930	.	G	A	19	19	38	0	3	41	0	0
14	30987985	.	A	G	21	14	35	0	4	39	0	0
14	30988627	.	A	G	18	12	30	0	3	33	0	0
14	30988664	.	C	T	11	8	19	0	1	20	0	0
14	30988707	.	T	G	7	9	16	0	1	17	0	0
14	30989292	.	C	G	0	6	6	0	4	10	0	0
14	30989908	.	A	G	8	6	14	0	0	14	0	0
14	30990321	.	T	A	15	10	25	0	2	27	0	0
14	30991060	.	C	T	5	2	7	0	0	7	0	0
14	30991272	.	C	T	1	14	15	0	13	28	0	0
14	30992515	.	A	T	3	6	9	0	0	9	0	0
14	30992593	.	A	G	6	3	9	0	0	9	0	0
14	31014047	.	G	A	9	5	14	0	0	14	0	0
14	31014113	.	T	A	8	13	21	0	0	21	0	0
14	31024053	.	A	G	6	6	12	0	0	12	0	0
14	31024077	.	C	A	6	5	11	0	0	11	0	0
14	31082249	.	C	T	8	6	14	0	1	15	0	0
14	31082400	.	T	C	11	6	17	0	2	19	0	0
14	31082501	.	T	G	5	6	11	0	0	11	0	0
14	31082519	.	C	T	0	5	5	0	4	9	0	0
14	31082569	.	C	T	1	7	8	0	0	8	0	0
14	31082857	.	C	T	16	9	25	0	1	26	0	0
14	31082975	.	A	G	4	13	17	0	2	19	0	0
14	31083110	.	C	A	5	14	19	0	1	20	0	0
14	31083227	.	G	A	7	8	15	0	2	17	0	0
14	31083242	.	C	A	0	7	7	0	9	16	0	0
14	31087245	.	T	A	6	4	10	0	0	10	0	0
14	31092483	.	C	A	2	1	3	0	0	3	0	0
14	31092489	.	T	G	3	2	5	0	0	5	0	0
14	31177140	.	G	C	3	0	3	0	2	5	0	0
14	31177651	.	G	A	7	4	11	0	0	11	0	0
14	31177704	.	A	G	4	2	6	0	1	7	0	0
14	31299174	.	T	C	3	3	6	0	0	6	0	0
14	31478767	.	G	A	6	4	10	0	3	13	0	0
14	31493317	.	C	T	9	4	13	0	1	14	0	0
14	31497559	.	C	T	11	7	18	0	2	20	0	0
14	31498413	.	T	C	11	9	20	0	2	22	0	0
14	31507476	.	A	G	4	0	4	0	8	12	0	0
14	31510055	.	G	A	0	5	5	0	8	13	0	0
14	31514373	.	T	C	6	8	14	0	2	16	0	0
14	31516506	.	A	G	9	8	17	0	1	18	0	0
14	31516509	.	G	A	1	9	10	0	7	17	0	0
14	31518812	.	T	A	6	5	11	0	0	11	0	0
14	31518856	.	T	A	5	5	10	0	0	10	0	0
14	31519018	.	A	C	7	7	14	0	0	14	0	0
14	31519051	.	A	G	9	8	17	0	0	17	0	0
14	31519241	.	A	G	4	6	10	0	2	12	0	0
14	31519590	.	G	A	1	5	6	0	0	6	0	0
14	31519616	.	A	T	1	4	5	0	0	5	0	0
14	31519730	.	T	A	7	5	12	0	0	12	0	0
14	31519777	.	T	A	4	8	12	0	0	12	0	0
14	31519948	.	T	C	10	11	21	0	0	21	0	0
14	31520119	.	T	C	5	7	12	1	0	13	0	0
14	31520213	.	A	C	0	2	2	0	1	3	0	0
14	31520215	.	A	T	1	2	3	0	0	3	0	0
14	31520316	.	G	A	1	5	6	0	0	6	0	0
14	31520336	.	A	G	1	0	1	0	6	7	0	0
14	31520371	.	A	T	5	3	8	0	0	8	0	0
14	31520483	.	T	C	6	13	19	0	1	20	0	0
14	31520555	.	T	C	5	6	11	0	0	11	0	0
14	31520626	.	A	T	8	3	11	0	0	11	0	0
14	31530186	.	A	G	3	2	5	0	0	5	0	0
14	31530350	.	A	G	9	4	13	0	1	14	0	0
14	31530421	.	G	A	13	5	18	0	1	19	0	0
14	31540464	.	C	T	1	2	3	0	0	3	0	0
14	31541318	.	C	T	26	12	38	0	5	43	0	0
14	31544922	.	A	T	13	14	27	0	4	31	0	0
14	31544947	.	C	T	12	13	25	0	3	28	0	0
14	31546470	.	A	T	5	12	17	0	1	18	0	0
14	31546493	.	A	G	5	1	6	0	12	18	0	0
14	31556263	.	T	C	10	7	17	0	0	17	0	0
14	31556344	.	A	G	13	7	20	0	0	20	0	0
14	31558943	.	A	G	6	11	17	0	0	17	0	0
14	31559000	.	T	G	8	10	18	0	2	20	0	0
14	31559062	.	A	G	10	10	20	0	1	21	0	0
14	31562713	.	G	A	17	10	27	0	1	28	0	0
14	31605874	.	A	G	3	2	5	0	1	6	0	0
14	31608076	.	G	T	2	2	4	0	0	4	0	0
14	31616186	.	C	T	13	9	22	0	1	23	0	0
14	31635435	.	A	G	12	3	15	0	0	15	0	0
14	31636382	.	T	C	7	10	17	0	0	17	0	0
14	31636502	.	T	G	6	4	10	0	1	11	0	0
14	31641769	.	C	T	6	7	13	0	0	13	0	0
14	31642476	.	T	G	6	4	10	0	0	10	0	0
14	31642965	.	A	T	9	4	13	0	0	13	0	0
14	31643257	.	T	C	2	4	6	0	0	6	0	0
14	31643411	.	A	T	2	2	4	0	0	4	0	0
14	31643645	.	A	C	2	7	9	0	1	10	0	0
14	31643749	.	C	A	9	4	13	0	1	14	0	0
14	31643781	.	A	G	3	11	14	0	2	16	0	0
14	31643849	.	A	G	5	5	10	0	1	11	0	0
14	31644218	.	T	C	17	8	25	0	2	27	0	0
14	31644229	.	C	G	19	0	19	0	9	28	0	0
14	31644488	.	T	C	8	5	13	0	0	13	0	0
14	31645022	.	C	T	5	8	13	0	0	13	0	0
14	31645082	.	A	G	12	11	23	0	3	26	0	0
14	31645473	.	C	G	6	4	10	0	0	10	0	0
14	31645683	.	A	T	3	6	9	0	0	9	0	0
14	31645766	.	A	G	2	9	11	0	1	12	0	0
14	31645785	.	C	T	12	4	16	0	2	18	0	0
14	31645891	.	C	T	13	5	18	0	0	18	0	0
14	31645962	.	A	G	3	6	9	0	0	9	0	0
14	31645989	.	T	A	4	4	8	0	0	8	0	0
14	31646039	.	C	A	9	6	15	0	0	15	0	0
14	31646121	.	G	A	5	5	10	0	0	10	0	0
14	31646217	.	C	A	8	14	22	0	0	22	0	0
14	31646224	.	G	A	7	14	21	0	1	22	0	0
14	31646407	.	C	T	2	1	3	0	1	4	0	0
14	31646486	.	A	T	6	3	9	0	0	9	0	0
14	31646650	.	A	G	12	0	12	0	8	20	0	0
14	31646655	.	T	C	13	7	20	0	0	20	0	0
14	31646869	.	A	G	5	9	14	0	0	14	0	0
14	31647135	.	A	T	7	11	18	0	0	18	0	0
14	31647217	.	A	G	8	8	16	0	3	19	0	0
14	31647291	.	G	C	14	9	23	0	1	24	0	0
14	31647309	.	A	G	23	6	29	0	0	29	0	0
14	31647335	.	G	T	13	10	23	0	0	23	0	0
14	31647682	.	A	G	13	5	18	0	0	18	0	0
14	31647730	.	T	C	12	5	17	0	1	18	0	0
14	31647829	.	C	A	10	5	15	0	1	16	0	0
14	31668339	.	T	C	1	2	3	0	0	3	0	0
14	31669103	.	A	T	10	7	17	0	2	19	0	0
14	31669304	.	C	A	8	7	15	0	0	15	0	0
14	31669551	.	T	C	11	13	24	0	2	26	0	0
14	31669558	.	C	A	10	14	24	0	2	26	0	0
14	31670044	.	C	G	5	3	8	0	0	8	0	0
14	31673775	.	A	G	4	6	10	0	0	10	0	0
14	31675852	.	G	T	7	6	13	0	0	13	0	0
14	31682168	.	T	C	9	3	12	0	3	15	0	0
14	31682244	.	T	C	4	5	9	0	0	9	0	0
14	31779713	.	C	G	3	2	5	0	1	6	0	0
14	31800369	.	T	C	8	0	8	0	7	15	0	0
14	31800371	.	A	G	7	7	14	0	1	15	0	0
14	31800589	.	G	A	8	9	17	0	0	17	0	0
14	31800875	.	G	A	10	8	18	0	0	18	0	0
14	31801168	.	A	G	7	2	9	0	0	9	0	0
14	31801196	.	G	A	4	2	6	0	0	6	0	0
14	31801428	.	C	G	8	5	13	0	0	13	0	0
14	31801454	.	C	T	0	7	7	0	5	12	0	0
14	31801483	.	A	G	4	9	13	0	0	13	0	0
14	31801904	.	A	G	14	7	21	0	0	21	0	0
14	31801979	.	T	C	3	12	15	0	0	15	0	0
14	31802067	.	A	T	5	9	14	0	1	15	0	0
14	31802156	.	T	C	7	6	13	0	0	13	0	0
14	31802443	.	A	G	2	7	9	0	0	9	0	0
14	31802507	.	C	T	3	4	7	0	1	8	0	0
14	31803044	.	C	A	4	3	7	0	1	8	0	0
14	31803150	.	T	C	3	4	7	0	1	8	0	0
14	31803337	.	G	A	1	2	3	0	0	3	0	0
14	31814000	.	C	G	5	3	8	0	0	8	0	0
14	31814089	.	T	C	5	0	5	0	3	8	0	0
14	31822530	.	A	G	1	5	6	0	0	6	0	0
14	31856891	.	G	T	9	13	22	0	2	24	0	0
14	31857773	.	T	A	10	16	26	0	2	28	0	0
14	31858123	.	G	A	24	13	37	0	1	38	0	0
14	31858492	.	T	G	12	14	26	0	0	26	0	0
14	31860525	.	C	T	12	18	30	0	7	37	0	0
14	31861179	.	A	G	11	15	26	0	1	27	0	0
14	31881740	.	A	G	6	3	9	0	1	10	0	0
14	31881791	.	G	T	1	2	3	0	1	4	0	0
14	31882246	.	G	T	1	2	3	0	1	4	0	0
14	31882339	.	G	T	1	3	4	0	4	8	0	0
14	31882340	.	C	T	5	2	7	0	1	8	0	0
14	31882422	.	T	C	3	3	6	0	0	6	0	0
14	31882481	.	A	G	4	0	4	0	4	8	0	0
14	31882507	.	T	C	7	5	12	0	0	12	0	0
14	31882587	.	T	C	3	4	7	0	0	7	0	0
14	31882656	.	C	T	7	3	10	0	0	10	0	0
14	31882709	.	A	T	5	3	8	0	0	8	0	0
14	31882714	.	A	T	5	2	7	0	0	7	0	0
14	31882817	.	T	A	4	5	9	0	1	10	0	0
14	31883188	.	A	T	2	4	6	0	0	6	0	0
14	31883426	.	C	T	1	2	3	0	1	4	0	0
14	31883472	.	A	C	3	6	9	0	0	9	0	0
14	31883475	.	A	T	3	6	9	0	0	9	0	0
14	31883735	.	G	A	0	6	6	0	6	12	0	0
14	31883889	.	T	A	2	2	4	0	1	5	0	0
14	31884011	.	T	A	5	4	9	0	1	10	0	0
14	31890748	.	T	C	4	0	4	0	4	8	0	0
14	31890817	.	G	A	3	4	7	0	0	7	0	0
14	31893726	.	C	G	2	4	6	0	0	6	0	0
14	31973439	.	C	T	5	3	8	0	0	8	0	0
14	31973448	.	T	C	4	2	6	0	1	7	0	0
14	32011834	.	C	A	12	8	20	0	0	20	0	0
14	32011929	.	C	G	2	17	19	0	16	35	0	0
14	32011993	.	T	C	9	13	22	0	2	24	0	0
14	32013167	.	C	A	0	8	8	0	11	19	0	0
14	32023213	.	T	C	2	4	6	0	0	6	0	0
14	32025140	.	A	T	4	7	11	0	0	11	0	0
14	32025381	.	T	C	3	3	6	0	0	6	0	0
14	32184937	.	C	T	15	17	32	0	0	32	0	0
14	32185199	.	A	G	12	13	25	0	0	25	0	0
14	32185374	.	C	T	7	9	16	0	0	16	0	0
14	32254558	.	C	T	5	6	11	0	0	11	0	0
14	32254770	.	C	T	5	5	10	0	0	10	0	0
14	32255068	.	G	T	2	2	4	0	0	4	0	0
14	32255124	.	C	T	3	2	5	0	0	5	0	0
14	32403594	.	G	C	2	8	10	0	2	12	0	0
14	32443552	.	T	A	8	9	17	0	1	18	0	0
14	32443572	.	A	C	7	8	15	0	2	17	0	0
14	32443696	.	A	G	8	18	26	0	0	26	0	0
14	32443727	.	C	T	0	14	14	0	9	23	0	0
14	32443734	.	A	T	8	12	20	0	1	21	0	0
14	32443841	.	A	T	9	6	15	0	1	16	0	0
14	32444064	.	C	G	22	14	36	0	1	37	0	0
14	32444114	.	C	G	14	14	28	0	0	28	0	0
14	32444121	.	C	T	13	14	27	0	0	27	0	0
14	32444392	.	C	T	7	8	15	0	1	16	0	0
14	32444614	.	G	A	21	7	28	2	1	31	0	0
14	32444615	.	T	C	22	7	29	2	1	32	0	0
14	32444651	.	G	A	18	10	28	0	1	29	0	0
14	32444854	.	G	T	6	9	15	0	0	15	0	0
14	32444878	.	C	A	8	7	15	0	0	15	0	0
14	32447862	.	G	A	15	4	19	0	0	19	0	0
14	32447915	.	T	C	12	0	12	0	5	17	0	0
14	32448068	.	T	C	10	8	18	0	0	18	0	0
14	32455602	.	T	C	8	0	8	0	8	16	0	0
14	32477810	.	T	C	7	0	7	0	10	17	0	0
14	32479378	.	G	A	5	3	8	0	0	8	0	0
14	32486680	.	A	G	1	3	4	0	0	4	0	0
14	32518873	.	C	T	3	3	6	0	0	6	0	0
14	32524195	.	C	T	1	2	3	0	0	3	0	0
14	32524969	.	T	A	4	3	7	0	1	8	0	0
14	32534834	.	G	A	5	4	9	0	0	9	0	0
14	32742955	.	A	T	4	3	7	0	0	7	0	0
14	32743736	.	G	A	4	6	10	0	0	10	0	0
14	32857704	.	G	A	2	9	11	1	2	14	0	0
14	32857812	.	A	C	8	12	20	0	0	20	0	0
14	32858004	.	G	C	1	14	15	0	10	25	0	0
14	32858012	.	C	T	20	7	27	0	0	27	0	0
14	32858080	.	C	A	11	12	23	0	0	23	0	0
14	32858244	.	T	C	19	14	33	0	0	33	0	0
14	32858301	.	C	T	11	13	24	0	1	25	0	0
14	32858364	.	C	T	6	8	14	0	2	16	0	0
14	32858570	.	C	T	11	12	23	0	1	24	0	0
14	32858578	.	C	G	11	11	22	0	0	22	0	0
14	32858638	.	G	A	6	14	20	0	1	21	0	0
14	32858701	.	C	T	15	8	23	0	0	23	0	0
14	32859554	.	C	T	11	5	16	0	0	16	0	0
14	32859908	.	G	T	14	11	25	1	0	26	0	0
14	32860345	.	A	G	12	5	17	0	0	17	0	0
14	32860374	.	T	C	10	0	10	0	12	22	0	0
14	32860434	.	C	T	10	8	18	0	2	20	0	0
14	32860692	.	T	A	18	14	32	0	3	35	0	0
14	32860704	.	G	A	18	11	29	0	1	30	0	0
14	32865916	.	G	A	15	6	21	0	0	21	0	0
14	32866234	.	C	T	9	6	15	0	1	16	0	0
14	32866838	.	T	C	1	3	4	0	0	4	0	0
14	32870048	.	A	T	1	2	3	0	0	3	0	0
14	32884065	.	C	T	0	12	12	0	15	27	0	0
14	32885319	.	T	A	3	3	6	0	0	6	0	0
14	32938217	.	C	A	1	2	3	0	0	3	0	0
14	32938218	.	A	T	1	2	3	0	0	3	0	0
14	32945536	.	C	T	4	2	6	0	0	6	0	0
14	32952148	.	C	T	4	4	8	0	1	9	0	0
14	32952180	.	T	A	4	6	10	0	0	10	0	0
14	32952312	.	A	T	6	5	11	0	0	11	0	0
14	32952576	.	C	T	6	6	12	0	1	13	0	0
14	32952665	.	C	T	0	6	6	0	7	13	0	0
14	32952857	.	T	A	8	5	13	0	0	13	0	0
14	32956430	.	A	G	3	5	8	0	0	8	0	0
14	32984047	.	G	A	4	3	7	0	0	7	0	0
14	32984084	.	G	A	6	6	12	0	0	12	0	0
14	32984128	.	C	A	10	9	19	0	1	20	0	0
14	32984414	.	G	T	3	2	5	0	1	6	0	0
14	32984627	.	C	G	3	2	5	0	0	5	0	0
14	32984958	.	A	C	4	2	6	0	0	6	0	0
14	32985067	.	A	T	3	2	5	0	0	5	0	0
14	33070588	.	C	A	1	17	18	0	25	50	7	0
14	33071522	.	A	G	25	18	43	0	7	50	0	0
14	33071814	.	G	A	27	19	46	0	0	46	0	0
14	33073954	.	G	A	20	15	35	0	1	36	0	0
14	33120461	.	G	A	9	15	24	0	1	25	0	0
14	33177949	.	G	C	12	1	13	0	9	22	0	0
14	33220216	.	A	G	3	3	6	0	0	6	0	0
14	33220527	.	A	T	4	2	6	0	0	6	0	0
14	33220710	.	C	T	2	2	4	0	0	4	0	0
14	33221152	.	T	C	2	3	5	0	0	5	0	0
14	33221163	.	T	C	3	2	5	0	0	5	0	0
14	33267946	.	T	C	12	8	20	0	2	22	0	0
14	33268211	.	T	A	10	4	14	0	1	15	0	0
14	33268330	.	C	A	11	3	14	0	2	16	0	0
14	33281240	.	T	A	31	19	50	0	5	55	0	0
14	33281777	.	C	T	5	8	13	0	26	39	0	0
14	33282050	.	C	T	31	11	42	0	7	49	0	0
14	33282119	.	A	G	29	28	57	0	0	57	0	0
14	33282245	.	A	T	35	19	54	0	3	57	0	0
14	33282246	.	A	C	37	20	57	0	1	58	0	0
14	33282347	.	C	T	5	23	28	0	27	55	0	0
14	33282483	.	T	C	2	2	4	0	6	10	0	0
14	33292079	.	A	G	21	14	35	0	0	35	0	0
14	33298637	.	C	T	22	29	51	0	1	52	0	0
14	33299087	.	T	C	26	14	40	0	0	40	0	0
14	33302331	.	G	A	3	2	5	0	0	5	0	0
14	33302416	.	A	T	1	4	5	0	0	5	0	0
14	33302745	.	T	C	3	3	6	0	0	6	0	0
14	33306505	.	C	T	19	21	40	0	3	43	0	0
14	33306583	.	T	C	31	20	51	1	0	52	0	0
14	33314102	.	G	A	20	24	44	0	4	48	0	0
14	33316828	.	A	G	16	15	31	0	1	32	0	0
14	33339472	.	T	C	5	3	8	0	0	8	0	0
14	33339531	.	T	A	6	2	8	0	0	8	0	0
14	33339617	.	C	T	7	5	12	0	0	12	0	0
14	33339761	.	G	C	7	4	11	0	0	11	0	0
14	33340099	.	C	T	5	7	12	0	2	14	0	0
14	33344463	.	A	G	5	4	9	0	0	9	0	0
14	33344536	.	T	G	4	3	7	0	0	7	0	0
14	33414015	.	G	T	3	2	5	0	1	6	0	0
14	33414168	.	C	T	38	40	78	0	1	79	0	0
14	33414885	.	C	T	21	15	36	0	0	36	0	0
14	33414894	.	C	T	19	12	31	0	1	32	0	0
14	33415210	.	A	G	7	14	21	0	0	21	0	0
14	33415337	.	C	T	12	6	18	0	1	19	0	0
14	33415410	.	T	G	3	0	3	0	10	13	0	0
14	33418525	.	G	C	3	5	8	0	0	8	0	0
14	33418766	.	A	G	9	19	28	0	2	30	0	0
14	33423037	.	C	T	13	14	27	0	2	29	0	0
14	33424854	.	A	C	19	0	19	0	27	46	0	0
14	33424869	.	C	T	10	27	37	0	4	41	0	0
14	33425008	.	A	T	15	16	31	0	1	32	0	0
14	33425013	.	C	T	3	18	21	0	10	31	0	0
14	33431448	.	T	C	1	3	4	0	0	4	0	0
14	33431674	.	G	A	3	6	9	0	1	10	0	0
14	33432132	.	A	G	2	1	3	0	1	4	0	0
14	33434218	.	G	A	1	5	6	0	0	6	0	0
14	33434902	.	A	G	1	2	3	0	0	3	0	0
14	33434976	.	T	C	4	4	8	0	0	8	0	0
14	33435231	.	G	A	5	6	11	0	1	12	0	0
14	33435384	.	G	A	4	9	13	0	1	14	0	0
14	33435540	.	T	A	5	11	16	0	1	17	0	0
14	33435573	.	T	A	8	8	16	0	0	16	0	0
14	33435598	.	C	T	8	8	16	0	0	16	0	0
14	33435686	.	T	C	3	8	11	0	0	11	0	0
14	33435714	.	G	A	4	3	7	0	0	7	0	0
14	33435893	.	C	T	1	8	9	0	7	16	0	0
14	33435916	.	T	G	14	6	20	0	0	20	0	0
14	33436091	.	A	T	13	10	23	0	0	23	0	0
14	33436311	.	A	G	17	17	34	0	2	36	0	0
14	33436650	.	A	T	16	13	29	0	5	34	0	0
14	33437248	.	C	T	19	25	44	0	0	44	0	0
14	33437262	.	T	G	19	21	40	0	1	41	0	0
14	33441928	.	C	T	20	24	44	0	0	44	0	0
14	33442006	.	A	G	23	27	50	0	3	53	0	0
14	33442066	.	T	C	13	19	32	0	4	36	0	0
14	33454561	.	T	C	14	1	15	0	19	34	0	0
14	33454570	.	C	T	2	18	20	0	14	34	0	0
14	33465057	.	A	G	4	7	11	0	0	11	0	0
14	33465603	.	C	T	9	9	18	0	1	19	0	0
14	33469026	.	C	A	26	23	49	0	3	52	0	0
14	33469094	.	T	A	22	19	41	0	2	43	0	0
14	33469177	.	C	A	17	15	32	0	2	34	0	0
14	33469180	.	A	G	19	1	20	0	14	34	0	0
14	33469241	.	A	G	15	0	15	0	14	29	0	0
14	33469281	.	G	A	14	16	30	0	0	30	0	0
14	33469356	.	C	T	15	7	22	0	1	23	0	0
14	33469370	.	C	T	16	5	21	0	0	21	0	0
14	33469419	.	G	A	1	3	4	0	7	11	0	0
14	33469609	.	C	T	8	9	17	0	0	17	0	0
14	33474119	.	C	A	6	3	9	0	0	9	0	0
14	33474745	.	T	C	20	0	20	0	10	30	0	0
14	33474762	.	G	C	16	12	28	0	0	28	0	0
14	33474809	.	T	C	10	0	10	0	7	17	0	0
14	33475273	.	G	C	4	4	8	0	0	8	0	0
14	33475767	.	C	T	4	5	9	1	1	11	0	0
14	33486539	.	A	C	6	4	10	0	1	11	0	0
14	33486543	.	C	G	7	6	13	0	0	13	0	0
14	33487022	.	A	T	5	6	11	0	0	11	0	0
14	33499239	.	A	T	9	11	20	0	1	21	0	0
14	33501772	.	C	A	13	9	22	0	1	23	0	0
14	33501922	.	A	G	11	9	20	0	2	22	0	0
14	33504572	.	A	G	8	18	26	0	0	26	0	0
14	33504657	.	A	G	12	13	25	0	1	26	0	0
14	33504669	.	T	A	10	15	25	0	3	28	0	0
14	33505058	.	A	G	14	1	15	0	13	28	0	0
14	33505500	.	A	C	12	8	20	0	1	21	0	0
14	33507743	.	C	T	11	7	18	0	4	22	0	0
14	33549786	.	G	A	5	3	8	0	0	8	0	0
14	33549834	.	T	C	5	2	7	0	0	7	0	0
14	33554764	.	C	T	6	5	11	0	1	12	0	0
14	33557503	.	C	A	3	3	6	0	0	6	0	0
14	33557521	.	C	T	6	5	11	0	0	11	0	0
14	33562482	.	C	T	11	13	24	0	3	27	0	0
14	33562504	.	G	C	18	16	34	0	0	34	0	0
14	33564955	.	C	T	21	13	34	0	2	36	0	0
14	33564956	.	T	G	21	13	34	0	2	36	0	0
14	33564994	.	A	G	19	9	28	0	3	31	0	0
14	33565054	.	C	A	11	10	21	0	1	22	0	0
14	33565153	.	T	C	10	13	23	0	1	24	0	0
14	33565170	.	C	T	10	16	26	0	1	27	0	0
14	33565209	.	C	T	8	13	21	0	0	21	0	0
14	33565275	.	C	A	11	8	19	0	2	21	0	0
14	33565296	.	C	A	11	14	25	0	0	25	0	0
14	33565477	.	G	T	6	5	11	0	1	12	0	0
14	33565665	.	T	C	13	7	20	1	0	21	0	0
14	33565675	.	T	G	11	3	14	0	0	14	0	0
14	33565794	.	A	C	8	3	11	0	1	12	0	0
14	33565797	.	T	G	10	0	10	0	3	13	0	0
14	33566515	.	G	A	0	10	10	0	15	25	0	0
14	33566617	.	C	T	8	9	17	0	0	17	0	0
14	33566651	.	A	G	10	6	16	0	2	18	0	0
14	33566744	.	G	T	15	17	32	0	1	33	0	0
14	33567023	.	T	A	9	13	22	0	2	24	0	0
14	33567024	.	T	A	8	14	22	0	2	24	0	0
14	33569135	.	T	C	1	2	3	0	0	3	0	0
14	33569138	.	T	A	1	2	3	0	0	3	0	0
14	33744608	.	T	C	7	9	16	0	0	16	0	0
14	33754000	.	C	T	11	12	23	0	0	23	0	0
14	33754476	.	G	A	2	7	9	0	13	22	0	0
14	33754581	.	C	T	10	13	23	0	0	23	0	0
14	33754587	.	C	T	9	13	22	0	2	24	0	0
14	33754710	.	T	G	13	13	26	0	1	27	0	0
14	33754766	.	T	C	14	18	32	0	1	33	0	0
14	33754793	.	T	A	18	16	34	0	0	34	0	0
14	33755394	.	A	C	10	11	21	0	1	22	0	0
14	33755590	.	T	C	14	15	29	0	3	32	0	0
14	33757169	.	A	C	28	29	57	0	7	64	0	0
14	33826267	.	A	T	6	10	16	0	1	17	0	0
14	33826305	.	G	A	13	10	23	0	1	24	0	0
14	33826371	.	T	C	10	12	22	0	0	22	0	0
14	33826385	.	A	G	9	12	21	0	1	22	0	0
14	33826453	.	G	A	6	9	15	0	2	17	0	0
14	33826580	.	T	A	7	7	14	0	1	15	0	0
14	33826767	.	T	A	8	3	11	0	1	12	0	0
14	33826849	.	T	C	6	2	8	0	1	9	0	0
14	33826850	.	T	C	6	3	9	0	0	9	0	0
14	33827170	.	T	C	5	5	10	0	0	10	0	0
14	33827188	.	C	T	6	5	11	0	0	11	0	0
14	33827313	.	T	C	7	2	9	0	0	9	0	0
14	33827426	.	T	C	7	3	10	0	0	10	0	0
14	33827434	.	T	C	4	7	11	0	0	11	0	0
14	33827584	.	C	G	8	11	19	0	1	20	0	0
14	33827698	.	A	T	6	8	14	0	0	14	0	0
14	33827732	.	C	A	9	9	18	0	0	18	0	0
14	33828002	.	C	T	0	4	4	0	3	7	0	0
14	33828086	.	G	T	3	4	7	0	0	7	0	0
14	33828777	.	C	A	11	10	21	0	0	21	0	0
14	33828919	.	A	G	9	3	12	0	0	12	0	0
14	33838779	.	T	G	4	3	7	0	0	7	0	0
14	33838806	.	C	G	3	4	7	0	0	7	0	0
14	33848593	.	C	T	4	2	6	0	0	6	0	0
14	33860183	.	G	C	5	7	12	0	1	13	0	0
14	33860250	.	T	A	8	7	15	0	2	17	0	0
14	33860262	.	C	T	0	8	8	0	12	20	0	0
14	33860480	.	C	G	26	19	45	0	2	47	0	0
14	33860567	.	C	A	26	14	40	0	3	43	0	0
14	33865704	.	A	G	13	14	27	0	1	28	0	0
14	33865764	.	C	T	20	12	32	0	1	33	0	0
14	33868576	.	G	A	2	1	3	0	0	3	0	0
14	33868606	.	G	A	17	9	26	0	1	27	0	0
14	33868723	.	G	A	24	9	33	1	0	34	0	0
14	33872087	.	G	A	5	5	10	0	1	11	0	0
14	33883090	.	T	G	6	3	9	0	0	9	0	0
14	33883098	.	C	T	5	4	9	0	1	10	0	0
14	33883191	.	T	A	5	2	7	0	0	7	0	0
14	33889544	.	T	C	5	4	9	0	1	10	0	0
14	33891229	.	G	A	15	11	26	0	4	30	0	0
14	33891981	.	A	T	3	8	11	0	0	11	0	0
14	33892044	.	A	T	5	4	9	0	1	10	0	0
14	33892126	.	A	T	13	6	19	0	2	21	0	0
14	33892153	.	T	C	18	9	27	0	1	28	0	0
14	33892441	.	C	G	6	9	15	0	0	15	0	0
14	33892490	.	G	A	8	15	23	0	0	23	0	0
14	33893776	.	A	G	1	8	9	0	3	12	0	0
14	33894793	.	A	C	3	0	3	0	3	6	0	0
14	33899145	.	T	A	1	5	6	0	1	7	0	0
14	33899337	.	A	G	1	4	5	0	0	5	0	0
14	33899629	.	C	T	23	19	42	0	6	48	0	0
14	33899786	.	G	A	15	14	29	0	0	29	0	0
14	33899912	.	C	A	3	21	24	0	19	43	0	0
14	33900155	.	T	C	16	0	16	0	22	38	0	0
14	33900229	.	C	A	13	10	23	0	0	23	0	0
14	33900552	.	A	T	21	17	38	0	0	38	0	0
14	33900575	.	A	T	17	19	36	0	0	36	0	0
14	33900611	.	G	A	16	24	40	0	1	41	0	0
14	33900663	.	T	A	26	7	33	0	1	34	0	0
14	33900955	.	A	T	7	21	28	0	1	29	0	0
14	33901129	.	C	T	16	13	29	5	5	39	0	0
14	33901217	.	T	A	16	7	23	1	1	25	0	0
14	33901221	.	T	C	18	7	25	1	0	26	0	0
14	33901293	.	A	C	21	17	38	0	0	38	0	0
14	33901445	.	T	G	3	11	14	0	2	16	0	0
14	33901591	.	T	C	8	5	13	0	2	15	0	0
14	33901617	.	G	A	16	3	19	3	0	23	1	0
14	33901704	.	G	A	18	15	33	0	2	35	0	0
14	33901766	.	G	C	17	13	30	0	1	31	0	0
14	33901790	.	C	G	3	13	16	0	17	33	0	0
14	33901807	.	A	G	19	9	28	0	0	28	0	0
14	33901865	.	C	A	23	16	39	0	2	41	0	0
14	33901907	.	G	A	11	10	21	0	2	23	0	0
14	33901946	.	A	T	7	12	19	0	2	21	0	0
14	33901957	.	C	A	12	10	22	0	0	22	0	0
14	33901993	.	G	A	17	12	29	0	0	29	0	0
14	33902094	.	G	A	23	16	39	0	0	39	0	0
14	33903006	.	C	A	12	13	25	0	0	25	0	0
14	33903090	.	G	A	10	10	20	0	0	20	0	0
14	33909978	.	C	T	12	7	19	0	1	20	0	0
14	33910014	.	T	A	6	10	16	0	2	18	0	0
14	33916050	.	A	G	9	6	15	0	0	15	0	0
14	33916539	.	G	A	13	8	21	0	1	22	0	0
14	33916671	.	C	T	2	9	11	0	18	29	0	0
14	33916861	.	G	A	11	9	20	0	0	20	0	0
14	33936366	.	A	T	9	14	23	0	0	23	0	0
14	33940934	.	A	T	2	2	4	0	1	5	0	0
14	33941169	.	G	A	2	2	4	0	0	4	0	0
14	33941274	.	T	C	12	7	19	0	0	19	0	0
14	33941436	.	C	T	1	5	6	0	2	8	0	0
14	33943652	.	G	A	2	2	4	0	0	4	0	0
14	33945261	.	T	A	1	2	3	0	2	5	0	0
14	33983741	.	G	T	8	7	15	1	0	16	0	0
14	33983904	.	T	C	25	27	52	0	3	55	0	0
14	33983966	.	G	A	22	26	48	0	3	51	0	0
14	33984300	.	A	G	17	8	25	0	7	32	0	0
14	33984402	.	G	A	9	6	15	2	2	19	0	0
14	33984436	.	A	T	6	8	14	0	0	14	0	0
14	33984610	.	A	G	25	28	53	0	0	53	0	0
14	33989580	.	G	A	23	21	44	0	3	47	0	0
14	33991784	.	G	A	17	17	34	1	0	35	0	0
14	33991799	.	G	T	16	10	26	1	5	32	0	0
14	33997606	.	G	A	11	8	19	0	0	19	0	0
14	33997861	.	A	G	10	10	20	0	1	21	0	0
14	33997873	.	G	A	13	9	22	0	1	23	0	0
14	33998078	.	G	A	16	9	25	0	0	25	0	0
14	33998156	.	A	G	6	10	16	0	0	16	0	0
14	34000502	.	G	A	3	3	6	0	1	7	0	0
14	34002325	.	G	A	6	4	10	0	1	11	0	0
14	34002547	.	A	G	7	11	18	0	1	19	0	0
14	34002571	.	T	A	13	9	22	0	0	22	0	0
14	34003447	.	G	A	5	4	9	0	1	10	0	0
14	34013059	.	G	A	4	3	7	0	2	9	0	0
14	34064313	.	C	T	1	4	5	0	1	6	0	0
14	34064371	.	A	T	8	7	15	0	0	15	0	0
14	34065115	.	A	T	6	8	14	0	1	15	0	0
14	34065178	.	G	A	8	4	12	0	2	14	0	0
14	34065232	.	C	T	13	7	20	0	1	21	0	0
14	34065290	.	T	C	7	9	16	0	0	16	0	0
14	34065454	.	G	A	13	10	23	0	0	23	0	0
14	34065568	.	C	G	11	0	11	0	4	15	0	0
14	34065586	.	G	A	5	11	16	0	0	16	0	0
14	34068110	.	A	G	11	6	17	0	0	17	0	0
14	34068458	.	C	T	3	10	13	0	0	13	0	0
14	34068889	.	C	A	9	8	17	0	0	17	0	0
14	34075094	.	T	G	12	0	12	0	7	19	0	0
14	34077401	.	C	A	14	11	25	0	0	25	0	0
14	34077406	.	A	T	10	15	25	0	1	26	0	0
14	34079322	.	C	T	15	10	25	0	0	25	0	0
14	34079362	.	G	A	6	14	20	0	2	22	0	0
14	34082287	.	G	A	10	9	19	0	0	19	0	0
14	34082311	.	G	A	13	11	24	0	0	24	0	0
14	34082628	.	C	A	10	7	17	0	0	17	0	0
14	34082694	.	T	A	10	9	19	0	3	23	1	0
14	34089653	.	G	A	13	10	23	0	0	23	0	0
14	34089676	.	C	T	15	8	23	0	0	23	0	0
14	34089864	.	C	T	11	12	23	0	2	25	0	0
14	34089900	.	G	A	13	8	21	0	2	23	0	0
14	34089941	.	A	G	16	11	27	0	0	27	0	0
14	34090001	.	G	T	0	14	14	0	11	25	0	0
14	34090169	.	T	C	11	8	19	0	0	19	0	0
14	34090342	.	G	A	9	4	13	0	2	15	0	0
14	34090422	.	A	G	12	4	16	0	0	16	0	0
14	34091123	.	G	T	7	6	13	0	2	15	0	0
14	34091134	.	A	C	8	5	13	0	2	15	0	0
14	34091423	.	C	T	11	11	22	0	1	23	0	0
14	34091461	.	G	T	15	10	25	0	1	26	0	0
14	34091787	.	T	A	11	13	24	0	3	27	0	0
14	34091805	.	C	A	18	8	26	0	1	27	0	0
14	34091851	.	C	T	18	10	28	0	2	30	0	0
14	34091971	.	G	A	18	13	31	0	2	33	0	0
14	34092369	.	C	T	12	14	26	0	2	28	0	0
14	34092507	.	T	G	17	11	28	0	0	28	0	0
14	34092737	.	T	A	1	3	4	0	1	5	0	0
14	34125983	.	T	A	4	3	7	0	1	8	0	0
14	34126353	.	A	T	26	23	49	0	3	52	0	0
14	34127403	.	A	G	4	8	12	1	0	13	0	0
14	34127445	.	A	G	6	16	22	1	0	23	0	0
14	34127457	.	C	T	13	14	27	0	1	28	0	0
14	34127492	.	G	T	18	11	29	0	1	30	0	0
14	34127507	.	T	G	19	6	25	0	4	29	0	0
14	34127675	.	A	G	5	6	11	0	1	12	0	0
14	34127686	.	A	T	3	4	7	0	3	10	0	0
14	34127925	.	T	A	12	8	20	0	0	20	0	0
14	34128023	.	C	T	6	3	9	0	1	10	0	0
14	34128063	.	A	G	2	2	4	0	0	4	0	0
14	34128223	.	C	A	1	3	4	0	0	4	0	0
14	34128314	.	A	T	16	4	20	0	0	20	0	0
14	34128349	.	C	A	14	5	19	0	0	19	0	0
14	34128371	.	G	T	10	12	22	0	2	24	0	0
14	34128477	.	A	C	13	0	13	0	15	28	0	0
14	34128516	.	C	T	10	11	21	0	0	21	0	0
14	34128565	.	T	G	12	14	26	0	1	27	0	0
14	34128796	.	G	T	15	6	21	0	1	22	0	0
14	34128930	.	G	T	13	5	18	0	0	18	0	0
14	34128967	.	G	A	12	6	18	0	0	18	0	0
14	34128969	.	T	C	12	6	18	0	0	18	0	0
14	34129103	.	A	G	11	7	18	0	1	19	0	0
14	34129159	.	T	C	14	13	27	0	1	28	0	0
14	34129338	.	A	T	16	11	27	0	2	29	0	0
14	34129353	.	T	C	16	0	16	0	17	33	0	0
14	34129377	.	G	T	11	14	25	0	1	26	0	0
14	34129545	.	G	A	10	11	21	0	1	22	0	0
14	34129558	.	A	T	11	10	21	0	2	23	0	0
14	34129970	.	T	C	4	2	6	1	0	7	0	0
14	34129992	.	T	C	3	0	3	1	3	7	0	0
14	34130176	.	T	C	3	5	8	0	0	8	0	0
14	34130548	.	G	A	4	2	6	0	0	6	0	0
14	34131056	.	T	C	7	14	21	0	0	21	0	0
14	34153801	.	A	G	9	5	14	1	1	16	0	0
14	34154746	.	C	T	1	4	5	0	5	10	0	0
14	34154815	.	A	G	5	2	7	0	0	7	0	0
14	34180461	.	A	G	3	3	6	0	0	6	0	0
14	34180530	.	T	C	7	0	7	0	6	13	0	0
14	34180557	.	T	G	5	7	12	0	0	12	0	0
14	34182101	.	C	T	6	3	9	0	0	9	0	0
14	34182107	.	A	T	5	3	8	0	0	8	0	0
14	34191157	.	G	A	4	4	8	0	0	8	0	0
14	34194564	.	A	G	3	7	10	0	1	11	0	0
14	34195879	.	C	T	0	3	3	0	1	4	0	0
14	34210915	.	A	G	2	1	3	0	0	3	0	0
14	34210925	.	T	C	2	0	2	0	2	4	0	0
14	34240760	.	A	G	3	3	6	0	0	6	0	0
14	34240844	.	G	A	1	3	4	0	1	5	0	0
14	34488456	.	T	C	7	22	29	0	2	31	0	0
14	34553031	.	G	C	7	3	10	0	0	10	0	0
14	34553445	.	C	T	2	4	6	0	0	6	0	0
14	34556534	.	T	C	3	6	9	0	0	9	0	0
14	34556826	.	C	G	10	9	19	0	0	19	0	0
14	34565539	.	T	C	1	2	3	0	0	3	0	0
14	34634415	.	T	A	2	2	4	0	1	5	0	0
14	34634584	.	C	A	6	4	10	0	0	10	0	0
14	34634788	.	G	A	4	2	6	0	0	6	0	0
14	34635144	.	C	T	5	3	8	0	2	10	0	0
14	34635565	.	G	A	3	4	7	0	1	8	0	0
14	34637134	.	A	T	8	7	15	0	2	17	0	0
14	34648339	.	C	A	1	1	2	0	1	3	0	0
14	34658139	.	G	T	7	4	11	0	0	11	0	0
14	34672611	.	C	T	3	5	8	0	0	8	0	0
14	34693868	.	A	T	2	3	5	0	0	5	0	0
14	34789729	.	A	G	1	0	1	0	2	3	0	0
14	34792398	.	G	T	1	5	6	0	0	6	0	0
14	34792627	.	T	C	4	2	6	0	1	7	0	0
14	34797734	.	C	A	5	14	19	0	0	19	0	0
14	35495820	.	T	C	9	5	14	1	0	15	0	0
14	35804833	.	A	G	29	12	41	0	1	43	1	0
14	35895960	.	C	A	2	5	7	2	0	9	0	0
14	35895983	.	G	A	5	3	8	0	0	8	0	0
14	36220744	.	G	T	2	3	5	0	0	5	0	0
14	36229211	.	T	A	4	4	8	0	0	8	0	0
14	36229227	.	T	G	1	5	6	0	0	6	0	0
14	36246854	.	C	T	16	10	26	0	1	27	0	0
14	36259377	.	G	A	1	10	11	0	8	19	0	0
14	36267395	.	C	A	23	12	35	0	2	37	0	0
14	36268152	.	C	T	9	9	18	0	0	18	0	0
14	36268339	.	C	T	18	21	39	0	0	39	0	0
14	36268426	.	T	C	10	6	16	0	0	16	0	0
14	36329023	.	C	A	0	3	3	0	3	6	0	0
14	36329348	.	G	A	4	2	6	0	0	6	0	0
14	36332527	.	G	C	1	0	1	0	2	3	0	0
14	36348652	.	G	A	5	2	7	0	0	7	0	0
14	36348793	.	A	G	8	8	16	0	1	17	0	0
14	36348878	.	G	A	15	32	47	0	0	47	0	0
14	36349387	.	A	T	32	37	69	2	6	77	0	0
14	36349409	.	A	G	30	34	64	2	13	79	0	0
14	36349607	.	C	G	11	32	43	0	34	77	0	0
14	36350639	.	G	T	32	32	64	0	0	64	0	0
14	36350669	.	T	C	30	0	30	0	29	59	0	0
14	36350917	.	A	T	45	28	73	0	1	74	0	0
14	36350932	.	T	A	47	22	69	0	0	69	0	0
14	36350980	.	T	C	36	0	36	1	24	62	1	0
14	36351004	.	C	T	19	34	53	2	7	62	0	0
14	36351064	.	G	A	43	16	59	0	1	60	0	0
14	36351143	.	A	G	38	23	61	0	3	64	0	0
14	36351148	.	C	T	38	22	60	0	3	63	0	0
14	36351209	.	G	A	43	23	66	0	1	67	0	0
14	36351217	.	A	G	42	25	67	0	3	70	0	0
14	36351347	.	G	A	24	36	60	0	3	63	0	0
14	36351350	.	C	T	40	21	61	0	3	64	0	0
14	36352148	.	T	C	32	3	35	0	26	61	0	0
14	36352265	.	G	A	42	38	80	0	1	81	0	0
14	36363689	.	G	A	13	31	44	0	1	45	0	0
14	36430603	.	G	T	10	8	18	0	0	18	0	0
14	36433568	.	T	C	8	0	8	0	4	12	0	0
14	36434258	.	C	T	6	7	13	0	0	13	0	0
14	36437217	.	C	A	3	3	6	0	0	6	0	0
14	36437234	.	G	C	1	2	3	0	0	3	0	0
14	36638417	.	C	T	4	2	6	0	0	6	0	0
14	36676187	.	A	T	1	2	3	0	0	3	0	0
14	36700371	.	T	C	1	2	3	0	0	3	0	0
14	36700380	.	T	C	1	2	3	0	1	4	0	0
14	36708609	.	T	C	2	3	5	0	0	5	0	0
14	36708741	.	T	C	3	4	7	0	0	7	0	0
14	36708909	.	A	G	2	3	5	0	0	5	0	0
14	36717230	.	T	C	4	5	9	0	0	9	0	0
14	36717315	.	A	G	3	0	3	0	6	9	0	0
14	36717320	.	A	G	4	6	10	0	0	10	0	0
14	36717368	.	T	C	4	3	7	0	0	7	0	0
14	36717374	.	T	C	5	2	7	0	1	8	0	0
14	36717629	.	T	C	3	5	8	0	0	8	0	0
14	36717800	.	G	A	4	3	7	0	0	7	0	0
14	36718265	.	C	T	4	7	11	0	1	12	0	0
14	36720770	.	C	T	10	9	19	0	2	21	0	0
14	36720985	.	A	G	8	2	10	0	1	11	0	0
14	36721033	.	A	G	9	0	9	0	7	16	0	0
14	36721102	.	T	A	8	6	14	0	1	15	0	0
14	36721153	.	G	A	11	9	20	0	0	20	0	0
14	36721175	.	C	G	8	9	17	0	1	18	0	0
14	36721229	.	G	A	7	5	12	0	1	13	0	0
14	36721379	.	G	C	4	10	14	0	1	15	0	0
14	36721437	.	G	A	0	9	9	0	6	15	0	0
14	36721497	.	C	G	7	5	12	0	0	12	0	0
14	36721564	.	G	A	6	5	11	0	0	11	0	0
14	36721599	.	C	A	3	5	8	0	0	8	0	0
14	36721675	.	T	C	5	5	10	0	0	10	0	0
14	36721676	.	G	A	4	5	9	0	0	9	0	0
14	36721724	.	T	A	7	5	12	0	0	12	0	0
14	36721730	.	T	A	8	5	13	0	1	14	0	0
14	36721984	.	G	C	8	7	15	0	0	15	0	0
14	36722015	.	C	T	12	4	16	0	1	17	0	0
14	36722095	.	T	C	2	10	12	0	1	13	0	0
14	36722140	.	C	A	7	5	12	0	0	12	0	0
14	36722364	.	C	T	6	8	14	0	1	15	0	0
14	36722405	.	G	A	12	9	21	0	1	22	0	0
14	36722568	.	A	T	8	4	12	0	0	12	0	0
14	36722601	.	T	G	8	0	8	0	4	12	0	0
14	36722904	.	G	A	0	7	7	0	11	18	0	0
14	36723134	.	A	T	3	7	10	0	0	10	0	0
14	36723213	.	G	A	8	6	14	0	1	15	0	0
14	36723270	.	A	G	13	0	13	0	9	22	0	0
14	36723276	.	T	C	13	10	23	0	0	23	0	0
14	36723326	.	C	T	14	7	21	0	1	22	0	0
14	36723402	.	C	G	17	9	26	0	0	26	0	0
14	36723607	.	A	G	12	4	16	0	1	17	0	0
14	36723690	.	C	G	10	7	17	0	0	17	0	0
14	36723694	.	C	A	8	5	13	0	1	14	0	0
14	36752264	.	T	C	5	0	5	0	5	10	0	0
14	36752283	.	C	A	0	2	2	0	5	7	0	0
14	36752477	.	T	C	3	5	8	0	0	8	0	0
14	36752504	.	T	C	6	4	10	0	0	10	0	0
14	36752514	.	T	A	6	2	8	0	0	8	0	0
14	36758413	.	A	C	3	1	4	0	3	7	0	0
14	36758452	.	T	C	3	3	6	0	0	6	0	0
14	36763156	.	A	T	3	2	5	0	0	5	0	0
14	36763191	.	A	T	5	2	7	0	0	7	0	0
14	36763225	.	A	G	3	3	6	0	2	8	0	0
14	36765662	.	G	A	7	7	14	0	1	15	0	0
14	36765721	.	C	T	10	13	23	0	0	23	0	0
14	36766273	.	A	T	8	14	22	0	0	22	0	0
14	36766394	.	A	C	7	10	17	0	0	17	0	0
14	36766624	.	T	A	7	13	20	0	1	21	0	0
14	36777121	.	A	G	10	17	27	0	2	29	0	0
14	36803100	.	G	T	11	5	16	0	0	16	0	0
14	36863407	.	T	C	1	0	1	0	4	5	0	0
14	37556752	.	T	A	4	5	9	0	0	9	0	0
14	39608657	.	G	A	1	2	3	0	0	3	0	0
14	39651511	.	A	G	1	2	3	0	0	3	0	0
14	39953174	.	C	T	5	7	12	0	0	12	0	0
14	39953208	.	G	T	2	4	6	0	4	10	0	0
14	39953291	.	G	A	3	4	7	0	0	7	0	0
14	39953293	.	C	T	3	3	6	0	1	7	0	0
14	39953337	.	T	A	1	6	7	0	0	7	0	0
14	39953446	.	C	T	1	6	7	0	0	7	0	0
14	39954169	.	C	T	1	5	6	0	0	6	0	0
14	39954272	.	A	G	2	5	7	0	0	7	0	0
14	39954423	.	A	T	3	2	5	0	0	5	0	0
14	39954493	.	A	G	2	2	4	0	0	4	0	0
14	39954716	.	A	G	2	2	4	0	0	4	0	0
14	39954789	.	C	T	1	5	6	0	0	6	0	0
14	39954835	.	G	A	4	3	7	0	0	7	0	0
14	39954963	.	C	T	6	2	8	0	0	8	0	0
14	39955172	.	A	T	3	5	8	0	0	8	0	0
14	39955231	.	T	A	3	3	6	0	0	6	0	0
14	39955448	.	C	T	7	10	17	0	1	18	0	0
14	39955457	.	C	A	8	6	14	0	1	15	0	0
14	39955612	.	A	T	14	6	20	0	1	21	0	0
14	39955646	.	T	C	4	12	16	2	1	19	0	0
14	39955772	.	T	A	8	5	13	0	0	13	0	0
14	39955823	.	T	C	8	3	11	0	2	13	0	0
14	39956075	.	G	A	9	8	17	0	2	19	0	0
14	39956380	.	T	C	10	5	15	0	1	16	0	0
14	39956690	.	A	C	3	4	7	0	0	7	0	0
14	39956804	.	G	T	4	8	12	0	0	12	0	0
14	39956825	.	T	C	9	4	13	0	0	13	0	0
14	39957077	.	C	G	6	6	12	0	0	12	0	0
14	39957304	.	T	G	2	4	6	0	0	6	0	0
14	40303348	.	A	T	25	10	35	0	0	35	0	0
14	40303366	.	C	T	21	10	31	0	2	33	0	0
14	40304488	.	C	G	1	13	14	0	14	28	0	0
14	40305230	.	G	A	19	22	41	0	2	43	0	0
14	40305287	.	C	A	1	13	14	0	22	36	0	0
14	40305635	.	C	T	2	21	23	0	18	41	0	0
14	40305659	.	C	T	0	21	21	0	14	35	0	0
14	40387603	.	C	T	7	18	25	0	0	25	0	0
14	40387627	.	G	A	10	7	17	0	3	20	0	0
14	40388107	.	A	G	13	14	27	0	0	27	0	0
14	40388185	.	A	G	12	9	21	0	1	22	0	0
14	40388440	.	G	A	5	16	21	0	0	21	0	0
14	40388629	.	T	C	15	13	28	0	0	28	0	0
14	40389145	.	C	G	5	7	12	0	0	12	0	0
14	40389789	.	A	T	3	3	6	0	0	6	0	0
14	40389823	.	T	A	4	6	10	0	1	11	0	0
14	40389978	.	C	T	2	4	6	0	0	6	0	0
14	40389988	.	T	A	6	3	9	0	0	9	0	0
14	41277518	.	T	C	8	30	38	0	2	40	0	0
14	41278386	.	C	T	24	12	36	0	5	41	0	0
14	41278945	.	T	C	1	3	4	2	0	6	0	0
14	41278946	.	T	C	0	3	3	2	1	6	0	0
14	41279747	.	T	C	26	6	32	0	8	40	0	0
14	41924593	.	T	C	3	2	5	0	0	5	0	0
14	42172389	.	A	C	6	4	10	0	0	10	0	0
14	42172396	.	C	T	6	4	10	0	0	10	0	0
14	42173572	.	A	T	9	6	15	0	1	16	0	0
14	42173803	.	C	T	6	3	9	0	0	9	0	0
14	42174385	.	C	T	9	9	18	0	0	18	0	0
14	42174401	.	C	T	10	10	20	0	0	20	0	0
14	42174645	.	A	T	14	4	18	0	0	19	1	0
14	42174724	.	C	T	11	11	22	0	2	24	0	0
14	42178503	.	C	T	15	19	34	0	2	36	0	0
14	42178626	.	C	T	7	16	23	0	1	24	0	0
14	42178728	.	G	A	15	9	24	0	1	25	0	0
14	42178974	.	G	A	21	9	30	0	2	32	0	0
14	42978742	.	T	C	2	0	2	0	5	7	0	0
14	42978789	.	G	A	14	6	20	0	0	20	0	0
14	42978975	.	A	G	23	11	34	0	0	34	0	0
14	42978980	.	A	C	23	11	34	0	1	35	0	0
14	42979090	.	T	A	8	15	23	0	2	25	0	0
14	42979233	.	G	C	14	16	30	1	2	34	1	0
14	42979513	.	C	T	25	22	47	0	1	48	0	0
14	42997943	.	G	A	15	24	39	0	1	40	0	0
14	42998114	.	G	A	14	14	28	0	3	31	0	0
14	42998740	.	A	G	19	16	35	0	1	36	0	0
14	42998900	.	G	A	10	6	16	0	1	17	0	0
14	42999314	.	C	T	12	6	18	0	2	20	0	0
14	42999662	.	T	C	7	11	18	0	0	18	0	0
14	43000785	.	A	T	4	5	9	0	0	9	0	0
14	43577704	.	G	A	5	8	13	0	0	13	0	0
14	43577916	.	G	A	8	8	16	0	0	16	0	0
14	43579983	.	A	G	11	6	17	0	0	17	0	0
14	43591152	.	G	T	10	15	25	0	2	27	0	0
14	43591188	.	G	A	7	18	25	0	1	26	0	0
14	43596699	.	G	A	10	9	19	0	2	21	0	0
14	43596774	.	C	A	11	9	20	1	1	22	0	0
14	43598196	.	C	T	0	4	4	0	6	10	0	0
14	43605462	.	C	T	9	8	17	0	1	18	0	0
14	43605498	.	T	C	7	0	7	0	8	15	0	0
14	43612822	.	T	C	2	3	5	0	0	5	0	0
14	43615151	.	G	A	6	7	13	0	1	14	0	0
14	43615244	.	C	G	4	3	7	0	0	7	0	0
14	43615391	.	C	T	4	4	8	0	0	8	0	0
14	44013794	.	C	A	2	2	4	0	0	4	0	0
14	44208093	.	G	A	0	3	3	0	2	5	0	0
14	44589624	.	C	T	6	10	16	0	1	17	0	0
14	44589711	.	T	A	13	13	26	0	0	26	0	0
14	44589834	.	A	G	12	5	17	0	0	17	0	0
14	44589972	.	T	A	10	6	16	0	1	17	0	0
14	44589978	.	G	A	10	5	15	0	1	16	0	0
14	44590297	.	G	C	10	12	22	0	1	23	0	0
14	44590301	.	A	G	12	0	12	0	13	25	0	0
14	44590644	.	C	T	24	14	38	0	0	38	0	0
14	44590838	.	T	A	12	12	24	0	0	24	0	0
14	44590935	.	G	A	0	13	13	0	15	28	0	0
14	44590992	.	A	G	10	10	20	0	0	20	0	0
14	45032173	.	C	T	3	3	6	0	0	6	0	0
14	45034567	.	C	A	2	5	7	0	0	7	0	0
14	45200749	.	A	G	3	2	5	0	1	6	0	0
14	45200792	.	T	G	1	2	3	0	0	3	0	0
14	45203526	.	A	T	2	2	4	0	0	4	0	0
14	45259961	.	A	G	5	5	10	0	0	10	0	0
14	45260381	.	G	T	6	2	8	0	0	8	0	0
14	45271464	.	G	A	2	3	5	0	0	5	0	0
14	45271622	.	T	C	7	6	13	0	0	13	0	0
14	45276551	.	T	C	8	12	20	0	0	20	0	0
14	45276603	.	G	A	2	5	7	0	9	16	0	0
14	45276629	.	C	G	11	5	16	0	1	17	0	0
14	45276671	.	C	T	9	4	13	0	0	13	0	0
14	45276826	.	T	C	4	9	13	0	2	15	0	0
14	45293316	.	T	G	7	6	13	0	0	13	0	0
14	45293345	.	C	G	7	0	7	0	5	12	0	0
14	45293390	.	G	A	7	10	17	0	0	17	0	0
14	45293511	.	G	A	1	3	4	0	10	14	0	0
14	45293599	.	G	T	4	5	9	0	0	9	0	0
14	45293625	.	A	G	3	5	8	0	0	8	0	0
14	45293640	.	T	A	6	6	12	0	0	12	0	0
14	45293898	.	C	T	2	7	9	0	0	9	0	0
14	45293956	.	G	A	4	6	10	0	1	11	0	0
14	45293965	.	G	A	4	8	12	0	1	13	0	0
14	45293995	.	G	A	10	12	22	0	1	23	0	0
14	45295314	.	T	C	8	4	12	0	1	13	0	0
14	45295374	.	A	G	5	0	5	0	6	11	0	0
14	45295547	.	A	G	1	5	6	0	0	6	0	0
14	45295590	.	A	G	14	4	18	0	0	18	0	0
14	45341645	.	T	C	6	12	18	0	1	19	0	0
14	45435447	.	T	C	9	0	9	1	4	14	0	0
14	45435597	.	T	C	4	4	8	0	0	8	0	0
14	45435598	.	T	C	2	6	8	0	0	8	0	0
14	45435891	.	T	C	4	11	15	0	0	15	0	0
14	45530665	.	T	C	6	7	13	0	1	14	0	0
14	45534043	.	T	G	5	4	9	0	2	11	0	0
14	45534178	.	A	G	7	5	12	0	0	12	0	0
14	45545172	.	A	G	2	2	4	0	0	4	0	0
14	45548614	.	G	A	2	2	4	0	0	4	0	0
14	45549643	.	A	T	5	5	10	0	3	13	0	0
14	45552371	.	T	C	1	2	3	1	0	4	0	0
14	45552410	.	A	G	1	2	3	0	0	3	0	0
14	45553885	.	T	C	1	3	4	0	0	4	0	0
14	45565914	.	G	T	5	3	8	0	0	8	0	0
14	45565915	.	A	T	5	3	8	0	0	8	0	0
14	45568736	.	G	T	10	8	18	0	0	18	0	0
14	45570967	.	G	A	13	9	22	0	1	23	0	0
14	45571124	.	A	T	11	6	17	0	0	17	0	0
14	45571501	.	G	A	10	9	19	0	0	19	0	0
14	45571593	.	C	T	15	10	25	1	1	27	0	0
14	45571679	.	T	C	3	4	7	0	0	7	0	0
14	45575139	.	G	A	7	10	17	0	1	18	0	0
14	45575203	.	C	A	5	10	15	1	0	16	0	0
14	45575214	.	T	C	9	0	9	1	10	20	0	0
14	45575336	.	A	G	15	6	21	0	0	21	0	0
14	45575495	.	T	C	8	7	15	0	0	15	0	0
14	45581382	.	T	C	15	10	25	0	0	25	0	0
14	45582312	.	C	A	5	10	15	0	13	28	0	0
14	45582314	.	T	A	16	10	26	0	0	26	0	0
14	45584078	.	T	C	5	1	6	0	5	11	0	0
14	45586237	.	G	A	7	6	13	0	0	13	0	0
14	45590653	.	T	A	2	2	4	0	1	5	0	0
14	45592523	.	C	T	0	3	3	0	6	9	0	0
14	45592634	.	T	C	13	5	18	0	1	19	0	0
14	45594741	.	C	T	2	3	5	0	0	5	0	0
14	45594753	.	T	C	3	2	5	0	0	5	0	0
14	45594792	.	G	C	2	0	2	0	3	5	0	0
14	45597143	.	T	G	2	2	4	0	0	4	0	0
14	45603874	.	C	T	4	4	8	0	0	8	0	0
14	45603951	.	T	C	8	0	8	0	7	15	0	0
14	45603976	.	G	A	11	8	19	0	0	19	0	0
14	45604392	.	C	T	1	6	7	0	16	23	0	0
14	45608886	.	A	G	9	13	22	0	1	23	0	0
14	45631345	.	C	T	2	9	11	0	3	14	0	0
14	45631716	.	C	T	17	20	37	0	1	38	0	0
14	45631768	.	G	T	23	22	45	0	1	46	0	0
14	45632834	.	A	C	30	31	61	0	5	66	0	0
14	45632967	.	T	C	22	7	29	0	32	61	0	0
14	45634860	.	A	T	40	40	80	0	5	85	0	0
14	45635333	.	C	T	16	42	58	0	32	91	1	0
14	45635767	.	T	C	44	53	97	1	5	103	0	0
14	45636078	.	A	G	21	2	23	0	8	31	0	0
14	45636616	.	G	A	54	15	69	4	9	82	0	0
14	45636701	.	G	A	42	15	57	2	3	62	0	0
14	45636719	.	A	T	61	3	64	0	2	66	0	0
14	45636800	.	A	G	42	15	57	1	11	69	0	0
14	45636844	.	A	T	35	33	68	0	2	70	0	0
14	45637103	.	A	C	24	2	26	0	30	56	0	0
14	45637200	.	C	T	34	41	75	0	3	78	0	0
14	45637201	.	T	A	34	42	76	0	1	78	1	0
14	45637382	.	A	G	36	25	61	0	5	66	0	0
14	45637545	.	T	G	18	20	38	0	10	48	0	0
14	45637702	.	C	T	36	16	52	0	1	53	0	0
14	45637804	.	G	T	28	32	60	11	6	77	0	0
14	45638280	.	G	C	34	29	63	0	2	65	0	0
14	45638509	.	C	T	29	19	48	0	2	50	0	0
14	45638562	.	T	G	27	24	51	0	0	51	0	0
14	45638563	.	T	A	25	24	49	0	1	50	0	0
14	45789912	.	T	G	2	1	3	0	0	3	0	0
14	45789920	.	G	A	1	2	3	0	0	3	0	0
14	45926364	.	C	T	2	3	5	0	0	5	0	0
14	45927130	.	T	G	1	0	1	0	3	4	0	0
14	45927282	.	A	T	1	2	3	0	0	3	0	0
14	45927624	.	T	A	5	3	8	0	2	10	0	0
14	45927849	.	C	T	2	5	7	0	0	7	0	0
14	45927861	.	T	C	2	4	6	0	0	6	0	0
14	45929100	.	A	T	2	4	6	0	0	6	0	0
14	45929137	.	T	G	2	6	8	0	0	8	0	0
14	45929140	.	T	A	2	6	8	0	0	8	0	0
14	45929173	.	A	G	3	2	5	0	1	6	0	0
14	45929837	.	T	A	9	6	15	0	0	15	0	0
14	45929974	.	T	C	5	6	11	0	0	11	0	0
14	45930135	.	T	C	8	4	12	0	0	12	0	0
14	45930196	.	A	C	4	8	12	0	1	13	0	0
14	45930399	.	C	T	5	7	12	1	0	13	0	0
14	45930508	.	A	G	3	4	7	0	0	7	0	0
14	45930515	.	G	A	4	4	8	0	0	8	0	0
14	45930690	.	A	G	5	5	10	0	1	11	0	0
14	45930735	.	T	A	5	6	11	0	1	16	4	0
14	45930794	.	G	A	7	6	13	0	1	14	0	0
14	45931079	.	C	G	14	8	22	0	1	23	0	0
14	45931194	.	G	T	12	7	19	0	2	21	0	0
14	45931504	.	C	G	8	8	16	0	1	17	0	0
14	45931637	.	C	T	14	5	19	0	0	19	0	0
14	45931899	.	C	T	10	8	18	0	1	19	0	0
14	46007306	.	A	G	7	5	12	0	0	12	0	0
14	46007321	.	G	A	5	5	10	0	0	10	0	0
14	46009611	.	G	A	6	11	17	0	0	17	0	0
14	46009683	.	A	T	7	7	14	0	0	14	0	0
14	46010711	.	C	T	15	5	20	0	1	21	0	0
14	46010909	.	T	C	15	7	22	0	0	22	0	0
14	46012960	.	T	C	9	9	18	0	0	18	0	0
14	46013121	.	A	T	8	12	20	0	0	20	0	0
14	46013402	.	C	T	19	11	30	0	0	30	0	0
14	46015888	.	C	A	14	21	35	0	0	35	0	0
14	46016107	.	A	G	18	18	36	0	0	36	0	0
14	46017969	.	G	A	16	16	32	0	0	32	0	0
14	46018029	.	C	T	16	9	25	0	2	27	0	0
14	46018468	.	A	G	1	7	8	0	0	8	0	0
14	46018488	.	A	G	13	3	16	0	1	17	0	0
14	46028329	.	G	T	2	5	7	0	0	7	0	0
14	46028330	.	T	A	2	5	7	0	0	7	0	0
14	46028376	.	G	A	3	3	6	0	1	7	0	0
14	46028548	.	G	C	1	6	7	0	3	10	0	0
14	46037489	.	T	C	2	5	7	0	1	8	0	0
14	46039751	.	T	C	5	2	7	0	1	8	0	0
14	46039904	.	C	G	4	0	4	0	6	10	0	0
14	46040318	.	T	C	5	5	10	0	0	10	0	0
14	46041036	.	G	A	2	3	5	0	0	5	0	0
14	46041800	.	C	T	9	4	13	0	0	13	0	0
14	46041861	.	A	T	8	4	12	0	1	13	0	0
14	46042005	.	T	C	2	2	4	0	0	4	0	0
14	46048396	.	A	G	4	4	8	0	1	9	0	0
14	46048644	.	C	T	1	16	17	0	7	24	0	0
14	46048704	.	C	G	1	13	14	0	8	22	0	0
14	46048875	.	T	C	11	12	23	0	3	26	0	0
14	46052172	.	T	A	9	10	19	0	0	19	0	0
14	46052244	.	G	T	6	8	14	0	2	16	0	0
14	46067317	.	A	T	5	6	11	0	1	12	0	0
14	46074433	.	C	T	7	3	10	0	1	11	0	0
14	46074473	.	T	A	8	3	11	0	1	12	0	0
14	46074568	.	C	T	11	6	17	0	0	17	0	0
14	46074576	.	G	A	9	5	14	0	0	14	0	0
14	46074626	.	C	G	6	1	7	0	0	7	0	0
14	46074646	.	G	T	2	4	6	0	0	6	0	0
14	46075085	.	T	C	4	3	7	0	0	7	0	0
14	46075581	.	T	C	1	2	3	0	0	3	0	0
14	46075640	.	A	C	7	6	13	0	1	14	0	0
14	46075749	.	A	G	10	5	15	0	1	16	0	0
14	46076407	.	T	C	5	3	8	2	0	10	0	0
14	46076814	.	T	C	2	0	2	0	2	4	0	0
14	46076858	.	T	C	7	3	10	0	0	10	0	0
14	46078135	.	A	C	4	2	6	0	0	6	0	0
14	46078151	.	C	A	1	2	3	0	3	6	0	0
14	46088595	.	T	A	1	1	2	0	1	3	0	0
14	46089176	.	C	T	8	7	15	0	0	15	0	0
14	46089234	.	C	G	7	3	10	0	0	10	0	0
14	46089242	.	A	C	6	1	7	0	0	7	0	0
14	46089433	.	T	G	6	2	8	0	0	8	0	0
14	46089515	.	T	C	6	4	10	0	0	10	0	0
14	46090508	.	T	A	2	2	4	0	0	4	0	0
14	46091627	.	T	C	7	6	13	0	0	13	0	0
14	46094922	.	C	T	9	11	20	0	1	21	0	0
14	46095043	.	A	G	27	16	43	0	0	43	0	0
14	46095058	.	A	G	24	16	40	0	3	43	0	0
14	46095108	.	A	G	29	28	57	0	2	59	0	0
14	46104150	.	C	T	29	16	45	0	4	49	0	0
14	46104222	.	C	T	2	24	26	0	28	54	0	0
14	46104935	.	G	A	27	24	51	0	3	54	0	0
14	46114944	.	G	A	10	18	28	0	3	31	0	0
14	46128996	.	A	C	1	3	4	0	0	4	0	0
14	46140812	.	C	A	4	5	9	0	0	9	0	0
14	46146715	.	G	A	11	12	23	0	2	25	0	0
14	46146730	.	G	A	14	8	22	0	2	24	0	0
14	46154358	.	C	A	12	9	21	0	1	22	0	0
14	46154561	.	G	A	1	8	9	0	3	12	0	0
14	46154713	.	A	G	6	5	11	0	1	12	0	0
14	46154723	.	G	A	7	9	16	0	0	16	0	0
14	46154798	.	T	C	14	7	21	0	1	22	0	0
14	46154854	.	G	T	1	13	14	0	11	25	0	0
14	46177875	.	C	A	3	2	5	0	0	5	0	0
14	46182955	.	G	A	1	3	4	0	0	4	0	0
14	46183140	.	C	T	2	3	5	0	0	5	0	0
14	46183585	.	C	T	3	4	7	0	1	8	0	0
14	46184037	.	T	C	1	3	4	0	0	4	0	0
14	46184039	.	A	G	1	3	4	0	0	4	0	0
14	46184115	.	G	C	4	3	7	0	0	7	0	0
14	46184223	.	G	A	2	2	4	0	0	4	0	0
14	46184509	.	G	C	2	3	5	0	0	5	0	0
14	46184814	.	G	A	1	2	3	0	0	3	0	0
14	46185402	.	G	C	4	3	7	0	0	7	0	0
14	46185546	.	A	T	1	2	3	0	0	3	0	0
14	46186175	.	T	G	2	4	6	0	0	6	0	0
14	46186188	.	T	C	2	4	6	0	0	6	0	0
14	46186425	.	A	G	3	2	5	2	0	7	0	0
14	46186746	.	G	A	0	3	3	1	4	8	0	0
14	46186827	.	A	G	9	1	10	0	5	15	0	0
14	46187270	.	A	G	4	2	6	0	0	6	0	0
14	46187458	.	A	G	4	0	4	0	3	7	0	0
14	46187641	.	C	T	3	5	8	0	1	9	0	0
14	46187644	.	T	G	4	0	4	0	5	9	0	0
14	46187730	.	G	A	4	4	8	0	0	8	0	0
14	46187879	.	C	T	2	3	5	0	1	6	0	0
14	46188109	.	A	T	13	6	19	0	0	19	0	0
14	46188114	.	C	T	4	10	14	0	2	16	0	0
14	46188526	.	C	T	8	4	12	0	0	12	0	0
14	46188561	.	A	C	7	12	19	0	0	19	0	0
14	46188578	.	C	T	11	10	21	0	0	21	0	0
14	46189130	.	G	A	12	9	21	0	1	22	0	0
14	46189158	.	C	T	11	9	20	0	2	22	0	0
14	46189173	.	G	T	13	6	19	0	0	19	0	0
14	46189251	.	A	G	8	10	18	0	2	20	0	0
14	46189268	.	C	T	7	9	16	0	2	18	0	0
14	46189342	.	T	C	9	3	12	0	0	12	0	0
14	46189460	.	T	C	11	6	17	0	0	17	0	0
14	46189512	.	T	C	6	6	12	0	0	12	0	0
14	46200128	.	G	A	13	12	25	0	0	25	0	0
14	46200244	.	A	C	10	6	16	0	1	17	0	0
14	46200396	.	A	G	10	5	15	1	0	16	0	0
14	46200422	.	A	T	7	6	13	2	0	15	0	0
14	46200445	.	C	A	11	9	20	2	0	22	0	0
14	46200636	.	G	T	17	16	33	0	0	33	0	0
14	46200814	.	G	A	14	17	31	0	0	31	0	0
14	46204139	.	A	G	13	20	33	0	2	35	0	0
14	46206097	.	C	G	0	11	11	0	7	18	0	0
14	46208722	.	G	A	10	18	28	0	2	30	0	0
14	46208725	.	T	C	18	8	26	0	4	30	0	0
14	46208818	.	A	T	16	14	30	0	3	33	0	0
14	46210481	.	G	A	6	5	11	0	0	11	0	0
14	46297049	.	A	G	3	2	5	0	0	5	0	0
14	46300696	.	A	G	3	0	3	0	2	5	0	0
14	46315523	.	C	T	1	2	3	0	0	3	0	0
14	46346878	.	T	A	6	8	14	0	1	15	0	0
14	46352475	.	A	T	11	9	20	0	3	23	0	0
14	46352654	.	A	T	10	8	18	0	0	18	0	0
14	46382221	.	T	C	2	5	7	0	1	8	0	0
14	46382488	.	C	T	2	3	5	0	0	5	0	0
14	46385910	.	T	A	1	3	4	0	0	4	0	0
14	46385928	.	T	C	1	0	1	0	4	5	0	0
14	46441791	.	G	A	4	4	8	0	0	8	0	0
14	46441899	.	G	A	4	2	6	0	1	7	0	0
14	46441921	.	T	A	1	1	2	0	5	7	0	0
14	46441977	.	A	C	2	3	5	0	0	5	0	0
14	46442358	.	C	T	2	2	4	0	0	4	0	0
14	46456501	.	T	G	15	20	35	0	0	35	0	0
14	46456905	.	T	A	16	9	25	0	4	29	0	0
14	46456989	.	C	T	21	17	38	1	1	40	0	0
14	46457009	.	T	G	20	11	31	1	2	34	0	0
14	46457684	.	A	G	8	4	12	0	0	12	0	0
14	46457700	.	A	G	6	3	9	0	1	10	0	0
14	46457724	.	G	T	7	4	11	0	1	12	0	0
14	46458185	.	T	G	4	5	9	0	0	9	0	0
14	46458376	.	T	A	3	15	18	0	0	18	0	0
14	46458790	.	A	G	4	10	14	0	0	14	0	0
14	46458915	.	C	G	4	10	14	0	0	14	0	0
14	46459269	.	G	A	9	6	15	0	2	17	0	0
14	46475543	.	G	A	4	4	8	0	0	8	0	0
14	46532469	.	C	G	5	2	7	6	0	13	0	0
14	46633753	.	G	C	2	2	4	0	0	4	0	0
14	46633864	.	A	G	3	3	6	0	0	6	0	0
14	46633919	.	T	A	2	4	6	0	0	6	0	0
14	46638308	.	C	T	1	6	7	0	0	7	0	0
14	46651453	.	G	A	2	3	5	0	0	5	0	0
14	46678919	.	A	G	8	4	12	0	1	13	0	0
14	46679197	.	T	A	1	5	6	0	0	6	0	0
14	46679259	.	A	G	2	8	10	0	0	10	0	0
14	46679263	.	C	T	1	8	9	0	1	10	0	0
14	46679304	.	A	G	9	6	15	0	0	15	0	0
14	46679307	.	A	T	9	6	15	0	1	16	0	0
14	46679348	.	C	T	15	6	21	0	0	21	0	0
14	46679786	.	T	C	22	9	31	1	0	32	0	0
14	46679902	.	A	C	12	7	19	6	0	25	0	0
14	46679912	.	G	A	10	9	19	4	2	25	0	0
14	46680043	.	T	C	13	8	21	0	1	22	0	0
14	46680226	.	C	A	14	5	19	0	0	19	0	0
14	46680857	.	A	T	1	5	6	0	0	6	0	0
14	46680864	.	T	G	2	4	6	0	0	6	0	0
14	46680900	.	T	C	0	0	0	0	12	12	0	0
14	46680904	.	A	T	5	9	14	0	0	14	0	0
14	46680966	.	T	C	8	6	14	0	0	14	0	0
14	46681005	.	A	C	4	8	12	0	0	12	0	0
14	46681020	.	T	A	3	7	10	0	0	10	0	0
14	46681435	.	A	T	5	4	9	0	0	9	0	0
14	46681436	.	A	T	5	4	9	0	0	9	0	0
14	46681641	.	A	G	7	7	14	0	0	14	0	0
14	46682877	.	T	G	3	7	10	0	0	10	0	0
14	46682919	.	T	C	3	4	7	0	2	9	0	0
14	46682926	.	A	G	3	4	7	0	2	9	0	0
14	46683101	.	T	A	5	4	9	0	0	9	0	0
14	46684102	.	C	T	1	3	4	0	1	5	0	0
14	46684195	.	A	C	5	3	8	1	1	10	0	0
14	46684227	.	T	C	6	5	11	1	2	14	0	0
14	46684233	.	G	T	6	5	11	1	2	14	0	0
14	46684565	.	C	T	6	3	9	0	0	9	0	0
14	46684632	.	T	C	2	0	2	1	5	8	0	0
14	46684636	.	T	A	3	5	8	1	1	10	0	0
14	46684800	.	T	G	7	12	19	0	0	19	0	0
14	46873439	.	C	A	8	5	13	0	1	14	0	0
14	46873543	.	G	A	7	6	13	0	0	13	0	0
14	46873868	.	C	T	6	7	13	0	0	13	0	0
14	46874001	.	G	A	14	7	21	0	0	21	0	0
14	46874572	.	G	A	7	2	9	0	0	9	0	0
14	46874605	.	T	A	5	4	9	0	0	9	0	0
14	46874740	.	C	T	1	5	6	0	0	6	0	0
14	46874763	.	A	G	1	4	5	0	0	5	0	0
14	46874835	.	A	T	3	2	5	0	0	5	0	0
14	46876924	.	T	C	1	2	3	0	0	3	0	0
14	46876970	.	C	T	4	4	8	0	0	8	0	0
14	46877085	.	T	C	4	5	9	0	0	9	0	0
14	46881719	.	A	G	4	11	15	0	2	17	0	0
14	46896932	.	T	C	1	2	3	0	0	3	0	0
14	47142035	.	A	G	5	3	8	0	0	8	0	0
14	47264962	.	T	C	3	1	4	0	3	7	0	0
14	47783003	.	C	A	3	3	6	0	0	6	0	0
14	48932470	.	T	A	24	21	45	0	1	46	0	0
14	48932712	.	G	A	14	18	32	0	1	33	0	0
14	48932880	.	A	T	27	14	41	0	3	44	0	0
14	48932970	.	T	A	7	26	33	0	4	37	0	0
14	48933224	.	A	G	32	22	54	0	2	56	0	0
14	48933273	.	C	A	30	18	48	1	1	50	0	0
14	48933361	.	T	A	34	11	45	1	0	46	0	0
14	48933513	.	T	C	16	6	22	0	3	25	0	0
14	48933575	.	A	G	23	7	30	1	2	33	0	0
14	48933958	.	T	C	29	13	42	2	3	47	0	0
14	48934025	.	G	A	31	14	45	0	0	45	0	0
14	48934052	.	G	A	25	14	39	0	0	39	0	0
14	48934253	.	G	A	17	7	24	0	1	25	0	0
14	48934276	.	G	A	18	2	20	0	2	22	0	0
14	48934299	.	C	A	16	3	19	0	1	20	0	0
14	48934547	.	A	T	32	13	45	0	0	45	0	0
14	48934577	.	G	T	27	17	44	0	0	44	0	0
14	48934630	.	C	G	32	9	41	0	1	42	0	0
14	48934639	.	T	C	34	0	34	0	7	41	0	0
14	48934701	.	T	C	24	15	39	0	3	42	0	0
14	48934719	.	T	G	28	20	48	0	0	48	0	0
14	48934829	.	T	A	14	26	40	0	3	43	0	0
14	48945253	.	C	T	0	3	3	0	1	4	0	0
14	48960842	.	C	T	1	2	3	0	0	3	0	0
14	48960979	.	T	G	2	5	7	0	0	7	0	0
14	48964697	.	T	C	10	10	20	0	3	23	0	0
14	48982292	.	A	T	2	2	4	0	0	4	0	0
14	48987031	.	C	T	1	2	3	0	0	3	0	0
14	48995551	.	C	G	5	2	7	0	0	7	0	0
14	48997367	.	G	A	2	3	5	0	0	5	0	0
14	48998026	.	A	C	4	6	10	0	1	11	0	0
14	49009896	.	T	C	1	2	3	0	0	3	0	0
14	49015393	.	C	T	1	3	4	0	0	4	0	0
14	49021945	.	C	T	7	5	12	0	1	13	0	0
14	49021960	.	C	T	9	4	13	0	0	13	0	0
14	49022002	.	C	T	6	6	12	0	0	12	0	0
14	49022071	.	A	G	6	1	7	0	5	12	0	0
14	49022145	.	A	G	4	0	4	0	4	8	0	0
14	49022290	.	G	T	2	6	8	0	7	15	0	0
14	49022328	.	T	C	8	7	15	0	0	15	0	0
14	49029026	.	A	G	5	0	5	0	8	13	0	0
14	49029159	.	C	A	3	5	8	0	0	8	0	0
14	49029992	.	C	T	9	3	12	0	0	12	0	0
14	49030155	.	C	T	3	7	10	1	0	11	0	0
14	49030439	.	A	G	4	2	6	1	0	7	0	0
14	49030450	.	A	G	2	3	5	1	2	8	0	0
14	49031081	.	T	G	2	7	9	0	0	9	0	0
14	49031086	.	G	A	2	7	9	0	0	9	0	0
14	49031116	.	C	T	4	8	12	0	2	14	0	0
14	49031149	.	T	C	6	9	15	0	1	16	0	0
14	49031162	.	C	T	7	10	17	0	0	17	0	0
14	49031304	.	T	A	2	2	4	0	0	4	0	0
14	49031382	.	G	T	7	4	11	0	2	13	0	0
14	49031385	.	G	A	7	5	12	0	1	13	0	0
14	49040425	.	A	G	5	2	7	0	0	7	0	0
14	49040563	.	T	A	5	12	17	0	2	19	0	0
14	49040574	.	G	A	6	11	17	0	2	19	0	0
14	49040673	.	C	A	2	2	4	0	0	8	4	0
14	49040773	.	G	A	6	2	8	0	0	8	0	0
14	49047525	.	T	G	14	21	35	0	2	37	0	0
14	49053391	.	G	A	9	7	16	0	1	17	0	0
14	49053402	.	C	G	7	6	13	0	1	14	0	0
14	49053431	.	T	G	8	4	12	0	1	13	0	0
14	49053523	.	T	C	3	5	8	0	0	8	0	0
14	49057237	.	T	C	4	3	7	0	2	9	0	0
14	49078728	.	T	G	1	3	4	0	1	5	0	0
14	49078734	.	G	T	2	3	5	0	1	6	0	0
14	49086021	.	G	A	1	2	3	0	0	3	0	0
14	49119048	.	G	T	11	19	30	0	0	30	0	0
14	49119062	.	G	A	28	15	43	0	0	43	0	0
14	49119115	.	T	G	41	20	61	0	1	62	0	0
14	49119192	.	T	A	19	29	48	1	0	49	0	0
14	49119321	.	A	C	26	23	49	0	4	53	0	0
14	49119484	.	T	A	20	24	44	0	0	44	0	0
14	49124645	.	G	C	14	9	23	0	0	23	0	0
14	49124711	.	A	C	10	7	17	0	2	19	0	0
14	49126924	.	G	A	11	6	17	0	1	18	0	0
14	49133139	.	A	G	4	7	11	0	0	11	0	0
14	49135328	.	A	T	14	15	29	0	3	32	0	0
14	49136483	.	C	T	24	11	35	0	2	37	0	0
14	49136530	.	T	G	9	1	10	0	15	25	0	0
14	49136551	.	T	G	9	2	11	0	5	16	0	0
14	49136835	.	G	A	6	13	19	0	0	19	0	0
14	49136886	.	C	A	11	10	21	0	0	21	0	0
14	49136909	.	C	T	8	10	18	3	0	21	0	0
14	49154087	.	A	T	3	2	5	0	0	5	0	0
14	49172185	.	A	T	2	2	4	0	0	4	0	0
14	49172472	.	T	G	1	2	3	0	0	3	0	0
14	49172884	.	C	A	1	3	4	0	0	4	0	0
14	49172926	.	T	G	1	0	1	0	3	4	0	0
14	49172961	.	G	A	0	2	2	0	4	6	0	0
14	49174995	.	G	T	3	2	5	0	0	5	0	0
14	49175579	.	T	C	5	3	8	0	0	8	0	0
14	49175612	.	T	A	5	4	9	0	0	9	0	0
14	49182980	.	T	G	2	5	7	0	0	7	0	0
14	49183104	.	C	G	2	5	7	0	1	8	0	0
14	49192488	.	C	T	3	3	6	0	0	6	0	0
14	49192533	.	A	G	1	0	1	0	3	4	0	0
14	49195504	.	C	T	5	5	10	0	0	10	0	0
14	49195572	.	C	A	4	5	9	0	0	9	0	0
14	49196757	.	A	T	6	4	10	0	2	12	0	0
14	49196784	.	C	T	9	3	12	0	2	14	0	0
14	49199004	.	A	T	5	2	7	0	0	7	0	0
14	49202015	.	C	T	2	3	5	0	0	5	0	0
14	49202111	.	C	G	5	3	8	0	0	8	0	0
14	49203983	.	C	T	5	2	7	0	1	8	0	0
14	49204136	.	G	A	2	2	4	0	2	6	0	0
14	49206948	.	G	A	1	3	4	0	0	4	0	0
14	49209884	.	G	A	0	5	5	0	4	9	0	0
14	49209983	.	C	T	8	6	14	0	0	14	0	0
14	49210055	.	T	C	7	7	14	0	0	14	0	0
14	49210075	.	C	A	7	7	14	0	0	14	0	0
14	49210231	.	A	G	5	6	11	0	0	11	0	0
14	49210349	.	G	A	2	4	6	0	1	7	0	0
14	49210569	.	G	C	4	6	10	0	0	10	0	0
14	49210686	.	T	G	1	2	3	0	1	4	0	0
14	49211001	.	A	G	6	9	15	0	0	15	0	0
14	49211045	.	T	C	8	3	11	0	2	13	0	0
14	49211269	.	A	G	2	4	6	0	1	7	0	0
14	49211280	.	T	A	5	3	8	0	0	8	0	0
14	49212350	.	C	T	8	8	16	0	1	17	0	0
14	49212395	.	T	C	11	7	18	0	0	18	0	0
14	49212501	.	A	G	5	5	10	0	0	10	0	0
14	49212505	.	A	G	6	3	9	0	0	9	0	0
14	49212716	.	A	G	2	6	8	0	1	9	0	0
14	49212718	.	A	G	4	3	7	0	2	9	0	0
14	49212757	.	A	T	4	7	11	0	0	11	0	0
14	49212867	.	A	C	6	4	10	0	0	10	0	0
14	49212887	.	A	C	4	5	9	0	0	9	0	0
14	49212985	.	A	T	7	5	12	0	1	13	0	0
14	49212986	.	G	A	7	6	13	0	0	13	0	0
14	49213126	.	A	T	8	7	15	0	0	15	0	0
14	49213250	.	C	T	6	2	8	0	0	8	0	0
14	49213697	.	A	G	4	2	6	0	0	6	0	0
14	49213725	.	A	G	3	4	7	0	0	7	0	0
14	49213732	.	A	G	3	5	8	0	0	8	0	0
14	49213871	.	A	T	4	3	7	0	2	9	0	0
14	49213932	.	C	T	1	5	6	0	1	7	0	0
14	49213950	.	C	T	3	3	6	0	2	8	0	0
14	49214108	.	T	C	0	6	6	0	0	6	0	0
14	49214158	.	G	A	5	4	9	0	0	9	0	0
14	49214170	.	A	G	6	0	6	0	4	10	0	0
14	49214347	.	T	G	7	0	7	0	4	11	0	0
14	49214392	.	G	A	6	5	11	0	0	11	0	0
14	49231813	.	C	T	9	14	23	0	0	23	0	0
14	49231903	.	C	G	9	6	15	0	0	15	0	0
14	49233937	.	A	G	6	9	15	0	1	16	0	0
14	49236476	.	A	G	12	4	16	0	1	17	0	0
14	49237917	.	A	G	8	7	15	0	2	17	0	0
14	49244377	.	T	C	17	13	30	0	1	31	0	0
14	49244425	.	A	G	18	0	18	0	21	39	0	0
14	49244496	.	C	T	14	17	31	1	1	34	1	0
14	49244740	.	A	T	10	7	17	0	1	18	0	0
14	49244874	.	A	G	11	11	22	1	0	23	0	0
14	49245255	.	G	C	15	18	33	0	2	35	0	0
14	49430817	.	A	G	15	18	33	0	1	34	0	0
14	49865132	.	A	C	4	7	11	0	1	12	0	0
14	49865367	.	T	A	16	7	23	0	1	24	0	0
14	49865508	.	G	A	16	10	26	0	3	29	0	0
14	49865563	.	C	T	8	9	17	0	2	20	1	0
14	49865711	.	A	G	21	13	34	0	2	36	0	0
14	49865747	.	C	T	1	19	20	0	13	33	0	0
14	49878814	.	T	C	7	0	7	0	13	20	0	0
14	49938797	.	C	A	8	7	15	0	1	16	0	0
14	49939493	.	C	T	2	7	9	0	12	21	0	0
14	49939498	.	A	G	14	8	22	0	0	22	0	0
14	49943137	.	G	A	9	6	15	0	1	16	0	0
14	49943171	.	G	T	7	3	10	0	1	11	0	0
14	49943185	.	T	A	8	6	14	0	2	16	0	0
14	49947717	.	T	C	6	5	11	0	0	11	0	0
14	49947724	.	C	T	4	5	9	0	3	12	0	0
14	49947765	.	C	T	5	6	11	0	1	12	0	0
14	49947806	.	G	A	5	6	11	0	0	11	0	0
14	49947846	.	G	A	4	5	9	0	0	9	0	0
14	49947868	.	T	C	5	0	5	0	7	12	0	0
14	49948196	.	G	T	3	7	10	0	0	10	0	0
14	49948217	.	A	G	3	6	9	0	0	9	0	0
14	49948589	.	G	A	4	5	9	0	0	9	0	0
14	49952434	.	C	A	1	12	13	0	7	20	0	0
14	49952515	.	A	G	4	7	11	0	1	12	0	0
14	49952554	.	A	G	7	7	14	0	1	15	0	0
14	49952819	.	G	A	14	6	20	0	0	20	0	0
14	49962203	.	C	T	3	3	6	0	3	9	0	0
14	49962227	.	A	G	2	6	8	0	0	8	0	0
14	49962383	.	G	A	3	3	6	0	0	6	0	0
14	49970407	.	A	G	1	3	4	0	0	4	0	0
14	49997004	.	G	A	2	5	7	0	0	7	0	0
14	49997040	.	A	G	1	4	5	0	0	5	0	0
14	49997043	.	T	C	1	4	5	0	0	5	0	0
14	49997102	.	T	C	5	2	7	0	0	7	0	0
14	49997115	.	G	A	3	4	7	0	0	7	0	0
14	49997246	.	A	G	4	6	10	0	0	10	0	0
14	49997276	.	G	A	4	2	6	0	1	7	0	0
14	49997867	.	G	A	4	3	7	0	0	7	0	0
14	50010696	.	A	G	3	1	4	0	2	6	0	0
14	50798988	.	C	T	43	39	82	0	7	89	0	0
14	50808063	.	A	C	1	4	5	0	0	5	0	0
14	50944705	.	C	A	3	1	4	0	1	5	0	0
14	50950535	.	T	C	2	7	9	0	0	9	0	0
14	50968017	.	T	C	1	5	6	0	0	6	0	0
14	50972229	.	A	T	3	3	6	0	1	7	0	0
14	50972733	.	G	A	0	6	6	0	2	8	0	0
14	50972921	.	G	A	0	5	5	0	4	9	0	0
14	50972963	.	C	T	1	3	4	0	1	5	0	0
14	50973219	.	A	G	3	4	7	0	0	7	0	0
14	50973374	.	C	A	1	3	4	0	0	4	0	0
14	50973537	.	G	C	3	6	9	0	1	10	0	0
14	50973563	.	T	A	2	7	9	0	0	9	0	0
14	50974538	.	C	A	4	8	12	0	0	12	0	0
14	50974785	.	C	G	2	4	6	0	0	6	0	0
14	50974827	.	A	G	2	3	5	0	1	6	0	0
14	50975094	.	A	G	1	6	7	0	1	8	0	0
14	50994361	.	A	G	6	7	13	0	0	13	0	0
14	50994436	.	C	G	5	10	15	0	2	17	0	0
14	50994687	.	G	T	16	14	30	0	3	33	0	0
14	50994695	.	G	C	15	18	33	0	1	34	0	0
14	50999698	.	A	G	11	9	20	0	0	21	1	0
14	51002874	.	G	C	15	0	15	0	17	32	0	0
14	51012349	.	C	T	8	5	13	0	0	13	0	0
14	51015245	.	C	T	4	15	19	0	1	20	0	0
14	51015264	.	A	G	7	17	24	0	1	25	0	0
14	51015359	.	G	C	7	14	21	0	0	21	0	0
14	51017771	.	G	A	3	18	21	0	12	33	0	0
14	51017841	.	A	G	6	18	24	0	4	28	0	0
14	51017906	.	A	T	7	11	18	0	0	18	0	0
14	51017952	.	G	A	0	8	8	0	9	17	0	0
14	51024089	.	A	G	4	6	10	0	0	10	0	0
14	51026649	.	A	T	5	5	10	0	1	11	0	0
14	51115058	.	A	G	2	1	3	0	1	4	0	0
14	51829341	.	G	A	45	32	77	0	1	78	0	0
14	51830952	.	G	A	35	34	69	0	5	74	0	0
14	52358971	.	G	C	4	2	6	0	0	6	0	0
14	52366401	.	G	A	11	7	18	0	0	18	0	0
14	52369280	.	C	G	2	2	4	0	0	4	0	0
14	52379740	.	T	A	8	4	12	0	2	14	0	0
14	52379749	.	T	A	4	8	12	0	0	12	0	0
14	52380113	.	G	A	1	2	3	0	0	3	0	0
14	52380266	.	C	T	0	2	2	0	1	3	0	0
14	52381762	.	G	A	6	8	14	7	0	21	0	0
14	52383871	.	G	A	18	12	30	0	0	30	0	0
14	52386667	.	G	A	9	16	25	0	0	25	0	0
14	52388115	.	G	A	13	8	21	0	2	23	0	0
14	52388136	.	G	C	13	7	20	0	1	21	0	0
14	52388357	.	G	A	6	7	13	0	0	13	0	0
14	52388360	.	G	T	5	7	12	0	0	13	1	0
14	52397323	.	G	A	7	2	9	0	0	9	0	0
14	52397752	.	G	A	9	6	15	0	0	15	0	0
14	52399977	.	A	G	5	7	12	0	0	12	0	0
14	52400426	.	G	C	4	2	6	0	0	6	0	0
14	52408677	.	C	T	5	6	11	0	0	11	0	0
14	52408678	.	A	G	5	6	11	0	0	11	0	0
14	52408723	.	T	C	7	4	11	0	0	11	0	0
14	52411301	.	G	A	1	7	8	0	4	12	0	0
14	52411315	.	C	G	3	7	10	0	1	11	0	0
14	52411904	.	C	T	8	4	12	0	1	13	0	0
14	52413182	.	C	T	9	8	17	0	0	17	0	0
14	52417537	.	C	T	6	4	10	0	0	10	0	0
14	52417555	.	T	C	5	5	10	0	1	11	0	0
14	52418070	.	T	G	6	5	11	0	0	11	0	0
14	52418307	.	T	G	7	8	15	0	0	15	0	0
14	52418308	.	T	A	7	8	15	0	0	15	0	0
14	52418565	.	T	G	14	0	14	0	6	20	0	0
14	52418772	.	G	T	9	5	14	0	0	14	0	0
14	52418818	.	A	G	7	7	14	0	2	16	0	0
14	52418900	.	A	G	2	3	5	0	1	6	0	0
14	52419007	.	C	G	4	7	11	0	0	11	0	0
14	52476624	.	T	C	2	4	6	0	1	7	0	0
14	52490168	.	C	G	8	3	11	0	0	11	0	0
14	52490198	.	G	A	0	5	5	0	4	9	0	0
14	52494438	.	A	G	8	4	12	0	0	12	0	0
14	52494442	.	T	C	7	5	12	0	0	12	0	0
14	52517782	.	T	A	7	7	14	0	2	16	0	0
14	52517957	.	T	C	14	15	29	0	0	29	0	0
14	52518002	.	A	G	9	12	21	0	2	23	0	0
14	52518030	.	G	A	0	13	13	0	12	25	0	0
14	52518125	.	C	A	6	14	20	0	1	21	0	0
14	52518278	.	G	C	1	5	6	0	8	14	0	0
14	52520585	.	C	T	2	4	6	0	5	11	0	0
14	52520747	.	G	T	1	2	3	0	0	3	0	0
14	52520882	.	G	T	2	3	5	0	0	5	0	0
14	52520969	.	C	T	1	2	3	0	0	3	0	0
14	52522820	.	T	C	7	16	23	0	1	24	0	0
14	52522822	.	C	T	7	16	23	0	1	24	0	0
14	52522876	.	C	T	7	11	18	0	1	19	0	0
14	52523087	.	G	A	18	10	28	0	0	28	0	0
14	52523131	.	G	A	11	5	16	0	0	16	0	0
14	52523707	.	A	G	4	15	19	0	0	19	0	0
14	52523798	.	C	T	8	6	14	0	0	14	0	0
14	52524195	.	C	A	5	11	16	0	0	16	0	0
14	52524307	.	G	A	7	6	13	0	0	13	0	0
14	52524364	.	C	T	0	6	6	0	7	13	0	0
14	52524399	.	G	A	7	4	11	0	0	11	0	0
14	52524603	.	C	T	3	5	8	0	0	8	0	0
14	52524651	.	A	T	7	6	13	0	1	14	0	0
14	52524665	.	T	G	8	6	14	0	0	14	0	0
14	52524687	.	T	A	3	8	11	0	0	11	0	0
14	52525016	.	C	T	0	8	8	0	6	14	0	0
14	52525185	.	C	T	2	6	8	0	0	8	0	0
14	52525207	.	T	C	6	3	9	0	0	9	0	0
14	52525326	.	C	T	1	5	6	0	9	15	0	0
14	52525340	.	T	A	9	5	14	0	0	14	0	0
14	52525673	.	G	A	9	8	17	0	1	18	0	0
14	52525812	.	C	T	1	11	12	0	12	24	0	0
14	52528210	.	G	A	11	10	21	0	0	21	0	0
14	52531368	.	G	C	5	0	5	0	3	8	0	0
14	52531384	.	T	C	7	6	13	0	1	14	0	0
14	52533500	.	G	A	11	8	19	0	0	19	0	0
14	52533578	.	T	C	9	12	21	0	2	23	0	0
14	52533584	.	T	C	12	0	12	0	9	21	0	0
14	52538887	.	G	A	5	7	12	0	0	12	0	0
14	52565823	.	C	T	45	29	74	0	2	76	0	0
14	52571230	.	A	G	2	4	6	0	1	7	0	0
14	52574434	.	C	G	4	5	9	0	0	9	0	0
14	52574497	.	C	A	3	3	6	0	0	6	0	0
14	52574520	.	C	T	3	3	6	0	0	6	0	0
14	52574954	.	C	G	2	3	5	0	0	5	0	0
14	52574979	.	C	T	0	6	6	0	1	7	0	0
14	52575138	.	C	T	6	3	9	0	0	9	0	0
14	52575738	.	C	T	5	10	15	0	0	15	0	0
14	52575878	.	A	G	5	7	12	0	1	13	0	0
14	52575879	.	T	A	5	7	12	0	1	13	0	0
14	52577036	.	G	A	3	2	5	0	0	5	0	0
14	52580608	.	G	A	2	5	7	0	1	8	0	0
14	52583001	.	C	A	3	3	6	0	0	6	0	0
15	784368	.	G	C	2	5	7	0	0	7	0	0
15	785772	.	C	T	1	3	4	0	0	4	0	0
15	785781	.	A	G	0	2	2	0	1	3	0	0
15	843520	.	T	A	1	1	2	0	0	2	0	0
15	892399	.	G	A	2	2	4	0	0	4	0	0
15	892714	.	G	A	1	2	3	0	1	4	0	0
15	894804	.	G	A	0	4	4	8	2	14	0	0
15	1029379	.	G	C	4	2	6	0	0	6	0	0
15	1029484	.	C	T	1	2	3	0	0	3	0	0
15	1033435	.	A	T	6	4	10	0	0	10	0	0
15	1033564	.	G	T	5	5	10	0	0	10	0	0
15	1033853	.	A	G	8	6	14	0	0	14	0	0
15	1033955	.	C	T	1	2	3	0	3	6	0	0
15	1036614	.	C	T	2	5	7	0	1	8	0	0
15	1036677	.	C	T	1	4	5	0	3	8	0	0
15	1036825	.	T	C	3	3	6	0	0	6	0	0
15	1148129	.	A	G	3	2	5	0	1	6	0	0
15	1152067	.	T	C	1	2	3	0	0	3	0	0
15	1167166	.	G	A	1	5	6	0	6	12	0	0
15	1169624	.	A	G	3	6	9	0	2	11	0	0
15	1173016	.	A	G	8	0	8	0	7	15	0	0
15	1173067	.	C	T	7	6	13	0	0	13	0	0
15	1173542	.	C	T	9	5	14	0	1	15	0	0
15	1174823	.	A	G	10	7	17	0	1	18	0	0
15	1176447	.	G	A	2	5	7	0	8	15	0	0
15	1178927	.	C	A	15	6	21	0	3	24	0	0
15	1181477	.	G	T	3	4	7	0	0	7	0	0
15	1181480	.	C	T	0	6	6	0	3	9	0	0
15	1183930	.	G	T	12	7	19	0	0	19	0	0
15	1183984	.	C	T	2	5	7	0	13	20	0	0
15	1186181	.	A	G	6	8	14	0	1	15	0	0
15	1186202	.	C	T	0	8	8	0	8	16	0	0
15	1189664	.	C	T	12	10	22	0	3	25	0	0
15	1191750	.	A	G	14	7	21	0	3	24	0	0
15	1191792	.	G	A	1	16	17	0	13	30	0	0
15	1191822	.	A	G	14	1	15	0	12	27	0	0
15	1194590	.	A	G	10	7	17	0	3	20	0	0
15	1194619	.	G	A	2	8	10	0	9	19	0	0
15	1194633	.	A	G	9	7	16	0	1	17	0	0
15	1194670	.	G	A	14	7	21	0	1	22	0	0
15	1194739	.	G	T	8	4	12	0	0	12	0	0
15	1194754	.	T	C	8	3	11	0	0	11	0	0
15	1197233	.	T	C	3	0	3	0	5	8	0	0
15	1209060	.	G	A	1	7	8	0	1	9	0	0
15	1417032	.	G	A	2	17	19	0	20	39	0	0
15	1417104	.	C	T	18	13	31	0	0	31	0	0
15	1430434	.	A	T	17	17	34	1	2	37	0	0
15	1434192	.	T	A	27	11	38	1	3	42	0	0
15	1434228	.	T	C	26	11	37	0	2	39	0	0
15	1434627	.	T	G	2	6	8	0	1	9	0	0
15	1434786	.	T	C	2	13	15	0	1	16	0	0
15	1434792	.	G	A	3	17	20	0	0	20	0	0
15	1434885	.	T	C	9	14	23	0	1	24	0	0
15	1435024	.	T	C	23	20	43	1	1	45	0	0
15	1435047	.	A	G	22	21	43	0	2	45	0	0
15	1435176	.	A	G	28	0	28	0	18	46	0	0
15	1435368	.	T	A	17	19	36	0	5	41	0	0
15	1435462	.	G	A	1	18	19	0	18	37	0	0
15	1436019	.	T	C	16	2	18	1	4	23	0	0
15	1436041	.	C	A	17	9	26	1	0	27	0	0
15	1436072	.	T	A	13	21	34	1	3	38	0	0
15	1436154	.	T	C	11	29	40	0	0	40	0	0
15	1436386	.	G	A	4	26	30	1	30	61	0	0
15	1436457	.	C	A	22	13	35	1	14	50	0	0
15	1436461	.	A	G	20	21	41	1	5	47	0	0
15	1436537	.	C	T	20	19	39	0	1	40	0	0
15	1436629	.	T	C	4	6	10	0	2	12	0	0
15	1453211	.	C	T	2	2	4	0	0	4	0	0
15	1453225	.	G	A	2	2	4	0	1	5	0	0
15	1459450	.	C	G	0	2	2	0	1	3	0	0
15	1469250	.	G	A	1	2	3	0	1	4	0	0
15	1471406	.	C	G	1	4	5	0	0	5	0	0
15	1471421	.	G	A	1	5	6	0	0	6	0	0
15	1495037	.	C	A	3	14	17	0	12	29	0	0
15	1495040	.	C	T	13	12	25	0	2	27	0	0
15	1497353	.	G	A	12	6	18	0	0	18	0	0
15	1497398	.	C	G	8	9	17	0	0	17	0	0
15	1497443	.	A	G	8	11	19	0	0	19	0	0
15	1497982	.	T	A	10	6	16	0	2	18	0	0
15	1499732	.	C	T	11	4	15	0	0	15	0	0
15	1506392	.	A	G	4	2	6	0	0	6	0	0
15	1506503	.	C	T	2	6	8	0	4	12	0	0
15	1602952	.	A	G	17	15	32	0	1	33	0	0
15	1606802	.	G	C	24	0	24	0	13	37	0	0
15	1607707	.	G	A	17	6	23	0	2	25	0	0
15	1612770	.	T	C	8	12	20	0	0	20	0	0
15	1612845	.	C	T	1	8	9	0	15	24	0	0
15	1614119	.	G	A	4	8	12	0	0	12	0	0
15	1614128	.	C	T	1	8	9	0	3	12	0	0
15	1617111	.	G	A	5	8	13	0	1	14	0	0
15	1622341	.	C	T	11	9	20	0	2	22	0	0
15	1622390	.	G	C	19	0	19	0	13	32	0	0
15	1631209	.	T	C	6	0	6	0	13	19	0	0
15	1631336	.	A	T	7	17	24	0	3	27	0	0
15	1631345	.	C	T	5	18	23	0	2	25	0	0
15	1631408	.	C	T	1	24	25	0	4	29	0	0
15	1631528	.	G	A	6	20	26	1	0	27	0	0
15	1633353	.	A	G	4	15	19	0	0	19	0	0
15	1651295	.	G	A	3	16	19	0	0	19	0	0
15	1651298	.	A	G	3	16	19	0	0	19	0	0
15	1651555	.	G	C	3	0	3	0	13	16	0	0
15	1651634	.	C	A	4	13	17	0	0	17	0	0
15	1654506	.	G	A	1	1	2	0	1	3	0	0
15	1661684	.	T	C	5	3	8	0	0	8	0	0
15	1661732	.	T	C	7	3	10	0	0	10	0	0
15	1667813	.	T	C	8	4	12	0	0	12	0	0
15	1667991	.	A	G	5	0	5	0	4	9	0	0
15	1669719	.	C	T	11	10	21	0	2	23	0	0
15	1672050	.	G	A	0	13	13	0	6	19	0	0
15	1672060	.	G	A	6	13	19	0	0	19	0	0
15	1672130	.	C	T	6	6	12	0	0	12	0	0
15	1672151	.	A	C	2	6	8	0	0	8	0	0
15	1680090	.	C	T	2	4	6	0	0	6	0	0
15	1680092	.	A	C	2	4	6	0	0	6	0	0
15	1682103	.	T	C	2	2	4	0	0	4	0	0
15	1682674	.	G	A	3	3	6	0	0	6	0	0
15	1719109	.	T	C	2	0	2	0	2	4	0	0
15	1719371	.	C	T	0	3	3	0	3	6	0	0
15	1719389	.	A	G	4	4	8	0	0	8	0	0
15	1719413	.	C	T	1	2	3	0	4	7	0	0
15	1719476	.	C	T	0	3	3	0	2	5	0	0
15	1721514	.	T	C	3	0	3	0	2	5	0	0
15	1721523	.	A	G	2	3	5	0	0	5	0	0
15	1730643	.	A	G	6	3	9	0	1	10	0	0
15	1750044	.	G	C	5	8	13	0	0	13	0	0
15	1750047	.	A	C	5	8	13	0	0	13	0	0
15	1753501	.	A	G	1	4	5	0	1	6	0	0
15	1756009	.	G	A	4	2	6	0	1	7	0	0
15	1758058	.	G	A	4	3	7	0	1	8	0	0
15	1758636	.	G	A	1	4	5	0	0	5	0	0
15	1758675	.	T	C	2	0	2	0	4	6	0	0
15	1766675	.	C	T	4	5	9	0	0	9	0	0
15	1774417	.	T	C	1	5	6	0	0	6	0	0
15	1778714	.	A	T	2	7	9	0	0	9	0	0
15	1778720	.	C	T	3	8	11	0	0	11	0	0
15	1782156	.	T	C	8	7	15	0	0	15	0	0
15	1789281	.	T	A	10	18	28	1	0	29	0	0
15	1789302	.	T	C	14	14	28	1	0	29	0	0
15	1792532	.	T	G	13	9	22	0	1	23	0	0
15	1828388	.	C	T	9	11	20	0	0	20	0	0
15	1829166	.	C	T	24	14	38	0	2	40	0	0
15	1829310	.	A	G	18	21	39	0	0	39	0	0
15	1830259	.	T	C	1	3	4	0	0	4	0	0
15	1830275	.	A	G	3	3	6	0	0	6	0	0
15	1830452	.	G	A	21	9	30	0	1	31	0	0
15	1834326	.	A	G	24	10	34	0	1	35	0	0
15	1837854	.	T	G	16	13	29	0	1	30	0	0
15	1837878	.	G	T	14	18	32	0	1	33	0	0
15	1841328	.	T	C	9	14	23	0	0	23	0	0
15	1847299	.	G	A	7	5	12	0	1	13	0	0
15	1847310	.	T	A	8	6	14	0	1	15	0	0
15	1847358	.	A	G	13	12	25	0	0	25	0	0
15	1847432	.	A	C	8	10	18	0	1	19	0	0
15	1847533	.	C	T	7	7	14	0	1	15	0	0
15	1847679	.	A	G	8	9	17	0	0	17	0	0
15	1847728	.	G	A	14	6	20	0	2	22	0	0
15	1847755	.	G	T	18	8	26	0	0	26	0	0
15	1847908	.	A	C	6	10	16	0	0	16	0	0
15	1847931	.	G	A	5	8	13	0	1	14	0	0
15	1847951	.	G	A	7	3	10	0	0	10	0	0
15	1848188	.	T	C	11	0	11	0	8	19	0	0
15	1848202	.	G	T	11	5	16	0	0	16	0	0
15	1848265	.	T	A	2	4	6	0	0	6	0	0
15	1848308	.	G	A	4	3	7	0	0	7	0	0
15	1848320	.	G	A	4	3	7	0	0	7	0	0
15	1848612	.	G	C	4	0	4	0	9	13	0	0
15	1850540	.	A	C	8	0	8	0	4	12	0	0
15	1853028	.	G	A	8	4	12	0	0	12	0	0
15	1858625	.	A	G	2	4	6	0	1	7	0	0
15	1858638	.	C	G	3	4	7	0	0	7	0	0
15	1858712	.	T	C	2	0	2	0	4	6	0	0
15	1858715	.	A	G	3	3	6	0	0	6	0	0
15	1862015	.	A	T	2	3	5	0	0	5	0	0
15	1862024	.	C	T	0	2	2	0	2	4	0	0
15	1865592	.	C	T	2	3	5	0	0	5	0	0
15	1871188	.	A	G	4	3	7	0	0	7	0	0
15	1871197	.	T	C	4	3	7	0	0	7	0	0
15	1893323	.	G	A	0	6	6	0	12	18	0	0
15	1893356	.	A	G	10	0	10	0	7	17	0	0
15	1897928	.	T	A	1	4	5	0	0	5	0	0
15	1898173	.	T	A	4	2	6	0	0	6	0	0
15	1898187	.	C	A	4	2	6	0	0	6	0	0
15	1898359	.	G	T	3	6	9	0	1	10	0	0
15	1898384	.	T	C	6	3	9	0	0	9	0	0
15	1899401	.	A	T	4	5	9	0	1	10	0	0
15	1899831	.	G	A	10	14	24	0	1	25	0	0
15	1899878	.	T	C	10	10	20	0	1	21	0	0
15	1902259	.	A	G	7	9	16	0	2	18	0	0
15	1902271	.	C	T	6	12	18	0	1	19	0	0
15	1903029	.	A	G	7	10	17	0	0	17	0	0
15	1905364	.	T	G	8	12	20	0	1	21	0	0
15	1905412	.	T	C	2	5	7	0	1	8	0	0
15	1908147	.	G	C	9	9	18	0	0	18	0	0
15	1914743	.	G	A	8	7	15	0	0	15	0	0
15	1915751	.	A	G	2	3	5	0	1	6	0	0
15	1926926	.	A	T	4	4	8	2	0	10	0	0
15	1929484	.	G	T	7	2	9	0	0	9	0	0
15	1933275	.	G	A	3	2	5	0	0	5	0	0
15	1950291	.	C	A	1	3	4	0	0	4	0	0
15	1959097	.	A	G	1	2	3	0	0	3	0	0
15	1967154	.	C	G	0	2	2	0	1	3	0	0
15	1972112	.	T	A	2	3	5	0	0	5	0	0
15	2188259	.	G	T	2	7	9	0	4	13	0	0
15	2414007	.	A	G	1	3	4	0	0	4	0	0
15	2414214	.	A	G	4	4	8	0	1	9	0	0
15	2414216	.	A	G	5	3	8	0	2	10	0	0
15	2414764	.	A	G	2	3	5	0	0	5	0	0
15	2414798	.	A	G	4	3	7	0	0	7	0	0
15	2729971	.	T	C	8	6	14	0	3	17	0	0
15	2730358	.	T	C	7	12	19	0	0	19	0	0
15	2730744	.	T	C	5	4	9	0	0	9	0	0
15	3027378	.	T	C	1	0	1	0	7	8	0	0
15	3160593	.	A	G	3	4	7	0	0	7	0	0
15	3376795	.	C	T	7	3	10	0	0	10	0	0
15	3377017	.	T	C	7	6	13	0	0	13	0	0
15	3377106	.	C	T	4	6	10	0	0	10	0	0
15	3900035	.	T	C	1	3	4	0	0	4	0	0
15	3900258	.	A	G	1	2	3	0	0	3	0	0
15	3900322	.	A	C	2	2	4	0	0	4	0	0
15	3921292	.	A	G	1	0	1	0	2	3	0	0
15	3921346	.	A	G	1	0	1	0	5	6	0	0
15	3922949	.	T	A	2	2	4	0	0	4	0	0
15	3924312	.	A	T	4	4	8	0	0	8	0	0
15	3924542	.	G	A	4	6	10	0	0	10	0	0
15	3924600	.	T	G	5	2	7	0	1	8	0	0
15	3924601	.	T	G	5	2	7	0	0	7	0	0
15	3924695	.	T	A	1	3	4	0	0	4	0	0
15	3925206	.	G	T	0	3	3	0	4	7	0	0
15	3925241	.	A	T	4	4	8	0	1	9	0	0
15	3925276	.	A	T	1	2	3	0	0	3	0	0
15	3925286	.	G	A	2	2	4	0	0	4	0	0
15	3927252	.	G	A	1	2	3	0	0	3	0	0
15	3927285	.	T	C	0	3	3	0	0	3	0	0
15	3927295	.	T	A	1	3	4	0	0	4	0	0
15	3927328	.	T	G	3	3	6	0	0	6	0	0
15	3927346	.	A	G	3	2	5	0	0	5	0	0
15	3927857	.	G	C	4	2	6	0	0	6	0	0
15	3928232	.	C	T	2	3	5	0	0	5	0	0
15	3929177	.	A	T	1	2	3	0	0	3	0	0
15	4105009	.	A	G	3	6	9	0	0	9	0	0
15	4105168	.	T	G	4	10	14	0	0	14	0	0
15	4105235	.	T	C	8	5	13	0	0	13	0	0
15	4105262	.	A	G	8	6	14	0	0	14	0	0
15	4105328	.	A	G	7	7	14	0	0	14	0	0
15	4105416	.	G	T	2	5	7	0	0	7	0	0
15	4111821	.	A	G	5	5	10	0	1	11	0	0
15	4112123	.	A	T	7	6	13	0	0	13	0	0
15	4112132	.	T	C	6	6	12	0	0	12	0	0
15	4112233	.	C	T	2	4	6	0	1	7	0	0
15	4119284	.	A	G	6	3	9	0	0	9	0	0
15	4123660	.	T	G	3	4	7	0	0	7	0	0
15	4139723	.	T	A	1	2	3	0	0	3	0	0
15	4172458	.	C	T	4	5	9	0	0	9	0	0
15	4174147	.	T	G	4	3	7	0	0	7	0	0
15	4174174	.	C	T	2	4	6	0	1	7	0	0
15	4174191	.	G	T	2	5	7	0	0	7	0	0
15	4177160	.	C	A	9	7	16	0	1	17	0	0
15	4202222	.	G	A	2	2	4	0	0	4	0	0
15	4207587	.	G	C	4	3	7	0	0	7	0	0
15	4214109	.	A	G	2	3	5	0	0	5	0	0
15	4214223	.	A	G	1	3	4	0	0	4	0	0
15	4353311	.	G	T	18	13	31	0	2	33	0	0
15	4353333	.	T	C	10	1	11	0	16	34	7	0
15	4353353	.	C	T	18	24	42	0	2	44	0	0
15	4353858	.	C	T	38	21	59	0	4	63	0	0
15	4353965	.	G	A	30	38	68	1	5	74	0	0
15	4354071	.	G	A	34	30	64	0	1	65	0	0
15	4367594	.	T	C	34	25	59	0	0	59	0	0
15	4371833	.	T	C	21	23	44	1	1	46	0	0
15	4371863	.	C	T	29	26	55	1	2	58	0	0
15	4415864	.	G	C	14	4	18	0	0	18	0	0
15	4422128	.	G	T	3	5	8	0	0	8	0	0
15	4422222	.	A	G	2	3	5	0	0	5	0	0
15	4422293	.	G	C	1	1	2	0	3	5	0	0
15	4422302	.	T	C	1	4	5	0	0	5	0	0
15	4422383	.	A	T	1	6	7	0	0	7	0	0
15	4422394	.	G	A	2	5	7	0	0	7	0	0
15	4422496	.	A	G	1	4	5	0	0	5	0	0
15	4422514	.	G	C	2	2	4	0	0	4	0	0
15	4422580	.	A	G	4	5	9	0	0	9	0	0
15	4553776	.	C	T	1	4	5	0	0	5	0	0
15	4585517	.	T	C	14	1	15	0	6	21	0	0
15	4585771	.	T	A	9	8	17	0	2	19	0	0
15	4586190	.	C	G	1	16	17	0	14	31	0	0
15	4586235	.	A	G	13	19	32	0	2	34	0	0
15	4586299	.	G	T	5	7	12	0	7	19	0	0
15	4633700	.	C	G	33	0	33	0	19	52	0	0
15	4634063	.	C	T	20	30	50	0	2	52	0	0
15	4634196	.	T	C	22	20	42	0	0	43	1	0
15	4634354	.	A	G	19	28	47	0	1	48	0	0
15	4634454	.	A	G	24	19	43	0	1	44	0	0
15	4634627	.	A	G	18	15	33	0	7	40	0	0
15	4634698	.	C	A	22	13	35	2	2	39	0	0
15	4635055	.	G	A	3	23	26	0	23	49	0	0
15	4635073	.	T	C	18	27	45	0	2	47	0	0
15	4635179	.	C	A	28	21	49	0	3	52	0	0
15	4635387	.	C	T	26	17	43	1	2	46	0	0
15	4635517	.	G	A	27	15	42	0	2	44	0	0
15	4635573	.	C	T	26	12	38	0	4	42	0	0
15	4635730	.	G	A	10	3	13	0	0	13	0	0
15	4969267	.	T	C	2	0	2	0	3	5	0	0
15	4981994	.	G	T	1	2	3	0	0	3	0	0
15	4982502	.	G	T	4	4	8	0	0	8	0	0
15	4982614	.	T	C	3	9	12	0	1	13	0	0
15	4982655	.	A	G	9	0	9	0	7	16	0	0
15	4982744	.	C	A	6	5	11	0	1	12	0	0
15	4982828	.	A	T	3	2	5	0	0	5	0	0
15	4983708	.	A	T	3	6	9	0	0	9	0	0
15	4983781	.	T	C	2	6	8	0	1	9	0	0
15	4984740	.	T	C	2	6	8	0	0	8	0	0
15	4984759	.	T	C	4	5	9	0	0	9	0	0
15	4985002	.	A	T	3	5	8	0	1	10	1	0
15	4991716	.	T	C	4	22	26	0	2	28	0	0
15	4991722	.	A	G	7	0	7	0	21	28	0	0
15	4995166	.	A	G	4	12	16	1	2	20	1	0
15	4999347	.	G	C	10	8	18	0	0	18	0	0
15	4999572	.	G	C	16	13	29	0	0	29	0	0
15	5073791	.	A	G	2	0	2	0	4	6	0	0
15	5074208	.	G	A	1	3	4	0	0	4	0	0
15	5074793	.	T	G	7	3	10	0	0	10	0	0
15	5074799	.	T	C	6	3	9	0	1	10	0	0
15	5074873	.	A	G	2	5	7	0	0	7	0	0
15	5074947	.	A	G	4	6	10	0	0	10	0	0
15	5116298	.	C	T	2	3	5	0	0	5	0	0
15	5116335	.	T	C	1	3	4	0	1	5	0	0
15	5140246	.	A	G	2	0	2	0	6	8	0	0
15	5140578	.	A	G	2	3	5	0	1	6	0	0
15	5140807	.	G	A	1	2	3	0	0	3	0	0
15	5140867	.	A	T	1	3	4	0	0	4	0	0
15	5140882	.	G	A	1	3	4	0	0	4	0	0
15	5140936	.	C	A	2	3	5	0	0	5	0	0
15	5140939	.	G	A	2	3	5	0	0	5	0	0
15	5142205	.	C	T	1	5	6	0	1	7	0	0
15	5144775	.	T	C	2	6	8	0	0	8	0	0
15	5144931	.	G	A	6	3	9	0	1	10	0	0
15	5145104	.	C	A	3	4	7	0	0	7	0	0
15	5145137	.	A	C	2	5	7	0	0	7	0	0
15	5147722	.	T	C	6	6	12	0	1	13	0	0
15	5147723	.	A	T	7	6	13	0	0	13	0	0
15	5147843	.	C	T	6	4	10	0	0	10	0	0
15	5147910	.	G	A	6	6	12	0	0	12	0	0
15	5147987	.	T	C	5	7	12	0	0	12	0	0
15	5148519	.	T	A	3	4	7	0	0	7	0	0
15	5148562	.	G	A	3	5	8	0	1	9	0	0
15	5403687	.	A	C	3	9	12	0	0	12	0	0
15	5406334	.	A	G	4	9	13	0	1	14	0	0
15	5412406	.	C	T	3	6	9	0	0	9	0	0
15	5467289	.	C	T	0	4	4	0	4	8	0	0
15	5566944	.	T	A	2	3	5	0	0	5	0	0
15	5566987	.	T	C	2	2	4	0	0	4	0	0
15	5568926	.	G	A	3	3	6	0	0	6	0	0
15	5632736	.	G	A	5	2	7	0	0	7	0	0
15	5641611	.	T	C	2	0	2	0	4	6	0	0
15	5648119	.	G	A	6	3	9	0	0	9	0	0
15	5660006	.	C	G	2	5	7	0	0	7	0	0
15	5660030	.	G	A	4	4	8	0	0	8	0	0
15	5671860	.	G	A	2	2	4	0	1	5	0	0
15	5671862	.	T	A	3	2	5	0	0	5	0	0
15	5723734	.	C	A	4	2	6	0	0	6	0	0
15	5723938	.	T	G	10	4	14	0	1	15	0	0
15	5723980	.	C	G	0	4	4	0	13	17	0	0
15	5726178	.	T	A	10	6	16	0	0	16	0	0
15	5728461	.	A	G	7	4	11	0	0	11	0	0
15	5738967	.	A	G	4	2	6	0	0	6	0	0
15	5805427	.	C	T	2	2	4	0	0	4	0	0
15	5805436	.	T	A	0	3	3	0	0	3	0	0
15	5829662	.	A	C	5	0	5	0	4	9	0	0
15	5829881	.	A	C	4	1	5	0	8	13	0	0
15	5829922	.	C	T	5	6	11	0	1	12	0	0
15	5830106	.	G	T	3	3	6	0	1	7	0	0
15	5830218	.	T	C	3	7	10	0	3	13	0	0
15	5830443	.	T	G	6	3	9	0	0	9	0	0
15	5830492	.	C	T	1	3	4	0	4	8	0	0
15	5830513	.	C	T	3	4	7	0	0	7	0	0
15	5830655	.	C	T	1	6	7	0	9	16	0	0
15	5830691	.	T	C	9	7	16	0	1	17	0	0
15	5830696	.	C	T	1	9	10	0	9	19	0	0
15	5830740	.	G	T	5	8	13	0	1	14	0	0
15	5831004	.	G	A	8	4	12	0	0	12	0	0
15	5831199	.	G	A	10	6	16	0	1	17	0	0
15	5836499	.	G	A	8	3	11	0	1	12	0	0
15	5836532	.	C	T	12	5	17	0	0	17	0	0
15	5836542	.	C	T	10	4	14	0	1	15	0	0
15	5836610	.	G	T	9	5	14	0	0	14	0	0
15	5837181	.	T	C	5	0	5	0	4	10	1	0
15	5853041	.	T	C	3	3	6	0	0	6	0	0
15	5857224	.	A	G	5	2	7	0	0	7	0	0
15	5862571	.	C	T	5	4	9	0	0	9	0	0
15	5862639	.	A	T	1	3	4	0	0	4	0	0
15	5865261	.	A	G	3	3	6	0	0	6	0	0
15	5892333	.	C	A	2	2	4	0	0	4	0	0
15	5898511	.	T	A	3	9	12	0	1	13	0	0
15	5898856	.	A	G	16	18	34	0	2	36	0	0
15	5898920	.	A	C	20	17	37	1	0	38	0	0
15	5899083	.	C	T	1	20	21	1	22	44	0	0
15	5899113	.	G	A	2	28	30	1	1	36	4	0
15	5899237	.	C	A	2	9	11	0	10	21	0	0
15	5899277	.	A	G	10	3	13	0	3	16	0	0
15	5899996	.	G	A	1	2	3	0	0	3	0	0
15	5900045	.	A	C	1	2	3	0	0	3	0	0
15	5904761	.	T	C	15	15	30	0	0	30	0	0
15	5914994	.	G	A	1	14	15	0	16	31	0	0
15	5916387	.	C	A	21	16	37	0	1	38	0	0
15	5916389	.	G	C	20	16	36	0	2	38	0	0
15	5916442	.	G	A	11	6	17	0	3	20	0	0
15	5943403	.	G	T	1	3	4	0	0	4	0	0
15	6139624	.	G	C	13	13	26	1	2	29	0	0
15	6139800	.	G	A	27	21	48	0	4	52	0	0
15	6139803	.	C	T	26	18	44	0	6	50	0	0
15	6154439	.	T	A	18	17	35	0	1	36	0	0
15	6161235	.	A	G	10	7	17	0	0	17	0	0
15	6161789	.	A	G	7	8	15	0	0	15	0	0
15	6161804	.	C	T	0	8	8	0	11	19	0	0
15	6174544	.	T	G	5	4	9	0	2	11	0	0
15	6186503	.	A	G	5	9	14	0	0	14	0	0
15	6217600	.	A	G	4	4	8	0	1	9	0	0
15	6234255	.	G	A	6	4	10	0	0	10	0	0
15	6519686	.	G	A	3	5	8	0	1	9	0	0
15	6525689	.	G	A	1	4	5	0	0	5	0	0
15	6529881	.	A	G	3	3	6	0	0	6	0	0
15	6529942	.	C	G	0	2	2	0	2	4	0	0
15	6541406	.	A	G	2	3	5	0	0	5	0	0
15	6545184	.	G	T	3	3	6	0	0	6	0	0
15	6553692	.	A	G	1	2	3	0	0	3	0	0
15	6652600	.	T	C	9	17	26	0	1	27	0	0
15	6653094	.	T	G	13	7	20	0	1	21	0	0
15	6653209	.	G	T	2	10	12	0	14	26	0	0
15	6653282	.	C	G	13	12	25	0	0	25	0	0
15	6654524	.	T	G	12	8	20	0	3	23	0	0
15	6654587	.	C	A	11	18	29	0	4	33	0	0
15	6659159	.	G	A	15	19	34	0	3	37	0	0
15	6661390	.	G	A	18	23	41	0	1	42	0	0
15	6661449	.	T	C	15	21	36	0	2	38	0	0
15	6661499	.	G	A	17	16	33	0	5	38	0	0
15	6778483	.	A	G	4	9	13	0	0	13	0	0
15	6778515	.	T	A	3	3	6	0	0	6	0	0
15	6778813	.	A	G	4	4	8	0	1	9	0	0
15	6778825	.	A	G	6	5	11	0	0	11	0	0
15	6778856	.	C	A	5	7	12	0	0	12	0	0
15	6778877	.	A	G	5	5	10	0	1	11	0	0
15	6789675	.	T	C	3	11	14	0	1	15	0	0
15	6799903	.	G	A	4	6	10	0	0	10	0	0
15	6806712	.	G	C	9	21	30	0	3	33	0	0
15	6806836	.	G	A	10	16	26	0	3	29	0	0
15	6806912	.	T	G	7	11	18	0	0	18	0	0
15	6806931	.	T	G	8	9	17	0	0	17	0	0
15	6807014	.	A	T	2	8	10	0	1	11	0	0
15	6807406	.	C	A	4	4	8	0	1	9	0	0
15	6807500	.	C	G	16	10	26	0	0	26	0	0
15	6807514	.	G	A	16	12	28	0	1	29	0	0
15	6807563	.	A	T	15	25	40	0	0	40	0	0
15	6807874	.	C	T	4	7	11	0	0	11	0	0
15	6838126	.	G	A	6	2	8	0	0	8	0	0
15	6838554	.	T	C	4	1	5	0	7	12	0	0
15	6838580	.	G	C	2	11	13	0	0	13	0	0
15	6838771	.	T	C	8	6	14	0	0	14	0	0
15	6838786	.	T	C	9	4	13	0	0	13	0	0
15	6841506	.	G	T	8	8	16	0	3	19	0	0
15	6845567	.	A	G	6	2	8	0	1	9	0	0
15	6845636	.	T	A	1	6	7	0	0	7	0	0
15	6863102	.	G	A	7	2	9	0	0	9	0	0
15	6863137	.	T	C	5	4	9	0	0	9	0	0
15	6957221	.	C	G	6	5	11	0	1	12	0	0
15	7300826	.	T	C	4	3	7	0	0	7	0	0
15	8394927	.	T	G	3	3	6	0	0	6	0	0
15	8394942	.	G	A	2	3	5	0	0	5	0	0
15	8394965	.	G	A	0	4	4	0	3	7	0	0
15	8394987	.	C	T	4	3	7	0	0	7	0	0
15	8425427	.	T	C	1	2	3	0	0	3	0	0
15	8425772	.	G	A	2	3	5	0	0	5	0	0
15	8426123	.	T	G	2	4	6	0	1	7	0	0
15	8427062	.	A	G	6	2	8	0	0	8	0	0
15	8437030	.	A	G	3	6	9	0	0	9	0	0
15	8437062	.	T	G	1	4	5	0	0	5	0	0
15	8604835	.	A	C	4	15	19	0	3	22	0	0
15	8605259	.	C	A	17	11	28	0	1	29	0	0
15	8605318	.	G	A	13	17	30	0	1	31	0	0
15	8605452	.	C	A	14	6	20	0	3	23	0	0
15	8605838	.	T	A	14	10	24	0	0	24	0	0
15	8605839	.	A	T	14	10	24	0	0	24	0	0
15	8605972	.	T	A	8	15	23	0	1	24	0	0
15	8606207	.	A	T	11	5	16	0	0	16	0	0
15	8606224	.	G	A	8	7	15	0	1	16	0	0
15	8606256	.	A	C	8	12	20	0	0	20	0	0
15	8606464	.	A	G	7	16	23	0	1	24	0	0
15	8606501	.	G	A	9	12	21	0	2	23	0	0
15	8606507	.	G	A	11	13	24	0	0	24	0	0
15	8606555	.	C	T	10	12	22	0	1	23	0	0
15	8606601	.	A	C	8	13	21	0	1	22	0	0
15	8606619	.	A	G	10	12	22	0	3	25	0	0
15	8606733	.	T	C	7	4	11	0	0	11	0	0
15	8606739	.	A	T	6	5	11	0	1	12	0	0
15	8606799	.	T	G	8	5	13	0	3	16	0	0
15	8606872	.	C	A	10	8	18	0	1	19	0	0
15	8606897	.	T	C	17	4	21	0	0	21	0	0
15	8606940	.	T	G	9	17	26	0	1	28	1	0
15	8606943	.	T	G	11	17	28	0	2	30	0	0
15	8607025	.	T	A	5	13	18	0	1	19	0	0
15	8607182	.	T	A	10	11	21	0	2	23	0	0
15	8607365	.	G	T	7	12	19	0	11	30	0	0
15	8607846	.	T	A	7	6	13	0	2	15	0	0
15	8661671	.	C	T	5	9	14	0	1	15	0	0
15	8665414	.	G	A	2	2	4	0	0	4	0	0
15	8797850	.	T	C	22	20	42	0	3	45	0	0
15	8799007	.	A	G	30	16	46	0	5	51	0	0
15	8799141	.	T	A	20	17	37	1	2	41	1	0
15	8799462	.	T	A	18	18	36	1	1	38	0	0
15	8799713	.	G	A	22	27	49	0	6	55	0	0
15	8799730	.	T	G	25	2	27	0	30	57	0	0
15	8799831	.	T	C	10	15	25	0	2	27	0	0
15	8799856	.	G	A	7	16	23	0	2	25	0	0
15	8799872	.	C	A	10	20	30	0	0	30	0	0
15	8799892	.	C	T	12	17	29	0	0	29	0	0
15	8799916	.	T	C	11	13	24	0	2	26	0	0
15	8813971	.	G	A	6	3	9	0	0	9	0	0
15	8814221	.	G	T	3	3	6	0	0	6	0	0
15	8814272	.	A	C	2	0	2	0	0	4	2	0
15	8856283	.	G	T	3	1	4	0	0	4	0	0
15	8856293	.	C	T	4	2	6	0	0	6	0	0
15	8990820	.	G	A	4	4	8	0	0	8	0	0
15	8991312	.	A	C	3	2	5	0	0	5	0	0
15	8991326	.	G	T	3	2	5	0	0	5	0	0
15	8991643	.	A	C	1	2	3	0	0	3	0	0
15	8992623	.	G	A	1	3	4	0	0	4	0	0
15	9011178	.	C	T	3	3	6	0	0	6	0	0
15	9011230	.	G	A	2	2	4	0	0	4	0	0
15	9020621	.	C	T	6	5	11	0	0	11	0	0
15	9022711	.	A	G	2	3	5	0	0	5	0	0
15	9022736	.	C	T	0	3	3	0	3	6	0	0
15	9234102	.	A	C	21	15	36	0	2	38	0	0
15	9234114	.	A	G	25	17	42	0	2	44	0	0
15	9234156	.	A	C	28	25	53	0	1	54	0	0
15	9234634	.	A	T	22	29	51	0	3	54	0	0
15	9234885	.	A	G	34	31	65	0	4	69	0	0
15	9234960	.	C	T	32	28	60	0	1	62	1	0
15	9234972	.	T	C	33	28	61	0	2	63	0	0
15	9235081	.	C	G	32	39	71	0	8	79	0	0
15	9235128	.	A	C	33	33	66	0	3	69	0	0
15	9235254	.	A	G	30	31	61	0	5	66	0	0
15	9235319	.	C	T	41	22	63	0	1	64	0	0
15	9235457	.	G	T	16	24	40	0	13	53	0	0
15	9238101	.	G	A	35	29	64	0	1	65	0	0
15	9249293	.	G	A	29	32	61	0	5	66	0	0
15	9249344	.	C	T	19	46	65	0	1	66	0	0
15	9249346	.	A	G	18	45	63	0	2	65	0	0
15	9272219	.	G	T	10	19	29	9	2	40	0	0
15	9315612	.	C	A	4	2	6	0	2	8	0	0
15	9319051	.	T	C	7	0	7	0	10	17	0	0
15	9321930	.	C	A	1	2	3	0	0	3	0	0
15	9367812	.	G	A	12	6	18	0	1	19	0	0
15	9367842	.	T	C	4	12	16	0	1	17	0	0
15	9367923	.	T	C	6	3	9	2	1	12	0	0
15	9368757	.	G	A	10	13	23	0	0	23	0	0
15	9368834	.	A	G	9	10	19	0	1	20	0	0
15	9369114	.	T	C	11	16	27	0	0	27	0	0
15	9369293	.	T	A	5	6	11	0	0	11	0	0
15	9369571	.	A	T	8	4	12	0	1	13	0	0
15	9369610	.	A	T	5	5	10	0	1	12	1	0
15	9369651	.	G	C	5	6	11	0	1	12	0	0
15	9369689	.	G	A	7	9	16	0	2	18	0	0
15	9369733	.	C	T	10	6	16	0	0	16	0	0
15	9369737	.	C	G	6	9	15	0	0	15	0	0
15	9370068	.	G	A	9	4	13	0	0	13	0	0
15	9370096	.	T	C	6	8	14	0	0	14	0	0
15	9370115	.	G	A	8	7	15	0	0	15	0	0
15	9370131	.	C	T	11	7	18	0	1	19	0	0
15	9370477	.	A	G	7	5	12	0	1	13	0	0
15	9370492	.	C	G	7	5	12	0	2	14	0	0
15	9370534	.	T	A	8	10	18	0	0	18	0	0
15	9370553	.	C	T	10	9	19	0	0	19	0	0
15	9370919	.	G	T	10	4	14	0	0	14	0	0
15	9370967	.	T	C	9	0	9	0	7	16	0	0
15	9371303	.	G	A	9	7	16	0	0	16	0	0
15	9371564	.	A	G	6	7	13	0	1	14	0	0
15	9371657	.	T	C	3	5	8	0	0	8	0	0
15	9371678	.	A	G	9	6	15	0	1	16	0	0
15	9372053	.	T	C	3	10	13	0	0	13	0	0
15	9372281	.	C	T	5	2	7	0	2	9	0	0
15	9372356	.	T	A	7	3	10	0	0	10	0	0
15	9372500	.	G	A	2	8	10	0	1	11	0	0
15	9372539	.	G	A	7	2	9	0	0	9	0	0
15	9372730	.	G	A	4	3	7	0	0	7	0	0
15	9372929	.	C	T	2	4	6	0	0	6	0	0
15	9373205	.	G	A	2	4	6	0	0	6	0	0
15	9374174	.	T	C	1	2	3	0	0	3	0	0
15	9374363	.	G	A	3	2	5	0	0	5	0	0
15	9374527	.	G	T	1	2	3	0	0	3	0	0
15	9374627	.	A	T	2	4	6	0	0	6	0	0
15	9375002	.	G	T	1	2	3	0	0	3	0	0
15	9379394	.	C	T	2	2	4	0	0	4	0	0
15	9379541	.	A	C	2	0	2	0	2	4	0	0
15	9379868	.	A	G	3	2	5	0	0	5	0	0
15	9608710	.	A	C	2	0	2	0	2	4	0	0
15	9617134	.	T	C	1	0	1	0	2	3	0	0
15	10001851	.	A	G	11	18	29	0	0	29	0	0
15	10002281	.	G	A	11	11	22	0	1	23	0	0
15	10002317	.	G	A	12	9	21	0	0	21	0	0
15	10002478	.	T	C	2	3	5	0	1	6	0	0
15	10002480	.	T	A	2	3	5	0	0	5	0	0
15	10002524	.	T	C	4	4	8	0	0	8	0	0
15	10002545	.	C	T	10	4	14	0	1	15	0	0
15	10002591	.	A	G	12	4	16	0	0	16	0	0
15	10003274	.	C	T	13	14	27	0	0	27	0	0
15	10003357	.	G	A	11	7	18	0	1	19	0	0
15	10003379	.	G	A	11	9	20	0	0	20	0	0
15	10003647	.	C	T	0	12	12	0	8	20	0	0
15	10003767	.	C	T	0	5	5	0	7	12	0	0
15	10025010	.	T	C	6	6	12	0	3	15	0	0
15	10025185	.	A	G	8	4	12	0	1	13	0	0
15	10025508	.	A	G	5	7	12	0	0	12	0	0
15	10025601	.	G	C	4	0	4	0	4	8	0	0
15	10025710	.	T	C	4	2	6	0	0	6	0	0
15	10025760	.	T	G	4	9	13	0	0	13	0	0
15	10025949	.	C	T	6	4	10	0	1	11	0	0
15	10027257	.	T	C	3	4	7	0	1	8	0	0
15	10039622	.	T	C	3	3	6	0	0	6	0	0
15	10039643	.	T	C	4	3	7	0	0	7	0	0
15	10039775	.	A	G	3	3	6	0	0	6	0	0
15	10065534	.	T	A	3	6	9	0	1	10	0	0
15	10066041	.	G	A	1	2	3	0	0	3	0	0
15	10066074	.	G	A	1	3	4	0	0	4	0	0
15	10066080	.	G	A	1	3	4	0	0	4	0	0
15	10081966	.	G	A	1	3	4	0	0	4	0	0
15	10114884	.	G	A	1	2	3	0	1	4	0	0
15	10114932	.	C	T	1	3	4	0	0	4	0	0
15	11668065	.	A	G	2	4	6	0	0	6	0	0
15	11668633	.	C	T	2	4	6	0	0	6	0	0
15	11669761	.	C	T	3	2	5	0	0	5	0	0
15	11670283	.	A	C	7	3	10	0	0	10	0	0
15	11680132	.	C	T	2	6	8	0	0	8	0	0
15	11690967	.	T	C	4	6	10	0	0	10	0	0
15	11691008	.	T	G	2	0	2	0	5	7	0	0
15	11757580	.	T	A	8	7	15	0	1	16	0	0
15	11871801	.	C	T	1	2	3	0	0	3	0	0
15	11874021	.	A	G	3	1	4	0	2	6	0	0
15	11874022	.	A	T	3	3	6	0	0	6	0	0
15	11874647	.	T	C	1	2	3	0	0	3	0	0
15	14418017	.	A	C	1	2	3	0	0	3	0	0
15	14631930	.	T	C	5	11	16	0	2	18	0	0
15	14631936	.	T	C	14	0	14	0	6	20	0	0
15	15349978	.	C	T	54	20	74	2	2	78	0	0
15	15406925	.	T	G	4	0	4	2	4	10	0	0
15	15406934	.	C	T	4	4	8	2	0	10	0	0
15	16937375	.	T	C	2	8	10	0	1	11	0	0
15	16937653	.	T	C	1	6	7	0	0	7	0	0
15	16937662	.	T	C	2	1	3	0	5	8	0	0
15	16937688	.	T	C	6	5	11	0	0	11	0	0
15	16937717	.	T	C	11	3	14	0	1	15	0	0
15	17297411	.	G	A	9	2	11	0	0	11	0	0
15	17487526	.	A	G	21	5	26	0	3	29	0	0
15	17487544	.	A	G	13	9	22	0	1	23	0	0
15	17487561	.	A	G	16	7	23	0	0	23	0	0
15	17866744	.	C	A	4	2	6	0	1	7	0	0
15	18102357	.	T	C	1	7	8	0	0	8	0	0
15	18368983	.	G	A	1	2	3	0	1	4	0	0
15	19139092	.	T	G	5	1	6	0	17	23	0	0
15	19209468	.	G	A	2	5	7	0	0	7	0	0
15	19293919	.	G	T	12	7	19	0	3	22	0	0
15	19293920	.	G	T	12	8	20	0	2	22	0	0
15	19301259	.	A	G	9	3	12	0	0	12	0	0
15	19311505	.	G	T	1	4	5	0	8	13	0	0
15	19316437	.	C	A	5	5	10	0	0	10	0	0
15	19316497	.	A	T	8	3	11	0	1	12	0	0
15	19316573	.	T	C	4	3	7	0	1	8	0	0
15	19317667	.	T	A	3	3	6	0	0	6	0	0
15	19318445	.	T	G	4	0	4	0	5	9	0	0
15	19318545	.	G	T	9	3	12	0	1	13	0	0
15	19318835	.	C	A	2	2	4	0	0	4	0	0
15	19318861	.	A	G	4	2	6	0	0	6	0	0
15	19319051	.	G	A	3	4	7	0	0	7	0	0
15	19319077	.	T	A	5	5	10	0	0	10	0	0
15	19319128	.	A	C	7	6	13	0	1	14	0	0
15	19319150	.	A	G	9	0	9	0	8	17	0	0
15	19319227	.	C	G	5	8	13	0	1	14	0	0
15	19319250	.	T	C	6	9	15	0	0	15	0	0
15	19319272	.	G	C	6	8	14	0	0	14	0	0
15	19319429	.	G	A	2	4	6	0	0	6	0	0
15	19319666	.	A	G	7	1	8	0	6	14	0	0
15	19319691	.	A	T	3	4	7	0	0	7	0	0
15	19324762	.	T	A	2	4	6	0	0	6	0	0
15	19327602	.	C	G	3	4	7	0	0	7	0	0
15	19327665	.	G	A	0	6	6	0	6	12	0	0
15	19328334	.	G	A	11	11	22	0	0	22	0	0
15	19329944	.	G	A	5	8	13	0	0	13	0	0
15	19329950	.	C	T	4	7	11	0	1	12	0	0
15	19330144	.	C	T	6	8	14	0	0	14	0	0
15	19330652	.	A	G	5	0	5	0	3	8	0	0
15	19330745	.	T	A	2	6	8	0	0	8	0	0
15	19330748	.	C	A	2	6	8	0	0	8	0	0
15	19331011	.	C	A	3	5	8	0	2	10	0	0
15	19332719	.	C	T	2	3	5	0	0	5	0	0
15	19337247	.	A	C	3	3	6	0	0	6	0	0
15	19337251	.	C	T	3	4	7	0	0	7	0	0
15	19345530	.	G	T	13	4	17	0	1	18	0	0
15	19345614	.	C	T	9	13	22	0	0	22	0	0
15	19347821	.	C	T	6	9	15	0	0	15	0	0
15	19347878	.	G	T	10	9	19	0	1	20	0	0
15	19348038	.	A	G	6	2	8	0	1	9	0	0
15	19348275	.	C	T	5	7	12	1	3	16	0	0
15	19482640	.	G	A	3	2	5	0	0	5	0	0
15	19522085	.	T	C	2	2	4	0	0	4	0	0
15	19544143	.	T	C	1	3	4	0	0	4	0	0
15	19561226	.	A	G	3	1	4	0	2	6	0	0
15	19576879	.	A	G	4	5	9	0	0	9	0	0
15	19577066	.	C	T	5	6	11	0	0	11	0	0
15	19577072	.	C	T	5	6	11	0	0	11	0	0
15	19577242	.	G	A	4	4	8	0	0	8	0	0
15	19577367	.	C	A	6	6	12	0	0	12	0	0
15	19577377	.	T	C	6	5	11	0	0	11	0	0
15	19583841	.	C	T	14	11	25	0	2	27	0	0
15	19584132	.	G	T	10	7	17	0	2	19	0	0
15	19584187	.	T	C	17	10	27	0	1	28	0	0
15	19595508	.	C	T	14	10	24	0	1	25	0	0
15	19595509	.	T	G	10	1	11	0	14	25	0	0
15	19600214	.	C	T	10	12	22	0	2	24	0	0
15	19600390	.	A	T	2	7	9	0	1	10	0	0
15	19600570	.	A	C	5	5	10	0	1	11	0	0
15	19600589	.	C	T	7	5	12	0	0	12	0	0
15	19600606	.	A	G	6	0	6	0	6	12	0	0
15	19661664	.	T	A	9	7	16	0	0	16	0	0
15	19661756	.	T	A	13	10	23	0	1	24	0	0
15	19661820	.	G	T	13	18	31	0	1	32	0	0
15	19668294	.	T	G	5	3	8	0	1	9	0	0
15	19668354	.	A	G	6	7	13	0	1	14	0	0
15	19668375	.	G	A	6	8	14	0	1	15	0	0
15	19668638	.	T	G	8	5	13	0	0	14	1	0
15	19669146	.	T	C	6	0	6	0	5	11	0	0
15	19727331	.	C	T	1	3	4	1	0	5	0	0
15	19727353	.	T	C	1	3	4	0	0	4	0	0
15	19727683	.	A	C	1	4	5	0	0	5	0	0
15	19727684	.	C	T	0	4	4	0	1	5	0	0
15	19727782	.	A	G	3	3	6	0	0	6	0	0
15	19727815	.	T	G	3	2	5	0	0	5	0	0
15	19727992	.	G	C	2	3	5	1	0	6	0	0
15	19728131	.	A	T	12	11	23	0	0	23	0	0
15	19728638	.	A	G	28	15	43	0	1	44	0	0
15	19728853	.	T	A	15	12	27	0	1	28	0	0
15	19728989	.	A	C	20	7	27	0	0	27	0	0
15	19737755	.	C	T	3	18	21	0	18	39	0	0
15	19742655	.	T	C	7	12	19	0	0	19	0	0
15	19745764	.	C	A	1	11	12	0	10	22	0	0
15	19772261	.	C	A	1	4	5	0	4	9	0	0
15	19878323	.	C	T	5	3	8	0	0	8	0	0
15	19878798	.	A	G	5	2	7	0	0	7	0	0
15	19878869	.	G	A	2	2	4	0	0	4	0	0
15	19878877	.	C	A	3	2	5	0	0	5	0	0
15	19891082	.	A	T	4	3	7	0	0	7	0	0
15	19891939	.	T	C	9	6	15	0	0	15	0	0
15	19892083	.	G	A	1	10	11	0	5	16	0	0
15	19894898	.	T	G	9	0	9	0	6	15	0	0
15	19895285	.	A	G	8	14	22	0	2	24	0	0
15	19895304	.	T	A	9	12	21	0	1	22	0	0
15	19895991	.	A	G	10	0	10	0	9	19	0	0
15	19896052	.	A	C	10	17	27	0	1	28	0	0
15	19900319	.	A	G	3	2	5	0	0	5	0	0
15	19907082	.	G	A	3	3	6	0	1	7	0	0
15	19907083	.	A	G	3	4	7	0	0	7	0	0
15	19908328	.	T	A	5	2	7	0	1	8	0	0
15	19908340	.	T	A	4	2	6	0	1	7	0	0
15	19908777	.	A	T	7	3	10	0	0	10	0	0
15	19925978	.	G	A	7	2	9	0	0	9	0	0
15	20003130	.	G	A	3	3	6	0	0	6	0	0
15	20005301	.	A	G	13	7	20	0	0	20	0	0
15	20005665	.	C	A	5	4	9	0	0	9	0	0
15	20005943	.	A	G	4	10	14	0	1	15	0	0
15	20006747	.	T	G	4	2	6	0	1	7	0	0
15	20007033	.	T	A	11	6	17	0	2	19	0	0
15	20008357	.	C	T	9	6	15	0	1	16	0	0
15	20008513	.	C	T	2	8	10	0	0	10	0	0
15	20012153	.	G	A	1	2	3	0	0	3	0	0
15	20012199	.	G	T	2	2	4	0	0	4	0	0
15	20061367	.	G	A	15	8	23	0	0	23	0	0
15	20065029	.	T	C	16	8	24	0	4	28	0	0
15	20065074	.	G	A	10	7	17	0	1	18	0	0
15	20065125	.	A	G	5	12	17	0	1	18	0	0
15	20069165	.	T	C	9	3	12	0	0	12	0	0
15	20069201	.	G	A	8	4	12	0	0	12	0	0
15	20071596	.	G	A	6	3	9	0	0	9	0	0
15	20071713	.	T	C	4	3	7	0	1	8	0	0
15	20074627	.	A	G	5	5	10	0	0	10	0	0
15	20076928	.	C	T	2	5	7	0	0	7	0	0
15	20081245	.	T	G	2	6	8	0	0	8	0	0
15	20081275	.	T	A	2	6	8	0	0	8	0	0
15	20081731	.	G	A	6	4	10	0	0	10	0	0
15	20081903	.	G	A	6	4	10	0	1	11	0	0
15	20088588	.	A	G	1	2	3	0	0	3	0	0
15	20204850	.	T	G	3	4	7	0	2	9	0	0
15	20204873	.	C	T	4	4	8	0	1	9	0	0
15	20205014	.	G	A	3	2	5	0	0	5	0	0
15	20205074	.	A	C	6	6	12	0	0	12	0	0
15	20369562	.	G	A	9	2	11	0	1	12	0	0
15	20376393	.	A	G	4	12	16	0	0	16	0	0
15	20377873	.	A	T	10	3	13	0	0	13	0	0
15	20377946	.	C	T	7	6	13	0	0	13	0	0
15	20378302	.	C	T	11	6	17	0	0	17	0	0
15	20378479	.	T	C	11	4	15	0	1	16	0	0
15	20379860	.	C	T	9	8	17	0	1	18	0	0
15	20380144	.	C	A	8	8	16	0	0	16	0	0
15	20383150	.	C	T	7	9	16	0	1	17	0	0
15	20384539	.	A	G	25	1	26	0	20	46	0	0
15	20394672	.	T	C	9	14	23	0	1	24	0	0
15	20395141	.	G	A	1	10	11	0	9	20	0	0
15	20395436	.	G	A	1	3	4	0	0	4	0	0
15	20406270	.	A	C	13	8	21	0	3	24	0	0
15	20406413	.	C	T	1	5	6	0	2	8	0	0
15	20406484	.	G	C	3	7	10	0	0	10	0	0
15	20407026	.	T	A	1	4	5	0	1	6	0	0
15	20407938	.	G	T	9	8	17	0	2	19	0	0
15	20407951	.	G	T	7	11	18	0	1	19	0	0
15	20411321	.	G	A	6	9	15	0	2	17	0	0
15	20412107	.	G	T	6	3	9	0	1	10	0	0
15	20412171	.	G	C	7	14	21	0	0	21	0	0
15	20463842	.	A	G	2	2	4	0	0	4	0	0
15	20464148	.	C	T	1	2	3	0	0	3	0	0
15	20475721	.	T	G	1	2	3	0	0	3	0	0
15	20475817	.	A	G	5	5	10	0	1	11	0	0
15	20478820	.	G	A	17	4	21	0	0	21	0	0
15	20479056	.	A	G	3	11	14	0	1	15	0	0
15	20489875	.	G	A	6	4	10	0	0	10	0	0
15	20525533	.	C	T	6	3	9	0	1	10	0	0
15	20535215	.	T	G	3	3	6	0	0	6	0	0
15	20535445	.	T	C	2	3	5	0	0	5	0	0
15	20535475	.	C	T	2	4	6	0	0	6	0	0
15	20540641	.	T	A	7	5	12	0	0	12	0	0
15	20607323	.	C	T	2	4	6	0	0	6	0	0
15	20628220	.	G	A	6	3	9	0	0	9	0	0
15	20629601	.	G	T	0	3	3	0	4	7	0	0
15	20629622	.	C	T	2	8	10	0	0	10	0	0
15	20637832	.	C	T	5	4	9	0	0	9	0	0
15	20652746	.	G	A	4	5	9	0	0	9	0	0
15	20652813	.	A	T	12	14	26	0	0	26	0	0
15	20652955	.	A	G	27	13	40	0	2	42	0	0
15	20653005	.	T	A	22	16	38	0	1	39	0	0
15	20653258	.	T	A	22	20	42	0	3	45	0	0
15	20709184	.	T	A	11	6	17	0	1	18	0	0
15	20709340	.	G	C	17	11	28	0	1	29	0	0
15	20709490	.	A	G	11	12	23	0	0	23	0	0
15	20709925	.	G	A	18	16	34	0	1	35	0	0
15	20731260	.	G	C	17	11	28	0	0	28	0	0
15	20731452	.	G	T	2	2	4	0	0	4	0	0
15	20832687	.	A	G	3	5	8	0	1	9	0	0
15	20832831	.	C	T	11	8	19	0	0	19	0	0
15	20833018	.	A	G	6	9	15	0	2	17	0	0
15	20833302	.	A	G	1	5	6	0	0	6	0	0
15	20833310	.	A	G	1	4	5	0	0	5	0	0
15	20836008	.	A	G	7	4	11	0	0	11	0	0
15	20843859	.	G	C	0	7	7	0	2	9	0	0
15	20844016	.	C	T	3	3	6	0	0	6	0	0
15	20844018	.	C	T	3	3	6	0	0	6	0	0
15	20844074	.	A	C	5	5	10	0	0	10	0	0
15	20869195	.	C	T	4	6	10	0	0	10	0	0
15	20872763	.	T	C	2	3	5	0	1	6	0	0
15	20875296	.	C	T	5	9	14	0	1	15	0	0
15	20883185	.	A	T	10	7	17	0	2	19	0	0
15	20886090	.	T	C	5	4	9	0	0	9	0	0
15	20891154	.	T	A	9	10	19	0	1	20	0	0
15	20893920	.	T	A	9	7	16	1	1	18	0	0
15	20894094	.	A	G	11	0	11	0	18	29	0	0
15	20894177	.	C	A	19	16	35	0	1	36	0	0
15	20901053	.	T	C	16	22	38	0	2	40	0	0
15	20901133	.	A	G	20	20	40	0	2	42	0	0
15	20901366	.	T	A	17	18	35	0	1	36	0	0
15	20901540	.	C	T	5	12	17	2	5	24	0	0
15	20901562	.	G	A	13	10	23	0	0	23	0	0
15	20907603	.	A	G	16	12	28	0	1	29	0	0
15	20941492	.	T	A	4	3	7	0	0	7	0	0
15	22046572	.	G	A	8	4	12	0	1	13	0	0
15	22046574	.	G	A	8	3	11	0	2	13	0	0
15	22046647	.	T	C	7	3	10	0	2	12	0	0
15	22046900	.	A	G	4	3	7	0	0	7	0	0
15	22046914	.	A	C	2	4	6	0	0	6	0	0
15	22046954	.	T	C	1	0	1	0	5	6	0	0
15	22046965	.	G	C	1	5	6	0	0	6	0	0
15	22047389	.	T	C	8	5	13	0	2	15	0	0
15	22133987	.	A	C	8	0	8	0	5	13	0	0
15	22143027	.	G	A	11	13	24	0	1	25	0	0
15	22147174	.	C	G	8	10	18	0	1	19	0	0
15	22147186	.	G	T	6	7	13	0	1	14	0	0
15	22167606	.	G	A	1	2	3	0	0	3	0	0
15	22272028	.	C	T	1	2	3	0	0	3	0	0
15	22319721	.	C	T	7	3	10	0	0	10	0	0
15	22319797	.	C	T	6	7	13	0	0	13	0	0
15	22319830	.	G	A	9	5	14	0	0	14	0	0
15	22324529	.	A	T	8	13	21	0	2	23	0	0
15	22324538	.	T	A	12	16	28	0	0	28	0	0
15	22324760	.	A	G	14	19	33	0	2	35	0	0
15	22324948	.	T	C	15	10	25	0	1	26	0	0
15	22325007	.	C	T	12	5	17	0	0	17	0	0
15	22325278	.	A	G	7	0	7	0	12	19	0	0
15	22325617	.	G	T	10	12	22	1	1	25	1	0
15	22435473	.	G	A	2	6	8	0	0	8	0	0
15	22441639	.	C	T	3	4	7	0	0	7	0	0
15	22441703	.	C	T	4	3	7	0	0	7	0	0
15	22441744	.	A	G	4	2	6	0	1	7	0	0
15	22441852	.	A	G	4	0	4	0	6	10	0	0
15	22441855	.	C	T	6	5	11	0	0	11	0	0
15	22441900	.	T	C	4	4	8	0	0	8	0	0
15	22441972	.	G	A	9	5	14	0	0	14	0	0
15	22442875	.	G	A	1	5	6	0	4	10	0	0
15	22443048	.	T	G	3	3	6	0	1	7	0	0
15	22443282	.	C	T	11	6	17	0	0	17	0	0
15	22443289	.	A	T	10	7	17	0	1	18	0	0
15	22443460	.	G	A	0	5	5	0	12	17	0	0
15	22443462	.	A	G	12	0	12	0	5	17	0	0
15	22443520	.	A	G	6	14	20	0	1	21	0	0
15	22443615	.	G	A	11	7	18	0	0	18	0	0
15	22443630	.	G	T	2	8	10	0	12	22	0	0
15	22443798	.	A	G	16	15	31	0	1	32	0	0
15	22443858	.	A	G	18	14	32	0	1	33	0	0
15	22443934	.	G	A	3	16	19	0	15	34	0	0
15	22444062	.	A	G	19	22	41	0	1	42	0	0
15	22444239	.	G	A	1	18	19	0	10	29	0	0
15	22444266	.	A	G	10	22	32	0	1	33	0	0
15	22444310	.	T	A	13	15	28	0	3	31	0	0
15	22444331	.	G	A	8	13	21	0	0	21	0	0
15	22444483	.	T	G	5	0	5	0	9	14	0	0
15	22444486	.	A	T	5	6	11	0	1	12	0	0
15	22444636	.	C	T	2	3	5	0	1	6	0	0
15	22500750	.	G	A	0	2	2	0	4	6	0	0
15	22503346	.	A	G	1	0	1	0	2	3	0	0
15	22510996	.	G	A	5	7	12	0	0	12	0	0
15	22516625	.	G	A	4	3	7	0	1	8	0	0
15	22524099	.	C	A	4	4	8	0	1	9	0	0
15	22526258	.	C	T	4	6	10	0	0	10	0	0
15	22533518	.	G	A	6	4	10	0	2	12	0	0
15	22536756	.	C	T	6	4	10	0	1	11	0	0
15	22536795	.	G	C	1	8	9	0	3	12	0	0
15	22536913	.	T	A	5	3	8	0	0	8	0	0
15	22537008	.	T	A	4	4	8	0	0	8	0	0
15	22945140	.	G	A	1	4	5	0	0	5	0	0
15	22976939	.	T	C	1	2	3	0	0	3	0	0
15	22976943	.	T	C	1	2	3	0	0	3	0	0
15	23181511	.	C	A	4	4	8	0	0	8	0	0
15	23187879	.	T	A	8	4	12	0	0	12	0	0
15	23187902	.	T	G	8	0	8	0	4	12	0	0
15	23188188	.	T	G	4	4	8	0	1	9	0	0
15	23188190	.	C	T	3	5	8	0	0	8	0	0
15	23188245	.	T	A	7	2	9	0	1	10	0	0
15	23243797	.	T	C	3	3	6	0	0	6	0	0
15	23255643	.	T	C	3	3	6	0	1	7	0	0
15	23256320	.	C	T	4	10	14	0	1	15	0	0
15	23256449	.	T	C	5	5	10	0	1	11	0	0
15	23264471	.	G	A	0	5	5	1	6	12	0	0
15	23264547	.	G	A	2	3	5	0	9	14	0	0
15	23265217	.	C	T	6	5	11	0	0	11	0	0
15	23272060	.	C	T	2	2	4	0	1	5	0	0
15	23273262	.	G	A	5	4	9	0	1	10	0	0
15	23280990	.	G	A	2	2	4	0	0	4	0	0
15	23281017	.	C	G	2	2	4	0	0	4	0	0
15	23284990	.	A	G	1	2	3	0	0	3	0	0
15	23285213	.	T	A	2	2	4	0	0	4	0	0
15	23356764	.	G	T	2	4	6	0	0	6	0	0
15	23357369	.	C	T	1	1	2	0	1	3	0	0
15	23357402	.	G	A	1	2	3	0	0	3	0	0
15	23357870	.	G	T	0	4	4	0	4	8	0	0
15	23358257	.	C	A	2	4	6	0	0	6	0	0
15	23358455	.	G	C	4	2	6	0	0	6	0	0
15	23382243	.	C	T	0	3	3	0	9	12	0	0
15	23386976	.	C	T	1	8	9	0	7	16	0	0
15	23387010	.	A	G	6	6	12	0	1	13	0	0
15	23387334	.	G	A	4	4	8	0	0	8	0	0
15	23387567	.	G	A	3	2	5	0	1	6	0	0
15	23387577	.	G	A	2	3	5	0	0	5	0	0
15	23388471	.	G	T	4	7	11	0	0	11	0	0
15	23389139	.	C	G	2	3	5	0	0	5	0	0
15	23389689	.	A	G	5	4	9	0	0	9	0	0
15	23391411	.	A	G	2	5	7	0	0	7	0	0
15	23391741	.	A	G	1	3	4	0	0	4	0	0
15	23394773	.	G	A	1	3	4	0	0	4	0	0
15	23400770	.	G	A	2	1	3	0	1	4	0	0
15	23400954	.	G	A	2	4	6	0	0	6	0	0
15	23400961	.	A	G	1	4	5	0	1	6	0	0
15	23403071	.	G	A	1	3	4	0	0	4	0	0
15	23403097	.	A	G	0	4	4	0	1	5	0	0
15	23403191	.	T	C	1	0	1	0	3	4	0	0
15	23423674	.	C	T	4	5	9	0	0	9	0	0
15	23423724	.	G	A	7	4	11	0	0	11	0	0
15	23426717	.	T	A	10	12	22	0	1	23	0	0
15	23427075	.	G	A	7	5	12	0	0	12	0	0
15	23429593	.	G	A	6	9	15	0	1	16	0	0
15	23429915	.	G	A	3	6	9	0	1	10	0	0
15	23431734	.	C	T	0	3	3	0	13	16	0	0
15	23434037	.	G	A	4	3	7	0	0	7	0	0
15	23434242	.	C	T	7	8	15	0	1	16	0	0
15	23434251	.	G	A	8	8	16	0	0	16	0	0
15	23437095	.	C	T	3	6	9	0	0	9	0	0
15	23437162	.	T	A	3	4	7	0	2	9	0	0
15	23440676	.	T	C	1	2	3	0	0	3	0	0
15	23442817	.	G	A	2	3	5	0	0	5	0	0
15	23468157	.	A	G	5	3	8	0	0	8	0	0
15	23468501	.	G	T	3	4	7	0	0	7	0	0
15	23468522	.	A	T	4	4	8	0	0	8	0	0
15	23468542	.	A	C	3	2	5	0	0	5	0	0
15	23472735	.	C	T	4	7	11	0	0	11	0	0
15	23474815	.	C	G	7	6	13	0	0	13	0	0
15	23475943	.	G	A	1	2	3	0	0	3	0	0
15	23512078	.	A	T	1	2	3	0	0	3	0	0
15	23520725	.	G	A	1	2	3	0	0	3	0	0
15	23528183	.	G	A	3	2	5	0	0	5	0	0
15	23529022	.	A	T	1	2	3	0	0	3	0	0
15	23531276	.	G	A	1	3	4	0	0	4	0	0
15	23531933	.	G	A	3	5	8	0	0	8	0	0
15	23532146	.	A	T	1	3	4	0	0	4	0	0
15	23540536	.	T	C	2	3	5	0	0	5	0	0
15	23541943	.	T	G	2	2	4	0	0	4	0	0
15	23551218	.	G	A	1	3	4	0	2	6	0	0
15	23551272	.	C	T	2	5	7	0	0	7	0	0
15	23551295	.	T	A	1	3	4	0	0	4	0	0
15	23551336	.	A	T	2	4	6	0	1	7	0	0
15	23551511	.	T	G	2	2	4	0	0	4	0	0
15	23551769	.	T	G	9	0	9	0	4	13	0	0
15	23551775	.	C	T	8	5	13	0	0	13	0	0
15	23617364	.	G	A	2	7	9	0	8	17	0	0
15	23617612	.	G	T	8	7	15	0	1	16	0	0
15	23619093	.	G	A	2	10	12	0	14	26	0	0
15	23620453	.	T	G	8	9	17	0	2	19	0	0
15	23620511	.	G	A	11	9	20	0	0	20	0	0
15	23620541	.	C	T	11	12	23	0	0	23	0	0
15	23620652	.	G	A	1	9	10	0	9	19	0	0
15	23640374	.	T	A	7	15	22	0	4	26	0	0
15	23640807	.	C	T	21	10	31	0	1	32	0	0
15	23641057	.	C	T	16	10	26	0	1	27	0	0
15	23641102	.	T	G	6	10	16	0	0	16	0	0
15	23641107	.	G	C	11	6	17	0	2	19	0	0
15	23641426	.	G	A	11	12	23	0	1	24	0	0
15	23644609	.	A	G	13	4	17	0	0	17	0	0
15	23645698	.	G	A	4	7	11	0	0	11	0	0
15	23645788	.	C	T	8	10	18	0	1	19	0	0
15	23645810	.	C	T	2	5	7	0	11	18	0	0
15	23662647	.	A	G	2	0	2	0	3	5	0	0
15	23670622	.	A	G	1	4	5	0	0	5	0	0
15	23675921	.	A	G	2	1	3	0	4	7	0	0
15	23677256	.	G	T	1	2	3	0	1	4	0	0
15	23677373	.	A	T	1	4	5	0	1	6	0	0
15	23677376	.	G	A	0	4	4	0	2	6	0	0
15	23684232	.	C	T	7	2	9	0	1	10	0	0
15	23686857	.	G	A	3	5	8	0	0	8	0	0
15	23686877	.	G	A	4	5	9	0	0	9	0	0
15	23689643	.	G	A	2	2	4	0	0	4	0	0
15	23693991	.	G	A	1	2	3	0	0	3	0	0
15	23693997	.	C	G	2	2	4	0	0	4	0	0
15	23694163	.	A	T	2	2	4	2	0	6	0	0
15	23709660	.	G	A	4	6	10	0	0	10	0	0
15	23710339	.	T	C	5	10	15	0	0	15	0	0
15	23710465	.	C	T	7	6	13	0	0	13	0	0
15	23710490	.	G	T	7	8	15	0	0	15	0	0
15	23710515	.	G	A	6	4	10	0	1	11	0	0
15	23710539	.	T	C	9	8	17	0	0	17	0	0
15	23710811	.	A	G	3	7	10	0	0	10	0	0
15	23711890	.	C	T	0	7	7	0	5	12	0	0
15	23711953	.	G	A	3	9	12	0	2	14	0	0
15	23712082	.	A	G	13	5	18	0	1	19	0	0
15	23713116	.	C	T	0	4	4	0	5	9	0	0
15	23713679	.	T	G	1	4	5	0	0	5	0	0
15	23713923	.	C	T	4	2	6	0	0	6	0	0
15	23718008	.	G	A	1	3	4	0	1	5	0	0
15	23718403	.	C	T	5	3	8	0	0	8	0	0
15	23723607	.	T	A	2	2	4	0	0	4	0	0
15	23724153	.	G	A	5	2	7	0	1	8	0	0
15	23730816	.	C	A	3	4	7	0	1	8	0	0
15	23733485	.	C	A	5	5	10	0	0	10	0	0
15	23738914	.	C	T	12	9	21	0	1	22	0	0
15	23738915	.	G	C	0	9	9	0	13	22	0	0
15	23739032	.	C	T	4	3	7	0	0	7	0	0
15	23745659	.	G	A	3	5	8	0	0	8	0	0
15	23745952	.	C	T	2	2	4	0	0	4	0	0
15	23746547	.	T	C	2	0	2	0	2	4	0	0
15	23746655	.	A	T	1	3	4	0	1	5	0	0
15	23746674	.	G	A	1	2	3	0	0	3	0	0
15	23747248	.	A	T	1	3	4	0	0	4	0	0
15	23777987	.	A	C	1	2	3	0	0	3	0	0
15	23780791	.	A	T	2	5	7	0	2	9	0	0
15	23780834	.	G	T	4	6	10	0	0	10	0	0
15	23781320	.	G	A	3	4	7	0	0	7	0	0
15	23783242	.	G	T	7	2	9	0	0	9	0	0
15	23783669	.	C	T	1	2	3	0	1	4	0	0
15	23784896	.	C	T	5	6	11	0	0	11	0	0
15	23788266	.	G	A	5	5	10	0	0	10	0	0
15	23790255	.	G	A	3	2	5	0	0	5	0	0
15	23792768	.	A	T	1	2	3	0	0	3	0	0
15	23793206	.	C	T	7	5	12	0	0	12	0	0
15	23817403	.	T	A	11	8	19	0	1	20	0	0
15	23817517	.	G	A	11	11	22	0	1	23	0	0
15	23817901	.	C	T	0	10	10	0	7	17	0	0
15	23818313	.	T	A	6	7	13	0	0	13	0	0
15	23818542	.	T	A	5	10	15	0	0	15	0	0
15	23818575	.	T	C	1	8	9	0	1	10	0	0
15	23818765	.	G	A	2	4	6	0	0	6	0	0
15	23818784	.	A	G	5	1	6	0	1	7	0	0
15	23819248	.	T	A	6	10	16	0	0	16	0	0
15	23819253	.	C	T	10	5	15	0	0	15	0	0
15	23819423	.	G	A	10	17	27	0	0	27	0	0
15	23823508	.	C	T	6	7	13	0	2	15	0	0
15	23823638	.	G	C	5	4	9	0	0	9	0	0
15	23829245	.	C	T	3	5	8	0	0	8	0	0
15	23830658	.	G	A	1	4	5	0	0	5	0	0
15	23831007	.	C	T	4	5	9	0	0	9	0	0
15	23863843	.	G	A	2	2	4	0	0	4	0	0
15	23911793	.	C	G	1	3	4	0	1	5	0	0
15	23912118	.	C	T	2	3	5	0	0	5	0	0
15	23918118	.	G	C	3	2	5	0	0	5	0	0
15	23918333	.	G	C	4	2	6	0	0	6	0	0
15	23918365	.	C	T	2	5	7	0	0	7	0	0
15	23918424	.	A	T	1	4	5	0	0	5	0	0
15	23922714	.	G	A	15	16	31	0	2	33	0	0
15	23922994	.	G	T	9	12	21	0	0	21	0	0
15	23923261	.	T	G	15	11	26	0	1	27	0	0
15	23925372	.	G	C	11	8	19	0	0	19	0	0
15	23927992	.	G	T	10	13	23	0	2	25	0	0
15	23931187	.	A	G	10	8	18	0	0	18	0	0
15	23931454	.	A	G	6	4	10	0	0	10	0	0
15	23942804	.	T	G	13	5	18	0	1	19	0	0
15	24016739	.	T	C	1	2	3	0	0	3	0	0
15	24035939	.	C	A	1	2	3	0	0	3	0	0
15	24035940	.	A	C	1	2	3	0	0	3	0	0
15	24052264	.	C	T	3	4	7	0	0	7	0	0
15	24054101	.	C	T	5	5	10	0	1	11	0	0
15	24084737	.	T	A	7	10	17	0	4	21	0	0
15	24084773	.	C	T	12	5	17	0	0	17	0	0
15	24094697	.	T	C	9	10	19	0	0	19	0	0
15	24096474	.	G	A	9	3	12	0	1	13	0	0
15	24096657	.	C	A	8	10	18	0	4	22	0	0
15	24104648	.	C	T	13	11	24	0	2	26	0	0
15	24106821	.	C	T	14	9	23	0	0	23	0	0
15	24119372	.	A	G	10	5	15	0	0	15	0	0
15	24119391	.	C	T	9	4	13	0	0	13	0	0
15	24119571	.	T	C	12	13	25	0	0	25	0	0
15	24119720	.	G	A	2	4	6	0	14	20	0	0
15	24120490	.	G	A	0	5	5	2	4	11	0	0
15	24120588	.	C	T	10	7	17	0	0	17	0	0
15	24388860	.	C	T	1	5	6	0	0	6	0	0
15	24389483	.	G	A	0	4	4	0	3	7	0	0
15	24391755	.	G	A	0	2	2	0	7	9	0	0
15	24439382	.	T	C	1	3	4	0	1	5	0	0
15	24489776	.	G	A	4	4	8	0	0	8	0	0
15	24500648	.	G	A	2	6	8	0	0	8	0	0
15	24525815	.	A	G	3	0	3	0	3	6	0	0
15	24525890	.	T	C	6	6	12	0	0	12	0	0
15	24530477	.	G	A	1	5	6	0	10	16	0	0
15	24535495	.	C	T	7	9	16	0	2	18	0	0
15	24544305	.	T	A	4	4	8	0	0	8	0	0
15	24544325	.	G	A	3	4	7	0	1	8	0	0
15	24544653	.	A	T	9	4	13	0	1	14	0	0
15	24544657	.	A	G	8	0	8	0	5	13	0	0
15	24549609	.	T	C	3	3	6	0	1	7	0	0
15	24554786	.	C	A	4	3	7	0	0	7	0	0
15	24557432	.	A	G	8	3	11	0	1	12	0	0
15	24557810	.	A	C	11	6	17	0	3	20	0	0
15	24561055	.	T	C	10	7	17	0	3	20	0	0
15	24561414	.	G	A	18	11	29	0	0	29	0	0
15	24561501	.	C	T	9	15	24	0	1	25	0	0
15	24568834	.	C	T	1	2	3	0	0	3	0	0
15	24568849	.	C	T	2	2	4	0	0	4	0	0
15	24583933	.	C	G	3	3	6	0	0	6	0	0
15	24584299	.	C	T	2	3	5	0	0	5	0	0
15	24584335	.	T	C	1	2	3	0	0	3	0	0
15	24671079	.	G	T	1	2	3	0	1	4	0	0
15	24673723	.	T	A	16	9	25	0	1	26	0	0
15	24673997	.	A	G	8	5	13	0	0	13	0	0
15	24679744	.	T	C	12	8	20	0	1	21	0	0
15	24679944	.	T	C	5	7	12	0	1	13	0	0
15	24683236	.	A	G	8	6	14	0	1	15	0	0
15	24686282	.	C	T	11	10	21	0	1	22	0	0
15	24686450	.	G	A	3	13	16	0	9	25	0	0
15	24689592	.	G	A	1	17	18	0	7	25	0	0
15	24689701	.	G	A	1	14	15	0	6	21	0	0
15	24689948	.	T	C	6	11	17	0	0	17	0	0
15	24691290	.	A	G	4	0	4	0	4	8	0	0
15	24691534	.	A	G	4	0	4	0	3	7	0	0
15	24692351	.	A	T	3	7	10	0	2	12	0	0
15	24692359	.	G	A	2	8	10	0	2	12	0	0
15	24733569	.	G	A	8	5	13	0	0	13	0	0
15	24733689	.	G	A	11	7	18	0	0	18	0	0
15	24733791	.	T	G	15	10	25	0	1	27	1	0
15	24733896	.	G	A	9	8	17	0	1	18	0	0
15	24733932	.	T	C	7	5	12	0	0	13	1	0
15	24735111	.	G	T	14	7	21	0	1	22	0	0
15	24735163	.	C	G	10	9	19	1	0	20	0	0
15	24735341	.	C	T	6	13	19	0	1	20	0	0
15	24735472	.	T	C	6	8	14	0	1	15	0	0
15	24735677	.	G	T	18	6	24	0	2	26	0	0
15	24735935	.	T	G	3	3	6	0	1	7	0	0
15	24736362	.	G	C	3	4	7	0	0	7	0	0
15	24736525	.	A	G	9	7	16	0	0	16	0	0
15	24736814	.	C	A	2	1	3	0	1	4	0	0
15	24737745	.	A	G	11	11	22	0	2	24	0	0
15	24742930	.	G	A	1	14	15	0	23	39	1	0
15	24743843	.	G	A	5	6	11	0	0	11	0	0
15	24744691	.	G	C	15	11	26	0	1	27	0	0
15	24744724	.	A	T	13	8	21	0	0	21	0	0
15	24749895	.	G	A	2	29	31	0	32	63	0	0
15	24751322	.	C	T	27	40	67	0	1	68	0	0
15	24754323	.	T	G	2	8	10	0	0	10	0	0
15	24754524	.	G	A	18	22	40	0	1	41	0	0
15	24791413	.	C	T	1	6	7	0	0	7	0	0
15	24791431	.	C	T	1	5	6	0	0	6	0	0
15	24791630	.	G	T	1	2	3	0	1	4	0	0
15	24791806	.	G	C	3	2	5	0	0	5	0	0
15	24793432	.	A	G	3	3	6	0	0	6	0	0
15	24794104	.	C	T	3	4	7	0	0	7	0	0
15	24794441	.	T	A	5	2	7	0	1	8	0	0
15	24798529	.	G	A	11	5	16	0	1	17	0	0
15	24806288	.	G	A	10	12	22	0	1	23	0	0
15	24837105	.	G	A	3	10	13	0	14	27	0	0
15	24837402	.	C	T	5	5	10	0	0	10	0	0
15	24837474	.	A	G	6	7	13	0	0	13	0	0
15	24845205	.	G	A	22	19	41	0	1	42	0	0
15	24845460	.	C	T	1	6	7	0	9	16	0	0
15	24845500	.	G	T	14	13	27	0	1	28	0	0
15	24846070	.	G	A	7	4	11	0	0	11	0	0
15	24846186	.	T	C	9	5	14	0	2	16	0	0
15	24846311	.	T	A	12	7	19	0	0	19	0	0
15	24846594	.	T	C	16	0	16	0	8	24	0	0
15	24869405	.	T	C	9	0	9	0	11	20	0	0
15	24869684	.	G	A	8	6	14	0	0	14	0	0
15	24946807	.	C	T	0	6	6	0	8	14	0	0
15	24946809	.	C	G	6	7	13	0	0	13	0	0
15	24946864	.	A	G	3	6	9	0	0	9	0	0
15	24946887	.	C	T	1	5	6	0	0	6	0	0
15	24947006	.	A	C	2	2	4	0	0	4	0	0
15	24947144	.	A	C	1	3	4	0	0	4	0	0
15	24948965	.	T	C	1	0	1	0	2	3	0	0
15	24949055	.	A	G	2	2	4	0	0	4	0	0
15	24950967	.	C	T	0	3	3	0	1	4	0	0
15	24960463	.	G	A	2	4	6	0	0	6	0	0
15	25085266	.	G	C	3	2	5	0	1	6	0	0
15	25093907	.	T	A	3	2	5	0	0	5	0	0
15	25096114	.	G	T	1	2	3	0	0	3	0	0
15	25096190	.	A	T	4	3	7	0	0	7	0	0
15	25096386	.	G	T	5	4	9	0	1	10	0	0
15	25096677	.	T	C	6	8	14	0	0	14	0	0
15	25097001	.	A	G	1	3	4	0	1	5	0	0
15	25097022	.	C	T	2	2	4	0	0	4	0	0
15	25097179	.	T	A	2	4	6	0	0	6	0	0
15	25101042	.	C	T	8	8	16	0	0	16	0	0
15	25101083	.	A	G	4	6	10	0	0	10	0	0
15	25101085	.	T	G	4	6	10	0	0	10	0	0
15	25101260	.	T	C	9	8	17	0	0	17	0	0
15	25101267	.	A	G	10	6	16	0	1	17	0	0
15	25101302	.	G	A	7	10	17	0	1	18	0	0
15	25101538	.	G	A	8	15	23	0	1	24	0	0
15	25101619	.	A	G	15	7	22	1	1	24	0	0
15	25101740	.	C	A	15	16	31	0	1	32	0	0
15	25101990	.	A	G	21	19	40	0	2	42	0	0
15	25173015	.	C	T	0	6	6	0	4	10	0	0
15	25173157	.	A	G	6	10	16	0	0	16	0	0
15	25173188	.	A	T	9	10	19	0	0	19	0	0
15	25173494	.	A	C	5	16	21	0	0	21	0	0
15	25173759	.	T	C	6	7	13	0	4	17	0	0
15	25173877	.	C	T	2	3	5	1	0	6	0	0
15	25173898	.	G	A	5	2	7	1	0	8	0	0
15	25173920	.	G	A	4	2	6	0	0	6	0	0
15	25174048	.	C	A	0	4	4	0	4	8	0	0
15	25174634	.	G	A	3	3	6	0	1	7	0	0
15	25174998	.	T	A	2	2	4	0	1	5	0	0
15	25175354	.	G	C	4	4	8	0	0	8	0	0
15	25175621	.	A	G	2	3	5	0	0	5	0	0
15	25175811	.	A	C	4	5	9	0	1	10	0	0
15	25176075	.	C	T	8	4	12	0	1	13	0	0
15	25176191	.	G	C	4	0	4	0	5	9	0	0
15	25176527	.	C	T	2	8	10	0	4	14	0	0
15	25214384	.	A	G	11	7	18	0	1	19	0	0
15	25238885	.	G	A	1	3	4	0	0	4	0	0
15	25238903	.	G	A	1	2	3	0	0	3	0	0
15	25239148	.	T	C	3	2	5	0	0	5	0	0
15	25267804	.	G	A	2	6	8	0	0	8	0	0
15	25273187	.	C	T	18	14	32	0	0	32	0	0
15	25274918	.	T	G	19	20	39	0	0	39	0	0
15	25278986	.	A	G	21	13	34	0	0	34	0	0
15	25281387	.	G	A	7	10	17	0	1	18	0	0
15	25283846	.	A	C	10	0	10	0	8	18	0	0
15	25283963	.	A	G	12	7	19	0	0	19	0	0
15	25304678	.	C	A	13	11	24	0	1	25	0	0
15	25321973	.	G	A	11	6	17	0	1	18	0	0
15	25321982	.	A	C	8	10	18	0	0	18	0	0
15	25322410	.	C	A	0	7	7	0	12	19	0	0
15	25322607	.	T	G	15	13	28	0	2	30	0	0
15	25322783	.	G	A	5	14	19	0	3	23	1	0
15	25322853	.	C	T	11	9	20	0	1	21	0	0
15	25323064	.	G	C	11	5	16	0	1	17	0	0
15	25333922	.	C	T	1	8	9	0	4	13	0	0
15	25344998	.	G	A	4	2	6	0	0	6	0	0
15	25345523	.	C	T	1	2	3	0	0	3	0	0
15	25346772	.	G	A	2	3	5	0	0	5	0	0
15	25346775	.	G	A	2	2	4	0	0	4	0	0
15	25376190	.	T	C	2	4	6	0	0	6	0	0
15	25376212	.	T	G	3	4	7	0	0	7	0	0
15	25376332	.	A	T	5	3	8	0	1	9	0	0
15	25376673	.	G	C	4	2	6	0	0	6	0	0
15	25376674	.	C	T	0	2	2	0	4	6	0	0
15	25376842	.	A	G	0	2	2	0	2	4	0	0
15	25377137	.	C	T	3	6	9	0	4	13	0	0
15	25377155	.	C	T	1	6	7	0	6	13	0	0
15	25377218	.	C	A	2	5	7	0	0	7	0	0
15	25388120	.	C	T	4	5	9	0	0	9	0	0
15	25398216	.	G	T	6	3	9	0	0	9	0	0
15	25399414	.	A	G	0	2	2	0	1	3	0	0
15	25399436	.	T	A	2	2	4	0	0	4	0	0
15	25400018	.	A	G	5	10	15	0	1	16	0	0
15	25484052	.	A	G	4	5	9	0	1	10	0	0
15	25485278	.	A	G	0	4	4	0	1	5	0	0
15	25485300	.	A	G	5	3	8	0	0	8	0	0
15	25485802	.	A	G	6	3	9	0	0	9	0	0
15	25492912	.	G	A	0	3	3	0	3	6	0	0
15	25498515	.	G	T	0	2	2	0	6	8	0	0
15	25498645	.	G	C	0	8	8	0	6	14	0	0
15	25498718	.	C	A	4	2	6	0	0	6	0	0
15	25498946	.	C	T	7	6	13	0	0	13	0	0
15	25504064	.	A	G	1	2	3	0	0	3	0	0
15	25504397	.	A	C	5	0	5	1	5	11	0	0
15	25504399	.	T	A	5	5	10	1	1	12	0	0
15	25507942	.	A	T	5	6	11	0	0	11	0	0
15	25509414	.	C	A	0	5	5	0	4	9	0	0
15	25509498	.	G	A	4	4	8	0	1	9	0	0
15	25509500	.	C	T	0	5	5	0	4	9	0	0
15	25510372	.	G	T	5	3	8	0	0	8	0	0
15	25517116	.	C	T	2	2	4	0	0	4	0	0
15	25528359	.	C	A	3	2	5	0	0	5	0	0
15	25532175	.	C	T	2	2	4	0	0	4	0	0
15	25532219	.	C	T	3	2	5	0	0	5	0	0
15	25533270	.	C	G	3	1	4	0	0	4	0	0
15	25533279	.	A	T	2	2	4	0	0	4	0	0
15	25533361	.	T	A	2	2	4	0	1	5	0	0
15	25533363	.	T	C	2	2	4	0	1	5	0	0
15	25534200	.	T	C	3	2	5	0	0	5	0	0
15	25537641	.	C	A	2	6	8	0	1	9	0	0
15	25537860	.	C	A	8	7	15	0	1	16	0	0
15	25538178	.	A	G	11	11	22	0	0	22	0	0
15	25538381	.	T	C	7	6	13	0	0	13	0	0
15	25538793	.	G	A	0	7	7	0	8	15	0	0
15	25578053	.	G	A	1	3	4	0	0	4	0	0
15	25578104	.	T	A	1	2	3	0	0	3	0	0
15	25588805	.	A	G	15	12	27	0	0	27	0	0
15	25588836	.	A	C	22	10	32	0	0	32	0	0
15	25588840	.	T	C	23	0	23	0	8	31	0	0
15	25589119	.	G	T	16	7	23	0	0	23	0	0
15	25589197	.	T	A	20	17	37	0	1	38	0	0
15	25589280	.	G	T	15	23	38	0	0	38	0	0
15	25589438	.	C	G	17	17	34	0	0	34	0	0
15	25589582	.	G	C	15	12	27	0	1	28	0	0
15	25589624	.	C	T	12	16	28	0	3	31	0	0
15	25589640	.	T	C	11	15	26	0	3	29	0	0
15	25589708	.	A	G	23	11	34	0	0	34	0	0
15	25589812	.	A	T	15	13	28	0	1	29	0	0
15	25589838	.	A	G	12	15	27	0	1	28	0	0
15	25589979	.	T	A	11	10	21	0	1	22	0	0
15	25589983	.	C	T	11	9	20	0	1	21	0	0
15	25590022	.	A	G	5	15	20	0	0	20	0	0
15	25590129	.	A	G	12	17	29	0	1	30	0	0
15	25590155	.	T	C	15	17	32	0	1	33	0	0
15	25590235	.	A	G	10	3	13	0	1	14	0	0
15	25590240	.	A	G	10	4	14	0	1	15	0	0
15	25590297	.	A	G	9	11	20	0	0	20	0	0
15	25590394	.	T	A	7	11	18	0	1	19	0	0
15	25590474	.	G	A	9	17	26	0	1	27	0	0
15	25590585	.	G	T	11	12	23	0	0	23	0	0
15	25590820	.	A	G	10	11	21	0	1	22	0	0
15	25591541	.	A	T	15	15	30	0	1	31	0	0
15	25591553	.	A	C	12	11	23	1	2	26	0	0
15	25591807	.	C	G	10	13	23	0	0	23	0	0
15	25591820	.	A	T	5	11	16	0	3	19	0	0
15	25591846	.	A	G	4	11	15	0	0	15	0	0
15	25592064	.	C	T	3	4	7	0	0	7	0	0
15	25592080	.	C	T	1	4	5	0	4	9	0	0
15	25592126	.	C	G	6	4	10	0	0	10	0	0
15	25592606	.	T	A	4	2	6	0	0	6	0	0
15	25593057	.	T	C	2	2	4	0	0	4	0	0
15	25593067	.	A	G	2	2	4	0	0	4	0	0
15	25593187	.	T	G	7	3	10	0	0	10	0	0
15	25594091	.	A	G	7	7	14	0	0	14	0	0
15	25594214	.	A	C	2	7	9	0	0	9	0	0
15	25594345	.	C	T	0	7	7	0	2	9	0	0
15	25594511	.	G	C	1	0	1	0	8	9	0	0
15	25594810	.	A	C	4	3	7	0	0	7	0	0
15	25595120	.	T	A	1	2	3	0	0	3	0	0
15	25595187	.	T	C	4	3	7	0	0	7	0	0
15	25595350	.	T	A	3	2	5	0	0	5	0	0
15	25595352	.	A	T	3	2	5	0	0	5	0	0
15	25595702	.	T	C	12	5	17	0	1	18	0	0
15	25598873	.	T	A	5	3	8	0	0	8	0	0
15	25598963	.	G	A	6	7	13	0	1	14	0	0
15	25599071	.	C	T	7	8	15	0	1	16	0	0
15	25602628	.	G	A	3	3	6	0	0	6	0	0
15	25602843	.	T	C	5	4	9	0	0	9	0	0
15	25602846	.	G	A	5	4	9	0	0	9	0	0
15	25602915	.	A	G	5	2	7	0	0	7	0	0
15	25603017	.	G	A	3	6	9	0	0	9	0	0
15	25605041	.	A	G	4	3	7	0	0	7	0	0
15	25635424	.	C	T	6	8	14	0	0	14	0	0
15	25638600	.	G	A	3	2	5	0	0	5	0	0
15	25640533	.	T	C	1	4	5	0	0	5	0	0
15	25640540	.	A	G	1	0	1	0	4	5	0	0
15	25641002	.	C	G	2	2	4	0	0	4	0	0
15	25649944	.	G	A	5	7	12	0	0	12	0	0
15	25649959	.	G	A	3	6	9	0	1	10	0	0
15	25650100	.	T	G	8	3	11	0	1	12	0	0
15	25653349	.	A	G	3	5	8	0	0	8	0	0
15	25656103	.	C	T	7	4	11	0	2	13	0	0
15	25656175	.	A	G	10	6	16	0	0	16	0	0
15	25910573	.	A	G	1	4	5	0	0	5	0	0
15	25910655	.	A	C	4	2	6	0	0	6	0	0
15	25910696	.	G	A	6	3	9	0	0	9	0	0
15	26400117	.	C	T	5	3	8	0	0	8	0	0
15	26400297	.	G	C	6	5	11	0	0	11	0	0
15	26400300	.	A	C	5	5	10	0	1	11	0	0
15	26400743	.	T	G	3	7	10	0	0	10	0	0
15	26400766	.	A	G	10	6	16	0	0	16	0	0
15	26400819	.	A	G	13	9	22	0	2	24	0	0
15	26400836	.	G	A	16	9	25	0	2	27	0	0
15	26400876	.	G	A	14	11	25	0	1	26	0	0
15	26400900	.	C	T	14	7	21	0	3	24	0	0
15	26400924	.	A	T	11	6	17	0	1	18	0	0
15	26401101	.	A	G	11	7	18	0	1	19	0	0
15	26401194	.	T	G	8	10	18	0	0	18	0	0
15	26401200	.	C	T	7	9	16	0	0	16	0	0
15	26401259	.	A	C	5	2	7	0	0	7	0	0
15	26401623	.	A	T	14	9	23	0	1	24	0	0
15	26401779	.	A	G	8	15	23	0	1	24	0	0
15	26401880	.	A	T	3	4	7	0	1	8	0	0
15	26401888	.	G	C	4	2	6	0	1	7	0	0
15	26402167	.	G	A	16	8	24	0	0	24	0	0
15	26498455	.	A	T	3	9	12	0	2	14	0	0
15	26498615	.	C	T	7	12	19	0	1	20	0	0
15	26498621	.	C	A	7	14	21	0	0	21	0	0
15	26498716	.	A	G	16	8	24	0	1	25	0	0
15	26498749	.	A	T	19	14	33	0	2	35	0	0
15	26498820	.	T	G	7	20	27	0	1	28	0	0
15	26505495	.	C	A	12	8	20	0	1	21	0	0
15	26515021	.	C	T	0	9	9	0	10	19	0	0
15	26534203	.	G	A	3	3	6	0	0	6	0	0
15	26538874	.	A	G	5	6	11	0	1	12	0	0
15	26538885	.	G	A	5	6	11	0	0	11	0	0
15	26553093	.	A	T	7	6	13	0	1	14	0	0
15	26553095	.	T	C	6	7	13	0	0	13	0	0
15	26554008	.	G	A	1	4	5	0	0	5	0	0
15	26554014	.	A	T	1	5	6	0	0	6	0	0
15	26554516	.	T	A	1	2	3	0	0	3	0	0
15	26554686	.	G	A	7	4	11	0	0	11	0	0
15	26554939	.	T	C	2	0	2	0	7	9	0	0
15	26561347	.	G	A	3	3	6	0	0	6	0	0
15	26561407	.	C	G	6	9	15	0	0	15	0	0
15	26561468	.	C	T	4	5	9	0	0	9	0	0
15	26561502	.	T	C	5	4	9	0	0	9	0	0
15	26561526	.	C	T	0	3	3	0	2	5	0	0
15	26561610	.	A	T	2	4	6	0	0	6	0	0
15	26564531	.	G	C	1	2	3	0	0	3	0	0
15	26616188	.	T	C	3	0	3	0	3	6	0	0
15	26678917	.	C	A	1	6	7	0	5	12	0	0
15	26678932	.	T	A	2	7	9	0	1	10	0	0
15	26679070	.	T	A	4	6	10	0	0	10	0	0
15	26679374	.	C	T	2	5	7	0	0	7	0	0
15	26679908	.	C	T	0	11	11	0	4	15	0	0
15	26680080	.	G	C	5	4	9	0	3	12	0	0
15	26683504	.	A	G	5	8	13	0	0	13	0	0
15	26683758	.	G	A	5	11	16	0	0	16	0	0
15	26683764	.	G	A	12	5	17	0	0	17	0	0
15	26686828	.	A	T	3	2	5	0	2	31	24	0
15	26699885	.	G	A	2	4	6	1	0	7	0	0
15	26707518	.	G	A	6	2	8	0	0	8	0	0
15	26707569	.	G	T	4	7	11	0	0	11	0	0
15	26710306	.	G	A	3	6	9	0	0	9	0	0
15	26720581	.	C	T	1	3	4	0	9	13	0	0
15	26729480	.	G	A	2	3	5	0	1	6	0	0
15	26844074	.	T	G	1	2	3	0	0	3	0	0
15	26844077	.	A	T	1	2	3	0	0	3	0	0
15	26849102	.	T	A	0	4	4	0	1	5	0	0
15	26849637	.	A	G	3	2	5	0	0	5	0	0
15	26850193	.	A	G	2	3	5	0	0	5	0	0
15	26855159	.	T	G	2	2	4	0	1	5	0	0
15	26873946	.	G	A	2	3	5	0	0	5	0	0
15	26877241	.	A	G	1	2	3	0	0	3	0	0
15	26879475	.	C	T	0	2	2	0	1	3	0	0
15	26880427	.	G	T	3	3	6	0	0	6	0	0
15	26885254	.	T	C	1	2	3	0	1	4	0	0
15	26885449	.	C	T	5	2	7	0	0	7	0	0
15	26904430	.	A	G	3	4	7	0	1	8	0	0
15	26904779	.	G	A	2	4	6	0	1	7	0	0
15	26904838	.	A	G	3	4	7	0	0	7	0	0
15	26904942	.	C	A	0	3	3	0	4	7	0	0
15	26904989	.	C	A	2	4	6	1	0	7	0	0
15	26905002	.	C	T	1	4	5	1	0	6	0	0
15	26905088	.	A	G	10	7	17	0	0	17	0	0
15	26905118	.	T	G	6	5	11	0	1	12	0	0
15	26915384	.	T	A	9	6	15	0	2	17	0	0
15	26915531	.	A	G	10	9	19	0	1	20	0	0
15	26915568	.	G	A	11	9	20	0	1	21	0	0
15	26915633	.	C	T	7	9	16	0	0	16	0	0
15	26915651	.	T	C	5	12	17	0	0	17	0	0
15	26919255	.	T	C	13	10	23	0	1	24	0	0
15	26921873	.	T	C	6	5	11	0	1	12	0	0
15	26922139	.	A	G	6	8	14	0	0	14	0	0
15	26922162	.	T	G	7	5	12	0	0	12	0	0
15	26924056	.	T	C	9	9	18	0	0	18	0	0
15	26924080	.	C	G	1	3	4	0	8	12	0	0
15	26935696	.	G	A	4	7	11	0	1	12	0	0
15	26938324	.	A	C	9	11	20	0	0	20	0	0
15	26939031	.	C	A	6	7	13	0	1	14	0	0
15	26939224	.	G	T	8	5	13	0	0	13	0	0
15	26939233	.	A	C	5	7	12	0	1	13	0	0
15	26939279	.	G	A	0	4	4	0	7	11	0	0
15	26941892	.	G	A	0	4	4	0	1	5	0	0
15	26961861	.	G	A	0	4	4	0	3	7	0	0
15	27071096	.	C	G	5	2	7	0	1	8	0	0
15	27071099	.	A	G	5	3	8	0	1	9	0	0
15	27071735	.	G	A	6	6	12	0	0	12	0	0
15	27071792	.	T	G	8	6	14	0	3	17	0	0
15	27071849	.	G	A	4	6	10	0	1	11	0	0
15	27087813	.	C	T	7	5	12	0	3	15	0	0
15	27328142	.	T	G	4	0	4	0	4	8	0	0
15	27352608	.	G	A	5	2	7	0	0	7	0	0
15	27353222	.	T	A	2	2	4	1	0	5	0	0
15	27353481	.	G	A	8	7	15	0	1	16	0	0
15	27353950	.	T	C	4	2	6	0	1	7	0	0
15	27354412	.	T	A	20	12	32	0	0	32	0	0
15	27410602	.	T	A	1	2	3	0	0	3	0	0
15	27410605	.	A	G	1	0	1	0	2	3	0	0
15	27703845	.	A	G	12	21	33	0	0	33	0	0
15	27704220	.	C	A	2	12	14	0	20	34	0	0
15	28079204	.	A	C	2	0	2	0	2	4	0	0
15	28079214	.	A	G	2	2	4	0	0	4	0	0
15	28079249	.	A	T	2	4	6	0	0	6	0	0
15	28079317	.	T	A	2	4	6	0	0	7	1	0
15	28079848	.	C	T	0	3	3	0	3	6	0	0
15	28085382	.	T	C	2	3	5	0	0	5	0	0
15	28106804	.	A	G	1	4	5	0	1	6	0	0
15	28124642	.	C	T	5	7	12	0	1	13	0	0
15	28125146	.	A	G	3	1	4	0	6	10	0	0
15	28125186	.	A	G	4	6	10	0	0	10	0	0
15	28175898	.	G	A	1	1	2	0	1	3	0	0
15	28182837	.	A	G	1	2	3	0	0	3	0	0
15	28189029	.	T	A	7	6	13	0	1	14	0	0
15	28189046	.	T	G	9	7	16	0	2	18	0	0
15	28189409	.	A	C	2	6	8	0	1	9	0	0
15	28189589	.	T	C	8	0	8	0	14	22	0	0
15	28189591	.	T	C	9	11	20	0	2	22	0	0
15	28189945	.	T	G	6	17	23	0	3	26	0	0
15	28192706	.	A	G	6	12	18	0	2	20	0	0
15	28194669	.	T	C	3	10	13	0	1	14	0	0
15	28194708	.	A	G	5	6	11	0	0	11	0	0
15	28195515	.	A	T	5	6	11	0	1	12	0	0
15	28199233	.	G	A	1	2	3	0	0	3	0	0
15	28199437	.	A	T	4	2	6	0	0	6	0	0
15	28199574	.	T	C	2	4	6	0	1	7	0	0
15	28199905	.	T	G	2	3	5	0	0	5	0	0
15	28199912	.	T	C	3	2	5	0	0	5	0	0
15	28230658	.	A	G	2	5	7	0	1	8	0	0
15	28230738	.	G	A	1	4	5	0	0	5	0	0
15	28247443	.	A	C	3	2	5	0	0	5	0	0
15	28249301	.	G	T	6	2	8	0	0	8	0	0
15	28251094	.	T	A	18	19	37	0	2	39	0	0
15	28252597	.	T	C	9	8	17	0	4	21	0	0
15	28252599	.	A	G	11	9	20	0	1	21	0	0
15	28253171	.	C	A	1	8	9	0	15	24	0	0
15	28253522	.	C	T	5	4	9	0	0	10	1	0
15	28253773	.	C	T	5	6	11	0	0	11	0	0
15	28254184	.	T	C	5	4	9	0	2	11	0	0
15	28254202	.	G	T	6	6	12	0	2	14	0	0
15	28260031	.	A	G	4	2	6	0	0	6	0	0
15	28260381	.	A	T	2	3	5	0	0	5	0	0
15	28343332	.	A	G	2	5	7	0	0	7	0	0
15	28343667	.	C	T	4	5	9	0	0	9	0	0
15	28349816	.	C	T	3	3	6	0	0	6	0	0
15	28350079	.	C	G	7	4	11	0	0	11	0	0
15	28350095	.	C	T	6	5	11	0	0	11	0	0
15	28350923	.	A	T	1	3	4	0	0	4	0	0
15	28350968	.	A	G	5	2	7	0	0	7	0	0
15	28351132	.	G	A	5	3	8	0	0	8	0	0
15	28351375	.	A	T	4	2	6	0	0	6	0	0
15	28351381	.	G	C	5	2	7	0	0	7	0	0
15	28352138	.	T	C	13	9	22	0	0	22	0	0
15	28352168	.	C	A	14	7	21	0	0	21	0	0
15	28392769	.	G	T	2	2	4	0	0	4	0	0
15	28403365	.	C	T	5	6	11	0	0	11	0	0
15	28432697	.	C	A	11	17	28	0	1	29	0	0
15	28432739	.	C	T	15	12	27	0	0	27	0	0
15	28432741	.	A	T	13	12	25	0	1	26	0	0
15	28432871	.	T	C	11	6	17	0	1	18	0	0
15	28432993	.	C	T	1	12	13	0	13	26	0	0
15	28433073	.	A	G	10	11	21	0	1	22	0	0
15	28433102	.	C	A	10	12	22	0	0	22	0	0
15	28433126	.	G	T	8	10	18	0	0	18	0	0
15	28433161	.	T	C	4	8	12	0	0	12	0	0
15	28433282	.	G	A	7	13	20	0	3	23	0	0
15	28433414	.	T	A	10	2	12	0	1	13	0	0
15	28433947	.	A	G	11	17	28	0	0	28	0	0
15	28439441	.	G	A	10	9	19	0	1	20	0	0
15	28446791	.	A	T	2	4	6	0	1	7	0	0
15	28452844	.	A	G	10	5	15	0	0	15	0	0
15	28453081	.	C	A	1	5	6	0	8	14	0	0
15	28453102	.	C	T	9	6	15	0	1	16	0	0
15	28463609	.	C	T	0	3	3	0	6	9	0	0
15	28483333	.	A	C	4	2	6	0	0	6	0	0
15	28509840	.	G	A	7	4	11	0	0	11	0	0
15	28515428	.	C	A	3	3	6	0	0	6	0	0
15	28526386	.	A	T	6	7	13	0	3	16	0	0
15	28537810	.	T	A	5	6	11	0	1	12	0	0
15	28537852	.	T	C	8	5	13	0	1	14	0	0
15	28537872	.	G	A	1	6	7	0	8	15	0	0
15	28537906	.	A	C	7	4	11	0	0	11	0	0
15	28537965	.	T	A	4	4	8	0	0	8	0	0
15	28538012	.	G	A	3	4	7	0	4	11	0	0
15	28538173	.	G	A	10	4	14	0	0	14	0	0
15	28538199	.	T	C	8	3	11	0	0	11	0	0
15	28538239	.	G	T	8	3	11	0	0	11	0	0
15	28538405	.	T	C	8	8	16	0	0	16	0	0
15	28538602	.	A	T	5	4	9	0	1	10	0	0
15	28538605	.	G	A	3	3	6	0	5	12	1	0
15	28538667	.	A	G	5	3	8	0	1	9	0	0
15	28538761	.	A	G	8	8	16	0	1	17	0	0
15	28538765	.	C	T	9	8	17	0	0	17	0	0
15	28539022	.	C	A	7	8	15	0	0	15	0	0
15	28539112	.	C	T	7	4	11	0	0	11	0	0
15	28539232	.	C	T	6	4	10	0	0	10	0	0
15	28539381	.	A	T	8	4	12	0	0	12	0	0
15	28539383	.	A	T	8	4	12	0	0	12	0	0
15	28539523	.	T	C	13	7	20	0	0	20	0	0
15	28539556	.	G	A	15	7	22	0	0	22	0	0
15	28539595	.	A	G	10	0	10	0	6	16	0	0
15	28539607	.	A	G	4	9	13	0	4	17	0	0
15	28539649	.	T	A	9	11	20	0	0	20	0	0
15	28549003	.	G	A	3	8	11	0	0	11	0	0
15	28549347	.	G	T	6	6	12	0	0	12	0	0
15	28549348	.	T	A	6	6	12	0	0	12	0	0
15	28549392	.	A	C	7	5	12	0	0	12	0	0
15	28549965	.	G	C	3	3	6	0	0	6	0	0
15	28550088	.	A	G	2	2	4	0	0	4	0	0
15	28551498	.	A	G	3	2	5	0	0	5	0	0
15	28552415	.	G	C	1	2	3	0	0	3	0	0
15	28609097	.	G	A	6	6	12	0	0	12	0	0
15	28634719	.	G	A	11	8	19	0	1	20	0	0
15	28646687	.	G	A	5	12	17	0	1	18	0	0
15	28646696	.	T	C	8	0	8	0	12	20	0	0
15	28646886	.	G	A	9	4	13	0	0	13	0	0
15	28646931	.	C	G	10	7	17	0	0	17	0	0
15	28677558	.	T	A	6	4	10	0	0	10	0	0
15	28686433	.	A	T	12	11	23	0	0	23	0	0
15	28758907	.	G	C	1	9	10	0	14	24	0	0
15	28758988	.	C	T	14	6	20	0	3	23	0	0
15	28759171	.	T	G	17	0	17	0	17	34	0	0
15	28759246	.	G	C	2	10	12	0	14	26	0	0
15	28759558	.	C	G	7	0	7	0	12	19	0	0
15	28759639	.	G	A	9	5	14	0	1	15	0	0
15	28759873	.	A	C	7	2	9	0	32	41	0	0
15	28760090	.	T	C	19	18	37	0	1	38	0	0
15	28760675	.	A	T	22	14	36	0	0	36	0	0
15	28761031	.	T	C	14	10	24	0	1	25	0	0
15	28761173	.	T	C	19	10	29	0	0	29	0	0
15	28761284	.	T	A	15	13	28	0	5	33	0	0
15	28762440	.	C	T	18	23	41	0	1	42	0	0
15	28763124	.	T	C	13	24	37	1	5	43	0	0
15	28763134	.	T	C	15	22	37	1	2	40	0	0
15	28763677	.	C	A	23	18	41	0	0	41	0	0
15	28763770	.	T	C	22	27	49	0	1	50	0	0
15	28763927	.	G	A	1	29	30	0	19	49	0	0
15	28763986	.	G	A	3	21	24	0	23	47	0	0
15	28764206	.	G	T	2	13	15	0	28	43	0	0
15	28764252	.	A	G	28	0	28	0	27	55	0	0
15	28766069	.	A	G	5	6	11	0	1	12	0	0
15	28787262	.	T	A	1	2	3	0	0	3	0	0
15	28802136	.	A	T	3	3	6	0	0	6	0	0
15	28881717	.	G	A	21	5	26	0	2	28	0	0
15	28882675	.	T	A	15	10	25	0	0	25	0	0
15	28882687	.	A	G	14	10	24	0	0	24	0	0
15	28886531	.	G	C	5	7	12	0	1	13	0	0
15	28886882	.	A	T	5	6	11	0	0	11	0	0
15	28887280	.	G	T	9	7	16	0	0	16	0	0
15	28887667	.	A	G	4	3	7	0	0	7	0	0
15	28960057	.	T	C	2	2	4	0	0	4	0	0
15	28973434	.	C	A	2	2	4	0	0	4	0	0
15	29000989	.	C	T	12	8	20	0	1	21	0	0
15	29001556	.	C	T	17	15	32	1	0	33	0	0
15	29001583	.	T	C	20	16	36	1	2	39	0	0
15	29004485	.	A	G	24	19	43	0	5	48	0	0
15	29005346	.	T	A	16	20	36	0	2	38	0	0
15	29005363	.	A	C	9	15	24	0	4	28	0	0
15	29005564	.	T	G	16	10	26	0	0	26	0	0
15	29005600	.	A	C	21	9	30	0	0	30	0	0
15	29005862	.	T	A	15	10	25	0	5	30	0	0
15	29005869	.	A	T	17	12	29	0	0	29	0	0
15	29005935	.	C	T	23	16	39	0	1	40	0	0
15	29005984	.	C	T	23	10	33	0	0	33	0	0
15	29005996	.	C	A	20	9	29	0	0	29	0	0
15	29006097	.	C	T	23	18	41	0	0	41	0	0
15	29006142	.	G	A	1	21	22	0	26	48	0	0
15	29089143	.	T	A	24	17	41	0	1	42	0	0
15	29089279	.	C	A	16	23	39	0	4	43	0	0
15	29089317	.	A	G	27	17	44	0	0	44	0	0
15	29089392	.	A	G	21	12	33	0	2	35	0	0
15	29089524	.	T	C	20	29	49	0	3	52	0	0
15	29089788	.	G	A	27	22	49	0	2	51	0	0
15	29089827	.	G	T	3	31	34	0	21	55	0	0
15	29089870	.	C	T	26	33	59	0	4	63	0	0
15	29090181	.	A	G	26	28	54	0	8	62	0	0
15	29091565	.	G	A	29	22	51	0	2	53	0	0
15	29092871	.	C	T	2	5	7	0	0	7	0	0
15	29093073	.	C	A	4	6	10	0	0	10	0	0
15	29097468	.	T	C	18	14	32	0	3	35	0	0
15	29097640	.	A	G	17	15	32	0	2	34	0	0
15	29100574	.	T	G	8	4	12	0	1	13	0	0
15	29100623	.	G	A	10	5	15	2	1	18	0	0
15	29100934	.	C	G	11	12	23	0	1	24	0	0
15	29104050	.	G	A	8	4	12	0	0	12	0	0
15	29106691	.	T	C	2	5	7	0	1	8	0	0
15	29108812	.	T	C	3	3	6	0	0	6	0	0
15	29108872	.	A	G	4	6	10	0	0	10	0	0
15	29108896	.	A	G	3	4	7	0	0	7	0	0
15	29111682	.	T	C	5	0	5	0	7	12	0	0
15	29111902	.	A	C	6	0	6	0	6	12	0	0
15	29111969	.	C	T	3	5	8	0	0	8	0	0
15	29111970	.	T	C	2	5	7	0	1	8	0	0
15	29114289	.	C	A	4	3	7	0	2	9	0	0
15	29114337	.	C	G	0	6	6	0	3	9	0	0
15	29114361	.	A	T	2	5	7	0	0	7	0	0
15	29116177	.	T	C	7	8	15	0	0	15	0	0
15	29116264	.	A	G	7	18	25	0	1	26	0	0
15	29116658	.	C	G	14	14	28	0	0	28	0	0
15	29116659	.	A	G	14	14	28	0	0	28	0	0
15	29119813	.	A	C	7	17	24	0	0	24	0	0
15	29119829	.	A	C	12	17	29	0	1	30	0	0
15	29122072	.	T	A	18	12	30	0	3	33	0	0
15	29123085	.	G	T	1	2	3	0	0	3	0	0
15	29136127	.	A	T	7	4	11	0	1	12	0	0
15	29148674	.	T	C	3	2	5	0	0	5	0	0
15	29148675	.	T	G	3	0	3	0	2	5	0	0
15	29149292	.	C	T	6	7	13	0	0	13	0	0
15	29152041	.	G	T	5	4	9	0	0	9	0	0
15	29294445	.	C	T	3	3	6	0	0	6	0	0
15	29297752	.	G	A	3	2	5	0	0	5	0	0
15	29311995	.	G	C	0	2	2	0	2	4	0	0
15	29312303	.	C	A	4	5	9	0	1	10	0	0
15	29312333	.	T	C	3	4	7	0	0	7	0	0
15	29312748	.	T	C	4	2	6	0	1	7	0	0
15	29312763	.	C	T	4	3	7	0	0	7	0	0
15	29316875	.	A	G	5	1	6	0	1	7	0	0
15	29316909	.	A	G	3	1	4	0	1	5	0	0
15	29316951	.	C	A	5	3	8	0	0	8	0	0
15	29317007	.	G	A	3	2	5	0	1	6	0	0
15	29343748	.	A	G	1	3	4	0	0	4	0	0
15	29343863	.	A	G	1	6	7	0	0	7	0	0
15	29344440	.	G	T	2	3	5	0	0	5	0	0
15	29393763	.	C	T	3	2	5	0	0	5	0	0
15	29454352	.	G	A	8	7	15	0	0	15	0	0
15	29456387	.	A	G	6	8	14	0	1	15	0	0
15	29456410	.	C	T	10	6	16	0	2	18	0	0
15	29459013	.	A	G	8	7	15	0	0	15	0	0
15	29459046	.	G	A	2	7	9	0	1	10	0	0
15	29465874	.	T	C	5	7	12	0	0	13	1	0
15	29467216	.	T	A	13	7	20	0	3	23	0	0
15	29467254	.	A	G	15	0	15	0	7	22	0	0
15	29467339	.	A	G	8	12	20	0	0	20	0	0
15	29469851	.	G	T	7	12	19	0	1	20	0	0
15	29481884	.	A	G	12	15	27	0	1	28	0	0
15	29481921	.	G	A	1	12	13	0	14	27	0	0
15	29482286	.	G	C	12	11	23	0	0	23	0	0
15	29482439	.	A	G	13	6	19	0	0	19	0	0
15	29483095	.	T	G	5	2	7	0	1	8	0	0
15	29483236	.	T	G	8	11	19	0	0	19	0	0
15	29483326	.	G	A	0	3	3	0	3	6	0	0
15	29483434	.	G	C	14	10	24	0	0	24	0	0
15	29483608	.	A	T	13	5	18	0	3	21	0	0
15	29483815	.	C	A	22	4	26	0	4	30	0	0
15	29483851	.	G	T	24	10	34	0	1	35	0	0
15	29549217	.	A	G	2	5	7	0	0	7	0	0
15	29549677	.	T	A	6	5	11	0	0	11	0	0
15	29549804	.	C	T	1	5	6	0	3	9	0	0
15	29555569	.	G	T	4	2	6	0	0	6	0	0
15	29556667	.	T	C	3	3	6	0	0	6	0	0
15	29709048	.	G	T	2	2	4	0	0	4	0	0
15	29710305	.	T	C	4	3	7	0	0	7	0	0
15	29710737	.	G	T	4	4	8	0	0	8	0	0
15	29712127	.	C	A	9	6	15	0	0	15	0	0
15	29712210	.	G	A	0	11	11	0	7	18	0	0
15	29712221	.	C	T	5	13	18	0	2	20	0	0
15	29712405	.	G	A	10	5	15	0	1	16	0	0
15	29772299	.	T	A	2	5	7	0	0	7	0	0
15	29773434	.	T	C	2	0	2	0	4	6	0	0
15	29775134	.	A	G	3	2	5	0	3	8	0	0
15	29889577	.	G	A	2	3	5	0	0	5	0	0
15	29889709	.	C	T	0	2	2	0	2	4	0	0
15	30127451	.	T	C	3	5	8	0	0	8	0	0
15	30130530	.	A	C	4	3	7	0	0	7	0	0
15	30130664	.	G	A	0	5	5	0	6	11	0	0
15	30131482	.	G	A	4	5	9	0	1	10	0	0
15	30131585	.	C	T	5	6	11	0	0	11	0	0
15	30134489	.	G	A	7	7	14	0	0	14	0	0
15	30134679	.	C	G	4	6	10	0	0	10	0	0
15	30135016	.	T	A	6	5	11	0	0	11	0	0
15	30135206	.	G	A	0	7	7	0	7	14	0	0
15	30135300	.	A	T	11	9	20	0	3	23	0	0
15	30135572	.	A	G	7	0	7	0	9	16	0	0
15	30135920	.	A	G	9	4	13	0	0	13	0	0
15	30136472	.	A	G	1	2	3	0	0	3	0	0
15	30136512	.	T	A	2	4	6	0	1	7	0	0
15	30136962	.	A	G	12	0	12	0	16	28	0	0
15	30137561	.	C	T	13	12	25	0	0	25	0	0
15	30157713	.	A	G	6	0	6	0	4	10	0	0
15	30158096	.	G	T	0	11	11	0	5	16	0	0
15	30159050	.	A	T	6	3	9	0	0	9	0	0
15	30252414	.	T	C	6	6	12	0	0	12	0	0
15	30265017	.	C	T	10	12	22	0	1	23	0	0
15	30300771	.	A	C	3	1	4	0	11	15	0	0
15	30301196	.	G	A	1	4	5	0	8	13	0	0
15	30301239	.	G	A	0	5	5	0	1	6	0	0
15	30301320	.	T	C	6	11	17	0	1	18	0	0
15	30301447	.	G	A	7	7	14	0	0	14	0	0
15	30301474	.	G	A	4	6	10	0	1	11	0	0
15	30311016	.	C	T	6	7	13	0	0	13	0	0
15	30311062	.	G	T	1	7	8	0	5	13	0	0
15	30311616	.	T	G	6	10	16	0	0	16	0	0
15	30354513	.	G	T	5	5	10	0	0	10	0	0
15	30354603	.	A	T	4	6	10	0	0	10	0	0
15	30424673	.	C	T	0	10	10	0	6	16	0	0
15	30425704	.	T	C	1	2	3	1	1	5	0	0
15	30425705	.	C	T	0	2	2	1	2	5	0	0
15	30425936	.	G	A	7	4	11	0	0	11	0	0
15	30838455	.	C	G	3	4	7	0	2	9	0	0
15	30838777	.	G	A	18	14	32	0	2	34	0	0
15	30838867	.	C	T	18	8	26	0	2	28	0	0
15	30839168	.	A	T	11	11	22	0	0	22	0	0
15	30852433	.	G	A	5	4	9	0	1	10	0	0
15	30852598	.	T	C	5	6	11	0	0	11	0	0
15	30853039	.	G	T	6	3	9	0	0	10	1	0
15	30853096	.	T	A	6	6	12	0	1	13	0	0
15	30861987	.	C	A	0	6	6	0	9	15	0	0
15	30862251	.	A	T	5	3	8	0	0	8	0	0
15	30862449	.	A	G	8	4	12	0	2	14	0	0
15	30862452	.	G	T	8	5	13	0	0	13	0	0
15	30862517	.	G	A	7	3	10	0	0	10	0	0
15	30862712	.	G	A	5	12	17	0	3	20	0	0
15	30862785	.	C	T	10	13	23	0	0	23	0	0
15	30862814	.	A	G	10	15	25	0	0	25	0	0
15	30862848	.	T	C	13	7	20	0	2	22	0	0
15	30862997	.	T	G	8	3	11	0	1	12	0	0
15	30863059	.	T	C	8	1	9	0	4	13	0	0
15	30863117	.	T	C	2	5	7	0	0	7	0	0
15	30863123	.	A	C	3	3	6	0	2	8	0	0
15	30863242	.	T	C	4	3	7	0	0	7	0	0
15	30863354	.	C	T	5	4	9	0	1	10	0	0
15	30863535	.	G	T	11	13	24	0	3	27	0	0
15	30863569	.	G	A	19	13	32	0	3	35	0	0
15	30863799	.	T	C	11	0	11	0	8	19	0	0
15	30863834	.	G	T	8	7	15	0	1	16	0	0
15	30863850	.	T	C	8	9	17	0	2	19	0	0
15	30864072	.	T	G	5	7	12	0	0	12	0	0
15	30864308	.	C	A	13	13	26	0	0	26	0	0
15	30864354	.	T	C	10	0	10	0	11	21	0	0
15	30874327	.	A	G	7	13	20	0	0	20	0	0
15	30874387	.	G	A	8	12	20	0	4	24	0	0
15	30883761	.	T	C	4	0	4	0	3	7	0	0
15	30887163	.	G	A	4	3	7	0	0	7	0	0
15	30888274	.	G	A	6	4	10	0	0	10	0	0
15	30889297	.	T	C	1	1	2	0	4	6	0	0
15	30889544	.	T	C	2	2	4	0	1	5	0	0
15	30894361	.	C	A	3	2	5	0	0	5	0	0
15	30900478	.	A	G	1	2	3	0	0	3	0	0
15	30907811	.	A	G	4	11	15	0	0	15	0	0
15	30907818	.	G	A	0	10	10	0	5	15	0	0
15	30907884	.	C	A	7	10	17	0	0	17	0	0
15	30907888	.	A	G	7	0	7	0	11	18	0	0
15	30909175	.	C	G	18	0	18	0	10	28	0	0
15	30909308	.	G	A	0	12	12	0	12	24	0	0
15	30909572	.	C	A	8	16	24	0	0	24	0	0
15	30909639	.	A	G	10	15	25	0	0	25	0	0
15	30909663	.	G	A	7	8	15	0	2	17	0	0
15	30909771	.	T	C	9	11	20	0	0	20	0	0
15	30909798	.	A	G	6	0	6	0	8	14	0	0
15	30909824	.	A	C	6	7	13	0	1	14	0	0
15	30909884	.	C	T	14	8	22	0	1	23	0	0
15	30917750	.	A	T	10	4	14	0	0	14	0	0
15	30919595	.	T	C	14	4	18	0	1	19	0	0
15	30919676	.	G	T	14	8	22	0	1	23	0	0
15	30919784	.	A	G	9	7	16	0	1	17	0	0
15	30919854	.	T	G	9	3	12	0	0	12	0	0
15	30920135	.	A	G	7	4	11	0	1	12	0	0
15	30920242	.	A	C	10	8	18	0	0	18	0	0
15	30920698	.	C	A	11	11	22	0	0	22	0	0
15	30920780	.	T	C	6	3	9	0	0	9	0	0
15	30920795	.	A	G	4	4	8	0	1	9	0	0
15	30924316	.	T	C	1	0	1	0	2	3	0	0
15	31054872	.	T	C	1	2	3	0	0	3	0	0
15	31162074	.	T	A	15	14	29	0	2	31	0	0
15	31162122	.	A	G	21	12	33	0	2	35	0	0
15	31162186	.	G	C	23	13	36	0	1	37	0	0
15	31162795	.	G	A	19	10	29	0	0	29	0	0
15	31162836	.	A	G	15	9	24	0	1	25	0	0
15	31163089	.	G	A	5	12	17	0	1	18	0	0
15	31163148	.	T	A	8	10	18	0	1	19	0	0
15	31163335	.	A	T	19	18	37	0	1	38	0	0
15	31163621	.	T	A	21	22	43	0	0	43	0	0
15	31166755	.	C	A	9	13	22	0	1	23	0	0
15	31166788	.	A	G	13	10	23	0	1	24	0	0
15	31177053	.	A	G	2	3	5	0	1	6	0	0
15	31177054	.	T	A	1	4	5	0	1	6	0	0
15	31177214	.	T	G	12	9	21	0	0	21	0	0
15	31203002	.	A	G	2	7	9	0	0	9	0	0
15	31205723	.	A	G	5	9	14	0	0	14	0	0
15	31206401	.	A	G	1	10	11	0	1	12	0	0
15	31213017	.	T	C	4	0	4	0	3	7	0	0
15	31213046	.	T	G	4	4	8	0	0	8	0	0
15	31237173	.	T	C	1	2	3	0	0	3	0	0
15	31237191	.	T	C	1	1	2	0	0	2	0	0
15	31244298	.	C	T	0	2	2	0	5	7	0	0
15	31244339	.	A	T	3	2	5	0	0	5	0	0
15	31244412	.	C	T	0	6	6	0	2	8	0	0
15	31250527	.	A	T	5	2	7	0	1	8	0	0
15	31513561	.	G	A	24	28	52	0	3	55	0	0
15	31513842	.	A	G	34	31	65	0	3	69	1	0
15	31513848	.	T	C	36	33	69	0	3	72	0	0
15	31513893	.	C	A	3	28	31	0	39	70	0	0
15	31514325	.	A	G	27	36	63	0	0	63	0	0
15	31516046	.	G	A	2	2	4	0	0	4	0	0
15	31564314	.	G	A	4	2	6	0	0	6	0	0
15	31564946	.	T	C	10	4	14	0	2	16	0	0
15	31571496	.	A	G	5	3	8	0	0	8	0	0
15	31574035	.	T	C	1	0	1	0	2	3	0	0
15	31574100	.	T	C	2	0	2	0	3	5	0	0
15	31574119	.	A	G	2	2	4	0	0	4	0	0
15	31580777	.	C	T	1	3	4	0	0	4	0	0
15	31674120	.	G	T	3	4	7	0	1	8	0	0
15	31694928	.	G	A	0	4	4	0	4	8	0	0
15	31700738	.	C	T	3	4	7	0	0	7	0	0
15	31706200	.	G	C	5	5	10	0	0	10	0	0
15	31712529	.	C	T	4	3	7	0	1	8	0	0
15	31732502	.	A	G	8	4	12	1	1	14	0	0
15	31766761	.	T	C	1	2	3	0	0	3	0	0
15	31770141	.	C	A	5	3	8	0	0	8	0	0
15	31772589	.	G	A	1	2	3	0	0	3	0	0
15	31862250	.	T	C	3	2	5	0	0	5	0	0
15	31862320	.	C	T	2	2	4	0	0	4	0	0
15	31866308	.	C	T	1	4	5	0	1	6	0	0
15	31880100	.	A	T	4	3	7	0	0	7	0	0
15	31881825	.	G	A	3	2	5	0	2	7	0	0
15	31881873	.	G	A	0	6	6	0	3	9	0	0
15	31882044	.	A	G	4	3	7	0	0	7	0	0
15	31882167	.	G	A	2	3	5	0	0	5	0	0
15	31882176	.	A	G	2	4	6	0	0	6	0	0
15	31882269	.	G	A	1	5	6	0	1	7	0	0
15	31882272	.	A	G	2	4	6	0	0	7	1	0
15	31882342	.	C	T	3	2	5	0	0	5	0	0
15	31884219	.	A	C	2	4	6	0	0	6	0	0
15	31889005	.	T	G	5	3	8	0	1	9	0	0
15	31889332	.	C	T	5	4	9	0	1	10	0	0
15	31890902	.	T	G	1	5	6	0	1	7	0	0
15	31893536	.	A	C	6	6	12	0	0	12	0	0
15	31893599	.	C	T	8	6	14	0	0	14	0	0
15	31895248	.	A	G	7	0	7	0	7	14	0	0
15	31905040	.	G	A	17	13	30	0	3	33	0	0
15	31905097	.	A	G	15	11	26	0	1	27	0	0
15	31909454	.	A	C	10	11	21	0	0	21	0	0
15	31909819	.	G	A	1	4	5	0	4	9	0	0
15	32194156	.	T	A	1	2	3	0	0	3	0	0
15	32194162	.	C	T	1	2	3	0	0	3	0	0
15	32194286	.	G	A	2	2	4	0	0	4	0	0
15	32194550	.	A	C	2	3	5	0	0	5	0	0
15	32195432	.	G	A	2	5	7	0	0	7	0	0
15	32195521	.	T	C	4	3	7	0	1	8	0	0
15	32195718	.	G	A	3	6	9	0	0	9	0	0
15	32195729	.	A	G	5	3	8	0	0	8	0	0
15	32195840	.	T	A	2	2	4	0	0	4	0	0
15	32195976	.	G	A	0	2	2	0	2	4	0	0
15	32196093	.	G	A	0	2	2	0	3	5	0	0
15	32196685	.	A	T	1	2	3	0	1	4	0	0
15	32196731	.	A	C	1	4	5	0	1	6	0	0
15	32196752	.	T	A	1	6	7	0	0	7	0	0
15	32249188	.	G	A	14	14	28	0	2	30	0	0
15	32259056	.	G	A	9	8	17	0	2	19	0	0
15	32261461	.	G	C	2	15	17	2	8	27	0	0
15	32261464	.	T	C	17	7	24	2	3	29	0	0
15	32265889	.	T	C	10	18	28	0	2	30	0	0
15	32266557	.	A	T	7	14	21	0	0	21	0	0
15	32266921	.	G	A	1	14	15	0	14	29	0	0
15	32267078	.	A	G	8	9	17	0	2	19	0	0
15	32267120	.	C	A	2	3	5	0	1	6	0	0
15	32349398	.	G	T	3	2	5	0	1	6	0	0
15	32349742	.	A	G	9	6	15	0	0	15	0	0
15	32349762	.	A	G	8	6	14	0	0	14	0	0
15	32350066	.	A	G	11	3	14	15	0	29	0	0
15	32350116	.	G	T	14	6	20	0	0	20	0	0
15	32350435	.	A	G	6	7	13	0	0	13	0	0
15	32351299	.	A	G	6	13	19	0	4	23	0	0
15	32351476	.	A	G	9	10	19	1	3	23	0	0
15	32437032	.	G	A	2	2	4	0	4	8	0	0
15	32857820	.	C	T	1	7	8	0	0	8	0	0
15	32887798	.	A	G	4	2	6	2	0	8	0	0
15	32887799	.	A	G	2	3	5	2	0	7	0	0
15	32887858	.	A	G	2	6	8	0	1	10	1	0
15	33608123	.	T	A	1	3	4	0	0	4	0	0
15	33853701	.	C	T	4	6	10	1	0	11	0	0
15	33864152	.	A	G	6	6	12	0	0	12	0	0
15	33864266	.	G	A	11	5	16	0	0	16	0	0
15	33864585	.	G	A	6	8	14	0	1	15	0	0
15	33891825	.	G	A	25	9	34	0	2	36	0	0
15	33891826	.	G	A	24	10	34	0	2	36	0	0
15	33891869	.	G	T	29	11	40	1	1	42	0	0
15	33891979	.	T	C	31	9	40	0	2	42	0	0
15	33896117	.	G	T	20	15	35	0	4	39	0	0
15	33896177	.	T	C	26	19	45	0	1	46	0	0
15	33896213	.	T	C	24	0	24	0	21	45	0	0
15	33896303	.	T	A	19	20	39	0	0	39	0	0
15	33896306	.	A	G	20	17	37	0	0	37	0	0
15	33896832	.	T	C	12	10	22	0	1	23	0	0
15	33899556	.	C	G	5	12	17	0	0	17	0	0
15	33899808	.	T	A	7	10	17	0	4	22	1	0
15	33902388	.	C	G	4	6	10	0	3	13	0	0
15	33970841	.	A	G	23	0	23	0	15	38	0	0
15	33970854	.	C	T	20	16	36	0	1	37	0	0
15	33970907	.	C	T	19	13	32	0	3	35	0	0
15	33971097	.	G	C	20	17	37	0	0	37	0	0
15	33977716	.	A	T	17	14	31	0	3	34	0	0
15	33977760	.	A	G	17	0	17	0	19	36	0	0
15	33977942	.	A	C	9	9	18	0	0	18	0	0
15	34074558	.	C	T	4	5	9	0	0	9	0	0
15	34074744	.	C	G	2	2	4	0	0	4	0	0
15	34074745	.	A	T	1	3	4	0	0	4	0	0
15	34174635	.	T	C	15	8	23	1	0	24	0	0
15	34175101	.	T	C	17	21	38	0	1	39	0	0
15	34175359	.	G	A	12	7	19	0	1	20	0	0
15	34175426	.	T	A	7	11	18	0	1	19	0	0
15	34175718	.	G	A	3	6	9	0	0	9	0	0
15	34175917	.	C	T	9	6	15	2	1	18	0	0
15	34175929	.	C	T	7	13	20	0	0	20	0	0
15	34176203	.	A	T	16	11	27	0	4	31	0	0
15	34176214	.	C	T	9	16	25	0	3	28	0	0
15	34176336	.	G	T	2	2	4	0	0	4	0	0
15	34176379	.	A	C	9	13	22	0	3	25	0	0
15	34176841	.	A	T	9	7	16	0	1	17	0	0
15	34176993	.	G	A	8	7	15	0	1	16	0	0
15	34182135	.	G	A	9	5	14	0	1	15	0	0
15	34189452	.	G	A	8	9	17	0	0	17	0	0
15	34215835	.	A	T	1	3	4	0	0	4	0	0
15	34326217	.	G	A	1	2	3	0	0	3	0	0
15	34335044	.	T	A	2	2	4	0	0	4	0	0
15	34335130	.	T	C	3	3	6	0	0	6	0	0
15	34335147	.	G	A	4	3	7	0	0	7	0	0
15	34335272	.	C	T	4	3	7	0	0	7	0	0
15	34534245	.	C	G	4	7	11	0	1	12	0	0
15	34558428	.	G	A	6	4	10	0	0	10	0	0
15	34558438	.	G	T	3	3	6	0	0	6	0	0
15	34562974	.	G	A	1	3	4	0	0	4	0	0
15	34573337	.	C	T	1	5	6	0	1	7	0	0
15	34573343	.	A	G	1	5	6	0	0	6	0	0
15	34573454	.	A	C	4	8	12	0	0	12	0	0
15	34573664	.	G	T	2	4	6	0	0	6	0	0
15	34573952	.	T	A	3	4	7	0	0	7	0	0
15	34573959	.	A	T	3	4	7	0	0	7	0	0
15	34574116	.	G	A	5	11	16	0	1	17	0	0
15	34577749	.	G	A	8	10	18	0	0	18	0	0
15	34590772	.	A	G	1	2	3	0	0	3	0	0
15	34618456	.	T	G	2	9	11	0	0	11	0	0
15	34618669	.	A	T	14	15	29	0	0	29	0	0
15	34618906	.	C	A	17	17	34	0	2	36	0	0
15	34618948	.	T	G	19	19	38	0	1	39	0	0
15	34618958	.	G	A	16	16	32	0	6	38	0	0
15	34621868	.	G	A	13	14	27	0	0	27	0	0
15	34621875	.	G	A	16	14	30	0	0	30	0	0
15	34627792	.	T	A	11	8	19	0	2	21	0	0
15	34627874	.	T	C	18	11	29	0	2	31	0	0
15	34635321	.	C	A	6	6	12	0	0	12	0	0
15	34635336	.	A	C	7	0	7	0	5	12	0	0
15	34637582	.	C	T	2	7	9	0	9	18	0	0
15	34638847	.	C	T	1	14	15	0	4	19	0	0
15	34641252	.	G	C	1	0	1	0	5	6	0	0
15	34641276	.	G	A	4	3	7	0	0	7	0	0
15	34641384	.	G	A	7	4	11	0	0	11	0	0
15	34657919	.	T	A	4	3	7	0	0	7	0	0
15	34854775	.	A	G	1	9	10	0	0	10	0	0
15	35076003	.	C	T	6	8	14	0	0	14	0	0
15	35091591	.	A	G	5	9	14	0	0	14	0	0
15	35102653	.	G	A	1	6	7	0	0	7	0	0
15	35103145	.	T	C	4	5	9	0	0	9	0	0
15	35115699	.	A	G	2	6	8	3	0	11	0	0
15	35156366	.	G	A	1	4	5	0	0	5	0	0
15	35156554	.	T	G	5	1	6	0	1	7	0	0
15	35156573	.	A	T	6	2	8	0	0	8	0	0
15	35158661	.	T	G	13	10	23	0	0	23	0	0
15	35163492	.	T	G	3	7	10	0	1	11	0	0
15	35212147	.	C	G	1	3	4	0	2	6	0	0
15	35212177	.	G	A	2	4	6	0	0	6	0	0
15	35212386	.	T	C	2	4	6	0	1	7	0	0
15	35212418	.	G	C	1	2	3	0	0	3	0	0
15	35214784	.	T	A	6	7	13	0	0	13	0	0
15	35214859	.	A	C	6	0	6	0	6	12	0	0
15	35214901	.	G	A	9	6	15	0	0	15	0	0
15	35217424	.	G	A	6	6	12	0	0	12	0	0
15	35217475	.	T	C	9	9	18	0	1	19	0	0
15	35217487	.	C	A	2	7	9	0	8	17	0	0
15	35221304	.	A	T	3	9	12	0	1	13	0	0
15	35224269	.	G	C	10	9	19	0	0	19	0	0
15	35227221	.	A	T	14	4	18	0	2	20	0	0
15	35247678	.	A	T	18	18	36	0	3	39	0	0
15	35247687	.	A	G	14	23	37	0	0	37	0	0
15	35247729	.	A	G	11	19	30	0	0	30	0	0
15	35247762	.	T	C	16	15	31	0	1	32	0	0
15	35709983	.	G	A	0	3	3	0	3	6	0	0
15	35709988	.	C	T	3	2	5	0	0	5	0	0
15	35718398	.	A	C	2	3	5	0	0	5	0	0
15	35760943	.	C	T	0	2	2	0	1	3	0	0
15	35760970	.	G	A	3	3	6	0	0	6	0	0
15	35761024	.	T	C	4	7	11	0	0	11	0	0
15	35761027	.	A	G	4	7	11	0	0	11	0	0
15	35761126	.	G	A	1	3	4	0	3	7	0	0
15	35761225	.	G	A	3	4	7	0	2	9	0	0
15	35761516	.	T	C	5	3	8	0	0	8	0	0
15	35889183	.	C	A	1	3	4	0	0	4	0	0
15	35889516	.	A	C	3	3	6	0	0	6	0	0
15	35889517	.	C	A	0	3	3	0	3	6	0	0
15	35889810	.	G	A	3	3	6	0	0	6	0	0
15	35889826	.	C	T	4	3	7	0	0	7	0	0
15	35889865	.	A	G	3	3	6	0	0	6	0	0
15	35890046	.	G	A	8	3	11	0	0	11	0	0
15	35890148	.	C	T	4	3	7	0	1	8	0	0
15	35891639	.	T	A	1	3	4	0	0	4	0	0
15	35926361	.	C	G	2	3	5	0	0	5	0	0
15	35927375	.	A	G	1	2	3	0	0	3	0	0
15	35927516	.	C	T	0	2	2	0	2	4	0	0
15	35944379	.	G	A	1	2	3	0	0	3	0	0
15	37222589	.	T	C	24	28	52	0	1	53	0	0
15	37227033	.	T	G	32	26	58	0	2	60	0	0
15	37227059	.	A	G	31	2	33	0	32	65	0	0
15	37227509	.	A	G	34	1	35	0	27	62	0	0
15	37227714	.	A	G	24	2	26	0	29	55	0	0
15	37227770	.	G	A	26	26	52	0	3	58	3	0
15	37228164	.	A	G	24	30	54	0	0	54	0	0
15	37228236	.	C	T	20	32	52	0	2	54	0	0
15	37228266	.	T	C	19	33	52	0	1	53	0	0
15	37228301	.	T	A	16	38	54	0	0	54	0	0
15	37228338	.	T	A	28	18	46	0	3	49	0	0
15	37228620	.	G	C	31	29	60	0	1	61	0	0
15	37228626	.	G	A	32	27	59	0	3	62	0	0
15	37228665	.	C	G	19	38	57	0	4	61	0	0
15	37228843	.	T	A	43	18	61	2	4	67	0	0
15	37228845	.	T	G	41	20	61	2	3	66	0	0
15	37229346	.	T	G	43	19	62	0	2	65	1	0
15	37229390	.	T	A	59	6	65	1	0	66	0	0
15	37229871	.	A	T	28	40	68	0	2	70	0	0
15	37229991	.	C	A	32	39	71	0	0	71	0	0
15	37230038	.	G	A	34	30	64	0	4	68	0	0
15	37230100	.	G	A	34	30	64	0	4	68	0	0
15	37459342	.	T	C	7	0	7	0	3	10	0	0
15	37459369	.	T	C	2	8	10	0	0	10	0	0
15	37459819	.	T	C	8	4	12	0	0	12	0	0
15	37459875	.	T	C	1	5	6	0	0	6	0	0
15	39140121	.	C	A	6	7	13	0	1	14	0	0
15	39140568	.	G	A	1	4	5	0	4	9	0	0
15	39141465	.	T	C	5	6	11	0	1	12	0	0
15	39208133	.	C	A	10	12	22	0	2	25	1	0
15	39208150	.	C	T	9	13	22	0	3	25	0	0
15	39208201	.	C	A	17	10	27	0	4	31	0	0
15	39208211	.	C	T	18	10	28	0	1	29	0	0
15	39208258	.	C	T	17	16	33	0	0	33	0	0
15	39228174	.	A	G	20	20	40	0	1	41	0	0
15	39278501	.	G	T	5	10	15	0	1	16	0	0
15	39281923	.	A	G	13	12	25	0	2	27	0	0
15	39282007	.	G	C	10	0	10	0	13	23	0	0
15	39282070	.	A	G	14	6	20	0	0	20	0	0
15	39294391	.	C	T	11	9	20	0	2	22	0	0
15	39296706	.	A	G	7	14	21	0	0	21	0	0
15	39296730	.	G	A	12	7	19	0	2	21	0	0
15	39297051	.	G	A	7	12	19	0	2	21	0	0
15	39297081	.	A	G	13	8	21	0	1	22	0	0
15	39305598	.	G	A	7	5	12	0	0	12	0	0
15	39326986	.	C	T	5	6	11	0	0	11	0	0
15	39339460	.	T	A	6	2	8	0	0	8	0	0
15	39339511	.	C	G	1	2	3	0	4	7	0	0
15	39345641	.	G	A	5	2	7	0	0	7	0	0
15	39967275	.	G	A	35	36	71	0	1	72	0	0
15	39969923	.	T	G	36	29	65	0	2	67	0	0
15	39987655	.	C	T	2	3	5	0	1	6	0	0
15	39992053	.	C	T	6	4	10	0	0	10	0	0
15	40000966	.	C	A	12	4	16	0	0	16	0	0
15	40002242	.	C	T	8	8	16	0	2	18	0	0
15	40002319	.	C	T	9	10	19	0	1	20	0	0
15	40002325	.	C	T	9	10	19	0	1	20	0	0
15	40002534	.	A	T	3	8	11	0	1	12	0	0
15	40004820	.	G	A	3	2	5	0	0	5	0	0
15	40005279	.	C	T	7	7	14	0	0	14	0	0
15	40005297	.	A	C	5	7	12	0	4	16	0	0
15	40005318	.	T	A	10	6	16	0	0	16	0	0
15	40005466	.	C	T	9	12	21	0	1	22	0	0
15	40005545	.	T	C	15	9	24	0	2	26	0	0
15	40006090	.	A	C	11	7	18	0	1	19	0	0
15	40008449	.	C	T	11	13	24	0	0	24	0	0
15	40008498	.	C	T	14	13	27	0	1	28	0	0
15	40008544	.	C	A	20	23	43	0	0	43	0	0
15	40018239	.	G	A	5	18	23	1	27	51	0	0
15	40018290	.	C	T	28	25	53	0	2	55	0	0
15	40027138	.	C	T	29	38	67	0	4	71	0	0
15	40027279	.	T	C	60	16	76	0	4	80	0	0
15	40027484	.	T	G	30	2	32	0	28	60	0	0
15	40027540	.	A	C	19	33	52	0	3	55	0	0
15	40027717	.	A	G	29	19	48	0	3	51	0	0
15	40028280	.	A	G	45	13	58	0	0	58	0	0
15	40028457	.	T	G	31	31	62	1	3	66	0	0
15	40028568	.	G	A	36	27	63	0	3	66	0	0
15	40028574	.	A	G	25	28	53	0	14	68	1	0
15	40091068	.	C	T	2	8	10	0	1	11	0	0
15	40099812	.	C	T	5	6	11	0	1	12	0	0
15	40099844	.	T	C	8	9	17	0	0	17	0	0
15	40104028	.	T	C	11	6	17	0	1	18	0	0
15	40108886	.	T	C	8	15	23	0	1	24	0	0
15	40108898	.	C	T	10	16	26	0	0	26	0	0
15	40115610	.	A	T	11	16	27	0	1	28	0	0
15	40115676	.	C	T	10	17	27	0	1	28	0	0
15	40122221	.	A	G	9	8	17	0	0	17	0	0
15	40122625	.	G	A	5	11	16	0	1	17	0	0
15	40126698	.	A	G	19	2	21	0	8	29	0	0
15	40128979	.	C	G	19	11	30	0	2	32	0	0
15	40129543	.	G	C	16	11	27	0	0	27	0	0
15	40129594	.	T	G	17	11	28	0	1	29	0	0
15	40129604	.	A	T	18	11	29	0	2	31	0	0
15	40129810	.	A	C	14	11	25	0	0	25	0	0
15	40130181	.	G	A	2	11	13	0	11	24	0	0
15	40130208	.	G	A	10	13	23	0	1	24	0	0
15	40130310	.	T	A	4	8	12	0	0	12	0	0
15	40130343	.	G	T	2	10	12	0	0	12	0	0
15	40130362	.	T	C	1	7	8	0	1	9	0	0
15	40130389	.	A	G	3	4	7	0	1	8	0	0
15	40130631	.	A	G	5	6	11	0	1	12	0	0
15	40130759	.	A	G	5	10	15	0	3	19	1	0
15	40131001	.	G	A	1	5	6	0	6	12	0	0
15	40131060	.	A	G	14	5	19	0	0	19	0	0
15	40131112	.	C	A	15	16	31	0	0	31	0	0
15	40131139	.	T	A	17	16	33	0	0	33	0	0
15	40131157	.	A	G	13	16	29	0	1	30	0	0
15	40131216	.	G	A	18	12	30	0	3	33	0	0
15	40131232	.	C	T	20	9	29	0	0	29	0	0
15	40131276	.	C	G	17	12	29	0	0	29	0	0
15	40131297	.	C	G	18	12	30	0	0	30	0	0
15	40131316	.	C	A	21	12	33	0	0	33	0	0
15	40131363	.	G	T	2	17	19	0	20	39	0	0
15	40131498	.	A	G	8	0	8	0	27	35	0	0
15	40131500	.	A	G	10	26	36	0	0	36	0	0
15	40131547	.	T	C	13	20	33	0	1	34	0	0
15	40131560	.	T	A	12	22	34	0	1	35	0	0
15	40131586	.	C	T	14	26	40	0	0	40	0	0
15	40131619	.	T	C	14	24	38	0	0	38	0	0
15	40131624	.	T	A	15	20	35	0	1	36	0	0
15	40131769	.	T	C	11	10	21	0	0	21	0	0
15	40202354	.	T	G	25	24	49	0	1	50	0	0
15	40202393	.	C	T	19	23	42	0	1	43	0	0
15	40211507	.	T	C	29	21	50	0	4	54	0	0
15	40211591	.	A	C	27	18	45	0	6	51	0	0
15	40211618	.	A	G	28	2	30	1	22	53	0	0
15	40211741	.	C	G	24	11	35	0	1	37	1	0
15	40211954	.	G	T	8	9	17	0	0	17	0	0
15	40218961	.	T	C	1	2	3	0	0	3	0	0
15	40218967	.	T	C	1	1	2	0	0	2	0	0
15	40219506	.	T	C	4	2	6	1	1	8	0	0
15	40219512	.	T	C	1	6	7	1	0	8	0	0
15	40894385	.	T	A	1	2	3	0	0	3	0	0
15	40933339	.	T	C	1	3	4	0	0	4	0	0
15	40938072	.	C	T	2	4	6	0	0	6	0	0
15	40938119	.	G	A	2	3	5	0	1	6	0	0
15	40938305	.	C	T	3	4	7	0	0	7	0	0
15	40938498	.	T	C	6	6	12	0	0	12	0	0
15	40945690	.	T	C	2	4	6	0	1	7	0	0
15	40945879	.	G	A	1	5	6	0	3	9	0	0
15	40945884	.	T	G	4	4	8	0	0	8	0	0
15	40952226	.	A	G	6	3	9	0	0	9	0	0
15	40962160	.	T	C	3	5	8	0	0	8	0	0
15	40962186	.	C	T	2	3	5	0	0	5	0	0
15	40988189	.	T	C	7	6	13	0	8	21	0	0
15	40988228	.	C	T	8	6	14	0	1	15	0	0
15	40988565	.	A	G	5	6	11	0	1	12	0	0
15	40988659	.	C	A	5	3	8	0	1	9	0	0
15	40989320	.	C	G	2	0	2	0	6	8	0	0
15	40989327	.	A	G	1	6	7	0	0	7	0	0
15	40989614	.	C	T	9	3	12	0	0	12	0	0
15	40989690	.	A	G	4	8	12	0	1	13	0	0
15	41170289	.	A	G	11	24	35	0	1	36	0	0
15	41170445	.	G	T	20	15	35	0	0	35	0	0
15	41170710	.	G	A	14	18	32	0	1	33	0	0
15	41170992	.	G	A	16	10	26	0	2	28	0	0
15	41171081	.	T	C	19	0	19	0	16	35	0	0
15	41171135	.	A	G	7	16	23	0	0	23	0	0
15	41171335	.	A	T	17	13	30	0	4	34	0	0
15	41171448	.	A	C	21	13	34	1	1	36	0	0
15	41171471	.	G	T	13	11	24	1	1	26	0	0
15	41171516	.	C	A	3	13	16	0	25	41	0	0
15	41172103	.	G	A	8	11	19	1	3	23	0	0
15	41172427	.	T	C	5	6	11	0	0	11	0	0
15	41172731	.	G	A	3	3	6	0	0	6	0	0
15	41172745	.	C	T	3	3	6	0	0	6	0	0
15	41172801	.	G	C	3	2	5	0	3	8	0	0
15	41172893	.	A	C	12	5	17	0	0	17	0	0
15	41172904	.	G	C	13	7	20	0	0	20	0	0
15	41173093	.	A	T	14	7	21	0	1	22	0	0
15	41173109	.	C	T	12	5	17	0	0	17	0	0
15	41173142	.	G	A	7	3	10	0	0	10	0	0
15	41173261	.	T	G	6	13	19	0	0	19	0	0
15	41173326	.	C	T	14	15	29	0	1	30	0	0
15	41173620	.	G	A	13	8	21	0	1	22	0	0
15	41758264	.	A	T	5	2	7	2	0	9	0	0
15	41758277	.	A	G	2	2	4	2	0	6	0	0
15	41807100	.	A	G	2	2	4	0	0	4	0	0
15	41828235	.	C	T	1	3	4	0	0	4	0	0
15	41845121	.	G	A	7	4	11	0	0	11	0	0
15	41845139	.	C	T	3	4	7	0	0	7	0	0
15	41845310	.	G	T	3	4	7	0	1	8	0	0
15	41845678	.	A	T	3	3	6	0	0	6	0	0
15	41845681	.	C	A	4	3	7	0	0	7	0	0
15	41948220	.	C	G	1	3	4	0	0	4	0	0
15	41948276	.	A	C	2	2	4	0	0	4	0	0
15	41948379	.	G	A	1	2	3	0	0	3	0	0
15	41948568	.	A	G	1	2	3	0	0	3	0	0
15	41948573	.	T	G	1	1	2	0	1	3	0	0
15	41948826	.	T	C	3	3	6	0	0	6	0	0
15	41949500	.	C	T	1	5	6	0	0	6	0	0
15	41950369	.	G	A	2	2	4	0	1	5	0	0
15	41950379	.	G	A	2	3	5	0	0	5	0	0
15	41950454	.	C	T	1	2	3	0	0	3	0	0
15	41950717	.	T	C	2	3	5	0	0	5	0	0
15	41950896	.	G	A	3	3	6	0	1	7	0	0
15	41951049	.	G	A	3	3	6	0	0	6	0	0
15	41954412	.	G	A	3	2	5	0	1	6	0	0
15	41972616	.	G	A	2	1	3	0	1	4	0	0
15	42264934	.	C	T	8	3	11	0	0	11	0	0
15	42264955	.	C	T	0	6	6	0	10	16	0	0
15	42265070	.	G	C	9	11	20	0	1	21	0	0
15	42265197	.	G	A	18	22	40	0	4	44	0	0
15	42265263	.	A	G	25	18	43	0	1	44	0	0
15	42267390	.	C	T	1	18	19	0	19	38	0	0
15	42267408	.	T	A	14	16	30	0	1	31	0	0
15	42272452	.	C	A	7	20	27	0	1	28	0	0
15	42278936	.	T	A	9	3	12	0	1	13	0	0
15	42280689	.	G	A	5	9	14	1	0	15	0	0
15	42283746	.	C	T	12	9	21	0	0	21	0	0
15	42285766	.	A	G	15	0	15	0	11	26	0	0
15	42285767	.	G	T	15	11	26	0	1	27	0	0
15	42297528	.	A	G	18	1	19	0	7	26	0	0
15	42297751	.	T	C	9	18	27	0	1	28	0	0
15	42302915	.	A	G	12	16	28	0	1	29	0	0
15	42317277	.	C	G	3	4	7	0	0	7	0	0
15	42317289	.	C	T	4	2	6	0	0	6	0	0
15	42344847	.	C	T	8	6	14	0	0	14	0	0
15	42346196	.	T	C	8	4	12	1	1	14	0	0
15	42346260	.	T	A	9	9	18	0	1	19	0	0
15	42346584	.	C	T	5	5	10	0	1	11	0	0
15	42346593	.	T	C	8	5	13	0	0	13	0	0
15	42346627	.	G	T	8	6	14	0	0	14	0	0
15	42346771	.	C	A	2	10	12	0	0	12	0	0
15	42346818	.	A	T	4	6	10	0	0	10	0	0
15	42346841	.	T	C	7	5	12	0	0	12	0	0
15	42346902	.	C	T	6	14	20	0	0	20	0	0
15	42347008	.	C	T	4	6	10	0	0	10	0	0
15	42434556	.	T	C	1	3	4	0	0	4	0	0
15	42434568	.	A	G	1	2	3	0	0	3	0	0
15	42467418	.	A	G	3	3	6	0	1	7	0	0
15	42480915	.	T	A	3	4	7	0	0	7	0	0
15	42543850	.	G	A	0	3	3	0	1	4	0	0
15	42550856	.	G	A	4	4	8	0	1	9	0	0
15	42550961	.	C	T	3	6	9	0	0	9	0	0
15	42551067	.	G	A	1	9	10	0	5	15	0	0
15	42676401	.	T	C	2	3	5	0	0	5	0	0
15	42758927	.	T	C	1	0	1	0	3	4	0	0
15	42758942	.	T	C	1	0	1	0	2	3	0	0
15	42767880	.	G	A	0	4	4	0	4	8	0	0
15	42933283	.	C	T	1	3	4	0	0	4	0	0
15	42952872	.	G	T	1	3	4	0	0	4	0	0
15	42976368	.	C	T	1	2	3	0	0	3	0	0
15	42976371	.	C	A	1	2	3	0	0	3	0	0
15	42980862	.	T	C	8	3	11	0	0	11	0	0
15	42981069	.	C	T	2	2	4	0	1	5	0	0
15	42981223	.	A	G	6	7	13	0	1	14	0	0
15	42981303	.	T	A	6	8	14	0	3	17	0	0
15	42981321	.	G	A	9	6	15	0	1	16	0	0
15	42981345	.	A	G	6	0	6	0	4	10	0	0
15	43100112	.	T	G	1	2	3	0	0	3	0	0
15	43187423	.	T	C	30	47	77	0	2	79	0	0
15	43195924	.	G	A	36	44	80	1	0	81	0	0
15	43196102	.	A	T	23	55	78	0	2	80	0	0
15	43196106	.	A	G	23	9	32	0	50	82	0	0
15	43196202	.	C	A	25	40	65	0	6	71	0	0
15	43196306	.	C	T	34	33	67	0	4	71	0	0
15	43196341	.	T	A	40	35	75	0	1	76	0	0
15	43196483	.	C	A	24	47	71	0	0	71	0	0
15	43196491	.	T	C	19	42	61	0	4	65	0	0
15	43604903	.	C	G	7	6	13	0	0	13	0	0
15	43604928	.	A	G	3	4	7	0	1	8	0	0
15	43605538	.	C	T	1	4	5	0	4	9	0	0
15	43651693	.	G	A	4	2	6	0	0	6	0	0
15	43656352	.	G	A	2	2	4	0	0	4	0	0
15	43662857	.	G	A	1	2	3	0	1	4	0	0
15	43663193	.	T	G	1	3	4	0	0	4	0	0
15	43938527	.	C	T	1	4	5	0	0	5	0	0
15	43938539	.	C	G	1	4	5	0	0	5	0	0
15	43973419	.	A	G	1	2	3	0	0	3	0	0
15	43982517	.	T	C	4	5	9	0	0	9	0	0
15	43982925	.	T	C	1	3	4	0	0	4	0	0
15	43983039	.	A	G	1	2	3	0	0	3	0	0
15	44025798	.	T	C	1	3	4	0	0	4	0	0
15	44029353	.	C	T	0	2	2	0	2	4	0	0
15	44029527	.	A	T	4	2	6	0	1	7	0	0
15	44029590	.	C	T	2	2	4	0	0	4	0	0
15	44030299	.	C	T	1	4	5	0	0	5	0	0
15	44030380	.	A	G	1	3	4	0	0	4	0	0
15	44031263	.	G	A	1	3	4	0	0	4	0	0
15	44035113	.	G	A	1	2	3	0	0	3	0	0
15	44072776	.	T	C	6	0	6	3	9	18	0	0
15	44074653	.	A	G	10	7	17	0	0	17	0	0
15	44075125	.	C	T	1	4	5	0	10	15	0	0
15	44077766	.	A	T	7	6	13	0	0	13	0	0
15	44140360	.	G	A	3	4	7	0	0	7	0	0
15	44140458	.	G	A	0	3	3	0	1	4	0	0
15	44140546	.	T	C	2	4	6	0	0	6	0	0
15	44140583	.	C	T	4	4	8	0	1	9	0	0
15	44140666	.	C	T	4	3	7	0	0	7	0	0
15	44140716	.	C	T	3	5	8	0	0	8	0	0
15	44140780	.	A	G	1	4	5	0	0	5	0	0
15	44140991	.	T	C	1	5	6	0	1	7	0	0
15	44141311	.	A	G	2	5	7	0	0	7	0	0
15	44141560	.	C	T	2	3	5	1	0	6	0	0
15	44141644	.	A	C	3	6	9	0	0	9	0	0
15	44141741	.	G	C	2	4	6	0	0	6	0	0
15	44141755	.	T	A	0	4	4	0	0	4	0	0
15	44255130	.	A	T	9	3	12	0	0	12	0	0
15	44255212	.	A	C	5	8	13	0	0	13	0	0
15	44255503	.	A	T	4	4	8	0	0	8	0	0
15	44290546	.	C	T	1	5	6	0	0	6	0	0
15	44295044	.	G	A	3	6	9	0	0	9	0	0
15	44323349	.	T	C	3	7	10	0	0	10	0	0
15	44323436	.	G	A	0	2	2	0	2	4	0	0
15	44323442	.	G	A	2	2	4	0	1	5	0	0
15	44336923	.	A	T	8	4	12	0	1	13	0	0
15	44340093	.	C	T	2	2	4	0	1	5	0	0
15	44344283	.	G	A	0	3	3	0	2	5	0	0
15	44345243	.	T	A	3	6	9	0	0	9	0	0
15	44370788	.	G	A	2	2	4	0	0	4	0	0
15	44370791	.	C	T	2	2	4	0	0	4	0	0
15	44371076	.	C	T	5	7	12	0	1	13	0	0
15	44371289	.	C	T	2	7	9	0	0	9	0	0
15	44371484	.	T	C	2	9	11	0	0	11	0	0
15	44371550	.	G	A	12	6	18	0	0	18	0	0
15	44384767	.	T	C	13	5	18	0	0	18	0	0
15	44385021	.	G	A	11	8	19	0	1	20	0	0
15	44385117	.	T	C	5	7	12	0	0	12	0	0
15	44385126	.	C	T	5	5	10	0	1	11	0	0
15	44399204	.	C	T	16	9	25	0	1	26	0	0
15	44445243	.	C	T	4	7	11	0	0	11	0	0
15	44447906	.	C	T	1	3	4	0	0	4	0	0
15	44462839	.	C	T	6	4	10	0	0	10	0	0
15	44465352	.	G	A	3	2	5	0	1	6	0	0
15	44475020	.	G	A	2	3	5	0	0	5	0	0
15	44475038	.	C	T	2	1	3	0	0	3	0	0
15	44499445	.	A	G	23	16	39	0	0	39	0	0
15	44499653	.	T	A	20	27	47	0	3	50	0	0
15	44499730	.	C	T	26	26	52	0	0	52	0	0
15	44534976	.	G	A	13	13	26	0	0	26	0	0
15	44733135	.	G	A	3	6	9	0	1	10	0	0
15	44733157	.	A	G	3	7	10	0	0	10	0	0
15	44755727	.	G	A	2	4	6	0	0	6	0	0
15	45027401	.	G	A	3	4	7	0	0	7	0	0
15	45034764	.	C	T	0	2	2	0	6	8	0	0
15	46662011	.	G	T	18	8	26	0	5	31	0	0
15	46662143	.	C	T	6	15	21	0	1	22	0	0
15	46691114	.	G	T	4	3	7	0	0	7	0	0
15	46691249	.	G	A	1	2	3	0	1	4	0	0
15	46699268	.	G	A	3	3	6	0	0	6	0	0
15	46699487	.	A	G	2	2	4	0	0	4	0	0
15	46727382	.	G	A	4	2	6	0	0	6	0	0
15	46727571	.	G	A	2	3	5	0	0	5	0	0
15	46792094	.	A	T	4	2	6	0	0	6	0	0
15	46792154	.	G	A	3	3	6	0	0	6	0	0
15	47083980	.	G	A	0	2	2	0	1	3	0	0
15	47086656	.	C	T	1	3	4	0	0	4	0	0
15	47086658	.	T	C	0	3	3	0	1	4	0	0
15	47100599	.	C	T	0	4	4	0	5	9	0	0
15	47107256	.	A	G	2	4	6	0	1	7	0	0
15	47115252	.	G	A	6	3	9	0	0	9	0	0
15	47336295	.	G	A	16	15	31	0	1	32	0	0
15	47338768	.	C	A	1	2	3	0	0	3	0	0
15	47386982	.	T	A	19	12	31	0	0	31	0	0
15	47410231	.	C	A	12	6	18	0	0	18	0	0
15	47418607	.	G	A	3	12	15	0	10	25	0	0
15	47418627	.	G	A	9	18	27	0	0	27	0	0
15	47419090	.	G	A	5	10	15	0	22	37	0	0
15	47419096	.	C	T	25	11	36	0	2	38	0	0
15	47419240	.	C	T	23	20	43	0	0	43	0	0
15	47419394	.	C	T	29	23	52	0	1	53	0	0
15	47419395	.	A	T	30	22	52	0	2	54	0	0
15	47420838	.	T	A	29	28	57	0	3	60	0	0
15	47420920	.	G	C	0	35	35	0	1	36	0	0
15	47421203	.	T	C	19	11	30	0	4	34	0	0
15	47421329	.	A	G	16	13	29	0	1	30	0	0
15	47421669	.	C	T	16	13	29	0	6	35	0	0
15	47421675	.	G	C	15	17	32	0	3	35	0	0
15	47448354	.	G	T	1	3	4	0	0	4	0	0
15	47448425	.	G	A	0	4	4	0	3	7	0	0
15	47448596	.	G	C	3	3	6	0	0	6	0	0
15	47452895	.	C	A	2	11	13	0	0	13	0	0
15	47453288	.	C	G	1	2	3	0	0	3	0	0
15	47830783	.	C	T	6	2	8	0	0	8	0	0
15	47831096	.	C	T	7	10	17	0	1	18	0	0
15	47831195	.	G	C	9	6	15	0	0	15	0	0
15	47831249	.	C	T	6	6	12	0	0	12	0	0
15	47831265	.	T	A	4	4	8	0	1	9	0	0
15	47831495	.	C	G	17	12	29	0	0	29	0	0
15	47831511	.	C	T	1	12	13	0	20	33	0	0
15	47831565	.	C	A	23	15	38	0	0	38	0	0
15	47831731	.	T	G	7	8	15	0	0	15	0	0
15	47831765	.	G	A	2	5	7	0	0	7	0	0
15	47832681	.	G	A	2	4	6	0	0	6	0	0
15	47832930	.	C	T	8	6	14	2	0	16	0	0
15	47832931	.	C	T	1	5	6	2	9	17	0	0
15	47833083	.	G	A	2	9	11	0	3	14	0	0
15	47833392	.	G	A	13	3	16	0	0	16	0	0
15	47833395	.	C	T	0	3	3	0	13	16	0	0
15	47833436	.	C	T	0	5	5	0	7	12	0	0
15	47833493	.	C	T	1	5	6	0	5	11	0	0
15	47833662	.	C	T	7	3	10	0	1	11	0	0
15	47833814	.	C	T	2	5	7	0	1	8	0	0
15	47833875	.	A	G	2	2	4	0	0	4	0	0
15	47834202	.	T	C	6	0	6	0	4	10	0	0
15	47834487	.	C	T	0	5	5	0	2	7	0	0
15	47834559	.	G	A	1	5	6	0	0	6	0	0
15	47839080	.	G	A	1	1	2	0	1	3	0	0
15	47845908	.	A	G	21	21	42	0	1	43	0	0
15	47847373	.	G	A	17	20	37	0	1	38	0	0
15	47848495	.	C	T	21	22	43	0	4	47	0	0
15	47851205	.	T	A	32	26	58	0	1	59	0	0
15	47851455	.	T	G	33	30	63	0	2	65	0	0
15	47851486	.	G	A	31	31	62	0	3	65	0	0
15	47851522	.	C	T	5	23	28	0	34	62	0	0
15	47851751	.	A	G	32	16	48	0	1	49	0	0
15	47851828	.	G	A	30	15	45	0	1	46	0	0
15	47851978	.	C	T	13	5	18	1	2	21	0	0
15	47851979	.	A	G	13	6	19	1	1	21	0	0
15	47852049	.	G	T	9	11	20	0	2	22	0	0
15	47855085	.	A	G	32	19	51	1	3	55	0	0
15	47856351	.	T	C	17	0	17	12	9	38	0	0
15	47856418	.	T	C	50	13	63	5	6	74	0	0
15	47860443	.	C	T	1	21	22	0	13	35	0	0
16	39527	.	G	C	1	6	7	0	6	13	0	0
16	39530	.	C	G	7	7	14	0	0	14	0	0
16	50458	.	C	A	3	8	11	0	1	12	0	0
16	51458	.	C	T	4	6	10	0	1	11	0	0
16	68254	.	A	G	8	6	14	0	1	15	0	0
16	68355	.	T	C	6	7	13	0	1	14	0	0
16	68356	.	C	T	8	7	15	0	0	15	0	0
16	68404	.	A	G	7	10	17	0	0	17	0	0
16	68477	.	G	A	0	9	9	0	10	19	0	0
16	68513	.	G	C	0	8	8	0	8	16	0	0
16	68635	.	A	G	6	7	13	0	0	13	0	0
16	68812	.	A	G	9	10	19	0	0	19	0	0
16	68854	.	T	C	12	8	20	0	1	21	0	0
16	69005	.	T	A	13	10	23	0	4	27	0	0
16	69428	.	A	C	13	11	24	0	0	24	0	0
16	70697	.	T	C	11	8	19	0	2	21	0	0
16	70839	.	A	G	6	0	6	0	8	15	1	0
16	70881	.	A	G	6	5	11	0	4	15	0	0
16	162713	.	T	C	1	2	3	0	0	3	0	0
16	221747	.	G	A	19	31	50	1	3	54	0	0
16	221828	.	C	T	17	23	40	0	1	41	0	0
16	224707	.	A	G	22	21	43	0	1	44	0	0
16	224734	.	C	G	25	22	47	0	1	48	0	0
16	224743	.	C	A	25	19	44	0	4	48	0	0
16	224837	.	A	C	26	19	45	1	1	47	0	0
16	224886	.	G	A	4	25	29	0	27	56	0	0
16	224974	.	A	T	28	16	44	0	2	46	0	0
16	225005	.	T	C	33	22	55	0	3	58	0	0
16	225304	.	C	A	26	22	48	0	5	53	0	0
16	225564	.	T	C	20	27	47	0	4	51	0	0
16	225615	.	A	G	24	27	51	0	1	52	0	0
16	225660	.	C	G	19	29	48	0	1	49	0	0
16	226526	.	A	G	15	10	25	0	2	27	0	0
16	227590	.	A	T	1	2	3	0	0	3	0	0
16	227797	.	T	C	3	1	4	1	5	10	0	0
16	250422	.	T	A	4	7	11	0	0	11	0	0
16	253879	.	G	C	2	0	2	0	3	5	0	0
16	253885	.	C	T	0	3	3	0	2	5	0	0
16	278750	.	C	T	1	8	9	0	7	16	0	0
16	280286	.	T	A	4	5	9	0	0	9	0	0
16	559050	.	T	A	3	11	14	0	0	14	0	0
16	2033947	.	A	G	1	1	2	0	3	5	0	0
16	2043122	.	G	C	2	6	8	0	15	23	0	0
16	2071535	.	G	A	2	3	5	0	9	14	0	0
16	2102245	.	A	G	4	4	8	0	0	8	0	0
16	2102256	.	T	G	2	0	2	0	3	5	0	0
16	2102468	.	A	T	5	4	9	0	0	9	0	0
16	2102544	.	T	A	8	5	13	1	0	14	0	0
16	2102683	.	C	T	4	1	5	0	3	8	0	0
16	2103052	.	C	T	13	6	19	0	1	20	0	0
16	2103058	.	G	T	13	7	20	0	1	21	0	0
16	2103088	.	G	A	1	6	7	0	19	26	0	0
16	2103167	.	C	T	11	9	20	0	0	20	0	0
16	2103209	.	C	T	7	8	15	0	1	16	0	0
16	2103241	.	T	A	9	12	21	0	0	21	0	0
16	2103268	.	A	T	13	14	27	0	1	28	0	0
16	2103307	.	T	C	13	14	27	0	2	29	0	0
16	2103714	.	A	T	5	4	9	0	0	9	0	0
16	2103783	.	A	T	1	3	4	0	0	4	0	0
16	2103854	.	C	T	1	2	3	0	0	3	0	0
16	2103855	.	A	G	1	2	3	0	0	3	0	0
16	2104114	.	T	A	1	5	6	1	1	8	0	0
16	2104181	.	T	A	4	2	6	0	0	6	0	0
16	2104312	.	A	C	11	12	23	0	0	23	0	0
16	2104400	.	T	C	15	15	30	0	2	32	0	0
16	2104597	.	T	C	25	24	49	1	5	55	0	0
16	2104604	.	A	G	25	3	28	1	26	55	0	0
16	2353020	.	C	A	3	4	7	0	1	8	0	0
16	2353023	.	T	C	3	4	7	0	2	9	0	0
16	2353191	.	C	A	3	5	8	0	0	8	0	0
16	2360324	.	C	T	4	2	6	0	1	7	0	0
16	2365716	.	G	A	3	3	6	0	1	7	0	0
16	2368422	.	T	C	2	0	2	0	6	8	0	0
16	2373689	.	T	C	4	2	6	0	0	6	0	0
16	2380735	.	G	A	3	3	6	0	0	6	0	0
16	2382011	.	G	T	4	5	9	0	0	9	0	0
16	2388216	.	A	G	2	6	8	0	0	8	0	0
16	2388237	.	A	C	2	0	2	0	4	6	0	0
16	2472263	.	G	A	13	8	21	0	2	23	0	0
16	2472284	.	T	C	14	7	21	0	0	21	0	0
16	2484064	.	C	T	1	9	10	0	18	28	0	0
16	2485904	.	G	A	11	9	20	0	0	20	0	0
16	2494323	.	T	C	7	0	7	0	11	18	0	0
16	2495649	.	G	C	12	4	16	0	0	16	0	0
16	2517184	.	G	T	8	8	16	0	1	17	0	0
16	2519056	.	T	C	12	4	16	0	0	16	0	0
16	2519071	.	T	C	11	4	15	0	0	15	0	0
16	2525891	.	A	G	6	4	10	0	0	10	0	0
16	2526035	.	C	T	7	2	9	0	1	10	0	0
16	2539405	.	G	A	2	2	4	0	0	4	0	0
16	2540235	.	G	A	1	7	8	0	0	8	0	0
16	2542782	.	G	C	7	6	13	0	0	13	0	0
16	2558252	.	G	C	1	3	4	0	0	4	0	0
16	2558549	.	G	A	1	2	3	0	0	3	0	0
16	2567316	.	A	G	5	0	5	0	10	15	0	0
16	2568847	.	G	A	0	11	11	0	11	22	0	0
16	2574963	.	C	T	10	4	14	0	1	15	0	0
16	2577717	.	T	A	8	6	14	0	2	16	0	0
16	2578771	.	G	A	0	11	11	0	13	24	0	0
16	2580255	.	T	A	11	13	24	0	1	25	0	0
16	2637673	.	T	C	3	0	3	0	3	6	0	0
16	2637703	.	C	A	2	2	4	0	1	5	0	0
16	2638507	.	G	C	2	2	4	0	0	4	0	0
16	2640406	.	G	A	2	2	4	0	1	5	0	0
16	2647072	.	C	T	2	4	6	0	0	6	0	0
16	4110125	.	T	A	2	3	5	0	0	5	0	0
16	4115198	.	C	T	2	5	7	0	0	7	0	0
16	4115237	.	A	G	2	4	6	0	0	6	0	0
16	4118991	.	G	A	3	4	7	0	0	7	0	0
16	4119048	.	C	T	1	6	7	0	0	7	0	0
16	4126903	.	C	A	5	8	13	0	0	13	0	0
16	4138698	.	G	A	2	2	4	0	0	4	0	0
16	4163503	.	C	T	5	4	9	0	0	9	0	0
16	4168036	.	T	A	8	2	10	1	4	15	0	0
16	4186458	.	G	A	0	2	2	0	1	3	0	0
16	4189867	.	G	A	0	3	3	0	1	4	0	0
16	4190052	.	A	T	6	3	9	0	0	9	0	0
16	4197130	.	T	A	4	7	11	0	0	12	1	0
16	4202038	.	C	T	9	6	15	0	0	15	0	0
16	4202081	.	T	C	11	10	21	0	0	21	0	0
16	4287757	.	C	G	8	4	12	0	1	13	0	0
16	4287936	.	C	T	0	3	3	0	7	10	0	0
16	4288960	.	T	C	5	2	7	0	1	8	0	0
16	4289022	.	A	T	4	2	6	0	0	6	0	0
16	4309183	.	A	G	7	2	9	0	1	10	0	0
16	4309192	.	T	G	6	3	9	0	0	9	0	0
16	4317343	.	A	T	5	2	7	0	1	8	0	0
16	4317516	.	A	C	2	2	4	0	0	4	0	0
16	4317534	.	T	A	1	3	4	0	1	5	0	0
16	4513775	.	A	G	1	5	6	0	0	6	0	0
16	4513876	.	A	T	6	6	12	0	0	12	0	0
16	4513901	.	T	C	8	9	17	0	0	17	0	0
16	4513920	.	C	G	7	5	12	0	2	15	1	0
16	4514114	.	T	C	4	0	4	0	7	11	0	0
16	4514467	.	A	T	9	3	12	0	0	12	0	0
16	4514592	.	A	C	5	5	10	0	0	10	0	0
16	4514594	.	T	A	4	5	9	0	0	9	0	0
16	4514633	.	T	C	7	7	14	0	0	14	0	0
16	4514666	.	T	C	7	0	7	0	4	11	0	0
16	4514795	.	T	C	2	3	5	1	0	6	0	0
16	4515614	.	G	T	3	2	5	0	0	5	0	0
16	4516801	.	C	T	1	2	3	0	0	3	0	0
16	4517456	.	C	T	3	5	8	0	0	8	0	0
16	4517477	.	G	A	3	5	8	0	0	8	0	0
16	4517606	.	A	G	6	6	12	0	0	12	0	0
16	4517704	.	C	T	4	3	7	0	0	7	0	0
16	4520595	.	C	T	0	2	2	0	0	2	0	0
16	4520609	.	G	A	1	2	3	0	0	3	0	0
16	4531827	.	A	G	5	7	12	0	0	12	0	0
16	4533768	.	T	C	11	10	21	0	0	21	0	0
16	4538422	.	A	G	12	9	21	0	0	21	0	0
16	4540864	.	G	C	9	8	17	0	2	19	0	0
16	4541022	.	A	C	3	10	13	0	0	13	0	0
16	4541061	.	T	G	6	5	11	0	0	11	0	0
16	4541085	.	T	C	8	3	11	0	0	11	0	0
16	4541233	.	T	C	16	7	23	0	0	23	0	0
16	4541250	.	C	T	15	8	23	0	0	23	0	0
16	4541281	.	A	T	8	4	12	0	0	12	0	0
16	4542051	.	T	C	6	2	8	1	1	10	0	0
16	4542252	.	A	G	5	3	8	0	0	8	0	0
16	4542518	.	C	T	3	16	19	0	12	31	0	0
16	4545454	.	T	C	7	12	19	0	1	20	0	0
16	4546606	.	A	C	7	0	7	0	15	22	0	0
16	4546651	.	G	A	8	7	15	0	0	15	0	0
16	4573450	.	G	T	4	4	8	0	1	9	0	0
16	4573458	.	C	T	5	4	9	0	0	9	0	0
16	4573556	.	A	T	4	6	10	0	1	11	0	0
16	4573588	.	A	G	5	7	12	0	0	12	0	0
16	4583847	.	A	T	2	2	4	0	1	5	0	0
16	4583864	.	A	G	3	3	6	0	0	6	0	0
16	4587184	.	C	T	1	4	5	1	0	6	0	0
16	4587187	.	G	A	1	5	6	1	0	7	0	0
16	4594818	.	A	G	1	4	5	0	0	5	0	0
16	4615993	.	C	A	9	5	14	0	0	14	0	0
16	4616071	.	A	T	14	9	23	0	0	23	0	0
16	4619598	.	A	T	15	11	26	0	0	26	0	0
16	4619614	.	A	G	16	7	23	0	0	23	0	0
16	4628953	.	T	C	2	6	8	0	0	8	0	0
16	4695323	.	A	C	4	4	8	0	3	11	0	0
16	4695368	.	T	A	5	2	7	0	4	11	0	0
16	4695530	.	A	G	6	7	13	0	2	15	0	0
16	4697599	.	A	G	6	0	6	0	3	9	0	0
16	4697713	.	A	G	6	0	6	0	3	9	0	0
16	4697821	.	G	A	6	7	13	0	0	13	0	0
16	4697829	.	C	G	7	6	13	0	1	14	0	0
16	4700766	.	T	C	7	8	15	0	0	15	0	0
16	4707211	.	G	T	1	8	9	0	6	15	0	0
16	4707381	.	A	T	3	2	5	0	0	5	0	0
16	4707480	.	G	A	4	3	7	0	0	7	0	0
16	4707544	.	G	A	3	2	5	0	0	5	0	0
16	4707638	.	A	T	1	1	2	0	1	3	0	0
16	4711553	.	T	C	1	2	3	0	0	3	0	0
16	4711574	.	A	T	1	3	4	0	0	4	0	0
16	4755816	.	A	T	6	11	17	0	1	18	0	0
16	4759113	.	G	A	2	7	9	0	0	9	0	0
16	4761133	.	T	C	5	0	5	0	3	8	0	0
16	4769909	.	A	C	1	0	1	0	3	4	0	0
16	4770454	.	A	C	2	2	4	0	0	4	0	0
16	4784020	.	T	C	1	2	3	0	0	3	0	0
16	4842203	.	T	A	9	8	17	0	0	17	0	0
16	4842308	.	A	G	4	3	7	0	0	7	0	0
16	4861083	.	T	C	13	6	19	0	3	22	0	0
16	4864771	.	G	A	5	6	11	0	1	12	0	0
16	4867445	.	C	T	9	7	16	0	0	16	0	0
16	4867487	.	C	T	11	6	17	0	2	19	0	0
16	4867496	.	A	G	10	9	19	0	1	20	0	0
16	4869973	.	G	A	10	7	17	0	0	17	0	0
16	4870180	.	C	T	8	14	22	0	1	23	0	0
16	4872260	.	C	T	6	11	17	0	0	17	0	0
16	4872320	.	G	A	5	3	8	0	0	8	0	0
16	4875198	.	A	G	9	4	13	0	0	13	0	0
16	4882945	.	G	A	13	7	20	0	0	20	0	0
16	4885458	.	T	A	11	9	20	0	3	23	0	0
16	4895423	.	T	C	16	16	32	0	0	32	0	0
16	5086725	.	G	A	16	4	20	0	2	22	0	0
16	5091076	.	G	A	11	3	14	0	2	16	0	0
16	5105119	.	T	G	11	5	16	0	1	17	0	0
16	5145459	.	T	C	14	14	28	0	0	28	0	0
16	5145599	.	C	A	22	13	35	0	2	37	0	0
16	5145622	.	G	A	24	16	40	0	3	43	0	0
16	5149298	.	T	C	13	18	31	0	1	32	0	0
16	5150817	.	G	A	1	1	2	0	1	3	0	0
16	5153956	.	T	C	25	11	36	0	3	39	0	0
16	5156563	.	G	A	0	7	7	0	3	10	0	0
16	5159283	.	A	G	10	3	13	0	1	14	0	0
16	5159289	.	C	T	8	4	12	0	0	12	0	0
16	5159328	.	T	C	10	6	16	0	1	17	0	0
16	5163275	.	T	C	8	5	13	0	1	14	0	0
16	5164569	.	C	T	7	3	10	0	0	10	0	0
16	5166015	.	G	A	0	10	10	0	23	33	0	0
16	5166030	.	C	T	19	10	29	0	2	31	0	0
16	5166288	.	G	A	15	13	28	0	1	29	0	0
16	5166332	.	T	A	21	14	35	0	0	35	0	0
16	5166351	.	T	C	22	14	36	0	0	36	0	0
16	5166546	.	G	A	9	13	22	1	0	23	0	0
16	5166645	.	A	C	16	12	28	4	1	33	0	0
16	5166719	.	A	G	8	7	15	0	0	15	0	0
16	5166805	.	A	G	15	1	16	1	4	21	0	0
16	5166889	.	G	T	10	8	18	0	1	19	0	0
16	5166977	.	G	T	5	6	11	0	0	11	0	0
16	5167010	.	A	G	5	1	6	0	5	11	0	0
16	5167030	.	G	A	9	5	14	0	0	14	0	0
16	5167257	.	A	G	8	7	15	0	1	16	0	0
16	5188029	.	A	C	4	4	8	0	0	8	0	0
16	5190168	.	C	T	4	3	7	0	0	7	0	0
16	5190210	.	C	T	8	4	12	0	0	12	0	0
16	5190590	.	A	G	7	6	13	0	1	14	0	0
16	5193682	.	C	T	1	8	9	0	0	9	0	0
16	5196813	.	C	A	3	8	11	0	0	11	0	0
16	5199264	.	A	G	1	3	4	0	0	4	0	0
16	5199307	.	C	T	2	2	4	0	1	5	0	0
16	5199381	.	C	T	8	3	11	0	0	11	0	0
16	5199399	.	C	T	7	4	11	0	0	11	0	0
16	5199442	.	C	T	5	4	9	0	0	9	0	0
16	5199503	.	C	T	6	6	12	0	0	12	0	0
16	5216548	.	G	A	11	5	16	0	2	18	0	0
16	5221622	.	T	A	10	8	18	0	1	19	0	0
16	5221680	.	A	C	4	4	8	0	0	8	0	0
16	5221888	.	T	C	8	10	18	0	0	18	0	0
16	5223206	.	G	A	15	7	22	0	1	23	0	0
16	5223740	.	C	T	5	8	13	0	0	13	0	0
16	5223880	.	G	C	1	19	20	0	9	29	0	0
16	5224375	.	G	C	3	13	16	0	18	34	0	0
16	5224429	.	A	T	18	21	39	0	2	41	0	0
16	5230627	.	G	A	4	15	19	0	8	27	0	0
16	5230782	.	A	T	9	8	17	0	2	19	0	0
16	5251770	.	G	A	3	2	5	0	0	5	0	0
16	5475185	.	C	T	2	2	4	0	0	4	0	0
16	5475197	.	C	T	2	2	4	0	0	4	0	0
16	5491815	.	C	T	2	3	5	0	0	5	0	0
16	5492649	.	C	T	2	2	4	0	0	4	0	0
16	5496522	.	T	C	2	5	7	0	0	7	0	0
16	5496904	.	T	G	4	2	6	0	0	6	0	0
16	5579767	.	C	T	1	2	3	0	4	7	0	0
16	5604765	.	A	T	6	3	9	0	0	9	0	0
16	5604846	.	T	C	2	2	4	0	0	4	0	0
16	5604865	.	A	G	2	1	3	0	2	5	0	0
16	5612617	.	A	T	1	5	6	0	1	7	0	0
16	5612631	.	A	T	2	4	6	0	1	7	0	0
16	5620883	.	C	T	2	2	4	0	0	4	0	0
16	5623099	.	T	C	1	2	3	0	0	3	0	0
16	5624209	.	C	T	3	2	5	0	0	5	0	0
16	5633503	.	G	C	0	2	2	0	6	8	0	0
16	5678244	.	A	G	1	2	3	0	0	3	0	0
16	5693532	.	T	C	3	3	6	0	0	6	0	0
16	5697039	.	C	T	6	3	9	0	0	9	0	0
16	5700534	.	C	T	7	3	10	0	2	12	0	0
16	5700577	.	T	A	3	1	4	0	2	6	0	0
16	5700578	.	T	C	4	2	6	0	0	6	0	0
16	5700646	.	T	C	2	2	4	0	1	5	0	0
16	5700689	.	G	A	0	3	3	0	4	7	0	0
16	5702807	.	C	T	5	7	12	0	1	13	0	0
16	5702891	.	T	G	5	4	9	0	0	9	0	0
16	5702906	.	T	C	5	5	10	0	0	10	0	0
16	5705811	.	G	T	0	4	4	0	4	8	0	0
16	5710369	.	C	T	5	7	12	0	0	12	0	0
16	5710627	.	G	T	2	5	7	0	0	7	0	0
16	5710652	.	G	T	1	6	7	0	1	8	0	0
16	5776274	.	T	C	18	19	37	0	1	38	0	0
16	5776356	.	C	T	24	22	46	0	0	46	0	0
16	5776371	.	T	G	22	18	40	0	0	40	0	0
16	5778882	.	A	G	21	21	42	0	0	42	0	0
16	5778913	.	T	C	18	21	39	0	3	42	0	0
16	5786889	.	C	T	3	6	9	0	0	9	0	0
16	5786890	.	A	G	3	6	9	0	0	9	0	0
16	5786945	.	G	A	9	6	15	0	0	15	0	0
16	5786989	.	C	T	1	7	8	0	12	20	0	0
16	5787185	.	A	T	6	5	11	0	3	14	0	0
16	5787435	.	T	C	15	6	21	0	1	22	0	0
16	5787506	.	T	A	11	8	19	0	0	19	0	0
16	5787562	.	G	A	12	5	17	0	0	17	0	0
16	5787671	.	G	C	12	6	18	0	0	18	0	0
16	5787931	.	A	G	1	2	3	0	1	4	0	0
16	5787981	.	T	C	4	5	9	0	0	9	0	0
16	5788079	.	A	G	4	5	9	0	0	9	0	0
16	5788163	.	T	A	6	9	15	0	0	15	0	0
16	5788405	.	A	T	9	3	12	0	1	13	0	0
16	5788410	.	A	T	8	3	11	0	0	11	0	0
16	5788655	.	T	C	8	4	12	0	0	12	0	0
16	5795721	.	C	T	1	5	6	0	6	12	0	0
16	5808789	.	C	T	1	3	4	0	2	6	0	0
16	5808802	.	A	G	3	4	7	0	1	8	0	0
16	5808910	.	T	C	5	13	18	0	1	19	0	0
16	5808931	.	G	A	5	10	15	0	0	15	0	0
16	5812610	.	C	T	0	4	4	0	4	8	0	0
16	5812703	.	G	A	2	3	5	0	2	7	0	0
16	5819132	.	A	G	2	6	8	0	0	8	0	0
16	5819209	.	T	A	9	4	13	0	0	13	0	0
16	5819970	.	T	A	8	5	13	0	0	13	0	0
16	6126477	.	T	A	1	2	3	0	0	3	0	0
16	6126525	.	T	C	2	3	5	0	0	5	0	0
16	6174231	.	T	C	3	2	5	0	0	5	0	0
16	6183022	.	A	C	17	20	37	0	7	44	0	0
16	6183658	.	T	G	35	32	67	0	2	69	0	0
16	6191622	.	C	G	29	30	59	1	2	62	0	0
16	6192811	.	A	G	22	27	49	0	1	50	0	0
16	6197212	.	T	C	18	18	36	0	2	38	0	0
16	6197593	.	G	A	17	21	38	0	1	39	0	0
16	6376437	.	C	G	0	2	2	0	2	4	0	0
16	6376446	.	A	G	1	3	4	0	0	4	0	0
16	6387037	.	G	A	18	25	43	0	0	43	0	0
16	6387121	.	G	A	28	22	50	0	2	52	0	0
16	6387143	.	A	C	39	3	42	0	19	61	0	0
16	6387157	.	A	C	37	23	60	0	2	62	0	0
16	6648351	.	G	A	1	2	3	0	0	3	0	0
16	6649785	.	G	A	0	4	4	0	3	7	0	0
16	6650087	.	C	T	1	2	3	0	0	3	0	0
16	6650631	.	C	A	5	2	7	0	0	7	0	0
16	6653139	.	G	T	5	4	9	0	0	9	0	0
16	6653508	.	C	A	5	2	7	0	0	7	0	0
16	6653875	.	G	T	7	3	10	0	0	10	0	0
16	6653883	.	A	G	7	3	10	0	0	10	0	0
16	6654152	.	T	C	2	2	4	0	0	4	0	0
16	6740784	.	C	T	1	2	3	0	0	3	0	0
16	6745636	.	T	C	2	2	4	0	1	5	0	0
16	6746003	.	C	T	3	2	5	0	2	7	0	0
16	6760432	.	T	G	3	0	3	0	2	5	0	0
16	6762134	.	T	A	1	3	4	0	0	4	0	0
16	6762166	.	A	C	1	2	3	0	1	4	0	0
16	6764962	.	T	C	2	2	4	0	0	4	0	0
16	6770441	.	A	G	4	2	6	0	0	6	0	0
16	6770455	.	G	A	5	2	7	0	0	7	0	0
16	6771841	.	T	C	4	5	9	0	1	10	0	0
16	6782653	.	T	C	4	5	9	0	1	10	0	0
16	6782680	.	T	C	4	6	10	0	0	10	0	0
16	6782896	.	A	T	5	4	9	0	0	9	0	0
16	6782918	.	T	C	6	5	11	0	0	11	0	0
16	6782948	.	T	C	6	3	9	0	0	9	0	0
16	6784609	.	C	G	5	5	10	0	0	10	0	0
16	6784791	.	T	C	3	4	7	0	0	7	0	0
16	6784821	.	A	G	4	2	6	0	1	7	0	0
16	6787491	.	G	A	2	8	10	0	6	16	0	0
16	6793312	.	C	T	6	5	11	0	0	11	0	0
16	6793333	.	C	G	7	4	11	0	0	11	0	0
16	6796096	.	C	T	1	4	5	0	0	5	0	0
16	6796105	.	G	A	0	6	6	0	2	8	0	0
16	6796195	.	A	G	9	4	13	0	0	13	0	0
16	6796279	.	T	C	3	6	9	0	1	10	0	0
16	6800033	.	G	A	8	6	14	0	0	14	0	0
16	6800127	.	A	G	5	0	5	0	6	11	0	0
16	6800140	.	C	T	7	5	12	0	0	12	0	0
16	6800263	.	G	A	2	2	4	0	0	4	0	0
16	6800289	.	G	A	3	3	6	0	0	6	0	0
16	6803410	.	C	T	4	3	7	0	0	7	0	0
16	6803429	.	T	C	6	7	13	0	2	15	0	0
16	6803725	.	T	C	24	16	40	0	2	42	0	0
16	6803736	.	G	C	25	14	39	0	2	42	1	0
16	6803887	.	A	G	20	19	39	0	2	41	0	0
16	6809872	.	A	G	24	23	47	0	1	48	0	0
16	6820725	.	G	A	10	13	23	0	1	24	0	0
16	6821332	.	A	G	7	12	19	0	1	20	0	0
16	6821465	.	C	T	0	14	14	0	10	24	0	0
16	6821995	.	T	C	12	0	12	0	13	25	0	0
16	6849625	.	A	G	5	3	8	0	0	8	0	0
16	6903350	.	T	A	2	2	4	0	1	5	0	0
16	6923646	.	A	T	4	3	7	0	3	10	0	0
16	6923836	.	A	G	5	2	7	0	0	7	0	0
16	6926751	.	C	T	4	2	6	0	0	6	0	0
16	6929670	.	C	A	4	2	6	0	1	7	0	0
16	6929671	.	A	T	4	3	7	0	0	7	0	0
16	6929812	.	C	T	6	6	12	0	0	12	0	0
16	6929832	.	G	A	6	5	11	0	2	13	0	0
16	6929860	.	G	A	7	5	12	0	0	12	0	0
16	6929886	.	C	G	5	3	8	0	0	8	0	0
16	6932083	.	A	G	6	0	6	0	3	9	0	0
16	6932477	.	G	A	5	3	8	0	0	8	0	0
16	6932820	.	T	A	4	2	6	0	0	6	0	0
16	6932886	.	A	T	5	2	7	0	0	7	0	0
16	6933016	.	T	C	8	6	14	0	0	14	0	0
16	6933037	.	C	G	7	4	11	0	0	11	0	0
16	6933057	.	T	C	4	2	6	0	1	7	0	0
16	6938038	.	A	T	1	2	3	0	0	3	0	0
16	6938057	.	C	T	0	2	2	0	1	3	0	0
16	6944603	.	G	T	1	2	3	0	0	3	0	0
16	6944713	.	G	T	4	4	8	0	1	9	0	0
16	6944720	.	A	G	6	7	13	0	2	15	0	0
16	6944766	.	T	C	14	16	30	0	1	31	0	0
16	6947998	.	T	C	21	24	45	0	1	46	0	0
16	7376648	.	C	T	2	5	7	0	0	7	0	0
16	7376900	.	A	G	5	2	7	0	0	7	0	0
16	7385689	.	C	T	6	3	9	0	0	9	0	0
16	7385807	.	C	T	4	6	10	0	0	10	0	0
16	7415215	.	G	A	11	13	24	0	0	24	0	0
16	7415254	.	T	A	15	13	28	0	0	28	0	0
16	7415423	.	C	A	12	9	21	0	1	22	0	0
16	7415435	.	G	A	10	9	19	0	1	20	0	0
16	7415542	.	A	T	14	7	21	0	6	27	0	0
16	7415559	.	C	A	13	10	23	0	1	24	0	0
16	7415761	.	G	A	18	5	23	0	0	23	0	0
16	7415793	.	G	A	17	8	25	0	2	27	0	0
16	7416236	.	C	T	8	9	17	0	1	18	0	0
16	7416320	.	C	T	12	9	21	0	1	22	0	0
16	7416352	.	T	A	5	9	14	0	2	16	0	0
16	7621002	.	T	G	1	2	3	0	0	3	0	0
16	7626589	.	T	C	16	11	27	0	0	27	0	0
16	7630612	.	T	C	15	11	26	0	0	26	0	0
16	7635527	.	C	T	24	12	36	0	1	37	0	0
16	7635721	.	T	A	18	14	32	0	0	32	0	0
16	7638788	.	T	C	21	8	29	0	1	30	0	0
16	7638815	.	A	T	19	12	31	0	2	33	0	0
16	7638828	.	A	G	18	1	19	0	13	32	0	0
16	7638866	.	A	T	26	16	42	0	0	42	0	0
16	7638979	.	C	T	25	13	38	0	4	42	0	0
16	7638984	.	C	A	22	12	34	0	8	43	1	0
16	7639085	.	A	C	30	16	46	0	1	47	0	0
16	7639100	.	T	A	29	20	49	0	1	50	0	0
16	7639125	.	A	G	42	11	53	0	0	53	0	0
16	7639527	.	C	T	25	22	47	0	1	48	0	0
16	7639534	.	G	C	2	26	28	0	23	51	0	0
16	7639621	.	C	T	23	22	45	0	1	46	0	0
16	7639643	.	A	T	23	22	45	0	2	47	0	0
16	7639684	.	A	G	16	20	36	0	1	37	0	0
16	7639774	.	T	A	16	20	36	0	2	38	0	0
16	7639856	.	T	C	9	27	36	0	5	41	0	0
16	7640116	.	A	G	24	19	43	0	0	43	0	0
16	7640127	.	G	A	1	23	24	0	22	46	0	0
16	7640390	.	C	T	28	14	42	1	1	44	0	0
16	7640410	.	A	G	27	16	43	1	1	45	0	0
16	7640425	.	T	A	28	20	48	1	1	50	0	0
16	7640757	.	T	A	14	14	28	0	3	31	0	0
16	7640999	.	G	A	1	2	3	0	0	3	0	0
16	7656878	.	T	G	2	2	4	0	0	4	0	0
16	7657306	.	C	A	1	2	3	0	0	3	0	0
16	7657352	.	G	A	2	2	4	0	0	4	0	0
16	7673244	.	T	C	1	4	5	0	0	5	0	0
16	7711556	.	C	A	5	2	7	0	0	7	0	0
16	7725555	.	A	T	4	6	10	0	0	10	0	0
16	7728408	.	C	T	3	6	9	0	0	9	0	0
16	7742867	.	A	G	7	5	12	0	0	12	0	0
16	7742872	.	C	T	7	2	9	0	1	10	0	0
16	7743598	.	T	A	1	3	4	0	0	4	0	0
16	7743687	.	A	G	4	5	9	0	0	9	0	0
16	7744638	.	C	T	3	3	6	0	0	6	0	0
16	7745027	.	C	A	4	2	6	0	0	6	0	0
16	7745053	.	C	G	5	4	9	0	0	9	0	0
16	7745464	.	T	G	2	2	4	0	0	4	0	0
16	7746040	.	G	C	3	2	5	0	2	8	1	0
16	7746152	.	A	T	4	6	10	0	0	10	0	0
16	7746153	.	G	A	4	6	10	0	0	10	0	0
16	7746193	.	G	A	4	6	10	0	0	10	0	0
16	7748211	.	G	A	3	2	5	0	0	5	0	0
16	7758386	.	C	T	1	4	5	0	0	5	0	0
16	7792786	.	C	T	3	2	5	0	0	5	0	0
16	7803023	.	T	C	7	8	15	0	0	15	0	0
16	7803298	.	T	C	2	6	8	0	0	8	0	0
16	7803340	.	T	C	1	4	5	0	0	5	0	0
16	7803418	.	G	C	2	4	6	0	0	6	0	0
16	7803560	.	A	G	9	5	14	0	0	14	0	0
16	7803627	.	T	A	10	6	16	0	0	16	0	0
16	7803765	.	C	G	9	6	15	0	0	15	0	0
16	7803782	.	C	A	0	2	2	0	10	12	0	0
16	7803905	.	G	C	6	0	6	0	4	10	0	0
16	7803923	.	T	A	5	3	8	0	0	8	0	0
16	7804081	.	T	A	4	8	12	0	0	12	0	0
16	7804269	.	A	T	5	4	9	0	0	10	1	0
16	7804270	.	C	T	4	5	9	0	0	9	0	0
16	7804355	.	C	G	7	4	11	0	1	12	0	0
16	7804391	.	T	C	7	0	7	0	4	11	0	0
16	7804458	.	A	C	7	6	13	0	1	14	0	0
16	7804990	.	A	C	5	2	7	0	0	7	0	0
16	7805423	.	C	T	1	2	3	0	6	9	0	0
16	7805524	.	C	A	1	3	4	0	2	6	0	0
16	7821241	.	C	T	6	1	7	0	1	8	0	0
16	7821244	.	G	A	5	2	7	0	1	8	0	0
16	7985896	.	T	A	3	2	5	0	0	5	0	0
16	7998969	.	A	G	0	3	3	0	2	5	0	0
16	8040833	.	C	G	13	5	18	0	0	18	0	0
16	8041179	.	A	G	3	3	6	0	0	6	0	0
16	8041234	.	G	A	0	2	2	0	6	8	0	0
16	8051941	.	T	C	14	0	14	0	11	25	0	0
16	8052033	.	T	C	9	14	23	0	1	24	0	0
16	8052049	.	G	A	9	17	26	1	2	29	0	0
16	8052145	.	C	A	16	15	31	0	3	34	0	0
16	8052537	.	C	T	12	11	23	0	0	23	0	0
16	8052606	.	T	C	16	0	16	0	13	29	0	0
16	8052651	.	T	C	19	13	32	0	0	32	0	0
16	8052673	.	G	C	20	0	20	0	16	36	0	0
16	8052747	.	A	G	16	10	26	0	0	26	0	0
16	8052831	.	T	A	8	10	18	0	0	18	0	0
16	8052866	.	C	A	0	5	5	3	7	15	0	0
16	8052909	.	T	A	1	7	8	6	1	15	0	0
16	8053206	.	T	G	7	11	18	0	2	20	0	0
16	8053403	.	C	T	15	11	26	0	1	27	0	0
16	8053485	.	C	T	11	10	21	0	1	22	0	0
16	8053716	.	A	G	12	16	28	0	3	31	0	0
16	8053717	.	T	C	13	16	29	0	2	31	0	0
16	8054260	.	T	G	1	8	9	0	0	9	0	0
16	8054389	.	C	T	1	5	6	0	7	13	0	0
16	8054434	.	T	C	7	0	7	0	5	12	0	0
16	8055037	.	A	G	2	8	10	0	0	10	0	0
16	8059585	.	T	C	7	9	16	0	0	16	0	0
16	8066237	.	A	C	5	8	13	0	0	13	0	0
16	8119672	.	G	A	9	5	14	0	0	14	0	0
16	8120033	.	G	A	11	5	16	0	1	17	0	0
16	8120171	.	C	T	6	4	10	0	1	11	0	0
16	8160484	.	T	C	1	2	3	0	0	3	0	0
16	8161555	.	C	T	2	2	4	0	0	4	0	0
16	8161573	.	C	A	4	4	8	0	1	9	0	0
16	8161591	.	G	A	5	5	10	0	1	11	0	0
16	8161708	.	G	A	1	8	9	0	2	11	0	0
16	8161875	.	C	T	3	4	7	0	0	7	0	0
16	8162024	.	G	A	0	2	2	0	1	3	0	0
16	8162046	.	G	A	0	3	3	0	2	5	0	0
16	8162356	.	T	G	1	3	4	0	0	4	0	0
16	8298642	.	T	C	2	2	4	0	0	4	0	0
16	8299025	.	T	A	5	2	7	0	0	7	0	0
16	8299037	.	A	T	7	1	8	0	0	8	0	0
16	8299123	.	T	A	10	4	14	0	1	15	0	0
16	8299302	.	G	A	2	5	7	0	0	7	0	0
16	8299308	.	T	A	4	5	9	0	0	9	0	0
16	8299410	.	T	A	4	2	6	0	0	6	0	0
16	8299462	.	G	C	4	2	6	0	0	6	0	0
16	8299793	.	T	A	7	3	10	1	0	11	0	0
16	8299794	.	G	A	7	3	10	1	0	11	0	0
16	8300255	.	G	A	5	2	7	0	0	7	0	0
16	8300471	.	G	C	4	2	6	0	0	6	0	0
16	8300905	.	T	C	3	2	5	0	0	5	0	0
16	8300989	.	A	G	2	2	4	0	0	4	0	0
16	8531299	.	C	T	3	6	9	0	0	9	0	0
16	8531571	.	A	G	6	5	11	2	0	13	0	0
16	8535966	.	C	T	0	3	3	0	2	5	0	0
16	8539523	.	C	T	1	3	4	0	0	4	0	0
16	8539885	.	C	A	1	2	3	0	0	3	0	0
16	8540664	.	G	T	3	3	6	0	0	6	0	0
16	8752017	.	T	A	16	27	43	0	0	43	0	0
16	8752091	.	A	G	14	21	35	0	2	37	0	0
16	8752223	.	C	T	13	10	23	0	2	25	0	0
16	8752316	.	G	T	20	13	33	0	1	34	0	0
16	8752334	.	C	T	3	15	18	0	19	37	0	0
16	8759975	.	G	A	15	24	39	0	0	39	0	0
16	8788386	.	T	C	6	7	13	0	1	14	0	0
16	8788446	.	A	G	10	8	18	0	2	20	0	0
16	8788629	.	T	C	9	0	9	0	6	15	0	0
16	8788659	.	G	C	7	4	11	0	0	11	0	0
16	8816122	.	G	A	5	4	9	0	1	10	0	0
16	8818958	.	T	C	6	3	9	0	1	10	0	0
16	8844580	.	A	G	5	2	7	0	0	7	0	0
16	8844586	.	C	A	5	2	7	0	0	7	0	0
16	8845738	.	T	G	2	5	7	0	0	7	0	0
16	8847272	.	T	C	3	6	9	0	0	9	0	0
16	9276038	.	T	A	9	10	19	0	1	20	0	0
16	9281297	.	T	C	4	10	14	0	1	15	0	0
16	9281534	.	G	A	7	11	18	0	0	18	0	0
16	9286987	.	A	G	5	2	7	0	0	7	0	0
16	9292698	.	T	C	5	0	5	0	6	11	0	0
16	9297728	.	C	T	3	5	8	0	1	9	0	0
16	9408972	.	G	A	0	2	2	0	3	5	0	0
16	9408980	.	A	G	3	0	3	0	2	5	0	0
16	9410978	.	C	G	1	2	3	0	1	4	0	0
16	9411083	.	G	A	1	2	3	0	0	3	0	0
16	9411749	.	G	A	4	4	8	0	0	8	0	0
16	9412024	.	A	T	3	2	5	0	0	5	0	0
16	9412048	.	T	C	3	3	6	0	0	6	0	0
16	9412125	.	A	G	3	3	6	0	0	6	0	0
16	9412151	.	T	C	2	3	5	0	0	5	0	0
16	9412177	.	A	G	2	0	2	0	4	6	0	0
16	9412302	.	C	T	5	3	8	0	1	9	0	0
16	9412401	.	C	T	3	8	11	0	0	11	0	0
16	9412615	.	T	G	3	4	7	0	0	7	0	0
16	9415063	.	C	T	3	4	7	0	0	7	0	0
16	9415697	.	T	C	6	4	10	0	0	10	0	0
16	9415749	.	G	A	3	6	9	0	0	9	0	0
16	9415793	.	C	T	3	6	9	0	0	9	0	0
16	9416017	.	A	G	2	3	5	0	1	6	0	0
16	9420260	.	A	G	2	2	4	0	0	4	0	0
16	9433766	.	T	A	1	2	3	0	0	3	0	0
16	9433808	.	T	A	1	2	3	0	0	3	0	0
16	9433915	.	C	T	1	4	5	0	2	7	0	0
16	9434023	.	G	A	10	6	16	0	1	17	0	0
16	9434036	.	G	A	7	3	10	0	4	14	0	0
16	9437789	.	G	A	10	11	21	0	0	21	0	0
16	9438075	.	A	G	5	7	12	1	0	13	0	0
16	9581981	.	T	C	2	3	5	0	0	5	0	0
16	9585301	.	A	C	1	4	5	0	0	5	0	0
16	9585373	.	G	T	0	5	5	0	2	7	0	0
16	9590394	.	G	T	3	4	7	0	0	7	0	0
16	9590406	.	A	G	2	4	6	0	1	7	0	0
16	9596127	.	C	T	6	4	10	0	1	11	0	0
16	9603382	.	T	C	8	9	17	0	0	17	0	0
16	9605806	.	A	G	5	7	12	0	0	12	0	0
16	9605947	.	A	G	15	6	21	0	0	21	0	0
16	9606011	.	G	T	8	3	11	0	4	15	0	0
16	9606024	.	C	T	9	3	12	0	0	12	0	0
16	9606048	.	G	A	5	2	7	0	1	8	0	0
16	9714080	.	G	A	7	5	12	0	0	12	0	0
16	9716237	.	C	A	2	2	4	0	0	4	0	0
16	9718216	.	G	A	9	3	12	0	1	13	0	0
16	9724878	.	A	T	8	5	13	0	1	14	0	0
16	9724909	.	T	A	8	3	11	1	1	13	0	0
16	9748874	.	C	G	1	5	6	0	0	6	0	0
16	9751693	.	A	C	8	7	15	0	0	15	0	0
16	9752999	.	A	G	3	2	5	0	0	5	0	0
16	9753005	.	C	G	3	2	5	0	0	5	0	0
16	9755701	.	G	A	9	5	14	0	0	14	0	0
16	9755719	.	G	T	1	5	6	0	7	13	0	0
16	9758164	.	C	T	5	5	10	1	0	11	0	0
16	9758944	.	G	A	0	7	7	0	6	13	0	0
16	9758958	.	T	C	3	6	9	0	1	10	0	0
16	9759073	.	C	G	0	10	10	0	0	10	0	0
16	9759244	.	A	G	8	5	13	0	0	13	0	0
16	9759336	.	C	T	5	2	7	0	0	7	0	0
16	9759376	.	C	T	8	3	11	0	0	11	0	0
16	9759464	.	C	G	6	8	14	0	0	14	0	0
16	9759554	.	G	A	2	9	11	0	8	19	0	0
16	9759605	.	A	T	10	6	16	0	2	18	0	0
16	9759820	.	T	A	6	5	11	4	0	15	0	0
16	9759842	.	A	G	6	3	9	4	0	13	0	0
16	9760006	.	C	T	9	3	12	0	0	12	0	0
16	9760564	.	C	T	6	4	10	0	0	10	0	0
16	9760597	.	A	G	6	0	6	0	4	10	0	0
16	9760718	.	T	C	4	3	7	0	0	7	0	0
16	9761004	.	A	G	6	10	16	0	1	17	0	0
16	9761141	.	G	A	0	11	11	0	10	21	0	0
16	9766586	.	A	C	3	4	7	0	0	7	0	0
16	9769846	.	C	T	9	7	16	0	0	16	0	0
16	9777613	.	A	G	8	13	21	0	0	21	0	0
16	9777788	.	G	T	1	3	4	0	0	4	0	0
16	9777789	.	C	T	1	3	4	0	0	4	0	0
16	9781031	.	T	C	21	12	33	0	2	35	0	0
16	9785860	.	G	A	22	18	40	0	0	40	0	0
16	9785868	.	T	G	21	23	44	0	0	44	0	0
16	9786036	.	A	C	25	5	30	0	0	30	0	0
16	9786040	.	G	A	3	4	7	0	23	30	0	0
16	9787392	.	T	A	15	5	20	0	1	21	0	0
16	9787620	.	G	A	3	3	6	0	0	6	0	0
16	9788005	.	C	T	23	18	41	0	1	42	0	0
16	9788019	.	T	A	22	19	41	0	0	41	0	0
16	9788110	.	C	T	6	4	10	0	1	11	0	0
16	9788194	.	A	C	3	7	10	1	0	11	0	0
16	9788486	.	G	A	9	13	22	0	1	23	0	0
16	9789007	.	A	T	15	10	25	0	0	25	0	0
16	9789317	.	T	C	13	14	27	0	3	30	0	0
16	9789984	.	T	C	10	18	28	0	0	28	0	0
16	9797177	.	A	G	1	2	3	0	0	3	0	0
16	9807425	.	C	A	2	6	8	0	0	8	0	0
16	9807463	.	A	G	2	4	6	0	2	8	0	0
16	9807475	.	C	T	3	4	7	0	1	8	0	0
16	9833887	.	T	A	33	16	49	1	4	54	0	0
16	9833889	.	C	A	34	18	52	1	1	54	0	0
16	9833936	.	A	G	19	27	46	0	4	50	0	0
16	9833974	.	G	A	28	22	50	0	5	55	0	0
16	9834135	.	A	C	22	16	38	0	1	39	0	0
16	9835250	.	C	G	18	21	39	0	1	40	0	0
16	9847182	.	T	C	20	8	28	1	0	29	0	0
16	9868953	.	C	T	14	24	38	0	2	40	0	0
16	9980299	.	A	T	12	11	23	1	0	24	0	0
16	10031572	.	C	A	1	6	7	0	0	7	0	0
16	10055952	.	A	G	6	7	13	0	1	14	0	0
16	10055956	.	G	C	8	0	8	0	5	13	0	0
16	10056127	.	T	G	6	8	14	0	0	14	0	0
16	10066194	.	G	A	7	2	9	0	2	11	0	0
16	10071730	.	G	A	3	6	9	0	0	9	0	0
16	10097362	.	T	C	1	0	1	0	6	7	0	0
16	10097449	.	G	A	4	3	7	0	0	7	0	0
16	10199573	.	C	A	7	3	10	0	0	10	0	0
16	10205161	.	G	T	3	4	7	0	0	7	0	0
16	10213761	.	A	T	1	2	3	0	0	3	0	0
16	10264382	.	T	A	1	4	5	0	0	5	0	0
16	10284582	.	A	T	4	5	9	0	0	9	0	0
16	10284593	.	T	A	3	7	10	0	0	10	0	0
16	10287677	.	T	G	2	4	6	0	0	6	0	0
16	10288311	.	G	C	2	7	9	0	1	10	0	0
16	10288859	.	A	T	2	5	7	0	0	7	0	0
16	10288882	.	T	A	2	7	9	0	1	10	0	0
16	10288951	.	G	A	2	4	6	0	0	6	0	0
16	10288998	.	G	A	1	5	6	0	0	6	0	0
16	10292782	.	A	G	4	3	7	0	0	7	0	0
16	10325723	.	G	A	1	4	5	0	10	15	0	0
16	10325732	.	T	C	3	12	15	0	1	16	0	0
16	10325870	.	C	T	10	5	15	0	1	16	0	0
16	10325960	.	G	A	1	9	10	0	14	24	0	0
16	10326305	.	G	A	2	13	15	0	18	33	0	0
16	10326704	.	C	T	28	18	46	0	3	49	0	0
16	10326737	.	A	G	28	19	47	0	2	49	0	0
16	10326990	.	G	A	3	21	24	0	18	42	0	0
16	10326993	.	A	T	20	19	39	0	2	41	0	0
16	10327128	.	C	T	20	12	32	0	5	37	0	0
16	10327530	.	C	A	14	8	22	0	0	22	0	0
16	10337945	.	A	T	3	6	9	0	0	9	0	0
16	10337988	.	C	T	4	3	7	0	0	7	0	0
16	10338166	.	A	C	0	4	4	0	1	5	0	0
16	10338171	.	G	A	1	5	6	0	0	6	0	0
16	10338255	.	C	G	3	3	6	0	0	6	0	0
16	10338290	.	G	A	1	1	2	0	5	7	0	0
16	10338384	.	G	A	0	2	2	0	2	4	0	0
16	10339196	.	A	G	1	0	1	0	2	3	0	0
16	10339436	.	T	C	4	3	7	0	0	7	0	0
16	10339872	.	G	T	4	4	8	0	0	8	0	0
16	10340349	.	G	A	7	6	13	0	0	13	0	0
16	10340399	.	A	T	4	5	9	0	1	10	0	0
16	10340840	.	G	A	6	7	13	0	2	15	0	0
16	10340941	.	T	C	2	12	14	0	0	14	0	0
16	10341452	.	G	A	1	4	5	0	0	5	0	0
16	10341470	.	G	A	5	3	8	0	1	9	0	0
16	10341508	.	A	G	7	4	11	0	1	12	0	0
16	10341548	.	G	A	5	3	8	0	2	10	0	0
16	10341778	.	C	A	8	4	12	0	0	12	0	0
16	10341881	.	A	G	4	8	12	0	0	12	0	0
16	10342275	.	C	T	5	2	7	0	1	8	0	0
16	10345223	.	T	C	5	7	12	0	0	12	0	0
16	10345720	.	A	G	11	10	21	0	0	21	0	0
16	10360935	.	T	C	1	2	3	0	0	3	0	0
16	10361049	.	T	C	2	2	4	0	0	4	0	0
16	10367171	.	G	A	5	2	7	0	1	8	0	0
16	10367475	.	C	A	9	7	16	0	3	19	0	0
16	10367499	.	C	T	7	10	17	0	0	17	0	0
16	10367674	.	C	T	13	8	21	0	1	22	0	0
16	10413601	.	C	T	3	4	7	0	0	7	0	0
16	10413611	.	A	G	3	3	6	0	1	7	0	0
16	10413777	.	T	A	2	8	10	0	1	11	0	0
16	10413815	.	C	A	13	4	17	0	0	17	0	0
16	10413957	.	T	C	8	7	15	0	0	15	0	0
16	10417124	.	G	C	7	13	20	0	0	20	0	0
16	10425842	.	C	T	3	3	6	0	0	6	0	0
16	10426247	.	T	A	4	3	7	0	0	7	0	0
16	10426327	.	C	T	2	7	9	0	2	11	0	0
16	10426612	.	T	A	3	3	6	0	0	6	0	0
16	10426975	.	A	T	3	3	6	0	0	6	0	0
16	10427590	.	G	C	4	5	9	0	0	9	0	0
16	10427722	.	A	T	5	5	10	0	0	10	0	0
16	10427746	.	T	G	5	6	11	0	0	11	0	0
16	10434856	.	G	T	4	2	6	0	0	6	0	0
16	10438508	.	G	A	1	2	3	0	0	3	0	0
16	10439032	.	A	C	5	2	7	0	0	7	0	0
16	10440612	.	G	A	0	5	5	0	2	7	0	0
16	10447453	.	C	T	5	4	9	0	0	9	0	0
16	10447477	.	T	C	3	4	7	0	1	8	0	0
16	10447923	.	C	A	4	3	7	0	0	7	0	0
16	10447983	.	C	T	4	5	9	0	0	9	0	0
16	10448008	.	G	C	3	2	5	0	1	6	0	0
16	10458749	.	A	G	3	3	6	0	0	6	0	0
16	10459006	.	C	A	2	6	8	0	0	8	0	0
16	10464534	.	A	C	5	10	15	0	0	15	0	0
16	10464570	.	T	C	4	8	12	0	0	12	0	0
16	10464571	.	C	T	8	4	12	0	0	12	0	0
16	10464609	.	A	G	4	5	9	0	0	9	0	0
16	10468283	.	T	C	8	7	15	0	0	15	0	0
16	10475006	.	C	T	16	6	22	0	1	23	0	0
16	10475645	.	C	T	13	8	21	0	0	21	0	0
16	10477905	.	A	G	8	11	19	0	2	21	0	0
16	10478061	.	G	T	10	21	31	0	2	33	0	0
16	10481425	.	C	T	17	10	27	0	1	28	0	0
16	10485445	.	G	A	16	17	33	0	0	33	0	0
16	10502065	.	A	G	12	8	20	0	0	20	0	0
16	10502069	.	A	G	7	10	17	0	0	17	0	0
16	10502169	.	G	A	3	5	8	0	1	9	0	0
16	10617196	.	C	T	2	2	4	0	0	4	0	0
16	10617265	.	T	C	2	5	7	0	0	7	0	0
16	10620018	.	G	A	1	4	5	0	2	7	0	0
16	10620111	.	G	A	3	3	6	0	0	6	0	0
16	10620129	.	T	C	4	2	6	0	0	6	0	0
16	10620183	.	T	C	2	3	5	0	0	5	0	0
16	10633215	.	A	G	5	3	8	0	0	8	0	0
16	10633287	.	C	A	5	10	15	0	0	15	0	0
16	10634013	.	A	G	3	0	3	0	7	10	0	0
16	10634027	.	A	G	3	0	3	0	9	12	0	0
16	10634460	.	T	C	3	4	7	0	0	7	0	0
16	10634510	.	C	T	3	2	5	0	0	5	0	0
16	10634568	.	A	T	4	2	6	0	0	6	0	0
16	10635148	.	G	A	3	2	5	0	1	6	0	0
16	10635942	.	A	G	8	7	15	0	0	15	0	0
16	10636003	.	A	G	8	8	16	0	0	16	0	0
16	10636168	.	C	T	7	10	17	0	0	17	0	0
16	10636173	.	A	G	13	4	17	0	0	17	0	0
16	10636577	.	G	A	13	8	21	0	0	21	0	0
16	10636947	.	T	G	10	1	11	0	5	16	0	0
16	10637050	.	C	T	7	14	21	0	0	21	0	0
16	10637259	.	A	G	11	15	26	0	5	31	0	0
16	10637510	.	T	C	10	6	16	0	0	16	0	0
16	10637701	.	T	A	3	3	6	1	0	7	0	0
16	10637705	.	A	C	3	4	7	1	0	8	0	0
16	10724517	.	C	T	2	4	6	0	0	6	0	0
16	10724845	.	G	C	3	4	7	0	1	8	0	0
16	10724876	.	G	A	3	3	6	0	0	6	0	0
16	10724883	.	A	G	3	4	7	0	0	7	0	0
16	10724941	.	T	C	2	2	4	0	0	4	0	0
16	10724995	.	C	G	2	0	2	0	2	4	0	0
16	10731388	.	G	C	7	4	11	0	1	12	0	0
16	10731717	.	C	G	4	5	9	0	0	9	0	0
16	10731819	.	T	G	3	3	6	0	1	7	0	0
16	10732053	.	A	T	2	3	5	0	0	5	0	0
16	10732197	.	T	A	3	2	5	0	0	5	0	0
16	10732313	.	C	A	3	3	6	0	0	6	0	0
16	10733751	.	A	G	1	5	6	0	0	6	0	0
16	10733829	.	G	C	3	4	7	0	1	8	0	0
16	10734190	.	T	C	6	5	11	0	2	13	0	0
16	10776922	.	A	C	12	6	18	0	2	20	0	0
16	10795620	.	G	A	9	18	27	0	1	28	0	0
16	10795647	.	T	C	11	9	20	0	1	21	0	0
16	10798995	.	A	T	17	13	30	0	0	31	1	0
16	10801121	.	G	A	10	15	25	1	0	26	0	0
16	10801374	.	T	C	11	16	27	0	1	28	0	0
16	10801422	.	G	A	19	9	28	0	0	28	0	0
16	10801682	.	C	T	11	9	20	0	0	20	0	0
16	10801772	.	C	T	12	9	21	0	1	22	0	0
16	10804843	.	T	C	19	18	37	1	1	39	0	0
16	10804862	.	A	T	20	16	36	1	1	38	0	0
16	10804878	.	C	T	24	16	40	0	1	41	0	0
16	10806318	.	C	T	23	18	41	1	0	42	0	0
16	10807471	.	A	G	22	19	41	0	3	44	0	0
16	10813138	.	A	C	32	21	53	0	1	54	0	0
16	10815877	.	T	C	36	25	61	0	1	62	0	0
16	10815907	.	A	G	36	2	38	0	28	66	0	0
16	10820667	.	T	C	39	26	65	0	5	70	0	0
16	10829019	.	T	C	10	15	25	0	0	25	0	0
16	10829139	.	A	G	9	16	25	0	1	26	0	0
16	10829235	.	G	A	1	10	11	0	0	11	0	0
16	10829276	.	T	A	21	6	27	0	1	28	0	0
16	10829872	.	G	C	5	11	16	0	1	17	0	0
16	10830309	.	T	A	12	7	19	0	0	19	0	0
16	10830431	.	G	A	8	16	24	0	1	25	0	0
16	10832217	.	C	T	6	3	9	0	0	9	0	0
16	10833987	.	G	A	11	7	18	0	0	18	0	0
16	10833993	.	C	T	1	11	12	0	7	19	0	0
16	10834715	.	A	C	4	13	17	0	0	17	0	0
16	10841177	.	A	G	8	7	15	0	1	16	0	0
16	10843402	.	A	G	8	0	8	0	9	17	0	0
16	10856130	.	A	G	13	7	20	0	0	20	0	0
16	10859434	.	C	T	32	23	55	0	3	58	0	0
16	10859435	.	T	C	33	23	56	0	3	59	0	0
16	10862159	.	T	A	20	22	42	0	2	44	0	0
16	10862162	.	T	A	20	24	44	0	0	44	0	0
16	10862279	.	A	G	21	14	35	0	3	38	0	0
16	10862280	.	G	T	23	14	37	0	2	39	0	0
16	10862331	.	C	G	16	11	27	1	2	30	0	0
16	10862773	.	T	C	29	15	44	0	1	45	0	0
16	10919019	.	G	A	3	3	6	0	0	6	0	0
16	10919100	.	G	A	1	5	6	0	0	6	0	0
16	10919317	.	C	T	0	2	2	0	1	3	0	0
16	10987970	.	A	C	1	4	5	0	1	6	0	0
16	10989286	.	A	G	1	0	1	0	2	3	0	0
16	10989287	.	C	T	1	2	3	0	0	3	0	0
16	10990177	.	G	A	0	2	2	0	3	5	0	0
16	10990445	.	T	A	4	2	6	0	1	7	0	0
16	10990490	.	G	A	3	2	5	0	0	5	0	0
16	10990633	.	A	G	1	3	4	0	0	4	0	0
16	10991162	.	T	A	2	1	3	0	1	4	0	0
16	11140660	.	A	G	3	0	3	0	2	5	0	0
16	11142333	.	C	G	5	0	5	0	7	12	0	0
16	11142340	.	A	C	1	2	3	0	5	8	0	0
16	11222031	.	T	A	9	15	24	1	1	26	0	0
16	11965486	.	T	C	0	4	4	0	1	5	0	0
16	11965673	.	G	T	18	17	35	0	2	37	0	0
16	11965803	.	G	T	19	25	44	0	3	47	0	0
16	11965931	.	T	C	22	3	25	0	19	44	0	0
16	11970239	.	C	T	14	11	25	0	0	25	0	0
16	11974658	.	G	A	9	16	25	0	0	25	0	0
16	11974703	.	G	A	12	9	21	0	0	21	0	0
16	11974720	.	G	T	10	10	20	0	0	20	0	0
16	11978045	.	G	A	13	14	27	0	0	27	0	0
16	11980484	.	C	T	0	7	7	0	15	22	0	0
16	11982471	.	G	A	13	7	20	0	1	21	0	0
16	11982519	.	G	T	13	7	20	0	1	21	0	0
16	11985606	.	C	T	6	3	9	0	3	12	0	0
16	12064771	.	T	A	7	4	11	0	0	12	1	0
16	12064946	.	C	T	8	7	15	0	1	16	0	0
16	12065025	.	G	A	15	6	21	0	1	22	0	0
16	12065201	.	C	T	14	17	31	0	0	31	0	0
16	12065392	.	G	A	8	20	28	1	3	32	0	0
16	12073577	.	G	A	8	4	12	0	2	14	0	0
16	12078916	.	A	G	4	7	11	0	0	11	0	0
16	12078976	.	C	T	5	10	15	0	0	15	0	0
16	12078982	.	C	T	4	11	15	0	0	15	0	0
16	12092428	.	A	G	6	2	8	0	0	8	0	0
16	12095043	.	G	A	2	4	6	0	0	6	0	0
16	12097241	.	T	C	5	6	11	0	0	11	0	0
16	12097292	.	G	T	7	5	12	0	1	13	0	0
16	12097325	.	G	A	3	6	9	0	0	9	0	0
16	12097354	.	G	T	3	7	10	0	0	10	0	0
16	12102412	.	A	T	19	18	37	0	0	37	0	0
16	12102671	.	T	C	34	34	68	2	4	74	0	0
16	12102708	.	A	G	37	29	66	0	4	70	0	0
16	12103083	.	T	C	32	5	37	0	29	66	0	0
16	12103331	.	T	A	27	28	55	0	3	58	0	0
16	12103344	.	A	G	28	29	57	0	1	58	0	0
16	12103530	.	G	A	24	29	53	0	3	56	0	0
16	12103540	.	G	A	30	22	52	0	3	55	0	0
16	12103598	.	G	A	36	15	51	0	0	51	0	0
16	12103732	.	C	T	4	21	25	0	20	45	0	0
16	12103749	.	C	T	24	19	43	0	1	44	0	0
16	12103982	.	G	A	26	26	52	0	1	53	0	0
16	12104042	.	C	T	30	28	58	0	1	59	0	0
16	12104043	.	A	T	30	29	59	0	0	59	0	0
16	12104083	.	C	T	28	25	53	1	4	58	0	0
16	12104209	.	A	C	34	15	49	2	3	54	0	0
16	12104316	.	T	A	32	14	46	4	3	53	0	0
16	12104601	.	G	A	35	19	54	1	1	56	0	0
16	12104665	.	A	G	41	13	54	2	2	58	0	0
16	12104778	.	T	C	15	21	36	3	10	49	0	0
16	12105206	.	A	G	22	17	39	0	0	39	0	0
16	12105265	.	T	A	38	10	48	0	3	51	0	0
16	12105443	.	A	T	16	4	20	0	3	23	0	0
16	12105689	.	C	T	2	23	25	0	13	38	0	0
16	12105796	.	C	T	4	35	39	0	18	57	0	0
16	12114975	.	G	A	21	18	39	0	2	41	0	0
16	12117537	.	G	A	6	17	23	0	1	24	0	0
16	12117645	.	G	A	13	24	37	0	1	38	0	0
16	12117648	.	G	A	12	24	36	0	1	37	0	0
16	12118207	.	G	A	21	16	37	0	1	38	0	0
16	12118210	.	C	T	23	12	35	0	3	38	0	0
16	12135754	.	G	A	13	10	23	0	2	25	0	0
16	12138841	.	G	A	12	4	16	0	0	16	0	0
16	12138940	.	A	G	11	11	22	0	1	23	0	0
16	12162370	.	A	C	6	0	6	0	4	10	0	0
16	12173511	.	T	A	5	5	10	0	0	10	0	0
16	12174891	.	C	T	6	4	10	0	0	10	0	0
16	12174949	.	G	T	2	2	4	0	1	5	0	0
16	12175377	.	T	C	1	6	7	0	1	8	0	0
16	12175483	.	A	G	2	2	4	0	0	4	0	0
16	12245751	.	T	C	33	33	66	0	1	67	0	0
16	12245954	.	C	T	30	38	68	0	2	70	0	0
16	12254457	.	C	T	38	27	65	0	7	72	0	0
16	12254469	.	T	C	43	26	69	0	1	70	0	0
16	12254592	.	T	C	24	29	53	0	4	57	0	0
16	12254674	.	C	T	31	14	45	0	1	46	0	0
16	12254776	.	A	T	19	23	42	0	3	45	0	0
16	12256585	.	C	T	10	9	19	0	1	20	0	0
16	12256614	.	G	A	16	22	38	0	2	40	0	0
16	12256629	.	A	G	25	23	48	0	1	49	0	0
16	12256681	.	C	A	2	22	24	0	32	56	0	0
16	12256801	.	C	T	28	28	56	0	3	59	0	0
16	12256816	.	G	T	30	19	49	0	3	52	0	0
16	12257154	.	T	C	19	30	49	0	0	49	0	0
16	12257216	.	A	T	25	26	51	0	3	54	0	0
16	12257506	.	G	A	23	18	41	0	2	43	0	0
16	12257904	.	C	T	21	33	54	0	0	54	0	0
16	12257921	.	T	G	18	29	47	0	5	52	0	0
16	12258044	.	C	T	20	6	26	0	1	27	0	0
16	12258128	.	A	T	7	16	23	0	0	23	0	0
16	12258264	.	G	C	14	8	22	0	1	23	0	0
16	12258268	.	C	T	15	8	23	0	2	25	0	0
16	12258302	.	A	T	10	14	24	0	2	26	0	0
16	12258593	.	T	G	10	12	22	0	1	23	0	0
16	12258733	.	A	T	8	17	25	0	2	27	0	0
16	12258999	.	G	C	18	26	44	0	0	44	0	0
16	12259298	.	G	C	21	20	41	0	2	43	0	0
16	12259302	.	A	T	25	20	45	0	0	45	0	0
16	12259589	.	G	A	16	25	41	0	0	41	0	0
16	12259678	.	T	C	21	14	35	0	0	35	0	0
16	12259737	.	A	T	19	15	34	0	1	35	0	0
16	12260002	.	T	G	16	17	33	0	1	34	0	0
16	12260134	.	A	T	15	12	27	0	0	27	0	0
16	12260291	.	G	T	16	9	25	0	2	27	0	0
16	12261211	.	A	G	10	15	25	0	0	25	0	0
16	12261625	.	A	G	9	8	17	0	1	18	0	0
16	12262453	.	T	G	15	6	21	0	0	21	0	0
16	12262762	.	T	A	10	14	24	0	0	24	0	0
16	12263047	.	C	T	2	20	22	0	16	38	0	0
16	12263385	.	G	A	16	13	29	0	1	30	0	0
16	12264912	.	A	T	18	14	32	0	2	34	0	0
16	12264999	.	T	C	14	1	15	0	14	29	0	0
16	12265237	.	A	G	14	15	29	0	0	29	0	0
16	12265917	.	C	G	9	11	20	0	1	21	0	0
16	12266073	.	G	A	11	11	22	0	0	22	0	0
16	12267706	.	C	G	2	3	5	0	0	5	0	0
16	12273636	.	G	A	4	25	29	0	20	49	0	0
16	12276030	.	G	A	22	20	42	1	3	46	0	0
16	12276033	.	A	T	21	21	42	1	2	45	0	0
16	12276065	.	A	T	20	10	30	1	1	32	0	0
16	12276102	.	G	A	7	4	11	0	1	12	0	0
16	12286264	.	C	A	4	4	8	0	0	8	0	0
16	12292467	.	G	A	3	31	34	0	8	42	0	0
16	12292599	.	T	C	16	34	50	0	1	51	0	0
16	12292622	.	G	A	19	29	48	0	4	52	0	0
16	12292648	.	T	C	16	25	41	0	0	41	0	0
16	12294316	.	C	A	3	4	7	1	2	10	0	0
16	12475737	.	T	C	1	3	4	0	1	5	0	0
16	12475750	.	A	G	2	3	5	0	0	5	0	0
16	12477825	.	G	A	1	2	3	0	0	3	0	0
16	12477853	.	G	T	2	2	4	0	1	5	0	0
16	12487025	.	A	G	1	2	3	0	0	3	0	0
16	12632593	.	G	C	3	4	7	0	0	7	0	0
16	12632664	.	T	C	2	5	7	0	1	8	0	0
16	12636347	.	T	C	8	3	11	0	1	12	0	0
16	12636546	.	T	C	6	5	11	0	1	12	0	0
16	12637140	.	T	C	5	3	8	0	1	9	0	0
16	12637271	.	G	A	3	3	6	0	0	6	0	0
16	12637284	.	T	C	1	4	5	0	1	6	0	0
16	12637552	.	A	T	2	6	8	0	0	8	0	0
16	12637681	.	T	G	5	7	12	0	0	12	0	0
16	12637779	.	C	T	7	7	14	0	0	14	0	0
16	12637822	.	T	C	6	7	13	0	0	13	0	0
16	12637824	.	G	A	0	7	7	0	6	13	0	0
16	12638612	.	C	G	5	2	7	0	0	7	0	0
16	12638622	.	A	G	6	2	8	0	0	8	0	0
16	12639184	.	C	G	4	7	11	0	0	11	0	0
16	12639320	.	C	G	3	5	8	0	0	8	0	0
16	12639488	.	G	A	3	5	8	0	0	8	0	0
16	12730380	.	A	G	6	5	11	0	0	11	0	0
16	12738324	.	G	A	4	5	9	0	1	10	0	0
16	12738351	.	T	C	7	6	13	0	0	13	0	0
16	12740779	.	C	T	12	7	19	0	1	20	0	0
16	12740949	.	C	G	9	14	23	0	1	24	0	0
16	12743927	.	G	A	1	9	10	0	13	23	0	0
16	12755992	.	C	T	25	23	48	0	1	49	0	0
16	12756094	.	A	C	13	14	27	0	2	29	0	0
16	12756255	.	C	T	14	9	23	0	0	23	0	0
16	12764221	.	G	A	3	3	6	0	0	6	0	0
16	12794075	.	C	G	4	3	7	0	0	7	0	0
16	12807038	.	G	A	2	3	5	0	0	5	0	0
16	12807129	.	C	G	5	4	9	0	0	9	0	0
16	12814102	.	A	T	9	12	21	0	1	22	0	0
16	12816486	.	T	C	9	15	24	0	0	24	0	0
16	12816745	.	A	C	8	9	17	0	0	17	0	0
16	12816975	.	G	A	10	4	14	0	2	16	0	0
16	12818220	.	G	T	18	19	37	0	1	38	0	0
16	12820952	.	C	T	7	13	20	1	3	24	0	0
16	12821091	.	C	A	24	12	36	0	0	36	0	0
16	12821106	.	C	T	18	20	38	0	2	40	0	0
16	12821221	.	G	A	17	16	33	0	0	33	0	0
16	12821300	.	G	C	4	17	21	1	9	31	0	0
16	12821449	.	G	A	17	19	36	0	1	37	0	0
16	12821459	.	A	G	11	20	31	0	6	37	0	0
16	12821611	.	A	G	6	6	12	0	1	13	0	0
16	12821618	.	C	T	3	5	8	0	1	9	0	0
16	12882612	.	C	T	4	13	17	0	36	53	0	0
16	12883126	.	G	A	24	19	43	1	2	46	0	0
16	12883618	.	C	T	16	10	26	0	1	27	0	0
16	12884054	.	A	T	18	12	30	1	2	33	0	0
16	12884510	.	A	T	9	8	17	0	0	17	0	0
16	12884513	.	G	A	8	9	17	0	0	17	0	0
16	12953670	.	C	T	11	10	21	0	0	21	0	0
16	12963274	.	A	T	9	9	18	0	0	18	0	0
16	12963368	.	G	A	8	13	21	0	0	21	0	0
16	12963384	.	C	T	0	12	12	0	10	22	0	0
16	12963975	.	A	G	20	24	44	0	1	45	0	0
16	12967855	.	G	A	11	13	24	0	1	25	0	0
16	12981637	.	G	A	11	5	16	0	1	17	0	0
16	12984488	.	C	G	12	6	18	0	2	20	0	0
16	13038004	.	T	C	1	0	1	0	2	3	0	0
16	13049162	.	A	G	2	2	4	0	0	4	0	0
16	13179335	.	G	A	5	4	9	0	0	9	0	0
16	13180389	.	T	C	2	8	10	0	0	10	0	0
16	13181465	.	T	C	4	3	7	0	0	7	0	0
16	13569354	.	C	T	1	4	5	0	0	5	0	0
16	13569875	.	G	T	1	2	3	0	0	3	0	0
16	13600680	.	A	C	13	16	29	0	2	31	0	0
16	13601013	.	A	G	10	14	24	0	1	25	0	0
16	13601026	.	T	C	12	15	27	0	2	29	0	0
16	13601228	.	A	T	7	5	12	0	0	12	0	0
16	13601286	.	G	T	6	7	13	0	0	13	0	0
16	13601328	.	C	T	6	3	9	0	1	10	0	0
16	13601964	.	T	C	6	0	6	0	13	19	0	0
16	13602164	.	T	C	12	9	21	0	0	21	0	0
16	13602454	.	T	A	5	7	12	0	2	14	0	0
16	13602488	.	T	C	2	8	10	0	0	10	0	0
16	13602800	.	T	A	9	11	20	0	0	20	0	0
16	13602922	.	A	G	12	5	17	0	0	17	0	0
16	13603007	.	T	G	9	21	30	0	4	34	0	0
16	13606896	.	A	T	9	4	13	0	1	14	0	0
16	13610651	.	A	T	19	17	36	0	1	37	0	0
16	13610966	.	A	G	10	8	18	0	0	18	0	0
16	13611035	.	G	A	5	9	14	0	1	15	0	0
16	13612999	.	T	A	7	5	12	0	0	12	0	0
16	13613104	.	T	C	5	4	9	0	0	9	0	0
16	13613208	.	A	T	4	3	7	0	2	9	0	0
16	13613210	.	C	A	4	4	8	0	0	8	0	0
16	13616698	.	A	T	12	19	31	0	2	33	0	0
16	13617152	.	C	T	13	14	27	0	0	27	0	0
16	13617291	.	G	A	9	8	17	0	0	17	0	0
16	13618172	.	C	G	10	9	19	1	3	23	0	0
16	13618374	.	A	T	18	11	29	0	1	30	0	0
16	13618662	.	T	A	10	13	23	0	1	24	0	0
16	13620832	.	T	C	3	4	7	0	0	7	0	0
16	13621056	.	G	A	3	3	6	0	0	6	0	0
16	13621998	.	G	C	1	0	1	0	5	6	0	0
16	13622769	.	T	A	3	3	6	0	0	6	0	0
16	13622770	.	G	T	3	3	6	0	0	6	0	0
16	13623642	.	T	A	7	4	11	0	2	13	0	0
16	13643504	.	C	T	1	22	23	0	14	37	0	0
16	13643974	.	C	T	1	11	12	0	12	24	0	0
16	13644781	.	T	A	4	5	9	0	1	10	0	0
16	13673660	.	T	A	2	4	6	0	0	6	0	0
16	13673734	.	A	C	4	5	9	0	1	10	0	0
16	13674176	.	T	G	4	15	19	0	0	19	0	0
16	13679037	.	A	G	4	2	6	0	0	6	0	0
16	13680487	.	T	G	3	3	6	0	0	6	0	0
16	13685800	.	G	A	3	8	11	0	2	13	0	0
16	13701482	.	C	T	13	15	28	0	0	28	0	0
16	13701599	.	A	G	7	5	12	0	1	13	0	0
16	13706207	.	G	C	14	5	19	0	0	19	0	0
16	13721408	.	C	T	7	9	16	0	3	19	0	0
16	13729810	.	C	T	7	11	18	0	1	19	0	0
16	13741610	.	G	A	5	7	12	0	0	12	0	0
16	13743390	.	G	A	6	6	12	0	1	13	0	0
16	13780375	.	G	A	2	6	8	0	0	8	0	0
16	13789765	.	G	A	11	4	15	0	0	15	0	0
16	13818640	.	T	A	6	4	10	0	0	10	0	0
16	13818644	.	G	A	5	2	7	0	2	9	0	0
16	13818896	.	A	T	1	2	3	0	0	3	0	0
16	13826195	.	C	T	9	12	21	0	2	23	0	0
16	13833484	.	T	A	5	4	9	0	1	10	0	0
16	13841360	.	T	A	8	10	18	0	2	20	0	0
16	13845350	.	G	A	12	18	30	0	3	33	0	0
16	13845368	.	G	A	2	10	12	0	20	32	0	0
16	13845571	.	T	A	6	6	12	0	0	12	0	0
16	13855121	.	C	T	8	5	13	0	1	14	0	0
16	13855142	.	T	C	8	12	20	0	1	21	0	0
16	13855179	.	A	G	13	0	13	0	12	25	0	0
16	13855285	.	T	A	12	24	36	0	0	36	0	0
16	13855482	.	T	A	9	6	15	0	0	15	0	0
16	13856159	.	A	C	0	1	1	0	2	3	0	0
16	13856554	.	T	C	1	5	6	0	0	6	0	0
16	13858356	.	C	A	15	17	32	0	3	35	0	0
16	13858436	.	C	A	19	16	35	0	1	36	0	0
16	13858570	.	C	T	14	20	34	0	2	37	1	0
16	13858673	.	T	C	16	18	34	0	0	34	0	0
16	13858866	.	T	A	20	13	33	0	2	35	0	0
16	13860459	.	G	A	0	3	3	0	2	5	0	0
16	13883968	.	C	A	12	5	17	0	0	17	0	0
16	13883980	.	A	C	13	7	20	0	0	20	0	0
16	14010210	.	G	T	4	4	8	0	0	8	0	0
16	14010241	.	C	A	6	4	10	0	0	10	0	0
16	14010794	.	C	T	2	3	5	0	0	5	0	0
16	14021817	.	G	T	7	6	13	0	0	13	0	0
16	14022252	.	G	A	2	7	9	0	17	26	0	0
16	14022830	.	T	C	2	3	5	0	0	5	0	0
16	14022842	.	A	G	3	2	5	0	0	5	0	0
16	14029329	.	A	T	6	5	11	0	0	11	0	0
16	14029424	.	A	C	4	8	12	0	0	13	1	0
16	14029437	.	T	C	4	12	16	0	0	16	0	0
16	14055048	.	G	C	8	9	17	0	1	18	0	0
16	14055284	.	A	T	8	10	18	0	0	18	0	0
16	14095097	.	C	T	0	6	6	1	9	16	0	0
16	14115928	.	G	T	11	10	21	0	0	21	0	0
16	14115931	.	G	A	10	10	20	0	0	20	0	0
16	14133851	.	G	A	2	5	7	0	0	7	0	0
16	14133907	.	C	T	8	6	14	0	0	14	0	0
16	14154226	.	C	T	5	6	11	0	1	12	0	0
16	14154240	.	T	A	4	4	8	0	1	9	0	0
16	14154708	.	G	A	6	8	14	0	0	14	0	0
16	14154798	.	C	T	2	6	8	0	10	18	0	0
16	14154870	.	A	G	7	12	19	0	0	19	0	0
16	14155038	.	G	A	3	3	6	0	0	6	0	0
16	14155169	.	C	T	3	3	6	0	1	7	0	0
16	14155400	.	A	G	5	3	8	0	0	8	0	0
16	14155563	.	T	C	7	5	12	0	2	14	0	0
16	14155684	.	G	A	5	2	7	0	0	7	0	0
16	14155686	.	C	T	5	2	7	0	0	7	0	0
16	14156157	.	T	C	3	3	6	0	0	6	0	0
16	14156646	.	G	A	1	2	3	0	0	3	0	0
16	14156695	.	C	T	0	2	2	0	2	4	0	0
16	14156775	.	C	A	0	3	3	0	1	4	0	0
16	14157055	.	C	T	1	3	4	0	0	4	0	0
16	14157112	.	C	T	1	3	4	0	0	4	0	0
16	14157371	.	G	A	4	5	9	0	0	9	0	0
16	14202197	.	T	A	7	6	13	0	1	14	0	0
16	14209195	.	G	A	11	12	23	0	2	25	0	0
16	14209348	.	T	C	6	13	19	0	0	19	0	0
16	14210949	.	A	C	6	13	19	0	2	21	0	0
16	14212079	.	G	C	2	6	8	0	5	13	0	0
16	14214534	.	G	A	6	3	9	0	0	9	0	0
16	14214543	.	A	G	6	2	8	0	1	9	0	0
16	14220363	.	C	T	1	4	5	0	1	6	0	0
16	14227913	.	C	T	4	8	12	0	0	12	0	0
16	14228677	.	C	T	2	2	4	0	1	5	0	0
16	14228902	.	C	T	4	7	11	0	0	11	0	0
16	14229031	.	T	A	6	2	8	0	0	8	0	0
16	14229167	.	G	C	3	4	7	0	0	7	0	0
16	14229169	.	T	C	3	4	7	0	0	7	0	0
16	14229397	.	A	G	2	4	6	0	1	7	0	0
16	14229539	.	C	T	1	2	3	0	1	4	0	0
16	14229946	.	T	C	8	5	13	0	0	13	0	0
16	14229947	.	A	T	7	4	11	0	2	13	0	0
16	14230295	.	C	G	3	3	6	0	1	7	0	0
16	14230329	.	G	C	1	3	4	1	0	5	0	0
16	14230514	.	T	A	1	2	3	0	0	3	0	0
16	14230517	.	C	T	1	2	3	0	0	3	0	0
16	14230808	.	G	A	6	2	8	0	0	8	0	0
16	14230834	.	T	C	5	2	7	0	0	7	0	0
16	14231038	.	A	G	6	9	15	0	3	18	0	0
16	14231063	.	G	A	0	8	8	0	9	17	0	0
16	14231079	.	G	A	2	5	7	0	7	14	0	0
16	14231207	.	T	A	6	5	11	0	0	11	0	0
16	14231501	.	G	T	1	2	3	0	0	3	0	0
16	14231502	.	T	G	1	2	3	0	0	3	0	0
16	14231941	.	A	G	13	9	22	1	0	23	0	0
16	14231952	.	A	T	14	10	24	1	0	25	0	0
16	14232005	.	G	A	12	14	26	0	2	28	0	0
16	14266647	.	A	T	1	2	3	0	0	3	0	0
16	14269906	.	G	A	4	3	7	0	0	7	0	0
16	14277577	.	G	A	4	2	6	0	0	6	0	0
16	14416520	.	C	T	1	4	5	0	0	5	0	0
16	14416599	.	C	T	3	6	9	0	0	9	0	0
16	14588209	.	G	A	3	8	11	0	1	12	0	0
16	14588301	.	A	G	1	3	4	0	0	4	0	0
16	14588311	.	G	A	1	3	4	0	0	4	0	0
16	14597927	.	A	C	5	2	7	0	0	7	0	0
16	14627207	.	T	C	2	2	4	0	1	5	0	0
16	14627294	.	G	A	2	3	5	0	1	6	0	0
16	14638413	.	G	A	4	3	7	0	0	7	0	0
16	14664767	.	T	A	2	8	10	0	2	12	0	0
16	14670990	.	A	G	4	0	4	0	5	9	0	0
16	14670994	.	T	A	3	4	7	0	0	7	0	0
16	14671097	.	A	T	2	5	7	0	0	7	0	0
16	14671099	.	A	T	5	2	7	0	0	7	0	0
16	14671135	.	A	G	3	3	6	0	0	6	0	0
16	14671249	.	T	G	2	0	2	0	3	5	0	0
16	14675175	.	C	T	7	4	11	0	0	11	0	0
16	14675373	.	A	C	10	9	19	0	0	19	0	0
16	14675413	.	G	T	0	8	8	0	7	15	0	0
16	14675487	.	T	A	3	7	10	0	0	10	0	0
16	14675572	.	G	A	17	7	24	0	0	24	0	0
16	14865602	.	G	T	2	2	4	0	0	4	0	0
16	14901812	.	C	T	2	2	4	0	1	5	0	0
16	14973890	.	G	A	1	6	7	0	1	8	0	0
16	14973968	.	A	T	5	8	13	0	0	13	0	0
16	14973989	.	A	T	4	6	10	0	0	10	0	0
16	15019105	.	T	G	8	1	9	0	4	13	0	0
16	15031839	.	C	T	2	6	8	0	0	8	0	0
16	15034797	.	G	A	2	12	14	0	13	27	0	0
16	15037778	.	C	T	12	12	24	0	1	25	0	0
16	15048737	.	A	T	3	5	8	0	1	9	0	0
16	15049133	.	A	G	6	7	13	0	0	13	0	0
16	15049220	.	C	T	2	4	6	1	0	7	0	0
16	15049278	.	A	T	3	2	5	0	0	5	0	0
16	15049496	.	C	T	2	2	4	0	0	4	0	0
16	15049533	.	T	C	1	2	3	0	0	3	0	0
16	15050112	.	C	G	5	7	12	0	0	12	0	0
16	15050135	.	C	T	9	6	15	1	0	16	0	0
16	15050277	.	G	A	10	9	19	0	2	21	0	0
16	15050623	.	C	T	9	14	23	0	1	24	0	0
16	15114963	.	G	T	1	3	4	0	0	4	0	0
16	15133084	.	T	G	3	0	3	0	2	5	0	0
16	15133150	.	A	G	3	2	5	0	0	5	0	0
16	15143512	.	G	A	2	2	4	0	0	4	0	0
16	15165052	.	T	C	2	1	3	0	1	4	0	0
16	15165262	.	G	A	1	2	3	0	0	3	0	0
16	15168740	.	G	A	3	6	9	0	1	10	0	0
16	15184543	.	C	T	0	4	4	0	3	7	0	0
16	15262854	.	G	T	1	3	4	0	1	5	0	0
16	15262870	.	G	A	1	2	3	0	0	3	0	0
16	15944980	.	A	T	8	5	13	0	1	14	0	0
16	16041698	.	A	T	6	10	16	0	3	19	0	0
16	16042240	.	G	A	8	3	11	0	1	12	0	0
16	16043191	.	T	G	6	10	16	0	0	16	0	0
16	16043218	.	A	G	5	5	10	0	0	10	0	0
16	16069884	.	A	G	6	6	12	0	0	12	0	0
16	16103927	.	C	T	5	3	8	0	1	9	0	0
16	16120849	.	C	T	4	3	7	0	0	7	0	0
16	16165179	.	T	A	36	26	62	0	1	63	0	0
16	16165418	.	C	T	31	37	68	0	3	71	0	0
16	16182195	.	T	C	34	27	61	0	1	62	0	0
16	16210784	.	T	C	2	3	5	0	0	5	0	0
16	16232902	.	A	T	4	9	13	0	0	13	0	0
16	16232911	.	A	G	4	9	13	0	1	14	0	0
16	16232998	.	T	G	1	2	3	0	0	4	1	0
16	16233000	.	T	A	2	2	4	0	1	5	0	0
16	16233124	.	T	G	9	8	17	0	0	17	0	0
16	16233250	.	T	G	9	5	14	0	1	15	0	0
16	16233715	.	T	C	7	0	7	0	9	16	0	0
16	16233907	.	A	T	7	6	13	0	1	14	0	0
16	16233937	.	G	T	10	7	17	0	2	19	0	0
16	16233952	.	C	A	2	8	10	0	10	20	0	0
16	16234297	.	C	T	4	2	6	0	1	7	0	0
16	16234309	.	C	A	0	6	6	0	4	10	0	0
16	16234516	.	A	C	4	10	14	0	0	14	0	0
16	16234633	.	T	C	7	0	7	0	5	12	0	0
16	16234642	.	C	T	6	6	12	0	1	13	0	0
16	16234747	.	T	A	10	7	17	0	0	17	0	0
16	16234948	.	C	T	0	7	7	0	3	10	0	0
16	16235056	.	G	C	10	7	17	0	0	17	0	0
16	16237745	.	G	C	4	3	7	0	0	7	0	0
16	16266645	.	A	G	1	2	3	0	0	3	0	0
16	16266653	.	A	T	1	2	3	0	0	3	0	0
16	16267895	.	G	A	0	6	6	0	1	7	0	0
16	16267903	.	A	G	4	3	7	0	0	7	0	0
16	16268037	.	A	T	3	3	6	0	0	6	0	0
16	16268205	.	A	T	1	1	2	0	2	4	0	0
16	16268208	.	G	A	0	3	3	0	1	4	0	0
16	16269285	.	G	A	1	2	3	0	0	3	0	0
16	16269690	.	G	A	0	4	4	0	3	7	0	0
16	16269724	.	G	A	4	3	7	0	0	7	0	0
16	16269926	.	G	C	6	3	9	0	0	9	0	0
16	16269964	.	T	C	3	4	7	0	1	8	0	0
16	16270326	.	G	A	2	3	5	0	0	5	0	0
16	16270358	.	A	G	2	2	4	0	0	4	0	0
16	16270361	.	T	C	2	3	5	0	0	5	0	0
16	16276678	.	G	A	2	2	4	0	0	4	0	0
16	16276938	.	T	C	4	2	6	0	0	6	0	0
16	16277689	.	A	G	5	5	10	0	1	11	0	0
16	16277728	.	G	A	5	2	7	0	2	9	0	0
16	16277810	.	G	A	5	3	8	0	0	8	0	0
16	16277954	.	G	A	4	9	13	0	0	13	0	0
16	16278013	.	A	T	4	6	10	0	0	10	0	0
16	16278043	.	T	C	4	4	8	0	1	9	0	0
16	16278172	.	G	T	0	4	4	0	6	10	0	0
16	16278755	.	G	C	8	4	12	0	0	12	0	0
16	16278756	.	C	A	8	4	12	0	0	12	0	0
16	16281479	.	A	C	8	7	15	0	2	17	0	0
16	16281740	.	A	C	4	10	14	0	0	14	0	0
16	16281869	.	T	A	10	4	14	0	0	14	0	0
16	16283661	.	G	A	7	5	12	0	3	15	0	0
16	16284057	.	T	C	12	12	24	0	0	24	0	0
16	16284159	.	G	A	0	10	10	0	11	21	0	0
16	16284192	.	C	A	13	11	24	0	1	25	0	0
16	16289121	.	C	T	12	14	26	0	1	27	0	0
16	16297057	.	G	A	14	9	23	0	0	23	0	0
16	16302166	.	T	C	6	8	14	0	1	15	0	0
16	16302244	.	A	G	9	0	9	0	16	25	0	0
16	16302247	.	A	T	10	16	26	0	0	26	0	0
16	16302371	.	A	C	11	8	19	0	1	20	0	0
16	16302426	.	T	A	9	13	22	0	0	22	0	0
16	16302477	.	G	A	1	10	11	0	14	25	0	0
16	16302835	.	T	C	11	13	24	0	1	25	0	0
16	16303025	.	C	T	10	19	29	0	0	29	0	0
16	16303065	.	A	G	15	9	24	0	2	26	0	0
16	16303086	.	T	A	16	8	24	0	3	27	0	0
16	16303163	.	G	A	1	13	14	0	10	24	0	0
16	16303196	.	A	G	14	2	16	0	9	25	0	0
16	16303293	.	T	G	5	10	15	0	0	15	0	0
16	16547388	.	C	T	8	7	15	0	1	16	0	0
16	16553899	.	C	T	10	11	21	0	1	22	0	0
16	16554693	.	A	T	2	2	4	0	0	4	0	0
16	16554695	.	T	C	2	2	4	0	0	4	0	0
16	16555484	.	A	C	8	7	15	0	0	15	0	0
16	16555611	.	A	G	6	10	16	0	1	17	0	0
16	16555628	.	A	T	10	5	15	0	1	16	0	0
16	16556223	.	C	A	4	11	15	0	0	15	0	0
16	16565998	.	C	T	11	8	19	0	0	19	0	0
16	16569578	.	C	G	7	8	15	0	0	15	0	0
16	16586232	.	C	T	6	13	19	0	5	24	0	0
16	16586290	.	G	A	11	9	20	0	2	22	0	0
16	16589462	.	G	A	2	5	7	0	1	8	0	0
16	16589552	.	G	A	4	5	9	0	0	9	0	0
16	16590439	.	C	T	0	9	9	0	8	17	0	0
16	16597649	.	C	T	0	3	3	0	1	4	0	0
16	16597754	.	G	A	2	3	5	0	0	5	0	0
16	16597939	.	A	T	1	2	3	0	0	3	0	0
16	16598049	.	T	C	1	3	4	0	0	4	0	0
16	16598146	.	T	C	2	2	4	0	1	5	0	0
16	16598179	.	G	A	2	2	4	0	0	4	0	0
16	16598430	.	C	T	0	2	2	0	2	4	0	0
16	16603081	.	C	A	1	5	6	0	0	6	0	0
16	16913096	.	C	T	5	4	9	0	0	9	0	0
16	16913102	.	G	A	4	5	9	0	0	9	0	0
16	16920424	.	C	T	1	3	4	0	0	4	0	0
16	16921088	.	C	T	7	6	13	0	0	13	0	0
16	16921134	.	G	A	6	9	15	0	0	15	0	0
16	16923663	.	G	A	7	5	12	0	0	12	0	0
16	16924638	.	T	C	7	3	10	0	0	10	0	0
16	16928396	.	T	C	4	5	9	0	1	10	0	0
16	16928424	.	A	G	2	6	8	0	0	8	0	0
16	16932986	.	C	T	7	9	16	0	0	16	0	0
16	16939462	.	C	T	1	2	3	0	0	3	0	0
16	16940700	.	A	G	4	5	9	0	0	9	0	0
16	16940824	.	A	C	4	8	12	0	2	14	0	0
16	16941019	.	T	C	9	12	21	0	0	21	0	0
16	16941162	.	T	C	7	8	15	0	0	15	0	0
16	16941270	.	G	A	0	9	9	0	6	15	0	0
16	16941527	.	A	C	6	4	10	0	0	10	0	0
16	16941533	.	G	T	6	4	10	0	0	10	0	0
16	16941741	.	C	T	14	9	23	0	0	23	0	0
16	16941776	.	A	T	11	3	14	0	0	14	0	0
16	16941979	.	C	A	7	6	13	0	0	13	0	0
16	16942001	.	G	A	1	6	7	0	3	10	0	0
16	16942906	.	C	G	5	16	21	3	1	25	0	0
16	16943024	.	C	T	9	4	13	0	0	13	0	0
16	16943111	.	A	G	11	6	17	0	0	17	0	0
16	16943348	.	C	A	15	12	27	0	1	28	0	0
16	16943720	.	G	A	12	9	21	0	1	22	0	0
16	16943930	.	G	T	20	9	29	0	4	33	0	0
16	16944259	.	A	T	13	9	22	0	3	25	0	0
16	16944260	.	C	T	13	10	23	0	1	24	0	0
16	16944348	.	G	A	13	6	19	0	3	22	0	0
16	16944941	.	G	T	13	10	23	0	2	25	0	0
16	16945128	.	T	G	6	10	16	0	0	16	0	0
16	16945261	.	A	G	6	4	10	0	1	11	0	0
16	16985499	.	C	T	30	30	60	2	7	69	0	0
16	16985511	.	A	T	36	32	68	1	1	70	0	0
16	17066745	.	C	T	1	2	3	0	2	5	0	0
16	17070845	.	A	G	1	4	5	0	0	5	0	0
16	17120136	.	C	T	13	9	22	0	0	22	0	0
16	17122132	.	C	A	0	5	5	0	2	7	0	0
16	17161580	.	T	C	7	0	7	0	5	12	0	0
16	17161739	.	G	A	10	3	13	0	0	13	0	0
16	17161877	.	A	G	8	3	11	0	0	11	0	0
16	17162411	.	A	C	2	6	8	1	0	9	0	0
16	17162558	.	G	A	5	5	10	0	0	10	0	0
16	17192957	.	G	A	11	5	16	0	0	16	0	0
16	17193489	.	C	G	4	5	9	0	0	9	0	0
16	17193510	.	G	C	6	6	12	0	0	12	0	0
16	17195343	.	A	G	4	3	7	0	1	8	0	0
16	17234683	.	G	T	2	2	4	0	0	4	0	0
16	17235251	.	G	A	3	7	10	0	0	10	0	0
16	17252774	.	G	T	12	12	24	0	1	25	0	0
16	17253023	.	G	A	1	9	10	0	10	20	0	0
16	17253105	.	C	A	7	6	13	0	0	13	0	0
16	17253223	.	A	G	1	5	6	0	0	6	0	0
16	17253293	.	C	T	10	5	15	0	1	16	0	0
16	17253377	.	C	T	7	4	11	0	0	11	0	0
16	17256113	.	C	T	5	5	10	0	0	10	0	0
16	17256243	.	G	C	5	3	8	0	1	9	0	0
16	17302526	.	T	C	5	9	14	0	0	14	0	0
16	17302821	.	A	G	10	4	14	0	0	14	0	0
16	17305481	.	T	C	7	7	14	0	0	14	0	0
16	17305579	.	G	A	6	8	14	0	0	14	0	0
16	17305597	.	C	T	7	5	12	0	0	12	0	0
16	17305620	.	A	G	5	3	8	0	0	8	0	0
16	17316782	.	G	A	1	5	6	0	0	6	0	0
16	17442933	.	G	A	2	3	5	0	1	6	0	0
16	17465977	.	T	A	5	3	8	0	1	9	0	0
16	17466463	.	C	G	1	2	3	0	0	3	0	0
16	17466824	.	A	T	9	3	12	1	0	13	0	0
16	17549087	.	G	A	5	4	9	0	0	9	0	0
16	17549176	.	G	T	5	3	8	0	1	9	0	0
16	17550202	.	T	C	4	2	6	0	0	6	0	0
16	17551191	.	G	T	2	2	4	0	0	4	0	0
16	17580036	.	C	T	2	4	6	0	0	6	0	0
16	17585730	.	T	A	5	2	7	0	1	8	0	0
16	17646269	.	T	C	10	10	20	0	0	20	0	0
16	17798055	.	T	C	4	8	12	0	0	12	0	0
16	17798056	.	C	T	4	8	12	0	0	12	0	0
16	18142759	.	C	T	8	2	10	0	0	10	0	0
16	18142765	.	A	G	8	2	10	0	0	10	0	0
16	18535689	.	G	A	4	9	13	0	0	13	0	0
16	18568933	.	C	T	8	5	13	0	4	17	0	0
16	19124404	.	T	C	8	3	11	0	0	11	0	0
16	19124452	.	A	G	4	3	7	0	1	8	0	0
16	19126439	.	A	G	2	0	2	0	10	12	0	0
16	19136123	.	A	G	9	5	14	0	1	15	0	0
16	19136328	.	C	T	9	3	12	0	0	12	0	0
16	19143714	.	G	T	9	4	13	0	1	14	0	0
16	19145102	.	C	T	9	5	14	0	0	14	0	0
16	19150643	.	A	T	8	10	18	0	0	18	0	0
16	19150678	.	C	T	10	9	19	0	1	20	0	0
16	19151174	.	C	A	4	7	11	0	0	11	0	0
16	19151254	.	A	G	3	9	12	0	0	12	0	0
16	19151656	.	G	T	8	8	16	1	1	18	0	0
16	19151699	.	C	T	4	3	7	1	0	8	0	0
16	19182237	.	C	T	2	2	4	0	0	4	0	0
16	19538923	.	G	A	2	2	4	0	0	4	0	0
16	19732795	.	C	T	2	2	4	0	1	5	0	0
16	19840562	.	T	C	17	9	26	0	1	27	0	0
16	19840645	.	T	A	11	7	18	1	2	21	0	0
16	19840658	.	A	C	10	11	21	1	2	24	0	0
16	19840792	.	C	T	16	13	29	0	2	31	0	0
16	19841213	.	G	A	19	14	33	0	0	33	0	0
16	19841215	.	C	T	17	11	28	0	3	31	0	0
16	19841443	.	G	C	7	4	11	0	1	12	0	0
16	19841501	.	T	C	7	4	11	0	0	11	0	0
16	19841502	.	A	T	5	5	10	0	0	10	0	0
16	19841591	.	A	G	6	12	18	0	1	19	0	0
16	19841720	.	A	G	11	11	22	0	1	23	0	0
16	19841786	.	A	T	10	8	18	0	1	19	0	0
16	19841890	.	G	A	6	9	15	0	0	15	0	0
16	19841922	.	G	A	11	5	16	1	1	18	0	0
16	19842493	.	G	A	13	11	24	1	0	25	0	0
16	19842530	.	A	G	8	6	14	1	4	19	0	0
16	19843053	.	G	T	14	14	28	0	1	29	0	0
16	19843056	.	G	T	16	12	28	0	1	29	0	0
16	19850746	.	G	A	12	13	25	0	1	26	0	0
16	19853074	.	G	A	28	12	40	1	2	43	0	0
16	19853098	.	C	T	28	13	41	1	3	45	0	0
16	19853125	.	A	T	16	22	38	1	3	42	0	0
16	19853230	.	A	C	9	10	19	0	1	20	0	0
16	19854886	.	C	T	0	4	4	0	2	6	0	0
16	19861463	.	A	G	8	14	22	0	1	23	0	0
16	19861475	.	G	A	12	10	22	0	1	23	0	0
16	19864588	.	G	T	10	6	16	0	0	16	0	0
16	19878856	.	G	A	10	4	14	0	1	15	0	0
16	20055913	.	G	A	5	2	7	0	0	7	0	0
16	20121122	.	T	C	4	4	8	0	1	9	0	0
16	20134015	.	A	G	3	6	9	0	0	9	0	0
16	20135013	.	G	C	0	2	2	0	3	5	0	0
16	20140877	.	T	G	1	4	5	0	0	5	0	0
16	20151309	.	C	T	4	9	13	0	4	17	0	0
16	20151397	.	C	T	12	10	22	0	0	22	0	0
16	20151460	.	C	T	11	3	14	0	0	14	0	0
16	20151841	.	T	C	12	5	17	0	2	19	0	0
16	20151991	.	G	A	19	6	25	0	0	25	0	0
16	20152044	.	C	A	6	3	9	0	1	18	8	0
16	20152128	.	G	A	0	7	7	0	4	11	0	0
16	20152474	.	A	G	5	4	9	0	1	10	0	0
16	20161823	.	G	A	3	2	5	0	0	5	0	0
16	20187253	.	G	T	3	3	6	0	0	6	0	0
16	20194352	.	A	T	1	2	3	0	1	4	0	0
16	20234576	.	C	T	3	2	5	0	1	6	0	0
16	20234583	.	G	A	4	2	6	0	0	6	0	0
16	20238498	.	C	T	3	3	6	0	0	6	0	0
16	20238868	.	A	G	4	3	7	0	0	7	0	0
16	20238874	.	A	G	2	0	2	0	4	6	0	0
16	20238911	.	C	T	4	3	7	0	0	7	0	0
16	20265655	.	T	C	0	4	4	0	4	8	0	0
16	20265702	.	G	A	1	3	4	1	0	5	0	0
16	20266055	.	T	C	1	4	5	0	0	5	0	0
16	20266109	.	T	A	3	2	5	0	0	5	0	0
16	20266321	.	T	C	3	3	6	0	0	6	0	0
16	20266799	.	A	C	8	7	15	0	0	15	0	0
16	20267424	.	A	T	3	2	5	0	0	5	0	0
16	20267909	.	A	T	6	3	9	0	0	9	0	0
16	20268143	.	T	A	2	4	6	0	0	6	0	0
16	20268145	.	T	A	2	4	6	0	0	6	0	0
16	20268322	.	A	G	2	4	6	0	0	6	0	0
16	20268328	.	A	T	2	6	8	0	0	8	0	0
16	20268470	.	C	T	1	3	4	0	1	5	0	0
16	20289511	.	T	C	3	4	7	0	0	7	0	0
16	20289537	.	T	C	4	3	7	0	0	7	0	0
16	20318550	.	G	A	5	5	10	0	0	10	0	0
16	20324870	.	C	T	8	5	13	0	1	14	0	0
16	20324891	.	A	G	6	10	16	0	1	17	0	0
16	20328092	.	C	T	0	6	6	0	3	9	0	0
16	20402034	.	A	C	4	1	5	0	8	13	0	0
16	20492447	.	G	T	1	4	5	0	0	5	0	0
16	20497302	.	C	T	3	4	7	0	0	7	0	0
16	20499829	.	G	A	3	4	7	0	0	7	0	0
16	20499859	.	G	A	1	2	3	0	1	4	0	0
16	20512387	.	G	C	3	2	5	0	1	6	0	0
16	20512408	.	A	C	2	2	4	0	1	5	0	0
16	20512661	.	T	C	9	3	12	0	1	13	0	0
16	20513103	.	T	G	9	0	9	0	9	18	0	0
16	20513152	.	A	G	5	14	19	0	1	20	0	0
16	20800347	.	C	T	10	11	21	0	0	21	0	0
16	20806487	.	C	T	27	25	52	0	3	55	0	0
16	20813628	.	C	T	0	21	21	0	15	36	0	0
16	20822881	.	T	C	15	11	26	0	2	28	0	0
16	20824508	.	C	G	14	14	28	0	1	29	0	0
16	20824566	.	C	T	19	13	32	0	1	33	0	0
16	20826697	.	T	C	14	25	39	0	1	40	0	0
16	20826703	.	G	A	23	14	37	0	1	38	0	0
16	20836206	.	C	T	18	20	38	0	1	39	0	0
16	20836218	.	G	A	16	17	33	0	1	34	0	0
16	20855582	.	G	A	11	9	20	0	1	21	0	0
16	20855636	.	C	T	10	9	19	0	0	19	0	0
16	20889325	.	C	T	7	3	10	0	0	10	0	0
16	20889436	.	C	A	2	2	4	0	0	4	0	0
16	21038585	.	A	T	3	5	8	0	2	10	0	0
16	21038697	.	A	C	4	6	10	0	2	12	0	0
16	21038801	.	T	A	8	13	21	0	0	21	0	0
16	21038832	.	T	A	9	13	22	0	1	23	0	0
16	21038924	.	G	A	10	7	17	0	0	17	0	0
16	21039939	.	G	C	7	5	12	0	0	12	0	0
16	21166622	.	C	T	3	2	5	0	1	6	0	0
16	21442772	.	A	T	3	2	5	0	0	5	0	0
16	21445335	.	A	C	1	1	2	0	1	3	0	0
16	21445338	.	G	A	1	2	3	0	0	3	0	0
16	21548398	.	T	C	3	4	7	0	0	7	0	0
16	21548456	.	C	T	4	5	9	0	3	12	0	0
16	21548547	.	G	A	8	8	16	0	2	18	0	0
16	21548556	.	G	A	9	7	16	0	0	16	0	0
16	21548625	.	G	T	5	2	7	0	4	11	0	0
16	21548776	.	C	T	4	10	14	0	0	14	0	0
16	21548881	.	T	C	5	4	9	0	0	9	0	0
16	21548891	.	A	T	5	3	8	0	0	8	0	0
16	21549022	.	C	T	2	6	8	0	9	17	0	0
16	21549231	.	T	A	6	5	11	0	1	12	0	0
16	21549520	.	C	T	0	7	7	0	11	18	0	0
16	21549539	.	A	C	3	13	16	0	1	17	0	0
16	21549600	.	T	A	7	3	10	0	2	12	0	0
16	21549924	.	C	T	3	6	9	0	0	9	0	0
16	21549984	.	C	T	0	2	2	0	5	7	0	0
16	21550124	.	G	A	4	3	7	0	0	7	0	0
16	21550251	.	C	A	4	5	9	0	0	9	0	0
16	21550255	.	T	A	6	5	11	0	0	11	0	0
16	21550318	.	C	T	6	4	10	0	0	10	0	0
16	21551609	.	G	C	1	2	3	0	0	3	0	0
16	21551743	.	C	T	4	4	8	0	0	8	0	0
16	21551749	.	T	G	6	3	9	0	0	9	0	0
16	21551819	.	T	G	2	3	5	0	0	5	0	0
16	21552107	.	G	T	2	3	5	0	0	5	0	0
16	21553079	.	C	T	1	2	3	0	0	3	0	0
16	21554696	.	T	C	2	0	2	0	4	6	0	0
16	21556301	.	C	T	0	2	2	0	2	4	0	0
16	21651780	.	T	C	7	0	7	0	9	16	0	0
16	21652059	.	T	A	14	6	20	0	1	21	0	0
16	21655336	.	C	T	10	7	17	0	0	17	0	0
16	21655611	.	G	A	9	5	14	0	2	16	0	0
16	21663023	.	G	A	3	8	11	0	1	12	0	0
16	21665403	.	G	C	5	6	11	0	2	13	0	0
16	21665605	.	G	T	5	9	14	0	0	14	0	0
16	21673726	.	A	G	4	3	7	0	0	7	0	0
16	21689469	.	C	T	0	3	3	0	5	8	0	0
16	21691065	.	T	G	3	2	5	0	1	6	0	0
16	21734574	.	A	G	5	4	9	0	0	9	0	0
16	21738666	.	A	T	13	6	19	0	0	19	0	0
16	21739233	.	G	A	13	17	30	0	1	31	0	0
16	21763843	.	G	A	13	17	30	0	0	30	0	0
16	21769044	.	G	A	12	23	35	0	0	35	0	0
16	21777508	.	G	C	7	0	7	0	10	17	0	0
16	21780023	.	G	A	2	4	6	0	1	7	0	0
16	21782076	.	C	A	3	8	11	0	0	11	0	0
16	21892068	.	G	A	8	5	13	0	0	13	0	0
16	21892173	.	G	A	8	8	16	0	0	16	0	0
16	21892312	.	C	A	17	2	19	0	1	20	0	0
16	21898159	.	T	A	7	10	17	0	0	17	0	0
16	21898279	.	C	T	5	12	17	0	0	17	0	0
16	21899211	.	C	T	11	7	18	0	0	18	0	0
16	21899384	.	C	G	1	2	3	0	8	11	0	0
16	21900294	.	A	G	7	11	18	0	0	18	0	0
16	21900333	.	C	A	1	16	17	0	8	25	0	0
16	21901015	.	G	A	5	3	8	0	0	8	0	0
16	21902949	.	G	A	6	5	11	0	2	13	0	0
16	21903803	.	A	G	4	7	11	0	1	12	0	0
16	21903845	.	C	T	9	5	14	0	0	14	0	0
16	21903911	.	C	A	1	3	4	0	7	11	0	0
16	21904091	.	G	A	6	6	12	0	0	12	0	0
16	21905681	.	A	G	6	4	10	0	0	10	0	0
16	21905814	.	G	A	6	10	16	0	0	16	0	0
16	21906282	.	A	C	13	0	13	0	7	20	0	0
16	21907744	.	A	G	4	5	9	0	0	9	0	0
16	21908775	.	T	C	2	2	4	0	1	5	0	0
16	21908890	.	A	G	3	5	8	0	0	8	0	0
16	21912092	.	G	C	3	2	5	0	0	5	0	0
16	21912963	.	C	A	4	4	8	0	0	8	0	0
16	21912997	.	G	A	5	7	12	0	0	12	0	0
16	21913069	.	T	A	5	4	9	0	0	9	0	0
16	21913091	.	T	A	3	4	7	0	0	7	0	0
16	21913221	.	A	C	2	2	4	0	0	4	0	0
16	21913227	.	G	C	1	3	4	0	1	5	0	0
16	21922356	.	A	T	1	2	3	0	0	3	0	0
16	21928360	.	G	A	2	2	4	0	1	5	0	0
16	21937834	.	C	G	4	3	7	0	0	7	0	0
16	21937991	.	G	T	3	3	6	0	4	10	0	0
16	22218355	.	C	A	1	3	4	0	0	4	0	0
16	22218451	.	A	G	4	2	6	0	0	6	0	0
16	22224698	.	A	G	4	4	8	0	1	9	0	0
16	22224707	.	C	G	3	4	7	0	1	8	0	0
16	22351659	.	A	G	2	0	2	1	4	7	0	0
16	22354677	.	A	G	5	3	8	0	1	9	0	0
16	22358841	.	T	A	6	5	11	0	0	11	0	0
16	22358944	.	A	T	7	9	16	0	0	16	0	0
16	22358947	.	T	A	5	9	14	0	1	16	1	0
16	22360552	.	G	A	7	16	23	0	1	24	0	0
16	22360577	.	G	A	11	13	24	0	2	26	0	0
16	22361101	.	T	C	13	10	23	0	0	23	0	0
16	22363956	.	G	A	16	5	21	0	0	21	0	0
16	22363957	.	G	A	16	5	21	0	0	21	0	0
16	22364064	.	C	T	14	15	29	0	1	30	0	0
16	22364067	.	T	G	14	14	28	0	1	29	0	0
16	22364241	.	A	C	11	18	29	1	0	30	0	0
16	22365562	.	C	G	5	2	7	0	0	7	0	0
16	22368962	.	T	A	8	8	16	0	3	19	0	0
16	22649862	.	T	G	1	3	4	0	1	5	0	0
16	22659905	.	A	G	5	5	10	0	0	10	0	0
16	22660094	.	C	A	2	5	7	0	0	7	0	0
16	22673219	.	C	T	8	8	16	0	1	17	0	0
16	22673234	.	C	T	7	7	14	0	1	15	0	0
16	22673528	.	C	G	6	16	22	0	0	22	0	0
16	22673804	.	G	T	3	6	9	0	1	10	0	0
16	22673817	.	G	T	4	6	10	0	2	12	0	0
16	22674181	.	A	C	3	6	9	0	0	9	0	0
16	22674317	.	A	G	6	7	13	0	1	14	0	0
16	22674427	.	C	T	5	7	12	0	0	12	0	0
16	22674490	.	G	A	7	5	12	0	0	12	0	0
16	22675081	.	T	A	11	4	15	0	0	15	0	0
16	22675110	.	A	T	8	7	15	0	1	16	0	0
16	22675253	.	C	T	6	6	12	0	0	12	0	0
16	22675310	.	T	A	5	2	7	0	4	11	0	0
16	22675367	.	C	A	7	8	15	0	0	15	0	0
16	22675418	.	T	C	7	9	16	0	0	16	0	0
16	22675574	.	T	C	7	10	17	0	0	17	0	0
16	22675663	.	T	C	10	11	21	0	1	22	0	0
16	22675795	.	G	A	1	10	11	0	2	13	0	0
16	22676589	.	G	T	16	4	20	0	1	21	0	0
16	22676671	.	T	A	12	7	19	0	2	21	0	0
16	22677037	.	C	A	9	8	17	0	2	19	0	0
16	22677086	.	G	A	11	10	21	0	1	22	0	0
16	22677206	.	C	A	18	14	32	0	0	32	0	0
16	22677276	.	A	G	16	14	30	1	2	33	0	0
16	22677537	.	A	G	4	10	14	0	0	14	0	0
16	22677658	.	T	C	2	5	7	0	0	7	0	0
16	22750244	.	A	T	9	10	19	0	0	19	0	0
16	22750506	.	A	G	12	20	32	0	1	33	0	0
16	22750566	.	G	A	22	18	40	0	1	41	0	0
16	22750579	.	A	G	21	16	37	0	0	37	0	0
16	22750610	.	A	T	18	16	34	0	2	36	0	0
16	22750693	.	G	A	23	12	35	0	0	35	0	0
16	22750718	.	A	T	22	6	28	0	0	28	0	0
16	22750754	.	G	A	9	15	24	0	1	25	0	0
16	22750781	.	A	G	17	10	27	0	0	27	0	0
16	22750839	.	A	G	5	14	19	0	1	20	0	0
16	22751093	.	C	A	7	15	22	0	0	22	0	0
16	22751101	.	C	T	4	12	16	0	0	16	0	0
16	22751129	.	T	A	2	8	10	0	2	12	0	0
16	22751141	.	T	G	3	2	5	0	2	7	0	0
16	22751167	.	T	A	6	6	12	0	0	12	0	0
16	22751181	.	C	T	4	5	9	0	1	10	0	0
16	22751376	.	A	C	3	4	7	0	0	7	0	0
16	22751426	.	T	C	8	6	14	0	1	15	0	0
16	22751645	.	A	G	3	2	5	0	1	6	0	0
16	22751926	.	C	T	3	6	9	0	0	9	0	0
16	22752154	.	G	A	4	21	25	0	0	25	0	0
16	22752274	.	G	C	6	5	11	0	0	11	0	0
16	22752279	.	T	C	7	4	11	0	1	12	0	0
16	22752328	.	G	A	7	6	13	0	1	14	0	0
16	22752345	.	C	T	8	7	15	0	0	15	0	0
16	22752399	.	G	A	7	2	9	0	1	10	0	0
16	22752624	.	C	T	2	7	9	0	1	10	0	0
16	22752829	.	C	A	1	5	6	0	0	6	0	0
16	22753068	.	G	A	1	2	3	0	0	3	0	0
16	22753116	.	C	A	0	2	2	0	5	7	0	0
16	22753206	.	G	C	12	4	16	0	0	16	0	0
16	22753380	.	T	G	15	12	27	0	0	27	0	0
16	22753452	.	G	A	8	3	11	0	3	14	0	0
16	22753574	.	C	T	2	9	11	0	4	15	0	0
16	22753583	.	T	C	6	0	6	0	8	14	0	0
16	22753626	.	C	T	10	9	19	0	1	20	0	0
16	22753631	.	C	T	9	8	17	0	2	19	0	0
16	22767597	.	A	G	3	2	5	0	0	5	0	0
16	22767646	.	G	A	3	2	5	0	0	5	0	0
16	22767732	.	A	G	3	2	5	0	0	5	0	0
16	22782175	.	G	T	3	3	6	0	0	6	0	0
16	22782306	.	A	T	17	6	23	0	3	26	0	0
16	22782308	.	A	T	18	8	26	0	0	26	0	0
16	22782422	.	C	T	3	16	19	0	11	30	0	0
16	22782443	.	A	T	14	15	29	0	2	31	0	0
16	22782458	.	T	C	16	13	29	0	0	29	0	0
16	22782682	.	T	G	11	11	22	0	1	23	0	0
16	22782904	.	G	C	15	8	23	0	0	23	0	0
16	22783338	.	C	G	0	11	11	0	7	18	0	0
16	22783978	.	A	G	14	10	24	0	1	25	0	0
16	22783995	.	T	C	13	0	13	0	10	23	0	0
16	22796434	.	T	G	11	14	25	0	0	25	0	0
16	22866015	.	T	C	6	3	9	0	0	9	0	0
16	22866017	.	C	A	6	3	9	0	0	9	0	0
16	22868973	.	T	C	2	4	6	0	0	6	0	0
16	22872011	.	A	G	3	0	3	0	3	6	0	0
16	22872317	.	A	C	6	8	14	0	0	14	0	0
16	22872602	.	G	A	6	5	11	0	0	11	0	0
16	22872657	.	A	C	9	5	14	0	3	17	0	0
16	22872693	.	T	C	13	5	18	0	1	19	0	0
16	22872694	.	C	T	15	5	20	0	0	20	0	0
16	22872927	.	T	C	7	9	16	0	2	18	0	0
16	22878965	.	T	A	7	7	14	0	0	14	0	0
16	22879104	.	T	A	2	4	6	0	0	6	0	0
16	23087656	.	G	A	2	4	6	0	0	6	0	0
16	23087803	.	G	A	2	4	6	0	0	6	0	0
16	23600684	.	A	C	5	0	5	0	5	10	0	0
16	23600686	.	A	C	3	0	3	0	5	8	0	0
16	23961572	.	C	G	3	0	3	0	15	18	0	0
16	23961950	.	C	A	14	8	22	0	0	22	0	0
16	23962010	.	T	C	14	9	23	0	1	24	0	0
16	23963246	.	C	T	23	18	41	0	2	43	0	0
16	23963315	.	G	T	14	21	35	0	3	38	0	0
16	23973477	.	G	A	19	25	44	0	2	48	2	0
16	24190674	.	C	T	2	4	6	0	1	7	0	0
16	24191564	.	G	A	29	35	64	0	9	73	0	0
16	24213444	.	T	A	20	13	33	0	2	35	0	0
16	24213446	.	T	A	22	13	35	0	1	36	0	0
16	24213538	.	G	T	35	19	54	1	5	60	0	0
16	24213657	.	G	A	28	19	47	2	2	51	0	0
16	24213666	.	T	G	26	20	46	2	2	50	0	0
16	24213793	.	T	C	22	35	57	0	2	59	0	0
16	24214023	.	A	G	25	31	56	0	3	59	0	0
16	24214106	.	T	C	20	0	20	0	31	51	0	0
16	24214468	.	T	C	33	25	58	0	4	62	0	0
16	24261594	.	C	G	21	16	37	0	2	39	0	0
16	24277750	.	C	T	14	14	28	0	2	30	0	0
16	24302164	.	G	A	14	12	26	0	1	27	0	0
16	24552024	.	A	T	6	5	11	0	0	11	0	0
16	24552032	.	G	A	5	6	11	0	0	11	0	0
16	24552081	.	C	T	8	4	12	0	0	12	0	0
16	24553018	.	G	T	6	7	13	0	0	13	0	0
16	24553082	.	T	A	4	9	13	0	0	13	0	0
16	24553225	.	C	G	5	4	9	0	0	9	0	0
16	24553450	.	T	C	7	7	14	0	2	16	0	0
16	24553633	.	A	G	3	5	8	0	0	8	0	0
16	24553843	.	A	G	1	3	4	0	0	4	0	0
16	24553861	.	T	C	1	3	4	0	0	4	0	0
16	24554438	.	T	A	4	8	12	0	1	13	0	0
16	24554475	.	A	G	8	6	14	0	0	14	0	0
16	24590767	.	T	A	15	17	32	0	0	32	0	0
16	24590823	.	C	T	14	18	32	0	2	34	0	0
16	24591172	.	A	G	16	16	32	0	4	36	0	0
16	24591245	.	A	T	7	22	29	0	0	29	0	0
16	24591258	.	A	G	8	20	28	0	1	29	0	0
16	24591287	.	C	T	6	11	17	0	17	34	0	0
16	24591330	.	A	G	16	12	28	0	2	30	0	0
16	24591360	.	G	A	14	8	22	0	0	22	0	0
16	24591410	.	G	A	10	5	15	0	2	17	0	0
16	24591693	.	G	C	32	16	48	0	1	49	0	0
16	24591751	.	C	T	20	20	40	0	6	46	0	0
16	24591794	.	G	T	13	22	35	0	3	38	0	0
16	24632121	.	G	T	1	4	5	0	0	5	0	0
16	24632231	.	C	T	11	13	24	0	3	27	0	0
16	24645448	.	C	G	10	7	17	0	0	17	0	0
16	24645620	.	T	G	5	5	10	0	0	10	0	0
16	24695160	.	G	T	11	23	34	0	1	35	0	0
16	24695301	.	T	C	29	26	55	1	2	58	0	0
16	24695322	.	G	T	5	27	32	0	30	62	0	0
16	24695520	.	G	A	41	22	63	0	2	65	0	0
16	24695525	.	A	C	42	19	61	0	2	63	0	0
16	24730634	.	C	A	8	9	17	0	0	17	0	0
16	24732602	.	A	G	9	1	10	0	9	19	0	0
16	24819936	.	C	T	1	2	3	2	0	5	0	0
16	24820061	.	A	G	4	2	6	0	0	6	0	0
16	24820163	.	C	T	4	2	6	0	0	6	0	0
16	24990255	.	T	A	1	3	4	0	0	4	0	0
16	24990261	.	A	G	1	2	3	0	0	3	0	0
16	24990672	.	C	T	4	4	8	0	0	8	0	0
16	24990850	.	C	T	2	4	6	0	1	7	0	0
16	24991164	.	G	T	0	5	5	0	2	7	0	0
16	24991225	.	C	G	3	6	9	0	0	9	0	0
16	24991239	.	G	A	0	7	7	0	3	10	0	0
16	24991333	.	T	C	2	10	12	0	1	13	0	0
16	24991593	.	A	T	8	5	13	0	0	13	0	0
16	24991636	.	G	A	8	5	13	0	0	13	0	0
16	24991637	.	C	T	6	5	11	0	1	12	0	0
16	24991919	.	T	A	5	5	10	0	1	11	0	0
16	24991940	.	T	A	8	4	12	0	0	12	0	0
16	24992129	.	T	C	2	2	4	0	0	4	0	0
16	24992477	.	C	G	2	4	6	0	2	8	0	0
16	24992580	.	T	G	4	2	6	0	2	8	0	0
16	25012031	.	G	T	2	2	4	0	0	4	0	0
16	25012935	.	T	A	1	2	3	0	0	3	0	0
16	25032037	.	C	T	1	3	4	0	1	5	0	0
16	25033173	.	G	A	3	5	8	0	1	9	0	0
16	25033191	.	C	T	2	5	7	0	0	7	0	0
16	25033809	.	G	A	7	5	12	0	1	13	0	0
16	25034683	.	A	T	5	8	13	0	0	13	0	0
16	25034715	.	C	T	7	4	11	0	0	11	0	0
16	25036217	.	C	T	6	3	9	0	0	9	0	0
16	25038185	.	A	T	3	6	9	0	3	12	0	0
16	25038429	.	C	T	10	8	18	0	0	18	0	0
16	25068507	.	C	T	1	3	4	0	1	5	0	0
16	25068794	.	A	G	1	0	1	0	2	3	0	0
16	25070393	.	A	C	4	7	11	0	0	11	0	0
16	25071019	.	G	A	7	3	10	0	0	10	0	0
16	25071614	.	C	T	15	9	24	0	1	25	0	0
16	25071782	.	G	A	0	9	9	0	8	17	0	0
16	25072355	.	G	A	6	7	13	0	0	13	0	0
16	25077608	.	C	T	3	2	5	0	0	5	0	0
16	25077819	.	C	T	5	3	8	0	0	8	0	0
16	25078397	.	G	T	5	3	8	0	0	8	0	0
16	25078715	.	A	G	6	6	12	0	0	12	0	0
16	25078907	.	T	A	2	5	7	0	3	10	0	0
16	25079407	.	A	C	2	4	6	1	0	7	0	0
16	25080042	.	G	T	3	2	5	0	1	6	0	0
16	25080207	.	C	T	7	3	10	0	0	10	0	0
16	25080236	.	G	T	7	5	12	0	0	12	0	0
16	25080252	.	A	T	6	5	11	0	0	11	0	0
16	25080306	.	T	C	2	3	5	0	0	5	0	0
16	25104031	.	T	C	21	18	39	0	0	39	0	0
16	25104454	.	C	G	12	19	31	0	2	33	0	0
16	25104543	.	C	T	9	12	21	0	0	21	0	0
16	25104850	.	A	C	17	16	33	0	1	34	0	0
16	25104899	.	T	G	21	18	39	0	0	39	0	0
16	25104941	.	T	C	17	6	23	0	3	26	0	0
16	25111665	.	C	A	3	2	5	0	0	5	0	0
16	25111794	.	G	A	3	2	5	0	0	5	0	0
16	25111899	.	G	A	3	3	6	0	0	6	0	0
16	25111920	.	G	A	2	3	5	0	2	7	0	0
16	25112001	.	A	G	3	6	9	0	0	9	0	0
16	25112316	.	G	A	3	3	6	0	0	6	0	0
16	25112769	.	C	T	5	4	9	0	0	9	0	0
16	25113741	.	G	A	0	9	9	0	4	13	0	0
16	25121958	.	C	T	3	6	9	0	0	9	0	0
16	25121970	.	C	T	8	3	11	0	0	11	0	0
16	25122240	.	C	T	3	10	13	0	0	13	0	0
16	25122387	.	C	T	5	6	11	0	0	11	0	0
16	25123129	.	A	G	3	9	12	0	0	12	0	0
16	25123130	.	A	G	2	6	8	0	4	12	0	0
16	25123221	.	C	A	3	7	10	0	0	10	0	0
16	25123382	.	G	T	4	6	10	0	0	10	0	0
16	25123505	.	A	T	5	2	7	1	0	8	0	0
16	25123506	.	C	T	4	2	6	1	0	7	0	0
16	25123832	.	A	G	4	2	6	0	1	7	0	0
16	25123843	.	T	A	5	2	7	0	2	9	0	0
16	25123884	.	C	G	2	3	5	0	0	5	0	0
16	25124500	.	G	A	5	5	10	0	1	11	0	0
16	25124662	.	G	T	3	4	7	0	0	7	0	0
16	25124750	.	G	A	3	4	7	0	0	7	0	0
16	25124832	.	C	T	5	6	11	0	0	11	0	0
16	25145978	.	G	A	0	2	2	0	1	3	0	0
16	25149191	.	G	A	1	3	4	0	0	4	0	0
16	25149228	.	C	T	3	2	5	0	0	5	0	0
16	25149254	.	G	T	2	3	5	0	0	5	0	0
16	25149474	.	C	T	2	4	6	0	1	7	0	0
16	25149563	.	T	G	1	2	3	0	0	3	0	0
16	25149797	.	C	G	1	4	5	0	0	5	0	0
16	25149819	.	T	C	1	2	3	0	0	3	0	0
16	25150307	.	T	G	1	0	1	0	3	4	0	0
16	25150329	.	A	G	3	2	5	0	0	5	0	0
16	25150468	.	A	G	5	3	8	0	0	8	0	0
16	25151012	.	T	C	4	4	8	0	0	8	0	0
16	25151456	.	G	A	4	2	6	0	0	6	0	0
16	25154081	.	A	C	0	5	5	0	1	6	0	0
16	25154115	.	C	T	2	2	4	0	0	4	0	0
16	25160922	.	A	T	3	3	6	0	0	6	0	0
16	25160985	.	G	A	0	2	2	0	5	7	0	0
16	25161315	.	T	C	6	9	15	0	1	16	0	0
16	25161693	.	G	A	6	7	13	0	1	14	0	0
16	25161873	.	G	A	0	13	13	0	4	17	0	0
16	25162320	.	T	A	2	4	6	0	0	6	0	0
16	25164326	.	C	A	4	2	6	0	1	7	0	0
16	25168548	.	G	A	14	12	26	0	1	27	0	0
16	25168765	.	C	A	22	9	31	0	0	31	0	0
16	25169336	.	G	A	8	8	16	0	0	16	0	0
16	25169616	.	A	T	3	4	7	0	0	7	0	0
16	25173993	.	T	A	4	4	8	0	0	8	0	0
16	25176777	.	T	G	2	0	2	0	3	5	0	0
16	25176780	.	C	A	4	2	6	0	0	6	0	0
16	25176840	.	G	A	0	3	3	0	1	4	0	0
16	25180397	.	A	C	5	6	11	0	0	11	0	0
16	25180415	.	C	T	5	5	10	0	1	11	0	0
16	25180485	.	T	C	3	2	5	0	1	6	0	0
16	25180488	.	G	A	4	1	5	0	0	5	0	0
16	25180658	.	C	A	8	3	11	0	0	11	0	0
16	25180674	.	T	A	5	3	8	0	0	8	0	0
16	25180737	.	C	T	5	6	11	0	1	12	0	0
16	25180775	.	G	A	7	7	14	0	1	15	0	0
16	25181046	.	A	G	4	7	11	0	0	11	0	0
16	25181095	.	C	T	3	3	6	0	0	6	0	0
16	25181194	.	G	C	1	3	4	0	0	4	0	0
16	25181213	.	A	G	1	2	3	0	0	3	0	0
16	25181256	.	G	A	3	4	7	0	0	7	0	0
16	25181291	.	T	C	3	3	6	0	1	7	0	0
16	25199291	.	G	C	2	2	4	0	0	4	0	0
16	25232250	.	T	C	5	3	8	0	0	8	0	0
16	25232288	.	C	A	0	7	7	0	5	12	0	0
16	25232421	.	T	C	3	5	8	0	0	8	0	0
16	25232433	.	C	T	0	2	2	0	4	6	0	0
16	25232967	.	G	A	1	4	5	0	0	5	0	0
16	25232973	.	C	T	1	4	5	0	2	7	0	0
16	25259332	.	T	C	2	2	4	0	0	4	0	0
16	25268129	.	C	T	1	2	3	0	0	3	0	0
16	25272148	.	G	T	0	2	2	0	2	4	0	0
16	25272149	.	A	G	2	2	4	0	0	4	0	0
16	25272529	.	A	C	1	3	4	0	0	4	0	0
16	25275842	.	C	A	2	3	5	0	1	6	0	0
16	25275848	.	T	C	2	4	6	0	1	7	0	0
16	25275909	.	A	C	9	14	23	0	0	23	0	0
16	25275957	.	C	T	17	15	32	0	0	32	0	0
16	25276281	.	G	A	10	16	26	0	0	26	0	0
16	25276387	.	T	A	13	10	23	0	0	23	0	0
16	25285506	.	G	A	20	15	35	0	2	37	0	0
16	25285507	.	G	A	22	16	38	0	0	38	0	0
16	25297565	.	T	C	1	2	3	0	0	3	0	0
16	25308516	.	C	T	6	3	9	0	1	10	0	0
16	25308986	.	G	A	2	2	4	0	0	4	0	0
16	25311000	.	T	C	3	4	7	0	1	8	0	0
16	25311038	.	A	T	3	6	9	0	1	10	0	0
16	25311772	.	G	A	4	4	8	0	1	9	0	0
16	25314682	.	C	T	8	7	15	0	1	16	0	0
16	25317000	.	G	A	3	8	11	0	0	11	0	0
16	25327155	.	C	A	10	11	21	0	0	21	0	0
16	25327181	.	C	T	11	14	25	0	0	25	0	0
16	25327202	.	G	A	10	19	29	0	0	29	0	0
16	25327730	.	C	T	8	3	11	0	0	11	0	0
16	25329319	.	C	T	6	8	14	0	0	14	0	0
16	25333270	.	A	G	8	16	24	0	1	25	0	0
16	25337248	.	C	A	16	18	34	0	9	43	0	0
16	25337286	.	C	T	17	25	42	0	3	45	0	0
16	25337319	.	G	A	11	16	27	0	2	29	0	0
16	25344017	.	G	T	0	2	2	0	4	6	0	0
16	25344035	.	T	C	1	3	4	0	0	4	0	0
16	25345961	.	A	G	2	3	5	1	0	6	0	0
16	25348767	.	G	A	4	3	7	0	0	7	0	0
16	25348860	.	C	T	2	2	4	0	0	4	0	0
16	25349471	.	C	T	4	6	10	0	0	10	0	0
16	25351283	.	A	T	4	2	6	0	0	6	0	0
16	25354571	.	A	G	5	0	5	0	4	9	0	0
16	25360762	.	G	A	2	5	7	0	0	7	0	0
16	25364479	.	T	C	6	10	16	0	1	17	0	0
16	25364589	.	T	C	6	9	15	0	2	17	0	0
16	25364742	.	T	C	10	0	10	0	7	17	0	0
16	25365156	.	C	T	7	10	17	0	1	18	0	0
16	25367788	.	A	G	6	2	8	0	0	8	0	0
16	25367902	.	C	T	3	6	9	0	2	11	0	0
16	25367917	.	C	G	4	5	9	0	1	10	0	0
16	25367938	.	G	C	5	0	5	0	9	14	0	0
16	25373823	.	C	T	2	3	5	0	0	5	0	0
16	25373979	.	T	A	10	4	14	1	0	15	0	0
16	25374275	.	T	C	3	7	10	0	1	11	0	0
16	25374507	.	T	C	5	1	6	0	10	16	0	0
16	25375019	.	T	C	6	0	6	0	8	14	0	0
16	25375521	.	C	A	8	4	12	0	0	12	0	0
16	25376046	.	T	A	1	5	6	0	2	8	0	0
16	25376528	.	C	T	3	3	6	0	1	7	0	0
16	25376808	.	T	C	1	3	4	0	0	4	0	0
16	25389094	.	G	A	5	12	17	0	1	18	0	0
16	25389106	.	C	T	6	10	16	0	0	16	0	0
16	25393342	.	G	A	1	2	3	0	0	3	0	0
16	25394879	.	C	A	1	2	3	0	0	3	0	0
16	25394883	.	C	T	1	2	3	0	0	3	0	0
16	25395154	.	G	T	4	4	8	0	1	10	1	0
16	25395702	.	G	T	4	6	10	0	2	12	0	0
16	25399585	.	A	T	6	3	9	0	0	9	0	0
16	25399588	.	A	T	6	4	10	0	0	10	0	0
16	25400055	.	G	C	1	3	4	0	0	4	0	0
16	25400061	.	A	T	1	3	4	0	0	4	0	0
16	25445746	.	G	A	4	2	6	0	0	6	0	0
16	25463401	.	C	A	5	3	8	0	0	8	0	0
16	25470975	.	A	G	6	7	13	0	0	13	0	0
16	25477428	.	G	A	4	4	8	0	0	8	0	0
16	25477736	.	A	G	3	4	7	0	0	7	0	0
16	25490833	.	A	G	4	1	5	0	2	7	0	0
16	25492951	.	C	T	3	2	5	0	0	5	0	0
16	25498402	.	T	A	5	3	8	0	1	9	0	0
16	25500137	.	A	G	3	8	11	0	0	11	0	0
16	25500223	.	T	C	2	2	4	0	0	4	0	0
16	25504192	.	G	C	13	14	27	0	1	28	0	0
16	25504337	.	G	A	18	9	27	0	0	27	0	0
16	25504466	.	C	T	12	17	29	0	0	29	0	0
16	25504467	.	G	A	16	11	27	0	0	27	0	0
16	25504792	.	G	C	23	23	46	0	0	46	0	0
16	25504900	.	G	A	24	20	44	0	2	46	0	0
16	25556650	.	T	A	15	7	22	0	1	23	0	0
16	25556697	.	A	G	11	14	25	0	0	25	0	0
16	25556710	.	C	T	10	13	23	0	0	23	0	0
16	25556766	.	C	G	2	7	9	0	6	15	0	0
16	25556780	.	A	G	8	5	13	0	1	14	0	0
16	25556802	.	C	A	12	4	16	0	1	17	0	0
16	25556930	.	A	G	9	8	17	0	0	17	0	0
16	25556966	.	T	A	9	11	20	0	0	20	0	0
16	25557352	.	C	T	2	7	9	0	4	13	0	0
16	25557400	.	A	G	5	5	10	0	0	10	0	0
16	25557403	.	T	C	4	4	8	0	1	9	0	0
16	25557690	.	C	T	5	6	11	0	0	11	0	0
16	25557806	.	C	T	5	11	16	0	0	16	0	0
16	25558135	.	C	T	14	9	23	0	1	24	0	0
16	25558223	.	A	G	5	8	13	0	0	13	0	0
16	25558351	.	C	T	0	8	8	0	8	16	0	0
16	25558439	.	G	T	10	10	20	0	0	20	0	0
16	25558704	.	T	G	13	5	18	0	1	19	0	0
16	25558829	.	C	T	6	5	11	0	2	13	0	0
16	25558892	.	G	A	5	3	8	0	0	8	0	0
16	25558986	.	A	G	8	4	12	0	1	13	0	0
16	25559028	.	A	C	8	6	14	0	0	14	0	0
16	25559193	.	A	G	1	4	5	0	1	6	0	0
16	25559274	.	C	T	1	5	6	0	2	8	0	0
16	25559632	.	G	A	6	8	14	0	0	14	0	0
16	25559743	.	A	T	10	5	15	0	0	15	0	0
16	25560135	.	T	C	7	0	7	0	4	11	0	0
16	25560184	.	A	G	9	3	12	0	0	12	0	0
16	25560322	.	G	A	4	7	11	0	0	11	0	0
16	25560586	.	A	G	1	2	3	0	1	4	0	0
16	25561175	.	A	G	7	4	11	0	0	11	0	0
16	25561471	.	C	G	2	3	5	0	1	6	0	0
16	25561681	.	T	A	4	2	6	0	1	7	0	0
16	25561795	.	C	A	11	6	17	0	0	17	0	0
16	25562480	.	G	A	3	2	5	0	1	6	0	0
16	25562549	.	G	A	4	6	10	0	0	10	0	0
16	25642663	.	G	A	9	19	28	0	0	28	0	0
16	25642673	.	C	T	23	11	34	0	0	34	0	0
16	25643038	.	G	A	15	13	28	0	1	29	0	0
16	25643041	.	G	A	4	13	17	0	10	27	0	0
16	25643113	.	G	C	17	13	30	0	0	30	0	0
16	25643452	.	T	A	5	7	12	0	0	12	0	0
16	25643818	.	G	T	7	6	13	0	0	13	0	0
16	25644357	.	C	A	8	8	16	0	0	16	0	0
16	25644378	.	A	T	8	7	15	0	0	15	0	0
16	25673249	.	T	A	6	7	13	0	0	13	0	0
16	25683018	.	T	C	5	7	12	0	1	13	0	0
16	25683387	.	C	T	0	10	10	0	11	21	0	0
16	25800756	.	A	G	1	2	3	0	0	3	0	0
16	26043044	.	T	A	8	7	15	0	0	15	0	0
16	26141678	.	C	A	11	7	18	0	0	18	0	0
16	26141785	.	C	A	0	6	6	1	8	15	0	0
16	26141817	.	T	G	7	10	17	1	2	20	0	0
16	26142105	.	C	T	6	6	12	0	0	12	0	0
16	26142311	.	A	C	10	7	17	0	1	18	0	0
16	26142773	.	G	A	4	7	11	0	1	12	0	0
16	26142779	.	C	T	4	7	11	0	0	11	0	0
16	26142900	.	T	C	4	0	4	0	12	16	0	0
16	26143371	.	T	G	5	6	11	0	0	12	1	0
16	26143538	.	C	T	5	5	10	0	0	10	0	0
16	26143561	.	C	T	4	3	7	0	2	9	0	0
16	26146174	.	G	A	9	6	15	0	2	17	0	0
16	26146736	.	G	A	9	7	16	0	0	16	0	0
16	26148741	.	C	T	3	2	5	0	0	5	0	0
16	26148962	.	C	A	3	4	7	0	0	7	0	0
16	26148963	.	C	A	3	4	7	0	0	7	0	0
16	26149005	.	A	T	2	5	7	0	1	8	0	0
16	26169515	.	T	G	4	4	8	0	2	10	0	0
16	26170412	.	G	A	4	3	7	0	0	7	0	0
16	26186178	.	C	A	1	3	4	0	0	4	0	0
16	26186187	.	G	C	2	0	2	0	3	5	0	0
16	26234317	.	T	C	2	2	4	0	0	4	0	0
16	26235386	.	G	A	2	2	4	0	0	4	0	0
16	26236259	.	C	T	2	6	8	0	0	8	0	0
16	26236263	.	G	A	0	6	6	0	1	7	0	0
16	26378553	.	T	A	1	2	3	0	0	3	0	0
16	26378655	.	T	C	2	0	2	0	2	4	0	0
16	26378665	.	G	T	1	3	4	0	0	4	0	0
16	26379397	.	G	A	2	3	5	0	0	5	0	0
16	26379437	.	T	C	1	0	1	0	2	3	0	0
16	26380536	.	A	G	2	3	5	0	0	5	0	0
16	26380784	.	C	T	1	12	13	0	9	22	0	0
16	26380866	.	G	A	9	7	16	0	0	16	0	0
16	26381192	.	T	G	11	7	18	0	0	18	0	0
16	26381271	.	C	T	9	13	22	0	0	22	0	0
16	26381344	.	T	G	5	5	10	1	3	14	0	0
16	26381416	.	C	T	0	28	28	0	15	43	0	0
16	26381463	.	C	T	2	10	12	0	26	38	0	0
16	26381768	.	C	T	1	7	8	0	13	21	0	0
16	26382084	.	T	C	10	12	22	0	1	23	0	0
16	26382225	.	A	T	25	10	35	0	0	35	0	0
16	26382243	.	G	A	20	17	37	0	0	37	0	0
16	26382308	.	T	C	22	15	37	0	1	38	0	0
16	26382453	.	T	C	11	0	11	0	14	25	0	0
16	26382585	.	A	G	7	6	13	0	1	14	0	0
16	26382942	.	T	C	18	8	26	0	1	27	0	0
16	26383016	.	C	T	2	18	20	0	25	45	0	0
16	26384188	.	C	G	9	8	17	0	0	17	0	0
16	26384219	.	G	A	6	10	16	0	0	16	0	0
16	26384417	.	G	A	7	9	16	0	1	17	0	0
16	26386817	.	T	C	5	5	10	0	0	10	0	0
16	26388840	.	A	G	3	5	8	0	1	9	0	0
16	26391447	.	A	G	2	7	9	0	0	9	0	0
16	26391450	.	C	T	2	7	9	0	0	9	0	0
16	26391970	.	C	A	0	4	4	0	4	8	0	0
16	26398488	.	G	A	1	2	3	0	0	3	0	0
16	26404077	.	A	G	1	2	3	0	0	3	0	0
16	26406028	.	A	G	1	2	3	0	0	3	0	0
16	26439576	.	A	G	2	4	6	0	2	8	0	0
16	26439809	.	T	G	4	3	7	0	0	7	0	0
16	26440252	.	G	A	4	4	8	0	1	9	0	0
16	26441526	.	T	A	1	4	5	0	0	5	0	0
16	26441532	.	T	C	1	4	5	0	0	5	0	0
16	26441561	.	G	A	2	4	6	0	0	6	0	0
16	26441624	.	A	T	1	2	3	0	0	3	0	0
16	26443781	.	G	A	1	3	4	0	0	4	0	0
16	26443835	.	C	T	4	2	6	0	0	6	0	0
16	26443958	.	A	T	4	5	9	0	0	9	0	0
16	26443976	.	C	T	6	5	11	0	0	11	0	0
16	26444135	.	T	C	2	4	6	0	0	6	0	0
16	26444431	.	T	A	5	9	14	0	0	14	0	0
16	26444443	.	A	G	6	9	15	0	0	15	0	0
16	26444505	.	C	T	6	5	11	0	0	11	0	0
16	26444668	.	C	T	1	4	5	0	0	5	0	0
16	26444680	.	G	T	1	4	5	0	0	5	0	0
16	26444776	.	G	A	4	2	6	0	1	7	0	0
16	26444830	.	G	A	0	4	4	0	5	9	0	0
16	26445484	.	T	C	2	3	5	0	1	6	0	0
16	26445512	.	A	C	2	5	7	0	1	8	0	0
16	26445547	.	A	G	4	4	8	0	0	8	0	0
16	26445571	.	G	C	4	4	8	0	0	8	0	0
16	26445593	.	G	C	2	4	6	0	0	6	0	0
16	26445614	.	G	C	4	5	9	0	0	9	0	0
16	26483363	.	T	A	2	2	4	0	0	4	0	0
16	26643598	.	G	C	7	5	12	0	1	13	0	0
16	26688229	.	T	C	1	3	4	0	0	4	0	0
16	26690047	.	A	T	4	3	7	0	0	7	0	0
16	26691491	.	C	T	2	3	5	0	1	6	0	0
16	26691622	.	G	A	1	3	4	0	0	4	0	0
16	26691646	.	T	C	2	3	5	0	0	5	0	0
16	26691665	.	C	T	2	3	5	0	0	5	0	0
16	26691832	.	A	T	3	4	7	0	0	7	0	0
16	26691880	.	C	T	3	2	5	0	0	5	0	0
16	26694669	.	C	T	2	4	6	0	0	6	0	0
16	26702648	.	A	C	8	3	11	0	2	13	0	0
16	26702780	.	G	T	0	7	7	0	8	15	0	0
16	26702786	.	G	A	0	10	10	0	7	17	0	0
16	26706875	.	C	T	5	5	10	0	0	10	0	0
16	26707494	.	A	G	5	4	9	0	3	12	0	0
16	26710900	.	C	A	5	18	23	0	0	23	0	0
16	26710954	.	A	T	10	13	23	0	1	24	0	0
16	26710957	.	G	A	10	13	23	0	1	24	0	0
16	26713964	.	G	T	13	16	29	0	2	31	0	0
16	26717318	.	C	T	10	10	20	0	0	20	0	0
16	26717457	.	C	A	6	12	18	0	0	18	0	0
16	26766508	.	A	T	3	4	7	0	0	7	0	0
16	26766926	.	G	A	6	4	10	0	0	10	0	0
16	26769118	.	C	T	5	4	9	0	0	9	0	0
16	26816799	.	A	G	13	2	15	1	1	17	0	0
16	26816806	.	G	T	11	3	14	1	1	16	0	0
16	26816852	.	G	T	3	6	9	1	0	11	1	0
16	26816885	.	A	G	9	4	13	0	0	13	0	0
16	26816918	.	T	A	10	4	14	0	1	15	0	0
16	26817046	.	T	G	7	8	15	0	0	15	0	0
16	26817069	.	C	T	0	4	4	0	11	15	0	0
16	26817178	.	T	A	6	7	13	0	1	14	0	0
16	26817358	.	C	T	6	4	10	0	1	11	0	0
16	26817754	.	C	T	0	7	7	0	4	11	0	0
16	26818658	.	C	T	4	3	7	0	0	7	0	0
16	26818666	.	A	C	2	4	6	0	0	6	0	0
16	26850833	.	C	T	5	7	12	0	0	12	0	0
16	26850845	.	T	C	7	8	15	0	0	15	0	0
16	26850885	.	C	T	8	9	17	0	0	17	0	0
16	26851025	.	C	G	3	6	9	0	0	9	0	0
16	26851036	.	T	A	2	5	7	0	1	8	0	0
16	26851191	.	C	T	5	9	14	0	0	14	0	0
16	26851236	.	C	T	1	4	5	0	8	13	0	0
16	26851445	.	T	A	7	9	16	0	0	16	0	0
16	26855729	.	C	A	13	15	28	0	0	28	0	0
16	26855786	.	G	A	13	8	21	0	0	21	0	0
16	26855833	.	C	A	3	10	13	0	4	17	0	0
16	26855859	.	C	A	0	14	14	0	12	26	0	0
16	27064864	.	A	G	8	9	17	0	0	17	0	0
16	27069608	.	A	G	9	0	9	0	10	19	0	0
16	27072488	.	G	A	0	4	4	0	6	10	0	0
16	27080221	.	T	C	5	6	11	0	0	11	0	0
16	27089100	.	T	G	6	7	13	0	1	14	0	0
16	27098305	.	T	C	12	12	24	0	1	25	0	0
16	27098530	.	A	G	10	5	15	0	0	15	0	0
16	27098549	.	A	T	7	6	13	0	0	13	0	0
16	27099121	.	A	T	7	2	9	0	1	10	0	0
16	27099508	.	G	A	7	7	14	0	0	14	0	0
16	27100042	.	T	G	5	2	7	0	0	7	0	0
16	27100133	.	A	C	9	12	21	0	1	22	0	0
16	27100139	.	A	T	8	10	18	0	2	21	1	0
16	27100198	.	T	A	7	20	27	0	4	31	0	0
16	27100222	.	T	C	20	12	32	0	0	32	0	0
16	27126647	.	C	T	0	11	11	0	11	22	0	0
16	27126998	.	A	G	7	8	15	0	1	16	0	0
16	27126999	.	T	A	8	7	15	0	1	16	0	0
16	27127157	.	G	C	10	14	24	0	1	25	0	0
16	27127158	.	C	A	9	15	24	0	1	25	0	0
16	27127576	.	T	C	15	13	28	0	0	28	0	0
16	27127959	.	G	A	20	21	41	0	1	42	0	0
16	27131005	.	C	T	1	4	5	0	12	17	0	0
16	27136541	.	A	G	13	10	23	0	0	23	0	0
16	27138207	.	C	G	8	6	14	0	0	14	0	0
16	27138391	.	C	G	11	5	16	0	2	18	0	0
16	27148691	.	C	T	6	6	12	0	0	12	0	0
16	27148861	.	G	T	4	3	7	0	2	9	0	0
16	27158741	.	A	T	8	4	12	0	0	12	0	0
16	27159124	.	G	C	3	0	3	0	4	7	0	0
16	27161089	.	G	A	3	4	7	0	0	7	0	0
16	27169529	.	G	A	15	17	32	0	0	32	0	0
16	27169586	.	G	A	18	14	32	0	1	33	0	0
16	27169664	.	A	T	9	12	21	0	0	22	1	0
16	27169809	.	G	A	14	8	22	0	2	24	0	0
16	27170206	.	A	G	7	5	12	0	0	12	0	0
16	27216353	.	G	A	3	2	5	0	0	5	0	0
16	27216701	.	C	T	4	5	9	0	2	11	0	0
16	27216845	.	C	T	0	3	3	0	4	7	0	0
16	27216970	.	G	A	2	2	4	0	0	4	0	0
16	27217103	.	G	C	3	2	5	0	0	5	0	0
16	27223056	.	G	A	2	3	5	0	0	5	0	0
16	27224450	.	G	C	18	13	31	2	1	34	0	0
16	27225215	.	C	A	10	25	35	0	1	36	0	0
16	27231337	.	T	A	22	23	45	0	1	46	0	0
16	27231416	.	C	T	18	27	45	0	3	48	0	0
16	27345418	.	C	T	3	2	5	0	0	5	0	0
16	27354980	.	G	A	2	3	5	0	0	5	0	0
16	27368175	.	G	A	8	6	14	0	0	14	0	0
16	27368290	.	G	A	0	10	10	0	15	25	0	0
16	27368315	.	G	A	1	9	10	0	11	21	0	0
16	27368577	.	A	G	6	10	16	0	0	16	0	0
16	27368688	.	A	C	10	11	21	0	1	22	0	0
16	27368756	.	A	G	8	3	11	0	0	11	0	0
16	27368823	.	T	G	10	6	16	0	1	17	0	0
16	27368863	.	C	T	7	13	20	0	0	20	0	0
16	27417573	.	T	C	12	7	19	0	0	19	0	0
16	27417659	.	T	G	9	18	27	0	0	27	0	0
16	27417925	.	A	T	16	19	35	0	0	35	0	0
16	27427064	.	A	G	4	5	9	0	0	9	0	0
16	27427760	.	G	A	10	5	15	0	0	15	0	0
16	27428048	.	G	A	4	8	12	0	1	13	0	0
16	27430189	.	G	A	5	6	11	0	1	12	0	0
16	27431597	.	G	A	6	5	11	0	1	12	0	0
16	27493804	.	T	C	2	3	5	0	0	5	0	0
16	27508505	.	G	A	8	2	10	0	2	12	0	0
16	27524890	.	A	T	3	5	8	0	1	9	0	0
16	27524893	.	A	T	3	4	7	0	0	7	0	0
16	27529856	.	G	A	3	4	7	0	0	7	0	0
16	27532506	.	C	T	0	5	5	0	5	10	0	0
16	27536796	.	C	A	0	2	2	0	1	3	0	0
16	27539501	.	G	A	2	4	6	0	1	7	0	0
16	27542452	.	C	G	2	4	6	0	0	6	0	0
16	27542489	.	C	T	2	3	5	0	0	5	0	0
16	27547540	.	A	C	1	2	3	0	0	3	0	0
16	27547545	.	A	T	1	2	3	0	0	3	0	0
16	27554909	.	C	G	10	10	20	0	1	21	0	0
16	27555010	.	T	C	12	11	23	0	3	26	0	0
16	27555011	.	A	C	14	12	26	0	0	26	0	0
16	27555069	.	C	T	15	13	28	0	1	29	0	0
16	27555221	.	C	T	23	10	33	0	0	33	0	0
16	27555395	.	G	A	7	13	20	0	2	22	0	0
16	27570895	.	A	G	1	3	4	0	0	4	0	0
16	27578538	.	C	A	4	3	7	0	1	8	0	0
16	27621786	.	A	T	10	7	17	0	2	19	0	0
16	27622175	.	A	T	1	1	2	0	1	3	0	0
16	27626240	.	A	G	26	24	50	0	1	51	0	0
16	27626566	.	G	T	34	17	51	0	5	56	0	0
16	27627051	.	T	C	32	20	52	0	3	55	0	0
16	27629038	.	C	T	0	23	23	0	20	43	0	0
16	27629343	.	A	G	21	24	45	0	2	47	0	0
16	27629365	.	G	T	15	26	41	0	1	42	0	0
16	27629639	.	C	A	24	18	42	0	2	44	0	0
16	27629798	.	A	T	22	11	33	0	2	35	0	0
16	27630174	.	A	T	15	25	40	0	1	41	0	0
16	27630207	.	C	T	16	21	37	0	4	41	0	0
16	27630302	.	A	T	19	16	35	0	3	38	0	0
16	27630552	.	G	A	12	21	33	0	1	34	0	0
16	27630663	.	G	A	19	12	31	0	3	34	0	0
16	27631229	.	A	T	12	9	21	0	0	21	0	0
16	27631585	.	T	A	15	9	24	0	1	25	0	0
16	27631690	.	T	G	11	9	20	0	0	20	0	0
16	27631695	.	T	C	10	11	21	0	0	21	0	0
16	27631741	.	C	A	8	7	15	0	1	16	0	0
16	27631751	.	T	A	7	5	12	0	2	14	0	0
16	27632153	.	C	T	11	8	19	0	0	19	0	0
16	27632189	.	G	A	11	7	18	0	2	20	0	0
16	27632228	.	C	T	7	10	17	0	0	17	0	0
16	27632520	.	A	T	7	8	15	0	0	15	0	0
16	27632814	.	G	A	7	5	12	0	2	14	0	0
16	27632934	.	T	C	6	7	13	0	0	13	0	0
16	27633002	.	G	A	9	4	13	0	0	13	0	0
16	27633180	.	C	T	0	3	3	0	11	14	0	0
16	27633812	.	C	T	4	7	11	0	0	11	0	0
16	27633839	.	T	C	6	0	6	0	6	12	0	0
16	27633950	.	G	T	4	2	6	0	0	6	0	0
16	27669917	.	T	G	7	4	11	0	1	12	0	0
16	27670010	.	A	T	3	8	11	0	0	11	0	0
16	27672033	.	A	G	2	2	4	0	0	4	0	0
16	27675950	.	G	A	2	2	4	0	0	4	0	0
16	28112706	.	A	T	6	2	8	0	0	8	0	0
16	28112772	.	G	A	7	5	12	0	0	12	0	0
16	28113049	.	G	A	3	4	7	0	0	7	0	0
16	28245545	.	G	A	7	6	13	0	0	13	0	0
16	28256800	.	G	T	10	6	16	0	0	16	0	0
16	28263526	.	G	A	5	7	12	0	1	13	0	0
16	28264350	.	C	T	4	6	10	0	0	10	0	0
16	28265687	.	T	C	7	3	10	0	0	10	0	0
16	28268273	.	C	A	6	4	10	0	0	10	0	0
16	28270067	.	G	T	0	4	4	0	3	7	0	0
16	28270118	.	C	T	4	6	10	0	0	10	0	0
16	28270561	.	C	T	5	3	8	0	0	8	0	0
16	28270695	.	G	A	5	5	10	0	0	10	0	0
16	28272554	.	T	C	5	4	9	0	1	10	0	0
16	28272555	.	G	A	4	5	9	0	1	10	0	0
16	28276389	.	C	T	8	15	23	0	0	23	0	0
16	28278360	.	T	C	4	5	9	0	0	9	0	0
16	28280057	.	T	C	6	3	9	0	0	9	0	0
16	28305482	.	G	T	3	6	9	0	1	10	0	0
16	28370872	.	T	A	6	8	14	0	0	14	0	0
16	28370943	.	A	T	7	10	17	0	2	19	0	0
16	28511709	.	C	T	1	2	3	0	0	3	0	0
16	28573328	.	G	C	0	5	5	0	3	8	0	0
16	28573665	.	C	A	3	7	10	0	1	11	0	0
16	28573871	.	A	C	6	4	10	0	0	10	0	0
16	28573928	.	C	T	5	4	9	0	0	9	0	0
16	28573957	.	T	A	1	4	5	0	0	5	0	0
16	28574403	.	C	T	4	8	12	1	0	13	0	0
16	28574531	.	T	G	5	14	19	0	0	19	0	0
16	28574664	.	G	A	4	6	10	0	0	10	0	0
16	28591186	.	T	A	4	13	17	0	0	17	0	0
16	28591277	.	A	G	10	23	33	0	1	34	0	0
16	28591312	.	G	A	3	12	15	0	17	32	0	0
16	28591353	.	A	C	9	16	25	0	0	25	0	0
16	28591385	.	C	G	9	14	23	0	1	24	0	0
16	28592667	.	G	C	6	0	6	0	5	11	0	0
16	28592688	.	T	C	6	0	6	0	4	10	0	0
16	28592758	.	A	T	8	9	17	0	0	17	0	0
16	28593056	.	C	T	1	2	3	0	0	3	0	0
16	28593394	.	G	A	5	8	13	0	0	13	0	0
16	28593430	.	G	A	6	8	14	0	1	15	0	0
16	28593493	.	C	T	2	2	4	0	1	5	0	0
16	28593705	.	C	T	2	6	8	0	0	8	0	0
16	28594086	.	T	A	15	6	21	0	1	22	0	0
16	28594102	.	G	T	18	7	25	0	0	25	0	0
16	28624646	.	C	T	4	4	8	0	1	9	0	0
16	28624648	.	G	C	0	4	4	0	5	9	0	0
16	28626282	.	G	A	4	3	7	0	0	7	0	0
16	28626997	.	C	T	2	5	7	0	0	7	0	0
16	28627005	.	C	T	5	2	7	0	0	7	0	0
16	28627127	.	C	T	3	8	11	0	0	11	0	0
16	28627198	.	T	A	4	3	7	0	1	8	0	0
16	28627341	.	T	G	9	7	16	0	0	16	0	0
16	28627342	.	T	A	9	7	16	0	0	16	0	0
16	28629299	.	C	T	0	9	9	0	6	15	0	0
16	28629504	.	C	T	6	6	12	0	0	12	0	0
16	28634954	.	G	A	3	4	7	0	0	7	0	0
16	28640907	.	G	A	1	2	3	0	0	3	0	0
16	28649336	.	C	T	1	2	3	0	0	3	0	0
16	28663361	.	C	T	1	4	5	0	2	7	0	0
16	28665605	.	A	C	1	3	4	0	0	4	0	0
16	28665610	.	A	C	1	1	2	0	1	3	0	0
16	28665700	.	A	G	1	2	3	0	0	3	0	0
16	28665707	.	C	T	2	3	5	0	0	5	0	0
16	28665912	.	G	T	1	2	3	1	0	4	0	0
16	28665925	.	C	T	1	1	2	0	1	3	0	0
16	28667189	.	C	A	2	4	6	0	0	6	0	0
16	28721145	.	A	G	1	3	4	0	0	4	0	0
16	28842438	.	C	T	23	10	33	0	2	35	0	0
16	28856026	.	G	A	15	10	25	0	0	25	0	0
16	28882792	.	T	A	3	2	5	0	0	5	0	0
16	28971711	.	G	A	0	4	4	0	1	5	0	0
16	28983644	.	G	A	4	3	7	0	0	7	0	0
16	28990523	.	C	G	5	3	8	0	0	8	0	0
16	28990769	.	C	T	1	2	3	0	0	3	0	0
16	28990816	.	A	T	1	3	4	0	0	4	0	0
16	28991175	.	T	A	2	2	4	0	0	4	0	0
16	28991213	.	C	T	1	2	3	0	0	3	0	0
16	28991214	.	C	T	1	2	3	0	0	3	0	0
16	29003349	.	C	T	2	2	4	0	1	5	0	0
16	29010826	.	A	T	6	3	9	0	0	9	0	0
16	29012933	.	G	T	0	4	4	0	10	14	0	0
16	29012961	.	C	T	11	3	14	0	0	14	0	0
16	29013039	.	C	G	9	3	12	0	1	13	0	0
16	29013126	.	C	T	7	3	10	0	0	10	0	0
16	29013134	.	C	A	8	2	10	0	0	10	0	0
16	29013188	.	C	T	6	4	10	0	0	10	0	0
16	29013377	.	C	T	12	3	15	0	0	15	0	0
16	29014091	.	A	T	8	7	15	0	0	15	0	0
16	29014109	.	T	C	9	7	16	0	0	16	0	0
16	29016659	.	C	T	7	13	20	0	0	20	0	0
16	29016904	.	T	C	8	5	13	0	0	13	0	0
16	29017221	.	T	C	11	5	16	0	0	16	0	0
16	29019039	.	G	A	9	11	20	0	0	20	0	0
16	29020482	.	G	T	12	15	27	0	3	30	0	0
16	29022955	.	C	A	7	7	14	0	2	16	0	0
16	29023266	.	A	T	6	8	14	0	1	15	0	0
16	29024181	.	A	G	8	4	12	0	0	12	0	0
16	29024280	.	T	G	7	0	7	0	8	15	0	0
16	29024341	.	T	C	4	4	8	0	0	8	0	0
16	29024405	.	C	T	4	3	7	0	3	10	0	0
16	29024409	.	C	T	8	4	12	0	1	13	0	0
16	29024512	.	A	T	6	11	17	0	1	18	0	0
16	29024551	.	A	T	6	7	13	0	0	13	0	0
16	29024552	.	T	G	6	7	13	0	0	13	0	0
16	29027161	.	C	T	3	4	7	0	0	7	0	0
16	29029392	.	G	A	2	2	4	0	0	4	0	0
16	29029444	.	G	A	2	4	6	1	0	7	0	0
16	29029476	.	A	G	2	4	6	0	0	6	0	0
16	29051095	.	A	T	2	2	4	0	0	4	0	0
16	29051102	.	G	A	1	2	3	0	0	3	0	0
16	29051929	.	T	C	1	2	3	0	1	4	0	0
16	29052030	.	C	T	3	4	7	0	0	7	0	0
16	29052096	.	G	T	1	2	3	0	2	5	0	0
16	29052120	.	A	G	1	4	5	0	0	5	0	0
16	29052137	.	A	G	1	4	5	0	0	5	0	0
16	29052653	.	A	T	7	5	12	0	0	12	0	0
16	29052752	.	C	G	3	0	3	0	3	6	0	0
16	29052914	.	G	A	2	4	6	0	0	6	0	0
16	29052991	.	C	T	8	4	12	0	0	12	0	0
16	29053045	.	T	A	5	9	14	0	0	14	0	0
16	29053670	.	A	G	5	2	7	0	0	7	0	0
16	29053673	.	A	G	4	4	8	0	0	8	0	0
16	29053798	.	C	G	3	0	3	2	18	23	0	0
16	29073068	.	G	A	4	2	6	0	2	8	0	0
16	29073621	.	T	A	7	3	10	0	1	11	0	0
16	29074254	.	G	A	19	33	52	0	0	52	0	0
16	29074459	.	T	A	9	10	19	0	1	20	0	0
16	29075137	.	C	T	6	18	24	1	0	26	1	0
16	29075195	.	A	G	14	15	29	0	1	30	0	0
16	29075222	.	T	A	14	10	24	0	2	26	0	0
16	29075305	.	G	A	14	15	29	0	1	30	0	0
16	29075343	.	G	A	11	14	25	0	2	27	0	0
16	29075347	.	C	G	14	12	26	0	1	27	0	0
16	29075674	.	C	A	13	12	25	0	2	27	0	0
16	29075870	.	G	T	10	15	25	0	1	26	0	0
16	29075959	.	C	T	10	7	17	0	1	18	0	0
16	29075962	.	C	T	8	10	18	0	0	18	0	0
16	29076270	.	G	T	24	16	40	0	4	45	1	0
16	29076407	.	C	T	0	15	15	0	20	35	0	0
16	29076471	.	G	A	12	15	27	0	2	29	0	0
16	29076575	.	C	G	2	17	19	0	15	34	0	0
16	29076633	.	G	A	21	23	44	0	1	45	0	0
16	29076669	.	A	G	14	24	38	0	2	40	0	0
16	29076678	.	T	C	18	0	18	0	22	40	0	0
16	29111066	.	T	C	6	1	7	0	6	13	0	0
16	29225873	.	C	G	5	12	17	0	0	17	0	0
16	29226129	.	A	T	6	8	14	0	1	15	0	0
16	29226151	.	C	A	5	6	11	0	0	11	0	0
16	29226538	.	G	T	2	6	8	0	0	8	0	0
16	29226588	.	A	T	6	5	11	0	0	11	0	0
16	29265958	.	A	G	6	2	8	0	0	8	0	0
16	29265992	.	A	C	5	3	8	0	1	9	0	0
16	29266042	.	G	A	6	3	9	0	0	9	0	0
16	29266264	.	T	C	2	2	4	0	0	4	0	0
16	29266271	.	A	T	3	2	5	0	0	5	0	0
16	29266518	.	G	A	2	2	4	0	0	4	0	0
16	29266872	.	A	T	1	2	3	0	0	3	0	0
16	29267889	.	T	A	1	2	3	0	1	4	0	0
16	29310455	.	C	T	17	13	30	0	1	31	0	0
16	29310530	.	C	A	30	15	45	0	1	46	0	0
16	29310541	.	A	G	23	10	33	0	3	36	0	0
16	29310760	.	C	A	19	11	30	0	2	32	0	0
16	29310893	.	G	A	15	7	22	0	2	24	0	0
16	29311381	.	G	A	22	6	28	0	0	28	0	0
16	29311493	.	A	G	17	15	32	0	4	36	0	0
16	29311720	.	T	C	19	11	30	0	0	30	0	0
16	29313828	.	T	C	15	7	22	0	1	23	0	0
16	29314147	.	C	A	14	8	22	0	2	24	0	0
16	29320647	.	A	G	10	8	18	0	0	18	0	0
16	29320674	.	T	G	10	6	16	0	1	17	0	0
16	29321269	.	C	T	7	2	9	0	1	10	0	0
16	29321290	.	C	T	7	2	9	0	1	10	0	0
16	29321310	.	C	T	7	4	11	0	0	11	0	0
16	29323307	.	T	C	10	6	16	0	0	16	0	0
16	29323394	.	T	C	8	5	13	0	0	13	0	0
16	29323864	.	C	T	0	2	2	0	3	5	0	0
16	29324994	.	G	A	2	5	7	0	0	7	0	0
16	29330456	.	A	C	1	1	2	0	1	3	0	0
16	29330481	.	G	A	1	2	3	0	0	3	0	0
16	29330493	.	A	G	1	2	3	0	0	3	0	0
16	29371029	.	C	T	2	2	4	0	0	4	0	0
16	29371164	.	A	G	2	2	4	0	0	4	0	0
16	29371187	.	T	C	2	3	5	0	1	6	0	0
16	29374075	.	A	C	3	2	5	0	1	6	0	0
16	29377838	.	G	A	2	1	3	0	0	3	0	0
16	29377848	.	A	T	2	2	4	0	0	4	0	0
16	29380991	.	C	T	2	3	5	0	0	5	0	0
16	29380992	.	G	A	3	2	5	0	0	5	0	0
16	29381076	.	A	C	3	2	5	0	1	6	0	0
16	29381204	.	G	T	7	4	11	0	0	11	0	0
16	29381369	.	G	A	2	2	4	0	0	4	0	0
16	29381391	.	T	C	3	2	5	0	0	5	0	0
16	29384090	.	T	C	3	3	6	0	1	7	0	0
16	29384099	.	T	A	4	3	7	0	0	7	0	0
16	29384139	.	G	A	3	4	7	0	0	7	0	0
16	29384182	.	C	T	3	5	8	0	0	8	0	0
16	29384187	.	T	C	3	6	9	0	0	9	0	0
16	29384431	.	C	T	2	4	6	0	0	6	0	0
16	29384569	.	C	T	1	3	4	0	0	4	0	0
16	29407754	.	C	T	3	6	9	0	0	9	0	0
16	29407791	.	C	A	17	11	28	0	0	28	0	0
16	29408024	.	A	C	22	11	33	0	4	37	0	0
16	29408926	.	A	T	23	16	39	0	0	39	0	0
16	29408948	.	T	A	16	24	40	0	0	40	0	0
16	29409134	.	A	G	6	6	12	0	0	12	0	0
16	29409181	.	T	A	2	5	7	0	0	7	0	0
16	29409646	.	T	G	20	24	44	0	0	44	0	0
16	29410425	.	A	G	28	22	50	0	2	52	0	0
16	29410520	.	A	G	17	17	34	0	0	34	0	0
16	29411209	.	G	A	18	33	51	0	3	54	0	0
16	29413193	.	C	T	2	18	20	0	20	40	0	0
16	29414004	.	A	C	7	6	13	0	0	13	0	0
16	29420803	.	T	C	5	5	10	0	2	12	0	0
16	29421026	.	C	T	3	8	11	0	0	11	0	0
16	29424985	.	T	A	3	5	8	0	0	8	0	0
16	29425278	.	G	A	4	3	7	0	2	9	0	0
16	29456966	.	G	A	5	3	8	0	0	8	0	0
16	29456996	.	A	G	4	4	8	0	0	8	0	0
16	29457158	.	A	G	1	5	6	0	0	6	0	0
16	29457473	.	T	A	4	4	8	0	0	8	0	0
16	29458388	.	T	C	2	0	2	0	4	6	0	0
16	29586680	.	A	G	9	14	23	0	1	24	0	0
16	29587067	.	G	A	3	6	9	0	0	9	0	0
16	29642184	.	T	C	16	4	20	0	0	20	0	0
16	29644223	.	C	T	7	12	19	0	0	19	0	0
16	29686304	.	A	G	2	2	4	0	0	4	0	0
16	29686355	.	G	C	6	3	9	0	0	9	0	0
16	29686370	.	G	T	4	5	9	0	0	9	0	0
16	29688362	.	A	G	2	3	5	0	1	6	0	0
16	29688363	.	A	T	3	3	6	0	0	6	0	0
16	29690142	.	T	A	3	2	5	0	0	5	0	0
16	29691190	.	A	G	2	0	2	0	4	6	0	0
16	29691334	.	G	A	1	3	4	0	0	4	0	0
16	29693871	.	A	G	1	0	1	0	3	4	0	0
16	29693999	.	A	G	3	3	6	0	0	6	0	0
16	29695989	.	G	T	1	2	3	0	0	3	0	0
16	29696212	.	G	C	2	3	5	0	0	5	0	0
16	29696626	.	T	A	2	2	4	0	0	4	0	0
16	29696627	.	C	T	1	2	3	0	0	3	0	0
16	30002867	.	G	T	1	4	5	0	0	5	0	0
16	30202882	.	G	A	1	2	3	0	0	3	0	0
16	30202951	.	T	C	2	3	5	0	0	5	0	0
16	30205225	.	T	C	2	2	4	0	0	4	0	0
16	30266844	.	G	A	7	2	9	0	1	10	0	0
16	30267228	.	A	G	12	2	14	0	13	27	0	0
16	30267841	.	T	C	6	5	11	0	0	11	0	0
16	30268158	.	A	G	9	3	12	1	3	16	0	0
16	30268242	.	T	C	6	5	11	0	0	11	0	0
16	30268290	.	G	A	8	2	10	0	2	12	0	0
16	30268475	.	A	C	6	6	12	0	0	12	0	0
16	30268633	.	C	T	7	8	15	0	0	15	0	0
16	30268660	.	A	G	9	8	17	0	0	17	0	0
16	30268675	.	C	T	8	5	13	0	1	14	0	0
16	30269159	.	A	C	8	9	17	0	0	17	0	0
16	30270332	.	G	T	1	4	5	0	9	14	0	0
16	30270381	.	T	G	11	4	15	0	1	16	0	0
16	30270601	.	C	T	25	15	40	0	1	41	0	0
16	30322796	.	C	T	5	2	7	0	0	7	0	0
16	30323168	.	T	G	3	2	5	0	0	5	0	0
16	30323212	.	T	A	1	2	3	0	1	4	0	0
16	30408725	.	A	T	1	4	5	0	0	5	0	0
16	30408765	.	T	A	1	4	5	0	0	5	0	0
16	30408917	.	A	G	17	19	36	0	4	40	0	0
16	30409055	.	A	T	27	25	52	0	0	52	0	0
16	30409313	.	A	T	35	25	60	0	1	61	0	0
16	30415027	.	C	T	17	27	44	0	2	46	0	0
16	30417511	.	A	G	20	23	43	0	2	45	0	0
16	30417977	.	A	G	13	20	33	0	0	33	0	0
16	30417986	.	A	G	12	20	32	0	1	33	0	0
16	30419504	.	A	G	21	11	32	0	0	32	0	0
16	30420547	.	C	T	14	12	26	0	0	26	0	0
16	30422582	.	C	G	13	10	23	0	0	23	0	0
16	30422807	.	T	C	19	0	19	0	11	30	0	0
16	30422891	.	G	A	18	4	22	0	3	25	0	0
16	30423680	.	G	C	2	2	4	0	0	4	0	0
16	30423953	.	G	A	12	12	24	0	1	25	0	0
16	30426496	.	T	A	10	4	14	0	2	16	0	0
16	30427042	.	A	G	2	5	7	0	0	7	0	0
16	30429159	.	A	G	4	5	9	0	0	9	0	0
16	30429384	.	G	A	4	3	7	0	0	7	0	0
16	30432287	.	A	G	2	2	4	0	0	4	0	0
16	30434127	.	A	G	2	3	5	0	0	5	0	0
16	30434156	.	C	T	1	2	3	0	0	3	0	0
16	30434215	.	T	A	4	2	6	0	0	6	0	0
16	30515689	.	A	T	3	2	5	0	0	5	0	0
16	30521704	.	A	T	7	6	13	0	2	15	0	0
16	30522176	.	G	C	3	13	16	0	1	17	0	0
16	30522317	.	G	C	4	10	14	0	0	14	0	0
16	30522334	.	C	T	7	5	12	0	0	12	0	0
16	30522565	.	T	G	1	1	2	0	0	2	0	0
16	30522577	.	A	T	1	2	3	0	0	3	0	0
16	30522852	.	G	A	1	4	5	0	0	5	0	0
16	30522923	.	C	T	1	4	5	0	4	9	0	0
16	30523253	.	C	G	4	5	9	0	1	10	0	0
16	30525371	.	T	C	2	0	2	0	4	6	0	0
16	30525458	.	A	G	4	7	11	0	1	12	0	0
16	30525499	.	A	G	5	7	12	0	0	12	0	0
16	30530401	.	C	T	2	4	6	0	0	6	0	0
16	30531304	.	C	T	3	12	15	0	0	15	0	0
16	30531358	.	T	C	4	9	13	0	0	13	0	0
16	30562816	.	T	G	3	6	9	0	3	12	0	0
16	30562862	.	G	A	2	6	8	0	1	9	0	0
16	30562958	.	C	T	3	3	6	0	0	6	0	0
16	30737594	.	A	G	13	11	24	0	2	26	0	0
16	30737638	.	C	T	14	16	30	0	1	31	0	0
16	30737770	.	A	G	20	21	41	0	0	41	0	0
16	30738108	.	C	T	2	14	16	0	20	36	0	0
16	30740719	.	T	G	8	18	26	0	1	27	0	0
16	30760879	.	A	C	11	0	11	0	7	18	0	0
16	30772417	.	C	T	2	7	9	0	6	15	0	0
16	30785451	.	T	C	9	5	14	0	0	14	0	0
16	30788182	.	A	G	8	7	15	0	0	15	0	0
16	30794822	.	T	G	4	3	7	0	0	7	0	0
16	30800501	.	G	A	7	5	12	0	0	12	0	0
16	30808411	.	T	C	6	3	9	0	0	9	0	0
16	30808429	.	C	T	0	3	3	0	7	10	0	0
16	30826525	.	A	G	3	6	9	0	0	9	0	0
16	30869597	.	C	G	0	4	4	0	4	8	0	0
16	30869623	.	A	T	4	7	11	0	0	11	0	0
16	30908705	.	G	C	3	4	7	0	0	7	0	0
16	30908825	.	A	C	5	2	7	0	0	7	0	0
16	30909367	.	A	G	2	4	6	0	0	6	0	0
16	30918883	.	C	G	2	2	4	0	0	4	0	0
16	30919193	.	C	T	0	2	2	0	1	3	0	0
16	30919222	.	C	T	3	2	5	0	0	5	0	0
16	30948583	.	A	C	2	2	4	0	0	4	0	0
16	30948760	.	C	T	1	3	4	0	0	4	0	0
16	30980453	.	C	T	1	4	5	0	0	5	0	0
16	30980501	.	G	A	1	3	4	0	1	5	0	0
16	31186631	.	A	T	18	10	28	0	0	28	0	0
16	31187097	.	C	T	0	10	10	0	7	17	0	0
16	31187322	.	A	G	16	11	27	0	0	27	0	0
16	31188481	.	G	A	4	9	13	0	3	16	0	0
16	31261003	.	A	T	5	4	9	0	0	9	0	0
16	31261213	.	C	A	1	8	9	0	4	13	0	0
16	31261344	.	C	T	5	9	14	0	3	17	0	0
16	31266548	.	G	A	7	2	9	0	0	9	0	0
16	31267559	.	C	T	1	2	3	0	5	8	0	0
16	31268893	.	C	A	3	4	7	0	1	8	0	0
16	31272424	.	C	G	8	7	15	0	0	15	0	0
16	31274289	.	T	A	11	4	15	0	0	15	0	0
16	31274491	.	G	A	3	6	9	0	0	9	0	0
16	31274554	.	G	A	2	2	4	0	0	4	0	0
16	31280355	.	G	A	5	5	10	0	0	10	0	0
16	31303616	.	T	C	1	0	1	0	5	6	0	0
16	31342344	.	C	T	1	3	4	0	0	4	0	0
16	31428813	.	T	G	10	4	14	0	0	14	0	0
16	31436504	.	A	T	0	2	2	0	2	4	0	0
16	31437115	.	A	G	12	10	22	0	0	22	0	0
16	31437955	.	A	G	28	29	57	2	5	64	0	0
16	31444428	.	G	A	15	13	28	0	0	28	0	0
16	31444843	.	A	T	15	13	28	0	0	28	0	0
16	31445516	.	T	C	9	14	23	0	1	24	0	0
16	31455092	.	T	C	1	3	4	0	1	5	0	0
16	31602170	.	A	G	11	10	21	0	0	21	0	0
16	31608012	.	A	G	8	4	12	0	2	14	0	0
16	31608101	.	C	T	0	6	6	0	4	10	0	0
16	31608967	.	G	T	3	6	9	0	0	9	0	0
16	31609241	.	C	T	1	4	5	0	9	14	0	0
16	31610375	.	C	T	4	9	13	0	0	13	0	0
16	31613619	.	A	G	6	2	8	0	1	9	0	0
16	31614272	.	C	G	6	5	11	0	0	11	0	0
16	31614918	.	G	A	4	5	9	0	1	10	0	0
16	31615114	.	G	A	5	5	10	0	1	11	0	0
16	31723863	.	T	C	1	3	4	0	0	4	0	0
16	31728192	.	A	G	1	2	3	0	0	3	0	0
16	31762960	.	C	T	15	13	28	0	1	29	0	0
16	31763316	.	T	C	10	17	27	0	0	27	0	0
16	31763318	.	C	T	9	15	24	0	3	27	0	0
16	31763668	.	C	G	12	15	27	0	0	27	0	0
16	31763743	.	T	A	20	22	42	0	3	45	0	0
16	31763751	.	A	C	25	20	45	0	1	47	1	0
16	31763785	.	G	A	22	22	44	0	2	46	0	0
16	31763786	.	C	A	23	20	43	0	4	47	0	0
16	31763880	.	A	G	12	24	36	0	0	36	0	0
16	31764987	.	C	T	16	10	26	0	1	27	0	0
16	31766937	.	T	A	15	7	22	0	0	22	0	0
16	31767116	.	T	C	7	0	7	0	15	22	0	0
16	31767152	.	A	G	13	13	26	0	1	27	0	0
16	31767163	.	G	A	16	14	30	0	0	30	0	0
16	31767191	.	T	C	12	15	27	0	3	30	0	0
16	31768343	.	C	G	24	10	34	0	0	34	0	0
16	31768394	.	T	C	17	9	26	0	0	26	0	0
16	31768436	.	T	C	14	16	30	0	0	30	0	0
16	31769317	.	G	A	14	15	29	0	2	31	0	0
16	31769395	.	A	G	7	17	24	0	1	25	0	0
16	31769428	.	G	A	9	7	16	0	1	17	0	0
16	31776125	.	C	T	6	8	14	0	1	15	0	0
16	31780108	.	C	T	0	5	5	0	2	7	0	0
16	31782938	.	C	T	2	6	8	0	0	8	0	0
16	31789327	.	C	T	3	5	8	0	0	8	0	0
16	31790262	.	C	T	3	3	6	0	0	6	0	0
16	31815638	.	C	T	17	12	29	0	0	29	0	0
16	31815878	.	G	A	4	14	18	0	0	18	0	0
16	31816005	.	C	A	16	5	21	0	0	21	0	0
16	31816205	.	C	T	12	4	16	0	0	16	0	0
16	31816336	.	C	T	0	13	13	0	4	17	0	0
16	31816596	.	C	T	12	19	31	0	1	32	0	0
16	31827642	.	T	A	14	17	31	0	1	32	0	0
16	31827703	.	C	T	16	15	31	0	1	32	0	0
16	31832606	.	A	G	16	2	18	0	37	55	0	0
16	31834505	.	G	A	0	2	2	0	1	3	0	0
16	31853932	.	T	A	4	2	6	0	0	6	0	0
16	31854325	.	C	A	5	2	7	0	1	8	0	0
16	31855327	.	G	A	5	5	10	0	0	10	0	0
16	31855351	.	G	C	3	5	8	0	1	9	0	0
16	31855575	.	C	T	14	3	17	0	1	18	0	0
16	31855576	.	C	T	14	4	18	0	0	18	0	0
16	31855814	.	T	G	6	2	8	0	4	12	0	0
16	31856239	.	A	G	4	3	7	0	0	7	0	0
16	31856276	.	G	A	2	2	4	0	5	9	0	0
16	31859200	.	A	G	28	9	37	0	1	38	0	0
16	31859227	.	T	C	23	15	38	0	1	39	0	0
16	31859341	.	C	T	30	21	51	0	3	54	0	0
16	31859371	.	T	C	19	22	41	1	4	46	0	0
16	31859686	.	G	A	10	8	18	0	0	18	0	0
16	31868443	.	G	A	22	12	34	0	1	35	0	0
16	31922892	.	A	G	24	32	56	0	2	58	0	0
16	31923083	.	G	A	36	28	64	0	1	65	0	0
16	31923435	.	A	G	29	32	61	0	2	63	0	0
16	31924485	.	T	C	25	21	46	0	3	49	0	0
16	31924501	.	A	C	26	21	47	0	5	52	0	0
16	31925727	.	G	A	2	3	5	0	1	6	0	0
16	31927369	.	C	A	4	3	7	0	0	7	0	0
16	31951694	.	G	C	2	3	5	0	0	5	0	0
16	31955226	.	C	G	1	4	5	0	0	5	0	0
16	31958514	.	C	T	1	3	4	0	0	4	0	0
16	31959098	.	G	A	1	4	5	0	5	10	0	0
16	31959476	.	G	A	3	2	5	0	0	5	0	0
16	31959496	.	A	G	3	0	3	0	2	5	0	0
16	31959845	.	A	G	3	0	3	0	5	8	0	0
16	31960037	.	G	A	1	6	7	0	4	11	0	0
16	31960064	.	G	C	6	4	10	0	1	11	0	0
16	31960093	.	T	C	9	5	14	0	1	15	0	0
16	31960145	.	C	T	5	10	15	0	1	16	0	0
16	31960152	.	C	T	5	10	15	0	1	16	0	0
16	32009736	.	A	T	6	3	9	0	0	9	0	0
16	32011649	.	C	T	9	5	14	0	3	17	0	0
16	32011673	.	A	G	6	10	16	0	1	17	0	0
16	32013272	.	G	A	6	7	13	0	3	16	0	0
16	32013766	.	T	G	3	2	5	0	0	5	0	0
16	32019695	.	G	A	4	5	9	1	1	11	0	0
16	32021999	.	C	T	4	7	11	0	0	11	0	0
16	32023124	.	T	A	5	5	10	0	0	10	0	0
16	32025648	.	T	A	6	15	21	0	2	23	0	0
16	32025978	.	G	A	11	6	17	0	0	17	0	0
16	32025987	.	T	A	12	7	19	0	1	20	0	0
16	32026063	.	G	A	1	10	11	1	11	23	0	0
16	32026105	.	T	A	8	6	14	1	1	16	0	0
16	32026154	.	T	G	4	3	7	0	1	8	0	0
16	32026203	.	C	T	1	2	3	0	0	3	0	0
16	32026206	.	A	G	1	2	3	0	0	3	0	0
16	32051854	.	A	C	4	10	14	0	2	16	0	0
16	32052004	.	T	G	5	7	12	0	0	12	0	0
16	32052283	.	T	A	8	6	14	0	1	15	0	0
16	32052307	.	T	C	9	9	18	0	0	18	0	0
16	32052328	.	T	A	10	8	18	0	2	20	0	0
16	32052404	.	G	T	2	5	7	0	13	20	0	0
16	32055726	.	T	G	12	12	24	0	0	24	0	0
16	32057809	.	T	C	7	5	12	0	4	16	0	0
16	32057853	.	G	A	0	6	6	0	9	15	0	0
16	32060121	.	G	T	5	2	7	0	0	7	0	0
16	32060130	.	C	A	5	2	7	0	0	7	0	0
16	32063433	.	C	T	2	3	5	0	0	5	0	0
16	32068332	.	G	A	3	3	6	0	0	6	0	0
16	32068503	.	T	C	4	3	7	0	0	7	0	0
16	32069310	.	T	A	9	5	14	0	2	16	0	0
16	32069653	.	A	G	5	7	12	0	2	14	0	0
16	32070489	.	A	G	14	0	14	0	6	20	0	0
16	32070570	.	C	T	10	5	15	0	1	16	0	0
16	32070981	.	G	C	9	19	28	0	0	28	0	0
16	32071965	.	G	C	4	4	8	0	1	9	0	0
16	32072334	.	A	G	8	18	26	0	1	27	0	0
16	32073301	.	A	C	17	14	31	0	3	34	0	0
16	32073507	.	A	C	21	21	42	0	3	45	0	0
16	32073555	.	A	G	22	21	43	0	0	43	0	0
16	32073760	.	G	A	22	17	39	0	4	43	0	0
16	32074041	.	G	A	21	16	37	0	0	37	0	0
16	32074257	.	A	G	16	0	16	0	22	38	0	0
16	32074293	.	T	A	15	21	36	0	3	39	0	0
16	32074294	.	A	G	15	24	39	0	0	39	0	0
16	32080069	.	G	T	3	10	13	0	10	23	0	0
16	32080099	.	G	A	4	3	7	0	1	8	0	0
16	32080196	.	T	C	0	4	4	0	2	6	0	0
16	32080206	.	T	C	2	3	5	0	2	7	0	0
16	32080306	.	T	A	9	4	13	0	1	14	0	0
16	32080508	.	T	A	15	17	32	0	4	36	0	0
16	32080738	.	G	A	6	4	10	0	0	10	0	0
16	32082397	.	T	C	7	13	20	0	2	22	0	0
16	32082589	.	G	A	8	13	21	0	0	21	0	0
16	32082597	.	G	A	7	13	20	0	0	20	0	0
16	32082642	.	G	A	5	4	9	0	1	10	0	0
16	32085319	.	T	A	9	6	15	0	3	18	0	0
16	32085631	.	A	G	8	4	12	0	2	14	0	0
16	32086136	.	C	T	4	11	15	0	1	16	0	0
16	32088580	.	T	A	4	12	16	0	1	17	0	0
16	32090349	.	C	T	15	10	25	0	0	25	0	0
16	32090425	.	G	C	11	6	17	0	1	18	0	0
16	32090539	.	T	C	2	3	5	0	0	5	0	0
16	32090542	.	A	T	2	3	5	0	0	5	0	0
16	32110659	.	A	G	25	7	32	0	0	32	0	0
16	32111246	.	G	T	16	18	34	0	1	35	0	0
16	32113155	.	G	A	15	11	26	0	3	29	0	0
16	32116790	.	A	T	12	8	20	0	0	20	0	0
16	32117345	.	T	A	4	10	14	0	9	23	0	0
16	32119581	.	C	A	4	7	11	0	0	11	0	0
16	32119618	.	C	T	2	10	12	0	1	13	0	0
16	32119895	.	G	T	12	8	20	0	1	21	0	0
16	32120138	.	G	T	6	5	11	0	1	12	0	0
16	32120141	.	T	C	4	0	4	0	7	11	0	0
16	32120173	.	G	A	8	7	15	0	1	16	0	0
16	32120204	.	G	T	8	7	15	0	0	15	0	0
16	32120279	.	A	C	8	7	15	0	1	16	0	0
16	32128259	.	T	A	4	5	9	0	0	9	0	0
16	32140638	.	G	C	4	2	6	0	0	6	0	0
16	32141058	.	A	G	5	3	8	0	0	8	0	0
16	32141075	.	G	A	5	4	9	0	0	9	0	0
16	32141544	.	A	G	12	0	12	0	12	24	0	0
16	32141565	.	A	C	12	11	23	0	0	23	0	0
16	32141604	.	A	T	4	3	7	0	2	10	1	0
16	32144337	.	T	C	10	7	17	0	0	17	0	0
16	32144377	.	T	C	7	6	13	0	0	13	0	0
16	32144854	.	G	T	1	7	8	0	2	10	0	0
16	32144989	.	T	C	6	4	10	0	0	10	0	0
16	32145160	.	T	A	6	8	14	0	0	14	0	0
16	32145391	.	G	A	6	4	10	0	0	10	0	0
16	32145547	.	T	C	2	3	5	0	0	5	0	0
16	32145636	.	A	G	11	9	20	0	0	20	0	0
16	32197969	.	C	T	14	12	26	0	1	27	0	0
16	32217198	.	G	T	3	3	6	0	0	6	0	0
16	32267128	.	G	A	4	4	8	0	0	8	0	0
16	32267203	.	G	A	1	7	8	0	7	15	0	0
16	32273066	.	G	T	3	6	9	0	0	9	0	0
16	32273192	.	G	A	0	5	5	0	9	14	0	0
16	32274935	.	G	A	8	6	14	1	0	15	0	0
16	32275601	.	T	A	6	4	10	0	0	10	0	0
16	32275628	.	A	T	4	10	14	0	1	15	0	0
16	32561581	.	T	A	1	4	5	0	0	5	0	0
16	32562817	.	A	T	3	3	6	0	1	7	0	0
16	32562840	.	C	G	0	8	8	0	0	8	0	0
16	33004387	.	C	T	4	2	6	0	5	11	0	0
16	33735481	.	G	A	3	2	5	0	0	5	0	0
16	33735503	.	C	T	3	3	6	0	1	7	0	0
16	33736068	.	A	G	1	2	3	0	0	3	0	0
16	33736595	.	C	T	1	2	3	0	0	3	0	0
16	33902151	.	C	T	1	3	4	0	0	4	0	0
16	33905018	.	C	T	2	3	5	0	0	5	0	0
16	33909384	.	G	A	0	2	2	0	5	7	0	0
16	33919623	.	G	A	3	3	6	0	0	6	0	0
16	33923421	.	G	T	2	2	4	0	0	4	0	0
16	33923448	.	G	T	3	4	7	0	0	7	0	0
16	33923514	.	G	A	6	8	14	0	0	14	0	0
16	33925132	.	G	C	13	9	22	0	2	24	0	0
16	33925356	.	G	A	0	4	4	0	5	9	0	0
16	33925565	.	T	G	2	2	4	0	0	4	0	0
16	33928015	.	G	A	0	3	3	0	2	5	0	0
16	33933213	.	C	T	6	8	14	0	0	14	0	0
16	33933496	.	G	C	3	3	6	0	0	6	0	0
16	33933498	.	C	T	3	3	6	0	0	6	0	0
16	33933732	.	G	A	1	6	7	0	11	18	0	0
16	33939824	.	T	C	4	4	8	0	0	8	0	0
16	33939859	.	C	T	3	7	10	0	0	10	0	0
16	33940098	.	G	A	3	4	7	0	2	9	0	0
16	33940122	.	G	A	3	3	6	0	0	6	0	0
16	33940364	.	A	G	5	0	5	0	6	11	0	0
16	33940379	.	T	A	7	8	15	0	1	16	0	0
16	33953968	.	C	T	4	3	7	0	0	7	0	0
16	33964788	.	G	T	1	2	3	0	0	3	0	0
16	33971993	.	G	A	0	2	2	0	7	9	0	0
16	33972008	.	G	A	4	7	11	0	0	11	0	0
16	33972037	.	A	C	5	5	10	0	2	12	0	0
16	33972067	.	A	G	6	4	10	0	0	10	0	0
16	33972193	.	G	A	0	6	6	0	6	12	0	0
16	33972242	.	G	T	5	5	10	0	0	10	0	0
16	33972249	.	C	T	2	4	6	0	1	7	0	0
16	33972454	.	C	T	6	3	9	0	0	9	0	0
16	33978019	.	A	G	4	0	4	0	4	8	0	0
16	33981439	.	C	T	6	6	12	0	0	12	0	0
16	33981873	.	A	G	3	0	3	0	9	12	0	0
16	33983784	.	T	G	7	5	12	0	0	12	0	0
16	33983904	.	C	T	9	4	13	0	0	13	0	0
16	33984178	.	C	T	7	4	11	0	0	11	0	0
16	33984190	.	C	T	8	5	13	0	1	14	0	0
16	33985050	.	G	T	0	15	15	0	14	29	0	0
16	33985362	.	C	T	15	12	27	0	1	28	0	0
16	33986179	.	A	T	17	9	26	0	3	29	0	0
16	33986452	.	T	G	28	20	48	0	1	49	0	0
16	33988049	.	T	C	2	4	6	0	0	6	0	0
16	33988069	.	C	A	3	3	6	0	0	6	0	0
16	33989606	.	G	T	0	6	6	0	2	8	0	0
16	33992678	.	A	C	2	2	4	0	0	4	0	0
16	33992799	.	C	G	2	2	4	0	0	4	0	0
16	33994640	.	G	A	1	2	3	0	2	5	0	0
16	33995754	.	G	A	0	5	5	0	1	6	0	0
16	33996739	.	C	T	2	3	5	0	0	5	0	0
16	34004562	.	G	A	0	10	10	0	6	16	0	0
16	34004595	.	T	C	12	5	17	0	0	17	0	0
16	34004862	.	C	T	2	4	6	0	0	6	0	0
16	34005290	.	C	T	4	8	12	0	0	12	0	0
16	34005415	.	C	T	5	3	8	0	1	9	0	0
16	34005500	.	C	A	5	5	10	0	0	10	0	0
16	34005669	.	C	T	10	5	15	0	2	17	0	0
16	34005686	.	C	T	8	6	14	0	2	16	0	0
16	34005845	.	A	G	3	3	6	0	4	10	0	0
16	34005858	.	A	G	2	4	6	0	1	7	0	0
16	34054464	.	C	A	3	8	11	0	0	11	0	0
16	34054515	.	A	G	4	5	9	0	0	9	0	0
16	34054519	.	C	T	2	5	7	0	1	8	0	0
16	34054712	.	T	G	2	0	2	0	4	6	0	0
16	34054923	.	G	A	1	3	4	0	4	8	0	0
16	34055747	.	A	T	1	1	2	0	0	2	0	0
16	34055754	.	C	T	2	1	3	0	1	4	0	0
16	34055965	.	A	T	1	2	3	0	0	3	0	0
16	34055966	.	T	G	1	2	3	0	0	3	0	0
16	34056204	.	T	A	2	3	5	0	0	5	0	0
16	34172916	.	G	A	1	3	4	0	0	4	0	0
16	34173000	.	T	C	4	3	7	0	2	9	0	0
16	34173331	.	G	A	4	3	7	0	0	7	0	0
16	34173624	.	G	A	3	3	6	0	1	7	0	0
16	34173954	.	G	T	1	2	3	0	0	3	0	0
16	34185906	.	A	T	7	6	13	0	2	15	0	0
16	34200704	.	C	T	16	28	44	0	1	45	0	0
16	34201023	.	A	G	17	14	31	0	0	31	0	0
16	34208582	.	T	C	18	0	18	0	14	32	0	0
16	34208696	.	A	G	20	14	34	0	2	36	0	0
16	34212477	.	A	G	8	15	23	0	1	24	0	0
16	34212516	.	A	G	11	14	25	0	1	26	0	0
16	34212565	.	G	A	15	13	28	0	1	29	0	0
16	34212567	.	G	C	14	13	27	0	1	28	0	0
16	34212630	.	T	C	22	4	26	1	20	47	0	0
16	34222439	.	T	G	14	14	28	1	5	34	0	0
16	34225173	.	T	C	13	15	28	0	3	31	0	0
16	34225392	.	A	G	10	9	19	0	2	21	0	0
16	34225472	.	G	A	9	18	27	0	0	27	0	0
16	34267938	.	C	T	0	8	8	0	9	17	0	0
16	34267991	.	G	C	8	8	16	0	0	16	0	0
16	34321568	.	A	T	5	6	11	0	1	12	0	0
16	34322036	.	G	T	3	7	10	0	0	10	0	0
16	34322346	.	G	A	14	16	30	0	1	31	0	0
16	34322372	.	C	T	2	14	16	0	14	30	0	0
16	34331489	.	A	G	7	7	14	0	0	14	0	0
16	34337976	.	A	T	13	8	21	0	1	22	0	0
16	34338475	.	A	G	10	10	20	0	0	20	0	0
16	34339168	.	A	C	8	11	19	0	1	20	0	0
16	34339432	.	A	T	6	13	19	0	3	22	0	0
16	34339693	.	C	T	10	8	18	0	0	18	0	0
16	34339808	.	A	G	9	4	13	0	0	13	0	0
16	34339857	.	T	G	7	6	13	0	0	13	0	0
16	34340179	.	A	T	4	6	10	0	0	10	0	0
16	34340311	.	T	C	5	0	5	0	4	9	0	0
16	34340397	.	A	C	10	7	17	0	1	18	0	0
16	34340520	.	G	T	5	5	10	0	1	11	0	0
16	34340538	.	C	T	4	5	9	0	0	9	0	0
16	34341012	.	C	T	6	2	8	0	1	9	0	0
16	34341021	.	C	T	5	2	7	0	0	7	0	0
16	34342182	.	T	C	7	4	11	0	1	12	0	0
16	34497550	.	T	C	6	4	10	0	0	10	0	0
16	34499701	.	G	A	0	2	2	0	4	6	0	0
16	34499820	.	G	T	2	4	6	0	0	6	0	0
16	34499833	.	G	A	2	3	5	0	0	5	0	0
16	34499940	.	A	G	6	4	10	0	0	10	0	0
16	34500167	.	A	G	2	5	7	0	0	7	0	0
16	34500189	.	T	A	2	3	5	0	0	5	0	0
16	34500283	.	A	G	1	2	3	0	0	3	0	0
16	34500542	.	G	C	9	9	18	0	4	22	0	0
16	34500582	.	G	A	7	3	10	0	0	10	0	0
16	34500589	.	G	C	0	5	5	0	2	7	0	0
16	34500899	.	G	A	18	8	26	0	1	27	0	0
16	34501292	.	A	G	6	2	8	0	3	11	0	0
16	34501348	.	C	T	9	5	14	3	0	17	0	0
16	34501380	.	C	T	7	9	16	3	1	20	0	0
16	34501496	.	G	A	0	11	11	0	3	14	0	0
16	34501670	.	C	T	4	15	19	0	0	19	0	0
16	34525621	.	C	A	40	42	82	0	4	86	0	0
16	34526092	.	C	G	27	34	61	0	1	62	0	0
16	34526093	.	A	C	19	35	54	0	8	62	0	0
16	34526926	.	A	T	23	29	52	1	14	68	1	0
16	34532205	.	G	A	1	15	16	0	10	26	0	0
16	34532782	.	C	G	3	10	13	0	1	14	0	0
16	34532843	.	T	C	3	7	10	0	1	11	0	0
16	34930635	.	A	G	8	7	15	0	0	15	0	0
16	34930719	.	C	T	1	8	9	0	8	17	0	0
16	34948262	.	C	T	5	10	15	0	0	15	0	0
16	34953166	.	C	T	8	5	13	0	2	15	0	0
16	34975908	.	A	G	6	11	17	0	0	17	0	0
16	34993814	.	T	C	4	0	4	0	4	8	0	0
16	35023920	.	C	T	4	4	8	0	0	8	0	0
16	35023934	.	T	C	3	5	8	0	0	8	0	0
16	35023967	.	T	A	6	3	9	0	1	10	0	0
16	35043863	.	C	T	7	4	11	1	3	15	0	0
16	35372069	.	C	T	4	4	8	0	0	8	0	0
16	35376825	.	C	T	6	7	13	0	0	13	0	0
16	35378615	.	A	G	1	2	3	0	0	3	0	0
16	35409483	.	C	T	3	25	28	0	27	55	0	0
16	35409783	.	G	A	12	20	32	0	4	36	0	0
16	35414455	.	A	G	13	7	20	0	0	20	0	0
16	35414470	.	T	C	14	8	22	0	1	23	0	0
16	35414991	.	C	T	13	15	28	0	1	29	0	0
16	35416113	.	A	G	13	9	22	0	2	24	0	0
16	35416158	.	C	T	11	19	30	0	2	32	0	0
16	35416786	.	A	G	20	22	42	0	3	45	0	0
16	35418744	.	T	C	15	1	16	0	15	31	0	0
16	35420600	.	T	C	18	0	18	0	17	35	0	0
16	35423585	.	C	T	1	6	7	0	8	15	0	0
16	35426998	.	T	C	6	0	6	0	11	17	0	0
16	35536574	.	C	A	11	8	19	0	1	20	0	0
16	35536576	.	G	A	1	9	10	0	10	20	0	0
16	35536848	.	G	A	5	7	12	0	0	12	0	0
16	35536900	.	A	G	3	7	10	0	1	11	0	0
16	35536960	.	T	C	11	9	20	0	1	21	0	0
16	35536990	.	C	T	14	12	26	0	0	26	0	0
16	35537153	.	G	A	11	6	17	0	0	17	0	0
16	35537270	.	C	A	17	6	23	0	3	26	0	0
16	35556078	.	G	A	2	3	5	0	0	5	0	0
16	35556083	.	C	T	2	4	6	0	0	6	0	0
16	35556275	.	C	A	4	3	7	0	0	7	0	0
16	35556303	.	C	T	4	4	8	0	0	8	0	0
16	35556365	.	A	G	4	2	6	0	0	6	0	0
16	35562788	.	C	A	1	1	2	0	0	2	0	0
16	35562804	.	A	G	1	2	3	0	1	4	0	0
16	35563494	.	T	C	3	0	3	0	3	6	0	0
16	35563507	.	G	A	3	3	6	0	0	6	0	0
16	35661979	.	A	G	3	7	10	0	0	10	0	0
16	35662078	.	T	G	4	4	8	0	1	9	0	0
16	35662132	.	A	C	4	5	9	0	0	9	0	0
16	35718538	.	A	G	5	3	8	0	0	8	0	0
16	35728994	.	G	A	7	4	11	0	0	11	0	0
16	35743849	.	A	T	7	7	14	0	0	14	0	0
16	35750714	.	T	A	11	12	23	0	1	24	0	0
16	35752670	.	C	T	12	12	24	0	0	24	0	0
16	35752785	.	T	C	12	15	27	0	2	29	0	0
16	35762009	.	C	A	5	7	12	0	1	13	0	0
16	35762010	.	A	C	4	8	12	0	1	13	0	0
16	35764580	.	C	T	14	10	24	0	0	24	0	0
16	35773005	.	A	G	10	10	20	0	0	20	0	0
16	35944291	.	T	A	2	2	4	0	0	4	0	0
16	36041247	.	G	A	5	7	12	0	0	12	0	0
16	36062265	.	T	C	3	0	3	0	2	5	0	0
16	36074270	.	C	A	1	2	3	0	0	3	0	0
16	36075471	.	G	A	6	4	10	0	1	11	0	0
16	36075478	.	T	A	6	4	10	0	0	10	0	0
16	36075677	.	C	A	8	12	20	0	2	22	0	0
16	36075999	.	A	G	12	8	20	0	0	20	0	0
16	36076082	.	G	A	10	10	20	0	0	20	0	0
16	36080364	.	C	T	15	10	25	0	0	25	0	0
16	36080376	.	A	C	12	11	23	0	0	23	0	0
16	36087550	.	A	C	2	0	2	0	5	7	0	0
16	36118070	.	T	C	7	0	7	0	7	14	0	0
16	36118166	.	T	C	2	0	2	0	6	8	0	0
16	36150674	.	A	G	4	6	10	0	5	15	0	0
16	36150707	.	C	T	11	8	19	0	1	20	0	0
16	36150949	.	C	T	16	21	37	0	1	38	0	0
16	36150964	.	C	T	14	24	38	0	2	40	0	0
16	36151000	.	C	A	14	19	33	0	1	34	0	0
16	36159928	.	T	C	12	17	29	0	1	30	0	0
16	36162013	.	C	T	13	18	31	0	2	33	0	0
16	36162201	.	A	G	6	10	16	0	1	17	0	0
16	36162584	.	G	C	0	10	10	0	10	20	0	0
16	36162650	.	T	C	16	11	27	0	1	28	0	0
16	36162727	.	A	G	19	11	30	0	2	32	0	0
16	36162754	.	A	G	18	11	29	0	1	30	0	0
16	36163005	.	G	A	12	8	20	0	1	21	0	0
16	36163006	.	A	C	13	8	21	0	0	21	0	0
16	36168251	.	C	T	7	6	13	0	2	15	0	0
16	36168317	.	G	C	9	11	20	0	0	20	0	0
16	36168416	.	T	C	6	7	13	0	2	15	0	0
16	36168450	.	A	T	6	5	11	0	0	11	0	0
16	36168510	.	A	T	8	8	16	0	0	16	0	0
16	36168575	.	T	G	6	3	9	0	2	11	0	0
16	36168787	.	T	A	3	4	7	0	0	7	0	0
16	36169057	.	T	G	5	5	10	0	1	11	0	0
16	36169150	.	T	C	5	3	8	0	0	8	0	0
16	36169568	.	G	T	7	3	10	0	1	11	0	0
16	36169868	.	A	C	5	0	5	0	6	11	0	0
16	36171552	.	A	G	4	4	8	0	0	8	0	0
16	36172961	.	A	G	4	4	8	0	1	9	0	0
16	36172982	.	C	T	5	3	8	0	0	8	0	0
16	36180540	.	G	A	3	3	6	0	0	6	0	0
16	36180591	.	A	G	3	3	6	0	0	6	0	0
16	36180753	.	A	G	1	4	5	0	0	5	0	0
16	36180810	.	T	A	4	2	6	0	0	6	0	0
16	36185315	.	G	A	3	2	5	0	0	5	0	0
16	36196411	.	T	C	3	2	5	0	0	5	0	0
16	36721560	.	A	T	8	5	13	0	0	13	0	0
16	36721589	.	T	G	10	4	14	0	0	14	0	0
16	36724010	.	C	G	3	15	18	0	12	30	0	0
16	36729322	.	A	T	4	5	9	0	1	10	0	0
16	36729352	.	G	T	6	7	13	0	0	13	0	0
16	36729373	.	A	G	7	10	17	0	1	18	0	0
16	36731307	.	A	G	6	7	13	0	0	13	0	0
16	36735751	.	T	C	5	5	10	0	0	10	0	0
16	36735760	.	T	C	6	0	6	0	4	10	0	0
16	36741148	.	T	C	0	4	4	0	1	5	0	0
16	36743328	.	G	A	6	5	11	0	0	11	0	0
16	36743351	.	G	A	3	3	6	0	0	6	0	0
16	36743757	.	T	C	1	3	4	0	0	4	0	0
16	36743787	.	A	G	1	2	3	0	1	4	0	0
16	36748214	.	T	G	1	3	4	0	0	4	0	0
16	36752278	.	T	C	2	2	4	0	0	4	0	0
16	36759756	.	A	G	2	3	5	0	0	5	0	0
16	36759763	.	G	T	2	3	5	0	0	5	0	0
16	36759834	.	T	C	1	2	3	0	0	3	0	0
16	36759908	.	A	T	5	4	9	0	0	9	0	0
16	36759937	.	A	G	5	3	8	0	1	9	0	0
16	36766180	.	T	G	18	9	27	2	1	30	0	0
16	36766467	.	G	T	11	10	21	0	6	27	0	0
16	36766497	.	T	G	2	3	5	0	19	24	0	0
16	36918992	.	G	A	3	3	6	0	0	6	0	0
16	36925462	.	G	A	1	5	6	0	9	15	0	0
16	36926775	.	C	A	9	11	20	0	2	22	0	0
16	36926779	.	A	C	10	12	22	0	1	23	0	0
16	36928169	.	A	T	15	8	23	0	0	23	0	0
16	36928179	.	A	C	15	7	22	0	1	23	0	0
16	36928429	.	A	G	17	13	30	0	0	30	0	0
16	36931728	.	T	C	22	7	29	0	0	29	0	0
16	36931822	.	T	C	11	4	15	2	1	18	0	0
16	36934191	.	T	A	6	5	11	0	0	11	0	0
16	36934340	.	C	A	1	2	3	0	6	9	0	0
16	36934398	.	G	C	9	6	15	0	0	15	0	0
16	36939973	.	T	C	5	0	5	0	3	8	0	0
16	36939982	.	A	G	7	4	11	0	0	11	0	0
16	36940045	.	C	T	11	6	17	0	1	18	0	0
16	36941706	.	T	C	3	9	12	1	0	13	0	0
16	36941790	.	T	C	3	5	8	0	0	8	0	0
16	36941961	.	T	C	4	0	4	0	7	11	0	0
16	36942068	.	C	A	4	5	9	0	0	9	0	0
16	36945182	.	T	G	7	5	12	0	0	12	0	0
16	36945288	.	G	A	7	5	12	0	1	13	0	0
16	36974719	.	T	C	5	3	8	0	0	8	0	0
16	36975141	.	G	A	14	19	33	0	1	34	0	0
16	36975146	.	C	T	2	14	16	0	17	33	0	0
16	36975183	.	G	C	16	11	27	0	0	27	0	0
16	36975318	.	T	A	14	4	18	0	0	18	0	0
16	36976721	.	A	G	8	6	14	0	0	14	0	0
16	36977387	.	A	G	12	4	16	0	0	16	0	0
16	36979518	.	G	A	16	9	25	0	0	25	0	0
16	36979521	.	A	G	16	10	26	0	0	26	0	0
16	37167545	.	T	A	3	5	8	0	0	8	0	0
16	37167589	.	T	G	2	10	12	0	0	12	0	0
16	37167784	.	C	G	3	10	13	0	0	13	0	0
16	37167968	.	G	A	2	11	13	0	0	13	0	0
16	37306905	.	G	A	10	12	22	0	1	23	0	0
16	37323594	.	A	C	4	6	10	0	2	12	0	0
16	37469777	.	T	A	1	2	3	0	0	3	0	0
16	37470964	.	T	C	2	3	5	0	0	5	0	0
16	37521130	.	A	G	1	4	5	0	0	5	0	0
16	37552348	.	A	C	2	5	7	0	0	7	0	0
16	37554821	.	C	T	4	7	11	0	0	11	0	0
16	37563601	.	G	A	5	2	7	0	0	7	0	0
16	37563643	.	T	G	10	0	10	0	4	14	0	0
16	37565676	.	C	G	3	6	9	0	0	9	0	0
16	37593444	.	G	A	9	10	19	0	1	20	0	0
16	37596645	.	C	T	6	4	10	0	1	11	0	0
16	37596669	.	G	A	6	6	12	0	1	13	0	0
16	37602947	.	A	G	1	2	3	0	0	3	0	0
16	37602954	.	G	C	1	2	3	0	1	4	0	0
16	37614071	.	A	G	7	7	14	0	1	15	0	0
16	37617219	.	A	G	11	0	11	0	20	31	0	0
16	37617304	.	A	G	19	2	21	0	15	36	0	0
16	37617738	.	T	C	15	25	40	0	2	42	0	0
16	37627218	.	T	G	12	16	28	0	5	33	0	0
16	37627762	.	G	A	2	32	34	0	15	49	0	0
16	37627997	.	T	G	15	28	43	0	2	45	0	0
16	37947769	.	T	C	2	3	5	0	1	6	0	0
16	37948242	.	C	G	5	6	11	0	1	12	0	0
16	37948256	.	G	T	7	3	10	0	0	10	0	0
16	37948389	.	G	T	8	8	16	0	1	17	0	0
16	37948624	.	G	A	4	9	13	0	0	13	0	0
16	37948625	.	G	A	4	9	13	0	0	13	0	0
16	37963955	.	T	A	3	5	8	0	0	8	0	0
16	37964100	.	C	T	2	7	9	0	0	9	0	0
16	37964222	.	T	A	3	7	10	0	4	14	0	0
16	37964252	.	T	A	0	3	3	0	0	3	0	0
16	37964310	.	C	G	0	2	2	0	1	3	0	0
16	38017652	.	G	A	4	5	9	0	0	9	0	0
16	38018644	.	A	T	4	2	6	0	0	6	0	0
16	38018672	.	T	A	4	3	7	0	0	7	0	0
16	38019814	.	G	A	2	2	4	0	1	5	0	0
16	38121528	.	G	A	0	3	3	0	1	4	0	0
16	38121981	.	C	T	1	2	3	0	0	3	0	0
16	38129427	.	T	A	3	2	5	0	0	5	0	0
16	38130661	.	T	C	3	3	6	0	1	7	0	0
16	38135699	.	T	C	7	11	18	0	0	18	0	0
16	38135763	.	A	G	6	5	11	0	0	11	0	0
16	38136117	.	C	T	11	8	19	0	0	19	0	0
16	38136278	.	C	T	8	10	18	0	0	18	0	0
16	38136317	.	G	A	14	7	21	0	2	23	0	0
16	38136346	.	C	T	12	11	23	0	0	23	0	0
16	38136491	.	G	C	6	8	14	0	0	14	0	0
16	38152095	.	G	A	0	2	2	0	1	3	0	0
16	38154203	.	G	A	3	2	5	0	1	6	0	0
16	38154236	.	A	G	2	4	6	0	0	6	0	0
16	38157153	.	T	A	2	3	5	0	0	5	0	0
16	38159817	.	C	A	2	4	6	0	1	7	0	0
16	38168009	.	A	G	13	3	16	0	1	17	0	0
16	38168095	.	G	A	0	4	4	0	2	6	0	0
16	38188955	.	G	A	0	5	5	0	9	14	0	0
16	38189099	.	T	C	6	8	14	0	0	14	0	0
16	38191645	.	C	T	5	8	13	0	3	16	0	0
16	38194017	.	T	C	9	11	20	0	0	20	0	0
16	38198170	.	G	A	5	5	10	0	3	13	0	0
16	38199647	.	G	A	6	3	9	0	1	10	0	0
16	38266273	.	G	A	2	2	4	0	0	4	0	0
16	38266477	.	T	C	1	2	3	0	0	3	0	0
16	38313341	.	A	T	1	2	3	0	0	3	0	0
16	38350881	.	T	C	1	3	4	0	0	4	0	0
16	38351061	.	T	A	2	3	5	0	0	5	0	0
16	38355299	.	G	A	9	7	16	0	0	16	0	0
16	38454535	.	A	G	6	4	10	0	0	10	0	0
16	38499053	.	C	T	0	5	5	0	5	10	0	0
16	38518207	.	G	A	2	2	4	0	0	4	0	0
16	38553647	.	C	T	4	3	7	0	0	7	0	0
16	38556912	.	G	A	6	12	18	0	0	18	0	0
16	38556922	.	C	G	1	12	13	0	6	19	0	0
16	38557876	.	G	C	25	0	25	0	26	51	0	0
16	38568644	.	G	C	18	19	37	0	1	38	0	0
16	38729548	.	G	A	2	6	8	0	1	9	0	0
16	38729551	.	G	T	0	2	2	0	7	9	0	0
16	38943253	.	C	T	7	8	15	0	2	17	0	0
16	38943547	.	A	G	5	0	5	0	6	11	0	0
16	39146871	.	A	C	10	10	20	0	0	20	0	0
16	39147060	.	C	G	20	1	21	0	6	27	0	0
16	39147355	.	G	C	24	14	38	0	1	39	0	0
16	39147386	.	C	A	27	18	45	0	2	47	0	0
16	39154953	.	G	A	13	5	18	0	0	18	0	0
16	39157751	.	C	A	20	21	41	0	2	43	0	0
16	39157885	.	T	A	11	26	37	0	1	38	0	0
16	39160458	.	A	C	25	17	42	0	2	44	0	0
16	39162786	.	C	T	30	21	51	0	1	52	0	0
16	39164213	.	G	A	19	20	39	0	1	40	0	0
16	39166773	.	C	T	19	21	40	0	3	43	0	0
16	39166854	.	C	T	16	31	47	0	4	51	0	0
16	39167028	.	C	A	19	17	36	0	4	40	0	0
16	39167088	.	C	T	11	7	18	0	1	19	0	0
16	39185580	.	G	A	20	10	30	0	2	32	0	0
16	39191557	.	T	C	14	0	14	0	12	26	0	0
16	39196850	.	A	C	1	4	5	0	0	5	0	0
16	39196890	.	A	C	1	3	4	0	0	4	0	0
16	39213237	.	G	A	0	3	3	0	3	6	0	0
16	39213314	.	G	A	3	4	7	0	1	8	0	0
16	39238437	.	A	C	7	0	7	0	3	10	0	0
16	39244286	.	T	C	21	15	36	0	1	37	0	0
16	39248745	.	T	A	5	4	9	0	1	10	0	0
16	39248765	.	G	C	6	5	11	0	0	11	0	0
16	39248811	.	C	G	8	7	15	0	0	15	0	0
16	39248813	.	T	A	8	7	15	0	0	15	0	0
16	39248864	.	G	A	6	3	9	0	0	9	0	0
16	39248886	.	C	A	6	4	10	0	0	10	0	0
16	39248976	.	G	A	9	5	14	0	0	14	0	0
16	39249056	.	G	A	9	7	16	0	0	16	0	0
16	39249229	.	C	T	5	5	10	0	1	11	0	0
16	39249350	.	A	C	5	4	9	0	0	9	0	0
16	39249475	.	C	A	4	3	7	0	0	7	0	0
16	39249506	.	G	A	3	4	7	0	0	7	0	0
16	39249527	.	A	T	4	4	8	0	0	8	0	0
16	39249907	.	G	T	1	2	3	0	0	3	0	0
16	39253200	.	G	A	3	3	6	0	1	7	0	0
16	39256291	.	A	G	2	5	7	1	0	8	0	0
16	39256303	.	T	C	2	5	7	1	0	8	0	0
16	39271329	.	A	C	3	6	9	0	0	9	0	0
16	39271394	.	G	C	3	2	5	0	0	5	0	0
16	39297336	.	C	A	4	4	8	0	0	8	0	0
16	39297344	.	A	T	2	3	5	0	0	5	0	0
16	39297378	.	C	T	1	3	4	0	0	4	0	0
16	39323626	.	T	G	2	0	2	0	6	8	0	0
16	39323716	.	C	T	5	4	9	0	0	9	0	0
16	39323809	.	T	C	3	3	6	0	0	6	0	0
16	39325084	.	A	G	4	0	4	0	5	9	0	0
16	39325121	.	G	A	3	4	7	0	1	8	0	0
16	39361889	.	C	T	6	3	9	0	0	9	0	0
16	39362312	.	G	T	0	10	10	0	4	14	0	0
16	39372345	.	G	A	7	3	10	0	1	11	0	0
16	39372372	.	T	C	8	10	18	0	0	18	0	0
16	39372735	.	G	C	1	4	5	0	10	15	0	0
16	39372780	.	C	A	18	9	27	0	1	28	0	0
16	39378744	.	A	G	14	0	14	0	7	21	0	0
16	39382047	.	C	G	10	9	19	0	0	19	0	0
16	39382084	.	C	T	13	10	23	0	0	23	0	0
16	39382098	.	G	A	11	6	17	0	0	17	0	0
16	39382467	.	C	G	3	6	9	0	0	9	0	0
16	39382482	.	G	A	2	6	8	0	0	8	0	0
16	39385755	.	T	C	16	0	16	0	13	29	0	0
16	39386184	.	T	C	24	13	37	0	1	38	0	0
16	39386239	.	T	A	16	26	42	0	2	44	0	0
16	39386915	.	C	T	24	13	37	0	1	38	0	0
16	39390139	.	T	C	24	1	25	0	19	44	0	0
16	39390175	.	G	A	19	18	37	0	2	39	0	0
16	39393370	.	A	G	15	15	30	0	2	32	0	0
16	39394630	.	A	G	17	15	32	0	1	33	0	0
16	39399140	.	A	C	12	0	12	0	5	17	0	0
16	39413514	.	C	T	6	10	16	0	0	16	0	0
16	39433472	.	A	G	1	3	4	0	0	4	0	0
16	39643512	.	G	A	2	5	7	0	1	8	0	0
16	39830006	.	C	T	0	4	4	0	2	6	0	0
16	40026573	.	A	G	3	0	3	0	8	11	0	0
16	40066964	.	C	T	2	4	6	0	1	7	0	0
16	40073960	.	C	T	2	2	4	0	0	4	0	0
16	40153313	.	G	C	1	4	5	0	0	5	0	0
16	40153505	.	A	G	1	0	1	0	3	4	0	0
16	40340664	.	A	T	3	3	6	0	0	6	0	0
16	40340706	.	T	G	2	4	6	0	1	7	0	0
16	40340953	.	C	G	4	0	4	0	6	10	0	0
16	40340967	.	A	G	5	5	10	0	1	11	0	0
16	40341024	.	T	C	5	2	7	0	0	7	0	0
16	40341255	.	C	G	2	2	4	0	0	4	0	0
16	40341264	.	C	T	1	2	3	0	0	3	0	0
16	40343747	.	T	C	3	4	7	0	0	7	0	0
16	40346609	.	A	G	2	2	4	0	0	4	0	0
16	40347546	.	T	A	3	3	6	0	0	6	0	0
16	40353892	.	A	G	1	2	3	0	0	3	0	0
16	40426272	.	G	A	2	5	7	0	0	7	0	0
16	40426311	.	A	G	1	4	5	0	0	5	0	0
16	40491931	.	A	G	4	10	14	0	0	14	0	0
16	40503994	.	G	A	5	5	10	0	0	10	0	0
16	40541261	.	A	G	2	0	2	0	2	4	0	0
16	40541493	.	A	T	1	4	5	0	0	5	0	0
16	40560713	.	C	T	9	4	13	0	0	13	0	0
16	40563673	.	G	T	3	5	8	0	2	10	0	0
16	40563811	.	G	A	2	3	5	0	0	5	0	0
16	40568336	.	A	G	2	0	2	0	4	6	0	0
16	40569480	.	C	G	1	4	5	0	0	5	0	0
16	40569558	.	A	C	4	3	7	0	0	7	0	0
16	40602823	.	G	A	1	3	4	0	0	4	0	0
16	40602886	.	G	A	2	6	8	0	0	8	0	0
16	40606678	.	G	A	3	2	5	0	0	5	0	0
16	40606844	.	T	A	6	2	8	0	0	8	0	0
16	40607436	.	C	T	1	3	4	0	0	4	0	0
16	40619514	.	C	G	2	3	5	0	0	5	0	0
16	40619531	.	G	T	2	2	4	0	0	4	0	0
16	40619643	.	C	A	2	2	4	0	1	5	0	0
16	40633846	.	C	T	1	4	5	0	0	5	0	0
16	40954538	.	C	T	8	11	19	0	0	19	0	0
16	40954866	.	T	C	13	5	18	0	1	19	0	0
16	40954983	.	A	C	12	14	26	0	0	26	0	0
16	40955515	.	G	T	9	5	14	0	1	15	0	0
16	40955525	.	C	T	7	6	13	0	3	16	0	0
16	40991986	.	G	T	3	3	6	0	0	6	0	0
16	40992009	.	G	A	3	4	7	0	0	7	0	0
16	40992165	.	T	A	1	3	4	0	1	5	0	0
16	40992167	.	T	A	3	2	5	0	0	5	0	0
16	40992490	.	A	G	6	4	10	0	0	10	0	0
16	41003665	.	T	C	1	0	1	0	2	3	0	0
16	41023779	.	A	T	8	2	10	13	0	23	0	0
16	41029443	.	G	A	4	7	11	0	0	11	0	0
16	41029795	.	C	T	4	4	8	0	0	8	0	0
16	41029836	.	A	G	1	6	7	0	1	8	0	0
16	41030017	.	A	C	4	7	11	0	1	12	0	0
16	41084891	.	C	T	1	3	4	0	0	4	0	0
16	41112493	.	C	T	3	4	7	0	0	7	0	0
16	41112571	.	T	C	7	7	14	0	0	14	0	0
16	41112861	.	G	C	10	0	10	0	5	15	0	0
16	41113676	.	T	G	12	10	22	0	0	22	0	0
16	41113698	.	A	T	10	7	17	0	1	18	0	0
16	41113752	.	G	A	10	12	22	0	1	23	0	0
16	41113755	.	C	T	13	11	24	0	0	24	0	0
16	41114779	.	G	A	7	9	16	0	1	17	0	0
16	41114800	.	A	T	9	7	16	0	1	17	0	0
16	41114890	.	C	T	4	3	7	0	0	7	0	0
16	41115079	.	T	G	5	4	9	0	0	9	0	0
16	41115997	.	A	T	5	7	12	0	2	14	0	0
16	41115998	.	C	T	0	6	6	0	8	14	0	0
16	41116367	.	G	A	2	4	6	0	2	8	0	0
16	41116571	.	G	A	2	2	4	0	0	4	0	0
16	41116613	.	G	C	3	2	5	0	1	6	0	0
16	41116783	.	C	T	4	3	7	0	0	7	0	0
16	41117169	.	G	A	5	6	11	0	1	12	0	0
16	41131574	.	A	T	2	1	3	0	2	5	0	0
16	41345674	.	A	T	13	5	18	0	0	18	0	0
16	41345826	.	G	T	5	9	14	0	3	17	0	0
16	41346007	.	C	A	1	6	7	0	10	17	0	0
16	41353140	.	G	A	13	6	19	0	0	19	0	0
16	41393773	.	C	T	9	5	14	0	0	14	0	0
16	41468848	.	T	G	3	4	7	0	0	7	0	0
16	41469008	.	G	A	6	4	10	0	1	11	0	0
16	41469029	.	C	A	4	6	10	0	0	10	0	0
16	41469130	.	T	A	9	7	16	0	1	17	0	0
16	41469329	.	G	A	8	4	12	0	2	14	0	0
16	41469426	.	T	A	8	4	12	0	1	13	0	0
16	41469508	.	G	C	3	2	5	0	1	6	0	0
16	41505369	.	C	A	1	2	3	0	0	3	0	0
16	41505372	.	G	A	1	2	3	0	0	3	0	0
16	41533866	.	G	A	1	2	3	0	0	3	0	0
16	41585743	.	C	T	0	5	5	0	6	11	0	0
16	41589214	.	A	G	3	7	10	0	1	11	0	0
16	41601658	.	T	C	3	2	5	0	0	5	0	0
16	41691555	.	C	A	0	3	3	0	3	6	0	0
16	41703632	.	G	T	3	4	7	0	0	7	0	0
16	41704050	.	A	G	2	2	4	0	0	4	0	0
16	41704056	.	T	A	2	1	3	0	1	4	0	0
16	41717479	.	G	A	7	9	16	0	0	16	0	0
16	41717482	.	A	G	7	7	14	0	1	15	0	0
16	41717666	.	G	A	1	7	8	0	15	23	0	0
16	41720533	.	G	T	10	10	20	0	0	20	0	0
16	41720536	.	T	G	9	9	18	0	1	19	0	0
16	41720587	.	T	C	6	14	20	0	2	22	0	0
16	41723228	.	T	G	11	0	11	0	9	20	0	0
16	41723280	.	A	G	7	0	7	0	10	17	0	0
16	41723778	.	C	G	6	0	6	0	5	11	0	0
16	41725215	.	T	C	9	7	16	0	0	16	0	0
16	41725238	.	T	C	8	6	14	0	0	14	0	0
16	41727162	.	T	G	11	9	20	0	2	22	0	0
16	41727376	.	C	A	14	15	29	0	0	29	0	0
16	41730407	.	G	A	15	14	29	0	1	30	0	0
16	41730625	.	C	G	11	17	28	0	1	29	0	0
16	41731928	.	A	T	5	5	10	0	1	11	0	0
16	41731929	.	C	A	5	6	11	0	0	11	0	0
16	41732009	.	G	T	5	8	13	0	0	13	0	0
16	41732031	.	G	T	0	5	5	0	7	12	0	0
16	41732067	.	T	C	5	5	10	0	1	11	0	0
16	41732158	.	C	A	3	7	10	0	1	11	0	0
16	41732166	.	C	T	2	8	10	0	1	11	0	0
16	41732262	.	T	C	9	7	16	0	2	18	0	0
16	41732295	.	G	T	9	8	17	0	0	17	0	0
16	41740704	.	A	T	3	8	11	0	1	12	0	0
16	41741050	.	C	T	2	4	6	0	3	9	0	0
16	41741398	.	A	G	2	2	4	0	0	4	0	0
16	41794900	.	C	A	2	10	12	0	14	26	0	0
16	41801525	.	G	T	12	16	28	0	0	28	0	0
16	41873717	.	T	A	8	11	19	0	0	19	0	0
16	41873797	.	G	A	10	8	18	0	0	18	0	0
16	41873992	.	C	T	6	9	15	0	0	15	0	0
16	41874039	.	G	C	10	7	17	0	0	17	0	0
16	41882490	.	G	T	1	4	5	0	2	7	0	0
16	41882512	.	A	G	2	4	6	0	0	6	0	0
16	41891572	.	C	T	17	16	33	0	2	35	0	0
16	41891662	.	A	C	10	16	26	0	1	27	0	0
16	41896361	.	G	A	16	16	32	0	3	35	0	0
16	41897244	.	A	G	12	16	28	0	0	28	0	0
16	41897332	.	A	G	16	12	28	0	1	29	0	0
16	41897347	.	G	A	17	13	30	0	2	32	0	0
16	41897375	.	A	T	18	18	36	0	2	38	0	0
16	41897452	.	C	A	17	6	23	0	0	23	0	0
16	41897599	.	A	T	9	6	15	0	0	15	0	0
16	41903475	.	A	T	9	8	17	0	1	18	0	0
16	41903686	.	G	A	14	12	26	0	1	27	0	0
16	41903770	.	T	C	12	10	22	0	0	22	0	0
16	41903801	.	T	G	12	9	21	0	0	21	0	0
16	41903957	.	T	C	4	7	11	0	2	13	0	0
16	41904121	.	T	G	5	11	16	0	0	17	1	0
16	41904209	.	T	C	12	11	23	0	0	23	0	0
16	41904261	.	G	A	14	10	24	0	0	24	0	0
16	41904430	.	C	A	18	16	34	0	0	34	0	0
16	41904440	.	C	A	2	13	15	0	17	32	0	0
16	41904615	.	T	C	12	0	12	0	15	27	0	0
16	41904650	.	G	A	11	6	17	0	1	18	0	0
16	41904680	.	A	T	10	2	12	2	0	14	0	0
16	41904879	.	A	T	3	3	6	0	0	6	0	0
16	41904961	.	A	G	12	2	14	0	1	15	0	0
16	41905631	.	A	G	11	11	22	0	0	22	0	0
16	41905666	.	A	G	6	8	14	0	0	14	0	0
16	41905682	.	G	T	8	9	17	0	0	17	0	0
16	41905720	.	T	A	3	6	9	0	0	9	0	0
16	41905807	.	G	C	9	5	14	0	0	14	0	0
16	41912225	.	G	A	5	10	15	0	0	15	0	0
16	41916819	.	A	G	12	18	30	0	2	32	0	0
16	41925227	.	G	C	10	0	10	0	11	21	0	0
16	41933222	.	A	C	6	4	10	0	0	10	0	0
16	41933411	.	G	A	7	6	13	0	0	13	0	0
16	42045976	.	T	C	2	2	4	0	0	4	0	0
16	42046274	.	A	C	2	2	4	0	0	4	0	0
16	42046734	.	C	A	2	2	4	0	0	4	0	0
16	42072207	.	T	A	18	14	32	0	1	33	0	0
16	42072719	.	A	C	24	22	46	0	0	46	0	0
16	42073086	.	A	G	6	6	12	0	2	14	0	0
16	42073488	.	T	C	17	2	19	0	19	38	0	0
16	42083039	.	G	A	7	11	18	0	0	18	0	0
16	42091814	.	A	G	10	19	29	0	1	30	0	0
16	42165264	.	T	A	1	2	3	0	0	3	0	0
16	42177840	.	C	T	4	3	7	0	0	7	0	0
16	42178002	.	C	T	0	7	7	1	12	20	0	0
16	42178012	.	A	G	14	6	20	1	0	21	0	0
16	42179879	.	C	A	14	5	19	0	3	22	0	0
16	42180079	.	A	G	16	8	24	0	1	25	0	0
16	42180271	.	G	A	19	12	31	0	0	31	0	0
16	42186022	.	G	A	5	3	8	0	0	8	0	0
16	42186043	.	A	T	5	3	8	0	0	8	0	0
16	42295124	.	C	T	1	2	3	0	0	3	0	0
16	42423606	.	G	T	3	4	7	0	7	14	0	0
16	42423683	.	A	G	5	3	8	0	2	10	0	0
16	42423749	.	T	G	3	7	10	0	0	10	0	0
16	42424189	.	G	A	15	10	25	0	1	26	0	0
16	42424405	.	G	A	13	10	23	0	0	23	0	0
16	42428454	.	T	C	13	11	24	0	0	24	0	0
16	42428472	.	C	T	11	14	25	0	2	27	0	0
16	42440999	.	T	C	8	6	14	0	0	14	0	0
16	42443875	.	A	G	4	7	11	0	0	11	0	0
16	42443965	.	G	A	5	6	11	0	2	13	0	0
16	42454027	.	G	C	8	4	12	0	0	12	0	0
16	42472146	.	G	T	1	2	3	0	0	3	0	0
16	42472229	.	T	C	3	2	5	0	0	5	0	0
16	42472388	.	C	T	3	3	6	0	0	6	0	0
16	42482275	.	T	C	5	6	11	0	0	11	0	0
16	42482378	.	T	C	3	10	13	0	0	13	0	0
16	42482418	.	A	T	3	8	11	0	1	13	1	0
16	42487947	.	A	G	5	12	17	0	10	27	0	0
16	42490255	.	C	T	13	10	23	0	2	25	0	0
16	42490264	.	T	C	12	9	21	0	0	21	0	0
16	42493796	.	G	C	1	9	10	0	17	27	0	0
16	42493900	.	A	T	11	3	14	1	0	15	0	0
16	42681270	.	G	C	1	3	4	0	0	4	0	0
16	42829855	.	C	A	5	6	11	0	1	12	0	0
16	42831980	.	A	G	11	1	12	0	11	23	0	0
16	42833084	.	T	C	11	13	24	0	1	25	0	0
16	42840237	.	A	G	14	9	23	0	1	24	0	0
16	42898555	.	A	G	6	7	13	0	3	16	0	0
16	42900259	.	A	C	1	5	6	0	1	7	0	0
16	42900500	.	G	A	5	5	10	0	0	10	0	0
16	42900509	.	A	G	5	5	10	0	0	10	0	0
16	42938926	.	A	T	3	8	11	0	1	12	0	0
16	42938927	.	G	T	3	8	11	0	1	12	0	0
16	42938995	.	A	G	4	7	11	0	0	11	0	0
16	42939030	.	C	G	2	2	4	0	0	4	0	0
16	42939088	.	C	A	3	3	6	0	0	6	0	0
16	42939124	.	T	A	5	3	8	0	1	9	0	0
16	42939343	.	C	T	0	10	10	0	16	26	0	0
16	42939443	.	A	C	12	1	13	0	12	25	0	0
16	42939607	.	C	T	17	12	29	0	2	31	0	0
16	42939675	.	G	C	9	10	19	0	1	20	0	0
16	42939841	.	T	C	3	2	5	0	0	5	0	0
16	42940062	.	A	C	5	2	7	0	0	7	0	0
16	42940836	.	A	C	4	2	6	0	0	6	0	0
16	42941189	.	C	A	6	5	11	0	0	12	1	0
16	42941405	.	A	T	7	3	10	0	0	10	0	0
16	42949149	.	G	A	4	3	7	0	0	7	0	0
16	42949254	.	T	C	2	0	2	0	3	5	0	0
16	42951909	.	C	T	5	2	7	0	0	7	0	0
16	43001124	.	A	T	7	10	17	0	2	19	0	0
16	43001148	.	G	A	6	10	16	0	0	16	0	0
16	43001290	.	A	C	2	6	8	0	0	8	0	0
16	43001368	.	T	G	13	16	29	0	0	29	0	0
16	43011187	.	T	C	7	5	12	0	1	13	0	0
16	43011223	.	C	T	0	3	3	0	4	7	0	0
16	43015484	.	A	G	23	41	64	0	4	68	0	0
16	43026164	.	G	T	1	5	6	0	2	8	0	0
16	43026189	.	A	C	4	2	6	0	0	6	0	0
16	43028262	.	C	A	6	11	17	0	0	17	0	0
16	43028626	.	A	C	10	8	18	0	0	18	0	0
16	43032163	.	T	C	7	4	11	0	1	12	0	0
16	43032175	.	C	A	6	4	10	0	1	11	0	0
16	43126513	.	T	A	4	6	10	0	0	10	0	0
16	43126546	.	A	C	5	0	5	0	3	8	0	0
16	43126603	.	A	T	2	2	4	0	1	5	0	0
16	43126694	.	T	C	2	0	2	0	3	5	0	0
16	43130296	.	C	T	6	7	13	0	0	13	0	0
16	43153537	.	C	A	4	3	7	0	0	7	0	0
16	43158681	.	C	T	5	5	10	0	0	10	0	0
16	43227842	.	C	T	1	2	3	0	0	3	0	0
16	43227950	.	T	C	18	0	18	0	6	24	0	0
16	43228017	.	T	A	7	5	12	0	3	15	0	0
16	43228055	.	C	T	6	9	15	0	1	16	0	0
16	43228331	.	A	C	6	1	7	0	6	13	0	0
16	43228406	.	T	C	3	0	3	0	8	11	0	0
16	43228567	.	A	G	1	4	5	0	0	5	0	0
16	43228796	.	C	T	1	9	10	0	4	14	0	0
16	43228847	.	G	T	3	6	9	0	1	10	0	0
16	43228942	.	C	T	10	7	17	0	1	18	0	0
16	43228945	.	T	C	12	6	18	0	0	18	0	0
16	43229315	.	T	C	5	0	5	0	14	19	0	0
16	43229396	.	T	C	5	7	12	0	0	12	0	0
16	43229443	.	T	G	6	5	11	0	0	11	0	0
16	43229610	.	C	G	0	4	4	0	5	9	0	0
16	43229612	.	T	C	4	5	9	0	0	9	0	0
16	43229961	.	T	A	1	4	5	0	0	5	0	0
16	43230258	.	T	C	7	5	12	0	3	15	0	0
16	43230296	.	A	G	8	4	12	0	2	14	0	0
16	43230435	.	T	C	5	0	5	0	8	13	0	0
16	43230527	.	A	G	4	4	8	0	0	8	0	0
16	43230540	.	G	T	4	4	8	0	0	8	0	0
16	43238243	.	A	T	5	7	12	0	1	13	0	0
16	43255499	.	G	A	11	5	16	0	0	16	0	0
16	43256440	.	A	T	6	9	15	0	1	16	0	0
16	43263617	.	G	T	0	7	7	0	4	11	0	0
16	43269922	.	C	T	9	15	24	0	1	25	0	0
16	43283941	.	C	T	4	14	18	0	2	20	0	0
16	43284313	.	G	A	11	15	26	0	1	27	0	0
16	43284429	.	C	T	15	15	30	0	2	32	0	0
16	43291872	.	T	C	4	3	7	0	0	7	0	0
16	43291907	.	A	G	2	4	6	0	0	6	0	0
16	43297195	.	G	C	4	3	7	0	0	7	0	0
16	43300053	.	A	G	9	5	14	0	1	15	0	0
16	43300083	.	C	T	2	9	11	0	16	27	0	0
16	43301905	.	T	G	7	11	18	0	0	18	0	0
16	43303873	.	T	C	5	5	10	0	1	11	0	0
16	43303912	.	A	G	7	2	9	0	0	9	0	0
16	43303921	.	C	T	9	2	11	0	1	12	0	0
16	43303948	.	T	C	7	6	13	0	0	13	0	0
16	43306721	.	T	C	11	10	21	0	0	21	0	0
16	43306995	.	A	G	6	5	11	0	2	13	0	0
16	43309443	.	A	G	5	8	13	2	0	15	0	0
16	43309498	.	T	C	10	0	10	0	5	15	0	0
16	43319477	.	C	A	5	2	7	0	2	9	0	0
16	43321050	.	C	T	3	4	7	0	0	7	0	0
16	43328702	.	T	C	1	3	4	0	0	4	0	0
16	43332428	.	G	A	1	2	3	0	0	3	0	0
16	43336681	.	A	G	5	3	8	0	3	11	0	0
16	43336855	.	G	A	8	7	15	0	1	16	0	0
16	43341256	.	C	T	2	21	23	0	21	44	0	0
16	43343999	.	A	C	12	0	12	0	5	17	0	0
16	43345237	.	C	A	16	12	28	0	0	28	0	0
16	43346877	.	C	T	1	4	5	0	1	6	0	0
16	43349183	.	C	T	8	10	18	0	0	18	0	0
16	43349315	.	G	A	4	9	13	0	1	14	0	0
16	43349624	.	C	T	4	9	13	0	3	16	0	0
16	43349639	.	T	C	4	13	17	0	0	17	0	0
16	43349843	.	A	T	3	3	6	0	0	6	0	0
16	43350160	.	G	A	1	3	4	0	0	4	0	0
16	43350191	.	T	G	5	0	5	0	0	5	0	0
16	43350236	.	T	C	2	4	6	0	0	6	0	0
16	43353398	.	C	T	0	4	4	0	1	5	0	0
16	43368574	.	T	A	3	6	9	0	1	10	0	0
16	43368669	.	G	T	7	6	13	0	0	13	0	0
16	43375493	.	G	A	0	4	4	0	4	8	0	0
16	43375550	.	A	G	3	2	5	0	0	5	0	0
16	43379430	.	T	A	2	3	5	0	0	5	0	0
16	43385317	.	A	G	4	1	5	0	2	7	0	0
16	43389752	.	T	C	2	6	8	0	0	8	0	0
16	43389797	.	T	C	10	11	21	0	0	21	0	0
16	43391618	.	G	A	11	18	29	0	0	29	0	0
16	43413013	.	C	A	2	3	5	0	0	5	0	0
16	43413176	.	A	C	2	2	4	0	0	4	0	0
16	43517526	.	C	T	2	18	20	1	15	36	0	0
16	43707397	.	A	G	6	6	12	0	1	13	0	0
16	43742277	.	A	T	1	4	5	0	0	5	0	0
16	43766129	.	A	G	3	2	5	0	0	5	0	0
16	43819623	.	A	G	12	15	27	0	0	27	0	0
16	43819934	.	A	G	15	11	26	0	1	27	0	0
16	43820317	.	A	G	25	19	44	0	0	44	0	0
16	43820405	.	G	A	13	16	29	0	1	30	0	0
16	43820453	.	C	T	16	15	31	0	2	33	0	0
16	43820654	.	T	C	15	16	31	0	2	33	0	0
16	43820655	.	G	A	15	17	32	0	1	33	0	0
16	43820777	.	G	A	16	11	27	0	0	27	0	0
16	43821047	.	G	A	6	11	17	0	1	18	0	0
16	43821146	.	G	A	13	12	25	0	2	27	0	0
16	43821170	.	T	G	18	16	34	0	0	34	0	0
16	43821455	.	C	T	9	12	21	0	0	21	0	0
16	43821734	.	G	T	8	8	16	0	1	17	0	0
16	43822025	.	T	C	4	7	11	0	0	11	0	0
16	43822343	.	T	G	5	9	14	0	0	14	0	0
16	43822794	.	G	T	5	11	16	0	1	17	0	0
16	43920381	.	C	T	7	7	14	0	1	15	0	0
16	43971245	.	T	C	4	4	8	0	2	10	0	0
16	43971248	.	G	A	5	5	10	0	0	10	0	0
16	44349687	.	T	C	13	0	13	0	13	26	0	0
16	44349766	.	A	G	13	12	25	0	2	27	0	0
16	44349830	.	A	G	8	17	25	0	0	25	0	0
16	44379120	.	A	G	19	11	30	0	0	30	0	0
16	44379168	.	T	C	20	19	39	0	0	39	0	0
16	44379219	.	T	A	24	14	38	0	1	39	0	0
16	44460348	.	C	T	0	13	13	0	6	19	0	0
16	44462580	.	T	A	9	11	20	0	2	22	0	0
16	44490752	.	G	A	6	6	12	0	2	14	0	0
16	44509758	.	G	A	11	10	21	0	0	21	0	0
16	44509821	.	C	T	12	9	21	0	0	21	0	0
16	44509842	.	T	C	9	0	9	0	12	21	0	0
16	44509923	.	C	T	4	7	11	0	0	11	0	0
16	44510055	.	C	A	6	13	19	0	2	21	0	0
16	44512583	.	C	T	2	4	6	3	14	23	0	0
16	44512625	.	A	T	15	6	21	3	1	25	0	0
16	44512685	.	G	C	14	9	23	0	1	24	0	0
16	44512706	.	G	A	13	8	21	0	1	22	0	0
16	44512733	.	A	G	13	7	20	0	1	21	0	0
16	44512936	.	T	C	8	1	9	0	4	13	0	0
16	44588173	.	G	A	7	3	10	0	0	10	0	0
16	44588182	.	A	T	7	3	10	0	0	10	0	0
16	44588236	.	T	C	5	6	11	0	0	11	0	0
16	44665348	.	C	T	2	9	11	0	8	19	0	0
16	44665358	.	A	G	10	7	17	0	1	18	0	0
16	44668083	.	G	A	9	7	16	0	1	17	0	0
16	44669333	.	A	G	8	5	13	0	2	15	0	0
16	44672368	.	C	T	4	5	9	0	0	9	0	0
16	44672389	.	A	C	2	2	4	0	1	5	0	0
16	44673395	.	C	G	8	5	13	0	1	14	0	0
16	44673734	.	C	A	11	6	17	0	0	17	0	0
16	44673748	.	T	C	11	0	11	0	5	16	0	0
16	44673769	.	A	G	9	3	12	0	0	12	0	0
16	44788444	.	A	C	6	0	6	0	12	18	0	0
16	44788736	.	G	T	5	3	8	0	0	8	0	0
16	44790834	.	G	A	7	5	12	0	0	12	0	0
16	44790945	.	T	G	8	4	12	0	0	12	0	0
16	44793179	.	T	G	2	6	8	0	0	8	0	0
16	44804145	.	C	T	1	2	3	0	0	3	0	0
16	44804154	.	T	C	2	0	2	0	2	4	0	0
16	44877275	.	T	A	1	3	4	0	0	4	0	0
16	44881869	.	A	G	2	3	5	0	0	5	0	0
16	44881979	.	C	T	9	3	12	0	0	12	0	0
16	44884701	.	A	G	11	10	21	0	0	21	0	0
16	44888458	.	T	G	6	11	17	0	3	20	0	0
16	44888473	.	G	A	7	12	19	0	0	19	0	0
16	44892957	.	T	C	7	8	15	0	0	15	0	0
16	44893131	.	C	T	10	2	12	0	1	13	0	0
16	44893137	.	C	G	8	3	11	0	0	11	0	0
16	44896883	.	T	C	5	1	6	0	10	16	0	0
16	44899639	.	T	C	5	0	5	0	3	8	0	0
16	44983870	.	A	T	4	6	10	0	1	11	0	0
16	44983982	.	A	C	6	12	18	0	0	18	0	0
16	44984214	.	C	T	6	12	18	0	2	20	0	0
16	44984622	.	A	G	1	2	3	0	1	4	0	0
16	44986810	.	A	T	4	4	8	0	0	8	0	0
16	44989142	.	T	A	4	3	7	0	0	7	0	0
16	44991350	.	A	G	2	6	8	0	0	8	0	0
16	44995484	.	C	T	0	2	2	0	2	4	0	0
16	45001639	.	T	C	2	2	4	0	1	5	0	0
16	45001660	.	T	A	1	2	3	0	1	4	0	0
16	45019606	.	A	T	9	10	19	0	0	19	0	0
16	45019768	.	C	G	25	19	44	0	1	45	0	0
16	45019868	.	A	G	15	22	37	0	0	37	0	0
16	45034336	.	G	A	14	17	31	0	0	31	0	0
16	45036921	.	T	A	7	4	11	0	1	12	0	0
16	45038877	.	G	C	9	0	9	0	5	14	0	0
16	45038895	.	G	A	10	9	19	0	0	19	0	0
16	45041694	.	G	A	11	3	14	0	0	14	0	0
16	45041736	.	A	G	6	7	13	0	1	14	0	0
16	45041772	.	T	C	6	6	12	0	1	13	0	0
16	45042174	.	G	A	6	3	9	0	1	10	0	0
16	45044709	.	T	G	27	28	55	0	0	55	0	0
16	45044710	.	A	T	26	28	54	0	0	54	0	0
16	45044858	.	T	C	34	3	37	4	39	80	0	0
16	45044910	.	T	C	42	49	91	0	5	96	0	0
16	45044952	.	T	A	45	48	93	0	2	95	0	0
16	45054004	.	A	G	30	35	65	0	4	69	0	0
16	45088196	.	A	C	6	3	9	0	0	9	0	0
16	45094399	.	A	G	5	6	11	0	1	12	0	0
16	45094423	.	A	G	4	9	13	0	0	13	0	0
16	45094523	.	A	G	3	7	10	0	0	10	0	0
16	45202703	.	G	A	20	10	30	0	2	32	0	0
16	45202795	.	A	G	16	19	35	0	1	36	0	0
16	45202798	.	A	G	13	22	35	0	2	37	0	0
16	45202926	.	A	G	19	14	33	0	1	34	0	0
16	45202962	.	T	A	14	10	24	0	1	25	0	0
16	45203076	.	C	A	9	12	21	0	0	21	0	0
16	45209294	.	A	G	11	22	33	0	0	33	0	0
16	45209300	.	A	G	10	19	29	0	5	34	0	0
16	45209787	.	T	A	9	6	15	0	0	15	0	0
16	45225374	.	G	A	7	4	11	0	0	11	0	0
16	45225381	.	C	A	7	5	12	0	0	12	0	0
16	45356981	.	A	T	1	3	4	0	0	4	0	0
16	45364556	.	G	A	2	4	6	0	0	6	0	0
16	45364570	.	C	T	0	5	5	0	2	7	0	0
16	45368093	.	A	G	3	2	5	0	1	6	0	0
16	45368111	.	T	C	5	3	8	0	0	8	0	0
16	45368144	.	A	G	3	3	6	0	0	6	0	0
16	45368181	.	G	C	5	3	8	0	0	8	0	0
16	45370401	.	G	A	2	2	4	0	0	4	0	0
16	45393312	.	A	G	1	2	3	0	0	3	0	0
16	45393321	.	T	G	1	2	3	0	0	3	0	0
16	45436883	.	T	C	3	2	5	0	0	5	0	0
16	45440521	.	G	T	0	5	5	0	7	12	0	0
16	45440539	.	G	A	5	6	11	0	1	12	0	0
16	45456240	.	T	C	2	3	5	0	0	5	0	0
16	45456241	.	G	A	2	3	5	0	0	5	0	0
16	45456309	.	T	G	1	1	2	0	2	4	0	0
16	45572473	.	C	T	1	4	5	0	0	5	0	0
16	45573088	.	C	T	2	3	5	0	0	5	0	0
16	45573090	.	T	C	2	3	5	0	0	5	0	0
16	45573228	.	A	G	1	3	4	0	0	4	0	0
16	45573251	.	T	A	1	3	4	0	0	4	0	0
16	45625065	.	G	A	7	4	11	0	0	11	0	0
16	45627066	.	T	G	4	6	10	1	1	12	0	0
16	45627081	.	T	C	4	6	10	1	0	11	0	0
16	45627297	.	G	A	0	4	4	0	1	5	0	0
16	45627363	.	A	G	4	3	7	0	1	8	0	0
16	45627378	.	G	A	4	4	8	0	0	8	0	0
16	45630207	.	G	C	0	7	7	0	7	14	0	0
16	45630276	.	A	G	7	0	7	0	10	17	0	0
16	45686536	.	C	T	7	10	17	0	1	18	0	0
16	45686586	.	C	T	6	6	12	0	3	15	0	0
16	45686998	.	T	A	8	5	13	0	2	15	0	0
16	45687065	.	G	A	4	5	9	0	2	11	0	0
16	45687076	.	A	G	5	0	5	0	5	10	0	0
16	45687199	.	G	A	1	7	8	0	3	11	0	0
16	45687202	.	A	T	4	7	11	0	0	11	0	0
16	45687299	.	C	T	9	6	15	0	0	15	0	0
16	45687631	.	G	A	5	1	6	0	0	7	1	0
16	45687718	.	A	G	8	0	8	0	6	14	0	0
16	45687766	.	T	G	7	7	14	0	0	14	0	0
16	45687896	.	T	G	9	8	17	0	1	18	0	0
16	45688005	.	T	C	6	8	14	0	2	16	0	0
16	45688171	.	C	T	9	11	20	0	0	20	0	0
16	45688228	.	G	A	1	4	5	0	5	10	0	0
16	45688323	.	G	T	9	4	13	0	1	14	0	0
16	45688431	.	T	A	12	18	30	0	0	30	0	0
16	45688662	.	T	C	15	17	32	0	0	32	0	0
16	45688814	.	C	T	19	14	33	0	1	34	0	0
16	45689411	.	T	A	24	9	33	2	2	37	0	0
16	45689435	.	A	G	23	16	39	2	3	44	0	0
16	45689476	.	T	A	25	24	49	0	4	54	1	0
16	45689484	.	G	T	25	29	54	0	1	55	0	0
16	45689835	.	T	C	14	22	36	0	1	37	0	0
16	45689898	.	A	T	26	16	42	0	0	42	0	0
16	45690148	.	A	T	18	14	32	0	1	33	0	0
16	45690296	.	T	C	18	12	30	0	1	31	0	0
16	45690926	.	G	A	8	11	19	0	1	20	0	0
16	45693611	.	G	A	9	9	18	0	1	19	0	0
16	45697007	.	T	C	11	5	16	0	1	17	0	0
16	45701289	.	G	A	10	7	17	0	0	17	0	0
16	45708377	.	T	A	6	7	13	0	1	14	0	0
16	45709001	.	G	T	2	8	10	0	10	20	0	0
16	45710316	.	T	A	21	10	31	0	1	32	0	0
16	45710337	.	T	C	21	10	31	0	0	31	0	0
16	45710536	.	C	T	9	5	14	0	0	14	0	0
16	45710691	.	A	G	8	12	20	0	3	23	0	0
16	45711077	.	C	T	11	18	29	0	11	40	0	0
16	45711117	.	A	G	14	16	30	0	5	35	0	0
16	45712455	.	A	G	8	13	21	0	1	22	0	0
16	45713631	.	A	G	19	9	28	0	2	30	0	0
16	45713661	.	A	G	15	3	18	0	13	31	0	0
16	45725844	.	A	G	12	17	29	1	1	31	0	0
16	45726665	.	T	A	29	17	46	0	1	47	0	0
16	45726677	.	A	G	24	16	40	0	2	42	0	0
16	45739418	.	T	C	1	2	3	0	0	3	0	0
16	45763476	.	G	A	0	4	4	1	7	12	0	0
16	45765813	.	C	T	9	6	15	0	0	15	0	0
16	45782233	.	C	G	10	13	23	0	0	23	0	0
16	45782244	.	C	G	9	12	21	0	2	23	0	0
16	45929436	.	A	G	21	0	21	0	30	51	0	0
16	46069113	.	C	T	1	3	4	0	0	4	0	0
16	46081274	.	A	G	5	2	7	0	0	7	0	0
16	46081352	.	A	G	4	3	7	0	0	7	0	0
16	46081353	.	A	C	4	2	6	0	1	7	0	0
16	46086280	.	A	G	5	11	16	0	0	16	0	0
16	46086333	.	G	A	8	8	16	0	1	17	0	0
16	46086357	.	A	G	11	7	18	0	1	19	0	0
16	46086373	.	T	A	12	6	18	0	2	20	0	0
16	46086484	.	A	T	15	7	22	0	2	24	0	0
16	46086538	.	G	A	0	10	10	0	14	24	0	0
16	46086638	.	A	T	5	2	7	0	1	8	0	0
16	46086654	.	C	A	1	2	3	0	2	5	0	0
16	46086719	.	G	T	5	2	7	0	0	7	0	0
16	46086844	.	A	G	5	3	8	0	0	8	0	0
16	46087257	.	G	A	13	6	19	0	0	19	0	0
16	46087290	.	T	A	8	4	12	0	0	12	0	0
16	46087511	.	A	T	3	2	5	0	0	5	0	0
16	46087583	.	C	A	4	5	9	0	1	10	0	0
16	46087945	.	T	A	9	3	12	0	0	12	0	0
16	46087951	.	T	A	11	4	15	0	0	15	0	0
16	46088372	.	T	C	5	4	9	0	2	11	0	0
16	46088652	.	C	T	10	11	21	0	1	22	0	0
16	46088711	.	T	G	14	7	21	0	0	21	0	0
16	46088837	.	C	T	13	12	25	0	1	26	0	0
16	46089278	.	A	T	13	9	22	0	1	23	0	0
16	46089485	.	A	G	13	14	27	0	0	27	0	0
16	46089490	.	T	A	12	13	25	0	1	26	0	0
16	46089809	.	C	T	5	8	13	0	14	27	0	0
16	46089867	.	G	A	17	8	25	0	1	26	0	0
16	46089979	.	T	A	11	10	21	0	2	23	0	0
16	46090056	.	C	G	9	10	19	0	0	19	0	0
16	46090070	.	T	C	11	7	18	0	1	19	0	0
16	46090157	.	G	A	11	4	15	0	0	15	0	0
16	46090186	.	C	T	13	4	17	0	0	17	0	0
16	46090296	.	G	A	10	5	15	0	2	17	0	0
16	46090310	.	G	A	8	5	13	0	2	15	0	0
16	46090447	.	A	G	9	9	18	0	0	18	0	0
16	46090629	.	G	T	10	5	15	1	1	17	0	0
16	46090640	.	A	G	9	11	20	1	1	22	0	0
16	46090713	.	T	C	10	0	10	0	4	14	0	0
16	46090731	.	T	G	9	3	12	0	1	13	0	0
16	46090749	.	G	C	9	4	13	0	0	13	0	0
16	46091024	.	T	C	2	2	4	0	0	4	0	0
16	46091068	.	T	C	4	3	7	0	0	7	0	0
16	46091116	.	A	G	2	4	6	0	0	6	0	0
16	46091247	.	T	C	4	3	7	0	0	7	0	0
16	46091273	.	A	G	3	2	5	0	0	5	0	0
16	46091291	.	C	T	5	1	6	0	1	7	0	0
16	46091412	.	T	C	5	4	9	0	0	9	0	0
16	46091415	.	T	C	6	4	10	0	0	10	0	0
16	46093580	.	G	T	3	5	8	0	1	9	0	0
16	46093685	.	T	C	7	1	8	0	7	15	0	0
16	46097033	.	A	C	8	1	9	0	4	13	0	0
16	46097111	.	G	A	11	6	17	0	2	19	0	0
16	46097239	.	G	A	3	6	9	0	1	10	0	0
16	46097268	.	A	G	6	8	14	0	0	14	0	0
16	46172471	.	C	A	3	4	7	0	1	8	0	0
16	46179734	.	T	C	10	8	18	0	0	18	0	0
16	46185307	.	A	G	10	6	16	0	0	16	0	0
16	46185349	.	G	C	0	6	6	0	11	17	0	0
16	46187505	.	T	C	8	10	18	0	1	19	0	0
16	46196245	.	C	T	11	13	24	0	2	26	0	0
16	46196287	.	T	C	11	18	29	0	0	29	0	0
16	46196347	.	T	A	11	16	27	0	1	28	0	0
16	46196536	.	T	C	14	9	23	0	1	24	0	0
16	46197266	.	G	A	2	20	22	0	32	54	0	0
16	46197308	.	A	G	31	1	32	0	24	56	0	0
16	46197313	.	T	G	32	21	53	0	1	55	1	0
16	46197343	.	C	T	37	20	57	0	1	58	0	0
16	46197358	.	A	G	22	0	22	0	38	60	0	0
16	46197442	.	G	A	30	11	41	1	16	58	0	0
16	46197490	.	G	A	27	18	45	0	6	51	0	0
16	46197955	.	T	G	20	26	46	2	4	52	0	0
16	46197988	.	A	T	17	21	38	2	3	43	0	0
16	46197999	.	A	C	18	23	41	2	1	44	0	0
16	46198166	.	T	A	21	22	43	0	2	45	0	0
16	46198167	.	T	G	20	24	44	0	1	45	0	0
16	46198208	.	C	T	19	26	45	0	5	50	0	0
16	46198222	.	T	A	20	26	46	0	6	52	0	0
16	46198265	.	A	G	35	12	47	0	2	49	0	0
16	46198380	.	C	A	24	17	41	0	4	46	1	0
16	46198406	.	A	G	18	23	41	0	2	43	0	0
16	46198430	.	A	G	15	1	16	0	31	47	0	0
16	46198451	.	A	C	20	27	47	0	0	48	1	0
16	46198486	.	A	C	15	22	37	0	3	40	0	0
16	46198641	.	C	T	13	5	18	0	0	18	0	0
16	46198658	.	T	A	10	4	14	0	0	14	0	0
16	46199364	.	C	T	34	25	59	1	0	60	0	0
16	46199471	.	C	A	30	30	60	0	2	62	0	0
16	46199492	.	C	A	29	29	58	0	3	61	0	0
16	46200063	.	T	C	30	25	55	0	7	62	0	0
16	46200165	.	C	A	22	17	39	0	5	44	0	0
16	46200409	.	T	C	35	23	58	1	3	62	0	0
16	46200510	.	G	T	31	22	53	0	0	53	0	0
16	46200560	.	G	C	41	22	63	0	1	64	0	0
16	46200578	.	G	A	37	23	60	0	6	66	0	0
16	46200655	.	G	A	5	30	35	0	29	64	0	0
16	46200678	.	A	T	29	31	60	0	2	62	0	0
16	46200787	.	T	C	25	27	52	0	0	52	0	0
16	46200907	.	T	C	23	33	56	0	0	56	0	0
16	46200958	.	C	A	19	26	45	0	2	48	1	0
16	46201121	.	T	G	31	21	52	2	2	56	0	0
16	46201155	.	A	G	43	10	53	2	3	58	0	0
16	46201157	.	T	A	44	11	55	2	0	57	0	0
16	46201254	.	A	T	34	31	65	0	1	66	0	0
16	46201525	.	T	C	29	29	58	0	3	61	0	0
16	46201559	.	A	T	38	29	67	0	1	68	0	0
16	46201583	.	A	G	35	32	67	0	3	70	0	0
16	46201599	.	T	C	34	32	66	0	0	66	0	0
16	46201943	.	T	A	34	35	69	0	1	70	0	0
16	46202287	.	G	A	29	31	60	0	5	65	0	0
16	46202423	.	C	A	21	18	39	0	0	39	0	0
16	46209196	.	A	C	10	9	19	0	0	20	1	0
16	46209231	.	T	C	12	3	15	0	1	16	0	0
16	46209710	.	C	T	1	2	3	0	0	3	0	0
16	46209767	.	A	T	1	2	3	0	1	4	0	0
16	46326751	.	C	A	1	4	5	0	1	6	0	0
16	46398536	.	A	C	20	0	20	0	2	22	0	0
16	46398567	.	C	G	10	11	21	1	1	23	0	0
16	46398595	.	T	A	9	7	16	1	0	17	0	0
16	46398609	.	G	T	8	6	14	1	1	16	0	0
16	46399542	.	G	T	3	6	9	0	1	10	0	0
16	46399602	.	T	C	8	4	12	0	0	12	0	0
16	46399623	.	C	G	5	5	10	0	1	11	0	0
16	46399680	.	C	G	6	2	8	0	0	8	0	0
16	46399709	.	C	A	5	3	8	0	1	9	0	0
16	46399788	.	G	A	4	10	14	0	0	14	0	0
16	46400716	.	T	C	2	4	6	0	0	6	0	0
16	46400723	.	C	A	2	3	5	0	2	7	0	0
16	46401002	.	T	A	2	6	8	0	0	8	0	0
16	46401030	.	A	T	2	10	12	0	1	13	0	0
16	46401210	.	T	C	4	9	13	0	0	13	0	0
16	46401284	.	G	A	4	6	10	0	0	10	0	0
16	46401308	.	T	G	1	8	9	0	0	9	0	0
16	46401350	.	T	G	2	6	8	0	0	8	0	0
16	46401576	.	A	G	6	11	17	0	0	17	0	0
16	46401584	.	T	A	7	9	16	1	0	17	0	0
16	46401617	.	A	T	5	7	12	2	0	14	0	0
16	46401805	.	G	A	7	6	13	0	0	13	0	0
16	46401945	.	A	T	3	8	11	0	1	12	0	0
16	46402049	.	C	A	4	7	11	0	0	11	0	0
16	46402130	.	A	G	5	6	11	0	0	11	0	0
16	46402167	.	G	C	7	5	12	0	0	12	0	0
16	46415769	.	T	G	10	3	13	0	0	13	0	0
16	46415836	.	T	C	3	4	7	0	0	7	0	0
16	46423028	.	G	C	5	2	7	0	0	7	0	0
16	46423378	.	G	A	5	4	9	0	0	9	0	0
16	46423477	.	G	A	9	4	13	0	1	14	0	0
16	46423636	.	G	A	11	9	20	0	0	20	0	0
16	46423663	.	A	G	12	8	20	0	1	21	0	0
16	46423675	.	T	C	12	9	21	0	1	22	0	0
16	46423705	.	G	A	13	11	24	0	0	24	0	0
16	46423793	.	C	T	12	8	20	0	2	22	0	0
16	46423805	.	T	C	14	6	20	0	0	20	0	0
16	46428381	.	C	T	5	7	12	0	0	12	0	0
16	46428430	.	A	G	2	8	10	0	0	10	0	0
16	46428448	.	A	G	3	7	10	0	2	12	0	0
16	46430421	.	T	C	3	6	9	0	0	9	0	0
16	46434021	.	A	T	16	15	31	1	0	32	0	0
16	46434982	.	C	G	8	6	14	5	1	20	0	0
16	46453207	.	G	A	1	3	4	0	7	11	0	0
16	46453268	.	A	T	6	3	9	0	0	9	0	0
16	46453269	.	T	C	6	3	9	0	0	9	0	0
16	46463730	.	C	A	1	4	5	0	0	5	0	0
16	46463979	.	A	G	4	3	7	0	0	7	0	0
16	46464028	.	A	C	3	4	7	0	0	7	0	0
16	46464030	.	G	A	2	4	6	0	0	6	0	0
16	46464090	.	A	C	2	5	7	0	0	7	0	0
16	46464219	.	G	A	9	5	14	4	0	18	0	0
16	46464345	.	C	A	3	18	21	1	0	22	0	0
16	46464951	.	C	T	1	4	5	0	0	5	0	0
16	46464964	.	G	A	0	2	2	0	1	4	1	0
16	46493014	.	G	C	2	3	5	0	0	5	0	0
16	46495109	.	G	A	0	6	6	0	3	9	0	0
16	46495214	.	A	C	9	5	14	0	0	14	0	0
16	46495334	.	T	C	7	6	13	0	0	13	0	0
16	46495697	.	C	T	9	15	24	0	1	25	0	0
16	46495798	.	T	A	11	9	20	0	0	20	0	0
16	46495811	.	G	A	11	9	20	0	2	22	0	0
16	46495934	.	C	T	16	10	26	0	0	26	0	0
16	46495967	.	T	A	14	12	26	0	0	26	0	0
16	46495973	.	G	A	13	11	24	0	0	24	0	0
16	46518484	.	G	T	14	10	24	0	1	25	0	0
16	46519918	.	G	T	12	14	26	0	1	27	0	0
16	46519934	.	T	C	18	0	18	0	10	28	0	0
16	46521257	.	A	C	1	2	3	0	0	3	0	0
16	46521259	.	A	G	0	2	2	0	0	2	0	0
16	46524751	.	G	A	3	2	5	0	0	5	0	0
16	46598124	.	G	C	2	2	4	0	0	4	0	0
16	46669372	.	C	T	10	11	21	0	1	22	0	0
16	46672203	.	C	T	19	15	34	0	0	34	0	0
16	46673322	.	A	G	21	18	39	0	1	40	0	0
16	46675583	.	A	G	19	0	19	0	23	42	0	0
16	46680792	.	G	A	13	9	22	0	0	22	0	0
16	46680793	.	A	T	13	9	22	0	0	22	0	0
16	46681041	.	G	A	8	5	13	0	1	14	0	0
16	46681057	.	G	A	7	3	10	0	0	10	0	0
16	46686003	.	C	T	15	6	21	0	0	21	0	0
16	46690948	.	G	A	1	15	16	0	14	30	0	0
16	46691033	.	G	C	14	3	17	1	1	19	0	0
16	46691090	.	C	T	7	4	11	0	0	11	0	0
16	46691095	.	A	T	7	3	10	0	1	11	0	0
16	47147338	.	T	A	2	2	4	0	0	4	0	0
16	47172327	.	G	A	4	2	6	0	0	6	0	0
16	47207696	.	G	T	3	4	7	0	0	7	0	0
16	47212178	.	C	T	6	6	12	0	1	13	0	0
16	47212235	.	T	C	12	6	18	2	1	21	0	0
16	47212262	.	T	C	12	8	20	2	0	22	0	0
16	47213952	.	T	C	3	8	11	1	2	14	0	0
16	47220091	.	C	T	12	5	17	0	0	17	0	0
16	47220423	.	G	A	9	5	14	0	0	14	0	0
16	47273332	.	A	G	4	2	6	0	0	6	0	0
16	47273333	.	A	G	4	2	6	0	0	6	0	0
16	47277494	.	A	C	2	5	7	0	1	8	0	0
16	47289949	.	G	C	3	2	5	0	0	5	0	0
16	47390849	.	A	C	30	2	32	1	20	53	0	0
16	47390924	.	G	A	22	27	49	0	1	50	0	0
16	47407678	.	G	A	20	17	37	0	2	39	0	0
16	47412094	.	T	C	13	11	24	0	0	24	0	0
16	47438767	.	A	C	4	2	6	0	0	6	0	0
16	47446694	.	A	G	6	6	12	0	0	12	0	0
16	47449824	.	C	T	2	5	7	0	1	8	0	0
16	47449968	.	C	T	2	2	4	3	1	8	0	0
16	47449978	.	T	C	2	2	4	3	0	7	0	0
16	47461930	.	T	C	1	2	3	0	0	3	0	0
16	48310177	.	G	T	10	11	21	0	0	21	0	0
16	48333845	.	G	A	14	9	23	0	1	24	0	0
16	48400548	.	A	G	11	8	19	1	0	20	0	0
16	48409352	.	T	A	9	6	15	0	1	16	0	0
16	48413440	.	C	A	20	22	42	0	1	43	0	0
16	48413512	.	T	C	24	16	40	0	2	42	0	0
16	48413518	.	A	G	21	16	37	0	3	40	0	0
16	48415976	.	A	G	11	18	29	0	4	33	0	0
16	48416125	.	A	G	19	15	34	0	0	34	0	0
16	48420833	.	T	C	10	9	19	0	1	20	0	0
16	48421111	.	C	A	12	15	27	0	1	28	0	0
16	48421120	.	G	A	12	15	27	0	0	27	0	0
16	48423129	.	G	A	17	16	33	0	1	34	0	0
16	48425249	.	T	C	9	19	28	0	0	28	0	0
16	48425361	.	C	T	14	18	32	0	0	32	0	0
16	48425409	.	A	G	15	17	32	0	1	33	0	0
16	48426900	.	T	C	17	2	19	0	3	22	0	0
16	48426912	.	T	C	16	6	22	0	0	22	0	0
16	48427232	.	G	C	9	12	21	0	1	22	0	0
16	48428029	.	T	G	6	8	14	0	1	15	0	0
16	48562683	.	T	G	3	3	6	0	1	7	0	0
16	48565712	.	T	C	5	4	9	0	1	10	0	0
16	48621332	.	A	G	1	3	4	0	0	4	0	0
16	48621341	.	C	T	1	2	3	0	1	4	0	0
16	48631134	.	A	G	4	0	4	0	3	7	0	0
16	48640819	.	G	A	0	5	5	0	3	8	0	0
16	48642999	.	C	T	5	2	7	0	1	8	0	0
16	48645716	.	A	G	3	6	9	0	0	9	0	0
16	48646099	.	G	A	2	2	4	0	0	4	0	0
16	48646106	.	G	A	1	1	2	0	1	3	0	0
16	48647903	.	C	T	2	4	6	0	0	6	0	0
16	48705431	.	A	G	1	3	4	0	0	4	0	0
16	48714084	.	G	A	1	2	3	0	2	5	0	0
16	48718810	.	C	G	2	0	2	0	4	6	0	0
16	48718822	.	T	C	4	5	9	0	0	9	0	0
16	48724702	.	A	G	5	0	5	0	8	13	0	0
16	48729892	.	T	C	5	3	8	0	1	9	0	0
16	48729898	.	T	C	4	4	8	0	1	9	0	0
16	48734182	.	C	A	8	1	9	0	1	10	0	0
16	48734183	.	A	C	8	2	10	0	0	10	0	0
16	48736054	.	A	T	5	4	9	0	0	9	0	0
16	48736081	.	A	T	6	3	9	0	0	9	0	0
16	48736173	.	A	G	1	0	1	0	6	7	0	0
16	48736197	.	G	T	0	9	9	0	5	14	0	0
16	48738688	.	C	G	7	4	11	0	1	12	0	0
16	48740686	.	C	T	6	8	14	0	0	14	0	0
16	48740787	.	A	G	3	7	10	0	0	10	0	0
16	48740799	.	C	T	2	8	10	0	0	10	0	0
16	48740833	.	C	T	2	9	11	0	0	11	0	0
16	48740886	.	A	G	3	0	3	0	9	12	0	0
16	48746356	.	T	C	5	8	13	0	0	13	0	0
16	48746364	.	A	G	5	9	14	0	0	14	0	0
16	48746661	.	A	G	6	9	15	0	0	15	0	0
16	48746695	.	T	G	8	7	15	0	2	17	0	0
16	48746731	.	G	A	9	4	13	0	0	13	0	0
16	48746744	.	T	C	8	5	13	0	0	13	0	0
16	48746783	.	A	T	4	4	8	0	0	8	0	0
16	49093177	.	A	G	2	2	4	0	0	4	0	0
16	49093519	.	T	C	1	1	2	0	1	3	0	0
16	49093802	.	T	C	2	4	6	0	0	6	0	0
16	49094074	.	T	C	4	2	6	0	1	7	0	0
16	49094428	.	A	C	4	5	9	0	0	9	0	0
16	49094545	.	T	C	3	3	6	0	0	6	0	0
16	49094563	.	A	G	2	4	6	0	0	6	0	0
16	49101761	.	A	C	9	7	16	0	0	16	0	0
16	49101764	.	T	C	9	8	17	0	0	17	0	0
16	49101833	.	G	A	0	2	2	0	8	10	0	0
16	49152252	.	A	G	5	4	9	0	0	9	0	0
16	49601851	.	C	A	7	7	14	0	0	14	0	0
16	49601927	.	T	A	4	4	8	0	0	8	0	0
16	49602080	.	T	C	3	6	9	0	0	9	0	0
16	49602096	.	A	T	3	4	7	0	0	7	0	0
16	49602143	.	C	G	4	0	4	0	2	6	0	0
16	49604533	.	T	C	8	6	14	0	0	14	0	0
16	49604710	.	A	G	10	0	10	1	5	16	0	0
16	49612936	.	G	A	0	4	4	0	3	7	0	0
16	49618212	.	T	C	2	2	4	0	0	4	0	0
16	49661388	.	A	G	2	1	3	0	1	4	0	0
16	49746618	.	A	G	2	2	4	0	0	4	0	0
16	50065048	.	A	G	20	0	20	1	13	34	0	0
16	50075551	.	C	T	25	22	47	1	4	52	0	0
16	50075605	.	T	A	23	16	39	4	0	43	0	0
16	50075929	.	A	C	20	9	29	0	2	31	0	0
16	50076029	.	C	T	20	16	36	0	3	39	0	0
16	50089599	.	T	A	10	5	15	2	0	17	0	0
16	50100455	.	C	T	7	9	16	0	0	16	0	0
16	50106063	.	C	T	12	10	22	0	1	23	0	0
16	50106645	.	A	G	11	6	17	0	1	18	0	0
16	50108888	.	C	T	6	3	9	0	0	9	0	0
16	50109017	.	C	T	6	9	15	0	2	17	0	0
16	50109386	.	T	A	13	9	22	0	2	24	0	0
16	50109434	.	G	A	18	9	27	0	4	31	0	0
16	50109595	.	T	C	15	13	28	0	2	30	0	0
16	50109701	.	T	A	6	7	13	0	1	14	0	0
16	50109795	.	T	C	23	11	34	0	1	35	0	0
16	50110125	.	G	A	1	7	8	0	12	20	0	0
16	50110277	.	C	T	18	16	34	0	5	39	0	0
16	50110671	.	A	G	22	10	32	0	2	34	0	0
16	50110899	.	T	C	18	11	29	0	0	29	0	0
16	50214904	.	G	T	8	4	12	0	0	12	0	0
16	50215016	.	T	C	13	15	28	0	0	28	0	0
16	50215017	.	G	C	12	15	27	0	1	28	0	0
16	50215058	.	C	T	21	14	35	0	0	35	0	0
16	50215068	.	T	C	21	12	33	0	2	35	0	0
16	50215112	.	C	T	20	10	30	0	2	32	0	0
16	50215171	.	G	A	26	14	40	0	3	43	0	0
16	50215222	.	A	C	25	12	37	0	1	38	0	0
16	50215734	.	T	C	21	16	37	0	1	38	0	0
16	50218386	.	T	C	13	1	14	0	25	39	0	0
16	50218401	.	A	G	14	21	35	0	0	35	0	0
16	50218470	.	T	A	13	10	23	0	0	23	0	0
16	50229213	.	T	G	4	2	6	0	0	6	0	0
16	50803247	.	G	A	4	3	7	0	0	7	0	0
16	50824069	.	C	A	13	5	18	0	1	19	0	0
16	50824090	.	C	T	15	6	21	0	0	21	0	0
16	51002287	.	G	A	1	2	3	0	0	3	0	0
16	51244464	.	T	C	6	3	9	0	1	10	0	0
16	51244487	.	T	C	2	3	5	0	0	5	0	0
16	51282129	.	G	T	1	2	3	0	0	3	0	0
16	51370110	.	T	C	2	0	2	0	4	6	0	0
16	51370414	.	T	C	3	2	5	0	0	5	0	0
16	51371348	.	G	A	1	5	6	0	0	6	0	0
16	51885808	.	G	A	32	26	58	4	5	67	0	0
16	51885855	.	A	T	37	24	61	4	5	70	0	0
16	51888929	.	C	T	31	24	55	0	1	56	0	0
16	51950697	.	T	A	22	14	36	0	2	38	0	0
16	51950726	.	C	A	22	24	46	0	2	48	0	0
16	51950754	.	C	T	26	32	58	0	0	58	0	0
16	51950814	.	A	T	34	0	34	0	0	34	0	0
16	51950877	.	G	C	22	24	46	1	4	51	0	0
16	51951690	.	T	C	5	19	24	0	2	26	0	0
16	51951691	.	T	C	15	9	24	0	2	26	0	0
16	51951861	.	G	C	15	11	26	0	2	28	0	0
16	51952002	.	T	G	11	15	26	0	0	26	0	0
16	51952023	.	A	T	7	17	24	0	3	27	0	0
16	51952063	.	A	C	8	20	28	0	1	29	0	0
16	51952817	.	C	T	9	4	13	0	1	14	0	0
16	51952826	.	C	A	5	8	13	0	1	14	0	0
16	51953009	.	G	A	18	24	42	0	1	43	0	0
16	51953048	.	T	C	23	26	49	0	2	51	0	0
16	51953057	.	T	A	21	29	50	0	0	50	0	0
16	51953189	.	G	T	25	10	35	0	1	36	0	0
16	51954683	.	C	T	1	21	22	0	14	36	0	0
16	51955675	.	G	A	22	19	41	0	2	43	0	0
16	51955696	.	G	A	19	21	40	0	0	40	0	0
16	51962068	.	A	G	12	19	31	0	1	32	0	0
16	51962089	.	C	T	21	10	31	0	2	33	0	0
16	51966774	.	C	G	15	14	29	0	1	30	0	0
16	53451141	.	A	G	1	4	5	0	0	5	0	0
16	54320243	.	A	G	1	2	3	0	0	3	0	0
16	54404803	.	A	G	1	3	4	0	0	4	0	0
16	54474858	.	A	G	7	4	11	0	0	11	0	0
16	54475037	.	G	A	13	5	18	0	2	20	0	0
16	54475064	.	G	A	8	9	17	0	0	17	0	0
16	54478053	.	A	G	7	6	13	0	1	14	0	0
16	54479732	.	G	A	9	8	17	0	1	18	0	0
16	54498049	.	G	A	6	5	11	0	1	12	0	0
16	54568813	.	G	C	1	6	7	0	1	8	0	0
16	54571035	.	G	A	4	8	12	0	0	12	0	0
16	54574237	.	T	G	5	9	14	0	0	14	0	0
16	54574282	.	C	G	5	10	15	0	1	16	0	0
16	54580999	.	T	C	9	4	13	0	0	13	0	0
16	54583177	.	C	T	15	4	19	0	0	19	0	0
16	54584670	.	C	T	7	9	16	0	0	16	0	0
16	54585729	.	G	C	0	6	6	0	9	15	0	0
16	54586574	.	C	G	10	5	15	0	0	15	0	0
16	54590177	.	C	T	7	9	16	0	0	16	0	0
16	54590219	.	A	G	8	0	8	0	12	20	0	0
16	54590594	.	C	T	13	19	32	0	2	34	0	0
16	54592503	.	T	C	16	11	27	0	0	27	0	0
16	54593401	.	A	G	15	15	30	0	0	30	0	0
16	54594047	.	A	C	14	23	37	2	5	44	0	0
16	54594413	.	C	T	17	13	30	0	1	31	0	0
16	54594421	.	A	G	18	15	33	0	0	33	0	0
16	54594511	.	A	G	7	1	8	0	16	24	0	0
16	54594598	.	T	A	6	23	29	0	3	32	0	0
16	54594605	.	T	C	5	25	30	0	4	34	0	0
16	54636042	.	T	C	1	1	2	0	3	5	0	0
16	54636973	.	T	G	4	5	9	0	1	10	0	0
16	54637993	.	T	C	1	0	1	0	4	5	0	0
16	54638569	.	A	G	2	2	4	0	2	6	0	0
16	54639451	.	G	A	0	5	5	0	1	6	0	0
16	54780864	.	G	A	0	15	15	0	17	32	0	0
16	54782542	.	G	A	2	22	24	0	19	43	0	0
16	54785573	.	C	G	29	22	51	0	2	53	0	0
16	54785894	.	A	G	11	11	22	0	0	22	0	0
16	54786147	.	A	C	6	0	6	0	6	12	0	0
16	54787578	.	G	A	7	7	14	0	2	16	0	0
16	54787725	.	C	T	4	20	24	1	27	52	0	0
16	54794760	.	G	A	4	5	9	24	0	33	0	0
16	54795732	.	A	G	7	10	17	0	0	17	0	0
16	54795735	.	G	A	8	10	18	0	0	18	0	0
16	54805136	.	A	C	1	0	1	0	3	4	0	0
16	54805173	.	G	A	4	2	6	0	0	6	0	0
16	54806967	.	C	A	0	2	2	0	2	4	0	0
16	54809990	.	A	G	3	3	6	0	0	6	0	0
16	54810110	.	G	A	2	2	4	0	0	4	0	0
16	54958913	.	G	A	1	5	6	0	0	6	0	0
16	55211071	.	A	G	0	2	2	0	1	3	0	0
17	1069048	.	G	T	4	2	6	0	0	6	0	0
17	1353930	.	A	G	1	0	1	0	6	7	0	0
17	2696692	.	T	C	2	2	4	0	0	4	0	0
17	3282104	.	C	A	2	3	5	0	0	5	0	0
17	3282367	.	A	G	3	4	7	0	1	8	0	0
17	3282394	.	A	G	1	4	5	0	0	5	0	0
17	3283250	.	A	T	3	3	6	0	0	6	0	0
17	3288101	.	A	G	3	9	12	0	1	13	0	0
17	3290700	.	A	G	3	3	6	0	1	7	0	0
17	3290771	.	A	T	3	4	7	0	0	7	0	0
17	3446847	.	T	C	4	10	14	0	1	15	0	0
17	3556184	.	C	A	2	7	9	0	2	11	0	0
17	3566811	.	A	G	3	3	6	0	1	7	0	0
17	3566844	.	T	A	4	5	9	0	1	10	0	0
17	3569047	.	T	C	7	11	18	0	1	19	0	0
17	3569050	.	A	C	8	9	17	0	1	18	0	0
17	3569169	.	A	G	12	12	24	0	0	24	0	0
17	3569264	.	A	C	6	4	10	0	0	10	0	0
17	3569298	.	A	G	1	3	4	0	1	5	0	0
17	3841153	.	A	G	9	9	18	1	0	19	0	0
17	3850524	.	G	A	7	7	14	0	0	14	0	0
17	3855403	.	G	A	4	8	12	0	1	13	0	0
17	3855436	.	T	C	6	0	6	0	7	13	0	0
17	3855697	.	C	T	3	9	12	0	5	17	0	0
17	3860794	.	C	G	8	6	14	0	0	14	0	0
17	3860797	.	T	C	8	0	8	0	6	14	0	0
17	3868759	.	A	C	3	1	4	0	2	6	0	0
17	3868765	.	T	C	2	1	3	0	3	6	0	0
17	3878982	.	T	C	5	0	5	0	4	9	0	0
17	3999726	.	T	G	3	2	5	0	0	5	0	0
17	4002659	.	C	A	2	2	4	0	0	4	0	0
17	4017277	.	T	C	1	3	4	0	0	4	0	0
17	4017389	.	A	T	1	3	4	0	0	4	0	0
17	4017399	.	T	C	1	2	3	0	0	3	0	0
17	4046651	.	G	T	0	2	2	0	1	3	0	0
17	4227439	.	G	A	1	2	3	0	0	3	0	0
17	4239711	.	A	G	14	7	21	0	2	23	0	0
17	4297232	.	G	A	24	9	33	0	2	35	0	0
17	4297546	.	C	T	24	17	41	0	0	41	0	0
17	4297551	.	A	C	23	15	38	0	0	38	0	0
17	4297600	.	T	C	30	14	44	0	0	44	0	0
17	4297608	.	G	C	27	0	27	0	18	45	0	0
17	4297697	.	A	T	14	14	28	0	4	32	0	0
17	4297819	.	A	T	3	3	6	0	0	6	0	0
17	4297957	.	G	C	14	0	14	0	23	37	0	0
17	4298174	.	C	T	18	18	36	0	2	38	0	0
17	4298190	.	T	A	16	24	40	0	3	43	0	0
17	4298221	.	T	A	17	21	38	0	2	40	0	0
17	4298307	.	A	T	20	11	31	4	2	37	0	0
17	4298326	.	T	G	11	17	28	4	1	33	0	0
17	4298349	.	T	A	13	14	27	2	9	38	0	0
17	4298768	.	T	G	2	14	16	0	1	17	0	0
17	4298876	.	A	G	6	2	8	1	0	9	0	0
17	4298945	.	G	A	19	9	28	1	1	30	0	0
17	4298990	.	A	G	15	12	27	0	1	28	0	0
17	4298996	.	C	T	15	12	27	0	3	30	0	0
17	4299030	.	C	G	15	13	28	0	1	29	0	0
17	4299031	.	C	T	15	14	29	1	0	30	0	0
17	4304841	.	G	A	17	28	45	0	1	46	0	0
17	4307242	.	T	C	21	0	21	0	20	41	0	0
17	4313342	.	G	A	10	14	24	0	1	25	0	0
17	4361710	.	C	G	1	2	3	0	0	3	0	0
17	4369379	.	G	T	1	3	4	0	0	4	0	0
17	4378210	.	G	A	5	5	10	1	1	12	0	0
17	4378219	.	C	T	7	6	13	1	0	14	0	0
17	4385982	.	C	T	1	5	6	0	0	6	0	0
17	4386026	.	T	A	1	2	3	0	0	3	0	0
17	5061184	.	G	C	6	6	12	0	1	13	0	0
17	5768756	.	T	C	2	0	2	0	5	7	0	0
17	5768776	.	A	C	2	3	5	0	1	6	0	0
17	5768792	.	C	T	4	4	8	0	0	8	0	0
17	5816666	.	C	T	1	3	4	0	0	4	0	0
17	5819951	.	C	T	3	6	9	0	0	9	0	0
17	5819969	.	C	T	2	4	6	0	0	6	0	0
17	5820083	.	C	T	4	4	8	0	1	9	0	0
17	5820170	.	C	T	1	5	6	0	0	6	0	0
17	5820209	.	T	C	1	2	3	0	0	3	0	0
17	5896025	.	G	A	16	12	28	0	0	28	0	0
17	5916392	.	A	G	10	16	26	0	2	28	0	0
17	5926722	.	T	C	25	8	33	0	1	34	0	0
17	5926981	.	A	T	15	16	31	0	2	33	0	0
17	5927085	.	C	A	12	11	23	0	1	24	0	0
17	5927101	.	T	C	8	10	18	0	0	18	0	0
17	5927172	.	G	A	4	4	8	0	1	9	0	0
17	6016741	.	C	T	1	3	4	0	1	5	0	0
17	6079976	.	A	T	1	4	5	0	0	5	0	0
17	6101343	.	C	T	4	2	6	0	0	6	0	0
17	6101565	.	G	A	1	2	3	0	0	3	0	0
17	6279806	.	C	A	8	12	20	0	1	21	0	0
17	6279876	.	G	T	0	12	12	0	5	17	0	0
17	6394106	.	C	T	5	4	9	0	0	9	0	0
17	6394301	.	C	T	0	4	4	0	2	6	0	0
17	6395381	.	G	C	3	4	7	0	0	7	0	0
17	6395560	.	T	C	5	0	5	0	4	9	0	0
17	6396090	.	G	A	3	2	5	0	0	5	0	0
17	6398949	.	G	A	2	2	4	1	0	5	0	0
17	6438334	.	A	G	4	3	7	0	2	9	0	0
17	6438387	.	T	C	1	2	3	0	1	4	0	0
17	6438630	.	T	A	11	5	16	1	1	18	0	0
17	6444514	.	T	A	9	5	14	0	0	14	0	0
17	6447234	.	A	G	5	4	9	0	1	10	0	0
17	6447418	.	G	T	5	6	11	0	0	11	0	0
17	6451511	.	G	A	3	2	5	0	0	5	0	0
17	6451687	.	A	G	1	3	4	0	0	4	0	0
17	6451702	.	A	G	1	3	4	0	0	4	0	0
17	6452854	.	C	T	2	5	7	0	1	8	0	0
17	6452857	.	T	C	2	4	6	0	1	7	0	0
17	6460449	.	A	C	6	4	10	0	0	10	0	0
17	6462023	.	A	T	9	5	14	0	0	14	0	0
17	6462228	.	G	A	2	6	8	0	0	8	0	0
17	6544615	.	T	C	1	3	4	0	0	4	0	0
17	6549831	.	C	G	1	3	4	0	0	4	0	0
17	6715755	.	T	A	36	20	56	0	2	58	0	0
17	6716412	.	G	T	33	30	63	0	3	66	0	0
17	6716472	.	G	A	37	30	67	0	2	69	0	0
17	6730114	.	G	A	39	31	70	0	2	72	0	0
17	6737970	.	C	A	2	28	30	0	20	50	0	0
17	6758867	.	T	G	6	16	22	0	0	22	0	0
17	6808341	.	A	G	9	4	13	0	0	13	0	0
17	6808406	.	A	G	9	2	11	0	1	12	0	0
17	6808413	.	T	C	0	7	7	0	2	9	0	0
17	6991832	.	C	T	1	4	5	0	1	6	0	0
17	6992302	.	T	G	0	1	1	0	11	12	0	0
17	7351265	.	T	C	1	2	3	0	0	3	0	0
17	7781458	.	T	A	2	4	6	0	0	6	0	0
17	7781609	.	A	T	1	3	4	0	0	4	0	0
17	7781648	.	A	C	1	2	3	0	0	3	0	0
17	7783375	.	C	T	2	2	4	0	0	4	0	0
17	7783451	.	G	T	2	3	5	0	0	5	0	0
17	7802799	.	A	G	4	6	10	0	1	11	0	0
17	7818872	.	T	A	2	3	5	0	0	5	0	0
17	7844994	.	G	A	5	6	11	0	1	12	0	0
17	7845364	.	G	C	10	19	29	0	2	31	0	0
17	7845412	.	T	C	21	12	33	0	0	33	0	0
17	7845566	.	C	T	12	23	35	0	0	35	0	0
17	7861124	.	C	T	20	23	43	0	0	43	0	0
17	7868632	.	G	A	29	25	54	0	1	55	0	0
17	7879348	.	T	C	15	20	35	0	0	35	0	0
17	7882941	.	G	A	15	8	23	0	0	23	0	0
17	7882998	.	G	A	17	14	31	0	0	31	0	0
17	7885662	.	A	G	9	15	24	0	1	25	0	0
17	7894976	.	T	A	16	10	26	0	2	28	0	0
17	7895023	.	G	A	13	17	30	0	3	33	0	0
17	7896356	.	C	T	2	10	12	0	22	34	0	0
17	7896390	.	C	T	1	13	14	0	20	34	0	0
17	7896478	.	C	T	14	14	28	0	1	29	0	0
17	7901137	.	C	T	15	10	25	0	2	27	0	0
17	7906568	.	G	T	12	13	25	0	1	26	0	0
17	7906610	.	C	T	4	13	17	0	1	18	0	0
17	7906612	.	G	A	14	5	19	0	0	19	0	0
17	7906646	.	T	A	6	14	20	0	2	22	0	0
17	7907851	.	C	T	5	6	11	0	2	13	0	0
17	7917997	.	G	A	10	9	19	0	2	21	0	0
17	7926040	.	G	A	10	9	19	0	1	20	0	0
17	7926076	.	C	T	7	7	14	0	2	16	0	0
17	7928263	.	A	G	7	10	17	0	0	17	0	0
17	7928600	.	C	A	0	7	7	0	7	14	0	0
17	7931737	.	G	A	6	6	12	0	0	12	0	0
17	7942191	.	T	G	5	6	11	0	1	12	0	0
17	7942366	.	T	G	4	7	11	0	4	15	0	0
17	7945421	.	C	G	6	4	10	0	0	10	0	0
17	7945485	.	A	G	6	4	10	0	0	10	0	0
17	7949042	.	G	A	6	4	10	0	0	10	0	0
17	7949066	.	G	A	3	4	7	0	1	8	0	0
17	7950372	.	C	T	2	4	6	0	1	7	0	0
17	7963202	.	G	C	2	5	7	0	0	7	0	0
17	7963236	.	G	A	3	5	8	0	0	8	0	0
17	7963282	.	G	A	6	4	10	0	0	10	0	0
17	7963294	.	G	A	5	3	8	0	0	8	0	0
17	7974804	.	T	C	6	5	11	0	1	12	0	0
17	7977746	.	A	T	2	2	4	0	0	4	0	0
17	7977806	.	C	T	3	5	8	0	0	8	0	0
17	7978533	.	G	A	3	2	5	0	0	5	0	0
17	7983068	.	A	G	6	3	9	0	1	10	0	0
17	7985543	.	A	G	1	3	4	0	0	4	0	0
17	7986359	.	T	C	2	3	5	0	2	7	0	0
17	7999827	.	G	T	2	2	4	0	0	4	0	0
17	8000049	.	T	C	4	4	8	0	1	9	0	0
17	8000122	.	C	A	1	2	3	0	0	3	0	0
17	8002928	.	C	G	3	3	6	0	0	6	0	0
17	8006696	.	T	C	2	3	5	0	0	5	0	0
17	8024551	.	G	A	3	2	5	0	0	5	0	0
17	8032895	.	C	T	1	2	3	0	0	3	0	0
17	8188963	.	G	T	0	6	6	0	2	8	0	0
17	8191475	.	A	G	5	2	7	0	0	7	0	0
17	8197141	.	G	A	5	6	11	0	0	11	0	0
17	8197569	.	C	A	6	4	10	0	0	10	0	0
17	8199812	.	C	T	5	2	7	0	0	7	0	0
17	8199824	.	G	A	2	4	6	0	0	6	0	0
17	8199896	.	T	C	3	2	5	0	0	5	0	0
17	8202712	.	G	A	0	5	5	0	10	15	0	0
17	8202742	.	G	A	2	7	9	0	16	25	0	0
17	8202778	.	T	C	17	14	31	0	0	31	0	0
17	8203468	.	G	A	13	8	21	0	2	23	0	0
17	8203498	.	G	A	12	6	18	0	3	21	0	0
17	8204086	.	G	C	12	7	19	0	0	19	0	0
17	8204087	.	C	T	12	7	19	0	0	19	0	0
17	8204248	.	A	G	9	0	9	0	17	26	0	0
17	8204533	.	C	T	13	12	25	0	0	25	0	0
17	8204755	.	A	G	11	26	37	0	3	40	0	0
17	8204818	.	A	G	27	10	37	0	1	38	0	0
17	8204935	.	T	C	19	25	44	0	4	48	0	0
17	8204962	.	C	T	20	24	44	0	0	44	0	0
17	8205340	.	A	T	17	15	32	0	0	32	0	0
17	8205697	.	A	G	14	21	35	0	3	39	1	0
17	8209315	.	T	C	15	10	25	0	2	27	0	0
17	8209327	.	C	T	12	15	27	0	0	27	0	0
17	8209837	.	T	A	10	20	30	0	2	32	0	0
17	8209931	.	C	A	11	11	22	0	0	22	0	0
17	8209944	.	A	G	14	6	20	0	3	23	0	0
17	8210203	.	G	A	15	4	19	0	1	20	0	0
17	8210411	.	A	G	7	17	24	0	0	24	0	0
17	8210466	.	A	G	9	0	9	0	12	21	0	0
17	8245790	.	C	A	0	3	3	0	4	7	0	0
17	8245868	.	G	A	6	4	10	0	0	10	0	0
17	8245903	.	T	C	6	0	6	0	8	14	0	0
17	8246281	.	G	A	2	2	4	0	0	4	0	0
17	8246329	.	T	C	3	4	7	0	0	7	0	0
17	8246341	.	A	G	3	5	8	0	0	8	0	0
17	8248987	.	A	G	5	4	9	0	1	10	0	0
17	8249153	.	A	T	3	3	6	0	1	7	0	0
17	8253267	.	A	G	1	4	5	0	0	5	0	0
17	8256534	.	C	T	1	5	6	0	0	6	0	0
17	8256546	.	C	T	1	5	6	0	0	6	0	0
17	8261565	.	G	A	7	5	12	0	0	12	0	0
17	8284514	.	C	T	1	2	3	0	1	4	0	0
17	8502883	.	G	A	4	7	11	0	1	12	0	0
17	8502934	.	A	G	4	4	8	0	0	8	0	0
17	8514511	.	G	A	2	4	6	0	0	6	0	0
17	8515222	.	C	A	1	2	3	0	0	3	0	0
17	8562349	.	A	G	1	2	3	0	0	3	0	0
17	8597174	.	T	A	15	13	28	0	1	30	1	0
17	8597702	.	A	T	16	20	36	0	2	38	0	0
17	8597965	.	T	A	25	18	43	1	3	47	0	0
17	8611580	.	G	A	22	18	40	0	2	42	0	0
17	8623396	.	G	A	18	16	34	0	2	36	0	0
17	8623456	.	T	C	18	9	27	0	1	29	1	0
17	8727654	.	A	T	7	1	8	0	1	9	0	0
17	8760493	.	T	C	2	3	5	0	0	5	0	0
17	8772665	.	C	T	1	6	7	0	0	7	0	0
17	8772776	.	C	T	1	2	3	0	0	3	0	0
17	8772800	.	G	A	3	3	6	0	0	6	0	0
17	8780716	.	G	A	4	3	7	0	0	7	0	0
17	8784682	.	T	C	2	4	6	0	0	6	0	0
17	8784742	.	G	A	0	4	4	0	4	8	0	0
17	8789449	.	G	A	4	2	6	0	0	6	0	0
17	8791468	.	A	G	4	7	11	0	0	11	0	0
17	8791573	.	A	T	1	5	6	0	0	6	0	0
17	8791841	.	T	G	1	5	6	0	0	6	0	0
17	8791863	.	C	T	6	2	8	0	0	8	0	0
17	8791907	.	A	G	2	0	2	0	5	7	0	0
17	8927638	.	A	G	9	9	18	0	2	20	0	0
17	8927641	.	A	G	11	9	20	0	0	20	0	0
17	8934223	.	G	A	17	16	33	0	2	35	0	0
17	8934307	.	C	T	19	10	29	0	1	30	0	0
17	8937918	.	G	A	14	10	24	0	0	24	0	0
17	8937954	.	G	A	21	9	30	0	1	31	0	0
17	8938023	.	C	T	14	17	31	0	2	33	0	0
17	8938249	.	T	C	17	17	34	0	2	36	0	0
17	8938269	.	G	A	22	16	38	0	0	38	0	0
17	8938305	.	T	A	25	17	42	0	0	42	0	0
17	8941320	.	C	T	5	8	13	0	0	13	0	0
17	8951606	.	C	G	1	17	18	0	7	25	0	0
17	8951644	.	C	T	1	9	10	0	17	27	0	0
17	8951655	.	T	C	16	11	27	0	2	29	0	0
17	8951867	.	C	T	3	20	23	0	11	34	0	0
17	8964520	.	G	A	8	11	19	0	1	20	0	0
17	8969278	.	A	G	15	10	25	0	2	27	0	0
17	8969296	.	G	A	18	15	33	0	1	34	0	0
17	9041364	.	C	T	2	5	7	0	0	7	0	0
17	9041460	.	A	G	1	3	4	0	0	4	0	0
17	9042223	.	A	G	1	2	3	0	0	3	0	0
17	9042447	.	C	T	2	3	5	0	0	5	0	0
17	9042608	.	G	C	1	4	5	0	0	5	0	0
17	9042652	.	T	C	6	4	10	0	0	10	0	0
17	9225184	.	G	A	1	6	7	0	7	14	0	0
17	9225223	.	A	G	5	4	9	0	1	10	0	0
17	9253705	.	T	C	6	5	11	0	0	11	0	0
17	9254269	.	T	A	2	5	7	0	0	7	0	0
17	9255196	.	G	A	0	6	6	0	15	21	0	0
17	9255547	.	G	C	10	12	22	0	1	23	0	0
17	9255703	.	C	T	12	11	23	0	1	24	0	0
17	9266298	.	C	T	18	22	40	0	2	42	0	0
17	9266501	.	G	T	1	15	16	0	19	35	0	0
17	9501615	.	G	A	0	3	3	0	1	4	0	0
17	9601121	.	G	C	2	2	4	0	0	4	0	0
17	9601133	.	C	T	2	2	4	0	0	4	0	0
17	9847212	.	C	T	6	3	9	0	0	9	0	0
17	9847215	.	C	T	3	5	8	0	1	9	0	0
17	9888958	.	C	G	4	7	11	0	0	11	0	0
17	9889127	.	T	A	15	7	22	0	1	23	0	0
17	9889223	.	C	T	11	6	17	0	3	20	0	0
17	9889313	.	T	A	6	9	15	0	3	18	0	0
17	9889427	.	G	A	15	6	21	0	0	21	0	0
17	9889728	.	A	T	8	5	13	0	0	13	0	0
17	9889745	.	A	G	9	0	9	0	9	18	0	0
17	9944848	.	T	A	6	6	12	0	0	12	0	0
17	9945176	.	T	A	6	4	10	0	1	11	0	0
17	9945178	.	T	G	8	4	12	0	0	12	0	0
17	9951885	.	G	A	3	2	5	0	0	5	0	0
17	9952033	.	C	T	0	7	7	0	7	14	0	0
17	9955952	.	C	T	6	3	9	0	0	9	0	0
17	9957913	.	T	A	3	3	6	0	0	6	0	0
17	9961080	.	G	A	2	6	8	0	0	8	0	0
17	9962399	.	C	A	6	10	16	0	1	17	0	0
17	9963519	.	G	A	6	6	12	0	0	12	0	0
17	9964019	.	G	A	4	2	6	0	0	6	0	0
17	9964177	.	C	A	2	2	4	0	1	5	0	0
17	9964359	.	T	C	5	2	7	0	0	7	0	0
17	9964361	.	A	G	5	2	7	0	0	7	0	0
17	9964437	.	A	T	3	3	6	0	1	7	0	0
17	9964912	.	G	A	2	5	7	0	0	7	0	0
17	9964930	.	C	A	2	3	5	0	0	5	0	0
17	9964954	.	T	A	1	4	5	0	1	6	0	0
17	9965231	.	T	C	4	0	4	0	4	8	0	0
17	9967566	.	G	A	3	3	6	0	0	6	0	0
17	9977651	.	T	C	1	2	3	0	0	3	0	0
17	10143757	.	A	G	4	7	11	0	1	12	0	0
17	10143792	.	A	G	6	0	6	0	1	7	0	0
17	10143808	.	A	G	2	5	7	0	0	7	0	0
17	10580113	.	A	G	3	0	3	0	2	5	0	0
17	10765766	.	A	G	3	5	8	0	0	8	0	0
17	10765773	.	A	G	3	7	10	0	0	10	0	0
17	11073603	.	C	T	1	2	3	0	0	3	0	0
17	11392264	.	G	A	1	5	6	0	0	6	0	0
17	11716754	.	A	G	1	2	3	0	0	3	0	0
17	11717109	.	C	T	2	17	19	3	5	27	0	0
17	12073108	.	T	C	0	4	4	0	1	5	0	0
17	12073148	.	A	G	1	5	6	0	0	6	0	0
17	12073155	.	G	C	0	5	5	0	1	6	0	0
17	12747536	.	G	A	7	3	10	0	0	10	0	0
17	13069424	.	T	C	11	2	13	0	0	13	0	0
17	14623422	.	T	C	5	2	7	0	0	7	0	0
17	15633377	.	T	C	6	26	32	0	0	32	0	0
17	15633379	.	T	C	8	24	32	0	0	32	0	0
17	15633530	.	C	T	6	3	9	1	0	10	0	0
17	15633605	.	T	C	10	4	14	0	0	14	0	0
17	15633721	.	T	C	2	7	9	0	0	9	0	0
17	15964906	.	C	T	1	2	3	0	0	3	0	0
17	15965018	.	G	T	0	4	4	0	2	6	0	0
17	16804700	.	A	G	4	11	15	0	0	15	0	0
17	17492857	.	A	T	2	1	3	0	1	4	0	0
17	18070138	.	G	A	2	16	18	1	1	20	0	0
17	18179927	.	T	C	6	10	16	1	6	23	0	0
17	19420053	.	G	C	2	5	7	0	3	10	0	0
17	19420197	.	C	T	14	12	26	0	2	28	0	0
17	19420434	.	C	T	1	5	6	0	8	14	0	0
17	19420563	.	T	G	9	8	17	0	2	19	0	0
17	19421109	.	C	G	11	12	23	0	1	24	0	0
17	19421248	.	T	G	15	12	27	0	1	28	0	0
17	19421636	.	T	C	16	0	16	0	11	27	0	0
17	19421667	.	A	G	16	7	23	0	1	24	0	0
17	19421948	.	C	T	14	11	25	0	1	26	0	0
17	19421955	.	A	T	14	11	25	0	1	26	0	0
17	19422452	.	C	T	1	7	8	0	8	16	0	0
17	19423145	.	C	T	3	7	10	0	0	10	0	0
17	19423334	.	C	T	4	3	7	0	1	8	0	0
17	19423375	.	A	T	5	3	8	0	0	8	0	0
17	19429290	.	T	C	5	0	5	0	4	9	0	0
17	19431175	.	C	A	1	7	8	0	1	9	0	0
17	19431439	.	C	T	0	6	6	0	2	8	0	0
17	19431481	.	G	A	2	2	4	0	0	4	0	0
17	19431718	.	G	A	5	9	14	0	0	14	0	0
17	19440149	.	T	G	1	4	5	0	0	5	0	0
17	19440233	.	C	T	0	6	6	0	3	9	0	0
17	19440460	.	T	C	3	0	3	0	2	5	0	0
17	19440492	.	G	A	2	4	6	0	2	8	0	0
17	19440500	.	T	G	3	3	6	0	1	7	0	0
17	19446105	.	A	G	4	2	6	0	0	6	0	0
17	19448684	.	G	T	3	2	5	0	0	5	0	0
17	19448792	.	C	T	1	4	5	0	0	5	0	0
17	19460095	.	G	A	2	2	4	0	0	4	0	0
17	19499276	.	A	T	2	1	3	0	0	3	0	0
17	19499281	.	G	C	2	2	4	0	0	4	0	0
17	19499326	.	C	T	3	2	5	0	0	5	0	0
17	19502407	.	T	C	4	2	6	0	1	7	0	0
17	19506474	.	C	T	5	2	7	0	1	8	0	0
17	19506575	.	A	C	5	1	6	0	1	7	0	0
17	19506934	.	G	A	0	2	2	0	3	5	0	0
17	19506943	.	A	C	3	2	5	0	0	5	0	0
17	19510714	.	G	A	3	7	10	0	0	10	0	0
17	19511087	.	T	C	0	2	2	0	1	3	0	0
17	19607654	.	A	T	5	5	10	0	3	13	0	0
17	19607950	.	C	G	2	2	4	0	0	4	0	0
17	19607983	.	T	G	2	1	3	0	0	3	0	0
17	19607991	.	T	C	2	1	3	0	1	4	0	0
17	19608339	.	A	C	1	2	3	0	0	3	0	0
17	19608612	.	C	T	1	2	3	0	2	5	0	0
17	19608741	.	A	G	1	4	5	0	0	5	0	0
17	19608758	.	C	T	2	2	4	0	1	5	0	0
17	19609092	.	C	T	1	3	4	0	0	4	0	0
17	19609705	.	T	C	2	3	5	0	0	5	0	0
17	19692573	.	A	C	7	8	15	0	0	15	0	0
17	19715899	.	T	C	17	14	31	0	2	33	0	0
17	19754364	.	G	A	2	2	4	0	0	4	0	0
17	19754387	.	A	T	3	2	5	0	0	5	0	0
17	19754456	.	G	A	2	3	5	0	0	5	0	0
17	19754724	.	C	T	0	3	3	0	2	5	0	0
17	19755032	.	C	T	1	2	3	0	3	6	0	0
17	19755102	.	C	T	2	5	7	0	0	7	0	0
17	19755158	.	C	G	1	3	4	0	3	7	0	0
17	19755269	.	T	C	2	3	5	0	0	5	0	0
17	19755829	.	C	T	0	2	2	0	1	3	0	0
17	19755922	.	C	T	1	4	5	0	0	5	0	0
17	19756051	.	T	C	1	3	4	0	0	4	0	0
17	19756277	.	A	G	2	1	3	0	0	3	0	0
17	19756332	.	C	G	2	4	6	0	0	6	0	0
17	19757177	.	T	A	2	3	5	0	0	5	0	0
17	19757193	.	A	G	3	4	7	0	0	7	0	0
17	19757255	.	A	C	1	2	3	0	0	3	0	0
17	19757256	.	T	A	1	2	3	0	0	3	0	0
17	19831968	.	T	C	2	3	5	0	1	6	0	0
17	19831980	.	A	T	2	3	5	0	0	5	0	0
17	19832895	.	T	C	1	2	3	0	0	3	0	0
17	20122430	.	A	G	1	2	3	0	0	3	0	0
17	20147756	.	A	C	7	4	11	0	1	12	0	0
17	20147771	.	A	G	7	6	13	0	0	13	0	0
17	20147804	.	C	A	4	5	9	0	0	9	0	0
17	20148867	.	G	A	8	4	12	0	0	12	0	0
17	20149668	.	G	A	5	9	14	0	0	14	0	0
17	20161885	.	A	G	3	6	9	0	0	9	0	0
17	20167047	.	C	A	1	4	5	0	0	5	0	0
17	20185215	.	G	A	2	2	4	0	0	4	0	0
17	20188929	.	C	T	0	8	8	0	5	13	0	0
17	20189047	.	A	T	3	13	16	0	0	16	0	0
17	20191569	.	T	C	3	0	3	0	7	10	0	0
17	20191941	.	A	G	7	5	12	0	1	13	0	0
17	20191956	.	A	G	2	6	8	0	3	11	0	0
17	20196194	.	A	G	7	3	10	0	0	10	0	0
17	20198914	.	T	C	2	0	2	0	3	5	0	0
17	20200047	.	C	T	2	2	4	0	0	4	0	0
17	20207216	.	G	T	1	3	4	0	0	4	0	0
17	20214570	.	C	A	3	2	5	0	1	6	0	0
17	20214757	.	T	C	4	4	8	0	0	8	0	0
17	20214766	.	T	C	5	0	5	0	4	9	0	0
17	20215498	.	G	A	5	7	12	0	1	13	0	0
17	20215739	.	T	C	2	3	5	0	1	6	0	0
17	20218318	.	T	C	1	0	1	0	3	4	0	0
17	20232526	.	G	T	4	5	9	0	0	9	0	0
17	20235494	.	G	A	4	6	10	0	0	10	0	0
17	20243035	.	A	G	24	1	25	0	16	41	0	0
17	20243375	.	C	A	17	21	38	0	5	43	0	0
17	20243564	.	G	A	11	11	22	0	1	23	0	0
17	20243611	.	G	A	14	13	27	0	3	30	0	0
17	20248398	.	A	G	24	17	41	0	1	42	0	0
17	20248455	.	A	T	20	21	41	0	1	42	0	0
17	20248479	.	T	C	24	20	44	0	2	46	0	0
17	20248500	.	C	G	0	13	13	0	26	39	0	0
17	20248705	.	T	C	19	1	20	0	18	38	0	0
17	20251987	.	T	C	16	10	26	0	0	26	0	0
17	20256603	.	A	C	15	12	27	0	0	27	0	0
17	20256669	.	A	G	13	10	23	0	1	24	0	0
17	20256894	.	T	C	12	12	24	0	3	27	0	0
17	20256921	.	A	G	18	7	25	0	1	26	0	0
17	20256948	.	G	C	11	1	12	0	6	18	0	0
17	20259679	.	A	C	4	4	8	0	0	8	0	0
17	20264097	.	C	T	4	8	12	0	3	15	0	0
17	20268379	.	G	A	9	9	18	0	0	18	0	0
17	20268442	.	C	T	6	6	12	0	3	15	0	0
17	20287338	.	C	T	8	5	13	0	0	13	0	0
17	20321614	.	C	T	0	2	2	0	4	6	0	0
17	20321650	.	C	T	5	2	7	0	0	7	0	0
17	20321730	.	C	T	7	6	13	1	0	14	0	0
17	20324012	.	T	C	7	8	15	0	1	16	0	0
17	20324036	.	C	T	2	6	8	0	10	18	0	0
17	20324051	.	A	G	12	8	20	0	0	20	0	0
17	20324084	.	T	C	10	1	11	0	7	18	0	0
17	20324114	.	C	T	0	10	10	0	12	22	0	0
17	20324144	.	G	A	9	14	23	0	0	23	0	0
17	20354894	.	G	T	1	2	3	0	0	3	0	0
17	20380992	.	G	A	2	2	4	0	0	4	0	0
17	20518147	.	G	A	1	4	5	0	0	5	0	0
17	20585362	.	T	C	5	10	15	0	1	16	0	0
17	20587321	.	A	C	3	2	5	0	1	6	0	0
17	20587947	.	T	A	3	3	6	0	0	6	0	0
17	20605277	.	C	T	1	2	3	0	0	3	0	0
17	20653983	.	T	C	7	4	11	0	0	11	0	0
17	20654140	.	G	A	6	6	12	0	0	12	0	0
17	20654948	.	T	A	1	2	3	0	0	3	0	0
17	20674063	.	C	T	4	8	12	0	0	12	0	0
17	20674489	.	T	C	10	1	11	0	14	25	0	0
17	20674755	.	A	T	3	2	5	1	0	6	0	0
17	20674794	.	C	T	5	13	18	0	2	20	0	0
17	20674889	.	T	A	11	17	28	0	3	31	0	0
17	20684685	.	A	T	18	17	35	0	8	43	0	0
17	20695604	.	G	A	11	6	17	0	0	17	0	0
17	20695941	.	C	A	0	3	3	0	7	10	0	0
17	20701602	.	A	G	29	19	48	0	2	50	0	0
17	20701999	.	G	A	24	19	43	0	2	45	0	0
17	20702030	.	C	T	2	21	23	0	22	45	0	0
17	20702056	.	G	A	23	19	42	0	0	42	0	0
17	20719067	.	G	C	9	17	26	0	0	26	0	0
17	20719232	.	A	G	8	12	20	0	2	22	0	0
17	20719248	.	C	T	12	9	21	0	1	22	0	0
17	20719746	.	G	T	8	8	16	0	0	16	0	0
17	20720046	.	C	T	3	15	18	2	8	28	0	0
17	20720121	.	G	T	17	10	27	0	1	28	0	0
17	20720334	.	C	T	25	13	38	0	0	38	0	0
17	20720581	.	G	A	12	18	30	0	0	30	0	0
17	20720739	.	G	T	16	15	31	0	3	34	0	0
17	20721597	.	A	G	6	4	10	0	1	11	0	0
17	20722113	.	C	A	6	10	16	0	0	16	0	0
17	20722389	.	A	G	10	5	15	0	1	16	0	0
17	20722955	.	A	G	9	5	14	0	0	14	0	0
17	20723081	.	A	T	8	9	17	0	0	17	0	0
17	20723407	.	A	G	10	10	20	0	1	21	0	0
17	20724187	.	A	T	4	3	7	0	1	8	0	0
17	20724318	.	C	T	7	4	11	0	0	11	0	0
17	20724675	.	A	G	6	14	20	0	1	21	0	0
17	20725107	.	G	A	8	6	14	0	0	14	0	0
17	20725296	.	T	C	7	5	12	0	1	13	0	0
17	20725474	.	A	C	4	5	9	0	0	9	0	0
17	20725554	.	G	A	1	8	9	0	0	9	0	0
17	20729433	.	C	T	4	3	7	0	1	8	0	0
17	20734207	.	G	A	3	5	8	0	0	8	0	0
17	20763022	.	C	T	0	3	3	0	6	9	0	0
17	20770456	.	G	A	2	2	4	0	0	4	0	0
17	20795953	.	G	A	1	2	3	0	0	3	0	0
17	20795992	.	G	A	2	3	5	0	0	5	0	0
17	20796115	.	C	T	0	4	4	0	1	5	0	0
17	20806988	.	C	T	2	2	4	0	0	4	0	0
17	20963653	.	T	C	11	8	19	0	2	21	0	0
17	20963664	.	T	C	10	7	17	0	1	18	0	0
17	20964056	.	A	T	3	3	6	0	0	6	0	0
17	20964611	.	G	A	5	8	13	0	0	13	0	0
17	20964669	.	A	G	11	9	20	0	0	20	0	0
17	20964978	.	A	G	3	14	17	0	0	17	0	0
17	20965143	.	G	A	10	8	18	0	2	20	0	0
17	20965182	.	C	T	3	9	12	0	16	28	0	0
17	20965194	.	G	T	19	9	28	0	0	28	0	0
17	20965295	.	T	G	16	17	33	1	1	35	0	0
17	20978673	.	A	G	13	12	25	0	1	26	0	0
17	20978822	.	A	G	3	3	6	2	0	8	0	0
17	20978823	.	G	A	4	2	6	2	0	8	0	0
17	20978972	.	G	A	3	5	8	0	1	9	0	0
17	20979056	.	A	T	6	4	10	0	2	12	0	0
17	20985487	.	T	A	1	2	3	0	0	3	0	0
17	21102352	.	T	A	6	2	8	0	1	9	0	0
17	21102367	.	G	A	3	5	8	1	2	11	0	0
17	21104883	.	A	G	3	4	7	0	0	7	0	0
17	21107316	.	T	C	3	3	6	0	0	6	0	0
17	21120781	.	G	A	11	5	16	0	0	16	0	0
17	21123435	.	G	A	6	3	9	0	0	9	0	0
17	21123461	.	A	T	1	4	5	0	2	7	0	0
17	21123537	.	T	C	2	4	6	0	0	6	0	0
17	21141630	.	G	A	1	3	4	0	0	4	0	0
17	21147021	.	C	T	3	4	7	0	1	8	0	0
17	21151945	.	C	A	4	4	8	0	0	8	0	0
17	21152106	.	G	A	4	3	7	0	0	7	0	0
17	21152145	.	A	C	6	5	11	0	0	11	0	0
17	21154691	.	A	G	4	4	8	0	0	8	0	0
17	21154957	.	C	A	7	8	15	1	0	16	0	0
17	21155425	.	C	A	13	10	23	0	0	23	0	0
17	21155817	.	T	C	12	11	23	0	1	24	0	0
17	21156140	.	G	T	11	4	15	0	5	20	0	0
17	21156162	.	A	G	11	10	21	0	1	22	0	0
17	21156207	.	A	C	11	13	24	0	1	25	0	0
17	21156220	.	C	T	12	12	24	0	2	26	0	0
17	21156265	.	T	A	7	10	17	0	2	19	0	0
17	21156299	.	T	C	8	0	8	0	9	17	0	0
17	21156342	.	C	T	5	4	9	0	1	10	0	0
17	21156352	.	C	T	6	2	8	0	0	8	0	0
17	21156590	.	C	A	1	2	3	0	6	9	0	0
17	21156808	.	A	T	7	7	14	0	0	14	0	0
17	21158291	.	A	T	4	3	7	0	0	7	0	0
17	21158438	.	C	A	1	3	4	0	0	4	0	0
17	21158439	.	C	A	1	3	4	0	0	4	0	0
17	21158527	.	G	A	2	3	5	0	0	5	0	0
17	21158629	.	C	G	4	6	10	0	0	10	0	0
17	21160083	.	G	A	6	4	10	0	0	10	0	0
17	21160107	.	G	A	3	6	9	0	0	9	0	0
17	21162573	.	T	C	4	5	9	0	0	9	0	0
17	21166028	.	T	C	3	0	3	0	2	5	0	0
17	21245410	.	T	C	4	0	4	0	6	10	0	0
17	21251211	.	G	A	3	3	6	0	0	6	0	0
17	21310117	.	G	A	1	2	3	0	0	3	0	0
17	21372616	.	C	T	3	10	13	0	22	35	0	0
17	21372810	.	G	T	18	29	47	0	2	49	0	0
17	21373062	.	G	A	19	18	37	0	2	39	0	0
17	21373105	.	C	G	3	19	22	0	17	39	0	0
17	21377133	.	G	A	21	13	34	0	3	37	0	0
17	21396399	.	A	G	12	7	19	0	0	19	0	0
17	21396444	.	A	G	8	11	19	0	0	19	0	0
17	21396462	.	A	G	9	14	23	0	0	23	0	0
17	21433014	.	C	T	0	3	3	0	4	7	0	0
17	21433074	.	G	A	5	7	12	0	0	12	0	0
17	21433680	.	C	A	4	3	7	0	0	7	0	0
17	21433750	.	C	T	0	5	5	0	5	10	0	0
17	21434317	.	C	T	0	2	2	0	1	3	0	0
17	21550216	.	T	C	5	2	7	0	1	8	0	0
17	21560706	.	A	T	5	6	11	0	0	11	0	0
17	21560738	.	A	G	3	6	9	0	0	9	0	0
17	21560763	.	T	C	2	5	7	0	0	7	0	0
17	21562474	.	A	T	1	2	3	0	0	3	0	0
17	21607781	.	C	T	3	3	6	0	0	6	0	0
17	21617536	.	T	C	5	4	9	0	0	9	0	0
17	21617586	.	C	T	10	3	13	0	0	13	0	0
17	21617588	.	A	T	2	9	11	0	1	12	0	0
17	21791668	.	T	C	2	0	2	0	6	8	0	0
17	21791974	.	C	T	1	2	3	0	0	3	0	0
17	21817552	.	G	C	3	3	6	0	0	6	0	0
17	21817651	.	G	A	0	2	2	0	5	7	0	0
17	21817652	.	G	A	5	2	7	0	0	7	0	0
17	21818245	.	C	T	6	5	11	0	0	11	0	0
17	21818266	.	T	C	7	6	13	0	0	13	0	0
17	21820366	.	C	T	7	6	13	0	1	14	0	0
17	21820378	.	C	T	7	4	11	0	0	11	0	0
17	21820583	.	G	A	7	3	10	0	0	10	0	0
17	21820657	.	C	A	8	3	11	0	1	12	0	0
17	21820744	.	A	T	3	9	12	0	0	12	0	0
17	21820772	.	A	G	4	7	11	0	3	14	0	0
17	21820879	.	C	T	9	17	26	0	0	26	0	0
17	21821381	.	A	G	7	5	12	0	1	13	0	0
17	21821405	.	T	C	6	8	14	0	0	14	0	0
17	21821627	.	C	T	2	6	8	0	0	8	0	0
17	21821653	.	T	C	5	4	9	0	1	10	0	0
17	21821856	.	C	T	7	6	13	0	2	15	0	0
17	21821958	.	C	T	3	5	8	0	0	8	0	0
17	21904009	.	G	A	2	12	14	0	13	27	0	0
17	21905752	.	A	C	9	8	17	10	1	28	0	0
17	21911999	.	T	C	20	21	41	0	2	43	0	0
17	21912381	.	T	C	11	8	19	0	4	23	0	0
17	21912489	.	T	C	21	11	32	0	0	32	0	0
17	21912517	.	T	C	23	5	28	0	2	30	0	0
17	21912597	.	C	A	12	7	19	0	1	20	0	0
17	21912622	.	C	A	5	8	13	0	0	13	0	0
17	21912676	.	A	T	7	13	20	0	0	20	0	0
17	21912708	.	T	A	12	15	27	0	0	27	0	0
17	21912797	.	T	C	9	12	21	0	1	22	0	0
17	21912874	.	A	G	14	19	33	0	0	33	0	0
17	21912890	.	G	T	11	17	28	0	1	29	0	0
17	21935871	.	T	C	3	3	6	0	0	6	0	0
17	21952787	.	G	A	1	4	5	0	4	9	0	0
17	21954957	.	C	T	2	10	12	0	0	12	0	0
17	21955115	.	T	C	4	13	17	0	1	18	0	0
17	21958945	.	A	G	11	0	11	0	13	24	0	0
17	21959239	.	A	T	10	8	18	0	0	18	0	0
17	21959338	.	C	T	4	2	6	0	0	6	0	0
17	21959342	.	A	T	4	2	6	0	0	6	0	0
17	21959375	.	A	G	2	2	4	0	0	4	0	0
17	21975525	.	G	A	0	13	13	0	9	22	0	0
17	21975528	.	C	G	9	14	23	0	1	24	0	0
17	21982062	.	T	C	3	6	9	2	0	11	0	0
17	22003274	.	A	G	5	5	10	0	0	10	0	0
17	22003324	.	A	T	4	5	9	0	0	9	0	0
17	22032345	.	T	A	7	4	11	1	1	13	0	0
17	22032679	.	A	C	7	3	10	0	0	10	0	0
17	22032718	.	G	C	9	3	12	0	1	13	0	0
17	22032729	.	C	T	12	4	16	0	0	16	0	0
17	22033020	.	G	A	8	5	13	0	0	13	0	0
17	22033142	.	T	C	12	0	12	0	9	21	0	0
17	22035770	.	T	C	6	0	6	0	15	21	0	0
17	22035945	.	C	T	1	10	11	0	5	16	0	0
17	22036460	.	C	A	4	3	7	0	0	7	0	0
17	22036602	.	A	C	6	0	6	0	11	17	0	0
17	22036659	.	G	T	5	6	11	0	0	11	0	0
17	22036686	.	A	G	5	6	11	0	1	12	0	0
17	22036896	.	G	A	3	4	7	0	0	7	0	0
17	22037014	.	G	A	2	5	7	0	0	7	0	0
17	22044272	.	T	C	3	0	3	0	5	8	0	0
17	22047883	.	C	T	3	6	9	0	6	15	0	0
17	22051176	.	A	G	6	6	12	0	0	12	0	0
17	22052074	.	G	A	9	9	18	0	0	18	0	0
17	22062275	.	C	T	17	6	23	0	0	23	0	0
17	22063318	.	T	C	2	5	7	0	0	7	0	0
17	22072375	.	G	A	1	2	3	0	1	4	0	0
17	22072673	.	A	C	4	2	6	0	0	6	0	0
17	22090673	.	C	T	2	2	4	0	0	4	0	0
17	22090897	.	T	G	2	0	2	0	2	4	0	0
17	22091044	.	T	G	4	5	9	0	0	9	0	0
17	22091067	.	G	A	4	6	10	0	0	10	0	0
17	22091118	.	T	A	1	7	8	0	1	9	0	0
17	22108065	.	G	A	10	7	17	0	1	18	0	0
17	22108207	.	A	T	6	5	11	1	1	13	0	0
17	22111379	.	T	G	12	7	19	1	0	20	0	0
17	22111386	.	T	C	13	0	13	1	6	21	1	0
17	22111610	.	G	A	14	8	22	1	0	23	0	0
17	22113050	.	T	C	8	10	18	0	0	18	0	0
17	22382726	.	C	T	1	1	2	0	1	3	0	0
17	22382885	.	A	G	6	1	7	0	6	13	0	0
17	22471649	.	G	A	0	5	5	0	6	11	0	0
17	22489033	.	A	C	3	3	6	0	2	8	0	0
17	22489072	.	G	C	0	4	4	0	7	11	0	0
17	22500507	.	C	A	12	4	16	0	3	19	0	0
17	22500600	.	G	A	10	10	20	1	2	23	0	0
17	22500627	.	C	T	12	12	24	1	2	27	0	0
17	22500898	.	T	G	8	0	8	0	9	17	0	0
17	22500937	.	G	A	1	9	10	0	7	17	0	0
17	22500972	.	A	C	11	9	20	0	1	21	0	0
17	22501063	.	G	A	1	11	12	0	5	17	0	0
17	22501353	.	G	A	6	10	16	0	0	16	0	0
17	22501447	.	T	A	13	12	25	0	0	25	0	0
17	22501490	.	T	C	8	13	21	0	1	22	0	0
17	22501493	.	C	A	9	12	21	0	0	21	0	0
17	22501547	.	C	A	6	15	21	0	0	21	0	0
17	22501645	.	G	T	8	6	14	0	1	15	0	0
17	22501858	.	C	T	4	5	9	0	2	11	0	0
17	22582313	.	C	T	21	11	32	0	1	33	0	0
17	22584847	.	G	A	20	21	41	0	2	43	0	0
17	22585264	.	T	A	19	25	44	0	2	46	0	0
17	22585273	.	C	T	27	19	46	0	1	47	0	0
17	22585337	.	T	A	23	11	34	0	0	34	0	0
17	22647001	.	C	T	2	2	4	0	0	4	0	0
17	22649721	.	G	A	1	3	4	0	0	4	0	0
17	22649838	.	C	T	1	4	5	0	1	6	0	0
17	22650505	.	G	T	0	6	6	0	1	7	0	0
17	22650586	.	C	T	2	3	5	0	0	5	0	0
17	22650641	.	C	A	2	6	8	0	1	9	0	0
17	22650760	.	C	T	3	3	6	0	0	6	0	0
17	22650979	.	C	T	2	3	5	0	0	5	0	0
17	22651351	.	C	T	3	3	6	0	1	7	0	0
17	22651375	.	T	C	4	4	8	0	0	8	0	0
17	22652799	.	T	A	6	5	11	0	0	11	0	0
17	22652825	.	G	T	4	4	8	0	0	8	0	0
17	22653491	.	C	T	5	4	9	0	0	9	0	0
17	22653710	.	C	T	12	3	15	0	0	15	0	0
17	22654096	.	C	T	7	8	15	0	1	16	0	0
17	22658245	.	A	G	11	6	17	0	1	18	0	0
17	22659176	.	G	T	2	6	8	0	8	16	0	0
17	22659206	.	G	A	4	5	9	0	1	10	0	0
17	22659957	.	A	G	7	0	7	0	7	14	0	0
17	22662759	.	T	C	7	5	12	0	0	12	0	0
17	22669012	.	G	A	2	10	12	0	8	20	0	0
17	22669060	.	C	T	12	13	25	0	1	26	0	0
17	22669511	.	A	C	9	9	18	0	0	18	0	0
17	22687408	.	C	A	6	11	17	0	0	17	0	0
17	22687409	.	C	G	7	11	18	0	0	18	0	0
17	22687451	.	T	C	8	12	20	0	1	21	0	0
17	22687500	.	T	G	9	8	17	1	2	20	0	0
17	22687558	.	T	A	19	11	30	0	1	31	0	0
17	22687561	.	G	A	20	12	32	0	1	33	0	0
17	22687729	.	T	C	21	21	42	0	3	45	0	0
17	22687842	.	T	A	18	22	40	0	0	40	0	0
17	22713696	.	C	T	19	13	32	0	0	32	0	0
17	22723479	.	T	C	13	11	24	0	0	24	0	0
17	22723515	.	C	T	16	9	25	0	1	26	0	0
17	22729079	.	T	C	11	17	28	0	1	29	0	0
17	22729772	.	T	A	19	9	28	0	1	29	0	0
17	22729796	.	G	A	2	13	15	0	20	35	0	0
17	22729886	.	C	T	13	7	20	0	1	21	0	0
17	22738350	.	G	A	13	14	27	0	1	28	0	0
17	22741044	.	C	T	8	13	21	0	0	21	0	0
17	22741070	.	G	A	1	12	13	0	8	21	0	0
17	22741096	.	A	T	7	12	19	0	0	19	0	0
17	22741437	.	A	T	9	10	19	0	0	20	1	0
17	22760817	.	T	A	4	4	8	0	0	8	0	0
17	22782653	.	G	A	1	5	6	0	4	10	0	0
17	22800422	.	C	T	1	4	5	0	0	5	0	0
17	22804934	.	A	T	1	3	4	0	0	4	0	0
17	22805016	.	G	A	3	4	7	0	1	8	0	0
17	22916905	.	C	T	6	7	13	0	0	13	0	0
17	22918230	.	G	A	1	4	5	0	0	5	0	0
17	22918258	.	A	G	3	9	12	0	0	12	0	0
17	22937684	.	A	T	3	8	11	0	1	12	0	0
17	22937719	.	A	T	2	8	10	0	2	12	0	0
17	22944875	.	A	G	6	8	14	0	0	14	0	0
17	22944887	.	A	G	7	8	15	0	0	15	0	0
17	22946926	.	C	T	1	4	5	0	0	5	0	0
17	22946930	.	A	G	0	4	4	0	0	4	0	0
17	23200277	.	A	C	1	2	3	0	0	3	0	0
17	23200509	.	G	A	2	3	5	0	0	5	0	0
17	23212811	.	G	A	3	3	6	0	0	6	0	0
17	23215411	.	T	C	7	3	10	0	1	11	0	0
17	23215612	.	G	A	6	5	11	0	0	11	0	0
17	23215678	.	A	T	1	2	3	0	0	3	0	0
17	23216461	.	C	T	3	7	10	0	0	10	0	0
17	23220627	.	A	G	5	9	14	0	0	14	0	0
17	23220698	.	T	A	10	5	15	0	2	17	0	0
17	23222460	.	C	G	8	7	15	0	1	16	0	0
17	23223166	.	C	G	8	11	19	0	0	19	0	0
17	23224626	.	C	T	8	8	16	0	1	17	0	0
17	23224680	.	G	A	6	12	18	0	0	18	0	0
17	23224743	.	A	G	10	0	10	0	15	25	0	0
17	23224800	.	G	A	12	11	23	0	2	25	0	0
17	23226667	.	C	T	10	8	18	0	0	18	0	0
17	23231130	.	C	T	14	13	27	0	0	27	0	0
17	23257660	.	C	A	1	2	3	0	0	3	0	0
17	23258164	.	G	A	2	2	4	0	0	4	0	0
17	23300837	.	C	G	10	3	13	0	0	13	0	0
17	23300879	.	G	A	18	8	26	0	0	26	0	0
17	23300888	.	T	C	18	8	26	0	0	26	0	0
17	23301102	.	C	T	5	9	14	0	1	15	0	0
17	23301303	.	G	A	24	19	43	0	0	43	0	0
17	23301372	.	C	T	18	20	38	0	3	41	0	0
17	23301390	.	G	A	3	16	19	0	23	42	0	0
17	23301433	.	G	T	17	22	39	0	1	40	0	0
17	23301484	.	G	A	21	19	40	0	2	42	0	0
17	23301799	.	A	G	7	4	11	0	1	12	0	0
17	23434216	.	G	A	9	8	17	0	1	18	0	0
17	23434264	.	A	G	9	9	18	0	1	19	0	0
17	23434389	.	T	C	9	0	9	0	8	17	0	0
17	23437102	.	A	G	3	6	9	0	0	9	0	0
17	23437677	.	C	G	1	5	6	0	0	6	0	0
17	23441680	.	C	T	4	2	6	0	0	6	0	0
17	23441698	.	A	G	5	3	8	0	0	8	0	0
17	23444362	.	G	C	6	4	10	0	0	10	0	0
17	23444415	.	A	G	6	6	12	0	0	12	0	0
17	23542264	.	T	A	4	6	10	0	0	10	0	0
17	23542616	.	A	G	1	2	3	0	0	3	0	0
17	23542662	.	C	T	3	4	7	0	0	7	0	0
17	23542677	.	G	A	2	3	5	0	0	5	0	0
17	23542752	.	A	G	3	3	6	0	0	6	0	0
17	23542770	.	A	G	6	4	10	0	0	10	0	0
17	23542890	.	C	G	1	5	6	0	0	6	0	0
17	23543088	.	C	T	1	3	4	0	0	4	0	0
17	23543343	.	A	C	3	2	5	0	0	5	0	0
17	23549232	.	A	G	2	1	3	0	4	7	0	0
17	23549293	.	A	G	5	0	5	0	4	9	0	0
17	23549416	.	G	A	2	4	6	0	0	6	0	0
17	23549710	.	G	T	5	7	12	0	0	12	0	0
17	23551512	.	T	C	3	3	6	0	0	6	0	0
17	23551536	.	C	T	3	4	7	0	0	7	0	0
17	23551971	.	G	A	0	2	2	0	2	4	0	0
17	23554980	.	T	C	4	4	8	0	0	8	0	0
17	23555032	.	T	C	5	2	7	0	0	7	0	0
17	23555278	.	A	T	4	3	7	0	0	7	0	0
17	23555403	.	A	T	3	3	6	0	0	6	0	0
17	23574682	.	G	A	5	6	11	0	0	11	0	0
17	23575413	.	A	G	2	4	6	0	3	9	0	0
17	23650844	.	T	G	6	4	10	0	17	27	0	0
17	23656034	.	A	C	22	0	22	0	29	51	0	0
17	23656112	.	C	T	3	23	26	0	19	45	0	0
17	23659853	.	C	T	27	19	46	0	3	49	0	0
17	23711184	.	A	T	5	8	13	0	1	14	0	0
17	23711421	.	A	C	6	17	23	0	1	24	0	0
17	23711775	.	C	T	1	9	10	0	9	19	0	0
17	23722882	.	A	T	6	7	13	0	0	13	0	0
17	23727637	.	G	T	4	5	9	0	1	10	0	0
17	23757541	.	G	A	0	5	5	0	4	9	0	0
17	23757906	.	C	T	1	4	5	0	0	5	0	0
17	23764591	.	T	C	6	5	11	0	0	11	0	0
17	23820614	.	A	G	4	6	10	0	1	11	0	0
17	23821410	.	C	T	7	4	11	0	0	11	0	0
17	23821480	.	T	A	5	3	8	0	0	8	0	0
17	23822235	.	G	T	5	6	11	0	0	11	0	0
17	23822323	.	G	A	2	6	8	0	0	8	0	0
17	23822537	.	C	T	1	1	2	0	1	3	0	0
17	23822749	.	C	T	2	9	11	0	3	14	0	0
17	23822856	.	G	A	4	3	7	0	1	8	0	0
17	23824244	.	C	T	5	2	7	0	1	8	0	0
17	23824504	.	A	G	3	7	10	0	0	10	0	0
17	23894359	.	G	A	2	1	3	0	1	4	0	0
17	23894378	.	C	T	1	2	3	0	1	4	0	0
17	23935259	.	C	T	2	3	5	0	0	5	0	0
17	23937626	.	T	G	6	17	23	0	0	23	0	0
17	23940102	.	C	A	6	22	28	0	3	31	0	0
17	23948365	.	A	G	27	10	37	0	3	40	0	0
17	23948396	.	C	T	28	10	38	0	1	39	0	0
17	23952672	.	G	C	10	31	41	0	2	43	0	0
17	23954987	.	C	G	5	5	10	0	0	10	0	0
17	23956882	.	G	A	6	17	23	0	0	23	0	0
17	23956925	.	G	A	0	15	15	0	8	23	0	0
17	23964637	.	T	C	4	4	8	0	0	8	0	0
17	23964690	.	T	A	7	5	12	0	2	14	0	0
17	23964719	.	A	G	6	5	11	0	0	11	0	0
17	23964732	.	T	C	6	4	10	0	1	11	0	0
17	23965283	.	T	A	4	3	7	0	0	7	0	0
17	23965475	.	G	C	7	6	13	0	0	13	0	0
17	23965694	.	A	C	8	3	11	0	0	11	0	0
17	23965983	.	C	A	9	7	16	0	2	18	0	0
17	23986153	.	A	G	12	0	12	0	6	18	0	0
17	23986585	.	T	C	19	12	31	0	0	31	0	0
17	24111050	.	G	T	1	2	3	0	0	3	0	0
17	24111400	.	G	A	0	4	4	0	2	6	0	0
17	24177150	.	T	C	5	3	8	0	0	8	0	0
17	24178449	.	G	C	6	4	10	0	0	10	0	0
17	24182184	.	T	A	6	6	12	0	1	13	0	0
17	24186029	.	C	T	6	12	18	0	0	18	0	0
17	24186042	.	T	C	2	7	9	0	4	13	0	0
17	24186129	.	C	T	3	4	7	0	0	7	0	0
17	24222649	.	G	A	8	12	20	0	2	22	0	0
17	24222730	.	T	A	14	8	22	0	1	23	0	0
17	24222752	.	A	T	13	7	20	0	2	22	0	0
17	24222771	.	G	T	13	11	24	0	0	24	0	0
17	24247670	.	G	T	2	7	9	0	0	9	0	0
17	24254467	.	G	A	1	8	9	0	9	18	0	0
17	24268278	.	G	A	17	8	25	0	5	30	0	0
17	24313974	.	T	A	2	5	7	0	0	7	0	0
17	24314068	.	G	A	2	7	9	0	0	9	0	0
17	24314331	.	A	G	15	8	23	1	2	26	0	0
17	24314468	.	A	T	6	7	13	0	0	13	0	0
17	24314986	.	G	A	0	12	12	0	6	18	0	0
17	24317350	.	G	T	1	2	3	0	0	3	0	0
17	24319071	.	A	C	4	4	8	0	0	8	0	0
17	24339217	.	G	T	4	4	8	0	1	9	0	0
17	24439623	.	T	A	1	4	5	0	0	5	0	0
17	24440579	.	G	A	2	7	9	0	0	9	0	0
17	24442526	.	G	A	1	8	9	0	9	18	0	0
17	24442888	.	C	T	7	9	16	0	0	16	0	0
17	24443182	.	G	C	9	4	13	0	0	13	0	0
17	24444239	.	T	G	4	5	9	0	0	9	0	0
17	24463526	.	G	A	10	4	14	0	0	14	0	0
17	24464939	.	A	C	7	10	17	0	0	17	0	0
17	24464987	.	A	T	11	6	17	0	1	18	0	0
17	24469255	.	G	A	7	8	15	0	0	15	0	0
17	24469752	.	A	C	13	15	28	0	1	29	0	0
17	24470146	.	C	A	19	10	29	0	4	33	0	0
17	24480111	.	T	C	4	4	8	0	0	8	0	0
17	24480273	.	C	T	0	3	3	0	3	6	0	0
17	24484184	.	T	A	4	5	9	0	0	9	0	0
17	24484202	.	G	T	5	3	8	0	0	8	0	0
17	24493276	.	G	T	6	4	10	0	0	10	0	0
17	24537442	.	G	T	3	4	7	0	1	8	0	0
17	24537450	.	T	A	5	5	10	0	0	10	0	0
17	24550311	.	G	A	1	3	4	0	0	4	0	0
17	24550541	.	G	A	2	2	4	0	0	4	0	0
17	24579134	.	A	C	1	0	1	0	7	8	0	0
17	24579158	.	T	C	1	5	6	0	0	6	0	0
17	24579293	.	T	C	1	4	5	0	0	5	0	0
17	24579422	.	G	A	3	5	8	0	0	8	0	0
17	24579518	.	T	C	1	6	7	0	0	7	0	0
17	24579519	.	A	C	1	6	7	0	0	7	0	0
17	24580328	.	A	C	5	0	5	0	3	8	0	0
17	24597770	.	C	T	3	2	5	0	0	5	0	0
17	24597853	.	T	C	2	2	4	0	0	4	0	0
17	24599488	.	C	G	3	3	6	0	0	6	0	0
17	24600150	.	A	C	4	4	8	0	0	8	0	0
17	24600595	.	G	A	1	5	6	0	9	15	0	0
17	24600767	.	G	A	7	3	10	0	0	10	0	0
17	24600976	.	G	A	4	9	13	0	1	14	0	0
17	24601072	.	G	A	0	8	8	0	5	13	0	0
17	24601579	.	T	A	13	5	18	0	0	18	0	0
17	24601924	.	C	T	5	12	17	0	1	18	0	0
17	24604619	.	G	T	0	2	2	0	4	6	0	0
17	24612661	.	G	T	13	6	19	0	0	19	0	0
17	24614468	.	C	T	30	25	55	0	4	59	0	0
17	24615205	.	A	G	8	12	20	0	1	21	0	0
17	24617888	.	C	A	6	21	27	0	2	29	0	0
17	24618912	.	C	T	6	2	8	0	0	8	0	0
17	24618945	.	C	T	7	2	9	0	0	9	0	0
17	24619650	.	A	G	4	3	7	0	0	7	0	0
17	24619693	.	A	G	4	0	4	0	5	9	0	0
17	24622623	.	G	T	9	4	13	0	0	13	0	0
17	24622644	.	G	A	10	7	17	0	0	17	0	0
17	24624477	.	G	C	3	3	6	0	0	6	0	0
17	24626513	.	T	G	2	3	5	0	1	6	0	0
17	24631156	.	C	T	1	3	4	0	0	4	0	0
17	24641085	.	G	A	2	3	5	0	0	5	0	0
17	24652987	.	C	T	6	2	8	0	0	8	0	0
17	24653089	.	C	T	1	2	3	0	0	3	0	0
17	24684823	.	G	A	2	2	4	0	0	4	0	0
17	24684844	.	T	G	7	8	15	0	1	16	0	0
17	24685850	.	C	T	12	10	22	0	5	27	0	0
17	24686352	.	C	T	4	8	12	0	1	13	0	0
17	24686443	.	A	T	3	6	9	0	0	9	0	0
17	24686511	.	G	A	2	5	7	0	0	7	0	0
17	24686574	.	A	G	3	2	5	0	0	5	0	0
17	24686575	.	C	G	3	2	5	0	0	5	0	0
17	24687392	.	C	A	1	2	3	0	1	4	0	0
17	24687602	.	G	C	3	7	10	0	0	10	0	0
17	24687693	.	G	T	1	2	3	0	0	3	0	0
17	24690050	.	G	A	0	3	3	0	3	6	0	0
17	24691987	.	C	T	7	3	10	0	1	11	0	0
17	24692030	.	A	C	10	3	13	0	0	13	0	0
17	24693207	.	T	C	10	8	18	0	0	18	0	0
17	24694145	.	A	G	10	4	14	0	0	14	0	0
17	24694573	.	T	A	3	3	6	0	1	7	0	0
17	24694742	.	C	A	1	2	3	0	0	3	0	0
17	24694877	.	C	G	4	4	8	0	0	8	0	0
17	24695096	.	C	A	4	4	8	2	0	10	0	0
17	24695683	.	T	A	6	5	11	0	3	14	0	0
17	24695743	.	G	A	11	6	17	0	1	18	0	0
17	24695815	.	G	C	6	0	6	0	10	16	0	0
17	24695968	.	G	C	9	9	18	0	0	18	0	0
17	24696047	.	G	T	17	14	31	0	1	32	0	0
17	24696142	.	A	C	4	7	11	0	1	12	0	0
17	24696274	.	T	C	9	4	13	0	0	13	0	0
17	24696658	.	C	A	12	4	16	0	1	17	0	0
17	24696716	.	A	G	10	7	17	0	2	19	0	0
17	24699483	.	G	A	8	15	23	0	0	23	0	0
17	24701274	.	T	C	1	2	3	0	0	3	0	0
17	24701496	.	C	T	2	5	7	0	1	8	0	0
17	24701767	.	T	C	3	7	10	0	2	12	0	0
17	24701793	.	C	G	1	3	4	0	5	9	0	0
17	24702981	.	T	C	5	3	8	0	0	8	0	0
17	24709204	.	C	T	11	10	21	1	1	23	0	0
17	24709292	.	T	C	10	0	10	0	6	16	0	0
17	24709443	.	T	G	7	6	13	0	1	14	0	0
17	24712929	.	C	T	6	6	12	0	0	12	0	0
17	24712985	.	C	T	1	11	12	0	3	15	0	0
17	24715189	.	A	G	10	7	17	0	1	18	0	0
17	24720907	.	T	C	10	8	18	0	0	18	0	0
17	24720964	.	G	C	12	13	25	0	0	25	0	0
17	24721345	.	G	A	8	8	16	0	2	18	0	0
17	24721378	.	C	A	7	6	13	0	0	13	0	0
17	24721384	.	G	A	5	4	9	0	2	11	0	0
17	24721462	.	G	A	0	9	9	0	8	17	0	0
17	24722402	.	C	T	10	4	14	1	0	15	0	0
17	24722441	.	A	G	8	5	13	1	1	15	0	0
17	24725877	.	C	A	14	16	30	0	2	32	0	0
17	24726035	.	A	T	20	13	33	0	1	34	0	0
17	24726134	.	A	G	8	1	9	0	16	25	0	0
17	24726239	.	G	T	10	11	21	0	1	22	0	0
17	24726276	.	A	G	12	8	20	0	1	21	0	0
17	24726533	.	T	A	15	8	23	0	1	25	1	0
17	24726585	.	C	T	12	10	22	0	1	23	0	0
17	24726613	.	G	A	6	10	16	0	1	17	0	0
17	24726637	.	A	G	10	7	17	0	0	17	0	0
17	24726737	.	T	C	14	13	27	0	1	28	0	0
17	24726753	.	G	A	13	11	24	0	0	24	0	0
17	24726996	.	A	G	9	11	20	0	1	21	0	0
17	24727037	.	C	T	8	12	20	0	0	20	0	0
17	24727130	.	T	G	10	0	10	0	7	17	0	0
17	24727186	.	C	G	5	3	8	0	0	8	0	0
17	24727206	.	C	T	6	2	8	0	0	8	0	0
17	24747328	.	A	C	6	2	8	0	0	8	0	0
17	24747412	.	C	T	2	2	4	0	0	4	0	0
17	24757422	.	T	G	3	0	3	0	3	6	0	0
17	24757443	.	G	A	0	5	5	0	1	6	0	0
17	24757572	.	G	C	4	2	6	0	0	6	0	0
17	24757587	.	G	A	1	2	3	0	4	7	0	0
17	24787248	.	G	A	5	2	7	0	0	7	0	0
17	24787736	.	C	A	2	3	5	0	0	5	0	0
17	24787774	.	A	T	2	5	7	0	0	7	0	0
17	24817636	.	A	G	1	3	4	0	1	5	0	0
17	24820044	.	C	T	3	5	8	0	0	8	0	0
17	24820052	.	T	C	4	5	9	0	0	9	0	0
17	24820502	.	G	T	3	3	6	0	0	6	0	0
17	24820559	.	C	T	4	4	8	0	0	8	0	0
17	24820587	.	C	T	2	4	6	0	1	7	0	0
17	24820621	.	G	T	2	6	8	0	1	9	0	0
17	24820683	.	T	A	4	4	8	0	0	8	0	0
17	24821697	.	T	C	5	11	16	0	0	16	0	0
17	24821720	.	G	A	3	5	8	0	1	9	0	0
17	24834743	.	C	T	7	11	18	0	1	19	0	0
17	24835158	.	A	T	13	8	21	0	1	22	0	0
17	24835251	.	G	C	8	10	18	0	0	19	1	0
17	24855813	.	T	C	2	5	7	0	0	7	0	0
17	24855867	.	T	G	8	5	13	0	2	15	0	0
17	24856019	.	G	A	24	15	39	0	2	41	0	0
17	24856088	.	C	G	14	15	29	0	0	29	0	0
17	24856338	.	T	C	12	5	17	0	0	17	0	0
17	24856648	.	G	T	8	10	18	0	0	18	0	0
17	24858939	.	A	C	7	0	7	0	9	16	0	0
17	24861176	.	C	T	0	11	11	0	21	32	0	0
17	24861252	.	G	A	12	11	23	0	0	23	0	0
17	24861558	.	A	G	9	11	20	0	0	20	0	0
17	24863929	.	C	G	10	6	16	0	0	16	0	0
17	24866585	.	G	T	7	5	12	0	1	13	0	0
17	24869963	.	G	A	4	2	6	0	1	7	0	0
17	24872642	.	G	A	8	3	11	0	0	11	0	0
17	24872714	.	T	A	2	7	9	0	0	9	0	0
17	24874858	.	C	T	2	3	5	0	0	5	0	0
17	24880613	.	G	A	3	7	10	0	0	10	0	0
17	24887118	.	T	C	2	7	9	0	0	9	0	0
17	24887419	.	G	A	5	2	7	0	0	7	0	0
17	24926540	.	T	C	3	0	3	0	2	5	0	0
17	24926623	.	G	A	2	2	4	0	1	5	0	0
17	24929215	.	A	T	4	5	9	0	0	9	0	0
17	24932994	.	T	A	5	3	8	0	0	8	0	0
17	24936070	.	T	C	3	3	6	0	0	6	0	0
17	24936154	.	A	T	2	4	6	0	0	6	0	0
17	24936160	.	G	A	3	4	7	0	0	7	0	0
17	24937305	.	A	T	1	2	3	0	0	3	0	0
17	25104984	.	T	A	2	4	6	0	0	6	0	0
17	25125576	.	A	G	1	0	1	0	6	7	0	0
17	25125612	.	T	C	5	2	7	0	0	7	0	0
17	25140974	.	C	T	3	2	5	0	0	5	0	0
17	25155779	.	C	T	3	2	5	0	2	7	0	0
17	25167346	.	G	A	3	4	7	0	0	7	0	0
17	25167454	.	C	A	3	7	10	0	0	10	0	0
17	25167709	.	G	A	3	3	6	0	0	6	0	0
17	25173643	.	A	G	7	0	7	0	8	15	0	0
17	25173803	.	T	C	3	7	10	0	0	10	0	0
17	25173899	.	A	T	5	1	6	0	1	7	0	0
17	25174425	.	G	T	1	4	5	0	0	5	0	0
17	25174688	.	T	C	1	4	5	0	0	5	0	0
17	25175072	.	C	T	5	3	8	0	0	8	0	0
17	25175100	.	T	A	4	5	9	0	0	9	0	0
17	25175134	.	T	C	2	3	5	0	0	5	0	0
17	25175326	.	A	C	2	4	6	0	1	7	0	0
17	25191422	.	C	A	1	2	3	0	0	3	0	0
17	25191706	.	A	C	3	2	5	0	0	5	0	0
17	25191754	.	A	T	1	3	4	0	1	5	0	0
17	25191758	.	A	T	0	4	4	0	2	6	0	0
17	25191901	.	T	C	1	2	3	0	0	3	0	0
17	25191936	.	C	G	2	3	5	0	0	5	0	0
17	25191962	.	T	C	2	2	4	0	0	4	0	0
17	25192133	.	C	T	2	2	4	0	0	4	0	0
17	25192139	.	T	C	0	3	3	0	0	3	0	0
17	25192169	.	A	G	3	0	3	0	4	7	0	0
17	25192202	.	A	T	1	4	5	0	1	6	0	0
17	25254376	.	A	G	1	0	1	0	3	4	0	0
17	25289571	.	C	A	11	5	16	0	1	17	0	0
17	25289889	.	C	T	8	5	13	0	1	14	0	0
17	25289905	.	A	G	8	7	15	0	1	16	0	0
17	25289930	.	A	T	10	4	14	0	1	15	0	0
17	25289955	.	C	T	8	4	12	0	0	12	0	0
17	25290396	.	C	T	3	16	19	0	0	19	0	0
17	25290481	.	G	A	2	7	9	0	11	20	0	0
17	25290657	.	C	T	4	12	16	0	0	16	0	0
17	25291068	.	A	G	13	1	14	0	4	18	0	0
17	25302715	.	C	T	4	4	8	0	0	8	0	0
17	25302891	.	G	A	1	3	4	0	0	4	0	0
17	25302909	.	G	A	4	5	9	0	0	9	0	0
17	25303189	.	C	T	1	3	4	0	4	8	0	0
17	25306107	.	G	A	6	4	10	0	0	10	0	0
17	25311113	.	A	T	2	2	4	0	1	5	0	0
17	25313198	.	A	G	4	7	11	0	0	11	0	0
17	25313378	.	A	G	2	2	4	0	1	5	0	0
17	25329038	.	A	C	2	2	4	0	0	4	0	0
17	25330135	.	T	C	1	4	5	0	0	5	0	0
17	25330181	.	C	T	1	3	4	0	0	4	0	0
17	25336507	.	T	C	2	2	4	0	0	4	0	0
17	25337466	.	C	T	3	5	8	0	0	8	0	0
17	25341745	.	T	A	2	4	6	0	1	7	0	0
17	25341751	.	A	C	2	5	7	0	0	7	0	0
17	25341840	.	G	A	2	2	4	0	0	4	0	0
17	25341844	.	A	C	2	2	4	0	0	4	0	0
17	25341932	.	C	G	2	3	5	0	0	5	0	0
17	25392813	.	C	A	2	3	5	1	0	6	0	0
17	25392917	.	G	A	4	7	11	0	0	11	0	0
17	25393034	.	A	C	6	10	16	0	2	18	0	0
17	25393073	.	C	T	3	6	9	0	3	12	0	0
17	25404868	.	A	G	1	5	6	0	0	6	0	0
17	25412386	.	G	C	2	9	11	0	0	11	0	0
17	25418707	.	T	G	7	7	14	0	0	14	0	0
17	25418727	.	C	A	5	2	7	0	4	11	0	0
17	25420065	.	T	C	2	4	6	0	0	6	0	0
17	25420151	.	A	G	5	3	8	0	0	8	0	0
17	25420937	.	C	T	4	8	12	0	0	12	0	0
17	25424205	.	C	A	10	11	21	0	0	21	0	0
17	25424239	.	C	T	10	6	16	0	2	18	0	0
17	25424330	.	T	A	13	12	25	0	1	26	0	0
17	25424331	.	C	A	13	13	26	0	0	26	0	0
17	25424462	.	G	T	5	5	10	0	0	10	0	0
17	25424568	.	A	G	12	13	25	0	0	25	0	0
17	25424597	.	C	T	11	14	25	0	1	26	0	0
17	25424664	.	G	A	12	11	23	0	1	24	0	0
17	25424770	.	G	A	0	5	5	0	2	7	0	0
17	25424771	.	A	G	1	5	6	0	0	6	0	0
17	25425081	.	G	T	6	8	14	0	0	14	0	0
17	25425094	.	A	G	8	5	13	0	0	13	0	0
17	25425146	.	T	A	15	9	24	0	1	25	0	0
17	25428280	.	A	T	2	2	4	1	0	5	0	0
17	25428842	.	A	C	3	2	5	0	0	5	0	0
17	25428936	.	A	T	2	4	6	0	0	6	0	0
17	25431447	.	C	T	5	2	7	0	0	7	0	0
17	25431492	.	G	A	7	2	9	0	0	9	0	0
17	25431493	.	A	T	6	2	8	0	0	8	0	0
17	25434250	.	G	T	18	22	40	0	4	44	0	0
17	25435992	.	A	G	23	31	54	0	1	55	0	0
17	25436073	.	T	C	33	30	63	0	1	64	0	0
17	25436591	.	A	T	29	25	54	0	1	56	1	0
17	25437384	.	A	G	19	0	19	0	30	49	0	0
17	25439909	.	G	A	31	22	53	0	4	57	0	0
17	25439949	.	C	T	25	25	50	4	3	57	0	0
17	25439950	.	C	A	27	21	48	4	4	57	1	0
17	25444580	.	T	A	4	3	7	0	0	7	0	0
17	25474261	.	C	T	4	3	7	0	0	7	0	0
17	25475601	.	C	T	5	9	14	0	0	14	0	0
17	25478710	.	A	G	4	2	6	0	0	6	0	0
17	25478896	.	C	T	3	2	5	0	0	5	0	0
17	25478897	.	T	G	3	1	4	0	1	5	0	0
17	25479147	.	T	A	4	5	9	0	0	9	0	0
17	25479151	.	A	C	4	5	9	0	0	9	0	0
17	25479200	.	T	C	2	3	5	0	0	5	0	0
17	25479240	.	C	T	2	6	8	0	0	8	0	0
17	25479594	.	T	A	7	10	17	0	1	18	0	0
17	25479640	.	A	G	2	16	18	0	3	21	0	0
17	25479792	.	G	A	15	13	28	0	1	29	0	0
17	25479874	.	T	A	14	4	18	0	0	18	0	0
17	25479920	.	A	G	10	7	17	0	0	17	0	0
17	25479980	.	C	T	9	3	12	0	3	15	0	0
17	25548992	.	G	A	1	1	2	0	0	2	0	0
17	25549372	.	G	T	2	4	6	0	0	6	0	0
17	25549610	.	T	C	2	3	5	0	0	5	0	0
17	25549943	.	A	T	1	2	3	0	0	3	0	0
17	25555209	.	G	A	8	4	12	0	0	12	0	0
17	25558916	.	G	A	9	7	16	0	0	16	0	0
17	25559072	.	G	A	6	2	8	0	1	9	0	0
17	25559162	.	A	T	5	2	7	0	1	8	0	0
17	25559491	.	A	G	7	5	12	0	2	14	0	0
17	25562160	.	A	G	4	3	7	0	0	7	0	0
17	25562198	.	G	T	3	2	5	0	0	5	0	0
17	25563524	.	T	A	6	4	10	0	1	11	0	0
17	25563542	.	G	A	6	4	10	0	1	11	0	0
17	25563843	.	A	T	4	2	6	0	0	6	0	0
17	25564794	.	C	G	2	5	7	0	0	7	0	0
17	25565231	.	A	G	1	2	3	0	0	3	0	0
17	25565267	.	A	G	3	3	6	0	0	6	0	0
17	25565938	.	G	T	4	3	7	0	0	7	0	0
17	25567927	.	G	C	3	2	5	0	0	5	0	0
17	25567936	.	G	T	0	1	1	0	3	4	0	0
17	25585750	.	G	T	5	5	10	0	0	10	0	0
17	25585755	.	A	C	6	5	11	0	0	11	0	0
17	25585926	.	G	A	3	2	5	0	0	5	0	0
17	25590388	.	A	G	3	0	3	0	7	10	0	0
17	25593557	.	G	A	1	5	6	0	0	6	0	0
17	25593566	.	A	G	1	5	6	0	0	6	0	0
17	25593705	.	G	A	0	5	5	0	3	8	0	0
17	25594390	.	C	A	2	2	4	0	0	4	0	0
17	25595674	.	G	A	1	1	2	0	2	4	0	0
17	25595697	.	G	A	2	4	6	0	0	6	0	0
17	25595731	.	T	C	3	3	6	0	0	6	0	0
17	25596801	.	C	T	3	2	5	0	0	5	0	0
17	25600129	.	A	C	5	2	7	0	1	8	0	0
17	25602744	.	C	T	6	5	11	0	1	12	0	0
17	25606154	.	G	A	4	18	22	0	16	38	0	0
17	25606161	.	C	T	18	16	34	0	3	37	0	0
17	25606421	.	T	A	7	12	19	0	1	20	0	0
17	25610895	.	G	T	15	8	23	0	0	23	0	0
17	25610975	.	C	T	4	9	13	0	9	22	0	0
17	25610989	.	C	T	11	5	16	0	1	17	0	0
17	25611011	.	A	G	8	6	14	0	0	14	0	0
17	25611067	.	A	C	8	5	13	0	2	15	0	0
17	25611091	.	C	A	2	7	9	0	11	20	0	0
17	25612941	.	G	C	11	12	23	0	0	23	0	0
17	25612978	.	G	A	12	8	20	0	1	21	0	0
17	25615493	.	A	G	6	9	15	0	1	16	0	0
17	25615894	.	A	G	3	3	6	0	0	6	0	0
17	25616374	.	C	T	2	5	7	0	0	7	0	0
17	25617760	.	G	T	3	5	8	0	0	8	0	0
17	25617950	.	G	T	3	9	12	0	0	12	0	0
17	25617967	.	T	A	4	6	10	0	1	11	0	0
17	25618850	.	G	T	3	5	8	0	0	8	0	0
17	25618961	.	C	A	1	2	3	0	0	3	0	0
17	25636167	.	G	A	28	20	48	0	3	51	0	0
17	25636381	.	C	T	6	25	31	0	41	72	0	0
17	25636412	.	A	G	41	18	59	0	4	63	0	0
17	25636539	.	T	C	31	6	37	0	40	77	0	0
17	25636594	.	C	T	5	43	48	0	26	74	0	0
17	25636679	.	C	T	4	34	38	0	30	68	0	0
17	25637106	.	A	C	35	24	59	0	7	67	1	0
17	25637676	.	T	C	30	1	31	0	30	61	0	0
17	25640476	.	G	A	17	24	41	0	3	44	0	0
17	25851505	.	G	T	1	1	2	0	1	3	0	0
17	25871375	.	G	A	0	3	3	0	1	4	0	0
17	25877526	.	A	G	3	5	8	0	0	8	0	0
17	25877694	.	G	A	0	3	3	0	6	9	0	0
17	25878173	.	A	G	2	5	7	0	0	7	0	0
17	25884610	.	T	C	2	4	6	0	0	6	0	0
17	25884620	.	G	T	2	4	6	0	0	6	0	0
17	25884851	.	T	C	1	2	3	0	0	3	0	0
17	25885103	.	A	G	1	0	1	0	3	4	0	0
17	25885415	.	T	A	6	4	10	0	0	10	0	0
17	25885418	.	C	G	6	4	10	0	0	10	0	0
17	26208866	.	T	C	3	4	7	0	0	7	0	0
17	26298967	.	C	T	5	5	10	0	0	10	0	0
17	26325267	.	C	T	1	4	5	0	1	6	0	0
17	26325282	.	C	T	1	3	4	0	0	4	0	0
17	26335000	.	G	A	6	3	9	0	0	9	0	0
17	26346175	.	T	A	2	7	9	0	0	9	0	0
17	26362130	.	G	A	8	5	13	0	2	15	0	0
17	26362500	.	C	T	4	3	7	0	2	9	0	0
17	26362512	.	A	C	4	5	9	0	1	10	0	0
17	26362539	.	C	T	3	6	9	0	0	9	0	0
17	26362741	.	C	T	8	5	13	0	2	15	0	0
17	26477795	.	A	C	13	8	21	0	2	25	2	0
17	26477857	.	T	C	12	14	26	0	2	28	0	0
17	26477860	.	C	T	13	16	29	0	0	29	0	0
17	26478023	.	T	C	22	3	25	0	1	26	0	0
17	26478403	.	T	G	4	8	12	0	4	16	0	0
17	26478544	.	A	T	6	6	12	0	0	12	0	0
17	26478563	.	C	T	12	11	23	0	0	23	0	0
17	26478592	.	A	G	14	18	32	0	2	34	0	0
17	26478818	.	T	C	9	0	9	0	11	20	0	0
17	26478952	.	G	A	10	14	24	0	1	25	0	0
17	26478986	.	A	G	14	6	20	0	1	21	0	0
17	26479063	.	A	G	14	6	20	0	0	20	0	0
17	26479145	.	T	C	9	15	24	0	1	25	0	0
17	26479916	.	G	T	4	2	6	0	1	7	0	0
17	26479960	.	C	T	4	6	10	0	0	10	0	0
17	26479997	.	A	T	4	4	8	0	0	8	0	0
17	26480250	.	A	C	2	3	5	0	0	5	0	0
17	26480254	.	G	A	2	2	4	0	1	5	0	0
17	26480421	.	A	G	10	4	14	0	0	14	0	0
17	26480423	.	T	C	10	4	14	0	0	14	0	0
17	26480622	.	A	T	9	7	16	0	0	16	0	0
17	26480683	.	A	G	4	8	12	0	0	12	0	0
17	26480926	.	T	G	8	3	11	0	0	11	0	0
17	26502013	.	A	G	4	4	8	0	1	9	0	0
17	26502047	.	A	C	4	0	4	0	4	8	0	0
17	26502107	.	G	A	5	7	12	0	0	12	0	0
17	26516745	.	G	C	4	6	10	0	0	10	0	0
17	26516748	.	G	C	6	4	10	0	0	10	0	0
17	26516878	.	G	A	5	4	9	0	0	9	0	0
17	26517310	.	A	C	2	0	2	0	3	5	0	0
17	26517366	.	G	A	4	5	9	0	1	10	0	0
17	26519364	.	A	G	1	2	3	0	0	3	0	0
17	26519475	.	T	C	2	0	2	0	4	6	0	0
17	26519681	.	C	T	4	5	9	0	0	9	0	0
17	26519823	.	T	C	2	0	2	0	4	6	0	0
17	26577293	.	T	C	0	4	4	0	1	5	0	0
17	26585135	.	G	T	5	6	11	0	0	11	0	0
17	26585163	.	A	T	4	7	11	0	1	12	0	0
17	26585316	.	C	T	5	5	10	0	1	11	0	0
17	26585646	.	C	T	14	6	20	0	0	20	0	0
17	26585727	.	C	T	9	7	16	0	1	17	0	0
17	26585748	.	A	G	10	0	10	0	12	22	0	0
17	26585763	.	T	A	11	18	29	0	0	29	0	0
17	26590001	.	T	G	13	10	23	0	1	24	0	0
17	26590054	.	C	T	11	7	18	0	0	18	0	0
17	26590091	.	C	T	3	8	11	0	1	12	0	0
17	26590170	.	A	T	7	5	12	0	1	13	0	0
17	26590330	.	T	C	12	6	18	0	2	20	0	0
17	26590536	.	G	A	3	2	5	0	0	5	0	0
17	26590650	.	G	T	7	5	12	0	1	14	1	0
17	26594931	.	C	T	8	7	15	0	2	17	0	0
17	26599208	.	C	T	1	7	8	0	5	13	0	0
17	26600555	.	T	A	6	3	9	0	0	9	0	0
17	26600639	.	G	A	8	10	18	0	0	18	0	0
17	26600667	.	C	T	9	7	16	0	0	16	0	0
17	26600785	.	G	A	5	5	10	0	1	11	0	0
17	26600881	.	G	A	6	4	10	0	0	10	0	0
17	26603369	.	A	T	4	4	8	0	0	8	0	0
17	26604572	.	A	G	4	2	6	0	0	6	0	0
17	26604751	.	G	C	8	3	11	0	0	11	0	0
17	26604758	.	C	T	9	4	13	0	0	13	0	0
17	26604801	.	C	A	5	3	8	0	0	8	0	0
17	26604917	.	G	A	2	2	4	0	0	4	0	0
17	26630909	.	C	T	10	3	13	0	0	13	0	0
17	26639659	.	C	T	10	6	16	0	1	17	0	0
17	26639725	.	A	G	5	1	6	0	9	15	0	0
17	26642775	.	C	A	5	7	12	0	1	13	0	0
17	26642817	.	T	G	11	0	11	0	7	18	0	0
17	26642818	.	T	C	10	7	17	0	1	18	0	0
17	26657852	.	T	C	9	14	23	0	1	24	0	0
17	26662347	.	C	T	10	10	20	0	1	21	0	0
17	26683466	.	T	C	19	16	35	1	2	38	0	0
17	26683526	.	C	T	20	16	36	1	1	38	0	0
17	26689753	.	G	A	22	14	36	0	6	42	0	0
17	26689768	.	C	A	21	19	40	0	0	40	0	0
17	26689792	.	C	A	15	15	30	0	3	33	0	0
17	26690112	.	T	A	17	14	31	0	1	33	1	0
17	26690250	.	C	T	10	10	20	0	0	20	0	0
17	26690276	.	C	T	9	10	19	0	2	21	0	0
17	26690478	.	C	T	10	8	18	0	0	18	0	0
17	26690558	.	G	A	0	18	18	0	13	31	0	0
17	26714009	.	C	T	34	28	62	0	5	67	0	0
17	26744174	.	G	A	1	2	3	0	0	3	0	0
17	26744516	.	A	G	1	1	2	0	3	5	0	0
17	26744748	.	T	A	1	4	5	0	1	6	0	0
17	26744981	.	C	T	2	2	4	0	0	4	0	0
17	26747392	.	G	T	3	4	7	0	0	7	0	0
17	26749836	.	G	A	2	3	5	0	1	6	0	0
17	26810380	.	C	T	18	28	46	0	3	49	0	0
17	26831861	.	G	A	3	6	9	0	0	9	0	0
17	26846203	.	C	T	13	6	19	0	0	19	0	0
17	26846650	.	G	A	9	5	14	1	3	18	0	0
17	26846707	.	G	A	0	7	7	0	7	14	0	0
17	26846901	.	T	G	9	9	18	0	0	18	0	0
17	26879854	.	A	C	14	15	29	1	1	31	0	0
17	26879869	.	A	G	16	12	28	1	0	30	1	0
17	26879893	.	A	G	23	20	43	0	2	45	0	0
17	26880107	.	G	A	18	19	37	0	1	38	0	0
17	26880231	.	T	C	32	22	54	0	2	56	0	0
17	26880424	.	T	C	26	27	53	0	3	56	0	0
17	26880714	.	G	T	16	0	16	0	0	16	0	0
17	26880926	.	T	C	16	1	17	0	19	36	0	0
17	26880964	.	A	G	22	22	44	0	3	47	0	0
17	26881131	.	T	A	25	18	43	0	1	44	0	0
17	26881354	.	A	G	22	18	40	1	1	42	0	0
17	26881777	.	A	G	28	17	45	1	0	46	0	0
17	26911747	.	A	G	17	9	26	0	1	27	0	0
17	26924308	.	C	T	0	3	3	0	6	9	0	0
17	26928994	.	C	T	5	4	9	1	0	10	0	0
17	26929475	.	T	C	7	3	10	0	0	10	0	0
17	26929577	.	C	A	11	5	16	0	0	16	0	0
17	26929649	.	A	G	7	6	13	0	0	13	0	0
17	26929654	.	T	A	6	7	13	0	0	13	0	0
17	26929776	.	C	T	2	0	2	0	3	5	0	0
17	26929893	.	G	A	9	3	12	0	0	12	0	0
17	26933223	.	A	G	1	3	4	0	0	4	0	0
17	26933328	.	C	T	2	4	6	0	0	6	0	0
17	26934417	.	C	T	0	2	2	0	4	6	0	0
17	26935160	.	C	T	7	3	10	0	0	10	0	0
17	26935254	.	G	T	5	2	7	0	0	8	1	0
17	26935274	.	G	T	7	5	12	0	0	12	0	0
17	26985158	.	G	A	0	9	9	0	10	19	0	0
17	26985561	.	T	G	7	0	7	0	6	13	0	0
17	26985586	.	C	T	6	8	14	0	2	16	0	0
17	26985638	.	T	G	5	8	13	0	0	13	0	0
17	26985656	.	T	A	6	4	10	0	0	10	0	0
17	26985692	.	G	T	4	3	7	0	0	7	0	0
17	27064523	.	T	A	1	2	3	0	0	3	0	0
17	27064725	.	T	C	5	2	7	0	0	7	0	0
17	27154580	.	C	A	4	4	8	0	0	8	0	0
17	27154695	.	A	G	2	2	4	0	0	4	0	0
17	27158692	.	C	T	3	5	8	0	0	8	0	0
17	27160846	.	C	T	1	7	8	0	0	8	0	0
17	27163266	.	T	C	3	4	7	0	0	7	0	0
17	27164530	.	C	T	5	7	12	0	0	12	0	0
17	27166221	.	T	C	7	6	13	0	0	13	0	0
17	27166257	.	T	C	5	4	9	0	0	9	0	0
17	27166521	.	C	T	6	7	13	0	0	13	0	0
17	27168957	.	G	T	1	11	12	0	7	19	0	0
17	27169783	.	A	C	3	6	9	0	0	9	0	0
17	27170017	.	G	A	3	8	11	0	9	20	0	0
17	27170341	.	G	A	4	4	8	0	1	9	0	0
17	27170390	.	G	T	3	3	6	0	2	8	0	0
17	27170516	.	G	A	0	10	10	0	5	15	0	0
17	27170605	.	T	G	13	4	17	0	1	18	0	0
17	27170678	.	C	A	7	9	16	0	3	19	0	0
17	27170746	.	A	T	8	5	13	0	1	14	0	0
17	27170961	.	T	C	2	2	4	0	0	4	0	0
17	27176640	.	G	A	3	4	7	0	1	8	0	0
17	27176967	.	G	C	2	3	5	0	0	5	0	0
17	27176991	.	C	T	5	6	11	0	0	11	0	0
17	27177745	.	G	A	2	4	6	0	0	6	0	0
17	27177776	.	G	T	2	4	6	0	0	6	0	0
17	27177808	.	G	T	3	2	5	0	0	5	0	0
17	27177864	.	C	T	5	3	8	3	0	11	0	0
17	27178024	.	T	A	3	4	7	0	0	7	0	0
17	27178088	.	T	A	3	2	5	0	0	5	0	0
17	27178191	.	G	A	7	4	11	0	0	11	0	0
17	27178232	.	A	G	2	4	6	0	0	6	0	0
17	27178273	.	G	T	1	2	3	0	0	3	0	0
17	27178296	.	G	A	0	2	2	0	4	6	0	0
17	27178356	.	T	A	4	2	6	0	1	7	0	0
17	27178383	.	C	G	5	5	10	0	0	10	0	0
17	27178401	.	C	T	7	3	10	0	0	10	0	0
17	27178557	.	C	T	6	2	8	0	0	8	0	0
17	27178633	.	A	T	3	1	4	0	0	4	0	0
17	27178638	.	C	G	1	2	3	0	0	3	0	0
17	27178730	.	C	A	4	5	9	0	0	9	0	0
17	27179189	.	A	G	4	3	7	0	0	7	0	0
17	27179434	.	G	T	6	3	9	0	0	9	0	0
17	27179645	.	G	A	2	2	4	0	0	4	0	0
17	27179848	.	A	G	3	3	6	1	0	7	0	0
17	27180100	.	G	A	1	2	3	0	1	4	0	0
17	27180407	.	T	A	3	2	5	0	0	5	0	0
17	27180847	.	A	G	4	5	9	0	0	9	0	0
17	27181021	.	T	C	2	4	6	0	2	8	0	0
17	27181048	.	C	G	4	6	10	0	2	12	0	0
17	27181129	.	G	A	10	9	19	0	1	20	0	0
17	27181130	.	G	A	9	10	19	0	1	20	0	0
17	27181257	.	A	C	15	4	19	0	0	19	0	0
17	27181323	.	A	G	13	1	14	0	12	26	0	0
17	27181411	.	A	G	11	0	11	0	7	18	0	0
17	27181427	.	C	T	12	7	19	0	0	19	0	0
17	27181463	.	A	G	5	0	5	0	5	10	0	0
17	27181481	.	A	G	3	6	9	0	0	9	0	0
17	27181618	.	C	A	1	3	4	0	0	4	0	0
17	27181680	.	C	T	2	4	6	0	0	6	0	0
17	27181829	.	A	G	11	3	14	0	1	15	0	0
17	27182114	.	A	G	8	12	20	0	0	20	0	0
17	27182146	.	C	T	7	8	15	0	1	16	0	0
17	27182331	.	T	G	7	5	12	0	0	12	0	0
17	27182340	.	C	T	6	4	10	0	0	10	0	0
17	27182449	.	G	T	7	10	17	0	1	18	0	0
17	27182484	.	T	C	10	12	22	0	1	23	0	0
17	27182645	.	G	T	11	9	20	0	0	20	0	0
17	27182649	.	A	G	11	10	21	0	0	21	0	0
17	27182769	.	A	G	6	6	12	0	1	13	0	0
17	27182894	.	T	C	10	11	21	0	3	24	0	0
17	27182925	.	A	T	8	10	18	0	1	19	0	0
17	27182979	.	C	T	6	6	12	0	0	12	0	0
17	27191528	.	C	T	4	3	7	0	0	7	0	0
17	27192756	.	G	C	2	3	5	0	0	5	0	0
17	27194087	.	G	A	1	2	3	0	0	3	0	0
17	27272913	.	T	C	4	12	16	0	1	17	0	0
17	27273013	.	C	T	14	9	23	0	0	23	0	0
17	27401038	.	A	T	11	4	15	0	6	21	0	0
17	27408386	.	A	G	12	10	22	0	0	22	0	0
17	27408472	.	C	T	10	14	24	0	3	27	0	0
17	27408523	.	G	T	5	5	10	0	2	12	0	0
17	27408531	.	T	A	3	4	7	0	2	9	0	0
17	27408836	.	T	G	8	15	23	0	0	23	0	0
17	27408889	.	T	C	5	15	20	1	0	21	0	0
17	27413564	.	T	C	13	20	33	0	1	34	0	0
17	27413705	.	T	C	12	11	23	0	0	23	0	0
17	27414035	.	G	A	5	8	13	0	1	14	0	0
17	27414098	.	C	A	5	10	15	0	0	15	0	0
17	27414203	.	G	A	4	13	17	0	2	19	0	0
17	27414215	.	C	T	0	10	10	0	6	16	0	0
17	27414367	.	A	G	7	11	18	0	0	18	0	0
17	27414658	.	T	C	7	7	14	0	0	14	0	0
17	27414701	.	A	G	6	5	11	0	1	12	0	0
17	27414791	.	A	G	3	5	8	0	0	8	0	0
17	27414815	.	G	A	4	8	12	0	0	12	0	0
17	27415010	.	C	T	0	7	7	0	4	11	0	0
17	27706643	.	A	G	1	0	1	0	2	3	0	0
17	27723800	.	G	T	8	8	16	0	3	19	0	0
17	27807455	.	T	C	19	16	35	0	0	35	0	0
17	27808190	.	A	G	11	0	11	0	13	24	0	0
17	27808335	.	A	G	14	12	26	0	1	27	0	0
17	27808686	.	G	A	5	9	14	0	0	14	0	0
17	27808700	.	G	A	9	9	18	0	0	18	0	0
17	27808987	.	G	T	2	11	13	0	33	46	0	0
17	27809548	.	T	A	19	10	29	0	2	31	0	0
17	27809631	.	G	T	4	4	8	0	15	23	0	0
17	27809779	.	C	A	26	20	46	0	1	47	0	0
17	27809885	.	A	G	24	11	35	0	1	36	0	0
17	27811254	.	T	C	6	2	8	0	1	9	0	0
17	27811277	.	C	G	8	3	11	0	0	11	0	0
17	27812562	.	G	A	1	6	7	0	22	29	0	0
17	27812702	.	A	T	15	6	21	0	1	22	0	0
17	27812789	.	A	G	1	1	2	0	2	4	0	0
17	27813221	.	C	T	12	8	20	0	0	20	0	0
17	27813222	.	A	G	12	8	20	0	0	20	0	0
17	27813549	.	C	G	7	4	11	0	1	12	0	0
17	27813553	.	C	G	6	5	11	0	2	13	0	0
17	28049663	.	A	T	1	3	4	0	1	5	0	0
17	28050530	.	A	G	1	5	6	0	1	7	0	0
17	28051073	.	C	T	2	4	6	0	0	6	0	0
17	28051247	.	T	A	1	2	3	0	2	5	0	0
17	28051465	.	T	C	3	5	8	0	0	8	0	0
17	28051504	.	G	T	2	9	11	0	0	11	0	0
17	28051605	.	A	G	1	2	3	0	0	3	0	0
17	28051739	.	A	G	5	8	13	0	2	15	0	0
17	28052322	.	C	A	9	7	16	0	1	17	0	0
17	28067389	.	C	T	7	9	16	0	3	19	0	0
17	28067472	.	A	C	8	11	19	0	4	23	0	0
17	28067618	.	A	G	5	5	10	0	0	10	0	0
17	28067856	.	C	T	7	9	16	0	0	16	0	0
17	28068083	.	T	C	9	5	14	0	0	14	0	0
17	28068087	.	G	T	8	5	13	0	1	15	1	0
17	28068168	.	G	A	8	6	14	0	0	14	0	0
17	28068262	.	T	G	5	0	5	0	8	13	0	0
17	28068276	.	C	T	3	7	10	0	0	10	0	0
17	28068507	.	A	G	9	7	16	0	0	16	0	0
17	28068514	.	T	C	7	8	15	0	1	16	0	0
17	28068832	.	T	A	4	4	8	0	0	8	0	0
17	28068916	.	C	T	8	6	14	0	0	14	0	0
17	28069170	.	G	A	9	17	26	0	2	28	0	0
17	28069341	.	G	T	7	10	17	0	0	17	0	0
17	28069342	.	T	C	7	10	17	0	0	17	0	0
17	28069645	.	G	T	16	17	33	0	0	33	0	0
17	28069716	.	G	C	22	18	40	0	2	42	0	0
17	28069787	.	G	A	2	16	18	0	14	32	0	0
17	28070078	.	G	C	12	14	26	0	1	27	0	0
17	28070167	.	C	T	14	15	29	0	2	31	0	0
17	28070284	.	G	A	5	11	16	0	0	16	0	0
17	28070286	.	A	C	4	11	15	0	1	16	0	0
17	28070481	.	T	A	20	13	33	0	0	33	0	0
17	28070600	.	C	A	12	16	28	0	4	32	0	0
17	28070840	.	G	A	8	10	18	0	0	18	0	0
17	28070879	.	T	G	9	8	17	0	2	19	0	0
17	28070897	.	T	A	11	6	17	0	1	18	0	0
17	28071194	.	C	T	9	2	11	0	2	13	0	0
17	28071260	.	A	G	11	13	24	0	0	24	0	0
17	28084592	.	C	T	6	5	11	0	2	13	0	0
17	28084639	.	T	C	6	4	10	0	1	11	0	0
17	28084733	.	T	C	17	21	38	4	2	44	0	0
17	28084869	.	A	C	17	21	38	0	2	40	0	0
17	28084996	.	A	T	20	21	41	0	1	42	0	0
17	28097235	.	G	A	11	4	15	0	0	15	0	0
17	28097672	.	T	C	7	10	17	0	2	19	0	0
17	28100598	.	C	T	1	6	7	0	15	22	0	0
17	28166980	.	C	T	2	5	7	0	0	7	0	0
17	28167235	.	T	C	6	0	6	0	7	13	0	0
17	28167439	.	G	A	8	6	14	0	0	14	0	0
17	28168054	.	A	G	6	4	10	0	0	10	0	0
17	28168363	.	G	A	6	3	9	0	0	9	0	0
17	28168366	.	G	A	4	3	7	0	0	7	0	0
17	28340294	.	C	T	1	3	4	0	0	4	0	0
17	28340295	.	C	T	1	3	4	0	0	4	0	0
17	28423770	.	C	T	2	4	6	0	0	6	0	0
17	28461857	.	G	A	1	2	3	0	5	8	0	0
17	28466273	.	C	T	4	2	6	0	0	6	0	0
17	28497878	.	T	C	6	6	12	0	1	13	0	0
17	28560736	.	T	C	10	11	21	0	0	21	0	0
17	28563725	.	G	A	8	13	21	0	0	21	0	0
17	28628362	.	C	G	1	1	2	0	1	3	0	0
17	28640361	.	T	G	1	2	3	0	0	3	0	0
17	28640690	.	G	T	1	3	4	0	0	4	0	0
17	28643635	.	C	T	2	3	5	0	0	5	0	0
17	28657421	.	G	T	1	6	7	0	0	8	1	0
17	28661628	.	C	G	7	0	7	0	3	10	0	0
17	28661931	.	G	T	1	4	5	0	1	6	0	0
17	28666381	.	C	T	2	5	7	0	0	7	0	0
17	28668465	.	T	C	7	4	11	0	1	12	0	0
17	28668627	.	C	T	2	6	8	0	0	8	0	0
17	28680051	.	C	T	4	3	7	0	0	7	0	0
17	28695753	.	C	T	11	10	21	0	0	21	0	0
17	28701100	.	G	A	11	12	23	0	0	23	0	0
17	28707268	.	T	A	8	11	19	0	1	20	0	0
17	28724530	.	A	G	4	0	4	0	7	11	0	0
17	28724539	.	A	T	3	6	9	0	2	11	0	0
17	28724833	.	T	C	6	12	18	0	0	18	0	0
17	28725346	.	A	G	8	0	8	0	5	13	0	0
17	28730705	.	C	T	8	8	16	0	0	16	0	0
17	28738387	.	C	T	5	2	7	0	1	8	0	0
17	28738675	.	A	G	7	0	7	0	5	12	0	0
17	28741442	.	G	A	8	6	14	0	2	16	0	0
17	28741467	.	G	A	0	6	6	0	12	18	0	0
17	28741540	.	A	G	12	1	13	0	10	24	1	0
17	28741752	.	C	T	17	7	24	0	1	25	0	0
17	28741934	.	C	T	5	8	13	0	1	14	0	0
17	28742263	.	G	C	12	14	26	0	0	26	0	0
17	28742385	.	T	A	9	9	18	0	1	19	0	0
17	28742505	.	T	G	20	10	30	0	4	34	0	0
17	28742559	.	C	T	17	17	34	0	0	34	0	0
17	28742681	.	C	T	8	11	19	0	0	19	0	0
17	28742755	.	C	A	3	3	6	0	2	8	0	0
17	28771228	.	T	A	10	8	18	0	1	19	0	0
17	28778186	.	C	T	6	8	14	0	1	15	0	0
17	28784090	.	G	T	8	5	13	0	1	14	0	0
17	28785010	.	G	A	8	9	17	0	0	17	0	0
17	28786873	.	G	A	8	7	15	0	0	15	0	0
17	28789014	.	C	T	0	7	7	0	10	17	0	0
17	28948905	.	G	A	3	3	6	0	0	6	0	0
17	28968461	.	T	C	18	17	35	0	2	37	0	0
17	29117355	.	G	A	4	3	7	0	0	7	0	0
17	29228222	.	A	G	1	2	3	0	0	3	0	0
17	29228351	.	T	C	3	0	3	0	2	5	0	0
17	29251810	.	G	C	8	8	16	0	0	16	0	0
17	29252043	.	C	T	4	3	7	0	1	8	0	0
17	29252122	.	C	A	4	11	15	0	1	16	0	0
17	29252218	.	C	T	6	7	13	0	1	14	0	0
17	29252254	.	C	T	9	8	17	0	0	17	0	0
17	29252295	.	T	C	5	8	13	0	1	14	0	0
17	29252308	.	T	G	4	6	10	0	0	10	0	0
17	29252352	.	C	T	3	3	6	0	1	7	0	0
17	29252665	.	G	C	5	3	8	0	0	8	0	0
17	29270021	.	C	T	5	4	9	0	0	9	0	0
17	29270939	.	C	T	0	2	2	0	1	3	0	0
17	29283126	.	T	A	1	2	3	0	2	5	0	0
17	29283688	.	G	C	4	3	7	0	0	7	0	0
17	29283723	.	A	T	5	4	9	1	0	10	0	0
17	29283902	.	G	A	3	10	13	0	1	14	0	0
17	29283920	.	A	C	4	0	4	0	9	13	0	0
17	29283943	.	A	G	6	12	18	0	0	18	0	0
17	29283962	.	A	G	8	9	17	0	1	18	0	0
17	29288057	.	G	T	3	3	6	0	0	6	0	0
17	29288718	.	A	G	5	10	15	0	0	15	0	0
17	29297901	.	A	G	3	3	6	0	0	6	0	0
17	29297907	.	C	A	0	3	3	0	3	6	0	0
17	29300641	.	A	T	3	2	5	0	2	7	0	0
17	29300650	.	A	G	3	3	6	0	0	6	0	0
17	29301058	.	G	C	2	4	6	0	0	6	0	0
17	29308706	.	G	A	2	4	6	0	0	6	0	0
17	29334520	.	T	A	13	7	20	0	1	21	0	0
17	29335645	.	G	A	7	5	12	0	3	15	0	0
17	29339149	.	T	G	14	15	29	0	1	30	0	0
17	29341079	.	C	T	14	5	19	0	1	20	0	0
17	29341118	.	C	T	8	16	24	0	2	26	0	0
17	29341597	.	T	C	15	17	32	0	0	32	0	0
17	29342904	.	G	A	2	9	11	0	10	21	0	0
17	29342947	.	C	T	11	12	23	0	0	23	0	0
17	29343143	.	T	C	9	17	26	0	1	27	0	0
17	29343153	.	G	A	8	16	24	0	1	25	0	0
17	29343358	.	A	G	11	12	23	0	4	27	0	0
17	29343494	.	A	G	9	7	16	0	0	16	0	0
17	29345725	.	T	G	4	2	6	0	0	6	0	0
17	29349739	.	G	A	2	4	6	0	3	9	0	0
17	29364518	.	G	A	2	8	10	0	0	10	0	0
17	29364713	.	C	T	1	2	3	0	0	3	0	0
17	29367320	.	T	C	5	9	14	0	1	15	0	0
17	29369029	.	C	T	2	7	9	1	0	10	0	0
17	29369072	.	T	C	3	6	9	1	1	11	0	0
17	29369114	.	T	C	5	3	8	0	2	10	0	0
17	29369213	.	T	G	5	7	12	0	1	13	0	0
17	29369414	.	G	A	4	4	8	0	0	8	0	0
17	29369612	.	A	G	10	6	16	0	3	19	0	0
17	29369713	.	A	C	9	5	14	0	2	16	0	0
17	29369748	.	C	T	6	11	17	0	1	18	0	0
17	29369780	.	C	A	8	5	13	0	1	14	0	0
17	29369831	.	A	T	4	2	6	0	0	6	0	0
17	29798098	.	A	G	9	9	18	0	0	18	0	0
17	29798312	.	C	A	2	16	18	0	10	28	0	0
17	29804291	.	G	C	6	8	14	0	0	14	0	0
17	29841590	.	A	T	4	9	13	0	4	17	0	0
17	29877079	.	C	T	0	4	4	0	3	7	0	0
17	29877094	.	A	G	3	7	10	0	0	10	0	0
17	30414430	.	C	T	3	2	5	0	0	5	0	0
17	30416997	.	T	C	3	2	5	0	0	5	0	0
17	30458569	.	C	T	1	2	3	0	0	3	0	0
17	30459602	.	C	A	2	6	8	0	0	8	0	0
17	30460216	.	T	C	3	7	10	0	1	11	0	0
17	30460217	.	G	C	3	7	10	0	1	11	0	0
17	30464806	.	A	T	9	4	13	0	2	15	0	0
17	30465779	.	T	A	2	3	5	0	1	6	0	0
17	30466186	.	G	A	3	3	6	0	1	7	0	0
17	30466395	.	T	C	3	4	7	0	0	7	0	0
17	30468428	.	C	T	13	8	21	0	1	22	0	0
17	30468730	.	G	T	3	5	8	0	0	8	0	0
17	30468889	.	T	G	3	0	3	0	2	5	0	0
17	30469200	.	C	A	4	4	8	0	0	8	0	0
17	30469350	.	A	T	6	2	8	0	0	8	0	0
17	30469364	.	T	C	2	6	8	0	0	8	0	0
17	30470034	.	C	T	3	1	4	0	1	5	0	0
17	30474161	.	A	G	4	3	7	0	0	7	0	0
17	30476939	.	C	A	2	3	5	0	8	13	0	0
17	30476978	.	A	G	5	7	12	0	0	12	0	0
17	30478808	.	A	G	5	8	13	0	1	14	0	0
17	30478897	.	G	A	4	6	10	0	0	10	0	0
17	30478943	.	A	G	5	5	10	0	0	10	0	0
17	30479161	.	A	G	6	5	11	0	0	11	0	0
17	30479359	.	T	C	4	4	8	0	0	8	0	0
17	30479647	.	T	C	3	3	6	0	0	6	0	0
17	30486671	.	T	C	3	0	3	0	8	11	0	0
17	30486971	.	G	A	6	3	9	0	0	9	0	0
17	30487040	.	G	A	4	3	7	0	0	7	0	0
17	30487094	.	G	C	6	3	9	0	0	9	0	0
17	30492088	.	C	T	4	4	8	0	0	8	0	0
17	30492999	.	A	C	5	0	5	0	4	9	0	0
17	30493478	.	T	G	5	2	7	0	0	7	0	0
17	30493500	.	C	T	4	2	6	0	1	7	0	0
17	30493770	.	T	C	1	0	1	0	4	5	0	0
17	30494073	.	T	G	3	7	10	0	0	10	0	0
17	30497848	.	G	C	1	2	3	0	0	3	0	0
17	30498084	.	C	T	4	6	10	0	0	10	0	0
17	30506896	.	A	G	2	2	4	0	0	4	0	0
17	30506899	.	G	A	2	2	4	0	0	4	0	0
17	30584841	.	A	G	1	2	3	0	0	3	0	0
17	30585604	.	C	T	2	5	7	0	0	7	0	0
17	30586485	.	C	T	5	6	11	0	0	11	0	0
17	30586521	.	A	G	7	0	7	0	7	14	0	0
17	30587324	.	T	G	4	0	4	0	2	6	0	0
17	30587325	.	A	G	4	2	6	0	0	6	0	0
17	30589166	.	T	C	1	3	4	0	1	5	0	0
17	30589379	.	A	G	5	3	8	0	0	8	0	0
17	30589623	.	T	A	6	2	8	0	0	8	0	0
17	30590020	.	A	G	9	4	13	0	1	14	0	0
17	30590271	.	G	T	10	10	20	0	1	21	0	0
17	30590273	.	C	G	9	9	18	0	3	21	0	0
17	30590325	.	C	T	7	14	21	0	0	21	0	0
17	30590367	.	G	A	5	7	12	0	0	12	0	0
17	30590838	.	T	C	7	10	17	0	0	17	0	0
17	30590842	.	C	A	7	11	18	0	0	18	0	0
17	30749304	.	C	A	1	4	5	0	0	5	0	0
17	30784396	.	A	G	1	0	1	0	3	4	0	0
17	30784400	.	C	T	1	3	4	0	0	4	0	0
17	30816937	.	T	C	1	4	5	0	0	5	0	0
17	30817119	.	T	A	1	3	4	0	0	4	0	0
17	30817170	.	A	G	0	2	2	0	1	3	0	0
17	30853988	.	T	C	1	2	3	0	0	3	0	0
17	30853989	.	C	T	1	2	3	0	0	3	0	0
17	30855477	.	T	C	1	2	3	0	0	3	0	0
17	30857288	.	A	G	16	16	32	0	1	33	0	0
17	30857431	.	A	T	9	4	13	1	1	15	0	0
17	30857433	.	A	T	10	4	14	1	0	15	0	0
17	30858809	.	C	T	3	9	12	0	22	34	0	0
17	30860630	.	G	T	15	14	29	0	0	29	0	0
17	30862909	.	A	G	11	9	20	0	2	22	0	0
17	30906570	.	A	C	2	0	2	1	14	17	0	0
17	30912562	.	C	A	9	13	22	0	3	25	0	0
17	30936802	.	C	T	0	5	5	0	12	17	0	0
17	30979170	.	T	C	5	12	17	0	1	18	0	0
17	30979208	.	T	C	6	9	15	0	4	19	0	0
17	30979339	.	T	C	7	9	16	0	0	16	0	0
17	30979391	.	T	C	15	0	15	0	17	32	0	0
17	30979518	.	G	A	13	9	22	0	2	24	0	0
17	30980336	.	A	G	10	10	20	0	3	23	0	0
17	30986665	.	T	C	13	10	23	0	2	25	0	0
17	30986712	.	G	T	9	11	20	0	0	20	0	0
17	30992178	.	T	C	6	5	11	0	0	11	0	0
17	30995008	.	G	A	7	5	12	0	0	12	0	0
17	31014189	.	G	A	5	6	11	0	0	11	0	0
17	31014192	.	T	C	5	6	11	0	0	11	0	0
17	31021588	.	A	G	5	6	11	0	1	12	0	0
17	31058673	.	T	A	4	3	7	0	0	7	0	0
17	31058807	.	C	A	4	4	8	0	0	8	0	0
17	31195800	.	G	T	0	2	2	0	5	7	0	0
17	31195824	.	T	C	6	3	9	0	0	9	0	0
17	31198945	.	C	T	5	7	12	0	0	12	0	0
17	31199717	.	G	A	0	5	5	0	5	10	0	0
17	31200222	.	T	C	10	4	14	0	1	15	0	0
17	31200247	.	C	A	6	5	11	0	0	11	0	0
17	31200394	.	G	C	5	6	11	0	0	11	0	0
17	31200475	.	A	T	6	6	12	0	0	12	0	0
17	31200481	.	C	T	8	6	14	0	0	14	0	0
17	31200621	.	C	T	4	3	7	0	0	7	0	0
17	31201207	.	C	T	8	3	11	0	0	11	0	0
17	31201348	.	A	G	10	0	10	0	6	16	0	0
17	31201523	.	A	T	13	10	23	0	0	23	0	0
17	31201894	.	A	C	8	14	22	0	0	22	0	0
17	31201954	.	A	G	11	16	27	0	0	27	0	0
17	31205217	.	A	G	6	2	8	0	0	8	0	0
17	31205360	.	G	A	3	6	9	0	0	9	0	0
17	31205375	.	T	A	3	5	8	0	1	9	0	0
17	31205579	.	G	A	7	3	10	0	0	10	0	0
17	31205600	.	T	C	4	0	4	0	3	7	0	0
17	31205614	.	G	A	4	3	7	0	0	7	0	0
17	31205727	.	G	A	5	4	9	0	2	11	0	0
17	31205865	.	G	A	4	2	6	0	0	6	0	0
17	31212357	.	T	C	3	0	3	0	2	5	0	0
17	31214459	.	A	T	4	6	10	0	2	12	0	0
17	31214665	.	G	C	10	1	11	0	12	23	0	0
17	31217113	.	T	A	10	8	18	0	1	19	0	0
17	31219140	.	C	T	0	5	5	0	6	11	0	0
17	31219208	.	T	C	9	0	9	0	5	14	0	0
17	31222505	.	A	T	12	17	29	0	3	32	0	0
17	31228767	.	G	C	17	15	32	0	0	32	0	0
17	31228801	.	C	T	11	13	24	0	0	24	0	0
17	31228837	.	G	A	2	13	15	0	8	23	0	0
17	31228900	.	T	C	6	6	12	0	0	12	0	0
17	31277169	.	A	T	10	9	19	0	0	20	1	0
17	31277443	.	A	G	19	14	33	0	1	34	0	0
17	31277758	.	A	T	4	7	11	0	1	12	0	0
17	31277820	.	C	A	11	6	17	0	1	18	0	0
17	31277855	.	G	A	13	9	22	0	1	23	0	0
17	31277987	.	T	C	14	1	15	0	10	25	0	0
17	31278022	.	G	A	10	11	21	0	1	22	0	0
17	31278433	.	C	A	21	13	34	0	1	35	0	0
17	31283510	.	C	G	0	11	11	0	9	20	0	0
17	31286221	.	G	A	6	7	13	0	0	13	0	0
17	31297284	.	G	A	9	8	17	0	0	17	0	0
17	31297746	.	C	T	1	4	5	0	4	9	0	0
17	31297768	.	G	T	4	3	7	0	1	8	0	0
17	31297791	.	C	T	5	5	10	0	2	12	0	0
17	31298042	.	A	C	7	8	15	0	0	15	0	0
17	31298055	.	T	C	9	7	16	0	0	16	0	0
17	31307837	.	A	G	1	2	3	0	0	3	0	0
17	31307882	.	T	C	2	3	5	0	0	5	0	0
17	31346575	.	A	G	1	1	2	0	1	3	0	0
17	31346582	.	T	C	2	2	4	0	0	4	0	0
17	31346653	.	C	T	4	8	12	0	0	12	0	0
17	31346695	.	A	G	5	12	17	0	2	19	0	0
17	31346712	.	G	A	6	12	18	0	1	19	0	0
17	31346840	.	A	G	15	12	27	0	1	28	0	0
17	31347029	.	T	A	17	14	31	0	3	34	0	0
17	31347046	.	T	G	19	17	36	0	2	38	0	0
17	31347193	.	A	C	21	18	39	0	1	40	0	0
17	31347254	.	A	G	15	14	29	0	1	30	0	0
17	31347344	.	C	G	9	11	20	0	1	21	0	0
17	31355841	.	C	T	7	7	14	0	1	15	0	0
17	31357531	.	C	T	9	5	14	0	0	14	0	0
17	31360631	.	T	C	7	8	15	0	1	16	0	0
17	31360763	.	G	A	6	4	10	0	0	10	0	0
17	31360786	.	G	A	10	4	14	0	0	14	0	0
17	31360804	.	C	T	12	8	20	0	0	20	0	0
17	31360854	.	G	A	7	10	17	0	0	17	0	0
17	31376521	.	T	C	1	2	3	0	0	3	0	0
17	31376532	.	C	T	1	2	3	0	0	3	0	0
17	31385102	.	A	T	2	3	5	0	0	5	0	0
17	31385111	.	G	T	0	3	3	0	2	5	0	0
17	31392984	.	C	T	1	2	3	0	1	4	0	0
17	31393786	.	T	C	1	4	5	0	0	5	0	0
17	31393845	.	A	G	1	1	2	0	3	5	0	0
17	31393855	.	T	A	1	3	4	0	0	4	0	0
17	31394023	.	T	C	1	2	3	0	0	3	0	0
17	31545911	.	C	G	1	2	3	0	0	3	0	0
17	31545935	.	A	G	2	2	4	0	0	4	0	0
17	31545971	.	C	A	0	2	2	0	2	4	0	0
17	31546169	.	G	A	6	5	11	0	0	11	0	0
17	31587839	.	G	T	0	2	2	0	1	3	0	0
17	31587857	.	T	G	1	0	1	0	2	3	0	0
17	31591104	.	G	T	0	2	2	0	2	4	0	0
17	31611601	.	T	C	2	0	2	0	3	5	0	0
17	31611632	.	C	T	0	3	3	0	2	5	0	0
17	31611922	.	T	A	4	5	9	0	0	9	0	0
17	31611947	.	T	C	6	7	13	0	0	13	0	0
17	31612019	.	A	G	9	3	12	0	0	12	0	0
17	31612027	.	A	G	7	0	7	0	3	10	0	0
17	31616799	.	T	C	8	11	19	0	1	20	0	0
17	31618624	.	C	T	13	12	25	0	1	26	0	0
17	31618636	.	T	C	16	13	29	0	0	29	0	0
17	31618953	.	T	C	23	9	32	0	1	33	0	0
17	31618962	.	A	G	26	8	34	0	1	35	0	0
17	31621894	.	C	T	6	6	12	0	1	13	0	0
17	31621921	.	C	A	7	6	13	0	0	13	0	0
17	31622024	.	C	A	6	7	13	0	1	14	0	0
17	31622083	.	A	C	9	9	18	0	1	19	0	0
17	31622123	.	C	A	9	9	18	0	4	22	0	0
17	31622233	.	T	A	12	5	17	0	0	17	0	0
17	31622367	.	A	G	10	9	19	0	2	21	0	0
17	31622662	.	C	T	6	4	10	0	0	10	0	0
17	31622690	.	A	C	1	3	4	0	1	5	0	0
17	31622995	.	G	A	1	2	3	0	0	3	0	0
17	31623588	.	A	G	4	6	10	0	0	10	0	0
17	31623635	.	C	T	8	8	16	0	0	16	0	0
17	31623646	.	A	G	8	8	16	0	1	17	0	0
17	31623829	.	G	C	21	8	29	0	0	29	0	0
17	31624119	.	A	T	8	4	12	0	2	14	0	0
17	31624604	.	A	G	9	9	18	0	1	19	0	0
17	31624652	.	C	T	0	12	12	0	8	21	1	0
17	31624682	.	A	G	9	13	22	0	0	22	0	0
17	31624716	.	T	A	9	16	25	0	0	25	0	0
17	31628812	.	C	A	0	5	5	0	13	18	0	0
17	31628953	.	G	T	10	13	23	0	0	23	0	0
17	31632288	.	T	C	5	5	10	0	1	11	0	0
17	31632330	.	A	G	11	4	15	0	0	15	0	0
17	31632751	.	C	T	7	5	12	0	2	14	0	0
17	31633027	.	A	G	7	9	16	0	1	17	0	0
17	31633186	.	C	T	12	14	26	0	0	26	0	0
17	31639014	.	C	T	0	3	3	0	8	11	0	0
17	31639721	.	T	C	5	6	11	0	0	11	0	0
17	31653218	.	A	G	1	1	2	0	1	3	0	0
17	31653421	.	C	T	3	2	5	0	0	5	0	0
17	31697102	.	C	G	1	3	4	0	0	4	0	0
17	31697126	.	G	T	1	3	4	0	0	4	0	0
17	31697158	.	A	G	2	2	4	0	0	4	0	0
17	31699881	.	G	T	1	2	3	0	0	3	0	0
17	31699931	.	A	G	1	2	3	0	1	4	0	0
17	31700087	.	T	C	3	3	6	0	0	6	0	0
17	31704999	.	G	A	4	4	8	0	2	10	0	0
17	31721451	.	G	A	1	7	8	0	7	15	0	0
17	31739475	.	C	T	7	5	12	0	0	12	0	0
17	31744553	.	G	A	1	6	7	0	7	14	0	0
17	31744849	.	C	T	6	4	10	0	0	10	0	0
17	31745597	.	C	A	4	5	9	0	2	11	0	0
17	31746341	.	T	A	11	9	20	1	3	24	0	0
17	31746553	.	T	C	14	9	23	0	0	23	0	0
17	31746833	.	G	A	12	9	21	0	4	25	0	0
17	31796240	.	C	T	17	8	25	0	1	26	0	0
17	31796481	.	T	G	15	11	26	0	0	26	0	0
17	31796576	.	G	A	12	7	19	0	0	19	0	0
17	31796821	.	T	A	4	5	9	0	0	9	0	0
17	31806005	.	T	A	2	2	4	0	0	4	0	0
17	31806207	.	A	T	3	3	6	0	0	6	0	0
17	31806710	.	T	C	2	4	6	0	1	7	0	0
17	31806994	.	T	A	3	3	6	0	2	8	0	0
17	31807063	.	G	A	2	9	11	0	0	11	0	0
17	31816422	.	T	C	1	2	3	0	0	3	0	0
17	31820605	.	T	C	5	7	12	0	1	13	0	0
17	31935226	.	C	T	2	2	4	0	0	4	0	0
17	31935600	.	T	C	3	2	5	0	0	5	0	0
17	31935889	.	A	G	2	3	5	0	1	6	0	0
17	32333834	.	A	G	1	2	3	0	0	3	0	0
17	32366387	.	A	G	3	4	7	0	0	7	0	0
17	32367193	.	A	G	3	4	7	0	0	7	0	0
17	32367238	.	A	C	2	4	6	0	0	6	0	0
17	32500495	.	G	A	23	18	41	0	3	44	0	0
17	32503110	.	G	A	2	30	32	1	29	62	0	0
17	32516973	.	T	C	31	25	56	0	3	59	0	0
17	32524654	.	C	T	29	27	56	1	0	57	0	0
17	32524695	.	A	G	43	14	57	1	2	60	0	0
17	32524851	.	T	G	32	37	69	1	3	73	0	0
17	32532015	.	C	A	3	4	7	0	0	7	0	0
17	32532056	.	A	G	3	3	6	0	0	6	0	0
17	32532062	.	A	C	2	2	4	0	0	4	0	0
17	32535870	.	C	A	2	4	6	0	0	6	0	0
17	32535977	.	T	C	6	3	9	0	0	9	0	0
17	32536067	.	G	C	3	5	8	0	1	9	0	0
17	32536401	.	C	T	2	3	5	0	0	5	0	0
17	32538608	.	A	G	5	0	5	0	3	8	0	0
17	32538638	.	A	G	5	4	9	0	0	9	0	0
17	32542518	.	A	C	2	4	6	0	0	6	0	0
17	32542884	.	C	T	3	5	8	0	0	8	0	0
17	32547618	.	C	G	2	4	6	0	0	6	0	0
17	32549725	.	C	G	3	7	10	0	0	10	0	0
17	32551164	.	G	T	1	3	4	0	0	4	0	0
17	32551176	.	T	C	1	3	4	0	1	5	0	0
17	32606523	.	A	G	3	2	5	0	1	6	0	0
17	32606572	.	A	C	2	2	4	0	1	5	0	0
17	32607414	.	A	G	1	2	3	0	1	4	0	0
17	32607443	.	A	T	1	3	4	0	0	4	0	0
17	32608019	.	C	A	3	2	5	0	0	5	0	0
17	32608127	.	A	T	1	2	3	0	0	3	0	0
17	32612329	.	G	A	2	6	8	0	0	8	0	0
17	32623004	.	T	G	17	0	17	0	9	26	0	0
17	32623009	.	T	G	14	8	22	0	3	25	0	0
17	32624451	.	C	T	7	6	13	0	0	13	0	0
17	32624460	.	T	C	6	4	10	0	1	11	0	0
17	32624501	.	C	T	0	3	3	0	0	3	0	0
17	32624507	.	A	G	1	4	5	0	0	5	0	0
17	32624653	.	A	C	7	6	13	0	1	14	0	0
17	32624668	.	A	T	11	6	17	0	0	17	0	0
17	32624707	.	T	C	13	12	25	0	0	25	0	0
17	32624725	.	C	T	9	14	23	0	2	25	0	0
17	32624910	.	T	C	8	11	19	0	0	19	0	0
17	32624916	.	A	T	7	9	16	0	3	19	0	0
17	32631400	.	C	T	10	6	16	0	0	16	0	0
17	32631513	.	A	T	8	3	11	0	0	11	0	0
17	32631533	.	A	G	10	4	14	0	1	15	0	0
17	32631560	.	G	T	11	15	26	0	0	26	0	0
17	32631603	.	C	G	11	20	31	0	0	31	0	0
17	32636025	.	A	T	5	5	10	0	2	12	0	0
17	32636179	.	T	C	4	0	4	0	5	9	0	0
17	32636238	.	C	T	0	2	2	0	2	4	0	0
17	34813921	.	T	C	1	2	3	0	0	3	0	0
17	34813927	.	T	C	1	2	3	0	0	3	0	0
17	35248121	.	T	A	5	10	15	0	0	16	1	0
17	36940974	.	T	G	2	17	19	0	0	19	0	0
17	36940977	.	T	C	2	14	16	0	1	17	0	0
17	37363938	.	A	G	3	0	3	0	4	7	0	0
17	37446208	.	A	T	8	5	13	0	1	14	0	0
17	37446379	.	T	C	1	4	5	0	1	6	0	0
17	37446555	.	T	A	7	7	14	0	0	14	0	0
17	37446563	.	G	A	7	6	13	0	0	13	0	0
17	37446735	.	G	A	9	12	21	0	1	22	0	0
17	37446789	.	A	C	13	0	13	1	5	19	0	0
17	37446790	.	A	C	14	1	15	1	3	19	0	0
17	37449200	.	G	C	3	5	8	0	1	9	0	0
17	37450132	.	C	T	1	2	3	0	0	3	0	0
17	37450180	.	T	G	3	3	6	0	1	7	0	0
17	37474560	.	T	G	2	8	10	0	1	11	0	0
17	37570871	.	A	G	6	3	9	0	0	9	0	0
17	37585002	.	A	G	2	2	4	0	0	4	0	0
17	37590024	.	C	T	8	3	11	0	0	11	0	0
17	37593662	.	C	T	5	6	11	0	1	12	0	0
17	37597175	.	A	T	6	6	12	0	0	12	0	0
17	37603748	.	G	A	2	8	10	2	6	18	0	0
17	37605870	.	A	G	17	0	17	0	12	29	0	0
17	37606011	.	G	A	0	15	15	0	17	32	0	0
17	37606101	.	G	A	0	10	10	0	10	20	0	0
17	37606116	.	G	A	10	7	17	0	2	19	0	0
17	37618028	.	C	G	7	6	13	0	0	13	0	0
17	37618070	.	T	C	9	5	14	0	1	15	0	0
17	37618083	.	T	G	11	3	14	0	3	17	0	0
17	37618143	.	T	C	8	5	13	0	1	14	0	0
17	37618157	.	A	C	8	5	13	0	0	13	0	0
17	37618316	.	C	T	3	3	6	0	1	7	0	0
17	37618485	.	C	T	6	8	14	0	1	15	0	0
17	37624913	.	A	T	9	7	16	0	0	16	0	0
17	37648766	.	C	T	5	7	12	0	1	13	0	0
17	37792745	.	A	G	4	8	12	0	0	12	0	0
17	37793456	.	C	T	2	5	7	0	7	14	0	0
17	37793627	.	G	A	5	4	9	0	0	9	0	0
17	38021502	.	C	T	2	2	4	0	0	4	0	0
17	38021526	.	A	G	2	2	4	0	0	4	0	0
17	38022330	.	C	T	2	2	4	0	0	4	0	0
17	38022338	.	C	G	2	2	4	0	0	4	0	0
17	38022372	.	T	C	2	3	5	0	0	5	0	0
17	38022394	.	T	C	2	2	4	0	1	5	0	0
17	38232237	.	T	C	3	4	7	0	1	8	0	0
17	38232630	.	A	T	6	2	8	1	0	9	0	0
17	38263912	.	G	C	0	4	4	0	4	8	0	0
17	38264044	.	G	T	4	7	11	0	1	12	0	0
17	38295925	.	C	A	3	3	6	0	0	6	0	0
17	38295927	.	T	A	3	3	6	0	0	6	0	0
17	38295991	.	C	T	3	3	6	0	0	6	0	0
17	38296642	.	G	A	8	3	11	0	1	12	0	0
17	38296644	.	T	G	4	7	11	0	0	11	0	0
17	38303423	.	C	T	9	4	13	0	1	14	0	0
17	38303607	.	A	G	6	6	12	0	0	12	0	0
17	38303652	.	G	A	1	7	8	0	8	16	0	0
17	38393681	.	G	T	1	2	3	0	0	3	0	0
17	38471166	.	G	T	1	2	3	0	0	3	0	0
17	38471298	.	G	C	1	3	4	0	0	4	0	0
17	38553771	.	C	A	2	2	4	0	0	4	0	0
17	38553772	.	A	T	2	2	4	0	0	4	0	0
17	38598185	.	T	C	1	2	3	0	0	3	0	0
17	38712775	.	T	G	1	4	5	0	1	6	0	0
17	38712817	.	T	C	3	2	5	0	0	5	0	0
17	38712818	.	G	A	3	2	5	0	0	5	0	0
17	38713125	.	G	C	4	2	6	0	0	6	0	0
17	38713174	.	G	T	0	4	4	0	2	6	0	0
17	38713334	.	G	T	1	6	7	0	0	7	0	0
17	38713640	.	A	C	3	2	5	0	0	5	0	0
17	38713709	.	C	T	2	5	7	0	1	8	0	0
17	38714216	.	A	C	4	3	7	0	0	7	0	0
17	38714280	.	A	T	2	5	7	0	0	7	0	0
17	38714446	.	A	G	2	4	6	0	0	6	0	0
17	38714578	.	A	T	3	2	5	0	0	5	0	0
17	38740684	.	T	C	3	7	10	0	0	10	0	0
17	38740698	.	A	T	3	8	11	0	1	12	0	0
17	38749800	.	G	A	8	6	14	0	0	14	0	0
17	38749807	.	G	A	7	6	13	0	2	15	0	0
17	38751711	.	T	A	7	9	16	0	0	16	0	0
17	38754825	.	C	A	11	6	17	0	1	18	0	0
17	38755038	.	A	G	13	17	30	0	1	31	0	0
17	38756777	.	T	G	3	12	15	0	0	15	0	0
17	38758682	.	G	A	2	10	12	0	0	12	0	0
17	38760619	.	G	A	5	9	14	0	1	15	0	0
17	38761035	.	A	G	4	2	6	0	0	6	0	0
17	38761069	.	T	C	6	5	11	0	1	12	0	0
17	38768370	.	G	T	5	2	7	0	1	8	0	0
17	38768433	.	C	T	0	6	6	0	3	9	0	0
17	38768483	.	G	A	3	5	8	0	0	8	0	0
17	38769924	.	T	A	9	4	13	0	0	13	0	0
17	38769935	.	T	C	7	3	10	0	1	11	0	0
17	38769975	.	G	A	6	7	13	0	0	13	0	0
17	38784387	.	T	A	3	16	19	1	1	21	0	0
17	38784477	.	T	C	15	7	22	0	2	24	0	0
17	38784545	.	G	T	13	5	18	0	1	19	0	0
17	38784642	.	T	C	5	12	17	0	0	17	0	0
17	38787327	.	G	A	3	4	7	0	0	7	0	0
17	38787498	.	G	A	2	7	9	0	0	9	0	0
17	38787540	.	A	T	5	3	8	0	0	8	0	0
17	38804808	.	C	T	4	5	9	0	1	10	0	0
17	38804853	.	A	T	2	5	7	0	0	7	0	0
17	38927932	.	T	C	5	3	8	0	0	8	0	0
17	38928073	.	A	T	4	6	10	0	0	10	0	0
17	38928447	.	T	C	2	0	2	0	6	8	0	0
17	38928947	.	A	T	3	5	8	0	1	9	0	0
17	38938727	.	G	A	4	2	6	0	1	7	0	0
17	38946528	.	G	A	3	2	5	0	0	5	0	0
17	39717616	.	T	C	7	7	14	0	0	14	0	0
17	39717645	.	A	G	5	0	5	0	5	10	0	0
17	39720791	.	T	C	4	5	9	0	1	10	0	0
17	39728239	.	C	T	9	6	15	0	1	16	0	0
17	39728261	.	G	T	13	7	20	0	0	20	0	0
17	39728423	.	T	A	9	10	19	0	1	20	0	0
17	39729014	.	G	A	13	10	23	0	0	23	0	0
17	39732512	.	C	T	8	11	19	0	3	22	0	0
17	39732573	.	C	A	8	10	18	0	1	19	0	0
17	39732584	.	G	A	9	8	17	0	1	18	0	0
17	39736088	.	T	A	14	9	23	0	1	24	0	0
17	39736103	.	G	A	13	7	20	0	1	21	0	0
17	39736130	.	T	C	6	10	16	0	0	16	0	0
17	39739842	.	A	T	9	10	19	0	1	20	0	0
17	39862334	.	A	G	2	8	10	0	1	11	0	0
17	39862536	.	C	G	5	3	8	0	0	8	0	0
17	39863633	.	C	T	7	7	14	1	0	15	0	0
17	40397668	.	G	C	1	2	3	0	0	3	0	0
17	40860266	.	C	T	2	4	6	0	0	6	0	0
17	40883596	.	C	T	2	2	4	0	1	5	0	0
17	40887285	.	G	T	2	3	5	0	1	6	0	0
17	40888907	.	A	C	1	3	4	0	2	6	0	0
17	40888909	.	G	C	1	5	6	0	0	6	0	0
17	40889011	.	A	G	5	3	8	0	0	8	0	0
17	40889613	.	C	A	3	3	6	0	0	6	0	0
17	40889697	.	A	G	4	2	6	0	0	6	0	0
17	40890056	.	C	T	3	6	9	0	0	9	0	0
17	40890107	.	G	T	3	2	5	0	0	5	0	0
17	40890396	.	C	T	5	5	10	0	0	10	0	0
17	40890433	.	G	A	5	2	7	0	0	7	0	0
17	40890443	.	C	T	3	2	5	0	0	5	0	0
17	40898927	.	G	T	3	3	6	0	0	6	0	0
17	40899449	.	A	G	2	4	6	0	0	6	0	0
17	40899455	.	A	G	4	2	6	0	0	6	0	0
17	40900354	.	C	T	3	7	10	0	0	10	0	0
17	40900389	.	G	A	5	2	7	0	0	7	0	0
17	40901439	.	T	C	1	3	4	0	0	4	0	0
17	40901695	.	G	C	5	11	16	0	0	16	0	0
17	40901712	.	C	G	4	9	13	0	1	14	0	0
17	40901752	.	G	A	2	7	9	0	1	10	0	0
17	40901799	.	A	C	3	3	6	0	0	6	0	0
17	40901804	.	A	T	2	3	5	0	0	5	0	0
17	40902005	.	C	A	4	5	9	0	6	15	0	0
17	40902065	.	G	A	5	6	11	0	1	12	0	0
17	40902148	.	G	T	6	10	16	0	1	17	0	0
17	40902180	.	G	C	8	7	15	0	1	16	0	0
17	40902256	.	G	T	2	3	5	0	0	5	0	0
17	40902297	.	A	G	2	8	10	0	0	10	0	0
17	40902347	.	C	T	7	9	16	0	0	16	0	0
17	40902368	.	T	G	8	7	15	0	0	15	0	0
17	40902418	.	G	A	2	8	10	0	5	15	0	0
17	40902598	.	G	A	7	5	12	0	0	12	0	0
17	40902629	.	A	T	9	6	15	0	1	16	0	0
17	40902657	.	A	C	8	5	13	0	0	13	0	0
17	40902830	.	A	T	5	11	16	0	0	16	0	0
17	40902932	.	T	C	5	2	7	1	1	9	0	0
17	40903162	.	C	T	6	3	9	0	1	10	0	0
17	40932270	.	G	A	2	3	5	0	0	5	0	0
17	40955529	.	G	C	1	2	3	0	0	3	0	0
17	40990061	.	T	A	15	13	28	0	1	29	0	0
17	40990097	.	T	A	19	13	32	0	0	32	0	0
17	40999460	.	A	G	19	7	26	0	1	27	0	0
17	40999697	.	C	G	7	3	10	0	1	11	0	0
17	40999700	.	C	A	6	3	9	0	1	10	0	0
17	40999732	.	A	G	4	5	9	0	1	10	0	0
17	41084623	.	C	T	5	4	9	0	0	9	0	0
17	41084670	.	T	C	2	7	9	0	0	9	0	0
17	41092465	.	C	T	4	3	7	0	0	7	0	0
17	41121783	.	C	G	4	3	7	0	0	7	0	0
17	41220064	.	T	A	2	6	8	0	1	9	0	0
17	41254741	.	C	T	12	8	20	0	2	22	0	0
17	41264165	.	C	A	2	3	5	0	0	5	0	0
17	41314040	.	G	T	2	13	15	0	8	23	0	0
17	41314097	.	T	C	9	12	21	0	2	23	0	0
17	41314471	.	G	A	8	11	19	0	0	19	0	0
17	41314501	.	A	G	5	5	10	0	0	10	0	0
17	41317234	.	A	G	5	0	5	0	10	15	0	0
17	41317494	.	G	A	9	18	27	0	1	28	0	0
17	41317999	.	G	A	13	12	25	0	1	26	0	0
17	41318310	.	A	G	9	11	20	0	2	22	0	0
17	41318392	.	G	A	5	5	10	0	1	11	0	0
17	41364799	.	G	T	1	2	3	0	0	3	0	0
17	41368655	.	G	A	1	2	3	0	0	3	0	0
17	41368695	.	A	T	1	3	4	0	0	4	0	0
17	41368697	.	C	T	1	3	4	0	0	4	0	0
17	41465504	.	A	C	4	8	12	0	0	12	0	0
17	41465922	.	G	A	1	4	5	0	0	5	0	0
17	41475863	.	T	C	12	13	25	1	0	26	0	0
17	41476104	.	T	C	19	0	19	0	21	40	0	0
17	41476161	.	A	G	15	25	40	1	3	44	0	0
17	41476279	.	G	A	20	19	39	0	0	39	0	0
17	41476298	.	T	A	18	13	31	0	2	33	0	0
17	41476393	.	G	T	12	5	17	0	4	21	0	0
17	41476833	.	T	C	8	10	18	0	0	18	0	0
17	41476906	.	A	C	6	0	6	0	6	12	0	0
17	41476917	.	C	T	2	5	7	0	4	11	0	0
17	41476970	.	T	C	8	12	20	0	0	20	0	0
17	41476994	.	G	A	9	9	18	0	2	20	0	0
17	41477007	.	C	T	0	10	10	0	9	19	0	0
17	41477157	.	T	C	10	7	17	0	1	18	0	0
17	41477324	.	G	A	11	5	16	0	1	17	0	0
17	41558269	.	G	C	9	5	14	0	1	15	0	0
17	41571328	.	T	A	9	6	15	0	0	15	0	0
17	41583555	.	C	G	0	7	7	0	7	14	0	0
17	41583747	.	G	T	9	3	12	0	0	12	0	0
17	41583768	.	T	C	3	0	3	0	8	11	0	0
17	41583786	.	A	G	2	5	7	0	1	8	0	0
17	41592172	.	A	C	4	4	8	0	0	8	0	0
17	41601633	.	G	A	7	5	12	2	0	14	0	0
17	41601916	.	G	A	7	5	12	0	1	13	0	0
17	41602081	.	T	C	5	2	7	0	0	7	0	0
17	41609762	.	G	A	1	9	10	0	0	10	0	0
17	41610991	.	G	A	2	5	7	0	0	7	0	0
17	41659641	.	C	T	0	3	3	0	2	5	0	0
17	41667109	.	C	T	0	2	2	0	6	8	0	0
17	41669406	.	A	G	4	3	7	0	1	8	0	0
17	41673488	.	C	T	1	3	4	0	0	4	0	0
17	41992262	.	T	G	3	0	3	0	4	7	0	0
17	41994768	.	G	T	2	8	10	0	1	11	0	0
17	41994868	.	A	G	1	1	2	0	4	6	0	0
17	42027915	.	C	T	6	7	13	0	0	13	0	0
17	42030083	.	A	G	14	1	15	0	9	24	0	0
17	42032119	.	T	C	12	6	18	0	0	18	0	0
17	42095539	.	A	T	2	4	6	0	0	6	0	0
17	42095602	.	A	G	2	5	7	0	0	7	0	0
17	42095620	.	C	T	3	3	6	0	0	6	0	0
17	42096960	.	C	G	0	2	2	0	1	3	0	0
17	42213145	.	C	A	1	6	7	0	0	7	0	0
17	42613355	.	C	T	0	4	4	0	1	5	0	0
17	42871419	.	G	T	17	7	24	0	1	25	0	0
17	43013675	.	G	A	20	26	46	0	2	48	0	0
17	43017672	.	C	T	16	15	31	0	0	31	0	0
17	43017687	.	G	A	19	12	31	0	0	31	0	0
17	43017830	.	A	G	10	7	17	0	0	17	0	0
17	43017863	.	A	C	12	8	20	0	1	21	0	0
17	43018037	.	G	A	0	16	16	0	18	34	0	0
17	43018124	.	A	G	18	0	18	0	11	29	0	0
17	43018273	.	G	A	21	26	47	0	0	47	0	0
17	43018382	.	T	G	15	14	29	0	1	30	0	0
17	43018502	.	T	A	27	9	36	0	1	38	1	0
17	43018549	.	C	G	22	11	33	0	2	35	0	0
17	43018638	.	A	T	18	20	38	0	0	38	0	0
17	43018815	.	A	G	17	18	35	0	3	38	0	0
17	43018899	.	T	A	10	21	31	0	0	31	0	0
17	43030696	.	T	C	7	4	11	0	1	12	0	0
17	43030737	.	T	G	11	8	19	0	0	19	0	0
17	43030828	.	G	A	15	6	21	0	1	22	0	0
17	43031495	.	G	A	1	5	6	0	0	6	0	0
17	43033177	.	G	A	13	15	28	0	1	29	0	0
17	43035798	.	T	C	14	16	30	0	2	32	0	0
17	43035958	.	A	G	18	5	23	0	4	27	0	0
17	43035996	.	G	T	17	16	33	0	0	34	1	0
17	43036025	.	A	G	11	18	29	0	2	31	0	0
17	43036055	.	T	C	17	12	29	0	0	29	0	0
17	43039706	.	A	G	2	2	4	0	0	4	0	0
17	43040422	.	T	A	4	9	13	0	2	15	0	0
17	43082871	.	G	A	4	3	7	0	1	8	0	0
17	43082976	.	A	T	5	8	13	0	1	14	0	0
17	43087252	.	A	T	3	5	8	0	0	8	0	0
17	43104590	.	T	A	3	4	7	0	0	7	0	0
17	43146607	.	G	C	4	3	7	0	0	7	0	0
17	43287129	.	C	T	0	3	3	0	1	4	0	0
17	43287146	.	A	G	1	3	4	0	0	4	0	0
17	43297561	.	T	G	0	2	2	0	1	3	0	0
17	43297946	.	G	C	9	15	24	0	0	24	0	0
17	43298011	.	G	A	20	15	35	0	0	35	0	0
17	43298068	.	G	A	17	16	33	0	1	34	0	0
17	43302492	.	G	A	12	12	24	0	0	24	0	0
17	43309095	.	A	G	7	11	18	0	1	19	0	0
17	43309164	.	C	T	0	11	11	0	15	26	0	0
17	43315085	.	C	T	6	6	12	0	0	12	0	0
17	43348986	.	T	C	1	9	10	0	2	12	0	0
17	43391434	.	G	T	6	5	11	1	0	12	0	0
17	43391442	.	C	T	6	6	12	1	0	13	0	0
17	43436782	.	T	C	26	0	26	0	23	49	0	0
17	43437305	.	G	C	31	19	50	1	2	53	0	0
17	43437365	.	C	G	29	20	49	0	3	52	0	0
17	43439720	.	G	T	21	23	44	1	7	52	0	0
17	43441575	.	A	T	20	18	38	0	2	40	0	0
17	43453507	.	T	C	11	10	21	0	1	22	0	0
17	43453531	.	G	A	8	13	21	0	0	21	0	0
17	43456825	.	C	T	12	10	22	0	1	23	0	0
17	43456900	.	G	A	17	7	24	0	0	24	0	0
17	43456921	.	T	C	9	12	21	0	1	22	0	0
17	43461181	.	G	A	4	5	9	0	1	10	0	0
17	43469204	.	A	C	7	8	15	0	0	15	0	0
17	43469377	.	G	A	9	6	15	0	0	15	0	0
17	43473913	.	T	C	14	5	19	0	0	19	0	0
17	43475577	.	G	A	4	7	11	0	12	23	0	0
17	43475619	.	A	G	11	1	12	0	11	23	0	0
17	43475691	.	T	A	6	3	9	0	0	9	0	0
17	43476046	.	C	T	3	4	7	0	1	8	0	0
17	43476137	.	T	A	4	12	16	0	0	16	0	0
17	43476241	.	A	G	3	2	5	0	0	5	0	0
17	43491218	.	T	C	1	4	5	0	0	5	0	0
17	43497404	.	A	T	0	3	3	0	1	4	0	0
17	43513109	.	G	A	16	7	23	0	0	23	0	0
17	43516464	.	T	A	9	6	15	0	2	17	0	0
17	43516502	.	G	T	6	14	20	0	0	20	0	0
17	43516506	.	A	C	6	12	18	0	2	20	0	0
17	43516548	.	A	G	5	16	21	0	1	22	0	0
17	43516579	.	T	C	3	0	3	0	12	15	0	0
17	43520103	.	G	A	4	2	6	0	0	6	0	0
17	43520136	.	G	A	2	4	6	0	0	6	0	0
17	43520158	.	A	G	3	3	6	0	0	6	0	0
17	43520191	.	G	A	6	7	13	0	0	13	0	0
17	43522776	.	A	G	3	7	10	0	0	10	0	0
17	43522782	.	T	C	6	0	6	0	3	9	0	0
17	43537865	.	C	T	7	9	16	0	0	16	0	0
17	43538018	.	A	C	6	4	10	0	2	12	0	0
17	43538035	.	C	T	0	5	5	0	7	12	0	0
17	43538081	.	G	A	4	4	8	0	0	8	0	0
17	43538097	.	C	T	7	4	11	0	0	11	0	0
17	43538131	.	G	A	2	5	7	0	0	7	0	0
17	43538209	.	C	T	10	3	13	0	2	15	0	0
17	43547945	.	A	G	3	9	12	0	0	12	0	0
17	43551547	.	G	T	4	10	14	0	0	14	0	0
17	43551835	.	A	G	1	5	6	0	0	6	0	0
17	43551841	.	G	C	2	3	5	0	0	5	0	0
17	43565638	.	G	T	4	2	6	0	1	7	0	0
17	43565680	.	A	T	10	6	16	2	0	18	0	0
17	43565697	.	C	A	10	3	13	2	2	17	0	0
17	43575504	.	C	T	0	4	4	0	1	5	0	0
17	43575782	.	C	T	4	2	6	0	0	6	0	0
17	43611462	.	T	C	1	2	3	0	0	3	0	0
17	43615454	.	G	A	2	2	4	0	0	4	0	0
17	43629319	.	C	A	1	2	3	0	1	4	0	0
17	43629342	.	T	C	1	4	5	0	0	5	0	0
17	43629622	.	C	T	1	2	3	0	0	3	0	0
17	43660232	.	G	A	8	9	17	0	0	17	0	0
17	43660779	.	T	C	14	8	22	0	0	22	0	0
17	43661106	.	T	G	6	6	12	0	1	13	0	0
17	43661291	.	G	T	12	2	14	0	1	15	0	0
17	43661293	.	A	T	9	2	11	0	4	15	0	0
17	43663789	.	A	C	14	21	35	0	1	36	0	0
17	43663870	.	G	A	17	29	46	0	3	49	0	0
17	43664128	.	G	C	17	17	34	0	1	35	0	0
17	43664580	.	A	G	19	10	29	0	1	30	0	0
17	43664605	.	G	A	13	7	20	0	0	20	0	0
17	43708546	.	C	T	7	7	14	0	2	16	0	0
17	43708563	.	A	G	10	9	19	0	1	20	0	0
17	43708608	.	C	T	11	9	20	0	0	20	0	0
17	43708649	.	T	C	6	11	17	0	0	17	0	0
17	43711557	.	C	T	1	2	3	0	4	7	0	0
17	43715607	.	C	T	4	3	7	0	0	7	0	0
17	43715851	.	T	C	8	7	15	0	0	15	0	0
17	43716633	.	C	T	2	7	9	0	0	9	0	0
17	43716648	.	T	A	1	5	6	0	1	7	0	0
17	43717878	.	G	T	3	2	5	0	0	5	0	0
17	43847277	.	A	G	1	0	1	0	3	4	0	0
17	43851013	.	A	G	14	9	23	0	0	23	0	0
17	43853538	.	G	A	10	19	29	0	2	31	0	0
17	43853767	.	A	G	13	16	29	1	1	31	0	0
17	43853778	.	C	T	2	15	17	1	13	31	0	0
17	43853938	.	C	T	14	8	22	0	0	22	0	0
17	43854007	.	G	A	9	15	24	0	2	26	0	0
17	43854010	.	T	G	17	10	27	0	0	27	0	0
17	43856232	.	T	C	3	5	8	0	0	8	0	0
17	43859282	.	T	C	6	8	14	0	0	14	0	0
17	43863609	.	A	C	11	17	28	0	1	29	0	0
17	43863655	.	G	C	5	8	13	0	0	13	0	0
17	43863656	.	C	T	5	8	13	0	0	13	0	0
17	43883424	.	T	C	2	3	5	0	0	5	0	0
17	43883634	.	C	T	3	2	5	0	0	5	0	0
17	43926650	.	C	A	6	4	10	0	0	10	0	0
17	43946901	.	C	T	5	6	11	0	1	12	0	0
17	43951868	.	G	T	11	7	18	0	1	19	0	0
17	43952984	.	C	T	4	2	6	0	0	6	0	0
17	43953000	.	G	A	1	2	3	0	4	7	0	0
17	43954926	.	A	C	2	4	6	0	0	6	0	0
17	43987048	.	A	G	17	21	38	0	0	38	0	0
17	43996483	.	G	A	21	14	35	0	1	36	0	0
17	43996485	.	G	A	21	14	35	0	1	36	0	0
17	43996620	.	A	T	19	13	32	0	1	33	0	0
17	43996667	.	G	A	19	14	33	0	1	34	0	0
17	44001540	.	A	G	17	15	32	0	2	34	0	0
17	44001584	.	T	C	19	12	31	0	0	31	0	0
17	44002032	.	A	T	15	14	29	0	0	29	0	0
17	44007047	.	A	T	2	2	4	0	0	4	0	0
17	44030906	.	C	T	1	2	3	0	0	3	0	0
17	44030943	.	C	T	2	6	8	0	0	8	0	0
17	44584833	.	A	G	1	3	4	0	0	4	0	0
17	45138591	.	T	C	7	8	15	0	0	15	0	0
17	45138733	.	T	C	15	13	28	0	1	29	0	0
17	45138741	.	T	C	19	7	26	0	3	29	0	0
17	45138796	.	T	C	19	9	28	0	2	30	0	0
17	45139429	.	T	C	16	6	22	0	0	22	0	0
17	45402422	.	A	G	5	7	12	0	0	12	0	0
17	45402602	.	A	T	3	4	7	0	0	7	0	0
17	45402640	.	C	A	3	6	9	0	0	9	0	0
17	45402713	.	T	A	1	3	4	0	2	6	0	0
17	45402714	.	C	T	2	4	6	0	0	6	0	0
17	45402811	.	A	G	2	2	4	0	0	4	0	0
17	45458154	.	C	G	2	0	2	0	2	4	0	0
17	45476850	.	C	T	1	2	3	0	0	3	0	0
17	45482181	.	C	A	5	2	7	0	0	7	0	0
17	45482313	.	A	T	1	2	3	0	0	3	0	0
17	45482360	.	G	A	2	2	4	0	2	6	0	0
17	45482377	.	T	C	1	4	5	0	1	6	0	0
17	45482409	.	C	T	1	4	5	0	0	5	0	0
17	45731991	.	T	C	3	8	11	0	0	11	0	0
17	45732147	.	T	C	13	8	21	0	0	21	0	0
17	45732173	.	C	T	0	10	10	0	9	19	0	0
17	45732327	.	G	A	18	5	23	0	0	23	0	0
17	45733632	.	T	G	2	3	5	0	0	5	0	0
17	45733752	.	G	A	9	3	12	0	1	13	0	0
17	45738138	.	A	G	1	2	3	0	1	4	0	0
17	45744138	.	C	T	3	3	6	0	1	7	0	0
17	45748623	.	C	T	7	3	10	0	0	10	0	0
17	45748674	.	A	G	3	4	7	0	1	8	0	0
17	45750485	.	C	T	6	4	10	0	0	10	0	0
17	45751404	.	T	C	5	4	9	0	1	10	0	0
17	45756484	.	A	G	11	7	18	0	0	18	0	0
17	45756610	.	T	C	4	5	9	0	0	9	0	0
17	45756652	.	T	C	1	4	5	0	0	5	0	0
17	45762487	.	G	A	8	6	14	0	2	16	0	0
17	45765234	.	G	A	9	14	23	0	1	24	0	0
17	45766167	.	A	G	11	0	11	0	7	18	0	0
17	45774378	.	G	A	1	4	5	0	5	10	0	0
17	45980097	.	A	G	1	0	1	0	2	3	0	0
17	45981104	.	G	A	1	2	3	0	0	3	0	0
17	45983392	.	G	A	2	2	4	0	0	4	0	0
17	45983410	.	C	T	2	2	4	0	0	4	0	0
17	45983439	.	C	G	1	5	6	0	0	6	0	0
17	45984465	.	G	T	0	4	4	0	3	7	0	0
17	45987075	.	G	A	0	4	4	0	1	5	0	0
17	45987120	.	C	T	3	5	8	0	0	8	0	0
17	45987143	.	A	T	3	5	8	0	0	8	0	0
17	45988188	.	A	G	2	0	2	0	3	5	0	0
17	45988864	.	C	T	7	4	11	0	1	12	0	0
17	45988991	.	G	C	4	4	8	0	0	8	0	0
17	45989003	.	A	G	5	0	5	0	3	8	0	0
17	45989032	.	G	T	4	5	9	0	1	10	0	0
17	46387226	.	C	A	4	6	10	0	1	11	0	0
17	46387291	.	C	A	1	7	8	0	0	8	0	0
17	46439098	.	G	A	3	7	10	0	0	10	0	0
17	46439102	.	C	T	2	6	8	0	1	9	0	0
17	46439186	.	A	G	3	3	6	0	0	6	0	0
17	46457321	.	G	C	13	6	19	0	1	20	0	0
17	46457326	.	C	A	1	6	7	0	13	21	1	0
17	47140969	.	G	A	0	5	5	0	3	8	0	0
17	47175837	.	C	T	5	2	7	0	0	7	0	0
17	47175854	.	T	C	2	6	8	0	0	8	0	0
17	47176349	.	G	A	0	4	4	0	1	5	0	0
17	47188563	.	T	C	6	3	9	0	0	9	0	0
17	47189003	.	A	G	10	14	24	1	0	25	0	0
17	47189025	.	C	A	7	10	17	1	0	19	1	0
17	47189725	.	G	A	8	8	16	0	0	16	0	0
17	47189765	.	G	T	4	5	9	0	0	9	0	0
17	47189790	.	A	G	6	2	8	0	0	8	0	0
17	47189810	.	C	T	1	4	5	0	7	12	0	0
17	47189919	.	G	T	7	10	17	0	0	18	1	0
17	47190032	.	C	T	10	11	21	0	0	21	0	0
17	47190045	.	C	A	1	9	10	0	11	21	0	0
17	47190149	.	G	C	8	7	15	0	1	16	0	0
17	47190264	.	C	T	0	5	5	0	2	7	0	0
17	47190492	.	G	A	4	3	7	0	0	7	0	0
17	47190941	.	G	T	6	4	10	0	0	10	0	0
17	47190967	.	T	G	5	5	10	0	0	10	0	0
17	47191186	.	T	A	2	2	4	0	0	4	0	0
17	47191229	.	G	A	2	4	6	0	1	7	0	0
17	47191248	.	G	A	1	6	7	0	0	7	0	0
17	47191842	.	T	C	3	5	8	0	0	8	0	0
17	47191871	.	T	C	3	0	3	0	2	5	0	0
17	47192009	.	T	C	1	1	2	0	2	4	0	0
17	47192331	.	T	C	2	3	5	0	1	6	0	0
17	47192359	.	A	G	1	2	3	0	1	4	0	0
17	47192766	.	C	T	1	4	5	0	0	5	0	0
17	47193359	.	T	C	3	0	3	0	8	11	0	0
17	47193651	.	A	G	5	6	11	0	0	11	0	0
17	47193872	.	C	T	5	3	8	0	0	8	0	0
17	47193902	.	C	T	0	4	4	0	4	8	0	0
17	47193941	.	T	G	2	3	5	0	1	6	0	0
17	47220857	.	C	A	2	2	4	0	0	4	0	0
17	47220868	.	A	G	2	2	4	0	0	4	0	0
17	47289395	.	C	A	2	5	7	0	0	7	0	0
17	48127380	.	T	A	1	2	3	0	0	3	0	0
17	48127384	.	T	C	1	2	3	0	0	3	0	0
17	48138510	.	T	A	4	5	9	0	0	9	0	0
17	48867268	.	C	T	0	2	2	0	1	3	0	0
17	48908911	.	A	G	6	11	17	0	0	17	0	0
17	48911097	.	T	G	4	3	7	0	0	7	0	0
17	49003651	.	A	G	4	4	8	0	0	8	0	0
17	49010654	.	T	C	5	5	10	0	0	10	0	0
17	49010678	.	T	C	3	5	8	0	0	8	0	0
17	49011174	.	A	G	7	6	13	1	0	14	0	0
17	49011177	.	C	A	7	6	13	1	0	14	0	0
17	49016534	.	C	T	2	10	12	0	3	15	0	0
17	49016858	.	C	T	10	7	17	0	2	19	0	0
17	49018224	.	G	A	1	10	11	0	11	22	0	0
17	49018508	.	C	G	8	9	17	0	0	17	0	0
17	49018575	.	G	A	12	5	17	0	2	19	0	0
17	49019177	.	C	A	25	13	38	0	1	39	0	0
17	49131879	.	G	A	0	3	3	0	1	4	0	0
17	49137269	.	G	T	2	2	4	0	1	5	0	0
17	49137274	.	C	T	2	2	4	0	1	5	0	0
17	49306256	.	C	T	16	7	23	0	2	25	0	0
17	49306334	.	G	A	1	3	4	0	8	12	0	0
17	49306341	.	T	C	10	2	12	0	3	15	0	0
17	49416044	.	T	G	9	9	18	0	1	19	0	0
17	49416151	.	T	C	12	0	12	2	8	22	0	0
17	49416259	.	T	C	12	1	13	0	8	21	0	0
17	49416327	.	T	C	10	15	25	0	0	25	0	0
17	49416992	.	G	A	11	4	15	0	0	15	0	0
17	49417137	.	C	T	7	6	13	0	1	14	0	0
17	49417148	.	A	T	8	7	15	0	0	15	0	0
17	49417414	.	T	A	9	8	17	0	3	20	0	0
17	49417569	.	T	C	3	11	14	0	0	14	0	0
17	49417599	.	G	C	4	7	11	0	0	11	0	0
17	49417835	.	G	A	7	11	18	0	0	18	0	0
17	49417838	.	A	G	8	11	19	0	0	19	0	0
17	49417961	.	A	C	6	10	16	0	0	16	0	0
17	49417974	.	C	A	7	10	17	0	0	17	0	0
17	49418122	.	C	G	4	6	10	0	0	10	0	0
17	49419410	.	T	C	5	2	7	0	0	7	0	0
17	49419491	.	A	G	2	2	4	0	0	4	0	0
17	49419761	.	G	T	3	7	10	0	0	10	0	0
17	49419887	.	C	T	0	6	6	0	6	12	0	0
17	49419954	.	C	T	2	4	6	0	1	7	0	0
17	49420049	.	T	G	5	4	9	0	0	9	0	0
17	49420565	.	A	C	4	0	4	0	3	7	0	0
17	49420954	.	G	T	2	3	5	0	0	5	0	0
17	49421056	.	A	T	1	3	4	0	0	4	0	0
17	49421083	.	T	C	1	3	4	0	0	4	0	0
17	49439447	.	G	A	8	5	13	0	0	13	0	0
17	49439473	.	T	A	6	3	9	0	5	14	0	0
17	49439611	.	T	C	3	7	10	0	0	10	0	0
17	49439612	.	T	C	4	6	10	0	0	10	0	0
17	49439886	.	T	C	5	2	7	0	0	7	0	0
17	49527452	.	A	G	1	4	5	0	0	5	0	0
17	49527456	.	A	G	2	0	2	0	3	5	0	0
17	49527588	.	A	G	10	4	14	0	4	18	0	0
17	49527773	.	A	G	2	4	6	0	0	6	0	0
17	49527783	.	A	G	4	4	8	0	0	8	0	0
17	49983202	.	A	T	13	6	19	0	1	20	0	0
17	49983273	.	C	T	21	24	45	0	1	46	0	0
17	49983315	.	C	T	23	24	47	0	0	47	0	0
17	49992629	.	G	A	31	29	60	0	2	62	0	0
17	49998171	.	T	C	15	13	28	0	0	28	0	0
17	49998221	.	G	A	18	14	32	0	1	33	0	0
17	49998658	.	G	A	12	4	16	0	0	16	0	0
17	49998734	.	G	A	19	13	32	0	2	34	0	0
17	49998804	.	C	A	28	20	48	0	1	49	0	0
17	49999037	.	G	T	25	22	47	0	1	48	0	0
17	50002381	.	A	G	27	17	44	0	2	46	0	0
17	50007340	.	G	A	6	12	18	0	1	19	0	0
17	50009829	.	T	C	10	0	10	0	16	26	0	0
17	50009832	.	T	A	8	17	25	0	1	26	0	0
17	50010078	.	T	C	14	16	30	0	4	34	0	0
17	50010087	.	C	A	1	13	14	0	17	31	0	0
17	50097129	.	G	A	3	2	5	0	0	5	0	0
17	50099911	.	A	G	2	1	3	0	3	6	0	0
17	50100027	.	C	T	2	6	8	0	0	8	0	0
17	50101438	.	C	A	5	4	9	0	0	9	0	0
17	50107391	.	G	A	5	2	7	0	0	7	0	0
17	50107394	.	C	A	2	5	7	0	0	7	0	0
17	50110215	.	C	T	1	5	6	0	2	8	0	0
17	50110391	.	G	T	5	12	17	0	0	17	0	0
17	50110461	.	G	A	4	9	13	0	0	13	0	0
17	50110479	.	C	G	3	6	9	0	2	11	0	0
17	50110838	.	C	T	2	2	4	0	0	4	0	0
17	50110893	.	G	A	3	2	5	0	1	6	0	0
17	50110966	.	T	C	2	3	5	0	0	5	0	0
17	50111397	.	A	G	6	10	16	0	0	16	0	0
17	50111406	.	G	A	10	5	15	0	2	17	0	0
17	50111528	.	A	G	3	9	12	0	0	12	0	0
17	50111549	.	A	G	6	8	14	0	0	14	0	0
17	50111680	.	A	T	2	3	5	2	0	7	0	0
17	50113141	.	G	A	8	5	13	0	0	13	0	0
17	50113148	.	C	T	5	9	14	0	0	14	0	0
17	50113336	.	C	T	5	4	9	0	3	12	0	0
17	50113404	.	C	T	3	4	7	0	0	7	0	0
17	50141759	.	A	T	5	2	7	0	0	7	0	0
17	50141766	.	T	A	3	5	8	0	0	8	0	0
17	50141806	.	A	G	4	0	4	0	6	10	0	0
17	50141904	.	A	T	10	8	18	0	0	18	0	0
17	50172581	.	T	G	14	7	21	0	1	22	0	0
17	50176483	.	G	A	7	5	12	0	0	12	0	0
17	50176519	.	C	A	9	5	14	0	2	17	1	0
17	50180672	.	C	T	12	12	24	1	1	26	0	0
17	50185665	.	T	A	9	19	28	0	1	29	0	0
17	50185841	.	A	T	12	10	22	0	3	25	0	0
17	50185930	.	T	C	11	14	25	0	0	25	0	0
17	50185964	.	G	A	0	12	12	0	12	24	0	0
17	50186011	.	G	A	0	10	10	0	12	22	0	0
17	50186097	.	G	A	6	8	14	0	2	16	0	0
17	50229135	.	A	C	11	15	26	0	1	27	0	0
17	50229301	.	G	T	10	18	28	0	0	29	1	0
17	50229718	.	A	G	5	20	25	0	1	26	0	0
17	50245580	.	G	A	13	11	24	0	2	26	0	0
17	50245673	.	T	C	23	21	44	0	2	46	0	0
17	50245715	.	C	G	14	23	37	0	2	39	0	0
17	50245772	.	C	T	11	25	36	0	2	38	0	0
17	50247886	.	T	C	16	0	16	0	21	37	0	0
17	50247988	.	A	T	10	2	12	0	2	14	0	0
17	50272729	.	G	A	2	3	5	0	0	5	0	0
17	50275229	.	C	A	8	4	12	0	0	12	0	0
17	50278271	.	G	A	8	5	13	0	0	13	0	0
17	50278808	.	C	T	10	8	18	0	0	18	0	0
17	50278884	.	C	A	6	3	9	0	1	10	0	0
17	50284899	.	T	A	19	13	32	0	1	33	0	0
17	50285009	.	A	T	5	5	10	0	2	12	0	0
17	50285052	.	C	T	4	4	8	0	0	8	0	0
17	50285221	.	A	T	7	5	12	0	0	12	0	0
17	50404824	.	A	T	2	1	3	0	1	4	0	0
17	50415329	.	T	C	2	0	2	0	4	6	0	0
17	50415378	.	C	A	2	3	5	0	1	6	0	0
17	50415844	.	C	T	4	7	11	0	1	12	0	0
17	50415858	.	A	G	9	3	12	0	3	15	0	0
17	50416238	.	C	T	0	2	2	0	3	5	0	0
17	50416269	.	C	T	0	2	2	0	4	6	0	0
17	50416332	.	A	G	2	2	4	0	0	4	0	0
17	50416392	.	T	C	1	7	8	0	0	8	0	0
17	50416414	.	T	A	2	5	7	0	0	7	0	0
17	50416456	.	C	T	3	2	5	0	0	5	0	0
17	50417310	.	T	C	1	3	4	0	0	4	0	0
17	50417534	.	C	T	2	3	5	0	0	5	0	0
17	50417537	.	C	T	3	2	5	0	0	5	0	0
17	50424455	.	T	C	2	1	3	0	3	6	0	0
17	50424555	.	A	T	3	9	12	0	0	12	0	0
17	50424556	.	A	T	2	9	11	0	0	11	0	0
17	50424662	.	A	G	1	8	9	3	2	14	0	0
17	50424663	.	A	G	2	9	11	3	0	14	0	0
17	50424697	.	A	G	5	14	19	3	0	22	0	0
17	50424880	.	T	A	2	5	7	0	0	7	0	0
17	50424885	.	A	T	2	4	6	0	1	7	0	0
17	50425042	.	C	G	3	8	11	0	0	11	0	0
17	50425171	.	A	T	3	5	8	0	0	8	0	0
17	50425321	.	C	T	3	5	8	0	1	9	0	0
17	50425388	.	A	T	7	6	13	1	0	14	0	0
17	50425393	.	T	C	6	6	12	1	0	13	0	0
17	50425478	.	C	T	1	3	4	0	0	4	0	0
17	50425488	.	A	G	2	3	5	0	0	5	0	0
17	50425854	.	C	T	0	4	4	0	6	10	0	0
17	50425858	.	T	A	6	4	10	0	0	10	0	0
17	50425899	.	A	G	8	3	11	0	0	11	0	0
17	50425954	.	C	T	2	2	4	0	0	4	0	0
17	50425992	.	A	T	1	3	4	1	0	5	0	0
17	50426194	.	C	A	1	7	8	0	0	8	0	0
17	50426275	.	A	G	5	2	7	0	0	7	0	0
17	50426303	.	A	G	2	5	7	0	0	7	0	0
17	50426644	.	C	T	2	2	4	0	0	4	0	0
17	50430607	.	C	A	4	2	6	0	0	6	0	0
17	50430614	.	G	A	4	2	6	0	0	6	0	0
17	50436183	.	G	T	1	2	3	0	0	3	0	0
17	50450060	.	C	T	2	2	4	0	0	4	0	0
17	50461380	.	T	C	2	2	4	0	0	4	0	0
17	50656237	.	A	C	1	4	5	0	0	5	0	0
17	50656312	.	A	G	2	2	4	0	1	5	0	0
17	50657067	.	C	T	1	3	4	0	0	4	0	0
17	50657321	.	T	C	1	6	7	0	0	7	0	0
17	50657663	.	G	A	2	3	5	0	0	5	0	0
17	50664473	.	A	C	1	4	5	0	0	5	0	0
17	50679790	.	C	T	5	2	7	0	0	7	0	0
17	50679791	.	T	A	5	2	7	0	0	7	0	0
17	50682945	.	C	T	4	7	11	0	0	11	0	0
17	50688480	.	T	C	6	5	11	0	0	11	0	0
17	50688775	.	A	G	3	1	4	0	3	7	0	0
17	50689755	.	G	A	0	5	5	0	1	6	0	0
17	50689787	.	T	A	2	6	8	1	0	9	0	0
17	50689811	.	A	C	2	7	9	1	0	10	0	0
17	50785539	.	T	C	1	4	5	0	0	5	0	0
17	50839928	.	C	T	3	8	11	0	0	11	0	0
17	50840514	.	A	G	1	2	3	0	1	4	0	0
17	50976567	.	C	T	11	15	26	0	1	27	0	0
17	51206851	.	T	C	12	12	24	0	1	25	0	0
17	51231698	.	T	C	8	4	12	0	0	12	0	0
17	51231980	.	T	C	6	7	13	0	1	14	0	0
17	51720517	.	A	G	4	2	6	0	0	6	0	0
17	51720520	.	A	G	3	2	5	0	1	6	0	0
17	51823617	.	G	T	13	10	23	0	1	24	0	0
17	51824046	.	C	T	16	4	20	0	0	20	0	0
17	51824061	.	G	A	15	4	19	0	0	19	0	0
17	51893050	.	T	G	3	4	7	0	0	7	0	0
17	52002953	.	G	A	0	2	2	0	1	3	0	0
17	52359031	.	C	T	3	2	5	0	0	5	0	0
17	52528662	.	G	C	20	21	41	0	1	42	0	0
17	52533036	.	C	G	17	9	26	0	0	26	0	0
17	52533073	.	C	T	10	17	27	0	3	30	0	0
17	52534241	.	G	A	2	18	20	0	27	47	0	0
17	52534343	.	G	A	16	14	30	0	3	33	0	0
17	52541342	.	G	A	2	15	17	0	17	34	0	0
17	52553107	.	C	A	15	29	44	0	0	44	0	0
17	52553141	.	T	C	22	15	37	0	1	38	0	0
17	52553270	.	G	A	12	22	34	0	0	34	0	0
17	52565832	.	T	G	6	3	9	0	0	9	0	0
17	52565833	.	C	T	0	3	3	0	6	9	0	0
17	52566100	.	C	T	2	5	7	0	7	14	0	0
17	52566423	.	T	C	4	0	4	0	5	9	0	0
17	52566925	.	A	G	3	7	10	0	0	10	0	0
17	52568040	.	A	C	1	0	1	0	4	5	0	0
17	52570140	.	A	C	3	0	3	0	3	6	0	0
17	52576250	.	G	A	3	3	6	0	0	6	0	0
17	52576316	.	G	A	3	5	8	0	2	10	0	0
17	52576380	.	A	G	4	3	7	0	2	9	0	0
17	52576394	.	C	T	4	2	6	0	0	6	0	0
17	52578489	.	A	G	3	5	8	0	0	8	0	0
17	52578491	.	A	G	2	5	7	0	1	8	0	0
17	52615536	.	A	G	1	2	3	0	0	3	0	0
17	52624619	.	C	G	2	3	5	0	0	5	0	0
17	52624707	.	T	C	1	2	3	0	0	3	0	0
17	52624758	.	A	G	1	3	4	0	0	4	0	0
17	52624926	.	T	G	3	4	7	0	0	7	0	0
17	52629120	.	T	A	4	2	6	0	0	6	0	0
17	52630907	.	A	T	2	1	3	0	1	4	0	0
17	52632139	.	A	G	9	8	17	0	1	18	0	0
17	52632151	.	G	C	8	10	18	0	0	18	0	0
17	52635258	.	A	G	5	6	11	0	0	11	0	0
17	52635261	.	C	T	1	4	5	0	6	11	0	0
17	52635954	.	C	T	1	8	9	0	6	15	0	0
17	52636296	.	T	C	8	0	8	0	5	13	0	0
17	52636829	.	C	T	14	5	19	0	0	19	0	0
17	52636831	.	C	G	14	5	19	0	0	19	0	0
17	52639729	.	C	T	1	18	19	0	6	25	0	0
17	52640311	.	G	A	23	24	47	0	1	48	0	0
17	52640385	.	G	C	25	19	44	0	1	45	0	0
17	52640419	.	C	T	2	18	20	0	22	42	0	0
17	52640540	.	C	T	1	24	25	0	15	40	0	0
17	52640645	.	T	G	17	16	33	0	0	33	0	0
17	52641091	.	A	T	21	17	38	0	4	42	0	0
17	52641571	.	C	T	15	10	25	0	3	28	0	0
17	52641724	.	A	C	14	14	28	0	2	30	0	0
17	52641751	.	G	C	17	0	17	0	16	33	0	0
17	52650878	.	G	C	12	12	24	0	0	24	0	0
17	52840328	.	A	C	20	28	48	0	4	52	0	0
17	52919954	.	C	T	28	30	58	0	1	59	0	0
17	52920291	.	A	T	21	20	41	0	4	45	0	0
17	52920792	.	C	T	32	21	53	0	2	55	0	0
17	52940649	.	T	C	2	2	4	0	0	4	0	0
17	52940710	.	T	C	2	3	5	0	1	6	0	0
17	52940932	.	T	C	3	4	7	0	0	7	0	0
17	52940982	.	T	C	2	3	5	0	1	6	0	0
17	52984470	.	C	A	4	2	6	0	0	6	0	0
17	52987571	.	C	T	2	3	5	0	0	5	0	0
17	53022320	.	C	G	1	3	4	0	1	5	0	0
17	53250861	.	C	T	8	7	15	0	0	15	0	0
17	53250909	.	G	A	0	7	7	0	4	11	0	0
17	53255614	.	T	A	2	2	4	0	1	6	1	0
17	53259471	.	C	G	3	0	3	0	7	10	0	0
17	53274262	.	C	T	0	3	3	0	1	4	0	0
17	53298000	.	C	G	1	1	2	0	9	11	0	0
17	53298033	.	C	T	2	12	14	0	0	14	0	0
17	53298051	.	G	A	8	2	10	0	0	10	0	0
17	53298457	.	A	G	0	4	4	0	1	5	0	0
17	53298472	.	A	G	3	2	5	0	1	6	0	0
17	53298514	.	C	G	7	5	12	0	0	12	0	0
17	53298616	.	G	A	3	2	5	0	2	7	0	0
17	53299346	.	G	T	2	7	9	0	0	9	0	0
17	53299485	.	T	C	1	5	6	0	0	6	0	0
17	53302527	.	T	C	3	7	10	0	0	10	0	0
17	53303980	.	G	C	9	4	13	0	0	13	0	0
17	53304127	.	G	C	1	5	6	0	1	7	0	0
17	53304397	.	T	C	2	6	8	0	0	8	0	0
17	53304566	.	G	A	13	6	19	2	0	21	0	0
17	53304635	.	A	T	11	7	18	1	0	19	0	0
17	53304786	.	T	A	0	5	5	0	1	6	0	0
17	53305318	.	G	C	20	8	28	0	1	29	0	0
17	53305327	.	C	T	17	9	26	0	1	27	0	0
17	53307580	.	C	G	10	17	27	0	2	29	0	0
17	53308737	.	T	C	14	14	28	0	0	28	0	0
17	53308820	.	C	T	2	4	6	0	5	11	0	0
17	53314871	.	A	C	1	3	4	0	0	4	0	0
17	53314981	.	A	G	6	0	6	0	6	12	0	0
17	53315422	.	C	T	6	2	8	0	0	8	0	0
17	53315604	.	G	A	7	3	10	0	1	11	0	0
17	53315750	.	C	G	8	3	11	0	1	12	0	0
17	53317065	.	C	T	8	3	11	0	1	12	0	0
17	53317123	.	T	C	10	4	14	0	0	14	0	0
17	53317175	.	G	A	0	6	6	0	8	14	0	0
17	53317844	.	G	A	0	2	2	0	2	4	0	0
17	53317917	.	A	G	1	8	9	0	1	10	0	0
17	53346648	.	C	A	4	3	7	0	2	9	0	0
17	53348412	.	G	A	1	4	5	0	1	6	0	0
17	53349843	.	T	G	1	4	5	0	0	5	0	0
17	53364181	.	C	T	2	4	6	0	0	6	0	0
17	53393165	.	G	A	21	10	31	0	1	32	0	0
18	1689	.	A	C	12	9	21	0	3	24	0	0
18	1983	.	T	C	10	3	13	0	0	13	0	0
18	2725	.	G	A	10	5	15	0	3	18	0	0
18	11295	.	A	G	6	3	9	0	0	9	0	0
18	17639	.	G	A	10	10	20	0	1	21	0	0
18	17786	.	G	A	18	7	25	0	0	25	0	0
18	17795	.	G	A	19	7	26	0	0	26	0	0
18	18606	.	T	A	14	8	22	0	1	23	0	0
18	18731	.	A	G	12	9	21	0	0	21	0	0
18	22746	.	A	G	15	7	22	0	0	22	0	0
18	22891	.	G	A	17	8	25	0	0	25	0	0
18	36098	.	A	C	1	0	1	0	8	9	0	0
18	54600	.	C	T	2	2	4	0	0	4	0	0
18	58631	.	C	T	2	3	5	0	0	5	0	0
18	60243	.	C	T	2	2	4	0	0	4	0	0
18	73437	.	T	C	1	2	3	0	0	3	0	0
18	73510	.	G	T	2	4	6	0	1	7	0	0
18	73543	.	T	A	6	5	11	0	2	13	0	0
18	73584	.	G	A	18	8	26	0	0	26	0	0
18	73714	.	C	G	15	5	20	0	2	22	0	0
18	73740	.	A	C	12	1	13	0	5	18	0	0
18	74680	.	G	A	12	4	16	3	4	23	0	0
18	74788	.	C	T	1	5	6	0	13	19	0	0
18	74994	.	A	G	9	7	16	0	0	16	0	0
18	79888	.	G	A	8	5	13	0	1	14	0	0
18	79894	.	C	G	9	7	16	0	0	16	0	0
18	81898	.	C	T	4	3	7	0	0	7	0	0
18	82705	.	C	T	7	11	18	0	0	18	0	0
18	97588	.	C	T	3	7	10	0	0	10	0	0
18	97762	.	G	A	5	6	11	0	0	11	0	0
18	97789	.	C	T	5	6	11	0	0	11	0	0
18	98622	.	G	A	2	4	6	0	1	7	0	0
18	100944	.	G	A	0	15	15	0	14	29	0	0
18	102350	.	T	G	10	0	10	0	12	22	0	0
18	102353	.	A	G	10	9	19	0	2	21	0	0
18	103101	.	G	C	1	12	13	0	9	22	0	0
18	104405	.	G	A	0	9	9	0	11	20	0	0
18	106814	.	T	C	15	13	28	0	4	32	0	0
18	107015	.	T	C	8	16	24	0	2	26	0	0
18	107135	.	A	T	17	23	40	0	2	42	0	0
18	107345	.	A	G	21	0	21	2	23	46	0	0
18	114089	.	A	C	9	12	21	0	0	21	0	0
18	114425	.	C	T	3	7	10	0	0	10	0	0
18	114502	.	T	C	9	0	9	0	8	17	0	0
18	114713	.	A	T	13	14	27	0	1	28	0	0
18	117788	.	G	A	14	13	27	0	0	27	0	0
18	118729	.	G	A	17	7	24	0	2	26	0	0
18	118912	.	G	A	8	14	22	0	1	23	0	0
18	127438	.	G	A	6	8	14	0	0	14	0	0
18	127444	.	A	G	6	8	14	0	0	14	0	0
18	127513	.	A	G	4	4	8	0	0	8	0	0
18	127678	.	A	G	2	5	7	0	2	9	0	0
18	130779	.	T	A	4	8	12	0	2	14	0	0
18	131092	.	C	T	0	3	3	0	8	11	0	0
18	135852	.	T	A	2	4	6	0	0	6	0	0
18	137781	.	A	G	2	2	4	0	0	4	0	0
18	144447	.	G	A	3	3	6	0	0	6	0	0
18	146940	.	C	A	1	2	3	0	0	3	0	0
18	173660	.	C	T	10	9	19	0	1	20	0	0
18	173694	.	C	T	8	8	16	0	1	17	0	0
18	173903	.	C	A	14	6	20	0	3	23	0	0
18	184917	.	T	C	5	16	21	0	0	21	0	0
18	193689	.	A	C	12	12	24	0	0	24	0	0
18	193982	.	C	T	16	13	29	0	2	31	0	0
18	194006	.	A	G	16	1	17	0	12	29	0	0
18	194078	.	C	T	19	16	35	0	0	35	0	0
18	194162	.	G	C	3	21	24	0	21	45	0	0
18	194318	.	A	G	12	5	17	0	2	19	0	0
18	194460	.	C	G	4	7	11	0	1	12	0	0
18	194464	.	C	T	2	7	9	0	1	10	0	0
18	204678	.	A	C	6	6	12	0	0	12	0	0
18	204742	.	G	A	10	11	21	0	0	21	0	0
18	204828	.	G	A	14	21	35	0	0	35	0	0
18	204866	.	T	A	9	22	31	0	8	39	0	0
18	204980	.	C	T	21	19	40	0	1	41	0	0
18	204982	.	G	A	19	17	36	0	5	41	0	0
18	205095	.	C	T	0	23	23	0	18	41	0	0
18	205105	.	A	G	16	23	39	0	1	40	0	0
18	205152	.	G	A	32	19	51	0	3	54	0	0
18	205179	.	G	A	23	28	51	0	0	51	0	0
18	207172	.	T	C	18	8	26	0	1	27	0	0
18	207184	.	G	A	16	12	28	0	1	29	0	0
18	207314	.	T	A	12	8	20	0	1	21	0	0
18	209114	.	G	A	14	10	24	0	0	24	0	0
18	209118	.	A	G	13	12	25	0	0	25	0	0
18	209321	.	T	G	13	15	28	0	3	31	0	0
18	209382	.	A	G	11	12	23	0	1	24	0	0
18	210385	.	T	A	14	13	27	0	2	29	0	0
18	210899	.	T	A	1	3	4	0	0	4	0	0
18	211101	.	G	A	20	6	26	0	1	27	0	0
18	211186	.	T	A	21	14	35	0	4	39	0	0
18	211304	.	T	C	15	1	16	0	18	34	0	0
18	211346	.	C	T	2	15	17	0	8	26	1	0
18	211380	.	G	A	17	17	34	0	0	34	0	0
18	211399	.	T	C	21	15	36	0	1	37	0	0
18	211438	.	T	A	21	9	30	1	3	34	0	0
18	211469	.	C	A	16	14	30	1	2	33	0	0
18	211483	.	A	T	17	13	30	1	3	34	0	0
18	211605	.	A	G	14	13	27	0	3	30	0	0
18	211610	.	T	C	13	1	14	0	16	30	0	0
18	211812	.	T	A	15	9	24	0	1	25	0	0
18	211851	.	T	A	9	2	11	0	2	13	0	0
18	212050	.	C	A	20	0	20	5	2	27	0	0
18	212305	.	A	G	26	23	49	0	0	49	0	0
18	214688	.	A	G	16	16	32	0	0	32	0	0
18	214717	.	T	C	13	15	28	0	1	29	0	0
18	216775	.	G	A	15	16	31	0	4	35	0	0
18	216779	.	G	A	16	16	32	0	2	34	0	0
18	220144	.	G	A	11	9	20	0	2	22	0	0
18	222448	.	T	C	12	0	12	0	12	24	0	0
18	334152	.	T	C	7	5	12	0	1	13	0	0
18	334298	.	T	C	2	9	11	1	1	13	0	0
18	334361	.	T	C	3	2	5	0	0	5	0	0
18	334436	.	G	T	1	9	10	1	0	11	0	0
18	334962	.	T	C	5	2	7	0	0	7	0	0
18	336586	.	T	C	6	3	9	0	1	10	0	0
18	494554	.	G	T	1	1	2	0	2	4	0	0
18	501624	.	C	T	1	3	4	0	0	4	0	0
18	581075	.	G	A	0	2	2	0	3	5	0	0
18	600337	.	C	T	4	2	6	0	0	6	0	0
18	609365	.	A	G	5	4	9	0	0	9	0	0
18	609877	.	G	A	10	8	18	0	0	18	0	0
18	609935	.	G	A	1	12	13	0	5	18	0	0
18	610126	.	A	T	12	11	23	0	0	23	0	0
18	610148	.	A	T	8	6	14	0	2	16	0	0
18	610184	.	G	T	8	2	10	0	0	10	0	0
18	610187	.	G	T	7	3	10	0	0	10	0	0
18	610259	.	A	T	7	2	9	0	1	10	0	0
18	610291	.	T	C	5	8	13	0	0	13	0	0
18	610631	.	T	A	6	3	9	0	2	11	0	0
18	642918	.	T	C	9	8	17	1	1	19	0	0
18	643164	.	C	T	5	9	14	0	1	15	0	0
18	660688	.	T	C	4	4	8	0	0	8	0	0
18	660752	.	G	C	0	2	2	0	2	4	0	0
18	789974	.	T	A	11	3	14	0	1	15	0	0
18	790247	.	T	C	6	13	19	0	3	22	0	0
18	790301	.	T	A	12	9	21	0	1	22	0	0
18	790451	.	T	G	16	1	17	0	16	33	0	0
18	790962	.	T	G	8	10	18	0	5	23	0	0
18	791069	.	A	G	13	0	13	0	9	22	0	0
18	791076	.	G	C	13	8	21	0	1	22	0	0
18	791137	.	T	A	16	9	25	0	0	25	0	0
18	791171	.	G	C	10	9	19	0	0	19	0	0
18	791246	.	G	A	11	9	20	0	2	22	0	0
18	791348	.	T	A	2	8	10	0	1	11	0	0
18	791350	.	T	A	4	7	11	0	1	12	0	0
18	791449	.	T	G	3	2	5	0	0	5	0	0
18	791582	.	G	A	0	5	5	0	9	14	0	0
18	809012	.	G	T	23	23	46	0	1	47	0	0
18	824345	.	A	T	2	2	4	0	0	4	0	0
18	824357	.	C	A	2	2	4	0	0	4	0	0
18	824557	.	A	C	1	3	4	0	0	4	0	0
18	824573	.	T	C	1	2	3	0	0	3	0	0
18	824994	.	G	A	3	1	4	0	1	5	0	0
18	824998	.	C	T	3	2	5	0	0	5	0	0
18	825078	.	A	T	5	5	10	0	1	11	0	0
18	826116	.	G	A	5	5	10	0	0	10	0	0
18	826190	.	A	T	10	7	17	0	0	17	0	0
18	826574	.	C	T	5	3	8	0	1	9	0	0
18	826998	.	A	T	6	2	8	0	1	9	0	0
18	888440	.	G	A	13	5	18	0	1	19	0	0
18	891534	.	C	A	9	6	15	0	0	15	0	0
18	891586	.	G	A	4	6	10	0	1	11	0	0
18	911036	.	C	A	3	7	10	0	0	10	0	0
18	911076	.	A	G	15	1	16	0	16	32	0	0
18	925088	.	C	T	15	28	43	0	7	50	0	0
18	925100	.	A	C	15	24	39	0	5	44	0	0
18	933299	.	G	A	25	26	51	0	2	53	0	0
18	936728	.	C	T	36	28	64	0	1	65	0	0
18	939430	.	C	T	24	30	54	0	2	56	0	0
18	951004	.	A	T	39	40	79	0	4	84	1	0
18	951005	.	T	C	39	42	81	0	3	84	0	0
18	964525	.	G	A	1	3	4	0	0	4	0	0
18	974067	.	C	A	2	2	4	0	0	4	0	0
18	974095	.	A	G	2	2	4	0	0	4	0	0
18	1151536	.	C	A	3	2	5	0	0	5	0	0
18	1152220	.	G	A	1	3	4	0	0	4	0	0
18	1154270	.	A	G	4	3	7	0	0	7	0	0
18	1154278	.	A	G	3	3	6	0	0	6	0	0
18	1158399	.	G	A	2	4	6	0	0	6	0	0
18	1161085	.	A	G	12	5	17	0	0	17	0	0
18	1161750	.	A	G	35	33	68	0	0	68	0	0
18	1173819	.	G	A	21	27	48	0	2	50	0	0
18	1173856	.	G	A	25	25	50	0	3	53	0	0
18	1173898	.	A	G	32	25	57	0	2	59	0	0
18	1292100	.	C	T	0	8	8	0	4	12	0	0
18	1292164	.	G	A	9	8	17	0	1	18	0	0
18	1292668	.	T	C	12	0	12	0	10	22	0	0
18	1293182	.	G	A	6	6	12	0	1	13	0	0
18	1363189	.	G	A	1	3	4	0	0	4	0	0
18	1391653	.	A	G	3	2	5	0	0	5	0	0
18	1391674	.	T	C	5	0	5	0	5	10	0	0
18	2173327	.	A	C	2	3	5	0	0	5	0	0
18	2173415	.	G	A	0	2	2	0	2	4	0	0
18	2180636	.	C	T	4	3	7	0	0	7	0	0
18	2190731	.	G	A	1	2	3	0	3	6	0	0
18	2197638	.	A	C	4	6	10	0	0	10	0	0
18	2204386	.	T	C	2	3	5	0	0	5	0	0
18	2205302	.	T	A	3	4	7	0	0	7	0	0
18	2210570	.	C	T	9	6	15	0	1	16	0	0
18	2211091	.	T	C	10	5	15	0	0	15	0	0
18	2215642	.	A	G	3	3	6	0	0	6	0	0
18	2219142	.	C	A	1	2	3	0	0	3	0	0
18	2225632	.	C	T	10	12	22	0	1	23	0	0
18	2225661	.	C	T	15	11	26	0	2	28	0	0
18	2225947	.	T	C	2	4	6	0	0	6	0	0
18	2377645	.	T	C	15	0	15	0	13	28	0	0
18	2378495	.	T	A	6	5	11	0	0	11	0	0
18	2378510	.	C	A	3	6	9	0	1	10	0	0
18	2378619	.	T	G	1	5	6	0	2	8	0	0
18	2378625	.	G	T	2	4	6	0	0	6	0	0
18	2378687	.	A	C	7	7	14	0	1	15	0	0
18	2378713	.	T	G	11	8	19	0	1	20	0	0
18	2378722	.	C	T	0	14	14	0	6	20	0	0
18	2408681	.	C	A	9	9	18	0	0	18	0	0
18	2408886	.	G	A	8	9	17	0	0	17	0	0
18	2412660	.	T	C	5	11	16	0	0	16	0	0
18	2412726	.	G	C	4	12	16	0	0	16	0	0
18	2441690	.	T	C	1	2	3	1	0	4	0	0
18	2533358	.	T	C	1	3	4	0	0	4	0	0
18	2533391	.	C	A	1	4	5	0	0	5	0	0
18	2603576	.	T	G	6	3	9	0	1	10	0	0
18	2603786	.	A	G	8	7	15	0	1	16	0	0
18	2612259	.	A	G	6	5	11	0	2	13	0	0
18	2612293	.	A	G	7	8	15	0	0	15	0	0
18	2619228	.	A	G	8	5	13	0	0	13	0	0
18	2629272	.	G	C	3	2	5	0	0	5	0	0
18	2629347	.	A	G	5	3	8	0	0	8	0	0
18	2631290	.	A	G	1	3	4	0	0	4	0	0
18	2634309	.	T	G	4	5	9	0	0	9	0	0
18	2668603	.	G	A	3	4	7	0	2	9	0	0
18	2681965	.	G	A	12	6	18	0	0	18	0	0
18	2682182	.	C	T	1	12	13	0	12	25	0	0
18	2682203	.	A	T	11	8	19	0	0	19	0	0
18	2682610	.	T	C	17	12	29	0	1	30	0	0
18	2683175	.	T	G	5	5	10	1	0	11	0	0
18	2683181	.	C	T	7	3	10	1	2	13	0	0
18	2683365	.	G	T	3	12	15	0	1	16	0	0
18	2684244	.	T	C	5	9	14	0	3	17	0	0
18	2684250	.	A	G	8	6	14	0	2	16	0	0
18	2684324	.	T	C	10	2	12	0	0	12	0	0
18	2684456	.	T	C	7	6	13	0	1	14	0	0
18	2684458	.	A	G	8	6	14	0	0	14	0	0
18	2684589	.	T	C	2	1	3	1	5	9	0	0
18	2684731	.	A	C	4	3	7	0	0	7	0	0
18	2684750	.	G	A	5	2	7	0	1	8	0	0
18	2684802	.	G	A	6	2	8	0	1	9	0	0
18	2684807	.	C	A	7	3	10	0	1	11	0	0
18	2684889	.	A	T	6	4	10	0	1	11	0	0
18	2685127	.	C	A	3	3	6	0	0	6	0	0
18	2685138	.	C	T	0	4	4	0	4	8	0	0
18	2685162	.	T	C	7	1	8	0	5	13	0	0
18	2685263	.	A	G	7	10	17	0	4	21	0	0
18	2685297	.	A	G	3	6	9	0	2	11	0	0
18	2685312	.	G	A	3	5	8	0	2	10	0	0
18	2685348	.	C	T	1	5	6	0	9	15	0	0
18	2687992	.	C	T	8	10	18	0	0	18	0	0
18	2692381	.	A	C	7	6	13	0	0	13	0	0
18	2702458	.	G	A	4	10	14	0	1	15	0	0
18	2702524	.	C	T	10	11	21	0	1	22	0	0
18	2702536	.	A	G	8	6	14	0	4	18	0	0
18	2702569	.	C	T	0	7	7	0	7	14	0	0
18	2702888	.	T	C	7	0	7	0	13	20	0	0
18	2702976	.	A	C	5	6	11	0	1	12	0	0
18	2703120	.	A	G	4	4	8	0	1	9	0	0
18	2707108	.	G	A	3	5	8	0	0	8	0	0
18	2708467	.	G	A	7	3	10	0	0	10	0	0
18	2708505	.	C	T	2	3	5	0	0	5	0	0
18	2709356	.	T	C	1	5	6	0	0	6	0	0
18	2709395	.	G	A	2	5	7	0	0	7	0	0
18	2710216	.	A	G	3	2	5	0	0	5	0	0
18	2710231	.	T	C	2	0	2	0	3	5	0	0
18	2711894	.	C	G	0	5	5	0	7	12	0	0
18	2713199	.	C	T	4	5	9	0	0	9	0	0
18	2721518	.	T	C	5	4	9	0	1	10	0	0
18	2721565	.	A	G	2	6	8	0	0	8	0	0
18	2902985	.	A	G	8	0	8	0	7	15	0	0
18	2934856	.	A	G	9	5	14	0	1	15	0	0
18	2935243	.	G	C	7	3	10	0	1	11	0	0
18	2935480	.	C	T	13	8	21	0	0	21	0	0
18	3039440	.	A	G	23	36	59	0	5	64	0	0
18	3049752	.	T	G	15	23	38	0	5	43	0	0
18	3049756	.	A	G	26	12	38	0	3	41	0	0
18	3078582	.	C	T	3	7	10	0	0	10	0	0
18	3084698	.	G	A	3	6	9	0	1	10	0	0
18	3087662	.	G	A	4	2	6	0	0	6	0	0
18	3087695	.	T	G	5	3	8	0	0	8	0	0
18	3087704	.	T	A	3	6	9	0	0	9	0	0
18	3089906	.	T	C	1	5	6	0	2	8	0	0
18	3096739	.	C	T	1	2	3	0	0	3	0	0
18	3096873	.	G	A	1	2	3	0	0	3	0	0
18	3096914	.	A	C	1	2	3	0	0	3	0	0
18	3140747	.	G	A	3	2	5	0	0	5	0	0
18	3140795	.	T	C	0	2	2	0	0	2	0	0
18	3140800	.	G	A	0	2	2	0	1	3	0	0
18	3140937	.	C	T	4	3	7	0	0	7	0	0
18	3142685	.	A	G	8	3	11	0	0	11	0	0
18	3144677	.	G	A	2	5	7	0	13	20	0	0
18	3144742	.	A	T	9	8	17	0	1	18	0	0
18	3153072	.	G	C	6	6	12	0	0	12	0	0
18	3153231	.	A	T	3	2	5	0	0	5	0	0
18	3158739	.	A	G	9	11	20	0	1	21	0	0
18	3158776	.	G	A	10	10	20	0	1	21	0	0
18	3158896	.	C	T	5	4	9	2	2	13	0	0
18	3159140	.	C	A	7	6	13	0	1	14	0	0
18	3159193	.	G	A	6	3	9	0	0	9	0	0
18	3159249	.	C	A	2	2	4	1	0	5	0	0
18	3159688	.	T	C	7	3	10	0	1	11	0	0
18	3159865	.	T	C	5	3	8	0	0	8	0	0
18	3159886	.	T	C	4	2	6	0	1	7	0	0
18	3159965	.	A	T	3	6	9	0	1	10	0	0
18	3160188	.	A	T	2	6	8	0	0	8	0	0
18	3160218	.	C	T	0	5	5	0	11	16	0	0
18	3160308	.	A	G	4	5	9	0	1	10	0	0
18	3160354	.	C	T	0	6	6	0	6	12	0	0
18	3160422	.	A	G	6	4	10	0	0	10	0	0
18	3166045	.	C	G	0	2	2	0	3	5	0	0
18	3166180	.	G	A	1	4	5	0	0	5	0	0
18	3259736	.	C	T	29	17	46	0	1	47	0	0
18	3259807	.	C	A	16	17	33	1	6	40	0	0
18	3259847	.	C	T	27	20	47	0	1	48	0	0
18	3265657	.	T	C	13	11	24	0	0	24	0	0
18	3276085	.	G	C	18	19	37	0	0	37	0	0
18	3276187	.	A	G	19	1	20	0	15	35	0	0
18	3283882	.	T	C	20	25	45	0	1	46	0	0
18	3339152	.	G	C	3	4	7	0	0	7	0	0
18	3345141	.	T	A	4	5	9	0	0	9	0	0
18	3349011	.	T	C	5	5	10	0	0	10	0	0
18	3371534	.	G	A	3	2	5	0	0	5	0	0
18	3371543	.	C	T	2	3	5	0	0	5	0	0
18	3371661	.	T	C	1	0	1	0	2	3	0	0
18	3371664	.	A	C	1	2	3	0	0	3	0	0
18	3499022	.	C	G	1	3	4	0	0	4	0	0
18	3501529	.	C	A	1	2	3	0	0	3	0	0
18	3501550	.	A	G	1	2	3	0	0	3	0	0
18	3535934	.	C	G	5	1	6	0	0	6	0	0
18	3535953	.	G	A	5	3	8	0	1	9	0	0
18	3536868	.	A	T	8	9	17	0	0	17	0	0
18	3536937	.	T	C	8	14	22	0	1	23	0	0
18	3539989	.	C	T	1	11	12	0	8	20	0	0
18	3540027	.	C	T	11	9	20	0	0	20	0	0
18	3556542	.	A	G	11	14	25	0	2	27	0	0
18	3556626	.	C	T	2	13	15	0	19	34	0	0
18	3556935	.	C	T	1	4	5	0	1	6	0	0
18	3557043	.	A	T	4	2	6	0	1	7	0	0
18	3572547	.	G	A	8	6	14	0	0	14	0	0
18	3572878	.	T	C	4	8	12	0	1	13	0	0
18	3575938	.	C	A	9	5	14	0	0	14	0	0
18	3576104	.	C	T	12	7	19	0	2	21	0	0
18	3576212	.	A	C	4	4	8	0	2	10	0	0
18	3635443	.	C	G	3	2	5	0	1	6	0	0
18	5170063	.	A	G	33	12	45	0	4	49	0	0
18	5170069	.	A	G	18	0	18	0	30	48	0	0
18	5234937	.	C	A	2	26	28	0	11	39	0	0
18	5234990	.	T	G	16	27	43	0	4	47	0	0
18	5235033	.	C	T	16	21	37	0	1	38	0	0
18	5242329	.	G	A	14	9	23	0	1	24	0	0
18	5243234	.	A	G	16	17	33	0	0	33	0	0
18	5243255	.	T	C	14	16	30	0	3	33	0	0
18	5244632	.	G	A	4	4	8	0	0	8	0	0
18	5244986	.	G	A	5	4	9	0	0	9	0	0
18	5245467	.	G	A	4	6	10	0	0	10	0	0
18	5245480	.	G	A	4	4	8	0	0	8	0	0
18	5245503	.	G	A	3	4	7	0	1	8	0	0
18	5245615	.	G	A	2	4	6	0	0	6	0	0
18	5245806	.	T	C	15	13	28	0	4	32	0	0
18	5245818	.	C	T	1	16	17	0	19	36	0	0
18	5308441	.	T	G	11	12	23	0	0	23	0	0
18	5310018	.	A	G	7	10	17	4	0	21	0	0
18	5316537	.	A	G	4	5	9	0	0	9	0	0
18	5316575	.	C	T	5	4	9	0	1	10	0	0
18	5316708	.	C	G	2	3	5	0	0	5	0	0
18	5318496	.	C	T	1	2	3	0	0	3	0	0
18	5318833	.	G	A	1	2	3	0	0	3	0	0
18	5375143	.	A	G	3	8	11	0	1	12	0	0
18	5378093	.	C	A	0	6	6	0	5	11	0	0
18	5454381	.	G	A	3	2	5	0	0	5	0	0
18	5455161	.	C	T	5	2	7	0	1	8	0	0
18	5455347	.	G	T	0	7	7	0	4	11	0	0
18	5456883	.	C	T	5	3	8	0	0	8	0	0
18	5491697	.	G	A	27	18	45	0	3	48	0	0
18	5494980	.	A	G	13	30	43	0	0	43	0	0
18	5495903	.	T	C	17	11	28	0	8	36	0	0
18	5506578	.	C	T	34	18	52	0	3	55	0	0
18	5509426	.	G	C	21	14	35	0	0	35	0	0
18	5514321	.	T	G	4	2	6	0	1	7	0	0
18	5514544	.	T	A	9	9	18	0	1	19	0	0
18	5514678	.	G	A	2	10	12	0	8	20	0	0
18	5516320	.	C	T	7	6	13	0	0	13	0	0
18	5516984	.	T	C	8	4	12	0	1	13	0	0
18	5518108	.	C	T	10	4	14	0	2	16	0	0
18	5518128	.	T	C	12	4	16	0	1	17	0	0
18	5518749	.	T	C	8	9	17	0	1	18	0	0
18	5518809	.	T	G	9	6	15	0	0	15	0	0
18	5519052	.	C	T	3	3	6	0	0	6	0	0
18	5519119	.	A	G	2	2	4	0	0	4	0	0
18	5519269	.	T	C	9	5	14	0	1	15	0	0
18	5519534	.	T	A	2	3	5	0	1	6	0	0
18	5519622	.	G	A	1	3	4	0	5	9	0	0
18	5535127	.	C	T	1	5	6	0	1	7	0	0
18	5535243	.	G	A	2	3	5	0	1	6	0	0
18	5537129	.	G	C	5	4	9	0	0	9	0	0
18	5537138	.	C	T	3	4	7	0	0	7	0	0
18	5537210	.	T	A	1	2	3	0	0	3	0	0
18	5537211	.	C	T	0	2	2	0	1	3	0	0
18	5537255	.	T	C	4	5	9	0	0	9	0	0
18	5537530	.	A	G	4	3	7	0	0	7	0	0
18	5539488	.	T	C	1	0	1	0	4	5	0	0
18	5539517	.	T	C	2	0	2	0	3	5	0	0
18	5550493	.	G	A	0	3	3	0	1	4	0	0
18	5619919	.	G	A	0	4	4	0	8	12	0	0
18	5619922	.	G	A	8	5	13	0	0	13	0	0
18	5624614	.	A	G	6	7	13	0	2	15	0	0
18	5624654	.	T	A	12	8	20	0	0	20	0	0
18	5626583	.	G	A	8	5	13	0	1	14	0	0
18	5626661	.	A	C	7	2	9	0	0	9	0	0
18	5692205	.	A	G	12	9	21	0	0	21	0	0
18	5692222	.	A	T	10	13	23	0	1	24	0	0
18	6080929	.	A	C	3	0	3	1	6	10	0	0
18	6868454	.	A	G	21	6	27	0	2	29	0	0
18	6869355	.	T	C	5	2	7	0	1	8	0	0
18	7015557	.	T	C	3	2	5	0	0	5	0	0
18	7015600	.	T	C	2	2	4	0	0	4	0	0
18	7571412	.	A	G	1	4	5	0	0	5	0	0
18	7571478	.	G	T	3	2	5	0	0	5	0	0
18	7571548	.	T	C	1	7	8	0	1	9	0	0
18	7571628	.	C	T	4	9	13	0	1	14	0	0
18	8846875	.	A	G	1	6	7	0	1	8	0	0
18	10693077	.	G	A	6	2	8	0	0	8	0	0
18	10693085	.	T	A	5	2	7	0	0	7	0	0
18	10693322	.	A	T	7	7	14	0	0	14	0	0
18	10698083	.	T	C	12	4	16	0	0	16	0	0
18	10698161	.	T	G	7	8	15	0	2	17	0	0
18	10698215	.	T	C	8	5	13	0	1	14	0	0
18	10703669	.	A	G	12	7	19	0	0	19	0	0
18	10708346	.	G	A	1	5	6	0	0	6	0	0
18	10709870	.	C	A	4	6	10	0	0	10	0	0
18	10709876	.	C	A	3	6	9	0	0	9	0	0
18	10710190	.	C	T	0	2	2	0	3	5	0	0
18	10820428	.	A	C	3	4	7	0	0	7	0	0
18	10825951	.	A	G	6	5	11	0	3	14	0	0
18	10840094	.	C	A	4	5	9	0	0	9	0	0
18	10840722	.	C	G	5	4	9	0	2	11	0	0
18	10846601	.	T	C	11	7	18	0	0	18	0	0
18	10847743	.	C	T	6	8	14	0	0	14	0	0
18	10847872	.	A	G	5	9	14	0	0	14	0	0
18	10867181	.	A	C	7	10	17	0	2	19	0	0
18	10870806	.	T	C	3	10	13	0	0	13	0	0
18	10877499	.	G	A	4	8	12	0	0	12	0	0
18	10887826	.	A	G	5	6	11	0	0	11	0	0
18	10888245	.	A	C	3	4	7	0	1	8	0	0
18	10888551	.	T	C	6	6	12	0	1	13	0	0
18	10888836	.	T	C	15	7	22	0	1	23	0	0
18	10889049	.	C	G	5	0	5	0	6	12	1	0
18	10889880	.	G	A	0	3	3	0	9	12	0	0
18	10889901	.	T	A	8	6	14	0	0	14	0	0
18	10889951	.	G	A	11	7	18	0	0	18	0	0
18	10890432	.	G	A	5	11	16	0	0	16	0	0
18	10921408	.	A	T	13	11	24	0	2	26	0	0
18	10921630	.	A	T	10	8	18	0	1	19	0	0
18	10921734	.	T	C	12	8	20	0	0	20	0	0
18	10921791	.	T	C	8	14	22	0	2	24	0	0
18	10921855	.	T	C	13	7	20	0	0	20	0	0
18	10921857	.	G	A	0	7	7	0	13	20	0	0
18	10921927	.	C	T	7	4	11	0	2	13	0	0
18	11507028	.	T	G	3	2	5	0	0	5	0	0
18	11507253	.	T	G	5	3	8	0	0	8	0	0
18	11507263	.	G	A	3	5	8	0	0	8	0	0
18	11515830	.	C	T	3	2	5	0	1	6	0	0
18	11537535	.	T	C	2	4	6	0	0	6	0	0
18	11537703	.	T	G	5	0	5	0	4	9	0	0
18	11548635	.	A	G	5	2	7	0	0	7	0	0
18	11558187	.	G	A	3	3	6	0	0	6	0	0
18	11558197	.	T	C	3	3	6	0	1	7	0	0
18	11558350	.	G	T	2	2	4	0	0	4	0	0
18	11558360	.	G	A	1	2	3	0	0	3	0	0
18	11858876	.	A	G	1	0	1	0	3	4	0	0
18	11862896	.	G	T	3	3	6	0	0	6	0	0
18	11878673	.	C	G	2	2	4	0	0	4	0	0
18	12036434	.	G	A	2	2	4	0	0	4	0	0
18	12058480	.	T	A	3	6	9	0	1	10	0	0
18	12111431	.	A	C	1	2	3	0	0	3	0	0
18	12111625	.	A	G	4	3	7	0	1	8	0	0
18	12111628	.	A	T	4	4	8	0	0	8	0	0
18	12111925	.	G	A	3	5	8	0	0	8	0	0
18	12112105	.	T	C	4	10	14	0	0	14	0	0
18	12112153	.	T	C	5	5	10	0	1	11	0	0
18	12112219	.	C	T	7	4	11	0	0	11	0	0
18	12112246	.	A	G	9	0	9	0	9	18	0	0
18	12112726	.	C	T	2	5	7	0	0	7	0	0
18	12113515	.	C	A	6	2	8	0	0	8	0	0
18	12113516	.	C	T	6	2	8	0	0	8	0	0
18	12148050	.	T	G	7	1	8	0	1	9	0	0
18	12148056	.	C	T	5	2	7	0	0	7	0	0
18	12171277	.	C	T	0	3	3	0	1	4	0	0
18	12171313	.	A	G	3	0	3	0	2	5	0	0
18	12196939	.	G	A	1	3	4	0	0	4	0	0
18	12207046	.	A	G	9	8	17	0	0	17	0	0
18	12207070	.	C	A	9	9	18	0	0	18	0	0
18	12214299	.	A	G	4	5	9	0	0	9	0	0
18	12228217	.	C	A	7	5	12	0	1	13	0	0
18	12228758	.	C	T	3	3	6	0	0	6	0	0
18	12228834	.	G	C	1	3	4	0	0	4	0	0
18	12229120	.	A	T	3	6	9	0	0	9	0	0
18	12229223	.	A	C	4	6	10	0	0	10	0	0
18	12229245	.	C	T	5	2	7	0	0	7	0	0
18	12229405	.	G	A	6	3	9	0	1	10	0	0
18	12236126	.	T	A	1	3	4	0	0	4	0	0
18	12236351	.	C	T	14	8	22	0	0	22	0	0
18	12238082	.	G	A	8	5	13	0	0	13	0	0
18	12240681	.	C	T	13	5	18	0	0	18	0	0
18	12240740	.	G	C	6	5	11	0	1	12	0	0
18	12242967	.	C	T	2	7	9	0	6	15	0	0
18	12245468	.	A	G	1	3	4	0	0	4	0	0
18	12245576	.	A	G	3	2	5	0	0	5	0	0
18	12249400	.	G	A	1	5	6	0	0	6	0	0
18	12251408	.	C	T	1	2	3	0	0	3	0	0
18	12254398	.	A	G	3	1	4	0	0	4	0	0
18	12254409	.	G	A	3	2	5	0	0	5	0	0
18	12254905	.	G	A	1	2	3	0	0	3	0	0
18	12276859	.	C	T	11	13	24	0	1	25	0	0
18	12277052	.	A	G	7	9	16	0	0	16	0	0
18	12277206	.	G	C	12	14	26	0	0	26	0	0
18	12277490	.	G	A	20	21	41	0	1	42	0	0
18	12280269	.	C	T	18	18	36	0	0	36	0	0
18	12292017	.	G	A	19	10	29	0	1	30	0	0
18	12327321	.	C	A	1	5	6	0	2	8	0	0
18	12364876	.	G	A	3	1	4	0	1	5	0	0
18	12366097	.	G	T	2	3	5	0	0	5	0	0
18	12366171	.	C	G	4	2	6	0	0	6	0	0
18	12366855	.	A	T	1	4	5	0	0	5	0	0
18	12370573	.	T	G	1	2	3	0	0	3	0	0
18	12374168	.	A	G	4	2	6	0	0	6	0	0
18	12464867	.	C	A	1	3	4	0	1	5	0	0
18	12465290	.	G	A	6	8	14	0	0	14	0	0
18	12465316	.	C	T	9	8	17	0	1	18	0	0
18	12467834	.	G	C	10	0	10	1	3	14	0	0
18	12470013	.	G	T	5	5	10	0	0	10	0	0
18	12470136	.	G	A	7	7	14	0	0	14	0	0
18	12470148	.	A	G	5	9	14	0	0	14	0	0
18	12470211	.	C	T	0	4	4	0	6	10	0	0
18	12471210	.	T	C	3	3	6	0	0	6	0	0
18	12612031	.	C	T	0	2	2	0	1	3	0	0
18	12612160	.	A	G	3	2	5	0	0	5	0	0
18	12653846	.	G	C	1	2	3	0	0	3	0	0
18	12659226	.	C	T	4	2	6	1	0	7	0	0
18	12776727	.	C	T	7	6	13	0	0	13	0	0
18	12779357	.	T	A	7	7	14	0	0	14	0	0
18	12828500	.	C	T	7	4	11	0	0	11	0	0
18	12833983	.	A	T	3	6	9	0	0	9	0	0
18	12842950	.	A	C	2	0	2	0	2	4	0	0
18	12847500	.	C	T	1	2	3	0	0	3	0	0
18	12847587	.	T	A	2	3	5	0	0	5	0	0
18	12867594	.	C	T	0	2	2	0	1	3	0	0
18	12867807	.	G	A	1	3	4	0	0	4	0	0
18	12871545	.	G	T	4	3	7	0	0	7	0	0
18	12871605	.	C	T	0	6	6	0	4	10	0	0
18	12871650	.	G	A	12	4	16	0	0	16	0	0
18	13063220	.	A	T	3	3	6	0	0	6	0	0
18	13063534	.	G	A	13	16	29	0	0	29	0	0
18	13082686	.	A	G	1	3	4	0	0	4	0	0
18	13102659	.	C	A	3	2	5	0	0	5	0	0
18	13121754	.	G	A	8	4	12	0	2	14	0	0
18	13124621	.	T	C	1	4	5	0	0	5	0	0
18	13125829	.	G	A	6	3	9	0	0	9	0	0
18	13125836	.	G	T	4	5	9	0	0	9	0	0
18	13133040	.	C	T	3	5	8	0	1	9	0	0
18	13196113	.	A	G	2	2	4	0	0	4	0	0
18	13196274	.	T	C	2	0	2	0	2	4	0	0
18	13196285	.	A	G	1	4	5	0	0	5	0	0
18	13215966	.	G	A	24	30	54	0	2	56	0	0
18	13216051	.	C	T	20	23	43	0	1	44	0	0
18	13216566	.	T	A	10	10	20	0	3	23	0	0
18	13236577	.	G	A	5	4	9	0	0	9	0	0
18	13238078	.	G	A	0	5	5	0	3	8	0	0
18	13245795	.	G	A	7	10	17	0	0	17	0	0
18	13245803	.	A	G	6	9	15	0	1	16	0	0
18	13324391	.	G	A	18	12	30	0	6	36	0	0
18	13324416	.	T	C	19	16	35	0	4	39	0	0
18	13324473	.	G	A	13	28	41	0	2	43	0	0
18	13324494	.	T	C	26	1	27	0	9	36	0	0
18	13324747	.	A	G	29	24	53	0	0	53	0	0
18	13325224	.	A	G	22	21	43	0	1	44	0	0
18	13325225	.	C	T	22	19	41	0	3	44	0	0
18	13325451	.	G	T	30	16	46	0	0	46	0	0
18	13325492	.	C	T	11	21	32	0	2	34	0	0
18	13325679	.	C	T	0	12	12	0	4	16	0	0
18	13325912	.	G	A	18	11	29	0	1	30	0	0
18	13326178	.	G	T	9	14	23	0	0	23	0	0
18	13326400	.	C	T	0	8	8	0	9	17	0	0
18	13326593	.	G	C	13	17	30	0	1	31	0	0
18	13336278	.	G	A	8	9	17	0	0	17	0	0
18	13345001	.	C	G	16	11	27	0	0	27	0	0
18	13345088	.	G	A	14	10	24	0	0	24	0	0
18	13345166	.	A	C	12	0	12	0	10	22	0	0
18	13347733	.	G	A	3	9	12	0	2	14	0	0
18	13356438	.	A	G	5	7	12	0	4	16	0	0
18	13837843	.	T	C	1	2	3	0	0	3	0	0
18	13888370	.	A	T	9	4	13	0	2	15	0	0
18	13888406	.	G	A	5	9	14	0	1	15	0	0
18	14041036	.	C	T	12	15	27	0	0	27	0	0
18	14075262	.	A	G	13	10	23	1	0	24	0	0
18	14114915	.	G	A	17	12	29	0	0	29	0	0
18	14114930	.	C	T	17	16	33	0	1	34	0	0
18	14115011	.	A	G	11	20	31	0	3	34	0	0
18	14115083	.	G	C	20	27	47	0	2	49	0	0
18	14132006	.	G	A	4	24	28	0	24	52	0	0
18	14132077	.	A	T	30	21	51	0	2	53	0	0
18	14132360	.	G	A	0	23	23	1	18	42	0	0
18	14132836	.	A	G	22	13	35	0	1	36	0	0
18	14132892	.	T	C	22	17	39	0	2	41	0	0
18	14233809	.	C	A	3	3	6	0	1	7	0	0
18	14334468	.	A	T	13	12	25	0	1	26	0	0
18	14337320	.	T	A	28	23	51	0	1	52	0	0
18	14529721	.	T	C	2	6	8	0	0	8	0	0
18	14529932	.	T	C	4	2	6	0	0	6	0	0
18	14529971	.	A	T	3	1	4	0	1	5	0	0
18	14530273	.	T	A	5	2	7	0	0	7	0	0
18	14622513	.	A	T	3	4	7	0	0	7	0	0
18	14624038	.	T	C	1	2	3	0	0	3	0	0
18	14624161	.	G	T	0	2	2	0	2	4	0	0
18	14625336	.	T	C	1	3	4	0	0	4	0	0
18	14633131	.	T	C	4	4	8	0	1	9	0	0
18	14637888	.	T	C	7	8	15	0	2	17	0	0
18	14642018	.	T	C	1	3	4	0	0	4	0	0
18	14642970	.	A	C	4	3	7	0	0	7	0	0
18	14647432	.	C	T	3	7	10	0	2	12	0	0
18	14648859	.	C	A	6	9	15	0	0	15	0	0
18	14649227	.	G	A	1	8	9	0	3	12	0	0
18	14652676	.	A	G	3	0	3	0	7	10	0	0
18	14660205	.	C	G	4	6	10	1	0	11	0	0
18	14667830	.	A	T	4	3	7	0	0	7	0	0
18	14672230	.	G	A	3	4	7	0	0	7	0	0
18	14672353	.	A	G	5	4	9	0	0	9	0	0
18	14691037	.	T	C	2	6	8	0	0	8	0	0
18	14691133	.	T	C	4	3	7	0	1	8	0	0
18	14691269	.	A	T	5	2	7	0	0	7	0	0
18	14691634	.	G	C	1	3	4	0	0	4	0	0
18	14698371	.	C	T	15	14	29	0	0	29	0	0
18	14698538	.	A	G	11	10	21	0	3	24	0	0
18	14698860	.	A	C	14	11	25	0	3	28	0	0
18	14698928	.	G	T	13	9	22	0	0	22	0	0
18	14699012	.	T	A	7	7	14	0	3	17	0	0
18	14700731	.	A	T	15	10	25	0	0	25	0	0
18	14702153	.	G	A	12	8	20	0	1	21	0	0
18	14702427	.	G	A	8	12	20	0	0	20	0	0
18	14702439	.	T	C	11	10	21	0	0	21	0	0
18	14702511	.	G	T	3	12	15	0	16	31	0	0
18	14705287	.	T	C	10	8	18	0	1	19	0	0
18	14705308	.	A	G	9	8	17	0	0	17	0	0
18	14705371	.	T	C	11	12	23	0	1	24	0	0
18	14705518	.	G	A	0	8	8	0	10	18	0	0
18	14705578	.	G	T	9	7	16	0	0	16	0	0
18	14705770	.	A	T	1	5	6	0	0	6	0	0
18	14705808	.	A	G	1	3	4	0	0	4	0	0
18	14731967	.	T	C	11	0	11	0	14	25	0	0
18	14732128	.	G	A	9	9	18	0	0	18	0	0
18	14732809	.	T	C	10	5	15	0	0	15	0	0
18	14732840	.	T	G	9	4	13	0	4	17	0	0
18	14732859	.	C	T	1	5	6	0	10	16	0	0
18	14732885	.	T	C	11	4	15	0	1	16	0	0
18	14732903	.	T	A	8	3	11	0	0	11	0	0
18	14732923	.	G	A	11	3	14	0	1	15	0	0
18	14732996	.	T	C	8	4	12	0	1	13	0	0
18	14733019	.	C	A	7	3	10	0	2	12	0	0
18	14733114	.	A	T	4	6	10	0	1	11	0	0
18	14733362	.	G	A	5	8	13	0	0	13	0	0
18	14733402	.	C	T	3	8	11	0	0	11	0	0
18	14733638	.	A	G	5	2	7	0	0	7	0	0
18	14733839	.	A	G	2	3	5	0	0	5	0	0
18	14734651	.	C	T	2	3	5	0	0	5	0	0
18	14772889	.	A	G	4	5	9	0	0	9	0	0
18	14772957	.	A	T	8	5	13	0	1	14	0	0
18	14773020	.	T	A	5	8	13	0	0	13	0	0
18	14773140	.	C	T	7	8	15	0	1	16	0	0
18	14779135	.	T	C	5	0	5	0	4	9	0	0
18	14779171	.	G	A	5	2	7	0	1	8	0	0
18	14779192	.	A	G	3	4	7	0	0	7	0	0
18	14780608	.	G	T	5	4	9	0	0	9	0	0
18	14780644	.	A	G	6	2	8	0	0	8	0	0
18	14780816	.	A	G	1	4	5	0	1	6	0	0
18	14780840	.	A	G	4	2	6	0	0	6	0	0
18	14782677	.	C	T	1	2	3	0	0	3	0	0
18	14836628	.	C	G	4	2	6	0	0	6	0	0
18	14836678	.	C	T	5	2	7	0	0	7	0	0
18	14836684	.	G	A	5	2	7	0	0	7	0	0
18	14836744	.	T	C	4	2	6	0	0	6	0	0
18	14836798	.	A	G	1	2	3	0	0	3	0	0
18	14863613	.	T	A	4	5	9	0	0	9	0	0
18	14863675	.	A	G	8	6	14	0	1	15	0	0
18	14863680	.	T	A	8	7	15	0	0	15	0	0
18	14863799	.	A	C	4	0	4	0	6	10	0	0
18	14866506	.	G	A	7	11	18	0	0	18	0	0
18	14866536	.	C	A	6	9	15	0	1	16	0	0
18	14867044	.	T	C	7	0	7	0	7	14	0	0
18	14867144	.	A	C	4	0	4	0	3	7	0	0
18	14867153	.	C	T	4	3	7	0	1	8	0	0
18	14871133	.	C	T	2	2	4	0	0	4	0	0
18	14871145	.	A	G	1	2	3	0	0	3	0	0
18	14871280	.	A	C	2	0	2	0	2	4	0	0
18	14878645	.	C	T	1	2	3	0	0	3	0	0
18	14878673	.	A	C	3	2	5	0	1	6	0	0
18	14886018	.	G	A	2	4	6	0	1	7	0	0
18	14893764	.	A	G	2	4	6	0	0	6	0	0
18	14893825	.	T	C	2	2	4	0	0	4	0	0
18	14909768	.	G	A	3	8	11	0	0	11	0	0
18	14909831	.	A	T	4	4	8	0	0	8	0	0
18	14910929	.	A	G	3	2	5	0	0	5	0	0
18	14910944	.	C	T	2	2	4	0	4	8	0	0
18	14917016	.	T	C	2	1	3	0	1	4	0	0
18	14928654	.	C	T	4	6	10	0	1	11	0	0
18	14928681	.	T	C	5	5	10	0	0	10	0	0
18	14928703	.	C	T	0	6	6	0	6	12	0	0
18	14979139	.	G	A	2	2	4	0	0	4	0	0
18	15100693	.	G	A	2	3	5	0	0	5	0	0
18	15121465	.	G	A	0	3	3	0	1	4	0	0
18	15122894	.	C	T	2	2	4	0	0	4	0	0
18	15122915	.	G	A	0	2	2	0	1	3	0	0
18	15123008	.	C	A	8	4	12	0	0	12	0	0
18	15123011	.	A	G	8	3	11	0	0	11	0	0
18	15125122	.	G	A	7	8	15	0	1	16	0	0
18	15125193	.	A	C	3	5	8	0	1	10	1	0
18	15128960	.	T	C	3	3	6	0	0	6	0	0
18	15128975	.	G	T	5	2	7	0	0	7	0	0
18	15132372	.	T	C	4	5	9	0	0	9	0	0
18	15132383	.	T	C	4	6	10	0	0	10	0	0
18	15136657	.	A	G	2	0	2	0	6	8	0	0
18	15139004	.	T	A	2	4	6	0	0	6	0	0
18	15139049	.	A	G	2	0	2	0	4	6	0	0
18	15139150	.	G	A	10	3	13	0	2	15	0	0
18	15139540	.	C	T	6	6	12	0	0	12	0	0
18	15139757	.	G	A	6	3	9	0	0	9	0	0
18	15139784	.	T	C	3	3	6	0	0	6	0	0
18	15148021	.	T	C	6	4	10	0	0	10	0	0
18	15148063	.	A	C	1	0	1	0	5	6	0	0
18	15148199	.	T	C	5	6	11	0	0	11	0	0
18	15148207	.	A	C	5	7	12	0	0	12	0	0
18	15148248	.	T	C	8	5	13	0	1	14	0	0
18	15148259	.	A	C	9	4	13	0	0	13	0	0
18	15148290	.	A	C	6	4	10	0	0	10	0	0
18	15148304	.	T	C	5	0	5	0	4	9	0	0
18	15148482	.	A	G	3	3	6	0	0	6	0	0
18	15148886	.	G	A	3	4	7	0	0	7	0	0
18	15148912	.	A	G	2	3	5	0	1	6	0	0
18	15148985	.	A	G	1	3	4	0	0	4	0	0
18	15149067	.	G	A	5	3	8	0	0	8	0	0
18	15149068	.	G	T	5	3	8	0	0	8	0	0
18	15149475	.	T	C	2	0	2	0	3	5	0	0
18	15149538	.	T	C	3	4	7	0	0	7	0	0
18	15149550	.	C	T	2	4	6	0	0	6	0	0
18	15289895	.	G	A	0	4	4	0	4	8	0	0
18	15295925	.	C	T	1	5	6	0	6	12	0	0
18	15295976	.	G	T	8	5	13	0	1	14	0	0
18	15296062	.	G	A	8	4	12	0	2	14	0	0
18	15329361	.	G	A	1	2	3	0	0	3	0	0
18	15334703	.	C	T	0	3	3	0	3	6	0	0
18	15334715	.	T	C	2	3	5	0	0	5	0	0
18	15334856	.	G	A	4	2	6	0	0	6	0	0
18	15345315	.	C	T	0	2	2	0	2	4	0	0
18	15345409	.	G	C	1	2	3	0	0	3	0	0
18	15393324	.	G	A	4	2	6	0	1	7	0	0
18	15393787	.	C	G	4	3	7	0	0	7	0	0
18	15394086	.	G	C	2	3	5	0	1	6	0	0
18	15394143	.	T	C	4	2	6	0	0	6	0	0
18	15403754	.	C	T	1	2	3	0	0	3	0	0
18	15459613	.	C	T	1	2	3	0	0	3	0	0
18	15459835	.	T	A	9	3	12	1	2	15	0	0
18	15459871	.	C	T	5	3	8	0	0	8	0	0
18	15469284	.	G	A	2	3	5	0	0	5	0	0
18	15469742	.	G	A	2	2	4	0	0	4	0	0
18	15469783	.	A	G	2	3	5	0	0	5	0	0
18	15469798	.	T	C	2	0	2	0	4	6	0	0
18	15478391	.	T	G	2	6	8	0	0	8	0	0
18	15478394	.	G	A	3	6	9	0	0	9	0	0
18	15478597	.	A	G	7	5	12	0	0	12	0	0
18	15481364	.	T	G	3	3	6	0	0	6	0	0
18	15481636	.	C	T	2	3	5	0	0	5	0	0
18	15483345	.	A	G	5	4	9	0	0	9	0	0
18	15483351	.	C	T	5	4	9	0	0	9	0	0
18	15483994	.	C	T	2	2	4	0	0	4	0	0
18	15490146	.	G	A	5	2	7	0	0	7	0	0
18	15490738	.	A	G	2	2	4	0	0	4	0	0
18	15490739	.	C	T	1	1	2	0	2	4	0	0
18	15512776	.	C	A	0	2	2	0	1	3	0	0
18	15512777	.	G	A	0	2	2	0	1	3	0	0
18	15584670	.	T	G	3	2	5	0	0	5	0	0
18	15635173	.	A	G	1	0	1	0	3	4	0	0
18	15792294	.	T	G	19	15	34	0	1	35	0	0
18	15792368	.	G	C	15	26	41	0	2	43	0	0
18	15792459	.	A	C	19	29	48	0	0	48	0	0
18	15792596	.	T	A	33	22	55	0	0	55	0	0
18	15792611	.	A	G	28	24	52	0	3	55	0	0
18	15792743	.	T	A	21	14	35	0	5	40	0	0
18	15793064	.	A	G	6	7	13	0	1	14	0	0
18	15829588	.	A	G	6	8	14	0	2	16	0	0
18	15836835	.	A	G	7	3	10	0	0	10	0	0
18	15836917	.	A	G	3	4	7	0	1	8	0	0
18	15836961	.	C	T	5	7	12	0	0	12	0	0
18	15858916	.	G	A	1	2	3	0	0	3	0	0
18	15865085	.	G	C	0	2	2	0	2	4	0	0
18	15865154	.	T	C	4	2	6	0	0	6	0	0
18	15865196	.	C	G	9	4	13	0	0	13	0	0
18	15866874	.	T	G	5	4	9	0	0	9	0	0
18	15866876	.	G	T	5	3	8	0	1	9	0	0
18	15869816	.	C	A	2	3	5	0	0	5	0	0
18	15869854	.	T	G	4	0	4	0	4	8	0	0
18	15872092	.	A	G	2	3	5	0	0	5	0	0
18	15872397	.	G	C	3	2	5	0	0	5	0	0
18	15874550	.	C	T	4	3	7	0	1	8	0	0
18	15875196	.	G	A	6	8	14	0	1	15	0	0
18	16111354	.	T	G	3	2	5	0	0	5	0	0
18	16127885	.	A	G	17	14	31	0	2	33	0	0
18	16127927	.	A	C	21	18	39	0	0	39	0	0
18	16128427	.	T	A	6	7	13	0	0	13	0	0
18	16128730	.	A	G	11	10	21	0	0	21	0	0
18	16128960	.	T	G	22	13	35	0	0	35	0	0
18	16129210	.	A	C	19	15	34	0	1	35	0	0
18	16129583	.	T	A	26	18	44	0	1	45	0	0
18	16129862	.	C	T	21	15	36	0	1	37	0	0
18	16133772	.	C	G	7	7	14	0	2	16	0	0
18	16133773	.	T	A	8	8	16	0	0	16	0	0
18	16133822	.	T	C	4	6	10	0	0	10	0	0
18	16140047	.	G	A	9	6	15	0	0	15	0	0
18	16140337	.	G	T	1	23	24	0	16	40	0	0
18	16145618	.	T	G	22	26	48	0	2	50	0	0
18	16145621	.	C	T	23	25	48	0	0	48	0	0
18	16145994	.	C	G	10	8	18	0	0	18	0	0
18	16151809	.	T	A	5	2	7	0	0	7	0	0
18	16151936	.	G	A	10	4	14	0	0	14	0	0
18	16152149	.	G	A	11	5	16	0	1	17	0	0
18	16153487	.	T	C	7	0	7	0	9	16	0	0
18	16158279	.	G	T	3	5	8	0	0	8	0	0
18	16215514	.	A	G	1	2	3	0	0	3	0	0
18	16215523	.	A	G	1	2	3	0	0	3	0	0
18	16215954	.	C	T	1	2	3	0	0	3	0	0
18	16388195	.	G	A	1	4	5	0	0	5	0	0
18	16388342	.	G	A	2	5	7	0	0	7	0	0
18	16388579	.	A	G	3	3	6	0	0	6	0	0
18	16589760	.	G	T	4	2	6	0	0	6	0	0
18	16719963	.	T	C	9	10	19	0	1	20	0	0
18	16720197	.	G	A	13	7	20	0	0	20	0	0
18	16721705	.	G	A	23	23	46	0	0	46	0	0
18	16721741	.	G	A	21	19	40	0	0	40	0	0
18	16722124	.	G	A	22	26	48	0	0	48	0	0
18	16722584	.	G	A	11	15	26	0	3	29	0	0
18	16723514	.	T	C	20	12	32	0	1	33	0	0
18	16723520	.	A	G	19	0	19	0	12	31	0	0
18	16723785	.	A	G	21	0	21	0	18	39	0	0
18	16725225	.	G	A	2	24	26	0	14	40	0	0
18	16725309	.	C	T	26	8	34	0	1	35	0	0
18	16725323	.	C	T	24	9	33	0	2	35	0	0
18	16725917	.	A	G	16	10	26	0	0	26	0	0
18	16726011	.	C	T	16	12	28	0	0	28	0	0
18	16755962	.	C	A	18	20	38	0	3	41	0	0
18	16756001	.	C	T	17	18	35	0	0	35	0	0
18	16756058	.	T	A	7	11	18	0	0	18	0	0
18	16756065	.	G	A	7	12	19	0	0	19	0	0
18	16876903	.	A	G	4	2	6	0	0	6	0	0
18	16885979	.	T	G	7	4	11	0	0	11	0	0
18	16886079	.	C	T	11	6	17	0	2	19	0	0
18	16894571	.	T	A	5	9	14	0	0	14	0	0
18	16894594	.	T	G	5	7	12	0	1	13	0	0
18	16894630	.	A	G	5	8	13	0	0	13	0	0
18	16906522	.	A	G	2	3	5	0	0	5	0	0
18	16918760	.	C	A	2	2	4	0	0	4	0	0
18	16929772	.	G	A	11	15	26	1	0	27	0	0
18	16936429	.	G	A	1	2	3	0	0	3	0	0
18	16936562	.	G	A	0	2	2	0	1	3	0	0
18	16936758	.	T	C	2	2	4	0	0	4	0	0
18	16936787	.	A	G	4	4	8	0	0	8	0	0
18	16961046	.	A	G	15	13	28	0	3	31	0	0
18	16962778	.	A	G	18	7	25	1	0	26	0	0
18	16962783	.	C	T	15	8	23	1	1	25	0	0
18	16962823	.	C	T	13	15	28	0	0	28	0	0
18	16963091	.	C	G	17	11	28	0	0	28	0	0
18	16966911	.	T	C	14	14	28	0	0	28	0	0
18	16968314	.	T	C	12	20	32	0	1	33	0	0
18	16970059	.	G	A	11	2	13	0	0	13	0	0
18	16970132	.	C	T	5	3	8	0	0	8	0	0
18	16970158	.	G	A	2	2	4	0	5	9	0	0
18	16970455	.	A	T	11	8	19	0	1	20	0	0
18	16970459	.	G	A	2	8	10	0	15	25	0	0
18	16970598	.	C	T	12	7	19	0	1	20	0	0
18	16970683	.	C	A	3	4	7	0	0	7	0	0
18	16970684	.	A	G	3	4	7	0	0	7	0	0
18	16970747	.	A	C	3	5	8	0	0	8	0	0
18	16970997	.	G	C	1	8	9	0	17	26	0	0
18	16971129	.	C	T	12	9	21	0	1	22	0	0
18	16971155	.	A	T	10	6	16	0	0	16	0	0
18	16986518	.	C	G	3	3	6	0	0	6	0	0
18	16988095	.	C	A	1	3	4	0	0	4	0	0
18	16988103	.	T	C	1	3	4	0	0	4	0	0
18	16990122	.	C	T	0	5	5	0	6	11	0	0
18	16990150	.	G	T	6	4	10	0	0	10	0	0
18	16990520	.	C	T	4	11	15	0	0	15	0	0
18	16990550	.	A	G	4	8	12	0	1	13	0	0
18	16993352	.	A	T	1	2	3	0	1	4	0	0
18	16998924	.	A	T	0	2	2	0	1	3	0	0
18	17002614	.	T	C	8	0	8	0	7	15	0	0
18	17002653	.	A	G	9	8	17	0	0	17	0	0
18	17003602	.	A	G	4	11	15	0	1	16	0	0
18	17005917	.	T	C	3	4	7	0	1	8	0	0
18	17007458	.	G	A	3	2	5	0	0	5	0	0
18	17007720	.	T	C	2	2	4	0	0	4	0	0
18	17016697	.	T	C	1	2	3	0	0	3	0	0
18	17018541	.	C	G	3	4	7	0	0	7	0	0
18	17062226	.	G	A	5	2	7	0	1	8	0	0
18	17062227	.	G	A	6	2	8	0	0	8	0	0
18	17062323	.	G	A	3	4	7	0	0	7	0	0
18	17062336	.	T	C	1	4	5	0	1	6	0	0
18	17062364	.	T	G	1	3	4	0	0	4	0	0
18	17062487	.	G	T	6	3	9	0	0	9	0	0
18	17062611	.	C	T	3	3	6	0	0	6	0	0
18	17078593	.	T	C	1	4	5	0	0	5	0	0
18	17079156	.	G	C	3	2	5	0	0	5	0	0
18	17079541	.	T	C	14	13	27	4	1	32	0	0
18	17079724	.	C	T	0	9	9	0	13	22	0	0
18	17080089	.	G	C	10	5	15	0	0	15	0	0
18	17080122	.	A	G	8	7	15	0	0	15	0	0
18	17080131	.	T	C	4	0	4	0	9	13	0	0
18	17084489	.	C	T	1	8	9	0	11	20	0	0
18	17097893	.	T	C	12	11	23	0	3	26	0	0
18	17098317	.	T	A	8	9	17	0	0	17	0	0
18	17098562	.	T	A	11	7	18	0	0	19	1	0
18	17102046	.	C	T	0	6	6	0	7	13	0	0
18	17131006	.	A	G	15	4	19	0	0	19	0	0
18	17134780	.	A	G	2	6	8	0	0	8	0	0
18	17144659	.	C	T	3	4	7	0	0	7	0	0
18	17144909	.	T	A	1	6	7	0	0	7	0	0
18	17535748	.	A	T	7	11	18	0	2	20	0	0
18	18421826	.	T	G	4	10	14	0	1	15	0	0
18	18748057	.	G	A	1	3	4	1	0	5	0	0
18	19419200	.	A	T	0	7	7	0	4	11	0	0
18	19419307	.	C	T	8	12	20	0	0	20	0	0
18	19441492	.	C	G	15	20	35	0	2	37	0	0
18	19441561	.	T	C	15	12	27	0	4	31	0	0
18	19441585	.	C	A	13	12	25	0	1	26	0	0
18	19450486	.	T	C	26	28	54	0	2	56	0	0
18	19450563	.	A	T	29	33	62	0	0	62	0	0
18	19450642	.	A	T	22	19	41	0	4	45	0	0
18	19450692	.	A	G	16	20	36	1	2	39	0	0
18	19450755	.	A	G	35	23	58	2	2	63	1	0
18	19451023	.	C	T	16	24	40	1	0	41	0	0
18	19451117	.	C	T	11	9	20	0	1	21	0	0
18	19451427	.	G	A	41	40	81	0	0	81	0	0
18	19451430	.	T	C	42	8	50	0	32	82	0	0
18	19451477	.	G	A	50	32	82	0	2	84	0	0
18	19452126	.	T	A	43	25	68	0	3	71	0	0
18	19452594	.	G	A	28	40	68	0	1	69	0	0
18	19452639	.	A	G	23	42	65	0	5	70	0	0
18	19487779	.	G	A	16	19	35	0	0	35	0	0
18	19490515	.	C	T	15	25	40	0	4	44	0	0
18	19648878	.	T	C	2	3	5	0	0	5	0	0
18	19698539	.	C	T	7	2	9	0	0	9	0	0
18	19698833	.	T	C	3	3	6	0	1	7	0	0
18	19698854	.	G	A	2	4	6	0	0	6	0	0
18	19805440	.	T	C	3	2	5	0	1	6	0	0
18	19805464	.	C	T	2	3	5	0	0	5	0	0
18	19806135	.	T	G	1	2	3	0	0	3	0	0
18	19812874	.	T	C	6	12	18	0	1	19	0	0
18	19812943	.	A	T	10	6	16	0	0	16	0	0
18	19813002	.	A	G	17	10	27	0	0	27	0	0
18	19814181	.	A	G	5	7	12	0	0	12	0	0
18	19815743	.	A	T	9	10	19	0	0	19	0	0
18	19817717	.	G	A	2	5	7	0	0	7	0	0
18	19819719	.	C	A	5	2	7	0	0	7	0	0
18	19883812	.	G	T	0	5	5	0	10	15	0	0
18	19981553	.	G	A	4	3	7	0	0	7	0	0
18	19981584	.	C	T	2	6	8	0	0	8	0	0
18	20006910	.	C	T	2	6	8	0	2	10	0	0
18	20020108	.	A	T	7	5	12	0	0	12	0	0
18	20022806	.	T	C	5	2	7	0	1	8	0	0
18	20024856	.	T	C	3	9	12	0	0	12	0	0
18	20024889	.	G	A	3	7	10	0	1	11	0	0
18	20034058	.	T	A	3	6	9	0	0	9	0	0
18	20041825	.	T	C	10	15	25	0	1	26	0	0
18	20042088	.	C	T	18	18	36	0	0	36	0	0
18	20044847	.	T	C	7	12	19	0	2	21	0	0
18	20045197	.	T	C	3	2	5	0	0	5	0	0
18	20468514	.	G	T	1	8	9	0	6	15	0	0
18	20473464	.	T	C	4	9	13	0	1	14	0	0
18	20479008	.	A	G	5	9	14	0	0	14	0	0
18	20482805	.	C	T	2	2	4	0	0	4	0	0
18	20488879	.	G	A	1	3	4	0	0	4	0	0
18	20489011	.	T	C	2	3	5	0	0	5	0	0
18	20489224	.	G	A	4	2	6	0	0	6	0	0
18	20489348	.	G	A	4	2	6	0	0	6	0	0
18	20490510	.	A	T	1	2	3	0	0	3	0	0
18	20490544	.	T	A	1	2	3	0	0	3	0	0
18	20490690	.	A	T	1	2	3	0	0	3	0	0
18	20490715	.	A	G	2	2	4	0	0	4	0	0
18	20490768	.	A	T	5	3	8	0	0	8	0	0
18	20490834	.	T	C	5	4	9	0	0	9	0	0
18	20490872	.	A	C	1	2	3	0	1	4	0	0
18	20518915	.	C	G	3	5	8	0	0	8	0	0
18	20518930	.	T	C	3	7	10	0	0	10	0	0
18	20520982	.	G	T	3	2	5	0	0	5	0	0
18	20521053	.	T	G	2	6	8	0	0	8	0	0
18	20521431	.	A	T	1	4	5	0	0	5	0	0
18	20521515	.	C	G	1	4	5	0	0	5	0	0
18	20532660	.	G	A	4	5	9	0	0	9	0	0
18	20533934	.	G	A	2	5	7	0	0	7	0	0
18	20534277	.	A	T	7	3	10	0	0	10	0	0
18	20535074	.	T	A	8	9	17	0	0	17	0	0
18	20536533	.	A	G	5	1	6	0	3	9	0	0
18	20539548	.	G	A	1	7	8	0	9	17	0	0
18	20539844	.	T	A	2	5	7	1	1	9	0	0
18	20539979	.	T	A	7	4	11	0	0	11	0	0
18	20540581	.	G	T	4	2	6	0	0	6	0	0
18	20540606	.	A	T	2	3	5	0	0	5	0	0
18	20541575	.	A	C	7	7	14	0	0	14	0	0
18	20541863	.	C	G	1	2	3	0	0	3	0	0
18	20542214	.	A	T	8	4	12	0	0	12	0	0
18	20542503	.	G	A	14	10	24	0	0	24	0	0
18	20542526	.	G	A	18	10	28	0	0	28	0	0
18	20542562	.	T	G	18	8	26	0	0	26	0	0
18	20542581	.	A	G	14	7	21	0	1	22	0	0
18	20542647	.	C	T	7	10	17	0	0	17	0	0
18	20542899	.	T	A	8	10	18	0	1	19	0	0
18	20542929	.	T	C	11	8	19	0	0	19	0	0
18	20544883	.	G	A	6	5	11	0	0	11	0	0
18	20544901	.	G	C	5	7	12	0	0	12	0	0
18	20559571	.	G	A	4	5	9	0	2	11	0	0
18	20581942	.	A	G	2	3	5	0	0	5	0	0
18	20582413	.	T	A	9	5	14	0	0	14	0	0
18	20582629	.	T	C	4	5	9	0	1	10	0	0
18	20582694	.	G	A	6	3	9	0	0	9	0	0
18	20582943	.	G	A	2	2	4	0	0	4	0	0
18	20583154	.	G	T	1	3	4	0	1	5	0	0
18	20583398	.	C	T	2	4	6	0	1	7	0	0
18	20583763	.	A	G	3	11	14	0	0	14	0	0
18	20584077	.	G	A	2	4	6	0	0	6	0	0
18	20584098	.	T	A	3	2	5	0	1	6	0	0
18	20585314	.	C	T	5	7	12	0	0	12	0	0
18	20585495	.	C	T	2	4	6	0	0	6	0	0
18	20594104	.	G	A	3	4	7	0	0	7	0	0
18	20726232	.	T	C	24	3	27	0	27	54	0	0
18	20730583	.	G	A	17	12	29	0	1	30	0	0
18	20735371	.	C	T	15	12	27	0	1	28	0	0
18	20735413	.	C	T	1	11	12	0	18	30	0	0
18	20738244	.	T	A	17	13	30	0	3	33	0	0
18	20738262	.	A	G	13	13	26	0	1	27	0	0
18	20738298	.	G	A	6	10	16	0	0	16	0	0
18	20738383	.	G	A	12	18	30	0	1	31	0	0
18	20739298	.	C	T	13	8	21	0	2	23	0	0
18	20742025	.	G	A	16	14	30	0	0	30	0	0
18	20752879	.	C	T	2	14	16	0	13	29	0	0
18	20755854	.	T	A	18	6	24	0	0	24	0	0
18	20760425	.	C	T	13	13	26	0	1	27	0	0
18	20768686	.	C	T	10	11	21	0	4	25	0	0
18	20768818	.	T	A	8	6	14	0	0	14	0	0
18	20771078	.	T	C	3	0	3	0	7	10	0	0
18	20771085	.	A	G	7	3	10	0	0	10	0	0
18	20859790	.	A	G	2	7	9	0	1	10	0	0
18	20859802	.	A	G	2	6	8	0	1	9	0	0
18	20859992	.	G	A	3	2	5	0	0	5	0	0
18	20860321	.	C	T	6	3	9	0	0	9	0	0
18	20860423	.	T	C	1	0	1	0	4	5	0	0
18	20861350	.	G	A	3	7	10	0	0	10	0	0
18	20865543	.	T	C	1	2	3	0	0	3	0	0
18	20868503	.	C	G	1	2	3	0	0	3	0	0
18	20869033	.	T	A	2	3	5	0	0	5	0	0
18	20881800	.	G	A	2	3	5	0	1	6	0	0
18	20882057	.	G	A	2	3	5	0	0	5	0	0
18	20882062	.	T	C	2	0	2	0	3	5	0	0
18	20883141	.	A	G	4	5	9	0	0	9	0	0
18	20897925	.	C	A	4	2	6	0	0	6	0	0
18	20909723	.	C	T	1	3	4	0	0	4	0	0
18	20917407	.	T	C	1	2	3	0	0	3	0	0
18	21071085	.	A	G	8	0	8	0	4	12	0	0
18	21102019	.	A	C	6	5	11	0	0	11	0	0
18	21102023	.	C	T	0	4	4	0	6	10	0	0
18	21102764	.	C	T	1	4	5	0	6	11	0	0
18	21102914	.	G	A	2	1	3	0	1	4	0	0
18	21103043	.	G	A	2	2	4	0	1	5	0	0
18	21103079	.	G	A	6	2	8	0	0	8	0	0
18	21103334	.	A	C	2	2	4	0	0	4	0	0
18	21105927	.	A	G	3	3	6	0	0	6	0	0
18	21105945	.	G	A	3	3	6	0	0	6	0	0
18	21114475	.	T	C	8	4	12	0	1	13	0	0
18	21115175	.	C	T	2	7	9	0	1	10	0	0
18	21116381	.	C	A	5	8	13	0	0	13	0	0
18	21117801	.	C	T	7	13	20	0	1	21	0	0
18	21118232	.	C	G	8	11	19	0	0	19	0	0
18	21119498	.	G	A	11	4	15	0	0	15	0	0
18	21119654	.	G	A	14	7	21	0	0	21	0	0
18	21119751	.	C	T	9	16	25	0	1	26	0	0
18	21119854	.	T	C	12	6	18	0	2	20	0	0
18	21136729	.	C	T	14	10	24	0	0	24	0	0
18	21136948	.	C	T	18	16	34	0	2	36	0	0
18	21143473	.	A	T	17	20	37	0	2	39	0	0
18	21143787	.	C	A	6	20	26	0	1	27	0	0
18	21143938	.	C	G	19	13	32	0	0	32	0	0
18	21143998	.	C	T	16	19	35	0	2	37	0	0
18	21144005	.	C	A	13	20	33	0	1	34	0	0
18	21144060	.	G	A	2	28	30	0	11	41	0	0
18	21144656	.	C	T	3	4	7	0	0	7	0	0
18	21144748	.	T	C	3	3	6	0	0	6	0	0
18	21144758	.	C	A	3	3	6	0	1	7	0	0
18	21144823	.	C	A	1	7	8	0	0	8	0	0
18	21144852	.	A	G	6	11	17	0	0	17	0	0
18	21144880	.	G	T	14	9	23	0	2	25	0	0
18	21144985	.	C	T	4	6	10	0	1	11	0	0
18	21145142	.	A	G	11	10	21	0	3	24	0	0
18	21145290	.	G	T	2	11	13	0	0	13	0	0
18	21178865	.	T	G	5	3	8	0	0	8	0	0
18	21179063	.	C	T	5	2	7	0	0	7	0	0
18	21179064	.	A	T	6	1	7	0	0	7	0	0
18	21179135	.	T	C	3	6	9	0	0	9	0	0
18	21179158	.	G	C	7	3	10	0	0	10	0	0
18	21179181	.	A	T	3	4	7	0	0	7	0	0
18	21179228	.	G	C	5	6	11	0	0	11	0	0
18	21179369	.	T	C	10	16	26	0	1	27	0	0
18	21179484	.	G	A	14	7	21	1	1	23	0	0
18	21179566	.	T	C	8	11	19	1	0	20	0	0
18	21179730	.	A	G	6	9	15	2	0	17	0	0
18	21182879	.	A	G	6	4	10	0	1	11	0	0
18	21185167	.	A	G	6	9	15	0	0	15	0	0
18	21198961	.	G	T	23	19	42	0	2	44	0	0
18	21199165	.	G	T	22	11	33	0	2	35	0	0
18	21201953	.	G	A	22	27	49	0	2	51	0	0
18	21203739	.	C	T	25	22	47	0	1	49	1	0
18	21257600	.	A	T	12	4	16	0	1	17	0	0
18	21257623	.	A	G	6	11	17	0	1	18	0	0
18	21257757	.	G	A	5	11	16	0	0	16	0	0
18	21257786	.	G	A	9	8	17	0	0	17	0	0
18	21257816	.	G	T	11	9	20	0	1	21	0	0
18	21257946	.	C	T	8	14	22	0	1	23	0	0
18	21258083	.	G	A	6	9	15	0	0	15	0	0
18	21263268	.	C	T	1	5	6	0	10	16	0	0
18	21400391	.	T	A	1	3	4	0	0	4	0	0
18	21409113	.	A	T	15	10	25	0	1	26	0	0
18	21492325	.	T	C	14	9	23	0	4	27	0	0
18	21617864	.	G	A	1	19	20	0	35	55	0	0
18	21618343	.	C	T	18	22	40	0	1	41	0	0
18	21618379	.	A	G	21	20	41	0	0	41	0	0
18	21618496	.	G	A	25	17	42	0	1	43	0	0
18	21618659	.	C	A	20	19	39	0	1	40	0	0
18	21618731	.	G	T	20	20	40	0	5	45	0	0
18	21618910	.	G	T	31	23	54	0	2	56	0	0
18	21619011	.	C	T	21	20	41	0	2	43	0	0
18	21619018	.	A	T	21	22	43	0	2	45	0	0
18	21619055	.	G	T	22	20	42	0	3	45	0	0
18	21619260	.	C	T	18	15	33	0	1	34	0	0
18	21619284	.	G	T	14	21	35	1	0	36	0	0
18	21619672	.	A	G	27	23	50	1	1	52	0	0
18	21619686	.	G	A	27	22	49	1	1	51	0	0
18	21619777	.	A	G	28	28	56	2	1	59	0	0
18	21619799	.	T	G	34	28	62	0	1	63	0	0
18	21619948	.	C	T	20	28	48	1	0	49	0	0
18	21620082	.	A	T	22	17	39	0	2	41	0	0
18	21620376	.	A	C	22	31	53	0	0	53	0	0
18	21620426	.	G	A	7	25	32	0	26	58	0	0
18	21645492	.	G	A	7	5	12	0	2	14	0	0
18	21645627	.	A	G	5	9	14	0	0	14	0	0
18	21645902	.	G	C	19	0	19	0	13	32	0	0
18	21645965	.	G	A	15	14	29	0	9	38	0	0
18	21645989	.	T	G	16	15	31	0	2	33	0	0
18	21647419	.	T	C	7	7	14	0	0	14	0	0
18	21648522	.	C	T	9	8	17	1	0	18	0	0
18	21648582	.	A	G	9	7	16	0	1	17	0	0
18	21648627	.	C	T	7	3	10	0	2	12	0	0
18	21648633	.	A	T	9	3	12	0	0	12	0	0
18	21653937	.	C	T	9	13	22	0	0	22	0	0
18	21654124	.	A	C	9	2	11	0	6	17	0	0
18	21654145	.	C	T	9	9	18	0	0	18	0	0
18	21654375	.	C	A	5	3	8	0	0	8	0	0
18	21654432	.	T	C	3	3	6	0	0	6	0	0
18	21654489	.	C	T	7	10	17	0	1	18	0	0
18	21656271	.	C	A	3	5	8	0	0	8	0	0
18	21656274	.	G	A	6	2	8	0	0	8	0	0
18	21656605	.	C	T	2	7	9	0	0	9	0	0
18	21657642	.	T	G	3	3	6	0	0	6	0	0
18	21662301	.	C	A	2	3	5	0	0	5	0	0
18	21662319	.	C	T	6	4	10	0	0	10	0	0
18	21674320	.	G	T	3	2	5	0	0	5	0	0
18	21678723	.	G	A	1	3	4	0	0	4	0	0
18	21689043	.	G	C	9	15	24	0	0	24	0	0
18	21689052	.	A	G	7	15	22	0	2	24	0	0
18	21689079	.	G	A	18	4	22	0	1	23	0	0
18	21693120	.	A	G	7	4	11	0	0	11	0	0
18	21693213	.	G	A	5	13	18	0	0	18	0	0
18	21693441	.	G	A	6	4	10	0	1	11	0	0
18	21697776	.	C	T	5	8	13	0	1	14	0	0
18	21698855	.	G	T	5	6	11	0	2	13	0	0
18	21699581	.	A	T	2	4	6	0	2	8	0	0
18	21704498	.	C	T	1	3	4	0	1	5	0	0
18	21704559	.	G	T	4	2	6	0	0	6	0	0
18	21724334	.	G	A	3	3	6	0	0	6	0	0
18	21724407	.	C	T	2	4	6	0	0	6	0	0
18	21728604	.	A	G	4	4	8	0	0	8	0	0
18	21729843	.	T	C	1	0	1	0	2	3	0	0
18	21729849	.	T	C	1	2	3	0	0	3	0	0
18	21782362	.	T	G	1	4	5	0	0	5	0	0
18	21782445	.	T	G	5	2	7	0	0	7	0	0
18	21782467	.	A	C	1	5	6	0	0	6	0	0
18	21782500	.	A	G	1	5	6	0	0	6	0	0
18	21782506	.	G	C	1	3	4	0	0	4	0	0
18	21782908	.	G	A	6	4	10	0	0	10	0	0
18	21783009	.	T	G	6	4	10	0	0	10	0	0
18	21783010	.	A	C	6	4	10	0	0	10	0	0
18	21783049	.	G	C	5	7	12	0	0	12	0	0
18	21783077	.	C	T	4	6	10	0	1	11	0	0
18	21783087	.	G	A	6	5	11	0	0	11	0	0
18	21783279	.	G	A	2	2	4	0	0	4	0	0
18	21783325	.	A	T	8	5	13	0	0	13	0	0
18	21783368	.	G	A	10	8	18	0	0	18	0	0
18	21796094	.	G	A	2	2	4	0	1	5	0	0
18	21860755	.	C	T	7	8	15	0	1	16	0	0
18	21861134	.	T	A	10	15	25	0	1	26	0	0
18	21861225	.	T	A	10	12	22	0	1	23	0	0
18	21861381	.	G	T	10	10	20	0	0	20	0	0
18	21861497	.	A	T	10	11	21	0	1	22	0	0
18	21861688	.	C	A	6	4	10	0	1	11	0	0
18	21861934	.	C	T	13	5	18	0	0	18	0	0
18	21862000	.	G	C	10	8	18	0	0	18	0	0
18	21862076	.	C	T	2	5	7	0	9	16	0	0
18	21862141	.	T	C	6	0	6	0	10	16	0	0
18	21862175	.	C	T	0	3	3	0	7	10	0	0
18	21862237	.	G	T	3	6	9	0	1	10	0	0
18	21862346	.	T	A	13	7	20	0	0	20	0	0
18	21880191	.	T	C	8	0	8	0	9	17	0	0
18	21888256	.	C	T	2	5	7	0	1	8	0	0
18	21890428	.	G	C	4	2	6	0	0	6	0	0
18	21900961	.	G	A	1	2	3	0	0	3	0	0
18	21904846	.	T	A	2	2	4	0	0	4	0	0
18	21913799	.	A	T	16	15	31	0	1	32	0	0
18	21913907	.	G	C	14	7	21	0	0	21	0	0
18	21913988	.	C	A	15	13	28	0	0	28	0	0
18	21914018	.	C	A	13	10	23	0	1	24	0	0
18	21914225	.	C	T	2	19	21	0	13	34	0	0
18	21914281	.	G	A	18	10	28	0	2	30	0	0
18	21914283	.	C	A	18	9	27	0	2	29	0	0
18	21943208	.	C	T	1	2	3	0	1	4	0	0
18	22002476	.	G	A	4	6	10	0	0	10	0	0
18	22002508	.	C	T	5	6	11	0	0	11	0	0
18	22029828	.	A	C	8	0	8	0	11	19	0	0
18	22030435	.	C	T	3	2	5	0	0	5	0	0
18	22082366	.	T	C	6	8	14	0	0	14	0	0
18	22255005	.	C	T	2	2	4	0	0	4	0	0
18	22261064	.	C	A	4	6	10	0	1	11	0	0
18	22267741	.	C	T	5	3	8	0	0	8	0	0
18	22267819	.	T	A	2	4	6	0	0	6	0	0
18	22272969	.	C	A	7	14	21	0	0	21	0	0
18	22275051	.	T	C	8	9	17	0	0	17	0	0
18	22282766	.	A	T	10	13	23	0	2	25	0	0
18	22282809	.	A	T	13	11	24	0	1	25	0	0
18	22282923	.	G	T	11	7	18	0	0	18	0	0
18	22282960	.	C	T	11	8	19	0	0	19	0	0
18	22282961	.	A	G	11	8	19	0	0	19	0	0
18	22283087	.	C	A	9	8	17	0	1	18	0	0
18	22283116	.	T	A	5	6	11	0	0	11	0	0
18	22288650	.	T	C	6	7	13	0	6	19	0	0
18	22288659	.	C	T	6	8	14	0	4	18	0	0
18	22289075	.	T	C	9	6	15	0	0	15	0	0
18	22289314	.	C	T	13	4	17	0	0	17	0	0
18	22290900	.	G	A	16	14	30	0	4	34	0	0
18	22290933	.	C	T	14	13	27	0	2	29	0	0
18	22292215	.	A	T	19	9	28	0	0	28	0	0
18	22292286	.	G	A	24	10	34	0	1	35	0	0
18	22292339	.	A	T	12	14	26	0	3	29	0	0
18	22293192	.	T	G	3	3	6	0	1	7	0	0
18	22356989	.	C	T	13	6	19	0	1	20	0	0
18	22377096	.	A	T	20	20	40	0	0	40	0	0
18	22377372	.	G	A	2	28	30	0	21	51	0	0
18	22377471	.	C	T	19	18	37	0	0	37	0	0
18	22385900	.	G	A	27	23	50	0	7	57	0	0
18	22405895	.	A	T	1	5	6	0	0	6	0	0
18	22406162	.	C	T	1	3	4	0	4	8	0	0
18	22406187	.	T	A	4	5	9	0	0	9	0	0
18	22406311	.	T	A	3	4	7	0	0	7	0	0
18	22406324	.	G	A	2	5	7	0	0	7	0	0
18	22406375	.	T	A	2	2	4	0	0	4	0	0
18	22406379	.	G	A	1	2	3	0	0	3	0	0
18	22406973	.	T	C	3	2	5	0	0	5	0	0
18	22407365	.	C	T	1	6	7	0	3	10	0	0
18	22417058	.	C	T	2	2	4	0	0	4	0	0
18	22417082	.	G	A	1	6	7	0	3	10	0	0
18	22417103	.	C	A	7	7	14	0	0	14	0	0
18	22420551	.	A	T	3	8	11	0	0	11	0	0
18	22420558	.	C	A	1	7	8	0	1	9	0	0
18	22424532	.	T	C	1	3	4	1	0	5	0	0
18	22424536	.	A	G	2	0	2	1	3	6	0	0
18	22424601	.	A	G	7	0	7	0	12	19	0	0
18	22486579	.	A	T	7	5	12	0	1	13	0	0
18	22669708	.	C	G	2	2	4	0	0	4	0	0
18	22679242	.	A	T	2	3	5	0	0	5	0	0
18	22679275	.	C	T	3	4	7	0	0	7	0	0
18	22679684	.	G	A	2	2	4	0	1	5	0	0
18	22685266	.	G	A	0	4	4	0	5	9	0	0
18	22685278	.	C	T	5	3	8	0	0	8	0	0
18	22685329	.	T	C	3	8	11	0	1	12	0	0
18	22685380	.	A	T	3	7	10	0	0	10	0	0
18	22685608	.	C	A	8	10	18	0	1	19	0	0
18	22686269	.	A	T	3	10	13	0	0	13	0	0
18	22686320	.	G	A	2	3	5	0	0	5	0	0
18	22686358	.	G	A	2	2	4	0	1	5	0	0
18	22686588	.	C	A	3	7	10	0	0	11	1	0
18	22686723	.	C	T	5	7	12	0	0	12	0	0
18	22686789	.	G	A	7	6	13	0	0	13	0	0
18	22686795	.	C	G	7	8	15	0	1	16	0	0
18	22686927	.	G	A	0	5	5	0	0	5	0	0
18	22687312	.	G	A	8	11	19	0	1	20	0	0
18	22687439	.	A	G	12	0	12	0	12	24	0	0
18	22687527	.	G	C	19	15	34	0	0	34	0	0
18	22687575	.	T	A	25	13	38	0	1	40	1	0
18	22687599	.	A	T	12	22	34	0	1	35	0	0
18	22687666	.	C	T	17	14	31	1	1	33	0	0
18	22728794	.	A	G	10	9	19	0	2	21	0	0
18	22732391	.	A	G	7	14	21	0	0	21	0	0
18	22921942	.	C	T	25	14	39	0	3	42	0	0
18	22921950	.	T	C	25	13	38	0	2	40	0	0
18	22975090	.	T	C	35	27	62	0	1	63	0	0
18	22975297	.	A	C	31	27	58	0	0	58	0	0
18	23070059	.	T	C	2	2	4	0	1	5	0	0
18	23071099	.	G	A	3	1	4	0	1	5	0	0
18	23071621	.	A	C	1	2	3	0	0	3	0	0
18	23072049	.	C	T	1	2	3	0	0	3	0	0
18	23072050	.	T	A	1	2	3	0	0	3	0	0
18	23072164	.	G	A	2	4	6	0	0	6	0	0
18	23249388	.	G	A	0	2	2	0	3	5	0	0
18	23270093	.	C	T	1	6	7	0	0	7	0	0
18	23869134	.	C	T	23	21	44	0	0	44	0	0
18	23869784	.	T	A	23	16	39	0	0	39	0	0
18	23870092	.	G	A	25	16	41	0	3	44	0	0
18	23870837	.	C	T	10	10	20	0	0	20	0	0
18	24922149	.	G	A	1	3	4	0	0	4	0	0
18	24929460	.	G	A	1	9	10	0	6	16	0	0
18	24929465	.	T	C	9	7	16	0	0	16	0	0
18	24930189	.	G	A	10	9	19	0	0	19	0	0
18	24930530	.	T	C	18	10	28	0	2	30	0	0
18	24930758	.	T	C	20	21	41	0	2	43	0	0
18	24931044	.	T	A	18	18	36	0	1	37	0	0
18	24931634	.	A	G	18	25	43	0	5	48	0	0
18	24931660	.	G	T	17	20	37	0	1	38	0	0
18	24934333	.	A	T	7	3	10	0	2	12	0	0
18	24934456	.	G	A	20	10	30	0	1	31	0	0
18	24934692	.	C	A	10	6	16	0	0	16	0	0
18	24935099	.	A	G	19	19	38	0	0	38	0	0
18	24938712	.	A	G	5	7	12	0	2	14	0	0
18	24938805	.	A	G	11	19	30	0	0	30	0	0
18	24938871	.	T	C	10	14	24	0	0	24	0	0
18	24938919	.	C	T	7	6	13	0	1	14	0	0
18	24944039	.	A	T	7	5	12	0	0	12	0	0
18	24944045	.	T	C	5	4	9	0	0	9	0	0
18	24946727	.	T	A	7	5	12	0	0	12	0	0
18	24947618	.	G	A	10	3	13	0	0	13	0	0
18	24950214	.	C	T	6	4	10	0	2	12	0	0
18	24952245	.	T	G	7	6	13	0	0	13	0	0
18	24959289	.	G	A	1	3	4	0	0	4	0	0
18	24968639	.	C	T	2	3	5	0	0	5	0	0
18	24969445	.	A	G	2	2	4	0	0	4	0	0
18	24989025	.	T	A	1	5	6	0	0	6	0	0
18	25003359	.	A	T	11	12	23	0	0	23	0	0
18	25003448	.	G	C	12	7	19	0	1	20	0	0
18	25009326	.	C	A	16	7	23	0	0	23	0	0
18	25009352	.	G	A	9	14	23	0	1	24	0	0
18	25009487	.	A	G	2	6	8	0	1	9	0	0
18	25754551	.	G	A	6	7	13	0	0	13	0	0
18	25754580	.	G	T	5	3	8	0	0	8	0	0
18	25754770	.	G	A	0	3	3	0	1	4	0	0
18	26089004	.	G	C	2	3	5	0	0	5	0	0
18	26089305	.	G	C	2	2	4	0	0	4	0	0
18	26089657	.	C	T	1	2	3	0	0	3	0	0
18	26094421	.	C	T	4	3	7	0	0	7	0	0
18	26094491	.	A	C	1	5	6	0	1	7	0	0
18	26097091	.	G	T	28	40	68	0	3	71	0	0
18	26097428	.	G	A	31	37	68	0	3	71	0	0
18	26125983	.	A	G	1	3	4	0	0	4	0	0
18	26126046	.	C	T	2	2	4	0	1	5	0	0
18	26338420	.	C	T	9	6	15	0	0	15	0	0
18	26393716	.	C	A	24	18	42	0	1	43	0	0
18	26401680	.	T	C	18	20	38	0	4	42	0	0
18	26401719	.	T	C	24	15	39	0	0	39	0	0
18	26401743	.	C	T	11	23	34	0	2	36	0	0
18	26405271	.	G	A	11	22	33	0	1	34	0	0
18	26422751	.	G	C	1	3	4	0	0	5	1	0
18	26425376	.	G	A	4	4	8	0	0	8	0	0
18	26445228	.	C	T	4	5	9	0	1	10	0	0
18	26460822	.	G	C	4	6	10	0	1	11	0	0
18	26460846	.	C	A	5	5	10	0	0	10	0	0
18	26476133	.	C	T	3	6	9	0	0	9	0	0
18	26679632	.	C	T	2	4	6	0	0	6	0	0
18	26679646	.	G	T	2	3	5	0	0	6	1	0
18	26776182	.	A	G	8	3	11	0	0	11	0	0
18	26793948	.	G	A	10	8	18	0	1	19	0	0
18	26800167	.	C	G	5	14	19	0	1	20	0	0
18	26800198	.	T	C	15	6	21	0	0	21	0	0
18	26800280	.	G	A	8	4	12	0	0	12	0	0
18	26800418	.	T	C	12	13	25	0	1	26	0	0
18	26863666	.	T	C	3	0	3	0	4	7	0	0
18	26870137	.	G	A	7	3	10	0	0	10	0	0
18	26870191	.	G	A	6	3	9	0	0	9	0	0
18	26870194	.	G	A	5	2	7	0	1	8	0	0
18	26870469	.	G	C	4	2	6	0	0	6	0	0
18	26874553	.	G	A	3	2	5	0	1	6	0	0
18	26876449	.	A	C	2	2	4	0	0	4	0	0
18	26894677	.	G	A	2	4	6	0	0	6	0	0
18	26896277	.	T	C	14	6	20	0	1	21	0	0
18	26896571	.	C	T	6	6	12	0	0	12	0	0
18	26909470	.	G	A	1	15	16	0	15	31	0	0
18	26913949	.	C	T	24	19	43	0	2	45	0	0
18	26919989	.	T	A	24	16	40	0	3	43	0	0
18	26920116	.	T	C	1	2	3	0	1	4	0	0
18	26968799	.	G	A	13	5	18	0	0	18	0	0
18	26971731	.	A	G	2	2	4	0	0	4	0	0
18	26971868	.	T	C	2	5	7	0	0	7	0	0
18	26977226	.	T	C	2	3	5	0	3	8	0	0
18	27063809	.	C	T	1	2	3	0	0	3	0	0
18	27072144	.	A	C	4	4	8	0	0	8	0	0
18	27072690	.	C	T	3	5	8	0	1	9	0	0
18	27072697	.	G	A	3	6	9	0	0	9	0	0
18	27072948	.	C	G	0	3	3	0	1	4	0	0
18	27077908	.	T	C	5	2	7	0	0	7	0	0
18	27080991	.	C	T	3	3	6	0	2	8	0	0
18	27254726	.	T	C	2	3	5	0	1	6	0	0
18	27254774	.	T	C	3	2	5	0	2	7	0	0
18	27254998	.	T	A	3	3	6	0	1	7	0	0
18	27281673	.	T	G	3	5	8	0	1	9	0	0
18	27281679	.	A	G	3	0	3	0	7	10	0	0
18	27283304	.	C	T	3	2	5	0	0	5	0	0
18	27285764	.	C	T	1	3	4	0	0	4	0	0
18	27309517	.	A	G	7	4	11	0	0	11	0	0
18	27309555	.	G	A	9	4	13	0	0	13	0	0
18	27335597	.	G	A	7	14	21	0	2	23	0	0
18	27335740	.	T	A	17	4	21	0	1	22	0	0
18	27335780	.	A	T	3	15	18	0	0	18	0	0
18	27340993	.	C	T	6	3	9	0	0	9	0	0
18	27340996	.	A	T	3	6	9	0	0	9	0	0
18	27358709	.	A	G	1	3	4	0	1	5	0	0
18	27568352	.	A	G	10	7	17	0	1	18	0	0
18	27624354	.	C	T	1	4	5	0	0	5	0	0
18	27625363	.	A	T	1	2	3	0	0	3	0	0
18	27625675	.	A	T	2	2	4	0	1	5	0	0
18	27625814	.	A	C	1	4	5	0	0	5	0	0
18	27626271	.	C	T	3	4	7	0	0	7	0	0
18	27732389	.	T	C	6	10	16	0	0	16	0	0
18	27802795	.	C	T	13	12	25	0	0	25	0	0
18	27812400	.	T	G	20	1	21	0	18	39	0	0
18	27812429	.	T	C	14	19	33	0	1	34	0	0
18	27812618	.	T	A	16	21	37	0	1	38	0	0
18	27982320	.	A	G	1	2	3	0	0	3	0	0
18	27984021	.	A	G	2	0	2	0	7	9	0	0
18	27984026	.	C	T	2	5	7	0	2	9	0	0
18	27984080	.	C	T	6	3	9	0	0	9	0	0
18	27988509	.	T	C	6	2	8	0	0	8	0	0
18	27993392	.	T	G	5	5	10	0	0	10	0	0
18	27993625	.	C	A	7	5	12	0	1	13	0	0
18	28106305	.	T	A	4	4	8	0	0	8	0	0
18	28106790	.	A	G	7	0	7	0	7	14	0	0
18	28123612	.	T	C	2	4	6	0	1	7	0	0
18	28564674	.	T	A	4	3	7	0	0	7	0	0
18	28564737	.	T	C	2	3	5	0	0	5	0	0
18	28564777	.	G	A	1	3	4	0	1	5	0	0
18	28564782	.	T	A	2	2	4	0	0	4	0	0
18	28564856	.	G	T	1	4	5	0	0	5	0	0
18	28564858	.	G	A	1	4	5	0	1	6	0	0
18	28564923	.	G	A	1	2	3	0	2	5	0	0
18	28565025	.	C	T	1	3	4	0	0	4	0	0
18	28606191	.	A	G	1	0	1	0	3	4	0	0
18	28852198	.	A	T	1	4	5	0	0	5	0	0
18	28852204	.	A	G	1	4	5	0	0	5	0	0
18	28867342	.	T	C	1	2	3	0	0	3	0	0
18	28876524	.	C	G	10	7	17	0	0	17	0	0
18	28876569	.	A	G	7	1	8	0	8	16	0	0
18	28879736	.	G	T	0	5	5	0	4	9	0	0
18	28879758	.	C	G	3	8	11	0	0	11	0	0
18	28879847	.	G	T	3	9	12	0	1	13	0	0
18	29008407	.	C	T	13	17	30	0	1	31	0	0
18	29058989	.	C	T	7	5	12	0	2	15	1	0
18	29059194	.	A	G	7	3	10	0	2	12	0	0
18	29405136	.	C	A	3	4	7	0	0	7	0	0
18	29886272	.	G	A	1	2	3	0	0	3	0	0
18	29886275	.	C	T	1	2	3	0	0	3	0	0
18	29889398	.	T	C	1	4	5	0	0	5	0	0
18	29889484	.	T	A	4	3	7	0	2	9	0	0
18	29889548	.	A	G	2	3	5	0	1	6	0	0
18	29896091	.	C	T	1	2	3	0	0	3	0	0
18	29896158	.	A	T	1	3	4	1	0	5	0	0
18	29896232	.	A	G	1	2	3	0	0	3	0	0
18	29898173	.	A	C	9	4	13	0	1	14	0	0
18	29898187	.	T	A	9	5	14	0	1	15	0	0
18	29898341	.	A	G	2	4	6	0	0	6	0	0
18	29953405	.	T	C	3	4	7	0	0	7	0	0
18	29953867	.	G	A	3	7	10	0	0	10	0	0
18	29954824	.	C	A	7	4	11	0	0	11	0	0
18	29954918	.	C	T	3	4	7	0	0	7	0	0
18	29954929	.	T	C	3	4	7	0	0	7	0	0
18	29958874	.	G	A	2	5	7	0	0	7	0	0
18	29958943	.	G	A	6	3	9	0	0	9	0	0
18	29959241	.	T	C	2	2	4	0	1	5	0	0
18	29959268	.	A	C	2	3	5	0	1	6	0	0
18	29959517	.	A	G	4	3	7	0	0	7	0	0
18	29969920	.	A	T	8	5	13	0	0	13	0	0
18	29970458	.	C	G	20	12	32	0	1	33	0	0
18	29970559	.	T	G	14	13	27	0	0	27	0	0
18	29976560	.	C	A	8	6	14	0	0	14	0	0
18	29976561	.	A	T	8	6	14	0	0	14	0	0
18	29977423	.	C	T	12	7	19	0	0	19	0	0
18	29977753	.	C	T	14	9	23	0	1	24	0	0
18	29977784	.	T	A	14	11	25	0	3	28	0	0
18	29977789	.	C	T	18	10	28	0	0	28	0	0
18	29978794	.	A	T	5	8	13	0	1	14	0	0
18	29978848	.	A	G	4	4	8	0	0	8	0	0
18	29979860	.	A	G	2	2	4	0	0	4	0	0
18	29980462	.	A	G	5	2	7	0	1	8	0	0
18	29980474	.	A	G	5	3	8	0	1	9	0	0
18	30014561	.	G	A	1	2	3	0	0	3	0	0
18	30441825	.	G	A	0	2	2	0	6	8	0	0
18	30463346	.	C	T	4	5	9	0	1	10	0	0
18	30466712	.	A	T	6	9	15	0	1	16	0	0
18	30467010	.	A	G	7	0	7	0	4	11	0	0
18	30470471	.	A	G	9	8	17	0	2	19	0	0
18	30470929	.	T	C	12	15	27	0	2	29	0	0
18	30470930	.	G	A	12	16	28	0	1	29	0	0
18	30473566	.	C	G	6	0	6	0	6	12	0	0
18	30473905	.	A	G	11	0	11	0	16	27	0	0
18	30476837	.	G	A	16	7	23	0	1	24	0	0
18	30477469	.	C	T	11	9	20	0	0	20	0	0
18	30477495	.	T	G	8	9	17	0	1	18	0	0
18	30477616	.	A	G	6	7	13	0	3	16	0	0
18	30477625	.	C	T	8	6	14	0	4	18	0	0
18	30477889	.	C	T	20	18	38	0	2	40	0	0
18	30478113	.	A	G	21	0	21	2	11	35	1	0
18	30478156	.	C	T	18	21	39	0	3	42	0	0
18	30500738	.	T	A	2	2	4	0	0	4	0	0
18	30500912	.	G	T	3	5	8	0	0	8	0	0
18	30500952	.	T	C	2	3	5	0	0	5	0	0
18	30501194	.	T	C	3	5	8	0	0	8	0	0
18	30501298	.	C	A	14	11	25	0	2	27	0	0
18	30501639	.	A	G	12	5	17	0	1	18	0	0
18	30501701	.	T	C	5	12	17	0	1	18	0	0
18	30503562	.	T	C	9	0	9	0	5	15	1	0
18	30504366	.	C	T	5	7	12	0	0	12	0	0
18	30556895	.	G	A	3	4	7	0	0	7	0	0
18	30564142	.	T	A	5	4	9	0	0	9	0	0
18	30564199	.	A	G	3	0	3	0	4	7	0	0
18	30564240	.	A	T	5	5	10	0	0	10	0	0
18	30564301	.	C	A	4	5	9	0	1	10	0	0
18	30564334	.	T	G	6	3	9	0	0	9	0	0
18	30564342	.	G	T	6	5	11	0	0	11	0	0
18	30564385	.	T	G	10	8	18	0	0	18	0	0
18	30564443	.	A	T	5	3	8	0	1	9	0	0
18	30564451	.	G	C	0	2	2	0	5	7	0	0
18	30564598	.	A	G	2	2	4	0	0	4	0	0
18	30949449	.	C	T	5	4	9	0	0	9	0	0
18	30949488	.	G	A	1	3	4	0	0	4	0	0
18	31033267	.	C	T	1	7	8	0	5	13	0	0
18	31036721	.	A	T	5	2	7	0	0	7	0	0
18	31036722	.	C	A	5	2	7	0	0	7	0	0
18	31041640	.	G	A	4	7	11	0	0	11	0	0
18	31058577	.	A	G	4	2	6	0	0	6	0	0
18	31064706	.	A	G	11	0	11	0	5	16	0	0
18	31064734	.	G	A	8	4	12	0	0	12	0	0
18	31068392	.	A	C	5	7	12	0	0	12	0	0
18	31068463	.	A	G	5	5	10	0	0	10	0	0
18	31068745	.	T	G	2	2	4	0	0	4	0	0
18	31075170	.	A	C	2	2	4	0	0	4	0	0
18	31105257	.	G	A	11	8	19	0	0	19	0	0
18	31151851	.	G	A	2	4	6	0	0	6	0	0
18	31152920	.	A	G	2	4	6	0	0	6	0	0
18	31152946	.	C	A	4	3	7	0	1	8	0	0
18	31201750	.	T	C	5	7	12	0	1	13	0	0
18	31281034	.	G	C	1	10	11	0	9	20	0	0
18	31281161	.	T	A	9	7	16	0	0	16	0	0
18	31281186	.	T	C	7	6	13	0	5	18	0	0
18	31281254	.	G	A	10	13	23	0	1	24	0	0
18	31775711	.	G	A	2	9	11	0	9	20	0	0
18	33982078	.	G	T	5	4	9	0	1	10	0	0
18	33982331	.	G	T	8	4	12	0	0	12	0	0
18	33982340	.	G	A	9	3	12	0	0	12	0	0
18	33982423	.	A	C	13	6	19	0	1	20	0	0
18	33982591	.	T	C	15	7	22	0	2	24	0	0
18	33982811	.	C	T	1	18	19	0	5	24	0	0
18	33983154	.	G	A	15	23	38	0	0	38	0	0
18	33983165	.	T	C	13	18	31	0	1	32	0	0
18	33983300	.	A	C	8	1	9	0	9	18	0	0
18	33983564	.	T	A	12	10	22	0	1	23	0	0
18	33983641	.	T	C	9	17	26	2	2	30	0	0
18	33983771	.	A	C	11	11	22	0	2	24	0	0
18	33984153	.	A	G	11	12	23	0	0	23	0	0
18	33984191	.	C	A	10	7	17	0	0	17	0	0
18	33984215	.	G	T	7	9	16	0	0	16	0	0
18	33984235	.	T	A	7	9	16	0	1	17	0	0
18	33984596	.	G	A	8	8	16	0	1	17	0	0
18	33984801	.	A	C	8	11	19	0	0	19	0	0
18	33985249	.	T	C	13	11	24	0	1	25	0	0
18	33985414	.	T	C	11	0	11	0	9	20	0	0
18	33985953	.	C	T	11	13	24	0	1	25	0	0
18	33986027	.	A	G	6	20	26	0	2	28	0	0
18	33986199	.	C	T	15	12	27	0	1	28	0	0
18	33986391	.	C	T	3	7	10	0	1	11	0	0
18	33986395	.	A	G	5	7	12	0	0	12	0	0
18	33986470	.	T	C	6	8	14	0	1	15	0	0
18	33988590	.	C	T	3	5	8	0	8	16	0	0
18	33988743	.	A	C	6	0	6	0	8	14	0	0
18	33988938	.	T	C	3	7	10	0	0	10	0	0
18	33999714	.	C	G	3	7	10	0	0	10	0	0
18	34015365	.	T	C	1	2	3	0	0	3	0	0
18	34046381	.	C	T	1	3	4	0	0	4	0	0
18	34146406	.	A	C	1	2	3	0	0	3	0	0
18	34148276	.	A	G	2	2	4	0	1	5	0	0
18	34152190	.	A	G	3	2	5	0	0	5	0	0
18	34156693	.	A	T	2	4	6	0	0	6	0	0
18	34160136	.	G	T	4	2	6	0	0	6	0	0
18	34160229	.	A	G	3	4	7	0	0	7	0	0
18	34163687	.	A	G	3	3	6	0	0	6	0	0
18	34189614	.	G	A	0	2	2	0	4	6	0	0
18	34195231	.	A	G	5	5	10	0	1	11	0	0
18	34195318	.	C	A	5	3	8	0	1	9	0	0
18	34195336	.	A	T	4	2	6	0	2	8	0	0
18	34196270	.	G	C	2	5	7	0	1	8	0	0
18	34207700	.	G	A	11	5	16	0	0	16	0	0
18	34213378	.	A	T	6	2	8	0	3	11	0	0
18	34213530	.	G	A	1	4	5	0	8	13	0	0
18	34213995	.	A	T	10	9	19	0	0	19	0	0
18	34214054	.	C	T	5	10	15	0	1	16	0	0
18	34214141	.	T	G	8	4	12	0	3	15	0	0
18	34214280	.	A	T	8	8	16	0	2	18	0	0
18	34214288	.	G	T	7	9	16	0	1	17	0	0
18	34214478	.	A	G	15	0	15	0	7	22	0	0
18	34214754	.	C	G	20	15	35	0	0	35	0	0
18	34214894	.	T	C	10	14	24	0	2	26	0	0
18	34362633	.	A	T	1	2	3	0	0	3	0	0
18	34534807	.	G	T	4	5	9	0	0	9	0	0
18	34535184	.	A	G	4	5	9	0	0	9	0	0
18	34535235	.	C	T	6	6	12	0	1	13	0	0
18	34535302	.	A	C	3	6	9	0	0	9	0	0
18	34535423	.	A	G	7	5	12	0	0	12	0	0
18	34535769	.	T	C	3	3	6	0	0	6	0	0
18	34542620	.	C	A	14	7	21	0	1	22	0	0
18	34601008	.	C	A	3	11	14	0	2	16	0	0
18	34601042	.	A	C	5	8	13	0	1	14	0	0
18	34601323	.	T	G	6	10	16	0	1	17	0	0
18	34601468	.	G	T	4	15	19	0	0	19	0	0
18	34601471	.	A	T	2	14	16	0	1	17	0	0
18	34641352	.	A	C	10	17	27	0	5	32	0	0
18	34641439	.	T	C	17	9	26	0	0	26	0	0
18	34641442	.	T	C	16	10	26	0	0	26	0	0
18	34641622	.	C	G	18	12	30	0	0	30	0	0
18	34641633	.	T	C	19	11	30	0	2	32	0	0
18	35134760	.	A	G	1	2	3	0	0	3	0	0
18	35143298	.	C	T	1	3	4	0	0	4	0	0
18	35147372	.	G	A	1	3	4	0	0	4	0	0
18	35147379	.	T	G	0	3	3	0	1	4	0	0
18	35182349	.	A	C	4	2	6	0	0	6	0	0
18	35182418	.	A	G	3	4	7	0	0	7	0	0
18	35195864	.	A	T	3	4	7	0	0	7	0	0
18	35246809	.	G	A	2	3	5	0	0	5	0	0
18	35251104	.	C	T	3	2	5	0	0	5	0	0
18	35251214	.	A	C	3	4	7	0	0	7	0	0
18	35251249	.	T	C	2	4	6	0	0	6	0	0
18	35251258	.	G	A	0	3	3	0	2	5	0	0
18	35405389	.	T	C	12	0	12	0	15	27	0	0
18	35406987	.	G	A	17	5	22	0	2	24	0	0
18	35411535	.	C	G	2	2	4	0	0	4	0	0
18	35431724	.	A	G	1	2	3	0	0	3	0	0
18	35491518	.	A	T	11	28	39	0	0	39	0	0
18	35497031	.	A	C	13	16	29	0	0	29	0	0
18	35501357	.	G	A	8	18	26	0	1	27	0	0
18	35503636	.	A	G	10	16	26	0	0	26	0	0
18	35503654	.	C	T	10	16	26	0	0	26	0	0
18	35503705	.	A	G	12	10	22	0	0	22	0	0
18	35508139	.	C	A	1	12	13	0	8	21	0	0
18	35508151	.	A	T	11	11	22	0	0	22	0	0
18	35508304	.	C	T	13	7	20	1	1	22	0	0
18	35509705	.	G	A	11	8	19	0	0	19	0	0
18	35510290	.	G	T	8	11	19	0	0	19	0	0
18	35510590	.	C	A	5	6	11	0	1	12	0	0
18	35516542	.	A	G	3	2	5	0	0	5	0	0
18	35516566	.	G	A	5	2	7	0	1	8	0	0
18	35520248	.	G	A	5	7	12	0	0	12	0	0
18	35520281	.	T	C	4	0	4	0	7	11	0	0
18	35528859	.	C	T	3	6	9	0	0	9	0	0
18	35529482	.	T	G	8	5	13	0	1	14	0	0
18	35561469	.	A	C	3	0	3	0	6	9	0	0
18	35561496	.	T	G	2	4	6	0	0	6	0	0
18	35561547	.	C	T	3	2	5	0	0	5	0	0
18	35579487	.	G	C	3	0	3	0	2	5	0	0
18	35579502	.	G	A	2	1	3	0	0	3	0	0
18	35582928	.	T	G	2	3	5	0	0	5	0	0
18	35582952	.	G	A	3	2	5	0	0	5	0	0
18	35583885	.	G	C	5	0	5	0	2	7	0	0
18	35583888	.	G	A	6	2	8	0	0	8	0	0
18	35588246	.	A	G	1	3	4	0	0	4	0	0
18	35801124	.	C	T	3	2	5	0	1	6	0	0
18	35807902	.	A	T	6	4	10	0	1	11	0	0
18	35808137	.	C	T	5	6	11	0	2	13	0	0
18	35808223	.	G	A	8	13	21	0	0	21	0	0
18	35808320	.	A	G	17	13	30	0	2	32	0	0
18	35814745	.	T	G	15	16	31	1	2	34	0	0
18	35827185	.	C	T	7	5	12	0	0	12	0	0
18	35829794	.	T	C	5	2	7	0	0	7	0	0
18	35832858	.	G	T	9	5	14	0	0	14	0	0
18	35832896	.	G	A	6	8	14	0	0	14	0	0
18	35832911	.	G	A	6	6	12	0	0	12	0	0
18	35832931	.	C	T	7	7	14	0	0	14	0	0
18	35833077	.	G	A	4	4	8	0	1	9	0	0
18	35837643	.	A	G	5	4	9	0	0	9	0	0
18	35838817	.	A	G	1	3	4	0	0	4	0	0
18	35839224	.	T	C	0	2	2	0	1	3	0	0
18	35839375	.	A	T	8	1	9	0	0	9	0	0
18	35839461	.	T	C	3	3	6	0	0	6	0	0
18	35839512	.	A	G	8	3	11	0	1	12	0	0
18	35839543	.	A	T	7	5	12	0	1	13	0	0
18	35839658	.	T	C	10	9	19	0	0	19	0	0
18	35839673	.	A	G	9	7	16	0	0	16	0	0
18	35839730	.	T	C	6	3	9	0	1	10	0	0
18	35839832	.	G	A	7	6	13	0	0	13	0	0
18	35842419	.	T	C	6	4	10	0	1	11	0	0
18	35842440	.	C	T	1	4	5	0	6	11	0	0
18	35842476	.	C	T	10	8	18	0	1	19	0	0
18	36037258	.	T	C	3	4	7	0	1	8	0	0
18	36065768	.	T	G	4	5	9	0	0	9	0	0
18	36066048	.	T	C	4	2	6	0	0	6	0	0
18	36066054	.	C	G	4	2	6	0	0	6	0	0
18	36071039	.	G	T	1	5	6	0	5	11	0	0
18	36071217	.	C	G	7	0	7	0	5	12	0	0
18	36071223	.	G	A	7	4	11	0	0	11	0	0
18	36080616	.	G	T	11	14	25	1	3	29	0	0
18	36080688	.	A	G	15	14	29	0	1	30	0	0
18	36080931	.	T	G	9	7	16	0	0	16	0	0
18	36081009	.	A	C	8	9	17	0	1	18	0	0
18	36081018	.	G	A	10	10	20	0	1	21	0	0
18	36081513	.	C	T	10	11	21	0	1	22	0	0
18	36081792	.	T	C	3	5	8	0	1	9	0	0
18	36106031	.	T	C	11	10	21	0	0	21	0	0
18	36114463	.	T	A	7	5	12	0	0	12	0	0
18	36114464	.	A	C	6	5	11	0	1	12	0	0
18	36129218	.	G	A	11	6	17	0	0	17	0	0
18	36593772	.	A	G	3	0	3	0	5	8	0	0
18	36593874	.	C	T	2	3	5	0	0	5	0	0
18	36597757	.	A	G	4	2	6	0	0	6	0	0
18	36597952	.	C	T	12	7	19	0	0	19	0	0
18	36598075	.	G	A	0	3	3	0	4	7	0	0
18	36598076	.	T	A	4	3	7	0	0	7	0	0
18	36598208	.	G	T	3	2	5	0	0	5	0	0
18	36598439	.	A	G	8	6	14	0	0	14	0	0
18	36598476	.	G	A	8	5	13	0	0	13	0	0
18	36620186	.	C	T	8	13	21	0	0	21	0	0
18	36623275	.	C	T	9	10	19	0	0	19	0	0
18	36630740	.	T	A	13	11	24	0	0	24	0	0
18	36630867	.	C	T	14	9	23	0	3	26	0	0
18	36631169	.	A	G	4	4	8	0	0	8	0	0
18	36769901	.	G	A	1	6	7	0	2	9	0	0
18	36799090	.	C	T	8	3	11	0	0	11	0	0
18	36799219	.	T	C	4	2	6	0	0	6	0	0
18	36799229	.	T	G	5	2	7	0	0	7	0	0
18	36799543	.	A	T	6	3	9	0	0	9	0	0
18	36799680	.	A	G	7	2	9	0	0	9	0	0
18	36799685	.	C	G	7	3	10	0	0	10	0	0
18	36799767	.	T	C	3	4	7	0	0	7	0	0
18	36799780	.	G	A	2	4	6	0	0	6	0	0
18	36800002	.	C	T	4	3	7	0	0	7	0	0
18	36800035	.	T	G	1	2	3	0	1	4	0	0
18	36806632	.	A	T	11	3	14	0	0	14	0	0
18	36806657	.	T	A	7	2	9	0	4	13	0	0
18	36806681	.	T	C	7	4	11	0	0	11	0	0
18	36806707	.	C	T	6	4	10	0	0	10	0	0
18	36806727	.	C	T	5	4	9	0	1	10	0	0
18	36806749	.	A	G	3	5	8	0	0	8	0	0
18	36858200	.	T	C	6	5	11	0	0	11	0	0
18	36869052	.	A	G	5	5	10	0	0	10	0	0
18	36869120	.	T	G	13	5	18	0	1	19	0	0
18	36869131	.	G	A	1	6	7	0	12	19	0	0
18	36869180	.	T	C	16	10	26	0	0	26	0	0
18	36869530	.	C	G	12	18	30	0	1	31	0	0
18	36869676	.	A	G	17	11	28	0	4	32	0	0
18	36869677	.	A	G	14	13	27	0	4	31	0	0
18	36869774	.	A	G	9	11	20	1	2	23	0	0
18	36869798	.	A	G	7	11	18	0	0	18	0	0
18	36870068	.	G	A	15	19	34	0	1	35	0	0
18	36870174	.	G	A	14	9	23	0	1	24	0	0
18	36870278	.	G	A	15	15	30	0	1	31	0	0
18	36870378	.	A	G	10	0	10	0	13	23	0	0
18	36870448	.	C	G	14	16	30	0	0	30	0	0
18	36870460	.	T	C	13	18	31	0	1	32	0	0
18	36870702	.	A	T	16	16	32	0	0	32	0	0
18	36949178	.	A	G	6	5	11	0	0	11	0	0
18	36951690	.	C	T	5	4	9	0	1	10	0	0
18	36951693	.	G	A	4	4	8	0	0	8	0	0
18	36951888	.	A	G	4	5	9	0	1	10	0	0
18	36954186	.	A	G	1	2	3	0	0	3	0	0
18	36956672	.	G	A	2	2	4	0	0	4	0	0
18	36957310	.	T	C	5	2	7	0	0	7	0	0
18	36963204	.	A	G	2	3	5	0	0	5	0	0
18	37007251	.	C	T	2	3	5	0	0	5	0	0
18	37191246	.	C	T	3	2	5	0	0	5	0	0
18	37191286	.	G	A	3	3	6	0	0	6	0	0
18	37197464	.	T	C	3	6	9	0	0	9	0	0
18	37219291	.	C	G	2	2	4	0	1	5	0	0
18	37219646	.	T	C	2	3	5	0	0	5	0	0
18	37228547	.	A	G	2	0	2	0	7	9	0	0
18	37228562	.	C	G	4	7	11	0	0	11	0	0
18	37230433	.	A	G	5	4	9	0	0	9	0	0
18	37230456	.	C	G	5	5	10	0	1	11	0	0
18	37230629	.	T	C	5	6	11	0	0	11	0	0
18	37234081	.	T	C	10	8	18	0	1	19	0	0
18	37234289	.	A	G	3	3	6	0	0	6	0	0
18	37259911	.	A	G	20	13	33	0	11	44	0	0
18	37260192	.	A	G	26	0	26	0	22	48	0	0
18	37267398	.	C	A	21	13	34	0	3	37	0	0
18	37267464	.	G	A	22	12	34	0	1	35	0	0
18	37267529	.	G	A	22	19	41	0	2	43	0	0
18	37269904	.	A	G	18	18	36	0	0	36	0	0
18	37270225	.	A	G	26	16	42	0	2	44	0	0
18	37270498	.	C	T	15	10	25	0	5	30	0	0
18	37270598	.	T	G	10	12	22	0	0	22	0	0
18	37284000	.	G	A	4	2	6	0	0	6	0	0
18	37837371	.	C	T	0	11	11	0	17	28	0	0
18	37837511	.	A	G	18	19	37	0	0	37	0	0
18	37837536	.	T	C	17	19	36	0	2	38	0	0
18	37837655	.	A	G	16	23	39	0	1	40	0	0
18	37837706	.	A	C	9	14	23	0	1	24	0	0
18	37837708	.	T	A	10	13	23	0	1	24	0	0
18	37837879	.	G	T	13	14	27	0	2	29	0	0
18	37838160	.	G	T	26	16	42	0	1	43	0	0
18	37838250	.	G	C	16	6	22	3	2	27	0	0
18	37840290	.	A	G	35	19	54	1	3	58	0	0
18	37866417	.	C	T	1	16	17	0	19	36	0	0
18	38194336	.	C	A	3	4	7	0	0	7	0	0
18	38199482	.	A	G	3	6	9	0	0	9	0	0
18	38202827	.	T	C	4	5	9	0	0	9	0	0
18	38209458	.	G	C	5	3	8	0	0	8	0	0
18	38209562	.	T	G	4	6	10	0	0	10	0	0
18	38209586	.	C	G	2	5	7	0	0	7	0	0
18	38209597	.	T	C	2	3	5	0	0	5	0	0
18	38209776	.	A	G	4	8	12	0	0	12	0	0
18	38217181	.	A	G	13	16	29	0	1	30	0	0
18	38222514	.	A	G	6	11	17	0	1	18	0	0
18	38223448	.	A	G	3	4	7	0	0	7	0	0
18	38223735	.	A	G	4	7	11	0	0	11	0	0
18	38225547	.	G	A	2	5	7	0	1	8	0	0
18	38235716	.	T	G	3	6	9	0	1	10	0	0
18	38235726	.	A	T	4	6	10	0	0	10	0	0
18	38240682	.	T	A	6	1	7	0	0	7	0	0
18	38240685	.	A	G	3	3	6	0	2	8	0	0
18	38248121	.	T	C	16	11	27	0	0	27	0	0
18	38250924	.	A	G	25	15	40	0	2	42	0	0
18	38256265	.	T	C	11	0	11	0	15	26	0	0
18	38256668	.	A	G	21	14	35	0	0	35	0	0
18	38260152	.	T	C	10	11	21	0	0	21	0	0
18	38260330	.	A	G	13	8	21	0	2	23	0	0
18	38260352	.	C	A	17	10	27	0	0	27	0	0
18	38260377	.	C	T	18	9	27	0	1	28	0	0
18	38263910	.	G	C	20	10	30	1	0	31	0	0
18	38266979	.	C	T	13	8	21	0	0	21	0	0
18	38270559	.	T	C	9	6	15	0	1	16	0	0
18	38296046	.	C	G	9	7	16	0	0	16	0	0
18	38296089	.	G	T	7	5	12	0	1	13	0	0
18	38296452	.	A	C	2	3	5	0	3	8	0	0
18	38296467	.	T	C	3	3	6	0	1	7	0	0
18	39523000	.	G	T	4	2	6	0	0	6	0	0
18	39523002	.	T	C	2	4	6	0	0	6	0	0
18	40711312	.	G	A	9	3	12	0	5	17	0	0
18	41267668	.	A	G	1	4	5	0	0	5	0	0
18	41267988	.	T	A	3	3	6	0	1	7	0	0
18	41278299	.	G	A	2	5	7	0	0	7	0	0
18	41278644	.	T	C	5	3	8	0	0	8	0	0
18	41284700	.	C	T	3	5	8	0	0	8	0	0
18	41293901	.	A	T	7	5	12	0	0	12	0	0
18	41295246	.	C	T	9	7	16	0	3	19	0	0
18	41297082	.	C	T	8	8	16	0	0	16	0	0
18	41300057	.	T	G	7	6	13	0	3	16	0	0
18	41300063	.	A	G	11	0	11	0	8	19	0	0
18	41305867	.	C	T	3	7	10	0	0	10	0	0
18	41309305	.	G	A	15	14	29	0	6	35	0	0
18	41310196	.	A	G	7	0	7	0	6	13	0	0
18	41310464	.	G	A	1	14	15	0	19	34	0	0
18	41364610	.	A	G	3	2	5	0	0	5	0	0
18	41364932	.	A	G	4	2	6	0	0	6	0	0
18	41364937	.	T	A	3	2	5	0	2	7	0	0
18	41365051	.	A	T	2	3	5	0	0	5	0	0
18	41365125	.	G	A	4	2	6	0	0	6	0	0
18	41365236	.	C	A	2	3	5	0	0	5	0	0
18	41365482	.	C	T	5	2	7	0	0	7	0	0
18	41372345	.	G	A	2	2	4	0	0	4	0	0
18	41420078	.	T	C	2	2	4	0	0	4	0	0
18	41420080	.	T	C	2	2	4	0	0	4	0	0
18	41495859	.	A	G	10	16	26	0	2	28	0	0
18	41495865	.	A	T	11	13	24	0	1	25	0	0
18	41499590	.	T	C	13	13	26	0	0	26	0	0
18	41499679	.	A	G	12	14	26	0	0	26	0	0
18	41499683	.	T	C	11	11	22	0	2	24	0	0
18	41499789	.	C	T	11	13	24	0	2	26	0	0
18	41503578	.	C	A	24	18	42	0	1	43	0	0
18	41505624	.	A	G	17	1	18	0	20	38	0	0
18	41509564	.	C	G	17	12	29	0	0	29	0	0
18	41509716	.	G	T	15	10	25	0	0	25	0	0
18	41512217	.	C	T	14	11	25	0	0	25	0	0
18	41512370	.	G	A	8	6	14	0	1	15	0	0
18	41514977	.	C	A	4	4	8	0	0	8	0	0
18	41524354	.	G	A	30	20	50	0	2	52	0	0
18	41524364	.	C	A	29	22	51	0	0	51	0	0
18	41525864	.	T	C	19	23	42	0	1	43	0	0
18	41525880	.	G	A	2	21	23	0	17	40	0	0
18	41526014	.	C	G	16	0	16	0	21	37	0	0
18	41526026	.	A	G	19	17	36	0	3	39	0	0
18	41526247	.	T	A	15	16	31	0	4	35	0	0
18	41526299	.	T	A	12	10	22	0	0	22	0	0
18	41526318	.	A	G	9	9	18	0	2	20	0	0
18	41526380	.	C	T	5	12	17	0	1	18	0	0
18	41526381	.	T	C	5	6	11	0	7	18	0	0
18	41527949	.	T	A	2	1	3	0	1	4	0	0
18	41533072	.	C	T	9	6	15	1	0	16	0	0
18	41538770	.	G	A	7	13	20	0	1	21	0	0
18	41538795	.	A	G	3	12	15	0	1	16	0	0
18	41538856	.	G	A	2	10	12	0	1	13	0	0
18	41539099	.	T	A	2	3	5	0	0	5	0	0
18	41542661	.	A	T	2	5	7	0	0	7	0	0
18	41542669	.	T	A	2	3	5	0	1	6	0	0
18	41542712	.	T	C	4	3	7	0	1	8	0	0
18	41543076	.	C	T	3	9	12	0	1	13	0	0
18	41546938	.	C	G	2	4	6	0	1	7	0	0
18	41547273	.	T	G	5	8	13	0	0	13	0	0
18	41547308	.	C	T	4	2	6	0	2	8	0	0
18	41549817	.	T	A	2	12	14	0	0	14	0	0
18	41556239	.	G	A	1	3	4	0	5	9	0	0
18	41558711	.	C	T	6	6	12	0	0	12	0	0
18	41559028	.	C	T	2	3	5	0	0	5	0	0
18	41559074	.	C	T	1	2	3	0	0	3	0	0
18	41565692	.	T	C	5	2	7	0	0	7	0	0
18	41565731	.	G	A	4	2	6	0	0	6	0	0
18	41571740	.	A	G	2	5	7	0	0	7	0	0
18	41572423	.	A	C	5	2	7	0	0	7	0	0
18	41572445	.	T	C	5	2	7	0	1	8	0	0
18	41573696	.	A	G	4	3	7	0	0	7	0	0
18	41573948	.	G	A	2	3	5	0	2	7	0	0
18	41574074	.	G	A	5	3	8	0	0	8	0	0
18	41574083	.	A	G	3	2	5	0	1	6	0	0
18	41574155	.	A	G	1	2	3	0	0	3	0	0
18	41574287	.	T	C	3	5	8	0	0	8	0	0
18	41574340	.	C	T	2	3	5	0	1	6	0	0
18	41574557	.	T	C	5	4	9	0	0	9	0	0
18	41574608	.	T	C	4	4	8	0	0	8	0	0
18	41579975	.	T	A	9	4	13	0	1	14	0	0
18	41586440	.	T	C	9	8	17	0	1	18	0	0
18	41588148	.	A	G	9	0	9	0	8	17	0	0
18	41588166	.	C	T	8	8	16	0	2	18	0	0
18	41589613	.	A	C	10	10	20	0	2	22	0	0
18	41649061	.	C	T	6	14	20	0	2	22	0	0
18	41649571	.	A	G	6	6	12	0	0	12	0	0
18	41757350	.	C	A	13	14	27	0	2	29	0	0
18	41757449	.	G	A	24	21	45	0	5	50	0	0
18	41757454	.	G	A	26	24	50	0	1	51	0	0
18	41757669	.	C	T	29	26	55	0	3	58	0	0
18	41764434	.	G	A	23	26	49	0	0	49	0	0
18	41764452	.	G	C	22	2	24	0	30	54	0	0
18	41808695	.	T	C	1	2	3	0	0	3	0	0
18	41869388	.	G	A	1	2	3	0	0	3	0	0
18	42162369	.	G	A	7	11	18	0	0	18	0	0
18	42189660	.	G	A	7	6	13	1	2	16	0	0
18	42189675	.	A	C	6	1	7	1	7	15	0	0
18	42201031	.	C	G	7	3	10	0	0	10	0	0
18	42218721	.	G	A	5	7	12	0	0	12	0	0
18	42218741	.	G	A	4	8	12	0	0	12	0	0
18	42258933	.	T	A	7	5	12	0	0	12	0	0
18	42276336	.	T	C	4	3	7	0	0	7	0	0
18	42313791	.	G	A	3	4	7	0	0	7	0	0
18	42333382	.	C	T	5	2	7	0	0	7	0	0
18	43867265	.	A	C	7	10	17	0	0	17	0	0
18	43867416	.	A	G	13	5	18	0	2	20	0	0
18	43867775	.	T	C	7	4	11	0	0	11	0	0
18	43867892	.	C	T	8	3	11	0	0	11	0	0
18	43868073	.	A	C	10	8	18	0	0	18	0	0
18	43868229	.	A	T	23	8	31	0	1	32	0	0
18	43868234	.	T	A	17	11	28	0	2	30	0	0
18	43868682	.	T	G	11	11	22	0	0	22	0	0
18	43869326	.	A	G	11	4	15	0	0	15	0	0
18	43869403	.	T	C	5	3	8	0	0	8	0	0
18	43869424	.	G	A	3	2	5	0	0	5	0	0
18	43869475	.	A	G	4	6	10	0	0	10	0	0
18	43869522	.	T	C	7	2	9	0	1	10	0	0
18	43869561	.	A	G	8	4	12	0	0	12	0	0
18	43869659	.	C	T	8	5	13	0	1	14	0	0
18	43869976	.	T	C	7	11	18	0	3	21	0	0
18	43870180	.	C	T	0	6	6	0	3	9	0	0
18	43870315	.	G	A	3	5	8	0	1	9	0	0
18	43870317	.	G	A	3	6	9	0	0	9	0	0
18	43870501	.	T	C	4	4	8	0	1	9	0	0
18	43870525	.	G	A	7	6	13	0	0	13	0	0
18	43870541	.	A	G	6	7	13	0	0	13	0	0
18	43870592	.	C	A	8	9	17	0	0	17	0	0
18	43870655	.	G	T	6	6	12	0	2	14	0	0
18	43870660	.	A	G	7	6	13	0	2	15	0	0
18	43870702	.	G	A	12	2	14	1	1	16	0	0
18	43873901	.	G	A	1	2	3	0	0	3	0	0
18	43896892	.	A	G	16	13	29	0	0	29	0	0
18	43896919	.	C	T	2	16	18	0	16	34	0	0
18	43897048	.	C	T	2	21	23	0	15	38	0	0
18	43897405	.	C	G	13	12	25	0	0	25	0	0
18	43897522	.	C	T	5	11	16	0	0	16	0	0
18	43897816	.	G	A	10	9	19	0	1	20	0	0
18	43898211	.	G	T	8	9	17	0	0	18	1	0
18	43898223	.	A	T	6	11	17	0	0	17	0	0
18	43898526	.	C	T	3	8	11	0	2	13	0	0
18	43898928	.	A	G	1	5	6	0	2	8	0	0
18	43899825	.	G	A	5	7	12	0	1	13	0	0
18	43900299	.	G	A	2	5	7	0	0	7	0	0
18	43908395	.	G	C	1	3	4	0	0	4	0	0
18	43993377	.	T	A	2	5	7	2	0	9	0	0
18	44053474	.	G	T	2	2	4	0	0	4	0	0
18	44053584	.	T	C	4	4	8	0	0	8	0	0
18	44057052	.	G	A	1	3	4	0	0	4	0	0
18	44065135	.	A	G	4	4	8	0	0	8	0	0
18	44065238	.	T	C	3	2	5	0	1	6	0	0
18	44075782	.	T	C	2	2	4	0	0	4	0	0
18	44321063	.	A	G	2	2	4	0	0	4	0	0
18	44321260	.	T	A	10	9	19	0	2	21	0	0
18	44321323	.	C	T	8	7	15	0	0	15	0	0
18	44321518	.	A	T	2	2	4	0	0	4	0	0
18	44321909	.	G	A	2	3	5	0	2	7	0	0
18	44321914	.	T	C	5	2	7	0	1	8	0	0
18	44321949	.	T	C	3	6	9	0	0	9	0	0
18	44321950	.	T	C	3	5	8	0	1	9	0	0
18	44322043	.	T	A	4	5	9	0	0	9	0	0
18	44322280	.	T	C	2	3	5	0	0	5	0	0
18	44322377	.	T	C	3	8	11	0	0	11	0	0
18	44322481	.	C	T	1	9	10	0	9	19	0	0
18	44325470	.	A	G	3	12	15	0	1	16	0	0
18	44325526	.	A	T	5	2	7	0	0	7	0	0
18	44327944	.	A	G	6	8	14	0	0	14	0	0
18	44327953	.	G	A	6	7	13	0	1	14	0	0
18	44331117	.	G	C	8	4	12	0	0	12	0	0
18	44332725	.	C	T	1	2	3	0	0	3	0	0
18	44334889	.	C	T	4	2	6	0	0	6	0	0
18	44345920	.	T	C	4	0	4	0	3	7	0	0
18	44346102	.	C	T	2	3	5	0	0	5	0	0
18	44346150	.	C	A	0	2	2	0	1	3	0	0
18	44355473	.	A	G	1	2	3	0	1	4	0	0
18	44355485	.	G	A	2	3	5	0	0	5	0	0
18	44359312	.	T	C	1	2	3	0	0	3	0	0
18	44364647	.	C	A	26	23	49	0	5	54	0	0
18	44365064	.	C	A	31	28	59	1	1	62	1	0
18	44365114	.	T	A	42	29	71	0	1	73	1	0
18	44365650	.	T	C	21	21	42	0	0	42	0	0
18	44365714	.	C	A	30	18	48	0	1	50	1	0
18	44365717	.	A	G	29	20	49	0	2	51	0	0
18	44365977	.	T	C	11	17	28	0	6	34	0	0
18	44365987	.	T	A	13	16	29	0	2	31	0	0
18	44367241	.	A	T	13	29	42	0	0	42	0	0
18	44367426	.	C	T	31	21	52	0	0	52	0	0
18	44367488	.	G	A	24	26	50	0	3	53	0	0
18	44377404	.	C	A	20	10	30	0	1	31	0	0
18	44377417	.	C	T	24	6	30	0	1	31	0	0
18	44388421	.	C	T	14	17	31	0	1	32	0	0
18	44397330	.	G	A	14	12	26	0	2	28	0	0
18	44404609	.	C	T	19	12	31	0	0	31	0	0
18	44404872	.	C	T	12	18	30	0	0	30	0	0
18	44408841	.	G	A	12	11	23	1	2	26	0	0
18	44418164	.	C	T	14	9	23	0	1	24	0	0
18	44425093	.	A	G	12	11	23	0	1	24	0	0
18	44425105	.	C	T	12	9	21	0	2	23	0	0
18	44425150	.	A	C	12	13	25	0	1	26	0	0
18	44453365	.	G	A	9	3	12	0	0	12	0	0
18	44453377	.	G	C	5	0	5	0	5	10	0	0
18	44564105	.	C	T	2	3	5	0	0	5	0	0
18	44564123	.	C	T	2	3	5	0	0	5	0	0
18	44567471	.	A	C	0	2	2	0	1	3	0	0
18	44573987	.	A	G	3	0	3	0	1	4	0	0
18	44573993	.	C	T	3	2	5	0	0	5	0	0
18	44574263	.	C	T	3	2	5	0	1	6	0	0
18	44576790	.	C	T	1	3	4	0	0	4	0	0
18	44579965	.	G	A	2	4	6	0	0	6	0	0
18	44585167	.	T	C	2	4	6	0	1	7	0	0
18	44587696	.	C	A	3	2	5	0	0	5	0	0
18	44587777	.	C	A	3	5	8	0	1	9	0	0
18	44589770	.	G	C	7	4	11	0	1	12	0	0
18	44597048	.	G	A	10	3	13	0	0	13	0	0
18	44597308	.	C	A	28	19	47	0	2	49	0	0
18	44597850	.	A	G	16	13	29	0	0	29	0	0
18	44597884	.	G	A	12	11	23	0	0	23	0	0
18	44598234	.	C	T	0	15	15	0	14	29	0	0
18	44598371	.	C	T	10	9	19	0	1	20	0	0
18	44599804	.	T	G	6	1	7	1	28	36	0	0
18	44599837	.	G	A	22	19	41	2	0	43	0	0
18	44606194	.	G	A	13	6	19	0	0	19	0	0
18	44615685	.	G	A	7	6	13	0	0	13	0	0
18	44615770	.	G	A	15	8	23	0	0	23	0	0
18	44615819	.	T	C	12	9	21	0	0	21	0	0
18	44615861	.	A	T	10	10	20	1	0	22	1	0
18	44618795	.	G	T	16	16	32	0	1	33	0	0
18	44619049	.	T	G	12	9	21	0	1	22	0	0
18	44623527	.	G	A	12	13	25	0	1	26	0	0
18	44633609	.	C	T	2	3	5	0	2	7	0	0
18	44633615	.	T	A	2	2	4	0	1	5	0	0
18	44637835	.	A	T	5	8	13	0	0	13	0	0
18	44637898	.	G	A	7	4	11	0	2	13	0	0
18	44638087	.	G	T	0	4	4	0	3	7	0	0
18	44640464	.	C	T	4	4	8	0	0	8	0	0
18	44640663	.	C	G	7	4	11	0	0	11	0	0
18	44642287	.	A	G	2	1	3	0	2	5	0	0
18	44645008	.	A	T	5	7	12	0	2	14	0	0
18	44645350	.	A	G	5	1	6	0	5	11	0	0
18	44645368	.	T	C	3	4	7	0	1	8	0	0
18	44645485	.	A	G	2	2	4	0	0	4	0	0
18	44645617	.	G	A	2	9	11	0	13	24	0	0
18	44645782	.	G	C	9	10	19	0	1	20	0	0
18	44645870	.	T	A	11	12	23	0	0	23	0	0
18	44646048	.	C	T	3	4	7	0	0	7	0	0
18	44646215	.	C	T	5	7	12	0	0	12	0	0
18	44646467	.	A	C	11	8	19	0	1	20	0	0
18	44646504	.	C	T	11	10	21	0	2	23	0	0
18	44646587	.	G	A	0	14	14	0	8	22	0	0
18	44646678	.	C	T	14	9	23	0	1	24	0	0
18	44646781	.	A	G	7	4	11	0	0	11	0	0
18	44682124	.	C	T	3	3	6	0	0	6	0	0
18	44692777	.	T	C	4	4	8	0	0	8	0	0
18	44696096	.	C	T	5	4	9	0	0	9	0	0
18	44696319	.	A	C	4	5	9	0	0	9	0	0
18	44696451	.	A	T	5	2	7	0	0	7	0	0
18	44757735	.	C	T	2	2	4	0	0	4	0	0
18	44764392	.	A	T	2	2	4	0	0	4	0	0
18	44765491	.	A	G	3	0	3	0	10	13	0	0
18	44770632	.	C	T	1	3	4	0	0	4	0	0
18	44781653	.	A	G	3	0	3	0	2	5	0	0
18	44782413	.	G	A	2	2	4	0	0	4	0	0
18	44790506	.	T	C	2	4	6	0	0	6	0	0
18	44790635	.	A	G	2	2	4	0	0	4	0	0
18	44790722	.	G	A	4	4	8	0	0	8	0	0
18	44791251	.	A	C	2	5	7	0	0	7	0	0
18	44791318	.	C	A	1	2	3	0	2	5	0	0
18	44826427	.	C	T	2	8	10	0	20	30	0	0
18	44826554	.	T	G	8	14	22	0	0	22	0	0
18	44826910	.	C	T	13	7	20	4	0	24	0	0
18	44830217	.	C	T	9	10	19	0	0	19	0	0
18	44830247	.	G	A	8	12	20	0	1	21	0	0
18	44830283	.	G	A	15	13	28	0	1	29	0	0
18	44832693	.	C	A	15	8	23	0	1	24	0	0
18	44834165	.	T	C	9	0	9	0	11	20	0	0
18	44837085	.	T	C	9	5	14	0	1	15	0	0
18	44838285	.	G	A	11	15	26	0	1	27	0	0
18	44838342	.	G	A	9	11	20	1	1	22	0	0
18	44840994	.	C	T	14	11	25	0	1	26	0	0
18	44843407	.	G	A	13	10	23	0	1	24	0	0
18	44843531	.	C	A	12	6	18	0	2	20	0	0
18	44852404	.	C	T	8	2	10	0	0	10	0	0
18	44857803	.	C	A	8	10	18	0	0	18	0	0
18	44866841	.	C	T	18	13	31	0	0	31	0	0
18	44870505	.	G	A	0	10	10	0	12	22	0	0
18	44870526	.	G	A	0	7	7	0	8	15	0	0
18	44870541	.	G	A	0	8	8	0	10	18	0	0
18	44873083	.	C	T	13	8	21	0	1	22	0	0
18	44873993	.	G	T	15	18	33	0	3	36	0	0
18	44874249	.	T	G	9	1	10	0	7	17	0	0
18	44874252	.	C	T	9	8	17	0	1	18	0	0
18	44913653	.	G	T	12	9	21	0	0	21	0	0
18	44913760	.	A	G	2	7	9	0	0	9	0	0
18	44913993	.	T	C	3	0	3	0	3	6	0	0
18	45231137	.	G	A	1	3	4	0	0	4	0	0
18	45235903	.	G	T	1	4	5	0	1	6	0	0
18	45235924	.	T	C	3	3	6	0	0	6	0	0
18	45248042	.	T	G	2	3	5	0	0	5	0	0
18	45257475	.	C	T	5	5	10	0	0	10	0	0
18	45259886	.	T	C	7	4	11	0	2	13	0	0
18	45259930	.	C	T	6	7	13	0	0	13	0	0
18	45260228	.	T	C	3	3	6	0	0	6	0	0
18	45260316	.	A	C	2	5	7	0	0	7	0	0
18	45260321	.	G	T	0	2	2	0	6	8	0	0
18	45260529	.	G	A	0	6	6	0	3	9	0	0
18	45261085	.	G	A	4	5	9	0	0	9	0	0
18	45261319	.	A	T	7	3	10	0	0	10	0	0
18	45261369	.	G	T	5	4	9	0	1	10	0	0
18	45261438	.	G	A	5	8	13	0	0	13	0	0
18	45261501	.	G	C	4	4	8	0	0	8	0	0
18	45261845	.	T	A	5	3	8	0	0	8	0	0
18	45261882	.	T	C	3	5	8	0	1	9	0	0
18	45262351	.	C	T	4	9	13	0	0	13	0	0
18	45262687	.	G	T	7	5	12	0	2	14	0	0
18	45262855	.	A	C	6	7	13	0	2	15	0	0
18	45262865	.	T	C	7	6	13	0	0	13	0	0
18	45550831	.	G	C	0	10	10	1	9	20	0	0
18	45550839	.	A	C	11	11	22	1	1	24	0	0
18	45561677	.	G	T	8	21	29	0	0	29	0	0
18	45569037	.	G	A	4	11	15	1	7	23	0	0
18	45569075	.	C	A	12	15	27	0	3	30	0	0
18	45569092	.	A	G	14	0	14	0	12	26	0	0
18	45574140	.	A	G	15	16	31	0	0	31	0	0
18	45574275	.	A	T	11	9	20	0	1	21	0	0
18	45575079	.	G	A	0	9	9	0	14	23	0	0
18	45581704	.	C	A	16	14	30	0	1	31	0	0
18	45581784	.	C	T	13	19	32	0	1	33	0	0
18	45583038	.	A	C	18	9	27	0	0	27	0	0
18	45583042	.	G	A	2	7	9	0	18	27	0	0
18	45584036	.	C	T	10	15	25	0	1	26	0	0
18	45584368	.	T	C	17	31	48	0	3	51	0	0
18	45588336	.	C	T	25	17	42	0	1	43	0	0
18	45591836	.	A	T	13	18	31	0	2	33	0	0
18	45591929	.	G	A	15	14	29	0	1	30	0	0
18	45647838	.	G	A	3	15	18	1	9	28	0	0
18	45647940	.	C	T	14	7	21	0	1	22	0	0
18	45649613	.	C	T	20	13	33	0	2	35	0	0
18	45649658	.	G	T	20	12	32	0	1	33	0	0
18	45651032	.	C	T	17	18	35	0	4	39	0	0
18	45651559	.	T	A	25	12	37	0	0	37	0	0
18	45656062	.	T	C	22	15	37	0	1	38	0	0
18	45656089	.	T	C	17	22	39	0	3	42	0	0
18	45681884	.	C	G	1	3	4	0	0	4	0	0
18	45684119	.	G	T	1	2	3	0	1	4	0	0
18	45684977	.	T	C	2	2	4	0	0	4	0	0
18	45685625	.	G	A	2	3	5	0	0	5	0	0
18	45685659	.	T	A	1	2	3	0	0	3	0	0
18	45685695	.	G	C	2	2	4	0	0	4	0	0
18	45685700	.	C	A	2	3	5	0	0	5	0	0
18	45686500	.	A	G	2	3	5	0	0	5	0	0
18	45686882	.	G	A	0	5	5	0	3	8	0	0
18	45687097	.	A	G	4	5	9	0	3	12	0	0
18	45687258	.	G	C	4	5	9	0	0	9	0	0
18	45687882	.	C	T	6	2	8	0	0	8	0	0
18	45689081	.	C	T	6	5	11	0	0	11	0	0
18	45691123	.	G	A	2	2	4	0	2	6	0	0
18	45697623	.	A	G	7	3	10	0	0	10	0	0
18	45697833	.	A	T	4	3	7	0	0	7	0	0
18	45697909	.	C	T	3	3	6	0	0	6	0	0
18	45697999	.	T	C	3	2	5	0	0	5	0	0
18	45698032	.	A	G	3	0	3	0	2	5	0	0
18	45698143	.	G	A	0	2	2	0	1	3	0	0
18	45698344	.	C	A	3	3	6	0	0	6	0	0
18	45734477	.	T	C	6	6	12	0	0	12	0	0
18	45742051	.	C	A	10	18	28	0	0	28	0	0
18	45742059	.	G	A	10	14	24	0	4	28	0	0
18	45743004	.	G	C	14	0	14	0	9	23	0	0
18	45743518	.	G	A	12	14	26	0	0	26	0	0
18	45743522	.	G	A	11	14	25	0	2	27	0	0
18	45743555	.	C	A	10	9	19	0	2	21	0	0
18	45745504	.	A	T	5	9	14	0	0	14	0	0
18	45750912	.	A	C	7	0	7	0	8	15	0	0
18	45750915	.	A	G	6	8	14	0	1	15	0	0
18	45752094	.	C	T	0	4	4	0	7	11	0	0
18	45759309	.	G	T	9	7	16	0	0	16	0	0
18	45781530	.	T	C	0	2	2	0	0	2	0	0
18	45781540	.	C	G	1	2	3	0	0	3	0	0
18	45784225	.	A	G	46	28	74	0	2	76	0	0
18	45807903	.	C	G	4	1	5	0	8	13	0	0
18	45807942	.	G	C	1	7	8	1	5	14	0	0
18	45809872	.	A	G	6	0	6	0	10	16	0	0
18	45809892	.	T	C	7	6	13	0	1	14	0	0
18	45818602	.	C	T	14	11	25	0	0	25	0	0
18	45820510	.	G	A	1	5	6	0	7	13	0	0
18	45820588	.	A	G	14	11	25	0	0	25	0	0
18	45824315	.	C	T	13	11	24	1	1	26	0	0
18	45824607	.	G	A	20	9	29	0	1	30	0	0
18	45835115	.	C	T	15	11	26	0	1	27	0	0
18	45840471	.	T	A	15	10	25	0	1	26	0	0
18	45840504	.	C	T	15	16	31	0	0	31	0	0
18	45842491	.	T	C	21	13	34	1	1	36	0	0
18	45842679	.	G	A	4	18	22	0	20	42	0	0
18	45844458	.	C	T	26	15	41	0	1	42	0	0
18	45844473	.	A	T	23	18	41	0	1	42	0	0
18	45848355	.	C	T	16	18	34	1	2	37	0	0
18	45849283	.	C	T	16	15	31	0	2	33	0	0
18	45851540	.	G	A	5	18	23	1	29	53	0	0
18	45932349	.	A	G	1	1	2	0	3	5	0	0
18	45934691	.	G	T	1	4	5	0	0	5	0	0
18	45944546	.	C	T	5	9	14	0	0	14	0	0
18	45944903	.	G	T	3	6	9	0	0	9	0	0
18	45947835	.	C	T	1	3	4	0	0	4	0	0
18	45947880	.	C	A	2	3	5	0	0	5	0	0
18	45948213	.	G	A	5	5	10	0	0	10	0	0
18	45948374	.	A	G	2	0	2	0	2	4	0	0
18	45948375	.	C	A	2	2	4	0	0	4	0	0
18	45962500	.	A	G	20	25	45	0	2	47	0	0
18	45962581	.	T	C	10	12	22	3	1	27	1	0
18	45962593	.	G	C	11	14	25	3	0	28	0	0
18	45962668	.	C	T	20	17	37	0	1	38	0	0
18	45969252	.	C	A	34	20	54	0	2	56	0	0
18	45979887	.	C	T	17	20	37	0	2	39	0	0
18	45983268	.	A	C	22	21	43	0	2	45	0	0
18	46003577	.	C	T	0	4	4	0	1	5	0	0
18	46012631	.	C	T	6	3	9	0	0	9	0	0
18	46015830	.	G	A	4	6	10	0	0	10	0	0
18	46057023	.	G	T	5	4	9	0	0	9	0	0
18	46059425	.	A	C	8	5	13	0	0	13	0	0
18	46061242	.	G	A	4	3	7	0	0	7	0	0
18	46061326	.	C	A	5	6	11	0	2	13	0	0
18	46063648	.	C	T	7	3	10	0	0	10	0	0
18	46361861	.	C	G	6	6	12	0	0	12	0	0
18	46362772	.	G	T	17	8	25	0	2	27	0	0
18	46367691	.	G	C	17	11	28	0	1	29	0	0
18	46368300	.	C	T	1	4	5	0	8	13	0	0
18	46368771	.	C	T	1	7	8	0	4	12	0	0
18	46368924	.	C	A	4	4	8	0	0	8	0	0
18	46369173	.	T	C	2	2	4	0	1	5	0	0
18	46393851	.	T	C	1	3	4	0	0	4	0	0
18	46393861	.	T	A	1	3	4	0	0	4	0	0
18	46395965	.	G	C	24	19	43	0	2	45	0	0
18	46400979	.	A	G	12	18	30	0	2	32	0	0
18	46401137	.	T	C	10	17	27	0	1	28	0	0
18	46417624	.	T	C	15	9	24	0	0	24	0	0
18	46417681	.	G	T	16	6	22	0	1	23	0	0
18	46417775	.	T	C	18	0	18	0	9	27	0	0
18	46417807	.	A	G	20	9	29	0	1	30	0	0
18	46418281	.	T	C	9	0	9	0	12	21	0	0
18	46418458	.	C	T	3	6	9	0	11	20	0	0
18	46418497	.	G	A	14	5	19	0	0	19	0	0
18	46418521	.	C	T	10	8	18	0	1	19	0	0
18	46418776	.	C	T	0	6	6	0	5	11	0	0
18	46453240	.	C	T	0	4	4	0	7	11	0	0
18	46634572	.	T	C	1	6	7	0	2	9	0	0
18	46635257	.	G	A	3	3	6	0	0	6	0	0
18	46635390	.	G	C	4	3	7	0	1	8	0	0
18	46635876	.	G	A	4	4	8	0	1	9	0	0
18	46653253	.	T	G	4	4	8	0	0	8	0	0
18	46653284	.	A	G	2	7	9	0	0	9	0	0
18	46684230	.	A	T	4	3	7	0	0	7	0	0
18	46684258	.	G	T	5	4	9	0	0	9	0	0
18	46699773	.	G	A	24	23	47	0	0	47	0	0
18	46702492	.	G	A	18	20	38	0	2	40	0	0
18	46714896	.	A	G	6	4	10	0	0	10	0	0
18	46729044	.	A	G	4	5	9	0	0	9	0	0
18	46729321	.	A	G	6	3	9	0	0	9	0	0
18	46732406	.	C	G	3	2	5	0	0	5	0	0
18	46732417	.	T	A	3	3	6	0	1	7	0	0
18	46738955	.	A	C	3	9	12	0	0	12	0	0
18	46738990	.	A	T	2	6	8	0	1	9	0	0
18	46784844	.	T	C	2	2	4	0	0	4	0	0
18	47095659	.	G	A	2	5	7	0	0	7	0	0
18	47305388	.	T	A	7	6	13	0	2	15	0	0
18	47305433	.	A	G	6	5	11	0	0	11	0	0
18	47566919	.	A	T	2	2	4	0	0	4	0	0
18	48486246	.	C	T	4	3	7	0	1	8	0	0
18	48486342	.	C	T	1	2	3	0	0	3	0	0
18	48620675	.	G	A	3	4	7	0	0	7	0	0
18	48640143	.	G	C	0	2	2	1	3	7	1	0
18	48640155	.	G	C	0	3	3	0	3	6	0	0
18	48640284	.	C	G	2	0	2	0	7	9	0	0
18	48640323	.	G	A	0	5	5	0	5	10	0	0
18	48640348	.	A	G	3	0	3	0	7	10	0	0
18	48640417	.	G	T	3	7	10	0	0	10	0	0
18	48640596	.	T	C	2	5	7	0	0	7	0	0
18	48641976	.	A	T	2	3	5	0	0	5	0	0
18	48641984	.	A	T	2	3	5	0	0	5	0	0
18	48642200	.	T	A	1	2	3	0	0	3	0	0
18	48642203	.	G	C	1	2	3	0	0	3	0	0
18	48642742	.	C	A	2	2	4	0	0	4	0	0
18	48642868	.	A	T	3	4	7	0	0	7	0	0
18	48643030	.	C	A	4	5	9	0	0	9	0	0
18	48643055	.	A	G	3	8	11	0	1	12	0	0
18	48643334	.	T	C	4	3	7	0	0	7	0	0
18	48697929	.	A	C	1	1	2	0	2	4	0	0
18	48707436	.	C	T	1	2	3	0	0	3	0	0
18	48803064	.	G	A	1	3	4	0	2	6	0	0
18	48807499	.	A	G	3	2	5	0	0	5	0	0
18	48807521	.	T	C	3	2	5	0	0	5	0	0
18	48807710	.	T	C	3	3	6	0	0	6	0	0
18	48807941	.	A	G	4	3	7	0	1	8	0	0
18	48807962	.	C	T	5	5	10	0	0	10	0	0
18	48808043	.	A	G	6	3	9	0	0	9	0	0
18	48808099	.	A	G	5	2	7	0	2	9	0	0
18	48808237	.	T	A	1	2	3	0	1	4	0	0
18	48808372	.	G	A	2	3	5	0	1	6	0	0
18	48808396	.	A	G	4	4	8	0	0	8	0	0
18	48808552	.	T	C	5	5	10	0	1	11	0	0
18	48808659	.	G	A	0	4	4	0	1	5	0	0
18	48808708	.	T	A	3	2	5	0	1	6	0	0
18	48808985	.	T	A	5	4	9	0	0	9	0	0
18	48809189	.	G	A	11	4	15	0	0	15	0	0
18	48809268	.	T	A	8	3	11	0	0	11	0	0
18	48809276	.	A	G	7	0	7	0	2	9	0	0
18	48864453	.	C	A	5	5	10	0	0	10	0	0
18	48864702	.	T	C	6	3	9	0	0	9	0	0
18	48898641	.	C	T	6	7	13	0	0	13	0	0
18	48921166	.	C	G	13	7	20	0	3	23	0	0
18	48921175	.	A	C	13	5	18	0	2	20	0	0
18	48923068	.	C	T	15	9	24	0	0	24	0	0
18	48928342	.	A	G	19	1	20	0	24	44	0	0
18	48928387	.	T	A	19	15	34	0	0	34	0	0
18	48928552	.	C	T	15	17	32	0	2	34	0	0
18	48928843	.	C	T	11	17	28	0	0	28	0	0
18	48934524	.	T	C	13	18	31	0	2	33	0	0
18	48934593	.	T	C	14	22	36	0	1	37	0	0
18	48934805	.	A	G	20	16	36	0	2	38	0	0
18	48934833	.	T	C	24	15	39	0	0	39	0	0
18	48934951	.	A	G	19	1	20	0	14	34	0	0
18	48935279	.	T	G	22	14	36	0	0	36	0	0
18	48951382	.	C	T	1	2	3	0	0	3	0	0
18	48956210	.	A	T	1	1	2	0	0	2	0	0
18	48960846	.	G	C	2	2	4	0	0	4	0	0
18	48960969	.	A	C	2	2	4	0	1	5	0	0
18	48964912	.	G	C	1	2	3	0	0	3	0	0
18	48964915	.	G	A	0	2	2	0	1	3	0	0
18	48971165	.	T	C	4	8	12	0	0	12	0	0
18	48971192	.	A	G	5	9	14	0	0	14	0	0
18	48972490	.	A	T	4	11	15	0	0	15	0	0
18	49001793	.	T	C	2	3	5	0	1	6	0	0
18	49001796	.	T	G	3	3	6	0	0	6	0	0
18	49001860	.	A	T	2	4	6	0	0	6	0	0
18	49004685	.	T	C	2	2	4	0	0	4	0	0
18	49006805	.	G	A	1	3	4	0	0	4	0	0
18	49024734	.	C	T	1	2	3	0	0	3	0	0
18	49032695	.	C	T	0	2	2	0	1	3	0	0
18	49039585	.	G	A	2	2	4	0	0	4	0	0
18	49039591	.	C	T	0	3	3	0	2	5	0	0
18	49125038	.	C	G	1	2	3	1	0	4	0	0
18	49125996	.	A	C	8	7	15	0	0	15	0	0
18	49126162	.	T	C	0	2	2	0	1	3	0	0
18	49126294	.	T	A	1	5	6	0	0	7	1	0
18	49126296	.	T	A	2	5	7	0	0	7	0	0
18	49126363	.	A	C	1	5	6	0	1	7	0	0
18	49126732	.	G	A	2	5	7	0	0	7	0	0
18	49126745	.	A	G	3	5	8	0	0	8	0	0
18	49126845	.	C	G	8	5	13	0	0	13	0	0
18	49126958	.	C	T	8	3	11	0	0	11	0	0
18	49153651	.	T	C	8	12	20	0	0	20	0	0
18	49153710	.	A	C	6	4	10	0	0	10	0	0
18	49153735	.	G	A	0	6	6	0	8	14	0	0
18	49153900	.	C	T	16	10	26	0	2	28	0	0
18	49153977	.	G	C	1	6	7	0	11	18	0	0
18	49153984	.	G	T	1	6	7	0	12	19	0	0
18	49154243	.	T	C	12	11	23	0	0	23	0	0
18	49154251	.	C	T	11	10	21	0	0	21	0	0
18	49154328	.	G	A	11	12	23	0	1	24	0	0
18	49154458	.	G	T	9	10	19	0	0	19	0	0
18	49154483	.	G	T	2	13	15	0	16	31	0	0
18	49154525	.	C	T	18	13	31	0	2	33	0	0
18	49154527	.	T	C	18	12	30	0	3	33	0	0
18	49154722	.	A	G	10	11	21	0	2	23	0	0
18	49155045	.	A	G	6	0	6	0	7	13	0	0
18	49155190	.	C	G	13	10	23	0	2	25	0	0
18	49155211	.	C	A	11	8	19	0	1	20	0	0
18	49155278	.	G	T	7	4	11	0	0	11	0	0
18	49155303	.	G	A	4	6	10	0	0	10	0	0
18	49155941	.	C	T	10	18	28	0	0	28	0	0
18	49156077	.	A	G	19	0	19	0	9	28	0	0
18	49156444	.	G	A	8	7	15	0	0	15	0	0
18	49156481	.	T	C	7	7	14	0	0	14	0	0
18	49156567	.	T	C	9	7	16	0	2	18	0	0
18	49156773	.	G	T	10	5	15	0	0	15	0	0
18	49214231	.	G	A	2	3	5	0	1	6	0	0
18	49214441	.	C	T	2	3	5	0	1	6	0	0
18	49225608	.	T	C	2	2	4	0	0	4	0	0
18	49239450	.	T	A	5	2	7	0	0	7	0	0
18	49239595	.	G	A	1	2	3	0	0	3	0	0
18	49244821	.	C	A	9	9	18	0	0	18	0	0
18	49245055	.	C	G	1	0	1	0	3	4	0	0
18	49245256	.	G	C	3	3	6	0	1	7	0	0
18	49245579	.	G	A	1	5	6	0	0	6	0	0
18	49246639	.	T	A	0	6	6	0	0	6	0	0
18	49246672	.	T	A	5	4	9	0	1	10	0	0
18	49248524	.	G	T	2	9	11	0	0	12	1	0
18	49261736	.	C	T	14	11	25	0	1	26	0	0
18	49265220	.	G	C	0	2	2	0	4	6	0	0
18	49265434	.	C	A	1	2	3	0	0	3	0	0
18	49266182	.	A	G	4	5	9	0	1	10	0	0
18	49266575	.	G	A	5	7	12	3	0	15	0	0
18	49266589	.	A	G	8	6	14	3	0	17	0	0
18	49266646	.	C	A	5	3	8	0	2	10	0	0
18	49266649	.	A	G	5	1	6	0	4	10	0	0
18	49266998	.	A	G	6	3	9	0	1	10	0	0
18	49267041	.	G	A	7	3	10	0	1	11	0	0
18	49267327	.	T	G	1	5	6	0	0	6	0	0
18	49267832	.	A	G	1	3	4	0	0	4	0	0
18	49310340	.	A	T	1	2	3	0	1	4	0	0
18	49412259	.	T	C	2	3	5	0	1	6	0	0
18	49412514	.	T	C	7	6	13	0	0	13	0	0
18	49412709	.	G	A	0	3	3	0	6	9	0	0
18	49428280	.	G	A	4	6	10	0	1	11	0	0
18	49428793	.	T	C	3	5	8	0	1	9	0	0
18	49446190	.	G	T	3	3	6	0	0	6	0	0
18	49446254	.	T	G	2	5	7	0	0	7	0	0
18	49446293	.	C	G	7	5	12	0	0	12	0	0
18	49446312	.	G	A	10	4	14	0	0	14	0	0
18	49446398	.	G	A	4	2	6	0	1	7	0	0
18	49446456	.	A	G	2	0	2	0	4	6	0	0
18	49446764	.	A	T	0	3	3	0	1	4	0	0
18	49446796	.	C	A	4	5	9	0	0	9	0	0
18	49446803	.	T	A	4	4	8	0	0	8	0	0
18	49446881	.	T	C	6	6	12	0	1	13	0	0
18	49447008	.	C	A	9	7	16	0	0	16	0	0
18	49447041	.	G	A	0	10	10	0	9	19	0	0
18	50037401	.	C	T	8	9	17	0	2	19	0	0
18	50037810	.	A	G	3	2	5	0	1	6	0	0
18	50037850	.	C	T	2	2	4	0	1	5	0	0
18	50038778	.	C	T	4	2	6	1	0	7	0	0
18	50039536	.	G	A	2	5	7	1	3	11	0	0
18	50039852	.	G	T	10	10	20	0	0	20	0	0
18	50039939	.	C	T	7	3	10	0	0	10	0	0
18	50040021	.	G	T	2	9	11	0	0	11	0	0
18	50124802	.	G	A	6	5	11	0	1	12	0	0
18	50124803	.	T	A	5	6	11	0	0	11	0	0
18	50124843	.	A	T	4	3	7	0	0	7	0	0
18	50124847	.	T	C	4	2	6	0	0	6	0	0
18	50124929	.	C	T	3	3	6	0	0	6	0	0
18	50124945	.	G	T	2	3	5	0	1	6	0	0
18	50125048	.	G	T	3	4	7	0	0	7	0	0
18	50125099	.	T	G	5	7	12	0	1	13	0	0
18	50276476	.	C	G	17	11	28	0	0	28	0	0
18	50276681	.	T	G	8	12	20	0	1	21	0	0
18	50279044	.	T	C	21	21	42	0	2	44	0	0
18	50279182	.	G	A	3	14	17	0	22	39	0	0
18	50353568	.	A	C	19	20	39	0	2	41	0	0
18	50353598	.	C	T	23	24	47	0	0	47	0	0
18	50356632	.	T	C	21	28	49	0	0	49	0	0
18	50443699	.	A	C	1	3	4	0	0	4	0	0
18	50443786	.	T	C	1	3	4	0	0	4	0	0
18	50443787	.	G	T	1	3	4	0	0	4	0	0
18	50538289	.	T	C	9	8	17	0	0	17	0	0
18	50538340	.	T	C	6	8	14	0	1	15	0	0
18	50538442	.	T	C	8	4	12	0	0	12	0	0
18	50538449	.	T	C	9	0	9	0	2	11	0	0
18	50538601	.	T	C	8	3	11	0	1	12	0	0
18	50823328	.	G	A	0	10	10	0	1	11	0	0
19	175381	.	A	G	6	4	10	0	0	10	0	0
19	175382	.	A	G	4	3	7	0	3	10	0	0
19	371692	.	A	G	2	3	5	0	0	5	0	0
19	371695	.	A	G	3	3	6	0	0	6	0	0
19	433722	.	T	C	2	5	7	0	0	7	0	0
19	433736	.	T	C	1	3	4	0	0	4	0	0
19	981432	.	C	T	0	4	4	0	6	10	0	0
19	981483	.	A	G	4	7	11	0	1	12	0	0
19	983651	.	T	G	7	6	13	0	1	14	0	0
19	985629	.	T	C	10	0	10	0	5	15	0	0
19	985638	.	G	C	11	7	18	0	0	18	0	0
19	987655	.	T	A	2	2	4	0	0	4	0	0
19	996179	.	T	C	3	4	7	0	1	8	0	0
19	1008043	.	T	C	1	5	6	0	1	7	0	0
19	1008049	.	A	G	2	1	3	0	5	8	0	0
19	1009031	.	C	T	3	3	6	0	1	7	0	0
19	1010362	.	T	C	7	3	10	0	1	11	0	0
19	1010434	.	G	C	2	8	10	0	6	16	0	0
19	1010529	.	C	A	3	3	6	0	0	6	0	0
19	1010592	.	C	T	4	4	8	0	1	9	0	0
19	1010700	.	T	C	2	3	5	0	0	5	0	0
19	1010901	.	C	T	3	6	9	0	0	9	0	0
19	1010904	.	T	A	3	6	9	0	0	9	0	0
19	1010962	.	T	A	2	2	4	0	0	4	0	0
19	1010983	.	C	T	4	2	6	0	0	6	0	0
19	1011329	.	C	A	1	3	4	0	0	4	0	0
19	1011359	.	G	T	3	4	7	0	0	7	0	0
19	1011400	.	C	T	4	5	9	0	0	9	0	0
19	1011530	.	A	G	3	3	6	0	1	7	0	0
19	1011633	.	G	A	4	6	10	0	0	10	0	0
19	1011656	.	C	G	5	6	11	0	0	11	0	0
19	1011697	.	A	C	9	3	12	0	0	13	1	0
19	1011917	.	T	C	2	3	5	0	0	5	0	0
19	1011926	.	T	C	2	5	7	0	0	7	0	0
19	1011955	.	T	G	4	7	11	0	1	12	0	0
19	1012048	.	G	A	1	5	6	0	4	10	0	0
19	1012085	.	A	C	4	4	8	0	0	8	0	0
19	1012210	.	C	T	7	2	9	0	0	9	0	0
19	1012459	.	A	G	1	2	3	0	3	6	0	0
19	1012474	.	T	C	2	2	4	0	4	8	0	0
19	1012683	.	C	T	6	4	10	0	0	10	0	0
19	1012990	.	T	C	5	3	8	0	0	8	0	0
19	1012998	.	T	C	6	2	8	0	0	8	0	0
19	1013144	.	G	A	3	5	8	0	7	15	0	0
19	1019153	.	T	C	15	0	15	0	20	35	0	0
19	1021490	.	C	T	8	11	19	0	2	21	0	0
19	1097579	.	A	G	2	0	2	0	12	14	0	0
19	1097613	.	T	C	6	11	17	0	0	17	0	0
19	1097616	.	T	C	6	11	17	0	0	17	0	0
19	1108290	.	C	T	14	11	25	0	2	27	0	0
19	1110528	.	G	A	16	16	32	0	0	32	0	0
19	1111871	.	T	C	9	10	19	0	1	20	0	0
19	1111882	.	G	T	10	12	22	0	0	22	0	0
19	1111982	.	T	G	7	3	10	0	0	10	0	0
19	1111983	.	G	A	7	3	10	0	0	10	0	0
19	1112032	.	C	A	6	5	11	0	1	12	0	0
19	1112121	.	T	C	2	2	4	0	1	5	0	0
19	1185244	.	T	C	7	6	13	0	1	14	0	0
19	1185343	.	G	A	0	3	3	0	10	13	0	0
19	1185485	.	A	G	12	15	27	0	4	31	0	0
19	1330730	.	T	G	3	0	3	0	0	3	0	0
19	1331064	.	G	T	7	3	10	0	0	10	0	0
19	1331105	.	T	A	6	6	12	0	1	13	0	0
19	1331146	.	C	A	7	5	12	0	1	13	0	0
19	1331394	.	T	G	8	7	15	0	0	15	0	0
19	1358114	.	A	G	2	3	5	0	0	5	0	0
19	1359700	.	T	G	6	3	9	0	1	10	0	0
19	1359703	.	G	A	6	4	10	0	0	10	0	0
19	1361459	.	C	T	4	3	7	0	0	7	0	0
19	1370542	.	T	G	9	0	9	0	5	14	0	0
19	1370714	.	A	G	7	10	17	0	1	18	0	0
19	1370725	.	A	C	6	11	17	0	0	17	0	0
19	1384408	.	A	T	7	13	20	0	2	22	0	0
19	1385881	.	A	G	12	9	21	0	0	21	0	0
19	1392134	.	G	A	0	19	19	0	17	36	0	0
19	1392482	.	T	C	7	14	21	0	1	22	0	0
19	1392544	.	T	A	6	10	16	0	0	16	0	0
19	1392565	.	A	G	6	15	21	0	1	22	0	0
19	1392586	.	T	A	10	14	24	0	2	26	0	0
19	1392885	.	T	G	13	9	22	0	1	23	0	0
19	1392904	.	C	T	11	8	19	1	2	22	0	0
19	1393073	.	T	A	8	25	33	0	2	35	0	0
19	1393085	.	C	A	8	19	27	0	3	30	0	0
19	1393176	.	C	T	15	8	23	0	1	24	0	0
19	1393199	.	A	G	15	9	24	0	1	25	0	0
19	1393212	.	A	G	12	1	13	0	6	19	0	0
19	1406549	.	A	C	6	4	10	0	0	10	0	0
19	1406593	.	T	G	5	5	10	0	0	10	0	0
19	1406751	.	C	T	4	3	7	0	0	7	0	0
19	1406760	.	A	T	3	6	9	0	1	10	0	0
19	1406795	.	A	C	1	5	6	0	0	6	0	0
19	1406895	.	T	G	3	7	10	0	0	10	0	0
19	1406967	.	G	T	4	6	10	0	0	10	0	0
19	1407181	.	T	A	2	2	4	0	0	4	0	0
19	1407396	.	A	G	3	3	6	0	0	6	0	0
19	1407731	.	G	A	3	7	10	0	0	10	0	0
19	1410896	.	A	G	4	4	8	0	0	8	0	0
19	1411076	.	A	G	3	2	5	0	0	5	0	0
19	1562020	.	G	A	1	2	3	0	2	5	0	0
19	1562570	.	C	T	2	4	6	0	1	7	0	0
19	1619018	.	T	C	1	2	3	0	0	3	0	0
19	1673711	.	T	C	1	2	3	0	0	3	0	0
19	1673756	.	C	T	2	3	5	0	0	5	0	0
19	1684972	.	C	T	2	4	6	0	0	6	0	0
19	1685755	.	A	G	1	4	5	0	0	5	0	0
19	1735376	.	G	A	1	3	4	0	0	4	0	0
19	1790838	.	A	G	1	3	4	0	1	5	0	0
19	1801819	.	G	A	0	4	4	0	2	6	0	0
19	1806491	.	C	T	3	2	5	0	0	5	0	0
19	1807303	.	C	T	5	3	8	0	0	8	0	0
19	1835945	.	G	A	0	7	7	0	3	10	0	0
19	1848057	.	G	A	2	6	8	0	0	8	0	0
19	1848062	.	A	T	2	6	8	0	0	8	0	0
19	1848239	.	G	A	11	12	23	0	0	23	0	0
19	1848298	.	A	G	8	6	14	0	0	14	0	0
19	1848301	.	G	A	2	4	6	0	9	15	0	0
19	1848334	.	T	C	9	5	14	0	1	15	0	0
19	1852303	.	T	C	6	13	19	0	5	24	0	0
19	1853802	.	A	G	35	33	68	0	2	71	1	0
19	1853826	.	T	C	22	41	63	0	9	72	0	0
19	1855354	.	A	G	0	6	6	0	1	7	0	0
19	1856335	.	G	A	2	2	4	0	0	4	0	0
19	1856458	.	T	G	9	4	13	0	1	14	0	0
19	1856556	.	C	G	16	8	24	1	0	25	0	0
19	1856641	.	T	A	17	12	29	1	1	31	0	0
19	1856716	.	A	C	26	15	41	0	2	43	0	0
19	1858785	.	G	A	15	15	30	0	2	32	0	0
19	1868152	.	G	C	10	1	11	0	7	18	0	0
19	1868327	.	A	G	3	7	10	0	0	10	0	0
19	1868460	.	C	T	1	5	6	0	7	13	0	0
19	1870977	.	T	C	5	0	5	0	5	10	0	0
19	1872897	.	G	A	8	16	24	0	0	24	0	0
19	1877255	.	A	G	19	1	20	0	16	36	0	0
19	1877288	.	T	C	18	16	34	0	4	38	0	0
19	1877536	.	G	C	11	21	32	0	0	32	0	0
19	1877544	.	G	T	13	19	32	0	0	32	0	0
19	1878618	.	G	A	3	8	11	0	0	11	0	0
19	1878630	.	C	G	4	11	15	0	0	15	0	0
19	1879923	.	G	C	6	8	14	0	0	14	0	0
19	1879951	.	C	T	4	5	9	0	0	9	0	0
19	1880602	.	T	C	6	7	13	0	0	13	0	0
19	1880836	.	G	A	2	7	9	0	3	12	0	0
19	1880886	.	T	C	6	4	10	0	0	10	0	0
19	1953569	.	A	G	15	22	37	0	2	39	0	0
19	1953583	.	G	T	22	19	41	0	1	42	0	0
19	1960987	.	T	G	15	9	24	0	1	25	0	0
19	1960997	.	T	C	20	10	30	0	2	32	0	0
19	1990839	.	G	C	1	3	4	0	0	4	0	0
19	1993007	.	C	T	2	4	6	0	0	6	0	0
19	1995133	.	A	T	1	5	6	0	2	8	0	0
19	1995229	.	G	A	0	2	2	0	5	7	0	0
19	1995367	.	A	G	7	1	8	0	3	11	0	0
19	1995404	.	G	A	9	4	13	0	1	14	0	0
19	1995425	.	A	G	8	5	13	0	3	16	0	0
19	1995499	.	G	T	10	4	14	0	1	15	0	0
19	1995590	.	T	G	6	6	12	0	1	13	0	0
19	1995594	.	A	G	7	4	11	0	1	12	0	0
19	1995733	.	C	T	4	4	8	0	0	8	0	0
19	1995915	.	A	G	3	0	3	0	6	9	0	0
19	1995925	.	C	A	4	5	9	0	0	9	0	0
19	1995982	.	G	C	6	2	8	0	0	8	0	0
19	1996098	.	C	T	3	4	7	0	1	8	0	0
19	1996248	.	A	T	1	2	3	0	0	3	0	0
19	1996444	.	C	T	4	3	7	0	1	8	0	0
19	1996452	.	A	G	4	2	6	0	1	7	0	0
19	1996494	.	G	T	0	2	2	0	5	7	0	0
19	1996504	.	T	C	4	2	6	0	0	6	0	0
19	1996550	.	G	A	1	6	7	0	0	7	0	0
19	1996639	.	T	G	4	8	12	0	0	12	0	0
19	1996776	.	G	A	4	5	9	0	0	9	0	0
19	1996995	.	C	T	4	2	6	0	0	6	0	0
19	1997010	.	G	A	4	2	6	0	0	6	0	0
19	1997091	.	A	T	3	5	8	0	0	8	0	0
19	1997159	.	T	C	2	8	10	0	0	10	0	0
19	1997165	.	C	T	2	8	10	0	0	10	0	0
19	1997326	.	G	T	0	5	5	0	1	6	0	0
19	1997495	.	C	G	5	2	7	0	0	7	0	0
19	1997521	.	A	G	4	3	7	0	0	7	0	0
19	1997538	.	G	C	3	3	6	0	0	6	0	0
19	1997638	.	T	A	6	4	10	0	0	10	0	0
19	1997733	.	C	T	4	3	7	0	0	7	0	0
19	1997767	.	C	G	7	6	13	0	0	13	0	0
19	1997781	.	A	T	8	5	13	0	1	14	0	0
19	1998260	.	G	A	1	5	6	0	0	6	0	0
19	1998287	.	G	A	1	6	7	0	0	7	0	0
19	2000142	.	C	G	2	7	9	0	0	9	0	0
19	2001557	.	T	C	3	8	11	0	0	11	0	0
19	2001618	.	A	C	4	2	6	0	0	6	0	0
19	2002992	.	A	G	3	0	3	0	7	10	0	0
19	2003634	.	T	C	6	4	10	0	0	10	0	0
19	2003767	.	C	T	8	7	15	0	0	15	0	0
19	2003803	.	C	G	4	0	4	0	11	15	0	0
19	2003902	.	A	T	5	11	16	0	0	16	0	0
19	2003962	.	G	T	1	8	9	0	8	17	0	0
19	2004046	.	G	C	3	10	13	0	0	13	0	0
19	2019147	.	C	T	0	4	4	0	5	9	0	0
19	2019430	.	G	A	5	4	9	0	0	9	0	0
19	2019480	.	C	T	0	2	2	0	4	6	0	0
19	2064762	.	G	C	4	3	7	0	0	7	0	0
19	2071597	.	T	C	2	2	4	0	0	4	0	0
19	2071672	.	A	G	1	3	4	0	0	4	0	0
19	2083254	.	C	T	1	2	3	0	0	3	0	0
19	2279284	.	C	T	6	4	10	0	2	12	0	0
19	2294971	.	G	C	2	3	5	0	0	5	0	0
19	2296760	.	A	T	8	4	12	0	0	12	0	0
19	2307248	.	C	A	7	4	11	0	0	11	0	0
19	2307268	.	C	T	6	4	10	0	1	11	0	0
19	2315752	.	A	T	9	3	12	0	0	12	0	0
19	2316215	.	G	A	3	3	6	0	1	7	0	0
19	2316354	.	A	T	3	2	5	0	0	5	0	0
19	2316510	.	T	C	5	6	11	0	1	12	0	0
19	2316765	.	T	C	3	4	7	0	0	7	0	0
19	2316894	.	T	C	3	4	7	0	1	8	0	0
19	2396022	.	C	T	2	4	6	0	0	6	0	0
19	2396492	.	C	A	4	4	8	0	0	8	0	0
19	2396647	.	C	T	3	5	8	0	0	8	0	0
19	2397559	.	T	C	3	2	5	0	0	5	0	0
19	2400403	.	G	A	6	3	9	0	0	9	0	0
19	2402609	.	T	A	3	2	5	0	0	5	0	0
19	2402611	.	T	A	4	2	6	0	0	6	0	0
19	2546871	.	T	A	1	4	5	0	0	5	0	0
19	2547046	.	C	T	2	3	5	0	0	5	0	0
19	2550676	.	G	A	5	2	7	0	2	9	0	0
19	2550839	.	C	T	4	4	8	0	0	8	0	0
19	2551214	.	C	T	11	3	14	0	0	14	0	0
19	2551727	.	C	T	5	5	10	0	2	12	0	0
19	2560950	.	A	G	4	7	11	0	1	12	0	0
19	2561048	.	A	C	9	11	20	0	0	20	0	0
19	2561739	.	G	A	2	6	8	0	12	20	0	0
19	2562198	.	T	C	1	2	3	0	0	3	0	0
19	2562472	.	A	G	5	11	16	0	0	16	0	0
19	2602934	.	G	A	3	2	5	0	0	5	0	0
19	2645115	.	C	T	8	6	14	0	0	14	0	0
19	2651272	.	A	G	3	9	12	0	0	12	0	0
19	2651344	.	G	A	0	6	6	0	7	13	0	0
19	2654388	.	A	T	10	3	13	0	1	14	0	0
19	2654424	.	C	T	5	11	16	0	1	17	0	0
19	2663609	.	A	G	4	12	16	0	1	17	0	0
19	2664125	.	G	A	3	7	10	0	2	12	0	0
19	2664394	.	C	T	11	20	31	0	0	31	0	0
19	2685839	.	T	C	2	2	4	0	1	5	0	0
19	2695030	.	T	C	13	23	36	0	1	37	0	0
19	2695314	.	G	A	11	6	17	0	3	20	0	0
19	2695351	.	A	G	7	0	7	0	3	10	0	0
19	2695358	.	G	A	5	3	8	0	0	8	0	0
19	2731100	.	C	T	6	7	13	0	0	13	0	0
19	2732833	.	C	T	4	7	11	0	0	11	0	0
19	2732836	.	G	A	4	7	11	0	0	11	0	0
19	2746008	.	G	A	2	8	10	0	3	13	0	0
19	2746134	.	C	T	12	13	25	0	1	26	0	0
19	2750162	.	G	A	2	10	12	0	12	24	0	0
19	2750973	.	C	T	7	7	14	0	0	14	0	0
19	2871511	.	A	G	7	7	14	0	0	14	0	0
19	2871553	.	C	T	7	8	15	1	0	16	0	0
19	2871559	.	G	A	8	6	14	1	1	16	0	0
19	2884200	.	G	A	1	3	4	0	0	4	0	0
19	2884207	.	C	T	2	3	5	0	0	5	0	0
19	2886952	.	G	A	4	3	7	0	2	9	0	0
19	2887046	.	G	C	0	4	4	0	3	7	0	0
19	2930521	.	T	C	5	2	7	0	1	8	0	0
19	2930597	.	A	G	8	7	15	0	0	15	0	0
19	3002047	.	G	A	1	2	3	0	0	3	0	0
19	3056629	.	C	T	3	3	6	0	0	6	0	0
19	3080572	.	G	A	4	3	7	0	0	7	0	0
19	3080712	.	T	A	6	7	13	0	1	14	0	0
19	3080907	.	A	T	6	6	12	0	0	12	0	0
19	3080916	.	A	G	7	4	11	0	1	12	0	0
19	3081106	.	C	G	6	4	10	0	0	10	0	0
19	3081122	.	A	T	6	7	13	0	0	13	0	0
19	3081154	.	G	C	6	4	10	0	0	10	0	0
19	3081206	.	G	T	5	6	11	0	0	11	0	0
19	3081628	.	T	C	2	2	4	4	0	8	0	0
19	3081927	.	G	A	14	8	22	0	0	22	0	0
19	3081933	.	G	A	3	11	14	0	11	25	0	0
19	3082102	.	C	T	9	7	16	0	2	18	0	0
19	3087025	.	A	G	6	7	13	0	0	13	0	0
19	3087180	.	C	A	1	5	6	0	0	6	0	0
19	3102895	.	C	A	0	2	2	0	1	3	0	0
19	3137727	.	C	T	2	27	29	0	23	52	0	0
19	3137761	.	C	A	17	28	45	0	2	47	0	0
19	3137803	.	A	T	25	18	43	0	6	49	0	0
19	3137888	.	T	C	22	0	22	0	31	53	0	0
19	3138325	.	A	C	28	12	40	0	3	43	0	0
19	3138355	.	T	G	28	16	44	0	1	45	0	0
19	3138638	.	T	C	15	0	15	0	16	31	0	0
19	3142240	.	T	C	15	16	31	0	2	33	0	0
19	3142260	.	T	C	20	0	20	0	11	31	0	0
19	3142286	.	C	G	19	7	26	0	0	26	0	0
19	3144567	.	A	G	6	25	31	0	1	32	0	0
19	3144841	.	T	A	15	14	29	0	2	31	0	0
19	3144859	.	C	T	14	14	28	0	1	30	1	0
19	3149236	.	T	C	8	7	15	0	0	15	0	0
19	3149296	.	A	C	5	6	11	0	1	12	0	0
19	3149320	.	T	G	6	9	15	0	0	15	0	0
19	3149368	.	A	T	2	12	14	0	0	14	0	0
19	3149692	.	A	G	3	6	9	0	0	9	0	0
19	3206382	.	G	A	14	13	27	0	0	27	0	0
19	3215468	.	A	G	10	10	20	0	0	20	0	0
19	3222241	.	G	A	6	7	13	0	2	15	0	0
19	3229424	.	A	G	13	17	30	0	3	33	0	0
19	3238395	.	T	A	16	20	36	0	2	38	0	0
19	3238425	.	T	C	16	24	40	0	1	41	0	0
19	3238721	.	T	A	35	26	61	0	2	63	0	0
19	3240409	.	G	C	26	26	52	1	0	53	0	0
19	3386258	.	T	A	9	12	21	0	0	21	0	0
19	3386358	.	A	G	9	13	22	0	0	22	0	0
19	3386485	.	C	A	10	14	24	0	1	25	0	0
19	3386580	.	T	A	8	4	12	0	3	15	0	0
19	3386873	.	C	T	14	16	30	0	3	33	0	0
19	3387040	.	C	A	2	18	20	0	21	41	0	0
19	3387068	.	A	C	15	20	35	0	1	36	0	0
19	3387097	.	C	G	14	21	35	0	5	40	0	0
19	3387506	.	G	A	16	19	35	0	0	35	0	0
19	3387713	.	G	A	27	15	42	0	4	46	0	0
19	3388376	.	T	C	21	25	46	0	1	47	0	0
19	3388467	.	T	C	17	19	36	0	1	37	0	0
19	3388617	.	G	A	10	18	28	0	1	29	0	0
19	3390203	.	G	A	10	17	27	0	1	28	0	0
19	3390283	.	G	T	12	9	21	0	0	21	0	0
19	3390506	.	C	G	11	9	20	0	0	20	0	0
19	3391479	.	G	A	6	4	10	0	0	10	0	0
19	3391608	.	T	A	12	3	15	0	0	15	0	0
19	3391669	.	A	G	9	5	14	0	0	14	0	0
19	3391805	.	T	G	6	8	14	0	1	15	0	0
19	3392127	.	G	A	8	5	13	0	0	13	0	0
19	3392178	.	C	T	5	4	9	0	0	9	0	0
19	3392415	.	G	T	6	6	12	0	0	12	0	0
19	3392481	.	A	G	6	5	11	0	0	11	0	0
19	3392854	.	T	A	6	2	8	0	0	8	0	0
19	3393128	.	A	T	8	7	15	0	2	17	0	0
19	3393343	.	G	C	2	8	10	0	0	10	0	0
19	3393437	.	T	A	5	2	7	0	1	8	0	0
19	3393924	.	G	A	5	2	7	0	0	7	0	0
19	3395763	.	T	A	2	2	4	0	0	4	0	0
19	3396103	.	A	G	1	2	3	0	0	3	0	0
19	3540311	.	T	C	2	0	2	0	3	5	0	0
19	3540314	.	C	G	2	3	5	0	0	5	0	0
19	3573912	.	A	T	1	7	8	0	1	9	0	0
19	3573971	.	A	G	1	5	6	0	2	8	0	0
19	3577994	.	A	G	1	4	5	0	0	5	0	0
19	3577997	.	A	G	1	4	5	0	0	5	0	0
19	3578066	.	G	A	1	2	3	0	0	3	0	0
19	3681134	.	C	T	2	2	4	0	0	4	0	0
19	3698060	.	A	G	1	2	3	0	0	3	0	0
19	3702941	.	G	A	0	4	4	0	4	8	0	0
19	3703149	.	A	G	4	7	11	0	0	11	0	0
19	3703178	.	C	T	6	3	9	0	2	11	0	0
19	3706875	.	C	T	3	6	9	0	0	9	0	0
19	3706902	.	C	G	6	0	6	0	3	9	0	0
19	3707235	.	A	G	7	7	14	0	4	18	0	0
19	3707334	.	G	A	3	2	5	0	3	8	0	0
19	3707562	.	T	A	1	4	5	0	0	5	0	0
19	3707576	.	C	T	3	3	6	0	0	6	0	0
19	3707625	.	G	A	0	4	4	0	6	10	0	0
19	3718110	.	A	T	10	10	20	0	1	21	0	0
19	3718222	.	G	A	7	16	23	0	3	26	0	0
19	3718251	.	C	A	11	21	32	0	0	32	0	0
19	3718330	.	G	A	20	19	39	0	1	40	0	0
19	3718415	.	G	T	21	18	39	0	4	43	0	0
19	3718675	.	C	A	15	21	36	0	0	36	0	0
19	3865928	.	C	T	2	10	12	0	12	24	0	0
19	3866029	.	C	T	10	17	27	0	0	27	0	0
19	3866031	.	G	A	8	17	25	0	1	26	0	0
19	3866075	.	T	C	15	11	26	0	1	27	0	0
19	3866102	.	A	G	18	15	33	0	1	34	0	0
19	3866165	.	T	C	24	11	35	0	3	38	0	0
19	3866206	.	T	A	11	5	16	0	0	16	0	0
19	3866289	.	C	G	8	7	15	0	1	16	0	0
19	3866424	.	A	T	11	20	31	0	4	35	0	0
19	3866727	.	C	T	0	10	10	0	20	30	0	0
19	3868535	.	T	C	14	15	29	0	0	29	0	0
19	3868541	.	C	T	1	9	10	0	18	28	0	0
19	3872386	.	G	A	12	6	18	0	0	18	0	0
19	3872419	.	C	T	6	10	16	0	0	16	0	0
19	3872833	.	C	T	4	10	14	0	3	17	0	0
19	3873019	.	C	T	14	8	22	0	2	24	0	0
19	3873055	.	C	T	14	8	22	0	1	23	0	0
19	3873847	.	A	C	7	8	15	0	0	15	0	0
19	3873955	.	G	A	5	5	10	0	1	11	0	0
19	3874195	.	A	G	8	13	21	0	0	21	0	0
19	3874277	.	C	A	7	6	13	0	0	13	0	0
19	3874339	.	G	A	3	6	9	0	0	9	0	0
19	3874381	.	G	A	2	2	4	0	1	5	0	0
19	3876296	.	C	T	3	3	6	0	0	6	0	0
19	3878548	.	C	T	3	5	8	0	0	8	0	0
19	3878565	.	G	C	3	4	7	0	0	7	0	0
19	3937971	.	T	C	23	29	52	0	4	56	0	0
19	3939887	.	C	T	30	21	51	0	4	55	0	0
19	3939902	.	G	T	30	22	52	0	2	54	0	0
19	3940022	.	C	T	6	12	18	0	34	52	0	0
19	3945750	.	G	T	26	12	38	0	3	41	0	0
19	4010146	.	A	G	9	7	16	0	0	16	0	0
19	4024467	.	T	C	3	2	5	0	0	5	0	0
19	4071374	.	G	A	2	5	7	0	0	7	0	0
19	4089843	.	A	C	4	1	5	0	1	6	0	0
19	4089974	.	T	C	7	3	10	0	0	10	0	0
19	4090131	.	G	T	1	3	4	0	0	4	0	0
19	4090149	.	A	G	2	2	4	0	0	4	0	0
19	4090658	.	T	A	8	2	10	0	0	10	0	0
19	4090662	.	A	G	7	2	9	0	1	10	0	0
19	4090694	.	T	A	7	2	9	0	0	9	0	0
19	4127217	.	G	A	1	3	4	0	0	4	0	0
19	4128405	.	C	T	1	4	5	0	0	5	0	0
19	4143053	.	A	T	2	3	5	0	0	5	0	0
19	4194072	.	T	C	3	3	6	0	0	6	0	0
19	4341539	.	T	C	4	9	13	0	0	13	0	0
19	4443403	.	T	C	8	5	13	0	1	14	0	0
19	4445222	.	A	T	5	3	8	0	0	8	0	0
19	4445269	.	T	C	4	3	7	0	0	7	0	0
19	4446293	.	A	G	8	8	16	0	0	17	1	0
19	4447347	.	G	A	4	1	5	0	3	8	0	0
19	4447403	.	A	T	6	3	9	0	0	9	0	0
19	4447502	.	T	A	9	7	16	0	0	16	0	0
19	4530146	.	A	G	4	0	4	0	3	7	0	0
19	4530264	.	T	C	3	4	7	0	0	7	0	0
19	4530872	.	G	T	0	4	4	0	4	8	0	0
19	4828395	.	T	C	3	4	7	0	0	7	0	0
19	4828428	.	A	T	3	4	7	0	0	7	0	0
19	4828463	.	A	G	5	5	10	0	0	10	0	0
19	4828464	.	A	T	5	4	9	0	1	10	0	0
19	4836409	.	T	C	1	0	1	0	2	3	0	0
19	4836418	.	T	C	1	3	4	0	0	4	0	0
19	4840428	.	A	C	1	0	1	0	2	3	0	0
19	4856825	.	C	A	2	2	4	0	2	6	0	0
19	4856852	.	A	T	4	2	6	0	0	6	0	0
19	4857547	.	G	A	3	8	11	0	0	11	0	0
19	4866919	.	T	C	15	7	22	0	3	25	0	0
19	4866936	.	C	T	15	10	25	0	1	26	0	0
19	4867128	.	C	T	13	12	25	0	1	26	0	0
19	4867168	.	G	C	13	9	22	0	5	27	0	0
19	4875478	.	G	A	8	3	11	0	0	11	0	0
19	4875583	.	A	G	8	9	17	0	0	17	0	0
19	4875595	.	A	G	10	8	18	0	1	19	0	0
19	4878742	.	G	T	4	8	12	0	1	13	0	0
19	4888471	.	T	G	8	12	20	0	0	20	0	0
19	4888744	.	A	G	18	11	29	0	0	29	0	0
19	4888756	.	G	A	1	8	9	0	20	29	0	0
19	4892154	.	G	A	20	14	34	0	1	35	0	0
19	4892590	.	C	T	3	4	7	0	1	8	0	0
19	4892628	.	A	G	4	6	10	0	0	10	0	0
19	4892643	.	T	C	7	10	17	0	0	17	0	0
19	4892787	.	C	T	5	7	12	0	3	15	0	0
19	4892940	.	G	A	1	7	8	0	8	16	0	0
19	4892946	.	A	T	5	8	13	0	1	14	0	0
19	4893033	.	A	G	6	0	6	0	4	10	0	0
19	4903998	.	A	G	24	11	35	0	0	35	0	0
19	4904042	.	A	T	13	7	20	0	10	30	0	0
19	4904127	.	C	T	5	9	14	0	2	16	0	0
19	4904193	.	A	G	6	2	8	0	2	10	0	0
19	4904196	.	A	G	7	1	8	0	2	10	0	0
19	4904407	.	T	C	3	4	7	0	0	7	0	0
19	4904429	.	G	A	4	3	7	0	0	7	0	0
19	4904529	.	T	A	7	3	10	0	0	10	0	0
19	4904569	.	T	C	5	2	7	0	0	7	0	0
19	4904766	.	T	C	7	9	16	0	1	17	0	0
19	4904972	.	T	C	12	8	20	0	0	20	0	0
19	4904991	.	T	C	11	7	18	0	1	19	0	0
19	4905088	.	G	T	14	9	23	0	3	26	0	0
19	4905175	.	G	A	13	6	19	0	1	20	0	0
19	4905229	.	T	C	11	7	18	0	0	18	0	0
19	4905239	.	C	T	11	6	17	0	1	18	0	0
19	4913087	.	A	G	3	7	10	0	1	11	0	0
19	4951183	.	C	A	8	5	13	1	1	15	0	0
19	4960956	.	G	A	4	6	10	0	0	10	0	0
19	4961489	.	A	G	2	2	4	0	0	4	0	0
19	4961490	.	A	G	2	2	4	0	0	4	0	0
19	4961575	.	A	G	2	2	4	0	0	4	0	0
19	4961603	.	C	T	4	2	6	0	0	6	0	0
19	4961656	.	A	G	3	7	10	0	0	10	0	0
19	4970776	.	C	T	7	2	9	0	1	10	0	0
19	4970896	.	G	A	1	3	4	0	0	4	0	0
19	4978660	.	G	T	2	2	4	0	1	5	0	0
19	4978704	.	C	G	3	6	9	0	1	10	0	0
19	4984739	.	G	A	4	7	11	0	1	12	0	0
19	4985064	.	T	A	6	6	12	0	1	13	0	0
19	4985105	.	A	G	3	4	7	0	0	7	0	0
19	4985125	.	C	T	2	2	4	0	0	4	0	0
19	4985151	.	T	A	1	2	3	0	0	3	0	0
19	4985285	.	C	T	2	3	5	0	0	6	1	0
19	4985444	.	T	C	2	2	4	0	0	4	0	0
19	4985465	.	T	A	3	2	5	0	0	5	0	0
19	4996674	.	A	G	2	6	8	0	0	8	0	0
19	4996698	.	T	C	1	3	4	0	1	5	0	0
19	4998787	.	T	A	1	2	3	0	0	3	0	0
19	4998818	.	T	C	2	2	4	0	0	4	0	0
19	5003359	.	T	G	14	23	37	0	0	37	0	0
19	5007465	.	G	A	14	15	29	0	2	31	0	0
19	5007549	.	G	A	25	18	43	0	0	43	0	0
19	5009251	.	A	C	8	14	22	0	2	24	0	0
19	5009489	.	G	A	14	13	27	0	3	30	0	0
19	5016071	.	T	C	14	22	36	0	1	37	0	0
19	5016257	.	G	C	13	0	13	0	13	26	0	0
19	5016302	.	T	G	13	18	31	0	1	32	0	0
19	5018340	.	A	G	11	6	17	0	3	20	0	0
19	5019697	.	G	C	17	11	28	0	1	29	0	0
19	5019712	.	A	T	17	12	29	0	0	29	0	0
19	5019736	.	A	G	18	8	26	0	0	26	0	0
19	5020451	.	G	A	7	9	16	0	1	17	0	0
19	5024541	.	C	T	16	10	26	0	0	26	0	0
19	5025813	.	T	C	3	0	3	0	10	13	0	0
19	5026119	.	A	G	6	8	14	0	1	15	0	0
19	5028136	.	G	A	11	10	21	0	0	21	0	0
19	5028605	.	A	G	3	10	13	0	0	13	0	0
19	5028719	.	C	T	0	4	4	1	5	10	0	0
19	5030032	.	T	C	9	4	13	0	0	13	0	0
19	5031461	.	G	A	4	4	8	0	1	9	0	0
19	5031617	.	T	C	9	4	13	0	0	13	0	0
19	5032178	.	T	C	3	5	8	0	0	8	0	0
19	5032199	.	A	C	4	4	8	0	0	8	0	0
19	5034965	.	G	A	5	6	11	0	0	11	0	0
19	5039259	.	G	T	1	6	7	0	1	8	0	0
19	5039491	.	A	T	7	4	11	0	0	11	0	0
19	5039530	.	T	C	4	0	4	0	5	9	0	0
19	5042062	.	T	C	4	0	4	0	7	11	0	0
19	5042074	.	G	A	4	6	10	0	1	11	0	0
19	5045606	.	C	T	0	3	3	0	2	5	0	0
19	5048954	.	T	A	5	2	7	0	0	7	0	0
19	5058655	.	T	A	2	2	4	0	0	4	0	0
19	5058763	.	G	A	3	2	5	0	1	6	0	0
19	5077114	.	C	T	27	18	45	0	2	47	0	0
19	5077167	.	A	G	24	25	49	0	2	51	0	0
19	5077173	.	C	T	25	21	46	0	3	49	0	0
19	5077356	.	C	T	29	28	57	1	1	59	0	0
19	5080112	.	A	C	28	24	52	0	6	58	0	0
19	5082095	.	A	G	28	27	55	0	1	56	0	0
19	5082161	.	C	T	22	24	46	0	5	51	0	0
19	5090035	.	C	G	36	19	55	0	3	58	0	0
19	5090264	.	G	A	25	15	40	1	1	42	0	0
19	5090409	.	G	A	35	23	58	0	1	59	0	0
19	5090483	.	A	T	29	28	57	0	2	59	0	0
19	5091503	.	C	T	33	23	56	0	4	60	0	0
19	5091587	.	G	C	24	32	56	0	4	60	0	0
19	5094244	.	C	T	5	2	7	0	0	7	0	0
19	5094405	.	C	A	1	14	15	0	7	22	0	0
19	5094417	.	A	T	15	9	24	0	1	25	0	0
19	5094504	.	A	G	12	17	29	0	1	30	0	0
19	5094564	.	T	A	12	13	25	0	1	26	0	0
19	5100191	.	G	A	14	9	23	0	1	24	0	0
19	5100240	.	G	A	12	11	23	0	0	23	0	0
19	5100249	.	C	T	12	9	21	0	1	22	0	0
19	5100458	.	G	A	8	15	23	0	1	24	0	0
19	5100665	.	C	T	11	12	23	0	1	24	0	0
19	5143975	.	A	T	3	2	5	0	1	6	0	0
19	5144107	.	C	T	3	4	7	0	0	7	0	0
19	5144395	.	T	C	1	4	5	0	0	5	0	0
19	5144962	.	G	A	3	3	6	0	0	6	0	0
19	5146708	.	C	T	9	11	20	0	3	23	0	0
19	5149133	.	T	C	19	18	37	0	1	38	0	0
19	5158657	.	G	A	56	32	88	0	4	92	0	0
19	5159120	.	C	T	50	20	70	0	10	80	0	0
19	5159399	.	T	A	36	26	62	1	3	66	0	0
19	5159425	.	C	T	31	30	61	0	2	63	0	0
19	5159534	.	G	A	30	24	54	2	3	59	0	0
19	5160048	.	C	G	31	31	62	0	6	68	0	0
19	5160121	.	T	C	27	1	28	0	31	59	0	0
19	5160201	.	A	G	28	30	58	0	3	62	1	0
19	5161750	.	A	G	25	24	49	2	0	51	0	0
19	5161782	.	C	T	17	27	44	1	2	47	0	0
19	5162105	.	G	A	28	21	49	0	2	51	0	0
19	5162300	.	T	G	28	30	58	0	4	62	0	0
19	5162521	.	G	A	29	18	47	0	0	47	0	0
19	5162679	.	A	G	23	22	45	1	1	47	0	0
19	5162685	.	T	A	22	26	48	1	1	50	0	0
19	5162960	.	A	T	15	16	31	0	5	36	0	0
19	5163127	.	A	T	23	25	48	0	0	49	1	0
19	5163409	.	G	A	27	27	54	0	0	54	0	0
19	5163434	.	A	G	27	27	54	0	1	55	0	0
19	5163635	.	C	T	23	18	41	0	1	45	3	0
19	5299970	.	T	C	1	7	8	0	0	8	0	0
19	5300036	.	G	A	2	4	6	0	0	6	0	0
19	5302286	.	A	G	1	3	4	0	0	4	0	0
19	5305193	.	T	C	5	6	11	0	0	11	0	0
19	5305612	.	C	T	3	2	5	0	0	5	0	0
19	5305710	.	A	T	2	2	4	0	0	4	0	0
19	5318355	.	G	A	1	3	4	1	11	16	0	0
19	5318356	.	T	A	11	4	15	1	0	16	0	0
19	5318806	.	A	C	8	8	16	0	0	16	0	0
19	5318979	.	G	A	14	9	23	0	4	27	0	0
19	5319096	.	C	G	14	9	23	0	1	24	0	0
19	5332399	.	C	T	0	2	2	0	1	3	0	0
19	5367858	.	C	A	2	2	4	0	0	4	0	0
19	5368273	.	A	C	1	3	4	0	0	4	0	0
19	5378640	.	G	A	4	4	8	0	1	9	0	0
19	5378808	.	T	A	16	14	30	0	0	30	0	0
19	5379587	.	T	C	16	11	27	0	0	27	0	0
19	5379727	.	C	T	9	7	16	0	3	19	0	0
19	5379748	.	C	T	8	4	12	0	0	12	0	0
19	5380014	.	G	T	8	9	17	0	2	19	0	0
19	5380530	.	G	A	1	5	6	0	0	6	0	0
19	5418116	.	T	A	21	18	39	0	1	40	0	0
19	5421086	.	T	A	32	30	62	0	8	70	0	0
19	5421277	.	T	G	22	0	22	0	36	58	0	0
19	5480485	.	T	C	7	4	11	0	0	11	0	0
19	5552433	.	G	A	0	7	7	0	3	10	0	0
19	5569767	.	C	G	3	3	6	0	0	6	0	0
19	5569864	.	A	C	3	3	6	0	1	7	0	0
19	5582319	.	G	T	10	6	16	0	1	17	0	0
19	5582376	.	A	G	4	8	12	0	1	13	0	0
19	5582418	.	T	C	6	6	12	0	2	14	0	0
19	5610860	.	T	A	12	10	22	0	0	22	0	0
19	5611772	.	G	A	23	24	47	0	3	50	0	0
19	5611856	.	A	T	21	18	39	0	2	41	0	0
19	5615570	.	C	A	20	16	36	1	3	40	0	0
19	5619685	.	G	A	2	10	12	0	33	45	0	0
19	5619735	.	G	A	28	20	48	0	1	49	0	0
19	5619926	.	G	A	2	9	11	0	12	23	0	0
19	5620011	.	G	A	0	12	12	0	18	30	0	0
19	5620370	.	T	C	16	14	30	0	0	30	0	0
19	5620380	.	G	A	17	14	31	0	1	32	0	0
19	5620419	.	G	A	20	14	34	0	2	36	0	0
19	5620498	.	T	A	17	14	31	0	1	32	0	0
19	5620631	.	C	T	14	14	28	0	3	31	0	0
19	5620772	.	G	A	16	11	27	0	0	27	0	0
19	5620810	.	T	C	19	9	28	0	0	28	0	0
19	5621096	.	T	C	13	19	32	0	2	34	0	0
19	5621124	.	G	T	23	14	37	0	1	38	0	0
19	5621131	.	A	G	15	0	15	0	23	38	0	0
19	5621269	.	C	T	1	6	7	0	0	7	0	0
19	5779170	.	C	T	8	4	12	0	0	12	0	0
19	5779271	.	A	G	7	11	18	0	2	20	0	0
19	5779829	.	G	T	13	8	21	0	2	23	0	0
19	5779835	.	C	T	14	9	23	0	0	23	0	0
19	5779897	.	T	C	18	13	31	0	1	32	0	0
19	5780032	.	C	G	0	8	8	0	9	17	0	0
19	5780293	.	A	T	14	8	22	1	1	24	0	0
19	5780312	.	A	T	12	11	23	1	1	25	0	0
19	5780585	.	G	T	7	10	17	0	0	17	0	0
19	5780688	.	A	C	8	7	15	0	0	15	0	0
19	5780989	.	G	A	16	10	26	1	0	27	0	0
19	5781259	.	A	T	7	10	17	0	1	18	0	0
19	5781316	.	G	T	8	4	12	0	1	13	0	0
19	5781367	.	T	C	2	6	8	0	1	9	0	0
19	5793484	.	C	G	10	5	15	0	0	15	0	0
19	5793532	.	T	C	6	8	14	0	0	14	0	0
19	5801151	.	G	A	8	4	12	0	2	14	0	0
19	5805833	.	G	A	5	4	9	0	0	9	0	0
19	5805839	.	G	A	6	6	12	0	0	12	0	0
19	6060281	.	T	A	13	14	27	0	1	28	0	0
19	6060309	.	A	T	8	17	25	1	3	29	0	0
19	6060415	.	C	A	1	5	6	0	10	16	0	0
19	6083524	.	G	A	6	3	9	0	0	9	0	0
19	6086441	.	C	G	13	18	31	0	2	33	0	0
19	6086577	.	C	T	2	21	23	0	15	38	0	0
19	6087130	.	T	A	6	13	19	0	0	19	0	0
19	6087146	.	C	T	1	16	17	0	5	22	0	0
19	6087186	.	A	T	10	12	22	0	1	24	1	0
19	6087619	.	T	C	7	0	7	0	12	19	0	0
19	6087894	.	G	A	12	9	21	0	0	21	0	0
19	6087948	.	A	T	12	7	19	1	3	23	0	0
19	6088000	.	C	T	2	14	16	1	18	35	0	0
19	6088166	.	T	C	8	9	17	0	0	17	0	0
19	6088259	.	A	C	11	14	25	0	3	28	0	0
19	6088368	.	A	G	14	15	29	0	2	32	1	0
19	6090702	.	T	C	15	14	29	0	0	29	0	0
19	6090732	.	T	A	13	10	23	0	2	25	0	0
19	6094162	.	A	C	15	12	27	0	1	28	0	0
19	6097473	.	C	A	13	15	28	0	1	29	0	0
19	6100295	.	A	G	9	16	25	0	1	26	0	0
19	6102594	.	A	T	12	6	18	0	2	20	0	0
19	6102732	.	T	C	6	11	17	0	1	18	0	0
19	6105528	.	A	T	7	10	17	0	0	18	1	0
19	6111214	.	A	G	6	9	15	0	4	19	0	0
19	6111223	.	A	G	5	10	15	0	2	17	0	0
19	6111268	.	G	A	11	12	23	0	2	25	0	0
19	6111544	.	A	G	7	4	11	0	0	11	0	0
19	6111724	.	T	C	6	3	9	0	0	9	0	0
19	6111793	.	G	A	4	7	11	0	2	13	0	0
19	6116638	.	A	G	6	7	13	0	1	14	0	0
19	6122614	.	A	G	4	3	7	0	0	7	0	0
19	6124000	.	T	C	2	1	3	0	3	6	0	0
19	6125329	.	G	T	6	4	10	0	0	10	0	0
19	6125350	.	A	G	5	6	11	0	0	11	0	0
19	6125425	.	A	T	3	6	9	0	1	10	0	0
19	6125656	.	G	C	3	3	6	0	0	6	0	0
19	6125926	.	G	A	6	5	11	0	0	11	0	0
19	6125941	.	C	T	3	6	9	0	2	11	0	0
19	6126001	.	G	A	3	8	11	0	2	13	0	0
19	6126046	.	A	T	2	4	6	0	6	12	0	0
19	6126403	.	C	G	4	2	6	0	0	6	0	0
19	6126625	.	G	A	2	3	5	0	0	5	0	0
19	6126645	.	T	C	2	3	5	0	0	5	0	0
19	6127847	.	G	T	3	4	7	0	1	8	0	0
19	6142187	.	C	A	1	4	5	0	11	16	0	0
19	6142433	.	T	A	8	2	10	0	4	14	0	0
19	6142669	.	T	A	16	9	25	0	1	26	0	0
19	6142714	.	A	T	13	7	20	0	2	22	0	0
19	6142802	.	G	T	7	5	12	0	0	12	0	0
19	6142803	.	A	G	7	5	12	0	0	12	0	0
19	6143825	.	C	T	8	4	12	0	0	12	0	0
19	6144267	.	C	A	3	4	7	0	2	9	0	0
19	6144659	.	G	A	3	2	5	0	0	5	0	0
19	6144722	.	C	T	5	5	10	0	0	10	0	0
19	6144822	.	C	G	3	3	6	0	0	6	0	0
19	6145382	.	T	A	1	3	4	0	0	4	0	0
19	6145736	.	G	A	5	2	7	0	0	7	0	0
19	6214598	.	G	A	6	5	11	0	2	13	0	0
19	6214884	.	T	A	5	6	11	0	0	11	0	0
19	6217133	.	T	A	1	2	3	0	0	3	0	0
19	6328442	.	T	C	46	10	56	0	38	94	0	0
19	6328514	.	A	C	44	25	69	0	3	72	0	0
19	6328533	.	A	G	50	31	81	0	2	83	0	0
19	6328830	.	T	G	45	29	74	2	7	83	0	0
19	6328859	.	G	A	41	24	65	2	5	72	0	0
19	6328889	.	C	T	1	27	28	0	41	69	0	0
19	6328906	.	G	A	35	36	71	0	2	73	0	0
19	6329062	.	A	T	40	21	61	3	3	67	0	0
19	6329381	.	A	T	42	26	68	0	3	71	0	0
19	6329382	.	T	G	43	27	70	0	2	72	0	0
19	6329533	.	C	T	2	36	38	0	35	73	0	0
19	6329813	.	G	A	43	26	69	0	5	74	0	0
19	6330194	.	A	C	45	4	49	1	31	81	0	0
19	6330239	.	C	A	2	33	35	1	42	78	0	0
19	6332767	.	A	C	39	3	42	0	40	82	0	0
19	6332902	.	C	A	8	36	44	0	31	75	0	0
19	6332947	.	C	T	9	27	36	0	43	79	0	0
19	6332973	.	G	A	38	31	69	0	5	74	0	0
19	6338207	.	A	G	20	31	51	0	3	54	0	0
19	6338261	.	A	G	21	26	47	0	1	48	0	0
19	6342278	.	G	T	35	26	61	0	1	62	0	0
19	6344522	.	G	C	27	0	27	0	30	57	0	0
19	6346506	.	C	G	26	18	44	0	0	44	0	0
19	6346587	.	C	T	1	15	16	0	18	34	0	0
19	6347662	.	C	T	16	14	30	0	2	32	0	0
19	6352379	.	A	G	9	11	20	1	5	26	0	0
19	6352448	.	G	A	9	19	28	0	0	28	0	0
19	6352511	.	G	A	15	22	37	0	1	38	0	0
19	6358232	.	A	G	11	12	23	0	0	23	0	0
19	6365777	.	G	A	12	14	26	0	0	26	0	0
19	6606673	.	T	A	2	3	5	0	0	5	0	0
19	6606764	.	A	T	3	2	5	0	0	5	0	0
19	6618293	.	A	G	3	3	6	0	0	6	0	0
19	6872595	.	C	T	2	2	4	0	0	4	0	0
19	6893220	.	T	C	1	2	3	0	0	3	0	0
19	6893224	.	T	C	1	1	2	0	0	2	0	0
19	6901116	.	A	T	1	5	6	0	0	6	0	0
19	6901174	.	G	T	0	4	4	0	4	8	0	0
19	6907716	.	C	T	4	1	5	3	0	8	0	0
19	6907740	.	T	C	4	2	6	1	0	7	0	0
19	6907785	.	G	A	2	4	6	0	0	6	0	0
19	6908433	.	A	C	1	2	3	0	0	3	0	0
19	6908650	.	T	C	4	2	6	0	0	6	0	0
19	6908651	.	T	C	4	2	6	0	0	6	0	0
19	6910409	.	A	G	2	4	6	0	0	6	0	0
19	6914280	.	A	T	5	3	8	0	1	9	0	0
19	6914415	.	T	C	1	3	4	1	0	5	0	0
19	6914589	.	T	C	1	5	6	0	0	6	0	0
19	6915030	.	T	C	5	3	8	0	0	8	0	0
19	6915114	.	C	T	2	3	5	0	0	5	0	0
19	6915234	.	G	A	5	1	6	3	1	10	0	0
19	6916158	.	C	A	2	5	7	0	0	7	0	0
19	6922240	.	G	A	1	2	3	0	0	3	0	0
19	6922387	.	A	G	1	2	3	0	0	3	0	0
19	6922936	.	G	A	3	2	5	1	0	6	0	0
19	6922938	.	A	G	3	2	5	1	0	6	0	0
19	6933253	.	G	A	2	2	4	1	0	5	0	0
19	6933469	.	G	A	4	1	5	1	1	7	0	0
19	6933697	.	G	T	0	4	4	0	1	5	0	0
19	6933716	.	T	A	1	2	3	0	0	3	0	0
19	6933808	.	G	C	2	3	5	0	0	5	0	0
19	6934112	.	G	C	1	4	5	0	0	5	0	0
19	6938364	.	A	T	6	4	10	0	0	10	0	0
19	6938377	.	A	T	7	4	11	0	0	11	0	0
19	6940213	.	C	T	8	5	13	0	1	14	0	0
19	6949256	.	G	A	1	14	15	0	14	29	0	0
19	6949316	.	C	A	18	13	31	0	1	32	0	0
19	6950393	.	G	A	17	9	26	0	3	29	0	0
19	6952600	.	T	C	17	15	32	0	2	34	0	0
19	6955061	.	C	T	18	20	38	0	1	39	0	0
19	6955130	.	C	T	15	14	29	0	1	30	0	0
19	6955131	.	C	T	16	13	29	0	1	30	0	0
19	6955198	.	C	A	19	17	36	0	2	38	0	0
19	6955411	.	C	T	10	7	17	0	2	19	0	0
19	6955475	.	T	C	12	6	18	0	1	19	0	0
19	6955609	.	C	G	15	12	27	0	1	28	0	0
19	6955620	.	G	A	3	9	12	0	15	27	0	0
19	6955920	.	G	A	12	10	22	0	1	23	0	0
19	6956058	.	T	C	17	21	38	1	2	41	0	0
19	6956060	.	G	A	17	21	38	1	2	41	0	0
19	6956553	.	A	C	2	4	6	0	3	9	0	0
19	6956555	.	A	T	5	4	9	0	0	9	0	0
19	6956665	.	C	A	13	10	23	0	1	24	0	0
19	6956728	.	T	A	21	13	34	0	0	34	0	0
19	6956829	.	T	A	12	9	21	0	3	24	0	0
19	6956835	.	C	G	13	7	20	0	0	20	0	0
19	6956881	.	T	C	10	8	18	0	1	19	0	0
19	6956892	.	T	A	10	7	17	0	0	17	0	0
19	6957127	.	A	T	33	15	48	0	3	51	0	0
19	6957131	.	C	A	30	15	45	0	6	51	0	0
19	6960653	.	C	A	7	4	11	0	1	12	0	0
19	6960921	.	T	A	7	2	9	1	2	12	0	0
19	6961095	.	G	A	8	8	16	0	0	16	0	0
19	6961211	.	T	C	3	3	6	4	0	10	0	0
19	6961421	.	T	A	10	10	20	0	0	20	0	0
19	6961610	.	G	A	9	5	14	0	0	14	0	0
19	6961674	.	A	G	8	11	19	0	0	19	0	0
19	6963020	.	C	T	4	4	8	0	0	8	0	0
19	6963996	.	G	A	4	4	8	0	0	8	0	0
19	6964041	.	A	G	6	5	11	1	1	13	0	0
19	6964273	.	C	A	4	9	13	0	1	14	0	0
19	6964364	.	C	T	10	6	16	0	1	17	0	0
19	6964381	.	T	C	10	7	17	0	1	18	0	0
19	6964417	.	A	G	6	8	14	0	0	14	0	0
19	6964636	.	C	T	5	3	8	0	1	9	0	0
19	6964641	.	T	C	4	0	4	0	4	8	0	0
19	6965894	.	C	A	0	3	3	0	3	6	0	0
19	6965897	.	C	T	3	3	6	0	0	6	0	0
19	6966208	.	G	A	6	3	9	0	0	9	0	0
19	6966271	.	T	G	7	6	13	0	4	17	0	0
19	6966781	.	A	T	8	4	12	0	0	12	0	0
19	6975261	.	A	C	3	0	3	1	4	8	0	0
19	6980493	.	C	T	4	2	6	1	1	8	0	0
19	6982477	.	C	G	1	2	3	0	0	3	0	0
19	6988778	.	T	C	2	3	5	0	0	5	0	0
19	6996885	.	A	G	1	2	3	0	0	3	0	0
19	7003228	.	C	A	2	3	5	0	0	5	0	0
19	7003266	.	T	C	2	2	4	0	0	4	0	0
19	7005549	.	A	C	1	3	4	0	0	4	0	0
19	7005881	.	C	T	1	7	8	0	0	8	0	0
19	7006215	.	C	T	2	5	7	0	1	8	0	0
19	7006682	.	G	A	2	2	4	0	0	4	0	0
19	7006709	.	G	T	0	3	3	0	1	4	0	0
19	7006928	.	C	T	3	5	8	0	0	8	0	0
19	7014570	.	C	A	1	2	3	0	0	3	0	0
19	7014778	.	T	A	5	2	7	0	0	7	0	0
19	7014815	.	C	T	3	5	8	0	0	8	0	0
19	7014863	.	T	G	5	4	9	0	0	9	0	0
19	7014909	.	C	A	3	3	6	0	0	6	0	0
19	7014912	.	G	A	3	3	6	0	0	6	0	0
19	7015034	.	T	A	2	2	4	0	1	5	0	0
19	7015143	.	T	A	2	2	4	0	1	5	0	0
19	7020179	.	G	A	8	7	15	0	0	15	0	0
19	7020347	.	C	T	5	3	8	0	0	8	0	0
19	7022107	.	G	A	7	5	12	0	0	12	0	0
19	7022128	.	G	A	5	4	9	0	3	12	0	0
19	7024591	.	T	G	3	2	5	0	0	5	0	0
19	7024593	.	C	T	3	2	5	0	0	5	0	0
19	7024627	.	T	C	2	3	5	0	0	5	0	0
19	7027127	.	G	C	2	3	5	0	1	6	0	0
19	7027810	.	A	T	2	4	6	0	0	6	0	0
19	7027927	.	G	A	1	4	5	0	0	5	0	0
19	7029769	.	A	G	4	1	5	0	1	6	0	0
19	7029770	.	C	G	4	2	6	0	0	6	0	0
19	7029806	.	C	G	6	4	10	0	0	10	0	0
19	7029811	.	G	A	6	4	10	0	0	10	0	0
19	7029883	.	C	A	3	2	5	0	1	6	0	0
19	7031333	.	A	G	2	2	4	0	0	4	0	0
19	7031350	.	G	A	2	2	4	0	0	4	0	0
19	7031368	.	T	G	1	2	3	0	0	3	0	0
19	7038901	.	A	C	1	4	5	0	0	5	0	0
19	7039113	.	G	A	1	5	6	0	0	6	0	0
19	7040056	.	G	C	3	2	5	0	0	5	0	0
19	7068980	.	G	C	1	2	3	0	0	3	0	0
19	7068998	.	C	T	0	2	2	0	1	3	0	0
19	7100564	.	A	T	14	3	17	0	1	18	0	0
19	7100810	.	A	T	1	2	3	0	1	4	0	0
19	7128225	.	T	C	6	3	9	0	0	9	0	0
19	7128229	.	A	C	5	2	7	0	1	8	0	0
19	7131154	.	G	C	1	4	5	0	9	14	0	0
19	7152971	.	G	T	1	5	6	0	5	11	0	0
19	7152974	.	G	A	5	5	10	0	1	11	0	0
19	7154729	.	A	G	16	22	38	0	1	39	0	0
19	7154770	.	A	C	17	18	35	0	2	37	0	0
19	7155001	.	A	T	7	14	21	0	2	23	0	0
19	7155034	.	A	G	14	17	31	0	0	31	0	0
19	7155065	.	T	C	14	17	31	0	0	31	0	0
19	7158469	.	C	T	6	6	12	0	2	14	0	0
19	7158546	.	A	G	13	0	13	0	5	18	0	0
19	7159062	.	G	A	1	7	8	0	11	19	0	0
19	7159107	.	T	C	10	9	19	0	1	20	0	0
19	7161452	.	G	A	3	3	6	0	0	6	0	0
19	7161527	.	A	G	7	0	7	0	7	14	0	0
19	7161539	.	G	T	5	6	11	0	0	11	0	0
19	7163908	.	A	G	9	9	18	0	3	21	0	0
19	7164022	.	G	A	9	5	14	0	0	14	0	0
19	7166211	.	C	T	10	7	17	0	1	18	0	0
19	7166454	.	C	A	9	10	19	0	0	19	0	0
19	7169204	.	A	C	8	12	20	0	2	22	0	0
19	7169228	.	C	T	15	14	29	0	0	29	0	0
19	7169304	.	G	A	8	2	10	0	2	12	0	0
19	7169587	.	A	G	5	5	10	0	0	10	0	0
19	7169588	.	G	A	6	5	11	0	0	11	0	0
19	7169770	.	A	C	4	10	14	1	0	15	0	0
19	7169809	.	C	T	6	9	15	0	0	15	0	0
19	7169880	.	T	C	11	9	20	0	1	21	0	0
19	7169886	.	G	A	11	10	21	0	3	24	0	0
19	7169929	.	G	A	11	11	22	0	0	22	0	0
19	7170014	.	A	C	9	8	17	0	1	18	0	0
19	7170015	.	T	C	9	8	17	0	1	18	0	0
19	7170128	.	A	G	5	8	13	0	1	14	0	0
19	7170191	.	A	C	6	10	16	0	0	16	0	0
19	7170228	.	A	T	1	9	10	0	1	11	0	0
19	7176913	.	G	A	0	3	3	0	8	11	0	0
19	7176915	.	C	A	8	2	10	0	1	11	0	0
19	7179606	.	G	A	3	2	5	0	0	5	0	0
19	7179612	.	G	A	3	2	5	0	0	5	0	0
19	7249800	.	A	G	12	12	24	0	1	25	0	0
19	7249811	.	T	C	14	12	26	0	1	27	0	0
19	7250372	.	T	C	3	6	9	0	0	9	0	0
19	7258085	.	A	G	7	6	13	0	0	13	0	0
19	7258118	.	C	T	6	3	9	0	0	9	0	0
19	7265377	.	T	C	2	4	6	0	0	6	0	0
19	7270102	.	G	A	6	7	13	0	0	13	0	0
19	7270156	.	C	A	1	3	4	0	11	15	0	0
19	7272224	.	C	A	3	7	10	0	0	10	0	0
19	7272935	.	G	A	8	3	11	0	0	11	0	0
19	7276106	.	G	A	8	16	24	0	1	25	0	0
19	7276149	.	A	G	22	26	48	0	0	48	0	0
19	7276194	.	T	A	20	31	51	0	0	51	0	0
19	7276559	.	G	A	33	34	67	0	3	70	0	0
19	7276610	.	G	A	36	34	70	0	4	74	0	0
19	7279235	.	A	G	38	28	66	3	0	69	0	0
19	7279721	.	A	G	28	25	53	0	2	55	0	0
19	7282541	.	C	T	24	31	55	0	3	58	0	0
19	7282554	.	G	A	22	35	57	0	0	57	0	0
19	7283427	.	C	A	29	18	47	0	1	48	0	0
19	7283499	.	A	G	26	27	53	1	0	54	0	0
19	7284840	.	C	T	3	18	21	0	27	48	0	0
19	7286301	.	A	G	24	25	49	0	0	49	0	0
19	7286355	.	A	G	23	21	44	0	2	46	0	0
19	7286421	.	T	A	15	30	45	0	0	45	0	0
19	7286742	.	A	G	24	15	39	0	1	40	0	0
19	7287600	.	T	C	14	20	34	0	3	37	0	0
19	7287603	.	G	A	16	21	37	0	0	37	0	0
19	7288195	.	A	G	25	13	38	0	3	41	0	0
19	7290175	.	A	G	15	26	41	0	1	42	0	0
19	7290214	.	A	G	19	17	36	0	2	38	0	0
19	7291642	.	A	T	16	16	32	0	0	32	0	0
19	7292621	.	G	A	3	4	7	0	0	7	0	0
19	7293138	.	A	G	4	2	6	0	1	7	0	0
19	7295279	.	G	A	7	5	12	0	0	12	0	0
19	7295572	.	G	C	1	4	5	0	0	5	0	0
19	7309154	.	G	A	11	18	29	0	1	30	0	0
19	7309391	.	C	A	24	19	43	0	1	44	0	0
19	7309522	.	G	C	17	21	38	0	3	41	0	0
19	7309556	.	T	A	23	12	35	0	1	36	0	0
19	7309557	.	T	A	23	11	34	0	1	35	0	0
19	7309754	.	T	G	7	18	25	0	1	27	1	0
19	7309929	.	A	T	15	10	25	0	0	26	1	0
19	7309968	.	G	T	14	11	25	0	1	26	0	0
19	7310117	.	T	C	9	0	9	0	23	32	0	0
19	7310131	.	C	T	7	19	26	0	1	27	0	0
19	7310154	.	A	T	10	10	20	0	2	22	0	0
19	7310974	.	T	G	16	15	31	0	0	31	0	0
19	7311678	.	T	G	17	8	25	0	1	26	0	0
19	7313933	.	C	G	21	21	42	1	1	44	0	0
19	7327462	.	A	G	12	10	22	0	1	23	0	0
19	7327519	.	C	T	9	18	27	0	1	28	0	0
19	7327564	.	G	T	9	17	26	0	1	27	0	0
19	7327570	.	T	C	5	16	21	0	3	24	0	0
19	7337862	.	C	A	9	6	15	0	0	15	0	0
19	7338033	.	C	T	5	14	19	0	15	34	0	0
19	7338125	.	C	T	10	6	16	0	0	16	0	0
19	7338150	.	G	A	7	4	11	0	0	11	0	0
19	7338218	.	A	T	7	5	12	0	0	12	0	0
19	7338309	.	C	T	1	6	7	0	11	18	0	0
19	7338402	.	C	T	1	11	12	0	9	21	0	0
19	7338425	.	T	C	6	8	14	0	1	15	0	0
19	7338444	.	T	C	12	0	12	0	5	17	0	0
19	7338969	.	C	T	6	9	15	0	0	15	0	0
19	7338978	.	T	C	6	0	6	0	8	14	0	0
19	7339008	.	T	G	6	5	11	0	1	12	0	0
19	7341300	.	G	A	7	7	14	0	0	14	0	0
19	7341385	.	A	G	6	7	13	0	0	13	0	0
19	7358131	.	A	G	10	10	20	1	1	22	0	0
19	7406810	.	G	T	3	3	6	0	0	6	0	0
19	7408360	.	T	G	5	12	17	0	0	17	0	0
19	7409961	.	A	G	5	6	11	0	0	11	0	0
19	7411975	.	T	C	4	7	11	0	0	11	0	0
19	7412062	.	T	C	8	6	14	0	0	14	0	0
19	7412320	.	C	T	7	8	15	0	2	17	0	0
19	7412358	.	A	T	6	9	15	0	3	18	0	0
19	7424794	.	G	A	9	2	11	0	1	12	0	0
19	7426637	.	C	T	5	3	8	0	0	8	0	0
19	7426814	.	C	T	5	5	10	0	0	10	0	0
19	7426832	.	G	A	5	6	11	0	0	11	0	0
19	7426967	.	T	C	11	8	19	0	0	19	0	0
19	7427099	.	C	A	12	16	28	0	0	28	0	0
19	7430160	.	T	C	10	9	19	0	0	19	0	0
19	7430607	.	G	A	3	12	15	0	12	27	0	0
19	7430652	.	C	T	11	9	20	0	1	21	0	0
19	7430700	.	A	G	7	1	8	0	7	15	0	0
19	7430715	.	C	A	10	4	14	0	0	14	0	0
19	7432753	.	T	C	2	2	4	0	0	4	0	0
19	7432806	.	A	C	5	7	12	0	0	12	0	0
19	7433149	.	A	T	2	3	5	0	0	5	0	0
19	7433454	.	G	A	3	3	6	0	0	6	0	0
19	7433598	.	C	T	2	2	4	0	0	4	0	0
19	7433601	.	T	C	2	3	5	0	0	5	0	0
19	7433637	.	C	A	2	4	6	0	2	8	0	0
19	7433746	.	A	C	3	4	7	0	0	7	0	0
19	7434082	.	A	G	3	3	6	0	0	6	0	0
19	7434139	.	T	C	5	3	8	0	0	8	0	0
19	7434161	.	G	T	3	4	7	0	1	8	0	0
19	7434555	.	C	T	2	4	6	0	0	6	0	0
19	7434611	.	G	C	6	4	10	0	1	11	0	0
19	7434813	.	G	A	1	1	2	0	2	4	0	0
19	7434866	.	C	T	3	5	8	0	1	9	0	0
19	7434881	.	C	T	1	4	5	0	3	8	0	0
19	7435078	.	A	G	4	3	7	0	0	7	0	0
19	7435083	.	A	C	5	3	8	0	0	8	0	0
19	7435605	.	T	C	5	5	10	0	0	10	0	0
19	7439799	.	C	T	3	2	5	0	0	5	0	0
19	7441832	.	T	A	3	2	5	0	0	5	0	0
19	7445676	.	G	A	7	6	13	2	1	16	0	0
19	7445897	.	C	T	33	32	65	0	0	65	0	0
19	7446050	.	T	C	34	18	52	0	4	56	0	0
19	7446137	.	G	T	19	31	50	0	4	55	1	0
19	7446286	.	G	T	33	26	59	0	2	61	0	0
19	7446495	.	G	T	38	24	62	0	4	66	0	0
19	7446621	.	C	A	35	30	65	0	0	65	0	0
19	7446702	.	T	C	37	23	60	0	3	63	0	0
19	7450572	.	G	A	36	30	66	0	2	68	0	0
19	7450658	.	T	C	15	9	24	0	0	24	0	0
19	7450750	.	A	G	9	7	16	0	1	17	0	0
19	7450783	.	C	T	0	5	5	0	7	12	0	0
19	7456364	.	T	C	2	7	9	0	0	9	0	0
19	7456371	.	A	C	3	6	9	0	0	9	0	0
19	7456722	.	C	G	2	7	9	0	0	9	0	0
19	7456793	.	A	G	4	9	13	0	2	15	0	0
19	7456816	.	C	G	7	7	14	0	0	14	0	0
19	7468556	.	G	T	2	11	13	0	1	14	0	0
19	7468580	.	C	T	4	12	16	0	1	17	0	0
19	7468746	.	T	A	5	7	12	0	0	12	0	0
19	7474242	.	T	C	5	9	14	0	0	14	0	0
19	7474245	.	T	G	6	2	8	0	9	17	0	0
19	7478159	.	A	G	17	12	29	0	0	29	0	0
19	7478283	.	C	T	5	9	14	0	0	14	0	0
19	7478356	.	G	A	6	11	17	0	0	17	0	0
19	7482931	.	C	T	7	5	12	0	0	12	0	0
19	7482993	.	G	A	6	3	9	0	0	9	0	0
19	7483469	.	T	G	2	5	7	0	1	9	1	0
19	7483667	.	G	A	4	2	6	0	1	7	0	0
19	7484313	.	T	A	4	3	7	0	0	7	0	0
19	7484354	.	A	T	3	3	6	0	0	6	0	0
19	7484357	.	G	A	3	3	6	0	0	6	0	0
19	7484536	.	G	T	5	2	7	0	1	8	0	0
19	7484668	.	A	T	3	3	6	0	1	7	0	0
19	7484834	.	A	G	1	4	5	0	0	5	0	0
19	7485117	.	C	T	2	4	6	0	0	6	0	0
19	7485339	.	A	C	4	2	6	0	0	6	0	0
19	7485343	.	T	A	4	2	6	0	0	6	0	0
19	7485528	.	T	C	1	0	1	0	2	3	0	0
19	7485839	.	G	T	1	5	6	0	2	8	0	0
19	7485890	.	G	A	3	4	7	0	0	7	0	0
19	7486022	.	T	C	2	3	5	0	0	5	0	0
19	7486087	.	G	A	1	3	4	0	1	5	0	0
19	7486314	.	A	T	2	3	5	0	0	5	0	0
19	7486791	.	T	C	5	4	9	0	0	9	0	0
19	7487321	.	C	T	8	5	13	0	0	13	0	0
19	7487592	.	T	A	2	3	5	0	0	5	0	0
19	7490873	.	T	A	2	2	4	0	0	4	0	0
19	7495867	.	A	T	14	13	27	0	2	29	0	0
19	7498046	.	T	C	9	13	22	0	1	23	0	0
19	7498079	.	A	G	9	17	26	0	2	28	0	0
19	7498103	.	A	G	8	17	25	0	0	25	0	0
19	7505591	.	A	G	17	11	28	0	1	29	0	0
19	7505907	.	A	G	13	0	13	0	15	28	0	0
19	7506036	.	A	G	9	1	10	0	4	14	0	0
19	7507833	.	A	T	10	9	19	0	0	19	0	0
19	7510223	.	T	C	10	12	22	0	0	22	0	0
19	7510348	.	T	C	14	3	17	0	3	20	0	0
19	7510501	.	G	A	1	8	9	0	9	18	0	0
19	7510567	.	C	T	15	12	27	0	0	27	0	0
19	7512406	.	C	G	16	17	33	0	1	34	0	0
19	7513085	.	C	T	15	10	25	0	0	25	0	0
19	7513291	.	A	C	10	9	19	0	0	19	0	0
19	7513406	.	A	T	9	9	18	0	0	18	0	0
19	7513631	.	A	G	6	9	15	0	0	15	0	0
19	7513651	.	A	G	4	5	9	0	0	9	0	0
19	7514025	.	T	C	10	4	14	0	0	14	0	0
19	7514512	.	T	C	6	8	14	0	0	14	0	0
19	7514538	.	C	G	5	3	8	0	0	8	0	0
19	7514697	.	A	G	8	0	8	0	3	11	0	0
19	7514917	.	A	G	6	3	9	1	1	11	0	0
19	7515336	.	A	T	13	9	22	0	0	22	0	0
19	7515356	.	G	A	12	12	24	0	0	24	0	0
19	7515423	.	A	G	10	6	16	0	0	16	0	0
19	7515787	.	A	T	10	10	20	0	2	22	0	0
19	7515829	.	C	T	9	15	24	0	1	25	0	0
19	7515845	.	A	T	7	13	20	0	4	24	0	0
19	7516035	.	A	G	10	8	18	0	2	20	0	0
19	7516063	.	A	C	13	10	23	0	1	24	0	0
19	7516169	.	C	A	14	6	20	0	1	21	0	0
19	7516183	.	T	G	11	7	18	0	1	19	0	0
19	7516229	.	A	G	3	2	5	0	1	6	0	0
19	7516231	.	T	A	4	2	6	0	0	6	0	0
19	7525337	.	C	A	4	5	9	0	0	9	0	0
19	7552736	.	C	A	7	8	15	0	1	16	0	0
19	7552737	.	G	T	2	8	10	0	7	17	0	0
19	7552887	.	A	G	8	12	20	0	3	23	0	0
19	7553368	.	T	C	5	10	15	0	4	19	0	0
19	7557538	.	T	C	16	14	30	0	0	30	0	0
19	7557735	.	T	C	15	12	27	0	0	27	0	0
19	7557793	.	G	C	12	17	29	0	0	29	0	0
19	7563894	.	A	T	12	18	30	0	1	31	0	0
19	7564073	.	A	G	15	16	31	0	1	32	0	0
19	7564176	.	C	T	11	25	36	0	1	37	0	0
19	7565462	.	T	A	22	17	39	0	1	40	0	0
19	7565463	.	T	C	21	17	38	0	2	40	0	0
19	7566488	.	A	T	10	4	14	0	1	15	0	0
19	7566770	.	A	G	11	18	29	0	2	31	0	0
19	7567011	.	T	C	20	18	38	0	2	40	0	0
19	7567021	.	T	A	20	20	40	0	1	41	0	0
19	7567196	.	A	C	3	2	5	0	0	5	0	0
19	7630359	.	T	A	3	2	5	0	0	5	0	0
19	7630435	.	A	G	4	2	6	0	2	8	0	0
19	7630458	.	C	A	3	3	6	0	2	8	0	0
19	7630689	.	A	T	7	4	11	0	0	11	0	0
19	7630785	.	C	T	1	2	3	0	0	3	0	0
19	7631386	.	C	T	11	16	27	0	3	30	0	0
19	7631700	.	G	A	2	8	10	0	11	21	0	0
19	7631860	.	T	C	11	14	25	0	0	25	0	0
19	7631968	.	T	C	9	7	16	0	0	16	0	0
19	7632056	.	C	T	8	4	12	0	0	12	0	0
19	7632470	.	C	T	4	6	10	0	0	10	0	0
19	7632526	.	T	C	6	11	17	0	0	17	0	0
19	7632837	.	C	T	9	10	19	0	1	20	0	0
19	7678900	.	A	G	2	3	5	0	1	6	0	0
19	7679616	.	T	C	2	3	5	0	0	5	0	0
19	7679640	.	T	G	2	0	2	0	2	4	0	0
19	7761855	.	C	T	5	5	10	0	0	10	0	0
19	7771431	.	G	A	1	6	7	0	6	13	0	0
19	7775789	.	G	A	0	4	4	0	7	11	0	0
19	7782743	.	G	T	1	17	18	0	19	37	0	0
19	7784681	.	T	A	16	6	22	0	12	34	0	0
19	7784684	.	T	A	16	12	28	0	7	35	0	0
19	7785138	.	C	T	17	21	38	0	3	41	0	0
19	7794830	.	G	C	3	22	25	0	17	42	0	0
19	7794872	.	A	G	21	3	24	0	25	49	0	0
19	7794893	.	A	T	21	26	47	0	5	52	0	0
19	7796746	.	C	T	2	13	15	0	2	17	0	0
19	7796888	.	G	A	23	13	36	0	3	39	0	0
19	7796951	.	T	C	15	19	34	0	3	37	0	0
19	7797534	.	C	T	15	18	33	0	3	36	0	0
19	7797805	.	G	A	0	5	5	0	3	8	0	0
19	7799137	.	T	C	6	10	16	0	0	16	0	0
19	7802622	.	G	A	12	8	20	0	0	20	0	0
19	7802700	.	G	A	3	9	12	0	0	12	0	0
19	7802704	.	T	C	3	8	11	0	0	11	0	0
19	7802873	.	G	A	13	9	22	0	1	23	0	0
19	7803459	.	C	T	10	8	18	0	0	18	0	0
19	7803480	.	G	A	0	15	15	0	7	22	0	0
19	7803730	.	G	A	9	13	22	0	2	24	0	0
19	7803745	.	T	A	9	18	27	0	0	27	0	0
19	7804785	.	A	C	9	22	31	0	0	31	0	0
19	7804841	.	G	A	8	15	23	0	1	24	0	0
19	7804843	.	G	A	8	15	23	0	1	24	0	0
19	7804892	.	C	T	5	13	18	0	1	19	0	0
19	7819991	.	G	A	7	10	17	0	1	18	0	0
19	7820018	.	C	G	9	9	18	0	0	18	0	0
19	7820031	.	T	A	9	7	16	0	3	19	0	0
19	7820665	.	T	A	13	10	23	0	1	24	0	0
19	7820767	.	C	T	1	11	12	0	11	23	0	0
19	7820980	.	C	T	13	10	23	0	0	23	0	0
19	7820992	.	C	A	2	14	16	0	7	23	0	0
19	7821055	.	C	T	7	9	16	0	0	16	0	0
19	7823330	.	C	T	5	8	13	0	0	13	0	0
19	7825025	.	T	G	10	7	17	0	0	17	0	0
19	7825163	.	C	T	3	6	9	0	1	10	0	0
19	7827031	.	T	G	8	13	21	0	0	21	0	0
19	7828576	.	G	A	6	3	9	0	0	9	0	0
19	7829080	.	G	A	2	3	5	0	0	5	0	0
19	7829094	.	T	G	2	3	5	0	0	5	0	0
19	7829506	.	A	T	1	2	3	0	0	3	0	0
19	7830253	.	A	G	3	2	5	0	0	5	0	0
19	7830261	.	G	A	3	1	4	0	0	4	0	0
19	7835708	.	C	T	4	4	8	0	1	9	0	0
19	7837889	.	A	C	0	3	3	0	1	4	0	0
19	7967063	.	C	T	2	2	4	2	0	6	0	0
19	7967067	.	T	C	2	1	3	2	1	6	0	0
19	8315478	.	C	T	4	3	7	0	0	7	0	0
19	8336054	.	A	G	7	0	7	0	8	15	0	0
19	8336208	.	C	T	8	4	12	0	0	12	0	0
19	8336335	.	C	A	6	4	10	0	0	10	0	0
19	8336640	.	G	C	8	15	23	0	1	24	0	0
19	8337120	.	T	A	3	2	5	0	0	5	0	0
19	8338487	.	G	A	4	2	6	0	0	6	0	0
19	8338559	.	A	G	6	6	12	0	0	12	0	0
19	8339302	.	A	G	16	16	32	0	0	32	0	0
19	8481850	.	G	T	1	3	4	0	0	4	0	0
19	8481852	.	A	G	1	3	4	0	0	4	0	0
19	8496701	.	C	T	4	5	9	0	0	9	0	0
19	8496737	.	T	A	6	2	8	0	0	8	0	0
19	8496758	.	T	C	4	5	9	0	0	9	0	0
19	8497743	.	C	A	5	6	11	0	1	12	0	0
19	8497744	.	A	C	5	7	12	0	0	12	0	0
19	8500688	.	T	C	9	6	15	0	1	16	0	0
19	8500928	.	A	T	4	3	7	0	0	7	0	0
19	8500960	.	A	T	5	6	11	0	0	11	0	0
19	8501019	.	G	A	2	6	8	0	4	12	0	0
19	8501499	.	T	C	9	7	16	0	3	19	0	0
19	8501540	.	C	A	13	16	29	0	2	31	0	0
19	8501873	.	G	A	11	12	23	0	1	24	0	0
19	8501901	.	A	T	11	13	24	0	1	25	0	0
19	8534334	.	G	A	7	10	17	0	2	19	0	0
19	8534426	.	G	A	14	11	25	0	1	26	0	0
19	8534428	.	A	G	16	11	27	0	0	27	0	0
19	8534859	.	A	C	9	6	15	0	3	18	0	0
19	8534878	.	A	G	8	6	14	0	0	14	0	0
19	8534996	.	A	G	10	4	14	0	1	15	0	0
19	8535005	.	T	G	9	5	14	0	0	14	0	0
19	8582809	.	A	G	10	5	15	0	1	16	0	0
19	8583131	.	G	A	5	8	13	0	1	14	0	0
19	8583170	.	G	T	4	10	14	0	0	14	0	0
19	8583354	.	A	T	3	11	14	0	2	16	0	0
19	8584219	.	T	A	4	8	12	0	0	12	0	0
19	8589693	.	C	T	2	6	8	0	0	8	0	0
19	8589714	.	C	T	2	2	4	0	0	4	0	0
19	8592419	.	A	G	6	6	12	0	0	12	0	0
19	8598667	.	A	G	3	7	10	0	0	10	0	0
19	8599547	.	A	G	3	2	5	0	2	7	0	0
19	8604154	.	A	G	4	4	8	0	0	8	0	0
19	8612981	.	G	C	1	10	11	0	8	19	0	0
19	8613146	.	A	G	4	3	7	0	0	7	0	0
19	8628830	.	G	T	0	4	4	0	7	11	0	0
19	8641403	.	A	G	6	0	6	0	6	12	0	0
19	8647747	.	T	A	8	12	20	0	0	20	0	0
19	8647865	.	C	T	10	3	13	0	1	14	0	0
19	8647869	.	T	A	11	2	13	0	0	13	0	0
19	8680667	.	C	T	0	2	2	0	3	5	0	0
19	8681281	.	C	G	4	2	6	0	0	6	0	0
19	8681317	.	A	T	3	2	5	0	0	5	0	0
19	8689918	.	A	G	0	2	2	0	1	3	0	0
19	8775362	.	A	T	6	3	9	0	0	9	0	0
19	8817480	.	A	G	24	15	39	1	5	45	0	0
19	8822347	.	A	G	27	16	43	0	0	43	0	0
19	8824364	.	A	G	15	18	33	0	1	34	0	0
19	8831895	.	T	C	15	0	15	0	19	34	0	0
19	8834529	.	A	G	18	21	39	1	1	41	0	0
19	8834583	.	T	C	19	14	33	0	2	35	0	0
19	8894229	.	T	C	3	8	11	0	0	11	0	0
19	8894905	.	G	T	3	7	10	0	0	10	0	0
19	8895074	.	G	A	10	14	24	0	0	24	0	0
19	8895163	.	T	C	15	8	23	0	2	25	0	0
19	8895546	.	C	T	3	5	8	0	0	8	0	0
19	8895630	.	C	T	4	2	6	0	2	8	0	0
19	8897649	.	A	T	4	4	8	0	1	9	0	0
19	8900991	.	T	G	3	2	5	0	0	5	0	0
19	8901446	.	T	G	2	3	5	0	0	5	0	0
19	8929035	.	T	C	4	5	9	0	0	9	0	0
19	8929057	.	G	A	5	5	10	0	0	10	0	0
19	8929488	.	C	T	3	19	22	0	5	27	0	0
19	8929549	.	T	C	9	0	9	0	14	23	0	0
19	8929669	.	A	G	8	12	20	0	1	21	0	0
19	8929678	.	A	G	5	11	16	0	3	19	0	0
19	8929708	.	A	T	7	8	15	0	1	16	0	0
19	8929743	.	T	A	6	12	18	0	3	21	0	0
19	8929839	.	G	A	7	9	16	1	0	17	0	0
19	8929860	.	T	C	5	10	15	0	0	15	0	0
19	8930187	.	A	G	14	11	25	0	0	25	0	0
19	8932643	.	T	C	10	0	10	0	5	15	0	0
19	8937285	.	G	A	3	5	8	0	1	9	0	0
19	8937377	.	T	C	3	7	10	0	0	10	0	0
19	8937485	.	A	G	7	7	14	0	1	15	0	0
19	8939917	.	C	T	4	13	17	0	0	17	0	0
19	8958797	.	C	T	4	6	10	0	0	10	0	0
19	8962840	.	A	C	7	0	7	0	7	14	0	0
19	8978684	.	C	T	1	2	3	0	0	3	0	0
19	8978695	.	C	T	1	2	3	0	0	3	0	0
19	8978964	.	G	A	1	2	3	0	0	3	0	0
19	8979038	.	T	C	4	2	6	0	0	6	0	0
19	8979171	.	G	C	2	2	4	0	0	4	0	0
19	8979221	.	T	G	2	5	7	0	0	7	0	0
19	8979519	.	T	C	4	2	6	0	0	6	0	0
19	8979539	.	T	G	1	0	1	0	5	6	0	0
19	8979575	.	A	T	1	3	4	0	0	4	0	0
19	8979581	.	G	A	0	3	3	0	1	4	0	0
19	8979659	.	A	G	1	3	4	0	0	4	0	0
19	8985221	.	G	A	3	2	5	0	0	5	0	0
19	8985408	.	C	T	1	2	3	0	0	3	0	0
19	8985564	.	G	A	1	5	6	0	13	19	0	0
19	8989992	.	G	A	1	9	10	0	8	18	0	0
19	8997627	.	T	C	4	7	11	0	3	14	0	0
19	8997629	.	G	A	4	10	14	0	0	14	0	0
19	8997903	.	C	T	16	14	30	0	0	30	0	0
19	9000718	.	G	A	2	25	27	0	18	45	0	0
19	9000838	.	C	T	22	14	36	0	3	39	0	0
19	9000868	.	C	G	18	0	18	0	17	35	0	0
19	9001058	.	C	T	11	21	32	0	1	33	0	0
19	9001151	.	C	T	16	17	33	0	1	34	0	0
19	9001180	.	A	G	21	13	34	0	1	35	0	0
19	9001315	.	C	T	15	11	26	0	1	27	0	0
19	9009026	.	C	T	1	2	3	0	0	3	0	0
19	9043096	.	T	C	4	4	8	0	1	9	0	0
19	9044331	.	C	T	2	6	8	0	0	8	0	0
19	9044727	.	G	A	4	5	9	0	0	9	0	0
19	9044799	.	T	A	4	4	8	0	0	8	0	0
19	9045282	.	G	A	2	2	4	0	0	4	0	0
19	9045443	.	C	G	5	3	8	0	0	8	0	0
19	9046119	.	G	C	4	7	11	0	0	11	0	0
19	9046230	.	T	G	4	3	7	0	1	8	0	0
19	9046383	.	T	A	3	2	5	0	3	8	0	0
19	9046542	.	A	C	3	6	9	0	0	9	0	0
19	9046551	.	T	C	3	7	10	0	0	10	0	0
19	9047004	.	G	A	0	5	5	0	6	11	0	0
19	9047283	.	A	G	7	4	11	0	0	11	0	0
19	9047806	.	T	A	6	5	11	0	4	15	0	0
19	9048066	.	A	G	6	2	8	0	2	10	0	0
19	9048345	.	C	T	6	3	9	0	0	9	0	0
19	9048614	.	C	T	15	7	22	0	1	23	0	0
19	9050305	.	G	A	14	9	23	0	3	26	0	0
19	9050319	.	C	T	12	12	24	0	1	25	0	0
19	9050609	.	C	G	15	7	22	0	0	22	0	0
19	9050631	.	T	C	13	6	19	0	2	21	0	0
19	9050823	.	A	G	6	3	9	0	2	11	0	0
19	9055793	.	C	T	11	9	20	0	2	22	0	0
19	9058454	.	T	C	9	14	23	0	0	23	0	0
19	9077465	.	C	T	11	15	26	0	0	26	0	0
19	9078840	.	A	T	23	16	39	0	2	41	0	0
19	9079084	.	T	C	24	14	38	0	1	39	0	0
19	9081228	.	T	C	22	10	32	0	2	34	0	0
19	9081272	.	C	T	17	12	29	1	2	32	0	0
19	9084604	.	G	A	16	18	34	0	3	37	0	0
19	9084688	.	T	C	14	15	29	0	3	32	0	0
19	9084797	.	A	G	20	16	36	0	0	36	0	0
19	9084859	.	G	T	27	18	45	0	2	47	0	0
19	9084880	.	T	C	20	22	42	0	2	44	0	0
19	9085359	.	A	T	25	2	27	0	1	28	0	0
19	9085423	.	G	A	12	17	29	0	4	33	0	0
19	9085730	.	A	G	9	0	9	0	2	14	3	0
19	9085757	.	A	C	15	16	31	0	1	32	0	0
19	9085835	.	A	G	13	14	27	0	1	28	0	0
19	9086084	.	T	A	17	19	36	0	0	36	0	0
19	9116708	.	T	C	1	3	4	0	0	4	0	0
19	9117167	.	T	G	1	2	3	0	0	3	0	0
19	9117402	.	G	A	3	3	6	0	0	6	0	0
19	9117731	.	G	T	3	3	6	0	1	7	0	0
19	9117769	.	A	G	4	2	6	0	1	7	0	0
19	9117777	.	T	A	5	2	7	0	0	7	0	0
19	9118044	.	G	A	0	3	3	0	5	8	0	0
19	9118081	.	A	G	2	0	2	0	2	4	0	0
19	9130205	.	T	A	5	3	8	0	0	8	0	0
19	9130441	.	G	A	3	7	10	0	1	11	0	0
19	9134017	.	G	A	0	7	7	0	8	15	0	0
19	9134125	.	G	A	0	6	6	0	4	10	0	0
19	9134140	.	T	C	4	8	12	0	1	13	0	0
19	9135053	.	C	T	7	7	14	0	1	15	0	0
19	9135065	.	A	G	6	0	6	0	9	15	0	0
19	9138695	.	A	G	8	0	8	0	7	15	0	0
19	9140507	.	A	G	14	11	25	0	1	26	0	0
19	9140618	.	C	T	15	14	29	0	1	30	0	0
19	9140750	.	T	C	14	10	24	0	3	27	0	0
19	9140950	.	T	C	8	14	22	0	0	22	0	0
19	9144228	.	T	G	9	3	12	0	0	12	0	0
19	9144234	.	C	T	8	4	12	0	0	12	0	0
19	9152720	.	C	A	26	18	44	0	1	45	0	0
19	9152841	.	A	T	16	21	37	0	3	40	0	0
19	9155603	.	A	G	18	2	20	0	12	32	0	0
19	9158481	.	A	T	17	10	27	0	1	28	0	0
19	9161595	.	G	A	20	20	40	0	2	42	0	0
19	9161830	.	C	T	16	17	33	0	0	33	0	0
19	9166374	.	G	A	30	15	45	1	3	49	0	0
19	9168513	.	C	T	20	21	41	0	2	43	0	0
19	9168608	.	C	A	32	7	39	0	3	42	0	0
19	9168622	.	C	T	22	14	36	0	2	38	0	0
19	9168699	.	T	C	29	13	42	0	2	44	0	0
19	9168947	.	G	T	0	13	13	0	22	35	0	0
19	9169099	.	G	A	16	14	30	0	1	31	0	0
19	9220813	.	C	T	15	23	38	1	0	39	0	0
19	9220828	.	C	T	19	19	38	1	0	39	0	0
19	9220939	.	T	C	14	14	28	0	1	29	0	0
19	9223369	.	T	C	34	21	55	0	0	55	0	0
19	9225567	.	C	T	25	25	50	0	3	53	0	0
19	9225585	.	G	A	24	27	51	0	2	53	0	0
19	9228196	.	T	G	19	17	36	0	0	36	0	0
19	9228326	.	A	T	19	21	40	0	0	40	0	0
19	9228462	.	G	A	0	5	5	0	11	16	0	0
19	9241173	.	T	C	1	2	3	0	0	3	0	0
19	9241568	.	G	A	2	3	5	0	0	5	0	0
19	9247042	.	A	G	1	2	3	0	0	3	0	0
19	9255657	.	T	G	3	3	6	0	0	6	0	0
19	9255906	.	C	T	5	2	7	0	1	8	0	0
19	9255915	.	C	A	5	3	8	0	0	8	0	0
19	9257885	.	A	G	3	2	5	0	0	5	0	0
19	9262543	.	T	G	3	0	3	0	2	5	0	0
19	9262982	.	A	T	4	4	8	0	0	8	0	0
19	9263201	.	T	A	3	3	6	0	1	7	0	0
19	9263219	.	A	C	4	2	6	0	0	6	0	0
19	9265048	.	T	C	10	3	13	0	1	14	0	0
19	9265297	.	G	A	3	2	5	0	0	5	0	0
19	9265774	.	A	G	2	3	5	1	0	6	0	0
19	9266076	.	A	G	1	3	4	0	1	5	0	0
19	9266162	.	G	A	3	4	7	0	1	8	0	0
19	9266749	.	T	C	3	5	8	0	0	8	0	0
19	9266963	.	C	T	2	3	5	0	0	5	0	0
19	9268433	.	C	T	5	2	7	0	0	7	0	0
19	9268619	.	C	A	4	6	10	0	0	10	0	0
19	9270836	.	T	C	3	7	10	0	0	10	0	0
19	9273768	.	T	A	8	8	16	0	2	18	0	0
19	9273997	.	A	G	6	0	6	0	4	10	0	0
19	9274070	.	G	A	3	12	15	0	3	18	0	0
19	9274095	.	G	T	5	11	16	0	0	16	0	0
19	9274248	.	T	A	4	7	11	0	1	12	0	0
19	9274428	.	T	A	9	8	17	0	0	17	0	0
19	9274497	.	G	A	13	6	19	0	1	20	0	0
19	9274500	.	T	C	14	6	20	0	1	21	0	0
19	9274891	.	G	T	10	5	15	0	0	15	0	0
19	9458166	.	A	G	20	0	20	0	25	45	0	0
19	9458181	.	A	C	21	19	40	0	3	43	0	0
19	9458304	.	G	A	13	11	24	0	1	25	0	0
19	9458328	.	T	C	10	13	23	0	1	24	0	0
19	9458421	.	G	A	16	8	24	0	7	31	0	0
19	9458463	.	C	T	15	20	35	0	0	35	0	0
19	9459325	.	T	A	24	17	41	0	1	42	0	0
19	9459330	.	C	T	22	12	34	0	0	34	0	0
19	9459378	.	A	G	23	2	25	0	28	53	0	0
19	9459597	.	G	A	3	18	21	0	23	44	0	0
19	9459673	.	G	A	4	19	23	0	22	45	0	0
19	9459820	.	T	C	15	20	35	0	0	35	0	0
19	9460128	.	A	C	16	12	28	0	1	29	0	0
19	9460196	.	A	G	22	15	37	0	0	37	0	0
19	9460499	.	A	G	15	25	40	0	1	41	0	0
19	9460531	.	G	T	20	28	48	0	4	53	1	0
19	9461072	.	A	G	39	18	57	0	2	59	0	0
19	9461376	.	A	G	23	28	51	0	5	56	0	0
19	9461841	.	A	G	39	32	71	0	3	74	0	0
19	9462810	.	T	A	35	33	68	0	11	79	0	0
19	9471066	.	G	A	46	23	69	0	1	70	0	0
19	9472368	.	T	A	5	8	13	0	0	13	0	0
19	9472405	.	A	G	4	3	7	1	0	8	0	0
19	9472865	.	G	A	23	20	43	0	1	44	0	0
19	9481781	.	T	G	4	3	7	0	0	7	0	0
19	9482126	.	C	T	2	4	6	0	8	14	0	0
19	9482127	.	G	T	8	5	13	0	1	14	0	0
19	9482261	.	A	G	7	11	18	0	0	18	0	0
19	9485543	.	A	G	6	8	14	0	0	14	0	0
19	9502456	.	A	C	3	10	13	0	1	14	0	0
19	9502640	.	T	C	9	9	18	0	2	20	0	0
19	9502656	.	A	G	7	7	14	0	3	17	0	0
19	9502968	.	C	T	6	2	8	0	2	10	0	0
19	9503356	.	T	G	3	6	9	0	0	9	0	0
19	9513443	.	T	C	5	5	10	0	0	10	0	0
19	9513863	.	A	C	7	11	18	0	1	19	0	0
19	9513869	.	A	C	6	12	18	0	0	18	0	0
19	9516869	.	A	G	7	9	16	0	2	18	0	0
19	9519284	.	G	A	9	6	15	0	0	15	0	0
19	9533299	.	C	G	4	4	8	0	0	8	0	0
19	9585421	.	C	T	3	5	8	0	0	8	0	0
19	9585436	.	G	A	2	3	5	0	0	5	0	0
19	9598053	.	C	T	8	3	11	0	0	11	0	0
19	9598080	.	A	G	3	4	7	0	1	8	0	0
19	9598119	.	C	A	4	6	10	0	1	11	0	0
19	9603062	.	C	T	5	7	12	0	2	14	0	0
19	9603160	.	G	A	0	7	7	0	14	21	0	0
19	9603425	.	C	T	16	15	31	0	1	32	0	0
19	9603432	.	T	A	17	13	30	0	2	32	0	0
19	9603975	.	G	T	3	5	8	0	1	9	0	0
19	9604050	.	T	A	3	1	4	0	1	5	0	0
19	9604073	.	T	A	1	3	4	0	0	4	0	0
19	9604100	.	A	G	3	2	5	0	0	5	0	0
19	9604114	.	A	G	1	5	6	0	0	6	0	0
19	9685506	.	A	G	20	12	32	0	1	33	0	0
19	9685695	.	A	G	30	17	47	0	2	49	0	0
19	9686123	.	G	T	14	10	24	0	1	25	0	0
19	9686128	.	A	G	15	12	27	0	2	29	0	0
19	9686160	.	T	C	17	12	29	0	1	30	0	0
19	9686163	.	C	A	17	11	28	0	2	30	0	0
19	9686421	.	G	T	16	14	30	0	2	32	0	0
19	9686515	.	T	A	19	10	29	1	1	31	0	0
19	9686519	.	G	A	16	9	25	1	3	29	0	0
19	9686615	.	T	C	11	21	32	0	1	33	0	0
19	9686627	.	T	C	10	20	30	0	2	32	0	0
19	9686678	.	T	A	14	15	29	0	0	29	0	0
19	9686806	.	T	C	8	5	13	1	0	14	0	0
19	9686807	.	C	T	9	5	14	1	0	15	0	0
19	9686902	.	T	A	2	4	6	0	2	8	0	0
19	9686905	.	T	C	2	0	2	0	6	8	0	0
19	9687001	.	T	G	7	8	15	0	0	15	0	0
19	9687146	.	T	C	22	20	42	0	2	44	0	0
19	9687206	.	T	A	19	17	36	0	2	38	0	0
19	9687306	.	G	A	19	16	35	0	2	37	0	0
19	9691780	.	A	G	10	12	22	0	2	24	0	0
19	9711421	.	T	C	4	3	7	0	0	7	0	0
19	9711444	.	G	A	2	5	7	0	0	7	0	0
19	9712337	.	G	A	6	5	11	0	0	11	0	0
19	9712357	.	T	A	10	4	14	0	0	14	0	0
19	9712444	.	G	A	7	6	13	0	1	14	0	0
19	9813608	.	G	A	20	24	44	0	3	47	0	0
19	9813781	.	C	A	0	7	7	0	11	18	0	0
19	9814291	.	C	T	6	23	29	0	25	54	0	0
19	9814336	.	T	C	33	19	52	0	1	53	0	0
19	9814423	.	A	G	21	21	42	0	2	44	0	0
19	9814444	.	G	A	23	24	47	0	1	48	0	0
19	9814504	.	G	A	23	30	53	0	0	53	0	0
19	9814516	.	A	G	21	30	51	0	3	54	0	0
19	9814549	.	T	C	24	29	53	0	3	56	0	0
19	9814611	.	A	G	11	11	22	0	0	22	0	0
19	9814621	.	C	T	1	10	11	0	10	21	0	0
19	9822566	.	G	C	20	10	30	0	0	31	1	0
19	9841077	.	T	A	2	12	14	0	1	15	0	0
19	9841203	.	A	T	12	16	28	0	0	28	0	0
19	9841450	.	C	G	13	13	26	0	0	26	0	0
19	9841728	.	T	C	10	7	17	0	2	19	0	0
19	9841825	.	C	T	12	9	21	0	1	22	0	0
19	9841902	.	A	T	15	17	32	0	0	32	0	0
19	9842306	.	A	G	27	17	44	0	0	44	0	0
19	9859170	.	A	G	3	4	7	0	0	7	0	0
19	9866930	.	C	G	3	6	9	0	1	10	0	0
19	9866933	.	C	T	5	2	7	0	2	9	0	0
19	9911419	.	G	A	5	5	10	0	0	10	0	0
19	9911566	.	T	A	9	7	16	0	1	17	0	0
19	9911587	.	T	G	7	7	14	0	0	15	1	0
19	9911855	.	G	A	5	5	10	0	0	10	0	0
19	9911863	.	A	T	2	4	6	0	0	6	0	0
19	9911904	.	A	T	1	5	6	0	0	6	0	0
19	9912041	.	C	T	9	10	19	2	0	21	0	0
19	9912063	.	C	T	6	9	15	1	1	17	0	0
19	9912113	.	A	C	8	9	17	0	0	17	0	0
19	9912117	.	C	T	7	7	14	0	4	18	0	0
19	9912169	.	G	A	4	3	7	0	1	8	0	0
19	9912487	.	A	T	6	5	11	0	2	13	0	0
19	9912561	.	A	C	5	2	7	3	0	10	0	0
19	9912663	.	G	C	8	1	9	1	11	21	0	0
19	9912665	.	G	T	8	9	17	1	3	21	0	0
19	9912756	.	C	A	5	10	15	0	0	15	0	0
19	9912946	.	A	T	7	7	14	0	1	15	0	0
19	9912993	.	C	A	4	8	12	0	0	12	0	0
19	9912998	.	T	C	4	8	12	0	0	12	0	0
19	9914291	.	T	G	5	5	10	0	1	11	0	0
19	9914357	.	G	A	8	6	14	0	0	14	0	0
19	9914845	.	G	A	9	6	15	0	0	15	0	0
19	9916197	.	C	T	4	4	8	0	0	8	0	0
19	9916597	.	C	T	2	2	4	0	0	4	0	0
19	9916630	.	G	T	2	4	6	0	0	6	0	0
19	9916786	.	A	G	5	8	13	0	0	13	0	0
19	9916840	.	G	A	3	3	6	0	0	6	0	0
19	9916918	.	A	G	1	6	7	0	1	8	0	0
19	9917437	.	A	G	1	1	2	0	1	3	0	0
19	9917466	.	G	A	1	2	3	0	0	3	0	0
19	9919150	.	C	A	1	2	3	0	0	3	0	0
19	10177290	.	G	A	8	12	20	0	2	22	0	0
19	10177382	.	C	A	22	14	36	0	0	36	0	0
19	10177397	.	T	G	14	20	34	0	0	34	0	0
19	10178339	.	T	A	17	20	37	0	5	42	0	0
19	10180561	.	C	T	0	8	8	0	21	29	0	0
19	10195375	.	C	G	6	3	9	0	0	9	0	0
19	10195376	.	A	C	6	0	6	0	3	9	0	0
19	10195756	.	T	G	10	7	17	0	1	18	0	0
19	10196049	.	T	A	9	6	15	0	2	17	0	0
19	10196070	.	T	A	6	4	10	0	1	14	3	0
19	10196113	.	T	C	7	6	13	0	4	17	0	0
19	10202682	.	T	C	11	1	12	0	17	29	0	0
19	10202756	.	T	A	14	7	21	0	0	21	0	0
19	10203024	.	C	A	1	5	6	0	10	16	0	0
19	10203420	.	T	C	11	16	27	0	1	28	0	0
19	10203936	.	T	G	8	7	15	0	1	16	0	0
19	10204023	.	G	A	10	11	21	0	0	21	0	0
19	10204407	.	G	C	6	4	10	0	1	11	0	0
19	10204476	.	C	T	5	6	11	0	1	12	0	0
19	10205505	.	G	A	2	7	9	0	0	9	0	0
19	10217742	.	A	G	15	13	28	0	1	29	0	0
19	10217844	.	T	A	6	11	17	0	4	21	0	0
19	10219001	.	C	T	16	12	28	0	0	28	0	0
19	10219542	.	G	A	20	13	33	0	1	34	0	0
19	10219547	.	T	C	21	14	35	0	1	36	0	0
19	10219749	.	C	T	12	18	30	0	0	30	0	0
19	10220064	.	A	T	27	15	42	0	1	43	0	0
19	10220283	.	T	G	23	19	42	0	3	45	0	0
19	10220421	.	A	G	15	26	41	0	2	43	0	0
19	10220448	.	C	G	3	22	25	0	23	48	0	0
19	10220651	.	T	C	28	7	35	0	20	55	0	0
19	10220790	.	C	T	23	19	42	0	2	44	0	0
19	10235373	.	T	C	22	11	33	0	0	33	0	0
19	10235899	.	G	C	22	16	38	0	1	39	0	0
19	10236249	.	C	T	13	12	25	0	1	26	0	0
19	10236490	.	C	A	10	9	19	0	1	20	0	0
19	10236569	.	T	C	4	14	18	0	3	21	0	0
19	10236853	.	A	G	4	3	7	0	0	7	0	0
19	10237198	.	G	C	3	2	5	0	0	5	0	0
19	10237365	.	C	A	1	7	8	0	9	17	0	0
19	10237394	.	A	G	12	9	21	0	1	22	0	0
19	10237446	.	A	T	21	13	34	0	0	34	0	0
19	10237815	.	A	T	3	2	5	0	0	5	0	0
19	10237950	.	T	C	4	0	4	0	9	13	0	0
19	10238011	.	G	C	6	0	6	0	6	12	0	0
19	10238045	.	C	G	12	6	18	0	1	19	0	0
19	10238301	.	G	C	3	1	4	0	3	7	0	0
19	10238303	.	T	C	3	3	6	0	1	7	0	0
19	10238348	.	G	A	3	3	6	0	2	8	0	0
19	10238350	.	C	G	5	4	9	0	0	9	0	0
19	10238580	.	G	A	3	9	12	0	0	12	0	0
19	10252575	.	T	C	3	3	6	0	0	6	0	0
19	10252596	.	T	C	3	0	3	0	2	5	0	0
19	10252807	.	T	C	3	6	9	0	0	9	0	0
19	10252922	.	T	C	2	3	5	0	0	5	0	0
19	10252958	.	T	C	1	5	6	0	0	6	0	0
19	10252964	.	T	C	3	3	6	0	0	6	0	0
19	10252999	.	A	G	9	4	13	0	0	13	0	0
19	10253087	.	T	G	2	6	8	0	1	9	0	0
19	10253140	.	A	T	3	7	10	0	0	10	0	0
19	10253175	.	G	A	5	5	10	0	1	11	0	0
19	10253176	.	T	C	5	0	5	0	6	11	0	0
19	10253316	.	T	C	5	10	15	0	0	15	0	0
19	10253347	.	T	C	6	8	14	0	0	14	0	0
19	10253812	.	T	A	5	5	10	0	0	10	0	0
19	10254063	.	T	A	5	2	7	0	0	7	0	0
19	10254091	.	C	T	5	2	7	0	0	7	0	0
19	10254100	.	C	A	4	3	7	0	0	7	0	0
19	10254128	.	T	G	2	5	7	0	2	9	0	0
19	10254146	.	A	C	4	5	9	0	1	10	0	0
19	10254169	.	T	C	7	2	9	0	1	10	0	0
19	10254303	.	C	A	3	2	5	0	1	6	0	0
19	10254650	.	C	T	5	2	7	0	0	7	0	0
19	10254690	.	A	C	4	5	9	0	1	10	0	0
19	10255387	.	T	A	5	2	7	0	0	7	0	0
19	10255458	.	T	C	2	0	2	0	3	5	0	0
19	10255459	.	A	G	2	3	5	0	0	5	0	0
19	10255552	.	T	G	1	2	3	0	0	3	0	0
19	10255554	.	G	A	1	2	3	0	0	3	0	0
19	10255702	.	A	C	5	4	9	0	2	11	0	0
19	11271224	.	C	T	4	3	7	0	0	7	0	0
19	11275304	.	T	A	5	4	9	0	1	10	0	0
19	11275607	.	G	C	2	4	6	0	0	6	0	0
19	11314625	.	C	T	2	3	5	0	0	5	0	0
19	11314807	.	C	T	4	6	10	0	0	10	0	0
19	11314858	.	A	T	4	1	5	0	3	8	0	0
19	11331967	.	G	T	12	4	16	3	4	23	0	0
19	11332050	.	G	T	20	8	28	0	0	28	0	0
19	11332071	.	T	C	17	12	29	0	0	29	0	0
19	11332574	.	T	A	15	13	28	0	1	30	1	0
19	11332576	.	C	T	15	14	29	0	0	29	0	0
19	11332670	.	T	C	11	0	11	0	11	22	0	0
19	11344347	.	T	A	16	11	27	0	0	27	0	0
19	11347910	.	C	T	2	10	12	0	17	29	0	0
19	11356692	.	G	A	14	9	23	0	1	24	0	0
19	11429841	.	C	T	0	2	2	0	2	4	0	0
19	11508991	.	G	C	9	6	15	0	0	15	0	0
19	11509029	.	T	C	8	0	8	0	9	17	0	0
19	11545803	.	T	G	3	2	5	0	0	5	0	0
19	11546105	.	G	A	4	10	14	0	0	14	0	0
19	11546181	.	G	A	2	3	5	0	1	6	0	0
19	11632927	.	A	C	4	4	8	0	0	8	0	0
19	11790720	.	C	T	0	5	5	0	3	8	0	0
19	11790915	.	G	A	5	6	11	0	1	12	0	0
19	11792756	.	A	T	1	4	5	0	0	5	0	0
19	11815024	.	T	C	2	3	5	0	0	5	0	0
19	11815030	.	T	A	2	3	5	0	0	5	0	0
19	11815087	.	G	A	3	4	7	0	0	7	0	0
19	11815576	.	T	A	1	2	3	0	0	3	0	0
19	11838654	.	C	T	1	2	3	0	0	3	0	0
19	11843254	.	G	A	1	2	3	0	0	3	0	0
19	11846550	.	G	C	2	2	4	0	0	4	0	0
19	11846911	.	A	T	4	3	7	0	1	8	0	0
19	11892419	.	A	T	5	10	15	0	1	16	0	0
19	11892422	.	A	G	5	13	18	0	0	18	0	0
19	11892636	.	T	A	4	15	19	0	1	20	0	0
19	11892961	.	A	G	3	2	5	1	1	7	0	0
19	11893087	.	A	G	5	11	16	0	0	16	0	0
19	11893309	.	G	T	1	4	5	1	8	15	1	0
19	11893313	.	G	A	8	5	13	1	0	14	0	0
19	11893445	.	A	G	6	9	15	0	0	15	0	0
19	11893624	.	T	C	5	8	13	0	0	13	0	0
19	11893650	.	T	A	4	7	11	0	0	11	0	0
19	11897774	.	T	C	4	2	6	0	0	6	0	0
19	11897841	.	G	T	5	8	13	0	0	13	0	0
19	11899324	.	A	G	10	8	18	0	1	19	0	0
19	11899384	.	T	C	14	5	19	1	1	21	0	0
19	11903571	.	A	G	8	5	13	0	1	14	0	0
19	11906178	.	G	A	9	5	14	0	1	15	0	0
19	11906238	.	T	G	8	8	16	0	3	19	0	0
19	11908436	.	A	G	3	10	13	0	1	14	0	0
19	11908567	.	G	A	5	3	8	0	1	9	0	0
19	11910538	.	T	C	6	0	6	0	4	10	0	0
19	11910595	.	A	C	5	5	10	0	0	10	0	0
19	11912635	.	T	A	6	8	14	0	1	15	0	0
19	11912838	.	T	G	4	7	11	0	0	11	0	0
19	11915272	.	A	G	3	4	7	0	0	7	0	0
19	11915320	.	G	A	5	7	12	0	2	14	0	0
19	11917609	.	T	A	2	4	6	0	0	6	0	0
19	11917682	.	A	T	1	5	6	0	1	7	0	0
19	11917805	.	T	C	3	4	7	0	0	7	0	0
19	11921816	.	G	A	1	6	7	0	0	7	0	0
19	11921817	.	T	A	1	6	7	0	0	7	0	0
19	11927986	.	G	A	9	2	11	0	1	12	0	0
19	11932822	.	T	C	5	2	7	0	0	7	0	0
19	11955713	.	A	G	5	4	9	0	1	10	0	0
19	11960343	.	C	T	5	3	8	0	1	9	0	0
19	11964016	.	A	G	4	4	8	0	0	8	0	0
19	11964313	.	A	G	3	4	7	0	0	7	0	0
19	11968998	.	G	A	3	2	5	0	0	5	0	0
19	11972725	.	A	G	3	3	6	0	0	6	0	0
19	11972732	.	G	A	3	3	6	0	0	6	0	0
19	11975110	.	A	G	2	3	5	0	0	5	0	0
19	11975159	.	G	T	2	2	4	0	0	4	0	0
19	11985848	.	C	T	6	8	14	0	0	14	0	0
19	11985858	.	T	C	4	11	15	0	0	15	0	0
19	11996249	.	T	A	3	11	14	0	1	15	0	0
19	11996360	.	A	C	12	8	20	0	1	21	0	0
19	12017902	.	G	A	1	7	8	0	16	24	0	0
19	12018036	.	C	G	4	6	10	0	0	10	0	0
19	12018084	.	C	T	7	5	12	0	1	13	0	0
19	12018263	.	A	C	5	0	5	0	6	11	0	0
19	12018291	.	A	G	6	0	6	0	6	12	0	0
19	12018367	.	G	T	3	7	10	0	2	12	0	0
19	12031202	.	C	T	0	3	3	0	14	17	0	0
19	12031466	.	T	A	5	4	9	0	1	10	0	0
19	12031515	.	T	G	5	5	10	1	2	13	0	0
19	12032273	.	G	T	5	4	9	0	0	9	0	0
19	12032622	.	C	T	6	5	11	0	0	11	0	0
19	12032649	.	G	A	7	4	11	0	0	11	0	0
19	12033494	.	T	C	2	1	3	0	4	7	0	0
19	12122035	.	A	G	30	20	50	0	2	52	0	0
19	12122039	.	G	A	30	19	49	0	3	52	0	0
19	12122124	.	C	A	45	20	65	0	4	69	0	0
19	12122489	.	G	T	30	40	70	0	2	72	0	0
19	12130089	.	G	A	49	35	84	0	1	85	0	0
19	12134950	.	C	G	6	3	9	0	0	9	0	0
19	12145548	.	A	T	30	20	50	0	1	51	0	0
19	12171712	.	C	T	34	26	60	0	1	61	0	0
19	12188083	.	G	T	30	30	60	0	3	63	0	0
19	12188207	.	A	G	27	27	54	0	0	54	0	0
19	12188243	.	A	G	24	29	53	0	1	54	0	0
19	12188249	.	A	G	23	30	53	0	2	55	0	0
19	12193578	.	G	C	32	13	45	0	4	49	0	0
19	12193604	.	A	G	13	18	31	0	0	31	0	0
19	12193617	.	T	A	7	11	18	0	2	20	0	0
19	12206504	.	T	G	14	10	24	0	1	25	0	0
19	12297178	.	C	T	3	5	8	0	1	9	0	0
19	12297375	.	A	G	5	9	14	0	0	14	0	0
19	12297471	.	A	G	4	2	6	0	0	6	0	0
19	12297869	.	A	C	2	4	6	0	0	6	0	0
19	12300840	.	G	A	3	8	11	0	1	12	0	0
19	12304137	.	A	G	8	7	15	0	0	15	0	0
19	12356418	.	G	A	0	3	3	0	3	6	0	0
19	12356511	.	C	A	2	8	10	0	1	11	0	0
19	12363275	.	C	T	8	8	16	1	0	17	0	0
19	12380004	.	A	T	11	13	24	0	0	24	0	0
19	12380029	.	A	T	12	15	27	0	2	29	0	0
19	12383623	.	G	A	9	5	14	0	0	14	0	0
19	12385998	.	A	G	5	6	11	0	0	11	0	0
19	12410252	.	A	G	5	8	13	0	0	13	0	0
19	12413422	.	C	A	7	8	15	0	0	15	0	0
19	12413479	.	C	T	5	6	11	0	0	11	0	0
19	12420188	.	G	A	0	8	8	0	8	16	0	0
19	12424420	.	A	T	4	7	11	0	0	11	0	0
19	12427675	.	G	A	13	6	19	0	0	19	0	0
19	12428413	.	C	G	4	4	8	0	0	8	0	0
19	12428454	.	A	G	4	3	7	0	0	7	0	0
19	12428634	.	A	G	11	8	19	0	0	19	0	0
19	12428646	.	A	G	10	7	17	0	0	17	0	0
19	12428741	.	T	C	13	6	19	0	0	19	0	0
19	12428754	.	A	G	17	7	24	0	0	24	0	0
19	12429162	.	C	A	1	2	3	0	0	3	0	0
19	12645583	.	G	T	10	10	20	0	0	20	0	0
19	12645661	.	C	T	7	8	15	0	1	16	0	0
19	12655554	.	G	A	1	7	8	1	4	13	0	0
19	12655606	.	G	C	2	5	7	0	0	7	0	0
19	12661671	.	T	G	1	3	4	0	2	6	0	0
19	12762981	.	G	C	6	7	13	0	0	14	1	0
19	12801983	.	T	C	6	7	13	0	1	14	0	0
19	12801987	.	T	C	7	7	14	0	0	14	0	0
19	12802035	.	C	A	4	4	8	0	1	9	0	0
19	12802554	.	T	C	7	4	11	0	0	11	0	0
19	12802662	.	T	C	7	5	12	0	2	14	0	0
19	12802665	.	T	C	9	6	15	0	0	15	0	0
19	12802986	.	T	C	7	5	12	0	0	12	0	0
19	12803053	.	T	C	6	5	11	0	0	11	0	0
19	12803218	.	A	G	7	6	13	0	1	14	0	0
19	12937143	.	A	G	4	6	10	0	0	10	0	0
19	12937176	.	G	C	9	8	17	0	0	17	0	0
19	12937249	.	A	G	16	23	39	0	1	40	0	0
19	12937364	.	G	A	15	14	29	0	2	31	0	0
19	12937444	.	T	C	17	1	18	0	20	38	0	0
19	12937542	.	C	T	8	14	22	0	4	26	0	0
19	12937574	.	A	G	17	12	29	0	2	31	0	0
19	12938085	.	G	A	3	4	7	0	0	7	0	0
19	12938160	.	G	T	5	1	6	0	2	8	0	0
19	12938483	.	C	T	1	2	3	0	0	3	0	0
19	12938575	.	T	A	2	3	5	0	2	7	0	0
19	12938578	.	A	G	3	2	5	0	1	6	0	0
19	12938750	.	T	C	5	2	7	0	0	7	0	0
19	12939183	.	T	C	2	2	4	0	1	5	0	0
19	12939223	.	G	A	2	2	4	0	0	4	0	0
19	12939298	.	A	C	6	4	10	0	0	10	0	0
19	12939317	.	A	G	6	6	12	0	0	12	0	0
19	12939380	.	T	C	5	5	10	0	0	10	0	0
19	12939385	.	G	A	6	5	11	0	0	11	0	0
19	12939424	.	G	A	7	2	9	0	0	9	0	0
19	13121476	.	C	T	5	6	11	0	0	11	0	0
19	13151155	.	A	G	9	0	9	0	27	36	0	0
19	13184781	.	A	T	21	17	38	0	0	38	0	0
19	13185127	.	G	A	18	18	36	0	0	36	0	0
19	13185378	.	C	A	28	21	49	0	3	52	0	0
19	13186340	.	C	T	23	22	45	1	0	46	0	0
19	13186357	.	A	G	23	20	43	1	2	46	0	0
19	13186673	.	A	G	24	16	40	0	1	41	0	0
19	13193382	.	T	A	5	5	10	0	0	10	0	0
19	13194073	.	T	A	6	9	15	0	1	16	0	0
19	13194133	.	C	T	5	12	17	0	1	18	0	0
19	13194246	.	A	G	6	3	9	0	0	9	0	0
19	13194309	.	T	G	6	3	9	0	0	9	0	0
19	13194522	.	T	C	3	0	3	0	5	8	0	0
19	13194812	.	T	A	5	10	15	0	2	17	0	0
19	13194861	.	A	G	7	2	9	0	0	9	0	0
19	13194902	.	G	T	6	4	10	0	0	10	0	0
19	13194930	.	T	C	5	6	11	0	0	11	0	0
19	13194974	.	C	G	6	9	15	0	0	15	0	0
19	13195023	.	A	T	9	11	20	0	0	20	0	0
19	13195224	.	G	C	4	0	4	0	4	8	0	0
19	13196586	.	A	G	5	3	8	0	1	9	0	0
19	13390921	.	G	C	1	6	7	0	0	7	0	0
19	13395156	.	T	A	9	7	16	0	1	17	0	0
19	13395347	.	G	A	0	13	13	0	9	22	0	0
19	13395737	.	A	G	10	5	15	0	1	16	0	0
19	13395819	.	T	C	15	6	21	0	1	22	0	0
19	13395959	.	G	T	18	4	22	0	0	22	0	0
19	13395962	.	T	G	17	3	20	0	0	20	0	0
19	13396252	.	C	T	8	8	16	0	2	18	0	0
19	13396481	.	T	C	14	25	39	0	0	39	0	0
19	13396486	.	G	C	15	22	37	0	0	37	0	0
19	13396619	.	C	A	7	10	17	0	0	17	0	0
19	13396702	.	C	G	14	6	20	0	0	20	0	0
19	13397219	.	A	G	5	4	9	0	1	10	0	0
19	13413068	.	A	T	10	12	22	1	0	23	0	0
19	13413387	.	T	C	11	12	23	0	0	23	0	0
19	13413432	.	C	A	6	7	13	0	4	17	0	0
19	13413445	.	A	G	6	8	14	0	0	14	0	0
19	13413547	.	A	G	1	3	4	0	0	4	0	0
19	13413683	.	A	G	2	9	11	0	0	11	0	0
19	13413727	.	G	A	5	4	9	0	0	9	0	0
19	13413776	.	G	C	5	6	11	0	0	11	0	0
19	13413807	.	G	T	4	3	7	0	0	7	0	0
19	13413844	.	C	T	5	4	9	0	1	10	0	0
19	13414896	.	C	T	11	6	17	0	0	17	0	0
19	13415169	.	C	T	18	16	34	0	0	34	0	0
19	13419582	.	T	C	22	23	45	0	1	46	0	0
19	13419696	.	A	G	19	0	19	0	22	41	0	0
19	13419948	.	A	C	12	9	21	0	8	29	0	0
19	13419986	.	C	G	18	10	28	0	1	29	0	0
19	13425618	.	T	C	4	9	13	0	0	13	0	0
19	13425707	.	A	G	3	8	11	0	0	11	0	0
19	13426090	.	A	T	7	3	10	0	1	11	0	0
19	13426863	.	T	G	2	1	3	0	6	9	0	0
19	13426961	.	T	C	2	3	5	0	0	5	0	0
19	13639492	.	T	A	15	19	34	0	1	35	0	0
19	13651691	.	G	T	12	8	20	0	0	20	0	0
19	13670103	.	C	T	4	7	11	0	14	25	0	0
19	13688974	.	G	A	15	7	22	0	1	23	0	0
19	13698141	.	G	A	13	10	23	0	0	23	0	0
19	13698643	.	G	A	16	11	27	0	1	28	0	0
19	13698685	.	T	C	10	7	17	0	1	18	0	0
19	13714963	.	A	G	17	8	25	0	0	25	0	0
19	13724014	.	T	C	27	21	48	0	1	49	0	0
19	13724320	.	T	G	9	8	17	0	2	19	0	0
19	13733583	.	C	G	15	14	29	0	1	30	0	0
19	13905442	.	T	A	13	9	22	0	2	24	0	0
19	13905469	.	T	G	11	10	21	0	0	21	0	0
19	13919292	.	A	T	8	13	21	0	1	22	0	0
19	13923051	.	A	T	2	12	14	0	0	14	0	0
19	13939827	.	T	C	8	8	16	0	1	17	0	0
19	13939839	.	G	C	10	11	21	0	2	23	0	0
19	13939883	.	C	G	15	23	38	0	1	39	0	0
19	13940106	.	A	G	14	17	31	0	3	34	0	0
19	13940123	.	A	T	14	21	35	0	1	36	0	0
19	13940168	.	G	A	18	23	41	0	2	43	0	0
19	13940227	.	G	T	19	15	34	0	3	37	0	0
19	13940423	.	G	T	17	20	37	0	2	39	0	0
19	13940500	.	C	T	18	15	33	0	0	33	0	0
19	13940614	.	T	C	11	14	25	0	2	27	0	0
19	13940728	.	A	G	1	7	8	0	0	8	0	0
19	13940936	.	C	A	11	11	22	0	0	22	0	0
19	13941161	.	C	T	19	22	41	0	0	41	0	0
19	13941285	.	T	C	10	18	28	0	1	29	0	0
19	13941311	.	C	T	12	20	32	0	0	32	0	0
19	13941403	.	T	A	9	13	22	0	1	23	0	0
19	13941442	.	T	C	10	19	29	0	2	31	0	0
19	13941448	.	A	G	14	18	32	0	0	32	0	0
19	13941505	.	G	C	25	14	39	1	0	40	0	0
19	13941526	.	G	T	26	12	38	1	0	39	0	0
19	13941667	.	T	A	19	29	48	0	2	50	0	0
19	13950183	.	T	C	7	5	12	0	0	12	0	0
19	14035672	.	G	A	2	2	4	0	0	4	0	0
19	14165408	.	G	A	0	7	7	0	11	18	0	0
19	14169238	.	T	A	8	13	21	0	0	21	0	0
19	14352661	.	C	T	4	1	5	0	1	6	0	0
19	14390171	.	G	A	1	2	3	0	0	3	0	0
19	14421259	.	A	G	2	0	2	0	6	8	0	0
19	14431424	.	T	A	3	6	9	0	0	9	0	0
19	14433417	.	A	G	5	7	12	0	0	12	0	0
19	14434077	.	A	G	13	8	21	0	1	22	0	0
19	14434078	.	G	A	13	9	22	0	0	22	0	0
19	14434441	.	A	T	11	10	21	0	0	21	0	0
19	14435968	.	T	C	16	14	30	0	1	32	1	0
19	14436033	.	A	T	11	4	15	0	0	15	0	0
19	14436060	.	C	T	8	8	16	0	2	18	0	0
19	14470399	.	A	C	3	2	5	0	0	5	0	0
19	14470433	.	G	A	1	3	4	0	0	4	0	0
19	14470443	.	A	T	1	3	4	0	0	4	0	0
19	14921109	.	C	T	1	4	5	0	1	6	0	0
19	14921125	.	C	T	2	3	5	0	0	5	0	0
19	14951474	.	T	C	3	3	6	0	0	6	0	0
19	15307882	.	T	C	11	2	13	0	0	13	0	0
19	15307883	.	T	C	10	2	12	0	1	13	0	0
19	15308389	.	G	T	12	9	21	0	1	22	0	0
19	15313034	.	A	C	10	11	21	0	0	21	0	0
19	15313115	.	G	A	5	6	11	0	3	14	0	0
19	15331663	.	T	C	7	8	15	0	2	17	0	0
19	15331686	.	T	C	7	7	14	0	1	15	0	0
19	15331699	.	C	T	0	6	6	0	10	16	0	0
19	15331805	.	C	A	9	6	15	0	2	17	0	0
19	15331970	.	T	C	5	0	5	0	11	16	0	0
19	15331978	.	G	A	4	10	14	0	0	14	0	0
19	15332115	.	G	T	1	5	6	0	0	6	0	0
19	15332116	.	A	G	1	5	6	0	0	6	0	0
19	15332911	.	T	C	1	8	9	0	1	10	0	0
19	15334851	.	C	G	1	5	6	0	0	6	0	0
19	15411142	.	G	A	1	3	4	0	1	5	0	0
19	15496293	.	C	G	3	5	8	0	0	8	0	0
19	15509850	.	C	A	1	2	3	0	0	3	0	0
19	15517933	.	G	A	2	2	4	0	0	4	0	0
19	15527165	.	C	T	1	1	2	0	1	3	0	0
19	15529302	.	A	C	4	2	6	0	1	7	0	0
19	15532081	.	C	T	2	7	9	0	1	10	0	0
19	15532082	.	G	A	0	7	7	0	3	10	0	0
19	15532159	.	C	T	4	2	6	0	1	7	0	0
19	15532386	.	G	C	2	2	4	0	0	4	0	0
19	15532391	.	C	T	4	2	6	0	0	6	0	0
19	15617983	.	A	C	3	5	8	0	1	9	0	0
19	15618501	.	G	A	4	2	6	0	0	6	0	0
19	15618813	.	C	T	8	9	17	0	2	19	0	0
19	15618951	.	G	A	10	11	21	0	0	21	0	0
19	15619503	.	C	T	12	6	18	0	0	18	0	0
19	15619584	.	A	G	11	13	24	0	1	25	0	0
19	15619675	.	A	G	2	0	2	0	11	13	0	0
19	15851707	.	C	A	8	15	23	0	4	27	0	0
19	15851710	.	G	A	17	8	25	0	0	25	0	0
19	15851777	.	G	A	18	9	27	0	2	29	0	0
19	15851890	.	C	T	10	9	19	0	0	19	0	0
19	15852389	.	T	A	8	10	18	0	0	18	0	0
19	15852965	.	C	T	0	7	7	0	2	9	0	0
19	15853008	.	C	T	1	7	8	0	9	17	0	0
19	15853153	.	C	T	9	8	17	0	1	18	0	0
19	15853275	.	A	G	17	11	28	0	0	28	0	0
19	15855335	.	A	T	9	10	19	0	1	20	0	0
19	16022671	.	G	A	3	4	7	0	0	7	0	0
19	16023901	.	C	T	7	5	12	0	1	13	0	0
19	16027319	.	A	T	2	3	5	0	0	5	0	0
19	16027334	.	G	A	2	3	5	0	1	6	0	0
19	16027375	.	T	G	2	2	4	0	0	4	0	0
19	16032397	.	C	A	3	5	8	0	0	8	0	0
19	16070475	.	A	G	3	6	9	0	0	9	0	0
19	16076887	.	C	T	5	6	11	0	0	11	0	0
19	16077033	.	C	T	3	6	9	0	0	9	0	0
19	16078744	.	C	A	6	3	9	0	0	9	0	0
19	16082394	.	G	A	1	1	2	1	2	5	0	0
19	16082756	.	G	A	8	5	13	0	0	13	0	0
19	16085862	.	A	T	6	6	12	0	1	13	0	0
19	16086025	.	T	A	11	7	18	0	1	19	0	0
19	16086937	.	G	A	4	8	12	0	0	12	0	0
19	16086957	.	T	C	8	3	11	0	0	11	0	0
19	16087201	.	T	C	4	2	6	0	0	6	0	0
19	16087503	.	T	A	4	3	7	0	1	8	0	0
19	16087527	.	C	T	4	4	8	0	1	9	0	0
19	16087538	.	G	A	6	4	10	0	0	10	0	0
19	16087875	.	A	T	1	3	4	0	1	5	0	0
19	16087895	.	T	A	2	2	4	0	1	5	0	0
19	16541333	.	C	T	3	2	5	0	0	5	0	0
19	16541375	.	A	T	1	4	5	0	0	5	0	0
19	16541378	.	G	A	1	4	5	0	0	5	0	0
19	16576532	.	G	A	7	3	10	0	1	11	0	0
19	16584121	.	G	A	1	4	5	0	12	17	0	0
19	16584205	.	C	T	1	6	7	0	0	7	0	0
19	16625154	.	G	T	6	10	16	0	0	16	0	0
19	16629317	.	A	G	6	11	17	0	0	17	0	0
19	16638661	.	C	T	15	9	24	1	0	25	0	0
19	16638786	.	C	T	18	13	31	0	1	32	0	0
19	16638906	.	C	G	12	7	19	0	2	21	0	0
19	16651469	.	T	C	15	9	24	0	1	25	0	0
19	16653867	.	T	C	15	10	25	2	1	28	0	0
19	16653977	.	T	C	12	12	24	0	3	27	0	0
19	16653998	.	T	C	12	9	21	0	0	21	0	0
19	16654012	.	T	C	11	10	21	0	1	22	0	0
19	16654277	.	G	A	1	9	10	0	13	24	1	0
19	16654640	.	A	G	19	18	37	0	2	39	0	0
19	17208304	.	C	T	3	4	7	0	0	7	0	0
19	17209325	.	G	A	4	4	8	0	0	8	0	0
19	17260250	.	C	G	4	3	7	0	0	7	0	0
19	17275632	.	C	A	7	4	11	0	0	11	0	0
19	17276921	.	A	T	11	9	20	0	0	20	0	0
19	17292898	.	T	A	6	4	10	0	0	10	0	0
19	17292905	.	G	A	6	3	9	0	0	9	0	0
19	17293153	.	T	G	2	3	5	0	0	5	0	0
19	17293345	.	C	T	12	9	21	0	0	21	0	0
19	17295656	.	G	A	11	11	22	0	2	24	0	0
19	17295674	.	C	T	10	9	19	0	1	20	0	0
19	17300130	.	G	A	13	8	21	0	0	21	0	0
19	17300536	.	C	T	9	11	20	0	0	20	0	0
19	17301033	.	T	C	14	1	15	0	7	22	0	0
19	17301292	.	A	G	13	9	22	0	0	22	0	0
19	17302363	.	T	A	5	8	13	0	0	13	0	0
19	17304888	.	A	G	5	13	18	0	0	18	0	0
19	17304891	.	T	C	5	13	18	0	0	18	0	0
19	17378142	.	G	A	5	3	8	0	1	9	0	0
19	17378361	.	C	T	8	3	11	0	0	11	0	0
19	17386556	.	G	T	25	33	58	0	2	60	0	0
19	17393069	.	T	C	21	31	52	0	3	55	0	0
19	17400470	.	C	T	9	6	15	0	0	15	0	0
19	17400653	.	G	C	13	7	20	0	1	21	0	0
19	17404237	.	C	T	19	18	37	0	2	39	0	0
19	17405304	.	C	T	27	27	54	0	2	56	0	0
19	17405364	.	C	T	28	32	60	0	2	62	0	0
19	17406014	.	A	T	18	26	44	0	1	45	0	0
19	17406081	.	A	C	28	18	46	0	1	47	0	0
19	17406082	.	G	A	28	18	46	0	1	47	0	0
19	17406271	.	T	G	14	14	28	0	1	29	0	0
19	17406656	.	C	G	25	1	26	0	30	56	0	0
19	17406770	.	T	G	24	32	56	0	0	56	0	0
19	17406918	.	T	C	24	13	37	0	0	37	0	0
19	17514860	.	T	A	14	14	28	0	5	34	1	0
19	17514897	.	T	C	16	1	17	0	13	30	0	0
19	17515048	.	T	C	2	6	8	0	1	9	0	0
19	17515297	.	T	A	3	2	5	0	3	8	0	0
19	17515347	.	G	C	10	3	13	0	0	13	0	0
19	17515954	.	T	C	1	2	3	0	0	3	0	0
19	17515990	.	G	A	1	4	5	0	0	5	0	0
19	17516039	.	G	A	2	4	6	0	0	6	0	0
19	17516103	.	G	C	5	0	5	0	8	13	0	0
19	17516130	.	T	C	5	11	16	0	1	17	0	0
19	17516162	.	A	T	6	14	20	0	2	22	0	0
19	17516195	.	T	C	11	0	11	0	18	29	0	0
19	17516211	.	G	T	13	16	29	0	2	31	0	0
19	17516330	.	A	G	13	18	31	0	1	32	0	0
19	17516390	.	A	G	14	18	32	0	1	33	0	0
19	17516585	.	C	A	8	6	14	0	0	14	0	0
19	17516608	.	A	C	9	2	11	0	0	11	0	0
19	17516920	.	A	G	14	5	19	0	1	20	0	0
19	17516922	.	A	G	13	6	19	0	1	20	0	0
19	17516962	.	T	C	11	4	15	0	0	15	0	0
19	17516997	.	A	G	9	7	16	0	1	17	0	0
19	17517105	.	T	C	8	5	13	0	0	13	0	0
19	17517118	.	G	A	8	3	11	0	0	11	0	0
19	17517305	.	T	G	3	2	5	0	0	5	0	0
19	17517669	.	C	G	5	3	8	0	0	8	0	0
19	17517768	.	T	G	8	10	18	0	0	18	0	0
19	17517816	.	T	C	8	10	18	0	1	19	0	0
19	17517821	.	A	G	11	11	22	0	0	22	0	0
19	17517912	.	T	G	8	14	22	1	1	24	0	0
19	17517928	.	C	G	8	9	17	1	1	19	0	0
19	17518179	.	A	T	13	9	22	0	2	24	0	0
19	17518231	.	T	C	8	9	17	0	2	19	0	0
19	17518276	.	G	C	4	9	13	0	0	13	0	0
19	17518330	.	T	C	10	12	22	0	0	22	0	0
19	17518351	.	C	A	1	7	8	0	10	18	0	0
19	17518366	.	A	T	8	8	16	0	1	17	0	0
19	17518489	.	T	A	10	8	18	0	2	20	0	0
19	17518531	.	T	G	5	9	14	1	0	15	0	0
19	17518550	.	A	C	5	4	9	1	1	11	0	0
19	17520859	.	A	G	13	10	23	0	3	26	0	0
19	17521027	.	A	T	7	8	15	0	2	17	0	0
19	17521060	.	C	A	8	11	19	0	0	19	0	0
19	17722355	.	T	C	9	8	17	0	0	17	0	0
19	17733001	.	G	A	7	5	12	0	0	12	0	0
19	17834633	.	T	A	3	2	5	0	0	5	0	0
19	17834671	.	T	A	2	5	7	0	0	7	0	0
19	17972837	.	C	T	0	2	2	0	1	3	0	0
19	18143837	.	C	T	4	3	7	1	1	9	0	0
19	18597259	.	C	T	1	3	4	0	0	4	0	0
19	18636530	.	A	T	2	8	10	0	0	10	0	0
19	18765109	.	C	T	1	2	3	0	0	3	0	0
19	18765612	.	C	T	1	4	5	0	0	5	0	0
19	18824276	.	A	G	4	0	4	0	2	6	0	0
19	18903694	.	C	T	3	4	7	0	0	7	0	0
19	18990243	.	G	A	16	4	20	0	0	20	0	0
19	19159654	.	C	T	1	2	3	0	0	3	0	0
19	19200483	.	A	G	5	10	15	0	0	15	0	0
19	19201301	.	T	G	16	13	29	0	2	31	0	0
19	19213871	.	C	T	6	12	18	0	0	18	0	0
19	19214295	.	T	G	12	10	22	0	2	24	0	0
19	19214316	.	T	A	10	12	22	0	0	22	0	0
19	19217233	.	T	C	0	3	3	0	1	4	0	0
19	19249688	.	G	A	0	2	2	0	1	3	0	0
19	19263154	.	A	T	2	3	5	0	0	5	0	0
19	19263510	.	G	T	3	3	6	0	1	7	0	0
19	19269522	.	C	T	6	4	10	0	0	10	0	0
19	19269659	.	T	C	3	4	7	0	0	7	0	0
19	19269931	.	G	A	3	5	8	0	1	9	0	0
19	19270468	.	C	T	5	7	12	0	1	13	0	0
19	19270606	.	A	C	4	2	6	0	0	6	0	0
19	19270623	.	T	C	2	5	7	0	0	7	0	0
19	19270703	.	C	T	2	5	7	0	0	7	0	0
19	19278351	.	C	T	2	2	4	0	0	4	0	0
19	19287981	.	G	A	21	16	37	0	3	40	0	0
19	19319164	.	T	C	19	10	29	0	0	29	0	0
19	19319229	.	C	T	18	15	33	0	0	33	0	0
19	19319315	.	G	A	16	13	29	0	2	31	0	0
19	19319337	.	A	G	12	10	22	0	1	23	0	0
19	19319556	.	T	C	7	0	7	0	6	13	0	0
19	19319626	.	A	C	13	12	25	0	0	25	0	0
19	19319692	.	C	T	0	7	7	0	11	18	0	0
19	19319724	.	A	G	9	12	21	0	1	22	0	0
19	19319814	.	T	A	8	9	17	0	0	17	0	0
19	19319852	.	T	A	5	12	17	0	1	18	0	0
19	19319864	.	T	A	12	3	15	0	1	16	0	0
19	19338923	.	T	A	4	4	8	0	0	8	0	0
19	19339071	.	C	G	3	6	9	0	0	9	0	0
19	19339232	.	C	A	0	7	7	0	8	15	0	0
19	19342328	.	C	T	3	3	6	0	0	6	0	0
19	19347856	.	T	C	10	7	17	0	0	17	0	0
19	19353790	.	G	A	4	4	8	0	1	9	0	0
19	19374940	.	G	A	2	3	5	0	0	5	0	0
19	19402950	.	T	C	1	3	4	0	0	4	0	0
19	19417985	.	C	T	14	4	18	0	0	18	0	0
19	19418066	.	G	A	10	8	18	0	1	19	0	0
19	19432598	.	C	T	18	12	30	0	0	30	0	0
19	19438484	.	G	A	1	2	3	0	0	3	0	0
19	19498760	.	T	C	3	5	8	0	0	8	0	0
19	19498814	.	C	T	0	4	4	0	4	8	0	0
19	19544615	.	C	T	8	10	18	0	1	19	0	0
19	19545090	.	A	G	1	2	3	0	0	4	1	0
19	19549921	.	T	C	9	9	18	0	1	19	0	0
19	19550141	.	T	G	12	6	18	0	2	20	0	0
19	19550184	.	G	T	14	11	25	0	1	26	0	0
19	19550381	.	T	G	15	9	24	0	0	24	0	0
19	19550601	.	C	A	9	15	24	0	1	25	0	0
19	19551819	.	G	A	10	8	18	0	0	18	0	0
19	19551828	.	A	G	8	8	16	0	0	16	0	0
19	19561923	.	C	T	1	10	11	0	5	16	0	0
19	19562669	.	A	G	6	8	14	0	0	14	0	0
19	19573913	.	C	T	1	10	11	0	16	27	0	0
19	19579200	.	C	T	10	9	19	0	0	19	0	0
19	19580971	.	C	T	0	11	11	0	6	17	0	0
19	19592010	.	C	T	0	10	10	0	14	24	0	0
19	19652494	.	G	A	0	2	2	0	3	5	0	0
19	19657128	.	C	A	1	3	4	0	0	4	0	0
19	19769016	.	C	A	7	4	11	1	0	12	0	0
19	19979049	.	C	T	3	2	5	0	0	5	0	0
19	20082608	.	A	T	3	2	5	0	1	6	0	0
19	20112056	.	G	C	21	33	54	0	3	57	0	0
19	20113526	.	G	A	26	30	56	0	0	56	0	0
19	20164058	.	G	A	0	4	4	0	5	9	0	0
19	20176418	.	G	A	0	4	4	0	6	10	0	0
19	20176665	.	G	T	6	3	9	0	0	9	0	0
19	20179257	.	G	A	16	8	24	0	5	29	0	0
19	20179291	.	G	A	19	10	29	0	2	31	0	0
19	20185030	.	C	T	21	17	38	0	1	39	0	0
19	20190752	.	G	T	9	3	12	0	0	12	0	0
19	20243214	.	A	T	1	2	3	0	0	3	0	0
19	20243263	.	G	T	2	3	5	0	0	5	0	0
19	20244004	.	T	A	4	2	6	0	0	6	0	0
19	20244114	.	C	T	1	3	4	0	0	4	0	0
19	20244346	.	T	A	1	2	3	0	0	3	0	0
19	20292924	.	C	A	2	2	4	0	0	4	0	0
19	20293189	.	A	G	3	3	6	0	0	6	0	0
19	20293414	.	G	A	5	2	7	0	0	7	0	0
19	20293548	.	C	G	3	2	5	0	0	5	0	0
19	20301843	.	T	A	2	6	8	0	0	8	0	0
19	20414805	.	C	G	1	9	10	0	8	18	0	0
19	20415143	.	T	A	9	10	19	0	2	21	0	0
19	20415146	.	T	C	10	0	10	0	10	20	0	0
19	20415242	.	G	A	11	5	16	0	2	18	0	0
19	20423199	.	C	T	2	5	7	0	2	9	0	0
19	20423507	.	A	G	7	4	11	0	0	11	0	0
19	20425879	.	T	C	2	0	2	0	2	4	0	0
19	20454087	.	G	A	4	5	9	0	0	9	0	0
19	20454123	.	A	G	4	4	8	0	0	8	0	0
19	20454276	.	G	A	3	3	6	0	0	6	0	0
19	20454324	.	G	A	2	6	8	0	0	8	0	0
19	20454393	.	G	A	5	7	12	0	0	12	0	0
19	20720782	.	T	C	20	22	42	0	2	44	0	0
19	20721025	.	C	T	32	19	51	1	2	54	0	0
19	20721135	.	G	A	22	41	63	0	1	64	0	0
19	20721215	.	C	T	23	32	55	0	9	64	0	0
19	20721761	.	A	C	10	19	29	0	8	37	0	0
19	20722093	.	C	A	20	11	31	0	4	35	0	0
19	20722144	.	C	T	8	15	23	0	4	27	0	0
19	20722330	.	C	G	7	4	11	0	0	11	0	0
19	20754096	.	C	A	3	4	7	0	0	7	0	0
19	20761382	.	C	T	0	5	5	0	2	7	0	0
19	20761710	.	T	G	3	5	8	0	2	10	0	0
19	20762228	.	T	C	2	10	12	0	2	14	0	0
19	20763798	.	G	A	4	4	8	0	0	8	0	0
19	20766777	.	C	T	3	3	6	0	0	6	0	0
19	20771290	.	G	A	5	2	7	0	0	7	0	0
19	20771317	.	G	A	6	2	8	0	0	8	0	0
19	20790572	.	T	C	9	11	20	0	0	20	0	0
19	20790809	.	C	T	17	10	27	0	0	27	0	0
19	20791295	.	T	C	16	7	23	0	1	24	0	0
19	20791525	.	T	G	6	7	13	0	1	14	0	0
19	20791935	.	C	T	2	2	4	0	0	4	0	0
19	20796566	.	C	T	15	17	32	2	1	35	0	0
19	20796605	.	C	T	13	15	28	2	0	30	0	0
19	20801521	.	G	A	6	2	8	0	1	9	0	0
19	20801926	.	A	G	2	2	4	0	0	4	0	0
19	20815229	.	T	A	4	4	8	0	0	8	0	0
19	20815256	.	G	A	3	4	7	0	1	8	0	0
19	20823024	.	C	T	1	2	3	0	0	3	0	0
19	20823070	.	A	G	1	2	3	0	0	3	0	0
19	21367862	.	C	T	4	3	7	0	2	9	0	0
19	21408969	.	C	T	6	5	11	0	0	11	0	0
19	21410404	.	G	A	13	16	29	0	2	31	0	0
19	21411022	.	C	T	10	9	19	0	0	19	0	0
19	21412041	.	C	T	16	18	34	0	1	35	0	0
19	21412293	.	A	G	6	8	14	0	0	14	0	0
19	21412755	.	T	C	6	16	22	0	1	23	0	0
19	21413152	.	G	A	4	11	15	0	13	28	0	0
19	21698413	.	G	A	6	8	14	0	1	15	0	0
19	21711187	.	G	C	7	0	7	0	3	10	0	0
19	21711267	.	G	C	6	3	9	0	1	10	0	0
19	21711681	.	A	G	4	5	9	0	0	9	0	0
19	21712031	.	A	T	1	3	4	0	0	4	0	0
19	21712032	.	C	G	1	3	4	0	0	4	0	0
19	21712285	.	T	A	4	2	6	0	1	7	0	0
19	21715094	.	A	T	5	6	11	0	0	11	0	0
19	21715367	.	C	T	6	3	9	0	0	9	0	0
19	21715385	.	T	C	5	3	8	0	0	8	0	0
19	21716791	.	C	T	1	3	4	0	1	5	0	0
19	21814362	.	A	C	38	37	75	0	3	78	0	0
19	21814372	.	T	A	39	45	84	0	1	85	0	0
19	21814408	.	T	C	47	45	92	0	3	95	0	0
19	21814457	.	C	T	46	66	112	1	6	119	0	0
19	21814515	.	C	T	64	46	110	0	5	115	0	0
19	21814644	.	T	G	34	39	73	0	4	77	0	0
19	21814852	.	T	C	39	36	75	0	4	79	0	0
19	21815151	.	C	T	16	40	56	0	41	97	0	0
19	21832562	.	A	G	7	5	12	0	2	14	0	0
19	21832623	.	G	A	3	2	5	0	1	6	0	0
19	22062875	.	A	G	1	2	3	0	0	3	0	0
19	22068656	.	A	C	1	2	3	0	0	3	0	0
19	22068667	.	A	G	1	0	1	0	2	3	0	0
19	22070497	.	G	A	4	4	8	0	1	9	0	0
19	22070526	.	C	A	1	7	8	0	0	8	0	0
19	22071792	.	T	C	6	4	10	0	1	11	0	0
19	22072680	.	A	C	1	3	4	1	0	5	0	0
19	22072797	.	C	A	1	2	3	1	0	4	0	0
19	22073191	.	A	T	4	6	10	0	0	10	0	0
19	22156048	.	G	A	1	3	4	0	2	6	0	0
19	22177122	.	G	A	0	3	3	0	4	7	0	0
19	22177164	.	T	C	4	4	8	0	0	8	0	0
19	22338132	.	T	G	1	2	3	0	0	3	0	0
19	22361962	.	A	C	9	11	20	0	2	22	0	0
19	22362260	.	A	C	5	7	12	0	0	12	0	0
19	22408746	.	T	C	5	5	10	0	0	10	0	0
19	22409431	.	G	T	12	4	16	0	1	17	0	0
19	22409533	.	G	A	7	4	11	0	0	11	0	0
19	22409994	.	G	C	8	6	14	0	0	14	0	0
19	22410447	.	C	T	2	5	7	0	0	7	0	0
19	22410578	.	C	G	0	8	8	0	9	17	0	0
19	22410665	.	G	A	11	7	18	0	0	18	0	0
19	22410707	.	C	T	3	9	12	0	5	17	0	0
19	22410923	.	T	A	5	7	12	0	0	12	0	0
19	22411136	.	G	A	5	7	12	0	0	12	0	0
19	22411187	.	A	G	10	8	18	0	1	19	0	0
19	22411664	.	A	G	5	3	8	0	0	8	0	0
19	22412240	.	G	A	4	5	9	0	0	9	0	0
19	22412822	.	C	T	5	3	8	0	1	9	0	0
19	22412827	.	G	A	5	5	10	0	0	10	0	0
19	22413296	.	C	T	5	7	12	0	0	12	0	0
19	22413377	.	A	G	4	3	7	0	0	7	0	0
19	22413508	.	T	C	4	3	7	0	0	7	0	0
19	22413733	.	A	G	3	3	6	0	0	6	0	0
19	22414063	.	C	T	0	3	3	0	3	6	0	0
19	22414304	.	A	G	1	4	5	0	0	5	0	0
19	22415548	.	G	A	3	3	6	0	0	6	0	0
19	22415990	.	G	A	1	2	3	0	0	3	0	0
19	22416218	.	T	A	2	2	4	0	0	4	0	0
19	22416620	.	T	C	2	0	2	0	2	4	0	0
19	22418578	.	G	A	4	2	6	0	0	6	0	0
19	22418698	.	T	C	2	3	5	0	0	5	0	0
19	22419682	.	G	A	3	2	5	0	0	5	0	0
19	22419685	.	C	T	2	3	5	0	0	5	0	0
19	22420183	.	G	A	4	2	6	0	0	6	0	0
19	22420322	.	T	G	1	1	2	0	0	2	0	0
19	22420346	.	T	G	2	3	5	0	0	5	0	0
19	22420414	.	A	T	1	2	3	0	0	3	0	0
19	22427116	.	T	C	2	3	5	0	0	5	0	0
19	22623638	.	G	T	3	2	5	0	0	5	0	0
19	22624319	.	T	C	3	0	3	0	4	7	0	0
19	22624484	.	T	A	5	3	8	0	0	8	0	0
19	22624554	.	G	A	8	3	11	0	0	11	0	0
19	22624557	.	G	A	7	3	10	0	0	10	0	0
19	22634093	.	G	A	11	5	16	0	0	16	0	0
19	22638187	.	T	C	6	17	23	0	0	23	0	0
19	22638250	.	C	A	7	11	18	0	0	18	0	0
19	22655190	.	A	G	9	7	16	0	0	16	0	0
19	22655690	.	T	C	7	5	12	0	1	13	0	0
19	22728025	.	T	C	1	2	3	0	0	3	0	0
19	22728834	.	A	C	1	4	5	0	0	5	0	0
19	22731075	.	C	T	4	2	6	0	0	6	0	0
19	22731086	.	A	G	3	3	6	0	1	7	0	0
19	22759523	.	C	A	1	7	8	0	4	12	0	0
19	22764168	.	T	G	3	4	7	0	1	8	0	0
19	22764259	.	A	G	3	5	8	0	0	8	0	0
19	22764274	.	G	A	4	6	10	0	1	11	0	0
19	22788903	.	G	A	3	3	6	0	0	6	0	0
19	22807233	.	A	T	1	2	3	0	1	4	0	0
19	22842677	.	T	A	2	3	5	0	0	5	0	0
19	23877478	.	A	T	3	4	7	0	0	7	0	0
19	23877497	.	C	T	5	3	8	0	0	8	0	0
19	23877558	.	G	A	4	3	7	0	0	7	0	0
19	23920598	.	G	T	2	7	9	0	14	23	0	0
19	23920826	.	T	G	3	8	11	0	0	11	0	0
19	23921127	.	T	C	5	8	13	0	2	15	0	0
19	23921147	.	C	G	8	1	9	0	7	16	0	0
19	23921282	.	T	A	7	12	19	0	1	20	0	0
19	23921381	.	G	A	11	11	22	0	1	23	0	0
19	23921617	.	A	G	11	20	31	0	0	31	0	0
19	23921662	.	A	G	4	0	4	0	19	23	0	0
19	23921669	.	G	A	0	14	14	0	13	27	0	0
19	23921858	.	A	G	3	6	9	0	1	10	0	0
19	23921898	.	T	C	3	3	6	0	0	6	0	0
19	23921905	.	T	C	2	3	5	0	0	5	0	0
19	23922237	.	T	G	16	0	16	0	12	28	0	0
19	23922260	.	A	T	13	8	21	0	1	22	0	0
19	23970632	.	A	T	3	6	9	0	2	11	0	0
19	23982575	.	T	G	10	12	22	0	0	22	0	0
19	24007465	.	G	A	15	21	36	0	0	36	0	0
19	24007471	.	C	T	15	14	29	0	2	31	0	0
19	24031592	.	C	T	27	11	38	0	0	38	0	0
19	24031761	.	T	A	26	24	50	0	0	50	0	0
19	24032122	.	T	A	24	16	40	0	1	41	0	0
19	24032386	.	G	A	0	14	14	0	12	26	0	0
19	24032407	.	C	A	12	14	26	0	0	26	0	0
19	24032502	.	T	G	7	13	20	0	2	22	0	0
19	24032528	.	C	T	14	10	24	0	2	26	0	0
19	24032766	.	A	T	20	30	50	0	3	53	0	0
19	24032867	.	T	A	25	28	53	1	2	56	0	0
19	24032907	.	T	C	17	29	46	2	4	52	0	0
19	24033226	.	A	C	34	26	60	0	4	64	0	0
19	24033288	.	A	G	32	21	53	0	1	54	0	0
19	24033494	.	G	A	3	33	36	0	37	73	0	0
19	24033686	.	C	T	39	16	55	0	3	58	0	0
19	24033804	.	C	T	47	25	72	0	1	73	0	0
19	24033856	.	A	C	27	31	58	0	4	62	0	0
19	24034115	.	C	T	27	29	56	1	5	62	0	0
19	24034148	.	T	C	29	30	59	1	4	64	0	0
19	24034169	.	T	C	29	26	55	1	4	60	0	0
19	24034276	.	T	G	21	34	55	0	6	61	0	0
19	24034410	.	G	A	32	33	65	0	4	69	0	0
19	24034437	.	G	A	2	37	39	0	28	67	0	0
19	24034525	.	C	T	24	35	59	0	1	60	0	0
19	24034573	.	T	A	26	28	54	0	2	56	0	0
19	24058585	.	A	G	1	0	1	0	2	3	0	0
19	24064961	.	A	G	1	0	1	0	2	3	0	0
19	24065367	.	T	G	2	5	7	0	1	8	0	0
19	24070243	.	G	A	2	3	5	0	0	5	0	0
19	24072602	.	C	T	1	4	5	0	0	5	0	0
19	24072644	.	T	G	2	0	2	0	8	10	0	0
19	24074533	.	T	C	6	7	13	0	0	13	0	0
19	24074564	.	G	A	6	7	13	0	0	13	0	0
19	24074617	.	G	A	0	9	9	0	11	20	0	0
19	24074632	.	C	A	10	9	19	0	2	21	0	0
19	24074679	.	C	T	8	7	15	0	1	16	0	0
19	24074716	.	A	G	6	0	6	0	8	14	0	0
19	24074773	.	C	A	4	3	7	0	1	8	0	0
19	24074794	.	A	G	3	5	8	0	0	8	0	0
19	24074812	.	G	A	3	2	5	0	0	5	0	0
19	24123917	.	G	C	5	2	7	0	0	7	0	0
19	24123919	.	A	T	6	1	7	0	1	8	0	0
19	24124448	.	C	T	5	6	11	0	0	11	0	0
19	24124577	.	C	A	3	7	10	0	0	10	0	0
19	24127458	.	A	C	1	2	3	0	0	3	0	0
19	24128252	.	G	A	1	3	4	0	0	4	0	0
19	24128743	.	A	T	5	3	8	0	0	8	0	0
19	24128951	.	C	T	1	4	5	0	3	8	0	0
19	24129199	.	A	T	5	2	7	0	0	7	0	0
19	24129244	.	C	T	3	5	8	0	0	8	0	0
19	24129267	.	T	C	4	2	6	0	0	6	0	0
19	24129343	.	C	T	3	5	8	0	0	8	0	0
19	24129347	.	T	C	3	0	3	0	4	7	0	0
19	24129728	.	C	A	6	2	8	0	0	8	0	0
19	24130139	.	G	A	5	6	11	0	0	11	0	0
19	24130179	.	G	T	4	2	6	0	0	6	0	0
19	24130541	.	T	G	2	4	6	0	0	6	0	0
19	24130685	.	C	G	2	6	8	0	3	11	0	0
19	24130996	.	G	A	2	3	5	0	0	5	0	0
19	24133938	.	G	T	2	5	7	0	0	7	0	0
19	24264105	.	G	A	3	8	11	0	0	11	0	0
19	24264106	.	C	G	0	8	8	0	3	11	0	0
19	24381285	.	A	T	2	3	5	0	0	5	0	0
19	24381326	.	A	G	2	2	4	0	0	4	0	0
19	24382124	.	G	A	2	2	4	0	0	4	0	0
19	24385036	.	T	C	2	4	6	0	0	6	0	0
19	24385063	.	A	C	2	5	7	0	0	7	0	0
19	24388639	.	T	C	3	3	6	0	1	7	0	0
19	24388866	.	C	T	2	4	6	0	0	6	0	0
19	24388927	.	C	A	3	2	5	0	1	6	0	0
19	24388987	.	A	G	6	0	6	0	4	10	0	0
19	24389170	.	G	A	2	3	5	0	5	10	0	0
19	24389629	.	A	T	1	3	4	0	0	4	0	0
19	24389662	.	T	C	1	2	3	0	0	3	0	0
19	24389679	.	T	C	1	3	4	0	0	4	0	0
19	24390033	.	A	C	1	4	5	0	1	6	0	0
19	24390282	.	T	C	1	2	3	0	0	3	0	0
19	24390584	.	G	A	2	2	4	0	0	4	0	0
19	24391232	.	A	G	4	0	4	0	4	8	0	0
19	24391234	.	A	T	4	4	8	0	0	8	0	0
19	24391280	.	T	G	4	2	6	0	0	6	0	0
19	24391289	.	G	A	4	2	6	0	0	6	0	0
19	24391373	.	T	C	2	4	6	0	0	6	0	0
19	24391477	.	A	T	7	4	11	0	0	11	0	0
19	24394573	.	A	G	1	3	4	0	1	5	0	0
19	24399414	.	C	T	3	2	5	0	0	5	0	0
19	24448940	.	T	C	2	4	6	0	0	6	0	0
19	24448985	.	T	C	5	1	6	0	2	8	0	0
19	24488632	.	T	A	3	3	6	0	2	8	0	0
19	24488728	.	A	T	3	6	9	0	1	10	0	0
19	24491086	.	A	T	6	6	12	0	1	13	0	0
19	24491140	.	G	T	5	4	9	0	0	9	0	0
19	24491224	.	C	T	6	3	9	0	1	10	0	0
19	24491230	.	A	T	6	5	11	0	1	12	0	0
19	24491268	.	C	T	3	7	10	0	2	12	0	0
19	24491982	.	G	C	8	8	16	0	1	18	1	0
19	24553388	.	A	G	1	2	3	0	1	4	0	0
19	24596635	.	G	A	2	5	7	0	0	7	0	0
19	24596665	.	C	T	4	4	8	0	0	8	0	0
19	24596725	.	A	G	5	3	8	0	0	8	0	0
19	24596890	.	G	T	3	2	5	0	0	5	0	0
19	24597055	.	C	A	5	3	8	0	0	8	0	0
19	24597082	.	T	G	6	0	6	0	2	8	0	0
19	24597091	.	C	T	6	2	8	0	0	8	0	0
19	24597217	.	T	A	3	2	5	0	0	5	0	0
19	24757063	.	T	C	2	4	6	0	0	6	0	0
19	24758037	.	G	C	3	6	9	0	0	9	0	0
19	24758040	.	T	G	3	6	9	0	0	9	0	0
19	24882961	.	G	A	9	4	13	0	0	13	0	0
19	24883750	.	G	A	8	2	10	0	1	11	0	0
19	24888024	.	A	G	7	17	24	0	2	26	0	0
19	24888090	.	A	T	19	9	28	0	2	30	0	0
19	24888187	.	C	T	12	15	27	0	4	31	0	0
19	24888195	.	A	T	15	12	27	0	1	28	0	0
19	24888398	.	G	A	2	24	26	0	22	48	0	0
19	24888748	.	T	C	21	20	41	0	7	48	0	0
19	24902408	.	T	C	3	3	6	0	0	6	0	0
19	24906427	.	G	A	0	3	3	0	1	4	0	0
19	24909651	.	T	C	4	4	8	0	0	8	0	0
19	24914462	.	C	T	2	6	8	0	0	8	0	0
19	24914632	.	T	C	3	2	5	0	1	6	0	0
19	24914687	.	G	T	2	3	5	0	0	5	0	0
19	24914737	.	G	A	1	2	3	0	0	3	0	0
19	24914743	.	T	A	0	2	2	0	1	3	0	0
19	24914799	.	T	G	3	2	5	0	1	6	0	0
19	24915403	.	G	A	1	6	7	0	4	11	0	0
19	24915680	.	A	G	5	2	7	0	0	7	0	0
19	24915688	.	C	T	5	2	7	0	0	7	0	0
19	24915742	.	T	A	4	5	9	0	0	9	0	0
19	24915782	.	G	A	0	6	6	0	5	11	0	0
19	24915796	.	A	G	6	6	12	0	0	12	0	0
19	24916007	.	T	G	4	5	9	0	1	10	0	0
19	24916427	.	C	T	5	3	8	0	0	8	0	0
19	24916543	.	A	T	1	3	4	0	1	5	0	0
19	24916766	.	T	G	3	6	9	0	1	10	0	0
19	25089839	.	A	G	10	10	20	0	2	22	0	0
19	25089979	.	A	G	11	11	22	0	2	24	0	0
19	25090032	.	T	G	8	10	18	0	0	18	0	0
19	25090079	.	A	G	8	10	18	0	0	18	0	0
19	25090231	.	T	C	20	10	30	0	1	31	0	0
19	25113207	.	C	A	8	9	17	0	1	18	0	0
19	25113524	.	T	C	17	14	31	0	2	33	0	0
19	25156378	.	T	A	3	3	6	0	0	6	0	0
19	25156453	.	A	G	3	7	10	0	0	10	0	0
19	25156458	.	A	T	3	6	9	0	1	10	0	0
19	25156572	.	C	T	12	9	21	0	0	21	0	0
19	25156639	.	T	C	4	0	4	0	10	14	0	0
19	25156669	.	T	C	7	7	14	0	0	14	0	0
19	25156717	.	A	C	5	9	14	0	1	15	0	0
19	25156774	.	T	A	13	14	27	0	0	27	0	0
19	25156959	.	A	T	14	23	37	0	0	37	0	0
19	25163587	.	G	A	14	13	27	0	1	28	0	0
19	25163633	.	G	T	9	15	24	0	3	27	0	0
19	25169531	.	A	C	3	0	3	0	8	11	0	0
19	25270949	.	A	G	12	11	23	0	0	23	0	0
19	25352327	.	T	C	9	7	16	0	0	16	0	0
19	25352503	.	G	A	10	2	12	0	3	15	0	0
19	25352702	.	A	C	10	5	15	1	1	17	0	0
19	25352789	.	T	C	3	8	11	1	1	13	0	0
19	25352901	.	A	T	18	7	25	0	0	25	0	0
19	25353088	.	A	G	13	14	27	0	1	28	0	0
19	25367246	.	G	A	10	7	17	0	0	17	0	0
19	25367270	.	T	C	11	0	11	0	7	18	0	0
19	25367291	.	C	T	4	5	9	0	11	20	0	0
19	25367414	.	A	C	4	0	4	0	5	9	0	0
19	25370392	.	G	A	6	12	18	0	1	19	0	0
19	25370730	.	C	T	8	10	18	0	0	18	0	0
19	25435364	.	G	A	2	2	4	0	1	5	0	0
19	25435501	.	T	G	4	2	6	0	1	7	0	0
19	25526483	.	G	A	1	4	5	0	6	11	0	0
19	25526529	.	T	C	7	7	14	0	1	15	0	0
19	25548114	.	C	G	7	14	21	0	1	22	0	0
19	25652962	.	C	T	18	17	35	1	3	39	0	0
19	25653042	.	C	T	13	21	34	1	4	39	0	0
19	25653147	.	C	T	10	8	18	0	3	21	0	0
19	25653170	.	G	T	4	6	10	0	7	17	0	0
19	25657306	.	C	A	2	5	7	0	1	8	0	0
19	25660405	.	G	A	6	3	9	0	0	9	0	0
19	25660432	.	C	T	0	2	2	0	3	5	0	0
19	25680169	.	A	T	3	7	10	0	0	10	0	0
19	25680170	.	C	T	4	7	11	0	0	11	0	0
19	25680248	.	A	T	11	7	18	0	0	18	0	0
19	25682029	.	G	A	4	10	14	0	0	14	0	0
19	25682044	.	A	G	9	3	12	0	1	13	0	0
19	25693539	.	T	C	4	5	9	0	0	9	0	0
19	25699903	.	G	A	3	4	7	0	0	7	0	0
19	25699929	.	G	A	2	3	5	0	0	5	0	0
19	25699959	.	C	A	4	1	5	0	1	6	0	0
19	25701161	.	G	A	2	2	4	0	0	4	0	0
19	25755757	.	G	A	2	4	6	0	0	6	0	0
19	26156423	.	C	T	4	3	7	0	0	7	0	0
19	26164906	.	G	A	19	17	36	0	1	37	0	0
19	26235083	.	G	A	8	11	19	0	0	19	0	0
19	26235089	.	C	T	7	9	16	0	3	19	0	0
19	26370720	.	A	T	2	7	9	0	0	9	0	0
19	26375471	.	C	T	10	4	14	0	0	14	0	0
19	26375643	.	T	G	15	7	22	0	1	23	0	0
19	26375699	.	G	T	9	7	16	0	1	17	0	0
19	26377775	.	A	T	3	2	5	0	0	5	0	0
19	26377784	.	T	C	3	1	4	0	0	4	0	0
19	26377946	.	T	A	5	6	11	0	0	11	0	0
19	26378250	.	T	C	3	8	11	0	1	12	0	0
19	26378265	.	G	A	6	6	12	0	1	13	0	0
19	26378285	.	G	A	8	5	13	0	1	14	0	0
19	26378447	.	T	A	4	4	8	0	0	8	0	0
19	26378451	.	G	A	4	3	7	0	1	8	0	0
19	26521070	.	G	A	3	3	6	0	0	6	0	0
19	26623634	.	C	T	2	2	4	0	0	4	0	0
19	26627274	.	G	A	0	2	2	0	2	4	0	0
19	26627680	.	C	T	3	2	5	0	0	5	0	0
19	26628037	.	A	G	1	2	3	0	0	3	0	0
19	26628244	.	C	T	6	2	8	0	0	8	0	0
19	26628279	.	C	T	3	6	9	0	0	9	0	0
19	26628287	.	G	A	2	5	7	0	0	7	0	0
19	26628387	.	G	A	0	3	3	0	2	5	0	0
19	26628980	.	C	A	2	3	5	0	0	5	0	0
19	26640232	.	C	T	2	2	4	0	0	4	0	0
19	26646365	.	C	T	1	2	3	0	0	3	0	0
19	26657193	.	T	C	5	3	8	0	0	8	0	0
19	26669225	.	G	A	6	10	16	0	0	16	0	0
19	26669228	.	T	C	6	10	16	0	0	16	0	0
19	26670618	.	A	G	7	0	7	0	8	15	0	0
19	26702349	.	T	A	2	2	4	0	0	4	0	0
19	26706935	.	G	A	2	2	4	0	0	4	0	0
19	26706947	.	C	T	3	2	5	0	0	5	0	0
19	26707384	.	T	C	1	2	3	0	0	3	0	0
19	26710828	.	C	T	3	2	5	0	1	6	0	0
19	26710899	.	T	A	1	3	4	0	0	4	0	0
19	26711151	.	A	T	3	1	4	0	0	4	0	0
19	26711397	.	G	A	6	3	9	0	0	9	0	0
19	26711447	.	G	A	8	3	11	0	0	11	0	0
19	26711534	.	A	G	5	6	11	0	0	11	0	0
19	26715006	.	A	G	2	0	2	0	8	10	0	0
19	26717511	.	G	T	4	2	6	0	0	6	0	0
19	26718261	.	G	C	3	3	6	0	0	6	0	0
19	26721300	.	C	T	1	4	5	0	0	5	0	0
19	26723474	.	G	C	1	3	4	0	0	4	0	0
19	26723498	.	A	G	2	2	4	0	0	4	0	0
19	26723690	.	G	A	8	7	15	0	0	15	0	0
19	26723705	.	A	T	8	8	16	0	0	16	0	0
19	26727535	.	G	A	2	6	8	0	5	13	0	0
19	26728070	.	G	A	7	6	13	0	1	14	0	0
19	26728079	.	A	C	5	7	12	0	1	13	0	0
19	26729597	.	A	T	9	10	19	0	0	19	0	0
19	26729651	.	T	C	7	12	19	0	0	19	0	0
19	26729811	.	A	C	4	6	10	0	0	10	0	0
19	26729867	.	C	T	8	7	15	2	0	17	0	0
19	26729887	.	T	A	5	8	13	2	2	17	0	0
19	26730073	.	A	T	3	6	9	0	1	10	0	0
19	26730077	.	G	T	7	5	12	0	1	13	0	0
19	26730108	.	A	G	5	0	5	0	9	14	0	0
19	26730545	.	C	T	15	21	36	0	1	37	0	0
19	26730642	.	T	C	22	3	25	0	19	44	0	0
19	26731183	.	C	T	0	25	25	0	6	31	0	0
19	26741296	.	C	G	25	19	44	0	1	45	0	0
19	26741378	.	T	C	25	1	26	0	23	49	0	0
19	26741427	.	G	A	12	23	35	0	6	41	0	0
19	26741831	.	C	T	2	14	16	0	21	37	0	0
19	26741918	.	G	T	14	24	38	0	1	39	0	0
19	26742224	.	T	C	10	7	17	0	0	17	0	0
19	26742321	.	G	A	20	11	31	0	0	31	0	0
19	26742379	.	A	C	11	1	12	0	18	30	0	0
19	26742598	.	A	T	14	18	32	0	1	33	0	0
19	26742716	.	T	A	18	21	39	0	2	41	0	0
19	26742732	.	A	G	16	21	37	0	2	39	0	0
19	26742751	.	C	T	26	21	47	0	1	48	0	0
19	26743295	.	A	T	20	17	37	0	0	37	0	0
19	26743446	.	T	A	27	20	47	0	3	50	0	0
19	26743781	.	G	A	19	19	38	0	1	39	0	0
19	26743808	.	C	T	16	18	34	0	5	39	0	0
19	26743900	.	T	A	13	10	23	0	0	23	0	0
19	26743943	.	C	T	15	11	26	0	2	28	0	0
19	26743984	.	A	G	18	13	31	0	1	32	0	0
19	26744235	.	G	T	14	19	33	0	1	34	0	0
19	26744840	.	C	T	24	10	34	0	1	35	0	0
19	26745392	.	T	A	11	17	28	0	2	30	0	0
19	26746246	.	C	T	12	4	16	0	2	18	0	0
19	26747192	.	C	T	7	10	17	0	2	19	0	0
19	26747682	.	G	A	9	12	21	0	1	22	0	0
19	26747979	.	C	T	14	7	21	0	1	22	0	0
19	26748003	.	T	G	8	8	16	0	0	16	0	0
19	26748158	.	C	T	0	4	4	0	3	7	0	0
19	26748225	.	C	A	5	2	7	0	0	7	0	0
19	26748499	.	G	C	11	0	11	0	6	17	0	0
19	26750310	.	T	C	8	0	8	0	3	11	0	0
19	26756636	.	G	A	7	7	14	0	0	14	0	0
19	26769771	.	A	G	2	2	4	0	0	4	0	0
19	26810460	.	C	T	7	4	11	0	0	11	0	0
19	26813901	.	G	A	7	3	10	0	0	10	0	0
19	26817918	.	T	A	2	3	5	0	0	5	0	0
19	26821825	.	C	T	0	3	3	0	1	4	0	0
19	26822657	.	G	A	1	2	3	0	0	3	0	0
19	26860799	.	T	C	19	1	20	0	17	37	0	0
19	26868876	.	C	T	9	10	19	0	0	20	1	0
19	26868899	.	G	A	12	8	20	0	1	21	0	0
19	26868963	.	A	G	6	5	11	0	1	12	0	0
19	26872741	.	A	G	2	3	5	0	0	5	0	0
19	26872742	.	C	A	2	2	4	0	1	5	0	0
19	26872886	.	T	C	4	0	4	0	12	16	0	0
19	26872898	.	C	T	3	10	13	0	3	16	0	0
19	26873020	.	C	T	8	5	13	0	0	13	0	0
19	26910877	.	T	C	8	0	8	0	3	11	0	0
19	26910991	.	T	C	5	3	8	0	0	8	0	0
19	26925280	.	G	A	10	14	24	0	0	24	0	0
19	26925296	.	T	C	8	14	22	0	2	24	0	0
19	26925526	.	G	A	8	8	16	0	1	17	0	0
19	26928320	.	C	T	10	12	22	1	3	26	0	0
19	26928356	.	A	G	20	10	30	0	2	32	0	0
19	26928399	.	A	C	18	10	28	0	0	28	0	0
19	26931520	.	G	A	8	10	18	0	0	18	0	0
19	26931680	.	T	A	11	7	18	0	0	18	0	0
19	26931730	.	T	A	8	6	14	0	0	14	0	0
19	26931732	.	A	T	6	8	14	0	0	14	0	0
19	26931765	.	G	A	1	7	8	0	2	10	0	0
19	26938030	.	G	A	3	2	5	0	0	5	0	0
19	26938379	.	A	G	1	3	4	0	0	4	0	0
19	26958604	.	G	A	6	3	9	0	0	9	0	0
19	26958687	.	T	G	3	6	9	0	2	11	0	0
19	26967634	.	G	T	9	8	17	0	1	18	0	0
19	26967737	.	A	C	13	6	19	0	0	19	0	0
19	26967780	.	C	T	11	7	18	0	0	18	0	0
19	26967783	.	T	G	7	7	14	0	1	15	0	0
19	27043887	.	A	G	12	14	26	0	1	27	0	0
19	27073262	.	A	G	6	4	10	0	1	11	0	0
19	27195604	.	A	G	2	3	5	0	0	5	0	0
19	27260458	.	A	C	5	0	5	0	5	10	0	0
19	27283342	.	C	G	9	5	14	0	0	14	0	0
19	27283472	.	A	T	12	5	17	0	0	17	0	0
19	27283557	.	C	A	8	7	15	0	0	15	0	0
19	27283612	.	A	G	5	4	9	0	1	10	0	0
19	27283783	.	G	C	6	5	11	0	0	11	0	0
19	27283940	.	C	T	9	8	17	0	0	17	0	0
19	27284178	.	G	A	11	6	17	0	0	17	0	0
19	27284195	.	T	G	8	7	15	0	0	15	0	0
19	27284387	.	A	G	9	6	15	0	1	16	0	0
19	27284741	.	C	T	6	6	12	0	0	12	0	0
19	27284744	.	C	T	6	4	10	0	1	11	0	0
19	27284817	.	A	C	12	10	22	0	1	23	0	0
19	27284957	.	G	A	6	5	11	0	1	12	0	0
19	27285085	.	T	C	5	0	5	0	12	17	0	0
19	27286084	.	A	C	1	3	4	0	0	4	0	0
19	27286354	.	C	T	1	2	3	0	0	3	0	0
19	27286390	.	G	T	3	1	4	0	1	5	0	0
19	27286406	.	C	T	3	2	5	0	1	6	0	0
19	27286590	.	G	C	2	0	2	0	6	8	0	0
19	27286813	.	G	A	3	3	6	0	0	6	0	0
19	27286818	.	C	T	3	3	6	0	0	6	0	0
19	27286940	.	C	T	3	2	5	0	0	5	0	0
19	27286966	.	A	T	2	2	4	0	0	4	0	0
19	27287204	.	T	C	7	6	13	0	0	13	0	0
19	27287294	.	T	G	8	8	16	0	1	17	0	0
19	27287492	.	T	A	5	5	10	0	0	10	0	0
19	27307583	.	G	A	5	3	8	0	1	9	0	0
19	27314273	.	T	C	5	2	7	0	0	7	0	0
19	27314393	.	C	G	5	10	15	0	0	15	0	0
19	27314624	.	C	T	3	4	7	0	0	7	0	0
19	27321573	.	C	G	13	10	23	0	1	24	0	0
19	27321615	.	A	G	9	8	17	0	1	18	0	0
19	27321843	.	G	A	4	3	7	0	0	7	0	0
19	27331814	.	T	C	5	2	7	0	0	7	0	0
19	27334273	.	A	T	6	9	15	0	1	16	0	0
19	27345887	.	G	A	1	2	3	0	0	3	0	0
19	27351218	.	G	A	8	5	13	0	1	14	0	0
19	27354331	.	C	A	8	5	13	0	1	14	0	0
19	27357250	.	C	A	11	7	18	0	0	18	0	0
19	27357485	.	A	T	10	8	18	0	3	21	0	0
19	27368719	.	T	C	4	5	9	0	0	9	0	0
19	27368870	.	A	G	2	3	5	0	1	6	0	0
19	27369089	.	C	T	1	2	3	0	0	3	0	0
19	27369504	.	G	A	1	2	3	0	0	3	0	0
19	27369553	.	T	C	4	5	9	0	0	9	0	0
19	27369613	.	T	C	4	0	4	0	3	7	0	0
19	27369853	.	T	A	6	6	12	0	0	12	0	0
19	27369971	.	A	C	1	6	7	0	0	7	0	0
19	27370197	.	C	A	5	3	8	0	0	8	0	0
19	27370232	.	C	A	5	6	11	0	0	11	0	0
19	27370273	.	C	T	0	2	2	0	4	6	0	0
19	27370380	.	C	T	0	2	2	0	1	3	0	0
19	27370662	.	C	T	0	2	2	0	2	4	0	0
19	27370682	.	G	A	2	2	4	0	0	4	0	0
19	27370774	.	A	T	5	2	7	0	0	7	0	0
19	27370805	.	C	T	0	2	2	0	2	4	0	0
19	27370827	.	C	T	0	2	2	0	2	4	0	0
19	27395471	.	A	T	2	2	4	0	0	4	0	0
19	27401412	.	G	A	9	5	14	0	0	14	0	0
19	27401515	.	C	T	6	11	17	0	0	17	0	0
19	27401680	.	G	A	5	6	11	0	0	11	0	0
19	27415248	.	G	A	8	7	15	0	0	15	0	0
19	27422029	.	G	A	2	3	5	0	0	5	0	0
19	27430422	.	G	T	3	3	6	0	0	6	0	0
19	27430455	.	G	A	1	2	3	0	0	3	0	0
19	27440899	.	A	T	1	3	4	0	2	6	0	0
19	27445369	.	A	G	3	2	5	0	0	5	0	0
19	27457166	.	T	C	11	0	11	0	9	20	0	0
19	27457213	.	T	C	8	13	21	0	2	23	0	0
19	27457505	.	G	T	10	9	19	0	0	19	0	0
19	27457516	.	T	G	8	8	16	0	1	17	0	0
19	27457607	.	C	T	6	3	9	0	1	10	0	0
19	27457621	.	T	A	4	6	10	0	0	10	0	0
19	27457749	.	C	T	6	5	11	0	1	12	0	0
19	27457892	.	T	C	6	7	13	0	2	15	0	0
19	27457989	.	T	A	2	10	12	0	1	13	0	0
19	27461139	.	C	T	0	5	5	0	5	10	0	0
19	27461183	.	C	T	8	11	19	0	0	19	0	0
19	27461560	.	C	T	2	7	9	0	12	21	0	0
19	27462012	.	T	C	6	5	11	0	0	11	0	0
19	27462092	.	A	T	3	6	9	0	0	9	0	0
19	27464010	.	A	G	1	4	5	0	0	5	0	0
19	27464012	.	T	C	1	3	4	0	1	5	0	0
19	27465119	.	G	A	5	3	8	0	0	8	0	0
19	27466189	.	C	G	17	15	32	0	1	33	0	0
19	27468598	.	G	A	18	22	40	0	0	40	0	0
19	27468606	.	C	T	14	18	32	0	5	37	0	0
19	27468983	.	A	C	15	11	26	5	3	35	1	0
19	27469060	.	C	G	1	6	7	0	15	22	0	0
19	27469137	.	A	T	13	0	13	0	0	13	0	0
19	27469178	.	A	C	15	11	26	0	2	28	0	0
19	27469184	.	G	A	17	11	28	0	0	28	0	0
19	27469224	.	A	C	8	4	12	0	0	12	0	0
19	27505191	.	G	A	1	9	10	0	13	23	0	0
19	27505211	.	G	A	14	4	18	0	2	20	0	0
19	27505962	.	G	T	7	6	13	0	0	13	0	0
19	27522973	.	G	A	1	2	3	0	0	3	0	0
19	27540538	.	A	G	1	2	3	0	0	3	0	0
19	27609998	.	C	T	11	12	23	0	2	25	0	0
19	27616055	.	C	T	16	13	29	0	1	30	0	0
19	27616337	.	G	A	13	15	28	0	0	28	0	0
19	27623285	.	C	T	6	6	12	0	2	14	0	0
19	27634823	.	C	T	10	6	16	0	0	16	0	0
19	27814159	.	A	T	1	1	2	0	2	4	0	0
19	28281242	.	T	A	2	3	5	0	1	6	0	0
19	28281343	.	G	A	18	15	33	0	4	37	0	0
19	28281351	.	T	G	24	15	39	0	2	41	0	0
19	28283749	.	C	T	4	30	34	1	24	59	0	0
19	28283786	.	C	T	33	23	56	0	2	58	0	0
19	28284146	.	T	A	9	6	15	0	0	15	0	0
19	28284203	.	A	T	23	18	41	0	1	42	0	0
19	28284220	.	T	A	21	11	32	0	3	35	0	0
19	28288148	.	C	T	14	15	29	0	0	30	1	0
19	28288480	.	G	A	12	12	24	0	1	25	0	0
19	28288489	.	C	T	12	11	23	0	0	23	0	0
19	28288656	.	T	C	2	2	4	0	0	4	0	0
19	28289692	.	T	C	2	2	4	0	0	4	0	0
19	28359920	.	G	A	11	9	20	0	3	23	0	0
19	28360028	.	T	G	20	17	37	0	1	38	0	0
19	28360029	.	C	T	20	17	37	0	2	39	0	0
19	28787154	.	C	T	19	16	35	0	2	37	0	0
19	28788220	.	A	G	17	14	31	0	2	33	0	0
19	28788430	.	T	A	16	20	36	0	2	38	0	0
19	28802039	.	A	G	6	3	9	0	0	9	0	0
19	28802469	.	G	A	3	2	5	0	0	5	0	0
19	28802487	.	G	T	2	3	5	0	1	6	0	0
19	28802954	.	C	A	18	14	32	0	4	36	0	0
19	28803173	.	G	A	25	26	51	0	1	52	0	0
19	28803267	.	G	A	3	22	25	1	15	41	0	0
19	28820643	.	C	T	15	20	35	0	0	35	0	0
19	28821230	.	G	A	7	15	22	0	0	22	0	0
19	28821333	.	G	A	0	13	13	0	16	29	0	0
19	28821334	.	G	T	14	13	27	0	2	29	0	0
19	28821383	.	A	C	9	3	12	0	2	14	0	0
19	28821666	.	G	C	18	17	35	0	2	37	0	0
19	28822057	.	T	C	12	12	24	0	0	24	0	0
19	28822187	.	C	T	10	20	30	0	1	31	0	0
19	28822521	.	A	G	7	3	10	0	1	11	0	0
19	28822794	.	A	T	2	3	5	0	0	5	0	0
19	28823124	.	C	T	3	5	8	0	1	9	0	0
19	28823162	.	T	C	3	6	9	0	0	9	0	0
19	28823987	.	C	G	4	4	8	0	0	8	0	0
19	29298102	.	A	T	2	2	4	0	0	4	0	0
19	29298866	.	C	A	1	2	3	0	0	3	0	0
19	29301647	.	A	T	2	3	5	0	0	5	0	0
19	29301650	.	C	G	4	2	6	0	0	6	0	0
19	29301708	.	T	C	3	1	4	0	1	6	1	0
19	29301863	.	A	T	2	5	7	0	0	7	0	0
19	29303871	.	A	C	4	4	8	0	0	8	0	0
19	29318861	.	A	C	7	6	13	0	0	13	0	0
19	29327825	.	A	G	6	0	6	0	11	17	0	0
19	29333382	.	C	T	6	4	10	0	0	10	0	0
19	29333418	.	G	T	6	4	10	0	0	10	0	0
19	29333597	.	A	C	2	6	8	0	1	9	0	0
19	29383644	.	C	T	0	10	10	0	10	20	0	0
19	29383675	.	G	C	8	11	19	0	1	20	0	0
19	29799885	.	C	T	36	42	78	0	14	92	0	0
19	29799900	.	T	C	40	39	79	0	8	87	0	0
19	29800229	.	A	G	42	29	71	0	0	71	0	0
19	29812799	.	G	T	2	11	13	0	9	22	0	0
19	29815096	.	T	C	29	23	52	0	2	54	0	0
19	29817914	.	C	G	34	21	55	0	0	55	0	0
19	29818142	.	C	T	34	22	56	0	1	57	0	0
19	29822615	.	C	T	0	11	11	0	14	25	0	0
19	29830215	.	G	A	23	23	46	0	1	47	0	0
19	29832781	.	G	A	6	16	22	3	1	26	0	0
19	29836645	.	T	C	7	0	7	0	5	12	0	0
19	29836821	.	T	G	9	5	14	0	0	14	0	0
19	29837310	.	A	G	3	3	6	0	1	7	0	0
19	29837619	.	T	A	3	1	4	0	3	7	0	0
19	29837705	.	C	T	0	4	4	0	4	8	0	0
19	29837964	.	C	T	14	6	20	0	2	22	0	0
19	29840445	.	C	G	0	6	6	0	3	9	0	0
19	29852666	.	C	T	3	4	7	0	0	7	0	0
19	29861961	.	C	A	3	5	8	0	5	13	0	0
19	29866630	.	C	T	1	7	8	0	10	18	0	0
19	29866882	.	G	A	9	6	15	0	3	18	0	0
19	29872768	.	C	T	0	5	5	0	5	10	0	0
19	29872783	.	C	T	0	4	4	0	4	8	0	0
19	29873369	.	A	G	6	5	11	0	0	11	0	0
19	29875000	.	G	T	1	2	3	0	0	3	0	0
19	29879060	.	G	A	3	2	5	0	0	5	0	0
19	29879063	.	G	A	2	3	5	0	0	5	0	0
19	29879393	.	C	T	1	3	4	0	0	4	0	0
19	30348804	.	G	A	20	12	32	0	4	36	0	0
19	30349310	.	A	T	14	17	31	0	1	32	0	0
19	30349553	.	C	G	0	6	6	0	16	22	0	0
19	30355383	.	T	C	21	16	37	0	1	38	0	0
19	30355907	.	A	T	23	14	37	0	0	37	0	0
19	30391816	.	T	C	1	5	6	0	0	6	0	0
19	30391968	.	G	T	8	4	12	0	0	12	0	0
19	30393919	.	C	A	5	5	10	0	3	13	0	0
19	30393967	.	T	C	15	6	21	0	1	22	0	0
19	30396690	.	T	C	16	18	34	0	1	35	0	0
19	30398700	.	A	C	1	4	5	0	1	6	0	0
19	30410406	.	A	G	18	21	39	0	1	40	0	0
19	30410519	.	C	A	12	5	17	0	1	18	0	0
19	30413354	.	G	A	24	13	37	0	1	38	0	0
19	30416170	.	T	C	12	0	12	0	8	20	0	0
19	30423199	.	A	T	6	5	11	0	0	11	0	0
19	30423209	.	A	G	6	6	12	0	0	12	0	0
19	30423366	.	A	G	5	5	10	0	0	10	0	0
19	30423368	.	G	A	6	5	11	0	0	11	0	0
19	30425616	.	G	T	9	11	20	0	1	21	0	0
19	30425622	.	T	C	9	13	22	0	0	22	0	0
19	30426436	.	C	A	12	9	21	0	0	21	0	0
19	30428688	.	A	C	11	8	19	0	1	20	0	0
19	30428726	.	A	G	8	0	8	0	10	18	0	0
19	30429063	.	G	A	6	6	12	0	0	12	0	0
19	30432697	.	A	G	9	9	18	0	2	20	0	0
19	30432742	.	G	A	16	11	27	0	0	27	0	0
19	30436629	.	G	A	10	8	18	0	2	20	0	0
19	30436891	.	G	A	9	9	18	0	0	18	0	0
19	30438518	.	A	G	6	3	9	0	0	9	0	0
19	30441396	.	A	G	2	5	7	0	1	8	0	0
19	30441399	.	A	G	3	5	8	0	0	8	0	0
19	30442717	.	C	A	8	6	14	0	0	14	0	0
19	30445915	.	C	A	5	6	11	0	0	11	0	0
19	30445927	.	A	G	4	5	9	0	1	10	0	0
19	30446181	.	T	A	6	7	13	0	1	14	0	0
19	30446552	.	T	C	6	8	14	0	0	14	0	0
19	30446567	.	G	T	7	6	13	0	0	13	0	0
19	30447533	.	C	T	4	4	8	0	0	8	0	0
19	30450234	.	T	C	1	2	3	0	0	3	0	0
19	30450375	.	C	T	7	4	11	0	1	12	0	0
19	30455640	.	T	C	5	5	10	0	2	12	0	0
19	30455650	.	T	C	7	4	11	0	0	11	0	0
19	30455675	.	T	C	11	1	12	0	2	14	0	0
19	30457770	.	A	T	6	7	13	0	4	17	0	0
19	30458039	.	C	A	6	12	18	0	2	20	0	0
19	30458103	.	G	A	1	12	13	0	8	21	0	0
19	30521443	.	C	A	4	2	6	0	3	9	0	0
19	30589376	.	T	G	3	0	3	0	6	9	0	0
19	32050593	.	A	T	12	13	25	0	2	27	0	0
19	32149988	.	A	C	11	12	23	0	0	23	0	0
19	32167216	.	T	C	14	10	24	0	0	24	0	0
19	32169087	.	T	G	1	0	1	0	3	4	0	0
19	32169089	.	A	G	1	0	1	0	3	4	0	0
19	32202111	.	G	A	1	2	3	0	0	3	0	0
19	32202141	.	G	A	1	2	3	0	0	3	0	0
19	32202179	.	A	C	1	2	3	0	0	3	0	0
19	32457087	.	G	T	4	2	6	0	0	6	0	0
19	32457264	.	C	G	5	3	8	0	0	8	0	0
19	32457390	.	T	C	2	3	5	0	0	5	0	0
19	32458152	.	C	T	3	2	5	0	0	5	0	0
19	32458158	.	T	C	2	2	4	0	1	5	0	0
19	32461473	.	C	T	1	6	7	0	0	7	0	0
19	32473399	.	A	G	2	4	6	0	0	6	0	0
19	32473451	.	G	A	2	3	5	0	0	5	0	0
19	32473770	.	C	T	5	5	10	0	1	11	0	0
19	32473812	.	C	T	4	4	8	0	0	8	0	0
19	32473936	.	C	T	1	4	5	0	6	11	0	0
19	32474031	.	T	G	2	3	5	0	0	5	0	0
19	32474042	.	C	A	2	2	4	0	0	4	0	0
19	32474181	.	G	T	1	4	5	0	0	5	0	0
19	32474193	.	G	T	1	5	6	0	0	6	0	0
19	32474723	.	G	T	1	1	2	0	1	3	0	0
19	32474885	.	A	G	5	5	10	0	0	10	0	0
19	32475348	.	A	G	4	2	6	0	0	6	0	0
19	32489056	.	G	A	1	2	3	0	0	3	0	0
19	32497388	.	C	T	6	8	14	0	1	15	0	0
19	32499736	.	G	A	4	6	10	0	0	10	0	0
19	32499983	.	G	A	4	4	8	0	0	8	0	0
19	32500236	.	T	C	5	2	7	0	0	7	0	0
19	32500269	.	G	A	4	4	8	0	0	8	0	0
19	32505825	.	C	T	3	7	10	0	0	10	0	0
19	32505846	.	C	A	3	6	9	0	3	12	0	0
19	32505875	.	C	T	0	5	5	0	7	12	0	0
19	32505927	.	G	T	3	3	6	0	0	6	0	0
19	32515377	.	T	A	5	5	10	0	2	12	0	0
19	32572647	.	T	C	11	6	17	0	1	18	0	0
19	32572999	.	A	T	7	5	12	0	0	12	0	0
19	32573001	.	T	A	7	5	12	0	0	12	0	0
19	32573057	.	G	A	8	6	14	0	0	14	0	0
19	32573064	.	C	T	9	6	15	0	0	15	0	0
19	32573100	.	C	A	4	3	7	0	1	8	0	0
19	32573173	.	T	C	8	0	8	0	10	18	0	0
19	32573193	.	A	G	5	9	14	0	1	15	0	0
19	32573229	.	A	G	10	7	17	0	1	18	0	0
19	32573269	.	T	C	14	7	21	0	0	21	0	0
19	32575190	.	G	A	9	11	20	0	0	20	0	0
19	32588706	.	C	T	5	3	8	0	0	8	0	0
19	32588775	.	G	A	4	5	9	0	2	11	0	0
19	32600206	.	C	G	1	2	3	0	1	4	0	0
19	32600395	.	T	A	1	2	3	0	0	3	0	0
19	32600644	.	C	T	0	5	5	0	5	10	0	0
19	32600720	.	A	C	3	4	7	0	0	7	0	0
19	32623251	.	T	C	3	1	4	0	0	4	0	0
19	32623259	.	G	A	3	2	5	0	1	6	0	0
19	32623687	.	G	A	17	31	48	0	2	50	0	0
19	32624048	.	A	C	22	17	39	0	2	41	0	0
19	32624138	.	G	A	16	27	43	0	0	43	0	0
19	32624247	.	A	G	21	23	44	0	0	44	0	0
19	32638212	.	G	A	21	24	45	0	2	47	0	0
19	32767799	.	T	C	2	0	2	0	3	5	0	0
19	32767889	.	A	G	3	3	6	0	1	7	0	0
19	32767891	.	T	A	4	3	7	0	0	7	0	0
19	32767965	.	C	T	2	5	7	0	0	7	0	0
19	32768397	.	C	G	5	5	10	0	0	10	0	0
19	32768434	.	T	C	4	6	10	0	0	10	0	0
19	32768551	.	C	T	4	3	7	0	0	7	0	0
19	32768668	.	T	C	0	6	6	0	1	7	0	0
19	32768880	.	G	T	2	3	5	0	0	5	0	0
19	32768935	.	T	G	2	6	8	0	0	8	0	0
19	32768954	.	A	C	3	6	9	0	0	9	0	0
19	32768985	.	G	A	2	6	8	0	0	8	0	0
19	32769271	.	G	T	2	3	5	0	0	5	0	0
19	32769296	.	T	C	3	4	7	0	0	7	0	0
19	32773651	.	A	G	1	2	3	0	0	3	0	0
19	32804432	.	T	C	1	2	3	0	0	3	0	0
19	32807301	.	A	T	2	3	5	0	0	5	0	0
19	32807915	.	A	G	2	4	6	0	1	7	0	0
19	32807933	.	A	C	2	2	4	0	0	4	0	0
19	32808140	.	C	T	2	4	6	0	0	6	0	0
19	32808332	.	G	T	0	3	3	0	5	8	0	0
19	32814334	.	G	T	7	5	12	0	2	14	0	0
19	32818503	.	G	T	0	5	5	0	8	13	0	0
19	32818824	.	A	G	8	14	22	0	0	22	0	0
19	32818825	.	G	A	7	14	21	0	1	22	0	0
19	32818910	.	G	A	1	4	5	0	3	8	0	0
19	32819234	.	G	A	9	12	21	0	2	23	0	0
19	32819303	.	T	C	14	13	27	0	0	27	0	0
19	32819347	.	C	T	12	14	26	0	2	28	0	0
19	32819640	.	A	G	9	6	15	0	0	15	0	0
19	32819703	.	C	A	6	3	9	0	0	9	0	0
19	32819760	.	A	T	5	5	10	1	0	11	0	0
19	32819798	.	C	T	3	4	7	0	1	8	0	0
19	32819952	.	T	C	4	5	9	0	2	11	0	0
19	32838396	.	T	A	7	10	17	0	1	18	0	0
19	32864963	.	T	G	15	16	31	0	0	31	0	0
19	32865113	.	G	A	18	12	30	3	1	34	0	0
19	32865276	.	A	T	9	11	20	0	1	21	0	0
19	32865337	.	C	A	12	10	22	0	3	25	0	0
19	32865347	.	C	T	13	12	25	0	1	26	0	0
19	32865631	.	T	C	9	2	11	0	1	12	0	0
19	32865632	.	G	T	9	3	12	0	0	12	0	0
19	32866126	.	A	C	14	14	28	0	1	29	0	0
19	32866234	.	T	G	10	7	17	0	2	19	0	0
19	32866264	.	G	C	14	0	14	0	8	22	0	0
19	32866322	.	A	G	12	8	20	0	0	20	0	0
19	32866362	.	T	A	10	8	18	0	1	19	0	0
19	32866372	.	C	T	9	5	14	0	2	16	0	0
19	32866475	.	T	A	18	12	30	0	1	31	0	0
19	32866570	.	T	A	23	10	33	0	0	33	0	0
19	32866571	.	A	G	23	9	32	0	1	33	0	0
19	32866620	.	G	A	11	7	18	0	0	18	0	0
19	32867218	.	G	A	12	9	21	0	0	21	0	0
19	32867274	.	A	T	12	14	26	0	5	31	0	0
19	32872674	.	A	G	20	11	31	0	0	31	0	0
19	32878103	.	G	A	14	16	30	0	0	30	0	0
19	32878370	.	A	G	15	9	24	0	0	24	0	0
19	32884181	.	A	G	4	4	8	0	0	8	0	0
19	32895748	.	G	T	14	15	29	0	0	29	0	0
19	32895873	.	T	A	2	10	12	0	7	19	0	0
19	32896001	.	G	A	10	6	16	0	1	17	0	0
19	32896174	.	A	T	2	5	7	0	0	7	0	0
19	32896336	.	G	T	4	8	12	3	4	19	0	0
19	32896427	.	C	A	0	12	12	0	13	25	0	0
19	32896499	.	T	G	16	11	27	0	0	27	0	0
19	32896519	.	T	C	15	9	24	0	0	24	0	0
19	32899313	.	T	A	9	8	17	0	3	20	0	0
19	32899328	.	T	A	13	8	21	0	0	21	0	0
19	32899452	.	A	G	17	8	25	0	1	26	0	0
19	32907732	.	A	C	9	8	17	0	0	17	0	0
19	32916614	.	T	C	1	4	5	0	0	5	0	0
19	32918241	.	T	A	24	4	28	0	1	29	0	0
19	32918807	.	T	C	16	8	24	0	0	24	0	0
19	32928367	.	A	T	9	5	14	0	4	18	0	0
19	32928446	.	T	C	9	0	9	0	5	14	0	0
19	32931100	.	A	T	27	15	42	0	2	44	0	0
19	32931101	.	C	T	2	15	17	0	28	45	0	0
19	32933891	.	C	A	32	25	57	0	4	61	0	0
19	32935480	.	G	C	30	26	56	0	1	57	0	0
19	32936989	.	T	C	31	23	54	1	2	57	0	0
19	32937663	.	C	A	31	18	49	0	3	52	0	0
19	32944034	.	A	G	10	16	26	0	0	26	0	0
19	32951040	.	G	C	9	11	20	0	0	20	0	0
19	32954310	.	A	G	7	8	15	0	1	16	0	0
19	32979625	.	A	G	8	9	17	0	1	18	0	0
19	33029392	.	C	T	4	6	10	0	0	10	0	0
19	33029423	.	C	T	5	4	9	0	0	9	0	0
19	33029452	.	A	G	6	4	10	0	1	11	0	0
19	33029587	.	T	C	7	5	12	0	0	12	0	0
19	33043458	.	A	G	7	8	15	0	0	15	0	0
19	33043749	.	T	C	7	3	10	0	0	10	0	0
19	33061247	.	C	T	6	9	15	0	0	15	0	0
19	33066783	.	C	G	14	0	14	0	18	32	0	0
19	33071055	.	C	G	12	10	22	0	0	22	0	0
19	33071126	.	G	T	15	12	27	0	1	28	0	0
19	33071172	.	G	T	11	10	21	0	0	21	0	0
19	33071249	.	G	C	8	9	17	0	0	17	0	0
19	33071635	.	A	T	3	4	7	0	0	7	0	0
19	33071795	.	A	T	8	18	26	0	3	29	0	0
19	33086794	.	A	G	2	2	4	0	0	4	0	0
19	33095789	.	T	C	5	2	7	0	0	7	0	0
19	33106035	.	G	C	2	2	4	0	0	4	0	0
19	33106333	.	G	A	0	7	7	1	5	13	0	0
19	33124700	.	A	T	5	8	13	0	0	13	0	0
19	33127718	.	T	C	8	7	15	2	1	18	0	0
19	33131666	.	C	T	22	10	32	0	1	33	0	0
19	33132033	.	T	A	11	9	20	0	2	22	0	0
19	33136410	.	A	G	27	0	27	0	29	56	0	0
19	33137436	.	A	G	23	1	24	0	15	39	0	0
19	33137667	.	C	T	4	2	6	0	0	6	0	0
19	33139701	.	C	A	3	2	5	0	0	5	0	0
19	33139827	.	G	A	3	3	6	0	1	7	0	0
19	33140259	.	A	C	4	5	9	0	1	10	0	0
19	33140322	.	T	C	3	3	6	0	0	6	0	0
19	33203048	.	A	T	2	2	4	0	2	6	0	0
19	33203744	.	G	A	10	10	20	0	0	20	0	0
19	33204301	.	A	C	2	4	6	0	0	6	0	0
19	33204317	.	G	A	2	4	6	0	0	6	0	0
19	33205130	.	G	A	3	2	5	0	0	5	0	0
19	33205223	.	T	A	2	2	4	0	0	4	0	0
19	33205255	.	C	G	0	2	2	0	2	4	0	0
19	33205316	.	G	A	1	3	4	0	0	4	0	0
19	33270936	.	T	C	1	0	1	0	3	4	0	0
19	33476598	.	T	C	5	4	9	0	1	10	0	0
19	33512144	.	G	A	2	4	6	0	0	6	0	0
19	33513272	.	G	T	0	2	2	0	2	4	0	0
19	33514118	.	C	T	1	2	3	0	0	3	0	0
19	33701679	.	C	T	7	3	10	0	0	10	0	0
19	33701838	.	G	A	1	5	6	0	4	10	0	0
19	33701887	.	T	A	10	7	17	0	1	18	0	0
19	33701923	.	T	A	9	7	16	0	1	17	0	0
19	33755973	.	G	A	1	9	10	0	6	16	0	0
19	33755985	.	A	G	4	0	4	0	8	12	0	0
19	33756009	.	G	T	6	7	13	0	1	14	0	0
19	33765636	.	C	T	13	14	27	0	4	31	0	0
19	33772226	.	T	A	19	12	31	1	1	33	0	0
19	33772280	.	T	C	17	13	30	0	2	32	0	0
19	33775750	.	C	T	6	9	15	0	2	17	0	0
19	33775810	.	T	C	7	7	14	0	1	15	0	0
19	33782757	.	A	G	7	0	7	0	14	21	0	0
19	33782914	.	A	G	12	12	24	0	0	24	0	0
19	33783332	.	A	T	11	13	24	0	3	27	0	0
19	33784221	.	T	A	5	8	13	0	0	13	0	0
19	33784896	.	T	C	26	10	36	0	0	36	0	0
19	33784897	.	C	T	25	10	35	0	0	35	0	0
19	33784966	.	C	T	22	13	35	0	0	35	0	0
19	33784986	.	T	C	21	12	33	0	3	36	0	0
19	33785094	.	C	T	10	15	25	0	1	26	0	0
19	33785109	.	C	T	14	17	31	0	0	31	0	0
19	33785175	.	G	A	15	12	27	0	1	28	0	0
19	33785197	.	G	A	1	13	14	0	15	29	0	0
19	33785234	.	A	G	14	1	15	0	10	25	0	0
19	33785240	.	T	C	15	9	24	0	1	25	0	0
19	33785357	.	C	A	19	19	38	0	1	39	0	0
19	33785379	.	G	A	21	20	41	0	1	42	0	0
19	33785512	.	T	C	12	24	36	0	1	37	0	0
19	33785704	.	G	T	19	19	38	0	0	38	0	0
19	33785735	.	T	G	19	0	19	0	23	42	0	0
19	34957804	.	T	C	1	2	3	0	0	3	0	0
19	34960099	.	A	G	8	5	13	0	1	14	0	0
19	34960143	.	A	G	7	6	13	0	0	13	0	0
19	34960147	.	G	A	7	6	13	0	1	14	0	0
19	34960190	.	C	G	1	12	13	0	20	33	0	0
19	34960198	.	T	C	20	12	32	0	1	33	0	0
19	34960315	.	T	A	4	9	13	0	1	14	0	0
19	34960558	.	G	A	5	3	8	1	5	14	0	0
19	34960694	.	T	A	4	6	10	0	2	12	0	0
19	34961152	.	C	T	9	15	24	0	0	24	0	0
19	34961269	.	A	G	7	5	12	0	0	12	0	0
19	35002450	.	G	A	4	3	7	0	0	7	0	0
19	35002527	.	G	A	0	5	5	0	4	9	0	0
19	35004117	.	A	C	3	8	11	0	0	11	0	0
19	35004135	.	C	T	4	5	9	0	0	9	0	0
19	35004868	.	C	A	3	6	9	0	0	9	0	0
19	35004869	.	C	A	3	5	8	0	1	9	0	0
19	35004920	.	G	A	7	7	14	0	0	14	0	0
19	35004941	.	T	C	10	4	14	0	1	15	0	0
19	35005136	.	A	C	7	2	9	0	0	9	0	0
19	35005137	.	A	T	5	2	7	0	0	8	1	0
19	35005318	.	G	A	11	8	19	0	6	25	0	0
19	35007021	.	G	A	1	2	3	0	4	7	0	0
19	35007220	.	G	A	11	15	26	0	1	27	0	0
19	35007235	.	G	A	15	14	29	0	1	30	0	0
19	35013806	.	C	T	27	25	52	0	0	52	0	0
19	35016477	.	C	T	18	17	35	0	3	38	0	0
19	35016553	.	T	G	16	14	30	0	3	34	1	0
19	35016646	.	A	T	26	14	40	0	2	42	0	0
19	35016696	.	T	G	13	14	27	0	2	29	0	0
19	35016835	.	C	T	11	13	24	0	0	24	0	0
19	35019490	.	T	A	3	4	7	0	0	7	0	0
19	35019560	.	A	G	1	3	4	0	1	5	0	0
19	35040003	.	G	T	5	11	16	0	1	17	0	0
19	35041158	.	T	A	29	30	59	0	4	63	0	0
19	35041308	.	A	G	32	27	59	1	5	65	0	0
19	35041458	.	T	C	23	0	23	0	32	55	0	0
19	35052411	.	G	T	21	12	33	0	1	34	0	0
19	35052435	.	T	C	19	0	19	0	12	31	0	0
19	35055889	.	A	G	16	14	30	0	0	30	0	0
19	35057860	.	G	T	12	12	24	0	1	25	0	0
19	35057869	.	C	T	12	12	24	0	0	24	0	0
19	35058232	.	T	C	18	12	30	0	2	32	0	0
19	35060217	.	A	C	14	12	26	0	3	29	0	0
19	35065906	.	A	T	9	11	20	0	1	21	0	0
19	35067367	.	G	A	10	11	21	0	1	22	0	0
19	35069299	.	G	T	16	12	28	0	0	28	0	0
19	35069755	.	C	A	18	12	30	0	0	30	0	0
19	35069934	.	T	G	10	10	20	0	1	21	0	0
19	35070015	.	C	T	12	8	20	0	0	20	0	0
19	35072613	.	A	C	19	12	31	0	0	31	0	0
19	35072712	.	G	C	11	2	13	0	5	18	0	0
19	35075637	.	C	T	3	6	9	0	13	22	0	0
19	35076301	.	C	T	1	7	8	0	8	16	0	0
19	35076773	.	G	A	8	10	18	0	0	18	0	0
19	35078584	.	T	C	10	1	11	0	10	21	0	0
19	35078632	.	T	C	11	1	12	0	8	20	0	0
19	35079259	.	C	T	9	6	15	0	1	16	0	0
19	35079515	.	A	T	4	3	7	0	0	7	0	0
19	35083010	.	G	A	5	8	13	0	1	14	0	0
19	35083019	.	C	T	5	9	14	0	0	14	0	0
19	35083182	.	C	T	5	9	14	0	0	14	0	0
19	35116228	.	A	G	5	10	15	0	1	16	0	0
19	35116297	.	T	C	10	6	16	0	0	16	0	0
19	35116405	.	A	G	9	8	17	0	1	18	0	0
19	35116438	.	G	A	5	6	11	0	0	11	0	0
19	35118813	.	G	C	7	6	13	0	0	13	0	0
19	35118842	.	T	C	4	4	8	0	1	9	0	0
19	35118860	.	G	T	6	3	9	0	0	9	0	0
19	35118911	.	C	A	2	4	6	0	0	6	0	0
19	35118983	.	A	T	7	4	11	0	1	12	0	0
19	35119039	.	T	C	5	3	8	0	1	9	0	0
19	35119052	.	A	G	6	3	9	0	1	10	0	0
19	35119082	.	T	C	5	0	5	0	4	9	0	0
19	35119169	.	G	A	5	8	13	0	2	15	0	0
19	35119205	.	G	A	8	6	14	0	0	14	0	0
19	35119436	.	C	T	5	10	15	0	0	15	0	0
19	35121381	.	T	C	4	5	9	0	0	9	0	0
19	35123452	.	A	T	1	4	5	0	0	5	0	0
19	35123508	.	T	C	4	1	5	0	5	10	0	0
19	35128238	.	T	C	8	3	11	0	0	11	0	0
19	35131332	.	G	A	2	5	7	0	1	8	0	0
19	35134092	.	G	T	1	2	3	0	1	4	0	0
19	35134181	.	G	A	3	3	6	0	0	6	0	0
19	35135406	.	C	A	0	5	5	0	3	8	0	0
19	35135711	.	A	G	2	2	4	0	1	5	0	0
19	35135870	.	C	T	1	2	3	0	0	3	0	0
19	35135961	.	A	G	2	3	5	0	0	5	0	0
19	35138260	.	A	G	3	2	5	0	0	5	0	0
19	35155676	.	C	T	2	3	5	0	0	5	0	0
19	35157472	.	A	G	1	3	4	0	1	5	0	0
19	35157621	.	C	T	1	1	2	0	2	4	0	0
19	35159665	.	G	T	5	2	7	0	0	7	0	0
19	35159668	.	G	A	4	2	6	0	0	6	0	0
19	35359341	.	C	T	24	34	58	0	1	59	0	0
19	35379917	.	A	G	2	10	12	0	0	12	0	0
19	35379923	.	G	A	2	10	12	0	0	12	0	0
19	35379998	.	A	G	2	6	8	0	0	8	0	0
19	35380031	.	G	A	5	8	13	0	0	13	0	0
19	35380070	.	G	A	4	6	10	0	0	10	0	0
19	35380168	.	T	C	1	1	2	0	2	4	0	0
19	35386288	.	T	G	2	7	9	0	0	9	0	0
19	35390668	.	T	C	1	2	3	0	0	3	0	0
19	35419026	.	C	T	0	2	2	0	3	5	0	0
19	35419202	.	A	G	4	3	7	0	1	8	0	0
19	35419215	.	T	A	3	3	6	0	2	8	0	0
19	35419292	.	T	A	1	3	4	0	0	4	0	0
19	35419300	.	A	T	1	2	3	0	0	3	0	0
19	35422354	.	T	C	12	14	26	0	0	26	0	0
19	35428735	.	G	A	17	6	23	0	1	24	0	0
19	35459414	.	A	G	21	11	32	0	5	37	0	0
19	35459737	.	G	A	23	26	49	0	1	50	0	0
19	35459801	.	A	T	20	26	46	0	0	46	0	0
19	35473080	.	C	A	2	25	27	0	20	47	0	0
19	35722947	.	T	C	5	4	9	0	0	9	0	0
19	35723040	.	G	T	12	16	28	0	2	30	0	0
19	35723087	.	G	T	24	17	41	0	1	42	0	0
19	35723113	.	G	T	17	21	38	0	1	39	0	0
19	35723214	.	T	C	3	0	3	0	10	13	0	0
19	35723237	.	C	A	5	13	18	0	2	20	0	0
19	35723268	.	A	T	10	15	25	0	2	27	0	0
19	35723289	.	C	A	12	15	27	0	0	27	0	0
19	35723422	.	C	T	8	17	25	0	0	25	0	0
19	35723552	.	C	T	2	15	17	0	13	30	0	0
19	35733351	.	T	C	8	8	16	0	1	17	0	0
19	36115044	.	G	A	2	6	8	0	0	8	0	0
19	36115084	.	C	T	2	12	14	0	1	15	0	0
19	36115100	.	C	T	1	13	14	0	1	15	0	0
19	36115170	.	G	C	2	8	10	0	1	11	0	0
19	36115210	.	G	A	5	11	16	0	2	18	0	0
19	36120265	.	C	T	1	6	7	0	2	9	0	0
19	36167703	.	C	T	1	3	4	0	4	8	0	0
19	36171682	.	T	C	5	0	5	0	5	10	0	0
19	36171778	.	G	A	3	2	5	0	2	7	0	0
19	36212370	.	G	A	1	3	4	0	0	4	0	0
19	36227281	.	G	A	2	3	5	0	0	5	0	0
19	36271838	.	C	T	1	2	3	0	0	3	0	0
19	36374365	.	G	A	1	3	4	0	0	4	0	0
19	37122590	.	A	C	8	4	12	1	0	13	0	0
19	37127483	.	A	T	18	5	23	1	0	24	0	0
19	37133533	.	C	A	4	5	9	0	1	10	0	0
19	37133719	.	G	T	8	6	14	0	1	15	0	0
19	37133872	.	T	C	4	5	9	0	0	9	0	0
19	37133916	.	C	T	2	2	4	0	1	5	0	0
19	37138743	.	C	T	9	10	19	0	0	19	0	0
19	37139266	.	T	C	3	6	9	0	0	9	0	0
19	37481658	.	C	T	3	5	8	0	1	9	0	0
19	37485121	.	C	T	2	2	4	0	0	4	0	0
19	37491605	.	C	A	3	3	6	0	1	7	0	0
19	37491689	.	G	A	3	2	5	0	0	5	0	0
19	37492351	.	G	A	6	5	11	0	1	12	0	0
19	37501738	.	T	C	8	0	8	0	13	21	0	0
19	37501802	.	C	T	13	12	25	0	1	26	0	0
19	37501935	.	A	G	21	22	43	0	2	45	0	0
19	37501959	.	C	T	25	18	43	0	2	45	0	0
19	37502235	.	G	A	32	20	52	0	1	54	1	0
19	37504201	.	G	A	13	10	23	0	0	23	0	0
19	37505790	.	G	A	14	8	22	0	0	22	0	0
19	37505808	.	G	A	9	12	21	0	1	22	0	0
19	37505880	.	C	G	17	23	40	0	0	40	0	0
19	37506405	.	G	A	9	12	21	1	1	23	0	0
19	37506414	.	T	C	9	14	23	1	0	24	0	0
19	37508533	.	G	A	5	7	12	0	1	13	0	0
19	37702120	.	A	G	2	1	3	0	1	4	0	0
19	37799569	.	T	C	2	2	4	0	1	5	0	0
19	37815718	.	C	A	8	6	14	0	0	14	0	0
19	37815733	.	A	G	4	4	8	0	2	10	0	0
19	37815763	.	G	A	7	4	11	0	1	12	0	0
19	37829463	.	A	C	8	4	12	0	0	12	0	0
19	37835433	.	A	C	9	8	17	0	1	18	0	0
19	37835502	.	A	G	4	4	8	0	0	8	0	0
19	37835508	.	T	C	4	4	8	0	0	8	0	0
19	37926003	.	C	T	28	8	36	0	2	38	0	0
19	37926066	.	C	A	34	12	46	0	0	46	0	0
19	37926261	.	C	T	16	21	37	0	1	38	0	0
19	37926267	.	C	A	16	22	38	0	2	40	0	0
19	37926447	.	C	T	17	15	32	0	3	35	0	0
19	37926493	.	C	T	16	9	25	0	3	28	0	0
19	37926637	.	A	G	12	1	13	0	12	25	0	0
19	37926816	.	T	G	27	19	46	0	3	49	0	0
19	38171067	.	G	A	1	2	3	0	1	4	0	0
19	38175219	.	C	T	3	4	7	0	1	8	0	0
19	38176911	.	A	G	2	2	4	0	0	4	0	0
19	38205299	.	T	C	5	5	10	0	0	10	0	0
19	38205350	.	T	C	2	5	7	0	0	7	0	0
19	38216302	.	A	C	9	3	12	0	0	12	0	0
19	38216310	.	C	G	7	0	7	0	4	11	0	0
19	38227086	.	T	G	4	4	8	0	0	8	0	0
19	38240541	.	A	G	7	0	7	0	4	11	0	0
19	38464589	.	C	T	2	2	4	0	0	4	0	0
19	38473901	.	G	T	1	2	3	0	0	3	0	0
19	38475182	.	G	T	1	2	3	0	0	3	0	0
19	38776962	.	A	G	15	4	19	0	2	21	0	0
19	38777235	.	T	C	7	4	11	0	0	11	0	0
19	38793349	.	G	A	3	5	8	0	0	8	0	0
19	40026627	.	A	G	16	18	34	0	1	35	0	0
19	40026661	.	T	C	15	14	29	0	3	32	0	0
19	40027585	.	A	G	17	8	25	0	5	30	0	0
19	40027652	.	C	A	19	13	32	0	0	32	0	0
19	40031164	.	G	A	14	32	46	0	4	50	0	0
19	40039603	.	G	A	7	10	17	0	1	18	0	0
19	40039606	.	T	A	8	10	18	0	1	19	0	0
19	40039651	.	A	T	16	7	23	0	2	25	0	0
19	40052809	.	G	T	13	11	24	0	2	26	0	0
19	40052884	.	G	A	10	12	22	0	0	22	0	0
19	40055365	.	A	T	4	3	7	0	1	8	0	0
19	40071619	.	A	G	1	0	1	0	3	4	0	0
19	40076842	.	C	T	1	5	6	0	0	6	0	0
19	40076845	.	T	C	1	5	6	0	0	6	0	0
19	40099361	.	C	T	4	3	7	0	1	8	0	0
19	40099478	.	G	A	2	3	5	1	1	7	0	0
19	40110897	.	G	A	8	8	16	0	1	17	0	0
19	40113305	.	G	A	0	7	7	0	10	17	0	0
19	40113549	.	T	G	4	8	12	0	0	12	0	0
19	40113555	.	C	T	7	4	11	0	0	11	0	0
19	40113618	.	T	C	4	7	11	0	0	11	0	0
19	40113658	.	G	A	2	13	15	0	0	15	0	0
19	40126647	.	A	G	2	0	2	0	4	6	0	0
19	40129258	.	A	C	2	4	6	0	0	6	0	0
19	40145888	.	G	A	3	3	6	0	0	6	0	0
19	40146214	.	C	T	4	2	6	0	0	6	0	0
19	40146215	.	G	A	2	4	6	0	0	6	0	0
19	40147719	.	C	A	2	7	9	0	0	9	0	0
19	40147782	.	T	C	8	6	14	0	0	15	1	0
19	40147821	.	G	A	0	5	5	0	6	11	0	0
19	40151351	.	C	T	3	2	5	0	0	5	0	0
19	40151970	.	G	A	5	8	13	0	0	13	0	0
19	40151983	.	C	T	9	7	16	0	1	17	0	0
19	40152569	.	G	A	7	3	10	0	0	10	0	0
19	40153024	.	A	T	10	12	22	0	1	23	0	0
19	40154957	.	C	T	8	6	14	0	0	14	0	0
19	40155144	.	C	A	13	9	22	0	0	22	0	0
19	40155327	.	C	T	17	7	24	3	4	31	0	0
19	40156805	.	G	A	2	9	11	0	9	20	0	0
19	40157041	.	T	A	9	8	17	0	0	17	0	0
19	40162945	.	C	A	17	14	31	0	1	32	0	0
19	40163077	.	C	T	20	9	29	0	1	30	0	0
19	40163184	.	C	T	18	10	28	0	2	30	0	0
19	40163223	.	G	A	15	10	25	0	2	27	0	0
19	40177726	.	G	C	2	5	7	0	0	7	0	0
19	40177762	.	T	C	4	3	7	0	0	7	0	0
19	40179916	.	G	C	0	7	7	0	8	15	0	0
19	40180011	.	C	T	7	4	11	0	0	11	0	0
19	40327103	.	T	A	1	1	2	0	0	3	1	0
19	40340319	.	A	G	14	12	26	0	0	26	0	0
19	40343087	.	C	T	24	16	40	0	4	44	0	0
19	40347600	.	T	G	9	1	10	0	20	30	0	0
19	40347702	.	T	A	18	21	39	0	3	42	0	0
19	40347760	.	T	A	14	13	27	0	1	29	1	0
19	40347785	.	A	T	14	11	25	0	2	27	0	0
19	40551964	.	C	T	2	2	4	0	0	4	0	0
19	40551982	.	T	G	4	0	4	0	3	7	0	0
19	40558221	.	C	T	3	6	9	0	0	9	0	0
19	40558281	.	A	G	5	4	9	0	0	9	0	0
19	40641356	.	C	G	4	0	4	0	3	7	0	0
19	40685424	.	C	T	7	8	15	0	1	16	0	0
19	40685447	.	A	G	3	0	3	0	10	13	0	0
19	40685875	.	G	A	4	2	6	0	1	7	0	0
19	40685923	.	T	C	3	5	8	0	0	9	1	0
19	40685935	.	A	G	6	4	10	0	1	11	0	0
19	40686599	.	T	C	4	6	10	0	1	11	0	0
19	40686626	.	A	T	2	4	6	0	1	7	0	0
19	40686662	.	T	A	7	5	12	0	0	12	0	0
19	40716977	.	T	C	2	6	8	0	0	8	0	0
19	40717020	.	C	T	3	4	7	0	0	7	0	0
19	40717649	.	C	A	9	8	17	0	1	18	0	0
19	40731649	.	C	T	5	2	7	0	1	8	0	0
19	40770455	.	G	A	6	4	10	0	0	10	0	0
19	40770527	.	G	A	3	5	8	0	0	8	0	0
19	40773573	.	G	A	6	3	9	0	1	10	0	0
19	40892312	.	T	C	11	8	19	0	1	20	0	0
19	40895763	.	G	A	10	5	15	0	1	16	0	0
19	40895826	.	T	C	10	10	20	0	1	21	0	0
19	40898334	.	A	C	10	4	14	0	0	14	0	0
19	40898500	.	G	A	4	4	8	0	1	9	0	0
19	40900059	.	T	A	3	2	5	0	1	6	0	0
19	40900205	.	T	C	7	2	9	0	10	19	0	0
19	40900334	.	C	T	6	2	8	0	1	9	0	0
19	40906097	.	A	C	10	12	22	0	0	22	0	0
19	40906118	.	T	A	8	8	16	0	1	18	1	0
19	41002111	.	G	T	2	2	4	1	2	7	0	0
19	41021048	.	T	C	8	8	16	0	0	16	0	0
19	41033811	.	G	A	3	16	19	0	16	35	0	0
19	41038728	.	T	A	2	2	4	0	0	4	0	0
19	41038855	.	C	T	14	22	36	0	0	36	0	0
19	41160939	.	A	G	3	2	5	0	0	5	0	0
19	42843640	.	A	G	4	0	4	0	4	8	0	0
19	42843845	.	A	G	9	9	18	0	1	19	0	0
19	42843859	.	A	G	15	8	23	0	0	23	0	0
19	42843894	.	A	G	13	9	22	0	1	23	0	0
19	42844126	.	A	G	6	4	10	0	0	10	0	0
19	43900995	.	A	G	9	9	18	0	2	20	0	0
19	43969379	.	A	T	1	1	2	0	2	4	0	0
19	45856295	.	A	G	8	8	16	0	0	16	0	0
19	45859824	.	C	T	23	15	38	1	6	45	0	0
19	45883626	.	C	A	18	11	29	0	2	31	0	0
19	45962080	.	T	G	2	3	5	0	0	5	0	0
19	45962214	.	G	A	3	2	5	0	0	5	0	0
19	45967297	.	C	G	4	0	4	0	7	11	0	0
19	45967306	.	A	T	6	7	13	0	0	13	0	0
19	45967406	.	G	A	5	13	18	0	0	18	0	0
19	45967516	.	A	G	7	1	8	0	5	13	0	0
19	45967623	.	G	T	3	6	9	0	0	9	0	0
19	45979380	.	C	T	13	4	17	0	0	17	0	0
19	45980192	.	A	G	2	3	5	0	0	5	0	0
19	45980323	.	C	T	2	6	8	0	0	8	0	0
19	45980348	.	T	C	4	1	5	0	0	5	0	0
19	45980428	.	A	C	6	3	9	0	0	9	0	0
19	45980618	.	A	C	1	2	3	2	1	6	0	0
19	45996230	.	G	A	1	2	3	0	0	3	0	0
19	46019603	.	G	A	8	5	13	0	2	15	0	0
19	46019616	.	G	T	8	5	13	0	1	14	0	0
19	46019803	.	A	G	20	14	34	0	2	36	0	0
19	46020052	.	C	A	0	3	3	0	0	3	0	0
19	46020067	.	A	T	8	3	11	0	0	11	0	0
19	46020453	.	C	A	17	13	30	0	0	30	0	0
19	46022453	.	C	T	0	15	15	0	10	25	0	0
19	46032793	.	T	G	3	4	7	0	0	7	0	0
19	46032947	.	A	G	3	4	7	0	0	7	0	0
19	46036290	.	G	A	3	5	8	0	0	8	0	0
19	46038800	.	G	A	2	5	7	0	0	7	0	0
19	46122698	.	T	C	2	3	5	0	0	5	0	0
19	46202110	.	G	A	3	3	6	0	0	6	0	0
19	46209433	.	G	A	0	6	6	0	3	9	0	0
19	46209516	.	T	A	1	2	3	0	0	3	0	0
19	46209522	.	A	T	1	2	3	0	0	3	0	0
19	46210054	.	T	G	3	2	5	0	0	5	0	0
19	46210120	.	G	T	3	7	10	0	0	10	0	0
19	46210209	.	A	T	6	3	9	0	0	9	0	0
19	46210242	.	G	C	7	4	11	0	3	14	0	0
19	46210286	.	A	G	6	3	9	0	2	11	0	0
19	46210354	.	A	T	5	4	9	0	0	9	0	0
19	46210355	.	T	G	5	4	9	0	0	9	0	0
19	46210412	.	T	A	2	2	4	1	0	5	0	0
19	46210505	.	G	C	1	2	3	0	0	3	0	0
19	46224575	.	G	A	11	12	23	0	1	24	0	0
19	46225960	.	C	T	13	9	22	0	1	23	0	0
19	46225972	.	G	A	12	12	24	0	0	24	0	0
19	46237787	.	C	T	13	14	27	0	2	29	0	0
19	46237794	.	A	T	11	15	26	0	5	31	0	0
19	46237844	.	G	T	1	14	15	0	15	30	0	0
19	46238199	.	G	A	1	12	13	0	6	19	0	0
19	46238227	.	T	C	8	11	19	0	1	20	0	0
19	46238297	.	T	G	3	13	16	0	0	16	0	0
19	46238366	.	T	C	8	5	13	0	0	13	0	0
19	46238382	.	G	A	2	2	4	0	7	11	0	0
19	46238538	.	C	T	6	3	9	0	0	9	0	0
19	46259649	.	A	G	13	10	23	0	0	23	0	0
19	46259660	.	A	T	15	12	27	0	0	27	0	0
19	46259709	.	G	A	1	16	17	0	16	33	0	0
19	46280672	.	G	T	5	12	17	0	15	32	0	0
19	46280861	.	G	A	1	9	10	0	10	20	0	0
19	46288632	.	T	C	14	15	29	0	2	31	0	0
19	46303140	.	C	T	23	27	50	0	2	52	0	0
19	46303320	.	G	A	23	18	41	0	3	44	0	0
19	46303330	.	G	A	2	18	20	0	27	47	0	0
19	46303414	.	C	T	36	21	57	0	1	58	0	0
19	46303457	.	A	T	38	11	49	0	7	56	0	0
19	46309596	.	T	C	2	3	5	0	0	5	0	0
19	46309664	.	C	A	4	9	13	0	1	14	0	0
19	46309686	.	A	G	4	0	4	0	3	7	0	0
19	46309787	.	G	A	3	3	6	0	1	7	0	0
19	46332910	.	G	A	0	11	11	0	7	18	0	0
19	46373704	.	T	G	14	12	26	0	1	27	0	0
19	46373705	.	G	T	15	10	25	0	2	27	0	0
19	47783403	.	A	G	1	0	1	0	3	4	0	0
19	47976325	.	C	T	25	28	53	0	2	55	0	0
2	19225	.	T	C	37	27	64	0	0	64	0	0
2	19568	.	G	A	22	27	49	0	0	49	0	0
2	21074	.	A	G	26	39	65	0	2	67	0	0
2	21479	.	C	T	1	26	27	0	29	56	0	0
2	108000	.	C	T	5	11	16	0	0	16	0	0
2	108586	.	G	A	1	10	11	0	17	28	0	0
2	109030	.	G	A	16	12	28	0	1	29	0	0
2	109284	.	T	C	7	9	16	0	0	16	0	0
2	136352	.	C	T	6	3	9	0	0	9	0	0
2	136368	.	C	T	4	4	8	0	1	9	0	0
2	136409	.	T	G	8	4	12	0	1	13	0	0
2	136479	.	A	G	6	6	12	0	1	13	0	0
2	137169	.	T	C	6	5	11	0	0	11	0	0
2	138603	.	G	A	6	3	9	0	0	9	0	0
2	138785	.	A	G	5	3	8	0	0	8	0	0
2	141926	.	G	A	5	2	7	0	0	7	0	0
2	146199	.	T	C	3	4	7	0	1	8	0	0
2	177241	.	G	T	10	4	14	1	0	15	0	0
2	177243	.	G	C	11	4	15	1	0	16	0	0
2	374634	.	T	C	6	7	13	0	0	13	0	0
2	1213071	.	C	T	4	3	7	0	0	7	0	0
2	1213640	.	C	T	1	2	3	0	0	3	0	0
2	1220802	.	T	C	7	15	22	0	1	23	0	0
2	1453259	.	G	A	8	14	22	0	1	23	0	0
2	1458357	.	T	C	3	3	6	0	1	7	0	0
2	1465096	.	C	T	3	3	6	0	0	6	0	0
2	1466829	.	G	A	3	6	9	0	1	10	0	0
2	1501029	.	A	G	1	2	3	0	0	3	0	0
2	1504911	.	G	A	2	2	4	0	0	4	0	0
2	1505018	.	T	G	2	2	4	0	0	4	0	0
2	1506632	.	T	C	2	5	7	0	0	7	0	0
2	1506641	.	T	G	2	4	6	0	1	7	0	0
2	1527682	.	C	G	5	2	7	0	0	7	0	0
2	1527828	.	T	C	5	0	5	0	8	13	0	0
2	1529602	.	G	C	7	0	7	0	5	12	0	0
2	1533027	.	T	A	6	3	9	0	2	11	0	0
2	1540611	.	A	C	3	0	3	0	5	8	0	0
2	1543191	.	A	G	3	8	11	0	0	11	0	0
2	1548430	.	T	A	2	2	4	0	1	5	0	0
2	1548470	.	A	C	4	0	4	0	3	7	0	0
2	1569132	.	T	C	4	3	7	0	0	7	0	0
2	1595187	.	C	T	10	5	15	0	1	16	0	0
2	1595330	.	A	G	23	6	29	4	2	35	0	0
2	1595334	.	G	A	19	5	24	4	5	33	0	0
2	1595495	.	C	T	1	10	11	0	11	22	0	0
2	1595524	.	T	G	10	9	19	0	1	20	0	0
2	1595582	.	C	T	2	7	9	0	12	21	0	0
2	1595601	.	A	G	11	11	22	0	0	22	0	0
2	1595696	.	A	G	6	6	12	0	0	12	0	0
2	1595897	.	T	C	10	5	15	0	1	16	0	0
2	1595914	.	T	C	8	8	16	0	0	16	0	0
2	1595945	.	G	C	8	11	19	0	0	19	0	0
2	1596159	.	C	T	2	5	7	0	6	13	0	0
2	1596196	.	T	A	9	7	16	0	1	17	0	0
2	1596282	.	G	T	6	8	14	0	1	15	0	0
2	1596325	.	C	A	1	12	13	0	11	24	0	0
2	1596327	.	C	T	2	12	14	0	10	24	0	0
2	1596424	.	T	A	10	8	18	0	1	19	0	0
2	1596671	.	C	T	2	3	5	0	1	6	0	0
2	1596690	.	T	C	1	4	5	0	0	5	0	0
2	1596758	.	A	G	4	2	6	0	2	8	0	0
2	1596772	.	A	C	6	0	6	0	3	9	0	0
2	1596830	.	C	T	1	10	11	0	6	17	0	0
2	1596908	.	A	T	7	11	18	0	2	20	0	0
2	1597048	.	C	T	6	6	12	0	1	13	0	0
2	1597054	.	A	G	6	7	13	0	0	13	0	0
2	1597084	.	G	A	6	7	13	0	1	14	0	0
2	1597096	.	G	A	6	5	11	0	0	11	0	0
2	1597396	.	A	C	7	7	14	0	0	14	0	0
2	1597413	.	T	C	7	9	16	0	0	16	0	0
2	1597433	.	T	C	9	1	10	0	4	14	0	0
2	1597534	.	T	C	8	0	8	0	7	15	0	0
2	1597588	.	A	G	11	4	15	0	1	16	0	0
2	1597617	.	T	C	8	10	18	0	0	18	0	0
2	1597634	.	T	A	11	8	19	0	2	21	0	0
2	1597658	.	C	T	0	7	7	0	15	22	0	0
2	1598065	.	A	G	2	3	5	0	0	5	0	0
2	1598115	.	C	A	6	4	10	0	0	10	0	0
2	1598124	.	G	A	7	5	12	0	0	12	0	0
2	1598533	.	A	C	9	0	9	0	8	17	0	0
2	1602477	.	C	T	1	4	5	0	4	9	0	0
2	1714808	.	A	G	1	3	4	0	0	4	0	0
2	1771233	.	A	T	3	2	5	0	0	5	0	0
2	1846624	.	A	G	3	3	6	0	1	7	0	0
2	1941054	.	G	A	6	3	9	0	0	9	0	0
2	1942812	.	C	T	6	5	11	0	2	13	0	0
2	1943037	.	A	G	4	0	4	0	13	17	0	0
2	1989937	.	A	C	3	2	5	0	0	5	0	0
2	1990005	.	A	G	3	2	5	0	0	5	0	0
2	1990007	.	A	G	2	0	2	0	2	4	0	0
2	2003525	.	T	C	4	2	6	0	0	6	0	0
2	2005807	.	T	C	4	6	10	0	1	11	0	0
2	2005836	.	T	A	3	3	6	0	0	6	0	0
2	2005844	.	C	A	2	3	5	0	1	6	0	0
2	2005892	.	T	C	2	4	6	0	0	6	0	0
2	2010765	.	T	C	30	0	30	0	27	57	0	0
2	2010945	.	G	C	24	27	51	0	2	53	0	0
2	2011287	.	T	A	14	19	33	0	2	35	0	0
2	2013834	.	C	T	2	12	14	0	18	32	0	0
2	2017450	.	T	C	10	16	26	0	0	26	0	0
2	2025044	.	A	G	7	3	10	0	3	13	0	0
2	2025080	.	T	C	7	7	14	0	1	15	0	0
2	2025175	.	C	A	11	6	17	0	0	17	0	0
2	2025219	.	G	T	8	3	11	0	0	11	0	0
2	2025617	.	A	G	10	9	19	0	0	19	0	0
2	2026068	.	G	A	9	10	19	0	2	21	0	0
2	2026218	.	G	A	5	3	8	0	0	8	0	0
2	2026397	.	T	C	11	5	16	0	0	16	0	0
2	2026475	.	G	T	7	7	14	0	2	16	0	0
2	2045718	.	G	A	1	5	6	0	0	6	0	0
2	2160252	.	C	T	1	2	3	0	0	3	0	0
2	2161269	.	C	T	1	2	3	0	1	4	0	0
2	2161356	.	C	T	2	2	4	0	0	4	0	0
2	2168642	.	T	A	14	15	29	0	3	32	0	0
2	2169353	.	T	C	18	15	33	0	1	34	0	0
2	2172878	.	G	A	2	15	17	0	12	29	0	0
2	2172879	.	T	A	13	15	28	0	1	29	0	0
2	2173317	.	A	T	25	24	49	0	1	50	0	0
2	2248991	.	C	A	3	2	5	0	2	7	0	0
2	2248993	.	C	T	3	2	5	0	2	7	0	0
2	2251501	.	C	T	7	9	16	0	0	16	0	0
2	2256216	.	T	C	5	12	17	0	1	18	0	0
2	2256375	.	C	T	2	6	8	0	0	8	0	0
2	2630212	.	A	G	32	30	62	0	0	62	0	0
2	2633731	.	G	A	30	29	59	1	0	60	0	0
2	2638528	.	C	T	2	28	30	0	23	53	0	0
2	2779408	.	T	C	4	2	6	0	0	6	0	0
2	2785378	.	C	T	9	10	19	0	0	19	0	0
2	2786198	.	T	A	6	13	19	0	1	20	0	0
2	2791168	.	C	T	0	8	8	0	16	24	0	0
2	2792843	.	A	G	12	9	21	0	2	23	0	0
2	2795564	.	C	T	11	4	15	0	0	15	0	0
2	2797105	.	C	T	4	6	10	0	0	10	0	0
2	2805882	.	T	C	5	0	5	0	5	10	0	0
2	2818664	.	G	A	0	3	3	0	1	4	0	0
2	2818818	.	A	G	1	3	4	0	0	4	0	0
2	2849616	.	C	T	2	2	4	0	1	5	0	0
2	2854959	.	C	G	2	3	5	0	0	5	0	0
2	2856851	.	T	A	1	2	3	0	0	3	0	0
2	2857400	.	T	C	3	5	8	0	0	8	0	0
2	2859642	.	C	T	4	4	8	0	0	8	0	0
2	2867344	.	A	G	5	6	11	0	1	12	0	0
2	2869590	.	A	G	3	5	8	0	0	8	0	0
2	2871722	.	T	C	3	2	5	0	1	6	0	0
2	2872180	.	G	T	0	4	4	0	3	7	0	0
2	2872550	.	G	A	6	4	10	0	1	11	0	0
2	2872565	.	A	G	6	7	13	0	2	15	0	0
2	2873531	.	A	G	8	0	8	0	5	13	0	0
2	2873546	.	G	A	10	5	15	0	1	16	0	0
2	2873579	.	T	A	5	6	11	0	0	11	0	0
2	2892531	.	A	G	7	6	13	0	0	13	0	0
2	2894098	.	A	T	11	13	24	0	3	27	0	0
2	2905776	.	G	A	2	5	7	0	0	7	0	0
2	2905812	.	C	G	2	0	2	0	5	7	0	0
2	2905996	.	T	C	6	4	10	0	1	11	0	0
2	2908617	.	A	G	9	1	10	0	6	16	0	0
2	2911877	.	G	T	9	4	13	0	0	13	0	0
2	2911892	.	A	T	10	5	15	0	0	15	0	0
2	2913151	.	C	T	16	13	29	0	0	29	0	0
2	2913161	.	G	A	15	14	29	0	1	30	0	0
2	2916697	.	T	C	8	9	17	0	1	18	0	0
2	2917105	.	T	C	12	15	27	0	1	28	0	0
2	2967440	.	T	G	2	2	4	0	0	4	0	0
2	2967453	.	C	T	2	3	5	0	0	5	0	0
2	2975272	.	G	A	2	3	5	0	0	5	0	0
2	2977237	.	C	A	5	3	8	0	0	8	0	0
2	2987062	.	G	A	6	5	11	0	0	11	0	0
2	2987488	.	A	C	4	3	7	2	0	9	0	0
2	2988214	.	C	T	1	2	3	0	0	3	0	0
2	2988626	.	A	C	1	2	3	1	0	4	0	0
2	3014326	.	G	A	1	3	4	0	0	4	0	0
2	3015975	.	T	C	2	4	6	0	0	6	0	0
2	3020186	.	G	T	1	2	3	0	0	3	0	0
2	3022253	.	G	A	0	4	4	0	4	8	0	0
2	3022607	.	A	T	1	3	4	0	0	4	0	0
2	3026997	.	T	C	11	7	18	0	0	18	0	0
2	3027065	.	T	A	15	4	19	0	1	20	0	0
2	3027066	.	A	T	15	4	19	0	1	20	0	0
2	3027200	.	T	A	13	14	27	0	4	31	0	0
2	3027286	.	G	A	13	16	29	0	0	29	0	0
2	3027383	.	C	T	13	6	19	0	1	20	0	0
2	3027504	.	C	T	16	10	26	0	0	26	0	0
2	3027704	.	C	G	21	14	35	0	0	35	0	0
2	3027765	.	G	T	10	8	18	0	3	21	0	0
2	3027804	.	C	T	1	11	12	0	5	17	0	0
2	3027859	.	T	C	13	1	14	0	14	28	0	0
2	3027862	.	A	G	13	14	27	0	2	29	0	0
2	3027928	.	T	C	6	13	19	0	0	19	0	0
2	3028117	.	A	G	10	8	18	0	0	18	0	0
2	3028156	.	G	T	10	9	19	0	0	19	0	0
2	3028203	.	T	C	12	13	25	0	0	25	0	0
2	3028233	.	C	T	13	11	24	0	2	26	0	0
2	3028270	.	A	T	18	5	23	0	2	25	0	0
2	3028312	.	T	G	15	9	24	0	1	25	0	0
2	3028463	.	G	A	7	11	18	0	2	20	0	0
2	3028558	.	T	C	14	5	19	0	1	20	0	0
2	3028605	.	G	A	10	7	17	0	0	17	0	0
2	3028893	.	A	G	7	8	15	0	0	15	0	0
2	3028908	.	A	T	8	4	12	0	3	15	0	0
2	3029048	.	T	C	5	0	5	0	7	12	0	0
2	3029383	.	T	A	12	6	18	1	1	20	0	0
2	3032707	.	G	A	9	7	16	1	3	20	0	0
2	3032944	.	C	T	4	8	12	0	14	26	0	0
2	3034701	.	T	C	11	0	11	0	9	20	0	0
2	3034704	.	T	A	11	8	19	0	1	20	0	0
2	3034819	.	G	A	14	11	25	0	2	27	0	0
2	3045272	.	C	G	4	2	6	0	1	7	0	0
2	3056627	.	A	G	4	2	6	0	1	7	0	0
2	3056663	.	A	C	8	4	12	0	0	12	0	0
2	3061300	.	A	C	1	2	3	0	0	3	0	0
2	3062181	.	T	G	2	3	5	0	0	5	0	0
2	3062381	.	T	G	1	1	2	0	1	3	0	0
2	3062464	.	C	A	4	4	8	0	0	8	0	0
2	3064922	.	A	G	2	9	11	0	0	11	0	0
2	3064984	.	C	G	4	4	8	0	0	8	0	0
2	3064991	.	T	C	4	4	8	0	0	8	0	0
2	3065155	.	T	C	8	4	12	0	0	12	0	0
2	3065248	.	C	T	7	5	12	0	0	12	0	0
2	3065428	.	C	T	7	9	16	0	0	16	0	0
2	3065451	.	C	T	9	9	18	0	0	18	0	0
2	3065474	.	C	G	5	9	14	0	0	14	0	0
2	3065507	.	C	T	4	4	8	0	1	9	0	0
2	3066074	.	T	A	1	3	4	0	0	4	0	0
2	3066075	.	C	T	1	3	4	0	0	4	0	0
2	3066860	.	A	T	1	3	4	0	1	5	0	0
2	4729279	.	A	T	2	1	3	0	2	5	0	0
2	4729554	.	A	G	8	4	12	0	0	12	0	0
2	4729682	.	A	T	6	7	13	0	1	14	0	0
2	4729798	.	A	T	2	5	7	0	0	7	0	0
2	4729857	.	G	T	4	4	8	0	0	8	0	0
2	4730051	.	T	C	1	3	4	0	0	4	0	0
2	4736978	.	G	A	5	3	8	0	1	9	0	0
2	4737177	.	C	G	8	6	14	0	1	15	0	0
2	4737217	.	G	T	10	3	13	0	0	13	0	0
2	4737350	.	G	T	6	8	14	0	0	14	0	0
2	4737524	.	T	A	1	3	4	0	0	4	0	0
2	4737607	.	G	A	2	5	7	0	0	7	0	0
2	4748043	.	T	C	1	0	1	0	3	4	0	0
2	4748061	.	A	G	3	3	6	0	0	6	0	0
2	4765408	.	G	A	3	2	5	0	0	5	0	0
2	4900650	.	T	C	33	9	42	0	6	48	0	0
2	4900688	.	A	C	20	14	34	0	2	36	0	0
2	4900798	.	T	C	15	31	46	1	0	47	0	0
2	4903760	.	G	A	12	17	29	0	1	30	0	0
2	4907857	.	C	T	13	19	32	0	1	33	0	0
2	4916452	.	G	A	12	9	21	0	0	21	0	0
2	4930730	.	T	C	5	7	12	0	0	12	0	0
2	4948832	.	A	G	12	11	23	0	1	24	0	0
2	4948850	.	G	A	11	10	21	0	0	21	0	0
2	4950607	.	C	T	13	11	24	0	1	25	0	0
2	4956028	.	T	G	6	3	9	0	1	10	0	0
2	4995045	.	C	G	5	11	16	0	0	16	0	0
2	4995084	.	C	T	1	4	5	0	7	12	0	0
2	5014631	.	A	C	6	8	14	0	0	14	0	0
2	5407137	.	A	G	0	3	3	0	1	4	0	0
2	5407489	.	A	G	5	3	8	0	1	9	0	0
2	5544025	.	C	G	3	3	6	0	0	6	0	0
2	5544076	.	T	C	6	0	6	0	4	10	0	0
2	5544261	.	C	G	10	5	15	0	0	15	0	0
2	5546933	.	T	C	5	5	10	0	4	14	0	0
2	5555407	.	C	G	8	4	12	0	0	12	0	0
2	5577647	.	A	G	5	0	5	0	5	10	0	0
2	5578745	.	C	T	9	6	15	0	1	16	0	0
2	5578772	.	C	T	11	9	20	0	0	20	0	0
2	5578820	.	T	A	16	8	24	0	3	27	0	0
2	5578872	.	A	G	11	0	11	0	6	17	0	0
2	5578936	.	A	T	3	8	11	0	0	11	0	0
2	5579111	.	A	G	5	4	9	0	0	9	0	0
2	5579120	.	G	A	1	3	4	0	3	7	0	0
2	5579246	.	A	G	4	9	13	0	0	13	0	0
2	5579276	.	T	C	6	5	11	0	0	11	0	0
2	5579285	.	T	A	6	4	10	0	0	10	0	0
2	5579320	.	T	A	6	2	8	0	1	10	1	0
2	5579325	.	T	C	4	4	8	0	1	9	0	0
2	5579359	.	A	G	5	4	9	3	0	12	0	0
2	5579415	.	G	A	7	7	14	2	0	16	0	0
2	5579721	.	G	A	2	2	4	0	1	5	0	0
2	5579958	.	A	G	8	0	8	0	8	16	0	0
2	5580140	.	G	A	5	10	15	0	0	15	0	0
2	5580249	.	A	G	6	5	11	0	1	12	0	0
2	5580267	.	T	G	9	3	12	0	2	14	0	0
2	5580439	.	T	C	14	13	27	0	1	28	0	0
2	5580510	.	C	T	10	7	17	0	1	18	0	0
2	5580544	.	A	G	9	13	22	0	0	22	0	0
2	5580592	.	C	T	16	13	29	0	0	29	0	0
2	5580644	.	A	G	10	0	10	0	13	23	0	0
2	5580887	.	G	T	4	4	8	7	0	15	0	0
2	5581063	.	G	A	0	5	5	0	7	12	0	0
2	5581073	.	A	G	6	4	10	0	0	10	0	0
2	5581233	.	C	T	6	9	15	0	2	17	0	0
2	5581234	.	G	T	1	10	11	0	6	17	0	0
2	5581482	.	T	A	8	12	20	0	4	24	0	0
2	5581612	.	A	G	9	5	14	0	3	17	0	0
2	5581660	.	T	A	11	5	16	0	0	16	0	0
2	5601282	.	A	T	5	8	13	0	1	14	0	0
2	5621176	.	A	T	8	9	17	0	0	17	0	0
2	5621360	.	C	T	10	6	16	0	0	16	0	0
2	5621394	.	A	C	14	9	23	0	2	25	0	0
2	5644548	.	C	T	11	10	21	0	1	22	0	0
2	5677650	.	C	T	17	14	31	0	1	32	0	0
2	5681049	.	A	C	27	15	42	0	1	43	0	0
2	5681388	.	T	G	10	3	13	0	22	35	0	0
2	5681446	.	T	C	17	9	26	0	1	27	0	0
2	5709579	.	T	C	6	1	7	0	8	15	0	0
2	5709663	.	C	G	10	7	17	0	0	17	0	0
2	5709670	.	T	A	13	7	20	0	0	20	0	0
2	5709746	.	T	A	16	5	21	1	0	22	0	0
2	5709782	.	C	T	9	7	16	0	1	17	0	0
2	5709843	.	C	A	12	7	19	0	0	19	0	0
2	5709850	.	T	G	14	5	19	0	2	21	0	0
2	5711684	.	C	A	17	12	29	0	2	31	0	0
2	5714194	.	A	G	16	6	22	0	0	22	0	0
2	5714303	.	G	T	14	16	30	0	0	30	0	0
2	5714789	.	C	T	12	16	28	0	2	30	0	0
2	5714813	.	C	T	0	8	8	0	15	23	0	0
2	5716793	.	T	C	16	6	22	0	0	22	0	0
2	5721008	.	C	T	1	15	16	0	12	28	0	0
2	5723497	.	A	G	12	8	20	0	0	20	0	0
2	5723515	.	A	G	9	7	16	0	4	20	0	0
2	5735134	.	C	T	2	6	8	0	9	17	0	0
2	5735271	.	G	A	1	2	3	0	0	3	0	0
2	5736158	.	T	C	3	3	6	0	0	6	0	0
2	5736291	.	G	A	7	3	10	0	0	10	0	0
2	5736405	.	G	A	4	3	7	0	1	8	0	0
2	5740418	.	T	A	5	3	8	0	1	9	0	0
2	5740678	.	T	C	5	5	10	0	2	12	0	0
2	5740709	.	A	G	5	5	10	0	1	11	0	0
2	5741110	.	C	G	3	2	5	0	1	6	0	0
2	5741305	.	C	G	6	6	12	0	0	12	0	0
2	5741391	.	A	G	7	6	13	0	0	13	0	0
2	5741400	.	G	C	7	5	12	0	0	12	0	0
2	5741534	.	T	A	1	2	3	0	1	4	0	0
2	5741631	.	A	G	4	5	9	0	0	9	0	0
2	5749335	.	A	G	3	4	7	0	0	7	0	0
2	5749641	.	C	T	0	2	2	0	6	8	0	0
2	5768003	.	C	G	1	2	3	0	0	3	0	0
2	5768011	.	G	A	1	1	2	0	0	2	0	0
2	5775852	.	C	G	1	2	3	0	0	3	0	0
2	5809907	.	C	A	3	2	5	0	0	6	1	0
2	5809911	.	G	A	2	3	5	0	0	5	0	0
2	5811687	.	A	T	1	2	3	0	1	4	0	0
2	5811778	.	T	A	2	9	11	0	0	12	1	0
2	5811868	.	G	A	3	2	5	0	0	5	0	0
2	5811891	.	T	C	1	2	3	0	0	3	0	0
2	5811971	.	T	G	3	2	5	0	0	5	0	0
2	5813681	.	C	T	2	5	7	0	1	8	0	0
2	5813710	.	C	T	5	2	7	0	1	8	0	0
2	5814029	.	T	A	3	4	7	0	0	7	0	0
2	5843880	.	A	T	4	3	7	0	0	7	0	0
2	5843941	.	G	T	3	3	6	0	0	6	0	0
2	5844019	.	T	G	2	5	7	0	1	8	0	0
2	5844113	.	G	A	8	3	11	0	1	12	0	0
2	5844126	.	A	T	5	4	9	0	0	9	0	0
2	5844206	.	G	A	1	3	4	0	2	6	0	0
2	5852823	.	A	T	1	5	6	0	0	6	0	0
2	5856251	.	C	A	4	2	6	0	1	7	0	0
2	5859607	.	G	A	3	2	5	0	0	5	0	0
2	5866850	.	T	A	5	5	10	0	1	11	0	0
2	5866977	.	C	T	8	5	13	0	0	13	0	0
2	5866989	.	G	A	5	6	11	0	0	11	0	0
2	5872950	.	C	T	4	9	13	0	1	14	0	0
2	5873674	.	T	C	3	7	10	0	0	10	0	0
2	5882398	.	A	T	10	3	13	0	0	13	0	0
2	5882441	.	A	G	7	1	8	0	10	18	0	0
2	5882542	.	T	C	8	4	12	0	0	12	0	0
2	5882793	.	A	C	6	10	16	0	1	17	0	0
2	5882799	.	A	G	10	0	10	0	8	18	0	0
2	5883039	.	C	T	7	4	11	0	0	11	0	0
2	5883198	.	G	A	18	9	27	1	2	30	0	0
2	5898829	.	C	T	1	3	4	0	0	4	0	0
2	5898946	.	C	T	2	7	9	0	0	9	0	0
2	5898955	.	C	T	2	7	9	0	0	9	0	0
2	5901537	.	T	C	1	3	4	0	0	4	0	0
2	5909405	.	C	T	3	3	6	0	0	6	0	0
2	5909435	.	C	T	2	5	7	0	0	7	0	0
2	5910120	.	C	G	2	0	2	0	2	4	0	0
2	5919314	.	C	T	10	6	16	0	0	16	0	0
2	5923438	.	G	A	11	8	19	0	1	20	0	0
2	5923640	.	A	T	2	1	3	0	0	3	0	0
2	5923645	.	C	T	2	2	4	0	0	4	0	0
2	5923679	.	G	A	4	4	8	0	0	8	0	0
2	5923759	.	G	C	0	3	3	0	3	6	0	0
2	5923863	.	C	T	8	7	15	0	2	17	0	0
2	5923921	.	T	G	12	6	18	0	0	18	0	0
2	5923943	.	C	T	10	7	17	0	0	17	0	0
2	5923978	.	C	T	5	6	11	0	2	13	0	0
2	5924170	.	T	A	8	3	11	0	0	11	0	0
2	5924207	.	T	C	5	9	14	0	0	14	0	0
2	5934080	.	C	A	7	5	12	4	0	16	0	0
2	5934920	.	G	C	7	13	20	0	0	20	0	0
2	5935219	.	A	T	6	13	19	0	0	19	0	0
2	5935294	.	G	A	11	6	17	0	1	18	0	0
2	5936035	.	T	A	3	8	11	0	0	11	0	0
2	5936038	.	A	G	3	7	10	0	0	10	0	0
2	5936153	.	C	A	0	6	6	0	4	10	0	0
2	5936465	.	G	T	3	8	11	0	0	11	0	0
2	5936476	.	G	C	8	4	12	0	2	14	0	0
2	5936678	.	T	A	11	4	15	0	2	17	0	0
2	5936751	.	T	G	6	6	12	0	0	12	0	0
2	5936910	.	G	A	4	3	7	0	1	8	0	0
2	5936922	.	A	G	4	3	7	0	0	7	0	0
2	5937079	.	T	G	5	2	7	0	0	7	0	0
2	5942155	.	C	T	2	3	5	0	1	6	0	0
2	5942173	.	T	A	5	2	7	0	1	8	0	0
2	6011531	.	G	A	10	8	18	0	1	19	0	0
2	6029769	.	T	A	3	4	7	0	1	8	0	0
2	6034314	.	C	T	1	4	5	0	0	5	0	0
2	6034469	.	C	T	2	3	5	0	0	5	0	0
2	6037004	.	C	A	2	6	8	0	0	8	0	0
2	6039678	.	T	C	1	2	3	0	1	4	0	0
2	6042195	.	T	C	12	7	19	0	2	22	1	0
2	6052179	.	A	T	9	4	13	0	1	14	0	0
2	6052295	.	A	T	6	3	9	0	0	9	0	0
2	6052580	.	T	A	4	5	9	0	0	9	0	0
2	6052932	.	G	A	5	8	13	0	1	14	0	0
2	6054935	.	A	G	9	5	14	0	0	14	0	0
2	6058633	.	G	A	8	4	12	0	0	12	0	0
2	6073604	.	A	T	3	2	5	0	0	5	0	0
2	6073939	.	A	T	1	2	3	0	0	3	0	0
2	6082748	.	T	C	2	11	13	0	0	13	0	0
2	6082752	.	A	C	2	10	12	0	0	12	0	0
2	6087200	.	A	G	6	1	7	0	11	18	0	0
2	6089471	.	T	C	10	3	13	0	0	13	0	0
2	6091653	.	A	G	4	3	7	0	0	7	0	0
2	6091689	.	G	A	0	4	4	0	2	6	0	0
2	6091764	.	A	G	6	0	6	0	3	9	0	0
2	6091876	.	A	T	3	3	6	0	0	6	0	0
2	6107289	.	G	A	12	16	28	2	0	30	0	0
2	6107310	.	A	T	9	15	24	2	2	28	0	0
2	6126753	.	T	A	7	11	18	0	0	18	0	0
2	6126783	.	A	T	8	6	14	0	1	15	0	0
2	6126857	.	T	C	10	16	26	0	1	27	0	0
2	6143912	.	T	C	19	19	38	0	0	38	0	0
2	6144085	.	G	A	2	23	25	0	14	39	0	0
2	6149006	.	T	C	5	10	15	0	0	15	0	0
2	6149220	.	T	G	2	3	5	0	0	5	0	0
2	6186956	.	T	A	5	6	11	0	0	11	0	0
2	6187031	.	G	T	11	6	17	0	1	18	0	0
2	6187138	.	T	C	9	12	21	0	1	22	0	0
2	6191691	.	T	C	9	14	23	0	0	23	0	0
2	6191829	.	C	T	8	9	17	0	0	17	0	0
2	6194151	.	T	C	7	6	13	0	2	15	0	0
2	6196798	.	T	A	4	10	14	0	1	15	0	0
2	6196804	.	A	G	3	0	3	0	11	14	0	0
2	6196858	.	C	A	9	5	14	0	0	14	0	0
2	6258164	.	C	G	1	2	3	0	0	3	0	0
2	6258497	.	G	A	2	5	7	0	0	7	0	0
2	6265929	.	C	A	15	17	32	0	0	32	0	0
2	6266115	.	T	A	17	11	28	0	1	29	0	0
2	6292405	.	T	G	15	13	28	0	0	28	0	0
2	6292416	.	G	C	13	19	32	0	1	33	0	0
2	6292453	.	G	T	13	23	36	0	1	37	0	0
2	6323084	.	C	T	1	4	5	0	4	9	0	0
2	6326226	.	C	T	0	6	6	0	6	12	0	0
2	6334330	.	C	T	0	2	2	0	3	5	0	0
2	6334331	.	G	A	3	2	5	0	0	5	0	0
2	6356072	.	C	T	0	2	2	0	4	6	0	0
2	6373740	.	C	T	2	2	4	0	0	4	0	0
2	6734267	.	A	G	1	3	4	0	0	4	0	0
2	6734356	.	C	A	1	2	3	0	0	3	0	0
2	6734490	.	G	A	4	2	6	0	0	6	0	0
2	6761213	.	C	G	2	4	6	0	0	6	0	0
2	6805112	.	G	A	7	6	13	0	1	14	0	0
2	6886758	.	T	G	7	1	8	0	9	17	0	0
2	6886837	.	G	A	1	7	8	0	12	20	0	0
2	6888679	.	G	A	8	8	16	0	1	17	0	0
2	6926573	.	C	T	4	3	7	0	0	7	0	0
2	6926619	.	C	A	3	5	8	0	0	8	0	0
2	6931552	.	A	G	4	2	6	0	0	6	0	0
2	6948707	.	C	T	8	9	17	0	1	18	0	0
2	6948717	.	T	C	12	8	20	0	2	22	0	0
2	6952460	.	G	A	1	5	6	0	1	7	0	0
2	6952610	.	A	C	4	6	10	0	0	10	0	0
2	6958671	.	A	T	13	10	23	0	2	25	0	0
2	6958677	.	A	T	14	10	24	0	0	24	0	0
2	6958712	.	T	A	10	5	15	0	2	17	0	0
2	7037580	.	C	T	3	4	7	0	1	8	0	0
2	7040253	.	C	T	4	4	8	0	0	8	0	0
2	7042165	.	C	T	4	7	11	0	0	11	0	0
2	7046777	.	C	T	4	2	6	0	0	6	0	0
2	7051164	.	G	A	1	12	13	0	11	24	0	0
2	7056102	.	G	A	8	12	20	1	1	22	0	0
2	7056359	.	G	T	14	8	22	0	0	22	0	0
2	7056417	.	C	T	11	8	19	2	0	21	0	0
2	7056450	.	T	A	8	5	13	7	1	21	0	0
2	7056604	.	A	G	11	0	11	0	6	17	0	0
2	7056610	.	A	G	11	7	18	0	0	18	0	0
2	7056711	.	T	G	15	8	23	0	1	24	0	0
2	7056761	.	G	A	1	11	12	0	12	24	0	0
2	7056763	.	G	A	1	11	12	0	11	23	0	0
2	7057010	.	T	C	16	5	21	0	0	21	0	0
2	7132376	.	C	T	3	3	6	0	0	6	0	0
2	7134386	.	T	C	2	5	7	0	0	7	0	0
2	7137939	.	A	T	5	3	8	0	0	8	0	0
2	7147920	.	G	A	7	3	10	0	1	11	0	0
2	7150075	.	G	T	4	6	10	0	2	12	0	0
2	7150571	.	C	G	11	14	25	0	1	26	0	0
2	7150573	.	A	G	11	14	25	0	0	25	0	0
2	7150790	.	G	C	7	0	7	0	5	12	0	0
2	7150908	.	C	G	7	9	16	0	0	16	0	0
2	7150950	.	A	T	9	5	14	0	0	14	0	0
2	7151148	.	A	G	6	10	16	0	1	17	0	0
2	7151161	.	A	T	6	10	16	0	1	17	0	0
2	7151197	.	C	T	8	6	14	0	1	15	0	0
2	7151392	.	C	A	0	12	12	0	14	27	1	0
2	7151485	.	A	T	12	7	19	0	1	20	0	0
2	7151613	.	A	G	6	4	10	0	0	10	0	0
2	7151647	.	C	G	6	2	8	0	0	8	0	0
2	7151667	.	C	G	6	6	12	0	1	13	0	0
2	7151682	.	C	A	5	6	11	0	1	12	0	0
2	7151843	.	C	A	1	6	7	0	9	16	0	0
2	7152168	.	C	T	0	6	6	0	4	10	0	0
2	7152196	.	T	A	6	4	10	0	0	10	0	0
2	7152326	.	G	A	11	4	15	0	0	15	0	0
2	7152350	.	C	A	0	4	4	0	11	15	0	0
2	7152409	.	T	C	8	5	13	1	0	14	0	0
2	7152431	.	T	C	7	8	15	0	0	15	0	0
2	7152469	.	G	T	5	7	12	0	1	13	0	0
2	7152518	.	A	G	2	4	6	0	0	6	0	0
2	7152520	.	C	G	1	4	5	0	0	5	0	0
2	7153293	.	A	T	4	7	11	0	1	12	0	0
2	7153861	.	T	C	1	4	5	0	1	6	0	0
2	7154018	.	C	T	0	5	5	0	4	9	0	0
2	7154295	.	C	T	1	1	2	0	2	4	0	0
2	7154297	.	A	G	1	1	2	0	1	3	0	0
2	7154474	.	C	T	3	5	8	0	0	8	0	0
2	7154626	.	T	C	2	3	5	0	0	5	0	0
2	7163378	.	G	A	5	4	9	0	0	9	0	0
2	7168167	.	G	A	3	5	8	0	0	8	0	0
2	7168179	.	T	A	3	4	7	0	1	8	0	0
2	7168762	.	G	A	2	2	4	0	0	4	0	0
2	7238725	.	A	G	3	2	5	0	0	5	0	0
2	7239047	.	C	T	8	6	14	0	1	15	0	0
2	7239079	.	T	C	11	7	18	0	0	18	0	0
2	7239308	.	G	A	8	2	10	0	0	10	0	0
2	7239505	.	T	C	13	10	23	0	4	27	0	0
2	7239812	.	G	A	4	10	14	0	1	15	0	0
2	7239816	.	C	T	3	12	15	0	0	15	0	0
2	7239919	.	A	T	7	3	10	1	1	12	0	0
2	7240378	.	G	A	4	4	8	0	2	10	0	0
2	7240865	.	C	T	0	5	5	0	3	8	0	0
2	7240988	.	T	C	3	1	4	0	0	4	0	0
2	7241014	.	T	C	2	4	6	0	0	6	0	0
2	7241037	.	C	T	2	2	4	0	0	4	0	0
2	7241356	.	T	G	5	3	8	0	0	8	0	0
2	7241358	.	T	G	5	3	8	0	0	8	0	0
2	7241649	.	C	T	6	3	9	0	0	9	0	0
2	7241962	.	G	A	9	4	13	0	1	14	0	0
2	7241980	.	T	A	8	5	13	0	1	14	0	0
2	7422927	.	C	T	0	2	2	0	4	6	0	0
2	7423129	.	T	C	1	6	7	0	0	7	0	0
2	7423142	.	T	C	2	0	2	0	5	7	0	0
2	7602133	.	T	G	4	2	6	0	0	6	0	0
2	7602149	.	A	G	4	3	7	0	0	7	0	0
2	7720800	.	C	T	21	16	37	0	0	37	0	0
2	7720836	.	T	C	21	16	37	0	1	38	0	0
2	7720879	.	C	A	16	26	42	0	0	42	0	0
2	7726414	.	T	A	21	21	42	0	4	46	0	0
2	7726924	.	T	A	11	18	29	0	2	32	1	0
2	7764894	.	C	T	4	12	16	0	15	31	0	0
2	7764983	.	T	C	10	0	10	0	19	29	0	0
2	7765145	.	A	G	2	9	11	0	0	11	0	0
2	7765215	.	G	A	4	3	7	0	1	8	0	0
2	7765613	.	C	T	12	6	18	0	0	18	0	0
2	7765685	.	A	G	4	6	10	0	0	10	0	0
2	7766746	.	T	A	1	2	3	1	0	4	0	0
2	7766819	.	G	C	1	0	1	0	3	4	0	0
2	7766820	.	C	G	1	2	3	0	1	4	0	0
2	7766946	.	G	A	2	2	4	0	0	4	0	0
2	7767336	.	T	A	2	4	6	0	0	6	0	0
2	7767496	.	C	A	0	2	2	0	1	3	0	0
2	7768114	.	G	T	4	3	7	0	0	7	0	0
2	7768615	.	T	C	1	2	3	0	1	4	0	0
2	7768648	.	G	T	1	4	5	0	0	5	0	0
2	7772234	.	G	C	3	2	5	0	0	5	0	0
2	7924183	.	A	T	14	13	27	0	0	27	0	0
2	7924713	.	T	C	21	29	50	0	3	53	0	0
2	7924867	.	G	A	21	24	45	0	1	46	0	0
2	7937238	.	C	T	1	14	15	0	17	32	0	0
2	7943854	.	G	A	16	10	26	0	0	26	0	0
2	7954914	.	G	A	14	15	29	0	0	29	0	0
2	7956982	.	T	C	8	10	18	0	0	18	0	0
2	7959294	.	T	C	10	8	18	0	0	18	0	0
2	7979881	.	T	C	10	7	17	0	1	18	0	0
2	7979938	.	G	A	5	6	11	0	0	11	0	0
2	7982680	.	G	A	6	8	14	0	0	14	0	0
2	7991728	.	C	A	5	4	9	0	0	10	1	0
2	7995486	.	A	G	5	2	7	0	0	7	0	0
2	8017314	.	C	T	3	2	5	0	0	5	0	0
2	8062447	.	A	G	1	4	5	0	0	5	0	0
2	8066897	.	C	T	0	3	3	0	2	5	0	0
2	8072350	.	A	G	2	3	5	0	0	5	0	0
2	8112516	.	C	T	14	21	35	0	0	35	0	0
2	8112611	.	G	A	11	9	20	0	0	20	0	0
2	8112679	.	C	A	15	5	20	0	2	22	0	0
2	8112687	.	A	T	15	4	19	0	2	21	0	0
2	8113819	.	A	G	16	20	36	0	2	38	0	0
2	8114179	.	T	C	16	16	32	0	1	33	0	0
2	10604787	.	A	T	2	5	7	0	0	7	0	0
2	10605096	.	T	G	2	5	7	0	1	8	0	0
2	10606297	.	C	T	3	2	5	0	0	5	0	0
2	10606315	.	G	C	2	2	4	0	0	4	0	0
2	10606346	.	G	T	1	1	2	0	0	2	0	0
2	10606581	.	T	C	1	3	4	0	0	4	0	0
2	10642111	.	C	T	3	7	10	0	0	10	0	0
2	10678202	.	C	T	8	4	12	0	0	12	0	0
2	10678244	.	G	T	6	4	10	0	0	10	0	0
2	10685850	.	T	C	3	6	9	1	0	10	0	0
2	10685890	.	G	C	2	6	8	0	0	8	0	0
2	10685924	.	A	G	9	0	9	0	2	11	0	0
2	10686009	.	T	C	5	3	8	0	1	9	0	0
2	10686018	.	C	T	6	2	8	0	0	8	0	0
2	10686209	.	G	A	1	6	7	0	7	14	0	0
2	10686277	.	A	C	6	9	15	0	1	16	0	0
2	10686280	.	G	A	6	8	14	0	1	15	0	0
2	10686341	.	A	C	6	9	15	0	0	15	0	0
2	10686898	.	G	C	2	11	13	0	1	14	0	0
2	10687002	.	G	T	5	3	8	0	0	8	0	0
2	10698150	.	T	C	32	14	46	0	1	47	0	0
2	10791593	.	A	G	1	6	7	0	0	7	0	0
2	10791702	.	A	G	1	4	5	0	1	6	0	0
2	10808163	.	T	G	0	2	2	0	1	3	0	0
2	10813298	.	T	A	3	3	6	0	0	6	0	0
2	10813499	.	C	T	0	2	2	0	2	4	0	0
2	10813500	.	G	T	2	2	4	0	0	4	0	0
2	10818912	.	A	G	2	3	5	0	0	5	0	0
2	10821750	.	G	T	0	2	2	0	1	3	0	0
2	10841504	.	C	T	3	4	7	0	0	7	0	0
2	10841536	.	T	A	5	6	11	0	0	11	0	0
2	10846471	.	C	T	9	3	12	0	0	12	0	0
2	10857439	.	G	T	6	8	14	0	0	14	0	0
2	10878554	.	G	C	0	2	2	0	2	4	0	0
2	10878579	.	T	C	3	2	5	0	0	5	0	0
2	10879879	.	G	A	4	1	5	0	2	7	0	0
2	10914200	.	A	C	6	6	12	0	0	12	0	0
2	10914340	.	C	A	9	10	19	0	0	19	0	0
2	10916419	.	T	C	6	8	14	0	1	15	0	0
2	10926449	.	T	C	7	11	18	0	1	19	0	0
2	10931675	.	C	G	7	11	18	0	1	19	0	0
2	10948652	.	T	C	2	0	2	0	2	4	0	0
2	10956861	.	T	G	2	2	4	0	1	5	0	0
2	11110222	.	A	G	2	7	9	0	0	9	0	0
2	11117731	.	G	T	2	7	9	0	0	9	0	0
2	11117997	.	C	T	0	3	3	0	1	4	0	0
2	11125635	.	C	G	3	2	5	0	0	5	0	0
2	11125863	.	C	T	1	2	3	0	0	3	0	0
2	11125896	.	C	A	2	4	6	0	0	6	0	0
2	11126039	.	A	C	4	4	8	0	0	8	0	0
2	11483197	.	T	C	3	5	8	0	0	8	0	0
2	11497307	.	C	T	0	3	3	0	2	5	0	0
2	11503588	.	G	C	2	2	4	0	0	4	0	0
2	11503623	.	C	T	3	1	4	0	1	5	0	0
2	11508780	.	G	A	12	3	15	0	0	15	0	0
2	11509016	.	A	T	18	15	33	1	1	35	0	0
2	11509517	.	T	C	24	1	25	0	28	53	0	0
2	11633751	.	A	C	9	0	9	0	7	16	0	0
2	11640026	.	C	T	12	6	18	0	2	20	0	0
2	11640104	.	A	T	8	8	16	0	1	17	0	0
2	11643084	.	C	G	6	4	10	0	0	10	0	0
2	11648332	.	C	T	5	4	9	0	1	10	0	0
2	11651327	.	A	T	9	6	15	0	0	15	0	0
2	11651328	.	T	G	8	6	14	0	1	15	0	0
2	11651573	.	A	T	5	5	10	0	1	11	0	0
2	11656775	.	A	G	12	17	29	0	1	30	0	0
2	11661162	.	T	C	8	9	17	0	1	18	0	0
2	11662575	.	G	T	16	11	27	2	1	30	0	0
2	11662590	.	G	T	12	9	21	2	2	25	0	0
2	11662621	.	A	C	13	12	25	2	2	29	0	0
2	11816266	.	T	C	4	2	6	0	0	6	0	0
2	11830396	.	T	C	3	3	6	1	0	7	0	0
2	11832162	.	C	G	3	3	6	0	0	6	0	0
2	11832443	.	G	T	3	2	5	0	0	5	0	0
2	11832876	.	A	C	8	2	10	0	0	10	0	0
2	11849167	.	A	G	20	8	28	0	1	29	0	0
2	11849190	.	T	C	16	9	25	0	1	26	0	0
2	11849637	.	G	A	14	7	21	0	0	21	0	0
2	11849760	.	A	C	15	4	19	4	2	25	0	0
2	11849764	.	C	A	15	4	19	4	0	24	1	0
2	11849911	.	A	T	3	2	5	1	0	6	0	0
2	11850220	.	C	A	10	3	13	0	0	13	0	0
2	11850244	.	T	A	9	6	15	0	1	16	0	0
2	11850350	.	A	T	18	6	24	2	0	27	1	0
2	11850385	.	C	T	3	7	10	0	27	37	0	0
2	11850395	.	G	A	23	9	32	0	4	36	0	0
2	11850525	.	A	G	12	5	17	0	0	17	0	0
2	11850528	.	T	C	12	0	12	0	5	17	0	0
2	11850948	.	C	A	10	4	14	0	0	14	0	0
2	11851010	.	C	T	6	2	8	0	1	9	0	0
2	11851148	.	G	T	7	4	11	0	1	12	0	0
2	11851189	.	A	C	12	7	19	0	0	19	0	0
2	11851205	.	T	A	12	7	19	0	0	19	0	0
2	11851256	.	T	G	11	10	21	0	1	22	0	0
2	11851260	.	T	G	11	9	20	0	1	21	0	0
2	11851325	.	A	G	10	4	14	0	1	15	0	0
2	11851371	.	T	C	10	6	16	0	1	17	0	0
2	11851434	.	A	C	7	4	11	0	0	11	0	0
2	11851663	.	G	A	3	5	8	0	1	9	0	0
2	11851708	.	C	T	5	5	10	0	0	10	0	0
2	11851750	.	G	A	3	2	5	0	1	6	0	0
2	11852128	.	T	C	6	0	6	0	11	17	0	0
2	11854003	.	T	C	7	2	9	0	0	9	0	0
2	11854009	.	T	C	6	2	8	0	2	10	0	0
2	11854040	.	T	C	4	4	8	0	0	8	0	0
2	11930506	.	A	C	3	5	8	0	0	8	0	0
2	11936125	.	T	C	5	2	7	0	1	8	0	0
2	11939719	.	T	G	4	5	9	0	1	10	0	0
2	11944741	.	G	A	4	2	6	0	0	6	0	0
2	11945070	.	C	G	5	4	9	0	0	9	0	0
2	11945155	.	A	G	3	0	3	0	6	9	0	0
2	11945171	.	T	C	3	6	9	0	1	10	0	0
2	11945329	.	G	C	6	5	11	0	0	11	0	0
2	11945334	.	G	C	8	5	13	0	0	13	0	0
2	11945679	.	T	A	4	2	6	0	1	7	0	0
2	11945680	.	T	C	5	2	7	0	0	7	0	0
2	11945823	.	T	C	4	4	8	0	0	8	0	0
2	11965241	.	C	T	8	7	15	0	0	15	0	0
2	11965262	.	G	A	9	9	18	0	0	18	0	0
2	11976487	.	A	T	2	3	5	0	0	5	0	0
2	11976563	.	C	T	0	6	6	0	4	10	0	0
2	11976633	.	A	G	8	7	15	0	0	15	0	0
2	11976700	.	G	T	7	6	13	0	1	14	0	0
2	11976896	.	T	G	7	6	13	0	1	14	0	0
2	11977146	.	A	T	5	8	13	0	0	13	0	0
2	11977163	.	T	C	7	9	16	0	1	17	0	0
2	11980710	.	C	A	0	3	3	0	5	8	0	0
2	11981009	.	G	C	4	3	7	0	0	7	0	0
2	11991153	.	T	C	9	5	14	0	0	14	0	0
2	12105281	.	T	A	7	10	17	0	1	18	0	0
2	12106289	.	A	G	21	14	35	0	1	36	0	0
2	12106363	.	T	C	10	12	22	0	1	23	0	0
2	12106443	.	T	C	13	10	23	0	1	24	0	0
2	12106508	.	A	T	5	12	17	0	0	17	0	0
2	12106603	.	C	T	18	12	30	5	0	35	0	0
2	12106701	.	G	T	10	17	27	0	1	28	0	0
2	12106721	.	G	A	11	17	28	0	1	29	0	0
2	12106792	.	A	G	15	8	23	0	1	24	0	0
2	12106828	.	C	T	16	6	22	0	1	23	0	0
2	12106846	.	A	T	13	7	20	0	1	21	0	0
2	12106864	.	C	T	1	7	8	0	9	17	0	0
2	12106923	.	C	T	14	6	20	0	1	21	0	0
2	12107063	.	G	A	8	8	16	0	0	16	0	0
2	12107176	.	G	A	7	4	11	0	0	11	0	0
2	12107211	.	C	T	1	4	5	0	2	7	0	0
2	12107214	.	A	C	1	6	7	0	0	7	0	0
2	12107605	.	A	T	9	3	12	0	1	13	0	0
2	12107608	.	A	T	10	2	12	0	0	12	0	0
2	12107678	.	A	T	5	6	11	0	0	11	0	0
2	12107747	.	T	G	3	5	8	0	0	8	0	0
2	12107752	.	A	T	3	7	10	0	0	10	0	0
2	12107879	.	A	T	5	5	10	0	0	10	0	0
2	12107908	.	T	C	6	0	6	0	4	10	0	0
2	12107992	.	G	A	2	2	4	0	1	5	0	0
2	12107994	.	A	G	3	2	5	0	0	5	0	0
2	12108248	.	G	C	6	3	9	0	0	9	0	0
2	12108381	.	C	T	1	3	4	0	6	10	0	0
2	12108513	.	T	A	7	3	10	0	0	10	0	0
2	12108696	.	T	A	9	14	23	0	0	23	0	0
2	12108754	.	G	C	13	7	20	1	0	21	0	0
2	12108810	.	G	T	11	6	17	0	2	19	0	0
2	12109065	.	G	A	12	11	23	0	0	23	0	0
2	12109153	.	T	A	14	11	25	0	0	25	0	0
2	12109637	.	C	T	2	13	15	0	1	16	0	0
2	12109685	.	A	G	3	9	12	0	1	13	0	0
2	12109942	.	G	C	8	4	12	0	0	12	0	0
2	12109971	.	G	A	6	3	9	0	0	9	0	0
2	12109989	.	G	A	4	3	7	0	0	7	0	0
2	12110082	.	C	A	4	5	9	0	1	10	0	0
2	12136395	.	A	G	1	3	4	0	0	4	0	0
2	12155851	.	C	T	1	2	3	0	0	3	0	0
2	12155860	.	A	C	1	2	3	0	0	3	0	0
2	12242171	.	G	A	1	2	3	0	0	3	0	0
2	12242818	.	G	T	1	4	5	0	0	5	0	0
2	12242860	.	A	G	1	4	5	0	1	6	0	0
2	12242916	.	A	C	1	2	3	0	0	3	0	0
2	12265751	.	T	C	7	4	11	0	0	11	0	0
2	12265808	.	T	C	2	4	6	0	0	6	0	0
2	12269834	.	G	T	6	3	9	0	0	9	0	0
2	12279203	.	A	G	8	5	13	0	0	13	0	0
2	12279303	.	C	T	8	4	12	0	0	12	0	0
2	12279419	.	C	T	6	7	13	0	1	14	0	0
2	12279508	.	G	C	3	5	8	0	0	8	0	0
2	12307980	.	C	T	2	4	6	0	0	6	0	0
2	12376848	.	A	T	1	3	4	0	0	4	0	0
2	12376857	.	A	G	1	4	5	0	0	5	0	0
2	12376925	.	A	G	7	11	18	0	0	18	0	0
2	12378489	.	G	A	1	6	7	0	8	15	0	0
2	12378618	.	A	G	14	9	23	0	1	24	0	0
2	12379585	.	A	C	10	10	20	0	1	21	0	0
2	12379872	.	C	T	11	18	29	0	1	30	0	0
2	12386865	.	A	G	12	14	26	0	1	27	0	0
2	12394569	.	G	A	4	8	12	0	21	33	0	0
2	12396788	.	T	G	15	1	16	0	11	27	0	0
2	12396962	.	T	C	15	16	31	0	0	31	0	0
2	12396995	.	G	T	1	15	16	0	12	28	0	0
2	12397418	.	A	G	11	11	22	0	0	22	0	0
2	12404169	.	A	C	21	27	48	0	2	50	0	0
2	12404411	.	T	C	17	24	41	0	3	44	0	0
2	12406022	.	A	T	24	9	33	0	0	33	0	0
2	12406260	.	C	T	15	10	25	0	0	25	0	0
2	12406490	.	A	G	16	22	38	0	1	39	0	0
2	12407106	.	G	A	22	13	35	0	0	35	0	0
2	12407188	.	A	C	29	13	42	0	0	43	1	0
2	12407205	.	T	C	30	0	30	0	17	47	0	0
2	12407626	.	T	A	28	15	43	0	3	46	0	0
2	12407992	.	T	C	30	19	49	0	1	50	0	0
2	12408081	.	T	G	32	19	51	0	2	53	0	0
2	12410548	.	A	G	24	15	39	0	3	43	1	0
2	12417224	.	G	T	18	14	32	0	1	33	0	0
2	12420413	.	T	A	15	14	29	0	1	30	0	0
2	12429868	.	G	A	13	8	21	0	0	21	0	0
2	12436163	.	A	G	4	2	6	0	1	7	0	0
2	12436202	.	G	A	4	8	12	0	1	13	0	0
2	12481342	.	G	A	8	6	14	0	0	14	0	0
2	12481522	.	A	G	7	3	10	0	0	10	0	0
2	12481528	.	A	G	7	3	10	0	0	10	0	0
2	12632749	.	T	C	2	3	5	0	0	5	0	0
2	12998669	.	G	T	3	3	6	0	0	6	0	0
2	12998797	.	C	T	4	5	9	0	0	9	0	0
2	13003417	.	A	C	3	2	5	0	0	5	0	0
2	13003603	.	A	T	2	3	5	0	1	6	0	0
2	13007027	.	C	T	1	3	4	0	0	4	0	0
2	13007141	.	T	A	2	3	5	0	0	5	0	0
2	13007156	.	C	T	3	3	6	0	0	6	0	0
2	13007219	.	G	T	5	3	8	0	1	9	0	0
2	13007360	.	G	A	6	5	11	0	0	11	0	0
2	13007489	.	G	A	6	7	13	0	1	14	0	0
2	13007573	.	T	A	4	2	6	0	0	6	0	0
2	13007693	.	T	C	3	3	6	0	1	7	0	0
2	13007757	.	G	C	6	4	10	0	0	10	0	0
2	13010202	.	A	G	5	4	9	0	0	9	0	0
2	13010241	.	G	T	3	7	10	0	0	10	0	0
2	13010262	.	A	C	1	6	7	0	0	7	0	0
2	13011641	.	T	C	7	5	12	0	1	13	0	0
2	13020264	.	C	A	9	8	17	0	1	18	0	0
2	13020541	.	G	A	1	3	4	0	5	9	0	0
2	13020611	.	C	A	5	8	13	0	0	13	0	0
2	13023068	.	C	A	17	5	22	0	0	22	0	0
2	13026080	.	G	A	1	11	12	0	15	27	0	0
2	13035847	.	T	A	9	8	17	0	0	17	0	0
2	13035942	.	C	A	14	8	22	0	1	23	0	0
2	13036009	.	T	C	11	2	13	0	2	15	0	0
2	13036154	.	T	A	16	13	29	0	1	30	0	0
2	13036769	.	T	C	14	12	26	0	0	27	1	0
2	13036951	.	A	T	14	21	35	0	2	37	0	0
2	13037124	.	T	C	8	10	18	0	1	19	0	0
2	13185332	.	T	G	3	5	8	0	0	8	0	0
2	13185534	.	G	A	6	3	9	0	0	9	0	0
2	13186237	.	A	T	6	3	9	0	0	9	0	0
2	13186333	.	G	T	15	9	24	0	0	24	0	0
2	13186504	.	C	T	18	22	40	0	2	42	0	0
2	13186521	.	T	C	19	18	37	0	4	41	0	0
2	13186986	.	C	T	16	11	27	0	0	27	0	0
2	13187003	.	T	A	12	16	28	0	0	28	0	0
2	13187154	.	A	G	16	9	25	0	1	26	0	0
2	13187210	.	T	G	26	16	42	0	0	42	0	0
2	13187263	.	C	A	24	11	35	0	0	35	0	0
2	13187332	.	G	T	17	19	36	0	1	37	0	0
2	13187386	.	T	G	16	21	37	0	4	41	0	0
2	13187507	.	G	A	18	7	25	0	1	26	0	0
2	13187534	.	A	C	18	11	29	0	0	29	0	0
2	13187634	.	A	G	5	11	16	0	0	16	0	0
2	13187781	.	T	C	5	5	10	0	0	10	0	0
2	13187860	.	T	G	7	5	12	0	0	12	0	0
2	13187868	.	G	A	8	7	15	0	1	16	0	0
2	13187905	.	G	A	12	6	18	0	0	18	0	0
2	13187944	.	G	A	14	11	25	0	1	26	0	0
2	13187958	.	C	A	14	12	26	0	0	26	0	0
2	13188073	.	A	T	15	14	29	0	3	32	0	0
2	13215870	.	A	G	3	12	15	0	0	15	0	0
2	13215967	.	G	A	11	9	20	0	1	21	0	0
2	13223761	.	T	C	5	5	10	0	0	10	0	0
2	13223815	.	T	A	6	5	11	0	1	12	0	0
2	13223853	.	A	G	4	4	8	0	0	8	0	0
2	13223864	.	T	A	4	0	4	0	1	5	0	0
2	13223925	.	A	G	3	10	13	0	0	13	0	0
2	13224229	.	C	T	4	5	9	0	0	9	0	0
2	13224697	.	G	A	5	4	9	0	0	9	0	0
2	13237666	.	C	T	9	4	13	1	0	14	0	0
2	13237699	.	A	G	3	6	9	0	0	9	0	0
2	13254444	.	A	G	2	2	4	0	0	4	0	0
2	13254445	.	C	A	2	2	4	0	0	4	0	0
2	13254625	.	C	T	3	3	6	0	0	6	0	0
2	13256668	.	T	G	11	7	18	0	0	18	0	0
2	13259024	.	C	T	5	5	10	0	0	10	0	0
2	13259120	.	G	T	3	3	6	0	0	6	0	0
2	13265122	.	T	A	6	3	9	0	1	10	0	0
2	13265191	.	G	A	6	5	11	0	1	12	0	0
2	13265572	.	T	G	6	7	13	0	0	13	0	0
2	13266565	.	A	G	7	6	13	0	1	14	0	0
2	13267007	.	C	T	7	2	9	0	3	12	0	0
2	13268443	.	C	A	2	3	5	0	0	5	0	0
2	13694984	.	C	T	3	5	8	0	0	8	0	0
2	13710826	.	T	C	15	13	28	0	0	28	0	0
2	13717388	.	C	T	14	14	28	0	1	29	0	0
2	13743907	.	A	T	2	2	4	0	0	4	0	0
2	13744343	.	A	G	3	2	5	0	1	6	0	0
2	13773911	.	G	C	5	8	13	0	1	14	0	0
2	13800275	.	G	C	6	6	12	0	1	13	0	0
2	13940480	.	C	T	3	3	6	0	1	7	0	0
2	14298495	.	G	A	10	7	17	0	1	18	0	0
2	14366886	.	G	C	15	1	16	0	16	32	0	0
2	14445180	.	A	G	5	6	11	0	1	12	0	0
2	14445297	.	C	T	3	2	5	0	0	5	0	0
2	14445697	.	T	C	2	5	7	0	0	7	0	0
2	14447196	.	G	A	3	2	5	0	0	5	0	0
2	14456081	.	C	T	1	4	5	0	5	10	0	0
2	14464794	.	T	C	2	0	2	0	4	6	0	0
2	14587157	.	T	C	2	3	5	0	1	6	0	0
2	14655158	.	G	A	2	4	6	0	0	6	0	0
2	14655666	.	G	T	1	2	3	0	0	3	0	0
2	14656028	.	C	T	1	2	3	0	0	3	0	0
2	14998651	.	T	A	3	2	5	0	0	5	0	0
2	14998679	.	A	T	1	2	3	0	0	3	0	0
2	14998699	.	T	A	2	2	4	1	0	5	0	0
2	15028974	.	G	A	6	3	9	0	1	10	0	0
2	15031023	.	G	A	2	8	10	0	0	10	0	0
2	15031096	.	A	C	9	0	9	1	7	17	0	0
2	15031126	.	T	C	6	5	11	1	0	12	0	0
2	15035425	.	A	G	4	3	7	0	0	7	0	0
2	15035521	.	C	A	3	4	7	0	0	7	0	0
2	15035928	.	A	T	1	5	6	0	0	6	0	0
2	15036227	.	A	G	2	4	6	0	0	6	0	0
2	15039468	.	G	A	2	3	5	0	0	5	0	0
2	15074470	.	C	T	1	6	7	0	1	8	0	0
2	15074491	.	C	T	2	5	7	0	0	7	0	0
2	15074672	.	T	C	1	2	3	0	0	3	0	0
2	15074697	.	C	A	2	2	4	0	0	4	0	0
2	15075134	.	G	A	0	4	4	0	3	7	0	0
2	15102079	.	C	T	3	3	6	0	0	6	0	0
2	15109704	.	T	C	5	4	9	0	2	11	0	0
2	15109884	.	A	G	5	4	9	0	0	9	0	0
2	15110014	.	T	C	5	3	8	0	0	8	0	0
2	15111806	.	C	T	1	5	6	0	2	8	0	0
2	15111948	.	C	T	5	4	9	0	0	9	0	0
2	15112025	.	G	T	6	8	14	0	1	15	0	0
2	15114286	.	C	T	0	5	5	0	4	9	0	0
2	15116120	.	A	T	4	8	12	0	1	13	0	0
2	15116355	.	T	C	8	2	10	0	0	10	0	0
2	15116356	.	C	T	8	2	10	0	0	10	0	0
2	15119619	.	A	G	0	3	3	0	1	4	0	0
2	15124705	.	C	T	3	2	5	0	1	6	0	0
2	15197217	.	T	A	3	2	5	0	0	5	0	0
2	15197513	.	A	T	2	2	4	0	0	4	0	0
2	15197550	.	A	G	3	0	3	0	4	7	0	0
2	15343219	.	A	G	1	2	3	0	1	4	0	0
2	15343239	.	G	A	2	5	7	0	0	7	0	0
2	15344015	.	G	A	3	4	7	0	0	7	0	0
2	15344210	.	C	A	0	2	2	0	3	5	0	0
2	15348123	.	G	T	5	2	7	0	0	7	0	0
2	15864127	.	C	T	2	6	8	0	0	8	0	0
2	15864466	.	C	T	3	3	6	0	0	6	0	0
2	15864514	.	T	C	4	5	9	0	0	9	0	0
2	15864586	.	C	T	8	3	11	0	0	11	0	0
2	15900093	.	G	A	1	4	5	0	4	9	0	0
2	15942458	.	G	T	9	11	20	0	3	23	0	0
2	15942544	.	A	G	11	15	26	0	1	27	0	0
2	15942637	.	A	G	8	7	15	0	1	16	0	0
2	15942671	.	G	A	5	10	15	0	1	16	0	0
2	15942674	.	A	T	6	9	15	0	0	15	0	0
2	15942774	.	G	A	6	8	14	0	0	14	0	0
2	15942817	.	T	C	7	10	17	0	1	18	0	0
2	15942843	.	C	T	9	10	19	0	1	20	0	0
2	15942877	.	C	T	10	14	24	1	0	25	0	0
2	15942897	.	C	G	8	8	16	1	6	23	0	0
2	15943022	.	C	T	6	9	15	0	1	16	0	0
2	15943048	.	G	T	6	9	15	0	1	16	0	0
2	15943120	.	T	G	12	3	15	0	0	15	0	0
2	15943267	.	G	A	0	5	5	0	6	11	0	0
2	15993771	.	C	T	0	2	2	0	4	6	0	0
2	16164268	.	T	G	7	0	7	0	12	19	0	0
2	16165809	.	C	A	9	11	20	0	0	20	0	0
2	16169397	.	A	G	7	8	15	0	0	15	0	0
2	16172013	.	C	A	5	12	17	0	1	18	0	0
2	16172040	.	C	T	5	6	11	0	0	11	0	0
2	16172088	.	T	G	1	9	10	0	0	10	0	0
2	16172096	.	A	T	2	10	12	0	1	13	0	0
2	16174117	.	A	C	4	5	9	0	1	10	0	0
2	16176308	.	G	A	6	5	11	0	0	11	0	0
2	16177590	.	C	G	5	3	8	0	1	9	0	0
2	16181251	.	C	T	4	3	7	0	0	7	0	0
2	16181258	.	A	G	4	2	6	0	0	6	0	0
2	16185079	.	A	G	4	4	8	0	1	9	0	0
2	16188660	.	C	T	1	2	3	0	0	3	0	0
2	16188834	.	G	A	0	4	4	0	2	6	0	0
2	16191697	.	G	C	1	13	14	0	17	31	0	0
2	16191718	.	G	A	5	9	14	0	14	28	0	0
2	16191829	.	C	T	16	8	24	0	1	25	0	0
2	16191841	.	A	C	7	16	23	0	0	23	0	0
2	16198807	.	T	C	7	8	15	0	1	16	0	0
2	16198864	.	T	C	18	0	18	0	11	29	0	0
2	16199018	.	G	A	24	35	59	0	0	59	0	0
2	16199331	.	A	G	38	18	56	0	1	57	0	0
2	16199332	.	G	A	39	17	56	0	1	57	0	0
2	16199411	.	C	T	7	28	35	0	27	62	0	0
2	16204716	.	C	G	5	29	34	2	30	66	0	0
2	16206766	.	G	T	25	25	50	0	1	51	0	0
2	16206840	.	C	T	20	29	49	0	2	51	0	0
2	16207151	.	G	A	17	13	30	0	2	32	0	0
2	16209753	.	G	A	24	19	43	0	4	47	0	0
2	16212643	.	G	A	8	3	11	0	0	11	0	0
2	16212924	.	A	G	10	6	16	0	0	16	0	0
2	16212957	.	A	G	12	12	24	0	1	25	0	0
2	16216830	.	G	T	9	15	24	0	1	25	0	0
2	16254439	.	T	G	4	5	9	0	1	10	0	0
2	16254496	.	C	A	3	4	7	0	1	8	0	0
2	16254659	.	C	T	0	4	4	0	3	7	0	0
2	16268108	.	C	T	1	3	4	0	0	4	0	0
2	16376143	.	T	C	7	5	12	0	1	13	0	0
2	16376295	.	G	A	4	4	8	0	1	9	0	0
2	16376947	.	G	A	1	4	5	0	0	5	0	0
2	16376990	.	G	A	3	4	7	0	0	7	0	0
2	16377082	.	A	G	1	2	3	0	1	4	0	0
2	16377232	.	C	T	3	3	6	0	0	6	0	0
2	16377241	.	C	T	3	3	6	0	0	6	0	0
2	16378171	.	G	A	2	4	6	0	0	6	0	0
2	16378601	.	G	T	3	2	5	0	0	5	0	0
2	16378606	.	C	G	3	1	4	0	0	4	0	0
2	16384494	.	A	T	1	2	3	0	0	3	0	0
2	16388003	.	G	A	1	2	3	0	0	3	0	0
2	16388020	.	A	G	2	2	4	0	0	4	0	0
2	16390438	.	C	T	1	2	3	0	1	4	0	0
2	16397538	.	A	G	4	2	6	0	0	6	0	0
2	16397877	.	C	T	0	2	2	0	5	7	0	0
2	16400842	.	T	G	2	2	4	0	0	4	0	0
2	16412902	.	A	G	1	2	3	0	1	4	0	0
2	16454119	.	A	G	2	5	7	0	1	8	0	0
2	16454182	.	T	A	3	7	10	0	2	12	0	0
2	16463862	.	T	C	5	2	7	0	0	7	0	0
2	16466383	.	A	G	6	1	7	0	4	11	0	0
2	16466720	.	A	G	8	0	8	0	9	17	0	0
2	16472243	.	T	C	8	16	24	0	2	26	0	0
2	16472284	.	T	C	7	13	20	0	1	21	0	0
2	16472288	.	C	G	7	0	7	0	13	20	0	0
2	16475415	.	C	G	17	1	18	0	15	33	0	0
2	16475469	.	C	A	21	13	34	0	0	34	0	0
2	16475484	.	G	A	2	12	14	0	16	30	0	0
2	16478577	.	G	A	3	6	9	0	6	15	0	0
2	16478587	.	A	G	7	6	13	0	0	13	0	0
2	16548120	.	A	T	8	10	18	0	2	20	0	0
2	16548178	.	C	T	0	5	5	0	2	7	0	0
2	16548286	.	T	C	11	0	11	0	18	29	0	0
2	16548289	.	C	T	11	19	30	0	0	30	0	0
2	16548514	.	T	C	18	14	32	0	1	33	0	0
2	16565384	.	T	G	7	3	10	0	2	12	0	0
2	16565560	.	G	T	10	12	22	0	0	22	0	0
2	16594896	.	T	A	4	4	8	0	0	8	0	0
2	16631338	.	G	A	4	2	6	0	0	6	0	0
2	16632334	.	C	T	1	5	6	0	0	6	0	0
2	16632420	.	T	C	1	2	3	0	0	3	0	0
2	16632788	.	T	C	2	4	6	0	0	6	0	0
2	16632812	.	T	C	4	2	6	0	0	6	0	0
2	16632917	.	T	C	3	6	9	0	0	9	0	0
2	16635588	.	G	A	3	3	6	0	1	7	0	0
2	16635733	.	G	A	5	3	8	0	1	9	0	0
2	16638459	.	C	T	3	3	6	0	1	7	0	0
2	16639434	.	G	A	3	3	6	0	0	6	0	0
2	16639585	.	G	A	6	1	7	0	2	9	0	0
2	16639684	.	G	A	4	10	14	0	0	14	0	0
2	16639818	.	C	T	4	7	11	0	0	11	0	0
2	16639827	.	G	T	6	2	8	1	1	10	0	0
2	16643054	.	C	T	6	5	11	0	0	11	0	0
2	16645821	.	A	C	10	3	13	0	1	14	0	0
2	16645852	.	T	A	3	2	5	0	4	9	0	0
2	16646117	.	C	T	5	2	7	0	1	8	0	0
2	16646222	.	C	T	5	2	7	0	0	7	0	0
2	16646275	.	G	C	5	2	7	0	0	7	0	0
2	16646377	.	T	A	4	8	12	0	0	12	0	0
2	16646519	.	A	T	5	2	7	1	0	8	0	0
2	16646556	.	G	A	0	4	4	1	4	9	0	0
2	16646684	.	A	G	1	2	3	0	0	3	0	0
2	16646693	.	T	C	1	2	3	0	0	3	0	0
2	16646808	.	A	C	3	4	7	0	0	7	0	0
2	16698199	.	A	G	11	8	19	0	1	20	0	0
2	16698384	.	C	A	6	16	22	0	0	22	0	0
2	16699560	.	C	T	9	17	26	0	0	26	0	0
2	16699565	.	A	T	9	18	27	0	1	28	0	0
2	16699595	.	T	C	11	21	32	0	0	32	0	0
2	16702570	.	G	A	1	10	11	0	17	28	0	0
2	16706549	.	A	C	33	21	54	0	3	57	0	0
2	16706563	.	T	C	27	26	53	0	2	55	0	0
2	16706618	.	G	A	2	26	28	0	24	52	0	0
2	16706737	.	G	A	2	20	22	0	19	41	0	0
2	16706994	.	T	C	16	14	30	0	2	32	0	0
2	16707014	.	C	A	13	16	29	0	3	32	0	0
2	16707030	.	G	T	19	19	38	0	0	38	0	0
2	16707056	.	C	G	19	17	36	0	3	39	0	0
2	16707509	.	C	A	17	18	35	0	2	37	0	0
2	16707718	.	G	A	3	3	6	0	0	6	0	0
2	16731783	.	C	T	6	5	11	0	2	13	0	0
2	16735292	.	C	A	16	7	23	0	1	24	0	0
2	16790968	.	C	G	3	2	5	0	0	5	0	0
2	16791991	.	T	G	2	6	8	0	0	8	0	0
2	16792030	.	A	T	2	2	4	0	0	4	0	0
2	16814762	.	T	C	2	4	6	0	0	6	0	0
2	16819317	.	A	G	3	6	9	0	0	9	0	0
2	16821329	.	A	C	8	4	12	0	1	13	0	0
2	16821788	.	A	T	3	2	5	0	0	5	0	0
2	16822370	.	A	C	3	3	6	0	1	7	0	0
2	16824536	.	T	C	5	7	12	0	0	12	0	0
2	16826297	.	G	A	7	4	11	0	0	11	0	0
2	16826899	.	T	C	3	8	11	0	1	12	0	0
2	16827129	.	G	A	6	3	9	0	0	9	0	0
2	16829221	.	C	A	4	7	11	0	0	11	0	0
2	16829555	.	G	A	1	4	5	0	4	9	0	0
2	16833650	.	C	A	6	8	14	0	0	14	0	0
2	16833884	.	A	T	16	10	26	0	0	26	0	0
2	16837849	.	C	T	18	6	24	2	1	27	0	0
2	16862267	.	C	T	2	4	6	0	1	7	0	0
2	16862271	.	T	C	2	6	8	0	1	9	0	0
2	16866879	.	C	G	3	4	7	0	1	8	0	0
2	16866933	.	G	A	0	3	3	0	7	10	0	0
2	16866940	.	C	A	7	3	10	0	0	10	0	0
2	16867341	.	C	A	1	5	6	0	0	6	0	0
2	16867376	.	A	G	1	0	1	0	2	3	0	0
2	16867606	.	A	T	5	4	9	1	1	11	0	0
2	16867621	.	T	G	5	7	12	1	0	13	0	0
2	16867733	.	G	C	5	4	9	0	0	9	0	0
2	16867897	.	G	A	1	3	4	0	2	6	0	0
2	16885660	.	C	T	2	1	3	0	1	4	0	0
2	16885671	.	T	C	2	2	4	0	0	4	0	0
2	16885720	.	A	G	5	2	7	0	0	7	0	0
2	16885774	.	A	T	1	4	5	0	1	6	0	0
2	16885782	.	T	A	2	3	5	0	1	6	0	0
2	16885857	.	A	C	2	3	5	0	0	5	0	0
2	16886106	.	A	T	2	3	5	0	0	5	0	0
2	17266812	.	G	C	2	0	2	0	2	4	0	0
2	17267091	.	T	G	3	2	5	0	0	5	0	0
2	17267621	.	G	A	1	2	3	0	0	3	0	0
2	17267626	.	G	A	1	2	3	0	1	4	0	0
2	17267684	.	A	G	4	5	9	0	0	9	0	0
2	17450424	.	T	C	5	1	6	0	4	10	0	0
2	17450707	.	T	C	6	0	6	0	4	10	0	0
2	17450726	.	A	T	6	3	9	0	0	9	0	0
2	17450744	.	G	A	6	2	8	0	0	8	0	0
2	17450967	.	T	C	9	0	9	0	8	17	0	0
2	17451198	.	G	A	5	9	14	0	0	14	0	0
2	17451233	.	T	C	8	10	18	0	0	18	0	0
2	17451327	.	A	G	8	11	19	0	1	20	0	0
2	17451375	.	G	A	4	6	10	0	0	10	0	0
2	17451387	.	T	C	4	3	7	0	0	7	0	0
2	17469413	.	T	C	2	1	3	0	4	7	0	0
2	17469441	.	A	G	2	3	5	0	0	5	0	0
2	17473497	.	T	G	2	5	7	0	1	8	0	0
2	17477335	.	G	T	9	5	14	0	0	15	1	0
2	17477480	.	G	T	8	7	15	0	0	15	0	0
2	17488590	.	G	A	1	2	3	0	0	3	0	0
2	17578471	.	A	T	4	2	6	0	0	6	0	0
2	17578480	.	A	T	5	3	8	0	0	8	0	0
2	17578593	.	A	G	8	16	24	0	1	25	0	0
2	17578658	.	T	A	8	20	28	0	2	30	0	0
2	17578853	.	C	T	14	13	27	0	2	29	0	0
2	17579033	.	G	A	14	7	21	0	0	21	0	0
2	17579109	.	A	C	11	0	11	0	9	20	0	0
2	17579110	.	A	G	11	7	18	0	2	20	0	0
2	17579324	.	T	C	17	13	30	0	1	31	0	0
2	17579639	.	G	A	1	4	5	0	0	5	0	0
2	17579888	.	A	C	15	0	15	0	17	32	0	0
2	17579926	.	G	C	23	0	23	0	17	40	0	0
2	17604640	.	G	C	3	6	9	0	1	10	0	0
2	17617513	.	T	C	6	5	11	0	1	12	0	0
2	17629935	.	T	C	6	8	14	0	4	18	0	0
2	17644591	.	G	A	9	11	20	0	1	21	0	0
2	17651370	.	A	G	6	2	8	0	0	9	1	0
2	17656439	.	A	T	5	5	10	0	0	10	0	0
2	17656562	.	A	G	5	4	9	0	0	9	0	0
2	17656583	.	G	A	4	5	9	0	0	9	0	0
2	17688318	.	A	C	6	0	6	0	6	12	0	0
2	17698505	.	T	C	4	3	7	0	0	7	0	0
2	17702137	.	T	C	2	0	2	0	4	6	0	0
2	17702518	.	G	A	3	2	5	0	0	5	0	0
2	17792300	.	T	C	1	0	1	0	2	3	0	0
2	18700662	.	A	T	1	2	3	0	0	3	0	0
2	20811080	.	C	T	1	4	5	0	1	6	0	0
2	20819738	.	A	G	0	13	13	0	1	14	0	0
2	21765814	.	G	A	2	2	4	0	0	4	0	0
2	22395752	.	A	G	1	2	3	0	1	4	0	0
2	22395758	.	A	G	1	3	4	0	0	4	0	0
2	22791330	.	G	A	1	2	3	0	0	3	0	0
2	22791540	.	G	C	1	2	3	0	0	3	0	0
2	22799294	.	T	A	16	26	42	0	0	42	0	0
2	22802004	.	T	A	22	24	46	1	0	47	0	0
2	22802117	.	A	T	19	15	34	1	7	42	0	0
2	22802524	.	T	A	18	17	35	0	0	35	0	0
2	22803074	.	G	A	2	21	23	0	24	47	0	0
2	22803128	.	G	T	20	29	49	0	2	51	0	0
2	22803467	.	A	G	33	2	35	0	18	53	0	0
2	22857691	.	T	C	3	2	5	0	0	5	0	0
2	22860541	.	C	T	2	4	6	1	0	7	0	0
2	22860711	.	T	C	1	3	4	0	0	4	0	0
2	22933377	.	G	T	3	3	6	0	0	6	0	0
2	22933381	.	C	T	3	3	6	0	0	6	0	0
2	22933455	.	T	C	4	6	10	0	0	10	0	0
2	22953005	.	T	C	1	4	5	0	0	5	0	0
2	22953020	.	A	C	1	0	1	0	3	4	0	0
2	22957533	.	G	A	1	4	5	0	1	6	0	0
2	22970361	.	A	G	4	2	6	0	0	6	0	0
2	22971012	.	T	A	8	8	16	0	0	16	0	0
2	22979768	.	G	T	4	6	10	0	0	10	0	0
2	22986358	.	C	A	0	5	5	0	5	10	0	0
2	22986555	.	C	T	2	2	4	0	0	4	0	0
2	22993548	.	G	C	4	2	6	0	0	6	0	0
2	22994264	.	T	G	12	6	18	0	0	18	0	0
2	22994322	.	C	T	8	7	15	0	0	15	0	0
2	22994327	.	G	A	7	6	13	0	0	13	0	0
2	23004238	.	T	C	14	4	18	0	0	18	0	0
2	23007678	.	G	A	2	3	5	0	0	5	0	0
2	23007891	.	C	G	1	0	1	0	2	3	0	0
2	23008209	.	C	T	2	2	4	0	0	4	0	0
2	23022716	.	C	T	5	4	9	0	0	9	0	0
2	23023121	.	G	A	0	3	3	0	3	6	0	0
2	23023337	.	G	A	3	2	5	0	0	5	0	0
2	23023466	.	C	G	4	2	6	0	2	8	0	0
2	23023524	.	G	T	7	3	10	0	0	10	0	0
2	23024677	.	A	G	2	5	7	0	0	7	0	0
2	23024704	.	A	C	3	6	9	0	2	11	0	0
2	23024764	.	G	T	0	3	3	0	0	3	0	0
2	23024767	.	G	T	1	2	3	0	1	4	0	0
2	23071236	.	G	A	10	17	27	0	0	27	0	0
2	23077432	.	A	G	23	6	29	5	0	34	0	0
2	23078244	.	T	C	17	18	35	0	1	36	0	0
2	23078532	.	T	C	11	7	18	0	0	18	0	0
2	23081309	.	G	A	0	2	2	0	2	4	0	0
2	23083338	.	C	T	2	4	6	0	1	7	0	0
2	23088871	.	C	T	1	7	8	0	0	8	0	0
2	23088936	.	C	T	2	2	4	0	0	4	0	0
2	23088951	.	G	A	1	2	3	0	0	3	0	0
2	23090867	.	C	T	3	4	7	0	0	7	0	0
2	23098385	.	A	T	5	6	11	0	0	11	0	0
2	23098416	.	G	A	6	5	11	0	0	11	0	0
2	23098614	.	A	C	3	3	6	0	1	7	0	0
2	23098856	.	T	A	4	6	10	0	3	13	0	0
2	23099090	.	G	T	1	1	2	0	0	2	0	0
2	23099104	.	T	C	3	2	5	0	0	5	0	0
2	23099307	.	T	C	3	2	5	0	0	5	0	0
2	23165559	.	A	G	3	4	7	0	1	8	0	0
2	23232884	.	T	C	2	9	11	0	0	11	0	0
2	23238502	.	C	T	12	8	20	0	0	20	0	0
2	23245557	.	C	T	6	7	13	0	0	13	0	0
2	23254158	.	G	A	6	9	15	0	1	16	0	0
2	23274792	.	C	T	17	12	29	0	2	31	0	0
2	23292123	.	A	T	14	19	33	0	0	33	0	0
2	23292359	.	G	A	2	8	10	0	9	19	0	0
2	23292432	.	C	A	12	11	23	0	1	24	0	0
2	23292490	.	C	G	10	11	21	0	0	21	0	0
2	23292549	.	C	A	6	11	17	0	1	18	0	0
2	23292776	.	G	A	3	3	6	0	1	7	0	0
2	23293123	.	G	C	9	8	17	0	0	17	0	0
2	23293230	.	A	T	13	6	19	1	2	22	0	0
2	23293376	.	C	A	6	9	15	0	1	16	0	0
2	23352323	.	G	A	8	15	23	0	2	25	0	0
2	23361208	.	C	T	17	21	38	0	2	40	0	0
2	23361359	.	T	C	13	18	31	0	1	32	0	0
2	23379532	.	G	A	4	4	8	0	0	8	0	0
2	23379588	.	C	T	4	7	11	0	1	12	0	0
2	23379861	.	G	A	4	3	7	0	0	7	0	0
2	23380621	.	C	A	4	10	14	0	0	14	0	0
2	23381056	.	A	G	4	3	7	0	0	7	0	0
2	23623149	.	C	T	1	3	4	0	0	4	0	0
2	23701651	.	C	T	2	3	5	0	0	5	0	0
2	23701680	.	G	A	3	2	5	0	0	5	0	0
2	23701714	.	A	C	3	5	8	0	0	8	0	0
2	23701743	.	T	A	2	5	7	0	0	7	0	0
2	23716572	.	T	C	8	5	13	0	0	13	0	0
2	23716802	.	A	G	3	0	3	0	5	8	0	0
2	23721729	.	T	A	5	2	7	0	0	7	0	0
2	23721974	.	C	A	4	4	8	0	0	8	0	0
2	23722338	.	G	A	4	2	6	0	0	6	0	0
2	23722414	.	A	G	2	0	2	0	4	6	0	0
2	23722444	.	A	T	5	7	12	0	0	12	0	0
2	23722518	.	A	G	3	0	3	0	3	6	0	0
2	23722828	.	G	A	8	7	15	0	0	15	0	0
2	23722849	.	T	C	8	10	18	0	0	18	0	0
2	23723521	.	A	T	2	3	5	0	3	8	0	0
2	23723594	.	A	G	2	0	2	0	3	5	0	0
2	23723638	.	A	T	3	10	13	0	0	13	0	0
2	23724359	.	A	T	7	6	13	0	0	13	0	0
2	23724382	.	T	A	6	2	8	0	0	8	0	0
2	23724469	.	G	A	1	4	5	0	8	13	0	0
2	23724535	.	T	G	7	7	14	0	1	15	0	0
2	23725075	.	G	A	5	7	12	0	1	13	0	0
2	23725159	.	T	C	4	13	17	0	0	17	0	0
2	23725184	.	C	A	9	4	13	0	1	14	0	0
2	23725239	.	C	T	8	7	15	0	3	18	0	0
2	23725608	.	A	T	6	4	10	0	0	10	0	0
2	23725754	.	A	T	10	8	18	0	1	19	0	0
2	23725756	.	A	T	11	8	19	0	0	19	0	0
2	23725906	.	C	A	5	4	9	0	1	10	0	0
2	23725980	.	A	C	4	2	6	0	0	6	0	0
2	23725986	.	G	T	4	5	9	0	0	9	0	0
2	23726290	.	T	C	14	8	22	0	2	24	0	0
2	23726312	.	G	A	13	13	26	0	2	28	0	0
2	23726353	.	G	A	16	16	32	0	2	34	0	0
2	23726393	.	C	T	12	16	28	1	0	29	0	0
2	23794620	.	A	G	1	2	3	0	0	3	0	0
2	23794686	.	A	T	1	2	3	0	0	3	0	0
2	23803219	.	G	A	1	3	4	0	0	4	0	0
2	23804309	.	G	A	2	3	5	0	0	5	0	0
2	23804396	.	T	A	4	2	6	0	0	6	0	0
2	23808760	.	G	A	3	4	7	0	0	7	0	0
2	23816293	.	A	C	5	4	9	0	0	9	0	0
2	23816626	.	T	A	2	2	4	0	0	4	0	0
2	23817497	.	C	T	1	4	5	0	0	5	0	0
2	23818580	.	T	A	1	4	5	0	1	6	0	0
2	23818790	.	A	G	1	0	1	0	5	6	0	0
2	23818835	.	T	C	1	2	3	0	1	4	0	0
2	23819302	.	C	G	5	2	7	0	0	7	0	0
2	23819603	.	T	C	1	2	3	0	0	3	0	0
2	23819862	.	A	C	2	3	5	0	0	5	0	0
2	23819946	.	T	G	4	0	4	0	4	8	0	0
2	23835209	.	T	C	1	4	5	0	1	6	0	0
2	23836807	.	A	C	3	6	9	0	0	9	0	0
2	23937227	.	G	A	6	3	9	0	0	9	0	0
2	23940470	.	T	G	1	3	4	0	0	4	0	0
2	23943510	.	G	A	1	5	6	0	1	7	0	0
2	23946416	.	G	T	1	3	4	0	0	4	0	0
2	23966057	.	G	A	1	2	3	0	0	3	0	0
2	24202456	.	G	A	6	6	12	0	2	14	0	0
2	24202528	.	T	C	3	2	5	0	0	5	0	0
2	24202855	.	A	G	5	1	6	0	4	10	0	0
2	24218927	.	G	A	1	18	19	0	25	44	0	0
2	24222069	.	A	C	32	24	56	0	1	57	0	0
2	24223991	.	A	G	14	32	46	0	10	56	0	0
2	24238629	.	C	T	20	22	42	0	0	42	0	0
2	24248657	.	A	G	3	42	45	0	1	46	0	0
2	24249037	.	T	A	25	11	36	0	1	37	0	0
2	24249211	.	A	G	30	24	54	1	1	56	0	0
2	24249849	.	C	T	8	13	21	1	1	23	0	0
2	24250303	.	C	T	21	16	37	0	2	39	0	0
2	24250345	.	A	C	22	22	44	0	3	47	0	0
2	24250482	.	C	T	18	21	39	0	5	44	0	0
2	24251294	.	G	A	2	28	30	0	33	63	0	0
2	24251430	.	A	G	34	25	59	1	4	64	0	0
2	24251800	.	G	A	42	24	66	0	7	73	0	0
2	24251848	.	T	C	41	28	69	0	3	72	0	0
2	24252088	.	C	T	41	29	70	0	4	74	0	0
2	24310822	.	C	T	15	11	26	0	2	28	0	0
2	24310850	.	G	C	14	12	26	0	3	29	0	0
2	24310897	.	G	A	14	22	36	0	2	38	0	0
2	24311035	.	T	C	24	0	24	0	14	38	0	0
2	24311045	.	T	C	17	1	18	0	22	40	0	0
2	24311118	.	T	A	7	6	13	0	1	14	0	0
2	24311697	.	C	T	21	11	32	0	5	37	0	0
2	24311703	.	A	G	23	11	34	0	3	37	0	0
2	24311793	.	G	C	15	20	35	1	3	39	0	0
2	24311879	.	A	G	28	25	53	0	2	55	0	0
2	24313884	.	T	C	10	11	21	0	1	22	0	0
2	24314185	.	T	A	5	5	10	0	2	12	0	0
2	24315047	.	A	G	9	4	13	0	0	13	0	0
2	24315068	.	A	G	10	4	14	0	0	14	0	0
2	24316545	.	C	T	12	13	25	0	0	25	0	0
2	24317537	.	G	A	10	10	20	0	0	20	0	0
2	24322180	.	G	T	16	10	26	0	0	26	0	0
2	24326455	.	A	G	11	16	27	0	0	27	0	0
2	24326509	.	G	A	8	12	20	0	1	21	0	0
2	24331297	.	T	C	9	5	14	0	0	14	0	0
2	24335246	.	G	A	4	3	7	0	0	7	0	0
2	24338492	.	G	A	3	4	7	0	0	7	0	0
2	24376511	.	C	T	5	5	10	0	0	10	0	0
2	24385271	.	T	G	7	8	15	0	0	15	0	0
2	24385603	.	G	A	1	16	17	0	7	24	0	0
2	24385633	.	C	T	10	13	23	0	0	23	0	0
2	24414062	.	G	A	13	10	23	0	2	25	0	0
2	24432634	.	G	T	13	4	17	0	0	17	0	0
2	24444839	.	C	G	0	6	6	0	1	7	0	0
2	24461235	.	G	A	6	4	10	0	0	10	0	0
2	24461305	.	C	T	0	4	4	0	2	6	0	0
2	24461957	.	G	A	7	5	12	0	8	20	0	0
2	24541321	.	T	C	1	2	3	0	0	3	0	0
2	24542121	.	T	A	1	3	4	0	0	4	0	0
2	24548957	.	G	C	1	2	3	0	0	3	0	0
2	24549532	.	G	A	4	2	6	0	0	6	0	0
2	24554334	.	C	A	1	3	4	0	0	4	0	0
2	24554335	.	G	T	1	3	4	0	0	4	0	0
2	24558443	.	C	T	3	4	7	0	0	7	0	0
2	24558465	.	C	T	4	2	6	0	1	7	0	0
2	24558512	.	A	T	7	3	10	1	1	12	0	0
2	24558545	.	A	G	11	3	14	1	0	15	0	0
2	24558570	.	C	T	9	6	15	0	1	16	0	0
2	24558790	.	C	G	3	2	5	0	0	5	0	0
2	24558836	.	T	C	7	4	11	0	0	11	0	0
2	24559091	.	A	T	4	6	10	0	1	11	0	0
2	24560167	.	T	C	4	0	4	0	4	8	0	0
2	24560218	.	G	C	6	0	6	0	5	11	0	0
2	24560248	.	A	G	6	6	12	0	1	13	0	0
2	24560794	.	T	A	4	4	8	0	0	8	0	0
2	24561244	.	A	G	6	4	10	0	0	10	0	0
2	24565123	.	A	G	2	5	7	0	0	7	0	0
2	24578215	.	G	A	2	2	4	0	0	4	0	0
2	24578568	.	A	G	3	3	6	0	0	6	0	0
2	24584052	.	C	T	0	3	3	0	4	7	0	0
2	24594669	.	T	G	5	3	8	0	0	8	0	0
2	24594673	.	T	A	4	3	7	0	0	7	0	0
2	24646290	.	A	G	4	0	4	0	4	8	0	0
2	24650758	.	C	T	4	5	9	0	0	9	0	0
2	24672447	.	T	C	2	6	8	0	1	9	0	0
2	24682951	.	T	C	9	17	26	0	2	28	0	0
2	24683093	.	A	G	13	1	14	0	11	25	0	0
2	24701098	.	T	C	6	2	8	0	0	8	0	0
2	24701330	.	G	A	1	3	4	0	0	4	0	0
2	24737749	.	C	T	3	3	6	0	0	6	0	0
2	24737776	.	C	T	4	2	6	0	2	8	0	0
2	24739910	.	G	T	5	3	8	1	0	9	0	0
2	24743787	.	G	A	1	6	7	0	2	9	0	0
2	24748834	.	A	G	2	2	4	0	0	4	0	0
2	24748999	.	C	T	4	2	6	0	4	10	0	0
2	24749403	.	G	A	3	4	7	0	0	7	0	0
2	24750918	.	A	T	3	2	5	0	0	5	0	0
2	24750971	.	T	A	1	2	3	0	0	3	0	0
2	24751286	.	C	T	4	5	9	0	1	10	0	0
2	24751567	.	T	A	3	5	8	0	0	8	0	0
2	24751608	.	A	T	4	6	10	0	0	10	0	0
2	24751991	.	A	G	4	7	11	0	2	13	0	0
2	24752048	.	C	T	4	5	9	0	1	10	0	0
2	24752157	.	G	A	6	11	17	0	0	17	0	0
2	24752179	.	C	T	7	13	20	0	0	20	0	0
2	24752247	.	A	G	8	3	11	0	0	11	0	0
2	24752737	.	A	G	5	6	11	0	0	11	0	0
2	24753062	.	T	C	5	12	17	0	0	17	0	0
2	24753085	.	C	G	9	3	12	0	0	12	0	0
2	24753164	.	G	A	2	2	4	0	0	4	0	0
2	24753492	.	G	C	10	5	15	0	0	15	0	0
2	24753535	.	A	C	9	4	13	0	1	14	0	0
2	24754489	.	G	A	4	5	9	0	1	11	1	0
2	24754565	.	A	T	8	8	16	0	2	18	0	0
2	24754597	.	C	T	11	7	18	0	0	18	0	0
2	24754641	.	G	A	1	10	11	0	7	18	0	0
2	24754783	.	C	T	15	14	29	0	3	33	1	0
2	24754794	.	G	A	19	15	34	0	0	34	0	0
2	24754883	.	T	A	11	6	17	0	1	18	0	0
2	24755018	.	T	C	16	18	34	0	1	35	0	0
2	24766941	.	G	A	3	2	5	0	1	6	0	0
2	24770731	.	C	A	1	4	5	0	0	5	0	0
2	24774344	.	C	T	6	5	11	0	0	11	0	0
2	24860969	.	A	G	2	3	5	0	1	6	0	0
2	24863101	.	G	T	3	4	7	0	0	7	0	0
2	24863757	.	G	T	2	2	4	0	0	4	0	0
2	24865187	.	C	A	2	7	9	0	0	9	0	0
2	24865872	.	T	A	3	2	5	0	0	5	0	0
2	24865972	.	A	T	4	4	8	0	0	8	0	0
2	24866075	.	G	C	5	11	16	0	0	16	0	0
2	24873047	.	G	A	13	10	23	0	1	24	0	0
2	24875201	.	T	C	4	13	17	0	0	17	0	0
2	24876864	.	T	A	6	7	13	0	2	15	0	0
2	24877010	.	A	G	7	17	24	0	1	25	0	0
2	24877227	.	C	T	9	5	14	0	0	14	0	0
2	24877276	.	A	C	6	13	19	0	1	20	0	0
2	24877294	.	T	C	7	13	20	0	0	20	0	0
2	24877327	.	T	C	3	7	10	0	0	10	0	0
2	24877797	.	G	A	5	3	8	0	0	8	0	0
2	24878017	.	T	A	5	27	32	0	1	33	0	0
2	24878051	.	C	T	18	15	33	0	2	35	0	0
2	24878081	.	T	A	17	14	31	0	1	32	0	0
2	24878332	.	A	G	13	6	19	0	1	20	0	0
2	24943237	.	G	A	5	12	17	0	11	28	0	0
2	24943482	.	G	T	9	9	18	0	2	20	0	0
2	24943536	.	C	T	9	5	14	0	0	14	0	0
2	24943567	.	A	G	5	2	7	0	0	7	0	0
2	24943891	.	A	T	6	14	20	0	1	21	0	0
2	24943916	.	T	C	5	11	16	0	0	16	0	0
2	24943971	.	A	T	8	10	18	0	2	20	0	0
2	24944187	.	C	T	12	7	19	0	2	21	0	0
2	24944415	.	C	T	6	11	17	0	0	17	0	0
2	24944644	.	A	G	4	4	8	0	0	8	0	0
2	24947129	.	G	T	14	5	19	0	0	19	0	0
2	24952186	.	G	A	3	9	12	0	1	13	0	0
2	24952406	.	C	A	6	5	11	0	2	13	0	0
2	24952607	.	T	C	8	5	13	0	0	13	0	0
2	24955877	.	C	T	1	3	4	0	0	4	0	0
2	24956681	.	G	A	4	4	8	0	0	8	0	0
2	24956856	.	T	C	2	0	2	0	3	5	0	0
2	24957008	.	G	A	5	2	7	0	0	7	0	0
2	24958945	.	C	T	1	3	4	0	0	4	0	0
2	24961833	.	C	T	0	4	4	0	3	7	0	0
2	24964333	.	A	G	2	2	4	0	0	4	0	0
2	24964336	.	C	A	0	3	3	0	2	5	0	0
2	24964691	.	T	A	3	3	6	0	0	6	0	0
2	24969647	.	C	T	2	3	5	0	0	5	0	0
2	24969756	.	G	A	4	2	6	0	0	6	0	0
2	24990629	.	T	A	7	3	10	0	1	11	0	0
2	24990751	.	A	T	4	4	8	0	0	8	0	0
2	24990845	.	T	C	6	6	12	0	0	12	0	0
2	24991202	.	C	G	15	15	30	0	1	31	0	0
2	24991265	.	T	G	17	11	28	0	2	30	0	0
2	24991387	.	G	T	20	9	29	0	1	30	0	0
2	24991429	.	G	A	12	15	27	0	3	30	0	0
2	24991909	.	A	G	10	14	24	0	0	24	0	0
2	24992002	.	T	C	10	1	11	0	15	26	0	0
2	24992035	.	A	C	7	10	17	0	0	17	0	0
2	24992110	.	G	A	14	16	30	0	3	33	0	0
2	24992134	.	G	A	13	14	27	0	1	28	0	0
2	24992185	.	T	C	11	13	24	0	1	25	0	0
2	24992242	.	C	T	1	12	13	0	13	26	0	0
2	24992368	.	T	C	9	9	18	0	1	19	0	0
2	24992464	.	C	T	16	10	26	0	5	31	0	0
2	24992536	.	C	G	12	12	24	0	2	26	0	0
2	24992584	.	G	A	10	10	20	0	0	20	0	0
2	25074873	.	C	T	2	2	4	0	0	4	0	0
2	25083763	.	C	A	1	1	2	0	1	3	0	0
2	25087221	.	G	T	1	3	4	0	0	4	0	0
2	25097106	.	G	A	1	4	5	0	1	6	0	0
2	25097289	.	G	A	3	3	6	0	0	6	0	0
2	25097543	.	C	T	5	4	9	0	1	10	0	0
2	25097582	.	T	C	3	5	8	0	0	8	0	0
2	25099926	.	T	C	5	5	10	0	0	10	0	0
2	25105482	.	G	A	7	7	14	0	0	14	0	0
2	25105586	.	C	T	9	6	15	0	0	15	0	0
2	25105618	.	A	C	10	5	15	0	0	15	0	0
2	25105716	.	T	C	13	4	17	0	2	19	0	0
2	25105900	.	C	T	9	11	20	0	1	21	0	0
2	25105992	.	G	A	6	4	10	0	1	11	0	0
2	25106020	.	T	C	4	4	8	0	0	8	0	0
2	25106099	.	G	T	6	5	11	0	0	11	0	0
2	25106310	.	A	T	11	9	20	0	0	20	0	0
2	25106346	.	A	T	7	4	11	0	1	12	0	0
2	25106380	.	A	G	5	3	8	0	1	9	0	0
2	25106402	.	C	A	7	5	12	0	1	13	0	0
2	25106554	.	G	T	7	4	11	0	0	11	0	0
2	25106631	.	C	G	5	6	11	0	1	12	0	0
2	25106874	.	A	C	8	3	11	0	0	11	0	0
2	25106984	.	A	T	4	2	6	0	0	6	0	0
2	25107843	.	G	C	11	8	19	0	0	19	0	0
2	25107891	.	G	T	12	12	24	0	3	27	0	0
2	25108104	.	A	G	12	12	24	0	1	25	0	0
2	25108377	.	T	A	6	3	9	0	0	9	0	0
2	25108865	.	T	C	6	5	11	0	1	12	0	0
2	25118023	.	A	G	1	5	6	0	0	6	0	0
2	25124875	.	G	A	0	3	3	0	1	4	0	0
2	25125073	.	G	A	2	2	4	0	0	4	0	0
2	25127132	.	C	A	5	4	9	0	2	11	0	0
2	25127219	.	T	C	4	3	7	0	0	7	0	0
2	25127261	.	G	T	1	4	5	0	6	11	0	0
2	25127651	.	C	T	2	3	5	0	0	5	0	0
2	25127876	.	G	A	0	2	2	0	4	6	0	0
2	25128019	.	C	G	2	4	6	0	0	7	1	0
2	25128024	.	C	T	3	4	7	0	0	7	0	0
2	25128668	.	C	T	8	10	18	0	0	18	0	0
2	25128780	.	T	A	12	5	17	0	0	17	0	0
2	25128858	.	C	T	9	6	15	0	1	16	0	0
2	25132600	.	A	T	1	2	3	0	0	3	0	0
2	25247496	.	T	G	1	0	1	0	3	4	0	0
2	25247499	.	T	G	1	3	4	0	0	4	0	0
2	25289919	.	G	T	1	3	4	0	0	4	0	0
2	25289933	.	G	A	0	2	2	0	1	3	0	0
2	25290595	.	C	A	2	3	5	0	1	6	0	0
2	25290690	.	A	C	2	3	5	0	1	6	0	0
2	25528512	.	A	G	2	0	2	0	3	5	0	0
2	25541074	.	A	C	1	2	3	0	0	3	0	0
2	25542237	.	G	A	2	3	5	0	0	5	0	0
2	25542890	.	C	A	7	3	10	0	2	12	0	0
2	25551530	.	A	G	1	3	4	0	0	4	0	0
2	25617002	.	C	A	1	2	3	0	0	3	0	0
2	25617005	.	A	C	1	2	3	0	0	3	0	0
2	25658376	.	G	T	2	3	5	0	0	5	0	0
2	25681707	.	C	A	2	3	5	0	0	5	0	0
2	25759446	.	C	A	3	4	7	0	0	7	0	0
2	25759497	.	G	A	2	7	9	0	0	9	0	0
2	25772113	.	G	A	5	4	9	0	1	10	0	0
2	25794241	.	C	A	6	7	13	0	0	13	0	0
2	25798647	.	A	G	4	6	10	0	0	10	0	0
2	25815407	.	A	T	11	7	18	0	3	21	0	0
2	25815737	.	G	T	7	6	13	0	1	14	0	0
2	25815758	.	C	T	6	3	9	0	2	11	0	0
2	25816321	.	C	T	8	7	15	0	1	16	0	0
2	25839381	.	G	T	0	8	8	0	8	16	0	0
2	25843532	.	T	C	15	12	27	0	0	27	0	0
2	25843806	.	G	A	1	12	13	0	14	27	0	0
2	25844341	.	T	C	10	10	20	0	2	22	0	0
2	25844345	.	A	T	9	12	21	0	1	22	0	0
2	25844840	.	C	T	12	17	29	2	0	31	0	0
2	25929801	.	C	T	3	3	6	0	0	6	0	0
2	25947351	.	C	T	3	4	7	0	1	8	0	0
2	25947354	.	T	A	5	3	8	0	0	8	0	0
2	25947678	.	T	C	3	3	6	0	0	6	0	0
2	25947699	.	T	C	3	2	5	0	0	5	0	0
2	25952800	.	C	T	4	3	7	0	0	7	0	0
2	25952983	.	C	T	3	2	5	0	3	8	0	0
2	25984751	.	G	A	5	3	8	0	1	9	0	0
2	25984970	.	C	T	13	6	19	0	0	19	0	0
2	25984982	.	C	T	8	8	16	0	1	17	0	0
2	25985012	.	C	T	10	9	19	0	0	19	0	0
2	25985219	.	T	C	3	4	7	0	0	7	0	0
2	25985234	.	G	A	2	3	5	0	1	6	0	0
2	25985268	.	G	A	4	6	10	0	0	10	0	0
2	25985300	.	A	C	6	7	13	0	0	13	0	0
2	25985405	.	C	T	8	5	13	0	2	15	0	0
2	25985409	.	C	T	9	7	16	0	0	16	0	0
2	25988570	.	T	C	6	11	17	0	1	18	0	0
2	25988633	.	A	G	3	7	10	0	0	10	0	0
2	25988635	.	A	G	3	7	10	0	0	10	0	0
2	25988846	.	A	G	10	2	12	0	8	20	0	0
2	25988874	.	T	C	11	12	23	0	2	25	0	0
2	25988991	.	T	C	6	2	8	0	0	8	0	0
2	25988992	.	C	A	5	2	7	0	1	8	0	0
2	25989134	.	A	G	8	12	20	0	1	21	0	0
2	25989142	.	T	G	9	9	18	0	1	19	0	0
2	25989246	.	T	A	10	13	23	0	3	26	0	0
2	25989290	.	T	G	10	14	24	0	1	25	0	0
2	25990020	.	C	A	16	13	29	0	5	34	0	0
2	25990323	.	G	A	18	14	32	1	2	35	0	0
2	25990563	.	A	G	11	9	20	4	2	26	0	0
2	25990628	.	C	A	16	9	25	0	0	25	0	0
2	25990702	.	G	A	22	18	40	0	2	42	0	0
2	25997982	.	G	A	6	3	9	0	1	10	0	0
2	26155762	.	G	A	1	6	7	0	1	8	0	0
2	26179171	.	A	T	3	3	6	0	0	6	0	0
2	26179183	.	G	A	4	3	7	0	0	7	0	0
2	26199708	.	C	T	5	5	10	0	0	10	0	0
2	26199714	.	C	T	4	5	9	0	0	9	0	0
2	26207155	.	C	T	9	4	13	0	0	13	0	0
2	26207350	.	G	A	7	11	18	0	0	18	0	0
2	26207713	.	G	A	5	3	8	0	1	9	0	0
2	26207752	.	C	T	8	7	15	0	0	15	0	0
2	26207938	.	C	T	13	7	20	0	1	21	0	0
2	26208480	.	A	C	9	9	18	0	1	19	0	0
2	26208520	.	A	G	10	7	17	0	0	17	0	0
2	26208589	.	A	G	9	13	22	0	0	22	0	0
2	26208668	.	T	G	16	0	16	0	9	25	0	0
2	26208733	.	C	A	8	3	11	0	0	11	0	0
2	26208815	.	G	T	11	11	22	1	0	23	0	0
2	26208996	.	A	G	13	5	18	0	2	20	0	0
2	26209120	.	C	T	9	8	17	0	1	18	0	0
2	26209141	.	G	A	3	6	9	0	3	12	0	0
2	26209266	.	A	C	6	5	11	0	1	12	0	0
2	26209325	.	G	A	4	3	7	0	0	7	0	0
2	26240742	.	C	T	13	17	30	0	10	40	0	0
2	26240771	.	A	T	26	18	44	0	1	45	0	0
2	26240857	.	C	T	20	15	35	0	2	37	0	0
2	26277924	.	C	A	23	22	45	0	5	50	0	0
2	26278044	.	G	A	15	29	44	1	3	48	0	0
2	26282745	.	C	T	31	21	52	0	1	53	0	0
2	26282829	.	A	G	28	0	28	0	22	50	0	0
2	26283181	.	C	T	16	20	36	0	2	38	0	0
2	26283723	.	A	G	11	14	25	0	0	25	0	0
2	26283922	.	T	G	19	24	43	0	1	44	0	0
2	26298571	.	C	T	1	2	3	0	0	3	0	0
2	26300085	.	A	G	3	2	5	0	0	5	0	0
2	26300091	.	G	A	1	2	3	0	2	5	0	0
2	26303689	.	A	T	7	3	10	0	0	10	0	0
2	26303719	.	T	G	3	0	3	0	5	8	0	0
2	26303845	.	A	C	7	5	12	0	1	13	0	0
2	26304008	.	C	A	3	5	8	0	0	8	0	0
2	26304173	.	G	A	2	3	5	0	0	5	0	0
2	26304329	.	A	G	6	4	10	0	0	10	0	0
2	26422266	.	G	T	0	7	7	0	5	14	2	0
2	26422287	.	C	T	11	4	15	0	0	15	0	0
2	26422332	.	C	T	7	10	17	0	1	18	0	0
2	26422359	.	C	T	9	7	16	0	0	16	0	0
2	26443146	.	G	T	19	11	30	0	1	31	0	0
2	26443517	.	T	C	6	2	8	0	0	8	0	0
2	26444190	.	A	T	3	3	6	0	2	8	0	0
2	26444332	.	C	A	2	2	4	0	0	4	0	0
2	26444403	.	G	A	1	5	6	0	3	9	0	0
2	26463199	.	C	A	1	4	5	0	1	6	0	0
2	26463309	.	C	T	5	5	10	0	1	11	0	0
2	26463534	.	C	A	9	5	14	0	0	14	0	0
2	26467072	.	A	G	7	3	10	0	0	10	0	0
2	26467131	.	T	G	6	4	10	0	0	10	0	0
2	26467150	.	G	A	5	5	10	0	0	10	0	0
2	26467291	.	T	C	7	4	11	0	0	11	0	0
2	26469030	.	C	T	0	5	5	0	3	8	0	0
2	26470237	.	G	T	16	12	28	0	0	28	0	0
2	26470267	.	G	A	13	11	24	0	0	24	0	0
2	26470357	.	G	A	16	16	32	0	0	32	0	0
2	26470537	.	C	T	28	16	44	0	2	46	0	0
2	26470636	.	C	T	1	16	17	0	20	37	0	0
2	26470666	.	A	G	15	16	31	0	3	34	0	0
2	26473106	.	T	C	14	19	33	0	0	33	0	0
2	26473361	.	C	T	19	19	38	0	1	39	0	0
2	26481029	.	C	T	4	6	10	0	0	10	0	0
2	26483946	.	G	T	6	2	8	0	1	9	0	0
2	26486605	.	A	G	8	7	15	0	4	19	0	0
2	26489500	.	C	T	4	9	13	0	0	13	0	0
2	26491676	.	A	T	15	11	26	0	0	26	0	0
2	26499519	.	C	T	32	17	49	0	0	49	0	0
2	26500872	.	T	C	33	29	62	0	2	64	0	0
2	26500899	.	G	A	35	24	59	0	8	67	0	0
2	26500989	.	C	T	32	38	70	0	2	72	0	0
2	26501832	.	A	G	5	2	7	0	0	7	0	0
2	26577314	.	T	A	4	14	18	0	1	19	0	0
2	26578227	.	T	G	6	9	15	0	0	15	0	0
2	26578280	.	G	T	4	8	12	0	1	13	0	0
2	26581675	.	G	C	5	2	7	0	1	8	0	0
2	26599057	.	C	T	1	3	4	0	0	4	0	0
2	26607181	.	G	C	2	2	4	0	0	4	0	0
2	26607399	.	T	C	4	2	6	0	1	7	0	0
2	26609832	.	G	C	3	5	8	0	0	8	0	0
2	26610677	.	T	C	2	2	4	0	1	5	0	0
2	26612624	.	G	C	6	5	11	0	1	12	0	0
2	26619829	.	G	T	19	20	39	0	3	42	0	0
2	26627301	.	C	A	27	15	42	0	1	43	0	0
2	26627332	.	T	A	25	15	40	0	0	40	0	0
2	26631084	.	G	A	12	11	23	0	2	25	0	0
2	26632384	.	T	G	17	19	36	0	2	38	0	0
2	26638857	.	C	T	3	8	11	0	1	12	0	0
2	26639157	.	T	C	19	8	27	0	0	27	0	0
2	26662143	.	T	A	8	3	11	0	1	12	0	0
2	26665081	.	A	G	5	11	16	0	1	17	0	0
2	26665155	.	A	T	9	6	15	0	0	15	0	0
2	26665233	.	G	A	5	6	11	0	0	11	0	0
2	26665375	.	A	G	4	4	8	0	0	8	0	0
2	26665824	.	A	T	9	7	16	0	0	16	0	0
2	26672488	.	A	G	8	10	18	2	0	20	0	0
2	26672761	.	T	G	7	0	7	0	9	16	0	0
2	26672800	.	G	A	5	2	7	0	0	7	0	0
2	26676715	.	T	A	5	4	9	0	1	10	0	0
2	26676759	.	T	C	10	3	13	0	0	13	0	0
2	26677017	.	C	A	2	7	9	0	0	9	0	0
2	26677111	.	T	A	3	8	11	0	0	11	0	0
2	26677172	.	G	A	3	4	7	0	0	7	0	0
2	26677361	.	C	A	4	4	8	0	0	8	0	0
2	26680440	.	G	A	3	4	7	0	0	7	0	0
2	26681214	.	A	C	3	4	7	0	0	7	0	0
2	26681219	.	T	A	6	3	9	0	0	9	0	0
2	26681958	.	G	T	5	3	8	0	0	8	0	0
2	26682031	.	G	T	1	4	5	0	8	13	0	0
2	26684689	.	A	G	6	9	15	0	0	15	0	0
2	26686340	.	A	T	9	3	12	0	1	13	0	0
2	26697666	.	C	T	2	3	5	0	1	6	0	0
2	26697929	.	A	G	2	3	5	0	0	5	0	0
2	27048999	.	C	A	4	2	6	0	0	6	0	0
2	27075884	.	G	A	0	2	2	0	3	5	0	0
2	27075992	.	A	T	5	6	11	0	1	12	0	0
2	27094393	.	C	T	11	11	22	0	0	22	0	0
2	27540182	.	C	T	9	4	13	0	1	14	0	0
2	27540458	.	C	T	11	9	20	0	0	20	0	0
2	27540488	.	C	A	8	15	23	0	1	24	0	0
2	27540614	.	C	T	7	15	22	0	0	22	0	0
2	27540905	.	T	C	9	10	19	0	0	19	0	0
2	27541778	.	G	T	10	8	18	0	2	20	0	0
2	27541914	.	A	C	10	7	17	0	1	18	0	0
2	27542721	.	C	T	8	13	21	0	1	22	0	0
2	27542856	.	G	A	0	8	8	0	12	20	0	0
2	27542958	.	A	G	9	8	17	0	0	17	0	0
2	27543212	.	T	A	7	12	19	0	0	19	0	0
2	27543499	.	C	A	7	4	11	0	2	13	0	0
2	27614007	.	A	G	1	4	5	0	0	5	0	0
2	27614082	.	G	C	5	6	11	0	0	11	0	0
2	27635788	.	C	T	2	4	6	0	0	6	0	0
2	27635928	.	T	A	4	3	7	0	1	8	0	0
2	27641130	.	G	A	4	2	6	0	0	6	0	0
2	27641287	.	G	A	1	4	5	0	0	5	0	0
2	27642776	.	C	G	1	3	4	0	0	4	0	0
2	27658566	.	A	G	1	7	8	0	1	9	0	0
2	27658651	.	T	C	3	2	5	0	0	5	0	0
2	27658973	.	T	G	6	8	14	0	0	14	0	0
2	27659018	.	T	C	8	5	13	0	0	13	0	0
2	27662374	.	C	T	1	6	7	0	1	8	0	0
2	27662706	.	T	C	2	3	5	0	0	5	0	0
2	27662744	.	A	T	2	2	4	0	0	4	0	0
2	27663344	.	A	G	6	5	11	0	0	11	0	0
2	27663402	.	T	C	9	3	12	0	0	12	0	0
2	27663435	.	C	T	7	4	11	0	2	13	0	0
2	27664143	.	G	T	4	2	6	0	1	7	0	0
2	27664195	.	A	C	3	4	7	0	0	8	1	0
2	27664317	.	G	T	4	4	8	0	0	8	0	0
2	27664343	.	C	T	1	3	4	0	0	4	0	0
2	27664407	.	G	C	1	5	6	0	0	6	0	0
2	27664482	.	G	C	2	2	4	0	0	4	0	0
2	27664665	.	A	C	2	3	5	0	0	5	0	0
2	27672103	.	T	C	7	11	18	0	0	18	0	0
2	27672426	.	T	C	8	14	22	0	0	22	0	0
2	27672440	.	C	T	0	12	12	0	11	23	0	0
2	27672535	.	C	T	10	7	17	0	1	18	0	0
2	27673041	.	A	G	10	6	16	1	0	17	0	0
2	27673080	.	G	A	8	9	17	0	1	18	0	0
2	27673148	.	G	A	8	4	12	0	0	12	0	0
2	27673173	.	A	G	6	4	10	0	1	11	0	0
2	27673194	.	C	T	7	3	10	0	0	10	0	0
2	27812578	.	G	A	6	5	11	0	2	13	0	0
2	27812592	.	C	A	7	5	12	0	0	12	0	0
2	27827558	.	G	A	5	4	9	2	0	11	0	0
2	27827573	.	C	T	6	6	12	2	0	14	0	0
2	27843845	.	G	A	8	5	13	0	0	13	0	0
2	27845694	.	G	A	4	2	6	0	1	7	0	0
2	27845845	.	A	T	4	3	7	0	2	9	0	0
2	27846108	.	G	A	8	4	12	0	2	14	0	0
2	27933143	.	C	T	4	3	7	0	1	8	0	0
2	27933215	.	C	A	3	5	8	0	0	8	0	0
2	27933260	.	C	A	7	4	11	0	1	12	0	0
2	27963686	.	C	T	0	4	4	0	1	5	0	0
2	27966368	.	C	T	0	5	5	0	6	11	0	0
2	27966376	.	G	C	4	4	8	0	0	8	0	0
2	27966602	.	C	T	2	2	4	0	2	6	0	0
2	27966636	.	C	T	1	3	4	0	0	4	0	0
2	27969534	.	T	C	3	3	6	0	0	6	0	0
2	27969966	.	G	A	1	2	3	0	0	3	0	0
2	27969985	.	A	G	2	2	4	0	0	4	0	0
2	27970017	.	A	G	1	2	3	0	0	3	0	0
2	27975443	.	G	T	3	6	9	0	0	9	0	0
2	27975458	.	T	C	5	5	10	0	1	11	0	0
2	27975486	.	T	A	5	4	9	0	0	9	0	0
2	28049696	.	C	T	8	10	18	0	2	20	0	0
2	28049996	.	A	G	6	9	15	0	1	16	0	0
2	28050058	.	C	A	7	7	14	0	0	14	0	0
2	28050243	.	T	C	9	1	10	0	8	18	0	0
2	28050565	.	T	A	4	7	11	0	1	12	0	0
2	28050759	.	A	G	5	4	9	0	0	9	0	0
2	28050921	.	G	T	9	5	14	0	1	15	0	0
2	28050933	.	G	A	6	8	14	0	0	14	0	0
2	28051041	.	T	A	4	11	15	0	0	15	0	0
2	28051092	.	C	T	1	7	8	0	13	21	0	0
2	28051104	.	G	A	13	8	21	0	1	22	0	0
2	28057518	.	G	A	8	11	19	0	0	19	0	0
2	28077152	.	C	A	0	4	4	0	3	7	0	0
2	28649938	.	A	T	1	2	3	0	0	3	0	0
2	28649945	.	A	T	1	2	3	0	0	3	0	0
2	28650052	.	G	T	1	1	2	0	1	3	0	0
2	28650074	.	T	A	1	1	2	0	0	2	0	0
2	28650238	.	A	G	7	4	11	0	2	13	0	0
2	28650248	.	C	A	5	4	9	0	4	13	0	0
2	28650273	.	C	A	8	4	12	0	1	13	0	0
2	28650309	.	A	T	7	4	11	0	0	11	0	0
2	28650352	.	A	C	8	6	14	0	0	14	0	0
2	28650358	.	T	A	7	5	12	0	1	13	0	0
2	28650422	.	T	C	4	4	8	0	0	8	0	0
2	28650504	.	T	C	3	6	9	0	0	9	0	0
2	28650521	.	G	A	4	1	5	0	0	6	1	0
2	28651497	.	G	A	6	3	9	0	0	9	0	0
2	28657867	.	G	A	5	2	7	0	0	7	0	0
2	28657936	.	T	C	5	3	8	0	1	9	0	0
2	28671081	.	G	A	2	3	5	0	1	6	0	0
2	28671093	.	C	A	1	4	5	0	1	6	0	0
2	28929177	.	G	A	0	6	6	0	3	9	0	0
2	28930100	.	T	C	8	5	13	0	0	13	0	0
2	28933846	.	T	G	5	13	18	0	0	18	0	0
2	28934011	.	C	T	9	6	15	0	0	15	0	0
2	28934152	.	T	C	6	6	12	0	0	12	0	0
2	29317718	.	G	A	7	4	11	0	1	12	0	0
2	29352279	.	G	A	1	17	18	0	7	25	0	0
2	29352333	.	G	A	1	11	12	0	1	13	0	0
2	29352379	.	A	C	7	9	16	0	0	16	0	0
2	29352411	.	A	C	9	8	17	0	3	20	0	0
2	29352481	.	G	C	7	8	15	0	0	15	0	0
2	29352579	.	T	C	8	5	13	0	0	13	0	0
2	29352673	.	C	T	13	5	18	0	0	18	0	0
2	29477653	.	T	C	20	13	33	0	0	33	0	0
2	29477733	.	A	T	17	16	33	0	1	34	0	0
2	29477769	.	G	T	15	15	30	0	4	34	0	0
2	29482390	.	G	A	13	7	20	0	0	20	0	0
2	29482417	.	A	G	11	6	17	0	1	18	0	0
2	29485046	.	G	A	8	16	24	0	0	24	0	0
2	29485068	.	G	T	16	7	23	0	0	23	0	0
2	31299241	.	A	C	0	28	28	0	1	29	0	0
2	31451661	.	A	G	13	8	21	0	0	21	0	0
2	31827396	.	G	A	8	11	19	1	1	21	0	0
2	31827474	.	A	T	9	2	11	0	0	11	0	0
2	32591323	.	A	G	4	2	6	0	0	6	0	0
2	32623878	.	C	T	8	6	14	7	0	21	0	0
2	33416771	.	T	A	2	3	5	0	0	5	0	0
2	33416819	.	G	A	1	2	3	0	1	4	0	0
2	33417504	.	G	T	3	1	4	0	1	5	0	0
2	33417661	.	A	T	1	5	6	0	0	6	0	0
2	33417700	.	C	T	4	6	10	0	0	10	0	0
2	33418534	.	C	A	2	3	5	0	0	5	0	0
2	33419463	.	G	C	2	2	4	0	0	4	0	0
2	33419602	.	A	G	6	4	10	0	0	10	0	0
2	33419650	.	A	G	5	4	9	1	0	10	0	0
2	33419661	.	C	T	1	6	7	1	1	9	0	0
2	33420272	.	G	T	7	2	9	0	0	9	0	0
2	33420384	.	G	A	0	3	3	0	4	7	0	0
2	33420806	.	C	T	5	6	11	0	0	11	0	0
2	33420975	.	G	A	1	14	15	0	6	21	0	0
2	33421078	.	G	T	7	5	12	0	0	12	0	0
2	33421146	.	G	A	5	3	8	0	0	8	0	0
2	33421154	.	G	A	5	2	7	0	0	7	0	0
2	33421200	.	C	T	9	8	17	0	0	17	0	0
2	33421222	.	A	C	11	8	19	0	2	21	0	0
2	33421275	.	C	G	7	3	10	0	0	10	0	0
2	33421276	.	T	C	7	3	10	0	0	10	0	0
2	33421331	.	C	A	4	9	13	0	0	13	0	0
2	33421382	.	A	T	6	11	17	0	0	17	0	0
2	33421404	.	T	A	7	10	17	0	0	17	0	0
2	33421441	.	T	G	7	1	8	0	9	17	0	0
2	33421613	.	C	T	8	5	13	0	0	13	0	0
2	33421720	.	A	G	8	10	18	0	1	19	0	0
2	33421774	.	A	G	11	6	17	0	0	17	0	0
2	33422211	.	G	A	9	7	16	0	0	16	0	0
2	33422374	.	T	G	16	1	17	0	18	35	0	0
2	33422484	.	G	A	4	7	11	0	8	19	0	0
2	33422565	.	C	A	20	19	39	1	1	41	0	0
2	33422604	.	C	T	21	27	48	0	0	48	0	0
2	33477014	.	G	T	4	3	7	0	0	7	0	0
2	33477073	.	C	T	2	3	5	0	0	5	0	0
2	33477139	.	G	A	7	5	12	0	0	12	0	0
2	33492685	.	T	C	5	0	5	0	3	8	0	0
2	33522130	.	A	T	3	3	6	0	1	7	0	0
2	33590448	.	C	T	6	2	8	0	0	8	0	0
2	33676391	.	G	A	5	2	7	0	1	8	0	0
2	33681330	.	G	A	21	33	54	0	2	56	0	0
2	33681483	.	A	G	15	20	35	0	2	38	1	0
2	33681701	.	A	T	17	22	39	0	0	39	0	0
2	33682321	.	G	A	19	19	38	0	1	40	1	0
2	33682323	.	T	A	18	21	39	0	2	41	0	0
2	33685582	.	T	A	18	14	32	0	5	37	0	0
2	33687110	.	C	A	17	23	40	0	1	41	0	0
2	33821103	.	C	G	2	3	5	0	0	5	0	0
2	34022992	.	T	A	13	5	18	0	0	18	0	0
2	34024832	.	A	G	12	6	18	0	1	19	0	0
2	34025152	.	C	A	4	6	10	0	0	10	0	0
2	34025167	.	G	A	5	7	12	0	0	12	0	0
2	34029353	.	G	A	8	5	13	0	0	13	0	0
2	34065661	.	G	A	1	4	5	0	0	5	0	0
2	34071479	.	G	T	4	3	7	0	1	9	1	0
2	34071955	.	A	T	3	4	7	0	0	7	0	0
2	34112170	.	C	G	1	0	1	0	2	3	0	0
2	34113147	.	A	G	1	2	3	0	0	3	0	0
2	34113153	.	A	G	1	2	3	0	0	3	0	0
2	34115340	.	C	A	2	3	5	0	2	7	0	0
2	34122859	.	A	G	6	9	15	0	1	16	0	0
2	34122886	.	C	A	5	10	15	0	1	16	0	0
2	34122928	.	C	T	5	8	13	0	0	13	0	0
2	34125775	.	G	A	0	14	14	0	11	25	0	0
2	34125909	.	A	T	11	6	17	0	2	20	1	0
2	34126040	.	T	C	4	6	10	1	0	11	0	0
2	34126514	.	G	T	6	6	12	0	0	12	0	0
2	34126588	.	A	T	8	6	14	0	0	14	0	0
2	34152985	.	G	A	1	4	5	0	0	5	0	0
2	34156264	.	A	C	1	1	2	0	1	3	0	0
2	34160995	.	G	A	1	4	5	1	0	6	0	0
2	34173136	.	G	A	3	4	7	0	0	7	0	0
2	34173253	.	C	T	5	2	7	0	0	7	0	0
2	34173297	.	C	A	8	7	15	0	0	15	0	0
2	34173335	.	A	C	4	7	11	0	0	11	0	0
2	34173360	.	C	T	2	7	9	0	0	9	0	0
2	34381013	.	T	G	7	15	22	0	0	22	0	0
2	34381032	.	T	C	7	12	19	0	0	19	0	0
2	34460848	.	G	A	7	5	12	0	0	12	0	0
2	34555410	.	A	G	5	3	8	0	0	8	0	0
2	34924412	.	A	G	11	20	31	0	1	32	0	0
2	35610890	.	T	G	4	11	15	1	1	17	0	0
2	37823576	.	A	T	0	2	2	0	0	2	0	0
2	37823592	.	A	T	1	3	4	0	1	5	0	0
2	37826819	.	A	C	3	7	10	0	3	13	0	0
2	37826933	.	T	C	1	4	5	0	0	5	0	0
2	38204025	.	C	A	1	10	11	0	0	11	0	0
2	38214974	.	T	G	9	3	12	31	0	43	0	0
2	39005950	.	C	T	10	2	12	0	0	12	0	0
2	39553038	.	A	G	5	2	7	0	0	7	0	0
2	39553628	.	T	A	6	2	8	0	0	8	0	0
2	39553632	.	T	A	5	2	7	0	2	9	0	0
2	41542707	.	A	T	5	6	11	0	1	12	0	0
2	41578137	.	G	T	24	9	33	2	0	37	2	0
2	41581035	.	T	A	32	17	49	6	2	57	0	0
2	41581042	.	C	G	2	9	11	1	38	50	0	0
2	41582801	.	T	C	1	10	11	0	0	11	0	0
2	42420541	.	T	C	9	3	12	0	0	12	0	0
2	45655691	.	G	A	13	3	16	0	1	17	0	0
2	46140470	.	T	C	1	5	6	0	0	6	0	0
2	46140479	.	T	C	1	4	5	0	0	5	0	0
2	46140512	.	G	A	2	3	5	0	0	5	0	0
2	46140539	.	G	A	2	4	6	0	0	6	0	0
2	46175367	.	G	T	1	4	5	0	3	8	0	0
2	46175484	.	C	T	7	3	10	0	2	12	0	0
2	46176783	.	A	G	3	6	9	0	0	9	0	0
2	46176822	.	T	C	6	4	10	0	0	10	0	0
2	46181029	.	T	C	8	6	14	0	0	14	0	0
2	46183855	.	T	C	12	5	17	0	0	17	0	0
2	46183897	.	G	A	18	10	28	0	0	28	0	0
2	46183985	.	A	T	13	10	23	0	0	23	0	0
2	46184024	.	T	A	12	7	19	0	1	20	0	0
2	46184057	.	C	A	15	8	23	0	0	23	0	0
2	46184193	.	C	T	7	13	20	0	1	21	0	0
2	46184248	.	G	C	9	8	17	0	1	19	1	0
2	46184277	.	C	A	8	5	13	0	0	13	0	0
2	46184287	.	T	G	7	0	7	0	3	11	1	0
2	46184555	.	A	G	8	15	23	0	1	24	0	0
2	46715639	.	G	A	0	2	2	0	1	3	0	0
2	47472068	.	T	A	5	3	8	0	1	9	0	0
2	47495077	.	T	C	8	3	11	0	0	11	0	0
2	47500251	.	C	T	7	7	14	0	1	15	0	0
2	47506185	.	C	T	2	7	9	0	0	9	0	0
2	47506187	.	G	A	4	7	11	0	0	11	0	0
2	47511341	.	T	C	12	19	31	0	0	31	0	0
2	47512820	.	G	A	10	14	24	0	0	24	0	0
2	47513002	.	G	T	13	10	23	0	2	25	0	0
2	47513391	.	G	A	0	7	7	0	6	13	0	0
2	47513712	.	C	A	15	13	28	0	3	31	0	0
2	47513871	.	C	A	16	16	32	0	1	33	0	0
2	47514001	.	A	G	14	18	32	0	0	32	0	0
2	47514504	.	C	A	4	2	6	0	0	6	0	0
2	47514582	.	T	G	8	13	21	0	0	21	0	0
2	47514613	.	T	A	9	15	24	0	0	24	0	0
2	47514619	.	A	T	10	15	25	0	1	26	0	0
2	47514697	.	A	G	12	14	26	0	1	27	0	0
2	47514878	.	T	G	17	19	36	0	1	37	0	0
2	47515019	.	T	C	17	16	33	0	0	33	0	0
2	47515073	.	T	C	18	12	30	0	3	33	0	0
2	47515111	.	G	A	19	13	32	0	2	34	0	0
2	47515223	.	T	A	9	13	22	0	2	24	0	0
2	47582559	.	C	G	2	6	8	0	0	8	0	0
2	47582891	.	A	G	26	16	42	0	2	44	0	0
2	47583029	.	C	A	27	28	55	0	0	55	0	0
2	47583377	.	G	A	4	37	41	0	29	70	0	0
2	47583701	.	C	T	29	30	59	0	0	59	0	0
2	47583788	.	T	A	27	30	57	0	1	58	0	0
2	47584064	.	G	A	2	35	37	0	33	70	0	0
2	47584092	.	G	A	33	37	70	0	4	74	0	0
2	47584547	.	T	A	26	25	51	0	3	54	0	0
2	47584612	.	G	A	26	21	47	0	3	50	0	0
2	47584799	.	A	T	39	33	72	0	4	76	0	0
2	47587423	.	A	T	5	2	7	0	0	7	0	0
2	47587472	.	T	C	3	0	3	0	3	6	0	0
2	47587652	.	C	T	7	7	14	0	2	16	0	0
2	47587703	.	A	G	8	7	15	0	2	17	0	0
2	47620714	.	C	T	2	6	8	0	0	8	0	0
2	47633835	.	T	A	7	3	10	0	0	10	0	0
2	47633841	.	C	T	8	3	11	0	0	11	0	0
2	47644488	.	T	G	26	21	47	0	0	48	1	0
2	47648076	.	A	G	25	15	40	0	0	40	0	0
2	47648091	.	T	G	21	14	35	0	2	37	0	0
2	47651598	.	A	G	20	18	38	0	1	39	0	0
2	47652403	.	A	G	16	24	40	0	3	43	0	0
2	47652406	.	A	G	16	25	41	0	2	43	0	0
2	47658641	.	T	G	8	11	19	0	0	19	0	0
2	47658653	.	G	A	8	9	17	0	1	18	0	0
2	47658752	.	A	G	8	7	15	0	1	17	1	0
2	47661273	.	A	C	11	1	12	0	13	25	0	0
2	47662955	.	A	G	10	13	23	0	0	23	0	0
2	47754158	.	T	A	3	3	6	0	1	7	0	0
2	47754160	.	C	A	4	3	7	0	0	7	0	0
2	47829112	.	T	C	6	5	11	0	2	13	0	0
2	47829126	.	C	T	6	5	11	0	2	13	0	0
2	47916384	.	T	A	1	2	3	0	0	3	0	0
2	47916389	.	T	C	1	0	1	0	4	5	0	0
2	47918257	.	T	A	2	3	5	0	0	5	0	0
2	47918584	.	C	T	2	2	4	0	0	4	0	0
2	47955412	.	A	G	3	3	6	0	0	6	0	0
2	47955528	.	T	C	4	2	6	0	0	6	0	0
2	47955530	.	C	G	4	2	6	0	0	6	0	0
2	47955859	.	C	T	0	3	3	0	2	5	0	0
2	48112887	.	A	T	1	4	5	0	0	5	0	0
2	48113040	.	G	A	4	3	7	0	0	7	0	0
2	48114388	.	G	A	3	5	8	0	0	8	0	0
2	48114391	.	T	G	3	0	3	0	6	9	0	0
2	48115732	.	T	A	5	5	10	0	1	11	0	0
2	48115990	.	C	T	5	6	11	0	0	11	0	0
2	48118470	.	T	C	4	3	7	0	4	11	0	0
2	48118485	.	G	A	2	9	11	0	8	19	0	0
2	48119134	.	G	A	1	10	11	0	1	12	0	0
2	48119209	.	G	A	2	4	6	0	0	6	0	0
2	48119530	.	T	A	1	2	3	0	0	3	0	0
2	48119631	.	A	C	7	8	15	0	0	15	0	0
2	48119696	.	A	T	6	13	19	0	0	19	0	0
2	48119704	.	A	T	5	11	16	0	2	18	0	0
2	48119744	.	A	G	11	14	25	0	0	25	0	0
2	48119793	.	A	C	11	15	26	0	3	30	1	0
2	48119821	.	T	A	10	13	23	0	0	23	0	0
2	48120190	.	A	T	14	5	19	0	0	20	1	0
2	48120273	.	T	C	26	4	30	0	1	31	0	0
2	48120274	.	T	A	27	4	31	0	1	32	0	0
2	48120318	.	A	T	18	6	24	0	1	25	0	0
2	48120392	.	C	G	18	2	20	0	0	20	0	0
2	48120401	.	A	G	15	4	19	0	0	19	0	0
2	48120430	.	C	T	11	6	17	0	0	17	0	0
2	48120462	.	T	A	7	11	18	0	0	18	0	0
2	48120516	.	T	C	18	15	33	0	0	33	0	0
2	48120689	.	G	A	17	9	26	0	1	27	0	0
2	48120694	.	C	G	16	9	25	0	1	26	0	0
2	48120743	.	T	C	10	9	19	0	0	19	0	0
2	48120744	.	G	A	10	9	19	0	0	19	0	0
2	48120805	.	T	A	9	6	15	0	0	15	0	0
2	48120825	.	A	C	8	4	12	0	0	12	0	0
2	48120864	.	C	A	4	2	6	0	0	6	0	0
2	48121312	.	G	A	14	4	18	0	0	18	0	0
2	48121351	.	G	C	17	7	24	0	1	25	0	0
2	48121352	.	T	C	18	7	25	0	1	26	0	0
2	48121428	.	T	A	11	5	16	0	1	17	0	0
2	48121713	.	G	T	6	3	9	0	1	10	0	0
2	48121743	.	A	G	5	6	11	0	0	11	0	0
2	48127810	.	A	G	5	3	8	0	0	8	0	0
2	48130185	.	G	A	5	2	7	0	0	7	0	0
2	48130200	.	G	A	5	2	7	0	0	7	0	0
2	48130224	.	A	G	5	2	7	0	0	7	0	0
2	48137605	.	A	G	1	3	4	0	0	4	0	0
2	48142617	.	C	T	0	2	2	0	2	4	0	0
2	48203544	.	A	G	19	11	30	0	0	30	0	0
2	48203554	.	C	T	20	15	35	0	0	35	0	0
2	48203622	.	G	A	15	14	29	0	1	30	0	0
2	48203920	.	C	A	1	9	10	0	10	20	0	0
2	48207319	.	C	T	2	9	11	0	19	30	0	0
2	48212114	.	C	A	8	14	22	0	0	22	0	0
2	48217207	.	T	C	9	12	21	0	0	21	0	0
2	48217229	.	T	A	10	8	18	0	2	20	0	0
2	48221479	.	C	T	2	8	10	0	10	20	0	0
2	48224011	.	T	C	10	4	14	0	2	16	0	0
2	48232643	.	T	A	3	3	6	0	1	7	0	0
2	48284721	.	G	A	22	21	43	0	1	44	0	0
2	48285153	.	C	G	18	16	34	0	0	34	0	0
2	48285241	.	T	G	13	12	25	0	2	28	1	0
2	48285265	.	A	C	12	14	26	0	0	26	0	0
2	48290805	.	A	T	22	39	61	0	4	65	0	0
2	48290820	.	C	T	21	37	58	0	3	61	0	0
2	48304467	.	G	A	11	16	27	0	1	28	0	0
2	48309874	.	T	A	13	13	26	0	1	27	0	0
2	48309876	.	A	T	14	13	27	0	0	27	0	0
2	48309970	.	C	A	17	14	31	0	2	33	0	0
2	48310207	.	C	T	3	9	12	0	12	24	0	0
2	48310258	.	A	T	15	3	18	0	0	18	0	0
2	48310266	.	T	C	14	0	14	0	3	17	0	0
2	48310330	.	C	G	7	8	15	0	0	15	0	0
2	48310342	.	A	G	4	9	13	0	2	15	0	0
2	48310374	.	G	A	4	7	11	0	0	11	0	0
2	48313598	.	A	G	14	18	32	0	1	33	0	0
2	48317363	.	G	T	19	11	30	0	2	32	0	0
2	48317418	.	C	G	15	9	24	0	0	24	0	0
2	48317444	.	G	T	15	13	28	0	1	29	0	0
2	48323317	.	C	T	9	7	16	0	0	16	0	0
2	48323341	.	T	C	10	9	19	0	0	19	0	0
2	48323470	.	A	T	13	12	25	0	2	27	0	0
2	48323562	.	A	T	10	20	30	0	5	35	0	0
2	48323572	.	A	G	14	17	31	0	6	37	0	0
2	48323695	.	A	G	20	19	39	0	0	39	0	0
2	48323863	.	A	G	15	17	32	0	0	32	0	0
2	48326354	.	G	A	9	14	23	0	0	23	0	0
2	48326408	.	C	T	2	12	14	0	5	19	0	0
2	48332566	.	A	G	10	3	13	0	0	13	0	0
2	48335187	.	G	A	11	8	19	0	1	20	0	0
2	48343259	.	T	G	2	3	5	0	0	5	0	0
2	48343367	.	G	A	6	4	10	0	0	10	0	0
2	48344066	.	C	G	2	4	6	0	0	6	0	0
2	48344072	.	T	C	2	0	2	0	4	6	0	0
2	48345379	.	A	G	4	2	6	0	0	6	0	0
2	48356642	.	C	T	2	7	9	0	0	9	0	0
2	48356689	.	T	C	1	6	7	0	1	8	0	0
2	48478608	.	A	G	4	2	6	1	0	7	0	0
2	48512106	.	A	C	3	0	3	0	2	5	0	0
2	48545975	.	A	C	2	2	4	0	0	4	0	0
2	48546121	.	T	A	8	7	15	0	0	15	0	0
2	48552301	.	A	G	1	4	5	0	0	5	0	0
2	48753714	.	C	T	15	6	21	0	1	22	0	0
2	48963111	.	G	A	2	2	4	0	1	5	0	0
2	49007765	.	A	G	12	3	15	0	1	16	0	0
2	49007781	.	A	T	5	12	17	0	1	18	0	0
2	49008073	.	T	A	6	7	13	0	2	15	0	0
2	49008339	.	A	T	6	6	12	0	0	12	0	0
2	49008382	.	T	G	2	8	10	0	1	11	0	0
2	49017754	.	C	T	9	10	19	0	1	20	0	0
2	49609190	.	T	C	3	2	5	0	0	5	0	0
2	49609196	.	T	C	3	0	3	0	2	5	0	0
2	52052697	.	A	G	6	1	7	0	4	11	0	0
2	52052790	.	T	C	5	8	13	0	0	13	0	0
2	52057394	.	A	G	5	0	5	0	15	20	0	0
2	52060070	.	T	G	10	5	15	0	1	16	0	0
2	52060365	.	C	T	9	5	14	0	1	15	0	0
2	52060390	.	T	C	8	5	13	0	0	13	0	0
2	52060409	.	A	G	7	7	14	1	0	15	0	0
2	52060450	.	G	A	6	7	13	5	0	18	0	0
2	52060492	.	A	T	12	3	15	4	0	19	0	0
2	52062918	.	G	A	3	18	21	0	9	30	0	0
2	52062989	.	T	A	8	6	14	0	0	14	0	0
2	52063101	.	T	A	5	5	10	0	0	10	0	0
2	52063128	.	T	C	8	2	10	1	1	12	0	0
2	52063207	.	T	C	4	5	9	0	0	9	0	0
2	52063208	.	C	T	4	5	9	0	0	9	0	0
2	52063250	.	C	G	5	9	14	0	0	14	0	0
2	52810997	.	G	T	2	3	5	0	1	6	0	0
2	52814146	.	C	T	6	9	15	0	2	17	0	0
2	52815260	.	G	A	9	12	21	0	1	22	0	0
2	52815292	.	C	T	12	8	20	0	0	20	0	0
2	52826659	.	A	G	4	7	11	0	0	11	0	0
2	52827067	.	G	A	7	5	12	0	0	12	0	0
2	52827298	.	A	G	6	4	10	0	0	10	0	0
2	53720058	.	G	C	0	8	8	0	5	13	0	0
2	53720098	.	A	G	7	0	7	0	10	17	0	0
2	53720122	.	C	G	6	5	11	0	0	11	0	0
2	53721966	.	G	C	1	3	4	0	0	4	0	0
2	53724856	.	G	A	2	5	7	0	0	7	0	0
2	53750668	.	T	C	13	12	25	0	5	30	0	0
2	53750707	.	C	T	9	7	16	0	3	19	0	0
2	53750719	.	C	T	7	4	11	0	0	11	0	0
2	54830914	.	A	G	1	4	5	0	0	5	0	0
2	54832405	.	A	G	3	3	6	0	0	6	0	0
2	55200897	.	C	T	5	3	8	0	1	9	0	0
2	55210962	.	C	T	2	9	11	0	1	12	0	0
2	55211004	.	G	A	1	4	5	0	3	8	0	0
2	55211034	.	A	G	3	1	4	0	3	7	0	0
2	55211049	.	C	G	3	0	3	0	4	7	0	0
2	55273940	.	G	T	3	3	6	0	0	6	0	0
2	55430016	.	C	T	10	2	12	0	3	15	0	0
2	55430024	.	T	C	10	5	15	0	2	17	0	0
2	55430091	.	T	C	8	11	19	0	0	19	0	0
2	55430128	.	C	T	11	8	19	0	0	19	0	0
2	55430136	.	A	G	9	6	15	0	2	17	0	0
2	55433494	.	C	A	14	15	29	3	2	34	0	0
2	55444789	.	A	G	10	0	10	0	17	27	0	0
2	55444825	.	C	G	14	17	31	0	0	31	0	0
2	55444831	.	A	G	15	17	32	0	1	33	0	0
2	55488992	.	G	A	3	4	7	0	9	16	0	0
2	55489067	.	G	T	2	3	5	0	11	16	0	0
2	55489237	.	T	G	4	4	8	0	0	8	0	0
2	55489383	.	T	A	15	11	26	0	2	28	0	0
2	55490016	.	C	G	9	7	16	0	1	17	0	0
2	55490062	.	C	T	17	12	29	0	1	30	0	0
2	55490232	.	T	C	26	12	38	0	1	39	0	0
2	55490313	.	C	T	13	12	25	0	4	29	0	0
2	55490348	.	G	A	20	12	32	0	1	33	0	0
2	55490434	.	A	G	17	0	17	0	11	28	0	0
2	55490521	.	T	C	17	15	32	0	0	32	0	0
2	55490609	.	A	G	16	6	22	0	0	22	0	0
2	55490934	.	G	T	26	13	39	1	1	41	0	0
2	55491272	.	C	T	16	10	26	0	4	30	0	0
2	55491471	.	C	T	27	20	47	0	1	48	0	0
2	55491666	.	G	A	27	8	35	0	0	35	0	0
2	55491717	.	G	A	21	17	38	0	3	41	0	0
2	55491754	.	C	A	24	23	47	0	0	47	0	0
2	55491884	.	T	C	15	19	34	0	5	39	0	0
2	55491893	.	T	C	15	19	34	0	2	36	0	0
2	55491945	.	A	T	14	19	33	0	2	35	0	0
2	55492064	.	T	C	20	21	41	0	2	43	0	0
2	55492104	.	T	C	13	20	33	0	0	33	0	0
2	55492108	.	A	G	12	0	12	0	20	32	0	0
2	55670477	.	C	A	3	2	5	0	0	5	0	0
2	55670501	.	C	A	4	2	6	0	0	6	0	0
2	55670652	.	C	A	1	3	4	0	0	4	0	0
2	55915156	.	G	C	5	3	8	0	0	8	0	0
2	55916904	.	C	G	6	3	9	0	0	9	0	0
2	55933226	.	C	T	4	5	9	0	0	9	0	0
2	55933491	.	T	A	3	7	10	0	1	11	0	0
2	55944189	.	G	A	6	4	10	0	0	10	0	0
2	55944195	.	C	T	6	4	10	0	0	10	0	0
2	55962664	.	C	A	2	2	4	0	0	4	0	0
2	55962949	.	G	A	4	3	7	0	1	8	0	0
2	55963116	.	G	A	2	2	4	0	0	4	0	0
2	55963134	.	T	G	1	0	1	0	2	3	0	0
2	55963207	.	A	C	1	2	3	0	2	5	0	0
2	55963625	.	A	G	2	2	4	0	0	4	0	0
2	55964168	.	T	C	6	2	8	0	0	8	0	0
2	55964186	.	A	T	8	3	11	0	0	11	0	0
2	55964306	.	A	T	4	2	6	0	0	6	0	0
2	55964935	.	A	T	6	2	8	0	1	9	0	0
2	55964971	.	A	C	8	5	13	0	0	13	0	0
2	55965163	.	A	T	12	18	30	0	1	31	0	0
2	55965256	.	C	T	9	6	15	1	0	16	0	0
2	55965273	.	T	C	9	6	15	2	1	18	0	0
2	55965328	.	C	T	11	9	20	2	0	22	0	0
2	55965684	.	C	T	5	6	11	0	1	12	0	0
2	55965727	.	A	C	7	4	11	0	0	11	0	0
2	55965799	.	G	T	5	10	15	0	0	15	0	0
2	55965898	.	A	G	10	1	11	0	4	15	0	0
2	55965900	.	G	A	0	4	4	0	11	15	0	0
2	55966028	.	A	C	1	4	5	1	5	11	0	0
2	55966612	.	G	C	3	4	7	0	0	7	0	0
2	55966616	.	G	A	4	4	8	0	0	8	0	0
2	55966716	.	G	T	5	13	18	0	0	18	0	0
2	55966822	.	T	G	2	5	7	0	1	8	0	0
2	55966912	.	A	T	4	5	9	0	0	9	0	0
2	55967065	.	T	A	3	4	7	0	0	7	0	0
2	55967188	.	T	C	12	5	17	0	0	17	0	0
2	55967233	.	C	T	7	5	12	0	1	13	0	0
2	55967471	.	A	T	11	12	23	0	0	23	0	0
2	55967638	.	T	A	12	13	25	1	2	28	0	0
2	55967667	.	C	T	13	18	31	0	2	33	0	0
2	55967758	.	T	C	12	12	24	0	1	25	0	0
2	55967908	.	C	A	2	3	5	0	1	6	0	0
2	55967949	.	A	G	2	6	8	0	0	8	0	0
2	55967987	.	T	G	3	8	11	0	0	11	0	0
2	55968123	.	C	A	12	7	19	0	1	20	0	0
2	55968147	.	T	C	18	8	26	0	0	26	0	0
2	55968204	.	A	G	17	8	25	0	0	25	0	0
2	55968240	.	C	T	18	15	33	0	0	33	0	0
2	55968294	.	G	T	17	14	31	0	0	31	0	0
2	55968383	.	A	C	13	15	28	0	0	28	0	0
2	55968411	.	T	G	16	0	16	0	16	32	0	0
2	55968472	.	A	G	15	0	15	0	19	34	0	0
2	55968859	.	A	G	4	9	13	0	0	13	0	0
2	55969691	.	A	G	4	2	6	0	1	7	0	0
2	55970499	.	T	A	6	7	13	0	0	13	0	0
2	55970504	.	C	G	6	7	13	0	0	13	0	0
2	55970625	.	T	A	15	5	20	0	0	20	0	0
2	55970662	.	C	T	14	12	26	0	2	28	0	0
2	55970684	.	C	T	13	11	24	0	1	25	0	0
2	56060865	.	A	T	2	2	4	0	0	4	0	0
2	56061488	.	A	G	1	3	4	5	0	9	0	0
2	56061520	.	C	T	0	3	3	3	2	8	0	0
2	56125231	.	G	A	4	11	15	0	0	15	0	0
2	56125687	.	T	C	18	20	38	0	4	42	0	0
2	56125744	.	G	C	24	1	25	0	19	44	0	0
2	56125821	.	G	T	14	18	32	0	1	33	0	0
2	56125837	.	C	T	2	13	15	0	14	29	0	0
2	56125859	.	A	T	13	11	24	0	2	26	0	0
2	56126011	.	T	A	4	4	8	0	0	8	0	0
2	56126359	.	A	G	2	3	5	0	2	7	0	0
2	56126588	.	G	T	11	9	20	0	0	20	0	0
2	56127612	.	G	A	11	9	20	0	1	22	1	0
2	56127693	.	T	G	7	9	16	0	0	16	0	0
2	56127720	.	C	G	9	9	18	0	0	18	0	0
2	56127848	.	T	A	6	10	16	0	1	17	0	0
2	56127881	.	T	A	4	8	12	0	0	12	0	0
2	56127884	.	A	T	4	7	11	0	1	12	0	0
2	56127951	.	A	T	8	6	14	0	1	15	0	0
2	56127962	.	T	C	5	7	12	0	1	13	0	0
2	56128025	.	A	G	10	14	24	0	1	25	0	0
2	56128029	.	A	T	10	17	27	0	0	27	0	0
2	56128224	.	A	G	8	7	15	0	6	21	0	0
2	56128259	.	A	G	10	5	15	0	1	16	0	0
2	56128455	.	G	A	12	10	22	0	3	25	0	0
2	56128527	.	A	G	11	9	20	0	1	21	0	0
2	56128582	.	A	G	9	10	19	0	0	19	0	0
2	56128677	.	C	T	8	12	20	0	0	20	0	0
2	56128687	.	A	T	6	9	15	0	2	17	0	0
2	56128768	.	A	T	4	3	7	0	0	7	0	0
2	56128895	.	T	A	10	15	25	0	0	25	0	0
2	56129001	.	A	G	19	5	24	0	0	24	0	0
2	56129175	.	G	C	11	17	28	0	0	28	0	0
2	56129285	.	G	T	8	11	19	0	3	23	1	0
2	56129299	.	G	A	8	15	23	0	1	24	0	0
2	56129332	.	G	A	7	10	17	0	2	19	0	0
2	56129613	.	T	C	8	11	19	0	0	19	0	0
2	56129793	.	A	G	3	5	8	0	0	8	0	0
2	56130019	.	A	C	11	13	24	0	1	25	0	0
2	56130212	.	T	G	11	10	21	0	1	22	0	0
2	56130259	.	A	G	3	10	13	0	0	13	0	0
2	56130260	.	C	G	2	8	10	0	3	13	0	0
2	56130296	.	C	A	8	6	14	0	3	17	0	0
2	56161999	.	A	G	2	2	4	0	0	4	0	0
2	56162145	.	G	A	0	3	3	1	1	5	0	0
2	56162254	.	G	C	4	3	7	0	0	7	0	0
2	56162404	.	C	G	4	2	6	0	0	6	0	0
2	56169512	.	G	A	0	3	3	0	13	16	0	0
2	56169722	.	G	A	2	2	4	0	1	5	0	0
2	56181587	.	T	C	2	2	4	1	0	5	0	0
2	56181821	.	C	T	4	2	6	0	0	6	0	0
2	56181833	.	T	G	4	0	4	0	2	6	0	0
2	56196950	.	C	T	5	6	11	0	0	11	0	0
2	56200571	.	C	A	3	6	9	0	0	9	0	0
2	56200652	.	G	A	0	6	6	0	2	8	0	0
2	56205615	.	G	T	0	3	3	0	4	7	0	0
2	56210654	.	T	C	4	3	7	0	0	7	0	0
2	56211530	.	T	C	4	5	9	0	0	9	0	0
2	56213051	.	C	G	4	4	8	0	0	8	0	0
2	56213063	.	T	C	6	4	10	0	0	10	0	0
2	56216760	.	C	T	7	6	13	0	0	13	0	0
2	56219233	.	G	A	7	7	14	0	1	15	0	0
2	56226369	.	C	G	11	12	23	0	1	24	0	0
2	56226372	.	A	G	11	0	11	0	15	26	0	0
2	56226444	.	T	C	10	10	20	0	0	20	0	0
2	56233498	.	C	G	7	9	16	0	1	17	0	0
2	56233508	.	G	T	10	12	22	0	1	23	0	0
2	56234749	.	T	C	8	15	23	0	1	24	0	0
2	56268014	.	C	T	2	4	6	0	0	6	0	0
2	56339104	.	T	G	15	16	31	0	1	32	0	0
2	56344833	.	A	G	33	24	57	0	7	64	0	0
2	56356796	.	T	C	13	14	27	0	1	28	0	0
2	56356806	.	T	C	12	12	24	0	1	25	0	0
2	56359363	.	G	A	13	8	21	0	2	23	0	0
2	56359434	.	A	G	5	7	12	0	0	12	0	0
2	56359641	.	G	A	4	5	9	0	0	9	0	0
2	56361406	.	G	A	10	4	14	0	1	15	0	0
2	56361412	.	A	G	10	4	14	0	1	15	0	0
2	56374933	.	C	A	5	4	9	0	1	10	0	0
2	56385336	.	T	A	6	3	9	0	0	9	0	0
2	56472472	.	C	T	15	14	29	0	2	31	0	0
2	56472553	.	C	T	5	8	13	25	1	39	0	0
2	56472613	.	T	A	18	13	31	4	0	35	0	0
2	56472625	.	A	C	16	17	33	4	0	37	0	0
2	56476113	.	G	A	5	24	29	0	26	55	0	0
2	56476573	.	G	T	2	24	26	0	24	50	0	0
2	56476732	.	C	T	19	18	37	0	3	40	0	0
2	56476762	.	A	G	16	11	27	0	4	31	0	0
2	56476812	.	A	G	10	19	29	0	2	31	0	0
2	56476909	.	A	C	7	9	16	0	2	18	0	0
2	56508570	.	A	C	5	5	10	0	1	11	0	0
2	56508695	.	T	C	25	11	36	0	4	40	0	0
2	56508878	.	A	G	15	9	24	0	0	24	0	0
2	56508880	.	C	T	14	9	23	0	0	23	0	0
2	56509097	.	T	A	14	5	19	0	1	20	0	0
2	56509098	.	A	T	15	5	20	0	0	20	0	0
2	56510817	.	T	C	20	0	20	0	10	30	0	0
2	56511064	.	G	T	9	14	23	0	1	24	0	0
2	56511463	.	A	C	1	4	5	0	1	6	0	0
2	56511575	.	C	T	6	3	9	0	0	9	0	0
2	56511687	.	A	T	8	7	15	1	0	16	0	0
2	56511713	.	A	T	8	2	10	1	1	12	0	0
2	56511792	.	A	C	2	4	6	0	0	6	0	0
2	56511845	.	G	T	10	6	16	0	0	16	0	0
2	56511877	.	C	T	6	6	12	0	0	12	0	0
2	56511917	.	C	T	2	6	8	0	0	8	0	0
2	56512009	.	T	C	3	0	3	0	2	5	0	0
2	56512032	.	C	T	5	4	9	0	1	10	0	0
2	56512054	.	T	C	2	0	2	0	9	11	0	0
2	56512241	.	G	T	9	1	10	1	1	13	1	0
2	56512255	.	T	G	3	6	9	1	2	12	0	0
2	56512307	.	A	G	4	3	7	0	0	7	0	0
2	56512322	.	T	A	4	1	5	0	0	5	0	0
2	56513510	.	A	C	9	8	17	0	2	19	0	0
2	56513660	.	C	T	0	5	5	0	7	12	0	0
2	56513742	.	C	A	17	8	25	1	3	29	0	0
2	56513795	.	G	T	10	16	26	1	0	27	0	0
2	56541388	.	T	C	11	0	11	0	10	21	0	0
2	56541417	.	G	A	14	8	22	0	1	23	0	0
2	56557264	.	G	T	10	12	22	0	2	24	0	0
2	56572249	.	G	A	6	5	11	0	2	13	0	0
2	56574486	.	C	T	1	4	5	0	4	9	0	0
2	56574525	.	C	T	1	6	7	0	4	11	0	0
2	56643465	.	G	A	17	35	52	0	4	56	0	0
2	56645018	.	G	A	32	34	66	0	4	70	0	0
2	56649806	.	A	G	29	22	51	0	0	51	0	0
2	56811625	.	C	T	2	2	4	0	1	5	0	0
2	56838480	.	A	G	1	2	3	0	0	3	0	0
2	57076329	.	G	T	1	7	8	0	1	9	0	0
2	57076496	.	G	A	2	4	6	0	0	6	0	0
2	57076516	.	C	T	0	3	3	0	2	5	0	0
2	57076559	.	A	G	3	3	6	0	0	6	0	0
2	57097175	.	G	A	1	4	5	0	0	5	0	0
2	57097176	.	C	A	1	4	5	0	0	5	0	0
2	57121623	.	A	T	1	3	4	0	0	4	0	0
2	57121773	.	C	T	0	4	4	1	5	10	0	0
2	57130154	.	G	A	5	3	8	0	1	9	0	0
2	57143433	.	G	A	1	4	5	0	0	5	0	0
2	57143436	.	C	T	1	4	5	0	0	5	0	0
2	57151194	.	G	A	24	22	46	0	3	49	0	0
2	57151242	.	G	T	28	23	51	0	0	51	0	0
2	57151326	.	A	G	25	2	27	0	22	49	0	0
2	57152858	.	T	G	24	26	50	0	3	53	0	0
2	57156050	.	C	A	22	23	45	0	7	53	1	0
2	57156092	.	C	A	26	23	49	0	1	50	0	0
2	57157952	.	C	T	31	23	54	0	1	55	0	0
2	57159557	.	G	A	29	20	49	0	3	52	0	0
2	57159668	.	G	A	27	33	60	0	3	63	0	0
2	57160272	.	C	T	28	26	54	0	4	58	0	0
2	57164902	.	A	G	29	30	59	0	3	62	0	0
2	57165001	.	C	T	31	26	57	0	3	60	0	0
2	57165544	.	C	T	37	22	59	0	1	60	0	0
2	57165565	.	C	T	25	37	62	0	2	64	0	0
2	57212864	.	G	A	8	5	13	0	2	15	0	0
2	57212966	.	T	C	6	0	6	0	7	13	0	0
2	57216903	.	G	A	6	3	9	0	3	12	0	0
2	57225001	.	G	A	1	2	3	0	0	3	0	0
2	57225181	.	C	T	1	5	6	0	3	9	0	0
2	57225187	.	A	G	3	5	8	0	0	8	0	0
2	57227354	.	A	C	4	5	9	0	1	10	0	0
2	57240340	.	A	T	2	4	6	0	1	7	0	0
2	57240345	.	C	T	3	3	6	0	0	6	0	0
2	57240570	.	A	T	4	9	13	0	1	14	0	0
2	57240649	.	C	T	1	3	4	0	8	12	0	0
2	57240708	.	C	T	5	4	9	0	0	9	0	0
2	57240736	.	G	A	8	8	16	0	0	16	0	0
2	57247280	.	C	A	2	8	10	0	8	18	0	0
2	57251501	.	A	T	5	6	11	0	0	11	0	0
2	57268868	.	G	A	14	18	32	0	1	33	0	0
2	57268877	.	T	A	16	16	32	0	1	33	0	0
2	57269031	.	C	G	22	30	52	0	3	55	0	0
2	57269136	.	T	A	32	24	56	0	2	58	0	0
2	57284550	.	A	T	25	31	56	0	2	58	0	0
2	57416930	.	T	C	2	2	4	0	0	4	0	0
2	57416951	.	T	A	4	3	7	0	0	7	0	0
2	57417062	.	C	T	4	2	6	0	1	7	0	0
2	57417092	.	A	C	6	4	10	0	2	12	0	0
2	57417223	.	G	A	6	5	11	0	1	12	0	0
2	57417357	.	C	T	2	5	7	0	0	7	0	0
2	57417362	.	C	A	2	5	7	0	0	7	0	0
2	57420477	.	G	A	13	7	20	0	0	20	0	0
2	57433321	.	T	C	10	3	13	0	0	13	0	0
2	57433333	.	A	G	10	3	13	0	0	13	0	0
2	57893346	.	G	A	6	3	9	7	2	18	0	0
2	57897290	.	G	A	3	3	6	9	0	15	0	0
2	57898811	.	G	A	2	2	4	0	0	4	0	0
2	57898837	.	A	T	5	2	7	1	0	8	0	0
2	57898866	.	A	G	5	3	8	2	1	11	0	0
2	57898875	.	G	A	3	6	9	2	0	11	0	0
2	57899003	.	G	A	1	5	6	0	0	6	0	0
2	57916336	.	G	C	2	2	4	9	1	14	0	0
2	58009416	.	A	G	2	14	16	1	0	17	0	0
2	58013279	.	C	T	11	5	16	1	0	17	0	0
2	58013448	.	G	A	8	10	18	2	0	20	0	0
2	58013812	.	T	C	10	2	12	1	1	14	0	0
2	58412124	.	G	A	2	17	19	0	25	44	0	0
2	58516445	.	C	A	22	11	33	1	2	36	0	0
2	58523710	.	C	A	1	6	7	0	11	18	0	0
2	58541939	.	G	A	16	15	31	0	3	34	0	0
2	58541981	.	C	G	10	15	25	0	3	28	0	0
2	58546893	.	G	A	13	15	28	0	0	28	0	0
2	58560081	.	G	C	10	7	17	0	0	17	0	0
2	58568120	.	C	T	4	3	7	0	0	7	0	0
2	58568129	.	G	A	4	2	6	0	1	7	0	0
2	58581582	.	G	C	3	7	10	0	0	10	0	0
2	58639153	.	C	T	0	3	3	0	8	11	0	0
2	58739467	.	T	C	9	12	21	0	0	21	0	0
2	58742652	.	G	A	1	11	12	0	12	24	0	0
2	58778264	.	G	A	15	11	26	0	1	27	0	0
2	58785286	.	G	A	9	8	17	4	0	21	0	0
2	58789112	.	G	A	6	9	15	0	2	17	0	0
2	58793396	.	C	T	0	9	9	0	12	21	0	0
2	58793438	.	A	G	12	9	21	0	0	21	0	0
2	58793652	.	A	G	5	4	9	0	1	10	0	0
2	58793667	.	G	A	7	3	10	0	1	11	0	0
2	58845161	.	G	T	1	9	10	0	8	18	0	0
2	58845239	.	C	T	2	3	5	0	1	6	0	0
2	58848646	.	T	G	32	1	33	0	31	64	0	0
2	58848767	.	C	T	22	11	33	0	3	36	0	0
2	58868190	.	G	A	8	8	16	0	5	21	0	0
2	58868439	.	T	C	16	0	16	0	14	30	0	0
2	58868508	.	A	C	12	0	12	0	15	27	0	0
2	58868679	.	G	A	13	11	24	0	0	24	0	0
2	58869166	.	G	A	10	6	16	0	0	16	0	0
2	58869268	.	A	G	5	9	14	0	1	15	0	0
2	58869319	.	G	A	9	3	12	0	2	14	0	0
2	58878288	.	G	A	1	4	5	0	5	10	0	0
2	58878612	.	C	T	15	6	21	0	2	23	0	0
2	58888870	.	A	G	3	6	9	0	1	11	1	0
2	58888916	.	T	A	6	4	10	3	2	15	0	0
2	58898167	.	C	T	1	7	8	0	9	17	0	0
2	58898910	.	A	G	8	5	13	0	4	17	0	0
2	58917504	.	A	T	2	7	9	0	1	10	0	0
2	58919954	.	G	A	7	5	12	0	0	12	0	0
2	59004046	.	C	T	4	3	7	0	1	8	0	0
2	59023901	.	T	C	10	8	18	0	0	18	0	0
2	59045912	.	A	G	3	0	3	0	7	10	0	0
2	59054254	.	A	G	20	21	41	0	4	45	0	0
2	59056203	.	C	T	13	20	33	1	0	34	0	0
2	59056212	.	G	A	15	16	31	1	1	33	0	0
2	59057670	.	C	T	20	21	41	0	1	42	0	0
2	59063227	.	T	C	13	16	29	1	2	32	0	0
2	59136859	.	T	C	1	5	6	0	0	6	0	0
2	59136919	.	T	G	3	10	13	0	0	13	0	0
2	59137050	.	T	A	7	7	14	4	0	18	0	0
2	59137182	.	G	T	3	7	10	0	0	10	0	0
2	59137184	.	G	T	3	7	10	0	0	10	0	0
2	59137356	.	G	C	6	0	6	0	2	8	0	0
2	59137357	.	A	G	5	2	7	0	0	7	0	0
2	59143183	.	A	G	4	9	13	0	0	13	0	0
2	59144065	.	A	G	2	5	7	0	0	7	0	0
2	59144092	.	A	G	4	5	9	0	0	9	0	0
2	59144385	.	T	G	7	3	10	0	0	10	0	0
2	59556968	.	A	G	2	0	2	0	3	5	0	0
2	59557097	.	G	C	0	2	2	0	4	6	0	0
2	59557119	.	A	C	4	2	6	0	1	7	0	0
2	59557199	.	T	C	3	2	5	0	0	5	0	0
2	59557202	.	A	T	3	2	5	0	0	5	0	0
2	59565439	.	C	T	2	2	4	0	0	4	0	0
2	59565521	.	T	G	4	0	4	0	3	7	0	0
20	22311	.	G	A	2	2	4	0	0	4	0	0
20	66886	.	C	A	4	3	7	0	0	7	0	0
20	67321	.	C	T	4	4	8	0	0	8	0	0
20	67755	.	C	T	5	2	7	0	0	7	0	0
20	67867	.	T	G	5	8	13	0	2	15	0	0
20	75079	.	C	A	13	6	19	0	0	19	0	0
20	75148	.	T	C	7	6	13	0	2	15	0	0
20	75266	.	G	A	2	7	9	0	5	14	0	0
20	75330	.	T	A	5	9	14	0	1	15	0	0
20	75374	.	A	G	4	7	11	0	3	14	0	0
20	75376	.	G	T	1	7	8	0	7	15	0	0
20	75889	.	C	T	18	13	31	0	1	32	0	0
20	76193	.	G	A	1	7	8	0	4	12	0	0
20	76209	.	A	G	11	8	19	0	1	20	0	0
20	76285	.	C	T	13	15	28	0	1	29	0	0
20	87449	.	A	T	2	3	5	0	0	5	0	0
20	88023	.	G	A	1	2	3	0	0	3	0	0
20	89176	.	A	G	10	7	17	0	1	18	0	0
20	89188	.	G	T	0	7	7	0	10	17	0	0
20	89351	.	C	G	2	4	6	0	0	6	0	0
20	89354	.	C	T	1	4	5	0	1	6	0	0
20	89567	.	G	A	13	13	26	0	0	26	0	0
20	89607	.	G	T	2	9	11	0	10	21	0	0
20	89625	.	T	A	7	12	19	0	1	20	0	0
20	89720	.	G	A	14	14	28	0	1	29	0	0
20	90003	.	A	T	19	15	34	0	1	35	0	0
20	90167	.	C	T	9	21	30	0	0	30	0	0
20	90242	.	T	C	15	18	33	0	2	35	0	0
20	90246	.	T	C	16	19	35	0	0	35	0	0
20	114708	.	A	G	28	27	55	0	1	56	0	0
20	114776	.	A	G	25	28	53	0	3	56	0	0
20	116164	.	A	T	29	19	48	0	1	49	0	0
20	122702	.	C	T	0	7	7	0	2	9	0	0
20	124691	.	C	T	0	3	3	0	2	5	0	0
20	151548	.	C	T	1	6	7	0	9	16	0	0
20	151846	.	C	T	18	17	35	0	2	37	0	0
20	152496	.	G	C	5	10	15	0	0	15	0	0
20	153992	.	C	T	1	4	5	0	9	14	0	0
20	162099	.	A	G	1	3	4	0	0	4	0	0
20	186752	.	G	A	14	12	26	0	0	26	0	0
20	188449	.	A	G	15	13	28	1	2	31	0	0
20	188638	.	T	C	4	12	16	0	0	16	0	0
20	196767	.	G	A	10	10	20	0	2	22	0	0
20	196773	.	T	A	12	9	21	0	0	21	0	0
20	196838	.	G	A	10	13	23	0	0	23	0	0
20	197274	.	T	C	9	9	18	0	2	20	0	0
20	197560	.	C	G	8	7	15	0	0	15	0	0
20	197842	.	T	C	12	12	24	0	2	27	1	0
20	198040	.	G	T	14	11	25	0	0	25	0	0
20	198049	.	C	T	17	11	28	0	0	28	0	0
20	198112	.	G	T	15	19	34	0	0	34	0	0
20	198127	.	A	T	20	13	33	0	2	35	0	0
20	198352	.	G	A	10	8	18	0	1	19	0	0
20	199168	.	C	T	0	13	13	0	8	21	0	0
20	199504	.	C	T	6	4	10	0	2	12	0	0
20	199962	.	T	C	2	6	8	0	0	8	0	0
20	200544	.	C	T	0	6	6	0	7	13	0	0
20	200851	.	G	A	7	4	11	0	1	12	0	0
20	201524	.	G	C	5	9	14	0	0	14	0	0
20	201718	.	G	A	4	4	8	0	0	8	0	0
20	202012	.	A	G	7	3	10	0	0	10	0	0
20	202340	.	T	A	6	8	14	0	1	15	0	0
20	202480	.	T	C	1	5	6	0	0	6	0	0
20	203089	.	C	A	0	2	2	0	5	7	0	0
20	203122	.	G	A	2	3	5	0	0	5	0	0
20	238607	.	T	C	2	2	4	0	0	4	0	0
20	245581	.	G	A	1	2	3	0	0	3	0	0
20	251162	.	A	G	2	0	2	0	3	5	0	0
20	254130	.	G	A	3	2	5	0	0	5	0	0
20	255431	.	C	T	5	4	9	0	0	9	0	0
20	255433	.	C	G	5	4	9	0	0	9	0	0
20	258687	.	G	A	5	3	8	0	2	10	0	0
20	259534	.	C	T	6	4	10	0	0	10	0	0
20	259602	.	T	C	10	10	20	0	0	20	0	0
20	259625	.	T	C	8	10	18	0	1	19	0	0
20	259763	.	C	T	9	11	20	0	0	20	0	0
20	259766	.	C	A	8	10	18	0	2	20	0	0
20	259847	.	C	T	1	6	7	0	0	7	0	0
20	329072	.	A	C	7	6	13	0	4	17	0	0
20	329113	.	G	A	7	3	10	0	0	10	0	0
20	343858	.	A	C	6	2	8	0	0	8	0	0
20	369583	.	A	G	2	0	2	0	3	5	0	0
20	379577	.	A	C	4	3	7	0	1	8	0	0
20	379595	.	C	T	3	2	5	0	0	5	0	0
20	384585	.	G	T	0	1	1	0	4	5	0	0
20	384606	.	C	T	3	2	5	0	0	5	0	0
20	395704	.	C	T	8	6	14	0	1	15	0	0
20	395990	.	C	T	1	3	4	0	0	4	0	0
20	405867	.	G	A	5	4	9	0	0	9	0	0
20	405925	.	A	C	14	5	19	0	1	20	0	0
20	405928	.	A	G	6	0	6	0	17	23	0	0
20	406264	.	T	A	4	2	6	1	0	7	0	0
20	406278	.	T	A	5	4	9	1	1	11	0	0
20	409377	.	C	A	3	3	6	0	2	8	0	0
20	409621	.	A	G	6	1	7	0	1	8	0	0
20	409629	.	T	C	6	2	8	0	0	8	0	0
20	410832	.	A	T	11	16	27	0	1	28	0	0
20	410981	.	A	T	7	10	17	0	0	17	0	0
20	411063	.	T	A	2	5	7	1	1	9	0	0
20	423977	.	G	C	7	11	18	1	1	20	0	0
20	426390	.	T	C	5	9	14	0	0	14	0	0
20	426434	.	T	A	4	6	10	0	0	10	0	0
20	429984	.	G	A	5	6	11	0	0	11	0	0
20	430080	.	A	G	2	3	5	0	1	6	0	0
20	430539	.	C	T	8	4	12	0	0	12	0	0
20	430703	.	A	C	5	2	7	0	0	7	0	0
20	431851	.	C	T	5	2	7	0	0	7	0	0
20	431886	.	C	T	0	3	3	0	1	4	0	0
20	432004	.	C	T	3	5	8	0	0	8	0	0
20	436661	.	T	C	3	6	9	0	0	9	0	0
20	438613	.	G	A	1	3	4	0	0	4	0	0
20	474341	.	C	A	6	5	11	2	0	13	0	0
20	483866	.	C	T	6	2	8	0	1	9	0	0
20	522541	.	G	A	10	8	18	0	0	18	0	0
20	522778	.	C	T	5	5	10	0	0	10	0	0
20	522811	.	T	A	4	7	11	0	0	11	0	0
20	528561	.	C	T	21	7	28	0	0	28	0	0
20	530335	.	C	T	6	7	13	0	1	14	0	0
20	530405	.	G	A	2	9	11	0	9	20	0	0
20	530408	.	C	T	11	9	20	0	1	21	0	0
20	530443	.	C	T	10	12	22	0	0	22	0	0
20	530445	.	T	G	10	12	22	0	0	22	0	0
20	530534	.	C	G	5	4	9	0	0	9	0	0
20	530536	.	C	T	5	5	10	0	0	10	0	0
20	530624	.	G	T	3	6	9	0	0	9	0	0
20	557393	.	G	A	1	3	4	0	1	5	0	0
20	557402	.	A	G	0	4	4	0	1	5	0	0
20	565903	.	A	C	1	2	3	0	0	3	0	0
20	566411	.	C	T	2	2	4	0	0	4	0	0
20	598242	.	T	C	2	2	4	0	0	4	0	0
20	603599	.	T	C	5	2	7	0	0	7	0	0
20	603647	.	T	C	1	2	3	0	0	3	0	0
20	605171	.	A	T	2	5	7	0	0	7	0	0
20	605264	.	C	T	3	3	6	0	0	6	0	0
20	605291	.	C	T	2	2	4	0	0	4	0	0
20	700683	.	C	T	6	4	10	0	0	10	0	0
20	700686	.	A	T	7	4	11	0	0	11	0	0
20	700899	.	C	A	10	6	16	0	0	16	0	0
20	700995	.	C	T	8	4	12	0	0	12	0	0
20	707767	.	C	T	4	7	11	0	2	13	0	0
20	708026	.	G	A	14	5	19	0	1	20	0	0
20	712497	.	A	G	2	4	6	0	0	6	0	0
20	742126	.	T	C	2	2	4	0	0	4	0	0
20	752624	.	G	A	0	4	4	0	2	6	0	0
20	755725	.	G	A	5	6	11	0	2	13	0	0
20	757522	.	G	A	7	4	11	0	0	11	0	0
20	757525	.	C	A	4	5	9	0	1	10	0	0
20	761004	.	C	T	12	10	22	0	0	22	0	0
20	761006	.	G	C	11	12	23	0	1	24	0	0
20	764346	.	A	G	15	12	27	0	2	29	0	0
20	764355	.	G	A	11	11	22	0	0	22	0	0
20	764388	.	A	G	9	11	20	0	2	22	0	0
20	764436	.	T	C	14	12	26	0	0	26	0	0
20	764807	.	G	A	12	7	19	0	2	21	0	0
20	771986	.	C	G	14	8	22	0	0	22	0	0
20	772577	.	C	A	11	7	18	0	0	18	0	0
20	772700	.	C	T	18	12	30	0	0	30	0	0
20	775412	.	G	A	3	15	18	0	13	31	0	0
20	775487	.	C	T	9	10	19	0	0	19	0	0
20	775538	.	G	A	1	18	19	0	18	37	0	0
20	775562	.	C	T	15	21	36	0	1	37	0	0
20	775583	.	T	A	19	19	38	0	0	38	0	0
20	776171	.	C	T	24	20	44	0	2	46	0	0
20	776261	.	A	T	18	26	44	0	6	50	0	0
20	776630	.	G	T	15	14	29	0	1	30	0	0
20	776826	.	G	A	9	8	17	0	1	18	0	0
20	847735	.	T	G	2	6	8	0	0	8	0	0
20	847758	.	T	A	2	4	6	0	0	6	0	0
20	847779	.	G	A	5	4	9	0	0	9	0	0
20	847820	.	G	A	1	10	11	0	2	13	0	0
20	847854	.	G	A	3	7	10	0	3	13	0	0
20	847887	.	T	A	3	8	11	0	1	12	0	0
20	847985	.	G	T	1	2	3	0	0	3	0	0
20	851699	.	G	A	5	3	8	0	0	8	0	0
20	851746	.	G	A	6	5	11	0	0	11	0	0
20	851843	.	T	C	7	13	20	0	2	22	0	0
20	851876	.	C	T	16	8	24	0	4	28	0	0
20	852184	.	A	G	12	10	22	1	0	23	0	0
20	856170	.	G	A	9	14	23	0	3	26	0	0
20	856185	.	G	A	9	18	27	0	0	27	0	0
20	875008	.	C	G	9	6	15	0	1	16	0	0
20	875042	.	G	A	9	4	13	0	0	13	0	0
20	880430	.	G	A	6	8	14	0	0	14	0	0
20	880447	.	A	G	10	7	17	0	0	17	0	0
20	880747	.	A	T	5	5	10	0	0	10	0	0
20	883163	.	C	T	0	5	5	0	5	10	0	0
20	892055	.	C	T	4	6	10	0	0	10	0	0
20	902671	.	G	A	3	7	10	0	0	10	0	0
20	902712	.	A	T	5	6	11	0	0	12	1	0
20	908294	.	A	G	2	7	9	0	1	10	0	0
20	908641	.	C	T	1	4	5	0	4	9	0	0
20	944302	.	T	C	9	2	11	0	0	11	0	0
20	944314	.	A	C	4	4	8	0	1	9	0	0
20	946681	.	G	A	9	12	21	0	1	22	0	0
20	1079035	.	G	A	4	6	10	0	0	10	0	0
20	1079084	.	G	C	4	7	11	0	0	11	0	0
20	1081952	.	G	T	4	6	10	0	0	10	0	0
20	1081960	.	G	A	6	4	10	0	0	10	0	0
20	1119975	.	C	G	2	2	4	0	0	4	0	0
20	1125057	.	A	G	7	9	16	0	0	16	0	0
20	1125135	.	G	A	1	3	4	0	8	12	0	0
20	1132561	.	G	A	3	3	6	0	0	6	0	0
20	1141668	.	A	G	2	2	4	0	0	4	0	0
20	1147695	.	G	A	3	2	5	0	0	5	0	0
20	1151113	.	G	A	1	2	3	0	0	3	0	0
20	1151123	.	C	A	1	2	3	0	0	3	0	0
20	1177879	.	A	T	9	6	15	0	0	15	0	0
20	1178040	.	T	A	3	3	6	0	0	6	0	0
20	1178041	.	T	C	4	3	7	0	0	7	0	0
20	1178505	.	T	C	1	3	4	0	0	4	0	0
20	1178725	.	A	G	1	3	4	0	0	4	0	0
20	1178759	.	G	C	4	4	8	0	0	8	0	0
20	1178813	.	T	C	9	4	13	0	1	14	0	0
20	1179196	.	T	C	5	6	11	0	1	12	0	0
20	1179348	.	A	C	2	3	5	0	1	6	0	0
20	1179404	.	T	G	3	3	6	0	0	6	0	0
20	1179485	.	T	C	4	5	9	0	0	9	0	0
20	1179577	.	C	T	0	2	2	0	3	5	0	0
20	1179715	.	A	C	2	0	2	0	4	6	0	0
20	1185942	.	G	A	3	5	8	0	0	8	0	0
20	1198485	.	C	T	12	6	18	0	1	19	0	0
20	1198558	.	A	T	14	3	17	0	3	20	0	0
20	1198819	.	T	A	14	9	23	5	0	28	0	0
20	1201917	.	A	T	5	4	9	0	0	9	0	0
20	1202107	.	C	T	6	2	8	0	0	8	0	0
20	1202134	.	A	T	5	3	8	0	0	8	0	0
20	1204555	.	G	C	4	0	4	0	3	7	0	0
20	1205980	.	G	A	6	5	11	0	1	12	0	0
20	1240552	.	A	T	7	3	10	0	1	11	0	0
20	1240684	.	G	A	6	5	11	0	0	11	0	0
20	1240848	.	C	A	2	8	10	0	0	10	0	0
20	1241409	.	A	T	12	4	16	0	3	19	0	0
20	1241596	.	T	G	2	3	5	0	1	6	0	0
20	1241809	.	A	T	1	2	3	0	0	3	0	0
20	1241839	.	G	T	1	2	3	0	0	3	0	0
20	1242029	.	A	T	4	2	6	0	0	6	0	0
20	1242313	.	G	C	1	2	3	0	0	3	0	0
20	1242395	.	A	G	2	2	4	0	0	4	0	0
20	1242440	.	T	A	2	2	4	0	0	4	0	0
20	1243150	.	C	T	1	5	6	0	3	9	0	0
20	1243358	.	T	G	3	2	5	0	0	5	0	0
20	1243367	.	A	G	2	1	3	0	1	4	0	0
20	1243941	.	C	G	3	3	6	0	0	6	0	0
20	1244166	.	A	G	1	3	4	0	0	4	0	0
20	1246641	.	C	A	2	3	5	0	0	5	0	0
20	1246870	.	C	T	2	3	5	0	0	5	0	0
20	1257193	.	G	A	2	2	4	0	0	4	0	0
20	1258054	.	G	A	1	3	4	0	0	4	0	0
20	1278565	.	A	T	3	3	6	0	1	7	0	0
20	1278796	.	G	A	6	7	13	0	1	14	0	0
20	1279033	.	G	A	6	2	8	0	1	9	0	0
20	1294012	.	T	G	12	8	20	0	1	21	0	0
20	1294062	.	C	G	7	22	29	0	1	30	0	0
20	1294612	.	T	C	6	4	10	0	0	10	0	0
20	1294626	.	A	T	2	4	6	0	0	6	0	0
20	1294863	.	T	G	15	8	23	0	0	23	0	0
20	1294970	.	A	G	24	13	37	2	0	39	0	0
20	1294993	.	T	C	17	0	17	2	5	24	0	0
20	1295017	.	T	C	5	2	7	2	0	9	0	0
20	1295302	.	T	C	7	6	13	2	0	15	0	0
20	1295426	.	G	T	3	4	7	0	0	7	0	0
20	1295840	.	G	A	17	17	34	0	0	34	0	0
20	1296022	.	G	C	19	13	32	1	2	36	1	0
20	1296114	.	G	A	16	12	28	0	0	28	0	0
20	1296139	.	A	G	15	11	26	0	1	27	0	0
20	1314478	.	A	G	2	4	6	0	0	6	0	0
20	1316764	.	A	G	2	4	6	0	0	6	0	0
20	1316860	.	G	C	0	4	4	0	5	9	0	0
20	1324404	.	G	A	12	6	18	0	0	18	0	0
20	1324976	.	C	A	7	4	11	0	0	11	0	0
20	1327545	.	A	T	8	10	18	0	0	18	0	0
20	1338778	.	C	T	2	3	5	0	0	5	0	0
20	1339066	.	G	A	0	4	4	0	3	7	0	0
20	1339798	.	G	A	6	9	15	0	0	15	0	0
20	1339843	.	C	T	4	7	11	0	2	13	0	0
20	1339924	.	G	A	8	4	12	0	1	13	0	0
20	1340015	.	G	A	1	4	5	0	6	11	0	0
20	1349264	.	A	T	2	3	5	0	0	5	0	0
20	1349357	.	G	A	0	3	3	0	4	7	0	0
20	1349739	.	A	G	2	0	2	0	2	4	0	0
20	1349947	.	G	A	0	7	7	0	5	12	0	0
20	1350101	.	G	A	0	5	5	0	2	7	0	0
20	1441815	.	A	C	24	20	44	0	3	50	3	0
20	1441825	.	T	C	24	17	41	1	1	43	0	0
20	1442358	.	G	T	13	10	23	0	2	26	1	0
20	1442468	.	G	A	8	12	20	0	0	20	0	0
20	1442515	.	A	T	11	10	21	0	7	28	0	0
20	1442522	.	C	A	16	11	27	0	0	27	0	0
20	1442582	.	G	T	13	6	19	0	2	21	0	0
20	1442624	.	C	T	15	14	29	0	2	31	0	0
20	1454065	.	T	C	13	15	28	0	1	29	0	0
20	1455104	.	G	A	11	13	24	0	2	26	0	0
20	1460979	.	C	A	5	10	15	0	2	17	0	0
20	1476772	.	C	T	4	8	12	0	1	13	0	0
20	1518414	.	G	A	6	8	14	0	2	16	0	0
20	1519699	.	A	G	3	3	6	0	1	7	0	0
20	1560842	.	C	T	0	4	4	0	5	9	0	0
20	2716149	.	C	A	16	4	20	0	3	23	0	0
20	2972260	.	A	G	2	0	2	0	27	29	0	0
20	2976094	.	A	G	17	9	26	2	0	28	0	0
20	2976114	.	A	G	15	7	22	3	0	25	0	0
20	2976257	.	A	G	20	5	25	1	0	26	0	0
20	2976682	.	G	A	2	21	23	4	7	34	0	0
20	2976703	.	G	A	22	27	49	4	0	53	0	0
20	2976727	.	A	G	34	15	49	0	6	55	0	0
20	2976909	.	C	A	18	12	30	2	3	35	0	0
20	2977257	.	C	T	29	22	51	1	2	54	0	0
20	2977417	.	C	A	23	6	29	4	2	35	0	0
20	2977418	.	C	A	25	6	31	4	1	36	0	0
20	2982943	.	T	C	2	2	4	1	1	6	0	0
20	3121947	.	G	A	1	6	7	0	0	7	0	0
20	3130450	.	T	C	6	2	8	0	0	8	0	0
20	3274150	.	A	G	7	2	9	0	0	9	0	0
20	3316382	.	A	T	2	4	6	0	0	6	0	0
20	3316725	.	G	A	1	6	7	0	0	7	0	0
20	3916456	.	T	A	7	8	15	0	0	15	0	0
20	3916464	.	C	T	8	11	19	0	0	19	0	0
20	3916621	.	T	G	10	3	13	0	0	13	0	0
20	3920746	.	T	G	9	4	13	0	1	14	0	0
20	3920873	.	T	A	7	13	20	0	0	20	0	0
20	3920875	.	G	A	7	12	19	0	1	21	1	0
20	3920977	.	G	A	0	7	7	0	9	16	0	0
20	3921127	.	A	T	9	7	16	0	0	16	0	0
20	3921184	.	G	A	7	7	14	0	0	14	0	0
20	3921202	.	T	C	9	9	18	0	0	18	0	0
20	3923735	.	C	G	3	7	10	0	0	10	0	0
20	3923983	.	G	A	0	8	8	0	10	18	0	0
20	3924098	.	A	T	13	6	19	0	2	21	0	0
20	3924349	.	G	A	13	4	17	0	0	17	0	0
20	3924430	.	G	A	1	5	6	0	7	13	0	0
20	3924528	.	C	A	7	9	16	0	0	17	1	0
20	3924824	.	A	C	4	2	6	0	0	6	0	0
20	3924943	.	T	G	10	0	10	0	8	18	0	0
20	3925146	.	A	T	7	6	13	0	0	13	0	0
20	3925537	.	T	C	7	12	19	0	0	19	0	0
20	3925544	.	T	A	17	6	23	0	1	24	0	0
20	3925842	.	C	A	15	4	19	0	1	20	0	0
20	3925889	.	C	T	19	5	24	3	1	28	0	0
20	3925907	.	T	A	3	15	18	3	0	22	1	0
20	3925934	.	C	T	5	1	6	2	1	9	0	0
20	3925942	.	A	G	4	4	8	1	0	9	0	0
20	3926020	.	C	T	14	7	21	1	0	22	0	0
20	3926337	.	C	T	8	3	11	3	2	16	0	0
20	3926721	.	T	C	17	6	23	1	1	25	0	0
20	3926736	.	T	A	12	7	19	1	3	23	0	0
20	3926907	.	T	G	23	11	34	0	4	38	0	0
20	3926928	.	T	A	25	12	37	0	0	38	1	0
20	3926951	.	A	G	20	19	39	0	1	40	0	0
20	3927267	.	C	A	17	16	33	0	4	37	0	0
20	3927326	.	A	G	14	16	30	0	0	30	0	0
20	3927446	.	C	G	5	11	16	0	2	18	0	0
20	3947058	.	C	A	2	3	5	0	1	6	0	0
20	3947100	.	C	T	4	5	9	0	0	9	0	0
20	3947116	.	A	G	0	8	8	0	0	8	0	0
20	3953593	.	T	C	8	9	17	0	0	17	0	0
20	3954813	.	G	C	2	4	6	0	0	6	0	0
20	3954846	.	A	T	2	3	5	0	0	5	0	0
20	3954870	.	C	T	0	5	5	0	2	7	0	0
20	3961034	.	C	T	0	2	2	0	8	10	0	0
20	4000366	.	C	T	5	5	10	0	0	10	0	0
20	4009304	.	T	A	1	2	3	0	1	5	1	0
20	4009310	.	A	G	2	3	5	0	0	5	0	0
20	4009409	.	C	G	3	3	6	0	0	6	0	0
20	4010104	.	G	C	3	3	6	0	0	6	0	0
20	4010256	.	T	C	7	4	11	0	0	11	0	0
20	4010462	.	C	T	4	8	12	0	0	12	0	0
20	4010821	.	G	A	0	3	3	1	4	8	0	0
20	4011135	.	G	A	1	3	4	0	1	5	0	0
20	4011161	.	C	T	2	2	4	0	0	4	0	0
20	4030825	.	G	A	3	3	6	0	0	6	0	0
20	4035614	.	T	A	0	3	3	0	1	4	0	0
20	4035837	.	G	A	5	11	16	0	0	16	0	0
20	4035858	.	G	C	4	10	14	0	1	15	0	0
20	4036272	.	G	T	2	2	4	0	0	4	0	0
20	4036375	.	A	G	1	3	4	0	1	5	0	0
20	4036559	.	T	G	2	3	5	0	0	5	0	0
20	4036720	.	T	C	2	2	4	0	0	4	0	0
20	4036795	.	T	C	1	4	5	0	0	5	0	0
20	4036889	.	A	T	2	2	4	0	0	4	0	0
20	4037154	.	T	C	2	3	5	0	0	5	0	0
20	4037349	.	T	C	4	3	7	0	0	7	0	0
20	4037409	.	T	A	5	3	8	0	1	9	0	0
20	4037500	.	C	T	1	3	4	0	0	4	0	0
20	4037708	.	C	T	0	2	2	0	5	7	0	0
20	4037942	.	C	T	4	3	7	0	0	7	0	0
20	4051818	.	C	T	5	8	13	0	1	14	0	0
20	4052313	.	T	C	1	4	5	0	0	5	0	0
20	4052460	.	C	T	4	3	7	0	0	7	0	0
20	4052472	.	C	T	5	2	7	0	0	7	0	0
20	4052502	.	G	T	0	4	4	0	3	7	0	0
20	4052854	.	G	C	2	2	4	0	0	4	0	0
20	4053012	.	G	A	0	4	4	0	4	8	0	0
20	4153436	.	A	G	3	8	11	0	0	11	0	0
20	4393455	.	C	T	0	3	3	1	0	4	0	0
20	5052112	.	C	T	1	2	3	0	0	3	0	0
20	5052151	.	A	G	2	2	4	0	0	4	0	0
20	5065552	.	C	A	2	3	5	0	0	5	0	0
20	5065553	.	C	G	2	3	5	0	0	5	0	0
20	5065776	.	T	A	3	5	8	0	0	8	0	0
20	5066065	.	A	T	1	3	4	0	1	5	0	0
20	5069500	.	T	C	3	8	11	0	0	11	0	0
20	5069565	.	G	A	2	3	5	0	0	5	0	0
20	5089011	.	C	T	4	5	9	0	0	9	0	0
20	5089150	.	C	A	5	2	7	0	0	7	0	0
20	5089183	.	G	A	0	2	2	0	4	6	0	0
20	5094207	.	G	A	1	4	5	0	5	10	0	0
20	5094283	.	A	T	5	4	9	0	0	9	0	0
20	5158691	.	C	T	0	2	2	0	1	3	0	0
20	5158705	.	A	G	2	2	4	0	0	4	0	0
20	5158742	.	A	G	1	2	3	0	0	3	0	0
20	5159001	.	A	C	4	3	7	0	0	7	0	0
20	5163286	.	C	T	3	5	8	0	1	9	0	0
20	5228120	.	A	G	3	3	6	0	0	6	0	0
20	5241524	.	G	A	2	3	5	0	0	5	0	0
20	5330859	.	C	G	7	3	10	0	0	10	0	0
20	5330875	.	A	G	4	7	11	0	3	14	0	0
20	5330990	.	T	A	6	5	11	0	0	11	0	0
20	5331095	.	A	G	8	3	11	0	0	11	0	0
20	5332145	.	C	G	8	2	10	0	0	10	0	0
20	5332551	.	G	A	3	3	6	0	0	6	0	0
20	5332682	.	A	T	4	3	7	0	0	7	0	0
20	5332700	.	G	C	5	3	8	0	0	8	0	0
20	5332728	.	G	A	4	2	6	0	0	6	0	0
20	5332901	.	T	C	8	1	9	0	7	16	0	0
20	5333317	.	A	G	5	2	7	0	0	7	0	0
20	5333405	.	T	G	4	5	9	0	0	9	0	0
20	5337006	.	G	A	5	2	7	0	0	7	0	0
20	5356940	.	A	G	1	3	4	0	0	4	0	0
20	5390784	.	A	T	16	11	27	0	1	28	0	0
20	5391138	.	G	T	17	17	34	0	0	34	0	0
20	5394584	.	G	A	10	8	18	0	0	18	0	0
20	5563869	.	A	T	1	2	3	0	0	3	0	0
20	5563947	.	A	C	1	3	4	0	0	4	0	0
20	5564292	.	A	G	1	0	1	0	4	5	0	0
20	5679786	.	T	C	2	3	5	0	1	6	0	0
20	5696971	.	C	A	3	2	5	0	0	5	0	0
20	5742118	.	C	T	3	5	8	0	1	9	0	0
20	5742169	.	T	C	1	5	6	0	0	6	0	0
20	5744339	.	T	C	4	5	9	0	0	9	0	0
20	5921278	.	T	C	11	9	20	0	0	20	0	0
20	6100614	.	A	T	1	2	3	0	1	4	0	0
20	6102729	.	G	A	4	2	6	0	0	6	0	0
20	6107484	.	C	G	0	2	2	0	1	3	0	0
20	6117668	.	T	A	2	2	4	0	0	4	0	0
20	6164060	.	A	T	8	8	16	0	1	17	0	0
20	6164432	.	T	A	13	8	21	0	3	24	0	0
20	6164484	.	T	G	12	13	25	0	1	26	0	0
20	6164569	.	A	T	21	8	29	1	2	32	0	0
20	6164608	.	C	A	20	10	30	2	0	32	0	0
20	6164923	.	C	T	15	14	29	0	0	29	0	0
20	6165289	.	A	C	17	0	17	0	12	29	0	0
20	6165412	.	T	A	15	14	29	0	0	29	0	0
20	6165675	.	T	C	13	13	26	0	2	28	0	0
20	6165684	.	G	A	17	11	28	0	1	29	0	0
20	6165825	.	A	C	16	22	38	0	1	39	0	0
20	6165864	.	A	G	14	17	31	0	3	34	0	0
20	6166467	.	G	T	11	3	14	0	1	15	0	0
20	6166499	.	T	G	14	0	14	0	1	15	0	0
20	6166522	.	A	T	8	7	15	0	0	15	0	0
20	6166595	.	T	A	12	12	24	0	3	27	0	0
20	6166757	.	C	A	9	10	19	0	1	20	0	0
20	6166907	.	A	T	5	5	10	0	0	10	0	0
20	6169916	.	G	A	8	15	23	0	1	24	0	0
20	6178530	.	C	T	8	5	13	0	0	13	0	0
20	6341343	.	C	T	5	8	13	0	0	13	0	0
20	6341346	.	C	T	0	6	6	0	7	13	0	0
20	6341427	.	C	T	5	7	12	0	1	13	0	0
20	6347143	.	G	A	6	7	13	0	0	13	0	0
20	6347246	.	C	T	8	6	14	0	0	14	0	0
20	6372166	.	A	T	1	5	6	0	4	10	0	0
20	6380081	.	T	C	2	4	6	0	1	7	0	0
20	6380084	.	T	C	4	3	7	0	0	7	0	0
20	6380203	.	C	T	4	4	8	0	0	8	0	0
20	6380210	.	G	A	4	4	8	0	0	8	0	0
20	6412812	.	G	A	1	1	2	0	0	2	0	0
20	6412822	.	C	T	1	2	3	0	0	3	0	0
20	6540485	.	C	A	1	3	4	0	0	4	0	0
20	6540486	.	G	A	0	3	3	0	1	4	0	0
20	6540566	.	T	C	1	3	4	0	0	4	0	0
20	8060106	.	G	A	1	2	3	0	0	3	0	0
20	8122772	.	A	T	2	6	8	0	1	9	0	0
20	8122938	.	T	A	10	5	15	0	0	15	0	0
20	8138389	.	C	G	9	4	13	0	0	13	0	0
20	8147222	.	C	T	1	1	2	0	7	10	1	0
20	8154178	.	G	A	10	6	16	0	0	16	0	0
20	8154562	.	A	G	6	2	8	0	0	8	0	0
20	8189652	.	C	G	1	6	7	0	8	15	0	0
20	8193390	.	T	A	5	5	10	0	0	10	0	0
20	8245716	.	G	A	6	4	10	0	1	11	0	0
20	9075361	.	A	T	1	2	3	0	0	3	0	0
20	9096451	.	T	A	2	2	4	0	0	4	0	0
20	9096766	.	A	C	2	3	5	0	0	5	0	0
20	9109195	.	T	C	7	3	10	0	0	10	0	0
20	9172399	.	T	A	3	2	5	0	0	5	0	0
20	9420974	.	A	T	16	13	29	1	4	34	0	0
20	9420976	.	C	T	20	13	33	1	1	35	0	0
20	9462312	.	T	A	11	17	28	0	1	29	0	0
20	9462412	.	G	T	9	10	19	0	2	21	0	0
20	9575868	.	T	C	8	0	8	0	9	17	0	0
20	9576710	.	C	G	1	4	5	0	5	10	0	0
20	9577157	.	G	A	4	5	9	0	1	10	0	0
20	9577250	.	A	G	5	9	14	0	0	14	0	0
20	9577487	.	G	A	6	6	12	0	1	13	0	0
20	9578173	.	A	T	1	1	2	0	2	4	0	0
20	9694526	.	G	A	4	2	6	0	0	6	0	0
20	9764211	.	T	C	9	11	20	0	0	20	0	0
20	9766973	.	G	A	9	9	18	0	2	20	0	0
20	9768191	.	C	T	15	8	23	0	1	24	0	0
20	9768230	.	C	T	19	8	27	0	1	28	0	0
20	9768330	.	A	G	9	17	26	0	2	28	0	0
20	9775889	.	A	G	22	10	32	0	2	34	0	0
20	9775934	.	T	C	24	16	40	0	1	41	0	0
20	9776270	.	G	A	5	8	13	0	4	17	0	0
20	9776555	.	A	T	4	1	5	0	0	5	0	0
20	9776579	.	T	C	2	3	5	0	0	5	0	0
20	9776770	.	A	G	5	3	8	0	0	8	0	0
20	9777447	.	G	A	4	5	9	0	0	9	0	0
20	9779236	.	T	G	1	2	3	0	0	3	0	0
20	9782147	.	T	G	7	1	8	0	3	11	0	0
20	9782747	.	C	A	7	5	12	0	2	14	0	0
20	9782913	.	T	C	6	7	13	0	0	13	0	0
20	9782990	.	T	C	7	6	13	0	0	13	0	0
20	9783071	.	T	C	2	3	5	0	0	5	0	0
20	9783086	.	A	G	5	2	7	0	0	7	0	0
20	9820430	.	T	C	8	7	15	0	1	16	0	0
20	9830642	.	T	C	27	31	58	0	6	64	0	0
20	9830684	.	G	T	34	28	62	0	2	64	0	0
20	9831443	.	G	A	26	30	56	0	3	60	1	0
20	9831703	.	T	A	41	33	74	0	2	76	0	0
20	9837587	.	G	A	36	33	69	0	4	73	0	0
20	9837593	.	T	C	34	32	66	0	4	70	0	0
20	9846751	.	A	G	26	36	62	0	4	66	0	0
20	9846989	.	T	C	32	41	73	0	3	76	0	0
20	9846997	.	A	T	34	37	71	0	1	73	1	0
20	9847078	.	T	C	40	28	68	0	2	70	0	0
20	9847252	.	G	T	14	15	29	0	2	31	0	0
20	9847298	.	T	G	23	16	39	0	1	40	0	0
20	9847304	.	G	A	23	13	36	0	2	38	0	0
20	9847381	.	A	C	25	16	41	0	2	43	0	0
20	9847529	.	A	T	32	19	51	0	2	53	0	0
20	9847772	.	T	C	28	27	55	0	2	57	0	0
20	9847895	.	C	T	32	21	53	0	2	55	0	0
20	9848116	.	C	T	40	20	60	0	3	63	0	0
20	9848181	.	A	T	50	12	62	0	1	63	0	0
20	9848196	.	T	G	47	17	64	0	0	64	0	0
20	9848544	.	C	A	1	2	3	0	0	3	0	0
20	9848556	.	G	T	0	1	1	0	1	2	0	0
20	9959377	.	G	A	4	3	7	0	0	7	0	0
20	9959699	.	T	A	9	4	13	0	0	13	0	0
20	9959725	.	C	T	4	4	8	0	0	8	0	0
20	9959794	.	T	C	3	5	8	0	0	8	0	0
20	9959890	.	G	A	6	3	9	0	1	10	0	0
20	9960348	.	A	G	1	2	3	0	0	3	0	0
20	9960378	.	G	A	3	2	5	0	0	5	0	0
20	9960635	.	G	A	1	5	6	0	0	6	0	0
20	9960859	.	G	T	2	2	4	0	0	4	0	0
20	9960974	.	C	T	2	3	5	0	0	5	0	0
20	9961144	.	G	A	5	2	7	0	0	7	0	0
20	9961145	.	T	C	5	0	5	0	2	7	0	0
20	10057929	.	T	C	1	3	4	0	0	4	0	0
20	10057993	.	C	G	0	4	4	0	12	16	0	0
20	10058109	.	T	A	7	9	16	0	1	17	0	0
20	10058111	.	A	G	7	9	16	0	1	17	0	0
20	10058242	.	T	C	12	9	21	0	0	21	0	0
20	10058350	.	C	T	8	7	15	0	2	17	0	0
20	10058441	.	A	T	6	9	15	0	0	15	0	0
20	10058476	.	T	A	6	12	18	0	1	19	0	0
20	10058796	.	G	A	8	3	11	0	0	11	0	0
20	10058948	.	T	A	9	6	15	0	0	15	0	0
20	10058993	.	T	C	7	0	7	0	14	21	0	0
20	10059194	.	G	A	8	9	17	0	0	17	0	0
20	10059278	.	A	G	7	8	15	0	1	16	0	0
20	10059815	.	A	G	6	2	8	0	0	8	0	0
20	10060483	.	A	C	5	5	10	0	0	10	0	0
20	10060586	.	C	T	2	5	7	0	0	7	0	0
20	10060768	.	G	C	3	2	5	0	0	5	0	0
20	10060859	.	C	A	3	3	6	0	0	6	0	0
20	10061144	.	T	A	1	2	3	0	1	4	0	0
20	10061250	.	G	C	1	3	4	0	0	4	0	0
20	10061563	.	C	T	3	2	5	0	0	5	0	0
20	10061859	.	C	T	3	2	5	0	0	5	0	0
20	10064993	.	A	G	5	4	9	0	0	9	0	0
20	10065033	.	T	A	2	2	4	0	0	4	0	0
20	10099362	.	T	A	5	5	10	0	0	10	0	0
20	10099363	.	C	T	5	5	10	0	0	10	0	0
20	10099521	.	T	G	3	3	6	0	1	7	0	0
20	10099602	.	C	A	8	4	12	0	1	13	0	0
20	10099603	.	C	A	8	5	13	0	0	13	0	0
20	10099816	.	C	T	9	11	20	0	0	20	0	0
20	10116067	.	A	G	16	10	26	0	0	26	0	0
20	10118393	.	A	T	7	4	11	0	1	12	0	0
20	10118691	.	T	C	4	6	10	0	1	11	0	0
20	10204518	.	T	C	3	2	5	0	0	5	0	0
20	10204644	.	A	T	2	4	6	0	0	6	0	0
20	10210328	.	A	G	3	0	3	0	7	10	0	0
20	10210358	.	C	T	4	4	8	0	1	9	0	0
20	10218637	.	T	A	5	2	7	0	0	7	0	0
20	10218937	.	C	A	3	3	6	0	1	7	0	0
20	10219467	.	C	A	2	5	7	0	0	7	0	0
20	10219537	.	C	T	3	4	7	0	0	7	0	0
20	10219779	.	G	A	3	4	7	0	0	7	0	0
20	10219829	.	C	G	2	2	4	0	1	5	0	0
20	10219985	.	A	T	2	4	6	0	0	6	0	0
20	10219988	.	A	G	1	4	5	0	1	6	0	0
20	10220138	.	T	C	2	9	11	0	0	11	0	0
20	10220213	.	G	A	2	5	7	0	1	8	0	0
20	10220261	.	G	T	5	4	9	0	1	10	0	0
20	10353474	.	A	G	9	4	13	0	0	13	0	0
20	10353528	.	G	A	2	8	10	0	1	11	0	0
20	10353654	.	T	C	2	1	3	0	3	6	0	0
20	10353683	.	C	T	4	3	7	0	0	7	0	0
20	10353718	.	G	T	3	4	7	0	1	8	0	0
20	10353728	.	A	G	2	5	7	0	1	8	0	0
20	10353762	.	T	C	1	7	8	0	0	8	0	0
20	10353797	.	A	G	4	6	10	0	0	10	0	0
20	10353798	.	A	T	4	6	10	0	0	10	0	0
20	10353912	.	G	C	7	7	14	0	0	14	0	0
20	10354329	.	A	G	2	3	5	0	1	6	0	0
20	10354482	.	T	G	5	5	10	0	0	10	0	0
20	10422619	.	A	C	9	4	13	0	0	13	0	0
20	10422658	.	G	T	6	4	10	0	0	10	0	0
20	10489564	.	A	G	5	4	9	0	1	10	0	0
20	11098255	.	G	A	5	7	12	0	1	13	0	0
20	11098301	.	T	C	4	4	8	0	0	8	0	0
20	11098547	.	T	A	3	4	7	0	0	7	0	0
20	11098710	.	C	A	7	7	14	0	0	14	0	0
20	11098851	.	G	A	7	4	11	0	0	11	0	0
20	11098859	.	G	A	8	4	12	0	0	12	0	0
20	11098960	.	G	A	5	7	12	0	0	12	0	0
20	11099013	.	G	A	8	8	16	0	0	16	0	0
20	11099064	.	C	T	6	10	16	0	0	16	0	0
20	11099223	.	C	T	1	6	7	0	4	11	0	0
20	11099304	.	A	G	5	2	7	0	2	9	0	0
20	11099345	.	T	A	7	7	14	0	0	14	0	0
20	11101271	.	C	T	2	2	4	0	0	4	0	0
20	11101291	.	G	T	1	2	3	0	0	3	0	0
20	11101331	.	T	C	0	2	2	0	1	3	0	0
20	11101578	.	T	A	5	2	7	0	0	7	0	0
20	11101584	.	C	T	5	2	7	0	0	7	0	0
20	11102895	.	T	G	3	2	5	0	0	5	0	0
20	11103392	.	G	T	3	4	7	0	0	7	0	0
20	11105202	.	G	A	2	2	4	0	0	4	0	0
20	13567503	.	T	C	8	0	8	0	9	17	0	0
20	14893339	.	A	C	3	17	20	0	1	22	1	0
20	14977165	.	G	A	2	10	12	0	6	18	0	0
20	14983779	.	C	T	9	10	19	0	2	21	0	0
20	14983788	.	C	T	8	11	19	0	0	19	0	0
20	14997711	.	G	C	13	13	26	0	0	27	1	0
20	14997729	.	G	A	14	10	24	0	1	25	0	0
20	14997753	.	T	A	13	9	22	0	0	22	0	0
20	15004153	.	T	C	14	21	35	0	0	35	0	0
20	15004205	.	C	T	14	21	35	0	1	36	0	0
20	15004321	.	C	T	15	25	40	0	0	40	0	0
20	15004334	.	A	C	16	24	40	0	0	40	0	0
20	15004518	.	A	G	7	22	29	0	0	29	0	0
20	15004575	.	C	A	11	17	28	0	1	29	0	0
20	15004611	.	A	C	10	19	29	0	0	29	0	0
20	15004710	.	C	T	14	15	29	0	0	29	0	0
20	15004746	.	T	A	15	13	28	0	0	28	0	0
20	15004751	.	T	G	12	12	24	0	1	25	0	0
20	15004806	.	C	T	17	8	25	0	1	26	0	0
20	15004825	.	A	T	14	7	21	0	3	24	0	0
20	15004862	.	T	C	23	4	27	0	0	27	0	0
20	15004874	.	A	G	20	0	20	0	6	26	0	0
20	15023488	.	T	C	9	16	25	0	1	26	0	0
20	15026847	.	C	T	1	9	10	0	15	25	0	0
20	15034192	.	A	G	10	8	18	0	2	20	0	0
20	15039385	.	C	T	0	4	4	0	7	11	0	0
20	15050678	.	G	A	1	3	4	0	1	6	1	0
20	15050753	.	G	T	1	3	4	0	2	6	0	0
20	15051266	.	C	T	3	4	7	0	0	7	0	0
20	15051379	.	T	G	1	4	5	0	0	5	0	0
20	15051422	.	C	T	4	5	9	0	0	9	0	0
20	15051770	.	G	A	1	4	5	0	0	5	0	0
20	15051791	.	G	A	2	6	8	0	0	8	0	0
20	15051812	.	T	C	2	4	6	0	0	6	0	0
20	15051832	.	T	A	6	1	7	0	0	7	0	0
20	15094356	.	C	T	0	4	4	0	1	5	0	0
20	15094583	.	T	A	2	2	4	0	0	4	0	0
20	15126465	.	A	G	1	2	3	0	0	3	0	0
20	15128402	.	C	G	1	3	4	0	0	4	0	0
20	15128457	.	G	A	2	4	6	0	0	6	0	0
20	15171711	.	C	T	13	11	24	0	0	24	0	0
20	15184455	.	C	T	21	15	36	0	2	38	0	0
20	15184458	.	A	G	17	2	19	0	18	37	0	0
20	15184527	.	T	A	20	22	42	0	2	44	0	0
20	15184568	.	T	G	23	20	43	0	1	44	0	0
20	15184611	.	A	T	12	12	24	0	0	24	0	0
20	15184629	.	T	G	9	7	16	0	1	17	0	0
20	15184654	.	C	T	6	6	12	0	0	12	0	0
20	15184671	.	A	G	4	5	9	0	0	9	0	0
20	15184748	.	C	G	2	3	5	0	0	5	0	0
20	15553003	.	C	T	18	6	24	0	0	24	0	0
20	15553159	.	A	G	12	14	26	0	0	26	0	0
20	15553366	.	G	T	14	14	28	0	4	32	0	0
20	15554247	.	A	G	18	11	29	0	1	30	0	0
20	15857317	.	G	C	19	5	24	0	0	24	0	0
20	15857761	.	T	A	14	21	35	0	0	35	0	0
20	15857805	.	T	A	14	20	34	0	2	36	0	0
20	15857850	.	C	T	19	12	31	0	4	35	0	0
20	15866267	.	A	G	11	20	31	0	1	32	0	0
20	15866414	.	T	C	13	11	24	0	2	26	0	0
20	15876778	.	A	G	15	21	36	0	1	37	0	0
20	15876812	.	G	A	16	16	32	0	3	35	0	0
20	15876824	.	C	A	0	17	17	0	16	33	0	0
20	15912192	.	C	T	0	11	11	0	5	16	0	0
20	15912853	.	C	T	0	2	2	0	1	3	0	0
20	15912906	.	T	C	8	10	18	0	1	19	0	0
20	15933068	.	C	T	0	2	2	0	1	3	0	0
20	15933168	.	G	C	8	8	16	0	0	16	0	0
20	15933223	.	C	A	11	8	19	0	1	20	0	0
20	15933229	.	T	C	12	8	20	0	1	21	0	0
20	15933258	.	C	T	11	13	24	0	0	24	0	0
20	15933289	.	G	A	11	16	27	0	2	29	0	0
20	15933419	.	G	A	8	7	15	0	2	17	0	0
20	15933424	.	T	C	7	8	15	0	2	17	0	0
20	15933489	.	T	C	12	0	12	0	6	18	0	0
20	15933553	.	G	A	9	4	13	0	2	15	0	0
20	15933566	.	G	A	7	10	17	0	1	18	0	0
20	15933852	.	C	T	7	4	11	0	2	13	0	0
20	15933961	.	C	T	4	3	7	0	3	10	0	0
20	15934395	.	G	T	9	3	12	0	0	12	0	0
20	15934519	.	A	G	5	10	15	0	0	15	0	0
20	15934526	.	G	T	6	11	17	0	2	19	0	0
20	15934592	.	T	C	5	3	8	0	0	8	0	0
20	15934639	.	G	C	4	2	6	0	0	6	0	0
20	15935012	.	G	T	3	1	4	0	1	5	0	0
20	15935109	.	A	T	2	3	5	0	0	5	0	0
20	15935141	.	T	G	3	3	6	0	1	7	0	0
20	15935146	.	A	C	3	5	8	0	0	8	0	0
20	15935892	.	C	T	1	4	5	0	0	5	0	0
20	15937029	.	A	T	10	5	15	0	0	15	0	0
20	15937049	.	C	T	4	7	11	0	1	12	0	0
20	15937567	.	G	T	6	3	9	0	0	9	0	0
20	15937613	.	G	A	4	2	6	1	1	8	0	0
20	15937648	.	A	T	8	3	11	1	1	13	0	0
20	15937709	.	G	A	3	8	11	0	0	11	0	0
20	15937926	.	C	A	1	2	3	0	0	3	0	0
20	15943257	.	G	T	1	2	3	0	0	3	0	0
20	15969999	.	G	A	5	2	7	0	0	7	0	0
20	15974445	.	G	A	7	2	9	0	0	9	0	0
20	16020682	.	A	G	2	2	4	0	0	4	0	0
20	16156347	.	A	G	6	4	10	0	0	10	0	0
20	16163282	.	C	T	8	9	17	0	0	17	0	0
20	16163333	.	T	C	13	0	13	0	10	23	0	0
20	16163348	.	T	C	11	13	24	0	1	25	0	0
20	16163384	.	A	G	20	9	29	0	0	29	0	0
20	16163447	.	T	C	8	1	9	0	13	22	0	0
20	16163552	.	G	A	6	7	13	0	1	14	0	0
20	16171113	.	G	C	2	0	2	0	2	4	0	0
20	16171203	.	A	T	3	1	4	0	2	6	0	0
20	16173957	.	T	C	3	3	6	0	0	6	0	0
20	16173984	.	T	G	3	0	3	0	4	7	0	0
20	16180064	.	C	A	4	6	10	0	0	10	0	0
20	16180103	.	G	T	6	4	10	0	0	10	0	0
20	16180469	.	G	A	3	3	6	0	1	7	0	0
20	16182806	.	C	T	4	3	7	1	0	8	0	0
20	16184525	.	C	T	4	4	8	0	0	8	0	0
20	16193658	.	T	C	5	12	17	0	1	18	0	0
20	16193899	.	C	T	10	10	20	0	1	21	0	0
20	16198986	.	G	A	3	10	13	0	10	23	0	0
20	16201109	.	T	A	14	5	19	2	2	23	0	0
20	16201111	.	G	A	1	12	13	3	7	23	0	0
20	16201200	.	C	T	9	16	25	0	0	25	0	0
20	16201649	.	A	C	4	10	14	0	1	15	0	0
20	16201709	.	A	G	10	4	14	0	2	16	0	0
20	16201759	.	T	C	9	7	16	0	1	17	0	0
20	16201812	.	A	G	1	6	7	0	0	7	0	0
20	16437895	.	A	G	6	5	11	0	0	11	0	0
20	16437958	.	A	G	4	7	11	0	2	13	0	0
20	16438097	.	G	A	11	10	21	0	1	22	0	0
20	16438119	.	T	A	11	10	21	0	0	21	0	0
20	16438252	.	G	A	11	15	26	0	2	28	0	0
20	16438258	.	A	T	14	12	26	0	0	26	0	0
20	16438658	.	A	T	7	9	16	0	0	16	0	0
20	16438854	.	T	C	8	7	15	0	0	15	0	0
20	16441658	.	C	T	15	6	21	0	1	22	0	0
20	16443545	.	G	A	8	7	15	0	1	16	0	0
20	16443740	.	C	T	11	19	30	0	1	31	0	0
20	16447831	.	A	G	7	6	13	0	0	13	0	0
20	16448930	.	T	C	6	7	13	0	1	14	0	0
20	16478294	.	G	A	1	6	7	0	0	7	0	0
20	16478324	.	G	A	3	4	7	0	2	9	0	0
20	16498932	.	C	A	1	2	3	0	1	4	0	0
20	16640049	.	C	T	3	8	11	0	1	12	0	0
20	16734343	.	C	T	16	16	32	0	3	35	0	0
20	16736960	.	G	A	15	18	33	0	0	33	0	0
20	16737485	.	C	T	16	12	28	0	1	29	0	0
20	16737512	.	C	T	11	20	31	0	0	31	0	0
20	16737524	.	T	C	22	15	37	0	0	37	0	0
20	16740834	.	G	A	13	15	28	0	0	28	0	0
20	16774513	.	A	T	41	26	67	0	2	69	0	0
20	16774868	.	A	G	26	23	49	1	8	59	1	0
20	16775173	.	C	T	23	22	45	0	2	47	0	0
20	16833019	.	C	T	0	8	8	0	8	16	0	0
20	16833089	.	A	G	12	11	23	0	0	23	0	0
20	16833096	.	A	G	12	10	22	0	1	23	0	0
20	16833125	.	C	T	9	7	16	0	2	18	0	0
20	16833213	.	G	C	7	4	11	0	1	12	0	0
20	16833284	.	A	T	7	12	19	0	1	20	0	0
20	16833560	.	T	C	6	4	10	1	3	14	0	0
20	16833654	.	A	T	1	3	4	1	1	6	0	0
20	16833671	.	C	A	4	0	4	1	1	6	0	0
20	16833699	.	C	A	6	0	6	1	0	7	0	0
20	16833806	.	C	A	6	7	13	0	1	14	0	0
20	16833893	.	A	G	2	2	4	0	1	5	0	0
20	16834096	.	T	C	5	7	12	0	1	13	0	0
20	16834307	.	C	A	1	7	8	0	4	12	0	0
20	16834525	.	A	G	4	5	9	0	0	9	0	0
20	16834572	.	C	T	1	8	9	0	5	14	0	0
20	16834647	.	T	C	5	4	9	0	0	9	0	0
20	16848908	.	C	T	8	5	13	0	0	13	0	0
20	16849100	.	C	A	1	8	9	0	7	16	0	0
20	16883694	.	C	G	4	0	4	0	5	9	0	0
20	16884078	.	C	T	3	3	6	0	0	6	0	0
20	16884434	.	C	T	8	8	16	0	0	16	0	0
20	17740099	.	T	G	0	0	0	0	3	3	0	0
20	17740215	.	G	A	9	9	18	0	1	19	0	0
20	17740260	.	G	C	1	3	4	0	8	12	0	0
20	17740261	.	T	C	9	3	12	0	0	12	0	0
20	17798876	.	C	T	14	7	21	0	0	21	0	0
20	17798906	.	T	C	5	11	16	0	0	16	0	0
20	17798930	.	C	T	13	8	21	0	0	21	0	0
20	17800867	.	T	C	15	13	28	0	0	28	0	0
20	17802979	.	C	T	10	14	24	0	2	26	0	0
20	17809123	.	G	A	19	22	41	0	3	44	0	0
20	17809177	.	C	T	22	24	46	0	1	47	0	0
20	17811587	.	G	A	19	21	40	0	0	40	0	0
20	17813702	.	C	T	23	23	46	2	1	49	0	0
20	17817659	.	G	T	21	15	36	0	3	39	0	0
20	17817886	.	T	A	25	10	35	0	0	35	0	0
20	17818129	.	G	C	5	18	23	0	1	24	0	0
20	17818159	.	A	T	2	13	15	1	4	20	0	0
20	17818291	.	T	C	15	8	23	1	5	29	0	0
20	17818445	.	T	A	20	20	40	0	4	44	0	0
20	17819008	.	T	C	24	9	33	1	2	36	0	0
20	18225441	.	C	A	3	9	12	0	1	13	0	0
20	18255474	.	A	G	11	0	11	0	15	26	0	0
20	18255810	.	T	C	13	12	25	0	1	26	0	0
20	18255931	.	A	T	11	11	22	0	3	25	0	0
20	18256176	.	T	A	4	6	10	0	2	12	0	0
20	18306290	.	T	A	8	12	20	1	0	21	0	0
20	18306298	.	T	G	8	13	21	1	1	23	0	0
20	18307075	.	T	C	18	2	20	0	13	33	0	0
20	18309277	.	C	T	11	18	29	0	1	30	0	0
20	18312803	.	T	C	21	16	37	0	1	38	0	0
20	18312839	.	T	C	20	17	37	0	0	37	0	0
20	18357820	.	T	C	5	8	13	0	0	13	0	0
20	18358002	.	T	C	5	4	9	0	4	13	0	0
20	18369979	.	G	A	8	6	14	0	1	15	0	0
20	18376800	.	C	T	3	1	4	0	2	6	0	0
20	18392845	.	C	T	18	18	36	0	1	37	0	0
20	18393249	.	T	C	13	17	30	0	1	31	0	0
20	18393359	.	A	T	13	18	31	0	2	33	0	0
20	18393376	.	C	T	14	19	33	0	1	34	0	0
20	18396134	.	A	G	24	15	39	0	1	40	0	0
20	18413987	.	T	C	11	1	12	0	8	20	0	0
20	18414262	.	C	T	10	4	14	0	2	16	0	0
20	18432732	.	C	T	11	4	15	0	0	15	0	0
20	18454644	.	G	A	1	4	5	0	0	5	0	0
20	18456519	.	C	A	2	3	5	0	0	5	0	0
20	18591638	.	G	T	19	24	43	0	3	46	0	0
20	18591704	.	G	A	22	17	39	0	4	43	0	0
20	18591716	.	A	C	22	18	40	0	2	42	0	0
20	18591743	.	A	T	19	17	36	0	0	36	0	0
20	18594958	.	C	A	31	23	54	0	1	56	1	0
20	18594980	.	T	A	26	27	53	0	2	55	0	0
20	18595296	.	T	G	10	0	10	0	22	32	0	0
20	18669600	.	G	A	7	8	15	0	0	15	0	0
20	18672064	.	C	T	4	13	17	0	0	17	0	0
20	18672094	.	T	C	7	10	17	0	0	17	0	0
20	18672193	.	G	A	0	6	6	0	13	19	0	0
20	18672733	.	A	T	9	11	20	0	0	20	0	0
20	18672970	.	G	A	8	8	16	0	2	18	0	0
20	18673132	.	C	T	7	12	19	0	3	22	0	0
20	18677343	.	G	A	2	10	12	0	0	12	0	0
20	18677391	.	T	G	9	0	9	0	3	12	0	0
20	18678023	.	T	C	12	10	22	0	1	23	0	0
20	18678466	.	C	T	15	11	26	0	0	26	0	0
20	18683158	.	T	C	18	18	36	0	1	37	0	0
20	18684922	.	A	T	21	9	30	0	2	32	0	0
20	18685139	.	G	A	10	9	19	0	1	20	0	0
20	18708770	.	T	C	30	24	54	0	1	55	0	0
20	18713067	.	T	C	27	24	51	0	4	55	0	0
20	18714024	.	C	T	3	8	11	0	0	11	0	0
20	18714242	.	C	A	6	4	10	0	0	10	0	0
20	18714282	.	A	G	3	2	5	0	2	7	0	0
20	18714430	.	A	T	1	2	3	0	1	4	0	0
20	18714824	.	G	A	3	4	7	0	0	7	0	0
20	18721340	.	G	T	1	5	6	0	0	6	0	0
20	18721775	.	T	G	9	11	20	0	0	20	0	0
20	18721910	.	G	A	11	10	21	0	1	22	0	0
20	18722089	.	G	C	16	9	25	0	1	26	0	0
20	18722312	.	A	C	8	12	20	0	0	20	0	0
20	18722565	.	A	T	20	20	40	1	2	43	0	0
20	18722630	.	C	T	1	9	10	0	8	18	0	0
20	18722857	.	G	A	3	8	11	0	1	12	0	0
20	18722931	.	G	A	3	4	7	1	0	8	0	0
20	18722943	.	G	A	4	3	7	1	0	8	0	0
20	18723062	.	C	T	9	9	18	0	1	19	0	0
20	18723105	.	C	T	12	16	28	0	1	29	0	0
20	18723401	.	T	C	9	0	9	1	7	17	0	0
20	18723441	.	G	A	7	13	20	0	0	20	0	0
20	18723459	.	T	C	8	9	17	0	1	18	0	0
20	18723781	.	T	G	7	12	19	0	0	19	0	0
20	18727472	.	T	C	11	7	18	0	1	19	0	0
20	18727506	.	T	C	5	10	15	0	0	15	0	0
20	18730498	.	G	A	6	6	12	0	0	12	0	0
20	18730840	.	T	C	4	10	14	0	0	14	0	0
20	18747062	.	C	A	2	2	4	0	0	4	0	0
20	18747199	.	C	A	1	3	4	0	0	4	0	0
20	18747210	.	G	A	1	3	4	0	0	4	0	0
20	18755283	.	C	T	2	4	6	0	0	6	0	0
20	18756628	.	A	G	1	3	4	0	1	5	0	0
20	18776489	.	T	G	2	3	5	0	0	5	0	0
20	18802172	.	C	A	2	2	4	0	0	4	0	0
20	18802651	.	G	A	1	3	4	0	0	4	0	0
20	18810201	.	C	T	2	3	5	0	0	5	0	0
20	18915249	.	C	T	7	3	10	0	0	11	1	0
20	18947331	.	G	A	0	7	7	1	8	16	0	0
20	18955563	.	A	T	4	9	13	0	1	14	0	0
20	18956708	.	T	A	6	4	10	0	1	11	0	0
20	18956729	.	C	T	4	4	8	0	0	8	0	0
20	18958106	.	C	G	6	5	11	0	0	11	0	0
20	18958159	.	T	C	3	8	11	0	0	11	0	0
20	18958477	.	G	A	0	6	6	0	7	13	0	0
20	18961835	.	T	C	6	6	12	0	0	12	0	0
20	18961838	.	C	T	6	7	13	0	0	13	0	0
20	18968826	.	C	T	6	9	15	0	2	17	0	0
20	18972850	.	T	A	11	14	25	0	1	26	0	0
20	18992711	.	G	A	7	3	10	0	0	10	0	0
20	18992763	.	T	C	6	6	12	0	0	12	0	0
20	18994634	.	C	T	3	3	6	0	0	6	0	0
20	18996331	.	C	T	10	8	18	0	1	19	0	0
20	18997305	.	A	G	16	13	29	0	0	29	0	0
20	18997610	.	A	G	15	11	26	0	1	27	0	0
20	18997875	.	A	G	9	10	19	2	1	22	0	0
20	19018520	.	G	A	8	6	14	0	0	14	0	0
20	19058143	.	G	A	9	4	13	0	0	13	0	0
20	19058152	.	T	G	9	3	12	0	1	13	0	0
20	19058188	.	A	G	12	3	15	0	0	15	0	0
20	19058194	.	T	C	10	3	13	0	0	13	0	0
20	19058241	.	A	C	13	6	19	0	2	21	0	0
20	19058326	.	A	G	7	9	16	0	1	17	0	0
20	19058475	.	T	G	1	4	5	0	0	5	0	0
20	19058500	.	A	G	3	2	5	0	0	5	0	0
20	19059193	.	A	T	1	1	2	0	1	3	0	0
20	19076873	.	C	T	4	4	8	0	0	8	0	0
20	19077156	.	T	C	5	7	12	0	2	14	0	0
20	19077628	.	A	G	5	12	17	0	0	17	0	0
20	19213235	.	G	A	13	5	18	0	3	21	0	0
20	19213586	.	T	A	10	8	18	0	3	21	0	0
20	19213587	.	G	C	10	11	21	0	0	21	0	0
20	19238509	.	A	T	11	11	22	0	0	22	0	0
20	19258639	.	T	C	10	11	21	0	2	23	0	0
20	19276967	.	G	C	3	2	5	0	0	5	0	0
20	19277169	.	G	C	3	3	6	0	0	6	0	0
20	19277610	.	T	A	3	3	6	0	0	6	0	0
20	19277611	.	C	G	2	2	4	0	2	6	0	0
20	19277663	.	C	T	4	3	7	0	0	7	0	0
20	19290547	.	C	T	4	7	11	0	0	11	0	0
20	19290586	.	G	A	5	7	12	0	2	14	0	0
20	19373597	.	G	A	7	9	16	0	2	18	0	0
20	19373616	.	T	C	9	8	17	0	2	19	0	0
20	19373647	.	C	T	17	11	28	0	2	30	0	0
20	19373653	.	T	A	17	11	28	0	2	30	0	0
20	19373720	.	T	C	12	0	12	1	17	30	0	0
20	19373852	.	A	G	18	11	29	0	0	29	0	0
20	19373919	.	A	G	11	8	19	0	0	19	0	0
20	19373939	.	G	A	11	10	21	0	0	21	0	0
20	19374058	.	C	T	10	5	15	0	1	16	0	0
20	19374093	.	A	T	10	9	19	0	1	20	0	0
20	19374120	.	G	T	7	6	13	0	1	14	0	0
20	19374242	.	G	T	2	3	5	0	1	6	0	0
20	19374415	.	C	T	0	6	6	0	10	16	0	0
20	19374524	.	G	A	12	3	15	0	0	15	0	0
20	19374714	.	G	A	11	5	16	0	0	16	0	0
20	19374755	.	A	G	10	4	14	0	2	16	0	0
20	19391641	.	A	G	10	4	14	0	0	14	0	0
20	19391677	.	T	A	7	8	15	0	1	16	0	0
20	19391704	.	A	G	2	5	7	0	1	8	0	0
20	19401018	.	T	C	3	3	6	0	1	7	0	0
20	19406475	.	A	G	3	4	7	0	1	8	0	0
20	19406620	.	A	G	7	3	10	0	0	10	0	0
20	19406683	.	T	C	3	4	7	0	0	7	0	0
20	19406709	.	A	C	3	3	6	0	0	6	0	0
20	19429879	.	T	C	2	2	4	0	0	4	0	0
20	19430352	.	C	A	5	4	9	0	1	10	0	0
20	19430778	.	C	A	8	9	17	0	2	19	0	0
20	19430790	.	C	T	11	8	19	0	2	21	0	0
20	19431631	.	G	C	8	8	16	0	0	16	0	0
20	19431665	.	G	A	6	7	13	0	2	15	0	0
20	19431960	.	C	G	7	6	13	0	0	13	0	0
20	19432007	.	G	T	4	3	7	0	1	8	0	0
20	19432150	.	T	A	10	4	14	0	1	15	0	0
20	19436389	.	G	C	8	7	15	0	0	15	0	0
20	19436440	.	G	A	8	6	14	0	0	14	0	0
20	19436890	.	T	C	6	0	6	0	1	7	0	0
20	19436899	.	C	A	6	8	14	0	0	14	0	0
20	19437434	.	T	C	8	1	9	0	4	13	0	0
20	19437624	.	T	C	10	0	10	0	8	18	0	0
20	19437848	.	T	C	6	0	6	0	9	15	0	0
20	19437969	.	A	G	8	4	12	0	1	13	0	0
20	19438082	.	T	G	7	6	13	0	0	13	0	0
20	19438110	.	C	A	9	6	15	0	1	16	0	0
20	19438146	.	T	C	7	1	8	0	10	18	0	0
20	19438181	.	C	T	1	4	5	0	7	12	0	0
20	19438193	.	T	A	7	4	11	0	0	11	0	0
20	19438425	.	G	A	9	8	17	0	0	17	0	0
20	19438460	.	T	G	6	8	14	0	0	14	0	0
20	19440796	.	T	C	7	9	16	0	2	18	0	0
20	19443045	.	G	T	7	3	10	0	1	11	0	0
20	19447443	.	G	A	5	3	8	0	0	8	0	0
20	19451575	.	A	G	5	8	13	0	0	13	0	0
20	19510892	.	G	C	3	6	9	0	0	9	0	0
20	19510904	.	A	G	3	7	10	0	1	11	0	0
20	19510950	.	C	A	2	4	6	0	0	6	0	0
20	19515966	.	G	T	9	6	15	0	0	15	0	0
20	19516009	.	A	G	4	4	8	0	3	11	0	0
20	19516068	.	C	T	4	7	11	0	0	11	0	0
20	19516096	.	T	A	5	6	11	0	1	12	0	0
20	19516274	.	C	A	3	5	8	0	2	10	0	0
20	19516276	.	G	A	4	6	10	0	0	10	0	0
20	19516315	.	G	C	5	4	9	0	0	9	0	0
20	19516392	.	T	C	5	11	16	0	1	17	0	0
20	19516406	.	T	G	7	1	8	0	12	20	0	0
20	19516537	.	T	C	5	7	12	0	3	15	0	0
20	19516772	.	T	C	6	4	10	0	1	11	0	0
20	19516837	.	G	A	10	11	21	1	0	22	0	0
20	19517027	.	C	G	10	11	21	0	1	22	0	0
20	19518685	.	A	G	14	14	28	0	0	28	0	0
20	19519403	.	C	G	10	10	20	0	0	20	0	0
20	19519454	.	T	G	4	10	14	0	0	14	0	0
20	19521657	.	C	T	10	9	19	0	0	19	0	0
20	19524966	.	A	G	11	12	23	0	0	23	0	0
20	19524978	.	G	A	12	13	25	0	2	27	0	0
20	19530702	.	G	A	7	9	16	0	0	16	0	0
20	19562536	.	C	A	5	2	7	0	0	7	0	0
20	19562565	.	G	T	5	4	9	0	1	10	0	0
20	19562630	.	G	T	2	3	5	0	5	10	0	0
20	19562664	.	C	A	4	3	7	0	0	7	0	0
20	19562743	.	G	T	6	5	11	1	1	13	0	0
20	19562853	.	T	A	5	7	12	0	1	13	0	0
20	19575264	.	G	A	9	13	22	0	0	22	0	0
20	19575271	.	A	G	8	13	21	0	3	24	0	0
20	19580091	.	A	T	9	9	18	0	0	18	0	0
20	19580331	.	C	T	12	7	19	0	2	21	0	0
20	19580367	.	T	A	9	7	16	0	1	17	0	0
20	19580397	.	A	G	7	6	13	0	1	14	0	0
20	19580405	.	G	A	7	7	14	0	1	15	0	0
20	19580441	.	A	G	9	8	17	0	0	17	0	0
20	19580525	.	C	A	11	8	19	0	0	19	0	0
20	19580584	.	T	C	16	0	16	0	14	30	0	0
20	19583028	.	C	G	9	10	19	0	0	19	0	0
20	19793708	.	A	G	1	2	3	0	0	3	0	0
20	19793727	.	A	G	1	2	3	0	0	3	0	0
20	19793745	.	A	T	1	2	3	0	0	3	0	0
20	19822051	.	C	T	1	3	4	0	0	4	0	0
20	19822153	.	G	A	1	2	3	0	3	6	0	0
20	19822442	.	A	G	3	0	3	0	6	9	0	0
20	19822603	.	G	C	4	3	7	0	1	8	0	0
20	19822612	.	C	T	3	3	6	0	0	6	0	0
20	19823472	.	C	T	2	6	8	0	0	8	0	0
20	19823518	.	A	G	3	5	8	0	0	8	0	0
20	19823761	.	A	T	3	2	5	0	0	5	0	0
20	19965289	.	T	A	2	2	4	0	1	5	0	0
20	19965301	.	A	G	2	3	5	0	0	5	0	0
20	20231995	.	G	C	10	13	23	0	0	23	0	0
20	20232347	.	A	T	12	12	24	0	0	24	0	0
20	20232456	.	G	T	11	16	27	0	0	27	0	0
20	20269835	.	T	A	4	4	8	0	2	10	0	0
20	20269836	.	T	C	5	4	9	0	1	10	0	0
20	20270109	.	G	T	4	4	8	0	2	10	0	0
20	20270173	.	G	T	3	2	5	0	0	5	0	0
20	20275088	.	G	A	3	4	7	0	2	9	0	0
20	20275095	.	A	T	6	5	11	0	0	11	0	0
20	20275193	.	A	T	7	10	17	0	0	17	0	0
20	20275196	.	C	A	9	9	18	0	0	18	0	0
20	20275306	.	C	T	6	15	21	0	0	21	0	0
20	20275322	.	T	A	11	15	26	0	0	26	0	0
20	20275434	.	T	A	20	9	29	0	0	29	0	0
20	20275455	.	C	T	23	9	32	0	5	37	0	0
20	20275661	.	C	T	3	11	14	0	16	30	0	0
20	20275674	.	A	G	16	9	25	0	1	26	0	0
20	20275766	.	T	G	11	11	22	0	1	23	0	0
20	20275776	.	T	C	13	0	13	0	10	23	0	0
20	20312278	.	G	A	2	5	7	0	0	7	0	0
20	20326945	.	A	T	8	7	15	0	2	17	0	0
20	20328055	.	A	G	30	22	52	0	6	58	0	0
20	20328137	.	G	A	27	31	58	0	5	63	0	0
20	20330095	.	C	A	24	23	47	0	0	47	0	0
20	20330256	.	T	C	28	18	46	0	1	48	1	0
20	20331235	.	T	A	23	20	43	0	0	43	0	0
20	20331740	.	A	G	15	19	34	0	1	35	0	0
20	20332079	.	G	A	22	17	39	0	0	39	0	0
20	20334705	.	G	A	12	10	22	0	0	22	0	0
20	20335543	.	A	G	8	6	14	0	0	14	0	0
20	20335739	.	G	C	10	5	15	0	0	15	0	0
20	20335784	.	A	T	11	10	21	0	0	21	0	0
20	20337215	.	G	A	15	14	29	0	2	31	0	0
20	20337263	.	A	C	14	10	24	0	1	25	0	0
20	20338509	.	A	G	11	14	25	0	2	27	0	0
20	20338569	.	C	T	8	7	15	0	0	15	0	0
20	20601233	.	C	G	11	7	18	0	0	18	0	0
20	20601651	.	T	G	9	10	19	0	2	21	0	0
20	20601883	.	A	T	14	12	26	0	2	28	0	0
20	20601884	.	A	C	14	12	26	0	1	28	1	0
20	20601985	.	T	C	13	5	18	0	0	18	0	0
20	20602097	.	A	T	9	10	19	0	1	21	1	0
20	20602167	.	T	C	4	3	7	0	0	7	0	0
20	20602182	.	T	C	10	2	12	0	0	12	0	0
20	20602232	.	T	C	13	7	20	1	2	23	0	0
20	20602290	.	G	T	9	7	16	0	2	19	1	0
20	20602370	.	A	T	15	6	21	0	3	25	1	0
20	20603131	.	T	A	9	7	16	0	1	17	0	0
20	20603389	.	T	G	2	6	8	0	0	8	0	0
20	20603443	.	T	G	1	3	4	0	0	4	0	0
20	20603906	.	G	A	2	3	5	0	0	5	0	0
20	20604015	.	T	G	3	2	5	0	0	5	0	0
20	20609663	.	G	A	10	4	14	0	0	14	0	0
20	20609735	.	G	C	6	0	6	0	5	11	0	0
20	20611040	.	C	G	4	3	7	0	0	7	0	0
20	20655141	.	G	C	9	6	15	0	1	16	0	0
20	20655142	.	T	C	9	7	16	0	0	16	0	0
20	20655339	.	A	T	7	12	19	0	3	22	0	0
20	20655357	.	G	A	0	13	13	0	10	23	0	0
20	20655394	.	C	G	10	0	10	0	9	19	0	0
20	20658851	.	G	T	12	9	21	0	5	26	0	0
20	20658954	.	C	T	7	10	17	0	0	17	0	0
20	20659009	.	T	C	5	20	25	0	1	26	0	0
20	20659067	.	G	A	16	16	32	0	1	33	0	0
20	20659188	.	C	G	15	13	28	0	2	30	0	0
20	20659305	.	T	C	12	9	21	0	1	22	0	0
20	20659306	.	C	T	11	9	20	0	0	20	0	0
20	20672289	.	T	C	31	32	63	0	1	64	0	0
20	20672335	.	C	T	26	29	55	4	0	59	0	0
20	20694918	.	A	T	31	42	73	0	0	73	0	0
20	20694999	.	C	T	28	17	45	1	0	46	0	0
20	20695642	.	G	T	4	28	32	0	31	63	0	0
20	20695779	.	T	A	32	22	54	0	5	59	0	0
20	20695829	.	A	T	35	19	54	0	1	55	0	0
20	20695856	.	A	T	33	17	50	0	2	52	0	0
20	20713481	.	T	A	4	2	6	0	0	6	0	0
20	20722032	.	T	C	1	5	6	0	1	7	0	0
20	20722071	.	A	G	1	7	8	0	0	8	0	0
20	20726287	.	G	T	22	37	59	0	5	64	0	0
20	20726291	.	G	A	2	41	43	0	23	66	0	0
20	20726966	.	T	C	28	30	58	0	2	60	0	0
20	20726993	.	C	A	30	25	55	0	4	59	0	0
20	20729975	.	C	T	30	36	66	1	5	72	0	0
20	20730061	.	C	G	16	31	47	0	4	51	0	0
20	20731663	.	A	G	2	6	8	0	0	8	0	0
20	20731706	.	G	A	4	5	9	0	0	9	0	0
20	20793358	.	G	A	1	5	6	0	1	7	0	0
20	20802754	.	C	A	7	21	28	0	3	31	0	0
20	20805250	.	T	G	4	2	6	0	15	21	0	0
20	20805438	.	T	C	7	25	32	0	0	32	0	0
20	20805643	.	G	C	0	21	21	0	11	32	0	0
20	20805690	.	C	T	7	19	26	0	1	27	0	0
20	20808044	.	C	A	7	21	28	0	0	28	0	0
20	20809666	.	T	C	5	22	27	0	0	27	0	0
20	20809702	.	T	C	7	27	34	0	2	36	0	0
20	20812680	.	C	T	8	29	37	0	5	42	0	0
20	20812728	.	T	C	11	38	49	0	1	50	0	0
20	20812898	.	T	C	8	17	25	0	4	29	0	0
20	20813116	.	A	T	10	26	36	0	1	37	0	0
20	20813162	.	T	C	17	24	41	0	1	42	0	0
20	20813197	.	A	C	17	26	43	0	2	45	0	0
20	20813270	.	C	T	7	26	33	0	0	33	0	0
20	20813336	.	T	C	6	34	40	0	1	41	0	0
20	20813460	.	C	T	7	30	37	0	2	39	0	0
20	20813568	.	A	C	10	26	36	0	1	37	0	0
20	20817263	.	A	G	40	34	74	0	3	77	0	0
20	20817921	.	A	G	40	28	68	0	9	77	0	0
20	20898262	.	G	A	1	2	3	0	0	3	0	0
20	20899424	.	A	T	2	3	5	0	1	6	0	0
20	20927973	.	A	C	7	0	7	0	7	14	0	0
20	20928239	.	C	G	1	7	8	1	18	27	0	0
20	20928536	.	G	A	13	22	35	0	2	37	0	0
20	20928932	.	A	G	11	11	22	0	0	22	0	0
20	20929166	.	G	A	14	20	34	0	3	37	0	0
20	20931142	.	C	G	5	10	15	0	0	15	0	0
20	20948025	.	A	G	3	7	10	0	1	11	0	0
20	20974065	.	T	C	3	5	8	0	0	8	0	0
20	20974071	.	T	G	4	5	9	0	0	9	0	0
20	20978278	.	G	A	4	7	11	0	1	12	0	0
20	21008471	.	T	A	3	4	7	0	0	7	0	0
20	21015748	.	G	A	5	3	8	0	0	8	0	0
20	21016348	.	C	T	2	5	7	0	1	8	0	0
20	21269081	.	T	C	1	7	8	0	0	8	0	0
20	21330448	.	G	A	3	2	5	0	0	5	0	0
20	21341865	.	A	C	1	2	3	0	0	3	0	0
20	21342009	.	A	T	1	3	4	0	0	4	0	0
20	21469759	.	G	C	2	3	5	0	0	5	0	0
20	21473681	.	T	C	11	10	21	0	1	22	0	0
20	21474159	.	T	C	10	6	16	0	1	17	0	0
20	21474185	.	C	T	6	3	9	0	1	10	0	0
20	21474664	.	A	G	14	0	14	0	5	19	0	0
20	21474700	.	A	G	9	6	15	0	0	15	0	0
20	21474715	.	A	C	6	3	9	0	2	11	0	0
20	21635578	.	C	T	1	3	4	0	0	4	0	0
20	21638431	.	C	A	5	2	7	0	0	7	0	0
20	21638575	.	T	C	1	5	6	0	0	6	0	0
20	21638903	.	T	C	4	2	6	0	0	6	0	0
20	21815659	.	G	T	11	14	25	0	0	25	0	0
20	21815986	.	C	T	1	16	17	0	17	34	0	0
20	21816061	.	C	G	19	11	30	0	0	30	0	0
20	21819062	.	T	C	17	11	28	0	1	29	0	0
20	21828117	.	T	C	9	10	19	0	0	19	0	0
20	21839504	.	G	A	7	11	18	0	2	20	0	0
20	21841312	.	G	A	7	8	15	0	0	15	0	0
20	21841316	.	G	T	6	8	14	0	0	14	0	0
20	21855195	.	T	C	9	15	24	0	0	24	0	0
20	21862963	.	C	T	2	8	10	0	11	21	0	0
20	21862975	.	C	T	1	7	8	0	14	23	1	0
20	21872945	.	A	G	3	6	9	0	0	9	0	0
20	21872990	.	G	A	5	2	7	0	2	9	0	0
20	21875111	.	G	A	2	4	6	0	1	7	0	0
20	21875162	.	G	A	4	2	6	0	0	6	0	0
20	21875165	.	T	G	4	2	6	0	0	6	0	0
20	21910005	.	C	T	0	3	3	0	5	8	0	0
20	22045260	.	A	C	6	7	13	0	2	15	0	0
20	22050420	.	T	G	3	0	3	0	5	8	0	0
20	22061949	.	C	T	4	3	7	0	0	7	0	0
20	22062032	.	A	G	1	0	1	0	2	3	0	0
20	22160859	.	T	A	1	2	3	0	0	3	0	0
20	22166199	.	G	A	3	2	5	0	0	5	0	0
20	22166512	.	A	G	4	2	6	0	0	6	0	0
20	22168567	.	C	T	3	3	6	0	0	6	0	0
20	22174303	.	T	A	2	6	8	0	0	8	0	0
20	22175204	.	A	G	4	2	6	0	0	6	0	0
20	22175625	.	T	C	8	3	11	0	0	11	0	0
20	22175815	.	T	C	4	2	6	0	1	7	0	0
20	22175830	.	G	A	4	3	7	0	0	7	0	0
20	22175928	.	C	T	3	2	5	0	0	5	0	0
20	22179962	.	T	A	7	9	16	0	0	16	0	0
20	22186632	.	G	A	8	9	17	0	0	17	0	0
20	22186738	.	G	A	10	10	20	0	5	25	0	0
20	22186765	.	C	G	16	11	27	0	2	29	0	0
20	22186886	.	A	G	9	9	18	0	0	18	0	0
20	22186914	.	A	G	10	8	18	0	0	18	0	0
20	22186971	.	C	T	10	9	19	0	0	19	0	0
20	22186973	.	C	T	9	8	17	0	1	18	0	0
20	22187233	.	T	C	12	13	25	0	0	25	0	0
20	22191361	.	A	T	13	10	23	0	0	23	0	0
20	22191376	.	A	G	11	9	20	0	1	21	0	0
20	22191493	.	T	C	7	0	7	0	7	14	0	0
20	22193013	.	C	A	0	4	4	0	7	11	0	0
20	22194285	.	C	T	2	4	6	0	3	9	0	0
20	22194385	.	A	T	9	5	14	0	1	15	0	0
20	22194395	.	G	A	8	3	11	0	0	11	0	0
20	22196960	.	T	G	4	2	6	0	1	7	0	0
20	22346156	.	T	C	1	2	3	0	0	3	0	0
20	22346165	.	T	C	1	3	4	0	0	4	0	0
20	22435335	.	C	A	4	2	6	0	0	6	0	0
20	22435672	.	T	C	2	5	7	0	0	7	0	0
20	22435893	.	T	A	3	2	5	0	0	5	0	0
20	22435901	.	C	T	2	2	4	0	1	5	0	0
20	22709685	.	T	A	14	6	20	0	2	22	0	0
20	22720443	.	A	G	15	17	32	0	2	34	0	0
20	22730689	.	C	G	17	16	33	0	2	35	0	0
20	22734145	.	C	A	16	20	36	0	5	41	0	0
20	22736625	.	T	C	13	23	36	0	1	37	0	0
20	22739946	.	C	A	25	22	47	0	1	48	0	0
20	22739985	.	T	C	24	22	46	0	1	47	0	0
20	22740056	.	C	T	21	17	38	0	0	38	0	0
20	22740140	.	C	T	21	17	38	0	1	39	0	0
20	22740230	.	A	G	23	27	50	0	0	50	0	0
20	22740567	.	A	G	22	5	27	0	20	47	0	0
20	22800147	.	G	A	0	3	3	0	1	4	0	0
20	22800759	.	G	A	2	3	5	0	0	5	0	0
20	22907915	.	C	T	4	4	8	0	0	8	0	0
20	23007497	.	G	A	4	3	7	0	1	8	0	0
20	23007547	.	G	A	5	4	9	0	0	9	0	0
20	23021287	.	G	T	4	1	5	0	0	5	0	0
20	23021292	.	A	T	4	2	6	0	0	6	0	0
20	23023364	.	G	A	8	11	19	0	3	22	0	0
20	23023471	.	C	T	11	12	23	0	1	24	0	0
20	23023482	.	A	G	10	11	21	0	1	22	0	0
20	23023623	.	G	A	15	6	21	0	0	21	0	0
20	23023641	.	A	G	9	7	16	0	1	17	0	0
20	23023670	.	T	C	4	0	4	0	12	16	0	0
20	23023835	.	A	G	17	4	21	0	0	21	0	0
20	23024096	.	G	A	2	7	9	0	0	9	0	0
20	23083938	.	G	A	0	3	3	0	1	4	0	0
20	23083951	.	T	G	1	0	1	0	5	6	0	0
20	23175425	.	A	G	13	10	23	0	0	23	0	0
20	23177734	.	G	A	8	6	14	0	2	16	0	0
20	23179786	.	C	T	17	10	27	0	1	28	0	0
20	23181718	.	A	G	12	25	37	0	0	37	0	0
20	23205004	.	G	A	15	14	29	0	1	30	0	0
20	23205868	.	T	C	26	17	43	0	2	45	0	0
20	23205879	.	G	A	29	16	45	0	3	48	0	0
20	23215901	.	C	T	7	8	15	0	1	16	0	0
20	23215949	.	C	T	8	10	18	0	0	18	0	0
20	23245866	.	T	A	4	6	10	0	1	11	0	0
20	23246105	.	G	A	3	3	6	0	0	6	0	0
20	23246215	.	G	A	3	4	7	0	0	7	0	0
20	23248572	.	G	A	7	7	14	0	2	16	0	0
20	23250491	.	A	C	10	0	10	0	7	17	0	0
20	23250690	.	C	A	0	7	7	0	7	14	0	0
20	23372290	.	T	C	2	6	8	0	0	8	0	0
20	23376396	.	T	A	2	2	4	0	0	4	0	0
20	23378401	.	G	A	2	1	3	0	1	4	0	0
20	23378434	.	A	T	1	2	3	0	1	4	0	0
20	23378899	.	G	A	0	2	2	0	4	6	0	0
20	23382695	.	T	A	2	5	7	0	0	7	0	0
20	23385556	.	G	A	5	4	9	0	0	9	0	0
20	23387619	.	G	A	0	6	6	0	1	7	0	0
20	23387808	.	C	T	2	2	4	0	1	5	0	0
20	23387811	.	C	T	2	2	4	0	1	5	0	0
20	23389772	.	T	C	6	5	11	0	2	13	0	0
20	23389793	.	A	G	4	0	4	0	6	10	0	0
20	23390621	.	G	A	1	5	6	0	3	9	0	0
20	23390798	.	C	T	7	8	15	0	1	16	0	0
20	23395376	.	T	A	1	3	4	0	12	16	0	0
20	23395404	.	C	T	5	5	10	0	2	12	0	0
20	23406545	.	T	A	11	18	29	0	0	29	0	0
20	23408734	.	T	C	3	13	16	0	0	16	0	0
20	23418228	.	G	A	15	15	30	0	1	31	0	0
20	23418291	.	C	G	14	15	29	0	0	29	0	0
20	23420784	.	A	T	17	20	37	0	4	41	0	0
20	23421442	.	T	C	12	20	32	1	1	34	0	0
20	23421695	.	T	C	17	23	40	0	2	42	0	0
20	23422061	.	T	C	16	17	33	0	5	38	0	0
20	23422205	.	A	T	16	7	23	0	0	23	0	0
20	23446854	.	C	T	7	12	19	0	1	20	0	0
20	23446868	.	T	A	12	7	19	0	2	21	0	0
20	23447224	.	T	C	8	0	8	0	3	11	0	0
20	23447274	.	A	C	2	4	6	0	0	6	0	0
20	23447467	.	A	T	5	4	9	0	0	9	0	0
20	23447564	.	C	G	14	13	27	0	2	29	0	0
20	23447873	.	C	G	10	16	26	0	0	26	0	0
20	23471742	.	G	A	3	4	7	0	0	7	0	0
20	23471859	.	C	A	1	6	7	0	1	8	0	0
20	23471985	.	G	A	2	3	5	0	0	5	0	0
20	23472036	.	C	T	4	2	6	0	0	6	0	0
20	23472039	.	C	T	2	3	5	0	1	6	0	0
20	23472186	.	T	C	4	3	7	0	0	7	0	0
20	23472239	.	C	T	0	3	3	0	5	8	0	0
20	23472259	.	G	T	5	3	8	0	0	8	0	0
20	23475653	.	G	C	2	2	4	0	0	4	0	0
20	23478231	.	C	T	5	3	8	0	1	9	0	0
20	23478294	.	T	C	2	4	6	0	1	7	0	0
20	23647541	.	C	T	2	6	8	0	0	8	0	0
20	23648724	.	T	C	5	3	8	0	1	9	0	0
20	23648828	.	G	A	10	4	14	0	2	16	0	0
20	23651294	.	C	T	3	6	9	0	0	9	0	0
20	23651350	.	C	T	2	3	5	0	0	5	0	0
20	23651503	.	T	C	7	0	7	0	8	15	0	0
20	23655749	.	A	T	4	7	11	0	0	11	0	0
20	23656226	.	T	A	3	2	5	0	1	6	0	0
20	23656454	.	A	G	9	7	16	0	0	16	0	0
20	23665185	.	A	T	3	3	6	0	2	8	0	0
20	23665455	.	T	A	2	5	7	0	0	7	0	0
20	23665793	.	G	T	2	8	10	0	7	17	0	0
20	23665863	.	G	A	1	8	9	0	9	18	0	0
20	23666055	.	T	A	3	5	8	2	0	10	0	0
20	23666135	.	G	A	2	3	5	1	0	6	0	0
20	23685062	.	G	A	5	3	8	0	1	9	0	0
20	23685106	.	A	T	5	3	8	0	2	10	0	0
20	23685259	.	G	T	5	3	8	0	0	8	0	0
20	23685270	.	T	A	2	6	8	0	0	8	0	0
20	23685529	.	T	A	5	2	7	0	2	9	0	0
20	23689192	.	G	A	3	4	7	0	0	7	0	0
20	23689902	.	T	C	2	7	9	0	1	10	0	0
20	23689933	.	G	C	2	8	10	0	1	11	0	0
20	23689996	.	G	A	6	3	9	0	1	10	0	0
20	23690051	.	A	T	11	3	14	0	0	14	0	0
20	23690077	.	C	A	9	3	12	0	0	12	0	0
20	23691015	.	G	A	4	8	12	0	0	12	0	0
20	23691059	.	A	G	6	0	6	0	3	9	0	0
20	23691911	.	T	C	9	6	15	0	1	16	0	0
20	23691917	.	C	T	9	9	18	0	0	18	0	0
20	23692094	.	T	C	11	4	15	0	1	16	0	0
20	23694299	.	G	T	2	8	10	0	5	15	0	0
20	23705719	.	G	A	5	6	11	3	0	14	0	0
20	23705974	.	G	A	7	6	13	0	1	14	0	0
20	23713122	.	G	A	1	12	13	0	4	17	0	0
20	23713197	.	A	G	8	0	8	0	7	15	0	0
20	23713435	.	T	C	2	2	4	0	1	5	0	0
20	23713475	.	T	A	1	3	4	0	1	5	0	0
20	23713497	.	G	T	1	7	8	0	1	9	0	0
20	23713512	.	A	T	2	7	9	0	0	9	0	0
20	23713535	.	A	G	4	6	10	0	0	10	0	0
20	23713763	.	G	A	6	6	12	0	1	13	0	0
20	23713824	.	A	G	7	4	11	0	0	11	0	0
20	23713858	.	T	G	3	0	3	0	6	9	0	0
20	23713883	.	A	G	1	0	1	0	5	6	0	0
20	23746966	.	C	G	1	0	1	0	2	3	0	0
20	23747107	.	G	C	0	2	2	0	1	3	0	0
20	23747167	.	A	G	1	5	6	0	0	6	0	0
20	23796406	.	T	C	4	3	7	0	1	8	0	0
20	23796565	.	C	T	1	3	4	0	0	4	0	0
20	23801024	.	C	T	3	2	5	0	0	5	0	0
20	23801069	.	G	T	0	5	5	0	2	7	0	0
20	23828102	.	G	T	7	3	10	0	2	12	0	0
20	23829161	.	A	G	2	0	2	0	4	6	0	0
20	23829170	.	C	T	4	3	7	0	0	7	0	0
20	23829413	.	A	G	5	0	5	0	9	14	0	0
20	23832884	.	G	C	5	5	10	0	0	10	0	0
20	23833193	.	G	T	6	8	14	1	2	17	0	0
20	23835228	.	C	T	10	3	13	0	0	13	0	0
20	23835472	.	C	T	11	5	16	0	1	17	0	0
20	23835549	.	C	A	8	2	10	0	0	10	0	0
20	23835591	.	G	T	9	4	13	0	0	13	0	0
20	23835988	.	C	A	4	4	8	0	0	8	0	0
20	23836009	.	G	T	2	2	4	0	1	5	0	0
20	23836106	.	A	T	5	2	7	0	0	7	0	0
20	23836161	.	C	T	6	2	8	0	0	8	0	0
20	23836310	.	A	T	4	4	8	0	0	8	0	0
20	23836422	.	A	T	1	2	3	0	0	3	0	0
20	23836608	.	C	T	6	2	8	0	1	9	0	0
20	23836685	.	A	T	8	6	14	0	0	14	0	0
20	23836688	.	C	A	6	8	14	0	0	14	0	0
20	23836756	.	G	A	0	6	6	0	6	12	0	0
20	23855673	.	C	T	1	5	6	0	1	7	0	0
20	23855675	.	T	A	1	6	7	0	0	7	0	0
20	23856345	.	A	T	15	10	25	0	1	26	0	0
20	23857214	.	G	C	11	21	32	0	0	32	0	0
20	23857407	.	C	A	27	12	39	0	2	41	0	0
20	23857559	.	G	A	7	22	29	0	1	30	0	0
20	23857592	.	C	T	6	20	26	0	0	26	0	0
20	23859383	.	G	C	22	8	30	0	2	32	0	0
20	23859386	.	A	G	24	8	32	0	0	32	0	0
20	23859425	.	G	A	1	11	12	0	20	32	0	0
20	23859458	.	A	G	20	9	29	0	4	33	0	0
20	23859486	.	G	A	3	11	14	0	24	38	0	0
20	23877623	.	G	A	4	5	9	0	0	9	0	0
20	23879673	.	C	T	11	4	15	0	0	15	0	0
20	23879879	.	G	T	6	12	18	0	1	19	0	0
20	23879903	.	C	A	7	11	18	0	2	20	0	0
20	23882437	.	C	T	13	7	20	0	2	22	0	0
20	23883008	.	T	C	4	5	9	0	0	9	0	0
20	23883351	.	T	A	4	7	11	0	1	12	0	0
20	23883599	.	T	C	14	8	22	0	1	23	0	0
20	23884479	.	T	C	10	0	10	0	4	14	0	0
20	23885402	.	T	A	9	5	14	0	0	14	0	0
20	23885485	.	T	A	10	8	18	0	0	18	0	0
20	23885505	.	C	T	0	6	6	0	9	15	0	0
20	23885925	.	G	A	4	8	12	0	0	12	0	0
20	23886277	.	A	G	8	10	18	0	1	19	0	0
20	23886358	.	A	G	1	8	9	0	1	10	0	0
20	23887034	.	C	G	5	2	7	0	1	8	0	0
20	23889403	.	T	G	4	5	9	0	0	9	0	0
20	23890306	.	T	C	5	5	10	0	0	10	0	0
20	23890307	.	C	T	5	5	10	0	0	10	0	0
20	23890376	.	C	T	0	2	2	0	2	4	0	0
20	23890478	.	C	T	1	3	4	0	2	6	0	0
20	23890489	.	C	T	1	4	5	0	1	6	0	0
20	23892006	.	G	A	4	2	6	0	0	6	0	0
20	23892027	.	C	T	0	6	6	0	3	9	0	0
20	23899009	.	T	C	1	2	3	0	0	3	0	0
20	23902097	.	A	G	1	3	4	0	0	4	0	0
20	23953822	.	A	G	1	3	4	0	1	5	0	0
20	23955171	.	G	T	3	3	6	0	0	6	0	0
20	23955237	.	C	G	5	2	7	0	0	7	0	0
20	23955326	.	G	T	0	3	3	0	2	5	0	0
20	23972997	.	C	T	0	5	5	0	7	12	0	0
20	23973245	.	T	G	1	2	3	0	0	3	0	0
20	23973253	.	T	A	1	4	5	0	0	5	0	0
20	23973433	.	T	C	4	4	8	0	0	8	0	0
20	23974755	.	G	A	1	3	4	0	0	4	0	0
20	23974953	.	T	G	4	4	8	0	1	9	0	0
20	23978159	.	G	C	2	4	6	0	0	6	0	0
20	23996985	.	C	A	3	2	5	0	0	5	0	0
20	24151599	.	C	T	0	7	7	0	10	17	0	0
20	24152821	.	G	A	16	13	29	0	1	30	0	0
20	24152822	.	G	A	13	15	28	0	1	29	0	0
20	24182819	.	T	C	4	0	4	0	3	7	0	0
20	24818922	.	T	C	20	11	31	0	0	31	0	0
20	24819091	.	A	G	7	16	23	0	1	24	0	0
20	24819152	.	C	G	4	7	11	0	2	13	0	0
20	24819184	.	G	A	1	3	4	0	3	7	0	0
20	24819376	.	G	A	1	3	4	0	0	4	0	0
20	24819403	.	T	A	2	3	5	0	0	5	0	0
20	24819582	.	C	T	1	12	13	1	6	20	0	0
20	24819858	.	T	C	1	7	8	0	1	9	0	0
20	24819861	.	T	C	0	8	8	0	0	8	0	0
20	24820032	.	T	C	13	8	21	0	0	21	0	0
20	24820353	.	A	T	9	2	11	3	1	15	0	0
20	24820383	.	T	C	3	7	10	0	0	10	0	0
20	24820405	.	G	A	7	4	11	0	1	12	0	0
20	24820963	.	T	A	10	7	17	0	0	17	0	0
20	24821023	.	T	G	14	11	25	0	1	26	0	0
20	24821072	.	A	G	10	10	20	0	0	20	0	0
20	24821499	.	T	G	5	5	10	0	2	12	0	0
20	24835754	.	C	T	1	7	8	0	3	11	0	0
20	24841646	.	G	A	7	3	10	0	0	10	0	0
20	24849372	.	G	A	2	7	9	0	2	11	0	0
20	24849453	.	C	T	0	3	3	0	6	9	0	0
20	24852707	.	C	T	0	2	2	0	2	4	0	0
20	24856399	.	C	T	5	4	9	0	1	10	0	0
20	24915538	.	G	A	6	4	10	0	0	10	0	0
20	24915763	.	T	G	3	2	5	0	2	7	0	0
20	24959732	.	A	G	1	7	8	0	1	9	0	0
20	25271367	.	A	G	2	2	4	0	0	4	0	0
20	25342164	.	C	T	3	4	7	0	1	8	0	0
20	25342837	.	G	A	1	7	8	0	13	21	0	0
20	25352527	.	C	T	2	2	4	0	0	4	0	0
20	25371869	.	A	G	3	4	7	0	0	7	0	0
20	25372057	.	A	G	1	5	6	0	0	6	0	0
20	25378583	.	T	G	7	3	10	0	0	10	0	0
20	25378610	.	C	T	7	2	9	0	0	9	0	0
20	25384473	.	A	T	4	3	7	0	0	7	0	0
20	25384494	.	G	A	5	3	8	0	0	8	0	0
20	25387850	.	T	A	5	2	7	0	1	8	0	0
20	25387865	.	A	G	2	5	7	0	0	7	0	0
20	25436215	.	C	T	0	2	2	0	1	3	0	0
20	25440628	.	T	G	3	5	8	0	0	8	0	0
20	25440648	.	C	G	5	7	12	0	2	14	0	0
20	25440668	.	T	C	5	10	15	0	0	15	0	0
20	25440724	.	G	T	7	5	12	0	1	13	0	0
20	25440731	.	G	A	7	8	15	0	0	15	0	0
20	25440790	.	A	C	6	7	13	0	1	14	0	0
20	25441033	.	G	T	9	11	20	0	3	23	0	0
20	25443159	.	T	A	10	8	18	0	0	18	0	0
20	25444903	.	G	A	7	7	14	0	0	14	0	0
20	25444929	.	A	G	6	5	11	0	0	11	0	0
20	25444943	.	G	A	5	7	12	0	0	12	0	0
20	25489625	.	C	T	5	2	7	0	1	8	0	0
20	25494432	.	G	A	2	4	6	0	0	6	0	0
20	25499025	.	G	T	1	4	5	0	0	5	0	0
20	25510331	.	A	G	10	7	17	0	2	19	0	0
20	25568000	.	G	T	2	5	7	0	0	7	0	0
20	25591248	.	A	G	2	4	6	0	0	6	0	0
20	25593109	.	C	T	2	4	6	0	0	6	0	0
20	25614852	.	C	A	1	2	3	0	0	3	0	0
20	25618240	.	G	A	3	3	6	0	0	6	0	0
20	25618330	.	G	A	5	6	11	0	0	11	0	0
20	25618601	.	T	A	13	6	19	0	1	20	0	0
20	25618908	.	G	A	3	8	11	0	0	11	0	0
20	25619965	.	G	A	8	5	13	0	0	13	0	0
20	25621633	.	G	A	2	4	6	0	0	6	0	0
20	25623770	.	A	T	3	6	9	0	0	9	0	0
20	25623778	.	A	T	7	3	10	0	0	10	0	0
20	25623921	.	C	T	1	5	6	0	5	11	0	0
20	25628390	.	C	T	0	2	2	0	4	6	0	0
20	25629317	.	C	T	2	2	4	0	0	4	0	0
20	25660441	.	A	G	14	24	38	0	1	39	0	0
20	25661199	.	A	G	19	11	30	0	0	30	0	0
20	25661396	.	G	A	14	15	29	0	1	30	0	0
20	25661403	.	T	G	12	6	18	0	0	18	0	0
20	25661509	.	G	A	24	19	43	0	0	43	0	0
20	25665325	.	T	G	6	11	17	0	0	17	0	0
20	25666402	.	A	T	17	8	25	0	0	26	1	0
20	25666524	.	T	C	9	5	14	0	1	15	0	0
20	25669512	.	T	C	7	6	13	0	0	13	0	0
20	25669567	.	T	G	2	7	9	0	0	9	0	0
20	25709311	.	C	T	1	2	3	0	5	8	0	0
20	25716005	.	C	A	1	2	3	0	0	3	0	0
20	25722363	.	C	T	1	2	3	0	0	3	0	0
20	25734733	.	A	T	3	2	5	0	0	5	0	0
20	25735011	.	G	A	0	2	2	0	2	4	0	0
20	25735086	.	G	A	2	2	4	0	0	4	0	0
20	25853191	.	T	C	2	3	5	0	1	6	0	0
20	25875221	.	T	C	3	0	3	0	5	8	0	0
20	25877666	.	G	A	4	5	9	0	0	9	0	0
20	25877787	.	A	T	6	5	11	0	0	12	1	0
20	25888066	.	T	C	0	2	2	0	1	3	0	0
20	25906480	.	A	T	2	2	4	0	0	4	0	0
20	25907347	.	G	C	2	5	7	0	1	8	0	0
20	25909661	.	C	A	14	10	24	0	0	24	0	0
20	25910368	.	A	T	8	7	15	0	0	15	0	0
20	25921009	.	C	T	14	7	21	0	0	21	0	0
20	25926688	.	C	A	5	7	12	0	0	12	0	0
20	25927310	.	A	G	16	11	27	0	0	27	0	0
20	26023822	.	T	C	3	4	7	0	1	8	0	0
20	26289484	.	C	T	2	3	5	0	0	5	0	0
20	26289485	.	A	T	2	3	5	0	0	5	0	0
20	26289572	.	G	A	1	3	4	0	4	8	0	0
20	26290667	.	A	T	1	8	9	0	0	9	0	0
20	26305019	.	A	T	6	4	10	0	0	10	0	0
20	26310596	.	T	A	8	4	12	0	1	13	0	0
20	26320221	.	C	T	6	4	10	0	1	11	0	0
20	26321073	.	G	A	9	4	13	0	2	15	0	0
20	26324196	.	T	G	6	11	17	0	3	20	0	0
20	26324307	.	T	A	8	10	18	0	0	18	0	0
20	26325380	.	A	G	9	15	24	1	1	26	0	0
20	26325481	.	T	A	11	8	19	0	1	20	0	0
20	26325493	.	T	C	10	8	18	0	1	19	0	0
20	26329035	.	G	A	5	9	14	0	0	14	0	0
20	26331683	.	C	T	16	12	28	0	1	29	0	0
20	26334414	.	A	G	15	14	29	0	1	30	0	0
20	26334446	.	C	T	17	10	27	0	1	28	0	0
20	26337790	.	C	A	27	12	39	0	1	41	1	0
20	26342889	.	C	T	15	16	31	0	3	34	0	0
20	26345230	.	C	T	24	18	42	0	1	43	0	0
20	26345856	.	T	A	14	19	33	0	3	36	0	0
20	26346710	.	C	T	25	23	48	0	3	51	0	0
20	26353770	.	A	G	17	20	37	0	4	41	0	0
20	26358743	.	G	A	27	18	45	0	5	50	0	0
20	26358964	.	G	A	26	14	40	0	2	42	0	0
20	26359109	.	A	T	13	3	16	0	2	18	0	0
20	26359819	.	T	A	4	5	9	0	0	9	0	0
20	26359872	.	A	T	1	2	3	0	1	4	0	0
20	26360070	.	C	T	1	2	3	0	0	3	0	0
20	26360125	.	T	G	2	2	4	0	2	6	0	0
20	26360470	.	A	G	4	6	10	0	0	10	0	0
20	26361065	.	T	C	1	2	3	0	0	3	0	0
20	26361094	.	C	T	0	2	2	0	2	4	0	0
20	26361110	.	T	A	2	2	4	0	0	4	0	0
20	26361200	.	C	T	2	3	5	0	0	5	0	0
20	26361212	.	C	T	2	4	6	0	0	6	0	0
20	26382021	.	T	G	1	2	3	0	0	3	0	0
20	26382028	.	C	G	1	2	3	0	0	3	0	0
20	26387181	.	G	A	9	6	15	1	0	16	0	0
20	26387288	.	T	A	9	10	19	0	1	20	0	0
20	26390906	.	C	T	1	6	7	0	0	7	0	0
20	26390912	.	G	A	1	4	5	0	0	5	0	0
20	26404155	.	C	T	2	3	5	0	0	5	0	0
20	26404320	.	A	G	1	0	1	0	2	3	0	0
20	26404361	.	C	G	5	3	8	0	0	8	0	0
20	26404369	.	G	A	2	5	7	0	0	7	0	0
20	26404443	.	G	A	0	5	5	0	2	7	0	0
20	26404479	.	C	T	5	3	8	0	0	8	0	0
20	26404753	.	C	A	2	4	6	0	1	7	0	0
20	26404860	.	T	A	4	6	10	0	1	11	0	0
20	26405121	.	G	A	1	4	5	0	6	11	0	0
20	26405356	.	A	T	1	5	6	0	0	6	0	0
20	26405382	.	C	T	1	2	3	0	0	3	0	0
20	26405485	.	A	T	1	3	4	1	1	6	0	0
20	26405808	.	T	A	6	4	10	0	1	11	0	0
20	26406160	.	G	A	1	4	5	0	6	11	0	0
20	26406252	.	T	C	3	3	6	0	1	7	0	0
20	26406565	.	A	T	1	2	3	0	0	3	0	0
20	26406640	.	G	T	1	3	4	0	5	9	0	0
20	26406806	.	C	T	4	4	8	0	0	8	0	0
20	26407091	.	T	C	4	2	6	0	1	7	0	0
20	26409194	.	T	A	9	9	18	0	1	19	0	0
20	26409261	.	C	A	0	9	9	0	11	20	0	0
20	26409295	.	C	A	14	12	26	0	1	27	0	0
20	26409310	.	A	T	13	10	23	0	2	25	0	0
20	26409372	.	T	G	5	12	17	0	2	19	0	0
20	26409471	.	C	T	0	8	8	1	10	19	0	0
20	26409723	.	C	T	17	23	40	0	2	42	0	0
20	26409922	.	T	C	16	19	35	0	1	36	0	0
20	26409991	.	G	A	16	7	23	0	2	25	0	0
20	26410224	.	G	T	6	6	12	0	2	14	0	0
20	26410275	.	G	A	10	7	17	0	0	17	0	0
20	26410341	.	A	G	13	14	27	0	2	29	0	0
20	26410344	.	A	C	13	16	29	0	1	30	0	0
20	26412372	.	T	A	8	14	22	0	0	22	0	0
20	26412479	.	C	T	12	7	19	0	0	19	0	0
20	26412501	.	G	A	12	7	19	0	1	20	0	0
20	26412579	.	C	A	10	8	18	0	0	18	0	0
20	26412876	.	G	A	16	13	29	0	1	30	0	0
20	26412968	.	T	A	23	10	33	0	2	35	0	0
20	26413038	.	C	T	11	13	24	0	1	25	0	0
20	26413057	.	G	A	9	11	20	0	1	21	0	0
20	26413269	.	C	A	10	10	20	0	0	20	0	0
20	26413280	.	A	C	12	0	12	0	9	21	0	0
20	26413311	.	C	T	13	5	18	0	2	20	0	0
20	26413470	.	G	T	8	10	18	0	1	19	0	0
20	26413640	.	C	A	6	6	12	0	1	13	0	0
20	26413923	.	C	T	5	4	9	0	0	9	0	0
20	26413998	.	A	T	12	5	17	0	0	17	0	0
20	26414724	.	C	T	0	9	9	0	6	15	0	0
20	26414747	.	C	T	5	8	13	0	0	13	0	0
20	26414919	.	A	G	7	6	13	0	0	13	0	0
20	26415021	.	G	T	5	3	8	0	2	10	0	0
20	26415760	.	G	A	4	4	8	0	0	8	0	0
20	26416068	.	G	C	8	0	8	0	4	12	0	0
20	26416469	.	C	G	4	3	7	0	1	8	0	0
20	26416514	.	T	C	6	3	9	0	1	10	0	0
20	26416515	.	C	T	4	5	9	0	0	9	0	0
20	26416551	.	A	T	5	2	7	0	0	7	0	0
20	26574266	.	C	T	8	9	17	0	1	18	0	0
20	26583972	.	T	C	8	12	20	0	0	20	0	0
20	26584155	.	A	T	8	6	14	0	0	14	0	0
20	26587834	.	A	G	8	3	11	0	0	11	0	0
20	26594516	.	G	T	5	3	8	0	0	8	0	0
20	26599709	.	C	T	3	4	7	0	1	8	0	0
20	26601222	.	G	A	3	6	9	0	1	10	0	0
20	26610433	.	G	A	5	6	11	0	1	12	0	0
20	26613462	.	A	G	8	5	13	0	0	13	0	0
20	26616241	.	G	C	5	0	5	0	3	8	0	0
20	26775892	.	G	A	5	6	11	0	1	12	0	0
20	26809059	.	A	G	7	6	13	0	1	14	0	0
20	26822389	.	A	G	5	4	9	0	0	9	0	0
20	26822449	.	A	G	4	8	12	0	1	13	0	0
20	26893097	.	G	A	1	2	3	0	0	3	0	0
20	26913236	.	G	T	4	1	5	0	1	6	0	0
20	26915472	.	T	C	2	2	4	0	0	4	0	0
20	26939926	.	C	T	12	10	22	0	0	22	0	0
20	26944106	.	G	A	11	22	33	0	3	36	0	0
20	26944311	.	G	A	18	16	34	0	10	44	0	0
20	26944576	.	C	T	14	12	26	0	1	27	0	0
20	26944762	.	C	T	13	14	27	0	3	30	0	0
20	26944951	.	C	T	7	9	16	0	0	16	0	0
20	26945120	.	A	T	15	9	24	0	3	27	0	0
20	26945394	.	C	T	13	11	24	0	2	26	0	0
20	26945735	.	C	T	13	11	24	0	0	24	0	0
20	26945793	.	T	A	8	9	17	0	2	19	0	0
20	26945950	.	T	A	13	5	18	0	1	19	0	0
20	26947873	.	T	G	3	3	6	0	0	6	0	0
20	26948161	.	A	G	4	3	7	0	0	7	0	0
20	26958653	.	C	A	7	3	10	0	1	11	0	0
20	26958685	.	A	G	6	7	13	0	0	13	0	0
20	26959605	.	T	C	4	2	6	0	1	7	0	0
20	26959624	.	C	T	4	2	6	0	0	6	0	0
20	26960039	.	T	G	12	11	23	0	0	23	0	0
20	26960371	.	T	C	8	7	15	0	0	15	0	0
20	26960430	.	C	T	7	3	10	0	0	10	0	0
20	26961149	.	A	G	5	6	11	0	0	11	0	0
20	26961469	.	A	G	3	3	6	0	2	8	0	0
20	26961643	.	C	T	4	3	7	0	1	8	0	0
20	26961719	.	T	A	2	6	8	0	1	9	0	0
20	26961758	.	A	T	6	8	14	0	1	15	0	0
20	26961862	.	T	C	8	7	15	0	1	16	0	0
20	26962095	.	T	C	6	10	16	0	1	17	0	0
20	26962119	.	T	C	11	7	18	0	0	18	0	0
20	26962290	.	G	T	14	9	23	0	1	24	0	0
20	26962318	.	G	A	1	9	10	0	9	19	0	0
20	26989211	.	C	G	6	1	7	0	3	10	0	0
20	26992102	.	G	A	1	2	3	0	1	4	0	0
20	26999506	.	T	A	3	9	12	0	1	13	0	0
20	27001816	.	A	C	8	15	23	0	2	25	0	0
20	27002595	.	T	G	5	10	15	0	0	15	0	0
20	27002769	.	T	A	5	4	9	0	0	9	0	0
20	27020294	.	T	A	12	27	39	0	0	39	0	0
20	27020346	.	A	C	11	17	28	0	2	30	0	0
20	27020442	.	G	T	16	14	30	1	1	32	0	0
20	27029685	.	A	C	31	17	48	1	0	49	0	0
20	27033847	.	A	T	30	27	57	1	4	62	0	0
20	27033914	.	A	G	17	32	49	4	3	56	0	0
20	27039339	.	A	C	38	17	55	0	7	62	0	0
20	27039364	.	G	T	5	39	44	0	21	65	0	0
20	27039498	.	C	T	20	36	56	0	3	59	0	0
20	27039523	.	C	T	38	12	50	0	1	51	0	0
20	27045501	.	G	A	28	30	58	0	0	58	0	0
20	27045649	.	T	G	24	3	27	0	35	62	0	0
20	27045858	.	T	A	9	6	15	0	0	15	0	0
20	27045875	.	T	C	8	9	17	0	0	17	0	0
20	27087569	.	C	T	2	4	6	0	1	7	0	0
20	27087600	.	T	A	7	4	11	0	0	11	0	0
20	27089281	.	C	T	6	5	11	0	1	12	0	0
20	27089954	.	G	A	6	5	11	0	0	11	0	0
20	27089995	.	C	T	4	5	9	0	0	9	0	0
20	27090401	.	C	T	6	4	10	0	1	11	0	0
20	27090409	.	C	T	4	7	11	0	1	12	0	0
20	27091206	.	G	A	10	10	20	0	0	20	0	0
20	27092231	.	C	T	17	9	26	0	1	27	0	0
20	27093335	.	G	A	6	6	12	0	0	12	0	0
20	27094693	.	T	C	4	5	9	0	0	9	0	0
20	27096092	.	A	T	7	12	19	0	0	19	0	0
20	27096400	.	C	A	6	6	12	0	0	12	0	0
20	27100011	.	A	T	13	8	21	0	0	21	0	0
20	27104562	.	C	T	14	8	22	0	2	24	0	0
20	27107089	.	C	T	7	8	15	0	1	16	0	0
20	27107140	.	C	A	13	7	20	0	0	20	0	0
20	27107241	.	C	A	6	12	18	0	1	19	0	0
20	27107572	.	C	G	3	3	6	0	0	6	0	0
20	27194918	.	T	C	1	4	5	0	0	5	0	0
20	27240885	.	C	T	3	10	13	0	1	14	0	0
20	27264482	.	G	A	4	2	6	0	0	6	0	0
20	27280808	.	G	A	3	4	7	0	0	7	0	0
20	27280840	.	G	A	0	3	3	0	3	6	0	0
20	27280859	.	C	G	1	0	1	0	3	4	0	0
20	27281295	.	T	A	4	2	6	0	0	6	0	0
20	27281624	.	T	C	8	8	16	0	1	17	0	0
20	27282592	.	A	G	8	14	22	0	0	22	0	0
20	27282788	.	C	A	1	3	4	0	0	4	0	0
20	27282929	.	T	C	2	3	5	0	0	5	0	0
20	27283404	.	A	C	7	8	15	0	1	16	0	0
20	27283604	.	G	A	4	5	9	0	0	9	0	0
20	27352584	.	T	C	3	8	11	0	1	12	0	0
20	27352591	.	A	G	4	2	6	0	7	13	0	0
20	27353040	.	T	C	4	2	6	0	0	6	0	0
20	27353250	.	G	A	11	6	17	0	1	18	0	0
20	27353265	.	C	T	12	5	17	0	4	21	0	0
20	27355748	.	C	T	3	6	9	0	0	9	0	0
20	27358777	.	C	A	14	14	28	1	2	31	0	0
20	27358859	.	G	A	17	15	32	0	1	33	0	0
20	27537750	.	G	A	2	2	4	0	0	4	0	0
20	27538539	.	G	A	1	3	4	0	0	4	0	0
20	27540604	.	T	C	1	3	4	0	0	4	0	0
20	27542005	.	G	A	0	4	4	0	3	7	0	0
20	27542146	.	G	A	0	3	3	0	6	9	0	0
20	27542371	.	G	A	0	2	2	0	6	8	0	0
20	27546032	.	C	T	3	2	5	0	0	5	0	0
20	27549524	.	G	A	3	4	7	0	0	7	0	0
20	27549625	.	T	A	3	2	5	0	0	5	0	0
20	27549968	.	A	G	3	3	6	0	0	6	0	0
20	27550526	.	G	A	2	3	5	0	0	5	0	0
20	27550866	.	G	A	4	4	8	0	0	8	0	0
20	27550915	.	T	A	5	2	7	0	1	8	0	0
20	27550977	.	G	A	0	4	4	0	1	5	0	0
20	27551005	.	T	C	1	4	5	0	0	5	0	0
20	27551123	.	G	T	7	8	15	0	0	15	0	0
20	27551363	.	G	A	6	6	12	0	0	12	0	0
20	27551492	.	C	G	3	4	7	0	0	7	0	0
20	27551563	.	T	C	3	4	7	0	0	7	0	0
20	27692330	.	G	T	1	2	3	0	0	3	0	0
20	27707974	.	G	A	4	2	6	0	0	6	0	0
20	27708016	.	G	A	4	2	6	0	0	6	0	0
20	27708306	.	A	G	6	6	12	0	0	12	0	0
20	27712847	.	T	C	2	2	4	0	0	4	0	0
20	27716086	.	G	A	0	4	4	0	1	5	0	0
20	27716093	.	C	T	1	3	4	0	0	4	0	0
20	27716190	.	T	C	3	3	6	0	0	6	0	0
20	27716227	.	T	C	5	4	9	0	0	9	0	0
20	27717055	.	T	A	4	8	12	0	1	13	0	0
20	27717493	.	A	G	1	3	4	0	0	4	0	0
20	27718292	.	T	C	1	2	3	0	0	3	0	0
20	27718549	.	T	A	4	3	7	0	0	7	0	0
20	27718578	.	A	T	3	4	7	0	0	7	0	0
20	27719088	.	A	G	3	7	10	0	0	10	0	0
20	27719099	.	A	G	5	4	9	0	1	10	0	0
20	27719578	.	T	C	4	3	7	0	0	7	0	0
20	27719608	.	A	G	4	2	6	0	0	6	0	0
20	27719763	.	G	A	5	4	9	1	0	10	0	0
20	27719859	.	T	C	3	3	6	1	0	7	0	0
20	27732628	.	A	G	2	6	8	0	0	8	0	0
20	27732832	.	A	G	7	5	12	0	1	13	0	0
20	27733034	.	G	A	6	5	11	0	1	12	0	0
20	27733631	.	G	C	4	0	4	0	4	8	0	0
20	27733650	.	C	A	0	8	8	0	5	13	0	0
20	28253375	.	A	G	5	2	7	0	0	7	0	0
20	28294732	.	G	T	3	4	7	0	0	7	0	0
20	28310920	.	A	G	3	3	6	0	0	6	0	0
20	28316845	.	G	T	2	5	7	0	0	7	0	0
20	28354549	.	T	A	6	6	12	0	1	13	0	0
20	28354588	.	A	G	8	9	17	0	0	17	0	0
20	28354951	.	A	G	3	10	13	0	0	13	0	0
20	28356989	.	T	C	6	8	14	0	2	16	0	0
20	28356998	.	G	A	7	10	17	0	1	18	0	0
20	28357028	.	A	G	5	12	17	0	1	18	0	0
20	28357184	.	A	G	2	7	9	0	0	9	0	0
20	28357190	.	C	T	4	7	11	0	0	11	0	0
20	28357463	.	A	G	6	9	15	0	0	15	0	0
20	28357538	.	G	A	4	5	9	0	0	9	0	0
20	28357570	.	A	G	5	6	11	0	1	12	0	0
20	28357610	.	A	G	6	9	15	0	0	15	0	0
20	28357688	.	T	C	4	4	8	0	0	8	0	0
20	28357718	.	T	C	1	2	3	0	0	3	0	0
20	28357823	.	T	A	4	2	6	0	0	6	0	0
20	28357883	.	C	T	3	4	7	0	0	7	0	0
20	28361044	.	C	T	1	2	3	0	0	3	0	0
20	28400232	.	A	T	2	4	6	0	1	7	0	0
20	28400380	.	A	T	3	2	5	0	0	5	0	0
20	28400422	.	C	T	3	4	7	0	0	7	0	0
20	28400455	.	A	C	5	8	13	0	0	13	0	0
20	28400481	.	A	G	8	9	17	0	0	17	0	0
20	28400619	.	G	A	9	12	21	0	0	21	0	0
20	28401147	.	A	G	20	10	30	0	1	31	0	0
20	28401298	.	C	G	7	5	12	0	0	12	0	0
20	28401309	.	C	T	7	5	12	0	0	12	0	0
20	28401587	.	G	A	3	3	6	1	0	7	0	0
20	28402253	.	G	A	3	4	7	0	0	7	0	0
20	28402456	.	A	G	9	3	12	0	0	12	0	0
20	28402470	.	G	A	7	4	11	0	1	12	0	0
20	28411204	.	A	G	2	2	4	0	0	4	0	0
20	28414423	.	T	C	10	7	17	0	0	17	0	0
20	28418587	.	C	T	2	3	5	0	2	7	0	0
20	28418730	.	A	T	10	6	16	0	0	16	0	0
20	28418741	.	A	G	9	0	9	0	8	17	0	0
20	28418939	.	T	C	10	9	19	0	1	20	0	0
20	28419015	.	A	T	8	6	14	0	1	15	0	0
20	28419133	.	A	T	5	2	7	0	1	8	0	0
20	28420438	.	C	G	11	11	22	0	0	22	0	0
20	28420496	.	C	T	6	7	13	0	0	13	0	0
20	28422842	.	C	A	2	2	4	0	1	5	0	0
20	28422920	.	A	G	5	3	8	0	1	9	0	0
20	28422927	.	T	C	6	0	6	0	4	10	0	0
20	28423035	.	G	T	7	5	12	0	0	12	0	0
20	28423062	.	G	A	5	5	10	0	0	10	0	0
20	28423072	.	A	T	6	4	10	0	1	11	0	0
20	28424806	.	A	G	4	2	6	0	0	6	0	0
20	28456574	.	T	C	8	4	12	0	0	12	0	0
20	28469982	.	A	G	9	14	23	0	0	23	0	0
20	28470057	.	T	C	8	5	13	0	0	13	0	0
20	28476107	.	T	C	10	4	14	0	1	15	0	0
20	28487287	.	T	C	6	7	13	0	1	14	0	0
20	28514841	.	A	G	12	5	17	0	0	17	0	0
20	28514878	.	T	C	5	10	15	0	1	16	0	0
20	28514955	.	C	T	14	4	18	0	0	18	0	0
20	28541670	.	A	G	3	2	5	0	0	5	0	0
20	28541754	.	A	G	1	5	6	0	1	7	0	0
20	28641940	.	A	T	10	3	13	0	0	13	0	0
20	28650323	.	T	C	10	13	23	0	0	23	0	0
20	28650328	.	A	C	13	13	26	0	0	26	0	0
20	28650945	.	A	T	22	19	41	0	0	41	0	0
20	28650946	.	T	G	23	17	40	0	2	42	0	0
20	28651194	.	C	T	21	15	36	0	2	38	0	0
20	28651239	.	A	G	15	21	36	0	0	36	0	0
20	28651454	.	G	A	19	22	41	0	2	43	0	0
20	28651709	.	T	C	18	0	18	0	7	25	0	0
20	28651958	.	T	G	8	9	17	0	1	18	0	0
20	28652449	.	G	C	12	19	31	0	1	32	0	0
20	28654339	.	G	A	9	14	23	0	0	23	0	0
20	28658666	.	A	C	10	7	17	0	1	18	0	0
20	28658693	.	T	C	12	0	12	0	9	21	0	0
20	28659924	.	A	G	9	4	13	0	0	13	0	0
20	28659969	.	G	T	5	5	10	0	0	10	0	0
20	28660050	.	G	A	14	7	21	0	2	23	0	0
20	28660729	.	T	C	7	0	7	0	11	18	0	0
20	28660795	.	G	A	7	6	13	0	0	13	0	0
20	28660828	.	G	T	4	3	7	0	1	8	0	0
20	28660837	.	T	C	4	3	7	0	0	7	0	0
20	28675587	.	C	A	0	5	5	0	6	11	0	0
20	28677911	.	G	T	5	7	12	0	0	12	0	0
20	28697073	.	C	T	0	2	2	0	1	3	0	0
20	28783046	.	T	C	15	4	19	0	2	21	0	0
20	28783327	.	T	C	3	5	8	0	1	9	0	0
20	28783502	.	C	G	7	5	12	0	0	12	0	0
20	28783607	.	T	C	6	0	6	0	10	16	0	0
20	28783627	.	T	C	9	9	18	0	0	18	0	0
20	28783688	.	C	A	18	9	27	0	2	29	0	0
20	28783781	.	A	C	9	0	9	0	10	19	0	0
20	28783999	.	G	T	3	4	7	0	2	9	0	0
20	28784045	.	G	T	11	10	21	0	0	21	0	0
20	28800961	.	A	G	16	9	25	0	0	25	0	0
20	28804089	.	G	A	5	9	14	0	0	14	0	0
20	28814902	.	T	C	2	2	4	0	2	6	0	0
20	28817492	.	A	G	4	4	8	0	0	8	0	0
20	28822696	.	T	A	6	6	12	0	0	12	0	0
20	28822735	.	T	C	5	12	17	0	2	19	0	0
20	28823116	.	T	C	7	10	17	0	3	20	0	0
20	28825375	.	C	T	11	10	21	0	3	24	0	0
20	28827208	.	A	G	6	5	11	0	1	12	0	0
20	28827350	.	T	C	4	9	13	0	1	14	0	0
20	28827388	.	C	A	5	9	14	0	1	15	0	0
20	28827416	.	C	T	6	9	15	0	0	15	0	0
20	28827433	.	A	C	4	8	12	0	1	13	0	0
20	28827633	.	T	C	7	2	9	0	0	9	0	0
20	28833245	.	C	T	10	18	28	0	0	28	0	0
20	28833312	.	C	A	18	21	39	0	3	42	0	0
20	28833793	.	A	G	15	24	39	0	1	40	0	0
20	28833878	.	T	C	22	1	23	0	19	42	0	0
20	28834008	.	C	T	21	19	40	0	4	44	0	0
20	28834536	.	C	A	3	3	6	0	0	6	0	0
20	28834571	.	G	A	3	4	7	0	0	7	0	0
20	28834629	.	T	C	2	0	2	0	4	6	0	0
20	28834915	.	T	C	3	2	5	0	0	5	0	0
20	28835101	.	T	G	1	2	3	0	0	3	0	0
20	28870806	.	C	G	41	16	57	0	1	58	0	0
20	28870843	.	T	C	43	18	61	0	1	62	0	0
20	28870922	.	T	C	37	11	48	0	4	52	0	0
20	28871830	.	G	A	38	22	60	0	7	67	0	0
20	28875824	.	T	C	16	0	16	0	18	34	0	0
20	28876885	.	G	A	8	21	29	0	1	30	0	0
20	28876899	.	A	G	6	16	22	0	3	25	0	0
20	28876942	.	T	A	20	13	33	0	0	33	0	0
20	28876971	.	A	C	11	0	11	0	20	31	0	0
20	28876996	.	T	A	13	12	25	0	2	27	0	0
20	28877028	.	C	T	9	17	26	0	0	26	0	0
20	28877085	.	T	A	6	15	21	0	1	22	0	0
20	28877136	.	A	T	10	15	25	0	1	26	0	0
20	28877696	.	T	C	9	1	10	0	23	33	0	0
20	28878097	.	T	G	13	10	23	0	1	24	0	0
20	28878229	.	T	A	7	6	13	0	0	13	0	0
20	28884768	.	T	A	13	16	29	0	0	29	0	0
20	28886159	.	A	T	12	9	21	0	2	23	0	0
20	28886311	.	T	C	17	15	32	0	2	34	0	0
20	28886530	.	C	T	16	4	20	0	3	23	0	0
20	28886608	.	C	A	2	7	9	0	1	10	0	0
20	28886618	.	C	A	1	4	5	0	1	6	0	0
20	28886735	.	T	C	13	10	23	0	1	24	0	0
20	28886771	.	A	C	7	12	19	0	0	19	0	0
20	28886991	.	T	A	2	2	4	0	0	4	0	0
20	28887303	.	A	G	7	7	14	0	1	15	0	0
20	28887498	.	T	A	16	10	26	0	0	26	0	0
20	28887590	.	G	C	9	11	20	0	2	22	0	0
20	28888012	.	C	A	5	9	14	0	1	15	0	0
20	28888041	.	A	T	7	10	17	0	1	18	0	0
20	28888198	.	G	C	13	0	13	0	10	23	0	0
20	28888331	.	T	A	11	9	20	0	1	21	0	0
20	28888629	.	T	G	4	7	11	0	0	11	0	0
20	28888743	.	T	A	7	5	12	0	1	15	2	0
20	28888856	.	A	G	9	3	12	0	0	12	0	0
20	28889248	.	G	T	10	10	20	0	0	20	0	0
20	28889306	.	A	G	7	6	13	0	1	14	0	0
20	28897255	.	G	A	2	5	7	0	0	7	0	0
20	28897595	.	A	G	10	5	15	0	1	16	0	0
20	28935493	.	G	A	1	2	3	0	0	3	0	0
20	28938491	.	C	T	2	3	5	0	0	5	0	0
20	28938581	.	T	C	2	2	4	0	0	4	0	0
20	28960528	.	C	T	4	2	6	0	0	6	0	0
20	28973834	.	T	C	5	4	9	0	0	9	0	0
20	29216103	.	G	T	4	2	6	0	0	6	0	0
20	29268260	.	A	G	4	2	6	0	0	6	0	0
20	29269095	.	T	C	16	0	16	0	11	27	0	0
20	30879211	.	C	T	4	3	7	0	2	9	0	0
20	30879358	.	A	T	2	2	4	0	0	4	0	0
20	30879361	.	C	T	2	2	4	0	0	4	0	0
20	30879494	.	G	A	6	3	9	0	0	9	0	0
20	30879703	.	C	A	1	2	3	0	0	3	0	0
20	30879704	.	C	T	1	2	3	0	0	3	0	0
20	30889723	.	A	G	3	7	10	0	0	10	0	0
20	30889754	.	T	G	2	6	8	0	0	8	0	0
20	30889792	.	T	A	3	2	5	0	1	6	0	0
20	30894333	.	T	C	3	0	3	0	4	7	0	0
20	30894496	.	G	T	3	7	10	0	0	10	0	0
20	30894510	.	T	A	2	6	8	0	0	8	0	0
20	30894630	.	A	T	1	5	6	0	0	6	0	0
20	30895007	.	A	G	4	4	8	0	0	8	0	0
20	30895013	.	A	G	2	3	5	0	2	7	0	0
20	30895070	.	A	G	6	3	9	0	1	10	0	0
20	30895091	.	G	A	7	3	10	0	0	10	0	0
20	30897944	.	G	A	5	5	10	0	1	11	0	0
20	30897948	.	G	T	6	5	11	0	1	12	0	0
20	30899353	.	A	G	4	2	6	0	0	6	0	0
20	30900928	.	C	G	0	3	3	0	5	8	0	0
20	30922687	.	G	A	6	8	14	0	1	15	0	0
20	30922688	.	A	T	6	8	14	0	1	15	0	0
20	30922808	.	T	A	8	3	11	0	1	12	0	0
20	30922836	.	C	A	9	4	13	0	0	14	1	0
20	30923101	.	T	C	10	6	16	0	3	19	0	0
20	30925253	.	T	C	8	0	8	0	7	15	0	0
20	30926205	.	T	C	5	6	11	0	1	12	0	0
20	30928174	.	T	C	5	3	8	0	0	8	0	0
20	30931021	.	A	T	9	6	15	0	0	15	0	0
20	30931108	.	G	A	4	6	10	0	0	10	0	0
20	30931671	.	G	A	12	9	21	0	1	22	0	0
20	30932277	.	T	C	21	0	21	0	20	41	0	0
20	30936755	.	T	C	6	1	7	0	16	23	0	0
20	30939177	.	T	C	13	13	26	0	0	26	0	0
20	30940566	.	C	G	16	19	35	0	0	35	0	0
20	30947353	.	T	C	33	16	49	0	2	51	0	0
20	30947433	.	T	C	18	6	24	0	0	24	0	0
20	31003145	.	T	C	1	3	4	0	0	4	0	0
20	31003147	.	C	T	1	3	4	0	0	4	0	0
20	31005200	.	T	A	1	3	4	0	0	4	0	0
20	31105619	.	G	A	9	5	14	1	1	16	0	0
20	31170202	.	G	A	4	7	11	0	0	11	0	0
20	31171010	.	G	A	2	3	5	0	0	5	0	0
20	31171079	.	A	G	7	2	9	0	0	9	0	0
20	31172725	.	A	C	3	2	5	0	0	5	0	0
20	31172996	.	C	T	4	4	8	0	0	8	0	0
20	31178425	.	G	T	8	3	11	0	0	11	0	0
20	31181050	.	A	G	7	4	11	0	0	11	0	0
20	31182194	.	G	A	6	2	8	0	1	9	0	0
20	31186253	.	T	C	4	7	11	0	0	11	0	0
20	31187975	.	G	A	16	15	31	0	0	31	0	0
20	31192304	.	A	C	8	15	23	0	1	24	0	0
20	31192720	.	C	T	15	13	28	0	2	30	0	0
20	31193762	.	G	A	1	8	9	0	9	18	0	0
20	31193826	.	C	T	12	9	21	0	3	24	0	0
20	31197217	.	G	T	9	14	23	0	0	23	0	0
20	31197307	.	G	A	0	21	21	0	13	34	0	0
20	31197465	.	T	C	17	16	33	0	1	34	0	0
20	31199655	.	G	A	13	14	27	0	0	27	0	0
20	31202316	.	C	T	11	4	15	0	0	15	0	0
20	31204173	.	T	C	7	19	26	0	3	29	0	0
20	31204191	.	A	C	9	14	23	0	2	25	0	0
20	31206649	.	A	G	18	12	30	0	1	31	0	0
20	31211701	.	T	A	22	15	37	0	0	37	0	0
20	31211710	.	A	G	23	11	34	0	1	35	0	0
20	31211812	.	G	A	1	9	10	0	13	23	0	0
20	31211846	.	G	A	1	9	10	0	14	24	0	0
20	31212156	.	G	A	2	15	17	0	14	31	0	0
20	31212390	.	G	C	13	5	18	0	1	19	0	0
20	31222978	.	T	G	10	0	10	0	13	24	1	0
20	31223282	.	C	T	8	5	13	0	0	13	0	0
20	31223336	.	C	T	8	7	15	0	0	15	0	0
20	31225875	.	C	T	15	9	24	0	0	24	0	0
20	31233463	.	T	G	4	4	8	0	0	8	0	0
20	31233679	.	A	G	8	6	14	0	2	16	0	0
20	31233837	.	G	C	6	7	13	0	0	13	0	0
20	31238061	.	A	G	6	7	13	0	0	13	0	0
20	31313111	.	C	T	2	5	7	0	0	7	0	0
20	31429181	.	C	T	6	2	8	0	0	8	0	0
20	31429648	.	C	T	14	15	29	0	1	30	0	0
20	31429824	.	G	A	9	5	14	0	0	14	0	0
20	31430039	.	G	C	7	6	13	0	0	13	0	0
20	31430204	.	C	A	6	5	11	0	1	12	0	0
20	31430279	.	A	G	7	6	13	0	1	14	0	0
20	31430320	.	T	C	8	0	8	0	5	13	0	0
20	31430769	.	C	T	0	10	10	0	5	15	0	0
20	31430922	.	T	A	8	4	12	0	0	12	0	0
20	31430993	.	C	T	1	7	8	0	7	15	0	0
20	31431160	.	A	T	11	9	20	0	0	20	0	0
20	31431375	.	T	C	7	4	11	0	1	12	0	0
20	31431457	.	T	A	7	6	13	0	2	15	0	0
20	31431501	.	G	T	6	3	9	0	0	9	0	0
20	31431561	.	A	G	5	2	7	0	2	9	0	0
20	31431701	.	A	G	7	7	14	0	1	15	0	0
20	31431739	.	A	G	8	6	14	0	2	16	0	0
20	31431962	.	A	G	11	5	16	0	0	16	0	0
20	31436304	.	C	T	6	5	11	0	0	11	0	0
20	31436450	.	G	A	12	8	20	0	1	21	0	0
20	31436483	.	C	T	13	10	23	0	1	24	0	0
20	31436750	.	C	T	1	2	3	0	4	7	0	0
20	31436819	.	C	A	4	4	8	0	0	8	0	0
20	31436984	.	C	T	4	2	6	0	0	6	0	0
20	31441076	.	G	A	1	2	3	0	0	3	0	0
20	31447413	.	C	T	0	3	3	0	6	9	0	0
20	31447455	.	C	T	6	3	9	0	0	9	0	0
20	31471068	.	G	A	2	4	6	0	0	6	0	0
20	31483629	.	C	A	1	3	4	0	0	4	0	0
20	31743161	.	C	T	1	2	3	0	0	3	0	0
20	31746604	.	C	T	8	11	19	2	1	22	0	0
20	31746611	.	A	T	8	10	18	2	1	21	0	0
20	31747116	.	A	T	15	14	29	3	1	33	0	0
20	31747673	.	C	A	2	23	25	0	9	34	0	0
20	31747695	.	G	C	22	12	34	0	1	35	0	0
20	31747792	.	C	T	3	14	17	0	12	29	0	0
20	31747860	.	C	T	4	11	15	8	15	38	0	0
20	31748178	.	T	C	10	17	27	0	1	28	0	0
20	31748183	.	C	T	18	11	29	0	0	29	0	0
20	31748363	.	A	G	8	19	27	0	0	27	0	0
20	31748448	.	A	G	12	9	21	0	0	21	0	0
20	31748518	.	C	T	8	10	18	0	3	21	0	0
20	31748755	.	G	A	11	11	22	0	0	22	0	0
20	31748845	.	A	T	10	10	20	0	0	20	0	0
20	31771899	.	G	A	9	5	14	0	0	14	0	0
20	31777192	.	C	T	0	6	6	0	7	13	0	0
20	31786688	.	T	A	2	2	4	0	0	4	0	0
20	31790975	.	A	G	4	2	6	0	0	6	0	0
20	31977463	.	G	C	1	2	3	0	0	3	0	0
20	32047457	.	T	C	10	6	16	0	2	18	0	0
20	32047741	.	A	C	16	16	32	0	1	33	0	0
20	32061596	.	G	A	5	10	15	0	0	15	0	0
20	32061611	.	C	A	0	8	8	0	4	12	0	0
20	32065517	.	G	A	9	4	13	0	1	14	0	0
20	32065650	.	C	T	7	8	15	1	0	16	0	0
20	32071494	.	A	G	7	8	15	0	0	15	0	0
20	32110172	.	T	C	6	0	6	0	6	12	0	0
20	32110331	.	G	A	7	6	13	0	3	16	0	0
20	32135962	.	T	C	5	11	16	0	0	16	0	0
20	32136378	.	G	T	10	5	15	0	1	16	0	0
20	32136451	.	T	G	11	8	19	0	2	21	0	0
20	32136588	.	G	T	13	9	22	0	1	23	0	0
20	32136953	.	C	T	8	5	13	0	0	13	0	0
20	32137423	.	G	A	5	7	12	0	0	12	0	0
20	32137529	.	A	T	8	6	14	0	0	14	0	0
20	32137638	.	A	G	8	13	21	0	1	22	0	0
20	32137752	.	G	T	10	11	21	0	0	21	0	0
20	32137984	.	A	T	14	10	24	0	2	26	0	0
20	32138029	.	T	A	22	7	29	0	0	29	0	0
20	32138111	.	C	T	11	10	21	0	1	22	0	0
20	32138171	.	T	C	11	14	25	0	0	25	0	0
20	32138478	.	A	G	13	12	25	0	1	26	0	0
20	32141959	.	T	A	3	2	5	0	0	5	0	0
20	32224452	.	A	G	4	0	4	0	6	10	0	0
20	32224485	.	C	A	6	3	9	0	2	11	0	0
20	32225711	.	G	A	6	6	12	0	1	13	0	0
20	32227268	.	G	A	11	9	20	0	1	21	0	0
20	32228863	.	G	A	18	16	34	0	0	34	0	0
20	32228872	.	A	G	12	19	31	0	3	34	0	0
20	32228936	.	A	C	21	13	34	0	1	35	0	0
20	32229004	.	G	A	21	19	40	0	1	41	0	0
20	32229047	.	G	A	17	18	35	0	2	37	0	0
20	32229053	.	C	T	18	16	34	0	2	36	0	0
20	32229095	.	T	C	12	15	27	0	3	30	0	0
20	32229214	.	G	T	27	7	34	0	2	36	0	0
20	32229825	.	G	T	26	21	47	1	2	50	0	0
20	32230017	.	A	C	20	24	44	0	4	48	0	0
20	32230205	.	T	G	14	1	15	0	15	30	0	0
20	32230301	.	T	C	5	8	13	0	0	13	0	0
20	32230362	.	C	A	6	9	15	0	1	16	0	0
20	32230470	.	T	C	13	11	24	0	0	24	0	0
20	32230472	.	A	C	15	9	24	0	1	25	0	0
20	32230518	.	C	A	15	8	23	0	2	25	0	0
20	32230521	.	G	A	0	8	8	0	17	25	0	0
20	32230555	.	C	A	17	9	26	0	1	27	0	0
20	32230620	.	C	T	18	21	39	0	3	42	0	0
20	32230836	.	T	C	17	8	25	0	3	28	0	0
20	32286800	.	C	T	1	10	11	2	7	20	0	0
20	32286875	.	C	T	19	8	27	0	0	27	0	0
20	32286877	.	A	C	8	18	26	0	0	26	0	0
20	32286960	.	A	C	13	14	27	0	2	29	0	0
20	32287317	.	C	T	8	4	12	0	0	12	0	0
20	32287349	.	C	G	5	10	15	0	0	15	0	0
20	32287736	.	T	C	6	11	17	0	0	17	0	0
20	32290160	.	G	A	7	9	16	0	0	16	0	0
20	32290435	.	A	G	7	11	18	0	0	18	0	0
20	32290679	.	G	A	6	12	18	0	2	20	0	0
20	32291287	.	G	A	5	6	11	0	0	11	0	0
20	32332463	.	A	G	3	2	5	0	0	5	0	0
20	32332494	.	A	C	2	0	2	0	2	4	0	0
20	32332633	.	A	T	4	3	7	0	0	7	0	0
20	32348568	.	C	T	2	6	8	0	0	8	0	0
20	32398151	.	G	A	5	2	7	0	0	7	0	0
20	32406066	.	T	C	1	5	6	0	0	6	0	0
20	32432156	.	T	C	20	17	37	0	1	38	0	0
20	32432315	.	G	T	7	14	21	0	3	24	0	0
20	32432532	.	C	T	15	9	24	0	2	26	0	0
20	32484600	.	C	T	4	5	9	0	0	9	0	0
20	32487507	.	T	C	4	5	9	0	0	9	0	0
20	32489618	.	G	A	0	2	2	0	3	5	0	0
20	32490403	.	C	T	9	9	18	0	0	18	0	0
20	32490480	.	C	T	1	6	7	0	0	7	0	0
20	32490783	.	C	G	1	2	3	0	0	3	0	0
20	32498335	.	C	T	2	6	8	0	0	8	0	0
20	32498410	.	C	G	2	5	7	0	0	7	0	0
20	32498441	.	G	C	2	6	8	0	1	9	0	0
20	32498517	.	C	T	7	3	10	0	0	10	0	0
20	32498635	.	C	A	4	2	6	0	0	6	0	0
20	32498690	.	C	T	4	6	10	0	0	10	0	0
20	32498771	.	C	G	2	5	7	0	0	7	0	0
20	32498869	.	A	G	1	3	4	0	1	5	0	0
20	32499166	.	G	A	0	8	8	0	8	16	0	0
20	32505856	.	G	A	2	2	4	0	0	4	0	0
20	32513235	.	G	A	13	15	28	0	0	28	0	0
20	32513256	.	G	A	9	15	24	0	2	26	0	0
20	32513987	.	G	A	13	12	25	0	1	26	0	0
20	32515968	.	C	T	6	14	20	0	0	20	0	0
20	32518298	.	T	C	1	4	5	0	0	5	0	0
20	32518306	.	G	A	1	3	4	0	0	4	0	0
20	32520852	.	A	G	3	6	9	0	1	10	0	0
20	32521203	.	C	T	6	12	18	1	3	22	0	0
20	32521220	.	T	C	14	7	21	1	2	24	0	0
20	32521377	.	C	T	6	6	12	0	0	12	0	0
20	32521686	.	A	C	19	17	36	0	0	36	0	0
20	32521719	.	A	C	17	12	29	0	3	32	0	0
20	32567835	.	G	T	1	2	3	0	0	3	0	0
20	32571781	.	C	T	5	4	9	0	2	11	0	0
20	32574157	.	T	C	3	4	7	0	0	7	0	0
20	32576667	.	T	C	5	3	8	0	0	8	0	0
20	32756790	.	G	A	2	5	7	0	4	11	0	0
20	32757807	.	C	G	8	0	8	0	16	24	0	0
20	32758490	.	A	G	14	13	27	0	0	27	0	0
20	32758558	.	T	C	18	9	27	0	0	27	0	0
20	32838495	.	G	A	4	2	6	0	0	6	0	0
20	32838710	.	A	T	4	3	7	0	0	7	0	0
20	32863650	.	A	G	2	3	5	0	0	5	0	0
20	32863657	.	A	G	2	3	5	0	0	5	0	0
20	32872156	.	C	A	1	3	4	0	0	4	0	0
20	32925890	.	T	C	4	2	6	0	0	6	0	0
20	32939176	.	T	C	3	3	6	0	2	8	0	0
20	32939208	.	T	A	5	4	9	0	0	9	0	0
20	32948411	.	A	T	2	3	5	0	0	5	0	0
20	32948551	.	A	C	2	3	5	0	1	6	0	0
20	32963014	.	C	T	0	3	3	0	3	6	0	0
20	33175232	.	A	G	5	0	5	0	9	14	0	0
20	33175351	.	G	A	5	11	16	0	1	17	0	0
20	33175504	.	T	C	6	11	17	0	0	17	0	0
20	33175549	.	C	T	7	8	15	0	1	16	0	0
20	33175948	.	A	C	12	4	16	0	0	16	0	0
20	33180111	.	T	C	6	8	14	0	1	15	0	0
20	33180295	.	G	A	5	5	10	0	0	10	0	0
20	33180547	.	C	T	6	4	10	0	0	10	0	0
20	33189326	.	T	G	15	0	15	0	12	27	0	0
20	33189386	.	G	A	2	6	8	0	13	21	0	0
20	33189631	.	G	A	6	3	9	0	0	9	0	0
20	33298184	.	C	T	6	5	11	0	0	11	0	0
20	33467794	.	A	T	11	6	17	1	1	19	0	0
20	33468040	.	T	G	20	17	37	0	2	39	0	0
20	33484083	.	G	A	5	5	10	0	0	10	0	0
20	33484387	.	T	C	5	4	9	0	1	10	0	0
20	33484438	.	G	C	3	0	3	0	6	9	0	0
20	33486846	.	G	A	4	5	9	0	0	9	0	0
20	33487143	.	G	T	1	3	4	0	0	4	0	0
20	33487152	.	A	T	1	2	3	0	0	3	0	0
20	33487603	.	C	T	4	7	11	0	0	11	0	0
20	33494411	.	G	T	15	16	31	0	1	32	0	0
20	33532383	.	T	A	1	1	2	0	1	3	0	0
20	33532392	.	A	G	1	2	3	0	0	3	0	0
20	33664996	.	C	T	2	2	4	0	0	4	0	0
20	33735327	.	G	A	1	2	3	0	0	3	0	0
20	33758874	.	C	T	9	4	13	0	1	14	0	0
20	33759151	.	G	C	18	0	18	0	14	32	0	0
20	33771521	.	G	A	5	5	10	0	0	10	0	0
20	33773493	.	G	A	4	9	13	0	3	16	0	0
20	33789927	.	C	T	1	7	8	0	2	10	0	0
20	33789965	.	G	T	5	11	16	0	0	16	0	0
20	33809707	.	A	G	16	11	27	0	2	29	0	0
20	33809971	.	C	A	4	11	15	0	1	16	0	0
20	33810099	.	G	A	2	5	7	0	1	8	0	0
20	33810101	.	G	A	3	5	8	0	0	8	0	0
20	33810302	.	C	T	3	3	6	1	2	9	0	0
20	33810303	.	C	A	3	4	7	1	1	9	0	0
20	33810751	.	T	C	1	6	7	0	0	7	0	0
20	33810845	.	C	T	13	10	23	0	1	24	0	0
20	33810921	.	T	C	12	1	13	0	14	27	0	0
20	33811519	.	G	T	10	11	21	0	0	21	0	0
20	33839868	.	A	G	8	7	15	0	0	15	0	0
20	33840638	.	T	C	3	5	8	0	1	9	0	0
20	33859788	.	A	T	10	6	16	0	0	16	0	0
20	33859869	.	C	T	2	9	11	0	17	28	0	0
20	33860113	.	G	A	4	7	11	0	0	11	0	0
20	33862741	.	G	A	2	6	8	0	1	9	0	0
20	33864772	.	A	G	2	4	6	0	0	6	0	0
20	33984086	.	G	C	12	11	23	0	0	23	0	0
20	34003047	.	G	A	0	3	3	0	2	5	0	0
20	34007128	.	G	A	5	4	9	0	0	9	0	0
20	34007589	.	G	C	3	3	6	0	0	6	0	0
20	34007607	.	G	A	3	2	5	0	0	5	0	0
20	34009225	.	C	G	8	0	8	0	4	12	0	0
20	34009952	.	C	A	7	16	23	0	2	26	1	0
20	34012828	.	T	A	12	6	18	0	0	18	0	0
20	34012916	.	A	T	2	9	11	0	0	11	0	0
20	34013073	.	T	G	8	10	18	0	1	19	0	0
20	34015654	.	C	T	2	8	10	0	9	19	0	0
20	34015907	.	G	A	10	10	20	0	1	21	0	0
20	34015921	.	T	A	12	9	21	0	1	22	0	0
20	34018783	.	C	T	12	7	19	0	0	19	0	0
20	34018852	.	C	A	9	6	15	0	0	15	0	0
20	34020560	.	G	A	4	7	11	0	0	11	0	0
20	34020608	.	T	C	5	0	5	0	5	10	0	0
20	34020861	.	T	A	4	5	9	0	0	9	0	0
20	34040132	.	C	A	6	9	15	0	2	17	0	0
20	34044813	.	G	A	10	8	18	0	0	18	0	0
20	34044845	.	A	T	15	9	24	0	0	24	0	0
20	34049141	.	G	A	9	7	16	0	1	17	0	0
20	34051237	.	C	T	9	13	22	0	0	22	0	0
20	34051417	.	G	A	11	10	21	0	0	21	0	0
20	34053787	.	T	A	13	20	33	0	0	33	0	0
20	34054401	.	C	T	16	13	29	0	0	29	0	0
20	34056206	.	C	G	8	3	11	0	0	11	0	0
20	34056227	.	C	T	4	10	14	0	0	14	0	0
20	34057323	.	C	A	5	4	9	0	0	9	0	0
20	34059166	.	T	C	3	2	5	0	1	6	0	0
20	34059335	.	T	C	3	0	3	0	5	8	0	0
20	34061117	.	C	T	3	5	8	0	1	9	0	0
20	34061784	.	C	T	3	2	5	0	0	5	0	0
20	34061788	.	G	T	4	2	6	0	0	6	0	0
20	34061986	.	G	A	4	4	8	0	0	8	0	0
20	34151818	.	C	A	8	9	17	0	0	17	0	0
20	34151873	.	C	T	5	5	10	0	0	10	0	0
20	34153975	.	G	A	10	3	13	0	1	14	0	0
20	34154122	.	C	T	8	4	12	0	0	12	0	0
20	34154618	.	C	A	7	5	12	0	4	16	0	0
20	34154831	.	G	A	12	6	18	0	0	18	0	0
20	34154982	.	G	T	11	11	22	0	3	25	0	0
20	34155025	.	C	T	17	8	25	0	0	25	0	0
20	34155192	.	T	C	5	10	15	0	0	15	0	0
20	34158296	.	T	A	1	2	3	0	0	3	0	0
20	34332683	.	C	A	21	9	30	0	0	30	0	0
20	34333733	.	T	C	12	17	29	0	1	30	0	0
20	34337702	.	G	A	4	5	9	0	0	9	0	0
20	34339473	.	G	A	28	23	51	0	2	53	0	0
20	34339516	.	C	T	28	24	52	0	1	53	0	0
20	34340055	.	T	C	21	34	55	0	1	56	0	0
20	34340678	.	A	T	22	17	39	0	6	45	0	0
20	34344358	.	T	G	1	3	4	0	0	4	0	0
20	34344363	.	A	C	1	2	3	0	0	3	0	0
20	34364991	.	C	T	2	2	4	0	0	4	0	0
20	34372374	.	C	T	0	2	2	0	1	3	0	0
20	34389953	.	T	C	1	1	2	0	0	2	0	0
20	34389963	.	C	A	1	2	3	0	0	3	0	0
20	34398646	.	G	A	1	2	3	0	0	3	0	0
20	34420788	.	G	A	21	20	41	0	1	42	0	0
20	34420860	.	A	G	26	12	38	0	0	38	0	0
20	34421307	.	A	G	10	12	22	0	1	23	0	0
20	34421485	.	C	T	14	13	27	0	2	29	0	0
20	34421758	.	G	A	6	10	16	0	0	16	0	0
20	34421801	.	G	C	14	0	14	0	14	28	0	0
20	34421804	.	G	A	14	13	27	0	1	28	0	0
20	34426660	.	T	G	20	14	34	0	1	35	0	0
20	34430100	.	T	G	9	9	18	0	1	19	0	0
20	34431467	.	G	C	9	9	18	0	0	18	0	0
20	34431661	.	A	G	11	11	22	0	0	22	0	0
20	34445005	.	A	G	8	4	12	0	0	12	0	0
20	34446718	.	G	A	4	2	6	0	0	6	0	0
20	34446733	.	A	G	2	2	4	0	0	4	0	0
20	34447477	.	G	C	3	5	8	0	1	9	0	0
20	34447522	.	T	C	4	5	9	0	0	9	0	0
20	34450257	.	T	G	2	3	5	0	0	5	0	0
20	34450535	.	T	C	5	5	10	0	0	10	0	0
20	34501246	.	T	C	3	2	5	0	0	5	0	0
20	34502644	.	G	A	4	4	8	0	0	8	0	0
20	34506642	.	A	T	1	2	3	0	0	3	0	0
20	34537775	.	A	C	3	8	11	0	0	11	0	0
20	34551195	.	C	T	2	5	7	0	1	8	0	0
20	34551222	.	A	G	6	6	12	0	0	12	0	0
20	34551246	.	G	A	11	4	15	0	0	15	0	0
20	34593729	.	G	A	7	5	12	0	0	12	0	0
20	34596633	.	G	T	1	3	4	0	0	4	0	0
20	34596634	.	T	A	1	3	4	0	0	4	0	0
20	34596710	.	A	T	1	2	3	0	0	3	0	0
20	34596736	.	C	G	3	0	3	0	2	5	0	0
20	34596788	.	C	T	3	4	7	0	1	8	0	0
20	34596797	.	G	T	4	4	8	0	0	8	0	0
20	34597244	.	A	G	7	12	19	0	0	19	0	0
20	34597631	.	C	T	10	9	19	0	1	20	0	0
20	34597844	.	T	C	7	12	19	0	0	19	0	0
20	34598076	.	T	A	6	14	20	0	0	20	0	0
20	34598113	.	C	A	7	10	17	0	1	18	0	0
20	34601175	.	G	A	14	19	33	0	1	34	0	0
20	34601214	.	A	T	7	21	28	0	0	28	0	0
20	34602561	.	A	C	20	12	32	0	2	34	0	0
20	34602576	.	T	G	20	17	37	0	1	38	0	0
20	34603661	.	C	T	18	22	40	0	0	40	0	0
20	34603733	.	T	G	11	18	29	0	5	34	0	0
20	34604241	.	C	A	21	25	46	0	2	48	0	0
20	34604356	.	C	T	12	15	27	0	3	30	0	0
20	34604432	.	C	T	15	22	37	0	1	38	0	0
20	34607698	.	A	G	12	1	13	0	13	26	0	0
20	34607893	.	A	G	11	12	23	0	0	23	0	0
20	34607970	.	C	T	11	8	19	0	0	19	0	0
20	34608235	.	A	G	9	6	15	0	0	15	0	0
20	34608458	.	A	C	8	12	20	0	0	20	0	0
20	34608519	.	T	C	5	7	12	0	0	12	0	0
20	34611709	.	G	T	6	6	12	1	0	13	0	0
20	34613651	.	A	G	4	2	6	0	0	6	0	0
20	34617642	.	T	C	5	2	7	0	1	8	0	0
20	34617729	.	G	A	5	4	9	0	0	9	0	0
20	34617780	.	A	T	3	5	8	0	0	8	0	0
20	34617837	.	G	A	1	2	3	0	2	5	0	0
20	34627817	.	G	C	6	4	10	0	0	10	0	0
20	34630281	.	A	G	7	6	13	0	0	13	0	0
20	34632577	.	T	C	9	7	16	0	1	17	0	0
20	34632587	.	C	T	9	5	14	0	1	15	0	0
20	34632740	.	C	A	1	4	5	0	0	5	0	0
20	34632864	.	C	A	2	2	4	0	1	5	0	0
20	34634979	.	T	C	10	4	14	0	0	14	0	0
20	34634988	.	T	C	9	5	14	0	0	14	0	0
20	34636529	.	A	T	6	5	11	0	0	11	0	0
20	34636536	.	G	A	6	5	11	0	0	11	0	0
20	34638185	.	A	G	8	0	8	0	5	13	0	0
20	34638235	.	G	A	0	7	7	0	9	16	0	0
20	34638251	.	G	A	5	7	12	0	0	12	0	0
20	34642639	.	C	A	9	7	16	0	0	16	0	0
20	34642805	.	A	G	11	7	18	0	1	19	0	0
20	34642931	.	G	A	5	4	9	0	1	10	0	0
20	34643007	.	A	G	10	4	14	0	1	15	0	0
20	34643051	.	T	C	19	3	22	0	3	25	0	0
20	34643054	.	A	G	21	4	25	0	0	25	0	0
20	34643163	.	A	G	10	8	18	0	1	19	0	0
20	34643305	.	C	A	3	2	5	0	1	6	0	0
20	34643378	.	A	T	3	2	5	0	0	5	0	0
20	34643386	.	A	T	3	3	6	0	2	8	0	0
20	34643433	.	T	A	10	4	14	0	4	18	0	0
20	34643491	.	A	T	5	3	8	0	1	9	0	0
20	34643535	.	T	C	2	4	6	0	0	6	0	0
20	34643800	.	C	T	8	8	16	1	0	17	0	0
20	34673199	.	T	A	6	3	9	0	1	10	0	0
20	34682639	.	C	T	3	2	5	0	0	5	0	0
20	34727666	.	G	A	4	3	7	0	0	7	0	0
20	34733553	.	C	A	11	13	24	0	0	24	0	0
20	34733604	.	G	A	12	12	24	0	0	24	0	0
20	34733752	.	C	T	14	10	24	1	4	29	0	0
20	34737886	.	T	A	7	5	12	0	0	12	0	0
20	34737944	.	G	C	12	5	17	0	0	17	0	0
20	34738198	.	G	A	26	27	53	0	1	54	0	0
20	34738314	.	G	A	15	15	30	0	7	37	0	0
20	34738397	.	G	T	14	14	28	0	0	28	0	0
20	34738473	.	T	G	16	9	25	0	2	27	0	0
20	34738756	.	A	G	17	20	37	0	1	38	0	0
20	34742840	.	G	A	16	15	31	1	0	32	0	0
20	34745872	.	A	G	18	12	30	0	2	32	0	0
20	34746019	.	G	A	13	16	29	0	0	29	0	0
20	34747208	.	T	C	10	9	19	0	1	20	0	0
20	34749747	.	G	A	10	8	18	0	2	20	0	0
20	34794668	.	T	C	6	5	11	0	1	12	0	0
20	34794939	.	C	T	24	31	55	0	5	60	0	0
20	34795111	.	C	A	38	28	66	0	2	68	0	0
20	34795126	.	A	G	36	30	66	0	2	68	0	0
20	34795296	.	T	C	32	31	63	0	1	64	0	0
20	34795379	.	T	C	31	31	62	0	1	63	0	0
20	34795473	.	C	T	5	28	33	0	32	65	0	0
20	34795689	.	C	T	40	33	73	0	5	78	0	0
20	34797252	.	G	T	42	37	79	0	3	82	0	0
20	34797598	.	A	T	30	25	55	0	7	62	0	0
20	34955791	.	C	T	42	27	69	0	4	73	0	0
20	34956159	.	A	T	19	11	30	0	1	31	0	0
20	34956164	.	T	A	17	13	30	0	2	32	0	0
20	34967476	.	T	C	5	0	5	0	8	13	0	0
20	34969773	.	A	T	15	21	36	0	2	38	0	0
20	34975831	.	G	A	9	12	21	0	1	22	0	0
20	34980452	.	T	C	10	13	23	0	0	23	0	0
20	34982018	.	C	T	7	10	17	0	0	17	0	0
20	34982323	.	T	A	6	9	15	0	0	15	0	0
20	34985368	.	C	A	2	4	6	0	6	12	0	0
20	34985384	.	C	T	1	5	6	0	8	14	0	0
20	34985424	.	T	G	5	11	16	0	1	17	0	0
20	34985462	.	A	G	6	10	16	0	0	16	0	0
20	34985480	.	A	T	11	4	15	0	2	17	0	0
20	34985499	.	A	C	7	4	11	0	1	12	0	0
20	34991804	.	C	T	3	5	8	0	3	11	0	0
20	35001423	.	G	A	3	2	5	0	0	5	0	0
20	35007466	.	A	G	6	3	9	0	0	9	0	0
20	35011946	.	C	T	8	3	11	0	1	12	0	0
20	35014149	.	A	T	0	2	2	0	1	3	0	0
20	35019062	.	A	T	2	2	4	0	1	5	0	0
20	35019578	.	T	C	2	4	6	0	0	6	0	0
20	35059085	.	G	A	0	4	4	0	14	18	0	0
20	35064469	.	T	C	17	13	30	0	1	31	0	0
20	35064808	.	C	T	20	8	28	0	4	32	0	0
20	35065345	.	G	A	2	18	20	0	19	39	0	0
20	35065573	.	A	C	16	18	34	0	8	42	0	0
20	35066821	.	G	A	3	18	21	0	30	52	1	0
20	35066935	.	G	A	2	20	22	1	30	53	0	0
20	35068064	.	A	G	30	0	30	0	28	58	0	0
20	35068790	.	A	T	12	8	20	0	1	22	1	0
20	35069063	.	A	C	8	10	18	0	1	19	0	0
20	35069756	.	A	G	16	18	34	0	2	36	0	0
20	35069963	.	A	C	17	16	33	0	0	33	0	0
20	35070176	.	C	T	17	18	35	0	3	38	0	0
20	35070217	.	T	G	29	23	52	0	0	52	0	0
20	35162090	.	G	A	1	2	3	0	0	3	0	0
20	35164811	.	A	T	2	2	4	0	0	4	0	0
20	35177501	.	T	C	3	3	6	0	0	6	0	0
20	35183406	.	A	G	3	0	3	0	5	8	0	0
20	35184413	.	T	C	4	2	6	0	0	6	0	0
20	35184419	.	T	C	4	1	5	0	1	6	0	0
20	35188776	.	G	A	2	4	6	0	0	6	0	0
20	35195535	.	A	G	9	9	18	0	1	19	0	0
20	35198810	.	A	C	7	11	18	0	0	19	1	0
20	35204702	.	A	C	5	6	11	0	1	12	0	0
20	35204729	.	T	C	7	5	12	0	0	12	0	0
20	35204773	.	C	T	8	10	18	0	2	20	0	0
20	35204814	.	A	G	6	0	6	0	9	15	0	0
20	35204848	.	T	G	6	4	10	0	0	10	0	0
20	35204944	.	G	A	6	9	15	0	1	16	0	0
20	35205061	.	C	T	7	12	19	0	0	19	0	0
20	35205182	.	T	C	13	7	20	0	0	20	0	0
20	35205600	.	A	T	12	16	28	0	0	28	0	0
20	35205680	.	A	G	5	11	16	0	0	16	0	0
20	35206101	.	A	T	8	8	16	0	2	18	0	0
20	35208046	.	A	G	8	4	12	0	0	12	0	0
20	35209012	.	G	A	4	2	6	0	0	6	0	0
20	35209080	.	T	A	5	5	10	0	1	11	0	0
20	35209201	.	C	T	8	5	13	0	1	14	0	0
20	35209405	.	C	T	11	14	25	0	1	26	0	0
20	35209481	.	G	A	15	9	24	0	1	25	0	0
20	35210175	.	C	A	19	10	29	0	0	29	0	0
20	35210212	.	G	T	16	7	23	0	0	23	0	0
20	35210229	.	A	C	11	8	19	0	0	19	0	0
20	35210538	.	C	G	5	4	9	0	1	10	0	0
20	35210575	.	C	T	6	3	9	0	2	11	0	0
20	35210649	.	A	G	11	5	16	0	0	16	0	0
20	35210690	.	A	G	10	3	13	0	0	13	0	0
20	35210781	.	A	G	6	3	9	0	0	9	0	0
20	35211153	.	A	G	3	6	9	0	0	9	0	0
20	35211225	.	A	G	3	2	5	0	0	5	0	0
20	35211399	.	G	A	3	3	6	0	0	6	0	0
20	35211515	.	C	T	0	3	3	0	3	7	1	0
20	35211760	.	G	A	9	3	12	0	0	12	0	0
20	35212366	.	T	C	2	4	6	0	0	6	0	0
20	35212398	.	A	G	3	3	6	0	1	7	0	0
20	35212860	.	A	T	2	5	7	0	0	7	0	0
20	35215671	.	C	T	3	4	7	0	0	7	0	0
20	35215680	.	T	G	3	3	6	0	1	7	0	0
20	35226554	.	T	G	1	2	3	0	0	3	0	0
20	35226665	.	T	C	4	6	10	0	0	10	0	0
20	35227256	.	C	G	1	4	5	0	0	5	0	0
20	35295208	.	C	T	6	4	10	0	0	10	0	0
20	35296980	.	T	C	4	4	8	0	0	8	0	0
20	35297212	.	T	G	11	0	11	0	6	17	0	0
20	35297693	.	G	A	8	5	13	0	1	14	0	0
20	35297699	.	A	G	8	5	13	0	1	14	0	0
20	35297870	.	T	C	3	6	9	0	1	10	0	0
20	35392100	.	C	T	30	25	55	0	3	58	0	0
20	35427409	.	G	C	22	27	49	0	0	49	0	0
20	35427676	.	T	G	24	0	24	0	33	57	0	0
20	35427745	.	A	G	34	0	34	0	31	65	0	0
20	35427782	.	T	C	29	32	61	0	3	64	0	0
20	35427907	.	C	G	18	28	46	0	2	48	0	0
20	35427946	.	A	G	19	2	21	0	27	48	0	0
20	35428035	.	A	G	38	18	56	0	2	58	0	0
20	35428128	.	A	T	40	18	58	1	15	74	0	0
20	35428436	.	G	A	28	35	63	0	6	69	0	0
20	35428633	.	T	C	27	38	65	1	7	73	0	0
20	35428802	.	A	G	20	49	69	0	2	71	0	0
20	35428910	.	A	G	30	32	62	0	2	64	0	0
20	35429017	.	T	A	27	11	38	0	2	40	0	0
20	35429054	.	A	G	27	1	28	0	40	68	0	0
20	35429610	.	A	T	27	42	69	0	0	69	0	0
20	35433311	.	A	G	27	0	27	0	26	53	0	0
20	35798370	.	G	A	16	15	31	0	2	33	0	0
20	35798697	.	A	T	3	10	13	0	0	13	0	0
20	35798851	.	C	A	2	4	6	0	0	6	0	0
20	35798973	.	T	A	2	9	11	0	1	12	0	0
20	35799001	.	A	G	4	10	14	0	1	15	0	0
20	35799135	.	G	A	12	12	24	0	1	25	0	0
20	35799291	.	G	C	7	7	14	0	1	15	0	0
20	35799534	.	T	C	6	7	13	0	0	13	0	0
20	35799612	.	A	T	11	8	19	0	1	20	0	0
20	35799673	.	T	A	16	10	26	0	0	26	0	0
20	35799729	.	T	A	17	10	27	0	1	28	0	0
20	35799803	.	T	A	15	5	20	0	1	21	0	0
20	35799889	.	A	T	11	13	24	0	1	25	0	0
20	35799913	.	T	G	11	7	18	0	0	18	0	0
20	35799931	.	A	T	16	4	20	0	0	20	0	0
20	35800098	.	G	A	14	18	32	0	1	33	0	0
20	35800338	.	T	G	7	3	10	0	0	10	0	0
20	35800349	.	C	T	8	5	13	0	2	15	0	0
20	35800520	.	G	A	10	8	18	0	0	18	0	0
20	35800557	.	G	A	11	7	18	0	0	18	0	0
20	35800564	.	T	C	10	5	15	0	0	15	0	0
20	35800749	.	G	A	7	7	14	0	0	14	0	0
20	35800848	.	T	C	5	5	10	0	0	10	0	0
20	35816533	.	A	G	6	7	13	0	0	13	0	0
20	35816534	.	A	G	6	7	13	0	0	13	0	0
20	35827930	.	A	G	3	4	7	0	0	7	0	0
20	35827945	.	G	C	4	3	7	0	0	7	0	0
20	35832179	.	G	A	7	2	9	0	0	9	0	0
20	35927851	.	A	G	2	2	4	0	0	4	0	0
20	35941146	.	G	A	0	3	3	0	2	5	0	0
20	35979899	.	G	T	3	7	10	0	0	10	0	0
20	35979910	.	T	G	3	7	10	0	0	10	0	0
20	35979983	.	G	C	3	2	5	0	0	5	0	0
20	36069265	.	C	T	0	2	2	0	2	4	0	0
20	36069601	.	C	T	1	2	3	0	0	3	0	0
20	36234084	.	C	A	8	4	12	0	0	12	0	0
20	36290217	.	C	T	6	9	15	0	1	16	0	0
20	36297356	.	G	A	2	12	14	0	17	31	0	0
20	36297418	.	C	A	13	11	24	0	1	25	0	0
20	36297871	.	A	T	12	11	23	0	1	24	0	0
20	36395748	.	C	T	1	2	3	0	0	3	0	0
20	36395801	.	A	C	3	2	5	0	0	5	0	0
20	36395895	.	G	A	2	4	6	0	0	6	0	0
20	36396098	.	G	A	3	2	5	0	0	5	0	0
20	36396668	.	A	G	3	3	6	0	1	7	0	0
20	36420218	.	A	C	13	15	28	1	2	31	0	0
20	36420713	.	C	T	1	15	16	0	16	32	0	0
20	36420753	.	T	A	11	18	29	0	2	31	0	0
20	36420804	.	G	T	18	13	31	0	1	32	0	0
20	36421219	.	G	A	23	4	27	0	2	29	0	0
20	36421238	.	C	T	16	12	28	0	4	32	0	0
20	36421530	.	A	C	13	0	13	0	17	30	0	0
20	36421757	.	C	T	1	7	8	0	11	19	0	0
20	36422098	.	C	A	12	16	28	0	3	32	1	0
20	36422146	.	G	C	23	14	37	0	0	37	0	0
20	36422291	.	G	T	11	13	24	0	1	25	0	0
20	36424252	.	T	C	13	8	21	0	0	21	0	0
20	36424273	.	G	A	11	11	22	0	2	24	0	0
20	36434308	.	A	G	12	8	20	0	1	21	0	0
20	36440170	.	C	T	2	7	9	0	14	23	0	0
20	36449286	.	G	A	8	9	17	0	0	17	0	0
20	36449385	.	C	T	10	6	16	0	2	18	0	0
20	36449442	.	A	C	12	13	25	0	0	25	0	0
20	36449601	.	C	T	7	9	16	0	0	16	0	0
20	36491016	.	T	C	10	8	18	0	0	18	0	0
20	36626195	.	A	G	15	0	15	0	16	31	0	0
20	36626218	.	C	T	14	14	28	0	1	29	0	0
20	36626248	.	G	A	12	14	26	0	0	26	0	0
20	36626335	.	C	T	12	8	20	0	1	21	0	0
20	36626354	.	C	A	13	10	23	0	0	23	0	0
20	36626465	.	C	T	9	3	12	0	0	12	0	0
20	36637604	.	T	A	3	14	17	0	0	17	0	0
20	36637657	.	A	C	3	9	12	0	2	14	0	0
20	36637829	.	T	C	3	4	7	0	0	7	0	0
20	36637999	.	G	A	4	7	11	0	0	11	0	0
20	36638033	.	G	T	5	6	11	0	1	12	0	0
20	36638138	.	C	G	3	11	14	0	0	14	0	0
20	36638169	.	T	C	2	8	10	0	1	11	0	0
20	36657824	.	C	T	1	3	4	0	0	4	0	0
20	36675294	.	G	C	7	1	8	0	11	19	0	0
20	36675456	.	G	A	9	7	16	0	0	16	0	0
20	36675468	.	C	T	8	7	15	0	0	15	0	0
20	36677457	.	C	T	6	7	13	0	0	13	0	0
20	36677574	.	G	A	9	9	18	0	1	19	0	0
20	36768736	.	T	C	1	2	3	0	0	3	0	0
20	36773807	.	A	G	3	3	6	0	0	6	0	0
20	36783480	.	C	T	6	6	12	0	0	12	0	0
20	36785477	.	G	A	2	2	4	0	2	6	0	0
20	36788775	.	C	T	6	4	10	0	0	10	0	0
20	36791885	.	C	T	7	9	16	0	1	17	0	0
20	36792123	.	T	C	5	5	10	0	0	10	0	0
20	36798128	.	T	A	2	2	4	0	0	4	0	0
20	36798154	.	C	G	3	2	5	0	1	6	0	0
20	36816471	.	G	A	7	3	10	0	0	10	0	0
20	36816961	.	A	C	2	2	4	0	0	4	0	0
20	36816972	.	C	T	2	2	4	0	0	4	0	0
20	36817184	.	G	A	0	3	3	0	7	10	0	0
20	36821214	.	A	G	11	4	15	0	2	17	0	0
20	36828833	.	T	C	7	3	10	0	0	10	0	0
20	36828948	.	A	C	5	5	10	0	0	10	0	0
20	36829040	.	T	C	10	11	21	0	1	22	0	0
20	36829208	.	T	C	8	8	16	0	0	16	0	0
20	36829517	.	T	G	7	1	8	0	8	16	0	0
20	36838717	.	C	T	5	4	9	0	2	11	0	0
20	36838805	.	C	T	5	4	9	0	1	10	0	0
20	36838871	.	C	T	5	12	17	0	1	18	0	0
20	36838896	.	A	G	5	9	14	0	1	15	0	0
20	36915481	.	G	A	13	4	17	0	1	18	0	0
20	36915529	.	G	A	15	10	25	0	0	25	0	0
20	36916004	.	G	A	11	17	28	0	1	29	0	0
20	36916050	.	A	G	8	11	19	0	0	19	0	0
20	36917631	.	C	T	8	7	15	1	0	16	0	0
20	37263668	.	C	A	4	2	6	0	0	6	0	0
20	37300862	.	G	C	1	4	5	0	5	10	0	0
20	37358885	.	G	A	0	11	11	0	13	24	0	0
20	37376467	.	G	A	0	4	4	0	9	13	0	0
20	37512259	.	G	A	17	18	35	0	0	35	0	0
20	37512503	.	T	G	1	4	5	0	0	5	0	0
20	37513257	.	C	A	22	21	43	0	0	43	0	0
20	37513632	.	A	G	33	27	60	0	4	64	0	0
20	37513702	.	G	A	27	34	61	0	2	63	0	0
20	37513753	.	G	T	31	25	56	0	4	60	0	0
20	37515525	.	G	T	17	22	39	0	0	39	0	0
20	37515607	.	T	G	17	15	32	0	0	32	0	0
20	37516363	.	C	T	21	21	42	0	2	45	1	0
20	37517962	.	T	C	23	0	23	0	11	34	0	0
20	37518718	.	A	T	12	4	16	0	3	19	0	0
20	37518823	.	A	G	13	8	21	0	1	22	0	0
20	37519399	.	G	A	12	8	20	0	1	21	0	0
20	37519429	.	A	T	7	7	14	0	2	16	0	0
20	37519453	.	G	T	3	7	10	0	1	11	0	0
20	37521010	.	T	C	5	0	5	0	7	12	0	0
20	37533137	.	C	T	3	2	5	0	0	5	0	0
20	37627953	.	G	A	3	2	5	0	0	5	0	0
20	37733712	.	A	G	1	4	5	0	0	5	0	0
20	37736409	.	T	G	12	11	23	0	0	23	0	0
20	37752042	.	A	T	4	2	6	0	0	6	0	0
20	37760614	.	C	A	4	4	8	0	0	8	0	0
20	37761205	.	C	T	6	3	9	0	0	9	0	0
20	37764120	.	A	G	2	0	2	0	3	5	0	0
20	37764309	.	C	G	6	3	9	0	0	9	0	0
20	37764500	.	C	A	5	2	7	0	0	7	0	0
20	37768543	.	G	A	15	10	25	0	0	25	0	0
20	37768621	.	C	T	9	14	23	0	0	23	0	0
20	37768627	.	T	A	10	12	22	0	1	23	0	0
20	37768844	.	G	T	4	9	13	0	1	15	1	0
20	37768862	.	T	C	4	10	14	0	0	14	0	0
20	37768997	.	A	T	7	6	13	0	1	14	0	0
20	37769084	.	A	G	4	6	10	0	1	11	0	0
20	37769099	.	C	A	2	6	8	0	0	8	0	0
20	37796387	.	T	C	1	4	5	0	0	5	0	0
20	37798805	.	A	G	4	2	6	0	2	8	0	0
20	37798860	.	A	C	3	4	7	0	0	7	0	0
20	37798912	.	G	A	5	3	8	0	1	9	0	0
20	37800100	.	A	C	3	4	7	0	1	8	0	0
20	37800368	.	G	A	2	2	4	0	0	4	0	0
20	37800379	.	T	C	2	4	6	0	0	6	0	0
20	37821047	.	A	G	3	1	4	0	0	4	0	0
20	37821053	.	G	A	3	2	5	0	0	5	0	0
20	37825839	.	C	T	1	4	5	0	0	5	0	0
20	37826103	.	A	G	2	0	2	0	3	5	0	0
20	37826815	.	G	C	1	2	3	0	0	3	0	0
20	37826820	.	A	T	2	1	3	0	0	3	0	0
20	37831776	.	T	C	2	3	5	0	0	5	0	0
20	37859577	.	T	C	6	11	17	0	1	18	0	0
20	37862414	.	T	C	5	3	8	0	1	9	0	0
20	37862466	.	C	G	4	2	6	0	0	6	0	0
20	37866514	.	C	T	6	3	9	0	0	9	0	0
20	37866655	.	A	G	2	3	5	0	1	6	0	0
20	37884692	.	A	G	6	0	6	0	6	12	0	0
20	37896247	.	T	C	7	5	12	0	0	12	0	0
20	37896256	.	T	C	6	4	10	0	0	10	0	0
20	37899220	.	A	G	10	8	18	0	1	19	0	0
20	37912862	.	C	G	8	3	11	0	1	12	0	0
20	37912863	.	C	A	7	4	11	0	0	11	0	0
20	37913335	.	A	T	9	3	12	0	1	13	0	0
20	37913410	.	A	C	2	4	6	0	0	6	0	0
20	37913552	.	T	C	1	1	2	0	0	2	0	0
20	37913572	.	A	T	1	5	6	0	0	6	0	0
20	37913752	.	T	C	8	4	12	0	0	12	0	0
20	37913866	.	A	G	3	9	12	0	0	12	0	0
20	37913988	.	T	G	12	5	17	0	1	18	0	0
20	37914001	.	A	G	12	9	21	0	0	21	0	0
20	37914025	.	A	G	12	0	12	0	8	20	0	0
20	37914048	.	G	C	11	4	15	0	2	17	0	0
20	37914145	.	C	T	7	5	12	0	0	12	0	0
20	37914395	.	A	G	2	5	7	0	1	8	0	0
20	37914517	.	C	T	9	3	12	0	0	12	0	0
20	37914651	.	C	T	8	4	12	0	0	12	0	0
20	37914668	.	G	T	9	4	13	0	0	13	0	0
20	37914709	.	A	C	7	8	15	0	1	16	0	0
20	37914722	.	C	T	9	8	17	0	0	17	0	0
20	37914750	.	C	A	10	8	18	0	2	20	0	0
20	37914855	.	T	G	7	16	23	0	2	25	0	0
20	37914913	.	A	G	13	14	27	0	1	28	0	0
20	37914924	.	T	C	14	14	28	0	0	28	0	0
20	37915005	.	A	C	6	5	11	0	2	13	0	0
20	37915027	.	C	T	8	4	12	0	0	12	0	0
20	37915080	.	T	A	12	6	18	0	1	19	0	0
20	37915097	.	C	G	12	7	19	0	0	19	0	0
20	37915237	.	C	T	10	3	13	0	2	15	0	0
20	37915292	.	A	G	7	5	12	0	3	15	0	0
20	37915465	.	A	G	11	0	11	0	9	20	0	0
20	37915619	.	T	G	5	13	18	0	0	18	0	0
20	37915733	.	C	T	6	5	11	1	0	12	0	0
20	37915859	.	C	T	6	6	12	0	6	18	0	0
20	37920726	.	A	G	5	5	10	0	1	11	0	0
20	37920773	.	T	C	9	4	13	0	1	14	0	0
20	37925455	.	A	C	6	5	11	0	0	11	0	0
20	37928465	.	C	T	0	3	3	0	7	10	0	0
20	37928510	.	C	G	6	5	11	0	0	11	0	0
20	37930514	.	C	G	6	3	9	0	0	9	0	0
20	37930593	.	A	G	3	2	5	0	0	5	0	0
20	37930672	.	C	G	1	3	4	0	0	4	0	0
20	37934024	.	G	A	1	2	3	0	0	3	0	0
20	38045859	.	G	T	4	9	13	0	0	13	0	0
20	38076127	.	G	A	0	3	3	0	3	6	0	0
20	38076495	.	G	A	4	7	11	0	0	11	0	0
20	38086653	.	A	G	7	10	17	0	2	19	0	0
20	38091814	.	C	T	9	5	14	0	2	16	0	0
20	38091838	.	G	A	5	9	14	0	0	14	0	0
20	38099500	.	C	T	11	11	22	0	2	24	0	0
20	38201945	.	T	G	1	2	3	0	0	3	0	0
20	38202064	.	G	A	0	2	2	0	2	4	0	0
20	38202135	.	G	T	2	2	4	0	0	4	0	0
20	38202228	.	T	C	1	3	4	0	0	4	0	0
20	38210484	.	C	T	5	2	7	0	0	7	0	0
20	38210544	.	C	T	5	3	8	0	1	9	0	0
20	38216798	.	C	T	5	2	7	0	1	8	0	0
20	38240907	.	G	A	7	12	19	0	1	20	0	0
20	38241264	.	C	T	1	5	6	0	1	7	0	0
20	38241357	.	T	C	3	3	6	0	0	6	0	0
20	38241363	.	T	A	3	3	6	0	0	6	0	0
20	38241484	.	T	A	4	2	6	0	1	7	0	0
20	38241567	.	T	A	1	6	7	0	1	8	0	0
20	38241685	.	T	A	5	2	7	0	0	7	0	0
20	38241757	.	G	T	1	2	3	0	0	3	0	0
20	38241825	.	T	G	4	3	7	0	0	7	0	0
20	38241843	.	A	G	3	4	7	0	0	7	0	0
20	38322489	.	C	T	2	2	4	0	0	4	0	0
20	38358534	.	T	C	6	9	15	0	0	15	0	0
20	38358657	.	A	C	9	6	15	0	1	16	0	0
20	38358691	.	G	A	9	7	16	0	0	16	0	0
20	38358752	.	C	T	5	8	13	0	0	13	0	0
20	38358755	.	G	C	1	8	9	0	4	13	0	0
20	38358866	.	T	C	6	3	9	0	0	9	0	0
20	38359137	.	A	T	2	1	3	0	0	3	0	0
20	38359152	.	C	T	4	2	6	0	0	6	0	0
20	38359181	.	T	C	4	5	9	0	0	9	0	0
20	38359258	.	G	A	5	5	10	0	0	10	0	0
20	38458149	.	C	T	2	3	5	0	0	5	0	0
20	38473763	.	T	C	11	8	19	0	1	20	0	0
20	38473805	.	A	T	6	12	18	0	0	18	0	0
20	38473817	.	C	T	11	5	16	0	0	16	0	0
20	38473886	.	T	C	4	8	12	0	1	13	0	0
20	38473940	.	T	G	10	1	11	0	7	18	0	0
20	38517640	.	C	T	11	16	27	0	2	29	0	0
20	38532334	.	C	T	2	2	4	0	1	5	0	0
20	38538098	.	G	C	1	5	6	0	0	6	0	0
20	38538248	.	C	T	9	3	12	0	2	14	0	0
20	38538249	.	G	A	4	9	13	0	0	13	0	0
20	38583632	.	G	A	0	3	3	0	1	4	0	0
20	38583911	.	A	T	2	2	4	0	0	4	0	0
20	38583935	.	G	A	2	1	3	0	1	4	0	0
20	38584035	.	C	T	4	2	6	0	0	6	0	0
20	38647270	.	T	A	1	3	4	0	0	4	0	0
20	38647369	.	T	C	8	4	12	0	1	13	0	0
20	38657825	.	T	C	9	6	15	0	0	15	0	0
20	38662649	.	A	G	10	10	20	0	0	20	0	0
20	38662697	.	G	T	9	10	19	0	0	19	0	0
20	38665194	.	G	A	10	8	18	0	1	19	0	0
20	38669294	.	T	C	8	16	24	0	1	25	0	0
20	38669329	.	A	G	4	2	6	0	11	17	0	0
20	38669406	.	C	A	3	4	7	0	0	7	0	0
20	38669453	.	C	G	3	5	8	0	0	8	0	0
20	38669562	.	C	T	2	7	9	1	0	10	0	0
20	38669869	.	T	G	5	3	8	0	0	8	0	0
20	38670071	.	C	T	8	3	11	0	2	13	0	0
20	38670100	.	C	T	3	9	12	0	0	12	0	0
20	38670108	.	T	C	5	7	12	0	1	13	0	0
20	38670143	.	C	T	16	4	20	0	2	22	0	0
20	38670157	.	G	A	1	6	7	0	11	18	0	0
20	38670397	.	C	T	2	2	4	0	0	4	0	0
20	38726253	.	A	G	16	17	33	0	2	35	0	0
20	38726283	.	C	T	14	6	20	0	0	24	4	0
20	38726399	.	A	C	11	14	25	0	0	25	0	0
20	38726624	.	C	G	10	10	20	0	2	22	0	0
20	38726664	.	C	T	12	9	21	0	1	22	0	0
20	38726721	.	C	A	7	9	16	0	1	17	0	0
20	38726935	.	C	T	13	10	23	0	0	23	0	0
20	38727047	.	A	G	12	12	24	0	0	24	0	0
20	38764192	.	C	A	26	12	38	0	0	38	0	0
20	38764201	.	C	A	26	13	39	0	0	39	0	0
20	38764265	.	A	G	17	10	27	0	0	27	0	0
20	38764992	.	T	C	14	8	22	0	1	23	0	0
20	38765100	.	C	T	1	8	9	0	9	18	0	0
20	38765296	.	T	G	16	2	18	0	0	18	0	0
20	38765318	.	T	C	14	6	20	0	0	20	0	0
20	38765364	.	T	A	12	11	23	0	1	24	0	0
20	38765552	.	C	T	1	13	14	0	8	22	0	0
20	38778463	.	G	A	9	7	16	0	1	17	0	0
20	38787014	.	T	A	14	7	21	0	1	22	0	0
20	38788676	.	C	T	2	6	8	0	0	8	0	0
20	38788749	.	A	C	6	3	9	0	0	9	0	0
20	38788887	.	G	A	7	5	12	0	2	14	0	0
20	38789855	.	T	C	2	13	15	0	0	15	0	0
20	38790051	.	C	T	1	5	6	0	18	24	0	0
20	38790283	.	A	G	3	12	15	0	0	15	0	0
20	38793405	.	G	A	8	7	15	0	0	15	0	0
20	38793414	.	C	T	0	8	8	0	9	17	0	0
20	38796487	.	C	T	1	2	3	0	0	3	0	0
20	38798501	.	A	C	10	12	22	0	0	22	0	0
20	38802704	.	A	G	4	6	10	0	0	10	0	0
20	38815968	.	C	A	2	2	4	0	0	4	0	0
20	38816028	.	G	A	3	5	8	0	0	8	0	0
20	38821208	.	C	T	1	2	3	0	1	4	0	0
20	38822655	.	T	A	1	3	4	0	0	4	0	0
20	38854164	.	C	T	1	2	3	0	0	3	0	0
20	38857772	.	C	T	1	2	3	0	0	3	0	0
20	38861536	.	T	C	2	6	8	0	0	8	0	0
20	38861646	.	T	C	3	6	9	0	0	9	0	0
20	38864559	.	A	G	4	4	8	0	0	8	0	0
20	38864684	.	A	G	5	3	8	0	0	8	0	0
20	38866779	.	T	C	3	2	5	0	0	5	0	0
20	38871129	.	A	G	2	4	6	0	1	7	0	0
20	38872436	.	T	C	10	4	14	0	1	15	0	0
20	38884042	.	C	T	3	7	10	0	0	10	0	0
20	38889148	.	C	T	6	7	13	0	0	13	0	0
20	38910374	.	A	G	15	8	23	0	0	23	0	0
20	39045960	.	A	T	7	10	17	0	1	19	1	0
20	39046032	.	T	C	6	6	12	0	0	12	0	0
20	39052063	.	A	T	11	6	17	0	2	19	0	0
20	39052100	.	T	A	19	11	30	0	3	33	0	0
20	39052254	.	C	T	3	16	19	0	27	46	0	0
20	39052505	.	C	A	17	18	35	0	0	35	0	0
20	39055706	.	T	A	8	6	14	0	0	14	0	0
20	39055731	.	G	T	10	4	14	0	2	16	0	0
20	39055868	.	T	A	10	11	21	0	1	22	0	0
20	39081196	.	A	G	9	8	17	0	2	19	0	0
20	39081322	.	C	T	5	11	16	0	0	16	0	0
20	39190930	.	C	A	1	3	4	0	0	4	0	0
20	39191097	.	G	T	4	4	8	0	0	8	0	0
20	39191098	.	T	A	4	4	8	0	0	8	0	0
20	39191354	.	T	C	6	5	11	0	0	11	0	0
20	39191708	.	C	T	5	8	13	0	0	13	0	0
20	39210086	.	C	T	0	7	7	0	2	9	0	0
20	39254961	.	A	G	4	0	4	0	9	13	0	0
20	39256320	.	G	A	4	4	8	0	1	9	0	0
20	39256515	.	A	G	7	4	11	0	0	11	0	0
20	39256735	.	G	A	0	5	5	0	7	12	0	0
20	39256968	.	C	T	5	4	9	0	2	11	0	0
20	39260481	.	T	A	1	5	6	0	0	6	0	0
20	39260535	.	C	T	2	2	4	0	7	11	0	0
20	39260578	.	C	T	9	3	12	0	1	13	0	0
20	39260755	.	C	T	24	31	55	0	6	61	0	0
20	39260837	.	G	A	19	39	58	0	0	58	0	0
20	39260865	.	T	G	24	37	61	0	1	63	1	0
20	39267227	.	T	G	23	15	38	0	2	40	0	0
20	39271725	.	T	C	12	22	34	0	1	35	0	0
20	39271731	.	G	A	21	14	35	0	3	38	0	0
20	39271833	.	C	G	12	21	33	0	0	33	0	0
20	39273910	.	A	T	14	11	25	0	6	31	0	0
20	39338845	.	C	T	4	3	7	0	0	7	0	0
20	39338929	.	C	T	7	3	10	0	0	10	0	0
20	39338965	.	T	C	8	5	13	0	1	14	0	0
20	39338981	.	G	T	10	9	19	0	1	20	0	0
20	39339030	.	T	C	10	9	19	0	0	19	0	0
20	39339169	.	A	G	7	10	17	0	0	17	0	0
20	39341517	.	G	A	14	8	22	0	0	22	0	0
20	39341520	.	T	C	14	7	21	0	2	23	0	0
20	39343397	.	T	C	2	6	8	0	0	8	0	0
20	39344011	.	C	A	1	4	5	0	1	6	0	0
20	39344085	.	T	C	8	9	17	0	0	17	0	0
20	39520835	.	T	C	3	4	7	0	0	7	0	0
20	39520942	.	C	A	7	3	10	0	0	10	0	0
20	39557001	.	A	G	2	3	5	0	0	5	0	0
20	39589080	.	A	T	1	3	4	0	0	4	0	0
20	39689513	.	T	C	5	3	8	0	1	9	0	0
20	39692392	.	T	G	2	2	4	0	0	4	0	0
20	39692433	.	C	A	2	2	4	0	0	4	0	0
20	39692831	.	C	T	3	2	5	0	0	5	0	0
20	39807080	.	G	A	3	3	6	0	0	6	0	0
20	40269926	.	T	C	7	0	7	1	11	19	0	0
20	40319649	.	C	G	4	4	8	0	1	9	0	0
20	40369463	.	C	A	2	2	4	0	0	4	0	0
20	40372729	.	G	A	16	14	30	0	0	30	0	0
20	40372760	.	T	A	13	17	30	0	2	32	0	0
20	40372811	.	A	G	18	15	33	0	0	33	0	0
20	40457669	.	G	C	15	7	22	0	1	23	0	0
20	40461550	.	G	A	9	14	23	0	1	24	0	0
20	40464613	.	C	G	15	13	28	0	2	30	0	0
20	40466540	.	C	T	30	16	46	0	3	49	0	0
20	40466662	.	C	T	26	24	50	0	4	54	0	0
20	40467044	.	C	T	39	20	59	0	1	60	0	0
20	40471756	.	A	T	43	30	73	0	3	76	0	0
20	40471844	.	C	T	24	20	44	1	3	48	0	0
20	40471886	.	T	A	15	19	34	1	6	41	0	0
20	40472009	.	T	A	34	33	67	0	2	69	0	0
20	40472075	.	C	A	27	36	63	2	2	67	0	0
20	40472175	.	G	C	37	31	68	2	2	72	0	0
20	40472409	.	A	G	0	10	10	0	0	10	0	0
20	40475815	.	C	T	9	7	16	0	3	19	0	0
20	40475872	.	G	A	8	14	22	0	2	24	0	0
20	40476094	.	G	A	15	7	22	0	3	25	0	0
20	40476165	.	C	T	22	16	38	0	1	39	0	0
20	40476214	.	A	T	22	20	42	0	4	47	1	0
20	40478035	.	G	A	16	14	30	0	1	31	0	0
20	40478289	.	A	C	15	12	27	0	2	29	0	0
20	40480227	.	G	T	14	13	27	0	0	27	0	0
20	40480250	.	C	T	14	17	31	0	1	32	0	0
20	40715260	.	A	G	18	25	43	0	3	46	0	0
20	40716123	.	A	G	6	14	20	0	14	34	0	0
20	40716124	.	C	A	22	7	29	0	5	34	0	0
20	40716899	.	G	A	25	22	47	0	3	50	0	0
20	40716911	.	A	G	27	25	52	0	2	54	0	0
20	40717271	.	G	T	15	11	26	0	3	29	0	0
20	40717418	.	G	A	9	8	17	0	0	17	0	0
20	40717691	.	G	A	6	2	8	0	0	8	0	0
20	40762073	.	A	G	2	3	5	0	0	5	0	0
20	40762361	.	T	C	4	3	7	0	1	8	0	0
20	40762505	.	G	T	2	2	4	0	0	4	0	0
20	40763990	.	T	C	4	2	6	0	0	6	0	0
20	40764004	.	G	A	3	2	5	0	0	5	0	0
20	40804683	.	C	A	1	2	3	0	0	3	0	0
20	40835131	.	A	G	11	6	17	0	0	17	0	0
20	40840802	.	G	A	13	4	17	0	0	17	0	0
20	40840963	.	A	C	6	4	10	0	1	11	0	0
20	41236764	.	G	A	1	6	7	0	6	13	0	0
20	41237731	.	G	A	4	2	6	1	0	7	0	0
20	41238925	.	G	A	2	2	4	0	0	4	0	0
20	41239038	.	T	C	6	6	12	0	1	13	0	0
20	41239110	.	G	A	0	4	4	0	2	6	0	0
20	41239396	.	T	A	3	7	10	0	0	10	0	0
20	41239399	.	A	G	3	7	10	0	0	10	0	0
20	41239439	.	T	C	7	5	12	0	3	15	0	0
20	41239461	.	C	T	9	9	18	0	2	20	0	0
20	41239604	.	C	T	11	6	17	0	1	18	0	0
20	41239624	.	G	A	13	7	20	0	0	20	0	0
20	41239753	.	G	T	1	10	11	0	7	18	0	0
20	41239760	.	G	A	1	10	11	0	8	19	0	0
20	41239838	.	A	G	3	5	8	0	0	8	0	0
20	41239899	.	G	T	4	6	10	0	3	13	0	0
20	41239916	.	A	T	4	4	8	0	2	11	1	0
20	41239946	.	A	G	11	5	16	0	1	17	0	0
20	41239977	.	T	C	7	6	13	0	0	13	0	0
20	41239992	.	T	C	7	5	12	0	0	12	0	0
20	41240107	.	G	C	7	4	11	0	2	13	0	0
20	41240108	.	A	G	7	0	7	0	6	13	0	0
20	41240148	.	A	G	5	0	5	0	4	9	0	0
20	41240480	.	A	G	8	0	8	0	9	17	0	0
20	41240512	.	A	C	7	8	15	0	1	16	0	0
20	41240643	.	G	A	0	4	4	0	4	8	0	0
20	41240736	.	T	C	3	10	13	0	0	13	0	0
20	41240958	.	A	G	10	13	23	0	0	23	0	0
20	41240986	.	A	G	9	0	9	0	15	24	0	0
20	41241316	.	G	C	16	6	22	0	0	22	0	0
20	41241350	.	C	A	15	10	25	0	0	25	0	0
20	41241355	.	C	T	15	9	24	0	1	25	0	0
20	41241443	.	A	C	6	7	13	0	0	13	0	0
20	41242045	.	G	A	1	18	19	0	12	31	0	0
20	41640701	.	A	C	8	13	21	0	0	21	0	0
20	41640743	.	G	A	8	12	20	0	0	20	0	0
20	41640878	.	T	G	5	6	11	0	0	11	0	0
20	41640903	.	T	C	5	5	10	0	0	10	0	0
20	41640917	.	A	G	4	8	12	0	0	12	0	0
20	41641019	.	A	T	12	6	18	0	0	18	0	0
20	41643457	.	C	T	9	8	17	0	0	17	0	0
20	41651639	.	C	T	9	8	17	0	0	17	0	0
20	41655513	.	G	A	3	7	10	0	11	21	0	0
20	41689967	.	A	G	15	15	30	0	0	30	0	0
20	41689979	.	C	T	16	12	28	0	1	29	0	0
20	41734344	.	C	T	8	13	21	0	3	24	0	0
20	41757835	.	A	G	18	7	25	1	1	27	0	0
20	41765105	.	T	C	15	17	32	0	2	34	0	0
20	41838726	.	C	A	2	2	4	0	0	4	0	0
20	41838965	.	G	A	0	3	3	0	1	4	0	0
20	41838992	.	T	A	1	2	3	0	0	3	0	0
20	41926416	.	G	A	1	3	4	0	0	4	0	0
20	41946745	.	A	G	4	2	6	0	2	8	0	0
20	41949354	.	G	T	1	4	5	0	3	8	0	0
20	41949355	.	C	T	4	4	8	0	0	8	0	0
20	41949408	.	G	A	4	3	7	0	0	7	0	0
20	41949432	.	C	T	3	2	5	0	0	5	0	0
20	41960702	.	G	A	1	2	3	0	2	5	0	0
20	41961012	.	A	T	1	1	2	0	1	3	0	0
20	41961043	.	G	A	3	2	5	0	0	5	0	0
20	41961076	.	G	A	6	3	9	0	0	9	0	0
20	41961113	.	C	T	7	2	9	0	1	10	0	0
20	41961220	.	A	C	0	5	5	0	0	5	0	0
20	41961229	.	A	T	2	4	6	0	0	6	0	0
20	41961283	.	A	G	1	0	1	0	4	5	0	0
20	41961287	.	T	C	1	4	5	0	0	5	0	0
20	41961779	.	C	T	5	2	7	0	1	8	0	0
20	41961880	.	G	A	2	2	4	0	1	5	0	0
20	41961909	.	A	T	4	3	7	0	0	7	0	0
20	41962523	.	A	G	3	0	3	0	4	7	0	0
20	41962677	.	C	G	5	0	5	0	6	11	0	0
20	41962872	.	A	G	7	4	11	0	1	12	0	0
20	41962923	.	A	T	5	4	9	1	1	11	0	0
20	41963188	.	G	A	3	6	9	0	0	9	0	0
20	41963398	.	T	G	4	6	10	0	0	10	0	0
20	41963451	.	G	A	0	5	5	0	5	10	0	0
20	41963530	.	A	G	3	7	10	0	0	10	0	0
20	41963652	.	C	T	8	4	12	1	1	14	0	0
20	41963660	.	C	T	10	2	12	1	0	13	0	0
20	41998601	.	C	G	14	7	21	0	1	22	0	0
20	41999025	.	C	A	14	5	19	0	1	20	0	0
20	41999046	.	G	A	10	6	16	0	2	18	0	0
20	41999106	.	A	G	11	6	17	1	0	19	1	0
20	42047386	.	C	T	3	9	12	0	1	13	0	0
20	42203465	.	T	C	13	11	24	0	0	24	0	0
20	42221387	.	A	T	2	3	5	0	0	5	0	0
20	42221710	.	C	T	9	12	21	0	3	24	0	0
20	42221713	.	C	T	7	12	19	0	2	21	0	0
20	42222444	.	A	T	5	3	8	0	1	9	0	0
20	42222546	.	A	T	5	9	14	0	0	14	0	0
20	42222549	.	A	T	5	10	15	0	0	15	0	0
20	42222621	.	T	C	11	6	17	0	0	17	0	0
20	42222770	.	T	C	3	5	8	0	2	10	0	0
20	42222816	.	C	A	4	8	12	0	0	12	0	0
20	42223350	.	A	T	2	4	6	0	0	6	0	0
20	42232554	.	A	G	5	7	12	0	0	12	0	0
20	42241224	.	T	G	5	2	7	0	0	8	1	0
20	42241254	.	A	T	9	7	16	0	0	16	0	0
20	42241367	.	C	T	0	3	3	0	2	5	0	0
20	42246990	.	C	T	1	4	5	0	0	5	0	0
20	42247180	.	T	C	5	2	7	0	0	7	0	0
20	42275414	.	C	T	8	4	12	0	2	14	0	0
20	42275441	.	G	A	1	10	11	0	8	19	0	0
20	42278043	.	C	T	11	3	14	0	0	14	0	0
20	42280829	.	C	T	7	4	11	0	0	11	0	0
20	42281248	.	T	G	5	3	8	0	1	9	0	0
20	42281369	.	G	A	7	10	17	0	0	17	0	0
20	42281383	.	C	T	9	11	20	0	0	20	0	0
20	42296893	.	C	G	1	7	8	0	0	8	0	0
20	42297038	.	C	T	3	2	5	0	2	7	0	0
20	42297042	.	T	C	3	0	3	0	3	6	0	0
20	42297080	.	T	A	4	3	7	0	0	7	0	0
20	42297131	.	T	A	3	3	6	0	0	6	0	0
20	42297133	.	T	A	2	3	5	0	1	6	0	0
20	42298548	.	T	C	2	2	4	0	0	4	0	0
20	42617167	.	C	G	1	2	3	0	0	3	0	0
20	42624383	.	G	C	2	2	4	0	0	4	0	0
20	42624385	.	G	A	0	2	2	0	2	4	0	0
20	42629329	.	C	T	2	2	4	0	0	4	0	0
20	43120256	.	T	G	11	6	17	0	0	17	0	0
20	43122921	.	G	T	2	18	20	0	2	22	0	0
20	43122925	.	T	G	3	19	22	0	1	23	0	0
20	43917422	.	A	T	0	2	2	0	1	3	0	0
20	43917468	.	A	G	2	2	4	0	0	4	0	0
20	43917559	.	A	G	1	4	5	0	0	5	0	0
20	43917616	.	A	C	4	4	8	0	0	8	0	0
20	43917617	.	C	A	3	4	7	0	1	8	0	0
20	43964125	.	G	T	1	2	3	0	0	3	0	0
20	43996111	.	A	T	1	2	3	0	0	3	0	0
20	44372854	.	G	C	6	4	10	0	0	10	0	0
20	44372902	.	A	T	10	9	19	0	2	21	0	0
20	44373336	.	G	A	21	17	38	1	2	41	0	0
20	44373378	.	A	G	17	21	38	1	0	39	0	0
20	44386501	.	A	G	20	18	38	1	1	40	0	0
20	44386556	.	C	T	22	12	34	1	3	38	0	0
20	44386562	.	G	T	23	11	34	1	2	37	0	0
20	44389647	.	G	A	15	14	29	0	0	29	0	0
20	44402797	.	C	T	13	13	26	0	0	26	0	0
20	44447798	.	G	T	12	12	24	0	1	25	0	0
20	44451262	.	G	A	6	8	14	0	0	14	0	0
20	44457278	.	C	T	8	2	10	0	0	10	0	0
20	44457311	.	G	C	5	0	5	0	7	12	0	0
20	44457314	.	A	G	6	5	11	0	1	12	0	0
20	44457593	.	C	T	10	3	13	0	0	13	0	0
20	44457595	.	G	T	3	9	12	0	0	12	0	0
20	44457659	.	A	T	7	4	11	0	0	11	0	0
20	44464502	.	G	T	7	3	10	0	1	11	0	0
20	44464579	.	T	C	12	8	20	0	0	20	0	0
20	44464835	.	C	G	18	5	23	0	1	24	0	0
20	44464875	.	G	T	13	11	24	0	0	24	0	0
20	44465778	.	G	T	18	26	44	1	3	48	0	0
20	44505956	.	G	A	3	2	5	0	0	5	0	0
20	44505971	.	T	G	2	2	4	0	0	4	0	0
20	44518070	.	G	T	3	2	5	0	0	5	0	0
20	44523296	.	A	G	3	3	6	0	0	6	0	0
20	44566955	.	T	G	12	10	22	0	1	23	0	0
20	44567001	.	G	A	12	9	21	0	1	22	0	0
20	44567107	.	T	C	9	9	18	0	3	21	0	0
20	45040929	.	T	C	4	0	4	0	15	19	0	0
20	45057888	.	C	T	2	3	5	0	1	6	0	0
20	45406997	.	T	C	7	12	19	0	0	19	0	0
20	45408047	.	T	C	9	7	16	0	3	19	0	0
20	45408436	.	G	A	3	5	8	0	5	13	0	0
20	45644152	.	G	C	11	9	20	1	1	22	0	0
20	45644163	.	G	T	9	10	19	1	2	22	0	0
20	45645392	.	G	A	12	11	23	0	0	23	0	0
20	45649379	.	C	T	0	11	11	0	10	21	0	0
20	45661000	.	C	T	3	4	7	0	0	7	0	0
20	45669353	.	C	T	2	9	11	0	21	32	0	0
20	45679302	.	T	G	5	10	15	0	0	15	0	0
20	45679303	.	T	A	5	10	15	0	0	15	0	0
20	45682240	.	A	C	6	8	14	0	0	14	0	0
20	45685823	.	T	A	7	3	10	0	1	11	0	0
20	45689866	.	G	A	2	8	10	0	0	10	0	0
20	45689951	.	A	G	2	7	9	0	0	9	0	0
20	45692585	.	G	A	7	4	11	0	0	11	0	0
20	45692624	.	C	T	9	2	11	0	0	11	0	0
20	45698216	.	C	A	6	6	12	0	0	12	0	0
20	45708968	.	A	G	5	4	9	0	0	9	0	0
20	45741592	.	C	A	3	6	9	0	0	9	0	0
20	45742077	.	A	G	9	4	13	0	1	14	0	0
20	45742126	.	C	T	15	7	22	0	0	22	0	0
20	45745523	.	C	T	10	4	14	0	2	16	0	0
20	45746063	.	C	T	14	12	26	0	0	26	0	0
20	45746064	.	A	G	14	12	26	0	0	26	0	0
20	45746150	.	G	A	13	6	19	0	1	20	0	0
20	45746297	.	C	T	18	7	25	0	0	25	0	0
20	45746524	.	T	A	17	14	31	0	1	32	0	0
20	45746567	.	C	T	18	18	36	0	0	36	0	0
20	45746588	.	C	A	14	18	32	0	1	33	0	0
20	45746674	.	C	A	14	22	36	0	1	37	0	0
20	45746678	.	C	T	17	22	39	0	1	40	0	0
20	45746936	.	C	G	15	11	26	0	2	28	0	0
20	45746977	.	G	A	3	9	12	0	26	38	0	0
20	45746978	.	A	C	26	9	35	0	2	37	0	0
20	45747032	.	G	C	3	13	16	0	31	47	0	0
20	45751466	.	G	A	12	17	29	0	2	31	0	0
20	45751526	.	T	G	17	18	35	0	0	35	0	0
20	45751561	.	G	C	1	15	16	0	18	34	0	0
20	45751563	.	T	C	12	20	32	0	2	34	0	0
20	45751668	.	G	A	5	11	16	1	0	17	0	0
20	45751989	.	T	A	4	8	12	0	2	14	0	0
20	45754378	.	C	G	1	2	3	0	0	3	0	0
20	45759508	.	G	A	0	2	2	0	1	3	0	0
20	45759989	.	T	C	1	3	4	0	0	4	0	0
20	45759994	.	G	T	1	3	4	0	0	4	0	0
20	45763038	.	T	C	3	2	5	0	0	5	0	0
20	45764707	.	C	T	2	6	8	0	0	8	0	0
20	45766438	.	C	G	4	2	6	0	0	6	0	0
20	45769421	.	C	A	0	3	3	0	1	4	0	0
20	45893237	.	C	T	2	2	4	0	0	4	0	0
20	45898667	.	C	T	2	2	4	0	0	4	0	0
20	46352444	.	G	C	3	3	6	0	0	6	0	0
20	46352460	.	A	T	5	2	7	0	0	7	0	0
20	46353099	.	G	T	2	3	5	0	1	6	0	0
20	46353428	.	C	T	3	2	5	0	1	6	0	0
20	46357199	.	C	G	1	2	3	0	0	3	0	0
20	46357298	.	T	G	5	3	8	0	0	8	0	0
20	46357333	.	C	A	0	4	4	0	4	8	0	0
20	46435243	.	G	A	2	3	5	0	0	5	0	0
20	46441564	.	T	G	1	4	5	0	0	5	0	0
20	46441612	.	G	A	0	8	8	0	1	9	0	0
20	46441627	.	C	T	1	8	9	0	0	9	0	0
20	46441695	.	G	C	1	6	7	0	0	7	0	0
20	46442459	.	A	G	7	8	15	0	0	15	0	0
20	46451592	.	G	A	12	11	23	0	1	24	0	0
20	46451910	.	A	G	13	14	27	0	1	28	0	0
20	46463315	.	T	A	14	8	22	0	1	23	0	0
20	46466920	.	G	A	8	7	15	0	0	15	0	0
20	46466934	.	G	T	7	10	17	0	0	17	0	0
20	46492305	.	A	C	3	3	6	0	0	6	0	0
20	46502505	.	C	T	6	6	12	0	0	12	0	0
20	46502535	.	C	A	6	7	13	0	0	13	0	0
20	46506203	.	T	A	6	4	10	0	1	11	0	0
20	46508767	.	C	T	8	7	15	0	0	15	0	0
20	46515625	.	G	A	4	4	8	0	1	9	0	0
20	46517286	.	C	G	6	12	18	0	1	19	0	0
20	46519148	.	T	A	7	4	11	0	2	13	0	0
20	46522932	.	G	A	3	4	7	0	3	10	0	0
20	46523196	.	G	A	8	9	17	0	0	17	0	0
20	46528709	.	A	G	10	10	20	0	0	20	0	0
20	46533981	.	T	G	7	7	14	0	1	15	0	0
20	46536936	.	G	T	20	19	39	0	1	40	0	0
20	46536981	.	C	T	12	30	42	0	1	43	0	0
20	46537039	.	A	T	20	24	44	0	0	44	0	0
20	46537143	.	A	T	26	21	47	0	2	49	0	0
20	46537239	.	C	T	17	16	33	0	6	39	0	0
20	46537404	.	G	A	12	9	21	0	1	22	0	0
20	46537563	.	A	G	17	24	41	0	2	43	0	0
20	46537636	.	G	A	21	14	35	1	1	37	0	0
20	46539619	.	A	G	20	19	39	0	1	40	0	0
20	46540898	.	A	G	19	15	34	0	0	34	0	0
20	46552431	.	C	T	2	14	16	0	13	29	0	0
20	46552965	.	G	T	33	29	62	0	1	63	0	0
20	46552966	.	G	T	35	29	64	0	1	65	0	0
20	46553995	.	T	A	3	2	5	0	0	5	0	0
20	46594450	.	A	G	1	2	3	0	0	3	0	0
20	46620445	.	A	T	1	5	6	0	1	7	0	0
20	46620458	.	A	G	1	1	2	0	1	3	0	0
20	46646259	.	G	A	1	4	5	0	0	5	0	0
20	46646313	.	C	T	4	2	6	0	0	6	0	0
20	46646403	.	T	C	5	4	9	0	0	9	0	0
20	46733096	.	C	T	8	3	11	0	4	15	0	0
20	48043470	.	A	G	1	6	7	0	0	7	0	0
20	48483088	.	A	C	2	2	4	2	1	7	0	0
20	48483164	.	A	G	7	1	8	0	0	8	0	0
20	48483184	.	T	A	5	4	9	0	0	9	0	0
20	48483921	.	C	G	2	4	6	0	0	6	0	0
20	48484411	.	A	C	3	0	3	0	3	6	0	0
20	48598493	.	C	T	4	15	19	0	0	19	0	0
20	48785457	.	T	C	1	2	3	0	0	3	0	0
20	48806088	.	A	G	3	6	9	0	0	9	0	0
20	48844050	.	T	C	13	0	13	0	18	31	0	0
20	48844134	.	A	G	16	11	27	0	0	27	0	0
20	48844259	.	G	T	21	6	27	0	1	28	0	0
20	48844295	.	C	T	1	7	8	0	25	33	0	0
20	48845298	.	A	G	15	12	27	0	1	28	0	0
20	48860755	.	G	A	4	3	7	0	0	7	0	0
20	48869895	.	G	A	6	9	15	0	1	16	0	0
20	48877311	.	G	T	5	7	12	0	1	13	0	0
20	48877475	.	G	A	4	6	10	0	0	10	0	0
20	48886005	.	C	T	2	7	9	0	0	9	0	0
20	48895103	.	G	A	6	8	14	0	0	14	0	0
20	49082581	.	C	T	3	3	6	0	0	6	0	0
20	49085648	.	G	A	3	3	6	0	1	7	0	0
20	49087720	.	A	G	3	1	4	0	2	6	0	0
20	49087762	.	G	A	0	4	4	0	3	7	0	0
20	49087768	.	G	A	3	3	6	0	0	6	0	0
20	49087816	.	G	T	3	1	4	0	2	6	0	0
20	49089192	.	T	C	7	3	10	0	1	11	0	0
20	49089237	.	C	T	8	3	11	0	1	12	0	0
20	49094970	.	C	T	4	5	9	0	2	11	0	0
20	49094973	.	T	C	6	5	11	0	0	11	0	0
20	49100237	.	C	T	10	6	16	0	0	16	0	0
20	49103131	.	G	A	10	10	20	0	1	21	0	0
20	49103164	.	G	A	8	8	16	0	1	17	0	0
20	49103217	.	A	T	5	2	7	0	0	7	0	0
20	49105469	.	A	T	3	3	6	0	0	6	0	0
20	49719213	.	T	C	2	0	2	0	5	7	0	0
20	49726499	.	C	T	1	2	3	0	0	3	0	0
20	50238558	.	G	A	3	2	5	0	1	6	0	0
20	50238657	.	A	G	4	2	6	0	0	6	0	0
20	50238672	.	A	G	5	2	7	0	1	8	0	0
20	50238717	.	G	A	4	2	6	0	0	6	0	0
20	50650253	.	G	A	0	2	2	0	2	4	0	0
20	50725479	.	G	A	0	4	4	0	1	5	0	0
20	50740230	.	G	T	1	4	5	0	4	9	0	0
20	50898883	.	T	C	9	7	16	0	0	16	0	0
20	50917646	.	T	C	7	5	12	0	1	13	0	0
20	50921211	.	T	C	8	10	18	0	1	19	0	0
20	50923848	.	G	A	12	12	24	0	0	24	0	0
20	50926713	.	A	G	14	0	14	0	12	26	0	0
20	50998422	.	G	A	8	4	12	0	0	12	0	0
20	51481811	.	G	A	1	2	3	0	0	3	0	0
20	51481818	.	A	C	1	2	3	0	0	3	0	0
20	51647926	.	T	C	3	8	11	0	0	11	0	0
20	51647927	.	T	C	3	7	10	0	1	11	0	0
20	51749045	.	A	G	14	9	23	1	2	26	0	0
20	51749074	.	C	T	14	6	20	0	0	20	0	0
20	51758602	.	A	C	7	19	26	0	3	29	0	0
20	52333070	.	A	G	2	7	9	0	0	9	0	0
20	52540721	.	A	G	0	8	8	0	1	9	0	0
20	52907598	.	T	C	1	0	1	0	5	6	0	0
20	53069778	.	C	T	0	12	12	0	9	21	0	0
20	53069784	.	G	A	10	15	25	0	0	25	0	0
20	53074615	.	T	C	3	0	3	0	6	9	0	0
20	53183510	.	C	T	5	4	9	0	1	10	0	0
20	53224585	.	A	G	6	4	10	0	0	10	0	0
20	53312604	.	G	T	12	9	21	0	1	22	0	0
20	53318814	.	G	T	7	10	17	0	0	17	0	0
20	53318884	.	C	T	1	9	10	0	8	18	0	0
20	53365862	.	C	T	2	4	6	2	2	10	0	0
20	53366073	.	A	C	2	5	7	0	0	7	0	0
20	53377661	.	A	G	3	0	3	0	5	8	0	0
20	53377691	.	G	A	3	2	5	0	0	5	0	0
20	53378919	.	T	G	4	0	4	0	3	7	0	0
20	53393594	.	T	C	10	6	16	0	0	16	0	0
20	53393669	.	C	A	7	11	18	0	0	18	0	0
20	53398784	.	T	A	10	9	19	0	1	20	0	0
20	53401771	.	T	C	13	7	20	0	0	20	0	0
20	53401778	.	A	G	10	5	15	0	2	17	0	0
20	53422244	.	G	T	1	2	3	0	0	3	0	0
20	53601590	.	G	A	1	2	3	0	0	3	0	0
20	53601608	.	C	T	1	2	3	0	0	3	0	0
20	53601677	.	T	C	2	0	2	0	2	4	0	0
20	53635042	.	T	C	1	1	2	0	1	3	0	0
20	53637818	.	C	T	1	4	5	0	0	5	0	0
20	53639152	.	C	T	2	2	4	0	1	5	0	0
20	53639462	.	T	C	2	5	7	0	0	7	0	0
20	53639876	.	T	C	1	3	4	0	0	4	0	0
20	53803637	.	C	T	9	3	12	0	0	12	0	0
20	53803783	.	T	A	16	6	22	0	1	23	0	0
20	53804306	.	A	G	9	6	15	0	1	16	0	0
20	53804342	.	A	G	8	4	12	0	2	14	0	0
20	53804439	.	A	G	8	8	16	0	0	16	0	0
20	53804470	.	G	A	12	11	23	0	0	23	0	0
20	53804618	.	G	C	10	4	14	0	0	14	0	0
20	53810197	.	A	T	18	12	30	0	0	30	0	0
20	53810395	.	G	A	9	2	11	0	4	15	0	0
20	53810419	.	A	G	5	4	9	0	3	12	0	0
20	53898735	.	T	A	19	16	35	0	3	38	0	0
20	53898770	.	C	T	2	17	19	0	22	41	0	0
20	53898930	.	G	A	2	12	14	0	2	16	0	0
20	53899023	.	G	C	9	25	34	0	0	34	0	0
20	53899035	.	G	A	11	25	36	0	2	38	0	0
20	53901183	.	A	G	4	2	6	2	1	9	0	0
20	53902151	.	G	A	2	7	9	0	0	9	0	0
20	53902155	.	G	C	2	5	7	0	1	8	0	0
20	53912151	.	T	C	3	1	4	0	9	13	0	0
20	53912208	.	C	T	0	8	8	0	5	13	0	0
20	53921147	.	T	C	4	9	13	0	0	13	0	0
20	53928363	.	T	C	1	0	1	0	4	5	0	0
20	53930457	.	G	A	1	7	8	0	1	9	0	0
20	53930466	.	C	T	0	4	4	0	2	6	0	0
20	53968105	.	A	G	27	30	57	0	2	59	0	0
20	53983510	.	T	G	1	3	4	0	0	4	0	0
20	53983516	.	T	C	1	3	4	0	0	4	0	0
20	54048078	.	T	C	2	2	4	0	0	4	0	0
20	54050531	.	A	G	2	0	2	0	2	4	0	0
20	54050873	.	A	G	4	4	8	0	0	8	0	0
20	54050877	.	T	A	3	4	7	0	0	7	0	0
20	54051096	.	T	G	1	0	1	0	2	3	0	0
20	54067345	.	A	G	11	5	16	0	1	17	0	0
20	54067399	.	G	A	9	5	14	0	1	15	0	0
20	54067414	.	G	A	9	5	14	0	0	14	0	0
20	54067714	.	A	G	9	10	19	0	0	19	0	0
20	54085851	.	T	C	30	24	54	0	3	57	0	0
20	54175011	.	A	G	1	2	3	0	0	3	0	0
20	54175527	.	A	G	4	2	6	0	0	6	0	0
20	54197221	.	A	C	19	1	20	0	17	37	0	0
20	54197287	.	A	T	19	18	37	0	0	37	0	0
20	54197383	.	G	A	14	12	26	0	0	26	0	0
20	54197473	.	A	G	10	17	27	0	0	27	0	0
20	54197485	.	C	T	1	16	17	0	12	29	0	0
20	54197751	.	A	G	10	10	20	0	1	21	0	0
20	54197752	.	G	A	10	11	21	0	0	21	0	0
20	54205704	.	C	T	32	34	66	0	3	69	0	0
20	54215073	.	C	A	12	6	18	0	0	18	0	0
20	54215081	.	T	C	13	0	13	0	6	19	0	0
20	54215133	.	A	C	10	8	18	0	1	19	0	0
20	54219286	.	T	C	27	0	27	0	28	55	0	0
20	54228003	.	A	T	29	26	55	0	1	56	0	0
20	54233207	.	T	C	12	1	13	0	17	30	0	0
20	54235969	.	G	A	18	12	30	0	1	31	0	0
20	54236421	.	A	C	16	11	27	0	1	28	0	0
20	54236423	.	G	A	17	11	28	0	0	28	0	0
20	54249577	.	G	C	18	18	36	0	4	40	0	0
20	54251406	.	T	C	25	19	44	0	0	44	0	0
20	54274561	.	G	A	5	10	15	0	2	17	0	0
20	54277241	.	A	C	13	9	22	0	2	24	0	0
20	54278129	.	T	A	10	11	21	0	1	22	0	0
20	54283833	.	T	C	16	15	31	0	0	31	0	0
20	54284869	.	A	G	19	1	20	0	22	42	0	0
20	54284986	.	A	G	20	24	44	0	1	45	0	0
20	54285758	.	T	C	12	23	35	0	2	37	0	0
20	54285799	.	C	T	12	25	37	0	1	38	0	0
20	54285804	.	C	T	10	29	39	0	3	42	0	0
20	54285853	.	A	T	19	24	43	3	0	46	0	0
20	54286016	.	G	A	23	16	39	1	1	41	0	0
20	54286097	.	A	T	31	11	42	0	0	42	0	0
20	54286170	.	A	G	10	2	12	0	5	17	0	0
20	54286454	.	C	A	9	11	20	0	3	23	0	0
20	54286666	.	C	T	20	15	35	0	3	38	0	0
20	54286682	.	G	A	20	16	36	0	2	38	0	0
20	54286797	.	G	T	8	10	18	0	0	18	0	0
20	54286798	.	A	G	8	10	18	0	0	18	0	0
20	54334478	.	C	T	8	6	14	0	3	17	0	0
20	54339998	.	C	T	3	3	6	0	0	6	0	0
20	54340018	.	G	C	3	2	5	0	0	5	0	0
20	54340285	.	C	T	6	8	14	0	0	14	0	0
20	54341082	.	A	C	6	5	11	0	0	11	0	0
20	54341108	.	G	T	0	5	5	0	6	11	0	0
20	54341130	.	C	T	7	5	12	0	0	12	0	0
20	54341154	.	A	G	3	4	7	0	0	7	0	0
20	54341203	.	T	A	5	4	9	0	1	10	0	0
20	54341305	.	G	A	0	2	2	0	1	3	0	0
20	54341643	.	A	G	2	3	5	0	0	5	0	0
20	54341644	.	T	A	2	3	5	0	0	5	0	0
20	54341822	.	C	T	5	2	7	1	0	8	0	0
20	54342051	.	T	G	2	4	6	0	1	7	0	0
20	54342388	.	A	G	6	3	9	0	2	12	1	0
20	54342589	.	A	T	5	4	9	1	0	10	0	0
20	54342674	.	T	C	4	4	8	0	0	8	0	0
20	54343441	.	C	G	7	8	15	3	0	19	1	0
20	54343442	.	C	T	9	7	16	3	0	19	0	0
20	54343566	.	G	C	1	13	14	0	7	21	0	0
20	54343639	.	C	A	3	5	8	0	0	8	0	0
20	54343682	.	T	C	7	6	13	0	1	14	0	0
20	54343695	.	A	T	8	9	17	0	1	18	0	0
20	54343866	.	G	A	8	4	12	0	0	12	0	0
20	54343928	.	A	G	8	3	11	0	0	11	0	0
20	54344748	.	T	C	10	13	23	0	0	23	0	0
20	54344795	.	G	A	8	18	26	0	0	26	0	0
20	54344815	.	G	T	5	14	19	0	1	20	0	0
20	54344910	.	C	T	10	4	14	0	1	15	0	0
20	54345226	.	C	T	3	3	6	0	0	6	0	0
20	54345955	.	A	T	19	10	29	0	0	29	0	0
20	54345979	.	A	G	19	11	30	2	1	33	0	0
20	54346012	.	G	C	1	4	5	2	22	36	7	0
20	54346124	.	A	T	8	8	16	0	1	17	0	0
20	54346159	.	G	T	1	12	13	0	12	25	0	0
20	54346178	.	G	T	11	15	26	0	1	27	0	0
20	54346239	.	A	G	9	8	17	0	0	17	0	0
20	54354874	.	A	T	1	1	2	0	1	3	0	0
20	54356452	.	G	C	22	17	39	0	0	39	0	0
20	54357955	.	C	T	14	7	21	0	0	21	0	0
20	54358656	.	T	C	4	2	6	0	0	6	0	0
20	54360143	.	G	A	2	3	5	0	2	7	0	0
20	54360148	.	G	T	0	3	3	0	3	6	0	0
20	54369479	.	A	G	1	2	3	0	0	3	0	0
20	54397812	.	T	C	9	6	15	0	0	15	0	0
20	54397897	.	G	C	13	6	19	0	0	19	0	0
20	54398242	.	C	T	2	10	12	0	1	13	0	0
20	54398380	.	T	A	8	10	18	0	0	18	0	0
20	54398443	.	A	G	12	7	19	0	0	19	0	0
20	54402157	.	G	T	2	11	13	0	12	25	0	0
20	54402346	.	G	A	8	13	21	0	0	21	0	0
20	54402489	.	G	A	11	17	28	0	0	28	0	0
20	54406699	.	A	T	13	15	28	0	1	29	0	0
20	54407401	.	G	C	16	26	42	0	0	42	0	0
20	54407456	.	T	C	12	14	26	0	0	26	0	0
20	54407556	.	C	T	9	6	15	0	0	15	0	0
20	54422636	.	G	A	21	22	43	1	1	45	0	0
20	54422780	.	C	G	17	11	28	0	1	29	0	0
20	54422909	.	C	T	9	14	23	0	1	24	0	0
20	54422929	.	G	A	8	17	25	0	0	25	0	0
20	54423005	.	T	C	20	6	26	0	0	26	0	0
20	54423027	.	C	G	16	14	30	0	2	32	0	0
20	54428696	.	A	G	15	15	30	0	0	30	0	0
20	54432835	.	T	C	13	2	15	0	16	31	0	0
20	54432855	.	T	C	16	2	18	0	12	30	0	0
20	54434895	.	G	A	14	16	30	0	2	32	0	0
20	54434918	.	C	T	20	17	37	0	1	38	0	0
20	54441757	.	A	C	22	30	52	0	4	56	0	0
20	54446877	.	G	A	22	27	49	0	1	50	0	0
20	54462151	.	G	C	21	19	40	0	1	41	0	0
20	54525439	.	T	C	7	8	15	0	0	15	0	0
20	54563425	.	A	G	14	8	22	0	2	24	0	0
20	54563722	.	C	A	0	2	2	0	5	7	0	0
20	54563995	.	G	A	10	3	13	0	1	14	0	0
20	54563998	.	G	C	10	5	15	0	0	15	0	0
20	54670904	.	C	G	5	0	5	0	6	11	0	0
20	54670966	.	A	G	5	5	10	0	0	10	0	0
20	54670984	.	T	A	3	4	7	0	1	8	0	0
20	54671032	.	A	C	2	3	5	0	0	5	0	0
20	54671989	.	G	A	1	8	9	0	0	9	0	0
20	54672839	.	A	G	7	0	7	0	6	13	0	0
20	54672869	.	T	C	6	5	11	0	1	12	0	0
20	54672891	.	T	C	9	6	15	0	0	15	0	0
20	54672974	.	G	A	0	8	8	0	7	15	0	0
20	54673175	.	T	C	3	8	11	0	2	13	0	0
20	54673198	.	T	A	7	7	14	0	0	14	0	0
20	54675294	.	T	C	4	9	13	0	1	14	0	0
20	54675308	.	C	G	5	1	6	0	9	15	0	0
20	54675356	.	C	T	10	12	22	0	1	23	0	0
20	54675391	.	T	C	5	12	17	0	0	17	0	0
20	54676529	.	A	G	4	1	5	0	18	23	0	0
20	54676532	.	T	G	3	20	23	0	0	24	1	0
20	54676583	.	C	T	12	5	17	0	1	18	0	0
20	54681734	.	G	A	7	8	15	0	1	16	0	0
20	54681797	.	T	A	4	10	14	0	0	14	0	0
20	54681944	.	A	T	17	3	20	0	0	20	0	0
20	54698791	.	C	T	6	8	14	0	0	14	0	0
20	54699133	.	C	T	8	5	13	0	1	14	0	0
20	54708193	.	T	C	4	8	12	0	1	13	0	0
20	54708277	.	G	A	3	10	13	0	7	20	0	0
20	54711535	.	G	C	4	7	11	0	0	11	0	0
20	54740904	.	G	A	13	12	25	0	0	25	0	0
20	54740907	.	A	G	12	0	12	0	12	24	0	0
20	54740955	.	C	T	9	14	23	1	1	25	0	0
20	54740976	.	G	T	1	13	14	1	13	28	0	0
20	54741763	.	G	A	5	9	14	0	1	15	0	0
20	54742641	.	C	G	10	12	22	0	0	22	0	0
20	54742714	.	C	T	10	13	23	0	0	23	0	0
20	54742750	.	A	G	10	0	10	0	17	27	0	0
20	54742765	.	A	C	14	17	31	0	1	32	0	0
20	54742912	.	A	C	12	7	19	0	0	19	0	0
20	54743917	.	G	A	26	12	38	0	0	38	0	0
20	54743937	.	C	T	17	8	25	0	0	25	0	0
20	54744230	.	C	T	16	18	34	0	1	35	0	0
20	54744314	.	A	G	20	1	21	0	16	37	0	0
20	54744363	.	A	G	22	0	22	0	12	34	0	0
20	54744419	.	A	G	18	12	30	1	0	31	0	0
20	54744451	.	A	G	17	7	24	1	0	25	0	0
21	18055	.	A	T	6	5	11	0	5	16	0	0
21	18057	.	T	A	7	7	14	0	2	16	0	0
21	18176	.	G	A	8	8	16	0	0	16	0	0
21	36346	.	A	C	1	2	3	0	1	4	0	0
21	36904	.	C	T	1	3	4	0	6	10	0	0
21	40609	.	T	C	15	22	37	2	0	39	0	0
21	41914	.	A	G	4	5	9	0	0	9	0	0
21	73729	.	A	G	2	0	2	0	4	6	0	0
21	73779	.	G	A	2	3	5	0	1	6	0	0
21	82193	.	C	T	2	3	5	0	0	5	0	0
21	103308	.	T	C	6	7	13	0	0	13	0	0
21	103962	.	C	T	6	3	9	0	0	9	0	0
21	104046	.	T	C	4	5	9	0	0	9	0	0
21	104143	.	G	C	0	3	3	0	5	8	0	0
21	104316	.	A	T	2	7	9	0	2	11	0	0
21	112730	.	C	A	17	14	31	0	1	32	0	0
21	170052	.	C	A	3	6	9	0	1	10	0	0
21	170842	.	C	G	10	11	21	0	0	21	0	0
21	170896	.	A	C	8	6	14	0	0	15	1	0
21	170916	.	T	C	4	6	10	0	1	11	0	0
21	171853	.	A	G	5	0	5	0	12	17	0	0
21	173536	.	A	G	12	13	25	0	1	26	0	0
21	173545	.	T	C	15	14	29	0	1	30	0	0
21	178062	.	T	C	8	5	13	0	2	15	0	0
21	178193	.	T	A	5	8	13	1	2	16	0	0
21	178227	.	G	A	0	8	8	0	6	14	0	0
21	178247	.	G	T	4	9	13	0	1	14	0	0
21	178559	.	T	C	3	11	14	0	0	14	0	0
21	217974	.	T	C	18	6	24	0	1	25	0	0
21	218795	.	A	G	10	5	15	0	1	16	0	0
21	219250	.	C	T	2	4	6	0	8	14	0	0
21	219259	.	T	C	10	0	10	0	2	12	0	0
21	222529	.	T	C	2	0	2	0	5	7	0	0
21	226054	.	G	A	4	4	8	0	0	8	0	0
21	233123	.	G	C	14	10	24	0	0	24	0	0
21	237246	.	G	C	12	14	26	0	0	26	0	0
21	238575	.	T	C	15	13	28	0	0	28	0	0
21	240046	.	A	G	9	1	10	0	9	19	0	0
21	243053	.	C	G	16	19	35	0	1	36	0	0
21	245641	.	G	A	1	3	4	0	3	7	0	0
21	247942	.	T	C	5	5	10	0	0	10	0	0
21	248156	.	C	G	9	6	15	0	1	16	0	0
21	248284	.	A	C	4	3	7	0	1	8	0	0
21	248286	.	A	C	4	3	7	0	0	7	0	0
21	250078	.	A	C	4	6	10	0	1	11	0	0
21	252150	.	G	A	3	6	9	0	0	9	0	0
21	259559	.	A	G	4	4	8	0	1	9	0	0
21	260189	.	C	T	5	4	9	0	0	9	0	0
21	261182	.	A	G	2	1	3	0	4	7	0	0
21	262572	.	C	G	5	7	12	0	0	12	0	0
21	266087	.	T	A	10	4	14	0	2	16	0	0
21	266195	.	A	G	6	0	6	0	8	14	0	0
21	267453	.	C	G	8	0	8	0	4	12	0	0
21	267717	.	T	C	18	9	27	0	1	28	0	0
21	269053	.	G	C	1	11	12	0	14	26	0	0
21	269057	.	G	A	13	12	25	0	0	25	0	0
21	269117	.	T	C	12	11	23	0	1	24	0	0
21	269328	.	G	A	0	4	4	0	6	10	0	0
21	269348	.	A	G	3	5	8	0	0	8	0	0
21	269391	.	G	A	2	3	5	0	0	5	0	0
21	269634	.	T	C	11	5	16	0	0	16	0	0
21	269676	.	C	T	6	3	9	0	1	10	0	0
21	269693	.	A	T	6	3	9	0	0	9	0	0
21	269727	.	C	T	4	4	8	0	0	8	0	0
21	269789	.	A	G	3	5	8	0	0	8	0	0
21	269840	.	A	T	3	3	6	0	0	6	0	0
21	269858	.	G	A	4	1	5	0	1	6	0	0
21	272159	.	T	C	5	3	8	0	1	9	0	0
21	301298	.	G	A	12	9	21	0	0	21	0	0
21	303310	.	G	A	3	4	7	0	0	7	0	0
21	303443	.	A	G	3	4	7	0	0	7	0	0
21	350020	.	C	T	3	2	5	0	0	5	0	0
21	350200	.	T	C	2	4	6	0	0	6	0	0
21	350447	.	C	G	2	1	3	0	1	4	0	0
21	350525	.	C	G	4	5	9	0	0	9	0	0
21	350728	.	T	C	2	3	5	0	0	5	0	0
21	350740	.	C	T	2	2	4	0	0	4	0	0
21	352447	.	A	C	3	3	6	0	1	7	0	0
21	356956	.	T	C	5	3	8	0	0	8	0	0
21	356971	.	A	T	5	2	7	0	0	7	0	0
21	363753	.	T	C	4	2	6	0	0	6	0	0
21	367657	.	T	C	6	7	13	0	0	13	0	0
21	382570	.	T	G	12	0	12	0	15	27	0	0
21	409978	.	G	A	1	11	12	0	11	23	0	0
21	409986	.	G	A	10	9	19	0	1	20	0	0
21	410139	.	A	G	8	9	17	0	0	17	0	0
21	410268	.	A	G	7	2	9	0	0	9	0	0
21	410281	.	C	T	6	4	10	0	1	11	0	0
21	410320	.	T	G	8	3	11	0	0	11	0	0
21	520628	.	G	A	8	5	13	0	0	13	0	0
21	522633	.	A	T	4	6	10	0	1	11	0	0
21	522926	.	A	G	9	10	19	0	0	19	0	0
21	527570	.	A	T	13	9	22	0	0	22	0	0
21	734962	.	A	G	8	0	8	0	14	22	0	0
21	735222	.	A	G	42	1	43	2	24	69	0	0
21	2932448	.	T	C	3	3	6	0	1	7	0	0
21	2934254	.	A	T	1	2	3	0	0	3	0	0
21	2948879	.	T	C	1	2	3	0	0	3	0	0
21	2950257	.	G	A	2	3	5	0	0	5	0	0
21	2950290	.	C	A	0	3	3	0	1	4	0	0
21	2958131	.	C	G	1	4	5	0	0	5	0	0
21	2958154	.	C	T	1	4	5	0	0	5	0	0
21	5004192	.	T	C	2	3	5	0	0	5	0	0
21	5368346	.	G	A	8	9	17	0	1	18	0	0
21	5368417	.	C	T	2	8	10	0	10	20	0	0
21	5368461	.	C	T	2	13	15	0	13	28	0	0
21	5368510	.	C	T	1	7	8	0	16	24	0	0
21	5370451	.	T	A	8	9	17	0	2	19	0	0
21	5372598	.	G	A	7	3	10	0	3	13	0	0
21	5372643	.	T	C	5	6	11	0	3	14	0	0
21	5372673	.	G	A	6	7	13	1	0	14	0	0
21	5374209	.	C	T	0	2	2	0	5	7	0	0
21	5374788	.	G	A	3	3	6	0	1	7	0	0
21	5392941	.	T	A	1	3	4	0	0	4	0	0
21	5392963	.	G	T	2	2	4	0	0	4	0	0
21	5601792	.	C	G	2	3	5	0	0	5	0	0
21	5602006	.	A	G	1	1	2	0	1	3	0	0
21	5602843	.	T	A	1	2	3	0	0	3	0	0
21	5781134	.	C	T	40	31	71	0	0	71	0	0
21	5782043	.	T	C	31	11	42	0	41	83	0	0
21	5789938	.	G	A	36	32	68	0	2	70	0	0
21	5796060	.	T	C	30	30	60	1	2	63	0	0
21	5797960	.	T	C	48	15	63	0	4	67	0	0
21	5798978	.	T	A	23	25	48	0	1	49	0	0
21	5802878	.	A	G	4	3	7	0	0	7	0	0
21	5803474	.	C	T	12	15	27	0	0	27	0	0
21	5803495	.	T	C	13	6	19	0	6	25	0	0
21	5803546	.	G	A	3	2	5	0	0	5	0	0
21	5807177	.	A	C	10	9	19	0	1	20	0	0
21	5813676	.	C	T	1	4	5	0	0	5	0	0
21	5816912	.	T	C	2	1	3	0	5	8	0	0
21	5816950	.	A	G	1	4	5	0	0	5	0	0
21	5884836	.	G	A	1	25	26	0	24	50	0	0
21	5884897	.	T	A	35	25	60	0	0	60	0	0
21	5884945	.	G	A	18	27	45	0	0	45	0	0
21	5885071	.	T	G	2	3	5	0	0	5	0	0
21	5905143	.	T	C	1	2	3	0	1	4	0	0
21	5909979	.	C	T	2	4	6	0	0	6	0	0
21	5915055	.	C	T	2	4	6	0	0	6	0	0
21	5915707	.	G	A	0	4	4	0	3	7	0	0
21	5915813	.	T	G	2	4	6	0	0	6	0	0
21	5920348	.	G	C	3	4	7	0	1	8	0	0
21	5920426	.	C	T	8	6	14	0	1	15	0	0
21	5920525	.	A	G	6	0	6	2	1	9	0	0
21	5920559	.	T	C	12	4	16	9	0	25	0	0
21	5920586	.	A	C	15	4	19	5	1	25	0	0
21	5920604	.	T	C	16	3	19	5	2	26	0	0
21	5926821	.	A	G	1	2	3	0	0	3	0	0
21	5926856	.	A	G	2	2	4	0	0	4	0	0
21	5927019	.	G	A	1	2	3	0	0	3	0	0
21	5927034	.	C	A	1	4	5	0	0	5	0	0
21	5927149	.	A	C	4	2	6	0	1	7	0	0
21	5929144	.	A	G	3	0	3	0	4	7	0	0
21	5932610	.	C	T	2	5	7	0	0	7	0	0
21	5938291	.	T	C	6	2	8	0	0	8	0	0
21	5938303	.	A	T	2	5	7	0	1	8	0	0
21	5938364	.	T	C	4	2	6	0	1	7	0	0
21	5938399	.	G	T	2	2	4	0	1	5	0	0
21	5942661	.	G	T	11	6	17	0	0	17	0	0
21	5942868	.	T	G	8	12	20	0	1	21	0	0
21	5942906	.	C	A	10	10	20	0	3	23	0	0
21	5942927	.	C	T	11	13	24	0	1	25	0	0
21	5948087	.	G	A	1	2	3	0	0	3	0	0
21	5966657	.	G	A	2	8	10	0	4	14	0	0
21	5971630	.	C	A	20	0	20	0	0	20	0	0
21	5971638	.	C	A	14	6	20	0	0	20	0	0
21	5971949	.	A	T	7	13	20	0	0	20	0	0
21	5971983	.	C	T	9	10	19	0	0	19	0	0
21	5972087	.	G	T	0	11	11	0	14	25	0	0
21	5972092	.	T	C	15	11	26	0	1	27	0	0
21	5972252	.	A	G	12	9	21	0	1	22	0	0
21	5972543	.	C	T	11	8	19	0	0	19	0	0
21	6114524	.	T	A	1	2	3	0	0	3	0	0
21	6114776	.	G	T	1	3	4	0	0	4	0	0
21	6119989	.	T	C	1	2	3	0	0	3	0	0
21	6129133	.	A	G	1	0	1	0	3	4	0	0
21	6133407	.	G	A	6	2	8	0	0	8	0	0
21	6133434	.	G	A	0	3	3	0	6	9	0	0
21	6133588	.	T	C	1	3	4	0	0	4	0	0
21	6134154	.	A	G	2	1	3	0	1	4	0	0
21	6134155	.	A	G	1	1	2	0	1	3	0	0
21	6134234	.	T	C	1	2	3	0	0	3	0	0
21	6134238	.	G	T	0	2	2	0	1	3	0	0
21	6134314	.	A	G	3	0	3	0	2	5	0	0
21	6134348	.	A	T	1	4	5	0	1	6	0	0
21	6137579	.	C	T	5	13	18	0	0	18	0	0
21	6145991	.	G	A	9	7	16	0	0	16	0	0
21	6147499	.	C	T	9	10	19	0	1	20	0	0
21	6148091	.	G	A	0	14	14	0	8	22	0	0
21	6149938	.	T	C	18	21	39	0	1	40	0	0
21	6150113	.	T	A	5	6	11	0	2	13	0	0
21	6150504	.	A	G	2	1	3	0	1	4	0	0
21	6212959	.	C	T	2	3	5	0	0	5	0	0
21	6416003	.	A	C	1	2	3	0	0	3	0	0
21	6416009	.	C	T	1	2	3	0	0	3	0	0
21	7750577	.	T	C	4	2	6	0	0	6	0	0
21	11493661	.	A	G	40	15	55	0	4	59	0	0
21	11494536	.	A	G	12	2	14	0	52	66	0	0
21	11501975	.	A	G	14	31	45	0	3	48	0	0
21	11502056	.	A	G	42	22	64	0	3	67	0	0
21	11502143	.	A	G	11	46	57	0	3	60	0	0
21	11845268	.	T	C	2	6	8	0	0	8	0	0
21	13611849	.	G	A	3	5	8	0	0	8	0	0
21	13611930	.	G	T	5	2	7	0	0	7	0	0
21	13611990	.	C	T	0	3	3	0	3	6	0	0
21	13612174	.	T	A	4	6	10	0	0	10	0	0
21	13612559	.	A	T	6	7	13	0	0	13	0	0
21	13612927	.	A	T	4	4	8	0	0	8	0	0
21	13613017	.	A	G	5	3	8	0	3	11	0	0
21	13613037	.	T	C	4	4	8	0	1	9	0	0
21	13613053	.	T	C	1	7	8	0	0	8	0	0
21	13613172	.	C	T	0	3	3	0	2	5	0	0
21	13613559	.	T	C	4	3	7	1	0	8	0	0
21	13613610	.	T	C	5	2	7	0	0	7	0	0
21	13613627	.	T	C	0	4	4	0	1	5	0	0
21	13615217	.	T	C	2	0	2	0	2	4	0	0
21	13619823	.	C	T	1	2	3	0	0	3	0	0
21	13621487	.	G	T	1	3	4	0	0	4	0	0
21	13628877	.	C	T	0	2	2	0	3	5	0	0
21	13641685	.	A	G	2	3	5	0	0	5	0	0
21	13702751	.	A	T	26	13	39	0	1	40	0	0
21	13714602	.	T	C	20	11	31	0	2	33	0	0
21	13714603	.	G	A	20	11	31	0	1	32	0	0
21	13715285	.	T	A	27	14	41	0	1	42	0	0
21	13715347	.	T	A	21	13	34	0	1	35	0	0
21	13715356	.	A	G	20	12	32	0	2	34	0	0
21	13751205	.	G	C	8	11	19	0	1	20	0	0
21	13762760	.	C	T	5	4	9	0	1	10	0	0
21	13766022	.	C	G	0	3	3	0	2	5	0	0
21	13771160	.	G	T	1	2	3	0	0	3	0	0
21	13771269	.	G	T	2	2	4	0	1	5	0	0
21	13786089	.	G	A	2	2	4	0	0	4	0	0
21	13794602	.	C	T	6	4	10	0	0	10	0	0
21	13794652	.	G	T	2	3	5	0	1	6	0	0
21	13796033	.	G	A	2	10	12	0	2	14	0	0
21	13796165	.	G	A	5	5	10	0	1	11	0	0
21	13796743	.	A	G	7	16	23	0	2	25	0	0
21	13895741	.	C	T	29	20	49	0	0	49	0	0
21	13895799	.	C	A	27	24	51	0	2	53	0	0
21	13895849	.	G	A	1	20	21	0	28	49	0	0
21	13895862	.	A	C	23	26	49	0	0	49	0	0
21	13909005	.	T	C	39	34	73	0	0	73	0	0
21	13919482	.	C	T	24	15	39	0	6	45	0	0
21	13919498	.	C	A	21	22	43	0	10	53	0	0
21	13920204	.	G	C	8	28	36	0	36	73	1	0
21	13920308	.	C	T	39	28	67	0	11	78	0	0
21	13920510	.	G	A	7	43	50	0	29	79	0	0
21	13920648	.	G	A	2	31	33	0	28	61	0	0
21	13979922	.	T	A	2	2	4	0	0	4	0	0
21	13980445	.	T	A	3	10	13	0	4	17	0	0
21	13980490	.	T	C	7	7	14	0	0	14	0	0
21	13980516	.	G	A	6	8	14	0	0	14	0	0
21	13980628	.	G	T	2	9	11	0	0	11	0	0
21	13980743	.	A	G	1	2	3	0	0	3	0	0
21	13981564	.	C	T	0	6	6	0	2	8	0	0
21	13981620	.	C	T	1	7	8	0	8	16	0	0
21	13981973	.	C	T	0	3	3	0	1	4	0	0
21	13981980	.	T	C	1	1	2	0	0	2	0	0
21	13982154	.	G	A	1	2	3	0	0	3	0	0
21	13982163	.	C	T	0	2	2	0	3	5	0	0
21	13982764	.	A	T	4	3	7	0	0	7	0	0
21	13982919	.	T	A	1	2	3	0	0	3	0	0
21	13983125	.	G	A	5	2	7	0	0	7	0	0
21	13983649	.	G	T	4	6	10	0	0	10	0	0
21	13983757	.	G	A	2	6	8	0	0	8	0	0
21	14217519	.	C	A	5	5	10	0	0	10	0	0
21	14217595	.	T	C	4	4	8	0	1	9	0	0
21	14217612	.	T	C	8	1	9	0	5	14	0	0
21	14217657	.	T	G	13	6	19	0	0	19	0	0
21	14217664	.	T	C	6	0	6	0	13	19	0	0
21	14217762	.	G	T	15	6	21	0	0	21	0	0
21	14224135	.	A	T	9	7	16	0	1	17	0	0
21	14224168	.	C	T	7	3	10	0	2	12	0	0
21	14226528	.	C	T	2	4	6	0	1	7	0	0
21	14226571	.	T	A	7	6	13	0	0	13	0	0
21	14226601	.	C	T	2	8	10	0	8	18	0	0
21	14226685	.	C	T	10	6	16	0	0	17	1	0
21	14228943	.	C	T	2	10	12	0	1	13	0	0
21	14232498	.	G	A	2	11	13	0	0	13	0	0
21	14235495	.	A	G	4	6	10	0	2	12	0	0
21	14241936	.	C	A	2	4	6	1	0	7	0	0
21	14250993	.	T	C	1	4	5	0	0	5	0	0
21	14251128	.	G	T	1	4	5	0	0	5	0	0
21	14254590	.	T	A	1	2	3	0	1	4	0	0
21	14381335	.	G	A	4	2	6	0	0	6	0	0
21	14381356	.	C	T	1	2	3	0	5	8	0	0
21	14381422	.	G	A	5	5	10	0	1	11	0	0
21	14381440	.	G	A	6	5	11	0	0	11	0	0
21	14381740	.	A	T	9	3	12	0	0	12	0	0
21	14396466	.	C	T	2	3	5	0	0	5	0	0
21	14399444	.	A	T	2	3	5	0	0	5	0	0
21	14399710	.	T	G	3	5	8	0	1	9	0	0
21	14399729	.	A	G	5	5	10	0	0	10	0	0
21	14644558	.	G	A	6	10	16	0	2	18	0	0
21	14644567	.	G	A	5	8	13	0	0	13	0	0
21	14644702	.	A	T	8	8	16	1	0	17	0	0
21	14644704	.	A	T	8	7	15	1	2	18	0	0
21	14644814	.	C	T	13	15	28	0	0	28	0	0
21	14644869	.	C	G	10	11	21	0	0	21	0	0
21	14644885	.	A	T	11	12	23	0	0	23	0	0
21	14644917	.	T	G	11	13	24	0	0	24	0	0
21	14644949	.	C	T	1	15	16	0	9	25	0	0
21	14644969	.	A	G	15	10	25	0	0	25	0	0
21	14645006	.	G	A	14	7	21	0	0	21	0	0
21	14645021	.	G	A	10	11	21	0	1	22	0	0
21	14645125	.	A	G	7	6	13	1	1	15	0	0
21	14645490	.	C	T	4	15	19	0	0	20	1	0
21	14645574	.	C	T	12	5	17	0	1	18	0	0
21	14645724	.	G	T	9	16	25	0	1	26	0	0
21	14645728	.	A	G	9	16	25	0	2	27	0	0
21	14645873	.	C	T	17	14	31	0	1	32	0	0
21	14654497	.	G	A	2	6	8	0	1	9	0	0
21	14657314	.	C	T	1	5	6	0	7	13	0	0
21	14659462	.	T	A	13	4	17	0	1	18	0	0
21	14659828	.	A	T	5	10	15	0	0	15	0	0
21	14659997	.	T	C	7	6	13	0	1	14	0	0
21	14660057	.	C	A	3	4	7	0	1	8	0	0
21	14663428	.	A	G	6	7	13	0	0	13	0	0
21	14663853	.	C	G	8	11	19	0	0	19	0	0
21	14664425	.	T	C	5	8	13	0	0	13	0	0
21	14664752	.	G	A	10	5	15	0	0	15	0	0
21	14664851	.	T	C	4	4	8	0	1	9	0	0
21	14665152	.	G	A	4	8	12	0	1	13	0	0
21	14665312	.	T	C	4	7	11	0	0	11	0	0
21	14665397	.	C	A	5	3	8	0	2	10	0	0
21	14665427	.	C	T	1	3	4	0	0	4	0	0
21	14665510	.	C	A	5	4	9	0	0	9	0	0
21	14701803	.	G	A	11	8	19	0	0	19	0	0
21	14701890	.	A	G	9	4	13	0	3	16	0	0
21	14701897	.	G	A	10	6	16	0	1	17	0	0
21	14701953	.	T	C	8	0	8	0	5	13	0	0
21	14702073	.	C	G	7	4	11	0	0	11	0	0
21	14702076	.	C	T	4	7	11	0	1	12	0	0
21	14702193	.	C	T	2	4	6	0	0	6	0	0
21	14702211	.	C	T	0	3	3	0	4	7	0	0
21	17110912	.	G	A	4	2	6	0	0	6	0	0
21	17179255	.	T	C	2	3	5	0	0	5	0	0
21	17192901	.	C	A	10	6	16	0	1	17	0	0
21	17241789	.	G	A	8	4	12	0	0	12	0	0
21	17241810	.	T	C	5	6	11	0	0	11	0	0
21	17242441	.	C	A	9	7	16	0	1	17	0	0
21	17243160	.	C	T	10	5	15	0	0	15	0	0
21	17253268	.	A	G	7	10	17	0	0	17	0	0
21	17255773	.	C	T	5	4	9	0	1	10	0	0
21	17256590	.	A	C	13	9	22	0	2	24	0	0
21	17256656	.	A	G	14	6	20	0	0	20	0	0
21	17258362	.	A	G	10	14	24	0	0	24	0	0
21	17258486	.	C	T	13	10	23	0	1	24	0	0
21	17258842	.	A	G	2	4	6	0	0	6	0	0
21	17258864	.	T	C	2	4	6	0	1	7	0	0
21	17259081	.	C	G	7	12	19	0	0	19	0	0
21	17259113	.	G	A	4	10	14	0	0	14	0	0
21	17259279	.	G	T	1	9	10	0	8	18	0	0
21	17259332	.	T	C	11	12	23	0	1	24	0	0
21	17259466	.	A	T	7	5	12	0	3	15	0	0
21	17307144	.	C	T	4	2	6	0	0	6	0	0
21	17314037	.	G	A	4	3	7	0	0	7	0	0
21	17314054	.	C	T	5	3	8	0	1	9	0	0
21	17322472	.	G	A	0	11	11	0	7	18	0	0
21	17322478	.	C	A	6	9	15	0	2	17	0	0
21	17322641	.	G	T	6	7	13	0	0	13	0	0
21	17325413	.	G	A	7	8	15	0	0	15	0	0
21	17325965	.	G	A	7	6	13	0	0	13	0	0
21	17327124	.	G	C	0	7	7	0	6	13	0	0
21	17327359	.	C	T	5	4	9	0	0	9	0	0
21	17327646	.	G	A	9	9	18	0	0	18	0	0
21	17333807	.	G	C	5	7	12	0	1	13	0	0
21	17335664	.	G	A	7	9	16	0	1	17	0	0
21	17335676	.	G	A	1	8	9	0	10	19	0	0
21	17335709	.	C	T	7	7	14	0	1	15	0	0
21	17337694	.	G	A	1	10	11	0	15	26	0	0
21	17337865	.	C	T	16	10	26	0	0	26	0	0
21	17337898	.	A	T	14	12	26	0	1	27	0	0
21	17338141	.	T	G	9	14	23	0	1	24	0	0
21	17338593	.	G	A	5	8	13	0	1	14	0	0
21	17338963	.	T	C	12	9	21	0	2	23	0	0
21	17339001	.	C	A	11	5	16	0	0	16	0	0
21	17339002	.	A	T	11	5	16	0	0	16	0	0
21	17339044	.	C	A	6	13	19	0	0	19	0	0
21	17339132	.	G	A	0	11	11	0	4	15	0	0
21	17419958	.	C	T	2	2	4	0	1	5	0	0
21	17478552	.	T	A	1	3	4	0	0	5	1	0
21	17478656	.	G	C	12	12	24	0	0	24	0	0
21	17480167	.	G	A	17	10	27	1	3	31	0	0
21	17480216	.	C	T	10	12	22	0	0	22	0	0
21	17482201	.	A	G	13	12	25	0	2	27	0	0
21	17482237	.	A	G	14	7	21	0	3	24	0	0
21	17568543	.	A	G	6	19	25	0	3	28	0	0
21	18372663	.	C	G	8	1	9	0	11	20	0	0
21	19008193	.	A	T	20	26	46	0	3	49	0	0
21	19008272	.	C	T	16	14	30	0	2	32	0	0
21	19008368	.	C	T	15	18	33	0	1	34	0	0
21	19008602	.	G	A	19	16	35	0	1	36	0	0
21	19008689	.	G	A	25	15	40	0	0	40	0	0
21	19008845	.	C	T	22	13	35	0	2	37	0	0
21	19009346	.	T	C	19	23	42	0	0	42	0	0
21	19009693	.	A	C	32	21	53	1	0	54	0	0
21	19010069	.	G	A	22	26	48	0	1	49	0	0
21	19010097	.	A	T	27	29	56	0	2	58	0	0
21	19010108	.	G	A	20	39	59	0	7	66	0	0
21	19013875	.	G	A	9	30	39	0	1	40	0	0
21	19014036	.	T	G	17	24	41	0	1	42	0	0
21	19014179	.	C	T	17	17	34	7	5	46	0	0
21	19014256	.	T	C	30	2	32	0	28	60	0	0
21	19014341	.	C	A	36	34	70	0	2	72	0	0
21	19014420	.	C	T	42	31	73	0	3	76	0	0
21	19014567	.	C	T	31	41	72	0	1	73	0	0
21	19014634	.	A	T	30	32	62	0	1	63	0	0
21	19014714	.	G	A	28	31	59	0	6	65	0	0
21	19014980	.	C	T	26	31	57	0	3	60	0	0
21	19015035	.	A	G	26	28	54	0	1	55	0	0
21	19015508	.	C	T	14	25	39	0	1	40	0	0
21	19017370	.	T	A	37	23	60	0	0	60	0	0
21	19018116	.	A	G	16	26	42	0	1	43	0	0
21	19018224	.	A	C	29	18	47	0	2	49	0	0
21	19018362	.	A	G	29	17	46	0	2	48	0	0
21	19018434	.	T	A	11	13	24	0	1	25	0	0
21	19063337	.	T	G	39	32	71	1	1	73	0	0
21	19067092	.	A	G	37	38	75	0	1	76	0	0
21	19073046	.	A	T	3	2	5	0	0	5	0	0
21	19073143	.	G	T	8	7	15	0	0	15	0	0
21	19073505	.	C	T	4	2	6	0	1	7	0	0
21	19073629	.	T	C	7	3	10	0	1	11	0	0
21	19073718	.	T	C	2	3	5	0	0	5	0	0
21	19301614	.	G	A	0	2	2	0	0	2	0	0
21	19301629	.	T	C	1	2	3	0	0	3	0	0
21	19324788	.	A	G	2	2	4	0	0	4	0	0
21	19329072	.	C	T	4	6	10	0	2	12	0	0
21	19329285	.	C	T	1	10	11	0	16	27	0	0
21	19329813	.	G	T	18	12	30	0	1	31	0	0
21	19337060	.	C	T	2	2	4	0	0	4	0	0
21	19339245	.	C	A	1	3	4	0	0	4	0	0
21	19343165	.	A	C	3	2	5	0	0	5	0	0
21	19345608	.	A	G	1	4	5	0	1	6	0	0
21	19347971	.	G	A	0	2	2	0	1	3	0	0
21	19353416	.	C	T	2	4	6	0	0	6	0	0
21	19354701	.	A	G	2	2	4	0	0	4	0	0
21	19438183	.	G	A	0	3	3	0	1	4	0	0
21	19441236	.	G	A	1	2	3	0	0	3	0	0
21	19489076	.	T	C	2	2	4	0	0	4	0	0
21	19602458	.	C	G	1	0	1	0	3	4	0	0
21	19763668	.	C	T	17	21	38	0	2	40	0	0
21	19763692	.	A	T	27	19	46	0	2	48	0	0
21	19763942	.	G	A	30	25	55	0	0	55	0	0
21	19764230	.	C	T	39	21	60	0	5	65	0	0
21	19764316	.	T	G	34	24	58	0	2	60	0	0
21	19764397	.	G	C	21	26	47	0	4	52	1	0
21	19764431	.	C	T	32	16	48	0	0	48	0	0
21	19764432	.	G	A	16	30	46	0	1	47	0	0
21	19764516	.	G	A	24	22	46	0	1	47	0	0
21	19764674	.	C	T	4	4	8	0	0	8	0	0
21	19764676	.	T	C	6	3	9	0	0	9	0	0
21	19765039	.	G	A	18	19	37	0	3	40	0	0
21	19785355	.	G	T	15	6	21	0	2	23	0	0
21	19785379	.	A	T	15	13	28	0	2	30	0	0
21	19792767	.	T	G	13	12	25	0	2	27	0	0
21	19795075	.	T	C	6	0	6	0	12	18	0	0
21	19804193	.	T	G	15	6	21	0	2	23	0	0
21	19805614	.	G	A	8	7	15	0	1	16	0	0
21	19807356	.	C	G	9	9	18	0	0	18	0	0
21	19872681	.	A	G	3	4	7	0	1	8	0	0
21	19904556	.	T	C	3	5	8	0	0	8	0	0
21	19904871	.	G	A	5	4	9	0	0	9	0	0
21	19905609	.	C	G	2	7	9	0	0	9	0	0
21	19906135	.	A	G	1	2	3	0	1	4	0	0
21	19911433	.	G	T	8	10	18	0	0	18	0	0
21	19911467	.	C	G	11	9	20	0	1	21	0	0
21	20035065	.	T	C	3	5	8	0	1	9	0	0
21	20039621	.	G	A	0	7	7	0	4	11	0	0
21	20039687	.	G	A	0	9	9	0	4	13	0	0
21	20064747	.	G	T	2	4	6	0	1	7	0	0
21	20080608	.	G	T	1	5	6	1	1	8	0	0
21	20089886	.	C	T	7	10	17	0	0	17	0	0
21	20101713	.	A	G	12	0	12	0	9	21	0	0
21	20103068	.	G	A	11	15	26	0	1	27	0	0
21	20103249	.	T	C	9	16	25	0	1	26	0	0
21	20106524	.	G	A	18	7	25	0	0	25	0	0
21	20106551	.	A	G	10	19	29	0	0	29	0	0
21	20108249	.	G	A	1	12	13	1	8	22	0	0
21	20108282	.	T	A	10	7	17	0	2	19	0	0
21	20108354	.	G	T	6	12	18	0	0	18	0	0
21	20108359	.	T	A	13	5	18	0	0	18	0	0
21	20108831	.	A	T	3	2	5	0	0	5	0	0
21	20113659	.	A	G	1	4	5	0	0	5	0	0
21	20113912	.	A	T	7	2	9	0	0	9	0	0
21	20114094	.	G	A	22	15	37	0	0	37	0	0
21	20114385	.	G	A	7	5	12	0	0	12	0	0
21	20118979	.	C	T	5	4	9	0	0	9	0	0
21	20305865	.	C	T	1	2	3	0	1	4	0	0
21	20325629	.	C	A	1	2	3	0	0	3	0	0
21	20325630	.	A	G	0	2	2	0	0	2	0	0
21	20328356	.	C	T	1	2	3	0	0	3	0	0
21	20394396	.	T	C	2	3	5	0	0	5	0	0
21	20394397	.	C	A	2	3	5	0	0	5	0	0
21	20395038	.	C	T	3	2	5	0	1	6	0	0
21	20395176	.	C	T	1	2	3	0	0	3	0	0
21	20397449	.	C	T	1	2	3	0	0	3	0	0
21	20615173	.	T	A	4	7	11	0	0	11	0	0
21	20615197	.	T	G	3	4	7	0	1	8	0	0
21	20633065	.	C	T	2	4	6	0	0	6	0	0
21	20633200	.	A	T	3	5	8	0	0	8	0	0
21	20633230	.	A	G	5	0	5	0	8	13	0	0
21	20633249	.	T	C	4	6	10	0	1	11	0	0
21	20633728	.	G	A	0	3	3	0	4	7	0	0
21	20633884	.	G	A	0	2	2	0	1	3	0	0
21	20634380	.	T	A	2	3	5	0	0	5	0	0
21	20634424	.	T	A	1	3	4	0	0	4	0	0
21	20634442	.	C	A	2	2	4	0	0	4	0	0
21	20634474	.	A	T	1	2	3	0	0	3	0	0
21	20634486	.	G	A	2	2	4	0	0	4	0	0
21	20635165	.	C	G	6	4	10	0	0	10	0	0
21	20635166	.	A	G	6	3	9	0	1	10	0	0
21	20635369	.	T	A	1	6	7	0	2	9	0	0
21	20635428	.	T	A	4	4	8	0	1	9	0	0
21	20636063	.	G	T	1	7	8	0	4	12	0	0
21	20636119	.	T	C	5	3	8	0	0	8	0	0
21	20636130	.	G	T	3	6	9	0	0	9	0	0
21	20636690	.	C	T	1	3	4	0	0	4	0	0
21	20744913	.	G	A	2	4	6	0	0	6	0	0
21	20909676	.	C	T	4	2	6	0	0	6	0	0
21	20914348	.	C	A	2	5	7	0	0	7	0	0
21	20915065	.	C	T	10	14	24	0	0	24	0	0
21	20915152	.	C	T	2	5	7	0	0	7	0	0
21	20915736	.	C	T	3	3	6	0	0	6	0	0
21	20922899	.	A	G	2	2	4	0	0	4	0	0
21	20933504	.	A	T	4	4	8	0	1	9	0	0
21	20933759	.	G	A	14	6	20	0	1	21	0	0
21	20933798	.	C	T	12	8	20	0	0	20	0	0
21	20938270	.	G	A	15	14	29	0	1	30	0	0
21	20938354	.	T	A	10	14	24	0	3	27	0	0
21	20938976	.	T	C	11	17	28	0	1	29	0	0
21	20938981	.	C	A	0	13	13	0	14	27	0	0
21	20950679	.	T	C	6	5	11	0	0	11	0	0
21	20950835	.	G	A	2	2	4	0	3	7	0	0
21	20951231	.	G	A	0	6	6	0	5	11	0	0
21	20951267	.	T	G	6	1	7	0	9	16	0	0
21	21013693	.	C	G	11	3	14	1	16	31	0	0
21	21017484	.	G	C	15	15	30	0	0	30	0	0
21	21017513	.	C	T	13	14	27	0	1	28	0	0
21	21017606	.	G	A	23	16	39	0	2	41	0	0
21	21020589	.	C	T	9	3	12	0	0	12	0	0
21	21028097	.	G	C	19	16	35	0	1	36	0	0
21	21049323	.	G	A	6	10	16	0	2	18	0	0
21	21051358	.	G	C	6	7	13	0	0	13	0	0
21	21051715	.	C	T	11	10	21	0	2	23	0	0
21	21057398	.	T	A	11	13	24	0	0	24	0	0
21	21065212	.	A	T	5	4	9	0	1	10	0	0
21	21069395	.	C	A	0	4	4	0	2	6	0	0
21	21069692	.	G	C	4	6	10	0	0	10	0	0
21	21072309	.	C	T	6	7	13	0	0	13	0	0
21	21075987	.	C	T	3	3	6	0	0	6	0	0
21	21079840	.	G	A	7	4	11	0	0	11	0	0
21	21079852	.	C	A	1	8	9	0	3	12	0	0
21	21082623	.	G	T	2	3	5	0	0	5	0	0
21	21217999	.	G	A	2	2	4	0	0	4	0	0
21	21228247	.	C	T	4	2	6	0	0	6	0	0
21	21230088	.	G	A	0	3	3	0	3	6	0	0
21	21233095	.	T	C	3	2	5	0	0	5	0	0
21	21233182	.	G	A	5	2	7	0	0	7	0	0
21	21233266	.	A	T	2	3	5	0	0	5	0	0
21	21233281	.	G	A	2	3	5	0	0	5	0	0
21	21235061	.	C	T	4	3	7	0	0	7	0	0
21	21236886	.	G	A	4	6	10	0	0	10	0	0
21	21236900	.	A	G	6	5	11	0	0	11	0	0
21	21238089	.	C	T	4	5	9	0	0	9	0	0
21	21238098	.	C	T	5	5	10	0	1	11	0	0
21	21238404	.	C	T	7	3	10	0	0	10	0	0
21	21239969	.	A	G	4	6	10	0	0	10	0	0
21	21240046	.	G	A	0	3	3	0	3	6	0	0
21	21240079	.	G	A	5	3	8	0	0	8	0	0
21	21240166	.	A	G	1	2	3	0	0	3	0	0
21	21240379	.	C	T	1	3	4	0	1	5	0	0
21	21240568	.	C	T	9	3	12	0	0	12	0	0
21	21240927	.	C	G	8	8	16	0	0	16	0	0
21	21241412	.	A	T	4	6	10	0	1	11	0	0
21	21241747	.	T	C	17	6	23	0	0	23	0	0
21	21269306	.	G	A	6	3	9	0	0	9	0	0
21	21269737	.	A	G	2	5	7	0	0	7	0	0
21	21269825	.	T	C	0	9	9	0	0	9	0	0
21	21269834	.	G	C	2	10	12	0	0	12	0	0
21	21272549	.	C	T	9	5	14	0	1	15	0	0
21	21279262	.	G	T	0	2	2	0	9	11	0	0
21	21279368	.	G	A	2	5	7	0	9	16	0	0
21	21279396	.	C	A	10	5	15	0	2	17	0	0
21	21279582	.	G	A	3	2	5	0	0	5	0	0
21	21279791	.	T	C	5	2	7	0	1	8	0	0
21	21294260	.	C	T	10	11	21	0	1	22	0	0
21	21294299	.	C	T	13	7	20	0	0	20	0	0
21	21295195	.	A	C	8	6	14	0	0	14	0	0
21	21297358	.	G	T	8	6	14	0	3	17	0	0
21	21297635	.	C	T	14	5	19	0	2	22	1	0
21	21297790	.	T	C	3	12	15	0	0	16	1	0
21	21297963	.	G	C	3	4	7	0	0	7	0	0
21	21298249	.	T	C	7	11	18	0	2	20	0	0
21	21298427	.	G	A	8	11	19	0	0	19	0	0
21	21298488	.	C	T	8	10	18	0	0	18	0	0
21	21298633	.	G	A	6	4	10	0	0	10	0	0
21	21298703	.	C	A	6	6	12	0	0	12	0	0
21	21298811	.	A	T	7	8	15	0	1	16	0	0
21	21298824	.	G	A	6	5	11	0	1	12	0	0
21	21313784	.	A	G	4	0	4	0	4	8	0	0
21	21314061	.	A	G	3	2	5	0	0	5	0	0
21	21315761	.	G	C	2	3	5	0	0	5	0	0
21	21343266	.	A	G	4	6	10	0	0	10	0	0
21	21450574	.	C	T	10	9	19	0	0	19	0	0
21	21450735	.	A	G	3	4	7	0	0	7	0	0
21	21451013	.	T	C	6	0	6	0	3	9	0	0
21	21451025	.	C	A	5	3	8	0	1	9	0	0
21	21525664	.	T	C	5	6	11	0	0	11	0	0
21	21525887	.	T	C	6	3	9	0	1	10	0	0
21	21525895	.	A	G	6	4	10	0	0	10	0	0
21	21527417	.	A	G	2	2	4	0	0	4	0	0
21	21615351	.	T	G	4	3	7	0	0	7	0	0
21	21633668	.	G	A	1	5	6	0	0	6	0	0
21	21633774	.	G	A	7	3	10	0	0	10	0	0
21	21633825	.	T	A	3	3	6	0	1	7	0	0
21	21640613	.	G	A	1	2	3	0	0	3	0	0
21	21745489	.	T	G	4	1	5	0	1	6	0	0
21	21745498	.	G	A	4	1	5	0	0	5	0	0
21	21745960	.	G	A	1	4	5	0	2	7	0	0
21	21750684	.	T	C	5	4	9	0	0	9	0	0
21	21750702	.	A	G	5	3	8	0	1	9	0	0
21	21751303	.	A	G	3	3	6	0	0	6	0	0
21	21754470	.	T	C	11	7	18	0	0	18	0	0
21	21754488	.	G	A	12	3	15	0	0	15	0	0
21	21794194	.	G	C	6	2	8	0	0	8	0	0
21	21794494	.	G	T	0	2	2	0	2	4	0	0
21	21818189	.	A	G	1	2	3	0	0	3	0	0
21	21820136	.	A	G	4	3	7	0	1	8	0	0
21	21820167	.	C	T	1	2	3	0	2	5	0	0
21	21821291	.	C	T	3	3	6	0	0	6	0	0
21	22030596	.	A	G	12	0	12	0	9	21	0	0
21	22038375	.	C	T	29	11	40	0	3	43	0	0
21	22082257	.	C	T	15	24	39	0	2	41	0	0
21	22099610	.	A	G	3	8	11	0	2	13	0	0
21	22100149	.	G	A	13	5	18	1	9	28	0	0
21	22101271	.	A	G	20	30	50	0	3	53	0	0
21	22101304	.	G	A	25	28	53	0	0	53	0	0
21	22101387	.	A	T	22	23	45	0	3	48	0	0
21	22101471	.	G	A	26	34	60	0	0	60	0	0
21	22101540	.	G	A	20	40	60	0	3	63	0	0
21	22101637	.	T	C	25	0	25	0	29	54	0	0
21	22101665	.	G	C	23	22	45	0	0	45	0	0
21	22101708	.	C	T	22	11	33	0	1	34	0	0
21	22101776	.	G	A	29	18	47	0	0	47	0	0
21	22101827	.	C	G	9	25	34	0	26	60	0	0
21	22101917	.	A	T	35	21	56	0	3	59	0	0
21	22102037	.	G	A	29	25	54	0	1	55	0	0
21	22102044	.	C	T	2	23	25	0	30	55	0	0
21	22102154	.	C	A	15	23	38	0	2	40	0	0
21	22102261	.	G	T	21	36	57	0	1	58	0	0
21	22102281	.	A	C	20	33	53	0	1	54	0	0
21	22102361	.	C	G	23	24	47	0	1	48	0	0
21	22102377	.	T	G	21	22	43	0	4	47	0	0
21	22102405	.	C	T	23	23	46	0	2	48	0	0
21	22102515	.	T	A	8	29	37	0	1	38	0	0
21	22102542	.	C	T	12	30	42	0	0	42	0	0
21	22102653	.	A	G	12	20	32	0	1	33	0	0
21	22102838	.	T	G	23	20	43	0	1	44	0	0
21	22102931	.	A	G	23	27	50	0	8	58	0	0
21	22110005	.	C	T	19	21	40	0	0	40	0	0
21	22110113	.	C	T	18	21	39	0	4	43	0	0
21	22111754	.	A	T	19	13	32	0	5	37	0	0
21	22116280	.	A	T	5	2	7	0	1	8	0	0
21	22116586	.	G	A	6	2	8	0	1	9	0	0
21	22116611	.	C	T	4	3	7	0	0	7	0	0
21	22116684	.	A	T	3	3	6	0	1	7	0	0
21	22117018	.	A	G	2	3	5	0	0	5	0	0
21	22132862	.	C	G	3	0	3	0	3	6	0	0
21	22138571	.	C	G	1	3	4	0	1	5	0	0
21	22140654	.	C	G	7	6	13	0	0	13	0	0
21	22140937	.	C	A	9	8	17	0	1	18	0	0
21	22142362	.	A	G	7	7	14	0	0	14	0	0
21	22142820	.	G	A	1	9	10	0	10	20	0	0
21	22314941	.	C	G	1	2	3	0	0	3	0	0
21	22330108	.	T	G	3	2	5	0	0	5	0	0
21	22330468	.	C	A	2	2	4	0	1	5	0	0
21	22330581	.	A	G	2	2	4	0	0	4	0	0
21	22330588	.	A	G	2	2	4	0	0	4	0	0
21	22346512	.	G	T	6	4	10	0	1	11	0	0
21	22386900	.	C	T	1	3	4	0	0	4	0	0
21	22386902	.	C	A	1	3	4	0	0	4	0	0
21	22387825	.	G	A	2	5	7	0	1	8	0	0
21	22387834	.	T	C	1	4	5	0	0	5	0	0
21	22391091	.	G	T	1	2	3	0	0	3	0	0
21	22404800	.	G	C	0	2	2	0	2	4	0	0
21	22404852	.	T	C	1	4	5	0	0	5	0	0
21	22404855	.	T	C	1	4	5	0	0	5	0	0
21	22405232	.	T	A	4	3	7	0	0	7	0	0
21	22406755	.	T	C	5	2	7	0	0	7	0	0
21	22407000	.	T	C	4	5	9	0	4	13	0	0
21	22410965	.	T	A	10	3	13	0	0	13	0	0
21	22412304	.	T	C	14	14	28	1	1	30	0	0
21	22412376	.	T	G	12	0	12	0	17	29	0	0
21	22421853	.	T	C	7	4	11	0	0	11	0	0
21	22422149	.	T	C	8	17	25	0	0	25	0	0
21	22422184	.	A	G	12	14	26	0	0	26	0	0
21	22422243	.	G	A	12	11	23	0	1	24	0	0
21	22422407	.	T	G	16	15	31	0	0	31	0	0
21	22448380	.	C	G	8	10	18	0	0	18	0	0
21	22448445	.	A	T	4	6	10	0	0	10	0	0
21	22448574	.	A	G	5	5	10	0	0	10	0	0
21	22448624	.	T	G	4	6	10	0	1	11	0	0
21	22448625	.	A	T	3	6	9	0	1	11	1	0
21	22448808	.	A	G	3	4	7	0	0	7	0	0
21	22448961	.	C	T	8	7	15	0	0	15	0	0
21	22454360	.	G	A	1	6	7	0	0	7	0	0
21	22460258	.	C	T	2	5	7	0	0	7	0	0
21	22467239	.	C	T	1	4	5	0	2	7	0	0
21	22467290	.	T	C	1	0	1	0	5	6	0	0
21	22467308	.	C	T	1	4	5	0	1	6	0	0
21	22478215	.	C	T	0	2	2	0	1	3	0	0
21	22479385	.	T	C	3	3	6	0	0	6	0	0
21	22554375	.	T	C	1	0	1	0	3	4	0	0
21	22598794	.	A	C	2	2	4	0	0	4	0	0
21	22630301	.	T	C	1	2	3	0	1	4	0	0
21	22630324	.	C	T	5	3	8	0	0	8	0	0
21	22630715	.	A	T	1	5	6	0	0	6	0	0
21	22630864	.	G	A	3	7	10	0	0	10	0	0
21	22631163	.	T	C	20	18	38	0	1	39	0	0
21	22631172	.	A	T	15	18	33	0	5	38	0	0
21	22633430	.	C	T	10	15	25	0	0	25	0	0
21	22633734	.	A	G	14	14	28	0	2	30	0	0
21	22633773	.	T	C	14	12	26	0	2	29	1	0
21	22634136	.	C	G	13	8	21	0	1	22	0	0
21	22634205	.	G	T	8	7	15	0	3	18	0	0
21	22634243	.	G	A	10	7	17	0	3	20	0	0
21	22634289	.	C	T	13	8	21	0	1	22	0	0
21	22637222	.	A	T	1	2	3	0	0	3	0	0
21	22697107	.	C	T	3	4	7	0	0	7	0	0
21	22697161	.	T	C	6	3	9	0	0	9	0	0
21	22698790	.	T	C	6	4	10	0	0	10	0	0
21	22699471	.	T	C	8	3	11	0	1	12	0	0
21	22699491	.	T	C	9	6	15	0	0	15	0	0
21	22699512	.	T	C	12	6	18	1	0	19	0	0
21	22699556	.	A	G	4	7	11	1	1	13	0	0
21	22699563	.	C	T	5	6	11	1	1	13	0	0
21	22699595	.	C	A	4	8	12	0	1	13	0	0
21	22699608	.	T	C	5	9	14	0	0	14	0	0
21	22699631	.	C	T	7	7	14	0	1	15	0	0
21	22699853	.	G	T	0	4	4	0	6	10	0	0
21	22699916	.	G	A	4	5	9	0	0	9	0	0
21	22699956	.	T	G	4	7	11	0	0	11	0	0
21	22702816	.	T	C	11	6	17	0	1	18	0	0
21	22704918	.	G	A	7	2	9	0	0	9	0	0
21	22704924	.	C	T	6	2	8	0	0	8	0	0
21	22706396	.	G	T	2	4	6	0	0	6	0	0
21	22706480	.	G	A	1	4	5	0	1	6	0	0
21	22706633	.	A	C	0	2	2	0	1	3	0	0
21	22708855	.	T	G	3	4	7	0	0	7	0	0
21	22708876	.	C	A	0	4	4	0	3	7	0	0
21	22785296	.	A	G	5	0	5	0	6	11	0	0
21	22785326	.	C	T	7	5	12	0	0	12	0	0
21	22791174	.	A	C	5	3	8	0	0	8	0	0
21	22793229	.	A	G	4	0	4	0	6	10	0	0
21	22793238	.	A	G	3	7	10	0	1	11	0	0
21	22795009	.	T	C	6	13	19	0	2	21	0	0
21	22795107	.	G	A	2	6	8	0	6	14	0	0
21	22795324	.	C	T	9	8	17	0	2	19	0	0
21	22795358	.	T	G	4	11	15	0	0	15	0	0
21	22795392	.	A	T	4	7	11	0	0	11	0	0
21	22795534	.	T	C	7	5	12	0	0	12	0	0
21	22795662	.	T	A	3	2	5	0	0	5	0	0
21	22846910	.	G	A	8	4	12	0	0	12	0	0
21	22846948	.	G	A	6	3	9	0	1	10	0	0
21	22846986	.	T	C	5	7	12	0	1	13	0	0
21	22847022	.	A	T	7	7	14	0	2	16	0	0
21	22847059	.	G	C	15	13	28	0	1	29	0	0
21	22847069	.	A	G	17	12	29	0	2	31	0	0
21	22847128	.	G	C	12	19	31	0	0	31	0	0
21	22847163	.	A	G	5	18	23	0	1	24	0	0
21	22847174	.	G	C	6	17	23	0	0	23	0	0
21	22847207	.	A	G	14	9	23	0	0	23	0	0
21	22847234	.	A	G	17	6	23	0	4	28	1	0
21	22847246	.	G	A	19	7	26	0	3	29	0	0
21	22847969	.	C	T	20	17	37	0	3	40	0	0
21	22847984	.	A	T	22	14	36	0	1	37	0	0
21	22848047	.	C	T	17	14	31	0	2	33	0	0
21	22848293	.	C	T	13	13	26	0	0	26	0	0
21	22848424	.	C	T	10	9	19	0	1	20	0	0
21	22850242	.	G	A	23	18	41	0	0	41	0	0
21	22850422	.	G	A	23	22	45	0	1	46	0	0
21	22876366	.	G	A	1	2	3	0	0	3	0	0
21	22876392	.	A	G	0	2	2	0	1	3	0	0
21	22876417	.	A	G	2	3	5	0	0	5	0	0
21	22876461	.	T	C	1	3	4	0	0	4	0	0
21	22876478	.	G	T	2	2	4	0	0	4	0	0
21	22876502	.	T	A	1	1	2	0	1	3	0	0
21	22877075	.	C	T	3	2	5	0	1	6	0	0
21	22877076	.	C	A	4	2	6	0	0	6	0	0
21	22878844	.	A	C	3	7	10	0	1	11	0	0
21	22878856	.	G	A	6	9	15	0	0	15	0	0
21	22878880	.	C	A	11	14	25	0	0	26	1	0
21	22878994	.	T	C	10	11	21	0	1	22	0	0
21	22879925	.	T	A	5	11	16	0	1	17	0	0
21	22882818	.	A	G	10	0	10	0	5	15	0	0
21	22883854	.	A	T	9	9	18	0	0	18	0	0
21	22886365	.	G	A	18	15	33	0	2	35	0	0
21	22887883	.	C	T	12	10	22	0	0	22	0	0
21	22887951	.	A	G	13	12	25	0	1	26	0	0
21	22888352	.	C	T	8	4	12	1	0	13	0	0
21	22888355	.	T	A	8	4	12	1	0	13	0	0
21	22889238	.	A	C	3	3	6	0	0	6	0	0
21	22891607	.	T	G	2	3	5	0	1	6	0	0
21	22892045	.	G	T	4	2	6	0	0	6	0	0
21	22894768	.	C	T	1	3	4	0	0	4	0	0
21	22894965	.	G	A	2	2	4	0	0	4	0	0
21	22901119	.	G	A	3	2	5	0	1	6	0	0
21	22922682	.	T	C	2	2	4	0	0	4	0	0
21	22922726	.	G	A	2	2	4	0	0	4	0	0
21	22961178	.	T	C	2	7	9	0	0	9	0	0
21	22961233	.	A	T	12	4	16	0	0	16	0	0
21	22965838	.	G	A	7	6	13	0	0	13	0	0
21	22965844	.	G	A	9	6	15	0	0	15	0	0
21	22965891	.	C	A	8	4	12	0	0	12	0	0
21	22969687	.	C	G	4	2	6	0	0	6	0	0
21	23019836	.	T	G	19	17	36	0	1	37	0	0
21	23019988	.	G	A	22	6	28	0	1	29	0	0
21	23020102	.	C	G	22	15	37	0	0	37	0	0
21	23024996	.	A	G	13	11	24	0	0	24	0	0
21	23025197	.	T	A	7	7	14	0	1	15	0	0
21	23027023	.	A	T	7	7	14	0	5	19	0	0
21	23028342	.	A	G	13	11	24	0	1	25	0	0
21	23028399	.	C	T	1	13	14	0	16	30	0	0
21	23028432	.	G	A	16	13	29	0	2	31	0	0
21	23029206	.	A	G	11	13	24	0	0	24	0	0
21	23029476	.	T	A	11	9	20	0	1	21	0	0
21	23034852	.	A	G	8	8	16	0	0	16	0	0
21	23036393	.	A	T	3	3	6	0	1	7	0	0
21	23036534	.	G	A	7	2	9	0	0	9	0	0
21	23037906	.	T	C	11	15	26	0	0	26	0	0
21	23040517	.	A	G	5	7	12	0	0	12	0	0
21	23040529	.	C	T	5	7	12	0	0	12	0	0
21	23040993	.	T	G	3	3	6	0	1	7	0	0
21	23041283	.	G	A	2	7	9	0	1	10	0	0
21	23041602	.	T	A	6	4	10	0	0	10	0	0
21	23042616	.	C	T	1	2	3	0	4	7	0	0
21	23043466	.	A	G	4	3	7	0	0	7	0	0
21	23043777	.	G	A	5	3	8	0	1	9	0	0
21	23046406	.	A	T	1	2	3	0	1	4	0	0
21	23046424	.	C	T	1	2	3	0	1	4	0	0
21	23160851	.	A	T	10	15	25	0	0	25	0	0
21	23161061	.	G	A	15	15	30	0	0	30	0	0
21	23162023	.	C	T	6	10	16	0	2	18	0	0
21	23162395	.	T	G	9	7	16	1	2	19	0	0
21	23163534	.	T	C	12	0	12	0	10	22	0	0
21	23163564	.	T	A	13	12	25	0	0	25	0	0
21	23163694	.	G	A	6	8	14	0	0	14	0	0
21	23163841	.	A	T	12	12	24	0	1	25	0	0
21	23163884	.	A	G	7	6	13	0	1	14	0	0
21	23163885	.	A	G	7	7	14	0	0	14	0	0
21	23163938	.	G	T	18	10	28	0	1	29	0	0
21	23163990	.	A	T	19	7	26	0	2	28	0	0
21	23169835	.	G	A	13	12	25	0	0	25	0	0
21	23175440	.	C	T	16	5	21	0	2	23	0	0
21	23305121	.	A	C	4	3	7	0	1	8	0	0
21	23307764	.	T	A	3	2	5	0	0	5	0	0
21	23338241	.	G	A	5	7	12	0	2	14	0	0
21	23350204	.	G	A	8	11	19	0	0	19	0	0
21	23352629	.	A	G	9	12	21	0	0	21	0	0
21	23352707	.	A	G	5	13	18	0	1	19	0	0
21	23352749	.	G	A	5	3	8	0	1	9	0	0
21	23352791	.	A	C	2	1	3	0	1	4	0	0
21	23367200	.	C	T	19	19	38	0	3	41	0	0
21	23367218	.	T	G	19	16	35	0	1	36	0	0
21	23467074	.	A	G	5	2	7	0	2	9	0	0
21	23469825	.	T	C	5	0	5	0	4	9	0	0
21	23475195	.	G	A	1	3	4	0	0	4	0	0
21	24531725	.	A	T	2	4	6	0	1	7	0	0
21	24531816	.	G	T	2	4	6	0	1	7	0	0
21	24531861	.	C	G	3	5	8	0	0	8	0	0
21	24532011	.	T	A	1	4	5	0	0	5	0	0
21	24532219	.	A	G	4	2	6	0	0	6	0	0
21	24532288	.	G	A	2	2	4	0	0	4	0	0
21	24532321	.	T	C	1	3	4	0	0	4	0	0
21	24536365	.	G	T	3	5	8	0	0	8	0	0
21	24536809	.	G	A	13	14	27	0	1	28	0	0
21	24536943	.	T	C	4	8	12	0	1	13	0	0
21	24539908	.	T	A	2	4	6	0	1	7	0	0
21	24539983	.	A	G	6	12	18	0	0	18	0	0
21	24540990	.	G	C	6	7	13	0	1	14	0	0
21	24541141	.	C	T	9	4	13	0	0	13	0	0
21	24541279	.	A	G	13	6	19	0	1	20	0	0
21	24541606	.	T	A	5	7	12	0	1	13	0	0
21	24545622	.	A	G	3	6	9	0	0	9	0	0
21	24548695	.	C	T	0	2	2	0	1	3	0	0
21	24548716	.	C	T	2	2	4	0	0	4	0	0
21	24548838	.	A	C	2	0	2	0	5	7	0	0
21	24554450	.	C	T	3	2	5	0	0	5	0	0
21	25037404	.	A	C	2	3	5	0	0	5	0	0
21	25037557	.	C	A	1	3	4	0	0	4	0	0
21	25043381	.	T	A	2	2	4	0	0	4	0	0
21	25044196	.	C	T	2	4	6	0	1	7	0	0
21	25044375	.	G	A	2	3	5	0	0	5	0	0
21	25044433	.	T	A	3	1	4	0	1	5	0	0
21	25044434	.	C	A	3	2	5	0	0	5	0	0
21	25044523	.	G	A	0	3	3	0	5	8	0	0
21	25045270	.	G	A	3	3	6	0	1	7	0	0
21	25045276	.	T	C	3	4	7	0	0	7	0	0
21	25046179	.	A	G	2	0	2	0	2	4	0	0
21	25046210	.	G	C	3	2	5	0	1	6	0	0
21	25046672	.	A	G	5	4	9	0	0	9	0	0
21	25055553	.	T	C	2	6	8	0	0	8	0	0
21	25057217	.	G	T	9	5	14	0	0	14	0	0
21	25083307	.	C	T	3	3	6	0	0	6	0	0
21	25083308	.	A	C	3	3	6	0	0	6	0	0
21	25083391	.	A	T	2	2	4	0	0	4	0	0
21	25085598	.	C	T	3	3	6	0	0	6	0	0
21	25092333	.	T	G	7	6	13	0	0	13	0	0
21	25092667	.	C	T	10	4	14	0	0	14	0	0
21	25103396	.	C	A	11	12	23	0	0	23	0	0
21	25103457	.	G	A	13	7	20	0	1	21	0	0
21	25103676	.	T	A	12	12	24	0	1	25	0	0
21	25110372	.	G	A	10	5	15	0	1	16	0	0
21	25115692	.	G	T	13	17	30	0	1	31	0	0
21	25117887	.	G	T	8	8	16	0	0	16	0	0
21	25117926	.	T	C	11	6	17	0	0	17	0	0
21	25117959	.	G	A	10	14	24	0	0	24	0	0
21	25118065	.	G	A	13	6	19	0	2	21	0	0
21	25125110	.	C	T	2	3	5	0	0	5	0	0
21	25125432	.	G	A	4	2	6	0	0	6	0	0
21	25127542	.	G	A	1	3	4	0	0	4	0	0
21	25135777	.	A	G	2	0	2	0	6	8	0	0
21	25142536	.	T	A	11	4	15	0	0	15	0	0
21	25156379	.	C	T	9	8	17	0	0	17	0	0
21	25181296	.	C	G	2	2	4	0	0	4	0	0
21	25181366	.	A	G	3	5	8	0	0	8	0	0
21	25181643	.	T	A	9	17	26	0	0	26	0	0
21	25182086	.	G	A	13	10	23	0	4	27	0	0
21	25182091	.	C	A	12	13	25	0	1	26	0	0
21	25182207	.	A	T	10	7	17	0	2	19	0	0
21	25182552	.	A	T	4	3	7	0	2	9	0	0
21	25182595	.	T	C	5	7	12	0	0	12	0	0
21	25182598	.	G	A	5	8	13	0	0	13	0	0
21	25182721	.	T	C	4	5	9	0	0	9	0	0
21	25182735	.	T	G	3	0	3	0	4	7	0	0
21	25182761	.	T	C	3	4	7	0	0	7	0	0
21	25182858	.	A	C	4	5	9	0	0	9	0	0
21	25183180	.	T	C	6	12	18	0	1	19	0	0
21	25183224	.	T	A	12	10	22	0	1	23	0	0
21	25183225	.	A	G	12	10	22	0	1	23	0	0
21	25183292	.	T	A	1	2	3	0	1	4	0	0
21	25207925	.	A	G	2	11	13	0	2	15	0	0
21	25207931	.	A	G	3	12	15	0	1	16	0	0
21	25210921	.	A	G	4	6	10	0	0	10	0	0
21	25210936	.	T	C	6	0	6	0	5	11	0	0
21	25247236	.	C	T	2	4	6	0	2	8	0	0
21	25247433	.	C	A	0	8	8	0	6	14	0	0
21	25250497	.	C	T	0	5	5	0	7	12	0	0
21	25250539	.	G	A	7	6	13	0	0	13	0	0
21	25250749	.	C	T	0	5	5	0	3	8	0	0
21	25250983	.	G	A	6	6	12	0	1	13	0	0
21	25251013	.	G	A	8	5	13	0	2	15	0	0
21	25251034	.	G	T	8	4	12	0	0	12	0	0
21	25251082	.	T	C	2	10	12	0	0	12	0	0
21	25254915	.	G	C	2	3	5	0	0	5	0	0
21	25256907	.	C	T	3	3	6	0	0	6	0	0
21	25257059	.	T	C	5	6	11	0	0	11	0	0
21	25257086	.	C	T	4	6	10	0	0	10	0	0
21	25259454	.	A	G	2	2	4	0	0	4	0	0
21	25265034	.	C	T	1	2	3	0	0	3	0	0
21	25380894	.	G	T	5	5	10	0	0	10	0	0
21	25384076	.	T	C	23	22	45	2	1	48	0	0
21	25386752	.	T	C	20	23	43	0	2	45	0	0
21	25399873	.	A	G	24	15	39	0	2	41	0	0
21	25407031	.	G	C	19	1	20	0	19	39	0	0
21	25407216	.	C	G	14	32	46	0	1	47	0	0
21	25425528	.	C	A	8	8	16	0	1	17	0	0
21	25425773	.	C	A	18	12	30	1	2	33	0	0
21	25425798	.	T	C	11	14	25	1	1	27	0	0
21	25425826	.	G	T	21	7	28	1	1	30	0	0
21	25425848	.	C	A	0	20	20	0	10	30	0	0
21	25425873	.	A	T	8	19	27	0	2	29	0	0
21	25439974	.	T	A	5	2	7	0	15	22	0	0
21	25440049	.	G	A	22	17	39	0	2	41	0	0
21	25440079	.	A	C	22	0	22	0	22	44	0	0
21	25440085	.	G	A	22	22	44	0	2	46	0	0
21	25449464	.	G	A	19	19	38	0	0	38	0	0
21	25450846	.	G	A	14	18	32	0	0	32	0	0
21	25451002	.	A	G	9	11	20	0	0	20	0	0
21	25452558	.	G	A	14	12	26	0	1	27	0	0
21	25458902	.	T	A	6	6	12	1	3	16	0	0
21	25460713	.	G	A	15	18	33	0	2	35	0	0
21	25460734	.	G	A	17	18	35	0	2	37	0	0
21	25463338	.	A	G	13	12	25	0	2	27	0	0
21	25470158	.	G	A	6	9	15	0	0	15	0	0
21	25476597	.	G	A	9	11	20	0	0	20	0	0
21	25492981	.	C	T	4	7	11	0	1	12	0	0
21	25533882	.	G	A	1	2	3	0	0	3	0	0
21	25538219	.	A	C	2	3	5	0	0	5	0	0
21	25538237	.	G	A	0	3	3	0	3	6	0	0
21	25540822	.	C	A	2	4	6	0	0	6	0	0
21	25540846	.	A	C	2	5	7	0	0	7	0	0
21	25540900	.	G	A	1	1	2	0	1	3	0	0
21	25541473	.	C	T	6	3	9	0	0	9	0	0
21	25541704	.	T	C	4	3	7	0	0	7	0	0
21	25542356	.	C	A	2	2	4	0	0	4	0	0
21	25542703	.	G	T	8	3	11	0	1	12	0	0
21	25542711	.	T	C	8	5	13	0	0	13	0	0
21	25543133	.	A	G	3	0	3	0	2	5	0	0
21	25561362	.	G	A	4	5	9	0	0	9	0	0
21	25561586	.	G	A	16	9	25	0	0	25	0	0
21	25561775	.	T	C	21	0	21	0	19	40	0	0
21	25570323	.	G	A	9	17	26	0	7	33	0	0
21	25570434	.	G	A	13	9	22	0	1	23	0	0
21	25571392	.	G	A	8	3	11	0	0	11	0	0
21	25571436	.	T	A	5	7	12	0	0	12	0	0
21	25571919	.	T	C	2	5	7	0	0	7	0	0
21	25572145	.	C	T	2	8	10	0	0	10	0	0
21	25572785	.	G	T	4	4	8	0	2	10	0	0
21	25573031	.	A	C	7	6	13	0	2	15	0	0
21	25605515	.	T	A	4	3	7	0	2	9	0	0
21	25605551	.	A	G	3	2	5	0	0	5	0	0
21	25605571	.	T	A	4	3	7	0	0	7	0	0
21	25605647	.	A	G	3	3	6	1	0	7	0	0
21	25609470	.	A	T	6	3	9	0	0	9	0	0
21	25610512	.	T	C	14	0	14	0	7	21	0	0
21	25611659	.	A	G	6	5	11	0	0	11	0	0
21	25611931	.	T	C	3	3	6	0	1	7	0	0
21	25617544	.	G	C	4	2	6	0	0	6	0	0
21	25620446	.	T	C	3	3	6	0	0	6	0	0
21	25620573	.	A	G	6	3	9	0	0	9	0	0
21	25622880	.	G	A	1	4	5	0	0	5	0	0
21	25645217	.	A	C	10	5	15	0	1	16	0	0
21	25645555	.	T	G	22	19	41	0	0	41	0	0
21	25645655	.	G	C	15	13	28	0	0	28	0	0
21	25663198	.	A	G	3	1	4	0	1	5	0	0
21	25663199	.	G	C	3	1	4	0	1	5	0	0
21	25671377	.	T	C	2	2	4	0	1	5	0	0
21	25677015	.	T	G	4	5	9	0	0	9	0	0
21	25685385	.	G	T	2	2	4	0	0	4	0	0
21	25713908	.	T	C	5	9	14	0	0	14	0	0
21	25722719	.	C	T	4	5	9	0	1	10	0	0
21	25796628	.	G	T	2	2	4	0	0	4	0	0
21	25817247	.	A	G	6	2	8	0	0	8	0	0
21	25817832	.	A	G	2	2	4	0	0	4	0	0
21	25817842	.	A	G	1	3	4	0	0	4	0	0
21	25818170	.	G	C	2	5	7	0	0	7	0	0
21	25818293	.	C	A	2	3	5	0	0	5	0	0
21	25818322	.	A	T	3	2	5	0	2	7	0	0
21	25818509	.	T	C	1	8	9	0	0	9	0	0
21	25819439	.	G	A	3	2	5	0	0	5	0	0
21	26014378	.	A	G	3	0	3	0	4	7	0	0
21	26021546	.	T	C	1	3	4	0	0	4	0	0
21	26021662	.	T	A	3	4	7	0	0	7	0	0
21	26021867	.	A	T	2	2	4	0	0	4	0	0
21	26022126	.	G	A	8	2	10	0	0	10	0	0
21	26022127	.	A	T	7	2	9	0	0	9	0	0
21	26023146	.	G	A	4	7	11	0	2	13	0	0
21	26023147	.	T	A	4	7	11	0	1	12	0	0
21	26023231	.	G	A	3	5	8	0	4	12	0	0
21	26026171	.	A	G	1	5	6	0	0	6	0	0
21	26029021	.	T	C	3	3	6	0	0	6	0	0
21	26030687	.	T	C	1	4	5	0	0	5	0	0
21	26033800	.	C	T	3	3	6	0	0	6	0	0
21	26041741	.	C	T	6	10	16	0	0	16	0	0
21	26043333	.	A	G	5	5	10	0	0	10	0	0
21	26044146	.	G	T	4	2	6	0	0	6	0	0
21	26050097	.	C	T	6	4	10	0	0	10	0	0
21	26050115	.	C	T	10	3	13	0	0	13	0	0
21	26050415	.	T	G	6	7	13	0	3	16	0	0
21	26053929	.	C	A	21	15	36	0	0	36	0	0
21	26054453	.	A	G	21	4	25	0	17	42	0	0
21	26057490	.	T	A	11	18	29	0	0	29	0	0
21	26057707	.	C	T	5	15	20	1	7	28	0	0
21	26058121	.	C	T	10	13	23	0	2	26	1	0
21	26058204	.	G	A	17	9	26	0	8	34	0	0
21	26058275	.	G	T	12	19	31	0	3	34	0	0
21	26058378	.	C	T	8	7	15	0	0	15	0	0
21	26058386	.	C	A	10	7	17	0	0	17	0	0
21	26073115	.	A	T	23	28	51	0	0	51	0	0
21	26080547	.	A	G	8	9	17	0	0	17	0	0
21	26089689	.	G	A	2	3	5	0	0	5	0	0
21	26152862	.	C	T	4	5	9	0	4	13	0	0
21	26153049	.	C	T	12	8	20	0	1	21	0	0
21	26153123	.	G	A	10	12	22	0	1	23	0	0
21	26161272	.	G	A	4	3	7	0	1	8	0	0
21	26184258	.	T	A	6	8	14	0	0	14	0	0
21	26184259	.	G	T	6	8	14	0	0	14	0	0
21	26389462	.	C	T	22	16	38	0	1	39	0	0
21	26390614	.	G	A	22	10	32	0	2	34	0	0
21	26390620	.	A	G	22	11	33	0	1	34	0	0
21	26401602	.	C	A	3	4	7	0	0	7	0	0
21	26415195	.	C	T	7	11	18	0	1	19	0	0
21	26417854	.	A	T	9	4	13	0	0	13	0	0
21	26429227	.	G	A	1	2	3	0	0	3	0	0
21	26441889	.	A	G	1	3	4	0	0	4	0	0
21	26483092	.	A	G	1	3	4	0	0	4	0	0
21	26522682	.	G	A	9	9	18	0	0	18	0	0
21	26523233	.	C	T	8	11	19	0	1	20	0	0
21	26523454	.	A	T	8	7	15	0	0	15	0	0
21	26524932	.	G	T	9	9	18	0	1	19	0	0
21	26527782	.	G	A	1	10	11	0	10	21	0	0
21	26528092	.	T	A	13	6	19	0	2	21	0	0
21	26530332	.	G	A	0	6	6	0	11	17	0	0
21	26530663	.	T	A	10	12	22	0	1	23	0	0
21	26530723	.	G	T	15	6	21	0	1	22	0	0
21	26530737	.	G	C	8	15	23	0	0	23	0	0
21	26530758	.	T	C	11	7	18	0	0	18	0	0
21	26531014	.	G	A	11	9	20	0	2	22	0	0
21	26531102	.	A	G	5	10	15	1	0	16	0	0
21	26531299	.	T	A	5	5	10	0	2	12	0	0
21	26545469	.	C	T	5	8	13	0	0	13	0	0
21	26545632	.	T	C	4	2	6	0	0	6	0	0
21	26549764	.	A	G	4	8	12	0	1	13	0	0
21	26549972	.	T	C	8	3	11	0	0	11	0	0
21	26553406	.	C	T	10	3	13	0	0	13	0	0
21	26553425	.	T	C	10	4	14	0	1	15	0	0
21	26553466	.	A	G	6	4	10	0	0	10	0	0
21	26553554	.	A	C	5	6	11	0	2	13	0	0
21	26553577	.	A	T	8	5	13	0	1	14	0	0
21	26553794	.	C	T	12	5	17	0	0	17	0	0
21	26553879	.	G	T	9	5	14	0	0	14	0	0
21	26553971	.	A	T	4	2	6	0	0	6	0	0
21	26554116	.	T	C	4	4	8	0	1	9	0	0
21	26554139	.	C	T	2	3	5	0	0	5	0	0
21	26621139	.	G	A	1	2	3	0	1	4	0	0
21	26634042	.	C	T	14	9	23	0	3	26	0	0
21	26662745	.	G	A	25	18	43	0	3	46	0	0
21	26663161	.	G	C	32	26	58	0	0	58	0	0
21	26664625	.	C	T	41	27	68	0	1	69	0	0
21	26664770	.	C	T	13	22	35	0	10	45	0	0
21	26665046	.	G	T	6	7	13	0	0	13	0	0
21	26665092	.	C	T	0	7	7	0	5	12	0	0
21	26665364	.	T	A	12	6	18	0	0	18	0	0
21	26665661	.	A	G	12	10	22	0	3	25	0	0
21	26665745	.	C	A	3	23	26	0	13	39	0	0
21	26665790	.	G	A	20	27	47	0	1	48	0	0
21	26665808	.	C	T	24	21	45	0	6	51	0	0
21	26665986	.	C	A	20	14	34	0	3	37	0	0
21	26668766	.	T	A	9	4	13	0	1	14	0	0
21	26668826	.	T	G	7	4	11	0	0	11	0	0
21	26668855	.	T	C	5	3	8	0	0	8	0	0
21	26669289	.	A	T	2	2	4	0	1	5	0	0
21	26669394	.	C	T	3	5	8	0	0	8	0	0
21	26669421	.	T	C	5	6	11	0	2	13	0	0
21	26669480	.	C	A	8	6	14	0	0	14	0	0
21	26669495	.	G	A	6	6	12	0	0	12	0	0
21	26669926	.	G	T	4	3	7	0	0	7	0	0
21	26670145	.	T	C	4	0	4	1	9	14	0	0
21	26670265	.	T	A	11	7	18	0	0	18	0	0
21	26670409	.	A	T	3	2	5	0	0	5	0	0
21	26670418	.	C	T	3	2	5	0	0	5	0	0
21	26670444	.	T	A	2	3	5	0	0	5	0	0
21	26671993	.	A	G	7	5	12	0	1	13	0	0
21	26672014	.	G	A	4	4	8	0	1	9	0	0
21	26672160	.	C	T	3	3	6	0	0	6	0	0
21	26672184	.	C	T	0	3	3	0	5	8	0	0
21	26672217	.	G	C	4	3	7	0	0	7	0	0
21	26672270	.	T	C	3	2	5	0	0	5	0	0
21	26672319	.	C	G	3	3	6	0	0	6	0	0
21	26672409	.	C	T	1	2	3	0	1	4	0	0
21	26672611	.	G	A	4	3	7	0	0	7	0	0
21	26677717	.	C	T	2	4	6	0	1	7	0	0
21	26677753	.	A	T	4	6	10	0	1	11	0	0
21	26678906	.	G	A	2	6	8	0	1	9	0	0
21	26678965	.	C	T	2	8	10	0	10	20	0	0
21	26684350	.	T	A	3	9	12	0	1	13	0	0
21	26685383	.	C	T	8	5	13	0	0	13	0	0
21	26689440	.	G	A	3	5	8	0	0	8	0	0
21	26689875	.	T	A	2	3	5	0	0	5	0	0
21	26691889	.	T	C	5	6	11	0	2	13	0	0
21	26691898	.	A	T	7	5	12	0	0	12	0	0
21	26691926	.	A	T	4	3	7	0	0	7	0	0
21	26697537	.	C	T	1	3	4	0	0	4	0	0
21	26697686	.	G	T	28	32	60	2	4	66	0	0
21	26706481	.	C	T	34	26	60	0	5	65	0	0
21	26706482	.	C	T	36	27	63	0	2	65	0	0
21	26706805	.	C	T	28	20	48	0	5	53	0	0
21	26706846	.	T	A	28	19	47	0	1	48	0	0
21	26710071	.	A	G	13	19	32	0	0	32	0	0
21	26710194	.	T	A	22	18	40	0	1	41	0	0
21	26710239	.	G	A	22	17	39	0	0	39	0	0
21	26710496	.	C	A	29	20	49	0	1	50	0	0
21	26714361	.	C	T	4	16	20	0	15	35	0	0
21	26714373	.	C	A	14	20	34	0	0	34	0	0
21	26722212	.	G	C	16	6	22	0	0	22	0	0
21	26722269	.	C	T	5	13	18	0	1	19	0	0
21	26722347	.	G	A	4	8	12	0	0	12	0	0
21	26722431	.	T	C	11	4	15	0	0	15	0	0
21	26722625	.	C	T	3	10	13	0	0	13	0	0
21	26722688	.	T	A	8	4	12	0	0	12	0	0
21	26724723	.	G	A	18	10	28	0	5	33	0	0
21	26724833	.	A	G	13	19	32	0	1	33	0	0
21	26725403	.	T	C	18	19	37	0	2	39	0	0
21	26726997	.	C	A	32	33	65	0	5	70	0	0
21	26731236	.	C	A	41	31	72	0	4	76	0	0
21	26731925	.	C	A	29	40	69	0	5	74	0	0
21	26733517	.	A	G	3	2	5	0	1	6	0	0
21	26748227	.	T	C	2	2	4	0	1	5	0	0
21	26750549	.	G	A	1	2	3	0	0	3	0	0
21	26760073	.	G	A	1	2	3	1	1	5	0	0
21	26787885	.	A	T	2	2	4	0	0	4	0	0
21	26908810	.	G	A	17	16	33	0	0	33	0	0
21	26909361	.	G	A	12	13	25	0	0	25	0	0
21	26914870	.	T	G	6	14	20	0	0	21	1	0
21	26914915	.	T	G	11	13	24	0	1	25	0	0
21	26915086	.	G	A	11	7	18	0	0	18	0	0
21	26915203	.	A	G	7	10	17	0	0	17	0	0
21	26915316	.	T	G	3	9	12	0	0	12	0	0
21	26915355	.	G	A	9	5	14	0	0	14	0	0
21	26915956	.	A	T	5	4	9	0	2	11	0	0
21	26916142	.	A	G	1	6	7	0	0	7	0	0
21	26916238	.	C	T	1	9	10	0	4	14	0	0
21	26917948	.	C	T	2	6	8	0	0	8	0	0
21	26917958	.	C	T	0	6	6	0	3	9	0	0
21	26918023	.	G	A	5	4	9	0	0	9	0	0
21	26918684	.	G	A	4	6	10	0	0	10	0	0
21	26927201	.	C	A	2	3	5	0	0	5	0	0
21	26929609	.	C	A	7	2	9	0	0	9	0	0
21	26929610	.	C	G	7	2	9	0	0	9	0	0
21	26961177	.	C	T	14	10	24	0	1	25	0	0
21	26961515	.	C	T	8	11	19	0	1	20	0	0
21	26961548	.	C	A	11	13	24	0	0	24	0	0
21	26965636	.	C	T	9	14	23	0	0	23	0	0
21	26965918	.	A	T	18	13	31	0	2	33	0	0
21	26966193	.	A	T	18	11	29	0	1	30	0	0
21	26966918	.	C	T	18	6	24	0	0	24	0	0
21	26967230	.	C	T	6	11	17	0	0	17	0	0
21	26967265	.	T	A	11	10	21	0	0	21	0	0
21	26967426	.	G	A	17	11	28	0	2	30	0	0
21	26967899	.	A	C	28	31	59	0	5	64	0	0
21	26968042	.	G	A	19	19	38	0	3	41	0	0
21	26968127	.	G	T	21	17	38	0	3	41	0	0
21	26968264	.	G	A	21	16	37	0	0	37	0	0
21	26968344	.	G	A	18	11	29	0	2	31	0	0
21	26995869	.	G	A	8	5	13	0	0	13	0	0
21	26996005	.	A	G	13	8	21	0	2	23	0	0
21	26996849	.	C	A	0	18	18	0	19	37	0	0
21	26996893	.	T	C	16	1	17	0	26	43	0	0
21	27047839	.	A	T	16	11	27	0	1	28	0	0
21	27047955	.	G	A	18	12	30	0	0	30	0	0
21	27048374	.	A	G	5	4	9	0	0	9	0	0
21	27048388	.	G	A	6	2	8	0	1	9	0	0
21	27053121	.	A	G	3	4	7	0	0	7	0	0
21	27055995	.	G	A	6	7	13	0	0	13	0	0
21	27055998	.	G	T	7	5	12	0	1	13	0	0
21	27058274	.	C	G	8	7	15	0	1	16	0	0
21	27061097	.	C	T	1	5	6	0	0	6	0	0
21	27061115	.	C	T	1	3	4	0	6	10	0	0
21	27119465	.	C	T	3	11	14	0	0	14	0	0
21	27119723	.	G	A	4	7	11	0	1	12	0	0
21	27119786	.	G	A	5	5	10	0	0	10	0	0
21	27119945	.	A	T	4	8	12	0	1	13	0	0
21	27121852	.	G	A	4	2	6	0	0	6	0	0
21	27122116	.	C	T	3	4	7	0	1	8	0	0
21	27122560	.	G	A	1	2	3	0	0	3	0	0
21	27122620	.	C	T	3	4	7	0	0	7	0	0
21	27122980	.	C	T	0	4	4	0	2	6	0	0
21	27123089	.	G	A	3	3	6	0	0	6	0	0
21	27189570	.	C	A	8	6	14	0	0	14	0	0
21	27190033	.	G	A	2	13	15	0	10	25	0	0
21	27198018	.	T	G	8	9	17	0	0	17	0	0
21	27198159	.	C	T	2	18	20	1	17	38	0	0
21	27198227	.	G	T	16	25	41	1	1	43	0	0
21	27198405	.	C	T	10	13	23	0	1	24	0	0
21	27198628	.	T	G	2	5	7	0	0	7	0	0
21	27198967	.	A	G	4	2	6	0	0	6	0	0
21	27199893	.	G	A	3	10	13	0	0	13	0	0
21	27205050	.	G	A	12	14	26	0	1	27	0	0
21	27213101	.	G	A	15	18	33	0	2	35	0	0
21	27213212	.	A	G	14	14	28	0	0	28	0	0
21	27283926	.	A	C	2	1	3	0	3	6	0	0
21	27283932	.	A	C	2	2	4	0	0	4	0	0
21	27305739	.	T	G	21	12	33	0	1	34	0	0
21	27305794	.	C	T	17	15	32	0	1	33	0	0
21	27312644	.	A	G	14	16	30	0	0	30	0	0
21	27312962	.	G	A	20	21	41	0	1	42	0	0
21	27318274	.	G	T	23	14	37	0	2	39	0	0
21	27324586	.	T	A	20	8	28	0	1	29	0	0
21	27324617	.	A	C	10	12	22	0	0	22	0	0
21	27341211	.	G	A	2	2	4	0	0	4	0	0
21	27341663	.	C	T	1	2	3	0	0	3	0	0
21	27343611	.	C	T	4	8	12	0	0	12	0	0
21	27343814	.	G	A	0	6	6	0	1	7	0	0
21	27344032	.	C	T	5	2	7	0	0	7	0	0
21	27344065	.	A	G	3	5	8	0	0	8	0	0
21	27351007	.	C	T	12	9	21	0	0	21	0	0
21	27351316	.	T	C	8	7	15	0	0	15	0	0
21	27353478	.	A	G	12	14	26	0	1	27	0	0
21	27354142	.	C	A	14	4	18	0	1	19	0	0
21	27354147	.	T	C	15	4	19	0	1	20	0	0
21	27354434	.	C	A	9	5	14	0	0	14	0	0
21	27354505	.	T	C	8	7	15	0	1	16	0	0
21	27357227	.	T	A	4	2	6	0	0	6	0	0
21	27357530	.	C	T	1	2	3	0	0	3	0	0
21	27374812	.	T	C	5	4	9	0	0	9	0	0
21	27375199	.	A	G	6	13	19	0	2	21	0	0
21	27375247	.	C	T	8	13	21	0	1	22	0	0
21	27377354	.	C	A	10	20	30	0	4	34	0	0
21	27377815	.	G	A	0	3	3	0	6	9	0	0
21	27378011	.	A	C	10	7	17	0	1	19	1	0
21	27378269	.	T	A	9	9	18	0	1	19	0	0
21	27378388	.	T	G	6	11	17	0	1	18	0	0
21	27378607	.	T	A	6	6	12	0	2	15	1	0
21	27378663	.	G	A	1	4	5	0	13	18	0	0
21	27408467	.	G	C	1	2	3	0	0	3	0	0
21	27473896	.	G	A	3	2	5	0	0	5	0	0
21	27480483	.	T	A	2	3	5	0	1	6	0	0
21	27482264	.	G	A	5	2	7	0	1	8	0	0
21	27483882	.	G	A	2	2	4	0	0	4	0	0
21	27488954	.	A	G	2	3	5	0	1	6	0	0
21	27514002	.	T	A	4	3	7	0	0	7	0	0
21	27526408	.	C	T	7	6	13	0	0	13	0	0
21	27530414	.	C	A	10	9	19	0	1	20	0	0
21	27536026	.	G	A	0	5	5	0	7	12	0	0
21	27536471	.	T	C	6	5	11	0	0	11	0	0
21	27543557	.	G	A	10	12	22	0	0	22	0	0
21	27549452	.	C	T	13	7	20	0	0	20	0	0
21	27549548	.	G	A	12	10	22	0	5	27	0	0
21	27549667	.	G	A	11	10	21	0	1	22	0	0
21	27552349	.	A	G	8	0	8	0	11	19	0	0
21	27552667	.	A	G	16	0	16	0	12	28	0	0
21	27553372	.	C	A	7	16	23	0	0	23	0	0
21	27554837	.	T	C	11	16	27	0	1	28	0	0
21	27554904	.	A	G	12	13	25	0	0	25	0	0
21	27554986	.	C	T	6	8	14	0	0	14	0	0
21	27555177	.	T	A	4	2	6	0	0	6	0	0
21	27555219	.	C	G	3	1	4	0	0	4	0	0
21	27555226	.	A	G	2	0	2	0	2	4	0	0
21	27555331	.	G	A	8	7	15	0	1	16	0	0
21	27578706	.	A	G	3	2	5	0	0	5	0	0
21	27578726	.	A	G	2	3	5	0	0	5	0	0
21	27578772	.	C	T	1	2	3	0	2	5	0	0
21	27586558	.	C	T	1	3	4	0	0	4	0	0
21	27602972	.	G	T	2	3	5	0	0	5	0	0
21	27603360	.	A	G	1	2	3	0	1	4	0	0
21	27610117	.	C	T	1	3	4	0	0	4	0	0
21	27636733	.	C	A	12	29	41	0	2	43	0	0
21	27636739	.	G	A	14	29	43	0	3	46	0	0
21	27637171	.	C	T	2	27	29	0	12	41	0	0
21	27637701	.	G	A	21	16	37	0	1	38	0	0
21	27637729	.	C	A	3	20	23	0	19	42	0	0
21	27637912	.	G	A	22	22	44	0	2	46	0	0
21	27637951	.	A	G	31	26	57	0	0	57	0	0
21	27637993	.	G	A	20	30	50	0	1	51	0	0
21	27657331	.	T	A	19	15	34	0	1	35	0	0
21	27657475	.	A	G	16	9	25	0	1	26	0	0
21	27669178	.	C	T	1	6	7	0	16	23	0	0
21	27880547	.	G	A	4	2	6	0	4	10	0	0
21	27880607	.	C	T	1	4	5	0	4	9	0	0
21	27881041	.	G	T	6	5	11	0	0	11	0	0
21	27881043	.	G	C	6	0	6	0	5	11	0	0
21	27881449	.	A	G	4	4	8	0	0	8	0	0
21	27881474	.	C	T	1	2	3	0	1	4	0	0
21	27881577	.	A	G	5	4	9	0	0	9	0	0
21	27881609	.	C	T	2	2	4	0	4	8	0	0
21	27881729	.	C	T	1	3	4	0	10	14	0	0
21	28051119	.	A	G	1	6	7	0	0	7	0	0
21	28076821	.	A	G	3	8	11	0	0	11	0	0
21	28078711	.	G	T	1	3	4	0	0	4	0	0
21	28078826	.	A	G	1	3	4	0	0	4	0	0
21	28078907	.	T	C	2	4	6	0	1	7	0	0
21	28082551	.	G	A	1	4	5	0	0	5	0	0
21	28235200	.	A	G	2	2	4	0	0	4	0	0
21	28493442	.	T	C	1	2	3	0	0	3	0	0
21	28496276	.	T	C	17	20	37	0	1	38	0	0
21	28500394	.	A	G	30	49	79	0	0	79	0	0
21	28500561	.	C	T	29	27	56	0	3	59	0	0
21	28512642	.	C	T	14	13	27	0	1	28	0	0
21	28512800	.	G	T	7	8	15	0	0	15	0	0
21	28512934	.	A	G	1	2	3	0	0	3	0	0
21	28512995	.	T	C	1	2	3	0	0	3	0	0
21	28555436	.	C	T	0	4	4	0	3	7	0	0
21	28555442	.	A	G	3	4	7	0	0	7	0	0
21	29075234	.	T	G	18	7	25	1	1	27	0	0
21	29075235	.	T	G	19	7	26	1	1	28	0	0
21	30299966	.	T	G	9	2	11	1	1	13	0	0
21	30692796	.	A	G	3	3	6	0	0	6	0	0
21	30692817	.	A	G	3	0	3	0	3	6	0	0
21	30693311	.	A	G	9	8	17	0	1	18	0	0
21	30693312	.	A	G	8	8	16	0	2	18	0	0
21	31151144	.	G	T	2	4	6	0	3	9	0	0
21	31151264	.	A	C	4	3	7	0	1	8	0	0
21	31167452	.	T	A	5	13	18	0	1	19	0	0
21	31167528	.	G	T	3	13	16	0	0	16	0	0
21	31176240	.	A	G	7	7	14	0	1	15	0	0
21	31183375	.	G	A	9	15	24	0	1	25	0	0
21	31183501	.	T	C	13	18	31	0	0	31	0	0
21	31183837	.	A	T	7	12	19	0	1	20	0	0
21	31233103	.	T	A	2	7	9	0	0	9	0	0
21	31233389	.	A	G	6	9	15	0	0	15	0	0
21	31233579	.	G	C	14	8	22	0	0	22	0	0
21	31233657	.	G	A	13	13	26	0	0	26	0	0
21	31237428	.	A	G	18	12	30	0	4	34	0	0
21	31237941	.	A	G	8	10	18	0	0	18	0	0
21	31238439	.	T	C	9	6	15	0	0	15	0	0
21	31241015	.	T	C	11	7	18	0	1	19	0	0
21	31241079	.	G	C	8	7	15	0	0	15	0	0
21	31271741	.	T	C	1	2	3	0	0	3	0	0
21	31271962	.	A	G	2	3	5	0	1	6	0	0
21	32281076	.	G	A	4	3	7	0	1	8	0	0
21	32281122	.	G	A	9	12	21	0	0	21	0	0
21	32281155	.	G	A	7	14	21	0	2	23	0	0
21	32281680	.	C	T	17	9	26	0	1	27	0	0
21	32283519	.	G	A	11	11	22	0	1	23	0	0
21	32284398	.	A	G	10	7	17	0	0	17	0	0
21	32285135	.	T	C	4	0	4	0	3	7	0	0
21	32285161	.	A	G	2	4	6	0	0	6	0	0
21	32342458	.	G	A	5	2	7	0	0	7	0	0
21	32343230	.	C	A	7	2	9	0	1	10	0	0
21	32343248	.	C	A	9	4	13	0	0	13	0	0
21	32343316	.	T	A	19	5	24	0	0	24	0	0
21	32343453	.	C	T	10	7	17	0	0	17	0	0
21	32343577	.	T	C	10	5	15	0	0	15	0	0
21	32343649	.	C	A	6	10	16	0	0	16	0	0
21	32343721	.	T	G	8	0	8	0	6	14	0	0
21	32344021	.	C	A	6	7	13	0	0	13	0	0
21	32345607	.	C	T	5	4	9	0	1	10	0	0
21	32345724	.	A	G	4	9	13	1	0	14	0	0
21	32345749	.	A	G	6	7	13	1	0	14	0	0
21	32345774	.	A	T	6	5	11	1	1	13	0	0
21	32346021	.	A	C	5	2	7	0	2	9	0	0
21	32346273	.	G	A	16	19	35	0	0	35	0	0
21	32346603	.	G	C	14	19	33	0	2	35	0	0
21	32346630	.	T	C	10	21	31	0	0	31	0	0
21	32346674	.	T	A	12	19	31	0	0	31	0	0
21	32346689	.	A	G	12	17	29	1	1	31	0	0
21	32346799	.	G	A	9	15	24	0	0	24	0	0
21	32346800	.	T	A	9	15	24	0	0	24	0	0
21	32346899	.	A	G	16	11	27	0	1	28	0	0
21	32346901	.	A	G	16	11	27	0	1	28	0	0
21	32347134	.	T	A	17	22	39	0	0	39	0	0
21	32347569	.	G	T	15	17	32	0	0	32	0	0
21	32347855	.	T	C	15	13	28	0	0	28	0	0
21	32347966	.	A	C	14	0	14	0	9	23	0	0
21	32348230	.	A	T	8	12	20	0	0	20	0	0
21	32348321	.	C	A	3	3	6	0	0	6	0	0
21	32348449	.	G	A	9	4	13	0	1	14	0	0
21	32348484	.	G	A	7	4	11	0	0	11	0	0
21	32348523	.	G	A	10	8	18	0	2	20	0	0
21	32348600	.	C	T	13	7	20	0	0	20	0	0
21	32348667	.	G	C	14	11	25	0	0	25	0	0
21	32348919	.	C	T	2	9	11	0	14	25	0	0
21	32349000	.	G	A	12	13	25	0	0	25	0	0
21	32349023	.	G	C	12	18	30	0	1	31	0	0
21	32349055	.	C	T	13	12	25	0	5	30	0	0
21	32352459	.	C	G	8	11	19	0	0	19	0	0
21	32353049	.	G	A	2	7	9	0	1	10	0	0
21	32354920	.	A	G	5	8	13	0	1	14	0	0
21	32354980	.	A	G	9	11	20	0	1	21	0	0
21	32374460	.	A	T	3	7	10	0	0	10	0	0
21	32457785	.	T	C	9	9	18	0	0	18	0	0
21	32457923	.	C	A	15	16	31	0	4	35	0	0
21	32457931	.	T	G	17	18	35	0	1	36	0	0
21	32457983	.	G	A	14	17	31	0	1	32	0	0
21	32458261	.	A	G	19	29	48	0	1	49	0	0
21	32458315	.	T	A	15	20	35	0	2	37	0	0
21	32460782	.	G	C	7	3	10	0	0	10	0	0
21	32460912	.	A	G	17	23	40	0	2	42	0	0
21	32466140	.	G	C	13	25	38	0	0	38	0	0
21	32467660	.	A	G	25	13	38	0	1	39	0	0
21	32467724	.	T	C	28	12	40	0	4	44	0	0
21	32476760	.	A	G	30	24	54	0	1	55	0	0
21	32477584	.	T	C	20	26	46	0	0	46	0	0
21	32477967	.	C	T	17	25	42	0	2	44	0	0
21	32477987	.	A	T	23	14	37	0	11	48	0	0
21	32478227	.	G	T	29	29	58	0	0	58	0	0
21	32482797	.	C	T	31	27	58	0	2	60	0	0
21	32482854	.	T	C	25	1	26	1	29	56	0	0
21	32486997	.	A	T	5	6	11	0	0	11	0	0
21	32758254	.	G	A	11	7	18	0	4	22	0	0
21	32758351	.	C	T	16	11	27	0	2	29	0	0
21	32758584	.	G	A	20	12	32	0	0	33	1	0
21	32759421	.	C	T	12	5	17	0	0	17	0	0
21	32766389	.	G	A	13	5	18	0	0	18	0	0
21	32772450	.	G	A	4	2	6	0	1	7	0	0
21	33058940	.	G	C	10	3	13	0	0	13	0	0
21	33066214	.	T	G	22	11	33	0	1	34	0	0
21	33069896	.	A	G	6	13	19	0	0	19	0	0
21	33211506	.	T	A	14	7	21	0	0	21	0	0
21	33211568	.	C	T	10	8	18	2	1	21	0	0
21	33211664	.	T	G	10	6	16	0	3	19	0	0
21	33211720	.	A	T	9	8	17	0	0	17	0	0
21	33211809	.	A	T	15	13	28	0	1	29	0	0
21	33213315	.	C	T	6	8	14	0	1	15	0	0
21	33213384	.	G	A	6	12	18	0	0	18	0	0
21	33218312	.	T	C	4	7	11	0	1	12	0	0
21	33218405	.	G	A	9	6	15	0	1	16	0	0
21	33249606	.	T	A	2	2	4	0	0	4	0	0
21	33249638	.	A	C	1	3	4	0	0	4	0	0
21	33447251	.	A	G	10	7	17	0	1	18	0	0
21	33463486	.	A	G	4	6	10	0	0	10	0	0
21	33521279	.	T	A	5	2	7	0	0	7	0	0
21	34001982	.	C	T	18	14	32	0	0	32	0	0
21	34002041	.	C	A	13	9	22	0	2	24	0	0
21	34002154	.	A	C	8	10	18	0	1	19	0	0
21	34002155	.	A	T	7	11	18	0	1	19	0	0
21	34002333	.	T	C	3	6	9	0	0	10	1	0
21	34002455	.	G	A	6	7	13	0	0	13	0	0
21	34002507	.	A	G	6	9	15	0	2	17	0	0
21	34026657	.	T	C	3	5	8	0	0	8	0	0
21	34031232	.	G	A	3	4	7	0	0	7	0	0
21	34057611	.	T	G	1	6	7	0	1	8	0	0
21	34059079	.	A	C	3	7	10	0	0	10	0	0
21	34074618	.	A	G	9	9	18	0	0	18	0	0
21	34074712	.	T	C	2	7	9	0	0	9	0	0
21	34075010	.	T	G	1	2	3	0	0	3	0	0
21	34103275	.	G	A	1	3	4	0	5	9	0	0
21	34114058	.	C	A	2	4	6	0	0	6	0	0
21	34114410	.	G	A	8	5	13	0	1	14	0	0
21	34128660	.	A	G	26	15	41	0	1	42	0	0
21	34129007	.	C	G	18	0	18	0	20	38	0	0
21	34129073	.	G	C	17	9	26	0	2	28	0	0
21	34129195	.	G	T	11	18	29	0	1	31	1	0
21	34129279	.	A	G	9	16	25	0	3	28	0	0
21	34195790	.	T	C	2	6	8	0	0	8	0	0
21	34199704	.	T	C	2	7	9	0	0	9	0	0
21	34364472	.	T	A	9	8	17	0	0	17	0	0
21	34364595	.	G	A	10	7	17	0	1	18	0	0
21	34365167	.	T	A	8	9	17	0	1	18	0	0
21	34391104	.	C	T	10	8	18	0	2	20	0	0
21	34391155	.	T	C	3	8	11	1	1	13	0	0
21	34392843	.	C	T	8	9	17	0	1	18	0	0
21	34424086	.	C	T	0	6	6	0	12	18	0	0
21	34424116	.	A	G	7	8	15	0	0	15	0	0
21	34428080	.	G	A	5	4	9	0	1	10	0	0
21	36570995	.	A	G	1	4	5	0	0	5	0	0
21	36598347	.	T	G	4	5	9	0	1	10	0	0
21	37107035	.	T	A	23	12	35	0	1	36	0	0
21	37107307	.	G	A	8	10	18	0	0	18	0	0
21	37107432	.	A	T	8	8	16	0	3	19	0	0
21	37107614	.	T	C	11	5	16	0	0	16	0	0
21	37107861	.	T	C	13	9	22	0	1	23	0	0
21	37108022	.	A	G	10	13	23	0	2	25	0	0
21	37108204	.	A	T	14	11	25	0	1	26	0	0
21	37688450	.	C	A	1	2	3	3	0	6	0	0
21	37689590	.	C	A	6	3	9	0	0	9	0	0
21	38014103	.	G	T	6	2	8	0	0	8	0	0
21	38587378	.	T	C	7	14	21	0	0	21	0	0
21	38587538	.	T	C	3	6	9	0	1	10	0	0
21	38647118	.	G	A	0	10	10	0	2	12	0	0
21	38647131	.	G	A	0	5	5	6	3	14	0	0
21	38647359	.	G	A	1	17	18	5	1	24	0	0
21	39509883	.	C	T	5	1	6	0	1	7	0	0
21	39511192	.	A	G	10	2	12	0	1	13	0	0
21	39511364	.	A	G	7	3	10	0	1	11	0	0
21	39511387	.	A	G	6	3	9	0	2	11	0	0
21	39973477	.	A	T	2	2	4	0	0	4	0	0
21	39973478	.	A	C	2	2	4	0	0	4	0	0
21	40045441	.	T	C	5	7	12	0	0	12	0	0
21	40045569	.	G	T	8	11	19	0	1	20	0	0
21	40045665	.	G	A	14	13	27	0	2	29	0	0
21	40045701	.	G	A	13	10	23	0	1	24	0	0
21	40045754	.	G	A	8	4	12	0	0	12	0	0
21	40048981	.	C	A	1	8	9	0	9	18	0	0
21	40049524	.	A	G	4	2	6	0	1	7	0	0
21	40049556	.	T	G	4	4	8	0	0	8	0	0
21	40049606	.	T	G	2	6	8	0	0	8	0	0
21	40467126	.	G	A	0	5	5	0	1	6	0	0
21	40532665	.	T	C	3	4	7	0	5	12	0	0
21	41599060	.	T	C	13	21	34	0	1	35	0	0
21	41599605	.	T	C	13	5	18	1	4	23	0	0
21	41600295	.	T	C	2	0	2	1	5	8	0	0
21	41601008	.	T	C	5	5	10	0	0	10	0	0
21	41601021	.	T	C	7	7	14	0	0	14	0	0
21	42046969	.	G	A	18	14	32	56	3	91	0	0
21	42051117	.	G	C	6	2	8	0	24	32	0	0
21	42779096	.	C	T	1	6	7	0	1	8	0	0
21	42971463	.	T	C	28	13	41	0	14	55	0	0
21	43420623	.	T	C	3	0	3	0	5	8	0	0
21	43461082	.	T	C	6	3	9	0	4	13	0	0
21	43461212	.	T	C	3	1	4	0	2	6	0	0
21	43476276	.	T	C	19	8	27	0	1	28	0	0
21	43477593	.	T	C	18	6	24	0	4	28	0	0
21	43477894	.	T	C	14	8	22	0	1	23	0	0
21	43507799	.	A	G	1	2	3	0	0	3	0	0
21	44553806	.	A	G	7	5	12	0	1	13	0	0
21	44558898	.	T	C	18	1	19	0	13	32	0	0
21	44559095	.	C	T	24	19	43	0	1	44	0	0
21	44561900	.	A	G	25	18	43	0	3	46	0	0
21	44563129	.	T	A	30	20	50	0	2	52	0	0
21	44581845	.	A	T	2	3	5	0	1	6	0	0
21	44777617	.	G	T	1	5	6	0	7	13	0	0
21	44781745	.	A	G	9	10	19	0	2	21	0	0
21	44784156	.	A	G	9	0	9	0	11	20	0	0
21	44784223	.	A	G	18	0	18	0	13	31	0	0
21	44784493	.	G	T	15	10	25	0	2	27	0	0
21	44784589	.	T	C	6	5	11	0	0	11	0	0
21	44784663	.	C	T	2	3	5	0	0	5	0	0
21	45017433	.	T	C	2	3	5	0	0	5	0	0
21	45103191	.	C	T	2	2	4	0	0	4	0	0
21	45114642	.	T	A	1	2	3	0	1	4	0	0
21	45114742	.	G	A	0	8	8	0	3	11	0	0
21	45114778	.	C	T	3	2	5	0	0	5	0	0
21	45114925	.	G	A	0	2	2	0	3	5	0	0
21	45117465	.	T	C	5	5	10	0	1	11	0	0
21	45117469	.	T	G	6	5	11	0	0	11	0	0
21	45117537	.	C	T	4	4	8	0	0	8	0	0
21	45182345	.	A	G	2	7	9	0	0	9	0	0
21	45182488	.	G	A	8	5	13	0	0	13	0	0
21	45182566	.	C	T	9	7	16	0	1	17	0	0
21	45185829	.	A	G	9	12	21	0	1	22	0	0
21	45186175	.	G	A	12	13	25	0	0	25	0	0
21	45187072	.	T	G	7	9	16	0	0	16	0	0
21	45187248	.	A	G	8	6	14	0	2	16	0	0
21	45187258	.	G	A	9	7	16	0	0	16	0	0
21	45190709	.	T	A	27	25	52	0	1	53	0	0
21	45190754	.	C	T	3	36	39	0	22	61	0	0
21	45190884	.	G	A	16	30	46	0	2	48	0	0
21	45190926	.	C	T	25	18	43	0	0	43	0	0
21	45190975	.	C	T	28	24	52	0	1	53	0	0
21	45190984	.	T	C	29	24	53	0	2	55	0	0
21	45191163	.	A	T	37	34	71	0	1	72	0	0
21	45198712	.	C	T	3	31	34	0	19	53	0	0
21	45352415	.	C	T	3	26	29	0	18	47	0	0
21	45356811	.	T	G	21	18	39	0	1	40	0	0
21	45359397	.	G	A	23	11	34	0	4	38	0	0
21	45363684	.	C	T	17	13	30	0	3	33	0	0
21	45363728	.	C	T	18	11	29	0	1	30	0	0
21	45363778	.	T	G	16	21	37	0	0	37	0	0
21	45366268	.	C	T	5	5	10	0	1	11	0	0
21	45366301	.	A	C	10	6	16	0	0	16	0	0
21	45374370	.	T	C	8	7	15	0	0	15	0	0
21	45374413	.	C	A	10	18	28	0	1	29	0	0
21	45374439	.	C	T	17	15	32	0	1	33	0	0
21	45374509	.	T	C	13	6	19	0	1	20	0	0
21	45375109	.	G	T	6	6	12	0	2	14	0	0
21	45377351	.	G	T	7	10	17	0	1	18	0	0
21	45377404	.	T	C	10	7	17	0	0	17	0	0
21	45377409	.	T	C	8	6	14	0	0	14	0	0
21	45382032	.	G	A	18	21	39	0	0	39	0	0
21	45386175	.	C	T	1	2	3	0	0	3	0	0
21	45398178	.	T	C	4	3	7	0	0	7	0	0
21	45399775	.	A	T	3	3	6	0	0	6	0	0
21	45410019	.	G	A	0	2	2	0	2	4	0	0
21	45410118	.	T	C	4	3	7	0	0	7	0	0
21	45410479	.	A	C	4	2	6	0	0	6	0	0
21	45410601	.	G	A	1	1	2	0	1	3	0	0
21	45510699	.	A	G	0	0	0	0	3	3	0	0
21	45542246	.	A	G	3	0	3	0	3	6	0	0
21	45544374	.	C	T	2	4	6	0	1	7	0	0
21	45544384	.	A	G	3	0	3	0	6	9	0	0
21	45544709	.	A	G	2	4	6	0	2	8	0	0
21	45673960	.	C	T	0	5	5	1	1	7	0	0
21	45673964	.	A	T	29	3	32	1	3	36	0	0
21	45768787	.	A	T	2	1	3	0	1	4	0	0
22	724787	.	A	G	19	0	19	10	9	38	0	0
22	732653	.	A	T	3	2	5	0	0	5	0	0
22	733144	.	A	T	0	2	2	0	1	3	0	0
22	869529	.	G	A	5	3	8	0	0	8	0	0
22	912563	.	T	C	1	2	3	1	0	4	0	0
22	1899945	.	A	G	1	2	3	1	0	4	0	0
22	1924746	.	A	C	2	3	5	1	0	6	0	0
22	1924754	.	T	A	2	3	5	1	0	6	0	0
22	2505120	.	A	G	1	3	4	0	0	4	0	0
22	2627746	.	C	A	3	2	5	0	1	6	0	0
22	2627773	.	A	T	1	7	8	3	0	11	0	0
22	2717105	.	T	C	2	2	4	0	0	4	0	0
22	2717148	.	A	G	2	2	4	1	0	5	0	0
22	3202344	.	C	G	5	2	7	0	0	7	0	0
22	4747456	.	C	A	5	4	9	0	0	9	0	0
22	4962472	.	T	A	3	4	7	0	1	8	0	0
22	4962559	.	G	A	6	8	14	0	1	15	0	0
22	4962610	.	A	T	10	13	23	0	0	23	0	0
22	4962635	.	A	G	13	15	28	0	1	29	0	0
22	4962696	.	T	C	13	13	26	0	2	28	0	0
22	4962878	.	G	A	12	10	22	0	2	24	0	0
22	4968955	.	A	G	17	15	32	2	0	34	0	0
22	4969051	.	G	A	18	11	29	0	0	29	0	0
22	4970773	.	T	C	5	0	5	0	14	19	0	0
22	4970797	.	G	C	6	8	14	0	0	14	0	0
22	4972848	.	T	G	6	10	16	0	3	19	0	0
22	4972980	.	C	T	2	10	12	0	13	25	0	0
22	4975236	.	T	A	9	14	23	0	4	27	0	0
22	4977106	.	G	A	4	7	11	0	2	13	0	0
22	4981480	.	T	A	1	5	6	0	2	8	0	0
22	4985831	.	G	C	4	3	7	0	0	7	0	0
22	5056425	.	G	T	7	10	17	0	0	17	0	0
22	5056706	.	G	A	13	3	16	0	1	17	0	0
22	5056760	.	T	G	13	17	30	0	2	32	0	0
22	5056978	.	A	T	11	5	16	0	2	18	0	0
22	5057421	.	C	A	0	7	7	0	13	20	0	0
22	5057443	.	T	C	6	0	6	0	15	21	0	0
22	5057489	.	T	A	12	4	16	0	1	17	0	0
22	5057504	.	T	A	13	3	16	0	2	18	0	0
22	5059916	.	A	G	14	14	28	0	1	29	0	0
22	5060162	.	T	A	7	12	19	0	1	20	0	0
22	5062457	.	G	A	11	2	13	0	2	15	0	0
22	5075291	.	T	C	6	6	12	1	0	13	0	0
22	5075390	.	A	G	9	5	14	0	1	15	0	0
22	5075673	.	A	G	9	8	17	0	1	18	0	0
22	5075732	.	T	C	9	8	17	0	1	18	0	0
22	5087451	.	G	A	12	3	15	0	1	16	0	0
22	5087488	.	G	A	9	7	16	0	0	16	0	0
22	5090115	.	C	A	0	7	7	0	8	15	0	0
22	5098433	.	G	T	8	4	12	0	0	12	0	0
22	5103769	.	G	A	4	2	6	0	0	6	0	0
22	5109554	.	G	A	16	21	37	0	1	38	0	0
22	5109560	.	T	A	16	20	36	0	0	36	0	0
22	5112644	.	G	T	20	22	42	0	3	45	0	0
22	5112749	.	T	C	18	22	40	0	3	43	0	0
22	5112864	.	G	A	24	18	42	0	0	42	0	0
22	5112915	.	A	C	25	23	48	0	0	48	0	0
22	5114380	.	G	C	2	34	36	1	23	60	0	0
22	5116267	.	A	C	11	6	17	0	0	17	0	0
22	5118373	.	A	G	1	0	1	0	3	4	0	0
22	5118378	.	G	A	0	3	3	0	1	4	0	0
22	5120039	.	G	A	0	2	2	0	1	3	0	0
22	5120043	.	G	A	0	2	2	0	1	3	0	0
22	5121464	.	C	T	3	14	17	0	0	17	0	0
22	5121471	.	C	T	4	12	16	0	1	17	0	0
22	5121623	.	A	G	6	0	6	0	5	11	0	0
22	5140122	.	A	G	2	3	5	0	0	5	0	0
22	5140840	.	C	T	0	2	2	0	5	7	0	0
22	5140851	.	C	G	2	4	6	0	1	7	0	0
22	5144566	.	G	C	5	8	13	0	1	14	0	0
22	5144645	.	C	T	11	6	17	0	0	17	0	0
22	5144750	.	T	A	8	4	12	0	1	13	0	0
22	5144981	.	T	C	6	10	16	0	0	16	0	0
22	5145109	.	C	A	3	5	8	0	0	8	0	0
22	5145199	.	C	G	1	5	6	0	0	6	0	0
22	5228744	.	G	A	1	6	7	8	12	27	0	0
22	5228882	.	A	C	3	2	5	5	0	10	0	0
22	5228889	.	A	G	3	2	5	7	0	12	0	0
22	5229048	.	G	A	4	5	9	0	1	10	0	0
22	5229077	.	T	C	13	6	19	0	0	19	0	0
22	5230977	.	A	C	7	4	11	3	0	14	0	0
22	5233998	.	A	G	3	0	3	5	1	9	0	0
22	5587490	.	A	T	2	1	3	0	2	5	0	0
22	5756066	.	G	A	22	14	36	1	2	39	0	0
22	5756317	.	C	T	3	3	6	0	0	6	0	0
22	5756340	.	A	T	1	3	4	0	0	4	0	0
22	5758678	.	C	T	12	10	22	0	7	29	0	0
22	5758689	.	A	T	14	18	32	0	0	32	0	0
22	5761968	.	G	A	5	7	12	0	1	13	0	0
22	5763846	.	G	A	1	2	3	0	1	4	0	0
22	5763881	.	A	G	2	6	8	0	0	8	0	0
22	5773401	.	T	C	5	4	9	0	0	9	0	0
22	5773482	.	G	A	3	6	9	0	0	9	0	0
22	5777193	.	A	G	1	3	4	0	0	4	0	0
22	5908791	.	G	A	1	3	4	0	0	4	0	0
22	6041399	.	T	A	1	2	3	0	0	3	0	0
22	6073717	.	C	T	1	3	4	0	0	4	0	0
22	6073731	.	A	T	1	3	4	0	0	4	0	0
22	6075652	.	G	T	1	10	11	0	0	11	0	0
22	6075656	.	T	G	1	10	11	0	0	11	0	0
22	6075714	.	A	C	1	5	6	0	0	6	0	0
22	6077657	.	T	C	2	0	2	0	3	5	0	0
22	6078223	.	C	A	2	4	6	0	1	7	0	0
22	6078310	.	C	G	1	4	5	0	1	6	0	0
22	6099098	.	A	G	1	0	1	0	2	3	0	0
22	6099105	.	C	G	3	0	3	0	0	3	0	0
22	6183523	.	T	C	2	3	5	0	0	5	0	0
22	6294288	.	C	T	0	4	4	0	1	5	0	0
22	6300409	.	G	T	5	2	7	0	0	7	0	0
22	6300506	.	A	G	1	4	5	0	0	5	0	0
22	6300543	.	G	A	1	4	5	0	0	5	0	0
22	6302544	.	G	C	0	3	3	0	0	3	0	0
22	6302548	.	G	A	1	3	4	0	0	4	0	0
22	6302717	.	T	C	1	0	1	0	4	5	0	0
22	6302736	.	C	T	0	4	4	0	1	5	0	0
22	6487855	.	T	G	7	13	20	0	0	20	0	0
22	6487920	.	C	A	5	5	10	0	1	11	0	0
22	6487932	.	A	G	3	5	8	0	1	9	0	0
22	6488007	.	T	G	4	5	9	0	0	9	0	0
22	6488050	.	A	T	9	6	15	0	0	15	0	0
22	6488068	.	G	A	9	8	17	0	0	17	0	0
22	6488204	.	G	A	11	11	22	0	0	22	0	0
22	6488261	.	A	G	6	7	13	0	2	15	0	0
22	6488266	.	A	C	7	8	15	0	1	16	0	0
22	6488313	.	T	A	4	6	10	0	1	11	0	0
22	6488364	.	A	G	5	7	12	0	0	12	0	0
22	6488433	.	G	T	2	6	8	0	2	10	0	0
22	6488528	.	G	C	2	0	2	0	11	13	0	0
22	6488548	.	T	C	2	7	9	0	0	9	0	0
22	6488565	.	A	G	1	7	8	0	0	8	0	0
22	6488598	.	G	T	1	11	12	0	1	13	0	0
22	6494840	.	G	A	4	5	9	0	0	9	0	0
22	6494855	.	A	T	4	7	11	0	0	11	0	0
22	6527546	.	C	T	12	4	16	0	0	16	0	0
22	6527758	.	G	T	4	5	9	0	0	9	0	0
22	6528274	.	C	A	0	3	3	0	13	16	0	0
22	6528284	.	T	G	12	4	16	0	0	16	0	0
22	6528445	.	C	A	10	6	16	0	0	16	0	0
22	6528446	.	A	G	10	6	16	0	0	16	0	0
22	6528586	.	C	T	10	3	13	0	0	13	0	0
22	6529068	.	A	C	5	3	8	0	0	8	0	0
22	6529158	.	T	A	5	3	8	0	0	8	0	0
22	6767649	.	A	G	3	1	4	0	0	4	0	0
22	6767664	.	G	A	3	2	5	0	0	5	0	0
22	6767696	.	A	C	3	2	5	0	0	5	0	0
22	6996116	.	T	C	7	1	8	0	9	17	0	0
22	6996343	.	G	A	13	13	26	0	3	29	0	0
22	6998904	.	A	G	8	15	23	0	2	25	0	0
22	6998949	.	G	T	9	11	20	0	0	20	0	0
22	6998988	.	T	C	12	13	25	0	3	28	0	0
22	6999006	.	A	G	13	14	27	0	0	27	0	0
22	6999060	.	G	C	5	0	5	0	6	11	0	0
22	6999148	.	T	A	3	7	10	0	1	11	0	0
22	7001474	.	G	T	7	4	11	0	0	11	0	0
22	7001827	.	G	A	3	7	10	0	1	11	0	0
22	7003603	.	A	G	1	5	6	0	0	6	0	0
22	7006913	.	T	C	1	0	1	0	6	7	0	0
22	7009333	.	A	T	13	10	23	1	2	26	0	0
22	7009393	.	A	G	11	7	18	2	0	20	0	0
22	7009833	.	C	T	5	7	12	0	3	15	0	0
22	7009835	.	T	G	8	7	15	0	0	15	0	0
22	7009911	.	A	G	7	8	15	0	0	15	0	0
22	7009915	.	C	T	2	7	9	0	6	15	0	0
22	7010011	.	A	C	16	16	32	0	2	34	0	0
22	7010100	.	T	C	20	0	20	0	24	44	0	0
22	7010151	.	T	C	16	16	32	0	4	36	0	0
22	7012898	.	C	T	1	16	17	0	14	31	0	0
22	7012931	.	C	G	15	16	31	0	0	31	0	0
22	7016655	.	A	G	16	15	31	0	1	32	0	0
22	7018223	.	G	A	6	11	17	0	2	19	0	0
22	7019397	.	C	A	0	8	8	0	15	23	0	0
22	7019701	.	T	A	14	10	24	0	2	26	0	0
22	7044634	.	C	G	15	9	24	0	0	24	0	0
22	7044667	.	T	G	7	12	19	0	0	19	0	0
22	7044681	.	T	C	5	10	15	0	1	16	0	0
22	7045031	.	G	A	9	10	19	0	0	19	0	0
22	7045041	.	C	A	7	11	18	0	1	19	0	0
22	7045070	.	C	T	6	6	12	0	1	13	0	0
22	7045215	.	A	G	9	8	17	0	1	18	0	0
22	7056645	.	C	T	10	10	20	0	1	21	0	0
22	7129212	.	G	C	4	2	6	0	0	6	0	0
22	7359844	.	T	C	5	4	9	0	0	9	0	0
22	7400193	.	A	G	2	2	4	0	0	4	0	0
22	7526865	.	G	A	1	2	3	0	0	3	0	0
22	7682820	.	T	A	13	3	16	5	1	23	1	0
22	7682825	.	T	G	11	3	14	5	3	22	0	0
22	7683040	.	C	A	7	2	9	0	0	9	0	0
22	7683668	.	A	T	15	4	19	1	0	20	0	0
22	7683921	.	T	C	6	2	8	3	0	11	0	0
22	7693741	.	C	A	2	2	4	6	0	10	0	0
22	7972792	.	A	G	3	8	11	4	1	16	0	0
22	7972848	.	A	G	8	5	13	3	0	16	0	0
22	7972851	.	T	C	7	5	12	3	0	15	0	0
22	7974164	.	C	A	4	10	14	2	0	16	0	0
22	7974302	.	C	G	4	2	6	0	1	7	0	0
22	7974314	.	T	C	5	2	7	0	0	7	0	0
22	8074067	.	C	T	2	5	7	9	3	19	0	0
22	8074093	.	T	A	2	4	6	8	1	15	0	0
22	8161804	.	T	G	3	4	7	0	0	7	0	0
22	8161809	.	T	C	3	0	3	0	3	6	0	0
22	8162059	.	C	T	1	5	6	0	7	13	0	0
22	8163863	.	T	C	7	0	7	0	7	14	0	0
22	8163917	.	G	A	5	7	12	0	0	12	0	0
22	8164035	.	C	T	5	3	8	0	0	8	0	0
22	8239945	.	T	C	1	3	4	0	0	4	0	0
22	8239955	.	G	T	1	2	3	0	0	3	0	0
22	8240175	.	C	A	0	3	3	0	3	6	0	0
22	8240230	.	A	G	3	2	5	0	0	5	0	0
22	8240232	.	A	C	3	2	5	0	0	5	0	0
22	8240737	.	A	C	3	6	9	0	0	9	0	0
22	8240843	.	G	A	1	6	7	0	1	8	0	0
22	8240852	.	A	T	2	6	8	0	0	8	0	0
22	8240892	.	T	A	1	2	3	0	0	3	0	0
22	8240902	.	A	T	0	1	1	0	1	2	0	0
22	8245932	.	C	T	1	2	3	0	0	3	0	0
22	8245941	.	A	G	1	2	3	0	0	3	0	0
22	8296763	.	G	T	5	3	8	0	0	8	0	0
22	8341919	.	T	A	2	2	4	0	0	4	0	0
22	8341943	.	C	T	3	3	6	0	0	6	0	0
22	8341982	.	T	C	2	2	4	0	0	4	0	0
22	8345311	.	C	T	2	2	4	0	0	4	0	0
22	8715641	.	C	T	3	2	5	3	0	8	0	0
22	8715670	.	C	T	0	3	3	1	7	11	0	0
22	8769442	.	A	G	3	0	3	1	3	7	0	0
22	8769579	.	T	G	4	5	9	0	0	9	0	0
22	8769730	.	T	C	1	1	2	0	1	3	0	0
22	8770302	.	T	C	3	3	6	0	0	6	0	0
22	8784585	.	T	A	2	2	4	0	0	4	0	0
22	8785914	.	C	T	2	3	5	0	1	6	0	0
22	8785965	.	C	T	2	4	6	0	0	6	0	0
22	8785982	.	T	G	4	2	6	0	1	7	0	0
22	8786022	.	G	A	1	5	6	0	1	7	0	0
22	8786112	.	G	A	0	2	2	0	0	4	2	0
22	8786316	.	C	T	2	5	7	0	0	7	0	0
22	9029072	.	A	G	1	2	3	0	0	3	0	0
22	9057022	.	A	G	1	2	3	0	0	3	0	0
22	9057025	.	A	G	1	2	3	0	0	3	0	0
22	9306945	.	A	G	1	6	7	2	0	9	0	0
22	9306948	.	C	G	1	6	7	2	0	9	0	0
22	9472870	.	T	C	2	5	7	0	0	7	0	0
22	9472873	.	T	C	2	5	7	0	0	7	0	0
22	9481089	.	A	G	2	0	2	0	2	4	0	0
22	9484355	.	T	C	2	4	6	0	0	6	0	0
22	9490564	.	G	A	4	2	6	0	0	6	0	0
22	9490730	.	C	T	5	5	10	0	1	11	0	0
22	9494144	.	A	G	5	6	11	0	0	11	0	0
22	9496933	.	T	A	2	4	6	0	2	8	0	0
22	9496954	.	G	A	0	5	5	0	5	10	0	0
22	9499762	.	T	C	12	8	20	0	0	20	0	0
22	9503739	.	G	A	6	3	9	0	1	10	0	0
22	9504689	.	C	T	10	6	16	0	3	19	0	0
22	9504749	.	T	C	8	9	17	0	0	17	0	0
22	9508114	.	G	A	13	10	23	0	0	23	0	0
22	9509637	.	G	A	0	11	11	0	13	24	0	0
22	9512565	.	A	C	19	14	33	0	1	34	0	0
22	9512717	.	C	T	4	13	17	3	1	21	0	0
22	9512731	.	T	A	4	12	16	3	0	19	0	0
22	9512829	.	A	G	5	9	14	0	0	14	0	0
22	9513039	.	C	T	10	8	18	0	0	18	0	0
22	9523557	.	A	T	5	2	7	0	0	7	0	0
22	9525415	.	C	T	4	5	9	0	0	9	0	0
22	9526389	.	C	T	7	2	9	0	0	9	0	0
22	9527373	.	T	C	2	7	9	0	0	9	0	0
22	9527409	.	T	C	6	3	9	0	0	9	0	0
22	9527439	.	G	T	7	5	12	0	0	12	0	0
22	9530328	.	T	C	4	8	12	0	0	12	0	0
22	9530377	.	G	A	6	3	9	0	1	10	0	0
22	9530388	.	C	T	5	7	12	0	0	12	0	0
22	9530418	.	A	G	4	0	4	0	9	13	0	0
22	9530562	.	G	A	9	8	17	0	2	19	0	0
22	9530598	.	G	A	8	7	15	0	1	16	0	0
22	9532431	.	G	A	7	3	10	0	0	10	0	0
22	9532488	.	G	A	6	8	14	0	0	14	0	0
22	9534066	.	C	T	6	7	13	0	4	17	0	0
22	9534138	.	C	T	10	10	20	0	4	24	0	0
22	9535914	.	G	A	12	8	20	0	0	20	0	0
22	9535932	.	C	A	9	11	20	0	2	22	0	0
22	9537583	.	T	C	19	21	40	0	15	55	0	0
22	9537859	.	C	T	11	9	20	0	0	20	0	0
22	9826434	.	G	A	3	2	5	0	1	6	0	0
22	9828848	.	C	T	2	2	4	0	0	4	0	0
22	9835108	.	C	T	7	3	10	0	0	10	0	0
22	9835393	.	G	A	4	3	7	0	0	7	0	0
22	9835481	.	C	T	2	2	4	0	0	4	0	0
22	9835482	.	C	G	2	2	4	0	0	4	0	0
22	9835604	.	G	A	1	2	3	0	0	3	0	0
22	9835622	.	A	G	1	2	3	0	0	3	0	0
22	9835844	.	T	C	3	2	5	0	0	5	0	0
22	9835885	.	T	C	1	5	6	0	0	6	0	0
22	9835984	.	T	A	0	2	2	0	0	2	0	0
22	9835999	.	T	C	2	2	4	0	0	4	0	0
22	9836301	.	G	C	1	3	4	0	0	4	0	0
22	9836348	.	T	C	3	2	5	0	0	5	0	0
22	9877968	.	T	G	4	5	9	0	2	11	0	0
22	9886990	.	C	T	0	3	3	0	1	4	0	0
22	9887167	.	G	A	5	3	8	0	1	9	0	0
22	9887632	.	C	T	2	3	5	1	0	6	0	0
22	9887777	.	T	A	3	4	7	0	0	7	0	0
22	9889432	.	A	C	3	2	5	0	0	5	0	0
22	9889436	.	C	T	3	2	5	0	0	5	0	0
22	9893357	.	A	T	0	4	4	1	0	5	0	0
22	9893360	.	T	C	0	3	3	1	2	6	0	0
22	9893688	.	G	A	2	3	5	0	0	5	0	0
22	9893701	.	A	G	2	2	4	0	0	4	0	0
22	9894218	.	C	T	1	3	4	0	0	4	0	0
22	9896120	.	G	A	1	3	4	0	0	4	0	0
22	9898052	.	A	G	1	2	3	0	0	3	0	0
22	9898190	.	A	C	3	2	5	1	0	6	0	0
22	9898355	.	C	T	1	7	8	0	1	9	0	0
22	9898801	.	G	A	4	2	6	0	0	6	0	0
22	9898802	.	A	T	3	2	5	0	1	6	0	0
22	9898898	.	T	C	6	4	10	0	1	11	0	0
22	9898982	.	A	G	4	2	6	0	0	6	0	0
22	9899279	.	A	G	4	3	7	2	0	9	0	0
22	9900443	.	T	C	1	2	3	0	0	3	0	0
22	9904733	.	A	C	1	2	3	2	0	5	0	0
22	9904755	.	A	T	1	2	3	2	0	5	0	0
22	9923022	.	G	A	1	2	3	0	0	3	0	0
22	9926204	.	A	G	4	3	7	0	0	7	0	0
22	9926532	.	C	G	1	2	3	0	0	3	0	0
22	9932903	.	T	A	4	3	7	0	1	8	0	0
22	9932947	.	C	G	5	4	9	0	0	9	0	0
22	9933972	.	C	T	3	4	7	0	0	7	0	0
22	9972546	.	C	T	0	3	3	0	0	3	0	0
22	10019568	.	C	T	6	3	9	0	0	9	0	0
22	10019645	.	C	G	3	2	5	0	0	5	0	0
22	10019712	.	A	G	1	4	5	0	2	7	0	0
22	10019742	.	T	C	2	0	2	0	4	6	0	0
22	10039417	.	G	A	4	3	7	0	0	7	0	0
22	10039497	.	G	A	5	2	7	0	0	7	0	0
22	10040015	.	C	T	0	3	3	0	2	5	0	0
22	10045173	.	A	T	5	2	7	0	1	8	0	0
22	10045212	.	T	C	3	4	7	0	0	7	0	0
22	10045225	.	A	C	2	3	5	0	0	5	0	0
22	10048779	.	T	C	3	2	5	0	0	5	0	0
22	10049094	.	G	A	1	2	3	0	0	3	0	0
22	10049148	.	G	T	2	2	4	0	0	4	0	0
22	10054364	.	G	C	1	0	1	0	2	3	0	0
22	10123910	.	G	C	4	13	17	0	2	19	0	0
22	10123962	.	T	C	5	0	5	0	14	19	0	0
22	10123998	.	C	T	1	12	13	0	13	26	0	0
22	10129878	.	A	G	6	7	13	0	0	13	0	0
22	10159001	.	C	T	5	4	9	0	1	10	0	0
22	10159339	.	C	T	8	7	15	0	1	16	0	0
22	10162958	.	A	T	10	10	20	0	0	20	0	0
22	10168219	.	T	C	3	5	8	0	0	8	0	0
22	10184079	.	T	A	5	4	9	0	1	10	0	0
22	10189611	.	A	G	4	4	8	0	1	9	0	0
22	10189781	.	G	A	1	6	7	0	0	7	0	0
22	10190801	.	T	C	12	11	23	0	1	24	0	0
22	10196055	.	A	T	5	6	11	0	0	11	0	0
22	10196058	.	T	A	4	5	9	0	0	9	0	0
22	10196291	.	T	C	11	11	22	0	1	23	0	0
22	10196297	.	A	T	13	10	23	0	0	23	0	0
22	10196330	.	C	T	11	12	23	0	1	24	0	0
22	10196468	.	A	T	7	11	18	0	1	20	1	0
22	10196483	.	A	G	6	10	16	0	1	17	0	0
22	10196508	.	T	A	8	9	17	0	1	18	0	0
22	10196634	.	C	T	11	15	26	0	1	27	0	0
22	10196813	.	A	G	15	0	15	1	22	38	0	0
22	10196821	.	C	T	17	13	30	1	4	35	0	0
22	10197180	.	T	A	27	10	37	0	1	38	0	0
22	10197195	.	T	C	21	9	30	0	0	31	1	0
22	10197395	.	G	T	1	14	15	1	19	35	0	0
22	10197433	.	T	A	24	14	38	0	1	39	0	0
22	10197957	.	C	A	12	15	27	1	3	31	0	0
22	10197966	.	C	T	17	12	29	0	4	33	0	0
22	10198018	.	A	C	14	19	33	0	0	33	0	0
22	10198075	.	T	G	6	0	6	0	9	15	0	0
22	10198120	.	A	T	10	5	15	0	2	17	0	0
22	10198167	.	G	A	13	18	31	1	2	34	0	0
22	10198211	.	T	C	7	15	22	0	0	22	0	0
22	10198232	.	T	A	6	10	16	0	0	16	0	0
22	10198335	.	A	C	18	17	35	0	1	36	0	0
22	10198359	.	G	A	18	18	36	0	2	38	0	0
22	10198399	.	T	A	26	18	44	0	1	45	0	0
22	10205736	.	C	T	15	19	34	0	3	37	0	0
22	10208212	.	C	T	23	18	41	0	2	43	0	0
22	10210467	.	T	C	12	20	32	0	1	33	0	0
22	10212089	.	C	T	23	26	49	0	3	52	0	0
22	10212161	.	A	C	28	25	53	0	5	58	0	0
22	10212307	.	C	T	23	17	40	0	2	42	0	0
22	10212416	.	T	A	4	14	18	0	1	19	0	0
22	10215007	.	T	C	3	2	5	0	0	5	0	0
22	10215008	.	G	A	3	2	5	0	0	5	0	0
22	10218656	.	A	T	5	5	10	0	0	10	0	0
22	10218682	.	A	T	3	2	5	0	0	5	0	0
22	10218916	.	T	A	1	5	6	0	1	7	0	0
22	10218973	.	T	C	4	6	10	0	1	11	0	0
22	10219030	.	T	C	6	8	14	0	1	15	0	0
22	10260258	.	G	A	0	9	9	0	9	18	0	0
22	10260468	.	A	G	2	0	2	0	6	8	0	0
22	10261037	.	C	T	4	4	8	0	0	8	0	0
22	10261723	.	A	G	7	5	12	0	1	13	0	0
22	10261792	.	T	A	6	8	14	0	2	16	0	0
22	10261853	.	G	A	11	5	16	0	2	18	0	0
22	10261905	.	T	C	11	7	18	0	0	18	0	0
22	10262236	.	T	G	13	5	18	0	0	18	0	0
22	10282344	.	G	A	3	4	7	0	0	7	0	0
22	10282401	.	C	A	1	2	3	0	0	3	0	0
22	10284372	.	A	G	1	2	3	0	0	3	0	0
22	10361190	.	A	T	1	4	5	0	1	6	0	0
22	10361385	.	C	G	9	3	12	0	0	12	0	0
22	10361391	.	T	C	3	7	10	0	0	10	0	0
22	10361577	.	G	C	14	0	14	0	10	24	0	0
22	10361937	.	C	T	1	13	14	0	6	20	0	0
22	10362072	.	G	A	7	7	14	0	3	17	0	0
22	10362239	.	G	A	10	9	19	0	3	23	1	0
22	10368054	.	A	T	8	6	14	0	1	15	0	0
22	10372950	.	A	C	3	0	3	0	5	8	0	0
22	10373099	.	C	T	1	5	6	0	4	10	0	0
22	10373118	.	A	T	3	3	6	0	1	7	0	0
22	10373263	.	G	T	2	6	8	0	0	8	0	0
22	10373617	.	G	A	2	3	5	0	1	6	0	0
22	10373849	.	G	A	2	2	4	0	0	4	0	0
22	10375864	.	C	T	1	2	3	0	0	3	0	0
22	10383159	.	A	G	4	4	8	0	0	8	0	0
22	10386085	.	T	G	4	3	7	0	0	7	0	0
22	10390601	.	G	C	2	2	4	0	0	4	0	0
22	10391280	.	G	A	2	3	5	0	0	5	0	0
22	10396971	.	G	C	3	2	5	0	0	5	0	0
22	10427265	.	T	A	4	2	6	0	0	6	0	0
22	10427283	.	C	T	1	2	3	0	5	8	0	0
22	10430183	.	C	A	0	3	3	0	6	9	0	0
22	10430369	.	A	T	4	5	9	0	0	9	0	0
22	10490987	.	G	A	1	3	4	0	0	4	0	0
22	10513686	.	C	T	1	3	4	0	0	4	0	0
22	10513689	.	T	A	1	3	4	0	0	4	0	0
22	10513783	.	T	C	3	4	7	0	0	7	0	0
22	10514288	.	G	T	8	9	17	0	0	17	0	0
22	10514302	.	C	T	2	8	10	0	4	15	1	0
22	10517306	.	G	T	1	2	3	0	0	3	0	0
22	10517499	.	T	C	1	0	1	0	2	3	0	0
22	10517505	.	A	C	1	0	1	0	2	3	0	0
22	10545267	.	C	T	2	4	6	0	0	7	1	0
22	10545408	.	G	A	4	2	6	0	0	6	0	0
22	10548171	.	G	A	1	3	4	0	0	4	0	0
22	10550310	.	C	G	1	0	1	0	4	5	0	0
22	10553526	.	G	A	3	4	7	0	0	7	0	0
22	10553532	.	C	T	3	3	6	0	0	6	0	0
22	10553620	.	G	T	2	6	8	0	0	8	0	0
22	10553626	.	G	A	3	5	8	0	0	8	0	0
22	10557870	.	T	G	10	3	13	0	1	14	0	0
22	10557898	.	C	T	8	3	11	0	1	12	0	0
22	10558913	.	G	A	0	4	4	0	4	8	0	0
22	10561255	.	A	T	14	9	23	0	0	23	0	0
22	10561514	.	A	G	8	9	17	0	3	20	0	0
22	10561758	.	A	G	11	13	24	0	1	25	0	0
22	10564220	.	T	C	10	1	11	0	14	25	0	0
22	10564247	.	A	C	16	10	26	0	0	26	0	0
22	10567550	.	T	A	5	5	10	0	1	11	0	0
22	10570575	.	T	C	2	7	9	0	0	9	0	0
22	10592056	.	A	G	3	2	5	0	0	5	0	0
22	10592059	.	A	G	2	2	4	0	0	4	0	0
22	10592426	.	C	A	6	4	10	0	0	10	0	0
22	10592719	.	T	C	13	13	26	0	2	28	0	0
22	10593310	.	A	G	8	7	15	0	1	16	0	0
22	10593527	.	A	G	13	11	24	0	1	25	0	0
22	10593531	.	G	A	11	10	21	0	0	21	0	0
22	10593831	.	T	C	9	7	16	0	1	17	0	0
22	10593990	.	A	G	9	7	16	0	0	16	0	0
22	10594008	.	G	T	5	8	13	0	2	15	0	0
22	10594074	.	C	T	16	5	21	0	2	23	0	0
22	10594098	.	G	A	17	8	25	0	1	26	0	0
22	10594170	.	A	G	3	7	10	0	1	11	0	0
22	10597470	.	A	T	9	3	12	0	6	18	0	0
22	10597715	.	T	C	10	0	10	0	6	16	0	0
22	10599510	.	A	G	9	7	16	0	0	16	0	0
22	10600175	.	T	C	6	5	11	0	3	14	0	0
22	10600265	.	C	T	1	7	8	0	10	18	0	0
22	10602243	.	A	G	11	6	17	0	1	18	0	0
22	10604423	.	C	T	7	3	10	0	0	11	1	0
22	10615559	.	A	G	3	2	5	0	0	5	0	0
22	10626747	.	T	C	3	4	7	0	0	7	0	0
22	10626861	.	T	C	2	2	4	0	0	4	0	0
22	10626873	.	C	T	4	3	7	0	1	8	0	0
22	10629133	.	T	C	3	6	9	0	0	9	0	0
22	10631759	.	T	A	3	2	5	0	1	6	0	0
22	10631774	.	C	G	3	4	7	0	0	7	0	0
22	10632503	.	C	T	1	4	5	0	0	5	0	0
22	10634437	.	G	A	6	8	14	0	1	15	0	0
22	10634810	.	T	C	6	3	9	0	0	9	0	0
22	10634822	.	G	A	9	3	12	0	1	13	0	0
22	10635402	.	G	A	9	8	17	0	0	17	0	0
22	10636581	.	T	C	6	12	18	0	3	21	0	0
22	10636762	.	A	T	8	4	12	0	1	13	0	0
22	10636974	.	G	C	8	12	20	0	1	21	0	0
22	10637232	.	A	G	13	12	25	0	0	25	0	0
22	10637253	.	T	C	13	16	29	0	2	31	0	0
22	10637298	.	C	A	12	15	27	0	2	29	0	0
22	10637669	.	G	T	12	7	19	0	0	19	0	0
22	10637729	.	T	C	14	5	19	0	1	20	0	0
22	10638536	.	A	T	10	7	17	0	0	17	0	0
22	10638700	.	T	C	4	5	9	0	1	10	0	0
22	10638887	.	T	C	3	7	10	0	0	10	0	0
22	10638932	.	G	A	0	4	4	0	3	7	0	0
22	10657947	.	T	C	4	3	7	0	0	7	0	0
22	10657980	.	A	G	2	5	7	0	0	7	0	0
22	10658007	.	T	A	3	5	8	0	0	8	0	0
22	10658042	.	A	C	4	4	8	0	0	8	0	0
22	10658090	.	G	A	0	2	2	0	3	5	0	0
22	10658102	.	A	C	4	3	7	0	0	7	0	0
22	10660261	.	A	T	18	16	34	0	0	34	0	0
22	10662886	.	C	T	11	8	19	0	2	21	0	0
22	10662952	.	C	T	17	8	25	0	1	26	0	0
22	10663090	.	G	T	3	9	12	0	11	23	0	0
22	10663390	.	T	G	13	12	25	0	1	26	0	0
22	10663433	.	A	T	9	8	17	0	3	20	0	0
22	10663469	.	T	A	10	5	15	0	1	16	0	0
22	10663504	.	T	A	16	13	29	0	1	30	0	0
22	10663567	.	A	T	16	15	31	0	3	34	0	0
22	10663915	.	A	T	1	2	3	0	2	5	0	0
22	10678954	.	A	G	2	2	4	0	0	4	0	0
22	10679121	.	G	T	0	2	2	0	1	3	0	0
22	10685598	.	C	T	1	2	3	0	0	3	0	0
22	10688155	.	G	A	1	3	4	0	0	4	0	0
22	10688179	.	T	A	2	2	4	0	0	4	0	0
22	10688844	.	A	T	1	2	3	0	2	5	0	0
22	10690497	.	T	A	1	2	3	0	0	3	0	0
22	10698635	.	A	T	5	1	6	0	1	7	0	0
22	10699012	.	T	C	4	4	8	0	0	8	0	0
22	10699054	.	C	G	3	5	8	0	1	9	0	0
22	10704081	.	T	G	7	0	7	0	8	15	0	0
22	10704255	.	A	C	15	7	22	0	2	24	0	0
22	10704279	.	T	C	17	7	24	0	0	24	0	0
22	10706462	.	G	A	1	11	12	0	9	21	0	0
22	10706586	.	T	G	7	10	17	0	0	17	0	0
22	10706603	.	G	A	0	12	12	0	10	22	0	0
22	10706855	.	T	A	7	7	14	0	0	14	0	0
22	10713858	.	T	C	2	4	6	0	1	7	0	0
22	10713880	.	C	A	3	4	7	0	0	7	0	0
22	10720122	.	G	A	2	4	6	0	0	6	0	0
22	10726968	.	T	C	7	7	14	0	0	14	0	0
22	10729626	.	C	T	7	8	15	0	0	15	0	0
22	10729675	.	C	A	7	19	26	0	0	26	0	0
22	10733284	.	C	G	12	0	12	0	24	36	0	0
22	10733360	.	A	G	13	0	13	0	18	31	0	0
22	10733512	.	C	T	6	9	15	0	1	16	0	0
22	10733554	.	G	A	10	9	19	0	0	19	0	0
22	10733977	.	A	G	3	2	5	0	0	5	0	0
22	10733992	.	A	T	3	2	5	0	0	5	0	0
22	10734916	.	G	A	11	5	16	0	2	18	0	0
22	10734967	.	A	T	10	5	15	0	1	16	0	0
22	10755600	.	A	G	13	13	26	0	0	26	0	0
22	10755652	.	T	A	9	11	20	0	2	22	0	0
22	10755746	.	G	T	20	16	36	0	1	37	0	0
22	10755888	.	T	C	21	14	35	0	2	37	0	0
22	10771195	.	C	T	1	5	6	0	4	11	1	0
22	10771284	.	T	C	10	10	20	0	0	20	0	0
22	10771369	.	G	A	8	8	16	0	2	18	0	0
22	10771415	.	A	T	8	10	18	0	2	20	0	0
22	10771628	.	T	C	8	6	14	0	0	14	0	0
22	10771743	.	C	G	3	10	13	0	1	14	0	0
22	10771752	.	G	A	4	11	15	0	0	15	0	0
22	10771919	.	T	C	8	0	8	0	13	21	0	0
22	10774628	.	G	A	6	10	16	1	1	18	0	0
22	10774632	.	T	C	5	10	15	1	0	16	0	0
22	10784741	.	C	A	1	3	4	0	0	4	0	0
22	10784758	.	G	A	0	3	3	0	1	4	0	0
22	10794802	.	A	C	1	2	3	0	0	3	0	0
22	10795696	.	C	G	1	2	3	0	0	3	0	0
22	10814281	.	A	C	5	0	5	0	1	6	0	0
22	10814285	.	G	A	6	2	8	0	0	8	0	0
22	10814345	.	A	G	4	3	7	0	0	7	0	0
22	10816880	.	T	C	1	0	1	0	2	3	0	0
22	10835415	.	G	A	1	3	4	0	0	4	0	0
22	10844935	.	C	T	1	2	3	0	0	3	0	0
22	10844938	.	A	T	1	2	3	0	0	3	0	0
22	10928084	.	A	G	4	2	6	0	0	6	0	0
22	10930054	.	T	C	4	0	4	0	3	7	0	0
22	10932048	.	G	A	1	2	3	0	0	3	0	0
22	11071011	.	G	C	3	0	3	0	2	5	0	0
22	11071053	.	A	G	4	2	6	0	0	6	0	0
22	11071059	.	C	T	4	1	5	0	0	5	0	0
22	11071416	.	G	C	2	3	5	2	0	7	0	0
22	11071505	.	A	G	2	5	7	0	0	7	0	0
22	11071568	.	C	A	5	5	10	0	0	10	0	0
22	11071698	.	T	G	3	5	8	0	1	9	0	0
22	11075978	.	A	G	8	4	12	0	1	13	0	0
22	11078902	.	T	C	4	6	10	0	0	10	0	0
22	11078944	.	C	A	0	8	8	0	8	16	0	0
22	11123770	.	C	T	30	18	48	0	1	49	0	0
22	11123889	.	T	C	23	11	34	0	4	38	0	0
22	11124524	.	T	C	30	25	55	0	2	57	0	0
22	11126857	.	A	G	27	26	53	0	1	54	0	0
22	11126866	.	G	A	26	24	50	0	2	52	0	0
22	11129995	.	G	A	23	17	40	0	0	40	0	0
22	11130058	.	T	C	19	2	21	1	11	33	0	0
22	11135408	.	G	A	17	10	27	0	2	29	0	0
22	11135446	.	G	A	21	13	34	0	1	35	0	0
22	11136606	.	G	A	18	21	39	0	0	39	0	0
22	11155516	.	A	G	1	0	1	0	3	4	0	0
22	11156275	.	C	T	4	7	11	0	0	11	0	0
22	11156977	.	C	A	2	2	4	0	1	5	0	0
22	11157023	.	G	C	3	3	6	0	0	6	0	0
22	11157035	.	A	T	2	2	4	0	0	4	0	0
22	11161201	.	T	C	11	11	22	0	0	22	0	0
22	11170855	.	T	C	14	7	21	1	1	23	0	0
22	11170954	.	T	C	12	9	21	0	1	22	0	0
22	11170966	.	T	G	13	0	13	0	10	23	0	0
22	11171086	.	G	A	13	13	26	0	2	28	0	0
22	11188598	.	C	T	9	10	19	0	2	21	0	0
22	11199942	.	T	A	18	14	32	0	2	34	0	0
22	11200242	.	T	G	2	7	9	0	0	10	1	0
22	11200401	.	G	A	1	8	9	0	21	30	0	0
22	12163370	.	T	A	10	7	17	0	1	18	0	0
22	12171293	.	G	A	5	4	9	0	1	10	0	0
22	12174573	.	T	G	13	4	17	0	0	17	0	0
22	12174740	.	A	G	14	9	23	0	1	24	0	0
22	12175021	.	T	G	21	0	21	0	11	32	0	0
22	12175181	.	T	C	9	9	18	0	0	18	0	0
22	12175556	.	A	G	9	0	9	0	14	23	0	0
22	12175583	.	A	T	9	12	21	0	2	23	0	0
22	12176043	.	G	T	20	11	31	0	2	33	0	0
22	12218882	.	C	A	1	2	3	0	0	3	0	0
22	12218884	.	G	A	1	2	3	0	0	3	0	0
22	12230054	.	G	A	1	3	4	0	0	4	0	0
22	12243335	.	G	A	2	3	5	0	0	5	0	0
22	12243380	.	G	A	1	2	3	0	0	3	0	0
22	12247703	.	T	G	1	1	2	0	1	3	0	0
22	12247715	.	T	C	2	0	2	0	2	4	0	0
22	12247778	.	G	A	3	6	9	0	0	9	0	0
22	12391480	.	A	G	4	0	4	0	2	6	0	0
22	13047271	.	G	A	4	2	6	0	0	6	0	0
22	13459294	.	A	G	7	12	19	0	1	20	0	0
22	13459472	.	T	A	6	2	8	0	2	10	0	0
22	13459596	.	T	C	8	0	8	0	11	19	0	0
22	13459611	.	A	G	7	9	16	0	3	19	0	0
22	13459636	.	G	T	8	11	19	0	0	19	0	0
22	13459718	.	A	G	10	8	18	0	1	19	0	0
22	13459865	.	G	C	6	1	7	0	13	20	0	0
22	13460406	.	T	C	7	14	21	0	2	23	0	0
22	13460441	.	C	T	0	13	13	0	7	20	0	0
22	13460483	.	A	G	6	10	16	0	1	17	0	0
22	13460509	.	T	G	5	11	16	0	1	17	0	0
22	13461012	.	A	G	6	4	10	0	0	10	0	0
22	13461073	.	C	G	7	8	15	0	0	15	0	0
22	13461084	.	C	T	9	7	16	0	1	17	0	0
22	13461529	.	T	G	5	10	15	0	0	16	1	0
22	13461622	.	T	C	3	5	8	0	0	8	0	0
22	13461993	.	A	G	5	4	9	0	0	9	0	0
22	13461996	.	A	G	4	4	8	0	1	9	0	0
22	13462863	.	T	C	2	11	13	0	0	13	0	0
22	13463071	.	A	G	7	10	17	0	0	17	0	0
22	13472514	.	G	A	8	5	13	0	0	13	0	0
22	13472568	.	G	C	7	0	7	0	7	14	0	0
22	13479802	.	G	A	5	2	7	0	0	7	0	0
22	13479990	.	A	G	3	7	10	0	1	11	0	0
22	13481352	.	A	G	5	3	8	0	0	8	0	0
22	13481363	.	A	C	5	2	7	0	0	7	0	0
22	13486398	.	A	T	2	4	6	0	0	6	0	0
22	13486926	.	T	A	3	2	5	0	0	5	0	0
22	13486928	.	C	T	3	2	5	0	0	5	0	0
22	13526489	.	A	T	2	1	3	0	0	3	0	0
22	13526497	.	A	G	3	2	5	0	1	6	0	0
22	13715336	.	C	T	2	2	4	0	0	4	0	0
22	13846395	.	T	A	9	10	19	0	1	20	0	0
22	13846606	.	G	A	11	10	21	0	2	23	0	0
22	13846788	.	C	A	4	8	12	0	1	13	0	0
22	13847783	.	A	G	35	22	57	0	1	58	0	0
22	13847797	.	C	G	31	22	53	0	4	57	0	0
22	13847940	.	G	A	23	22	45	0	2	47	0	0
22	13848006	.	A	C	27	1	28	0	22	50	0	0
22	13848031	.	G	A	32	18	50	0	4	54	0	0
22	13848085	.	G	A	30	12	42	0	1	43	0	0
22	13848106	.	A	G	24	11	35	0	0	35	0	0
22	13850865	.	A	G	34	22	56	0	4	60	0	0
22	13919887	.	G	A	3	2	5	0	0	5	0	0
22	13939993	.	G	C	1	2	3	0	0	4	1	0
22	13940036	.	T	C	2	2	4	0	0	4	0	0
22	13942856	.	T	G	1	3	4	0	0	4	0	0
22	13978228	.	T	C	1	7	8	0	0	8	0	0
22	14366222	.	G	A	2	6	8	0	2	10	0	0
22	14380352	.	G	A	2	5	7	0	1	8	0	0
22	14381812	.	G	T	2	2	4	0	0	4	0	0
22	14381857	.	T	G	3	2	5	0	0	5	0	0
22	14381885	.	C	T	0	2	2	0	2	4	0	0
22	14390142	.	C	T	1	4	5	0	0	5	0	0
22	14398606	.	G	T	2	3	5	0	0	5	0	0
22	14398645	.	G	A	3	3	6	0	0	6	0	0
22	14398690	.	A	G	3	4	7	0	0	7	0	0
22	14404788	.	C	A	3	5	8	0	0	8	0	0
22	14445860	.	G	C	1	0	1	0	3	4	0	0
22	14454602	.	C	T	1	2	3	0	0	3	0	0
22	14850790	.	T	A	3	3	6	0	1	7	0	0
22	15010508	.	G	A	1	1	2	0	0	2	0	0
22	16341498	.	G	A	0	3	3	0	4	7	0	0
22	16345485	.	A	G	3	2	5	0	1	6	0	0
22	16345630	.	C	T	4	3	7	0	0	7	0	0
22	16345668	.	C	A	4	5	9	0	1	10	0	0
22	16348504	.	A	T	7	1	8	0	1	9	0	0
22	16348506	.	C	T	6	2	8	0	0	8	0	0
22	16350682	.	G	A	17	17	34	0	2	36	0	0
22	16350792	.	T	A	27	16	43	0	3	46	0	0
22	16350811	.	T	G	28	10	38	0	5	43	0	0
22	16350862	.	C	T	27	8	35	0	0	35	0	0
22	16350877	.	T	A	20	13	33	0	2	35	0	0
22	16351141	.	G	A	12	16	28	0	0	28	0	0
22	16351199	.	C	G	24	9	33	0	0	33	0	0
22	16351345	.	A	T	3	9	12	0	0	12	0	0
22	16351353	.	G	A	2	8	10	0	0	10	0	0
22	16351390	.	A	C	2	3	5	0	0	5	0	0
22	16351490	.	T	G	6	3	9	0	1	10	0	0
22	16351552	.	A	T	6	5	11	0	0	11	0	0
22	16351678	.	C	T	1	2	3	0	1	4	0	0
22	16352215	.	A	G	9	6	15	0	1	16	0	0
22	16352249	.	T	C	11	7	18	0	0	18	0	0
22	16352269	.	T	G	13	5	18	0	0	18	0	0
22	16352668	.	T	C	16	0	16	0	16	32	0	0
22	16352768	.	A	G	18	10	28	0	1	29	0	0
22	16357818	.	A	G	14	7	21	0	0	21	0	0
22	16357831	.	A	G	14	7	21	0	1	22	0	0
22	16357867	.	G	A	13	11	24	0	1	25	0	0
22	16357909	.	C	T	15	11	26	0	0	26	0	0
22	16367055	.	A	G	6	2	8	1	1	10	0	0
22	16377364	.	A	G	9	8	17	0	0	17	0	0
22	16407115	.	A	T	1	2	3	0	0	3	0	0
22	16407136	.	C	T	1	2	3	0	0	3	0	0
22	16412091	.	A	G	3	6	9	0	0	9	0	0
22	16418990	.	G	A	2	3	5	0	0	5	0	0
22	16419007	.	A	T	2	4	6	0	0	6	0	0
22	16423042	.	G	A	1	9	10	0	5	15	0	0
22	16424576	.	T	C	4	5	9	0	1	10	0	0
22	16427969	.	A	G	10	0	10	0	21	31	0	0
22	16428005	.	C	A	11	16	27	0	1	28	0	0
22	16430623	.	G	A	14	10	24	0	0	24	0	0
22	16430782	.	T	A	8	8	16	0	0	16	0	0
22	16430913	.	T	C	2	5	7	0	0	7	0	0
22	16433009	.	G	A	7	3	10	0	0	10	0	0
22	16433054	.	T	A	13	12	25	0	3	28	0	0
22	16433078	.	G	A	17	12	29	0	0	29	0	0
22	16433096	.	A	G	14	19	33	0	1	34	0	0
22	16433378	.	G	A	4	8	12	0	2	14	0	0
22	16433394	.	G	A	2	9	11	0	2	13	0	0
22	16433422	.	A	G	5	8	13	0	2	15	0	0
22	16433895	.	T	C	10	2	12	0	0	12	0	0
22	16433912	.	T	A	14	3	17	0	1	18	0	0
22	16434056	.	G	A	15	6	21	0	1	22	0	0
22	16440072	.	G	A	15	12	27	0	0	27	0	0
22	16440086	.	T	C	15	2	17	0	10	27	0	0
22	16442789	.	A	G	12	18	30	0	0	30	0	0
22	16442796	.	T	A	14	18	32	0	1	33	0	0
22	16477702	.	T	A	1	3	4	0	0	4	0	0
22	16484489	.	G	C	15	1	16	0	17	33	0	0
22	16484712	.	C	T	4	2	6	0	1	7	0	0
22	16484877	.	A	T	4	10	14	0	3	17	0	0
22	16484938	.	A	G	10	14	24	0	1	25	0	0
22	16484944	.	T	C	8	13	21	0	2	23	0	0
22	16485238	.	A	C	12	13	25	0	0	25	0	0
22	16485379	.	A	T	16	8	24	0	0	24	0	0
22	16485538	.	T	C	7	0	7	0	11	18	0	0
22	16485563	.	A	T	6	5	11	0	0	11	0	0
22	16485768	.	G	A	4	5	9	0	0	9	0	0
22	16485790	.	C	T	5	6	11	0	0	11	0	0
22	16485920	.	G	A	8	13	21	0	0	21	0	0
22	16485962	.	C	G	14	6	20	0	0	20	0	0
22	16486102	.	G	A	10	8	18	0	2	20	0	0
22	16486112	.	T	C	11	8	19	0	0	19	0	0
22	16491711	.	C	A	15	10	25	0	2	27	0	0
22	16491942	.	G	A	11	21	32	0	1	33	0	0
22	16498232	.	T	C	12	18	30	0	3	33	0	0
22	16498333	.	A	C	16	22	38	0	3	41	0	0
22	16498661	.	A	G	8	0	8	0	12	20	0	0
22	16537854	.	C	T	9	6	15	0	0	15	0	0
22	16537878	.	C	A	9	6	15	0	1	16	0	0
22	16544243	.	C	T	7	8	15	0	0	15	0	0
22	16544308	.	A	G	6	3	9	2	0	11	0	0
22	16544384	.	G	A	17	9	26	0	0	26	0	0
22	16544400	.	T	G	17	5	22	0	1	23	0	0
22	16544498	.	T	G	12	9	21	1	1	23	0	0
22	16544599	.	A	G	18	0	18	0	19	37	0	0
22	16544674	.	T	G	23	18	41	0	0	41	0	0
22	16544780	.	A	T	16	15	31	0	4	35	0	0
22	16544800	.	G	A	12	12	24	0	1	25	0	0
22	16584198	.	T	G	2	0	2	0	14	16	0	0
22	16594852	.	G	A	8	12	20	0	1	21	0	0
22	16594870	.	T	A	13	5	18	0	0	18	0	0
22	16594981	.	C	A	10	5	15	0	0	15	0	0
22	16597623	.	G	A	8	10	18	0	1	19	0	0
22	16601400	.	C	T	14	4	18	0	0	18	0	0
22	16601422	.	C	T	2	13	15	0	0	15	0	0
22	16606938	.	G	A	6	12	18	0	0	18	0	0
22	16759111	.	G	A	4	2	6	0	0	6	0	0
22	16775197	.	G	A	0	17	17	0	10	27	0	0
22	16775284	.	T	G	9	16	25	0	2	27	0	0
22	16775306	.	C	T	16	10	26	0	1	27	0	0
22	16840260	.	G	A	2	2	4	0	2	6	0	0
22	16862842	.	A	G	6	6	12	0	0	12	0	0
22	16991847	.	C	T	0	4	4	0	2	6	0	0
22	16997788	.	T	A	1	2	3	0	0	3	0	0
22	17187626	.	G	C	3	2	5	0	0	5	0	0
22	17188247	.	A	C	1	2	3	0	0	3	0	0
22	17191224	.	G	A	1	2	3	0	1	4	0	0
22	17197209	.	T	A	8	7	15	0	0	15	0	0
22	17197367	.	A	T	14	10	24	0	1	25	0	0
22	17200635	.	G	A	16	17	33	0	0	33	0	0
22	17200890	.	G	A	6	12	18	0	1	19	0	0
22	17200985	.	A	C	7	12	19	0	0	19	0	0
22	17201015	.	C	G	7	15	22	0	1	23	0	0
22	17201102	.	C	G	12	14	26	0	0	26	0	0
22	17201135	.	G	A	13	12	25	0	1	26	0	0
22	17201172	.	C	T	7	4	11	0	0	11	0	0
22	17208680	.	T	C	12	11	23	0	0	23	0	0
22	17208695	.	A	G	13	8	21	0	1	22	0	0
22	17208770	.	T	C	23	8	31	0	0	31	0	0
22	17208913	.	A	C	8	5	13	0	2	15	0	0
22	17208973	.	G	A	14	12	26	0	1	27	0	0
22	17208983	.	T	C	14	14	28	0	0	28	0	0
22	17209036	.	A	T	19	6	25	0	2	27	0	0
22	17209273	.	T	A	22	11	33	0	0	33	0	0
22	17209384	.	A	C	21	16	37	0	0	37	0	0
22	17209413	.	T	A	24	16	40	0	1	41	0	0
22	17209484	.	T	A	22	14	36	0	1	37	0	0
22	17209492	.	T	A	19	16	35	0	5	40	0	0
22	17209523	.	A	T	20	15	35	0	1	36	0	0
22	17209737	.	T	C	17	11	28	0	1	29	0	0
22	17209762	.	T	C	17	8	25	0	0	25	0	0
22	17209986	.	A	T	11	10	21	0	0	21	0	0
22	17209993	.	A	T	9	9	18	0	0	18	0	0
22	17210053	.	C	G	13	8	21	0	2	23	0	0
22	17210157	.	T	A	28	12	40	0	1	41	0	0
22	17210196	.	C	G	26	0	26	0	14	40	0	0
22	17210217	.	C	A	26	7	33	0	2	35	0	0
22	17210820	.	A	C	38	19	57	0	1	58	0	0
22	17210825	.	G	A	1	19	20	0	38	58	0	0
22	17211343	.	C	T	10	15	25	0	1	26	0	0
22	17211361	.	A	G	12	14	26	0	2	28	0	0
22	17211431	.	C	T	20	21	41	0	1	42	0	0
22	17211438	.	T	C	22	20	42	0	2	44	0	0
22	17211875	.	G	C	27	23	50	0	1	51	0	0
22	17211990	.	A	G	22	17	39	0	3	42	0	0
22	17212235	.	T	A	23	9	32	0	1	33	0	0
22	17212236	.	T	C	22	9	31	0	1	32	0	0
22	17214642	.	A	G	3	2	5	0	1	6	0	0
22	17228144	.	G	A	1	3	4	0	1	5	0	0
22	17228150	.	T	C	1	4	5	0	0	5	0	0
22	17234620	.	G	A	1	3	4	0	6	10	0	0
22	17235449	.	A	C	6	3	9	0	1	10	0	0
22	17235841	.	T	C	6	1	7	0	2	9	0	0
22	17278644	.	G	A	0	2	2	0	1	3	0	0
22	17318172	.	C	T	3	2	5	0	0	5	0	0
22	17318401	.	T	C	6	5	11	0	1	12	0	0
22	17318404	.	T	C	6	5	11	0	0	11	0	0
22	17318635	.	G	T	0	4	4	0	5	9	0	0
22	17322532	.	C	T	7	3	10	0	1	11	0	0
22	17331325	.	A	G	3	3	6	0	1	7	0	0
22	17359735	.	A	G	5	0	5	0	8	13	0	0
22	17359816	.	G	C	1	12	13	0	4	17	0	0
22	17360107	.	C	A	13	6	19	0	1	20	0	0
22	17360428	.	G	A	1	11	12	0	11	23	0	0
22	17405361	.	C	T	6	2	8	0	0	8	0	0
22	17446858	.	T	C	21	20	41	0	3	44	0	0
22	17448778	.	G	A	17	21	38	0	3	42	1	0
22	17448781	.	C	T	18	22	40	0	1	41	0	0
22	17450115	.	G	A	0	16	16	0	16	32	0	0
22	17452798	.	C	T	14	25	39	0	1	40	0	0
22	17453286	.	T	G	21	16	37	0	2	39	0	0
22	17453336	.	A	G	17	0	17	0	18	35	0	0
22	17453419	.	G	A	15	11	26	0	0	26	0	0
22	17453478	.	T	A	24	18	42	0	0	42	0	0
22	17453552	.	T	C	15	9	24	0	0	24	0	0
22	17453569	.	C	G	16	5	21	0	0	21	0	0
22	17453680	.	C	T	16	9	25	0	1	26	0	0
22	17453688	.	A	G	13	9	22	0	0	22	0	0
22	17453742	.	A	G	10	10	20	1	3	24	0	0
22	17453836	.	A	G	12	15	27	0	1	28	0	0
22	17453883	.	A	T	12	22	34	0	0	34	0	0
22	17453884	.	T	C	11	22	33	0	0	33	0	0
22	17454015	.	T	C	20	14	34	0	0	34	0	0
22	17454038	.	G	T	20	10	30	0	0	30	0	0
22	17454120	.	C	T	6	6	12	1	2	15	0	0
22	17454178	.	A	G	8	0	8	0	12	20	0	0
22	17454179	.	T	G	7	10	17	0	2	19	0	0
22	17454320	.	T	C	15	13	28	0	0	28	0	0
22	17454382	.	C	T	4	8	12	0	0	12	0	0
22	17454424	.	C	T	1	4	5	0	0	5	0	0
22	17455835	.	C	A	1	2	3	0	0	3	0	0
22	17501623	.	G	C	19	13	32	0	1	33	0	0
22	17505820	.	A	C	26	24	50	0	3	53	0	0
22	17506536	.	A	T	26	15	41	0	2	43	0	0
22	17506537	.	T	G	25	17	42	0	1	43	0	0
22	17509449	.	A	T	3	2	5	0	0	5	0	0
22	17509494	.	T	A	6	5	11	0	1	12	0	0
22	17509533	.	T	A	5	4	9	0	0	9	0	0
22	17517881	.	G	A	3	7	10	0	1	11	0	0
22	17531044	.	G	A	1	10	11	0	8	19	0	0
22	17531188	.	A	G	13	20	33	0	0	33	0	0
22	17533907	.	C	T	10	8	18	0	0	18	0	0
22	17539297	.	C	T	26	18	44	0	1	45	0	0
22	17539633	.	G	A	30	27	57	0	1	58	0	0
22	17540807	.	C	T	34	22	56	0	2	58	0	0
22	17541450	.	C	A	16	8	24	0	0	24	0	0
22	17541593	.	G	A	17	17	34	1	1	36	0	0
22	17542016	.	C	T	17	24	41	0	1	42	0	0
22	17542057	.	C	T	15	16	31	0	3	34	0	0
22	17542117	.	T	C	13	13	26	0	1	27	0	0
22	17542136	.	G	A	13	17	30	0	2	32	0	0
22	17542199	.	A	T	13	8	21	0	0	21	0	0
22	17542293	.	C	T	17	7	24	0	1	25	0	0
22	17542594	.	G	T	9	4	13	1	1	15	0	0
22	17542702	.	G	A	9	3	12	0	0	12	0	0
22	17542774	.	C	T	4	2	6	0	0	6	0	0
22	17542892	.	A	G	2	4	6	0	1	7	0	0
22	17543079	.	C	G	8	4	12	0	0	12	0	0
22	17543408	.	A	G	7	8	15	1	1	17	0	0
22	17543421	.	G	A	9	7	16	1	0	17	0	0
22	17543552	.	G	A	8	10	18	0	1	19	0	0
22	17543634	.	A	C	12	11	23	0	0	23	0	0
22	17543668	.	A	T	4	8	12	0	0	12	0	0
22	17543748	.	A	C	3	0	3	0	7	10	0	0
22	17543903	.	A	G	9	7	16	0	0	16	0	0
22	17550643	.	T	C	8	0	8	0	6	14	0	0
22	17550664	.	G	A	10	8	18	0	2	20	0	0
22	17550684	.	C	T	1	11	12	0	9	21	0	0
22	17550724	.	T	G	7	11	18	0	0	18	0	0
22	17552526	.	A	G	14	9	23	0	0	23	0	0
22	17554785	.	G	A	8	13	21	0	1	22	0	0
22	17560376	.	A	C	7	4	11	0	0	11	0	0
22	17564009	.	T	C	13	9	22	0	1	23	0	0
22	17565735	.	C	T	13	8	21	0	0	21	0	0
22	17565837	.	A	G	10	7	17	0	0	17	0	0
22	17571533	.	C	A	6	6	12	0	0	12	0	0
22	17590019	.	G	A	27	19	46	0	1	47	0	0
22	17590037	.	C	T	24	23	47	0	3	50	0	0
22	17591712	.	G	A	12	35	47	1	1	49	0	0
22	17596874	.	G	A	10	27	37	0	1	38	0	0
22	17596903	.	C	G	14	35	49	0	1	51	1	0
22	17596943	.	A	T	14	26	40	0	1	41	0	0
22	17606908	.	A	C	5	8	13	0	0	13	0	0
22	17607226	.	G	A	11	15	26	0	2	28	0	0
22	17609589	.	C	G	6	4	10	0	0	10	0	0
22	17693792	.	C	T	0	2	2	0	1	3	0	0
22	17822821	.	A	G	4	2	6	0	0	6	0	0
22	17822833	.	T	C	5	3	8	0	0	8	0	0
22	17828741	.	C	T	10	4	14	0	0	14	0	0
22	17829069	.	A	C	10	6	16	0	0	16	0	0
22	17829168	.	A	G	10	10	20	0	1	21	0	0
22	17830360	.	A	G	20	15	35	0	2	37	0	0
22	17830632	.	A	G	15	7	22	0	3	25	0	0
22	17830640	.	A	G	17	7	24	0	0	24	0	0
22	17865106	.	G	A	4	6	10	0	1	11	0	0
22	17878868	.	G	A	3	5	8	0	0	8	0	0
22	17881737	.	A	G	1	6	7	0	0	7	0	0
22	17881743	.	T	C	1	5	6	0	0	6	0	0
22	18164768	.	T	A	1	2	3	0	0	3	0	0
22	18175050	.	T	A	1	3	4	0	0	4	0	0
22	18175062	.	T	A	1	2	3	0	0	3	0	0
22	18202324	.	A	G	1	2	3	0	0	3	0	0
22	18211058	.	G	A	2	2	4	0	0	4	0	0
22	18213480	.	A	C	3	4	7	0	0	7	0	0
22	18214614	.	A	G	1	2	3	0	0	3	0	0
22	18231080	.	A	G	1	2	3	0	0	3	0	0
22	18231099	.	G	T	2	2	4	0	0	4	0	0
22	18231234	.	A	G	4	2	6	0	0	6	0	0
22	18231673	.	T	A	1	7	8	0	1	9	0	0
22	18231770	.	C	G	3	4	7	1	0	8	0	0
22	18231836	.	A	T	4	2	6	0	1	7	0	0
22	18231942	.	A	G	2	2	4	0	0	4	0	0
22	18232416	.	G	A	2	2	4	0	1	5	0	0
22	18232475	.	A	C	5	4	9	0	0	9	0	0
22	18232503	.	G	C	7	5	12	0	0	12	0	0
22	18232527	.	C	T	7	5	12	0	0	12	0	0
22	18232612	.	C	T	3	3	6	0	0	6	0	0
22	18232640	.	G	A	2	1	3	0	1	4	0	0
22	18232711	.	A	G	5	5	10	0	0	10	0	0
22	18232754	.	T	C	1	3	4	0	1	5	0	0
22	18232868	.	G	T	1	4	5	0	0	5	0	0
22	18232935	.	T	G	5	6	11	0	1	12	0	0
22	18233053	.	C	A	4	6	10	0	0	10	0	0
22	18233219	.	C	A	0	2	2	0	5	7	0	0
22	18233234	.	T	C	2	3	5	0	0	5	0	0
22	18233284	.	T	A	5	2	7	0	0	7	0	0
22	18233367	.	T	A	4	9	13	0	2	15	0	0
22	18233403	.	G	A	7	6	13	0	1	14	0	0
22	18233747	.	T	C	5	7	12	0	2	14	0	0
22	18234340	.	A	C	2	2	4	0	0	4	0	0
22	18236760	.	G	A	1	3	4	0	0	4	0	0
22	18247883	.	T	C	5	2	7	1	0	8	0	0
22	18353302	.	T	G	1	4	5	0	0	5	0	0
22	18376143	.	G	C	0	3	3	0	1	4	0	0
22	18376359	.	C	A	5	3	8	0	0	8	0	0
22	18376434	.	G	A	11	5	16	0	1	17	0	0
22	18376467	.	A	C	6	3	9	0	1	10	0	0
22	18383311	.	G	T	0	4	4	0	2	6	0	0
22	18384304	.	T	G	12	2	14	0	0	15	1	0
22	18384306	.	G	T	8	5	13	0	1	14	0	0
22	18459182	.	C	T	9	5	14	0	0	14	0	0
22	18461964	.	C	T	13	6	19	0	0	19	0	0
22	18462018	.	A	G	15	6	21	0	1	22	0	0
22	18462239	.	C	T	9	12	21	0	0	21	0	0
22	18464455	.	T	C	11	17	28	0	0	28	0	0
22	18488823	.	T	C	2	8	10	0	0	10	0	0
22	18488952	.	C	A	3	2	5	0	1	6	0	0
22	18489191	.	A	G	7	3	10	0	0	10	0	0
22	18530548	.	T	A	1	2	3	0	0	3	0	0
22	18530697	.	A	C	1	3	4	0	0	4	0	0
22	18542090	.	C	T	26	22	48	0	0	48	0	0
22	18542195	.	C	A	3	2	5	0	0	5	0	0
22	18542393	.	C	T	16	13	29	0	2	31	0	0
22	18542508	.	A	G	26	12	38	1	3	43	1	0
22	18542720	.	A	T	25	20	45	1	4	50	0	0
22	18543819	.	C	G	30	25	55	0	2	57	0	0
22	18543847	.	T	G	30	26	56	0	2	58	0	0
22	18544465	.	C	T	5	29	34	2	44	80	0	0
22	18544992	.	T	C	34	31	65	0	1	66	0	0
22	18725485	.	T	A	7	7	14	0	1	15	0	0
22	18726040	.	A	T	17	24	41	0	1	44	2	0
22	18726470	.	A	T	22	22	44	1	2	47	0	0
22	18726505	.	T	A	21	18	39	1	3	43	0	0
22	18726668	.	C	A	13	26	39	0	2	41	0	0
22	18727787	.	C	A	2	9	11	0	13	24	0	0
22	18727890	.	G	A	18	7	25	0	0	25	0	0
22	18736155	.	T	C	20	0	20	0	16	36	0	0
22	18736182	.	C	T	20	10	30	0	2	32	0	0
22	18736859	.	A	G	25	9	34	0	2	36	0	0
22	18746486	.	A	G	6	4	10	0	0	10	0	0
22	18778872	.	C	T	24	25	49	0	1	50	0	0
22	18778895	.	A	C	23	23	46	0	2	48	0	0
22	18799110	.	T	G	6	8	14	0	0	14	0	0
22	18799190	.	C	T	6	8	14	0	0	14	0	0
22	18896221	.	G	A	0	2	2	0	1	3	0	0
22	18966298	.	T	C	2	3	5	0	0	5	0	0
22	18966421	.	G	A	2	2	4	0	0	4	0	0
22	18966529	.	A	T	2	2	4	0	1	5	0	0
22	18966575	.	T	C	1	3	4	0	0	4	0	0
22	18971697	.	T	C	1	4	5	0	0	5	0	0
22	18971736	.	T	C	1	2	3	0	0	3	0	0
22	20954086	.	T	A	1	3	4	0	0	4	0	0
22	21303748	.	A	G	1	0	1	0	2	3	0	0
22	21303773	.	A	T	1	3	4	0	0	4	0	0
22	21367155	.	G	C	2	2	4	0	0	4	0	0
22	21369882	.	C	T	0	3	3	0	3	6	0	0
22	21407312	.	T	C	5	5	10	0	0	10	0	0
22	21454448	.	A	G	1	0	1	0	2	3	0	0
22	21465156	.	T	C	2	6	8	0	0	8	0	0
22	21465232	.	T	C	2	2	4	0	0	4	0	0
22	21465597	.	G	T	4	2	6	0	0	6	0	0
22	21465606	.	T	C	4	1	5	0	1	6	0	0
22	21530404	.	C	G	1	2	3	0	0	3	0	0
22	21530405	.	A	G	1	2	3	0	0	3	0	0
22	21541437	.	A	G	1	3	4	0	0	4	0	0
22	21584038	.	G	A	4	3	7	0	0	7	0	0
22	21618495	.	A	G	2	0	2	0	4	6	0	0
22	21618633	.	G	A	6	8	14	0	0	14	0	0
22	21624764	.	G	C	2	5	7	0	0	7	0	0
22	21657871	.	C	T	12	6	18	1	1	20	0	0
22	21661029	.	T	C	4	6	10	0	0	10	0	0
22	21661258	.	T	A	8	10	18	0	4	22	0	0
22	21661611	.	A	G	1	0	1	0	3	4	0	0
22	21661819	.	T	C	2	12	14	3	1	18	0	0
22	21676215	.	A	G	5	2	7	11	0	18	0	0
22	21676296	.	G	A	3	18	21	0	1	22	0	0
22	21680218	.	G	T	6	2	8	0	0	8	0	0
22	21680240	.	T	A	5	3	8	0	0	8	0	0
22	21852158	.	C	T	15	13	28	0	1	29	0	0
22	21852269	.	A	G	11	8	19	0	3	22	0	0
22	21852281	.	T	C	9	0	9	1	10	20	0	0
22	22129478	.	C	T	0	2	2	0	2	4	0	0
22	22129568	.	T	A	6	2	8	0	1	9	0	0
22	22129754	.	A	G	6	6	12	0	0	12	0	0
22	22129883	.	T	C	5	4	9	0	0	9	0	0
22	22130255	.	G	A	9	4	13	0	0	13	0	0
22	22130414	.	A	C	2	0	2	0	2	4	0	0
22	22130528	.	G	A	3	5	8	0	0	8	0	0
22	22130549	.	T	C	5	2	7	0	0	7	0	0
22	22141788	.	C	T	3	2	5	0	0	5	0	0
22	22142272	.	G	A	3	2	5	0	0	5	0	0
22	22142293	.	A	T	1	2	3	1	0	4	0	0
22	22179714	.	A	G	13	9	22	0	0	22	0	0
22	22179825	.	C	T	7	12	19	0	1	20	0	0
22	22187939	.	T	A	5	9	14	0	0	14	0	0
22	22188682	.	T	C	13	12	25	0	0	25	0	0
22	22188715	.	T	C	13	10	23	0	3	26	0	0
22	22188717	.	C	T	17	10	27	0	0	27	0	0
22	22214640	.	G	A	2	4	6	0	0	6	0	0
22	22214852	.	T	C	3	3	6	0	2	8	0	0
22	22231662	.	C	T	5	4	9	0	0	9	0	0
22	22231717	.	A	T	3	4	7	0	1	8	0	0
22	22234418	.	C	T	2	11	13	0	10	23	0	0
22	22234750	.	G	A	15	23	38	0	1	39	0	0
22	22241769	.	A	G	16	17	33	0	2	35	0	0
22	22245435	.	C	T	13	9	22	0	1	23	0	0
22	22245617	.	A	G	15	8	23	0	3	26	0	0
22	22245781	.	G	T	9	10	19	0	0	19	0	0
22	22245812	.	C	T	7	10	17	0	3	20	0	0
22	22259155	.	G	A	9	4	13	0	0	13	0	0
22	22273388	.	C	T	8	4	12	0	0	12	0	0
22	22273465	.	G	A	11	8	19	0	1	20	0	0
22	22274249	.	T	G	6	4	10	0	0	10	0	0
22	22303040	.	T	G	5	2	7	0	0	7	0	0
22	22312463	.	G	A	4	2	6	0	0	6	0	0
22	22312496	.	C	A	1	4	5	0	0	5	0	0
22	22313395	.	G	A	0	4	4	0	5	9	0	0
22	22313574	.	A	G	1	0	1	0	3	4	0	0
22	22313601	.	C	T	3	3	6	0	0	6	0	0
22	22313639	.	A	C	3	2	5	0	0	5	0	0
22	22313686	.	G	A	0	3	3	0	2	5	0	0
22	22313710	.	C	A	2	3	5	0	0	5	0	0
22	22313794	.	G	A	4	6	10	0	0	10	0	0
22	22314043	.	T	G	4	7	11	0	0	11	0	0
22	22314046	.	G	A	3	7	10	0	1	11	0	0
22	22314094	.	T	C	6	7	13	0	1	14	0	0
22	22314547	.	T	G	6	6	12	0	0	12	0	0
22	22314564	.	C	A	7	7	14	0	0	14	0	0
22	22314991	.	T	C	6	6	12	0	0	12	0	0
22	22315211	.	A	G	2	4	6	0	0	6	0	0
22	22345197	.	C	T	14	13	27	0	1	28	0	0
22	22348234	.	A	G	9	9	18	0	1	19	0	0
22	22350963	.	C	T	8	8	16	0	1	17	0	0
22	22351180	.	A	T	12	15	27	0	1	28	0	0
22	22352249	.	C	T	13	10	23	0	1	24	0	0
22	22352312	.	T	C	8	11	19	0	1	20	0	0
22	22352611	.	A	C	6	10	16	0	1	17	0	0
22	22352693	.	T	A	11	8	19	0	2	21	0	0
22	22353128	.	G	A	15	5	20	0	1	21	0	0
22	22353779	.	G	A	4	4	8	0	0	8	0	0
22	22353803	.	C	T	1	4	5	0	3	8	0	0
22	22353822	.	G	A	5	6	11	0	0	11	0	0
22	22353902	.	G	A	1	3	4	0	2	6	0	0
22	22354867	.	C	T	2	2	4	0	0	4	0	0
22	22418224	.	C	T	1	1	2	0	1	3	0	0
22	22418245	.	G	T	4	5	9	0	0	9	0	0
22	22418342	.	C	T	1	2	3	0	0	3	0	0
22	22418446	.	A	G	2	0	2	0	5	7	0	0
22	22418465	.	A	T	4	3	7	0	0	7	0	0
22	22420420	.	A	G	2	2	4	0	1	5	0	0
22	22420646	.	G	T	0	6	6	0	5	11	0	0
22	22420664	.	A	G	4	3	7	0	1	8	0	0
22	22420746	.	G	T	6	2	8	0	0	8	0	0
22	22424034	.	G	A	10	3	13	0	2	15	0	0
22	22424085	.	A	T	4	9	13	0	0	13	0	0
22	22424106	.	G	A	1	4	5	0	8	13	0	0
22	22425439	.	T	C	8	4	12	0	1	13	0	0
22	22427415	.	T	C	6	11	17	0	0	17	0	0
22	22427442	.	T	C	7	12	19	0	1	20	0	0
22	22427694	.	C	T	12	10	22	0	2	24	0	0
22	22428125	.	T	C	1	3	4	0	0	4	0	0
22	22636374	.	G	T	2	2	4	0	0	4	0	0
22	22979279	.	G	A	1	2	3	0	0	3	0	0
22	22979303	.	T	C	4	2	6	0	0	6	0	0
22	22995818	.	A	T	3	2	5	0	0	5	0	0
22	23492330	.	A	T	1	3	4	0	0	4	0	0
22	23492929	.	A	T	2	2	4	0	0	4	0	0
22	24157961	.	G	C	12	5	17	0	1	18	0	0
22	24158037	.	T	A	3	5	8	0	2	10	0	0
22	24158146	.	A	C	8	9	17	0	0	17	0	0
22	24158190	.	C	T	10	16	26	0	0	26	0	0
22	24158242	.	C	A	18	11	29	0	1	31	1	0
22	24158275	.	G	C	13	12	25	0	2	27	0	0
22	24166896	.	G	A	0	14	14	0	17	31	0	0
22	24166919	.	A	G	20	16	36	0	0	36	0	0
22	24167633	.	C	T	14	14	28	0	1	29	0	0
22	24168125	.	T	C	21	22	43	0	0	43	0	0
22	24168573	.	T	C	21	18	39	0	2	41	0	0
22	24168610	.	T	A	29	16	45	0	3	48	0	0
22	24218631	.	A	G	9	0	9	0	6	15	0	0
22	24218656	.	T	A	6	6	12	0	0	12	0	0
22	24220962	.	A	G	8	8	16	0	2	18	0	0
22	24220996	.	G	A	13	9	22	0	1	23	0	0
22	24221009	.	C	T	10	10	20	0	2	22	0	0
22	24224676	.	A	T	12	9	21	0	1	22	0	0
22	24225409	.	T	C	15	13	28	0	0	28	0	0
22	24229293	.	C	T	11	18	29	0	2	32	1	0
22	24229513	.	T	C	22	16	38	0	1	39	0	0
22	24229890	.	T	C	9	22	31	0	0	31	0	0
22	24230005	.	G	A	2	12	14	0	28	42	0	0
22	24230020	.	G	A	13	29	42	0	3	45	0	0
22	24233536	.	G	T	15	19	34	0	0	34	0	0
22	24361095	.	A	G	15	8	23	1	0	24	0	0
22	24715404	.	A	G	11	1	12	0	17	29	0	0
22	24716636	.	T	A	9	20	29	1	1	31	0	0
22	24717105	.	G	A	18	21	39	0	2	41	0	0
22	24718973	.	T	C	12	25	37	0	3	40	0	0
22	24724279	.	T	C	5	6	11	8	0	19	0	0
22	24975668	.	C	T	0	5	5	0	4	9	0	0
22	24975753	.	G	A	1	4	5	0	0	5	0	0
22	24975792	.	C	T	2	2	4	0	0	4	0	0
22	24981171	.	T	C	2	4	6	0	0	6	0	0
22	25028660	.	G	A	16	14	30	0	1	31	0	0
22	25028694	.	G	A	14	11	25	0	1	26	0	0
22	25028751	.	A	G	11	14	25	0	0	25	0	0
22	25028838	.	A	G	5	7	12	0	0	12	0	0
22	25029136	.	T	A	9	14	23	0	0	23	0	0
22	25029193	.	C	G	0	16	16	0	7	23	0	0
22	25032266	.	C	T	13	13	26	0	1	27	0	0
22	25032293	.	T	C	15	14	29	0	1	30	0	0
22	25032344	.	C	T	3	14	17	0	11	28	0	0
22	25032665	.	T	C	12	4	16	0	5	21	0	0
22	25032693	.	T	C	13	14	27	0	0	27	0	0
22	25038315	.	C	T	3	10	13	0	1	14	0	0
22	25038360	.	T	C	1	6	7	0	0	7	0	0
22	25038387	.	A	G	2	4	6	0	1	7	0	0
22	25038432	.	T	C	12	5	17	0	1	18	0	0
22	25038646	.	G	A	3	4	7	0	2	9	0	0
22	25040867	.	G	A	3	6	9	0	0	9	0	0
22	25042166	.	A	G	3	3	6	0	0	6	0	0
22	25042814	.	T	C	6	0	6	0	7	13	0	0
22	25042879	.	G	A	6	5	11	0	0	11	0	0
22	25042918	.	G	A	3	3	6	0	1	7	0	0
22	25054496	.	C	G	1	2	3	0	0	3	0	0
22	25055511	.	G	A	0	2	2	0	2	4	0	0
22	25055645	.	G	T	1	2	3	0	0	3	0	0
22	25058509	.	C	G	1	0	1	0	3	4	0	0
22	25058518	.	T	G	1	2	3	0	0	3	0	0
22	25059919	.	G	A	0	5	5	0	2	7	0	0
22	25060629	.	C	A	2	4	6	0	0	6	0	0
22	25063696	.	A	G	7	2	9	0	7	16	0	0
22	25063745	.	C	A	6	7	13	0	0	13	0	0
22	25063767	.	C	A	4	7	11	0	0	11	0	0
22	25066332	.	C	T	1	2	3	0	3	6	0	0
22	25066410	.	T	C	9	10	19	0	2	21	0	0
22	25066583	.	A	G	10	8	18	0	0	18	0	0
22	25066939	.	C	T	4	6	10	0	0	10	0	0
22	25067274	.	A	G	4	6	10	0	0	10	0	0
22	25067596	.	C	T	6	5	11	0	1	12	0	0
22	25072474	.	C	G	3	3	6	0	0	6	0	0
22	25076727	.	A	G	6	7	13	0	2	15	0	0
22	25078630	.	A	C	6	10	16	0	0	16	0	0
22	25109796	.	G	C	1	2	3	0	0	3	0	0
22	25559055	.	T	C	2	2	4	0	0	4	0	0
22	25573161	.	C	T	1	3	4	0	0	4	0	0
22	25573197	.	G	T	2	5	7	0	1	8	0	0
22	25573313	.	G	A	2	3	5	0	0	5	0	0
22	25576950	.	T	A	1	2	3	0	1	4	0	0
22	25577248	.	C	T	2	5	7	0	0	7	0	0
22	25577265	.	A	G	3	4	7	0	0	7	0	0
22	25581699	.	A	G	1	3	4	0	0	4	0	0
22	25582764	.	T	C	1	6	7	0	0	7	0	0
22	25586906	.	T	A	1	7	8	0	0	8	0	0
22	25844997	.	C	T	2	3	5	0	0	5	0	0
22	25845010	.	C	T	2	3	5	0	0	5	0	0
22	25845170	.	C	T	1	2	3	0	1	4	0	0
22	25845419	.	G	A	4	2	6	0	0	6	0	0
22	25845831	.	C	G	1	3	4	0	0	4	0	0
22	25934061	.	A	G	6	5	11	0	0	11	0	0
22	25934659	.	G	A	0	6	6	0	9	15	0	0
22	25934662	.	A	G	9	6	15	0	0	15	0	0
22	25937001	.	G	A	1	6	7	0	6	13	0	0
22	25937037	.	T	A	4	7	11	0	1	12	0	0
22	25937052	.	T	C	5	6	11	0	1	12	0	0
22	25938915	.	C	T	5	3	8	0	1	9	0	0
22	25939066	.	A	G	2	11	13	0	0	13	0	0
22	25940965	.	A	T	5	6	11	0	0	11	0	0
22	25942349	.	A	G	12	5	17	0	2	19	0	0
22	25942390	.	A	C	10	5	15	0	1	16	0	0
22	25942392	.	C	A	10	5	15	0	0	15	0	0
22	25942586	.	G	T	6	9	15	0	0	15	0	0
22	25942659	.	A	G	5	4	9	0	0	9	0	0
22	25942769	.	T	C	3	5	8	0	0	8	0	0
22	25942934	.	T	G	2	2	4	0	0	4	0	0
22	26180205	.	A	T	1	7	8	0	0	8	0	0
22	26180410	.	A	C	1	2	3	1	0	4	0	0
22	26239610	.	G	A	5	5	10	0	0	10	0	0
22	26239654	.	A	T	11	5	16	0	0	16	0	0
22	26239752	.	G	A	6	6	12	0	0	12	0	0
22	26239798	.	C	A	1	3	4	0	2	6	0	0
22	26239873	.	T	A	12	12	24	0	0	24	0	0
22	26239879	.	G	A	10	12	22	0	0	22	0	0
22	26244704	.	C	T	7	8	15	0	0	15	0	0
22	26244755	.	C	T	3	1	4	0	3	7	0	0
22	26245683	.	G	A	3	7	10	0	1	11	0	0
22	26245743	.	A	G	7	7	14	0	0	14	0	0
22	26245881	.	T	C	5	0	5	0	5	10	0	0
22	26264646	.	G	A	2	2	4	0	0	4	0	0
22	26264805	.	T	A	3	3	6	0	0	6	0	0
22	26264807	.	A	G	3	3	6	0	0	6	0	0
22	26265477	.	C	T	1	5	6	0	4	10	0	0
22	26266765	.	C	T	6	6	12	0	2	14	0	0
22	26266798	.	C	A	6	8	14	0	0	14	0	0
22	26266807	.	T	A	8	6	14	0	1	15	0	0
22	26274099	.	G	A	4	2	6	0	0	6	0	0
22	26274106	.	A	T	4	3	7	0	0	7	0	0
22	26277695	.	T	C	7	5	12	0	0	12	0	0
22	26277735	.	A	C	5	4	9	0	2	11	0	0
22	26277773	.	G	A	7	9	16	0	1	17	0	0
22	26277820	.	T	C	7	10	17	0	1	18	0	0
22	26277871	.	C	A	10	2	12	0	1	13	0	0
22	26277939	.	T	C	6	0	6	0	6	12	0	0
22	26277994	.	T	C	6	5	11	0	0	11	0	0
22	26277999	.	G	A	6	4	10	0	0	10	0	0
22	26278081	.	C	T	6	5	11	0	1	12	0	0
22	26278144	.	T	G	5	6	11	0	1	12	0	0
22	26281043	.	A	G	9	8	17	0	0	17	0	0
22	26289243	.	T	G	3	7	10	0	1	11	0	0
22	26289430	.	G	A	8	4	12	0	0	12	0	0
22	26290324	.	C	T	15	8	23	0	0	23	0	0
22	26290508	.	C	T	16	10	26	0	1	27	0	0
22	26290851	.	A	T	1	3	4	0	0	4	0	0
22	26301324	.	G	A	4	9	13	0	1	14	0	0
22	26309106	.	C	G	2	3	5	0	0	5	0	0
22	26311254	.	A	G	4	3	7	0	0	7	0	0
22	26313846	.	G	A	4	4	8	0	0	8	0	0
22	26313876	.	A	T	1	3	4	0	2	6	0	0
22	26524896	.	G	A	2	6	8	0	0	8	0	0
22	26524910	.	A	T	1	4	5	0	1	6	0	0
22	26525535	.	C	T	3	3	6	0	1	7	0	0
22	26525753	.	G	A	6	4	10	0	0	10	0	0
22	26526057	.	C	T	0	7	7	0	6	13	0	0
22	26526127	.	G	T	8	8	16	0	2	18	0	0
22	26526135	.	G	C	10	7	17	0	0	17	0	0
22	26526293	.	A	C	4	5	9	0	0	9	0	0
22	26526637	.	C	T	0	6	6	0	5	11	0	0
22	26526710	.	G	A	4	5	9	0	2	11	0	0
22	26526722	.	A	G	5	4	9	0	0	9	0	0
22	26526969	.	A	T	5	4	9	0	0	9	0	0
22	26527416	.	C	G	3	3	6	0	0	6	0	0
22	26527792	.	A	G	7	6	13	0	1	14	0	0
22	26527864	.	C	T	1	2	3	0	0	3	0	0
22	26528290	.	G	A	1	2	3	0	0	3	0	0
22	26528357	.	G	A	6	2	8	0	0	8	0	0
22	26528373	.	G	A	5	2	7	0	0	7	0	0
22	26528518	.	A	T	4	3	7	0	0	7	0	0
22	26528740	.	T	A	1	4	5	0	0	5	0	0
22	26528781	.	G	A	3	3	6	0	0	6	0	0
22	26528783	.	T	C	3	0	3	0	3	6	0	0
22	26529165	.	T	G	4	2	6	0	1	7	0	0
22	26529204	.	C	T	0	8	8	0	4	12	0	0
22	26529278	.	T	G	2	2	4	0	0	4	0	0
22	26529429	.	A	G	2	5	7	0	0	7	0	0
22	26529500	.	T	G	3	3	6	0	0	6	0	0
22	26858161	.	T	C	4	7	11	0	0	11	0	0
22	29858935	.	T	C	18	11	29	1	1	31	0	0
22	29858936	.	T	C	13	17	30	1	1	32	0	0
22	30359955	.	G	T	14	3	17	0	2	19	0	0
22	31404427	.	T	A	3	2	5	0	0	5	0	0
22	31440674	.	C	T	1	3	4	0	0	4	0	0
22	31513575	.	C	T	0	4	4	0	4	8	0	0
22	31668049	.	T	C	19	1	20	0	9	29	0	0
22	31671957	.	T	A	20	16	36	0	3	39	0	0
22	33592309	.	T	C	13	17	30	0	0	30	0	0
22	33592530	.	G	T	6	11	17	0	1	18	0	0
22	33639388	.	G	A	10	10	20	0	2	22	0	0
22	33791076	.	G	T	5	5	10	1	0	11	0	0
22	33791208	.	G	A	7	8	15	0	0	15	0	0
22	33791235	.	G	A	6	11	17	0	0	17	0	0
22	33915629	.	G	A	2	6	8	0	1	9	0	0
22	33916599	.	A	G	3	4	7	0	0	7	0	0
22	35176526	.	C	G	4	0	4	0	14	18	0	0
22	35182097	.	C	A	8	5	13	0	3	16	0	0
22	35524336	.	A	C	1	3	4	0	0	4	0	0
22	35531002	.	C	T	8	5	13	0	0	13	0	0
22	35531196	.	G	A	4	3	7	0	1	8	0	0
22	35531281	.	G	A	3	4	7	0	0	7	0	0
22	35531376	.	A	G	3	4	7	0	0	7	0	0
22	36524302	.	T	C	2	2	4	0	1	5	0	0
22	36524374	.	T	A	2	2	4	0	0	4	0	0
22	36527075	.	C	T	2	3	5	0	0	5	0	0
22	36530155	.	T	C	2	3	5	0	0	5	0	0
22	36547873	.	C	T	4	3	7	0	0	7	0	0
22	36584963	.	T	C	4	2	6	0	1	7	0	0
22	36601742	.	G	A	6	2	8	0	0	8	0	0
22	36616814	.	G	A	0	3	3	0	7	10	0	0
22	36622717	.	A	G	5	5	10	0	1	11	0	0
22	36634111	.	T	C	3	2	5	0	0	5	0	0
22	36634127	.	T	C	5	3	8	0	0	8	0	0
22	36634167	.	G	C	2	2	4	0	3	7	0	0
22	36676056	.	G	C	20	32	52	0	1	53	0	0
22	36679390	.	G	A	24	29	53	0	1	54	0	0
22	36683803	.	C	A	17	14	31	0	2	33	0	0
22	36685729	.	C	T	25	18	43	1	3	47	0	0
22	36686828	.	G	A	13	20	33	3	1	37	0	0
22	36686867	.	G	A	18	13	31	0	3	34	0	0
22	36686870	.	A	G	21	14	35	0	0	35	0	0
22	36686948	.	G	T	14	17	31	0	0	31	0	0
22	36687328	.	G	A	14	17	31	2	3	36	0	0
22	36687403	.	G	A	30	9	39	0	1	40	0	0
22	36687541	.	T	C	11	22	33	0	2	35	0	0
22	36687616	.	C	T	1	19	20	1	23	44	0	0
22	36690668	.	T	A	12	16	28	0	1	29	0	0
22	36741467	.	T	C	5	0	5	0	3	8	0	0
22	36750518	.	G	A	4	3	7	0	0	7	0	0
22	36755371	.	T	G	2	3	5	0	3	8	0	0
22	36755395	.	A	G	4	3	7	0	0	7	0	0
22	36755554	.	A	C	3	4	7	0	0	7	0	0
22	36755751	.	A	T	6	2	8	0	0	8	0	0
22	36755831	.	G	A	7	3	10	0	0	10	0	0
22	36755963	.	G	C	7	0	7	0	14	21	0	0
22	36756112	.	A	G	3	14	17	0	0	17	0	0
22	36756325	.	G	A	5	8	13	0	0	13	0	0
22	36756333	.	T	C	8	1	9	0	5	14	0	0
22	36756400	.	C	T	9	5	14	0	1	15	0	0
22	36756404	.	G	C	10	7	17	0	0	17	0	0
22	36756464	.	T	A	7	9	16	0	0	16	0	0
22	36757155	.	A	C	12	0	12	0	9	21	0	0
22	36768060	.	C	T	0	3	3	1	1	5	0	0
22	36770971	.	A	G	1	2	3	0	0	3	0	0
22	36794786	.	T	A	4	1	5	0	1	6	0	0
22	36795845	.	G	T	7	6	13	0	0	13	0	0
22	36798416	.	G	A	3	8	11	0	0	11	0	0
22	36800981	.	G	C	6	9	15	0	0	15	0	0
22	36801929	.	T	A	4	2	6	0	0	6	0	0
22	36802765	.	T	G	2	3	5	0	0	5	0	0
22	36802898	.	G	A	2	2	4	0	0	4	0	0
22	36802928	.	C	T	0	2	2	0	3	5	0	0
22	36802988	.	A	T	1	2	3	0	0	3	0	0
22	36875475	.	A	T	1	7	8	0	0	8	0	0
22	36875581	.	T	C	2	6	8	1	0	9	0	0
22	36875584	.	A	G	2	0	2	1	6	9	0	0
22	36877531	.	G	A	0	2	2	0	1	3	0	0
22	36877534	.	G	T	0	3	3	0	1	4	0	0
22	36877963	.	G	A	4	2	6	0	0	6	0	0
22	36878044	.	T	A	6	5	11	0	0	11	0	0
22	36879468	.	G	T	9	3	12	0	1	13	0	0
22	36879483	.	C	T	7	5	12	0	0	12	0	0
22	36882150	.	G	A	3	7	10	0	0	10	0	0
22	36882168	.	G	A	0	4	4	0	8	12	0	0
22	36882189	.	G	A	1	4	5	0	9	14	0	0
22	36882388	.	T	C	6	10	16	0	0	16	0	0
22	36882409	.	T	A	4	6	10	0	4	14	0	0
22	36885065	.	T	G	7	1	8	0	2	10	0	0
22	36887954	.	C	T	8	8	16	0	0	16	0	0
22	36891142	.	G	A	8	7	15	0	0	15	0	0
22	36893330	.	T	C	10	4	14	0	1	15	0	0
22	36893357	.	G	A	3	14	17	0	2	19	0	0
22	36894316	.	T	A	6	19	25	0	1	26	0	0
22	36894410	.	A	C	11	8	19	0	0	19	0	0
22	36896641	.	G	A	2	13	15	0	10	25	0	0
22	36896677	.	G	T	13	8	21	0	0	21	0	0
22	36899269	.	C	T	20	23	43	0	0	43	0	0
22	36899483	.	G	A	0	3	3	0	7	10	0	0
22	36899611	.	C	A	4	5	9	0	0	9	0	0
22	36899621	.	A	T	7	6	13	0	0	13	0	0
22	36947793	.	T	A	8	12	20	0	1	21	0	0
22	36947836	.	C	A	8	8	16	0	0	16	0	0
22	36947849	.	G	A	6	9	15	0	1	16	0	0
22	36947879	.	G	C	9	11	20	0	4	24	0	0
22	36947997	.	A	G	12	13	25	0	0	25	0	0
22	36948052	.	T	G	6	9	15	0	1	16	0	0
22	36948133	.	G	A	4	7	11	0	0	11	0	0
22	36948134	.	C	T	4	6	10	0	1	11	0	0
22	36948202	.	C	A	6	9	15	0	0	15	0	0
22	36948312	.	C	T	1	7	8	0	7	15	0	0
22	36948395	.	T	C	12	0	12	0	5	17	0	0
22	36948603	.	T	A	7	10	17	0	0	17	0	0
22	36978477	.	G	C	1	2	3	0	0	3	0	0
22	37276635	.	T	C	5	0	5	0	5	10	0	0
22	37276709	.	C	T	0	7	7	0	15	22	0	0
22	37277941	.	A	C	2	6	8	0	0	8	0	0
22	37277963	.	A	G	1	5	6	0	0	6	0	0
22	37277996	.	A	G	0	6	6	0	0	6	0	0
22	37278175	.	C	T	0	2	2	0	2	4	0	0
22	37278475	.	A	G	18	11	29	0	0	29	0	0
22	37278479	.	T	C	17	0	17	0	10	27	0	0
22	37278634	.	C	T	19	10	29	0	5	34	0	0
22	37348345	.	C	T	12	5	17	0	0	17	0	0
22	37352700	.	C	G	7	24	31	0	2	33	0	0
22	37543070	.	A	T	19	5	24	0	1	25	0	0
22	37543457	.	A	G	12	15	27	0	0	27	0	0
22	37551481	.	G	C	16	1	17	0	8	25	0	0
22	37551496	.	T	C	10	1	11	0	11	22	0	0
22	37552717	.	G	A	11	7	18	0	0	18	0	0
22	37552783	.	A	C	10	0	10	0	11	21	0	0
22	37553015	.	C	T	1	4	5	0	5	10	0	0
22	37557531	.	G	A	11	11	22	0	0	22	0	0
22	37559603	.	G	A	7	5	12	0	0	12	0	0
22	37561609	.	G	A	8	6	14	0	0	14	0	0
22	37561642	.	C	G	7	7	14	0	0	14	0	0
22	37588622	.	T	C	8	1	9	0	8	17	0	0
22	37588667	.	A	C	9	12	21	0	2	23	0	0
22	37588715	.	T	C	7	10	17	0	5	22	0	0
22	37589420	.	T	C	12	4	16	0	0	16	0	0
22	37589898	.	A	T	13	4	17	4	0	21	0	0
22	37590171	.	C	T	2	3	5	0	2	7	0	0
22	37590339	.	A	T	10	11	21	0	1	22	0	0
22	37590535	.	C	T	7	8	15	0	0	15	0	0
22	37590710	.	T	G	1	9	10	0	0	10	0	0
22	37590711	.	C	T	2	9	11	0	0	11	0	0
22	37590925	.	T	C	5	7	12	0	0	12	0	0
22	37591023	.	A	C	7	6	13	0	0	13	0	0
22	37591491	.	A	T	7	9	16	0	1	17	0	0
22	37596906	.	C	T	3	4	7	0	0	7	0	0
22	37599007	.	C	A	5	4	9	0	0	9	0	0
22	37599058	.	G	A	4	3	7	0	0	7	0	0
22	37599076	.	A	G	4	6	10	0	0	10	0	0
22	37602190	.	C	T	1	3	4	0	4	8	0	0
22	37602479	.	A	C	2	3	5	0	0	5	0	0
22	37608435	.	T	C	2	0	2	0	4	6	0	0
22	37608465	.	G	A	1	3	4	0	0	4	0	0
22	37609996	.	G	A	2	2	4	0	0	4	0	0
22	37610001	.	T	C	2	2	4	0	0	4	0	0
22	37610043	.	C	T	1	2	3	0	1	4	0	0
22	37635796	.	C	G	3	6	9	0	0	9	0	0
22	37639239	.	C	T	2	5	7	0	0	7	0	0
22	37639311	.	C	T	1	5	6	0	0	6	0	0
22	37644009	.	C	A	12	5	17	0	1	18	0	0
22	37644021	.	C	G	11	5	16	0	1	17	0	0
22	37644048	.	A	G	7	9	16	0	0	16	0	0
22	37645990	.	T	C	9	7	16	0	2	18	0	0
22	37646124	.	C	T	13	10	23	0	1	24	0	0
22	37646226	.	T	A	19	11	30	0	1	31	0	0
22	37652191	.	C	T	9	16	25	0	1	26	0	0
22	37652925	.	C	T	9	9	18	0	1	19	0	0
22	37655702	.	C	T	9	7	16	0	2	18	0	0
22	37697408	.	C	T	13	9	22	0	1	23	0	0
22	37708199	.	T	A	21	15	36	0	2	38	0	0
22	37710178	.	G	T	28	20	48	0	3	51	0	0
22	37712570	.	A	G	19	1	20	0	20	40	0	0
22	37716493	.	G	C	9	14	23	0	2	25	0	0
22	37716613	.	A	T	2	2	4	0	0	4	0	0
22	37738043	.	C	T	2	2	4	0	0	4	0	0
22	37738049	.	G	T	1	2	3	0	0	3	0	0
22	37738162	.	C	T	0	2	2	0	3	5	0	0
22	37805329	.	C	T	17	22	39	0	0	39	0	0
22	37823332	.	C	A	0	12	12	0	20	32	0	0
22	37875270	.	T	C	1	3	4	0	0	4	0	0
22	37881090	.	A	G	0	8	8	0	0	8	0	0
22	37881126	.	C	T	2	8	10	0	0	10	0	0
22	37881134	.	G	A	3	6	9	0	2	11	0	0
22	37881208	.	A	G	4	5	9	1	3	13	0	0
22	37951706	.	A	G	1	2	3	0	0	3	0	0
22	38001277	.	A	C	1	3	4	0	0	4	0	0
22	38001504	.	G	A	4	6	10	0	0	10	0	0
22	38005162	.	C	G	0	4	4	0	1	5	0	0
22	38014726	.	T	C	1	3	4	0	0	4	0	0
22	38019898	.	T	C	1	2	3	0	0	3	0	0
22	38022171	.	A	T	1	2	3	0	0	3	0	0
22	38037578	.	A	T	6	8	14	0	0	14	0	0
22	38037603	.	G	T	6	3	9	0	0	9	0	0
22	38040050	.	G	A	0	8	8	0	5	13	0	0
22	38040070	.	T	G	8	4	12	0	0	12	0	0
22	38044902	.	G	C	0	12	12	0	9	21	0	0
22	38045009	.	T	A	6	10	16	0	2	18	0	0
22	38168114	.	A	T	1	2	3	0	0	3	0	0
22	38178747	.	G	A	2	2	4	0	0	4	0	0
22	38183762	.	C	T	4	2	6	0	0	6	0	0
22	38191715	.	A	G	5	11	16	0	1	17	0	0
22	38191718	.	T	A	14	5	19	0	0	19	0	0
22	38192440	.	A	G	7	11	18	0	0	18	0	0
22	38194106	.	C	T	13	15	28	0	0	28	0	0
22	38194415	.	A	G	16	13	29	0	0	29	0	0
22	38194419	.	G	C	14	12	26	0	1	28	1	0
22	38195217	.	G	A	21	18	39	0	4	43	0	0
22	38197777	.	C	T	37	26	63	0	2	65	0	0
22	38197783	.	G	C	38	28	66	0	4	70	0	0
22	38199812	.	A	G	5	7	12	0	2	14	0	0
22	38199902	.	G	T	8	3	11	0	0	11	0	0
22	38202898	.	T	C	5	4	9	0	3	12	0	0
22	38202904	.	C	T	7	5	12	0	0	12	0	0
22	38205099	.	C	T	0	8	8	0	6	14	0	0
22	38209139	.	T	G	1	2	3	0	0	3	0	0
22	38209295	.	A	G	1	3	4	0	0	4	0	0
22	38211271	.	C	A	0	2	2	0	1	3	0	0
22	38217308	.	G	C	1	0	1	0	4	5	0	0
22	38222778	.	G	C	1	3	4	0	0	4	0	0
22	38283993	.	A	G	4	5	9	0	0	9	0	0
22	38284020	.	A	C	5	3	8	0	0	8	0	0
22	38289982	.	T	C	2	3	5	0	0	5	0	0
22	38290307	.	G	A	6	9	15	0	0	15	0	0
23	252280	.	T	C	8	0	8	0	4	12	0	0
23	252305	.	T	C	4	5	9	0	1	10	0	0
23	458254	.	T	C	13	10	23	0	0	23	0	0
23	585458	.	A	G	10	0	10	1	4	15	0	0
23	585505	.	A	G	3	0	3	1	8	12	0	0
23	587161	.	A	G	6	9	15	0	0	15	0	0
23	588077	.	T	G	2	0	2	0	25	28	1	0
23	862457	.	T	C	3	2	5	0	0	5	0	0
23	862467	.	T	C	3	0	3	0	2	5	0	0
23	863395	.	T	C	8	3	11	0	1	12	0	0
23	863405	.	T	C	3	0	3	0	6	9	0	0
23	864134	.	T	C	1	3	4	0	1	5	0	0
23	864537	.	G	A	0	2	2	0	0	2	0	0
23	864549	.	T	C	1	2	3	0	0	3	0	0
23	1698139	.	T	C	1	8	9	0	0	9	0	0
23	1719384	.	A	G	4	7	11	0	2	13	0	0
23	1723720	.	A	G	8	0	8	0	13	21	0	0
23	1723748	.	G	A	11	7	18	0	0	18	0	0
23	1723992	.	C	T	8	9	17	0	0	17	0	0
23	1725456	.	T	C	8	5	13	1	3	17	0	0
23	1725508	.	T	C	4	3	7	0	1	8	0	0
23	1725510	.	G	A	4	3	7	0	1	8	0	0
23	1725634	.	A	G	4	0	4	0	5	9	0	0
23	1725664	.	G	A	5	4	9	0	0	9	0	0
23	1725785	.	G	C	4	9	13	0	0	13	0	0
23	1725803	.	G	C	4	6	10	0	0	10	0	0
23	1725959	.	C	T	22	6	28	0	0	28	0	0
23	1725974	.	T	A	23	7	30	0	1	31	0	0
23	1726080	.	T	C	16	7	23	0	0	23	0	0
23	1726106	.	G	T	20	4	24	0	0	24	0	0
23	1726467	.	T	A	7	5	12	0	0	12	0	0
23	2054010	.	C	T	8	5	13	0	2	15	0	0
23	2054175	.	G	A	9	3	12	0	1	13	0	0
23	2054316	.	C	G	4	4	8	0	0	8	0	0
23	2054505	.	G	A	1	5	6	0	0	6	0	0
23	2054584	.	G	C	2	2	4	0	0	4	0	0
23	2054613	.	A	G	1	3	4	0	0	4	0	0
23	2054622	.	T	C	2	1	3	0	2	5	0	0
23	2054760	.	G	A	1	2	3	0	0	3	0	0
23	2054838	.	C	T	1	2	3	0	3	6	0	0
23	2054886	.	A	G	2	3	5	0	0	5	0	0
23	2055162	.	G	A	5	2	7	0	0	7	0	0
23	2081004	.	T	G	2	2	4	0	0	4	0	0
23	2099158	.	A	G	1	3	4	0	0	4	0	0
23	2099214	.	A	G	1	3	4	0	0	4	0	0
23	2136417	.	T	C	6	5	11	0	0	11	0	0
23	2155134	.	T	C	2	2	4	0	0	4	0	0
23	2158054	.	T	C	2	4	6	0	0	6	0	0
23	2159114	.	G	A	5	5	10	0	0	10	0	0
23	2160242	.	T	C	7	8	15	0	0	15	0	0
23	2246536	.	G	A	3	3	6	0	0	6	0	0
23	2246855	.	C	G	3	0	3	0	3	6	0	0
23	2246915	.	G	A	2	7	9	0	2	11	0	0
23	2249537	.	A	G	2	0	2	0	4	6	0	0
23	2249589	.	G	A	0	5	5	0	2	7	0	0
23	2249633	.	T	C	2	6	8	0	0	8	0	0
23	2252812	.	G	A	3	5	8	0	0	8	0	0
23	2256142	.	G	C	4	5	9	0	0	9	0	0
23	2256348	.	C	T	5	5	10	0	0	10	0	0
23	2256349	.	A	T	5	5	10	0	0	10	0	0
23	2435776	.	G	A	17	28	45	0	1	46	0	0
23	2438388	.	G	A	8	25	33	0	2	35	0	0
23	2438463	.	G	T	1	13	14	0	10	24	0	0
23	2438641	.	A	T	24	23	47	0	0	47	0	0
23	2440698	.	G	A	11	25	36	0	0	36	0	0
23	2443160	.	C	T	20	16	36	0	3	39	0	0
23	2443613	.	C	T	16	23	39	0	2	41	0	0
23	2443772	.	T	C	12	2	14	0	0	14	0	0
23	2443782	.	T	C	13	4	17	0	0	17	0	0
23	2542247	.	T	A	2	2	4	0	0	4	0	0
23	2547556	.	A	C	6	6	12	1	0	13	0	0
23	2564339	.	T	A	15	9	24	3	3	30	0	0
23	2564420	.	T	C	7	6	13	0	0	13	0	0
23	2679634	.	G	A	0	5	5	14	11	30	0	0
23	2689807	.	T	C	16	19	35	0	1	36	0	0
23	2690659	.	C	T	15	12	27	0	1	28	0	0
23	2709931	.	T	C	2	2	4	0	0	4	0	0
23	2716519	.	C	A	6	2	8	0	0	8	0	0
23	2717852	.	A	C	13	14	27	0	4	31	0	0
23	2717867	.	T	G	13	20	33	0	3	36	0	0
23	2718009	.	C	G	23	9	32	0	2	34	0	0
23	2721348	.	T	C	4	2	6	0	0	6	0	0
23	2721539	.	A	G	14	21	35	0	1	36	0	0
23	2725095	.	A	C	9	11	20	0	2	22	0	0
23	2757841	.	C	T	3	2	5	0	0	5	0	0
23	2762007	.	A	G	3	6	9	0	0	9	0	0
23	2762855	.	G	A	1	1	2	1	1	4	0	0
23	2767194	.	G	A	0	5	5	0	5	10	0	0
23	2767227	.	C	T	3	4	7	0	0	7	0	0
23	2773310	.	C	T	3	6	9	0	0	9	0	0
23	2774812	.	G	A	5	10	15	0	0	15	0	0
23	2775033	.	G	A	3	7	10	0	2	12	0	0
23	2778827	.	A	G	6	7	13	0	1	14	0	0
23	2837155	.	T	C	5	4	9	0	0	9	0	0
23	2837188	.	C	T	7	3	10	0	0	10	0	0
23	2837218	.	T	C	9	3	12	0	0	12	0	0
23	2839156	.	G	T	0	2	2	0	3	5	0	0
23	2842292	.	G	T	0	3	3	0	3	6	0	0
23	2849307	.	G	A	1	3	4	0	6	10	0	0
23	2860937	.	T	G	5	0	5	0	10	15	0	0
23	2861990	.	C	T	11	15	26	0	2	28	0	0
23	2864186	.	A	T	9	9	18	0	1	19	0	0
23	2870732	.	T	A	12	11	23	0	4	27	0	0
23	2871264	.	C	T	6	6	12	0	0	12	0	0
23	2871699	.	G	A	12	7	19	0	3	22	0	0
23	2871908	.	A	G	14	9	23	0	0	23	0	0
23	2871994	.	T	C	7	12	19	0	3	22	0	0
23	2872206	.	T	C	12	11	23	0	0	23	0	0
23	2872338	.	T	G	23	0	23	0	12	35	0	0
23	2872517	.	G	T	17	25	42	0	1	44	1	0
23	2872924	.	A	C	1	3	4	0	0	4	0	0
23	2873327	.	A	T	13	6	19	0	0	19	0	0
23	2877144	.	C	T	0	10	10	0	5	15	0	0
23	2877519	.	T	C	7	0	7	0	6	13	0	0
23	2877603	.	A	C	6	5	11	0	0	11	0	0
23	2877792	.	C	A	3	2	5	0	2	7	0	0
23	2877930	.	T	C	6	4	10	0	0	10	0	0
23	2878041	.	C	A	0	3	3	0	6	9	0	0
23	2878401	.	A	G	7	5	12	0	1	13	0	0
23	2878629	.	T	G	3	5	8	0	0	8	0	0
23	2878630	.	A	C	3	5	8	0	0	8	0	0
23	2878689	.	C	T	3	3	6	0	0	6	0	0
23	2879040	.	A	G	3	1	4	0	1	5	0	0
23	2879235	.	A	G	5	3	8	0	1	9	0	0
23	2879618	.	A	G	0	2	2	0	1	3	0	0
23	2880143	.	T	C	2	2	4	0	2	6	0	0
23	2900767	.	A	G	2	3	5	0	0	5	0	0
23	2906312	.	A	G	10	9	19	0	0	19	0	0
23	2914789	.	C	A	1	2	3	0	1	4	0	0
23	2919264	.	A	G	1	1	2	0	3	5	0	0
23	2920588	.	G	T	1	2	3	0	2	5	0	0
23	2920603	.	T	C	3	3	6	0	0	6	0	0
23	2920753	.	G	A	4	4	8	0	0	8	0	0
23	2923068	.	G	A	0	3	3	0	4	7	0	0
23	2925086	.	T	C	2	4	6	0	0	6	0	0
23	2925137	.	C	T	7	3	10	0	1	11	0	0
23	2925238	.	A	T	2	3	5	0	0	5	0	0
23	2925357	.	T	C	2	7	9	0	0	9	0	0
23	2927117	.	A	G	4	7	11	0	0	11	0	0
23	2927144	.	A	G	6	5	11	0	1	12	0	0
23	2927175	.	C	T	3	5	8	0	1	9	0	0
23	2929180	.	A	G	7	6	13	0	1	14	0	0
23	2931288	.	T	A	7	5	12	0	0	12	0	0
23	2931321	.	G	A	9	3	12	0	0	12	0	0
23	2931329	.	C	A	11	4	15	0	0	15	0	0
23	2931358	.	C	T	12	12	24	0	0	24	0	0
23	2931409	.	C	T	13	12	25	0	2	27	0	0
23	2931461	.	A	G	9	0	9	0	9	18	0	0
23	2931732	.	C	A	10	5	15	0	0	15	0	0
23	2931836	.	C	A	3	5	8	0	1	9	0	0
23	2931970	.	T	A	11	13	24	0	1	25	0	0
23	2932241	.	A	T	7	8	15	0	1	16	0	0
23	3406708	.	T	C	8	14	22	0	2	24	0	0
23	3406729	.	A	G	11	11	22	0	0	22	0	0
23	3406811	.	T	C	15	12	27	0	1	28	0	0
23	3406950	.	T	G	6	8	14	0	0	14	0	0
23	3407285	.	T	A	24	20	44	0	2	46	0	0
23	3407305	.	C	A	25	13	38	0	2	40	0	0
23	3503614	.	C	A	1	3	4	0	0	4	0	0
23	3503622	.	A	G	1	3	4	0	0	4	0	0
23	3511204	.	C	A	3	2	5	0	0	5	0	0
23	3517582	.	T	A	2	7	9	0	0	9	0	0
23	3517621	.	T	G	4	5	9	0	0	9	0	0
23	3517734	.	T	G	7	0	7	0	7	14	0	0
23	3517800	.	C	T	4	4	8	0	0	8	0	0
23	3519953	.	A	G	11	0	11	0	9	20	0	0
23	3520120	.	C	T	9	12	21	0	0	21	0	0
23	3653478	.	G	T	20	23	43	0	0	43	0	0
23	3653846	.	T	C	20	9	29	0	0	29	0	0
23	3653859	.	G	A	18	16	34	0	0	34	0	0
23	3653953	.	T	A	7	9	16	0	0	16	0	0
23	3654034	.	A	G	13	7	20	0	1	21	0	0
23	3654106	.	C	T	4	9	13	0	0	13	0	0
23	3654134	.	A	G	3	9	12	0	0	12	0	0
23	3654356	.	C	T	5	7	12	0	0	12	0	0
23	3654490	.	A	C	7	11	18	0	2	20	0	0
23	3654747	.	C	T	2	22	24	0	18	42	0	0
23	3654774	.	G	A	16	23	39	1	2	42	0	0
23	3654989	.	A	G	19	19	38	0	3	41	0	0
23	3655082	.	C	T	2	9	11	0	17	29	1	0
23	3655139	.	T	A	23	15	38	0	2	40	0	0
23	3655207	.	T	G	21	26	47	0	1	48	0	0
23	3655220	.	A	G	22	26	48	0	0	48	0	0
23	3657557	.	T	C	22	34	56	1	0	57	0	0
23	3657602	.	T	C	29	2	31	1	19	51	0	0
23	3660060	.	C	A	3	25	28	0	23	51	0	0
23	3660674	.	A	G	27	16	43	0	2	45	0	0
23	3660713	.	G	A	16	19	35	0	2	37	0	0
23	3662210	.	G	A	21	19	40	0	0	40	0	0
23	3662246	.	C	T	2	15	17	0	17	34	0	0
23	3664306	.	A	G	15	17	32	1	1	34	0	0
23	3667257	.	T	C	20	13	33	0	1	34	0	0
23	3711308	.	C	A	4	2	6	0	0	6	0	0
23	3711949	.	T	G	6	4	10	0	1	11	0	0
23	3712002	.	G	A	8	7	15	0	1	16	0	0
23	3712654	.	A	G	4	4	8	1	0	9	0	0
23	3712719	.	A	G	3	1	4	0	1	5	0	0
23	3712723	.	C	T	3	2	5	0	0	5	0	0
23	3713045	.	T	G	2	5	7	0	0	7	0	0
23	3713321	.	A	G	5	3	8	0	0	8	0	0
23	3713363	.	A	G	5	8	13	0	0	13	0	0
23	3713388	.	C	T	2	10	12	0	0	12	0	0
23	3713400	.	A	C	4	10	14	0	0	14	0	0
23	3713452	.	T	C	15	5	20	0	0	20	0	0
23	3713453	.	G	A	15	5	20	0	0	20	0	0
23	3713491	.	G	A	14	4	18	0	1	19	0	0
23	3713622	.	A	G	4	3	7	0	0	7	0	0
23	3713643	.	G	A	5	3	8	0	0	8	0	0
23	3713692	.	T	A	7	2	9	0	0	9	0	0
23	3713928	.	A	G	2	4	6	0	0	6	0	0
23	3721131	.	T	C	11	7	18	0	1	19	0	0
23	3740379	.	T	A	14	18	32	1	0	33	0	0
23	3744621	.	C	T	9	14	23	0	1	24	0	0
23	3744654	.	A	C	7	9	16	0	1	17	0	0
23	3751965	.	A	G	18	17	35	0	0	35	0	0
23	3751990	.	A	G	17	21	38	0	2	40	0	0
23	3752305	.	C	G	12	20	32	0	4	36	0	0
23	3752394	.	C	T	0	17	17	0	19	36	0	0
23	3752992	.	T	A	17	15	32	0	3	35	0	0
23	3951804	.	T	C	10	11	21	0	1	22	0	0
23	3951948	.	G	T	13	3	16	0	0	16	0	0
23	3962692	.	A	G	5	2	7	0	0	7	0	0
23	3982480	.	G	A	3	5	8	0	0	8	0	0
23	3982936	.	G	C	5	0	5	0	4	9	0	0
23	4017626	.	G	A	1	2	3	0	0	3	0	0
23	4019600	.	T	C	2	5	7	0	0	7	0	0
23	4086817	.	T	G	4	3	7	0	0	7	0	0
23	4086855	.	T	C	4	0	4	0	2	6	0	0
23	4088361	.	A	G	3	2	5	0	0	5	0	0
23	4216363	.	T	C	7	0	7	0	3	10	0	0
23	4222119	.	A	G	3	3	6	0	0	6	0	0
23	4222149	.	G	A	4	4	8	0	1	9	0	0
23	4222164	.	G	T	5	4	9	0	1	10	0	0
23	4222503	.	C	T	1	1	2	0	1	3	0	0
23	4222509	.	G	A	2	1	3	0	1	4	0	0
23	4225038	.	A	G	2	2	4	0	0	4	0	0
23	4225051	.	A	C	1	2	3	0	0	3	0	0
23	4254105	.	G	T	3	32	35	0	21	56	0	0
23	4254192	.	A	C	15	23	38	0	1	39	0	0
23	4255566	.	C	G	18	1	19	0	25	44	0	0
23	4259194	.	A	G	24	18	42	0	0	42	0	0
23	4259369	.	T	G	20	21	41	0	2	43	0	0
23	4259626	.	G	A	17	18	35	0	0	35	0	0
23	4259635	.	G	C	0	14	14	0	16	30	0	0
23	4259674	.	G	T	8	10	18	0	0	18	0	0
23	4260629	.	G	A	6	5	11	0	1	12	0	0
23	4269780	.	C	G	19	19	38	0	0	38	0	0
23	4270928	.	T	C	26	17	43	0	3	46	0	0
23	4271333	.	A	G	34	22	56	0	3	59	0	0
23	4271730	.	G	C	19	11	30	0	1	31	0	0
23	4274411	.	G	T	1	2	3	0	0	3	0	0
23	4274423	.	C	T	2	2	4	0	0	4	0	0
23	4280602	.	A	G	1	0	1	0	5	6	0	0
23	4280877	.	A	C	1	3	4	0	0	4	0	0
23	4280888	.	G	A	2	3	5	0	0	5	0	0
23	4289066	.	C	G	5	4	9	0	0	9	0	0
23	4292251	.	C	T	2	8	10	0	0	10	0	0
23	4307737	.	C	T	7	14	21	0	0	21	0	0
23	4307740	.	T	C	7	14	21	0	0	21	0	0
23	4312033	.	T	G	10	15	25	0	1	26	0	0
23	4314691	.	G	A	11	13	24	0	0	24	0	0
23	4353495	.	G	A	0	2	2	0	1	3	0	0
23	4353498	.	A	C	1	2	3	0	0	3	0	0
23	4354309	.	G	A	0	2	2	0	2	4	0	0
23	4354363	.	C	T	2	2	4	0	0	4	0	0
23	4356042	.	G	T	1	2	3	0	1	4	0	0
23	4356932	.	C	T	1	2	3	0	0	3	0	0
23	4357457	.	G	C	0	2	2	0	1	3	0	0
23	4362874	.	T	C	2	2	4	0	0	4	0	0
23	4364914	.	C	T	7	5	12	0	2	14	0	0
23	4367390	.	T	A	4	4	8	7	0	15	0	0
23	4390094	.	T	G	3	3	6	0	0	6	0	0
23	4390121	.	A	G	4	2	6	0	0	6	0	0
23	4390180	.	G	T	3	3	6	0	0	6	0	0
23	4398919	.	T	C	1	3	4	0	0	4	0	0
23	4542695	.	A	T	2	2	4	0	0	4	0	0
23	4547628	.	A	G	1	0	1	0	2	3	0	0
23	4553255	.	T	C	4	2	6	0	0	6	0	0
23	5010006	.	C	T	3	3	6	0	2	8	0	0
23	5010250	.	T	A	2	2	4	0	0	4	0	0
23	5010722	.	C	T	5	6	11	0	2	13	0	0
23	5011064	.	T	A	2	3	5	0	0	5	0	0
23	5012826	.	C	T	2	3	5	0	0	5	0	0
23	5012832	.	T	C	0	3	3	0	2	5	0	0
23	5565893	.	T	A	8	2	10	0	0	10	0	0
23	5565897	.	A	G	6	4	10	0	0	10	0	0
23	5585483	.	T	C	2	3	5	0	0	5	0	0
23	5585528	.	G	T	4	7	11	0	0	11	0	0
23	5585555	.	T	C	4	4	8	0	1	9	0	0
23	5587860	.	G	A	1	3	4	0	0	4	0	0
23	5756781	.	G	T	5	3	8	0	0	8	0	0
23	5756847	.	C	T	3	3	6	0	2	8	0	0
23	5757010	.	G	A	2	4	6	0	0	6	0	0
23	5757047	.	A	T	1	3	4	0	0	4	0	0
23	5757193	.	G	T	3	3	6	0	0	6	0	0
23	5759124	.	A	G	2	2	4	0	0	4	0	0
23	5919188	.	C	T	2	2	4	0	0	4	0	0
23	5919430	.	A	T	1	3	4	0	0	4	0	0
23	6011958	.	A	G	2	3	5	0	0	5	0	0
23	6027379	.	G	A	2	2	4	0	0	4	0	0
23	6027415	.	T	G	2	2	4	0	1	5	0	0
23	6027439	.	G	A	3	2	5	0	0	5	0	0
23	6027781	.	T	C	2	3	5	0	0	5	0	0
23	6028015	.	C	T	2	4	6	0	0	6	0	0
23	6028029	.	C	T	5	3	8	0	0	8	0	0
23	6028051	.	G	A	2	5	7	0	1	8	0	0
23	6030946	.	T	C	2	3	5	0	0	5	0	0
23	6035912	.	C	G	3	4	7	0	0	7	0	0
23	6046867	.	T	C	2	2	4	0	0	4	0	0
23	6058704	.	C	T	1	2	3	0	0	3	0	0
23	6060084	.	C	A	1	4	5	0	0	5	0	0
23	6062654	.	C	T	3	3	6	0	0	6	0	0
23	6064579	.	T	C	6	2	8	0	0	8	0	0
23	6272793	.	C	T	1	5	6	0	0	6	0	0
23	6301287	.	T	A	5	6	11	0	0	11	0	0
23	6301332	.	T	C	5	4	9	0	0	9	0	0
23	6301413	.	A	G	5	9	14	0	0	14	0	0
23	6301416	.	T	C	5	9	14	0	0	14	0	0
23	6304243	.	A	G	5	0	5	0	6	11	0	0
23	6304249	.	T	C	6	4	10	0	0	10	0	0
23	6421954	.	G	A	2	6	8	0	0	8	0	0
23	6714773	.	G	A	6	2	8	0	0	8	0	0
23	6926414	.	G	A	1	1	2	0	1	3	0	0
23	6951037	.	T	G	4	2	6	0	0	6	0	0
23	6951157	.	C	T	1	2	3	0	3	6	0	0
23	6958211	.	A	T	1	2	3	0	0	3	0	0
23	6966857	.	C	T	0	4	4	0	4	8	0	0
23	6982389	.	T	C	3	0	3	0	2	5	0	0
23	6985279	.	G	A	1	4	5	0	0	5	0	0
23	7003744	.	C	T	7	14	21	0	0	21	0	0
23	7007480	.	C	T	9	10	19	0	2	21	0	0
23	7027534	.	C	T	0	9	9	0	9	18	0	0
23	7029600	.	G	A	6	8	14	0	1	15	0	0
23	7029741	.	G	A	12	6	18	0	0	18	0	0
23	7029777	.	A	T	4	14	18	0	0	18	0	0
23	7029916	.	A	T	4	3	7	0	1	8	0	0
23	7029964	.	A	C	7	0	7	0	5	12	0	0
23	7032435	.	C	A	3	4	7	0	0	7	0	0
23	7040708	.	T	A	7	4	11	0	0	11	0	0
23	7067257	.	T	C	2	4	6	0	0	6	0	0
23	7556970	.	C	G	5	2	7	0	0	7	0	0
23	7556979	.	G	C	6	2	8	0	0	8	0	0
23	7567446	.	C	T	4	3	7	0	0	7	0	0
23	7578710	.	T	C	7	11	18	0	2	20	0	0
23	7695127	.	T	C	3	3	6	0	0	6	0	0
23	7702128	.	A	G	2	1	3	0	2	5	0	0
23	7715282	.	G	T	2	2	4	0	0	4	0	0
23	7715651	.	C	T	5	4	9	0	0	9	0	0
23	7715801	.	G	A	0	4	4	0	1	5	0	0
23	7715873	.	G	A	1	4	5	0	1	6	0	0
23	7715909	.	T	C	2	7	9	0	0	9	0	0
23	7715945	.	G	C	0	6	6	0	2	8	0	0
23	7716281	.	T	C	3	11	14	0	1	15	0	0
23	7718380	.	G	A	4	2	6	0	1	7	0	0
23	7718972	.	G	A	0	3	3	0	2	5	0	0
23	7718999	.	C	T	6	4	10	0	0	10	0	0
23	7721342	.	A	G	5	5	10	0	2	12	0	0
23	7732578	.	T	C	9	6	15	0	0	15	0	0
23	7732760	.	C	G	2	2	4	0	0	4	0	0
23	7732820	.	G	A	3	3	6	0	0	6	0	0
23	7733088	.	C	G	8	7	15	0	0	15	0	0
23	7733423	.	A	G	3	3	6	0	0	6	0	0
23	7733444	.	A	G	1	3	4	0	0	4	0	0
23	7733603	.	T	C	7	4	11	0	0	11	0	0
23	7733614	.	G	T	8	3	11	0	0	11	0	0
23	7733732	.	T	C	4	3	7	0	0	7	0	0
23	7733826	.	T	A	4	3	7	0	0	7	0	0
23	7733836	.	T	C	3	4	7	0	0	7	0	0
23	7734213	.	A	T	2	6	8	0	0	8	0	0
23	7734321	.	C	T	6	4	10	0	0	10	0	0
23	7734801	.	C	A	3	3	6	0	0	6	0	0
23	7735423	.	G	A	5	5	10	0	0	10	0	0
23	7735497	.	T	C	5	9	14	0	0	14	0	0
23	7735649	.	C	T	7	7	14	0	2	16	0	0
23	7735809	.	A	T	1	6	7	0	1	8	0	0
23	7736089	.	T	G	6	0	6	0	4	10	0	0
23	7736382	.	G	T	1	2	3	0	0	3	0	0
23	7743670	.	T	C	2	5	7	0	0	7	0	0
23	7743691	.	T	C	3	6	9	0	0	9	0	0
23	7746618	.	T	C	3	0	3	0	3	6	0	0
23	7746797	.	T	G	4	4	8	0	1	9	0	0
23	7750693	.	A	C	1	5	6	0	0	6	0	0
23	7755088	.	T	C	3	0	3	0	8	11	0	0
23	7755112	.	A	C	1	5	6	0	1	7	0	0
23	7755189	.	T	G	3	6	9	0	0	9	0	0
23	7755215	.	T	C	1	3	4	0	1	5	0	0
23	7762045	.	A	G	11	10	21	0	0	21	0	0
23	7765955	.	G	A	6	6	12	0	0	12	0	0
23	7765961	.	C	T	8	5	13	0	0	13	0	0
23	7768416	.	T	C	8	0	8	0	8	16	0	0
23	7771305	.	T	C	5	7	12	0	2	14	0	0
23	7778670	.	G	A	11	9	20	0	1	21	0	0
23	7778715	.	A	G	11	8	19	0	1	20	0	0
23	7789635	.	G	A	7	7	14	0	0	14	0	0
23	7789930	.	C	T	0	10	10	0	5	15	0	0
23	8285094	.	G	T	5	4	9	0	1	10	0	0
23	8285236	.	G	T	8	20	28	0	1	29	0	0
23	8285297	.	C	T	2	20	22	0	14	36	0	0
23	8285365	.	G	A	16	17	33	0	1	34	0	0
23	8285585	.	A	T	9	9	18	0	1	19	0	0
23	8285640	.	C	T	6	16	22	0	0	22	0	0
23	8286192	.	T	C	5	0	5	0	9	14	0	0
23	8286237	.	G	A	6	9	15	0	0	15	0	0
23	8286342	.	C	T	1	5	6	0	6	12	0	0
23	8286384	.	G	T	4	4	8	0	0	8	0	0
23	8286483	.	G	A	3	4	7	0	0	7	0	0
23	8372159	.	T	C	3	0	3	0	3	6	0	0
23	8373535	.	T	G	5	3	8	0	0	8	0	0
23	8373641	.	A	G	2	5	7	0	0	7	0	0
23	8687821	.	G	A	2	2	4	0	0	4	0	0
23	8719074	.	T	C	6	7	13	0	1	14	0	0
23	8719491	.	G	C	1	2	3	0	6	9	0	0
23	8721202	.	G	A	5	8	13	0	2	15	0	0
23	8724467	.	G	A	19	8	27	0	1	28	0	0
23	8799677	.	C	G	4	2	6	0	0	6	0	0
23	8799808	.	A	G	1	2	3	0	0	3	0	0
23	8993280	.	G	A	6	3	9	0	0	9	0	0
23	9013456	.	C	G	6	0	6	0	5	11	0	0
23	9013597	.	T	C	3	11	14	0	0	14	0	0
23	9013876	.	T	A	8	6	14	0	0	14	0	0
23	9014122	.	G	A	0	12	12	0	9	21	0	0
23	9014259	.	G	A	11	5	16	0	1	17	0	0
23	9058105	.	A	T	6	2	8	0	0	8	0	0
23	9058108	.	C	A	2	5	7	0	0	7	0	0
23	9067121	.	G	A	0	2	2	0	2	4	0	0
23	9069900	.	A	G	3	3	6	0	1	7	0	0
23	9112869	.	C	T	1	4	5	0	0	5	0	0
23	9272674	.	C	T	4	3	7	0	0	7	0	0
23	9272984	.	T	C	4	5	9	0	0	9	0	0
23	9287619	.	G	A	4	2	6	0	0	6	0	0
23	9287629	.	C	A	2	4	6	0	1	7	0	0
23	9287666	.	C	T	2	2	4	0	2	6	0	0
23	9287689	.	T	C	2	3	5	0	0	5	0	0
23	9288200	.	G	T	6	6	12	0	0	12	0	0
23	9400848	.	G	C	5	4	9	0	2	11	0	0
23	9400902	.	G	A	6	3	9	0	1	10	0	0
23	9401006	.	A	T	5	3	8	0	1	9	0	0
23	9401107	.	C	T	3	5	8	0	1	9	0	0
23	9401210	.	T	C	4	0	4	0	5	9	0	0
23	9401344	.	G	A	3	4	7	0	0	7	0	0
23	9401439	.	T	C	3	5	8	0	0	8	0	0
23	9401470	.	C	T	8	3	11	0	0	11	0	0
23	9401918	.	A	G	2	5	7	0	0	7	0	0
23	9401954	.	G	A	2	3	5	0	0	5	0	0
23	9402459	.	G	A	2	3	5	0	0	5	0	0
23	9403223	.	G	A	1	2	3	0	0	3	0	0
23	9405572	.	C	G	0	4	4	0	1	5	0	0
23	9405633	.	C	A	0	3	3	0	4	7	0	0
23	9413456	.	C	T	2	2	4	0	0	4	0	0
23	9566027	.	A	C	4	1	5	0	7	12	0	0
23	9566030	.	A	C	4	3	7	0	6	13	0	0
23	9794733	.	T	C	5	3	8	2	0	10	0	0
23	9794959	.	T	A	12	11	23	0	1	24	0	0
23	9795057	.	A	G	18	20	38	0	1	39	0	0
23	9795097	.	C	T	1	20	21	0	14	35	0	0
23	9795663	.	A	C	11	12	23	0	2	25	0	0
23	9795908	.	C	T	19	15	34	0	0	34	0	0
23	9800761	.	T	G	19	12	31	0	3	34	0	0
23	9800993	.	G	T	14	8	22	0	0	22	0	0
23	9801946	.	A	T	1	3	4	0	0	4	0	0
23	9801964	.	T	A	2	2	4	0	2	6	0	0
23	9802387	.	A	G	3	2	5	0	0	5	0	0
23	9802402	.	A	C	2	2	4	0	0	4	0	0
23	9809863	.	A	G	16	17	33	0	0	33	0	0
23	9809977	.	C	T	2	6	8	1	11	20	0	0
23	9810491	.	C	G	20	21	41	1	0	42	0	0
23	9818153	.	C	T	6	9	15	0	1	16	0	0
23	9828802	.	T	C	3	0	3	0	9	12	0	0
23	9837018	.	G	A	3	2	5	0	0	5	0	0
23	9840151	.	A	G	3	2	5	0	0	5	0	0
23	9840154	.	A	C	3	1	4	0	0	4	0	0
23	9840669	.	G	A	3	3	6	0	0	6	0	0
23	9842935	.	G	A	2	2	4	0	0	4	0	0
23	9842980	.	C	T	2	3	5	0	0	5	0	0
23	9845905	.	T	G	1	2	3	0	0	3	0	0
23	9845906	.	T	C	1	2	3	0	0	3	0	0
23	9938497	.	G	A	5	4	9	0	0	9	0	0
23	9938714	.	G	T	8	4	12	0	0	12	0	0
23	9938765	.	A	G	7	7	14	0	0	14	0	0
23	9938812	.	A	T	6	6	12	0	0	12	0	0
23	9938824	.	T	C	3	0	3	0	6	9	0	0
23	9938869	.	C	T	3	4	7	0	1	8	0	0
23	9938905	.	T	C	5	0	5	0	5	10	0	0
23	9939602	.	T	C	3	10	13	0	1	14	0	0
23	9939817	.	A	G	8	14	22	1	1	24	0	0
23	9950087	.	A	C	3	5	8	0	0	8	0	0
23	9952460	.	C	T	1	5	6	0	0	6	0	0
23	9952532	.	C	G	0	7	7	0	1	8	0	0
23	9959911	.	A	G	1	2	3	0	0	3	0	0
23	9962955	.	T	C	3	3	6	0	1	7	0	0
23	9963087	.	T	C	2	2	4	0	0	4	0	0
23	9963108	.	C	T	2	2	4	0	0	4	0	0
23	9965037	.	A	G	3	3	6	0	0	6	0	0
23	9967419	.	T	G	1	2	3	0	0	3	0	0
23	9973557	.	G	A	1	2	3	0	0	3	0	0
23	9973621	.	G	A	1	3	4	0	0	4	0	0
23	10174422	.	A	G	5	5	10	0	1	11	0	0
23	10174426	.	T	C	5	6	11	0	0	11	0	0
23	10174904	.	C	T	7	6	13	0	0	13	0	0
23	10174961	.	A	G	5	4	9	0	0	9	0	0
23	10176989	.	T	G	7	4	11	0	0	11	0	0
23	10177241	.	C	T	1	3	4	0	0	4	0	0
23	10250357	.	G	A	26	15	41	0	0	41	0	0
23	10251076	.	A	G	12	18	30	0	1	31	0	0
23	10251750	.	T	C	8	10	18	0	0	18	0	0
23	10252499	.	A	G	9	9	18	0	0	18	0	0
23	10252526	.	G	A	6	10	16	0	1	17	0	0
23	10252625	.	T	A	8	13	21	0	1	22	0	0
23	10254018	.	A	G	10	15	25	0	1	26	0	0
23	10254075	.	G	A	5	8	13	0	1	14	0	0
23	10254081	.	A	G	5	10	15	0	0	15	0	0
23	10348049	.	T	C	5	5	10	0	0	10	0	0
23	10348052	.	C	T	4	5	9	0	1	10	0	0
23	10350105	.	T	C	1	1	2	0	1	3	0	0
23	10350534	.	A	C	2	4	6	0	0	6	0	0
23	10350549	.	T	C	3	5	8	0	1	9	0	0
23	10350591	.	G	A	5	4	9	0	2	11	0	0
23	10405707	.	A	G	5	0	5	0	11	16	0	0
23	10405742	.	G	C	2	7	9	0	8	17	0	0
23	10411562	.	A	C	12	4	16	0	0	16	0	0
23	10419933	.	A	C	12	9	21	0	0	21	0	0
23	10421216	.	A	C	14	15	29	0	0	29	0	0
23	10423909	.	C	G	16	12	28	0	1	29	0	0
23	10426291	.	C	T	14	8	22	0	1	23	0	0
23	10448936	.	C	T	7	8	15	0	1	16	0	0
23	10449063	.	T	C	12	12	24	0	0	24	0	0
23	10449136	.	A	G	10	0	10	0	7	17	0	0
23	10449185	.	C	T	5	9	14	0	0	14	0	0
23	10449405	.	A	T	3	3	6	0	0	6	0	0
23	10638101	.	T	G	1	2	3	0	0	3	0	0
23	10639121	.	G	A	3	6	9	0	1	10	0	0
23	10725272	.	A	T	2	3	5	0	0	5	0	0
23	10725320	.	T	C	1	6	7	0	0	7	0	0
23	10725334	.	T	C	6	5	11	0	0	11	0	0
23	10725638	.	A	T	5	9	14	0	2	16	0	0
23	10725919	.	C	A	14	12	26	0	1	27	0	0
23	10727563	.	G	A	12	7	19	0	2	21	0	0
23	10727614	.	C	T	11	10	21	0	0	21	0	0
23	10745058	.	G	T	7	4	11	0	0	11	0	0
23	10762922	.	G	A	7	13	20	0	0	20	0	0
23	10762972	.	T	A	11	7	18	0	0	18	0	0
23	10763070	.	G	A	4	11	15	0	1	16	0	0
23	10771991	.	C	A	1	10	11	0	14	25	0	0
23	10805322	.	A	G	1	2	3	0	0	3	0	0
23	10817179	.	G	A	5	5	10	0	0	10	0	0
23	10825591	.	C	T	5	4	9	0	2	11	0	0
23	10826718	.	C	A	7	3	10	0	0	10	0	0
23	10826856	.	A	T	4	2	6	0	0	6	0	0
23	10826917	.	C	T	2	2	4	0	0	4	0	0
23	11015322	.	G	A	1	2	3	0	0	3	0	0
23	11764391	.	A	G	3	2	5	0	0	5	0	0
23	11848645	.	C	T	6	2	8	0	0	8	0	0
23	11851459	.	C	A	3	3	6	0	1	7	0	0
23	11851467	.	C	T	3	3	6	0	1	7	0	0
23	11851545	.	T	C	3	9	12	0	0	12	0	0
23	11851603	.	C	T	2	2	4	0	0	4	0	0
23	11855160	.	A	G	1	8	9	0	1	10	0	0
23	11855169	.	G	A	3	7	10	0	0	10	0	0
23	11859294	.	C	T	8	4	12	0	0	12	0	0
23	11865055	.	T	A	13	11	24	0	0	24	0	0
23	11865934	.	C	T	17	13	30	0	2	32	0	0
23	11866086	.	G	A	20	17	37	0	3	40	0	0
23	11866183	.	G	A	14	22	36	0	1	37	0	0
23	11866259	.	T	C	20	26	46	0	1	47	0	0
23	11870203	.	A	T	15	15	30	0	1	31	0	0
23	11896251	.	G	A	7	4	11	0	0	11	0	0
23	11920705	.	G	A	7	2	9	0	0	9	0	0
23	11920712	.	C	T	2	5	7	0	1	8	0	0
23	12155166	.	G	A	4	5	9	0	0	9	0	0
23	12155298	.	G	A	2	5	7	0	1	8	0	0
23	12155319	.	G	A	4	3	7	0	0	7	0	0
23	12155364	.	A	G	5	3	8	0	0	8	0	0
23	12155391	.	G	A	8	3	11	0	0	11	0	0
23	12158643	.	A	G	4	3	7	0	1	8	0	0
23	12161399	.	T	C	1	2	3	0	0	3	0	0
23	12161557	.	A	G	1	0	1	0	3	4	0	0
23	12161593	.	G	C	1	2	3	0	3	6	0	0
23	12162034	.	G	A	2	8	10	0	1	11	0	0
23	12162073	.	T	G	3	1	4	0	7	11	0	0
23	12162099	.	G	C	4	5	9	0	1	10	0	0
23	12162163	.	C	T	2	5	7	0	1	8	0	0
23	12232873	.	G	A	5	3	8	1	4	13	0	0
23	12233117	.	G	A	16	9	25	0	1	26	0	0
23	12233121	.	C	T	1	16	17	0	10	27	0	0
23	12259026	.	C	T	3	19	22	0	16	38	0	0
23	12345695	.	G	A	10	6	16	0	0	16	0	0
23	12546823	.	C	T	1	4	5	0	0	5	0	0
23	13332325	.	A	C	2	5	7	0	1	8	0	0
23	13558711	.	C	T	3	2	5	0	0	5	0	0
23	13567194	.	C	T	1	4	5	0	0	5	0	0
23	13567257	.	G	T	4	3	7	0	0	7	0	0
23	13567264	.	A	C	3	4	7	0	1	8	0	0
23	13598094	.	C	T	1	2	3	0	0	3	0	0
23	13598679	.	C	T	9	5	14	0	0	14	0	0
23	13599008	.	G	A	3	3	6	0	1	7	0	0
23	13599079	.	G	A	0	3	3	0	3	6	0	0
23	13599249	.	A	G	2	2	4	0	0	4	0	0
23	13722416	.	C	A	1	2	3	0	1	4	0	0
23	13722728	.	G	A	0	2	2	1	7	10	0	0
23	13722755	.	C	G	7	0	7	1	8	16	0	0
23	13806408	.	C	T	14	15	29	0	0	29	0	0
23	13833376	.	T	A	25	13	38	0	1	39	0	0
23	13835932	.	C	A	10	7	17	0	1	18	0	0
23	13840297	.	G	A	7	11	18	0	0	18	0	0
23	13840362	.	C	T	1	4	5	0	5	10	0	0
23	13845114	.	A	C	5	5	10	0	1	11	0	0
23	13845131	.	G	A	6	7	13	0	0	13	0	0
23	13845149	.	T	G	12	7	19	0	0	19	0	0
23	13845201	.	A	G	9	5	14	0	0	14	0	0
23	13845247	.	G	T	3	3	6	0	0	6	0	0
23	13845258	.	A	T	4	3	7	0	0	7	0	0
23	13845411	.	G	T	4	6	10	0	0	10	0	0
23	13845447	.	T	C	10	7	17	0	1	18	0	0
23	13845901	.	G	T	7	6	13	0	1	14	0	0
23	13846482	.	G	T	7	2	9	0	0	10	1	0
23	13846664	.	T	C	3	2	5	0	0	5	0	0
23	13846938	.	G	T	7	2	9	1	0	10	0	0
23	13847142	.	G	A	2	2	4	0	2	6	0	0
23	13847220	.	T	C	2	8	10	0	2	12	0	0
23	13848537	.	G	A	7	4	11	0	0	11	0	0
23	13857114	.	G	A	3	4	7	0	0	7	0	0
23	13941275	.	C	T	9	7	16	0	3	19	0	0
23	13946174	.	C	T	0	9	9	0	9	18	0	0
23	13948993	.	G	A	12	6	18	0	0	18	0	0
23	13949110	.	C	T	0	12	12	0	8	20	0	0
23	14006105	.	G	A	5	2	7	0	0	7	0	0
23	14056306	.	C	T	1	5	6	0	1	7	0	0
23	14056679	.	G	A	2	4	6	0	0	6	0	0
23	14193676	.	A	G	5	6	11	0	2	13	0	0
23	14193777	.	C	T	12	7	19	0	0	19	0	0
23	14193880	.	C	T	11	15	26	0	0	26	0	0
23	14193923	.	A	C	14	8	22	0	2	24	0	0
23	14193940	.	C	T	15	8	23	0	1	24	0	0
23	14194035	.	C	G	10	12	22	0	1	23	0	0
23	14194058	.	G	A	10	16	26	0	1	27	0	0
23	14198137	.	G	A	18	11	29	0	1	30	0	0
23	14201512	.	T	C	12	5	17	0	1	18	0	0
23	14201521	.	T	C	10	4	14	0	3	17	0	0
23	14203829	.	T	G	8	7	15	0	1	16	0	0
23	14208718	.	A	G	10	11	21	0	1	22	0	0
23	14208817	.	A	T	13	14	27	0	1	28	0	0
23	14209024	.	T	G	10	10	20	0	0	20	0	0
23	14211707	.	C	T	14	14	28	0	0	28	0	0
23	14218065	.	C	T	5	4	9	0	0	9	0	0
23	14720234	.	G	A	0	3	3	0	3	6	0	0
23	14731394	.	A	G	1	2	3	0	0	3	0	0
23	14731424	.	G	A	1	2	3	0	0	3	0	0
23	14731430	.	A	G	1	2	3	0	0	3	0	0
23	14752817	.	G	A	2	2	4	0	0	4	0	0
23	14772079	.	G	A	1	2	3	0	0	3	0	0
23	14777039	.	A	C	2	2	4	0	0	4	0	0
23	14782599	.	C	T	3	3	6	0	0	6	0	0
23	14784150	.	G	A	2	3	5	0	0	5	0	0
23	14784237	.	A	C	3	2	5	0	1	6	0	0
23	14786347	.	T	C	5	7	12	0	0	12	0	0
23	14786429	.	A	T	5	5	10	0	3	13	0	0
23	14787318	.	T	A	4	5	9	0	0	9	0	0
23	14787409	.	G	A	0	4	4	0	7	11	0	0
23	14787426	.	G	A	5	6	11	0	3	14	0	0
23	14788082	.	A	G	7	0	7	0	5	12	0	0
23	14790429	.	G	A	2	6	8	0	0	8	0	0
23	14790611	.	C	T	5	3	8	0	1	9	0	0
23	14790827	.	G	A	3	4	7	0	1	8	0	0
23	14803409	.	C	T	7	3	10	0	0	10	0	0
23	14803617	.	T	C	3	3	6	1	0	7	0	0
23	14803624	.	C	T	3	2	5	1	0	6	0	0
23	14808490	.	G	A	10	3	13	0	1	14	0	0
23	14808537	.	G	T	4	5	9	0	0	9	0	0
23	14808545	.	A	G	5	3	8	0	1	9	0	0
23	14809613	.	C	A	2	3	5	0	0	5	0	0
23	14812065	.	A	G	1	2	3	0	0	3	0	0
23	14832549	.	A	T	1	1	2	0	1	3	0	0
23	14832677	.	G	A	15	22	37	0	3	40	0	0
23	14832774	.	G	A	34	15	49	0	2	51	0	0
23	14832835	.	C	T	36	23	59	0	1	60	0	0
23	14832866	.	C	T	24	24	48	0	8	56	0	0
23	14832926	.	A	T	31	16	47	0	3	50	0	0
23	14833032	.	C	T	31	21	52	0	1	53	0	0
23	14833142	.	A	T	20	23	43	0	1	44	0	0
23	14833143	.	A	T	19	21	40	0	4	44	0	0
23	14833189	.	A	C	23	21	44	0	1	46	1	0
23	14833552	.	T	C	28	22	50	0	6	56	0	0
23	14833581	.	T	C	35	0	35	0	18	53	0	0
23	14833664	.	G	A	33	20	53	0	0	53	0	0
23	14833765	.	G	A	28	35	63	0	2	65	0	0
23	14851621	.	A	G	30	11	41	0	3	44	0	0
23	14853221	.	G	A	24	14	38	0	1	39	0	0
23	14853342	.	G	A	27	18	45	0	4	49	0	0
23	14853411	.	C	T	34	13	47	0	0	47	0	0
23	14853414	.	C	T	3	14	17	0	29	46	0	0
23	14853833	.	C	T	25	18	43	0	0	43	0	0
23	14861941	.	T	C	20	10	30	0	3	33	0	0
23	14993089	.	G	A	16	11	27	0	1	28	0	0
23	14993140	.	T	C	9	1	10	0	9	19	0	0
23	14993200	.	A	T	12	13	25	0	0	25	0	0
23	14993393	.	C	A	11	8	19	0	1	20	0	0
23	14993936	.	A	T	5	12	17	0	1	18	0	0
23	14999053	.	C	T	12	12	24	0	3	27	0	0
23	14999095	.	C	T	2	5	7	0	15	22	0	0
23	15006653	.	C	T	2	9	11	0	16	27	0	0
23	15021985	.	A	T	9	10	19	0	0	19	0	0
23	15022206	.	T	C	6	0	6	0	11	17	0	0
23	15022526	.	C	T	9	7	16	0	0	16	0	0
23	15036698	.	G	A	3	8	11	0	0	11	0	0
23	15047065	.	G	T	2	3	5	0	0	5	0	0
23	15047732	.	C	T	1	3	4	0	1	5	0	0
23	15048070	.	A	G	2	5	7	0	0	7	0	0
23	15050912	.	T	C	2	2	4	0	0	4	0	0
23	15076070	.	T	C	3	4	7	0	0	7	0	0
23	15088005	.	C	G	1	2	3	0	0	3	0	0
23	15090620	.	G	A	1	2	3	0	0	3	0	0
23	15204222	.	C	T	0	19	19	0	20	39	0	0
23	15204417	.	A	G	14	25	39	0	2	41	0	0
23	15204936	.	G	T	12	13	25	0	3	28	0	0
23	15205428	.	A	T	14	22	36	0	4	40	0	0
23	15205487	.	C	G	26	15	41	0	2	43	0	0
23	15205994	.	G	A	38	19	57	0	0	57	0	0
23	15206057	.	A	G	19	32	51	0	0	51	0	0
23	15206061	.	G	C	19	29	48	0	2	50	0	0
23	15211253	.	G	C	20	18	38	0	1	39	0	0
23	15215796	.	T	G	21	13	34	0	1	35	0	0
23	15216314	.	G	A	14	17	31	0	1	32	0	0
23	15216644	.	T	C	14	0	14	0	15	29	0	0
23	15216664	.	G	T	11	20	31	0	1	32	0	0
23	15222572	.	G	A	15	7	22	0	2	24	0	0
23	15232380	.	T	G	9	10	19	0	0	19	0	0
23	15259821	.	G	A	12	9	21	0	0	21	0	0
23	15270775	.	G	A	9	7	16	0	1	17	0	0
23	15284590	.	C	T	11	7	18	0	0	18	0	0
23	16640852	.	A	G	14	0	14	0	5	19	0	0
23	16640925	.	A	G	8	13	21	0	1	22	0	0
23	16641012	.	A	G	10	1	11	0	9	20	0	0
23	16641017	.	A	G	10	9	19	0	2	21	0	0
23	16648643	.	A	G	4	4	8	0	1	9	0	0
23	16648656	.	A	G	5	4	9	0	0	9	0	0
23	16648950	.	T	A	20	10	30	0	2	32	0	0
23	16649012	.	C	T	10	6	16	0	2	18	0	0
23	16649021	.	C	G	11	0	11	1	2	16	2	0
23	16649054	.	C	T	12	9	21	3	0	24	0	0
23	16649599	.	G	T	11	15	26	0	6	32	0	0
23	16649855	.	T	C	17	2	19	0	27	46	0	0
23	16650074	.	G	A	20	30	50	0	4	54	0	0
23	16654424	.	A	G	21	15	36	0	2	38	0	0
23	16688448	.	G	A	17	16	33	0	0	33	0	0
23	16748903	.	A	T	3	2	5	0	1	6	0	0
23	16748915	.	T	A	4	3	7	0	0	7	0	0
23	16753735	.	T	C	6	6	12	0	0	12	0	0
23	16757528	.	G	T	6	5	11	0	0	11	0	0
23	16770091	.	A	G	3	0	3	0	2	5	0	0
23	16770121	.	G	A	0	1	1	0	3	4	0	0
23	16822464	.	G	A	2	3	5	0	7	12	0	0
23	16822469	.	T	C	9	2	11	0	1	12	0	0
23	16822707	.	G	A	2	7	9	0	5	14	0	0
23	16822736	.	A	G	2	0	2	0	5	7	0	0
23	16831386	.	G	A	2	1	3	0	1	4	0	0
23	16831507	.	A	T	4	2	6	0	0	6	0	0
23	16831755	.	A	G	2	5	7	1	2	10	0	0
23	16831822	.	G	A	0	2	2	1	4	7	0	0
23	16831928	.	G	A	4	2	6	2	0	8	0	0
23	16834080	.	G	A	4	5	9	0	2	11	0	0
23	16848866	.	G	A	3	4	7	0	0	7	0	0
23	16849341	.	C	T	2	4	6	1	0	7	0	0
23	16849383	.	A	G	5	2	7	4	0	11	0	0
23	16883749	.	T	C	1	2	3	0	0	3	0	0
23	16883764	.	A	T	2	2	4	0	1	5	0	0
23	16883822	.	G	T	9	3	12	0	0	12	0	0
23	16961626	.	T	C	3	3	6	0	1	7	0	0
23	16962074	.	T	A	6	2	8	0	0	8	0	0
23	16964089	.	C	A	0	2	2	0	3	5	0	0
23	16964113	.	C	A	2	3	5	0	0	5	0	0
23	16964518	.	T	G	6	3	9	0	0	9	0	0
23	16966364	.	T	C	2	0	2	0	2	4	0	0
23	16979750	.	T	G	1	2	3	0	0	3	0	0
23	17105324	.	C	T	7	2	9	0	0	9	0	0
23	17113831	.	G	A	0	3	3	0	3	6	0	0
23	17113842	.	A	G	4	3	7	0	0	7	0	0
23	17339044	.	C	T	3	4	7	0	0	7	0	0
23	17340346	.	G	A	0	2	2	0	2	4	0	0
23	17340355	.	G	A	2	3	5	0	0	5	0	0
23	17354662	.	T	C	5	7	12	0	0	12	0	0
23	17354693	.	G	T	7	5	12	0	0	13	1	0
23	17354718	.	A	T	5	5	10	0	1	11	0	0
23	17354853	.	G	A	3	7	10	0	0	10	0	0
23	17354868	.	C	A	6	6	12	0	0	12	0	0
23	17355063	.	C	T	7	4	11	0	1	12	0	0
23	17355109	.	C	T	6	4	10	0	0	10	0	0
23	17355174	.	C	T	3	5	8	0	1	9	0	0
23	17370877	.	C	A	5	5	10	0	1	11	0	0
23	17381564	.	G	A	4	2	6	0	1	7	0	0
23	17384981	.	A	G	6	7	13	0	0	13	0	0
23	17385050	.	T	A	3	8	11	0	0	11	0	0
23	17428153	.	C	T	37	35	72	0	3	76	1	0
23	17429632	.	C	T	2	24	26	0	39	65	0	0
23	17431644	.	A	T	22	25	47	0	1	48	0	0
23	17431707	.	T	A	19	23	42	0	1	43	0	0
23	17431734	.	C	T	21	12	33	0	2	35	0	0
23	17432036	.	T	C	20	18	38	0	0	38	0	0
23	17432133	.	A	C	12	15	27	0	0	27	0	0
23	17432169	.	T	A	15	11	26	0	2	28	0	0
23	17432412	.	T	C	18	12	30	0	1	31	0	0
23	17447240	.	A	G	11	10	21	0	1	22	0	0
23	17450623	.	T	G	11	14	25	0	1	26	0	0
23	17450650	.	G	T	8	11	19	0	1	20	0	0
23	17450661	.	A	T	12	7	19	0	2	21	0	0
23	17450779	.	A	T	9	3	12	0	1	13	0	0
23	17473187	.	C	T	10	10	20	0	0	20	0	0
23	17473309	.	G	A	11	16	27	0	1	28	0	0
23	17473365	.	T	C	15	11	26	0	3	29	0	0
23	17473398	.	G	T	10	8	18	0	2	20	0	0
23	17473611	.	C	G	6	18	24	0	0	24	0	0
23	17473649	.	T	A	12	3	15	0	0	15	0	0
23	17473795	.	A	C	21	23	44	1	1	46	0	0
23	17473857	.	A	G	23	24	47	0	1	48	0	0
23	17474167	.	G	A	6	7	13	0	2	15	0	0
23	17474206	.	A	T	10	4	14	0	1	15	0	0
23	17474438	.	T	A	1	2	3	0	0	3	0	0
23	17474532	.	T	C	9	8	17	0	1	18	0	0
23	17474801	.	T	G	14	7	21	0	0	21	0	0
23	17474862	.	C	T	20	9	29	0	4	33	0	0
23	17474928	.	C	G	16	11	27	0	1	28	0	0
23	17475043	.	C	A	15	9	24	0	3	27	0	0
23	17475329	.	G	C	8	0	8	0	1	21	12	0
23	17475349	.	A	T	10	10	20	0	0	20	0	0
23	17475378	.	C	A	7	8	15	0	0	15	0	0
23	17475389	.	T	A	5	6	11	0	2	13	0	0
23	17475552	.	G	A	9	5	14	0	1	15	0	0
23	17475553	.	T	C	5	0	5	0	9	14	0	0
23	17475662	.	A	T	12	6	18	1	0	19	0	0
23	17475702	.	C	T	11	6	17	1	1	19	0	0
23	17475808	.	G	T	14	12	26	0	3	29	0	0
23	17475830	.	G	A	19	12	31	0	0	31	0	0
23	17475857	.	A	T	13	13	26	0	0	26	0	0
23	17475922	.	G	T	11	9	20	0	3	23	0	0
23	17476145	.	T	A	8	5	13	0	2	15	0	0
23	17476164	.	C	T	10	6	16	0	0	16	0	0
23	17476213	.	C	T	1	6	7	0	12	19	0	0
23	17476453	.	T	C	6	6	12	0	0	12	0	0
23	17476459	.	G	T	7	5	12	0	0	12	0	0
23	17476491	.	A	G	5	6	11	0	1	12	0	0
23	17476834	.	A	T	4	2	6	0	0	6	0	0
23	17481905	.	C	T	0	4	4	0	8	12	0	0
23	17484395	.	C	T	9	13	22	0	2	24	0	0
23	17484484	.	A	G	5	3	8	0	0	8	0	0
23	17509537	.	A	G	4	14	18	0	1	19	0	0
23	17516889	.	C	T	7	17	24	0	1	25	0	0
23	17516897	.	C	T	7	18	25	0	0	25	0	0
23	17520025	.	C	G	18	15	33	0	1	34	0	0
23	17520245	.	T	C	13	13	26	0	3	29	0	0
23	17520311	.	T	G	12	13	25	1	3	29	0	0
23	17520338	.	G	A	10	12	22	0	5	27	0	0
23	17520632	.	A	T	3	6	9	0	0	9	0	0
23	17520870	.	T	C	2	9	11	1	0	12	0	0
23	17520939	.	G	C	0	2	2	0	1	3	0	0
23	17523056	.	C	G	1	2	3	0	0	3	0	0
23	17548350	.	T	C	2	2	4	0	0	4	0	0
23	17656654	.	G	A	15	13	28	0	2	30	0	0
23	17657265	.	G	C	8	9	17	0	0	17	0	0
23	17782767	.	G	A	2	2	4	0	0	4	0	0
23	17812711	.	C	T	26	17	43	0	1	44	0	0
23	17812720	.	T	A	19	27	46	0	0	46	0	0
23	17812755	.	G	T	23	20	43	0	3	46	0	0
23	17813057	.	G	A	27	14	41	0	0	41	0	0
23	17813161	.	T	A	10	14	24	3	10	37	0	0
23	17813717	.	G	A	27	18	45	0	3	48	0	0
23	17813876	.	A	G	23	6	29	1	0	30	0	0
23	17813924	.	A	G	10	4	14	0	1	15	0	0
23	17813952	.	G	T	12	8	20	0	1	21	0	0
23	17814056	.	G	A	21	28	49	0	0	49	0	0
23	17814223	.	C	T	17	21	38	0	5	43	0	0
23	17814281	.	G	T	20	16	36	0	1	38	1	0
23	17814299	.	A	C	18	15	33	0	1	34	0	0
23	17814408	.	A	C	13	16	29	0	1	30	0	0
23	17849044	.	T	A	4	2	6	0	0	6	0	0
23	17849275	.	T	G	13	8	21	0	1	22	0	0
23	17849296	.	C	G	0	12	12	0	12	24	0	0
23	17849627	.	C	T	13	10	23	0	1	24	0	0
23	17849699	.	C	G	5	5	10	0	0	10	0	0
23	17851768	.	C	T	0	4	4	0	5	9	0	0
23	17853145	.	T	G	6	6	12	0	0	12	0	0
23	17853396	.	A	T	5	2	7	0	1	8	0	0
23	17855427	.	C	A	5	6	11	0	0	11	0	0
23	17857831	.	G	A	5	3	8	0	0	8	0	0
23	17865973	.	T	C	2	0	2	0	2	4	0	0
23	17872049	.	C	A	2	3	5	0	1	6	0	0
23	17873750	.	C	A	45	27	72	1	2	75	0	0
23	17879299	.	G	A	10	6	16	0	1	17	0	0
23	17880800	.	C	T	7	6	13	0	0	13	0	0
23	17901655	.	A	G	2	0	2	0	2	4	0	0
23	17903574	.	C	T	1	4	5	0	1	6	0	0
23	17907323	.	A	C	1	2	3	0	0	3	0	0
23	17994148	.	A	T	3	2	5	0	0	5	0	0
23	17994274	.	C	G	9	3	12	0	0	12	0	0
23	17994354	.	T	C	8	8	16	0	1	17	0	0
23	17994359	.	C	T	8	9	17	0	0	17	0	0
23	17995469	.	G	T	6	5	11	0	0	12	1	0
23	17997033	.	A	G	2	6	8	0	3	11	0	0
23	17997043	.	T	C	4	0	4	0	6	10	0	0
23	18032772	.	G	A	3	2	5	0	0	5	0	0
23	18032912	.	A	C	8	5	13	0	0	13	0	0
23	18032924	.	T	A	4	5	9	0	1	10	0	0
23	18118653	.	A	T	4	6	10	0	0	10	0	0
23	18118922	.	G	A	25	22	47	0	2	49	0	0
23	18119166	.	C	T	22	16	38	0	4	42	0	0
23	18119192	.	T	C	17	0	17	0	16	33	0	0
23	18119399	.	A	G	18	14	32	0	1	33	0	0
23	18286781	.	G	A	5	7	12	0	2	14	0	0
23	18286782	.	C	T	5	7	12	0	2	14	0	0
23	18372124	.	A	T	1	2	3	0	0	3	0	0
23	18372135	.	C	T	2	2	4	0	0	4	0	0
23	18375847	.	G	A	12	16	28	0	0	28	0	0
23	18375853	.	T	C	16	0	16	0	11	27	0	0
23	18387709	.	T	A	19	26	45	0	1	46	0	0
23	18388004	.	G	A	18	17	35	0	1	36	0	0
23	18388166	.	T	A	10	12	22	0	4	27	1	0
23	18388476	.	G	A	15	11	26	0	0	26	0	0
23	18388555	.	A	G	13	16	29	0	1	30	0	0
23	18388685	.	G	A	8	10	18	0	0	18	0	0
23	18388764	.	G	A	10	7	17	0	1	18	0	0
23	18388954	.	G	A	6	7	13	0	0	13	0	0
23	18389594	.	G	T	19	14	33	0	1	34	0	0
23	18390402	.	G	A	11	9	20	0	0	20	0	0
23	18390635	.	G	A	11	10	21	0	0	21	0	0
23	18390758	.	T	C	8	1	9	0	7	16	0	0
23	18390780	.	C	T	5	11	16	0	1	17	0	0
23	18394401	.	T	G	10	10	20	0	2	22	0	0
23	18405812	.	C	T	5	5	10	0	0	10	0	0
23	18405862	.	A	G	2	4	6	0	0	6	0	0
23	18406479	.	G	A	9	4	13	0	1	14	0	0
23	18406573	.	C	A	3	6	9	1	1	11	0	0
23	18415329	.	G	C	8	7	15	0	0	15	0	0
23	18543166	.	C	T	1	2	3	0	0	3	0	0
23	18561289	.	T	A	12	18	30	0	0	30	0	0
23	18561434	.	C	T	0	15	15	0	13	28	0	0
23	18562299	.	A	T	5	5	10	0	0	10	0	0
23	18562358	.	T	G	6	2	8	0	0	8	0	0
23	18562427	.	C	T	6	5	11	0	0	11	0	0
23	18562484	.	G	A	13	8	21	0	1	22	0	0
23	18562522	.	A	C	11	7	18	1	1	20	0	0
23	18562623	.	C	T	10	10	20	0	0	20	0	0
23	18562911	.	C	A	1	12	13	0	21	34	0	0
23	18563951	.	G	T	17	4	21	0	0	21	0	0
23	18563952	.	T	C	15	0	15	0	5	20	0	0
23	18568144	.	G	A	6	4	10	0	0	10	0	0
23	18568206	.	G	A	5	3	8	0	0	8	0	0
23	18569380	.	T	A	8	9	17	0	2	19	0	0
23	18569399	.	C	A	1	8	9	0	10	19	0	0
23	18569543	.	T	C	17	7	24	0	3	27	0	0
23	18569625	.	A	G	20	16	36	0	3	39	0	0
23	18570887	.	C	T	13	14	27	0	1	28	0	0
23	18572547	.	T	A	17	11	28	0	1	29	0	0
23	18572605	.	T	A	8	12	20	0	5	25	0	0
23	18572618	.	G	A	14	9	23	0	1	24	0	0
23	18574353	.	G	A	11	9	20	0	2	22	0	0
23	18574720	.	T	C	10	20	30	0	1	31	0	0
23	18574800	.	C	T	2	14	16	0	16	32	0	0
23	18580933	.	C	A	13	13	26	0	1	27	0	0
23	18580939	.	C	A	1	12	13	0	13	26	0	0
23	18581065	.	A	G	21	13	34	0	3	37	0	0
23	18581835	.	G	A	19	14	33	0	2	35	0	0
23	18581933	.	T	G	11	19	30	0	0	30	0	0
23	18584225	.	G	A	12	11	23	0	0	23	0	0
23	18586793	.	C	T	2	9	11	1	12	24	0	0
23	18588969	.	C	T	10	9	19	0	0	19	0	0
23	18597667	.	G	A	7	9	16	0	1	17	0	0
23	18616517	.	A	T	10	6	16	0	1	17	0	0
23	18616661	.	T	C	23	7	30	0	0	30	0	0
23	18616880	.	T	A	10	14	24	1	1	26	0	0
23	18616980	.	C	G	8	6	14	0	1	15	0	0
23	18617300	.	G	A	13	10	23	0	2	25	0	0
23	18619766	.	C	T	7	14	21	0	1	22	0	0
23	18622541	.	T	G	9	13	22	0	0	22	0	0
23	18628460	.	T	G	15	9	24	0	0	24	0	0
23	18629024	.	T	C	5	3	8	0	1	9	0	0
23	18651789	.	G	A	5	2	7	0	1	8	0	0
23	18651918	.	C	A	9	5	14	0	0	14	0	0
23	18652067	.	T	C	5	8	13	0	2	15	0	0
23	18668440	.	T	C	5	3	8	0	0	8	0	0
23	18702862	.	A	G	2	4	6	0	0	6	0	0
23	18702863	.	G	A	2	3	5	0	1	6	0	0
23	18759802	.	C	A	10	5	15	0	0	15	0	0
23	18759827	.	T	C	4	11	15	0	0	15	0	0
23	18760004	.	G	C	7	0	7	0	4	11	0	0
23	18760049	.	T	A	11	7	18	0	1	19	0	0
23	18760223	.	T	A	4	5	9	0	0	9	0	0
23	18760256	.	C	T	4	6	10	0	0	10	0	0
23	18760519	.	T	A	6	10	16	0	2	18	0	0
23	18764770	.	A	C	3	2	5	0	0	5	0	0
23	18769161	.	T	C	1	0	1	0	4	5	0	0
23	18774122	.	T	C	2	2	4	0	1	5	0	0
23	18777816	.	C	T	6	5	11	0	0	11	0	0
23	18795055	.	T	C	5	6	11	0	2	13	0	0
23	18795620	.	A	G	17	19	36	0	1	37	0	0
23	18795721	.	C	T	18	20	38	0	2	40	0	0
23	18801275	.	G	A	17	14	31	0	0	31	0	0
23	18869550	.	C	A	0	7	7	0	5	12	0	0
23	18870235	.	A	T	7	8	15	0	0	15	0	0
23	18870245	.	T	C	9	0	9	0	5	14	0	0
23	18870716	.	G	T	6	3	9	0	0	9	0	0
23	18944489	.	A	G	9	5	14	0	2	16	0	0
23	18944543	.	G	A	1	17	18	0	15	33	0	0
23	18947344	.	C	A	14	22	36	0	0	36	0	0
23	18947385	.	G	C	12	20	32	0	1	33	0	0
23	18950968	.	T	C	11	19	30	0	1	31	0	0
23	18950970	.	T	A	10	20	30	0	0	30	0	0
23	18951010	.	G	A	15	16	31	0	1	32	0	0
23	18954023	.	A	G	7	10	17	0	1	18	0	0
23	18954100	.	A	G	9	4	13	0	0	13	0	0
23	18954151	.	G	A	5	10	15	0	0	15	0	0
23	18954759	.	T	G	13	15	28	0	2	30	0	0
23	18979342	.	C	T	11	18	29	0	1	30	0	0
23	18979561	.	G	A	15	13	28	0	3	31	0	0
23	18979756	.	T	C	6	8	14	0	3	17	0	0
23	18982375	.	G	A	8	8	16	0	0	16	0	0
23	18986338	.	G	A	11	8	19	0	2	21	0	0
23	18986344	.	G	A	8	10	18	0	3	21	0	0
23	18990914	.	C	T	3	19	22	0	5	27	0	0
23	18993525	.	T	C	7	13	20	0	2	22	0	0
23	18993827	.	C	T	2	10	12	0	9	21	0	0
23	18996030	.	C	T	7	10	17	0	3	20	0	0
23	19005426	.	G	T	11	3	14	0	1	15	0	0
23	19005486	.	T	C	9	4	13	0	0	13	0	0
23	19005758	.	C	T	2	7	9	0	2	11	0	0
23	19005761	.	C	G	5	7	12	0	0	12	0	0
23	19007389	.	G	T	4	4	8	0	0	8	0	0
23	19012845	.	C	G	4	5	9	0	0	9	0	0
23	19017421	.	C	A	2	6	8	0	0	8	0	0
23	19022534	.	G	A	7	3	10	0	0	10	0	0
23	19027510	.	A	C	3	0	3	0	3	6	0	0
23	19035542	.	A	G	1	2	3	0	0	3	0	0
23	19051737	.	C	T	1	2	3	0	0	3	0	0
23	19051739	.	G	A	0	2	2	0	1	3	0	0
23	19066873	.	G	A	1	1	2	0	1	3	0	0
23	19106781	.	G	A	3	3	6	0	0	6	0	0
23	19118372	.	G	T	6	6	12	0	0	12	0	0
23	19118960	.	G	T	5	5	10	0	0	10	0	0
23	19153221	.	A	T	1	2	3	0	0	3	0	0
23	19198348	.	A	T	4	5	9	0	2	11	0	0
23	19198588	.	A	T	8	10	18	0	2	20	0	0
23	19200168	.	G	A	12	10	22	0	0	22	0	0
23	19201103	.	C	A	8	17	25	0	2	27	0	0
23	19201148	.	G	T	3	7	10	0	0	10	0	0
23	19202799	.	A	T	2	2	4	0	0	4	0	0
23	19202800	.	A	T	2	2	4	0	0	4	0	0
23	19203952	.	C	T	1	6	7	0	0	7	0	0
23	19204738	.	C	T	6	4	10	0	0	10	0	0
23	19474823	.	G	T	5	13	18	0	3	21	0	0
23	19575044	.	G	A	1	11	12	0	9	21	0	0
23	19575134	.	C	T	16	9	25	0	4	29	0	0
23	19577464	.	G	A	2	13	15	0	18	33	0	0
23	19582481	.	T	C	16	20	36	0	2	38	0	0
23	19582559	.	G	T	11	6	17	0	1	18	0	0
23	19582668	.	T	C	18	9	27	0	0	27	0	0
23	19582678	.	C	T	21	11	32	0	0	32	0	0
23	19583208	.	G	A	1	6	7	0	13	20	0	0
23	19583252	.	C	T	8	9	17	0	3	20	0	0
23	19603630	.	T	C	28	36	64	1	2	67	0	0
23	19603753	.	T	C	24	26	50	0	3	53	0	0
23	19603803	.	T	C	20	18	38	0	3	41	0	0
23	19603880	.	A	T	27	13	40	0	5	45	0	0
23	19603994	.	G	A	20	20	40	0	1	41	0	0
23	19604263	.	A	G	19	1	20	0	17	37	0	0
23	19604351	.	G	T	7	14	21	0	0	21	0	0
23	19630573	.	C	T	1	2	3	0	0	3	0	0
23	19670139	.	G	C	8	4	12	0	0	12	0	0
23	19670185	.	A	T	7	11	18	0	2	20	0	0
23	19672720	.	T	C	11	11	22	0	0	22	0	0
23	19673170	.	C	T	17	10	27	0	0	27	0	0
23	19673376	.	C	T	7	13	20	0	0	20	0	0
23	19675812	.	G	A	0	8	8	0	2	10	0	0
23	19712898	.	G	A	33	30	63	0	3	66	0	0
23	19713291	.	A	G	32	34	66	0	2	68	0	0
23	19713324	.	A	G	30	32	62	0	5	67	0	0
23	19786363	.	T	C	3	2	5	0	0	5	0	0
23	19790413	.	A	G	2	4	6	0	0	6	0	0
23	19790712	.	C	T	2	4	6	0	0	6	0	0
23	19795565	.	T	C	2	3	5	0	0	5	0	0
23	19795568	.	C	T	2	2	4	0	1	5	0	0
23	19796643	.	A	T	3	2	5	0	0	5	0	0
23	19796651	.	G	A	3	2	5	0	1	6	0	0
23	19798168	.	T	C	2	2	4	0	0	4	0	0
23	19798174	.	A	G	2	2	4	0	0	4	0	0
23	19798493	.	T	C	2	5	7	0	0	7	0	0
23	19798700	.	T	A	2	2	4	0	0	4	0	0
23	19800228	.	T	C	3	3	6	0	1	7	0	0
23	19804543	.	C	A	3	2	5	0	0	5	0	0
23	19804743	.	A	C	3	2	5	0	0	5	0	0
23	19804744	.	T	C	3	2	5	0	0	5	0	0
23	19805577	.	A	T	3	8	11	0	2	13	0	0
23	19808022	.	C	T	10	9	19	0	3	22	0	0
23	19808078	.	T	C	7	7	14	0	2	16	0	0
23	19808691	.	G	A	2	11	13	0	16	29	0	0
23	19808895	.	A	G	4	0	4	0	3	7	0	0
23	19815467	.	G	A	9	7	16	0	0	16	0	0
23	19816699	.	A	T	10	10	20	0	1	21	0	0
23	19821136	.	A	G	9	0	9	0	13	22	0	0
23	19821150	.	C	T	10	9	19	0	2	21	0	0
23	19821277	.	A	C	9	8	17	0	2	19	0	0
23	19821408	.	C	T	7	6	13	0	3	16	0	0
23	19821447	.	G	C	4	3	7	0	0	7	0	0
23	19821470	.	G	A	0	2	2	0	4	6	0	0
23	19821489	.	A	T	2	1	3	0	1	4	0	0
23	19821549	.	C	A	2	3	5	0	0	5	0	0
23	19835308	.	T	C	31	23	54	0	2	56	0	0
23	19836260	.	C	T	31	22	53	1	0	54	0	0
23	19837080	.	T	C	31	26	57	0	3	60	0	0
23	19837503	.	G	A	24	28	52	0	0	52	0	0
23	19837939	.	A	G	11	15	26	0	2	28	0	0
23	19837974	.	G	A	18	8	26	0	1	27	0	0
23	19838100	.	C	A	33	24	57	0	1	58	0	0
23	19838295	.	T	G	9	6	15	0	0	15	0	0
23	19838312	.	A	T	7	6	13	0	0	13	0	0
23	19838387	.	A	T	10	8	18	0	1	19	0	0
23	19838388	.	T	A	7	9	16	0	3	19	0	0
23	19838458	.	A	T	9	11	20	0	2	22	0	0
23	19838459	.	A	C	11	11	22	0	0	22	0	0
23	19869132	.	G	A	20	12	32	0	2	34	0	0
23	19871615	.	A	G	24	13	37	0	1	38	0	0
23	19879576	.	C	T	1	13	14	0	23	37	0	0
23	19883318	.	T	C	17	10	27	0	1	28	0	0
23	19893409	.	A	T	12	18	30	0	3	33	0	0
23	19933542	.	A	G	11	6	17	0	2	19	0	0
23	19933578	.	G	A	9	7	16	0	0	16	0	0
23	19933742	.	G	A	10	8	18	0	0	18	0	0
23	19933850	.	A	G	7	6	13	0	1	14	0	0
23	19933896	.	A	G	8	10	18	0	2	20	0	0
23	19933952	.	A	G	8	10	18	0	2	20	0	0
23	19952743	.	C	T	0	9	9	0	12	21	0	0
23	19952869	.	T	A	9	10	19	0	0	19	0	0
23	19969136	.	C	A	1	2	3	0	0	3	0	0
23	19969420	.	A	T	1	3	4	0	0	4	0	0
23	19969710	.	G	A	1	6	7	0	0	7	0	0
23	19974092	.	G	A	3	3	6	0	1	7	0	0
23	19981119	.	C	T	2	2	4	0	0	4	0	0
23	19981124	.	T	C	1	2	3	0	1	4	0	0
23	19981510	.	G	T	6	4	10	0	1	11	0	0
23	19981554	.	T	C	11	5	16	0	0	16	0	0
23	19981608	.	A	T	9	3	12	0	0	12	0	0
23	19985054	.	A	G	3	7	10	0	0	10	0	0
23	19985307	.	G	T	2	3	5	0	0	5	0	0
23	19985403	.	T	C	9	4	13	0	0	13	0	0
23	20000716	.	A	G	2	6	8	0	4	12	0	0
23	20002339	.	G	C	4	6	10	0	0	10	0	0
23	20002373	.	T	A	2	5	7	0	1	8	0	0
23	20002439	.	G	C	3	0	3	0	5	8	0	0
23	20010287	.	T	A	2	2	4	0	0	4	0	0
23	20010481	.	A	C	2	0	2	0	2	4	0	0
23	20014069	.	A	C	1	3	4	0	0	4	0	0
23	20014070	.	T	A	1	3	4	0	0	4	0	0
23	20014285	.	A	T	4	4	8	0	0	8	0	0
23	20014407	.	A	T	4	2	6	0	2	8	0	0
23	20014474	.	T	A	3	2	5	0	0	5	0	0
23	20014486	.	C	T	0	2	2	0	3	5	0	0
23	20014802	.	T	A	4	2	6	0	0	6	0	0
23	20014811	.	C	T	3	2	5	0	3	8	0	0
23	20022144	.	A	G	1	2	3	0	0	3	0	0
23	20022199	.	G	A	4	1	5	0	1	6	0	0
23	20113599	.	T	C	16	14	30	0	1	31	0	0
23	20113848	.	G	T	21	20	41	0	1	42	0	0
23	20114327	.	C	A	31	15	46	0	1	47	0	0
23	20117625	.	C	G	2	14	16	0	16	33	1	0
23	20117830	.	A	G	17	17	34	0	0	34	0	0
23	20117938	.	A	C	14	0	14	0	14	28	0	0
23	20118597	.	T	G	16	12	28	0	2	30	0	0
23	20120646	.	T	C	11	0	11	0	12	23	0	0
23	20121265	.	T	A	20	12	32	0	0	32	0	0
23	20121270	.	G	T	19	11	30	0	0	30	0	0
23	20121326	.	G	A	18	8	26	0	1	27	0	0
23	20122190	.	A	G	12	8	20	0	0	20	0	0
23	20123375	.	G	A	6	6	12	0	0	12	0	0
23	20123386	.	G	T	6	6	12	0	2	14	0	0
23	20123575	.	C	A	4	12	16	0	0	16	0	0
23	20123576	.	C	T	4	11	15	0	1	16	0	0
23	20123629	.	A	G	9	14	23	0	1	24	0	0
23	20138134	.	T	C	3	4	7	0	0	7	0	0
23	20145420	.	T	A	8	14	22	0	0	22	0	0
23	20145823	.	T	C	9	8	17	0	0	17	0	0
23	20146080	.	A	G	8	6	14	0	0	14	0	0
23	20152477	.	T	C	7	13	20	0	2	22	0	0
23	20152640	.	G	A	8	13	21	0	0	21	0	0
23	20154486	.	A	G	4	9	13	0	0	13	0	0
23	20157790	.	G	A	7	8	15	0	1	16	0	0
23	20157923	.	G	C	5	0	5	0	3	8	0	0
23	20157930	.	T	C	5	0	5	0	4	9	0	0
23	20159225	.	C	T	1	2	3	0	4	7	0	0
23	20159234	.	G	T	5	2	7	0	0	7	0	0
23	20162004	.	G	A	7	2	9	0	0	9	0	0
23	20167944	.	T	C	1	3	4	0	0	4	0	0
23	20167966	.	G	A	2	4	6	0	0	6	0	0
23	20168127	.	C	T	0	7	7	0	2	9	0	0
23	20168404	.	C	G	5	4	9	0	0	9	0	0
23	20168642	.	G	A	3	3	6	0	1	7	0	0
23	20170945	.	T	A	3	3	6	0	0	6	0	0
23	20190137	.	T	C	1	2	3	0	0	3	0	0
23	20261773	.	G	A	1	2	3	0	1	4	0	0
23	20262604	.	T	G	0	2	2	0	1	3	0	0
23	20264440	.	C	T	3	4	7	0	0	7	0	0
23	20636333	.	T	G	6	0	6	0	14	23	3	0
23	20636338	.	A	C	7	3	10	0	14	24	0	0
23	21111170	.	A	G	6	0	6	0	4	10	0	0
23	21456791	.	T	A	2	3	5	0	0	5	0	0
23	21470390	.	C	G	2	3	5	0	0	5	0	0
23	21489572	.	A	G	7	4	11	0	2	13	0	0
23	21797393	.	A	G	5	2	7	0	0	7	0	0
23	22060088	.	T	A	1	9	10	1	1	12	0	0
23	22886149	.	C	T	3	6	9	0	0	9	0	0
23	22888817	.	G	A	3	5	8	0	0	8	0	0
23	22918609	.	A	T	4	4	8	0	0	8	0	0
23	22919817	.	C	T	17	12	29	0	1	30	0	0
23	22919883	.	T	C	8	16	24	0	0	24	0	0
23	22920221	.	T	A	10	12	22	0	3	25	0	0
23	22920427	.	A	C	10	0	10	0	11	21	0	0
23	22920431	.	A	C	2	1	3	0	16	19	0	0
23	22920594	.	C	T	18	17	35	0	2	37	0	0
23	22923021	.	A	C	21	15	36	0	4	40	0	0
23	22923057	.	A	G	16	1	17	0	23	40	0	0
23	22923093	.	C	T	15	24	39	0	4	43	0	0
23	22923147	.	C	T	20	9	29	0	0	29	0	0
23	22923198	.	C	T	17	7	24	0	2	26	0	0
23	22923537	.	C	T	13	15	28	0	1	29	0	0
23	23118653	.	A	T	6	6	12	0	3	15	0	0
23	23118815	.	C	T	5	6	11	0	0	11	0	0
23	23122178	.	G	A	1	6	7	1	8	16	0	0
23	23122381	.	C	T	7	9	16	0	0	16	0	0
23	23122412	.	G	A	0	6	6	0	10	16	0	0
23	23122528	.	C	T	4	5	9	0	0	9	0	0
23	23122898	.	A	G	9	5	14	0	1	15	0	0
23	23123146	.	G	T	7	4	11	0	0	11	0	0
23	23123420	.	G	T	6	2	8	0	0	8	0	0
23	23126414	.	A	G	4	4	8	0	2	10	0	0
23	23126447	.	G	A	2	8	10	0	0	10	0	0
23	23126621	.	T	C	4	3	7	0	0	7	0	0
23	23136745	.	G	A	4	4	8	0	0	8	0	0
23	23154388	.	T	A	3	4	7	0	1	8	0	0
23	23160057	.	C	T	4	2	6	0	0	6	0	0
23	23174035	.	A	G	3	3	6	0	0	6	0	0
23	23174059	.	G	A	4	2	6	0	0	6	0	0
23	23190151	.	T	A	1	6	7	0	0	7	0	0
23	23205469	.	A	G	3	0	3	0	8	11	0	0
23	23212257	.	C	T	3	14	17	0	0	17	0	0
23	23213068	.	A	C	1	8	9	0	1	10	0	0
23	23213069	.	A	C	2	7	9	0	1	10	0	0
23	23213219	.	T	C	2	19	21	0	1	22	0	0
23	23213437	.	G	A	0	21	21	0	3	24	0	0
23	23213582	.	C	A	2	17	19	0	0	19	0	0
23	23214070	.	C	T	2	8	10	0	0	10	0	0
23	23214417	.	C	T	8	2	10	0	2	12	0	0
23	23399987	.	T	C	5	9	14	0	0	14	0	0
23	23400032	.	A	G	8	9	17	0	0	17	0	0
23	23401093	.	T	A	2	3	5	0	0	5	0	0
23	23658506	.	T	A	2	3	5	0	0	5	0	0
23	23658766	.	C	T	2	4	6	0	1	7	0	0
23	23754415	.	C	T	4	2	6	0	0	6	0	0
23	23794656	.	T	C	5	3	8	0	0	8	0	0
23	23830952	.	T	C	2	7	9	0	2	11	0	0
23	23830985	.	C	G	5	5	10	0	0	10	0	0
23	23844523	.	A	C	1	1	2	0	7	9	0	0
23	23860113	.	T	A	7	5	12	0	2	14	0	0
23	23860117	.	G	A	8	6	14	0	0	14	0	0
23	23863569	.	G	A	8	7	15	0	1	16	0	0
23	23869182	.	T	C	14	14	28	0	1	29	0	0
23	23877088	.	A	G	14	1	15	0	17	32	0	0
23	23888136	.	G	A	1	9	10	0	17	27	0	0
23	23890928	.	T	C	14	12	26	0	2	28	0	0
23	23891535	.	C	T	19	15	34	0	1	35	0	0
23	23891551	.	G	A	2	15	17	0	17	34	0	0
23	23903278	.	G	A	0	21	21	0	8	29	0	0
23	23903308	.	C	T	15	9	24	0	0	24	0	0
23	23912720	.	G	T	23	12	35	0	1	36	0	0
23	23912723	.	C	A	21	14	35	0	1	36	0	0
23	23912881	.	C	T	16	13	29	0	1	30	0	0
23	23913053	.	T	A	9	7	16	0	1	17	0	0
23	23913055	.	T	A	11	7	18	0	1	19	0	0
23	23913240	.	G	T	11	20	31	0	0	31	0	0
23	23913417	.	T	C	28	28	56	1	0	57	0	0
23	23913818	.	A	T	21	20	41	0	1	42	0	0
23	23913832	.	G	A	21	17	38	0	2	40	0	0
23	23913858	.	A	C	18	20	38	0	4	42	0	0
23	23914176	.	A	T	20	12	32	0	1	33	0	0
23	23973724	.	T	A	5	2	7	0	0	7	0	0
23	23973781	.	C	A	5	4	9	0	0	9	0	0
23	23977689	.	T	C	6	3	9	0	0	9	0	0
23	23981262	.	T	G	3	0	3	0	2	5	0	0
23	23994595	.	C	T	7	2	9	0	1	10	0	0
23	24090108	.	T	A	1	2	3	0	0	3	0	0
23	24144860	.	A	G	2	4	6	0	1	7	0	0
23	24144872	.	T	C	3	3	6	0	0	6	0	0
23	24176425	.	C	T	1	23	24	0	18	42	0	0
23	24176474	.	A	G	17	19	36	0	0	36	0	0
23	24178789	.	C	T	4	10	14	0	12	26	0	0
23	24181913	.	G	A	11	5	16	0	0	16	0	0
23	24183523	.	A	C	14	7	21	0	1	22	0	0
23	24190677	.	C	T	7	4	11	0	1	12	0	0
23	24195611	.	T	C	7	0	7	3	4	14	0	0
23	24202583	.	A	T	9	5	14	0	1	15	0	0
23	24202734	.	C	A	1	4	5	0	2	7	0	0
23	24202754	.	A	C	3	0	3	0	2	5	0	0
23	24202833	.	G	A	4	9	13	0	0	13	0	0
23	24202859	.	A	T	5	7	12	0	0	12	0	0
23	24202985	.	T	C	6	11	17	0	0	17	0	0
23	24208208	.	G	C	4	6	10	0	4	14	0	0
23	24209873	.	C	T	1	4	5	0	1	6	0	0
23	24216339	.	A	C	3	0	3	0	4	7	0	0
23	24227400	.	G	A	5	9	14	0	0	14	0	0
23	24227696	.	C	T	20	7	27	0	1	28	0	0
23	24227702	.	T	A	18	8	26	0	2	28	0	0
23	24229110	.	G	A	6	12	18	0	1	19	0	0
23	24233831	.	A	G	6	8	14	0	1	15	0	0
23	24234181	.	T	C	2	5	7	0	0	7	0	0
23	24234232	.	T	C	2	10	12	0	1	13	0	0
23	24238798	.	C	T	1	11	12	0	1	13	0	0
23	24239009	.	C	T	9	7	16	0	1	17	0	0
23	24241090	.	C	G	1	5	6	1	11	18	0	0
23	24243168	.	G	A	6	5	11	0	0	11	0	0
23	24244694	.	C	T	0	2	2	0	5	7	0	0
23	24246864	.	A	G	4	6	10	0	0	10	0	0
23	24249074	.	G	T	7	5	12	0	0	12	0	0
23	24249227	.	C	T	11	7	18	0	0	18	0	0
23	24251531	.	C	A	5	4	9	0	1	10	0	0
23	24258499	.	A	G	1	2	3	0	0	3	0	0
23	24263392	.	G	A	2	3	5	0	0	5	0	0
23	24300958	.	T	A	1	4	5	0	0	5	0	0
23	24301297	.	C	T	2	1	3	0	1	4	0	0
23	24304648	.	T	C	2	2	4	0	0	4	0	0
23	24308629	.	A	C	3	2	5	0	0	5	0	0
23	24439480	.	G	T	16	14	30	0	1	31	0	0
23	24439580	.	T	C	25	0	25	0	24	49	0	0
23	24439780	.	G	A	11	20	31	0	1	32	0	0
23	24440273	.	G	A	8	7	15	0	0	15	0	0
23	24440414	.	C	A	18	11	29	0	1	30	0	0
23	24443161	.	G	T	6	6	12	0	0	12	0	0
23	24444279	.	C	T	12	12	24	0	3	27	0	0
23	24444803	.	T	G	12	11	23	0	1	24	0	0
23	24444861	.	G	A	12	10	22	0	1	23	0	0
23	24445112	.	G	T	15	12	27	0	1	28	0	0
23	24445584	.	A	G	7	12	19	0	0	19	0	0
23	24445906	.	G	C	10	6	16	0	1	17	0	0
23	24446040	.	T	A	6	4	10	0	1	11	0	0
23	24447113	.	C	T	4	5	9	0	0	9	0	0
23	24448071	.	T	A	7	6	13	0	1	14	0	0
23	24448621	.	G	C	4	2	6	0	0	6	0	0
23	24448630	.	G	T	5	1	6	0	1	7	0	0
23	24451083	.	A	G	5	6	11	0	0	11	0	0
23	24451283	.	A	G	2	3	5	0	0	5	0	0
23	24451920	.	T	A	2	3	5	0	0	5	0	0
23	24485932	.	C	A	1	2	3	0	0	3	0	0
23	24489423	.	G	T	2	2	4	0	0	4	0	0
23	24507550	.	A	G	7	11	18	0	2	20	0	0
23	24507555	.	T	C	6	13	19	0	2	21	0	0
23	24507668	.	A	G	8	0	8	0	5	13	0	0
23	24508422	.	T	G	12	4	16	0	0	16	0	0
23	24508500	.	C	T	11	8	19	0	0	19	0	0
23	24508630	.	T	C	23	11	34	0	1	35	0	0
23	24513096	.	C	T	0	3	3	0	4	7	0	0
23	24581809	.	G	A	11	7	18	0	0	18	0	0
23	24582165	.	G	A	2	5	7	0	1	8	0	0
23	24582185	.	C	T	7	2	9	0	1	10	0	0
23	24589983	.	G	A	1	2	3	0	2	5	0	0
23	24591447	.	G	C	0	2	2	0	3	5	0	0
23	24591676	.	G	A	3	2	5	0	0	5	0	0
23	24591764	.	G	A	1	2	3	0	2	5	0	0
23	24591799	.	G	A	2	3	5	0	0	5	0	0
23	24591808	.	G	A	2	3	5	0	0	5	0	0
23	24595418	.	G	A	0	5	5	0	2	7	0	0
23	24600513	.	C	T	10	5	15	0	1	16	0	0
23	24600947	.	T	C	10	7	17	0	1	18	0	0
23	24604042	.	C	T	7	13	20	0	2	22	0	0
23	24604323	.	C	T	13	12	25	0	2	27	0	0
23	24604461	.	A	G	9	1	10	0	7	17	0	0
23	24605243	.	T	A	10	12	22	0	1	23	0	0
23	24608805	.	G	A	8	11	19	0	3	22	0	0
23	24608847	.	G	A	1	12	13	0	12	25	0	0
23	24611786	.	G	A	0	3	3	0	4	7	0	0
23	24652327	.	G	A	1	2	3	0	0	3	0	0
23	24654287	.	G	T	5	3	8	0	0	8	0	0
23	24655227	.	T	C	2	5	7	0	0	7	0	0
23	24655478	.	C	T	2	4	6	0	0	6	0	0
23	24655761	.	T	G	2	0	2	0	5	7	0	0
23	24655833	.	A	G	3	5	8	0	0	8	0	0
23	24661762	.	A	G	9	0	9	0	4	13	0	0
23	24661851	.	C	T	9	4	13	0	1	14	0	0
23	24669319	.	A	T	16	8	24	0	1	25	0	0
23	24669381	.	C	T	2	11	13	0	12	25	0	0
23	24669561	.	A	G	9	19	28	0	2	30	0	0
23	24669633	.	T	C	14	1	15	0	14	29	0	0
23	24676192	.	G	C	6	9	15	0	0	15	0	0
23	24693600	.	G	T	1	2	3	0	0	3	0	0
23	24694096	.	C	T	13	17	30	0	0	30	0	0
23	24694184	.	G	C	18	13	31	0	1	32	0	0
23	24694242	.	C	A	15	13	28	0	0	28	0	0
23	24694387	.	A	G	15	30	45	0	2	47	0	0
23	24694756	.	C	T	21	20	41	0	0	41	0	0
23	24696943	.	A	G	10	16	26	0	0	26	0	0
23	24697036	.	G	A	9	11	20	0	0	20	0	0
23	24697287	.	A	C	14	12	26	0	0	26	0	0
23	24699281	.	T	A	8	16	24	0	0	24	0	0
23	24735340	.	C	T	1	1	2	0	1	3	0	0
23	24749292	.	A	G	1	2	3	0	0	3	0	0
23	24749514	.	A	G	3	0	3	0	2	5	0	0
23	24749528	.	A	T	2	2	4	0	1	5	0	0
23	24749673	.	C	T	1	2	3	0	0	3	0	0
23	24750285	.	T	C	2	5	7	0	0	7	0	0
23	24819831	.	C	G	2	6	8	0	1	9	0	0
23	24819936	.	G	A	8	6	14	0	0	14	0	0
23	24823899	.	T	C	6	5	11	0	0	11	0	0
23	24824056	.	G	A	2	2	4	0	0	4	0	0
23	24926470	.	G	A	7	8	15	0	2	17	0	0
23	24932979	.	G	A	8	6	14	0	1	15	0	0
23	24933121	.	C	T	6	6	12	0	0	12	0	0
23	24934567	.	T	C	8	9	17	0	1	18	0	0
23	24934597	.	C	G	4	7	11	0	2	13	0	0
23	24934646	.	G	A	9	9	18	0	1	19	0	0
23	24937143	.	T	C	17	20	37	0	4	41	0	0
23	24937357	.	T	C	10	11	21	0	0	21	0	0
23	24937676	.	T	C	7	3	10	0	0	10	0	0
23	24937750	.	T	A	9	6	15	0	2	17	0	0
23	24937813	.	G	A	6	6	12	0	2	14	0	0
23	24937848	.	T	C	6	6	12	0	0	12	0	0
23	24938290	.	T	A	6	4	10	0	0	10	0	0
23	24938401	.	G	A	13	11	24	0	0	24	0	0
23	24938446	.	T	C	11	7	18	0	1	19	0	0
23	24938627	.	G	A	10	3	13	0	0	13	0	0
23	24938642	.	C	T	9	3	12	0	0	12	0	0
23	24938791	.	A	G	3	0	3	0	5	8	0	0
23	24938901	.	G	A	5	5	10	0	0	10	0	0
23	24939008	.	T	C	3	3	6	0	0	6	0	0
23	24941366	.	T	A	1	2	3	0	0	3	0	0
23	24941479	.	C	A	1	3	4	0	0	4	0	0
23	24941524	.	T	C	2	6	8	0	0	8	0	0
23	24941714	.	T	C	1	7	8	0	1	9	0	0
23	24944247	.	G	A	4	3	7	0	0	7	0	0
23	24948934	.	C	G	2	3	5	0	0	5	0	0
23	24950420	.	C	A	1	3	4	0	0	4	0	0
23	24957161	.	G	C	1	2	3	0	0	3	0	0
23	24959374	.	G	C	2	3	5	0	0	5	0	0
23	24960393	.	T	A	4	3	7	0	0	7	0	0
23	24968676	.	C	A	2	5	7	0	0	7	0	0
23	24969026	.	G	T	8	8	16	0	0	16	0	0
23	24970331	.	A	G	4	0	4	0	8	12	0	0
23	24973857	.	C	T	7	2	9	0	0	9	0	0
23	24973871	.	T	C	6	2	8	0	0	8	0	0
23	24980415	.	G	A	2	4	6	0	1	7	0	0
23	24983469	.	C	G	3	4	7	0	0	7	0	0
23	24983479	.	G	C	3	3	6	0	0	6	0	0
23	24984588	.	T	A	5	5	10	0	0	10	0	0
23	24984969	.	A	C	8	4	12	0	0	12	0	0
23	25009935	.	C	T	3	5	8	0	1	9	0	0
23	25012510	.	G	T	6	3	9	0	0	9	0	0
23	25012584	.	T	C	2	6	8	0	0	8	0	0
23	25014445	.	G	C	2	7	9	0	0	9	0	0
23	25122283	.	T	A	6	8	14	0	2	16	0	0
23	25132264	.	G	A	19	8	27	0	1	28	0	0
23	25135899	.	C	G	4	5	9	0	0	9	0	0
23	25135944	.	T	A	7	6	13	0	0	13	0	0
23	25135945	.	T	A	6	6	12	0	1	13	0	0
23	25136067	.	G	A	1	5	6	0	0	6	0	0
23	25149777	.	C	T	17	7	24	0	1	25	0	0
23	25149921	.	A	G	12	6	18	0	0	18	0	0
23	25211392	.	T	G	8	4	12	0	1	13	0	0
23	25211419	.	C	A	6	8	14	0	0	14	0	0
23	25217774	.	C	T	9	6	15	0	0	15	0	0
23	25218647	.	C	G	9	13	22	0	1	23	0	0
23	25218728	.	G	A	10	5	15	0	1	16	0	0
23	25218850	.	A	G	10	8	18	0	0	18	0	0
23	25218854	.	A	G	10	6	16	0	0	16	0	0
23	25220160	.	A	G	8	7	15	0	2	17	0	0
23	25220217	.	T	C	9	7	16	0	0	16	0	0
23	25220226	.	G	T	9	8	17	0	0	17	0	0
23	25220262	.	T	C	8	11	19	0	2	21	0	0
23	25220286	.	C	A	7	10	17	0	3	20	0	0
23	25220545	.	C	T	6	6	12	0	0	12	0	0
23	25221198	.	G	A	13	8	21	0	0	21	0	0
23	25221264	.	G	A	13	11	24	0	0	24	0	0
23	25222196	.	C	T	20	14	34	0	1	35	0	0
23	25222214	.	G	A	2	15	17	0	19	36	0	0
23	25222578	.	G	T	11	8	19	0	1	20	0	0
23	25222585	.	A	T	10	7	17	0	1	18	0	0
23	25257927	.	C	T	2	2	4	0	0	4	0	0
23	25274450	.	T	G	2	2	4	0	0	4	0	0
23	25274483	.	G	A	1	2	3	0	0	3	0	0
23	25276277	.	A	G	2	0	2	0	2	4	0	0
23	25282205	.	G	A	5	4	9	0	0	9	0	0
23	25284824	.	C	T	6	4	10	0	2	12	0	0
23	25284869	.	T	C	2	7	9	0	0	9	0	0
23	25286802	.	A	C	8	6	14	0	0	14	0	0
23	25287292	.	A	C	2	6	8	0	0	8	0	0
23	25287308	.	G	A	1	6	7	0	5	12	0	0
23	25292000	.	G	A	11	10	21	1	1	23	0	0
23	25293908	.	A	C	4	10	14	0	1	15	0	0
23	25308040	.	A	G	1	0	1	0	2	3	0	0
23	25317939	.	A	G	1	0	1	0	2	3	0	0
23	25448451	.	T	C	1	3	4	0	0	4	0	0
23	25458584	.	G	A	12	19	31	0	1	32	0	0
23	25458615	.	G	A	11	15	26	0	3	29	0	0
23	25464156	.	A	G	13	12	25	0	2	27	0	0
23	25471197	.	G	A	5	5	10	0	0	10	0	0
23	25471652	.	G	A	5	6	11	0	0	11	0	0
23	25484859	.	G	A	6	6	12	0	0	12	0	0
23	25484886	.	G	A	8	5	13	0	0	13	0	0
23	25491895	.	T	C	3	0	3	0	3	6	0	0
23	25495443	.	A	G	2	4	6	0	1	7	0	0
23	25496518	.	T	G	1	3	4	0	1	5	0	0
23	25501969	.	T	G	1	4	5	0	0	5	0	0
23	25514702	.	G	A	1	1	2	0	1	3	0	0
23	25525236	.	A	G	1	2	3	0	0	3	0	0
23	25770804	.	T	A	4	2	6	0	0	6	0	0
23	25771107	.	G	A	6	9	15	0	2	17	0	0
23	25772648	.	A	G	5	6	11	0	1	12	0	0
23	25772799	.	G	A	5	4	9	0	0	9	0	0
23	25773469	.	G	A	3	6	9	0	1	10	0	0
23	25773505	.	G	T	1	4	5	0	0	5	0	0
23	25774855	.	A	G	2	2	4	0	0	4	0	0
23	25776811	.	G	T	3	4	7	0	2	9	0	0
23	25776879	.	A	G	6	5	11	0	0	11	0	0
23	25777286	.	A	G	3	4	7	0	0	7	0	0
23	25779888	.	G	A	3	1	4	0	0	4	0	0
23	25779893	.	A	G	3	2	5	0	0	5	0	0
23	25792923	.	A	T	15	6	21	0	0	21	0	0
23	25796355	.	C	T	7	2	9	0	0	9	0	0
23	25796444	.	T	C	4	2	6	0	0	6	0	0
23	25796484	.	G	C	2	0	2	0	6	8	0	0
23	25796899	.	G	A	8	5	13	0	0	13	0	0
23	25796975	.	G	A	6	6	12	0	0	12	0	0
23	25797143	.	G	C	5	6	11	1	0	12	0	0
23	25869596	.	C	A	9	4	13	0	0	13	0	0
23	25869658	.	C	T	6	8	14	0	1	15	0	0
23	25869706	.	A	G	5	5	10	0	1	11	0	0
23	25871493	.	A	G	5	3	8	0	0	8	0	0
23	25871628	.	G	C	4	10	14	0	0	14	0	0
23	25871764	.	C	A	15	9	24	0	0	24	0	0
23	25873670	.	A	G	5	2	7	0	0	7	0	0
23	25873708	.	C	T	2	2	4	0	0	4	0	0
23	25873828	.	C	A	1	3	4	0	0	4	0	0
23	25873876	.	A	T	5	4	9	0	1	10	0	0
23	25873882	.	G	C	4	5	9	0	0	9	0	0
23	25874089	.	A	C	19	10	29	0	1	30	0	0
23	25874100	.	A	T	18	9	27	0	2	29	0	0
23	25874135	.	G	A	1	10	11	0	19	30	0	0
23	25874154	.	T	G	18	8	26	0	1	27	0	0
23	25874249	.	A	G	15	0	15	0	13	28	0	0
23	25874261	.	T	A	14	8	22	0	1	23	0	0
23	25874334	.	C	G	5	9	14	0	0	14	0	0
23	25874355	.	A	T	3	9	12	0	0	12	0	0
23	25874385	.	T	C	2	12	14	0	0	14	0	0
23	25874452	.	A	T	8	11	19	0	2	21	0	0
23	25874570	.	T	C	3	6	9	0	0	9	0	0
23	25930689	.	C	T	16	19	35	0	1	36	0	0
23	25942399	.	T	G	12	0	12	0	18	30	0	0
23	25942559	.	T	A	8	5	13	0	0	13	0	0
23	25942708	.	G	A	0	3	3	0	4	7	0	0
23	25946732	.	A	G	2	2	4	0	0	4	0	0
23	25946766	.	C	T	5	2	7	0	0	7	0	0
23	25946931	.	A	T	1	3	4	0	0	4	0	0
23	25946941	.	A	T	1	2	3	0	0	3	0	0
23	25947258	.	A	C	0	2	2	0	2	4	0	0
23	25947416	.	T	G	2	3	5	0	0	5	0	0
23	25947599	.	T	C	1	0	1	0	3	4	0	0
23	25954602	.	G	A	3	2	5	0	0	5	0	0
23	25956818	.	C	T	1	2	3	0	0	3	0	0
23	25958173	.	T	C	1	0	1	0	2	3	0	0
23	26063179	.	A	T	2	2	4	0	0	4	0	0
23	26063264	.	T	C	3	2	5	0	1	6	0	0
23	26063560	.	A	T	26	22	48	0	3	51	0	0
23	26063581	.	T	C	28	0	28	0	23	51	0	0
23	26063614	.	A	C	29	27	56	0	4	60	0	0
23	26064050	.	T	A	34	23	57	0	4	61	0	0
23	26064122	.	T	A	20	24	44	1	1	46	0	0
23	26064124	.	T	A	33	11	44	1	2	47	0	0
23	26064186	.	C	G	21	20	41	1	0	42	0	0
23	26064192	.	T	A	18	20	38	1	1	40	0	0
23	26064234	.	G	T	19	26	45	0	2	47	0	0
23	26064266	.	T	A	13	23	36	0	5	41	0	0
23	26074123	.	G	A	16	14	30	0	2	32	0	0
23	26074252	.	T	A	9	9	18	0	5	23	0	0
23	26074288	.	T	C	9	12	21	0	0	21	0	0
23	26074312	.	C	T	10	6	16	0	0	16	0	0
23	26083822	.	A	C	6	3	9	0	1	10	0	0
23	26088857	.	T	C	4	6	10	0	0	10	0	0
23	26094671	.	C	T	11	8	19	0	0	19	0	0
23	26184132	.	T	C	8	8	16	0	0	16	0	0
23	26184225	.	G	A	7	9	16	0	0	16	0	0
23	26187373	.	C	T	0	2	2	0	9	11	0	0
23	26187415	.	A	G	4	4	8	0	0	8	0	0
23	26187657	.	A	G	2	4	6	0	0	6	0	0
23	26187885	.	T	C	3	2	5	0	0	5	0	0
23	26187912	.	G	A	3	3	6	0	0	6	0	0
23	26225670	.	T	C	2	3	5	0	0	5	0	0
23	26225871	.	G	A	4	2	6	0	0	6	0	0
23	26225907	.	A	T	6	4	10	0	0	10	0	0
23	26226066	.	G	T	1	3	4	0	0	4	0	0
23	26227697	.	C	T	0	6	6	0	3	9	0	0
23	26232509	.	C	A	10	6	16	0	1	17	0	0
23	26240897	.	C	T	5	4	9	0	1	10	0	0
23	26241224	.	T	A	8	4	12	0	1	13	0	0
23	26249884	.	G	A	7	3	10	0	1	11	0	0
23	26251973	.	C	T	5	8	13	0	2	15	0	0
23	26251979	.	A	T	6	10	16	0	0	16	0	0
23	26252012	.	A	G	7	5	12	0	0	12	0	0
23	26343689	.	C	G	3	4	7	0	0	7	0	0
23	26488554	.	A	G	2	2	4	0	0	4	0	0
23	26504151	.	A	C	34	3	37	3	27	67	0	0
23	26504202	.	A	T	49	18	67	1	3	71	0	0
23	26504254	.	G	A	42	17	59	1	2	62	0	0
23	26504264	.	C	T	38	20	58	1	2	61	0	0
23	26507741	.	G	A	30	30	60	0	2	62	0	0
23	26509764	.	G	A	25	35	60	0	0	60	0	0
23	26514677	.	G	A	31	12	43	0	1	44	0	0
23	26514797	.	T	C	26	10	36	0	7	43	0	0
23	26517183	.	G	A	23	19	42	0	4	46	0	0
23	26519635	.	T	G	14	7	21	0	2	23	0	0
23	26522647	.	A	G	13	14	27	0	1	28	0	0
23	26543878	.	A	T	3	2	5	0	0	5	0	0
23	26763798	.	A	T	4	5	9	0	1	10	0	0
23	26764138	.	T	C	3	8	11	0	0	11	0	0
23	26764269	.	G	A	11	4	15	0	0	15	0	0
23	26764324	.	C	A	5	7	12	0	0	12	0	0
23	26764351	.	A	C	5	4	9	0	0	9	0	0
23	26770174	.	A	G	1	5	6	0	0	6	0	0
23	26797108	.	T	A	6	7	13	0	0	13	0	0
23	26879781	.	A	C	2	3	5	0	1	6	0	0
23	26946805	.	A	G	2	3	5	0	0	5	0	0
23	26950928	.	G	A	0	6	6	0	3	9	0	0
23	26951926	.	G	A	3	2	5	0	0	5	0	0
23	26979212	.	C	A	12	7	19	0	0	19	0	0
23	27003720	.	G	A	26	23	49	0	3	52	0	0
23	27003925	.	T	C	28	22	50	0	1	51	0	0
23	27003983	.	A	T	25	13	38	0	2	40	0	0
23	27005195	.	G	A	31	20	51	0	1	52	0	0
23	27041461	.	A	T	5	5	10	0	0	10	0	0
23	27042357	.	G	A	3	7	10	0	1	11	0	0
23	27044307	.	A	G	3	5	8	0	0	8	0	0
23	27045022	.	G	A	2	5	7	0	0	7	0	0
23	27052058	.	C	T	16	27	43	0	0	44	1	0
23	27054361	.	C	T	10	10	20	0	0	20	0	0
23	27056877	.	G	A	16	17	33	0	3	36	0	0
23	27059120	.	G	A	2	15	17	0	17	34	0	0
23	27059376	.	T	A	9	14	23	0	1	24	0	0
23	27059422	.	C	T	13	17	30	0	1	31	0	0
23	27059526	.	G	A	3	27	30	0	14	44	0	0
23	27059591	.	C	A	12	13	25	0	2	27	0	0
23	27059782	.	A	G	16	16	32	0	0	32	0	0
23	27135377	.	A	G	1	2	3	0	0	3	0	0
23	27135734	.	G	A	2	1	3	0	2	5	0	0
23	27251789	.	G	C	24	16	40	0	0	40	0	0
23	27252024	.	G	A	17	29	46	0	3	49	0	0
23	27252425	.	G	A	19	23	42	0	1	43	0	0
23	27252587	.	A	G	26	11	37	0	1	38	0	0
23	27252833	.	A	G	11	21	32	0	0	32	0	0
23	27274110	.	G	A	4	5	9	0	1	10	0	0
23	27274266	.	G	A	8	9	17	0	0	17	0	0
23	27279320	.	A	G	7	8	15	0	0	15	0	0
23	27279533	.	C	T	10	9	19	0	1	20	0	0
23	27283466	.	T	C	5	6	11	0	0	11	0	0
23	27283475	.	A	G	5	7	12	0	0	12	0	0
23	27293293	.	C	T	0	5	5	0	6	11	0	0
23	27293335	.	G	A	7	6	13	0	0	13	0	0
23	27296964	.	G	C	5	0	5	0	6	11	0	0
23	27336193	.	G	A	1	3	4	0	0	4	0	0
23	27359176	.	A	G	4	14	18	0	1	19	0	0
23	27359526	.	T	C	7	8	15	0	1	16	0	0
23	27359528	.	C	G	9	8	17	0	0	17	0	0
23	27359825	.	C	A	5	9	14	0	2	16	0	0
23	27361210	.	A	T	6	9	15	0	0	15	0	0
23	27361216	.	G	A	6	9	15	0	1	16	0	0
23	27364018	.	C	T	3	6	9	0	1	10	0	0
23	27366669	.	C	T	3	5	8	0	0	8	0	0
23	27389324	.	C	A	1	4	5	0	0	5	0	0
23	27448169	.	T	C	2	2	4	0	0	4	0	0
23	27498040	.	C	G	13	9	22	0	1	23	0	0
23	27498111	.	C	A	14	7	21	0	0	21	0	0
23	27498177	.	T	C	10	12	22	0	3	25	0	0
23	27498195	.	A	T	13	14	27	0	2	29	0	0
23	27498359	.	T	A	7	5	12	0	1	13	0	0
23	27498564	.	T	A	2	3	5	0	0	5	0	0
23	27498798	.	C	T	2	14	16	0	20	36	0	0
23	27498865	.	G	A	22	11	33	0	1	34	0	0
23	27499096	.	G	A	13	9	22	0	2	24	0	0
23	27499135	.	G	A	12	17	29	0	0	29	0	0
23	27499195	.	A	T	8	11	19	0	1	20	0	0
23	27499246	.	G	A	9	11	20	0	2	22	0	0
23	27513919	.	G	A	14	10	24	0	0	24	0	0
23	27513934	.	T	C	19	10	29	0	2	31	0	0
23	27518434	.	G	A	6	9	15	0	1	16	0	0
23	27521608	.	A	T	1	2	3	0	0	3	0	0
23	27547568	.	G	A	2	3	5	0	1	6	0	0
23	27576533	.	T	G	1	2	3	0	0	3	0	0
23	27576535	.	G	A	0	2	2	0	1	3	0	0
23	27576708	.	G	A	1	2	3	0	0	3	0	0
23	27576900	.	C	T	2	3	5	0	1	6	0	0
23	27591378	.	G	T	5	9	14	0	2	16	0	0
23	27593230	.	C	T	11	5	16	0	1	17	0	0
23	27595823	.	C	A	0	8	8	0	5	13	0	0
23	27595868	.	T	C	7	10	17	0	0	17	0	0
23	27596059	.	G	A	10	7	17	0	2	19	0	0
23	27597141	.	C	A	1	4	5	0	6	11	0	0
23	27601731	.	G	A	2	2	4	0	0	4	0	0
23	27601803	.	C	T	1	2	3	0	0	3	0	0
23	27603158	.	C	T	3	4	7	0	0	7	0	0
23	27605903	.	C	T	3	2	5	0	0	5	0	0
23	27605927	.	C	T	1	3	4	0	0	4	0	0
23	27606827	.	T	A	2	2	4	0	0	4	0	0
23	27622036	.	T	A	33	19	52	0	3	55	0	0
23	27622094	.	C	A	14	24	38	0	0	38	0	0
23	27622324	.	T	C	19	6	25	0	1	26	0	0
23	27622452	.	C	A	6	3	9	0	0	9	0	0
23	27622531	.	A	T	22	7	29	0	0	29	0	0
23	27622706	.	T	C	9	0	9	1	8	18	0	0
23	27629713	.	G	A	19	20	39	0	3	42	0	0
23	27629923	.	A	T	23	15	38	0	0	38	0	0
23	27643941	.	T	C	1	0	1	0	2	3	0	0
23	27654841	.	C	A	1	3	4	0	0	4	0	0
23	27676223	.	G	T	27	33	60	0	3	63	0	0
23	27677278	.	G	A	30	27	57	0	5	62	0	0
23	27677457	.	G	A	16	11	27	0	3	30	0	0
23	27683143	.	G	T	4	5	9	0	2	11	0	0
23	27683248	.	C	A	0	2	2	0	1	3	0	0
23	27683371	.	C	T	1	7	8	0	5	13	0	0
23	27683497	.	C	T	5	7	12	0	1	13	0	0
23	27683629	.	C	T	0	5	5	0	6	11	0	0
23	27683710	.	G	A	4	4	8	0	0	8	0	0
23	27684618	.	T	C	2	0	2	0	3	5	0	0
23	27727163	.	T	C	2	3	5	0	0	5	0	0
23	27788665	.	C	T	10	4	14	0	0	14	0	0
23	27800681	.	G	T	8	6	14	0	0	14	0	0
23	27800977	.	C	T	2	12	14	0	2	16	0	0
23	27807523	.	A	G	4	4	8	0	1	9	0	0
23	27807664	.	G	A	3	4	7	0	0	7	0	0
23	27809601	.	A	C	5	4	9	0	0	9	0	0
23	27822743	.	T	C	5	3	8	0	0	8	0	0
23	27836003	.	C	G	4	4	8	0	0	8	0	0
23	27842530	.	A	T	3	4	7	0	0	7	0	0
23	28186006	.	T	G	3	1	4	0	8	12	0	0
23	28374570	.	G	A	17	20	37	0	2	39	0	0
23	28374711	.	C	A	20	15	35	0	1	36	0	0
23	28374722	.	C	T	21	18	39	0	1	40	0	0
23	28378254	.	G	A	14	10	24	0	3	27	0	0
23	28382953	.	C	T	27	24	51	0	4	55	0	0
23	28388013	.	C	A	20	25	45	1	2	48	0	0
23	28388318	.	C	T	20	14	34	0	1	35	0	0
23	28388325	.	T	C	18	14	32	0	0	32	0	0
23	28421241	.	G	T	2	2	4	0	0	4	0	0
23	28500660	.	G	A	1	2	3	0	0	3	0	0
23	28514441	.	T	C	1	2	3	0	0	3	0	0
23	28522491	.	A	G	2	0	2	0	2	4	0	0
23	28525270	.	T	C	2	3	5	0	0	5	0	0
23	28537575	.	G	A	0	3	3	0	3	6	0	0
23	28541633	.	A	G	8	8	16	0	1	17	0	0
23	28541683	.	G	T	6	4	10	0	0	10	0	0
23	28546870	.	G	A	2	8	10	0	4	14	0	0
23	28547207	.	C	G	8	10	18	0	1	19	0	0
23	28547242	.	A	G	7	0	7	0	11	18	0	0
23	28547261	.	A	G	8	10	18	0	1	19	0	0
23	28548883	.	A	G	11	0	11	0	8	19	0	0
23	28551306	.	A	T	8	14	22	0	0	22	0	0
23	28551671	.	A	G	7	0	7	0	8	15	0	0
23	28551764	.	A	G	7	1	8	0	7	15	0	0
23	28551770	.	G	A	6	7	13	0	2	15	0	0
23	28554784	.	A	T	10	9	19	0	4	23	0	0
23	28557337	.	T	C	13	15	28	0	4	32	0	0
23	28561502	.	C	A	23	16	39	0	2	41	0	0
23	28564191	.	C	A	15	20	35	0	1	36	0	0
23	28659252	.	A	T	2	2	4	0	0	4	0	0
23	28663197	.	T	C	2	3	5	0	0	5	0	0
23	28663227	.	T	C	4	3	7	0	0	7	0	0
23	28663266	.	G	A	4	2	6	0	0	6	0	0
23	28667217	.	T	C	4	2	6	0	0	6	0	0
23	28667300	.	C	A	3	2	5	0	0	5	0	0
23	28669550	.	C	T	6	5	11	0	0	11	0	0
23	28672063	.	G	A	2	4	6	1	1	8	0	0
23	28672155	.	G	A	0	5	5	0	9	14	0	0
23	28674046	.	C	T	6	2	8	0	0	8	0	0
23	28674252	.	G	A	6	8	14	0	1	15	0	0
23	28674890	.	A	C	12	3	15	0	0	15	0	0
23	28679693	.	A	G	18	9	27	0	2	29	0	0
23	28679696	.	C	T	20	8	28	0	2	30	0	0
23	28679753	.	C	T	18	10	28	0	2	30	0	0
23	28680239	.	A	G	10	13	23	0	2	25	0	0
23	28687446	.	C	T	1	2	3	0	0	3	0	0
23	28687448	.	C	G	1	1	2	0	1	3	0	0
23	28687561	.	C	T	2	2	4	0	1	5	0	0
23	28687637	.	G	T	2	3	5	0	0	5	0	0
23	28687656	.	G	A	2	4	6	0	0	6	0	0
23	28704635	.	C	T	4	6	10	0	3	13	0	0
23	28705908	.	C	T	11	6	17	0	0	17	0	0
23	28707051	.	C	T	6	11	17	0	0	17	0	0
23	28713648	.	C	T	11	10	21	0	0	21	0	0
23	28722917	.	C	T	7	4	11	0	0	11	0	0
23	28723338	.	C	A	1	6	7	0	0	7	0	0
23	28724964	.	A	G	8	6	14	0	0	14	0	0
23	28725174	.	G	A	0	3	3	0	3	6	0	0
23	28725425	.	C	T	5	6	11	0	0	11	0	0
23	28725558	.	T	A	1	4	5	0	0	5	0	0
23	28725644	.	G	A	1	6	7	0	1	8	0	0
23	28725743	.	A	G	3	2	5	0	0	5	0	0
23	28725830	.	T	C	6	2	8	0	0	8	0	0
23	28725847	.	A	G	0	5	5	0	1	6	0	0
23	28725872	.	C	T	2	3	5	0	2	7	0	0
23	28726407	.	G	T	1	3	4	0	0	4	0	0
23	28726521	.	A	G	5	8	13	0	0	13	0	0
23	28726852	.	T	C	5	6	11	0	1	12	0	0
23	28726937	.	C	A	2	7	9	0	0	9	0	0
23	28731499	.	C	T	22	31	53	0	0	53	0	0
23	28882538	.	T	C	4	5	9	0	0	9	0	0
23	28882550	.	C	T	4	5	9	0	1	10	0	0
23	28922716	.	C	T	1	3	4	0	1	5	0	0
23	28923151	.	C	T	2	3	5	0	0	5	0	0
23	28923390	.	T	G	2	3	5	0	0	5	0	0
23	28923660	.	A	T	3	4	7	1	0	8	0	0
23	28923760	.	T	A	10	6	16	0	0	16	0	0
23	28923797	.	G	A	3	5	8	0	0	8	0	0
23	28923959	.	T	A	6	6	12	0	2	14	0	0
23	28923962	.	A	G	6	6	12	0	1	13	0	0
23	28924079	.	A	C	4	8	12	1	0	13	0	0
23	28924687	.	G	A	0	8	8	0	6	14	0	0
23	28924872	.	G	A	2	3	5	0	0	5	0	0
23	28924961	.	G	A	0	2	2	0	1	3	0	0
23	28925156	.	A	T	7	7	14	0	0	14	0	0
23	28925159	.	G	A	0	7	7	0	7	14	0	0
23	28925441	.	G	A	3	9	12	0	1	13	0	0
23	28925451	.	A	T	4	9	13	0	0	13	0	0
23	28925589	.	G	A	0	5	5	0	3	8	0	0
23	29358241	.	G	A	2	21	23	0	16	39	0	0
23	29358253	.	C	T	22	20	42	0	1	43	0	0
23	29360044	.	T	C	16	17	33	0	0	33	0	0
23	29360687	.	G	T	9	4	13	0	1	14	0	0
23	29360707	.	G	T	7	4	11	0	1	12	0	0
23	29360757	.	T	G	4	5	9	0	1	10	0	0
23	29361357	.	C	A	6	24	30	3	1	34	0	0
23	29361365	.	A	C	13	19	32	3	2	37	0	0
23	29361557	.	A	T	6	10	16	1	0	17	0	0
23	29376111	.	T	C	13	12	25	0	1	26	0	0
23	29381816	.	G	A	15	14	29	0	2	31	0	0
23	29381819	.	T	G	15	17	32	0	1	33	0	0
23	29381855	.	T	G	18	15	33	0	2	35	0	0
23	29383693	.	C	A	8	19	27	0	0	28	1	0
23	29386735	.	C	T	8	3	11	0	0	11	0	0
23	29386973	.	G	T	3	4	7	0	1	8	0	0
23	29392421	.	G	A	4	12	16	0	0	16	0	0
23	29393414	.	C	T	1	3	4	0	7	11	0	0
23	29393628	.	G	A	8	5	13	0	1	14	0	0
23	29393643	.	A	T	7	4	11	0	0	11	0	0
23	29396452	.	C	T	1	26	27	0	30	57	0	0
23	29396482	.	C	T	26	31	57	0	2	59	0	0
23	29396588	.	T	C	28	5	33	1	27	61	0	0
23	29397230	.	T	A	26	29	55	0	0	55	0	0
23	29397451	.	T	G	23	19	42	0	2	44	0	0
23	29397816	.	G	A	20	22	42	0	2	44	0	0
23	29397907	.	T	C	30	31	61	0	0	61	0	0
23	29398015	.	C	A	4	32	36	0	25	61	0	0
23	29398025	.	G	A	29	26	55	0	4	59	0	0
23	29398310	.	C	T	38	9	47	0	1	48	0	0
23	29398343	.	A	G	33	23	56	0	1	57	0	0
23	29398390	.	C	T	30	25	55	0	1	56	0	0
23	29398718	.	A	T	14	31	45	0	1	46	0	0
23	29402103	.	A	G	29	23	52	0	0	52	0	0
23	29403243	.	G	A	31	27	58	0	0	58	0	0
23	29403297	.	G	A	27	21	48	0	2	50	0	0
23	29403306	.	T	G	23	26	49	0	0	49	0	0
23	29408929	.	G	A	31	23	54	0	0	54	0	0
23	29421959	.	C	G	18	18	36	0	1	37	0	0
23	29422007	.	G	C	27	0	27	0	17	44	0	0
23	29423410	.	G	A	13	16	29	0	2	31	0	0
23	29433670	.	G	A	9	13	22	0	0	22	0	0
23	29433715	.	C	A	12	10	22	0	1	23	0	0
23	29435330	.	C	T	10	9	19	0	0	19	0	0
23	29435381	.	G	A	11	12	23	0	0	23	0	0
23	29582416	.	T	C	24	38	62	0	5	67	0	0
23	29582420	.	T	C	20	45	65	0	1	66	0	0
23	29756977	.	T	C	1	2	3	1	1	5	0	0
23	30061605	.	A	C	19	17	36	0	6	42	0	0
23	30712041	.	T	A	1	5	6	0	1	7	0	0
23	30715397	.	G	A	0	3	3	0	5	8	0	0
23	30716096	.	C	T	2	3	5	0	0	5	0	0
23	30718514	.	T	A	5	6	11	0	0	11	0	0
23	30723747	.	A	T	12	3	15	0	0	15	0	0
23	30724362	.	T	G	4	9	13	0	0	13	0	0
23	30724440	.	T	C	9	9	18	0	0	18	0	0
23	30724793	.	G	T	4	2	6	0	0	6	0	0
23	30730351	.	C	T	2	2	4	0	0	4	0	0
23	30730374	.	C	T	1	3	4	0	0	4	0	0
23	30747357	.	G	C	2	8	10	0	1	11	0	0
23	30747953	.	G	A	5	6	11	0	1	12	0	0
23	30748097	.	G	A	6	5	11	0	1	12	0	0
23	30748712	.	C	G	3	0	3	0	9	12	0	0
23	30748743	.	C	T	3	6	9	0	0	9	0	0
23	30750402	.	C	A	9	9	18	0	2	20	0	0
23	30750694	.	C	A	11	16	27	0	2	29	0	0
23	30750751	.	G	A	1	15	16	0	15	31	0	0
23	30750932	.	A	C	14	23	37	0	1	38	0	0
23	30751008	.	T	C	11	18	29	0	0	29	0	0
23	30751027	.	A	T	7	12	19	0	3	22	0	0
23	30751061	.	A	G	7	2	9	0	17	26	0	0
23	30751117	.	T	C	16	12	28	0	1	29	0	0
23	30751132	.	T	G	22	1	23	0	8	31	0	0
23	30751252	.	A	G	20	16	36	0	3	39	0	0
23	30751570	.	C	T	18	12	30	0	0	30	0	0
23	30751633	.	T	C	18	17	35	0	0	35	0	0
23	30755989	.	C	T	16	14	30	0	1	31	0	0
23	30758493	.	G	T	18	9	27	0	0	27	0	0
23	30764058	.	T	A	8	6	14	0	0	14	0	0
23	30764214	.	G	T	11	8	19	0	0	19	0	0
23	30767575	.	T	A	11	10	21	0	1	22	0	0
23	30770193	.	A	G	16	7	23	0	0	23	0	0
23	30772610	.	C	T	1	5	6	0	14	20	0	0
23	30772902	.	C	T	11	8	19	0	1	20	0	0
23	30775315	.	T	C	10	0	10	0	19	29	0	0
23	30776329	.	T	A	5	2	7	0	0	7	0	0
23	30776380	.	T	C	5	0	5	0	10	15	0	0
23	30776574	.	A	T	4	7	11	0	0	11	0	0
23	30778358	.	T	C	3	5	8	0	1	9	0	0
23	30778499	.	G	A	7	6	13	0	0	13	0	0
23	30778864	.	C	G	0	7	7	0	12	19	0	0
23	30781226	.	T	A	8	10	18	0	1	19	0	0
23	30781319	.	A	G	12	5	17	0	0	17	0	0
23	30781367	.	T	C	9	6	15	0	0	15	0	0
23	30845616	.	G	A	0	2	2	0	1	3	0	0
23	30890839	.	C	T	2	2	4	0	0	4	0	0
23	30898297	.	T	C	3	3	6	0	0	6	0	0
23	30898355	.	A	C	7	4	11	0	0	12	1	0
23	30898387	.	C	T	3	6	9	0	0	9	0	0
23	30898467	.	G	C	1	2	3	0	3	6	0	0
23	30918933	.	T	C	4	3	7	0	0	7	0	0
23	30918961	.	G	T	7	2	9	0	0	9	0	0
23	30918998	.	A	G	5	7	12	0	0	12	0	0
23	30919027	.	T	G	2	8	10	0	1	11	0	0
23	31248605	.	A	T	2	8	10	0	0	10	0	0
23	31276396	.	T	A	6	9	15	0	0	15	0	0
23	31276453	.	G	A	5	14	19	0	0	19	0	0
23	31276657	.	T	C	7	5	12	0	0	12	0	0
23	31278183	.	G	T	5	8	13	0	0	13	0	0
23	31278237	.	C	T	1	5	6	0	4	10	0	0
23	31278322	.	A	G	6	6	12	0	0	12	0	0
23	31278375	.	A	G	6	10	16	0	0	16	0	0
23	31278417	.	G	T	6	6	12	0	0	12	0	0
23	31278450	.	T	A	4	5	9	0	1	10	0	0
23	31278732	.	C	T	4	2	6	0	0	6	0	0
23	31279122	.	G	T	2	6	8	0	0	8	0	0
23	31280198	.	G	A	2	4	6	0	0	6	0	0
23	31280892	.	T	A	1	3	4	0	0	4	0	0
23	31281768	.	T	G	2	2	4	0	0	4	0	0
23	31304679	.	A	G	3	3	6	0	0	6	0	0
23	31307138	.	C	A	1	4	5	0	0	5	0	0
23	31358342	.	A	T	25	21	46	0	2	49	1	0
23	31358344	.	A	T	22	23	45	0	0	46	1	0
23	31358489	.	T	G	28	25	53	0	0	53	0	0
23	31358631	.	G	A	27	32	59	0	1	60	0	0
23	31381068	.	C	T	3	3	6	0	0	6	0	0
23	31381335	.	A	G	2	3	5	0	0	5	0	0
23	31381389	.	T	C	5	2	7	0	0	7	0	0
23	31381392	.	C	T	5	3	8	0	0	8	0	0
23	31388310	.	G	A	2	2	4	0	0	4	0	0
23	31396169	.	C	T	3	2	5	0	0	5	0	0
23	31405519	.	C	T	12	6	18	0	0	18	0	0
23	31405570	.	A	C	14	9	23	0	1	25	1	0
23	31419064	.	C	T	9	4	13	0	2	15	0	0
23	31419172	.	A	T	6	4	10	0	0	10	0	0
23	31422369	.	A	T	6	3	9	0	0	9	0	0
23	31422429	.	C	T	10	3	13	0	0	13	0	0
23	31422600	.	C	T	4	7	11	0	0	11	0	0
23	31422768	.	A	G	4	12	16	1	0	17	0	0
23	31423091	.	T	C	5	6	11	0	1	12	0	0
23	31423145	.	G	A	0	6	6	0	8	14	0	0
23	31423392	.	C	A	22	7	29	0	0	29	0	0
23	31423427	.	A	G	21	0	21	0	6	27	0	0
23	31423432	.	C	A	19	5	24	0	1	25	0	0
23	31432102	.	A	G	5	0	5	0	15	20	0	0
23	31440251	.	G	A	2	2	4	0	1	5	0	0
23	31596584	.	T	G	6	0	6	0	5	11	0	0
23	31597571	.	T	C	6	9	15	0	0	15	0	0
23	31604900	.	C	T	5	6	11	0	0	11	0	0
23	31604912	.	G	T	5	4	9	0	0	9	0	0
23	31640363	.	A	G	4	2	6	0	1	7	0	0
23	31641153	.	C	A	24	19	43	0	2	46	1	0
23	31641197	.	A	G	23	24	47	0	2	49	0	0
23	31641270	.	G	A	23	24	47	0	1	48	0	0
23	31643818	.	A	G	10	14	24	0	0	24	0	0
23	31644368	.	A	G	12	12	24	0	0	24	0	0
23	31644419	.	A	G	13	8	21	0	0	21	0	0
23	31644602	.	T	G	6	11	17	0	3	20	0	0
23	31684244	.	A	G	8	8	16	0	3	19	0	0
23	31684352	.	G	A	16	13	29	0	0	29	0	0
23	31768596	.	T	C	7	10	17	0	0	17	0	0
23	31771282	.	T	C	3	11	14	0	0	14	0	0
23	31774194	.	G	A	7	3	10	0	1	11	0	0
23	31778174	.	A	G	6	6	12	0	1	13	0	0
23	31778183	.	C	T	6	6	12	0	0	12	0	0
23	31782969	.	T	C	7	0	7	0	11	18	0	0
23	31785175	.	G	A	4	5	9	0	0	9	0	0
23	31785183	.	T	G	5	4	9	0	0	9	0	0
23	31787127	.	C	G	7	3	10	0	0	10	0	0
23	31804162	.	A	G	6	8	14	0	2	16	0	0
23	31909338	.	T	A	1	3	4	0	0	4	0	0
23	31940681	.	C	A	2	7	9	0	0	9	0	0
23	31953501	.	A	G	1	2	3	0	0	3	0	0
23	31962971	.	T	C	10	12	22	0	0	22	0	0
23	31963226	.	C	T	5	10	15	0	0	15	0	0
23	31963360	.	A	G	3	8	11	0	2	13	0	0
23	31964680	.	C	T	5	10	15	0	1	16	0	0
23	31992690	.	C	T	1	1	2	0	1	3	0	0
23	31993590	.	C	T	1	3	4	0	0	4	0	0
23	31995113	.	G	A	3	3	6	0	1	7	0	0
23	31997582	.	G	A	4	10	14	0	1	15	0	0
23	31998162	.	T	C	6	5	11	0	0	11	0	0
23	31998741	.	A	G	6	0	6	0	5	11	0	0
23	32000336	.	G	C	4	6	10	0	0	10	0	0
23	32003354	.	T	A	6	5	11	0	0	11	0	0
23	32003808	.	T	C	3	3	6	0	0	6	0	0
23	32003820	.	G	T	5	3	8	0	0	8	0	0
23	32007376	.	T	G	10	4	14	0	0	14	0	0
23	32007445	.	T	A	10	10	20	0	3	23	0	0
23	32007520	.	T	C	5	7	12	0	1	13	0	0
23	32007526	.	C	G	6	7	13	0	0	13	0	0
23	32019746	.	A	G	1	1	2	0	1	3	0	0
23	32026927	.	T	C	7	18	25	0	2	27	0	0
23	32026978	.	C	T	3	2	5	0	0	5	0	0
23	32033330	.	A	G	1	2	3	0	0	3	0	0
23	32081708	.	C	T	13	9	22	0	2	24	0	0
23	32081717	.	T	C	13	12	25	0	0	25	0	0
23	32085908	.	G	T	2	4	6	0	0	6	0	0
23	32088077	.	T	G	4	3	7	0	0	7	0	0
23	32129326	.	C	A	5	2	7	0	1	8	0	0
23	32129476	.	G	T	5	2	7	0	1	8	0	0
23	32129514	.	G	T	6	3	9	0	0	9	0	0
23	32151669	.	A	C	17	14	31	0	0	31	0	0
23	32152022	.	C	T	14	16	30	0	1	31	0	0
23	32154021	.	G	T	5	5	10	0	1	11	0	0
23	32155325	.	A	G	11	10	21	0	0	21	0	0
23	32155719	.	C	T	9	8	17	0	0	17	0	0
23	32155720	.	C	T	1	7	8	0	9	17	0	0
23	32155864	.	A	C	9	0	9	0	8	17	0	0
23	32155975	.	C	T	7	2	9	0	0	9	0	0
23	32157787	.	G	T	6	6	12	0	0	12	0	0
23	32200071	.	A	G	7	3	10	0	0	10	0	0
23	32200076	.	T	G	7	2	9	0	1	10	0	0
23	32200482	.	T	C	5	5	10	0	0	10	0	0
23	32200517	.	C	A	2	2	4	0	1	5	0	0
23	32200979	.	A	G	7	6	13	0	0	13	0	0
23	32201087	.	G	T	4	2	6	0	0	6	0	0
23	32239474	.	A	G	5	2	7	0	1	8	0	0
23	32239672	.	G	A	5	7	12	0	0	12	0	0
23	32239688	.	C	A	9	8	17	0	0	17	0	0
23	32239708	.	G	A	10	12	22	0	0	22	0	0
23	32239824	.	G	A	10	5	15	1	4	20	0	0
23	32240258	.	C	T	5	5	10	0	1	11	0	0
23	32240290	.	A	G	3	5	8	0	0	8	0	0
23	32242086	.	C	A	12	5	17	0	1	18	0	0
23	32242251	.	T	C	4	8	12	0	0	12	0	0
23	32248595	.	C	G	3	3	6	0	0	6	0	0
23	32250286	.	C	T	6	2	8	0	0	8	0	0
23	32251473	.	T	G	2	6	8	0	0	8	0	0
23	32262708	.	G	A	2	2	4	0	0	4	0	0
23	32309187	.	T	C	13	14	27	0	1	28	0	0
23	32309193	.	G	A	15	12	27	0	0	27	0	0
23	32309323	.	G	A	11	16	27	0	2	29	0	0
23	32309533	.	A	G	7	14	21	0	1	22	0	0
23	32309659	.	C	A	0	14	14	0	13	27	0	0
23	32309709	.	G	A	10	4	14	0	0	14	0	0
23	32309787	.	A	C	14	5	19	0	1	20	0	0
23	32309943	.	A	G	5	4	9	0	0	9	0	0
23	32310209	.	C	T	3	8	11	0	0	11	0	0
23	32310254	.	T	A	6	3	9	0	2	11	0	0
23	32310349	.	A	G	4	3	7	0	1	8	0	0
23	32310359	.	C	T	0	4	4	0	4	8	0	0
23	32310419	.	C	T	1	3	4	0	0	4	0	0
23	32310864	.	G	A	5	4	9	0	1	10	0	0
23	32311418	.	T	C	11	4	15	0	1	16	0	0
23	32311555	.	G	C	16	13	29	0	1	30	0	0
23	32311612	.	G	A	17	14	31	0	0	31	0	0
23	32318047	.	A	G	13	17	30	0	2	32	0	0
23	32326532	.	A	G	9	8	17	0	1	18	0	0
23	32362317	.	A	G	3	4	7	0	0	7	0	0
23	32589398	.	C	T	5	3	8	0	1	9	0	0
23	32592518	.	A	G	4	2	6	0	1	7	0	0
23	32592593	.	C	T	0	2	2	0	6	8	0	0
23	32621780	.	C	T	0	4	4	0	3	7	0	0
23	32621792	.	G	A	4	3	7	0	0	7	0	0
23	32636209	.	T	C	1	5	6	0	0	6	0	0
23	32636251	.	G	A	2	3	5	0	0	5	0	0
23	32641956	.	C	T	0	3	3	0	5	8	0	0
23	32641959	.	G	A	5	3	8	0	0	8	0	0
23	33357953	.	T	A	5	2	7	0	0	7	0	0
23	33361256	.	C	T	1	2	3	0	1	4	0	0
23	33361310	.	C	T	6	3	9	0	1	10	0	0
23	33636203	.	C	T	3	2	5	0	0	5	0	0
23	33657205	.	A	G	16	14	30	0	2	32	0	0
23	33657451	.	A	G	11	18	29	0	3	32	0	0
23	33658013	.	T	G	4	11	15	0	5	20	0	0
23	33658031	.	A	C	9	12	21	0	0	21	0	0
23	33658052	.	G	A	7	8	15	0	1	16	0	0
23	33663285	.	C	T	11	7	18	0	0	18	0	0
23	33664546	.	C	T	7	12	19	0	2	21	0	0
23	33678530	.	G	A	5	5	10	0	0	10	0	0
23	34386119	.	T	C	2	2	4	0	0	4	0	0
23	34710333	.	C	T	10	3	13	0	3	16	0	0
23	34726384	.	A	G	6	0	6	0	4	10	0	0
23	34726387	.	A	G	6	4	10	0	1	11	0	0
23	34726438	.	T	C	6	4	10	0	0	10	0	0
23	34726444	.	G	T	6	3	9	0	1	10	0	0
23	34732871	.	A	G	8	1	9	0	3	12	0	0
23	34748833	.	G	A	1	8	9	0	4	13	0	0
23	34753803	.	A	G	7	9	16	0	3	19	0	0
23	35027189	.	T	C	1	4	5	0	0	5	0	0
23	35027386	.	T	G	6	3	9	0	0	9	0	0
23	35027480	.	T	G	6	5	11	0	0	11	0	0
23	35027518	.	T	A	6	2	8	0	1	9	0	0
23	35027541	.	A	G	6	5	11	0	0	11	0	0
23	35027736	.	C	G	4	11	15	0	0	15	0	0
23	35039803	.	C	T	3	7	10	0	0	10	0	0
23	35188562	.	G	A	2	4	6	0	0	6	0	0
23	35192697	.	G	T	2	2	4	0	0	4	0	0
23	35256186	.	G	A	1	2	3	0	0	3	0	0
23	35310779	.	G	A	1	4	5	0	1	6	0	0
23	35362951	.	C	T	5	11	16	0	1	17	0	0
23	35362973	.	G	T	8	8	16	0	0	16	0	0
23	35363024	.	A	T	9	6	15	0	1	16	0	0
23	35363067	.	A	T	6	4	10	0	6	16	0	0
23	35363106	.	G	A	15	9	24	0	0	24	0	0
23	35363111	.	C	G	16	9	25	0	0	25	0	0
23	35363226	.	T	C	9	0	9	0	18	27	0	0
23	35363341	.	A	G	12	8	20	0	0	20	0	0
23	35369733	.	G	A	6	7	13	0	1	14	0	0
23	35376893	.	A	G	1	3	4	0	0	4	0	0
23	35382971	.	C	T	2	2	4	0	0	4	0	0
23	35389118	.	C	T	3	2	5	0	0	5	0	0
23	35393459	.	A	G	4	4	8	0	0	8	0	0
23	35393473	.	G	T	4	4	8	0	1	9	0	0
23	35396735	.	C	A	5	4	9	0	0	9	0	0
23	35396791	.	C	A	1	6	7	0	0	7	0	0
23	35469135	.	T	C	1	4	5	0	0	5	0	0
23	35469136	.	G	A	1	4	5	0	0	5	0	0
23	35469479	.	A	G	7	9	16	0	1	17	0	0
23	35469668	.	G	T	9	9	18	0	1	19	0	0
23	35473640	.	A	G	6	8	14	0	0	14	0	0
23	35489123	.	A	G	1	2	3	0	0	3	0	0
23	35489927	.	A	G	1	2	3	0	0	3	0	0
23	35537291	.	T	A	4	5	9	0	1	10	0	0
23	35537293	.	A	G	4	5	9	0	1	10	0	0
23	35537390	.	C	T	20	5	25	0	0	25	0	0
23	35537398	.	A	G	18	7	25	0	1	26	0	0
23	35537474	.	G	A	14	3	17	0	1	18	0	0
23	35537482	.	C	T	13	5	18	0	1	19	0	0
23	35537599	.	G	A	10	5	15	0	2	17	0	0
23	35537617	.	G	A	7	6	13	0	1	14	0	0
23	35537693	.	A	C	5	3	8	0	1	9	0	0
23	35642327	.	T	G	5	7	12	0	0	12	0	0
23	35644234	.	C	T	4	7	11	0	0	11	0	0
23	35651790	.	T	C	1	3	4	0	1	5	0	0
23	35661380	.	C	T	4	2	6	0	0	6	0	0
23	35661530	.	T	C	5	2	7	0	0	7	0	0
23	35661549	.	A	C	2	3	5	0	0	5	0	0
23	35661572	.	A	C	1	5	6	0	0	6	0	0
23	35661723	.	A	C	2	3	5	0	0	5	0	0
23	35663421	.	T	G	3	3	6	0	1	7	0	0
23	35664298	.	A	G	5	2	7	0	0	7	0	0
23	35709839	.	T	C	21	15	36	15	1	52	0	0
23	35710179	.	A	C	52	13	65	5	1	71	0	0
23	35710620	.	A	C	24	29	53	1	3	58	1	0
23	35714883	.	T	C	5	3	8	23	0	31	0	0
23	35746233	.	A	G	1	1	2	0	0	2	0	0
23	35746236	.	C	T	1	2	3	0	0	3	0	0
23	35746290	.	A	G	1	1	2	0	1	3	0	0
23	35771483	.	T	C	6	9	15	0	1	16	0	0
23	35771486	.	T	C	7	9	16	0	0	16	0	0
23	35782311	.	T	C	8	6	14	0	1	15	0	0
23	35787299	.	A	C	3	2	5	1	0	6	0	0
23	35787331	.	T	G	3	3	6	0	0	6	0	0
23	35787573	.	A	G	3	3	6	0	0	6	0	0
23	35788256	.	G	A	3	7	10	0	1	11	0	0
23	35788328	.	G	A	5	6	11	0	1	12	0	0
23	35788505	.	C	T	3	2	5	0	1	6	0	0
23	35788513	.	G	A	3	2	5	0	0	5	0	0
23	35788775	.	G	A	4	2	6	0	0	6	0	0
23	35789898	.	A	G	2	3	5	0	0	5	0	0
23	35800550	.	C	T	1	11	12	0	16	28	0	0
23	35800591	.	C	T	14	12	26	0	0	26	0	0
23	35821401	.	C	T	3	6	9	0	0	9	0	0
23	35821403	.	C	T	0	6	6	0	3	9	0	0
23	35821442	.	T	A	3	4	7	0	0	7	0	0
23	35918697	.	A	T	3	2	5	0	0	5	0	0
23	35918795	.	G	A	3	2	5	0	0	5	0	0
23	35960683	.	G	A	12	12	24	0	0	24	0	0
23	35963076	.	G	T	1	11	12	0	11	23	0	0
23	35963176	.	T	G	9	10	19	0	1	20	0	0
23	35963316	.	C	T	6	4	10	0	0	10	0	0
23	35963322	.	T	G	6	4	10	0	0	10	0	0
23	35982441	.	A	G	6	8	14	0	1	15	0	0
23	35982533	.	G	A	6	10	16	0	1	17	0	0
23	35982637	.	G	A	4	6	10	0	0	10	0	0
23	35982726	.	C	G	11	7	18	3	0	21	0	0
23	35982755	.	T	C	7	8	15	1	0	16	0	0
23	35983029	.	A	G	18	7	25	0	3	28	0	0
23	35993540	.	T	A	10	4	14	0	3	17	0	0
23	35993793	.	T	C	13	10	23	0	0	23	0	0
23	36000704	.	T	C	4	0	4	0	7	11	0	0
23	36132338	.	C	A	8	9	17	0	0	17	0	0
23	36145470	.	G	A	0	2	2	0	1	3	0	0
23	36297367	.	C	T	5	4	9	0	2	11	0	0
23	36297471	.	C	T	12	6	18	0	1	19	0	0
23	36297916	.	C	T	7	4	11	0	1	12	0	0
23	36298320	.	T	A	19	17	36	0	3	39	0	0
23	36298327	.	A	T	14	22	36	0	1	37	0	0
23	36298375	.	T	C	19	23	42	0	0	42	0	0
23	36298719	.	G	A	17	20	37	0	5	42	0	0
23	36301544	.	G	A	15	10	25	0	0	25	0	0
23	36301679	.	A	G	21	20	41	0	2	43	0	0
23	36303266	.	G	C	12	14	26	0	0	26	0	0
23	36306566	.	G	T	0	8	8	0	7	15	0	0
23	36307656	.	A	T	19	20	39	0	2	41	0	0
23	36307779	.	C	T	16	14	30	0	2	32	0	0
23	36307906	.	C	G	6	12	18	3	0	21	0	0
23	36343467	.	T	C	15	13	28	0	1	29	0	0
23	36353698	.	A	G	28	13	41	0	1	42	0	0
23	36353869	.	C	G	11	14	25	0	1	26	0	0
23	36353876	.	G	T	2	8	10	0	15	26	1	0
23	36353979	.	G	T	1	4	5	0	15	20	0	0
23	36401926	.	T	C	5	5	10	0	0	10	0	0
23	36401930	.	A	G	6	4	10	0	0	10	0	0
23	36401986	.	G	C	5	2	7	0	0	7	0	0
23	36402184	.	A	G	3	5	8	0	0	8	0	0
23	36402256	.	A	C	1	2	3	0	1	4	0	0
23	36402274	.	T	C	1	3	4	0	0	4	0	0
23	36404898	.	C	G	3	4	7	0	0	7	0	0
23	36405429	.	A	G	3	4	7	0	0	7	0	0
23	36443511	.	A	T	9	4	13	0	2	15	0	0
23	36443813	.	C	T	2	4	6	0	0	6	0	0
23	36443865	.	C	A	3	5	8	0	0	8	0	0
23	36444201	.	G	C	6	0	6	0	7	13	0	0
23	36445967	.	C	G	6	7	13	0	0	13	0	0
23	36446023	.	G	A	7	3	10	0	0	10	0	0
23	36446132	.	A	G	1	2	3	0	0	3	0	0
23	36446190	.	A	T	4	4	8	0	0	8	0	0
23	36446258	.	T	C	4	0	4	0	3	7	0	0
23	36446271	.	C	T	7	4	11	0	1	12	0	0
23	36487865	.	C	T	3	2	5	0	0	5	0	0
23	36487925	.	A	T	4	2	6	0	1	7	0	0
23	36488378	.	G	C	3	6	9	0	0	9	0	0
23	36491169	.	C	G	2	6	8	0	10	18	0	0
23	36497530	.	A	T	3	2	5	0	0	5	0	0
23	36500273	.	G	A	3	3	6	0	0	6	0	0
23	36538298	.	G	A	2	2	4	0	0	4	0	0
23	36604488	.	G	A	7	7	14	0	0	14	0	0
23	36616998	.	C	T	9	12	21	0	1	22	0	0
23	36627793	.	C	T	10	11	21	1	1	23	0	0
23	36627859	.	G	C	17	7	24	0	2	26	0	0
23	36638542	.	G	A	8	13	21	0	2	23	0	0
23	36644423	.	T	G	27	19	46	0	3	49	0	0
23	36644907	.	C	T	20	9	29	0	2	31	0	0
23	36662097	.	A	G	3	4	7	0	0	7	0	0
23	36662098	.	C	G	0	4	4	0	3	7	0	0
23	36662174	.	T	G	4	2	6	0	0	6	0	0
23	36662175	.	T	G	4	2	6	0	0	6	0	0
23	36662273	.	G	A	6	3	9	0	0	9	0	0
23	36662327	.	T	A	2	2	4	0	1	5	0	0
23	36662651	.	G	C	2	3	5	0	0	5	0	0
23	36662685	.	C	A	6	2	8	0	0	8	0	0
23	36662714	.	G	A	5	3	8	0	0	8	0	0
23	36662772	.	A	T	4	2	6	0	0	6	0	0
23	36663346	.	G	A	1	3	4	0	0	4	0	0
23	36663407	.	G	A	2	6	8	0	0	8	0	0
23	36663506	.	C	A	0	3	3	0	3	6	0	0
23	36663512	.	C	T	0	3	3	0	3	6	0	0
23	36666666	.	A	G	4	1	5	0	1	6	0	0
23	36666669	.	A	G	4	1	5	0	1	6	0	0
23	36679751	.	C	T	18	19	37	0	2	39	0	0
23	36679829	.	G	C	25	0	25	0	20	45	0	0
23	36679874	.	T	C	20	1	21	0	25	46	0	0
23	36681545	.	C	T	1	18	19	0	22	41	0	0
23	36681557	.	A	G	18	17	35	0	4	39	0	0
23	36681927	.	T	C	15	21	36	0	1	37	0	0
23	36683801	.	G	A	11	23	34	1	3	38	0	0
23	36688236	.	T	C	22	0	22	0	18	40	0	0
23	36689677	.	C	T	6	18	24	0	0	24	0	0
23	36690595	.	G	A	14	12	26	0	0	26	0	0
23	36690641	.	T	A	14	9	23	0	2	25	0	0
23	36700836	.	T	G	14	8	22	0	1	23	0	0
23	36700891	.	G	A	16	15	31	0	3	34	0	0
23	36700896	.	T	A	18	17	35	0	2	37	0	0
23	36730854	.	A	T	6	5	11	0	1	12	0	0
23	36738776	.	C	T	9	10	19	0	1	20	0	0
23	36749380	.	G	A	2	28	30	0	19	49	0	0
23	36750005	.	C	G	14	13	27	0	1	28	0	0
23	36750440	.	A	T	2	2	4	0	0	4	0	0
23	36772018	.	G	A	0	12	12	0	10	22	0	0
23	36798184	.	C	T	14	15	29	0	0	29	0	0
23	36798220	.	G	A	13	17	30	0	1	31	0	0
23	36798612	.	G	A	0	21	21	0	11	32	0	0
23	36816573	.	A	G	3	2	5	0	0	5	0	0
23	36816698	.	G	T	3	5	8	0	0	8	0	0
23	36816840	.	C	T	3	7	10	0	1	11	0	0
23	36845672	.	G	A	3	2	5	0	1	6	0	0
23	36845687	.	G	A	2	2	4	0	0	4	0	0
23	36848586	.	G	A	1	2	3	0	0	3	0	0
23	36856155	.	T	A	1	2	3	0	0	3	0	0
23	36907624	.	G	A	3	8	11	0	0	11	0	0
23	36907690	.	A	G	4	3	7	0	0	7	0	0
23	36910155	.	G	A	5	5	10	0	0	10	0	0
23	36914223	.	A	G	4	3	7	0	1	8	0	0
23	36920063	.	C	T	1	2	3	0	1	4	0	0
23	36920076	.	C	G	0	1	1	0	3	4	0	0
23	37068571	.	T	C	7	7	14	0	1	15	0	0
23	37075407	.	C	T	5	3	8	0	0	8	0	0
23	37077689	.	A	C	2	3	5	0	0	5	0	0
23	37086288	.	A	C	5	4	9	0	0	9	0	0
23	37086368	.	G	A	5	3	8	0	0	8	0	0
23	37089102	.	G	A	5	8	13	0	0	13	0	0
23	37089162	.	C	T	6	15	21	0	0	21	0	0
23	37089192	.	C	T	4	11	15	0	1	16	0	0
23	37089333	.	C	T	2	7	9	0	0	9	0	0
23	37089609	.	T	G	9	7	16	0	0	16	0	0
23	37089852	.	A	T	16	11	27	0	0	27	0	0
23	37090003	.	T	C	2	13	15	0	1	16	0	0
23	37277157	.	A	G	11	9	20	0	0	20	0	0
23	37277289	.	G	A	13	10	23	0	0	23	0	0
23	37280658	.	C	T	16	10	26	0	1	27	0	0
23	37288130	.	T	C	1	0	1	0	2	3	0	0
23	37324009	.	A	G	10	1	11	1	15	27	0	0
23	37324638	.	A	C	16	23	39	0	0	39	0	0
23	37324848	.	G	A	15	14	29	2	2	33	0	0
23	37324868	.	G	C	16	11	27	2	2	31	0	0
23	37324990	.	A	G	22	21	43	0	1	44	0	0
23	37325026	.	C	T	25	12	37	0	1	38	0	0
23	37325138	.	T	G	23	0	23	0	14	37	0	0
23	37325570	.	A	C	19	20	39	0	2	41	0	0
23	37325817	.	T	G	17	10	27	0	1	28	0	0
23	37458666	.	G	T	1	5	6	0	0	6	0	0
23	37458748	.	G	A	7	12	19	0	0	20	1	0
23	37458791	.	A	T	7	19	26	0	2	28	0	0
23	37461642	.	T	C	13	13	26	0	1	27	0	0
23	37464452	.	A	G	7	7	14	0	1	15	0	0
23	37464621	.	A	G	7	3	10	0	0	10	0	0
23	37464661	.	T	A	8	2	10	0	0	11	1	0
23	37464760	.	G	C	1	5	6	0	5	11	0	0
23	37464804	.	C	A	7	5	12	0	0	12	0	0
23	37465007	.	T	C	7	5	12	0	1	13	0	0
23	37465257	.	A	G	8	0	8	0	4	12	0	0
23	37465276	.	A	T	7	4	11	0	1	12	0	0
23	37465332	.	A	T	9	4	13	0	1	14	0	0
23	37465414	.	G	A	8	4	12	0	2	14	0	0
23	37465479	.	G	C	8	11	19	0	0	19	0	0
23	37465505	.	A	G	5	12	17	0	3	20	0	0
23	37465527	.	A	G	10	8	18	0	1	19	0	0
23	37467109	.	A	G	4	0	4	0	4	8	0	0
23	37467115	.	A	G	5	0	5	0	3	8	0	0
23	37468225	.	T	C	4	5	9	0	0	9	0	0
23	37468267	.	C	T	3	9	12	0	0	12	0	0
23	37468393	.	A	G	1	3	4	0	1	5	0	0
23	37476475	.	T	C	9	11	20	0	0	20	0	0
23	37476675	.	G	A	1	6	7	0	4	11	0	0
23	37478227	.	G	T	3	6	9	0	0	9	0	0
23	37488582	.	A	C	3	2	5	0	0	5	0	0
23	37497367	.	A	T	1	3	4	0	0	4	0	0
23	37503288	.	A	G	4	4	8	0	0	8	0	0
23	37504900	.	A	G	3	3	6	0	0	6	0	0
23	37823651	.	T	A	3	3	6	0	0	6	0	0
23	37823704	.	A	G	6	3	9	0	0	9	0	0
23	37823710	.	T	C	5	3	8	0	0	8	0	0
23	37823795	.	T	C	2	3	5	0	0	5	0	0
23	37824108	.	G	T	2	2	4	0	0	4	0	0
23	37828884	.	A	G	1	2	3	0	0	3	0	0
23	37955083	.	C	T	1	3	4	0	0	4	0	0
23	37955662	.	G	C	0	4	4	0	3	7	0	0
23	37970998	.	C	T	3	2	5	0	0	5	0	0
23	38093419	.	G	A	1	2	3	2	0	5	0	0
23	38151520	.	C	T	13	12	25	0	0	25	0	0
23	38162798	.	A	C	1	2	3	0	0	3	0	0
23	38162799	.	A	T	1	2	3	0	0	3	0	0
23	38262180	.	G	A	2	2	4	0	0	4	0	0
23	38262647	.	G	A	4	3	7	0	0	7	0	0
23	38379786	.	C	T	1	11	12	0	19	31	0	0
23	38380005	.	C	T	12	21	33	0	1	34	0	0
23	38380047	.	G	A	9	22	31	0	1	32	0	0
23	38381217	.	C	T	0	8	8	0	9	17	0	0
23	38381281	.	T	C	5	7	12	0	1	13	0	0
23	38381316	.	T	C	9	0	9	0	9	18	0	0
23	38381490	.	G	A	3	6	9	0	0	9	0	0
23	38816824	.	T	C	3	6	9	0	0	9	0	0
23	38816827	.	T	C	3	5	8	0	0	8	0	0
23	38817049	.	A	G	1	2	3	0	0	3	0	0
23	38817350	.	T	G	3	3	6	0	0	6	0	0
23	38817509	.	T	C	1	2	3	0	1	4	0	0
23	38818067	.	A	T	4	3	7	0	0	7	0	0
23	38818094	.	G	A	4	2	6	0	1	7	0	0
23	38818249	.	G	T	2	5	7	0	1	8	0	0
23	38945690	.	A	G	1	2	3	0	0	3	0	0
23	39002515	.	G	A	0	2	2	0	1	3	0	0
23	39028513	.	C	T	4	2	6	0	0	6	0	0
23	39333284	.	C	T	1	3	4	0	0	4	0	0
23	39333291	.	T	C	1	3	4	0	0	4	0	0
23	39413176	.	C	T	4	3	7	0	0	7	0	0
23	39413341	.	A	C	3	4	7	0	0	7	0	0
23	39425547	.	G	A	5	2	7	0	0	7	0	0
23	39433818	.	C	T	6	3	9	0	0	9	0	0
23	39442965	.	C	T	3	3	6	0	0	6	0	0
23	39445059	.	A	G	2	0	2	1	2	5	0	0
23	39449770	.	C	G	7	4	11	0	1	12	0	0
23	39450022	.	A	G	7	4	11	0	0	11	0	0
23	39516525	.	T	C	1	2	3	0	0	3	0	0
23	39516528	.	T	C	0	2	2	0	1	3	0	0
23	39516572	.	C	A	2	3	5	0	1	6	0	0
23	39516810	.	T	A	3	4	7	0	0	7	0	0
23	39587272	.	T	C	2	3	5	0	0	5	0	0
23	39587284	.	G	C	5	2	7	0	0	7	0	0
23	39587323	.	A	G	5	0	5	0	3	8	0	0
23	39587347	.	G	T	5	3	8	0	0	8	0	0
23	39594141	.	C	T	2	2	4	0	0	4	0	0
23	39594211	.	A	G	4	1	5	0	7	12	0	0
23	39594962	.	C	T	2	2	4	0	0	4	0	0
23	39594993	.	A	G	3	0	3	0	2	5	0	0
23	39595026	.	A	G	1	2	3	0	0	3	0	0
23	39595159	.	G	A	0	3	3	0	5	8	0	0
23	39595297	.	G	T	3	4	7	0	0	7	0	0
23	39595974	.	C	T	5	5	10	0	0	10	0	0
23	39596028	.	C	T	2	2	4	0	0	4	0	0
23	39596919	.	G	A	1	3	4	0	8	12	0	0
23	39597119	.	G	T	2	8	10	0	2	12	0	0
23	39597309	.	G	A	1	4	5	0	11	16	0	0
23	39597566	.	T	C	3	6	9	0	1	10	0	0
23	39597657	.	A	T	2	4	6	1	1	8	0	0
23	39607494	.	G	T	3	2	5	0	0	5	0	0
23	39607505	.	T	G	2	3	5	0	0	5	0	0
23	39611787	.	G	T	0	4	4	0	9	13	0	0
23	39615660	.	C	T	2	6	8	0	0	8	0	0
23	39615706	.	C	A	2	2	4	0	0	4	0	0
23	39620973	.	A	G	1	0	1	0	3	4	0	0
23	39621173	.	G	C	3	7	10	0	0	10	0	0
23	39623042	.	G	A	0	10	10	0	12	22	0	0
23	39626230	.	G	C	9	6	15	0	1	16	0	0
23	39626311	.	C	T	12	7	19	0	0	19	0	0
23	39626395	.	C	T	12	5	17	0	0	17	0	0
23	39626525	.	G	A	5	4	9	0	2	11	0	0
23	39626554	.	G	A	3	4	7	0	1	8	0	0
23	39632901	.	A	G	3	6	9	0	1	10	0	0
23	39633114	.	C	T	2	8	10	0	13	23	0	0
23	39635959	.	C	T	0	6	6	0	9	15	0	0
23	39636079	.	G	T	7	2	9	0	0	9	0	0
23	39636181	.	C	T	2	5	7	0	4	11	0	0
23	39638480	.	A	G	2	2	4	0	1	5	0	0
23	39641840	.	G	A	2	3	5	0	0	5	0	0
23	39642002	.	C	T	0	2	2	0	3	5	0	0
23	39649499	.	C	A	1	3	4	0	0	4	0	0
23	39744501	.	A	G	10	5	15	0	1	16	0	0
23	39744788	.	T	A	13	0	13	0	1	14	0	0
23	39744943	.	A	T	27	10	37	0	2	39	0	0
23	39756650	.	G	A	1	3	4	0	0	4	0	0
23	39756666	.	A	G	3	6	9	0	0	9	0	0
23	39756775	.	T	G	9	9	18	0	2	20	0	0
23	39756864	.	T	C	14	6	20	0	3	23	0	0
23	39756917	.	C	A	10	4	14	0	2	16	0	0
23	39756958	.	A	G	8	10	18	0	0	18	0	0
23	39757017	.	A	G	4	8	12	0	0	12	0	0
23	39757562	.	T	C	2	3	5	0	0	5	0	0
23	39758527	.	C	A	3	6	9	0	0	9	0	0
23	39758980	.	T	C	1	5	6	0	0	6	0	0
23	39759044	.	C	T	1	3	4	0	0	4	0	0
23	39759290	.	A	C	2	2	4	0	0	4	0	0
23	39759344	.	A	C	5	1	6	0	4	10	0	0
23	39759355	.	T	C	4	1	5	0	6	11	0	0
23	39759400	.	T	C	4	0	4	0	10	14	0	0
23	39764804	.	G	A	6	4	10	0	1	11	0	0
23	39764906	.	C	T	6	2	8	0	2	10	0	0
23	39765105	.	G	A	6	12	18	0	0	18	0	0
23	39767894	.	A	G	7	16	23	0	1	24	0	0
23	39768001	.	T	G	5	7	12	0	1	13	0	0
23	39771935	.	C	T	4	6	10	0	0	10	0	0
23	39771972	.	A	T	4	8	12	0	0	12	0	0
23	39772002	.	C	T	3	8	11	0	0	11	0	0
23	39772035	.	G	A	2	3	5	0	1	6	0	0
23	39808332	.	G	A	16	8	24	0	0	24	0	0
23	39808337	.	G	C	14	12	26	1	1	28	0	0
23	39808439	.	A	G	21	20	41	0	6	47	0	0
23	39808644	.	A	C	23	17	40	0	1	41	0	0
23	39808705	.	A	G	14	19	33	0	0	33	0	0
23	39808818	.	T	G	10	7	17	7	1	25	0	0
23	39808824	.	G	A	11	2	13	0	1	14	0	0
23	39809381	.	A	T	14	6	20	13	3	36	0	0
23	39809437	.	A	G	13	13	26	1	1	28	0	0
23	39809454	.	T	G	14	10	24	2	1	27	0	0
23	39809876	.	C	T	1	15	16	3	9	28	0	0
23	39809908	.	C	A	7	6	13	11	0	24	0	0
23	39809911	.	T	C	6	7	13	12	0	25	0	0
23	39811187	.	C	T	0	5	5	0	10	15	0	0
23	39811191	.	C	A	11	6	17	0	0	17	0	0
23	39811242	.	T	C	14	7	21	0	3	24	0	0
23	39811324	.	A	G	12	10	22	0	2	24	0	0
23	39811401	.	T	C	8	6	14	0	0	14	0	0
23	39811548	.	A	G	7	3	10	0	0	10	0	0
23	39811587	.	G	A	4	2	6	0	0	6	0	0
23	39811612	.	T	C	4	7	11	0	0	11	0	0
23	39811647	.	C	G	5	9	14	0	1	15	0	0
23	39811741	.	G	A	10	7	17	0	0	17	0	0
23	39811956	.	T	A	14	5	19	1	0	20	0	0
23	39812003	.	A	G	9	8	17	1	1	19	0	0
23	39812131	.	T	C	4	11	15	0	2	17	0	0
23	39812142	.	C	G	4	12	16	0	2	18	0	0
23	39812482	.	G	A	3	4	7	0	1	8	0	0
23	39812535	.	T	C	8	8	16	0	0	16	0	0
23	39812608	.	C	T	0	13	13	0	6	19	0	0
23	39812633	.	A	T	9	11	20	0	0	20	0	0
23	39812643	.	C	T	1	11	12	0	9	21	0	0
23	39919571	.	T	C	3	3	6	0	0	6	0	0
23	39926437	.	T	C	4	3	7	0	0	7	0	0
23	39929955	.	G	A	8	3	11	0	0	11	0	0
23	39940362	.	A	G	1	2	3	0	0	3	0	0
23	39940473	.	A	C	7	3	10	0	0	10	0	0
23	39940504	.	T	G	5	4	9	0	1	10	0	0
23	39940519	.	G	T	4	6	10	0	0	10	0	0
23	39940575	.	G	C	2	4	6	0	0	6	0	0
23	39940577	.	G	A	2	4	6	0	0	6	0	0
23	40238136	.	C	T	1	2	3	0	0	3	0	0
23	40284703	.	C	T	1	3	4	0	0	4	0	0
23	40284741	.	G	A	2	2	4	0	0	4	0	0
23	40285389	.	A	C	1	2	3	0	0	3	0	0
23	40285390	.	A	C	1	2	3	0	0	3	0	0
23	40285775	.	T	A	1	4	5	0	0	5	0	0
23	40452660	.	A	T	5	6	11	0	1	12	0	0
23	40452667	.	T	C	7	8	15	0	0	15	0	0
23	40452735	.	G	T	12	6	18	0	0	18	0	0
23	40452739	.	G	C	2	5	7	0	11	18	0	0
23	40452793	.	A	G	6	5	11	0	0	11	0	0
23	40460860	.	G	C	6	6	12	0	0	12	0	0
23	40462004	.	A	G	2	6	8	0	1	9	0	0
23	40466320	.	C	T	13	4	17	0	3	20	0	0
23	40466623	.	C	G	5	4	9	0	1	10	0	0
23	40466714	.	T	A	10	6	16	0	1	17	0	0
23	40471895	.	G	T	11	7	18	0	1	19	0	0
23	40471897	.	C	A	13	6	19	0	1	20	0	0
23	40471963	.	G	A	1	11	12	0	17	29	0	0
23	40472068	.	A	G	12	0	12	0	10	22	0	0
23	40480255	.	C	A	14	5	19	0	0	19	0	0
23	40480263	.	C	T	14	6	20	0	0	20	0	0
23	40526745	.	G	T	8	7	15	2	0	17	0	0
23	40526760	.	G	A	15	5	20	2	0	22	0	0
23	40526883	.	T	G	11	6	17	0	0	17	0	0
23	40526926	.	G	A	10	3	13	0	0	13	0	0
23	40527583	.	G	A	2	3	5	4	0	9	0	0
23	40527632	.	G	A	3	3	6	7	0	13	0	0
23	40527653	.	T	G	3	3	6	6	0	12	0	0
23	40527759	.	G	T	7	4	11	0	0	11	0	0
23	40528019	.	C	T	9	4	13	0	0	13	0	0
23	40528172	.	T	C	2	0	2	0	4	6	0	0
23	40528182	.	T	C	1	0	1	0	4	5	0	0
23	40528209	.	C	T	5	4	9	0	0	9	0	0
23	40528226	.	G	C	3	4	7	1	1	9	0	0
23	40528392	.	T	C	5	0	5	1	2	8	0	0
23	40528397	.	A	G	4	3	7	1	0	8	0	0
23	40528427	.	C	T	5	3	8	1	0	9	0	0
23	40528669	.	C	T	1	10	11	0	5	16	0	0
23	40528727	.	G	A	6	18	24	0	0	24	0	0
23	40528886	.	T	A	14	8	22	0	0	22	0	0
23	40528998	.	G	A	8	11	19	0	2	21	0	0
23	40529137	.	T	C	4	12	16	0	0	16	0	0
23	40529288	.	T	C	2	7	9	0	1	10	0	0
23	40529318	.	A	G	5	6	11	0	1	12	0	0
23	40529693	.	T	C	7	3	10	0	1	11	0	0
23	40529708	.	T	C	7	4	11	0	1	12	0	0
23	40605356	.	C	T	2	2	4	0	0	4	0	0
23	40655425	.	A	G	1	3	4	0	0	4	0	0
23	40709943	.	A	G	3	0	3	0	5	8	0	0
23	40709944	.	C	T	4	2	6	0	2	8	0	0
23	40720324	.	G	A	0	3	3	0	2	5	0	0
23	40731757	.	A	G	1	4	5	0	0	5	0	0
23	40738508	.	A	G	1	3	4	0	0	4	0	0
23	40741673	.	A	G	1	8	9	0	0	9	0	0
23	40742067	.	G	A	0	5	5	0	4	9	0	0
23	40742145	.	A	G	4	0	4	0	5	9	0	0
23	40742236	.	G	C	6	6	12	0	0	12	0	0
23	40755895	.	C	G	1	2	3	0	0	3	0	0
23	40756296	.	A	C	5	6	11	0	0	11	0	0
23	40761073	.	T	A	6	4	10	0	1	11	0	0
23	40761326	.	T	A	4	6	10	0	1	11	0	0
23	40937583	.	G	T	3	2	5	0	0	5	0	0
23	40957904	.	C	G	2	2	4	0	0	4	0	0
23	40972121	.	G	A	1	2	3	0	3	6	0	0
23	40972205	.	A	T	4	5	9	0	2	11	0	0
23	41313116	.	G	C	7	7	14	0	0	14	0	0
23	41320957	.	G	A	2	4	6	0	0	6	0	0
23	41739874	.	C	A	2	5	7	0	1	8	0	0
23	41754587	.	A	G	2	2	4	0	0	4	0	0
23	41799849	.	C	A	6	4	10	0	0	10	0	0
23	41800953	.	T	C	0	2	2	0	1	3	0	0
23	41801492	.	C	T	15	12	27	0	2	29	0	0
23	41801555	.	G	A	12	15	27	0	0	27	0	0
23	41801940	.	G	T	15	17	32	0	2	34	0	0
23	41802130	.	T	G	10	17	27	0	0	27	0	0
23	41803017	.	G	A	4	6	10	0	0	10	0	0
23	41803124	.	G	T	8	9	17	0	2	19	0	0
23	41803217	.	T	C	5	0	5	0	11	16	0	0
23	41803447	.	G	A	8	9	17	0	2	19	0	0
23	41803473	.	A	G	10	10	20	0	2	22	0	0
23	41803643	.	G	C	6	5	11	0	0	11	0	0
23	41803672	.	C	T	5	3	8	0	0	8	0	0
23	41803740	.	A	G	5	8	13	0	2	15	0	0
23	41804039	.	A	G	1	5	6	0	0	6	0	0
23	41804070	.	C	T	2	6	8	0	0	8	0	0
23	41804202	.	T	A	3	5	8	0	0	8	0	0
23	41804287	.	C	A	1	3	4	0	0	4	0	0
23	41804304	.	T	A	2	1	3	0	0	3	0	0
23	41804326	.	C	A	1	3	4	0	0	4	0	0
23	41804340	.	A	T	1	2	3	0	0	3	0	0
23	41804518	.	A	C	3	8	11	0	0	11	0	0
23	41804600	.	T	A	5	8	13	0	2	15	0	0
23	41805158	.	C	T	7	8	15	0	0	15	0	0
23	41805348	.	G	A	6	10	16	0	0	16	0	0
23	41808038	.	G	A	1	6	7	0	0	7	0	0
23	41821117	.	G	C	2	2	4	0	2	6	0	0
23	41831305	.	T	A	8	9	17	0	0	17	0	0
23	41831306	.	C	T	8	8	16	0	1	17	0	0
23	41839373	.	G	A	1	10	11	0	9	20	0	0
23	41853782	.	T	C	6	6	12	0	1	13	0	0
23	41853876	.	T	C	10	4	14	0	0	14	0	0
23	41853892	.	A	T	12	5	17	0	0	17	0	0
23	41854068	.	G	T	14	5	19	0	0	19	0	0
23	41929478	.	G	A	0	2	2	0	1	3	0	0
23	41949585	.	A	C	1	6	7	0	0	7	0	0
23	41949602	.	T	G	1	5	6	0	0	6	0	0
23	41949748	.	T	G	4	2	6	0	0	6	0	0
23	41949751	.	A	G	4	3	7	0	0	7	0	0
23	41964709	.	G	A	2	3	5	0	0	5	0	0
23	42283476	.	A	G	7	4	11	0	0	11	0	0
23	42289260	.	C	A	4	3	7	0	1	8	0	0
23	42341744	.	T	C	1	2	3	1	0	4	0	0
23	42627748	.	A	T	3	2	5	0	0	5	0	0
23	42640138	.	T	G	3	7	10	0	1	11	0	0
23	42640631	.	C	T	2	2	4	0	0	4	0	0
23	42641879	.	T	C	6	5	11	0	1	12	0	0
23	42641921	.	T	C	8	3	11	0	0	11	0	0
23	42642044	.	G	A	17	6	23	0	1	24	0	0
23	42642207	.	G	C	1	2	3	0	17	20	0	0
23	42642211	.	A	C	2	0	2	0	20	22	0	0
23	42642361	.	G	A	13	4	17	0	6	23	0	0
23	42642897	.	A	T	5	4	9	0	0	9	0	0
23	42766311	.	T	A	1	3	4	0	0	4	0	0
23	42766555	.	T	C	1	0	1	0	4	5	0	0
23	42766561	.	T	C	3	0	3	0	3	6	0	0
23	42766607	.	G	A	4	3	7	0	0	7	0	0
23	42766609	.	A	T	4	3	7	0	0	7	0	0
23	42766656	.	A	G	2	4	6	1	0	7	0	0
23	42766672	.	C	T	0	4	4	1	2	7	0	0
23	42766709	.	G	A	5	5	10	0	0	10	0	0
23	42766720	.	A	G	5	2	7	0	0	7	0	0
23	43508528	.	A	G	1	1	2	0	2	4	0	0
23	43517448	.	G	A	3	2	5	0	0	5	0	0
23	43517458	.	A	G	4	2	6	0	0	6	0	0
23	43519354	.	C	G	3	3	6	0	1	7	0	0
23	43559313	.	T	C	1	0	1	0	4	5	0	0
23	43642345	.	A	G	1	0	1	0	2	3	0	0
23	43649431	.	T	C	3	3	6	0	0	6	0	0
23	43650505	.	T	A	10	4	14	0	0	14	0	0
23	43652819	.	T	C	3	5	8	0	0	8	0	0
23	43652912	.	G	T	1	2	3	0	3	6	0	0
23	43688078	.	C	T	2	3	5	0	0	5	0	0
23	43688737	.	G	A	4	6	10	0	0	10	0	0
23	43688810	.	T	C	4	3	7	0	0	7	0	0
23	43688838	.	C	A	3	5	8	0	0	8	0	0
23	43689026	.	A	T	2	2	4	0	1	5	0	0
23	43689034	.	C	G	4	1	5	0	0	5	0	0
23	43689202	.	T	C	1	6	7	0	0	7	0	0
23	43689621	.	C	G	2	0	2	0	2	4	0	0
23	43690394	.	A	G	3	3	6	0	0	6	0	0
23	43690506	.	C	A	1	5	6	0	0	6	0	0
23	43690629	.	C	G	3	0	3	0	4	7	0	0
23	43690715	.	T	C	4	4	8	0	0	8	0	0
23	43690762	.	C	A	2	3	5	0	0	5	0	0
23	43690838	.	A	G	3	3	6	0	0	6	0	0
23	43691045	.	T	C	3	4	7	0	0	7	0	0
23	43691069	.	G	A	3	3	6	0	0	6	0	0
23	43691117	.	T	G	5	7	12	0	0	12	0	0
23	43691336	.	T	G	1	3	4	0	0	4	0	0
23	43691595	.	A	G	1	2	3	0	0	3	0	0
23	43695927	.	C	A	2	6	8	0	8	17	1	0
23	43696095	.	G	A	20	18	38	0	0	38	0	0
23	43696211	.	G	T	23	20	43	1	0	44	0	0
23	43696355	.	G	A	20	20	40	0	1	41	0	0
23	43699846	.	A	G	20	18	38	0	2	40	0	0
23	43700064	.	T	C	14	0	14	0	15	29	0	0
23	43700114	.	G	A	10	18	28	0	0	28	0	0
23	43700121	.	G	A	9	19	28	0	0	28	0	0
23	43705961	.	G	T	17	16	33	0	2	35	0	0
23	43706003	.	A	G	19	16	35	0	0	35	0	0
23	43706102	.	T	G	12	16	28	0	0	29	1	0
23	43713602	.	A	G	8	8	16	0	1	17	0	0
23	43713692	.	T	A	4	3	7	0	1	8	0	0
23	43718169	.	T	A	3	6	9	0	0	9	0	0
23	43718185	.	T	A	3	6	9	0	0	9	0	0
23	43718225	.	G	A	1	5	6	0	3	9	0	0
23	43718257	.	G	T	5	2	7	0	0	7	0	0
23	43718947	.	A	G	3	2	5	0	1	6	0	0
23	43719866	.	T	C	3	3	6	0	0	6	0	0
23	43719875	.	G	A	0	3	3	0	4	7	0	0
23	43723615	.	G	A	12	6	18	0	1	19	0	0
23	43723633	.	C	T	11	9	20	0	1	21	0	0
23	43723765	.	C	T	2	5	7	0	0	7	0	0
23	43770210	.	C	T	5	6	11	0	1	12	0	0
23	43770240	.	A	C	8	7	15	0	2	17	0	0
23	43770279	.	A	T	6	3	9	0	0	9	0	0
23	43770360	.	A	T	8	3	11	0	2	13	0	0
23	43770414	.	T	C	9	3	12	0	1	13	0	0
23	43770433	.	T	C	8	4	12	0	0	12	0	0
23	43770467	.	T	C	8	5	13	0	0	13	0	0
23	43770583	.	C	A	8	8	16	0	0	16	0	0
23	43770634	.	G	C	7	7	14	0	0	15	1	0
23	43770832	.	T	C	11	6	17	0	0	17	0	0
23	43778396	.	T	G	11	9	20	0	1	21	0	0
23	43780214	.	C	T	5	11	16	0	0	16	0	0
23	43781781	.	C	T	3	8	11	0	1	12	0	0
23	43784985	.	C	T	12	8	20	0	1	21	0	0
23	43799463	.	T	C	1	3	4	0	0	4	0	0
23	43799542	.	G	C	2	6	8	0	0	8	0	0
23	43799598	.	G	C	0	3	3	0	1	4	0	0
23	43800594	.	C	T	3	2	5	0	0	5	0	0
23	43800684	.	G	A	0	3	3	0	1	4	0	0
23	43800701	.	T	C	2	2	4	0	0	4	0	0
23	43800723	.	G	A	0	3	3	0	2	5	0	0
23	43800747	.	A	C	1	2	3	0	1	4	0	0
23	43800912	.	C	T	1	2	3	0	1	4	0	0
23	43800983	.	G	A	1	2	3	0	0	3	0	0
23	43801018	.	A	G	2	1	3	0	1	4	0	0
23	43801284	.	C	G	3	1	4	0	2	6	0	0
23	43802158	.	A	T	3	2	5	0	0	5	0	0
23	43830137	.	T	A	2	2	4	0	0	4	0	0
23	43830408	.	C	T	3	2	5	0	0	5	0	0
23	43876158	.	A	C	4	3	7	0	0	7	0	0
23	43876163	.	T	G	4	0	4	0	3	7	0	0
23	43889641	.	T	C	1	4	5	0	0	5	0	0
23	43897047	.	G	A	3	3	6	0	1	7	0	0
23	43928824	.	A	G	1	3	4	0	0	4	0	0
23	44521330	.	A	G	10	6	16	0	0	16	0	0
23	45588485	.	A	G	5	2	7	0	0	7	0	0
24	20740	.	C	G	2	0	2	0	4	6	0	0
24	24470	.	T	C	5	11	16	0	0	16	0	0
24	24473	.	C	T	4	11	15	0	0	15	0	0
24	24765	.	A	T	7	4	11	0	0	11	0	0
24	25774	.	G	A	0	2	2	0	2	4	0	0
24	26103	.	C	T	9	6	15	0	0	15	0	0
24	44306	.	C	T	15	7	22	0	2	24	0	0
24	83308	.	C	T	1	2	3	0	0	3	0	0
24	83933	.	A	G	3	0	3	0	2	5	0	0
24	166969	.	T	G	3	4	7	0	0	7	0	0
24	167149	.	A	T	7	14	21	0	0	21	0	0
24	167177	.	A	G	8	10	18	0	0	18	0	0
24	174353	.	A	G	11	1	12	0	12	24	0	0
24	178693	.	G	A	11	12	23	0	0	23	0	0
24	184800	.	A	G	10	0	10	0	26	36	0	0
24	184818	.	C	T	14	20	34	0	1	35	0	0
24	187371	.	T	A	14	13	27	0	2	29	0	0
24	187414	.	T	A	14	7	21	0	1	22	0	0
24	187539	.	A	G	10	7	17	0	0	17	0	0
24	187540	.	A	G	5	11	16	0	1	17	0	0
24	187686	.	T	A	10	8	18	0	1	20	1	0
24	187787	.	C	T	8	11	19	0	2	21	0	0
24	187811	.	A	T	5	9	14	0	2	16	0	0
24	187946	.	A	G	7	3	10	0	0	10	0	0
24	187971	.	A	G	6	1	7	0	3	10	0	0
24	188155	.	C	G	11	6	17	0	0	17	0	0
24	188191	.	T	A	14	4	18	0	0	18	0	0
24	188199	.	A	G	14	5	19	0	3	22	0	0
24	188363	.	G	A	20	9	29	0	1	30	0	0
24	188382	.	G	A	2	10	12	0	17	29	0	0
24	188423	.	T	C	17	23	40	0	0	40	0	0
24	188425	.	A	T	15	23	38	0	2	40	0	0
24	188464	.	T	C	14	24	38	0	4	42	0	0
24	196679	.	G	A	7	8	15	0	0	15	0	0
24	197062	.	C	T	12	7	19	0	0	19	0	0
24	197072	.	C	T	0	7	7	0	10	17	0	0
24	788343	.	A	G	6	10	16	0	1	17	0	0
24	788384	.	A	G	3	8	11	0	0	11	0	0
24	788409	.	A	G	6	1	7	0	4	11	0	0
24	788419	.	A	G	7	0	7	0	4	11	0	0
24	945478	.	C	T	2	3	5	0	3	8	0	0
24	945494	.	G	C	6	0	6	0	1	7	0	0
24	945706	.	T	C	21	8	29	0	1	30	0	0
24	947503	.	G	C	5	6	11	0	0	11	0	0
24	947518	.	C	T	2	6	8	1	3	12	0	0
24	947611	.	C	T	4	9	13	0	7	20	0	0
24	947680	.	T	C	17	4	21	0	7	28	0	0
24	947957	.	C	A	4	5	9	0	6	15	0	0
24	947984	.	G	C	5	8	13	0	0	13	0	0
24	948080	.	A	G	5	3	8	0	1	9	0	0
24	948313	.	C	A	4	4	8	0	9	17	0	0
24	948360	.	A	G	3	3	6	0	4	10	0	0
24	948438	.	T	C	13	3	16	0	9	25	0	0
24	948466	.	C	G	10	11	21	0	5	26	0	0
24	948503	.	C	T	12	10	22	0	9	31	0	0
24	948565	.	T	C	16	3	19	0	6	25	0	0
24	948571	.	G	A	15	7	22	0	0	22	0	0
24	948806	.	G	A	8	10	18	0	0	18	0	0
24	948848	.	C	T	0	8	8	0	8	16	0	0
24	948868	.	T	C	7	9	16	0	0	16	0	0
24	985094	.	A	T	11	5	16	0	3	19	0	0
24	985740	.	C	G	10	10	20	0	0	20	0	0
24	988373	.	A	C	6	0	6	0	12	18	0	0
24	994885	.	T	C	7	0	7	1	7	15	0	0
24	1000112	.	G	A	3	10	13	0	0	13	0	0
24	1002664	.	T	C	6	12	18	0	0	18	0	0
24	1002757	.	T	C	6	6	12	0	1	13	0	0
24	1003494	.	C	T	1	8	9	0	4	13	0	0
24	1003551	.	C	A	0	11	11	0	7	18	0	0
24	1009078	.	A	G	4	9	13	0	1	14	0	0
24	1009381	.	C	A	0	3	3	0	2	5	0	0
24	1009978	.	A	C	2	1	3	0	4	7	0	0
24	1010167	.	A	G	3	4	7	0	1	8	0	0
24	1010168	.	G	A	4	4	8	0	0	8	0	0
24	1011355	.	A	T	1	2	3	0	0	3	0	0
24	1011439	.	T	C	4	4	8	0	0	8	0	0
24	1012101	.	A	T	2	4	6	0	0	6	0	0
24	1012613	.	C	G	3	2	5	0	0	5	0	0
24	1013290	.	G	C	1	4	5	0	0	6	1	0
24	1013303	.	G	A	2	3	5	0	1	6	0	0
24	1013421	.	G	A	2	2	4	0	0	4	0	0
24	1013531	.	G	A	1	3	4	0	0	4	0	0
24	1013559	.	T	G	3	2	5	0	0	5	0	0
24	1013847	.	T	A	1	3	4	0	0	4	0	0
24	1013861	.	A	G	1	4	5	0	0	5	0	0
24	1014681	.	T	A	4	2	6	0	0	6	0	0
24	1014745	.	A	T	4	2	6	0	1	7	0	0
24	1015029	.	C	T	0	2	2	0	2	4	0	0
24	1015292	.	T	C	7	0	7	0	18	25	0	0
24	1018672	.	T	C	17	1	18	0	19	37	0	0
24	1021216	.	T	G	21	6	27	1	0	28	0	0
24	1021222	.	A	G	19	6	25	1	0	26	0	0
24	1110150	.	T	C	2	11	13	0	0	13	0	0
24	1110152	.	T	A	1	10	11	0	2	13	0	0
24	1110227	.	G	A	8	10	18	0	0	18	0	0
24	1110325	.	C	A	3	4	7	0	0	7	0	0
24	1110595	.	G	C	5	2	7	0	0	7	0	0
24	1110601	.	G	A	5	3	8	0	0	8	0	0
24	1111076	.	G	A	2	3	5	0	0	5	0	0
24	1111102	.	G	T	2	6	8	0	0	8	0	0
24	1111571	.	T	A	3	3	6	0	1	7	0	0
24	1111572	.	G	T	3	4	7	0	0	7	0	0
24	1111712	.	A	G	1	3	4	0	0	4	0	0
24	1111717	.	T	C	1	3	4	0	0	4	0	0
24	1111857	.	C	T	2	2	4	0	0	4	0	0
24	1111905	.	C	A	2	3	5	0	0	5	0	0
24	1111910	.	T	C	1	4	5	0	0	5	0	0
24	1112087	.	T	G	1	2	3	0	0	3	0	0
24	1113010	.	T	G	4	0	4	0	0	4	0	0
24	1113025	.	T	C	4	3	7	0	0	7	0	0
24	1163061	.	G	A	19	10	29	0	1	30	0	0
24	1165052	.	A	G	20	21	41	0	0	41	0	0
24	1166957	.	G	A	11	6	17	0	3	20	0	0
24	1166975	.	T	C	12	10	22	0	2	24	0	0
24	1167496	.	G	A	12	10	22	1	2	25	0	0
24	1167506	.	G	A	13	10	23	1	2	26	0	0
24	1169291	.	C	T	2	17	19	1	16	36	0	0
24	1177074	.	T	A	20	15	35	1	0	36	0	0
24	1185142	.	G	A	8	8	16	0	0	16	0	0
24	1185271	.	G	A	5	9	14	0	0	14	0	0
24	1203471	.	A	T	4	8	12	0	1	13	0	0
24	1203573	.	A	G	11	10	21	1	0	22	0	0
24	1221280	.	C	T	1	12	13	0	8	21	0	0
24	1229646	.	G	C	12	0	12	0	11	23	0	0
24	1229683	.	G	C	9	12	21	0	1	22	0	0
24	1236358	.	A	G	7	8	15	0	0	15	0	0
24	1301258	.	C	T	4	7	11	0	0	11	0	0
24	1303892	.	A	G	6	6	12	0	0	12	0	0
24	2284456	.	A	T	13	13	26	0	3	29	0	0
24	2284526	.	T	C	10	0	10	0	19	29	0	0
24	2284647	.	C	T	3	21	24	0	10	34	0	0
24	2290232	.	T	C	14	0	14	0	8	22	0	0
24	2297093	.	T	A	7	7	14	0	1	15	0	0
24	2297117	.	A	G	7	6	13	0	2	15	0	0
24	2303784	.	C	T	7	6	13	0	0	13	0	0
24	2307342	.	C	T	6	4	10	0	1	11	0	0
24	2308075	.	A	G	2	2	4	0	0	4	0	0
24	2308122	.	T	G	2	2	4	0	0	4	0	0
24	2322219	.	C	T	2	2	4	0	0	4	0	0
24	2322475	.	T	C	3	2	5	0	1	6	0	0
24	2322519	.	A	G	1	3	4	0	0	4	0	0
24	2327254	.	A	G	1	1	2	0	2	4	0	0
24	2331198	.	G	A	1	5	6	0	0	6	0	0
24	2331330	.	A	G	2	0	2	0	2	4	0	0
24	2333751	.	C	T	1	1	2	0	1	3	0	0
24	2333811	.	C	T	3	3	6	0	1	7	0	0
24	2333841	.	T	C	1	4	5	0	1	6	0	0
24	2336243	.	G	A	1	3	4	0	1	5	0	0
24	2340671	.	A	T	1	4	5	0	0	5	0	0
24	2346825	.	A	T	2	4	6	0	0	6	0	0
24	2346826	.	A	T	2	2	4	0	2	6	0	0
24	2347647	.	C	T	1	2	3	0	0	3	0	0
24	3471183	.	T	C	4	5	9	0	0	9	0	0
24	5653468	.	C	T	5	3	8	0	0	8	0	0
24	6011063	.	G	T	2	2	4	0	1	5	0	0
24	7306440	.	C	A	8	3	11	0	0	11	0	0
24	7306441	.	A	G	8	3	11	0	0	11	0	0
24	7942785	.	T	C	6	0	6	0	8	14	0	0
24	7942865	.	T	C	5	0	5	0	4	9	0	0
24	7942873	.	T	C	5	2	7	0	0	7	0	0
24	8861521	.	G	C	9	3	12	0	0	12	0	0
24	8861821	.	A	G	4	2	6	0	0	6	0	0
24	8862103	.	C	T	1	2	3	0	0	3	0	0
24	8863082	.	A	G	2	3	5	0	0	5	0	0
24	8863085	.	T	C	2	2	4	0	0	4	0	0
24	8906130	.	A	T	2	3	5	0	0	5	0	0
24	8968808	.	G	A	0	4	4	0	7	11	0	0
24	8979615	.	C	G	2	4	6	0	0	6	0	0
24	8979618	.	G	A	1	4	5	0	0	5	0	0
24	8979708	.	C	T	0	15	15	0	8	23	0	0
24	8979937	.	G	A	5	4	9	0	1	10	0	0
24	8980026	.	T	A	2	2	4	0	0	4	0	0
24	8980027	.	A	T	2	2	4	0	0	4	0	0
24	8980122	.	G	A	2	5	7	0	1	8	0	0
24	8988945	.	G	C	5	2	7	0	9	16	0	0
24	8999699	.	T	A	2	5	7	0	0	7	0	0
24	9250601	.	C	T	1	2	3	0	0	3	0	0
24	9269953	.	G	A	3	3	6	0	0	6	0	0
24	9288553	.	T	G	3	1	4	0	12	16	0	0
24	9288889	.	G	T	17	15	32	0	1	33	0	0
24	9293831	.	A	G	10	5	15	0	0	15	0	0
24	9612595	.	C	T	1	2	3	0	0	3	0	0
24	9619638	.	A	C	1	2	3	0	0	3	0	0
24	9673517	.	T	G	4	5	9	1	3	13	0	0
24	9673525	.	C	A	7	5	12	1	1	14	0	0
24	9673568	.	G	T	11	10	21	0	1	22	0	0
24	9676144	.	T	C	12	10	22	0	0	22	0	0
24	9683072	.	G	A	10	4	14	1	2	17	0	0
24	9683376	.	A	G	10	5	15	0	0	15	0	0
24	9689613	.	G	T	3	4	7	0	0	7	0	0
24	9702150	.	C	T	3	2	5	0	0	5	0	0
24	9707007	.	G	C	2	2	4	0	0	4	0	0
24	9709073	.	G	A	1	2	3	0	0	3	0	0
24	9714103	.	C	G	2	2	4	0	0	4	0	0
24	9714155	.	C	T	2	6	8	0	0	8	0	0
24	9717383	.	C	T	1	3	4	0	0	4	0	0
24	9723636	.	C	T	2	4	6	0	0	6	0	0
24	9723677	.	G	C	2	4	6	0	0	6	0	0
24	9724925	.	A	G	1	5	6	0	0	6	0	0
24	9726828	.	C	G	5	2	7	0	0	7	0	0
24	9729835	.	T	C	3	2	5	0	0	5	0	0
24	9730098	.	G	A	4	4	8	0	0	8	0	0
24	9732066	.	T	A	4	4	8	0	1	9	0	0
24	9732132	.	T	C	3	4	7	0	1	8	0	0
24	9732183	.	A	T	3	5	8	0	0	8	0	0
24	9734938	.	G	A	6	2	8	0	0	8	0	0
24	9744227	.	G	A	4	7	11	0	0	11	0	0
24	9744236	.	G	A	0	7	7	0	6	13	0	0
24	9746304	.	C	T	3	2	5	0	0	5	0	0
24	9865836	.	G	A	0	8	8	0	6	14	0	0
24	9866192	.	A	T	4	8	12	0	1	13	0	0
24	9866270	.	G	A	6	6	12	0	0	12	0	0
24	9866562	.	A	T	4	13	17	0	2	19	0	0
24	9866623	.	G	T	10	10	20	0	1	21	0	0
24	9866721	.	C	T	10	4	14	0	0	14	0	0
24	9867105	.	T	A	4	13	17	0	3	20	0	0
24	10270447	.	T	C	1	2	3	0	0	3	0	0
24	10303297	.	T	C	4	2	6	0	0	6	0	0
24	10309119	.	G	C	0	3	3	0	9	12	0	0
24	10309244	.	G	A	2	3	5	0	0	5	0	0
24	10309454	.	C	T	2	7	9	0	0	9	0	0
24	10309611	.	G	T	3	4	7	0	0	7	0	0
24	10314437	.	T	A	1	2	3	0	0	3	0	0
24	10332172	.	C	T	1	2	3	0	0	3	0	0
24	10338272	.	C	T	1	1	2	0	1	3	0	0
24	10349671	.	C	T	2	3	5	0	1	6	0	0
24	10349818	.	G	A	3	2	5	0	0	5	0	0
24	10349865	.	T	G	2	7	9	0	0	9	0	0
24	10349898	.	T	C	2	7	9	0	0	9	0	0
24	10350089	.	T	A	1	3	4	0	1	5	0	0
24	10350135	.	A	T	3	3	6	0	0	6	0	0
24	10356563	.	G	A	2	4	6	0	2	8	0	0
24	10368855	.	G	A	4	2	6	0	0	6	0	0
24	10376840	.	G	A	1	3	4	0	0	4	0	0
24	10376984	.	G	A	2	3	5	0	0	5	0	0
24	10394079	.	A	C	1	3	4	0	0	4	0	0
24	10394180	.	T	C	3	2	5	0	0	5	0	0
24	10394181	.	C	T	3	2	5	0	0	5	0	0
24	10413706	.	T	C	2	5	7	0	0	7	0	0
24	10414439	.	G	T	1	7	8	0	8	16	0	0
24	10415193	.	A	G	8	10	18	0	3	21	0	0
24	10415324	.	G	A	9	7	16	1	0	17	0	0
24	10415424	.	A	C	8	13	21	0	1	22	0	0
24	10415487	.	G	A	2	10	12	0	10	22	0	0
24	10464409	.	C	T	3	2	5	0	1	6	0	0
24	10828512	.	A	G	3	10	13	0	2	15	0	0
24	10897254	.	G	A	9	4	13	0	1	14	0	0
24	10897340	.	C	A	2	5	7	0	0	7	0	0
24	10901467	.	A	C	4	5	9	0	1	10	0	0
24	10901696	.	C	G	22	30	52	0	3	55	0	0
24	10901759	.	G	T	31	14	45	0	2	47	0	0
24	10901946	.	C	T	15	15	30	0	3	33	0	0
24	10902065	.	T	G	12	13	25	0	2	27	0	0
24	10902268	.	G	A	8	15	23	0	2	25	0	0
24	10902688	.	G	A	25	16	41	0	2	43	0	0
24	10907000	.	T	C	12	19	31	0	0	31	0	0
24	10907473	.	C	T	24	10	34	0	5	39	0	0
24	10907587	.	G	T	16	21	37	0	0	37	0	0
24	10915813	.	A	G	15	13	28	0	2	30	0	0
24	10917040	.	C	T	16	18	34	0	2	36	0	0
24	10917046	.	C	T	0	13	13	0	21	34	0	0
24	10917238	.	C	T	18	11	29	0	0	29	0	0
24	10919519	.	A	G	6	10	16	0	0	16	0	0
24	10919563	.	G	T	5	5	10	0	1	11	0	0
24	10924880	.	C	T	7	10	17	0	2	19	0	0
24	10924912	.	C	T	14	7	21	0	0	21	0	0
24	10924930	.	T	A	10	5	15	0	3	18	0	0
24	10944579	.	T	A	11	5	16	0	0	16	0	0
24	10961510	.	T	C	6	8	14	0	0	14	0	0
24	10971160	.	G	A	5	2	7	0	0	7	0	0
24	11086887	.	C	A	2	16	18	0	1	19	0	0
24	11113648	.	T	A	4	2	6	0	1	7	0	0
24	17020761	.	T	A	4	3	7	0	0	7	0	0
24	17020764	.	A	T	4	3	7	0	0	7	0	0
24	17214629	.	T	C	15	15	30	0	3	33	0	0
24	17214746	.	C	T	13	8	21	1	0	22	0	0
24	17404222	.	A	G	8	3	11	0	1	12	0	0
24	18521384	.	T	A	7	3	10	0	2	12	0	0
24	19402231	.	G	A	0	5	5	0	6	11	0	0
24	19656939	.	G	A	0	2	2	0	1	3	0	0
24	19696794	.	C	G	3	2	5	0	0	5	0	0
24	19697387	.	A	G	7	3	10	0	1	11	0	0
24	19707838	.	G	A	13	13	26	0	0	26	0	0
24	19711455	.	A	G	8	10	18	0	0	18	0	0
24	19711576	.	G	T	14	9	23	0	1	24	0	0
24	19719122	.	G	A	10	8	18	0	0	18	0	0
24	19719189	.	G	T	3	5	8	0	3	11	0	0
24	20064232	.	G	A	8	7	15	0	1	16	0	0
24	20064504	.	G	A	6	2	8	0	0	8	0	0
24	20064924	.	A	G	8	10	18	0	0	18	0	0
24	20064988	.	A	C	9	4	13	0	0	13	0	0
24	20065021	.	T	C	6	0	6	0	4	10	0	0
24	20065481	.	T	C	1	2	3	0	0	3	0	0
24	20065688	.	T	A	3	5	8	0	0	8	0	0
24	20066021	.	T	C	4	4	8	0	0	8	0	0
24	20072399	.	G	A	9	1	10	0	1	11	0	0
24	20072405	.	G	A	8	2	10	0	1	11	0	0
24	20082881	.	T	C	3	6	9	0	0	9	0	0
24	20191628	.	A	G	0	2	2	0	1	3	0	0
24	20192418	.	A	G	1	2	3	0	0	3	0	0
24	20194372	.	T	C	3	2	5	0	0	5	0	0
24	20199122	.	A	C	4	4	8	0	0	8	0	0
24	20200528	.	A	G	5	6	11	0	0	11	0	0
24	20200540	.	T	C	4	6	10	0	0	10	0	0
24	20208353	.	A	G	2	9	11	0	0	11	0	0
24	20214496	.	T	C	2	2	4	0	0	4	0	0
24	20325475	.	G	A	1	2	3	0	3	6	0	0
24	20325754	.	G	A	4	5	9	0	1	10	0	0
24	20328567	.	G	C	5	10	15	0	0	15	0	0
24	20328609	.	G	A	6	10	16	0	0	16	0	0
24	20329346	.	A	T	3	11	14	0	0	14	0	0
24	20334386	.	C	T	3	2	5	0	0	5	0	0
24	20450191	.	A	G	12	9	21	0	0	21	0	0
24	20450270	.	G	C	6	6	12	0	0	12	0	0
24	20450417	.	C	G	12	4	16	0	1	17	0	0
24	20450467	.	C	G	8	7	15	0	0	15	0	0
24	20450672	.	C	G	12	10	22	0	2	24	0	0
24	20450843	.	A	C	15	0	15	0	7	23	1	0
24	20470788	.	A	G	10	11	21	0	0	21	0	0
24	20531566	.	C	T	6	7	13	0	2	15	0	0
24	20531692	.	C	A	6	6	12	0	0	12	0	0
24	20536292	.	A	G	3	3	6	0	0	6	0	0
24	20537515	.	A	T	5	2	7	0	0	7	0	0
24	20537554	.	C	A	5	4	9	0	0	9	0	0
24	20541421	.	C	T	5	3	8	0	1	9	0	0
24	20542972	.	T	C	9	7	16	0	1	17	0	0
24	20554857	.	G	T	7	9	16	0	2	18	0	0
24	20554858	.	T	G	9	9	18	0	1	19	0	0
24	20589791	.	G	A	7	5	12	0	0	12	0	0
24	20591775	.	G	A	4	4	8	0	1	9	0	0
24	20600589	.	A	C	1	2	3	0	0	3	0	0
24	20628266	.	T	C	2	2	4	0	0	4	0	0
24	20644356	.	C	T	18	17	35	0	1	36	0	0
24	20645858	.	A	T	20	16	36	0	0	36	0	0
24	20646694	.	G	A	10	6	16	0	0	16	0	0
24	20648945	.	T	C	9	9	18	0	1	19	0	0
24	20649013	.	T	C	7	15	22	0	2	24	0	0
24	20658421	.	T	G	3	3	6	0	0	6	0	0
24	20658427	.	T	A	1	3	4	0	0	4	0	0
24	20664650	.	C	G	2	0	2	0	3	5	0	0
24	20708388	.	A	G	3	4	7	0	0	7	0	0
24	20708517	.	G	A	1	4	5	0	0	5	0	0
24	20893161	.	C	T	3	3	6	0	0	6	0	0
24	20893389	.	A	G	5	4	9	0	0	9	0	0
24	20895308	.	A	G	1	2	3	0	0	3	0	0
24	20897560	.	T	C	2	2	4	0	0	4	0	0
24	20897561	.	G	T	2	2	4	0	0	4	0	0
24	20899964	.	A	T	2	2	4	0	0	4	0	0
24	20900032	.	G	T	1	2	3	0	0	3	0	0
24	20902184	.	C	T	4	3	7	0	1	8	0	0
24	20902188	.	C	T	0	3	3	0	5	8	0	0
24	20916772	.	A	T	1	3	4	0	0	4	0	0
24	20916788	.	A	G	3	6	9	0	0	9	0	0
24	20916874	.	A	T	4	4	8	0	0	8	0	0
24	20917017	.	T	C	2	5	7	0	0	7	0	0
24	20917029	.	T	C	2	6	8	0	2	10	0	0
24	20921565	.	C	A	14	10	24	0	0	24	0	0
24	20921615	.	A	G	7	9	16	0	0	16	0	0
24	20921645	.	A	G	1	7	8	0	0	8	0	0
24	20922783	.	G	A	5	5	10	0	0	10	0	0
24	20934223	.	C	T	21	21	42	0	2	44	0	0
24	20941605	.	A	G	9	5	14	0	0	14	0	0
24	20941687	.	A	G	18	18	36	0	1	37	0	0
24	20941789	.	A	G	16	20	36	0	1	37	0	0
24	20942281	.	G	A	10	12	22	0	2	24	0	0
24	20942541	.	G	T	21	15	36	0	3	39	0	0
24	20946263	.	G	A	11	19	30	0	1	31	0	0
24	20946305	.	C	T	12	12	24	0	1	25	0	0
24	20948122	.	C	T	13	13	26	0	1	27	0	0
24	20948330	.	G	A	14	8	22	0	0	22	0	0
24	20949494	.	A	G	10	13	23	0	1	24	0	0
24	20953045	.	C	T	10	4	14	0	0	14	0	0
24	20962342	.	G	A	0	2	2	0	1	3	0	0
24	20969467	.	C	T	1	3	4	0	0	4	0	0
24	20969491	.	G	A	0	2	2	0	1	3	0	0
24	20969650	.	A	G	1	0	1	0	2	3	0	0
24	20980039	.	A	G	4	1	5	0	3	8	0	0
24	20980141	.	A	G	7	6	13	0	1	14	0	0
24	20980197	.	C	T	6	8	14	0	0	14	0	0
24	20984901	.	T	C	4	11	15	0	0	15	0	0
24	20987865	.	A	G	4	4	8	0	0	8	0	0
24	21005729	.	A	G	9	9	18	0	1	19	0	0
24	21005908	.	A	T	10	3	13	0	1	14	0	0
24	21005973	.	A	T	5	9	14	0	2	16	0	0
24	21059947	.	G	A	3	2	5	0	0	5	0	0
24	21060332	.	A	G	2	3	5	0	0	5	0	0
24	21119938	.	G	A	1	2	3	0	0	3	0	0
24	21122974	.	C	T	1	1	2	0	1	3	0	0
24	21154415	.	A	G	23	19	42	0	2	44	0	0
24	21154421	.	A	T	23	19	42	0	0	43	1	0
24	21154707	.	A	G	24	31	55	0	1	56	0	0
24	21157661	.	G	A	30	20	50	0	2	52	0	0
24	21159814	.	A	G	19	18	37	0	2	39	0	0
24	21161459	.	C	T	1	14	15	0	19	34	0	0
24	21167389	.	A	G	15	8	23	0	1	24	0	0
24	21167443	.	G	A	13	9	22	0	0	22	0	0
24	21167446	.	G	A	12	9	21	0	1	22	0	0
24	21167660	.	G	A	2	12	14	0	0	14	0	0
24	21168638	.	G	A	3	5	8	0	0	8	0	0
24	21172062	.	G	A	3	2	5	0	0	5	0	0
24	21177180	.	T	C	4	10	14	0	0	14	0	0
24	21182444	.	A	G	8	6	14	0	0	14	0	0
24	21182642	.	G	A	16	15	31	0	0	31	0	0
24	21182783	.	C	T	7	11	18	0	5	23	0	0
24	21183047	.	A	C	8	6	14	0	0	14	0	0
24	21183181	.	C	T	15	9	24	0	1	25	0	0
24	21183228	.	C	G	16	17	33	0	0	33	0	0
24	21183290	.	A	C	16	14	30	0	1	31	0	0
24	21183467	.	T	C	4	5	9	0	1	10	0	0
24	21195375	.	G	T	4	3	7	0	0	7	0	0
24	21195881	.	A	G	2	2	4	0	0	4	0	0
24	21196166	.	T	C	1	2	3	0	0	3	0	0
24	21196637	.	T	A	2	3	5	0	1	6	0	0
24	21197665	.	T	G	1	2	3	0	0	3	0	0
24	21198160	.	T	A	2	2	4	0	1	5	0	0
24	21198226	.	G	T	2	3	5	0	0	5	0	0
24	21198264	.	T	A	1	4	5	0	0	5	0	0
24	21199460	.	C	T	5	3	8	0	0	8	0	0
24	21200926	.	C	T	5	6	11	0	0	11	0	0
24	21200953	.	C	G	3	7	10	0	1	11	0	0
24	21201380	.	T	C	10	9	19	0	0	19	0	0
24	21201500	.	G	T	1	10	11	0	10	21	0	0
24	21201506	.	T	C	9	9	18	0	2	20	0	0
24	21201830	.	A	T	10	7	17	0	1	18	0	0
24	21202067	.	G	T	2	8	10	0	0	10	0	0
24	21202448	.	T	A	1	2	3	0	0	3	0	0
24	21206347	.	T	A	1	2	3	0	0	3	0	0
24	21206352	.	G	T	1	2	3	0	0	3	0	0
24	21206903	.	T	A	4	8	12	0	0	12	0	0
24	21207571	.	G	C	4	7	11	0	1	12	0	0
24	21210728	.	G	T	3	5	8	0	0	8	0	0
24	21212594	.	A	C	3	0	3	0	2	5	0	0
24	21212663	.	A	G	5	4	9	0	0	9	0	0
24	21212684	.	G	A	6	3	9	0	0	9	0	0
24	21333833	.	G	A	2	2	4	0	0	4	0	0
24	21336101	.	G	A	2	4	6	0	0	6	0	0
24	21337622	.	T	C	0	0	0	0	3	3	0	0
24	21340810	.	C	T	1	2	3	0	0	3	0	0
24	21371282	.	A	C	2	2	4	0	0	4	0	0
24	21371345	.	C	T	1	14	15	0	7	22	0	0
24	21371848	.	T	C	27	1	28	0	18	46	0	0
24	21382737	.	C	A	22	9	31	0	0	31	0	0
24	21392168	.	T	C	22	12	34	0	0	34	0	0
24	21392258	.	T	C	17	13	30	0	1	31	0	0
24	21411514	.	G	A	9	10	19	0	1	20	0	0
24	21411834	.	G	T	8	12	20	0	0	21	1	0
24	21417797	.	C	T	3	12	15	0	19	34	0	0
24	21438113	.	A	G	8	8	16	0	3	19	0	0
24	21438161	.	G	A	5	11	16	0	0	16	0	0
24	21442815	.	A	G	13	14	27	0	1	28	0	0
24	21445237	.	C	T	17	6	23	0	1	24	0	0
24	21445240	.	G	A	17	7	24	0	0	24	0	0
24	21448002	.	T	C	5	4	9	0	1	10	0	0
24	21450130	.	C	T	8	11	19	0	1	20	0	0
24	21462810	.	A	G	4	4	8	0	1	9	0	0
24	21469067	.	T	G	4	6	10	0	1	11	0	0
24	21469157	.	T	C	7	0	7	0	8	15	0	0
24	21470795	.	G	C	3	0	3	0	3	6	0	0
24	21501990	.	C	G	4	3	7	0	0	7	0	0
24	21502133	.	T	C	7	0	7	0	8	15	0	0
24	21502305	.	A	G	9	15	24	0	1	25	0	0
24	21502973	.	G	A	7	10	17	0	0	17	0	0
24	21503043	.	G	T	12	10	22	0	1	23	0	0
24	21503350	.	C	T	3	7	10	0	1	11	0	0
24	21504169	.	T	G	1	4	5	0	0	5	0	0
24	21504467	.	A	G	3	11	14	0	1	15	0	0
24	21504746	.	C	T	2	9	11	0	6	17	0	0
24	21504785	.	A	G	6	8	14	0	1	15	0	0
24	21504860	.	G	T	5	6	11	0	3	14	0	0
24	21505178	.	A	C	3	4	7	0	0	7	0	0
24	21505255	.	T	G	3	5	8	0	2	10	0	0
24	21505446	.	A	T	3	5	8	0	0	8	0	0
24	21505606	.	T	C	1	4	5	0	0	5	0	0
24	21505895	.	A	G	2	4	6	0	1	7	0	0
24	21514386	.	T	A	5	4	9	0	0	9	0	0
24	21514437	.	T	C	8	5	13	0	0	13	0	0
24	21538430	.	C	T	14	11	25	0	1	26	0	0
24	21538441	.	T	G	12	1	13	0	9	23	1	0
24	21538568	.	A	C	6	13	19	0	2	21	0	0
24	21538982	.	T	A	17	8	25	0	0	25	0	0
24	21561074	.	C	T	5	6	11	0	0	11	0	0
24	21567672	.	C	T	3	10	13	0	1	14	0	0
24	21568808	.	T	A	10	4	14	0	1	15	0	0
24	21572604	.	G	T	9	8	17	0	1	18	0	0
24	21575273	.	T	A	22	9	31	0	0	31	0	0
24	21575311	.	G	C	18	11	29	0	1	30	0	0
24	21575372	.	G	A	12	9	21	0	2	23	0	0
24	21577239	.	G	A	10	8	18	0	0	18	0	0
24	21577450	.	C	G	8	8	16	0	0	16	0	0
24	21577620	.	T	G	5	6	11	0	0	11	0	0
24	21584115	.	T	C	6	7	13	0	0	13	0	0
24	21584116	.	A	C	6	6	12	0	1	13	0	0
24	21584231	.	T	A	4	6	10	0	0	10	0	0
24	21584411	.	A	G	1	2	3	0	0	3	0	0
24	21587309	.	T	G	4	2	6	0	0	6	0	0
24	21600893	.	G	T	13	15	28	0	4	32	0	0
24	21621730	.	G	T	13	15	28	0	1	29	0	0
24	21646704	.	G	T	18	20	38	0	1	39	0	0
24	21646808	.	G	A	19	21	40	0	2	42	0	0
24	21646847	.	A	C	23	17	40	0	1	41	0	0
24	21650088	.	G	A	16	12	28	0	2	30	0	0
24	21657738	.	T	C	15	0	15	0	14	29	0	0
24	21659864	.	A	T	9	14	23	0	2	25	0	0
24	21659873	.	A	G	10	11	21	0	0	22	1	0
24	21662298	.	T	G	8	8	16	0	0	16	0	0
24	21671387	.	G	A	8	6	14	0	2	16	0	0
24	21724424	.	C	T	4	2	6	0	2	8	0	0
24	21738430	.	T	C	3	2	5	0	1	6	0	0
24	21744239	.	G	A	1	6	7	0	5	12	0	0
24	21744266	.	A	G	8	4	12	0	0	12	0	0
24	21747672	.	G	A	1	6	7	0	11	18	0	0
24	21748175	.	A	G	6	11	17	0	2	19	0	0
24	21748249	.	T	C	24	7	31	0	1	32	0	0
24	21748371	.	C	T	3	2	5	0	0	5	0	0
24	21780981	.	A	G	5	6	11	0	0	11	0	0
24	21781146	.	A	G	2	3	5	0	0	5	0	0
24	21781451	.	T	G	2	2	4	0	1	5	0	0
24	21788158	.	T	C	1	1	2	0	2	4	0	0
24	21788161	.	A	T	1	3	4	0	1	5	0	0
24	21788194	.	C	T	1	5	6	0	0	6	0	0
24	21917293	.	A	C	1	3	4	0	0	4	0	0
24	21917704	.	G	C	4	7	11	0	0	11	0	0
24	21917745	.	T	G	2	11	13	0	0	13	0	0
24	21920915	.	A	G	3	8	11	0	0	11	0	0
24	21920918	.	T	G	4	8	12	0	0	12	0	0
24	21921104	.	T	C	3	4	7	0	0	7	0	0
24	21927358	.	C	T	2	2	4	0	0	4	0	0
24	21927434	.	G	A	6	3	9	0	0	9	0	0
24	21927503	.	A	G	2	4	6	0	0	6	0	0
24	21927506	.	A	G	2	4	6	0	0	6	0	0
24	21927720	.	T	G	5	3	8	0	0	8	0	0
24	21929107	.	T	C	1	0	1	0	3	4	0	0
24	21960044	.	C	A	2	4	6	0	0	6	0	0
24	21960293	.	C	T	10	11	21	0	0	21	0	0
24	21960299	.	G	A	11	11	22	0	1	23	0	0
24	21960445	.	A	T	5	6	11	0	2	13	0	0
24	21960546	.	C	G	5	2	7	0	0	7	0	0
24	21960598	.	T	A	2	5	7	0	1	8	0	0
24	21960609	.	T	C	2	6	8	0	0	8	0	0
24	21960930	.	C	T	4	3	7	0	0	7	0	0
24	21968103	.	A	G	5	5	10	0	1	11	0	0
24	21969526	.	G	A	4	5	9	0	0	9	0	0
24	21978531	.	A	G	13	17	30	0	1	31	0	0
24	21978593	.	T	C	13	0	13	0	13	26	0	0
24	21978647	.	C	G	11	14	25	0	0	25	0	0
24	21978733	.	C	T	25	14	39	0	0	39	0	0
24	21978790	.	T	C	13	23	36	0	0	36	0	0
24	21984256	.	C	A	0	13	13	0	12	25	0	0
24	21986571	.	T	C	5	12	17	0	2	19	0	0
24	21986826	.	C	G	8	23	31	0	0	31	0	0
24	22070389	.	T	A	2	2	4	0	0	4	0	0
24	22071146	.	G	C	4	3	7	0	0	7	0	0
24	22071556	.	G	C	7	1	8	0	13	21	0	0
24	22071644	.	G	T	14	23	37	0	6	43	0	0
24	22071649	.	G	T	29	15	44	0	1	45	0	0
24	22100861	.	G	C	8	15	23	0	1	24	0	0
24	22122922	.	C	T	3	11	14	0	16	30	0	0
24	22123784	.	T	A	17	18	35	0	2	37	0	0
24	22123927	.	A	C	18	2	20	0	19	39	0	0
24	22123930	.	G	T	16	16	32	0	8	40	0	0
24	22124020	.	G	A	24	22	46	1	1	48	0	0
24	22442301	.	T	C	2	0	2	0	6	8	0	0
24	22442349	.	T	C	1	5	6	0	0	6	0	0
24	22533940	.	T	C	2	5	7	0	0	7	0	0
24	22740589	.	T	C	10	4	14	0	1	15	0	0
24	22740772	.	T	A	20	9	29	0	1	30	0	0
24	22744460	.	C	T	15	7	22	0	1	23	0	0
24	22744487	.	C	T	16	10	26	0	2	28	0	0
24	22744502	.	A	G	11	16	27	0	1	28	0	0
24	22746843	.	T	G	15	10	25	0	2	27	0	0
24	22759703	.	C	T	7	22	29	0	0	29	0	0
24	22769484	.	C	T	3	6	9	0	0	9	0	0
24	23213886	.	G	A	0	2	2	0	1	3	0	0
24	23214154	.	G	A	0	2	2	0	1	3	0	0
24	23243257	.	A	G	0	7	7	0	0	7	0	0
24	23244265	.	G	A	1	8	9	1	4	14	0	0
24	23687961	.	A	G	4	3	7	0	0	7	0	0
24	23708870	.	G	A	2	3	5	0	0	5	0	0
24	23717064	.	C	G	2	5	7	0	0	7	0	0
24	23720091	.	G	A	16	13	29	0	0	29	0	0
24	23723983	.	G	A	16	16	32	0	0	32	0	0
24	23758880	.	A	C	1	3	4	0	1	5	0	0
24	23759679	.	G	A	1	3	4	0	0	4	0	0
24	23766841	.	G	A	2	2	4	0	0	4	0	0
24	23816117	.	T	C	1	2	3	0	0	3	0	0
24	23838469	.	C	A	0	3	3	0	1	4	0	0
24	23838535	.	T	A	1	2	3	0	0	3	0	0
24	23839024	.	T	C	4	7	11	0	0	11	0	0
24	23839088	.	C	T	6	3	9	0	1	10	0	0
24	23839600	.	A	G	9	7	16	0	0	16	0	0
24	23839644	.	T	C	1	2	3	0	0	3	0	0
24	23858175	.	C	T	2	1	3	0	0	3	0	0
24	23858181	.	A	G	1	0	1	0	3	4	0	0
24	23931982	.	C	T	4	2	6	0	0	6	0	0
24	23937985	.	C	T	9	9	18	0	1	19	0	0
24	23941618	.	G	T	8	5	13	0	0	13	0	0
24	23942642	.	G	A	2	2	4	0	0	4	0	0
24	23971151	.	C	G	13	18	31	0	1	32	0	0
24	23971205	.	T	C	21	18	39	0	3	42	0	0
24	23971255	.	T	C	2	2	4	0	0	4	0	0
24	23971296	.	T	A	1	2	3	0	1	4	0	0
24	23971303	.	A	C	2	2	4	0	0	4	0	0
24	23974411	.	C	T	31	22	53	0	4	57	0	0
24	23974484	.	C	T	1	22	23	0	16	39	0	0
24	23989555	.	G	A	1	2	3	0	0	3	0	0
24	23990654	.	G	A	1	2	3	0	0	3	0	0
24	23991557	.	C	G	1	2	3	0	0	3	0	0
24	23992309	.	A	G	2	2	4	0	0	4	0	0
24	24014960	.	G	T	2	2	4	0	1	5	0	0
24	24015086	.	G	T	3	4	7	0	0	7	0	0
24	24020314	.	C	T	13	10	23	0	1	24	0	0
24	24027939	.	A	G	10	11	21	0	2	23	0	0
24	24028016	.	C	T	23	8	31	0	0	31	0	0
24	24028032	.	G	C	24	7	31	0	0	31	0	0
24	24028059	.	T	A	10	20	30	0	1	31	0	0
24	24102026	.	C	T	3	12	15	0	11	26	0	0
24	24102091	.	T	C	12	1	13	0	28	41	0	0
24	24102190	.	A	T	21	15	36	0	3	40	1	0
24	24102318	.	A	C	29	22	51	0	0	51	0	0
24	24108653	.	T	C	21	22	43	0	4	47	0	0
24	24111587	.	G	T	13	8	21	0	1	22	0	0
24	24114321	.	C	T	11	14	25	0	0	25	0	0
24	24114744	.	G	A	12	15	27	0	1	28	0	0
24	24115352	.	T	G	7	4	11	0	0	11	0	0
24	24115485	.	C	G	0	11	11	0	17	28	0	0
24	24115602	.	A	G	11	7	18	0	0	18	0	0
24	24115626	.	G	T	9	3	12	0	1	13	0	0
24	24118213	.	A	C	4	8	12	0	1	13	0	0
24	24118272	.	A	G	6	8	14	0	0	14	0	0
24	24118362	.	C	T	9	7	16	0	0	16	0	0
24	24118366	.	A	T	8	7	15	0	0	15	0	0
24	24119611	.	C	A	2	2	4	0	0	4	0	0
24	24119757	.	G	A	1	4	5	0	0	5	0	0
24	24121130	.	C	T	32	19	51	0	0	51	0	0
24	24121568	.	C	T	21	13	34	0	2	36	0	0
24	24121582	.	T	C	19	1	20	0	19	39	0	0
24	24121826	.	G	T	22	24	46	0	1	47	0	0
24	24121851	.	A	T	23	26	49	0	1	50	0	0
24	24122040	.	G	A	35	26	61	1	1	63	0	0
24	24124517	.	G	A	24	28	52	1	0	53	0	0
24	24129728	.	C	T	25	42	67	0	3	70	0	0
24	24135906	.	G	A	26	26	52	0	0	52	0	0
24	24146815	.	T	A	9	7	16	0	2	18	0	0
24	24155586	.	T	C	16	11	27	0	2	29	0	0
24	24159360	.	C	G	6	17	23	0	2	25	0	0
24	24163114	.	C	T	6	7	13	0	0	13	0	0
24	24164278	.	C	A	13	3	16	0	1	17	0	0
24	24164770	.	G	A	18	7	25	0	1	26	0	0
24	24164935	.	A	C	7	19	26	0	2	28	0	0
24	24165563	.	G	T	33	32	65	1	1	68	1	0
24	24168471	.	C	G	5	4	9	0	0	9	0	0
24	24174826	.	C	T	2	2	4	0	0	4	0	0
24	24175497	.	G	T	2	3	5	0	0	5	0	0
24	24175614	.	T	A	2	2	4	0	0	4	0	0
24	24175669	.	A	T	1	2	3	0	0	3	0	0
24	24176122	.	A	C	1	2	3	0	0	3	0	0
24	24176392	.	T	A	1	2	3	0	0	3	0	0
24	24177080	.	G	A	6	10	16	1	0	17	0	0
24	24177137	.	A	G	5	7	12	0	2	14	0	0
24	24177158	.	T	C	3	6	9	0	1	10	0	0
24	24183959	.	T	G	2	4	6	0	2	8	0	0
24	24183974	.	T	C	5	3	8	0	1	9	0	0
24	24184394	.	T	C	3	0	3	0	8	11	0	0
24	24184414	.	A	C	9	4	13	0	1	14	0	0
24	24184677	.	T	A	6	5	11	0	0	11	0	0
24	24187454	.	T	G	2	2	4	0	1	5	0	0
24	24194328	.	A	G	2	4	6	0	1	7	0	0
24	24194331	.	A	G	2	4	6	0	0	6	0	0
24	24274024	.	A	G	6	3	9	0	0	9	0	0
24	24274069	.	A	T	3	3	6	0	0	6	0	0
24	24288004	.	T	C	4	2	6	0	0	6	0	0
24	24288223	.	T	C	3	3	6	0	1	7	0	0
24	24299421	.	G	A	1	6	7	0	4	11	0	0
24	24417214	.	C	T	0	1	1	0	2	3	0	0
24	24417246	.	G	A	1	4	5	0	0	5	0	0
24	24417438	.	A	G	2	4	6	0	0	6	0	0
24	24417480	.	G	A	2	3	5	0	1	6	0	0
24	24417493	.	G	A	2	3	5	0	1	6	0	0
24	24461710	.	T	A	10	11	21	0	1	22	0	0
24	24462021	.	C	T	14	10	24	0	0	24	0	0
24	24462036	.	G	C	0	12	12	0	16	28	0	0
24	24462081	.	C	T	16	13	29	0	0	29	0	0
24	24463030	.	T	A	23	9	32	0	1	33	0	0
24	24463060	.	A	G	12	12	24	0	5	29	0	0
24	24463212	.	T	A	17	16	33	0	2	35	0	0
24	24701885	.	C	G	11	9	20	0	0	20	0	0
24	24701938	.	T	C	9	12	21	0	2	23	0	0
24	24702119	.	A	C	6	0	6	0	7	13	0	0
24	24702674	.	C	T	14	13	27	0	1	28	0	0
24	24702930	.	C	T	0	12	12	0	11	23	0	0
24	24702936	.	T	C	9	11	20	0	0	20	0	0
24	24720991	.	G	A	7	8	15	0	0	15	0	0
24	24728940	.	C	T	3	2	5	0	0	5	0	0
24	24732503	.	C	G	1	3	4	0	0	4	0	0
24	24745966	.	T	C	3	0	3	0	7	10	0	0
24	24796567	.	C	G	0	3	3	0	2	5	0	0
24	24796811	.	T	C	2	0	2	0	2	4	0	0
24	24848118	.	C	T	4	21	25	0	21	46	0	0
24	24931465	.	T	C	4	4	8	0	0	8	0	0
24	24934236	.	A	G	7	2	9	0	1	10	0	0
24	24934347	.	T	C	9	12	21	0	0	21	0	0
24	24935527	.	G	A	10	9	19	0	2	21	0	0
24	24935560	.	A	G	11	1	12	0	9	21	0	0
24	24935791	.	G	C	8	4	12	0	1	13	0	0
24	24935810	.	T	C	8	5	13	0	2	15	0	0
24	24944387	.	A	C	8	9	17	0	1	18	0	0
24	24948089	.	T	A	13	7	20	0	0	20	0	0
24	24948101	.	T	A	11	5	16	0	0	16	0	0
24	24950569	.	T	C	11	3	14	0	0	14	0	0
24	24954478	.	T	C	4	8	12	0	0	12	0	0
24	24989293	.	T	G	5	4	9	0	1	10	0	0
24	24989368	.	C	T	2	15	17	0	6	23	0	0
24	24992522	.	G	A	4	5	9	0	1	10	0	0
24	24992832	.	A	G	2	3	5	0	0	5	0	0
24	25008304	.	G	T	1	2	3	0	0	3	0	0
24	25008378	.	G	C	1	0	1	0	2	3	0	0
24	25008884	.	G	A	6	9	15	0	0	15	0	0
24	25008887	.	G	A	5	9	14	0	1	15	0	0
24	25020054	.	T	G	7	6	13	0	0	13	0	0
24	25026344	.	C	T	0	7	7	0	4	11	0	0
24	25029860	.	T	A	3	7	10	0	1	11	0	0
24	25032485	.	G	A	5	2	7	0	0	7	0	0
24	25041054	.	T	C	4	4	8	0	0	8	0	0
24	25049209	.	C	T	6	5	11	0	2	13	0	0
24	25049436	.	T	C	2	4	6	0	0	6	0	0
24	25049484	.	T	G	4	2	6	0	0	6	0	0
24	25049658	.	T	C	4	4	8	0	0	8	0	0
24	25052078	.	C	T	4	7	11	0	0	11	0	0
24	25052723	.	T	A	8	11	19	0	1	20	0	0
24	25052774	.	C	T	6	11	17	0	0	17	0	0
24	25053032	.	C	A	10	14	24	0	1	25	0	0
24	25059127	.	C	T	3	5	8	0	0	8	0	0
24	25059129	.	T	C	4	5	9	0	0	9	0	0
24	25069670	.	G	A	6	7	13	0	2	15	0	0
24	25069926	.	A	G	8	0	8	0	6	14	0	0
24	25069928	.	T	A	6	6	12	0	1	13	0	0
24	25070289	.	C	T	4	6	10	0	0	10	0	0
24	25070515	.	C	T	10	3	13	0	1	14	0	0
24	25070745	.	G	A	1	8	9	0	6	15	0	0
24	25070921	.	C	T	5	3	8	0	1	9	0	0
24	25070922	.	T	G	5	4	9	0	0	9	0	0
24	25071270	.	T	A	5	14	19	0	1	20	0	0
24	25071474	.	T	C	15	18	33	0	1	34	0	0
24	25071486	.	A	T	20	10	30	0	0	31	1	0
24	25071726	.	G	A	5	6	11	0	0	11	0	0
24	25071742	.	T	C	3	6	9	0	0	9	0	0
24	25072088	.	T	C	11	12	23	0	1	24	0	0
24	25072102	.	T	C	15	8	23	0	1	24	0	0
24	25072311	.	C	T	9	6	15	0	0	15	0	0
24	25072358	.	C	A	7	5	12	0	0	12	0	0
24	25072487	.	A	G	13	12	25	0	4	29	0	0
24	25072511	.	T	G	12	12	24	0	2	26	0	0
24	25072711	.	G	A	19	10	29	0	0	29	0	0
24	25203867	.	G	A	0	3	3	0	1	4	0	0
24	25204095	.	A	G	1	2	3	0	0	3	0	0
24	25347794	.	G	T	3	9	12	0	1	13	0	0
24	25348354	.	C	T	7	6	13	0	2	15	0	0
24	25351911	.	C	T	0	4	4	0	2	6	0	0
24	25351955	.	C	T	1	4	5	0	0	5	0	0
24	25353471	.	A	G	2	2	4	0	0	4	0	0
24	25404778	.	C	T	2	2	4	0	0	4	0	0
24	25448127	.	A	T	6	6	12	0	1	13	0	0
24	25448155	.	G	A	6	8	14	0	1	15	0	0
24	25448374	.	G	A	6	4	10	0	1	11	0	0
24	25448475	.	C	T	6	3	9	0	0	9	0	0
24	25448632	.	T	A	3	2	5	0	0	5	0	0
24	25448752	.	T	C	5	7	12	0	2	14	0	0
24	25449182	.	G	A	3	3	6	0	1	7	0	0
24	25449245	.	A	C	4	6	10	0	1	11	0	0
24	25458885	.	T	C	1	4	5	0	0	5	0	0
24	25496549	.	C	G	6	5	11	0	1	12	0	0
24	25497036	.	A	T	3	5	8	0	0	8	0	0
24	25497085	.	C	G	5	4	9	0	0	9	0	0
24	25497099	.	G	C	4	3	7	0	0	7	0	0
24	25497189	.	G	A	6	6	12	0	0	12	0	0
24	25497236	.	A	C	7	8	15	0	1	16	0	0
24	25497327	.	T	C	7	3	10	0	0	10	0	0
24	25497477	.	G	T	5	4	9	0	1	10	0	0
24	25497677	.	G	A	7	4	11	0	0	11	0	0
24	25497680	.	G	T	4	6	10	0	1	11	0	0
24	25498627	.	G	A	2	3	5	0	0	5	0	0
24	25514777	.	A	T	3	3	6	0	1	7	0	0
24	25525977	.	G	T	9	6	15	0	0	15	0	0
24	25535917	.	A	G	2	3	5	0	0	5	0	0
24	25564486	.	T	A	5	4	9	0	0	9	0	0
24	25565407	.	T	C	2	0	2	0	4	6	0	0
24	25575049	.	A	G	4	3	7	0	0	7	0	0
24	25693003	.	G	A	29	15	44	0	0	44	0	0
24	25693026	.	C	T	16	27	43	0	2	45	0	0
24	25693948	.	A	G	19	29	48	0	0	48	0	0
24	25693992	.	T	A	18	20	38	0	9	47	0	0
24	25694537	.	A	C	16	18	34	0	2	36	0	0
24	25761637	.	T	C	1	3	4	0	0	4	0	0
24	25762044	.	T	C	4	3	7	0	0	7	0	0
24	25762052	.	C	T	4	2	6	0	0	6	0	0
24	25762272	.	G	A	6	8	14	0	0	14	0	0
24	25762491	.	A	G	4	2	6	0	0	6	0	0
24	25762506	.	C	T	3	2	5	0	0	5	0	0
24	25762884	.	C	T	3	6	9	0	1	10	0	0
24	25762930	.	C	A	1	5	6	0	1	7	0	0
24	25762968	.	G	A	3	3	6	0	0	6	0	0
24	25763513	.	A	G	1	2	3	0	0	3	0	0
24	25764207	.	A	T	1	2	3	0	0	3	0	0
24	25764281	.	A	G	4	2	6	0	0	6	0	0
24	25764383	.	G	A	3	2	5	0	0	5	0	0
24	25764398	.	T	C	1	2	3	0	0	3	0	0
24	25765159	.	C	T	1	2	3	0	0	3	0	0
24	25779059	.	G	A	2	3	5	0	0	5	0	0
24	25794522	.	C	A	7	5	12	0	0	12	0	0
24	25794530	.	G	A	8	3	11	0	0	11	0	0
24	25872390	.	C	T	7	6	13	0	3	16	0	0
24	25988309	.	A	T	2	4	6	0	0	6	0	0
24	26017175	.	T	A	2	2	4	0	0	4	0	0
24	26017188	.	A	G	2	2	4	0	0	4	0	0
24	26025151	.	T	C	1	4	5	0	0	5	0	0
24	26025384	.	T	A	1	4	5	0	1	6	0	0
24	26030340	.	T	G	8	8	16	0	0	16	0	0
24	26030571	.	C	T	8	16	24	0	0	24	0	0
24	26030663	.	T	C	8	9	17	0	0	17	0	0
24	26030827	.	A	C	4	13	17	0	3	20	0	0
24	26030849	.	T	A	11	12	23	0	1	24	0	0
24	26030893	.	G	A	11	10	21	0	0	21	0	0
24	26030985	.	A	T	6	7	13	0	1	14	0	0
24	26039798	.	A	G	3	3	6	0	0	6	0	0
24	26040719	.	A	G	2	3	5	0	0	5	0	0
24	26041227	.	T	C	5	2	7	0	0	7	0	0
24	26045132	.	C	T	3	4	7	0	0	7	0	0
24	26045910	.	A	G	1	2	3	0	2	5	0	0
24	26045916	.	T	C	2	2	4	0	0	4	0	0
24	26046588	.	A	G	2	0	2	0	4	6	0	0
24	26046618	.	G	A	4	2	6	0	1	7	0	0
24	26048017	.	G	A	4	7	11	0	0	11	0	0
24	26049166	.	G	T	9	5	14	0	0	14	0	0
24	26049946	.	A	C	5	6	11	0	0	12	1	0
24	26050066	.	A	T	6	8	14	0	2	16	0	0
24	26052082	.	T	C	8	7	15	0	0	15	0	0
24	26142739	.	C	T	2	2	4	0	0	4	0	0
24	26142760	.	T	G	3	0	3	0	2	5	0	0
24	26178446	.	G	A	3	2	5	0	0	5	0	0
24	26196843	.	G	T	0	3	3	0	1	4	0	0
24	26197142	.	T	C	1	3	4	0	0	4	0	0
24	26197291	.	A	G	3	2	5	0	0	5	0	0
24	26197313	.	G	T	5	2	7	0	0	7	0	0
24	26279657	.	G	A	2	2	4	1	0	5	0	0
24	26279722	.	C	A	1	3	4	0	0	4	0	0
24	26279877	.	G	A	2	3	5	0	0	5	0	0
24	26280058	.	G	A	5	8	13	0	0	13	0	0
24	26280163	.	A	G	4	8	12	0	0	12	0	0
24	26280668	.	A	C	2	2	4	0	0	4	0	0
24	26280756	.	G	A	2	3	5	0	0	5	0	0
24	26281680	.	G	T	1	2	3	0	0	3	0	0
24	26284612	.	G	T	11	12	23	0	0	23	0	0
24	26331307	.	C	T	2	4	6	0	0	6	0	0
24	26333084	.	T	C	1	3	4	0	0	4	0	0
24	26333366	.	G	A	2	4	6	0	0	6	0	0
24	26333597	.	C	T	1	4	5	0	0	5	0	0
24	26333801	.	C	T	3	4	7	0	1	8	0	0
24	26334257	.	G	A	3	7	10	0	0	10	0	0
24	26334299	.	A	G	4	0	4	0	4	8	0	0
24	26337236	.	T	G	4	4	8	0	0	8	0	0
24	26337238	.	T	G	4	0	4	0	4	8	0	0
24	26373473	.	G	A	10	6	16	0	0	16	0	0
24	26373498	.	G	A	10	9	19	0	0	19	0	0
24	26376380	.	A	G	13	14	27	0	1	28	0	0
24	26383253	.	C	T	4	5	9	0	0	9	0	0
24	26383430	.	A	G	8	6	14	0	0	14	0	0
24	26383604	.	T	A	5	2	7	0	0	7	0	0
24	26383670	.	A	G	4	5	9	0	1	10	0	0
24	26383700	.	C	T	1	4	5	0	4	9	0	0
24	26383829	.	C	T	1	3	4	0	3	7	0	0
24	26383840	.	C	T	3	4	7	0	0	7	0	0
24	26383907	.	T	C	3	3	6	0	0	6	0	0
24	26384030	.	G	C	3	0	3	0	5	8	0	0
24	26399297	.	C	T	1	2	3	0	0	3	0	0
24	26415190	.	T	C	10	9	19	0	0	19	0	0
24	26417367	.	A	C	1	0	1	0	4	5	0	0
24	26417369	.	C	G	1	0	1	0	4	5	0	0
24	26420141	.	T	C	7	8	15	0	2	17	0	0
24	26429443	.	T	C	8	11	19	0	2	21	0	0
24	26429456	.	C	T	10	10	20	0	0	20	0	0
24	26440716	.	T	C	1	3	4	0	0	4	0	0
24	26440756	.	C	T	1	2	3	0	0	3	0	0
24	26475383	.	C	G	6	19	25	0	2	27	0	0
24	26475434	.	C	T	12	8	20	0	3	23	0	0
24	26482097	.	A	G	20	29	49	0	3	52	0	0
24	26482133	.	C	A	38	25	63	0	3	66	0	0
24	26482337	.	T	C	38	35	73	0	3	76	0	0
24	26492113	.	C	T	2	16	18	0	12	30	0	0
24	26492505	.	G	T	13	10	23	1	0	24	0	0
24	26493077	.	T	C	14	0	14	0	13	27	0	0
24	26494477	.	C	T	1	5	6	0	7	13	0	0
24	26508844	.	A	G	9	5	14	0	1	15	0	0
24	26510341	.	C	A	6	6	12	0	0	12	0	0
24	26511001	.	C	T	3	6	9	0	0	9	0	0
24	26513292	.	T	A	4	5	9	0	0	9	0	0
24	26516788	.	C	T	8	2	10	0	1	11	0	0
24	26529715	.	G	A	5	4	9	0	0	9	0	0
24	26530814	.	T	A	3	2	5	0	0	5	0	0
24	26558029	.	A	G	7	6	13	0	0	13	0	0
24	26572615	.	A	T	2	3	5	0	0	5	0	0
24	26631978	.	T	C	2	3	5	0	0	5	0	0
24	26663232	.	A	T	2	2	4	1	0	5	0	0
24	26663381	.	C	T	0	4	4	0	9	13	0	0
24	26663696	.	G	T	4	3	7	0	0	7	0	0
24	26663929	.	C	T	7	6	13	0	1	14	0	0
24	26663944	.	A	G	6	6	12	0	1	13	0	0
24	26668621	.	G	A	5	2	7	0	0	7	0	0
24	26889359	.	G	A	4	2	6	0	0	6	0	0
24	26948820	.	G	A	3	2	5	0	0	5	0	0
24	26948823	.	A	C	3	2	5	0	0	5	0	0
24	26949164	.	T	A	0	6	6	0	0	6	0	0
24	26949181	.	T	G	1	3	4	0	0	4	0	0
24	26949229	.	T	C	2	3	5	0	0	5	0	0
24	26949412	.	C	T	7	4	11	0	0	11	0	0
24	26949606	.	T	C	7	4	11	0	0	11	0	0
24	26958347	.	A	G	9	9	18	0	1	19	0	0
24	26958365	.	T	A	8	12	20	0	1	21	0	0
24	26964695	.	A	G	7	3	10	0	0	10	0	0
24	26968308	.	G	A	1	5	6	0	0	6	0	0
24	26970404	.	G	A	3	4	7	0	1	8	0	0
24	26970407	.	C	T	3	4	7	0	0	7	0	0
24	26970846	.	C	T	3	4	7	0	0	7	0	0
24	26970879	.	A	G	4	3	7	0	0	7	0	0
24	26980842	.	A	G	2	2	4	0	1	5	0	0
24	26997920	.	G	A	1	3	4	0	2	6	0	0
24	27006002	.	G	A	0	4	4	0	1	5	0	0
24	27011189	.	T	A	9	6	15	0	1	17	1	0
24	27013469	.	A	T	7	8	15	0	1	16	0	0
24	27014011	.	C	T	14	10	24	0	0	24	0	0
24	27019276	.	C	T	12	9	21	0	1	22	0	0
24	27130971	.	A	T	9	3	12	0	0	12	0	0
24	27153245	.	C	T	3	2	5	0	0	5	0	0
24	27181048	.	T	A	3	8	11	0	0	11	0	0
24	27181057	.	G	A	9	2	11	0	1	12	0	0
24	27185859	.	T	A	3	2	5	0	1	6	0	0
24	27216987	.	G	A	1	6	7	0	8	15	0	0
24	27222937	.	G	A	2	13	15	0	14	29	0	0
24	27224064	.	T	A	25	16	41	0	0	41	0	0
24	27224385	.	G	A	1	14	15	0	24	39	0	0
24	27224863	.	C	A	19	8	27	0	0	27	0	0
24	27225096	.	T	C	15	15	30	1	2	33	0	0
24	27225238	.	C	T	1	12	13	0	14	27	0	0
24	27225342	.	G	A	17	16	33	0	0	33	0	0
24	27225675	.	T	A	15	15	30	0	4	34	0	0
24	27225693	.	A	G	20	17	37	0	3	40	0	0
24	27225859	.	C	G	13	13	26	0	1	27	0	0
24	27225960	.	G	A	18	15	33	0	3	36	0	0
24	27226057	.	C	T	6	12	18	0	0	18	0	0
24	27226368	.	C	T	13	6	19	0	1	20	0	0
24	27236412	.	A	C	7	15	22	0	2	24	0	0
24	27236653	.	C	T	10	10	20	0	1	21	0	0
24	27236716	.	T	C	12	17	29	0	1	30	0	0
24	27244691	.	C	A	1	4	5	0	2	7	0	0
24	27251249	.	C	T	11	10	21	0	0	21	0	0
24	27346819	.	G	A	4	2	6	0	0	6	0	0
24	27346837	.	C	T	3	2	5	0	0	5	0	0
24	27399940	.	G	A	10	8	18	0	0	18	0	0
24	27677724	.	G	A	2	2	4	0	1	5	0	0
24	27700425	.	G	A	4	4	8	0	1	9	0	0
24	27700473	.	T	C	4	5	9	0	0	9	0	0
24	27713822	.	G	A	3	3	6	0	0	6	0	0
24	27714331	.	C	T	1	5	6	0	0	6	0	0
24	27714338	.	C	T	1	5	6	0	0	6	0	0
24	27714396	.	G	A	0	3	3	0	5	8	0	0
24	27714419	.	G	A	2	6	8	0	0	8	0	0
24	27714717	.	A	G	2	2	4	0	0	4	0	0
24	27783955	.	G	A	4	9	13	0	1	14	0	0
24	27783982	.	G	A	6	12	18	0	0	18	0	0
24	27784009	.	C	T	7	12	19	0	0	19	0	0
24	27784036	.	A	G	11	8	19	0	0	19	0	0
24	27784057	.	T	C	9	4	13	0	0	13	0	0
24	27784102	.	C	G	7	6	13	0	2	15	0	0
24	27784129	.	A	G	7	15	22	0	1	23	0	0
24	27784210	.	G	T	9	5	14	0	0	14	0	0
24	27784246	.	G	A	10	7	17	0	2	19	0	0
24	27784348	.	C	T	7	6	13	0	1	14	0	0
24	28137429	.	G	A	4	6	10	0	1	11	0	0
24	28242709	.	T	C	9	0	9	0	3	12	0	0
24	28245753	.	G	T	9	8	17	0	0	17	0	0
24	28252898	.	C	A	11	15	26	0	0	26	0	0
24	28253127	.	G	A	8	9	17	0	1	18	0	0
24	28253646	.	A	T	10	15	25	0	1	26	0	0
24	28253663	.	G	A	14	13	27	0	0	27	0	0
24	28253740	.	A	T	14	14	28	0	0	28	0	0
24	28258999	.	G	A	11	6	17	0	1	18	0	0
24	28259134	.	T	C	10	15	25	0	2	27	0	0
24	28263850	.	G	A	6	11	17	0	2	19	0	0
24	28268081	.	T	C	14	7	21	0	0	21	0	0
24	28276193	.	C	T	0	6	6	0	8	14	0	0
24	28293347	.	C	T	1	6	7	0	6	13	0	0
24	28306386	.	T	A	2	5	7	0	0	7	0	0
24	28306413	.	A	C	2	0	2	0	6	8	0	0
24	28306471	.	C	T	2	4	6	0	0	6	0	0
24	28312326	.	T	A	4	6	10	0	1	11	0	0
24	28312359	.	G	A	6	6	12	0	0	12	0	0
24	28312431	.	G	A	8	12	20	1	2	23	0	0
24	28312460	.	A	T	7	13	20	1	2	23	0	0
24	28354675	.	T	G	7	8	15	0	3	18	0	0
24	28381103	.	C	T	3	3	6	0	0	6	0	0
24	28381267	.	C	T	6	3	9	0	0	9	0	0
24	28381298	.	C	A	1	2	3	0	3	6	0	0
24	28381351	.	C	A	3	3	6	0	0	6	0	0
24	28392421	.	T	C	2	3	5	0	0	5	0	0
24	28394446	.	G	T	4	2	6	0	1	7	0	0
24	28394461	.	A	T	6	3	9	0	1	10	0	0
24	28394482	.	C	T	4	3	7	0	0	7	0	0
24	28397569	.	G	A	2	2	4	0	0	4	0	0
24	28426082	.	T	A	13	6	19	0	1	20	0	0
24	28426363	.	T	G	28	13	41	0	3	44	0	0
24	28426583	.	T	A	21	18	39	0	3	42	0	0
24	28426615	.	G	A	24	21	45	0	2	47	0	0
24	28426705	.	T	A	15	14	29	0	5	34	0	0
24	28426717	.	C	T	0	15	15	0	20	35	0	0
24	28432162	.	A	G	14	19	33	0	0	33	0	0
24	28432297	.	A	C	26	11	37	0	0	37	0	0
24	28432372	.	G	A	18	12	30	0	1	31	0	0
24	28437375	.	A	G	19	19	38	0	2	40	0	0
24	28437405	.	G	A	19	18	37	0	0	37	0	0
24	28437681	.	C	T	6	15	21	0	1	22	0	0
24	28556213	.	T	G	3	2	5	0	0	5	0	0
24	28691389	.	C	T	5	7	12	0	0	12	0	0
24	28691457	.	C	T	0	6	6	0	11	17	0	0
24	28710915	.	G	T	1	9	10	0	1	11	0	0
24	28710953	.	G	A	2	10	12	0	0	12	0	0
24	28711027	.	T	A	2	5	7	0	0	7	0	0
24	28764374	.	T	G	3	2	5	0	1	6	0	0
24	28764415	.	C	T	0	2	2	0	2	4	0	0
24	28935232	.	A	G	4	5	9	0	0	9	0	0
24	28936801	.	A	T	15	11	26	0	1	27	0	0
24	28960786	.	T	G	21	9	30	0	2	32	0	0
24	28963133	.	C	T	11	10	21	0	1	22	0	0
24	28963445	.	C	T	19	7	26	0	1	27	0	0
24	28963903	.	G	C	3	3	6	0	0	6	0	0
24	28964215	.	A	G	1	6	7	0	0	7	0	0
24	28964326	.	G	A	0	2	2	0	1	3	0	0
24	28964575	.	G	A	3	3	6	0	0	6	0	0
24	28964747	.	T	A	3	2	5	0	0	5	0	0
24	28965032	.	G	T	1	2	3	0	0	3	0	0
24	28965903	.	A	G	3	3	6	0	0	6	0	0
24	28965995	.	G	T	4	2	6	0	0	6	0	0
24	28966034	.	C	G	6	3	9	0	1	10	0	0
24	28966068	.	T	A	5	8	13	0	1	14	0	0
24	28966088	.	A	T	7	6	13	0	0	13	0	0
24	28966271	.	G	A	3	2	5	0	0	5	0	0
24	28966810	.	T	C	5	6	11	0	0	11	0	0
24	28966812	.	T	G	4	6	10	0	0	10	0	0
24	28966892	.	T	C	12	5	17	0	2	19	0	0
24	29352296	.	T	A	1	4	5	0	0	5	0	0
24	29353340	.	T	A	1	6	7	0	0	7	0	0
24	29382235	.	T	C	10	7	17	0	0	17	0	0
24	29450177	.	T	C	11	12	23	0	0	23	0	0
24	29450195	.	C	T	11	11	22	0	0	22	0	0
24	29450222	.	C	T	12	8	20	0	1	21	0	0
24	29525071	.	C	T	18	14	32	0	0	32	0	0
24	29525169	.	T	A	6	11	17	0	12	29	0	0
24	29930715	.	A	C	1	3	4	0	0	4	0	0
24	29961958	.	G	A	3	3	6	0	0	6	0	0
24	29965446	.	T	C	9	0	9	0	9	18	0	0
24	29997145	.	A	T	5	6	11	1	0	12	0	0
24	31116765	.	T	C	2	3	5	0	0	5	0	0
24	31170701	.	C	T	0	3	3	0	6	9	0	0
24	31170921	.	A	G	3	4	7	0	1	8	0	0
24	31176087	.	A	G	4	4	8	0	0	8	0	0
24	31310981	.	T	G	10	4	14	0	0	14	0	0
24	31311110	.	T	A	17	8	25	0	0	25	0	0
24	31311137	.	A	G	15	10	25	0	0	25	0	0
24	31311185	.	T	G	7	8	15	0	2	17	0	0
24	31315500	.	A	G	10	6	16	0	1	17	0	0
24	31315985	.	A	G	2	6	8	0	1	9	0	0
24	31319044	.	A	G	5	4	9	0	0	9	0	0
24	31319333	.	T	G	5	4	9	0	1	10	0	0
24	31319363	.	A	C	7	3	10	0	0	10	0	0
24	31319544	.	T	C	3	5	8	0	0	8	0	0
24	31319606	.	A	G	3	5	8	0	0	8	0	0
24	31320006	.	A	G	3	6	9	0	0	9	0	0
24	31320049	.	G	A	4	4	8	0	0	8	0	0
24	31322911	.	G	C	5	0	5	0	6	11	0	0
24	31322920	.	A	G	5	5	10	0	0	10	0	0
24	31322950	.	T	G	5	7	12	0	0	12	0	0
24	31325202	.	T	C	1	3	4	0	0	4	0	0
24	31329983	.	C	G	0	5	5	0	5	10	0	0
24	31334313	.	A	G	21	15	36	0	2	38	0	0
24	31340562	.	A	C	27	21	48	0	7	55	0	0
24	31340610	.	C	G	24	4	28	0	25	53	0	0
24	31340922	.	A	G	19	0	19	0	33	52	0	0
24	31342684	.	A	G	1	4	5	0	0	5	0	0
24	31342746	.	A	T	3	3	6	0	1	7	0	0
24	31342846	.	G	C	2	5	7	0	1	8	0	0
24	31342855	.	G	A	1	5	6	0	0	6	0	0
24	31364622	.	C	T	2	2	4	0	1	5	0	0
24	31367533	.	T	C	6	4	10	0	0	10	0	0
24	31367748	.	G	T	0	3	3	0	4	7	0	0
24	31367775	.	A	G	5	3	8	0	0	8	0	0
24	31367841	.	C	A	2	4	6	0	0	6	0	0
24	31367851	.	G	A	3	3	6	0	0	6	0	0
24	31379369	.	A	T	1	3	4	0	0	4	0	0
24	31379390	.	A	G	1	4	5	0	0	5	0	0
24	31393957	.	A	T	4	2	6	0	0	6	0	0
24	31397840	.	G	A	5	4	9	0	0	9	0	0
24	32650263	.	T	G	3	8	11	0	2	13	0	0
24	32674686	.	T	A	10	12	22	0	0	22	0	0
24	32674708	.	C	T	5	5	10	0	0	10	0	0
24	32674886	.	A	G	4	8	12	0	0	12	0	0
24	32674960	.	T	A	3	4	7	1	0	8	0	0
24	33670903	.	C	T	1	2	3	0	0	3	0	0
24	33685278	.	A	T	3	2	5	0	0	5	0	0
24	33685344	.	T	C	1	2	3	0	0	3	0	0
24	33687600	.	C	T	3	3	6	0	0	6	0	0
24	33709247	.	C	G	37	20	57	0	5	63	1	0
24	33714797	.	A	G	14	14	28	0	1	29	0	0
24	33714854	.	G	A	19	19	38	0	0	38	0	0
24	33723289	.	C	A	2	22	24	0	15	39	0	0
24	33755683	.	C	T	15	20	35	0	4	39	0	0
24	33767992	.	T	C	4	7	11	0	0	11	0	0
24	33768192	.	G	A	2	2	4	0	0	4	0	0
24	33768346	.	T	A	15	2	17	1	0	18	0	0
24	33768509	.	C	T	5	2	7	0	0	7	0	0
24	33768530	.	G	T	7	4	11	0	0	11	0	0
24	33768705	.	A	G	18	7	25	0	2	27	0	0
24	33774457	.	G	A	3	4	7	0	0	7	0	0
24	33777341	.	C	T	0	2	2	0	5	7	0	0
24	33785898	.	G	A	5	7	12	0	0	12	0	0
24	33788330	.	G	A	4	3	7	0	0	7	0	0
24	33790094	.	G	A	2	3	5	0	0	5	0	0
24	33792254	.	C	T	0	5	5	0	4	9	0	0
24	33800095	.	C	T	0	2	2	0	4	6	0	0
24	33824554	.	G	A	0	3	3	0	2	5	0	0
24	33824590	.	A	G	2	0	2	0	2	4	0	0
24	33826850	.	C	T	3	7	10	0	0	10	0	0
24	33832513	.	G	A	3	2	5	1	1	7	0	0
24	33835327	.	A	G	1	2	3	0	0	3	0	0
24	33836236	.	T	A	4	2	6	0	0	6	0	0
24	33836490	.	T	A	3	6	9	0	0	9	0	0
24	33836512	.	A	G	6	2	8	0	1	9	0	0
24	33836581	.	C	T	2	4	6	0	1	7	0	0
24	33837210	.	A	G	3	3	6	0	0	6	0	0
24	33837595	.	A	G	7	3	10	0	1	11	0	0
24	33837636	.	G	T	9	6	15	0	0	15	0	0
24	33837790	.	A	G	3	5	8	0	1	9	0	0
24	33837845	.	A	G	2	2	4	1	0	5	0	0
24	33837865	.	A	G	2	3	5	0	0	5	0	0
24	33838012	.	A	C	5	3	8	0	3	11	0	0
24	33838293	.	A	G	7	8	15	0	1	16	0	0
24	33838486	.	G	A	0	5	5	0	3	8	0	0
24	33838533	.	T	G	4	0	4	0	6	10	0	0
24	33838549	.	A	G	8	4	12	0	0	12	0	0
24	33838753	.	G	A	9	5	14	0	1	15	0	0
24	33838876	.	A	G	10	0	10	0	11	21	0	0
24	33838954	.	A	C	6	4	10	0	0	10	0	0
24	33839031	.	G	A	9	7	16	0	1	17	0	0
24	33839221	.	A	C	4	2	6	0	0	6	0	0
24	34115830	.	G	A	4	7	11	0	0	11	0	0
24	34115850	.	G	A	0	3	3	0	5	8	0	0
24	34116386	.	G	C	4	4	8	0	0	8	0	0
24	34116399	.	C	T	3	4	7	0	0	7	0	0
24	34139278	.	G	A	7	6	13	0	0	13	0	0
24	34139317	.	C	T	5	3	8	0	1	9	0	0
24	34139323	.	T	C	7	0	7	0	3	10	0	0
24	34176593	.	C	T	3	2	5	0	1	6	0	0
24	34185156	.	T	C	3	4	7	0	1	8	0	0
24	34185357	.	G	T	2	4	6	0	0	6	0	0
24	34185364	.	G	A	2	5	7	0	0	7	0	0
24	34208678	.	G	A	3	3	6	0	0	6	0	0
24	34208684	.	T	C	2	3	5	0	1	6	0	0
24	34208747	.	A	G	6	3	9	0	0	9	0	0
24	34284596	.	G	T	16	17	33	0	1	34	0	0
24	35196166	.	C	T	8	9	17	1	1	19	0	0
24	35213755	.	T	C	14	15	29	0	1	30	0	0
24	35213764	.	G	A	1	13	14	0	15	29	0	0
24	35216439	.	A	T	17	24	41	0	4	45	0	0
24	35216835	.	A	G	8	16	24	0	0	24	0	0
24	35216973	.	C	T	11	10	21	0	0	21	0	0
24	35217222	.	A	T	22	10	32	0	1	33	0	0
24	35217255	.	G	A	15	10	25	0	0	25	0	0
24	35217258	.	C	G	14	9	23	0	2	25	0	0
24	35217311	.	T	A	14	3	17	0	1	18	0	0
24	35217426	.	C	T	13	9	22	1	4	27	0	0
24	35217937	.	A	C	1	2	3	0	0	3	0	0
24	35217999	.	A	C	2	3	5	0	0	5	0	0
24	35218006	.	C	T	2	2	4	0	0	4	0	0
24	35218227	.	C	T	2	3	5	0	0	5	0	0
24	35269876	.	T	C	2	3	5	0	0	5	0	0
24	35522379	.	A	T	10	6	16	0	2	18	0	0
24	35522417	.	C	A	13	13	26	0	3	29	0	0
24	35522568	.	C	T	31	22	53	0	1	54	0	0
24	35522962	.	A	G	23	25	48	0	3	51	0	0
24	35523088	.	A	T	13	34	47	0	11	58	0	0
24	35523134	.	T	A	37	14	51	0	4	55	0	0
24	35530249	.	T	G	20	19	39	0	0	39	0	0
24	35536845	.	C	T	1	3	4	0	0	4	0	0
24	35537156	.	G	A	3	2	5	0	0	5	0	0
24	35565350	.	C	G	14	0	14	0	20	34	0	0
24	35681625	.	G	A	16	24	40	0	4	44	0	0
24	35681753	.	G	A	26	27	53	1	4	58	0	0
24	35683349	.	T	C	28	20	48	0	3	51	0	0
24	35683883	.	A	G	17	28	45	0	0	45	0	0
24	35686180	.	A	G	18	15	33	0	4	37	0	0
24	35692741	.	C	T	2	14	16	0	15	31	0	0
24	35713710	.	T	C	3	7	10	0	2	12	0	0
24	35713835	.	G	A	2	3	5	0	1	6	0	0
24	35720498	.	C	T	1	5	6	0	4	10	0	0
24	35735837	.	C	T	1	2	3	0	1	4	0	0
24	35742791	.	A	G	3	2	5	0	0	5	0	0
24	35749016	.	C	T	0	2	2	0	1	3	0	0
24	35767462	.	C	T	1	3	4	0	0	4	0	0
24	35899121	.	A	G	4	1	5	0	4	9	0	0
24	35899358	.	A	G	4	0	4	0	4	8	0	0
24	35906191	.	G	A	0	10	10	0	5	15	0	0
24	35914362	.	A	T	1	2	3	0	0	3	0	0
24	35918445	.	C	G	1	2	3	0	0	3	0	0
24	35923708	.	T	C	2	2	4	0	0	4	0	0
24	35925145	.	T	C	8	3	11	0	0	11	0	0
24	35925163	.	C	A	9	3	12	0	0	12	0	0
24	35925499	.	T	C	6	5	11	0	0	11	0	0
24	35925529	.	T	C	6	4	10	0	0	10	0	0
24	35926460	.	C	T	3	3	6	0	0	6	0	0
24	35927589	.	G	A	0	7	7	0	2	9	0	0
24	35927598	.	C	T	3	7	10	0	0	10	0	0
24	35929814	.	A	C	3	7	10	0	0	10	0	0
24	35930005	.	A	C	3	6	9	0	0	9	0	0
24	35930056	.	T	G	2	2	4	0	0	4	0	0
24	36027212	.	T	C	18	10	28	0	2	30	0	0
24	36166121	.	T	G	3	3	6	0	1	7	0	0
24	36166196	.	A	G	5	4	9	0	0	9	0	0
24	36175205	.	G	A	9	3	12	0	0	12	0	0
24	36175208	.	C	T	10	2	12	0	1	13	0	0
24	36177597	.	A	C	7	6	13	0	0	13	0	0
24	36177609	.	T	C	7	6	13	0	0	13	0	0
24	36177713	.	T	C	6	0	6	0	5	11	0	0
24	36178063	.	C	G	5	2	7	0	0	7	0	0
24	36180824	.	C	T	3	5	8	0	0	8	0	0
24	36182443	.	A	G	4	6	10	0	1	11	0	0
24	36182455	.	G	A	5	7	12	0	0	12	0	0
24	36182503	.	G	C	3	3	6	0	0	6	0	0
24	36186986	.	G	A	4	3	7	0	0	7	0	0
24	36186987	.	T	A	4	3	7	0	0	7	0	0
24	36187507	.	G	T	7	3	10	0	0	10	0	0
24	36187933	.	A	T	1	5	6	0	0	6	0	0
24	36187963	.	C	T	1	2	3	0	2	5	0	0
24	36193431	.	C	T	0	2	2	0	3	5	0	0
24	36194151	.	G	A	1	2	3	0	0	3	0	0
24	36194721	.	T	A	3	2	5	0	0	5	0	0
24	36195103	.	G	A	1	2	3	0	0	3	0	0
24	36206077	.	C	T	3	2	5	0	0	5	0	0
24	36211811	.	G	T	3	2	5	0	0	5	0	0
24	36211822	.	C	T	2	3	5	0	1	6	0	0
24	36220106	.	A	T	2	4	6	0	0	6	0	0
24	36223627	.	T	C	5	4	9	0	0	9	0	0
24	36227170	.	G	T	2	3	5	0	0	5	0	0
24	36244407	.	C	T	5	3	8	0	0	8	0	0
24	36247261	.	A	T	6	7	13	0	1	14	0	0
24	36247537	.	C	T	5	6	11	0	0	11	0	0
24	36248705	.	C	T	5	5	10	0	1	11	0	0
24	36249910	.	G	T	10	10	20	0	1	21	0	0
24	36250403	.	T	C	13	8	21	0	0	21	0	0
24	36253324	.	C	T	27	14	41	0	1	42	0	0
24	36261730	.	C	T	1	4	5	0	6	11	0	0
24	36266460	.	C	A	3	3	6	0	0	6	0	0
24	36271163	.	G	A	2	2	4	0	0	4	0	0
24	36275987	.	C	T	2	2	4	0	0	4	0	0
24	36276035	.	A	C	5	6	11	0	0	11	0	0
24	36276059	.	G	T	6	3	9	0	1	10	0	0
24	36276087	.	A	G	4	3	7	0	0	7	0	0
24	36276363	.	A	G	11	9	20	0	0	20	0	0
24	36276364	.	G	T	11	9	20	0	0	20	0	0
24	36280272	.	A	G	12	7	19	0	1	20	0	0
24	36280296	.	T	G	13	5	18	0	2	21	1	0
24	36284470	.	G	A	6	5	11	0	0	11	0	0
24	36287396	.	G	T	4	6	10	0	0	10	0	0
24	36289642	.	T	C	1	3	4	0	0	4	0	0
24	36295355	.	C	T	3	3	6	0	0	6	0	0
24	36295445	.	C	T	0	3	3	0	5	8	0	0
24	36295448	.	C	T	5	3	8	0	0	8	0	0
24	36295817	.	A	G	7	2	9	0	0	9	0	0
24	36298928	.	G	A	7	3	10	0	1	12	1	0
24	36298934	.	G	A	8	3	11	0	1	12	0	0
24	36298963	.	A	G	8	4	12	0	0	12	0	0
24	36300941	.	T	A	3	5	8	0	0	8	0	0
24	36301035	.	T	G	3	4	7	0	0	7	0	0
24	36323386	.	T	A	1	4	5	0	0	5	0	0
24	36325256	.	C	G	3	5	8	0	0	8	0	0
24	36325262	.	C	G	3	5	8	0	0	8	0	0
24	36331150	.	A	G	4	4	8	0	0	8	0	0
24	36331180	.	G	C	2	4	6	0	1	7	0	0
24	36331207	.	G	T	1	2	3	0	2	5	0	0
24	36334589	.	G	A	3	2	5	0	1	6	0	0
24	36334677	.	T	C	7	4	11	0	0	11	0	0
24	36334724	.	A	G	6	5	11	0	0	11	0	0
24	36334848	.	A	G	3	6	9	0	0	9	0	0
24	36334857	.	G	A	3	5	8	0	1	9	0	0
24	36335024	.	C	G	3	2	5	0	0	5	0	0
24	36335106	.	A	T	1	5	6	0	2	8	0	0
24	36335139	.	T	C	3	0	3	0	8	11	0	0
24	36335196	.	C	G	3	3	6	0	0	6	0	0
24	36343107	.	T	C	1	2	3	0	0	3	0	0
24	36345780	.	A	C	2	2	4	0	0	4	0	0
24	36349911	.	C	T	2	4	6	0	0	6	0	0
24	36349915	.	G	A	2	4	6	0	0	6	0	0
24	36357149	.	A	C	1	2	3	0	0	3	0	0
24	36362031	.	G	C	6	3	9	0	0	9	0	0
24	36362141	.	T	C	5	17	22	0	2	24	0	0
24	36364454	.	A	G	4	2	6	0	0	6	0	0
24	37302011	.	T	A	1	9	10	0	2	12	0	0
24	37604311	.	G	T	2	2	4	0	0	4	0	0
24	37623247	.	A	C	1	2	3	0	0	3	0	0
24	37631842	.	G	A	1	2	3	0	0	3	0	0
24	37634889	.	G	T	2	2	4	0	0	4	0	0
24	37649810	.	T	C	5	3	8	0	0	8	0	0
24	37655196	.	A	T	3	7	10	0	0	10	0	0
24	37655213	.	C	T	5	6	11	0	1	12	0	0
24	37657884	.	T	C	4	2	6	0	1	7	0	0
24	37660621	.	T	C	1	2	3	0	0	3	0	0
24	37660628	.	G	A	1	2	3	0	0	3	0	0
24	37661949	.	C	T	2	2	4	0	0	4	0	0
24	37661996	.	C	T	3	2	5	0	0	5	0	0
24	37661999	.	G	A	3	2	5	0	0	5	0	0
24	37664505	.	G	A	2	2	4	0	0	4	0	0
24	37664506	.	T	C	2	2	4	0	0	4	0	0
24	37668208	.	T	C	1	2	3	0	0	3	0	0
24	37681556	.	G	T	4	2	6	0	1	7	0	0
24	37685925	.	C	T	4	4	8	0	0	8	0	0
24	37685942	.	C	T	0	2	2	0	5	7	0	0
24	37689919	.	T	C	30	29	59	0	4	63	0	0
24	37692529	.	G	A	32	33	65	0	2	67	0	0
24	37696508	.	T	C	4	7	11	0	0	11	0	0
24	37704287	.	G	C	2	8	10	0	0	10	0	0
24	37708017	.	T	C	4	4	8	0	0	8	0	0
24	37708207	.	T	A	5	4	9	0	0	9	0	0
24	37708288	.	A	C	6	6	12	0	0	12	0	0
24	37718769	.	T	C	2	3	5	0	0	5	0	0
24	37718813	.	C	T	2	5	7	0	0	7	0	0
24	37723056	.	G	A	3	2	5	0	0	5	0	0
24	37723096	.	G	A	3	4	7	0	0	7	0	0
24	37723133	.	G	A	2	2	4	0	0	4	0	0
24	37724206	.	T	C	2	3	5	0	0	5	0	0
24	37725117	.	T	C	2	4	6	0	0	6	0	0
24	37725837	.	G	A	5	3	8	0	2	10	0	0
24	37725860	.	T	G	3	4	7	0	1	8	0	0
24	37726106	.	C	T	1	3	4	0	0	4	0	0
24	37726128	.	G	A	3	4	7	0	0	7	0	0
24	37726147	.	T	A	3	6	9	0	0	9	0	0
24	37726188	.	C	A	5	7	12	0	0	12	0	0
24	37726649	.	G	A	2	3	5	0	4	9	0	0
24	37726867	.	C	G	3	3	6	0	0	6	0	0
24	37726991	.	C	T	1	4	5	0	0	5	0	0
24	37746094	.	G	A	0	4	4	0	6	10	0	0
24	37781428	.	G	A	10	5	15	0	0	15	0	0
24	37781446	.	C	T	5	10	15	0	2	17	0	0
24	37791099	.	C	T	10	5	15	0	1	16	0	0
24	37793276	.	C	A	7	9	16	0	0	16	0	0
24	37793282	.	C	T	7	11	18	0	0	18	0	0
24	37793315	.	C	T	6	9	15	0	1	16	0	0
24	37793725	.	C	T	6	8	14	0	2	16	0	0
24	37800356	.	C	T	0	3	3	0	0	3	0	0
24	37800362	.	A	T	1	3	4	0	0	4	0	0
24	37802119	.	T	G	3	0	3	0	3	6	0	0
24	37802272	.	G	A	0	4	4	0	1	5	0	0
24	37816405	.	C	T	5	2	7	0	0	7	0	0
24	37823329	.	T	C	3	3	6	0	0	6	0	0
24	37844852	.	A	G	2	2	4	0	0	4	0	0
24	37888518	.	C	T	4	5	9	0	0	9	0	0
24	37893269	.	A	G	2	2	4	0	0	4	0	0
24	37895022	.	C	T	5	2	7	0	1	8	0	0
24	37896875	.	C	T	2	7	9	0	0	9	0	0
24	37897208	.	G	C	7	5	12	0	0	12	0	0
24	37899479	.	A	T	8	3	11	0	0	11	0	0
24	37900945	.	G	A	0	5	5	0	3	8	0	0
24	37901148	.	A	G	6	3	9	0	0	9	0	0
24	37901178	.	C	T	9	5	14	0	0	14	0	0
24	37919753	.	T	G	2	3	5	0	0	5	0	0
24	37941922	.	A	C	8	10	18	0	1	19	0	0
24	37942032	.	C	T	7	6	13	0	1	14	0	0
24	37942423	.	G	A	5	2	7	0	1	8	0	0
24	37942559	.	C	T	3	5	8	0	0	8	0	0
24	37943664	.	G	C	1	3	4	0	0	4	0	0
24	37943666	.	T	C	1	3	4	0	0	4	0	0
24	37943725	.	A	C	2	3	5	0	0	5	0	0
24	37943767	.	C	T	0	4	4	0	3	7	0	0
24	37943897	.	A	G	1	2	3	0	0	3	0	0
24	37943905	.	C	T	1	2	3	0	0	3	0	0
24	37952667	.	C	T	3	2	5	0	0	5	0	0
24	37952719	.	T	C	1	1	2	0	2	4	0	0
24	38073247	.	A	G	14	10	24	0	1	25	0	0
24	38073271	.	G	A	14	14	28	0	1	29	0	0
24	38073625	.	A	G	6	14	20	0	1	21	0	0
24	38073712	.	C	T	14	13	27	0	0	27	0	0
24	38073754	.	A	C	11	10	21	0	2	23	0	0
24	38174887	.	T	A	2	2	4	0	0	4	0	0
24	38188229	.	A	G	4	4	8	0	0	8	0	0
24	38189538	.	G	A	1	4	5	0	0	5	0	0
24	38190121	.	A	G	5	6	11	0	0	11	0	0
24	38190199	.	A	G	7	3	10	0	1	11	0	0
24	38190201	.	C	T	8	3	11	0	0	11	0	0
24	38190387	.	T	C	4	2	6	0	0	6	0	0
24	38190396	.	A	C	5	5	10	0	0	10	0	0
24	38190594	.	G	T	0	3	3	0	7	10	0	0
24	38190606	.	A	T	5	3	8	0	0	8	0	0
24	38190704	.	T	A	3	2	5	0	0	5	0	0
24	38190768	.	G	A	3	4	7	0	0	7	0	0
24	38190868	.	A	G	3	7	10	0	0	10	0	0
24	38191525	.	A	C	4	4	8	0	0	8	0	0
24	38191537	.	C	T	5	4	9	0	0	9	0	0
24	38191590	.	T	C	4	3	7	0	1	8	0	0
24	38191643	.	A	G	4	4	8	0	0	8	0	0
24	38191652	.	A	T	5	4	9	0	0	9	0	0
24	38191900	.	A	G	2	2	4	0	0	4	0	0
24	38369559	.	T	A	19	14	33	0	1	34	0	0
24	38369873	.	G	A	26	13	39	0	0	39	0	0
24	38370188	.	A	G	15	12	27	0	2	29	0	0
24	38370245	.	C	G	1	14	15	0	12	27	0	0
24	38370443	.	C	T	2	8	10	0	10	20	0	0
24	38370998	.	A	G	7	13	20	0	0	20	0	0
24	38371178	.	A	G	5	3	8	0	1	9	0	0
24	38372822	.	T	G	5	8	13	0	0	13	0	0
24	38374682	.	A	G	5	2	7	0	1	8	0	0
24	38384245	.	A	T	5	5	10	0	0	10	0	0
24	38544721	.	A	G	3	0	3	0	2	5	0	0
24	38544723	.	A	G	3	2	5	0	0	5	0	0
24	38558011	.	C	T	1	2	3	0	0	3	0	0
24	38755528	.	T	G	1	2	3	0	0	3	0	0
24	38815105	.	T	A	3	4	7	0	0	7	0	0
24	38815524	.	G	A	5	4	9	0	0	9	0	0
24	38816010	.	G	T	10	5	15	0	0	15	0	0
24	38816340	.	T	G	4	3	7	0	0	7	0	0
24	39051126	.	C	T	4	5	9	0	0	9	0	0
24	39051803	.	A	C	3	6	9	0	4	13	0	0
24	39051981	.	G	A	1	5	6	0	6	12	0	0
24	39052200	.	C	T	7	11	18	0	0	18	0	0
24	39052236	.	G	T	2	9	11	0	12	23	0	0
24	39052302	.	G	A	6	14	20	0	0	20	0	0
24	39052311	.	C	T	12	7	19	0	0	19	0	0
24	39052410	.	C	T	2	6	8	0	0	8	0	0
24	39065978	.	T	C	1	8	9	0	0	9	0	0
24	39073885	.	G	A	0	4	4	0	7	11	0	0
24	39075534	.	T	C	3	9	12	0	2	14	0	0
24	39078597	.	A	G	3	0	3	0	11	14	0	0
24	39081150	.	C	T	4	5	9	0	0	9	0	0
24	39137015	.	C	T	5	6	11	0	1	12	0	0
24	39137027	.	G	C	6	5	11	0	1	12	0	0
24	39137777	.	G	A	0	5	5	0	3	8	0	0
24	39137785	.	G	T	5	5	10	0	0	10	0	0
24	39151148	.	A	G	8	7	15	0	1	16	0	0
24	39151989	.	A	G	17	15	32	0	1	33	0	0
24	39152001	.	A	G	17	9	26	0	2	28	0	0
24	39152504	.	A	G	2	8	10	0	0	10	0	0
24	39153010	.	C	G	8	4	12	1	0	13	0	0
24	39215736	.	G	T	0	2	2	0	2	4	0	0
24	39217192	.	T	C	1	2	3	0	0	3	0	0
24	39217252	.	C	G	3	6	9	0	0	9	0	0
24	39217715	.	G	A	2	3	5	0	1	6	0	0
24	39217846	.	T	C	1	4	5	0	0	5	0	0
24	39217847	.	A	G	1	0	1	0	4	5	0	0
24	39268891	.	A	G	7	10	17	0	1	18	0	0
24	39272041	.	A	G	3	5	8	0	3	11	0	0
24	39274821	.	A	G	5	5	10	0	2	12	0	0
24	39277575	.	C	G	5	6	11	0	0	11	0	0
24	39287210	.	A	G	5	4	9	0	0	9	0	0
24	39295664	.	T	C	8	5	13	0	2	15	0	0
24	39298214	.	C	T	5	4	9	0	1	10	0	0
24	39309684	.	A	G	9	0	9	0	9	18	0	0
24	39309889	.	A	T	12	8	20	0	1	21	0	0
24	39310129	.	G	A	5	6	11	0	0	11	0	0
24	39310163	.	G	T	11	5	16	0	0	16	0	0
24	39310253	.	C	T	13	11	24	0	0	24	0	0
24	39321017	.	T	C	29	16	45	0	0	45	0	0
24	39322945	.	G	T	2	23	25	0	22	47	0	0
24	39323791	.	C	T	25	33	58	0	1	59	0	0
24	39333916	.	C	T	17	25	42	0	0	42	0	0
24	39334153	.	T	G	21	18	39	0	0	39	0	0
24	39334388	.	A	G	18	26	44	0	1	45	0	0
24	39334681	.	G	T	12	41	53	0	3	56	0	0
24	39334796	.	G	A	2	14	16	0	15	31	0	0
24	39353867	.	G	A	3	2	5	0	0	5	0	0
24	39511016	.	T	C	9	7	16	0	0	16	0	0
24	39511034	.	G	A	8	8	16	0	1	17	0	0
24	39511157	.	G	A	5	2	7	0	0	7	0	0
24	39511298	.	A	C	1	4	5	0	1	6	0	0
24	39511477	.	C	T	3	3	6	0	0	6	0	0
24	39511509	.	A	G	4	4	8	0	1	9	0	0
24	39514075	.	A	C	6	13	19	0	1	20	0	0
24	39514296	.	C	G	9	9	18	0	0	18	0	0
24	39518554	.	C	G	0	11	11	0	4	15	0	0
24	39530034	.	G	A	0	2	2	0	4	6	0	0
24	39533337	.	A	G	10	3	13	0	1	14	0	0
24	39533836	.	C	T	3	4	7	0	0	7	0	0
24	39533987	.	T	A	3	12	15	0	1	16	0	0
24	39534214	.	A	G	2	2	4	0	0	4	0	0
24	39534532	.	A	G	3	0	3	0	4	7	0	0
24	39549343	.	G	A	0	3	3	0	2	5	0	0
24	39556276	.	G	T	0	4	4	0	1	5	0	0
24	39556324	.	G	A	5	3	8	0	0	8	0	0
24	39559205	.	T	C	3	3	6	0	0	6	0	0
24	39559386	.	G	A	3	5	8	0	1	9	0	0
24	39576071	.	A	T	4	3	7	0	1	8	0	0
24	39576414	.	C	T	4	6	10	0	1	11	0	0
24	39579443	.	C	T	8	7	15	0	0	15	0	0
24	39579569	.	G	A	3	6	9	0	0	9	0	0
24	39579730	.	A	G	7	6	13	0	2	15	0	0
24	39579989	.	G	A	0	9	9	0	7	16	0	0
24	39586778	.	A	T	6	5	11	0	1	12	0	0
24	39587369	.	C	G	4	5	9	0	1	10	0	0
24	39593009	.	T	C	12	6	18	0	0	18	0	0
24	39593038	.	G	A	0	6	6	0	9	15	0	0
24	39595866	.	A	C	7	7	14	0	0	14	0	0
24	39606237	.	G	A	13	26	39	0	3	42	0	0
24	39610535	.	G	T	14	11	25	0	0	25	0	0
24	39615052	.	A	G	2	2	4	0	0	4	0	0
24	39615224	.	T	G	2	2	4	1	5	12	2	0
24	39615406	.	G	A	19	8	27	2	3	32	0	0
24	39616009	.	A	T	4	2	6	1	0	7	0	0
24	39616010	.	A	G	4	2	6	1	1	8	0	0
24	39616170	.	C	A	6	4	10	0	2	12	0	0
24	39625539	.	T	C	1	3	4	0	0	4	0	0
24	39628474	.	G	A	1	5	6	0	0	6	0	0
24	39638642	.	G	A	20	16	36	0	1	37	0	0
24	39642072	.	A	T	13	8	21	1	0	22	0	0
24	39642220	.	A	G	5	6	11	0	1	12	0	0
24	39642229	.	A	G	5	7	12	0	0	12	0	0
24	39642336	.	C	A	15	8	23	1	1	25	0	0
24	39642361	.	G	T	19	9	28	0	0	28	0	0
24	39644259	.	T	C	17	17	34	0	0	34	0	0
24	39646762	.	C	T	12	26	38	0	1	39	0	0
24	39647021	.	C	T	20	24	44	0	2	46	0	0
24	39647042	.	G	C	18	20	38	0	1	39	0	0
24	39648806	.	C	T	23	27	50	0	3	53	0	0
24	39651567	.	T	G	30	22	52	0	2	54	0	0
24	39651612	.	A	T	26	25	51	0	3	54	0	0
24	39653626	.	G	A	26	18	44	14	3	61	0	0
24	39660219	.	C	T	15	11	26	0	1	27	0	0
24	39661890	.	T	A	9	10	19	0	0	19	0	0
24	39661905	.	C	T	9	10	19	0	0	19	0	0
24	39662074	.	T	C	13	12	25	0	0	25	0	0
24	39663197	.	A	G	11	14	25	0	1	26	0	0
24	39667348	.	T	C	10	15	25	2	0	27	0	0
24	39742273	.	G	A	2	4	6	0	0	6	0	0
24	39742786	.	T	A	5	8	13	0	0	13	0	0
24	39742869	.	G	T	3	9	12	0	0	12	0	0
24	39771659	.	G	T	4	4	8	0	2	10	0	0
24	39779020	.	C	T	4	2	6	0	0	6	0	0
24	39781817	.	T	C	3	3	6	0	0	6	0	0
24	40498708	.	G	A	1	4	5	0	0	5	0	0
24	40498712	.	C	A	1	4	5	0	0	5	0	0
24	40500264	.	A	G	2	0	2	0	4	6	0	0
24	40500267	.	G	A	3	3	6	0	0	6	0	0
24	40608954	.	C	T	9	7	16	0	0	16	0	0
24	40608962	.	G	T	9	6	15	0	0	15	0	0
24	40609001	.	A	G	4	8	12	0	0	12	0	0
24	40624408	.	T	C	5	6	11	0	0	11	0	0
24	40648270	.	C	T	16	23	39	0	2	41	0	0
24	40648284	.	T	A	27	13	40	1	0	41	0	0
24	40821609	.	T	G	3	2	5	0	0	5	0	0
24	40865731	.	T	C	1	2	3	0	0	3	0	0
24	40876839	.	G	A	1	3	4	7	0	11	0	0
24	40876873	.	G	T	2	5	7	1	0	8	0	0
24	40881240	.	T	A	6	2	8	2	0	10	0	0
24	40885816	.	A	G	2	3	5	0	2	7	0	0
24	40885828	.	T	C	2	5	7	0	0	7	0	0
24	40891668	.	G	A	2	4	6	0	0	6	0	0
24	40892759	.	C	T	0	3	3	0	2	5	0	0
24	41246800	.	G	A	2	2	4	0	0	4	0	0
24	41291593	.	T	C	7	6	13	0	1	14	0	0
24	41293409	.	G	A	13	7	20	0	0	20	0	0
24	41299506	.	C	T	5	3	8	0	0	8	0	0
24	41299605	.	A	T	5	2	7	7	1	15	0	0
24	41473576	.	T	C	13	0	13	0	6	19	0	0
24	41953649	.	T	G	23	11	34	0	1	35	0	0
24	41954745	.	A	G	5	0	5	0	7	12	0	0
24	41964610	.	G	A	1	12	13	0	12	25	0	0
24	41964613	.	A	C	13	12	25	0	0	25	0	0
24	41969781	.	C	A	13	24	37	0	4	41	0	0
24	41972519	.	A	G	15	17	32	0	1	33	0	0
24	41972633	.	C	G	19	0	19	0	20	39	0	0
24	41972638	.	A	T	18	17	35	0	2	37	0	0
24	41974704	.	G	A	15	12	27	0	2	29	0	0
24	41974736	.	C	T	16	12	28	0	1	29	0	0
24	41981865	.	A	G	23	25	48	0	5	53	0	0
24	41986273	.	C	T	20	28	48	1	1	50	0	0
24	41986311	.	C	A	25	28	53	0	1	54	0	0
24	41986626	.	G	C	2	21	23	0	19	42	0	0
24	41989196	.	A	C	4	5	9	0	1	10	0	0
24	41989453	.	T	C	6	3	9	0	0	9	0	0
24	41990626	.	A	T	2	7	9	0	0	9	0	0
24	41990821	.	G	A	1	8	9	0	10	19	0	0
24	41991010	.	A	G	11	6	17	0	1	19	1	0
24	42061316	.	T	A	3	3	6	0	0	6	0	0
24	42061364	.	G	T	3	3	6	0	1	7	0	0
24	42083840	.	G	A	18	14	32	0	1	33	0	0
24	42083906	.	G	A	12	11	23	0	0	23	0	0
24	42090574	.	A	T	13	17	30	0	0	30	0	0
24	42094925	.	G	A	8	9	17	1	0	18	0	0
24	42102647	.	G	A	5	2	7	0	0	7	0	0
24	42105278	.	C	A	5	2	7	0	0	7	0	0
24	42108547	.	G	A	2	3	5	0	0	5	0	0
24	42117761	.	A	G	4	8	12	0	1	13	0	0
24	42118145	.	C	T	5	8	13	0	0	13	0	0
24	42120459	.	G	C	3	10	13	0	2	15	0	0
24	42138533	.	A	G	16	1	17	0	17	34	0	0
24	42139889	.	C	T	15	14	29	0	1	30	0	0
24	42141381	.	A	G	4	4	8	0	1	9	0	0
24	42141460	.	C	T	7	8	15	0	4	19	0	0
24	42141461	.	T	C	11	0	11	0	9	20	0	0
24	42141605	.	G	A	4	22	26	4	0	30	0	0
24	42141770	.	T	C	10	22	32	0	0	32	0	0
24	42141793	.	A	G	10	18	28	0	0	28	0	0
24	42142938	.	C	T	11	12	23	0	0	23	0	0
24	42148189	.	G	A	5	12	17	0	3	20	0	0
24	42153199	.	C	T	9	12	21	0	1	22	0	0
24	42153205	.	C	T	9	12	21	0	1	22	0	0
24	42153241	.	A	G	8	11	19	0	4	23	0	0
24	42153476	.	G	A	0	14	14	0	7	21	0	0
24	42153503	.	G	A	7	14	21	0	0	21	0	0
24	42155187	.	T	C	7	15	22	0	0	22	0	0
24	42157498	.	C	T	9	10	19	0	2	21	0	0
24	42157571	.	A	G	11	15	26	0	2	28	0	0
24	42157602	.	C	T	19	12	31	0	0	31	0	0
24	42157817	.	C	T	5	3	8	1	1	10	0	0
25	14095	.	C	T	4	9	13	0	0	13	0	0
25	15467	.	C	T	11	12	23	0	2	25	0	0
25	15542	.	T	C	9	12	21	0	0	21	0	0
25	15764	.	A	G	14	0	14	0	10	24	0	0
25	127683	.	T	G	6	0	6	0	5	11	0	0
25	127770	.	G	T	0	3	3	0	6	9	0	0
25	127786	.	A	G	4	0	4	0	4	8	0	0
25	136788	.	T	C	17	14	31	1	0	32	0	0
25	136857	.	C	T	18	16	34	0	1	35	0	0
25	136986	.	C	T	15	22	37	1	2	40	0	0
25	137043	.	C	A	9	5	14	2	3	19	0	0
25	137492	.	C	A	7	10	17	0	1	18	0	0
25	146159	.	G	A	0	30	30	0	24	54	0	0
25	146282	.	C	T	29	14	43	0	2	46	1	0
25	146735	.	C	G	18	29	47	0	1	48	0	0
25	154440	.	C	T	3	4	7	0	0	7	0	0
25	156522	.	C	T	4	7	11	0	0	11	0	0
25	156608	.	C	T	2	7	9	0	0	9	0	0
25	157151	.	T	C	6	11	17	0	1	18	0	0
25	157157	.	C	T	6	10	16	0	0	16	0	0
25	157389	.	T	C	9	6	15	0	1	16	0	0
25	157996	.	C	A	7	9	16	0	0	16	0	0
25	158641	.	T	C	10	7	17	0	0	17	0	0
25	158770	.	C	T	9	6	15	0	1	16	0	0
25	159510	.	C	T	8	14	22	0	0	22	0	0
25	159543	.	T	C	15	10	25	0	0	25	0	0
25	187241	.	T	G	7	4	11	0	1	12	0	0
25	196495	.	T	C	21	30	51	0	10	61	0	0
25	203396	.	T	C	23	22	45	0	6	51	0	0
25	238295	.	G	C	0	7	7	1	7	15	0	0
25	238588	.	A	G	5	4	9	0	0	9	0	0
25	241694	.	C	T	3	4	7	0	0	7	0	0
25	241695	.	A	G	3	4	7	0	0	7	0	0
25	244115	.	C	T	2	7	9	0	1	10	0	0
25	265570	.	A	G	3	3	6	0	1	7	0	0
25	269134	.	A	C	1	0	1	0	4	5	0	0
25	314968	.	G	C	5	2	7	0	0	7	0	0
25	315157	.	C	T	1	2	3	0	0	3	0	0
25	388320	.	C	A	2	2	4	0	1	5	0	0
25	399691	.	G	A	2	2	4	0	0	4	0	0
25	399984	.	G	T	4	3	7	0	0	7	0	0
25	401363	.	T	C	4	4	8	0	0	8	0	0
25	401558	.	C	A	8	6	14	0	1	15	0	0
25	401810	.	T	C	3	5	8	0	1	9	0	0
25	402152	.	T	C	3	3	6	0	0	6	0	0
25	402348	.	G	A	0	4	4	0	4	8	0	0
25	402359	.	T	G	2	0	2	0	5	7	0	0
25	403590	.	G	T	2	1	3	0	2	5	0	0
25	403592	.	A	T	2	1	3	0	2	5	0	0
25	403761	.	C	T	6	4	10	0	0	10	0	0
25	403935	.	T	G	9	7	16	0	0	16	0	0
25	404795	.	T	A	11	8	19	0	0	19	0	0
25	405253	.	G	A	8	12	20	0	2	22	0	0
25	450354	.	C	T	10	10	20	0	2	22	0	0
25	474938	.	T	A	28	11	39	0	0	39	0	0
25	485437	.	C	T	11	8	19	0	0	19	0	0
25	485612	.	C	T	6	17	23	0	20	43	0	0
25	485772	.	C	A	20	16	36	0	2	39	1	0
25	485802	.	T	C	24	18	42	0	0	42	0	0
25	485847	.	T	C	16	21	37	0	1	38	0	0
25	485863	.	A	T	16	16	32	0	1	33	0	0
25	486284	.	G	A	17	10	27	0	2	29	0	0
25	486472	.	A	T	12	6	18	1	4	23	0	0
25	486712	.	G	A	9	8	17	0	0	17	0	0
25	486895	.	C	T	8	9	17	0	2	19	0	0
25	487039	.	C	A	17	14	31	0	2	33	0	0
25	487045	.	C	T	13	17	30	0	1	31	0	0
25	487078	.	T	G	16	13	29	0	1	30	0	0
25	488701	.	G	C	11	1	12	0	12	24	0	0
25	488817	.	G	T	14	11	25	0	0	25	0	0
25	495366	.	G	A	14	10	24	0	2	26	0	0
25	498814	.	T	C	6	6	12	0	0	12	0	0
25	502608	.	G	A	9	10	19	0	0	19	0	0
25	504837	.	G	A	5	3	8	0	0	8	0	0
25	505214	.	C	T	3	11	14	0	2	16	0	0
25	509223	.	G	T	3	6	9	0	0	9	0	0
25	509625	.	G	A	9	3	12	0	1	13	0	0
25	509744	.	A	T	7	4	11	0	1	12	0	0
25	509899	.	C	T	6	7	13	0	1	14	0	0
25	509917	.	T	A	6	8	14	0	2	16	0	0
25	510000	.	T	G	5	5	10	0	2	12	0	0
25	510505	.	T	C	7	0	7	0	5	12	0	0
25	510514	.	T	A	5	8	13	0	0	13	0	0
25	510645	.	G	A	3	5	8	0	1	9	0	0
25	523342	.	C	T	0	3	3	0	2	5	0	0
25	552560	.	G	A	4	5	9	0	0	9	0	0
25	552872	.	G	A	2	2	4	0	0	4	0	0
25	663178	.	C	T	24	27	51	0	0	51	0	0
25	663284	.	G	A	2	16	18	0	31	49	0	0
25	664590	.	A	C	24	23	47	0	2	49	0	0
25	763774	.	T	C	17	9	26	0	0	26	0	0
25	769484	.	A	G	4	5	9	0	1	10	0	0
25	771140	.	T	G	2	2	4	0	0	4	0	0
25	771625	.	G	A	2	4	6	0	0	6	0	0
25	774360	.	T	C	1	3	4	0	0	4	0	0
25	774366	.	C	A	0	3	3	0	0	3	0	0
25	824627	.	C	T	1	5	6	0	4	10	0	0
25	824774	.	C	T	5	4	9	0	0	9	0	0
25	824807	.	G	A	5	2	7	0	0	7	0	0
25	824881	.	G	T	3	4	7	0	1	8	0	0
25	824909	.	G	A	5	4	9	0	0	9	0	0
25	825656	.	G	A	2	2	4	0	0	4	0	0
25	825704	.	A	C	1	0	1	0	4	5	0	0
25	825746	.	T	C	2	0	2	0	4	6	0	0
25	825805	.	G	T	4	3	7	0	0	7	0	0
25	825842	.	T	A	1	4	5	0	0	5	0	0
25	825866	.	G	A	1	5	6	0	0	6	0	0
25	825902	.	G	T	5	2	7	0	1	8	0	0
25	825968	.	A	C	6	2	8	0	2	10	0	0
25	826445	.	G	T	6	2	8	0	0	8	0	0
25	826745	.	G	A	5	2	7	0	0	7	0	0
25	827027	.	C	T	3	4	7	0	0	7	0	0
25	827246	.	A	G	2	2	4	0	0	5	1	0
25	827255	.	G	A	2	3	5	0	0	5	0	0
25	1048457	.	C	T	1	2	3	0	0	3	0	0
25	1049940	.	C	T	0	2	2	0	2	4	0	0
25	1049967	.	G	A	1	4	5	0	0	5	0	0
25	1055072	.	G	A	1	2	3	0	0	3	0	0
25	1088800	.	A	G	1	5	6	0	0	6	0	0
25	1089010	.	G	A	21	12	33	0	1	34	0	0
25	1089026	.	G	A	17	12	29	0	0	29	0	0
25	1091806	.	G	A	10	14	24	0	0	24	0	0
25	1092442	.	C	A	0	8	8	0	6	14	0	0
25	1092451	.	C	T	10	6	16	0	0	16	0	0
25	1093520	.	G	A	6	4	10	0	1	11	0	0
25	1093567	.	G	A	8	6	14	0	3	17	0	0
25	1101431	.	A	G	2	6	8	0	0	8	0	0
25	1101659	.	A	G	6	5	11	0	0	11	0	0
25	1101704	.	C	G	4	4	8	0	2	10	0	0
25	1101707	.	G	A	3	6	9	0	0	9	0	0
25	1103369	.	G	T	5	7	12	0	0	12	0	0
25	1103980	.	G	A	2	5	7	0	0	7	0	0
25	1104000	.	T	C	4	3	7	0	0	7	0	0
25	1105866	.	A	G	1	2	3	0	0	3	0	0
25	1106187	.	G	A	5	4	9	0	0	9	0	0
25	1106247	.	C	G	1	2	3	0	1	4	0	0
25	1107992	.	G	A	3	10	13	0	2	15	0	0
25	1108057	.	T	C	2	0	2	0	5	7	0	0
25	1108210	.	G	A	4	5	9	0	0	9	0	0
25	1108222	.	T	C	5	0	5	0	7	12	0	0
25	1112046	.	G	A	1	2	3	0	0	3	0	0
25	1112164	.	G	T	3	4	7	0	0	7	0	0
25	1124405	.	C	T	0	3	3	0	6	9	0	0
25	1124488	.	C	G	4	3	7	0	0	7	0	0
25	1132509	.	G	A	10	14	24	0	0	24	0	0
25	1132543	.	G	A	12	13	25	0	1	26	0	0
25	1132628	.	G	A	4	3	7	0	0	7	0	0
25	1132630	.	A	C	3	4	7	0	0	7	0	0
25	1220400	.	G	T	3	10	13	0	0	13	0	0
25	1235287	.	G	A	3	3	6	0	0	7	1	0
25	1304556	.	G	A	4	4	8	0	0	8	0	0
25	1305338	.	T	G	10	8	18	0	1	19	0	0
25	1335681	.	G	A	2	3	5	0	0	5	0	0
25	1335805	.	T	C	2	2	4	0	0	4	0	0
25	1335814	.	T	C	3	2	5	0	0	5	0	0
25	1338263	.	C	T	3	6	9	0	0	9	0	0
25	1338272	.	G	T	3	2	5	0	1	6	0	0
25	1339403	.	C	T	11	7	18	0	1	19	0	0
25	1339601	.	G	T	1	3	4	0	4	8	0	0
25	1339760	.	C	T	4	5	9	0	0	9	0	0
25	1340215	.	G	A	3	6	9	0	0	9	0	0
25	2264091	.	C	A	3	4	7	0	0	7	0	0
25	2264112	.	T	C	1	5	6	0	0	6	0	0
25	2264875	.	C	A	1	4	5	0	0	5	0	0
25	2273945	.	C	T	2	7	9	0	1	10	0	0
25	2276602	.	C	G	0	2	2	0	0	2	0	0
25	2276623	.	A	T	0	2	2	0	1	3	0	0
25	2276770	.	T	C	4	5	9	0	2	11	0	0
25	2276781	.	A	G	6	7	13	0	0	13	0	0
25	2276828	.	T	A	4	6	10	0	0	10	0	0
25	2276869	.	C	T	1	3	4	0	0	4	0	0
25	2282566	.	A	G	15	1	16	0	13	29	0	0
25	2282846	.	A	C	14	14	28	0	1	29	0	0
25	2286066	.	C	T	11	19	30	0	2	32	0	0
25	2286120	.	G	A	9	12	21	0	2	23	0	0
25	2286328	.	T	G	7	3	10	0	0	10	0	0
25	2286376	.	T	C	4	5	9	0	3	12	0	0
25	2286502	.	T	C	15	8	23	0	0	23	0	0
25	2286600	.	A	T	9	11	20	0	4	24	0	0
25	2286762	.	A	C	11	8	19	0	1	20	0	0
25	2286798	.	A	C	14	11	25	0	2	28	1	0
25	2286837	.	C	T	11	16	27	0	2	30	1	0
25	2286841	.	C	A	12	15	27	0	3	30	0	0
25	2702712	.	A	G	7	3	10	0	1	11	0	0
25	2702722	.	A	G	11	3	14	0	0	14	0	0
25	3245895	.	A	G	4	6	10	0	0	10	0	0
25	3246593	.	A	G	13	6	19	0	0	19	0	0
25	3319366	.	G	A	1	2	3	0	0	3	0	0
25	3393296	.	G	A	1	9	10	0	0	10	0	0
25	3881331	.	A	G	3	3	6	0	0	6	0	0
25	3881346	.	A	G	3	3	6	0	0	6	0	0
25	4689513	.	A	G	1	0	1	0	2	3	0	0
25	4689688	.	A	G	4	2	6	0	0	6	0	0
25	4893059	.	G	A	1	3	4	1	0	5	0	0
25	5676227	.	C	T	8	2	10	0	1	11	0	0
25	6042820	.	C	T	3	3	6	0	0	6	0	0
25	6350336	.	G	A	6	2	8	0	1	9	0	0
25	6403852	.	T	C	1	6	7	0	0	7	0	0
25	6403853	.	T	C	3	4	7	0	0	7	0	0
25	7229255	.	T	A	1	2	3	0	0	3	0	0
25	7229462	.	A	C	2	3	5	0	0	5	0	0
25	7230239	.	T	C	7	6	13	0	1	14	0	0
25	7324580	.	C	T	12	11	23	1	0	24	0	0
25	7327718	.	C	T	17	13	30	0	0	30	0	0
25	7333751	.	G	A	18	17	35	0	1	36	0	0
25	7333841	.	C	T	17	19	36	0	3	40	1	0
25	7334900	.	A	G	15	0	15	0	22	37	0	0
25	7334951	.	T	C	16	15	31	0	3	34	0	0
25	7334987	.	G	C	18	11	29	0	0	29	0	0
25	7336096	.	T	A	11	14	25	0	2	27	0	0
25	7336269	.	A	G	3	3	6	0	1	7	0	0
25	7401539	.	C	T	2	2	4	0	0	4	0	0
25	7401580	.	A	G	2	2	4	0	0	4	0	0
25	7410399	.	A	G	2	5	7	0	0	7	0	0
25	7410558	.	C	A	2	5	7	0	0	7	0	0
25	7410645	.	G	A	3	6	9	0	0	9	0	0
25	7410822	.	G	A	0	3	3	0	1	4	0	0
25	7412640	.	T	G	4	3	7	0	1	8	0	0
25	7413288	.	T	A	4	8	12	0	1	13	0	0
25	7413501	.	C	T	1	4	5	0	2	7	0	0
25	7428932	.	A	C	6	3	9	0	0	9	0	0
25	7428944	.	T	C	5	3	8	0	0	8	0	0
25	7428971	.	A	T	2	4	6	0	0	6	0	0
25	7429028	.	C	A	3	3	6	0	0	6	0	0
25	7431288	.	T	G	2	5	7	0	0	7	0	0
25	7431310	.	A	C	4	3	7	0	1	8	0	0
25	7431626	.	T	C	2	3	5	0	0	5	0	0
25	7454578	.	T	C	4	5	9	0	1	10	0	0
25	7454599	.	T	C	6	4	10	0	0	10	0	0
25	7456535	.	C	A	3	5	8	0	0	8	0	0
25	7456843	.	G	A	0	4	4	0	6	10	0	0
25	7456860	.	G	A	1	5	6	0	3	9	0	0
25	7477641	.	C	T	12	14	26	0	2	28	0	0
25	7487835	.	G	C	18	29	47	0	1	48	0	0
25	7488407	.	T	C	17	24	41	0	1	42	0	0
25	7488599	.	G	T	15	10	25	0	3	28	0	0
25	7488660	.	C	T	27	7	34	0	0	34	0	0
25	7488812	.	G	A	30	20	50	0	2	52	0	0
25	7488813	.	G	T	32	19	51	0	2	53	0	0
25	7489011	.	A	T	24	30	54	0	3	57	0	0
25	7489034	.	G	A	2	19	21	0	35	56	0	0
25	7489197	.	G	T	11	15	26	0	2	28	0	0
25	7492888	.	C	T	2	2	4	0	1	5	0	0
25	7492927	.	T	A	2	2	4	0	0	4	0	0
25	7494243	.	G	A	1	2	3	0	5	8	0	0
25	7496003	.	C	T	3	3	6	0	0	6	0	0
25	7496039	.	C	T	5	3	8	0	0	8	0	0
25	7496992	.	G	C	0	6	6	0	10	16	0	0
25	7500473	.	T	C	20	22	42	0	0	42	0	0
25	7501997	.	G	A	11	9	20	0	1	21	0	0
25	7502022	.	G	C	10	10	20	0	1	21	0	0
25	7502119	.	T	C	14	7	21	0	0	21	0	0
25	7502241	.	G	A	7	3	10	0	1	11	0	0
25	7502271	.	T	G	6	0	6	0	7	13	0	0
25	7520376	.	T	A	3	2	5	0	0	5	0	0
25	7719407	.	T	A	2	3	5	0	1	6	0	0
25	7825948	.	A	T	1	9	10	0	0	10	0	0
25	7890599	.	T	C	7	4	11	0	0	11	0	0
25	7890814	.	T	C	2	2	4	0	1	5	0	0
25	7891836	.	T	C	1	2	3	0	0	3	0	0
25	7892019	.	T	C	2	0	2	0	3	5	0	0
25	8739810	.	C	G	3	0	3	0	9	12	0	0
25	9011153	.	T	C	1	3	4	0	0	4	0	0
25	9678666	.	G	A	10	9	19	0	3	22	0	0
25	9679242	.	G	A	17	13	30	0	0	30	0	0
25	9679389	.	G	A	7	7	14	0	0	14	0	0
25	9679413	.	C	T	0	6	6	0	6	12	0	0
25	9679539	.	T	C	4	7	11	0	0	11	0	0
25	9680022	.	T	C	2	8	10	0	0	10	0	0
25	9680196	.	T	A	3	2	5	0	0	5	0	0
25	9680448	.	A	G	5	6	11	0	0	11	0	0
25	9805253	.	G	C	3	5	8	0	0	8	0	0
25	9805257	.	G	C	3	6	9	0	0	9	0	0
25	11377080	.	G	A	5	2	7	0	0	7	0	0
25	11796531	.	T	C	13	0	13	0	16	29	0	0
25	11796579	.	T	A	19	22	41	0	1	42	0	0
25	11796728	.	A	T	13	16	29	0	1	30	0	0
25	11796860	.	T	C	10	18	28	0	1	29	0	0
25	11796973	.	T	C	12	0	12	0	10	22	0	0
25	11796987	.	A	G	11	9	20	0	1	21	0	0
25	11797056	.	G	C	12	4	16	0	2	18	0	0
25	11797515	.	A	G	14	9	23	0	0	23	0	0
25	11797550	.	G	T	12	11	23	0	0	23	0	0
25	11797789	.	A	T	4	7	11	0	1	12	0	0
25	11797912	.	T	A	8	3	11	0	0	11	0	0
25	11797979	.	A	G	7	6	13	0	0	13	0	0
25	11797990	.	A	G	5	7	12	0	0	12	0	0
25	11798043	.	G	A	4	6	10	0	0	10	0	0
25	11798081	.	T	C	7	0	7	0	6	13	0	0
25	11798215	.	A	C	11	10	21	0	0	21	0	0
25	11798227	.	T	A	9	8	17	0	0	17	0	0
25	11798333	.	A	T	7	4	11	1	2	14	0	0
25	11798381	.	T	A	10	6	16	0	0	16	0	0
25	11798509	.	A	T	7	16	23	0	1	24	0	0
25	11798511	.	C	A	0	17	17	0	5	22	0	0
25	11798598	.	C	T	1	6	7	0	0	7	0	0
25	11798863	.	G	C	2	2	4	0	0	4	0	0
25	11798922	.	A	G	4	6	10	0	0	10	0	0
25	11799527	.	A	T	9	5	14	0	0	14	0	0
25	11799577	.	G	A	11	5	16	0	1	17	0	0
25	11799625	.	A	T	13	6	19	0	2	21	0	0
25	11799670	.	G	T	8	7	15	0	1	16	0	0
25	11799685	.	A	G	9	4	13	0	0	13	0	0
25	11799945	.	T	C	9	2	11	0	0	11	0	0
25	11799954	.	G	T	8	4	12	0	0	12	0	0
25	11800098	.	G	C	7	5	12	0	0	12	0	0
25	11800140	.	A	G	6	8	14	0	0	14	0	0
25	11800319	.	T	G	3	4	7	0	0	7	0	0
25	11800328	.	C	T	1	3	4	0	3	7	0	0
25	11800522	.	G	A	6	6	12	0	1	13	0	0
25	11800652	.	C	T	1	8	9	0	5	14	0	0
25	11800883	.	C	T	5	3	8	0	0	8	0	0
25	11801111	.	C	A	3	4	7	0	0	7	0	0
25	11801513	.	A	C	6	3	9	0	0	9	0	0
25	11801642	.	C	G	4	7	11	0	0	11	0	0
25	11801731	.	C	G	5	6	11	0	1	12	0	0
25	11801838	.	A	C	2	0	2	0	5	7	0	0
25	11801841	.	G	T	2	4	6	0	1	7	0	0
25	11802066	.	C	G	1	2	3	0	0	3	0	0
25	11802115	.	C	A	2	2	4	0	0	4	0	0
25	11802306	.	C	A	0	7	7	0	8	15	0	0
25	11802485	.	C	T	1	3	4	0	9	13	0	0
25	11803455	.	G	T	9	4	13	0	0	13	0	0
25	11803467	.	A	T	7	4	11	0	0	11	0	0
25	11803813	.	T	A	1	2	3	0	0	4	1	0
25	11803817	.	A	T	3	2	5	0	0	5	0	0
25	11803850	.	T	G	0	2	2	0	1	3	0	0
25	11805675	.	T	A	2	2	4	0	0	4	0	0
25	11805841	.	A	G	1	2	3	0	0	3	0	0
25	12853211	.	C	T	0	3	3	0	1	4	0	0
25	12853691	.	C	T	13	41	54	0	1	55	0	0
25	12853811	.	G	A	24	12	36	0	2	38	0	0
25	12853971	.	T	A	17	36	53	0	1	54	0	0
25	12854112	.	C	T	36	12	48	0	4	52	0	0
25	12854266	.	A	T	14	26	40	4	3	47	0	0
25	13104333	.	C	A	1	4	5	0	4	9	0	0
25	13104393	.	T	C	4	4	8	0	2	10	0	0
25	13105029	.	A	G	3	2	5	0	0	5	0	0
25	13105061	.	A	G	1	2	3	0	0	3	0	0
25	13332531	.	C	T	35	25	60	0	2	62	0	0
25	13332693	.	G	A	37	37	74	0	3	77	0	0
25	13332737	.	A	G	31	43	74	0	9	83	0	0
25	13333027	.	A	G	39	29	68	4	2	74	0	0
25	13333287	.	A	G	27	38	65	0	7	73	1	0
25	13333986	.	T	A	42	39	81	0	2	83	0	0
25	13333994	.	C	T	38	38	76	0	5	81	0	0
25	13334023	.	T	A	43	29	72	0	3	75	0	0
25	13334049	.	A	T	41	30	71	0	3	74	0	0
25	13334061	.	A	G	37	32	69	0	3	72	0	0
25	13334334	.	A	T	33	30	63	0	4	67	0	0
25	13334371	.	T	C	24	38	62	0	1	63	0	0
25	13334397	.	C	G	31	31	62	0	3	65	0	0
25	13334429	.	T	C	33	29	62	0	4	66	0	0
25	13334526	.	A	G	43	19	62	0	2	64	0	0
25	13334537	.	T	C	46	0	46	0	15	61	0	0
25	13334729	.	C	T	40	31	71	0	4	75	0	0
25	13335021	.	G	T	31	26	57	0	8	66	1	0
25	13335059	.	G	C	36	30	66	0	3	69	0	0
25	13335078	.	A	G	32	29	61	0	2	63	0	0
25	13335185	.	A	G	28	29	57	0	4	61	0	0
25	13335225	.	T	C	32	28	60	1	2	63	0	0
25	13335331	.	T	C	31	33	64	0	3	67	0	0
25	13335359	.	C	T	6	34	40	1	31	72	0	0
25	13335524	.	T	C	27	27	54	0	5	59	0	0
25	13335892	.	A	G	26	28	54	0	1	55	0	0
25	13335897	.	T	C	28	26	54	0	1	55	0	0
25	13336236	.	G	T	44	12	56	0	0	56	0	0
25	13336391	.	G	A	33	34	67	0	2	69	0	0
25	13336409	.	A	C	33	33	66	0	2	69	1	0
25	13336755	.	G	T	35	31	66	0	3	69	0	0
25	13336780	.	A	G	35	34	69	0	1	70	0	0
25	13336815	.	T	A	35	28	63	0	4	67	0	0
25	13336967	.	T	A	24	34	58	0	1	59	0	0
25	13337044	.	G	A	30	24	54	1	3	58	0	0
25	13337136	.	A	G	28	31	59	0	2	61	0	0
25	13340180	.	C	T	46	22	68	1	0	69	0	0
25	13346723	.	G	A	26	32	58	0	1	59	0	0
25	13346730	.	A	G	26	35	61	0	0	61	0	0
25	13350259	.	A	G	23	32	55	0	2	57	0	0
25	13351894	.	T	A	16	32	48	0	7	55	0	0
25	13352304	.	T	A	30	13	43	0	4	47	0	0
25	13352316	.	A	G	32	17	49	0	1	50	0	0
25	13353747	.	G	A	28	22	50	0	1	51	0	0
25	13469844	.	A	G	18	1	19	0	14	33	0	0
25	13469858	.	T	C	17	16	33	0	2	35	0	0
25	13470424	.	C	T	9	17	26	0	0	26	0	0
25	13470430	.	A	T	12	17	29	0	0	29	0	0
25	13470544	.	A	T	7	7	14	1	1	16	0	0
25	13471127	.	A	G	22	1	23	0	12	35	0	0
25	13474246	.	C	T	4	3	7	0	0	7	0	0
25	13474362	.	C	G	2	9	11	0	0	11	0	0
25	13474411	.	A	G	7	7	14	1	0	15	0	0
25	13479710	.	G	A	5	3	8	0	1	9	0	0
25	13525407	.	G	A	12	14	26	0	0	26	0	0
25	13525453	.	C	T	18	12	30	0	0	30	0	0
25	13525521	.	A	C	7	11	18	0	0	18	0	0
25	13525633	.	A	C	6	8	14	0	1	15	0	0
25	13525848	.	A	T	13	11	24	0	2	26	0	0
25	13525864	.	G	A	17	9	26	0	1	27	0	0
25	13525890	.	A	C	15	11	26	0	2	28	0	0
25	13526171	.	A	C	22	10	32	0	2	34	0	0
25	13559168	.	T	G	3	5	8	0	0	8	0	0
25	13559194	.	G	A	6	6	12	0	1	13	0	0
25	13559220	.	G	A	9	12	21	0	3	24	0	0
25	13559446	.	T	A	10	13	23	0	2	25	0	0
25	13559500	.	T	C	6	10	16	0	0	16	0	0
25	13559723	.	T	A	4	10	14	0	0	14	0	0
25	13559740	.	A	G	4	12	16	0	0	16	0	0
25	13559760	.	T	C	4	0	4	0	10	14	0	0
25	13559953	.	A	T	11	7	18	1	2	21	0	0
25	13560080	.	C	T	3	8	11	0	2	13	0	0
25	13560136	.	C	T	4	10	14	0	0	14	0	0
25	13560149	.	C	T	4	7	11	0	0	11	0	0
25	13560186	.	A	G	9	5	14	0	1	15	0	0
25	13560207	.	T	C	10	7	17	0	1	18	0	0
25	13560414	.	T	C	14	0	14	0	9	23	0	0
25	13560420	.	T	C	14	9	23	0	0	23	0	0
25	13560547	.	C	T	2	12	14	0	11	25	0	0
25	13560576	.	C	T	9	13	22	0	0	22	0	0
25	13560598	.	T	G	9	10	19	0	0	19	0	0
25	13560638	.	C	A	5	6	11	0	1	12	0	0
25	13561065	.	T	C	2	1	3	0	1	4	0	0
25	13561133	.	T	C	4	6	10	0	0	10	0	0
25	13561149	.	T	C	4	2	6	0	0	6	0	0
25	13561296	.	A	G	3	4	7	0	0	7	0	0
25	13561775	.	C	A	0	3	3	0	5	8	0	0
25	13561851	.	A	C	4	3	7	0	0	7	0	0
25	13562742	.	T	C	5	1	6	0	5	11	0	0
25	13614475	.	G	C	2	0	2	0	5	7	0	0
25	13614509	.	C	G	2	5	7	0	0	7	0	0
25	13614536	.	C	T	0	3	3	0	1	4	0	0
25	13614593	.	G	A	2	3	5	0	0	5	0	0
25	13645911	.	C	T	21	12	33	0	1	34	0	0
25	13646153	.	G	A	11	10	21	0	0	23	2	0
25	13649206	.	C	T	1	9	10	0	8	18	0	0
25	13651394	.	A	T	9	9	18	0	0	18	0	0
25	13658316	.	C	T	1	8	9	0	17	26	0	0
25	13658940	.	G	A	11	4	15	1	1	17	0	0
25	13658976	.	T	C	12	0	12	0	6	18	0	0
25	13659075	.	T	A	7	10	17	0	1	18	0	0
25	13659156	.	T	C	2	2	4	0	0	4	0	0
25	13672226	.	C	T	7	3	10	0	2	12	0	0
25	13672296	.	T	G	6	3	9	0	0	9	0	0
25	13672349	.	G	A	4	2	6	0	0	6	0	0
25	13672629	.	A	C	5	6	11	0	0	11	0	0
25	13673377	.	A	G	5	2	7	0	0	7	0	0
25	13674202	.	A	G	3	2	5	0	1	6	0	0
25	13674214	.	A	G	4	2	6	0	0	6	0	0
25	13677396	.	A	G	2	3	5	0	0	5	0	0
25	13680295	.	A	G	3	3	6	0	0	6	0	0
25	13685517	.	T	C	1	6	7	0	0	7	0	0
25	13689341	.	T	C	1	7	8	0	3	11	0	0
25	13689486	.	T	C	2	0	2	0	6	8	0	0
25	13689575	.	A	G	6	3	9	0	1	10	0	0
25	13689612	.	A	G	5	1	6	0	2	8	0	0
25	13689617	.	C	A	5	3	8	0	1	9	0	0
25	13689945	.	G	A	2	3	5	0	2	7	0	0
25	13744547	.	G	T	2	3	5	0	0	5	0	0
25	13744587	.	T	C	1	3	4	0	0	5	1	0
25	13745659	.	A	G	31	32	63	0	2	65	0	0
25	13745665	.	A	G	32	34	66	0	0	66	0	0
25	13745776	.	A	G	31	24	55	0	3	58	0	0
25	13745788	.	A	C	36	0	36	0	21	57	0	0
25	13747722	.	G	C	36	1	37	0	26	63	0	0
25	13747948	.	T	C	15	2	17	0	26	43	0	0
25	13750734	.	T	A	16	19	35	0	1	36	0	0
25	13754015	.	A	G	13	22	35	0	2	37	0	0
25	13754094	.	T	A	19	16	35	0	4	39	0	0
25	13754338	.	T	G	19	15	34	0	3	37	0	0
25	13754359	.	A	G	17	16	33	0	0	33	0	0
25	13759547	.	G	A	13	15	28	0	3	31	0	0
25	13762889	.	T	C	7	11	18	0	2	20	0	0
25	13763626	.	A	G	3	8	11	0	0	11	0	0
25	13763641	.	C	T	2	6	8	0	1	9	0	0
25	13767612	.	G	A	8	7	15	0	0	15	0	0
25	13767726	.	G	A	8	9	17	0	0	17	0	0
25	13768396	.	G	A	8	7	15	0	1	16	0	0
25	13768547	.	A	G	8	8	16	0	1	17	0	0
25	13774036	.	C	T	2	7	9	0	1	10	0	0
25	13774400	.	G	A	6	10	16	0	0	16	0	0
25	13775158	.	A	G	7	6	13	0	1	14	0	0
25	13776771	.	T	A	7	7	14	0	0	14	0	0
25	13780322	.	C	G	3	5	8	0	3	11	0	0
25	13782361	.	T	C	3	2	5	0	0	5	0	0
25	13782376	.	A	G	3	3	6	0	0	6	0	0
25	13787514	.	A	T	4	6	10	0	0	10	0	0
25	13791853	.	A	C	9	8	17	0	0	17	0	0
25	13795332	.	G	A	20	6	26	0	1	27	0	0
25	13795440	.	T	C	20	18	38	0	1	39	0	0
25	13795441	.	G	A	21	17	38	0	2	40	0	0
25	13795494	.	A	G	27	19	46	0	1	47	0	0
25	13796379	.	T	C	28	15	43	0	3	46	0	0
25	13799172	.	G	A	4	6	10	0	0	10	0	0
25	13799689	.	C	T	8	21	29	0	1	30	0	0
25	13801895	.	G	C	21	17	38	0	0	38	0	0
25	13801933	.	C	T	18	12	30	0	1	31	0	0
25	13802100	.	C	T	25	15	40	0	3	43	0	0
25	13802235	.	T	A	12	10	22	0	1	23	0	0
25	13802673	.	C	T	2	11	13	0	14	27	0	0
25	13802688	.	C	A	15	14	29	0	1	30	0	0
25	13802876	.	G	A	16	20	36	0	2	38	0	0
25	13802901	.	G	A	16	22	38	0	1	39	0	0
25	13802918	.	A	G	18	19	37	0	0	37	0	0
25	13802940	.	A	T	22	17	39	0	0	39	0	0
25	13803710	.	A	G	16	15	31	0	0	31	0	0
25	13803712	.	T	G	16	15	31	0	0	31	0	0
25	13803895	.	A	G	18	10	28	0	0	28	0	0
25	13803903	.	C	T	9	16	25	0	1	26	0	0
25	13804056	.	C	T	11	16	27	0	4	31	0	0
25	13804097	.	T	A	11	22	33	0	1	34	0	0
25	13804216	.	C	T	13	16	29	0	2	31	0	0
25	13813656	.	A	G	19	16	35	0	1	36	0	0
25	13813659	.	G	A	18	15	33	0	3	36	0	0
25	13815325	.	G	A	6	16	22	0	0	22	0	0
25	13815361	.	A	G	15	10	25	0	1	26	0	0
25	13816724	.	G	A	12	10	22	0	1	23	0	0
25	13816840	.	C	T	0	10	10	0	6	16	0	0
25	13817135	.	C	G	7	11	18	0	0	18	0	0
25	13817243	.	C	T	0	9	9	0	14	23	0	0
25	13821187	.	C	T	10	10	20	0	0	20	0	0
25	13846984	.	A	G	5	7	12	0	2	14	0	0
25	13847533	.	A	G	11	10	21	1	1	23	0	0
25	13848801	.	G	A	15	13	28	0	2	30	0	0
25	13848930	.	A	G	21	20	41	0	0	41	0	0
25	13850757	.	A	C	22	19	41	0	3	44	0	0
25	13854838	.	G	A	10	7	17	0	0	17	0	0
25	13855707	.	T	A	14	6	20	0	1	21	0	0
25	13856023	.	C	A	2	6	8	0	7	15	0	0
25	13871070	.	C	T	11	6	17	0	0	17	0	0
25	14018007	.	T	C	5	3	8	0	0	8	0	0
25	14018872	.	T	G	5	3	8	0	0	8	0	0
25	14019921	.	G	A	0	9	9	0	7	16	0	0
25	14020923	.	C	A	7	2	9	0	0	9	0	0
25	14020924	.	A	C	7	2	9	0	0	9	0	0
25	14020973	.	C	T	4	3	7	0	0	7	0	0
25	14021000	.	A	C	5	4	9	0	0	9	0	0
25	14021062	.	A	G	1	2	3	0	0	3	0	0
25	14021070	.	T	C	1	2	3	0	0	3	0	0
25	14033268	.	T	C	17	16	33	0	2	35	0	0
25	14033670	.	T	G	12	8	20	0	1	21	0	0
25	14033867	.	A	G	9	5	14	0	0	14	0	0
25	14033914	.	G	A	10	3	13	0	0	13	0	0
25	14034065	.	T	C	5	5	10	0	0	10	0	0
25	14034240	.	G	C	20	14	34	0	2	36	0	0
25	14034398	.	C	T	14	9	23	0	0	23	0	0
25	14034406	.	G	A	11	10	21	0	2	23	0	0
25	14034512	.	C	T	22	8	30	0	0	30	0	0
25	14034513	.	T	A	21	5	26	0	3	29	0	0
25	14034620	.	A	G	6	9	15	0	3	18	0	0
25	14034667	.	C	T	11	13	24	0	0	24	0	0
25	14034725	.	T	A	8	11	19	0	0	19	0	0
25	14034881	.	T	C	9	7	16	0	0	16	0	0
25	14034911	.	C	G	10	7	17	0	0	17	0	0
25	14035012	.	T	G	8	11	19	0	0	19	0	0
25	14035017	.	T	A	6	13	19	0	1	20	0	0
25	14035229	.	C	T	5	5	10	0	0	10	0	0
25	14035247	.	T	G	5	7	12	0	0	12	0	0
25	14035278	.	C	A	1	8	9	0	6	15	0	0
25	14035292	.	C	T	6	7	13	0	1	14	0	0
25	14035414	.	A	T	13	8	21	0	3	24	0	0
25	14035500	.	T	G	7	8	15	0	0	15	0	0
25	14035559	.	T	G	9	4	13	0	0	14	1	0
25	14035908	.	A	C	8	4	12	0	0	12	0	0
25	14351449	.	C	T	4	3	7	0	0	7	0	0
25	14351932	.	G	A	1	2	3	0	2	5	0	0
25	14361812	.	C	T	8	6	14	0	2	16	0	0
25	14363216	.	C	T	11	16	27	0	2	29	0	0
25	14363291	.	T	A	12	9	21	0	2	23	0	0
25	14363572	.	G	T	12	14	26	0	0	26	0	0
25	14365546	.	G	A	19	19	38	0	3	41	0	0
25	14365781	.	C	T	17	17	34	0	0	34	0	0
25	14365834	.	C	T	12	14	26	0	2	28	0	0
25	14366056	.	T	A	14	17	31	0	2	33	0	0
25	14369631	.	C	T	10	5	15	0	2	17	0	0
25	14369712	.	G	A	12	15	27	0	8	35	0	0
25	14369869	.	T	A	7	7	14	0	2	16	0	0
25	14369883	.	T	C	12	4	16	0	8	24	0	0
25	14374076	.	G	A	5	4	9	0	2	11	0	0
25	14381497	.	T	G	2	3	5	0	1	6	0	0
25	14381513	.	G	T	4	7	11	0	1	12	0	0
25	14381583	.	A	G	13	14	27	0	1	28	0	0
25	14381763	.	G	A	17	17	34	0	0	34	0	0
25	14384028	.	G	T	19	15	34	0	4	38	0	0
25	14387616	.	C	T	16	19	35	0	2	37	0	0
25	14388955	.	A	T	10	13	23	0	1	24	0	0
25	14392808	.	C	G	10	15	25	0	0	25	0	0
25	14393533	.	A	G	13	11	24	0	2	26	0	0
25	14398703	.	A	C	5	2	7	1	0	8	0	0
25	14398744	.	A	T	8	10	18	1	0	19	0	0
25	14401150	.	C	T	8	9	17	0	0	17	0	0
25	14401219	.	C	A	8	4	12	0	2	14	0	0
25	14403369	.	T	C	16	13	29	0	0	29	0	0
25	14403404	.	C	T	11	13	24	0	0	24	0	0
25	14406608	.	A	C	9	8	17	0	0	17	0	0
25	14406621	.	T	C	8	8	16	0	1	17	0	0
25	14406649	.	A	T	8	3	11	0	0	11	0	0
25	14409099	.	A	T	3	4	7	0	1	8	0	0
25	14409222	.	T	A	3	2	5	0	1	6	0	0
25	14409257	.	A	C	6	0	6	0	4	10	0	0
25	14409642	.	G	A	2	9	11	0	0	11	0	0
25	14409936	.	T	C	3	0	3	0	5	8	0	0
25	14426595	.	A	T	2	2	4	0	0	4	0	0
25	14511422	.	T	C	3	2	5	0	1	6	0	0
25	14511458	.	T	A	3	4	7	0	0	7	0	0
25	14511470	.	G	T	3	4	7	0	1	8	0	0
25	14511493	.	G	T	5	2	7	0	0	7	0	0
25	14513992	.	C	T	5	3	8	0	0	8	0	0
25	14516439	.	A	T	1	3	4	0	0	4	0	0
25	14518722	.	C	T	1	3	4	0	0	4	0	0
25	14518815	.	A	G	2	2	4	0	0	4	0	0
25	14694979	.	T	C	4	5	9	0	0	9	0	0
25	14695065	.	T	C	4	2	6	0	0	6	0	0
25	14695092	.	C	T	5	5	10	0	0	10	0	0
25	14695122	.	A	G	2	0	2	0	6	8	0	0
25	14702821	.	C	T	6	3	9	0	0	9	0	0
25	14733824	.	C	T	3	7	10	0	2	12	0	0
25	14734122	.	A	G	6	6	12	0	1	13	0	0
25	14738244	.	A	G	4	3	7	0	0	7	0	0
25	14738298	.	T	C	4	2	6	0	0	6	0	0
25	14738535	.	A	T	6	3	9	0	0	9	0	0
25	14738541	.	T	C	6	3	9	0	0	9	0	0
25	14870811	.	T	C	2	3	5	0	0	5	0	0
25	15029225	.	C	T	7	7	14	0	0	14	0	0
25	15031773	.	G	A	13	9	22	0	1	23	0	0
25	15031851	.	A	G	15	14	29	0	1	30	0	0
25	15032087	.	A	G	12	11	23	0	1	24	0	0
25	15034012	.	C	T	1	6	7	0	7	14	0	0
25	15045221	.	T	A	2	3	5	0	0	5	0	0
25	15273455	.	A	T	4	5	9	0	1	10	0	0
25	15275985	.	G	A	1	4	5	0	0	5	0	0
25	15281889	.	C	T	4	9	13	0	2	15	0	0
25	15281891	.	A	G	4	11	15	0	0	15	0	0
25	15284485	.	T	C	10	3	13	0	0	13	0	0
25	15284644	.	C	G	8	0	8	0	5	13	0	0
25	15284734	.	G	T	16	17	33	0	1	34	0	0
25	15284799	.	C	T	10	12	22	0	4	26	0	0
25	15284862	.	T	C	21	9	30	0	1	31	0	0
25	15284959	.	T	C	19	10	29	0	1	30	0	0
25	15285004	.	A	C	15	11	26	0	0	26	0	0
25	15285092	.	T	C	17	8	25	0	1	26	0	0
25	15285105	.	C	A	17	7	24	0	1	25	0	0
25	15285213	.	G	C	10	10	20	0	0	20	0	0
25	15285256	.	T	A	9	9	18	0	1	19	0	0
25	15285470	.	C	T	4	12	16	0	0	16	0	0
25	15285471	.	C	A	4	12	16	0	0	16	0	0
25	15339285	.	C	T	2	3	5	0	0	5	0	0
25	15342700	.	G	A	2	4	6	0	1	7	0	0
25	15343016	.	C	A	5	4	9	0	0	9	0	0
25	15347416	.	A	G	4	0	4	0	4	8	0	0
25	15347688	.	G	A	4	4	8	0	0	8	0	0
25	15348359	.	A	G	5	3	8	0	0	8	0	0
25	15350012	.	A	G	8	6	14	0	0	14	0	0
25	15350016	.	G	A	8	6	14	0	1	15	0	0
25	15350058	.	A	G	9	8	17	1	1	19	0	0
25	15350402	.	T	G	9	14	23	0	0	23	0	0
25	15350467	.	T	C	9	3	12	0	0	12	0	0
25	15351088	.	A	G	14	5	19	0	0	19	0	0
25	15354333	.	G	T	3	5	8	0	0	8	0	0
25	15354360	.	C	T	5	5	10	0	0	10	0	0
25	15404898	.	G	A	10	9	19	0	0	19	0	0
25	15408820	.	G	A	0	11	11	0	18	29	0	0
25	15409013	.	T	C	14	12	26	0	1	27	0	0
25	15430310	.	T	C	9	16	25	0	1	26	0	0
25	15430334	.	T	C	11	13	24	0	1	25	0	0
25	15432769	.	G	A	11	10	21	0	2	23	0	0
25	15434566	.	T	C	17	13	30	0	0	30	0	0
25	15434579	.	C	T	17	17	34	0	1	35	0	0
25	15438723	.	G	A	3	22	25	0	21	46	0	0
25	15438789	.	C	A	20	14	34	0	4	38	0	0
25	15450807	.	C	G	17	19	36	2	1	39	0	0
25	15465167	.	T	C	25	13	38	0	1	39	0	0
25	15472286	.	C	A	31	22	53	0	4	57	0	0
25	15477186	.	G	A	5	17	22	0	26	48	0	0
25	15478092	.	A	G	27	30	57	0	2	59	0	0
25	15480676	.	G	A	4	29	33	0	34	67	0	0
25	15480711	.	T	C	31	27	58	0	2	60	0	0
25	15481040	.	C	T	14	17	31	8	8	47	0	0
25	15481240	.	A	G	18	34	52	1	3	56	0	0
25	15481481	.	T	G	20	18	38	0	1	39	0	0
25	15481759	.	G	A	23	22	45	0	3	48	0	0
25	15482251	.	T	C	6	3	9	0	0	9	0	0
25	15648042	.	G	A	5	2	7	0	0	7	0	0
25	15648092	.	A	G	3	4	7	0	0	7	0	0
25	15648237	.	T	A	5	8	13	0	0	13	0	0
25	15648243	.	C	A	4	7	11	0	1	12	0	0
25	15648330	.	C	A	2	7	9	0	0	9	0	0
25	15648342	.	G	C	2	7	9	0	3	12	0	0
25	15649992	.	G	A	3	6	9	0	0	9	0	0
25	16963906	.	T	C	1	5	6	0	0	6	0	0
25	17593585	.	T	C	1	4	5	0	0	5	0	0
25	18031443	.	A	T	2	1	3	0	2	5	0	0
25	18328741	.	T	G	10	3	13	0	19	32	0	0
25	18906783	.	A	G	2	2	4	0	0	4	0	0
25	18907847	.	A	G	2	2	4	0	0	4	0	0
25	18907937	.	A	G	3	2	5	0	1	6	0	0
25	18963193	.	A	G	7	5	12	0	0	12	0	0
25	18977066	.	A	G	2	2	4	0	0	4	0	0
25	18977092	.	A	G	3	3	6	0	0	6	0	0
25	18977133	.	A	G	2	6	8	0	0	8	0	0
25	18977138	.	A	G	2	6	8	0	0	8	0	0
25	18977347	.	A	G	3	4	7	0	0	7	0	0
25	18977365	.	A	G	4	6	10	0	0	10	0	0
25	18977422	.	A	G	10	5	15	0	1	16	0	0
25	18977423	.	A	G	8	8	16	0	0	16	0	0
25	19883227	.	T	C	1	2	3	0	0	3	0	0
25	19935446	.	C	G	6	1	7	0	22	29	0	0
25	20388721	.	C	T	1	2	3	0	1	4	0	0
25	20669202	.	T	G	5	2	7	0	0	7	0	0
25	22066772	.	G	C	0	1	1	0	3	4	0	0
25	22076324	.	C	T	3	2	5	0	0	5	0	0
25	22086896	.	T	C	1	8	9	0	0	9	0	0
25	22094967	.	G	A	2	5	7	0	1	8	0	0
25	22095022	.	C	T	2	4	6	0	0	6	0	0
25	22095054	.	G	A	2	4	6	0	0	6	0	0
25	22095199	.	T	C	1	3	4	0	0	4	0	0
25	22095800	.	A	T	1	3	4	0	1	5	0	0
25	22227976	.	T	C	1	4	5	0	1	6	0	0
25	22227979	.	C	T	1	5	6	0	0	6	0	0
25	22232767	.	A	T	2	3	5	0	0	5	0	0
25	22232870	.	C	T	3	4	7	0	0	7	0	0
25	22274809	.	A	T	1	2	3	0	0	3	0	0
25	22274813	.	A	G	1	2	3	0	1	4	0	0
25	22281645	.	G	A	1	2	3	0	0	3	0	0
25	22291805	.	G	A	6	6	12	0	0	12	0	0
25	22633999	.	T	G	4	2	6	0	0	6	0	0
25	22634029	.	C	T	3	2	5	0	0	5	0	0
25	22635759	.	A	G	28	26	54	0	3	57	0	0
25	22635812	.	T	G	31	19	50	0	2	52	0	0
25	22636075	.	C	A	16	18	34	0	3	37	0	0
25	22636574	.	G	A	25	23	48	0	3	51	0	0
25	22636967	.	C	T	13	18	31	0	3	34	0	0
25	22637012	.	C	T	17	12	29	0	6	35	0	0
25	22637039	.	A	G	12	18	30	0	3	33	0	0
25	22637290	.	C	A	3	10	13	0	23	36	0	0
25	22637384	.	G	A	18	15	33	0	3	36	0	0
25	22637444	.	A	T	16	8	24	0	2	26	0	0
25	22637501	.	A	G	17	12	29	0	2	31	0	0
25	22637584	.	A	T	16	12	28	0	3	31	0	0
25	22637667	.	T	C	13	19	32	0	0	32	0	0
25	22637729	.	G	T	17	17	34	0	0	34	0	0
25	22637732	.	G	A	16	16	32	0	1	33	0	0
25	22637873	.	C	A	12	22	34	0	1	35	0	0
25	22638170	.	C	G	1	7	8	0	2	10	0	0
25	22639039	.	G	A	13	4	17	0	1	18	0	0
25	22730504	.	T	C	1	5	6	0	0	6	0	0
25	22853810	.	G	A	1	4	5	0	0	5	0	0
25	23449787	.	A	G	2	2	4	0	0	4	0	0
25	23556378	.	C	G	9	11	20	0	0	20	0	0
25	23556452	.	T	C	6	5	11	0	2	13	0	0
25	23562487	.	C	T	1	12	13	0	9	22	0	0
25	23571614	.	A	G	5	2	7	0	0	7	0	0
25	23583076	.	G	C	2	0	2	0	4	6	0	0
25	23631148	.	C	T	3	3	6	0	0	6	0	0
25	23636329	.	C	T	6	2	8	0	1	9	0	0
25	23643111	.	A	C	1	2	3	0	0	3	0	0
25	23643122	.	A	T	2	3	5	0	0	5	0	0
25	23643172	.	A	G	2	0	2	0	2	4	0	0
25	23643477	.	C	T	3	5	8	0	0	8	0	0
25	23643840	.	A	C	2	2	4	0	0	4	0	0
25	23657542	.	T	C	1	0	1	0	2	3	0	0
25	23777510	.	C	A	6	10	16	0	0	16	0	0
25	23777545	.	G	A	12	17	29	0	1	30	0	0
25	23815540	.	C	T	10	12	22	0	0	22	0	0
25	24039661	.	T	C	3	0	3	0	5	8	0	0
25	24055419	.	T	C	3	0	3	0	3	6	0	0
25	24059983	.	A	G	3	4	7	0	0	7	0	0
25	24059991	.	A	G	4	3	7	0	0	7	0	0
25	24060460	.	G	A	6	3	9	0	0	9	0	0
25	24188421	.	C	T	0	2	2	0	1	3	0	0
25	24237087	.	A	T	1	3	4	0	0	4	0	0
25	24237301	.	A	G	1	2	3	0	0	3	0	0
25	24237313	.	G	C	1	2	3	0	0	3	0	0
25	24237636	.	G	A	11	9	20	0	0	20	0	0
25	24238066	.	T	G	13	14	27	0	0	27	0	0
25	24238134	.	A	C	13	1	14	0	0	14	0	0
25	24240918	.	C	T	7	8	15	0	1	16	0	0
25	24241338	.	T	G	9	9	18	0	3	21	0	0
25	24241350	.	G	A	14	11	25	0	0	25	0	0
25	24242001	.	A	G	8	10	18	0	0	18	0	0
25	24242103	.	A	G	7	11	18	0	0	18	0	0
25	24242115	.	T	C	6	9	15	0	0	15	0	0
25	24247267	.	C	G	9	10	19	0	0	19	0	0
25	24247282	.	A	C	8	12	20	0	0	20	0	0
25	24247758	.	A	C	7	0	7	0	10	17	0	0
25	24247765	.	T	C	7	10	17	0	0	17	0	0
25	24247985	.	G	A	2	5	7	0	0	7	0	0
25	24264276	.	G	A	0	2	2	0	6	8	0	0
25	24388630	.	A	G	1	0	1	0	2	3	0	0
25	24593833	.	A	T	1	3	4	0	0	4	0	0
25	24594339	.	C	T	6	6	12	0	0	12	0	0
25	24598869	.	T	C	3	2	5	0	0	5	0	0
25	24605595	.	G	T	4	5	9	0	1	10	0	0
25	24605598	.	A	C	4	5	9	0	1	10	0	0
25	24609348	.	C	T	4	4	8	0	0	8	0	0
25	24609463	.	T	A	7	3	10	0	0	10	0	0
25	24609515	.	A	G	7	5	12	0	1	13	0	0
25	24610020	.	G	A	8	5	13	0	0	13	0	0
25	24610030	.	T	C	6	4	10	0	0	10	0	0
25	24610543	.	A	T	4	8	12	0	0	12	0	0
25	24610544	.	A	G	4	7	11	0	1	12	0	0
25	24709476	.	A	G	1	0	1	0	2	3	0	0
25	24714795	.	C	T	1	4	5	0	0	5	0	0
25	24714919	.	C	T	1	2	3	0	1	4	0	0
25	24714928	.	T	C	1	3	4	0	0	4	0	0
25	24716931	.	C	T	3	2	5	0	0	5	0	0
25	24716984	.	A	G	1	0	1	0	2	3	0	0
25	24716990	.	C	G	1	3	4	0	0	4	0	0
25	24723447	.	C	T	3	2	5	0	0	5	0	0
25	24723468	.	T	C	3	4	7	0	0	7	0	0
25	24736579	.	A	T	12	13	25	0	0	25	0	0
25	24736828	.	A	T	8	6	14	0	1	15	0	0
25	24736875	.	T	G	7	7	14	0	0	14	0	0
25	24736921	.	G	A	5	8	13	0	0	13	0	0
25	24737026	.	C	T	3	6	9	0	2	11	0	0
25	24737154	.	C	T	0	2	2	0	3	5	0	0
25	24737215	.	C	T	8	4	12	0	1	13	0	0
25	24737244	.	A	C	9	6	15	0	0	15	0	0
25	24737335	.	C	A	0	3	3	0	2	5	0	0
25	24737664	.	C	A	6	8	14	0	0	14	0	0
25	24738023	.	T	C	4	0	4	0	9	13	0	0
25	24738084	.	T	C	8	0	8	0	11	19	0	0
25	24738114	.	C	G	8	12	20	0	0	20	0	0
25	24738826	.	G	A	6	8	14	0	3	17	0	0
25	24739029	.	A	G	10	14	24	0	1	25	0	0
25	24752181	.	A	G	7	10	17	0	2	19	0	0
25	24760448	.	C	A	0	8	8	0	7	15	0	0
25	24763746	.	A	G	4	10	14	0	0	14	0	0
25	24763755	.	G	T	5	9	14	0	1	15	0	0
25	24770089	.	G	A	15	15	30	0	2	32	0	0
25	24792647	.	C	A	6	2	8	0	2	10	0	0
25	24805912	.	T	A	7	2	9	0	2	11	0	0
25	24826290	.	A	G	2	3	5	0	0	5	0	0
25	24847561	.	A	T	4	5	9	0	0	9	0	0
25	25058302	.	C	T	2	3	5	0	1	6	0	0
25	25058334	.	A	C	2	0	2	0	5	7	0	0
25	25123445	.	T	C	8	8	16	0	1	17	0	0
25	25124779	.	A	T	14	15	29	0	1	30	0	0
25	25127090	.	C	T	17	19	36	0	1	37	0	0
25	25127250	.	A	G	14	18	32	0	1	33	0	0
25	25130648	.	C	T	20	28	48	0	1	49	0	0
25	25130693	.	C	T	25	27	52	0	2	54	0	0
25	25130747	.	C	T	24	27	51	0	2	53	0	0
25	25130782	.	G	A	23	27	50	0	3	53	0	0
25	25130908	.	C	T	22	19	41	1	1	43	0	0
25	25130924	.	T	C	24	22	46	1	0	47	0	0
25	25130968	.	C	T	20	26	46	0	0	46	0	0
25	25131274	.	A	G	15	17	32	0	2	34	0	0
25	25131298	.	A	T	20	20	40	0	2	42	0	0
25	25131389	.	A	T	25	19	44	0	1	45	0	0
25	25131464	.	G	A	25	28	53	0	1	54	0	0
25	25131631	.	C	T	25	18	43	1	3	51	4	0
25	25131710	.	A	G	16	16	32	0	2	34	0	0
25	25132985	.	C	T	9	9	18	0	1	19	0	0
25	25133030	.	G	A	10	10	20	0	2	22	0	0
25	25133123	.	T	G	16	15	31	0	3	34	0	0
25	25133171	.	A	G	19	27	46	0	1	47	0	0
25	25133353	.	G	A	19	18	37	0	4	41	0	0
25	25133365	.	T	A	19	22	41	0	1	42	0	0
25	25133509	.	A	G	12	10	22	0	2	24	0	0
25	25142127	.	G	A	6	4	10	1	1	13	1	0
25	25142171	.	T	C	5	5	10	0	1	11	0	0
25	25396237	.	T	C	14	7	21	0	0	21	0	0
25	25396295	.	T	C	7	11	18	0	1	19	0	0
25	25488772	.	T	G	4	3	7	0	0	7	0	0
25	25490963	.	C	T	1	2	3	0	0	3	0	0
25	25536394	.	C	A	2	4	6	0	1	7	0	0
25	25538143	.	A	C	4	5	9	0	0	9	0	0
25	25538151	.	C	T	3	5	8	0	1	9	0	0
25	25538206	.	G	T	7	8	15	0	0	15	0	0
25	25538354	.	T	A	5	3	8	0	0	8	0	0
25	25538440	.	T	G	6	6	12	0	0	12	0	0
25	25538624	.	C	A	4	2	6	0	0	6	0	0
25	25539028	.	G	A	7	3	10	0	1	11	0	0
25	25539270	.	C	A	2	3	5	0	0	5	0	0
25	25539434	.	G	A	1	3	4	0	4	8	0	0
25	25539518	.	A	G	4	8	12	0	0	12	0	0
25	25539569	.	A	G	2	1	3	0	7	10	0	0
25	25539723	.	C	A	11	8	19	0	2	21	0	0
25	25539783	.	G	C	10	7	17	0	3	20	0	0
25	25539800	.	A	G	10	7	17	0	1	18	0	0
25	25539834	.	A	T	5	10	15	0	3	18	0	0
25	25539928	.	A	G	6	1	7	0	5	12	0	0
25	25540058	.	T	A	7	5	12	0	0	12	0	0
25	25540060	.	G	A	6	5	11	0	0	11	0	0
25	25540181	.	A	T	4	7	11	0	0	11	0	0
25	25540245	.	A	G	8	6	14	0	0	14	0	0
25	25540444	.	T	C	6	5	11	0	1	12	0	0
25	25540490	.	C	T	8	5	13	0	0	13	0	0
25	25540954	.	G	A	12	6	18	0	0	18	0	0
25	25545131	.	T	C	7	6	13	0	1	14	0	0
25	25545149	.	G	C	9	5	14	0	0	14	0	0
25	25545365	.	G	C	9	11	20	0	1	21	0	0
25	25545420	.	G	A	0	8	8	0	7	15	0	0
25	25545700	.	A	T	4	2	6	0	0	6	0	0
25	25545722	.	T	C	3	3	6	0	0	6	0	0
25	25545810	.	A	C	4	4	8	0	0	8	0	0
25	25547043	.	C	A	2	2	4	0	1	5	0	0
25	25547137	.	C	A	5	2	7	0	0	7	0	0
25	25547150	.	T	A	7	3	10	0	0	10	0	0
25	25547228	.	G	A	1	3	4	0	0	4	0	0
25	25548032	.	G	T	2	5	7	0	0	7	0	0
25	25548076	.	T	A	1	4	5	0	0	5	0	0
25	25565883	.	A	T	2	1	3	0	0	3	0	0
25	25565898	.	T	C	1	0	1	0	2	3	0	0
25	25592821	.	G	A	1	4	5	0	1	6	0	0
25	25619515	.	C	T	0	2	2	0	2	4	0	0
25	25646690	.	C	T	3	1	4	0	1	5	0	0
25	25806264	.	C	T	21	8	29	0	1	30	0	0
25	25823529	.	T	C	20	15	35	0	4	39	0	0
25	25829020	.	T	C	7	4	11	0	0	11	0	0
25	26673233	.	A	G	4	6	10	0	1	11	0	0
25	26744995	.	G	T	5	4	9	0	1	10	0	0
25	26816885	.	A	G	2	0	2	0	3	5	0	0
25	26821795	.	T	C	3	5	8	0	0	8	0	0
25	26821844	.	A	T	5	4	9	0	0	9	0	0
25	26822823	.	C	T	2	2	4	0	0	4	0	0
25	26823244	.	C	T	3	2	5	0	0	5	0	0
25	26823888	.	G	A	3	6	9	0	0	9	0	0
25	26824155	.	G	A	3	2	5	0	0	5	0	0
25	26829266	.	G	T	13	6	19	0	0	19	0	0
25	26830142	.	C	T	6	4	10	0	0	10	0	0
25	26832141	.	A	G	5	7	12	1	0	13	0	0
25	26840452	.	G	T	5	9	14	0	2	16	0	0
25	26840480	.	T	G	5	14	19	0	0	19	0	0
25	26840678	.	A	T	5	8	13	0	0	13	0	0
25	26840919	.	G	A	9	6	15	0	0	15	0	0
25	26842444	.	G	A	6	3	9	0	2	11	0	0
25	26867671	.	A	T	0	2	2	0	2	4	0	0
25	26867682	.	G	T	3	1	4	0	1	5	0	0
25	26867731	.	C	T	3	2	5	0	0	5	0	0
25	26867765	.	C	A	2	4	6	0	0	6	0	0
25	26877783	.	A	T	8	9	17	0	0	17	0	0
25	26877865	.	A	T	8	11	19	0	0	19	0	0
25	26879592	.	T	C	27	17	44	0	1	45	0	0
25	26884286	.	G	A	14	11	25	0	1	26	0	0
25	26884407	.	C	T	5	13	18	1	0	19	0	0
25	26888170	.	A	G	3	12	15	0	0	15	0	0
25	26890845	.	A	G	17	12	29	0	1	30	0	0
25	26909101	.	C	T	4	7	11	0	0	11	0	0
25	26909197	.	G	A	3	8	11	0	1	12	0	0
25	26909269	.	A	G	8	10	18	0	1	19	0	0
25	26909392	.	A	T	6	7	13	0	2	15	0	0
25	26909618	.	A	C	13	13	26	0	1	27	0	0
25	26911554	.	T	A	7	5	12	0	2	14	0	0
25	26911605	.	C	A	7	7	14	0	0	14	0	0
25	26911768	.	A	G	4	6	10	0	0	10	0	0
25	26912062	.	C	T	1	2	3	0	1	4	0	0
25	27010243	.	G	A	0	3	3	0	6	9	0	0
25	27173852	.	G	A	5	3	8	0	0	8	0	0
25	27173936	.	C	T	6	5	11	0	0	11	0	0
25	27173940	.	A	C	6	5	11	0	1	12	0	0
25	27174065	.	C	T	7	3	10	0	1	11	0	0
25	27210906	.	T	C	10	13	23	0	2	25	0	0
25	27237022	.	A	G	9	7	16	0	2	18	0	0
25	27488764	.	T	G	2	2	4	0	0	4	0	0
25	27493723	.	A	T	0	2	2	0	1	3	0	0
25	27494094	.	T	A	1	2	3	0	1	4	0	0
25	27494109	.	G	A	0	2	2	0	2	4	0	0
25	27494578	.	A	T	2	2	4	0	0	4	0	0
25	27499172	.	A	G	2	2	4	0	0	4	0	0
25	27499175	.	G	A	2	2	4	0	0	4	0	0
25	27499304	.	T	A	0	3	3	0	1	4	0	0
25	27499385	.	T	C	6	3	9	0	1	10	0	0
25	27500038	.	C	A	1	3	4	0	0	4	0	0
25	27500055	.	A	G	2	3	5	0	0	5	0	0
25	27744408	.	C	A	7	4	11	0	0	11	0	0
25	27759983	.	A	G	9	9	18	0	0	18	0	0
25	27788019	.	T	A	2	2	4	0	1	5	0	0
25	27795017	.	A	G	12	13	25	0	2	27	0	0
25	27795083	.	C	T	12	10	22	0	2	24	0	0
25	27801759	.	T	G	5	1	6	0	26	32	0	0
25	27801873	.	T	G	5	0	5	0	21	26	0	0
25	27801876	.	A	C	6	0	6	0	17	23	0	0
25	27802122	.	C	A	20	15	35	0	3	38	0	0
25	27802149	.	G	A	22	20	42	0	1	43	0	0
25	27811761	.	C	T	14	10	24	0	4	28	0	0
25	28070673	.	A	C	3	3	6	0	1	7	0	0
25	28138918	.	A	C	5	2	7	0	1	8	0	0
25	28640724	.	T	G	26	22	48	1	4	53	0	0
25	28640890	.	T	G	23	22	45	0	2	47	0	0
25	28641207	.	A	T	11	10	21	1	9	31	0	0
25	28641261	.	T	A	16	11	27	2	3	32	0	0
25	28641321	.	T	G	15	17	32	0	2	34	0	0
25	28648067	.	T	C	24	16	40	0	0	40	0	0
25	28648078	.	A	G	22	16	38	0	2	40	0	0
25	28650764	.	T	A	21	19	40	0	0	40	0	0
25	28655056	.	G	A	15	13	28	0	1	29	0	0
25	28661185	.	C	T	11	10	21	0	1	22	0	0
25	28661227	.	T	C	10	6	16	0	2	18	0	0
25	28661351	.	G	A	16	14	30	0	1	31	0	0
25	28661626	.	G	A	13	11	24	0	1	25	0	0
25	28665446	.	T	A	11	8	19	0	2	21	0	0
25	28665464	.	A	C	15	9	24	0	0	24	0	0
25	28668001	.	G	A	15	9	24	0	1	25	0	0
25	28668723	.	C	A	15	9	24	0	1	25	0	0
25	28716206	.	G	A	4	2	6	0	0	6	0	0
25	28719957	.	T	G	7	7	14	0	0	14	0	0
25	28720044	.	T	C	6	0	6	0	8	14	0	0
25	28726758	.	A	G	5	6	11	0	0	11	0	0
25	28736679	.	C	T	7	4	11	0	1	12	0	0
25	28736893	.	A	G	7	7	14	0	1	15	0	0
25	28737007	.	A	T	9	5	14	0	0	14	0	0
25	28745047	.	C	T	3	2	5	0	0	5	0	0
25	28745070	.	T	G	3	2	5	0	0	5	0	0
25	28745128	.	A	G	4	2	6	0	1	7	0	0
25	28745260	.	G	A	4	2	6	0	0	6	0	0
25	28745266	.	C	T	3	1	4	0	2	6	0	0
25	28768464	.	C	T	4	3	7	0	0	7	0	0
25	28825652	.	G	C	8	6	14	0	1	15	0	0
25	28826630	.	A	G	12	0	12	0	10	22	0	0
25	28827752	.	A	G	11	0	11	0	7	18	0	0
25	28846383	.	G	T	0	7	7	0	11	18	0	0
25	28893665	.	T	A	7	6	13	0	1	14	0	0
25	28893713	.	C	A	11	12	23	0	0	23	0	0
25	28893956	.	C	T	13	5	18	0	0	18	0	0
25	28903105	.	A	C	15	14	29	0	0	29	0	0
25	28903253	.	A	G	7	0	7	0	10	17	0	0
25	28907971	.	T	C	2	0	2	0	4	6	0	0
25	28907997	.	A	G	3	5	8	0	0	8	0	0
25	28926529	.	T	G	1	4	5	0	0	5	0	0
25	29076852	.	T	A	31	31	62	2	2	66	0	0
25	29080112	.	G	A	5	5	10	0	1	11	0	0
25	29083827	.	T	A	2	5	7	0	0	7	0	0
25	29084154	.	G	A	4	4	8	0	0	8	0	0
25	29087845	.	T	C	4	0	4	0	8	12	0	0
25	29087859	.	T	C	2	0	2	0	5	7	0	0
25	29103734	.	G	T	1	1	2	0	0	2	0	0
25	29103743	.	A	T	1	2	3	0	0	3	0	0
25	29109251	.	G	A	7	6	13	0	1	14	0	0
25	29110052	.	A	G	5	5	10	0	0	10	0	0
25	29114835	.	G	A	9	3	12	0	0	12	0	0
25	29117835	.	A	G	5	5	10	0	1	11	0	0
25	29128870	.	G	C	8	7	15	0	1	16	0	0
25	29212008	.	G	A	5	5	10	1	0	11	0	0
25	29212167	.	G	T	9	8	17	0	0	17	0	0
25	29212302	.	C	T	0	7	7	0	2	9	0	0
25	29212780	.	A	T	4	8	12	0	0	12	0	0
25	29212781	.	C	G	0	8	8	0	4	12	0	0
25	29212835	.	A	T	5	2	7	0	0	7	0	0
25	29212851	.	G	T	4	3	7	0	0	7	0	0
25	29212986	.	A	G	1	4	5	0	0	5	0	0
25	29213001	.	G	C	3	5	8	0	0	8	0	0
25	29213804	.	A	G	1	2	3	0	0	3	0	0
25	29429187	.	A	G	3	24	27	0	2	29	0	0
25	31171523	.	T	C	1	5	6	0	0	6	0	0
25	32216389	.	A	G	4	0	4	0	9	13	0	0
25	32739551	.	C	T	1	2	3	0	1	4	0	0
25	32886762	.	A	G	3	3	6	0	0	6	0	0
25	32886771	.	C	T	0	3	3	0	3	6	0	0
25	32888015	.	A	G	1	3	4	0	0	4	0	0
25	33081889	.	A	G	2	2	4	0	0	4	0	0
25	33093485	.	T	C	5	5	10	0	0	10	0	0
25	33104491	.	T	C	4	6	10	0	2	12	0	0
25	33104494	.	T	C	5	7	12	0	0	12	0	0
25	33107524	.	G	T	0	6	6	0	4	10	0	0
25	33107535	.	T	A	3	5	8	0	0	8	0	0
25	33121219	.	T	C	2	3	5	0	1	6	0	0
25	33121740	.	C	T	2	2	4	0	0	4	0	0
25	33121782	.	A	G	3	0	3	0	3	6	0	0
25	33125194	.	A	C	1	2	3	0	1	4	0	0
25	33145031	.	C	T	4	5	9	0	1	10	0	0
25	33151573	.	C	G	8	0	8	0	8	16	0	0
25	33192594	.	C	T	0	2	2	0	3	5	0	0
25	33225248	.	A	G	31	14	45	0	2	47	0	0
25	33225287	.	G	A	23	10	33	0	2	35	0	0
25	33226972	.	A	G	20	14	34	0	1	35	0	0
25	33226984	.	A	G	18	19	37	0	1	38	0	0
25	33238998	.	G	T	0	2	2	0	2	4	0	0
25	33242605	.	A	T	3	3	6	0	3	9	0	0
25	33242606	.	T	G	5	3	8	0	1	9	0	0
25	33249905	.	T	G	8	22	30	0	1	31	0	0
25	33250017	.	C	A	10	13	23	0	1	24	0	0
25	33250053	.	A	G	12	14	26	0	2	28	0	0
25	33256212	.	C	A	3	4	7	0	1	8	0	0
25	33258739	.	G	A	1	6	7	0	3	10	0	0
25	33258745	.	T	G	4	0	4	0	6	10	0	0
25	33258811	.	A	G	3	0	3	0	2	5	0	0
25	33258817	.	C	T	3	2	5	0	0	5	0	0
25	33259568	.	A	G	7	0	7	0	5	12	0	0
25	33259778	.	T	C	2	2	4	0	0	4	0	0
25	33262180	.	A	G	7	10	17	0	0	17	0	0
25	33265759	.	A	G	10	10	20	0	1	21	0	0
25	33265814	.	C	T	4	11	15	0	0	15	0	0
25	33265898	.	C	T	7	12	19	0	0	20	1	0
25	33266029	.	G	A	6	5	11	0	1	12	0	0
25	33266128	.	A	G	2	0	2	0	8	10	0	0
25	33266157	.	A	C	2	5	7	0	2	9	0	0
25	33962809	.	G	A	2	8	10	1	7	18	0	0
25	33963168	.	C	A	8	4	12	0	0	12	0	0
25	33963427	.	A	T	6	7	13	0	1	14	0	0
25	33964265	.	C	T	6	3	9	0	1	10	0	0
25	33964791	.	A	G	11	5	16	2	0	18	0	0
25	33964962	.	A	G	7	6	13	0	1	14	0	0
25	33964968	.	A	G	9	7	16	0	0	16	0	0
25	33965016	.	C	A	5	6	11	0	2	13	0	0
25	33965238	.	A	G	2	2	4	0	2	6	0	0
25	33965251	.	G	A	0	3	3	0	3	6	0	0
25	33965518	.	G	T	8	5	13	0	0	13	0	0
25	33965541	.	C	T	11	4	15	0	0	15	0	0
25	33965695	.	C	T	7	5	12	0	0	12	0	0
25	33965893	.	C	T	6	3	9	0	0	9	0	0
25	33965974	.	A	C	8	6	14	0	1	15	0	0
25	33966100	.	G	A	8	12	20	0	1	21	0	0
25	33966251	.	T	G	13	14	27	0	0	27	0	0
25	33966585	.	C	G	9	2	11	0	9	20	0	0
25	33966731	.	T	C	10	7	17	0	1	18	0	0
25	33966854	.	C	T	11	10	21	0	1	22	0	0
25	33966969	.	T	A	12	6	18	0	0	18	0	0
25	33967133	.	T	A	6	18	24	0	1	25	0	0
25	33967361	.	A	G	15	17	32	0	0	32	0	0
25	33967495	.	T	C	8	14	22	0	0	22	0	0
25	33967695	.	T	C	5	17	22	0	1	23	0	0
25	33967791	.	C	T	11	15	26	0	3	29	0	0
25	33967803	.	G	A	13	13	26	0	1	27	0	0
25	33968091	.	C	T	13	14	27	0	0	27	0	0
25	33968470	.	T	A	8	9	17	0	4	21	0	0
25	33968691	.	A	G	15	15	30	0	0	30	0	0
25	33968842	.	G	C	25	24	49	0	2	51	0	0
25	33968857	.	C	T	21	22	43	0	2	45	0	0
25	33968881	.	T	A	18	19	37	0	3	40	0	0
25	33981180	.	A	G	2	0	2	0	3	5	0	0
25	33983031	.	G	A	1	4	5	0	0	5	0	0
25	33987782	.	G	C	1	2	3	0	0	3	0	0
25	33987783	.	G	A	1	2	3	0	0	3	0	0
25	33987881	.	A	G	1	7	8	0	0	8	0	0
25	33988864	.	T	G	2	3	5	0	0	5	0	0
25	33988893	.	G	A	2	2	4	0	0	4	0	0
25	33988899	.	T	C	2	3	5	0	0	5	0	0
25	33988928	.	A	T	2	3	5	0	0	5	0	0
25	34000414	.	A	G	1	2	3	0	0	3	0	0
25	34002853	.	T	C	6	4	10	0	0	10	0	0
25	34014573	.	A	G	10	11	21	0	0	21	0	0
25	34017089	.	A	G	7	3	10	0	0	10	0	0
25	34018537	.	C	T	10	5	15	0	0	15	0	0
25	34020631	.	T	A	9	7	16	0	0	16	0	0
25	34022288	.	T	C	10	17	27	0	0	27	0	0
25	34022309	.	T	C	15	15	30	0	1	31	0	0
25	34027086	.	A	T	17	9	26	0	1	27	0	0
25	34027215	.	C	A	7	5	12	0	1	13	0	0
25	34027263	.	G	T	5	4	9	0	1	10	0	0
25	34154496	.	A	T	8	11	19	0	4	23	0	0
25	34154540	.	T	G	21	9	30	0	0	30	0	0
25	34154678	.	G	A	30	17	47	0	1	48	0	0
25	34246669	.	G	T	0	4	4	0	1	5	0	0
25	34246687	.	A	T	1	4	5	0	0	5	0	0
25	34260835	.	T	C	2	3	5	0	2	7	0	0
25	34711261	.	T	C	1	2	3	0	0	3	0	0
25	34911352	.	A	G	2	6	8	0	0	8	0	0
25	34972856	.	T	A	2	3	5	0	0	5	0	0
25	34973070	.	C	T	2	2	4	0	0	4	0	0
25	34973090	.	C	A	1	6	7	0	0	7	0	0
25	35002394	.	G	A	33	32	65	1	0	66	0	0
25	35005362	.	G	A	38	20	58	1	2	61	0	0
25	35006830	.	G	A	3	34	37	0	29	66	0	0
25	35006989	.	C	T	36	29	65	0	2	67	0	0
25	35007857	.	C	T	37	21	58	1	3	62	0	0
25	35007864	.	G	A	40	20	60	1	1	62	0	0
25	35101434	.	T	C	1	0	1	0	3	4	0	0
25	35101485	.	C	T	2	3	5	0	0	5	0	0
25	35270407	.	A	G	20	17	37	0	1	38	0	0
25	35467298	.	G	A	1	3	4	1	2	7	0	0
25	35713260	.	G	A	14	8	22	0	0	22	0	0
25	35713263	.	G	C	13	6	19	0	0	19	0	0
25	37335961	.	A	G	4	3	7	0	0	7	0	0
25	37336710	.	A	G	3	9	12	0	1	13	0	0
25	37336717	.	A	G	7	7	14	0	2	16	0	0
25	37365168	.	A	G	1	2	3	0	0	3	0	0
25	37365200	.	C	T	1	3	4	0	0	4	0	0
25	37470588	.	G	C	10	4	14	0	0	14	0	0
3	13937	.	C	T	2	7	9	13	0	22	0	0
3	441342	.	A	G	5	7	12	0	0	12	0	0
3	1096863	.	A	G	1	0	1	0	4	5	0	0
3	1192757	.	T	C	0	22	22	0	3	25	0	0
3	1323879	.	T	A	4	8	12	0	0	12	0	0
3	1323895	.	C	A	8	3	11	0	0	11	0	0
3	1324064	.	C	A	16	4	20	0	2	22	0	0
3	1324281	.	G	T	7	5	12	0	0	12	0	0
3	1324300	.	T	C	3	5	8	0	1	9	0	0
3	1324383	.	G	C	1	0	1	0	5	7	1	0
3	1324509	.	C	A	4	4	8	0	1	9	0	0
3	1324515	.	C	T	5	5	10	0	1	11	0	0
3	1337593	.	A	G	5	4	9	0	0	9	0	0
3	1500004	.	A	T	12	13	25	0	1	26	0	0
3	3610150	.	A	T	2	2	4	0	0	4	0	0
3	3610185	.	C	A	5	3	8	0	0	8	0	0
3	3610202	.	A	T	5	3	8	0	1	9	0	0
3	3610224	.	C	T	3	2	5	0	1	6	0	0
3	3617633	.	G	A	0	4	4	0	6	10	0	0
3	3630587	.	T	C	3	9	12	0	0	12	0	0
3	3631407	.	T	C	14	10	24	0	0	24	0	0
3	3634408	.	G	A	8	10	18	0	4	22	0	0
3	3813847	.	T	C	3	2	5	0	0	5	0	0
3	3820708	.	T	C	4	3	7	0	0	7	0	0
3	4502158	.	C	A	13	8	21	0	0	21	0	0
3	4502161	.	T	C	13	9	22	0	0	22	0	0
3	4504739	.	A	G	13	10	23	0	2	25	0	0
3	4506897	.	A	G	9	7	16	0	1	17	0	0
3	4506961	.	G	A	0	7	7	0	4	11	0	0
3	4508042	.	A	C	7	13	20	0	1	21	0	0
3	4508093	.	C	A	6	11	17	0	1	18	0	0
3	4508120	.	C	T	4	11	15	0	1	16	0	0
3	4511052	.	T	C	7	12	19	0	0	19	0	0
3	4511163	.	A	G	4	1	5	0	8	13	0	0
3	4514030	.	G	A	6	7	13	0	0	13	0	0
3	4530061	.	G	A	13	6	19	0	1	20	0	0
3	4530118	.	T	A	5	4	9	0	0	9	0	0
3	4648886	.	C	A	0	2	2	0	2	4	0	0
3	5010664	.	A	T	13	11	24	0	1	25	0	0
3	5012736	.	T	C	12	0	12	0	7	19	0	0
3	5012832	.	C	G	1	14	15	0	9	24	0	0
3	5019643	.	C	T	2	3	5	0	0	5	0	0
3	5019660	.	T	C	1	2	3	0	0	3	0	0
3	5019701	.	C	A	5	2	7	0	0	7	0	0
3	5019801	.	A	G	6	4	10	0	0	10	0	0
3	5019839	.	A	T	2	11	13	0	0	13	0	0
3	5021453	.	C	T	3	12	15	0	9	24	0	0
3	5021516	.	T	C	20	14	34	0	1	35	0	0
3	5027635	.	A	G	9	13	22	0	0	22	0	0
3	5029924	.	A	C	11	14	25	0	1	26	0	0
3	5029982	.	A	T	9	17	26	0	0	26	0	0
3	5053060	.	C	T	4	19	23	0	21	44	0	0
3	5053084	.	C	T	3	20	23	0	21	44	0	0
3	5053108	.	A	C	20	15	35	0	0	35	0	0
3	5053246	.	G	A	11	8	19	0	0	19	0	0
3	5053260	.	C	T	10	6	16	0	1	17	0	0
3	5053361	.	T	A	20	9	29	0	0	29	0	0
3	5053387	.	C	T	19	8	27	0	2	29	0	0
3	5053409	.	C	T	1	11	12	0	17	29	0	0
3	5053465	.	T	C	15	1	16	0	10	26	0	0
3	5053586	.	C	T	4	13	17	0	14	31	0	0
3	5053934	.	G	A	16	18	34	0	0	34	0	0
3	5054018	.	A	G	16	11	27	0	4	31	0	0
3	5056247	.	G	A	18	17	35	0	0	35	0	0
3	5056390	.	A	T	21	14	35	0	3	38	0	0
3	5062927	.	G	A	21	16	37	0	1	38	0	0
3	5062980	.	C	A	13	13	26	0	1	27	0	0
3	5063011	.	T	C	15	0	15	0	14	29	0	0
3	5063176	.	G	A	8	13	21	0	0	21	0	0
3	5130791	.	C	A	7	6	13	0	1	14	0	0
3	5130851	.	T	C	6	10	16	0	2	18	0	0
3	5134113	.	G	A	7	10	17	0	2	19	0	0
3	5134122	.	G	A	13	7	20	0	0	20	0	0
3	5134669	.	T	C	6	7	13	0	0	13	0	0
3	5136617	.	G	A	4	4	8	0	0	8	0	0
3	5140851	.	A	G	2	8	10	0	0	10	0	0
3	5141035	.	C	T	7	5	12	0	2	14	0	0
3	5141152	.	C	T	3	8	11	1	0	12	0	0
3	5143119	.	C	T	13	6	19	0	1	20	0	0
3	5143522	.	C	T	2	3	5	0	1	6	0	0
3	5145139	.	C	A	1	6	7	0	4	11	0	0
3	5145797	.	C	T	0	7	7	0	4	11	0	0
3	5145988	.	G	A	4	7	11	0	0	11	0	0
3	5145991	.	T	C	4	0	4	0	8	12	0	0
3	5147544	.	G	A	3	5	8	0	0	8	0	0
3	5147606	.	G	T	5	4	9	0	0	9	0	0
3	5152715	.	T	C	1	4	5	0	0	5	0	0
3	5163418	.	C	G	1	3	4	0	0	4	0	0
3	5163826	.	C	T	0	2	2	0	1	3	0	0
3	5163889	.	G	A	2	2	4	0	0	4	0	0
3	5265366	.	T	C	13	14	27	0	0	27	0	0
3	5267221	.	G	A	17	18	35	0	2	37	0	0
3	5267251	.	C	T	12	10	22	0	1	23	0	0
3	5270274	.	C	T	1	11	12	0	16	28	0	0
3	5623807	.	C	T	4	15	19	0	24	43	0	0
3	5624487	.	C	T	3	20	23	0	16	39	0	0
3	5624604	.	C	A	20	14	34	0	2	36	0	0
3	5627917	.	G	A	20	16	36	0	1	37	0	0
3	5633089	.	G	A	18	7	25	0	0	25	0	0
3	5719007	.	G	T	1	2	3	0	0	3	0	0
3	5719113	.	G	A	1	2	3	0	0	3	0	0
3	5719136	.	C	T	2	1	3	0	0	3	0	0
3	5723535	.	C	T	0	2	2	0	1	3	0	0
3	5778981	.	G	A	10	12	22	0	1	23	0	0
3	5779044	.	T	A	5	15	20	0	1	21	0	0
3	5779093	.	G	T	9	11	20	0	1	21	0	0
3	5782501	.	A	G	7	6	13	0	2	15	0	0
3	5782715	.	A	G	5	16	21	0	1	22	0	0
3	5792569	.	T	A	8	7	15	0	1	16	0	0
3	5812205	.	C	T	6	6	12	0	2	14	0	0
3	5812802	.	C	T	1	4	5	0	13	18	0	0
3	5812813	.	G	A	6	3	9	0	9	18	0	0
3	5814475	.	C	T	5	9	14	0	1	15	0	0
3	5814478	.	C	T	5	9	14	0	1	15	0	0
3	5823477	.	G	A	4	3	7	0	0	7	0	0
3	5823483	.	C	A	2	3	5	0	4	9	0	0
3	5824858	.	C	T	5	2	7	0	0	7	0	0
3	5824870	.	C	T	4	4	8	0	1	9	0	0
3	5829319	.	G	A	2	11	13	0	1	14	0	0
3	5829415	.	A	G	3	9	12	0	1	13	0	0
3	5882439	.	A	G	1	2	3	0	0	3	0	0
3	5886917	.	C	T	3	22	25	0	30	55	0	0
3	5887223	.	T	C	22	11	33	0	0	33	0	0
3	5887463	.	T	G	28	12	40	0	1	41	0	0
3	5887661	.	A	T	18	15	33	0	1	34	0	0
3	5887673	.	G	C	19	0	19	0	17	36	0	0
3	5887715	.	T	C	17	18	35	0	1	36	0	0
3	5887841	.	T	A	16	18	34	0	5	39	0	0
3	5887931	.	A	T	16	20	36	0	2	38	0	0
3	5888245	.	C	T	16	11	27	0	0	27	0	0
3	5888664	.	G	A	13	7	20	0	1	21	0	0
3	5888868	.	G	A	13	15	28	0	0	28	0	0
3	5889077	.	G	T	10	10	20	0	0	20	0	0
3	5889302	.	T	C	11	10	21	0	1	22	0	0
3	5889642	.	A	T	7	5	12	0	1	14	1	0
3	5889983	.	A	G	1	2	3	0	2	5	0	0
3	5890274	.	T	A	6	9	15	0	2	17	0	0
3	5890287	.	A	G	5	10	15	0	2	17	0	0
3	5890698	.	C	T	0	11	11	0	11	22	0	0
3	5908262	.	C	T	2	5	7	0	2	9	0	0
3	5908302	.	T	C	1	0	1	0	5	6	0	0
3	5908452	.	T	C	8	1	9	0	6	15	0	0
3	5908569	.	C	A	0	8	8	0	2	10	0	0
3	5964113	.	G	A	4	4	8	0	0	8	0	0
3	5991798	.	C	T	0	3	3	0	1	4	0	0
3	5994984	.	C	T	7	3	10	0	0	10	0	0
3	5995038	.	A	G	2	6	8	0	1	9	0	0
3	5995071	.	A	G	4	4	8	0	0	8	0	0
3	6015843	.	A	G	1	2	3	0	0	3	0	0
3	6018562	.	A	G	2	2	4	0	0	4	0	0
3	6380368	.	T	C	31	22	53	1	1	55	0	0
3	6417172	.	G	A	26	26	52	0	3	55	0	0
3	6444075	.	C	A	6	3	9	0	0	9	0	0
3	6454507	.	G	A	2	3	5	0	0	5	0	0
3	6474593	.	A	G	7	8	15	0	0	15	0	0
3	6477596	.	G	C	3	4	7	0	2	9	0	0
3	6491540	.	C	T	4	5	9	0	0	9	0	0
3	6491542	.	G	T	4	5	9	0	0	9	0	0
3	6491670	.	C	T	2	6	8	0	1	9	0	0
3	6491820	.	A	T	7	5	12	0	0	12	0	0
3	6491833	.	A	G	6	3	9	0	0	9	0	0
3	6491881	.	G	T	7	4	11	0	0	11	0	0
3	6491906	.	T	C	4	8	12	0	0	12	0	0
3	6495017	.	G	A	5	2	7	0	0	7	0	0
3	6499606	.	T	C	3	0	3	0	3	6	0	0
3	6499636	.	A	G	4	2	6	0	0	6	0	0
3	6502039	.	G	A	3	3	6	0	0	6	0	0
3	6504814	.	T	A	9	4	13	0	0	14	1	0
3	6505007	.	G	T	4	3	7	0	0	7	0	0
3	6505010	.	T	C	3	5	8	0	1	9	0	0
3	6515014	.	C	G	1	5	6	0	0	6	0	0
3	6515029	.	A	G	1	5	6	0	0	6	0	0
3	6516457	.	C	T	1	2	3	0	3	6	0	0
3	6608024	.	C	A	1	4	5	0	0	5	0	0
3	6608098	.	G	A	7	2	9	0	0	9	0	0
3	6659702	.	G	A	0	3	3	1	4	8	0	0
3	6659843	.	C	T	4	4	8	0	0	8	0	0
3	6664270	.	A	G	2	0	2	0	2	4	0	0
3	6664474	.	A	G	8	0	8	1	3	12	0	0
3	6664609	.	T	C	5	3	8	0	1	9	0	0
3	6664850	.	T	G	4	3	7	0	0	7	0	0
3	6664915	.	A	G	3	2	5	1	1	7	0	0
3	6665181	.	A	G	1	0	1	0	3	4	0	0
3	6665184	.	A	G	1	0	1	0	4	5	0	0
3	6665759	.	T	C	1	3	4	0	0	4	0	0
3	6665874	.	C	G	6	1	7	0	10	17	0	0
3	6665902	.	G	T	4	11	15	0	0	15	0	0
3	6665951	.	C	A	13	4	17	0	0	17	0	0
3	6665985	.	A	T	11	7	18	0	1	19	0	0
3	6666027	.	C	T	5	4	9	0	1	10	0	0
3	6666080	.	A	G	7	6	13	0	1	14	0	0
3	6666092	.	T	C	4	10	14	0	0	14	0	0
3	6666194	.	G	C	13	14	27	0	0	27	0	0
3	6666283	.	A	T	13	10	23	0	0	23	0	0
3	6666342	.	A	G	12	8	20	0	0	20	0	0
3	6666362	.	G	A	7	11	18	0	0	18	0	0
3	6666689	.	T	C	1	6	7	0	0	7	0	0
3	6666730	.	C	T	1	6	7	0	0	7	0	0
3	6666846	.	T	C	2	9	11	0	0	11	0	0
3	6667060	.	G	C	19	11	30	0	1	31	0	0
3	6667209	.	C	T	4	14	18	0	1	19	0	0
3	6667383	.	T	C	1	4	5	2	0	7	0	0
3	6721286	.	G	C	9	7	16	0	0	16	0	0
3	6721421	.	T	G	16	10	26	0	0	26	0	0
3	6721430	.	T	C	8	11	19	0	0	19	0	0
3	6721456	.	A	T	8	8	16	0	1	17	0	0
3	6721579	.	G	A	5	6	11	0	0	11	0	0
3	6721763	.	T	C	5	6	11	0	3	14	0	0
3	6721851	.	C	T	10	10	20	0	0	20	0	0
3	6721971	.	A	T	12	6	18	0	1	19	0	0
3	6722438	.	C	T	7	6	13	0	1	14	0	0
3	6722904	.	G	A	26	6	32	1	0	33	0	0
3	6722981	.	G	A	12	13	25	0	0	25	0	0
3	6722986	.	A	T	9	10	19	0	3	22	0	0
3	6723078	.	A	C	13	6	19	0	3	22	0	0
3	6723161	.	C	G	3	4	7	1	0	8	0	0
3	6723257	.	A	G	11	6	17	0	0	17	0	0
3	6725122	.	G	A	5	5	10	1	0	11	0	0
3	6725332	.	T	G	3	10	13	0	0	13	0	0
3	6725432	.	T	A	2	5	7	0	0	7	0	0
3	6725468	.	C	T	2	2	4	0	0	4	0	0
3	6725523	.	C	T	5	3	8	3	0	11	0	0
3	6725554	.	T	C	4	3	7	4	0	11	0	0
3	6725607	.	A	G	2	3	5	2	0	7	0	0
3	6726020	.	C	T	5	4	9	0	0	9	0	0
3	6726284	.	A	T	5	8	13	0	0	13	0	0
3	6726317	.	A	G	5	5	10	0	1	11	0	0
3	6726359	.	G	A	7	4	11	0	0	11	0	0
3	6726455	.	A	T	10	11	21	0	0	21	0	0
3	6727154	.	C	T	0	8	8	0	13	21	0	0
3	6732696	.	G	A	2	4	6	0	0	6	0	0
3	6732697	.	C	T	0	2	2	0	4	6	0	0
3	6737079	.	G	A	2	7	9	0	0	9	0	0
3	6737099	.	G	T	5	5	10	0	0	10	0	0
3	7007381	.	G	C	2	3	5	0	0	5	0	0
3	7007845	.	C	T	1	2	3	0	0	3	0	0
3	7007906	.	A	G	2	0	2	0	3	5	0	0
3	7008220	.	G	T	2	7	9	0	0	10	1	0
3	7008234	.	G	A	1	5	6	0	2	8	0	0
3	7008640	.	T	A	4	2	6	0	0	6	0	0
3	7098976	.	T	C	2	3	5	0	1	6	0	0
3	7099049	.	C	T	3	3	6	3	1	10	0	0
3	7099210	.	T	C	2	4	6	0	1	7	0	0
3	7099344	.	A	G	3	4	7	0	0	7	0	0
3	7099380	.	C	T	3	2	5	0	0	5	0	0
3	7099452	.	T	C	2	0	2	0	6	8	0	0
3	7099460	.	T	G	1	5	6	0	0	6	0	0
3	7099770	.	C	T	2	4	6	0	0	6	0	0
3	7100136	.	T	A	1	2	3	0	0	3	0	0
3	7113025	.	C	T	0	8	8	0	7	15	0	0
3	7113330	.	T	C	6	4	10	0	0	10	0	0
3	7113660	.	A	G	2	5	7	0	0	7	0	0
3	7113669	.	C	T	1	4	5	0	0	5	0	0
3	7113720	.	G	A	6	7	13	3	0	16	0	0
3	7113742	.	G	A	7	4	11	4	1	16	0	0
3	7113772	.	A	G	4	6	10	4	0	14	0	0
3	7113934	.	A	G	4	3	7	1	0	8	0	0
3	7124437	.	A	G	3	3	6	0	0	6	0	0
3	7134022	.	G	C	2	3	5	0	0	5	0	0
3	7141527	.	G	T	2	5	7	0	0	7	0	0
3	7141651	.	T	C	8	5	13	0	2	15	0	0
3	7141717	.	A	G	7	3	10	0	0	10	0	0
3	7141846	.	G	A	1	4	5	0	1	6	0	0
3	7142143	.	G	A	3	4	7	0	0	7	0	0
3	7155428	.	G	A	8	5	13	0	0	13	0	0
3	7155462	.	C	T	0	9	9	0	5	14	0	0
3	7155771	.	G	A	1	2	3	0	2	5	0	0
3	7155846	.	T	C	4	8	12	0	1	13	0	0
3	7155960	.	T	G	7	5	12	0	0	12	0	0
3	7170561	.	C	T	4	3	7	1	0	8	0	0
3	7276854	.	C	T	0	2	2	0	1	3	0	0
3	7510268	.	G	A	1	3	4	0	0	4	0	0
3	7557932	.	C	T	2	4	6	0	0	6	0	0
3	7557948	.	T	G	2	3	5	0	0	5	0	0
3	7617385	.	G	A	0	5	5	0	3	8	0	0
3	7618805	.	C	T	1	7	8	0	0	8	0	0
3	7618823	.	A	C	1	9	10	0	0	10	0	0
3	7623208	.	G	A	8	6	14	0	1	15	0	0
3	7638510	.	A	G	4	5	9	0	0	9	0	0
3	7638520	.	T	G	4	3	7	0	2	9	0	0
3	7638675	.	C	A	4	5	9	0	0	9	0	0
3	7638946	.	T	A	11	11	22	0	2	24	0	0
3	7638947	.	T	C	11	10	21	0	3	24	0	0
3	7654833	.	C	G	4	26	30	0	26	56	0	0
3	7654835	.	T	C	22	27	49	0	6	56	1	0
3	7655186	.	A	G	24	31	55	0	3	58	0	0
3	7655588	.	T	C	23	1	24	0	29	53	0	0
3	7655660	.	C	T	24	28	52	0	4	56	0	0
3	7655780	.	T	G	38	24	62	0	3	65	0	0
3	7655817	.	A	T	33	20	53	0	1	54	0	0
3	7655819	.	C	T	6	19	25	0	27	52	0	0
3	7655908	.	A	G	14	24	38	0	1	40	1	0
3	7795302	.	A	G	3	0	3	0	5	8	0	0
3	7799602	.	C	G	2	4	6	0	0	6	0	0
3	7801997	.	G	A	0	4	4	0	3	7	0	0
3	7818839	.	A	T	5	6	11	0	1	12	0	0
3	7818905	.	C	G	1	0	1	0	3	4	0	0
3	7818929	.	G	A	0	3	3	0	3	6	0	0
3	7819142	.	A	G	3	2	5	0	0	5	0	0
3	7819144	.	A	G	3	2	5	0	0	5	0	0
3	7823333	.	G	A	8	22	30	0	2	32	0	0
3	7833801	.	T	C	10	6	16	0	1	17	0	0
3	7833897	.	T	C	10	12	22	0	1	23	0	0
3	7833928	.	C	G	8	18	26	0	2	28	0	0
3	7833995	.	T	C	8	13	21	0	0	21	0	0
3	7840106	.	A	G	3	4	7	0	1	8	0	0
3	7853231	.	A	T	5	3	8	0	1	9	0	0
3	7853248	.	A	G	7	4	11	0	0	11	0	0
3	7853274	.	A	C	7	4	11	0	0	11	0	0
3	7853320	.	G	A	8	3	11	0	0	11	0	0
3	7853755	.	T	A	4	6	10	0	1	11	0	0
3	7853805	.	T	C	4	0	4	0	5	9	0	0
3	7853827	.	A	C	4	2	6	0	2	8	0	0
3	7853950	.	T	C	2	0	2	0	7	9	0	0
3	7853965	.	T	C	2	6	8	0	1	9	0	0
3	7854082	.	G	A	4	5	9	0	1	10	0	0
3	7854178	.	G	A	6	2	8	0	0	8	0	0
3	7862593	.	A	G	1	3	4	0	0	4	0	0
3	7866296	.	G	C	4	3	7	0	0	7	0	0
3	7870469	.	G	A	2	2	4	0	0	4	0	0
3	7870547	.	T	C	3	2	5	0	0	5	0	0
3	7870796	.	T	C	1	3	4	0	1	5	0	0
3	7870868	.	T	C	2	2	4	0	0	4	0	0
3	7882384	.	G	A	1	3	4	0	0	4	0	0
3	8323879	.	A	G	2	2	4	0	0	4	0	0
3	9417311	.	C	G	2	3	5	0	0	5	0	0
3	9417690	.	A	G	1	2	3	0	0	3	0	0
3	9418030	.	C	T	1	2	3	0	0	3	0	0
3	9418494	.	G	A	1	3	4	0	3	7	0	0
3	9418575	.	C	T	2	3	5	0	0	5	0	0
3	9418780	.	A	T	1	4	5	0	0	5	0	0
3	9419319	.	G	A	1	6	7	0	1	8	0	0
3	9420518	.	A	T	2	2	4	0	0	4	0	0
3	9420541	.	T	C	2	3	5	0	0	5	0	0
3	9420973	.	A	G	2	4	6	0	0	6	0	0
3	9421209	.	A	T	2	4	6	0	1	7	0	0
3	9421253	.	T	C	2	2	4	0	0	4	0	0
3	9421668	.	G	A	1	5	6	0	5	11	0	0
3	9421840	.	T	G	2	5	7	0	0	7	0	0
3	9421878	.	C	A	2	6	8	0	0	8	0	0
3	9422176	.	T	A	1	1	2	0	1	3	0	0
3	9596311	.	C	T	3	5	8	0	0	8	0	0
3	9596313	.	C	T	3	4	7	0	1	8	0	0
3	9599885	.	G	T	4	2	6	0	3	9	0	0
3	9609472	.	C	G	13	9	22	0	0	22	0	0
3	9609502	.	G	A	8	6	14	0	2	16	0	0
3	9611371	.	G	A	1	6	7	0	5	12	0	0
3	9615718	.	G	A	10	5	15	0	4	19	0	0
3	9616399	.	C	T	12	11	23	0	2	25	0	0
3	9624849	.	G	A	14	13	27	0	1	28	0	0
3	9624882	.	G	A	13	16	29	0	0	29	0	0
3	9625735	.	C	T	13	13	26	0	1	27	0	0
3	9626276	.	G	T	1	7	8	0	0	8	0	0
3	9626307	.	T	G	5	5	10	0	0	10	0	0
3	9639162	.	A	G	17	12	29	0	1	30	0	0
3	9640322	.	C	T	2	14	16	0	12	28	0	0
3	9640467	.	A	G	10	15	25	0	0	25	0	0
3	9640659	.	A	G	16	14	30	0	0	30	0	0
3	9641337	.	C	T	13	12	25	1	7	33	0	0
3	9641451	.	C	T	2	15	17	0	17	34	0	0
3	9641859	.	G	A	6	8	14	0	0	14	0	0
3	9644553	.	C	T	8	6	14	0	1	15	0	0
3	9644745	.	G	A	5	3	8	0	0	8	0	0
3	9644772	.	A	G	6	4	10	0	0	10	0	0
3	9650313	.	A	G	4	2	6	0	0	6	0	0
3	9650327	.	A	G	2	4	6	0	1	7	0	0
3	9650403	.	A	G	3	4	7	0	2	9	0	0
3	9650598	.	G	A	3	2	5	0	0	5	0	0
3	9650682	.	T	C	6	0	6	0	4	10	0	0
3	9650706	.	A	G	7	6	13	0	0	13	0	0
3	9654675	.	G	A	9	7	16	0	0	16	0	0
3	9656656	.	C	T	0	4	4	0	5	9	0	0
3	9658463	.	C	T	0	3	3	0	1	4	0	0
3	9658481	.	A	G	1	4	5	0	0	5	0	0
3	9664193	.	C	T	0	4	4	0	6	10	0	0
3	9665608	.	G	T	4	6	10	0	0	10	0	0
3	9686142	.	C	A	1	2	3	0	0	3	0	0
3	9706117	.	T	G	2	2	4	0	0	4	0	0
3	9706445	.	T	C	5	4	9	0	1	10	0	0
3	10152166	.	G	T	2	2	4	0	0	4	0	0
3	10163405	.	T	C	2	2	4	0	0	4	0	0
3	10163785	.	A	G	4	0	4	0	7	11	0	0
3	10163815	.	G	A	5	7	12	0	1	14	1	0
3	10163971	.	G	A	5	3	8	0	0	8	0	0
3	10164338	.	C	G	2	2	4	0	0	4	0	0
3	10164352	.	A	C	2	2	4	0	0	4	0	0
3	10410920	.	T	C	1	2	3	0	0	3	0	0
3	10412073	.	G	A	2	4	6	0	0	6	0	0
3	10536157	.	T	G	1	7	8	0	0	8	0	0
3	10536511	.	C	T	21	5	26	0	0	26	0	0
3	10536673	.	A	G	14	5	19	0	0	19	0	0
3	10551014	.	G	A	3	11	14	0	1	15	0	0
3	10561044	.	C	T	2	5	7	0	0	7	0	0
3	10561127	.	G	C	3	3	6	0	0	6	0	0
3	10582122	.	C	G	2	4	6	0	0	6	0	0
3	10612103	.	G	A	2	4	6	0	0	6	0	0
3	10634422	.	C	T	6	8	14	0	7	21	0	0
3	10634437	.	T	C	13	6	19	0	1	20	0	0
3	10638563	.	G	T	0	1	1	0	2	3	0	0
3	10638614	.	C	T	2	2	4	0	0	4	0	0
3	11073388	.	A	G	12	15	27	0	1	28	0	0
3	11073431	.	C	T	8	12	20	0	0	20	0	0
3	11073454	.	T	C	15	6	21	0	1	22	0	0
3	11073517	.	C	T	9	18	27	0	0	27	0	0
3	11074764	.	C	G	12	0	12	0	12	24	0	0
3	11075120	.	G	A	13	15	28	0	3	31	0	0
3	11075190	.	G	A	2	15	17	0	7	24	0	0
3	11075310	.	A	G	17	0	17	0	11	28	0	0
3	11564499	.	G	A	4	5	9	0	1	10	0	0
3	11564523	.	T	C	4	8	12	0	0	12	0	0
3	11564592	.	C	T	7	9	16	1	0	17	0	0
3	11575354	.	G	A	0	10	10	0	7	17	0	0
3	11575471	.	T	C	11	3	14	0	0	14	0	0
3	11575591	.	C	A	2	7	9	1	2	12	0	0
3	11575828	.	A	C	2	2	4	0	0	4	0	0
3	11576231	.	A	G	1	3	4	0	0	4	0	0
3	11585488	.	T	A	17	17	34	0	0	34	0	0
3	11585492	.	G	A	17	15	32	0	0	32	0	0
3	11585815	.	A	G	7	10	17	0	0	17	0	0
3	11585852	.	T	A	9	13	22	0	1	23	0	0
3	11585937	.	G	A	12	15	27	0	2	29	0	0
3	11586002	.	T	G	10	6	16	0	18	34	0	0
3	11586028	.	T	A	11	6	17	0	1	18	0	0
3	11586051	.	T	C	10	0	10	0	4	14	0	0
3	11586227	.	C	A	11	3	14	0	0	14	0	0
3	11586331	.	C	T	1	10	11	0	25	36	0	0
3	11586346	.	C	T	23	12	35	0	2	37	0	0
3	11586382	.	G	A	27	11	38	0	3	41	0	0
3	11586679	.	C	T	17	10	27	3	3	33	0	0
3	11586695	.	C	T	2	9	11	6	12	29	0	0
3	11590280	.	A	G	15	19	34	0	1	35	0	0
3	11614970	.	T	C	26	13	39	0	1	40	0	0
3	11615007	.	A	T	24	15	39	0	3	42	0	0
3	11615041	.	T	C	20	0	20	0	24	44	0	0
3	11615109	.	G	A	25	12	37	0	0	37	0	0
3	11615133	.	A	G	22	13	35	0	2	37	0	0
3	11615224	.	A	G	20	14	34	0	0	34	0	0
3	11624298	.	A	G	7	14	21	0	0	21	0	0
3	11781003	.	A	C	11	14	25	0	2	27	0	0
3	11781079	.	T	C	22	8	30	0	5	35	0	0
3	11781113	.	G	A	22	19	41	0	4	45	0	0
3	11784743	.	G	A	15	18	33	0	5	38	0	0
3	11797076	.	C	T	0	13	13	0	6	19	0	0
3	11934018	.	G	A	8	9	17	0	0	17	0	0
3	11934021	.	T	C	8	8	16	0	1	17	0	0
3	11934072	.	C	T	9	8	17	0	1	18	0	0
3	11937063	.	G	A	9	13	22	0	0	22	0	0
3	11937093	.	T	C	10	12	22	0	1	23	0	0
3	11937295	.	C	T	7	4	11	0	0	11	0	0
3	11937499	.	T	C	15	12	27	0	0	27	0	0
3	11941226	.	A	C	14	18	32	0	3	35	0	0
3	11947012	.	A	G	23	0	23	0	7	30	0	0
3	11947323	.	C	G	7	10	17	0	1	18	0	0
3	11947401	.	A	T	7	11	18	0	1	19	0	0
3	11947462	.	G	A	8	2	10	0	0	10	0	0
3	11958700	.	A	T	3	5	8	0	0	8	0	0
3	12131838	.	A	G	2	2	4	0	0	4	0	0
3	12203028	.	C	G	5	5	10	0	0	10	0	0
3	12226807	.	T	C	3	3	6	0	1	7	0	0
3	12226808	.	C	T	3	3	6	0	1	7	0	0
3	12335842	.	T	A	6	2	8	0	0	8	0	0
3	12345351	.	T	C	10	10	20	0	0	20	0	0
3	12345373	.	G	T	12	14	26	0	2	28	0	0
3	12349672	.	A	G	8	14	22	0	1	23	0	0
3	12371848	.	T	A	1	2	3	1	0	4	0	0
3	12371849	.	C	T	1	2	3	1	0	4	0	0
3	12376803	.	C	T	0	3	3	0	5	8	0	0
3	12585827	.	T	C	3	2	5	0	0	5	0	0
3	12630622	.	C	G	3	0	3	0	2	5	0	0
3	12634976	.	C	A	2	2	4	0	0	4	0	0
3	12647220	.	G	T	4	3	7	0	0	7	0	0
3	12647229	.	A	G	4	2	6	0	0	6	0	0
3	12647316	.	T	C	4	4	8	0	0	8	0	0
3	12652186	.	T	C	5	4	9	0	0	9	0	0
3	12658066	.	G	C	4	7	11	0	1	12	0	0
3	12658518	.	T	C	4	2	6	0	2	8	0	0
3	12658591	.	G	A	4	3	7	0	1	8	0	0
3	12672020	.	C	T	9	5	14	0	1	15	0	0
3	12672068	.	C	T	9	5	14	0	1	15	0	0
3	12672195	.	C	A	13	4	17	0	0	17	0	0
3	12678383	.	G	A	6	2	8	0	0	8	0	0
3	12678482	.	A	G	9	4	13	0	1	14	0	0
3	12678993	.	T	C	12	10	22	0	3	25	0	0
3	12679090	.	C	T	12	7	19	0	0	19	0	0
3	12681141	.	C	T	18	10	28	0	0	28	0	0
3	12681359	.	G	A	13	6	19	0	1	20	0	0
3	12689490	.	T	C	14	12	26	0	0	26	0	0
3	12689511	.	A	G	15	0	15	0	10	25	0	0
3	12689613	.	T	A	12	7	19	0	1	20	0	0
3	12691823	.	C	A	6	7	13	0	0	13	0	0
3	12692858	.	G	T	22	8	30	0	2	32	0	0
3	12692859	.	T	G	21	10	31	0	0	31	0	0
3	12698502	.	A	G	16	0	16	0	12	28	0	0
3	12698831	.	A	T	21	11	32	0	1	33	0	0
3	12698890	.	T	C	17	11	28	0	2	30	0	0
3	12698897	.	A	G	16	12	28	0	1	29	0	0
3	12698976	.	C	A	11	13	24	0	3	27	0	0
3	12699026	.	T	A	13	7	20	0	2	22	0	0
3	12699044	.	T	C	14	7	21	0	1	22	0	0
3	12699073	.	T	A	15	6	21	0	0	21	0	0
3	12699260	.	A	G	14	14	28	0	0	28	0	0
3	12699274	.	C	T	15	14	29	0	1	30	0	0
3	12699311	.	A	T	14	10	24	0	2	26	0	0
3	12699525	.	C	T	22	15	37	0	0	37	0	0
3	12699662	.	C	T	18	5	23	0	1	24	0	0
3	12831862	.	A	C	5	2	7	0	2	9	0	0
3	13424069	.	C	A	6	2	8	0	1	9	0	0
3	13424392	.	T	G	5	5	10	0	0	10	0	0
3	13424595	.	A	T	3	9	12	0	0	12	0	0
3	13424601	.	T	G	3	8	11	0	1	12	0	0
3	13424635	.	G	A	5	6	11	0	0	11	0	0
3	13424847	.	G	T	7	7	14	0	0	14	0	0
3	13424877	.	T	C	8	9	17	0	1	18	0	0
3	13424919	.	T	C	11	10	21	0	0	21	0	0
3	13424950	.	A	T	7	7	14	0	2	16	0	0
3	13424968	.	C	T	3	9	12	0	0	12	0	0
3	13424989	.	C	A	2	8	10	0	5	15	0	0
3	13426691	.	G	A	8	6	14	0	0	14	0	0
3	13426754	.	C	A	0	17	17	0	4	21	0	0
3	13430606	.	A	G	14	14	28	0	0	28	0	0
3	13431327	.	G	A	13	14	27	0	2	29	0	0
3	13432609	.	C	T	8	12	20	0	0	20	0	0
3	13434860	.	C	T	1	9	10	1	6	17	0	0
3	13434888	.	A	G	7	14	21	0	0	21	0	0
3	13434920	.	C	G	7	10	17	0	2	19	0	0
3	13434930	.	A	T	6	12	18	0	1	19	0	0
3	13435998	.	T	C	8	0	8	0	10	18	0	0
3	13437767	.	G	A	4	10	14	0	0	14	0	0
3	13445758	.	G	A	0	6	6	0	8	14	0	0
3	13445819	.	T	C	9	7	16	0	0	16	0	0
3	13445884	.	T	G	9	5	14	0	0	14	0	0
3	13446019	.	C	T	5	9	14	0	0	14	0	0
3	13447870	.	C	T	6	19	25	0	1	26	0	0
3	13453494	.	C	T	7	5	12	0	0	12	0	0
3	13453500	.	A	G	6	5	11	0	0	11	0	0
3	13456393	.	G	A	2	3	5	0	0	5	0	0
3	13456436	.	A	G	3	5	8	0	0	8	0	0
3	13456472	.	C	T	0	2	2	0	2	4	0	0
3	13456492	.	T	C	3	2	5	0	1	6	0	0
3	13488422	.	C	T	3	3	6	0	0	6	0	0
3	13504965	.	C	T	1	2	3	0	2	5	0	0
3	13524193	.	T	C	6	2	8	0	0	8	0	0
3	13524274	.	T	A	1	2	3	1	0	4	0	0
3	13524281	.	T	C	1	2	3	1	0	4	0	0
3	13525775	.	T	A	2	3	5	0	1	6	0	0
3	13525976	.	C	G	6	3	9	0	0	9	0	0
3	13526043	.	A	G	4	5	9	0	2	11	0	0
3	13534291	.	C	T	0	4	4	0	4	8	0	0
3	13534311	.	G	C	2	4	6	0	0	6	0	0
3	13534339	.	C	T	1	2	3	0	1	4	0	0
3	13535827	.	C	T	0	2	2	0	3	5	0	0
3	13541879	.	C	T	0	2	2	0	3	5	0	0
3	13542252	.	C	T	3	3	6	0	0	6	0	0
3	13582031	.	A	T	1	2	3	0	0	3	0	0
3	13582156	.	T	C	16	11	27	2	1	30	0	0
3	13582181	.	G	A	21	11	32	0	0	32	0	0
3	13582217	.	G	T	23	11	34	0	1	35	0	0
3	13582220	.	A	T	22	11	33	0	1	34	0	0
3	13582288	.	A	T	15	13	28	0	4	32	0	0
3	13582295	.	T	A	18	11	29	0	3	32	0	0
3	13582547	.	C	G	3	15	18	0	13	31	0	0
3	13589391	.	G	T	11	10	21	0	2	23	0	0
3	13589412	.	G	A	12	11	23	0	0	23	0	0
3	13589469	.	A	G	9	19	28	0	1	29	0	0
3	13590995	.	G	A	16	11	27	0	0	27	0	0
3	13593605	.	C	T	12	9	21	0	3	24	0	0
3	13595100	.	A	G	9	4	13	0	0	13	0	0
3	13595245	.	G	A	10	9	19	0	0	19	0	0
3	13595686	.	C	T	13	15	28	0	0	28	0	0
3	13599436	.	A	G	8	6	14	0	1	15	0	0
3	13603365	.	T	G	6	3	9	0	1	10	0	0
3	13607036	.	G	A	0	2	2	0	6	8	0	0
3	13607051	.	T	C	5	2	7	0	1	8	0	0
3	13617738	.	T	A	1	6	7	0	0	7	0	0
3	13617993	.	G	T	1	2	3	0	0	3	0	0
3	13618095	.	A	G	3	3	6	0	0	6	0	0
3	13618203	.	A	T	5	7	12	0	1	13	0	0
3	13860363	.	G	A	17	20	37	0	4	41	0	0
3	14496729	.	T	C	16	1	17	0	20	37	0	0
3	14585727	.	C	T	1	6	7	0	0	7	0	0
3	14598409	.	C	T	1	5	6	0	0	6	0	0
3	14605750	.	T	C	3	4	7	0	1	8	0	0
3	14605813	.	G	A	1	2	3	0	1	4	0	0
3	14605841	.	A	T	1	2	3	0	0	3	0	0
3	14605868	.	A	G	3	0	3	0	2	5	0	0
3	14692201	.	T	C	18	20	38	0	1	39	0	0
3	14692204	.	T	C	19	0	19	0	20	39	0	0
3	14694835	.	G	A	23	13	36	0	0	36	0	0
3	14860158	.	C	T	9	4	13	0	1	14	0	0
3	15020506	.	C	T	13	8	21	0	1	22	0	0
3	15020548	.	T	A	13	9	22	0	2	24	0	0
3	15020572	.	C	T	13	12	25	0	0	25	0	0
3	15041021	.	C	T	9	16	25	0	1	26	0	0
3	15041084	.	T	C	12	15	27	0	2	29	0	0
3	15057214	.	G	T	17	10	27	0	1	28	0	0
3	15057538	.	C	T	9	16	25	0	0	25	0	0
3	15057549	.	T	G	16	9	25	0	0	25	0	0
3	15057656	.	G	A	0	10	10	0	10	20	0	0
3	15057697	.	G	T	0	6	6	0	6	12	0	0
3	15058278	.	A	T	8	12	20	0	0	20	0	0
3	15058323	.	A	G	6	11	17	0	2	19	0	0
3	15085528	.	C	T	6	7	13	0	0	13	0	0
3	15085530	.	G	T	6	7	13	0	0	13	0	0
3	15085821	.	C	T	9	14	23	0	0	23	0	0
3	15091183	.	C	T	0	5	5	0	5	10	0	0
3	15091201	.	A	G	4	4	8	0	0	8	0	0
3	15095987	.	A	G	13	5	18	0	0	18	0	0
3	15110967	.	T	C	1	2	3	0	0	3	0	0
3	15113378	.	A	G	1	5	6	0	0	6	0	0
3	15114919	.	G	A	5	3	8	0	0	8	0	0
3	15114935	.	C	T	2	2	4	0	0	4	0	0
3	15131295	.	C	A	0	2	2	0	3	5	0	0
3	15134326	.	G	A	2	2	4	0	0	4	0	0
3	15134327	.	G	A	2	2	4	0	0	4	0	0
3	15134427	.	G	A	1	3	4	0	0	4	0	0
3	15134894	.	T	A	12	3	15	0	1	16	0	0
3	15137023	.	C	T	6	7	13	0	1	14	0	0
3	15137045	.	A	G	11	8	19	0	0	19	0	0
3	15193773	.	T	A	12	6	18	0	0	18	0	0
3	15198701	.	A	G	9	19	28	2	1	31	0	0
3	15203329	.	C	A	22	15	37	1	1	39	0	0
3	15203371	.	A	C	14	25	39	1	4	44	0	0
3	15203388	.	T	G	26	15	41	0	1	42	0	0
3	15203935	.	C	T	8	12	20	0	1	21	0	0
3	15203977	.	G	A	8	14	22	0	1	23	0	0
3	15207876	.	T	A	12	12	24	0	0	24	0	0
3	15214252	.	A	C	5	12	17	0	2	19	0	0
3	15214300	.	T	A	9	4	13	0	0	13	0	0
3	15214462	.	C	A	9	15	24	0	3	27	0	0
3	15214475	.	T	A	5	17	22	0	0	22	0	0
3	15214683	.	C	T	6	8	14	0	5	19	0	0
3	15215101	.	T	A	6	5	11	0	0	11	0	0
3	15215599	.	G	A	7	6	13	0	0	13	0	0
3	15215625	.	G	A	5	6	11	0	0	11	0	0
3	15217246	.	A	G	16	7	23	0	0	23	0	0
3	15217255	.	C	T	15	6	21	0	0	21	0	0
3	15223921	.	G	A	8	4	12	0	0	12	0	0
3	15232447	.	A	G	26	35	61	0	3	64	0	0
3	15232481	.	G	A	31	25	56	0	1	57	0	0
3	15232498	.	G	A	25	30	55	0	2	57	0	0
3	15242201	.	C	T	1	20	21	0	24	45	0	0
3	15245973	.	C	T	19	22	41	0	2	43	0	0
3	15246060	.	T	C	19	30	49	0	1	50	0	0
3	15246871	.	C	T	18	24	42	1	2	45	0	0
3	15255286	.	C	T	6	5	11	0	0	11	0	0
3	15255334	.	C	T	0	5	5	0	2	7	0	0
3	15258440	.	T	A	5	9	14	0	1	15	0	0
3	15258676	.	G	A	11	4	15	0	0	15	0	0
3	15259118	.	G	A	6	2	8	0	0	8	0	0
3	15272263	.	A	G	6	4	10	0	2	12	0	0
3	15273982	.	G	C	11	10	21	0	1	22	0	0
3	15274280	.	G	A	1	11	12	0	13	25	0	0
3	15274320	.	G	A	13	12	25	0	1	26	0	0
3	15274649	.	G	A	1	10	11	0	14	25	0	0
3	15274691	.	T	C	15	6	21	0	1	22	0	0
3	15278931	.	A	G	17	0	17	0	15	32	0	0
3	15279045	.	C	G	22	9	31	0	0	31	0	0
3	15282328	.	C	T	12	23	35	0	1	36	0	0
3	15284041	.	C	T	11	10	21	0	1	22	0	0
3	15284047	.	C	T	12	9	21	0	1	22	0	0
3	15284513	.	C	A	7	5	12	1	21	34	0	0
3	15284604	.	G	A	0	10	10	0	7	17	0	0
3	15310362	.	A	G	3	2	5	0	0	5	0	0
3	15310678	.	T	A	1	1	2	0	1	3	0	0
3	15317111	.	A	T	1	2	3	0	0	3	0	0
3	15317262	.	A	G	1	4	5	0	0	5	0	0
3	15332476	.	C	A	18	16	34	0	1	35	0	0
3	15332538	.	C	G	21	27	48	0	1	49	0	0
3	15332641	.	C	T	18	11	29	0	0	29	0	0
3	15550837	.	C	T	4	3	7	0	1	8	0	0
3	15551446	.	A	C	4	2	6	0	0	6	0	0
3	15562804	.	G	A	1	11	12	0	9	21	0	0
3	15562834	.	A	C	15	10	25	0	1	26	0	0
3	15591107	.	C	T	12	7	19	0	0	19	0	0
3	15599576	.	A	G	9	0	9	0	12	21	0	0
3	15607970	.	T	G	16	13	29	0	3	32	0	0
3	15608000	.	C	A	15	14	29	0	1	30	0	0
3	15623132	.	T	G	1	5	6	0	0	6	0	0
3	15627502	.	G	A	4	6	10	0	0	10	0	0
3	15627722	.	G	A	14	6	20	0	2	22	0	0
3	15627806	.	G	C	11	9	20	0	0	20	0	0
3	15628704	.	A	C	3	2	5	0	0	5	0	0
3	15629022	.	T	C	8	3	11	0	0	11	0	0
3	15629149	.	G	C	5	3	8	0	1	9	0	0
3	15635069	.	A	G	3	4	7	0	0	7	0	0
3	15635237	.	T	C	3	3	6	0	0	6	0	0
3	15635249	.	T	C	4	3	7	0	0	7	0	0
3	15637716	.	C	G	2	8	10	0	2	12	0	0
3	15642468	.	A	T	7	2	9	0	0	9	0	0
3	15642472	.	A	T	7	2	9	0	0	9	0	0
3	15642539	.	C	T	7	2	9	0	0	9	0	0
3	15642576	.	G	C	1	7	8	0	0	8	0	0
3	15642595	.	T	C	2	0	2	0	5	7	0	0
3	15642812	.	T	A	1	2	3	0	0	3	0	0
3	15646974	.	T	A	5	7	12	0	0	12	0	0
3	15647784	.	G	A	4	3	7	0	0	7	0	0
3	15648759	.	T	C	10	5	15	0	0	15	0	0
3	15648767	.	C	T	8	6	14	0	1	15	0	0
3	15648886	.	C	T	6	2	8	0	0	8	0	0
3	15649094	.	T	C	5	3	8	0	0	8	0	0
3	15649096	.	G	A	4	3	7	0	0	7	0	0
3	15649675	.	G	A	6	2	8	0	0	8	0	0
3	15649731	.	C	T	5	3	8	0	0	8	0	0
3	15661849	.	T	C	2	0	2	0	5	7	0	0
3	15667548	.	G	A	2	2	4	0	0	4	0	0
3	15670246	.	C	T	2	4	6	0	1	7	0	0
3	15670456	.	T	C	2	3	5	0	0	5	0	0
3	15670457	.	G	T	2	3	5	0	0	5	0	0
3	15670746	.	A	G	2	4	6	0	0	6	0	0
3	15670769	.	C	T	0	3	3	0	2	5	0	0
3	15670812	.	T	C	1	2	3	0	0	3	0	0
3	15671578	.	A	T	2	4	6	0	1	7	0	0
3	15671703	.	G	A	6	3	9	0	0	9	0	0
3	15671704	.	A	G	6	3	9	0	0	9	0	0
3	15679004	.	C	A	1	2	3	0	1	4	0	0
3	15697388	.	A	G	8	9	17	0	1	18	0	0
3	15697454	.	A	G	12	8	20	0	1	21	0	0
3	15697487	.	G	T	5	8	13	0	2	15	0	0
3	15697529	.	C	T	6	6	12	0	0	12	0	0
3	15706550	.	T	A	8	10	18	0	2	20	0	0
3	15706582	.	G	A	6	11	17	0	1	18	0	0
3	15715141	.	A	G	2	6	8	0	0	8	0	0
3	15717641	.	C	G	3	3	6	0	0	6	0	0
3	15741954	.	C	T	11	8	19	0	4	23	0	0
3	15744752	.	A	G	14	0	14	0	25	39	0	0
3	15744895	.	G	A	21	19	40	0	1	41	0	0
3	15746427	.	T	A	18	13	31	0	0	31	0	0
3	15746488	.	T	C	10	15	25	0	1	26	0	0
3	15746518	.	G	T	8	17	25	0	0	25	0	0
3	15746612	.	G	A	18	9	27	0	1	28	0	0
3	15746613	.	T	C	18	10	28	0	0	28	0	0
3	15746701	.	C	T	11	15	26	0	1	27	0	0
3	15746884	.	G	T	7	19	26	0	2	28	0	0
3	15746937	.	A	T	7	4	11	0	0	11	0	0
3	15746938	.	C	T	8	4	12	0	0	12	0	0
3	15775992	.	C	G	6	0	6	0	6	12	0	0
3	15776000	.	G	A	0	5	5	0	6	11	0	0
3	15776027	.	G	A	2	6	8	0	7	15	0	0
3	15776060	.	C	T	5	10	15	0	0	15	0	0
3	15776153	.	T	C	7	5	12	0	0	12	0	0
3	15776377	.	G	A	5	5	10	0	0	10	0	0
3	15776603	.	T	A	1	4	5	0	1	6	0	0
3	15776624	.	G	A	5	2	7	0	0	7	0	0
3	15794907	.	C	G	13	1	14	0	8	22	0	0
3	15795012	.	C	T	11	7	18	0	0	18	0	0
3	15795090	.	C	T	13	13	26	0	3	29	0	0
3	15795192	.	A	G	13	9	22	0	4	26	0	0
3	15795395	.	G	A	12	6	18	0	0	18	0	0
3	15809664	.	G	T	2	2	4	0	0	4	0	0
3	15818992	.	T	C	3	7	10	0	1	11	0	0
3	15821653	.	C	T	14	5	19	0	0	19	0	0
3	15821763	.	C	T	8	7	15	0	1	16	0	0
3	15821919	.	C	T	9	7	16	0	0	16	0	0
3	15822017	.	A	T	6	5	11	0	0	11	0	0
3	15822193	.	A	T	6	6	12	0	0	12	0	0
3	15822354	.	A	G	6	0	6	0	3	9	0	0
3	15822491	.	A	T	4	3	7	0	1	8	0	0
3	15822542	.	A	T	2	4	6	0	1	7	0	0
3	15822628	.	A	T	3	8	11	0	0	11	0	0
3	15822668	.	T	C	10	9	19	0	1	20	0	0
3	15822706	.	A	T	11	7	18	0	0	19	1	0
3	15822721	.	T	C	10	5	15	0	1	16	0	0
3	15822758	.	T	C	7	5	12	0	0	12	0	0
3	15822800	.	G	A	6	2	8	0	0	8	0	0
3	15823252	.	T	A	7	5	12	1	2	15	0	0
3	15823267	.	C	A	8	4	12	1	1	14	0	0
3	15823373	.	C	A	13	7	20	0	0	20	0	0
3	15823578	.	T	A	11	5	16	0	0	16	0	0
3	15823857	.	T	A	12	16	28	0	1	29	0	0
3	15823858	.	C	T	9	17	26	0	2	28	0	0
3	15823958	.	A	G	6	3	9	0	0	9	0	0
3	15835605	.	A	C	14	20	34	0	3	37	0	0
3	15835616	.	G	A	2	18	20	0	12	32	0	0
3	15835777	.	G	A	2	14	16	0	18	34	0	0
3	15852739	.	T	A	9	5	14	0	1	15	0	0
3	15856234	.	C	A	1	5	6	0	5	11	0	0
3	15862581	.	A	T	12	10	22	0	3	25	0	0
3	15862687	.	G	A	14	9	23	0	1	24	0	0
3	15862895	.	G	A	15	9	24	0	0	24	0	0
3	15863398	.	G	C	10	8	18	0	0	18	0	0
3	15867593	.	G	A	15	19	34	0	0	34	0	0
3	15868504	.	C	T	8	8	16	0	7	23	0	0
3	15868578	.	C	T	8	3	11	0	2	13	0	0
3	15873653	.	A	G	2	4	6	0	1	7	0	0
3	15876085	.	T	A	5	4	9	0	0	9	0	0
3	15879331	.	G	A	4	5	9	0	0	9	0	0
3	15882141	.	A	G	1	4	5	0	0	5	0	0
3	15882171	.	T	C	5	2	7	0	0	7	0	0
3	15882177	.	G	T	5	3	8	0	0	8	0	0
3	15887079	.	C	T	0	5	5	0	1	6	0	0
3	15900668	.	A	C	10	4	14	1	3	18	0	0
3	15900764	.	C	T	6	3	9	0	0	9	0	0
3	15900849	.	T	C	6	5	11	0	0	11	0	0
3	15900875	.	T	G	5	0	5	0	7	12	0	0
3	15900998	.	C	T	10	4	14	0	1	15	0	0
3	15901024	.	C	T	6	7	13	0	2	15	0	0
3	15901147	.	A	T	12	4	16	0	0	16	0	0
3	15901481	.	C	T	6	11	17	0	0	17	0	0
3	15902013	.	A	C	9	6	15	0	1	16	0	0
3	15907410	.	G	A	7	12	19	0	1	20	0	0
3	15907421	.	T	C	7	9	16	0	0	16	0	0
3	15907523	.	T	G	15	17	32	0	2	34	0	0
3	15907610	.	T	G	14	14	28	0	0	28	0	0
3	15907619	.	C	T	12	16	28	0	0	28	0	0
3	15921020	.	A	G	16	10	26	0	0	26	0	0
3	15921045	.	T	C	14	11	25	0	3	28	0	0
3	15921089	.	T	C	13	9	22	0	1	23	0	0
3	15922002	.	A	T	21	15	36	0	0	36	0	0
3	15957830	.	T	G	21	0	21	0	14	35	0	0
3	15957896	.	T	C	19	19	38	0	4	42	0	0
3	15957962	.	T	C	15	24	39	0	4	43	0	0
3	15969632	.	A	C	15	18	33	0	0	33	0	0
3	15974017	.	A	T	23	18	41	0	0	41	0	0
3	15986073	.	G	A	4	22	26	0	36	62	0	0
3	15988105	.	A	G	31	6	37	0	0	37	0	0
3	15988337	.	A	G	20	23	43	0	0	44	1	0
3	15988435	.	A	G	16	10	26	2	2	30	0	0
3	15990607	.	C	T	3	4	7	0	0	7	0	0
3	15990688	.	C	A	8	5	13	0	0	13	0	0
3	15990698	.	A	G	7	4	11	0	0	11	0	0
3	15990797	.	C	T	9	8	17	0	1	18	0	0
3	15990891	.	G	A	6	2	8	0	1	9	0	0
3	15990929	.	A	T	6	3	9	0	0	9	0	0
3	15991141	.	C	T	0	18	18	1	5	24	0	0
3	15993894	.	T	C	11	0	11	0	7	18	0	0
3	15994064	.	C	T	2	4	6	0	1	7	0	0
3	15996759	.	G	T	7	7	14	0	1	15	0	0
3	15996819	.	G	T	12	6	18	0	0	18	0	0
3	16003199	.	C	A	11	4	15	0	2	17	0	0
3	16003208	.	T	C	5	9	14	0	2	16	0	0
3	16003331	.	T	A	14	10	24	0	1	25	0	0
3	16004015	.	G	A	16	20	36	0	3	39	0	0
3	16004240	.	G	A	18	19	37	1	2	40	0	0
3	16018378	.	T	G	5	9	14	0	1	15	0	0
3	16018463	.	A	T	7	6	13	0	1	14	0	0
3	16018813	.	G	A	2	3	5	0	0	5	0	0
3	16019165	.	C	A	11	11	22	0	1	23	0	0
3	16019451	.	A	G	11	6	17	0	1	18	0	0
3	16019455	.	A	T	10	7	17	0	0	17	0	0
3	16019929	.	A	T	4	3	7	0	0	7	0	0
3	16020210	.	C	A	8	3	11	0	0	11	0	0
3	16021057	.	A	G	5	5	10	0	0	10	0	0
3	16021208	.	G	A	3	3	6	0	1	7	0	0
3	16021210	.	T	G	3	3	6	0	1	7	0	0
3	16021244	.	G	A	3	6	9	0	0	9	0	0
3	16021397	.	C	T	5	5	10	0	0	10	0	0
3	16021491	.	T	C	6	2	8	1	2	11	0	0
3	16021723	.	T	A	5	6	11	0	0	11	0	0
3	16021820	.	G	A	2	5	7	0	0	7	0	0
3	16021870	.	G	T	5	2	7	0	1	8	0	0
3	16021960	.	C	T	5	9	14	0	0	14	0	0
3	16022076	.	C	T	1	4	5	0	4	9	0	0
3	16024429	.	C	T	7	8	15	0	0	15	0	0
3	16024459	.	G	A	7	6	13	0	0	13	0	0
3	16024501	.	C	A	3	4	7	0	1	8	0	0
3	16035067	.	T	G	7	4	11	0	0	11	0	0
3	16039493	.	G	A	3	5	8	0	1	9	0	0
3	16045215	.	G	A	21	15	36	0	4	40	0	0
3	16045404	.	A	C	31	38	69	1	3	73	0	0
3	16045544	.	A	G	37	33	70	0	3	73	0	0
3	16045569	.	C	G	43	16	59	0	1	60	0	0
3	16045592	.	T	A	44	28	72	1	2	75	0	0
3	16068159	.	T	G	27	20	47	0	3	51	1	0
3	16073274	.	A	T	19	21	40	0	2	42	0	0
3	16073434	.	A	C	22	0	22	1	22	45	0	0
3	16073453	.	G	A	22	19	41	1	2	44	0	0
3	16073481	.	C	T	23	19	42	0	3	45	0	0
3	16073547	.	C	T	21	26	47	0	4	51	0	0
3	16073594	.	C	T	2	20	22	0	26	48	0	0
3	16073991	.	G	A	36	18	54	0	11	65	0	0
3	16074016	.	T	A	39	24	63	0	2	65	0	0
3	16074031	.	G	A	36	17	53	0	2	55	0	0
3	16074141	.	G	T	30	26	56	0	4	60	0	0
3	16074155	.	G	A	28	21	49	1	3	53	0	0
3	16074340	.	C	G	27	28	55	0	0	55	0	0
3	16074376	.	C	T	1	25	26	0	24	50	0	0
3	16134797	.	C	G	0	5	5	1	6	12	0	0
3	16134798	.	C	G	5	6	11	1	0	12	0	0
3	16138950	.	C	G	11	9	20	0	0	20	0	0
3	16141803	.	C	T	2	7	9	0	0	9	0	0
3	16141870	.	C	T	1	6	7	1	0	8	0	0
3	16157160	.	C	T	1	3	4	0	0	4	0	0
3	16157194	.	A	G	4	2	6	0	0	6	0	0
3	16157220	.	T	G	5	5	10	0	1	11	0	0
3	16157243	.	T	A	6	8	14	0	1	15	0	0
3	16157328	.	G	T	8	17	25	0	0	25	0	0
3	16161653	.	G	T	9	8	17	0	3	20	0	0
3	16165135	.	T	C	4	6	10	0	0	10	0	0
3	16171589	.	G	A	4	6	10	0	1	11	0	0
3	16191248	.	C	T	3	2	5	0	0	5	0	0
3	16227536	.	A	C	3	6	9	0	1	10	0	0
3	16241142	.	T	A	1	4	5	0	0	5	0	0
3	16241162	.	A	T	3	2	5	0	0	5	0	0
3	16241621	.	A	G	2	2	4	0	1	5	0	0
3	16245242	.	T	C	1	0	1	0	2	3	0	0
3	16283797	.	T	C	2	2	4	0	0	4	0	0
3	16283860	.	A	G	3	3	6	0	1	7	0	0
3	16283861	.	G	A	3	3	6	0	1	7	0	0
3	16283989	.	G	T	3	7	10	0	0	10	0	0
3	16284147	.	T	C	4	3	7	0	1	8	0	0
3	16284258	.	C	T	2	2	4	0	0	4	0	0
3	16285193	.	C	T	2	2	4	0	0	4	0	0
3	16389180	.	G	T	5	3	8	0	1	9	0	0
3	16389230	.	C	T	11	7	18	0	1	19	0	0
3	16389517	.	C	T	21	14	35	0	1	36	0	0
3	16391695	.	G	A	7	5	12	0	1	13	0	0
3	16391719	.	T	C	2	0	2	0	10	12	0	0
3	16394522	.	A	G	7	8	15	0	0	15	0	0
3	16397627	.	A	T	3	8	11	0	1	12	0	0
3	16404204	.	T	C	2	3	5	0	1	6	0	0
3	16404370	.	G	A	2	2	4	0	0	4	0	0
3	16404382	.	G	A	3	2	5	0	0	5	0	0
3	16404406	.	G	C	1	5	6	0	0	6	0	0
3	16408960	.	A	G	1	3	4	0	1	5	0	0
3	16455693	.	G	A	3	2	5	0	0	5	0	0
3	16455740	.	C	A	3	2	5	0	0	5	0	0
3	16456255	.	C	T	3	2	5	0	0	5	0	0
3	16457532	.	G	A	2	4	6	0	0	6	0	0
3	16457843	.	C	A	1	6	7	0	0	7	0	0
3	16457921	.	A	T	2	2	4	0	0	4	0	0
3	16476588	.	C	T	1	2	3	0	0	3	0	0
3	16516044	.	C	T	1	2	3	0	0	3	0	0
3	16637830	.	C	T	10	7	17	0	0	17	0	0
3	16637877	.	G	A	11	5	16	0	0	16	0	0
3	16643170	.	A	G	5	7	12	0	2	14	0	0
3	16645507	.	A	C	17	11	28	0	1	29	0	0
3	16646520	.	A	G	14	16	30	0	0	30	0	0
3	16646562	.	T	C	19	13	32	0	1	33	0	0
3	16664476	.	T	C	9	7	16	0	0	16	0	0
3	16664530	.	C	T	6	6	12	0	0	12	0	0
3	16668671	.	C	T	7	6	13	0	0	13	0	0
3	16670880	.	T	G	5	1	6	0	5	11	0	0
3	16671831	.	A	G	6	0	6	0	12	18	0	0
3	16671849	.	A	G	9	0	9	0	9	18	0	0
3	16678754	.	G	A	1	4	5	0	19	24	0	0
3	16678830	.	C	T	8	10	18	0	1	19	0	0
3	16679136	.	C	T	12	3	15	0	1	16	0	0
3	16679171	.	T	G	10	4	14	0	0	14	0	0
3	16679172	.	G	T	9	4	13	0	0	13	0	0
3	16679238	.	C	T	3	9	12	0	1	13	0	0
3	16679248	.	C	T	4	9	13	0	0	13	0	0
3	16679349	.	G	A	5	4	9	0	0	9	0	0
3	16679520	.	G	A	6	6	12	0	0	12	0	0
3	16679556	.	G	A	0	5	5	0	5	10	0	0
3	16679561	.	A	G	5	0	5	0	5	10	0	0
3	16691951	.	A	G	2	3	5	0	1	6	0	0
3	16692232	.	A	G	2	3	5	0	0	5	0	0
3	16731938	.	A	G	3	0	3	0	5	8	0	0
3	16746036	.	T	C	14	13	27	0	1	28	0	0
3	16746153	.	A	C	18	21	39	0	0	39	0	0
3	16746659	.	A	T	3	4	7	0	0	7	0	0
3	16746666	.	T	C	4	3	7	0	0	7	0	0
3	16746718	.	T	A	3	5	8	0	1	9	0	0
3	16746756	.	G	A	6	7	13	0	0	13	0	0
3	16746782	.	A	G	7	4	11	0	0	11	0	0
3	16746849	.	C	A	14	9	23	0	0	23	0	0
3	16746871	.	T	G	14	12	26	0	1	27	0	0
3	16747148	.	T	C	9	18	27	0	2	29	0	0
3	16841984	.	C	A	2	2	4	0	0	4	0	0
3	16842168	.	A	G	1	2	3	0	0	3	0	0
3	16869168	.	T	A	1	2	3	0	0	3	0	0
3	16871897	.	T	C	1	3	4	0	0	4	0	0
3	16872038	.	T	A	1	3	4	0	0	4	0	0
3	16872084	.	A	G	3	3	6	0	1	7	0	0
3	16872200	.	C	T	5	6	11	0	1	12	0	0
3	16872453	.	A	T	3	4	7	0	0	7	0	0
3	16872493	.	T	C	5	4	9	0	0	9	0	0
3	16872572	.	T	C	5	8	13	0	0	13	0	0
3	16872584	.	G	A	0	10	10	0	6	16	0	0
3	16872634	.	A	G	1	8	9	0	2	11	0	0
3	16972991	.	T	C	5	4	9	0	0	9	0	0
3	17030751	.	A	G	3	1	4	0	3	7	0	0
3	17090749	.	T	C	2	6	8	0	0	8	0	0
3	17090956	.	T	C	4	4	8	0	0	8	0	0
3	17093097	.	T	C	3	4	7	0	0	7	0	0
3	17104220	.	T	C	3	3	6	0	0	6	0	0
3	17107058	.	G	C	1	4	5	1	2	8	0	0
3	17107067	.	A	T	1	4	5	1	2	8	0	0
3	17107194	.	T	A	3	2	5	0	0	5	0	0
3	17107216	.	A	T	0	2	2	0	1	3	0	0
3	17292909	.	A	C	1	2	3	0	1	4	0	0
3	17292914	.	G	A	2	2	4	0	0	4	0	0
3	17321179	.	G	T	1	2	3	0	1	4	0	0
3	17458045	.	C	T	1	2	3	0	0	3	0	0
3	17458615	.	C	T	5	6	11	0	3	14	0	0
3	17458888	.	A	G	2	0	2	0	7	9	0	0
3	17481844	.	C	T	2	4	6	0	0	6	0	0
3	17481886	.	T	C	3	4	7	0	0	7	0	0
3	17481955	.	G	A	0	6	6	0	3	9	0	0
3	17482012	.	G	A	6	7	13	0	1	14	0	0
3	17522960	.	A	G	2	0	2	0	11	13	0	0
3	17600574	.	A	T	2	4	6	0	0	6	0	0
3	17602203	.	G	T	4	2	6	0	0	6	0	0
3	17602332	.	A	C	2	4	6	0	0	6	0	0
3	17615630	.	A	C	3	8	11	0	0	11	0	0
3	17634816	.	T	C	11	13	24	0	4	28	0	0
3	17640544	.	C	T	18	21	39	0	1	40	0	0
3	17647236	.	T	C	10	23	33	0	5	38	0	0
3	17650732	.	A	G	22	29	51	0	9	60	0	0
3	17650927	.	C	G	18	17	35	0	2	37	0	0
3	17651072	.	A	G	19	1	20	0	29	49	0	0
3	17651382	.	C	T	15	14	29	0	1	30	0	0
3	17651718	.	C	T	19	23	42	0	0	42	0	0
3	17651837	.	C	T	10	16	26	0	2	28	0	0
3	17669484	.	T	C	4	3	7	0	0	7	0	0
3	17671843	.	G	A	2	3	5	0	1	6	0	0
3	17671888	.	G	A	4	6	10	0	0	10	0	0
3	17671897	.	T	C	4	2	6	0	1	7	0	0
3	17673157	.	G	C	6	8	14	0	1	16	1	0
3	17673250	.	C	T	4	8	12	0	0	12	0	0
3	17673386	.	C	T	2	7	9	0	0	9	0	0
3	17677237	.	G	T	2	7	9	0	0	9	0	0
3	17678335	.	T	C	5	7	12	0	0	12	0	0
3	17806542	.	C	T	8	7	15	0	0	15	0	0
3	17813564	.	A	G	10	0	10	0	5	15	0	0
3	17847103	.	T	G	7	4	11	0	3	14	0	0
3	17853383	.	T	C	5	9	14	0	1	15	0	0
3	17853488	.	C	T	5	5	10	0	1	11	0	0
3	17867440	.	T	C	7	6	13	0	0	13	0	0
3	17867564	.	T	C	14	8	22	0	8	30	0	0
3	17867647	.	T	C	17	5	22	0	0	22	0	0
3	17867668	.	T	A	6	9	15	0	3	18	0	0
3	17867683	.	T	A	9	9	18	0	0	18	0	0
3	17867716	.	C	A	3	8	11	0	0	11	0	0
3	17867755	.	T	C	4	2	6	0	0	6	0	0
3	17867784	.	T	C	8	3	11	0	0	11	0	0
3	17868103	.	G	A	7	3	10	0	0	10	0	0
3	17868174	.	T	G	9	4	13	0	0	13	0	0
3	17868416	.	G	A	5	2	7	0	0	7	0	0
3	17868540	.	T	C	12	0	12	0	3	15	0	0
3	17868585	.	G	A	14	7	21	0	2	23	0	0
3	17868586	.	T	C	14	7	21	0	1	22	0	0
3	17868669	.	C	A	4	6	10	0	0	10	0	0
3	17868673	.	A	G	4	6	10	0	0	10	0	0
3	17869300	.	G	A	11	6	17	0	0	17	0	0
3	17886528	.	G	A	11	9	20	0	1	21	0	0
3	17886996	.	C	T	7	10	17	0	0	17	0	0
3	17894416	.	A	G	4	12	16	1	2	19	0	0
3	17896899	.	T	C	9	7	16	0	0	16	0	0
3	17896956	.	T	C	9	13	22	0	2	24	0	0
3	17897723	.	T	C	12	14	26	0	2	28	0	0
3	17899820	.	A	G	27	0	27	1	11	39	0	0
3	17902600	.	C	T	16	17	33	0	5	38	0	0
3	17907520	.	C	T	28	21	49	0	4	53	0	0
3	17907545	.	T	C	22	21	43	0	3	46	0	0
3	17907626	.	T	C	27	21	48	0	3	51	0	0
3	17907741	.	A	T	23	22	45	0	2	47	0	0
3	17907801	.	T	A	25	31	56	0	0	56	0	0
3	17907812	.	T	C	17	27	44	0	9	53	0	0
3	17907861	.	G	T	23	16	39	0	3	42	0	0
3	17907907	.	T	C	24	12	36	1	5	42	0	0
3	17907976	.	G	A	3	18	21	0	23	44	0	0
3	17908002	.	A	G	28	21	49	0	1	50	0	0
3	17908034	.	G	T	25	20	45	0	1	46	0	0
3	17908730	.	T	C	16	20	36	0	0	36	0	0
3	17940057	.	G	C	7	3	10	0	0	10	0	0
3	17940289	.	T	G	5	5	10	0	0	10	0	0
3	17942432	.	C	T	3	5	8	0	0	8	0	0
3	17942468	.	G	A	1	3	4	0	5	9	0	0
3	17942471	.	C	T	5	4	9	0	0	9	0	0
3	17942627	.	C	A	7	4	11	0	1	12	0	0
3	17942948	.	G	C	7	8	15	0	0	15	0	0
3	17943523	.	G	T	9	17	26	0	0	26	0	0
3	17943529	.	C	A	11	15	26	0	0	26	0	0
3	17943567	.	C	A	13	9	22	0	2	24	0	0
3	17943648	.	A	C	7	11	18	0	0	18	0	0
3	17943679	.	C	T	8	10	18	0	1	19	0	0
3	17944149	.	A	G	5	7	12	0	1	13	0	0
3	17967826	.	C	A	6	4	10	0	0	10	0	0
3	17967859	.	G	A	1	5	6	0	0	6	0	0
3	17967880	.	A	G	1	3	4	0	0	4	0	0
3	17967896	.	T	A	1	4	5	0	0	5	0	0
3	17984415	.	G	A	4	3	7	0	0	7	0	0
3	17986376	.	A	C	5	7	12	1	0	13	0	0
3	17988049	.	T	A	12	5	17	0	0	17	0	0
3	17991395	.	A	T	7	9	16	1	3	20	0	0
3	17991465	.	C	T	10	11	21	0	0	21	0	0
3	17991468	.	A	G	10	0	10	0	12	22	0	0
3	17993540	.	G	A	15	10	25	0	0	25	0	0
3	17993892	.	C	T	8	8	16	0	1	17	0	0
3	17995833	.	G	A	6	11	17	0	0	17	0	0
3	17995860	.	T	C	9	11	20	0	0	20	0	0
3	17996064	.	A	T	15	8	23	0	0	23	0	0
3	17996133	.	T	C	8	8	16	0	0	16	0	0
3	17999665	.	T	G	18	19	37	0	0	37	0	0
3	17999773	.	T	C	18	17	35	0	2	37	0	0
3	18002989	.	T	G	27	13	40	0	2	42	0	0
3	18004984	.	T	C	18	25	43	0	2	45	0	0
3	18004987	.	C	T	20	21	41	0	2	43	0	0
3	18006423	.	T	C	17	16	33	0	3	36	0	0
3	18007841	.	A	G	12	3	15	0	2	17	0	0
3	18007946	.	T	G	18	24	42	0	0	42	0	0
3	18008040	.	C	G	25	22	47	0	0	47	0	0
3	18008083	.	T	C	19	20	39	0	3	42	0	0
3	18008095	.	A	T	18	26	44	0	1	45	0	0
3	18008273	.	T	A	17	21	38	3	3	44	0	0
3	18008351	.	C	G	25	27	52	0	0	52	0	0
3	18008510	.	T	C	18	23	41	1	3	45	0	0
3	18008564	.	A	G	21	20	41	0	1	42	0	0
3	18008642	.	G	C	17	16	33	0	3	37	1	0
3	18008833	.	C	A	6	6	12	0	0	12	0	0
3	18008853	.	G	A	5	4	9	0	0	9	0	0
3	18056951	.	G	C	3	6	9	0	0	9	0	0
3	18059698	.	G	A	9	5	14	0	0	14	0	0
3	18061548	.	A	G	1	6	7	0	0	7	0	0
3	18066006	.	T	C	11	5	16	0	0	16	0	0
3	18069821	.	C	T	5	13	18	0	1	19	0	0
3	18070082	.	T	C	6	4	10	0	0	10	0	0
3	18079296	.	G	A	7	5	12	0	3	15	0	0
3	18079331	.	C	G	5	8	13	0	0	13	0	0
3	18079662	.	A	G	8	0	8	0	10	18	0	0
3	18079754	.	T	C	2	9	11	0	1	12	0	0
3	18079787	.	C	T	2	8	10	0	0	10	0	0
3	18080208	.	G	A	12	6	18	0	0	18	0	0
3	18080439	.	T	C	2	3	5	0	0	5	0	0
3	18186295	.	C	T	4	20	24	0	16	40	0	0
3	18189151	.	C	A	26	22	48	0	0	48	0	0
3	18189250	.	A	T	13	22	35	0	0	35	0	0
3	18303452	.	A	G	4	3	7	0	2	9	0	0
3	18303473	.	G	C	6	3	9	0	0	9	0	0
3	18333407	.	A	G	8	3	11	0	0	11	0	0
3	18376403	.	A	T	19	4	23	1	2	26	0	0
3	18376408	.	A	T	18	4	22	1	1	24	0	0
3	18376464	.	T	C	16	11	27	0	1	28	0	0
3	18377229	.	T	G	7	8	15	0	0	15	0	0
3	18377230	.	A	G	7	7	14	0	1	15	0	0
3	18377406	.	C	T	1	11	12	0	14	26	0	0
3	18377441	.	A	T	11	13	24	0	0	24	0	0
3	18377514	.	T	C	9	13	22	0	1	23	0	0
3	18377728	.	C	T	2	23	25	0	19	44	0	0
3	18379645	.	T	G	2	7	9	0	5	14	0	0
3	18383126	.	A	G	5	3	8	0	1	9	0	0
3	18383141	.	G	A	7	4	11	0	1	12	0	0
3	18384272	.	C	T	3	4	7	0	1	8	0	0
3	18384424	.	T	A	6	6	12	0	0	12	0	0
3	18399412	.	A	G	44	30	74	0	3	77	0	0
3	18399695	.	G	A	33	33	66	0	1	67	0	0
3	18400615	.	A	C	27	29	56	0	4	60	0	0
3	18400819	.	G	A	34	36	70	1	1	72	0	0
3	18405239	.	A	C	12	0	12	0	12	24	0	0
3	18407179	.	A	T	25	28	53	0	3	56	0	0
3	18407184	.	T	C	24	0	24	0	32	56	0	0
3	18409607	.	A	G	29	27	56	0	1	57	0	0
3	18409612	.	T	G	29	26	55	0	2	57	0	0
3	18410941	.	T	C	10	4	14	0	0	14	0	0
3	18429610	.	A	G	2	2	4	0	1	5	0	0
3	18429667	.	G	A	2	3	5	0	1	6	0	0
3	18431867	.	C	A	5	3	8	0	0	8	0	0
3	18435053	.	C	T	1	2	3	0	0	3	0	0
3	18435063	.	G	C	1	2	3	0	0	3	0	0
3	18435421	.	T	A	1	2	3	0	0	3	0	0
3	18447738	.	T	C	6	8	14	0	2	16	0	0
3	18448093	.	C	T	8	10	18	0	0	18	0	0
3	18448234	.	A	G	5	3	8	0	1	9	0	0
3	18448294	.	T	C	7	3	10	0	0	10	0	0
3	18468905	.	G	A	10	3	13	0	0	13	0	0
3	18468932	.	T	G	10	5	15	0	0	15	0	0
3	18469004	.	T	C	9	4	13	0	1	14	0	0
3	18473078	.	A	G	8	0	8	0	8	16	0	0
3	18487320	.	G	T	13	13	26	0	0	26	0	0
3	18498313	.	T	C	10	8	18	0	2	20	0	0
3	18498486	.	C	T	8	8	16	0	0	16	0	0
3	18498563	.	A	G	4	8	12	0	0	12	0	0
3	18561461	.	T	C	5	4	9	0	1	10	0	0
3	18562193	.	T	C	3	7	10	0	1	11	0	0
3	18562235	.	G	A	5	5	10	0	0	10	0	0
3	18562418	.	T	C	8	3	11	0	0	11	0	0
3	18562584	.	T	C	1	2	3	0	0	3	0	0
3	18563512	.	A	T	7	3	10	0	0	10	0	0
3	18568896	.	G	A	9	3	12	0	2	14	0	0
3	18569080	.	C	A	1	5	6	0	0	6	0	0
3	18569659	.	G	C	13	4	17	0	0	17	0	0
3	18569699	.	C	A	9	4	13	0	0	13	0	0
3	18569905	.	A	C	6	6	12	0	1	13	0	0
3	18570029	.	A	T	7	3	10	0	1	11	0	0
3	18570041	.	G	T	0	4	4	0	7	11	0	0
3	18570142	.	T	C	3	4	7	0	0	7	0	0
3	18570161	.	C	T	3	3	6	0	0	6	0	0
3	18570434	.	A	C	11	10	21	0	1	22	0	0
3	18570683	.	G	C	6	5	11	0	1	12	0	0
3	18570696	.	G	A	7	3	10	0	0	10	0	0
3	18570759	.	A	G	2	6	8	0	3	11	0	0
3	18570815	.	G	A	3	6	9	0	0	9	0	0
3	18570904	.	G	A	4	4	8	0	1	9	0	0
3	18676153	.	C	T	6	8	14	0	2	16	0	0
3	18676186	.	G	A	9	11	20	0	2	22	0	0
3	18676190	.	T	A	10	12	22	0	1	23	0	0
3	18676224	.	A	T	10	7	17	0	0	17	0	0
3	18676551	.	C	T	0	2	2	0	2	4	0	0
3	18676830	.	G	A	2	4	6	0	0	6	0	0
3	18676832	.	G	A	2	4	6	0	0	6	0	0
3	18676953	.	T	C	2	5	7	0	0	7	0	0
3	18677047	.	A	T	3	4	7	0	0	7	0	0
3	18677077	.	A	G	7	4	11	0	1	12	0	0
3	18677171	.	C	T	15	11	26	0	1	27	0	0
3	18677314	.	C	T	7	5	12	0	0	12	0	0
3	18677389	.	G	T	11	13	24	0	3	27	0	0
3	18680023	.	A	C	9	7	16	0	1	17	0	0
3	18685468	.	A	T	17	16	33	0	2	35	0	0
3	18685471	.	T	A	16	15	31	0	3	34	0	0
3	18685669	.	T	C	7	4	11	0	5	16	0	0
3	18685762	.	C	G	0	7	7	0	12	19	0	0
3	18685918	.	T	C	9	17	26	0	2	28	0	0
3	18686542	.	T	C	10	6	16	0	1	17	0	0
3	18686781	.	T	C	5	0	5	0	7	12	0	0
3	18689384	.	C	T	0	2	2	1	1	4	0	0
3	18720644	.	C	T	0	8	8	0	7	15	0	0
3	18720719	.	A	G	3	3	6	0	2	8	0	0
3	18720949	.	G	A	5	3	8	0	0	8	0	0
3	18723030	.	G	A	5	6	11	0	0	11	0	0
3	18723036	.	T	C	5	6	11	0	1	12	0	0
3	18723095	.	A	G	5	6	11	1	1	13	0	0
3	18732955	.	A	T	3	5	8	0	0	8	0	0
3	18732969	.	G	C	4	4	8	0	0	8	0	0
3	18760534	.	T	C	2	2	4	0	1	5	0	0
3	18760539	.	G	A	0	2	2	0	3	5	0	0
3	18765436	.	T	C	4	4	8	0	1	9	0	0
3	18768933	.	T	C	4	8	12	0	0	12	0	0
3	18769081	.	T	C	4	5	9	0	1	10	0	0
3	18769165	.	T	C	5	4	9	0	0	9	0	0
3	18769380	.	C	A	2	4	6	0	0	6	0	0
3	18774922	.	T	A	8	5	13	0	3	16	0	0
3	18775305	.	C	A	20	12	32	0	0	32	0	0
3	18777284	.	T	C	24	14	38	1	1	40	0	0
3	18778996	.	A	T	17	9	26	0	0	26	0	0
3	18787884	.	G	A	11	6	17	0	1	18	0	0
3	18795638	.	C	T	1	3	4	0	0	4	0	0
3	18795907	.	G	T	1	2	3	0	3	6	0	0
3	18796218	.	C	T	2	2	4	0	0	4	0	0
3	18799290	.	C	A	1	2	3	0	0	3	0	0
3	18818893	.	T	C	4	2	6	0	0	6	0	0
3	18818929	.	C	T	4	2	6	0	1	7	0	0
3	18819979	.	T	C	5	2	7	0	1	8	0	0
3	18821163	.	C	T	6	2	8	0	0	8	0	0
3	18823027	.	T	C	5	3	8	0	0	8	0	0
3	18823331	.	T	C	3	6	9	0	0	9	0	0
3	18827249	.	G	T	5	11	16	0	0	16	0	0
3	18827491	.	T	C	5	8	13	0	0	13	0	0
3	18827509	.	G	A	9	8	17	0	0	17	0	0
3	18833001	.	G	A	2	2	4	0	6	10	0	0
3	18833016	.	C	T	7	3	10	0	1	11	0	0
3	18835665	.	C	T	9	4	13	0	0	13	0	0
3	18835852	.	C	G	4	3	7	0	0	7	0	0
3	18836023	.	T	C	6	4	10	0	1	11	0	0
3	18836168	.	A	G	7	3	10	0	0	10	0	0
3	18836289	.	C	G	2	6	8	0	0	8	0	0
3	18836316	.	G	A	5	2	7	0	0	7	0	0
3	18836518	.	C	T	1	2	3	0	2	5	0	0
3	18836857	.	A	T	10	6	16	0	0	16	0	0
3	18836935	.	T	G	10	6	16	0	0	16	0	0
3	18837029	.	G	A	2	2	4	0	1	5	0	0
3	18837095	.	A	T	6	8	14	0	1	15	0	0
3	18837111	.	G	A	2	7	9	0	7	16	0	0
3	18837456	.	G	A	9	8	17	0	2	19	0	0
3	18837468	.	A	T	9	9	18	0	0	18	0	0
3	18837887	.	G	A	3	5	8	0	16	24	0	0
3	18837917	.	A	T	16	6	22	0	0	22	0	0
3	18837995	.	C	T	12	6	18	0	2	20	0	0
3	18838097	.	A	C	5	8	13	0	0	13	0	0
3	18838595	.	T	A	7	9	16	0	0	16	0	0
3	18838715	.	G	C	8	4	12	0	2	14	0	0
3	18838728	.	T	G	10	4	14	0	0	14	0	0
3	18838900	.	T	A	7	3	10	0	0	10	0	0
3	18839017	.	C	T	6	2	8	0	3	11	0	0
3	18839028	.	C	T	10	3	13	0	3	16	0	0
3	18922745	.	T	C	4	2	6	0	0	6	0	0
3	18922801	.	G	A	3	5	8	0	0	8	0	0
3	18922819	.	C	T	3	7	10	0	0	10	0	0
3	18923536	.	C	T	4	2	6	0	0	6	0	0
3	18923586	.	C	G	4	0	4	0	3	7	0	0
3	18923601	.	T	C	4	3	7	0	0	7	0	0
3	18923644	.	C	T	3	2	5	0	0	5	0	0
3	19006010	.	G	A	4	7	11	0	1	12	0	0
3	19006388	.	G	A	9	11	20	0	0	20	0	0
3	19042691	.	A	C	3	5	8	0	0	8	0	0
3	19068868	.	G	A	1	6	7	0	0	7	0	0
3	19090629	.	A	G	1	2	3	0	1	4	0	0
3	19090884	.	A	G	2	5	7	0	0	7	0	0
3	19132983	.	T	C	1	4	5	0	0	5	0	0
3	19162654	.	A	G	9	3	12	0	0	12	0	0
3	19162663	.	A	G	10	2	12	0	0	12	0	0
3	19162717	.	A	G	8	5	13	0	0	13	0	0
3	19172078	.	A	G	9	2	11	0	0	11	0	0
3	19172087	.	C	T	1	5	6	0	6	12	0	0
3	19172284	.	G	T	10	3	13	0	2	15	0	0
3	19180634	.	G	A	4	4	8	0	1	9	0	0
3	19180650	.	C	G	5	6	11	0	0	11	0	0
3	19180775	.	C	A	3	4	7	0	1	8	0	0
3	19180778	.	A	G	2	5	7	0	0	7	0	0
3	19180811	.	C	T	3	3	6	0	0	6	0	0
3	19200437	.	C	T	1	5	6	0	0	6	0	0
3	19207219	.	A	G	4	0	4	0	11	15	0	0
3	19210238	.	T	C	16	17	33	0	1	34	0	0
3	19210287	.	A	G	16	0	16	0	21	37	0	0
3	19210352	.	A	G	9	11	20	0	2	22	0	0
3	19210495	.	T	C	4	4	8	0	0	8	0	0
3	19264751	.	A	G	6	7	13	0	1	15	1	0
3	19264760	.	T	A	7	5	12	0	4	16	0	0
3	19264787	.	G	T	9	13	22	0	1	23	0	0
3	19264874	.	T	C	7	7	14	0	0	14	0	0
3	19267552	.	C	T	14	13	27	0	1	28	0	0
3	19267564	.	T	C	12	11	23	0	1	24	0	0
3	19267906	.	A	G	11	0	11	0	10	21	0	0
3	19267963	.	A	G	16	11	27	0	1	28	0	0
3	19270732	.	C	T	12	14	26	0	1	27	0	0
3	19271549	.	A	G	12	18	30	0	0	30	0	0
3	19273907	.	A	G	13	22	35	0	2	37	0	0
3	19274532	.	C	G	14	16	30	0	0	30	0	0
3	19274544	.	A	C	15	16	31	0	3	34	0	0
3	19274688	.	T	C	18	6	24	0	1	25	0	0
3	19277027	.	A	G	16	18	34	0	3	37	0	0
3	19277084	.	T	A	15	23	38	0	3	41	0	0
3	19278247	.	T	C	18	27	45	0	0	45	0	0
3	19278796	.	C	T	19	24	43	0	1	44	0	0
3	19281259	.	G	A	1	22	23	0	24	47	0	0
3	19281295	.	A	G	19	23	42	0	3	45	0	0
3	19338418	.	A	T	4	2	6	0	0	6	0	0
3	19338599	.	C	T	4	3	7	0	0	7	0	0
3	19338875	.	C	T	4	5	9	0	0	9	0	0
3	19339594	.	T	C	2	5	7	0	1	8	0	0
3	19339833	.	A	G	4	5	9	0	1	10	0	0
3	19346162	.	C	G	8	3	11	0	0	11	0	0
3	19346376	.	C	T	7	8	15	0	0	15	0	0
3	19346394	.	C	T	5	5	10	0	1	11	0	0
3	19354657	.	G	C	11	5	16	0	0	16	0	0
3	19354768	.	A	C	7	4	11	0	1	12	0	0
3	19354902	.	T	C	7	8	15	0	1	16	0	0
3	19609716	.	G	A	6	5	11	0	2	13	0	0
3	19609747	.	G	A	9	11	20	0	1	21	0	0
3	19609897	.	A	C	13	12	25	0	0	25	0	0
3	19610495	.	T	A	5	7	12	0	0	12	0	0
3	19610648	.	A	T	13	10	23	0	2	25	0	0
3	19610655	.	G	T	13	10	23	0	1	24	0	0
3	19610865	.	A	C	27	17	44	0	1	45	0	0
3	19610933	.	A	G	3	3	6	0	0	6	0	0
3	19674385	.	C	T	1	2	3	0	0	3	0	0
3	19674525	.	T	A	2	2	4	0	0	4	0	0
3	19676791	.	A	G	1	4	5	0	0	5	0	0
3	19686149	.	C	T	4	6	10	0	0	10	0	0
3	19686332	.	G	T	5	5	10	0	1	11	0	0
3	19687393	.	T	C	3	4	7	0	0	7	0	0
3	19702196	.	G	A	8	8	16	0	1	17	0	0
3	19702224	.	T	C	10	5	15	1	0	16	0	0
3	19702551	.	T	C	7	6	13	0	0	13	0	0
3	19706564	.	A	G	13	8	21	0	0	21	0	0
3	19707181	.	G	A	11	10	21	0	1	22	0	0
3	19710389	.	T	C	16	13	29	0	0	29	0	0
3	19716761	.	C	T	4	9	13	0	1	14	0	0
3	19717047	.	G	C	8	5	13	0	0	13	0	0
3	19717079	.	T	C	7	7	14	0	1	15	0	0
3	19717171	.	T	A	8	5	13	0	1	15	1	0
3	19717459	.	C	T	13	15	28	0	0	28	0	0
3	19717589	.	T	G	16	1	17	1	17	35	0	0
3	19717656	.	T	C	17	12	29	0	2	32	1	0
3	19717669	.	G	A	15	10	25	0	1	26	0	0
3	19851120	.	G	C	6	6	12	0	0	12	0	0
3	19851289	.	G	T	13	9	22	0	0	22	0	0
3	19851325	.	T	C	13	8	21	0	0	21	0	0
3	19914453	.	A	G	12	10	22	0	0	22	0	0
3	19914619	.	C	T	17	13	30	0	0	30	0	0
3	19914781	.	G	A	0	20	20	0	9	29	0	0
3	19969409	.	C	T	24	7	31	0	1	32	0	0
3	19969416	.	G	C	25	7	32	0	0	32	0	0
3	19969530	.	G	C	17	23	40	0	1	41	0	0
3	19969560	.	C	T	21	22	43	0	0	43	0	0
3	19969909	.	C	T	24	16	40	0	2	42	0	0
3	19970397	.	C	A	22	21	43	0	2	45	0	0
3	19970589	.	G	A	6	17	23	0	18	41	0	0
3	19971063	.	T	G	38	19	57	0	0	57	0	0
3	19971316	.	A	G	23	21	44	0	2	46	0	0
3	19971719	.	A	C	16	20	36	0	10	46	0	0
3	20015458	.	G	T	15	8	23	0	1	24	0	0
3	20015752	.	T	C	12	16	28	0	2	30	0	0
3	20015785	.	G	C	17	11	28	0	3	31	0	0
3	20021477	.	C	T	7	11	18	0	1	19	0	0
3	20021593	.	C	T	8	5	13	0	2	15	0	0
3	20026042	.	G	T	12	13	25	0	4	29	0	0
3	20026106	.	G	A	18	15	33	0	0	33	0	0
3	20026148	.	G	A	13	18	31	0	1	32	0	0
3	20035849	.	C	T	1	20	21	0	13	34	0	0
3	20036309	.	A	G	16	14	30	2	1	33	0	0
3	20040557	.	C	G	0	13	13	0	8	21	0	0
3	20042325	.	A	T	20	14	34	0	6	40	0	0
3	20042453	.	G	C	21	16	37	0	2	39	0	0
3	20042476	.	C	T	23	15	38	0	3	41	0	0
3	20042679	.	A	G	5	15	20	0	0	20	0	0
3	20042681	.	A	G	4	15	19	0	0	19	0	0
3	20042824	.	A	G	13	25	38	0	1	39	0	0
3	20042965	.	T	C	18	21	39	0	1	40	0	0
3	20043024	.	A	G	22	18	40	0	0	40	0	0
3	20043069	.	C	A	14	15	29	0	3	32	0	0
3	20043121	.	A	T	26	11	37	0	0	37	0	0
3	20043279	.	A	T	16	15	31	0	0	31	0	0
3	20043556	.	C	T	11	15	26	0	2	28	0	0
3	20045679	.	A	G	12	25	37	0	2	39	0	0
3	20049714	.	G	A	15	13	28	0	0	28	0	0
3	20051185	.	G	A	8	13	21	0	1	22	0	0
3	20051290	.	G	A	13	10	23	0	1	24	0	0
3	20062718	.	A	G	8	13	21	0	0	21	0	0
3	20063757	.	A	G	9	11	20	0	2	22	0	0
3	20063901	.	C	T	4	5	9	0	1	10	0	0
3	20063978	.	T	C	6	2	8	0	0	8	0	0
3	20064002	.	C	T	2	4	6	0	0	6	0	0
3	20066145	.	T	A	0	2	2	0	1	3	0	0
3	20108424	.	A	T	26	23	49	0	0	49	0	0
3	20108636	.	A	T	18	22	40	0	2	42	0	0
3	20108643	.	G	T	19	22	41	0	0	41	0	0
3	20108790	.	T	C	25	20	45	2	2	49	0	0
3	20109247	.	T	C	19	1	20	0	12	32	0	0
3	20109421	.	T	C	10	21	31	0	2	33	0	0
3	20109583	.	A	G	10	12	22	0	0	22	0	0
3	20109861	.	G	A	13	25	38	0	1	39	0	0
3	20109951	.	C	A	16	21	37	0	3	40	0	0
3	20110268	.	T	C	28	12	40	0	1	41	0	0
3	20110269	.	T	C	32	8	40	0	0	41	1	0
3	20110346	.	A	G	20	23	43	0	4	47	0	0
3	20110359	.	T	A	12	22	34	0	5	39	0	0
3	20110444	.	C	A	16	14	30	0	0	30	0	0
3	20110557	.	A	G	15	34	49	0	1	50	0	0
3	20118281	.	C	G	17	21	38	0	2	40	0	0
3	20208474	.	A	G	1	0	1	0	2	3	0	0
3	20224065	.	A	G	1	3	4	0	0	4	0	0
3	20224569	.	A	T	1	3	4	0	0	4	0	0
3	20224612	.	G	A	1	3	4	0	2	6	0	0
3	20224700	.	A	C	2	3	5	0	0	5	0	0
3	20224704	.	G	T	0	3	3	0	2	5	0	0
3	20224832	.	T	C	5	2	7	0	0	7	0	0
3	20226515	.	T	C	2	2	4	0	0	4	0	0
3	20226859	.	T	G	3	2	5	0	0	5	0	0
3	20226889	.	G	T	4	3	7	0	0	7	0	0
3	20226924	.	T	C	7	8	15	0	1	16	0	0
3	20226937	.	A	C	8	7	15	0	0	15	0	0
3	20227480	.	G	A	0	3	3	0	6	9	0	0
3	20227507	.	G	A	6	2	8	0	0	8	0	0
3	20227531	.	A	G	5	3	8	0	1	9	0	0
3	20227555	.	G	A	1	5	6	0	0	6	0	0
3	20227781	.	T	A	3	2	5	0	0	5	0	0
3	20227805	.	T	C	4	3	7	0	0	7	0	0
3	20227848	.	A	C	1	3	4	0	2	6	0	0
3	20228052	.	C	T	2	4	6	0	0	6	0	0
3	20228168	.	A	T	4	5	9	0	0	9	0	0
3	20228303	.	C	T	5	2	7	0	1	8	0	0
3	20228335	.	T	C	3	2	5	0	0	5	0	0
3	20228616	.	C	G	3	3	6	0	0	6	0	0
3	20228686	.	T	G	4	5	9	0	0	9	0	0
3	20228874	.	C	T	3	2	5	0	0	5	0	0
3	20228919	.	G	T	6	2	8	0	1	9	0	0
3	20228961	.	A	G	8	0	8	0	9	17	0	0
3	20229033	.	C	G	3	1	4	0	5	9	0	0
3	20229057	.	A	T	2	5	7	0	0	7	0	0
3	20229235	.	A	G	7	6	13	0	1	14	0	0
3	20229260	.	G	A	11	9	20	0	1	21	0	0
3	20229479	.	A	G	6	5	11	0	0	11	0	0
3	20230598	.	T	C	8	4	12	0	1	13	0	0
3	20230615	.	A	G	4	0	4	1	4	9	0	0
3	20231025	.	T	G	13	8	21	0	1	22	0	0
3	20231060	.	C	T	8	8	16	0	2	18	0	0
3	20231080	.	G	A	1	6	7	0	6	13	0	0
3	20231288	.	G	A	4	8	12	0	0	12	0	0
3	20231289	.	C	T	4	8	12	0	0	12	0	0
3	20231385	.	C	T	13	15	28	0	1	29	0	0
3	20231539	.	C	G	5	12	17	0	1	18	0	0
3	20658235	.	C	T	11	6	17	0	1	18	0	0
3	20658333	.	G	T	17	13	30	0	2	32	0	0
3	20658653	.	C	G	12	10	22	0	0	22	0	0
3	20658809	.	C	T	10	15	25	0	1	26	0	0
3	20658899	.	T	A	5	12	17	0	1	18	0	0
3	20659051	.	T	G	18	14	32	0	2	34	0	0
3	20666937	.	A	G	10	8	18	0	1	19	0	0
3	20666970	.	A	T	10	8	18	0	1	19	0	0
3	20677240	.	A	G	15	8	23	0	1	24	0	0
3	20677261	.	C	A	14	4	18	0	1	19	0	0
3	20720843	.	G	A	1	1	2	0	1	3	0	0
3	20721042	.	C	A	6	3	9	0	0	9	0	0
3	20721049	.	T	A	5	3	8	0	0	8	0	0
3	20752904	.	A	T	6	4	10	0	0	10	0	0
3	20752928	.	A	T	10	3	13	0	2	15	0	0
3	20793587	.	G	A	15	6	21	0	0	21	0	0
3	20948584	.	G	C	1	0	1	0	3	4	0	0
3	20948598	.	G	C	1	2	3	0	0	3	0	0
3	20950366	.	C	T	11	21	32	0	1	33	0	0
3	20950529	.	T	C	27	31	58	2	1	62	1	0
3	20956926	.	C	A	28	25	53	0	2	55	0	0
3	20956957	.	G	A	11	20	31	0	6	37	0	0
3	20973017	.	C	T	1	7	8	0	0	8	0	0
3	20982056	.	G	A	3	3	6	0	0	6	0	0
3	20982061	.	T	C	4	2	6	0	0	6	0	0
3	20982159	.	C	T	2	1	3	0	1	4	0	0
3	21022558	.	C	A	2	9	11	0	0	11	0	0
3	21022993	.	A	G	6	6	12	0	0	12	0	0
3	21022996	.	T	C	6	6	12	0	1	13	0	0
3	21025709	.	A	T	24	24	48	0	2	50	0	0
3	21025986	.	A	T	21	13	34	0	4	38	0	0
3	21026079	.	A	G	23	22	45	0	1	46	0	0
3	21026293	.	A	G	15	23	38	0	1	39	0	0
3	21026370	.	T	C	15	13	28	0	2	30	0	0
3	21026573	.	G	A	5	4	9	0	0	9	0	0
3	21026576	.	C	T	5	4	9	0	0	9	0	0
3	21026729	.	A	G	2	2	4	0	1	5	0	0
3	21026748	.	G	A	0	2	2	0	1	3	0	0
3	21026894	.	A	T	4	4	8	0	0	8	0	0
3	21027101	.	A	T	14	15	29	0	1	30	0	0
3	21027504	.	C	T	16	9	25	0	1	26	0	0
3	21027749	.	A	T	30	7	37	3	3	43	0	0
3	21029813	.	C	A	27	12	39	0	1	41	1	0
3	21029902	.	T	G	17	20	37	0	2	39	0	0
3	21030101	.	G	A	24	16	40	0	4	44	0	0
3	21030293	.	C	T	23	26	49	0	4	53	0	0
3	21030318	.	A	C	33	21	54	0	3	57	0	0
3	21030730	.	T	C	19	13	32	0	0	32	0	0
3	21037760	.	C	T	1	5	6	0	1	7	0	0
3	21044189	.	G	A	19	15	34	0	1	35	0	0
3	21062703	.	T	C	8	0	8	0	8	16	0	0
3	21062721	.	T	A	5	4	9	0	0	9	0	0
3	21066467	.	T	A	6	4	10	0	1	11	0	0
3	21066745	.	A	T	7	13	20	0	0	20	0	0
3	21067384	.	A	G	6	16	22	0	1	23	0	0
3	21067565	.	A	G	8	7	15	0	0	15	0	0
3	21067606	.	A	T	7	8	15	0	2	17	0	0
3	21067718	.	T	A	9	7	16	0	0	16	0	0
3	21067911	.	G	T	9	12	21	0	0	21	0	0
3	21068176	.	G	A	10	9	19	1	0	20	0	0
3	21068205	.	G	T	7	7	14	4	0	18	0	0
3	21068378	.	T	G	10	10	20	1	1	22	0	0
3	21074598	.	G	A	13	6	19	0	0	19	0	0
3	21074667	.	G	A	8	8	16	0	0	16	0	0
3	21086092	.	G	A	6	6	12	0	0	12	0	0
3	21087743	.	G	T	4	5	9	0	0	9	0	0
3	21094398	.	C	A	2	5	7	2	1	10	0	0
3	21094462	.	G	A	3	8	11	0	0	11	0	0
3	21096056	.	A	T	4	3	7	0	0	7	0	0
3	21096057	.	T	C	3	4	7	0	0	7	0	0
3	21096176	.	C	T	7	4	11	0	0	11	0	0
3	21096487	.	G	A	16	11	27	0	1	28	0	0
3	21096693	.	T	A	17	8	25	0	0	25	0	0
3	21104470	.	A	G	11	13	24	0	2	26	0	0
3	21111671	.	C	T	1	13	14	0	12	26	0	0
3	21111680	.	T	C	7	15	22	0	0	22	0	0
3	21111916	.	G	C	8	12	20	0	2	22	0	0
3	21111940	.	A	G	12	6	18	0	1	19	0	0
3	21113913	.	C	A	17	19	36	0	0	36	0	0
3	21125687	.	G	T	25	18	43	0	0	43	0	0
3	21126015	.	C	T	23	32	55	0	4	59	0	0
3	21139754	.	T	C	10	8	18	0	0	18	0	0
3	21140872	.	T	C	5	6	11	0	0	11	0	0
3	21141184	.	C	T	7	9	16	0	4	20	0	0
3	21142429	.	A	T	7	5	12	0	1	13	0	0
3	21240878	.	A	T	1	2	3	0	1	4	0	0
3	21240971	.	C	G	1	3	4	0	0	4	0	0
3	21241269	.	A	G	3	5	8	0	0	8	0	0
3	21241413	.	C	A	0	4	4	0	2	6	0	0
3	21241416	.	A	G	1	5	6	0	0	6	0	0
3	21241461	.	G	A	2	7	9	0	0	9	0	0
3	21242399	.	A	T	2	5	7	0	0	7	0	0
3	21242438	.	C	G	0	3	3	0	2	5	0	0
3	21251642	.	A	T	5	12	17	0	1	18	0	0
3	21251873	.	A	G	12	10	22	0	1	23	0	0
3	21251924	.	G	A	9	9	18	0	1	19	0	0
3	21252172	.	C	G	19	16	35	0	0	35	0	0
3	21281117	.	A	G	3	3	6	0	1	7	0	0
3	21281178	.	C	A	1	4	5	0	1	6	0	0
3	21281483	.	G	C	10	9	19	0	1	20	0	0
3	21281677	.	C	T	3	11	14	0	17	31	0	0
3	21282192	.	T	C	8	7	15	0	0	15	0	0
3	21282299	.	T	A	4	7	11	0	0	11	0	0
3	21282340	.	A	G	6	13	19	0	1	20	0	0
3	21282546	.	G	A	13	11	24	0	1	25	0	0
3	21282981	.	A	G	11	11	22	0	0	22	0	0
3	21283365	.	T	C	13	0	13	0	12	25	0	0
3	21283509	.	C	A	7	7	14	0	0	14	0	0
3	21283741	.	T	C	7	9	16	0	5	21	0	0
3	21283759	.	T	C	10	7	17	0	2	19	0	0
3	21283811	.	T	G	6	10	16	0	0	16	0	0
3	21284429	.	A	G	9	4	13	0	1	14	0	0
3	21284430	.	A	G	9	5	14	0	0	14	0	0
3	21284514	.	A	T	6	7	13	0	0	13	0	0
3	21284752	.	G	A	6	2	8	0	2	10	0	0
3	21284794	.	G	T	6	2	8	0	1	9	0	0
3	21287872	.	G	C	5	2	7	0	0	7	0	0
3	21287981	.	C	T	2	2	4	0	0	4	0	0
3	21288007	.	T	C	4	3	7	0	0	7	0	0
3	21348283	.	T	G	4	3	7	0	0	7	0	0
3	21881762	.	A	G	2	2	4	0	0	4	0	0
3	21883287	.	A	T	1	2	3	0	0	3	0	0
3	21883288	.	C	A	0	2	2	0	1	3	0	0
3	21887512	.	T	A	1	4	5	0	0	5	0	0
3	21887513	.	A	T	1	4	5	0	0	5	0	0
3	21887641	.	G	A	1	4	5	0	0	5	0	0
3	21887815	.	C	T	2	3	5	0	0	5	0	0
3	21888924	.	T	G	3	2	5	0	0	5	0	0
3	21889268	.	A	G	4	6	10	0	2	12	0	0
3	21889443	.	A	G	1	3	4	0	0	4	0	0
3	22039893	.	C	T	5	4	9	0	0	9	0	0
3	22050000	.	C	A	3	4	7	0	0	7	0	0
3	22050263	.	G	A	7	7	14	0	0	14	0	0
3	22054324	.	G	A	8	12	20	0	1	21	0	0
3	22054356	.	C	T	8	9	17	0	2	19	0	0
3	22054491	.	C	T	9	12	21	1	1	23	0	0
3	22054724	.	T	C	8	4	12	0	0	12	0	0
3	22054793	.	A	C	11	9	20	0	0	20	0	0
3	22054856	.	G	A	7	5	12	0	0	12	0	0
3	22054917	.	G	A	10	5	15	0	1	16	0	0
3	22054919	.	C	T	10	5	15	0	0	15	0	0
3	22055128	.	A	G	6	0	6	0	9	15	0	0
3	22055216	.	T	A	4	7	11	0	0	11	0	0
3	22057143	.	A	G	0	2	2	0	1	3	0	0
3	22059083	.	A	T	2	7	9	0	0	9	0	0
3	22079377	.	C	T	6	2	8	0	2	10	0	0
3	22079815	.	A	T	3	1	4	0	1	5	0	0
3	22080117	.	A	G	5	4	9	0	0	9	0	0
3	22128495	.	C	T	4	2	6	0	0	6	0	0
3	22146900	.	G	C	1	4	5	0	9	14	0	0
3	22146945	.	T	C	7	6	13	0	0	13	0	0
3	22146969	.	C	T	5	5	10	0	1	11	0	0
3	22152952	.	C	T	6	4	10	0	0	10	0	0
3	22153116	.	C	T	11	13	24	0	0	24	0	0
3	22153178	.	C	T	3	8	11	0	3	14	0	0
3	22153372	.	A	G	6	1	7	0	10	17	0	0
3	22153412	.	A	C	11	6	17	0	1	18	0	0
3	22153849	.	A	G	3	4	7	0	1	8	0	0
3	22153885	.	A	G	4	6	10	0	0	10	0	0
3	22153896	.	C	T	6	5	11	0	0	11	0	0
3	22153983	.	A	G	1	5	6	0	0	6	0	0
3	22154008	.	A	G	6	0	6	0	3	9	0	0
3	22154051	.	A	G	9	7	16	0	3	19	0	0
3	22154274	.	C	G	8	5	13	1	1	15	0	0
3	22154306	.	G	T	1	6	7	1	6	14	0	0
3	22154368	.	A	G	7	4	11	0	1	12	0	0
3	22154382	.	T	C	7	7	14	0	0	14	0	0
3	22154429	.	C	T	6	12	18	1	0	19	0	0
3	22154431	.	A	G	9	7	16	1	2	19	0	0
3	22154610	.	A	C	11	12	23	0	2	25	0	0
3	22154745	.	C	T	14	13	27	0	0	27	0	0
3	22158243	.	T	A	36	21	57	0	1	58	0	0
3	22158364	.	T	C	30	14	44	0	3	47	0	0
3	22158373	.	G	T	29	16	45	0	6	51	0	0
3	22158414	.	G	A	25	27	52	0	0	52	0	0
3	22158489	.	G	A	28	24	52	0	3	55	0	0
3	22158551	.	T	C	41	21	62	0	3	65	0	0
3	22158768	.	T	G	34	20	54	0	3	57	0	0
3	22159081	.	T	C	27	35	62	0	2	64	0	0
3	22159520	.	T	G	20	22	42	1	1	44	0	0
3	22159525	.	A	T	15	19	34	1	6	41	0	0
3	22159584	.	C	A	1	13	14	0	24	38	0	0
3	22159943	.	C	T	12	8	20	0	0	20	0	0
3	22160007	.	G	A	16	16	32	1	2	35	0	0
3	22160042	.	T	G	18	14	32	1	1	34	0	0
3	22160421	.	C	T	13	15	28	0	2	30	0	0
3	22161176	.	G	T	14	12	26	0	3	29	0	0
3	22172765	.	A	G	12	17	29	0	0	29	0	0
3	23248840	.	A	G	3	7	10	0	2	12	0	0
3	23250603	.	C	G	2	6	8	0	0	8	0	0
3	23250652	.	G	A	0	7	7	0	6	13	0	0
3	23251018	.	A	G	5	8	13	0	0	13	0	0
3	23251258	.	A	C	6	3	9	0	2	11	0	0
3	23251744	.	G	A	0	5	5	0	8	13	0	0
3	23251822	.	A	G	6	10	16	0	1	17	0	0
3	23302371	.	A	G	13	7	20	0	0	20	0	0
3	23307870	.	G	T	1	14	15	0	10	25	0	0
3	23309155	.	C	A	9	15	24	0	3	27	0	0
3	23309214	.	A	G	9	8	17	0	0	17	0	0
3	23318362	.	G	A	12	8	20	0	2	22	0	0
3	23318368	.	C	T	14	9	23	0	0	23	0	0
3	23323560	.	T	A	11	5	16	0	2	18	0	0
3	23323719	.	T	C	7	4	11	0	1	12	0	0
3	23323788	.	G	A	2	5	7	0	1	8	0	0
3	23323829	.	T	C	3	3	6	0	0	6	0	0
3	23324159	.	T	A	7	11	18	0	0	18	0	0
3	23324235	.	G	A	9	6	15	0	2	17	0	0
3	23324420	.	T	C	4	2	6	0	0	6	0	0
3	23324421	.	T	C	4	2	6	0	0	6	0	0
3	23324472	.	T	A	5	2	7	0	1	8	0	0
3	23324481	.	G	T	5	4	9	0	0	9	0	0
3	23324536	.	C	T	5	7	12	0	0	12	0	0
3	23324746	.	T	A	9	13	22	0	0	22	0	0
3	23324815	.	T	A	13	5	18	0	3	21	0	0
3	23324829	.	C	T	12	6	18	0	2	20	0	0
3	23325207	.	A	C	7	4	11	0	0	11	0	0
3	23325476	.	G	A	9	5	14	0	0	14	0	0
3	23325559	.	C	T	9	6	15	0	1	16	0	0
3	23326418	.	C	G	7	0	7	0	4	11	0	0
3	23326478	.	G	A	7	5	12	0	3	15	0	0
3	23326711	.	G	A	10	11	21	0	0	21	0	0
3	23327282	.	C	T	21	18	39	0	1	40	0	0
3	23334465	.	A	T	13	8	21	0	0	21	0	0
3	23335024	.	G	A	13	10	23	0	1	24	0	0
3	23348300	.	T	G	13	14	27	0	1	28	0	0
3	23348304	.	C	T	12	14	26	0	2	28	0	0
3	23351944	.	G	A	7	7	14	0	0	14	0	0
3	23363193	.	G	A	6	7	13	0	0	13	0	0
3	23406614	.	G	A	8	6	14	0	0	14	0	0
3	23406637	.	G	C	7	0	7	0	10	17	0	0
3	23406701	.	C	T	5	4	9	0	1	10	0	0
3	23407085	.	G	T	4	4	8	0	1	9	0	0
3	23429169	.	A	C	10	8	18	0	2	20	0	0
3	23429262	.	A	T	9	11	20	0	0	20	0	0
3	23429263	.	T	C	9	11	20	0	0	20	0	0
3	23429433	.	A	G	8	2	10	0	2	12	0	0
3	23429696	.	A	G	8	4	12	0	1	13	0	0
3	23429763	.	A	C	13	0	13	0	18	31	0	0
3	23430011	.	G	A	12	8	20	0	0	20	0	0
3	23430067	.	A	G	15	7	22	0	0	22	0	0
3	23430116	.	T	A	17	10	27	0	0	27	0	0
3	23430119	.	C	T	1	9	10	0	17	27	0	0
3	23436305	.	T	A	15	21	36	0	3	39	0	0
3	23442923	.	A	G	12	10	22	0	1	23	0	0
3	23443487	.	G	A	13	6	19	0	0	19	0	0
3	23444539	.	A	T	8	6	14	0	3	17	0	0
3	23444551	.	T	G	9	8	17	0	1	18	0	0
3	23456344	.	T	C	9	1	10	0	10	20	0	0
3	23464828	.	T	C	3	3	6	0	0	6	0	0
3	23464865	.	T	C	6	3	9	0	0	9	0	0
3	23464894	.	G	A	6	8	14	0	1	15	0	0
3	23464911	.	C	T	8	6	14	0	1	15	0	0
3	23465292	.	T	C	8	11	19	0	1	20	0	0
3	23469391	.	C	T	13	10	23	0	1	24	0	0
3	23469438	.	A	G	5	12	17	0	0	17	0	0
3	23469472	.	T	C	3	6	9	0	0	9	0	0
3	23469848	.	T	A	10	5	15	0	1	16	0	0
3	23470037	.	A	C	10	1	11	0	9	20	0	0
3	23470044	.	T	A	10	10	20	0	1	21	0	0
3	23470172	.	G	A	10	4	14	0	1	15	0	0
3	23470173	.	T	A	12	4	16	0	0	16	0	0
3	23488816	.	T	C	10	10	20	0	0	20	0	0
3	23492529	.	A	T	19	6	25	0	1	26	0	0
3	23493694	.	T	C	25	17	42	0	2	44	0	0
3	23493864	.	C	T	27	15	42	0	4	46	0	0
3	23494015	.	G	A	4	13	17	0	29	46	0	0
3	23494216	.	T	C	20	24	44	0	7	51	0	0
3	23494780	.	A	G	16	10	26	0	1	27	0	0
3	23494805	.	G	A	1	11	12	0	16	28	0	0
3	23495908	.	A	G	13	10	23	0	0	23	0	0
3	23518524	.	A	G	1	2	3	0	0	3	0	0
3	23583995	.	A	C	3	2	5	0	0	5	0	0
3	23584052	.	G	A	2	9	11	0	0	11	0	0
3	23584173	.	G	C	9	10	19	0	0	19	0	0
3	23584577	.	A	C	15	9	24	1	1	26	0	0
3	23584977	.	A	C	5	8	13	0	1	14	0	0
3	23585082	.	T	A	5	5	10	0	1	11	0	0
3	23585197	.	T	A	10	8	18	0	0	18	0	0
3	23585253	.	T	A	7	12	19	0	2	21	0	0
3	23585442	.	G	T	17	8	25	0	1	26	0	0
3	23591620	.	T	C	17	0	17	0	9	26	0	0
3	23591662	.	G	C	14	0	14	0	12	26	0	0
3	23592988	.	G	T	16	6	22	0	0	22	0	0
3	23596401	.	G	A	7	8	15	0	1	16	0	0
3	23596632	.	G	C	13	8	21	0	1	22	0	0
3	23596791	.	T	A	13	9	22	0	3	25	0	0
3	23599443	.	G	T	25	27	52	0	0	52	0	0
3	23599844	.	A	C	25	27	52	1	1	54	0	0
3	23708080	.	G	A	1	8	9	0	13	22	0	0
3	23710000	.	G	T	4	10	14	0	0	14	0	0
3	23723655	.	T	A	1	3	4	0	0	4	0	0
3	23723715	.	C	A	3	5	8	0	0	8	0	0
3	23746344	.	T	C	10	4	14	0	0	14	0	0
3	23748084	.	T	A	4	2	6	0	0	6	0	0
3	23748628	.	T	A	9	4	13	0	3	16	0	0
3	24065389	.	A	T	9	14	23	0	2	25	0	0
3	24065395	.	A	G	10	15	25	0	0	25	0	0
3	24065437	.	C	T	12	20	32	0	0	32	0	0
3	24067629	.	A	T	11	15	26	0	3	29	0	0
3	24070118	.	C	T	15	8	23	1	1	25	0	0
3	24070134	.	A	G	15	7	22	1	2	25	0	0
3	24070251	.	T	C	15	11	26	0	0	26	0	0
3	24070336	.	G	A	13	4	17	0	0	17	0	0
3	24070569	.	A	G	11	4	15	0	0	15	0	0
3	24070815	.	G	T	8	3	11	0	0	11	0	0
3	24071163	.	G	A	14	5	19	0	3	22	0	0
3	24071294	.	A	T	8	11	19	0	0	19	0	0
3	24072775	.	A	C	1	2	3	0	0	3	0	0
3	24072783	.	G	T	1	2	3	0	0	3	0	0
3	24096191	.	C	T	7	11	18	0	1	19	0	0
3	24100770	.	C	T	8	11	19	0	0	19	0	0
3	24110160	.	T	C	2	0	2	0	0	5	3	0
3	24111188	.	G	C	2	6	8	0	0	8	0	0
3	24134600	.	C	T	3	6	9	0	0	9	0	0
3	24143497	.	T	A	4	4	8	0	0	8	0	0
3	24143559	.	G	A	8	5	13	0	0	13	0	0
3	24196507	.	G	A	0	2	2	0	6	8	0	0
3	24196513	.	A	G	6	2	8	0	0	8	0	0
3	24198970	.	G	A	25	15	40	0	1	41	0	0
3	24199073	.	T	G	20	1	21	0	38	59	0	0
3	24199154	.	T	C	26	26	52	0	0	52	0	0
3	24199577	.	T	C	30	32	62	0	6	68	0	0
3	24199689	.	T	C	28	31	59	0	1	60	0	0
3	24200287	.	T	A	44	28	72	0	1	73	0	0
3	24200578	.	C	T	17	17	34	0	4	38	0	0
3	24200643	.	C	T	14	8	22	0	0	22	0	0
3	24200645	.	A	G	14	8	22	0	1	23	0	0
3	24203272	.	C	T	8	7	15	0	2	17	0	0
3	24203504	.	A	G	5	13	18	0	0	18	0	0
3	24203513	.	G	A	13	6	19	0	0	19	0	0
3	24203584	.	C	T	5	4	9	0	1	10	0	0
3	24203654	.	G	A	2	3	5	0	0	5	0	0
3	24203676	.	G	T	1	2	3	0	0	3	0	0
3	24203735	.	G	A	2	2	4	0	0	4	0	0
3	24205306	.	T	C	0	2	2	0	1	3	0	0
3	24207390	.	G	A	4	6	10	0	1	11	0	0
3	24207449	.	T	C	5	5	10	0	0	10	0	0
3	24209792	.	G	A	6	7	13	0	0	13	0	0
3	24212197	.	T	G	4	7	11	0	2	13	0	0
3	24214534	.	G	T	9	6	15	0	0	15	0	0
3	24218282	.	C	T	10	5	15	0	0	15	0	0
3	24290104	.	T	C	1	2	3	0	0	3	0	0
3	24290112	.	A	C	1	0	1	0	2	3	0	0
3	24292535	.	C	T	2	6	8	0	0	8	0	0
3	24292634	.	A	G	2	0	2	0	5	7	0	0
3	24295198	.	C	T	2	4	6	0	0	6	0	0
3	24295426	.	G	T	3	3	6	0	0	6	0	0
3	24295429	.	T	C	3	4	7	0	0	7	0	0
3	24361132	.	C	T	17	15	32	2	1	35	0	0
3	24361245	.	T	C	26	21	47	2	1	50	0	0
3	24433057	.	C	A	27	33	60	0	4	64	0	0
3	24434512	.	C	G	33	39	72	1	4	77	0	0
3	24434601	.	C	T	33	29	62	0	4	66	0	0
3	24434694	.	A	G	33	37	70	0	0	71	1	0
3	24434833	.	C	A	25	16	41	0	2	43	0	0
3	24483064	.	C	A	10	12	22	0	0	22	0	0
3	24483322	.	C	T	11	9	20	0	1	21	0	0
3	24489662	.	T	C	13	9	22	0	1	23	0	0
3	24501757	.	G	A	3	21	24	0	17	41	0	0
3	24501772	.	G	A	19	19	38	0	3	41	0	0
3	24512002	.	A	T	1	2	3	0	0	3	0	0
3	24512020	.	C	G	1	4	5	0	0	5	0	0
3	24517063	.	T	A	2	2	4	0	0	4	0	0
3	24517070	.	T	C	2	2	4	0	0	4	0	0
3	24518388	.	A	G	1	2	3	1	1	5	0	0
3	24682798	.	A	T	1	5	6	0	0	6	0	0
3	24690027	.	A	G	1	2	3	0	0	3	0	0
3	24690061	.	T	A	3	2	5	0	0	5	0	0
3	24690077	.	A	C	2	3	5	0	0	5	0	0
3	24690431	.	G	A	3	2	5	0	0	5	0	0
3	24690453	.	T	A	3	3	6	0	0	6	0	0
3	24692117	.	T	C	8	5	13	0	0	13	0	0
3	24692120	.	G	A	5	7	12	0	0	12	0	0
3	24750887	.	T	C	1	2	3	0	0	3	0	0
3	24750893	.	A	G	1	2	3	0	0	3	0	0
3	24763520	.	A	G	1	0	1	0	3	4	0	0
3	24765011	.	C	T	3	3	6	0	0	6	0	0
3	24765063	.	G	T	2	2	4	0	0	4	0	0
3	24973867	.	T	A	13	19	32	0	1	33	0	0
3	24973912	.	T	C	12	0	12	0	12	24	0	0
3	24974298	.	G	A	14	20	34	0	1	35	0	0
3	24990641	.	G	A	3	30	33	0	17	50	0	0
3	24993349	.	G	A	3	21	24	0	38	62	0	0
3	24993449	.	G	A	29	21	50	0	0	50	0	0
3	24993791	.	G	A	4	20	24	0	30	54	0	0
3	24997055	.	A	T	17	10	27	0	2	29	0	0
3	24998204	.	C	G	7	8	15	0	3	18	0	0
3	24998533	.	A	G	21	15	36	0	1	37	0	0
3	24998536	.	A	G	17	19	36	0	2	38	0	0
3	24998833	.	C	T	15	12	27	0	0	27	0	0
3	24998860	.	C	T	10	12	22	0	1	23	0	0
3	24998977	.	G	T	11	8	19	0	3	22	0	0
3	24999259	.	G	A	8	10	18	0	1	19	0	0
3	24999358	.	T	G	7	11	18	0	0	18	0	0
3	24999955	.	T	G	7	12	19	0	0	19	0	0
3	25000051	.	G	T	5	12	17	0	0	17	0	0
3	25000114	.	G	A	5	7	12	0	3	15	0	0
3	25002169	.	A	G	3	8	11	0	0	11	0	0
3	25024580	.	C	T	2	2	4	0	0	4	0	0
3	25027734	.	G	A	2	3	5	0	0	5	0	0
3	25030198	.	G	T	1	3	4	0	0	4	0	0
3	25030809	.	C	T	3	2	5	0	1	6	0	0
3	25033548	.	C	T	2	2	4	0	0	4	0	0
3	25033581	.	G	A	1	5	6	0	0	6	0	0
3	25033623	.	T	C	1	2	3	0	0	3	0	0
3	25039408	.	C	G	1	2	3	0	0	3	0	0
3	25039489	.	A	G	1	3	4	0	0	4	0	0
3	25046097	.	A	G	1	2	3	0	0	3	0	0
3	25046205	.	G	A	4	2	6	0	0	6	0	0
3	25054458	.	G	A	3	2	5	0	0	5	0	0
3	25059690	.	A	G	3	3	6	0	0	6	0	0
3	25059864	.	T	A	6	3	9	0	1	10	0	0
3	25066348	.	A	G	7	7	14	0	0	14	0	0
3	25075675	.	T	C	6	4	10	0	1	11	0	0
3	25080982	.	G	T	2	6	8	0	0	8	0	0
3	25081203	.	C	T	4	2	6	0	1	7	0	0
3	25085122	.	G	A	4	3	7	0	0	7	0	0
3	25086825	.	A	T	2	6	8	0	1	9	0	0
3	25094590	.	G	A	14	14	28	0	1	29	0	0
3	25097218	.	T	A	14	23	37	0	2	39	0	0
3	25097257	.	T	C	20	27	47	0	1	48	0	0
3	25099883	.	T	C	19	21	40	0	1	41	0	0
3	25100222	.	G	A	0	23	23	0	24	47	0	0
3	25100260	.	A	G	25	17	42	0	6	48	0	0
3	25100379	.	A	T	15	18	33	0	0	33	0	0
3	25102095	.	A	G	27	16	43	0	2	45	0	0
3	25102121	.	C	T	21	26	47	0	3	50	0	0
3	25105097	.	A	C	17	3	20	0	22	42	0	0
3	25136706	.	C	G	8	2	10	0	1	11	0	0
3	25137585	.	T	C	2	2	4	0	0	4	0	0
3	25138114	.	A	G	11	10	21	0	0	21	0	0
3	25138543	.	C	T	0	4	4	0	6	10	0	0
3	25142371	.	T	A	2	5	7	0	1	8	0	0
3	25144108	.	A	C	7	5	12	0	0	12	0	0
3	25147989	.	G	A	3	3	6	0	0	6	0	0
3	25167117	.	T	C	2	5	7	0	0	7	0	0
3	25167168	.	C	T	12	10	22	0	0	22	0	0
3	25168882	.	T	C	11	5	16	0	0	16	0	0
3	25169181	.	C	T	2	5	7	0	0	7	0	0
3	25169426	.	C	T	2	3	5	0	0	5	0	0
3	25169483	.	C	T	3	3	6	0	0	6	0	0
3	25169600	.	A	T	4	4	8	0	0	8	0	0
3	25169612	.	A	T	4	2	6	0	1	7	0	0
3	25269936	.	A	C	6	15	21	0	1	22	0	0
3	25269960	.	A	G	11	18	29	0	3	32	0	0
3	25270023	.	A	G	7	20	27	2	0	29	0	0
3	25270058	.	A	C	11	20	31	2	1	34	0	0
3	25270311	.	A	G	35	32	67	0	16	83	0	0
3	25270515	.	G	A	36	36	72	0	2	74	0	0
3	25270602	.	C	G	39	34	73	0	8	81	0	0
3	25270680	.	C	T	42	37	79	0	1	80	0	0
3	25270710	.	A	C	37	35	72	2	3	77	0	0
3	25270752	.	A	G	40	28	68	2	5	75	0	0
3	25271579	.	C	T	28	20	48	0	1	49	0	0
3	25272653	.	T	C	36	23	59	0	1	60	0	0
3	25273463	.	G	A	34	23	57	0	2	59	0	0
3	25282004	.	C	T	0	3	3	0	2	5	0	0
3	25282029	.	C	T	5	2	7	1	0	8	0	0
3	25282063	.	A	C	1	4	5	1	0	6	0	0
3	25282135	.	T	C	3	0	3	0	4	7	0	0
3	25282348	.	T	C	11	9	20	0	1	21	0	0
3	25282387	.	T	G	14	12	26	0	1	27	0	0
3	25282422	.	A	G	13	9	22	0	2	24	0	0
3	25282928	.	G	A	10	9	19	0	1	20	0	0
3	25282979	.	T	C	7	10	17	0	1	18	0	0
3	25312797	.	C	A	6	9	15	0	0	15	0	0
3	25322673	.	G	A	5	6	11	0	0	11	0	0
3	25333049	.	A	G	1	3	4	0	0	4	0	0
3	25379483	.	C	A	2	16	18	1	17	36	0	0
3	25379546	.	A	G	21	19	40	0	2	42	0	0
3	25391167	.	G	A	11	19	30	1	0	31	0	0
3	25393308	.	A	G	16	14	30	0	1	31	0	0
3	25393509	.	G	C	15	11	26	0	0	26	0	0
3	25393602	.	T	A	10	19	29	0	8	37	0	0
3	25393641	.	C	T	1	20	21	0	19	40	0	0
3	25393677	.	A	C	16	1	17	0	21	38	0	0
3	25393707	.	A	C	22	0	22	0	15	37	0	0
3	25393785	.	C	T	21	19	40	0	4	44	0	0
3	25396597	.	C	T	2	13	15	0	24	39	0	0
3	25396677	.	G	T	20	11	31	0	6	37	0	0
3	25396731	.	G	A	18	17	35	0	2	37	0	0
3	25397899	.	C	T	13	7	20	0	1	21	0	0
3	25400320	.	C	T	9	9	18	0	1	19	0	0
3	25400673	.	C	T	0	8	8	0	12	20	0	0
3	25403654	.	G	A	5	5	10	0	0	10	0	0
3	25409114	.	A	T	1	2	3	0	0	3	0	0
3	25409641	.	C	T	0	4	4	0	2	6	0	0
3	25409655	.	C	T	2	4	6	0	1	7	0	0
3	25414648	.	T	C	2	2	4	0	0	4	0	0
3	25417006	.	G	A	1	4	5	0	0	5	0	0
3	25436085	.	A	C	14	19	33	0	1	34	0	0
3	25436370	.	G	A	7	4	11	0	0	11	0	0
3	25436439	.	G	C	8	10	18	0	2	20	0	0
3	25436440	.	C	T	1	11	12	0	8	20	0	0
3	25436493	.	T	A	9	7	16	0	3	19	0	0
3	25436561	.	A	G	23	9	32	0	1	33	0	0
3	25436893	.	T	G	4	11	15	0	4	19	0	0
3	25437017	.	G	A	9	4	13	0	3	16	0	0
3	25437284	.	G	T	22	13	35	0	1	36	0	0
3	25437451	.	A	G	27	13	40	0	0	40	0	0
3	25437517	.	G	A	18	11	29	1	2	32	0	0
3	25492299	.	A	G	5	3	8	0	0	8	0	0
3	25508990	.	A	G	1	1	2	0	1	3	0	0
3	25510408	.	G	T	2	5	7	0	0	7	0	0
3	25510531	.	T	C	7	3	10	0	0	10	0	0
3	25510551	.	C	G	3	4	7	0	0	7	0	0
3	25510580	.	T	C	5	3	8	0	1	9	0	0
3	25510782	.	A	G	2	0	2	0	2	4	0	0
3	25510832	.	T	A	2	2	4	0	1	5	0	0
3	25510848	.	A	T	2	4	6	0	0	6	0	0
3	25511122	.	G	A	1	1	2	0	1	3	0	0
3	25511209	.	A	T	2	2	4	0	0	4	0	0
3	25511506	.	A	T	3	5	8	0	1	9	0	0
3	25512384	.	T	A	3	2	5	0	0	6	1	0
3	25547835	.	T	C	2	2	4	0	0	4	0	0
3	25645983	.	G	C	1	2	3	0	0	3	0	0
3	25709176	.	T	A	6	7	13	0	0	13	0	0
3	25709242	.	A	G	10	4	14	0	0	14	0	0
3	25709679	.	T	G	5	2	7	0	0	7	0	0
3	25709844	.	T	C	5	0	5	0	3	8	0	0
3	25709859	.	C	T	5	3	8	0	1	9	0	0
3	25710190	.	G	A	3	3	6	0	0	6	0	0
3	25710398	.	G	A	5	4	9	0	0	9	0	0
3	25710444	.	A	T	6	5	11	0	0	11	0	0
3	25710591	.	G	A	1	7	8	0	0	8	0	0
3	25710799	.	C	G	1	2	3	0	0	3	0	0
3	25710828	.	A	C	4	3	7	0	1	8	0	0
3	25710952	.	A	G	6	3	9	0	0	9	0	0
3	25813178	.	G	A	1	2	3	0	0	3	0	0
3	25890275	.	T	C	6	3	9	0	1	10	0	0
3	25892553	.	A	G	4	4	8	0	1	9	0	0
3	25894035	.	A	G	2	2	4	0	0	4	0	0
3	25914122	.	G	T	5	5	10	0	0	10	0	0
3	25914125	.	T	C	6	5	11	0	0	11	0	0
3	25914386	.	A	C	3	4	7	0	2	9	0	0
3	25914415	.	C	T	3	5	8	0	0	8	0	0
3	25917795	.	C	T	3	4	7	0	1	8	0	0
3	25917972	.	A	T	8	8	16	0	1	17	0	0
3	25918090	.	G	A	6	6	12	0	0	12	0	0
3	25938298	.	C	T	8	13	21	0	0	21	0	0
3	25938375	.	T	C	10	4	14	0	0	14	0	0
3	25938377	.	T	C	10	4	14	0	0	14	0	0
3	25938793	.	A	C	4	7	11	0	3	14	0	0
3	25938950	.	G	T	17	7	24	0	1	25	0	0
3	25939068	.	T	G	2	3	5	0	0	5	0	0
3	25990199	.	T	C	2	4	6	0	1	7	0	0
3	25991802	.	G	A	4	3	7	0	0	7	0	0
3	25991805	.	A	T	4	3	7	0	0	7	0	0
3	25992741	.	T	C	4	2	6	0	0	6	0	0
3	25997803	.	G	A	4	2	6	0	0	6	0	0
3	25997804	.	G	A	4	2	6	0	0	6	0	0
3	26010909	.	G	A	1	4	5	0	2	7	0	0
3	26057839	.	G	A	1	13	14	0	3	17	0	0
3	26057842	.	G	T	0	16	16	0	1	17	0	0
3	26120592	.	G	A	2	3	5	5	0	10	0	0
3	26157625	.	T	C	4	3	7	0	0	7	0	0
3	27695326	.	A	G	5	0	5	0	4	9	0	0
3	27767284	.	A	G	6	14	20	0	0	20	0	0
3	27767288	.	A	G	15	5	20	0	2	22	0	0
3	27833009	.	T	C	24	6	30	0	0	30	0	0
3	27833093	.	T	C	21	9	30	0	1	31	0	0
3	27834134	.	T	C	17	7	24	0	2	26	0	0
3	27834305	.	T	C	25	7	32	0	0	32	0	0
3	27834412	.	T	C	14	19	33	0	2	35	0	0
3	27834547	.	T	C	13	4	17	0	2	19	0	0
3	27836036	.	T	C	7	9	16	0	1	17	0	0
3	28626340	.	A	C	6	3	9	0	1	10	0	0
3	28627044	.	T	A	3	10	13	0	2	15	0	0
3	28627393	.	T	G	1	2	3	0	0	3	0	0
3	28634485	.	T	A	8	4	12	0	1	13	0	0
3	28634549	.	A	G	9	14	23	0	1	24	0	0
3	28634883	.	C	A	13	9	22	0	9	31	0	0
3	28634884	.	A	C	11	10	21	0	10	31	0	0
3	28635106	.	G	A	12	12	24	0	1	25	0	0
3	28640608	.	C	T	1	9	10	1	9	20	0	0
3	28640734	.	G	A	6	9	15	0	2	17	0	0
3	28650721	.	T	C	9	0	9	0	8	17	0	0
3	28665218	.	T	C	5	5	10	0	2	12	0	0
3	28665239	.	G	A	7	5	12	0	0	12	0	0
3	28719103	.	G	A	4	2	6	0	1	7	0	0
3	28719160	.	C	A	7	3	10	0	0	10	0	0
3	28719189	.	C	T	7	4	11	0	0	11	0	0
3	28719506	.	C	G	11	4	15	0	0	15	0	0
3	28719592	.	T	G	8	8	16	0	2	18	0	0
3	28719636	.	T	A	8	6	14	0	1	15	0	0
3	28719649	.	C	T	10	5	15	0	0	15	0	0
3	28719730	.	G	T	4	7	11	0	1	12	0	0
3	28719852	.	T	C	5	10	15	0	1	16	0	0
3	28719878	.	G	A	10	7	17	0	0	17	0	0
3	28719905	.	C	A	0	4	4	0	11	15	0	0
3	28719971	.	C	A	0	8	8	0	4	12	0	0
3	28720010	.	G	A	4	5	9	0	0	9	0	0
3	28750223	.	G	T	5	3	8	0	0	8	0	0
3	29950927	.	T	C	15	11	26	0	2	28	0	0
3	30801282	.	G	A	3	2	5	0	1	6	0	0
3	30801370	.	T	C	1	0	1	0	2	3	0	0
3	30860896	.	A	T	2	2	4	0	0	4	0	0
3	30868430	.	A	G	1	2	3	0	0	3	0	0
3	30868853	.	T	G	4	8	12	0	0	12	0	0
3	30868855	.	T	C	4	8	12	0	0	12	0	0
3	30869205	.	A	G	9	4	13	0	0	13	0	0
3	30869206	.	C	T	9	2	11	0	2	13	0	0
3	30869662	.	C	T	10	5	15	0	0	15	0	0
3	30869728	.	C	T	1	4	5	0	9	14	0	0
3	30870382	.	T	G	4	2	6	0	0	6	0	0
3	30870508	.	G	A	7	2	9	0	0	9	0	0
3	30870670	.	G	A	4	2	6	0	0	6	0	0
3	30870838	.	T	A	1	2	3	0	0	3	0	0
3	30870974	.	A	C	6	4	10	0	0	10	0	0
3	30871021	.	G	T	7	2	9	0	0	9	0	0
3	30871478	.	A	T	1	3	4	0	0	4	0	0
3	30871873	.	C	G	0	5	5	0	4	9	0	0
3	30872004	.	C	T	3	2	5	0	0	5	0	0
3	30872264	.	T	G	3	6	9	0	0	9	0	0
3	30872608	.	C	T	0	3	3	0	4	7	0	0
3	30872655	.	T	C	4	5	9	0	0	9	0	0
3	30873165	.	C	T	2	2	4	0	0	4	0	0
3	30873185	.	A	T	1	2	3	0	1	4	0	0
3	30873408	.	T	C	2	3	5	0	0	5	0	0
3	30877163	.	C	T	1	3	4	0	0	4	0	0
3	30890630	.	T	A	11	10	21	0	1	22	0	0
3	30890869	.	G	A	19	21	40	0	3	43	0	0
3	30891201	.	A	G	25	23	48	0	1	49	0	0
3	30894281	.	A	G	11	13	24	0	2	26	0	0
3	30925617	.	T	C	2	2	4	0	0	4	0	0
3	30925642	.	T	G	1	2	3	0	0	3	0	0
3	30935001	.	A	G	1	3	4	0	0	4	0	0
3	30948173	.	G	A	3	3	6	0	0	6	0	0
3	30962456	.	C	G	5	3	8	0	1	9	0	0
3	30962536	.	C	T	1	2	3	0	4	7	0	0
3	31039992	.	A	G	2	2	4	0	0	4	0	0
3	31043800	.	T	C	1	4	5	0	0	5	0	0
3	31043876	.	A	C	3	0	3	0	2	5	0	0
3	31044579	.	A	G	4	2	6	0	1	7	0	0
3	31044649	.	T	C	3	2	5	0	0	5	0	0
3	31044782	.	A	C	0	0	0	0	6	6	0	0
3	31044850	.	T	C	2	4	6	0	0	6	0	0
3	31044986	.	G	T	4	4	8	0	0	8	0	0
3	31045271	.	T	G	2	2	4	0	0	4	0	0
3	31050126	.	T	A	5	3	8	0	0	8	0	0
3	31050554	.	T	C	3	3	6	0	1	7	0	0
3	31052466	.	T	C	2	2	4	0	0	4	0	0
3	31060219	.	A	G	3	0	3	0	2	5	0	0
3	31060366	.	C	T	2	6	8	0	1	9	0	0
3	31063625	.	A	T	3	4	7	0	0	7	0	0
3	31066143	.	C	G	2	2	4	0	0	4	0	0
3	31066637	.	G	A	1	2	3	0	2	5	0	0
3	31069634	.	T	C	18	10	28	0	1	29	0	0
3	31070892	.	A	G	17	24	41	0	1	42	0	0
3	31080994	.	G	A	2	8	10	0	1	11	0	0
3	31081017	.	T	C	4	6	10	0	0	10	0	0
3	31084598	.	C	T	6	3	9	0	0	9	0	0
3	31086366	.	A	G	2	2	4	0	1	5	0	0
3	31090190	.	A	G	1	2	3	0	1	4	0	0
3	31103136	.	C	G	1	2	3	0	0	3	0	0
3	31103143	.	G	T	1	2	3	0	0	3	0	0
3	31103852	.	G	A	3	2	5	0	0	5	0	0
3	31103861	.	C	T	3	1	4	0	0	4	0	0
3	31104209	.	A	T	1	1	2	0	2	4	0	0
3	31104309	.	C	T	1	2	3	0	4	7	0	0
3	31104333	.	A	G	4	4	8	0	0	8	0	0
3	31104355	.	G	A	5	3	8	0	0	8	0	0
3	31104453	.	A	C	2	2	4	0	0	4	0	0
3	31104464	.	C	T	1	2	3	0	1	4	0	0
3	31104652	.	G	A	1	3	4	0	0	4	0	0
3	31104655	.	G	T	1	3	4	0	0	4	0	0
3	31104695	.	C	T	3	1	4	0	0	4	0	0
3	31104718	.	C	A	0	2	2	0	2	4	0	0
3	31104969	.	G	A	11	6	17	0	0	17	0	0
3	31105259	.	A	C	32	24	56	0	3	59	0	0
3	31120249	.	C	T	16	17	33	0	2	35	0	0
3	31122581	.	T	G	11	13	24	0	1	25	0	0
3	31135832	.	T	C	7	0	7	0	5	12	0	0
3	31135898	.	T	C	5	0	5	0	7	12	0	0
3	31137926	.	T	C	3	6	9	0	0	9	0	0
3	31137957	.	G	A	2	7	9	0	2	11	0	0
3	31138225	.	A	G	6	4	10	0	0	10	0	0
3	31138247	.	C	T	7	5	12	0	0	12	0	0
3	31150018	.	C	T	2	3	5	0	0	5	0	0
3	31179384	.	G	A	0	4	4	0	1	5	0	0
3	31184034	.	C	T	1	3	4	0	0	4	0	0
3	31187564	.	C	G	2	3	5	0	0	5	0	0
3	31187608	.	C	T	1	3	4	0	0	4	0	0
3	31187719	.	G	A	3	4	7	0	0	7	0	0
3	31187721	.	A	C	3	3	6	0	1	7	0	0
3	31201643	.	T	G	1	7	8	0	0	8	0	0
3	31217714	.	G	T	1	1	2	0	0	2	0	0
3	31217723	.	G	A	1	2	3	0	0	3	0	0
3	31218153	.	C	T	0	6	6	0	2	8	0	0
3	31218230	.	G	A	4	2	6	0	1	7	0	0
3	31218240	.	T	A	4	3	7	0	1	8	0	0
3	31396679	.	A	G	10	5	15	0	3	18	0	0
3	31396760	.	A	C	6	5	11	0	1	12	0	0
3	31396781	.	C	G	8	0	8	0	6	14	0	0
3	31396826	.	T	C	6	6	12	2	0	14	0	0
3	31430327	.	T	C	8	10	18	0	2	20	0	0
3	31600731	.	T	C	1	5	6	0	0	6	0	0
3	31603766	.	G	A	1	7	8	0	2	10	0	0
3	31603925	.	A	G	1	5	6	0	0	6	0	0
3	31603976	.	G	A	1	4	5	0	0	5	0	0
3	31604834	.	A	T	5	5	10	0	1	11	0	0
3	31605033	.	A	G	6	4	10	0	0	10	0	0
3	31605039	.	C	T	5	4	9	0	0	9	0	0
3	31623718	.	G	T	3	2	5	0	0	5	0	0
3	31698887	.	G	A	1	2	3	0	0	3	0	0
3	31706607	.	C	A	13	8	21	0	0	21	0	0
3	31706966	.	T	C	9	8	17	0	0	17	0	0
3	31709010	.	C	T	20	17	37	0	1	38	0	0
3	31709079	.	G	A	16	24	40	0	3	43	0	0
3	31711526	.	T	C	10	16	26	0	0	26	0	0
3	31712328	.	G	T	5	4	9	0	1	10	0	0
3	31717595	.	C	T	13	15	28	0	1	29	0	0
3	31722101	.	A	T	21	20	41	0	1	43	1	0
3	31722342	.	A	G	15	27	42	0	2	44	0	0
3	31725824	.	C	T	21	26	47	0	1	48	0	0
3	31726066	.	T	C	26	12	38	1	0	39	0	0
3	31726395	.	G	A	2	9	11	0	11	22	0	0
3	31726541	.	A	T	7	13	20	0	3	23	0	0
3	31726829	.	C	T	9	10	19	1	0	20	0	0
3	31729177	.	G	C	3	5	8	0	0	8	0	0
3	31729328	.	A	G	5	3	8	0	0	8	0	0
3	31729531	.	C	T	3	4	7	0	0	7	0	0
3	31734188	.	C	T	0	3	3	0	3	6	0	0
3	31792600	.	T	A	1	4	5	0	2	7	0	0
3	31792601	.	G	A	4	3	7	0	0	7	0	0
3	31792683	.	G	T	15	8	23	0	0	23	0	0
3	31792856	.	G	A	9	11	20	0	1	21	0	0
3	31793080	.	C	T	8	11	19	0	1	20	0	0
3	31793515	.	T	G	7	8	15	0	0	15	0	0
3	31793518	.	G	A	8	7	15	0	0	15	0	0
3	31793557	.	A	G	5	9	14	0	0	14	0	0
3	31793715	.	G	C	10	6	16	0	2	18	0	0
3	31793739	.	C	T	8	8	16	0	0	16	0	0
3	31797508	.	C	G	6	10	16	0	2	18	0	0
3	31797749	.	A	G	6	6	12	0	0	12	0	0
3	31799575	.	G	A	1	3	4	0	0	4	0	0
3	31874969	.	G	T	5	6	11	0	1	12	0	0
3	31879513	.	T	A	3	2	5	0	0	5	0	0
3	31879626	.	G	A	4	3	7	0	0	7	0	0
3	31879725	.	T	A	9	5	14	1	0	15	0	0
3	31879726	.	C	A	9	5	14	1	0	15	0	0
3	31879880	.	G	T	14	18	32	0	0	32	0	0
3	31879911	.	T	C	10	12	22	0	1	23	0	0
3	31880184	.	C	G	1	6	7	1	5	13	0	0
3	31880641	.	C	T	0	16	16	0	9	25	0	0
3	31881082	.	G	T	7	3	10	0	0	10	0	0
3	31884001	.	A	G	7	9	16	0	0	16	0	0
3	31884321	.	C	T	1	7	8	0	9	17	0	0
3	31884477	.	C	T	8	10	18	0	1	19	0	0
3	31886783	.	C	T	1	5	6	0	7	13	0	0
3	31890010	.	T	C	4	5	9	0	0	9	0	0
3	31892324	.	C	T	5	5	10	0	0	10	0	0
3	31897070	.	A	G	2	3	5	0	0	5	0	0
3	31914167	.	T	A	6	7	13	0	0	13	0	0
3	31916624	.	T	G	7	1	8	1	13	22	0	0
3	31916701	.	A	T	11	11	22	0	2	24	0	0
3	31916724	.	A	G	10	11	21	0	0	21	0	0
3	31916787	.	G	T	16	8	24	0	2	26	0	0
3	31916863	.	T	C	13	18	31	0	0	31	0	0
3	31917075	.	T	G	10	0	10	0	9	19	0	0
3	31917279	.	G	T	5	9	14	0	0	14	0	0
3	31926052	.	C	A	20	14	34	0	0	34	0	0
3	31939272	.	A	G	20	9	29	0	0	29	0	0
3	31939473	.	G	T	0	23	23	0	17	41	1	0
3	31939566	.	C	A	9	18	27	0	1	28	0	0
3	31941152	.	C	T	22	11	33	0	1	34	0	0
3	31944357	.	A	T	12	8	20	2	0	23	1	0
3	31951034	.	A	C	3	3	6	0	0	6	0	0
3	31961992	.	G	A	1	8	9	0	8	17	0	0
3	32021628	.	G	A	7	4	11	0	2	13	0	0
3	32049674	.	C	G	1	1	2	0	19	21	0	0
3	32049689	.	C	A	19	4	23	0	2	25	0	0
3	32049740	.	C	T	16	8	24	0	2	26	0	0
3	32087455	.	T	G	1	2	3	0	0	3	0	0
3	32098130	.	G	A	0	2	2	0	8	10	0	0
3	32098194	.	C	T	5	3	8	0	2	10	0	0
3	32099841	.	A	G	24	0	24	1	22	47	0	0
3	32100183	.	G	T	19	11	30	19	1	50	0	0
3	32100206	.	T	C	9	3	12	29	2	43	0	0
3	32100755	.	T	C	29	9	38	9	1	48	0	0
3	32105746	.	C	A	12	10	22	0	1	23	0	0
3	32118802	.	C	T	2	2	4	0	0	4	0	0
3	32119573	.	T	C	1	2	3	0	0	3	0	0
3	32120187	.	A	T	3	2	5	6	0	11	0	0
3	32120271	.	G	A	1	3	4	0	0	4	0	0
3	32120280	.	G	T	1	2	3	0	0	3	0	0
3	32139671	.	G	A	5	2	7	0	1	8	0	0
3	32157262	.	C	G	1	2	3	0	0	3	0	0
3	32169545	.	G	A	2	7	9	0	1	10	0	0
3	32170835	.	C	T	5	2	7	0	0	7	0	0
3	32175758	.	C	T	0	4	4	0	3	7	0	0
3	32175918	.	C	A	3	2	5	0	0	5	0	0
3	32175945	.	T	C	2	0	2	0	3	5	0	0
3	32294745	.	G	A	17	18	35	0	0	35	0	0
3	32294869	.	C	G	1	12	13	0	31	44	0	0
3	32295151	.	C	T	18	16	34	0	3	37	0	0
3	32295294	.	G	A	25	11	36	7	1	44	0	0
3	32295519	.	A	C	13	13	26	0	1	27	0	0
3	32295635	.	T	A	10	8	18	0	1	19	0	0
3	32296122	.	C	T	17	10	27	0	0	27	0	0
3	32296202	.	G	A	15	11	26	0	0	26	0	0
3	32296253	.	T	A	9	9	18	0	1	19	0	0
3	32296283	.	G	A	6	9	15	0	0	15	0	0
3	32296306	.	G	A	5	10	15	0	0	15	0	0
3	32296379	.	A	G	13	13	26	0	3	29	0	0
3	32296559	.	G	A	17	11	28	0	1	29	0	0
3	32296560	.	C	T	1	17	18	0	11	29	0	0
3	32296673	.	A	G	14	20	34	0	1	35	0	0
3	32296873	.	G	A	14	12	26	0	1	27	0	0
3	32303009	.	T	C	2	5	7	0	2	9	0	0
3	32303045	.	G	A	10	6	16	0	2	18	0	0
3	32303698	.	A	G	17	16	33	0	3	36	0	0
3	32314732	.	G	A	11	9	20	0	0	20	0	0
3	32325218	.	A	G	2	6	8	0	1	9	0	0
3	32329167	.	A	T	10	21	31	0	0	31	0	0
3	32357596	.	C	T	20	28	48	5	10	63	0	0
3	32357799	.	A	C	29	28	57	0	1	58	0	0
3	32360978	.	G	A	16	11	27	0	0	27	0	0
3	32361669	.	G	A	12	13	25	0	3	28	0	0
3	32361865	.	A	G	16	5	21	2	1	24	0	0
3	32366131	.	T	C	7	7	14	0	0	14	0	0
3	32366279	.	T	C	4	3	7	0	0	7	0	0
3	32366332	.	G	A	7	4	11	0	0	11	0	0
3	32366403	.	C	T	9	8	17	0	0	17	0	0
3	32400967	.	C	T	25	37	62	0	3	65	0	0
3	32401159	.	C	A	22	40	62	0	0	62	0	0
3	32401252	.	C	T	26	21	47	0	3	50	0	0
3	32403959	.	T	G	8	0	8	0	13	21	0	0
3	32405571	.	C	T	14	22	36	0	1	37	0	0
3	32405865	.	G	C	16	18	34	0	2	36	0	0
3	32405910	.	C	T	26	14	40	0	3	43	0	0
3	32406447	.	T	C	33	27	60	0	3	63	0	0
3	32406547	.	T	C	26	27	53	0	1	54	0	0
3	32406618	.	G	A	35	18	53	0	5	58	0	0
3	32406631	.	C	G	16	34	50	0	3	53	0	0
3	32414873	.	T	C	3	2	5	0	0	5	0	0
3	32414882	.	G	C	3	2	5	0	0	5	0	0
3	32415781	.	A	C	3	3	6	0	0	6	0	0
3	32433953	.	T	C	8	6	14	0	0	14	0	0
3	32434974	.	G	A	1	7	8	0	7	15	0	0
3	32435034	.	G	T	1	5	6	0	6	12	0	0
3	32435757	.	G	A	0	11	11	0	6	17	0	0
3	32435874	.	G	A	0	7	7	0	5	12	0	0
3	32436024	.	C	A	2	8	10	0	1	11	0	0
3	32436109	.	T	A	2	3	5	0	0	5	0	0
3	32436156	.	T	C	1	4	5	0	0	5	0	0
3	32436426	.	C	T	20	13	33	0	0	33	0	0
3	32436736	.	G	C	14	6	20	0	0	20	0	0
3	32438425	.	A	C	10	6	16	0	1	17	0	0
3	32440805	.	A	G	20	16	36	0	2	38	0	0
3	32441156	.	T	G	19	1	20	0	18	38	0	0
3	32441297	.	C	A	13	13	26	0	1	27	0	0
3	32441385	.	G	C	21	20	41	0	3	44	0	0
3	32441532	.	G	A	6	22	28	0	6	34	0	0
3	32441779	.	C	T	19	21	40	0	3	43	0	0
3	32447386	.	G	A	22	10	32	0	1	33	0	0
3	32447505	.	G	T	25	18	43	0	1	45	1	0
3	32447674	.	C	G	15	15	30	0	2	32	0	0
3	32447800	.	T	C	13	20	33	0	1	34	0	0
3	32450399	.	T	C	17	18	35	0	2	37	0	0
3	32453727	.	G	A	23	19	42	0	4	46	0	0
3	32457325	.	G	A	1	22	23	1	27	51	0	0
3	32457620	.	T	C	28	13	41	0	0	41	0	0
3	32457686	.	T	C	22	18	40	0	2	42	0	0
3	32458627	.	C	T	5	11	16	0	2	18	0	0
3	32477891	.	T	C	6	8	14	0	0	14	0	0
3	32477950	.	T	A	10	5	15	0	0	15	0	0
3	32479471	.	T	C	4	2	6	0	0	6	0	0
3	32482222	.	A	T	9	11	20	0	0	20	0	0
3	32482231	.	A	G	6	1	7	0	10	17	0	0
3	32482495	.	G	T	0	5	5	0	10	15	0	0
3	32482834	.	A	G	5	7	12	0	0	12	0	0
3	32483557	.	T	G	14	10	24	0	2	26	0	0
3	32483956	.	T	C	13	7	20	0	2	22	0	0
3	32484034	.	A	G	18	0	18	0	13	32	1	0
3	32484039	.	A	G	20	0	20	0	14	34	0	0
3	32484204	.	T	C	16	14	30	0	0	30	0	0
3	32484472	.	T	C	9	15	24	0	2	26	0	0
3	32484676	.	T	G	21	10	31	0	1	32	0	0
3	32484892	.	A	G	12	10	22	0	1	23	0	0
3	32485306	.	A	G	26	20	46	0	0	46	0	0
3	32485324	.	C	T	20	20	40	0	2	42	0	0
3	32485366	.	A	G	17	22	39	0	2	41	0	0
3	32485519	.	A	C	18	19	37	0	2	39	0	0
3	32485967	.	C	A	26	18	44	2	4	50	0	0
3	32486049	.	A	T	22	19	41	0	0	41	0	0
3	32486069	.	C	G	23	0	23	0	18	41	0	0
3	32489613	.	C	T	23	22	45	0	2	47	0	0
3	32490098	.	C	T	19	13	32	0	2	34	0	0
3	32490251	.	G	T	22	16	38	1	0	39	0	0
3	32490264	.	G	A	16	15	31	0	2	33	0	0
3	32490487	.	G	T	9	9	18	0	0	18	0	0
3	32530514	.	G	A	1	2	3	0	0	3	0	0
3	32534263	.	A	G	10	9	19	0	0	19	0	0
3	32534353	.	C	T	16	8	24	0	2	26	0	0
3	32534365	.	T	A	16	7	23	0	2	25	0	0
3	32587304	.	C	T	6	2	8	0	0	8	0	0
3	32596217	.	T	C	1	2	3	0	0	3	0	0
3	32641716	.	T	G	5	6	11	0	0	11	0	0
3	32643512	.	G	A	11	9	20	0	0	20	0	0
3	32647124	.	T	C	16	17	33	0	3	36	0	0
3	32647194	.	C	T	16	13	29	0	0	29	0	0
3	32647252	.	G	A	11	10	21	0	4	25	0	0
3	32647308	.	G	C	17	6	23	0	4	27	0	0
3	32647414	.	A	G	11	12	23	0	1	24	0	0
3	32647558	.	A	G	13	0	13	0	15	28	0	0
3	32649846	.	C	T	11	16	27	0	2	29	0	0
3	32649960	.	G	A	10	17	27	0	0	27	0	0
3	32650004	.	A	G	11	15	26	0	1	27	0	0
3	32650199	.	C	A	10	5	15	0	0	15	0	0
3	32663255	.	T	C	3	3	6	0	0	6	0	0
3	32663485	.	T	C	5	9	14	0	0	14	0	0
3	32663764	.	T	G	5	6	11	0	1	12	0	0
3	32665515	.	G	A	1	2	3	0	0	3	0	0
3	32667118	.	A	C	8	4	12	0	1	13	0	0
3	32668806	.	A	G	7	9	16	0	0	16	0	0
3	32668818	.	A	G	7	6	13	0	1	14	0	0
3	32669077	.	T	A	1	2	3	0	0	3	0	0
3	32672501	.	C	A	4	4	8	0	1	9	0	0
3	32675236	.	G	A	17	11	28	0	1	29	0	0
3	32679267	.	T	A	10	14	24	0	2	26	0	0
3	32679289	.	T	A	10	15	25	0	1	26	0	0
3	32679332	.	C	T	14	16	30	0	0	30	0	0
3	32679528	.	C	A	12	11	23	0	0	23	0	0
3	32686230	.	A	G	12	0	12	0	16	28	0	0
3	32686245	.	T	C	17	15	32	0	1	33	0	0
3	32686353	.	T	G	1	2	3	0	0	3	0	0
3	32686373	.	G	C	1	2	3	0	0	3	0	0
3	32698458	.	T	C	1	3	4	0	0	4	0	0
3	32698500	.	A	G	11	9	20	0	2	22	0	0
3	32700697	.	A	G	11	9	20	0	1	21	0	0
3	32700758	.	A	G	14	11	25	0	1	26	0	0
3	32700988	.	C	T	13	18	31	0	0	31	0	0
3	32701031	.	T	G	20	0	20	0	22	43	1	0
3	32702596	.	T	A	13	6	19	0	3	22	0	0
3	32707219	.	G	A	12	9	21	0	1	22	0	0
3	32707267	.	T	C	9	14	23	1	0	24	0	0
3	32707272	.	C	A	4	13	17	1	2	20	0	0
3	32707480	.	C	T	11	11	22	0	1	23	0	0
3	32707621	.	C	G	20	11	31	0	1	32	0	0
3	32707813	.	C	G	18	20	38	0	0	38	0	0
3	32708077	.	T	C	28	22	50	0	1	51	0	0
3	32709139	.	G	A	1	5	6	0	0	6	0	0
3	32710705	.	A	G	25	20	45	0	5	50	0	0
3	32710812	.	G	A	3	32	35	1	16	52	0	0
3	32710999	.	C	A	9	8	17	1	0	18	0	0
3	32711117	.	T	C	6	3	9	0	1	10	0	0
3	32711147	.	T	A	4	4	8	0	3	11	0	0
3	32718945	.	C	G	3	2	5	0	0	5	0	0
3	32722973	.	C	T	3	6	9	0	0	9	0	0
3	32723033	.	A	G	4	1	5	0	2	7	0	0
3	32723497	.	A	G	6	0	6	0	5	11	0	0
3	32723698	.	C	T	4	2	6	0	0	6	0	0
3	32724010	.	G	A	0	3	3	0	4	7	0	0
3	32724100	.	G	A	5	2	7	0	1	8	0	0
3	32726271	.	A	G	8	4	12	0	1	13	0	0
3	32728304	.	T	C	7	4	11	0	0	11	0	0
3	32729150	.	T	C	10	12	22	0	0	22	0	0
3	32729591	.	C	T	7	6	13	0	0	13	0	0
3	32729663	.	C	T	6	6	12	0	2	14	0	0
3	32729699	.	A	G	6	4	10	0	0	10	0	0
3	32729759	.	C	A	6	6	12	0	1	13	0	0
3	32729827	.	A	T	7	3	10	0	0	10	0	0
3	32729845	.	G	A	5	7	12	0	0	12	0	0
3	32730011	.	A	G	9	0	9	0	4	13	0	0
3	32731255	.	A	G	10	0	10	0	5	15	0	0
3	32731418	.	C	T	7	15	22	0	1	23	0	0
3	32731750	.	A	G	9	0	9	0	12	21	0	0
3	32731804	.	T	C	15	8	23	0	1	24	0	0
3	32731855	.	T	C	6	3	9	0	1	10	0	0
3	32731879	.	A	G	1	0	1	0	3	4	0	0
3	32734926	.	G	A	0	9	9	0	5	14	0	0
3	32737727	.	C	T	11	5	16	0	2	18	0	0
3	32741137	.	G	A	0	11	11	0	11	22	0	0
3	32741385	.	G	A	1	12	13	5	13	31	0	0
3	32741809	.	A	G	7	0	7	0	16	23	0	0
3	32777481	.	A	C	10	14	24	0	1	25	0	0
3	32777733	.	G	T	14	16	30	0	0	30	0	0
3	32789654	.	G	T	2	2	4	0	8	12	0	0
3	32789985	.	T	C	5	9	14	0	0	14	0	0
3	32794931	.	C	A	5	7	12	0	1	13	0	0
3	32795068	.	C	T	5	4	9	0	2	11	0	0
3	32795425	.	G	A	2	8	10	0	0	10	0	0
3	32795461	.	A	T	7	5	12	0	1	13	0	0
3	32795614	.	C	T	4	3	7	0	2	9	0	0
3	32807667	.	G	A	8	14	22	0	1	23	0	0
3	32808023	.	T	A	6	15	21	0	0	21	0	0
3	32808185	.	T	C	9	19	28	0	1	29	0	0
3	32808214	.	G	A	17	15	32	0	4	36	0	0
3	32808338	.	A	C	19	21	40	0	2	42	0	0
3	32808554	.	T	G	14	10	24	0	3	27	0	0
3	32808771	.	G	A	8	10	18	0	3	21	0	0
3	32808772	.	G	C	7	12	19	0	1	20	0	0
3	32808979	.	T	G	10	9	19	0	0	19	0	0
3	32809154	.	A	T	8	12	20	0	0	20	0	0
3	32809368	.	G	A	15	14	29	0	1	30	0	0
3	32809410	.	G	A	13	14	27	0	1	28	0	0
3	32809432	.	T	A	9	12	21	0	2	23	0	0
3	32809548	.	T	C	10	19	29	0	0	29	0	0
3	32809561	.	G	A	10	19	29	0	0	29	0	0
3	32809836	.	A	G	10	0	10	0	13	23	0	0
3	32809927	.	T	C	11	9	20	0	3	23	0	0
3	32810011	.	T	A	9	11	20	0	1	21	0	0
3	32810580	.	C	T	18	15	33	0	1	34	0	0
3	32810715	.	A	G	17	15	32	0	0	32	0	0
3	32811094	.	A	T	8	10	18	0	0	18	0	0
3	32813575	.	C	T	0	2	2	0	3	5	0	0
3	32813647	.	A	C	2	5	7	0	1	8	0	0
3	32813880	.	A	T	6	7	13	0	0	13	0	0
3	32823531	.	A	G	2	2	4	0	0	4	0	0
3	32825564	.	T	A	1	2	3	0	0	3	0	0
3	32825565	.	C	T	1	2	3	0	0	3	0	0
3	32825846	.	G	A	2	4	6	0	0	6	0	0
3	32837514	.	G	A	18	17	35	0	6	41	0	0
3	32837643	.	G	A	21	14	35	0	5	40	0	0
3	32837904	.	A	G	24	1	25	0	22	47	0	0
3	32838033	.	G	A	3	14	17	0	34	51	0	0
3	32838039	.	A	G	41	14	55	0	0	55	0	0
3	32842163	.	C	T	9	7	16	0	0	16	0	0
3	32842235	.	G	T	11	11	22	0	1	23	0	0
3	32842318	.	C	T	6	5	11	0	0	11	0	0
3	32847607	.	C	T	4	4	8	0	0	8	0	0
3	32847839	.	C	A	1	2	3	0	1	4	0	0
3	32847887	.	C	G	3	4	7	0	0	7	0	0
3	32847923	.	C	A	2	8	10	0	0	10	0	0
3	32847942	.	A	G	2	0	2	0	7	9	0	0
3	32848175	.	T	G	7	3	10	0	0	10	0	0
3	32848418	.	C	T	5	6	11	0	0	11	0	0
3	32848714	.	A	G	6	5	11	0	0	11	0	0
3	32849079	.	C	T	6	4	10	0	0	10	0	0
3	32849679	.	T	A	19	8	27	0	0	27	0	0
3	32850029	.	A	T	14	9	23	0	0	23	0	0
3	32850265	.	A	G	7	0	7	0	5	12	0	0
3	32850499	.	T	C	8	8	16	0	0	16	0	0
3	32854276	.	T	C	6	4	10	0	3	13	0	0
3	32854533	.	T	C	6	8	14	0	0	14	0	0
3	32854743	.	C	G	10	0	10	0	9	19	0	0
3	32854744	.	A	G	13	6	19	0	0	19	0	0
3	32854986	.	T	A	8	2	10	0	0	10	0	0
3	32855066	.	G	A	9	9	18	0	0	18	0	0
3	32863128	.	C	A	1	4	5	0	0	5	0	0
3	32866135	.	C	T	2	5	7	0	1	8	0	0
3	32868114	.	G	T	5	5	10	0	0	10	0	0
3	32868143	.	C	T	2	6	8	0	0	8	0	0
3	32868519	.	G	T	4	7	11	0	0	11	0	0
3	32868590	.	C	T	3	2	5	0	0	5	0	0
3	32868593	.	A	G	3	1	4	0	2	6	0	0
3	32869770	.	C	T	4	7	11	0	0	11	0	0
3	32869773	.	G	A	4	7	11	0	0	11	0	0
3	32870756	.	A	G	8	1	9	0	2	11	0	0
3	32870766	.	G	A	6	3	9	0	0	9	0	0
3	32870947	.	A	G	3	4	7	0	0	7	0	0
3	32871023	.	G	C	3	3	6	0	0	6	0	0
3	32871247	.	A	G	1	2	3	0	2	5	0	0
3	32871350	.	T	C	1	5	6	0	2	8	0	0
3	32871413	.	G	A	0	4	4	0	1	5	0	0
3	32871414	.	A	C	1	2	3	0	2	5	0	0
3	32889849	.	T	C	5	1	6	0	13	19	0	0
3	32890002	.	G	T	14	19	33	0	0	33	0	0
3	32890058	.	A	G	11	12	23	0	2	25	0	0
3	32892061	.	G	A	16	19	35	0	0	35	0	0
3	32892422	.	A	G	8	24	32	0	2	34	0	0
3	32900428	.	A	G	15	16	31	0	0	31	0	0
3	32924386	.	G	A	6	9	15	0	0	15	0	0
3	32924643	.	G	A	3	4	7	0	3	10	0	0
3	32924836	.	T	A	12	4	16	0	1	17	0	0
3	32924989	.	G	A	11	6	17	0	0	17	0	0
3	32925066	.	G	A	1	4	5	0	1	6	0	0
3	32925248	.	C	T	4	14	18	0	0	18	0	0
3	32925264	.	G	T	5	6	11	0	3	14	0	0
3	32926016	.	C	T	2	3	5	0	5	10	0	0
3	32926025	.	G	A	6	3	9	0	0	9	0	0
3	32926058	.	A	G	4	2	6	0	0	6	0	0
3	32926148	.	G	A	1	3	4	0	0	4	0	0
3	32926184	.	A	T	1	3	4	0	0	4	0	0
3	32933849	.	A	T	6	9	15	0	0	15	0	0
3	32935936	.	A	G	4	0	4	0	8	12	0	0
3	32937628	.	A	G	7	10	17	0	1	18	0	0
3	32941242	.	G	A	7	12	19	0	0	19	0	0
3	32941661	.	A	G	9	8	17	0	2	19	0	0
3	32944203	.	C	A	13	20	33	0	0	33	0	0
3	32944569	.	C	T	17	23	40	0	1	41	0	0
3	32944668	.	C	A	20	18	38	0	0	38	0	0
3	32944854	.	C	T	16	21	37	0	1	38	0	0
3	32947971	.	T	C	16	20	36	0	1	37	0	0
3	32950959	.	G	A	12	13	25	0	0	25	0	0
3	32950977	.	G	A	0	9	9	0	12	21	0	0
3	32951001	.	G	T	1	10	11	0	12	23	0	0
3	32951394	.	G	A	26	26	52	0	3	55	0	0
3	32951564	.	A	C	11	8	19	0	1	20	0	0
3	32951637	.	G	A	9	12	21	0	4	25	0	0
3	32951778	.	C	T	9	13	22	0	2	24	0	0
3	32951891	.	T	C	21	8	29	0	1	30	0	0
3	33065643	.	T	A	6	4	10	2	0	12	0	0
3	33065950	.	T	C	8	3	11	2	1	14	0	0
3	33066155	.	C	T	2	9	11	0	11	22	0	0
3	33066241	.	C	T	1	6	7	2	6	15	0	0
3	33066292	.	C	T	9	7	16	0	0	16	0	0
3	33066629	.	C	T	0	3	3	0	4	7	0	0
3	33066714	.	A	T	8	5	13	0	0	13	0	0
3	33066804	.	T	C	5	0	5	0	11	16	0	0
3	33066809	.	C	G	5	12	17	0	1	18	0	0
3	33066969	.	T	C	12	0	12	0	5	17	0	0
3	33066976	.	T	C	11	5	16	0	0	16	0	0
3	33067092	.	A	T	1	1	2	0	0	2	0	0
3	33067337	.	A	G	5	2	7	0	0	7	0	0
3	33067340	.	A	G	5	2	7	0	0	7	0	0
3	33067376	.	G	A	4	5	9	0	0	9	0	0
3	33067438	.	G	A	3	11	14	0	1	15	0	0
3	33069274	.	A	C	5	4	9	0	1	10	0	0
3	33069596	.	G	A	4	10	14	0	1	15	0	0
3	33075167	.	C	T	5	6	11	0	0	11	0	0
3	33341072	.	T	A	21	16	37	0	2	39	0	0
3	33344470	.	T	A	16	19	35	0	2	37	0	0
3	33344636	.	A	T	2	2	4	0	0	4	0	0
3	33345482	.	G	A	1	5	6	0	3	9	0	0
3	33360480	.	A	G	5	0	5	0	7	12	0	0
3	33368134	.	T	C	4	9	13	0	3	16	0	0
3	33373443	.	T	C	8	6	14	0	0	14	0	0
3	33373540	.	A	C	7	8	15	0	1	16	0	0
3	33375645	.	C	A	4	5	9	0	1	10	0	0
3	33379072	.	C	T	8	9	17	0	1	18	0	0
3	33379405	.	T	A	3	3	6	0	1	7	0	0
3	33379440	.	A	C	4	3	7	0	2	9	0	0
3	33420845	.	T	G	1	3	4	0	0	4	0	0
3	33424010	.	C	T	3	9	12	0	9	21	0	0
3	33424420	.	G	A	21	39	60	0	10	70	0	0
3	33426513	.	G	A	36	28	64	0	3	67	0	0
3	33433319	.	T	C	1	0	1	0	2	3	0	0
3	33433621	.	G	A	4	6	10	0	1	11	0	0
3	33437399	.	T	C	4	2	6	0	0	6	0	0
3	33440693	.	C	T	2	6	8	0	1	9	0	0
3	33445039	.	A	T	9	3	12	0	0	12	0	0
3	33445090	.	G	C	0	6	6	0	4	10	0	0
3	33449405	.	C	T	9	13	22	0	1	23	0	0
3	33449554	.	G	A	0	15	15	0	5	20	0	0
3	33452168	.	C	T	17	19	36	0	1	37	0	0
3	33455809	.	G	A	5	18	23	0	14	37	0	0
3	33458803	.	C	T	16	13	29	0	3	32	0	0
3	33458911	.	A	T	10	17	27	0	1	28	0	0
3	33459394	.	T	A	12	5	17	0	1	18	0	0
3	33459489	.	C	T	10	8	18	0	0	18	0	0
3	33459517	.	C	T	9	8	17	0	1	18	0	0
3	33459532	.	G	A	8	7	15	0	2	17	0	0
3	33461366	.	C	T	2	18	20	0	11	31	0	0
3	33461646	.	C	T	3	13	16	0	15	31	0	0
3	33461796	.	A	T	14	16	30	0	0	30	0	0
3	33469413	.	A	G	14	11	25	0	3	28	0	0
3	33469614	.	T	A	12	11	23	0	1	24	0	0
3	33473131	.	C	T	2	7	9	0	9	18	0	0
3	33476589	.	T	C	2	12	14	0	1	15	0	0
3	33478690	.	G	A	3	6	9	0	1	10	0	0
3	33494089	.	A	T	11	10	21	0	0	21	0	0
3	33494091	.	G	C	10	9	19	0	2	21	0	0
3	33571294	.	C	T	1	2	3	0	0	3	0	0
3	33572095	.	G	A	1	2	3	0	0	3	0	0
3	33572464	.	T	C	2	0	2	0	3	5	0	0
3	33572473	.	A	G	2	3	5	0	0	5	0	0
3	33747527	.	A	G	8	7	15	0	0	15	0	0
3	33747563	.	A	G	8	0	8	0	7	15	0	0
3	33761597	.	C	T	11	6	17	0	0	17	0	0
3	33761705	.	G	A	0	15	15	0	23	38	0	0
3	33761834	.	G	A	17	18	35	0	1	36	0	0
3	33761835	.	A	T	16	18	34	0	2	36	0	0
3	33762068	.	A	G	15	9	24	0	1	25	0	0
3	33762278	.	A	G	19	10	29	0	1	30	0	0
3	33762310	.	C	A	13	14	27	0	1	28	0	0
3	33762408	.	T	A	15	9	24	0	1	25	0	0
3	33762480	.	C	T	10	7	17	0	0	17	0	0
3	33773294	.	A	G	14	17	31	0	1	32	0	0
3	33777317	.	T	G	18	16	34	0	5	39	0	0
3	33777425	.	A	G	19	16	35	0	1	36	0	0
3	33777807	.	A	G	21	13	34	0	1	35	0	0
3	33820291	.	T	C	4	6	10	0	0	10	0	0
3	33821929	.	C	T	5	3	8	0	0	8	0	0
3	33844761	.	T	C	4	0	4	0	6	10	0	0
3	33847104	.	A	G	1	6	7	0	0	7	0	0
3	33847131	.	C	T	2	5	7	0	0	7	0	0
3	33854879	.	T	C	2	4	6	0	0	6	0	0
3	33854927	.	G	A	3	3	6	0	0	6	0	0
3	33854972	.	A	G	3	2	5	0	0	5	0	0
3	33918537	.	T	A	3	2	5	0	0	5	0	0
3	33918611	.	A	G	3	2	5	0	0	5	0	0
3	33918775	.	A	G	4	9	13	0	1	14	0	0
3	33921663	.	A	C	4	11	15	0	0	15	0	0
3	33922168	.	T	A	1	3	4	0	0	4	0	0
3	33922198	.	C	T	1	3	4	0	0	4	0	0
3	33922233	.	T	A	4	3	7	0	0	7	0	0
3	33922245	.	T	C	4	2	6	0	0	6	0	0
3	33922269	.	A	G	3	4	7	0	0	7	0	0
3	33922359	.	G	A	4	9	13	0	1	14	0	0
3	33922413	.	T	A	9	8	17	0	1	18	0	0
3	33922415	.	G	A	7	9	16	0	1	17	0	0
3	33922471	.	T	C	5	9	14	0	0	14	0	0
3	33932170	.	C	T	0	5	5	0	8	13	0	0
3	33932430	.	T	A	8	11	19	0	0	19	0	0
3	33932628	.	G	A	3	12	15	0	0	15	0	0
3	33934848	.	T	C	3	5	8	0	0	8	0	0
3	33934849	.	G	C	3	5	8	0	0	8	0	0
3	33936783	.	G	C	3	4	7	0	0	7	0	0
3	34129941	.	C	T	0	7	7	0	13	20	0	0
3	34135868	.	C	T	2	5	7	0	0	7	0	0
3	34144353	.	A	T	2	3	5	0	0	5	0	0
3	34144807	.	C	G	4	2	6	0	2	8	0	0
3	34144808	.	G	A	2	2	4	0	4	8	0	0
3	34146882	.	G	T	6	10	16	0	0	16	0	0
3	34146955	.	A	G	4	2	6	0	0	6	0	0
3	34166288	.	C	A	11	11	22	0	2	24	0	0
3	34170913	.	G	A	18	13	31	0	0	31	0	0
3	34171862	.	C	G	2	0	2	0	13	15	0	0
3	34171863	.	C	G	3	0	3	0	13	16	0	0
3	34180096	.	G	T	3	5	8	0	1	9	0	0
3	34180386	.	G	A	2	5	7	0	1	8	0	0
3	34182164	.	C	T	12	7	19	0	0	19	0	0
3	34182306	.	G	C	5	5	10	0	0	10	0	0
3	34182376	.	A	C	8	9	17	0	1	18	0	0
3	34182386	.	G	A	0	8	8	0	7	15	0	0
3	34220359	.	A	T	4	6	10	0	0	10	0	0
3	34244901	.	G	C	8	11	19	0	0	19	0	0
3	34258965	.	G	A	14	16	30	0	1	31	0	0
3	34259013	.	C	G	21	14	35	0	6	41	0	0
3	34259060	.	C	T	23	20	43	0	0	43	0	0
3	34259870	.	T	G	18	1	19	1	6	26	0	0
3	34260325	.	T	C	12	12	24	0	0	24	0	0
3	34260808	.	T	C	13	9	22	0	0	22	0	0
3	34261204	.	T	C	12	7	19	0	1	20	0	0
3	34261354	.	A	G	17	16	33	0	1	34	0	0
3	34261795	.	G	A	17	11	28	0	2	30	0	0
3	34262290	.	C	T	17	8	25	0	1	26	0	0
3	34262421	.	C	A	10	14	24	0	0	24	0	0
3	34262639	.	G	A	15	14	29	0	0	29	0	0
3	34262823	.	A	T	15	15	30	0	1	31	0	0
3	34263007	.	C	T	0	3	3	0	7	11	1	0
3	34263101	.	T	A	13	3	16	0	3	19	0	0
3	34264140	.	A	T	8	6	14	0	3	17	0	0
3	34264634	.	T	A	5	10	15	0	0	15	0	0
3	34264657	.	A	T	7	8	15	0	0	15	0	0
3	34270546	.	A	G	8	3	11	0	0	11	0	0
3	34323584	.	C	T	2	2	4	0	0	4	0	0
3	34337389	.	A	G	2	3	5	0	0	5	0	0
3	34456397	.	G	A	3	3	6	0	0	6	0	0
3	34456405	.	A	G	4	2	6	0	0	6	0	0
3	34588493	.	A	G	4	3	7	0	0	7	0	0
3	34588788	.	G	A	4	6	10	0	0	10	0	0
3	34590350	.	A	C	1	2	3	0	0	3	0	0
3	34604202	.	A	G	1	2	3	0	1	4	0	0
3	34697461	.	G	A	5	6	11	0	2	13	0	0
3	34697514	.	T	C	11	0	11	0	10	21	0	0
3	34703722	.	T	G	1	4	5	0	0	5	0	0
3	34703731	.	G	C	1	4	5	0	0	5	0	0
3	34767112	.	G	T	25	18	43	0	9	52	0	0
3	34767662	.	T	G	28	35	63	0	0	63	0	0
3	34767669	.	G	A	27	34	61	0	1	62	0	0
3	34772941	.	T	G	42	29	71	0	1	72	0	0
3	34775942	.	G	A	26	34	60	0	3	63	0	0
3	34776115	.	T	G	18	31	49	0	5	54	0	0
3	34776133	.	G	C	30	24	54	0	4	58	0	0
3	34776151	.	C	A	34	25	59	0	3	62	0	0
3	34781074	.	A	G	33	25	58	0	2	60	0	0
3	34781095	.	C	T	33	29	62	0	2	64	0	0
3	34781448	.	T	C	18	20	38	0	1	39	0	0
3	34781586	.	T	C	21	1	22	0	17	39	0	0
3	34783970	.	G	A	18	12	30	0	1	31	0	0
3	34783982	.	A	G	17	10	27	0	1	29	1	0
3	34801034	.	T	C	3	5	8	0	1	9	0	0
3	34804427	.	A	G	16	13	29	0	1	30	0	0
3	34814839	.	A	G	5	6	11	0	0	11	0	0
3	34822049	.	C	T	17	11	28	0	1	29	0	0
3	34822169	.	C	T	13	14	27	0	1	28	0	0
3	34822214	.	T	C	13	7	20	0	0	20	0	0
3	34919853	.	A	G	1	0	1	0	8	9	0	0
3	34919892	.	C	T	3	11	14	0	1	15	0	0
3	34977497	.	A	G	13	1	14	0	11	25	0	0
3	34977508	.	A	G	11	0	11	0	8	19	0	0
3	34981394	.	T	C	3	3	6	0	0	6	0	0
3	34994140	.	C	T	30	28	58	2	6	66	0	0
3	34994750	.	A	G	10	18	28	0	0	28	0	0
3	35170112	.	T	C	13	13	26	0	1	27	0	0
3	35225160	.	A	G	18	1	19	0	24	43	0	0
3	35225202	.	C	T	13	20	33	0	1	34	0	0
3	35248387	.	T	C	12	8	20	0	8	28	0	0
3	35248470	.	T	C	14	10	24	0	0	24	0	0
3	35248492	.	T	A	12	12	24	0	1	25	0	0
3	35249369	.	T	C	22	13	35	0	0	36	1	0
3	35249535	.	T	C	15	18	33	0	1	34	0	0
3	35250145	.	A	T	20	20	40	0	2	42	0	0
3	35250188	.	A	G	16	9	25	0	4	29	0	0
3	35264406	.	T	G	26	17	43	0	1	44	0	0
3	35264460	.	C	T	27	17	44	0	4	48	0	0
3	35264744	.	T	A	13	18	31	0	2	34	1	0
3	35264951	.	G	A	19	10	29	1	0	30	0	0
3	35265350	.	T	C	18	11	29	3	5	37	0	0
3	35265419	.	T	G	15	16	31	0	1	32	0	0
3	35265654	.	G	A	2	21	23	0	30	53	0	0
3	35298531	.	G	T	3	4	7	0	0	7	0	0
3	35298725	.	T	A	6	4	10	0	0	10	0	0
3	35374719	.	C	T	12	12	24	0	2	26	0	0
3	35375112	.	G	A	16	12	28	0	2	30	0	0
3	35375162	.	T	A	15	18	33	0	2	35	0	0
3	35375279	.	A	T	15	12	27	0	0	27	0	0
3	35375306	.	T	C	13	9	22	0	0	22	0	0
3	35375448	.	T	G	26	0	26	0	14	40	0	0
3	35375638	.	T	A	12	13	25	0	2	27	0	0
3	35406475	.	G	A	5	3	8	0	0	8	0	0
3	35406648	.	G	T	1	5	6	0	3	9	0	0
3	35418047	.	A	G	8	11	19	0	0	19	0	0
3	35419683	.	A	T	10	12	22	0	1	23	0	0
3	35420588	.	A	G	7	5	12	0	1	13	0	0
3	35420604	.	C	T	8	4	12	0	1	13	0	0
3	35513674	.	A	G	2	4	6	0	0	6	0	0
3	35514786	.	C	T	5	2	7	0	0	7	0	0
3	35514849	.	C	A	2	5	7	0	2	9	0	0
3	35515053	.	G	T	8	4	12	0	0	12	0	0
3	35515074	.	C	T	7	5	12	0	0	12	0	0
3	35515103	.	G	A	4	7	11	0	0	11	0	0
3	35515179	.	T	C	7	4	11	0	0	11	0	0
3	35515206	.	G	A	4	3	7	0	0	7	0	0
3	35515304	.	T	G	5	6	11	0	0	11	0	0
3	35515866	.	A	T	8	6	14	0	0	14	0	0
3	35517999	.	A	C	7	4	11	0	0	11	0	0
3	35518036	.	C	G	7	7	14	0	0	14	0	0
3	35518464	.	A	C	3	3	6	0	0	6	0	0
3	35518962	.	C	A	5	7	12	0	1	13	0	0
3	35523824	.	C	G	10	13	23	0	1	24	0	0
3	35527024	.	T	C	5	4	9	0	3	12	0	0
3	35529040	.	T	C	14	9	23	0	1	24	0	0
3	35530165	.	T	A	3	1	4	0	2	6	0	0
3	35530167	.	T	A	3	3	6	0	0	6	0	0
3	35530787	.	C	T	5	4	9	0	0	9	0	0
3	35531018	.	T	C	15	11	26	0	3	29	0	0
3	35531028	.	T	C	16	14	30	0	4	34	0	0
3	35531328	.	G	A	0	11	11	0	10	21	0	0
3	35531329	.	A	T	10	11	21	0	0	21	0	0
3	35531671	.	A	T	15	13	28	0	0	28	0	0
3	35531791	.	A	G	13	0	13	0	25	38	0	0
3	35531866	.	T	A	18	17	35	0	1	36	0	0
3	35531985	.	G	A	29	15	44	0	3	47	0	0
3	35532074	.	A	T	14	16	30	1	2	33	0	0
3	35532452	.	A	T	22	15	37	0	1	38	0	0
3	35532634	.	A	G	25	0	25	0	16	41	0	0
3	35532665	.	C	T	21	18	39	0	3	42	0	0
3	35532736	.	A	C	10	12	22	0	1	23	0	0
3	35535695	.	A	C	1	2	3	0	0	3	0	0
3	35535702	.	G	T	1	2	3	0	0	3	0	0
3	35536115	.	C	G	16	21	37	0	1	38	0	0
3	35536269	.	G	A	17	16	33	0	0	33	0	0
3	35541273	.	A	G	25	26	51	0	3	54	0	0
3	35548780	.	T	C	1	5	6	0	1	7	0	0
3	35549002	.	G	A	4	6	10	0	1	11	0	0
3	35551047	.	A	T	8	17	25	0	3	28	0	0
3	35551190	.	C	T	3	10	13	0	20	33	0	0
3	35589548	.	C	T	22	15	37	0	1	38	0	0
3	35589881	.	T	C	18	26	44	0	6	50	0	0
3	35589908	.	A	G	17	28	45	0	2	47	0	0
3	35589918	.	G	A	22	26	48	0	1	49	0	0
3	35590270	.	T	C	25	1	26	1	26	53	0	0
3	35602007	.	A	C	16	1	17	0	27	44	0	0
3	35602047	.	A	G	18	25	43	0	3	46	0	0
3	35602153	.	A	G	16	10	26	0	1	27	0	0
3	35602154	.	T	A	15	11	26	0	1	27	0	0
3	35617940	.	A	C	1	3	4	0	0	4	0	0
3	35617943	.	A	C	1	3	4	0	0	4	0	0
3	35623614	.	A	G	4	3	7	0	1	8	0	0
3	35634953	.	A	G	7	7	14	0	0	14	0	0
3	35635039	.	C	T	4	7	11	0	1	12	0	0
3	35635116	.	A	G	6	2	8	0	0	8	0	0
3	35635117	.	A	G	4	2	6	0	1	7	0	0
3	35635612	.	A	G	4	2	6	0	0	6	0	0
3	35635629	.	A	G	1	3	4	0	1	5	0	0
3	35636183	.	A	G	8	3	11	0	1	12	0	0
3	35636188	.	A	G	8	0	8	0	3	11	0	0
3	35636472	.	A	G	5	2	7	0	0	7	0	0
3	35636476	.	A	G	4	2	6	0	1	7	0	0
3	35638008	.	T	A	10	13	23	0	1	24	0	0
3	35638119	.	A	C	14	17	31	0	2	33	0	0
3	35638201	.	A	G	15	15	30	0	2	32	0	0
3	35638240	.	C	T	17	10	27	0	0	27	0	0
3	35638366	.	T	C	13	7	20	0	0	20	0	0
3	35638513	.	G	A	14	10	24	0	2	27	1	0
3	35638908	.	C	T	3	22	25	0	23	48	0	0
3	35638986	.	C	A	21	24	45	0	1	46	0	0
3	35639020	.	A	G	19	20	39	0	3	42	0	0
3	35639021	.	G	A	21	21	42	0	0	42	0	0
3	35639194	.	T	C	13	15	28	0	4	32	0	0
3	35639621	.	A	C	14	14	28	0	3	32	1	0
3	35639817	.	T	A	7	10	17	0	1	18	0	0
3	35639862	.	G	T	16	12	28	0	0	28	0	0
3	35639884	.	T	C	20	1	21	0	6	27	0	0
3	35639958	.	T	C	13	4	17	1	0	18	0	0
3	35640042	.	A	G	10	11	21	0	3	24	0	0
3	35640122	.	G	T	8	9	17	0	2	19	0	0
3	35640441	.	C	A	16	6	22	0	0	22	0	0
3	35640554	.	G	A	4	4	8	1	0	9	0	0
3	35640588	.	A	G	10	6	16	0	0	16	0	0
3	35640625	.	C	T	14	12	26	0	0	26	0	0
3	35640784	.	T	C	22	15	37	0	0	37	0	0
3	35641173	.	C	T	6	9	15	0	0	15	0	0
3	35641371	.	C	T	1	18	19	0	16	36	1	0
3	35641382	.	G	A	18	21	39	0	1	40	0	0
3	35641595	.	A	T	16	12	28	0	1	29	0	0
3	35641663	.	T	C	17	9	26	0	0	26	0	0
3	35641785	.	C	T	0	8	8	0	6	14	0	0
3	35642012	.	A	T	15	10	25	0	0	25	0	0
3	35642072	.	A	G	6	7	13	0	0	13	0	0
3	35642462	.	T	C	9	0	9	0	10	19	0	0
3	35643320	.	G	A	2	3	5	0	1	6	0	0
3	35643540	.	G	A	7	11	18	0	1	19	0	0
3	35643546	.	A	T	8	9	17	0	1	18	0	0
3	35645380	.	T	C	16	0	16	0	15	31	0	0
3	35645411	.	G	A	12	11	23	0	1	24	0	0
3	35645661	.	T	G	14	8	22	0	1	23	0	0
3	35646025	.	G	T	4	11	15	0	2	17	0	0
3	35646160	.	G	T	9	10	19	0	0	19	0	0
3	35646611	.	T	G	2	7	9	0	0	9	0	0
3	35647181	.	A	G	8	10	18	0	0	18	0	0
3	35647321	.	G	A	7	6	13	0	0	13	0	0
3	35647882	.	G	A	2	4	6	0	0	6	0	0
3	35647975	.	A	G	5	10	15	0	1	16	0	0
3	35800738	.	T	C	1	3	4	0	1	5	0	0
3	35831095	.	G	T	2	3	5	0	1	6	0	0
3	35831167	.	T	C	4	4	8	0	0	8	0	0
3	35845774	.	T	C	2	5	7	0	0	7	0	0
3	35845805	.	A	G	3	4	7	0	1	8	0	0
3	35846120	.	C	G	6	6	12	0	0	12	0	0
3	35846343	.	C	G	3	3	6	3	0	9	0	0
3	35846410	.	A	T	5	5	10	0	1	11	0	0
3	35846440	.	G	A	4	6	10	0	0	10	0	0
3	35846823	.	A	G	8	9	17	0	0	17	0	0
3	35850364	.	A	G	2	3	5	0	0	5	0	0
3	35850380	.	C	T	3	2	5	0	0	5	0	0
3	35850785	.	C	T	3	3	6	0	0	6	0	0
3	35858954	.	G	T	2	2	4	0	0	4	0	0
3	35864853	.	A	C	1	2	3	0	0	3	0	0
3	36023342	.	T	G	16	19	35	0	1	36	0	0
3	36023455	.	A	G	17	15	32	0	0	32	0	0
3	36023465	.	A	G	14	15	29	0	1	30	0	0
3	36026294	.	C	G	0	28	28	0	23	51	0	0
3	36032241	.	G	A	17	17	34	0	0	34	0	0
3	36038631	.	G	A	18	17	35	1	0	36	0	0
3	36040863	.	A	G	11	13	24	0	1	25	0	0
3	36041017	.	A	C	20	12	32	0	0	32	0	0
3	36123546	.	G	A	2	3	5	0	0	5	0	0
3	36125256	.	C	G	1	7	8	0	5	13	0	0
3	36127108	.	G	A	1	2	3	0	0	3	0	0
3	36127402	.	A	G	2	0	2	0	4	6	0	0
3	36131883	.	T	A	4	3	7	0	0	7	0	0
3	36132099	.	C	T	7	4	11	0	1	12	0	0
3	36132740	.	T	C	14	7	21	0	0	21	0	0
3	36135481	.	A	G	1	3	4	0	0	4	0	0
3	36135745	.	T	C	2	0	2	0	3	5	0	0
3	36135867	.	A	C	2	4	6	0	0	6	0	0
3	36136290	.	G	C	3	3	6	0	0	6	0	0
3	36136405	.	A	T	2	2	4	0	0	4	0	0
3	36136533	.	T	A	3	3	6	0	0	6	0	0
3	36136537	.	T	A	3	3	6	0	0	6	0	0
3	36136609	.	T	C	1	5	6	0	0	6	0	0
3	36167286	.	T	C	3	2	5	0	1	6	0	0
3	36173633	.	T	C	12	14	26	0	1	27	0	0
3	36174175	.	C	A	15	15	30	0	2	32	0	0
3	36174248	.	C	G	21	15	36	0	0	36	0	0
3	36174276	.	T	C	19	1	20	0	9	29	0	0
3	36184806	.	A	G	9	13	22	0	2	24	0	0
3	36188400	.	A	G	5	9	14	0	1	15	0	0
3	36210030	.	G	A	6	3	9	0	0	9	0	0
3	36210074	.	C	T	5	3	8	0	0	8	0	0
3	36228235	.	A	G	2	0	2	0	4	6	0	0
3	36229823	.	G	A	4	2	6	1	1	8	0	0
3	36229886	.	A	T	7	5	12	0	2	14	0	0
3	36232331	.	C	T	8	6	14	0	0	14	0	0
3	36232368	.	A	C	6	4	10	0	0	10	0	0
3	36241839	.	T	C	11	7	18	0	0	18	0	0
3	36241938	.	T	C	8	0	8	0	6	14	0	0
3	36242239	.	C	T	0	7	7	0	14	21	0	0
3	36248869	.	T	C	4	17	21	0	1	22	0	0
3	36249172	.	C	T	9	6	15	0	1	16	0	0
3	36249419	.	G	A	20	9	29	0	0	29	0	0
3	36249476	.	T	A	23	18	41	0	0	41	0	0
3	36249516	.	T	A	21	14	35	0	1	36	0	0
3	36249518	.	A	C	21	14	35	0	0	35	0	0
3	36253186	.	G	A	20	13	33	0	2	35	0	0
3	36255436	.	A	G	22	16	38	0	1	39	0	0
3	36259855	.	T	C	15	13	28	0	1	29	0	0
3	36262799	.	A	C	18	1	19	0	16	35	0	0
3	36263099	.	T	C	18	1	19	0	11	30	0	0
3	36263151	.	A	G	18	21	39	0	1	40	0	0
3	36263163	.	C	T	17	22	39	0	1	40	0	0
3	36263464	.	C	A	14	22	36	0	0	36	0	0
3	36263557	.	A	G	22	12	34	0	1	35	0	0
3	36263563	.	T	A	21	14	35	0	1	36	0	0
3	36263596	.	T	C	12	1	13	0	11	24	0	0
3	36263666	.	T	C	5	0	5	0	18	23	0	0
3	36263824	.	T	C	20	22	42	0	1	43	0	0
3	36263895	.	A	T	20	21	41	0	1	42	0	0
3	36264028	.	T	C	18	0	18	0	17	35	0	0
3	36264204	.	T	G	7	20	27	0	0	27	0	0
3	36264217	.	A	C	7	19	26	0	0	26	0	0
3	36264248	.	T	C	9	17	26	0	0	26	0	0
3	36264822	.	C	A	2	3	5	0	0	5	0	0
3	36265895	.	C	T	0	13	13	0	17	30	0	0
3	36266137	.	T	A	12	12	24	0	4	28	0	0
3	36266173	.	A	G	13	5	18	0	0	18	0	0
3	36268616	.	A	G	7	5	12	0	0	12	0	0
3	36291213	.	A	G	10	0	10	0	7	17	0	0
3	36292481	.	G	C	2	5	7	0	8	15	0	0
3	36292657	.	T	C	8	8	16	0	0	16	0	0
3	36293950	.	C	T	13	9	22	0	0	22	0	0
3	36293964	.	C	T	12	10	22	0	0	22	0	0
3	36305854	.	A	G	24	19	43	0	2	45	0	0
3	36305860	.	A	G	23	0	23	0	22	45	0	0
3	36305971	.	T	A	10	13	23	0	0	23	0	0
3	36306346	.	A	G	3	3	6	1	1	8	0	0
3	36306349	.	G	A	3	2	5	1	1	7	0	0
3	36325569	.	T	A	3	4	7	0	1	8	0	0
3	36325599	.	G	C	1	5	6	0	0	6	0	0
3	36325648	.	A	T	5	4	9	0	1	10	0	0
3	36326031	.	C	T	2	3	5	0	0	5	0	0
3	36326091	.	A	C	2	4	6	0	0	6	0	0
3	36326108	.	A	T	2	3	5	0	0	5	0	0
3	36326139	.	T	G	2	4	6	0	0	6	0	0
3	36326370	.	A	G	4	3	7	0	2	9	0	0
3	36326839	.	T	A	5	4	9	0	0	9	0	0
3	36327097	.	C	T	3	1	4	0	1	5	0	0
3	36327129	.	G	A	4	5	9	0	0	9	0	0
3	36327414	.	T	A	1	3	4	0	1	5	0	0
3	36327872	.	G	A	10	5	15	0	1	16	0	0
3	36327906	.	G	T	10	5	15	0	0	15	0	0
3	36327909	.	G	T	1	5	6	0	9	15	0	0
3	36328029	.	T	G	3	3	6	0	0	6	0	0
3	36328204	.	C	A	5	5	10	0	0	10	0	0
3	36328218	.	G	A	8	4	12	0	0	12	0	0
3	36328339	.	G	A	2	4	6	0	0	6	0	0
3	36349176	.	T	C	1	3	4	0	0	4	0	0
3	36402930	.	T	C	6	0	6	0	6	12	0	0
3	36407283	.	C	A	4	7	11	0	1	12	0	0
3	36407604	.	A	G	2	3	5	0	0	5	0	0
3	36408402	.	G	T	2	2	4	0	0	4	0	0
3	36409877	.	C	T	1	2	3	0	0	3	0	0
3	36409969	.	T	C	1	3	4	0	0	4	0	0
3	36416026	.	C	A	1	3	4	0	0	4	0	0
3	36416984	.	C	A	1	2	3	0	0	3	0	0
3	36417310	.	C	T	0	2	2	0	1	3	0	0
3	36428612	.	T	A	19	15	34	0	4	38	0	0
3	36428620	.	T	A	20	17	37	0	3	40	0	0
3	36431380	.	T	C	27	13	40	0	2	42	0	0
3	36441465	.	G	A	6	2	8	0	2	10	0	0
3	36441484	.	T	C	8	5	13	0	1	14	0	0
3	36442021	.	T	C	4	12	16	0	2	18	0	0
3	36442029	.	A	G	4	6	10	0	2	12	0	0
3	36442071	.	A	G	9	10	19	0	0	19	0	0
3	36442551	.	C	T	1	16	17	0	13	30	0	0
3	36442661	.	T	G	9	5	14	0	2	16	0	0
3	36442726	.	A	G	11	12	23	0	1	24	0	0
3	36443189	.	G	A	17	12	29	0	1	30	0	0
3	36446613	.	A	G	8	10	18	0	1	19	0	0
3	36859720	.	C	T	17	8	25	0	0	25	0	0
3	36859755	.	A	T	12	5	17	0	1	18	0	0
3	36859821	.	G	T	10	5	15	0	1	16	0	0
3	36862242	.	T	G	10	6	16	0	1	17	0	0
3	36868428	.	T	C	18	11	29	0	0	29	0	0
3	36871254	.	A	T	16	5	21	0	3	24	0	0
3	36871260	.	G	A	1	3	4	0	15	19	0	0
3	36871310	.	A	G	16	0	16	0	4	20	0	0
3	36871316	.	A	G	12	0	12	0	8	20	0	0
3	36877656	.	A	G	17	8	25	0	1	26	0	0
3	36880046	.	C	T	15	11	26	0	2	29	1	0
3	36880084	.	A	C	3	0	3	0	6	9	0	0
3	36883659	.	A	G	14	0	14	0	13	27	0	0
3	36888169	.	T	C	17	16	33	0	0	33	0	0
3	36888395	.	G	A	21	12	33	0	1	34	0	0
3	36889316	.	C	G	29	0	29	0	13	42	0	0
3	36889376	.	G	A	2	14	16	0	23	39	0	0
3	36889821	.	A	G	25	0	25	0	21	46	0	0
3	36892130	.	C	T	19	13	32	0	1	33	0	0
3	36892366	.	C	T	1	4	5	0	0	5	0	0
3	36892457	.	T	G	2	3	5	0	0	5	0	0
3	36892469	.	T	G	2	2	4	0	0	4	0	0
3	36907411	.	T	C	3	3	6	0	0	6	0	0
3	36909852	.	T	G	5	9	14	0	0	14	0	0
3	36910132	.	T	G	2	6	8	0	0	8	0	0
3	36910159	.	C	A	1	4	5	0	1	6	0	0
3	36910174	.	G	A	2	4	6	0	1	7	0	0
3	36917320	.	A	T	3	4	7	0	0	7	0	0
3	36918852	.	G	A	4	6	10	0	0	10	0	0
3	36918966	.	A	G	4	8	12	0	2	14	0	0
3	36923106	.	G	A	2	3	5	0	0	5	0	0
3	36923412	.	A	G	3	3	6	0	0	6	0	0
3	36923933	.	C	T	6	2	8	0	2	10	0	0
3	36926456	.	C	T	0	3	3	0	1	4	0	0
3	36926546	.	G	A	2	2	4	0	0	4	0	0
3	37053166	.	A	G	0	2	2	0	2	4	0	0
3	37104617	.	A	G	2	3	5	0	0	5	0	0
3	37107093	.	C	T	5	4	9	0	1	10	0	0
3	37107100	.	G	T	8	3	11	0	5	16	0	0
3	37237892	.	T	C	9	3	12	0	0	12	0	0
3	37237893	.	T	C	9	0	9	0	3	12	0	0
3	37558571	.	C	A	5	2	7	0	0	7	0	0
3	37559334	.	A	T	30	24	54	0	3	57	0	0
3	37559905	.	A	C	19	21	40	0	3	43	0	0
3	37564769	.	G	A	17	17	34	0	4	38	0	0
3	37649598	.	G	C	8	5	13	0	0	13	0	0
3	37660661	.	A	G	9	1	10	0	3	13	0	0
3	37664117	.	A	T	7	11	18	0	1	19	0	0
3	37664635	.	A	G	16	14	30	0	0	30	0	0
3	37665855	.	G	A	22	30	52	0	3	55	0	0
3	37666774	.	C	T	2	20	22	0	18	40	0	0
3	37667562	.	C	T	1	18	19	0	20	39	0	0
3	37667608	.	G	C	16	16	32	0	0	32	0	0
3	37667646	.	C	T	15	16	31	0	2	33	0	0
3	37667952	.	C	T	2	15	17	0	16	33	0	0
3	37668319	.	A	G	8	5	13	0	0	13	0	0
3	37668370	.	T	C	3	5	8	0	1	9	0	0
3	37668578	.	T	A	10	8	18	0	2	20	0	0
3	37668667	.	C	A	12	12	24	0	0	24	0	0
3	37670156	.	G	T	6	4	10	0	0	10	0	0
3	37673750	.	T	A	3	7	10	0	1	11	0	0
3	37725453	.	A	G	1	0	1	0	4	5	0	0
3	37726111	.	C	T	5	3	8	0	0	8	0	0
3	37727784	.	T	C	3	7	10	0	0	10	0	0
3	37727926	.	C	G	3	4	7	0	0	7	0	0
3	37730412	.	T	C	5	3	8	0	0	8	0	0
3	37737680	.	C	A	5	4	9	0	0	9	0	0
3	37737735	.	T	G	4	1	5	0	9	14	0	0
3	37737736	.	C	T	4	9	13	0	1	14	0	0
3	37737852	.	A	G	5	9	14	0	0	14	0	0
3	37738024	.	A	G	3	8	11	0	0	11	0	0
3	37738050	.	C	G	3	7	10	0	0	10	0	0
3	37738089	.	G	A	3	8	11	0	0	11	0	0
3	37742116	.	A	C	6	3	9	0	1	10	0	0
3	37742152	.	T	C	4	6	10	0	0	10	0	0
3	37742245	.	C	T	4	8	12	0	0	12	0	0
3	37742247	.	A	G	4	8	12	0	0	12	0	0
3	37742284	.	T	G	2	6	8	0	1	9	0	0
3	37742338	.	C	G	2	2	4	0	0	4	0	0
3	37742363	.	C	T	3	2	5	0	0	5	0	0
3	37742468	.	T	C	2	2	4	0	0	4	0	0
3	37742469	.	A	C	2	2	4	0	0	4	0	0
3	37776713	.	T	C	4	6	10	0	0	10	0	0
3	37777309	.	A	T	3	4	7	0	3	10	0	0
3	37777590	.	C	T	4	7	11	0	0	11	0	0
3	37777811	.	C	T	0	8	8	0	5	13	0	0
3	37788401	.	T	C	38	20	58	0	3	61	0	0
3	37789216	.	G	T	4	8	12	0	1	13	0	0
3	37827364	.	G	A	2	3	5	0	0	5	0	0
3	37827420	.	G	A	2	4	6	0	0	6	0	0
3	37827822	.	C	T	4	3	7	0	0	7	0	0
3	37827948	.	C	T	3	3	6	0	1	7	0	0
3	38505629	.	A	G	8	14	22	0	2	24	0	0
3	38614366	.	C	T	13	9	22	0	2	24	0	0
3	38614426	.	A	G	12	0	12	0	8	20	0	0
3	38614562	.	C	T	16	10	26	0	0	26	0	0
3	38624737	.	A	G	13	1	14	0	15	29	0	0
3	38624823	.	G	A	17	9	26	0	1	27	0	0
3	38625098	.	A	C	17	11	28	0	0	28	0	0
3	38625497	.	G	T	16	6	22	0	0	22	0	0
3	38625559	.	T	C	15	6	21	0	0	21	0	0
3	38625605	.	G	A	13	11	24	0	0	24	0	0
3	38625751	.	A	C	10	6	16	0	0	16	0	0
3	38625901	.	T	G	10	12	22	0	0	22	0	0
3	38649991	.	A	T	9	9	18	0	1	19	0	0
3	38650440	.	T	C	6	10	16	0	0	16	0	0
3	38650462	.	T	C	9	4	13	0	0	13	0	0
3	38650477	.	T	C	12	5	17	0	1	18	0	0
3	38763153	.	T	A	11	8	19	0	1	20	0	0
3	38763174	.	G	A	6	5	11	0	16	27	0	0
3	38763391	.	A	G	10	6	16	0	1	17	0	0
3	38763449	.	C	T	7	5	12	0	0	12	0	0
3	38763505	.	G	A	5	4	9	0	0	9	0	0
3	38763527	.	C	T	0	4	4	0	7	11	0	0
3	38763564	.	C	A	5	10	15	0	0	15	0	0
3	38763700	.	G	A	3	10	13	0	1	14	0	0
3	38764738	.	A	C	1	0	1	0	9	10	0	0
3	38765149	.	A	T	3	7	10	0	0	10	0	0
3	38765811	.	A	T	4	2	6	0	0	6	0	0
3	38766207	.	C	T	1	7	8	0	11	19	0	0
3	38766395	.	G	A	3	4	7	0	0	7	0	0
3	38766507	.	G	A	4	3	7	0	0	7	0	0
3	38858514	.	T	G	3	0	3	0	2	5	0	0
3	38858649	.	A	G	4	5	9	0	0	9	0	0
3	38858673	.	C	A	3	6	9	0	0	9	0	0
3	38858722	.	G	A	3	2	5	0	0	5	0	0
3	38858908	.	G	A	0	2	2	0	4	6	0	0
3	38858949	.	G	C	7	3	10	0	0	10	0	0
3	38859126	.	A	T	4	3	7	0	0	7	0	0
3	39181560	.	A	C	3	5	8	0	0	8	0	0
3	39181635	.	C	T	3	3	6	0	1	7	0	0
3	39181823	.	A	G	3	2	5	0	0	5	0	0
3	39181849	.	A	G	3	5	8	0	0	8	0	0
3	39184156	.	A	G	6	9	15	0	0	15	0	0
3	39184180	.	C	T	5	12	17	0	1	18	0	0
3	39184710	.	A	G	7	4	11	0	0	11	0	0
3	39184883	.	C	T	4	5	9	0	0	9	0	0
3	39186729	.	T	C	3	2	5	1	0	6	0	0
3	39238579	.	C	A	10	4	14	0	1	15	0	0
3	39238580	.	C	A	10	5	15	0	0	15	0	0
3	39239380	.	A	G	18	17	35	0	0	35	0	0
3	39241350	.	G	T	14	11	25	0	0	25	0	0
3	39248863	.	A	G	8	5	13	0	1	14	0	0
3	39251020	.	G	T	7	5	12	0	1	13	0	0
3	39251341	.	T	C	9	4	13	0	0	13	0	0
3	39259624	.	T	C	6	0	6	0	9	15	0	0
3	39260767	.	A	T	2	6	8	0	0	8	0	0
3	39260818	.	A	G	2	9	11	0	0	11	0	0
3	39261182	.	C	A	0	5	5	0	2	7	0	0
3	39261230	.	C	T	1	4	5	0	2	7	0	0
3	39261270	.	C	T	0	3	3	0	1	4	0	0
3	39261670	.	A	T	1	2	3	0	0	3	0	0
3	39261843	.	T	G	1	1	2	0	1	3	0	0
3	39262250	.	C	T	2	3	5	0	1	6	0	0
3	39262251	.	A	G	3	3	6	0	1	7	0	0
3	39262694	.	A	G	1	2	3	0	0	3	0	0
3	39262695	.	T	A	1	2	3	0	0	3	0	0
3	39313310	.	A	G	8	5	13	0	1	14	0	0
3	39313625	.	T	C	7	11	18	0	2	20	0	0
3	39314028	.	C	T	12	16	28	0	2	30	0	0
3	39314101	.	T	C	16	13	29	0	3	32	0	0
3	39314146	.	C	G	17	16	33	0	0	33	0	0
3	39314260	.	A	G	8	10	18	0	1	19	0	0
3	39314502	.	G	C	7	17	24	0	3	27	0	0
3	39314631	.	C	T	1	6	7	0	8	15	0	0
3	39314677	.	C	T	9	4	13	0	1	14	0	0
3	39314857	.	G	T	4	2	6	0	1	7	0	0
3	39314986	.	G	T	5	2	7	0	0	7	0	0
3	39315154	.	C	A	4	5	9	0	0	9	0	0
3	39315169	.	C	G	5	6	11	0	0	11	0	0
3	39315191	.	C	G	3	9	12	0	0	12	0	0
3	39315229	.	A	T	1	3	4	0	1	5	0	0
3	39315292	.	A	G	3	4	7	0	0	7	0	0
3	39315728	.	C	T	8	4	12	0	1	13	0	0
3	39315737	.	T	C	9	2	11	0	0	11	0	0
3	39315816	.	A	G	1	8	9	0	0	9	0	0
3	39315874	.	C	A	4	9	13	0	1	14	0	0
3	39315876	.	C	T	4	8	12	0	2	14	0	0
3	39315937	.	A	C	1	0	1	0	6	7	0	0
3	39316037	.	T	C	8	4	12	0	1	13	0	0
3	39316062	.	G	A	10	9	19	0	1	20	0	0
3	39316167	.	A	G	10	7	17	0	0	17	0	0
3	39316570	.	G	A	5	4	9	0	0	9	0	0
3	39316846	.	T	C	9	9	18	0	1	19	0	0
3	39316906	.	C	A	14	12	26	0	2	28	0	0
3	39316912	.	G	A	14	12	26	0	0	26	0	0
3	39316996	.	A	G	16	17	33	0	2	35	0	0
3	39317215	.	C	G	4	5	9	0	0	9	0	0
3	39317279	.	C	T	3	3	6	0	1	7	0	0
3	39317310	.	T	C	4	5	9	0	2	11	0	0
3	39317370	.	C	T	7	5	12	0	0	12	0	0
3	39322109	.	G	A	4	5	9	0	1	10	0	0
3	39328095	.	G	C	7	8	15	0	3	18	0	0
3	39330407	.	T	C	4	0	4	0	6	10	0	0
3	39348533	.	G	A	6	10	16	0	0	16	0	0
3	39348914	.	G	A	1	6	7	0	0	7	0	0
3	39560664	.	T	C	2	2	4	0	0	4	0	0
3	39568368	.	T	G	17	22	39	0	1	40	0	0
3	39568856	.	A	G	28	22	50	1	0	51	0	0
3	39574883	.	C	A	33	33	66	0	6	72	0	0
3	39574961	.	G	A	32	28	60	0	6	66	0	0
3	39576621	.	T	G	35	3	38	0	37	76	1	0
3	39576663	.	A	G	37	41	78	0	1	79	0	0
3	39576866	.	T	C	29	15	44	1	4	49	0	0
3	39579660	.	G	T	3	4	7	0	1	8	0	0
3	39580908	.	T	C	6	5	11	0	0	11	0	0
3	39581137	.	A	G	1	0	1	0	3	4	0	0
3	39586473	.	A	T	2	7	9	0	0	9	0	0
3	39592640	.	T	G	4	4	8	0	0	8	0	0
3	39592797	.	C	T	4	6	10	0	0	10	0	0
3	39592800	.	G	C	1	5	6	0	5	11	0	0
3	39606220	.	C	T	4	2	6	0	0	6	0	0
3	39612261	.	T	A	9	18	27	0	0	27	0	0
3	39612430	.	T	C	9	13	22	0	0	22	0	0
3	39612579	.	G	C	16	11	27	0	1	28	0	0
3	39612715	.	A	T	9	8	17	0	0	17	0	0
3	39613024	.	T	C	12	14	26	0	0	26	0	0
3	39631505	.	T	C	2	3	5	0	0	5	0	0
3	39663915	.	C	T	1	2	3	0	0	3	0	0
3	39663929	.	T	C	2	1	3	0	1	4	0	0
3	39683715	.	A	G	2	2	4	0	1	5	0	0
3	39686776	.	T	A	5	4	9	0	0	9	0	0
3	39686807	.	A	T	5	5	10	0	0	10	0	0
3	39687418	.	C	T	5	4	9	0	1	10	0	0
3	39688558	.	T	G	4	3	7	0	0	7	0	0
3	39688892	.	T	C	3	6	9	0	0	9	0	0
3	39688906	.	C	T	4	3	7	0	0	7	0	0
3	39689216	.	T	C	4	4	8	0	0	8	0	0
3	39689234	.	G	T	6	5	11	0	0	11	0	0
3	39691795	.	C	T	2	2	4	0	0	4	0	0
3	39691978	.	C	G	5	4	9	0	0	9	0	0
3	39692008	.	G	T	4	6	10	0	1	11	0	0
3	39692165	.	A	T	4	7	11	0	0	11	0	0
3	39692196	.	C	T	0	8	8	0	6	14	0	0
3	39692206	.	C	T	5	9	14	0	0	14	0	0
3	39692235	.	C	A	8	7	15	0	2	17	0	0
3	39692265	.	G	A	10	6	16	0	0	16	0	0
3	39692307	.	A	G	7	7	14	0	0	14	0	0
3	39695744	.	T	C	3	9	12	0	0	12	0	0
3	39878663	.	C	T	2	3	5	0	0	5	0	0
3	39919127	.	G	A	2	3	5	0	0	5	0	0
3	39925012	.	T	G	7	0	7	0	5	12	0	0
3	39925087	.	T	C	4	3	7	0	0	7	0	0
3	39940210	.	T	C	5	5	10	0	0	10	0	0
3	39945696	.	A	G	8	7	15	0	0	15	0	0
3	39949389	.	G	A	8	5	13	0	0	13	0	0
3	39949650	.	G	A	0	6	6	0	17	23	0	0
3	39950276	.	A	C	11	7	18	0	3	21	0	0
3	39950340	.	C	T	15	7	22	0	0	22	0	0
3	39950414	.	T	C	17	11	28	0	3	31	0	0
3	39950954	.	T	C	12	8	20	0	0	20	0	0
3	39951124	.	C	T	9	6	15	0	1	16	0	0
3	39951216	.	T	C	3	6	9	0	1	10	0	0
3	39951703	.	A	T	8	5	13	0	1	14	0	0
3	39952025	.	T	C	2	10	12	0	1	13	0	0
3	39952272	.	A	G	11	12	23	0	0	23	0	0
3	39952273	.	A	T	10	12	22	0	1	23	0	0
3	39958680	.	C	T	4	4	8	0	0	8	0	0
3	39958729	.	T	A	9	8	17	0	1	18	0	0
3	39959679	.	A	C	6	4	10	0	1	11	0	0
3	39960535	.	G	C	1	4	5	0	5	10	0	0
3	39962906	.	T	G	8	7	15	0	1	16	0	0
3	39962981	.	T	C	3	13	16	0	0	16	0	0
3	39963053	.	T	C	7	7	14	0	0	14	0	0
3	39963089	.	A	G	3	6	9	0	0	9	0	0
3	39963128	.	G	A	3	9	12	0	1	13	0	0
3	39963131	.	A	G	4	8	12	0	0	12	0	0
3	39967177	.	C	T	3	2	5	0	0	5	0	0
3	39970555	.	G	A	9	10	19	0	0	19	0	0
3	39970641	.	T	G	6	11	17	0	0	17	0	0
3	39971447	.	T	C	10	3	13	0	1	14	0	0
3	39971470	.	T	C	7	7	14	0	1	15	0	0
3	39971499	.	T	C	9	5	14	0	1	15	0	0
3	39971592	.	T	C	7	4	11	0	0	11	0	0
3	39971894	.	T	C	6	7	13	0	0	13	0	0
3	39971943	.	T	C	8	3	11	0	1	12	0	0
3	39972055	.	T	C	5	4	9	0	1	10	0	0
3	39972073	.	G	A	5	4	9	0	1	10	0	0
3	39975467	.	T	C	11	1	12	0	7	19	0	0
3	39982019	.	C	T	6	6	12	0	0	12	0	0
3	39982198	.	A	T	5	6	11	0	0	11	0	0
3	39984581	.	G	A	1	3	4	0	0	4	0	0
3	39987992	.	T	C	2	0	2	0	3	5	0	0
3	40154310	.	G	A	1	2	3	0	1	4	0	0
3	40154322	.	G	A	2	2	4	0	0	4	0	0
3	40154387	.	C	T	2	5	7	0	2	9	0	0
3	40158383	.	C	G	12	14	26	0	0	26	0	0
3	40160676	.	G	A	4	3	7	0	0	7	0	0
3	40162535	.	T	C	6	0	6	0	11	17	0	0
3	40162805	.	A	G	6	11	17	0	0	17	0	0
3	40164156	.	C	T	3	7	10	0	0	10	0	0
3	40164233	.	T	C	6	11	17	0	1	18	0	0
3	40164238	.	G	T	4	10	14	0	2	16	0	0
3	40165637	.	T	C	4	8	12	0	0	12	0	0
3	40165733	.	T	C	9	11	20	0	1	21	0	0
3	40168006	.	A	C	6	16	22	0	0	22	0	0
3	40168007	.	G	A	6	16	22	0	0	22	0	0
3	40168192	.	T	G	9	3	12	0	2	14	0	0
3	40168424	.	T	G	1	2	3	0	0	3	0	0
3	40172218	.	C	T	16	17	33	0	0	33	0	0
3	40178148	.	C	T	23	23	46	0	1	47	0	0
3	40178154	.	C	T	22	24	46	0	3	49	0	0
3	40178343	.	G	A	22	15	37	0	1	38	0	0
3	40178644	.	A	T	13	3	16	0	2	18	0	0
3	40178761	.	G	A	9	7	16	0	0	16	0	0
3	40178833	.	G	A	1	12	13	0	14	27	0	0
3	40178956	.	G	T	20	18	38	0	2	40	0	0
3	40179025	.	G	C	21	18	39	0	1	40	0	0
3	40179331	.	A	T	25	15	40	0	0	40	0	0
3	40179457	.	A	T	16	10	26	0	1	27	0	0
3	40179476	.	T	C	16	12	28	0	0	28	0	0
3	40179528	.	G	T	22	16	38	0	0	38	0	0
3	40179533	.	T	A	22	17	39	0	1	40	0	0
3	40179604	.	T	A	27	18	45	0	0	45	0	0
3	40179608	.	A	G	23	21	44	0	2	46	0	0
3	40179642	.	C	T	22	21	43	0	12	55	0	0
3	40179669	.	G	A	24	27	51	0	3	54	0	0
3	40179849	.	C	T	21	31	52	0	1	53	0	0
3	40179870	.	C	A	26	29	55	0	2	57	0	0
3	40180023	.	A	G	20	0	20	0	22	42	0	0
3	40180091	.	A	G	29	18	47	0	2	49	0	0
3	40180092	.	A	G	30	19	49	0	0	49	0	0
3	40180197	.	A	T	11	14	25	0	0	25	0	0
3	40186041	.	C	T	10	8	18	0	0	18	0	0
3	40188830	.	A	G	8	11	19	0	0	19	0	0
3	40189828	.	A	C	4	0	4	0	7	11	0	0
3	40190805	.	A	G	5	5	10	0	0	10	0	0
3	40190838	.	T	C	6	0	6	0	7	13	0	0
3	40190926	.	C	T	2	7	9	0	3	12	0	0
3	40191012	.	C	T	3	4	7	0	2	9	0	0
3	40191116	.	C	T	3	4	7	0	0	7	0	0
3	40193140	.	A	G	4	4	8	0	1	9	0	0
3	40193176	.	C	T	0	2	2	0	3	5	0	0
3	40193281	.	A	G	2	4	6	0	0	6	0	0
3	40193589	.	G	T	4	6	10	0	0	10	0	0
3	40193819	.	C	T	5	5	10	0	0	10	0	0
3	40206355	.	C	A	10	4	14	0	2	16	0	0
3	40206373	.	A	T	9	9	18	0	3	21	0	0
3	40206430	.	G	T	20	11	31	0	1	32	0	0
3	40206440	.	T	C	18	13	31	0	0	31	0	0
3	40206597	.	A	T	12	7	19	0	0	19	0	0
3	40206736	.	T	G	11	5	16	0	1	17	0	0
3	40206766	.	C	T	3	9	12	0	5	17	0	0
3	40207030	.	A	G	21	9	30	0	0	30	0	0
3	40207407	.	A	C	1	3	4	0	1	5	0	0
3	40207449	.	C	A	6	3	9	0	1	10	0	0
3	40214005	.	C	T	10	8	18	0	0	18	0	0
3	40216281	.	G	A	15	4	19	0	1	20	0	0
3	40218727	.	G	A	7	3	10	0	0	10	0	0
3	40220951	.	G	A	4	4	8	0	0	8	0	0
3	40220984	.	A	G	1	2	3	0	0	3	0	0
3	40221059	.	G	A	9	3	12	0	0	12	0	0
3	40237298	.	A	G	6	4	10	0	1	11	0	0
3	40237325	.	C	T	4	4	8	0	0	8	0	0
3	40237492	.	G	A	5	4	9	0	0	9	0	0
3	40237496	.	A	G	6	4	10	0	1	11	0	0
3	40237555	.	G	A	6	3	9	0	0	9	0	0
3	40237574	.	A	T	5	2	7	0	1	8	0	0
3	40241337	.	A	T	3	2	5	0	0	5	0	0
3	40245681	.	T	C	4	0	4	0	3	7	0	0
3	40255500	.	G	T	0	2	2	0	1	3	0	0
3	40255951	.	C	T	3	4	7	0	1	8	0	0
3	40256418	.	C	T	2	6	8	0	0	8	0	0
3	40256688	.	T	C	5	4	9	0	1	10	0	0
3	40256734	.	G	A	3	6	9	0	0	9	0	0
3	40256735	.	C	A	3	5	8	0	1	9	0	0
3	40256835	.	C	T	2	2	4	0	0	4	0	0
3	40256864	.	C	T	3	3	6	0	0	6	0	0
3	40257201	.	C	T	5	2	7	0	0	7	0	0
3	40257397	.	C	G	3	2	5	0	0	5	0	0
3	40261306	.	T	A	1	3	4	0	0	4	0	0
3	40280034	.	T	C	13	7	20	0	1	21	0	0
3	40284375	.	T	C	11	1	12	0	8	20	0	0
3	40284447	.	T	A	7	10	17	0	0	17	0	0
3	40284837	.	A	T	5	4	9	0	0	9	0	0
3	40284860	.	G	T	13	12	25	0	0	25	0	0
3	40287538	.	C	T	3	2	5	0	1	6	0	0
3	40287574	.	A	G	2	3	5	0	1	6	0	0
3	40287808	.	A	G	8	6	14	0	1	15	0	0
3	40287831	.	T	C	6	4	10	0	0	10	0	0
3	40294179	.	G	A	14	7	21	0	2	23	0	0
3	40294969	.	A	G	7	0	7	0	6	13	0	0
3	40299905	.	A	T	26	36	62	0	5	67	0	0
3	40318555	.	C	G	1	3	4	0	1	5	0	0
3	40318556	.	C	G	1	4	5	0	0	5	0	0
3	40318733	.	T	A	2	4	6	0	0	6	0	0
3	40318754	.	T	C	2	4	6	0	1	7	0	0
3	40333793	.	T	C	4	3	7	0	0	7	0	0
3	40346035	.	C	T	14	12	26	0	1	27	0	0
3	40348839	.	T	C	20	9	29	1	2	32	0	0
3	40349123	.	C	T	6	9	15	0	1	16	0	0
3	40349354	.	T	G	9	5	14	0	0	14	0	0
3	40405035	.	T	A	1	2	3	1	0	4	0	0
3	40430922	.	G	A	1	2	3	0	4	7	0	0
3	40443143	.	A	T	5	3	8	0	0	8	0	0
3	40444020	.	C	T	1	1	2	0	1	3	0	0
3	40444470	.	G	A	5	3	8	0	1	9	0	0
3	40448220	.	T	C	3	5	8	0	0	8	0	0
3	40467464	.	C	T	4	4	8	0	3	11	0	0
3	40467486	.	G	A	0	9	9	0	5	14	0	0
3	40467687	.	G	A	10	11	21	0	1	22	0	0
3	40467756	.	C	T	13	7	20	0	3	23	0	0
3	40468374	.	C	T	9	4	13	0	2	15	0	0
3	40479178	.	G	A	9	6	15	0	1	16	0	0
3	40479736	.	A	T	10	8	18	0	0	18	0	0
3	40480877	.	G	A	0	13	13	0	15	28	0	0
3	40480986	.	G	T	17	11	28	0	3	31	0	0
3	40484376	.	A	T	12	9	21	0	0	21	0	0
3	40484454	.	C	A	15	17	32	0	0	32	0	0
3	40485360	.	C	A	20	9	29	0	3	32	0	0
3	40485499	.	G	A	16	14	30	0	1	31	0	0
3	40485582	.	C	T	13	15	28	0	2	30	0	0
3	40485965	.	G	C	11	10	21	0	0	21	0	0
3	40486256	.	C	T	21	25	46	0	0	46	0	0
3	40486294	.	C	T	28	19	47	0	2	49	0	0
3	40487095	.	G	T	10	11	21	0	0	21	0	0
3	40487197	.	T	A	13	8	21	1	1	23	0	0
3	40487628	.	T	C	12	22	34	0	1	35	0	0
3	40487957	.	G	A	18	18	36	0	0	36	0	0
3	40488212	.	C	T	21	18	39	0	1	40	0	0
3	40488266	.	T	C	28	12	40	0	7	47	0	0
3	40488630	.	T	C	6	4	10	0	0	10	0	0
3	40488640	.	T	C	5	5	10	0	0	10	0	0
3	40527028	.	G	A	35	47	82	0	6	88	0	0
3	40527575	.	G	A	44	45	89	1	14	104	0	0
3	40527853	.	T	C	2	2	4	0	0	4	0	0
3	40528241	.	A	T	30	37	67	0	4	71	0	0
3	40576600	.	C	T	22	20	42	0	1	43	0	0
3	40576780	.	C	T	12	17	29	0	3	32	0	0
3	40577032	.	C	T	16	19	35	0	0	35	0	0
3	40581432	.	C	T	12	14	26	0	1	27	0	0
3	40587884	.	G	A	3	26	29	0	25	54	0	0
3	40587901	.	G	A	1	24	25	0	21	46	0	0
3	40588109	.	A	T	23	29	52	0	2	55	1	0
3	40588363	.	C	T	22	26	48	0	0	48	0	0
3	40588410	.	C	A	30	18	48	0	0	48	0	0
3	40588746	.	C	G	22	18	40	0	0	40	0	0
3	40589117	.	T	A	34	24	58	0	0	58	0	0
3	40589214	.	C	A	17	23	40	0	2	42	0	0
3	40589348	.	A	G	18	22	40	0	2	42	0	0
3	40589356	.	A	G	17	23	40	0	0	40	0	0
3	40615891	.	A	G	14	6	20	0	1	21	0	0
3	40615948	.	G	A	10	9	19	0	0	19	0	0
3	40647450	.	C	A	3	4	7	0	0	7	0	0
3	40649928	.	A	T	8	2	10	0	1	11	0	0
3	40656449	.	T	G	1	6	7	0	0	7	0	0
3	40656600	.	T	C	4	3	7	0	0	7	0	0
3	40658853	.	C	T	0	2	2	0	3	5	0	0
3	40690901	.	G	A	8	4	12	0	0	12	0	0
3	40691643	.	A	T	11	3	14	0	1	15	0	0
3	40691969	.	C	T	9	9	18	0	1	19	0	0
3	40692064	.	A	T	8	8	16	0	2	18	0	0
3	40692099	.	A	G	7	8	15	0	0	15	0	0
3	40698424	.	C	A	9	5	14	1	0	15	0	0
3	40698481	.	A	G	8	6	14	0	2	16	0	0
3	40712935	.	G	A	4	6	10	0	0	10	0	0
3	40716045	.	G	A	2	6	8	0	0	8	0	0
3	40804286	.	T	G	29	1	30	1	2	33	0	0
3	40804382	.	G	A	3	12	15	0	6	21	0	0
3	40814704	.	C	A	3	3	6	1	0	7	0	0
3	40817338	.	C	T	6	2	8	0	1	9	0	0
3	40817712	.	G	A	3	7	10	0	0	10	0	0
3	40819959	.	A	C	1	2	3	0	0	3	0	0
3	40821871	.	A	T	15	7	22	1	4	27	0	0
3	40826707	.	G	T	16	13	29	0	0	29	0	0
3	40833733	.	C	T	10	10	20	0	0	20	0	0
3	40833775	.	C	T	1	4	5	0	7	12	0	0
3	40876757	.	G	A	5	4	9	0	1	10	0	0
3	40876770	.	G	C	3	5	8	0	1	9	0	0
3	40880130	.	C	A	2	3	5	0	0	5	0	0
3	40913590	.	G	A	4	7	11	0	1	12	0	0
3	40913730	.	G	A	2	8	10	0	0	10	0	0
3	40927653	.	C	T	3	7	10	0	2	12	0	0
3	40927656	.	C	T	0	3	3	0	9	12	0	0
3	40979597	.	G	C	7	13	20	0	1	21	0	0
3	40979746	.	T	A	12	7	19	0	1	20	0	0
3	40979791	.	G	C	12	6	18	0	0	18	0	0
3	40980024	.	G	A	12	6	18	0	1	19	0	0
3	40980166	.	T	A	13	9	22	0	2	24	0	0
3	40980167	.	T	A	9	15	24	0	0	24	0	0
3	40980245	.	G	T	4	12	16	0	4	20	0	0
3	40983062	.	A	G	7	9	16	0	1	17	0	0
3	40985992	.	T	C	7	2	9	0	2	11	0	0
3	40990933	.	A	G	3	2	5	0	0	5	0	0
3	40995278	.	G	A	5	5	10	0	0	10	0	0
3	41000159	.	T	C	4	1	5	0	2	7	0	0
3	41023331	.	G	A	3	3	6	0	0	6	0	0
3	41030891	.	C	T	0	9	9	0	3	12	0	0
3	41030921	.	T	C	2	5	7	0	0	7	0	0
3	41030939	.	T	C	1	5	6	0	0	6	0	0
3	41037779	.	A	T	6	3	9	0	0	9	0	0
3	41089046	.	C	T	1	2	3	0	0	3	0	0
3	41092137	.	A	T	2	4	6	0	0	6	0	0
3	41282708	.	C	T	0	2	2	0	1	3	0	0
3	41704687	.	G	A	1	4	5	0	0	5	0	0
3	41705428	.	C	T	4	1	5	0	1	6	0	0
3	41705468	.	A	T	1	3	4	0	2	6	0	0
3	41705476	.	C	T	1	2	3	0	2	5	0	0
3	41705626	.	G	T	4	2	6	0	0	6	0	0
3	41705949	.	G	A	1	4	5	0	1	6	0	0
3	41715646	.	G	A	1	6	7	0	9	16	0	0
3	41716889	.	C	A	5	8	13	0	0	13	0	0
3	41719049	.	G	A	12	13	25	0	2	27	0	0
3	41719219	.	A	G	15	0	15	0	13	28	0	0
3	41721916	.	G	A	13	15	28	0	1	29	0	0
3	41723069	.	G	A	21	8	29	0	0	29	0	0
3	41723437	.	G	A	15	23	38	0	0	38	0	0
3	41724298	.	C	T	21	17	38	0	2	40	0	0
3	41724806	.	G	A	17	12	29	0	1	30	0	0
3	41731929	.	C	A	1	3	4	0	2	6	0	0
3	41731980	.	G	A	4	2	6	0	0	6	0	0
3	41732076	.	T	C	2	3	5	0	0	5	0	0
3	41732220	.	C	T	2	3	5	0	2	7	0	0
3	41732349	.	C	T	3	2	5	0	1	6	0	0
3	41732486	.	T	A	3	5	8	0	0	8	0	0
3	41922587	.	C	T	2	2	4	0	1	5	0	0
3	41922766	.	A	G	5	0	5	0	4	9	0	0
3	41922799	.	C	T	3	4	7	0	0	7	0	0
3	41923195	.	T	C	5	2	7	0	0	7	0	0
3	41923288	.	C	T	3	5	8	0	0	8	0	0
3	41925154	.	C	T	2	4	6	0	0	6	0	0
3	41925508	.	A	G	2	3	5	0	0	5	0	0
3	41925541	.	C	G	3	2	5	0	0	5	0	0
3	41925694	.	A	C	9	5	14	0	0	14	0	0
3	41925823	.	C	T	3	2	5	0	0	5	0	0
3	41925889	.	T	C	6	3	9	0	0	9	0	0
3	41926020	.	T	A	2	4	6	0	0	6	0	0
3	41926557	.	G	A	2	3	5	0	0	5	0	0
3	41926695	.	T	C	3	4	7	0	1	8	0	0
3	41955449	.	A	G	2	2	4	0	0	4	0	0
3	41955613	.	G	T	20	13	33	0	1	34	0	0
3	41955911	.	C	G	12	13	25	0	2	27	0	0
3	41956040	.	G	T	17	10	27	0	2	29	0	0
3	41956299	.	T	C	10	10	20	0	0	20	0	0
3	41956353	.	T	A	14	12	26	0	1	27	0	0
3	41956467	.	T	A	8	4	12	1	1	14	0	0
3	41956504	.	C	T	2	2	4	1	1	6	0	0
3	41956553	.	T	A	3	2	5	0	0	5	0	0
3	41956792	.	A	T	10	13	23	0	1	24	0	0
3	41956818	.	T	C	13	9	22	0	0	22	0	0
3	41956837	.	T	G	9	8	17	0	0	17	0	0
3	41956855	.	C	T	7	10	17	0	0	17	0	0
3	41956921	.	T	A	6	7	13	1	0	14	0	0
3	41956941	.	T	C	6	4	10	0	1	11	0	0
3	41956978	.	G	A	4	4	8	0	0	8	0	0
3	41957580	.	G	T	7	3	10	0	0	10	0	0
3	41957751	.	A	C	2	3	5	0	0	5	0	0
3	41958291	.	T	G	4	4	8	0	0	8	0	0
3	41959370	.	G	T	5	14	19	0	0	19	0	0
3	41959658	.	G	T	3	5	8	0	0	8	0	0
3	41959772	.	A	G	8	6	14	0	0	14	0	0
3	41959906	.	T	A	5	5	10	0	0	10	0	0
3	41959943	.	T	C	1	6	7	0	1	8	0	0
3	41959958	.	A	G	1	5	6	0	0	6	0	0
3	41960005	.	C	A	4	5	9	0	0	9	0	0
3	41960069	.	G	T	5	5	10	0	1	11	0	0
3	41960346	.	A	G	4	5	9	0	0	9	0	0
3	41960873	.	A	C	0	1	1	0	1	3	1	0
3	41961341	.	T	G	4	5	9	0	1	10	0	0
3	41961469	.	A	G	3	4	7	0	0	7	0	0
3	41961558	.	A	T	7	4	11	0	0	11	0	0
3	41961587	.	T	G	7	6	13	0	1	14	0	0
3	41961651	.	G	A	5	5	10	0	0	10	0	0
3	41961688	.	T	C	8	1	9	0	5	14	0	0
3	41961993	.	C	G	0	2	2	0	4	6	0	0
3	41962098	.	T	C	2	5	7	0	0	7	0	0
3	41962463	.	G	A	1	3	4	0	0	4	0	0
3	42016675	.	A	T	2	4	6	0	0	6	0	0
3	42016682	.	C	G	0	4	4	0	2	6	0	0
3	42121833	.	C	A	2	3	5	0	0	5	0	0
3	42918924	.	C	A	13	7	20	0	2	22	0	0
3	42919474	.	C	T	11	11	22	0	0	22	0	0
3	42919510	.	C	T	8	6	14	0	4	18	0	0
3	42919664	.	C	T	9	6	15	0	0	15	0	0
3	42919846	.	T	G	4	6	10	0	0	10	0	0
3	42919849	.	C	T	3	6	9	0	0	9	0	0
3	42919881	.	C	T	2	4	6	0	0	6	0	0
3	42919895	.	A	G	3	5	8	0	0	8	0	0
3	42919943	.	G	C	7	3	10	0	0	10	0	0
3	42919959	.	A	T	6	3	9	0	0	9	0	0
3	42957152	.	A	T	1	2	3	0	0	3	0	0
3	42957196	.	G	A	1	2	3	0	0	3	0	0
3	43000474	.	A	G	1	2	3	0	1	4	0	0
3	43017912	.	T	C	1	3	4	0	0	4	0	0
3	43024872	.	T	C	1	3	4	0	1	5	0	0
3	43029889	.	T	C	3	4	7	0	0	7	0	0
3	43036193	.	T	C	2	2	4	0	0	4	0	0
3	43038222	.	G	A	3	5	8	0	0	8	0	0
3	43039306	.	A	G	8	7	15	0	0	15	0	0
3	43039479	.	C	T	1	8	9	0	0	9	0	0
3	43052230	.	T	C	4	8	12	0	0	12	0	0
3	43059090	.	A	G	4	9	13	0	0	13	0	0
3	43059153	.	A	G	4	7	11	0	4	15	0	0
3	43376543	.	A	G	5	3	8	0	0	8	0	0
3	43380283	.	C	T	8	6	14	0	1	15	0	0
3	43392755	.	T	A	9	10	19	1	1	21	0	0
3	43392795	.	C	A	6	6	12	0	0	12	0	0
3	43474920	.	A	T	3	3	6	0	1	7	0	0
3	43475184	.	C	T	2	4	6	0	0	6	0	0
3	43475325	.	A	G	8	8	16	0	2	18	0	0
3	43475376	.	T	C	2	8	10	0	0	10	0	0
3	43475397	.	C	T	4	6	10	0	2	12	0	0
3	43475592	.	A	C	8	3	11	0	1	12	0	0
3	43475617	.	G	T	0	4	4	0	5	9	0	0
3	43475654	.	C	T	5	5	10	0	0	10	0	0
3	43475742	.	G	T	5	6	11	0	0	11	0	0
3	43475772	.	A	G	3	3	6	0	0	6	0	0
3	43476017	.	A	G	1	4	5	0	1	6	0	0
3	43476088	.	G	T	4	4	8	0	0	8	0	0
3	43476411	.	A	T	4	4	8	0	1	9	0	0
3	43476435	.	G	T	4	8	12	0	0	12	0	0
3	43476514	.	A	C	7	4	11	0	1	12	0	0
3	43476698	.	A	G	8	3	11	0	0	11	0	0
3	43476880	.	C	T	9	3	12	0	0	12	0	0
3	43476887	.	T	G	10	3	13	0	1	14	0	0
3	43477255	.	T	A	4	4	8	0	1	9	0	0
3	43478137	.	T	C	11	4	15	0	0	15	0	0
3	43478238	.	C	T	9	3	12	0	0	12	0	0
3	43478310	.	T	G	8	9	17	0	1	18	0	0
3	43478321	.	A	G	8	0	8	0	11	19	0	0
3	43478433	.	A	T	12	3	15	0	0	15	0	0
3	43478586	.	C	T	3	2	5	0	1	6	0	0
3	43579820	.	C	T	2	9	11	0	9	20	0	0
3	43580055	.	A	G	14	13	27	0	1	28	0	0
3	43580195	.	A	T	11	9	20	0	0	20	0	0
3	43580583	.	T	C	8	8	16	0	0	16	0	0
3	43581272	.	A	C	11	8	19	0	0	19	0	0
3	43584423	.	T	C	13	0	13	0	16	29	0	0
3	43584453	.	T	C	9	14	23	0	4	27	0	0
3	43594256	.	A	G	15	12	27	0	2	29	0	0
3	43594358	.	C	T	4	17	21	0	1	22	0	0
3	43594376	.	C	T	2	11	13	0	6	19	0	0
3	43594577	.	G	A	15	8	23	0	0	23	0	0
3	43594655	.	C	T	1	12	13	0	4	17	0	0
3	43594658	.	G	A	5	12	17	0	0	17	0	0
3	43594735	.	T	C	7	7	14	0	0	14	0	0
3	43600999	.	C	T	1	6	7	0	9	16	0	0
3	43645900	.	G	C	5	7	12	0	0	12	0	0
3	43646161	.	A	G	4	6	10	0	0	10	0	0
3	43646362	.	C	T	0	5	5	0	9	14	0	0
3	43774440	.	C	A	3	7	10	0	1	11	0	0
3	43785646	.	A	T	5	3	8	0	0	8	0	0
3	43791284	.	T	C	3	7	10	0	1	11	0	0
3	43791317	.	G	A	3	7	10	0	1	11	0	0
3	43793147	.	T	C	7	5	12	0	0	12	0	0
3	43793389	.	T	C	5	2	7	0	0	7	0	0
3	43796956	.	T	G	4	0	4	1	7	12	0	0
3	43797073	.	C	T	8	6	14	0	0	14	0	0
3	43801338	.	C	T	14	13	27	0	2	29	0	0
3	43807512	.	T	C	6	10	16	0	1	17	0	0
3	43807921	.	C	A	5	13	18	0	1	19	0	0
3	43807945	.	T	A	5	5	10	0	0	13	3	0
3	43814607	.	C	T	4	9	13	0	1	14	0	0
3	43821273	.	G	T	4	10	14	0	0	14	0	0
3	43821328	.	A	G	3	7	10	0	0	10	0	0
3	43825892	.	T	A	2	2	4	0	1	5	0	0
3	43825901	.	T	C	3	1	4	0	0	4	0	0
3	43828672	.	T	C	1	2	3	0	0	3	0	0
3	43828902	.	G	A	1	5	6	0	0	6	0	0
3	43828906	.	T	C	0	5	5	0	0	5	0	0
3	43829370	.	A	C	3	7	10	0	0	10	0	0
3	43829411	.	C	T	2	2	4	0	0	4	0	0
3	43829413	.	C	T	2	2	4	0	0	4	0	0
3	43829712	.	G	A	1	6	7	0	2	9	0	0
3	43942053	.	A	C	2	3	5	0	0	5	0	0
3	43944611	.	A	G	5	7	12	0	0	12	0	0
3	43953805	.	C	T	6	2	8	0	0	8	0	0
3	43953883	.	T	C	5	2	7	0	3	10	0	0
3	43985549	.	T	C	1	3	4	0	1	5	0	0
3	43985593	.	A	G	1	3	4	0	0	4	0	0
3	43986008	.	C	T	1	3	4	0	0	4	0	0
3	43986759	.	T	C	2	2	4	0	0	4	0	0
3	43986937	.	G	A	1	3	4	0	2	6	0	0
3	43987059	.	G	A	0	1	1	0	3	4	0	0
3	43987062	.	G	C	2	2	4	0	0	4	0	0
3	44076950	.	C	G	4	0	4	0	5	9	0	0
3	44077295	.	A	T	3	2	5	0	0	5	0	0
3	44077429	.	A	C	1	1	2	0	1	3	0	0
3	44077508	.	C	T	3	4	7	0	0	7	0	0
3	44077543	.	G	T	1	2	3	0	0	3	0	0
3	44082200	.	A	G	3	2	5	0	0	5	0	0
3	44082239	.	T	G	1	3	4	0	0	4	0	0
3	44089225	.	T	G	2	5	7	0	0	7	0	0
3	44089529	.	A	G	2	4	6	0	0	6	0	0
3	44093661	.	T	C	1	0	1	0	3	4	0	0
3	44541955	.	C	A	5	3	8	0	1	9	0	0
3	45284339	.	T	C	5	3	8	0	1	9	0	0
3	45715511	.	T	A	3	3	6	0	1	7	0	0
3	45715716	.	C	T	3	5	8	0	0	8	0	0
3	45715776	.	T	C	2	5	7	0	0	7	0	0
3	45716082	.	T	C	6	4	10	0	0	10	0	0
3	45716098	.	C	T	6	3	9	0	0	9	0	0
3	45716156	.	A	T	1	2	3	0	0	3	0	0
3	45716705	.	A	G	3	7	10	0	0	10	0	0
3	45716766	.	A	G	3	1	4	0	5	9	0	0
3	45717180	.	C	T	7	10	17	0	4	21	0	0
3	45776520	.	T	C	17	0	17	0	19	36	0	0
3	45776721	.	T	C	22	32	54	0	3	57	0	0
3	45778103	.	T	A	3	4	7	0	1	8	0	0
3	45790559	.	T	C	3	2	5	0	0	5	0	0
3	45805605	.	C	G	7	3	10	0	0	10	0	0
3	45814631	.	A	T	6	4	10	0	0	10	0	0
3	45815894	.	A	C	3	5	8	0	0	8	0	0
3	45815997	.	G	A	1	8	9	0	3	12	0	0
3	45816004	.	C	T	4	7	11	0	0	11	0	0
3	45816549	.	A	G	7	12	19	0	0	19	0	0
3	45816618	.	T	C	8	13	21	0	0	21	0	0
3	46043483	.	G	A	2	4	6	0	1	7	0	0
3	46043528	.	T	A	4	2	6	0	0	6	0	0
3	46044190	.	G	T	3	3	6	0	0	6	0	0
3	46795013	.	G	T	3	4	7	0	1	8	0	0
3	46795113	.	G	T	3	3	6	0	0	6	0	0
3	46802864	.	G	A	5	2	7	0	5	12	0	0
3	48229390	.	A	G	1	0	1	0	7	8	0	0
3	48638814	.	T	G	1	3	4	0	1	5	0	0
3	49460024	.	A	G	18	4	22	0	0	22	0	0
3	50365808	.	C	A	2	10	12	0	0	12	0	0
3	51907077	.	G	T	1	3	4	0	0	4	0	0
3	52699364	.	T	C	6	2	8	0	0	8	0	0
3	53074922	.	A	C	9	1	10	1	3	14	0	0
3	55098813	.	G	T	11	25	36	28	2	66	0	0
3	55099174	.	A	G	2	3	5	0	0	5	0	0
3	55100228	.	T	C	15	19	34	5	2	41	0	0
3	55100413	.	C	A	29	11	40	11	3	54	0	0
3	55100522	.	A	G	11	5	16	41	1	58	0	0
3	55104129	.	T	C	18	10	28	17	7	52	0	0
3	55104214	.	T	C	6	0	6	21	11	38	0	0
3	55104215	.	A	G	8	9	17	21	0	38	0	0
3	56883657	.	T	C	1	0	1	0	4	5	0	0
3	57423485	.	A	C	3	6	9	0	1	10	0	0
3	57423489	.	C	T	3	8	11	0	0	11	0	0
3	57423533	.	A	G	2	4	6	0	0	6	0	0
3	57424244	.	C	T	9	4	13	0	0	13	0	0
3	57424311	.	G	A	9	3	12	0	1	13	0	0
3	57424327	.	T	C	8	4	12	0	0	12	0	0
3	57424743	.	A	G	4	5	9	0	0	9	0	0
3	57425892	.	G	C	3	0	3	0	3	6	0	0
3	57462285	.	G	A	2	7	9	0	0	9	0	0
3	57462301	.	A	C	7	4	11	0	1	12	0	0
3	57462490	.	G	T	12	13	25	0	1	26	0	0
3	57462548	.	C	T	0	17	17	0	20	37	0	0
3	57462584	.	C	T	13	16	29	0	1	30	0	0
3	57462598	.	A	G	14	13	27	0	1	28	0	0
3	57462643	.	A	C	13	8	21	0	1	22	0	0
3	57462673	.	G	T	17	5	22	0	0	22	0	0
3	57462751	.	G	C	8	11	19	0	0	19	0	0
3	57462953	.	T	C	6	3	9	0	6	15	0	0
3	57462962	.	T	C	2	10	12	0	4	16	0	0
3	57462990	.	T	C	9	5	14	0	0	14	0	0
3	57463446	.	A	T	12	10	22	0	1	23	0	0
3	57463470	.	C	T	11	11	22	0	0	22	0	0
3	57463698	.	C	T	1	11	12	3	18	33	0	0
3	57463933	.	G	A	15	8	23	5	4	32	0	0
3	57463972	.	G	C	12	4	16	1	0	17	0	0
3	57464484	.	G	A	4	11	15	0	1	16	0	0
3	57464735	.	T	A	11	16	27	0	0	27	0	0
3	57464746	.	C	T	1	8	9	0	13	22	0	0
3	57464793	.	T	A	10	4	14	0	0	14	0	0
3	57464884	.	T	A	7	4	11	0	1	12	0	0
3	57464986	.	A	C	6	5	11	0	0	11	0	0
3	57465090	.	G	C	8	12	20	0	1	21	0	0
3	57465176	.	G	C	11	12	23	0	1	24	0	0
3	57465308	.	T	C	9	0	9	0	16	25	0	0
3	57465544	.	A	T	3	5	8	0	1	9	0	0
3	57465550	.	A	G	3	6	9	0	0	9	0	0
3	57465827	.	G	C	8	5	13	0	2	15	0	0
3	57465965	.	G	T	5	6	11	0	1	12	0	0
3	57492140	.	C	T	5	7	12	1	1	14	0	0
3	57494405	.	G	A	2	9	11	0	0	11	0	0
3	57583954	.	C	T	9	8	17	0	1	18	0	0
3	57584599	.	A	T	10	8	18	0	2	20	0	0
3	57584606	.	A	G	10	7	17	0	0	17	0	0
3	57584656	.	A	C	9	11	20	0	2	22	0	0
3	57584783	.	T	C	6	0	6	0	4	10	0	0
3	57585015	.	C	T	1	8	9	0	13	22	0	0
3	57585033	.	C	T	8	12	20	0	1	21	0	0
3	57585150	.	C	T	2	20	22	0	8	30	0	0
3	57593524	.	C	T	9	20	29	0	2	31	0	0
3	57593977	.	G	A	6	11	17	0	2	19	0	0
3	57593978	.	G	A	8	11	19	0	0	19	0	0
3	57594016	.	G	A	13	8	21	0	3	24	0	0
3	57599177	.	C	T	6	4	10	0	0	10	0	0
3	57604181	.	C	T	3	3	6	0	0	6	0	0
3	57608735	.	G	A	5	5	10	0	0	10	0	0
3	57608900	.	A	T	4	2	6	0	0	6	0	0
3	57608951	.	G	A	2	2	4	0	2	6	0	0
3	57614363	.	G	A	6	4	10	0	0	10	0	0
3	57634380	.	A	G	2	3	5	0	0	5	0	0
3	57634480	.	G	A	4	8	12	0	0	12	0	0
3	57646269	.	A	G	6	7	13	0	0	13	0	0
3	57646437	.	C	T	0	8	8	0	2	10	0	0
3	57649281	.	G	T	2	2	4	0	0	4	0	0
3	57654123	.	A	G	3	5	8	0	0	8	0	0
3	57666435	.	C	A	2	2	4	0	0	4	0	0
3	57742154	.	G	A	5	3	8	0	0	8	0	0
3	57742220	.	G	A	10	5	15	0	0	15	0	0
3	57742262	.	C	G	9	14	23	0	0	23	0	0
3	57742532	.	T	G	1	7	8	0	0	8	0	0
3	57742805	.	G	A	1	2	3	0	0	3	0	0
3	57747977	.	C	T	4	4	8	0	0	8	0	0
3	57748026	.	G	A	4	5	9	0	0	9	0	0
3	57748044	.	A	G	4	4	8	0	0	8	0	0
3	57748246	.	C	T	7	6	13	0	0	13	0	0
3	57748342	.	T	A	7	9	16	0	0	16	0	0
3	57748437	.	A	G	5	7	12	0	1	13	0	0
3	57748449	.	G	A	6	5	11	0	0	11	0	0
3	57748494	.	T	C	5	6	11	0	1	12	0	0
3	57748581	.	C	G	1	6	7	0	7	14	0	0
3	57751835	.	G	A	12	7	19	0	0	19	0	0
3	57754460	.	C	T	9	4	13	0	2	15	0	0
3	57767152	.	G	T	3	3	6	0	0	6	0	0
3	57767327	.	C	G	3	3	6	0	0	6	0	0
3	57767998	.	C	G	1	4	5	0	0	5	0	0
3	57768802	.	T	C	0	4	4	0	0	4	0	0
3	57768835	.	T	C	2	1	3	0	0	3	0	0
3	57829926	.	T	A	1	5	6	0	0	6	0	0
3	58002477	.	T	G	4	3	7	0	0	7	0	0
3	58004532	.	C	T	3	3	6	0	1	7	0	0
3	58137414	.	T	C	5	2	7	1	0	8	0	0
3	58137540	.	C	T	2	4	6	0	0	6	0	0
3	58139655	.	C	T	2	4	6	0	1	7	0	0
3	58140344	.	G	A	3	3	6	0	2	8	0	0
3	58147315	.	C	G	1	4	5	0	0	5	0	0
3	58147479	.	C	A	5	2	7	0	1	8	0	0
3	58148643	.	G	A	9	3	12	0	0	12	0	0
3	58149114	.	C	A	2	10	12	0	0	12	0	0
3	58149192	.	T	C	5	2	7	0	0	7	0	0
3	58149204	.	G	A	4	3	7	0	0	7	0	0
3	58153632	.	C	T	3	6	9	1	1	11	0	0
3	58153889	.	T	A	13	6	19	0	0	19	0	0
3	58153994	.	A	G	2	0	2	0	7	9	0	0
3	58158709	.	T	C	2	4	6	1	0	7	0	0
3	58158712	.	T	C	3	3	6	1	0	7	0	0
3	58171761	.	C	T	11	10	21	0	1	22	0	0
3	58172028	.	T	C	9	15	24	0	1	25	0	0
3	58174380	.	C	T	10	11	21	0	1	22	0	0
3	58175761	.	G	C	12	11	23	0	2	25	0	0
3	58178032	.	G	A	5	10	15	0	16	31	0	0
3	58180664	.	G	A	15	15	30	0	1	31	0	0
3	58180695	.	C	T	27	11	38	0	0	38	0	0
3	58197600	.	A	G	1	5	6	7	0	13	0	0
3	58197950	.	G	A	12	3	15	2	0	17	0	0
3	58197952	.	A	T	11	3	14	2	0	16	0	0
3	58202022	.	T	G	2	2	4	1	0	5	0	0
3	58475460	.	T	C	1	3	4	0	0	4	0	0
3	58565662	.	T	G	3	2	5	3	0	8	0	0
3	58581212	.	C	G	1	2	3	0	0	3	0	0
3	58608283	.	C	G	2	8	10	7	1	18	0	0
3	58608291	.	T	G	6	3	9	7	1	17	0	0
3	58608335	.	G	A	1	5	6	13	2	21	0	0
3	58610881	.	A	G	3	2	5	4	2	11	0	0
3	58610890	.	G	A	3	2	5	4	1	10	0	0
3	58615428	.	T	G	3	4	7	6	0	13	0	0
3	58704640	.	T	C	3	4	7	0	0	7	0	0
3	58704655	.	C	A	2	3	5	0	0	6	1	0
3	58710350	.	T	C	2	18	20	5	0	25	0	0
3	58710351	.	T	A	19	2	21	5	0	26	0	0
3	60223424	.	G	A	0	2	2	0	2	4	0	0
3	60294079	.	A	G	1	5	6	8	0	14	0	0
3	60294089	.	C	G	1	5	6	9	0	15	0	0
3	60342876	.	T	G	2	3	5	0	0	5	0	0
3	60594703	.	G	A	1	6	7	0	0	7	0	0
3	60595650	.	T	C	8	3	11	0	1	12	0	0
3	60596020	.	G	A	8	4	12	0	0	12	0	0
3	61178685	.	G	A	15	5	20	0	1	21	0	0
3	61194020	.	A	G	3	3	6	0	1	7	0	0
3	61244015	.	C	T	2	2	4	0	0	4	0	0
3	61276907	.	C	T	4	3	7	0	0	7	0	0
3	61277028	.	C	G	7	9	16	0	1	17	0	0
3	61278677	.	A	G	5	2	7	0	0	7	0	0
3	61278692	.	C	T	4	4	8	0	0	8	0	0
3	61278992	.	C	T	4	3	7	0	0	7	0	0
3	61279427	.	A	C	6	4	10	0	0	10	0	0
3	61279585	.	G	A	0	4	4	0	9	13	0	0
3	61279643	.	T	C	11	7	18	0	0	18	0	0
3	61280055	.	G	A	8	6	14	0	1	15	0	0
3	61280117	.	T	C	4	5	9	0	1	10	0	0
3	61280343	.	G	C	7	8	15	0	0	15	0	0
3	61280350	.	C	G	6	8	14	0	1	15	0	0
3	61280381	.	T	A	11	6	17	0	1	18	0	0
3	61280579	.	T	G	8	0	8	0	10	18	0	0
3	61281051	.	A	G	11	6	17	0	1	18	0	0
3	61281681	.	G	A	1	7	8	0	9	17	0	0
3	61285787	.	C	T	11	7	18	0	1	19	0	0
3	61286009	.	A	C	6	8	14	0	1	15	0	0
3	61286062	.	T	A	6	12	18	0	0	18	0	0
3	61286081	.	C	A	8	8	16	0	1	17	0	0
3	61286325	.	C	G	9	0	9	0	8	17	0	0
3	61286468	.	C	T	7	5	12	0	0	12	0	0
3	61286528	.	A	T	4	8	12	0	1	13	0	0
3	61286687	.	T	A	7	9	16	0	0	16	0	0
3	61286889	.	T	C	11	10	21	0	0	21	0	0
3	61287282	.	T	G	8	1	9	0	12	21	0	0
3	61287491	.	T	A	18	5	23	0	1	24	0	0
3	61287590	.	G	T	18	12	30	0	0	30	0	0
3	61287627	.	C	G	14	13	27	0	1	28	0	0
3	61287893	.	T	G	13	0	13	0	16	29	0	0
3	61288028	.	T	C	15	17	32	0	2	34	0	0
3	61288105	.	C	A	20	17	37	0	2	39	0	0
3	61288238	.	A	C	13	15	28	0	1	29	0	0
3	61288469	.	T	G	17	2	19	0	25	44	0	0
3	61288639	.	C	G	2	3	5	0	0	5	0	0
3	61292963	.	C	A	3	6	9	0	0	9	0	0
3	61297154	.	C	T	3	2	5	0	0	5	0	0
3	61302038	.	T	C	3	0	3	0	2	5	0	0
3	61306994	.	C	T	6	5	11	0	0	11	0	0
3	61331755	.	A	G	1	2	3	0	0	3	0	0
3	61334171	.	C	T	0	2	2	0	1	3	0	0
3	61342120	.	G	A	4	3	7	0	0	7	0	0
3	61342225	.	G	A	7	5	12	0	0	12	0	0
3	61342368	.	T	C	4	6	10	0	0	10	0	0
3	61342387	.	G	A	5	7	12	0	0	12	0	0
3	61342408	.	G	A	6	3	9	0	0	9	0	0
3	61342423	.	G	C	4	6	10	0	0	10	0	0
3	61342708	.	T	A	6	5	11	0	1	12	0	0
3	61342747	.	C	T	1	4	5	0	8	13	0	0
3	61342770	.	G	A	3	12	15	0	1	16	0	0
3	61343076	.	C	T	2	8	10	0	1	11	0	0
3	61343224	.	C	T	2	5	7	0	1	8	0	0
3	61343339	.	A	T	2	5	7	0	1	8	0	0
3	61343390	.	A	C	2	0	2	0	5	7	0	0
3	61343589	.	T	C	5	4	9	0	0	9	0	0
3	61349602	.	G	A	9	4	13	0	0	13	0	0
3	61349654	.	C	T	3	4	7	0	2	9	0	0
3	61349887	.	A	T	10	8	18	0	1	19	0	0
3	61349931	.	G	T	9	12	21	0	0	21	0	0
3	61350156	.	A	G	2	2	4	0	1	5	0	0
3	61350259	.	T	A	3	3	6	0	0	6	0	0
3	61350529	.	T	A	1	7	8	0	0	8	0	0
3	61350673	.	T	G	2	5	7	0	0	7	0	0
3	61350700	.	C	T	4	4	8	0	0	8	0	0
3	61350787	.	A	T	5	5	10	0	0	10	0	0
3	61350788	.	T	G	5	5	10	0	0	10	0	0
3	61350971	.	C	T	3	2	5	0	0	5	0	0
3	61351007	.	A	G	2	4	6	0	0	6	0	0
3	61351640	.	G	T	2	2	4	0	0	4	0	0
3	61351905	.	C	T	1	4	5	0	2	7	0	0
3	61351910	.	T	A	1	4	5	0	0	5	0	0
3	61359266	.	G	T	1	3	4	2	0	6	0	0
3	61361306	.	T	C	1	3	4	0	0	4	0	0
3	61361409	.	G	A	5	4	9	0	0	9	0	0
3	61372060	.	T	G	2	2	4	1	0	5	0	0
3	61382289	.	C	T	4	2	6	0	0	6	0	0
3	61383062	.	A	T	2	2	4	4	1	9	0	0
3	61383072	.	C	T	0	4	4	4	2	10	0	0
3	61383666	.	T	C	4	2	6	0	0	6	0	0
3	61385095	.	C	T	2	3	5	0	1	6	0	0
3	61387263	.	C	A	3	3	6	0	0	6	0	0
3	61391953	.	C	A	9	5	14	0	2	16	0	0
3	61392048	.	A	G	5	0	5	0	8	13	0	0
3	61395181	.	C	T	11	3	14	0	1	15	0	0
3	61395211	.	G	A	1	3	4	0	9	13	0	0
3	61396868	.	A	T	1	6	7	0	0	7	0	0
3	61396891	.	C	A	2	6	8	0	1	9	0	0
3	61396911	.	C	T	4	5	9	0	0	9	0	0
3	61397037	.	T	A	10	3	13	0	1	14	0	0
3	61397093	.	C	T	5	12	17	0	1	18	0	0
3	61397141	.	G	T	11	9	20	0	0	20	0	0
3	61397231	.	C	A	6	10	16	0	0	16	0	0
3	61397248	.	A	G	10	0	10	0	8	18	0	0
3	61398272	.	A	T	3	5	8	0	1	9	0	0
3	61398505	.	C	G	4	9	13	1	0	14	0	0
3	61398610	.	T	A	13	6	19	0	2	21	0	0
3	61398612	.	C	T	13	6	19	0	2	21	0	0
3	61398728	.	A	G	14	5	19	0	0	19	0	0
3	61398835	.	G	A	7	10	17	0	1	18	0	0
3	61398839	.	T	C	7	9	16	0	0	16	0	0
3	61533099	.	T	C	1	4	5	0	1	6	0	0
3	61540804	.	C	G	1	0	1	0	1	4	2	0
3	61540821	.	A	G	1	0	1	0	2	3	0	0
3	61542663	.	G	A	1	2	3	0	0	3	0	0
3	61542854	.	G	T	1	3	4	0	0	4	0	0
3	61542889	.	C	A	2	5	7	0	0	7	0	0
3	61542910	.	C	T	2	3	5	0	0	5	0	0
3	61543429	.	A	G	1	2	3	1	0	4	0	0
3	61566380	.	T	C	3	0	3	0	3	6	0	0
3	61566559	.	G	A	2	3	5	0	0	5	0	0
3	62035861	.	C	T	1	2	3	0	0	3	0	0
3	62036047	.	G	A	1	2	3	0	4	7	0	0
3	62036320	.	A	G	2	2	4	0	0	4	0	0
3	62036323	.	A	G	2	3	5	0	0	5	0	0
3	62036570	.	G	A	3	4	7	0	1	8	0	0
3	62037105	.	T	C	3	8	11	1	0	12	0	0
3	62037343	.	G	C	1	4	5	0	1	6	0	0
3	62037430	.	A	G	3	1	4	0	8	12	0	0
3	62037716	.	G	A	5	6	11	0	0	11	0	0
3	62038526	.	T	C	8	9	17	0	1	18	0	0
3	62038739	.	G	C	9	9	18	0	0	18	0	0
3	62038993	.	G	A	2	13	15	0	15	30	0	0
3	62039278	.	A	G	8	0	8	0	15	23	0	0
3	62039657	.	G	A	1	5	6	0	18	24	0	0
3	62039689	.	C	A	13	10	23	0	0	23	0	0
3	62039718	.	G	A	10	15	25	0	0	25	0	0
3	62039813	.	T	A	9	11	20	0	1	21	0	0
3	62040555	.	G	A	19	21	40	0	1	41	0	0
3	62051107	.	C	T	14	6	20	0	5	25	0	0
3	62051125	.	C	T	15	5	20	0	0	20	0	0
3	62051395	.	A	G	10	7	17	0	1	18	0	0
3	62051660	.	T	A	16	10	26	0	0	26	0	0
3	62068902	.	C	T	0	2	2	0	4	6	0	0
3	62069815	.	G	A	6	5	11	0	0	11	0	0
3	62069821	.	G	A	4	4	8	0	2	10	0	0
3	62070890	.	G	A	6	3	9	0	2	11	0	0
3	62073967	.	T	A	4	7	11	0	0	11	0	0
3	62074030	.	T	C	5	3	8	0	1	9	0	0
3	62080117	.	G	C	4	4	8	0	0	8	0	0
3	62091398	.	A	G	1	5	6	0	0	6	0	0
3	62091632	.	T	A	7	11	18	0	1	19	0	0
3	62091660	.	T	A	7	11	18	0	0	18	0	0
3	62091880	.	C	T	9	9	18	0	2	20	0	0
3	62091975	.	C	A	16	14	30	0	1	31	0	0
3	62091995	.	G	T	17	11	28	0	0	28	0	0
3	62092025	.	C	T	0	10	10	0	13	23	0	0
3	62092262	.	T	A	10	8	18	0	0	18	0	0
3	62092279	.	A	T	9	7	16	0	0	16	0	0
3	62092666	.	G	A	10	6	16	0	0	16	0	0
3	62092715	.	A	C	12	11	23	0	2	25	0	0
3	62092749	.	G	C	9	9	18	0	2	20	0	0
3	62092801	.	C	T	12	5	17	0	1	18	0	0
3	62092902	.	A	T	9	5	14	0	0	14	0	0
3	62093241	.	T	A	13	11	24	0	0	24	0	0
3	62093567	.	A	C	2	3	5	0	1	6	0	0
3	62094327	.	C	T	9	2	11	0	2	13	0	0
3	62094645	.	A	G	3	5	8	0	3	11	0	0
3	62094686	.	C	A	0	3	3	0	8	11	0	0
3	62094849	.	A	G	3	7	10	0	1	11	0	0
3	62095051	.	G	A	1	7	8	0	0	8	0	0
3	62095175	.	T	A	4	9	13	0	0	13	0	0
3	62095827	.	G	C	3	3	6	0	0	6	0	0
3	62095887	.	T	C	3	0	3	0	3	6	0	0
3	62095940	.	G	C	1	2	3	0	0	3	0	0
3	62095980	.	A	C	2	3	5	0	0	5	0	0
3	62096021	.	G	A	2	3	5	0	0	5	0	0
3	62096131	.	T	C	2	2	4	0	0	4	0	0
3	62096399	.	A	C	1	2	3	0	0	3	0	0
3	62096912	.	A	G	1	4	5	0	0	5	0	0
3	62097272	.	T	C	2	2	4	0	0	4	0	0
3	62097490	.	A	T	2	1	3	0	2	5	0	0
3	62097548	.	A	T	3	5	8	0	0	8	0	0
3	62114663	.	C	T	2	5	7	0	0	7	0	0
3	62117154	.	C	T	0	4	4	0	5	9	0	0
3	62117187	.	C	T	2	4	6	0	0	6	0	0
3	62137708	.	C	T	11	5	16	0	1	17	0	0
3	62138746	.	A	G	6	4	10	0	1	11	0	0
3	62147737	.	G	A	5	2	7	0	0	7	0	0
3	62149774	.	C	T	5	4	9	0	0	9	0	0
3	62173443	.	A	T	6	3	9	0	0	9	0	0
3	62173459	.	C	T	5	5	10	0	0	10	0	0
3	62173503	.	G	T	5	9	14	0	0	14	0	0
3	62173546	.	C	T	6	10	16	0	0	16	0	0
3	62173593	.	T	C	4	4	8	0	1	9	0	0
3	62173628	.	T	C	10	3	13	0	0	13	0	0
3	62176426	.	T	C	3	0	3	0	2	5	0	0
3	62180788	.	G	A	7	4	11	0	0	11	0	0
3	62196977	.	C	T	5	7	12	0	0	12	0	0
3	62203509	.	G	A	7	5	12	0	0	12	0	0
3	62205906	.	C	A	4	2	6	0	1	7	0	0
3	62208678	.	C	T	1	2	3	0	0	3	0	0
3	62209183	.	A	G	6	0	6	0	4	10	0	0
3	62209216	.	A	G	5	7	12	0	0	12	0	0
3	62238692	.	G	A	2	2	4	0	0	4	0	0
3	62238721	.	C	T	5	2	7	0	0	7	0	0
3	62240972	.	G	T	1	4	5	1	0	6	0	0
3	62240973	.	C	T	1	4	5	1	0	6	0	0
3	62275115	.	A	T	1	3	4	0	0	4	0	0
3	62275507	.	T	A	2	3	5	0	0	5	0	0
3	62275743	.	T	C	2	2	4	0	1	5	0	0
3	62275855	.	G	C	1	5	6	1	0	7	0	0
3	62276101	.	G	A	2	5	7	0	0	7	0	0
3	62276104	.	A	G	1	5	6	0	1	7	0	0
3	62323384	.	G	A	4	4	8	0	1	9	0	0
3	62323648	.	G	A	6	3	9	0	0	9	0	0
3	62323771	.	C	T	2	3	5	1	0	6	0	0
3	62323789	.	C	T	4	3	7	1	0	8	0	0
3	62324030	.	C	T	4	2	6	0	0	6	0	0
3	62324118	.	G	A	2	7	9	0	0	9	0	0
3	62324282	.	A	C	2	2	4	0	0	4	0	0
3	62324312	.	T	C	1	1	2	0	1	3	0	0
3	62324421	.	G	C	2	3	5	0	1	6	0	0
3	62324427	.	T	C	3	3	6	0	0	6	0	0
3	62328846	.	G	C	5	3	8	1	0	9	0	0
3	62328970	.	A	G	4	2	6	1	0	7	0	0
3	62329097	.	G	C	8	4	12	0	1	13	0	0
3	62329199	.	A	G	8	0	8	0	4	12	0	0
3	62329373	.	A	T	4	4	8	1	0	9	0	0
3	62329545	.	G	T	3	6	9	0	0	9	0	0
3	62345471	.	A	T	1	4	5	0	0	5	0	0
3	62345588	.	T	A	5	5	10	0	0	10	0	0
3	62345686	.	T	A	4	8	12	2	1	15	0	0
3	62345708	.	G	A	8	7	15	2	0	17	0	0
3	62345770	.	A	T	4	6	10	0	0	10	0	0
3	62353679	.	G	T	2	1	3	0	1	4	0	0
3	62353952	.	G	A	7	2	9	0	1	10	0	0
3	62359440	.	G	T	8	19	27	0	0	27	0	0
3	62360484	.	C	T	14	19	33	0	3	36	0	0
3	62360686	.	G	A	2	5	7	0	0	7	0	0
3	62360736	.	C	A	5	3	8	0	0	8	0	0
3	62369864	.	G	A	15	7	22	0	0	23	1	0
3	62370381	.	A	G	7	9	16	0	0	16	0	0
3	62370476	.	G	A	4	5	9	0	1	10	0	0
3	62379739	.	C	T	7	2	9	0	0	9	0	0
3	62382863	.	A	G	51	23	74	1	2	77	0	0
3	62383314	.	T	G	54	12	66	0	1	67	0	0
3	62383315	.	G	T	54	11	65	0	2	67	0	0
3	62383438	.	G	A	30	29	59	0	3	62	0	0
3	62383439	.	A	G	31	29	60	0	1	61	0	0
3	62383565	.	T	A	22	24	46	0	4	50	0	0
3	62383589	.	A	C	20	26	46	1	2	49	0	0
3	62383610	.	G	C	25	2	27	1	24	52	0	0
3	62383706	.	C	T	41	20	61	2	2	65	0	0
3	62383992	.	C	G	9	14	23	3	2	28	0	0
3	62384055	.	G	A	12	10	22	4	2	28	0	0
3	62384208	.	C	T	4	46	50	0	13	63	0	0
3	62384219	.	G	A	44	11	55	0	4	59	0	0
3	62384423	.	C	G	32	40	72	0	1	73	0	0
3	62384428	.	T	A	39	28	67	0	4	71	0	0
3	62384565	.	C	G	34	22	56	1	5	62	0	0
3	62386420	.	T	C	31	0	31	0	22	53	0	0
3	62386955	.	G	T	28	20	48	0	2	50	0	0
3	62387141	.	C	T	4	18	22	0	20	42	0	0
3	62387144	.	C	T	18	21	39	0	0	39	0	0
3	62389681	.	A	C	1	4	5	0	0	5	0	0
3	62390349	.	A	G	26	17	43	0	1	44	0	0
3	62393297	.	T	C	11	5	16	0	3	19	0	0
3	62393321	.	G	A	16	8	24	0	0	24	0	0
3	62393337	.	C	T	21	9	30	0	1	31	0	0
3	62399218	.	C	T	0	3	3	0	1	4	0	0
3	62399310	.	T	C	3	2	5	0	0	5	0	0
3	62399314	.	A	C	4	2	6	0	0	6	0	0
3	62433064	.	C	T	13	6	19	0	1	20	0	0
3	62433138	.	T	G	4	10	14	0	1	15	0	0
3	62521137	.	G	A	4	5	9	0	0	9	0	0
3	62521142	.	T	C	5	0	5	0	5	10	0	0
3	62521263	.	T	A	13	12	25	0	1	26	0	0
3	62521956	.	G	A	16	6	22	0	1	23	0	0
3	62522063	.	A	T	14	12	26	0	0	26	0	0
3	62522065	.	G	T	13	12	25	0	0	25	0	0
3	62522238	.	A	G	7	8	15	0	0	15	0	0
3	62522347	.	T	G	2	3	5	0	0	5	0	0
3	62522648	.	C	A	5	2	7	0	0	7	0	0
3	62522742	.	C	A	3	5	8	0	0	8	0	0
3	62522750	.	G	C	5	3	8	0	0	8	0	0
3	62522804	.	C	T	0	3	3	0	6	9	0	0
3	62522808	.	C	T	1	4	5	0	4	9	0	0
3	62522899	.	C	G	13	7	20	0	1	21	0	0
3	62523031	.	A	G	4	11	15	3	1	19	0	0
3	62523032	.	A	T	12	4	16	3	0	19	0	0
3	62523325	.	G	T	10	5	15	0	3	18	0	0
3	62523502	.	G	A	7	3	10	0	0	10	0	0
3	62523550	.	C	T	4	3	7	0	0	7	0	0
3	62527379	.	G	T	4	7	11	0	1	12	0	0
3	62527397	.	G	T	7	2	9	0	2	11	0	0
3	62527533	.	C	A	4	2	6	0	0	6	0	0
4	316946	.	A	T	16	17	33	0	3	36	0	0
4	317091	.	A	G	11	27	38	0	4	42	0	0
4	317217	.	T	A	13	15	28	0	2	30	0	0
4	317275	.	G	T	8	10	18	0	1	19	0	0
4	317938	.	G	A	5	5	10	0	1	11	0	0
4	325126	.	G	A	6	5	11	0	1	12	0	0
4	325136	.	G	A	8	5	13	0	1	14	0	0
4	325161	.	A	C	10	0	10	0	5	15	0	0
4	329743	.	G	A	14	14	28	0	0	28	0	0
4	329746	.	A	G	13	13	26	0	0	26	0	0
4	332491	.	G	T	0	2	2	0	1	3	0	0
4	349490	.	A	C	3	5	8	0	0	8	0	0
4	349514	.	T	C	4	3	7	0	1	8	0	0
4	350652	.	C	T	3	4	7	0	0	7	0	0
4	350832	.	G	A	3	6	9	0	0	9	0	0
4	351654	.	T	A	1	3	4	0	0	4	0	0
4	351840	.	G	C	3	3	6	0	0	6	0	0
4	351845	.	A	C	1	3	4	0	2	6	0	0
4	352031	.	C	G	1	5	6	0	0	6	0	0
4	352284	.	A	G	7	0	7	0	5	12	0	0
4	352289	.	T	C	7	5	12	0	1	13	0	0
4	352504	.	T	C	8	9	17	0	1	18	0	0
4	353049	.	A	T	7	8	15	0	1	16	0	0
4	353064	.	C	G	4	8	12	0	3	15	0	0
4	353238	.	T	G	5	0	5	0	9	14	0	0
4	353247	.	T	C	6	8	14	0	0	14	0	0
4	353379	.	A	T	5	10	15	0	0	15	0	0
4	353481	.	A	G	8	0	8	0	6	14	0	0
4	353638	.	C	T	5	6	11	0	0	11	0	0
4	357887	.	T	G	4	3	7	0	1	8	0	0
4	357954	.	G	A	1	3	4	0	0	4	0	0
4	358080	.	T	C	2	1	3	0	1	4	0	0
4	362282	.	C	T	4	4	8	0	0	8	0	0
4	367532	.	T	G	3	0	3	0	3	6	0	0
4	385092	.	C	T	21	9	30	0	3	33	0	0
4	385576	.	T	A	1	3	4	0	0	4	0	0
4	385625	.	A	T	2	3	5	1	1	7	0	0
4	385668	.	G	A	9	8	17	0	1	18	0	0
4	385710	.	T	C	15	12	27	0	0	27	0	0
4	386085	.	G	A	16	8	24	0	0	24	0	0
4	386537	.	T	A	24	16	40	2	2	44	0	0
4	386538	.	T	A	28	16	44	2	2	48	0	0
4	386839	.	A	G	36	0	36	0	7	43	0	0
4	386947	.	A	G	47	10	57	4	7	68	0	0
4	394020	.	T	C	36	26	62	0	6	69	1	0
4	647752	.	G	T	4	6	10	0	1	11	0	0
4	659276	.	C	T	4	10	14	0	0	14	0	0
4	659345	.	T	C	2	5	7	0	0	7	0	0
4	660571	.	G	A	3	11	14	0	3	17	0	0
4	660649	.	T	A	9	9	18	0	0	18	0	0
4	660655	.	G	A	2	10	12	0	9	21	0	0
4	660715	.	T	C	13	14	27	0	1	28	0	0
4	667358	.	T	C	15	9	24	0	0	24	0	0
4	667382	.	A	G	13	0	13	0	7	20	0	0
4	674838	.	T	C	15	19	34	0	0	34	0	0
4	675080	.	T	C	4	10	14	0	2	16	0	0
4	676885	.	A	G	8	9	17	0	0	17	0	0
4	676942	.	A	G	9	11	20	0	2	22	0	0
4	678853	.	C	T	12	10	22	0	0	22	0	0
4	679441	.	C	G	2	17	19	0	16	35	0	0
4	680314	.	G	T	6	5	11	0	1	12	0	0
4	680320	.	C	T	6	5	11	0	1	12	0	0
4	680359	.	C	T	8	8	16	0	2	19	1	0
4	680395	.	T	C	13	1	14	0	10	24	0	0
4	680404	.	G	A	14	9	23	0	0	23	0	0
4	681595	.	G	A	10	3	13	0	1	14	0	0
4	686987	.	G	A	1	4	5	0	2	7	0	0
4	686999	.	C	G	3	4	7	0	0	7	0	0
4	687083	.	A	G	3	0	3	0	5	8	0	0
4	694680	.	A	C	3	7	10	0	0	10	0	0
4	694718	.	G	A	3	4	7	0	0	7	0	0
4	694741	.	T	G	3	5	8	0	0	8	0	0
4	694757	.	A	T	4	4	8	0	1	9	0	0
4	695219	.	T	C	5	7	12	0	4	16	0	0
4	700281	.	A	C	13	9	22	0	5	27	0	0
4	700284	.	G	T	1	7	8	0	18	26	0	0
4	700563	.	G	T	2	4	6	0	1	7	0	0
4	700569	.	G	A	0	3	3	0	2	5	0	0
4	700598	.	A	T	4	5	9	0	0	9	0	0
4	700606	.	T	C	4	2	6	0	1	7	0	0
4	700634	.	A	C	3	4	7	0	0	7	0	0
4	700665	.	G	T	1	3	4	0	0	4	0	0
4	701838	.	A	G	1	2	3	0	0	3	0	0
4	701848	.	A	G	1	2	3	0	0	3	0	0
4	702061	.	C	G	2	7	9	0	1	10	0	0
4	702130	.	G	A	2	11	13	0	2	15	0	0
4	702138	.	C	A	2	12	14	0	1	15	0	0
4	736442	.	A	G	8	13	21	0	1	22	0	0
4	737615	.	A	G	5	1	6	0	1	7	0	0
4	737636	.	A	T	12	5	17	0	0	17	0	0
4	737883	.	T	A	6	2	8	0	0	8	0	0
4	740921	.	T	C	10	7	17	0	0	17	0	0
4	740965	.	T	G	16	5	21	1	1	23	0	0
4	749803	.	G	A	16	15	31	0	1	32	0	0
4	749989	.	G	T	9	10	19	0	2	21	0	0
4	750016	.	T	C	3	0	3	0	16	19	0	0
4	750526	.	C	G	9	15	24	0	0	24	0	0
4	750531	.	C	T	10	11	21	0	3	24	0	0
4	750661	.	C	T	0	9	9	0	12	21	0	0
4	751275	.	A	G	10	7	17	0	1	18	0	0
4	751546	.	G	A	5	5	10	0	0	10	0	0
4	751553	.	C	T	4	4	8	0	1	9	0	0
4	751640	.	T	G	7	6	13	0	0	13	0	0
4	755539	.	C	T	7	6	13	0	0	13	0	0
4	757613	.	T	C	5	7	12	0	1	13	0	0
4	760555	.	G	T	3	3	6	0	0	6	0	0
4	765112	.	A	G	9	8	17	0	0	17	0	0
4	766575	.	G	A	8	5	13	0	2	15	0	0
4	766588	.	G	A	8	4	12	0	1	13	0	0
4	766613	.	A	C	7	3	10	0	0	10	0	0
4	769533	.	A	T	8	5	13	0	0	13	0	0
4	769726	.	G	A	8	7	15	1	1	17	0	0
4	772363	.	C	T	7	14	21	0	0	21	0	0
4	777976	.	A	G	7	5	12	0	0	12	0	0
4	778111	.	G	A	9	7	16	0	3	19	0	0
4	779310	.	G	A	7	7	14	0	2	16	0	0
4	779363	.	T	C	5	0	5	0	10	15	0	0
4	779429	.	A	G	9	6	15	0	0	15	0	0
4	779442	.	G	A	9	7	16	0	1	17	0	0
4	783816	.	G	T	14	20	34	0	3	37	0	0
4	783835	.	A	G	17	19	36	0	2	38	0	0
4	784002	.	T	A	36	16	52	0	1	53	0	0
4	784177	.	T	C	30	19	49	0	2	51	0	0
4	784325	.	A	T	13	15	28	0	2	30	0	0
4	784373	.	T	A	9	11	20	0	1	21	0	0
4	784435	.	G	T	3	6	9	0	0	9	0	0
4	784472	.	T	C	2	2	4	0	0	4	0	0
4	784473	.	A	C	2	2	4	0	0	4	0	0
4	784642	.	G	A	12	7	19	0	0	19	0	0
4	784733	.	T	A	3	6	9	0	1	10	0	0
4	784854	.	C	A	8	6	14	0	0	14	0	0
4	784990	.	T	A	15	13	28	0	5	33	0	0
4	785011	.	T	C	16	7	23	0	5	28	0	0
4	785132	.	G	A	23	16	39	0	1	40	0	0
4	788970	.	G	C	12	1	13	0	14	27	0	0
4	789589	.	A	G	14	18	32	0	2	34	0	0
4	798743	.	G	C	1	5	6	0	2	8	0	0
4	798804	.	G	A	12	14	26	0	3	29	0	0
4	798850	.	A	C	18	16	34	0	1	35	0	0
4	798861	.	G	T	19	17	36	0	1	37	0	0
4	799006	.	G	T	25	15	40	0	0	40	0	0
4	799090	.	T	C	13	13	26	0	1	27	0	0
4	799127	.	T	G	17	13	30	0	2	32	0	0
4	799245	.	G	A	14	15	29	0	0	29	0	0
4	799385	.	C	G	15	5	20	0	0	20	0	0
4	799475	.	A	G	12	14	26	0	0	26	0	0
4	799513	.	G	A	16	16	32	0	2	34	0	0
4	799620	.	C	T	27	12	39	0	1	40	0	0
4	799643	.	T	A	26	9	35	0	4	39	0	0
4	799933	.	C	T	22	14	36	0	1	37	0	0
4	800027	.	C	T	21	9	30	0	0	30	0	0
4	800094	.	A	G	17	14	31	0	2	33	0	0
4	800113	.	A	G	19	19	38	0	1	39	0	0
4	800363	.	C	T	4	21	25	0	21	46	0	0
4	800520	.	T	C	30	18	48	1	2	51	0	0
4	802909	.	T	A	23	24	47	0	2	49	0	0
4	803862	.	T	C	18	0	18	0	14	32	0	0
4	806319	.	G	A	10	15	25	0	1	26	0	0
4	806322	.	T	C	10	14	24	0	1	25	0	0
4	807895	.	C	G	12	15	27	0	5	32	0	0
4	807898	.	A	G	13	15	28	0	2	30	0	0
4	808031	.	C	T	12	3	15	0	0	15	0	0
4	808065	.	G	C	1	2	3	0	0	3	0	0
4	808421	.	A	G	8	16	24	0	0	24	0	0
4	809456	.	A	G	17	12	29	0	3	32	0	0
4	809512	.	T	C	12	0	12	0	18	30	0	0
4	809549	.	A	G	9	8	17	0	0	17	0	0
4	813157	.	G	A	6	8	14	0	1	15	0	0
4	813226	.	A	G	13	14	27	0	1	28	0	0
4	861856	.	T	A	4	4	8	0	1	9	0	0
4	862009	.	A	G	5	4	9	0	0	9	0	0
4	864324	.	T	A	12	4	16	0	2	18	0	0
4	864712	.	C	T	7	7	14	0	0	14	0	0
4	864739	.	G	C	10	7	17	0	0	17	0	0
4	867454	.	A	G	3	4	7	0	1	8	0	0
4	867601	.	G	C	5	7	12	0	1	13	0	0
4	870833	.	C	T	0	2	2	0	3	5	0	0
4	870876	.	C	T	4	2	6	0	0	6	0	0
4	872296	.	T	C	4	0	4	0	6	10	0	0
4	872356	.	A	G	8	2	10	0	0	10	0	0
4	873704	.	G	A	3	8	11	0	0	11	0	0
4	873763	.	C	G	6	6	12	0	1	13	0	0
4	874241	.	G	T	3	8	11	0	2	13	0	0
4	874323	.	C	T	3	6	9	0	0	9	0	0
4	875350	.	A	G	2	3	5	0	0	5	0	0
4	880033	.	A	G	6	6	12	0	0	12	0	0
4	880201	.	A	C	1	4	5	0	0	5	0	0
4	880275	.	A	G	2	3	5	0	1	6	0	0
4	880286	.	C	T	2	1	3	0	0	3	0	0
4	880394	.	A	G	1	2	3	0	0	3	0	0
4	880402	.	G	A	1	2	3	0	0	3	0	0
4	880692	.	T	G	1	2	3	0	0	3	0	0
4	880693	.	G	T	1	2	3	0	0	3	0	0
4	880747	.	C	T	1	2	3	0	1	4	0	0
4	881497	.	A	C	2	2	4	0	0	4	0	0
4	881677	.	G	T	4	2	6	0	0	6	0	0
4	882808	.	C	T	5	2	7	8	3	18	0	0
4	884021	.	A	C	1	2	3	0	0	3	0	0
4	905612	.	G	A	1	3	4	0	1	5	0	0
4	905657	.	A	G	1	5	6	0	0	6	0	0
4	905713	.	C	G	1	4	5	0	1	6	0	0
4	958978	.	A	T	4	2	6	0	0	6	0	0
4	959015	.	T	C	5	5	10	0	0	10	0	0
4	961542	.	G	A	4	7	11	0	0	11	0	0
4	963452	.	A	G	3	5	8	0	0	8	0	0
4	965124	.	C	G	1	2	3	0	2	5	0	0
4	967974	.	C	T	6	5	11	1	0	12	0	0
4	968001	.	G	A	0	5	5	1	5	11	0	0
4	968121	.	T	C	10	7	17	0	0	17	0	0
4	969475	.	A	T	8	5	13	0	2	15	0	0
4	969486	.	T	G	10	0	10	0	7	17	0	0
4	970689	.	A	G	3	0	3	0	8	11	0	0
4	971765	.	A	G	2	3	5	0	1	6	0	0
4	974482	.	C	T	12	5	17	1	2	20	0	0
4	975735	.	G	C	1	10	11	0	10	21	0	0
4	975758	.	C	T	11	9	20	0	0	20	0	0
4	975792	.	G	C	1	10	11	0	10	21	0	0
4	975938	.	T	C	11	9	20	0	0	20	0	0
4	982892	.	G	A	10	4	14	0	2	16	0	0
4	982893	.	T	C	4	9	13	0	1	14	0	0
4	982958	.	A	G	5	2	7	0	0	7	0	0
4	983105	.	G	A	0	2	2	0	6	8	0	0
4	986210	.	T	C	2	2	4	0	0	4	0	0
4	986350	.	C	A	0	2	2	0	6	8	0	0
4	1014659	.	A	G	2	2	4	0	0	4	0	0
4	1054775	.	G	A	11	10	21	0	2	23	0	0
4	1055008	.	C	T	43	9	52	0	1	53	0	0
4	1055149	.	A	G	24	7	31	0	0	31	0	0
4	1055200	.	A	G	11	8	19	1	2	22	0	0
4	1055724	.	C	T	30	23	53	0	1	54	0	0
4	1055770	.	A	G	32	14	46	0	2	48	0	0
4	1146384	.	T	C	3	2	5	0	0	5	0	0
4	1283989	.	G	A	1	3	4	0	0	4	0	0
4	1284013	.	C	A	2	3	5	0	0	5	0	0
4	1301582	.	G	A	8	11	19	0	1	20	0	0
4	1301848	.	G	A	2	3	5	0	0	5	0	0
4	1301866	.	A	T	3	4	7	0	2	9	0	0
4	1301921	.	T	C	2	0	2	0	5	7	0	0
4	1301954	.	C	T	2	3	5	0	0	5	0	0
4	1302059	.	T	C	16	0	16	1	5	22	0	0
4	1302155	.	A	G	5	6	11	0	0	11	0	0
4	1302198	.	G	A	7	4	11	0	3	14	0	0
4	1302219	.	G	T	5	2	7	0	6	13	0	0
4	1302385	.	G	A	6	8	14	0	1	15	0	0
4	1302401	.	G	A	6	7	13	0	0	13	0	0
4	1302437	.	A	G	8	7	15	0	1	16	0	0
4	1302485	.	T	C	4	1	5	0	12	17	0	0
4	1302488	.	T	C	5	0	5	0	13	18	0	0
4	1302556	.	T	A	9	2	11	0	2	13	0	0
4	1302584	.	A	G	2	4	6	0	0	6	0	0
4	1302609	.	A	G	1	5	6	0	0	6	0	0
4	1302624	.	A	G	2	6	8	0	0	8	0	0
4	1302785	.	C	T	0	9	9	0	3	12	0	0
4	1303044	.	C	T	3	2	5	0	0	5	0	0
4	1303097	.	A	G	2	2	4	0	0	4	0	0
4	1389106	.	C	T	19	11	30	0	2	32	0	0
4	1390851	.	T	C	13	0	13	0	12	25	0	0
4	1390926	.	C	T	9	11	20	0	1	21	0	0
4	1390932	.	T	C	9	9	18	0	1	19	0	0
4	1392957	.	G	A	13	4	17	0	1	18	0	0
4	1393032	.	T	A	9	4	13	0	0	13	0	0
4	1396176	.	C	T	7	8	15	0	0	15	0	0
4	1469788	.	T	C	7	6	13	0	0	13	0	0
4	1470000	.	C	T	8	2	10	0	0	10	0	0
4	1470380	.	C	A	18	13	31	0	0	31	0	0
4	1477538	.	A	G	5	9	14	0	1	15	0	0
4	1479855	.	C	A	9	3	12	0	0	12	0	0
4	1497159	.	G	A	9	3	12	0	0	12	0	0
4	1547354	.	G	A	0	2	2	0	2	4	0	0
4	1563583	.	A	G	1	0	1	0	2	3	0	0
4	1563938	.	T	A	3	3	6	0	0	6	0	0
4	1564041	.	T	C	1	2	3	0	0	3	0	0
4	1565587	.	G	A	9	3	12	1	0	13	0	0
4	1565832	.	G	A	5	2	7	0	0	7	0	0
4	1566427	.	C	A	10	5	15	0	0	15	0	0
4	1566501	.	T	C	3	5	8	0	0	8	0	0
4	1566502	.	T	G	3	0	3	0	5	8	0	0
4	1834169	.	C	G	2	4	6	0	0	6	0	0
4	1834190	.	G	A	3	3	6	0	0	6	0	0
4	1835801	.	C	T	3	2	5	0	0	5	0	0
4	1835950	.	G	T	1	1	2	0	1	3	0	0
4	1837647	.	A	T	5	3	8	0	0	8	0	0
4	1839142	.	T	C	2	3	5	0	0	5	0	0
4	1988778	.	T	A	3	2	5	0	3	8	0	0
4	1988856	.	T	C	2	0	2	1	4	7	0	0
4	1988988	.	A	C	1	0	1	0	5	6	0	0
4	1989071	.	G	A	2	3	5	0	0	5	0	0
4	1989101	.	T	C	2	0	2	0	2	4	0	0
4	1994560	.	A	T	2	2	4	0	0	4	0	0
4	2036617	.	C	A	0	2	2	0	2	4	0	0
4	2044213	.	A	G	12	9	21	0	0	21	0	0
4	2044222	.	T	C	8	0	8	0	12	20	0	0
4	2044359	.	A	C	18	14	32	0	3	35	0	0
4	2044379	.	T	A	22	17	39	0	1	40	0	0
4	2044409	.	A	G	19	25	44	0	3	47	0	0
4	2044517	.	A	G	14	23	37	0	2	39	0	0
4	2044541	.	T	C	18	1	19	0	23	42	0	0
4	2044944	.	T	A	7	3	10	0	1	11	0	0
4	2051223	.	C	G	0	5	5	0	4	9	0	0
4	2051259	.	C	T	0	2	2	0	3	5	0	0
4	2051355	.	G	A	4	6	10	0	0	10	0	0
4	2051447	.	A	G	2	7	9	0	0	9	0	0
4	2051929	.	T	G	34	18	52	0	6	58	0	0
4	2055019	.	G	A	8	19	27	0	4	31	0	0
4	2055318	.	G	A	21	11	32	0	3	35	0	0
4	2056055	.	A	C	11	0	11	0	14	25	0	0
4	2056607	.	G	A	14	10	24	0	1	25	0	0
4	2059765	.	C	A	9	15	24	0	0	24	0	0
4	2060125	.	T	C	10	5	15	0	5	20	0	0
4	2060134	.	C	T	9	10	19	0	2	21	0	0
4	2061214	.	G	A	17	13	30	0	2	32	0	0
4	2061217	.	G	A	17	14	31	0	1	32	0	0
4	2062085	.	A	G	8	13	21	0	1	22	0	0
4	2062088	.	G	A	8	14	22	0	0	22	0	0
4	2151664	.	T	A	10	9	19	0	0	19	0	0
4	2151743	.	G	A	8	3	11	0	1	12	0	0
4	2160995	.	G	A	5	13	18	0	0	18	0	0
4	2162639	.	G	A	6	7	13	0	0	13	0	0
4	2162726	.	C	G	1	8	9	0	14	23	0	0
4	2162798	.	G	A	15	10	25	0	1	26	0	0
4	2162804	.	A	G	17	9	26	0	1	27	0	0
4	2163383	.	T	C	3	0	3	0	5	8	0	0
4	2210437	.	T	G	8	13	21	0	2	23	0	0
4	2210459	.	C	T	7	10	17	0	1	18	0	0
4	2210499	.	T	C	9	1	10	0	6	16	0	0
4	2210517	.	C	T	11	11	22	0	0	22	0	0
4	2210553	.	A	G	10	14	24	0	0	24	0	0
4	2210583	.	A	G	5	14	19	0	2	21	0	0
4	2258723	.	T	C	1	2	3	0	0	3	0	0
4	2259067	.	G	A	3	3	6	0	1	7	0	0
4	2259071	.	T	C	3	0	3	0	4	7	0	0
4	2260515	.	T	C	3	0	3	0	6	9	0	0
4	2261176	.	A	G	3	6	9	0	0	9	0	0
4	2265201	.	G	A	5	5	10	0	0	10	0	0
4	2349386	.	G	A	7	5	12	0	0	12	0	0
4	2349391	.	C	T	5	5	10	0	1	11	0	0
4	2349527	.	A	G	8	5	13	0	0	13	0	0
4	2349542	.	A	T	6	6	12	0	3	15	0	0
4	2349576	.	A	C	7	9	16	0	0	16	0	0
4	2349656	.	T	C	1	4	5	0	1	6	0	0
4	2349713	.	C	T	5	3	8	1	0	9	0	0
4	2349798	.	G	A	8	10	18	1	0	19	0	0
4	2349805	.	G	T	9	9	18	1	1	20	0	0
4	2361733	.	G	A	27	17	44	0	2	46	0	0
4	2361835	.	T	C	29	0	29	0	24	53	0	0
4	2362945	.	C	A	3	22	25	0	31	56	0	0
4	2396616	.	C	T	8	5	13	0	1	14	0	0
4	2402861	.	G	A	2	3	5	0	0	5	0	0
4	2404872	.	A	G	2	2	4	0	0	4	0	0
4	2408432	.	G	A	1	2	3	0	1	4	0	0
4	2497044	.	T	C	5	7	12	0	0	12	0	0
4	2549154	.	T	C	1	3	4	0	0	4	0	0
4	2944894	.	A	G	1	6	7	0	0	7	0	0
4	3474629	.	A	G	4	2	6	0	1	7	0	0
4	4090438	.	C	T	3	2	5	0	0	5	0	0
4	4098479	.	T	A	16	5	21	0	1	22	0	0
4	4104264	.	A	G	9	0	9	0	17	26	0	0
4	4111070	.	A	G	10	9	19	0	0	19	0	0
4	4111180	.	C	T	3	7	10	0	1	11	0	0
4	4111229	.	A	T	3	8	11	0	0	11	0	0
4	4111396	.	T	C	5	13	18	0	0	18	0	0
4	4117174	.	A	C	4	6	10	0	0	10	0	0
4	4117330	.	A	T	1	2	3	0	0	3	0	0
4	4117480	.	T	C	2	2	4	0	0	4	0	0
4	4117730	.	T	C	1	0	1	0	4	5	0	0
4	4117876	.	G	A	2	4	6	0	1	7	0	0
4	4117893	.	C	T	0	5	5	0	3	8	0	0
4	4119344	.	G	A	1	3	4	0	0	4	0	0
4	4119368	.	G	A	1	3	4	0	0	5	1	0
4	4119406	.	T	C	1	2	3	0	1	4	0	0
4	4119407	.	G	T	1	2	3	0	1	4	0	0
4	4120825	.	C	T	3	5	8	0	1	9	0	0
4	4224460	.	C	T	2	3	5	1	0	6	0	0
4	4232886	.	C	G	3	0	3	0	2	5	0	0
4	4232994	.	T	C	3	4	7	0	0	7	0	0
4	4233088	.	T	C	1	2	3	0	0	3	0	0
4	4235162	.	A	G	25	12	37	0	3	40	0	0
4	4238175	.	C	T	0	18	18	0	13	31	0	0
4	4240177	.	T	C	19	25	44	0	3	47	0	0
4	4243084	.	G	A	12	29	41	0	0	41	0	0
4	4249690	.	G	A	6	12	18	0	1	19	0	0
4	4258884	.	A	G	5	10	15	0	0	15	0	0
4	4258927	.	T	C	6	14	20	0	0	20	0	0
4	4258951	.	C	T	10	13	23	0	0	23	0	0
4	4327793	.	C	T	1	2	3	0	0	3	0	0
4	4348785	.	C	T	3	3	6	0	0	6	0	0
4	4355714	.	C	T	7	9	16	0	0	16	0	0
4	4355791	.	G	T	0	7	7	0	5	12	0	0
4	4357073	.	A	G	9	13	22	0	1	23	0	0
4	4357173	.	C	T	10	6	16	0	0	16	0	0
4	4357175	.	G	A	11	5	16	0	0	16	0	0
4	4358411	.	T	A	5	11	16	0	0	16	0	0
4	4358420	.	C	T	11	7	18	0	0	18	0	0
4	4358471	.	C	T	10	5	15	0	1	16	0	0
4	4358536	.	A	G	11	4	15	0	1	16	0	0
4	4358561	.	A	G	8	6	14	0	1	15	0	0
4	4358580	.	A	G	3	10	13	0	1	14	0	0
4	4358610	.	C	A	10	9	19	0	1	20	0	0
4	4484788	.	A	G	20	6	26	0	2	28	0	0
4	4484914	.	T	A	11	16	27	0	1	28	0	0
4	4485186	.	A	T	23	21	44	1	5	50	0	0
4	4485247	.	A	T	23	21	44	1	1	46	0	0
4	4485306	.	T	C	15	16	31	1	6	38	0	0
4	4485534	.	C	A	8	17	25	0	2	27	0	0
4	4485650	.	A	T	14	6	20	0	1	21	0	0
4	4485736	.	T	G	14	7	21	0	0	21	0	0
4	4485793	.	C	G	11	7	18	0	0	18	0	0
4	4488137	.	A	G	9	10	19	0	2	21	0	0
4	4488207	.	G	A	13	5	18	0	0	18	0	0
4	4491740	.	T	C	9	0	9	0	9	18	0	0
4	4491782	.	T	C	3	1	4	0	16	20	0	0
4	4492003	.	C	T	9	7	16	0	1	17	0	0
4	4492336	.	A	G	5	10	15	0	1	16	0	0
4	4492369	.	C	A	0	12	12	0	3	15	0	0
4	4492444	.	A	G	8	6	14	0	2	16	0	0
4	4492456	.	T	C	8	0	8	0	10	18	0	0
4	4494733	.	C	A	7	5	12	0	1	13	0	0
4	4495334	.	G	A	8	7	15	0	0	15	0	0
4	4514215	.	A	G	6	0	6	0	4	10	0	0
4	4516310	.	G	C	1	9	10	0	14	24	0	0
4	4516313	.	A	G	12	0	12	0	12	24	0	0
4	4516346	.	C	T	13	11	24	0	1	25	0	0
4	4519688	.	G	A	16	18	34	0	1	35	0	0
4	4519697	.	T	C	17	18	35	0	2	37	0	0
4	4523403	.	C	G	21	19	40	0	3	43	0	0
4	4523579	.	T	C	14	36	50	0	4	54	0	0
4	4523885	.	A	C	12	13	25	0	1	26	0	0
4	4524215	.	T	A	5	5	10	0	0	10	0	0
4	4526251	.	G	A	4	3	7	0	1	8	0	0
4	4527870	.	C	T	0	4	4	0	1	5	0	0
4	4528554	.	A	G	1	2	3	0	1	4	0	0
4	4635691	.	C	G	15	10	25	0	1	26	0	0
4	4638701	.	G	C	13	0	13	0	13	26	0	0
4	4640605	.	G	A	18	13	31	0	0	31	0	0
4	4640614	.	G	A	15	13	28	0	1	29	0	0
4	4647977	.	A	G	12	17	29	0	0	29	0	0
4	4653380	.	A	C	19	0	19	0	9	28	0	0
4	4657961	.	G	A	13	17	30	0	1	31	0	0
4	4706687	.	G	T	10	13	23	0	2	25	0	0
4	4706819	.	C	T	0	9	9	0	9	18	0	0
4	4706825	.	C	G	9	10	19	0	1	20	0	0
4	4712685	.	A	T	2	3	5	0	0	5	0	0
4	4712951	.	G	A	4	4	8	0	0	8	0	0
4	4714109	.	C	A	3	3	6	0	1	7	0	0
4	4714338	.	A	T	1	2	3	0	0	3	0	0
4	4714358	.	C	T	1	2	3	0	0	3	0	0
4	4751738	.	T	C	2	2	4	0	0	4	0	0
4	4754474	.	A	G	7	7	14	0	0	14	0	0
4	4755605	.	G	T	7	4	11	2	0	13	0	0
4	4758291	.	C	A	3	3	6	0	0	6	0	0
4	4758452	.	T	C	4	0	4	0	2	6	0	0
4	4758458	.	A	G	6	2	8	0	0	8	0	0
4	4762804	.	T	A	5	3	8	0	2	10	0	0
4	4783059	.	A	T	5	7	12	0	0	12	0	0
4	4783067	.	C	T	5	7	12	0	0	12	0	0
4	4784802	.	G	A	7	7	14	0	0	14	0	0
4	4786350	.	A	G	7	5	12	0	0	12	0	0
4	4786383	.	G	A	3	5	8	0	0	8	0	0
4	4831630	.	T	G	7	4	11	0	0	11	0	0
4	4831660	.	G	A	2	4	6	0	1	7	0	0
4	4831722	.	A	C	7	3	10	0	0	10	0	0
4	4831885	.	A	C	7	3	10	0	0	10	0	0
4	4831898	.	T	C	3	5	8	0	0	8	0	0
4	4831968	.	A	C	4	7	11	0	0	11	0	0
4	4832241	.	A	G	11	9	20	0	0	20	0	0
4	4834125	.	G	A	11	14	25	0	1	26	0	0
4	4834497	.	A	G	20	8	28	0	0	28	0	0
4	4834526	.	T	C	17	5	22	0	0	22	0	0
4	4901602	.	C	T	7	5	12	0	1	13	0	0
4	4901611	.	T	G	5	1	6	0	8	14	0	0
4	4902137	.	A	C	5	5	10	0	1	11	0	0
4	4902425	.	G	C	8	5	13	0	1	14	0	0
4	4908409	.	C	T	3	5	8	0	1	9	0	0
4	4911071	.	C	T	8	10	18	0	0	18	0	0
4	4911247	.	A	G	9	10	19	0	2	21	0	0
4	4913422	.	C	T	13	9	22	0	0	22	0	0
4	4914832	.	A	G	11	7	18	0	0	18	0	0
4	4921733	.	T	C	20	17	37	0	1	38	0	0
4	4921773	.	G	A	1	18	19	0	10	29	0	0
4	4923290	.	A	T	18	6	24	0	0	24	0	0
4	4923323	.	C	T	15	22	37	0	0	37	0	0
4	4923755	.	T	G	18	18	36	0	1	37	0	0
4	4925611	.	C	T	21	20	41	0	1	42	0	0
4	4926035	.	G	A	6	8	14	0	0	14	0	0
4	4926037	.	G	T	9	5	14	0	1	15	0	0
4	4938978	.	C	T	6	2	8	4	0	12	0	0
4	4971354	.	C	A	7	3	10	0	0	10	0	0
4	4971703	.	C	A	4	3	7	0	1	8	0	0
4	4971911	.	G	T	9	8	17	1	1	19	0	0
4	4972056	.	C	T	10	6	16	0	0	16	0	0
4	4972533	.	G	A	10	14	24	0	2	26	0	0
4	4972555	.	G	C	9	11	20	0	1	21	0	0
4	4972664	.	G	T	14	5	19	0	0	19	0	0
4	4973053	.	G	A	6	8	14	0	0	14	0	0
4	4975329	.	C	G	6	7	13	0	0	13	0	0
4	4975597	.	G	A	5	3	8	0	0	8	0	0
4	4980443	.	G	A	3	5	8	0	1	9	0	0
4	4980458	.	C	T	0	4	4	0	5	9	0	0
4	4983209	.	T	C	1	5	6	0	0	6	0	0
4	4984298	.	G	A	2	5	7	0	1	8	0	0
4	4985789	.	G	A	4	2	6	0	0	6	0	0
4	5025964	.	G	C	16	15	31	5	2	38	0	0
4	5026355	.	T	C	23	14	37	0	4	41	0	0
4	5042689	.	T	A	18	11	29	0	1	30	0	0
4	5042755	.	C	T	14	17	31	0	2	33	0	0
4	5048903	.	C	T	10	10	20	0	1	21	0	0
4	5094237	.	C	T	4	5	9	0	0	9	0	0
4	5097421	.	C	T	0	4	4	0	5	9	0	0
4	5098152	.	G	A	3	6	9	0	0	9	0	0
4	5102316	.	A	C	3	0	3	0	4	7	0	0
4	5106051	.	A	G	2	2	4	0	0	4	0	0
4	5107389	.	G	A	2	2	4	0	2	6	0	0
4	5158749	.	C	T	10	9	19	0	1	20	0	0
4	5161241	.	G	T	7	6	13	0	1	14	0	0
4	5161256	.	A	C	10	5	15	0	1	16	0	0
4	5240203	.	A	C	22	1	23	0	25	48	0	0
4	5240265	.	C	T	28	17	45	4	2	51	0	0
4	5240472	.	T	A	23	33	56	0	4	60	0	0
4	5240505	.	A	G	25	30	55	0	3	58	0	0
4	5242055	.	T	G	22	27	49	0	1	50	0	0
4	5242300	.	C	G	34	36	70	1	1	72	0	0
4	5243657	.	C	A	39	30	69	0	2	71	0	0
4	5244568	.	C	A	30	29	59	0	2	61	0	0
4	5244789	.	G	A	31	25	56	0	1	57	0	0
4	5247107	.	G	A	25	29	54	0	0	54	0	0
4	5247127	.	G	C	27	28	55	0	0	55	0	0
4	5247145	.	C	T	2	33	35	0	24	59	0	0
4	5255128	.	C	A	21	8	29	1	1	31	0	0
4	5255148	.	C	T	12	18	30	1	4	35	0	0
4	5255180	.	T	C	19	17	36	0	1	37	0	0
4	5256482	.	A	G	12	12	24	0	2	26	0	0
4	5256659	.	A	G	5	1	6	0	11	17	0	0
4	5256674	.	G	T	11	3	14	0	1	15	0	0
4	5256737	.	A	G	3	5	8	0	1	9	0	0
4	5256788	.	G	A	1	3	4	0	1	5	0	0
4	5256844	.	A	T	3	3	6	0	0	6	0	0
4	5269608	.	G	A	40	19	59	0	2	61	0	0
4	5269660	.	C	G	25	41	66	0	1	67	0	0
4	5290944	.	G	A	19	20	39	0	2	41	0	0
4	5290947	.	C	T	18	18	36	0	4	40	0	0
4	5291755	.	T	C	23	14	37	0	1	38	0	0
4	5291794	.	T	C	21	15	36	0	1	37	0	0
4	5302127	.	C	T	1	15	16	0	14	30	0	0
4	5302195	.	A	G	17	11	28	0	1	29	0	0
4	5302689	.	G	A	5	7	12	0	2	14	0	0
4	5318995	.	G	A	14	11	25	0	4	29	0	0
4	5324871	.	G	T	9	14	23	0	1	24	0	0
4	5325105	.	C	T	13	12	25	0	0	25	0	0
4	5329849	.	G	A	6	6	12	0	1	13	0	0
4	5329850	.	G	A	6	7	13	0	0	13	0	0
4	5330192	.	C	A	12	7	19	0	1	20	0	0
4	5330341	.	C	T	10	8	18	0	2	20	0	0
4	5331720	.	G	A	7	3	10	0	1	11	0	0
4	5334029	.	G	C	3	5	8	0	0	8	0	0
4	5334061	.	G	A	10	7	17	0	1	18	0	0
4	5338909	.	T	A	8	7	15	1	0	20	4	0
4	5338950	.	G	T	9	14	23	1	1	25	0	0
4	5339053	.	T	A	7	20	27	0	1	28	0	0
4	5363744	.	A	C	2	4	6	0	0	6	0	0
4	5363760	.	A	T	4	4	8	0	0	8	0	0
4	5365399	.	G	A	2	8	10	0	1	11	0	0
4	5366080	.	A	G	2	2	4	0	0	4	0	0
4	5366765	.	G	A	3	3	6	0	1	7	0	0
4	5366789	.	G	A	3	3	6	0	0	6	0	0
4	5367493	.	C	T	0	2	2	0	1	3	0	0
4	5403149	.	A	G	1	2	3	0	0	3	0	0
4	5450518	.	C	G	5	3	8	0	0	9	1	0
4	5521510	.	C	T	15	9	24	0	0	24	0	0
4	5521996	.	G	T	19	11	30	0	0	30	0	0
4	5522154	.	G	T	9	14	23	0	0	23	0	0
4	5522161	.	C	T	13	9	22	0	1	23	0	0
4	5595171	.	C	T	10	3	13	0	0	13	0	0
4	5597604	.	C	A	3	3	6	0	0	6	0	0
4	5597772	.	T	C	1	4	5	0	0	5	0	0
4	5643321	.	G	A	13	19	32	0	0	32	0	0
4	5644808	.	G	A	23	19	42	0	1	43	0	0
4	5644974	.	G	A	10	10	20	0	1	21	0	0
4	5645116	.	T	G	1	4	5	0	0	5	0	0
4	5665612	.	T	C	5	0	5	0	6	11	0	0
4	5672765	.	G	A	1	2	3	0	0	3	0	0
4	5691208	.	C	A	0	2	2	0	1	3	0	0
4	5742551	.	G	A	16	7	23	0	0	23	0	0
4	5742831	.	A	C	15	17	32	0	1	33	0	0
4	5742846	.	C	T	19	12	31	0	1	32	0	0
4	5742936	.	G	A	0	15	15	0	14	29	0	0
4	5742962	.	A	T	10	16	26	0	0	26	0	0
4	5743027	.	A	G	12	10	22	0	2	24	0	0
4	5750854	.	G	A	10	7	17	0	1	18	0	0
4	5750884	.	T	A	6	12	18	0	0	18	0	0
4	5751381	.	A	C	8	14	22	0	0	22	0	0
4	5751382	.	C	T	0	14	14	0	8	22	0	0
4	5751551	.	G	A	13	8	21	0	2	23	0	0
4	5755018	.	C	T	1	14	15	0	13	28	0	0
4	5755027	.	C	T	1	12	13	0	14	27	0	0
4	5757253	.	C	T	9	12	21	0	1	22	0	0
4	5759617	.	T	G	14	6	20	0	1	21	0	0
4	5763975	.	G	A	15	6	21	1	0	22	0	0
4	5764128	.	T	A	11	11	22	2	0	24	0	0
4	5765985	.	C	A	2	2	4	0	2	6	0	0
4	5766156	.	C	T	0	5	5	0	5	10	0	0
4	5766200	.	T	A	3	4	7	0	0	7	0	0
4	5766315	.	G	A	9	2	11	0	2	13	0	0
4	5769036	.	T	C	3	4	7	0	0	7	0	0
4	5785840	.	C	T	3	2	5	0	0	5	0	0
4	5785875	.	A	G	4	2	6	0	0	6	0	0
4	5786267	.	G	T	1	3	4	0	1	5	0	0
4	5786961	.	T	C	3	1	4	0	2	6	0	0
4	5790426	.	G	A	1	2	3	0	0	3	0	0
4	5790438	.	C	A	1	3	4	0	0	4	0	0
4	5794167	.	C	T	0	4	4	0	1	5	0	0
4	5806111	.	G	A	2	4	6	0	0	6	0	0
4	5806252	.	T	A	2	3	5	0	0	5	0	0
4	5806274	.	T	A	3	2	5	0	0	5	0	0
4	5806303	.	C	T	3	2	5	0	0	5	0	0
4	5806312	.	C	A	2	3	5	0	0	5	0	0
4	5806810	.	T	A	1	2	3	0	0	3	0	0
4	5835612	.	C	T	5	2	7	0	0	7	0	0
4	5835688	.	T	G	3	4	7	0	0	7	0	0
4	5835733	.	G	A	6	6	12	0	1	13	0	0
4	5838505	.	G	A	6	2	8	0	0	8	0	0
4	5846054	.	T	A	1	2	3	0	0	3	0	0
4	5849003	.	C	A	5	17	22	0	0	22	0	0
4	5849180	.	A	G	5	0	5	0	11	16	0	0
4	5849225	.	G	A	4	8	12	0	1	13	0	0
4	5849368	.	A	G	6	3	9	0	0	9	0	0
4	5849373	.	C	T	6	3	9	0	0	9	0	0
4	5849408	.	A	G	3	3	6	0	0	6	0	0
4	5850281	.	T	C	11	10	21	0	0	21	0	0
4	5850297	.	A	G	12	12	24	0	0	24	0	0
4	5850800	.	C	T	2	2	4	0	0	4	0	0
4	5851019	.	G	A	2	3	5	0	1	6	0	0
4	5896187	.	C	T	2	2	4	0	0	4	0	0
4	5906358	.	T	C	3	2	5	0	0	5	0	0
4	5907100	.	C	T	7	5	12	0	1	13	0	0
4	5907145	.	C	T	9	7	16	0	1	17	0	0
4	5907465	.	G	T	2	4	6	0	6	12	0	0
4	5910137	.	A	G	2	5	7	0	0	7	0	0
4	5910302	.	C	T	8	5	13	0	0	13	0	0
4	5910644	.	G	A	25	27	52	0	2	54	0	0
4	5912445	.	C	T	22	8	30	0	3	33	0	0
4	5912475	.	G	A	12	21	33	0	0	33	0	0
4	5912707	.	A	G	15	15	30	0	1	31	0	0
4	6436701	.	G	A	17	15	32	0	1	33	0	0
4	6436845	.	G	A	21	11	32	0	0	32	0	0
4	6508193	.	A	G	3	3	6	0	0	6	0	0
4	6508320	.	G	A	0	3	3	0	4	7	0	0
4	6578234	.	G	A	1	2	3	0	0	3	0	0
4	6579603	.	A	G	2	3	5	0	0	5	0	0
4	6579625	.	T	C	3	2	5	0	0	5	0	0
4	6946608	.	C	T	2	3	5	0	0	5	0	0
4	6948909	.	C	T	3	2	5	0	0	5	0	0
4	6948918	.	C	A	2	2	4	0	1	5	0	0
4	6960377	.	C	T	3	7	10	0	0	10	0	0
4	6964074	.	A	G	4	2	6	0	1	7	0	0
4	6989731	.	G	A	0	10	10	0	6	16	0	0
4	6991438	.	A	C	3	2	5	0	0	5	0	0
4	6991442	.	G	T	0	4	4	0	0	4	0	0
4	6991480	.	T	G	5	4	9	0	0	9	0	0
4	6991582	.	C	A	9	8	17	0	1	18	0	0
4	6991825	.	C	A	8	8	16	0	0	16	0	0
4	6991975	.	T	A	9	8	17	0	1	18	0	0
4	6992348	.	C	A	20	19	39	0	1	40	0	0
4	6992744	.	C	T	8	8	16	0	3	19	0	0
4	6992808	.	T	C	15	10	25	0	2	28	1	0
4	7870444	.	A	T	4	3	7	0	1	8	0	0
4	7870599	.	T	C	5	4	9	0	1	10	0	0
4	7870624	.	T	C	4	2	6	0	0	6	0	0
4	7870913	.	T	G	7	4	11	0	2	13	0	0
4	7870952	.	C	T	0	4	4	0	8	12	0	0
4	7870983	.	C	T	7	4	11	0	0	11	0	0
4	7871084	.	A	C	3	8	11	0	0	11	0	0
4	7872229	.	A	G	4	5	9	0	0	9	0	0
4	7872637	.	G	A	6	3	9	0	1	10	0	0
4	7875702	.	A	T	2	6	8	0	0	8	0	0
4	7875901	.	T	G	3	1	4	0	1	5	0	0
4	7875917	.	A	T	3	2	5	0	0	5	0	0
4	7876796	.	C	A	3	4	7	0	1	8	0	0
4	7879522	.	A	G	11	0	11	0	8	19	0	0
4	7881534	.	C	G	8	1	9	0	6	15	0	0
4	7883462	.	A	C	2	10	12	0	0	12	0	0
4	7883466	.	G	A	3	8	11	0	0	11	0	0
4	7888181	.	A	C	4	3	7	0	0	7	0	0
4	8046099	.	C	T	15	7	22	0	1	23	0	0
4	8609608	.	T	A	1	8	9	0	1	10	0	0
4	8609648	.	G	A	7	9	16	0	0	16	0	0
4	8609799	.	T	C	9	12	21	0	2	23	0	0
4	8680965	.	C	T	11	3	14	0	0	14	0	0
4	8681039	.	C	T	3	6	9	0	0	9	0	0
4	8697245	.	C	T	3	3	6	0	1	7	0	0
4	8697269	.	A	G	3	3	6	0	0	6	0	0
4	8702687	.	G	A	8	5	13	0	0	13	0	0
4	8702765	.	C	T	5	11	16	0	1	17	0	0
4	8704655	.	C	T	4	6	10	0	0	10	0	0
4	8706385	.	G	A	5	11	16	0	0	16	0	0
4	8706716	.	A	G	13	6	19	0	0	19	0	0
4	8706855	.	A	T	5	3	8	0	0	8	0	0
4	8707154	.	C	T	11	8	19	0	1	20	0	0
4	8707182	.	T	C	6	8	14	0	0	14	0	0
4	8707381	.	A	G	2	2	4	0	0	4	0	0
4	8761205	.	C	T	0	2	2	0	2	4	0	0
4	8777050	.	T	G	2	3	5	0	0	5	0	0
4	8795038	.	C	G	1	2	3	0	1	4	0	0
4	8797201	.	T	A	23	15	38	0	0	38	0	0
4	8797234	.	T	A	22	16	38	0	5	43	0	0
4	8797315	.	T	C	14	22	36	0	0	36	0	0
4	8803071	.	C	T	17	14	31	0	3	34	0	0
4	8805792	.	T	C	32	25	57	0	2	59	0	0
4	8808775	.	C	T	43	30	73	0	4	77	0	0
4	8808823	.	C	T	32	28	60	0	4	64	0	0
4	8808974	.	C	T	19	21	40	0	4	44	0	0
4	8809268	.	T	G	28	18	46	0	1	47	0	0
4	8809431	.	T	G	6	13	19	1	1	21	0	0
4	8809506	.	A	T	14	18	32	0	1	33	0	0
4	8809544	.	C	G	23	1	24	0	20	44	0	0
4	8809690	.	G	T	0	15	15	0	3	18	0	0
4	8809695	.	C	T	0	24	24	0	0	24	0	0
4	8809772	.	T	A	3	11	14	1	0	15	0	0
4	8809879	.	T	G	6	3	9	0	0	9	0	0
4	8809985	.	G	T	13	7	20	0	0	20	0	0
4	8810200	.	G	T	10	15	25	0	1	26	0	0
4	8810367	.	A	C	22	24	46	0	2	48	0	0
4	8810474	.	A	T	23	20	43	0	0	43	0	0
4	8810597	.	A	T	25	13	38	0	1	39	0	0
4	8810607	.	C	T	22	14	36	0	2	38	0	0
4	8851503	.	T	A	17	10	27	0	1	28	0	0
4	8851547	.	A	G	12	19	31	0	4	35	0	0
4	8851740	.	G	A	9	11	20	0	0	20	0	0
4	8851864	.	G	A	12	6	18	0	1	19	0	0
4	8851999	.	C	T	21	6	27	0	1	28	0	0
4	8852085	.	G	T	14	8	22	0	0	22	0	0
4	8854403	.	G	T	10	24	34	0	1	35	0	0
4	8857562	.	T	G	12	7	19	0	0	19	0	0
4	8882297	.	G	T	8	16	24	0	0	24	0	0
4	8898917	.	C	T	0	6	6	0	10	16	0	0
4	8898939	.	G	A	9	7	16	0	0	16	0	0
4	8903051	.	T	A	6	5	11	0	1	12	0	0
4	9012215	.	T	G	5	0	5	0	8	13	0	0
4	9012218	.	T	C	5	8	13	0	0	13	0	0
4	9012258	.	A	T	5	5	10	0	0	10	0	0
4	9017996	.	C	T	9	4	13	0	0	13	0	0
4	9018107	.	A	G	9	0	9	0	10	19	0	0
4	9021166	.	T	G	7	9	16	0	3	19	0	0
4	9021369	.	T	C	8	11	19	0	2	21	0	0
4	9024665	.	T	G	8	10	18	0	2	20	0	0
4	9024671	.	A	G	8	11	19	0	2	21	0	0
4	9024720	.	A	C	19	13	32	0	0	32	0	0
4	9024784	.	A	G	18	11	29	0	0	29	0	0
4	9024807	.	A	G	16	7	23	0	6	29	0	0
4	9045012	.	T	C	3	3	6	0	0	6	0	0
4	9045979	.	C	T	3	2	5	0	0	5	0	0
4	9047365	.	C	T	3	3	6	0	1	7	0	0
4	9048957	.	G	T	3	3	6	0	0	6	0	0
4	9052184	.	A	G	1	3	4	0	0	4	0	0
4	9052192	.	T	A	1	3	4	0	0	4	0	0
4	9052254	.	A	C	4	1	5	0	0	5	0	0
4	9052282	.	C	T	7	3	10	0	1	11	0	0
4	9085337	.	A	G	1	0	1	0	4	5	0	0
4	9094270	.	G	T	4	3	7	0	2	9	0	0
4	9094347	.	G	A	2	2	4	0	0	4	0	0
4	9094666	.	T	G	5	7	12	0	0	12	0	0
4	9094668	.	T	A	5	5	10	0	2	12	0	0
4	9104510	.	T	C	4	0	4	0	7	11	0	0
4	9105199	.	T	C	2	0	2	0	4	6	0	0
4	9173425	.	A	G	6	4	10	0	0	10	0	0
4	9173514	.	T	C	1	2	3	0	0	3	0	0
4	9180680	.	G	A	5	9	14	0	2	16	0	0
4	9180746	.	T	C	14	11	25	0	0	25	0	0
4	9183115	.	T	A	10	17	27	0	0	27	0	0
4	9184684	.	A	T	3	3	6	0	0	6	0	0
4	9189969	.	C	T	0	2	2	0	6	8	0	0
4	9192444	.	G	A	6	4	10	0	0	10	0	0
4	9192507	.	A	C	2	0	2	0	3	5	0	0
4	9192813	.	A	G	1	4	5	0	1	6	0	0
4	9195006	.	A	G	1	4	5	0	0	5	0	0
4	9208383	.	A	G	4	4	8	0	0	8	0	0
4	9208486	.	C	G	3	4	7	0	0	7	0	0
4	9208598	.	C	A	0	4	4	0	2	6	0	0
4	9209019	.	C	T	2	2	4	0	0	4	0	0
4	9209023	.	T	A	2	2	4	0	0	4	0	0
4	9209366	.	C	T	1	2	3	0	1	4	0	0
4	9209469	.	G	A	1	2	3	0	0	3	0	0
4	9209486	.	G	A	2	3	5	0	0	5	0	0
4	9280070	.	G	A	0	1	1	0	2	3	0	0
4	9280074	.	G	A	2	2	4	0	0	4	0	0
4	9302284	.	T	C	1	3	4	0	0	4	0	0
4	9308224	.	C	T	4	2	6	0	0	6	0	0
4	9308332	.	C	T	6	6	12	0	0	12	0	0
4	9308344	.	G	A	4	6	10	0	0	10	0	0
4	9329819	.	T	A	7	5	12	0	0	12	0	0
4	9329912	.	C	A	6	5	11	0	2	13	0	0
4	9331330	.	G	A	1	11	12	0	13	25	0	0
4	9331495	.	T	G	15	0	15	0	7	22	0	0
4	9333565	.	G	A	1	9	10	0	13	23	0	0
4	9333739	.	A	C	18	14	32	0	3	35	0	0
4	9334180	.	G	C	0	12	12	0	11	23	0	0
4	9334196	.	A	G	10	11	21	0	2	23	0	0
4	9334735	.	A	G	12	1	13	0	10	23	0	0
4	9339140	.	G	A	2	5	7	0	0	7	0	0
4	9339202	.	G	A	6	4	10	0	0	10	0	0
4	9339274	.	C	T	3	4	7	0	0	7	0	0
4	9339316	.	C	T	1	3	4	0	3	7	0	0
4	9339637	.	C	T	1	3	4	0	4	8	0	0
4	9350496	.	G	T	1	2	3	0	0	3	0	0
4	9360781	.	T	A	2	6	8	0	0	8	0	0
4	9362867	.	A	G	1	2	3	0	0	3	0	0
4	9376859	.	A	G	4	0	4	0	7	11	0	0
4	9385390	.	A	G	10	0	10	0	13	23	0	0
4	9386108	.	C	T	13	7	20	0	0	20	0	0
4	9388890	.	C	T	8	3	11	0	1	12	0	0
4	9389112	.	G	A	5	7	12	0	0	12	0	0
4	9446126	.	C	G	3	4	7	0	0	7	0	0
4	9447758	.	C	T	3	5	8	0	0	8	0	0
4	9448634	.	G	A	5	5	10	0	1	11	0	0
4	9448643	.	G	T	4	5	9	0	0	9	0	0
4	9460213	.	A	G	6	0	6	0	9	15	0	0
4	9460603	.	A	C	4	4	8	0	0	8	0	0
4	9461548	.	A	G	1	0	1	0	2	3	0	0
4	9461946	.	T	A	6	4	10	0	0	10	0	0
4	9462237	.	T	C	1	4	5	0	0	5	0	0
4	9463671	.	G	A	2	3	5	0	5	10	0	0
4	9463679	.	C	T	7	6	13	0	0	13	0	0
4	9463840	.	C	G	4	6	10	0	0	10	0	0
4	9463855	.	T	A	6	7	13	0	0	13	0	0
4	9464057	.	T	A	1	2	3	0	0	3	0	0
4	9464142	.	G	A	0	6	6	0	1	7	0	0
4	9464143	.	T	G	2	6	8	0	0	8	0	0
4	9464224	.	T	C	5	3	8	0	0	8	0	0
4	9465193	.	T	A	2	3	5	0	0	5	0	0
4	9465197	.	G	A	0	4	4	0	0	4	0	0
4	9465637	.	A	G	4	6	10	0	0	10	0	0
4	9465832	.	G	T	9	6	15	0	3	18	0	0
4	9465899	.	C	A	14	10	24	0	0	24	0	0
4	9465900	.	C	A	14	10	24	0	0	24	0	0
4	9466075	.	G	T	10	10	20	0	2	22	0	0
4	9466192	.	C	A	2	4	6	0	0	6	0	0
4	9496926	.	C	T	3	2	5	0	0	5	0	0
4	9496934	.	G	A	3	2	5	0	0	5	0	0
4	9496969	.	A	T	2	4	6	0	1	7	0	0
4	9496976	.	C	G	3	4	7	0	0	7	0	0
4	9498803	.	C	A	2	3	5	0	0	5	0	0
4	9498886	.	G	C	3	3	6	0	0	6	0	0
4	9498896	.	T	C	4	4	8	0	0	8	0	0
4	9499448	.	C	A	3	2	5	0	0	5	0	0
4	9500311	.	A	T	7	4	11	0	0	11	0	0
4	9500312	.	G	T	7	4	11	0	0	11	0	0
4	9500370	.	G	A	5	4	9	0	0	9	0	0
4	9502243	.	G	T	7	8	15	0	1	16	0	0
4	9502312	.	T	A	9	10	19	0	2	21	0	0
4	9502347	.	C	G	7	0	7	0	4	11	0	0
4	9502388	.	T	C	6	6	12	0	1	13	0	0
4	9502422	.	G	A	12	2	14	0	5	19	0	0
4	9502440	.	A	G	13	0	13	0	9	22	0	0
4	9502608	.	T	G	8	1	9	0	11	20	0	0
4	9537015	.	A	G	12	14	26	0	0	26	0	0
4	9537025	.	C	T	15	13	28	0	0	28	0	0
4	9539303	.	G	A	9	4	13	0	0	13	0	0
4	9562957	.	G	T	3	7	10	0	0	10	0	0
4	9565450	.	C	T	0	4	4	0	3	7	0	0
4	9579297	.	C	G	2	3	5	0	0	5	0	0
4	9592782	.	A	T	3	12	15	0	0	15	0	0
4	9593832	.	C	A	2	3	5	0	0	5	0	0
4	9596614	.	A	G	6	3	9	0	0	9	0	0
4	9597837	.	G	A	4	1	5	0	3	8	0	0
4	9597862	.	G	A	3	5	8	0	1	9	0	0
4	9598642	.	C	T	12	4	16	0	1	17	0	0
4	9598690	.	C	T	17	4	21	0	1	22	0	0
4	9599566	.	G	A	18	13	31	0	0	31	0	0
4	9601158	.	C	T	7	5	12	0	1	13	0	0
4	9601174	.	T	C	10	4	14	0	1	15	0	0
4	9601256	.	A	C	4	5	9	0	0	9	0	0
4	9601329	.	C	T	7	6	13	0	3	16	0	0
4	9601401	.	A	T	6	11	17	0	0	17	0	0
4	9603559	.	G	A	2	4	6	2	0	8	0	0
4	9603589	.	G	A	1	2	3	2	0	5	0	0
4	9603791	.	G	A	11	11	22	0	2	24	0	0
4	9603803	.	G	A	12	8	20	0	1	21	0	0
4	9604134	.	G	A	9	11	20	0	1	21	0	0
4	9604294	.	C	T	0	6	6	0	7	13	0	0
4	9604384	.	A	G	7	5	12	0	1	13	0	0
4	9605221	.	C	T	1	5	6	0	4	10	0	0
4	9605397	.	A	G	12	6	18	0	0	18	0	0
4	9614854	.	G	A	1	2	3	0	0	3	0	0
4	9616190	.	A	G	7	4	11	0	1	12	0	0
4	9618432	.	A	G	7	9	16	0	0	16	0	0
4	9618867	.	A	C	13	6	19	0	1	20	0	0
4	9632179	.	A	G	10	0	10	0	2	12	0	0
4	9632188	.	C	A	7	2	9	0	1	10	0	0
4	9653570	.	A	G	3	5	8	0	1	9	0	0
4	9653574	.	C	A	0	5	5	0	4	9	0	0
4	9654020	.	T	A	7	8	15	0	0	15	0	0
4	9654071	.	T	C	10	12	22	0	0	22	0	0
4	9654103	.	A	G	9	13	22	0	1	23	0	0
4	9654114	.	C	T	0	11	11	0	9	20	0	0
4	9654149	.	C	G	10	7	17	0	1	18	0	0
4	9655534	.	T	C	7	0	7	0	7	14	0	0
4	9655807	.	G	A	8	9	17	0	1	18	0	0
4	9659858	.	G	A	6	2	8	0	0	8	0	0
4	9661253	.	A	T	11	5	16	0	0	16	0	0
4	9664900	.	G	A	4	2	6	0	0	6	0	0
4	9669846	.	A	T	4	6	10	0	0	10	0	0
4	9669869	.	C	T	2	10	12	0	0	12	0	0
4	9674206	.	G	A	3	2	5	0	1	6	0	0
4	9675420	.	G	A	0	6	6	0	1	7	0	0
4	9677280	.	G	C	2	5	7	0	2	9	0	0
4	9677319	.	T	C	3	6	9	0	2	11	0	0
4	9686153	.	A	G	8	0	8	0	14	22	0	0
4	9688093	.	T	C	11	16	27	0	1	28	0	0
4	9688570	.	C	T	11	23	34	0	1	35	0	0
4	9688636	.	G	A	13	19	32	0	1	33	0	0
4	9689825	.	G	A	2	25	27	0	20	47	0	0
4	9697599	.	C	A	6	10	16	0	2	18	0	0
4	9698023	.	C	T	10	11	21	0	2	23	0	0
4	9724441	.	A	G	6	3	9	0	1	10	0	0
4	9724635	.	T	A	16	13	29	0	3	32	0	0
4	9724644	.	C	T	14	14	28	0	1	29	0	0
4	9724718	.	C	A	8	7	15	0	0	15	0	0
4	9724898	.	A	G	9	22	31	0	2	33	0	0
4	9736186	.	A	G	18	10	28	0	0	28	0	0
4	9736211	.	C	T	16	10	26	0	0	26	0	0
4	9737157	.	G	T	7	9	16	0	0	16	0	0
4	9737314	.	A	C	10	1	11	0	14	25	0	0
4	9739228	.	C	A	6	3	9	0	0	9	0	0
4	9740769	.	G	A	13	11	24	0	1	25	0	0
4	9743708	.	G	C	9	7	16	0	0	16	0	0
4	9743762	.	T	G	3	3	6	0	0	6	0	0
4	9743774	.	C	T	2	4	6	0	1	7	0	0
4	9746515	.	A	G	3	4	7	0	1	8	0	0
4	9746547	.	C	T	5	3	8	0	0	8	0	0
4	9746559	.	C	A	6	4	10	0	0	10	0	0
4	9746604	.	G	A	4	3	7	0	1	8	0	0
4	9747209	.	C	G	1	4	5	0	3	8	0	0
4	9747647	.	C	T	5	6	11	0	0	11	0	0
4	9750109	.	G	T	6	4	10	0	0	10	0	0
4	9750154	.	T	G	8	4	12	0	1	13	0	0
4	9751050	.	A	G	4	4	8	0	0	8	0	0
4	9751310	.	T	G	3	3	6	0	0	6	0	0
4	9753200	.	A	G	3	7	10	0	0	10	0	0
4	9755341	.	G	A	7	4	11	0	0	11	0	0
4	9755350	.	G	A	7	4	11	0	0	11	0	0
4	9756488	.	G	T	3	6	9	0	1	10	0	0
4	9758862	.	C	A	0	2	2	0	3	5	0	0
4	9764703	.	G	A	1	2	3	0	0	3	0	0
4	9784331	.	T	A	9	5	14	0	2	16	0	0
4	9784669	.	G	A	11	5	16	0	1	17	0	0
4	9784678	.	C	T	1	6	7	0	11	18	0	0
4	9784740	.	A	G	12	8	20	0	0	20	0	0
4	9784747	.	T	A	11	10	21	0	1	22	0	0
4	9785900	.	T	A	12	9	21	0	0	21	0	0
4	9785985	.	C	T	6	4	10	0	1	11	0	0
4	9786203	.	A	G	8	12	20	0	1	21	0	0
4	9786338	.	T	A	10	11	21	0	0	21	0	0
4	9786466	.	C	G	0	6	6	0	8	14	0	0
4	9786514	.	C	T	9	4	13	0	1	14	0	0
4	9786574	.	T	A	6	3	9	0	0	9	0	0
4	9786617	.	C	A	5	6	11	0	1	12	0	0
4	9786670	.	C	A	4	2	6	0	1	7	0	0
4	9786705	.	A	C	3	3	6	0	0	6	0	0
4	9786925	.	T	C	2	0	2	0	3	5	0	0
4	9786976	.	G	A	3	1	4	0	0	4	0	0
4	9787025	.	T	G	2	4	6	0	1	7	0	0
4	9787156	.	A	T	2	2	4	0	0	4	0	0
4	9787250	.	A	G	5	5	10	0	1	11	0	0
4	9787415	.	G	A	10	9	19	0	0	19	0	0
4	9787516	.	C	T	9	7	16	0	3	19	0	0
4	9787600	.	G	T	7	12	19	0	1	20	0	0
4	9787761	.	A	G	13	11	24	0	2	26	0	0
4	9789478	.	A	G	7	6	13	0	1	14	0	0
4	9791466	.	A	T	7	7	14	0	0	14	0	0
4	9791493	.	T	C	7	0	7	0	8	15	0	0
4	9792102	.	T	G	9	5	14	0	0	14	0	0
4	9792229	.	G	T	6	10	16	0	0	16	0	0
4	9792726	.	T	G	5	5	10	0	0	10	0	0
4	9794644	.	C	A	0	7	7	0	8	15	0	0
4	9795288	.	C	T	6	3	9	0	2	11	0	0
4	9795417	.	T	A	1	6	7	0	0	7	0	0
4	9797312	.	C	T	0	5	5	0	1	6	0	0
4	9798229	.	T	C	1	1	2	0	4	6	0	0
4	9801626	.	G	A	3	3	6	1	0	7	0	0
4	9801662	.	A	G	3	3	6	1	0	7	0	0
4	9801730	.	A	T	5	4	9	0	0	9	0	0
4	9801747	.	G	A	5	3	8	0	1	9	0	0
4	9801935	.	A	G	3	5	8	0	0	8	0	0
4	9802472	.	A	T	2	2	4	0	1	5	0	0
4	9802487	.	C	T	0	3	3	0	1	4	0	0
4	9809829	.	T	C	2	0	2	0	3	5	0	0
4	9814044	.	C	G	9	4	13	0	0	13	0	0
4	9814880	.	T	G	10	6	16	0	1	17	0	0
4	9817327	.	C	T	3	11	14	1	0	15	0	0
4	9819858	.	A	T	4	7	11	0	0	11	0	0
4	9819944	.	T	C	5	3	8	0	0	8	0	0
4	9836583	.	T	A	5	7	12	0	0	12	0	0
4	9837992	.	A	G	5	5	10	0	0	10	0	0
4	9838875	.	T	C	7	5	12	0	0	12	0	0
4	9838932	.	C	T	5	5	10	0	1	11	0	0
4	9838974	.	T	C	8	11	19	0	1	20	0	0
4	9840136	.	T	C	7	8	15	0	1	16	0	0
4	9840242	.	T	C	6	10	16	0	0	16	0	0
4	9840338	.	T	C	10	5	15	0	1	16	0	0
4	9841657	.	G	A	21	8	29	0	2	31	0	0
4	9844249	.	G	A	1	2	3	0	0	3	0	0
4	9854313	.	T	C	5	6	11	0	0	11	0	0
4	9854458	.	T	C	1	0	1	0	5	6	0	0
4	9854467	.	C	T	1	4	5	0	0	5	0	0
4	9855482	.	G	A	7	8	15	0	0	15	0	0
4	9858023	.	A	G	5	7	12	0	2	14	0	0
4	9858050	.	C	T	2	5	7	0	1	8	0	0
4	9860188	.	T	G	2	2	4	0	1	5	0	0
4	9864001	.	C	T	2	3	5	0	1	6	0	0
4	9867387	.	A	G	1	2	3	0	1	4	0	0
4	9955350	.	C	T	4	3	7	0	1	8	0	0
4	9957319	.	T	C	4	6	10	0	0	10	0	0
4	9957331	.	C	T	3	5	8	0	0	8	0	0
4	9957367	.	T	C	4	2	6	0	0	6	0	0
4	9964153	.	T	C	3	2	5	0	1	6	0	0
4	9964161	.	C	G	3	4	7	0	0	7	0	0
4	9964813	.	C	T	2	2	4	0	0	4	0	0
4	9966229	.	C	T	4	4	8	0	0	8	0	0
4	9969261	.	C	T	6	3	9	0	1	10	0	0
4	9969306	.	G	T	7	4	11	0	1	13	1	0
4	9974720	.	C	T	3	7	10	0	0	10	0	0
4	9980400	.	G	A	1	3	4	0	4	8	0	0
4	9981763	.	C	T	3	3	6	0	0	6	0	0
4	9981838	.	G	A	5	6	11	0	1	12	0	0
4	9982775	.	G	T	4	5	9	0	1	10	0	0
4	9982872	.	A	T	6	8	14	0	1	15	0	0
4	9982883	.	A	G	7	8	15	0	0	15	0	0
4	9983269	.	C	G	9	4	13	0	0	13	0	0
4	9983347	.	G	T	6	5	11	0	0	11	0	0
4	9985320	.	G	C	7	9	16	0	3	19	0	0
4	9986279	.	G	A	12	11	23	0	1	24	0	0
4	9988867	.	C	T	12	11	23	0	0	23	0	0
4	9990796	.	G	A	11	10	21	0	0	21	0	0
4	9993789	.	C	T	16	17	33	0	0	33	0	0
4	9996182	.	T	C	27	13	40	0	1	41	0	0
4	9998553	.	G	A	3	13	16	0	11	27	0	0
4	9998566	.	A	C	10	11	21	0	2	23	0	0
4	9998677	.	A	G	16	6	22	0	3	25	0	0
4	9998986	.	A	T	14	9	23	0	1	24	0	0
4	9998988	.	T	C	14	9	23	0	1	24	0	0
4	9999240	.	C	T	19	18	37	0	2	39	0	0
4	9999367	.	A	G	22	13	35	0	2	37	0	0
4	9999830	.	T	C	14	9	23	0	6	29	0	0
4	10011770	.	A	C	9	6	15	0	0	15	0	0
4	10017468	.	A	G	19	15	34	0	3	37	0	0
4	10038009	.	T	C	16	20	36	0	0	36	0	0
4	10040249	.	G	A	2	13	15	0	23	38	0	0
4	10040285	.	A	G	28	0	28	0	18	46	0	0
4	10040297	.	C	T	26	18	44	0	3	47	0	0
4	10128828	.	A	C	3	2	5	0	0	5	0	0
4	10366710	.	G	A	1	2	3	0	0	3	0	0
4	10367349	.	G	A	3	3	6	0	0	6	0	0
4	10367358	.	A	G	1	1	2	0	3	5	0	0
4	10367610	.	C	T	4	3	7	0	0	7	0	0
4	10367619	.	C	T	5	3	8	0	2	10	0	0
4	10553528	.	G	A	3	4	7	0	3	10	0	0
4	10558370	.	C	T	6	5	11	0	2	13	0	0
4	10558510	.	T	C	1	4	5	0	0	5	0	0
4	10558578	.	C	T	0	9	9	0	0	9	0	0
4	10558600	.	A	T	9	2	11	1	2	14	0	0
4	10559042	.	A	T	7	3	10	0	0	10	0	0
4	10559088	.	C	A	7	2	9	6	0	15	0	0
4	10559213	.	C	G	10	6	16	0	0	16	0	0
4	10559558	.	A	G	7	0	7	0	3	10	0	0
4	10559621	.	C	A	7	4	11	0	0	11	0	0
4	10559992	.	C	T	5	3	8	0	0	8	0	0
4	10560246	.	G	A	8	7	15	0	0	15	0	0
4	10560253	.	A	T	9	8	17	0	2	19	0	0
4	10560284	.	C	T	6	15	21	0	1	22	0	0
4	10560404	.	A	T	15	11	26	0	1	27	0	0
4	10560607	.	A	G	2	6	8	0	4	12	0	0
4	10560916	.	C	T	13	5	18	0	2	20	0	0
4	10561598	.	T	C	13	12	25	0	1	26	0	0
4	10561603	.	G	A	12	12	24	0	0	24	0	0
4	10605409	.	T	C	5	2	7	0	0	7	0	0
4	10608878	.	G	T	8	11	19	0	2	21	0	0
4	10611014	.	T	A	17	11	28	0	1	29	0	0
4	10615123	.	A	T	14	7	21	0	1	22	0	0
4	10615127	.	G	T	16	8	24	0	1	25	0	0
4	10615175	.	A	G	14	0	14	0	9	23	0	0
4	10690370	.	A	C	1	2	3	0	0	3	0	0
4	10709530	.	C	T	2	2	4	0	0	4	0	0
4	10713426	.	C	T	1	2	3	0	0	3	0	0
4	10713491	.	G	C	2	2	4	0	0	4	0	0
4	10761803	.	C	G	3	0	3	0	5	8	0	0
4	10762071	.	G	A	2	1	3	2	1	6	0	0
4	10783836	.	C	T	0	2	2	1	4	7	0	0
4	10825618	.	G	A	1	1	2	0	1	3	0	0
4	10825629	.	G	A	1	2	3	0	0	3	0	0
4	10888935	.	C	A	2	4	6	0	0	6	0	0
4	10890822	.	G	A	4	6	10	0	0	10	0	0
4	10896354	.	G	C	3	2	5	0	0	5	0	0
4	10904784	.	C	T	6	7	13	0	0	13	0	0
4	10905246	.	C	T	12	6	18	0	0	18	0	0
4	10906254	.	C	T	7	5	12	0	0	12	0	0
4	10907182	.	C	A	2	3	5	0	2	7	0	0
4	10908001	.	C	T	10	13	23	0	1	24	0	0
4	10908182	.	T	C	8	6	14	0	1	15	0	0
4	10908294	.	C	T	7	9	16	1	1	18	0	0
4	10908726	.	T	C	11	7	18	0	2	20	0	0
4	10964235	.	G	A	1	1	2	0	0	2	0	0
4	10974437	.	T	C	1	2	3	0	0	3	0	0
4	10974650	.	C	T	3	2	5	1	0	6	0	0
4	10974722	.	G	A	10	2	12	0	1	13	0	0
4	10974747	.	A	T	4	8	12	0	0	12	0	0
4	10975629	.	A	G	2	6	8	0	0	8	0	0
4	10975632	.	G	A	2	5	7	0	0	7	0	0
4	10976944	.	G	A	6	3	9	0	0	9	0	0
4	10982291	.	C	T	8	4	12	0	0	12	0	0
4	10982339	.	T	G	4	3	7	0	0	7	0	0
4	10982390	.	C	A	0	4	4	0	6	10	0	0
4	10987895	.	T	A	3	5	8	0	1	9	0	0
4	10988546	.	G	C	2	2	4	0	1	5	0	0
4	10988581	.	C	T	0	4	4	0	2	6	0	0
4	10994841	.	G	A	2	2	4	0	0	4	0	0
4	10995138	.	G	A	1	3	4	0	1	5	0	0
4	11053745	.	T	C	2	2	4	0	0	4	0	0
4	11053771	.	G	A	1	7	8	0	3	11	0	0
4	11053851	.	G	A	1	9	10	0	4	14	0	0
4	11054484	.	A	C	5	11	16	0	0	16	0	0
4	11054509	.	G	C	6	12	18	0	0	19	1	0
4	11344964	.	G	A	3	1	4	0	1	5	0	0
4	11356555	.	A	G	3	6	9	0	1	10	0	0
4	11356618	.	T	C	10	4	14	0	0	14	0	0
4	11358626	.	C	T	6	3	9	0	1	10	0	0
4	11366360	.	T	C	13	9	22	0	0	22	0	0
4	11366481	.	G	A	20	6	26	0	2	28	0	0
4	11367668	.	T	A	13	6	19	1	0	20	0	0
4	11367952	.	T	C	9	11	20	0	0	20	0	0
4	11368056	.	A	T	14	21	35	0	4	39	0	0
4	11368076	.	G	T	21	22	43	0	2	45	0	0
4	11368171	.	G	A	2	23	25	0	14	39	0	0
4	11416701	.	C	T	4	11	15	0	0	15	0	0
4	11416758	.	T	A	3	4	7	0	0	7	0	0
4	11416854	.	G	A	7	5	12	0	1	13	0	0
4	11417753	.	G	T	2	2	4	0	0	4	0	0
4	11417829	.	C	A	4	4	8	0	1	9	0	0
4	11418969	.	C	T	2	4	6	0	1	7	0	0
4	11419062	.	G	A	4	2	6	0	1	7	0	0
4	11419163	.	C	G	4	4	8	0	0	8	0	0
4	11419656	.	C	T	4	4	8	0	0	8	0	0
4	11419836	.	A	T	6	3	9	0	0	9	0	0
4	11419869	.	T	C	5	6	11	0	0	11	0	0
4	11420005	.	A	T	9	9	18	0	2	20	0	0
4	11421575	.	C	T	6	6	12	0	2	14	0	0
4	11422121	.	C	T	7	8	15	0	0	15	0	0
4	11425839	.	G	T	17	16	33	0	1	34	0	0
4	11439544	.	C	A	3	3	6	0	1	8	1	0
4	11444080	.	C	T	15	18	33	0	2	35	0	0
4	11446078	.	A	G	21	20	41	0	1	42	0	0
4	11446365	.	A	T	22	19	41	0	4	45	0	0
4	11446771	.	A	G	11	4	15	0	2	17	0	0
4	11446818	.	A	G	0	16	16	0	0	16	0	0
4	11447135	.	T	C	17	21	38	0	3	41	0	0
4	11447144	.	G	A	21	15	36	0	2	38	0	0
4	11447226	.	T	G	23	2	25	0	15	40	0	0
4	11447251	.	T	C	16	14	30	0	0	30	0	0
4	11447719	.	T	G	14	24	38	0	3	41	0	0
4	11448296	.	A	T	19	24	43	0	0	43	0	0
4	11448403	.	G	A	2	24	26	0	26	52	0	0
4	11458318	.	T	G	1	2	3	0	0	3	0	0
4	11461181	.	C	G	3	5	8	0	0	8	0	0
4	11461914	.	A	G	2	11	13	0	1	14	0	0
4	11464390	.	A	G	18	15	33	0	1	34	0	0
4	11470854	.	A	G	4	6	10	0	2	12	0	0
4	11471203	.	T	C	20	9	29	0	1	30	0	0
4	11472674	.	T	C	18	17	35	0	0	35	0	0
4	11476472	.	G	A	3	24	27	0	28	55	0	0
4	11476487	.	C	T	27	22	49	0	6	55	0	0
4	11476740	.	C	T	27	29	56	2	2	60	0	0
4	11476868	.	C	G	17	32	49	0	5	54	0	0
4	11476945	.	C	T	31	32	63	0	1	64	0	0
4	11477047	.	T	A	25	34	59	0	1	61	1	0
4	11477377	.	C	T	44	13	57	1	2	60	0	0
4	11480649	.	T	C	8	5	13	0	4	17	0	0
4	11480824	.	C	A	7	4	11	0	0	11	0	0
4	11482235	.	G	A	1	7	8	0	7	15	0	0
4	11482259	.	G	A	11	10	21	0	0	21	0	0
4	11482358	.	T	G	8	6	14	0	0	14	0	0
4	11482367	.	C	G	7	5	12	0	0	12	0	0
4	11482668	.	T	A	15	10	25	0	0	25	0	0
4	11482830	.	C	T	5	4	9	0	0	9	0	0
4	11489736	.	C	T	3	3	6	0	1	7	0	0
4	11489758	.	G	A	1	3	4	0	2	6	0	0
4	11573918	.	C	T	3	2	5	0	1	6	0	0
4	11704180	.	C	T	2	2	4	0	0	4	0	0
4	11704195	.	A	G	1	2	3	0	0	3	0	0
4	11712653	.	C	T	2	2	4	0	0	4	0	0
4	11712704	.	G	T	0	2	2	0	3	5	0	0
4	11712794	.	T	C	3	9	12	0	0	12	0	0
4	11721659	.	T	C	2	7	9	0	1	10	0	0
4	11721731	.	C	T	4	4	8	0	0	8	0	0
4	11726366	.	T	A	6	10	16	0	4	20	0	0
4	11728959	.	G	A	0	10	10	0	10	20	0	0
4	11729233	.	G	T	1	1	2	0	1	3	0	0
4	11729719	.	G	A	3	5	8	0	0	8	0	0
4	11730159	.	G	C	6	6	12	0	0	12	0	0
4	11730515	.	C	A	10	6	16	0	1	17	0	0
4	11732213	.	G	A	2	1	3	0	1	4	0	0
4	11732222	.	G	A	2	2	4	0	1	5	0	0
4	11732589	.	T	C	4	8	12	0	1	13	0	0
4	11732590	.	T	C	3	9	12	0	0	12	0	0
4	11732956	.	A	G	5	6	11	0	0	11	0	0
4	11732975	.	G	A	4	2	6	0	0	6	0	0
4	11733061	.	A	C	4	4	8	0	1	9	0	0
4	11733114	.	A	C	3	0	3	0	6	9	0	0
4	11733222	.	C	T	8	3	11	0	0	11	0	0
4	11733299	.	T	C	0	2	2	0	1	3	0	0
4	11733545	.	T	C	7	0	7	0	4	11	0	0
4	11733573	.	G	A	9	8	17	0	0	17	0	0
4	11733726	.	A	C	8	6	14	0	1	15	0	0
4	11733778	.	C	A	0	3	3	0	4	7	0	0
4	11734150	.	A	G	2	3	5	0	0	5	0	0
4	11734196	.	A	T	2	4	6	0	0	6	0	0
4	11780560	.	C	T	1	2	3	6	0	9	0	0
4	11804825	.	C	G	11	5	16	0	0	16	0	0
4	11804940	.	G	A	7	9	16	0	0	16	0	0
4	11805396	.	G	T	4	4	8	0	1	9	0	0
4	11805423	.	T	C	4	8	12	0	0	12	0	0
4	11806934	.	G	A	7	8	15	0	1	16	0	0
4	11806965	.	G	C	8	10	18	0	0	18	0	0
4	11810123	.	T	G	3	3	6	0	2	8	0	0
4	11810129	.	A	G	2	4	6	0	0	6	0	0
4	11814022	.	A	G	22	8	30	0	3	33	0	0
4	11814055	.	C	T	2	31	33	0	16	49	0	0
4	11814074	.	T	A	23	31	54	0	0	54	0	0
4	11814429	.	A	T	9	11	20	0	2	22	0	0
4	11814456	.	A	G	12	10	22	0	0	22	0	0
4	11814471	.	G	A	8	10	18	0	1	19	0	0
4	11814494	.	C	T	11	6	17	0	0	17	0	0
4	11814565	.	A	T	11	6	17	0	0	17	0	0
4	11814684	.	C	T	14	6	20	0	0	20	0	0
4	11814723	.	A	C	5	20	25	0	0	25	0	0
4	11815137	.	G	T	15	20	35	0	0	35	0	0
4	11815143	.	C	G	15	21	36	0	0	36	0	0
4	11815324	.	A	C	16	16	32	0	0	32	0	0
4	11815801	.	T	A	2	12	14	0	1	15	0	0
4	11816535	.	T	C	7	1	8	0	5	13	0	0
4	11818347	.	G	A	6	5	11	0	1	12	0	0
4	11818353	.	A	G	5	9	14	0	0	14	0	0
4	11827171	.	C	T	6	6	12	1	0	13	0	0
4	11841949	.	T	A	3	3	6	0	0	6	0	0
4	12006542	.	G	A	6	6	12	0	0	12	0	0
4	12013513	.	A	T	2	3	5	0	0	5	0	0
4	12020936	.	C	T	10	8	18	0	2	20	0	0
4	12021120	.	C	T	11	15	26	0	3	29	0	0
4	12021703	.	C	T	18	14	32	0	1	33	0	0
4	12021748	.	G	T	1	16	17	0	17	34	0	0
4	12022108	.	A	G	12	1	13	0	16	29	0	0
4	12022444	.	T	C	18	20	38	0	0	38	0	0
4	12023445	.	A	C	16	22	38	0	3	41	0	0
4	12025771	.	G	A	38	10	48	2	4	54	0	0
4	12026098	.	G	A	9	5	14	0	0	14	0	0
4	12026286	.	A	T	14	16	30	0	2	32	0	0
4	12026305	.	T	C	16	15	31	0	1	32	0	0
4	12026369	.	G	T	13	13	26	0	1	27	0	0
4	12026429	.	C	A	8	13	21	0	0	21	0	0
4	12026488	.	T	C	5	2	7	0	0	7	0	0
4	12036357	.	G	A	2	2	4	0	0	4	0	0
4	12036384	.	G	T	2	2	4	0	0	4	0	0
4	12078423	.	T	C	8	0	8	0	4	12	0	0
4	12080673	.	C	T	5	4	9	0	0	9	0	0
4	12080911	.	T	G	7	8	15	0	1	16	0	0
4	12087262	.	G	C	5	0	5	0	3	8	0	0
4	12091037	.	T	C	8	0	8	0	6	14	0	0
4	12091104	.	G	T	7	5	12	0	0	12	0	0
4	12103619	.	T	C	1	0	1	1	6	8	0	0
4	12103964	.	T	A	5	10	15	0	0	15	0	0
4	12106000	.	G	C	6	0	6	0	3	9	0	0
4	12113128	.	C	T	1	4	5	0	2	7	0	0
4	12234792	.	A	G	12	8	20	0	3	23	0	0
4	12236495	.	A	G	9	0	9	0	13	22	0	0
4	12679190	.	C	T	4	2	6	0	1	7	0	0
4	12902609	.	G	A	2	2	4	0	0	4	0	0
4	12917348	.	A	G	9	7	16	0	3	19	0	0
4	12917534	.	C	T	2	10	12	0	13	25	0	0
4	12921893	.	T	C	5	0	5	0	5	10	0	0
4	12929147	.	C	T	1	5	6	0	3	9	0	0
4	12971436	.	A	G	23	15	38	0	0	38	0	0
4	12971495	.	C	A	23	15	38	0	3	41	0	0
4	12971935	.	A	T	19	6	25	0	2	27	0	0
4	12972000	.	T	A	13	12	25	0	0	25	0	0
4	12972017	.	T	A	16	7	23	0	0	23	0	0
4	12972215	.	C	T	3	26	29	0	25	54	0	0
4	12976735	.	G	A	14	13	27	0	1	28	0	0
4	12976983	.	T	C	15	1	16	0	15	31	0	0
4	12978779	.	G	A	10	10	20	0	0	20	0	0
4	12978843	.	A	C	11	13	24	0	0	24	0	0
4	13035881	.	A	G	15	11	26	0	1	27	0	0
4	13035962	.	T	C	19	12	31	0	1	32	0	0
4	13036046	.	G	A	13	23	36	0	2	38	0	0
4	13036572	.	G	A	15	8	23	0	0	23	0	0
4	13041589	.	C	T	2	12	14	0	13	27	0	0
4	13054610	.	G	A	10	3	13	0	1	14	0	0
4	13056441	.	G	A	10	12	22	0	0	22	0	0
4	13079354	.	A	T	5	5	10	0	0	10	0	0
4	13138021	.	T	C	5	6	11	0	0	11	0	0
4	13419775	.	G	C	0	3	3	0	6	9	0	0
4	13424839	.	G	A	20	16	36	0	2	38	0	0
4	13424968	.	A	C	12	7	19	0	0	19	0	0
4	13453413	.	G	A	7	2	9	0	0	9	0	0
4	13453445	.	T	C	1	5	6	0	0	6	0	0
4	13457587	.	T	G	3	2	5	0	0	5	0	0
4	13457770	.	G	C	5	4	9	0	0	9	0	0
4	13458052	.	G	T	0	3	3	0	6	9	0	0
4	13458187	.	A	T	2	4	6	0	0	6	0	0
4	13458469	.	C	T	5	8	13	0	0	13	0	0
4	13458800	.	C	T	4	6	10	0	0	10	0	0
4	13459602	.	T	G	12	4	16	0	1	17	0	0
4	13459753	.	G	T	12	4	16	0	1	17	0	0
4	13459823	.	G	A	7	8	15	0	1	16	0	0
4	13459917	.	G	A	7	6	13	0	1	14	0	0
4	13459964	.	A	T	11	3	14	0	0	14	0	0
4	13460125	.	G	A	8	7	15	0	1	16	0	0
4	13460244	.	A	G	10	8	18	0	2	20	0	0
4	13460289	.	G	A	10	6	16	0	2	18	0	0
4	13460653	.	G	A	7	6	13	0	1	14	0	0
4	13461216	.	T	A	8	10	18	0	2	20	0	0
4	13555327	.	G	A	3	2	5	0	1	6	0	0
4	13562110	.	T	C	1	0	1	0	2	3	0	0
4	13564842	.	C	T	1	2	3	0	0	3	0	0
4	13586824	.	C	A	4	3	7	0	0	7	0	0
4	13589685	.	C	T	4	5	9	0	0	9	0	0
4	13589787	.	G	A	5	5	10	0	0	10	0	0
4	13592863	.	G	A	6	10	16	0	0	16	0	0
4	13593060	.	G	A	0	4	4	0	5	9	0	0
4	13593097	.	T	C	3	3	6	0	0	6	0	0
4	13595838	.	G	A	1	4	5	0	5	10	0	0
4	13597393	.	A	T	5	4	9	0	0	9	0	0
4	13597529	.	T	A	5	6	11	0	0	11	0	0
4	13597547	.	A	G	6	9	15	0	0	15	0	0
4	13599365	.	G	T	16	6	22	1	2	25	0	0
4	13599410	.	C	T	14	8	22	0	1	23	0	0
4	13599570	.	A	G	14	0	14	0	12	26	0	0
4	13599840	.	C	T	13	11	24	0	0	24	0	0
4	13628281	.	C	T	8	4	12	0	0	12	0	0
4	13628328	.	G	T	2	5	7	0	0	7	0	0
4	13628583	.	G	A	7	7	14	0	0	14	0	0
4	13628724	.	G	A	4	2	6	0	0	6	0	0
4	13631269	.	G	A	4	9	13	0	1	14	0	0
4	13631308	.	C	T	8	6	14	0	0	14	0	0
4	13640812	.	C	T	15	20	35	0	0	35	0	0
4	13642486	.	C	T	16	9	25	0	4	29	0	0
4	13642676	.	T	G	13	0	13	0	17	30	0	0
4	13642715	.	A	T	16	13	29	0	1	30	0	0
4	13642897	.	A	G	6	5	11	0	1	12	0	0
4	13643349	.	A	T	8	11	19	0	0	19	0	0
4	13643418	.	C	G	6	4	10	0	1	11	0	0
4	13643427	.	G	A	6	3	9	0	1	10	0	0
4	13643461	.	G	A	0	5	5	0	4	9	0	0
4	13643547	.	C	T	5	3	8	0	1	9	0	0
4	13702490	.	C	T	2	2	4	0	0	4	0	0
4	13703106	.	T	C	1	2	3	0	0	3	0	0
4	13705743	.	G	A	0	5	5	0	5	10	0	0
4	13706138	.	G	A	1	3	4	0	0	4	0	0
4	13706810	.	C	T	2	4	6	0	1	7	0	0
4	13707603	.	G	A	6	4	10	0	0	10	0	0
4	13708840	.	C	A	9	5	14	0	1	15	0	0
4	13710868	.	T	C	2	4	6	0	0	6	0	0
4	13712997	.	C	G	4	4	8	0	0	8	0	0
4	13714183	.	G	A	11	4	15	0	0	15	0	0
4	13714209	.	G	A	4	10	14	0	0	14	0	0
4	13716481	.	C	G	8	8	16	0	0	16	0	0
4	13721451	.	A	C	1	2	3	0	0	3	0	0
4	13723362	.	C	T	13	10	23	0	0	23	0	0
4	13723446	.	C	T	18	17	35	0	0	35	0	0
4	13734018	.	T	G	4	2	6	0	0	6	0	0
4	13742550	.	A	G	7	0	7	0	6	13	0	0
4	13742619	.	A	G	8	10	18	0	1	19	0	0
4	13742827	.	A	G	8	8	16	0	0	16	0	0
4	13744525	.	C	A	6	8	14	0	0	14	0	0
4	13744717	.	G	A	8	5	13	0	0	13	0	0
4	13748217	.	C	T	8	9	17	0	1	18	0	0
4	13748250	.	T	C	7	8	15	0	0	15	0	0
4	13748521	.	T	G	12	12	24	0	0	24	0	0
4	13753404	.	G	A	19	13	32	0	2	34	0	0
4	13753561	.	A	T	20	13	33	0	1	34	0	0
4	13753717	.	C	T	17	22	39	0	0	39	0	0
4	13753738	.	C	G	18	1	19	0	21	40	0	0
4	13753864	.	T	C	18	25	43	0	5	48	0	0
4	13754405	.	C	T	16	31	47	0	3	50	0	0
4	13754456	.	A	C	14	33	47	0	2	49	0	0
4	13755213	.	G	A	28	16	44	0	2	46	0	0
4	13755392	.	G	A	1	13	14	0	12	26	0	0
4	13755455	.	A	T	7	11	18	0	3	21	0	0
4	13755476	.	G	T	7	11	18	0	0	18	0	0
4	13755805	.	C	G	6	11	17	0	1	18	0	0
4	13755813	.	C	T	14	7	21	0	0	21	0	0
4	13756324	.	T	C	16	19	35	0	0	35	0	0
4	13847775	.	G	A	2	3	5	0	1	6	0	0
4	13847803	.	T	A	6	3	9	0	1	10	0	0
4	13859984	.	G	A	2	2	4	0	1	5	0	0
4	13893301	.	C	A	1	2	3	0	0	3	0	0
4	13893369	.	C	T	1	2	3	0	0	3	0	0
4	13905926	.	T	A	16	11	27	0	0	27	0	0
4	13905985	.	C	T	12	13	25	0	1	26	0	0
4	13906051	.	T	C	6	0	6	0	7	13	0	0
4	13906547	.	G	C	5	9	14	0	1	15	0	0
4	13906766	.	G	A	16	15	31	0	0	31	0	0
4	13906847	.	C	T	4	12	16	0	15	31	0	0
4	13925593	.	T	C	6	0	6	0	6	12	0	0
4	13925621	.	A	G	7	7	14	0	0	14	0	0
4	13925714	.	C	T	8	8	16	0	0	16	0	0
4	13929543	.	G	A	9	4	13	0	0	13	0	0
4	13931846	.	G	A	4	6	10	0	2	12	0	0
4	13935669	.	T	C	4	7	11	0	3	14	0	0
4	13950946	.	C	T	7	6	13	0	1	14	0	0
4	13953957	.	C	A	3	7	10	0	1	11	0	0
4	13954031	.	C	T	1	2	3	0	0	3	0	0
4	13962749	.	C	A	2	0	2	0	11	13	0	0
4	13963045	.	T	C	9	13	22	0	0	22	0	0
4	13963048	.	T	A	13	9	22	0	1	23	0	0
4	13964085	.	A	G	4	3	7	0	1	8	0	0
4	13964679	.	C	G	1	4	5	0	0	5	0	0
4	13964769	.	A	T	5	5	10	0	1	11	0	0
4	13965558	.	G	A	1	2	3	0	0	3	0	0
4	13969955	.	G	A	1	2	3	0	0	3	0	0
4	14178305	.	T	C	5	2	7	1	0	8	0	0
4	14191951	.	G	A	1	2	3	0	0	3	0	0
4	14193462	.	G	T	16	10	26	0	4	30	0	0
4	14193473	.	C	A	14	9	23	0	2	26	1	0
4	14193512	.	T	C	6	0	6	0	8	14	0	0
4	14194036	.	G	A	5	9	14	0	1	15	0	0
4	14194426	.	G	A	5	4	9	0	1	10	0	0
4	14196368	.	T	C	9	9	18	0	0	18	0	0
4	14198037	.	T	C	3	4	7	0	0	7	0	0
4	14247890	.	G	C	22	20	42	1	7	50	0	0
4	14248128	.	G	A	32	22	54	0	5	59	0	0
4	14248332	.	C	A	4	27	31	0	27	58	0	0
4	14248615	.	T	A	36	28	64	0	1	65	0	0
4	14248643	.	A	G	28	29	57	0	5	62	0	0
4	14248750	.	T	G	46	12	58	0	1	59	0	0
4	14248751	.	A	G	47	12	59	0	1	60	0	0
4	14248804	.	G	A	27	29	56	0	1	57	0	0
4	14248848	.	G	A	20	28	48	0	2	50	0	0
4	14248856	.	C	T	21	24	45	0	1	46	0	0
4	14248906	.	C	T	30	14	44	0	1	45	0	0
4	14248948	.	A	G	26	12	38	0	1	39	0	0
4	14248969	.	T	G	28	12	40	0	1	41	0	0
4	14249043	.	C	T	26	12	38	0	5	43	0	0
4	14249151	.	T	C	10	18	28	0	2	30	0	0
4	14249159	.	T	G	7	17	24	0	1	25	0	0
4	14249247	.	A	T	8	12	20	0	0	20	0	0
4	14249269	.	T	C	5	12	17	0	2	19	0	0
4	14249329	.	C	T	10	11	21	0	0	21	0	0
4	14249358	.	T	A	7	11	18	1	1	20	0	0
4	14249374	.	G	T	5	11	16	1	3	20	0	0
4	14249549	.	C	A	17	12	29	0	0	29	0	0
4	14249588	.	A	T	15	7	22	0	0	22	0	0
4	14249649	.	T	C	6	18	24	1	2	27	0	0
4	14250024	.	T	A	31	13	44	1	4	49	0	0
4	14250053	.	G	A	34	12	46	1	9	56	0	0
4	14250678	.	G	A	23	26	49	0	3	52	0	0
4	14250831	.	G	A	30	25	55	0	2	57	0	0
4	14282301	.	C	T	17	12	29	0	0	29	0	0
4	14305901	.	G	A	17	20	37	0	1	38	0	0
4	14311380	.	G	A	13	12	25	0	1	26	0	0
4	14315713	.	T	A	14	7	21	0	1	22	0	0
4	14328925	.	A	G	5	5	10	0	0	10	0	0
4	14348562	.	A	C	8	5	13	0	0	13	0	0
4	14369527	.	T	G	4	4	8	0	1	9	0	0
4	14370932	.	C	T	4	5	9	0	1	10	0	0
4	14372509	.	A	T	7	9	16	0	0	16	0	0
4	14372610	.	C	A	8	4	12	0	3	15	0	0
4	14372785	.	C	T	11	4	15	0	0	15	0	0
4	14435991	.	A	C	3	5	8	0	0	8	0	0
4	14435997	.	C	T	0	5	5	0	3	8	0	0
4	14437335	.	T	C	2	2	4	0	1	5	0	0
4	14449492	.	G	C	13	0	13	0	13	26	0	0
4	14449660	.	T	A	8	3	11	0	5	16	0	0
4	14449762	.	T	A	8	4	12	0	0	12	0	0
4	14449795	.	T	C	5	5	10	0	1	11	0	0
4	14450330	.	T	C	7	0	7	0	8	15	0	0
4	14450355	.	A	T	12	7	19	0	0	19	0	0
4	14450377	.	T	C	9	8	17	0	0	17	0	0
4	14450501	.	G	A	3	7	10	0	2	12	0	0
4	14450634	.	A	T	2	6	8	0	0	8	0	0
4	14452194	.	C	T	0	10	10	0	8	18	0	0
4	14452220	.	G	A	10	12	22	0	0	22	0	0
4	14454082	.	T	G	3	2	5	0	0	5	0	0
4	14456539	.	G	A	7	10	17	0	0	17	0	0
4	14466213	.	T	G	4	2	6	0	0	6	0	0
4	14466340	.	G	T	2	3	5	0	0	5	0	0
4	14467771	.	C	G	4	3	7	0	0	7	0	0
4	14676205	.	T	C	2	3	5	0	0	5	0	0
4	14692667	.	C	T	3	3	6	0	0	6	0	0
4	14695933	.	A	C	1	2	3	0	0	3	0	0
4	14700843	.	A	T	7	2	9	0	0	9	0	0
4	14702044	.	T	C	5	9	14	0	2	16	0	0
4	14711899	.	A	G	9	4	13	0	0	13	0	0
4	14711984	.	G	T	12	7	19	0	1	20	0	0
4	14728640	.	T	A	6	12	18	0	1	19	0	0
4	14734276	.	A	T	25	17	42	0	1	43	0	0
4	14734336	.	C	T	16	16	32	0	4	36	0	0
4	14736369	.	G	A	18	12	30	0	0	30	0	0
4	14736546	.	C	T	2	4	6	0	0	6	0	0
4	14736571	.	G	C	1	2	3	0	0	3	0	0
4	14826305	.	G	A	9	6	15	0	0	15	0	0
4	14844000	.	T	C	3	2	5	0	0	5	0	0
4	14859181	.	A	G	5	0	5	0	4	9	0	0
4	14863210	.	T	C	3	3	6	0	0	6	0	0
4	14863282	.	A	G	6	4	10	0	0	10	0	0
4	14863321	.	A	C	9	4	13	0	0	13	0	0
4	14863363	.	C	T	5	4	9	0	0	9	0	0
4	14896037	.	T	C	4	4	8	0	0	8	0	0
4	14896040	.	T	C	4	5	9	0	0	9	0	0
4	14896509	.	G	A	4	5	9	0	0	9	0	0
4	14896658	.	G	A	2	3	5	0	0	5	0	0
4	14901443	.	C	A	1	2	3	0	0	3	0	0
4	14906746	.	C	G	1	5	6	0	1	7	0	0
4	14906767	.	G	A	4	6	10	0	0	10	0	0
4	14906795	.	G	T	8	4	12	0	1	13	0	0
4	14906991	.	T	G	5	5	10	0	1	11	0	0
4	14906993	.	C	A	5	5	10	0	1	11	0	0
4	14912790	.	C	T	5	2	7	0	0	7	0	0
4	14915247	.	T	G	2	2	4	0	1	5	0	0
4	14915252	.	G	T	2	2	4	0	0	4	0	0
4	14919655	.	C	T	3	5	8	0	0	8	0	0
4	14919678	.	C	T	1	3	4	0	2	6	0	0
4	14920979	.	T	C	1	1	2	0	3	5	0	0
4	14926618	.	T	G	3	4	7	0	0	7	0	0
4	14928973	.	G	A	2	8	10	0	11	21	0	0
4	14931446	.	G	A	10	12	22	0	2	24	0	0
4	14933513	.	G	T	6	5	11	0	0	11	0	0
4	14933567	.	C	T	1	7	8	0	3	11	0	0
4	14933750	.	G	A	6	7	13	0	0	13	0	0
4	14933768	.	C	G	7	7	14	0	0	14	0	0
4	14979018	.	A	C	1	1	2	0	1	3	0	0
4	14979050	.	T	G	1	2	3	0	0	3	0	0
4	14979055	.	C	A	1	2	3	0	0	3	0	0
4	14991806	.	A	G	9	9	18	0	3	21	0	0
4	14992131	.	C	A	3	5	8	0	0	8	0	0
4	14992569	.	T	C	10	7	17	0	0	17	0	0
4	14992723	.	T	C	3	4	7	0	0	7	0	0
4	14992774	.	G	C	6	3	9	0	0	9	0	0
4	14992838	.	A	T	6	9	15	1	0	16	0	0
4	14992902	.	G	A	5	8	13	0	0	13	0	0
4	14992910	.	T	C	5	0	5	0	5	10	0	0
4	14993076	.	T	C	5	6	11	0	0	11	0	0
4	14994200	.	C	T	0	6	6	0	5	11	0	0
4	14995395	.	G	T	6	7	13	0	0	13	0	0
4	15007968	.	A	G	2	2	4	0	0	4	0	0
4	15007992	.	G	A	0	3	3	0	1	4	0	0
4	15009243	.	C	T	8	6	14	0	0	14	0	0
4	15009332	.	G	C	10	4	14	0	0	14	0	0
4	15009947	.	G	A	2	4	6	0	0	6	0	0
4	15010172	.	T	A	4	7	11	0	0	11	0	0
4	15010386	.	G	A	1	8	9	0	6	15	0	0
4	15010557	.	A	G	12	0	12	0	9	21	0	0
4	15010584	.	T	G	10	5	15	0	0	15	0	0
4	15058663	.	A	C	4	19	23	4	1	28	0	0
4	15082090	.	T	C	8	8	16	0	1	17	0	0
4	16633451	.	T	C	3	3	6	0	1	7	0	0
4	16791673	.	C	A	11	6	17	0	0	17	0	0
4	16982845	.	C	A	9	2	11	0	0	11	0	0
4	17661062	.	A	G	2	3	5	0	1	6	0	0
4	17873930	.	C	T	1	3	4	0	2	6	0	0
4	18208026	.	C	A	1	3	4	0	2	6	0	0
4	18208068	.	A	G	4	6	10	0	2	12	0	0
4	18208215	.	C	T	19	15	34	0	1	35	0	0
4	18208347	.	C	G	11	8	19	0	1	20	0	0
4	18208393	.	T	A	7	0	7	0	2	14	5	0
4	18208606	.	A	G	2	1	3	0	0	3	0	0
4	18208788	.	C	T	2	7	9	0	0	9	0	0
4	18208814	.	A	G	1	6	7	0	1	8	0	0
4	18208939	.	C	T	8	4	12	0	1	13	0	0
4	18209084	.	G	A	5	12	17	1	1	19	0	0
4	18237355	.	A	G	7	3	10	0	0	10	0	0
4	18240451	.	G	A	4	2	6	0	0	6	0	0
4	18240464	.	C	A	4	4	8	0	1	9	0	0
4	18240811	.	G	A	1	4	5	0	0	5	0	0
4	18241297	.	C	T	2	1	3	0	1	4	0	0
4	18241378	.	C	G	1	3	4	0	4	8	0	0
4	18242936	.	G	T	1	2	3	0	0	3	0	0
4	18249120	.	G	C	4	2	6	0	0	6	0	0
4	18280978	.	C	T	1	2	3	0	2	5	0	0
4	18283111	.	A	G	1	2	3	0	0	3	0	0
4	18287263	.	T	C	5	2	7	0	0	7	0	0
4	18296099	.	T	C	2	0	2	0	3	5	0	0
4	18296126	.	T	C	2	3	5	0	0	5	0	0
4	18301293	.	C	A	0	2	2	0	2	4	0	0
4	18301353	.	T	C	1	4	5	0	0	5	0	0
4	18416462	.	T	G	2	4	6	0	0	6	0	0
4	18432363	.	G	T	2	4	6	0	0	6	0	0
4	18432599	.	A	T	1	2	3	0	0	3	0	0
4	18453737	.	G	T	1	2	3	0	0	3	0	0
4	18453875	.	T	A	1	2	3	0	0	3	0	0
4	18454423	.	G	A	2	2	4	0	1	5	0	0
4	18454583	.	T	C	3	8	11	0	0	11	0	0
4	18497179	.	A	T	2	3	5	0	0	5	0	0
4	18502494	.	C	T	1	3	4	0	0	4	0	0
4	18504505	.	T	A	6	3	9	0	0	9	0	0
4	18599283	.	C	T	1	3	4	0	0	4	0	0
4	18609636	.	T	C	4	1	5	0	4	9	0	0
4	18609698	.	C	G	5	5	10	0	0	10	0	0
4	18609855	.	G	C	6	3	9	0	0	9	0	0
4	18610030	.	G	A	9	7	16	0	0	16	0	0
4	18614034	.	A	G	6	5	11	0	0	11	0	0
4	18614166	.	T	A	4	3	7	0	0	7	0	0
4	18614484	.	G	A	2	3	5	0	0	5	0	0
4	18720905	.	C	T	3	5	8	0	1	9	0	0
4	18734708	.	T	C	1	2	3	0	0	3	0	0
4	18837307	.	T	C	8	9	17	0	4	21	0	0
4	18837559	.	C	T	3	10	13	0	13	26	0	0
4	18837561	.	T	G	11	11	22	0	2	24	0	0
4	18838057	.	C	T	8	5	13	0	0	13	0	0
4	18839942	.	G	A	6	3	9	0	0	9	0	0
4	18839957	.	C	T	7	3	10	0	0	10	0	0
4	18846932	.	G	A	3	8	11	0	0	11	0	0
4	18849036	.	T	G	2	2	4	0	0	4	0	0
4	18851009	.	C	T	1	3	4	0	0	4	0	0
4	18853815	.	A	G	13	15	28	0	3	31	0	0
4	18853972	.	C	G	11	15	26	0	1	27	0	0
4	18854250	.	A	C	17	0	17	0	16	33	0	0
4	18854417	.	T	A	3	9	12	0	1	13	0	0
4	18854519	.	A	C	9	8	17	0	2	19	0	0
4	18854525	.	A	C	11	9	20	0	0	20	0	0
4	18967321	.	C	T	4	5	9	0	3	12	0	0
4	18976574	.	C	T	2	9	11	0	0	11	0	0
4	18979820	.	T	A	9	10	19	0	0	19	0	0
4	18981945	.	A	G	6	12	18	0	0	18	0	0
4	18984234	.	A	C	15	12	27	0	2	29	0	0
4	18984588	.	A	G	11	11	22	0	0	22	0	0
4	18984628	.	G	A	10	6	16	0	0	16	0	0
4	18984939	.	C	T	5	4	9	0	1	10	0	0
4	18984950	.	A	T	6	5	11	0	2	13	0	0
4	18984999	.	T	C	9	4	13	0	3	16	0	0
4	18985048	.	A	T	5	5	10	0	0	10	0	0
4	18985142	.	G	A	11	8	19	0	0	19	0	0
4	18985206	.	T	C	10	9	19	0	2	21	0	0
4	18985216	.	T	C	10	12	22	0	1	23	0	0
4	18985327	.	A	C	10	5	15	0	1	16	0	0
4	18985406	.	G	T	1	4	5	0	8	13	0	0
4	18985594	.	T	A	5	2	7	0	0	7	0	0
4	18985730	.	G	A	8	7	15	0	1	16	0	0
4	18986413	.	G	A	10	15	25	0	0	25	0	0
4	18986497	.	C	T	2	12	14	0	17	31	0	0
4	18986754	.	T	C	3	3	6	0	0	6	0	0
4	18986805	.	G	T	9	5	14	0	0	14	0	0
4	18986873	.	C	T	3	10	13	0	0	13	0	0
4	18986893	.	C	G	8	2	10	0	0	10	0	0
4	18986997	.	G	A	9	4	13	0	0	13	0	0
4	18987202	.	C	A	10	9	19	0	0	19	0	0
4	18987250	.	G	A	11	5	16	0	1	17	0	0
4	18987391	.	G	A	9	11	20	0	3	23	0	0
4	18988651	.	G	A	2	6	8	0	1	9	0	0
4	18988912	.	G	A	5	3	8	0	0	8	0	0
4	18989253	.	T	G	1	2	3	0	0	3	0	0
4	18989389	.	G	A	2	3	5	0	2	7	0	0
4	18999680	.	C	T	1	5	6	0	9	15	0	0
4	19007187	.	C	T	0	4	4	0	7	11	0	0
4	19007357	.	C	T	1	3	4	0	5	9	0	0
4	19007377	.	T	A	3	4	7	0	0	7	0	0
4	19007506	.	T	C	9	0	9	0	4	13	0	0
4	19007615	.	G	A	4	4	8	0	0	8	0	0
4	19397640	.	A	T	12	14	26	0	3	29	0	0
4	19397641	.	A	T	17	9	26	0	3	29	0	0
4	19414905	.	G	A	12	4	16	0	0	16	0	0
4	19421890	.	G	A	11	5	16	0	1	17	0	0
4	19493773	.	G	T	12	17	29	0	0	29	0	0
4	19535360	.	T	A	8	14	22	0	0	22	0	0
4	19535841	.	T	G	15	8	23	0	1	24	0	0
4	19536344	.	A	T	18	13	31	0	0	31	0	0
4	19536554	.	A	T	11	12	23	0	3	26	0	0
4	19536953	.	C	T	22	19	41	0	1	42	0	0
4	19536959	.	G	A	23	18	41	0	0	41	0	0
4	19537268	.	G	A	3	27	30	0	19	49	0	0
4	19537703	.	A	G	30	26	56	0	4	60	0	0
4	19537803	.	A	C	21	32	53	0	10	63	0	0
4	19537937	.	A	G	33	0	33	0	25	58	0	0
4	19538578	.	A	T	16	32	48	0	9	57	0	0
4	19539017	.	C	T	11	8	19	0	0	19	0	0
4	19611694	.	G	A	7	13	20	0	0	20	0	0
4	19611739	.	T	G	8	3	11	0	0	11	0	0
4	19611769	.	G	A	5	5	10	0	0	10	0	0
4	19651917	.	G	A	4	2	6	0	0	6	0	0
4	19664993	.	T	C	5	0	5	0	6	11	0	0
4	19681585	.	C	T	3	9	12	0	0	12	0	0
4	19690484	.	C	A	0	2	2	0	3	5	0	0
4	19693953	.	T	C	3	0	3	0	5	8	0	0
4	19783537	.	C	T	1	2	3	0	0	3	0	0
4	19784819	.	A	G	1	2	3	0	0	3	0	0
4	19789222	.	G	A	1	2	3	0	0	3	0	0
4	19789267	.	C	T	1	3	4	0	1	5	0	0
4	19916830	.	C	T	1	3	4	0	0	4	0	0
4	19948131	.	G	A	6	2	8	0	0	8	0	0
4	19948746	.	T	C	4	5	9	1	0	10	0	0
4	19948826	.	A	G	1	1	2	0	1	3	0	0
4	19948829	.	C	T	1	2	3	0	0	3	0	0
4	19948883	.	C	G	3	4	7	0	1	8	0	0
4	19948960	.	C	T	5	5	10	0	1	11	0	0
4	19949083	.	T	C	4	0	4	0	4	8	0	0
4	19949388	.	C	A	0	4	4	0	4	8	0	0
4	19949565	.	T	G	2	2	4	0	0	4	0	0
4	19949651	.	C	T	0	4	4	0	2	6	0	0
4	19949730	.	T	C	5	2	7	0	0	7	0	0
4	19949793	.	C	T	1	7	8	0	3	11	0	0
4	19949865	.	T	A	9	8	17	0	0	17	0	0
4	19950115	.	C	A	1	4	5	0	0	5	0	0
4	19950156	.	G	T	1	2	3	0	0	3	0	0
4	20049403	.	A	T	4	3	7	0	0	7	0	0
4	20053901	.	C	T	21	12	33	0	0	33	0	0
4	20054036	.	C	T	16	12	28	0	1	29	0	0
4	20054243	.	A	G	4	3	7	0	0	7	0	0
4	20060589	.	A	G	1	2	3	0	1	4	0	0
4	20066208	.	G	A	5	4	9	0	0	9	0	0
4	20066276	.	G	A	0	4	4	0	6	10	0	0
4	20068185	.	A	G	7	5	12	0	1	13	0	0
4	20068446	.	G	A	7	12	19	0	0	19	0	0
4	20068950	.	G	A	11	6	17	0	0	17	0	0
4	20069091	.	T	C	4	7	11	0	1	12	0	0
4	20069343	.	C	A	10	8	18	0	0	18	0	0
4	20071344	.	A	T	8	4	12	0	3	15	0	0
4	20071401	.	G	T	6	9	15	0	1	16	0	0
4	20071509	.	T	C	4	2	6	0	0	6	0	0
4	20071604	.	T	C	4	0	4	0	8	12	0	0
4	20072129	.	T	G	1	7	8	0	1	9	0	0
4	20072176	.	A	T	4	6	10	0	0	10	0	0
4	20072429	.	T	G	8	9	17	0	0	17	0	0
4	20072441	.	C	T	11	10	21	0	1	22	0	0
4	20073790	.	T	C	14	10	24	0	0	24	0	0
4	20075025	.	A	G	4	8	12	0	0	12	0	0
4	20075028	.	T	C	4	8	12	0	0	12	0	0
4	20075455	.	T	C	9	6	15	0	0	15	0	0
4	20075473	.	G	A	8	6	14	0	0	14	0	0
4	20080778	.	T	A	4	2	6	0	0	6	0	0
4	20081443	.	T	C	1	1	2	0	0	2	0	0
4	20082639	.	A	T	2	5	7	0	0	7	0	0
4	20091024	.	T	C	2	4	6	0	0	6	0	0
4	20091055	.	G	C	1	2	3	0	5	8	0	0
4	20093155	.	A	T	8	5	13	0	0	13	0	0
4	20094257	.	T	C	8	6	14	0	0	14	0	0
4	20094438	.	C	T	5	4	9	0	0	9	0	0
4	20094460	.	G	C	3	3	6	0	0	6	0	0
4	20098630	.	T	C	6	5	11	0	0	11	0	0
4	20098662	.	T	A	5	4	9	0	2	11	0	0
4	20099131	.	C	T	4	8	12	0	0	12	0	0
4	20099261	.	C	T	4	4	8	1	1	11	1	0
4	20099564	.	C	T	5	5	10	0	0	10	0	0
4	20099631	.	T	C	6	4	10	0	1	11	0	0
4	20100081	.	C	T	5	2	7	0	0	7	0	0
4	20100730	.	A	T	6	9	15	0	0	15	0	0
4	20100754	.	A	G	8	0	8	0	8	16	0	0
4	20100805	.	C	T	8	7	15	0	1	16	0	0
4	20101072	.	G	A	9	4	13	0	0	13	0	0
4	20101207	.	C	T	9	4	13	0	0	13	0	0
4	20101399	.	A	C	6	12	18	0	0	18	0	0
4	20101404	.	G	A	6	12	18	0	1	19	0	0
4	20101508	.	A	G	5	6	11	0	0	11	0	0
4	20101510	.	A	T	6	5	11	0	0	12	1	0
4	20101562	.	T	C	4	2	6	0	0	6	0	0
4	20102188	.	C	T	4	3	7	0	0	7	0	0
4	20102291	.	C	T	2	4	6	0	1	7	0	0
4	20102905	.	A	T	3	3	6	0	0	6	0	0
4	20105434	.	G	A	3	2	5	0	0	5	0	0
4	20125874	.	C	T	5	3	8	0	0	8	0	0
4	20125890	.	T	C	6	3	9	0	1	10	0	0
4	20127787	.	C	T	4	3	7	0	0	7	0	0
4	20130015	.	G	T	1	2	3	0	1	4	0	0
4	20958929	.	G	A	0	3	3	0	3	6	0	0
4	20970268	.	T	A	4	7	11	0	1	12	0	0
4	20971490	.	C	T	6	4	10	0	0	10	0	0
4	20974226	.	C	T	4	3	7	0	0	7	0	0
4	20974235	.	C	G	4	5	9	0	0	9	0	0
4	20974343	.	C	A	3	6	9	0	0	9	0	0
4	20976252	.	G	A	1	3	4	0	1	5	0	0
4	20976371	.	C	T	3	3	6	0	1	7	0	0
4	20979223	.	C	T	4	6	10	0	1	11	0	0
4	20979410	.	C	A	4	6	10	0	1	11	0	0
4	20979435	.	C	A	4	4	8	0	0	8	0	0
4	20980971	.	A	G	5	4	9	0	2	11	0	0
4	20981184	.	T	C	7	8	15	0	0	15	0	0
4	20981198	.	G	A	1	10	11	0	6	17	0	0
4	20981273	.	A	C	8	3	11	0	1	12	0	0
4	20986930	.	A	T	8	5	13	0	1	14	0	0
4	20987317	.	A	T	7	5	12	0	0	12	0	0
4	20987326	.	T	G	8	4	12	0	1	13	0	0
4	21263703	.	C	T	17	13	30	0	0	30	0	0
4	21290798	.	G	A	24	16	40	0	1	41	0	0
4	21312731	.	C	G	33	26	59	0	1	60	0	0
4	21312981	.	C	T	23	28	51	0	5	56	0	0
4	21313779	.	T	G	36	28	64	0	2	66	0	0
4	21313805	.	G	A	2	28	30	0	42	72	0	0
4	21314036	.	T	A	33	26	59	0	3	62	0	0
4	21314338	.	G	T	36	31	67	0	3	70	0	0
4	21314663	.	C	T	29	34	63	0	1	64	0	0
4	21314771	.	T	C	34	36	70	0	2	72	0	0
4	21314940	.	C	T	37	36	73	1	3	77	0	0
4	21323345	.	C	A	11	6	17	0	0	17	0	0
4	21323363	.	G	C	8	5	13	0	1	14	0	0
4	21466187	.	C	G	0	4	4	0	3	7	0	0
4	21466265	.	A	G	3	5	8	0	0	8	0	0
4	21489110	.	G	A	9	15	24	0	3	27	0	0
4	21489242	.	G	A	17	8	25	0	2	27	0	0
4	21489550	.	A	G	10	1	11	0	6	17	0	0
4	21489975	.	T	A	13	26	39	0	3	43	1	0
4	21507026	.	G	A	8	12	20	0	0	20	0	0
4	21508317	.	G	A	12	13	25	0	1	26	0	0
4	21508410	.	T	C	16	1	17	0	18	35	0	0
4	21512191	.	C	T	17	10	27	3	0	30	0	0
4	21519783	.	C	T	6	12	18	0	1	19	0	0
4	21523541	.	A	T	13	5	18	2	0	20	0	0
4	21523789	.	T	G	10	11	21	0	0	21	0	0
4	21525430	.	G	T	4	8	12	0	0	12	0	0
4	21539658	.	G	A	10	4	14	0	2	16	0	0
4	21651465	.	A	T	37	27	64	0	3	67	0	0
4	21651525	.	G	A	37	28	65	1	1	67	0	0
4	21652609	.	A	T	8	9	17	0	0	17	0	0
4	21752284	.	G	A	14	8	22	1	1	24	0	0
4	21752291	.	C	T	13	5	18	1	3	22	0	0
4	21752372	.	T	A	7	9	16	0	0	16	0	0
4	21752495	.	C	G	4	5	9	0	0	9	0	0
4	21752688	.	G	C	5	1	6	0	16	22	0	0
4	21752699	.	C	T	13	8	21	0	0	21	0	0
4	21752728	.	A	T	13	13	26	0	2	28	0	0
4	21752736	.	T	C	13	13	26	0	3	29	0	0
4	21752867	.	T	C	10	14	24	1	1	26	0	0
4	21753145	.	T	C	20	12	32	0	0	32	0	0
4	21761688	.	A	T	15	15	30	0	1	31	0	0
4	21766808	.	G	A	14	16	30	0	0	30	0	0
4	21851415	.	G	T	4	4	8	1	0	9	0	0
4	21953163	.	C	T	1	2	3	0	0	3	0	0
4	21957708	.	C	G	1	3	4	0	0	4	0	0
4	21958150	.	C	T	13	17	30	0	1	31	0	0
4	21958210	.	A	C	11	15	26	0	0	26	0	0
4	21958276	.	C	T	3	14	17	0	16	33	0	0
4	21962364	.	T	A	14	12	26	0	1	27	0	0
4	21966846	.	T	A	0	2	2	0	0	2	0	0
4	21966850	.	T	A	1	2	3	0	0	3	0	0
4	21974853	.	C	T	5	7	12	0	1	13	0	0
4	21987662	.	G	A	7	6	13	0	0	13	0	0
4	21987695	.	C	T	8	6	14	0	2	16	0	0
4	21988402	.	G	A	5	9	14	0	2	16	0	0
4	21988481	.	G	A	10	9	19	0	0	19	0	0
4	21998286	.	A	G	1	3	4	0	0	4	0	0
4	22002244	.	A	C	3	4	7	0	0	7	0	0
4	22016531	.	C	T	0	2	2	0	3	5	0	0
4	22033404	.	G	A	5	5	10	0	0	10	0	0
4	22299747	.	G	A	8	7	15	0	0	15	0	0
4	22299976	.	A	G	1	0	1	0	8	9	0	0
4	22300045	.	G	C	2	6	8	0	1	9	0	0
4	22313195	.	G	C	10	8	18	0	1	19	0	0
4	22313216	.	T	G	9	9	18	0	0	18	0	0
4	22313351	.	G	A	7	8	15	0	4	20	1	0
4	22313397	.	C	A	4	7	11	0	1	12	0	0
4	22313398	.	T	A	4	3	7	0	4	11	0	0
4	22313582	.	T	C	8	0	8	0	6	14	0	0
4	22313677	.	A	G	6	4	10	0	0	10	0	0
4	22313861	.	T	A	8	9	17	0	1	18	0	0
4	22314001	.	A	T	6	8	14	0	0	14	0	0
4	22314094	.	A	C	8	7	15	0	0	15	0	0
4	22314279	.	G	A	3	6	9	0	1	10	0	0
4	22316323	.	C	T	1	9	10	0	7	17	0	0
4	22316481	.	C	T	6	5	11	0	0	11	0	0
4	22316558	.	G	A	9	11	20	0	0	20	0	0
4	22317702	.	T	A	5	8	13	0	0	13	0	0
4	22318046	.	A	G	8	3	11	0	0	11	0	0
4	22318144	.	C	T	5	9	14	0	2	16	0	0
4	22318395	.	C	T	7	3	10	0	0	10	0	0
4	22318415	.	G	A	6	4	10	0	1	11	0	0
4	22318574	.	T	C	1	5	6	0	0	6	0	0
4	22318640	.	A	T	6	1	7	0	3	10	0	0
4	22318750	.	G	T	7	3	10	0	0	10	0	0
4	22318828	.	G	A	8	7	15	0	0	15	0	0
4	22319033	.	G	A	4	4	8	0	0	8	0	0
4	22319101	.	G	T	3	2	5	0	1	6	0	0
4	22319133	.	G	A	1	7	8	0	0	8	0	0
4	22319562	.	G	A	3	9	12	0	0	12	0	0
4	22319840	.	T	C	3	3	6	0	1	7	0	0
4	22319951	.	C	T	2	5	7	0	0	7	0	0
4	22320043	.	C	T	2	3	5	0	0	5	0	0
4	22320056	.	C	T	2	2	4	0	0	4	0	0
4	22320156	.	G	A	10	3	13	0	0	13	0	0
4	22320996	.	C	T	1	2	3	0	0	3	0	0
4	22321175	.	T	C	3	4	7	0	1	8	0	0
4	22321176	.	G	A	3	5	8	0	0	8	0	0
4	22321226	.	T	C	1	2	3	0	0	3	0	0
4	22321246	.	T	C	3	2	5	0	0	5	0	0
4	22322003	.	C	A	2	4	6	0	0	6	0	0
4	22327352	.	C	T	4	3	7	0	0	7	0	0
4	22328163	.	C	T	1	2	3	0	0	3	0	0
4	22329327	.	T	C	1	2	3	0	0	3	0	0
4	22365114	.	C	T	12	6	18	0	2	20	0	0
4	22365163	.	G	C	6	10	16	0	0	16	0	0
4	22365251	.	G	A	11	6	17	0	1	18	0	0
4	22365356	.	T	G	10	7	17	0	2	19	0	0
4	22365400	.	G	A	11	9	20	0	1	21	0	0
4	22365489	.	C	A	20	13	33	0	1	34	0	0
4	22365747	.	C	T	17	18	35	0	2	37	0	0
4	22418493	.	G	T	36	20	56	0	3	59	0	0
4	22418966	.	C	G	32	26	58	0	1	59	0	0
4	22419003	.	A	G	26	27	53	0	3	56	0	0
4	22419473	.	C	A	28	29	57	0	3	60	0	0
4	22419663	.	T	G	6	13	19	1	0	20	0	0
4	22419739	.	A	G	3	0	3	0	6	9	0	0
4	22424854	.	G	A	15	15	30	0	1	31	0	0
4	22424927	.	A	T	25	18	43	0	3	46	0	0
4	22428110	.	G	A	5	15	20	0	1	21	0	0
4	22428148	.	C	T	2	10	12	0	16	28	0	0
4	22428745	.	C	T	3	7	10	0	12	22	0	0
4	22429021	.	T	C	8	4	12	0	1	13	0	0
4	22430827	.	C	T	2	14	16	0	13	29	0	0
4	22432794	.	T	A	12	6	18	0	1	19	0	0
4	22433062	.	C	T	8	7	15	0	0	15	0	0
4	22433348	.	G	A	15	10	25	0	1	26	0	0
4	22438644	.	C	T	5	8	13	0	0	13	0	0
4	22440324	.	C	T	6	7	13	1	0	14	0	0
4	22445415	.	C	T	0	6	6	0	3	9	0	0
4	22472603	.	A	T	6	4	10	0	0	10	0	0
4	22480266	.	G	T	27	26	53	0	3	56	0	0
4	22480279	.	T	A	22	27	49	0	1	50	0	0
4	22482708	.	A	G	2	4	6	0	0	6	0	0
4	22482828	.	C	G	4	6	10	0	1	11	0	0
4	22482923	.	T	C	10	9	19	0	1	20	0	0
4	22482930	.	G	A	10	11	21	0	0	21	0	0
4	22483117	.	T	A	4	4	8	0	1	9	0	0
4	22485085	.	C	T	4	4	8	0	2	11	1	0
4	22485148	.	C	T	0	6	6	0	4	10	0	0
4	22491854	.	G	A	5	2	7	0	2	9	0	0
4	22492322	.	T	A	4	8	12	0	1	13	0	0
4	22492367	.	A	T	8	3	11	0	1	12	0	0
4	22492406	.	T	C	10	6	16	0	0	16	0	0
4	22494630	.	C	T	5	4	9	0	1	10	0	0
4	22502671	.	T	C	3	5	8	0	1	9	0	0
4	22652698	.	A	C	3	4	7	0	0	7	0	0
4	22652782	.	T	C	2	2	4	0	0	4	0	0
4	22652836	.	G	A	4	5	9	0	0	9	0	0
4	22658838	.	A	G	7	7	14	0	0	14	0	0
4	22659899	.	T	C	12	12	24	0	0	24	0	0
4	22660036	.	A	T	11	14	25	0	0	25	0	0
4	22670410	.	A	G	2	4	6	0	0	6	0	0
4	22671170	.	T	A	1	3	4	0	0	4	0	0
4	22671354	.	T	C	6	4	10	0	2	12	0	0
4	22680636	.	G	T	2	11	13	0	11	24	0	0
4	22697095	.	C	G	12	0	12	0	14	26	0	0
4	22697209	.	T	C	15	14	29	0	0	29	0	0
4	22707767	.	T	C	26	27	53	0	1	54	0	0
4	22707820	.	C	T	27	19	46	0	2	48	0	0
4	22709147	.	C	T	17	22	39	14	1	54	0	0
4	22713026	.	G	A	21	14	35	0	2	37	0	0
4	22713260	.	A	G	13	1	14	0	11	25	0	0
4	22713644	.	A	G	24	16	40	0	3	43	0	0
4	22713946	.	T	G	12	0	12	0	17	29	0	0
4	22730951	.	A	C	4	8	12	0	0	12	0	0
4	22731883	.	C	T	5	3	8	0	0	8	0	0
4	22731943	.	T	G	8	4	12	0	0	12	0	0
4	22734643	.	C	T	7	4	11	0	0	11	0	0
4	22734676	.	C	T	6	5	11	0	2	13	0	0
4	22736977	.	A	G	4	3	7	0	0	7	0	0
4	22738694	.	C	T	4	2	6	0	0	6	0	0
4	22740936	.	T	C	2	4	6	0	0	6	0	0
4	22741066	.	A	G	3	4	7	0	0	7	0	0
4	22743616	.	A	G	4	4	8	0	1	9	0	0
4	22749481	.	C	T	4	6	10	0	0	10	0	0
4	22749482	.	T	C	4	6	10	0	0	10	0	0
4	22755549	.	T	C	6	0	6	0	8	14	0	0
4	22756239	.	T	C	15	15	30	0	0	30	0	0
4	22756301	.	A	C	17	12	29	0	2	31	0	0
4	22756333	.	C	T	15	9	24	0	2	26	0	0
4	22756436	.	G	A	12	8	20	0	0	20	0	0
4	22756593	.	A	T	8	6	14	0	2	16	0	0
4	22756879	.	G	A	4	3	7	0	0	7	0	0
4	22756886	.	C	T	1	3	4	0	4	8	0	0
4	22757136	.	A	T	7	6	13	0	0	13	0	0
4	22757402	.	T	G	5	7	12	0	0	12	0	0
4	22757494	.	T	A	4	8	12	0	2	14	0	0
4	22757519	.	A	T	3	11	14	0	0	14	0	0
4	22758095	.	C	T	10	2	12	0	1	13	0	0
4	22758343	.	C	T	4	8	12	0	1	13	0	0
4	22758553	.	C	T	1	4	5	0	10	15	0	0
4	22768137	.	G	T	4	4	8	0	0	8	0	0
4	22773483	.	T	C	3	4	7	0	0	7	0	0
4	22776277	.	G	T	5	4	9	0	0	9	0	0
4	22776286	.	G	A	4	3	7	0	0	7	0	0
4	22776849	.	A	G	2	3	5	0	1	6	0	0
4	22822855	.	G	A	3	4	7	0	0	7	0	0
4	22859115	.	G	A	2	2	4	0	0	4	0	0
4	22859133	.	T	C	3	1	4	0	2	6	0	0
4	22865973	.	T	C	2	0	2	0	4	6	0	0
4	22866064	.	G	A	2	2	4	0	0	4	0	0
4	23119427	.	T	C	3	3	6	0	0	6	0	0
4	23122759	.	T	C	2	3	5	0	0	5	0	0
4	23122999	.	T	C	3	6	9	0	0	9	0	0
4	23123160	.	A	T	2	2	4	0	1	5	0	0
4	23129080	.	A	G	2	4	6	0	0	6	0	0
4	23132725	.	G	A	7	4	11	0	1	12	0	0
4	23132830	.	A	G	2	0	2	0	11	13	0	0
4	23134282	.	C	G	11	10	21	0	3	24	0	0
4	23134520	.	T	C	10	8	18	0	1	19	0	0
4	23134541	.	G	A	8	6	14	0	0	14	0	0
4	23135038	.	G	A	3	2	5	0	0	5	0	0
4	23135047	.	G	A	4	4	8	0	0	8	0	0
4	23135186	.	G	C	4	2	6	0	1	7	0	0
4	23135194	.	G	T	0	2	2	0	5	7	0	0
4	23135330	.	A	G	4	6	10	0	0	10	0	0
4	23135354	.	G	C	3	6	9	0	0	9	0	0
4	23135399	.	A	T	9	4	13	0	0	13	0	0
4	23135406	.	C	T	11	4	15	0	0	15	0	0
4	23135717	.	C	G	2	3	5	0	0	5	0	0
4	23135791	.	A	C	5	5	10	0	0	10	0	0
4	23303552	.	C	G	1	4	5	0	0	5	0	0
4	23312240	.	G	A	1	2	3	2	0	5	0	0
4	23312264	.	T	C	3	3	6	0	0	6	0	0
4	23367891	.	G	A	5	5	10	0	2	12	0	0
4	23385119	.	A	G	5	3	8	2	1	11	0	0
4	23385122	.	C	T	7	3	10	2	0	12	0	0
4	23391628	.	T	C	8	4	12	0	1	13	0	0
4	23408029	.	G	A	6	8	14	0	0	14	0	0
4	23458752	.	G	T	5	3	8	0	1	9	0	0
4	23459111	.	C	T	2	5	7	0	0	7	0	0
4	23465482	.	A	G	3	2	5	1	0	6	0	0
4	23465570	.	G	T	3	7	10	1	1	12	0	0
4	23486639	.	G	A	10	3	13	4	0	17	0	0
4	23527631	.	G	A	5	3	8	4	0	12	0	0
4	23550737	.	C	T	2	2	4	0	0	4	0	0
4	23550740	.	C	A	2	3	5	0	0	5	0	0
4	23550854	.	C	T	1	2	3	0	3	6	0	0
4	23636947	.	A	G	3	4	7	1	0	8	0	0
4	23636987	.	C	A	2	4	6	1	0	7	0	0
4	23740734	.	T	G	2	3	5	0	0	5	0	0
4	23741132	.	T	G	4	1	5	0	0	5	0	0
4	23741146	.	G	A	2	2	4	0	1	5	0	0
4	23741169	.	G	C	2	1	3	0	0	3	0	0
4	23773192	.	A	T	3	4	7	0	0	7	0	0
4	23773210	.	T	A	1	3	4	0	1	5	0	0
4	23773529	.	A	G	4	3	7	0	0	7	0	0
4	23773977	.	A	G	8	7	15	0	0	15	0	0
4	23773982	.	T	G	7	5	12	0	0	12	0	0
4	23774038	.	C	A	2	3	5	0	0	5	0	0
4	23775252	.	C	A	14	7	21	0	2	23	0	0
4	23775435	.	T	G	1	0	1	0	14	15	0	0
4	23775630	.	G	C	10	0	10	0	10	20	0	0
4	23775759	.	C	T	1	5	6	0	10	16	0	0
4	23775827	.	T	C	6	1	7	0	4	11	0	0
4	23784376	.	A	G	3	4	7	0	0	7	0	0
4	23790723	.	A	G	3	4	7	0	1	8	0	0
4	23887175	.	G	A	9	9	18	1	8	27	0	0
4	23887318	.	C	T	4	13	17	0	19	36	0	0
4	23887847	.	T	A	6	6	12	0	0	12	0	0
4	23888406	.	A	T	8	13	21	0	0	21	0	0
4	23892938	.	C	T	1	8	9	0	12	21	0	0
4	23892998	.	G	A	9	11	20	0	3	23	0	0
4	23893052	.	C	A	8	10	18	0	0	18	0	0
4	23908758	.	C	T	8	9	17	0	0	17	0	0
4	23913316	.	C	T	9	14	23	0	2	25	0	0
4	23938614	.	G	A	9	14	23	0	0	23	0	0
4	23938617	.	C	T	10	12	22	0	2	24	0	0
4	24031700	.	T	C	2	4	6	0	1	7	0	0
4	25055230	.	G	A	27	21	48	0	2	50	0	0
4	25084596	.	A	G	4	5	9	0	0	9	0	0
4	25104684	.	C	T	4	7	11	0	1	12	0	0
4	25104957	.	C	T	11	8	19	0	0	19	0	0
4	25165623	.	A	G	3	9	12	0	1	13	0	0
4	25165692	.	C	T	8	4	12	0	0	12	0	0
4	25165694	.	A	G	8	4	12	0	0	12	0	0
4	25168368	.	G	A	5	5	10	0	1	11	0	0
4	25176420	.	C	T	33	27	60	4	2	66	0	0
4	25184430	.	T	A	1	7	8	0	0	8	0	0
4	25184559	.	C	T	3	6	9	0	0	9	0	0
4	25184565	.	G	A	3	6	9	0	0	9	0	0
4	25184603	.	G	A	5	3	8	0	0	8	0	0
4	25184890	.	C	T	5	7	12	0	0	12	0	0
4	25351703	.	T	C	1	5	6	0	0	6	0	0
4	25353985	.	T	C	3	4	7	0	1	8	0	0
4	25353994	.	T	C	2	3	5	0	0	5	0	0
4	25354048	.	C	T	3	2	5	0	1	6	0	0
4	25354069	.	T	C	4	2	6	0	0	6	0	0
4	25354389	.	C	A	4	4	8	0	0	8	0	0
4	25354412	.	C	T	5	4	9	0	1	10	0	0
4	25357238	.	A	T	2	4	6	0	0	6	0	0
4	25358412	.	T	C	1	2	3	0	0	3	0	0
4	25358624	.	T	A	3	3	6	0	0	6	0	0
4	25358687	.	T	C	1	3	4	0	0	4	0	0
4	25358713	.	A	G	1	3	4	0	0	4	0	0
4	25473316	.	T	G	5	2	7	0	1	8	0	0
4	25473708	.	A	T	10	4	14	0	1	15	0	0
4	25473927	.	C	A	1	5	6	0	14	20	0	0
4	25474177	.	T	C	18	8	26	0	2	28	0	0
4	25474301	.	T	C	16	15	31	0	4	35	0	0
4	25474305	.	A	T	17	15	32	0	2	34	0	0
4	25474419	.	C	T	0	6	6	0	19	25	0	0
4	25476524	.	A	T	10	7	17	0	1	18	0	0
4	25476629	.	G	A	12	4	16	0	0	16	0	0
4	25479114	.	G	A	12	6	18	0	1	19	0	0
4	25479126	.	A	G	12	6	18	0	1	19	0	0
4	25479704	.	G	A	6	3	9	0	0	9	0	0
4	25480923	.	A	T	8	3	11	0	2	13	0	0
4	25481635	.	G	A	2	4	6	0	0	6	0	0
4	25481656	.	T	C	3	5	8	0	0	8	0	0
4	25481683	.	G	A	4	4	8	0	1	9	0	0
4	25485348	.	G	A	3	4	7	0	0	7	0	0
4	25485350	.	G	A	3	4	7	0	0	7	0	0
4	25497411	.	T	C	5	1	6	0	3	9	0	0
4	25502038	.	C	T	17	12	29	0	0	29	0	0
4	25503078	.	T	C	10	0	10	0	8	18	0	0
4	25505955	.	C	A	11	3	14	0	1	15	0	0
4	25506944	.	T	C	6	0	6	0	12	18	0	0
4	25511451	.	T	C	8	6	14	0	0	14	0	0
4	25511562	.	T	C	13	0	13	0	7	20	0	0
4	25512840	.	C	T	8	4	12	0	0	12	0	0
4	25515513	.	A	T	14	4	18	0	0	18	0	0
4	25694636	.	T	C	2	2	4	2	0	6	0	0
4	25697282	.	T	G	2	3	5	0	0	5	0	0
4	25700800	.	A	T	4	4	8	0	0	8	0	0
4	25702919	.	C	T	7	7	14	0	0	14	0	0
4	25703048	.	G	A	5	4	9	0	0	9	0	0
4	25703135	.	C	A	2	2	4	0	0	4	0	0
4	25703139	.	C	T	2	2	4	0	0	4	0	0
4	25703181	.	G	A	1	1	2	0	0	2	0	0
4	25703251	.	C	T	5	3	8	0	0	8	0	0
4	25750826	.	C	T	3	2	5	0	1	6	0	0
4	25751003	.	A	G	5	0	5	0	3	8	0	0
4	25751196	.	A	C	2	1	3	0	1	4	0	0
4	25755201	.	G	A	4	4	8	0	0	8	0	0
4	25755269	.	C	T	12	9	21	0	0	21	0	0
4	25755341	.	T	A	4	6	10	0	0	10	0	0
4	25755359	.	G	T	4	6	10	0	0	10	0	0
4	25755437	.	C	T	0	2	2	0	3	5	0	0
4	25755922	.	C	T	2	4	6	0	1	7	0	0
4	25756105	.	A	G	1	2	3	0	0	3	0	0
4	25756148	.	A	G	3	2	5	0	0	5	0	0
4	25756262	.	C	A	4	3	7	0	0	7	0	0
4	25756305	.	A	C	4	7	11	0	0	11	0	0
4	25756387	.	T	G	1	3	4	0	1	5	0	0
4	25756432	.	A	G	3	5	8	0	0	8	0	0
4	25759088	.	T	A	4	7	11	0	0	11	0	0
4	25759183	.	T	C	6	4	10	0	1	11	0	0
4	25759198	.	C	T	1	4	5	0	7	12	0	0
4	25759690	.	A	G	3	5	8	0	1	9	0	0
4	25759816	.	T	C	1	4	5	0	0	5	0	0
4	25796742	.	T	C	4	0	4	0	8	12	0	0
4	25833146	.	A	G	30	23	53	0	3	56	0	0
4	25839817	.	A	C	12	0	12	0	5	17	0	0
4	25842977	.	G	A	6	7	13	0	1	14	0	0
4	25843004	.	A	G	3	6	9	0	0	9	0	0
4	25860509	.	T	C	3	2	5	0	0	5	0	0
4	25860758	.	A	T	3	6	9	0	0	9	0	0
4	25860842	.	G	A	2	8	10	0	0	10	0	0
4	25860868	.	A	G	4	6	10	0	1	11	0	0
4	25861165	.	A	G	5	2	7	0	0	7	0	0
4	25862231	.	A	G	2	3	5	0	0	5	0	0
4	25862270	.	A	G	2	3	5	0	0	5	0	0
4	25862579	.	A	T	1	2	3	0	0	3	0	0
4	25927026	.	C	T	2	2	4	0	0	4	0	0
4	25929486	.	A	G	1	3	4	0	0	4	0	0
4	25932628	.	A	G	1	0	1	0	5	6	0	0
4	25934667	.	G	A	4	2	6	0	0	6	0	0
4	25934709	.	C	T	9	5	14	0	0	14	0	0
4	25934722	.	T	C	7	3	10	0	1	11	0	0
4	25936512	.	C	T	6	5	11	0	0	11	0	0
4	25946450	.	A	G	6	3	9	1	0	10	0	0
4	25946479	.	C	T	9	4	13	1	1	15	0	0
4	25946522	.	T	G	5	2	7	3	0	10	0	0
4	25946722	.	G	C	5	5	10	1	0	11	0	0
4	26016340	.	A	C	4	5	9	0	2	11	0	0
4	26021910	.	A	G	3	5	8	0	0	8	0	0
4	26021970	.	C	A	4	6	10	0	3	13	0	0
4	26022076	.	T	C	5	0	5	0	4	9	0	0
4	26022447	.	T	C	2	0	2	0	6	8	0	0
4	26022637	.	T	C	3	6	9	0	0	9	0	0
4	26022640	.	C	T	2	5	7	0	3	10	0	0
4	26027022	.	A	G	1	5	6	0	1	7	0	0
4	26028947	.	C	T	1	3	4	0	4	8	0	0
4	26065274	.	C	T	1	2	3	0	0	3	0	0
4	26068170	.	T	C	3	1	4	0	1	5	0	0
4	26077426	.	C	T	12	4	16	0	1	17	0	0
4	26078134	.	A	G	1	4	5	0	1	6	0	0
4	26078410	.	T	C	4	2	6	0	0	6	0	0
4	26078412	.	A	C	4	2	6	0	0	6	0	0
4	26078675	.	A	T	3	2	5	0	0	5	0	0
4	26079353	.	A	C	2	3	5	0	1	6	0	0
4	26079372	.	C	T	3	4	7	0	0	7	0	0
4	26079443	.	A	G	3	4	7	0	1	8	0	0
4	26079635	.	C	T	1	2	3	0	0	3	0	0
4	26079761	.	A	T	4	5	9	0	1	10	0	0
4	26079844	.	A	G	2	4	6	0	0	6	0	0
4	26079940	.	T	C	3	2	5	0	0	5	0	0
4	26080071	.	T	C	11	6	17	0	0	17	0	0
4	26080102	.	A	T	10	6	16	0	0	16	0	0
4	26080222	.	A	G	7	4	11	0	0	11	0	0
4	26080294	.	A	G	8	7	15	0	1	16	0	0
4	26080321	.	A	G	11	5	16	0	1	17	0	0
4	26080414	.	A	T	3	13	16	0	6	22	0	0
4	26080440	.	T	C	6	5	11	0	1	12	0	0
4	26080593	.	T	C	5	8	13	0	0	13	0	0
4	26080651	.	G	A	3	7	10	0	0	10	0	0
4	26303911	.	A	G	4	8	12	0	1	13	0	0
4	26303953	.	T	C	10	11	21	0	1	22	0	0
4	26304190	.	T	A	8	10	18	0	0	18	0	0
4	26304451	.	T	C	9	20	29	0	0	29	0	0
4	26306209	.	A	G	9	8	17	0	0	17	0	0
4	26321216	.	A	G	9	8	17	0	1	18	0	0
4	26322651	.	C	T	5	8	13	0	0	13	0	0
4	26322655	.	C	A	0	4	4	0	9	13	0	0
4	26322721	.	C	T	0	8	8	0	17	25	0	0
4	26496683	.	G	A	7	5	12	0	0	12	0	0
4	26496730	.	G	A	5	6	11	0	0	11	0	0
4	26629672	.	C	T	7	13	20	0	1	21	0	0
4	26763314	.	A	T	3	2	5	0	1	6	0	0
4	26764217	.	C	T	4	13	17	0	1	18	0	0
4	26765359	.	A	T	4	2	6	0	0	6	0	0
4	27105026	.	A	C	1	2	3	0	0	3	0	0
4	27109288	.	A	T	4	4	8	0	0	8	0	0
4	27112663	.	T	A	2	3	5	0	1	6	0	0
4	27114333	.	A	G	1	2	3	0	2	5	0	0
4	27115478	.	A	G	3	8	11	0	0	11	0	0
4	27133735	.	C	T	2	3	5	0	0	5	0	0
4	27137406	.	C	T	4	3	7	0	0	7	0	0
4	27137517	.	T	A	1	4	5	0	0	5	0	0
4	27137874	.	G	A	2	2	4	0	0	4	0	0
4	27137991	.	T	G	5	3	8	0	1	9	0	0
4	27139922	.	A	G	2	3	5	0	0	5	0	0
4	27139955	.	T	A	3	2	5	0	0	5	0	0
4	27140658	.	A	G	5	2	7	0	0	7	0	0
4	27147712	.	C	T	6	8	14	0	1	15	0	0
4	27148046	.	G	A	0	5	5	0	3	8	0	0
4	27148142	.	T	C	7	4	11	0	0	11	0	0
4	27148267	.	A	G	4	8	12	0	0	12	0	0
4	27148291	.	G	T	6	4	10	0	1	11	0	0
4	27148417	.	T	C	8	9	17	2	0	19	0	0
4	27148425	.	A	T	6	9	15	2	2	19	0	0
4	27148545	.	A	C	8	6	14	0	0	14	0	0
4	27148927	.	G	A	3	4	7	0	1	8	0	0
4	27148943	.	A	C	6	4	10	0	0	10	0	0
4	27149017	.	G	A	0	7	7	0	5	12	0	0
4	27149634	.	A	T	4	2	6	0	1	7	0	0
4	27252027	.	T	C	11	8	19	0	0	19	0	0
4	27252096	.	C	T	8	5	13	0	0	13	0	0
4	27252813	.	C	T	16	15	31	1	3	35	0	0
4	27253043	.	T	A	16	20	36	0	3	39	0	0
4	27350432	.	G	T	8	6	14	0	0	14	0	0
4	27350674	.	C	G	1	5	6	0	8	14	0	0
4	27628113	.	G	A	1	2	3	0	0	3	0	0
4	27628300	.	C	A	3	1	4	0	1	5	0	0
4	27628686	.	C	A	0	2	2	0	1	3	0	0
4	27869698	.	C	T	0	2	2	0	2	4	0	0
4	27898949	.	C	T	3	3	6	0	0	6	0	0
4	27937093	.	G	A	0	7	7	0	3	10	0	0
4	27938777	.	G	A	7	7	14	0	0	14	0	0
4	27938837	.	G	A	6	5	11	0	0	11	0	0
4	27941562	.	T	A	7	5	12	0	1	14	1	0
4	27941588	.	C	T	6	4	10	0	0	10	0	0
4	27945947	.	C	T	6	4	10	0	1	11	0	0
4	27945995	.	G	A	1	2	3	0	6	9	0	0
4	27946067	.	A	T	4	4	8	0	2	10	0	0
4	27953774	.	C	T	5	5	10	0	0	10	0	0
4	28062951	.	T	C	4	5	9	0	0	9	0	0
4	35084692	.	C	T	2	2	4	2	0	6	0	0
4	37246202	.	C	T	3	2	5	0	0	5	0	0
4	37246221	.	A	G	3	2	5	0	0	5	0	0
4	42038973	.	G	A	5	2	7	1	0	8	0	0
4	46872732	.	C	T	3	6	9	0	0	9	0	0
4	49573842	.	A	C	3	3	6	0	0	6	0	0
4	50756495	.	G	A	2	5	7	0	2	9	0	0
4	57351478	.	G	A	3	2	5	1	0	6	0	0
4	60936891	.	T	C	1	2	3	0	0	3	0	0
4	65491852	.	G	A	1	5	6	2	0	8	0	0
4	65491860	.	C	T	1	4	5	2	0	7	0	0
4	65727802	.	C	T	7	3	10	3	0	13	0	0
4	65727822	.	G	A	6	3	9	4	1	14	0	0
4	68476545	.	C	T	2	3	5	0	0	5	0	0
4	68497154	.	T	A	3	2	5	0	1	6	0	0
4	68497199	.	G	A	2	4	6	0	0	6	0	0
4	70842953	.	G	T	3	2	5	0	0	5	0	0
4	70850966	.	G	T	4	4	8	0	0	8	0	0
4	70851202	.	T	C	5	0	5	1	5	11	0	0
4	70855931	.	T	C	12	2	14	1	1	16	0	0
4	70860034	.	A	C	6	2	8	0	12	20	0	0
4	70860166	.	A	G	11	8	19	5	0	24	0	0
4	70864034	.	G	A	5	4	9	0	0	9	0	0
4	70864037	.	C	T	0	4	4	1	5	10	0	0
4	70864441	.	C	G	2	3	5	0	0	5	0	0
4	70864466	.	G	A	1	2	3	0	0	3	0	0
4	70866683	.	C	T	2	2	4	0	0	4	0	0
4	70866787	.	A	T	5	5	10	0	0	10	0	0
4	70866791	.	A	T	5	5	10	0	0	10	0	0
4	72217285	.	T	C	2	5	7	0	1	8	0	0
4	72217405	.	C	T	2	4	6	0	0	6	0	0
4	72217438	.	A	C	2	4	6	0	0	6	0	0
4	72217495	.	C	A	4	2	6	0	2	8	0	0
4	72217508	.	C	T	4	2	6	0	0	6	0	0
4	72217647	.	T	C	2	4	6	0	0	6	0	0
4	72217779	.	A	G	1	0	1	0	3	4	0	0
4	72217813	.	T	C	3	5	8	0	0	8	0	0
4	72217847	.	G	A	0	2	2	0	2	4	0	0
4	72272239	.	G	A	4	4	8	0	0	8	0	0
4	72272461	.	C	T	2	3	5	0	1	6	0	0
4	72272491	.	A	G	2	2	4	0	2	6	0	0
4	72272617	.	G	A	4	3	7	0	0	7	0	0
4	72272779	.	T	C	3	5	8	0	0	8	0	0
4	72272890	.	A	C	1	0	1	0	2	3	0	0
4	72275250	.	G	A	1	3	4	0	0	4	0	0
4	72275308	.	C	T	8	3	11	0	0	11	0	0
4	72296038	.	A	T	1	2	3	0	0	3	0	0
4	72296261	.	C	G	0	5	5	0	2	7	0	0
4	72296413	.	C	G	2	4	6	0	0	6	0	0
4	72296433	.	C	G	2	3	5	0	0	5	0	0
4	72349083	.	G	A	1	3	4	0	0	4	0	0
4	72356870	.	G	A	1	2	3	0	0	3	0	0
4	72356895	.	G	T	2	3	5	0	0	5	0	0
4	72559585	.	A	G	4	2	6	0	0	6	0	0
4	72559612	.	A	G	4	2	6	0	0	6	0	0
4	72573242	.	A	C	2	2	4	0	0	4	0	0
4	72573245	.	T	C	2	0	2	0	2	4	0	0
4	72603483	.	C	A	3	2	5	0	0	5	0	0
4	72604255	.	G	A	2	3	5	0	1	6	0	0
4	72628932	.	G	A	1	2	3	0	0	3	0	0
4	72629058	.	C	T	0	2	2	0	1	3	0	0
4	72629250	.	T	A	2	3	5	0	0	5	0	0
4	72629739	.	G	A	3	3	6	0	0	6	0	0
4	72630316	.	G	A	2	4	6	0	0	6	0	0
4	72630351	.	C	A	4	3	7	0	0	7	0	0
4	72630360	.	C	G	4	2	6	0	0	6	0	0
4	72754244	.	C	T	22	16	38	1	3	42	0	0
4	72772769	.	T	C	13	17	30	0	1	31	0	0
4	72775687	.	C	A	14	24	38	0	1	39	0	0
4	72781277	.	A	G	22	21	43	0	3	46	0	0
4	72784800	.	T	C	9	16	25	0	0	25	0	0
4	72784939	.	T	G	1	0	1	0	7	8	0	0
4	72784940	.	A	C	1	7	8	0	0	8	0	0
4	72785129	.	C	G	1	4	5	1	0	6	0	0
4	72785147	.	T	C	1	3	4	1	0	5	0	0
4	72785425	.	C	T	1	2	3	0	0	3	0	0
4	72785903	.	G	A	2	4	6	0	1	7	0	0
4	72785914	.	T	C	2	3	5	0	0	5	0	0
4	73059149	.	C	T	3	3	6	0	0	6	0	0
4	73063082	.	A	G	0	1	1	0	5	6	0	0
4	73063117	.	C	T	3	2	5	0	0	5	0	0
4	73063863	.	A	C	1	2	3	2	0	5	0	0
4	73186320	.	G	A	1	1	2	0	1	3	0	0
4	73186489	.	G	A	1	3	4	0	0	4	0	0
4	73186532	.	T	G	1	2	3	0	0	3	0	0
4	73186557	.	G	A	1	2	3	0	0	3	0	0
4	73186793	.	C	T	0	2	2	0	1	3	0	0
4	73186835	.	C	T	2	2	4	0	0	4	0	0
4	73188129	.	G	A	1	3	4	0	0	4	0	0
4	73279340	.	T	C	1	0	1	0	3	4	0	0
4	73335530	.	A	G	2	2	4	0	0	4	0	0
4	73335990	.	T	A	2	2	4	0	0	4	0	0
4	73336629	.	C	T	5	2	7	0	0	7	0	0
4	73336748	.	C	T	0	3	3	0	4	7	0	0
4	73336818	.	C	T	4	2	6	0	1	7	0	0
4	73336863	.	A	C	7	3	10	0	0	10	0	0
4	73336869	.	G	C	6	2	8	0	0	8	0	0
4	73337244	.	A	G	1	3	4	0	0	4	0	0
4	73337248	.	G	A	2	3	5	0	0	5	0	0
4	73338060	.	C	A	2	3	5	1	0	6	0	0
4	73338062	.	T	C	2	2	4	1	1	6	0	0
4	73338166	.	G	A	2	3	5	0	0	5	0	0
4	73383550	.	T	C	4	6	10	0	0	10	0	0
4	73383553	.	G	A	4	6	10	0	0	10	0	0
4	73399255	.	T	G	1	4	5	2	0	7	0	0
4	73399278	.	A	G	1	4	5	2	0	7	0	0
4	73418744	.	A	T	2	6	8	0	0	8	0	0
4	73418823	.	T	C	3	5	8	0	0	8	0	0
4	73419026	.	C	T	1	1	2	0	1	3	0	0
4	73419160	.	C	T	4	5	9	1	2	12	0	0
4	73419209	.	G	T	1	4	5	0	1	6	0	0
4	73419217	.	G	A	1	3	4	0	0	4	0	0
4	73419550	.	G	A	3	6	9	0	0	9	0	0
4	73419970	.	G	A	2	5	7	0	0	7	0	0
4	73420191	.	G	T	1	5	6	0	0	6	0	0
4	73446988	.	C	G	0	2	2	0	1	3	0	0
4	73447096	.	C	T	0	2	2	0	2	4	0	0
4	73454803	.	T	C	3	3	6	0	0	6	0	0
4	73455516	.	G	A	2	2	4	0	0	4	0	0
4	73455814	.	T	C	1	2	3	0	0	3	0	0
4	73455828	.	C	T	0	3	3	0	1	4	0	0
4	73472873	.	A	T	1	2	3	0	0	3	0	0
4	73473364	.	A	G	2	2	4	0	0	4	0	0
4	73491109	.	G	C	3	2	5	0	0	5	0	0
4	73498655	.	G	A	2	1	3	0	4	7	0	0
4	73498714	.	A	G	2	3	5	0	0	5	0	0
4	73499279	.	T	C	9	3	12	0	0	12	0	0
4	73499736	.	T	A	2	2	4	0	1	5	0	0
4	73501606	.	A	T	2	2	4	0	0	4	0	0
4	73501699	.	T	C	2	2	4	0	0	4	0	0
4	73501858	.	C	T	4	2	6	0	0	6	0	0
4	73501963	.	G	A	4	2	6	0	0	6	0	0
4	73519301	.	T	A	1	3	4	0	1	5	0	0
4	73519433	.	A	G	4	4	8	1	0	9	0	0
4	73542302	.	C	G	1	4	5	0	1	6	0	0
4	73542303	.	A	G	2	4	6	0	0	6	0	0
4	73542582	.	A	G	3	5	8	0	0	8	0	0
4	73542913	.	A	G	3	3	6	0	1	7	0	0
4	73543687	.	T	C	2	1	3	0	1	4	0	0
4	73550610	.	A	T	3	3	6	0	0	6	0	0
4	73551456	.	T	C	2	3	5	0	0	5	0	0
4	73573799	.	T	A	3	2	5	0	0	5	0	0
4	73573923	.	C	G	2	2	4	0	1	5	0	0
4	73573926	.	A	C	2	1	3	0	0	3	0	0
4	73574374	.	G	A	4	2	6	0	0	6	0	0
4	73574386	.	T	A	4	3	7	0	0	7	0	0
4	73574579	.	A	G	2	1	3	0	1	4	0	0
4	73574583	.	C	G	3	2	5	0	0	5	0	0
4	73575094	.	T	C	1	2	3	0	0	3	0	0
4	73575171	.	A	G	1	4	5	0	0	5	0	0
4	73575576	.	G	T	3	6	9	0	0	9	0	0
4	73575958	.	C	T	2	2	4	0	0	4	0	0
4	73575967	.	C	T	2	1	3	0	1	4	0	0
4	73638451	.	T	C	1	2	3	0	0	3	0	0
4	73690631	.	C	T	5	2	7	0	0	7	0	0
4	73690653	.	T	C	3	3	6	0	0	6	0	0
4	73690711	.	C	T	3	2	5	0	0	5	0	0
4	73702473	.	G	A	1	3	4	0	0	4	0	0
4	73702490	.	T	G	1	1	2	0	1	3	0	0
4	73712311	.	A	T	1	3	4	0	0	4	0	0
4	73712313	.	C	T	1	3	4	0	0	4	0	0
4	73713173	.	C	T	1	3	4	0	0	4	0	0
4	73713289	.	T	C	1	0	1	0	2	3	0	0
4	73713818	.	A	G	2	3	5	0	0	5	0	0
4	73713850	.	G	T	2	6	8	0	0	8	0	0
4	73713907	.	G	T	1	2	3	0	0	3	0	0
4	73714386	.	T	A	1	3	4	0	0	4	0	0
4	73714421	.	G	A	1	3	4	0	0	4	0	0
4	73729780	.	C	A	2	3	5	0	0	5	0	0
4	73730609	.	A	G	1	2	3	0	0	3	0	0
4	73730644	.	G	A	2	2	4	0	0	4	0	0
4	73740087	.	G	A	2	2	4	0	1	5	0	0
4	73740157	.	C	G	3	2	5	0	0	5	0	0
4	73740169	.	G	C	3	2	5	0	0	5	0	0
4	73740301	.	G	A	5	5	10	0	1	11	0	0
4	73740391	.	C	G	11	7	18	0	0	18	0	0
4	73740409	.	C	A	8	8	16	0	1	17	0	0
4	73740517	.	A	G	1	2	3	0	1	4	0	0
4	73740651	.	G	C	3	4	7	0	0	7	0	0
4	73740691	.	T	A	2	4	6	0	1	7	0	0
4	73740763	.	T	A	1	3	4	0	1	5	0	0
4	73740879	.	A	C	7	6	13	0	1	14	0	0
4	73741110	.	T	A	1	3	4	0	0	4	0	0
4	73741212	.	C	T	2	2	4	0	0	4	0	0
4	73741217	.	T	C	3	0	3	0	2	5	0	0
4	73741258	.	G	A	4	2	6	0	0	6	0	0
4	73741283	.	T	C	5	3	8	0	0	8	0	0
4	73741298	.	A	G	4	3	7	0	0	7	0	0
4	73755900	.	G	A	2	3	5	0	1	6	0	0
4	73755904	.	A	T	2	3	5	0	0	5	0	0
4	73759983	.	A	G	3	2	5	0	0	5	0	0
4	73773222	.	T	G	2	5	7	0	0	7	0	0
4	73781928	.	T	C	2	2	4	0	0	4	0	0
4	73796484	.	A	G	1	2	3	0	1	4	0	0
4	73796694	.	C	T	2	2	4	0	0	4	0	0
4	73815897	.	T	A	3	3	6	0	0	6	0	0
4	73818170	.	A	C	1	0	1	0	2	3	0	0
4	73848472	.	T	C	1	0	1	0	3	4	0	0
4	73848513	.	T	C	2	2	4	0	0	4	0	0
4	73898168	.	G	T	2	3	5	0	1	6	0	0
4	73898170	.	C	T	3	3	6	0	0	6	0	0
4	73898879	.	C	T	3	2	5	0	0	5	0	0
4	73899248	.	A	G	2	2	4	0	0	4	0	0
4	73899293	.	A	G	1	2	3	0	0	3	0	0
4	73899511	.	A	G	6	0	6	0	4	10	0	0
4	73980112	.	G	A	4	2	6	0	0	6	0	0
4	73980836	.	C	A	3	2	5	0	0	5	0	0
4	73980954	.	G	A	2	2	4	0	0	4	0	0
4	74006572	.	C	T	1	3	4	0	0	4	0	0
4	74008378	.	T	A	1	2	3	0	0	3	0	0
4	74087951	.	G	A	7	5	12	0	4	16	0	0
4	74088060	.	T	G	21	14	35	0	3	38	0	0
4	74092153	.	T	C	22	16	38	0	1	39	0	0
4	74109763	.	A	T	8	13	21	0	1	22	0	0
4	74131583	.	T	G	3	0	3	0	7	10	0	0
4	74131652	.	T	C	5	5	10	0	0	10	0	0
4	74131717	.	G	A	1	8	9	0	10	19	0	0
4	74135244	.	G	T	5	8	13	0	1	14	0	0
4	74135295	.	A	G	9	4	13	0	0	13	0	0
4	74135415	.	C	T	9	8	17	0	0	17	0	0
4	74141580	.	C	A	2	5	7	0	0	7	0	0
4	74176550	.	G	A	2	3	5	0	0	5	0	0
4	74180716	.	G	A	1	7	8	0	11	19	0	0
4	74180788	.	T	C	5	7	12	0	1	13	0	0
4	74182382	.	G	C	10	8	18	0	2	20	0	0
4	74182389	.	G	T	12	8	20	0	2	22	0	0
4	74193480	.	C	G	2	6	8	0	1	9	0	0
4	74196686	.	T	C	5	6	11	0	1	12	0	0
4	74196704	.	T	C	9	6	15	0	1	16	0	0
4	74196764	.	G	T	10	12	22	0	0	22	0	0
4	74200391	.	C	T	10	10	20	0	1	21	0	0
4	74204177	.	T	C	17	7	24	0	2	26	0	0
4	74204236	.	G	T	1	6	7	0	9	16	0	0
4	74204387	.	G	T	8	8	16	0	0	16	0	0
4	74204842	.	A	G	10	11	21	0	1	22	0	0
4	74267225	.	A	G	6	13	19	0	1	20	0	0
4	74267348	.	C	T	8	4	12	0	0	12	0	0
4	74267519	.	A	G	23	10	33	0	1	34	0	0
4	74267540	.	G	A	2	17	19	0	15	34	0	0
4	74267582	.	T	G	10	14	24	0	0	24	0	0
4	74267639	.	T	A	17	10	27	0	1	28	0	0
4	74267733	.	A	T	19	18	37	0	1	38	0	0
4	74267748	.	C	T	18	15	33	0	5	38	0	0
4	74267865	.	A	C	16	6	22	0	1	23	0	0
4	74268175	.	A	G	11	10	21	0	0	21	0	0
4	74268182	.	C	T	12	9	21	0	0	21	0	0
4	74278079	.	T	G	3	3	6	0	1	7	0	0
4	74282709	.	C	T	8	4	12	0	0	12	0	0
4	74282917	.	G	A	5	10	15	0	0	15	0	0
4	74284790	.	A	C	2	6	8	0	0	8	0	0
4	74287776	.	T	A	2	5	7	1	0	8	0	0
4	74302501	.	T	A	2	2	4	0	0	4	0	0
4	74302502	.	T	C	2	0	2	0	2	4	0	0
4	74556163	.	A	G	3	0	3	0	2	5	0	0
4	74875802	.	A	G	3	2	5	0	0	5	0	0
4	74891524	.	C	T	0	3	3	0	1	4	0	0
4	74891548	.	A	G	0	1	1	0	0	1	0	0
4	74943202	.	A	T	11	14	25	0	0	25	0	0
4	74952477	.	G	A	12	11	23	0	1	24	0	0
4	74952525	.	A	G	13	0	13	0	13	26	0	0
4	74952660	.	G	T	5	13	18	0	18	36	0	0
4	74960826	.	C	T	12	15	27	0	3	30	0	0
4	74961011	.	C	T	17	9	26	0	4	30	0	0
4	74961075	.	G	A	16	16	32	0	0	32	0	0
4	74961520	.	T	A	2	5	7	0	1	8	0	0
4	75138707	.	G	A	2	6	8	0	1	9	0	0
4	75138750	.	A	G	3	5	8	0	0	8	0	0
4	75138987	.	C	T	7	12	19	0	1	20	0	0
4	75139002	.	A	T	7	5	12	0	0	12	0	0
4	75139194	.	C	T	12	11	23	0	2	25	0	0
4	75139264	.	T	C	14	12	26	0	0	26	0	0
4	75142269	.	G	A	7	13	20	0	0	20	0	0
4	75149056	.	C	T	11	15	26	0	0	26	0	0
4	75149071	.	T	A	12	12	24	0	3	27	0	0
4	75149125	.	C	A	0	12	12	0	8	20	0	0
4	75149149	.	C	T	0	9	9	0	9	18	0	0
4	75150806	.	T	G	9	5	14	0	1	15	0	0
4	75153925	.	C	T	10	6	16	0	0	16	0	0
4	75153930	.	G	A	10	6	16	0	1	17	0	0
4	75157664	.	T	C	1	4	5	0	2	7	0	0
4	75270438	.	G	C	3	8	11	0	0	11	0	0
4	75392271	.	C	T	3	5	8	0	0	8	0	0
4	75416605	.	C	T	5	3	8	0	0	8	0	0
4	75416647	.	G	A	2	3	5	0	0	5	0	0
4	75416760	.	G	A	0	3	3	0	3	6	0	0
4	75416980	.	C	T	2	3	5	0	0	5	0	0
4	75417138	.	C	T	2	2	4	0	0	4	0	0
4	75417250	.	T	G	3	2	5	0	0	5	0	0
4	75417258	.	T	A	2	2	4	0	0	4	0	0
4	75417414	.	C	T	3	3	6	0	0	6	0	0
4	75417441	.	C	T	1	4	5	0	0	5	0	0
4	75417608	.	C	A	2	1	3	0	1	4	0	0
4	75417916	.	C	A	2	4	6	0	0	6	0	0
4	75419127	.	A	T	5	2	7	0	0	7	0	0
4	75419342	.	A	T	7	3	10	0	0	10	0	0
4	75419353	.	C	T	6	4	10	0	1	11	0	0
4	75419528	.	G	C	1	5	6	0	1	7	0	0
4	75419551	.	G	C	4	4	8	0	0	8	0	0
4	75419653	.	G	A	11	4	15	0	0	15	0	0
4	75419819	.	C	G	8	6	14	0	0	14	0	0
4	75419822	.	A	C	7	5	12	0	1	13	0	0
4	75419916	.	G	T	10	9	19	0	1	20	0	0
4	75419928	.	T	G	11	0	11	0	7	18	0	0
4	75419961	.	A	C	13	10	23	0	2	25	0	0
4	75419970	.	G	A	2	10	12	0	14	26	0	0
4	75420159	.	T	C	9	5	14	0	0	14	0	0
4	75420186	.	A	G	6	0	6	0	3	9	0	0
4	75420270	.	A	G	6	9	15	0	0	15	0	0
4	75420318	.	T	A	11	5	16	0	1	17	0	0
4	75420931	.	A	T	5	1	6	0	1	7	0	0
4	75420934	.	A	G	4	2	6	0	1	7	0	0
4	76317041	.	T	C	1	2	3	0	0	3	0	0
4	76320439	.	C	T	4	3	7	0	1	8	0	0
4	76320752	.	G	A	8	4	12	3	0	15	0	0
4	76320798	.	C	G	4	5	9	2	0	11	0	0
4	76322882	.	G	A	0	7	7	2	7	16	0	0
4	76336468	.	T	A	2	4	6	0	0	6	0	0
4	76336471	.	A	C	4	2	6	0	0	6	0	0
4	76344109	.	C	A	3	3	6	0	0	7	1	0
4	76344120	.	C	A	4	3	7	0	0	7	0	0
4	76345974	.	A	G	2	6	8	1	0	9	0	0
4	76346004	.	T	C	4	3	7	1	1	9	0	0
4	76346011	.	T	C	6	3	9	1	0	10	0	0
4	76346153	.	G	C	2	4	6	0	1	7	0	0
4	76346188	.	T	A	6	9	15	0	0	15	0	0
4	76346238	.	C	A	8	3	11	5	0	16	0	0
4	76346554	.	A	G	6	0	6	0	7	13	0	0
4	76347126	.	T	C	5	4	9	1	0	10	0	0
4	76347163	.	A	G	5	2	7	0	0	7	0	0
4	76347460	.	A	G	5	5	10	0	2	12	0	0
4	76347541	.	G	C	5	3	8	0	2	10	0	0
4	76347977	.	A	T	1	4	5	0	0	5	0	0
4	76360500	.	T	A	1	1	2	0	3	5	0	0
4	76361212	.	C	A	1	2	3	0	0	3	0	0
4	76361229	.	T	C	3	3	6	0	0	6	0	0
4	76361286	.	T	C	2	2	4	0	0	4	0	0
4	76362977	.	T	G	1	2	3	0	0	3	0	0
4	76363060	.	A	C	2	7	9	0	0	9	0	0
4	76363195	.	C	T	1	2	3	0	2	5	0	0
4	76363204	.	A	C	2	2	4	0	0	4	0	0
4	76378159	.	C	A	2	2	4	0	0	4	0	0
4	76408988	.	G	A	2	12	14	0	0	14	0	0
4	76409020	.	G	A	1	6	7	0	0	7	0	0
4	76409192	.	A	G	2	2	4	0	1	5	0	0
4	76409226	.	G	A	2	2	4	0	0	4	0	0
4	76409375	.	A	T	3	2	5	0	1	6	0	0
4	76409385	.	C	G	4	3	7	0	1	8	0	0
4	76409422	.	C	T	2	6	8	0	1	9	0	0
4	76409494	.	A	C	3	2	5	0	0	5	0	0
4	76409882	.	A	G	1	4	5	0	0	5	0	0
4	76411005	.	A	G	3	5	8	0	0	8	0	0
4	76411072	.	A	C	2	5	7	0	0	7	0	0
4	76411346	.	T	C	2	4	6	0	0	6	0	0
4	76411505	.	C	T	2	5	7	0	0	7	0	0
4	76411517	.	T	C	2	8	10	0	0	10	0	0
4	76411990	.	A	G	2	0	2	0	13	15	0	0
4	76412531	.	A	T	2	5	7	0	0	7	0	0
4	76412570	.	G	A	5	3	8	0	0	8	0	0
4	76416857	.	G	T	3	4	7	0	0	7	0	0
4	76420875	.	C	T	1	1	2	0	0	2	0	0
4	76420883	.	G	A	2	2	4	0	0	4	0	0
4	76420930	.	T	A	2	2	4	0	0	4	0	0
4	76421193	.	C	T	1	5	6	0	0	6	0	0
4	76421515	.	T	A	1	2	3	0	0	3	0	0
4	76421602	.	A	C	5	2	7	0	0	7	0	0
4	76421886	.	C	T	1	3	4	0	0	4	0	0
4	76421958	.	C	T	1	5	6	0	0	6	0	0
4	76421987	.	G	T	3	2	5	0	0	5	0	0
4	76422231	.	G	A	1	6	7	0	0	7	0	0
4	76422424	.	A	G	3	4	7	0	1	8	0	0
4	76423234	.	G	A	3	3	6	2	1	9	0	0
4	76423537	.	C	T	2	6	8	0	1	9	0	0
4	76427137	.	G	C	3	8	11	0	0	11	0	0
4	76427145	.	A	G	3	10	13	0	0	13	0	0
4	76429102	.	A	G	1	7	8	0	1	9	0	0
4	76429719	.	G	T	1	5	6	2	0	8	0	0
4	76429969	.	G	A	3	5	8	0	1	9	0	0
4	76430115	.	G	A	4	5	9	0	2	11	0	0
4	76430256	.	G	A	2	3	5	0	0	5	0	0
4	76430257	.	A	G	2	3	5	0	0	5	0	0
4	76438019	.	A	T	2	2	4	0	0	4	0	0
4	76438049	.	T	C	4	2	6	0	0	6	0	0
4	76439021	.	A	G	2	1	3	0	1	4	0	0
4	76439374	.	C	T	1	3	4	0	1	5	0	0
4	76464354	.	C	T	1	3	4	0	0	4	0	0
4	76464704	.	T	G	3	3	6	0	0	6	0	0
4	76474078	.	G	A	4	3	7	0	1	8	0	0
4	76474127	.	A	G	4	2	6	0	0	6	0	0
4	76474339	.	G	C	2	4	6	0	0	6	0	0
4	76480491	.	A	C	5	5	10	0	1	11	0	0
4	76480834	.	C	G	1	5	6	0	1	7	0	0
4	76481168	.	C	G	6	5	11	0	0	11	0	0
4	76481177	.	T	C	6	0	6	0	5	11	0	0
4	76481262	.	A	G	5	3	8	0	0	8	0	0
4	76481403	.	T	A	7	9	16	0	0	16	0	0
4	76481409	.	T	G	7	9	16	0	1	17	0	0
4	76481511	.	A	G	6	4	10	0	2	12	0	0
4	76481572	.	G	A	3	5	8	0	0	8	0	0
4	76481576	.	C	A	3	5	8	0	0	8	0	0
4	76481665	.	A	T	8	2	10	0	0	10	0	0
4	76482245	.	C	T	3	5	8	0	0	8	0	0
4	76482273	.	C	G	2	3	5	0	1	6	0	0
4	76482509	.	G	A	4	3	7	0	1	8	0	0
4	76482696	.	T	A	2	3	5	0	0	5	0	0
4	76484531	.	T	C	4	4	8	0	1	9	0	0
4	76484688	.	C	T	1	2	3	0	0	3	0	0
4	76488624	.	A	G	4	2	6	0	0	6	0	0
4	76488742	.	G	C	4	4	8	0	0	8	0	0
4	76488820	.	G	A	1	3	4	1	0	5	0	0
4	76504205	.	A	G	1	3	4	0	0	4	0	0
4	76575587	.	A	G	1	2	3	0	0	3	0	0
4	76582384	.	A	G	1	2	3	0	0	3	0	0
4	76582665	.	G	T	5	2	7	0	0	7	0	0
4	76582696	.	G	A	2	3	5	0	3	8	0	0
4	76587462	.	T	C	9	6	15	0	1	16	0	0
4	76587474	.	C	T	10	6	16	2	0	18	0	0
4	76588133	.	A	C	13	6	19	5	3	27	0	0
4	76588134	.	C	G	15	0	15	4	7	26	0	0
4	76588177	.	T	C	10	7	17	0	1	18	0	0
4	76588295	.	G	T	9	3	12	0	0	12	0	0
4	76750984	.	T	C	2	2	4	0	0	4	0	0
4	76839294	.	G	A	4	2	6	0	0	6	0	0
4	76839306	.	C	T	4	2	6	0	0	6	0	0
4	76866860	.	A	G	5	4	9	0	0	9	0	0
4	76866875	.	A	G	1	0	1	2	7	10	0	0
4	76866993	.	A	G	9	6	15	0	1	16	0	0
4	76867743	.	T	C	15	8	23	0	0	23	0	0
4	77053734	.	A	T	2	2	4	0	1	5	0	0
4	77053738	.	G	A	0	2	2	0	3	5	0	0
4	77057006	.	G	A	1	3	4	0	0	4	0	0
4	77057152	.	C	A	1	4	5	0	0	5	0	0
4	77057169	.	A	G	1	3	4	0	0	4	0	0
4	77057671	.	G	A	2	1	3	0	0	3	0	0
4	77057695	.	C	G	0	0	0	0	2	2	0	0
4	77057877	.	A	T	2	3	5	0	0	5	0	0
4	77057914	.	A	T	4	3	7	0	1	8	0	0
4	77058313	.	C	T	2	3	5	0	0	5	0	0
4	77058320	.	G	T	2	3	5	0	0	5	0	0
4	77058420	.	C	G	1	2	3	0	0	3	0	0
4	77058436	.	A	T	1	4	5	0	0	5	0	0
4	77058503	.	G	C	3	4	7	0	1	8	0	0
4	77058543	.	G	A	2	4	6	0	2	8	0	0
4	77058723	.	A	G	2	4	6	0	1	7	0	0
4	77058754	.	T	C	3	5	8	0	0	8	0	0
4	77058875	.	T	A	2	4	6	0	0	6	0	0
4	77060002	.	A	G	3	2	5	0	0	5	0	0
4	77060087	.	A	G	5	3	8	0	0	8	0	0
4	77060260	.	G	A	3	2	5	0	1	6	0	0
4	77064908	.	C	G	5	2	7	0	0	7	0	0
4	77064946	.	A	G	4	2	6	0	0	6	0	0
4	77065265	.	G	A	3	2	5	0	0	5	0	0
4	77065304	.	A	T	2	2	4	0	0	4	0	0
4	77065342	.	A	T	4	4	8	0	0	8	0	0
4	77147410	.	C	T	1	2	3	0	0	3	0	0
4	77147450	.	T	C	1	2	3	0	0	3	0	0
4	77148162	.	A	G	0	3	3	0	1	4	0	0
4	77148661	.	T	C	2	5	7	0	2	9	0	0
4	77148695	.	G	T	2	6	8	0	0	8	0	0
4	77148706	.	G	C	1	5	6	0	1	7	0	0
4	77148807	.	T	C	2	3	5	0	0	5	0	0
4	77148814	.	G	A	0	2	2	0	2	4	0	0
4	77149729	.	G	A	1	3	4	0	1	5	0	0
4	77149765	.	C	T	1	4	5	0	1	6	0	0
4	77149805	.	A	T	8	4	12	0	0	12	0	0
4	77149888	.	C	T	1	6	7	0	1	8	0	0
4	77149989	.	C	A	3	2	5	0	0	5	0	0
4	77149990	.	T	G	3	2	5	0	0	5	0	0
4	77207726	.	G	A	1	3	4	0	1	5	0	0
4	77207728	.	T	A	1	3	4	0	1	5	0	0
4	77207768	.	G	C	1	5	6	0	1	7	0	0
4	77207903	.	C	T	1	10	11	0	7	18	0	0
4	77209054	.	A	G	10	9	19	0	5	24	0	0
4	77211866	.	G	A	10	9	19	0	0	19	0	0
4	77211872	.	G	A	11	9	20	0	0	20	0	0
4	77212126	.	G	T	6	6	12	0	1	13	0	0
4	77214843	.	C	A	1	6	7	0	3	10	0	0
4	77214846	.	G	A	3	6	9	0	0	9	0	0
4	77216563	.	C	A	3	5	8	1	1	10	0	0
4	77220252	.	T	C	3	0	3	0	2	5	0	0
4	77222714	.	C	A	2	2	4	0	0	4	0	0
4	77229982	.	T	A	1	2	3	0	0	3	0	0
4	77230003	.	T	A	3	1	4	0	1	5	0	0
4	77250925	.	T	C	9	7	16	0	0	16	0	0
4	77250931	.	T	C	8	6	14	0	0	15	1	0
4	77349372	.	A	G	1	2	3	0	0	3	0	0
4	77349374	.	G	A	1	2	3	0	0	3	0	0
4	77349501	.	G	A	1	5	6	0	0	6	0	0
4	77354716	.	A	G	1	3	4	0	0	4	0	0
4	77357903	.	T	A	1	2	3	0	1	4	0	0
4	77389707	.	G	C	2	0	2	0	1	3	0	0
4	77389712	.	G	A	2	2	4	0	0	4	0	0
4	77389776	.	A	C	4	4	8	0	1	9	0	0
4	77389832	.	G	C	4	9	13	0	0	13	0	0
4	77389877	.	C	T	9	8	17	0	1	18	0	0
4	77390006	.	G	A	15	5	20	0	0	20	0	0
4	77390083	.	A	T	8	7	15	0	1	16	0	0
4	77390164	.	G	T	4	9	13	0	0	13	0	0
4	77390174	.	C	T	7	9	16	0	0	16	0	0
4	77390254	.	T	G	6	7	13	0	1	14	0	0
4	77390288	.	A	C	5	13	18	0	2	20	0	0
4	77390314	.	A	G	7	14	21	0	0	21	0	0
4	77390347	.	G	C	10	10	20	0	1	21	0	0
4	77390400	.	G	A	13	11	24	0	1	25	0	0
4	77400439	.	G	T	7	3	10	0	0	10	0	0
4	77400454	.	A	T	6	2	8	0	0	8	0	0
4	77402753	.	A	G	1	2	3	0	1	4	0	0
4	77928526	.	G	C	3	2	5	0	0	5	0	0
4	77928565	.	T	C	13	12	25	0	1	26	0	0
4	77931408	.	G	A	17	18	35	0	0	35	0	0
4	77932143	.	C	T	22	15	37	0	2	39	0	0
4	77932186	.	T	C	12	16	28	0	3	31	0	0
4	77932198	.	A	G	16	14	30	0	2	32	0	0
4	77932221	.	A	G	11	13	24	0	3	27	0	0
4	77932408	.	G	C	12	11	23	0	0	23	0	0
4	77932414	.	T	C	10	9	19	0	0	19	0	0
4	77944562	.	T	C	2	5	7	0	0	7	0	0
4	77948591	.	G	A	3	2	5	0	0	5	0	0
4	77951184	.	T	C	2	2	4	0	1	5	0	0
4	77953610	.	A	G	6	0	6	0	9	15	0	0
4	77953718	.	T	C	1	2	3	0	1	4	0	0
4	77953731	.	G	A	0	3	3	0	1	4	0	0
4	77954267	.	T	C	0	2	2	0	2	4	0	0
4	77954290	.	T	A	2	3	5	0	0	5	0	0
4	77957641	.	A	G	1	0	1	0	2	3	0	0
4	77957718	.	C	A	5	3	8	0	0	8	0	0
4	77959109	.	T	C	4	3	7	0	0	7	0	0
4	77960215	.	T	A	11	8	19	0	1	20	0	0
4	77963210	.	C	G	10	3	13	0	0	13	0	0
4	77963270	.	A	G	5	6	11	0	1	12	0	0
4	77963637	.	T	G	2	0	2	0	4	6	0	0
4	77963819	.	C	T	8	9	17	0	0	17	0	0
4	77964574	.	C	A	10	11	21	0	0	21	0	0
4	77964609	.	G	A	0	11	11	0	9	20	0	0
4	77966107	.	T	C	2	3	5	0	0	5	0	0
4	77966135	.	C	T	3	7	10	0	0	10	0	0
4	77966336	.	G	T	2	3	5	0	0	5	0	0
4	77967545	.	C	T	2	6	8	0	0	8	0	0
4	77967578	.	G	C	1	8	9	0	0	9	0	0
4	77967745	.	A	G	1	0	1	0	8	9	0	0
4	77967759	.	G	A	1	8	9	0	2	11	0	0
4	77967850	.	A	G	1	0	1	0	3	4	0	0
4	77968534	.	G	A	3	5	8	0	0	8	0	0
4	77971350	.	A	G	1	0	1	0	2	3	0	0
4	77972024	.	C	A	2	2	4	0	0	4	0	0
4	77973929	.	G	A	0	2	2	0	2	4	0	0
4	77975895	.	T	G	4	2	6	0	0	6	0	0
4	77979228	.	C	T	1	3	4	0	1	5	0	0
4	77981599	.	C	T	2	5	7	0	0	7	0	0
4	77984473	.	C	A	3	4	7	0	0	7	0	0
4	77984705	.	C	A	2	4	6	0	0	6	0	0
4	77993148	.	T	A	5	6	11	0	0	11	0	0
4	77993813	.	T	C	6	6	12	0	0	12	0	0
4	77993916	.	G	A	8	6	14	0	2	16	0	0
4	77995476	.	T	C	6	10	16	0	3	19	0	0
4	77995941	.	C	T	9	13	22	0	1	23	0	0
4	77995990	.	C	G	10	3	13	0	1	14	0	0
4	77996032	.	C	A	11	7	18	0	2	20	0	0
4	77996171	.	C	T	12	8	20	0	0	20	0	0
4	78008782	.	T	C	17	23	40	0	0	40	0	0
4	78022570	.	A	G	2	5	7	0	0	7	0	0
4	78024247	.	A	G	26	23	49	0	1	50	0	0
4	78024558	.	C	T	1	33	34	0	21	55	0	0
4	78025040	.	C	T	20	22	42	0	3	45	0	0
4	78025052	.	T	G	22	20	42	0	3	45	0	0
4	78025223	.	C	T	3	26	29	0	21	50	0	0
5	299439	.	C	G	1	2	3	0	0	3	0	0
5	318077	.	G	A	9	8	17	0	0	17	0	0
5	318125	.	C	T	11	9	20	0	1	21	0	0
5	320383	.	T	C	6	0	6	0	10	16	0	0
5	340614	.	A	G	9	11	20	0	3	23	0	0
5	340667	.	T	C	10	11	21	0	0	21	0	0
5	341740	.	A	C	19	7	26	0	2	28	0	0
5	342047	.	A	G	6	17	23	1	2	26	0	0
5	342082	.	A	G	13	1	14	0	6	20	0	0
5	342167	.	A	G	4	0	4	0	5	9	0	0
5	342179	.	A	G	4	4	8	0	0	8	0	0
5	342228	.	C	T	3	4	7	0	0	7	0	0
5	393858	.	G	A	5	7	12	0	0	12	0	0
5	393979	.	T	C	7	6	13	0	2	16	1	0
5	394181	.	G	A	17	13	30	0	0	30	0	0
5	394184	.	T	C	16	12	28	0	1	29	0	0
5	394238	.	A	G	15	18	33	0	1	34	0	0
5	394239	.	T	G	15	19	34	0	0	34	0	0
5	394360	.	C	G	13	5	18	0	0	18	0	0
5	394417	.	G	A	3	6	9	0	14	23	0	0
5	394484	.	A	G	6	0	6	0	7	13	0	0
5	395404	.	T	A	4	16	20	0	0	20	0	0
5	395405	.	T	C	4	15	19	0	1	20	0	0
5	440032	.	A	G	8	0	8	0	8	16	0	0
5	440033	.	A	C	7	8	15	0	1	16	0	0
5	440106	.	T	C	7	5	12	0	0	12	0	0
5	457736	.	C	G	18	9	27	0	1	28	0	0
5	486597	.	C	T	7	3	10	0	1	11	0	0
5	489764	.	T	C	6	3	9	0	0	9	0	0
5	491375	.	C	T	3	2	5	0	0	5	0	0
5	491376	.	A	C	3	2	5	0	1	6	0	0
5	491832	.	T	C	4	4	8	0	0	8	0	0
5	491982	.	T	C	3	2	5	0	0	5	0	0
5	496604	.	G	T	2	3	5	1	11	17	0	0
5	894613	.	C	T	5	4	9	0	1	10	0	0
5	894882	.	T	A	4	4	8	0	0	8	0	0
5	895581	.	T	C	8	13	21	0	1	22	0	0
5	896908	.	C	A	5	12	17	0	0	17	0	0
5	899952	.	C	T	8	4	12	0	1	13	0	0
5	905263	.	C	A	4	7	11	0	0	11	0	0
5	917336	.	C	T	12	16	28	0	1	29	0	0
5	1055103	.	C	T	15	17	32	0	2	34	0	0
5	1059697	.	T	C	18	21	39	0	0	39	0	0
5	1064013	.	A	G	21	19	40	0	3	43	0	0
5	1068116	.	T	A	15	19	34	0	1	35	0	0
5	1079480	.	C	T	13	5	18	0	1	19	0	0
5	1079558	.	G	T	10	10	20	0	0	20	0	0
5	1083073	.	A	G	4	0	4	0	4	8	0	0
5	1083203	.	G	C	2	5	7	0	1	8	0	0
5	1083283	.	G	T	1	3	4	0	0	4	0	0
5	1083429	.	A	G	6	3	9	1	0	10	0	0
5	1083894	.	T	G	11	0	11	0	5	16	0	0
5	1149832	.	C	T	2	2	4	0	0	4	0	0
5	1152013	.	G	C	2	3	5	0	0	5	0	0
5	1155594	.	G	A	4	7	11	0	1	12	0	0
5	1187950	.	G	A	4	3	7	0	0	7	0	0
5	1207835	.	C	T	7	8	15	0	0	15	0	0
5	1216494	.	A	G	4	9	13	0	1	14	0	0
5	1216536	.	C	T	0	8	8	0	7	15	0	0
5	1216575	.	G	A	6	7	13	0	0	13	0	0
5	1218781	.	G	A	2	5	7	0	0	7	0	0
5	1219263	.	C	T	18	12	30	0	0	30	0	0
5	1219381	.	G	A	18	13	31	0	4	35	0	0
5	1223368	.	A	T	12	11	23	1	1	25	0	0
5	1223369	.	C	T	13	9	22	1	2	25	0	0
5	1240403	.	C	A	1	6	7	0	2	9	0	0
5	1240517	.	T	C	1	5	6	0	1	7	0	0
5	1240589	.	C	T	0	5	5	0	1	6	0	0
5	1299350	.	C	G	11	1	12	0	6	18	0	0
5	1311041	.	G	A	12	11	23	0	0	23	0	0
5	1317871	.	T	C	7	6	13	0	1	14	0	0
5	1317883	.	G	A	7	7	14	0	1	15	0	0
5	1346838	.	T	C	18	12	30	0	3	33	0	0
5	1420926	.	C	A	6	2	8	0	0	8	0	0
5	1420949	.	A	C	8	3	11	0	0	11	0	0
5	1420995	.	C	T	6	2	8	0	0	8	0	0
5	1420997	.	G	A	6	2	8	0	0	8	0	0
5	1421052	.	T	A	1	5	6	0	0	7	1	0
5	1438628	.	G	A	10	9	19	0	0	19	0	0
5	1451568	.	G	A	2	2	4	1	0	5	0	0
5	1451666	.	T	C	6	0	6	0	3	9	0	0
5	1456393	.	G	A	4	11	15	0	0	15	0	0
5	1456411	.	T	C	2	8	10	0	0	10	0	0
5	1467806	.	C	T	1	4	5	0	5	10	0	0
5	1519571	.	G	C	10	11	21	0	1	22	0	0
5	1519574	.	T	A	10	9	19	0	3	22	0	0
5	1624525	.	G	A	13	2	15	0	2	17	0	0
5	1653920	.	C	T	14	25	39	0	2	41	0	0
5	1653989	.	T	C	22	17	39	0	2	41	0	0
5	1688200	.	T	C	1	4	5	0	0	5	0	0
5	1706404	.	T	C	4	0	4	0	4	8	0	0
5	1707066	.	T	A	4	2	6	0	1	7	0	0
5	1726781	.	C	T	5	3	8	0	1	9	0	0
5	1729730	.	A	T	4	2	6	0	0	6	0	0
5	1730613	.	G	A	1	2	3	0	0	3	0	0
5	1869447	.	T	C	3	2	5	0	0	5	0	0
5	1950783	.	G	A	39	38	77	0	2	79	0	0
5	1952857	.	T	C	41	37	78	0	3	81	0	0
5	1952872	.	A	G	41	32	73	0	11	84	0	0
5	1952940	.	A	G	44	32	76	0	1	77	0	0
5	1953019	.	C	A	39	30	69	0	4	73	0	0
5	1955757	.	G	A	48	29	77	0	5	82	0	0
5	1957996	.	G	A	34	37	71	0	2	73	0	0
5	1958120	.	T	A	37	29	66	0	5	71	0	0
5	1962010	.	G	A	35	33	68	0	1	69	0	0
5	1991091	.	T	G	2	3	5	0	0	5	0	0
5	1991092	.	C	T	2	3	5	0	0	5	0	0
5	1991532	.	T	G	1	3	4	0	0	4	0	0
5	1997902	.	A	G	11	3	14	0	0	14	0	0
5	1997957	.	A	G	19	13	32	0	2	34	0	0
5	1997958	.	G	A	19	15	34	0	0	34	0	0
5	1998019	.	A	C	23	0	23	0	19	42	0	0
5	1999199	.	G	A	17	25	42	0	0	42	0	0
5	1999289	.	C	T	15	28	43	0	0	43	0	0
5	1999419	.	T	C	3	2	5	0	0	5	0	0
5	2047372	.	G	T	0	7	7	0	6	13	0	0
5	2066324	.	C	A	2	3	5	0	0	5	0	0
5	2067597	.	T	G	5	3	8	1	1	10	0	0
5	2067621	.	G	A	5	8	13	1	0	14	0	0
5	2067781	.	G	A	2	6	8	1	0	9	0	0
5	2067832	.	C	T	7	8	15	0	0	15	0	0
5	2067842	.	T	A	9	6	15	0	1	16	0	0
5	2068043	.	C	T	0	3	3	0	1	4	0	0
5	2068318	.	G	T	1	3	4	0	0	6	2	0
5	2068482	.	G	T	1	2	3	0	0	3	0	0
5	2068515	.	T	A	4	3	7	0	0	7	0	0
5	2068682	.	C	T	0	2	2	0	4	6	0	0
5	2068685	.	A	C	4	0	4	0	2	6	0	0
5	2068782	.	A	C	2	0	2	0	11	13	0	0
5	2069684	.	C	G	6	4	10	2	1	14	1	0
5	2086223	.	C	G	5	3	8	0	0	8	0	0
5	2242499	.	C	T	4	3	7	0	0	7	0	0
5	2242549	.	G	A	5	2	7	0	0	7	0	0
5	2242550	.	G	T	5	2	7	0	0	7	0	0
5	2242708	.	A	G	2	2	4	0	0	4	0	0
5	2242762	.	C	G	2	6	8	0	0	8	0	0
5	2242795	.	G	A	1	3	4	0	0	4	0	0
5	2242815	.	A	T	1	3	4	0	0	4	0	0
5	2243005	.	G	T	5	3	8	0	0	8	0	0
5	2248737	.	G	A	1	2	3	0	0	3	0	0
5	2410373	.	T	C	23	0	23	2	21	46	0	0
5	2410610	.	G	A	19	25	44	0	1	45	0	0
5	2413134	.	G	A	17	16	33	0	2	35	0	0
5	2413303	.	A	G	22	13	35	0	1	36	0	0
5	2413327	.	G	A	22	13	35	0	4	39	0	0
5	2419100	.	G	A	23	10	33	0	2	35	0	0
5	2420156	.	G	A	23	7	30	0	0	30	0	0
5	2426103	.	C	T	15	15	30	0	1	31	0	0
5	2434335	.	C	A	8	11	19	0	2	21	0	0
5	2434362	.	G	A	14	8	22	0	1	23	0	0
5	2434401	.	C	T	3	15	18	0	12	30	0	0
5	2434504	.	C	T	13	4	17	0	4	21	0	0
5	2434507	.	T	A	8	13	21	0	1	22	0	0
5	2435940	.	G	A	14	9	23	0	0	23	0	0
5	2451222	.	G	A	15	12	27	0	4	31	0	0
5	2451276	.	C	T	3	11	14	0	17	31	0	0
5	2451294	.	A	C	17	0	17	0	11	28	0	0
5	2454780	.	C	G	11	10	21	0	0	21	0	0
5	2454791	.	C	T	11	8	19	0	1	20	0	0
5	2457599	.	C	T	1	10	11	0	12	23	0	0
5	2460563	.	C	G	6	6	12	0	0	12	0	0
5	2461886	.	G	A	14	6	20	0	0	20	0	0
5	2463679	.	T	C	7	0	7	0	13	20	0	0
5	2464885	.	G	A	9	9	18	1	0	19	0	0
5	2467870	.	G	A	7	10	17	0	1	18	0	0
5	2509488	.	A	T	10	8	18	1	1	20	0	0
5	2509521	.	G	A	3	9	12	1	2	15	0	0
5	2521496	.	G	A	8	4	12	0	0	12	0	0
5	2571368	.	C	T	0	1	1	0	11	12	0	0
5	2658348	.	G	A	5	7	12	0	1	13	0	0
5	2681119	.	G	C	1	3	4	0	0	4	0	0
5	2686225	.	G	C	11	5	16	0	0	16	0	0
5	2689347	.	G	A	1	3	4	0	0	4	0	0
5	2689361	.	C	G	1	2	3	0	1	4	0	0
5	2713967	.	A	G	23	18	41	0	4	45	0	0
5	2714042	.	C	T	28	26	54	0	1	55	0	0
5	2714135	.	C	T	26	24	50	0	2	52	0	0
5	2714237	.	G	A	36	19	55	0	0	55	0	0
5	2714495	.	G	A	22	21	43	0	3	46	0	0
5	2714507	.	A	G	25	22	47	0	2	49	0	0
5	2714531	.	T	C	29	0	29	0	21	51	1	0
5	2716930	.	G	A	22	7	29	2	1	32	0	0
5	2716963	.	G	A	17	11	28	0	1	29	0	0
5	2717014	.	G	A	15	16	31	0	0	31	0	0
5	2717022	.	G	A	16	12	28	0	1	29	0	0
5	2717260	.	T	C	7	14	21	0	0	21	0	0
5	2717350	.	G	C	11	0	11	0	16	27	0	0
5	2717611	.	C	T	15	8	23	0	1	24	0	0
5	2717623	.	A	G	15	7	22	0	1	23	0	0
5	2717960	.	A	G	6	8	14	0	1	15	0	0
5	2718696	.	A	G	8	5	13	0	1	14	0	0
5	2718834	.	G	A	3	5	8	0	1	9	0	0
5	2720119	.	A	G	10	3	13	0	1	14	0	0
5	2721588	.	C	T	12	9	21	0	0	21	0	0
5	2744938	.	C	T	5	10	15	0	0	15	0	0
5	2744962	.	C	G	4	9	13	0	0	13	0	0
5	2744998	.	C	T	3	4	7	0	0	7	0	0
5	2745220	.	G	T	10	6	16	0	1	17	0	0
5	2750087	.	G	A	7	8	15	0	0	15	0	0
5	2750127	.	G	A	9	8	17	0	0	17	0	0
5	2750244	.	G	A	9	7	16	0	0	16	0	0
5	2750256	.	G	A	8	5	13	0	0	13	0	0
5	2751319	.	G	A	5	4	9	0	1	10	0	0
5	2751511	.	G	A	9	4	13	0	0	13	0	0
5	3118842	.	A	G	7	20	27	0	4	31	0	0
5	3127488	.	T	A	4	4	8	0	0	8	0	0
5	3185195	.	A	T	3	2	5	0	0	5	0	0
5	3192019	.	C	T	0	2	2	0	3	5	0	0
5	3502001	.	A	G	20	12	32	0	8	40	0	0
5	3544098	.	C	T	31	23	54	0	3	57	0	0
5	3544380	.	C	T	28	28	56	0	2	58	0	0
5	3544955	.	T	C	22	23	45	0	2	47	0	0
5	3545011	.	T	A	26	19	45	0	3	48	0	0
5	3568363	.	G	C	4	0	4	1	1	6	0	0
5	3568386	.	C	T	1	3	4	0	7	12	1	0
5	3568401	.	G	A	8	5	13	0	0	13	0	0
5	3568494	.	C	T	13	17	30	0	0	30	0	0
5	3568518	.	G	T	10	13	23	0	1	24	0	0
5	3611613	.	T	C	7	0	7	2	6	15	0	0
5	3611638	.	T	A	3	5	8	2	2	12	0	0
5	3612063	.	G	A	4	3	7	0	0	7	0	0
5	3612118	.	G	A	2	3	5	0	1	6	0	0
5	3612122	.	T	G	0	4	4	0	0	4	0	0
5	3612254	.	A	G	2	8	10	0	1	11	0	0
5	3617983	.	A	G	7	3	10	0	1	11	0	0
5	3617992	.	G	A	9	2	11	0	2	13	0	0
5	3618043	.	A	G	8	5	13	0	0	13	0	0
5	3891528	.	C	A	7	3	10	0	1	11	0	0
5	3892688	.	G	T	6	5	11	0	1	13	1	0
5	3898074	.	G	A	6	3	9	0	0	9	0	0
5	3901558	.	T	C	5	3	8	0	0	8	0	0
5	3906272	.	C	T	2	3	5	1	0	6	0	0
5	3906293	.	C	T	1	2	3	1	1	5	0	0
5	3914668	.	C	T	15	18	33	0	0	33	0	0
5	3914701	.	G	A	19	19	38	0	3	41	0	0
5	3927700	.	C	T	6	8	14	0	1	15	0	0
5	3937641	.	C	T	2	2	4	0	0	4	0	0
5	4024797	.	G	T	7	3	10	0	0	10	0	0
5	4037394	.	T	C	7	7	14	0	1	15	0	0
5	4037469	.	C	T	9	7	16	0	4	20	0	0
5	4040153	.	G	A	11	14	25	0	0	25	0	0
5	4041064	.	C	T	6	10	16	0	0	16	0	0
5	4041181	.	T	C	14	8	22	0	1	23	0	0
5	4041671	.	C	A	9	16	25	0	1	26	0	0
5	4048760	.	A	G	13	16	29	0	1	30	0	0
5	4048820	.	C	T	15	13	28	0	0	28	0	0
5	4051551	.	C	T	15	19	34	0	1	35	0	0
5	4051594	.	A	G	11	0	11	0	21	32	0	0
5	4142284	.	T	G	3	2	5	0	0	5	0	0
5	4142581	.	T	A	1	3	4	0	0	4	0	0
5	4142582	.	T	G	1	3	4	0	0	4	0	0
5	4254061	.	C	T	1	11	12	0	8	20	0	0
5	4260672	.	G	A	6	11	17	0	1	18	0	0
5	4263154	.	G	C	15	14	29	0	2	31	0	0
5	4263241	.	G	T	12	22	34	0	1	35	0	0
5	4263297	.	G	T	20	10	30	0	2	32	0	0
5	4263322	.	C	T	21	12	33	0	0	33	0	0
5	4265441	.	G	A	7	6	13	0	2	15	0	0
5	4265468	.	C	T	1	8	9	0	7	16	0	0
5	4269325	.	G	T	9	16	25	0	3	28	0	0
5	4273144	.	T	C	15	6	21	0	2	23	0	0
5	4273159	.	T	C	18	11	29	0	1	30	0	0
5	4273216	.	G	A	18	16	34	0	0	34	0	0
5	4278433	.	G	A	15	13	28	0	0	28	0	0
5	4292545	.	A	T	5	2	7	0	0	7	0	0
5	4292578	.	A	G	5	3	8	0	0	8	0	0
5	4296556	.	C	G	8	9	17	0	0	17	0	0
5	4308861	.	G	A	12	7	19	0	0	19	0	0
5	4373684	.	C	T	9	3	12	0	1	13	0	0
5	4373701	.	G	T	0	3	3	0	11	14	0	0
5	4382543	.	A	G	7	6	13	0	0	13	0	0
5	4387137	.	T	G	11	6	17	0	0	17	0	0
5	4444829	.	G	A	5	2	7	0	0	7	0	0
5	4445039	.	T	C	3	2	5	0	0	5	0	0
5	4448306	.	T	C	1	2	3	0	0	3	0	0
5	4469658	.	G	A	0	3	3	0	1	4	0	0
5	4470225	.	T	G	2	0	2	0	3	5	0	0
5	4482992	.	G	A	15	6	21	0	0	21	0	0
5	4493427	.	C	G	2	7	9	0	4	13	0	0
5	4523677	.	T	C	6	0	6	0	3	9	0	0
5	4528225	.	G	A	9	3	12	0	0	12	0	0
5	4532499	.	A	G	3	3	6	0	0	6	0	0
5	4729334	.	G	A	4	6	10	0	0	10	0	0
5	4921265	.	T	C	1	2	3	0	0	3	0	0
5	5171358	.	T	A	2	2	4	0	0	4	0	0
5	5308502	.	A	G	2	6	8	0	0	8	0	0
5	5313840	.	C	T	0	3	3	0	2	5	0	0
5	5313879	.	T	C	1	4	5	0	0	5	0	0
5	5321110	.	A	G	3	2	5	1	1	7	0	0
5	5321191	.	C	T	1	2	3	1	0	4	0	0
5	5325934	.	C	T	3	1	4	0	1	5	0	0
5	5399006	.	G	A	6	3	9	0	0	9	0	0
5	5399019	.	C	T	3	7	10	0	0	10	0	0
5	5406529	.	T	C	3	4	7	0	0	7	0	0
5	5406568	.	C	T	2	7	9	0	0	9	0	0
5	5434071	.	G	C	1	3	4	0	2	6	0	0
5	5498155	.	C	T	5	2	7	0	0	7	0	0
5	5498206	.	G	A	5	3	8	0	0	8	0	0
5	5619670	.	G	T	4	2	6	0	0	6	0	0
5	5619677	.	C	G	0	3	3	0	4	7	0	0
5	5619722	.	A	G	2	4	6	0	0	6	0	0
5	5622094	.	C	G	2	1	3	0	2	5	0	0
5	5628979	.	C	T	3	2	5	0	0	5	0	0
5	5666936	.	C	T	1	2	3	0	0	3	0	0
5	5696023	.	G	A	0	3	3	0	1	4	0	0
5	5696044	.	T	C	1	2	3	0	0	3	0	0
5	5708595	.	C	G	9	11	20	0	0	20	0	0
5	5720021	.	G	A	3	3	6	0	1	7	0	0
5	5733101	.	T	C	4	2	6	0	0	6	0	0
5	5733130	.	C	T	3	5	8	0	0	8	0	0
5	5733227	.	C	G	5	4	9	0	0	9	0	0
5	5736673	.	A	G	2	1	3	0	0	3	0	0
5	5736683	.	C	T	1	2	3	0	1	4	0	0
5	6858380	.	C	A	8	14	22	0	0	22	0	0
5	6858540	.	T	A	15	6	21	0	3	24	0	0
5	6858779	.	G	T	0	8	8	0	14	22	0	0
5	6863647	.	C	T	19	10	29	0	4	33	0	0
5	6863768	.	G	C	10	17	27	0	0	27	0	0
5	6863793	.	G	A	22	11	33	0	1	34	0	0
5	6863834	.	A	G	13	1	14	0	9	23	0	0
5	6863855	.	G	A	9	7	16	0	2	18	0	0
5	6863912	.	A	C	5	8	13	0	1	14	0	0
5	6864010	.	C	T	2	5	7	0	0	7	0	0
5	8006212	.	T	A	5	2	7	1	2	10	0	0
5	8006474	.	A	G	2	3	5	0	2	7	0	0
5	8006503	.	A	G	2	12	14	0	0	14	0	0
5	8537820	.	T	C	1	3	4	0	0	4	0	0
5	8537821	.	T	C	2	2	4	0	0	4	0	0
5	8703338	.	G	A	1	8	9	0	0	9	0	0
5	9443250	.	T	C	1	3	4	0	2	6	0	0
5	9443251	.	T	C	3	3	6	0	0	6	0	0
5	9823873	.	T	A	0	1	1	0	0	1	0	0
5	9823889	.	G	A	1	3	4	0	0	4	0	0
5	9823922	.	T	G	1	3	4	0	0	4	0	0
5	9824694	.	G	A	3	1	4	0	1	5	0	0
5	9824885	.	C	T	3	3	6	0	0	6	0	0
5	9824894	.	G	T	3	3	6	0	0	6	0	0
5	9983463	.	G	T	1	2	3	0	0	3	0	0
5	10046718	.	G	A	0	5	5	0	2	7	0	0
5	10046839	.	G	A	0	2	2	0	3	5	0	0
5	10053778	.	C	A	1	2	3	0	0	3	0	0
5	10055905	.	T	A	2	2	4	0	0	4	0	0
5	10056128	.	T	C	1	2	3	0	0	3	0	0
5	10056181	.	T	G	1	0	1	0	2	3	0	0
5	10766286	.	G	A	5	13	18	0	0	18	0	0
5	10766505	.	A	G	15	18	33	4	3	40	0	0
5	10766529	.	G	A	18	14	32	5	3	40	0	0
5	10766879	.	A	G	9	12	21	0	1	22	0	0
5	10767113	.	C	T	10	13	23	0	1	25	1	0
5	10767259	.	A	G	20	17	37	0	0	37	0	0
5	10767456	.	G	A	8	5	13	0	0	13	0	0
5	10767588	.	C	T	5	3	8	0	0	8	0	0
5	10768089	.	G	A	7	7	14	0	1	15	0	0
5	10768182	.	G	A	6	6	12	0	0	12	0	0
5	10768215	.	T	C	6	0	6	0	5	11	0	0
5	10946038	.	G	A	2	3	5	0	1	6	0	0
5	10946085	.	G	T	4	3	7	0	0	7	0	0
5	11250049	.	C	T	2	2	4	0	1	5	0	0
5	11507602	.	A	G	3	6	9	0	2	11	0	0
5	11573461	.	C	T	7	3	10	0	1	11	0	0
5	11812278	.	C	T	4	4	8	0	0	8	0	0
5	11816599	.	G	A	4	8	12	0	0	12	0	0
5	11824059	.	G	A	0	5	5	0	5	10	0	0
5	11824188	.	T	C	6	5	11	0	1	12	0	0
5	11826347	.	T	C	6	5	11	0	0	11	0	0
5	11836437	.	T	C	16	12	28	0	0	28	0	0
5	11864572	.	C	G	1	4	5	0	1	6	0	0
5	11864593	.	A	G	2	3	5	0	0	5	0	0
5	11864774	.	T	G	12	6	18	0	0	18	0	0
5	11869576	.	C	A	0	5	5	0	8	13	0	0
5	11900230	.	T	C	7	1	8	0	9	17	0	0
5	11905038	.	G	A	4	6	10	0	0	10	0	0
5	11905044	.	A	C	4	4	8	0	0	8	0	0
5	11905661	.	T	C	5	0	5	0	4	9	0	0
5	11905725	.	C	T	3	2	5	0	1	6	0	0
5	11905890	.	A	G	4	6	10	0	1	11	0	0
5	11905903	.	T	G	5	5	10	0	0	10	0	0
5	11917125	.	C	T	5	7	12	0	0	12	0	0
5	11917405	.	G	A	9	13	22	0	0	22	0	0
5	11917436	.	G	A	7	10	17	0	0	17	0	0
5	11917485	.	G	A	12	8	20	0	1	21	0	0
5	11917596	.	C	A	1	15	16	0	13	30	1	0
5	11933155	.	A	G	6	9	15	0	0	15	0	0
5	11935444	.	G	A	11	5	16	0	1	17	0	0
5	11937564	.	A	T	4	2	6	0	0	6	0	0
5	11943662	.	A	C	5	5	10	0	1	11	0	0
5	11943868	.	G	A	3	8	11	0	2	13	0	0
5	11943934	.	C	A	6	5	11	0	0	11	0	0
5	11943948	.	T	A	5	5	10	0	0	10	0	0
5	11943989	.	G	A	4	3	7	0	0	7	0	0
5	11944060	.	T	G	3	6	9	0	0	9	0	0
5	11949244	.	G	T	10	8	18	0	1	19	0	0
5	11959776	.	G	T	2	15	17	0	14	31	0	0
5	11959777	.	C	T	16	15	31	0	0	31	0	0
5	11959818	.	C	T	15	16	31	0	2	33	0	0
5	11959966	.	C	G	11	8	19	0	4	23	0	0
5	11959988	.	G	A	2	13	15	0	9	24	0	0
5	11982950	.	C	A	4	3	7	0	1	8	0	0
5	11983395	.	T	A	9	3	12	1	0	13	0	0
5	11983548	.	C	G	3	9	12	0	0	12	0	0
5	11984086	.	T	C	5	2	7	0	1	8	0	0
5	11984133	.	C	T	5	3	8	0	1	9	0	0
5	11984808	.	C	T	1	6	7	0	1	8	0	0
5	11985842	.	T	A	2	2	4	0	0	4	0	0
5	11985843	.	G	T	2	2	4	0	0	4	0	0
5	12000924	.	A	G	2	2	4	0	0	4	0	0
5	12100335	.	G	A	5	6	11	0	0	11	0	0
5	12113257	.	T	C	2	0	2	0	2	4	0	0
5	12115313	.	A	G	1	2	3	0	0	3	0	0
5	12136669	.	G	C	1	2	3	0	0	3	0	0
5	12146026	.	A	G	2	4	6	0	0	6	0	0
5	12284075	.	C	T	21	15	36	0	1	37	0	0
5	12285172	.	T	C	14	1	15	0	12	27	0	0
5	12285316	.	C	T	4	2	6	0	2	8	0	0
5	12285499	.	C	A	4	2	6	0	0	6	0	0
5	12285504	.	C	A	1	4	5	0	0	5	0	0
5	12285601	.	C	G	6	3	9	0	1	10	0	0
5	12288541	.	A	G	12	7	19	0	1	20	0	0
5	12297084	.	C	T	10	12	22	0	0	22	0	0
5	12322321	.	G	A	7	7	14	0	0	14	0	0
5	12357538	.	G	A	10	7	17	0	0	17	0	0
5	12357554	.	C	T	6	5	11	0	1	12	0	0
5	12454563	.	T	C	6	0	6	0	4	10	0	0
5	12503554	.	G	A	2	3	5	0	0	5	0	0
5	12530423	.	G	T	4	8	12	0	1	13	0	0
5	12530425	.	C	A	4	9	13	0	0	13	0	0
5	12533070	.	G	A	3	3	6	0	0	6	0	0
5	12533197	.	C	T	5	3	8	0	1	9	0	0
5	12535785	.	A	T	2	4	6	0	1	7	0	0
5	12549258	.	C	T	14	8	22	0	0	22	0	0
5	12549642	.	C	A	3	3	6	0	0	6	0	0
5	12549776	.	G	T	0	2	2	0	1	3	0	0
5	12549807	.	A	G	1	6	7	0	0	7	0	0
5	12549981	.	G	T	3	6	9	0	1	10	0	0
5	12553935	.	C	T	0	4	4	0	7	11	0	0
5	12554073	.	G	A	1	5	6	0	0	6	0	0
5	12554119	.	A	G	5	3	8	0	1	9	0	0
5	12620755	.	G	T	1	1	2	0	0	2	0	0
5	12620762	.	T	C	1	2	3	0	0	3	0	0
5	12625831	.	A	T	2	5	7	0	0	7	0	0
5	12645971	.	G	A	2	4	6	0	0	6	0	0
5	12648074	.	G	A	2	4	6	0	0	6	0	0
5	12664330	.	T	C	1	2	3	0	0	3	0	0
5	12701139	.	C	T	1	2	3	0	0	3	0	0
5	12724121	.	C	T	7	7	14	0	1	15	0	0
5	12724224	.	G	A	12	8	20	0	0	20	0	0
5	12724249	.	A	C	6	6	12	0	0	12	0	0
5	12724292	.	C	A	6	4	10	0	0	10	0	0
5	12724307	.	A	G	6	6	12	0	0	12	0	0
5	12724412	.	A	G	7	2	9	0	0	9	0	0
5	12724450	.	C	T	0	8	8	0	6	14	0	0
5	12724505	.	C	A	15	10	25	0	1	26	0	0
5	12724518	.	G	C	17	0	17	0	10	27	0	0
5	12724567	.	A	G	14	15	29	0	0	29	0	0
5	12724694	.	C	T	1	7	8	0	14	22	0	0
5	12725930	.	G	A	20	26	46	0	2	48	0	0
5	12726842	.	A	G	16	23	39	0	0	39	0	0
5	12729397	.	C	T	7	14	21	0	0	21	0	0
5	12732247	.	C	T	8	7	15	0	0	15	0	0
5	12734883	.	G	T	7	12	19	0	1	20	0	0
5	12734910	.	T	C	7	13	20	0	1	21	0	0
5	12743011	.	C	A	4	4	8	0	0	8	0	0
5	12809409	.	G	C	1	0	1	0	2	3	0	0
5	12809410	.	T	G	1	2	3	0	0	3	0	0
5	12837064	.	G	A	4	5	9	0	1	10	0	0
5	12865111	.	A	G	11	10	21	0	0	21	0	0
5	12865134	.	A	G	3	15	18	0	1	19	0	0
5	12903862	.	G	C	2	2	4	0	0	4	0	0
5	12905717	.	C	A	2	3	5	0	0	5	0	0
5	12905968	.	T	G	5	3	8	0	0	8	0	0
5	12906014	.	C	T	5	3	8	0	0	8	0	0
5	12906273	.	C	T	5	5	10	1	0	11	0	0
5	12908828	.	C	A	2	3	5	0	0	5	0	0
5	12935223	.	A	G	1	3	4	0	1	5	0	0
5	12956918	.	T	C	6	8	14	0	0	14	0	0
5	12956960	.	C	T	8	4	12	0	1	13	0	0
5	12975297	.	G	A	0	5	5	0	12	17	0	0
5	12975532	.	C	T	7	5	12	0	1	13	0	0
5	12979889	.	C	T	3	2	5	0	1	6	0	0
5	13037199	.	C	T	1	5	6	0	2	8	0	0
5	13037203	.	C	T	2	3	5	0	3	8	0	0
5	13037723	.	A	G	6	3	9	0	0	9	0	0
5	13037939	.	T	G	6	10	16	0	0	16	0	0
5	13037967	.	G	A	5	10	15	0	1	16	0	0
5	13037998	.	A	G	8	10	18	0	2	20	0	0
5	13105020	.	C	T	17	24	41	1	5	47	0	0
5	13105070	.	C	A	5	35	40	0	13	53	0	0
5	13112979	.	G	A	11	11	22	0	0	22	0	0
5	13167048	.	A	T	9	4	13	0	0	13	0	0
5	13214048	.	T	C	2	3	5	0	1	6	0	0
5	13214116	.	C	T	2	3	5	0	0	5	0	0
5	13214637	.	C	G	7	6	13	0	0	13	0	0
5	13227057	.	C	T	1	4	5	0	3	8	0	0
5	13229024	.	C	A	3	2	5	0	0	5	0	0
5	13229846	.	G	T	2	3	5	0	0	5	0	0
5	13237809	.	G	A	2	2	4	0	0	4	0	0
5	13239172	.	A	G	3	2	5	0	0	5	0	0
5	13239412	.	A	G	2	3	5	0	1	6	0	0
5	13308738	.	G	A	1	3	4	0	0	4	0	0
5	13308846	.	G	T	1	2	3	0	0	3	0	0
5	13309174	.	T	C	11	1	12	0	9	21	0	0
5	13309215	.	C	T	11	14	25	0	0	25	0	0
5	13309273	.	C	T	13	18	31	0	0	31	0	0
5	13309309	.	G	A	13	15	28	0	0	28	0	0
5	13309402	.	A	G	5	18	23	0	1	24	0	0
5	13309435	.	A	T	3	22	25	0	1	26	0	0
5	13309522	.	G	A	6	19	25	1	2	28	0	0
5	13312671	.	A	T	11	15	26	0	1	27	0	0
5	13312746	.	G	A	11	9	20	0	0	20	0	0
5	13315490	.	G	C	18	15	33	0	1	34	0	0
5	13315526	.	T	C	15	8	23	0	1	24	0	0
5	13315603	.	A	C	12	11	23	0	1	24	0	0
5	13332930	.	A	G	1	4	5	0	0	5	0	0
5	13335291	.	C	T	4	2	6	0	0	6	0	0
5	13335333	.	G	A	4	3	7	0	0	7	0	0
5	13335373	.	G	T	0	2	2	0	5	7	0	0
5	13335423	.	C	T	4	2	6	0	3	9	0	0
5	13337803	.	C	T	7	11	18	0	1	19	0	0
5	13337883	.	T	A	17	12	29	0	4	33	0	0
5	13338441	.	C	T	0	23	23	0	16	39	0	0
5	13338762	.	A	T	8	9	17	0	2	19	0	0
5	13339038	.	G	C	15	14	29	2	10	41	0	0
5	13415128	.	A	T	1	2	3	0	0	3	0	0
5	13415131	.	A	G	1	0	1	0	1	2	0	0
5	13465095	.	T	C	5	3	8	0	0	8	0	0
5	13468108	.	G	T	0	3	3	0	6	9	0	0
5	13468172	.	C	T	5	3	8	0	0	8	0	0
5	13468440	.	T	A	1	3	4	0	2	6	0	0
5	13468574	.	G	A	1	3	4	0	1	5	0	0
5	13468655	.	G	A	1	4	5	0	0	5	0	0
5	13468656	.	A	T	1	4	5	0	0	5	0	0
5	13469137	.	C	A	1	2	3	0	0	3	0	0
5	13472279	.	C	T	3	2	5	0	0	5	0	0
5	13472295	.	G	T	2	3	5	0	0	5	0	0
5	13473334	.	G	A	1	2	3	0	3	6	0	0
5	13539403	.	A	G	6	0	6	1	5	12	0	0
5	13539493	.	A	G	2	0	2	0	4	6	0	0
5	13540689	.	C	T	6	5	11	0	0	11	0	0
5	13540738	.	C	T	3	4	7	0	1	8	0	0
5	13540846	.	T	A	5	3	8	0	0	8	0	0
5	13554146	.	A	G	1	2	3	0	0	3	0	0
5	13557614	.	T	C	1	2	3	0	0	3	0	0
5	13615462	.	G	A	2	1	3	0	1	4	0	0
5	13615482	.	C	T	2	2	4	0	0	4	0	0
5	13643325	.	G	A	16	12	28	0	3	31	0	0
5	13643411	.	C	T	2	28	30	0	8	38	0	0
5	13643824	.	G	A	13	18	31	0	2	33	0	0
5	13644126	.	A	T	21	22	43	0	0	43	0	0
5	13644185	.	T	G	13	22	35	0	0	35	0	0
5	13644189	.	T	G	14	18	32	0	4	36	0	0
5	13644227	.	A	G	11	14	25	1	3	29	0	0
5	13644256	.	A	T	10	11	21	7	4	32	0	0
5	13644581	.	T	G	18	19	37	0	3	40	0	0
5	13644602	.	T	A	19	18	37	0	2	41	2	0
5	13644781	.	C	T	11	10	21	0	1	22	0	0
5	13644797	.	A	G	12	11	23	0	0	23	0	0
5	13645047	.	C	G	17	15	32	0	1	33	0	0
5	13645746	.	A	G	16	14	30	0	1	31	0	0
5	13645885	.	T	C	15	8	23	0	1	24	0	0
5	13649518	.	C	T	19	15	34	0	0	34	0	0
5	13652410	.	T	C	12	22	34	0	2	36	0	0
5	13671624	.	G	T	4	6	10	0	1	11	0	0
5	13671631	.	A	C	8	4	12	0	1	13	0	0
5	13671899	.	C	G	21	14	35	0	0	35	0	0
5	13672004	.	C	T	3	21	24	0	21	45	0	0
5	13672211	.	C	T	13	28	41	0	1	42	0	0
5	13672232	.	C	T	26	13	39	0	0	39	0	0
5	13673016	.	C	G	1	16	17	0	21	38	0	0
5	13684132	.	A	G	17	20	37	0	0	37	0	0
5	13684502	.	C	A	8	13	21	0	16	37	0	0
5	13814793	.	A	G	1	9	10	0	1	11	0	0
5	15809903	.	C	T	1	4	5	0	0	5	0	0
5	16718993	.	G	C	3	4	7	0	0	7	0	0
5	16720830	.	G	A	7	7	14	0	0	14	0	0
5	16800437	.	A	G	9	10	19	0	0	19	0	0
5	16800710	.	T	C	16	1	17	0	15	32	0	0
5	16800955	.	C	T	0	11	11	0	9	20	0	0
5	16815222	.	C	G	16	11	27	0	0	27	0	0
5	16818828	.	G	A	21	13	34	0	2	36	0	0
5	16818858	.	T	G	18	11	29	0	1	30	0	0
5	16833631	.	A	G	8	12	20	0	0	20	0	0
5	16916446	.	T	C	8	4	12	0	1	13	0	0
5	16916476	.	G	A	15	5	20	0	0	20	0	0
5	16916575	.	T	C	7	6	13	0	1	14	0	0
5	16928099	.	T	C	14	0	14	0	6	20	0	0
5	16956501	.	G	A	8	7	15	0	0	15	0	0
5	16956615	.	C	T	7	8	15	0	2	17	0	0
5	16982624	.	G	A	9	9	18	0	3	21	0	0
5	16983206	.	C	T	6	8	14	0	0	14	0	0
5	17726335	.	T	A	1	0	1	0	12	13	0	0
5	17727417	.	C	A	9	8	17	0	0	17	0	0
5	17727421	.	A	C	8	8	16	0	1	17	0	0
5	17731592	.	C	A	5	3	8	0	1	9	0	0
5	17738720	.	G	A	0	6	6	0	9	15	0	0
5	17751119	.	G	A	7	6	13	0	1	14	0	0
5	17751681	.	G	A	0	17	17	0	5	22	0	0
5	17751894	.	A	T	8	18	26	0	3	29	0	0
5	17751939	.	A	G	14	15	29	0	1	30	0	0
5	17752545	.	A	G	18	21	39	0	0	39	0	0
5	17752702	.	C	T	12	4	16	0	1	17	0	0
5	17752778	.	A	T	9	8	17	0	0	17	0	0
5	17753529	.	A	T	16	10	26	0	3	29	0	0
5	17788888	.	T	C	3	3	6	0	0	6	0	0
5	17805041	.	G	C	1	2	3	0	0	3	0	0
5	17812618	.	G	A	1	2	3	0	0	3	0	0
5	17813007	.	G	A	0	3	3	0	4	7	0	0
5	17813008	.	G	T	4	3	7	0	0	7	0	0
5	17813051	.	T	G	1	4	5	0	0	5	0	0
5	17813181	.	C	T	5	5	10	0	1	11	0	0
5	17848892	.	G	T	0	2	2	0	1	3	0	0
5	17881793	.	T	G	1	4	5	0	0	5	0	0
5	17881851	.	A	T	5	3	8	0	0	8	0	0
5	17881995	.	A	T	4	2	6	0	1	7	0	0
5	17882282	.	T	A	5	6	11	0	1	12	0	0
5	17882291	.	C	T	6	6	12	0	0	12	0	0
5	17882438	.	G	A	4	6	10	0	0	10	0	0
5	17882454	.	G	A	4	6	10	0	0	10	0	0
5	17885194	.	T	C	4	0	4	0	9	13	0	0
5	17885287	.	A	C	4	2	6	0	1	7	0	0
5	17885902	.	G	A	5	5	10	0	0	10	0	0
5	17885920	.	C	T	3	3	6	0	0	6	0	0
5	17885995	.	A	G	3	7	10	0	0	10	0	0
5	17891709	.	G	A	4	3	7	0	0	7	0	0
5	18827368	.	T	C	4	6	10	0	0	10	0	0
5	19008335	.	A	G	24	10	34	4	9	47	0	0
5	20416565	.	G	C	1	3	4	0	4	8	0	0
5	20416618	.	A	T	5	8	13	0	1	14	0	0
5	20416958	.	T	C	10	4	14	0	0	14	0	0
5	20417018	.	A	C	8	7	15	0	0	15	0	0
5	20417099	.	T	C	8	3	11	0	1	12	0	0
5	20417180	.	G	A	1	7	8	0	9	17	0	0
5	20417274	.	G	A	1	4	5	0	6	11	0	0
5	20417399	.	G	C	2	5	7	0	0	7	0	0
5	20417405	.	C	G	1	6	7	0	0	7	0	0
5	20417515	.	T	C	7	4	11	0	1	12	0	0
5	20417631	.	T	G	4	0	4	0	7	11	0	0
5	20418958	.	A	T	6	4	10	0	1	11	0	0
5	20419008	.	A	T	9	6	15	0	0	15	0	0
5	20419087	.	A	G	9	9	18	0	2	20	0	0
5	20419563	.	A	C	9	3	12	0	0	12	0	0
5	20419613	.	G	A	5	4	9	0	1	10	0	0
5	20443949	.	A	G	4	4	8	0	1	9	0	0
5	20444017	.	G	T	10	13	23	0	1	24	0	0
5	20444216	.	G	C	16	22	38	0	5	43	0	0
5	20445065	.	G	A	15	17	32	0	2	34	0	0
5	20445985	.	A	T	21	25	46	0	1	47	0	0
5	20446021	.	T	A	11	15	26	0	0	26	0	0
5	20457291	.	T	C	4	8	12	0	1	13	0	0
5	20457390	.	C	T	6	6	12	0	0	12	0	0
5	20467641	.	A	G	4	8	12	0	0	12	0	0
5	20471875	.	G	C	7	12	19	0	1	20	0	0
5	20473812	.	A	G	3	0	3	1	10	14	0	0
5	20473818	.	G	A	1	8	9	1	3	13	0	0
5	20474076	.	A	G	11	10	21	0	1	22	0	0
5	20475730	.	A	G	10	12	22	0	0	22	0	0
5	20477419	.	T	C	15	16	31	0	2	33	0	0
5	20479921	.	C	A	7	9	16	0	2	18	0	0
5	20479990	.	A	G	5	12	17	0	3	20	0	0
5	20480036	.	A	T	5	8	13	0	0	13	0	0
5	20480401	.	G	A	2	12	14	0	1	15	0	0
5	20480758	.	T	A	8	15	23	0	0	23	0	0
5	20480867	.	C	T	7	14	21	0	1	22	0	0
5	20481132	.	G	A	7	6	13	0	1	14	0	0
5	20485863	.	A	C	2	2	4	0	0	4	0	0
5	20485896	.	T	C	2	4	6	0	0	6	0	0
5	20485912	.	G	T	1	3	4	0	0	4	0	0
5	20485965	.	C	T	2	4	6	0	1	7	0	0
5	20486338	.	G	A	1	2	3	0	0	3	0	0
5	20486485	.	G	A	1	4	5	0	0	5	0	0
5	20486727	.	G	T	6	7	13	0	0	13	0	0
5	20486746	.	A	G	4	4	8	0	0	8	0	0
5	20486866	.	T	C	4	3	7	0	1	8	0	0
5	20487175	.	A	G	6	4	10	0	0	10	0	0
5	20487328	.	G	A	6	2	8	0	0	8	0	0
5	20487379	.	G	A	5	5	10	0	0	10	0	0
5	20487490	.	A	G	3	3	6	0	0	6	0	0
5	20627301	.	G	A	1	4	5	0	0	5	0	0
5	20627337	.	G	A	1	4	5	0	0	5	0	0
5	20627556	.	G	T	2	2	4	0	1	5	0	0
5	20627569	.	A	G	3	1	4	0	1	5	0	0
5	20627917	.	T	G	2	4	6	0	0	6	0	0
5	20628036	.	G	A	3	3	6	0	0	6	0	0
5	20638976	.	A	T	2	4	6	0	0	6	0	0
5	20647434	.	A	G	4	3	7	0	0	7	0	0
5	20678070	.	T	C	3	4	7	0	0	7	0	0
5	20787190	.	T	C	8	4	12	0	1	13	0	0
5	20933321	.	C	A	6	32	38	0	3	41	0	0
5	21295883	.	G	A	11	10	21	0	1	22	0	0
5	21296027	.	T	C	8	0	8	0	12	20	0	0
5	21296298	.	C	G	7	14	21	0	0	21	0	0
5	21296363	.	T	C	10	0	10	0	12	22	0	0
5	21296527	.	A	G	6	14	20	0	1	21	0	0
5	21296693	.	G	T	16	16	32	0	3	35	0	0
5	21296720	.	T	A	9	17	26	0	0	26	0	0
5	21296822	.	T	C	11	11	22	0	1	23	0	0
5	21297014	.	A	G	8	16	24	0	1	25	0	0
5	21297188	.	A	T	9	13	22	0	0	22	0	0
5	21297320	.	G	A	6	14	20	0	0	20	0	0
5	21301127	.	A	G	4	9	13	0	0	13	0	0
5	21301232	.	C	A	1	7	8	0	4	12	0	0
5	21301322	.	T	C	4	4	8	0	1	9	0	0
5	21301424	.	T	C	6	0	6	0	9	15	0	0
5	21301445	.	A	G	10	10	20	0	0	20	0	0
5	21301871	.	G	A	5	3	8	0	0	8	0	0
5	21302012	.	A	G	6	4	10	0	1	11	0	0
5	21309754	.	T	C	3	0	3	0	12	15	0	0
5	21309886	.	G	A	5	7	12	0	1	13	0	0
5	21331520	.	C	T	2	4	6	0	1	7	0	0
5	21334671	.	C	T	2	2	4	0	2	6	0	0
5	21340998	.	A	G	2	4	6	0	1	7	0	0
5	21341060	.	A	T	3	2	5	0	0	5	0	0
5	21359091	.	C	T	1	7	8	0	4	12	0	0
5	21374171	.	C	T	1	3	4	0	2	6	0	0
5	21422329	.	A	G	1	1	2	0	1	3	0	0
5	21471337	.	C	T	0	2	2	0	2	4	0	0
5	22012345	.	T	C	5	3	8	0	0	8	0	0
5	22012452	.	T	C	3	3	6	0	3	9	0	0
5	22012459	.	T	C	4	4	8	0	1	9	0	0
5	22012823	.	T	C	12	3	15	0	0	15	0	0
5	22012827	.	T	C	11	2	13	0	1	14	0	0
5	22012895	.	T	C	4	5	9	0	0	9	0	0
5	22013412	.	G	A	3	2	5	0	1	6	0	0
5	22013658	.	G	A	13	10	23	0	0	23	0	0
5	22013712	.	A	G	8	10	18	0	1	19	0	0
5	22013913	.	C	T	5	3	8	0	0	8	0	0
5	22013966	.	A	G	2	3	5	0	0	5	0	0
5	22013985	.	T	C	2	0	2	0	4	6	0	0
5	22014023	.	T	C	2	0	2	0	5	7	0	0
5	22014062	.	C	T	1	6	7	0	1	8	0	0
5	22014129	.	T	G	2	2	4	0	0	4	0	0
5	22014560	.	C	G	6	6	12	0	3	15	0	0
5	22014589	.	G	A	6	7	13	0	0	13	0	0
5	22015475	.	A	T	3	2	5	0	0	5	0	0
5	22015496	.	G	A	3	2	5	0	0	5	0	0
5	22015583	.	G	A	5	3	8	0	1	9	0	0
5	22015991	.	G	A	2	3	5	0	0	5	0	0
5	22016003	.	A	G	2	4	6	0	0	6	0	0
5	22016771	.	T	C	2	2	4	0	0	4	0	0
5	22017104	.	T	C	3	0	3	0	8	11	0	0
5	22017149	.	A	G	1	3	4	0	0	4	0	0
5	22021447	.	A	T	2	2	4	0	0	4	0	0
5	22024022	.	A	G	4	2	6	0	0	6	0	0
5	22024040	.	A	C	2	3	5	0	0	5	0	0
5	22025729	.	C	A	0	4	4	0	2	6	0	0
5	22032674	.	G	A	1	3	4	0	0	4	0	0
5	22073813	.	C	T	1	4	5	0	0	5	0	0
5	22073989	.	A	T	15	14	29	0	3	32	0	0
5	22074040	.	C	T	15	15	30	0	1	31	0	0
5	22074118	.	A	T	13	23	36	0	0	36	0	0
5	22074132	.	T	C	14	22	36	0	2	38	0	0
5	22074376	.	C	T	1	20	21	0	24	45	0	0
5	22074407	.	C	T	19	22	41	0	0	41	0	0
5	22082786	.	T	C	11	14	25	0	0	25	0	0
5	22098739	.	C	T	7	6	13	0	0	13	0	0
5	22098790	.	G	A	0	5	5	0	3	8	0	0
5	22106043	.	C	G	6	0	6	0	4	10	0	0
5	22106168	.	T	G	2	0	2	0	7	9	0	0
5	22106174	.	T	C	2	4	6	0	1	7	0	0
5	22115256	.	G	A	4	7	11	0	0	11	0	0
5	22115277	.	A	G	4	3	7	0	0	7	0	0
5	22115579	.	A	G	1	2	3	0	0	3	0	0
5	22115786	.	C	T	1	4	5	0	0	5	0	0
5	22115821	.	A	C	2	5	7	0	0	7	0	0
5	22115915	.	G	T	9	4	13	0	1	14	0	0
5	22121467	.	G	A	5	7	12	0	1	13	0	0
5	22123288	.	G	T	3	9	12	0	0	12	0	0
5	22123513	.	A	G	5	3	8	0	0	8	0	0
5	22123557	.	G	A	3	2	5	0	1	6	0	0
5	22125222	.	G	A	2	3	5	1	1	7	0	0
5	22125248	.	G	A	3	4	7	2	0	9	0	0
5	22127703	.	T	A	3	4	7	0	0	7	0	0
5	22161350	.	T	C	4	4	8	0	1	9	0	0
5	22161359	.	T	C	5	5	10	0	0	10	0	0
5	22163437	.	C	T	4	7	11	0	0	11	0	0
5	22172454	.	A	C	5	6	11	0	0	11	0	0
5	22172613	.	T	A	5	3	8	0	2	10	0	0
5	22173409	.	G	A	10	5	15	0	0	15	0	0
5	22173691	.	T	A	10	15	25	0	1	26	0	0
5	22173875	.	T	G	9	0	9	0	14	23	0	0
5	22173999	.	C	T	0	2	2	0	3	5	0	0
5	22465140	.	A	G	5	10	15	0	0	15	0	0
5	22465152	.	A	C	4	9	13	0	0	13	0	0
5	22465206	.	A	G	6	8	14	0	0	14	0	0
5	22473572	.	T	C	10	10	20	0	0	20	0	0
5	22473746	.	C	T	18	9	27	0	2	29	0	0
5	22474043	.	A	T	9	5	14	0	1	15	0	0
5	22474151	.	G	A	13	8	21	0	0	21	0	0
5	22474349	.	A	G	17	12	29	0	1	30	0	0
5	22476208	.	G	A	8	10	18	0	0	18	0	0
5	22479469	.	C	T	8	4	12	0	0	12	0	0
5	22479571	.	T	C	9	0	9	0	4	13	0	0
5	22481954	.	A	G	6	5	11	0	3	14	0	0
5	22482071	.	T	C	7	6	13	0	0	13	0	0
5	22482875	.	A	G	5	6	11	0	0	11	0	0
5	22484165	.	G	C	4	4	8	0	0	8	0	0
5	22485748	.	T	C	7	2	9	0	3	12	0	0
5	22489258	.	A	G	5	2	7	0	3	10	0	0
5	22489369	.	A	G	10	9	19	0	2	21	0	0
5	22489390	.	G	A	16	10	26	0	0	26	0	0
5	22489501	.	G	A	8	4	12	0	4	16	0	0
5	22515632	.	A	C	1	2	3	0	1	4	0	0
5	22515705	.	A	G	1	3	4	0	0	4	0	0
5	22531484	.	C	T	2	4	6	0	0	6	0	0
5	22544064	.	C	T	1	2	3	0	0	3	0	0
5	22550983	.	G	A	14	13	27	0	1	28	0	0
5	22550990	.	A	G	13	12	25	0	1	26	0	0
5	22557201	.	T	C	9	10	19	0	1	20	0	0
5	22557626	.	T	G	16	11	27	0	0	27	0	0
5	22560446	.	G	A	12	7	19	0	0	19	0	0
5	22562118	.	A	G	8	9	17	0	1	18	0	0
5	22562154	.	T	C	9	0	9	0	7	16	0	0
5	22562177	.	T	A	12	10	22	0	1	23	0	0
5	22564726	.	A	T	4	2	6	0	0	6	0	0
5	22564829	.	G	A	7	4	11	0	0	11	0	0
5	22564843	.	G	A	5	3	8	0	1	9	0	0
5	22564997	.	G	T	4	7	11	0	0	11	0	0
5	22573616	.	T	C	7	0	7	0	9	16	0	0
5	22593801	.	A	G	9	10	19	0	2	21	0	0
5	22593877	.	G	A	19	17	36	0	0	36	0	0
5	22593882	.	T	A	17	15	32	0	2	35	1	0
5	22593930	.	A	G	21	20	41	0	0	41	0	0
5	22596067	.	T	C	12	16	28	0	4	32	0	0
5	22598531	.	C	G	16	12	28	0	0	28	0	0
5	22598746	.	G	A	8	13	21	0	1	22	0	0
5	22600498	.	A	C	13	1	14	0	9	23	0	0
5	22600552	.	A	G	9	12	21	0	1	22	0	0
5	22600579	.	A	G	5	11	16	0	0	16	0	0
5	22606052	.	A	G	14	5	19	0	1	20	0	0
5	22619671	.	T	G	7	4	11	0	0	11	0	0
5	22683531	.	C	T	17	14	31	0	2	33	0	0
5	22683556	.	G	A	11	15	26	0	0	26	0	0
5	22683732	.	G	T	19	14	33	0	1	34	0	0
5	22683836	.	G	A	13	13	26	0	2	28	0	0
5	22683949	.	T	C	5	5	10	0	0	10	0	0
5	22683953	.	T	C	5	5	10	0	0	10	0	0
5	22820157	.	A	G	2	3	5	0	0	5	0	0
5	22822569	.	C	T	6	5	11	0	1	12	0	0
5	22851915	.	T	A	7	11	18	0	0	18	0	0
5	22852200	.	C	T	3	9	12	0	1	13	0	0
5	22852263	.	G	A	2	9	11	0	1	12	0	0
5	22856713	.	C	T	0	5	5	0	14	19	0	0
5	22856939	.	T	G	17	10	27	0	0	27	0	0
5	22857069	.	T	G	6	12	18	0	0	18	0	0
5	22857109	.	G	A	11	8	19	0	2	21	0	0
5	22858028	.	A	G	5	9	14	0	0	14	0	0
5	22860557	.	C	T	3	4	7	0	0	7	0	0
5	22860577	.	C	T	1	4	5	0	5	10	0	0
5	22860626	.	T	C	6	0	6	0	3	9	0	0
5	22860897	.	A	G	3	5	8	0	1	9	0	0
5	22872067	.	A	C	14	12	26	0	1	27	0	0
5	22872627	.	A	T	18	18	36	0	1	37	0	0
5	22873075	.	C	T	4	0	4	0	7	11	0	0
5	22876443	.	T	A	11	14	25	0	4	29	0	0
5	22876475	.	G	T	8	10	18	0	2	20	0	0
5	22876587	.	G	A	14	14	28	0	1	29	0	0
5	22876890	.	A	G	9	12	21	0	1	22	0	0
5	22879260	.	T	C	14	9	23	1	0	24	0	0
5	22888231	.	G	A	5	10	15	0	0	15	0	0
5	22916732	.	A	G	4	2	6	0	0	6	0	0
5	22916789	.	G	A	1	2	3	0	0	3	0	0
5	22971151	.	T	C	13	5	18	0	0	18	0	0
5	22971222	.	T	A	2	5	7	0	1	8	0	0
5	22971270	.	G	A	3	42	45	0	42	87	0	0
5	22971463	.	T	C	25	36	61	0	2	63	0	0
5	22972573	.	A	G	18	33	51	0	4	55	0	0
5	22972597	.	A	C	18	31	49	0	5	54	0	0
5	22989109	.	A	G	5	0	5	0	3	8	0	0
5	22989148	.	T	C	1	3	4	0	0	4	0	0
5	22994447	.	A	G	1	2	3	0	0	3	0	0
5	23014929	.	C	T	2	2	4	0	1	5	0	0
5	23019939	.	G	A	0	7	7	0	4	11	0	0
5	23020075	.	G	C	6	7	13	0	0	13	0	0
5	23020084	.	C	T	7	7	14	0	0	14	0	0
5	23026604	.	G	A	20	10	30	0	1	31	0	0
5	23026779	.	C	T	21	16	37	0	0	38	1	0
5	23027597	.	G	C	10	15	25	0	1	26	0	0
5	23027642	.	A	C	9	20	29	0	2	31	0	0
5	23027770	.	T	C	15	21	36	0	1	37	0	0
5	23027937	.	C	T	11	21	32	0	3	35	0	0
5	23028131	.	C	A	6	5	11	0	1	12	0	0
5	23045605	.	G	T	2	5	7	0	0	7	0	0
5	23056697	.	A	G	10	9	19	0	0	19	0	0
5	23062252	.	A	G	1	0	1	0	2	3	0	0
5	23076015	.	C	T	1	2	3	0	0	3	0	0
5	23079094	.	A	G	2	4	6	0	0	6	0	0
5	23079272	.	A	G	3	6	9	0	0	9	0	0
5	23082105	.	C	A	2	10	12	1	0	13	0	0
5	23082128	.	T	C	2	6	8	1	0	9	0	0
5	23082845	.	G	A	2	6	8	0	0	8	0	0
5	23082847	.	T	A	3	6	9	0	0	9	0	0
5	23083648	.	T	C	1	3	4	0	0	4	0	0
5	23107927	.	C	T	5	9	14	0	1	15	0	0
5	23108019	.	G	A	9	6	15	0	0	15	0	0
5	23108042	.	T	A	10	10	20	0	0	20	0	0
5	23108128	.	G	A	29	23	52	0	2	54	0	0
5	23110311	.	C	T	15	7	22	0	1	23	0	0
5	23118253	.	A	T	9	12	21	0	1	22	0	0
5	23125545	.	G	A	9	4	13	0	0	13	0	0
5	23125555	.	C	T	6	3	9	0	2	11	0	0
5	23126065	.	C	T	9	8	17	0	0	17	0	0
5	23126464	.	T	G	9	0	9	0	5	14	0	0
5	23126500	.	G	A	9	6	15	0	0	15	0	0
5	23126677	.	C	G	9	6	15	0	2	17	0	0
5	23126856	.	C	G	8	7	15	0	1	16	0	0
5	23127025	.	C	T	8	5	13	0	0	13	0	0
5	23127376	.	T	C	16	10	26	0	1	27	0	0
5	23127418	.	C	T	13	10	23	0	1	24	0	0
5	23127451	.	A	G	15	10	25	0	1	26	0	0
5	23127946	.	T	G	19	14	33	0	2	35	0	0
5	23127979	.	A	G	19	12	31	0	3	34	0	0
5	23128135	.	T	C	12	8	20	0	2	22	0	0
5	23128651	.	A	C	4	23	27	0	0	27	0	0
5	23128696	.	T	A	6	11	17	0	3	20	0	0
5	23128714	.	C	A	8	14	22	0	0	22	0	0
5	23128957	.	T	C	13	10	23	0	2	25	0	0
5	23129161	.	C	T	19	16	35	0	2	37	0	0
5	23129902	.	G	T	11	11	22	0	1	23	0	0
5	23130629	.	T	C	22	19	41	0	0	41	0	0
5	23130970	.	C	T	19	13	32	0	1	33	0	0
5	23131106	.	G	C	22	20	42	0	2	44	0	0
5	23131147	.	T	C	24	20	44	0	1	45	0	0
5	23132256	.	G	T	8	2	10	0	1	11	0	0
5	23136584	.	T	C	6	5	11	0	0	11	0	0
5	23136635	.	G	A	13	10	23	0	4	27	0	0
5	23140527	.	T	G	10	14	24	0	1	25	0	0
5	23140548	.	A	G	11	0	11	0	11	22	0	0
5	23143454	.	G	T	9	11	20	0	2	22	0	0
5	23143725	.	A	G	7	0	7	0	22	29	0	0
5	23143755	.	C	T	13	22	35	0	2	37	0	0
5	23146414	.	T	C	22	11	33	0	1	34	0	0
5	23146537	.	G	A	1	23	24	0	11	35	0	0
5	23146576	.	T	A	11	24	35	0	0	35	0	0
5	23146790	.	G	T	14	30	44	0	2	46	0	0
5	23146897	.	T	G	6	9	15	0	0	15	0	0
5	23147007	.	A	T	6	5	11	0	1	12	0	0
5	23147008	.	T	A	6	6	12	0	0	12	0	0
5	23147118	.	C	A	2	7	9	0	0	9	0	0
5	23147127	.	T	C	2	6	8	0	2	10	0	0
5	23147185	.	T	A	13	13	26	0	1	27	0	0
5	23147479	.	C	G	11	15	26	0	1	27	0	0
5	23223647	.	T	A	2	3	5	0	2	7	0	0
5	23230692	.	C	T	5	3	8	0	1	9	0	0
5	23230877	.	A	G	2	0	2	0	3	5	0	0
5	23231042	.	A	G	3	3	6	0	0	6	0	0
5	23268370	.	A	C	30	34	64	3	3	70	0	0
5	23268371	.	C	A	33	32	65	3	3	71	0	0
5	23268542	.	T	G	36	43	79	0	21	100	0	0
5	23268785	.	C	G	55	50	105	0	1	106	0	0
5	23272981	.	T	G	39	33	72	0	6	78	0	0
5	23273487	.	G	A	36	39	75	0	4	79	0	0
5	23275945	.	G	A	41	22	63	0	1	64	0	0
5	23276037	.	G	A	35	19	54	0	2	56	0	0
5	23277139	.	G	A	24	32	56	0	2	58	0	0
5	23277816	.	C	A	15	20	35	0	1	36	0	0
5	23283890	.	A	T	1	2	3	0	0	3	0	0
5	23284014	.	T	C	15	11	26	0	0	26	0	0
5	23284867	.	A	G	11	10	21	0	0	21	0	0
5	23285133	.	T	C	21	13	34	0	0	34	0	0
5	23285206	.	G	A	29	8	37	0	0	37	0	0
5	23285546	.	A	G	31	22	53	0	0	53	0	0
5	23285554	.	A	G	27	21	48	0	2	50	0	0
5	23285611	.	G	A	21	28	49	0	1	50	0	0
5	23286004	.	A	G	20	27	47	0	3	50	0	0
5	23286280	.	A	G	17	18	35	0	1	36	0	0
5	23286361	.	A	G	17	11	28	0	2	30	0	0
5	23286376	.	G	A	15	14	29	0	2	31	0	0
5	23288545	.	A	G	14	11	25	0	1	26	0	0
5	23288560	.	C	T	14	9	23	0	0	23	0	0
5	23288653	.	G	A	13	4	17	0	0	17	0	0
5	23288710	.	T	C	6	0	6	0	6	12	0	0
5	23288725	.	C	T	6	3	9	0	1	11	1	0
5	23316807	.	C	T	10	4	14	0	0	14	0	0
5	23353648	.	A	G	24	22	46	0	4	50	0	0
5	23357357	.	T	A	5	5	10	0	0	10	0	0
5	23386277	.	C	T	15	11	26	0	0	26	0	0
5	23389025	.	C	T	1	8	9	0	16	25	0	0
5	23389190	.	A	G	12	18	30	0	1	31	0	0
5	23389268	.	G	A	13	4	17	0	0	17	0	0
5	23397221	.	T	C	11	17	28	0	1	29	0	0
5	23403173	.	T	C	7	11	18	0	1	19	0	0
5	23417421	.	G	C	2	8	10	0	0	10	0	0
5	23428594	.	C	T	1	7	8	0	9	17	0	0
5	23574618	.	T	A	3	2	5	0	0	5	0	0
5	23574869	.	T	C	4	4	8	0	0	8	0	0
5	23574916	.	T	C	1	7	8	0	0	8	0	0
5	23575521	.	T	C	1	3	4	0	0	4	0	0
5	23575646	.	T	C	2	7	9	0	0	9	0	0
5	24128962	.	G	C	6	3	9	0	0	9	0	0
5	24129122	.	C	T	6	7	13	0	1	14	0	0
5	24130706	.	T	C	10	13	23	0	1	24	0	0
5	24130715	.	C	T	11	16	27	0	1	28	0	0
5	24130809	.	C	T	15	8	23	0	0	23	0	0
5	24131320	.	A	C	17	10	27	0	1	28	0	0
5	24131611	.	A	G	16	15	31	0	1	32	0	0
5	24132457	.	G	A	4	9	13	0	2	15	0	0
5	24132615	.	T	C	14	5	19	0	1	20	0	0
5	24133732	.	G	A	2	18	20	0	20	40	0	0
5	24134952	.	A	T	13	13	26	0	0	26	0	0
5	24134997	.	A	T	8	12	20	0	1	21	0	0
5	24135361	.	G	T	2	16	18	0	16	34	0	0
5	24138964	.	G	A	10	19	29	0	0	29	0	0
5	24147460	.	C	T	9	11	20	0	4	24	0	0
5	24147508	.	C	G	9	16	25	0	1	26	0	0
5	24147529	.	A	G	12	16	28	0	0	28	0	0
5	24148419	.	T	G	3	10	13	0	0	13	0	0
5	24148431	.	C	T	4	8	12	0	0	12	0	0
5	24153202	.	C	T	2	9	11	0	10	21	0	0
5	24153253	.	G	C	9	7	16	0	0	16	0	0
5	24153289	.	T	C	6	1	7	0	8	15	0	0
5	24153331	.	T	C	9	0	9	0	8	17	0	0
5	24153403	.	C	T	5	9	14	0	1	15	0	0
5	24153441	.	T	C	5	11	16	0	0	16	0	0
5	24153523	.	T	G	6	10	16	0	0	16	0	0
5	24153524	.	C	T	0	10	10	0	6	16	0	0
5	24153887	.	C	T	1	11	12	0	11	23	0	0
5	24162191	.	T	G	2	4	6	0	0	6	0	0
5	24163000	.	T	A	1	4	5	0	1	6	0	0
5	24168114	.	A	G	2	3	5	0	0	5	0	0
5	24185470	.	C	A	2	2	4	0	0	4	0	0
5	24185593	.	G	T	0	2	2	0	2	4	0	0
5	24199739	.	T	C	5	6	11	0	3	14	0	0
5	24199757	.	T	A	7	5	12	0	0	12	0	0
5	24199987	.	C	A	2	7	9	0	0	9	0	0
5	24200017	.	C	A	3	6	9	0	0	9	0	0
5	24200259	.	T	C	2	2	4	0	0	4	0	0
5	24200592	.	G	A	10	4	14	0	0	14	0	0
5	24200611	.	G	A	9	6	15	0	0	15	0	0
5	24208530	.	C	G	19	16	35	0	0	35	0	0
5	24208781	.	G	C	30	32	62	2	3	67	0	0
5	24208900	.	G	C	16	1	17	0	33	50	0	0
5	24209088	.	C	T	12	23	35	0	4	39	0	0
5	24209293	.	A	T	26	28	54	0	2	56	0	0
5	24209460	.	A	G	27	28	55	0	3	58	0	0
5	24213273	.	T	G	28	30	58	0	1	59	0	0
5	24213291	.	T	C	29	1	30	0	32	62	0	0
5	24223858	.	T	G	5	5	10	0	1	11	0	0
5	24223890	.	G	T	5	5	10	0	0	10	0	0
5	24227532	.	A	G	5	4	9	0	0	9	0	0
5	24227658	.	C	T	1	4	5	0	0	5	0	0
5	24227700	.	T	C	1	7	8	0	0	8	0	0
5	24240491	.	C	T	5	3	8	0	0	8	0	0
5	24240586	.	A	T	2	4	6	0	1	7	0	0
5	24240866	.	C	T	7	4	11	0	0	11	0	0
5	24240968	.	T	A	3	7	10	0	1	11	0	0
5	24244891	.	G	T	1	3	4	0	0	4	0	0
5	24244952	.	G	T	3	5	8	0	0	8	0	0
5	24252744	.	A	G	11	15	26	0	1	27	0	0
5	24256387	.	G	A	24	26	50	1	3	54	0	0
5	24259642	.	A	G	39	4	43	0	24	67	0	0
5	24259980	.	T	G	3	5	8	0	1	9	0	0
5	24330493	.	A	G	11	2	13	0	1	14	0	0
5	24330527	.	T	C	4	0	4	0	8	12	0	0
5	24330840	.	G	T	10	7	17	0	1	18	0	0
5	24330932	.	C	A	15	10	25	0	3	28	0	0
5	24331724	.	G	C	8	8	16	0	0	16	0	0
5	24331840	.	T	A	7	3	10	0	0	10	0	0
5	24333135	.	C	T	4	4	8	0	0	8	0	0
5	24333612	.	C	G	2	5	7	0	0	7	0	0
5	24511111	.	C	T	0	12	12	0	19	31	0	0
5	24511748	.	G	A	5	7	12	0	0	12	0	0
5	24513193	.	G	A	8	12	20	0	0	20	0	0
5	24516819	.	A	G	4	6	10	0	2	12	0	0
5	24521812	.	G	A	9	10	19	0	0	19	0	0
5	24522206	.	A	T	17	11	28	0	1	29	0	0
5	24530663	.	A	T	9	13	22	0	1	23	0	0
5	24530853	.	C	T	10	9	19	0	0	19	0	0
5	24531370	.	C	T	14	8	22	1	6	29	0	0
5	24531538	.	T	G	10	11	21	0	3	24	0	0
5	24531854	.	A	T	6	3	9	0	0	9	0	0
5	24532661	.	T	C	4	0	4	0	3	7	0	0
5	24535421	.	G	T	7	4	11	0	0	11	0	0
5	24542259	.	G	A	1	3	4	0	0	4	0	0
5	24542490	.	G	A	1	5	6	0	1	7	0	0
5	24563811	.	G	A	1	3	4	0	5	9	0	0
5	24566917	.	A	G	4	5	9	0	0	9	0	0
5	24567269	.	A	T	4	3	7	0	0	7	0	0
5	24567297	.	C	T	3	3	6	0	0	6	0	0
5	24567412	.	A	G	6	4	10	0	0	10	0	0
5	24567460	.	C	A	1	2	3	0	0	3	0	0
5	24567716	.	G	A	1	3	4	0	1	5	0	0
5	24567727	.	C	T	1	4	5	0	0	5	0	0
5	24578500	.	C	A	0	7	7	0	9	16	0	0
5	24584547	.	C	T	5	4	9	0	0	9	0	0
5	24596078	.	G	C	5	0	5	0	10	15	0	0
5	24596080	.	C	T	1	9	10	0	5	15	0	0
5	24665621	.	C	T	2	2	4	0	0	4	0	0
5	24712264	.	G	A	2	3	5	0	0	5	0	0
5	24756576	.	G	A	4	2	6	0	1	7	0	0
5	24756844	.	G	A	12	17	29	0	5	34	0	0
5	24756845	.	A	G	19	11	30	0	4	34	0	0
5	24756967	.	A	T	15	16	31	1	1	33	0	0
5	24757494	.	A	C	5	2	7	0	0	7	0	0
5	24757497	.	C	A	4	2	6	0	1	7	0	0
5	24757561	.	A	T	5	5	10	0	0	10	0	0
5	24757656	.	A	G	4	7	11	0	0	11	0	0
5	24757748	.	T	A	6	9	15	0	1	16	0	0
5	24757916	.	G	A	14	13	27	0	0	27	0	0
5	24757952	.	A	T	9	14	23	0	1	24	0	0
5	24757976	.	G	A	13	8	21	0	1	22	0	0
5	24758013	.	C	T	0	7	7	0	16	23	0	0
5	24768725	.	A	G	16	13	29	0	1	30	0	0
5	24772801	.	C	T	9	7	16	0	2	18	0	0
5	24778244	.	A	G	12	8	20	0	1	21	0	0
5	24790326	.	C	A	3	5	8	0	0	8	0	0
5	24790335	.	C	T	0	6	6	0	3	9	0	0
5	24796678	.	G	A	7	4	11	0	0	11	0	0
5	24800407	.	T	C	8	3	11	0	0	11	0	0
5	24805457	.	A	G	3	3	6	0	0	6	0	0
5	24816449	.	C	A	3	5	8	0	2	10	0	0
5	24816788	.	A	T	2	5	7	0	0	7	0	0
5	24816838	.	G	T	7	3	10	0	0	10	0	0
5	24816854	.	T	A	4	9	13	0	0	13	0	0
5	24817014	.	C	G	9	20	29	0	0	29	0	0
5	24817142	.	A	T	7	12	19	0	2	21	0	0
5	24817445	.	A	G	8	3	11	2	0	13	0	0
5	24817450	.	T	C	3	8	11	2	0	13	0	0
5	24817674	.	T	C	11	8	19	0	0	19	0	0
5	24817806	.	T	C	1	0	1	0	6	7	0	0
5	24817947	.	C	T	9	6	15	0	0	15	0	0
5	24818461	.	T	C	9	3	12	0	2	14	0	0
5	24826299	.	G	A	4	4	8	0	0	8	0	0
5	24826464	.	C	T	2	4	6	0	3	9	0	0
5	24875097	.	T	A	20	17	37	8	1	46	0	0
5	24875494	.	A	G	15	12	27	2	1	30	0	0
5	24878111	.	A	G	19	6	25	6	1	32	0	0
5	24886066	.	T	C	6	4	10	0	0	10	0	0
5	24886291	.	G	T	3	4	7	0	0	7	0	0
5	24887340	.	C	T	3	3	6	0	6	12	0	0
5	24887472	.	T	G	3	5	8	0	0	8	0	0
5	24887541	.	G	T	12	10	22	0	2	24	0	0
5	24887707	.	C	T	14	9	23	1	0	24	0	0
5	24887828	.	A	G	7	7	14	0	0	14	0	0
5	24887830	.	T	A	8	7	15	0	0	15	0	0
5	24896837	.	C	T	6	8	14	0	0	14	0	0
5	24909161	.	C	T	5	2	7	0	4	11	0	0
5	25046430	.	C	A	3	2	5	0	0	5	0	0
5	25046440	.	C	T	6	3	9	0	0	9	0	0
5	25047223	.	T	C	4	9	13	0	3	16	0	0
5	25048598	.	C	T	3	2	5	0	0	5	0	0
5	25074812	.	C	T	14	12	26	0	0	26	0	0
5	25074917	.	C	T	13	9	22	0	2	24	0	0
5	25075040	.	G	A	5	4	9	0	0	9	0	0
5	25077553	.	T	C	11	1	12	0	6	18	0	0
5	25083986	.	G	A	0	3	3	0	2	5	0	0
5	25084459	.	A	T	2	3	5	0	0	5	0	0
5	25084499	.	C	T	3	3	6	0	0	6	0	0
5	25085351	.	G	A	4	2	6	0	0	6	0	0
5	25085617	.	A	G	3	3	6	0	0	6	0	0
5	25086921	.	A	G	2	3	5	0	0	5	0	0
5	25089174	.	A	G	13	22	35	0	0	35	0	0
5	25089212	.	C	T	1	19	20	0	16	36	0	0
5	25094191	.	G	A	12	11	23	0	1	24	0	0
5	25094203	.	G	T	13	11	24	0	1	25	0	0
5	25100142	.	C	T	10	5	15	0	2	17	0	0
5	25100473	.	C	T	3	8	11	0	5	16	0	0
5	25100494	.	G	A	6	8	14	0	0	14	0	0
5	25101971	.	G	A	10	8	18	0	4	22	0	0
5	25102013	.	A	G	11	12	23	0	0	23	0	0
5	25102025	.	C	A	11	13	24	0	1	25	0	0
5	25104670	.	G	A	11	8	19	0	1	20	0	0
5	25104733	.	C	A	10	7	17	0	1	18	0	0
5	25104945	.	G	A	14	11	25	0	1	26	0	0
5	25107035	.	T	C	9	0	9	0	6	15	0	0
5	25118134	.	C	G	6	5	11	0	0	11	0	0
5	25122848	.	T	C	1	2	3	0	0	3	0	0
5	25122851	.	A	G	1	2	3	0	0	3	0	0
5	25129252	.	A	G	1	2	3	0	0	3	0	0
5	25129312	.	C	T	2	4	6	0	2	8	0	0
5	25129378	.	T	C	5	0	5	0	4	9	0	0
5	25129690	.	C	T	2	3	5	0	0	5	0	0
5	25141784	.	A	G	1	2	3	0	0	3	0	0
5	25311388	.	T	A	9	7	16	0	1	17	0	0
5	25311468	.	T	C	1	3	4	0	0	4	0	0
5	25314181	.	C	G	8	5	13	0	0	13	0	0
5	25314213	.	G	A	4	3	7	0	0	7	0	0
5	25369610	.	C	A	5	2	7	0	0	7	0	0
5	25372384	.	C	T	0	4	4	0	4	8	0	0
5	25372429	.	C	T	0	2	2	0	2	4	0	0
5	25537107	.	A	G	2	2	4	0	0	4	0	0
5	25571629	.	G	A	4	2	6	0	0	6	0	0
5	25578601	.	T	G	6	5	11	0	0	11	0	0
5	25610245	.	T	C	2	2	4	0	0	4	0	0
5	25683970	.	C	A	9	9	18	0	0	18	0	0
5	25693229	.	C	T	6	4	10	0	1	11	0	0
5	25693550	.	C	A	7	5	12	0	1	13	0	0
5	25693551	.	G	A	6	7	13	0	0	13	0	0
5	25693790	.	T	C	15	16	31	0	0	31	0	0
5	25722644	.	A	G	1	2	3	0	0	3	0	0
5	25722927	.	C	G	2	2	4	0	0	4	0	0
5	25726642	.	G	T	2	4	6	0	0	6	0	0
5	25726660	.	G	T	1	2	3	0	0	3	0	0
5	25726755	.	C	T	3	4	7	1	0	8	0	0
5	25726813	.	T	A	10	4	14	0	0	14	0	0
5	25726838	.	T	G	4	8	12	0	0	12	0	0
5	25726882	.	T	C	4	0	4	0	8	12	0	0
5	25728428	.	C	T	1	2	3	0	0	3	0	0
5	25729849	.	A	G	2	5	7	0	2	9	0	0
5	25729900	.	C	T	0	5	5	0	7	12	0	0
5	25733877	.	T	C	12	5	17	0	0	17	0	0
5	25750414	.	C	T	2	3	5	0	0	5	0	0
5	25753013	.	A	G	8	0	8	0	5	13	0	0
5	25753265	.	C	A	7	11	18	0	0	18	0	0
5	25753990	.	G	A	10	4	14	0	0	14	0	0
5	25754054	.	T	C	13	5	18	0	0	18	0	0
5	25754092	.	T	C	11	6	17	0	2	19	0	0
5	25754231	.	T	A	4	3	7	0	1	8	0	0
5	25754302	.	C	T	1	5	6	0	0	6	0	0
5	25754631	.	T	C	1	2	3	0	0	3	0	0
5	25754788	.	C	A	4	2	6	0	0	6	0	0
5	25754913	.	T	C	9	10	19	1	0	20	0	0
5	25955323	.	G	C	0	3	3	0	1	4	0	0
5	25962593	.	C	T	4	2	6	0	0	6	0	0
5	26036192	.	A	T	2	3	5	0	0	5	0	0
5	26050872	.	C	T	2	4	6	0	0	6	0	0
5	26060141	.	C	T	3	5	8	0	1	9	0	0
5	26061919	.	G	A	4	4	8	0	0	8	0	0
5	26062582	.	A	G	7	6	13	0	1	14	0	0
5	26062888	.	A	G	6	6	12	0	0	12	0	0
5	26077498	.	A	T	6	4	10	0	0	10	0	0
5	26077504	.	G	T	1	6	7	0	4	11	0	0
5	26077666	.	C	T	5	5	10	0	0	10	0	0
5	26077692	.	A	G	6	6	12	0	1	13	0	0
5	26077751	.	T	C	7	4	11	0	1	12	0	0
5	26077762	.	A	T	5	6	11	0	1	12	0	0
5	26077791	.	A	C	9	8	17	0	0	17	0	0
5	26077892	.	T	A	5	5	10	0	0	10	0	0
5	26077909	.	G	T	2	3	5	0	1	6	0	0
5	26082485	.	G	T	14	19	33	1	0	34	0	0
5	26082537	.	T	A	19	13	32	0	2	34	0	0
5	26092042	.	G	A	18	11	29	0	0	29	0	0
5	26093962	.	A	T	11	17	28	0	2	30	0	0
5	26100912	.	A	T	1	4	5	0	0	5	0	0
5	26101020	.	C	T	1	4	5	0	3	8	0	0
5	26101332	.	T	C	2	11	13	0	2	15	0	0
5	26101353	.	C	T	7	11	18	0	0	18	0	0
5	26101653	.	T	A	4	2	6	0	0	6	0	0
5	26102115	.	A	G	10	5	15	0	1	16	0	0
5	26102160	.	T	A	8	10	18	0	0	18	0	0
5	26102254	.	G	A	9	4	13	0	0	13	0	0
5	26102258	.	G	C	4	9	13	0	0	13	0	0
5	26102365	.	A	G	5	2	7	0	0	7	0	0
5	26102370	.	C	G	1	5	6	0	1	7	0	0
5	26102931	.	C	T	1	5	6	0	0	6	0	0
5	26102973	.	A	G	2	3	5	0	0	5	0	0
5	26102986	.	G	A	2	2	4	0	0	4	0	0
5	26103388	.	A	G	5	2	7	0	0	7	0	0
5	26103601	.	T	C	1	6	7	0	0	7	0	0
5	26135241	.	A	T	2	3	5	0	0	5	0	0
5	26135751	.	A	G	3	0	3	0	2	5	0	0
5	26136378	.	A	C	2	3	5	0	0	5	0	0
5	26145347	.	C	T	3	3	6	0	0	6	0	0
5	26145378	.	G	T	4	3	7	0	0	7	0	0
5	26158753	.	G	C	1	2	3	0	0	3	0	0
5	26159543	.	G	A	2	4	6	0	0	6	0	0
5	26162632	.	G	A	1	4	5	0	0	5	0	0
5	26162700	.	C	T	0	3	3	0	3	6	0	0
5	26165257	.	C	A	10	7	17	0	0	17	0	0
5	26167933	.	G	A	3	5	8	0	0	8	0	0
5	26168049	.	C	A	4	3	7	0	0	7	0	0
5	26168782	.	G	A	3	2	5	0	0	5	0	0
5	26170087	.	G	T	1	3	4	0	0	4	0	0
5	26189125	.	C	T	3	3	6	0	0	6	0	0
5	26189151	.	A	T	3	3	6	0	0	6	0	0
5	26192860	.	C	G	0	2	2	0	2	4	0	0
5	26200679	.	T	G	7	5	12	0	1	13	0	0
5	26200802	.	T	C	8	6	14	0	0	14	0	0
5	26202863	.	T	A	3	10	13	0	0	13	0	0
5	26202898	.	T	C	6	8	14	0	1	15	0	0
5	26202914	.	T	A	6	10	16	0	1	17	0	0
5	26203055	.	A	T	2	3	5	0	0	5	0	0
5	26227758	.	C	T	5	6	11	0	0	11	0	0
5	26232765	.	G	C	6	7	13	0	0	13	0	0
5	26232790	.	A	T	6	5	11	0	0	12	1	0
5	26234797	.	C	T	6	3	9	0	0	9	0	0
5	26234819	.	C	T	0	2	2	0	3	5	0	0
5	26235098	.	T	C	3	3	6	0	0	6	0	0
5	26235156	.	A	G	6	3	9	0	0	9	0	0
5	26235183	.	C	T	0	6	6	0	2	8	0	0
5	26236243	.	C	T	2	5	7	0	0	7	0	0
5	26238927	.	A	G	2	4	6	0	0	6	0	0
5	26238934	.	T	C	1	4	5	0	1	6	0	0
5	26263562	.	T	A	25	18	43	0	2	45	0	0
5	26274540	.	C	T	1	13	14	0	15	29	0	0
5	26274582	.	C	T	9	9	18	0	0	18	0	0
5	26281262	.	G	T	17	12	29	0	1	30	0	0
5	26281331	.	T	C	19	0	19	1	17	37	0	0
5	26285471	.	G	A	6	15	21	0	1	22	0	0
5	26285474	.	A	G	6	14	20	0	0	20	0	0
5	26322742	.	C	T	11	4	15	0	0	15	0	0
5	26330230	.	T	A	11	5	16	0	3	19	0	0
5	26334568	.	G	A	5	14	19	0	0	19	0	0
5	26355982	.	C	T	6	6	12	0	0	12	0	0
5	26356000	.	G	C	5	6	11	0	0	11	0	0
5	26356051	.	C	T	0	6	6	0	9	15	0	0
5	26387686	.	G	A	8	6	14	0	1	15	0	0
5	26493095	.	A	G	2	4	6	0	1	7	0	0
5	26687349	.	C	T	6	2	8	0	0	8	0	0
5	26697420	.	A	G	1	3	4	0	0	4	0	0
5	26721436	.	A	T	4	3	7	0	0	7	0	0
5	26721569	.	A	T	1	5	6	0	0	6	0	0
5	26721601	.	T	C	4	4	8	0	0	8	0	0
5	26721659	.	A	G	5	2	7	0	0	7	0	0
5	26721663	.	A	G	5	1	6	0	1	7	0	0
5	26721884	.	G	A	2	1	3	0	1	4	0	0
5	26721966	.	T	G	7	4	11	0	0	11	0	0
5	26722268	.	T	G	5	5	10	0	0	10	0	0
5	26722361	.	T	C	3	5	8	0	0	8	0	0
5	26750165	.	A	T	4	2	6	0	0	6	0	0
5	26750291	.	C	A	4	6	10	0	0	10	0	0
5	26756338	.	C	T	3	6	9	0	0	9	0	0
5	26787426	.	A	G	1	8	9	0	1	10	0	0
5	26789576	.	T	C	4	5	9	0	0	9	0	0
5	26793573	.	G	C	7	4	11	0	0	11	0	0
5	26793625	.	T	A	3	5	8	0	0	8	0	0
5	26793733	.	G	C	1	2	3	0	0	3	0	0
5	26795605	.	A	C	1	2	3	0	0	3	0	0
5	26802371	.	G	A	0	3	3	0	4	7	0	0
5	26802968	.	G	A	5	3	8	0	1	9	0	0
5	26805168	.	G	A	2	3	5	0	1	6	0	0
5	26805207	.	C	T	2	6	8	0	0	8	0	0
5	26805212	.	A	T	3	5	8	0	0	8	0	0
5	26805636	.	T	C	4	5	9	0	0	9	0	0
5	26805746	.	G	T	3	4	7	0	0	7	0	0
5	26805748	.	C	A	3	4	7	0	0	7	0	0
5	26805925	.	C	T	2	3	5	0	0	5	0	0
5	26805952	.	G	T	1	4	5	0	0	5	0	0
5	26805961	.	T	A	1	4	5	0	1	6	0	0
5	26806262	.	G	A	0	2	2	0	3	5	0	0
5	26807122	.	A	C	1	2	3	0	0	3	0	0
5	26814159	.	G	A	0	3	3	0	4	7	0	0
5	26814171	.	C	T	4	3	7	0	1	8	0	0
5	26816779	.	G	A	0	5	5	0	18	23	0	0
5	26823191	.	G	A	8	5	13	0	2	15	0	0
5	26823636	.	C	G	10	7	17	0	0	17	0	0
5	26858086	.	C	T	2	3	5	0	0	5	0	0
5	26859409	.	C	A	2	2	4	0	0	4	0	0
5	26859778	.	G	A	2	3	5	0	0	5	0	0
5	26862098	.	C	T	2	2	4	0	0	4	0	0
5	26862176	.	T	C	2	2	4	0	0	4	0	0
5	26865185	.	T	C	1	2	3	0	0	3	0	0
5	26865204	.	A	T	3	2	5	0	0	5	0	0
5	26865257	.	T	C	2	3	5	0	0	5	0	0
5	26865900	.	G	A	0	7	7	0	4	11	0	0
5	26865914	.	T	G	8	3	11	0	0	11	0	0
5	26866284	.	A	G	3	2	5	0	0	5	0	0
5	26866435	.	T	A	1	2	3	0	0	3	0	0
5	26866616	.	T	C	2	2	4	0	0	4	0	0
5	26866763	.	T	A	0	2	2	0	0	2	0	0
5	26866773	.	T	C	2	1	3	0	0	3	0	0
5	26867065	.	T	A	7	2	9	0	0	9	0	0
5	26867066	.	A	T	7	1	8	0	1	9	0	0
5	26867151	.	G	A	5	2	7	0	1	8	0	0
5	26867482	.	G	T	4	6	10	0	0	10	0	0
5	26867516	.	C	A	7	4	11	0	0	11	0	0
5	26868133	.	A	G	10	4	14	0	0	14	0	0
5	26868223	.	T	C	2	4	6	0	0	6	0	0
5	26868292	.	G	T	5	3	8	0	1	9	0	0
5	26868351	.	C	A	7	2	9	0	0	9	0	0
5	26869044	.	G	C	18	9	27	0	0	27	0	0
5	26884770	.	C	T	2	5	7	0	0	7	0	0
5	26884809	.	C	T	1	2	3	0	1	4	0	0
5	26885569	.	T	A	4	3	7	0	0	7	0	0
5	26885838	.	T	A	5	3	8	0	1	9	0	0
5	26887993	.	T	C	2	2	4	0	0	4	0	0
5	26921041	.	C	T	3	3	6	0	1	7	0	0
5	26926446	.	G	T	2	3	5	0	0	5	0	0
5	26926488	.	T	A	2	3	5	0	0	5	0	0
5	26926496	.	G	T	2	2	4	0	1	5	0	0
5	27137703	.	G	A	0	2	2	0	2	4	0	0
5	27137736	.	A	G	2	3	5	0	0	5	0	0
5	27345083	.	C	T	2	2	4	0	0	4	0	0
5	27354960	.	A	G	2	7	9	0	0	9	0	0
5	27355029	.	G	T	0	4	4	0	3	7	0	0
5	27381557	.	G	A	1	2	3	0	0	3	0	0
5	27385471	.	A	G	1	0	1	0	3	4	0	0
5	27392278	.	G	A	1	5	6	0	0	6	0	0
5	27526008	.	G	A	1	4	5	0	0	5	0	0
5	27866921	.	G	A	30	8	38	0	0	38	0	0
5	27867129	.	G	A	24	27	51	0	7	58	0	0
5	27919171	.	A	T	1	2	3	0	0	3	0	0
5	27924458	.	C	A	3	7	10	0	1	11	0	0
5	27924827	.	A	G	14	13	27	0	1	28	0	0
5	27999952	.	G	T	5	0	5	1	6	12	0	0
5	29491363	.	A	G	2	4	6	0	1	7	0	0
5	29491467	.	A	T	5	5	10	0	1	11	0	0
5	29494625	.	C	T	4	5	9	0	0	9	0	0
5	29498314	.	G	T	4	2	6	0	0	6	0	0
5	29498332	.	G	A	3	3	6	0	0	6	0	0
5	29503160	.	A	G	2	4	6	0	0	6	0	0
5	29505078	.	A	G	3	4	7	0	0	7	0	0
5	29508315	.	C	T	0	2	2	0	2	4	0	0
5	29512529	.	C	T	3	3	6	0	0	6	0	0
5	29549064	.	G	A	3	2	5	0	1	6	0	0
5	29549090	.	C	T	2	5	7	0	4	11	0	0
5	29549231	.	T	A	4	6	10	0	1	11	0	0
5	29549237	.	A	G	6	6	12	0	1	13	0	0
5	29549279	.	A	G	9	5	14	0	1	15	0	0
5	29551150	.	A	G	3	6	9	0	2	11	0	0
5	29552891	.	T	C	5	2	7	0	0	7	0	0
5	29553944	.	T	G	5	2	7	0	0	7	0	0
5	29556157	.	C	T	2	4	6	0	0	6	0	0
5	29598008	.	A	G	8	11	19	0	1	20	0	0
5	29598312	.	C	T	2	28	30	0	34	64	0	0
5	29598386	.	A	G	19	20	39	2	2	43	0	0
5	29598425	.	G	A	17	28	45	2	1	48	0	0
5	29598513	.	G	A	25	17	42	0	3	45	0	0
5	29598984	.	T	C	42	0	42	0	15	57	0	0
5	29599023	.	A	G	32	19	51	0	2	53	0	0
5	29599236	.	T	C	22	26	48	0	3	51	0	0
5	29599315	.	T	C	21	0	21	0	31	52	0	0
5	29599429	.	A	G	21	24	45	0	0	45	0	0
5	29599754	.	A	T	27	33	60	0	1	61	0	0
5	29599784	.	C	T	26	32	58	0	5	63	0	0
5	29599878	.	A	C	26	30	56	0	1	57	0	0
5	29611084	.	G	A	30	29	59	0	1	60	0	0
5	29614090	.	G	A	21	27	48	0	2	50	0	0
5	29619159	.	T	C	35	11	46	0	0	46	0	0
5	29619464	.	G	T	18	15	33	0	2	35	0	0
5	29619500	.	A	G	17	14	31	0	0	31	0	0
5	29622609	.	A	T	18	16	34	0	1	36	1	0
5	29628856	.	A	T	17	19	36	0	0	36	0	0
5	29639357	.	C	T	1	7	8	0	14	22	0	0
5	29639384	.	A	G	14	7	21	0	0	21	0	0
5	29639451	.	T	A	11	8	19	0	1	20	0	0
5	29643158	.	C	T	9	12	21	0	2	23	0	0
5	29658561	.	T	C	6	6	12	0	0	12	0	0
5	29660282	.	C	G	3	1	4	0	3	7	0	0
5	29660509	.	A	T	5	3	8	0	2	10	0	0
5	29661032	.	C	A	7	2	9	0	0	9	0	0
5	29661116	.	T	C	2	3	5	0	0	5	0	0
5	29661119	.	T	C	2	2	4	0	1	5	0	0
5	29661461	.	T	C	4	6	10	0	1	11	0	0
5	29663745	.	T	C	6	9	15	0	0	15	0	0
5	29664763	.	G	A	9	4	13	0	1	14	0	0
5	29666599	.	T	C	10	5	15	0	1	16	0	0
5	29666947	.	G	C	9	8	17	0	0	17	0	0
5	29667260	.	T	C	10	6	16	0	0	16	0	0
5	29667305	.	G	A	7	8	15	0	1	16	0	0
5	29667437	.	T	G	3	3	6	0	0	6	0	0
5	29667470	.	A	C	3	2	5	0	2	7	0	0
5	29668146	.	T	G	7	0	7	0	6	13	0	0
5	29668519	.	G	A	6	12	18	0	0	18	0	0
5	29668551	.	G	A	9	7	16	0	0	16	0	0
5	29668570	.	G	A	14	7	21	0	0	21	0	0
5	29668676	.	T	C	19	6	25	0	1	26	0	0
5	29668691	.	G	A	15	5	20	0	0	20	0	0
5	29668754	.	C	T	9	6	15	0	0	15	0	0
5	29668867	.	G	A	7	8	15	0	1	16	0	0
5	29711393	.	A	G	2	3	5	0	0	5	0	0
5	29711421	.	C	T	1	3	4	0	0	4	0	0
5	29711428	.	C	T	1	3	4	0	0	4	0	0
5	29711464	.	A	C	2	2	4	0	0	4	0	0
5	29731596	.	G	A	1	2	3	0	1	4	0	0
5	29745268	.	A	G	2	1	3	0	2	5	0	0
5	29746404	.	T	A	0	4	4	0	1	5	0	0
5	29746419	.	T	C	1	7	8	0	0	8	0	0
5	29746642	.	A	G	5	3	8	0	2	10	0	0
5	29746706	.	A	T	4	2	6	0	0	6	0	0
5	29747027	.	C	T	8	17	25	0	1	26	0	0
5	29747121	.	G	T	9	16	25	0	5	30	0	0
5	29749734	.	T	C	11	16	27	0	2	29	0	0
5	29749827	.	C	G	14	7	21	0	0	21	0	0
5	29750074	.	G	A	6	9	15	0	0	15	0	0
5	29750285	.	G	A	7	5	12	0	1	13	0	0
5	29784196	.	T	A	8	8	16	0	0	16	0	0
5	29784200	.	G	C	8	9	17	0	0	17	0	0
5	29789706	.	T	C	5	6	11	0	0	11	0	0
5	29790175	.	T	A	12	15	27	0	1	28	0	0
5	29790301	.	G	C	5	8	13	0	2	15	0	0
5	29790390	.	A	C	4	8	12	0	0	12	0	0
5	29803960	.	A	C	10	14	24	0	1	25	0	0
5	29817549	.	A	C	2	3	5	0	0	5	0	0
5	29884098	.	T	G	3	2	5	0	0	5	0	0
5	29884125	.	T	C	5	5	10	0	0	10	0	0
5	29888138	.	T	C	3	2	5	0	0	5	0	0
5	29893544	.	T	C	6	3	9	0	0	9	0	0
5	29894003	.	T	C	5	5	10	0	0	10	0	0
5	30053125	.	G	A	4	3	7	0	1	8	0	0
5	30053182	.	G	A	9	7	16	0	1	17	0	0
5	30053291	.	C	T	1	9	10	1	7	18	0	0
5	30054008	.	G	T	2	8	10	0	0	10	0	0
5	30054062	.	T	C	3	12	15	0	3	18	0	0
5	30054122	.	T	A	4	8	12	0	0	12	0	0
5	30054201	.	T	C	2	0	2	0	5	7	0	0
5	30054203	.	G	T	2	4	6	0	1	7	0	0
5	30054255	.	G	T	4	4	8	0	0	8	0	0
5	30054403	.	T	A	2	2	4	1	0	5	0	0
5	30054566	.	G	A	2	4	6	0	0	6	0	0
5	30055086	.	G	T	2	3	5	0	0	5	0	0
5	30055267	.	A	T	4	5	9	0	0	9	0	0
5	30055294	.	C	T	0	4	4	0	1	5	0	0
5	30056162	.	G	T	4	5	9	0	0	9	0	0
5	30056993	.	G	C	5	4	9	0	1	10	0	0
5	30062903	.	C	A	1	4	5	0	0	5	0	0
5	30068381	.	G	C	3	2	5	0	0	5	0	0
5	30068396	.	T	A	3	3	6	0	0	6	0	0
5	30074289	.	C	T	0	3	3	0	4	7	0	0
5	30081359	.	G	A	5	8	13	0	1	14	0	0
5	30081495	.	G	A	16	13	29	0	1	30	0	0
5	30081737	.	C	T	7	10	17	1	0	18	0	0
5	30087667	.	C	A	5	11	16	3	1	20	0	0
5	30087954	.	G	A	12	6	18	0	1	19	0	0
5	30090364	.	C	A	6	4	10	0	0	10	0	0
5	30090419	.	T	A	0	4	4	0	0	4	0	0
5	30145265	.	A	G	2	3	5	0	1	6	0	0
5	30145601	.	C	T	1	6	7	0	0	7	0	0
5	30145718	.	T	A	1	4	5	0	0	5	0	0
5	30145850	.	A	G	2	2	4	0	0	4	0	0
5	30179816	.	A	C	1	1	2	0	3	5	0	0
5	30203613	.	T	C	1	2	3	0	0	3	0	0
5	30208905	.	A	T	1	4	5	0	0	5	0	0
5	30415236	.	A	G	23	11	34	0	2	36	0	0
5	30437327	.	T	C	2	0	2	0	3	5	0	0
5	30437804	.	C	T	7	4	11	0	0	11	0	0
5	30440415	.	T	C	3	0	3	0	5	8	0	0
5	30440486	.	G	T	6	3	9	0	1	10	0	0
5	30456179	.	T	A	5	2	7	0	1	8	0	0
5	30466621	.	A	C	2	3	5	0	0	5	0	0
5	30466678	.	C	G	3	3	6	0	0	6	0	0
5	30466705	.	T	G	1	2	3	0	0	3	0	0
5	30466853	.	G	A	3	5	8	0	0	8	0	0
5	30502862	.	A	G	15	6	21	0	0	21	0	0
5	30503022	.	A	G	7	3	10	0	0	10	0	0
5	30503194	.	C	A	4	5	9	0	1	10	0	0
5	30507329	.	T	G	3	14	17	0	0	17	0	0
5	30507745	.	A	T	5	3	8	0	0	8	0	0
5	30510396	.	A	G	7	3	10	0	1	11	0	0
5	30513045	.	G	T	2	2	4	0	2	6	0	0
5	30513069	.	G	A	2	4	6	0	0	6	0	0
5	30516553	.	G	A	5	2	7	0	0	7	0	0
5	30534910	.	G	A	11	15	26	0	0	26	0	0
5	30537647	.	A	G	12	16	28	0	1	29	0	0
5	30538043	.	T	C	11	0	11	0	20	31	0	0
5	30538110	.	G	T	13	19	32	0	1	33	0	0
5	30542683	.	A	G	20	20	40	0	1	41	0	0
5	30542695	.	C	T	19	16	35	0	3	38	0	0
5	30544147	.	T	C	14	14	28	0	0	28	0	0
5	30544364	.	G	A	16	16	32	0	1	33	0	0
5	30549756	.	G	A	11	6	17	0	0	17	0	0
5	30554108	.	C	A	8	11	19	0	0	19	0	0
5	30554110	.	T	G	8	9	17	0	2	19	0	0
5	30554190	.	T	C	14	4	18	0	0	18	0	0
5	30554191	.	G	T	13	4	17	0	1	18	0	0
5	30583872	.	G	C	10	0	10	0	7	17	0	0
5	30583995	.	G	A	11	3	14	0	0	14	0	0
5	30586171	.	A	T	5	6	11	0	0	11	0	0
5	30588905	.	C	T	1	2	3	0	0	3	0	0
5	30588933	.	T	C	2	2	4	0	0	4	0	0
5	30589722	.	T	C	2	2	4	0	1	5	0	0
5	30589728	.	C	T	3	2	5	0	0	5	0	0
5	30594075	.	A	G	6	6	12	0	0	12	0	0
5	30605226	.	G	A	4	6	10	0	0	10	0	0
5	30605280	.	G	A	6	2	8	0	0	8	0	0
5	30605880	.	A	G	3	3	6	0	0	6	0	0
5	30606022	.	G	T	1	3	4	0	0	4	0	0
5	30606067	.	T	A	2	3	5	0	0	5	0	0
5	30624183	.	G	A	2	3	5	0	0	5	0	0
5	30624264	.	C	A	2	3	5	0	0	5	0	0
5	30624345	.	G	C	7	6	13	0	1	14	0	0
5	30624432	.	C	A	2	6	8	0	0	8	0	0
5	30624638	.	A	G	4	3	7	0	0	7	0	0
5	30635431	.	T	A	1	5	6	0	1	7	0	0
5	30635497	.	C	T	2	6	8	0	1	9	0	0
5	30661242	.	G	A	5	3	8	0	1	9	0	0
5	30661296	.	T	C	6	3	9	0	1	10	0	0
5	30661443	.	C	A	6	4	10	0	0	10	0	0
5	30663282	.	G	A	2	3	5	0	7	12	0	0
5	30665690	.	G	A	0	7	7	0	5	12	0	0
5	30665720	.	C	T	5	6	11	0	0	11	0	0
5	30669581	.	C	T	6	3	9	0	0	9	0	0
5	30670212	.	A	G	9	4	13	0	2	15	0	0
5	30670251	.	G	C	11	4	15	0	0	15	0	0
5	30672016	.	A	T	7	3	10	0	0	10	0	0
5	30672019	.	T	C	6	3	9	0	0	9	0	0
5	30672366	.	T	C	8	17	25	0	1	26	0	0
5	30672446	.	C	T	10	10	20	0	0	20	0	0
5	30699337	.	A	T	34	17	51	0	0	51	0	0
5	30702796	.	G	A	4	9	13	0	2	15	0	0
5	30702903	.	A	T	11	9	20	0	0	20	0	0
5	30704029	.	C	T	6	9	15	0	0	15	0	0
5	30704188	.	G	A	7	10	17	0	0	17	0	0
5	30704229	.	C	T	3	4	7	0	0	7	0	0
5	30760569	.	A	T	5	3	8	0	1	9	0	0
5	30760821	.	C	T	6	5	11	0	1	12	0	0
5	30763118	.	T	C	4	6	10	0	0	10	0	0
5	30764160	.	T	G	6	8	14	0	1	15	0	0
5	30764214	.	T	C	7	9	16	0	0	16	0	0
5	30764629	.	T	G	9	10	19	0	0	19	0	0
5	30764820	.	A	G	4	13	17	0	0	17	0	0
5	30766804	.	T	C	11	3	14	0	2	16	0	0
5	30770617	.	C	T	4	5	9	0	0	9	0	0
5	30804287	.	G	A	5	3	8	0	0	8	0	0
5	30805072	.	T	A	2	9	11	0	0	11	0	0
5	30805147	.	G	A	4	2	6	0	0	6	0	0
5	30805623	.	A	G	12	15	27	0	1	28	0	0
5	30805781	.	A	G	8	8	16	0	0	16	0	0
5	30806237	.	C	T	5	5	10	0	0	10	0	0
5	30806391	.	C	G	3	10	13	0	2	15	0	0
5	30806553	.	T	C	7	6	13	0	0	13	0	0
5	30806962	.	G	A	7	12	19	0	0	19	0	0
5	30806966	.	T	G	8	11	19	0	0	19	0	0
5	30828381	.	T	G	4	5	9	0	0	9	0	0
5	30828680	.	G	A	2	3	5	0	0	5	0	0
5	30828761	.	C	T	1	3	4	0	0	4	0	0
5	30842345	.	G	A	5	2	7	0	0	7	0	0
5	30842363	.	A	G	5	2	7	0	0	7	0	0
5	30891443	.	A	G	7	5	12	0	0	12	0	0
5	30891565	.	A	C	6	7	13	0	1	14	0	0
5	30924101	.	T	C	7	10	17	0	1	18	0	0
5	30924247	.	T	A	13	7	20	0	0	20	0	0
5	30994105	.	T	A	9	11	20	0	1	22	1	0
5	30994256	.	C	T	4	7	11	0	1	12	0	0
5	30994610	.	T	C	13	5	18	0	0	18	0	0
5	30994818	.	C	T	4	12	16	0	0	16	0	0
5	30994843	.	G	T	1	11	12	0	0	12	0	0
5	30994882	.	C	T	1	4	5	0	1	6	0	0
5	31015399	.	G	A	2	3	5	0	0	5	0	0
5	31015566	.	T	C	3	6	9	0	0	9	0	0
5	31021146	.	G	A	1	2	3	0	1	4	0	0
5	31021450	.	C	T	6	3	9	0	0	9	0	0
5	31025009	.	G	T	0	7	7	0	4	11	0	0
5	31029089	.	G	A	5	4	9	0	4	13	0	0
5	31029471	.	G	A	0	12	12	0	7	19	0	0
5	31029520	.	G	A	2	9	11	0	12	23	0	0
5	31029701	.	G	T	9	3	12	0	1	13	0	0
5	31029702	.	G	T	9	4	13	0	0	13	0	0
5	31029766	.	C	T	6	8	14	0	2	16	0	0
5	31029886	.	A	C	4	9	13	0	1	14	0	0
5	31029898	.	A	G	4	9	13	0	0	13	0	0
5	31030037	.	T	A	5	5	10	0	1	11	0	0
5	31030435	.	A	G	14	0	14	0	6	20	0	0
5	31061637	.	C	A	1	3	4	0	0	4	0	0
5	31068612	.	C	T	5	2	7	0	1	8	0	0
5	31069699	.	C	T	3	3	6	0	0	6	0	0
5	31069714	.	C	T	3	3	6	0	0	6	0	0
5	31071736	.	C	A	5	2	7	0	0	7	0	0
5	31071802	.	C	A	8	3	11	0	0	11	0	0
5	31071820	.	C	A	6	4	10	0	0	10	0	0
5	31073991	.	T	A	3	4	7	0	0	7	0	0
5	31074007	.	T	C	2	3	5	0	1	6	0	0
5	31078042	.	T	C	2	3	5	0	0	5	0	0
5	31078048	.	A	G	2	3	5	0	0	5	0	0
5	31082425	.	T	C	4	6	10	0	1	11	0	0
5	31084778	.	A	G	4	2	6	0	0	6	0	0
5	31087232	.	G	A	0	8	8	0	3	11	0	0
5	31092294	.	T	C	3	6	9	0	1	10	0	0
5	31092321	.	C	T	5	5	10	0	0	10	0	0
5	31108523	.	A	G	6	0	6	0	7	13	0	0
5	31108569	.	T	A	6	6	12	0	0	12	0	0
5	31108800	.	A	G	6	0	6	0	7	13	0	0
5	31108804	.	T	C	7	6	13	0	1	14	0	0
5	31108922	.	A	G	7	4	11	0	0	11	0	0
5	31230971	.	T	A	2	4	6	0	0	6	0	0
5	31264263	.	C	T	19	19	38	0	0	38	0	0
5	31266352	.	T	A	24	15	39	0	3	42	0	0
5	31266620	.	G	A	14	20	34	0	2	36	0	0
5	31266676	.	T	C	17	11	28	0	4	32	0	0
5	31266716	.	T	G	16	17	33	0	2	35	0	0
5	31267009	.	C	G	15	18	33	0	1	34	0	0
5	31267164	.	A	G	15	13	28	0	2	30	0	0
5	31267233	.	A	C	21	11	32	0	1	33	0	0
5	31267254	.	A	G	17	12	29	0	3	32	0	0
5	31267313	.	T	A	10	18	28	0	0	28	0	0
5	31267336	.	G	A	15	13	28	0	5	33	0	0
5	31267450	.	T	G	20	0	20	0	23	43	0	0
5	31267655	.	C	T	15	19	34	0	2	36	0	0
5	31267975	.	T	C	25	20	45	0	0	45	0	0
5	31268104	.	A	T	22	23	45	0	1	46	0	0
5	31268417	.	A	G	26	25	51	0	3	54	0	0
5	31268489	.	T	C	19	22	41	0	1	42	0	0
5	31268601	.	G	A	27	12	39	0	1	40	0	0
5	31269004	.	C	T	14	24	38	0	3	41	0	0
5	31334390	.	T	C	3	6	9	0	0	9	0	0
5	31401792	.	T	A	3	3	6	0	0	6	0	0
5	31419826	.	G	A	5	8	13	0	0	13	0	0
5	31431901	.	C	T	2	3	5	0	0	5	0	0
5	31432024	.	C	G	1	2	3	0	0	3	0	0
5	31432032	.	G	T	0	2	2	0	1	3	0	0
5	31432252	.	C	T	2	2	4	0	0	4	0	0
5	31432387	.	A	G	2	3	5	0	0	5	0	0
5	31432444	.	G	T	2	4	6	0	1	7	0	0
5	31432498	.	A	T	5	2	7	0	0	7	0	0
5	31480399	.	C	G	1	4	5	0	0	5	0	0
5	31480674	.	C	T	5	3	8	0	0	8	0	0
5	31480891	.	A	T	1	3	4	0	0	4	0	0
5	31546306	.	T	A	6	3	9	0	0	9	0	0
5	31562670	.	G	A	1	3	4	0	3	7	0	0
5	31579415	.	C	A	6	3	9	0	0	9	0	0
5	31579508	.	T	C	8	6	14	0	0	14	0	0
5	31644517	.	T	A	8	6	14	0	1	15	0	0
5	31644614	.	T	G	12	14	26	0	1	28	1	0
5	31644867	.	A	G	14	19	33	0	3	36	0	0
5	31649757	.	G	A	16	21	37	0	1	38	0	0
5	31658294	.	C	T	14	21	35	0	5	40	0	0
5	31658303	.	T	C	15	19	34	0	1	35	0	0
5	31699112	.	T	C	8	0	8	0	5	13	0	0
5	31703395	.	A	G	2	5	7	0	0	7	0	0
5	31703432	.	T	C	3	0	3	0	4	7	0	0
5	31703622	.	G	A	4	8	12	0	0	12	0	0
5	31711869	.	C	G	4	4	8	0	1	9	0	0
5	31711915	.	T	C	1	0	1	0	6	7	0	0
5	31712231	.	A	G	1	3	4	0	0	4	0	0
5	31712245	.	C	A	1	3	4	0	1	5	0	0
5	31714394	.	G	A	2	6	8	0	1	9	0	0
5	31714550	.	C	T	9	11	20	0	0	20	0	0
5	31714742	.	A	C	14	18	32	0	0	32	0	0
5	31714914	.	T	C	10	24	34	0	2	36	0	0
5	31723612	.	A	G	7	2	9	0	0	9	0	0
5	31723845	.	G	A	9	7	16	0	0	16	0	0
5	31723870	.	A	G	10	7	17	0	0	17	0	0
5	31724052	.	T	G	3	2	5	0	0	5	0	0
5	31730513	.	T	C	1	7	8	0	0	8	0	0
5	31730525	.	T	G	2	7	9	0	0	9	0	0
5	31735704	.	T	C	2	3	5	0	2	7	0	0
5	33019181	.	G	A	4	3	7	0	0	7	0	0
5	33019571	.	C	G	7	4	11	0	0	11	0	0
5	33019598	.	G	A	5	5	10	0	0	10	0	0
5	33019826	.	T	C	3	5	8	0	0	8	0	0
5	33200071	.	G	A	7	11	18	0	2	20	0	0
5	33200279	.	T	C	20	1	21	0	14	35	0	0
5	33208429	.	A	G	9	17	26	2	0	28	0	0
5	33215307	.	G	A	4	2	6	0	0	6	0	0
5	33238950	.	C	A	6	3	9	0	0	9	0	0
5	33239444	.	G	T	4	9	13	0	1	14	0	0
5	33239486	.	A	G	3	11	14	0	0	14	0	0
5	33239551	.	A	T	5	5	10	0	0	10	0	0
5	33239625	.	T	C	4	8	12	0	2	14	0	0
5	33239965	.	G	C	6	7	13	0	1	14	0	0
5	33239996	.	T	C	5	5	10	0	1	11	0	0
5	33240295	.	G	A	5	14	19	0	4	23	0	0
5	33240425	.	A	T	4	6	10	0	1	11	0	0
5	33240469	.	T	C	11	8	19	0	1	20	0	0
5	33240600	.	G	A	6	9	15	0	0	15	0	0
5	33240930	.	A	T	6	7	13	0	1	14	0	0
5	33245860	.	C	T	0	4	4	0	2	6	0	0
5	33247152	.	C	T	4	6	10	0	0	10	0	0
5	33248925	.	G	A	2	8	10	0	0	10	0	0
5	33251276	.	A	T	2	3	5	0	0	5	0	0
5	33268218	.	T	C	2	3	5	0	0	5	0	0
5	33268426	.	T	G	5	2	7	0	0	7	0	0
5	33269645	.	A	G	5	3	8	0	0	8	0	0
5	33272649	.	A	G	2	2	4	0	0	4	0	0
5	33272654	.	A	T	3	2	5	0	0	5	0	0
5	33277701	.	A	G	3	9	12	0	0	12	0	0
5	33280951	.	A	G	3	2	5	0	0	5	0	0
5	33281047	.	A	C	4	3	7	0	0	7	0	0
5	33281196	.	T	C	2	3	5	0	0	5	0	0
5	33285096	.	C	T	6	35	41	0	35	76	0	0
5	33289072	.	T	G	7	6	13	0	1	14	0	0
5	33289170	.	A	T	8	3	11	0	1	12	0	0
5	33290815	.	A	G	7	0	7	0	7	14	0	0
5	33296924	.	G	T	15	14	29	0	2	31	0	0
5	33297994	.	G	A	10	3	13	0	0	13	0	0
5	33302826	.	C	A	3	3	6	0	1	7	0	0
5	33304310	.	G	C	4	3	7	0	0	7	0	0
5	33304337	.	T	C	3	3	6	0	0	6	0	0
5	33307621	.	C	G	7	10	17	0	1	18	0	0
5	33307805	.	C	G	8	13	21	0	0	21	0	0
5	33307812	.	C	A	7	11	18	0	1	19	0	0
5	33310458	.	G	T	6	6	12	0	0	12	0	0
5	33310947	.	T	G	5	8	13	0	1	14	0	0
5	33314422	.	G	C	10	5	15	0	0	15	0	0
5	33314610	.	T	C	4	7	11	1	0	12	0	0
5	33315247	.	A	T	7	5	12	0	0	12	0	0
5	33318597	.	G	A	1	11	12	0	11	23	0	0
5	33328791	.	C	A	8	13	21	0	1	22	0	0
5	33328939	.	A	G	11	8	19	0	1	20	0	0
5	33329210	.	G	A	1	5	6	0	9	15	0	0
5	33329345	.	G	A	3	15	18	0	13	31	0	0
5	33329418	.	G	A	21	12	33	0	0	33	0	0
5	33329600	.	T	C	8	15	23	0	0	23	0	0
5	33329740	.	G	T	10	6	16	0	1	17	0	0
5	33329774	.	A	G	7	5	12	0	0	12	0	0
5	33329786	.	A	G	2	12	14	0	0	14	0	0
5	33330146	.	G	C	12	9	21	0	2	23	0	0
5	33330435	.	C	A	1	3	4	0	0	4	0	0
5	33336805	.	C	A	3	4	7	0	1	8	0	0
5	33336920	.	A	G	2	6	8	0	1	9	0	0
5	33336934	.	C	T	2	5	7	0	0	7	0	0
5	33337041	.	T	A	3	1	4	1	0	5	0	0
5	33337050	.	G	A	2	3	5	1	0	6	0	0
5	33337470	.	C	G	3	4	7	0	0	7	0	0
5	33337593	.	A	T	4	5	9	0	0	9	0	0
5	33337610	.	A	G	4	6	10	0	1	11	0	0
5	33337776	.	A	C	5	4	9	0	1	10	0	0
5	33338099	.	T	A	4	15	19	0	2	21	0	0
5	33360761	.	C	G	10	7	17	0	1	18	0	0
5	33360835	.	T	G	7	14	21	0	0	21	0	0
5	33360884	.	T	C	14	8	22	0	0	22	0	0
5	33382095	.	G	A	4	4	8	0	0	8	0	0
5	33385512	.	T	A	1	6	7	0	3	10	0	0
5	33387624	.	A	G	7	5	12	0	1	13	0	0
5	33537918	.	T	A	1	5	6	0	0	6	0	0
5	33538011	.	G	T	2	6	8	0	0	8	0	0
5	33538197	.	C	T	0	3	3	0	2	5	0	0
5	33554892	.	T	C	1	2	3	0	0	3	0	0
5	33558640	.	T	C	5	0	5	0	3	8	0	0
5	33636449	.	C	T	2	3	5	0	0	5	0	0
5	33636887	.	A	G	2	3	5	0	0	5	0	0
5	33658010	.	G	A	2	2	4	0	0	4	0	0
5	33668755	.	A	G	3	4	7	0	1	8	0	0
5	33668894	.	C	T	3	5	8	0	0	8	0	0
5	33668936	.	G	T	0	3	3	0	1	4	0	0
5	33668943	.	A	T	4	0	4	0	0	4	0	0
5	33679862	.	T	G	6	7	13	0	0	13	0	0
5	33680184	.	T	G	18	9	27	0	1	28	0	0
5	33692389	.	C	T	0	3	3	0	4	7	0	0
5	33694109	.	T	C	11	7	18	0	1	19	0	0
5	33698666	.	G	A	8	5	13	0	2	15	0	0
5	34066594	.	C	T	4	2	6	0	0	6	0	0
5	34066837	.	G	A	8	4	12	0	0	12	0	0
5	34098880	.	G	T	8	4	12	0	0	12	0	0
5	34185186	.	C	G	4	2	6	0	0	6	0	0
5	34185195	.	C	T	4	2	6	0	0	6	0	0
5	34532673	.	T	C	1	2	3	0	0	3	0	0
5	34532752	.	T	C	1	6	7	0	0	7	0	0
5	34542344	.	C	T	6	3	9	0	1	10	0	0
5	34542389	.	G	C	3	7	10	0	0	10	0	0
5	34568883	.	T	C	14	17	31	0	0	31	0	0
5	34573792	.	T	C	17	17	34	0	1	35	0	0
5	34573807	.	T	C	21	24	45	0	1	46	0	0
5	34574165	.	G	A	19	13	32	0	1	33	0	0
5	34574191	.	T	G	17	13	30	0	2	32	0	0
5	34574224	.	G	A	18	10	28	0	1	29	0	0
5	34574238	.	C	A	17	10	27	0	0	27	0	0
5	34574267	.	G	A	13	14	27	0	0	27	0	0
5	34574546	.	A	G	12	0	12	0	27	39	0	0
5	34574915	.	C	T	14	15	29	0	1	30	0	0
5	34574919	.	A	G	15	17	32	0	0	32	0	0
5	34575079	.	T	A	22	2	24	0	2	26	0	0
5	34586139	.	T	G	1	2	3	0	0	3	0	0
5	34588977	.	A	G	4	0	4	0	4	8	0	0
5	34589009	.	G	T	5	6	11	0	0	11	0	0
5	34589225	.	G	T	7	3	10	0	0	10	0	0
5	34593568	.	A	G	2	7	9	0	0	9	0	0
5	34600639	.	C	G	2	2	4	0	0	4	0	0
5	34603792	.	T	G	4	8	12	0	0	12	0	0
5	34603811	.	T	C	4	8	12	0	0	12	0	0
5	34606570	.	C	T	6	5	11	0	1	12	0	0
5	34609005	.	A	G	4	7	11	0	0	11	0	0
5	34609116	.	G	C	3	0	3	0	3	6	0	0
5	34609321	.	A	G	4	3	7	0	0	7	0	0
5	34609324	.	G	A	3	3	6	0	0	6	0	0
5	34609357	.	G	A	4	4	8	0	1	9	0	0
5	34614057	.	A	G	2	5	7	0	0	7	0	0
5	34625129	.	T	C	1	2	3	0	0	3	0	0
5	34626076	.	T	C	6	5	11	0	0	11	0	0
5	34633673	.	C	T	6	2	8	0	1	9	0	0
5	34634180	.	C	A	7	2	9	0	0	9	0	0
5	34634253	.	T	G	10	4	14	0	0	14	0	0
5	34634754	.	T	A	1	3	4	0	0	4	0	0
5	34634894	.	G	T	6	5	11	0	0	11	0	0
5	34635133	.	A	T	16	4	20	0	0	20	0	0
5	34635194	.	A	G	8	10	18	0	1	19	0	0
5	34635451	.	A	C	3	2	5	0	0	5	0	0
5	34635673	.	G	A	7	11	18	0	0	18	0	0
5	34635795	.	A	T	5	4	9	0	0	12	3	0
5	34636252	.	G	A	8	8	16	0	1	17	0	0
5	34636347	.	G	T	2	5	7	0	0	7	0	0
5	34636413	.	G	A	4	5	9	0	0	9	0	0
5	34636457	.	A	T	4	8	12	0	1	13	0	0
5	34636638	.	T	C	4	3	7	0	1	8	0	0
5	34636731	.	A	T	10	5	15	0	1	16	0	0
5	34636986	.	T	G	6	8	14	0	1	15	0	0
5	34637067	.	T	C	5	6	11	0	1	12	0	0
5	34637399	.	A	C	7	8	15	4	2	21	0	0
5	34637466	.	T	C	6	11	17	0	0	17	0	0
5	34637539	.	A	G	6	8	14	0	2	16	0	0
5	34637667	.	T	G	7	8	15	0	0	15	0	0
5	34637681	.	A	G	4	9	13	0	2	15	0	0
5	34637706	.	T	G	9	11	20	0	1	21	0	0
5	34637843	.	A	G	23	9	32	0	1	33	0	0
5	34637849	.	G	C	24	9	33	0	1	34	0	0
5	34637997	.	A	C	17	19	36	0	0	36	0	0
5	34837117	.	A	G	3	2	5	0	1	6	0	0
5	34981636	.	A	T	3	4	7	0	0	7	0	0
5	34982414	.	G	A	6	6	12	0	0	12	0	0
5	34982866	.	C	G	7	0	7	0	8	15	0	0
5	34987043	.	A	T	17	21	38	0	1	39	0	0
5	34987812	.	G	A	35	25	60	1	1	62	0	0
5	34991271	.	C	T	23	34	57	0	5	62	0	0
5	34998551	.	A	G	1	4	5	0	0	5	0	0
5	35123955	.	C	T	6	7	13	0	0	13	0	0
5	35124398	.	C	T	13	7	20	0	0	20	0	0
5	35124435	.	T	C	10	0	10	0	11	21	0	0
5	35124939	.	G	A	8	5	13	0	1	14	0	0
5	35125414	.	C	T	0	3	3	0	4	7	0	0
5	35125423	.	C	T	5	3	8	0	0	8	0	0
5	35125492	.	C	T	1	4	5	0	3	8	0	0
5	35125882	.	G	A	6	6	12	0	1	13	0	0
5	35125883	.	A	T	6	6	12	0	1	13	0	0
5	35127255	.	G	C	8	4	12	0	0	12	0	0
5	35129861	.	C	A	5	3	8	0	0	8	0	0
5	35129892	.	T	C	5	0	5	0	4	9	0	0
5	35137621	.	C	T	0	4	4	0	9	13	0	0
5	35178640	.	G	A	0	2	2	0	1	3	0	0
5	35202771	.	G	T	3	3	6	0	0	6	0	0
5	35202815	.	T	A	9	12	21	0	3	24	0	0
5	35202876	.	A	T	13	7	20	0	2	22	0	0
5	35202958	.	G	A	9	11	20	0	0	21	1	0
5	35202959	.	A	T	9	11	20	0	1	21	0	0
5	35203092	.	G	A	14	6	20	0	1	21	0	0
5	35203544	.	G	A	12	6	18	0	0	18	0	0
5	35203629	.	C	T	2	12	14	0	18	32	0	0
5	35204077	.	T	G	8	7	15	0	3	18	0	0
5	35204390	.	G	A	9	2	11	0	1	12	0	0
5	35204681	.	A	C	4	11	15	0	0	15	0	0
5	35204689	.	A	C	4	0	4	0	11	15	0	0
5	35204857	.	T	C	11	0	11	0	5	16	0	0
5	35204934	.	A	T	10	4	14	0	1	15	0	0
5	35204945	.	T	C	12	7	19	0	2	21	0	0
5	35205005	.	G	A	15	10	25	0	1	26	0	0
5	35205123	.	C	G	6	5	11	0	1	12	0	0
5	35207914	.	T	G	7	5	12	0	0	12	0	0
5	35218361	.	G	A	6	3	9	0	0	9	0	0
5	35220402	.	T	A	4	2	6	0	0	6	0	0
5	35222413	.	T	G	3	8	11	0	0	11	0	0
5	35229964	.	G	A	2	3	5	0	0	5	0	0
5	35241963	.	A	T	1	2	3	0	0	3	0	0
5	35253608	.	T	C	3	0	3	0	4	7	0	0
5	35258669	.	T	C	3	0	3	0	6	9	0	0
5	35258880	.	C	T	5	6	11	0	1	12	0	0
5	35259846	.	G	C	4	6	10	0	0	10	0	0
5	35260553	.	A	G	4	2	6	0	1	7	0	0
5	35260554	.	C	T	4	2	6	0	1	7	0	0
5	35261066	.	T	A	5	2	7	0	1	8	0	0
5	35261280	.	A	T	5	2	7	0	0	7	0	0
5	35262439	.	C	A	3	4	7	0	0	7	0	0
5	35271001	.	C	T	29	17	46	0	3	49	0	0
5	35271465	.	T	C	31	21	52	0	3	55	0	0
5	35271613	.	G	A	9	27	36	0	2	38	0	0
5	35271706	.	C	T	14	34	48	0	1	49	0	0
5	35271791	.	T	A	25	20	45	0	7	52	0	0
5	35271824	.	C	A	23	24	47	0	2	49	0	0
5	35271889	.	T	A	18	15	33	0	0	33	0	0
5	35272562	.	A	C	11	21	32	0	0	32	0	0
5	35272774	.	T	G	14	18	32	0	1	33	0	0
5	35272835	.	G	A	20	24	44	0	1	45	0	0
5	35272909	.	A	G	25	17	42	0	1	43	0	0
5	35273099	.	G	C	24	16	40	0	0	40	0	0
5	35273164	.	T	C	16	20	36	0	3	39	0	0
5	35273632	.	T	C	20	6	26	0	1	27	0	0
5	35273793	.	A	T	21	17	38	0	1	39	0	0
5	35273825	.	C	A	20	20	40	0	3	43	0	0
5	35273838	.	A	C	24	20	44	0	2	46	0	0
5	35274029	.	C	A	16	19	35	0	1	36	0	0
5	35275070	.	G	A	18	28	46	0	1	47	0	0
5	35275103	.	C	T	24	20	44	0	1	45	0	0
5	35276154	.	A	G	14	9	23	0	0	23	0	0
5	35276911	.	C	T	1	5	6	0	10	16	0	0
5	35277256	.	T	A	9	6	15	0	0	15	0	0
5	35277319	.	T	C	9	8	17	0	0	17	0	0
5	35277459	.	T	C	11	5	16	0	2	18	0	0
5	35278597	.	C	T	8	4	12	0	0	12	0	0
5	35278863	.	C	T	4	4	8	0	0	8	0	0
5	35278933	.	T	C	3	0	3	0	4	7	0	0
5	35279275	.	T	G	7	6	13	0	0	13	0	0
5	35279341	.	G	A	6	4	10	0	0	10	0	0
5	35279387	.	T	G	6	3	9	0	0	9	0	0
5	35279647	.	G	T	1	6	7	0	0	7	0	0
5	35279884	.	G	A	1	5	6	0	0	6	0	0
5	35280157	.	T	C	3	0	3	0	2	5	0	0
5	35301563	.	A	G	1	2	3	0	0	3	0	0
5	35422550	.	G	C	2	1	3	0	7	10	0	0
5	35422692	.	C	T	11	6	17	0	1	18	0	0
5	35431641	.	A	G	8	5	13	0	0	13	0	0
5	35431703	.	T	G	7	9	16	0	0	16	0	0
5	35454416	.	C	T	1	14	15	0	10	25	0	0
5	35454464	.	C	T	9	13	22	0	2	24	0	0
5	35478326	.	G	A	7	5	12	0	0	12	0	0
5	35478593	.	G	C	0	4	4	0	4	8	0	0
5	35486917	.	C	A	4	2	6	0	0	6	0	0
5	35487132	.	C	T	11	8	19	0	0	19	0	0
5	35487658	.	G	C	6	6	12	0	1	13	0	0
5	35506763	.	C	A	1	2	3	0	0	3	0	0
5	35506772	.	T	G	1	2	3	0	0	3	0	0
5	35683116	.	G	A	1	1	2	0	1	3	0	0
5	35683134	.	C	A	2	2	4	0	1	5	0	0
5	35683225	.	C	A	1	2	3	0	2	5	0	0
5	35683861	.	A	G	4	2	6	0	0	6	0	0
5	35683950	.	T	A	1	3	4	0	0	4	0	0
5	35683965	.	C	T	0	4	4	0	1	5	0	0
5	35683991	.	A	G	1	2	3	0	0	3	0	0
5	35749470	.	A	G	2	6	8	0	1	9	0	0
5	35749826	.	A	G	6	3	9	0	0	9	0	0
5	35751883	.	G	T	7	4	11	0	2	13	0	0
5	35751970	.	C	T	10	6	16	0	1	17	0	0
5	35751977	.	A	G	9	11	20	0	1	21	0	0
5	35754354	.	A	G	17	12	29	0	1	30	0	0
5	35754481	.	T	G	13	8	21	0	1	22	0	0
5	35955514	.	T	C	13	13	26	0	1	27	0	0
5	35955534	.	G	T	16	14	30	0	0	30	0	0
5	35955663	.	T	A	15	4	19	0	2	21	0	0
5	35967234	.	C	T	8	11	19	0	0	19	0	0
5	35967270	.	T	A	5	4	9	0	0	9	0	0
5	36274750	.	C	A	2	2	4	0	1	5	0	0
5	36296066	.	G	A	2	1	3	0	1	4	0	0
5	36416597	.	C	G	17	18	35	0	0	35	0	0
5	36421991	.	G	A	1	8	9	0	9	18	0	0
5	36536924	.	A	G	6	4	10	0	1	11	0	0
5	36537182	.	G	A	2	6	8	0	7	15	0	0
5	36537510	.	A	G	8	2	10	0	0	10	0	0
5	36537522	.	A	G	10	2	12	0	0	12	0	0
5	36551614	.	C	A	6	12	18	0	1	19	0	0
5	36551824	.	C	T	1	21	22	0	15	37	0	0
5	36558059	.	G	A	23	12	35	0	1	36	0	0
5	36558286	.	G	A	13	24	37	0	0	37	0	0
5	36558369	.	G	A	12	12	24	0	2	26	0	0
5	36558441	.	C	T	20	16	36	0	0	36	0	0
5	36563257	.	T	C	8	16	24	0	1	25	0	0
5	36567750	.	C	A	1	3	4	0	11	16	1	0
5	36568071	.	A	T	11	14	25	0	1	26	0	0
5	36570280	.	G	A	4	13	17	0	2	19	0	0
5	36577828	.	T	C	5	9	14	0	1	15	0	0
5	36583575	.	C	T	1	5	6	0	6	12	0	0
5	36583644	.	G	A	2	6	8	1	0	9	0	0
5	36584779	.	G	T	2	4	6	0	1	7	0	0
5	36584985	.	C	T	8	3	11	0	0	11	0	0
5	36585662	.	G	A	5	4	9	0	1	10	0	0
5	36586844	.	A	C	3	2	5	0	0	5	0	0
5	36596278	.	G	A	4	3	7	0	0	7	0	0
5	36596294	.	G	A	4	5	9	0	0	9	0	0
5	36596517	.	C	A	2	5	7	0	6	13	0	0
5	36614419	.	A	G	13	2	15	0	0	15	0	0
5	36624638	.	A	T	16	13	29	0	0	29	0	0
5	36625809	.	A	T	12	17	29	0	0	29	0	0
5	36626632	.	A	T	19	19	38	0	1	39	0	0
5	36650289	.	T	G	5	2	7	0	0	7	0	0
5	36653522	.	G	A	5	7	12	0	0	12	0	0
5	36653876	.	T	G	5	1	6	0	11	17	0	0
5	36654147	.	G	A	2	3	5	0	9	14	0	0
5	36654334	.	A	T	4	2	6	0	0	6	0	0
5	36665351	.	C	T	8	11	19	0	0	19	0	0
5	36668321	.	C	T	6	4	10	0	0	10	0	0
5	36673347	.	C	T	1	3	4	0	0	4	0	0
5	36673470	.	C	A	6	5	11	0	1	12	0	0
5	36673609	.	A	G	5	6	11	0	0	11	0	0
5	36673687	.	A	T	4	3	7	0	0	7	0	0
5	36674005	.	A	T	3	4	7	0	0	7	0	0
5	36674796	.	G	C	2	5	7	0	1	8	0	0
5	36674831	.	C	T	4	5	9	0	1	10	0	0
5	36730732	.	C	T	2	2	4	0	0	4	0	0
5	36732199	.	G	C	24	11	35	0	2	37	0	0
5	36732217	.	A	G	21	13	34	0	3	37	0	0
5	36739134	.	T	C	12	18	30	0	2	32	0	0
5	36739310	.	T	A	13	13	26	0	0	26	0	0
5	36739316	.	T	C	12	12	24	0	0	24	0	0
5	36739352	.	T	A	12	13	25	0	1	26	0	0
5	36739361	.	T	C	12	12	24	0	1	25	0	0
5	36802452	.	A	G	3	0	3	0	6	9	0	0
5	36805119	.	A	G	3	3	6	0	1	7	0	0
5	36832340	.	A	G	6	8	14	0	1	15	0	0
5	36832565	.	A	G	7	9	16	0	1	17	0	0
5	36832577	.	A	C	8	7	15	0	1	16	0	0
5	36833814	.	G	A	4	4	8	0	0	8	0	0
5	36851191	.	C	T	4	11	15	0	0	15	0	0
5	36852564	.	A	G	6	0	6	0	11	17	0	0
5	36852808	.	T	A	11	6	17	0	0	17	0	0
5	36853849	.	C	G	17	9	26	0	0	26	0	0
5	36880027	.	G	A	3	2	5	0	0	5	0	0
5	36895627	.	G	A	1	3	4	0	0	4	0	0
5	36897226	.	G	T	3	1	4	0	1	5	0	0
5	36897361	.	T	A	2	3	5	0	0	5	0	0
5	36898476	.	C	T	24	26	50	0	8	58	0	0
5	36898668	.	A	G	31	0	31	0	25	56	0	0
5	36901003	.	T	G	12	9	21	0	0	21	0	0
5	36902610	.	A	G	6	0	6	0	20	26	0	0
5	36902628	.	T	C	5	20	25	0	0	25	0	0
5	36903131	.	C	T	11	18	29	0	1	30	0	0
5	36907111	.	G	A	4	5	9	0	0	9	0	0
5	36907117	.	C	T	4	7	11	0	0	11	0	0
5	36908004	.	G	T	21	18	39	0	1	40	0	0
5	36908034	.	T	C	21	18	39	0	1	40	0	0
5	36913570	.	A	G	2	3	5	0	0	5	0	0
5	36913916	.	A	T	4	3	7	2	0	9	0	0
5	36916257	.	C	A	0	8	8	0	3	11	0	0
5	36916615	.	C	T	6	6	12	0	0	12	0	0
5	36945327	.	T	G	5	7	12	0	2	14	0	0
5	36945378	.	T	A	18	17	35	7	4	47	1	0
5	36945518	.	T	G	27	23	50	0	3	53	0	0
5	36945608	.	G	A	32	34	66	0	6	72	0	0
5	36945680	.	T	C	32	40	72	0	2	74	0	0
5	36945927	.	A	C	28	39	67	0	3	70	0	0
5	36945937	.	C	T	26	33	59	0	3	62	0	0
5	36946133	.	A	G	32	32	64	0	1	65	0	0
5	36946244	.	A	G	39	34	73	0	7	80	0	0
5	36996638	.	A	G	17	0	17	0	20	37	0	0
5	36997133	.	A	G	15	16	31	0	0	31	0	0
5	37032095	.	A	G	13	15	28	0	1	29	0	0
5	37032225	.	C	G	6	7	13	0	1	14	0	0
5	37032280	.	C	G	7	13	20	0	1	21	0	0
5	37032339	.	A	G	4	0	4	0	20	24	0	0
5	37032446	.	T	C	9	15	24	0	0	24	0	0
5	37032500	.	A	G	5	17	22	0	1	23	0	0
5	37032717	.	A	C	9	16	25	0	1	26	0	0
5	37032782	.	G	A	14	13	27	0	0	27	0	0
5	37032959	.	A	G	8	13	21	0	0	21	0	0
5	37033688	.	C	T	10	14	24	0	2	26	0	0
5	37036421	.	G	A	10	9	19	0	1	20	0	0
5	37036562	.	A	T	9	14	23	0	1	24	0	0
5	37037232	.	A	G	16	12	28	0	0	28	0	0
5	37037256	.	G	T	18	13	31	0	0	31	0	0
5	37037284	.	C	T	18	9	27	0	0	27	0	0
5	37037325	.	G	A	10	3	13	0	0	13	0	0
5	37037392	.	G	T	7	6	13	0	0	13	0	0
5	37037436	.	G	T	0	6	6	0	7	13	0	0
5	37037489	.	A	C	14	11	25	0	0	25	0	0
5	37037669	.	T	G	22	13	35	0	0	35	0	0
5	37037742	.	A	T	17	17	34	0	0	34	0	0
5	37037987	.	A	C	11	11	22	0	2	24	0	0
5	37038017	.	T	C	8	6	14	0	3	17	0	0
5	37065508	.	T	C	18	13	31	0	0	31	0	0
5	37065537	.	T	C	19	9	28	0	0	28	0	0
5	37065729	.	C	T	23	2	25	0	1	29	3	0
5	37091961	.	C	T	1	2	3	0	0	3	0	0
5	37092021	.	C	T	2	2	4	0	0	4	0	0
5	37092067	.	T	C	3	4	7	0	1	8	0	0
5	37093389	.	T	A	2	7	9	0	0	9	0	0
5	37094944	.	T	A	10	6	16	0	0	16	0	0
5	37095008	.	A	C	5	3	8	0	0	9	1	0
5	37095066	.	A	C	4	2	6	0	0	6	0	0
5	37141356	.	T	G	1	3	4	0	0	4	0	0
5	37277355	.	A	G	1	3	4	0	0	4	0	0
5	37277534	.	A	G	2	2	4	0	0	4	0	0
5	37280856	.	C	T	1	3	4	1	0	5	0	0
5	37286325	.	A	G	2	0	2	0	5	7	0	0
5	37286590	.	G	A	2	5	7	0	1	8	0	0
5	37286708	.	G	A	1	4	5	0	0	5	0	0
5	37286709	.	C	A	1	4	5	0	0	5	0	0
5	37293815	.	T	C	8	3	11	0	0	11	0	0
5	37295469	.	C	T	4	8	12	0	0	12	0	0
5	37295646	.	C	T	7	5	12	0	0	12	0	0
5	37296298	.	C	T	5	7	12	0	1	13	0	0
5	37299125	.	G	A	13	12	25	1	2	28	0	0
5	37301236	.	G	A	8	9	17	0	1	18	0	0
5	37301249	.	C	T	5	8	13	0	0	13	0	0
5	37301282	.	C	T	7	5	12	0	1	13	0	0
5	37301505	.	A	G	9	11	20	0	1	21	0	0
5	37301783	.	A	G	14	13	27	0	0	27	0	0
5	37304028	.	T	C	8	6	14	0	1	15	0	0
5	37304070	.	G	T	8	10	18	0	0	18	0	0
5	37307921	.	C	G	21	15	36	0	1	37	0	0
5	37309734	.	A	G	25	13	38	0	2	40	0	0
5	37309881	.	C	T	26	17	43	0	0	43	0	0
5	37312520	.	T	A	20	13	33	0	3	36	0	0
5	37312556	.	A	T	18	18	36	0	1	37	0	0
5	37312577	.	A	G	17	0	17	0	20	37	0	0
5	37312681	.	C	A	10	13	23	0	0	23	0	0
5	37316716	.	G	C	16	1	17	0	19	36	0	0
5	37316743	.	A	G	16	19	35	0	2	37	0	0
5	37316954	.	A	G	16	24	40	0	1	41	0	0
5	37320254	.	A	G	8	13	21	0	0	21	0	0
5	37321251	.	C	G	0	9	9	0	9	18	0	0
5	37321488	.	G	A	5	8	13	0	0	13	0	0
5	37321519	.	C	T	3	7	10	0	0	10	0	0
5	37323690	.	C	T	8	7	15	0	1	16	0	0
5	37380701	.	T	G	2	7	9	0	1	10	0	0
5	37413846	.	C	T	6	4	10	1	0	11	0	0
5	37422993	.	C	T	5	5	10	0	0	10	0	0
5	37422999	.	A	T	5	4	9	0	0	9	0	0
5	37423298	.	G	A	1	7	8	0	3	11	0	0
5	37439388	.	C	T	7	10	17	0	0	17	0	0
5	37439418	.	C	T	7	14	21	0	2	23	0	0
5	37439505	.	T	C	7	8	15	0	0	15	0	0
5	37439517	.	A	C	6	6	12	0	0	12	0	0
5	37439891	.	T	C	10	14	24	0	0	24	0	0
5	37494630	.	A	T	2	2	4	0	0	4	0	0
5	37494666	.	C	T	4	2	6	0	0	6	0	0
5	37504913	.	C	T	3	2	5	0	1	6	0	0
5	37504927	.	G	T	4	2	6	0	0	6	0	0
5	37504966	.	G	A	3	2	5	0	1	6	0	0
5	37507823	.	T	C	5	5	10	0	0	10	0	0
5	37507901	.	C	T	6	4	10	0	0	10	0	0
5	37508303	.	T	C	5	6	11	0	0	11	0	0
5	37508828	.	C	T	5	2	7	1	0	8	0	0
5	37508832	.	T	G	4	2	6	1	1	8	0	0
5	37508893	.	A	T	2	2	4	0	0	4	0	0
5	37509093	.	A	T	1	1	2	0	1	3	0	0
5	37509102	.	T	C	2	3	5	0	0	5	0	0
5	37509156	.	G	A	2	6	8	0	0	8	0	0
5	37509285	.	T	C	6	7	13	0	0	13	0	0
5	37509296	.	G	C	7	7	14	0	0	14	0	0
5	37509374	.	T	A	3	5	8	0	1	9	0	0
5	37509428	.	T	G	3	4	7	0	0	7	0	0
5	37509703	.	C	T	12	8	20	0	0	20	0	0
5	37509766	.	G	A	1	12	13	0	6	19	0	0
5	37509857	.	A	G	5	9	14	0	2	16	0	0
5	37509916	.	A	G	6	3	9	0	0	9	0	0
5	37510292	.	C	T	4	5	9	0	0	9	0	0
5	37510293	.	T	C	4	6	10	0	0	10	0	0
5	37510496	.	G	T	12	9	21	0	0	21	0	0
5	37510565	.	A	T	5	9	14	0	0	14	0	0
5	37580857	.	C	T	4	2	6	0	0	6	0	0
5	37585024	.	T	A	1	2	3	0	0	3	0	0
5	37680403	.	G	A	0	2	2	1	4	7	0	0
5	37684289	.	G	A	7	6	13	0	0	13	0	0
5	37686590	.	C	T	5	8	13	0	0	13	0	0
5	37688077	.	C	T	5	3	8	0	0	8	0	0
5	37688560	.	C	G	6	5	11	0	0	11	0	0
5	37688878	.	A	C	10	9	19	0	2	21	0	0
5	37691459	.	T	C	6	7	13	0	0	13	0	0
5	37691516	.	C	T	8	5	13	0	0	13	0	0
5	37692198	.	C	T	11	8	19	0	2	21	0	0
5	37694568	.	A	C	11	8	19	0	1	20	0	0
5	37695528	.	A	G	6	5	11	0	1	12	0	0
5	37696582	.	G	A	3	6	9	0	3	12	0	0
5	37697134	.	C	T	13	16	29	0	0	29	0	0
5	37699115	.	A	G	12	15	27	0	3	30	0	0
5	37699373	.	C	T	16	7	23	0	0	23	0	0
5	37700687	.	C	A	7	8	15	0	0	15	0	0
5	37700905	.	C	T	14	10	24	0	1	25	0	0
5	37701281	.	C	T	10	13	23	0	1	24	0	0
5	37703176	.	G	A	2	14	16	0	8	24	0	0
5	37703180	.	G	A	14	8	22	0	0	22	0	0
5	37707190	.	G	A	22	18	40	0	2	42	0	0
5	37747276	.	C	T	3	3	6	0	0	6	0	0
5	37749854	.	G	C	4	2	6	0	0	6	0	0
5	37757331	.	A	G	2	0	2	0	3	5	0	0
5	37757505	.	C	T	1	5	6	0	0	6	0	0
5	37757677	.	C	T	2	9	11	0	2	13	0	0
5	37813990	.	G	T	4	2	6	0	0	6	0	0
5	37814319	.	T	C	5	3	8	0	0	8	0	0
5	37912292	.	T	A	24	12	36	0	1	37	0	0
5	37912859	.	A	C	21	16	37	0	1	38	0	0
5	37919253	.	A	T	8	4	12	0	0	12	0	0
5	37919258	.	T	C	8	0	8	0	3	11	0	0
5	37919293	.	C	T	5	4	9	0	0	9	0	0
5	37926362	.	C	T	1	3	4	0	8	12	0	0
5	37934058	.	G	A	6	7	13	0	0	13	0	0
5	37963259	.	C	T	18	7	25	0	1	26	0	0
5	37968912	.	T	G	9	7	16	0	0	16	0	0
5	37970764	.	C	T	10	11	21	0	3	24	0	0
5	37970773	.	A	T	8	10	18	0	2	20	0	0
5	37970818	.	T	G	7	1	8	0	10	18	0	0
5	37981972	.	C	T	2	3	5	0	1	6	0	0
5	37981997	.	T	C	4	0	4	0	4	8	0	0
5	37987114	.	A	T	10	11	21	0	0	21	0	0
5	37987301	.	T	C	9	6	15	0	0	15	0	0
5	37987325	.	C	T	1	9	10	0	5	15	0	0
5	37987369	.	G	A	3	10	13	0	1	14	0	0
5	37989128	.	G	C	10	0	10	0	8	18	0	0
5	37989135	.	A	G	13	8	21	0	0	21	0	0
5	37989204	.	A	G	12	6	18	0	0	18	0	0
5	37989325	.	G	A	8	8	16	0	0	16	0	0
5	37989379	.	G	T	3	9	12	0	1	13	0	0
5	37989443	.	A	C	8	6	14	0	4	18	0	0
5	37989447	.	A	G	10	6	16	0	2	18	0	0
5	37991350	.	T	A	8	5	13	0	1	14	0	0
5	37991535	.	T	G	3	6	9	0	0	9	0	0
5	37991566	.	C	A	2	5	7	0	3	10	0	0
5	37991756	.	C	T	4	2	6	0	0	6	0	0
5	37991757	.	C	T	4	2	6	0	0	6	0	0
5	37993446	.	G	T	1	2	3	0	0	3	0	0
5	37997251	.	T	A	4	5	9	0	0	9	0	0
5	38302158	.	C	A	2	43	45	0	3	48	0	0
5	38302159	.	A	C	16	28	44	0	4	48	0	0
5	38390672	.	C	T	1	5	6	0	1	7	0	0
5	39386667	.	A	G	3	2	5	0	1	6	0	0
5	39386685	.	A	G	3	4	7	0	0	7	0	0
5	39386709	.	T	A	1	4	5	0	1	6	0	0
5	39386721	.	A	T	3	2	5	0	1	6	0	0
5	39386752	.	T	A	2	2	4	0	0	4	0	0
5	39504190	.	C	A	4	10	14	0	0	14	0	0
5	39504307	.	C	A	2	2	4	0	1	5	0	0
5	39506614	.	G	T	3	4	7	0	0	7	0	0
5	39508009	.	C	T	20	18	38	0	1	39	0	0
5	39508059	.	T	A	14	12	26	0	3	29	0	0
5	39707424	.	G	A	7	3	10	0	0	10	0	0
5	39707825	.	G	A	3	12	15	0	2	17	0	0
5	39708565	.	A	T	7	18	25	0	3	28	0	0
5	39708576	.	G	T	7	21	28	0	1	29	0	0
5	39708658	.	T	C	16	11	27	0	1	28	0	0
5	39708686	.	G	A	18	15	33	0	0	33	0	0
5	39708711	.	G	A	14	16	30	0	0	30	0	0
5	39715249	.	G	A	6	12	18	0	0	18	0	0
5	39730575	.	C	T	4	7	11	0	2	13	0	0
5	40040058	.	T	C	2	0	2	0	5	7	0	0
5	40040065	.	G	T	3	5	8	0	1	9	0	0
5	40040152	.	A	G	3	11	14	0	1	15	0	0
5	40054407	.	C	G	15	15	30	0	2	32	0	0
5	40059610	.	A	G	23	13	36	0	0	36	0	0
5	40059811	.	A	C	24	0	24	0	11	35	0	0
5	40059860	.	T	C	19	15	34	0	0	34	0	0
5	40062094	.	G	A	13	13	26	0	3	29	0	0
5	40062121	.	G	T	11	10	21	0	1	22	0	0
5	40062276	.	T	C	11	0	11	0	6	17	0	0
5	40062351	.	A	G	5	17	22	0	0	22	0	0
5	40062396	.	C	A	7	5	12	0	2	14	0	0
5	40069356	.	C	T	15	9	24	0	0	24	0	0
5	40069741	.	C	T	7	12	19	0	1	20	0	0
5	40077300	.	G	A	2	3	5	0	0	5	0	0
5	40078717	.	C	A	8	6	14	0	0	14	0	0
5	40093858	.	G	A	2	3	5	0	0	5	0	0
5	40095602	.	C	T	0	2	2	0	2	4	0	0
5	40203540	.	G	A	8	4	12	0	0	12	0	0
5	40206117	.	G	A	9	8	17	0	0	17	0	0
5	40206358	.	A	C	4	5	9	0	1	10	0	0
5	40273080	.	T	A	5	3	8	0	0	8	0	0
5	40273166	.	C	A	4	5	9	0	0	9	0	0
5	40273606	.	C	T	0	6	6	0	2	8	0	0
5	40273727	.	T	A	2	5	7	0	0	7	0	0
5	40273864	.	G	A	5	8	13	0	1	14	0	0
5	40291079	.	A	G	3	5	8	0	0	8	0	0
5	40292111	.	C	T	0	4	4	0	3	7	0	0
5	40501035	.	G	A	18	22	40	0	0	40	0	0
5	40505074	.	C	A	1	2	3	0	0	3	0	0
5	40505124	.	C	T	2	2	4	0	2	6	0	0
5	40506843	.	G	T	3	3	6	0	0	6	0	0
5	40507577	.	C	A	5	3	8	0	2	10	0	0
5	40728852	.	A	G	1	2	3	0	0	3	0	0
5	40729147	.	T	C	4	2	6	0	0	6	0	0
5	40729408	.	G	A	11	10	21	0	2	23	0	0
5	40729618	.	A	G	12	5	17	0	1	18	0	0
5	40732293	.	A	G	1	4	5	0	0	5	0	0
5	40732341	.	T	A	3	3	6	0	0	6	0	0
5	40865171	.	T	C	7	3	10	0	0	10	0	0
5	41083917	.	T	C	31	9	40	0	1	41	0	0
5	41650505	.	T	G	7	5	12	0	14	26	0	0
5	41891324	.	T	C	1	0	1	0	7	8	0	0
5	42067588	.	G	A	16	15	31	32	1	64	0	0
5	42094464	.	C	A	1	6	7	2	0	9	0	0
5	43073005	.	A	T	7	4	11	0	0	11	0	0
5	43073019	.	T	C	6	5	11	0	1	12	0	0
5	43073116	.	T	C	1	4	5	0	1	6	0	0
5	43082997	.	A	G	10	0	10	0	15	25	0	0
5	43083084	.	A	C	7	10	17	0	1	18	0	0
5	43602425	.	C	T	3	3	6	0	0	6	0	0
5	43602431	.	T	C	3	3	6	0	0	6	0	0
5	43617277	.	C	G	7	4	11	0	0	11	0	0
5	43617295	.	C	G	8	6	14	0	0	14	0	0
5	43626060	.	C	T	1	4	5	0	5	10	0	0
5	43862663	.	T	A	6	4	10	1	0	11	0	0
5	44795297	.	A	G	8	0	8	0	28	36	0	0
5	45748593	.	T	C	10	7	17	0	1	18	0	0
5	49735220	.	T	G	2	0	2	0	4	6	0	0
5	50390547	.	A	T	0	2	2	0	1	3	0	0
5	50444435	.	A	G	3	1	4	0	0	4	0	0
5	51360577	.	G	A	3	2	5	0	0	5	0	0
5	51575586	.	C	T	3	2	5	0	1	6	0	0
5	51575756	.	C	T	3	3	6	0	0	6	0	0
5	51575827	.	C	T	2	3	5	0	0	5	0	0
5	51578163	.	T	C	3	2	5	0	0	5	0	0
5	51616474	.	A	T	3	4	7	0	0	7	0	0
5	51617022	.	T	C	10	10	20	0	1	21	0	0
5	51619264	.	T	C	3	3	6	1	0	7	0	0
5	51775291	.	A	T	18	12	30	0	0	30	0	0
5	51775391	.	A	G	17	12	29	0	1	30	0	0
5	51775501	.	T	G	15	20	35	0	3	38	0	0
5	51775715	.	G	A	11	12	23	0	1	24	0	0
5	51775805	.	A	G	18	17	35	0	2	37	0	0
5	51775837	.	G	C	17	16	33	0	1	34	0	0
5	51775997	.	A	T	19	15	34	0	1	35	0	0
5	51776171	.	T	C	11	14	25	0	4	29	0	0
5	51776183	.	C	A	14	21	35	0	0	35	0	0
5	51789264	.	T	G	15	7	22	0	0	22	0	0
5	51789286	.	A	T	8	6	14	0	1	15	0	0
5	51789428	.	A	G	9	5	14	0	1	15	0	0
5	51793031	.	C	T	1	26	27	0	17	44	0	0
5	51843021	.	G	T	4	6	10	0	1	11	0	0
5	51893952	.	A	G	10	8	18	0	0	18	0	0
5	51898868	.	C	T	4	4	8	0	1	9	0	0
5	51913733	.	C	T	1	3	4	0	0	4	0	0
5	51914528	.	G	A	0	2	2	0	2	4	0	0
5	51932744	.	T	C	1	2	3	0	0	3	0	0
5	51947551	.	T	C	8	15	23	0	0	23	0	0
5	51947621	.	T	A	9	11	20	0	0	20	0	0
5	51947759	.	G	T	8	10	18	0	0	18	0	0
5	51947852	.	A	T	5	6	11	0	0	11	0	0
5	51947927	.	T	C	3	1	4	0	2	6	0	0
5	51948076	.	G	A	6	6	12	0	1	13	0	0
5	51948189	.	T	G	4	9	13	0	2	15	0	0
5	51948222	.	G	C	12	5	17	0	0	17	0	0
5	51948289	.	G	A	11	8	19	0	0	19	0	0
5	51948389	.	A	T	9	4	13	0	0	13	0	0
5	51948436	.	G	T	5	6	11	0	1	12	0	0
5	51948762	.	G	A	5	2	7	0	0	7	0	0
5	51948858	.	T	A	4	9	13	0	2	15	0	0
5	51948946	.	T	C	12	0	12	1	13	26	0	0
5	51949071	.	T	A	13	9	22	0	2	24	0	0
5	51949284	.	T	C	3	4	7	0	1	8	0	0
5	51949306	.	T	A	1	4	5	0	1	6	0	0
5	51949862	.	G	A	0	6	6	0	1	7	0	0
5	51949896	.	G	A	2	3	5	0	0	5	0	0
5	51949970	.	T	G	4	1	5	0	0	5	0	0
5	51949974	.	T	G	4	1	5	0	0	5	0	0
5	51950054	.	T	C	11	0	11	0	9	20	0	0
5	51958596	.	G	A	2	2	4	0	0	4	0	0
5	52005851	.	G	T	6	9	15	0	2	17	0	0
5	52005893	.	C	T	2	5	7	0	1	8	0	0
5	52008999	.	A	G	5	5	10	0	0	10	0	0
5	52010134	.	C	T	0	3	3	0	1	4	0	0
5	52010145	.	A	T	1	1	2	0	1	3	0	0
5	52068452	.	G	A	2	5	7	0	0	7	0	0
5	52121940	.	T	G	2	5	7	0	0	7	0	0
5	52121945	.	C	T	4	2	6	0	0	6	0	0
5	52122841	.	T	G	3	2	5	0	0	5	0	0
5	52123862	.	C	T	7	3	10	0	0	10	0	0
5	52124144	.	C	A	4	2	6	0	0	6	0	0
5	52124259	.	G	A	2	4	6	0	0	6	0	0
5	52132672	.	G	A	10	5	15	0	0	15	0	0
5	52190806	.	T	C	1	1	2	1	0	3	0	0
5	52190948	.	G	T	2	6	8	0	0	8	0	0
5	52190969	.	A	G	2	5	7	0	0	7	0	0
5	52191263	.	T	C	13	6	19	0	0	19	0	0
5	52191270	.	C	T	6	13	19	0	1	20	0	0
5	52191329	.	T	G	7	6	13	0	1	14	0	0
5	52191525	.	A	T	3	6	9	0	0	9	0	0
5	52191617	.	C	T	3	4	7	0	0	7	0	0
5	52191715	.	A	C	5	3	8	0	1	9	0	0
5	52191722	.	T	C	5	0	5	0	6	11	0	0
5	52191758	.	C	T	7	6	13	0	0	13	0	0
5	52191987	.	A	G	2	2	4	0	0	4	0	0
5	52192361	.	T	C	9	10	19	2	0	21	0	0
5	52192364	.	A	G	8	10	18	2	1	21	0	0
5	52192508	.	G	T	4	4	8	0	1	9	0	0
5	52192572	.	T	C	2	3	5	0	1	6	0	0
5	52192598	.	G	A	1	3	4	0	0	4	0	0
5	52192649	.	A	C	1	4	5	0	0	5	0	0
5	52192668	.	C	T	0	2	2	0	2	4	0	0
5	52193066	.	C	T	2	5	7	0	0	7	0	0
5	52193154	.	G	A	1	8	9	0	2	11	0	0
5	52201265	.	C	T	1	4	5	0	0	5	0	0
5	52227269	.	T	A	5	4	9	0	1	10	0	0
5	52227393	.	T	C	2	5	7	0	0	7	0	0
5	52227404	.	T	C	2	0	2	0	4	6	0	0
5	52227660	.	T	A	1	3	4	0	0	4	0	0
5	52232991	.	C	T	2	3	5	0	1	6	0	0
5	52232993	.	T	A	1	4	5	0	1	6	0	0
5	52234672	.	T	C	2	2	4	0	0	4	0	0
5	52234729	.	G	A	1	6	7	0	0	7	0	0
5	52237001	.	T	G	3	2	5	0	0	5	0	0
5	52237028	.	C	T	3	2	5	0	0	5	0	0
5	52239939	.	C	T	0	2	2	0	3	5	0	0
5	52257463	.	T	C	10	16	26	0	1	27	0	0
5	52257530	.	A	G	14	14	28	0	1	29	0	0
5	52257905	.	A	G	10	17	27	0	1	28	0	0
5	52258036	.	G	A	13	6	19	0	1	20	0	0
5	52258068	.	C	T	1	10	11	0	13	24	0	0
5	52258152	.	C	A	19	8	27	0	1	28	0	0
5	52258653	.	C	G	4	4	8	0	0	8	0	0
5	52258801	.	T	A	8	5	13	0	1	14	0	0
5	52258995	.	C	G	13	2	15	0	0	15	0	0
5	52259289	.	A	G	3	8	11	0	0	11	0	0
5	52259503	.	G	T	6	9	15	0	1	16	0	0
5	52259887	.	G	A	10	7	17	0	0	17	0	0
5	52696879	.	C	T	1	4	5	0	2	7	0	0
5	53748152	.	T	C	4	2	6	0	0	6	0	0
5	54459325	.	T	C	10	3	13	0	0	13	0	0
5	54459672	.	T	C	7	4	11	0	1	12	0	0
5	54459746	.	T	C	7	4	11	0	0	11	0	0
5	56268535	.	A	G	2	2	4	0	0	4	0	0
5	56270933	.	T	C	2	4	6	0	0	6	0	0
5	56277951	.	A	T	1	7	8	0	0	8	0	0
5	56287987	.	T	A	1	4	5	0	0	5	0	0
5	56289713	.	G	A	3	3	6	2	0	8	0	0
5	56289841	.	C	T	3	5	8	0	0	8	0	0
5	56290079	.	C	T	4	2	6	0	0	6	0	0
5	56294045	.	C	T	3	2	5	0	0	5	0	0
5	56294202	.	C	T	1	2	3	1	0	4	0	0
5	56308647	.	A	T	0	2	2	0	0	2	0	0
5	56308657	.	G	A	3	2	5	0	0	5	0	0
5	56309445	.	C	T	19	11	30	0	0	30	0	0
5	56309506	.	G	A	18	13	31	0	1	32	0	0
5	56309677	.	C	A	10	14	24	0	0	24	0	0
5	56313246	.	C	T	19	24	43	0	0	43	0	0
5	56317470	.	C	T	15	16	31	0	0	31	0	0
5	56317473	.	T	G	16	15	31	0	0	31	0	0
5	56343032	.	C	T	1	6	7	0	14	21	0	0
5	56343053	.	G	A	7	13	20	0	0	20	0	0
5	56343095	.	C	T	4	11	15	0	0	15	0	0
5	56345036	.	G	C	15	6	21	0	1	22	0	0
5	56345157	.	C	T	10	3	13	0	0	13	0	0
5	56355129	.	C	T	5	2	7	0	0	7	0	0
5	56360829	.	G	A	5	6	11	0	3	14	0	0
5	56362376	.	C	T	5	7	12	0	0	12	0	0
5	56375262	.	G	T	4	7	11	0	0	11	0	0
5	56381655	.	G	A	1	6	7	2	0	9	0	0
5	56915422	.	G	A	9	10	19	0	0	19	0	0
5	56918884	.	G	T	5	7	12	0	1	13	0	0
5	56921906	.	G	A	4	3	7	0	0	7	0	0
5	56924686	.	C	T	8	3	11	0	0	11	0	0
5	56942793	.	A	C	1	0	1	0	2	3	0	0
5	56951034	.	G	A	10	5	15	0	1	16	0	0
5	56951229	.	C	T	19	15	34	0	1	35	0	0
5	56951769	.	A	G	1	7	8	0	1	9	0	0
5	56951841	.	T	A	6	6	12	0	0	14	2	0
5	56952141	.	T	C	19	1	20	0	20	40	0	0
5	56952316	.	A	G	23	17	40	0	0	40	0	0
5	56955460	.	C	T	15	15	30	0	0	30	0	0
5	56955508	.	T	G	17	15	32	0	1	33	0	0
5	56956359	.	G	A	16	10	26	0	0	26	0	0
5	56958516	.	C	T	2	10	12	0	8	20	0	0
5	56961348	.	G	A	9	4	13	0	0	13	0	0
5	57219496	.	G	A	4	4	8	0	0	8	0	0
5	57219736	.	T	C	6	7	13	0	1	14	0	0
5	57219789	.	C	T	7	4	11	0	0	11	0	0
5	57219938	.	G	C	1	6	7	0	4	11	0	0
5	57219941	.	G	A	4	6	10	0	2	12	0	0
5	57220033	.	T	C	10	9	19	0	0	19	0	0
5	57220108	.	G	A	1	6	7	0	9	16	0	0
5	57220190	.	A	G	5	0	5	0	10	15	0	0
5	57220324	.	T	C	4	4	8	0	1	9	0	0
5	57225343	.	C	T	11	5	16	0	0	16	0	0
5	57225496	.	C	G	7	0	7	0	13	20	0	0
5	57231089	.	C	T	19	19	38	0	1	39	0	0
5	57325118	.	C	A	32	35	67	0	3	70	0	0
5	57325123	.	G	T	32	38	70	0	1	71	0	0
5	57325204	.	T	G	31	0	31	0	30	61	0	0
5	57325210	.	G	A	28	29	57	0	3	60	0	0
5	57325381	.	A	T	23	37	60	0	0	60	0	0
5	57325537	.	C	T	6	2	8	0	1	9	0	0
5	57351036	.	A	G	2	0	2	0	3	5	0	0
5	57354166	.	T	C	5	4	9	0	1	10	0	0
5	57354452	.	C	T	8	4	12	0	0	12	0	0
5	57354552	.	C	T	4	4	8	0	0	8	0	0
5	57354596	.	C	T	7	4	11	0	0	11	0	0
5	57354786	.	G	T	7	10	17	0	0	17	0	0
5	57359699	.	G	T	2	3	5	0	0	5	0	0
5	57361541	.	T	C	8	7	15	0	0	15	0	0
5	57372378	.	T	C	1	2	3	1	0	4	0	0
5	57422118	.	T	C	3	6	9	0	0	9	0	0
5	57422146	.	A	T	2	8	10	0	0	10	0	0
5	57433384	.	G	T	3	6	9	0	1	10	0	0
5	57450440	.	C	A	7	3	10	0	0	10	0	0
5	57451036	.	A	T	2	9	11	0	2	13	0	0
5	57453635	.	T	C	2	2	4	0	0	4	0	0
5	57489777	.	T	C	11	0	11	0	15	26	0	0
5	57489821	.	G	A	11	9	20	0	2	22	0	0
5	57490344	.	C	A	1	11	12	0	17	29	0	0
5	57490371	.	C	T	2	12	14	0	10	24	0	0
5	57499990	.	T	C	18	0	18	0	18	36	0	0
5	57505050	.	C	T	11	13	24	0	0	24	0	0
5	57641823	.	C	T	0	5	5	0	1	6	0	0
5	57644213	.	G	T	1	3	4	0	5	9	0	0
5	57693699	.	C	T	1	7	8	0	0	8	0	0
5	57704805	.	T	C	5	1	6	0	4	10	0	0
5	57718488	.	A	C	8	7	15	0	0	18	3	0
5	57718716	.	T	C	11	6	17	0	0	17	0	0
5	57718739	.	T	C	7	3	10	0	0	10	0	0
5	57718794	.	T	C	1	2	3	0	1	4	0	0
5	57726576	.	T	C	3	2	5	0	0	5	0	0
5	57726655	.	G	C	1	3	4	0	0	4	0	0
5	57734348	.	C	T	1	2	3	0	1	4	0	0
5	57735420	.	A	G	5	5	10	0	0	10	0	0
5	57737535	.	C	G	3	2	5	0	0	5	0	0
5	57737589	.	T	C	6	4	10	0	0	10	0	0
5	57737919	.	T	A	8	3	11	0	0	11	0	0
5	57744722	.	C	A	4	1	5	0	0	5	0	0
5	57744731	.	T	C	3	2	5	0	0	5	0	0
5	57753791	.	G	T	7	5	12	0	0	12	0	0
5	57755422	.	T	C	6	11	17	0	0	17	0	0
5	57759107	.	C	T	17	13	30	0	1	31	0	0
5	57759159	.	G	A	1	11	12	0	14	26	0	0
5	57762423	.	A	T	12	17	29	1	0	30	0	0
5	57762608	.	A	G	11	1	12	0	22	34	0	0
5	57762986	.	C	G	8	20	28	0	0	28	0	0
5	57781459	.	T	A	8	14	22	1	1	24	0	0
5	57797086	.	C	T	36	30	66	0	1	67	0	0
5	57814468	.	C	T	7	4	11	0	0	11	0	0
5	57814523	.	A	G	4	4	8	0	1	9	0	0
5	57814630	.	T	C	5	0	5	0	14	19	0	0
5	57818963	.	G	T	3	4	7	0	0	7	0	0
5	57819001	.	A	G	4	7	11	0	1	12	0	0
5	57819091	.	A	T	3	4	7	0	0	7	0	0
5	57820641	.	C	A	2	2	4	0	0	4	0	0
5	57820658	.	C	T	2	3	5	0	0	5	0	0
5	57820716	.	C	T	2	4	6	0	0	6	0	0
5	58075815	.	T	G	3	6	9	0	3	12	0	0
5	58081110	.	C	T	5	3	8	0	0	8	0	0
5	58081173	.	T	A	2	3	5	0	0	5	0	0
5	58173534	.	A	G	1	3	4	0	0	4	0	0
5	58382267	.	G	A	29	28	57	0	3	60	0	0
5	58382415	.	C	T	29	18	47	0	0	47	0	0
5	58382474	.	T	A	18	18	36	0	3	39	0	0
5	58382596	.	G	A	3	4	7	0	11	18	0	0
5	58851232	.	G	A	13	13	26	0	0	26	0	0
5	58852925	.	T	G	5	3	8	0	0	8	0	0
5	58852972	.	G	A	2	4	6	0	0	6	0	0
5	58853688	.	A	G	7	7	14	0	0	14	0	0
5	58868948	.	A	C	2	5	7	0	1	8	0	0
5	58871633	.	T	G	4	5	9	0	0	9	0	0
5	58875035	.	C	T	0	3	3	0	8	11	0	0
5	58876301	.	C	T	0	3	3	0	2	5	0	0
5	58878899	.	G	T	3	4	7	0	0	7	0	0
5	58939388	.	C	A	0	6	6	0	4	10	0	0
5	58997286	.	T	A	2	4	6	0	0	6	0	0
5	59008759	.	T	A	6	3	9	0	1	10	0	0
5	59008762	.	G	C	6	3	9	0	0	9	0	0
5	59041862	.	T	C	4	2	6	0	0	6	0	0
5	59050241	.	A	G	6	5	11	0	0	11	0	0
5	59050307	.	G	A	5	5	10	0	0	10	0	0
5	59063090	.	C	A	3	10	13	0	0	13	0	0
5	59063102	.	C	T	3	8	11	0	1	12	0	0
5	59079618	.	A	T	13	12	25	0	0	25	0	0
5	59079732	.	A	C	15	15	30	0	0	30	0	0
5	59079806	.	C	A	12	13	25	0	0	25	0	0
5	59080050	.	C	T	2	3	5	0	1	6	0	0
5	59080163	.	C	T	6	5	11	0	0	11	0	0
5	59080392	.	C	A	10	3	13	0	1	14	0	0
5	59080452	.	G	T	0	13	13	0	9	22	0	0
5	59080526	.	T	A	10	6	16	0	0	16	0	0
5	59082758	.	G	T	12	10	22	0	1	23	0	0
5	59082761	.	C	T	11	11	22	0	1	23	0	0
5	59095793	.	C	T	9	5	14	0	1	15	0	0
5	59095862	.	G	A	11	3	14	0	1	15	0	0
5	59100577	.	G	A	6	4	10	0	1	11	0	0
5	59101602	.	A	G	2	3	5	0	0	5	0	0
5	59101605	.	G	A	2	3	5	0	0	5	0	0
5	59103118	.	A	T	4	3	7	0	0	7	0	0
5	59107979	.	T	A	1	3	4	0	0	4	0	0
5	59147690	.	C	T	6	5	11	0	0	11	0	0
5	59147711	.	T	C	6	5	11	0	0	11	0	0
5	59199018	.	G	A	0	4	4	0	0	4	0	0
5	59199028	.	C	T	2	2	4	0	0	4	0	0
5	59199517	.	C	T	3	4	7	0	0	7	0	0
5	59199538	.	C	T	2	2	4	0	0	4	0	0
5	59199581	.	T	A	5	0	5	0	1	6	0	0
5	59200211	.	C	T	2	5	7	0	1	8	0	0
5	59200270	.	T	A	4	5	9	0	0	9	0	0
5	59200412	.	G	T	2	3	5	0	1	6	0	0
5	59200687	.	C	A	2	4	6	0	2	8	0	0
5	59200794	.	G	A	2	5	7	0	0	7	0	0
5	59200813	.	C	T	2	5	7	0	0	7	0	0
5	59201785	.	T	G	7	4	11	0	0	11	0	0
5	59201883	.	T	G	7	9	16	0	0	16	0	0
5	59234451	.	G	T	3	3	6	0	1	7	0	0
5	59239773	.	C	G	8	5	13	0	0	13	0	0
5	59239851	.	G	A	6	9	15	0	1	16	0	0
5	59247894	.	A	G	11	6	17	0	0	17	0	0
5	59248031	.	T	C	7	6	13	0	0	13	0	0
5	59248038	.	C	G	7	6	13	0	0	13	0	0
5	59278569	.	G	A	3	3	6	0	0	6	0	0
5	59341675	.	C	A	2	4	6	0	0	6	0	0
5	59368490	.	T	C	8	5	13	0	0	13	0	0
5	59368516	.	G	T	9	5	14	0	1	15	0	0
5	59381774	.	C	T	5	7	12	0	0	12	0	0
5	59386289	.	T	G	4	4	8	0	0	8	0	0
5	59386332	.	A	G	3	2	5	0	0	5	0	0
5	59386416	.	A	G	3	3	6	0	0	6	0	0
5	59386755	.	A	T	2	2	4	0	0	4	0	0
5	59387075	.	A	C	7	6	13	0	1	14	0	0
5	59387094	.	A	T	5	6	11	0	0	11	0	0
5	59387120	.	C	T	1	4	5	0	0	5	0	0
5	59387362	.	C	T	5	4	9	0	0	9	0	0
5	59387476	.	C	A	2	3	5	0	1	6	0	0
5	59387478	.	C	A	1	3	4	0	2	6	0	0
5	59387566	.	G	T	9	6	15	0	1	16	0	0
5	59387577	.	C	A	10	9	19	0	1	21	1	0
5	59388227	.	T	A	4	3	7	0	0	7	0	0
5	59388251	.	T	A	3	4	7	0	0	7	0	0
5	59388449	.	G	A	0	2	2	0	9	11	0	0
5	59388479	.	G	A	9	4	13	0	0	13	0	0
5	59388660	.	A	G	7	11	18	0	0	18	0	0
5	59388686	.	C	T	5	6	11	0	1	12	0	0
5	59388739	.	A	G	5	2	7	0	1	8	0	0
5	59388852	.	T	A	4	5	9	0	1	10	0	0
5	59389002	.	G	A	13	7	20	0	1	21	0	0
5	59389014	.	G	A	5	12	17	0	2	20	1	0
5	59389440	.	T	A	6	3	9	0	1	10	0	0
5	59389450	.	A	C	2	6	8	0	1	9	0	0
5	59389693	.	A	T	5	5	10	0	1	11	0	0
5	59389786	.	T	G	1	6	7	0	0	7	0	0
5	59398655	.	A	G	4	2	6	0	0	6	0	0
5	59419954	.	C	T	2	3	5	0	1	6	0	0
5	59420030	.	C	T	2	4	6	0	0	6	0	0
5	59420321	.	A	C	4	6	10	0	0	10	0	0
5	59420366	.	T	C	3	3	6	0	1	7	0	0
5	59420375	.	C	T	6	4	10	0	0	10	0	0
5	59449717	.	T	C	7	2	9	0	1	10	0	0
5	59449729	.	C	T	5	2	7	0	1	8	0	0
5	59449764	.	G	A	4	5	9	0	1	10	0	0
5	59449818	.	C	T	3	4	7	0	1	8	0	0
5	59450034	.	C	T	7	7	14	0	0	14	0	0
5	59462457	.	G	A	4	4	8	0	0	8	0	0
5	59462501	.	G	A	0	3	3	0	10	13	0	0
5	59462534	.	A	G	7	6	13	0	0	13	0	0
5	59462595	.	C	T	4	4	8	0	0	8	0	0
5	59462663	.	C	T	13	5	18	0	0	18	0	0
5	59462679	.	C	T	4	9	13	0	0	13	0	0
5	59462727	.	C	T	7	6	13	0	0	13	0	0
5	59462790	.	C	T	7	5	12	0	0	12	0	0
5	59462829	.	T	G	3	7	10	0	1	11	0	0
5	59462991	.	T	C	5	5	10	0	1	11	0	0
5	59463213	.	T	C	3	7	10	0	1	11	0	0
5	59466867	.	T	G	7	0	7	0	5	12	0	0
5	59479541	.	C	A	5	8	13	1	1	15	0	0
5	59479818	.	C	G	8	5	13	0	2	15	0	0
5	59515497	.	A	T	3	4	7	0	0	7	0	0
5	59538782	.	C	T	2	4	6	0	0	6	0	0
5	59542153	.	T	C	9	4	13	0	0	13	0	0
5	59544642	.	A	C	2	5	7	0	0	7	0	0
5	59544717	.	A	G	4	0	4	0	5	9	0	0
5	59549143	.	A	G	3	0	3	0	5	8	0	0
5	59549148	.	G	A	3	5	8	0	0	8	0	0
5	59549306	.	T	A	1	2	3	2	1	6	0	0
5	59549354	.	T	C	3	3	6	1	2	9	0	0
5	59550581	.	T	C	4	4	8	0	1	9	0	0
5	59559881	.	C	T	2	2	4	0	1	5	0	0
5	59560171	.	A	G	8	6	14	0	1	15	0	0
5	59584626	.	C	T	9	5	14	0	1	15	0	0
5	59589199	.	G	A	1	8	9	0	10	19	0	0
5	59593231	.	C	T	8	8	16	0	0	16	0	0
5	59593363	.	C	T	9	7	16	0	0	16	0	0
5	59593441	.	G	A	2	12	14	0	3	17	0	0
5	59593502	.	C	T	1	7	8	0	0	8	0	0
5	59593520	.	C	T	2	3	5	0	0	5	0	0
5	59593623	.	C	T	8	4	12	0	0	12	0	0
5	59593685	.	A	T	3	3	6	0	0	6	0	0
5	59593795	.	T	A	4	6	10	0	1	11	0	0
5	59594485	.	G	T	15	7	22	0	1	23	0	0
5	59594507	.	A	C	16	8	24	0	0	24	0	0
5	59594825	.	A	T	3	8	11	0	0	11	0	0
5	59594878	.	C	T	13	8	21	0	0	21	0	0
5	59594893	.	C	T	10	7	17	0	0	17	0	0
5	59595307	.	C	A	8	3	11	0	1	12	0	0
5	59595407	.	G	A	7	15	22	0	0	22	0	0
5	59595508	.	G	A	8	4	12	0	1	13	0	0
5	60684728	.	C	T	9	5	14	0	0	14	0	0
5	60684731	.	C	T	8	5	13	0	1	14	0	0
5	60685584	.	A	C	0	0	0	0	5	5	0	0
5	60685590	.	A	C	0	2	2	0	2	4	0	0
5	60685676	.	C	T	7	6	13	0	0	13	0	0
5	60686409	.	G	A	10	10	20	0	0	20	0	0
5	60686452	.	C	T	7	4	11	0	0	11	0	0
5	60686473	.	C	T	7	4	11	0	0	11	0	0
5	60686541	.	A	G	9	5	14	0	2	16	0	0
5	60686603	.	C	T	9	4	13	0	0	13	0	0
5	60686636	.	C	T	8	7	15	0	0	15	0	0
5	60686784	.	G	T	3	7	10	0	2	13	1	0
5	60686918	.	A	T	4	11	15	0	1	16	0	0
5	60687313	.	A	T	4	11	15	0	1	16	0	0
5	60687344	.	A	T	5	10	15	0	0	15	0	0
5	60687362	.	A	G	5	11	16	0	1	17	0	0
5	60850570	.	G	C	1	4	5	0	0	5	0	0
5	60850638	.	T	C	2	2	4	0	0	4	0	0
5	60861610	.	C	T	6	3	9	0	0	9	0	0
5	60863132	.	C	T	3	5	8	0	0	8	0	0
5	60868958	.	T	C	6	3	9	0	0	10	1	0
5	60868987	.	G	A	7	4	11	0	0	11	0	0
5	60871969	.	C	T	11	6	17	0	1	18	0	0
5	60872639	.	G	A	0	6	6	0	4	10	0	0
5	60893432	.	C	T	1	1	2	0	1	3	0	0
5	60894768	.	A	G	3	3	6	0	0	6	0	0
5	60894807	.	A	G	1	0	1	0	5	6	0	0
5	60894846	.	A	G	1	0	1	0	3	4	0	0
5	60902623	.	G	A	0	2	2	0	3	5	0	0
5	60906002	.	C	T	3	2	5	0	0	5	0	0
5	61316248	.	T	C	12	7	19	0	1	20	0	0
5	61325345	.	A	T	12	7	19	0	0	19	0	0
5	61329508	.	G	C	13	8	21	0	0	21	0	0
5	61329604	.	C	T	12	12	24	0	1	25	0	0
5	61329650	.	A	G	10	9	19	0	0	19	0	0
5	61351582	.	C	A	6	11	17	0	0	17	0	0
5	61351600	.	C	A	4	11	15	0	1	16	0	0
5	61352582	.	T	C	6	7	13	0	0	13	0	0
5	61353710	.	G	C	5	5	10	0	2	12	0	0
5	61353728	.	G	A	0	4	4	0	7	11	0	0
5	61353901	.	G	A	2	2	4	0	1	5	0	0
5	61354264	.	A	G	3	3	6	0	0	6	0	0
5	61380091	.	A	G	5	0	5	0	9	14	0	0
5	61389725	.	T	C	14	18	32	0	0	32	0	0
5	61392719	.	C	T	17	9	26	0	1	27	0	0
5	61401915	.	C	T	8	11	19	0	2	21	0	0
5	61402366	.	G	C	11	10	21	0	1	22	0	0
5	61402440	.	T	C	14	11	25	0	1	26	0	0
5	61402455	.	A	T	15	12	27	0	1	28	0	0
5	61402584	.	A	G	23	0	23	0	10	33	0	0
5	61402607	.	C	T	22	14	36	0	0	36	0	0
5	61402761	.	T	A	18	21	39	0	1	40	0	0
5	61402999	.	T	A	20	19	39	0	1	40	0	0
5	61403005	.	A	T	19	16	35	0	3	38	0	0
5	61404613	.	C	A	3	2	5	0	1	6	0	0
5	61405203	.	C	T	6	5	11	0	0	11	0	0
5	61405245	.	C	A	7	6	13	0	1	14	0	0
5	61405954	.	A	G	13	6	19	0	0	19	0	0
5	61414618	.	A	T	14	9	23	0	0	23	0	0
5	61414619	.	C	T	13	9	22	0	1	23	0	0
5	61416963	.	C	A	6	10	16	0	1	17	0	0
5	61420653	.	C	T	6	8	14	0	1	15	0	0
5	61425708	.	C	T	5	9	14	1	0	15	0	0
5	61425723	.	C	T	6	9	15	1	0	16	0	0
5	61425795	.	G	C	5	6	11	0	0	11	0	0
5	61425800	.	A	G	5	6	11	0	0	11	0	0
5	61428878	.	A	G	6	7	13	0	1	14	0	0
5	61428915	.	C	G	7	8	15	0	0	15	0	0
5	61429058	.	G	T	6	5	11	0	0	11	0	0
5	61429149	.	C	T	1	5	6	0	3	9	0	0
5	61431609	.	C	T	2	5	7	0	1	8	0	0
5	61431752	.	A	G	3	7	10	0	1	11	0	0
5	61431765	.	C	T	3	5	8	0	1	9	0	0
5	61464900	.	G	T	12	5	17	0	0	17	0	0
5	61467748	.	G	T	4	4	8	0	0	8	0	0
5	61467754	.	T	A	4	4	8	0	0	8	0	0
5	61472429	.	G	A	5	9	14	0	0	14	0	0
5	61472637	.	C	T	1	2	3	0	1	4	0	0
5	61472639	.	G	A	2	2	4	0	0	4	0	0
5	61508451	.	A	G	5	12	17	0	0	17	0	0
5	61508648	.	G	T	11	5	16	0	1	17	0	0
5	61548819	.	T	G	9	0	9	0	16	25	0	0
5	61552554	.	T	C	13	16	29	0	2	31	0	0
5	61552591	.	A	T	10	15	25	0	1	26	0	0
5	61552623	.	G	A	0	10	10	0	13	23	0	0
5	61552724	.	G	T	11	13	24	0	0	24	0	0
5	61552831	.	C	T	10	7	17	0	0	17	0	0
5	61552939	.	C	T	13	7	20	0	0	20	0	0
5	61553022	.	G	A	12	9	21	0	0	21	0	0
5	61553252	.	G	T	10	4	14	0	0	14	0	0
5	61553409	.	A	T	11	8	19	0	1	20	0	0
5	61553452	.	C	T	8	9	17	0	2	19	0	0
5	61553699	.	G	T	14	9	23	0	0	23	0	0
5	61553702	.	A	T	13	8	21	0	2	23	0	0
5	61553852	.	A	T	10	10	20	0	2	22	0	0
5	61566819	.	T	C	3	6	9	0	0	9	0	0
5	61570931	.	C	T	5	4	9	0	0	9	0	0
5	61571203	.	C	T	5	2	7	0	0	7	0	0
5	61584008	.	A	T	3	5	8	0	2	10	0	0
5	61584010	.	A	T	4	4	8	0	1	9	0	0
5	61584047	.	T	C	1	0	1	0	8	9	0	0
5	61586142	.	C	A	4	7	11	0	0	11	0	0
5	61588913	.	A	G	10	3	13	0	0	13	0	0
5	61588991	.	C	T	1	2	3	0	1	4	0	0
5	61658315	.	A	C	8	7	15	0	0	15	0	0
5	61660310	.	C	T	5	5	10	0	0	10	0	0
5	61660526	.	C	T	4	10	14	0	0	14	0	0
5	61696396	.	C	T	21	16	37	0	2	39	0	0
5	61706220	.	T	C	23	22	45	0	0	45	0	0
5	61712754	.	C	T	34	25	59	0	5	64	0	0
5	61723180	.	T	C	29	36	65	0	0	65	0	0
5	61723289	.	A	G	31	34	65	0	1	66	0	0
5	61723315	.	G	C	26	32	58	0	2	60	0	0
5	61723366	.	A	G	18	34	52	0	2	54	0	0
5	61723481	.	G	T	5	30	35	0	22	57	0	0
5	61723538	.	A	G	15	0	15	0	29	44	0	0
5	61723584	.	A	T	18	22	40	0	1	41	0	0
5	61723674	.	G	A	31	10	41	0	1	42	0	0
5	61723981	.	G	A	14	7	21	0	2	23	0	0
5	61724016	.	A	T	10	4	14	0	1	15	0	0
5	61790157	.	T	C	3	3	6	0	0	6	0	0
5	61790460	.	G	T	5	4	9	0	1	10	0	0
5	61790480	.	A	G	5	2	7	0	0	7	0	0
5	61790501	.	A	T	4	3	7	0	0	7	0	0
5	61793756	.	T	C	2	5	7	0	0	7	0	0
5	61793886	.	T	A	1	7	8	0	0	8	0	0
5	61794625	.	G	A	3	2	5	0	0	5	0	0
5	61799766	.	G	A	15	13	28	0	1	29	0	0
5	61801070	.	G	A	13	10	23	0	2	25	0	0
5	61804538	.	C	T	14	8	22	0	0	22	0	0
5	61806498	.	T	C	9	13	22	0	1	23	0	0
5	61817051	.	A	T	30	29	59	0	1	60	0	0
5	61868731	.	G	A	1	2	3	0	0	3	0	0
5	61871360	.	T	C	2	5	7	0	0	7	0	0
5	61874068	.	G	A	2	2	4	0	0	4	0	0
5	61877517	.	G	A	4	2	6	0	1	7	0	0
5	61881101	.	C	T	5	2	7	0	0	7	0	0
5	61881353	.	A	G	5	2	7	0	0	7	0	0
5	61884167	.	G	A	6	9	15	0	0	15	0	0
5	61884460	.	C	T	9	9	18	0	0	18	0	0
5	61884478	.	C	T	10	8	18	0	0	18	0	0
5	61884514	.	C	T	14	12	26	0	1	28	1	0
5	61886601	.	C	T	12	16	28	0	5	33	0	0
5	61886622	.	G	A	22	10	32	0	2	34	0	0
5	61889421	.	A	G	18	2	20	0	13	33	0	0
5	61889572	.	C	G	15	13	28	0	2	30	0	0
5	61890223	.	G	A	1	15	16	0	6	22	0	0
5	61890336	.	A	T	6	10	16	0	0	16	0	0
5	61921824	.	C	T	2	7	9	0	1	10	0	0
5	61923322	.	A	G	3	3	6	0	0	6	0	0
5	61928415	.	C	T	5	5	10	0	1	11	0	0
5	61930715	.	A	T	13	6	19	0	1	20	0	0
5	61931392	.	A	G	17	19	36	0	1	37	0	0
5	61931409	.	C	T	19	16	35	0	1	36	0	0
5	61931795	.	T	C	5	8	13	0	0	13	0	0
5	61932177	.	G	A	4	2	6	1	0	7	0	0
5	61932319	.	C	T	6	12	18	0	0	18	0	0
5	61932332	.	C	T	11	5	16	0	0	16	0	0
5	61932383	.	G	A	9	6	15	0	0	15	0	0
5	61932568	.	T	C	20	13	33	0	4	37	0	0
5	61932604	.	C	T	11	15	26	0	1	27	0	0
5	61932706	.	C	G	10	14	24	0	0	24	0	0
5	61932707	.	T	G	10	13	23	0	1	24	0	0
5	61932754	.	G	C	12	20	32	0	0	32	0	0
5	61934579	.	C	T	5	11	16	0	0	16	0	0
5	61941680	.	C	T	1	3	4	0	0	4	0	0
5	61947848	.	G	C	2	4	6	0	0	6	0	0
5	61947962	.	G	A	3	2	5	0	0	5	0	0
5	61947983	.	G	A	2	2	4	0	0	4	0	0
5	61948214	.	C	T	1	2	3	0	0	3	0	0
5	61948809	.	G	A	0	3	3	0	2	5	0	0
5	61949549	.	T	G	6	6	12	0	0	12	0	0
5	61949624	.	C	T	7	6	13	0	0	13	0	0
5	61949757	.	C	G	1	4	5	0	1	6	0	0
5	61950345	.	T	G	3	4	7	0	0	7	0	0
5	61950639	.	G	T	4	2	6	0	0	6	0	0
5	61950834	.	A	T	8	6	14	0	0	14	0	0
5	61951032	.	T	C	10	3	13	0	1	14	0	0
5	61951038	.	A	G	9	4	13	1	0	14	0	0
5	61998644	.	C	T	7	8	15	0	2	17	0	0
5	62004552	.	C	T	27	22	49	0	3	52	0	0
5	62004561	.	A	G	23	26	49	0	0	49	0	0
5	62004999	.	A	G	9	9	18	1	1	20	0	0
5	62005005	.	G	T	9	8	17	1	0	19	1	0
5	62005054	.	C	T	5	2	7	1	0	8	0	0
5	62018920	.	G	A	1	3	4	0	3	7	0	0
5	62025541	.	C	T	6	2	8	0	0	8	0	0
5	62025736	.	G	A	0	7	7	0	7	14	0	0
5	62025829	.	C	A	6	6	12	0	0	12	0	0
5	62025924	.	T	C	4	3	7	0	1	8	0	0
5	62026018	.	C	A	3	3	6	0	0	6	0	0
5	62029820	.	C	T	4	4	8	0	0	8	0	0
5	62042450	.	A	G	11	11	22	0	1	23	0	0
5	62052860	.	T	G	2	5	7	0	1	8	0	0
5	62053043	.	G	A	5	4	9	0	0	9	0	0
5	62288882	.	T	C	4	5	9	0	1	10	0	0
5	62288960	.	C	T	4	14	18	0	1	19	0	0
5	62289032	.	A	T	2	12	14	0	0	14	0	0
5	62289363	.	C	A	2	5	7	0	0	7	0	0
5	62289365	.	A	G	2	5	7	0	0	7	0	0
5	62289478	.	A	G	2	5	7	0	1	8	0	0
5	62289822	.	A	G	8	0	8	0	7	15	0	0
5	62290430	.	G	T	2	4	6	0	1	7	0	0
5	62290448	.	A	T	9	3	12	0	0	12	0	0
5	62290480	.	G	A	1	5	6	0	1	7	0	0
5	62290516	.	G	T	0	3	3	0	4	7	0	0
5	62290539	.	A	G	5	0	5	0	4	9	0	0
5	62290568	.	A	T	4	6	10	0	0	10	0	0
5	62290605	.	T	C	9	4	13	0	0	13	0	0
5	62290844	.	G	A	3	5	8	0	0	8	0	0
5	62290869	.	A	T	3	4	7	0	0	7	0	0
5	62290904	.	T	C	4	4	8	0	0	8	0	0
5	62290931	.	T	C	3	3	6	0	0	6	0	0
5	62290956	.	T	C	5	7	12	0	0	12	0	0
5	62311639	.	C	A	3	4	7	0	0	7	0	0
5	62319358	.	G	A	1	2	3	0	0	3	0	0
5	62319386	.	C	T	1	2	3	0	0	3	0	0
5	62328731	.	C	G	3	3	6	0	0	6	0	0
5	62328740	.	G	A	2	3	5	0	0	5	0	0
5	62328795	.	G	T	0	2	2	0	2	4	0	0
5	62329102	.	C	T	4	2	6	0	0	6	0	0
5	62329288	.	A	G	2	2	4	0	0	4	0	0
5	62329773	.	G	T	5	4	9	0	0	9	0	0
5	62329876	.	C	G	2	2	4	0	0	4	0	0
5	62329944	.	A	G	5	0	5	0	6	11	0	0
5	62330232	.	G	T	2	4	6	0	0	6	0	0
5	62330313	.	A	G	5	5	10	0	1	11	0	0
5	62330389	.	A	G	2	6	8	0	0	8	0	0
5	62330438	.	G	A	0	5	5	0	7	12	0	0
5	62330541	.	G	C	1	2	3	0	1	4	0	0
5	62330661	.	G	A	1	3	4	0	3	7	0	0
5	62330737	.	C	G	5	4	9	0	0	9	0	0
5	62330879	.	G	A	0	3	3	0	3	6	0	0
5	62330913	.	A	G	2	0	2	0	3	5	0	0
5	62331120	.	T	C	2	3	5	0	1	6	0	0
5	62331123	.	A	T	2	3	5	0	1	6	0	0
5	62331163	.	C	T	2	4	6	0	1	7	0	0
5	62331193	.	G	T	0	8	8	0	4	12	0	0
5	62331255	.	T	C	6	2	8	0	0	8	0	0
5	62331427	.	A	T	4	2	6	1	0	7	0	0
5	62331478	.	C	A	4	4	8	1	0	9	0	0
5	62331516	.	A	T	5	3	8	0	0	8	0	0
5	62331519	.	A	G	5	3	8	0	0	8	0	0
5	62331675	.	G	A	5	3	8	0	1	9	0	0
5	62331897	.	C	T	4	5	9	0	2	11	0	0
5	62331932	.	T	G	6	5	11	0	0	11	0	0
5	62331999	.	G	T	9	3	12	0	0	12	0	0
5	62332231	.	A	C	7	6	13	0	1	14	0	0
5	62332256	.	C	T	10	5	15	0	0	15	0	0
5	62332491	.	G	A	7	6	13	0	2	15	0	0
5	62332508	.	G	A	4	5	9	0	0	10	1	0
5	62332735	.	C	T	7	3	10	0	1	11	0	0
5	62333198	.	C	A	4	8	12	1	0	13	0	0
5	62333534	.	A	C	6	5	11	0	0	11	0	0
5	62333740	.	T	G	6	3	9	0	1	10	0	0
5	62333926	.	T	A	6	3	9	0	0	9	0	0
5	62333981	.	A	G	9	0	9	0	5	14	0	0
5	62334062	.	A	G	7	4	11	0	0	11	0	0
5	62334064	.	C	T	8	3	11	0	0	11	0	0
5	62334121	.	G	C	5	10	15	0	0	15	0	0
5	62334164	.	G	A	6	8	14	0	0	14	0	0
5	62334610	.	C	T	6	4	10	0	0	10	0	0
5	62334694	.	A	T	4	6	10	0	2	12	0	0
5	62334738	.	A	C	5	3	8	0	0	8	0	0
5	62334754	.	G	A	6	4	10	0	0	10	0	0
5	62334788	.	A	G	5	2	7	0	0	7	0	0
5	62334843	.	G	T	5	9	14	0	1	15	0	0
5	62334980	.	G	A	4	3	7	0	1	8	0	0
5	62335079	.	A	G	8	0	8	0	4	12	0	0
5	62335089	.	A	G	8	0	8	0	5	13	0	0
5	62335297	.	C	A	7	6	13	0	1	14	0	0
5	62335337	.	A	T	7	4	11	0	0	11	0	0
5	62335523	.	A	G	10	0	10	0	8	18	0	0
5	62335641	.	T	A	7	3	10	0	0	10	0	0
5	62335655	.	G	T	5	3	8	0	1	9	0	0
5	62521757	.	C	A	6	6	12	0	0	12	0	0
5	62526241	.	T	C	7	4	11	0	1	12	0	0
5	62526295	.	C	T	9	6	15	0	0	15	0	0
5	62533737	.	C	T	7	6	13	0	0	13	0	0
5	62633231	.	A	G	13	0	13	0	12	25	0	0
5	62637753	.	A	C	15	8	23	0	0	23	0	0
5	62639596	.	G	A	25	23	48	0	1	49	0	0
5	62806675	.	A	G	7	12	19	0	0	19	0	0
5	62806701	.	A	G	5	10	15	0	3	18	0	0
5	62806902	.	T	C	10	0	10	0	7	17	0	0
5	62806918	.	G	C	8	10	18	0	0	18	0	0
5	62806951	.	A	G	9	5	14	0	1	15	0	0
5	62807294	.	G	A	3	5	8	0	0	8	0	0
5	62807357	.	G	A	1	4	5	0	0	5	0	0
5	62821214	.	A	T	5	5	10	0	3	13	0	0
5	62856559	.	C	T	8	8	16	0	0	16	0	0
5	62868303	.	T	C	7	5	12	0	0	12	0	0
5	62868328	.	G	A	7	3	10	0	0	10	0	0
5	62883587	.	C	T	8	6	14	0	0	14	0	0
5	62884052	.	T	C	5	4	9	0	1	10	0	0
5	62885777	.	A	G	12	6	18	0	0	18	0	0
5	62885835	.	C	T	9	5	14	0	0	14	0	0
5	62885838	.	G	A	9	6	15	0	0	15	0	0
5	62889966	.	C	G	5	11	16	0	1	17	0	0
5	62890047	.	C	T	0	3	3	0	4	7	0	0
5	62890397	.	T	A	4	5	9	0	0	9	0	0
5	62890482	.	C	T	3	3	6	0	0	6	0	0
5	62890515	.	A	G	1	3	4	0	0	4	0	0
5	62890650	.	C	T	6	4	10	0	0	10	0	0
5	62890740	.	C	T	3	3	6	0	0	6	0	0
5	62890951	.	G	A	6	8	14	0	0	14	0	0
5	62940788	.	A	G	3	2	5	0	0	5	0	0
5	63248368	.	T	C	2	3	5	0	0	5	0	0
5	63248433	.	G	A	0	2	2	0	1	3	0	0
5	63248665	.	A	C	5	3	8	0	0	8	0	0
5	63248668	.	T	C	5	3	8	0	0	8	0	0
5	63265018	.	T	C	5	2	7	0	0	7	0	0
5	63273840	.	T	G	1	2	3	0	0	3	0	0
5	63289312	.	C	A	1	2	3	0	0	3	0	0
5	63315112	.	C	G	2	2	4	1	0	5	0	0
5	63315113	.	T	C	2	2	4	1	0	5	0	0
5	63359812	.	G	A	1	3	4	0	0	4	0	0
5	63359936	.	G	A	1	2	3	0	0	3	0	0
5	63360227	.	G	C	1	2	3	0	0	3	0	0
5	63360344	.	T	C	2	5	7	0	0	7	0	0
5	63375709	.	A	G	1	3	4	1	0	5	0	0
5	63376108	.	C	T	1	3	4	0	0	4	0	0
5	63382567	.	A	G	1	0	1	0	2	3	0	0
5	63386534	.	C	G	1	3	4	1	0	5	0	0
5	63395030	.	T	C	18	19	37	0	0	37	0	0
5	63395057	.	A	T	17	20	37	0	3	40	0	0
5	63398317	.	A	T	36	17	53	0	1	54	0	0
5	63398329	.	T	C	34	6	40	0	5	45	0	0
5	63398847	.	T	C	10	14	24	0	2	26	0	0
5	63399066	.	G	C	22	18	40	0	2	42	0	0
5	63399202	.	C	T	23	18	41	0	2	43	0	0
5	63399479	.	C	T	31	26	57	0	1	58	0	0
5	63399683	.	T	A	13	11	24	0	4	28	0	0
5	63400629	.	C	A	5	3	8	0	1	9	0	0
5	63407363	.	A	T	2	3	5	0	0	5	0	0
5	63411033	.	A	G	2	3	5	0	0	5	0	0
5	63412759	.	A	G	2	2	4	0	0	4	0	0
5	63416987	.	G	A	3	2	5	0	0	5	0	0
5	63425407	.	G	A	1	2	3	0	0	3	0	0
5	63434314	.	T	C	1	0	1	0	2	3	0	0
5	63510908	.	G	T	9	9	18	0	0	18	0	0
5	63511045	.	A	G	7	6	13	0	1	14	0	0
5	63511110	.	T	C	5	0	5	0	8	13	0	0
5	63511170	.	A	G	4	4	8	0	1	9	0	0
5	63511172	.	T	G	3	4	7	0	0	7	0	0
5	63511525	.	A	G	7	8	15	0	0	15	0	0
5	63511537	.	A	G	6	9	15	0	0	15	0	0
5	63629121	.	C	A	5	3	8	0	1	9	0	0
5	63629136	.	G	A	4	4	8	0	0	8	0	0
5	63629299	.	A	T	8	8	16	0	0	16	0	0
5	63644801	.	T	C	2	0	2	0	5	7	0	0
5	63644850	.	G	A	1	3	4	0	0	4	0	0
5	63648811	.	A	G	1	1	2	1	1	4	0	0
5	63657628	.	A	G	1	2	3	0	0	3	0	0
5	63658512	.	G	A	2	2	4	0	0	4	0	0
5	63659513	.	C	T	1	3	4	0	0	4	0	0
5	63680655	.	A	G	3	0	3	0	5	8	0	0
5	63680661	.	C	G	2	6	8	0	0	8	0	0
5	63680709	.	T	G	3	5	8	0	0	8	0	0
5	63680718	.	A	G	3	0	3	0	4	7	0	0
5	63681123	.	A	G	3	2	5	0	0	5	0	0
5	63695760	.	C	T	9	11	20	0	1	21	0	0
5	63698549	.	T	C	13	11	24	0	1	25	0	0
5	63699468	.	T	C	8	14	22	0	0	23	1	0
5	63720639	.	A	G	19	17	36	0	2	38	0	0
5	63723807	.	G	A	1	11	12	0	13	25	0	0
5	63730115	.	G	A	1	26	27	0	20	47	0	0
5	63739912	.	A	G	20	23	43	0	3	46	0	0
5	63740093	.	C	T	16	11	27	0	2	29	0	0
5	63740097	.	T	A	17	11	28	0	2	30	0	0
5	63740149	.	T	C	13	9	22	1	2	25	0	0
5	63740167	.	A	G	9	16	25	1	0	27	1	0
5	63740438	.	A	G	16	8	24	0	0	24	0	0
5	63740465	.	C	A	9	8	17	0	0	19	2	0
5	63740565	.	A	G	28	10	38	0	4	42	0	0
5	63740815	.	A	C	23	25	48	0	0	48	0	0
5	63740874	.	A	C	26	23	49	0	2	51	0	0
5	63740895	.	A	C	21	21	42	0	1	43	0	0
5	63740910	.	A	G	21	22	43	0	1	44	0	0
5	63741023	.	T	A	11	12	23	0	2	25	0	0
5	63741077	.	A	T	11	8	19	0	1	20	0	0
5	63848593	.	T	C	3	2	5	0	1	6	0	0
5	63848662	.	C	G	1	2	3	0	0	3	0	0
5	63860701	.	G	A	0	5	5	0	4	9	0	0
5	63860831	.	A	G	3	0	3	0	2	5	0	0
5	63860943	.	A	G	5	0	5	0	6	11	0	0
5	63862089	.	T	G	2	3	5	0	0	5	0	0
5	63862298	.	G	C	1	2	3	0	0	3	0	0
5	63862323	.	G	A	1	3	4	0	1	5	0	0
5	63862671	.	T	C	1	2	3	0	0	3	0	0
5	63862938	.	A	G	3	2	5	0	0	5	0	0
5	63862942	.	A	G	3	2	5	0	0	5	0	0
5	63863629	.	A	G	2	0	2	0	2	4	0	0
5	63863857	.	A	T	1	2	3	0	0	3	0	0
5	63863998	.	G	A	1	3	4	0	1	5	0	0
5	64177760	.	T	A	4	4	8	0	1	9	0	0
5	64177762	.	T	A	5	3	8	0	0	8	0	0
5	64181114	.	T	A	4	7	11	0	0	11	0	0
5	64184521	.	C	T	3	4	7	0	0	7	0	0
5	64184626	.	G	A	5	5	10	0	0	10	0	0
5	64204517	.	C	T	11	14	25	0	1	26	0	0
5	64204524	.	T	C	10	15	25	1	1	27	0	0
5	64204565	.	T	G	3	12	15	1	0	16	0	0
5	64204574	.	G	A	2	9	11	1	2	14	0	0
5	64205046	.	C	T	6	3	9	0	0	9	0	0
5	64205219	.	G	T	5	5	10	0	0	10	0	0
5	64205229	.	A	G	4	6	10	0	0	10	0	0
5	64205388	.	C	T	12	8	20	0	0	20	0	0
5	64205624	.	C	A	0	1	1	0	5	6	0	0
5	64205639	.	A	T	7	3	10	0	0	10	0	0
5	64205879	.	T	A	5	4	9	0	2	11	0	0
5	64205881	.	G	A	5	6	11	0	0	11	0	0
5	64205937	.	T	C	5	4	9	0	0	9	0	0
5	64206182	.	G	A	7	7	14	1	0	15	0	0
5	64206266	.	C	T	1	2	3	2	5	10	0	0
5	64206402	.	G	A	6	7	13	0	1	14	0	0
5	64206411	.	A	G	6	7	13	0	2	15	0	0
5	64206455	.	C	T	2	5	7	0	2	9	0	0
5	64206591	.	A	G	6	10	16	0	1	17	0	0
5	64206688	.	C	T	14	5	19	0	1	20	0	0
5	64207001	.	T	C	3	0	3	0	3	6	0	0
5	64207040	.	T	C	4	4	8	0	1	9	0	0
5	64207415	.	C	T	1	9	10	0	7	17	0	0
5	64207570	.	T	G	4	5	9	0	2	11	0	0
5	64210227	.	C	T	1	3	4	0	8	12	0	0
5	64210350	.	G	A	3	3	6	0	0	6	0	0
5	64212865	.	G	A	2	3	5	0	0	5	0	0
5	64212868	.	T	A	2	3	5	0	0	5	0	0
5	64291675	.	G	T	3	3	6	0	0	6	0	0
5	64299257	.	T	C	2	6	8	0	0	8	0	0
5	64369001	.	A	C	3	3	6	0	1	7	0	0
5	64369089	.	C	T	4	4	8	0	0	8	0	0
5	64376756	.	C	A	2	7	9	0	0	9	0	0
5	64377399	.	C	T	3	3	6	0	0	6	0	0
5	64377618	.	T	C	3	5	8	0	0	8	0	0
5	64378234	.	T	A	7	4	11	0	0	11	0	0
5	64378272	.	C	T	9	4	13	0	1	14	0	0
5	64378293	.	G	A	0	7	7	0	5	12	0	0
5	64378369	.	T	C	6	3	9	0	0	9	0	0
5	64378404	.	T	C	4	3	7	0	2	9	0	0
5	64378413	.	G	C	3	6	9	0	0	9	0	0
5	64397667	.	C	A	17	16	33	0	2	35	0	0
5	64398506	.	C	T	25	29	54	0	2	56	0	0
5	64398554	.	G	A	28	29	57	0	2	59	0	0
5	64398688	.	C	T	29	17	46	0	5	51	0	0
5	64407949	.	C	T	1	8	9	0	0	9	0	0
5	64408107	.	C	A	2	4	6	0	0	6	0	0
5	64408477	.	A	G	1	2	3	0	0	3	0	0
5	64412096	.	C	T	1	10	11	0	15	26	0	0
5	64412907	.	G	A	13	17	30	0	0	30	0	0
5	64413095	.	A	C	15	17	32	0	1	33	0	0
5	64413319	.	G	A	13	7	20	0	1	21	0	0
5	64413383	.	G	T	15	6	21	0	0	21	0	0
5	64413458	.	A	G	9	3	12	0	1	13	0	0
5	64413834	.	G	T	11	9	20	0	0	23	3	0
5	64413943	.	C	T	14	17	31	0	0	31	0	0
5	64439116	.	G	A	5	5	10	0	1	11	0	0
5	64439218	.	T	C	7	6	13	0	1	14	0	0
5	64439272	.	T	C	5	1	6	0	10	16	0	0
5	64444517	.	G	A	14	10	24	0	2	26	0	0
5	64448456	.	T	A	6	3	9	0	1	10	0	0
5	64454394	.	A	G	7	4	11	0	0	11	0	0
5	64732170	.	T	A	20	12	32	0	3	35	0	0
5	64732240	.	T	C	25	20	45	0	1	46	0	0
5	64740004	.	G	A	8	6	14	0	1	15	0	0
5	64849374	.	A	T	10	2	12	0	3	15	0	0
5	64849380	.	A	T	10	2	12	0	3	15	0	0
5	66252054	.	G	A	0	7	7	0	8	15	0	0
5	66259001	.	T	C	7	2	9	0	0	9	0	0
5	67079660	.	A	G	6	3	9	0	0	9	0	0
5	67095814	.	C	T	2	4	6	0	0	6	0	0
5	67096429	.	T	C	1	1	2	0	1	3	0	0
5	67188350	.	C	T	12	8	20	0	1	21	0	0
5	67188515	.	C	G	0	13	13	0	7	20	0	0
5	67188524	.	G	A	12	7	19	0	1	20	0	0
5	67192155	.	G	A	9	11	20	0	0	20	0	0
5	67194260	.	G	A	10	5	15	0	0	15	0	0
5	67198919	.	C	T	3	6	9	0	1	10	0	0
5	67200217	.	G	T	9	7	16	0	0	16	0	0
5	67205474	.	T	C	7	8	15	0	0	15	0	0
5	67205570	.	C	T	8	4	12	0	0	12	0	0
5	67205590	.	C	T	7	3	10	0	0	10	0	0
5	67211298	.	A	G	3	3	6	0	0	6	0	0
5	67211335	.	T	C	1	1	2	0	6	8	0	0
5	67211372	.	T	C	5	6	11	0	1	12	0	0
5	67211634	.	T	C	7	0	7	0	11	18	0	0
5	67211643	.	T	C	7	2	9	0	10	19	0	0
5	67217758	.	T	A	6	6	12	0	3	15	0	0
5	67217933	.	C	T	1	4	5	0	5	10	0	0
5	67229772	.	G	T	2	3	5	0	1	6	0	0
5	67229824	.	T	C	5	2	7	0	2	9	0	0
5	67229827	.	A	C	5	2	7	0	2	9	0	0
5	67234603	.	T	G	4	7	11	0	0	11	0	0
5	67239425	.	G	A	1	4	5	0	0	5	0	0
5	67253229	.	T	A	1	2	3	0	0	3	0	0
5	67254234	.	C	T	1	2	3	0	1	4	0	0
5	67254501	.	T	G	4	5	9	0	0	9	0	0
5	67254531	.	G	A	8	5	13	0	1	14	0	0
5	67254601	.	T	G	6	3	9	0	0	9	0	0
5	67254648	.	G	T	9	4	13	0	2	15	0	0
5	67254861	.	G	A	5	6	11	0	1	12	0	0
5	67254908	.	T	C	7	0	7	0	6	13	0	0
5	67255049	.	C	T	4	9	13	1	2	16	0	0
5	67260308	.	C	A	6	3	9	0	0	9	0	0
5	67260354	.	A	G	5	4	9	0	0	9	0	0
5	67268171	.	A	G	1	5	6	0	0	6	0	0
5	67272557	.	T	C	3	5	8	0	0	8	0	0
5	67272580	.	A	G	2	7	9	0	0	9	0	0
5	67272686	.	T	G	4	3	7	0	0	7	0	0
5	67272745	.	C	T	1	3	4	0	1	5	0	0
5	67272760	.	C	G	1	3	4	0	1	5	0	0
5	67272835	.	T	C	1	5	6	0	0	6	0	0
5	67278712	.	T	C	23	25	48	0	3	51	0	0
5	67280269	.	C	T	2	20	22	0	29	51	0	0
5	67280329	.	C	A	1	34	35	1	20	56	0	0
5	67280332	.	G	T	20	33	53	1	2	56	0	0
5	67288575	.	C	T	3	9	12	0	0	12	0	0
5	67288576	.	T	G	3	9	12	0	0	12	0	0
5	67288662	.	A	G	4	12	16	0	1	17	0	0
5	67288733	.	G	A	5	9	14	0	0	14	0	0
5	67289050	.	G	T	4	6	10	0	0	10	0	0
5	67292110	.	C	T	1	20	21	0	18	39	0	0
5	67292599	.	A	T	15	27	42	0	1	44	1	0
5	67316015	.	T	G	1	2	3	0	0	3	0	0
5	67316729	.	C	T	0	2	2	0	1	3	0	0
5	67316735	.	C	A	0	2	2	0	1	3	0	0
5	67316940	.	C	T	0	1	1	0	2	3	0	0
5	67316996	.	G	A	3	2	5	0	0	5	0	0
5	67317069	.	T	G	2	5	7	0	0	7	0	0
5	67317913	.	A	G	0	1	1	0	0	1	0	0
5	67317926	.	A	G	1	2	3	0	0	3	0	0
5	67317957	.	T	A	1	3	4	0	1	5	0	0
5	67481356	.	C	T	4	3	7	0	0	7	0	0
5	67481663	.	A	G	1	2	3	0	1	4	0	0
5	67484741	.	A	T	2	2	4	0	0	4	0	0
5	67672694	.	C	T	1	2	3	0	0	3	0	0
5	67838362	.	G	A	1	5	6	0	0	6	0	0
5	67838400	.	C	T	1	7	8	0	0	8	0	0
5	67838455	.	C	T	4	8	12	0	0	12	0	0
5	67838521	.	T	G	3	0	3	0	3	6	0	0
5	67838608	.	G	T	3	3	6	0	3	9	0	0
5	67838659	.	C	T	8	6	14	0	2	16	0	0
5	67839973	.	C	G	4	3	7	0	1	8	0	0
5	67839975	.	A	T	4	3	7	0	0	7	0	0
5	67840542	.	G	A	0	7	7	0	3	10	0	0
5	67840572	.	C	T	4	7	11	0	0	11	0	0
5	67840721	.	C	T	2	3	5	0	0	5	0	0
5	67842800	.	C	T	2	4	6	0	1	7	0	0
5	67842965	.	A	T	2	5	7	0	2	9	0	0
5	67845505	.	A	G	3	4	7	0	0	7	0	0
5	67845527	.	A	C	1	3	4	0	0	4	0	0
5	67847635	.	G	A	5	8	13	0	3	16	0	0
5	67849749	.	A	G	4	4	8	0	0	8	0	0
5	67855969	.	G	A	0	10	10	0	8	18	0	0
5	67857796	.	A	G	15	9	24	0	2	26	0	0
5	67857877	.	T	C	12	8	20	0	1	21	0	0
5	67858727	.	G	A	9	16	25	0	0	25	0	0
5	67859619	.	A	G	3	0	3	0	10	13	0	0
5	67860007	.	A	G	4	9	13	0	1	14	0	0
5	67873094	.	G	A	15	17	32	0	1	33	0	0
5	67873103	.	C	T	4	20	24	0	13	37	0	0
5	67874952	.	T	G	15	7	22	0	0	22	0	0
5	67874988	.	C	T	15	4	19	0	1	20	0	0
5	67884361	.	A	G	4	10	14	0	0	14	0	0
5	67884436	.	A	G	7	8	15	0	0	15	0	0
5	67884533	.	G	A	5	3	8	0	0	8	0	0
5	67884583	.	G	A	5	2	7	0	2	9	0	0
5	67884737	.	A	T	1	1	2	0	1	3	0	0
5	67884762	.	T	G	1	3	4	0	1	5	0	0
5	67884779	.	G	A	2	2	4	0	0	4	0	0
5	67885131	.	T	A	4	6	10	0	1	11	0	0
5	67885142	.	G	A	4	10	14	0	0	14	0	0
5	67885211	.	A	T	7	11	18	0	1	19	0	0
5	67885240	.	G	A	5	7	12	0	2	14	0	0
5	67885444	.	G	A	11	6	17	0	1	18	0	0
5	67885526	.	C	T	0	8	8	0	8	16	0	0
5	67886945	.	G	T	2	3	5	0	0	5	0	0
5	67887028	.	C	T	7	5	12	0	0	12	0	0
5	67887143	.	A	G	6	9	15	0	2	17	0	0
5	67887239	.	T	C	3	6	9	0	1	10	0	0
5	67887281	.	T	C	8	5	13	0	0	13	0	0
5	67889104	.	A	G	3	5	8	0	1	9	0	0
5	67889124	.	A	G	2	6	8	0	1	9	0	0
5	67891030	.	A	G	6	7	13	0	0	13	0	0
5	67892776	.	G	A	9	5	14	0	0	14	0	0
5	67892821	.	T	C	7	3	10	0	0	10	0	0
5	67909854	.	G	A	1	3	4	0	0	4	0	0
5	67910829	.	T	A	4	2	6	0	4	10	0	0
5	67971698	.	T	A	2	2	4	0	1	5	0	0
5	67971710	.	C	T	3	4	7	0	0	7	0	0
5	67974464	.	C	T	5	2	7	0	1	8	0	0
5	67974485	.	C	T	6	3	9	0	1	10	0	0
5	67977911	.	G	T	9	7	16	0	1	17	0	0
5	67977914	.	C	T	6	9	15	0	2	17	0	0
5	67978636	.	G	A	4	7	11	0	0	11	0	0
5	67978662	.	G	T	2	4	6	0	1	7	0	0
5	67978673	.	G	T	2	3	5	0	1	6	0	0
5	67980580	.	A	C	5	5	10	0	0	10	0	0
5	67980719	.	G	A	8	3	11	0	3	14	0	0
5	67980720	.	T	A	9	4	13	0	2	15	0	0
5	67982853	.	G	A	6	8	14	0	0	14	0	0
5	67991148	.	A	G	6	3	9	0	0	9	0	0
5	67992962	.	G	A	3	4	7	0	0	7	0	0
5	67992980	.	T	A	5	3	8	0	0	8	0	0
5	67992997	.	A	G	5	2	7	0	0	7	0	0
5	68037759	.	A	C	15	0	15	0	15	30	0	0
5	68037950	.	T	C	15	0	15	0	8	23	0	0
5	68042238	.	C	G	1	3	4	0	4	8	0	0
5	68044996	.	G	A	1	2	3	0	0	3	0	0
5	68045047	.	G	C	1	0	1	0	3	4	0	0
5	68045050	.	T	A	1	2	3	0	0	3	0	0
5	68048062	.	G	A	4	4	8	0	0	8	0	0
5	68060143	.	T	A	9	12	21	0	0	21	0	0
5	68060578	.	T	C	10	8	18	0	0	18	0	0
5	68060617	.	T	C	10	0	10	0	6	16	0	0
5	68060634	.	T	C	7	9	16	0	1	17	0	0
5	68060721	.	T	C	10	0	10	0	19	29	0	0
5	68060789	.	T	G	6	7	13	1	0	14	0	0
5	68066856	.	C	T	15	10	25	0	1	26	0	0
5	68068550	.	C	T	1	19	20	0	29	49	0	0
5	68068574	.	A	G	26	23	49	0	1	50	0	0
5	68069003	.	C	T	4	25	29	1	24	54	0	0
5	68074508	.	G	A	16	27	43	0	0	43	0	0
5	68074565	.	A	G	14	5	19	0	2	21	0	0
5	68076925	.	T	A	14	12	26	0	2	28	0	0
5	68088638	.	T	C	14	1	15	0	16	31	0	0
5	68088641	.	T	A	18	13	31	0	1	32	0	0
5	68090104	.	G	A	31	12	43	0	1	44	0	0
5	68093051	.	A	C	15	3	18	0	24	42	0	0
5	68170797	.	G	A	1	2	3	0	5	8	0	0
5	68180870	.	A	G	14	4	18	0	0	18	0	0
5	68181041	.	A	G	5	9	14	0	1	15	0	0
5	68181056	.	G	A	6	9	15	0	0	15	0	0
5	68188140	.	C	T	6	9	15	0	0	15	0	0
5	68188170	.	C	A	9	14	23	0	0	23	0	0
5	68409956	.	C	T	2	7	9	0	14	23	0	0
5	68409977	.	T	C	7	1	8	0	12	20	0	0
5	68415142	.	C	T	6	7	13	0	0	13	0	0
5	68431452	.	G	A	6	5	11	0	1	12	0	0
5	68431509	.	A	T	3	5	8	0	0	8	0	0
5	68766688	.	T	C	4	0	4	0	5	9	0	0
5	68766704	.	C	T	7	4	11	0	0	11	0	0
5	68767050	.	C	T	1	12	13	0	7	20	0	0
5	68767355	.	T	C	4	2	6	0	0	6	0	0
5	68767439	.	G	T	6	4	10	0	0	10	0	0
5	68767642	.	A	C	7	7	14	0	2	16	0	0
5	68767802	.	G	A	4	11	15	0	0	15	0	0
5	68778040	.	G	T	4	7	11	0	3	14	0	0
5	68778455	.	T	A	6	6	12	0	0	12	0	0
5	68778524	.	C	A	0	6	6	0	4	10	0	0
5	68778746	.	C	G	0	8	8	0	4	12	0	0
5	68778895	.	C	G	3	7	10	0	2	12	0	0
5	68778937	.	A	G	5	7	12	0	1	13	0	0
5	68778957	.	G	T	7	7	14	0	1	15	0	0
5	68779049	.	A	G	6	5	11	0	0	11	0	0
5	68779472	.	G	T	2	3	5	0	0	5	0	0
5	68782433	.	T	G	3	3	6	0	0	6	0	0
5	68831382	.	C	T	5	5	10	0	0	10	0	0
5	68832435	.	A	G	3	4	7	0	0	7	0	0
5	68840928	.	T	C	10	10	20	0	1	21	0	0
5	68846542	.	G	T	8	10	18	0	0	18	0	0
5	68848116	.	G	A	8	6	14	0	1	15	0	0
5	68850856	.	C	T	0	8	8	0	10	18	0	0
5	68850967	.	C	G	1	10	11	0	7	18	0	0
5	68860776	.	A	C	7	1	8	0	4	12	0	0
5	68863784	.	C	T	0	2	2	0	2	4	0	0
5	68863806	.	T	C	2	0	2	0	3	5	0	0
5	68873804	.	C	T	5	7	12	0	0	12	0	0
5	68892515	.	A	C	20	12	32	7	1	41	1	0
5	68892543	.	T	C	14	13	27	0	2	29	0	0
5	68892728	.	T	C	3	2	5	1	0	6	0	0
5	68892801	.	G	A	3	9	12	0	0	12	0	0
5	68899505	.	C	T	5	3	8	0	0	8	0	0
5	68899585	.	C	T	3	2	5	0	0	5	0	0
5	68900820	.	C	G	8	9	17	0	0	17	0	0
5	68900825	.	G	A	8	8	16	0	0	16	0	0
5	68900891	.	C	T	1	7	8	0	12	20	0	0
5	68927410	.	T	A	6	5	11	0	1	12	0	0
5	68927539	.	G	A	4	4	8	0	0	8	0	0
5	68927557	.	G	A	4	4	8	0	1	9	0	0
5	68927591	.	G	A	5	4	9	0	0	9	0	0
5	68963602	.	A	T	4	2	6	0	0	6	0	0
5	68980985	.	G	T	4	3	7	0	0	7	0	0
5	68982205	.	G	T	2	6	8	0	0	8	0	0
5	68982340	.	G	A	3	3	6	0	0	6	0	0
5	68998572	.	A	T	1	2	3	0	0	3	0	0
5	69002293	.	C	T	1	3	4	0	1	5	0	0
5	69008453	.	A	C	4	0	4	0	3	7	0	0
5	69014276	.	T	C	3	4	7	0	0	7	0	0
5	69018997	.	G	A	3	2	5	0	0	5	0	0
5	69141307	.	G	A	6	6	12	0	1	13	0	0
5	69141440	.	G	T	12	10	22	0	0	22	0	0
5	69144428	.	C	T	1	4	5	0	0	5	0	0
5	69155281	.	G	A	1	4	5	0	1	6	0	0
5	69199553	.	T	C	1	2	3	0	0	3	0	0
5	69205284	.	A	G	4	2	6	0	1	7	0	0
5	69234725	.	C	T	1	4	5	0	1	6	0	0
5	69238002	.	G	A	1	2	3	0	0	3	0	0
5	69246853	.	G	C	5	3	8	0	0	8	0	0
5	69259068	.	C	T	2	2	4	0	0	4	0	0
5	69278192	.	A	G	8	0	8	0	29	37	0	0
5	69280119	.	G	A	15	9	24	1	0	25	0	0
5	69287061	.	C	T	15	16	31	0	3	34	0	0
5	69287180	.	A	T	25	16	41	0	2	43	0	0
5	69287264	.	C	G	13	17	30	0	0	30	0	0
5	69290128	.	A	G	2	2	4	0	0	4	0	0
5	69290139	.	C	G	1	2	3	0	0	3	0	0
5	69290962	.	A	G	2	3	5	0	0	5	0	0
5	69290980	.	C	T	3	3	6	0	0	6	0	0
5	69291071	.	A	T	10	4	14	0	1	15	0	0
5	69291488	.	G	A	1	3	4	0	0	4	0	0
5	69291510	.	T	C	0	4	4	0	1	5	0	0
5	69291525	.	G	T	2	2	4	0	0	4	0	0
5	69427984	.	A	G	13	20	33	0	0	33	0	0
5	69428056	.	A	T	12	7	19	0	2	21	0	0
5	69428148	.	T	C	7	4	11	0	1	12	0	0
5	69428201	.	G	A	3	2	5	0	2	7	0	0
5	69429544	.	G	A	15	15	30	0	8	38	0	0
5	69431287	.	G	C	13	22	35	0	1	36	0	0
5	69431486	.	A	G	18	23	41	0	2	43	0	0
5	69462894	.	C	T	0	2	2	0	5	7	0	0
5	69463038	.	G	T	2	5	7	0	1	8	0	0
5	69463077	.	G	A	3	5	8	0	0	8	0	0
5	69464731	.	G	A	4	3	7	0	0	7	0	0
5	69464811	.	C	T	1	5	6	0	1	7	0	0
5	69466375	.	G	T	5	5	10	0	0	10	0	0
5	69469336	.	G	A	1	4	5	0	0	5	0	0
5	69482654	.	A	G	5	2	7	0	0	7	0	0
5	69482658	.	G	A	2	5	7	0	0	7	0	0
5	69486618	.	T	C	6	9	15	0	2	17	0	0
5	69486698	.	G	A	8	8	16	0	0	16	0	0
5	69486749	.	A	T	9	9	18	0	1	20	1	0
5	69486756	.	G	A	8	10	18	0	0	18	0	0
5	69486844	.	G	T	12	9	21	1	2	26	2	0
5	69491754	.	G	A	7	13	20	0	1	21	0	0
5	69491766	.	T	C	4	1	5	0	11	16	0	0
5	69492126	.	G	C	3	0	3	0	6	9	0	0
5	69495928	.	C	G	0	3	3	0	4	7	0	0
5	69557764	.	A	G	5	3	8	0	0	8	0	0
5	69557776	.	G	T	6	3	9	0	1	10	0	0
5	69574972	.	G	T	13	10	23	0	0	23	0	0
5	69577902	.	G	T	11	6	17	17	0	34	0	0
5	69579118	.	T	C	20	1	21	0	16	37	0	0
5	69579378	.	G	A	14	5	19	2	0	21	0	0
5	69581937	.	G	A	2	4	6	2	0	8	0	0
5	69588720	.	A	T	3	18	21	4	1	26	0	0
5	69595361	.	G	A	5	21	26	1	2	29	0	0
5	69599798	.	G	T	2	8	10	3	0	13	0	0
5	69607398	.	T	C	2	7	9	1	0	10	0	0
5	69607411	.	A	G	4	4	8	2	0	14	4	0
5	69616625	.	A	T	2	3	5	2	1	8	0	0
5	69686414	.	T	C	1	3	4	0	0	4	0	0
5	69700379	.	C	T	1	3	4	0	0	4	0	0
5	70182082	.	A	G	23	38	61	0	0	61	0	0
5	70182599	.	T	G	33	0	33	0	22	55	0	0
5	70317090	.	T	A	2	2	4	0	0	4	0	0
5	70317960	.	G	A	4	2	6	0	0	6	0	0
5	70318311	.	T	C	4	6	10	0	0	10	0	0
5	70318320	.	G	A	4	6	10	0	0	10	0	0
5	70318665	.	A	T	4	3	7	0	0	7	0	0
5	70318671	.	C	T	4	3	7	0	1	8	0	0
5	70318898	.	T	A	1	4	5	0	0	5	0	0
5	70319066	.	G	A	1	3	4	0	4	8	0	0
5	70319533	.	C	T	4	2	6	0	0	6	0	0
6	29439	.	T	C	17	11	28	0	1	29	0	0
6	32436	.	G	A	0	2	2	0	3	5	0	0
6	33139	.	A	G	1	4	5	0	1	6	0	0
6	35464	.	G	C	3	4	7	0	1	8	0	0
6	36084	.	A	G	4	0	4	0	9	13	0	0
6	37050	.	C	T	6	3	9	0	0	9	0	0
6	37919	.	C	T	12	9	21	0	1	22	0	0
6	38168	.	C	T	9	10	19	0	0	19	0	0
6	38264	.	C	G	6	7	13	0	1	14	0	0
6	41065	.	A	T	11	15	26	0	0	26	0	0
6	41164	.	A	G	5	5	10	0	6	16	0	0
6	48863	.	G	T	1	2	3	0	1	4	0	0
6	58559	.	G	A	0	7	7	0	7	14	0	0
6	59171	.	G	A	6	4	10	0	2	12	0	0
6	59459	.	T	C	3	7	10	0	0	10	0	0
6	59465	.	G	A	4	5	9	0	1	10	0	0
6	59732	.	T	C	11	6	17	0	0	17	0	0
6	68277	.	A	T	9	6	15	0	0	15	0	0
6	92359	.	T	G	14	12	26	0	1	27	0	0
6	92383	.	A	G	11	12	23	0	2	25	0	0
6	93840	.	T	C	21	12	33	0	4	37	0	0
6	93966	.	A	G	27	11	38	0	1	39	0	0
6	121239	.	C	T	8	3	11	0	0	11	0	0
6	125868	.	C	T	1	2	3	0	1	4	0	0
6	132157	.	G	C	8	8	16	0	0	16	0	0
6	132867	.	C	T	7	6	13	1	2	16	0	0
6	132868	.	A	G	9	6	15	1	1	17	0	0
6	134267	.	C	G	4	8	12	0	3	15	0	0
6	134270	.	C	T	1	7	8	0	8	16	0	0
6	136816	.	G	A	3	5	8	0	0	8	0	0
6	136988	.	A	T	5	3	8	0	0	8	0	0
6	152306	.	A	G	14	0	14	0	18	32	0	0
6	152537	.	T	C	11	3	14	0	0	14	0	0
6	152539	.	T	C	11	3	14	0	0	14	0	0
6	152680	.	T	A	6	6	12	0	1	13	0	0
6	169959	.	A	C	2	4	6	0	0	6	0	0
6	184361	.	C	T	15	14	29	0	0	29	0	0
6	184382	.	A	G	11	0	11	0	19	30	0	0
6	202699	.	C	A	4	7	11	0	0	11	0	0
6	203950	.	A	T	5	4	9	0	0	9	0	0
6	204004	.	C	T	4	6	10	0	0	10	0	0
6	204014	.	A	C	3	5	8	0	1	9	0	0
6	204106	.	G	A	1	3	4	0	2	6	0	0
6	204354	.	T	C	1	2	3	0	0	3	0	0
6	204385	.	C	T	2	2	4	0	0	4	0	0
6	204952	.	T	C	4	9	13	0	1	14	0	0
6	205090	.	T	C	8	8	16	0	0	16	0	0
6	205102	.	G	A	11	7	18	0	1	19	0	0
6	205159	.	T	C	8	12	20	0	0	20	0	0
6	205258	.	G	A	2	4	6	0	3	9	0	0
6	265188	.	G	T	10	12	22	0	2	24	0	0
6	265191	.	A	T	8	12	20	0	1	21	0	0
6	265837	.	G	A	14	18	32	0	0	32	0	0
6	267412	.	C	T	12	11	23	0	1	24	0	0
6	267417	.	C	G	13	11	24	0	0	24	0	0
6	267451	.	G	A	0	6	6	0	14	20	0	0
6	267645	.	C	T	5	11	16	0	0	16	0	0
6	267669	.	C	T	5	10	15	0	1	16	0	0
6	267720	.	C	G	7	6	13	0	0	13	0	0
6	267817	.	G	A	6	12	18	0	0	18	0	0
6	267884	.	T	C	6	5	11	0	0	11	0	0
6	267886	.	T	C	6	4	10	0	1	11	0	0
6	271793	.	C	A	24	19	43	0	2	46	1	0
6	272041	.	C	T	29	25	54	0	3	57	0	0
6	272056	.	A	G	26	23	49	0	2	51	0	0
6	272194	.	A	G	34	0	34	0	14	48	0	0
6	272298	.	G	A	1	18	19	0	27	46	0	0
6	272503	.	T	C	8	12	20	0	2	22	0	0
6	322371	.	C	T	13	10	23	0	1	24	0	0
6	331909	.	T	A	12	8	20	0	2	22	0	0
6	331912	.	C	T	12	9	21	0	2	23	0	0
6	340480	.	A	C	28	15	43	0	0	43	0	0
6	340488	.	T	C	15	19	34	0	1	35	0	0
6	340670	.	A	G	18	19	37	0	2	39	0	0
6	340800	.	T	G	17	19	36	0	2	38	0	0
6	340839	.	A	G	10	14	24	0	1	25	0	0
6	340931	.	G	A	10	6	16	0	1	17	0	0
6	341882	.	G	A	16	20	36	0	1	38	1	0
6	341933	.	G	A	26	17	43	0	0	43	0	0
6	341953	.	C	T	24	25	49	0	0	49	0	0
6	342017	.	T	A	13	21	34	0	0	34	0	0
6	342123	.	C	T	13	14	27	3	0	30	0	0
6	374956	.	T	A	5	7	12	0	1	13	0	0
6	374988	.	G	T	2	6	8	0	0	8	0	0
6	375007	.	A	C	6	4	10	0	0	10	0	0
6	375051	.	T	C	6	4	10	0	0	10	0	0
6	543216	.	G	A	3	3	6	0	1	7	0	0
6	840792	.	C	G	14	11	25	0	1	26	0	0
6	841511	.	T	C	10	13	23	0	0	23	0	0
6	841557	.	A	G	16	7	23	0	0	23	0	0
6	841851	.	T	C	12	22	34	0	2	36	0	0
6	841941	.	G	A	15	6	21	0	3	24	0	0
6	842009	.	G	A	16	13	29	0	2	31	0	0
6	842010	.	C	T	3	14	17	0	14	31	0	0
6	842149	.	A	T	4	10	14	0	0	17	3	0
6	842192	.	T	C	8	0	8	0	8	16	0	0
6	842241	.	T	C	10	3	13	0	0	13	0	0
6	842264	.	T	C	9	7	16	0	1	17	0	0
6	842343	.	C	T	9	10	19	1	1	21	0	0
6	842461	.	C	T	6	3	9	0	2	11	0	0
6	842739	.	C	T	1	13	14	1	17	32	0	0
6	842791	.	C	A	10	17	27	0	2	30	1	0
6	842816	.	A	C	17	9	26	0	0	26	0	0
6	842882	.	T	A	2	5	7	0	1	8	0	0
6	843745	.	C	A	7	5	12	0	2	14	0	0
6	843836	.	G	A	8	5	13	1	1	15	0	0
6	843978	.	T	A	2	3	5	0	1	7	1	0
6	844146	.	G	T	5	6	11	0	0	11	0	0
6	844164	.	C	T	5	4	9	0	0	9	0	0
6	844209	.	G	A	3	2	5	0	0	5	0	0
6	844282	.	T	C	2	3	5	0	0	5	0	0
6	844337	.	A	G	3	5	8	0	1	9	0	0
6	844388	.	A	G	17	6	23	0	2	25	0	0
6	858026	.	C	T	2	6	8	0	11	19	0	0
6	858128	.	C	T	1	12	13	0	13	26	0	0
6	858713	.	A	G	11	9	20	0	2	22	0	0
6	859364	.	C	T	7	3	10	0	1	11	0	0
6	869374	.	T	C	5	4	9	0	1	10	0	0
6	1431988	.	A	C	1	2	3	0	0	3	0	0
6	1511685	.	A	G	22	23	45	0	3	48	0	0
6	1535603	.	G	T	4	2	6	0	0	6	0	0
6	1538150	.	G	A	8	3	11	0	0	11	0	0
6	1539074	.	G	A	2	6	8	0	0	8	0	0
6	1541393	.	A	G	7	3	10	0	1	11	0	0
6	1544724	.	G	A	1	2	3	0	0	3	0	0
6	1554299	.	T	G	7	4	11	0	0	11	0	0
6	1554922	.	A	T	4	4	8	0	0	8	0	0
6	1556890	.	C	T	2	3	5	0	0	5	0	0
6	1557177	.	G	C	3	2	5	0	0	5	0	0
6	1562026	.	A	C	2	4	6	0	0	6	0	0
6	1562230	.	G	A	1	2	3	0	0	3	0	0
6	1581411	.	C	A	2	2	4	0	0	4	0	0
6	1581418	.	G	A	2	2	4	0	0	4	0	0
6	1794944	.	T	C	1	4	5	0	0	5	0	0
6	1797560	.	A	T	2	3	5	0	1	6	0	0
6	1797567	.	G	T	2	4	6	0	0	6	0	0
6	1797895	.	A	G	3	0	3	0	14	17	0	0
6	1798710	.	G	A	1	2	3	4	10	17	0	0
6	1798716	.	T	G	3	5	8	4	3	15	0	0
6	1799112	.	A	T	3	3	6	0	1	7	0	0
6	1838527	.	C	T	3	7	10	0	0	10	0	0
6	1874606	.	T	G	3	3	6	0	0	6	0	0
6	2089145	.	C	T	1	3	4	0	0	4	0	0
6	2089197	.	A	C	2	3	5	0	0	5	0	0
6	2089239	.	A	G	2	0	2	0	4	6	0	0
6	2091200	.	G	A	1	3	4	0	1	5	0	0
6	2091946	.	C	T	1	2	3	0	0	3	0	0
6	2091948	.	G	A	0	2	2	0	1	3	0	0
6	2117557	.	G	A	1	2	3	0	0	3	0	0
6	2120734	.	G	A	1	4	5	0	0	5	0	0
6	2120821	.	A	C	1	6	7	0	0	7	0	0
6	2120833	.	T	C	1	5	6	0	0	6	0	0
6	2126043	.	G	A	2	3	5	0	1	6	0	0
6	2126320	.	G	A	2	3	5	0	0	5	0	0
6	2126444	.	G	T	7	2	9	0	0	9	0	0
6	2126469	.	T	C	0	8	8	0	0	8	0	0
6	2126486	.	T	A	4	6	10	0	0	10	0	0
6	2126512	.	C	T	5	5	10	0	0	10	0	0
6	2133641	.	T	A	2	4	6	0	0	6	0	0
6	2133644	.	C	A	0	2	2	0	4	6	0	0
6	2165703	.	T	G	5	2	7	0	0	7	0	0
6	2165735	.	A	T	2	5	7	0	0	7	0	0
6	2165955	.	A	G	4	8	12	0	0	12	0	0
6	2165982	.	A	T	8	5	13	0	0	13	0	0
6	2166074	.	G	A	6	4	10	0	0	10	0	0
6	2166085	.	T	G	5	4	9	0	0	9	0	0
6	2166111	.	A	T	3	5	8	0	0	8	0	0
6	2166157	.	G	A	6	5	11	0	0	11	0	0
6	2166240	.	T	C	10	0	10	0	6	16	0	0
6	2166287	.	A	T	5	6	11	0	0	11	0	0
6	2166531	.	A	T	6	4	10	0	0	10	0	0
6	2171341	.	A	G	2	3	5	0	0	5	0	0
6	2190325	.	T	A	4	2	6	0	0	6	0	0
6	2190337	.	C	T	2	3	5	0	0	5	0	0
6	2190857	.	C	T	1	8	9	0	0	9	0	0
6	2194178	.	A	G	2	4	6	0	0	6	0	0
6	2198105	.	G	C	7	8	15	0	1	16	0	0
6	2198635	.	A	C	1	3	4	0	0	4	0	0
6	2198659	.	A	G	1	3	4	0	0	4	0	0
6	2206682	.	C	T	1	4	5	0	0	5	0	0
6	2206704	.	G	T	1	4	5	0	0	5	0	0
6	2206884	.	G	A	10	5	15	0	0	15	0	0
6	2207189	.	G	T	2	4	6	0	0	6	0	0
6	2208261	.	A	T	1	6	7	0	0	7	0	0
6	2208479	.	T	G	6	2	8	0	0	8	0	0
6	2208562	.	C	T	8	3	11	0	1	12	0	0
6	2208609	.	C	T	5	8	13	0	0	13	0	0
6	2208655	.	A	G	5	4	9	2	0	11	0	0
6	2210120	.	A	G	7	5	12	0	1	13	0	0
6	2215208	.	T	A	3	2	5	0	0	6	1	0
6	2216896	.	G	T	1	4	5	0	1	6	0	0
6	2217689	.	C	T	0	4	4	0	4	8	0	0
6	2384828	.	C	T	1	4	5	0	0	5	0	0
6	2391475	.	G	A	1	9	10	0	5	15	0	0
6	2453730	.	T	C	4	6	10	0	0	10	0	0
6	2453751	.	A	C	4	8	12	0	1	13	0	0
6	2533345	.	T	G	2	2	4	0	0	4	0	0
6	2560464	.	C	T	1	4	5	0	0	5	0	0
6	2560500	.	C	T	2	2	4	0	0	4	0	0
6	2586037	.	A	G	1	0	1	0	2	3	0	0
6	2586154	.	G	A	2	3	5	0	0	5	0	0
6	2620078	.	C	G	2	3	5	0	0	5	0	0
6	2621637	.	C	G	1	10	11	0	5	16	0	0
6	2621656	.	G	A	9	7	16	0	1	17	0	0
6	2621677	.	C	T	8	7	15	0	1	16	0	0
6	2621719	.	T	A	5	3	8	0	1	9	0	0
6	2623378	.	G	C	6	4	10	0	0	10	0	0
6	2624527	.	G	C	3	7	10	0	0	10	0	0
6	3040572	.	G	A	1	2	3	0	0	3	0	0
6	3143019	.	C	T	3	3	6	0	0	6	0	0
6	3143292	.	T	A	3	4	7	0	0	7	0	0
6	3197028	.	C	T	5	7	12	0	0	12	0	0
6	3205538	.	T	C	9	5	14	0	2	16	0	0
6	3223245	.	C	T	6	3	9	0	0	9	0	0
6	3223341	.	C	G	9	4	13	0	1	14	0	0
6	3268327	.	T	C	7	11	18	0	1	19	0	0
6	3270011	.	G	A	14	12	26	0	2	28	0	0
6	3273341	.	T	A	8	11	19	0	1	20	0	0
6	3273379	.	A	G	10	10	20	0	2	22	0	0
6	3273588	.	A	T	7	3	10	1	2	13	0	0
6	3273826	.	A	T	6	15	21	0	2	23	0	0
6	3273965	.	C	T	15	22	37	0	1	38	0	0
6	3273986	.	T	C	9	29	38	0	1	39	0	0
6	3274114	.	G	C	5	18	23	0	15	38	0	0
6	3274289	.	C	T	17	12	29	0	0	29	0	0
6	3295998	.	C	A	5	5	10	0	0	10	0	0
6	3302599	.	C	T	4	2	6	0	0	6	0	0
6	3302644	.	T	C	4	2	6	0	1	7	0	0
6	3302645	.	A	G	5	0	5	0	2	7	0	0
6	3309358	.	C	T	2	5	7	0	0	7	0	0
6	3312627	.	C	T	2	5	7	0	0	7	0	0
6	3312750	.	A	T	1	3	4	0	1	5	0	0
6	3318673	.	T	C	6	7	13	0	0	13	0	0
6	3319047	.	A	G	1	2	3	0	0	3	0	0
6	3395649	.	C	T	7	4	11	0	0	11	0	0
6	3398876	.	A	G	6	0	6	0	3	9	0	0
6	3398906	.	A	G	4	4	8	0	0	8	0	0
6	3404956	.	G	A	0	9	9	0	6	15	0	0
6	3405060	.	G	A	1	6	7	0	5	12	0	0
6	3405143	.	T	C	12	3	15	0	1	16	0	0
6	3405191	.	G	C	7	5	12	0	0	12	0	0
6	3405244	.	A	G	7	6	13	0	0	13	0	0
6	3405245	.	C	A	8	6	14	0	0	14	0	0
6	3509041	.	T	G	5	4	9	0	1	10	0	0
6	3514481	.	A	C	31	26	57	3	3	63	0	0
6	3564404	.	A	G	3	3	6	0	0	6	0	0
6	3566502	.	T	C	2	0	2	0	2	4	0	0
6	3698558	.	C	T	2	5	7	0	0	7	0	0
6	3704391	.	G	A	1	8	9	0	6	15	0	0
6	3707095	.	A	G	12	9	21	0	1	22	0	0
6	3707116	.	G	A	12	11	23	0	0	23	0	0
6	3707371	.	G	A	0	12	12	0	11	23	0	0
6	3707372	.	A	G	10	12	22	0	1	23	0	0
6	3707407	.	T	C	7	12	19	0	2	21	0	0
6	3708061	.	A	G	8	11	19	0	1	20	0	0
6	3708149	.	T	C	10	7	17	0	2	19	0	0
6	3711200	.	T	A	2	9	11	0	0	11	0	0
6	3711221	.	A	G	6	10	16	0	1	17	0	0
6	3711338	.	A	G	6	3	9	0	0	9	0	0
6	3711386	.	T	C	8	8	16	0	1	17	0	0
6	3711419	.	A	G	5	9	14	0	1	15	0	0
6	3711448	.	C	A	3	7	10	0	1	11	0	0
6	3711971	.	G	A	3	4	7	0	0	7	0	0
6	3712045	.	T	A	9	2	11	0	0	11	0	0
6	3712069	.	A	T	8	5	13	0	0	13	0	0
6	3712136	.	G	A	4	2	6	0	0	6	0	0
6	3712198	.	G	T	2	2	4	0	0	4	0	0
6	3712199	.	A	C	2	2	4	0	0	4	0	0
6	3712238	.	A	T	3	2	5	0	1	6	0	0
6	3712264	.	A	C	6	2	8	0	0	8	0	0
6	3712335	.	T	G	8	0	8	0	3	11	0	0
6	3712389	.	C	T	2	7	9	0	0	9	0	0
6	3712433	.	A	T	4	4	8	0	0	8	0	0
6	3712713	.	C	G	4	4	8	0	0	8	0	0
6	3712979	.	G	A	1	2	3	0	0	3	0	0
6	3717110	.	A	T	6	9	15	0	0	15	0	0
6	3717843	.	C	T	7	9	16	0	0	16	0	0
6	3724870	.	A	C	8	12	20	0	0	20	0	0
6	3725767	.	C	A	19	25	44	0	0	44	0	0
6	3727891	.	C	T	8	8	16	0	0	16	0	0
6	3728295	.	A	T	3	6	9	0	0	9	0	0
6	3728559	.	G	C	3	4	7	0	1	8	0	0
6	3827894	.	C	A	14	8	22	0	2	24	0	0
6	3834630	.	G	C	36	12	48	0	1	49	0	0
6	3853120	.	T	G	29	0	29	0	29	58	0	0
6	3853165	.	T	C	35	30	65	0	1	66	0	0
6	3862018	.	A	G	11	20	31	0	1	32	0	0
6	3867542	.	A	T	8	8	16	0	1	17	0	0
6	3869454	.	G	A	2	10	12	0	12	24	0	0
6	3869891	.	C	T	18	17	35	0	0	35	0	0
6	3871982	.	T	A	22	20	42	0	3	45	0	0
6	3874504	.	G	A	5	27	32	0	20	52	0	0
6	3874533	.	C	T	23	20	43	0	4	47	0	0
6	3874686	.	A	G	16	18	34	0	3	37	0	0
6	3878513	.	T	A	5	8	13	0	0	13	0	0
6	3878593	.	A	G	7	12	19	0	0	19	0	0
6	3878831	.	G	C	3	6	9	0	1	10	0	0
6	3878983	.	A	T	10	7	17	0	8	25	0	0
6	3879158	.	A	G	9	7	16	0	1	17	0	0
6	3879247	.	C	A	0	10	10	0	16	26	0	0
6	3879314	.	C	G	0	12	12	0	9	21	0	0
6	3879335	.	C	T	10	13	23	0	1	24	0	0
6	3879367	.	G	A	6	13	19	0	1	20	0	0
6	3881078	.	G	A	12	9	21	0	0	21	0	0
6	3885451	.	C	T	17	6	23	0	0	23	0	0
6	3895442	.	A	T	6	7	13	0	0	13	0	0
6	3895460	.	C	T	2	10	12	0	8	20	0	0
6	3901120	.	C	T	1	8	9	0	10	19	0	0
6	3906051	.	C	T	0	8	8	0	8	16	0	0
6	3907796	.	A	T	11	5	16	0	0	16	0	0
6	3945773	.	C	A	3	4	7	0	0	7	0	0
6	3950267	.	C	T	4	4	8	0	0	8	0	0
6	3950270	.	C	T	3	3	6	0	1	7	0	0
6	3950309	.	C	T	5	5	10	0	0	10	0	0
6	3953280	.	T	C	5	5	10	0	0	10	0	0
6	3953302	.	A	C	5	3	8	0	2	10	0	0
6	3962132	.	G	A	25	24	49	0	3	52	0	0
6	3962192	.	A	T	24	20	44	0	4	48	0	0
6	3964619	.	G	A	12	10	22	0	1	23	0	0
6	3965389	.	G	T	14	8	22	0	0	22	0	0
6	3965461	.	A	G	10	14	24	0	1	25	0	0
6	3973572	.	G	A	6	7	13	0	0	13	0	0
6	3973638	.	T	G	6	8	14	0	1	15	0	0
6	3974047	.	G	A	8	6	14	0	1	15	0	0
6	3984909	.	T	A	1	2	3	0	0	3	0	0
6	3985083	.	G	A	7	8	15	0	2	17	0	0
6	3985137	.	G	A	9	11	20	0	0	20	0	0
6	3987131	.	A	G	8	3	11	0	0	11	0	0
6	3987145	.	T	C	3	6	9	0	0	9	0	0
6	3989704	.	C	A	3	4	7	0	0	7	0	0
6	4185678	.	G	A	11	16	27	0	1	28	0	0
6	4191449	.	C	T	9	4	13	0	0	13	0	0
6	4191554	.	A	T	4	6	10	0	1	11	0	0
6	4192025	.	G	A	6	4	10	0	1	11	0	0
6	4192031	.	A	G	3	6	9	0	0	9	0	0
6	4192171	.	G	A	3	5	8	0	0	8	0	0
6	4199494	.	T	C	2	2	4	0	0	4	0	0
6	4204117	.	G	T	1	3	4	0	0	4	0	0
6	4219856	.	G	A	4	5	9	0	0	9	0	0
6	4229830	.	C	T	2	2	4	0	0	4	0	0
6	4241945	.	C	T	1	2	3	0	0	3	0	0
6	4241954	.	A	G	1	5	6	0	0	6	0	0
6	4245276	.	C	T	9	6	15	0	0	15	0	0
6	4246466	.	T	C	3	4	7	1	1	9	0	0
6	4246496	.	G	A	0	6	6	0	1	7	0	0
6	4247099	.	A	T	0	6	6	0	0	6	0	0
6	4247755	.	C	T	2	4	6	1	0	7	0	0
6	4247928	.	C	T	5	7	12	0	1	13	0	0
6	4247942	.	T	C	4	4	8	0	1	9	0	0
6	4248399	.	A	T	2	9	11	0	0	11	0	0
6	4248412	.	T	A	3	6	9	0	1	10	0	0
6	4249420	.	C	T	3	3	6	0	0	6	0	0
6	4249437	.	A	G	3	3	6	0	1	7	0	0
6	4249684	.	A	G	4	7	11	0	0	11	0	0
6	4249821	.	G	A	3	5	8	0	0	8	0	0
6	4250046	.	A	T	1	3	4	0	0	4	0	0
6	4314593	.	C	A	1	2	3	0	0	3	0	0
6	4347505	.	A	T	2	1	3	0	1	4	0	0
6	4347541	.	T	C	3	3	6	0	0	6	0	0
6	4352140	.	G	T	2	3	5	0	0	5	0	0
6	4359773	.	G	A	2	4	6	0	0	6	0	0
6	4360110	.	C	T	2	4	6	0	0	6	0	0
6	4365163	.	C	T	2	7	9	0	1	10	0	0
6	4365295	.	G	C	5	9	14	0	0	14	0	0
6	4376831	.	T	C	3	4	7	0	0	7	0	0
6	4376849	.	G	A	0	4	4	0	4	8	0	0
6	4376894	.	G	A	2	3	5	0	1	6	0	0
6	4377182	.	A	G	2	3	5	0	1	6	0	0
6	4379559	.	G	C	6	10	16	0	0	16	0	0
6	4379760	.	G	A	0	6	6	0	5	11	0	0
6	4389434	.	G	A	6	10	16	0	1	17	0	0
6	4389436	.	T	C	10	7	17	0	1	18	0	0
6	4392639	.	C	T	5	7	12	0	0	12	0	0
6	4397173	.	G	A	13	13	26	0	0	26	0	0
6	4397181	.	C	A	15	10	25	0	2	27	0	0
6	4397262	.	C	T	16	11	27	0	0	27	0	0
6	4398906	.	C	T	10	8	18	0	1	19	0	0
6	4398939	.	A	C	17	6	23	0	1	24	0	0
6	4400999	.	C	T	7	9	16	0	0	16	0	0
6	4417007	.	G	A	4	2	6	0	0	6	0	0
6	4531158	.	T	C	3	4	7	0	0	7	0	0
6	4540110	.	A	G	3	0	3	0	3	6	0	0
6	4540115	.	C	A	4	5	9	0	0	9	0	0
6	4540422	.	A	G	5	8	13	0	0	13	0	0
6	4541178	.	T	C	5	6	11	0	0	11	0	0
6	4542260	.	G	A	0	3	3	0	4	7	0	0
6	4542492	.	A	G	2	0	2	0	3	5	0	0
6	4542573	.	A	C	2	6	8	0	1	9	0	0
6	4874563	.	C	T	2	2	4	0	0	4	0	0
6	4875031	.	G	A	0	2	2	0	1	3	0	0
6	4875292	.	C	T	1	3	4	0	0	4	0	0
6	4876522	.	G	C	0	4	4	0	1	5	0	0
6	4876738	.	G	A	8	8	16	0	0	16	0	0
6	4876946	.	C	A	1	3	4	0	1	5	0	0
6	4877023	.	C	T	7	3	10	0	0	10	0	0
6	6231117	.	T	C	3	5	8	0	0	8	0	0
6	6231244	.	T	C	2	4	6	0	0	6	0	0
6	6231321	.	C	A	5	4	9	0	0	9	0	0
6	6231337	.	A	C	6	4	10	0	0	10	0	0
6	6232301	.	A	C	26	26	52	0	1	53	0	0
6	6232315	.	T	C	26	1	27	0	24	51	0	0
6	6234779	.	A	G	18	35	53	0	2	55	0	0
6	6235307	.	G	A	22	21	43	0	2	45	0	0
6	6258045	.	G	C	10	0	10	0	6	16	0	0
6	6258130	.	C	T	5	3	8	0	1	9	0	0
6	6258239	.	C	T	0	3	3	0	4	7	0	0
6	6258240	.	A	G	3	4	7	0	0	7	0	0
6	6270811	.	C	G	1	2	3	0	0	3	0	0
6	6270833	.	T	G	1	3	4	0	0	4	0	0
6	6270882	.	G	C	27	20	47	0	4	51	0	0
6	6273345	.	C	T	34	38	72	0	0	72	0	0
6	6273396	.	C	T	32	24	56	0	1	57	0	0
6	6275574	.	G	A	6	3	9	0	1	10	0	0
6	6275667	.	C	T	5	7	12	0	0	12	0	0
6	6275668	.	A	G	5	7	12	0	0	12	0	0
6	6284114	.	A	G	10	8	18	0	0	18	0	0
6	6293926	.	T	C	3	0	3	0	7	10	0	0
6	6303823	.	C	A	2	2	4	0	1	5	0	0
6	6395035	.	T	G	4	5	9	0	0	9	0	0
6	6395096	.	C	T	0	4	4	0	3	7	0	0
6	6395099	.	C	T	4	3	7	0	0	7	0	0
6	6395211	.	T	A	8	3	11	0	1	12	0	0
6	6395222	.	T	A	8	3	11	0	0	11	0	0
6	6395367	.	C	T	1	9	10	0	3	13	0	0
6	6395405	.	C	T	4	4	8	0	0	8	0	0
6	6459235	.	T	C	5	5	10	0	1	11	0	0
6	6459315	.	G	A	6	4	10	0	0	10	0	0
6	6463633	.	T	G	4	4	8	0	0	8	0	0
6	6466502	.	C	T	2	2	4	0	1	5	0	0
6	6467931	.	C	T	0	3	3	0	6	9	0	0
6	6470529	.	G	A	6	5	11	0	0	11	0	0
6	6470842	.	G	A	3	5	8	0	0	8	0	0
6	6471174	.	C	G	2	3	5	0	0	5	0	0
6	6471486	.	G	A	2	2	4	0	0	4	0	0
6	6477785	.	G	A	6	2	8	0	0	8	0	0
6	6480100	.	T	A	4	5	9	0	0	9	0	0
6	6498842	.	C	T	2	2	4	0	0	4	0	0
6	6498866	.	G	A	0	3	3	0	2	5	0	0
6	6541039	.	C	T	3	2	5	0	0	5	0	0
6	6541128	.	G	A	1	5	6	0	0	6	0	0
6	6665965	.	G	A	2	2	4	0	0	4	0	0
6	6666079	.	C	T	3	3	6	0	0	6	0	0
6	6666313	.	T	C	1	3	4	0	0	4	0	0
6	6666322	.	T	A	2	2	4	0	0	4	0	0
6	6669502	.	C	G	1	2	3	0	0	3	0	0
6	6669743	.	G	A	1	4	5	0	2	7	0	0
6	6671545	.	G	C	6	4	10	0	1	11	0	0
6	6671607	.	C	G	2	4	6	0	1	7	0	0
6	6671769	.	T	A	4	2	6	0	0	6	0	0
6	6673527	.	C	A	1	5	6	0	0	6	0	0
6	6737391	.	C	T	8	15	23	0	0	23	0	0
6	6737401	.	G	T	7	13	20	0	0	20	0	0
6	6737982	.	T	A	16	14	30	0	1	31	0	0
6	6737998	.	C	T	1	19	20	0	15	35	0	0
6	6769345	.	T	A	11	7	18	0	2	20	0	0
6	6769716	.	C	T	12	8	20	0	1	21	0	0
6	6769719	.	T	C	13	6	19	0	1	20	0	0
6	6769782	.	A	G	7	13	20	0	0	20	0	0
6	6775689	.	G	T	8	5	13	0	0	13	0	0
6	6784095	.	G	A	3	3	6	0	0	6	0	0
6	6784239	.	G	C	4	3	7	0	0	7	0	0
6	6785788	.	G	A	2	3	5	0	0	5	0	0
6	6788714	.	A	G	5	0	5	0	3	8	0	0
6	6793164	.	C	T	10	11	21	0	0	21	0	0
6	6793224	.	G	A	2	6	8	0	11	19	0	0
6	6795520	.	T	A	4	9	13	0	1	14	0	0
6	6795526	.	C	T	11	5	16	0	0	16	0	0
6	6795664	.	T	C	6	7	13	0	0	13	0	0
6	6796229	.	G	A	2	3	5	0	1	6	0	0
6	6796263	.	C	T	2	2	4	0	1	5	0	0
6	6796274	.	G	A	2	2	4	0	0	4	0	0
6	6797583	.	A	G	7	6	13	0	0	13	0	0
6	6797598	.	T	C	9	9	18	0	0	18	0	0
6	6797694	.	T	A	8	7	15	0	1	16	0	0
6	6800031	.	G	T	5	4	9	0	0	9	0	0
6	6800107	.	T	A	3	3	6	0	0	6	0	0
6	6803534	.	T	A	10	10	20	0	1	21	0	0
6	6803726	.	T	A	12	9	21	0	2	23	0	0
6	6805245	.	C	T	11	15	26	0	0	26	0	0
6	6805275	.	G	A	10	14	24	0	0	24	0	0
6	6805477	.	T	C	2	5	7	0	0	7	0	0
6	6805572	.	G	T	19	13	32	0	0	32	0	0
6	6806842	.	C	T	1	3	4	0	0	4	0	0
6	6806853	.	C	T	2	2	4	0	1	5	0	0
6	6807004	.	C	T	3	2	5	0	1	6	0	0
6	6807042	.	C	T	2	2	4	0	0	4	0	0
6	6808217	.	A	G	1	2	3	0	0	3	0	0
6	6808431	.	C	G	3	3	6	0	0	6	0	0
6	6900767	.	T	C	5	2	7	0	1	8	0	0
6	6905848	.	G	A	0	5	5	0	2	7	0	0
6	6908699	.	A	G	1	3	4	0	0	4	0	0
6	6916417	.	A	G	9	0	9	0	4	13	0	0
6	6919866	.	G	T	0	8	8	0	7	15	0	0
6	6920171	.	C	T	3	2	5	0	0	5	0	0
6	6920673	.	A	T	10	6	16	1	0	17	0	0
6	6920938	.	G	A	1	3	4	0	1	5	0	0
6	6921577	.	C	T	5	15	20	0	1	21	0	0
6	6921581	.	T	C	5	14	19	0	0	19	0	0
6	6921802	.	G	A	24	16	40	0	0	40	0	0
6	6921889	.	T	A	12	12	24	0	6	30	0	0
6	6922072	.	G	T	7	14	21	0	0	21	0	0
6	6922187	.	T	C	8	6	14	0	1	15	0	0
6	6973009	.	A	T	9	8	17	0	0	17	0	0
6	6973383	.	G	T	8	5	13	19	2	34	0	0
6	6974214	.	T	C	1	2	3	0	0	3	0	0
6	6989883	.	G	A	3	2	5	1	0	6	0	0
6	6990063	.	G	A	2	7	9	10	0	19	0	0
6	7086134	.	G	C	1	3	4	0	0	4	0	0
6	7089952	.	C	G	8	4	12	0	0	12	0	0
6	7105388	.	G	A	5	4	9	0	0	9	0	0
6	7105400	.	C	T	4	2	6	0	1	7	0	0
6	7107034	.	A	G	1	5	6	0	1	7	0	0
6	7107833	.	C	T	5	2	7	0	1	8	0	0
6	7110148	.	C	T	5	8	13	0	1	14	0	0
6	7110434	.	C	T	9	9	18	1	0	19	0	0
6	7110435	.	T	G	9	9	18	1	0	19	0	0
6	7110551	.	C	T	23	18	41	0	1	42	0	0
6	7113001	.	T	G	11	8	19	0	3	22	0	0
6	7114482	.	C	T	16	10	26	0	0	26	0	0
6	7114937	.	A	G	12	15	27	0	1	28	0	0
6	7115967	.	T	C	15	12	27	0	1	28	0	0
6	7118398	.	A	C	2	4	6	0	0	6	0	0
6	7133402	.	C	T	0	2	2	0	2	4	0	0
6	7157615	.	C	T	1	5	6	0	0	6	0	0
6	7157771	.	G	A	3	3	6	0	0	6	0	0
6	7207934	.	G	A	2	4	6	0	0	6	0	0
6	7251362	.	A	T	5	7	12	0	0	12	0	0
6	7251426	.	A	G	5	6	11	0	0	11	0	0
6	7251564	.	G	A	9	6	15	0	0	15	0	0
6	7251627	.	A	G	13	4	17	0	0	17	0	0
6	7251694	.	G	A	7	3	10	0	1	11	0	0
6	7270355	.	T	C	5	8	13	0	0	13	0	0
6	7273005	.	A	G	5	0	5	0	13	18	0	0
6	7273021	.	C	T	7	13	20	0	0	20	0	0
6	7273512	.	T	A	7	3	10	0	2	12	0	0
6	7273518	.	G	A	0	3	3	0	11	14	0	0
6	7276139	.	T	C	4	5	9	0	0	9	0	0
6	7276178	.	T	A	11	11	22	0	1	23	0	0
6	7276212	.	C	T	13	11	24	0	1	25	0	0
6	7276263	.	G	A	2	13	15	0	11	26	0	0
6	7276776	.	A	C	7	5	12	0	0	12	0	0
6	7280175	.	G	A	3	2	5	0	0	5	0	0
6	7280177	.	C	G	4	2	6	0	0	6	0	0
6	7390358	.	A	G	1	0	1	0	2	3	0	0
6	7435565	.	C	T	3	4	7	0	0	7	0	0
6	7438474	.	C	T	4	4	8	0	1	9	0	0
6	7438570	.	G	A	1	2	3	0	0	3	0	0
6	7444930	.	T	C	6	13	19	0	0	19	0	0
6	7451563	.	T	G	14	13	27	0	2	29	0	0
6	7452519	.	T	C	11	10	21	0	1	22	0	0
6	7453379	.	T	G	18	0	18	0	14	32	0	0
6	7453567	.	G	T	14	3	17	0	2	19	0	0
6	7453649	.	C	G	11	11	22	0	1	23	0	0
6	7453660	.	C	T	11	9	20	0	1	21	0	0
6	7531396	.	T	C	1	2	3	0	0	3	0	0
6	7542491	.	G	T	3	11	14	0	7	21	0	0
6	7545794	.	C	T	14	10	24	0	3	27	0	0
6	7545824	.	T	C	11	10	21	0	1	22	0	0
6	7547451	.	C	T	6	6	12	0	0	12	0	0
6	7549967	.	G	A	28	14	42	0	3	45	0	0
6	7550210	.	A	C	14	10	24	0	1	25	0	0
6	7550405	.	C	T	10	18	28	0	3	31	0	0
6	7551087	.	C	A	3	4	7	0	1	8	0	0
6	7555618	.	C	T	3	4	7	0	0	7	0	0
6	7555634	.	G	T	4	2	6	0	0	6	0	0
6	7624725	.	T	C	4	2	6	0	1	7	0	0
6	7626457	.	C	T	4	6	10	0	1	11	0	0
6	7633452	.	G	C	2	11	13	0	11	25	1	0
6	7636811	.	A	T	13	10	23	0	1	24	0	0
6	7637195	.	C	T	13	13	26	0	1	27	0	0
6	7638717	.	G	A	13	10	23	0	1	24	0	0
6	7645319	.	T	C	14	10	24	0	2	26	0	0
6	7646039	.	A	G	14	15	29	0	1	30	0	0
6	7646102	.	G	A	18	17	35	0	1	36	0	0
6	7646111	.	G	C	18	18	36	0	0	36	0	0
6	7648224	.	A	G	14	1	15	1	15	31	0	0
6	7652458	.	C	T	24	17	41	0	3	44	0	0
6	7652470	.	A	C	28	17	45	0	2	47	0	0
6	7652896	.	G	A	1	25	26	0	17	43	0	0
6	7652959	.	C	T	20	26	46	0	1	47	0	0
6	7652989	.	C	T	28	18	46	0	0	46	0	0
6	7656920	.	A	G	27	0	27	1	25	53	0	0
6	7656932	.	A	G	23	29	52	1	2	55	0	0
6	7657077	.	A	C	29	10	39	0	2	41	0	0
6	7657177	.	C	T	15	12	27	0	0	27	0	0
6	7657793	.	A	C	25	13	38	0	0	38	0	0
6	7657886	.	T	A	17	23	40	0	2	42	0	0
6	7657887	.	G	T	18	24	42	0	0	42	0	0
6	7657972	.	T	G	20	9	29	0	2	31	0	0
6	7658076	.	G	A	16	11	27	0	2	29	0	0
6	7659915	.	G	A	4	6	10	0	0	10	0	0
6	7660063	.	C	A	10	3	13	0	0	13	0	0
6	7660119	.	A	G	7	20	27	0	0	27	0	0
6	7660300	.	T	C	5	0	5	0	4	9	0	0
6	7660369	.	T	C	6	5	11	0	0	11	0	0
6	7660458	.	A	C	2	1	3	0	6	9	0	0
6	7660594	.	C	T	6	6	12	0	1	13	0	0
6	7660659	.	C	A	0	5	5	0	2	7	0	0
6	7660707	.	C	T	1	4	5	0	4	9	0	0
6	7679455	.	G	A	3	2	5	0	0	5	0	0
6	7686080	.	G	A	1	2	3	0	0	3	0	0
6	7688598	.	C	T	1	3	4	0	2	6	0	0
6	7688757	.	A	C	2	0	2	0	9	11	0	0
6	7697573	.	G	A	1	4	5	0	1	6	0	0
6	7702770	.	G	T	4	6	10	0	0	10	0	0
6	7705984	.	G	A	3	2	5	0	0	5	0	0
6	7711239	.	G	A	4	2	6	0	0	6	0	0
6	7713433	.	G	A	25	27	52	0	2	54	0	0
6	7721530	.	T	A	4	9	13	0	0	13	0	0
6	7721860	.	G	A	12	5	17	0	1	18	0	0
6	7721906	.	G	A	10	16	26	0	0	26	0	0
6	7721958	.	C	A	12	15	27	0	0	27	0	0
6	7722143	.	G	T	21	14	35	0	1	36	0	0
6	7722159	.	A	T	22	15	37	0	1	38	0	0
6	7722195	.	G	T	13	10	23	0	1	24	0	0
6	7722205	.	G	A	14	9	23	0	1	24	0	0
6	7722333	.	G	A	8	10	18	1	3	22	0	0
6	7722402	.	T	C	12	8	20	0	1	21	0	0
6	7722577	.	C	T	0	16	16	0	9	25	0	0
6	7722625	.	T	C	20	8	28	0	1	29	0	0
6	7722921	.	A	T	2	6	8	0	0	8	0	0
6	7723008	.	G	T	9	5	14	0	1	15	0	0
6	7723155	.	A	C	9	9	18	0	1	19	0	0
6	7723232	.	A	T	7	9	16	0	0	16	0	0
6	7723850	.	C	T	2	6	8	0	9	17	0	0
6	7723961	.	G	A	13	7	20	0	1	21	0	0
6	7726824	.	G	A	13	8	21	0	1	22	0	0
6	7734250	.	A	C	4	4	8	0	1	9	0	0
6	7734271	.	C	A	5	2	7	0	1	8	0	0
6	7745825	.	C	T	2	2	4	0	0	4	0	0
6	7795698	.	C	T	19	12	31	1	4	36	0	0
6	7842013	.	C	T	1	3	4	0	8	12	0	0
6	7842034	.	C	A	7	5	12	0	0	12	0	0
6	8176101	.	A	G	2	3	5	0	0	5	0	0
6	8176575	.	C	T	5	4	9	0	0	9	0	0
6	8177030	.	T	C	9	11	20	0	0	20	0	0
6	8177399	.	T	C	7	3	10	0	0	10	0	0
6	8177600	.	T	C	11	7	18	0	2	20	0	0
6	8177678	.	C	T	8	9	17	0	1	18	0	0
6	8178002	.	T	C	15	11	26	0	2	28	0	0
6	8178053	.	G	A	1	11	12	0	8	20	0	0
6	8178113	.	T	C	14	9	23	0	2	25	0	0
6	8178351	.	G	A	11	8	19	0	2	21	0	0
6	8179022	.	G	T	2	19	21	0	16	37	0	0
6	8179205	.	A	T	14	11	25	0	2	28	1	0
6	8179373	.	G	A	18	10	28	0	1	29	0	0
6	8179683	.	A	T	1	5	6	0	1	7	0	0
6	8210334	.	A	G	1	2	3	0	0	3	0	0
6	8210902	.	C	G	1	2	3	0	0	3	0	0
6	8211075	.	C	T	6	3	9	0	0	9	0	0
6	8211106	.	T	C	4	2	6	0	1	7	0	0
6	8211253	.	G	A	4	4	8	0	0	8	0	0
6	8212174	.	G	A	6	3	9	0	1	10	0	0
6	8214044	.	G	A	3	8	11	0	0	11	0	0
6	8214045	.	T	G	3	8	11	0	0	11	0	0
6	8214118	.	T	C	4	3	7	0	1	8	0	0
6	8214947	.	T	C	2	0	2	0	3	5	0	0
6	8217870	.	G	A	1	2	3	0	1	4	0	0
6	8265282	.	G	A	7	6	13	0	0	13	0	0
6	8267111	.	C	T	17	17	34	0	0	34	0	0
6	8267266	.	A	G	14	15	29	0	2	31	0	0
6	8267284	.	G	A	13	18	31	0	0	31	0	0
6	8267307	.	G	C	14	11	25	0	0	27	2	0
6	8267352	.	A	T	10	19	29	0	3	32	0	0
6	8267519	.	G	A	23	18	41	0	2	43	0	0
6	8267563	.	G	T	24	14	38	0	1	39	0	0
6	8267635	.	T	C	15	21	36	0	1	37	0	0
6	8267795	.	T	A	14	4	18	0	1	19	0	0
6	8267880	.	G	A	12	14	26	0	0	26	0	0
6	8268529	.	A	G	11	8	19	0	0	19	0	0
6	8273066	.	G	A	7	5	12	0	1	13	0	0
6	8277141	.	C	A	6	3	9	0	0	9	0	0
6	8315076	.	A	G	5	9	14	0	1	15	0	0
6	8315078	.	A	G	6	9	15	0	0	15	0	0
6	8316947	.	A	G	3	8	11	0	0	11	0	0
6	8318001	.	T	C	8	5	13	0	1	14	0	0
6	8318037	.	G	A	0	11	11	0	8	19	0	0
6	8328181	.	G	T	6	14	20	0	3	23	0	0
6	8366006	.	A	T	6	7	13	0	1	14	0	0
6	8366167	.	C	T	19	11	30	1	2	33	0	0
6	8370489	.	T	C	14	9	23	0	2	25	0	0
6	8374716	.	G	A	3	6	9	0	0	9	0	0
6	8375089	.	C	T	16	5	21	0	2	23	0	0
6	8380345	.	G	A	5	7	12	0	0	12	0	0
6	8380433	.	G	C	7	5	12	0	0	12	0	0
6	8380485	.	G	T	4	3	7	0	0	7	0	0
6	8391629	.	C	T	0	10	10	0	7	17	0	0
6	8392005	.	G	A	5	7	12	0	1	13	0	0
6	8454024	.	G	A	2	3	5	0	0	5	0	0
6	8455483	.	T	C	1	0	1	0	3	4	0	0
6	8457125	.	T	C	2	3	5	0	1	6	0	0
6	8465662	.	A	G	2	3	5	0	0	5	0	0
6	8501017	.	A	G	1	2	3	0	1	4	0	0
6	9130575	.	A	G	4	10	14	0	1	15	0	0
6	9130579	.	A	G	10	0	10	0	5	15	0	0
6	9372376	.	T	C	1	4	5	0	0	5	0	0
6	9997665	.	A	C	8	5	13	0	20	33	0	0
6	10008329	.	G	A	1	15	16	0	18	34	0	0
6	10008398	.	A	G	27	11	38	0	2	40	0	0
6	10008407	.	C	T	25	12	37	0	0	37	0	0
6	10009850	.	C	T	14	23	37	0	2	39	0	0
6	10009903	.	A	T	22	20	42	0	2	44	0	0
6	10015551	.	T	C	8	8	16	0	1	17	0	0
6	10015602	.	T	C	34	14	48	0	0	48	0	0
6	10015794	.	A	T	41	22	63	1	5	69	0	0
6	10015902	.	A	T	36	23	59	0	1	60	0	0
6	10015952	.	C	A	37	25	62	0	2	64	0	0
6	10015992	.	A	C	36	30	66	0	2	68	0	0
6	10015993	.	G	A	35	31	66	0	2	68	0	0
6	10016114	.	C	T	36	29	65	0	4	69	0	0
6	10016116	.	C	A	36	29	65	0	4	69	0	0
6	10016174	.	T	G	44	22	66	1	15	82	0	0
6	10016363	.	T	G	35	23	58	3	4	77	12	0
6	10020055	.	G	A	28	29	57	0	3	60	0	0
6	10026677	.	C	T	21	28	49	0	2	51	0	0
6	10026818	.	G	A	8	2	10	0	2	12	0	0
6	10029217	.	G	C	6	0	6	0	4	10	0	0
6	10029332	.	G	A	3	2	5	0	0	5	0	0
6	10032925	.	T	G	3	3	6	0	0	6	0	0
6	10032932	.	C	T	3	3	6	0	0	6	0	0
6	10033015	.	G	A	2	4	6	0	0	6	0	0
6	10034079	.	C	T	3	1	4	0	1	5	0	0
6	10045449	.	G	T	13	10	23	0	1	24	0	0
6	10047204	.	T	C	10	7	17	0	3	20	0	0
6	10047805	.	G	A	13	14	27	0	0	27	0	0
6	10047814	.	T	C	10	15	25	0	2	27	0	0
6	10050050	.	G	A	18	14	32	0	0	32	0	0
6	10056466	.	G	T	20	14	34	0	3	37	0	0
6	10087683	.	C	A	2	2	4	0	0	4	0	0
6	10248476	.	T	A	12	11	23	0	2	25	0	0
6	10248530	.	A	G	11	8	19	0	3	22	0	0
6	10248546	.	T	C	13	0	13	0	7	20	0	0
6	10248596	.	T	C	18	8	26	0	1	27	0	0
6	10248980	.	A	G	6	6	12	0	1	13	0	0
6	10249451	.	A	G	7	10	17	0	1	18	0	0
6	10251188	.	C	A	9	10	19	0	1	20	0	0
6	10257886	.	A	G	3	3	6	0	1	7	0	0
6	10264656	.	T	C	6	0	6	0	3	9	0	0
6	10283462	.	A	G	4	2	6	0	1	7	0	0
6	10288855	.	A	G	6	3	9	0	0	9	0	0
6	10305813	.	T	G	5	2	7	0	0	7	0	0
6	10305821	.	A	G	4	2	6	0	0	6	0	0
6	10305922	.	G	A	4	2	6	0	0	6	0	0
6	10354469	.	T	C	2	2	4	0	1	5	0	0
6	10512858	.	C	T	2	2	4	0	0	4	0	0
6	10512903	.	C	G	2	2	4	0	1	5	0	0
6	10513182	.	C	G	2	4	6	0	0	6	0	0
6	10522332	.	C	T	5	4	9	0	0	9	0	0
6	10534898	.	T	C	5	2	7	0	0	7	0	0
6	10540300	.	A	T	1	2	3	0	0	3	0	0
6	10547409	.	C	T	2	2	4	0	0	4	0	0
6	10547556	.	T	C	1	2	3	0	1	4	0	0
6	10564408	.	C	T	2	3	5	0	0	5	0	0
6	10564426	.	T	C	3	3	6	0	0	6	0	0
6	10567861	.	C	T	1	8	9	0	0	9	0	0
6	10570843	.	C	T	4	4	8	0	1	9	0	0
6	10576573	.	A	G	5	0	5	0	4	9	0	0
6	10701627	.	C	T	5	5	10	0	2	12	0	0
6	10701642	.	C	A	0	6	6	0	5	11	0	0
6	10702203	.	T	C	4	0	4	0	5	9	0	0
6	10702244	.	T	C	4	0	4	0	3	7	0	0
6	10702269	.	T	A	1	2	3	0	0	3	0	0
6	10713784	.	G	A	3	4	7	0	1	8	0	0
6	10713810	.	G	T	1	3	4	0	1	5	0	0
6	10721767	.	C	T	22	0	22	0	0	22	0	0
6	10721971	.	T	G	8	11	19	0	0	19	0	0
6	10722541	.	G	A	13	11	24	0	0	24	0	0
6	10724275	.	G	A	6	5	11	0	0	11	0	0
6	10724336	.	C	T	1	11	12	0	8	20	0	0
6	10724591	.	G	T	15	6	21	0	3	24	0	0
6	10724645	.	A	T	10	6	16	0	0	16	0	0
6	10724665	.	G	A	7	6	13	0	0	13	0	0
6	10724765	.	G	A	8	8	16	0	0	16	0	0
6	10725365	.	T	C	2	0	2	0	3	5	0	0
6	10728256	.	G	C	1	2	3	0	0	3	0	0
6	10736746	.	C	T	0	4	4	0	1	5	0	0
6	10736760	.	A	C	1	3	4	0	0	4	0	0
6	10741694	.	G	A	4	2	6	0	0	6	0	0
6	10741853	.	T	G	3	2	5	0	0	5	0	0
6	10741916	.	G	C	7	7	14	0	0	14	0	0
6	10742120	.	T	C	21	23	44	0	1	45	0	0
6	10742121	.	G	A	21	23	44	0	1	45	0	0
6	10742306	.	A	G	19	30	49	0	1	50	0	0
6	10742318	.	G	A	29	19	48	0	2	50	0	0
6	10742497	.	T	C	29	0	29	0	18	48	1	0
6	10751216	.	G	A	9	8	17	1	0	18	0	0
6	10758866	.	A	T	4	4	8	0	0	8	0	0
6	10758890	.	A	C	8	0	8	0	3	11	0	0
6	10763977	.	A	G	1	5	6	0	0	6	0	0
6	10764001	.	A	G	1	8	9	0	0	9	0	0
6	10776227	.	A	T	1	3	4	0	0	4	0	0
6	10780694	.	A	G	1	5	6	0	0	6	0	0
6	10782960	.	C	G	1	3	4	0	1	5	0	0
6	10787952	.	G	A	1	2	3	0	0	3	0	0
6	10831093	.	G	A	36	21	57	1	10	68	0	0
6	10833078	.	T	C	29	0	29	0	27	56	0	0
6	10834821	.	G	C	29	28	57	0	1	58	0	0
6	10835676	.	G	A	2	2	4	0	1	5	0	0
6	10835700	.	T	A	2	2	4	0	2	6	0	0
6	10835721	.	A	G	2	3	5	0	0	5	0	0
6	10835788	.	G	A	7	3	10	0	1	11	0	0
6	10839332	.	A	G	4	4	8	0	1	9	0	0
6	10839885	.	C	A	2	12	14	0	12	26	0	0
6	10846001	.	G	A	21	9	30	0	0	30	0	0
6	10858734	.	C	T	11	6	17	0	0	17	0	0
6	10858747	.	T	C	9	6	15	0	0	15	0	0
6	10859011	.	G	A	5	3	8	0	0	8	0	0
6	10863599	.	T	C	4	4	8	0	1	9	0	0
6	10863617	.	T	C	1	2	3	0	1	4	0	0
6	10872687	.	T	C	13	13	26	0	1	27	0	0
6	10877269	.	A	G	17	17	34	0	3	37	0	0
6	10879525	.	T	C	24	17	41	0	1	42	0	0
6	10879633	.	T	C	20	12	32	0	4	36	0	0
6	10879679	.	G	A	17	15	32	0	1	33	0	0
6	10879816	.	A	T	10	16	26	0	2	28	0	0
6	10879833	.	A	G	10	1	11	0	18	29	0	0
6	10910684	.	G	A	1	7	8	0	3	11	0	0
6	10910784	.	C	A	27	16	43	0	1	44	0	0
6	10911066	.	T	C	22	25	47	0	2	49	0	0
6	10911198	.	A	G	36	34	70	0	3	74	1	0
6	10912341	.	G	A	27	19	46	0	1	47	0	0
6	10982902	.	A	G	1	2	3	0	1	4	0	0
6	10983337	.	T	A	2	1	3	0	1	4	0	0
6	10983433	.	A	C	3	7	10	0	0	10	0	0
6	11070530	.	A	T	37	17	54	0	3	57	0	0
6	11071222	.	A	G	25	26	51	1	2	54	0	0
6	11101781	.	T	C	7	7	14	0	1	15	0	0
6	11101790	.	C	T	1	7	8	0	6	14	0	0
6	11101852	.	G	A	8	10	18	0	0	18	0	0
6	11106924	.	C	G	2	4	6	0	0	6	0	0
6	11107167	.	G	C	7	0	7	0	3	10	0	0
6	11107233	.	C	A	4	3	7	0	0	7	0	0
6	11107326	.	T	C	2	0	2	0	3	5	0	0
6	11120420	.	G	A	1	2	3	0	0	3	0	0
6	11122579	.	A	G	2	5	7	0	0	7	0	0
6	11122682	.	T	C	3	0	3	0	3	6	0	0
6	11129105	.	C	T	3	3	6	0	0	6	0	0
6	11250427	.	A	T	6	3	9	0	4	13	0	0
6	11250462	.	C	T	4	5	9	0	1	10	0	0
6	11250973	.	T	C	2	4	6	0	0	6	0	0
6	11252838	.	C	A	6	6	12	0	0	12	0	0
6	11253881	.	T	C	4	5	9	0	1	10	0	0
6	11253890	.	C	T	4	7	11	0	0	11	0	0
6	11254142	.	T	G	10	0	10	0	5	15	0	0
6	11254358	.	A	G	3	0	3	0	6	9	0	0
6	11254526	.	C	T	11	5	16	0	0	16	0	0
6	11257827	.	G	A	1	12	13	0	15	28	0	0
6	11257866	.	G	C	1	17	18	0	11	29	0	0
6	11257917	.	T	A	18	14	32	0	1	33	0	0
6	11259970	.	C	A	22	12	34	0	0	34	0	0
6	11265612	.	G	T	3	14	17	0	18	35	0	0
6	11265681	.	T	A	20	10	30	0	0	30	0	0
6	11265717	.	T	C	23	15	38	0	1	39	0	0
6	11266255	.	C	T	18	20	38	0	2	40	0	0
6	11266490	.	A	T	7	5	12	0	0	12	0	0
6	11266496	.	T	C	4	5	9	0	2	11	0	0
6	11276827	.	T	A	2	2	4	0	0	4	0	0
6	11276912	.	A	G	8	6	14	0	0	14	0	0
6	11281923	.	A	G	4	6	10	0	0	10	0	0
6	11282371	.	A	T	2	5	7	0	1	8	0	0
6	11285310	.	C	T	4	2	6	0	0	6	0	0
6	11285362	.	T	C	6	0	6	0	4	10	0	0
6	11285374	.	C	T	6	3	9	0	0	9	0	0
6	11285453	.	T	C	12	5	17	0	2	19	0	0
6	11285583	.	C	T	3	8	11	0	0	11	0	0
6	11285662	.	C	T	1	2	3	0	7	10	0	0
6	11285716	.	G	A	4	7	11	0	0	11	0	0
6	11285772	.	C	T	4	5	9	0	0	9	0	0
6	11287918	.	C	G	1	6	7	0	0	7	0	0
6	11288179	.	T	A	5	2	7	0	0	7	0	0
6	11288265	.	T	G	3	5	8	0	0	8	0	0
6	11288460	.	G	T	4	3	7	0	1	8	0	0
6	11288558	.	T	C	1	0	1	0	5	6	0	0
6	11292023	.	A	G	1	3	4	0	1	5	0	0
6	11295408	.	T	G	1	3	4	0	0	4	0	0
6	11295430	.	G	T	3	3	6	0	0	6	0	0
6	11295484	.	G	A	3	4	7	0	0	7	0	0
6	11295616	.	T	G	2	5	7	0	1	8	0	0
6	11299643	.	C	T	4	4	8	0	0	8	0	0
6	11299909	.	C	T	2	3	5	0	0	6	1	0
6	11303424	.	T	G	2	2	4	0	0	4	0	0
6	11309502	.	C	T	0	3	3	0	2	5	0	0
6	11316644	.	C	T	3	2	5	0	0	5	0	0
6	11316654	.	A	G	3	2	5	0	0	5	0	0
6	11320584	.	C	T	0	3	3	0	1	4	0	0
6	11326973	.	G	A	2	2	4	0	0	4	0	0
6	11330758	.	C	T	4	2	6	0	0	6	0	0
6	11330918	.	T	A	3	3	6	0	0	6	0	0
6	11330927	.	C	T	0	5	5	0	2	7	0	0
6	11397818	.	G	C	0	7	7	0	3	10	0	0
6	11398324	.	G	T	8	5	13	0	1	14	0	0
6	11403359	.	C	A	10	11	21	0	3	24	0	0
6	11407918	.	G	A	10	10	20	0	0	20	0	0
6	11407944	.	A	G	12	11	23	0	2	25	0	0
6	11407954	.	A	G	14	10	24	0	1	25	0	0
6	11410523	.	C	T	13	8	21	0	0	21	0	0
6	11413532	.	A	T	8	8	16	0	1	17	0	0
6	11414715	.	C	T	6	7	13	0	1	14	0	0
6	11414748	.	G	A	6	8	14	0	0	14	0	0
6	11414777	.	A	T	5	6	11	0	0	11	0	0
6	11414822	.	T	G	7	0	7	0	4	11	0	0
6	11415220	.	A	C	18	15	33	0	2	35	0	0
6	11415460	.	G	A	1	10	11	0	6	17	0	0
6	11504470	.	G	A	5	2	7	0	0	7	0	0
6	11512622	.	C	T	1	2	3	0	0	3	0	0
6	11540362	.	T	C	3	5	8	0	1	9	0	0
6	11765506	.	A	G	22	23	45	0	3	48	0	0
6	11766190	.	T	A	11	21	32	0	0	32	0	0
6	11766267	.	G	A	25	14	39	0	3	42	0	0
6	11766276	.	A	G	25	16	41	0	3	44	0	0
6	11766765	.	T	C	19	21	40	0	2	42	0	0
6	11829902	.	C	T	5	2	7	0	0	7	0	0
6	12504230	.	T	C	4	5	9	0	0	9	0	0
6	12504392	.	G	C	3	3	6	0	0	6	0	0
6	12529163	.	C	T	8	9	17	0	2	19	0	0
6	12529247	.	C	T	8	6	14	0	1	15	0	0
6	12550437	.	G	A	10	18	28	0	1	29	0	0
6	12550764	.	G	A	7	4	11	0	2	13	0	0
6	12550934	.	C	T	15	15	30	0	1	31	0	0
6	12627321	.	T	A	4	3	7	0	0	7	0	0
6	12629345	.	T	C	1	2	3	0	1	4	0	0
6	12797755	.	G	A	11	7	18	0	2	20	0	0
6	12797815	.	A	G	9	14	23	0	0	23	0	0
6	12798345	.	T	C	3	6	9	0	1	10	0	0
6	12803257	.	C	A	3	5	8	0	0	8	0	0
6	12803325	.	A	G	3	4	7	0	1	8	0	0
6	12803568	.	A	G	9	3	12	0	0	12	0	0
6	12803598	.	T	C	6	3	9	0	0	9	0	0
6	12803664	.	G	A	4	3	7	0	0	7	0	0
6	12803790	.	A	G	10	3	13	0	0	13	0	0
6	12803919	.	C	G	3	5	8	0	0	8	0	0
6	12804024	.	A	T	7	2	9	0	1	10	0	0
6	12804132	.	G	A	5	4	9	0	0	9	0	0
6	13506931	.	G	C	1	4	5	0	0	5	0	0
6	13509296	.	C	T	4	4	8	0	0	8	0	0
6	13510493	.	G	A	4	3	7	0	0	7	0	0
6	13510565	.	T	C	2	9	11	0	0	11	0	0
6	13513936	.	C	T	3	3	6	0	0	6	0	0
6	13513962	.	A	G	1	3	4	0	0	4	0	0
6	13700485	.	G	A	2	2	4	0	0	4	0	0
6	13734266	.	G	A	2	4	6	0	1	7	0	0
6	13734439	.	C	T	2	6	8	0	2	10	0	0
6	13743317	.	G	A	24	32	56	0	0	56	0	0
6	13743753	.	T	C	30	22	52	0	4	56	0	0
6	13743923	.	C	T	31	34	65	0	3	68	0	0
6	13744099	.	C	T	41	28	69	1	1	71	0	0
6	13746346	.	T	A	6	3	9	0	0	9	0	0
6	13806522	.	C	T	10	8	18	0	1	19	0	0
6	13862171	.	C	T	9	6	15	0	1	16	0	0
6	13862576	.	A	C	16	16	32	0	1	33	0	0
6	13866551	.	G	A	21	17	38	0	3	41	0	0
6	13868823	.	A	G	25	17	42	0	1	43	0	0
6	13868850	.	A	T	19	18	37	0	3	42	2	0
6	13869608	.	C	T	15	21	36	0	3	39	0	0
6	13871812	.	C	G	0	3	3	0	1	4	0	0
6	13873193	.	T	C	2	4	6	0	0	6	0	0
6	13897552	.	G	A	4	2	6	0	0	6	0	0
6	13897624	.	C	G	3	0	3	0	4	7	0	0
6	13901255	.	A	T	3	5	8	0	0	8	0	0
6	13901312	.	C	T	5	7	12	0	0	12	0	0
6	13901517	.	T	C	2	4	6	0	0	6	0	0
6	13901538	.	G	C	1	6	7	0	1	8	0	0
6	13901604	.	T	C	3	6	9	0	0	9	0	0
6	13903413	.	T	C	3	5	8	0	0	8	0	0
6	13907856	.	T	A	5	8	13	0	0	13	0	0
6	13908633	.	G	A	0	15	15	0	3	18	0	0
6	13914821	.	T	C	6	10	16	0	0	16	0	0
6	13914824	.	G	A	6	9	15	0	0	15	0	0
6	13920194	.	A	G	6	3	9	0	1	10	0	0
6	13920275	.	T	G	4	2	6	0	0	6	0	0
6	13941729	.	C	A	12	9	21	0	1	22	0	0
6	13967038	.	A	T	9	14	23	0	0	23	0	0
6	13967328	.	G	A	17	7	24	0	4	28	0	0
6	13967512	.	C	A	17	16	33	0	3	43	7	0
6	13977080	.	T	A	21	16	37	0	2	39	0	0
6	13977567	.	G	T	13	24	37	0	3	40	0	0
6	13977588	.	C	T	13	29	42	0	1	43	0	0
6	13977648	.	G	A	14	16	30	0	1	31	0	0
6	13987287	.	G	C	23	10	33	0	0	33	0	0
6	13987299	.	A	T	22	14	36	0	5	41	0	0
6	13987346	.	C	T	14	13	27	0	1	28	0	0
6	13987560	.	T	C	13	17	30	0	0	30	0	0
6	13987631	.	G	A	20	25	45	0	2	47	0	0
6	13987663	.	T	A	14	26	40	0	1	41	0	0
6	13987710	.	G	A	17	15	32	0	0	32	0	0
6	13987713	.	T	G	14	16	30	0	1	31	0	0
6	13993783	.	A	T	3	3	6	0	0	6	0	0
6	14032693	.	T	C	28	8	36	0	1	37	0	0
6	14032698	.	T	A	28	7	35	0	1	36	0	0
6	14032739	.	G	A	18	14	32	0	0	32	0	0
6	14033030	.	G	T	11	8	19	0	1	20	0	0
6	14033167	.	G	A	18	17	35	0	1	36	0	0
6	14033556	.	T	A	11	6	17	0	4	21	0	0
6	14033836	.	G	C	11	11	22	0	0	22	0	0
6	14034887	.	G	C	13	12	25	0	2	27	0	0
6	14034907	.	C	T	0	14	14	0	14	28	0	0
6	14034949	.	G	A	11	11	22	0	2	24	0	0
6	14038506	.	T	A	4	5	9	0	0	9	0	0
6	14086810	.	T	C	22	28	50	0	2	52	0	0
6	14086901	.	G	T	29	22	51	0	5	56	0	0
6	14086942	.	G	C	25	27	52	0	1	53	0	0
6	14087182	.	C	A	26	25	51	0	3	54	0	0
6	14087220	.	T	A	26	21	47	0	3	50	0	0
6	14087569	.	T	G	24	26	50	0	1	51	0	0
6	14087641	.	A	C	32	26	58	0	3	61	0	0
6	14087883	.	T	C	23	11	34	0	0	34	0	0
6	14088095	.	C	T	25	21	46	0	5	51	0	0
6	14092942	.	T	A	19	26	45	0	4	49	0	0
6	14096684	.	C	T	1	19	20	0	19	39	0	0
6	14098760	.	C	T	1	21	22	0	25	47	0	0
6	14105071	.	G	T	18	22	40	0	0	40	0	0
6	14173159	.	C	A	5	6	11	0	0	11	0	0
6	14173599	.	A	G	3	5	8	0	2	10	0	0
6	14173641	.	G	A	7	9	16	0	1	17	0	0
6	14191637	.	A	G	3	6	9	0	0	9	0	0
6	14191709	.	T	C	1	0	1	0	6	7	0	0
6	14209151	.	C	T	2	4	6	0	2	8	0	0
6	14209674	.	A	G	2	4	6	0	0	6	0	0
6	14212352	.	G	A	2	4	6	0	0	6	0	0
6	14212370	.	G	A	1	4	5	0	0	5	0	0
6	14212430	.	T	G	1	4	5	0	0	5	0	0
6	14220145	.	G	T	3	3	6	0	0	6	0	0
6	14950538	.	T	A	9	3	12	0	1	13	0	0
6	14950567	.	T	C	9	3	12	0	0	12	0	0
6	14950759	.	T	C	11	6	17	0	0	17	0	0
6	14951854	.	C	T	14	15	29	0	3	32	0	0
6	14952579	.	T	C	21	10	31	0	1	32	0	0
6	14988559	.	G	T	7	6	13	0	1	14	0	0
6	15000149	.	C	T	4	6	10	0	0	10	0	0
6	15027643	.	G	C	2	1	3	0	1	4	0	0
6	15027652	.	C	T	2	2	4	0	0	4	0	0
6	15037258	.	A	G	4	2	6	0	0	6	0	0
6	15042303	.	A	T	2	1	3	0	2	5	0	0
6	15043728	.	T	G	1	3	4	0	0	4	0	0
6	15043738	.	C	T	1	3	4	0	0	4	0	0
6	15059249	.	A	G	1	3	4	0	0	4	0	0
6	15059283	.	T	C	1	3	4	0	0	4	0	0
6	15127591	.	G	A	1	5	6	0	5	11	0	0
6	15130921	.	G	A	3	7	10	0	0	10	0	0
6	15130982	.	G	A	0	4	4	0	5	9	0	0
6	15235960	.	A	C	2	2	4	0	0	4	0	0
6	15236344	.	G	A	5	2	7	0	0	7	0	0
6	15242287	.	A	T	6	4	10	0	0	10	0	0
6	15242641	.	C	T	3	6	9	0	1	10	0	0
6	15243129	.	T	C	1	3	4	0	0	4	0	0
6	15243137	.	A	C	2	2	4	0	0	4	0	0
6	15434544	.	T	A	6	18	24	0	0	24	0	0
6	15447086	.	C	T	1	2	3	0	0	3	0	0
6	15447143	.	T	C	1	4	5	0	1	6	0	0
6	15447165	.	A	G	2	0	2	0	3	5	0	0
6	15455804	.	C	A	1	3	4	0	1	5	0	0
6	15459617	.	C	T	0	3	3	0	4	7	0	0
6	15470505	.	A	G	3	2	5	0	0	5	0	0
6	15527107	.	A	G	3	5	8	0	0	8	0	0
6	15527202	.	T	C	3	6	9	0	2	11	0	0
6	15527356	.	T	C	2	5	7	0	0	7	0	0
6	15527385	.	G	A	3	4	7	0	0	7	0	0
6	15531697	.	G	A	4	7	11	0	0	11	0	0
6	15541015	.	G	A	7	7	14	0	0	14	0	0
6	15541077	.	T	C	3	9	12	0	0	12	0	0
6	15543451	.	C	T	9	5	14	0	0	14	0	0
6	15548966	.	A	G	7	6	13	0	1	14	0	0
6	15604133	.	C	T	1	3	4	0	1	5	0	0
6	15752298	.	A	C	6	0	6	0	4	10	0	0
6	15752348	.	A	G	6	4	10	0	1	11	0	0
6	15752489	.	C	T	5	6	11	0	0	11	0	0
6	15892844	.	G	A	4	3	7	0	0	7	0	0
6	16031714	.	C	T	1	3	4	0	1	5	0	0
6	16033239	.	A	G	3	4	7	0	0	7	0	0
6	16043950	.	C	T	2	14	16	0	11	27	0	0
6	16043980	.	A	G	11	15	26	0	0	26	0	0
6	16044019	.	T	C	20	0	20	0	17	37	0	0
6	16044597	.	C	T	13	10	23	0	2	25	0	0
6	16044664	.	T	C	17	17	34	0	1	35	0	0
6	16045413	.	T	C	10	10	20	0	0	20	0	0
6	16045463	.	G	C	12	0	12	0	15	27	0	0
6	16045511	.	G	A	15	15	30	0	0	30	0	0
6	16045650	.	G	A	7	7	14	0	1	15	0	0
6	16045884	.	A	G	18	12	30	0	1	31	0	0
6	16045912	.	T	C	13	0	13	0	23	36	0	0
6	16045946	.	A	C	12	18	30	2	5	37	0	0
6	16045947	.	A	T	14	17	31	2	4	37	0	0
6	16046025	.	T	A	18	12	30	0	0	30	0	0
6	16046049	.	G	T	14	11	25	0	1	28	2	0
6	16046110	.	T	C	17	10	27	0	3	30	0	0
6	16046115	.	T	C	9	20	29	0	1	30	0	0
6	16046272	.	G	T	11	9	20	0	0	20	0	0
6	16046365	.	G	A	8	7	15	1	2	18	0	0
6	16046371	.	A	T	10	5	15	1	1	17	0	0
6	16046664	.	A	G	5	7	12	0	0	12	0	0
6	16046676	.	G	A	10	5	15	0	0	15	0	0
6	16046850	.	G	A	7	9	16	0	0	16	0	0
6	16047197	.	C	T	1	10	11	0	13	24	0	0
6	16084168	.	T	C	6	2	8	0	0	8	0	0
6	16104448	.	G	T	5	12	17	0	1	18	0	0
6	16129824	.	G	T	7	3	10	0	0	10	0	0
6	16135963	.	C	T	4	5	9	0	0	9	0	0
6	16135966	.	C	T	5	4	9	0	0	9	0	0
6	16162994	.	G	A	7	4	11	0	1	12	0	0
6	16169641	.	G	A	9	3	12	0	1	13	0	0
6	16196326	.	G	A	4	3	7	0	0	7	0	0
6	16393518	.	G	A	3	5	8	0	0	8	0	0
6	16393570	.	G	T	4	2	6	0	0	7	1	0
6	16394244	.	A	G	2	4	6	0	0	6	0	0
6	16406047	.	C	T	3	2	5	0	0	5	0	0
6	16406056	.	A	G	2	2	4	0	1	5	0	0
6	16474853	.	T	C	2	2	4	0	0	4	0	0
6	16474879	.	T	C	4	2	6	0	0	6	0	0
6	16474948	.	T	C	8	5	13	0	0	13	0	0
6	16475047	.	T	A	9	11	20	0	1	21	0	0
6	16475499	.	G	A	5	4	9	0	0	9	0	0
6	16475502	.	G	T	5	3	8	0	0	8	0	0
6	16475559	.	T	A	3	4	7	0	0	7	0	0
6	16475582	.	G	T	2	5	7	0	0	7	0	0
6	16475728	.	G	A	0	10	10	0	4	14	0	0
6	16485073	.	A	T	24	17	41	0	0	41	0	0
6	16493381	.	A	T	21	17	38	0	0	38	0	0
6	16499206	.	G	A	7	9	16	0	1	17	0	0
6	16499312	.	A	G	7	0	7	0	8	15	0	0
6	16499422	.	A	G	5	4	9	0	0	9	0	0
6	16521166	.	C	A	3	2	5	0	0	5	0	0
6	16523647	.	A	G	2	4	6	0	0	6	0	0
6	16523662	.	C	T	1	3	4	0	4	8	0	0
6	16523788	.	G	A	2	2	4	0	0	4	0	0
6	16524618	.	C	G	3	7	10	0	0	10	0	0
6	16524653	.	G	A	2	5	7	0	0	7	0	0
6	16524663	.	T	C	2	4	6	0	1	7	0	0
6	16535731	.	G	C	1	2	3	0	0	3	0	0
6	16545661	.	A	G	3	4	7	0	1	8	0	0
6	16586221	.	C	T	1	2	3	0	1	4	0	0
6	16589347	.	C	T	2	3	5	0	0	5	0	0
6	16673924	.	C	T	1	4	5	0	0	5	0	0
6	16674296	.	A	G	9	7	16	0	1	17	0	0
6	16674344	.	T	A	16	9	25	1	6	32	0	0
6	16674371	.	T	C	12	9	21	1	8	30	0	0
6	16674435	.	A	C	13	9	22	0	3	25	0	0
6	16674618	.	G	A	14	12	26	0	2	28	0	0
6	16674808	.	T	C	12	11	23	0	2	25	0	0
6	16683385	.	T	C	11	20	31	0	2	33	0	0
6	16683421	.	A	G	13	16	29	0	2	32	1	0
6	16684004	.	A	G	7	6	13	0	1	14	0	0
6	16687429	.	C	A	11	8	19	0	4	23	0	0
6	16687432	.	T	A	12	10	22	0	0	22	0	0
6	16688900	.	T	C	7	9	16	0	1	17	0	0
6	16688921	.	A	G	11	7	18	0	0	18	0	0
6	16689416	.	T	A	2	2	4	0	0	4	0	0
6	16695994	.	A	C	2	4	6	0	0	6	0	0
6	16696083	.	C	T	4	2	6	0	1	7	0	0
6	16699626	.	C	G	3	3	6	0	0	6	0	0
6	17726078	.	G	A	4	3	7	0	4	11	0	0
6	17770073	.	C	G	1	6	7	0	0	7	0	0
6	17886558	.	A	G	1	1	2	0	1	3	0	0
6	18078439	.	G	A	2	5	7	0	0	7	0	0
6	18203842	.	G	A	17	19	36	0	1	37	0	0
6	18220141	.	G	A	2	2	4	0	0	4	0	0
6	18245385	.	G	A	22	15	37	0	2	39	0	0
6	18272415	.	T	A	1	2	3	0	0	3	0	0
6	18274351	.	T	A	3	6	9	0	0	9	0	0
6	18290937	.	G	A	0	5	5	0	6	11	0	0
6	18359389	.	G	A	7	2	9	0	1	10	0	0
6	18361359	.	A	T	7	5	12	0	1	13	0	0
6	18361609	.	T	C	4	9	13	0	1	14	0	0
6	18362043	.	T	G	7	0	7	0	7	14	0	0
6	18364081	.	G	A	1	4	5	0	2	7	0	0
6	18367670	.	C	A	2	2	4	0	0	4	0	0
6	18375692	.	A	C	3	3	6	0	0	6	0	0
6	18375693	.	T	C	3	3	6	0	0	6	0	0
6	18381278	.	G	A	0	6	6	0	4	10	0	0
6	18388387	.	T	G	4	5	9	0	0	9	0	0
6	18388517	.	G	C	8	4	12	0	0	12	0	0
6	18388569	.	C	T	5	2	7	0	0	7	0	0
6	18389220	.	G	A	6	8	14	0	0	14	0	0
6	18389541	.	C	T	8	10	18	0	0	18	0	0
6	18390031	.	T	A	11	10	21	0	0	21	0	0
6	18390141	.	C	T	3	5	8	0	0	8	0	0
6	18393826	.	A	T	4	5	9	0	1	10	0	0
6	18418714	.	T	G	4	5	9	0	1	10	0	0
6	18431143	.	G	A	3	2	5	0	0	5	0	0
6	18437514	.	T	G	12	0	12	0	12	24	0	0
6	18438459	.	A	G	8	5	13	0	1	14	0	0
6	18439256	.	C	A	9	10	19	0	1	20	0	0
6	18439481	.	A	T	8	11	19	0	1	20	0	0
6	18439576	.	A	G	9	7	16	0	2	18	0	0
6	18439723	.	G	A	8	12	20	0	1	21	0	0
6	18439774	.	G	A	1	6	7	0	11	18	0	0
6	18440051	.	A	G	1	3	4	0	0	4	0	0
6	18440069	.	C	A	0	1	1	0	0	1	0	0
6	18520930	.	T	A	15	24	39	0	0	39	0	0
6	18523549	.	C	A	10	18	28	0	0	28	0	0
6	18523770	.	A	T	17	12	29	0	1	30	0	0
6	18523772	.	C	G	12	15	27	0	2	29	0	0
6	18523817	.	T	A	12	10	22	0	2	24	0	0
6	18524550	.	A	G	6	2	8	0	0	8	0	0
6	18524579	.	A	G	3	4	7	0	0	7	0	0
6	18529148	.	G	T	3	2	5	0	1	6	0	0
6	18529457	.	G	A	4	2	6	0	0	6	0	0
6	18530378	.	C	T	5	5	10	0	5	15	0	0
6	18531296	.	T	G	2	2	4	0	0	4	0	0
6	18531946	.	T	C	1	2	3	0	0	3	0	0
6	18532000	.	A	T	3	4	7	0	0	7	0	0
6	18532012	.	C	T	4	2	6	0	0	6	0	0
6	18532445	.	A	T	2	6	8	0	1	9	0	0
6	18536239	.	G	T	6	5	11	0	0	11	0	0
6	18536748	.	C	T	4	7	11	0	1	12	0	0
6	18540815	.	G	T	8	8	16	0	0	16	0	0
6	18541077	.	A	G	3	3	6	0	0	6	0	0
6	18541083	.	A	G	3	4	7	0	0	7	0	0
6	18542836	.	C	A	1	4	5	0	0	5	0	0
6	18542933	.	T	C	8	5	13	0	0	13	0	0
6	18543385	.	C	T	11	16	27	0	0	27	0	0
6	18543400	.	A	G	11	15	26	0	0	26	0	0
6	18543735	.	A	G	8	6	14	0	1	15	0	0
6	18543950	.	G	T	12	5	17	0	2	19	0	0
6	18554177	.	T	G	4	8	12	0	0	12	0	0
6	18554431	.	G	A	1	2	3	0	1	4	0	0
6	18554541	.	G	A	1	2	3	0	1	4	0	0
6	18554702	.	C	G	6	2	8	0	0	8	0	0
6	18554764	.	G	C	3	2	5	0	0	5	0	0
6	18555195	.	T	C	3	2	5	0	0	5	0	0
6	18558062	.	G	A	2	3	5	0	0	5	0	0
6	18584793	.	T	A	4	2	6	0	0	6	0	0
6	18587728	.	G	A	7	5	12	0	0	12	0	0
6	18589235	.	T	C	7	4	11	0	1	12	0	0
6	18592209	.	G	A	5	5	10	0	2	12	0	0
6	18595346	.	G	A	0	2	2	0	0	2	0	0
6	18595352	.	G	A	1	1	2	0	0	2	0	0
6	18595391	.	C	A	4	5	9	0	1	10	0	0
6	18600213	.	A	G	5	3	8	0	0	8	0	0
6	18600234	.	T	G	5	2	7	0	1	8	0	0
6	18600288	.	C	T	1	8	9	0	3	12	0	0
6	18606063	.	T	C	7	7	14	0	0	14	0	0
6	18606135	.	T	G	11	17	28	0	1	29	0	0
6	18607590	.	G	A	20	15	35	0	0	35	0	0
6	18623673	.	C	G	2	2	4	0	0	4	0	0
6	18624426	.	C	T	5	3	8	0	2	10	0	0
6	18663450	.	C	A	1	2	3	0	0	3	0	0
6	18714592	.	T	G	1	5	6	0	0	6	0	0
6	18714845	.	A	C	4	8	12	0	0	12	0	0
6	18714890	.	T	A	6	6	12	0	1	13	0	0
6	18714910	.	T	C	5	6	11	0	0	11	0	0
6	18714937	.	A	G	6	7	13	0	0	13	0	0
6	18715090	.	A	G	12	4	16	0	0	16	0	0
6	18715372	.	A	G	3	4	7	0	0	7	0	0
6	18715540	.	A	G	3	2	5	0	0	5	0	0
6	18715544	.	C	T	2	2	4	0	0	4	0	0
6	18715879	.	A	C	4	5	9	0	0	9	0	0
6	18716054	.	G	A	8	7	15	0	0	15	0	0
6	18716085	.	C	T	11	8	19	0	0	19	0	0
6	18716242	.	G	A	3	6	9	0	0	9	0	0
6	18716269	.	A	G	5	3	8	0	0	8	0	0
6	18716330	.	C	T	7	3	10	0	0	10	0	0
6	18716539	.	C	T	0	5	5	0	6	11	0	0
6	18716551	.	T	C	4	6	10	0	0	10	0	0
6	18717238	.	T	A	5	5	10	0	0	10	0	0
6	18717315	.	T	C	2	6	8	0	0	8	0	0
6	18717319	.	A	T	2	5	7	0	1	8	0	0
6	18717449	.	C	A	0	3	3	0	5	8	0	0
6	18717610	.	T	A	2	2	4	0	0	4	0	0
6	18717682	.	A	G	1	4	5	0	0	5	0	0
6	18717991	.	T	A	1	2	3	0	0	3	0	0
6	18718126	.	G	A	4	2	6	0	0	6	0	0
6	18718662	.	G	A	3	3	6	0	1	7	0	0
6	18718663	.	C	T	4	3	7	0	0	7	0	0
6	18718846	.	A	T	3	3	6	0	0	6	0	0
6	18718964	.	A	G	4	6	10	0	0	10	0	0
6	18721099	.	T	C	4	2	6	0	0	6	0	0
6	18724415	.	T	A	4	4	8	0	0	8	0	0
6	18725232	.	A	G	0	3	3	0	1	4	0	0
6	18737442	.	A	G	2	2	4	0	0	4	0	0
6	18937493	.	T	C	2	3	5	0	0	5	0	0
6	18953406	.	G	C	5	4	9	0	0	9	0	0
6	19263882	.	T	A	2	2	4	0	0	4	0	0
6	19263902	.	G	A	2	2	4	0	0	4	0	0
6	19295015	.	T	A	14	16	30	0	3	33	0	0
6	19295044	.	A	T	17	13	30	0	1	31	0	0
6	19295469	.	T	C	27	1	28	0	15	43	0	0
6	19295609	.	A	T	5	7	12	0	0	13	1	0
6	19295644	.	C	T	1	15	16	0	9	25	0	0
6	19327236	.	T	C	0	0	0	0	5	5	0	0
6	19327239	.	C	T	1	5	6	0	0	6	0	0
6	19330729	.	T	C	2	2	4	0	1	5	0	0
6	19331045	.	G	A	2	2	4	0	0	4	0	0
6	19331054	.	C	T	2	2	4	0	0	4	0	0
6	19334643	.	T	C	1	2	3	0	0	3	0	0
6	19334722	.	A	C	2	3	5	0	0	5	0	0
6	19334948	.	A	T	2	2	4	0	0	4	0	0
6	19334949	.	C	A	2	2	4	0	0	4	0	0
6	19339426	.	C	T	4	2	6	0	0	6	0	0
6	19344846	.	C	T	8	7	15	0	1	16	0	0
6	19344930	.	G	C	7	5	12	0	1	13	0	0
6	19344950	.	C	T	6	6	12	0	0	12	0	0
6	19345191	.	G	A	5	6	11	1	1	13	0	0
6	19347426	.	C	T	0	7	7	0	4	11	0	0
6	19381640	.	G	T	2	4	6	0	1	7	0	0
6	19381679	.	C	G	2	7	9	0	0	9	0	0
6	19715507	.	A	C	6	5	11	0	0	11	0	0
6	19802042	.	T	C	12	7	19	0	0	19	0	0
6	19802242	.	C	T	14	7	21	0	1	22	0	0
6	19802330	.	G	A	10	4	14	0	1	15	0	0
6	19802354	.	G	A	6	4	10	0	0	10	0	0
6	19802414	.	C	G	2	0	2	0	7	9	0	0
6	19802415	.	G	A	7	3	10	0	0	10	0	0
6	19804743	.	A	T	2	7	9	0	0	9	0	0
6	19807574	.	A	G	3	3	6	0	0	6	0	0
6	19807640	.	T	C	3	0	3	0	2	5	0	0
6	19808670	.	C	T	1	5	6	0	0	6	0	0
6	19808818	.	G	A	3	6	9	0	2	11	0	0
6	20766136	.	C	T	7	6	13	0	0	13	0	0
6	20766307	.	A	G	20	11	31	0	2	33	0	0
6	20766500	.	G	T	9	3	12	0	1	13	0	0
6	20767015	.	T	A	25	15	40	0	0	40	0	0
6	20767537	.	A	G	28	20	48	0	0	48	0	0
6	20767830	.	T	G	13	3	16	0	1	17	0	0
6	20767958	.	T	G	6	4	10	0	0	10	0	0
6	20767994	.	T	C	10	9	19	0	0	19	0	0
6	20768061	.	A	G	12	6	18	0	0	18	0	0
6	20768076	.	C	A	13	6	19	0	0	19	0	0
6	20768107	.	A	T	15	8	23	0	2	25	0	0
6	20768239	.	A	G	17	8	25	3	2	30	0	0
6	20768338	.	G	A	14	14	28	0	0	28	0	0
6	20768346	.	T	G	14	10	24	0	1	26	1	0
6	20768558	.	C	G	13	7	20	0	1	21	0	0
6	20773961	.	G	A	12	14	26	0	1	27	0	0
6	20774048	.	A	C	16	17	33	0	3	36	0	0
6	20774701	.	G	A	19	9	28	0	0	28	0	0
6	20774768	.	C	T	13	7	20	0	0	20	0	0
6	20785089	.	A	G	8	9	17	0	1	18	0	0
6	20785105	.	C	T	0	8	8	0	9	17	0	0
6	20785144	.	G	A	6	11	17	0	0	17	0	0
6	20789072	.	A	G	8	16	24	0	0	24	0	0
6	20789162	.	G	A	6	13	19	0	0	19	0	0
6	20789195	.	C	T	10	13	23	0	0	23	0	0
6	20789351	.	T	C	4	4	8	0	0	8	0	0
6	20789369	.	T	A	7	4	11	0	0	11	0	0
6	20789489	.	T	C	3	4	7	0	0	7	0	0
6	20815058	.	A	T	1	4	5	0	0	5	0	0
6	20822108	.	T	C	1	3	4	0	0	4	0	0
6	20910627	.	A	C	3	2	5	0	0	5	0	0
6	20910713	.	G	T	2	2	4	0	0	4	0	0
6	20910759	.	A	T	2	3	5	0	1	6	0	0
6	20910830	.	T	C	2	5	7	0	0	7	0	0
6	20917730	.	A	T	8	4	12	0	0	12	0	0
6	20917780	.	T	A	8	7	15	0	0	15	0	0
6	20917921	.	G	A	10	7	17	0	0	17	0	0
6	20917922	.	A	C	10	7	17	0	0	17	0	0
6	20918215	.	A	G	6	3	9	0	2	11	0	0
6	20918237	.	A	G	3	8	11	0	0	11	0	0
6	20918456	.	C	A	3	8	11	0	0	11	0	0
6	20918613	.	G	T	14	6	20	0	2	22	0	0
6	20918673	.	T	C	11	6	17	0	1	18	0	0
6	20921859	.	G	A	6	9	15	0	0	15	0	0
6	20921888	.	T	C	4	3	7	0	1	8	0	0
6	20922057	.	A	T	9	6	15	0	0	15	0	0
6	20922330	.	G	A	8	4	12	0	2	14	0	0
6	20922396	.	G	A	9	7	16	0	0	16	0	0
6	20922468	.	G	A	6	10	16	0	0	16	0	0
6	20961760	.	T	A	3	3	6	0	1	7	0	0
6	20965710	.	G	A	0	3	3	0	2	5	0	0
6	20965745	.	T	A	3	2	5	0	1	6	0	0
6	20965873	.	T	A	6	7	13	0	0	13	0	0
6	20969124	.	A	T	3	3	6	0	0	6	0	0
6	20969126	.	G	T	2	3	5	0	0	5	0	0
6	20970989	.	T	A	5	3	8	0	0	8	0	0
6	20977715	.	T	C	1	3	4	0	0	4	0	0
6	20978972	.	C	T	7	3	10	0	0	10	0	0
6	20995800	.	A	G	3	5	8	0	0	8	0	0
6	20996640	.	C	T	3	8	11	0	0	11	0	0
6	20996705	.	C	T	6	6	12	0	0	12	0	0
6	20996733	.	A	C	3	5	8	0	4	12	0	0
6	20997031	.	A	T	6	5	11	0	0	11	0	0
6	21116134	.	C	G	4	5	9	0	0	9	0	0
6	21119598	.	C	T	5	5	10	0	0	10	0	0
6	21119779	.	G	A	1	2	3	0	0	3	0	0
6	21119953	.	C	A	5	2	7	0	0	7	0	0
6	21119994	.	T	C	4	2	6	0	0	6	0	0
6	21120001	.	A	G	4	2	6	0	0	6	0	0
6	21120080	.	A	G	2	5	7	0	0	7	0	0
6	21120193	.	T	C	3	4	7	0	0	7	0	0
6	21120201	.	T	C	3	5	8	0	0	8	0	0
6	21120261	.	C	T	4	5	9	0	0	9	0	0
6	21121977	.	T	C	2	4	6	0	0	6	0	0
6	21121986	.	G	C	2	4	6	0	1	7	0	0
6	21130593	.	G	A	2	3	5	0	0	5	0	0
6	21130623	.	C	T	4	3	7	0	0	7	0	0
6	21130668	.	A	C	3	3	6	0	0	6	0	0
6	21131142	.	A	T	5	8	13	0	0	13	0	0
6	21131414	.	C	A	2	7	9	0	0	9	0	0
6	21138869	.	C	T	2	4	6	0	0	6	0	0
6	21138870	.	T	G	2	4	6	0	0	6	0	0
6	21140553	.	G	T	1	2	3	1	0	4	0	0
6	21143033	.	T	C	2	8	10	0	0	10	0	0
6	21143685	.	C	T	5	6	11	0	0	11	0	0
6	21143995	.	G	A	1	3	4	0	0	4	0	0
6	21144020	.	T	G	1	3	4	0	0	4	0	0
6	21144245	.	C	T	4	7	11	0	0	11	0	0
6	21144285	.	T	C	3	2	5	0	1	6	0	0
6	21146813	.	T	G	3	0	3	0	3	6	0	0
6	21147218	.	G	A	1	7	8	0	8	16	0	0
6	21147240	.	A	G	7	9	16	0	1	17	0	0
6	21147291	.	C	A	5	6	11	0	2	13	0	0
6	21147332	.	T	A	3	8	11	0	0	11	0	0
6	21147334	.	T	A	3	8	11	0	0	11	0	0
6	21147368	.	G	A	0	5	5	0	6	11	0	0
6	21147818	.	T	C	7	12	19	0	0	19	0	0
6	21147837	.	A	G	7	12	19	0	1	20	0	0
6	21147920	.	A	C	6	10	16	0	1	17	0	0
6	21148166	.	A	T	12	9	21	0	0	21	0	0
6	21148167	.	T	C	12	8	20	0	1	21	0	0
6	21148736	.	T	A	5	6	11	0	1	12	0	0
6	21148737	.	A	T	5	7	12	0	0	12	0	0
6	21148972	.	G	C	7	13	20	0	1	21	0	0
6	21149337	.	G	A	5	17	22	0	2	24	0	0
6	21150661	.	T	C	11	15	26	0	3	29	0	0
6	21150672	.	G	A	9	16	25	0	3	28	0	0
6	21150712	.	A	T	11	20	31	0	1	32	0	0
6	21150872	.	C	T	17	22	39	0	2	41	0	0
6	21150958	.	A	G	11	16	27	0	3	30	0	0
6	21151027	.	A	G	7	14	21	0	0	21	0	0
6	21151078	.	T	C	13	14	27	0	0	27	0	0
6	21151312	.	T	C	6	6	12	0	1	13	0	0
6	21151379	.	A	C	12	14	26	0	1	27	0	0
6	21151415	.	T	C	13	10	23	0	0	23	0	0
6	21151459	.	T	C	10	10	20	0	0	20	0	0
6	21153285	.	G	A	2	17	19	0	15	34	0	0
6	21154996	.	T	A	15	10	25	0	0	25	0	0
6	21390316	.	G	A	1	5	6	0	6	12	0	0
6	21391439	.	G	A	3	2	5	0	0	5	0	0
6	21391444	.	C	T	3	1	4	0	1	5	0	0
6	21391675	.	A	G	3	3	6	0	0	6	0	0
6	21392126	.	A	G	5	3	8	0	1	9	0	0
6	21392472	.	G	A	1	3	4	0	0	4	0	0
6	21392545	.	C	T	2	6	8	0	0	8	0	0
6	21392584	.	C	A	0	3	3	0	5	8	0	0
6	21392722	.	T	C	8	4	12	0	1	13	0	0
6	21393635	.	G	A	0	8	8	0	6	14	0	0
6	21513773	.	G	C	5	3	8	0	0	8	0	0
6	21513778	.	A	G	4	5	9	0	0	9	0	0
6	21513826	.	C	A	3	5	8	0	0	8	0	0
6	21513885	.	G	T	3	2	5	0	0	5	0	0
6	21514000	.	A	T	3	3	6	0	0	6	0	0
6	21515037	.	G	T	1	2	3	0	1	4	0	0
6	21515063	.	A	G	2	2	4	0	0	4	0	0
6	21525887	.	C	A	7	5	12	0	0	12	0	0
6	21525916	.	A	G	8	9	17	1	0	18	0	0
6	21525943	.	T	A	12	10	22	1	2	25	0	0
6	21526322	.	A	G	16	10	26	0	1	27	0	0
6	21526357	.	C	T	1	12	13	0	12	25	0	0
6	21526620	.	T	C	14	11	25	0	0	25	0	0
6	21529229	.	A	G	8	13	21	0	0	21	0	0
6	21529253	.	C	A	9	18	27	0	0	27	0	0
6	21529379	.	A	T	18	19	37	0	0	37	0	0
6	21570236	.	G	A	3	3	6	0	0	6	0	0
6	21570468	.	A	G	2	3	5	0	0	5	0	0
6	21576216	.	T	G	3	4	7	0	0	7	0	0
6	21578702	.	G	A	2	5	7	0	1	8	0	0
6	21578732	.	A	T	2	3	5	0	1	6	0	0
6	21578760	.	C	T	2	5	7	0	1	8	0	0
6	21588594	.	C	A	0	12	12	0	8	20	0	0
6	21588597	.	T	G	7	12	19	0	2	21	0	0
6	21588727	.	T	A	11	7	18	0	0	18	0	0
6	21598085	.	C	T	6	8	14	0	1	15	0	0
6	21602514	.	C	T	14	8	22	0	0	22	0	0
6	21602679	.	T	G	8	12	20	0	0	20	0	0
6	21602849	.	C	A	8	5	13	0	2	15	0	0
6	21615529	.	C	T	8	5	13	0	1	14	0	0
6	21693910	.	A	G	9	6	15	0	1	16	0	0
6	21694156	.	C	G	5	0	5	0	4	9	0	0
6	21694306	.	G	A	9	8	17	0	1	18	0	0
6	21694369	.	T	A	8	3	11	0	0	11	0	0
6	21694486	.	C	A	8	3	11	1	0	12	0	0
6	21694544	.	A	G	6	8	14	0	0	14	0	0
6	21694591	.	C	A	8	9	17	0	0	17	0	0
6	21694652	.	T	A	9	10	19	0	1	20	0	0
6	21694917	.	C	A	8	10	18	0	1	19	0	0
6	21726584	.	C	T	3	2	5	0	0	5	0	0
6	21809771	.	T	A	4	2	6	0	0	6	0	0
6	21809936	.	T	A	5	4	9	0	2	11	0	0
6	21811551	.	G	A	4	2	6	0	1	7	0	0
6	21815301	.	C	A	0	2	2	0	5	7	0	0
6	21815389	.	G	A	6	3	9	0	0	9	0	0
6	21861324	.	G	T	20	18	38	0	2	40	0	0
6	21861490	.	C	A	0	16	16	0	23	39	0	0
6	21861590	.	G	T	21	13	34	0	1	35	0	0
6	21861736	.	T	G	5	8	13	0	1	14	0	0
6	21862054	.	C	A	26	22	48	0	1	49	0	0
6	21862158	.	G	C	15	17	32	0	0	32	0	0
6	21862486	.	G	A	26	16	42	0	2	44	0	0
6	21875429	.	A	C	3	4	7	0	0	7	0	0
6	21875511	.	T	C	4	4	8	0	0	8	0	0
6	21875691	.	T	C	2	0	2	0	8	10	0	0
6	21876060	.	G	A	3	5	8	0	0	8	0	0
6	21876131	.	T	A	9	5	14	0	0	14	0	0
6	21876182	.	T	C	3	6	9	0	2	11	0	0
6	21876183	.	T	C	3	8	11	0	0	11	0	0
6	21877981	.	G	A	1	2	3	0	0	3	0	0
6	21878294	.	T	C	1	2	3	0	0	3	0	0
6	21878474	.	T	C	5	0	5	0	4	9	0	0
6	21996194	.	A	C	5	4	9	0	0	9	0	0
6	21996281	.	C	A	5	4	9	0	0	9	0	0
6	21996320	.	A	G	4	2	6	0	0	6	0	0
6	21996452	.	C	A	5	5	10	0	0	10	0	0
6	21999860	.	A	T	5	10	15	0	0	15	0	0
6	22001456	.	G	A	6	3	9	0	0	9	0	0
6	22007420	.	G	A	11	3	14	0	0	14	0	0
6	22013133	.	A	G	1	3	4	0	0	4	0	0
6	22026088	.	A	G	2	0	2	0	4	6	0	0
6	22026339	.	T	A	3	2	5	0	1	6	0	0
6	22026431	.	G	C	1	5	6	0	0	6	0	0
6	22026440	.	G	A	1	6	7	0	0	7	0	0
6	22026825	.	C	A	2	2	4	0	1	5	0	0
6	22027263	.	A	G	4	0	4	0	5	9	0	0
6	22028009	.	A	T	5	5	10	0	1	11	0	0
6	22034802	.	A	G	9	8	17	0	2	19	0	0
6	22034961	.	A	C	12	4	16	0	1	17	0	0
6	22035222	.	G	A	2	14	16	0	9	25	0	0
6	22035426	.	A	G	6	15	21	0	0	21	0	0
6	22035519	.	G	A	7	12	19	0	0	19	0	0
6	22037517	.	A	G	15	1	16	0	8	24	0	0
6	22037553	.	G	A	12	5	17	0	0	17	0	0
6	22037565	.	A	G	9	0	9	0	7	16	0	0
6	22037625	.	C	T	9	8	17	0	0	17	0	0
6	22048636	.	A	G	7	3	10	0	0	10	0	0
6	22053067	.	C	T	2	7	9	0	0	9	0	0
6	22055545	.	A	G	1	6	7	0	0	7	0	0
6	22055789	.	G	A	5	2	7	0	1	8	0	0
6	22078734	.	C	T	1	3	4	0	0	4	0	0
6	22078752	.	G	A	2	4	6	0	0	6	0	0
6	22085711	.	C	T	2	3	5	0	0	5	0	0
6	22088099	.	C	T	4	2	6	0	0	6	0	0
6	22093707	.	A	G	1	5	6	0	0	6	0	0
6	22093722	.	A	G	3	6	9	0	0	9	0	0
6	22099448	.	C	T	3	11	14	0	0	14	0	0
6	22105061	.	G	C	5	10	15	0	0	15	0	0
6	22105118	.	A	T	7	5	12	0	2	14	0	0
6	22105289	.	T	G	5	7	12	0	1	13	0	0
6	22107277	.	C	T	11	6	17	0	1	18	0	0
6	22107813	.	T	G	8	0	8	0	10	18	0	0
6	22107858	.	C	T	6	12	18	0	0	18	0	0
6	22108004	.	C	G	11	5	16	0	0	16	0	0
6	22108307	.	C	A	12	9	21	0	2	23	0	0
6	22109552	.	T	G	8	0	8	0	7	15	0	0
6	22109678	.	A	T	15	8	23	0	1	24	0	0
6	22111594	.	A	G	17	11	28	0	1	29	0	0
6	22112416	.	C	T	20	10	30	0	3	33	0	0
6	22118497	.	G	C	18	42	60	0	1	61	0	0
6	22118630	.	G	A	21	19	40	3	2	45	0	0
6	22118681	.	C	T	18	15	33	0	2	35	0	0
6	22119201	.	T	A	15	12	27	0	2	29	0	0
6	22119241	.	A	T	8	10	18	0	5	23	0	0
6	22119376	.	A	C	15	17	32	0	2	34	0	0
6	22119516	.	T	C	18	31	49	0	0	49	0	0
6	22119582	.	T	C	25	11	36	0	1	37	0	0
6	22119668	.	T	C	5	3	8	0	0	8	0	0
6	22119836	.	T	A	3	3	6	0	0	6	0	0
6	22119977	.	T	A	12	10	22	0	1	23	0	0
6	22120342	.	T	A	6	7	13	0	0	13	0	0
6	22120445	.	A	G	15	6	21	0	1	22	0	0
6	22120793	.	A	G	8	8	16	0	0	16	0	0
6	22127270	.	C	T	3	8	11	0	3	14	0	0
6	22327331	.	T	C	7	3	10	0	0	10	0	0
6	22328821	.	A	G	8	0	8	0	11	19	0	0
6	22333884	.	A	T	2	3	5	0	1	6	0	0
6	22344452	.	C	T	16	14	30	0	0	30	0	0
6	22351692	.	T	C	29	26	55	0	1	56	0	0
6	22351727	.	T	C	25	21	46	0	3	49	0	0
6	22351770	.	A	C	24	15	39	0	1	40	0	0
6	22351780	.	T	A	18	19	37	0	3	40	0	0
6	22352229	.	T	C	11	9	20	0	4	24	0	0
6	22352539	.	C	T	15	18	33	0	1	34	0	0
6	22354759	.	A	G	2	8	10	0	1	11	0	0
6	22355040	.	T	C	4	0	4	0	5	9	0	0
6	22364151	.	T	C	2	3	5	0	0	5	0	0
6	22463151	.	A	G	4	4	8	0	0	8	0	0
6	22597503	.	G	A	15	14	29	0	0	29	0	0
6	22615546	.	G	A	10	20	30	0	3	33	0	0
6	22628073	.	T	G	11	12	23	0	0	23	0	0
6	22628112	.	A	G	9	9	18	0	0	18	0	0
6	22628483	.	G	A	1	16	17	0	24	41	0	0
6	22628779	.	T	C	22	14	36	0	1	37	0	0
6	22628997	.	T	G	4	0	4	0	6	10	0	0
6	22629099	.	A	T	9	11	20	0	0	20	0	0
6	22629182	.	A	G	8	3	11	0	0	11	0	0
6	22683362	.	A	G	2	3	5	0	0	5	0	0
6	22966966	.	C	A	8	4	12	0	0	12	0	0
6	23001363	.	G	A	5	3	8	0	0	8	0	0
6	23010957	.	G	A	1	2	3	0	0	3	0	0
6	23010975	.	A	C	1	2	3	0	0	3	0	0
6	23042113	.	G	T	4	6	10	0	2	12	0	0
6	23053129	.	C	T	7	5	12	0	1	13	0	0
6	23053296	.	A	G	6	7	13	0	0	13	0	0
6	23053374	.	G	A	1	10	11	0	7	18	0	0
6	23053744	.	A	G	15	5	20	0	1	21	0	0
6	23053761	.	A	G	7	11	18	0	1	19	0	0
6	23053980	.	A	T	16	10	26	0	0	26	0	0
6	23054266	.	C	T	11	18	29	0	0	29	0	0
6	23054267	.	A	G	13	10	23	0	7	30	0	0
6	23054433	.	A	G	19	3	22	0	0	22	0	0
6	23054569	.	C	T	4	8	12	0	5	17	0	0
6	23054705	.	A	G	5	0	5	0	6	11	0	0
6	23137335	.	T	A	7	6	13	0	0	13	0	0
6	23752615	.	G	A	0	4	4	0	8	12	0	0
6	23781314	.	C	T	5	6	11	0	0	11	0	0
6	23810518	.	T	C	9	7	16	0	1	17	0	0
6	23810922	.	G	C	11	10	21	0	0	21	0	0
6	23811154	.	C	T	10	6	16	0	3	19	0	0
6	23812768	.	T	A	11	20	31	0	2	33	0	0
6	23812771	.	C	G	13	18	31	0	0	31	0	0
6	23812885	.	T	C	11	16	27	0	0	27	0	0
6	23813437	.	G	C	18	14	32	0	0	32	0	0
6	23813554	.	C	A	8	23	31	0	1	32	0	0
6	23813767	.	C	A	11	13	24	0	0	24	0	0
6	23938676	.	A	C	8	10	18	0	2	20	0	0
6	23938738	.	A	G	5	8	13	0	1	14	0	0
6	24055743	.	T	A	12	8	20	0	0	20	0	0
6	24055784	.	G	A	9	11	20	0	0	20	0	0
6	24055866	.	G	T	5	6	11	0	4	15	0	0
6	24056103	.	C	T	1	5	6	0	9	15	0	0
6	24065975	.	C	G	0	8	8	0	3	11	0	0
6	24066253	.	T	C	6	0	6	0	6	12	0	0
6	24066345	.	A	G	5	4	9	0	0	9	0	0
6	24066382	.	T	A	7	5	12	0	0	12	0	0
6	24066547	.	C	T	2	5	7	0	8	15	0	0
6	24066575	.	T	C	11	8	19	0	0	19	0	0
6	24091437	.	G	T	2	2	4	0	0	4	0	0
6	24094574	.	T	A	1	2	3	0	0	3	0	0
6	24153159	.	C	T	26	21	47	0	1	48	0	0
6	24155442	.	A	T	18	19	37	0	0	37	0	0
6	24155744	.	T	C	14	16	30	0	0	30	0	0
6	24155766	.	T	C	15	15	30	0	0	30	0	0
6	24155886	.	A	C	12	0	12	0	10	22	0	0
6	24155898	.	C	T	11	9	20	0	0	20	0	0
6	24156027	.	T	C	19	15	34	0	2	36	0	0
6	24156399	.	C	G	14	10	24	0	0	24	0	0
6	24156428	.	A	T	13	10	23	0	0	23	0	0
6	24156476	.	T	G	10	9	19	0	0	19	0	0
6	24156486	.	A	C	11	6	17	0	2	19	0	0
6	24156567	.	T	C	17	0	17	0	9	26	0	0
6	24157177	.	C	T	10	6	16	0	0	16	0	0
6	24158601	.	T	C	6	0	6	0	5	11	0	0
6	24160303	.	T	C	9	9	18	0	0	18	0	0
6	24161409	.	G	A	10	10	20	0	1	21	0	0
6	24163420	.	T	C	2	4	6	0	0	6	0	0
6	24163448	.	C	T	4	4	8	0	0	8	0	0
6	24163505	.	C	T	3	0	3	0	2	5	0	0
6	24163543	.	T	C	2	3	5	0	0	5	0	0
6	24338496	.	T	A	13	17	30	0	2	32	0	0
6	24338526	.	G	A	19	7	26	0	0	26	0	0
6	24358326	.	G	A	5	7	12	0	1	13	0	0
6	24358596	.	G	A	7	4	11	0	0	11	0	0
6	24358608	.	T	A	3	6	9	0	1	10	0	0
6	24364750	.	C	T	1	2	3	0	0	3	0	0
6	24365205	.	T	A	6	5	11	0	1	12	0	0
6	24370637	.	C	T	11	6	17	0	1	18	0	0
6	24370646	.	T	C	7	12	19	0	0	19	0	0
6	24379745	.	T	C	11	9	20	0	1	21	0	0
6	24379760	.	T	C	11	10	21	0	0	21	0	0
6	24379802	.	T	G	2	3	5	0	0	5	0	0
6	24379865	.	G	A	9	14	23	0	1	24	0	0
6	24380335	.	C	A	10	13	23	0	0	23	0	0
6	24382063	.	A	T	8	11	19	0	0	19	0	0
6	24384613	.	T	C	6	7	13	0	0	13	0	0
6	24389518	.	A	T	5	4	9	0	1	10	0	0
6	24392318	.	C	T	7	3	10	0	0	10	0	0
6	24392562	.	T	C	5	0	5	0	6	11	0	0
6	24392674	.	G	T	2	6	8	0	0	8	0	0
6	24392732	.	T	C	3	4	7	0	0	7	0	0
6	24681529	.	C	T	6	4	10	0	0	10	0	0
6	24682165	.	G	C	5	2	7	0	0	7	0	0
6	24682721	.	C	T	5	8	13	0	2	15	0	0
6	24682759	.	G	T	6	11	17	0	1	18	0	0
6	24682925	.	T	C	9	7	16	0	1	17	0	0
6	24683354	.	C	T	5	4	9	0	0	9	0	0
6	24683723	.	A	T	6	4	10	0	1	11	0	0
6	24691718	.	A	T	3	4	7	0	0	7	0	0
6	24691791	.	A	T	6	4	10	0	0	10	0	0
6	24697940	.	G	C	7	9	16	0	0	16	0	0
6	24818240	.	C	A	13	10	23	0	3	26	0	0
6	24818312	.	C	G	12	12	24	0	2	26	0	0
6	25168647	.	G	C	4	2	6	0	0	6	0	0
6	25169241	.	A	T	3	3	6	0	0	6	0	0
6	25169385	.	T	A	1	3	4	0	0	4	0	0
6	25170022	.	G	C	0	3	3	0	1	4	0	0
6	25170035	.	C	T	1	4	5	0	0	5	0	0
6	25170438	.	T	C	6	7	13	0	1	14	0	0
6	25170579	.	A	G	6	5	11	0	1	12	0	0
6	25171078	.	T	A	2	3	5	0	1	6	0	0
6	25171100	.	A	G	4	3	7	0	0	7	0	0
6	25171285	.	A	G	4	5	9	0	0	9	0	0
6	25171940	.	A	G	4	3	7	0	0	7	0	0
6	25172176	.	A	T	2	2	4	0	0	4	0	0
6	25173005	.	G	A	2	2	4	0	0	4	0	0
6	25173026	.	A	G	2	4	6	0	0	6	0	0
6	25264039	.	C	T	1	4	5	0	1	6	0	0
6	25265306	.	G	A	3	3	6	0	0	6	0	0
6	25314577	.	T	A	1	4	5	0	0	5	0	0
6	25315051	.	A	G	1	3	4	0	0	4	0	0
6	25933917	.	T	C	25	1	26	0	12	38	0	0
6	25934214	.	A	G	18	11	29	0	3	35	3	0
6	25934313	.	A	T	18	14	32	0	3	35	0	0
6	26065499	.	A	C	6	8	14	0	1	15	0	0
6	26065508	.	C	A	1	8	9	0	5	14	0	0
6	26066097	.	A	T	5	5	10	0	1	11	0	0
6	26080187	.	A	G	7	4	11	0	0	11	0	0
6	26080352	.	C	T	6	9	15	0	0	15	0	0
6	26225456	.	G	A	4	7	11	0	1	12	0	0
6	26225479	.	T	G	5	4	9	0	0	9	0	0
6	26225575	.	A	C	4	1	5	0	3	8	0	0
6	26225657	.	G	C	3	5	8	0	0	8	0	0
6	26558837	.	C	T	2	22	24	0	8	32	0	0
6	26558927	.	C	T	0	23	23	0	12	35	0	0
6	26559179	.	T	C	13	1	14	0	25	39	0	0
6	26559780	.	A	G	8	15	23	0	1	24	0	0
6	26559807	.	A	G	9	15	24	0	0	24	0	0
6	26875804	.	C	A	6	14	20	0	1	21	0	0
6	26875944	.	T	A	19	19	38	0	3	41	0	0
6	26878802	.	G	A	9	6	15	0	0	15	0	0
6	26879486	.	G	T	8	7	15	0	0	15	0	0
6	26879510	.	T	C	8	8	16	0	1	17	0	0
6	26883895	.	T	G	9	3	12	0	1	13	0	0
6	26891891	.	A	G	9	5	14	0	1	15	0	0
6	27038125	.	T	C	1	3	4	0	0	4	0	0
6	27041886	.	T	C	3	7	10	0	0	10	0	0
6	27041988	.	C	T	5	6	11	0	0	11	0	0
6	27045205	.	G	A	11	7	18	0	1	19	0	0
6	27045238	.	A	G	9	5	14	0	0	14	0	0
6	27045424	.	T	C	11	0	11	0	10	21	0	0
6	27048800	.	T	A	10	13	23	0	4	27	0	0
6	27048976	.	A	G	13	10	23	0	1	24	0	0
6	27051710	.	G	A	16	9	25	0	2	27	0	0
6	27051749	.	C	T	12	7	19	0	2	21	0	0
6	27051836	.	G	A	10	4	14	0	0	15	1	0
6	27055569	.	T	C	6	3	9	0	1	10	0	0
6	27057438	.	A	G	6	4	10	0	0	10	0	0
6	27057586	.	T	C	13	6	19	0	0	19	0	0
6	27057598	.	A	T	10	8	18	0	2	20	0	0
6	27063155	.	T	A	4	3	7	0	0	7	0	0
6	27063158	.	G	A	4	3	7	0	0	7	0	0
6	27067473	.	G	A	2	4	6	0	0	6	0	0
6	27067485	.	C	G	2	4	6	0	0	6	0	0
6	27087515	.	T	A	4	5	9	0	0	10	1	0
6	27087776	.	A	G	5	4	9	0	1	10	0	0
6	27087788	.	C	T	3	7	10	0	0	10	0	0
6	27087827	.	A	T	1	6	7	0	0	7	0	0
6	27087843	.	A	G	1	4	5	0	0	5	0	0
6	27087929	.	T	C	2	3	5	0	0	5	0	0
6	27088076	.	G	C	9	10	19	0	1	20	0	0
6	27088260	.	A	G	6	6	12	0	1	13	0	0
6	27088519	.	T	A	2	3	5	0	0	5	0	0
6	27092370	.	G	A	0	3	3	0	1	4	0	0
6	27099004	.	T	C	2	8	10	0	1	11	0	0
6	27099061	.	G	A	5	6	11	0	1	12	0	0
6	27101393	.	A	G	8	0	8	0	7	15	0	0
6	27104458	.	G	C	4	7	11	0	0	11	0	0
6	27104584	.	T	C	12	9	21	0	0	21	0	0
6	27104752	.	A	G	5	5	10	0	1	11	0	0
6	27106554	.	G	A	3	3	6	0	0	6	0	0
6	27106952	.	A	G	1	4	5	0	1	6	0	0
6	27146902	.	C	T	1	7	8	0	0	8	0	0
6	27146933	.	C	T	5	2	7	0	0	7	0	0
6	27220245	.	C	T	19	11	30	0	1	31	0	0
6	27231706	.	G	A	0	13	13	0	11	24	0	0
6	27233775	.	G	A	1	12	13	0	13	26	0	0
6	27234032	.	T	G	16	16	32	0	1	33	0	0
6	27234250	.	C	T	20	10	30	0	1	31	0	0
6	27234414	.	A	G	13	14	27	0	1	28	0	0
6	27259107	.	T	A	13	15	28	0	1	29	0	0
6	27260541	.	A	G	21	0	21	1	11	33	0	0
6	27265434	.	C	T	18	18	36	0	1	37	0	0
6	27269862	.	G	A	4	21	25	0	14	39	0	0
6	27269873	.	C	T	25	13	38	0	1	39	0	0
6	27269902	.	T	A	12	20	32	0	0	32	0	0
6	27270389	.	C	A	7	19	26	0	1	27	0	0
6	27270548	.	G	A	28	14	42	0	3	45	0	0
6	27270738	.	A	G	18	0	18	0	14	32	0	0
6	27270959	.	C	A	19	8	27	0	1	28	0	0
6	27271208	.	A	G	22	3	25	0	29	54	0	0
6	27271214	.	A	G	41	14	55	0	1	56	0	0
6	27271352	.	G	A	2	16	18	0	25	43	0	0
6	27271355	.	C	T	25	17	42	0	1	43	0	0
6	27271390	.	T	A	15	26	41	0	0	44	3	0
6	27271498	.	C	T	24	26	50	0	0	50	0	0
6	27271543	.	C	T	24	17	41	1	0	43	1	0
6	27271610	.	A	T	21	8	29	0	0	29	0	0
6	27271617	.	G	A	21	8	29	0	2	31	0	0
6	27271813	.	A	G	36	15	51	0	3	54	0	0
6	27272205	.	G	C	22	28	50	0	0	50	0	0
6	27272440	.	C	T	19	23	42	0	2	44	0	0
6	27272487	.	A	T	19	21	40	0	1	41	0	0
6	27272488	.	T	C	21	20	41	0	1	42	0	0
6	27272623	.	A	G	17	33	50	0	3	53	0	0
6	27272660	.	C	G	19	33	52	0	0	52	0	0
6	27272835	.	G	T	23	13	36	0	1	37	0	0
6	27450462	.	T	A	1	3	4	0	0	4	0	0
6	27510024	.	T	C	1	2	3	0	0	3	0	0
6	27574439	.	C	G	2	3	5	0	0	5	0	0
6	27574472	.	G	A	3	3	6	0	0	6	0	0
6	27593999	.	C	T	1	2	3	0	0	3	0	0
6	27613633	.	C	T	6	2	8	0	0	8	0	0
6	27614482	.	C	A	2	5	7	0	0	7	0	0
6	27614989	.	A	T	5	3	8	0	0	8	0	0
6	27614993	.	T	C	4	3	7	0	0	7	0	0
6	27667415	.	A	C	27	19	46	0	1	47	0	0
6	27775416	.	T	A	26	21	47	0	2	49	0	0
6	27874674	.	T	C	12	21	33	0	0	33	0	0
6	27874680	.	C	G	12	20	32	0	1	33	0	0
6	27874730	.	A	G	8	1	9	0	18	27	0	0
6	27874753	.	G	C	0	14	14	0	6	20	0	0
6	27874769	.	T	A	9	8	17	0	3	20	0	0
6	27874896	.	T	A	14	18	32	0	0	32	0	0
6	27875309	.	T	C	24	23	47	0	4	51	0	0
6	27875383	.	G	T	32	23	55	0	3	58	0	0
6	27875519	.	G	T	29	26	55	1	0	56	0	0
6	27875598	.	T	C	2	46	48	1	1	50	0	0
6	27875600	.	A	C	61	2	63	1	1	65	0	0
6	27875873	.	A	G	22	23	45	0	1	46	0	0
6	27876060	.	T	A	29	23	52	0	1	53	0	0
6	27876134	.	C	T	20	25	45	0	0	45	0	0
6	27876503	.	G	A	1	2	3	0	1	4	0	0
6	27993450	.	A	T	2	3	5	0	0	5	0	0
6	27997333	.	C	T	3	6	9	0	0	9	0	0
6	27997510	.	A	G	2	0	2	0	4	6	0	0
6	27998329	.	C	A	5	5	10	0	1	11	0	0
6	27999396	.	G	C	6	3	9	0	0	9	0	0
6	27999744	.	A	C	5	9	14	0	0	14	0	0
6	28000242	.	T	A	5	4	9	0	0	9	0	0
6	28000316	.	G	A	0	4	4	0	4	8	0	0
6	28000597	.	A	C	4	3	7	0	0	7	0	0
6	28000768	.	G	T	4	6	10	0	0	10	0	0
6	28020082	.	T	C	1	2	3	0	1	4	0	0
6	28025213	.	C	T	1	2	3	0	0	3	0	0
6	28036311	.	C	T	4	4	8	0	0	8	0	0
6	28039034	.	C	T	7	7	14	0	1	15	0	0
6	28039175	.	T	A	4	7	11	0	0	11	0	0
6	28041161	.	G	A	3	8	11	0	8	19	0	0
6	28044401	.	A	G	5	10	15	0	0	15	0	0
6	28048870	.	C	T	5	2	7	0	0	7	0	0
6	28048883	.	C	T	3	3	6	0	3	9	0	0
6	28048923	.	C	A	5	3	8	0	2	10	0	0
6	28206124	.	T	C	13	6	19	0	1	20	0	0
6	28206442	.	G	A	9	13	22	0	0	22	0	0
6	28207340	.	C	T	9	12	21	0	0	21	0	0
6	28207418	.	C	G	7	13	20	0	0	20	0	0
6	28207532	.	C	A	4	5	9	0	0	9	0	0
6	28207534	.	A	G	4	4	8	0	1	9	0	0
6	28207593	.	A	G	2	5	7	0	1	8	0	0
6	28209525	.	T	A	1	2	3	0	0	3	0	0
6	28217596	.	C	T	1	5	6	0	11	17	0	0
6	28218159	.	G	T	5	12	17	0	1	18	0	0
6	28218555	.	T	G	7	11	18	0	0	18	0	0
6	28223884	.	G	T	1	2	3	0	1	4	0	0
6	28223912	.	C	T	1	3	4	0	0	4	0	0
6	28224044	.	T	A	2	2	4	0	0	4	0	0
6	28913682	.	C	A	2	2	4	0	0	4	0	0
6	28914331	.	A	G	3	4	7	0	1	8	0	0
6	28914336	.	C	T	5	4	9	0	0	9	0	0
6	28914418	.	A	G	11	11	22	0	0	22	0	0
6	28914523	.	G	A	19	8	27	1	1	29	0	0
6	28914571	.	T	A	17	7	24	1	0	25	0	0
6	28914886	.	G	A	13	7	20	0	0	20	0	0
6	28914975	.	T	A	6	7	13	0	0	13	0	0
6	28923667	.	G	A	4	3	7	0	1	8	0	0
6	28926540	.	C	T	9	6	15	0	0	15	0	0
6	28926567	.	T	A	5	6	11	0	4	15	0	0
6	28931184	.	C	T	5	6	11	0	0	11	0	0
6	28932634	.	G	A	8	5	13	0	0	13	0	0
6	28946199	.	T	G	17	22	39	0	2	41	0	0
6	28956323	.	A	G	12	19	31	0	1	32	0	0
6	28957089	.	G	A	14	9	23	0	0	23	0	0
6	28957814	.	C	G	8	12	20	0	1	21	0	0
6	28961407	.	A	G	12	12	24	0	0	24	0	0
6	29011988	.	C	T	5	8	13	0	1	14	0	0
6	29012037	.	A	T	6	6	12	0	3	15	0	0
6	29034576	.	G	C	14	8	22	0	1	23	0	0
6	29040789	.	C	T	1	10	11	0	5	16	0	0
6	29040885	.	C	T	4	6	10	0	10	20	0	0
6	29043162	.	T	G	8	4	12	0	1	13	0	0
6	29043673	.	G	A	3	2	5	0	0	5	0	0
6	29044465	.	A	G	1	4	5	0	0	5	0	0
6	29086613	.	C	T	1	4	5	0	1	6	0	0
6	29087164	.	T	G	26	32	58	0	1	59	0	0
6	29096659	.	A	C	31	25	56	0	7	63	0	0
6	29097297	.	G	A	33	13	46	0	3	49	0	0
6	29097344	.	T	C	22	7	29	0	1	30	0	0
6	29103005	.	G	A	4	3	7	0	1	8	0	0
6	29103419	.	G	A	4	3	7	0	0	7	0	0
6	29143365	.	A	T	4	5	9	0	0	9	0	0
6	29144951	.	T	A	5	4	9	0	4	13	0	0
6	29144952	.	A	T	8	4	12	0	1	13	0	0
6	29145433	.	C	A	2	9	11	0	12	23	0	0
6	29145742	.	T	A	11	10	21	0	1	22	0	0
6	29152208	.	C	T	5	8	13	0	1	14	0	0
6	29152618	.	A	G	6	4	10	0	0	10	0	0
6	29152769	.	G	A	3	5	8	0	0	8	0	0
6	29152819	.	C	T	5	4	9	0	1	10	0	0
6	29154280	.	T	A	6	3	9	0	0	9	0	0
6	29154295	.	T	C	4	0	4	0	7	11	0	0
6	29154520	.	C	T	7	2	9	0	0	9	0	0
6	29154721	.	G	A	4	2	6	0	0	6	0	0
6	29154889	.	C	A	3	3	6	0	2	8	0	0
6	29155039	.	G	A	2	2	4	0	0	4	0	0
6	29221040	.	C	T	9	4	13	0	0	13	0	0
6	29222796	.	A	C	5	9	14	0	0	14	0	0
6	29223651	.	T	C	10	5	15	0	1	16	0	0
6	29226126	.	G	A	2	11	13	0	9	22	0	0
6	29226186	.	A	G	8	20	28	0	1	29	0	0
6	29226189	.	C	T	20	9	29	0	1	30	0	0
6	29226767	.	A	T	14	13	27	0	1	28	0	0
6	29226790	.	G	A	13	16	29	0	0	29	0	0
6	29226823	.	A	C	11	11	22	0	0	22	0	0
6	29273690	.	C	T	6	3	9	0	0	9	0	0
6	29273855	.	G	A	9	6	15	0	2	17	0	0
6	29287954	.	G	A	4	2	6	0	0	6	0	0
6	29288042	.	G	A	3	3	6	0	0	6	0	0
6	29289437	.	G	A	1	7	8	0	0	8	0	0
6	29289625	.	G	A	2	3	5	0	0	5	0	0
6	29289844	.	A	T	1	3	4	0	0	4	0	0
6	29292610	.	A	C	2	6	8	0	0	8	0	0
6	29292651	.	A	G	3	9	12	0	0	12	0	0
6	29292728	.	C	T	3	7	10	0	0	10	0	0
6	29292780	.	G	A	5	7	12	0	0	12	0	0
6	29292804	.	G	A	7	6	13	0	0	13	0	0
6	29292849	.	G	T	6	3	9	0	0	9	0	0
6	29295492	.	T	A	12	4	16	0	1	17	0	0
6	29295517	.	G	C	12	8	20	0	0	20	0	0
6	29295535	.	T	A	10	6	16	0	4	20	0	0
6	29295713	.	C	A	6	9	15	0	1	16	0	0
6	29295714	.	G	A	8	7	15	0	1	16	0	0
6	29295851	.	G	A	9	9	18	0	0	18	0	0
6	29295860	.	C	T	10	7	17	0	1	18	0	0
6	29303573	.	C	T	3	10	13	0	0	13	0	0
6	29303625	.	G	A	7	5	12	0	0	12	0	0
6	29303630	.	G	A	6	7	13	0	0	13	0	0
6	29303778	.	C	T	2	8	10	0	9	19	0	0
6	29303925	.	C	T	2	8	10	0	0	10	0	0
6	29303958	.	C	T	0	5	5	0	5	10	0	0
6	29322547	.	G	A	7	9	16	1	0	17	0	0
6	29328308	.	G	A	12	6	18	0	0	18	0	0
6	29328524	.	A	G	6	5	11	0	0	11	0	0
6	29328866	.	G	A	1	3	4	0	0	4	0	0
6	29330676	.	G	A	3	5	8	0	0	8	0	0
6	29330727	.	A	G	4	6	10	0	0	10	0	0
6	29332546	.	A	T	2	5	7	0	0	7	0	0
6	29336100	.	T	C	3	4	7	0	1	8	0	0
6	29337926	.	A	G	1	4	5	0	0	5	0	0
6	29343892	.	G	A	2	4	6	0	0	6	0	0
6	29347875	.	T	C	3	0	3	0	4	7	0	0
6	29393714	.	C	T	10	7	17	0	0	17	0	0
6	29394244	.	A	T	10	10	20	0	0	20	0	0
6	29395424	.	G	A	12	7	19	0	2	21	0	0
6	29395497	.	T	A	11	11	22	0	0	22	0	0
6	29397697	.	G	A	5	5	10	0	0	10	0	0
6	29401837	.	T	C	6	6	12	0	0	12	0	0
6	29402451	.	C	A	1	5	6	0	8	14	0	0
6	29403052	.	G	T	1	12	13	0	11	24	0	0
6	29403076	.	C	T	22	15	37	0	0	37	0	0
6	29410040	.	C	T	2	3	5	0	1	6	0	0
6	29430755	.	T	C	1	2	3	1	0	4	0	0
6	29434711	.	G	A	2	2	4	0	0	4	0	0
6	29458942	.	T	C	2	5	7	0	0	7	0	0
6	29466626	.	C	A	5	2	7	0	1	8	0	0
6	29466897	.	A	C	1	2	3	0	0	3	0	0
6	29466993	.	T	A	4	2	6	0	0	6	0	0
6	29468013	.	T	C	1	3	4	0	0	4	0	0
6	29468196	.	T	G	1	5	6	0	0	6	0	0
6	29468198	.	C	T	1	5	6	0	0	6	0	0
6	29468320	.	C	T	7	3	10	0	0	10	0	0
6	29468331	.	A	T	7	3	10	0	1	11	0	0
6	29468551	.	A	T	4	2	6	0	0	6	0	0
6	29468556	.	T	G	4	2	6	0	0	6	0	0
6	29468671	.	A	G	6	4	10	0	0	10	0	0
6	29476983	.	C	A	2	6	8	2	0	10	0	0
6	29477526	.	C	T	2	4	6	0	0	6	0	0
6	29477962	.	C	T	3	3	6	0	0	6	0	0
6	29477989	.	C	T	0	2	2	0	1	3	0	0
6	29488641	.	C	T	1	3	4	0	0	4	0	0
6	29705343	.	C	T	14	6	20	0	0	20	0	0
6	29705561	.	A	T	11	10	21	0	2	23	0	0
6	29705614	.	G	A	3	7	10	0	3	13	0	0
6	29705901	.	T	C	3	3	6	1	0	7	0	0
6	29708100	.	C	T	11	3	14	0	2	16	0	0
6	29710252	.	T	C	10	14	24	0	0	24	0	0
6	29713920	.	G	T	11	5	16	0	0	16	0	0
6	29713926	.	T	C	9	5	14	0	0	14	0	0
6	29714017	.	A	G	5	5	10	0	1	11	0	0
6	29714054	.	A	C	4	4	8	0	0	8	0	0
6	29714064	.	C	T	4	3	7	0	0	7	0	0
6	29754191	.	T	G	1	6	7	0	0	7	0	0
6	29793814	.	C	T	26	44	70	0	8	78	0	0
6	29794003	.	T	G	41	38	79	0	1	80	0	0
6	29794042	.	G	A	37	35	72	0	2	74	0	0
6	29794695	.	T	C	23	32	55	1	4	60	0	0
6	30027896	.	C	A	22	8	30	0	0	30	0	0
6	30032574	.	A	G	12	0	12	0	9	21	0	0
6	30048285	.	A	G	4	0	4	0	4	8	0	0
6	30052061	.	C	A	15	20	35	0	1	36	0	0
6	30052085	.	A	G	20	21	41	0	2	43	0	0
6	30060296	.	C	T	15	23	38	0	2	40	0	0
6	30081420	.	C	T	20	10	30	0	6	36	0	0
6	30081421	.	T	C	19	10	29	0	6	35	0	0
6	30081503	.	A	G	24	19	43	0	0	43	0	0
6	30081725	.	C	T	18	16	34	1	1	36	0	0
6	30082838	.	G	T	9	8	17	0	2	19	0	0
6	30124575	.	C	T	21	16	37	0	2	39	0	0
6	30133958	.	G	T	13	18	31	0	8	39	0	0
6	30134052	.	C	T	5	10	15	0	29	44	0	0
6	30147249	.	T	C	30	0	30	0	15	45	0	0
6	30148182	.	G	A	7	11	18	0	1	19	0	0
6	30148422	.	C	T	7	15	22	0	3	25	0	0
6	30148863	.	T	C	10	12	22	0	2	24	0	0
6	30151519	.	G	A	11	11	22	0	1	23	0	0
6	30151537	.	G	A	11	12	23	0	0	23	0	0
6	30160956	.	C	T	9	10	19	0	0	19	0	0
6	30177635	.	G	A	8	5	13	0	1	14	0	0
6	30177724	.	G	A	7	2	9	0	0	9	0	0
6	30177742	.	T	C	2	8	10	0	0	10	0	0
6	30431878	.	G	A	0	1	1	0	2	3	0	0
6	30433337	.	T	A	1	2	3	0	0	3	0	0
6	30434201	.	G	A	2	2	4	0	1	5	0	0
6	30440099	.	A	C	4	3	7	0	0	7	0	0
6	30441589	.	C	G	2	4	6	0	0	6	0	0
6	30441762	.	G	A	3	4	7	0	0	7	0	0
6	30450458	.	T	C	3	4	7	0	0	7	0	0
6	30452540	.	T	G	5	0	5	0	6	11	0	0
6	30452573	.	C	T	5	5	10	0	0	10	0	0
6	30452669	.	A	T	2	3	5	0	0	5	0	0
6	30452811	.	C	T	0	1	1	0	1	2	0	0
6	30452829	.	C	T	2	1	3	0	0	3	0	0
6	30452932	.	G	C	3	5	8	0	0	8	0	0
6	30579371	.	A	T	2	4	6	0	1	7	0	0
6	30583746	.	A	G	1	0	1	0	3	5	1	0
6	30587201	.	T	A	1	2	3	0	0	3	0	0
6	30626630	.	T	G	8	7	15	0	1	16	0	0
6	30626908	.	G	A	9	13	22	1	0	23	0	0
6	30626931	.	T	C	6	11	17	1	1	19	0	0
6	30627182	.	T	A	11	8	19	0	1	20	0	0
6	30627228	.	A	C	19	14	33	0	0	33	0	0
6	30627549	.	G	A	7	22	29	0	0	29	0	0
6	30627674	.	G	T	12	11	23	0	1	24	0	0
6	30627764	.	G	T	13	10	23	0	1	24	0	0
6	30627807	.	G	T	4	14	18	0	1	19	0	0
6	30628066	.	T	C	11	12	23	0	0	23	0	0
6	30628097	.	C	T	11	9	20	0	2	22	0	0
6	30628185	.	G	A	5	13	18	0	0	18	0	0
6	30628447	.	G	A	3	12	15	0	0	15	0	0
6	30628459	.	A	G	4	11	15	0	0	15	0	0
6	30628651	.	G	A	3	6	9	0	0	9	0	0
6	30628684	.	C	A	6	10	16	0	1	17	0	0
6	30628848	.	C	T	7	6	13	0	1	14	0	0
6	30628976	.	T	A	10	11	21	0	0	21	0	0
6	30628978	.	C	T	12	9	21	0	1	22	0	0
6	30629142	.	G	A	10	7	17	0	0	17	0	0
6	30629229	.	T	A	3	6	9	0	0	9	0	0
6	30629373	.	A	T	3	3	6	0	2	8	0	0
6	30629384	.	T	C	4	0	4	0	2	6	0	0
6	30629553	.	C	T	0	5	5	0	9	14	0	0
6	30629734	.	A	G	2	3	5	0	2	7	0	0
6	30629827	.	C	A	7	3	10	0	0	10	0	0
6	30630017	.	C	T	1	3	4	0	5	9	0	0
6	30630454	.	T	G	4	7	11	0	1	12	0	0
6	30630811	.	T	C	6	11	17	0	1	18	0	0
6	30630904	.	A	G	10	7	17	0	0	17	0	0
6	30658102	.	T	C	6	3	9	0	0	9	0	0
6	30658524	.	T	C	4	5	9	0	1	10	0	0
6	30658545	.	G	A	6	7	13	0	0	13	0	0
6	30658728	.	A	C	7	3	10	0	0	10	0	0
6	30677475	.	A	G	1	6	7	0	0	7	0	0
6	30677582	.	T	C	9	4	13	0	0	13	0	0
6	30677602	.	A	T	6	6	12	0	3	15	0	0
6	30677646	.	A	G	7	5	12	0	1	13	0	0
6	30677701	.	C	T	0	6	6	0	4	10	0	0
6	30677734	.	A	C	4	0	4	0	6	10	0	0
6	30678133	.	A	T	2	4	6	0	0	6	0	0
6	30681291	.	C	A	3	4	7	0	0	7	0	0
6	30683571	.	T	A	4	7	11	0	0	11	0	0
6	30683578	.	T	C	4	8	12	0	0	12	0	0
6	30685078	.	A	T	3	2	5	0	0	5	0	0
6	30685311	.	A	G	2	2	4	0	0	4	0	0
6	30685353	.	T	C	1	5	6	0	0	6	0	0
6	30685354	.	G	A	1	5	6	0	0	6	0	0
6	30688021	.	A	G	1	3	4	0	0	4	0	0
6	30700657	.	G	A	1	4	5	0	0	5	0	0
6	30710313	.	C	A	25	19	44	0	0	44	0	0
6	30710591	.	G	A	2	8	10	0	0	10	0	0
6	30711447	.	C	T	8	5	13	0	0	13	0	0
6	30711485	.	A	T	20	9	29	0	2	31	0	0
6	30711511	.	C	T	19	14	33	0	1	34	0	0
6	30711554	.	C	T	2	16	18	0	12	30	0	0
6	30711586	.	A	C	22	1	23	0	16	39	0	0
6	30711612	.	G	A	20	19	39	0	4	43	0	0
6	30711777	.	C	T	20	20	40	1	0	41	0	0
6	30712121	.	G	T	21	14	35	1	4	40	0	0
6	30712458	.	A	G	11	8	19	0	0	19	0	0
6	30712508	.	G	A	17	10	27	0	0	27	0	0
6	30712616	.	C	T	0	5	5	0	13	18	0	0
6	30712622	.	A	G	10	9	19	3	2	24	0	0
6	30712883	.	A	C	23	8	31	1	3	35	0	0
6	30713184	.	T	A	11	16	27	0	2	29	0	0
6	30713334	.	G	C	11	8	19	1	0	20	0	0
6	30713341	.	G	A	8	10	18	1	0	19	0	0
6	30713647	.	C	T	7	3	10	0	1	11	0	0
6	30713910	.	C	T	19	11	30	0	4	34	0	0
6	30713929	.	C	G	18	22	40	0	2	42	0	0
6	30714177	.	T	A	11	6	17	0	1	18	0	0
6	30715647	.	A	T	14	9	23	0	2	25	0	0
6	30715865	.	A	T	17	12	29	0	2	31	0	0
6	30719348	.	G	C	8	6	14	0	0	14	0	0
6	30719391	.	A	T	15	8	23	0	1	24	0	0
6	30719935	.	C	T	12	9	21	0	0	21	0	0
6	30721397	.	G	A	8	11	19	0	0	19	0	0
6	30740160	.	C	A	1	3	4	0	1	5	0	0
6	30851611	.	A	T	5	4	9	0	1	10	0	0
6	30853053	.	T	A	36	29	65	0	2	67	0	0
6	30855423	.	G	A	15	11	26	0	0	26	0	0
6	30859381	.	T	A	13	12	25	0	2	27	0	0
6	30931362	.	C	T	0	5	5	0	4	9	0	0
6	30931476	.	A	T	1	4	5	0	0	5	0	0
6	30931479	.	T	C	0	0	0	0	5	5	0	0
6	31146723	.	G	A	5	3	8	0	0	8	0	0
6	31184478	.	A	G	3	8	11	0	1	12	0	0
6	31184532	.	T	C	6	6	12	0	0	12	0	0
6	31184952	.	T	C	1	2	3	0	1	4	0	0
6	31185133	.	G	A	10	4	14	0	0	14	0	0
6	31185247	.	C	G	3	8	11	0	1	12	0	0
6	31185292	.	A	C	3	4	7	0	1	8	0	0
6	31186563	.	T	A	4	2	6	0	0	6	0	0
6	31186737	.	A	C	3	4	7	0	0	7	0	0
6	31186794	.	G	A	1	2	3	0	2	5	0	0
6	31186981	.	G	A	3	6	9	0	0	9	0	0
6	31214421	.	C	G	1	2	3	0	0	3	0	0
6	31279834	.	G	A	16	13	29	0	2	31	0	0
6	31280141	.	G	A	22	17	39	0	1	40	0	0
6	31280185	.	T	A	20	15	35	0	2	37	0	0
6	31280495	.	C	T	13	10	23	0	1	24	0	0
6	31280586	.	A	G	12	21	33	1	3	37	0	0
6	31280646	.	A	C	13	10	23	0	0	23	0	0
6	31280681	.	C	A	10	13	23	0	0	23	0	0
6	31280936	.	A	T	12	12	24	0	2	26	0	0
6	31281006	.	C	T	1	8	9	0	16	25	0	0
6	31281130	.	A	G	25	23	48	0	3	51	0	0
6	31281304	.	C	A	13	30	43	0	3	46	0	0
6	31281481	.	A	G	7	2	9	0	0	9	0	0
6	31281533	.	T	A	7	10	17	0	0	17	0	0
6	31281537	.	A	G	8	9	17	0	1	18	0	0
6	31281594	.	A	T	19	12	31	0	1	32	0	0
6	31281694	.	C	T	7	10	17	0	3	20	0	0
6	31281994	.	T	A	11	9	20	0	0	20	0	0
6	31282028	.	T	G	11	5	16	0	2	18	0	0
6	31282170	.	T	C	5	0	5	0	5	10	0	0
6	31282205	.	C	T	8	5	13	0	0	13	0	0
6	31282710	.	A	T	1	3	4	0	0	4	0	0
6	31283049	.	C	A	6	4	10	0	2	12	0	0
6	31283055	.	G	A	8	5	13	0	1	14	0	0
6	31283245	.	A	G	13	10	23	1	2	26	0	0
6	31283280	.	T	A	13	8	21	1	1	23	0	0
6	31309823	.	C	T	1	5	6	0	5	11	0	0
6	31336156	.	G	A	7	8	15	0	0	15	0	0
6	31352298	.	T	A	13	9	22	0	1	23	0	0
6	31352406	.	C	A	10	15	25	0	1	26	0	0
6	31352556	.	G	A	11	6	17	0	0	17	0	0
6	31352635	.	T	G	6	3	9	0	0	9	0	0
6	31352664	.	C	T	4	4	8	0	0	8	0	0
6	31353022	.	G	C	12	8	20	0	2	22	0	0
6	31353345	.	T	A	10	12	22	0	0	22	0	0
6	31353451	.	A	T	9	6	15	0	0	15	0	0
6	31355787	.	C	T	15	8	23	0	0	23	0	0
6	31358525	.	C	T	1	11	12	0	10	22	0	0
6	31395835	.	G	A	2	3	5	0	0	5	0	0
6	31405923	.	C	T	2	2	4	0	0	4	0	0
6	31411751	.	C	T	6	3	9	0	1	10	0	0
6	31414061	.	A	C	7	3	10	0	0	10	0	0
6	31417667	.	C	T	6	4	10	0	0	10	0	0
6	31419749	.	T	C	2	3	5	0	1	6	0	0
6	31426246	.	A	G	10	0	10	0	8	18	0	0
6	31426727	.	C	G	5	9	14	0	0	14	0	0
6	31426881	.	C	T	14	11	25	0	2	27	0	0
6	31426886	.	C	T	12	12	24	0	1	25	0	0
6	31427226	.	C	T	5	3	8	0	0	8	0	0
6	31427261	.	T	C	7	6	13	0	0	13	0	0
6	31427468	.	A	G	7	10	17	0	0	17	0	0
6	31427646	.	A	T	7	7	14	0	0	14	0	0
6	31428283	.	C	A	17	11	28	1	0	29	0	0
6	31428448	.	T	A	1	4	5	0	0	5	0	0
6	31428565	.	T	G	5	4	9	0	0	9	0	0
6	31428566	.	A	G	4	4	8	0	1	9	0	0
6	31428705	.	C	T	19	7	26	0	2	28	0	0
6	31431355	.	G	A	10	13	23	0	2	25	0	0
6	31431520	.	A	G	17	13	30	0	0	30	0	0
6	31431775	.	T	C	15	13	28	0	3	31	0	0
6	31431870	.	G	A	19	10	29	0	1	30	0	0
6	31431926	.	A	T	22	19	41	0	1	42	0	0
6	31432302	.	G	A	7	3	10	0	0	10	0	0
6	31432554	.	A	T	5	4	9	0	0	9	0	0
6	31432563	.	T	C	5	5	10	0	0	10	0	0
6	31432617	.	T	G	7	3	10	0	0	10	0	0
6	31432679	.	T	A	4	3	7	0	0	7	0	0
6	31432684	.	T	C	3	4	7	0	0	7	0	0
6	31432881	.	C	T	0	7	7	3	8	18	0	0
6	31432950	.	G	A	5	6	11	4	0	15	0	0
6	31432955	.	T	C	4	5	9	2	0	11	0	0
6	31433341	.	G	A	10	3	13	0	0	13	0	0
6	31433412	.	A	G	3	2	5	0	0	5	0	0
6	31433572	.	T	A	8	6	14	0	0	14	0	0
6	31433692	.	A	T	2	6	8	0	0	8	0	0
6	31433846	.	G	A	2	3	5	0	0	5	0	0
6	31434050	.	C	A	5	3	8	0	0	8	0	0
6	31434245	.	A	T	5	6	11	0	0	11	0	0
6	31434554	.	G	A	4	2	6	0	0	6	0	0
6	31434830	.	A	G	6	7	13	0	0	13	0	0
6	31434923	.	C	T	1	5	6	0	4	10	0	0
6	31435017	.	C	T	3	4	7	0	3	10	0	0
6	31441574	.	A	T	9	10	19	0	0	19	0	0
6	31462606	.	G	A	2	2	4	0	0	4	0	0
6	31463147	.	A	T	5	2	7	0	0	7	0	0
6	31470029	.	G	C	2	0	2	0	3	5	0	0
6	31470041	.	T	C	2	5	7	0	1	8	0	0
6	31591116	.	C	T	7	4	11	0	7	18	0	0
6	31591452	.	C	T	5	9	14	0	0	14	0	0
6	31591838	.	T	G	12	18	30	0	1	31	0	0
6	31591841	.	G	A	16	10	26	0	5	31	0	0
6	31591883	.	C	T	0	3	3	0	22	25	0	0
6	31591997	.	A	C	15	0	15	0	19	34	0	0
6	31598783	.	C	T	15	8	23	0	3	26	0	0
6	31624107	.	T	C	3	7	10	0	2	12	0	0
6	31625714	.	C	T	1	4	5	0	0	5	0	0
6	31627223	.	G	A	3	4	7	0	0	7	0	0
6	32010215	.	C	T	4	2	6	0	1	7	0	0
6	32010259	.	G	A	8	4	12	0	0	12	0	0
6	32010341	.	C	T	5	17	22	0	17	39	0	0
6	32010475	.	A	G	23	25	48	0	7	55	0	0
6	32014771	.	T	G	27	20	47	0	2	49	0	0
6	32016492	.	T	C	18	11	29	0	1	30	0	0
6	32020326	.	G	A	7	7	14	0	1	15	0	0
6	32020327	.	T	A	4	6	10	0	4	14	0	0
6	32024960	.	C	T	7	3	10	1	2	13	0	0
6	32025005	.	C	T	0	3	3	0	4	7	0	0
6	32025109	.	C	A	9	11	20	0	2	22	0	0
6	32032371	.	A	C	8	8	16	0	1	17	0	0
6	32032479	.	C	T	7	6	13	1	2	16	0	0
6	32040581	.	G	A	2	5	7	0	0	7	0	0
6	32040620	.	G	A	3	3	6	0	0	6	0	0
6	32042325	.	C	T	5	4	9	0	0	9	0	0
6	32042381	.	G	A	6	6	12	0	0	13	1	0
6	32042501	.	G	A	4	6	10	0	0	10	0	0
6	32043513	.	G	C	2	2	4	0	0	4	0	0
6	32043514	.	G	T	3	2	5	0	0	5	0	0
6	32065310	.	C	T	3	4	7	0	1	8	0	0
6	32068411	.	G	C	1	3	4	0	0	4	0	0
6	32068488	.	G	A	3	5	8	0	0	8	0	0
6	32071935	.	G	A	2	4	6	0	0	6	0	0
6	32092825	.	C	T	0	2	2	0	3	5	0	0
6	32092853	.	G	A	1	2	3	0	1	4	0	0
6	32300717	.	G	A	3	2	5	0	0	5	0	0
6	32301137	.	A	T	7	3	10	0	0	10	0	0
6	32301161	.	C	T	4	6	10	0	0	10	0	0
6	32301214	.	A	T	7	6	13	0	1	14	0	0
6	32301265	.	A	T	7	6	13	0	2	15	0	0
6	32301462	.	C	T	6	4	10	0	0	10	0	0
6	32301487	.	G	C	2	4	6	0	0	6	0	0
6	32301900	.	C	G	0	3	3	0	1	4	0	0
6	32302236	.	C	T	0	6	6	0	4	10	0	0
6	32314240	.	G	A	3	3	6	0	0	6	0	0
6	32339831	.	C	A	4	3	7	0	1	8	0	0
6	32340005	.	C	T	1	4	5	0	0	5	0	0
6	32344428	.	T	A	3	2	5	0	0	5	0	0
6	32345039	.	G	A	3	2	5	0	0	5	0	0
6	32359371	.	A	G	1	2	3	0	0	3	0	0
6	32359470	.	G	A	2	2	4	0	0	4	0	0
6	32364439	.	C	T	3	4	7	0	0	7	0	0
6	32375838	.	T	C	8	4	12	0	0	12	0	0
6	32382629	.	C	T	6	7	13	0	0	13	0	0
6	32397588	.	C	T	20	20	40	0	3	43	0	0
6	32398844	.	G	A	18	17	35	0	1	36	0	0
6	32403028	.	G	A	8	21	29	0	6	35	0	0
6	32403052	.	T	C	13	15	28	0	2	30	0	0
6	32404206	.	C	G	11	11	22	0	2	24	0	0
6	32404863	.	C	T	0	11	11	0	3	14	0	0
6	32405020	.	G	A	9	15	24	0	0	24	0	0
6	32405266	.	G	A	3	6	9	0	2	11	0	0
6	32405478	.	A	T	3	3	6	0	0	6	0	0
6	32405741	.	A	T	5	5	10	0	0	10	0	0
6	32405784	.	A	G	4	7	11	0	0	11	0	0
6	32405952	.	C	T	8	3	11	0	0	11	0	0
6	32406216	.	G	A	13	5	18	0	1	19	0	0
6	32408299	.	G	A	4	2	6	0	0	6	0	0
6	32408437	.	C	T	1	2	3	0	5	8	0	0
6	32408742	.	A	T	4	4	8	0	1	9	0	0
6	32409301	.	G	A	4	2	6	0	0	6	0	0
6	32409490	.	T	A	1	7	8	0	2	10	0	0
6	32409931	.	A	G	1	2	3	0	0	3	0	0
6	32481835	.	G	A	2	3	5	0	0	5	0	0
6	32481868	.	G	A	1	3	4	0	0	4	0	0
6	32481998	.	T	C	3	4	7	0	0	7	0	0
6	32482376	.	G	A	2	2	4	0	0	4	0	0
6	32482727	.	G	A	2	2	4	0	0	4	0	0
6	32482984	.	C	T	1	2	3	0	0	3	0	0
6	32483265	.	A	G	1	2	3	0	0	3	0	0
6	32483750	.	T	C	6	4	10	0	1	11	0	0
6	32493039	.	C	A	1	4	5	0	0	5	0	0
6	32493103	.	C	T	1	2	3	0	0	3	0	0
6	32497690	.	A	G	5	6	11	0	0	11	0	0
6	32504356	.	C	T	5	6	11	0	1	12	0	0
6	32506349	.	T	A	7	10	17	0	1	18	0	0
6	32506386	.	C	T	11	7	18	0	0	18	0	0
6	32506473	.	G	A	2	6	8	0	6	14	0	0
6	32506526	.	A	G	3	6	9	0	0	9	0	0
6	32699666	.	G	A	7	4	11	0	0	11	0	0
6	32699682	.	T	A	5	7	12	0	0	12	0	0
6	32699775	.	A	C	10	0	10	0	6	16	0	0
6	32699870	.	A	T	6	3	9	0	0	9	0	0
6	32700064	.	A	G	3	1	4	0	2	6	0	0
6	32700069	.	G	A	2	4	6	0	1	7	0	0
6	32700607	.	T	G	5	2	7	0	0	7	0	0
6	32702198	.	C	T	4	6	10	0	0	10	0	0
6	32722640	.	C	T	0	9	9	0	7	16	0	0
6	32722680	.	A	T	6	7	13	0	1	14	0	0
6	32773726	.	T	C	6	0	6	0	5	11	0	0
6	32830082	.	T	C	4	2	6	0	2	8	0	0
6	32830083	.	A	G	3	4	7	0	1	8	0	0
6	32831529	.	C	T	0	3	3	0	1	4	0	0
6	32831787	.	T	G	3	2	5	0	0	5	0	0
6	32831871	.	G	T	1	2	3	0	0	3	0	0
6	32831881	.	C	T	1	2	3	0	0	3	0	0
6	32831927	.	G	A	2	2	4	0	0	4	0	0
6	32832113	.	G	A	1	6	7	0	0	7	0	0
6	32832166	.	T	C	2	0	2	0	3	5	0	0
6	32832409	.	G	T	5	3	8	0	0	8	0	0
6	32832662	.	A	G	2	4	6	0	0	6	0	0
6	32883071	.	A	T	1	2	3	0	0	3	0	0
6	32883097	.	G	A	1	3	4	0	0	4	0	0
6	32966915	.	G	C	9	13	22	0	1	23	0	0
6	32967065	.	C	T	8	12	20	0	0	20	0	0
6	32967080	.	T	C	10	11	21	0	0	21	0	0
6	32967174	.	G	A	12	8	20	0	0	20	0	0
6	32967182	.	A	T	12	9	21	0	0	21	0	0
6	32967357	.	G	A	11	10	21	0	2	23	0	0
6	32969517	.	G	A	1	3	4	0	1	5	0	0
6	32970032	.	G	A	4	7	11	0	0	11	0	0
6	32979285	.	A	C	2	4	6	0	0	6	0	0
6	33023389	.	T	A	6	2	8	0	0	8	0	0
6	33023439	.	G	A	5	3	8	0	0	8	0	0
6	33023545	.	T	C	4	0	4	0	7	11	0	0
6	33023601	.	A	G	2	4	6	0	0	6	0	0
6	33023625	.	G	C	3	2	5	0	0	5	0	0
6	33077446	.	T	C	1	4	5	0	0	5	0	0
6	33083415	.	G	A	2	3	5	0	0	5	0	0
6	33085555	.	G	T	3	2	5	0	0	5	0	0
6	33085558	.	G	T	2	3	5	0	0	5	0	0
6	33085730	.	G	A	2	4	6	0	0	6	0	0
6	33089139	.	G	A	1	3	4	0	6	10	0	0
6	33089475	.	G	A	2	2	4	0	0	4	0	0
6	33092969	.	A	C	2	4	6	0	0	6	0	0
6	33094767	.	A	C	5	3	8	0	1	9	0	0
6	33095174	.	G	A	5	1	6	0	1	7	0	0
6	33095499	.	T	C	1	3	4	0	0	4	0	0
6	33548919	.	A	G	9	3	12	0	0	12	0	0
6	33549187	.	T	G	7	0	7	0	6	13	0	0
6	33553084	.	G	A	5	2	7	0	1	8	0	0
6	33554433	.	A	T	14	6	20	0	0	20	0	0
6	33554435	.	C	T	12	5	17	0	0	18	1	0
6	33555159	.	G	A	1	6	7	0	5	12	0	0
6	33555168	.	C	T	5	7	12	0	0	12	0	0
6	33555570	.	G	A	8	11	19	0	0	19	0	0
6	33555594	.	T	C	4	5	9	0	0	9	0	0
6	33555691	.	T	G	1	0	1	0	5	6	0	0
6	33555736	.	G	T	5	6	11	0	1	12	0	0
6	33555952	.	T	A	10	17	27	0	1	28	0	0
6	33556036	.	T	A	10	7	17	0	2	19	0	0
6	33556316	.	C	T	12	12	24	0	1	25	0	0
6	33556424	.	A	G	7	15	22	0	0	22	0	0
6	33556441	.	G	A	18	9	27	0	0	27	0	0
6	33556493	.	A	T	1	21	22	0	1	23	0	0
6	33556497	.	A	T	14	11	25	0	5	30	0	0
6	33556706	.	G	C	13	15	28	0	2	30	0	0
6	33556877	.	G	A	1	18	19	0	18	37	0	0
6	33556968	.	G	C	15	9	24	0	2	26	0	0
6	33557077	.	G	A	3	6	9	0	10	19	0	0
6	33557141	.	G	C	10	15	25	0	0	25	0	0
6	33557438	.	T	A	10	5	15	0	1	16	0	0
6	33557625	.	C	T	22	21	43	0	3	46	0	0
6	33558437	.	G	A	21	23	44	0	1	45	0	0
6	33558711	.	G	C	18	18	36	0	1	37	0	0
6	33558837	.	C	T	7	8	15	0	0	15	0	0
6	33663690	.	T	C	5	14	19	0	1	20	0	0
6	33663701	.	T	C	14	7	21	0	2	23	0	0
6	33663839	.	C	T	2	14	16	0	16	32	0	0
6	33664182	.	A	G	6	12	18	0	1	19	0	0
6	33664556	.	C	T	2	6	8	0	0	8	0	0
6	33664801	.	A	G	6	8	14	0	0	14	0	0
6	33664899	.	G	A	14	7	21	1	0	22	0	0
6	33664917	.	C	T	2	12	14	0	6	20	0	0
6	33665123	.	T	G	13	11	24	0	0	24	0	0
6	33665320	.	G	A	7	3	10	0	0	10	0	0
6	33665327	.	C	T	6	2	8	0	0	8	0	0
6	33665734	.	C	T	7	11	18	0	1	19	0	0
6	33665867	.	G	T	14	10	24	0	0	24	0	0
6	33665968	.	C	T	8	17	25	0	0	25	0	0
6	33666166	.	G	A	10	9	19	0	1	20	0	0
6	33666302	.	C	A	4	7	11	0	1	12	0	0
6	33666308	.	G	A	4	8	12	0	2	14	0	0
6	33666472	.	G	T	9	20	29	0	0	30	1	0
6	33666578	.	G	T	15	9	24	0	0	24	0	0
6	33666631	.	C	T	16	5	21	0	1	22	0	0
6	33666715	.	C	A	14	16	30	0	1	31	0	0
6	33666733	.	A	G	16	17	33	0	0	33	0	0
6	33666871	.	A	T	11	4	15	0	1	16	0	0
6	33666910	.	G	T	11	7	18	0	0	18	0	0
6	33667006	.	C	T	7	3	10	1	0	11	0	0
6	33667056	.	T	C	6	1	7	1	9	17	0	0
6	33667180	.	C	T	1	3	4	0	4	8	0	0
6	33667234	.	T	A	3	8	11	0	1	12	0	0
6	33667345	.	G	C	5	6	11	0	0	11	0	0
6	33667369	.	G	A	8	3	11	0	0	11	0	0
6	33667492	.	G	T	9	6	15	0	9	24	0	0
6	33668228	.	A	T	5	6	11	0	0	11	0	0
6	33668729	.	A	T	5	4	9	0	0	9	0	0
6	33669168	.	G	C	3	0	3	0	3	6	0	0
6	33669460	.	A	C	3	9	12	0	0	12	0	0
6	33672116	.	C	A	1	2	3	0	0	3	0	0
6	33673964	.	A	G	1	2	3	0	0	3	0	0
6	33683882	.	A	G	2	2	4	0	0	4	0	0
6	33683885	.	T	A	2	2	4	0	0	4	0	0
6	33694269	.	G	A	3	2	5	1	1	7	0	0
6	33875746	.	T	A	2	2	4	0	0	4	0	0
6	33875902	.	C	T	0	2	2	0	4	6	0	0
6	33875954	.	A	G	5	3	8	0	0	8	0	0
6	33883580	.	C	T	2	5	7	0	0	7	0	0
6	33896399	.	T	A	23	23	46	0	1	47	0	0
6	33896457	.	A	G	21	21	42	0	4	46	0	0
6	33896538	.	T	C	28	17	45	0	4	49	0	0
6	33896562	.	A	G	27	14	41	0	2	43	0	0
6	33896615	.	G	A	4	13	17	0	20	37	0	0
6	33896620	.	C	T	15	19	34	0	1	35	0	0
6	33897505	.	G	A	13	9	22	0	2	24	0	0
6	33910573	.	T	G	3	2	5	0	0	5	0	0
6	33910770	.	A	G	1	3	4	0	0	4	0	0
6	33912228	.	G	T	8	9	17	0	0	17	0	0
6	33912708	.	A	C	8	0	8	0	5	13	0	0
6	33914024	.	C	T	1	4	5	0	0	5	0	0
6	33916648	.	T	C	1	1	2	0	2	4	0	0
6	33918858	.	G	T	2	2	4	0	0	4	0	0
6	33921298	.	C	T	6	10	16	0	1	17	0	0
6	33921511	.	G	A	6	5	11	0	0	11	0	0
6	33921631	.	A	G	6	4	10	0	0	10	0	0
6	33923900	.	C	T	6	2	8	0	1	9	0	0
6	33924622	.	A	T	8	4	12	0	0	12	0	0
6	33924693	.	A	G	4	6	10	0	1	11	0	0
6	33927040	.	A	T	8	9	17	0	2	19	0	0
6	33927271	.	G	T	17	6	23	0	1	24	0	0
6	33931582	.	T	C	4	10	14	0	0	14	0	0
6	33982662	.	C	G	0	3	3	0	1	4	0	0
6	33982683	.	C	T	3	2	5	0	0	5	0	0
6	33982936	.	A	T	2	2	4	0	0	4	0	0
6	33982947	.	A	G	3	2	5	1	0	6	0	0
6	33984216	.	T	A	4	2	6	0	0	6	0	0
6	34039046	.	T	A	1	2	3	0	0	3	0	0
6	34072117	.	A	G	1	3	4	0	0	4	0	0
6	34806307	.	T	C	2	5	7	0	0	7	0	0
6	34806407	.	G	A	6	6	12	0	0	12	0	0
6	34806893	.	A	T	5	3	8	0	0	8	0	0
6	34807605	.	C	G	1	2	3	0	0	3	0	0
6	34807640	.	A	C	1	2	3	0	0	3	0	0
6	34807999	.	G	T	6	5	11	0	1	12	0	0
6	34808517	.	A	G	3	2	5	0	0	5	0	0
6	34808591	.	G	A	7	6	13	0	0	13	0	0
6	34808754	.	C	T	5	10	15	0	0	15	0	0
6	34808821	.	G	A	6	5	11	0	1	12	0	0
6	34809697	.	C	G	6	1	7	0	12	19	0	0
6	34810495	.	G	A	3	7	10	0	17	27	0	0
6	34810748	.	A	C	11	11	22	0	0	22	0	0
6	34810763	.	T	A	12	13	25	0	0	25	0	0
6	34810896	.	G	A	13	5	18	0	0	18	0	0
6	34810908	.	T	C	4	10	14	0	0	14	0	0
6	34811130	.	A	T	10	3	13	0	1	14	0	0
6	34811175	.	T	C	9	11	20	0	1	21	0	0
6	34825949	.	C	T	3	2	5	0	0	5	0	0
6	34825955	.	C	T	1	2	3	0	3	6	0	0
6	34826051	.	T	C	4	4	8	0	0	8	0	0
6	34826214	.	G	A	6	5	11	0	1	12	0	0
6	34826598	.	G	A	1	2	3	1	2	6	0	0
6	34826870	.	G	A	2	9	11	0	0	11	0	0
6	34826882	.	T	G	3	12	15	0	1	16	0	0
6	34828893	.	A	T	9	10	19	0	0	19	0	0
6	34831124	.	A	C	2	0	2	0	3	5	0	0
6	34856516	.	A	T	2	2	4	0	0	4	0	0
6	34931646	.	G	A	18	13	31	0	1	32	0	0
6	34931911	.	C	T	24	30	54	0	2	56	0	0
6	34931912	.	C	T	24	28	52	0	4	56	0	0
6	34933574	.	C	T	28	31	59	0	1	60	0	0
6	34934903	.	G	T	27	28	55	0	3	58	0	0
6	34943714	.	G	A	7	4	11	0	0	11	0	0
6	34943760	.	A	G	5	3	8	0	0	8	0	0
6	34944523	.	G	A	7	5	12	0	0	12	0	0
6	34947195	.	T	A	4	6	10	0	0	10	0	0
6	34947415	.	G	A	3	4	7	0	0	7	0	0
6	35036320	.	C	T	6	3	9	0	0	9	0	0
6	35036459	.	A	T	7	7	14	0	0	14	0	0
6	35036463	.	T	C	6	0	6	0	7	13	0	0
6	35036520	.	A	G	7	6	13	0	0	13	0	0
6	35036525	.	T	G	5	4	9	0	3	12	0	0
6	35036755	.	T	A	6	6	12	0	0	12	0	0
6	35039912	.	G	T	4	3	7	0	0	7	0	0
6	35039966	.	C	T	8	4	12	0	0	12	0	0
6	35042176	.	C	T	3	2	5	0	0	5	0	0
6	35042201	.	A	G	3	4	7	0	0	7	0	0
6	35046783	.	G	A	1	4	5	0	0	5	0	0
6	35046852	.	T	C	6	5	11	0	0	11	0	0
6	35046894	.	A	G	2	6	8	0	0	8	0	0
6	35051403	.	T	G	3	2	5	0	0	5	0	0
6	35053090	.	T	G	2	2	4	0	0	4	0	0
6	35053243	.	G	A	3	4	7	0	0	7	0	0
6	35053250	.	A	G	3	4	7	0	0	7	0	0
6	35056787	.	A	G	3	4	7	0	0	7	0	0
6	35058456	.	C	T	3	5	8	0	1	9	0	0
6	35058696	.	A	G	4	2	6	0	0	6	0	0
6	35058850	.	A	G	4	3	7	0	0	7	0	0
6	35060983	.	G	T	3	2	5	0	1	6	0	0
6	35060985	.	C	A	3	2	5	0	1	6	0	0
6	35099980	.	T	C	1	4	5	0	0	5	0	0
6	35100084	.	G	A	5	8	13	0	0	13	0	0
6	35100230	.	T	A	10	7	17	0	1	18	0	0
6	35100423	.	C	T	7	2	9	0	1	10	0	0
6	35100442	.	T	C	5	2	7	0	2	9	0	0
6	35100528	.	A	G	5	8	13	0	0	13	0	0
6	35100795	.	C	G	0	5	5	0	8	13	0	0
6	35100801	.	T	G	8	6	14	0	1	15	0	0
6	35100857	.	A	G	9	5	14	0	3	17	0	0
6	35100868	.	T	A	9	7	16	0	0	16	0	0
6	35100894	.	C	T	1	9	10	0	3	13	0	0
6	35100933	.	A	G	5	8	13	1	0	14	0	0
6	35101184	.	A	T	8	3	11	0	0	11	0	0
6	35101605	.	C	G	3	2	5	0	0	5	0	0
6	35101696	.	C	T	2	2	4	0	0	4	0	0
6	35101703	.	T	G	2	3	5	0	0	5	0	0
6	35102174	.	G	T	3	4	7	0	0	7	0	0
6	35102178	.	A	C	3	4	7	0	0	7	0	0
6	35102225	.	A	G	5	1	6	0	1	7	0	0
6	35102555	.	G	C	2	5	7	0	0	7	0	0
6	35102576	.	C	T	2	5	7	0	0	7	0	0
6	35102840	.	A	G	3	2	5	0	1	6	0	0
6	35102886	.	T	G	1	4	5	0	0	5	0	0
6	35106554	.	G	A	1	2	3	0	0	3	0	0
6	35106655	.	C	T	0	2	2	0	2	4	0	0
6	35136451	.	T	C	4	3	7	0	0	7	0	0
6	35136471	.	C	T	0	4	4	0	3	7	0	0
6	35136505	.	T	A	2	8	10	0	0	10	0	0
6	35136558	.	G	A	4	4	8	0	2	10	0	0
6	35136983	.	A	G	3	7	10	0	0	10	0	0
6	35137587	.	A	G	6	3	9	0	0	9	0	0
6	35139248	.	T	C	3	2	5	0	1	6	0	0
6	35194786	.	G	A	3	2	5	0	1	6	0	0
6	35309798	.	T	G	1	4	5	0	0	5	0	0
6	35309823	.	A	T	3	3	6	0	0	6	0	0
6	35309901	.	T	G	3	4	7	0	0	7	0	0
6	35309942	.	G	A	3	3	6	0	0	6	0	0
6	35363247	.	A	G	5	7	12	0	1	13	0	0
6	35364869	.	G	A	8	3	11	0	0	11	0	0
6	35365098	.	A	T	2	8	10	0	1	11	0	0
6	35365872	.	C	T	13	5	18	0	0	18	0	0
6	35365877	.	C	T	13	5	18	0	0	18	0	0
6	35366140	.	G	T	0	7	7	0	4	11	0	0
6	35366141	.	A	G	4	7	11	0	0	11	0	0
6	35366544	.	A	G	6	5	11	0	1	12	0	0
6	35366640	.	C	G	8	4	12	0	1	13	0	0
6	35389384	.	T	A	3	3	6	0	0	6	0	0
6	35389517	.	C	G	0	6	6	0	8	14	0	0
6	35461790	.	T	A	2	2	4	0	0	4	0	0
6	35461859	.	A	G	3	3	6	0	0	6	0	0
6	35462087	.	G	A	22	5	27	0	0	27	0	0
6	35462088	.	A	G	21	5	26	0	1	27	0	0
6	35462134	.	G	A	17	10	27	5	1	33	0	0
6	35462186	.	A	G	19	12	31	1	1	33	0	0
6	35462470	.	G	A	20	13	33	1	0	34	0	0
6	35472834	.	C	T	12	18	30	0	1	31	0	0
6	35472858	.	G	T	13	18	31	0	2	33	0	0
6	35676784	.	A	G	11	13	24	0	0	24	0	0
6	35676799	.	C	T	13	17	30	0	2	32	0	0
6	35688231	.	G	A	7	6	13	0	0	13	0	0
6	35693656	.	C	T	4	7	11	0	0	11	0	0
6	35713078	.	T	A	2	5	7	0	0	7	0	0
6	35718058	.	T	C	6	7	13	0	2	15	0	0
6	35737276	.	G	T	5	4	9	0	0	9	0	0
6	35737289	.	A	G	5	4	9	0	0	9	0	0
6	35737387	.	C	G	2	2	4	1	0	5	0	0
6	35738397	.	G	A	1	2	3	0	1	4	0	0
6	35738430	.	C	A	0	3	3	0	3	6	0	0
6	36128976	.	C	T	5	2	7	0	0	7	0	0
6	36129003	.	T	G	1	2	3	0	1	4	0	0
6	36129115	.	C	G	2	5	7	0	1	8	0	0
6	36129135	.	T	A	2	6	8	0	0	8	0	0
6	36130245	.	G	A	4	7	11	0	1	12	0	0
6	36130351	.	T	A	2	2	4	0	1	5	0	0
6	36130358	.	A	C	2	2	4	0	0	4	0	0
6	36130501	.	A	G	1	2	3	0	1	4	0	0
6	36130906	.	T	G	3	2	5	0	0	5	0	0
6	36130925	.	T	A	3	3	6	0	1	7	0	0
6	36130962	.	G	A	3	2	5	0	0	5	0	0
6	36130963	.	A	G	3	1	4	0	1	5	0	0
6	36131055	.	A	G	4	5	9	0	1	10	0	0
6	36131097	.	A	T	3	5	8	0	0	8	0	0
6	36131376	.	A	G	8	3	11	0	0	11	0	0
6	36132072	.	C	T	0	6	6	0	3	9	0	0
6	36137010	.	G	A	3	3	6	0	0	6	0	0
6	36141739	.	T	G	5	4	9	0	0	9	0	0
6	36141741	.	A	G	5	4	9	0	0	9	0	0
6	36469118	.	A	G	1	2	3	0	0	3	0	0
6	36720799	.	C	A	6	2	8	0	0	8	0	0
6	36758758	.	A	G	9	15	24	0	3	27	0	0
6	36760065	.	A	C	10	0	10	0	14	24	0	0
6	36760080	.	T	A	10	11	21	0	1	22	0	0
6	36760140	.	C	T	15	7	22	0	0	22	0	0
6	36762535	.	A	G	11	11	22	0	0	22	0	0
6	36770666	.	C	T	4	3	7	0	1	8	0	0
6	36783178	.	T	C	8	5	13	0	0	13	0	0
6	36783187	.	T	A	6	5	11	0	0	11	0	0
6	36789072	.	A	G	10	11	21	0	0	21	0	0
6	36792028	.	A	C	7	10	17	0	0	17	0	0
6	36792112	.	A	G	8	6	14	0	0	14	0	0
6	36792130	.	A	T	9	5	14	0	0	14	0	0
6	36792163	.	C	G	10	3	13	0	0	13	0	0
6	36792294	.	A	G	7	8	15	0	1	16	0	0
6	36818779	.	T	A	2	3	5	0	0	5	0	0
6	36818784	.	C	T	2	3	5	0	0	5	0	0
6	36818840	.	C	T	3	3	6	0	0	6	0	0
6	36819202	.	C	G	2	2	4	0	0	4	0	0
6	36854168	.	C	T	3	2	5	0	1	6	0	0
6	36854171	.	A	G	3	2	5	0	1	6	0	0
6	36876926	.	A	G	2	2	4	0	0	4	0	0
6	36876939	.	A	G	2	4	6	0	0	6	0	0
6	36877419	.	A	G	2	0	2	0	2	4	0	0
6	36896798	.	T	C	1	4	5	0	0	5	0	0
6	36896843	.	A	G	1	4	5	0	0	5	0	0
6	37071353	.	G	A	13	10	23	0	1	24	0	0
6	37071374	.	A	G	14	12	26	0	2	28	0	0
6	37163366	.	A	T	9	14	23	0	0	23	0	0
6	37163449	.	G	A	1	10	11	2	25	38	0	0
6	37163488	.	G	A	17	18	35	0	0	35	0	0
6	37163588	.	G	T	1	18	19	0	19	38	0	0
6	37163932	.	T	C	18	15	33	0	2	35	0	0
6	37163943	.	C	T	16	18	34	0	1	35	0	0
6	37164060	.	T	C	15	15	30	0	3	33	0	0
6	37164173	.	T	G	16	9	25	0	1	26	0	0
6	37301438	.	G	T	13	10	23	0	2	25	0	0
6	37301458	.	A	G	18	8	26	0	2	28	0	0
6	37301479	.	A	T	17	13	30	0	2	32	0	0
6	37305142	.	A	C	15	16	31	0	2	33	0	0
6	37305368	.	A	G	3	0	3	0	4	7	0	0
6	37305383	.	A	G	5	3	8	0	0	8	0	0
6	37305532	.	G	T	5	7	12	0	0	12	0	0
6	37305539	.	G	T	5	8	13	0	1	14	0	0
6	37306620	.	A	T	18	15	33	0	1	34	0	0
6	37306827	.	C	T	10	11	21	0	0	21	0	0
6	37307034	.	C	T	9	6	15	1	0	16	0	0
6	37409738	.	C	T	6	15	21	0	0	21	0	0
6	37409986	.	C	T	7	9	16	0	0	16	0	0
6	37410029	.	A	G	7	8	15	0	0	15	0	0
6	37410047	.	C	T	10	10	20	0	2	22	0	0
6	37410119	.	C	T	8	9	17	0	0	17	0	0
6	37417345	.	T	A	5	8	13	0	0	13	0	0
6	37419449	.	G	A	7	4	11	0	0	11	0	0
6	37419479	.	G	A	6	5	11	0	0	11	0	0
6	37419491	.	A	T	3	2	5	0	1	6	0	0
6	37420172	.	A	C	1	6	7	0	0	7	0	0
6	37421038	.	C	A	1	2	3	0	2	5	0	0
6	37422787	.	A	G	11	6	17	0	0	17	0	0
6	37431476	.	T	G	3	6	9	0	0	9	0	0
6	37431532	.	G	C	4	9	13	0	1	14	0	0
6	37431592	.	C	T	4	4	8	0	0	8	0	0
6	37431649	.	T	C	6	12	18	0	2	20	0	0
6	37438497	.	T	A	1	3	4	0	0	4	0	0
6	37440068	.	G	A	2	4	6	0	0	6	0	0
6	37440515	.	G	T	4	5	9	0	0	9	0	0
6	37440547	.	T	A	2	4	6	0	0	6	0	0
6	37441474	.	T	C	1	4	5	0	1	6	0	0
6	37441492	.	G	A	1	3	4	0	0	4	0	0
6	37442218	.	A	C	1	2	3	0	0	3	0	0
6	37443945	.	T	C	1	2	3	0	1	4	0	0
6	37445258	.	T	A	1	3	4	0	2	6	0	0
6	37445357	.	T	C	5	6	11	0	0	11	0	0
6	37461661	.	G	A	6	5	11	0	0	11	0	0
6	37461662	.	T	A	6	5	11	1	0	12	0	0
6	37469295	.	T	G	1	3	4	0	0	4	0	0
6	37469418	.	G	T	1	2	3	0	0	3	0	0
6	37469571	.	C	A	0	3	3	0	2	5	0	0
6	37469637	.	C	A	3	4	7	0	0	7	0	0
6	37478859	.	G	A	3	5	8	0	1	9	0	0
6	37478878	.	G	A	5	5	10	0	1	11	0	0
6	37478905	.	G	A	5	7	12	0	1	13	0	0
6	37479506	.	G	A	9	5	14	0	0	14	0	0
6	37479563	.	C	G	3	5	8	0	0	8	0	0
6	37479578	.	G	A	3	4	7	0	3	10	0	0
6	37479779	.	A	C	7	8	15	0	0	15	0	0
6	37479785	.	A	C	6	9	15	0	0	15	0	0
6	37479910	.	T	G	11	6	17	0	0	17	0	0
6	37479932	.	G	A	13	7	20	0	1	21	0	0
6	37479998	.	A	G	10	8	18	0	0	18	0	0
6	37480028	.	A	G	6	8	14	0	0	14	0	0
6	37485828	.	G	A	1	2	3	0	0	3	0	0
6	37495117	.	G	A	4	5	9	0	1	10	0	0
6	37495147	.	G	A	3	5	8	0	1	9	0	0
6	37499562	.	A	C	2	3	5	0	0	5	0	0
6	37514749	.	T	C	2	3	5	0	0	5	0	0
6	37515353	.	T	A	4	5	9	0	0	9	0	0
6	37521529	.	A	T	5	8	13	0	2	15	0	0
6	37521594	.	C	A	9	3	12	0	3	15	0	0
6	37521778	.	G	A	3	4	7	0	0	7	0	0
6	37525748	.	G	A	10	4	14	0	0	14	0	0
6	37529504	.	C	A	6	11	17	0	1	18	0	0
6	37548605	.	T	C	6	6	12	0	0	12	0	0
6	37548897	.	C	T	6	7	13	0	0	13	0	0
6	37551165	.	G	A	0	5	5	0	8	13	0	0
6	37551548	.	T	C	11	13	24	0	0	24	0	0
6	37552621	.	C	T	14	15	29	0	3	32	0	0
6	37554293	.	C	T	12	13	25	0	1	26	0	0
6	37598966	.	C	T	11	21	32	0	3	35	0	0
6	37599293	.	C	T	11	10	21	0	0	21	0	0
6	37599406	.	G	A	19	8	27	0	1	28	0	0
6	37599499	.	G	T	12	16	28	0	0	28	0	0
6	37599687	.	A	T	17	13	30	2	1	33	0	0
6	37599937	.	T	G	17	18	35	0	1	36	0	0
6	37599954	.	C	T	20	13	33	0	0	33	0	0
6	37600173	.	A	G	21	1	22	0	18	40	0	0
6	37600210	.	G	A	2	22	24	0	24	48	0	0
6	37600233	.	G	A	24	23	47	0	2	49	0	0
6	37604311	.	C	A	1	2	3	0	0	3	0	0
6	37604410	.	T	A	5	5	10	0	1	11	0	0
6	37604547	.	A	G	5	6	11	0	0	11	0	0
6	37604724	.	G	A	3	5	8	0	1	9	0	0
6	37604866	.	A	C	8	4	12	0	3	15	0	0
6	37621204	.	A	G	3	2	5	0	1	6	0	0
6	37621213	.	A	G	2	3	5	0	0	5	0	0
6	37621918	.	A	G	3	2	5	0	1	6	0	0
6	37627004	.	A	G	2	3	5	0	0	5	0	0
6	37627141	.	C	A	1	2	3	0	0	3	0	0
6	37628973	.	G	A	3	3	6	0	0	6	0	0
6	37628991	.	C	T	6	2	8	0	0	8	0	0
6	37629402	.	A	G	2	0	2	0	5	7	0	0
6	37631456	.	A	G	6	4	10	0	0	10	0	0
6	37632921	.	G	A	7	2	9	0	0	9	0	0
6	37633549	.	G	A	1	3	4	0	6	10	0	0
6	37635589	.	G	A	2	5	7	0	0	7	0	0
6	37635595	.	C	A	1	6	7	0	1	8	0	0
6	37635649	.	T	C	2	13	15	0	0	15	0	0
6	37637987	.	G	A	3	4	7	0	0	7	0	0
6	37651619	.	T	C	15	9	24	0	1	25	0	0
6	37729880	.	T	C	1	2	3	0	0	3	0	0
6	37730423	.	G	T	9	3	12	0	0	12	0	0
6	37730520	.	C	T	3	4	7	0	0	7	0	0
6	37730527	.	C	T	3	2	5	0	1	6	0	0
6	37743373	.	C	G	1	3	4	0	0	4	0	0
6	37743456	.	T	C	4	0	4	0	4	8	0	0
6	37744304	.	C	A	4	5	9	0	0	9	0	0
6	37745914	.	A	T	2	4	6	0	0	6	0	0
6	37745985	.	T	G	1	2	3	0	0	3	0	0
6	37746085	.	C	T	2	3	5	0	0	5	0	0
6	37746099	.	G	A	1	7	8	0	0	8	0	0
6	37748864	.	T	A	2	2	4	0	0	4	0	0
6	37808238	.	G	A	0	3	3	0	5	8	0	0
6	37808262	.	G	C	0	2	2	0	3	5	0	0
6	37810029	.	T	C	3	3	6	0	0	6	0	0
6	37812199	.	A	G	1	2	3	0	0	3	0	0
6	37812271	.	G	A	0	2	2	0	4	6	0	0
6	37815348	.	C	G	2	4	6	0	0	6	0	0
6	37815525	.	T	C	6	4	10	0	0	10	0	0
6	37815621	.	T	G	3	3	6	0	0	6	0	0
6	37818324	.	A	C	3	3	6	0	0	6	0	0
6	37818327	.	G	A	3	3	6	0	0	6	0	0
6	37820306	.	C	T	4	7	11	0	0	11	0	0
6	37820960	.	T	C	7	5	12	0	0	12	0	0
6	37824355	.	G	T	4	3	7	0	2	9	0	0
6	37824645	.	T	C	6	4	10	0	0	10	0	0
6	37825508	.	T	G	2	0	2	0	10	12	0	0
6	37829585	.	G	A	12	5	17	0	0	17	0	0
6	37829613	.	T	C	12	4	16	0	0	16	0	0
6	37830742	.	A	T	16	13	29	0	0	29	0	0
6	37830784	.	C	T	18	7	25	0	0	25	0	0
6	37830811	.	C	T	12	8	20	0	0	20	0	0
6	37832947	.	C	T	12	12	24	0	0	24	0	0
6	37832953	.	G	A	11	14	25	0	1	26	0	0
6	37833493	.	T	C	23	13	36	0	1	37	0	0
6	37835767	.	T	C	17	12	29	0	1	30	0	0
6	37835797	.	C	T	17	11	28	0	0	28	0	0
6	37836387	.	G	A	15	9	24	0	1	25	0	0
6	37841100	.	C	T	12	12	24	0	1	25	0	0
6	37846026	.	C	T	23	18	41	0	4	45	0	0
6	38367062	.	G	C	12	0	12	0	9	21	0	0
6	38367107	.	T	C	7	15	22	0	0	22	0	0
6	38375020	.	G	A	13	16	29	0	1	30	0	0
6	38381094	.	G	A	6	4	10	0	1	11	0	0
6	38386454	.	T	A	8	8	16	0	0	16	0	0
6	38415315	.	G	A	6	9	15	0	0	15	0	0
6	38415385	.	A	G	11	5	16	0	1	17	0	0
6	38426875	.	A	T	3	2	5	0	0	5	0	0
6	38427427	.	G	A	2	3	5	0	1	6	0	0
6	38427515	.	A	T	2	9	11	0	1	12	0	0
6	38477019	.	G	T	7	8	15	0	2	17	0	0
6	38503673	.	C	T	11	7	18	0	0	18	0	0
6	38511604	.	G	A	13	10	23	0	0	23	0	0
6	38511739	.	C	T	11	9	20	0	0	20	0	0
6	38511921	.	T	C	13	7	20	1	2	23	0	0
6	38511967	.	A	T	12	7	19	1	1	21	0	0
6	38512160	.	T	C	9	11	20	0	1	21	0	0
6	38512178	.	G	A	12	13	25	0	0	25	0	0
6	38512236	.	C	T	14	17	31	0	1	32	0	0
6	38512629	.	C	T	14	16	30	0	1	31	0	0
6	38513231	.	C	T	15	12	27	0	3	30	0	0
6	38778327	.	T	C	4	6	10	0	0	10	0	0
6	38782025	.	C	T	2	6	8	0	0	8	0	0
6	38782439	.	C	A	6	5	11	0	0	11	0	0
6	38782442	.	C	T	4	6	10	0	0	10	0	0
6	38782511	.	A	G	3	9	12	0	0	12	0	0
6	38782712	.	T	C	3	6	9	0	2	11	0	0
6	38782794	.	C	T	9	5	14	0	0	14	0	0
6	38782799	.	T	A	10	5	15	0	0	15	0	0
6	38783002	.	T	A	5	8	13	0	0	13	0	0
6	38783044	.	T	A	7	8	15	0	1	16	0	0
6	38786301	.	G	A	0	3	3	0	4	7	0	0
6	38786622	.	C	A	9	6	15	0	3	18	0	0
6	38789065	.	C	A	9	13	22	0	0	22	0	0
6	38789292	.	C	T	10	11	21	0	1	22	0	0
6	38789317	.	C	T	13	10	23	0	1	24	0	0
6	38789507	.	A	T	18	8	26	0	1	27	0	0
6	38789583	.	G	C	14	11	25	0	1	26	0	0
6	38789733	.	A	G	10	8	18	0	5	23	0	0
6	38789832	.	A	G	18	8	26	0	1	27	0	0
6	38789853	.	T	A	16	10	26	0	0	26	0	0
6	38845797	.	G	A	6	4	10	0	0	10	0	0
6	38845817	.	T	C	4	4	8	0	0	8	0	0
6	38845865	.	G	A	5	4	9	0	0	9	0	0
6	38845943	.	C	G	5	3	8	0	0	8	0	0
6	38845964	.	A	G	1	2	3	0	1	4	0	0
6	38845986	.	A	G	1	0	1	0	8	9	0	0
6	38846240	.	A	G	4	3	7	0	0	7	0	0
6	38858036	.	G	T	0	7	7	0	4	11	0	0
6	38858784	.	T	G	11	7	18	0	0	18	0	0
6	38858832	.	T	G	10	7	17	0	0	17	0	0
6	38858902	.	T	A	1	2	3	0	0	3	0	0
6	38859796	.	T	A	6	3	9	0	1	10	0	0
6	38860293	.	C	G	5	4	9	0	3	12	0	0
6	38860362	.	T	A	4	7	11	0	1	12	0	0
6	38860421	.	C	T	3	8	11	0	0	11	0	0
6	38860815	.	A	G	2	15	17	0	1	18	0	0
6	38860823	.	C	T	1	16	17	0	2	19	0	0
6	38860898	.	T	C	6	16	22	0	0	22	0	0
6	38860905	.	C	T	5	16	21	0	0	21	0	0
6	38860981	.	T	C	5	11	16	0	1	17	0	0
6	38860985	.	T	G	5	11	16	0	1	17	0	0
6	38861035	.	C	A	7	6	13	0	1	14	0	0
6	38896523	.	T	C	5	12	17	0	0	17	0	0
6	38899123	.	T	C	9	5	14	0	1	15	0	0
6	38901991	.	T	C	8	8	16	0	2	18	0	0
6	39068424	.	A	G	13	14	27	0	1	28	0	0
6	39075254	.	A	C	10	11	21	0	3	24	0	0
6	39075513	.	G	A	9	9	18	0	2	20	0	0
6	39077308	.	G	C	11	13	24	0	0	24	0	0
6	39077364	.	C	T	7	8	15	0	0	15	0	0
6	39123712	.	A	T	1	3	4	0	1	5	0	0
6	39123923	.	C	A	4	5	9	0	0	9	0	0
6	39124288	.	C	A	8	5	13	0	0	13	0	0
6	39124304	.	A	C	7	8	15	0	0	15	0	0
6	39124389	.	G	A	3	5	8	0	0	8	0	0
6	39124784	.	T	A	9	2	11	0	0	14	3	0
6	39124789	.	C	A	10	3	13	0	0	13	0	0
6	39125228	.	G	A	4	6	10	0	2	12	0	0
6	39125296	.	C	T	5	2	7	0	1	8	0	0
6	39125390	.	T	A	0	3	3	0	1	4	0	0
6	39125392	.	C	A	1	3	4	0	0	4	0	0
6	39125446	.	C	T	1	2	3	0	0	3	0	0
6	39125609	.	A	C	1	4	5	0	0	5	0	0
6	39125653	.	G	A	3	4	7	0	0	7	0	0
6	39125746	.	A	C	3	5	8	0	0	8	0	0
6	39125843	.	G	C	2	2	4	0	0	4	0	0
6	39126503	.	G	A	4	2	6	0	0	6	0	0
6	39127005	.	A	T	3	2	5	0	4	9	0	0
6	39127012	.	A	T	4	4	8	0	0	8	0	0
6	39127231	.	G	C	4	5	9	0	0	9	0	0
6	39127340	.	G	A	2	3	5	0	0	5	0	0
6	39136487	.	A	G	1	2	3	0	1	4	0	0
6	39162488	.	C	A	2	5	7	0	0	7	0	0
6	39162491	.	C	G	2	5	7	0	0	7	0	0
6	39162607	.	C	T	6	7	13	0	0	13	0	0
6	39162718	.	A	T	4	9	13	0	0	13	0	0
6	39162756	.	T	A	8	7	15	0	0	15	0	0
6	39162855	.	C	T	7	8	15	0	0	15	0	0
6	39162896	.	G	A	7	8	15	0	1	16	0	0
6	39163058	.	T	A	7	3	10	5	0	15	0	0
6	39163286	.	G	A	9	3	12	0	0	12	0	0
6	39163363	.	A	T	8	4	12	0	1	13	0	0
6	39163657	.	T	G	11	12	23	0	2	25	0	0
6	39163690	.	T	C	11	0	11	0	8	19	0	0
6	39163876	.	A	G	4	6	10	0	0	10	0	0
6	39164046	.	T	G	4	6	10	0	0	10	0	0
6	39994107	.	A	T	1	7	8	3	0	11	0	0
6	40544157	.	T	C	6	2	8	0	0	8	0	0
6	40558847	.	G	A	7	2	9	0	0	9	0	0
6	40761940	.	T	C	4	3	7	0	1	8	0	0
6	40761959	.	T	C	3	4	7	0	0	7	0	0
6	40947468	.	C	G	1	0	1	1	5	9	2	0
6	41435866	.	A	G	23	29	52	0	0	52	0	0
6	41461169	.	T	C	3	2	5	0	0	5	0	0
6	42657181	.	G	C	3	2	5	0	0	5	0	0
6	42657682	.	A	C	4	3	7	1	0	8	0	0
6	44585799	.	T	C	5	2	7	0	0	7	0	0
6	44914915	.	G	T	2	2	4	0	0	4	0	0
6	44924866	.	A	C	1	1	2	0	1	3	0	0
6	44931081	.	T	G	3	4	7	0	0	7	0	0
6	44939209	.	A	G	4	4	8	0	0	8	0	0
6	44942314	.	G	A	0	2	2	0	2	4	0	0
6	44945233	.	A	G	3	3	6	0	0	6	0	0
6	44945279	.	C	A	3	3	6	0	1	7	0	0
6	44945301	.	C	T	8	5	13	0	0	13	0	0
6	44945320	.	T	C	8	5	13	0	0	13	0	0
6	44945585	.	C	T	3	3	6	0	1	7	0	0
6	44947635	.	G	A	1	7	8	0	4	12	0	0
6	44950364	.	C	T	5	4	9	0	0	9	0	0
6	44950644	.	C	T	8	4	12	0	0	12	0	0
6	44950701	.	T	G	6	4	10	0	0	10	0	0
6	44961519	.	A	G	8	6	14	0	0	14	0	0
6	44970154	.	A	G	3	0	3	0	3	6	0	0
6	44977406	.	G	A	17	14	31	0	2	33	0	0
6	46357708	.	C	A	0	4	4	0	7	11	0	0
6	46413092	.	A	G	0	3	3	0	1	4	0	0
6	46419928	.	A	T	2	4	6	0	0	6	0	0
6	46422955	.	G	A	6	9	15	1	1	17	0	0
6	46423470	.	C	A	5	8	13	0	1	14	0	0
6	46423593	.	G	T	7	5	12	0	1	13	0	0
6	46428452	.	A	T	1	2	3	0	0	3	0	0
6	46428718	.	A	C	8	12	20	0	1	21	0	0
6	46431113	.	G	A	2	6	8	0	6	14	0	0
6	46431950	.	A	G	22	29	51	0	0	51	0	0
6	46432016	.	G	A	30	17	47	0	1	48	0	0
6	46450487	.	C	G	33	26	59	0	3	62	0	0
6	46450547	.	T	C	29	22	51	0	2	53	0	0
6	46450804	.	C	T	23	17	40	0	6	46	0	0
6	46452997	.	C	T	32	20	52	0	2	54	0	0
6	46454103	.	C	A	18	16	34	0	0	34	0	0
6	46454148	.	G	A	24	10	34	0	2	36	0	0
6	46454173	.	T	G	27	16	43	0	0	43	0	0
6	46454396	.	T	A	34	30	64	0	1	65	0	0
6	46454816	.	T	A	1	2	3	0	2	5	0	0
6	46507773	.	C	T	1	2	3	0	0	3	0	0
6	46508072	.	G	T	4	3	7	0	0	7	0	0
6	46509415	.	A	G	2	3	5	0	0	5	0	0
6	46697930	.	T	C	3	3	6	0	0	6	0	0
6	46701953	.	C	T	3	4	7	0	0	7	0	0
6	46715399	.	A	G	2	2	4	0	0	4	0	0
6	46715454	.	T	A	4	6	10	0	0	10	0	0
6	46716897	.	T	C	6	6	12	0	0	12	0	0
6	46716915	.	C	T	6	9	15	0	0	15	0	0
6	46716954	.	T	C	7	11	18	0	1	19	0	0
6	46717535	.	T	C	4	4	8	0	0	8	0	0
6	46717731	.	A	G	3	1	4	0	9	13	0	0
6	46717772	.	T	C	7	11	18	0	0	18	0	0
6	46718103	.	T	G	10	6	16	0	1	17	0	0
6	46718193	.	G	T	9	10	19	0	0	19	0	0
6	46718237	.	G	A	12	7	19	0	0	19	0	0
6	46718243	.	G	A	13	7	20	0	0	20	0	0
6	46721369	.	C	T	15	13	28	0	0	28	0	0
6	46722670	.	G	A	6	9	15	0	0	15	0	0
6	46722671	.	G	T	6	9	15	0	0	15	0	0
6	46722783	.	G	T	0	5	5	0	4	9	0	0
6	46722786	.	C	G	3	5	8	0	1	9	0	0
6	46722883	.	T	G	7	7	14	0	0	14	0	0
6	46725949	.	T	C	1	5	6	0	0	6	0	0
6	46725966	.	T	A	3	6	9	0	0	9	0	0
6	46726212	.	G	T	2	0	2	0	5	7	0	0
6	46726234	.	T	G	8	3	11	0	1	12	0	0
6	46726901	.	C	T	5	8	13	0	0	13	0	0
6	47006599	.	G	A	11	16	27	0	2	29	0	0
6	47006611	.	A	G	12	20	32	0	1	33	0	0
6	47032679	.	C	T	9	7	16	0	1	17	0	0
6	47032772	.	A	G	4	4	8	0	1	9	0	0
6	47054448	.	A	G	6	7	13	0	0	13	0	0
6	47246513	.	C	T	5	2	7	0	1	8	0	0
6	47530112	.	C	G	3	4	7	0	0	7	0	0
6	47530428	.	T	C	2	3	5	0	0	5	0	0
6	47530562	.	G	T	4	5	9	0	0	9	0	0
6	47530563	.	T	A	3	5	8	0	1	9	0	0
6	47530828	.	C	T	0	2	2	0	3	5	0	0
6	47531110	.	C	A	4	6	10	0	1	11	0	0
6	47540093	.	C	T	8	2	10	0	1	11	0	0
6	47540405	.	A	T	1	5	6	0	0	6	0	0
6	47558374	.	C	T	0	4	4	0	2	6	0	0
6	47809905	.	T	G	2	3	5	0	1	6	0	0
6	47810323	.	A	G	11	7	18	0	0	18	0	0
6	47810671	.	T	A	15	7	22	0	1	23	0	0
6	47810804	.	A	T	5	13	18	0	0	18	0	0
6	47810941	.	C	T	0	5	5	0	8	13	0	0
6	47811024	.	G	A	5	8	13	0	0	13	0	0
6	47811463	.	G	A	4	6	10	0	1	11	0	0
6	47811473	.	G	A	5	5	10	0	0	10	0	0
6	47811687	.	T	C	3	0	3	0	3	6	0	0
6	47811940	.	G	A	3	6	9	0	0	9	0	0
6	47811993	.	A	G	2	2	4	1	1	6	0	0
6	47812067	.	G	T	5	3	8	0	0	8	0	0
6	47812280	.	G	C	5	0	5	0	3	8	0	0
6	47812843	.	C	T	0	4	4	0	6	10	0	0
6	47812880	.	C	G	5	6	11	0	0	11	0	0
6	47812893	.	G	A	5	4	9	0	0	9	0	0
6	47812920	.	G	A	2	3	5	0	0	5	0	0
6	47813100	.	T	G	6	3	9	0	1	11	1	0
6	47813366	.	G	A	2	4	6	0	0	6	0	0
6	47813407	.	T	A	2	4	6	0	0	6	0	0
6	47813499	.	G	A	3	2	5	0	1	6	0	0
6	47813548	.	T	C	2	4	6	0	2	8	0	0
6	47816406	.	G	C	4	4	8	0	0	8	0	0
6	47816512	.	G	A	3	2	5	0	1	6	0	0
6	47816730	.	T	C	2	0	2	0	3	5	0	0
6	47825288	.	G	A	2	2	4	0	0	4	0	0
6	47825364	.	T	A	2	3	5	0	1	6	0	0
6	47825404	.	C	A	2	6	8	0	0	8	0	0
6	47838392	.	T	C	3	0	3	0	3	6	0	0
6	47865238	.	C	G	9	3	12	0	0	12	0	0
6	47865287	.	C	A	6	10	16	0	0	17	1	0
6	47865322	.	C	T	8	10	18	0	0	18	0	0
6	47865391	.	C	T	12	12	24	0	2	26	0	0
6	47865553	.	T	C	8	4	12	0	0	12	0	0
6	47865554	.	C	G	8	0	8	0	4	12	0	0
6	47865588	.	T	C	2	6	8	0	0	8	0	0
6	47865661	.	A	T	1	5	6	0	0	6	0	0
6	47865770	.	A	C	3	2	5	0	1	6	0	0
6	47865780	.	C	G	3	2	5	0	0	5	0	0
6	47869500	.	C	T	3	10	13	0	0	13	0	0
6	47869510	.	C	G	6	4	10	0	0	10	0	0
6	47869802	.	C	A	0	2	2	1	2	5	0	0
6	47870185	.	T	C	5	0	5	0	3	8	0	0
6	47870463	.	G	A	6	5	11	0	0	11	0	0
6	47872510	.	G	A	5	5	10	0	0	10	0	0
6	47875681	.	G	A	7	6	13	0	0	13	0	0
6	47879230	.	C	T	6	4	10	0	0	10	0	0
6	47894170	.	A	G	2	2	4	0	0	4	0	0
6	48051616	.	A	G	0	2	2	0	1	3	0	0
6	48051920	.	T	C	6	2	8	0	0	8	0	0
6	48052127	.	G	A	6	3	9	0	0	9	0	0
6	48052310	.	C	T	2	5	7	0	0	7	0	0
6	48054766	.	C	T	3	7	10	0	0	10	0	0
6	48057928	.	C	T	9	15	24	0	0	24	0	0
6	48058088	.	T	A	3	3	6	0	1	7	0	0
6	48058628	.	A	G	2	12	14	0	0	14	0	0
6	48058719	.	A	G	8	1	9	0	4	13	0	0
6	48058720	.	C	T	9	3	12	0	1	13	0	0
6	49108077	.	T	C	21	4	25	0	1	26	0	0
6	49108078	.	T	C	21	3	24	0	2	26	0	0
6	49577405	.	A	G	5	3	8	0	0	8	0	0
6	49577503	.	A	G	3	3	6	1	0	7	0	0
6	49738006	.	A	G	11	5	16	0	1	17	0	0
6	49738159	.	A	G	9	4	13	0	1	14	0	0
6	49738171	.	A	G	5	0	5	0	13	18	0	0
6	49738534	.	A	G	11	0	11	0	6	17	0	0
6	49738729	.	A	G	3	0	3	0	19	22	0	0
6	49738760	.	A	G	12	1	13	0	8	21	0	0
6	50581953	.	G	A	6	2	8	0	0	8	0	0
6	51530669	.	A	T	1	2	3	0	0	3	0	0
6	51531893	.	T	C	4	2	6	0	0	6	0	0
6	51531900	.	T	C	2	3	5	0	0	5	0	0
6	52223936	.	A	G	29	17	46	0	5	51	0	0
6	52224090	.	A	G	33	16	49	0	3	52	0	0
6	52224406	.	A	G	36	26	62	0	1	63	0	0
6	54417312	.	T	G	3	0	3	0	5	8	0	0
6	54417315	.	T	C	3	1	4	0	3	7	0	0
6	55217796	.	A	G	13	8	21	0	1	22	0	0
6	55218016	.	A	G	4	3	7	0	0	7	0	0
6	55218047	.	A	G	5	8	13	0	0	13	0	0
6	55218127	.	A	G	9	5	14	0	2	16	0	0
6	55218256	.	A	G	3	6	9	0	0	9	0	0
6	55218273	.	A	G	8	2	10	0	0	10	0	0
6	55218340	.	A	G	3	3	6	0	1	7	0	0
6	57401553	.	G	C	2	2	4	0	0	4	0	0
6	57401624	.	C	T	0	2	2	0	1	3	0	0
6	57439021	.	T	C	12	10	22	0	1	23	0	0
6	57439429	.	C	T	11	7	18	0	1	19	0	0
6	57455557	.	T	C	8	8	16	0	0	16	0	0
6	57459817	.	C	T	3	2	5	0	0	5	0	0
6	57459823	.	T	G	3	2	5	0	0	5	0	0
6	57478900	.	C	T	3	13	16	0	30	46	0	0
6	57481377	.	A	G	19	25	44	1	1	46	0	0
6	57492086	.	G	A	12	10	22	0	0	22	0	0
6	57492208	.	G	A	4	6	10	0	0	10	0	0
6	57492209	.	A	G	4	6	10	0	0	10	0	0
6	57498040	.	G	A	7	5	12	0	0	12	0	0
6	57498088	.	T	C	9	11	20	0	1	21	0	0
6	57498253	.	A	G	5	5	10	0	1	11	0	0
6	57498255	.	A	T	5	5	10	0	1	11	0	0
6	57500563	.	G	A	5	4	9	0	1	10	0	0
6	57500608	.	C	T	8	5	13	0	0	13	0	0
6	57500617	.	G	C	9	0	9	0	5	14	0	0
6	57508317	.	G	A	4	7	11	0	0	11	0	0
6	57510245	.	T	A	3	3	6	0	1	7	0	0
6	57510254	.	T	A	2	4	6	0	1	7	0	0
6	57516039	.	A	C	2	6	8	0	0	8	0	0
6	57519053	.	T	C	2	1	3	0	3	6	0	0
6	57519534	.	G	A	4	4	8	0	0	8	0	0
6	57519597	.	G	C	6	4	10	0	0	10	0	0
6	57523366	.	C	A	0	2	2	0	3	5	0	0
6	57526109	.	G	A	1	3	4	0	0	4	0	0
6	57541942	.	T	A	12	9	21	0	0	21	0	0
6	57583996	.	T	C	10	8	18	0	1	19	0	0
6	57595160	.	T	C	16	12	28	0	1	29	0	0
6	57595196	.	T	C	12	13	25	0	1	26	0	0
6	57618934	.	C	T	24	25	49	0	0	49	0	0
6	57620177	.	T	C	28	17	45	0	3	48	0	0
6	57620315	.	A	C	23	12	35	0	3	38	0	0
6	57630819	.	A	G	5	4	9	0	0	9	0	0
6	57630879	.	C	A	2	4	6	0	0	6	0	0
6	57634880	.	T	G	9	13	22	0	2	24	0	0
6	57634922	.	G	A	8	11	19	0	2	21	0	0
6	57634949	.	G	A	15	6	21	0	0	21	0	0
6	57638474	.	T	G	9	11	20	0	0	20	0	0
6	57644779	.	C	T	8	3	11	0	2	13	0	0
6	57652041	.	T	C	6	0	6	0	7	13	0	0
6	57652209	.	T	C	7	10	17	0	0	17	0	0
6	57900462	.	C	T	3	9	12	1	0	13	0	0
6	57901172	.	C	T	10	11	21	0	0	21	0	0
6	57909090	.	T	C	13	0	13	0	15	28	0	0
6	57930218	.	A	G	8	6	14	0	0	14	0	0
6	57984041	.	C	T	7	4	11	0	0	11	0	0
6	58307588	.	C	T	1	3	4	0	0	4	0	0
6	58359511	.	G	A	2	2	4	0	1	5	0	0
6	58364534	.	A	T	3	2	5	0	0	5	0	0
6	58367679	.	C	T	1	4	5	0	0	5	0	0
6	58369530	.	T	C	4	5	9	0	0	9	0	0
6	58370814	.	A	G	2	0	2	0	3	5	0	0
6	58370817	.	C	T	3	3	6	0	0	6	0	0
6	58376845	.	T	C	2	4	6	0	0	6	0	0
6	58381405	.	T	G	1	0	1	0	5	6	0	0
6	58381417	.	T	C	0	4	4	0	1	5	0	0
6	58382815	.	A	G	5	4	9	0	0	9	0	0
6	58382846	.	A	G	4	0	4	0	6	10	0	0
6	58382915	.	T	G	5	3	8	0	2	10	0	0
6	58384020	.	T	C	3	6	9	0	0	9	0	0
6	58384067	.	A	G	3	0	3	0	5	8	0	0
6	58389115	.	A	C	5	16	21	0	1	22	0	0
6	58389139	.	C	T	9	8	17	0	0	17	0	0
6	58389151	.	G	T	8	6	14	0	0	14	0	0
6	58393919	.	A	T	9	12	21	0	2	23	0	0
6	58395444	.	G	A	0	5	5	0	14	19	0	0
6	58395451	.	C	A	11	5	16	0	1	17	0	0
6	58459557	.	G	C	3	2	5	0	0	5	0	0
6	58463718	.	C	T	2	2	4	0	0	4	0	0
6	58463787	.	C	T	1	1	2	0	1	3	0	0
6	58495301	.	G	A	3	3	6	0	0	6	0	0
6	58495315	.	A	C	3	2	5	0	0	5	0	0
6	58495573	.	G	T	4	4	8	0	0	8	0	0
6	58496148	.	T	C	3	5	8	0	0	8	0	0
6	58496868	.	A	T	3	2	5	0	0	5	0	0
6	58497327	.	C	A	0	2	2	0	1	3	0	0
6	58497334	.	A	G	1	3	4	0	0	4	0	0
6	58497757	.	C	T	2	4	6	0	0	6	0	0
6	58497993	.	C	T	5	2	7	0	0	7	0	0
6	58498352	.	C	A	2	2	4	1	0	5	0	0
6	58499168	.	T	G	3	0	3	0	4	7	0	0
6	58499600	.	A	C	8	6	14	0	0	14	0	0
6	58522771	.	A	G	10	7	17	0	0	17	0	0
6	58524509	.	C	A	14	7	21	0	0	21	0	0
6	58549100	.	A	G	23	0	23	0	28	51	0	0
6	58553387	.	G	A	13	14	27	0	1	28	0	0
6	58553424	.	T	C	19	19	38	0	0	38	0	0
6	58560682	.	G	A	27	24	51	0	1	52	0	0
6	58560718	.	G	A	26	27	53	0	2	55	0	0
6	58561057	.	T	C	14	16	30	0	0	30	0	0
6	58561081	.	A	C	16	16	32	0	0	33	1	0
6	58561190	.	C	G	13	13	26	0	0	26	0	0
6	58561494	.	G	T	28	7	35	0	1	36	0	0
6	58562188	.	A	G	21	10	31	0	1	32	0	0
6	58562220	.	T	G	18	1	19	1	7	27	0	0
6	58562248	.	G	T	18	2	20	1	1	22	0	0
6	58562407	.	T	A	22	7	29	12	6	47	0	0
6	58562840	.	G	A	2	12	14	4	29	47	0	0
6	58562841	.	G	A	32	12	44	4	0	48	0	0
6	58562876	.	T	C	34	18	52	0	1	53	0	0
6	58563093	.	T	A	23	25	48	0	1	49	0	0
6	58563157	.	T	C	16	30	46	0	3	49	0	0
6	58563159	.	G	A	18	32	50	0	0	50	0	0
6	58563229	.	A	C	21	19	40	2	2	45	1	0
6	58563374	.	C	T	16	10	26	0	2	28	0	0
6	58563415	.	A	T	8	10	18	0	1	19	0	0
6	58698673	.	A	G	2	3	5	0	0	5	0	0
6	58698737	.	C	T	6	6	12	0	1	13	0	0
6	58698875	.	C	A	4	3	7	0	0	7	0	0
6	58698960	.	C	T	4	2	6	1	2	9	0	0
6	58708185	.	A	G	3	2	5	1	0	6	0	0
6	58708194	.	T	C	4	4	8	0	0	8	0	0
6	58708227	.	T	G	4	4	8	0	1	9	0	0
6	58712458	.	G	C	5	12	17	0	0	17	0	0
6	58712477	.	C	G	5	10	15	0	0	15	0	0
6	58712540	.	G	A	0	4	4	0	7	11	0	0
6	58723254	.	C	G	2	4	6	0	0	6	0	0
6	58723383	.	T	G	7	8	15	0	1	16	0	0
6	58725930	.	T	C	11	8	19	0	0	19	0	0
6	58726154	.	A	G	13	8	21	0	2	23	0	0
6	58728706	.	G	A	3	12	15	0	8	24	1	0
6	58728825	.	A	G	5	7	12	0	1	13	0	0
6	58728858	.	G	A	2	7	9	0	6	15	0	0
6	58729053	.	T	A	5	6	11	1	0	12	0	0
6	58729059	.	T	G	5	0	5	1	6	12	0	0
6	58729120	.	T	C	6	8	14	0	0	14	0	0
6	58729145	.	G	A	8	10	18	0	0	18	0	0
6	58730208	.	A	T	2	8	10	0	1	11	0	0
6	58730393	.	T	C	2	3	5	0	0	5	0	0
6	58730410	.	A	T	6	4	10	0	0	10	0	0
6	58730474	.	A	T	2	3	5	0	0	5	0	0
6	58730493	.	G	C	1	2	3	0	0	3	0	0
6	58730603	.	A	G	3	2	5	0	0	5	0	0
6	58730657	.	T	C	5	10	15	0	2	17	0	0
6	58732475	.	C	G	23	15	38	0	0	38	0	0
6	58772271	.	T	A	17	12	29	0	3	32	0	0
6	58772272	.	G	A	19	12	31	0	1	32	0	0
6	58773647	.	T	G	16	20	36	0	4	40	0	0
6	58773785	.	C	T	2	7	9	0	13	22	0	0
6	58773788	.	A	G	15	9	24	0	0	24	0	0
6	58778896	.	G	C	12	0	12	0	6	18	0	0
6	58781017	.	G	A	10	10	20	0	1	21	0	0
6	58784810	.	A	G	11	13	24	0	3	27	0	0
6	58789896	.	A	G	10	7	17	0	0	17	0	0
6	58808298	.	G	A	5	4	9	0	1	10	0	0
6	58808328	.	C	T	5	5	10	0	0	10	0	0
6	58828036	.	A	G	6	6	12	0	1	13	0	0
6	58855648	.	C	T	19	11	30	0	1	31	0	0
6	58857964	.	A	G	23	0	23	0	18	41	0	0
6	58859737	.	G	A	4	14	18	0	23	41	0	0
6	58861707	.	A	G	20	18	38	1	0	39	0	0
6	58862341	.	G	A	3	22	25	0	16	41	0	0
6	58867018	.	A	G	25	1	26	0	28	54	0	0
6	58867240	.	A	G	24	5	29	0	1	30	0	0
6	58867362	.	A	G	23	6	29	0	1	30	0	0
6	58867470	.	C	A	16	14	30	0	2	32	0	0
6	58873918	.	T	C	9	2	11	0	0	11	0	0
6	58873926	.	G	C	10	2	12	0	0	12	0	0
6	58874121	.	T	C	3	0	3	0	7	10	0	0
6	58875665	.	T	C	4	0	4	1	4	9	0	0
6	58877981	.	G	C	6	0	6	0	3	9	0	0
6	58878077	.	T	C	1	3	4	0	0	4	0	0
6	58886232	.	A	C	4	4	8	0	1	9	0	0
6	58889105	.	G	A	2	4	6	0	0	6	0	0
6	58889363	.	A	T	4	2	6	0	0	6	0	0
6	58889426	.	C	A	4	2	6	0	0	6	0	0
6	58891765	.	T	A	6	4	10	0	1	11	0	0
6	58892365	.	C	T	0	2	2	0	2	4	0	0
6	58892633	.	T	C	1	2	3	0	0	3	0	0
6	58918095	.	T	C	12	14	26	0	0	26	0	0
6	58918506	.	A	G	13	1	14	0	25	39	0	0
6	58918676	.	T	G	22	21	43	0	0	43	0	0
6	58918693	.	T	C	19	18	37	0	2	39	0	0
6	58921434	.	C	A	6	6	12	0	0	12	0	0
6	58921506	.	G	T	8	6	14	0	0	14	0	0
6	58923246	.	T	C	4	11	15	0	0	15	0	0
6	58939261	.	T	C	3	3	6	0	0	6	0	0
6	58939303	.	G	T	3	6	9	0	2	11	0	0
6	58948931	.	C	T	6	4	10	0	0	10	0	0
6	58949325	.	C	T	2	6	8	0	1	9	0	0
6	58949337	.	G	A	2	4	6	0	0	6	0	0
6	58949364	.	C	A	1	3	4	0	1	5	0	0
6	58953302	.	G	T	1	5	6	0	0	6	0	0
6	58953366	.	C	T	4	4	8	0	0	8	0	0
6	58961996	.	C	T	5	3	8	0	0	8	0	0
6	59350764	.	T	C	5	0	5	1	5	11	0	0
6	59350766	.	T	C	7	0	7	1	4	12	0	0
6	59671954	.	A	G	6	1	7	0	4	11	0	0
6	59679633	.	G	A	0	4	4	0	7	11	0	0
6	59679636	.	C	A	7	4	11	0	0	11	0	0
6	59681450	.	A	T	8	5	13	0	0	13	0	0
6	59681464	.	G	A	8	7	15	0	0	15	0	0
6	59691533	.	C	T	7	6	13	0	0	13	0	0
6	59813578	.	G	A	2	18	20	0	18	38	0	0
6	59813608	.	A	G	9	20	29	0	2	31	0	0
6	59813857	.	G	A	0	8	8	0	17	25	0	0
6	59813905	.	A	G	22	0	22	0	15	37	0	0
6	59819362	.	C	T	15	17	32	0	1	33	0	0
6	59824482	.	C	T	21	24	45	0	1	46	0	0
6	59824496	.	C	T	25	15	40	0	4	44	0	0
6	59824672	.	C	T	21	20	41	0	4	45	0	0
6	59824736	.	C	T	24	18	42	0	1	43	0	0
6	59832922	.	T	C	8	9	17	0	2	19	0	0
6	59833006	.	T	A	16	8	24	0	0	24	0	0
6	59833007	.	A	G	15	8	23	0	1	24	0	0
6	59837587	.	C	G	12	8	20	0	1	21	0	0
6	59837710	.	A	G	21	11	32	0	3	35	0	0
6	59837747	.	G	A	1	12	13	0	19	32	0	0
6	59839033	.	G	A	0	16	16	0	15	31	0	0
6	59839048	.	G	A	15	12	27	0	0	27	0	0
6	59841394	.	G	A	0	12	12	0	11	23	0	0
6	59847692	.	C	T	1	2	3	0	0	3	0	0
6	59848119	.	C	T	25	25	50	0	3	53	0	0
6	59848345	.	T	C	24	23	47	0	3	50	0	0
6	59848624	.	C	G	19	9	28	1	2	31	0	0
6	59848894	.	T	C	27	20	47	1	1	49	0	0
6	59850253	.	C	T	21	14	35	0	3	38	0	0
6	59850308	.	T	C	18	23	41	0	1	42	0	0
6	59854344	.	G	T	2	4	6	0	6	12	0	0
6	59882680	.	T	C	12	11	23	0	0	23	0	0
6	59882704	.	T	C	8	8	16	0	1	18	1	0
6	59883154	.	G	A	12	16	28	0	1	29	0	0
6	59889640	.	G	T	2	15	17	0	13	30	0	0
6	59889964	.	A	G	8	0	8	0	8	16	0	0
6	59889978	.	C	T	9	7	16	0	0	16	0	0
6	59890125	.	C	T	7	10	17	0	0	17	0	0
6	59891289	.	T	C	10	15	25	0	0	25	0	0
6	59892864	.	C	T	12	13	25	0	4	29	0	0
6	59894548	.	T	C	12	15	27	0	0	27	0	0
6	59894580	.	T	A	13	13	26	0	2	28	0	0
6	59894719	.	T	C	14	6	20	0	0	20	0	0
6	59915599	.	T	C	9	13	22	0	0	22	0	0
6	59915608	.	T	C	9	15	24	0	1	25	0	0
6	59921661	.	T	G	16	15	31	0	0	31	0	0
6	59921685	.	T	C	17	11	28	0	2	30	0	0
6	59921788	.	A	C	10	14	24	0	0	24	0	0
6	59939277	.	G	A	18	13	31	0	1	32	0	0
6	59945088	.	A	G	2	4	6	2	1	9	0	0
6	59947097	.	C	A	6	2	8	0	1	9	0	0
6	59949374	.	C	A	4	5	9	1	1	11	0	0
6	59949585	.	A	G	4	4	8	1	2	11	0	0
6	59949591	.	G	A	4	3	7	1	2	10	0	0
6	59951038	.	C	T	3	4	7	0	0	7	0	0
6	59951483	.	C	G	1	2	3	0	0	3	0	0
6	59971416	.	C	T	18	24	42	0	2	44	0	0
6	59971598	.	A	G	25	22	47	0	2	49	0	0
6	59971711	.	G	A	27	21	48	3	1	52	0	0
6	59971718	.	C	A	22	21	43	3	4	50	0	0
6	59971964	.	G	A	5	2	7	0	0	7	0	0
6	59971968	.	A	G	3	4	7	0	0	7	0	0
6	59972259	.	T	A	10	17	27	1	0	28	0	0
6	59985833	.	C	T	6	3	9	0	1	10	0	0
6	60031520	.	G	A	6	8	14	0	1	15	0	0
6	60031641	.	C	T	2	3	5	0	8	13	0	0
6	60043150	.	A	G	5	3	8	0	0	8	0	0
6	60043179	.	T	C	3	4	7	0	0	7	0	0
6	60043297	.	T	A	6	2	8	0	0	8	0	0
6	60043413	.	G	A	3	4	7	0	1	8	0	0
6	60044319	.	T	A	4	6	10	0	0	10	0	0
6	60044320	.	A	T	4	6	10	0	0	10	0	0
7	742828	.	T	C	6	25	31	0	1	32	0	0
7	837955	.	T	G	3	3	6	0	0	6	0	0
7	846579	.	C	T	5	5	10	0	0	10	0	0
7	847189	.	A	T	4	9	13	0	0	13	0	0
7	860858	.	G	A	6	2	8	1	0	9	0	0
7	860914	.	A	G	1	2	3	1	2	6	0	0
7	868470	.	A	G	1	3	4	0	0	4	0	0
7	1418216	.	A	T	8	3	11	2	0	13	0	0
7	1418299	.	A	G	6	7	13	0	0	13	0	0
7	1418310	.	T	C	8	6	14	0	0	14	0	0
7	1521882	.	C	T	2	11	13	11	0	24	0	0
7	1526860	.	G	A	1	9	10	0	24	34	0	0
7	1539481	.	C	T	3	3	6	0	0	6	0	0
7	1539532	.	C	T	5	3	8	0	0	8	0	0
7	1539538	.	C	T	4	2	6	0	1	7	0	0
7	1540812	.	T	A	1	3	4	0	1	5	0	0
7	1541012	.	G	A	0	3	3	0	5	8	0	0
7	1541117	.	G	T	0	6	6	1	2	9	0	0
7	1588610	.	C	T	4	5	9	1	1	11	0	0
7	1594408	.	C	T	8	8	16	0	0	16	0	0
7	1594606	.	C	A	13	8	21	0	2	23	0	0
7	1600153	.	C	T	16	11	27	0	1	28	0	0
7	1600263	.	A	T	16	5	21	0	1	22	0	0
7	1603053	.	G	T	1	9	10	0	16	26	0	0
7	1603116	.	T	G	9	0	9	0	14	23	0	0
7	1606334	.	C	T	18	7	25	0	1	26	0	0
7	1609555	.	C	T	17	7	24	0	1	25	0	0
7	1613117	.	T	C	19	10	29	0	0	29	0	0
7	1613131	.	A	G	20	11	31	0	0	31	0	0
7	1613230	.	T	G	24	16	40	0	2	42	0	0
7	1615439	.	C	T	25	13	38	0	2	40	0	0
7	1617209	.	T	A	37	12	49	0	0	49	0	0
7	1617218	.	T	C	38	4	42	0	1	43	0	0
7	1617433	.	A	C	35	17	52	0	0	52	0	0
7	1618771	.	G	A	2	17	19	1	6	26	0	0
7	1618863	.	T	C	19	13	32	0	3	35	0	0
7	1618865	.	G	A	14	13	27	0	7	34	0	0
7	1619124	.	A	T	4	3	7	0	3	10	0	0
7	1619868	.	G	C	1	2	3	0	0	3	0	0
7	1620135	.	G	A	1	4	5	0	1	6	0	0
7	3931029	.	A	G	36	18	54	0	2	56	0	0
7	3931264	.	C	T	23	27	50	0	6	56	0	0
7	3931396	.	A	T	29	26	55	0	0	55	0	0
7	3931543	.	A	T	26	32	58	0	2	60	0	0
7	3931598	.	G	T	26	24	50	0	4	54	0	0
7	3932209	.	A	T	16	22	38	0	0	38	0	0
7	3932402	.	T	C	14	15	29	0	3	32	0	0
7	3932405	.	A	T	15	18	33	0	0	33	0	0
7	3932463	.	T	G	12	7	19	0	4	23	0	0
7	3932546	.	C	A	4	4	8	0	0	8	0	0
7	3932694	.	G	A	26	14	40	0	0	40	0	0
7	3932698	.	T	C	29	13	42	0	2	44	0	0
7	3932731	.	C	A	33	13	46	0	3	49	0	0
7	3933121	.	G	A	34	22	56	0	2	58	0	0
7	3933243	.	C	A	26	16	42	0	0	42	0	0
7	3933271	.	C	T	28	17	45	0	1	46	0	0
7	3933383	.	A	C	10	2	12	0	19	31	0	0
7	3933481	.	T	C	22	0	22	0	15	37	0	0
7	3933483	.	C	T	5	14	19	0	20	39	0	0
7	3933998	.	C	T	23	9	32	0	1	33	0	0
7	3934038	.	A	T	7	19	26	0	1	27	0	0
7	3934208	.	T	C	30	3	33	0	1	34	0	0
7	3934387	.	C	T	20	14	34	0	1	35	0	0
7	3934428	.	G	T	12	25	37	0	2	39	0	0
7	3934551	.	A	T	12	6	18	0	0	18	0	0
7	3934645	.	A	C	8	13	21	0	0	21	0	0
7	3934818	.	G	A	10	4	14	0	1	15	0	0
7	3934970	.	A	G	9	12	21	0	1	22	0	0
7	3935055	.	T	C	11	15	26	0	1	27	0	0
7	3935123	.	A	G	10	14	24	0	1	25	0	0
7	3935171	.	G	C	21	7	28	0	0	29	1	0
7	3935283	.	G	A	10	13	23	0	0	23	0	0
7	3935737	.	C	T	1	16	17	0	15	32	0	0
7	3935788	.	C	A	10	11	21	1	0	22	0	0
7	3936127	.	C	T	2	11	13	1	17	31	0	0
7	3936702	.	A	G	2	4	6	0	0	6	0	0
7	3936764	.	G	A	4	9	13	0	0	13	0	0
7	3936946	.	C	T	0	7	7	0	11	18	0	0
7	3951010	.	C	T	4	15	19	0	11	30	0	0
7	3951115	.	G	A	18	12	30	0	0	30	0	0
7	3952993	.	A	G	8	11	19	0	0	19	0	0
7	3955628	.	G	A	3	9	12	0	2	14	0	0
7	4088334	.	C	T	16	17	33	0	2	35	0	0
7	4088545	.	C	T	2	20	22	0	14	36	0	0
7	4088680	.	G	A	13	15	28	0	3	31	0	0
7	4088727	.	A	T	27	20	47	0	3	50	0	0
7	4088832	.	A	G	24	18	42	1	2	45	0	0
7	4089042	.	A	G	31	11	42	0	0	42	0	0
7	4089090	.	G	A	19	6	25	0	1	26	0	0
7	4095265	.	C	T	0	26	26	0	23	49	0	0
7	4100931	.	C	T	15	13	28	0	2	30	0	0
7	4100967	.	G	A	18	16	34	0	2	36	0	0
7	4110441	.	T	C	9	0	9	0	8	17	0	0
7	4180298	.	G	A	2	2	4	0	0	4	0	0
7	4180410	.	C	T	1	2	3	0	0	3	0	0
7	4180787	.	T	C	5	4	9	0	0	9	0	0
7	4180984	.	G	A	1	2	3	0	0	3	0	0
7	4180988	.	C	T	1	2	3	0	0	3	0	0
7	4181192	.	G	A	1	7	8	0	0	8	0	0
7	4183996	.	C	T	2	4	6	0	2	8	0	0
7	4184897	.	G	T	5	6	11	0	1	12	0	0
7	4185569	.	A	G	6	4	10	0	0	10	0	0
7	4186499	.	A	G	4	6	10	1	0	11	0	0
7	4186532	.	G	A	1	4	5	1	6	12	0	0
7	4186553	.	T	C	4	4	8	1	1	10	0	0
7	4186611	.	A	G	9	5	14	0	0	14	0	0
7	4186629	.	C	T	4	10	14	0	1	15	0	0
7	5324606	.	G	C	1	5	6	0	1	7	0	0
7	5324609	.	T	A	1	6	7	0	0	7	0	0
7	5325577	.	T	C	4	0	4	1	5	10	0	0
7	5326976	.	T	C	1	5	6	0	0	6	0	0
7	7002248	.	C	T	2	5	7	0	0	7	0	0
7	7011428	.	A	C	6	3	9	0	0	9	0	0
7	7031161	.	C	T	2	2	4	0	0	4	0	0
7	7035949	.	G	A	0	2	2	5	6	13	0	0
7	7038414	.	A	G	6	2	8	0	0	8	0	0
7	7038426	.	C	T	6	4	10	0	0	10	0	0
7	7038541	.	G	A	8	4	12	3	1	16	0	0
7	7038959	.	A	G	4	3	7	0	0	7	0	0
7	7038966	.	A	G	2	2	4	0	2	6	0	0
7	7039446	.	T	A	7	6	13	8	0	21	0	0
7	7039475	.	C	G	10	9	19	1	1	21	0	0
7	7042115	.	A	G	22	9	31	3	1	35	0	0
7	7042160	.	A	G	9	9	18	5	0	24	1	0
7	7042506	.	C	T	5	6	11	27	0	38	0	0
7	7042604	.	C	T	22	15	37	0	0	37	0	0
7	7042626	.	T	G	23	17	40	5	0	45	0	0
7	7245297	.	A	G	8	4	12	0	1	13	0	0
7	7245508	.	C	G	1	2	3	0	1	4	0	0
7	7245706	.	A	G	2	3	5	1	1	7	0	0
7	7247184	.	C	T	5	4	9	0	3	12	0	0
7	7248193	.	C	T	18	12	30	0	1	31	0	0
7	7248212	.	A	T	10	5	15	0	7	22	0	0
7	7248292	.	T	C	5	12	17	0	1	18	0	0
7	7248293	.	A	G	12	0	12	0	8	20	0	0
7	7248813	.	G	C	2	2	4	0	0	4	0	0
7	7248819	.	C	A	2	3	5	0	1	6	0	0
7	7248849	.	A	G	8	3	11	0	0	11	0	0
7	7248862	.	A	G	4	7	11	0	0	11	0	0
7	7249515	.	T	A	3	10	13	0	0	13	0	0
7	7321594	.	T	G	3	0	3	0	6	9	0	0
7	7324749	.	C	T	2	1	3	0	1	4	0	0
7	7333188	.	C	T	3	2	5	0	0	5	0	0
7	7347352	.	G	T	1	2	3	0	0	3	0	0
7	7364788	.	T	C	4	8	12	0	0	12	0	0
7	7365111	.	G	T	4	4	8	0	0	8	0	0
7	7365155	.	G	A	0	2	2	0	1	3	0	0
7	7367315	.	T	A	2	4	6	0	0	6	0	0
7	7367630	.	A	G	1	0	1	0	13	14	0	0
7	7367690	.	A	G	1	1	2	0	9	11	0	0
7	7367809	.	G	C	1	7	8	0	1	9	0	0
7	7368109	.	G	C	6	15	21	0	2	23	0	0
7	7368148	.	T	C	6	10	16	0	1	17	0	0
7	7368187	.	A	G	5	6	11	1	0	12	0	0
7	7368199	.	C	T	3	4	7	1	2	10	0	0
7	7368264	.	T	C	4	8	12	0	0	12	0	0
7	7368503	.	A	T	2	7	9	0	2	11	0	0
7	7368515	.	A	G	3	9	12	0	0	12	0	0
7	7368582	.	C	T	3	3	6	0	1	7	0	0
7	7368834	.	G	T	12	6	18	0	0	18	0	0
7	7368869	.	T	C	12	4	16	0	0	16	0	0
7	7368972	.	T	A	4	7	11	1	1	13	0	0
7	7369000	.	G	T	0	7	7	1	5	13	0	0
7	7369040	.	G	A	0	6	6	0	5	11	0	0
7	7369184	.	A	C	3	3	6	0	0	6	0	0
7	7369404	.	C	T	8	4	12	0	0	12	0	0
7	7369729	.	T	A	7	9	16	0	0	16	0	0
7	7369768	.	G	A	1	7	8	0	12	20	0	0
7	7369831	.	G	A	3	4	7	1	4	12	0	0
7	7370412	.	C	A	6	3	9	0	1	10	0	0
7	7370581	.	T	A	4	3	7	0	0	7	0	0
7	7370852	.	T	A	4	2	6	0	0	6	0	0
7	7370858	.	T	A	2	2	4	0	0	4	0	0
7	7372694	.	A	G	10	24	34	0	1	35	0	0
7	7372772	.	A	G	13	0	13	0	13	26	0	0
7	7372892	.	A	G	11	6	17	0	3	20	0	0
7	7466495	.	A	G	7	6	13	0	0	13	0	0
7	7466603	.	C	T	1	9	10	0	5	15	0	0
7	7466706	.	A	G	8	5	13	0	0	13	0	0
7	7466827	.	A	T	6	2	8	0	0	8	0	0
7	7466910	.	A	G	2	2	4	0	0	4	0	0
7	7467303	.	A	T	13	4	17	0	1	18	0	0
7	7467308	.	C	T	12	4	16	0	1	17	0	0
7	7467376	.	A	G	12	5	17	0	0	17	0	0
7	7467386	.	G	A	11	5	16	0	0	16	0	0
7	7467568	.	T	A	5	2	7	0	0	7	0	0
7	7467906	.	T	A	11	4	15	0	1	16	0	0
7	7468719	.	C	T	7	2	9	0	1	10	0	0
7	7468721	.	T	C	7	0	7	0	2	9	0	0
7	7469478	.	C	T	2	1	3	0	4	7	0	0
7	7473408	.	A	G	2	3	5	0	0	5	0	0
7	7473427	.	A	C	3	0	3	0	3	6	0	0
7	7473451	.	C	A	4	3	7	0	0	7	0	0
7	7473466	.	C	T	0	4	4	0	3	7	0	0
7	7473634	.	G	T	5	4	9	0	0	9	0	0
7	7474027	.	G	A	2	3	5	0	0	5	0	0
7	7474069	.	A	G	2	2	4	0	0	4	0	0
7	7474078	.	C	A	2	3	5	0	0	5	0	0
7	7474150	.	G	A	1	5	6	0	0	6	0	0
7	7474180	.	G	A	1	5	6	0	1	7	0	0
7	7474189	.	A	G	1	5	6	0	0	6	0	0
7	7477594	.	A	T	13	7	20	0	2	23	1	0
7	7478105	.	A	G	5	9	14	0	0	14	0	0
7	7478137	.	A	G	4	6	10	0	1	11	0	0
7	7478308	.	G	T	3	5	8	0	0	8	0	0
7	7478654	.	T	C	9	11	20	0	0	20	0	0
7	7478717	.	T	G	14	11	25	0	2	27	0	0
7	7478806	.	G	A	21	12	33	0	1	34	0	0
7	7482475	.	G	A	17	16	33	1	0	34	0	0
7	7500511	.	G	A	1	2	3	0	1	4	0	0
7	7552069	.	C	T	7	6	13	0	0	13	0	0
7	7552113	.	G	A	10	8	18	0	1	19	0	0
7	7597059	.	A	G	6	0	6	0	7	13	0	0
7	7608920	.	G	A	1	9	10	0	5	15	0	0
7	7608965	.	C	T	9	9	18	0	1	19	0	0
7	7611758	.	C	T	20	10	30	0	1	31	0	0
7	7611830	.	C	A	10	8	18	0	2	20	0	0
7	7617861	.	G	A	3	16	19	0	16	35	0	0
7	7624082	.	A	G	21	20	41	0	4	45	0	0
7	7641230	.	A	T	24	20	44	0	0	44	0	0
7	7641240	.	T	G	23	23	46	0	1	47	0	0
7	7641351	.	G	A	21	8	29	0	1	30	0	0
7	7641353	.	G	A	21	9	30	0	0	30	0	0
7	7641481	.	C	T	25	10	35	0	1	36	0	0
7	7641504	.	G	A	2	13	15	0	23	38	0	0
7	7641678	.	T	A	8	14	22	0	3	25	0	0
7	7641765	.	T	C	8	12	20	0	3	23	0	0
7	7642554	.	T	A	27	17	44	0	1	45	0	0
7	7642578	.	A	G	22	0	22	0	15	37	0	0
7	7642787	.	A	T	17	23	40	0	1	41	0	0
7	7643277	.	T	C	19	27	46	0	2	48	0	0
7	7643313	.	T	C	24	28	52	0	1	53	0	0
7	7643488	.	A	G	24	26	50	0	4	54	0	0
7	7643676	.	G	A	5	13	18	2	32	52	0	0
7	7643711	.	C	A	19	9	28	0	2	30	0	0
7	7643712	.	T	C	21	10	31	0	0	31	0	0
7	7662467	.	C	G	7	9	16	0	1	17	0	0
7	7662825	.	A	C	11	0	11	0	13	24	0	0
7	7663132	.	A	G	16	14	30	0	0	30	0	0
7	7663254	.	G	A	14	5	19	0	1	20	0	0
7	7663453	.	A	T	14	9	23	0	1	24	0	0
7	7663682	.	C	T	1	5	6	0	7	13	0	0
7	7663902	.	G	T	7	11	18	3	0	21	0	0
7	7664061	.	A	G	5	3	8	0	0	8	0	0
7	7664473	.	C	T	0	3	3	0	1	4	0	0
7	7664535	.	T	A	1	5	6	0	0	6	0	0
7	7664708	.	T	A	15	15	30	0	1	31	0	0
7	7664760	.	G	T	8	13	21	0	3	24	0	0
7	7664815	.	C	A	12	7	19	0	1	20	0	0
7	7664838	.	G	T	7	12	19	0	1	20	0	0
7	7664870	.	G	T	4	8	12	0	2	14	0	0
7	7664882	.	G	C	3	8	11	0	1	12	0	0
7	7664912	.	A	C	5	6	11	0	0	11	0	0
7	7665075	.	G	T	6	5	11	0	1	12	0	0
7	7665480	.	A	C	9	10	19	0	0	19	0	0
7	7665559	.	T	A	7	12	19	0	1	20	0	0
7	7665952	.	T	A	4	2	6	0	0	6	0	0
7	7665961	.	T	C	4	2	6	0	0	6	0	0
7	7666388	.	G	A	15	11	26	0	0	26	0	0
7	7666760	.	T	A	4	3	7	0	0	7	0	0
7	7674378	.	T	C	9	0	9	0	14	23	0	0
7	7674462	.	C	G	10	5	15	0	0	15	0	0
7	7674474	.	T	A	8	5	13	0	0	13	0	0
7	7676112	.	C	T	6	7	13	0	0	13	0	0
7	7681878	.	A	G	2	5	7	0	1	8	0	0
7	7683342	.	G	A	2	3	5	0	1	6	0	0
7	7685156	.	C	T	2	3	5	0	0	5	0	0
7	7696785	.	T	A	4	5	9	0	0	9	0	0
7	7696794	.	G	T	1	5	6	0	4	10	0	0
7	7696875	.	C	A	6	4	10	0	0	10	0	0
7	7700867	.	G	A	0	6	6	1	3	10	0	0
7	7700965	.	T	G	9	0	9	0	7	16	0	0
7	7705993	.	C	G	5	0	5	0	14	19	0	0
7	7706005	.	C	T	8	13	21	0	0	21	0	0
7	7706869	.	A	G	2	5	7	0	1	8	0	0
7	7706950	.	A	G	9	8	17	0	1	18	0	0
7	7707029	.	T	G	11	8	19	0	1	20	0	0
7	7707191	.	A	C	1	2	3	0	0	3	0	0
7	7708572	.	T	C	6	4	10	0	1	11	0	0
7	7708666	.	A	C	2	9	11	0	2	13	0	0
7	7708826	.	T	G	5	3	8	0	0	8	0	0
7	7708944	.	T	A	6	4	10	0	0	10	0	0
7	7708972	.	A	C	6	4	10	0	1	11	0	0
7	7709053	.	C	T	2	4	6	0	0	6	0	0
7	7720185	.	G	A	2	2	4	0	0	4	0	0
7	7785604	.	C	T	1	3	4	0	0	4	0	0
7	7795328	.	A	T	2	2	4	0	0	4	0	0
7	7797397	.	T	G	3	2	5	0	1	6	0	0
7	8694613	.	C	A	0	4	4	0	0	4	0	0
7	8890460	.	T	A	1	3	4	0	0	4	0	0
7	8890736	.	T	C	8	5	13	0	0	13	0	0
7	8890884	.	A	G	22	16	38	0	0	38	0	0
7	8890903	.	G	A	23	16	39	0	1	40	0	0
7	8890983	.	C	A	1	10	11	0	13	24	0	0
7	8891057	.	A	T	12	10	22	0	0	22	0	0
7	8891062	.	G	T	10	8	18	0	0	18	0	0
7	8891236	.	C	G	13	9	22	0	0	22	0	0
7	8891399	.	T	C	8	0	8	1	5	14	0	0
7	8891402	.	T	C	7	0	7	1	5	13	0	0
7	8891598	.	G	A	2	2	4	0	0	4	0	0
7	8891710	.	A	G	9	9	18	0	0	18	0	0
7	8891717	.	A	G	9	8	17	0	0	17	0	0
7	8891755	.	T	G	8	3	11	0	1	12	0	0
7	8892038	.	T	C	6	0	6	0	3	9	0	0
7	8924570	.	G	A	1	2	3	0	0	3	0	0
7	8950314	.	C	A	0	3	3	0	2	5	0	0
7	9192375	.	C	A	1	2	3	0	1	4	0	0
7	9192381	.	C	A	2	2	4	0	0	4	0	0
7	9224393	.	G	T	1	6	7	0	0	7	0	0
7	9229327	.	A	C	4	5	9	0	0	9	0	0
7	9238631	.	A	G	1	0	1	1	2	4	0	0
7	9302796	.	A	G	5	11	16	0	0	16	0	0
7	9302841	.	A	G	12	8	20	0	0	20	0	0
7	9302905	.	A	G	17	0	17	0	8	25	0	0
7	10352447	.	G	A	1	3	4	0	1	5	0	0
7	10353266	.	C	A	2	6	8	0	0	8	0	0
7	10372319	.	T	G	2	2	4	0	1	5	0	0
7	10372340	.	G	A	0	3	3	0	3	6	0	0
7	10372424	.	T	C	3	2	5	0	0	5	0	0
7	10528048	.	T	C	1	2	3	1	0	4	0	0
7	10528078	.	T	A	0	2	2	1	0	4	1	0
7	10528084	.	T	C	2	2	4	1	0	5	0	0
7	10578316	.	G	T	2	6	8	0	0	8	0	0
7	10582851	.	T	C	2	5	7	0	0	7	0	0
7	10701814	.	C	A	5	6	11	0	2	13	0	0
7	10701966	.	A	T	5	15	20	0	1	21	0	0
7	10740494	.	A	G	6	0	6	0	12	18	0	0
7	10740506	.	T	C	4	10	14	0	0	14	0	0
7	10766511	.	A	G	4	5	9	0	1	10	0	0
7	10800689	.	G	A	4	7	11	0	0	11	0	0
7	10820643	.	T	C	6	11	17	0	2	19	0	0
7	10845526	.	T	C	13	10	23	1	0	24	0	0
7	10845567	.	G	C	12	13	25	1	0	26	0	0
7	10854748	.	G	A	17	10	27	0	2	29	0	0
7	10873382	.	G	T	6	10	16	0	2	18	0	0
7	10873415	.	G	A	8	4	12	0	0	12	0	0
7	10873567	.	C	T	8	6	14	0	1	15	0	0
7	10873752	.	G	A	1	4	5	0	4	9	0	0
7	10873753	.	C	T	4	5	9	0	0	9	0	0
7	10874141	.	A	T	10	4	14	0	2	16	0	0
7	10874170	.	A	T	8	6	14	0	1	15	0	0
7	10874231	.	T	C	11	18	29	0	2	31	0	0
7	10874252	.	A	C	15	14	29	0	1	30	0	0
7	10874377	.	A	T	10	13	23	0	1	24	0	0
7	10874424	.	T	C	9	12	21	0	1	22	0	0
7	10874548	.	T	A	2	3	5	0	0	5	0	0
7	10874753	.	T	C	8	11	19	0	0	19	0	0
7	10874761	.	A	T	5	12	17	0	1	18	0	0
7	10874837	.	T	A	14	5	19	1	1	21	0	0
7	10874857	.	G	C	14	9	23	1	0	24	0	0
7	10874878	.	A	G	14	15	29	1	1	31	0	0
7	10874949	.	A	G	12	1	13	0	16	29	0	0
7	10875246	.	A	T	18	8	26	1	1	28	0	0
7	10875489	.	C	T	10	9	19	0	2	21	0	0
7	10875539	.	A	G	8	10	18	0	1	19	0	0
7	10875626	.	A	G	24	0	24	0	19	43	0	0
7	10875627	.	T	C	22	22	44	0	0	44	0	0
7	10875692	.	G	C	2	21	23	0	28	51	0	0
7	10875761	.	A	G	26	10	36	0	3	39	0	0
7	10875816	.	T	G	17	0	17	0	12	29	0	0
7	10875870	.	G	A	2	10	12	0	11	23	0	0
7	10875898	.	C	T	12	8	20	0	3	23	0	0
7	10875992	.	G	A	12	13	25	0	1	26	0	0
7	10876209	.	T	C	2	12	14	1	0	15	0	0
7	10876464	.	A	G	15	24	39	0	0	39	0	0
7	10876503	.	C	A	18	27	45	0	0	45	0	0
7	10876643	.	A	G	41	21	62	1	3	66	0	0
7	10876719	.	T	C	24	25	49	0	1	50	0	0
7	10876726	.	T	C	22	28	50	0	1	51	0	0
7	10876870	.	A	G	37	0	37	1	4	42	0	0
7	10876890	.	A	T	30	13	43	1	0	44	0	0
7	10876997	.	A	G	25	1	26	0	24	50	0	0
7	10877036	.	A	C	30	10	40	0	1	41	0	0
7	10877229	.	A	G	28	24	52	0	3	55	0	0
7	10877337	.	C	T	8	12	20	0	1	21	0	0
7	10911514	.	T	G	1	2	3	0	1	4	0	0
7	10911564	.	A	G	3	3	6	0	0	6	0	0
7	10911610	.	C	A	1	5	6	0	0	6	0	0
7	10911934	.	C	G	4	3	7	0	0	7	0	0
7	10912108	.	T	C	3	8	11	0	0	11	0	0
7	11004175	.	T	C	8	10	18	1	0	19	0	0
7	11004374	.	G	T	11	5	16	0	0	16	0	0
7	11004405	.	C	T	9	5	14	0	0	14	0	0
7	11004740	.	C	T	5	6	11	0	0	11	0	0
7	11004820	.	A	G	10	6	16	0	0	16	0	0
7	11004869	.	C	G	0	13	13	0	2	15	0	0
7	11004885	.	T	C	6	15	21	0	0	21	0	0
7	11005098	.	A	C	9	9	18	0	1	19	0	0
7	11005270	.	G	A	2	6	8	0	6	14	0	0
7	11005603	.	G	A	2	4	6	0	0	6	0	0
7	11218333	.	A	G	1	2	3	0	0	3	0	0
7	11218486	.	C	T	1	2	3	0	0	3	0	0
7	11314675	.	C	T	4	2	6	0	1	7	0	0
7	11314693	.	C	T	4	4	8	0	0	8	0	0
7	11318875	.	G	A	5	6	11	0	0	11	0	0
7	11323296	.	C	G	7	1	8	0	7	15	0	0
7	11339674	.	G	A	7	9	16	0	1	17	0	0
7	11340098	.	G	A	5	5	10	0	0	10	0	0
7	11340557	.	A	T	3	5	8	0	1	9	0	0
7	11340558	.	T	G	2	6	8	0	1	9	0	0
7	11340720	.	T	C	3	8	11	0	0	11	0	0
7	11340758	.	G	T	6	6	12	0	0	12	0	0
7	11341472	.	T	G	6	13	19	0	0	19	0	0
7	11341521	.	T	C	14	11	25	0	1	26	0	0
7	11341809	.	T	C	2	10	12	0	1	13	0	0
7	11341815	.	T	A	3	10	13	0	1	14	0	0
7	11341951	.	A	C	2	3	5	0	0	5	0	0
7	11341952	.	T	A	3	3	6	0	0	6	0	0
7	11342252	.	G	T	15	6	21	0	0	21	0	0
7	11378961	.	A	T	12	5	17	0	1	18	0	0
7	11379135	.	T	C	13	11	24	0	0	24	0	0
7	11384178	.	A	G	17	10	27	0	0	27	0	0
7	11580705	.	G	C	0	2	2	0	2	4	0	0
7	11580761	.	A	G	3	3	6	0	0	6	0	0
7	11581838	.	T	C	1	2	3	0	0	3	0	0
7	11581897	.	T	C	1	1	2	0	0	2	0	0
7	11583003	.	G	T	2	3	5	0	0	5	0	0
7	11583086	.	A	G	2	2	4	0	0	4	0	0
7	11583861	.	T	A	1	3	4	0	0	4	0	0
7	11591012	.	G	A	2	2	4	0	0	4	0	0
7	11595738	.	G	A	1	4	5	0	0	5	0	0
7	12062314	.	C	T	11	11	22	0	0	22	0	0
7	12062340	.	A	G	9	12	21	0	2	23	0	0
7	12064002	.	A	G	16	19	35	0	1	36	0	0
7	12065319	.	A	T	11	13	24	0	1	25	0	0
7	12141254	.	C	A	4	2	6	0	0	6	0	0
7	12141390	.	T	C	2	0	2	0	2	4	0	0
7	12141496	.	C	A	2	4	6	0	0	6	0	0
7	12142118	.	G	C	3	4	7	0	0	7	0	0
7	12181186	.	T	C	3	2	5	0	0	5	0	0
7	12310174	.	G	A	2	2	4	0	0	4	0	0
7	12390138	.	T	G	3	3	6	0	0	6	0	0
7	12390365	.	A	T	2	5	7	0	0	7	0	0
7	12401677	.	G	T	3	2	5	0	0	5	0	0
7	12418214	.	C	A	1	2	3	0	1	4	0	0
7	12421116	.	A	G	4	2	6	0	0	6	0	0
7	12421122	.	C	T	4	2	6	0	0	6	0	0
7	12446556	.	A	C	1	0	1	0	3	4	0	0
7	12463760	.	T	A	1	2	3	0	0	3	0	0
7	12463775	.	G	A	0	1	1	0	2	3	0	0
7	12843975	.	T	C	4	1	5	0	4	9	0	0
7	12843987	.	T	C	1	8	9	0	0	9	0	0
7	12844513	.	T	C	7	4	11	0	0	11	0	0
7	12844537	.	T	C	9	3	12	0	0	12	0	0
7	13336485	.	A	T	1	2	3	0	1	4	0	0
7	13617359	.	A	G	3	0	3	0	2	5	0	0
7	13618290	.	A	G	2	2	4	0	0	4	0	0
7	13626070	.	A	G	3	2	5	0	0	5	0	0
7	14203761	.	A	G	3	5	8	0	0	8	0	0
7	15607893	.	A	G	5	3	8	0	1	9	0	0
7	15608177	.	A	G	4	4	8	1	1	10	0	0
7	15608353	.	A	G	2	3	5	0	2	7	0	0
7	15608462	.	A	G	9	3	12	0	0	12	0	0
7	15608473	.	A	G	6	6	12	0	2	14	0	0
7	15608791	.	A	G	3	2	5	0	0	5	0	0
7	15608792	.	A	G	2	3	5	0	0	5	0	0
7	15609031	.	A	G	11	5	16	0	0	16	0	0
7	15609037	.	A	G	9	7	16	0	0	16	0	0
7	17102964	.	G	T	7	3	10	0	0	10	0	0
7	17761684	.	T	C	2	2	4	2	0	6	0	0
7	17942482	.	A	G	3	6	9	0	0	9	0	0
7	17969792	.	A	G	7	4	11	0	0	11	0	0
7	18607732	.	C	T	1	4	5	0	0	5	0	0
7	19071617	.	T	C	17	6	23	0	2	25	0	0
7	19071633	.	T	C	18	5	23	0	2	25	0	0
7	19073105	.	T	C	1	7	8	0	0	8	0	0
7	19073818	.	T	C	6	6	12	0	0	12	0	0
7	19745853	.	G	A	1	8	9	0	8	17	0	0
7	19753008	.	C	A	9	16	25	0	0	25	0	0
7	19753702	.	C	T	9	13	22	0	0	22	0	0
7	19759079	.	G	T	9	13	22	0	0	22	0	0
7	19759194	.	C	A	7	6	13	0	2	15	0	0
7	19759209	.	G	A	0	10	10	0	8	18	0	0
7	19759263	.	T	A	13	6	19	0	0	19	0	0
7	19759296	.	C	T	14	4	18	0	0	18	0	0
7	19759299	.	A	T	12	4	16	0	2	18	0	0
7	19759550	.	C	T	6	5	11	0	0	11	0	0
7	19759895	.	C	T	3	2	5	0	0	5	0	0
7	19759962	.	C	T	3	4	7	0	0	7	0	0
7	19759968	.	A	T	4	3	7	0	0	7	0	0
7	19851480	.	C	T	3	2	5	0	0	5	0	0
7	19855044	.	T	C	0	2	2	0	0	2	0	0
7	19855049	.	A	G	1	3	4	0	0	4	0	0
7	19862407	.	C	T	1	3	4	0	0	4	0	0
7	19864504	.	G	A	1	3	4	0	5	9	0	0
7	19881951	.	A	G	1	1	2	0	0	2	0	0
7	19881961	.	C	G	1	1	2	0	1	3	0	0
7	19891551	.	G	A	4	2	6	0	0	6	0	0
7	19891779	.	G	C	1	5	6	0	0	6	0	0
7	19892592	.	A	G	3	0	3	0	4	7	0	0
7	19892880	.	G	A	0	3	3	0	4	7	0	0
7	19893023	.	A	G	1	3	4	0	0	4	0	0
7	19893149	.	T	G	1	6	7	0	0	7	0	0
7	19893463	.	A	G	3	4	7	0	0	7	0	0
7	19893573	.	T	A	2	4	6	0	1	7	0	0
7	19893705	.	A	T	4	3	7	0	0	7	0	0
7	19894016	.	A	G	3	4	7	0	1	8	0	0
7	19894099	.	A	G	4	1	5	0	2	7	0	0
7	19894234	.	A	T	1	2	3	0	0	3	0	0
7	19894322	.	T	G	1	3	4	0	0	4	0	0
7	19894406	.	T	C	1	1	2	0	1	3	0	0
7	19895088	.	G	A	0	8	8	0	11	19	0	0
7	19895139	.	G	C	5	5	10	0	0	10	0	0
7	19895268	.	G	A	3	2	5	0	0	5	0	0
7	19895506	.	G	A	0	2	2	0	1	3	0	0
7	19895683	.	C	T	5	2	7	0	0	7	0	0
7	19895919	.	C	G	2	2	4	0	0	4	0	0
7	19895958	.	G	A	3	2	5	0	0	5	0	0
7	19895963	.	G	T	4	2	6	0	0	6	0	0
7	19896060	.	A	G	2	3	5	0	0	5	0	0
7	19896212	.	G	A	1	5	6	0	0	6	0	0
7	19896221	.	G	C	5	2	7	0	0	7	0	0
7	19896400	.	A	C	6	6	12	0	1	13	0	0
7	19896628	.	G	A	8	3	11	0	0	11	0	0
7	19896642	.	G	T	6	4	10	0	1	11	0	0
7	19897309	.	C	T	12	9	21	0	0	21	0	0
7	19897599	.	G	A	3	2	5	0	0	5	0	0
7	19897959	.	T	C	5	8	13	0	0	13	0	0
7	19910307	.	G	A	3	2	5	0	1	6	0	0
7	19910308	.	A	G	2	3	5	0	1	6	0	0
7	19910931	.	G	A	1	2	3	0	0	3	0	0
7	19931616	.	A	C	1	7	8	0	0	8	0	0
7	19965281	.	G	A	3	9	12	0	0	12	0	0
7	19965721	.	T	A	5	3	8	0	0	8	0	0
7	19966252	.	G	A	7	2	9	0	0	9	0	0
7	19978616	.	G	A	1	6	7	0	0	7	0	0
7	19978847	.	G	A	4	2	6	0	0	6	0	0
7	19978875	.	T	A	1	5	6	0	0	6	0	0
7	19979028	.	C	T	5	5	10	0	0	10	0	0
7	19979133	.	C	T	4	7	11	0	0	11	0	0
7	19979200	.	A	G	8	6	14	0	0	14	0	0
7	19979561	.	C	T	0	5	5	0	1	6	0	0
7	19979575	.	G	T	1	5	6	0	0	6	0	0
7	19979669	.	G	A	5	8	13	0	0	13	0	0
7	19979943	.	A	T	6	7	13	0	1	14	0	0
7	19979968	.	C	A	1	4	5	0	7	12	0	0
7	19984249	.	A	G	2	4	6	0	0	6	0	0
7	19988393	.	G	A	1	6	7	0	1	8	0	0
7	19988581	.	G	A	3	6	9	0	0	9	0	0
7	19998621	.	A	G	2	4	6	0	1	7	0	0
7	20026875	.	A	G	3	3	6	0	0	6	0	0
7	20027717	.	G	A	3	5	8	0	1	9	0	0
7	20027807	.	G	A	0	3	3	0	2	5	0	0
7	20046123	.	T	C	1	2	3	0	0	3	0	0
7	20118228	.	C	G	6	11	17	0	1	18	0	0
7	20118330	.	T	C	13	10	23	0	0	23	0	0
7	20141697	.	T	C	12	15	27	0	4	31	0	0
7	20141823	.	A	G	19	8	27	0	1	28	0	0
7	20141916	.	T	C	9	10	19	0	0	19	0	0
7	20142497	.	T	A	4	3	7	0	0	7	0	0
7	20142523	.	T	C	2	2	4	0	1	5	0	0
7	20176444	.	A	T	1	3	4	0	0	4	0	0
7	20222385	.	A	G	8	5	13	0	0	13	0	0
7	20222861	.	C	G	3	4	7	0	0	7	0	0
7	20223074	.	G	A	4	5	9	0	0	9	0	0
7	20223079	.	A	G	5	6	11	0	0	11	0	0
7	20223110	.	G	A	4	5	9	0	0	9	0	0
7	20223478	.	T	A	4	6	10	0	0	10	0	0
7	20223568	.	C	T	10	5	15	0	1	16	0	0
7	20223632	.	C	T	7	3	10	0	0	10	0	0
7	20292846	.	G	T	1	2	3	0	0	3	0	0
7	20293664	.	T	C	3	3	6	0	0	6	0	0
7	20293669	.	A	C	3	3	6	0	0	6	0	0
7	20293913	.	A	G	1	2	3	0	0	3	0	0
7	20294039	.	T	C	2	3	5	0	0	5	0	0
7	20294074	.	T	C	2	4	6	0	0	6	0	0
7	20294433	.	C	T	1	2	3	0	0	3	0	0
7	20294592	.	C	A	1	3	4	0	0	4	0	0
7	20298598	.	A	T	2	3	5	0	0	5	0	0
7	20298670	.	T	C	1	3	4	0	0	4	0	0
7	20298709	.	A	C	1	2	3	0	1	4	0	0
7	20298789	.	C	G	3	9	12	0	1	13	0	0
7	20298851	.	C	G	3	5	8	0	0	8	0	0
7	20301839	.	C	T	4	7	11	0	0	11	0	0
7	20302952	.	A	G	7	6	13	0	1	14	0	0
7	20305694	.	C	T	2	7	9	0	0	9	0	0
7	20305697	.	C	T	2	6	8	0	0	8	0	0
7	20310893	.	T	C	8	8	16	0	1	17	0	0
7	20310929	.	T	C	8	8	16	0	0	16	0	0
7	20315913	.	G	A	6	9	15	0	2	17	0	0
7	20325995	.	C	T	9	9	18	0	0	18	0	0
7	20326405	.	T	C	7	9	16	0	0	16	0	0
7	20332513	.	T	C	7	12	19	0	1	20	0	0
7	20332775	.	A	T	16	12	28	0	1	29	0	0
7	20332784	.	G	A	15	14	29	0	1	30	0	0
7	20332959	.	G	A	18	11	29	0	3	32	0	0
7	20332963	.	G	A	18	13	31	0	0	31	0	0
7	20333061	.	A	G	11	1	12	0	6	18	0	0
7	20333076	.	C	A	11	6	17	0	0	17	0	0
7	20333120	.	A	C	12	4	16	0	0	16	0	0
7	20333276	.	T	G	4	8	12	0	2	14	0	0
7	20334388	.	A	C	1	2	3	0	0	3	0	0
7	20334603	.	T	C	5	9	14	0	0	14	0	0
7	20334891	.	T	G	1	3	4	0	0	4	0	0
7	20335283	.	T	C	1	4	5	0	1	6	0	0
7	20335323	.	G	A	0	3	3	0	1	4	0	0
7	20636168	.	C	A	6	3	9	0	0	9	0	0
7	20780758	.	T	C	9	7	16	0	4	20	0	0
7	20780797	.	T	C	15	5	20	0	1	21	0	0
7	20781528	.	T	C	4	4	8	0	1	9	0	0
7	20781535	.	T	C	3	4	7	0	1	8	0	0
7	20781592	.	T	C	1	4	5	0	1	6	0	0
7	20781593	.	T	C	1	5	6	0	0	6	0	0
7	20859823	.	T	A	5	3	8	0	1	9	0	0
7	22324727	.	A	G	1	5	6	0	0	6	0	0
7	22626669	.	A	G	1	8	9	0	0	9	0	0
7	22793530	.	T	G	2	0	2	0	30	32	0	0
7	22850588	.	A	G	22	6	28	0	1	29	0	0
7	23493268	.	C	T	1	4	5	0	0	5	0	0
7	23751420	.	T	C	14	6	20	0	0	20	0	0
7	23970588	.	A	T	1	1	2	0	1	3	0	0
7	24457845	.	T	C	35	13	48	0	2	50	0	0
7	24672766	.	A	G	2	3	5	0	0	5	0	0
7	25293646	.	C	T	7	3	10	0	0	10	0	0
7	26148260	.	A	G	48	1	49	0	16	65	0	0
7	26148796	.	C	T	15	3	18	0	2	20	0	0
7	26230138	.	G	A	4	3	7	0	0	7	0	0
7	26230142	.	T	A	4	2	6	0	0	6	0	0
7	26892514	.	A	C	0	2	2	0	1	3	0	0
7	27681025	.	G	T	8	9	17	0	1	18	0	0
7	27681071	.	A	T	14	16	30	0	2	32	0	0
7	27682919	.	C	T	13	12	25	0	0	25	0	0
7	27683530	.	G	A	2	3	5	0	0	5	0	0
7	27700517	.	G	A	9	7	16	0	1	17	0	0
7	27700777	.	C	T	4	7	11	0	13	24	0	0
7	27701155	.	C	G	0	4	4	0	1	5	0	0
7	27701231	.	T	A	6	6	12	0	0	12	0	0
7	27701348	.	A	C	9	6	15	0	2	17	0	0
7	27701431	.	T	A	3	4	7	0	0	7	0	0
7	27701561	.	A	T	4	14	18	0	1	19	0	0
7	27701623	.	C	A	6	4	10	0	0	10	0	0
7	27701634	.	A	G	4	4	8	0	1	9	0	0
7	27702003	.	A	C	3	5	8	0	0	8	0	0
7	27702571	.	T	G	11	5	16	0	0	16	0	0
7	27702934	.	G	A	8	6	14	0	0	14	0	0
7	27702998	.	T	A	8	9	17	0	0	17	0	0
7	27703102	.	T	C	5	10	15	0	3	18	0	0
7	27705837	.	G	A	7	12	19	0	0	19	0	0
7	27718258	.	C	G	0	5	5	0	7	12	0	0
7	27720520	.	A	G	5	9	14	0	0	14	0	0
7	27722513	.	A	G	6	5	11	0	0	11	0	0
7	27722534	.	A	G	7	3	10	0	0	10	0	0
7	27797760	.	A	G	2	2	4	0	2	6	0	0
7	27797834	.	A	C	2	3	5	0	0	5	0	0
7	27798561	.	A	C	5	4	9	0	0	9	0	0
7	27805487	.	A	G	6	4	10	0	0	10	0	0
7	27805547	.	C	T	4	2	6	0	1	7	0	0
7	27806074	.	G	A	0	6	6	0	6	12	0	0
7	27811770	.	C	T	8	9	17	0	0	17	0	0
7	27813749	.	C	T	10	8	18	0	3	21	0	0
7	27813942	.	G	A	6	8	14	0	3	17	0	0
7	27813978	.	A	G	9	0	9	0	7	16	0	0
7	27814326	.	C	T	15	11	26	0	1	27	0	0
7	27816668	.	T	C	12	16	28	0	1	29	0	0
7	27816875	.	C	T	15	10	25	0	0	25	0	0
7	27817229	.	C	A	24	11	35	0	2	37	0	0
7	27817283	.	A	G	20	0	20	0	17	37	0	0
7	27817755	.	G	C	18	27	45	0	1	46	0	0
7	27820177	.	G	A	3	6	9	0	0	9	0	0
7	27834170	.	A	G	4	3	7	0	0	7	0	0
7	27884185	.	A	G	6	7	13	0	0	13	0	0
7	27884211	.	A	G	5	6	11	0	0	11	0	0
7	27884979	.	G	T	5	3	8	0	0	8	0	0
7	27885000	.	T	C	3	3	6	0	0	6	0	0
7	27885043	.	C	T	4	3	7	1	0	8	0	0
7	27885259	.	A	G	6	4	10	0	0	10	0	0
7	27885941	.	G	A	4	10	14	0	0	14	0	0
7	27886502	.	A	T	6	4	10	0	0	10	0	0
7	27886508	.	A	T	7	3	10	0	0	10	0	0
7	27886602	.	C	A	9	8	17	0	0	18	1	0
7	27886923	.	A	G	13	15	28	0	1	29	0	0
7	27886924	.	A	G	11	17	28	0	0	28	0	0
7	27977083	.	G	A	2	2	4	0	3	7	0	0
7	28033649	.	G	A	1	6	7	0	9	16	0	0
7	28039990	.	G	A	0	6	6	0	5	11	0	0
7	28040014	.	G	T	0	4	4	0	6	10	0	0
7	28040083	.	T	C	3	9	12	0	0	12	0	0
7	28040885	.	T	C	5	1	6	0	1	7	0	0
7	28041246	.	T	G	1	0	1	0	5	6	0	0
7	28041496	.	T	C	6	6	12	0	0	12	0	0
7	28041538	.	T	C	7	8	15	0	0	15	0	0
7	28041570	.	G	T	10	6	16	0	0	16	0	0
7	28041615	.	C	T	6	2	8	0	0	8	0	0
7	28041842	.	T	C	3	2	5	0	1	6	0	0
7	28041942	.	T	C	7	4	11	0	0	11	0	0
7	28042027	.	G	A	9	4	13	0	0	13	0	0
7	28042690	.	A	G	4	0	4	0	2	6	0	0
7	28042699	.	A	G	3	0	3	0	3	6	0	0
7	28042740	.	G	A	2	7	9	0	1	10	0	0
7	28043184	.	A	G	9	0	9	0	5	14	0	0
7	28043284	.	A	G	9	5	14	0	0	14	0	0
7	28043416	.	A	G	4	10	14	0	2	16	0	0
7	28043837	.	T	G	8	0	8	0	8	16	0	0
7	28043852	.	G	A	5	8	13	0	1	14	0	0
7	28044193	.	A	G	8	9	17	0	0	17	0	0
7	28044303	.	A	G	9	3	12	0	0	12	0	0
7	28044339	.	A	G	3	7	10	0	0	10	0	0
7	28044628	.	A	G	9	3	12	2	0	14	0	0
7	28044639	.	A	G	9	3	12	1	0	13	0	0
7	28045160	.	G	A	0	4	4	1	5	10	0	0
7	28045263	.	C	G	11	9	20	1	0	21	0	0
7	28045404	.	A	C	13	4	17	0	0	17	0	0
7	28045444	.	T	A	11	11	22	0	1	23	0	0
7	28045541	.	A	T	12	4	16	0	1	17	0	0
7	28045571	.	T	C	10	6	16	0	0	16	0	0
7	28045600	.	C	T	12	8	20	0	1	21	0	0
7	28045685	.	C	T	5	4	9	0	0	9	0	0
7	28046436	.	T	C	13	4	17	2	0	19	0	0
7	28046530	.	A	G	12	15	27	0	0	27	0	0
7	28046572	.	T	C	15	8	23	0	0	23	0	0
7	28046580	.	A	G	8	16	24	0	2	26	0	0
7	28046619	.	A	G	19	0	19	3	9	31	0	0
7	28046718	.	G	A	12	4	16	1	0	17	0	0
7	28046723	.	G	A	12	4	16	0	0	16	0	0
7	28046784	.	C	T	6	3	9	0	0	9	0	0
7	28046918	.	A	C	5	7	12	0	1	13	0	0
7	28047004	.	G	A	12	4	16	0	1	17	0	0
7	28047072	.	C	T	11	9	20	0	0	20	0	0
7	28047163	.	C	T	4	3	7	0	0	7	0	0
7	28147806	.	T	A	18	16	34	0	2	36	0	0
7	28406477	.	G	A	2	6	8	0	0	8	0	0
7	28406514	.	G	A	2	6	8	0	0	8	0	0
7	28407151	.	G	T	4	3	7	0	1	8	0	0
7	28407152	.	T	G	4	4	8	0	0	8	0	0
7	28407339	.	A	G	1	8	9	0	0	9	0	0
7	28424095	.	G	A	2	5	7	0	1	8	0	0
7	28424237	.	C	G	9	5	14	0	2	16	0	0
7	28424381	.	A	T	11	6	17	0	0	17	0	0
7	28430010	.	G	A	7	12	19	0	0	19	0	0
7	28430127	.	C	A	11	8	19	0	2	21	0	0
7	28430430	.	C	T	10	8	18	0	2	20	0	0
7	28430454	.	C	A	7	7	14	0	1	15	0	0
7	28430503	.	G	A	5	8	13	0	0	13	0	0
7	28430528	.	G	T	6	8	14	0	1	15	0	0
7	28434034	.	A	T	8	10	18	2	0	20	0	0
7	28436486	.	G	C	12	10	22	0	2	24	0	0
7	28442009	.	G	C	12	6	18	0	1	19	0	0
7	28448588	.	C	T	9	5	14	0	0	14	0	0
7	28465338	.	G	A	9	9	18	0	0	18	0	0
7	28467182	.	A	G	12	9	21	0	2	23	0	0
7	28485206	.	G	A	2	5	7	0	0	7	0	0
7	28499926	.	G	A	7	2	9	0	0	9	0	0
7	28516154	.	A	G	3	2	5	0	0	5	0	0
7	28516905	.	G	A	1	2	3	0	0	3	0	0
7	28559598	.	C	T	0	2	2	0	1	3	0	0
7	28559907	.	G	A	22	12	34	0	0	34	0	0
7	28559969	.	G	T	17	9	26	0	1	27	0	0
7	28560250	.	G	C	19	14	33	0	1	35	1	0
7	28560256	.	G	A	22	14	36	0	1	37	0	0
7	28560467	.	C	G	11	23	34	0	1	35	0	0
7	28562196	.	A	G	14	15	29	0	1	30	0	0
7	28569646	.	T	C	1	2	3	0	0	3	0	0
7	28570209	.	T	C	3	3	6	0	0	6	0	0
7	28571529	.	G	A	2	2	4	0	0	4	0	0
7	28586850	.	T	C	1	2	3	0	0	3	0	0
7	28586860	.	T	C	1	0	1	0	1	2	0	0
7	28612726	.	T	C	15	13	28	0	0	28	0	0
7	28612899	.	G	A	0	6	6	0	13	19	0	0
7	28612929	.	A	G	10	11	21	0	1	22	0	0
7	28612962	.	G	A	15	8	23	0	0	23	0	0
7	28615709	.	T	C	12	14	26	0	1	27	0	0
7	28615850	.	G	A	12	20	32	0	2	34	0	0
7	28615922	.	A	G	23	0	23	1	15	39	0	0
7	28618813	.	C	T	31	13	44	2	4	50	0	0
7	28622856	.	G	A	23	13	36	0	4	40	0	0
7	28622970	.	T	C	21	22	43	0	2	45	0	0
7	28623456	.	G	A	6	5	11	0	1	12	0	0
7	28623506	.	T	A	2	6	8	0	0	8	0	0
7	28623533	.	A	T	2	3	5	0	0	5	0	0
7	28623823	.	G	T	3	4	7	0	0	7	0	0
7	28623860	.	A	G	7	5	12	0	0	12	0	0
7	28623863	.	A	G	8	6	14	0	0	14	0	0
7	28624106	.	A	T	2	5	7	1	0	8	0	0
7	28624157	.	C	G	3	2	5	1	0	6	0	0
7	28624171	.	T	C	5	2	7	0	0	7	0	0
7	28624688	.	A	T	8	6	14	0	0	14	0	0
7	28624692	.	T	C	6	7	13	0	1	14	0	0
7	28625145	.	A	T	3	4	7	0	0	7	0	0
7	28625174	.	G	C	1	2	3	0	0	3	0	0
7	28625933	.	G	T	2	4	6	0	0	6	0	0
7	28626037	.	G	C	1	3	4	0	0	4	0	0
7	28626098	.	G	A	5	6	11	0	0	11	0	0
7	28649564	.	G	A	1	3	4	0	0	4	0	0
7	28649573	.	T	C	2	2	4	0	0	4	0	0
7	29172082	.	T	G	3	3	6	0	0	6	0	0
7	29177427	.	T	C	1	2	3	0	0	3	0	0
7	29182296	.	T	G	3	0	3	0	5	8	0	0
7	29182733	.	A	G	8	3	11	0	0	11	0	0
7	29185910	.	C	G	10	0	10	0	5	15	0	0
7	29186433	.	T	C	10	11	21	0	3	24	0	0
7	29186453	.	A	C	11	13	24	0	0	24	0	0
7	29186483	.	C	T	10	7	17	0	2	19	0	0
7	29186504	.	T	C	7	8	15	0	2	17	0	0
7	29186549	.	T	C	7	8	15	0	1	16	0	0
7	29186589	.	C	G	6	0	6	0	10	16	0	0
7	29186605	.	T	C	9	5	14	0	1	15	0	0
7	29186640	.	G	A	5	6	11	0	0	11	0	0
7	29186677	.	C	T	2	4	6	0	1	7	0	0
7	29186717	.	G	A	1	1	2	0	1	3	0	0
7	29189508	.	G	C	19	10	29	0	2	31	0	0
7	29189652	.	C	T	15	5	20	0	0	20	0	0
7	29200013	.	G	A	14	5	19	0	0	19	0	0
7	29204945	.	T	C	5	6	11	0	2	13	0	0
7	29205418	.	T	G	7	8	15	0	2	17	0	0
7	29207187	.	A	G	6	3	9	0	0	9	0	0
7	29207208	.	T	A	1	6	7	0	0	7	0	0
7	29210014	.	G	A	2	3	5	0	1	6	0	0
7	29210755	.	G	A	3	3	6	0	1	7	0	0
7	29211339	.	C	A	1	5	6	0	0	6	0	0
7	29214910	.	G	A	5	3	8	0	0	8	0	0
7	29223536	.	G	T	4	5	9	0	0	9	0	0
7	29224517	.	G	A	2	2	4	0	0	4	0	0
7	29229377	.	G	T	1	2	3	0	0	3	0	0
7	29229535	.	G	A	4	3	7	0	0	7	0	0
7	29229594	.	T	G	1	3	4	0	0	4	0	0
7	29235738	.	C	G	1	2	3	0	0	3	0	0
7	29262646	.	G	A	1	2	3	0	0	3	0	0
7	29301751	.	C	T	13	5	18	0	1	19	0	0
7	29308739	.	T	A	1	3	4	0	0	4	0	0
7	29308886	.	C	A	7	5	12	0	0	12	0	0
7	29308910	.	G	A	8	5	13	0	0	13	0	0
7	29308930	.	C	A	9	4	13	0	0	13	0	0
7	29308968	.	A	T	5	4	9	0	0	9	0	0
7	29309027	.	A	G	7	5	12	0	0	12	0	0
7	29309271	.	A	T	9	4	13	0	1	14	0	0
7	29309851	.	T	C	7	8	15	0	1	16	0	0
7	29310618	.	G	A	9	5	14	1	0	15	0	0
7	29310700	.	G	A	6	4	10	0	0	10	0	0
7	29355244	.	G	C	15	1	16	0	16	32	0	0
7	29356006	.	A	C	16	0	16	0	21	37	0	0
7	29539523	.	T	A	8	12	20	0	2	22	0	0
7	29539862	.	T	C	14	7	21	0	0	21	0	0
7	29540412	.	G	A	9	20	29	0	1	30	0	0
7	29540693	.	A	G	9	6	15	0	1	16	0	0
7	29540885	.	T	A	16	22	38	0	0	38	0	0
7	29540999	.	A	G	11	11	22	0	1	23	0	0
7	29542909	.	T	G	14	12	26	0	0	26	0	0
7	29542916	.	T	C	13	13	26	0	0	26	0	0
7	29625427	.	G	A	6	6	12	0	0	12	0	0
7	29629143	.	A	T	3	2	5	0	2	7	0	0
7	29629235	.	A	C	1	3	4	0	0	4	0	0
7	29629874	.	C	A	2	2	4	0	0	4	0	0
7	29633693	.	T	C	2	5	7	0	0	7	0	0
7	29633743	.	G	A	7	7	14	0	1	15	0	0
7	29649401	.	C	G	1	5	6	0	1	7	0	0
7	29653004	.	A	G	7	6	13	0	2	15	0	0
7	29655006	.	A	G	3	5	8	0	0	8	0	0
7	29657144	.	T	C	5	0	5	0	4	9	0	0
7	29657186	.	A	G	6	3	9	1	0	10	0	0
7	29658306	.	T	C	3	2	5	0	0	5	0	0
7	29674931	.	T	C	5	2	7	0	1	8	0	0
7	29675798	.	C	G	1	2	3	0	0	3	0	0
7	29683914	.	C	T	1	2	3	0	0	3	0	0
7	29683915	.	A	G	1	2	3	0	0	3	0	0
7	29689837	.	G	A	1	3	4	0	1	5	0	0
7	29902696	.	T	C	3	3	6	0	0	6	0	0
7	29906436	.	A	G	2	2	4	0	0	4	0	0
7	29924109	.	A	G	1	2	3	0	0	3	0	0
7	29928703	.	C	A	3	2	5	0	0	5	0	0
7	29930218	.	C	T	3	3	6	0	0	6	0	0
7	29939497	.	A	C	6	4	10	0	1	11	0	0
7	29939694	.	G	C	9	7	16	0	0	16	0	0
7	29941546	.	A	G	6	6	12	0	0	12	0	0
7	29941709	.	G	A	2	5	7	0	5	12	0	0
7	29942050	.	A	T	9	8	17	0	1	18	0	0
7	29944670	.	C	T	5	5	10	0	0	10	0	0
7	29944689	.	C	G	7	5	12	0	0	12	0	0
7	29944881	.	G	C	0	4	4	0	9	13	0	0
7	29945372	.	A	T	3	2	5	0	0	5	0	0
7	29945564	.	C	A	10	11	21	0	0	21	0	0
7	29945607	.	T	C	8	9	17	0	1	18	0	0
7	29945837	.	G	A	13	13	26	0	3	29	0	0
7	29960352	.	G	C	1	2	3	0	1	4	0	0
7	29960848	.	G	A	9	6	15	0	1	16	0	0
7	29960947	.	C	T	9	4	13	0	0	13	0	0
7	29961106	.	C	G	10	9	19	0	1	20	0	0
7	29961207	.	A	C	8	11	19	0	0	19	0	0
7	29961296	.	A	G	9	14	23	0	1	24	0	0
7	29961513	.	T	A	17	9	26	0	3	29	0	0
7	29961592	.	G	A	14	15	29	0	1	30	0	0
7	29961965	.	A	T	1	3	4	0	0	4	0	0
7	29964289	.	A	G	5	2	7	0	1	8	0	0
7	29967989	.	C	T	2	7	9	0	0	9	0	0
7	29968012	.	G	C	2	5	7	0	0	7	0	0
7	29968099	.	C	T	4	7	11	0	0	11	0	0
7	29968505	.	G	A	5	4	9	0	1	10	0	0
7	29968534	.	A	G	1	3	4	0	2	6	0	0
7	29968869	.	A	G	1	2	3	0	0	3	0	0
7	29969008	.	A	G	0	3	3	0	1	4	0	0
7	29969280	.	A	G	6	3	9	1	0	10	0	0
7	29969303	.	T	G	5	4	9	1	0	10	0	0
7	29969479	.	A	G	3	0	3	0	2	5	0	0
7	29969616	.	G	C	5	3	8	0	0	8	0	0
7	29969644	.	G	A	0	3	3	0	8	11	0	0
7	29969682	.	C	G	7	3	10	0	1	11	0	0
7	29969704	.	A	G	6	2	8	0	2	10	0	0
7	29969724	.	A	C	6	4	10	1	0	11	0	0
7	30075289	.	T	G	3	2	5	0	0	5	0	0
7	30076966	.	A	G	4	4	8	0	0	8	0	0
7	30077328	.	A	G	5	9	14	0	0	14	0	0
7	30077347	.	A	G	6	8	14	0	1	15	0	0
7	30077479	.	G	C	4	9	13	0	0	13	0	0
7	30077495	.	C	T	4	11	15	0	0	15	0	0
7	30077581	.	T	G	12	8	20	0	1	21	0	0
7	30080032	.	G	A	8	10	18	0	2	20	0	0
7	30080166	.	A	G	11	16	27	0	2	29	0	0
7	30080468	.	C	G	18	6	24	0	0	24	0	0
7	30080603	.	T	C	10	12	22	0	2	24	0	0
7	30080872	.	G	A	6	11	17	0	0	17	0	0
7	30082857	.	C	A	18	14	32	0	0	32	0	0
7	30082871	.	T	A	14	11	25	0	0	25	0	0
7	30082894	.	G	C	6	8	14	0	0	14	0	0
7	30086732	.	T	C	6	7	13	0	2	15	0	0
7	30136304	.	C	G	9	10	19	0	2	21	0	0
7	30136604	.	C	T	3	2	5	0	1	6	0	0
7	30137350	.	C	T	1	2	3	0	1	4	0	0
7	30137667	.	C	T	7	3	10	0	0	10	0	0
7	30138559	.	T	A	1	2	3	0	0	3	0	0
7	30138737	.	G	A	2	2	4	0	1	5	0	0
7	30139247	.	G	A	2	2	4	0	0	4	0	0
7	30139655	.	C	T	2	3	5	0	0	5	0	0
7	30139952	.	G	A	2	4	6	0	1	7	0	0
7	30139991	.	T	A	5	8	13	0	0	13	0	0
7	30140027	.	G	A	6	3	9	0	0	9	0	0
7	30177438	.	T	A	1	2	3	0	0	3	0	0
7	30179568	.	G	C	2	2	4	0	0	4	0	0
7	30188324	.	T	C	3	5	8	0	0	8	0	0
7	30188459	.	C	T	5	2	7	0	0	7	0	0
7	30210151	.	T	A	10	4	14	0	1	15	0	0
7	30210250	.	A	C	8	7	15	0	0	15	0	0
7	30210282	.	T	G	8	12	20	0	1	21	0	0
7	30210445	.	C	G	1	14	15	0	12	27	0	0
7	30210659	.	T	C	9	8	17	0	1	18	0	0
7	30210833	.	C	T	5	2	7	0	0	7	0	0
7	30210840	.	T	C	4	4	8	0	0	8	0	0
7	30211482	.	C	T	6	9	15	0	0	15	0	0
7	30211530	.	T	A	10	9	19	0	1	20	0	0
7	30213672	.	A	G	16	13	29	0	0	29	0	0
7	30214023	.	A	T	7	12	19	0	1	21	1	0
7	30214047	.	G	C	11	0	11	0	11	22	0	0
7	30214333	.	A	C	5	3	8	0	0	8	0	0
7	30263244	.	A	C	1	2	3	0	1	4	0	0
7	30263253	.	G	C	1	1	2	0	0	2	0	0
7	30264178	.	C	T	2	5	7	0	0	7	0	0
7	30266996	.	G	T	2	2	4	0	0	4	0	0
7	30270675	.	T	G	6	2	8	0	0	8	0	0
7	30270676	.	T	A	4	2	6	0	2	8	0	0
7	30270984	.	G	A	7	5	12	0	0	12	0	0
7	30275668	.	A	T	4	9	13	0	0	13	0	0
7	30275834	.	G	A	5	4	9	0	0	9	0	0
7	30275935	.	G	A	2	6	8	0	0	8	0	0
7	30276365	.	C	T	17	18	35	0	1	36	0	0
7	30276528	.	T	A	21	26	47	0	1	48	0	0
7	30280856	.	C	G	28	30	58	0	1	59	0	0
7	30283700	.	C	T	7	3	10	0	0	10	0	0
7	30286678	.	A	G	3	3	6	0	0	6	0	0
7	30330368	.	G	A	7	7	14	0	0	14	0	0
7	30409217	.	G	A	1	2	3	0	0	3	0	0
7	30409322	.	T	C	3	16	19	0	1	20	0	0
7	30409539	.	T	A	16	13	29	0	3	32	0	0
7	30409580	.	A	T	13	15	28	0	0	28	0	0
7	30409585	.	G	A	13	11	24	0	1	25	0	0
7	30409661	.	G	A	4	13	17	0	1	18	0	0
7	30410035	.	T	A	7	8	15	0	0	15	0	0
7	30410089	.	C	T	1	4	5	0	5	10	0	0
7	30410447	.	T	C	2	4	6	0	0	6	0	0
7	30410687	.	T	A	6	6	12	0	1	13	0	0
7	30411052	.	C	T	4	10	14	0	0	14	0	0
7	30412884	.	C	T	8	5	13	0	0	13	0	0
7	30421532	.	G	A	3	3	6	0	0	6	0	0
7	30494077	.	T	A	3	2	5	0	0	5	0	0
7	30494089	.	G	A	2	2	4	0	0	4	0	0
7	30518843	.	C	T	4	3	7	0	1	8	0	0
7	30519636	.	C	A	6	4	10	0	0	10	0	0
7	30522713	.	C	T	4	2	6	0	0	6	0	0
7	30525721	.	G	T	1	7	8	0	0	8	0	0
7	30533152	.	A	T	4	4	8	0	1	9	0	0
7	30533299	.	G	T	5	4	9	0	2	11	0	0
7	30534082	.	T	C	1	6	7	0	2	9	0	0
7	30534397	.	G	A	5	2	7	0	0	7	0	0
7	30534404	.	G	A	5	2	7	0	0	7	0	0
7	30534433	.	G	T	1	4	5	0	0	5	0	0
7	30534538	.	C	T	6	3	9	0	0	9	0	0
7	30534556	.	C	T	4	2	6	0	1	7	0	0
7	30534678	.	G	A	0	5	5	0	5	10	0	0
7	30534824	.	G	C	1	6	7	1	0	8	0	0
7	30534930	.	T	A	6	4	10	0	1	11	0	0
7	30535113	.	G	T	3	4	7	0	1	8	0	0
7	30535162	.	T	G	3	7	10	0	1	11	0	0
7	30535163	.	G	T	3	7	10	0	1	11	0	0
7	30535422	.	A	G	1	2	3	0	0	3	0	0
7	30536396	.	C	G	9	10	19	0	0	19	0	0
7	30536480	.	G	A	10	8	18	0	0	18	0	0
7	30536566	.	A	G	11	0	11	0	5	16	0	0
7	30536829	.	A	T	7	11	18	0	2	20	0	0
7	30537014	.	G	A	13	6	19	1	1	21	0	0
7	30537190	.	A	G	2	2	4	0	0	4	0	0
7	30537804	.	C	T	5	9	14	0	0	14	0	0
7	30537848	.	A	C	5	13	18	0	1	19	0	0
7	30537858	.	G	A	13	5	18	0	1	19	0	0
7	30537955	.	G	A	15	10	25	0	3	28	0	0
7	30538022	.	C	A	12	11	23	0	2	25	0	0
7	30538074	.	G	A	8	11	19	0	0	19	0	0
7	30538081	.	G	A	15	7	22	0	1	23	0	0
7	30538268	.	C	A	7	3	10	0	2	12	0	0
7	30538439	.	C	T	2	7	9	0	5	14	0	0
7	30538995	.	G	A	15	23	38	0	4	42	0	0
7	30543452	.	G	A	22	19	41	0	4	45	0	0
7	30543754	.	A	G	28	29	57	0	2	59	0	0
7	30543882	.	C	T	22	31	53	0	1	54	0	0
7	30544903	.	A	G	21	16	37	0	6	43	0	0
7	30552603	.	G	A	14	6	20	0	0	20	0	0
7	30552610	.	G	A	13	5	18	0	0	18	0	0
7	30552992	.	G	A	8	4	12	0	0	12	0	0
7	30553495	.	T	C	13	18	31	0	0	31	0	0
7	30560354	.	C	T	2	14	16	0	15	31	0	0
7	30562290	.	C	T	1	10	11	0	15	26	0	0
7	30562400	.	T	C	10	9	19	0	1	20	0	0
7	30562645	.	T	A	7	9	16	1	1	18	0	0
7	30563080	.	T	C	3	4	7	0	0	7	0	0
7	30563160	.	G	T	7	15	22	0	0	22	0	0
7	30566157	.	C	T	6	8	14	0	3	17	0	0
7	30571228	.	T	A	11	13	24	0	4	28	0	0
7	30578916	.	G	A	12	7	19	0	2	21	0	0
7	30632416	.	A	T	1	2	3	0	0	3	0	0
7	30632582	.	T	A	3	2	5	0	0	5	0	0
7	30632669	.	T	C	2	5	7	0	0	7	0	0
7	30632737	.	G	T	2	7	9	0	1	10	0	0
7	30632765	.	G	A	6	3	9	0	0	9	0	0
7	30632797	.	T	G	5	5	10	0	0	10	0	0
7	30632807	.	G	C	3	0	3	0	10	13	0	0
7	30632860	.	A	T	7	6	13	0	0	13	0	0
7	30633038	.	A	G	1	6	7	0	0	7	0	0
7	30638970	.	G	A	6	7	13	0	0	13	0	0
7	30652369	.	T	C	3	0	3	0	3	6	0	0
7	30652971	.	C	T	4	3	7	0	1	8	0	0
7	30653976	.	T	C	2	2	4	0	0	4	0	0
7	30768073	.	C	T	2	2	4	0	0	4	0	0
7	30768551	.	T	A	3	2	5	0	0	5	0	0
7	30769748	.	G	T	8	3	11	0	0	11	0	0
7	30769847	.	A	C	10	7	17	0	0	17	0	0
7	30770021	.	A	G	6	3	9	0	0	9	0	0
7	30770204	.	G	A	1	2	3	0	0	3	0	0
7	30770366	.	G	T	0	3	3	0	5	8	0	0
7	30770549	.	T	C	7	3	10	0	0	10	0	0
7	30770629	.	T	G	8	2	10	0	1	11	0	0
7	30775626	.	C	T	3	2	5	0	0	5	0	0
7	30775882	.	C	T	3	5	8	0	0	8	0	0
7	30777592	.	C	A	5	6	11	0	1	12	0	0
7	30777617	.	G	A	4	5	9	0	1	10	0	0
7	30778394	.	C	T	6	4	10	0	0	10	0	0
7	30778802	.	T	C	3	2	5	0	0	5	0	0
7	30778891	.	T	C	5	3	8	0	1	9	0	0
7	30778912	.	A	G	3	6	9	0	2	11	0	0
7	30779801	.	T	C	2	3	5	0	1	6	0	0
7	30780017	.	A	G	7	9	16	0	1	17	0	0
7	30782104	.	C	T	8	3	11	0	0	11	0	0
7	30782476	.	T	A	3	7	10	0	1	11	0	0
7	30782837	.	G	T	5	3	8	0	0	8	0	0
7	30782929	.	A	T	6	6	12	0	1	13	0	0
7	30867006	.	C	T	24	12	36	0	2	38	0	0
7	30867286	.	T	C	19	19	38	0	2	40	0	0
7	30867550	.	G	T	12	20	32	0	0	32	0	0
7	30867658	.	T	A	16	17	33	0	0	33	0	0
7	30867702	.	T	C	17	10	27	0	3	30	0	0
7	30867740	.	A	G	15	15	30	0	1	31	0	0
7	30867775	.	T	G	12	13	25	0	1	26	0	0
7	30867817	.	G	A	0	13	13	0	14	27	0	0
7	30867855	.	G	A	2	11	13	0	14	27	0	0
7	30868009	.	C	T	18	25	43	0	1	44	0	0
7	30875257	.	G	A	18	12	30	0	2	32	0	0
7	30875277	.	G	A	19	18	37	0	0	37	0	0
7	30879211	.	G	A	17	14	31	0	0	31	0	0
7	30911937	.	C	T	17	25	42	0	5	47	0	0
7	30914622	.	C	T	19	30	49	0	3	52	0	0
7	30914706	.	C	T	25	20	45	0	2	47	0	0
7	30915040	.	A	G	17	11	28	2	3	33	0	0
7	30915306	.	G	A	26	24	50	0	2	52	0	0
7	30915388	.	A	G	30	28	58	0	2	60	0	0
7	30915823	.	G	A	3	25	28	0	29	57	0	0
7	30923638	.	C	T	0	5	5	0	5	10	0	0
7	30923658	.	C	A	4	8	12	0	1	13	0	0
7	31093055	.	A	G	4	0	4	0	3	7	0	0
7	31107735	.	G	A	0	5	5	0	6	11	0	0
7	31108139	.	A	T	2	8	10	0	1	11	0	0
7	31112120	.	C	T	1	4	5	0	0	5	0	0
7	31112204	.	G	A	5	6	11	0	1	12	0	0
7	31112264	.	G	T	11	6	17	0	1	18	0	0
7	31120825	.	G	A	2	17	19	0	10	29	0	0
7	31120906	.	C	A	10	18	28	0	1	29	0	0
7	31121005	.	C	T	10	16	26	0	0	26	0	0
7	31125653	.	C	T	8	11	19	0	0	19	0	0
7	31125776	.	G	A	4	15	19	0	13	32	0	0
7	31125860	.	T	C	14	27	41	0	1	42	0	0
7	31125980	.	C	A	13	18	31	0	0	31	0	0
7	31126127	.	C	A	4	9	13	0	1	14	0	0
7	31128396	.	T	C	17	23	40	0	2	42	0	0
7	31128475	.	A	C	16	15	31	0	3	34	0	0
7	31130267	.	A	G	15	1	16	0	25	41	0	0
7	31130285	.	T	C	17	18	35	0	6	41	0	0
7	31132771	.	A	C	8	10	18	0	2	20	0	0
7	31140479	.	C	A	25	24	49	0	0	49	0	0
7	31140594	.	G	A	13	12	25	1	1	27	0	0
7	31140634	.	A	C	10	12	22	1	3	26	0	0
7	31140976	.	A	C	5	13	18	0	3	21	0	0
7	31141044	.	C	T	14	12	26	0	0	26	0	0
7	31141086	.	G	A	1	6	7	0	12	19	0	0
7	31141372	.	T	C	22	14	36	0	2	38	0	0
7	31141747	.	T	A	11	19	30	0	1	31	0	0
7	31142030	.	C	T	8	12	20	0	1	21	0	0
7	31326689	.	G	A	6	3	9	0	2	11	0	0
7	31326759	.	G	A	1	6	7	0	7	14	0	0
7	31326795	.	G	A	6	6	12	0	1	13	0	0
7	31326862	.	T	C	6	7	13	0	0	13	0	0
7	31327064	.	T	C	3	4	7	0	0	7	0	0
7	31332206	.	T	C	10	9	19	0	3	22	0	0
7	31335951	.	A	C	3	3	6	0	0	6	0	0
7	31339177	.	T	A	8	4	12	0	1	13	0	0
7	31339344	.	T	C	11	16	27	0	3	30	0	0
7	31359003	.	T	C	16	21	37	0	1	38	0	0
7	31364072	.	C	T	12	10	22	0	0	22	0	0
7	31366684	.	C	T	7	9	16	0	0	16	0	0
7	31367057	.	A	G	14	11	25	0	1	26	0	0
7	31367667	.	A	T	17	13	30	0	2	32	0	0
7	31367668	.	C	T	18	12	30	0	1	31	0	0
7	31367777	.	C	G	19	12	31	0	3	34	0	0
7	31367850	.	C	T	10	5	15	0	3	18	0	0
7	31381100	.	A	T	6	13	19	0	0	19	0	0
7	31381129	.	G	T	7	12	19	0	0	19	0	0
7	31381713	.	C	T	10	9	19	0	0	19	0	0
7	31388206	.	C	T	8	4	12	0	1	13	0	0
7	31390492	.	T	A	12	8	20	0	0	20	0	0
7	31390995	.	T	G	10	3	13	0	0	13	0	0
7	31391020	.	T	C	9	7	16	0	0	16	0	0
7	31391429	.	C	T	9	4	13	0	0	13	0	0
7	31391784	.	G	A	10	4	14	0	2	16	0	0
7	31391799	.	C	G	8	3	11	0	1	12	0	0
7	31392315	.	T	A	16	9	25	0	1	26	0	0
7	31392485	.	A	G	6	16	22	0	1	23	0	0
7	31392492	.	G	A	5	18	23	0	0	23	0	0
7	31393266	.	T	C	1	3	4	0	0	4	0	0
7	31393386	.	G	A	0	3	3	0	3	6	0	0
7	31393497	.	G	A	2	2	4	2	2	8	0	0
7	31427812	.	T	C	3	5	8	0	0	8	0	0
7	31431548	.	T	A	9	5	14	0	0	14	0	0
7	31431745	.	C	G	5	6	11	0	2	13	0	0
7	31431898	.	T	C	9	7	16	0	0	16	0	0
7	31494838	.	A	G	1	2	3	0	0	3	0	0
7	31495208	.	A	G	10	10	20	0	1	21	0	0
7	31495329	.	C	T	5	8	13	0	0	13	0	0
7	31495353	.	C	T	9	7	16	0	0	16	0	0
7	31495377	.	C	T	8	4	12	0	1	13	0	0
7	31496350	.	T	C	12	5	17	0	2	19	0	0
7	31496524	.	T	C	7	0	7	0	4	11	0	0
7	31496544	.	C	T	8	5	13	0	0	13	0	0
7	31496601	.	T	A	7	5	12	0	1	13	0	0
7	31496641	.	T	A	4	3	7	0	0	7	0	0
7	31496759	.	C	A	2	6	8	0	0	8	0	0
7	31497590	.	C	A	3	5	8	0	0	8	0	0
7	31497601	.	T	C	4	4	8	0	0	8	0	0
7	31497627	.	A	G	1	3	4	0	1	5	0	0
7	31498249	.	A	G	5	4	9	0	0	9	0	0
7	31498394	.	A	T	2	2	4	0	1	5	0	0
7	31498395	.	G	A	3	2	5	0	0	5	0	0
7	31498469	.	G	A	7	3	10	0	0	10	0	0
7	31498706	.	T	C	1	2	3	0	0	3	0	0
7	31498707	.	T	A	1	2	3	0	0	3	0	0
7	31500367	.	A	G	1	2	3	0	1	4	0	0
7	31500381	.	T	A	2	2	4	0	0	4	0	0
7	31504393	.	C	T	1	2	3	0	1	4	0	0
7	31504703	.	T	A	2	2	4	0	0	4	0	0
7	31504763	.	G	A	1	2	3	0	0	3	0	0
7	31603329	.	C	T	2	4	6	0	0	6	0	0
7	31626335	.	T	C	2	2	4	0	0	4	0	0
7	31628372	.	T	A	1	2	3	0	0	3	0	0
7	31776224	.	G	A	16	12	28	0	1	29	0	0
7	31776645	.	T	A	11	10	21	0	2	26	3	0
7	31776706	.	G	A	18	8	26	0	0	26	0	0
7	31776735	.	T	C	13	12	25	0	3	28	0	0
7	31776877	.	C	T	6	11	17	0	1	18	0	0
7	31777227	.	T	C	7	12	19	0	3	22	0	0
7	31777528	.	C	T	10	13	23	0	3	26	0	0
7	31777569	.	G	C	13	0	13	1	14	28	0	0
7	31782235	.	A	G	8	6	14	0	1	15	0	0
7	31784631	.	G	T	7	5	12	0	2	14	0	0
7	31784661	.	A	G	4	8	12	0	0	12	0	0
7	31784996	.	T	C	4	4	8	0	0	8	0	0
7	31796453	.	G	A	12	13	25	0	1	26	0	0
7	31796725	.	T	C	11	0	11	1	8	20	0	0
7	31796845	.	A	G	9	5	14	0	1	15	0	0
7	31796861	.	T	G	8	3	11	0	1	12	0	0
7	31796990	.	C	T	2	8	10	0	19	29	0	0
7	31802890	.	C	T	15	10	25	0	1	26	0	0
7	31802938	.	A	T	12	8	20	0	0	20	0	0
7	31803408	.	G	A	7	9	16	0	2	18	0	0
7	31815146	.	T	G	3	4	7	0	0	7	0	0
7	31818640	.	A	G	1	2	3	0	0	3	0	0
7	31827282	.	C	A	1	2	3	1	0	4	0	0
7	31902535	.	G	T	6	8	14	0	0	14	0	0
7	31902536	.	A	T	6	8	14	0	0	14	0	0
7	31902633	.	T	A	11	13	24	0	2	26	0	0
7	31902757	.	T	A	17	17	34	0	0	34	0	0
7	31903205	.	T	A	13	7	20	0	0	20	0	0
7	31903256	.	C	A	11	3	14	0	0	14	0	0
7	31903276	.	G	A	8	4	12	0	0	12	0	0
7	31903516	.	T	G	5	5	10	0	1	11	0	0
7	31903554	.	A	T	11	3	14	0	2	16	0	0
7	31903788	.	C	T	6	2	8	0	1	9	0	0
7	31903823	.	G	T	3	6	9	0	1	10	0	0
7	31903993	.	A	T	3	7	10	0	1	11	0	0
7	31904146	.	G	A	6	10	16	0	0	16	0	0
7	31904180	.	G	A	9	13	22	0	0	22	0	0
7	31904192	.	G	T	11	14	25	0	0	25	0	0
7	31904381	.	C	A	11	10	21	0	0	21	0	0
7	31904442	.	T	G	13	8	21	0	1	22	0	0
7	31905040	.	T	C	5	0	5	0	12	20	3	0
7	31905067	.	G	T	8	0	8	0	9	17	0	0
7	31905126	.	C	T	5	9	14	0	0	14	0	0
7	31905190	.	A	T	6	6	12	0	0	12	0	0
7	31905217	.	T	A	5	8	13	0	1	14	0	0
7	31905392	.	G	A	10	12	22	0	1	23	0	0
7	31907970	.	C	A	16	6	22	0	2	24	0	0
7	31925975	.	C	T	32	17	49	0	1	50	0	0
7	31940373	.	A	G	1	2	3	0	1	4	0	0
7	32142302	.	A	C	7	4	11	0	0	11	0	0
7	32456619	.	A	C	3	3	6	0	0	6	0	0
7	32458136	.	C	A	1	6	7	0	0	7	0	0
7	32458154	.	G	A	0	6	6	0	1	7	0	0
7	32458183	.	G	A	1	2	3	0	7	10	0	0
7	32458227	.	A	T	7	4	11	0	0	11	0	0
7	32458270	.	C	A	7	2	9	0	0	9	0	0
7	32458467	.	G	C	3	4	7	0	0	7	0	0
7	32458471	.	G	T	2	4	6	0	0	6	0	0
7	32458846	.	A	T	1	3	4	1	1	6	0	0
7	32459107	.	C	A	6	5	11	0	0	11	0	0
7	32459126	.	G	T	4	8	12	0	0	12	0	0
7	32459220	.	C	T	2	3	5	0	1	6	0	0
7	32459256	.	G	T	4	5	9	0	0	9	0	0
7	32459318	.	C	T	5	3	8	0	0	8	0	0
7	32459486	.	C	T	3	5	8	1	0	9	0	0
7	32459592	.	G	T	2	3	5	0	0	5	0	0
7	32459639	.	C	A	2	2	4	0	0	4	0	0
7	32538091	.	G	T	3	3	6	0	1	7	0	0
7	32624814	.	T	A	6	17	23	0	0	23	0	0
7	32624823	.	G	A	7	16	23	0	0	23	0	0
7	32624892	.	C	T	12	17	29	0	1	30	0	0
7	32628387	.	T	C	12	7	19	0	0	19	0	0
7	32629309	.	C	A	1	12	13	0	6	19	0	0
7	32629349	.	G	T	8	11	19	0	0	19	0	0
7	32637565	.	C	T	2	2	4	0	1	5	0	0
7	32644881	.	G	A	2	5	7	0	2	9	0	0
7	32644953	.	C	T	3	6	9	0	1	10	0	0
7	32700010	.	G	A	3	2	5	0	0	5	0	0
7	32700594	.	C	T	6	8	14	0	1	15	0	0
7	32714459	.	T	A	4	2	6	0	0	6	0	0
7	32714730	.	T	C	4	6	10	0	0	10	0	0
7	32714833	.	C	T	5	6	11	0	0	11	0	0
7	32722539	.	G	A	1	3	4	0	1	5	0	0
7	32722694	.	G	T	3	4	7	0	0	7	0	0
7	32742572	.	G	A	4	13	17	0	0	17	0	0
7	32742962	.	T	C	8	5	13	0	0	13	0	0
7	32742967	.	G	A	8	5	13	0	0	13	0	0
7	32743001	.	A	G	5	0	5	0	4	9	0	0
7	32743091	.	A	T	7	6	13	0	0	13	0	0
7	32743110	.	A	T	5	6	11	0	1	12	0	0
7	32743459	.	A	G	2	0	2	0	6	8	0	0
7	32743512	.	T	C	3	5	8	0	0	8	0	0
7	32743585	.	G	A	0	5	5	0	4	9	0	0
7	32743688	.	A	T	2	2	4	0	0	4	0	0
7	32743728	.	C	G	5	2	7	0	0	7	0	0
7	32743751	.	C	A	6	4	10	0	0	10	0	0
7	32743811	.	T	A	8	3	11	0	0	11	0	0
7	32743818	.	T	A	10	2	12	0	2	14	0	0
7	32743918	.	G	C	6	13	19	0	2	21	0	0
7	32743959	.	A	C	7	12	19	0	0	19	0	0
7	32743961	.	A	G	8	12	20	0	0	20	0	0
7	32744027	.	T	C	11	11	22	0	0	22	0	0
7	32744459	.	T	A	10	12	22	0	2	24	0	0
7	32744485	.	A	G	12	6	18	0	1	19	0	0
7	32744540	.	T	C	12	14	26	0	0	26	0	0
7	32744542	.	A	G	12	1	13	0	13	26	0	0
7	32744648	.	A	G	9	11	20	0	1	21	0	0
7	32744663	.	T	A	12	9	21	0	1	22	0	0
7	32744856	.	G	A	12	8	20	0	1	21	0	0
7	32744906	.	T	C	6	13	19	0	2	21	0	0
7	32744919	.	T	G	6	12	18	0	0	18	0	0
7	32744958	.	T	A	3	8	11	0	0	11	0	0
7	32744974	.	G	C	6	8	14	0	0	14	0	0
7	32745025	.	T	C	10	11	21	0	0	21	0	0
7	32745170	.	A	G	4	7	11	0	2	13	0	0
7	32745190	.	T	C	8	7	15	0	0	15	0	0
7	32745461	.	C	T	8	6	14	0	0	14	0	0
7	32746026	.	T	C	5	9	14	0	0	14	0	0
7	32746151	.	A	T	10	4	14	0	1	15	0	0
7	32746213	.	A	G	16	8	24	2	1	27	0	0
7	32746324	.	G	A	17	14	31	0	1	32	0	0
7	32746327	.	A	C	17	13	30	0	3	33	0	0
7	32746370	.	C	T	21	10	31	0	2	33	0	0
7	32746457	.	A	C	20	12	32	0	0	32	0	0
7	32746546	.	T	C	13	4	17	3	0	20	0	0
7	32746552	.	G	A	13	4	17	3	0	20	0	0
7	32746584	.	C	T	12	10	22	0	2	24	0	0
7	32746614	.	C	T	15	8	23	0	2	25	0	0
7	32746676	.	T	C	23	14	37	0	0	37	0	0
7	32746732	.	A	G	18	6	24	0	0	24	0	0
7	32746838	.	A	G	25	0	25	0	9	34	0	0
7	32746839	.	A	T	23	8	31	0	1	33	1	0
7	32747029	.	A	T	4	3	7	0	0	7	0	0
7	32747056	.	A	C	1	6	7	0	0	7	0	0
7	32747135	.	T	C	8	10	18	0	1	19	0	0
7	32747424	.	T	A	4	2	6	0	1	7	0	0
7	32747482	.	A	C	1	2	3	0	0	3	0	0
7	32747956	.	A	G	18	1	19	0	8	27	0	0
7	32747973	.	A	G	19	11	30	0	1	31	0	0
7	32748006	.	T	C	14	11	25	1	1	27	0	0
7	32748203	.	A	G	20	8	28	1	1	30	0	0
7	32748319	.	C	A	13	23	36	0	3	39	0	0
7	32748486	.	A	T	11	9	20	0	0	20	0	0
7	32748725	.	G	A	17	15	32	0	0	32	0	0
7	32748914	.	G	A	23	14	37	0	0	37	0	0
7	32749048	.	T	A	18	20	38	0	0	38	0	0
7	32749144	.	T	C	22	22	44	0	0	44	0	0
7	32749146	.	A	G	21	21	42	0	1	43	0	0
7	32812361	.	A	G	30	22	52	0	2	54	0	0
7	32812472	.	G	A	19	15	34	1	2	37	0	0
7	32812804	.	G	A	5	24	29	0	12	41	0	0
7	32813004	.	T	C	17	21	38	0	1	39	0	0
7	32813366	.	A	G	18	25	43	0	0	43	0	0
7	32813605	.	T	G	13	9	22	0	2	24	0	0
7	32813689	.	C	T	17	10	27	0	1	28	0	0
7	32813962	.	A	C	5	4	9	0	1	10	0	0
7	32814139	.	C	G	15	14	29	0	1	30	0	0
7	32814141	.	G	C	14	15	29	0	1	30	0	0
7	32814364	.	G	A	10	9	19	2	1	22	0	0
7	32814379	.	C	A	1	10	11	2	12	26	1	0
7	32814451	.	C	T	2	8	10	1	20	31	0	0
7	32814502	.	T	C	23	0	23	0	6	29	0	0
7	32814542	.	C	T	19	8	27	0	6	33	0	0
7	32814600	.	C	G	16	8	24	0	2	26	0	0
7	32814830	.	A	G	18	16	34	0	0	34	0	0
7	32815485	.	A	T	6	10	16	0	0	16	0	0
7	32815506	.	A	G	10	17	27	0	3	30	0	0
7	32815910	.	C	T	2	22	24	0	16	40	0	0
7	32818809	.	G	T	12	17	29	0	1	30	0	0
7	32818848	.	A	T	11	19	30	0	1	31	0	0
7	32827457	.	A	G	16	8	24	0	1	25	0	0
7	32831592	.	G	A	9	11	20	0	1	21	0	0
7	32833155	.	T	G	8	13	21	0	0	21	0	0
7	32834445	.	G	T	7	4	11	0	0	11	0	0
7	32834650	.	C	A	7	8	15	0	0	15	0	0
7	32834674	.	G	A	9	4	13	0	1	14	0	0
7	32834835	.	G	A	6	7	13	0	0	13	0	0
7	32834912	.	C	G	4	3	7	0	1	8	0	0
7	32835042	.	T	G	7	10	17	0	0	17	0	0
7	32835053	.	T	C	6	7	13	0	2	15	0	0
7	32835182	.	G	A	7	4	11	0	0	11	0	0
7	32835349	.	A	G	2	4	6	0	1	7	0	0
7	32835573	.	T	A	4	3	7	0	1	8	0	0
7	32835724	.	G	A	3	2	5	0	0	5	0	0
7	32836032	.	T	C	6	4	10	0	1	11	0	0
7	32836100	.	G	A	7	6	13	0	1	14	0	0
7	32836163	.	A	G	9	4	13	0	0	13	0	0
7	32836203	.	A	T	7	4	11	0	0	11	0	0
7	32836227	.	A	G	10	5	15	0	0	15	0	0
7	32836334	.	T	C	3	0	3	0	9	12	0	0
7	32843511	.	T	C	7	0	7	0	9	16	0	0
7	32895566	.	G	A	2	4	6	0	1	7	0	0
7	32895595	.	A	C	2	3	5	0	0	5	0	0
7	32898148	.	T	G	15	0	15	1	19	35	0	0
7	32898640	.	A	T	10	8	18	0	1	19	0	0
7	32898696	.	C	T	9	13	22	0	1	23	0	0
7	32898744	.	C	T	16	11	27	0	1	28	0	0
7	32898747	.	T	A	14	10	24	0	1	26	1	0
7	32898827	.	C	A	10	14	24	0	0	24	0	0
7	32899602	.	A	T	10	12	22	0	2	24	0	0
7	32899744	.	A	G	7	11	18	0	1	19	0	0
7	32928226	.	T	A	3	2	5	0	1	6	0	0
7	32928369	.	G	A	4	4	8	0	0	8	0	0
7	32928542	.	T	A	2	2	4	0	0	4	0	0
7	32942985	.	C	T	4	3	7	0	0	7	0	0
7	32946639	.	C	T	1	2	3	0	0	3	0	0
7	32983726	.	T	A	36	27	63	1	1	65	0	0
7	32983948	.	A	C	43	6	49	0	19	68	0	0
7	32984127	.	T	A	26	44	70	0	3	73	0	0
7	32984604	.	C	T	38	19	57	0	2	59	0	0
7	32984625	.	T	A	36	20	56	0	1	57	0	0
7	32984804	.	T	A	37	16	53	0	0	53	0	0
7	32984812	.	C	A	37	12	49	0	1	50	0	0
7	32985013	.	A	T	26	17	43	0	1	44	0	0
7	32985128	.	T	C	35	19	54	0	0	54	0	0
7	32985274	.	A	T	12	16	28	0	0	28	0	0
7	32985282	.	T	A	11	15	26	0	0	26	0	0
7	32985518	.	A	T	19	3	22	0	1	23	0	0
7	32985519	.	C	T	20	3	23	0	0	23	0	0
7	32985602	.	G	A	34	11	45	0	0	45	0	0
7	32985616	.	A	T	30	17	47	0	0	47	0	0
7	32985716	.	A	G	27	23	50	0	0	50	0	0
7	32985847	.	A	G	37	10	47	0	1	48	0	0
7	32986043	.	T	A	17	24	41	0	4	45	0	0
7	32986311	.	T	G	14	21	35	0	3	38	0	0
7	32986422	.	G	T	20	5	25	0	2	27	0	0
7	32988848	.	T	C	14	0	14	0	8	22	0	0
7	32992111	.	G	A	17	8	25	0	1	26	0	0
7	33014041	.	T	C	6	0	6	0	8	14	0	0
7	33028462	.	G	A	0	15	15	0	10	25	0	0
7	33028564	.	T	G	9	7	16	0	2	18	0	0
7	33028738	.	T	C	15	15	30	0	1	31	0	0
7	33068415	.	C	T	5	9	14	0	1	15	0	0
7	33068436	.	T	C	10	9	19	0	4	23	0	0
7	33068457	.	G	A	12	16	28	0	1	29	0	0
7	33068640	.	T	C	15	15	30	0	2	32	0	0
7	33068718	.	A	G	8	20	28	0	2	30	0	0
7	33083616	.	A	C	20	8	28	0	0	28	0	0
7	33083665	.	A	G	14	11	25	0	0	25	0	0
7	33083699	.	C	T	11	16	27	0	0	27	0	0
7	33084411	.	A	G	4	3	7	0	1	8	0	0
7	33084487	.	T	G	2	8	10	0	0	10	0	0
7	33084644	.	C	T	13	7	20	0	1	21	0	0
7	33084659	.	A	G	14	7	21	0	1	22	0	0
7	33084693	.	C	A	12	4	16	0	1	17	0	0
7	33084697	.	T	A	14	3	17	0	0	17	0	0
7	33084768	.	G	A	2	6	8	0	8	16	0	0
7	33084769	.	G	A	9	5	14	0	1	15	0	0
7	33085039	.	G	A	9	10	19	0	1	20	0	0
7	33085069	.	A	T	13	5	18	0	1	19	0	0
7	33085082	.	C	A	14	4	18	0	0	18	0	0
7	33085212	.	C	T	14	13	27	0	0	27	0	0
7	33085359	.	G	C	10	7	17	0	3	20	0	0
7	33085667	.	T	A	6	11	17	0	0	17	0	0
7	33086384	.	C	T	12	18	30	0	0	30	0	0
7	33086491	.	T	C	7	26	33	0	1	34	0	0
7	33086564	.	G	C	11	22	33	0	1	34	0	0
7	33086569	.	T	A	11	19	30	0	4	34	0	0
7	33086865	.	G	T	2	13	15	1	23	39	0	0
7	33087209	.	T	G	21	19	40	0	5	45	0	0
7	33087334	.	A	T	18	12	30	0	0	30	0	0
7	33087472	.	A	G	14	18	32	0	0	32	0	0
7	33087841	.	T	G	15	29	44	0	0	44	0	0
7	33088052	.	G	A	10	11	21	0	1	22	0	0
7	33122566	.	G	A	2	3	5	0	0	5	0	0
7	33122622	.	G	A	1	2	3	0	1	4	0	0
7	33124141	.	C	T	1	1	2	0	1	3	0	0
7	33318208	.	C	A	3	2	5	1	0	6	0	0
7	33318226	.	C	T	2	5	7	0	0	7	0	0
7	33328477	.	G	A	0	3	3	0	3	6	0	0
7	33328487	.	G	C	2	4	6	0	0	6	0	0
7	33331303	.	G	A	4	2	6	0	0	6	0	0
7	33332438	.	A	G	8	4	12	0	0	12	0	0
7	33340607	.	C	T	4	5	9	0	2	11	0	0
7	33340645	.	C	T	4	7	11	0	0	11	0	0
7	33340747	.	C	T	9	4	13	0	0	13	0	0
7	33341082	.	A	C	7	5	12	0	4	16	0	0
7	33341124	.	T	A	8	7	15	0	0	15	0	0
7	33341143	.	T	G	7	5	12	0	1	13	0	0
7	33341709	.	T	C	14	4	18	0	0	18	0	0
7	33341722	.	C	T	3	15	18	0	0	18	0	0
7	33346451	.	C	T	18	26	44	0	4	48	0	0
7	33347436	.	T	C	24	25	49	0	1	50	0	0
7	33440343	.	T	C	4	2	6	0	1	7	0	0
7	33440463	.	C	T	5	3	8	0	1	9	0	0
7	33440466	.	C	G	4	0	4	0	5	9	0	0
7	33441295	.	T	A	6	2	8	0	0	8	0	0
7	33441689	.	G	A	8	3	11	0	1	12	0	0
7	33441762	.	A	G	4	0	4	0	6	10	0	0
7	33442138	.	A	G	4	2	6	0	0	6	0	0
7	33442639	.	C	A	7	11	18	1	3	22	0	0
7	33442680	.	T	C	12	6	18	0	1	19	0	0
7	33442795	.	G	A	3	3	6	0	1	7	0	0
7	33443246	.	A	T	2	3	5	0	1	6	0	0
7	33443587	.	T	A	3	5	8	0	1	9	0	0
7	33443684	.	A	G	1	6	7	0	0	7	0	0
7	33443748	.	C	G	13	10	23	0	0	23	0	0
7	33443808	.	T	C	9	6	15	0	0	15	0	0
7	33645876	.	A	T	12	3	15	0	4	19	0	0
7	33645932	.	C	A	3	10	13	0	15	28	0	0
7	33646044	.	G	C	15	10	25	0	1	26	0	0
7	33646409	.	C	T	13	13	26	0	0	26	0	0
7	33646459	.	G	A	12	12	24	0	1	25	0	0
7	33646920	.	G	C	22	4	26	1	0	27	0	0
7	33649963	.	G	A	13	7	20	0	1	21	0	0
7	33653910	.	G	T	10	9	19	0	1	20	0	0
7	33653982	.	T	C	4	0	4	0	5	9	0	0
7	33684615	.	T	C	1	0	1	0	3	4	0	0
7	33801012	.	A	G	2	3	5	0	0	5	0	0
7	33801076	.	C	T	2	3	5	0	1	6	0	0
7	33801112	.	T	A	4	3	7	0	0	7	0	0
7	33801322	.	T	C	8	6	14	0	2	16	0	0
7	33802258	.	C	T	2	5	7	0	0	7	0	0
7	33804829	.	C	T	0	4	4	0	2	6	0	0
7	33804901	.	T	C	1	5	6	0	0	6	0	0
7	33804985	.	C	T	1	4	5	0	4	9	0	0
7	33805171	.	G	C	2	2	4	0	0	4	0	0
7	33805198	.	C	T	3	2	5	0	0	5	0	0
7	33880055	.	A	C	1	2	3	0	0	3	0	0
7	33880667	.	G	A	1	2	3	0	0	3	0	0
7	33883436	.	A	T	5	2	7	0	1	8	0	0
7	33883852	.	C	A	13	0	13	0	0	13	0	0
7	33883855	.	G	A	9	0	9	0	4	13	0	0
7	33886248	.	A	T	1	7	8	0	0	8	0	0
7	33886721	.	C	T	6	4	10	0	0	10	0	0
7	33889923	.	A	G	3	2	5	0	0	5	0	0
7	33893337	.	T	A	1	2	3	0	0	3	0	0
7	33971021	.	A	T	3	8	11	0	0	11	0	0
7	33971304	.	A	C	8	16	24	0	2	26	0	0
7	33971549	.	T	G	5	3	8	0	0	8	0	0
7	34027308	.	A	T	4	4	8	0	1	9	0	0
7	34104755	.	G	T	3	4	7	0	0	7	0	0
7	34104786	.	G	T	2	4	6	0	1	7	0	0
7	34106738	.	T	G	1	3	4	0	0	4	0	0
7	34124478	.	G	C	1	0	1	0	5	6	0	0
7	34183237	.	T	A	5	7	12	0	0	12	0	0
7	34183285	.	A	T	6	4	10	0	0	10	0	0
7	34192415	.	T	C	2	0	2	0	2	4	0	0
7	34240336	.	T	A	3	4	7	0	0	7	0	0
7	34240646	.	G	T	1	4	5	0	0	5	0	0
7	34241474	.	T	C	3	0	3	0	2	5	0	0
7	34241477	.	C	A	2	3	5	0	0	5	0	0
7	34241707	.	C	T	4	3	7	0	0	7	0	0
7	34241815	.	G	A	8	7	15	0	0	15	0	0
7	34251954	.	C	T	1	2	3	0	1	4	0	0
7	34290102	.	A	C	3	5	8	0	0	8	0	0
7	34290420	.	G	A	0	3	3	0	3	6	0	0
7	34291237	.	A	T	3	4	7	0	0	7	0	0
7	34291342	.	T	A	3	2	5	0	0	5	0	0
7	34292306	.	T	C	4	3	7	0	1	8	0	0
7	34292434	.	C	A	3	4	7	0	0	7	0	0
7	34292617	.	G	A	5	5	10	0	0	10	0	0
7	34292848	.	G	A	4	2	6	0	0	6	0	0
7	34318079	.	T	C	24	27	51	0	1	52	0	0
7	34318619	.	C	T	2	23	25	0	23	48	0	0
7	34318750	.	A	G	31	27	58	0	3	61	0	0
7	34321638	.	C	T	8	20	28	0	0	28	0	0
7	34321698	.	C	T	8	8	16	0	0	16	0	0
7	34321887	.	T	G	11	10	21	0	1	22	0	0
7	34324215	.	T	C	8	10	18	0	0	18	0	0
7	34329845	.	A	G	18	20	38	0	1	39	0	0
7	34341457	.	A	G	11	29	40	0	1	42	1	0
7	34341538	.	A	G	17	23	40	0	0	40	0	0
7	34342185	.	T	C	7	22	29	0	0	29	0	0
7	34342251	.	C	T	12	14	26	1	1	28	0	0
7	34351132	.	A	G	17	10	27	0	1	28	0	0
7	34352928	.	G	A	22	10	32	0	0	32	0	0
7	34352941	.	T	A	20	8	28	0	3	31	0	0
7	34353164	.	T	C	11	0	11	0	15	26	0	0
7	34353202	.	T	C	14	7	21	0	0	21	0	0
7	34360337	.	A	G	13	10	23	0	1	24	0	0
7	34360380	.	T	C	10	8	18	0	1	19	0	0
7	34361708	.	A	G	10	5	15	0	0	15	0	0
7	34361781	.	G	T	2	4	6	0	0	6	0	0
7	34361832	.	G	C	3	5	8	0	0	8	0	0
7	34383082	.	G	A	4	7	11	0	0	11	0	0
7	34385248	.	G	A	6	5	11	0	0	11	0	0
7	34413123	.	T	A	11	6	17	0	1	18	0	0
7	34413218	.	A	G	6	7	13	0	1	14	0	0
7	34413240	.	A	T	8	3	11	0	3	14	0	0
7	34416106	.	G	A	11	8	19	0	0	19	0	0
7	34416511	.	A	C	5	7	12	1	2	15	0	0
7	34417537	.	T	A	5	6	11	0	2	13	0	0
7	34417696	.	C	T	0	5	5	0	3	8	0	0
7	34417729	.	C	A	3	7	10	0	0	10	0	0
7	34417846	.	T	C	3	2	5	0	0	5	0	0
7	34418240	.	G	A	4	5	9	0	2	11	0	0
7	34418365	.	G	A	4	10	14	0	1	15	0	0
7	34418457	.	G	T	7	4	11	0	1	12	0	0
7	34418546	.	A	T	7	12	19	0	0	19	0	0
7	34418547	.	C	T	7	12	19	0	0	19	0	0
7	34421271	.	C	T	8	9	17	0	0	17	0	0
7	34426954	.	T	C	7	3	10	0	0	10	0	0
7	34429119	.	T	C	5	0	5	0	6	11	0	0
7	34431708	.	T	C	5	7	12	0	0	12	0	0
7	34489051	.	G	T	6	3	9	0	1	10	0	0
7	34489245	.	C	T	2	3	5	1	1	7	0	0
7	34491872	.	C	T	8	7	15	0	0	15	0	0
7	34491878	.	T	A	10	6	16	0	1	17	0	0
7	34491935	.	G	C	10	9	19	0	1	20	0	0
7	34501480	.	G	A	3	5	8	0	0	8	0	0
7	34501782	.	T	G	5	2	7	0	1	8	0	0
7	34502482	.	G	A	2	4	6	1	0	7	0	0
7	34540380	.	C	T	1	3	4	0	0	4	0	0
7	34540500	.	A	G	3	3	6	0	0	6	0	0
7	34541022	.	A	G	6	3	9	0	0	9	0	0
7	34541955	.	A	G	6	8	14	0	0	14	0	0
7	34542108	.	A	G	2	0	2	0	2	4	0	0
7	34542156	.	T	C	4	4	8	0	1	9	0	0
7	34543434	.	A	G	3	0	3	0	2	5	0	0
7	34544751	.	T	A	10	6	16	0	1	17	0	0
7	34545068	.	C	T	10	10	20	0	1	21	0	0
7	34545268	.	A	G	7	4	11	0	0	11	0	0
7	34617672	.	T	G	2	3	5	0	0	5	0	0
7	34635561	.	A	G	1	2	3	0	0	3	0	0
7	34651419	.	G	A	0	3	3	0	8	11	0	0
7	34652081	.	C	G	13	11	24	0	1	25	0	0
7	34725424	.	G	A	2	2	4	0	0	4	0	0
7	34725425	.	G	T	2	2	4	0	0	4	0	0
7	34765425	.	T	C	1	2	3	0	0	3	0	0
7	34766277	.	G	A	1	3	4	0	1	5	0	0
7	34773935	.	G	A	0	4	4	0	2	6	0	0
7	34776487	.	T	C	4	4	8	0	1	9	0	0
7	34823861	.	A	G	1	10	11	0	0	11	0	0
7	34823909	.	A	T	3	4	7	0	1	8	0	0
7	34824695	.	C	A	3	3	6	0	1	7	0	0
7	34825117	.	A	G	1	2	3	0	0	3	0	0
7	34825438	.	C	T	1	3	4	0	0	4	0	0
7	34828382	.	T	A	4	2	6	0	0	6	0	0
7	34963887	.	C	T	3	3	6	0	0	6	0	0
7	34964173	.	A	G	3	2	5	0	0	5	0	0
7	34964833	.	G	T	3	3	6	0	0	6	0	0
7	34965049	.	G	A	7	2	9	0	0	9	0	0
7	34965064	.	T	C	7	3	10	0	0	10	0	0
7	34965199	.	A	G	3	0	3	0	3	6	0	0
7	34979813	.	T	C	1	0	1	0	3	4	0	0
7	34979972	.	G	A	6	2	8	0	0	8	0	0
7	35081270	.	G	A	1	1	2	0	1	3	0	0
7	35086461	.	C	T	9	15	24	0	1	25	0	0
7	35088435	.	T	C	16	15	31	0	1	32	0	0
7	35091113	.	A	T	16	16	32	0	1	33	0	0
7	35091118	.	A	G	16	16	32	0	0	32	0	0
7	35091293	.	G	A	16	16	32	0	2	34	0	0
7	35091365	.	T	A	20	25	45	0	1	46	0	0
7	35093784	.	C	T	21	19	40	0	0	40	0	0
7	35093968	.	A	C	40	19	59	0	3	62	0	0
7	35094025	.	T	A	28	22	50	0	6	56	0	0
7	35094218	.	T	C	25	28	53	0	2	55	0	0
7	35094292	.	T	G	26	1	27	0	23	50	0	0
7	35094604	.	T	G	22	24	46	0	1	47	0	0
7	35094647	.	T	C	22	19	41	0	2	43	0	0
7	35094682	.	T	C	35	0	35	0	5	40	0	0
7	35094859	.	C	T	7	11	18	0	2	20	0	0
7	35112615	.	A	G	2	3	5	0	0	5	0	0
7	35112919	.	T	C	4	2	6	0	1	7	0	0
7	35112994	.	G	T	4	6	10	0	0	10	0	0
7	35113419	.	G	A	4	2	6	0	0	6	0	0
7	35113508	.	A	G	1	2	3	0	0	3	0	0
7	35116941	.	G	A	1	2	3	0	1	4	0	0
7	35208379	.	G	A	7	5	12	3	0	15	0	0
7	35208381	.	C	T	6	5	11	3	0	14	0	0
7	35210921	.	C	G	4	5	9	0	0	9	0	0
7	35210924	.	C	A	4	5	9	0	0	9	0	0
7	35211010	.	T	G	13	6	19	0	1	20	0	0
7	35211073	.	A	C	6	5	11	0	0	11	0	0
7	35211743	.	C	T	5	5	10	0	0	10	0	0
7	35211787	.	G	A	5	6	11	0	0	11	0	0
7	35211806	.	T	C	3	5	8	0	2	10	0	0
7	35211825	.	G	A	1	5	6	0	5	11	0	0
7	35211855	.	G	A	7	5	12	0	1	13	0	0
7	35211872	.	G	A	7	3	10	0	0	10	0	0
7	35212252	.	G	A	8	3	11	0	0	11	0	0
7	35212255	.	C	T	7	2	9	0	3	12	0	0
7	35241706	.	T	C	5	3	8	0	1	9	0	0
7	35241776	.	G	A	2	3	5	0	6	11	0	0
7	36314372	.	G	A	6	7	13	0	0	13	0	0
7	36618869	.	C	T	9	2	11	1	1	13	0	0
7	36619052	.	A	C	16	0	16	1	0	17	0	0
7	37585422	.	C	T	3	2	5	0	0	5	0	0
7	37585425	.	A	G	4	2	6	0	0	6	0	0
7	37861725	.	T	A	4	3	7	0	2	9	0	0
7	38037685	.	T	A	2	4	6	12	0	18	0	0
7	38533575	.	A	G	4	4	8	0	0	8	0	0
7	38736747	.	A	T	1	1	2	0	1	3	0	0
7	38775075	.	A	G	13	19	32	0	0	32	0	0
7	38775078	.	C	T	10	19	29	0	0	29	0	0
7	38777330	.	T	C	14	25	39	0	1	40	0	0
7	38779297	.	T	A	13	13	26	0	1	27	0	0
7	38779695	.	T	A	22	13	35	0	2	37	0	0
7	38779696	.	T	C	21	14	35	0	2	37	0	0
7	38779759	.	A	G	15	1	16	1	20	37	0	0
7	38783439	.	C	T	25	20	45	0	1	46	0	0
7	38783644	.	A	G	28	15	43	0	5	48	0	0
7	38783718	.	A	G	14	15	29	0	1	30	0	0
7	38783799	.	A	T	18	16	34	0	1	35	0	0
7	38783881	.	T	A	14	9	23	0	2	25	0	0
7	38783984	.	G	T	1	9	10	1	15	26	0	0
7	38784327	.	G	A	14	15	29	0	1	30	0	0
7	38784370	.	C	G	14	18	32	0	1	33	0	0
7	38784486	.	T	C	16	19	35	0	1	36	0	0
7	38784494	.	A	G	12	0	12	0	23	35	0	0
7	38784681	.	G	A	27	25	52	0	2	54	0	0
7	38784786	.	T	A	24	31	55	0	2	57	0	0
7	38784976	.	T	A	28	21	49	0	0	49	0	0
7	38784985	.	T	G	29	5	34	0	8	46	4	0
7	38785069	.	C	T	15	19	34	0	2	36	0	0
7	38785224	.	G	A	1	21	22	0	25	47	0	0
7	38785311	.	T	A	27	15	42	0	0	42	0	0
7	38794090	.	T	G	18	16	34	0	0	34	0	0
7	38794233	.	C	T	2	16	18	0	17	35	0	0
7	38794411	.	A	G	17	16	33	0	2	35	0	0
7	38794562	.	A	G	18	22	40	0	0	40	0	0
7	38798630	.	A	G	17	15	32	0	2	34	0	0
7	38799622	.	T	C	18	0	18	0	20	38	0	0
7	38807750	.	C	T	13	15	28	0	0	28	0	0
7	38807797	.	G	A	5	5	10	0	0	10	0	0
7	38809502	.	T	C	5	4	9	0	0	9	0	0
7	38809556	.	T	C	3	4	7	0	0	7	0	0
7	38809625	.	T	C	4	4	8	0	0	8	0	0
7	38810173	.	C	A	4	3	7	0	0	7	0	0
7	38820266	.	T	A	1	3	4	0	1	5	0	0
7	38820543	.	C	A	5	3	8	0	1	9	0	0
7	38820889	.	G	A	1	2	3	0	0	3	0	0
7	38821790	.	G	C	1	4	5	0	0	5	0	0
7	38822327	.	C	T	12	5	17	0	2	19	0	0
7	38822365	.	T	A	9	7	16	0	1	17	0	0
7	38822523	.	G	A	2	6	8	0	0	8	0	0
7	38822528	.	C	A	0	5	5	0	2	7	0	0
7	38822559	.	C	T	0	6	6	0	3	9	0	0
7	38822801	.	A	G	5	3	8	0	0	8	0	0
7	38823659	.	G	A	5	2	7	0	0	7	0	0
7	38824972	.	G	A	3	9	12	0	0	12	0	0
7	38827635	.	T	A	5	3	8	0	1	9	0	0
7	38935810	.	T	C	1	4	5	0	0	5	0	0
7	38935998	.	G	A	0	2	2	0	2	4	0	0
7	38953149	.	T	G	4	2	6	0	1	7	0	0
7	38953154	.	A	G	4	4	8	0	0	8	0	0
7	38954102	.	T	C	2	7	9	0	0	9	0	0
7	38954130	.	T	C	1	3	4	0	2	6	0	0
7	38954657	.	T	C	3	2	5	0	0	5	0	0
7	39088765	.	G	A	3	5	8	0	0	8	0	0
7	39092476	.	A	G	5	3	8	0	0	8	0	0
7	39100137	.	C	A	3	2	5	0	0	5	0	0
7	39123095	.	G	A	2	6	8	0	7	15	0	0
7	39140281	.	A	G	5	6	11	1	0	12	0	0
7	39142946	.	G	T	9	5	14	0	0	14	0	0
7	39142961	.	C	T	6	6	12	0	0	12	0	0
7	39143018	.	G	A	8	9	17	0	0	17	0	0
7	39153769	.	C	A	5	3	8	0	0	8	0	0
7	39153975	.	G	A	2	5	7	0	0	7	0	0
7	39154119	.	C	T	7	6	13	0	0	13	0	0
7	39154272	.	A	T	6	6	12	0	0	12	0	0
7	39154273	.	C	G	6	6	12	0	0	12	0	0
7	39154984	.	T	G	3	6	9	0	0	9	0	0
7	39155099	.	C	T	6	4	10	0	0	10	0	0
7	39155157	.	A	G	3	5	8	0	0	8	0	0
7	39155344	.	G	A	7	5	12	0	0	12	0	0
7	39155508	.	A	T	11	4	15	0	1	16	0	0
7	39155943	.	T	C	2	4	6	0	1	7	0	0
7	39156101	.	T	G	9	8	17	0	1	18	0	0
7	39156161	.	C	T	3	9	12	0	1	13	0	0
7	39156376	.	A	G	7	11	18	0	1	19	0	0
7	39156474	.	T	C	14	12	26	0	1	27	0	0
7	39156567	.	G	C	15	7	22	0	0	22	0	0
7	39156698	.	G	A	0	13	13	0	5	18	0	0
7	39156846	.	T	C	16	11	27	0	1	28	0	0
7	39156969	.	T	C	9	10	19	0	0	19	0	0
7	39157175	.	A	T	7	7	14	0	1	15	0	0
7	39157239	.	C	A	8	8	16	0	0	16	0	0
7	39157320	.	C	T	2	2	4	0	0	4	0	0
7	39157327	.	C	T	2	2	4	0	0	4	0	0
7	39174145	.	T	C	19	19	38	0	0	38	0	0
7	39176261	.	G	A	3	21	24	3	27	54	0	0
7	39176444	.	G	A	1	21	22	0	22	44	0	0
7	39176447	.	A	C	21	22	43	0	0	43	0	0
7	39176790	.	T	G	20	21	41	0	0	41	0	0
7	39176863	.	G	A	21	17	38	0	4	42	0	0
7	39176922	.	T	A	19	6	25	2	2	29	0	0
7	39177132	.	A	T	1	2	3	0	0	3	0	0
7	39177524	.	T	A	25	15	40	0	2	42	0	0
7	39177527	.	G	A	25	14	39	0	1	40	0	0
7	39177601	.	C	A	21	11	32	0	1	33	0	0
7	39177643	.	A	G	14	14	28	0	3	31	0	0
7	39177679	.	C	T	18	17	35	0	1	36	0	0
7	39177717	.	A	G	18	16	34	0	1	35	0	0
7	39177729	.	A	G	17	10	27	0	2	29	0	0
7	39177962	.	T	C	5	8	13	0	0	13	0	0
7	39178065	.	A	G	5	6	11	0	0	11	0	0
7	39178123	.	A	G	5	4	9	0	1	10	0	0
7	39181264	.	T	C	11	2	13	0	19	32	0	0
7	39181275	.	A	G	6	16	22	0	3	25	0	0
7	39181318	.	C	T	12	13	25	0	2	27	0	0
7	39181347	.	G	A	14	11	25	0	0	25	0	0
7	39181597	.	C	A	20	14	34	0	1	35	0	0
7	39182127	.	T	C	14	12	26	0	1	27	0	0
7	39203411	.	G	A	3	6	9	0	1	10	0	0
7	39255816	.	C	T	1	1	2	0	2	4	0	0
7	39256326	.	A	G	2	2	4	0	0	4	0	0
7	39280721	.	A	T	5	2	7	0	0	7	0	0
7	39280835	.	T	A	1	6	7	0	0	7	0	0
7	39366672	.	C	A	4	4	8	0	0	8	0	0
7	39366892	.	A	G	3	0	3	0	4	7	0	0
7	39367765	.	G	A	2	2	4	0	0	4	0	0
7	39371295	.	T	C	7	2	9	0	0	9	0	0
7	39373331	.	A	G	2	5	7	0	0	7	0	0
7	39454089	.	C	T	6	7	13	0	0	13	0	0
7	39538001	.	T	C	3	5	8	0	1	9	0	0
7	39538153	.	T	C	3	2	5	0	0	5	0	0
7	39636727	.	T	C	1	3	4	0	0	4	0	0
7	39640249	.	C	T	6	5	11	0	0	11	0	0
7	39643046	.	A	G	5	3	8	0	1	9	0	0
7	39648980	.	A	G	4	3	7	0	0	7	0	0
7	39655524	.	T	A	7	5	12	0	0	12	0	0
7	39655586	.	C	G	2	6	8	0	0	8	0	0
7	39655618	.	A	G	2	0	2	0	5	7	0	0
7	39656974	.	G	A	7	6	13	0	2	15	0	0
7	39657389	.	C	A	4	4	8	0	0	8	0	0
7	39657467	.	T	A	9	8	17	0	1	18	0	0
7	39657693	.	G	T	6	2	8	0	0	8	0	0
7	39658195	.	C	T	13	8	21	0	0	21	0	0
7	39658224	.	A	C	12	13	25	0	0	25	0	0
7	39658356	.	T	C	3	11	14	0	0	14	0	0
7	39658441	.	T	C	8	7	15	0	1	16	0	0
7	39658831	.	T	G	13	15	28	0	1	29	0	0
7	39659275	.	A	C	4	4	8	0	0	8	0	0
7	39659400	.	T	A	4	4	8	0	1	9	0	0
7	39659711	.	A	C	6	4	10	0	0	10	0	0
7	39659758	.	C	A	2	2	4	0	0	4	0	0
7	39659792	.	T	C	4	3	7	0	0	7	0	0
7	39659806	.	G	A	4	3	7	0	1	8	0	0
7	39660054	.	A	C	12	8	20	0	2	22	0	0
7	39660201	.	G	A	17	11	28	1	5	34	0	0
7	39660239	.	A	T	17	10	27	0	2	29	0	0
7	39660304	.	A	G	20	26	46	0	5	51	0	0
7	39660624	.	C	A	15	15	30	0	3	33	0	0
7	39670892	.	G	C	10	3	13	0	0	13	0	0
7	39671118	.	T	A	6	6	12	0	1	13	0	0
7	39671281	.	G	A	11	10	21	0	0	21	0	0
7	39671647	.	C	T	8	4	12	0	1	13	0	0
7	39672054	.	A	T	11	3	14	0	1	15	0	0
7	39672741	.	A	G	11	9	20	0	2	22	0	0
7	39673095	.	A	G	11	0	11	0	6	17	0	0
7	39673773	.	G	C	2	6	8	0	14	22	0	0
7	39675838	.	A	G	12	6	18	0	1	19	0	0
7	39675961	.	T	A	6	4	10	0	1	11	0	0
7	39675991	.	C	T	2	2	4	0	0	4	0	0
7	39676183	.	T	A	6	2	8	0	0	8	0	0
7	39676301	.	G	T	7	4	11	0	0	11	0	0
7	39676303	.	A	T	7	4	11	0	0	11	0	0
7	39676364	.	T	G	10	3	13	0	1	14	0	0
7	39676365	.	C	T	11	3	14	0	0	14	0	0
7	39676446	.	A	T	10	6	16	0	0	16	0	0
7	39676518	.	A	G	11	9	20	0	0	20	0	0
7	39676776	.	C	G	14	7	21	0	0	21	0	0
7	39676947	.	T	G	17	6	23	0	4	27	0	0
7	39677257	.	A	T	5	6	11	0	4	15	0	0
7	39677347	.	G	A	17	7	24	0	1	25	0	0
7	39677549	.	T	C	16	10	26	0	1	27	0	0
7	39677625	.	G	T	13	16	29	0	3	32	0	0
7	39677755	.	C	T	5	8	13	0	2	15	0	0
7	39677878	.	G	C	14	15	29	0	1	30	0	0
7	39677924	.	A	G	14	19	33	1	1	35	0	0
7	39677948	.	G	T	9	16	25	1	2	28	0	0
7	39677998	.	C	G	7	13	20	0	1	21	0	0
7	39691143	.	T	C	6	6	12	0	1	13	0	0
7	39691328	.	A	T	7	3	10	0	1	11	0	0
7	39691394	.	A	G	2	6	8	0	0	8	0	0
7	39695527	.	A	G	8	0	8	0	6	14	0	0
7	39695535	.	T	C	8	7	15	0	0	15	0	0
7	39695776	.	A	C	4	2	6	0	0	6	0	0
7	39698691	.	G	A	0	7	7	0	6	13	0	0
7	39698963	.	T	C	13	12	25	0	2	27	0	0
7	39701913	.	A	C	7	8	15	0	0	15	0	0
7	39702022	.	C	G	6	6	12	0	0	12	0	0
7	39702827	.	C	T	2	3	5	0	0	5	0	0
7	39704015	.	A	G	6	0	6	0	3	9	0	0
7	39704229	.	C	T	10	3	13	0	1	14	0	0
7	39704340	.	T	A	6	5	11	0	0	11	0	0
7	39704345	.	C	T	7	3	10	0	0	10	0	0
7	39704473	.	T	G	2	4	6	0	2	8	0	0
7	39704599	.	G	T	8	3	11	0	0	11	0	0
7	39704632	.	C	T	5	3	8	0	1	9	0	0
7	39704677	.	T	A	1	2	3	0	0	3	0	0
7	39704928	.	G	A	1	9	10	0	10	20	0	0
7	39704955	.	T	A	8	11	19	0	0	19	0	0
7	39705178	.	C	T	15	10	25	1	0	26	0	0
7	39705187	.	T	G	16	10	26	1	1	28	0	0
7	39705245	.	G	A	4	7	11	0	4	15	0	0
7	39705337	.	A	C	9	9	18	0	1	19	0	0
7	39730901	.	T	G	2	5	7	0	0	7	0	0
7	39731036	.	G	T	1	2	3	0	0	3	0	0
7	39740651	.	A	G	2	3	5	0	0	5	0	0
7	39742334	.	G	A	0	4	4	0	3	7	0	0
7	39742784	.	A	G	4	5	9	1	2	12	0	0
7	39742841	.	A	T	3	4	7	0	2	9	0	0
7	39743126	.	G	A	2	6	8	0	0	8	0	0
7	39743177	.	C	A	2	4	6	0	0	6	0	0
7	39744494	.	G	A	5	10	15	0	0	15	0	0
7	39744543	.	G	A	2	2	4	0	0	4	0	0
7	39745110	.	A	T	7	4	11	0	0	11	0	0
7	39745580	.	A	G	12	9	21	0	0	21	0	0
7	39748934	.	A	C	7	12	19	0	4	23	0	0
7	40059995	.	C	T	4	2	6	0	0	6	0	0
7	40492740	.	T	A	46	26	72	0	2	75	1	0
7	40492764	.	G	C	5	35	40	0	35	76	1	0
7	40492789	.	T	C	41	26	67	0	0	67	0	0
7	40492800	.	G	T	40	19	59	0	1	60	0	0
7	40903374	.	T	A	0	6	6	0	1	7	0	0
7	41714385	.	T	C	4	5	9	0	2	11	0	0
7	41900402	.	G	C	4	4	8	0	0	8	0	0
7	41901207	.	A	G	3	6	9	0	0	9	0	0
7	42068201	.	C	T	1	5	6	0	1	7	0	0
7	43760754	.	T	C	19	8	27	0	1	28	0	0
7	44467740	.	G	T	4	1	5	0	3	8	0	0
7	44588458	.	A	G	11	5	16	0	1	17	0	0
7	46487662	.	C	A	2	4	6	0	0	6	0	0
7	46728942	.	T	A	1	3	4	0	0	4	0	0
7	48829926	.	A	T	4	3	7	0	0	7	0	0
7	50228702	.	A	T	1	5	6	0	2	8	0	0
7	50548086	.	A	G	1	7	8	0	0	8	0	0
7	50877064	.	T	C	5	8	13	0	0	13	0	0
7	50877100	.	T	C	8	3	11	0	0	11	0	0
7	50881578	.	A	G	1	1	2	0	0	2	0	0
7	51220557	.	G	A	9	3	12	0	0	12	0	0
7	51249441	.	G	T	3	2	5	0	0	5	0	0
7	51352721	.	A	T	2	4	6	0	0	6	0	0
7	51352806	.	T	C	5	2	7	0	0	7	0	0
7	51353191	.	G	A	2	6	8	0	0	8	0	0
7	51353854	.	T	A	4	2	6	0	0	6	0	0
7	51353935	.	G	A	7	6	13	0	0	13	0	0
7	51354066	.	G	A	0	5	5	0	3	8	0	0
7	51354424	.	T	A	4	4	8	0	1	9	0	0
7	51354442	.	C	A	3	8	11	0	0	11	0	0
7	51354583	.	A	G	5	1	6	0	0	6	0	0
7	51354672	.	T	A	3	7	10	0	1	11	0	0
7	51354696	.	C	T	6	8	14	0	0	14	0	0
7	51354756	.	T	C	11	9	20	0	0	20	0	0
7	51355133	.	A	G	6	0	6	0	2	8	0	0
7	51355134	.	A	G	6	2	8	0	0	8	0	0
7	51355195	.	A	G	8	6	14	0	0	14	0	0
7	51355196	.	A	G	8	6	14	0	0	14	0	0
7	51355531	.	T	A	1	2	3	0	0	3	0	0
7	51355936	.	G	T	9	4	13	0	0	13	0	0
7	51356089	.	A	G	2	5	7	0	1	8	0	0
7	51356100	.	A	T	2	5	7	0	1	8	0	0
7	51356150	.	A	G	4	4	8	0	1	9	0	0
7	51356197	.	A	G	8	0	8	0	3	11	0	0
7	51356212	.	A	G	12	3	15	0	1	16	0	0
7	51356542	.	C	G	10	11	21	0	0	21	0	0
7	51368654	.	T	G	1	2	3	0	0	3	0	0
7	51423426	.	G	A	1	1	2	0	1	3	0	0
7	51468042	.	C	T	3	15	18	0	12	30	0	0
7	51468199	.	C	T	22	15	37	0	2	39	0	0
7	51468389	.	C	T	3	18	21	0	10	31	0	0
7	51468411	.	A	T	12	13	25	0	0	25	0	0
7	51468556	.	G	C	17	13	30	0	3	33	0	0
7	51468577	.	C	A	14	17	31	0	1	33	1	0
7	51468928	.	G	A	13	8	21	1	2	24	0	0
7	51469048	.	T	G	16	19	35	0	0	35	0	0
7	51469166	.	A	T	20	13	33	0	1	34	0	0
7	51469340	.	G	A	9	7	16	0	0	16	0	0
7	51469361	.	A	G	7	10	17	0	1	18	0	0
7	51469578	.	T	G	13	8	21	0	0	21	0	0
7	51469952	.	A	T	10	10	20	0	0	20	0	0
7	51469956	.	C	T	0	10	10	0	10	20	0	0
7	51470070	.	T	C	7	0	7	0	8	15	0	0
7	51470569	.	G	T	6	5	11	0	0	11	0	0
7	51470741	.	A	G	5	2	7	0	0	7	0	0
7	51470868	.	C	A	8	4	12	0	0	12	0	0
7	51471107	.	G	A	6	18	24	0	0	24	0	0
7	51471117	.	A	G	7	15	22	0	0	22	0	0
7	51471365	.	T	C	11	0	11	0	0	11	0	0
7	51471554	.	T	C	3	0	3	0	10	13	0	0
7	51471690	.	T	C	7	0	7	0	6	13	0	0
7	51471714	.	A	G	8	7	15	0	1	16	0	0
7	51471775	.	G	A	2	6	8	0	1	9	0	0
7	51472175	.	A	C	2	3	5	1	1	7	0	0
7	51472179	.	C	A	0	5	5	1	0	6	0	0
7	51472456	.	C	T	5	4	9	0	0	9	0	0
7	51472693	.	C	T	0	4	4	0	3	7	0	0
7	51472702	.	A	G	3	4	7	0	0	7	0	0
7	51472793	.	A	C	7	1	8	0	6	14	0	0
7	51473000	.	C	T	6	2	8	0	3	11	0	0
7	51473021	.	C	T	7	3	10	0	0	10	0	0
7	51473585	.	T	C	5	0	5	0	3	8	0	0
7	51473673	.	G	A	14	8	22	0	0	22	0	0
7	51473814	.	C	T	5	9	14	0	1	15	0	0
7	51474238	.	G	A	9	3	12	0	0	12	0	0
7	51474279	.	C	A	4	5	9	0	0	9	0	0
7	51474300	.	G	T	4	5	9	0	0	9	0	0
7	51474468	.	C	T	0	6	6	0	5	11	0	0
7	51475111	.	G	A	3	5	8	0	0	8	0	0
7	51475288	.	G	A	1	3	4	0	0	4	0	0
7	51476108	.	G	A	3	4	7	0	0	7	0	0
7	51634231	.	A	G	27	27	54	0	4	58	0	0
7	51634285	.	C	T	35	29	64	0	4	69	1	0
7	51634480	.	G	A	39	28	67	0	5	72	0	0
7	51643163	.	A	G	4	6	10	0	0	10	0	0
7	51643363	.	G	A	4	4	8	0	0	8	0	0
7	51643366	.	G	A	7	4	11	0	0	11	0	0
7	51643639	.	A	C	4	4	8	0	0	8	0	0
7	51643722	.	A	G	1	5	6	0	0	6	0	0
7	51698403	.	T	A	4	6	10	0	0	10	0	0
7	51712777	.	T	C	1	5	6	0	0	6	0	0
7	51779552	.	G	A	1	20	21	0	18	39	0	0
7	51779636	.	T	C	12	21	33	0	0	33	0	0
7	51786442	.	T	G	25	0	25	0	11	36	0	0
7	51788729	.	C	T	16	20	36	2	0	38	0	0
7	51788756	.	A	C	14	20	34	2	2	38	0	0
7	51793623	.	C	T	17	14	31	0	2	33	0	0
7	51793747	.	C	T	13	21	34	0	2	36	0	0
7	51793813	.	G	C	7	12	19	0	1	20	0	0
7	51806570	.	T	C	3	2	5	0	0	5	0	0
7	51808324	.	C	A	2	4	6	0	0	6	0	0
7	51808384	.	G	C	0	6	6	0	2	8	0	0
7	51813764	.	G	A	2	3	5	0	1	6	0	0
7	51814287	.	C	G	4	4	8	0	1	9	0	0
7	51814385	.	G	C	7	7	14	0	0	14	0	0
7	51814416	.	T	A	6	5	11	0	0	11	0	0
7	51814512	.	C	T	2	8	10	0	0	10	0	0
7	51824687	.	C	A	8	6	14	0	1	15	0	0
7	51824718	.	A	C	7	4	11	0	1	12	0	0
7	51824772	.	T	G	5	4	9	0	2	11	0	0
7	51826059	.	G	A	3	3	6	0	1	7	0	0
7	52152053	.	A	T	1	2	3	0	0	3	0	0
7	52152063	.	C	T	0	2	2	0	2	4	0	0
7	52152101	.	C	T	2	4	6	0	0	6	0	0
7	52153001	.	G	A	1	1	2	0	1	3	0	0
7	52153006	.	C	T	1	1	2	0	1	3	0	0
7	52156113	.	G	A	0	4	4	0	1	5	0	0
7	52156137	.	T	A	3	3	6	0	0	6	0	0
7	52157531	.	T	G	4	5	9	0	0	9	0	0
7	52157782	.	T	C	6	4	10	0	1	11	0	0
7	52157814	.	G	T	8	3	11	0	0	11	0	0
7	52157994	.	A	G	3	0	3	1	4	8	0	0
7	52158035	.	C	T	5	1	6	1	1	8	0	0
7	52158210	.	G	T	2	5	7	0	1	8	0	0
7	52158304	.	G	A	6	4	10	0	0	10	0	0
7	52158339	.	G	C	7	3	10	0	0	10	0	0
7	52158435	.	A	T	2	7	9	1	0	10	0	0
7	52161646	.	G	T	1	6	7	0	0	7	0	0
7	52164592	.	T	C	7	3	10	0	0	10	0	0
7	52165016	.	T	A	7	6	13	0	1	14	0	0
7	52166143	.	G	A	10	14	24	0	0	24	0	0
7	52173195	.	C	A	7	3	10	0	1	11	0	0
7	52175362	.	T	C	7	10	17	0	0	17	0	0
7	52178542	.	T	C	5	8	13	0	1	14	0	0
7	52282674	.	G	T	16	8	24	0	0	24	0	0
7	52285113	.	C	G	11	7	18	0	0	18	0	0
7	52285262	.	T	A	1	2	3	0	0	3	0	0
7	52285272	.	T	C	6	1	7	0	0	7	0	0
7	52294403	.	G	A	15	15	30	0	3	33	0	0
7	52294540	.	A	T	23	11	34	0	2	36	0	0
7	52294746	.	C	T	3	12	15	0	7	22	0	0
7	52295795	.	C	T	2	8	10	0	16	26	0	0
7	52296018	.	T	C	20	6	26	0	1	27	0	0
7	52296033	.	T	C	18	7	25	0	3	28	0	0
7	52296320	.	G	A	4	10	14	0	0	14	0	0
7	52296352	.	G	T	3	6	9	0	1	10	0	0
7	52296400	.	C	A	5	10	15	0	1	16	0	0
7	52309924	.	G	A	11	12	23	0	0	23	0	0
7	52315434	.	C	G	0	3	3	0	4	7	0	0
7	52328463	.	A	G	3	3	6	0	0	6	0	0
7	52328569	.	C	T	4	7	11	0	0	11	0	0
7	52432459	.	G	A	1	2	3	0	0	3	0	0
7	52517561	.	C	G	8	5	13	0	0	13	0	0
7	52518134	.	G	C	9	0	9	0	11	20	0	0
7	52518271	.	A	T	9	10	19	0	1	20	0	0
7	52519134	.	G	A	9	8	17	0	0	17	0	0
7	52521352	.	G	A	5	6	11	0	3	14	0	0
7	52533621	.	C	T	3	4	7	0	0	7	0	0
7	52533649	.	C	T	3	4	7	0	0	7	0	0
7	52551570	.	A	T	1	2	3	0	1	4	0	0
7	52574213	.	A	C	1	0	1	0	3	4	0	0
7	52574225	.	G	A	2	3	5	0	0	5	0	0
7	52589092	.	G	A	2	4	6	0	0	6	0	0
7	52589094	.	A	C	2	0	2	0	4	6	0	0
7	52716777	.	T	A	1	6	7	0	0	7	0	0
7	52716792	.	A	T	1	7	8	0	1	9	0	0
7	52716875	.	C	A	4	4	8	0	1	9	0	0
7	52717095	.	T	C	5	4	9	0	0	9	0	0
7	52728713	.	G	A	3	3	6	0	1	7	0	0
7	52729079	.	T	G	3	0	3	0	4	7	0	0
7	52750565	.	C	T	13	12	25	0	1	26	0	0
7	52750847	.	C	T	10	10	20	0	1	21	0	0
7	52751341	.	T	A	3	2	5	0	1	6	0	0
7	52751357	.	T	C	2	3	5	0	1	6	0	0
7	52820060	.	T	A	7	7	14	0	2	16	0	0
7	52820320	.	C	T	7	12	19	0	0	19	0	0
7	52821156	.	T	G	4	3	7	0	0	7	0	0
7	52821432	.	A	G	11	8	19	0	1	20	0	0
7	52821646	.	A	C	7	13	20	0	0	20	0	0
7	52821658	.	C	A	14	6	20	0	1	21	0	0
7	52821701	.	G	A	10	6	16	0	1	17	0	0
7	52822708	.	C	T	9	4	13	0	0	13	0	0
7	52822791	.	T	A	7	8	15	0	1	16	0	0
7	52822793	.	A	G	7	9	16	0	0	16	0	0
7	52823429	.	A	T	10	10	20	0	2	22	0	0
7	52830423	.	G	T	3	4	7	0	0	7	0	0
7	52830447	.	G	T	4	3	7	0	2	9	0	0
7	52830601	.	T	G	16	16	32	0	3	35	0	0
7	52831053	.	G	T	27	15	42	0	4	46	0	0
7	52831413	.	C	T	13	17	30	0	2	32	0	0
7	52831622	.	T	C	13	5	18	0	0	18	0	0
7	52832127	.	C	T	12	18	30	0	0	30	0	0
7	52832129	.	C	T	12	15	27	0	3	30	0	0
7	52833126	.	C	G	11	7	18	0	1	19	0	0
7	52833248	.	A	T	12	13	25	0	4	29	0	0
7	52833606	.	G	A	17	18	35	0	2	37	0	0
7	52833792	.	G	A	13	21	34	0	1	35	0	0
7	52837804	.	T	G	17	12	29	0	0	29	0	0
7	52837908	.	G	A	15	6	21	0	1	22	0	0
7	52838681	.	G	A	7	10	17	0	1	18	0	0
7	52839062	.	C	T	3	7	10	0	0	10	0	0
7	52900928	.	A	C	11	11	22	0	2	24	0	0
7	52901531	.	C	T	12	12	24	0	0	24	0	0
7	52902160	.	G	A	14	9	23	0	2	25	0	0
7	52929182	.	G	A	30	20	50	0	0	50	0	0
7	52933191	.	C	T	8	2	10	0	0	10	0	0
7	52937334	.	G	A	7	11	18	0	0	18	0	0
7	52942312	.	G	T	9	8	17	0	0	17	0	0
7	52944199	.	G	A	13	6	19	0	1	20	0	0
7	52958716	.	A	T	3	2	5	0	0	5	0	0
7	52958995	.	T	C	1	5	6	0	0	6	0	0
7	52962765	.	T	C	3	2	5	0	7	12	0	0
7	53162425	.	T	C	2	2	4	1	3	8	0	0
7	53162537	.	A	G	2	4	6	3	1	10	0	0
7	54039538	.	T	C	3	4	7	0	0	7	0	0
7	54039544	.	G	A	3	2	5	0	1	6	0	0
7	54058390	.	C	T	1	3	4	0	0	4	0	0
7	54070097	.	G	A	0	4	4	0	1	5	0	0
7	54071109	.	G	A	1	3	4	0	2	6	0	0
7	54071118	.	T	C	1	6	7	0	0	7	0	0
7	54088034	.	C	T	5	5	10	0	1	11	0	0
7	54088230	.	C	T	6	3	9	0	1	10	0	0
7	54088520	.	G	A	4	10	14	0	2	16	0	0
7	54088578	.	T	C	6	7	13	0	0	13	0	0
7	54088850	.	A	G	7	5	12	0	0	12	0	0
7	54088988	.	G	A	3	10	13	0	0	13	0	0
7	54089192	.	A	T	3	4	7	0	0	7	0	0
7	54089272	.	T	C	4	2	6	0	0	6	0	0
7	54092602	.	A	T	12	19	31	0	1	32	0	0
7	54102515	.	C	T	10	5	15	0	0	15	0	0
7	54102764	.	C	A	6	6	12	0	0	12	0	0
7	54102884	.	T	A	4	7	11	0	0	11	0	0
7	54103168	.	C	T	0	4	4	0	5	9	0	0
7	54103328	.	G	T	4	9	13	0	0	13	0	0
7	54103397	.	A	G	4	8	12	0	0	12	0	0
7	54104127	.	C	A	1	5	6	0	3	9	0	0
7	54104153	.	C	T	3	4	7	0	2	9	0	0
7	54105266	.	C	T	1	4	5	0	2	7	0	0
7	54105412	.	C	T	1	6	7	0	5	12	0	0
7	54137202	.	G	A	3	6	9	0	0	9	0	0
7	54307268	.	G	C	3	6	9	0	0	9	0	0
7	54307826	.	G	T	2	2	4	0	0	4	0	0
7	54307836	.	G	T	3	2	5	0	0	5	0	0
7	54307886	.	G	A	4	5	9	0	0	9	0	0
7	54307898	.	T	C	4	6	10	0	0	10	0	0
7	54323986	.	T	C	13	0	13	0	13	26	0	0
7	54324019	.	C	T	9	13	22	0	0	22	0	0
7	54324133	.	C	A	13	13	26	0	0	26	0	0
7	54327110	.	G	A	7	5	12	0	0	12	0	0
7	54327402	.	T	C	11	7	18	0	1	19	0	0
7	54361300	.	C	T	0	6	6	0	2	8	0	0
7	54361303	.	A	G	2	6	8	0	0	8	0	0
7	54373299	.	A	G	1	3	4	0	0	4	0	0
7	54373311	.	C	T	2	5	7	0	0	7	0	0
7	54407619	.	C	T	4	4	8	0	1	9	0	0
7	54407828	.	T	C	3	4	7	0	1	8	0	0
7	54420390	.	C	T	1	2	3	0	1	4	0	0
7	54475473	.	T	G	1	2	3	0	0	3	0	0
7	54486811	.	A	G	2	0	2	0	1	3	0	0
7	54486819	.	T	C	1	2	3	0	0	3	0	0
7	54655025	.	A	T	3	4	7	0	0	7	0	0
7	54655136	.	T	A	4	2	6	0	0	6	0	0
7	54655141	.	G	A	4	2	6	0	0	6	0	0
7	54670384	.	C	T	4	3	7	0	1	8	0	0
7	54671038	.	C	T	0	4	4	0	1	5	0	0
7	54671934	.	A	T	4	4	8	0	0	8	0	0
7	55299333	.	T	C	2	2	4	0	0	4	0	0
7	55314253	.	A	G	3	2	5	0	0	5	0	0
7	55315983	.	C	G	4	4	8	0	0	8	0	0
7	55531105	.	A	G	13	9	22	0	1	23	0	0
7	55531112	.	G	A	13	9	22	0	0	22	0	0
7	55531295	.	C	T	4	4	8	0	13	21	0	0
7	55531430	.	G	T	9	2	11	0	1	12	0	0
7	55531608	.	T	C	9	5	14	0	1	15	0	0
7	55531610	.	G	A	10	5	15	0	0	15	0	0
7	55532234	.	C	T	3	3	6	0	1	7	0	0
7	55532281	.	G	A	3	3	6	0	1	7	0	0
7	55532316	.	A	G	2	3	5	0	0	5	0	0
7	55532327	.	C	A	1	3	4	0	0	4	0	0
7	55532380	.	T	C	4	0	4	0	4	8	0	0
7	55532424	.	C	A	5	4	9	0	0	9	0	0
7	55532429	.	T	C	4	4	8	0	0	8	0	0
7	55532524	.	A	G	4	2	6	0	0	6	0	0
7	55532656	.	A	G	8	4	12	0	0	12	0	0
7	55535754	.	T	A	6	2	8	0	1	9	0	0
7	55536451	.	G	A	4	2	6	0	0	6	0	0
7	55536487	.	G	A	6	2	8	0	1	9	0	0
7	55539410	.	A	G	1	2	3	0	0	3	0	0
7	55593120	.	A	C	5	4	9	0	0	9	0	0
7	55607306	.	G	T	1	0	1	0	1	2	0	0
7	55607313	.	G	C	1	2	3	0	0	3	0	0
7	55635202	.	T	C	12	15	27	0	0	27	0	0
7	55635355	.	G	A	1	4	5	0	5	10	0	0
7	55635390	.	C	T	1	2	3	0	0	3	0	0
7	55635409	.	T	C	1	2	3	0	0	3	0	0
7	55635995	.	C	T	1	2	3	0	0	3	0	0
7	55637122	.	C	A	2	6	8	0	1	9	0	0
7	55660269	.	G	A	10	13	23	0	0	23	0	0
7	56020062	.	C	T	2	2	4	0	0	4	0	0
7	56152363	.	C	A	6	8	14	0	0	14	0	0
7	56152436	.	G	A	4	10	14	0	2	16	0	0
7	56152437	.	G	A	5	10	15	0	0	15	0	0
7	56152660	.	T	C	10	10	20	0	0	20	0	0
7	56152740	.	G	A	13	9	22	0	2	24	0	0
7	56152759	.	C	G	2	11	13	0	14	27	0	0
7	56158197	.	G	A	9	15	24	0	0	24	0	0
7	56164219	.	T	G	9	7	16	0	1	17	0	0
7	56164267	.	G	A	8	12	20	0	0	20	0	0
7	56167349	.	C	A	8	9	17	0	0	17	0	0
7	56253928	.	T	A	1	4	5	0	0	5	0	0
7	56394991	.	T	C	3	2	5	0	0	5	0	0
7	56396599	.	G	A	1	6	7	0	6	13	0	0
7	56400738	.	C	T	2	5	7	0	0	7	0	0
7	56401039	.	G	A	8	3	11	0	1	12	0	0
7	56401173	.	T	C	8	5	13	0	0	13	0	0
7	56473558	.	T	A	5	3	8	0	2	10	0	0
7	56483078	.	T	C	2	2	4	0	0	4	0	0
7	56483131	.	A	C	2	2	4	0	0	4	0	0
7	56483141	.	T	C	1	2	3	0	0	3	0	0
7	56483772	.	T	G	14	8	22	0	3	25	0	0
7	56483928	.	C	T	12	11	23	0	0	23	0	0
7	56484288	.	G	C	17	11	28	0	0	29	1	0
7	56528530	.	T	C	2	7	9	0	0	9	0	0
7	56721933	.	A	G	7	0	7	0	3	10	0	0
7	56746224	.	T	C	5	8	13	0	0	13	0	0
7	56751971	.	A	G	12	14	26	0	4	30	0	0
7	56752243	.	G	A	16	16	32	0	1	33	0	0
7	56761453	.	A	T	6	7	13	0	0	13	0	0
7	56761482	.	G	T	4	8	12	0	0	12	0	0
7	56762118	.	G	C	11	4	15	0	0	15	0	0
7	56764603	.	G	A	7	6	13	0	1	14	0	0
7	56766115	.	C	T	1	4	5	0	5	10	0	0
7	56766282	.	A	C	3	0	3	0	2	5	0	0
7	56766455	.	A	T	4	2	6	0	0	6	0	0
7	56766691	.	G	A	3	2	5	0	0	5	0	0
7	56766754	.	A	T	2	4	6	0	1	7	0	0
7	56766828	.	C	G	2	2	4	0	0	4	0	0
7	56766845	.	T	C	1	3	4	0	0	4	0	0
7	56777813	.	T	C	12	1	13	0	9	22	0	0
7	56778305	.	G	A	16	8	24	0	0	24	0	0
7	56778605	.	A	T	35	14	49	0	1	50	0	0
7	56778672	.	G	T	15	15	30	0	2	32	0	0
7	56778721	.	G	T	24	10	34	0	0	34	0	0
7	56778817	.	G	A	13	16	29	0	1	31	1	0
7	56778895	.	A	G	11	9	20	0	1	21	0	0
7	56784046	.	C	T	16	14	30	0	2	32	0	0
7	56784963	.	T	C	16	0	16	0	8	24	0	0
7	56785093	.	A	C	11	19	30	0	1	31	0	0
7	56785308	.	C	T	17	17	34	0	3	37	0	0
7	56787671	.	T	A	9	7	16	0	1	17	0	0
7	56793362	.	G	A	7	7	14	0	0	14	0	0
7	56793377	.	A	C	9	0	9	0	6	15	0	0
7	56793647	.	C	A	3	4	7	0	4	11	0	0
7	57839716	.	A	C	6	8	14	0	2	16	0	0
7	57862456	.	C	T	10	8	18	0	0	18	0	0
7	57874026	.	G	A	6	7	13	0	0	13	0	0
7	57874038	.	A	C	7	5	12	0	2	14	0	0
7	57874083	.	G	A	1	5	6	0	9	15	0	0
7	57876512	.	T	C	8	10	18	0	0	18	0	0
7	57878712	.	T	C	5	4	9	0	0	9	0	0
7	57878726	.	A	T	3	2	5	0	1	6	0	0
7	57878885	.	C	T	5	8	13	0	0	13	0	0
7	57878973	.	A	T	5	3	8	0	1	9	0	0
7	57878974	.	C	T	6	3	9	0	0	9	0	0
7	57879076	.	A	G	7	0	7	0	6	13	0	0
7	57879396	.	T	A	14	8	22	0	3	25	0	0
7	57879431	.	G	T	0	13	13	0	15	28	0	0
7	57879436	.	C	A	13	14	27	0	1	28	0	0
7	57879576	.	C	A	18	12	30	0	2	32	0	0
7	57879601	.	T	C	22	9	31	0	1	32	0	0
7	57879959	.	C	A	5	6	11	0	2	14	1	0
7	57879992	.	G	A	6	10	16	0	0	16	0	0
7	57880073	.	G	C	1	6	7	0	0	7	0	0
7	57886347	.	C	A	16	28	44	0	5	49	0	0
7	57886392	.	T	A	32	24	56	0	0	56	0	0
7	57886964	.	T	G	29	30	59	0	0	59	0	0
7	57887480	.	C	T	32	22	54	1	4	59	0	0
7	57898605	.	G	A	34	23	57	0	2	59	0	0
7	57898623	.	C	T	39	25	64	0	0	64	0	0
7	57898650	.	T	C	30	33	63	0	2	65	0	0
7	57898658	.	C	G	26	35	61	0	2	63	0	0
7	57913558	.	C	A	20	32	52	0	3	55	0	0
7	57914155	.	T	G	26	29	55	0	1	56	0	0
7	57918590	.	A	G	19	6	25	0	1	26	0	0
7	57918799	.	G	A	28	27	55	0	1	56	0	0
7	57919087	.	T	G	30	11	41	0	8	49	0	0
7	57919241	.	G	A	26	18	44	0	4	48	0	0
7	57919249	.	T	C	26	0	26	0	21	47	0	0
7	57919567	.	T	C	11	20	31	0	1	32	0	0
7	57920608	.	A	T	11	12	23	0	0	23	0	0
7	57920908	.	A	G	19	11	30	0	1	31	0	0
7	57921094	.	A	G	22	23	45	0	0	45	0	0
7	57921335	.	A	G	9	14	23	0	3	26	0	0
7	57921914	.	G	A	11	15	26	0	0	26	0	0
7	57922018	.	T	G	9	9	18	0	0	18	0	0
7	57922480	.	G	A	10	15	25	0	1	26	0	0
7	57922555	.	G	T	15	14	29	0	2	31	0	0
7	57922793	.	G	T	13	10	23	0	0	23	0	0
7	57922827	.	C	T	11	10	21	0	0	21	0	0
7	57922828	.	A	G	10	10	20	0	1	21	0	0
7	57928407	.	A	T	10	10	20	0	0	20	0	0
7	57934036	.	A	T	15	10	25	0	0	25	0	0
7	57934051	.	T	C	12	9	21	0	0	21	0	0
7	57936171	.	G	A	15	7	22	0	1	23	0	0
7	57952714	.	T	C	8	5	13	0	1	14	0	0
7	57954099	.	G	A	8	4	12	0	0	12	0	0
7	57954123	.	A	C	8	5	13	0	0	13	0	0
7	57956503	.	C	T	8	7	15	0	0	15	0	0
7	57959962	.	G	A	12	8	20	0	1	21	0	0
7	57961917	.	C	A	7	11	18	0	0	18	0	0
7	57967373	.	A	G	5	7	12	0	0	12	0	0
7	57972616	.	T	C	5	5	10	0	0	10	0	0
7	57994952	.	T	A	5	5	10	0	0	10	0	0
7	58007916	.	G	T	3	7	10	0	1	11	0	0
7	58143104	.	A	G	2	3	5	0	1	6	0	0
7	58143123	.	G	C	2	3	5	0	3	8	0	0
7	58143877	.	G	A	3	4	7	0	1	8	0	0
7	58143885	.	G	A	4	3	7	0	0	7	0	0
7	58150120	.	A	T	9	6	15	0	0	15	0	0
7	58158456	.	C	T	1	3	4	0	4	8	0	0
7	58158484	.	T	C	2	5	7	0	0	7	0	0
7	58158847	.	T	C	2	5	7	0	0	7	0	0
7	58188252	.	A	G	8	4	12	0	0	12	0	0
7	58188253	.	A	C	8	4	12	0	0	12	0	0
7	58193195	.	A	G	4	2	6	0	0	6	0	0
7	58205622	.	T	C	5	3	8	0	0	8	0	0
7	58207453	.	A	G	5	2	7	0	0	7	0	0
7	58259472	.	C	T	16	8	24	0	0	24	0	0
7	58259494	.	T	A	15	8	23	0	2	25	0	0
7	58259561	.	A	G	12	11	23	0	1	24	0	0
7	58259808	.	C	T	0	9	9	0	6	15	0	0
7	58262100	.	G	A	7	8	15	0	0	15	0	0
7	58264129	.	T	C	5	5	10	0	0	10	0	0
7	58265533	.	G	A	7	11	18	0	1	19	0	0
7	58687138	.	G	A	11	6	17	0	0	17	0	0
7	58695379	.	A	C	2	7	9	0	1	10	0	0
7	58695441	.	C	A	20	13	33	0	0	33	0	0
7	58695599	.	G	T	13	10	23	0	1	24	0	0
7	58720696	.	T	A	1	4	5	0	0	5	0	0
7	58720718	.	T	C	1	0	1	0	2	3	0	0
7	58748871	.	A	C	27	23	50	0	3	53	0	0
7	58748891	.	T	C	28	22	50	0	0	50	0	0
7	58750327	.	A	C	24	16	40	0	2	42	0	0
7	58841391	.	T	C	14	1	15	0	10	25	0	0
7	58841552	.	T	G	8	7	15	0	1	16	0	0
7	58843134	.	T	C	5	13	18	0	0	18	0	0
7	59037573	.	A	C	2	3	5	0	0	5	0	0
7	59037972	.	C	T	7	4	11	0	1	12	0	0
7	59041471	.	A	G	2	6	8	0	0	8	0	0
7	59041504	.	A	G	1	5	6	0	0	6	0	0
7	59041531	.	A	G	3	0	3	0	5	8	0	0
7	59043246	.	C	A	5	6	11	0	0	11	0	0
7	59046711	.	T	A	8	2	10	0	0	10	0	0
7	59046966	.	T	A	14	8	22	0	3	25	0	0
7	59048307	.	C	T	0	17	17	0	16	33	0	0
7	59048907	.	G	A	15	6	21	0	0	21	0	0
7	59069079	.	G	A	6	5	11	0	0	11	0	0
7	59069080	.	T	G	3	5	8	0	3	11	0	0
7	59202384	.	G	A	1	2	3	0	0	3	0	0
7	59202852	.	T	G	2	4	6	0	0	6	0	0
7	59202989	.	A	T	3	5	8	0	2	10	0	0
7	59203097	.	A	G	4	5	9	0	0	9	0	0
7	59203289	.	G	A	2	10	12	0	2	14	0	0
7	59210423	.	T	A	1	2	3	0	0	3	0	0
7	59210625	.	C	T	2	3	5	0	1	6	0	0
7	59456904	.	A	C	3	2	5	0	0	5	0	0
7	59469015	.	G	A	2	6	8	0	0	8	0	0
7	59574234	.	C	A	6	2	8	0	0	8	0	0
7	59589259	.	A	G	4	10	14	0	1	15	0	0
7	59677296	.	C	A	1	2	3	0	0	3	0	0
7	59677543	.	C	T	1	1	2	0	1	3	0	0
7	60149599	.	C	T	19	18	37	0	3	40	0	0
7	60242851	.	C	A	2	3	5	0	0	5	0	0
7	60243042	.	A	G	5	4	9	0	2	11	0	0
7	60244637	.	A	G	3	3	6	0	0	6	0	0
7	60256778	.	C	T	0	3	3	0	2	5	0	0
7	60359455	.	A	G	3	0	3	0	3	6	0	0
7	60359512	.	G	A	1	6	7	0	1	8	0	0
7	60359516	.	A	C	1	7	8	0	0	8	0	0
7	60359574	.	G	A	0	3	3	0	1	4	0	0
7	60359584	.	C	T	2	2	4	0	0	4	0	0
7	60359719	.	A	T	2	4	6	0	1	7	0	0
7	60409230	.	T	C	8	14	22	0	1	23	0	0
7	60416010	.	T	C	10	9	19	0	3	22	0	0
7	60416016	.	A	G	9	9	18	0	2	21	1	0
7	60416175	.	C	T	8	12	20	0	1	21	0	0
7	60416317	.	A	G	2	0	2	0	13	15	0	0
7	60416327	.	C	T	3	12	15	0	0	15	0	0
7	60416379	.	G	A	6	11	17	0	0	17	0	0
7	60416383	.	C	T	6	12	18	0	0	18	0	0
7	60416439	.	A	G	9	14	23	0	1	24	0	0
7	60416702	.	A	C	0	9	9	0	0	9	0	0
7	60416724	.	A	G	3	5	8	0	0	8	0	0
7	60416764	.	T	G	6	5	11	0	1	12	0	0
7	60417176	.	T	A	7	2	9	0	0	9	0	0
7	60551171	.	A	C	15	13	28	0	2	30	0	0
7	60551471	.	A	G	10	10	20	0	1	21	0	0
7	60585523	.	A	G	18	1	19	0	14	33	0	0
7	60585599	.	G	A	19	8	27	0	0	27	0	0
7	60585702	.	G	A	10	5	15	0	1	16	0	0
7	60585748	.	G	T	3	10	13	0	3	16	0	0
7	60585818	.	G	C	6	10	16	0	2	18	0	0
7	60586187	.	T	C	15	17	32	0	3	35	0	0
7	60586364	.	A	C	7	12	19	0	0	19	0	0
7	60586771	.	C	T	6	9	15	0	1	16	0	0
7	60586784	.	A	T	10	9	19	0	0	19	0	0
7	60586835	.	C	T	13	8	21	0	0	21	0	0
7	60586874	.	G	A	1	11	12	0	12	24	0	0
7	60586976	.	C	T	12	15	27	0	0	27	0	0
7	60597482	.	G	A	12	14	26	0	2	28	0	0
7	60597500	.	T	G	15	11	26	0	0	26	0	0
7	60597863	.	C	T	20	22	42	0	1	43	0	0
7	60598265	.	T	A	19	22	41	0	1	42	0	0
7	61169079	.	A	G	1	5	6	0	0	6	0	0
7	61586641	.	C	G	4	10	14	0	1	15	0	0
7	61586719	.	C	T	0	5	5	0	3	8	0	0
7	61586910	.	C	T	7	2	9	0	0	9	0	0
7	61587138	.	A	G	3	2	5	0	0	5	0	0
7	61587143	.	T	A	2	2	4	0	0	4	0	0
7	61594209	.	G	A	3	4	7	0	0	7	0	0
7	61771495	.	C	G	1	1	2	0	1	3	0	0
7	61771497	.	C	T	1	1	2	0	1	3	0	0
7	61775523	.	G	A	2	3	5	0	0	5	0	0
7	61804797	.	T	C	3	2	5	0	0	5	0	0
7	61921387	.	T	A	3	3	6	0	0	6	0	0
7	61950074	.	C	T	2	2	4	0	0	4	0	0
7	61953293	.	C	T	5	2	7	0	2	9	0	0
7	61953344	.	G	C	5	3	8	0	1	9	0	0
7	61954500	.	G	T	3	2	5	0	0	5	0	0
7	61959031	.	G	A	10	9	19	0	0	19	0	0
7	61961063	.	G	A	8	9	17	0	0	17	0	0
7	61961229	.	T	C	4	7	11	0	0	11	0	0
7	61961581	.	A	G	5	3	8	0	0	8	0	0
7	61962002	.	A	G	4	5	9	0	0	9	0	0
7	61962040	.	T	C	4	2	6	0	1	7	0	0
7	61962238	.	G	T	0	3	3	0	3	6	0	0
7	61962292	.	G	T	6	3	9	0	0	9	0	0
7	61977170	.	G	C	5	2	7	0	1	8	0	0
7	61977229	.	C	T	3	3	6	0	0	6	0	0
7	61977256	.	A	T	3	5	8	0	0	8	0	0
7	61977744	.	G	A	3	5	8	0	0	8	0	0
7	61977769	.	G	A	4	6	10	0	2	12	0	0
7	61982188	.	A	G	3	3	6	0	1	7	0	0
7	61989033	.	A	C	2	4	6	0	1	7	0	0
7	61995417	.	G	A	3	3	6	0	1	7	0	0
7	62000825	.	G	A	2	2	4	0	0	4	0	0
7	62004146	.	C	T	13	20	33	0	2	35	0	0
7	62009630	.	T	A	10	11	21	0	4	25	0	0
7	62009652	.	G	A	1	11	12	0	13	25	0	0
7	62009701	.	C	T	9	10	19	0	0	19	0	0
7	62205268	.	A	G	1	0	1	0	2	3	0	0
7	62248635	.	C	T	1	7	8	0	0	8	0	0
7	62248883	.	C	T	1	3	4	0	0	4	0	0
7	62248906	.	T	A	2	2	4	0	1	5	0	0
7	62260866	.	C	T	4	6	10	0	1	11	0	0
7	62261533	.	A	T	5	5	10	0	0	10	0	0
7	62261581	.	C	T	3	3	6	0	0	6	0	0
7	62268259	.	C	T	1	4	5	0	0	5	0	0
7	63325484	.	T	C	1	3	4	0	0	4	0	0
7	63325567	.	C	G	2	6	8	0	1	9	0	0
7	63326184	.	A	G	3	5	8	0	0	8	0	0
7	63326928	.	G	A	1	6	7	0	3	10	0	0
7	63327468	.	C	T	4	4	8	0	0	8	0	0
7	63327912	.	G	C	0	9	9	0	7	16	0	0
7	63328125	.	A	T	6	7	13	0	1	14	0	0
7	63328305	.	T	C	6	8	14	0	0	14	0	0
7	63328320	.	T	C	6	6	12	0	1	13	0	0
7	63328446	.	T	A	11	9	20	0	5	25	0	0
7	63328485	.	C	T	15	12	27	0	0	27	0	0
7	63328599	.	A	G	13	0	13	0	10	23	0	0
7	63328632	.	C	A	11	12	23	0	0	23	0	0
7	63328746	.	G	T	18	7	25	0	2	27	0	0
7	63328764	.	G	A	0	15	15	0	9	24	0	0
7	64740893	.	T	C	7	0	7	0	4	11	0	0
7	64741855	.	T	C	4	2	6	0	0	6	0	0
7	64963482	.	T	C	3	2	5	0	1	6	0	0
7	64978891	.	A	C	10	5	15	0	0	15	0	0
7	64980793	.	A	G	11	6	17	0	0	17	0	0
7	64980820	.	A	G	13	10	23	0	0	23	0	0
7	64988061	.	A	G	9	11	20	0	0	20	0	0
7	64988122	.	C	T	13	13	26	0	2	28	0	0
7	65011498	.	A	G	5	7	12	0	0	12	0	0
7	65011513	.	C	T	4	7	11	0	0	11	0	0
7	65019731	.	T	C	5	4	9	0	0	9	0	0
7	65019746	.	T	C	4	4	8	0	1	9	0	0
7	65024002	.	G	A	3	9	12	0	3	15	0	0
7	65024082	.	C	T	1	4	5	0	7	12	0	0
7	65035275	.	A	G	4	9	13	0	0	13	0	0
7	65035416	.	G	T	6	7	13	0	0	13	0	0
7	65035437	.	C	T	5	5	10	0	0	10	0	0
7	65039436	.	A	C	9	0	9	0	8	17	0	0
7	65049706	.	C	T	0	2	2	0	6	8	0	0
7	65093097	.	G	A	8	5	13	0	0	13	0	0
7	65104042	.	A	T	3	3	6	0	0	6	0	0
7	65104080	.	A	G	2	3	5	0	0	5	0	0
7	65105011	.	G	C	1	2	3	0	0	3	0	0
7	65105024	.	G	A	1	2	3	0	0	3	0	0
7	65105053	.	T	G	2	2	4	0	0	4	0	0
7	65105160	.	C	A	2	2	4	0	0	4	0	0
7	65132821	.	T	C	3	4	7	0	0	7	0	0
7	65132884	.	C	T	4	4	8	0	1	9	0	0
7	65140532	.	C	A	1	3	4	0	1	5	0	0
7	65140577	.	T	C	1	6	7	0	0	7	0	0
7	65140786	.	G	A	7	3	10	0	0	10	0	0
7	65144861	.	G	T	2	5	7	0	6	13	0	0
7	65148056	.	C	T	10	6	16	0	0	16	0	0
7	65152024	.	T	C	3	2	5	0	4	9	0	0
7	65152036	.	C	A	3	3	6	0	0	6	0	0
7	65152075	.	A	G	2	5	7	0	0	7	0	0
7	65169335	.	G	A	1	16	17	0	24	41	0	0
7	65169795	.	G	A	0	20	20	0	17	37	0	0
7	65173289	.	A	T	14	15	29	0	1	30	0	0
7	65177570	.	G	T	1	2	3	0	0	3	0	0
7	65297041	.	A	T	11	3	14	0	1	15	0	0
7	65306085	.	C	T	8	4	12	0	2	14	0	0
7	65306229	.	G	A	7	7	14	0	0	14	0	0
7	65306255	.	A	G	9	5	14	0	0	14	0	0
7	65306417	.	C	A	3	1	4	0	1	5	0	0
7	65333876	.	C	T	1	7	8	0	0	8	0	0
7	65371899	.	C	T	2	3	5	0	0	5	0	0
7	65433092	.	T	C	1	4	5	0	0	5	0	0
7	65434513	.	G	A	1	6	7	0	5	12	0	0
7	65440232	.	T	A	1	3	4	0	0	4	0	0
7	65440361	.	G	A	0	5	5	0	2	7	0	0
7	65443348	.	T	C	7	5	12	0	0	12	0	0
7	65443396	.	G	A	4	3	7	0	0	7	0	0
7	65445884	.	C	A	2	8	10	0	0	10	0	0
7	65451369	.	C	T	8	6	14	0	1	15	0	0
7	65452005	.	G	A	1	4	5	0	8	13	0	0
7	65452017	.	G	A	7	7	14	0	1	15	0	0
7	65453057	.	G	A	1	5	6	0	8	14	0	0
7	65453159	.	C	A	7	4	11	0	2	13	0	0
7	65457079	.	G	A	6	7	13	0	0	13	0	0
7	65457103	.	A	G	5	1	6	0	6	12	0	0
7	65461201	.	A	G	9	9	18	0	0	18	0	0
7	65461211	.	T	C	9	9	18	0	1	19	0	0
7	65463165	.	C	A	10	3	13	0	3	16	0	0
7	65463169	.	G	A	10	5	15	0	1	16	0	0
7	65463297	.	G	T	2	14	16	0	10	26	0	0
7	65464010	.	C	T	7	7	14	0	2	16	0	0
7	65464164	.	G	T	15	10	25	0	1	26	0	0
7	65464189	.	A	T	22	9	31	0	0	31	0	0
7	65473186	.	A	T	11	29	40	0	1	41	0	0
7	65473364	.	T	C	20	22	42	0	2	45	1	0
7	65473700	.	G	C	34	20	54	0	0	54	0	0
7	65473775	.	G	T	21	22	43	0	0	43	0	0
7	65473814	.	T	C	27	19	46	0	2	48	0	0
7	65473933	.	C	A	20	15	35	0	2	37	0	0
7	65473972	.	T	C	16	24	40	0	1	41	0	0
7	65474100	.	C	T	20	28	48	0	3	51	0	0
7	65474103	.	A	G	20	30	50	0	1	51	0	0
7	65475669	.	C	T	20	14	34	0	0	34	0	0
7	65475708	.	T	G	18	12	30	0	0	30	0	0
7	65488586	.	G	A	14	11	25	0	2	27	0	0
7	65491855	.	A	T	22	23	45	0	1	46	0	0
7	65922348	.	A	G	2	2	4	0	0	4	0	0
7	66069906	.	A	G	4	2	6	0	0	6	0	0
7	66105498	.	C	T	7	6	13	0	0	13	0	0
7	66105663	.	A	G	7	0	7	0	8	15	0	0
7	66105752	.	C	T	5	6	11	0	0	11	0	0
7	66105804	.	G	A	0	4	4	0	2	6	0	0
7	66112702	.	T	C	6	4	10	0	1	11	0	0
7	66126466	.	T	C	8	8	16	0	0	16	0	0
7	66133626	.	A	T	3	4	7	0	1	8	0	0
7	66259315	.	G	A	2	2	4	0	0	4	0	0
7	66259325	.	C	T	3	2	5	0	0	5	0	0
7	66259353	.	C	T	2	2	4	0	0	4	0	0
7	66259574	.	A	T	7	5	12	0	1	13	0	0
7	66276243	.	G	A	5	8	13	0	0	13	0	0
7	66361984	.	A	G	9	5	14	0	1	15	0	0
7	66368653	.	T	C	6	0	6	0	4	10	0	0
7	66452390	.	C	T	6	6	12	0	1	13	0	0
7	66452543	.	T	C	2	6	8	0	1	9	0	0
7	66634326	.	T	C	7	8	15	0	1	16	0	0
7	66639333	.	T	C	4	7	11	0	0	11	0	0
7	66642286	.	T	A	18	15	33	0	2	35	0	0
7	66646655	.	T	C	9	10	19	0	2	21	0	0
7	66653019	.	G	A	11	15	26	0	3	29	0	0
7	66653335	.	G	C	18	12	30	0	1	31	0	0
7	66653442	.	G	T	1	11	12	0	29	41	0	0
7	66653469	.	T	G	26	15	41	0	2	43	0	0
7	66653529	.	T	C	16	12	28	0	0	28	0	0
7	66653785	.	G	A	2	10	12	0	13	25	0	0
7	66653840	.	T	A	10	17	27	1	1	29	0	0
7	66653929	.	T	C	14	16	30	0	1	31	0	0
7	66653950	.	C	T	14	16	30	0	2	32	0	0
7	66655930	.	G	T	3	5	8	0	1	9	0	0
7	66655938	.	A	T	6	3	9	0	2	11	0	0
7	66656242	.	C	T	1	9	10	0	18	28	0	0
7	66660481	.	T	C	14	0	14	0	11	25	0	0
7	66664405	.	C	T	4	13	17	0	0	17	0	0
7	66670802	.	A	G	8	9	17	0	0	17	0	0
7	66670865	.	T	C	6	4	10	0	0	10	0	0
7	66676514	.	C	T	4	3	7	0	0	7	0	0
7	66676520	.	T	A	4	3	7	0	0	7	0	0
7	67152142	.	C	T	8	7	15	0	0	15	0	0
7	67157950	.	T	C	6	7	13	0	0	13	0	0
7	67161491	.	A	G	10	5	15	0	1	16	0	0
7	67165438	.	G	A	3	8	11	0	8	19	0	0
7	67170774	.	A	G	4	0	4	0	4	8	0	0
7	67170837	.	A	T	5	5	10	0	0	10	0	0
7	67171186	.	G	T	1	5	6	0	8	14	0	0
7	67220614	.	C	T	3	9	12	0	1	13	0	0
7	67227885	.	T	G	9	5	14	0	0	14	0	0
7	67239098	.	A	G	3	11	14	0	0	14	0	0
7	67241045	.	T	C	3	9	12	0	0	12	0	0
7	67247101	.	A	C	4	0	4	0	7	11	0	0
7	67248773	.	A	G	3	5	8	0	0	8	0	0
7	67251967	.	G	C	1	9	10	0	0	10	0	0
7	67251973	.	T	A	1	8	9	0	1	10	0	0
7	67252044	.	A	C	2	14	16	0	0	16	0	0
7	67310028	.	G	T	2	4	6	0	0	6	0	0
7	67310030	.	T	A	2	4	6	0	0	6	0	0
7	67310144	.	G	T	8	6	14	0	2	16	0	0
7	67310147	.	T	C	10	0	10	0	7	17	0	0
7	67310200	.	T	G	16	13	29	0	2	31	0	0
7	67310269	.	G	A	13	14	27	0	1	28	0	0
7	67310429	.	A	T	11	10	21	0	3	24	0	0
7	67310507	.	T	C	20	24	44	0	3	47	0	0
7	67310690	.	A	G	18	24	42	0	0	42	0	0
7	67314142	.	A	G	6	9	15	0	0	15	0	0
7	67315481	.	G	T	13	9	22	0	1	23	0	0
7	67432668	.	A	G	2	8	10	0	0	10	0	0
7	67435587	.	T	C	16	14	30	0	1	31	0	0
7	67436273	.	C	T	12	14	26	0	0	26	0	0
7	67439428	.	A	C	14	12	26	0	0	26	0	0
7	67444837	.	G	A	21	15	36	0	1	37	0	0
7	67446295	.	C	T	24	16	40	0	1	41	0	0
7	67448338	.	T	C	18	15	33	0	0	33	0	0
7	67448363	.	A	T	15	10	25	0	0	25	0	0
7	67448373	.	T	A	14	9	23	0	3	26	0	0
7	67471561	.	C	T	37	31	68	0	5	73	0	0
7	67476197	.	A	T	1	2	3	0	0	3	0	0
7	67545636	.	C	T	1	2	3	0	0	3	0	0
7	67555434	.	G	A	0	3	3	0	2	5	0	0
7	67594467	.	T	C	1	5	6	0	0	6	0	0
7	67743603	.	T	A	6	3	9	0	0	10	1	0
7	67743604	.	G	T	6	3	9	0	1	10	0	0
7	67743646	.	A	G	4	2	6	0	0	6	0	0
7	67743878	.	T	C	4	5	9	0	1	10	0	0
7	67743902	.	A	G	8	3	11	3	1	15	0	0
7	67747404	.	T	A	7	8	15	0	1	16	0	0
7	67747819	.	T	C	12	11	23	0	0	23	0	0
7	67747826	.	T	G	11	8	19	0	1	20	0	0
7	67747915	.	G	A	6	4	10	0	0	10	0	0
7	67747916	.	A	T	6	4	10	0	0	10	0	0
7	67751133	.	C	T	2	2	4	0	0	4	0	0
7	67751286	.	A	G	2	0	2	0	5	7	0	0
7	67751430	.	C	T	2	5	7	0	1	8	0	0
7	67752263	.	T	C	1	3	4	0	1	5	0	0
7	67752290	.	G	A	1	4	5	0	0	5	0	0
7	67759936	.	C	T	3	5	8	0	0	8	0	0
7	67760437	.	G	C	0	4	4	0	2	6	0	0
7	67770477	.	T	G	3	3	6	0	0	6	0	0
7	67776588	.	C	T	2	4	6	0	0	6	0	0
7	67794598	.	T	G	1	2	3	0	0	3	0	0
7	67795367	.	T	C	5	4	9	0	2	11	0	0
7	67795386	.	A	G	10	7	17	0	1	18	0	0
7	67795429	.	G	A	11	9	20	0	0	20	0	0
7	67795576	.	C	T	3	2	5	4	1	10	0	0
7	67795633	.	G	A	3	3	6	0	0	6	0	0
7	67796356	.	G	A	3	2	5	1	0	6	0	0
7	67796413	.	C	A	3	3	6	0	0	6	0	0
7	67796437	.	G	T	5	5	10	0	0	10	0	0
7	67796494	.	G	A	2	7	9	0	12	21	0	0
7	67797037	.	C	G	9	4	13	0	0	13	0	0
7	67797087	.	G	T	6	10	16	0	0	16	0	0
7	67797097	.	C	T	5	9	14	0	0	14	0	0
7	67817399	.	C	T	4	7	11	0	0	11	0	0
7	67830051	.	C	T	0	6	6	0	4	10	0	0
7	67833051	.	G	A	3	7	10	0	2	12	0	0
7	67835264	.	A	G	4	5	9	0	0	9	0	0
7	67835269	.	A	C	4	3	7	0	1	8	0	0
7	67842641	.	G	T	2	7	9	0	0	9	0	0
7	67846087	.	T	C	6	5	11	0	0	11	0	0
7	67870323	.	A	G	4	3	7	0	0	7	0	0
7	67876771	.	C	T	0	3	3	0	3	6	0	0
7	67876820	.	T	G	3	4	7	0	1	8	0	0
7	67876822	.	C	T	5	4	9	0	0	9	0	0
7	67876880	.	T	A	6	7	13	1	1	15	0	0
7	67876881	.	G	A	6	7	13	1	1	15	0	0
7	67888194	.	T	C	1	2	3	0	0	3	0	0
7	67893985	.	G	C	4	4	8	0	0	8	0	0
7	67916385	.	A	G	1	4	5	0	0	5	0	0
7	67916456	.	C	A	2	4	6	0	0	6	0	0
7	68215451	.	A	T	17	20	37	1	5	43	0	0
7	68215990	.	T	G	12	27	39	0	0	39	0	0
7	68216504	.	C	A	0	11	11	0	9	20	0	0
7	68216781	.	G	C	4	2	6	0	1	7	0	0
7	68217387	.	G	A	13	12	25	0	2	27	0	0
7	68328858	.	T	G	1	2	3	0	0	3	0	0
7	68328861	.	A	G	1	2	3	0	0	3	0	0
7	68329037	.	C	T	1	2	3	0	0	3	0	0
7	68540716	.	T	A	7	6	13	0	0	13	0	0
7	68542234	.	G	A	1	1	2	0	1	3	0	0
7	68542421	.	T	A	7	4	11	0	0	11	0	0
7	68542538	.	C	T	2	5	7	0	0	7	0	0
7	69144036	.	T	C	2	8	10	0	0	10	0	0
7	69144037	.	T	C	1	9	10	0	0	10	0	0
7	69145516	.	T	C	10	5	15	0	0	15	0	0
7	69145672	.	T	C	7	0	7	0	3	10	0	0
7	69146362	.	T	C	2	5	7	0	0	7	0	0
7	69146417	.	T	C	3	0	3	0	4	7	0	0
7	69437422	.	A	C	2	4	6	0	0	6	0	0
7	69437472	.	T	C	2	3	5	0	0	5	0	0
7	69437495	.	C	A	3	3	6	0	0	6	0	0
7	69439094	.	T	A	1	2	3	0	1	4	0	0
7	69442261	.	T	G	4	2	6	0	0	6	0	0
7	69442374	.	C	T	6	3	9	0	0	10	1	0
7	69447324	.	G	A	5	4	9	0	0	9	0	0
7	69447352	.	T	C	7	8	15	0	1	16	0	0
7	69447469	.	C	G	4	7	11	0	0	11	0	0
7	69447516	.	A	G	5	6	11	0	0	11	0	0
7	69447520	.	G	A	6	6	12	0	0	12	0	0
7	69458667	.	A	G	1	0	1	0	4	5	0	0
7	69458673	.	T	C	2	3	5	0	0	5	0	0
7	69467145	.	A	G	3	3	6	0	0	6	0	0
7	69467267	.	A	G	5	4	9	0	0	9	0	0
7	69477283	.	T	G	30	27	57	2	1	62	2	0
7	69477303	.	A	G	16	1	17	0	43	60	0	0
7	69477361	.	T	C	23	35	58	0	2	60	0	0
7	69477437	.	A	G	23	31	54	0	1	55	0	0
7	69477464	.	T	C	22	24	46	0	5	51	0	0
7	69484697	.	A	G	1	0	1	0	3	4	0	0
7	69492100	.	T	C	1	3	4	0	0	4	0	0
7	69496521	.	C	A	12	9	21	0	2	23	0	0
7	69496537	.	A	T	9	8	17	0	3	20	0	0
7	69496572	.	A	G	8	15	23	0	0	23	0	0
7	69497048	.	A	T	16	12	28	0	0	28	0	0
7	69497493	.	G	T	14	20	34	0	1	35	0	0
7	69497637	.	G	A	25	18	43	0	1	44	0	0
7	69501040	.	A	G	20	18	38	0	1	39	0	0
7	69501148	.	A	G	10	13	23	0	1	24	0	0
7	69501300	.	A	G	10	13	23	0	0	23	0	0
7	69501345	.	G	T	13	12	25	0	1	26	0	0
7	69518021	.	T	A	6	7	13	0	1	14	0	0
7	69518077	.	T	A	7	5	12	0	1	13	0	0
7	69521129	.	A	T	8	3	11	0	0	11	0	0
7	69540248	.	G	A	3	2	5	0	0	5	0	0
7	69540312	.	T	C	4	4	8	0	0	8	0	0
7	69566119	.	A	G	12	6	18	0	0	18	0	0
7	69566179	.	A	T	6	5	11	0	0	11	0	0
7	69566908	.	G	A	1	6	7	0	8	15	0	0
7	69576031	.	G	A	7	10	17	0	1	18	0	0
7	69918119	.	A	G	1	2	3	0	0	3	0	0
7	69943002	.	C	T	5	3	8	0	0	8	0	0
7	69950304	.	A	G	5	3	8	0	0	8	0	0
7	69950354	.	A	C	4	2	6	0	0	6	0	0
7	69950365	.	A	T	4	3	7	0	0	7	0	0
7	69950785	.	G	C	0	2	2	0	2	4	0	0
7	69959980	.	G	A	3	5	8	0	0	8	0	0
7	69962366	.	C	T	2	6	8	0	1	9	0	0
7	70267378	.	G	A	2	3	5	0	0	5	0	0
7	70267390	.	A	G	1	4	5	0	0	5	0	0
7	70267426	.	T	C	2	4	6	0	0	6	0	0
7	70267453	.	A	G	3	3	6	0	0	6	0	0
7	70267680	.	T	C	5	3	8	0	0	8	0	0
7	70267905	.	C	T	3	2	5	0	0	5	0	0
7	70601377	.	C	T	3	3	6	0	1	7	0	0
7	70611159	.	C	T	4	2	6	0	2	8	0	0
7	70611567	.	T	C	5	5	10	0	1	11	0	0
7	70611606	.	G	A	3	5	8	0	1	9	0	0
7	70611741	.	C	T	0	2	2	0	3	5	0	0
7	70619207	.	C	A	1	4	5	0	4	9	0	0
7	70619253	.	G	A	3	6	9	0	0	9	0	0
7	71433944	.	C	T	1	3	4	0	0	4	0	0
7	72028742	.	A	G	31	8	39	0	4	43	0	0
7	72032812	.	T	C	21	0	21	0	8	29	0	0
7	72034823	.	T	A	9	3	12	0	2	14	0	0
7	73617717	.	A	G	11	6	17	0	0	17	0	0
7	73617726	.	A	G	13	4	17	0	0	17	0	0
7	73617817	.	A	G	14	5	19	0	0	19	0	0
7	73617880	.	A	G	3	8	11	0	2	13	0	0
7	73618841	.	A	G	2	5	7	0	0	7	0	0
7	73618855	.	A	G	7	0	7	0	2	9	0	0
7	74135779	.	G	T	12	4	16	0	3	19	0	0
8	41751	.	G	C	15	12	27	0	0	27	0	0
8	41754	.	C	T	15	12	27	0	1	28	0	0
8	41925	.	T	C	15	1	16	0	22	38	0	0
8	41948	.	A	G	15	22	37	0	0	37	0	0
8	43740	.	T	C	12	0	12	0	17	29	0	0
8	43800	.	A	G	13	21	34	0	0	34	0	0
8	44337	.	G	A	5	19	24	0	3	27	0	0
8	52280	.	C	T	8	16	24	0	1	25	0	0
8	56225	.	T	G	6	9	15	0	0	15	0	0
8	56285	.	A	G	8	8	16	0	1	17	0	0
8	56884	.	C	T	8	7	15	0	1	16	0	0
8	57732	.	C	T	1	11	12	0	13	25	0	0
8	58399	.	C	G	5	6	11	0	1	12	0	0
8	61833	.	G	A	4	14	18	0	0	18	0	0
8	75188	.	C	A	3	6	9	0	0	9	0	0
8	75446	.	G	T	0	3	3	0	8	11	0	0
8	75646	.	G	C	1	4	5	0	6	11	0	0
8	81536	.	A	G	5	0	5	0	7	12	0	0
8	109321	.	G	A	0	3	3	0	5	8	0	0
8	109375	.	C	A	2	3	5	0	0	5	0	0
8	109378	.	T	C	2	3	5	0	0	5	0	0
8	109489	.	T	C	4	6	10	0	0	10	0	0
8	115080	.	T	C	2	5	7	0	1	8	0	0
8	118378	.	T	C	6	4	10	0	0	10	0	0
8	120282	.	G	A	6	5	11	0	0	11	0	0
8	120839	.	G	A	0	11	11	0	6	17	0	0
8	121145	.	A	C	5	2	7	0	0	7	0	0
8	121149	.	A	C	5	2	7	0	0	7	0	0
8	158431	.	C	T	8	4	12	0	1	13	0	0
8	173841	.	A	G	17	9	26	0	1	27	0	0
8	261498	.	T	C	3	5	8	0	0	8	0	0
8	262012	.	C	T	7	4	11	0	0	11	0	0
8	262054	.	C	A	1	2	3	0	1	4	0	0
8	262858	.	G	T	0	5	5	0	2	7	0	0
8	268215	.	G	A	4	8	12	0	0	12	0	0
8	276277	.	C	T	1	7	8	1	0	9	0	0
8	286192	.	A	G	10	10	20	0	3	23	0	0
8	286251	.	C	T	16	11	27	0	0	27	0	0
8	286302	.	G	A	13	14	27	0	0	27	0	0
8	387853	.	A	T	8	3	11	0	0	11	0	0
8	388020	.	G	C	3	6	9	0	0	9	0	0
8	388885	.	C	T	13	14	27	0	1	28	0	0
8	389114	.	T	A	10	16	26	0	0	26	0	0
8	391712	.	T	C	10	2	12	2	0	14	0	0
8	391715	.	T	C	9	3	12	2	0	14	0	0
8	391988	.	C	A	4	12	16	0	0	16	0	0
8	392047	.	G	T	5	6	11	1	4	16	0	0
8	395281	.	C	A	0	5	5	0	8	13	0	0
8	395287	.	C	T	8	5	13	0	0	13	0	0
8	397341	.	C	T	1	13	14	0	12	26	0	0
8	400185	.	C	G	11	8	19	0	0	19	0	0
8	412303	.	G	A	8	6	14	0	2	16	0	0
8	412504	.	T	C	13	0	13	0	16	29	0	0
8	423533	.	T	C	8	7	15	0	0	15	0	0
8	423723	.	C	T	12	10	22	0	3	25	0	0
8	423815	.	C	A	17	12	29	0	0	29	0	0
8	424123	.	G	A	8	18	26	0	1	27	0	0
8	424969	.	G	A	9	7	16	0	0	16	0	0
8	471390	.	A	C	7	2	9	0	0	9	0	0
8	478707	.	C	T	4	4	8	0	0	8	0	0
8	478844	.	T	C	3	4	7	0	0	7	0	0
8	478889	.	G	T	5	5	10	0	0	10	0	0
8	481970	.	C	T	7	6	13	0	1	14	0	0
8	481976	.	G	C	7	8	15	0	0	15	0	0
8	482033	.	A	G	7	3	10	0	0	10	0	0
8	487208	.	G	A	7	4	11	0	1	12	0	0
8	487241	.	T	C	8	6	14	0	0	14	0	0
8	489194	.	T	A	4	6	10	0	0	10	0	0
8	540214	.	G	A	0	16	16	0	10	26	0	0
8	541376	.	C	A	19	21	40	0	0	40	0	0
8	595166	.	C	T	1	5	6	0	4	10	0	0
8	657489	.	G	A	0	3	3	0	1	4	0	0
8	657645	.	A	G	2	2	4	0	0	4	0	0
8	660467	.	T	C	8	4	12	0	1	13	0	0
8	926772	.	G	A	4	2	6	0	0	6	0	0
8	926779	.	C	T	0	2	2	0	4	6	0	0
8	927337	.	G	A	11	16	27	0	1	28	0	0
8	1094910	.	T	A	10	8	18	0	0	18	0	0
8	1094973	.	G	T	1	6	7	0	8	15	0	0
8	1100463	.	C	T	20	6	26	0	1	27	0	0
8	1102404	.	T	C	12	11	23	0	2	25	0	0
8	1102533	.	G	T	10	18	28	0	1	29	0	0
8	1102551	.	C	T	11	13	24	0	3	27	0	0
8	1129838	.	T	C	1	5	6	0	0	6	0	0
8	1130331	.	C	T	5	6	11	0	0	11	0	0
8	1130450	.	C	G	7	0	7	0	5	12	0	0
8	1130526	.	C	A	7	4	11	0	0	11	0	0
8	1130544	.	T	C	3	7	10	0	0	10	0	0
8	1130574	.	G	A	5	2	7	0	1	8	0	0
8	1130590	.	A	T	7	4	11	0	0	11	0	0
8	1133753	.	C	G	7	7	14	0	0	14	0	0
8	1151416	.	T	C	9	11	20	0	0	20	0	0
8	1222417	.	T	C	5	1	6	0	13	19	0	0
8	1222504	.	T	C	16	0	16	1	16	33	0	0
8	1255292	.	C	G	4	13	17	0	15	32	0	0
8	1255304	.	G	A	19	10	29	0	0	29	0	0
8	1259023	.	G	A	18	18	36	0	1	37	0	0
8	1264645	.	A	G	4	12	16	0	1	17	0	0
8	1265705	.	T	G	14	8	22	1	0	23	0	0
8	1267074	.	T	A	11	9	20	0	2	22	0	0
8	1267153	.	G	A	11	11	22	0	1	23	0	0
8	1267157	.	G	A	11	12	23	0	0	23	0	0
8	1267233	.	G	T	3	3	6	0	0	6	0	0
8	1270193	.	C	T	1	2	3	0	0	3	0	0
8	1270205	.	C	T	1	2	3	0	0	3	0	0
8	1291986	.	C	T	1	5	6	0	0	6	0	0
8	1291993	.	G	A	0	3	3	0	2	5	0	0
8	1852078	.	A	G	3	2	5	0	0	5	0	0
8	1852138	.	A	G	2	3	5	0	0	5	0	0
8	1852274	.	A	G	4	4	8	0	0	8	0	0
8	1853004	.	A	G	4	2	6	0	1	7	0	0
8	1853406	.	A	G	6	3	9	0	2	11	0	0
8	1853474	.	A	G	4	8	12	0	0	12	0	0
8	1855256	.	A	G	12	4	16	0	0	16	0	0
8	1855312	.	A	G	12	4	16	0	0	16	0	0
8	1856174	.	A	G	2	15	17	0	0	17	0	0
8	1856185	.	A	G	6	15	21	0	1	22	0	0
8	2219604	.	G	A	1	3	4	0	0	4	0	0
8	3085466	.	C	A	1	3	4	0	0	4	0	0
8	3099585	.	G	A	1	11	12	0	9	21	0	0
8	3101241	.	G	T	5	4	9	0	1	10	0	0
8	3101277	.	T	C	8	8	16	0	0	16	0	0
8	3426764	.	C	T	1	2	3	0	0	3	0	0
8	3438873	.	C	T	2	2	4	0	0	4	0	0
8	3537152	.	G	A	0	3	3	0	2	5	0	0
8	3539482	.	C	T	3	2	5	0	0	5	0	0
8	3545108	.	G	A	1	4	5	0	0	5	0	0
8	3566172	.	A	T	1	1	2	0	0	2	0	0
8	3566190	.	C	T	3	3	6	0	0	6	0	0
8	3568037	.	C	T	1	3	4	0	0	4	0	0
8	3569907	.	C	T	2	3	5	0	0	5	0	0
8	3589375	.	T	G	1	4	5	0	0	5	0	0
8	3591211	.	C	A	1	2	3	0	0	3	0	0
8	3594308	.	A	G	5	0	5	0	5	10	0	0
8	3595161	.	G	A	0	3	3	0	12	15	0	0
8	3595359	.	C	T	6	7	13	0	1	14	0	0
8	3597233	.	T	C	6	4	10	0	0	10	0	0
8	3602715	.	T	A	3	6	9	0	0	9	0	0
8	3605050	.	A	G	1	0	1	0	4	5	0	0
8	3612263	.	T	A	6	9	15	0	3	18	0	0
8	3612308	.	A	T	7	9	16	0	4	20	0	0
8	3624208	.	G	C	16	13	29	0	0	29	0	0
8	3628683	.	C	T	10	13	23	0	0	23	0	0
8	3628747	.	C	A	5	9	14	0	1	15	0	0
8	3628758	.	T	A	6	8	14	0	0	14	0	0
8	3628782	.	G	A	1	15	16	0	4	20	0	0
8	3631371	.	T	C	12	5	17	0	1	18	0	0
8	3631932	.	C	T	27	12	39	0	1	40	0	0
8	3641218	.	G	C	15	25	40	0	2	42	0	0
8	3643299	.	T	C	26	18	44	1	2	47	0	0
8	3659979	.	T	C	5	4	9	0	1	10	0	0
8	3660034	.	C	T	7	5	12	0	0	12	0	0
8	3674510	.	C	T	1	2	3	0	0	3	0	0
8	3691113	.	T	C	1	0	1	0	2	3	0	0
8	3859383	.	T	A	3	4	7	0	0	7	0	0
8	3865233	.	T	C	6	2	8	0	0	8	0	0
8	3883831	.	C	G	5	9	14	0	2	16	0	0
8	3886220	.	T	C	2	9	11	0	0	11	0	0
8	3889662	.	G	A	1	6	7	0	7	14	0	0
8	3890837	.	T	C	7	7	14	0	1	15	0	0
8	3904963	.	C	T	10	8	18	0	0	18	0	0
8	3915909	.	G	A	12	9	21	0	3	24	0	0
8	3923371	.	C	T	15	10	25	0	1	26	0	0
8	3932974	.	A	G	3	5	8	0	0	8	0	0
8	3932990	.	A	G	4	7	11	0	0	11	0	0
8	3933498	.	T	A	12	12	24	0	1	25	0	0
8	3949558	.	G	T	4	3	7	0	0	7	0	0
8	3950039	.	C	G	6	5	11	0	0	11	0	0
8	3950270	.	A	T	7	2	9	0	0	9	0	0
8	3950317	.	G	A	2	3	5	0	0	5	0	0
8	3950529	.	C	T	2	3	5	0	0	5	0	0
8	3950554	.	C	T	1	3	4	0	0	4	0	0
8	3950655	.	C	T	2	3	5	0	0	5	0	0
8	3952495	.	G	T	3	2	5	0	0	5	0	0
8	3960992	.	G	A	3	6	9	0	0	9	0	0
8	3974903	.	G	A	1	3	4	0	0	4	0	0
8	4044846	.	G	A	7	4	11	0	0	11	0	0
8	4368586	.	T	G	3	3	6	0	0	6	0	0
8	4368847	.	T	A	1	2	3	0	0	3	0	0
8	4368848	.	C	G	1	2	3	0	0	3	0	0
8	4369021	.	A	C	4	5	9	0	1	10	0	0
8	4381510	.	A	G	7	1	8	0	8	16	0	0
8	4381624	.	G	A	2	2	4	0	0	4	0	0
8	4386198	.	A	G	4	5	9	0	0	9	0	0
8	4393910	.	C	G	4	7	11	0	0	11	0	0
8	4398425	.	A	T	8	7	15	0	1	16	0	0
8	4398531	.	T	C	4	2	6	0	3	9	0	0
8	4398737	.	C	T	11	5	16	0	0	16	0	0
8	4398762	.	A	G	10	12	22	0	0	22	0	0
8	4398981	.	G	A	2	10	12	0	8	20	0	0
8	4399366	.	G	A	1	2	3	0	5	8	0	0
8	4399394	.	C	G	4	3	7	0	1	8	0	0
8	4399674	.	A	G	9	0	9	0	3	12	0	0
8	4399754	.	T	A	2	3	5	0	0	5	0	0
8	4400699	.	C	A	8	6	14	0	1	15	0	0
8	4400861	.	T	C	9	8	17	0	0	17	0	0
8	4400872	.	G	A	1	7	8	0	9	17	0	0
8	4401053	.	T	G	10	9	19	0	0	19	0	0
8	4401068	.	C	T	7	9	16	0	0	16	0	0
8	4401374	.	G	A	2	3	5	0	6	11	0	0
8	4401514	.	A	T	6	8	14	0	1	15	0	0
8	4401687	.	G	A	16	20	36	0	0	36	0	0
8	4401708	.	C	T	16	16	32	0	1	33	0	0
8	4401813	.	G	T	15	24	39	0	2	41	0	0
8	4401913	.	T	G	5	8	13	0	0	13	0	0
8	4401931	.	T	C	7	5	12	0	0	12	0	0
8	4436224	.	A	G	2	3	5	0	0	5	0	0
8	4436241	.	G	C	1	2	3	0	1	4	0	0
8	4440705	.	A	C	2	6	8	0	1	9	0	0
8	4440720	.	T	C	2	5	7	0	0	7	0	0
8	4442655	.	G	A	0	3	3	0	1	4	0	0
8	4444201	.	A	G	1	3	4	0	1	5	0	0
8	4446247	.	A	C	5	2	7	0	2	9	0	0
8	4446266	.	C	T	2	4	6	0	3	9	0	0
8	4446303	.	T	C	4	3	7	0	1	8	0	0
8	4446407	.	T	C	5	1	6	0	4	10	0	0
8	4455801	.	A	G	2	2	4	0	0	4	0	0
8	4461859	.	A	G	1	2	3	0	0	3	0	0
8	4516962	.	G	A	4	5	9	1	0	10	0	0
8	4519161	.	C	T	1	1	2	0	1	3	0	0
8	4522035	.	T	A	2	2	4	0	0	5	1	0
8	4525126	.	C	T	2	2	4	0	0	4	0	0
8	4530599	.	A	G	2	2	4	0	0	4	0	0
8	4530611	.	A	G	2	2	4	0	1	5	0	0
8	4530635	.	C	A	4	5	9	0	0	9	0	0
8	4530647	.	G	A	3	5	8	0	0	8	0	0
8	4531903	.	C	A	1	2	3	0	0	3	0	0
8	4538760	.	A	T	2	2	4	0	0	4	0	0
8	4538766	.	C	T	1	2	3	0	0	3	0	0
8	4556863	.	A	T	5	2	7	0	0	7	0	0
8	4576656	.	A	G	4	2	6	0	0	6	0	0
8	4589148	.	A	G	22	23	45	0	0	45	0	0
8	4589169	.	T	G	25	25	50	0	1	51	0	0
8	4589216	.	A	T	22	19	41	0	2	43	0	0
8	4589402	.	C	T	31	27	58	0	3	61	0	0
8	4596649	.	T	A	27	22	49	0	5	54	0	0
8	4609822	.	T	C	31	0	31	0	16	47	0	0
8	4618536	.	G	A	19	15	34	0	1	35	0	0
8	4618562	.	C	T	1	8	9	0	10	19	0	0
8	4621454	.	A	G	3	5	8	0	0	8	0	0
8	4621614	.	A	T	4	3	7	0	0	7	0	0
8	4621626	.	A	G	5	2	7	0	0	7	0	0
8	4621742	.	A	G	3	2	5	0	0	5	0	0
8	4621744	.	C	T	3	2	5	0	0	5	0	0
8	4622023	.	T	A	7	2	9	0	0	9	0	0
8	4622032	.	A	G	7	2	9	0	0	9	0	0
8	4698518	.	G	A	2	5	7	0	1	8	0	0
8	4699317	.	A	T	1	1	2	0	1	3	0	0
8	4762881	.	G	A	3	7	10	0	3	13	0	0
8	4771987	.	C	T	13	13	26	0	1	27	0	0
8	4776243	.	A	T	15	13	28	0	1	29	0	0
8	4780127	.	A	T	6	2	8	0	0	8	0	0
8	4780552	.	C	T	0	9	9	0	13	22	0	0
8	4780586	.	G	A	7	11	18	0	1	19	0	0
8	4788763	.	A	G	7	5	12	0	0	12	0	0
8	4788942	.	T	C	7	0	7	0	16	23	0	0
8	4798747	.	A	G	4	2	6	0	0	6	0	0
8	4799594	.	T	G	2	0	2	12	3	17	0	0
8	4800185	.	C	T	4	2	6	6	1	13	0	0
8	4800401	.	C	T	1	1	2	1	0	3	0	0
8	4800407	.	C	T	1	2	3	1	0	4	0	0
8	4964521	.	G	A	10	12	22	0	1	23	0	0
8	4972812	.	C	T	7	11	18	0	0	18	0	0
8	5845891	.	T	C	2	3	5	0	0	5	0	0
8	5845957	.	T	C	1	4	5	0	0	5	0	0
8	6415248	.	G	A	1	2	3	0	0	3	0	0
8	6415959	.	T	C	2	2	4	0	0	4	0	0
8	6863678	.	A	G	12	1	13	0	15	28	0	0
8	6863822	.	G	A	11	14	25	0	0	25	0	0
8	6864062	.	C	G	15	10	25	0	0	25	0	0
8	6864077	.	T	C	14	11	25	0	1	26	0	0
8	6864416	.	C	A	6	17	23	0	1	24	0	0
8	6865247	.	T	A	25	22	47	0	1	48	0	0
8	6865357	.	C	T	24	22	46	0	0	46	0	0
8	6865542	.	C	T	17	22	39	0	2	41	0	0
8	6865834	.	A	G	29	16	45	0	1	46	0	0
8	6866083	.	G	A	24	23	47	0	1	48	0	0
8	6866592	.	G	T	29	19	48	0	0	48	0	0
8	6866835	.	T	G	10	7	17	0	1	18	0	0
8	6874937	.	C	T	9	14	23	0	1	24	0	0
8	6874968	.	A	G	10	17	27	0	1	28	0	0
8	6875061	.	G	T	14	15	29	0	0	29	0	0
8	6875300	.	C	T	20	20	40	0	2	42	0	0
8	6875354	.	T	C	12	11	23	0	1	24	0	0
8	6875562	.	C	T	10	9	19	0	1	20	0	0
8	6875563	.	C	T	10	10	20	0	0	20	0	0
8	6875722	.	A	G	18	11	29	0	3	32	0	0
8	6876297	.	T	C	9	11	20	0	1	21	0	0
8	6876381	.	A	G	13	11	24	0	0	24	0	0
8	6876705	.	A	C	12	13	25	0	1	26	0	0
8	6876941	.	G	T	18	7	25	0	0	25	0	0
8	6876999	.	T	C	19	7	26	0	1	27	0	0
8	6877130	.	T	G	7	4	11	0	0	11	0	0
8	6877248	.	T	C	4	0	4	0	5	9	0	0
8	6877268	.	T	C	6	5	11	0	0	11	0	0
8	6877375	.	A	G	2	2	4	0	0	4	0	0
8	6903595	.	G	C	2	0	2	0	3	5	0	0
8	6903650	.	A	G	5	6	11	0	0	11	0	0
8	6904092	.	C	T	2	2	4	0	0	4	0	0
8	6913809	.	T	C	4	0	4	0	4	8	0	0
8	6920909	.	A	G	6	4	10	0	2	12	0	0
8	6921117	.	C	G	2	22	24	1	28	53	0	0
8	6921344	.	A	C	18	21	39	0	1	40	0	0
8	6921421	.	T	A	17	15	32	0	0	33	1	0
8	6921581	.	A	C	19	34	53	0	0	53	0	0
8	6921671	.	G	A	18	29	47	0	1	48	0	0
8	6927428	.	T	C	20	24	44	0	0	44	0	0
8	6935642	.	A	T	15	13	28	0	6	34	0	0
8	6943167	.	A	T	3	9	12	0	0	12	0	0
8	6970040	.	G	A	6	8	14	0	1	15	0	0
8	6985008	.	A	G	8	5	13	0	0	13	0	0
8	7014341	.	A	G	6	7	13	0	1	14	0	0
8	7018017	.	G	A	9	9	18	0	0	18	0	0
8	7022216	.	T	A	6	9	15	0	0	15	0	0
8	7022227	.	A	G	5	12	17	0	0	17	0	0
8	7022305	.	C	T	14	6	20	0	1	21	0	0
8	7052445	.	A	G	1	2	3	0	1	4	0	0
8	7052461	.	G	A	1	2	3	0	0	3	0	0
8	7108624	.	C	T	4	6	10	0	0	10	0	0
8	7114497	.	T	C	7	5	12	0	0	12	0	0
8	7118497	.	T	C	6	9	15	1	1	17	0	0
8	7118520	.	T	G	7	1	8	0	7	15	0	0
8	7118809	.	G	A	9	6	15	0	0	15	0	0
8	7119013	.	G	A	0	8	8	0	6	14	0	0
8	7119189	.	A	G	1	3	4	0	0	4	0	0
8	7119203	.	T	C	1	1	2	0	0	2	0	0
8	7119718	.	C	G	3	0	3	0	7	10	0	0
8	7120014	.	C	A	6	3	9	0	0	9	0	0
8	7120395	.	G	A	0	2	2	0	3	5	0	0
8	7120498	.	A	G	7	4	11	0	0	11	0	0
8	7120546	.	A	G	10	4	14	0	0	14	0	0
8	7120572	.	C	G	9	3	12	0	0	12	0	0
8	7120604	.	T	C	12	3	15	0	1	16	0	0
8	7120873	.	G	A	5	3	8	0	1	9	0	0
8	7120876	.	A	G	3	6	9	0	0	9	0	0
8	7121011	.	T	A	16	5	21	0	0	21	0	0
8	7121067	.	G	A	6	3	9	0	0	9	0	0
8	7121347	.	A	T	3	4	7	0	0	7	0	0
8	7121868	.	C	T	9	5	14	0	0	14	0	0
8	7121877	.	A	G	8	5	13	0	0	13	0	0
8	7122010	.	T	G	1	5	6	0	1	7	0	0
8	7122171	.	A	T	5	3	8	0	0	8	0	0
8	7122186	.	T	C	4	2	6	0	0	6	0	0
8	7122248	.	C	A	5	2	7	0	0	7	0	0
8	7122369	.	T	C	5	4	9	0	0	9	0	0
8	7122396	.	C	A	8	4	12	0	2	14	0	0
8	7122459	.	A	G	13	2	15	0	1	16	0	0
8	7122460	.	A	T	14	2	16	0	0	16	0	0
8	7122592	.	G	A	0	2	2	0	1	3	0	0
8	7122931	.	G	A	1	8	9	0	12	21	0	0
8	7123171	.	G	C	2	14	16	0	14	30	0	0
8	7123233	.	A	T	17	15	32	0	1	33	0	0
8	7123257	.	T	C	11	12	23	0	5	28	0	0
8	7123323	.	C	A	11	6	17	0	1	18	0	0
8	7123326	.	A	G	10	7	17	0	1	18	0	0
8	7123360	.	A	T	9	8	17	0	0	17	0	0
8	7123414	.	G	A	0	8	8	0	7	15	0	0
8	7123415	.	G	C	6	9	15	0	0	15	0	0
8	7123452	.	G	A	12	10	22	0	1	23	0	0
8	7123472	.	A	G	12	12	24	0	2	26	0	0
8	7123491	.	T	C	14	14	28	0	1	29	0	0
8	7123538	.	G	A	17	8	25	0	0	25	0	0
8	7742196	.	C	T	6	6	12	0	1	13	0	0
8	7745898	.	G	A	8	2	10	0	1	11	0	0
8	7745907	.	T	C	6	4	10	0	0	10	0	0
8	7746030	.	C	T	4	11	15	0	0	15	0	0
8	7747613	.	A	G	8	0	8	0	8	16	0	0
8	7747616	.	C	T	8	7	15	0	0	15	0	0
8	7754289	.	C	T	5	5	10	0	0	10	0	0
8	7765230	.	G	A	0	10	10	0	10	20	0	0
8	7772097	.	C	T	10	12	22	0	0	22	0	0
8	7854167	.	G	C	3	2	5	0	0	5	0	0
8	7854194	.	C	G	5	4	9	0	0	9	0	0
8	7854236	.	G	T	0	2	2	0	4	6	0	0
8	7854247	.	T	C	3	2	5	0	0	5	0	0
8	7855697	.	G	T	0	2	2	0	4	6	0	0
8	7857369	.	A	G	6	0	6	0	4	10	0	0
8	7857378	.	T	C	6	5	11	0	0	11	0	0
8	7863603	.	C	T	4	5	9	0	0	9	0	0
8	7863747	.	T	C	7	5	12	0	1	13	0	0
8	7872053	.	A	T	9	8	17	0	0	17	0	0
8	7872056	.	C	T	7	9	16	0	1	17	0	0
8	7872374	.	T	A	3	2	5	0	0	5	0	0
8	7872510	.	A	G	3	2	5	0	0	5	0	0
8	7872521	.	A	C	4	1	5	0	0	5	0	0
8	7872971	.	A	G	5	0	5	0	4	9	0	0
8	7880956	.	A	G	2	2	4	0	0	4	0	0
8	7891240	.	T	C	3	4	7	0	0	7	0	0
8	7891371	.	A	C	2	4	6	0	0	6	0	0
8	7891397	.	G	A	1	3	4	0	1	5	0	0
8	7903144	.	C	T	2	2	4	0	1	5	0	0
8	7908142	.	A	T	1	2	3	0	0	3	0	0
8	7908221	.	T	C	6	2	8	0	0	8	0	0
8	7908308	.	T	C	1	3	4	0	0	4	0	0
8	7908309	.	T	C	1	3	4	0	0	4	0	0
8	7908370	.	A	G	3	4	7	0	2	9	0	0
8	7908374	.	A	G	3	0	3	0	7	10	0	0
8	7908417	.	C	A	1	4	5	0	1	6	0	0
8	7908520	.	A	G	3	3	6	0	0	6	0	0
8	7910050	.	C	T	1	3	4	0	0	4	0	0
8	7910107	.	T	C	1	8	9	0	0	9	0	0
8	7912216	.	A	C	6	13	19	0	2	21	0	0
8	7912267	.	C	G	2	0	2	0	6	8	0	0
8	7912394	.	G	A	10	8	18	0	1	19	0	0
8	7912647	.	A	T	2	1	3	0	2	5	0	0
8	8032918	.	T	C	2	4	6	0	0	6	0	0
8	8032945	.	A	G	3	3	6	0	0	6	0	0
8	8033275	.	G	A	0	3	3	0	4	7	0	0
8	8033290	.	A	G	5	3	8	0	0	8	0	0
8	8034933	.	A	C	2	2	4	0	0	4	0	0
8	8298291	.	A	G	12	9	21	0	2	23	0	0
8	8298472	.	C	T	12	14	26	0	1	27	0	0
8	8301910	.	A	G	6	3	9	0	0	9	0	0
8	8301913	.	T	A	5	3	8	0	1	9	0	0
8	8325553	.	T	A	10	11	21	0	0	21	0	0
8	8331823	.	A	T	10	15	25	0	4	29	0	0
8	8334428	.	C	T	10	9	19	0	1	20	0	0
8	8338969	.	C	T	16	10	26	0	0	26	0	0
8	8341155	.	G	A	3	3	6	0	0	6	0	0
8	8341170	.	G	A	3	3	6	0	0	6	0	0
8	8341313	.	T	C	8	8	16	0	0	16	0	0
8	8341340	.	A	C	11	9	20	0	0	20	0	0
8	8341383	.	T	C	7	5	12	0	3	15	0	0
8	8341617	.	A	C	8	9	17	0	0	17	0	0
8	8341619	.	T	C	8	0	8	0	9	17	0	0
8	8343217	.	T	G	2	13	15	0	2	17	0	0
8	8362684	.	G	A	1	4	5	0	0	5	0	0
8	8389011	.	A	G	7	4	11	0	0	11	0	0
8	8390797	.	A	G	4	2	6	0	1	7	0	0
8	8391508	.	A	G	1	5	6	0	1	7	0	0
8	8394495	.	A	C	2	5	7	0	0	7	0	0
8	8426432	.	A	G	2	3	5	0	0	5	0	0
8	8446343	.	T	A	3	4	7	0	0	7	0	0
8	8478746	.	G	A	3	1	4	0	2	6	0	0
8	8478751	.	C	A	2	2	4	0	1	5	0	0
8	8478819	.	A	G	7	1	8	0	3	11	0	0
8	8478861	.	C	T	2	4	6	0	0	6	0	0
8	8478862	.	T	C	2	4	6	0	0	6	0	0
8	8478921	.	A	C	1	2	3	0	0	3	0	0
8	8480454	.	A	C	2	2	4	0	1	5	0	0
8	8480484	.	A	T	1	2	3	0	1	4	0	0
8	8484032	.	G	A	3	2	5	0	1	6	0	0
8	8484269	.	A	G	5	8	13	0	1	14	0	0
8	8484275	.	A	G	5	8	13	0	0	13	0	0
8	8486783	.	G	A	3	4	7	0	3	10	0	0
8	8489175	.	G	A	2	2	4	0	0	4	0	0
8	8489342	.	C	G	2	2	4	0	0	4	0	0
8	8579618	.	A	C	1	2	3	0	0	3	0	0
8	8605950	.	T	C	7	4	11	0	0	11	0	0
8	8606067	.	C	T	1	7	8	0	0	8	0	0
8	8606070	.	C	T	2	6	8	0	0	8	0	0
8	8606286	.	C	T	4	2	6	0	0	6	0	0
8	8686398	.	T	C	4	0	4	0	5	9	0	0
8	8846877	.	C	T	10	4	14	0	0	14	0	0
8	8847341	.	T	A	5	10	15	0	0	15	0	0
8	8847476	.	C	T	6	3	9	0	1	10	0	0
8	8847593	.	T	C	9	11	20	0	0	20	0	0
8	8847648	.	T	A	16	5	21	0	0	21	0	0
8	8847676	.	G	C	13	8	21	0	0	21	0	0
8	8847788	.	A	C	7	8	15	0	0	15	0	0
8	8847857	.	T	C	7	9	16	1	0	17	0	0
8	8847860	.	T	C	7	9	16	1	0	17	0	0
8	8848122	.	C	A	3	6	9	0	0	9	0	0
8	8905416	.	T	C	17	12	29	0	1	30	0	0
8	8914899	.	T	C	8	16	24	0	0	24	0	0
8	8914911	.	C	T	5	16	21	0	2	23	0	0
8	8919045	.	G	A	4	13	17	0	14	31	0	0
8	8922367	.	T	A	22	18	40	0	0	40	0	0
8	8932581	.	T	A	1	2	3	0	0	3	0	0
8	8957424	.	G	A	1	3	4	0	0	4	0	0
8	8975926	.	T	C	8	4	12	0	1	13	0	0
8	8977919	.	G	A	7	5	12	0	1	13	0	0
8	9011843	.	G	A	12	7	19	0	1	20	0	0
8	9029047	.	C	A	10	3	13	0	0	13	0	0
8	9052123	.	C	T	8	6	14	0	1	15	0	0
8	9052184	.	A	T	7	11	18	0	0	18	0	0
8	9059491	.	C	T	6	7	13	0	0	13	0	0
8	9092466	.	A	G	3	5	8	0	1	9	0	0
8	9093623	.	A	T	5	8	13	0	2	15	0	0
8	9222862	.	C	T	2	14	16	0	11	27	0	0
8	9222867	.	T	A	11	14	25	0	0	25	0	0
8	9222988	.	G	C	10	10	20	0	1	21	0	0
8	9223044	.	A	G	10	22	32	0	1	33	0	0
8	9231039	.	T	C	9	0	9	0	10	19	0	0
8	9231054	.	C	T	9	10	19	0	0	19	0	0
8	9232930	.	C	T	8	10	18	0	0	18	0	0
8	9262024	.	G	A	4	3	7	0	1	8	0	0
8	9270373	.	G	A	2	6	8	0	1	9	0	0
8	9275102	.	G	A	6	4	10	0	1	11	0	0
8	9275165	.	C	T	0	3	3	0	4	7	0	0
8	9275180	.	G	A	4	3	7	0	0	7	0	0
8	9280529	.	G	A	2	2	4	0	0	4	0	0
8	9390769	.	G	A	1	2	3	0	1	4	0	0
8	9394977	.	C	T	3	3	6	0	0	6	0	0
8	9395005	.	G	A	3	2	5	0	0	5	0	0
8	9542541	.	G	A	1	2	3	0	0	3	0	0
8	9542724	.	C	T	2	4	6	0	0	6	0	0
8	9699182	.	G	C	4	6	10	0	2	12	0	0
8	9709591	.	T	C	5	4	9	0	0	9	0	0
8	9716229	.	A	G	3	3	6	0	1	7	0	0
8	9728650	.	G	A	0	3	3	0	7	10	0	0
8	9731233	.	A	G	5	11	16	0	0	16	0	0
8	9733153	.	G	A	0	4	4	0	6	10	0	0
8	9733174	.	G	A	7	7	14	0	0	14	0	0
8	9743078	.	T	C	9	6	15	0	0	15	0	0
8	9743081	.	A	T	9	5	14	0	1	15	0	0
8	9748783	.	A	G	10	7	17	0	0	17	0	0
8	9755411	.	A	G	7	0	7	0	10	17	0	0
8	9761116	.	A	C	6	7	13	0	0	13	0	0
8	9791976	.	T	C	8	3	11	0	1	12	0	0
8	9791977	.	G	A	8	4	12	0	0	12	0	0
8	9867790	.	A	G	1	4	5	0	0	5	0	0
8	9868310	.	A	G	1	5	6	0	0	6	0	0
8	9961673	.	T	C	7	5	12	0	0	12	0	0
8	9985326	.	C	T	10	10	20	0	2	22	0	0
8	9985458	.	T	C	11	9	20	0	0	20	0	0
8	10306283	.	T	C	12	17	29	0	1	30	0	0
8	10307170	.	C	T	18	26	44	0	3	47	0	0
8	10307686	.	G	T	11	27	38	0	3	41	0	0
8	10307730	.	C	G	16	3	19	0	21	40	0	0
8	10308684	.	T	G	4	1	5	0	11	16	0	0
8	10562400	.	A	C	6	4	10	0	1	11	0	0
8	10823100	.	G	C	3	2	5	0	0	5	0	0
8	10823405	.	G	A	0	5	5	0	2	7	0	0
8	10835439	.	A	G	3	3	6	0	0	6	0	0
8	10848266	.	T	G	2	0	2	0	5	7	0	0
8	10852169	.	T	A	8	3	11	0	2	13	0	0
8	10856107	.	A	G	4	6	10	0	0	10	0	0
8	10856883	.	A	C	4	7	11	0	0	11	0	0
8	10856915	.	T	C	5	6	11	0	0	11	0	0
8	10870625	.	C	T	3	2	5	0	0	5	0	0
8	10882708	.	T	C	5	7	12	0	1	13	0	0
8	10882877	.	A	C	5	6	11	0	0	11	0	0
8	10884489	.	T	C	8	10	18	0	0	18	0	0
8	10890013	.	C	T	4	5	9	0	1	10	0	0
8	10890318	.	T	C	4	9	13	0	0	13	0	0
8	10890325	.	C	G	5	1	6	0	7	13	0	0
8	10894887	.	C	T	9	3	12	0	0	12	0	0
8	10895135	.	T	A	2	6	8	0	1	9	0	0
8	10895162	.	G	A	2	4	6	0	0	6	0	0
8	10937661	.	A	G	3	4	7	0	0	7	0	0
8	10937696	.	A	T	3	4	7	0	1	8	0	0
8	10937990	.	T	A	2	3	5	0	0	6	1	0
8	10938191	.	A	G	1	2	3	0	1	4	0	0
8	10938418	.	T	C	4	0	4	0	5	9	0	0
8	10956747	.	G	A	3	9	12	0	0	12	0	0
8	10956824	.	A	G	6	9	15	0	1	16	0	0
8	10957045	.	G	T	8	4	12	0	0	12	0	0
8	10957168	.	A	C	19	0	19	0	7	26	0	0
8	10967342	.	T	C	12	0	12	0	14	26	0	0
8	10969651	.	T	A	6	11	17	0	1	18	0	0
8	10972414	.	G	A	13	12	25	0	1	26	0	0
8	10978101	.	A	G	10	9	19	0	0	19	0	0
8	10980909	.	A	G	5	5	10	0	1	11	0	0
8	10981277	.	A	T	6	4	10	0	2	12	0	0
8	10987348	.	A	G	8	5	13	0	0	13	0	0
8	10988903	.	C	T	6	5	11	0	0	11	0	0
8	10988963	.	A	G	3	3	6	0	0	6	0	0
8	11004246	.	G	A	2	4	6	0	0	6	0	0
8	11009117	.	T	C	6	11	17	0	2	19	0	0
8	11010146	.	C	T	13	8	21	0	1	22	0	0
8	11016720	.	A	C	8	5	13	0	1	14	0	0
8	11019273	.	A	T	3	4	7	0	1	8	0	0
8	11028031	.	T	C	2	2	4	0	1	5	0	0
8	11066361	.	T	C	1	0	1	0	3	4	0	0
8	11080730	.	A	C	3	4	7	0	0	7	0	0
8	11080740	.	C	T	1	4	5	0	2	7	0	0
8	11115578	.	A	T	0	2	2	0	1	3	0	0
8	11115873	.	G	A	1	2	3	0	0	3	0	0
8	11116057	.	A	T	1	4	5	0	0	5	0	0
8	11116122	.	T	C	1	2	3	0	1	4	0	0
8	11146856	.	T	C	4	5	9	0	0	9	0	0
8	11146883	.	T	G	5	6	11	0	0	12	1	0
8	11179228	.	T	A	5	9	14	0	1	15	0	0
8	11180061	.	C	T	8	7	15	0	0	15	0	0
8	11180063	.	T	G	8	7	15	0	0	15	0	0
8	11182273	.	G	A	13	7	20	0	1	21	0	0
8	11182825	.	G	A	8	3	11	0	1	12	0	0
8	11182905	.	A	C	2	3	5	0	0	5	0	0
8	11183508	.	T	A	4	5	9	0	1	10	0	0
8	11183555	.	G	T	6	4	10	0	0	10	0	0
8	11183576	.	A	T	7	3	10	0	0	10	0	0
8	11183670	.	G	T	3	4	7	0	0	7	0	0
8	11183690	.	T	C	3	3	6	0	0	6	0	0
8	11183708	.	G	A	2	3	5	0	0	5	0	0
8	11183733	.	C	T	1	3	4	0	0	4	0	0
8	11183773	.	T	G	1	2	3	0	1	4	0	0
8	11183787	.	G	A	1	4	5	0	0	5	0	0
8	11183943	.	A	T	4	3	7	0	0	7	0	0
8	11184296	.	C	T	2	3	5	0	0	5	0	0
8	11184413	.	C	A	3	3	6	0	0	6	0	0
8	11185209	.	C	T	2	1	3	0	1	4	0	0
8	11185242	.	A	T	1	4	5	0	1	6	0	0
8	11185286	.	C	T	2	3	5	0	1	6	0	0
8	11185289	.	C	G	3	3	6	0	0	6	0	0
8	11190323	.	G	A	1	3	4	0	0	4	0	0
8	11190403	.	A	T	1	2	3	0	0	3	0	0
8	11504198	.	A	C	7	0	7	0	4	11	0	0
8	14441524	.	A	G	11	6	17	1	1	19	0	0
8	14441527	.	A	G	14	3	17	1	1	19	0	0
8	14792860	.	A	G	1	2	3	0	0	3	0	0
8	14981124	.	A	T	1	7	8	0	1	9	0	0
8	14981814	.	G	T	3	2	5	0	0	5	0	0
8	14983117	.	A	G	9	4	13	0	1	14	0	0
8	14983703	.	T	C	0	4	4	0	0	4	0	0
8	14983706	.	T	C	5	3	8	0	0	8	0	0
8	15479282	.	T	A	1	2	3	0	1	4	0	0
8	16527091	.	G	A	1	2	3	0	0	3	0	0
8	16597424	.	T	C	12	5	17	0	1	18	0	0
8	16682943	.	G	A	1	6	7	0	0	7	0	0
8	17086043	.	C	T	6	5	11	0	4	15	0	0
8	17156950	.	T	A	1	6	7	0	0	7	0	0
8	18562570	.	C	T	11	14	25	0	0	25	0	0
8	18562576	.	G	A	12	11	23	0	1	24	0	0
8	20458389	.	T	C	6	2	8	0	0	8	0	0
8	21251604	.	A	G	13	5	18	0	0	18	0	0
8	21672835	.	A	G	4	4	8	0	0	8	0	0
8	21672840	.	A	G	3	2	5	0	2	7	0	0
8	21672883	.	A	G	3	8	11	0	1	12	0	0
8	21672884	.	A	G	3	11	14	0	0	14	0	0
8	21674314	.	A	G	8	5	13	0	3	16	0	0
8	22504451	.	A	G	1	7	8	0	1	9	0	0
8	23151740	.	A	T	2	1	3	0	2	5	0	0
8	23641993	.	A	G	3	2	5	0	2	7	0	0
8	23711985	.	G	A	1	4	5	0	0	5	0	0
8	23860127	.	A	T	2	3	5	0	1	6	0	0
8	25043047	.	T	C	5	0	5	1	4	10	0	0
8	25293008	.	A	G	18	14	32	0	1	33	0	0
8	25300893	.	G	A	2	6	8	0	0	8	0	0
8	25397537	.	A	G	2	2	4	0	1	5	0	0
8	25708998	.	C	T	1	9	10	0	0	10	0	0
8	25821105	.	T	A	8	3	11	0	1	12	0	0
8	25970772	.	A	G	20	9	29	0	2	31	0	0
8	26073777	.	G	A	1	5	6	0	0	6	0	0
8	27618649	.	G	T	2	13	15	0	19	34	0	0
8	27623973	.	A	G	15	4	19	0	23	42	0	0
8	28351635	.	A	T	6	2	8	0	0	8	0	0
8	29711547	.	G	A	1	2	3	0	0	3	0	0
8	29718850	.	G	A	2	2	4	0	0	4	0	0
8	29718974	.	G	T	2	4	6	0	1	7	0	0
8	29719073	.	G	T	4	1	5	0	1	6	0	0
8	29719074	.	C	T	0	2	2	0	4	6	0	0
8	29734525	.	T	A	6	3	9	0	0	9	0	0
8	29734615	.	T	A	2	2	4	0	0	4	0	0
8	29742477	.	C	T	8	2	10	0	0	10	0	0
8	29742483	.	C	T	2	5	7	0	0	7	0	0
8	29749008	.	C	T	2	4	6	0	0	6	0	0
8	29749265	.	G	A	2	2	4	0	0	4	0	0
8	29760980	.	G	A	1	3	4	1	3	8	0	0
8	29763383	.	A	G	4	0	4	0	4	8	0	0
8	29763390	.	G	C	6	5	11	0	0	11	0	0
8	29763621	.	G	T	5	2	7	0	0	7	0	0
8	29763822	.	A	G	5	0	5	0	9	14	0	0
8	29763954	.	A	G	5	6	11	0	0	11	0	0
8	29764103	.	G	A	2	4	6	0	0	6	0	0
8	29764150	.	A	T	1	7	8	0	0	8	0	0
8	29764461	.	A	G	3	3	6	1	2	9	0	0
8	29764789	.	A	G	2	3	5	0	0	5	0	0
8	29764843	.	A	G	3	2	5	0	1	6	0	0
8	29764926	.	T	C	2	6	8	0	2	10	0	0
8	29765010	.	G	C	0	7	7	0	4	11	0	0
8	29765016	.	C	T	4	8	12	0	0	12	0	0
8	29765158	.	G	A	0	3	3	0	4	7	0	0
8	29765447	.	A	G	4	2	6	0	0	6	0	0
8	29765472	.	A	G	4	2	6	0	0	6	0	0
8	29765493	.	A	G	3	5	8	0	0	8	0	0
8	29770511	.	C	T	27	27	54	0	1	55	0	0
8	29770644	.	T	A	27	23	50	0	4	54	0	0
8	29770650	.	T	A	31	21	52	0	3	55	0	0
8	29770734	.	T	A	26	17	43	0	4	47	0	0
8	29770771	.	A	C	27	18	45	0	3	48	0	0
8	29771032	.	T	A	27	12	39	0	1	40	0	0
8	29771053	.	A	G	15	25	40	0	1	41	0	0
8	29771516	.	C	A	6	6	12	0	0	12	0	0
8	29771774	.	G	A	2	2	4	0	0	4	0	0
8	29771938	.	C	T	0	8	8	1	6	15	0	0
8	29772076	.	T	A	2	2	4	0	0	4	0	0
8	29772253	.	G	A	17	15	32	0	0	32	0	0
8	29772268	.	T	C	19	16	35	0	0	35	0	0
8	29772309	.	A	G	14	7	21	0	6	27	0	0
8	29772489	.	T	A	3	3	6	0	1	7	0	0
8	29772910	.	G	T	6	8	14	0	1	15	0	0
8	29773164	.	G	A	11	6	17	0	4	21	0	0
8	29773263	.	G	A	9	18	27	0	0	27	0	0
8	29773444	.	A	G	18	18	36	0	0	36	0	0
8	29774268	.	C	T	15	9	24	0	3	27	0	0
8	29774387	.	T	A	10	3	13	0	2	15	0	0
8	29774528	.	C	T	0	8	8	0	9	17	0	0
8	29774570	.	C	T	9	14	23	0	0	23	0	0
8	29787265	.	C	T	2	5	7	0	9	16	0	0
8	29787292	.	C	T	0	10	10	0	8	18	0	0
8	29793782	.	A	G	4	4	8	0	0	8	0	0
8	29799045	.	C	T	11	4	15	0	1	16	0	0
8	29799192	.	T	C	9	0	9	0	12	21	0	0
8	29801150	.	C	G	11	6	17	0	1	18	0	0
8	29819419	.	T	C	4	0	4	0	5	9	0	0
8	29819581	.	A	G	7	4	11	0	0	11	0	0
8	29898947	.	T	C	8	3	11	0	2	13	0	0
8	29899082	.	C	T	1	6	7	0	7	14	0	0
8	29899186	.	G	T	7	2	9	0	0	9	0	0
8	29899209	.	T	C	2	6	8	0	0	8	0	0
8	29899303	.	G	A	9	4	13	0	1	14	0	0
8	29899373	.	G	A	12	5	17	0	1	18	0	0
8	29899453	.	A	G	12	5	17	0	0	17	0	0
8	29899477	.	C	G	2	11	13	0	0	13	0	0
8	29899543	.	A	G	4	7	11	0	1	12	0	0
8	29904949	.	G	A	3	5	8	0	0	8	0	0
8	29904952	.	C	A	2	5	7	0	1	8	0	0
8	29907701	.	C	T	3	2	5	0	0	5	0	0
8	29911381	.	G	T	2	5	7	0	1	8	0	0
8	29911966	.	T	A	2	2	4	0	1	5	0	0
8	29914361	.	C	T	1	2	3	0	0	3	0	0
8	29921692	.	C	T	0	4	4	0	5	9	0	0
8	29923616	.	G	T	2	2	4	0	1	5	0	0
8	29926484	.	C	T	1	3	4	0	0	4	0	0
8	29926972	.	A	T	1	4	5	0	0	5	0	0
8	29926989	.	A	G	1	4	5	0	0	5	0	0
8	29930754	.	T	A	2	5	7	0	0	7	0	0
8	30021383	.	C	T	2	3	5	0	0	5	0	0
8	30021416	.	A	G	1	0	1	0	3	4	0	0
8	30047510	.	C	T	2	2	4	0	0	4	0	0
8	30052107	.	A	C	1	3	4	0	0	4	0	0
8	30065903	.	G	A	1	2	3	0	1	4	0	0
8	30159394	.	G	C	2	4	6	0	0	6	0	0
8	30159560	.	A	C	12	0	12	0	10	22	0	0
8	30242797	.	A	G	3	3	6	0	0	6	0	0
8	30326441	.	C	T	1	2	3	0	0	3	0	0
8	30326480	.	A	C	2	2	4	0	0	4	0	0
8	30330667	.	C	T	1	2	3	0	1	4	0	0
8	30338857	.	G	A	2	4	6	0	0	6	0	0
8	30338875	.	C	G	3	3	6	0	1	7	0	0
8	30338926	.	C	T	4	7	11	0	0	11	0	0
8	30358354	.	G	A	2	2	4	0	0	4	0	0
8	30359873	.	C	A	3	3	6	0	0	6	0	0
8	30378318	.	C	A	0	2	2	0	2	4	0	0
8	30425723	.	T	A	5	6	11	0	0	11	0	0
8	30425782	.	G	T	3	8	11	0	0	11	0	0
8	30502138	.	G	A	0	2	2	0	1	3	0	0
8	30547188	.	C	T	2	2	4	0	0	4	0	0
8	30560867	.	C	T	2	4	6	0	0	6	0	0
8	30560889	.	C	T	2	3	5	0	0	5	0	0
8	30585283	.	C	T	6	5	11	0	0	11	0	0
8	30591955	.	T	C	8	3	11	0	0	11	0	0
8	30591991	.	G	T	5	2	7	0	0	7	0	0
8	30593538	.	A	G	6	0	6	0	6	12	0	0
8	30600565	.	C	T	2	11	13	0	0	13	0	0
8	30600606	.	T	A	1	8	9	0	2	11	0	0
8	30600668	.	G	C	4	2	6	0	0	6	0	0
8	30652064	.	T	G	5	0	5	0	6	11	0	0
8	30661568	.	G	A	0	10	10	0	7	17	0	0
8	30661645	.	G	A	13	9	22	0	0	22	0	0
8	30662343	.	G	C	3	8	11	0	0	11	0	0
8	30662417	.	C	T	5	4	9	0	0	9	0	0
8	30662627	.	A	T	4	6	10	1	2	13	0	0
8	30662649	.	T	C	4	7	11	2	1	14	0	0
8	30730803	.	C	A	2	2	4	0	0	4	0	0
8	30730974	.	A	G	7	6	13	0	0	13	0	0
8	30730983	.	A	C	7	3	10	0	0	10	0	0
8	30731362	.	C	T	2	2	4	0	0	4	0	0
8	30734941	.	A	G	5	4	9	0	1	10	0	0
8	30735085	.	A	G	4	7	11	0	1	12	0	0
8	30741991	.	C	G	2	2	4	0	0	4	0	0
8	30742075	.	C	T	10	3	13	0	0	13	0	0
8	30743321	.	T	C	1	8	9	0	0	9	0	0
8	30745463	.	T	C	2	4	6	0	0	6	0	0
8	30764690	.	C	G	0	3	3	0	1	4	0	0
8	30921457	.	C	G	4	3	7	0	1	8	0	0
8	30928987	.	C	T	8	7	15	0	0	15	0	0
8	30929006	.	T	A	7	8	15	0	0	15	0	0
8	30929143	.	T	A	6	9	15	0	0	15	0	0
8	30929261	.	C	T	7	6	13	0	0	13	0	0
8	30929313	.	C	T	3	10	13	0	3	16	0	0
8	30929886	.	A	G	9	7	16	0	1	17	0	0
8	30929958	.	T	A	18	13	31	0	0	31	0	0
8	30930764	.	C	A	20	24	44	0	4	49	1	0
8	30938396	.	T	C	13	10	23	0	3	26	0	0
8	30938408	.	T	A	14	17	31	0	2	33	0	0
8	30940027	.	T	A	8	11	19	0	1	20	0	0
8	30950057	.	G	A	10	3	13	0	0	13	0	0
8	30951623	.	G	A	6	2	8	0	1	9	0	0
8	30953292	.	T	C	3	0	3	0	4	7	0	0
8	30953444	.	C	T	1	3	4	0	1	5	0	0
8	31008514	.	G	C	7	4	11	0	0	11	0	0
8	31008525	.	A	T	6	5	11	0	0	11	0	0
8	31010623	.	A	C	16	7	23	0	0	23	0	0
8	31010648	.	T	C	9	10	19	0	3	22	0	0
8	31010988	.	T	A	9	6	15	0	2	17	0	0
8	31012993	.	C	T	12	15	27	0	2	29	0	0
8	31013027	.	C	T	17	10	27	0	1	28	0	0
8	31013318	.	C	T	5	9	14	0	1	15	0	0
8	31013319	.	G	A	1	9	10	0	5	15	0	0
8	31013493	.	A	C	2	4	6	0	0	6	0	0
8	31013547	.	A	G	1	2	3	0	0	3	0	0
8	31030717	.	A	C	4	3	7	0	1	8	0	0
8	31030838	.	G	C	10	3	13	0	1	14	0	0
8	31030914	.	A	T	18	16	34	0	0	34	0	0
8	31031069	.	A	T	13	7	20	0	3	23	0	0
8	31031180	.	T	G	13	12	25	0	1	26	0	0
8	31031269	.	T	G	8	4	12	0	1	13	0	0
8	31031272	.	T	C	7	3	10	0	2	12	0	0
8	31031438	.	T	A	0	3	3	0	0	3	0	0
8	31031442	.	T	A	2	2	4	0	0	4	0	0
8	31031535	.	G	A	4	3	7	0	0	7	0	0
8	31031603	.	A	T	5	10	15	1	4	20	0	0
8	31031639	.	C	T	1	10	11	1	13	25	0	0
8	31031993	.	G	A	14	20	34	0	1	35	0	0
8	31032379	.	C	T	12	17	29	0	1	30	0	0
8	31032510	.	G	A	17	14	31	0	0	31	0	0
8	31036126	.	G	A	14	17	31	0	1	32	0	0
8	31037403	.	C	T	9	5	14	0	0	14	0	0
8	31037626	.	T	C	7	0	7	0	7	14	0	0
8	31037647	.	A	G	5	9	14	0	0	14	0	0
8	31040157	.	G	A	8	4	12	0	0	12	0	0
8	31040973	.	T	C	3	0	3	0	4	7	0	0
8	31040988	.	C	A	3	3	6	0	1	7	0	0
8	31041221	.	A	G	6	2	8	0	0	8	0	0
8	31041287	.	C	T	0	5	5	0	1	6	0	0
8	31041913	.	G	A	7	2	9	0	0	9	0	0
8	31045790	.	A	G	0	3	3	0	1	4	0	0
8	31046698	.	A	G	2	6	8	0	0	8	0	0
8	31051157	.	C	T	1	2	3	0	0	3	0	0
8	31119730	.	A	G	5	5	10	0	1	11	0	0
8	31131079	.	G	A	14	6	20	0	0	20	0	0
8	31131277	.	A	G	14	17	31	0	0	31	0	0
8	31131394	.	A	C	20	10	30	0	1	31	0	0
8	31135892	.	A	G	15	25	40	0	0	40	0	0
8	31135934	.	C	T	14	22	36	0	1	37	0	0
8	31139439	.	C	T	18	21	39	0	1	40	0	0
8	31142311	.	C	T	21	29	50	0	1	51	0	0
8	31145897	.	C	T	28	33	61	0	1	62	0	0
8	31145940	.	G	C	25	33	58	0	2	60	0	0
8	31145948	.	G	A	25	29	54	0	5	59	0	0
8	31146748	.	G	A	26	21	47	0	4	51	0	0
8	31146805	.	T	C	25	24	49	0	2	51	0	0
8	31146862	.	T	A	37	20	57	0	1	58	0	0
8	31146913	.	G	A	26	24	50	0	1	51	0	0
8	31147159	.	C	T	25	34	59	0	2	61	0	0
8	31147208	.	C	A	25	33	58	0	1	59	0	0
8	31147241	.	A	T	30	27	57	0	2	59	0	0
8	31147315	.	C	T	25	16	41	0	2	43	0	0
8	31147380	.	T	G	25	22	47	0	2	49	0	0
8	31147651	.	C	T	24	32	56	0	1	57	0	0
8	31147898	.	G	A	18	30	48	0	4	52	0	0
8	31249080	.	A	C	4	3	7	0	1	8	0	0
8	31249365	.	G	A	10	6	16	0	3	19	0	0
8	31250032	.	A	G	8	0	8	0	5	13	0	0
8	31250823	.	G	A	15	10	25	0	0	25	0	0
8	31251091	.	A	G	13	15	28	0	3	31	0	0
8	31251222	.	T	C	14	17	31	0	1	32	0	0
8	31251282	.	A	C	11	22	33	0	2	35	0	0
8	31251873	.	T	C	17	14	31	0	2	33	0	0
8	31367747	.	T	C	3	5	8	0	1	9	0	0
8	31368279	.	T	G	11	12	23	0	1	24	0	0
8	31368672	.	G	C	1	3	4	0	0	4	0	0
8	31368865	.	T	A	7	12	19	0	1	20	0	0
8	31375195	.	A	G	5	4	9	0	1	10	0	0
8	31375434	.	T	A	9	10	19	0	0	19	0	0
8	31375457	.	A	G	9	11	20	0	0	20	0	0
8	31376117	.	T	G	12	11	23	0	0	23	0	0
8	31376125	.	A	T	14	12	26	0	0	26	0	0
8	31387695	.	A	G	8	7	15	0	0	15	0	0
8	31387833	.	C	T	1	6	7	0	6	13	0	0
8	31388280	.	C	T	3	6	9	0	0	9	0	0
8	31393220	.	G	A	6	6	12	0	2	14	0	0
8	31393235	.	G	A	5	6	11	0	2	13	0	0
8	31393424	.	C	T	0	3	3	0	4	7	0	0
8	31393451	.	G	T	6	3	9	0	0	9	0	0
8	31395485	.	T	C	3	3	6	0	1	7	0	0
8	31395606	.	C	T	0	2	2	0	8	10	0	0
8	31395632	.	A	C	2	3	5	0	1	6	0	0
8	31395644	.	T	C	6	2	8	0	0	8	0	0
8	31395749	.	C	G	1	3	4	0	0	4	0	0
8	31395795	.	G	A	3	2	5	0	0	5	0	0
8	31395884	.	A	G	6	3	9	0	0	9	0	0
8	31395894	.	A	C	4	5	9	0	0	9	0	0
8	31407126	.	A	T	9	11	20	0	2	22	0	0
8	31407168	.	C	A	12	13	25	0	0	25	0	0
8	31410872	.	C	T	11	6	17	0	1	18	0	0
8	31410887	.	G	A	8	6	14	0	1	15	0	0
8	31411089	.	C	T	0	4	4	0	6	10	0	0
8	31411176	.	T	G	7	8	15	0	1	16	0	0
8	31411638	.	G	T	5	9	14	0	2	16	0	0
8	31437497	.	G	C	21	28	49	0	0	49	0	0
8	31437626	.	C	T	26	13	39	0	0	39	0	0
8	31437671	.	T	C	16	25	41	0	4	45	0	0
8	31441870	.	T	C	35	25	60	0	0	60	0	0
8	31442523	.	C	G	19	14	33	0	1	34	0	0
8	31442595	.	G	A	23	19	42	0	0	42	0	0
8	31442794	.	G	T	25	26	51	1	0	52	0	0
8	31442835	.	T	A	0	45	45	1	5	51	0	0
8	31711411	.	T	C	9	0	9	0	14	23	0	0
8	31716001	.	G	T	11	13	24	0	0	24	0	0
8	31719059	.	C	T	9	8	17	0	1	18	0	0
8	31719077	.	T	C	8	9	17	0	2	19	0	0
8	31730419	.	G	T	12	9	21	0	0	21	0	0
8	31733870	.	C	T	12	14	26	0	0	26	0	0
8	31735854	.	C	A	17	16	33	1	2	36	0	0
8	31756865	.	T	C	15	17	32	0	1	33	0	0
8	31756940	.	T	C	18	18	36	0	0	36	0	0
8	31756946	.	T	C	17	14	31	0	1	32	0	0
8	31818022	.	G	A	2	19	21	0	16	37	0	0
8	31818083	.	A	T	14	19	33	0	1	34	0	0
8	31818371	.	A	G	12	12	24	0	2	26	0	0
8	31818425	.	A	C	11	13	24	0	0	24	0	0
8	31818456	.	A	G	7	10	17	0	0	17	0	0
8	31818745	.	C	T	13	11	24	0	0	24	0	0
8	31850955	.	A	T	22	11	33	0	1	34	0	0
8	31851150	.	A	C	6	8	14	0	1	15	0	0
8	31851594	.	T	C	21	21	42	0	1	43	0	0
8	31861425	.	A	G	16	21	37	0	0	37	0	0
8	31861479	.	C	T	21	20	41	0	0	41	0	0
8	31861580	.	G	C	18	21	39	0	0	39	0	0
8	31861615	.	A	C	23	15	38	0	0	38	0	0
8	31861742	.	G	A	22	9	31	0	0	31	0	0
8	31862165	.	C	T	20	14	34	0	1	35	0	0
8	31862384	.	A	G	21	14	35	0	0	35	0	0
8	31862407	.	G	A	22	15	37	0	2	39	0	0
8	31862584	.	G	T	17	12	29	0	1	30	0	0
8	31862670	.	T	A	9	11	20	0	6	26	0	0
8	31887845	.	G	A	2	2	4	0	1	5	0	0
8	31887859	.	G	T	3	2	5	0	0	5	0	0
8	31893561	.	A	G	1	1	2	1	1	4	0	0
8	31898706	.	C	T	3	5	8	0	0	8	0	0
8	31901659	.	A	G	6	15	21	0	1	22	0	0
8	31914427	.	A	T	16	14	30	0	3	33	0	0
8	31919101	.	G	C	14	12	26	0	1	27	0	0
8	31919451	.	G	T	12	16	28	0	5	33	0	0
8	31919548	.	C	T	16	10	26	0	0	26	0	0
8	31941904	.	T	A	7	9	16	0	0	16	0	0
8	31942099	.	C	T	13	4	17	0	0	17	0	0
8	31942174	.	G	A	2	11	13	0	11	24	0	0
8	31942723	.	G	A	9	9	18	0	0	18	0	0
8	32028856	.	G	T	2	3	5	0	1	6	0	0
8	32028921	.	T	A	4	5	9	0	1	10	0	0
8	32029267	.	G	A	4	4	8	0	0	8	0	0
8	32029479	.	A	G	1	1	2	0	0	2	0	0
8	32029573	.	T	C	6	0	6	0	3	9	0	0
8	32029699	.	T	C	2	0	2	0	4	6	0	0
8	32029810	.	G	C	4	2	6	0	0	6	0	0
8	32029843	.	T	C	6	3	9	0	0	9	0	0
8	32030053	.	T	C	1	2	3	0	0	3	0	0
8	32030087	.	G	A	2	3	5	0	0	5	0	0
8	32030107	.	G	A	1	5	6	0	0	6	0	0
8	32030144	.	A	G	1	4	5	0	0	5	0	0
8	32030771	.	T	G	6	3	9	0	1	10	0	0
8	32030837	.	T	A	4	7	11	0	0	11	0	0
8	32129255	.	T	C	2	3	5	0	0	5	0	0
8	32191744	.	G	A	2	3	5	0	0	5	0	0
8	32270327	.	G	T	2	2	4	0	0	4	0	0
8	32403079	.	G	A	2	2	4	0	0	4	0	0
8	32482851	.	C	T	15	12	27	0	0	27	0	0
8	32483536	.	C	T	13	9	22	0	1	23	0	0
8	32483905	.	G	C	10	17	27	0	1	28	0	0
8	32486956	.	C	T	0	16	16	0	9	25	0	0
8	32497629	.	G	T	11	11	22	0	2	24	0	0
8	32501429	.	T	G	1	5	6	0	0	6	0	0
8	32501541	.	A	G	3	3	6	0	0	6	0	0
8	32502932	.	C	T	3	2	5	0	0	5	0	0
8	32503968	.	C	T	4	4	8	0	0	8	0	0
8	32596634	.	A	T	6	10	16	0	1	17	0	0
8	32599363	.	T	C	3	6	9	0	0	9	0	0
8	32599421	.	T	C	12	8	20	0	1	21	0	0
8	32599432	.	T	G	10	10	20	0	0	20	0	0
8	32599556	.	C	G	7	7	14	0	0	14	0	0
8	32599743	.	A	G	4	7	11	0	0	11	0	0
8	32914694	.	C	T	15	14	29	0	0	29	0	0
8	32914748	.	G	T	24	14	38	0	0	38	0	0
8	32914782	.	T	A	6	16	22	0	1	23	0	0
8	32914813	.	A	T	7	11	18	0	0	18	0	0
8	32916957	.	T	A	14	9	23	0	1	24	0	0
8	32925670	.	T	G	6	9	15	0	0	15	0	0
8	32925721	.	A	G	9	12	21	0	0	21	0	0
8	32930789	.	A	G	8	5	13	0	0	13	0	0
8	32930837	.	C	T	7	6	13	0	3	16	0	0
8	32939561	.	T	C	4	10	14	0	1	15	0	0
8	32939573	.	T	C	6	0	6	0	9	15	0	0
8	33084515	.	A	G	12	10	22	0	0	22	0	0
8	33285546	.	C	T	1	2	3	0	0	3	0	0
8	33896326	.	A	T	30	11	41	1	1	43	0	0
8	33896698	.	A	G	19	15	34	0	2	36	0	0
8	33896922	.	G	A	22	22	44	0	2	46	0	0
8	33897274	.	C	T	3	22	25	0	26	52	1	0
8	33918631	.	C	T	22	21	43	1	2	46	0	0
8	33924432	.	C	T	0	15	15	0	23	38	0	0
8	34051719	.	G	A	16	18	34	0	0	34	0	0
8	34051795	.	T	C	15	17	32	0	0	32	0	0
8	34051930	.	T	G	12	13	25	0	2	27	0	0
8	34342123	.	G	C	10	0	10	0	14	24	0	0
8	34342376	.	G	A	14	14	28	0	2	30	0	0
8	34342409	.	A	G	16	7	23	0	3	26	0	0
8	34345285	.	G	A	14	18	32	0	1	33	0	0
8	34345556	.	A	G	15	8	23	0	0	23	0	0
8	34348958	.	A	C	4	6	10	0	0	10	0	0
8	34376669	.	A	G	2	4	6	0	0	6	0	0
8	34376728	.	G	A	1	3	4	0	0	4	0	0
8	34397046	.	C	T	2	2	4	0	0	4	0	0
8	35759276	.	G	A	0	3	3	0	10	13	0	0
8	35759444	.	C	T	3	2	5	0	0	5	0	0
8	35759524	.	A	G	4	3	7	0	0	7	0	0
8	35759726	.	C	T	2	3	5	0	0	5	0	0
8	35759999	.	C	T	1	5	6	0	0	6	0	0
8	35760328	.	C	T	2	2	4	0	0	4	0	0
8	35760338	.	T	C	5	2	7	0	0	7	0	0
8	36058504	.	G	T	1	2	3	0	0	3	0	0
8	36059886	.	A	T	1	4	5	0	1	6	0	0
8	36061541	.	C	T	0	3	3	0	1	4	0	0
8	36473141	.	G	T	2	3	5	0	0	5	0	0
8	36473144	.	A	G	2	3	5	0	0	5	0	0
8	36473183	.	G	A	3	3	6	0	0	6	0	0
8	36473189	.	G	A	3	3	6	0	0	6	0	0
8	36473313	.	G	A	1	8	9	0	0	9	0	0
8	36473319	.	T	C	0	7	7	0	2	9	0	0
8	36507567	.	C	A	3	1	4	0	1	5	0	0
8	36512716	.	G	A	0	4	4	0	2	6	0	0
8	36562451	.	A	G	20	1	21	0	13	34	0	0
8	36563192	.	G	A	19	8	27	0	1	29	1	0
8	36564746	.	C	T	7	11	18	0	9	28	1	0
8	36566182	.	T	C	22	11	33	0	2	35	0	0
8	36566353	.	T	C	14	7	21	0	3	24	0	0
8	36567193	.	T	A	21	18	39	0	3	42	0	0
8	36567208	.	A	T	19	22	41	0	2	44	1	0
8	36567316	.	T	C	27	19	46	0	3	49	0	0
8	36567349	.	A	C	24	14	38	0	5	43	0	0
8	36568304	.	C	T	22	10	32	0	2	34	0	0
8	36568492	.	T	C	11	13	24	0	3	27	0	0
8	36568561	.	A	G	11	20	31	0	1	32	0	0
8	36568755	.	T	C	16	8	24	0	0	24	0	0
8	36570147	.	T	C	4	2	6	0	0	6	0	0
8	36573796	.	C	T	3	1	4	0	0	4	0	0
8	36577368	.	T	A	2	2	4	0	1	5	0	0
8	36582989	.	T	C	10	14	24	0	1	25	0	0
8	36583834	.	T	C	4	5	9	0	1	10	0	0
8	36583877	.	C	A	11	10	21	0	0	21	0	0
8	36587934	.	A	G	14	11	25	0	3	28	0	0
8	36587936	.	A	G	13	0	13	0	12	25	0	0
8	36587970	.	C	A	11	6	17	0	0	17	0	0
8	36587981	.	G	T	9	5	14	0	1	15	0	0
8	36588600	.	G	T	2	11	13	0	19	32	0	0
8	36589226	.	T	C	8	10	18	0	1	19	0	0
8	36589319	.	T	A	1	3	4	0	1	5	0	0
8	36591823	.	A	T	1	2	3	0	0	3	0	0
8	36592011	.	A	G	7	6	13	0	0	13	0	0
8	36592018	.	A	G	8	6	14	0	0	14	0	0
8	36592237	.	T	C	9	9	18	0	1	19	0	0
8	36592374	.	A	G	11	15	26	1	2	29	0	0
8	36600801	.	C	G	14	14	28	0	0	28	0	0
8	36600803	.	T	G	13	14	27	0	1	28	0	0
8	36600840	.	T	C	16	0	16	0	11	27	0	0
8	36602459	.	C	T	6	12	18	0	0	18	0	0
8	36613882	.	G	T	8	8	16	0	1	17	0	0
8	36617635	.	C	G	4	6	10	0	1	11	0	0
8	36617669	.	A	G	5	8	13	0	1	14	0	0
8	36746770	.	T	A	3	5	8	0	0	8	0	0
8	36781596	.	A	G	2	0	2	0	2	4	0	0
8	36781722	.	C	T	6	2	8	0	1	9	0	0
8	36785572	.	A	C	2	4	6	0	0	6	0	0
8	36785599	.	T	C	2	3	5	0	0	5	0	0
8	36803574	.	C	A	9	11	20	0	0	20	0	0
8	36803850	.	T	C	9	8	17	0	0	17	0	0
8	36951346	.	C	T	14	12	26	0	1	27	0	0
8	36951481	.	C	T	11	14	25	0	1	26	0	0
8	36951610	.	T	C	7	6	13	0	1	14	0	0
8	36952015	.	A	G	17	0	17	0	22	39	0	0
8	36953884	.	A	G	7	13	20	0	0	20	0	0
8	36953947	.	C	T	7	8	15	0	2	17	0	0
8	36953950	.	G	C	7	11	18	0	1	19	0	0
8	36956254	.	C	T	17	11	28	0	0	28	0	0
8	36956269	.	T	C	15	7	22	0	1	23	0	0
8	36964126	.	G	A	6	9	15	0	2	17	0	0
8	36974076	.	C	A	12	23	35	0	2	38	1	0
8	36976089	.	T	C	14	13	27	0	0	27	0	0
8	36976200	.	A	G	4	0	4	0	3	7	0	0
8	36976255	.	T	A	7	4	11	0	0	11	0	0
8	36976288	.	T	A	6	4	10	0	1	11	0	0
8	36976557	.	G	A	17	17	34	0	2	36	0	0
8	36976966	.	C	T	31	16	47	0	2	49	0	0
8	36977170	.	C	T	20	20	40	0	4	44	0	0
8	37001591	.	T	A	5	4	9	0	0	9	0	0
8	37007527	.	T	C	5	10	15	0	0	15	0	0
8	37010662	.	T	C	4	6	10	0	0	10	0	0
8	37010668	.	C	T	4	6	10	0	0	10	0	0
8	37012762	.	T	A	9	7	16	0	0	16	0	0
8	37012825	.	C	T	6	6	12	0	1	13	0	0
8	37012872	.	C	G	7	5	12	0	1	13	0	0
8	37013093	.	A	G	4	8	12	0	2	14	0	0
8	37013210	.	G	A	9	4	13	0	1	14	0	0
8	37013255	.	T	C	3	11	14	0	1	15	0	0
8	37013282	.	T	C	3	13	16	0	0	16	0	0
8	37013833	.	C	T	12	11	23	0	3	26	0	0
8	37013877	.	A	T	12	10	22	0	1	23	0	0
8	37014535	.	G	C	14	11	25	0	1	26	0	0
8	37014582	.	T	C	13	6	19	0	1	20	0	0
8	37016584	.	G	T	1	12	13	0	20	33	0	0
8	37016658	.	C	A	14	12	26	0	6	32	0	0
8	37016752	.	A	G	11	11	22	0	2	24	0	0
8	37016790	.	T	C	16	13	29	0	1	30	0	0
8	37017149	.	G	A	11	8	19	0	1	20	0	0
8	37017159	.	C	T	13	10	23	1	0	24	0	0
8	37018877	.	A	G	14	10	24	1	1	26	0	0
8	37018901	.	T	C	16	11	27	1	0	29	1	0
8	37019059	.	G	A	22	15	37	0	2	39	0	0
8	37019113	.	G	A	16	19	35	0	1	36	0	0
8	37025566	.	C	T	15	20	35	0	1	36	0	0
8	37025576	.	A	T	15	20	35	0	0	35	0	0
8	37025614	.	T	A	19	14	33	0	3	36	0	0
8	37025633	.	A	G	14	1	15	0	14	29	0	0
8	37025896	.	T	C	13	7	20	0	2	22	0	0
8	37031235	.	A	G	1	3	4	0	0	4	0	0
8	37033434	.	T	C	1	3	4	0	1	5	0	0
8	37038912	.	T	C	1	2	3	0	0	3	0	0
8	37060149	.	G	T	5	3	8	0	0	8	0	0
8	37060234	.	T	A	4	6	10	0	0	10	0	0
8	37060305	.	C	T	1	4	5	0	5	10	0	0
8	37060434	.	C	A	9	3	12	0	0	12	0	0
8	37060580	.	G	A	6	12	18	0	0	18	0	0
8	37060595	.	A	T	9	8	17	0	2	19	0	0
8	37060702	.	C	T	7	8	15	0	3	18	0	0
8	37072775	.	G	C	1	5	6	0	0	6	0	0
8	37072784	.	A	G	1	5	6	0	1	7	0	0
8	37082711	.	A	G	1	3	4	0	0	4	0	0
8	37082927	.	A	G	0	3	3	0	1	4	0	0
8	37101319	.	C	T	1	3	4	0	0	4	0	0
8	37101346	.	T	C	2	5	7	0	0	7	0	0
8	37101370	.	G	C	3	4	7	0	1	8	0	0
8	37230394	.	C	T	1	2	3	0	0	3	0	0
8	37230736	.	C	T	0	2	2	0	1	3	0	0
8	37232135	.	G	C	9	1	10	0	11	22	1	0
8	37232289	.	T	A	12	10	22	0	3	25	0	0
8	37232312	.	G	C	12	12	24	0	0	24	0	0
8	37232419	.	G	A	7	19	26	0	2	28	0	0
8	37232487	.	A	C	21	14	35	0	3	38	0	0
8	37238801	.	C	G	3	19	22	0	0	22	0	0
8	37242374	.	A	T	1	4	5	0	0	5	0	0
8	37280748	.	T	C	13	10	23	0	1	24	0	0
8	37280752	.	C	T	15	9	24	0	0	24	0	0
8	37280809	.	G	T	13	15	28	0	2	30	0	0
8	37280845	.	G	A	11	8	19	0	1	20	0	0
8	37280865	.	C	T	10	8	18	0	1	19	0	0
8	37280923	.	T	A	10	12	22	0	3	25	0	0
8	37281109	.	T	C	10	3	13	1	1	15	0	0
8	37281440	.	T	A	14	12	26	0	0	26	0	0
8	37281444	.	T	A	14	15	29	0	0	29	0	0
8	37281547	.	G	A	8	15	23	0	3	26	0	0
8	37282088	.	C	T	11	6	17	0	1	18	0	0
8	37282110	.	A	T	14	7	21	0	0	21	0	0
8	37282126	.	G	T	14	7	21	0	1	22	0	0
8	37282407	.	G	A	22	8	30	0	0	30	0	0
8	37282848	.	C	T	16	18	34	0	0	34	0	0
8	37282888	.	G	A	13	13	26	0	2	28	0	0
8	37282986	.	G	A	6	9	15	0	0	15	0	0
8	37283016	.	T	A	5	11	16	0	0	16	0	0
8	37283435	.	C	T	0	3	3	0	7	10	0	0
8	37283452	.	C	T	7	3	10	0	1	11	0	0
8	37283486	.	A	G	5	3	8	0	0	8	0	0
8	37283487	.	A	C	4	3	7	0	0	7	0	0
8	37283663	.	C	T	11	6	17	0	0	17	0	0
8	37283743	.	A	G	6	2	8	0	0	8	0	0
8	37283748	.	G	T	6	3	9	0	0	9	0	0
8	37284386	.	A	G	24	18	42	0	0	42	0	0
8	37284428	.	T	G	21	20	41	0	5	46	0	0
8	37284478	.	A	G	27	20	47	0	4	51	0	0
8	37294894	.	A	T	17	4	21	0	5	26	0	0
8	37294930	.	A	G	11	4	15	0	5	20	0	0
8	37295395	.	C	T	1	16	17	0	15	32	0	0
8	37303244	.	G	A	10	13	23	0	2	25	0	0
8	37303271	.	A	C	4	0	4	0	12	17	1	0
8	37303673	.	T	C	3	5	8	0	1	9	0	0
8	37303891	.	G	A	5	7	12	0	0	12	0	0
8	37305515	.	G	C	1	6	7	0	0	7	0	0
8	37390950	.	T	A	6	2	8	0	1	9	0	0
8	37447650	.	A	G	1	2	3	0	0	3	0	0
8	37447683	.	T	A	4	2	6	0	0	6	0	0
8	37447696	.	C	T	3	5	8	0	0	8	0	0
8	37447751	.	C	T	8	5	13	0	0	13	0	0
8	37453646	.	T	A	6	3	9	0	1	10	0	0
8	37453683	.	G	A	6	7	13	0	1	14	0	0
8	37456522	.	A	T	7	5	12	0	0	12	0	0
8	37456801	.	T	A	7	5	12	0	0	12	0	0
8	37460616	.	A	T	10	8	18	0	0	18	0	0
8	37460743	.	T	C	6	0	6	0	6	12	0	0
8	37460746	.	C	T	1	5	6	0	6	12	0	0
8	37460919	.	G	A	4	2	6	0	0	6	0	0
8	37460942	.	G	A	3	1	4	0	2	6	0	0
8	37460985	.	T	C	1	4	5	0	1	6	0	0
8	37461780	.	A	G	4	3	7	0	0	7	0	0
8	37738165	.	A	G	1	0	1	0	2	3	0	0
8	38190775	.	T	C	1	2	3	0	0	3	0	0
8	38190785	.	T	C	1	3	4	0	0	4	0	0
8	38319615	.	T	C	1	3	4	0	0	4	0	0
8	38319906	.	A	T	2	2	4	0	0	4	0	0
8	38319999	.	T	G	4	3	7	0	0	7	0	0
8	38421515	.	C	A	1	4	5	1	1	7	0	0
8	38421535	.	A	C	2	5	7	0	0	7	0	0
8	38421820	.	C	T	10	11	21	0	1	22	0	0
8	38422058	.	G	A	7	8	15	0	0	15	0	0
8	38422439	.	G	A	8	7	15	0	0	15	0	0
8	38422748	.	C	G	4	7	11	0	0	11	0	0
8	38423170	.	T	C	7	1	8	0	5	13	0	0
8	38423210	.	A	G	5	7	12	0	0	12	0	0
8	38423250	.	G	A	4	13	17	0	1	18	0	0
8	38423297	.	A	G	7	10	17	0	0	17	0	0
8	38423373	.	A	T	3	6	9	0	1	10	0	0
8	38423462	.	A	G	6	12	18	0	1	19	0	0
8	38423617	.	C	T	5	11	16	0	0	16	0	0
8	38423641	.	A	G	5	12	17	0	0	17	0	0
8	38430297	.	G	A	5	4	9	0	0	9	0	0
8	38436657	.	G	A	5	3	8	0	0	8	0	0
8	38565008	.	A	G	2	12	14	0	1	15	0	0
8	38565040	.	C	T	6	12	18	0	0	18	0	0
8	38571041	.	T	A	10	3	13	0	0	13	0	0
8	38571116	.	A	T	1	1	2	0	1	3	0	0
8	38572620	.	C	T	5	4	9	0	0	9	0	0
8	38650055	.	T	C	3	2	5	0	0	5	0	0
8	39575223	.	G	A	3	2	5	0	0	5	0	0
8	39643546	.	T	G	1	0	1	0	2	3	0	0
8	39646024	.	A	T	4	5	9	0	0	9	0	0
8	39646768	.	G	A	10	8	18	0	2	20	0	0
8	39646781	.	T	C	12	5	17	0	3	20	0	0
8	39676552	.	C	T	4	3	7	0	0	7	0	0
8	39693130	.	C	T	12	11	23	2	0	25	0	0
8	39702807	.	T	C	14	5	19	0	2	21	0	0
8	39703277	.	T	C	14	5	19	0	0	19	0	0
8	39703321	.	G	A	4	4	8	0	0	8	0	0
8	39703342	.	T	C	3	1	4	0	0	4	0	0
8	39760860	.	C	T	39	35	74	0	2	76	0	0
8	39765798	.	A	G	33	36	69	0	4	73	0	0
8	39781340	.	T	A	2	2	4	0	0	4	0	0
8	39781351	.	C	A	2	3	5	0	0	5	0	0
8	39781517	.	G	C	3	2	5	0	0	5	0	0
8	39786378	.	T	G	1	2	3	0	0	3	0	0
8	39816887	.	C	G	2	3	5	0	0	5	0	0
8	39816893	.	G	A	3	2	5	0	0	5	0	0
8	39816992	.	C	T	5	6	11	0	2	13	0	0
8	39817011	.	A	G	5	8	13	0	0	13	0	0
8	39817031	.	T	G	5	7	12	0	0	12	0	0
8	39817054	.	A	T	6	2	8	0	0	8	0	0
8	39821560	.	A	G	5	3	8	0	0	8	0	0
8	39821958	.	A	G	1	3	4	0	0	4	0	0
8	39821964	.	G	T	0	3	3	0	1	4	0	0
8	39822585	.	C	G	4	2	6	0	0	6	0	0
8	39822634	.	G	A	1	3	4	0	0	4	0	0
8	39848967	.	A	T	5	6	11	0	0	11	0	0
8	39849336	.	A	G	2	6	8	0	0	8	0	0
8	39849354	.	C	T	5	2	7	0	0	7	0	0
8	39849373	.	A	T	4	4	8	0	0	8	0	0
8	39849394	.	C	G	3	5	8	0	2	10	0	0
8	39849422	.	T	G	2	5	7	0	2	9	0	0
8	39849466	.	A	C	5	2	7	0	0	7	0	0
8	39849524	.	C	T	5	4	9	0	0	9	0	0
8	39849617	.	A	G	2	4	6	0	0	6	0	0
8	39849688	.	T	C	3	7	10	0	0	10	0	0
8	39849728	.	A	T	3	5	8	0	1	9	0	0
8	39849767	.	A	T	6	5	11	0	0	11	0	0
8	39849791	.	A	G	6	3	9	0	1	10	0	0
8	39849847	.	C	A	3	3	6	0	0	6	0	0
8	39850149	.	C	T	6	10	16	0	0	16	0	0
8	39850157	.	A	G	6	10	16	0	0	16	0	0
8	39850251	.	C	T	4	5	9	0	1	10	0	0
8	39850455	.	G	A	5	4	9	0	0	9	0	0
8	39850475	.	C	T	3	5	8	0	0	8	0	0
8	39850500	.	C	G	6	6	12	0	0	12	0	0
8	39850625	.	T	A	3	4	7	0	0	7	0	0
8	39851386	.	A	G	5	5	10	0	0	10	0	0
8	39851514	.	A	G	8	3	11	0	1	12	0	0
8	39852514	.	C	T	4	2	6	0	0	6	0	0
8	39870752	.	G	T	3	2	5	0	0	5	0	0
8	39870975	.	C	T	5	2	7	0	0	7	0	0
8	39871074	.	A	G	1	2	3	0	0	3	0	0
8	39876339	.	G	A	1	3	4	0	0	4	0	0
8	39884127	.	A	T	4	2	6	0	0	6	0	0
8	39951571	.	G	A	7	6	13	0	1	14	0	0
8	39976817	.	C	T	12	14	26	0	1	27	0	0
8	39976850	.	G	C	16	0	16	0	12	28	0	0
8	39977153	.	C	G	15	16	31	0	2	33	0	0
8	39977333	.	G	A	12	15	27	0	3	30	0	0
8	39978559	.	A	G	11	14	25	0	0	25	0	0
8	40163223	.	C	T	15	14	29	0	0	29	0	0
8	40186982	.	A	T	2	6	8	0	0	8	0	0
8	40187080	.	G	A	4	2	6	0	0	6	0	0
8	40189738	.	A	T	1	3	4	0	0	4	0	0
8	40192696	.	T	A	4	3	7	0	0	7	0	0
8	40192708	.	G	A	3	5	8	0	0	8	0	0
8	40193033	.	G	A	2	5	7	0	0	7	0	0
8	40193072	.	G	A	2	3	5	0	0	5	0	0
8	40196220	.	T	C	4	5	9	0	0	9	0	0
8	40196570	.	G	A	2	3	5	0	0	5	0	0
8	40204983	.	A	G	2	2	4	0	0	4	0	0
8	40217948	.	G	A	3	5	8	0	0	8	0	0
8	40226297	.	T	C	7	5	12	0	0	12	0	0
8	40234640	.	C	T	6	7	13	0	0	13	0	0
8	40234764	.	C	T	7	7	14	2	1	17	0	0
8	40234830	.	A	G	6	9	15	0	1	16	0	0
8	40234831	.	T	A	6	10	16	0	0	16	0	0
8	40235184	.	A	T	5	4	9	0	1	10	0	0
8	40235244	.	C	T	5	7	12	0	0	12	0	0
8	40235281	.	G	A	5	6	11	0	1	12	0	0
8	40235348	.	G	C	10	4	14	0	1	15	0	0
8	40235419	.	T	A	4	2	6	0	0	6	0	0
8	40235900	.	G	T	5	2	7	0	0	7	0	0
8	40236088	.	T	A	6	4	10	0	0	10	0	0
8	40237074	.	A	G	2	0	2	0	2	4	0	0
8	40240019	.	G	A	4	1	5	0	1	6	0	0
8	40240922	.	C	G	11	12	23	0	1	24	0	0
8	40241161	.	A	G	17	15	32	0	6	38	0	0
8	40241304	.	C	T	0	20	20	0	19	39	0	0
8	40241364	.	T	G	17	25	42	0	1	43	0	0
8	40241441	.	A	G	27	16	43	7	1	51	0	0
8	40241446	.	A	G	27	13	40	7	0	47	0	0
8	40241640	.	A	T	19	15	34	5	0	39	0	0
8	40241681	.	A	G	26	15	41	0	1	42	0	0
8	40241695	.	T	A	24	10	34	0	5	39	0	0
8	40241718	.	T	C	32	5	37	1	3	41	0	0
8	40241748	.	G	A	25	8	33	3	4	40	0	0
8	40241976	.	C	A	24	17	41	0	3	44	0	0
8	40242005	.	T	G	20	18	38	0	2	40	0	0
8	40242107	.	A	T	18	16	34	0	1	35	0	0
8	40242131	.	A	C	17	11	28	0	1	29	0	0
8	40242243	.	A	C	22	14	36	0	1	37	0	0
8	40242424	.	T	A	11	8	19	0	1	20	0	0
8	40242453	.	G	A	15	9	24	0	1	25	0	0
8	40242613	.	T	A	12	9	21	0	3	24	0	0
8	40242653	.	C	T	11	9	20	0	5	25	0	0
8	40242683	.	A	C	11	10	21	0	1	22	0	0
8	40243052	.	G	C	19	14	33	0	1	34	0	0
8	40243148	.	T	C	12	16	28	0	2	30	0	0
8	40248373	.	T	G	10	13	23	0	2	25	0	0
8	40248673	.	T	C	14	13	27	0	1	28	0	0
8	40248976	.	G	T	15	17	32	0	0	32	0	0
8	40250747	.	C	A	2	15	17	0	9	26	0	0
8	40250798	.	G	A	16	15	31	0	0	31	0	0
8	40251045	.	A	T	7	13	20	0	1	21	0	0
8	40251380	.	G	T	13	13	26	0	1	27	0	0
8	40251700	.	C	G	7	6	13	0	0	13	0	0
8	40254366	.	A	G	7	16	23	0	0	23	0	0
8	40254375	.	T	G	7	14	21	0	1	22	0	0
8	40254499	.	T	C	15	0	15	0	14	29	0	0
8	40270856	.	G	A	11	6	17	0	0	17	0	0
8	40270905	.	A	G	7	8	15	0	2	17	0	0
8	40325709	.	G	T	16	4	20	0	1	21	0	0
8	40325798	.	C	T	13	6	19	0	1	20	0	0
8	40325945	.	T	G	14	11	25	0	0	25	0	0
8	40326072	.	A	T	25	12	37	0	4	41	0	0
8	40326087	.	A	T	25	13	38	0	3	41	0	0
8	40326128	.	C	T	18	10	28	0	1	29	0	0
8	40326736	.	A	G	5	6	11	0	1	12	0	0
8	40427489	.	T	C	9	6	15	0	0	15	0	0
8	40427500	.	T	C	10	6	16	0	2	18	0	0
8	40427737	.	T	A	2	5	7	0	0	7	0	0
8	40428337	.	T	A	2	2	4	0	0	4	0	0
8	40428717	.	A	T	1	2	3	0	1	4	0	0
8	40433871	.	C	T	2	2	4	0	0	4	0	0
8	40631442	.	C	G	4	6	10	0	1	11	0	0
8	40632014	.	T	C	4	14	18	0	1	19	0	0
8	40632305	.	C	T	14	6	20	0	0	20	0	0
8	40632499	.	T	C	8	7	15	0	0	15	0	0
8	40632509	.	C	A	11	10	21	0	0	21	0	0
8	40632545	.	C	T	9	4	13	0	2	15	0	0
8	40632758	.	A	C	9	8	17	0	0	17	0	0
8	40632793	.	A	T	6	5	11	0	0	11	0	0
8	40633226	.	T	A	1	2	3	0	2	5	0	0
8	40644840	.	C	T	7	5	12	0	0	12	0	0
8	40645084	.	T	C	3	4	7	0	0	7	0	0
8	40645113	.	C	T	2	4	6	0	0	6	0	0
8	40645524	.	A	T	1	7	8	0	0	8	0	0
8	40645602	.	A	G	13	8	21	0	1	22	0	0
8	40645723	.	G	A	9	6	15	0	2	17	0	0
8	40645890	.	A	G	3	7	10	1	0	11	0	0
8	40646283	.	C	T	8	10	18	0	4	22	0	0
8	41197077	.	A	T	4	2	6	0	0	6	0	0
8	41201716	.	G	A	1	4	5	0	0	5	0	0
8	41201863	.	C	T	0	6	6	0	4	10	0	0
8	41235191	.	G	A	1	2	3	0	0	3	0	0
8	41239494	.	G	A	5	5	10	0	0	10	0	0
8	41239500	.	T	C	5	7	12	0	0	12	0	0
8	41240949	.	T	C	4	8	12	1	0	13	0	0
8	41243315	.	A	G	6	8	14	0	0	14	0	0
8	41243772	.	T	C	10	9	19	0	0	19	0	0
8	41255573	.	T	C	16	7	23	0	2	25	0	0
8	41255750	.	G	A	4	4	8	0	0	8	0	0
8	41261002	.	A	G	27	21	48	0	1	49	0	0
8	41261092	.	T	A	26	24	50	1	1	52	0	0
8	41273680	.	C	T	15	8	23	0	0	23	0	0
8	41274617	.	G	A	6	2	8	0	0	8	0	0
8	41468868	.	C	T	6	3	9	0	0	9	0	0
8	41474547	.	T	C	4	3	7	0	1	8	0	0
8	41474556	.	G	A	4	4	8	0	0	8	0	0
8	41475236	.	T	C	6	4	10	0	0	10	0	0
8	41482466	.	C	T	7	8	15	0	0	15	0	0
8	41484219	.	G	A	6	5	11	0	0	11	0	0
8	41485132	.	A	G	6	5	11	0	0	11	0	0
8	41485204	.	T	A	4	7	11	0	0	11	0	0
8	41485993	.	A	G	3	3	6	0	0	6	0	0
8	41493936	.	C	G	4	4	8	0	0	8	0	0
8	41493994	.	T	C	3	2	5	0	0	5	0	0
8	41533605	.	T	C	7	7	14	0	0	14	0	0
8	41533738	.	A	T	4	2	6	0	2	8	0	0
8	42642120	.	C	A	2	9	11	0	11	22	0	0
8	42642199	.	T	G	7	12	19	0	2	21	0	0
8	42642247	.	G	C	15	14	29	0	1	30	0	0
8	42642434	.	C	T	7	13	20	0	1	21	0	0
8	42642641	.	A	T	4	5	9	0	0	9	0	0
8	42642671	.	T	A	3	6	9	0	1	10	0	0
8	42642683	.	G	A	6	2	8	0	2	10	0	0
8	42642879	.	G	A	3	10	13	0	0	13	0	0
8	42642941	.	G	T	3	5	8	0	0	8	0	0
8	42643153	.	G	T	7	6	13	0	0	13	0	0
8	42649431	.	G	C	1	8	9	0	0	9	0	0
8	42649485	.	G	A	7	9	16	0	1	17	0	0
8	42650538	.	T	C	7	4	11	0	1	12	0	0
8	42653344	.	A	T	7	2	9	0	0	9	0	0
8	42653389	.	A	G	6	4	10	0	0	10	0	0
8	42655774	.	G	T	4	12	16	0	1	17	0	0
8	42676804	.	A	C	3	0	3	0	8	11	0	0
8	42676918	.	G	A	2	7	9	0	1	10	0	0
8	42688733	.	T	C	2	3	5	0	0	5	0	0
8	42688884	.	C	G	2	2	4	0	0	4	0	0
8	42689198	.	G	A	2	3	5	0	0	5	0	0
8	42689252	.	G	A	3	5	8	0	0	8	0	0
8	42689429	.	T	C	2	2	4	0	0	4	0	0
8	42689805	.	T	C	1	2	3	0	0	3	0	0
8	42689992	.	G	T	2	2	4	0	0	4	0	0
8	42690499	.	G	T	1	2	3	0	0	3	0	0
8	42690618	.	T	C	1	4	5	0	0	5	0	0
8	42690638	.	T	A	1	5	6	0	0	6	0	0
8	42690749	.	G	A	2	2	4	0	0	4	0	0
8	42690977	.	C	A	3	2	5	0	0	5	0	0
8	42834091	.	C	G	3	3	6	0	1	7	0	0
8	42834146	.	T	C	2	7	9	0	1	10	0	0
8	43455875	.	G	A	5	4	9	0	0	9	0	0
8	45396028	.	T	C	8	1	9	0	12	21	0	0
8	45427189	.	C	A	25	13	38	0	1	39	0	0
8	45428039	.	C	T	14	16	30	0	0	30	0	0
8	45430757	.	G	A	22	24	46	0	2	48	0	0
8	45755117	.	G	A	3	5	8	0	0	8	0	0
8	45755185	.	T	C	2	5	7	0	0	7	0	0
8	45755577	.	G	A	2	4	6	0	0	6	0	0
8	45755816	.	T	C	31	36	67	0	6	73	0	0
8	45755973	.	C	G	45	28	73	0	2	75	0	0
8	45756191	.	A	G	34	37	71	0	1	72	0	0
8	45756206	.	G	A	27	36	63	0	8	71	0	0
8	45760071	.	A	C	10	0	10	0	9	19	0	0
8	45762987	.	A	G	1	1	2	0	1	3	0	0
8	45763562	.	G	A	21	15	36	0	3	39	0	0
8	45763991	.	A	G	14	26	40	0	1	41	0	0
8	45764006	.	G	C	26	17	43	0	1	44	0	0
8	45764118	.	C	T	1	21	22	0	22	44	0	0
8	45764684	.	T	C	20	0	20	0	10	30	0	0
8	45764697	.	T	C	12	9	21	0	0	21	0	0
8	45764873	.	T	C	7	12	19	0	1	20	0	0
8	45764893	.	T	C	8	21	29	0	2	31	0	0
8	45764939	.	G	A	31	17	48	0	1	49	0	0
8	45764988	.	A	T	20	24	44	0	1	45	0	0
8	45765023	.	T	A	26	22	48	2	5	55	0	0
8	45765024	.	T	A	27	21	48	2	5	55	0	0
8	45765305	.	G	A	28	20	48	0	0	48	0	0
8	45772915	.	C	A	25	14	39	0	1	40	0	0
8	45774471	.	C	T	2	12	14	0	15	29	0	0
8	45775047	.	C	T	12	9	21	0	0	21	0	0
8	45775068	.	A	T	7	15	22	0	1	23	0	0
8	45775304	.	G	A	7	8	15	0	0	15	0	0
8	45775319	.	G	T	5	7	12	0	1	13	0	0
8	45779729	.	A	C	9	11	20	0	1	21	0	0
8	45786186	.	C	T	0	7	7	0	5	12	0	0
8	45786615	.	A	G	5	4	9	0	0	9	0	0
8	45787137	.	A	G	10	8	18	0	1	19	0	0
8	45788941	.	T	G	2	8	10	0	0	10	0	0
8	45797305	.	G	A	8	5	13	0	1	14	0	0
8	45838228	.	C	T	2	2	4	0	0	4	0	0
8	45853101	.	T	C	2	2	4	0	0	4	0	0
8	45853626	.	G	A	7	4	11	0	1	12	0	0
8	45864652	.	G	C	15	6	21	0	2	23	0	0
8	45870914	.	C	A	0	3	3	0	1	4	0	0
8	45871782	.	A	G	2	3	5	0	1	6	0	0
8	45875696	.	T	G	2	2	4	0	3	7	0	0
8	45879493	.	T	C	1	0	1	0	3	4	0	0
8	45880167	.	C	T	4	4	8	0	0	8	0	0
8	45939648	.	C	G	1	2	3	1	0	4	0	0
8	45944896	.	T	A	12	4	16	0	2	18	0	0
8	45944983	.	G	A	7	4	11	0	1	12	0	0
8	45945024	.	C	T	3	7	10	0	1	11	0	0
8	45951974	.	G	A	0	6	6	0	4	10	0	0
8	45952152	.	A	T	4	3	7	0	0	7	0	0
8	45952281	.	C	T	8	6	14	0	0	14	0	0
8	45952352	.	G	C	4	6	10	0	0	10	0	0
8	45952437	.	G	A	0	3	3	0	5	8	0	0
8	45952461	.	G	A	0	3	3	0	4	7	0	0
8	45952500	.	A	G	1	0	1	0	4	5	0	0
8	45952547	.	G	T	2	2	4	0	0	4	0	0
8	45962000	.	A	C	2	4	6	0	1	7	0	0
8	45986839	.	G	C	1	2	3	0	0	3	0	0
8	46005260	.	T	A	1	3	4	0	0	4	0	0
8	46014147	.	T	C	3	2	5	0	1	6	0	0
8	46077850	.	T	A	5	3	8	0	0	8	0	0
8	46077879	.	C	A	7	3	10	0	0	10	0	0
8	46078241	.	A	T	16	4	20	0	3	23	0	0
8	46078264	.	A	T	6	14	20	0	2	22	0	0
8	46078287	.	A	G	12	12	24	0	1	25	0	0
8	46078342	.	C	G	9	5	14	0	2	16	0	0
8	46089052	.	T	C	19	14	33	0	1	34	0	0
8	46094790	.	G	A	14	14	28	0	1	29	0	0
8	46123717	.	G	A	4	4	8	0	1	9	0	0
8	46123731	.	G	A	4	4	8	0	0	8	0	0
8	46125509	.	G	A	4	3	7	0	1	8	0	0
8	46265147	.	G	A	1	3	4	0	1	5	0	0
8	46310717	.	G	A	1	2	3	0	0	3	0	0
8	46327404	.	A	G	4	4	8	0	0	8	0	0
8	46340777	.	A	G	2	0	2	0	4	6	0	0
8	46346713	.	C	T	4	3	7	0	0	7	0	0
8	46346837	.	T	C	2	2	4	0	2	6	0	0
8	46346857	.	T	C	2	3	5	0	1	6	0	0
8	46346949	.	G	T	0	4	4	0	4	9	1	0
8	46347147	.	C	T	5	9	14	0	0	14	0	0
8	46348145	.	G	T	4	3	7	0	0	7	0	0
8	46356282	.	G	A	6	7	13	0	0	13	0	0
8	46359860	.	C	T	0	2	2	0	8	10	0	0
8	46362082	.	G	A	3	2	5	0	0	5	0	0
8	46362083	.	G	T	3	2	5	0	0	5	0	0
8	46367371	.	G	A	6	4	10	0	0	10	0	0
8	46367411	.	C	A	5	6	11	0	1	12	0	0
8	46385590	.	T	C	2	0	2	0	2	4	0	0
8	46385602	.	T	C	2	0	2	0	2	4	0	0
8	46395887	.	C	T	1	2	3	0	0	3	0	0
8	46396047	.	T	G	1	4	5	0	0	5	0	0
8	46402449	.	G	A	2	2	4	0	0	4	0	0
8	46406145	.	C	A	3	2	5	0	0	5	0	0
8	46431134	.	A	G	4	2	6	0	0	6	0	0
8	46431240	.	A	C	6	5	11	0	0	11	0	0
8	46431247	.	A	T	6	6	12	0	0	12	0	0
8	46431298	.	A	G	4	6	10	0	0	10	0	0
8	46431329	.	T	A	4	4	8	0	0	8	0	0
8	46431403	.	T	G	4	9	13	0	0	13	0	0
8	46431408	.	G	A	3	9	12	0	0	12	0	0
8	46431453	.	A	T	4	8	12	0	0	12	0	0
8	46431620	.	C	T	8	4	12	0	1	13	0	0
8	46431631	.	G	C	9	5	14	0	1	15	0	0
8	46431680	.	G	C	10	4	14	0	0	14	0	0
8	46431684	.	C	T	9	4	13	0	0	13	0	0
8	46433538	.	T	C	4	3	7	0	2	9	0	0
8	46433554	.	G	C	5	3	8	0	0	8	0	0
8	46433637	.	T	C	3	2	5	0	1	6	0	0
8	46433693	.	T	C	6	5	11	0	2	13	0	0
8	46433712	.	T	A	5	5	10	0	1	11	0	0
8	46499645	.	T	C	1	4	5	0	0	5	0	0
8	46853005	.	A	T	17	12	29	0	1	30	0	0
8	46853015	.	A	T	16	11	27	0	3	30	0	0
8	46855313	.	G	A	5	4	9	0	1	10	0	0
8	46881326	.	G	T	8	4	12	0	0	12	0	0
8	46883677	.	T	A	3	5	8	1	2	11	0	0
8	46894269	.	G	A	2	2	4	0	0	4	0	0
8	46894318	.	A	G	1	5	6	1	0	7	0	0
8	47145008	.	A	G	44	38	82	0	4	86	0	0
8	47147333	.	A	T	33	30	63	0	6	69	0	0
8	47149394	.	A	G	39	31	70	0	1	71	0	0
8	47159557	.	C	A	6	3	9	0	0	10	1	0
8	47163244	.	G	A	6	8	14	0	1	15	0	0
8	47163283	.	G	A	8	7	15	0	0	15	0	0
8	47178393	.	T	A	5	4	9	0	0	9	0	0
8	47325279	.	C	T	1	2	3	0	0	3	0	0
8	47835146	.	T	C	3	2	5	0	2	7	0	0
8	47835148	.	C	T	5	2	7	0	0	7	0	0
8	47835307	.	A	T	2	2	4	0	0	4	0	0
8	47843557	.	T	A	4	3	7	0	0	7	0	0
8	47843962	.	A	T	1	2	3	0	0	3	0	0
8	47844423	.	T	C	2	0	2	0	2	4	0	0
8	47895654	.	G	T	1	2	3	0	0	3	0	0
8	47911031	.	C	G	3	1	4	0	5	9	0	0
8	47917304	.	C	T	7	5	12	0	0	12	0	0
8	47927814	.	C	T	5	3	8	0	0	8	0	0
8	47928187	.	T	A	7	4	11	0	2	13	0	0
8	47932409	.	C	T	8	2	10	0	1	11	0	0
8	47932442	.	G	A	6	9	15	0	1	16	0	0
8	47937152	.	T	C	10	10	20	0	3	23	0	0
8	47937156	.	A	G	7	1	8	0	15	23	0	0
8	47937263	.	T	C	14	10	24	0	0	24	0	0
8	47946517	.	T	C	16	11	27	0	3	30	0	0
8	47946674	.	G	A	5	8	13	0	0	13	0	0
8	47946753	.	C	T	10	12	22	0	0	22	0	0
8	47946776	.	T	C	9	16	25	0	1	26	0	0
8	47946833	.	A	G	13	19	32	0	1	33	0	0
8	47946846	.	A	G	8	19	27	0	3	30	0	0
8	47947052	.	A	C	11	5	16	0	1	17	0	0
8	47947297	.	C	T	11	9	20	0	1	21	0	0
8	47947341	.	C	A	9	7	16	0	1	17	0	0
8	47947649	.	T	A	14	17	31	0	0	31	0	0
8	47947772	.	A	G	20	0	20	0	7	27	0	0
8	47947996	.	T	G	11	15	26	0	1	27	0	0
8	47948102	.	T	A	15	14	29	0	1	30	0	0
8	47948602	.	G	A	2	12	14	0	18	33	1	0
8	47948755	.	C	T	11	17	28	0	5	33	0	0
8	47948820	.	A	C	8	10	18	0	2	20	0	0
8	47948866	.	C	A	5	7	12	0	0	12	0	0
8	48093139	.	T	C	2	2	4	0	2	6	0	0
8	48492424	.	C	T	1	2	3	0	0	3	0	0
8	48603552	.	T	C	7	6	13	0	1	14	0	0
8	48603788	.	G	C	0	3	3	0	5	8	0	0
8	48604114	.	T	A	2	3	5	0	0	5	0	0
8	48629640	.	T	A	8	3	11	0	0	11	0	0
8	48629668	.	G	A	5	5	10	0	2	12	0	0
8	48629797	.	C	A	11	5	16	0	0	16	0	0
8	48629946	.	A	T	11	6	17	0	3	20	0	0
8	48629969	.	T	C	15	1	16	0	9	25	0	0
8	48630017	.	A	G	12	7	19	0	1	20	0	0
8	48642433	.	G	A	3	6	9	0	0	9	0	0
8	48642496	.	A	G	3	4	7	0	0	7	0	0
8	48649106	.	A	C	2	3	5	0	0	5	0	0
8	48809531	.	C	G	7	3	10	0	1	11	0	0
8	48809587	.	T	G	1	6	7	0	0	7	0	0
8	48809678	.	A	C	1	9	10	0	1	11	0	0
8	48816412	.	C	G	3	2	5	0	0	5	0	0
8	48816438	.	T	G	4	2	6	0	0	6	0	0
8	48816447	.	C	T	0	2	2	0	5	7	0	0
8	48847630	.	T	C	2	2	4	0	0	4	0	0
8	48958468	.	C	T	6	3	9	0	0	9	0	0
8	48958637	.	A	G	8	7	15	0	0	15	0	0
8	48958822	.	C	T	13	11	24	0	2	26	0	0
8	48959047	.	G	A	5	6	11	0	2	13	0	0
8	48966016	.	A	C	3	2	5	0	1	6	0	0
8	48966140	.	C	G	2	3	5	0	0	5	0	0
8	48991948	.	C	T	2	3	5	0	0	5	0	0
8	49002116	.	A	G	2	2	4	0	1	5	0	0
8	49003785	.	A	G	1	0	1	0	3	4	0	0
8	49005753	.	C	T	5	2	7	0	0	7	0	0
8	49009822	.	C	A	6	8	14	0	0	14	0	0
8	49009829	.	C	T	8	7	15	0	0	15	0	0
8	49021126	.	C	T	2	4	6	0	0	6	0	0
8	49034320	.	A	G	2	5	7	0	0	7	0	0
8	49034323	.	G	A	5	2	7	0	0	7	0	0
8	49067278	.	G	A	1	2	3	0	0	3	0	0
8	49071247	.	T	A	1	3	4	0	0	4	0	0
8	49075512	.	G	A	4	3	7	0	0	7	0	0
8	49078792	.	G	A	1	6	7	0	9	16	0	0
8	49078817	.	C	T	6	6	12	0	0	12	0	0
8	49078827	.	A	C	4	6	10	0	1	11	0	0
8	49082598	.	C	A	3	4	7	0	2	9	0	0
8	49086105	.	G	T	6	3	9	0	1	10	0	0
8	49092108	.	C	T	9	3	12	0	1	13	0	0
8	49092129	.	C	T	8	3	11	0	2	13	0	0
8	49096541	.	G	T	13	4	17	0	0	17	0	0
8	49108347	.	A	T	14	17	31	0	2	33	0	0
8	49170190	.	T	A	5	4	9	0	1	10	0	0
8	49170366	.	T	A	38	26	64	0	4	68	0	0
8	49172338	.	A	G	39	29	68	0	2	70	0	0
8	49310786	.	T	C	8	3	11	0	2	13	0	0
8	49310830	.	C	T	7	8	15	0	0	15	0	0
8	49311090	.	C	T	18	13	31	0	0	31	0	0
8	49311355	.	T	C	14	18	32	1	1	34	0	0
8	49311396	.	C	A	23	12	35	1	0	36	0	0
8	49311398	.	G	C	20	10	30	1	3	34	0	0
8	49345116	.	C	T	8	7	15	0	0	15	0	0
8	49345191	.	T	C	8	13	21	0	1	22	0	0
8	49345212	.	G	T	13	5	18	0	0	18	0	0
8	49345272	.	A	G	13	6	19	0	1	20	0	0
8	49404152	.	G	T	24	14	38	2	5	45	0	0
8	49404262	.	C	T	28	23	51	0	7	58	0	0
8	49404502	.	C	T	38	32	70	2	3	75	0	0
8	49404928	.	C	T	37	34	71	0	2	73	0	0
8	49413417	.	G	T	32	39	71	0	2	73	0	0
8	49413444	.	G	A	36	30	66	0	5	71	0	0
8	49413459	.	G	A	33	34	67	0	3	70	0	0
8	49415718	.	G	C	26	15	41	0	5	47	1	0
8	49435964	.	C	G	9	6	15	0	1	16	0	0
8	49443191	.	A	G	14	1	15	0	13	28	0	0
8	49447326	.	A	G	2	2	4	0	0	4	0	0
8	49447458	.	A	T	5	3	8	0	1	9	0	0
8	49447519	.	G	A	3	5	8	0	0	8	0	0
8	49447657	.	C	A	7	6	13	0	0	13	0	0
8	49623131	.	G	A	1	3	4	0	0	4	0	0
8	49710686	.	G	A	9	11	20	0	0	20	0	0
8	49722313	.	T	C	6	4	10	0	1	11	0	0
8	49728659	.	T	A	8	11	19	0	0	19	0	0
8	49732151	.	T	C	2	1	3	0	2	5	0	0
8	49745727	.	T	G	4	2	6	0	0	6	0	0
8	49746224	.	T	C	15	15	30	0	0	30	0	0
8	49746256	.	G	A	15	15	30	0	0	30	0	0
8	49746440	.	T	C	26	17	43	1	6	50	0	0
8	49746456	.	T	G	29	18	47	1	0	48	0	0
8	49755801	.	A	C	19	17	36	0	2	38	0	0
8	49755867	.	A	T	24	14	38	0	0	38	0	0
8	49756121	.	A	T	16	9	25	0	0	25	0	0
8	49759453	.	A	G	15	7	22	0	0	22	0	0
8	49768413	.	G	A	0	4	4	0	3	7	0	0
8	49768420	.	C	T	3	3	6	0	1	7	0	0
8	49769237	.	G	A	4	3	7	0	0	7	0	0
8	49769496	.	G	A	5	5	10	0	1	11	0	0
8	49845392	.	A	G	5	5	10	0	0	10	0	0
8	49850230	.	C	T	6	5	11	0	0	11	0	0
8	49860718	.	C	T	1	3	4	0	2	6	0	0
8	49864103	.	T	C	13	5	18	0	2	20	0	0
8	49864124	.	G	A	5	13	18	0	1	19	0	0
8	49864212	.	C	T	13	11	24	0	1	25	0	0
8	49864232	.	G	A	10	12	22	0	2	24	0	0
8	49864402	.	C	T	12	6	18	0	0	18	0	0
8	49864655	.	G	T	4	9	13	0	0	13	0	0
8	49864774	.	A	C	9	3	12	0	1	13	0	0
8	49864973	.	T	G	6	3	9	0	0	9	0	0
8	49864985	.	A	T	4	3	7	0	1	8	0	0
8	49865070	.	G	A	6	2	8	0	0	8	0	0
8	49865124	.	C	T	7	4	11	0	0	11	0	0
8	49899474	.	G	A	3	7	10	0	0	10	0	0
8	49899528	.	G	A	6	4	10	0	0	10	0	0
8	49901127	.	T	C	3	0	3	0	4	7	0	0
8	49908677	.	C	T	1	5	6	0	0	6	0	0
8	49908719	.	C	T	0	3	3	0	6	9	0	0
8	49908789	.	G	T	4	3	7	0	0	7	0	0
8	49908792	.	G	A	3	4	7	0	0	7	0	0
8	49908841	.	C	T	4	2	6	0	1	7	0	0
8	49911143	.	G	A	2	5	7	0	1	8	0	0
8	49912682	.	G	A	1	4	5	0	1	6	0	0
8	49917833	.	G	A	1	2	3	0	0	3	0	0
8	49917837	.	C	T	1	1	2	0	1	3	0	0
8	49947483	.	C	T	2	2	4	0	0	4	0	0
8	49949798	.	C	T	3	7	10	0	0	10	0	0
8	49952260	.	C	T	4	6	10	0	1	11	0	0
8	49969037	.	C	T	1	6	7	0	0	7	0	0
8	49989214	.	A	C	1	3	4	0	0	4	0	0
8	50000859	.	C	A	2	3	5	0	0	5	0	0
8	50156805	.	G	A	5	4	9	0	0	9	0	0
8	50159305	.	C	T	1	4	5	0	0	5	0	0
8	50163398	.	A	G	5	0	5	0	5	10	0	0
8	50179868	.	T	A	6	4	10	0	2	12	0	0
8	50179944	.	T	G	5	3	8	0	0	8	0	0
8	50501462	.	C	T	1	2	3	0	0	3	0	0
8	50812321	.	G	A	4	4	8	0	0	8	0	0
8	50818102	.	G	T	5	4	9	0	1	10	0	0
8	50818180	.	C	T	7	5	12	0	0	12	0	0
8	50835236	.	T	A	4	2	6	0	0	6	0	0
8	50835254	.	A	G	3	3	6	0	0	6	0	0
8	50837603	.	C	T	3	3	6	0	0	6	0	0
8	50837684	.	G	C	1	3	4	0	0	4	0	0
8	50837731	.	A	G	2	2	4	0	0	4	0	0
8	50838854	.	G	A	5	4	9	0	0	9	0	0
8	50845104	.	T	C	6	8	14	0	1	15	0	0
8	50849973	.	C	T	3	10	13	0	0	13	0	0
8	50890422	.	A	T	7	6	13	0	0	13	0	0
8	50898126	.	C	T	1	7	8	0	4	12	0	0
8	50942296	.	T	G	6	10	16	0	0	16	0	0
8	50947386	.	G	C	19	28	47	0	2	49	0	0
8	50947648	.	T	A	20	14	34	0	1	35	0	0
8	50947807	.	C	T	10	2	12	4	0	16	0	0
8	50949040	.	T	A	18	15	33	0	1	35	1	0
8	50949086	.	T	A	11	11	22	3	0	25	0	0
8	50949128	.	T	C	19	12	31	3	0	34	0	0
8	50949160	.	A	T	20	14	34	0	1	35	0	0
8	50949188	.	C	T	22	18	40	0	0	40	0	0
8	50949430	.	T	A	31	16	47	0	3	50	0	0
8	50949479	.	A	G	19	36	55	0	1	56	0	0
8	50949501	.	A	T	40	21	61	0	2	63	0	0
8	50949570	.	G	A	32	27	59	2	2	63	0	0
8	50949573	.	G	A	30	27	57	2	3	62	0	0
8	50949639	.	C	T	26	21	47	3	5	55	0	0
8	50949766	.	C	T	5	14	19	0	0	19	0	0
8	50949903	.	A	G	27	0	27	0	18	45	0	0
8	50960443	.	C	A	7	11	18	0	0	18	0	0
8	50960542	.	T	C	11	13	24	0	3	27	0	0
8	50962536	.	T	C	17	21	38	0	1	39	0	0
8	50962623	.	T	G	19	1	20	0	16	36	0	0
8	50967774	.	C	G	7	8	15	0	1	16	0	0
8	50967890	.	C	T	5	9	14	0	1	15	0	0
8	50969141	.	T	C	3	7	10	0	1	11	0	0
8	50969150	.	A	G	6	8	14	0	0	14	0	0
8	50969367	.	G	A	6	5	11	0	0	11	0	0
8	50969493	.	T	A	3	7	10	1	2	13	0	0
8	50971524	.	G	A	11	6	17	1	1	19	0	0
8	50972267	.	C	T	7	7	14	0	1	15	0	0
8	50983992	.	C	A	1	2	3	0	0	3	0	0
8	51008419	.	T	C	1	4	5	0	0	5	0	0
8	51008524	.	T	G	4	2	6	1	0	7	0	0
8	51027069	.	C	T	4	3	7	0	0	7	0	0
8	51027111	.	T	G	3	3	6	0	0	6	0	0
8	51027123	.	C	A	1	2	3	0	0	3	0	0
8	51134832	.	A	C	1	2	3	0	0	3	0	0
8	51147570	.	A	G	2	3	5	0	0	5	0	0
8	51165572	.	T	C	5	12	17	0	0	17	0	0
8	51165786	.	C	A	0	8	8	0	8	16	0	0
8	51173843	.	A	G	6	5	11	0	1	12	0	0
8	51175677	.	G	A	2	2	4	0	1	5	0	0
8	51195100	.	G	A	2	3	5	0	0	5	0	0
8	51247891	.	G	C	1	2	3	0	0	3	0	0
8	51309145	.	T	G	20	12	32	0	2	34	0	0
8	51309311	.	A	G	15	14	29	0	1	30	0	0
8	51314087	.	G	A	15	13	28	0	0	28	0	0
8	51320547	.	C	T	15	13	28	0	1	29	0	0
8	51320652	.	C	T	9	10	19	1	0	20	0	0
8	51325510	.	T	G	10	9	19	0	0	19	0	0
8	51330776	.	T	C	9	10	19	0	0	19	0	0
8	51330836	.	A	T	5	4	9	0	0	9	0	0
8	51351121	.	C	T	14	8	22	0	0	22	0	0
8	51351155	.	T	A	7	6	13	0	1	14	0	0
8	51351200	.	A	T	6	11	17	0	1	18	0	0
8	51352480	.	A	G	12	12	24	0	1	25	0	0
8	51352525	.	A	T	13	16	29	0	0	29	0	0
8	51358769	.	G	A	15	11	26	0	1	27	0	0
8	51364515	.	T	C	5	6	11	0	1	12	0	0
8	51364644	.	C	A	1	8	9	0	16	25	0	0
8	51364665	.	T	C	17	8	25	0	2	27	0	0
8	51364696	.	C	G	12	7	19	0	3	22	0	0
8	51364713	.	C	A	1	8	9	0	10	19	0	0
8	51367178	.	A	T	13	6	19	0	1	20	0	0
8	51367206	.	C	T	14	5	19	0	1	20	0	0
8	51367217	.	C	T	15	7	22	0	0	22	0	0
8	51367267	.	A	T	5	12	17	0	0	17	0	0
8	51375405	.	T	G	16	10	26	0	3	29	0	0
8	51379609	.	G	A	7	5	12	0	0	12	0	0
8	51379699	.	G	A	4	6	10	0	0	10	0	0
8	51379741	.	A	T	2	7	9	0	0	9	0	0
8	51379747	.	G	A	2	6	8	0	1	9	0	0
8	51383765	.	C	T	1	2	3	0	0	3	0	0
8	51431321	.	T	A	16	7	23	0	0	23	0	0
8	51431396	.	C	T	2	7	9	0	10	19	0	0
8	51431477	.	G	A	7	4	11	0	0	11	0	0
8	51431526	.	A	T	7	4	11	0	0	11	0	0
8	51431561	.	A	G	8	6	14	0	0	14	0	0
8	51431573	.	A	T	7	6	13	0	0	13	0	0
8	51431805	.	T	A	6	4	10	0	1	11	0	0
8	51432733	.	C	A	2	2	4	0	0	4	0	0
8	51433088	.	C	T	8	3	11	0	0	11	0	0
8	51433141	.	G	T	3	3	6	0	0	6	0	0
8	51433238	.	A	G	4	3	7	0	0	7	0	0
8	51433258	.	C	A	4	4	8	0	1	9	0	0
8	51433310	.	T	G	1	2	3	0	0	3	0	0
8	51433569	.	G	A	2	4	6	0	0	6	0	0
8	51433604	.	C	T	0	3	3	0	1	4	0	0
8	51434224	.	G	C	1	3	4	0	1	5	0	0
8	51434289	.	C	T	2	3	5	0	0	5	0	0
8	51434330	.	C	A	1	4	5	0	2	7	0	0
8	51434357	.	C	G	2	4	6	0	0	6	0	0
8	51437323	.	A	G	3	3	6	0	0	6	0	0
8	51573346	.	C	G	2	2	4	0	0	4	0	0
8	51573385	.	C	T	3	2	5	0	0	5	0	0
8	51573406	.	A	T	2	2	4	0	0	4	0	0
8	51576856	.	C	T	0	4	4	0	3	7	0	0
8	51576887	.	C	T	1	2	3	0	2	5	0	0
8	51576925	.	C	T	0	3	3	0	2	5	0	0
8	51635607	.	C	T	0	2	2	0	2	4	0	0
8	51635631	.	C	T	2	3	5	0	0	5	0	0
8	51713542	.	G	A	0	3	3	0	1	4	0	0
8	51721863	.	A	T	1	2	3	0	0	3	0	0
8	51723164	.	C	T	1	3	4	0	0	4	0	0
8	51723249	.	A	G	1	3	4	3	0	7	0	0
8	51723285	.	G	A	1	18	19	4	1	24	0	0
8	51723320	.	A	G	2	15	17	2	0	19	0	0
8	51723957	.	T	C	3	3	6	0	0	6	0	0
8	51723984	.	A	T	7	5	12	0	0	12	0	0
8	51724029	.	T	G	7	4	11	0	0	11	0	0
8	51724067	.	C	T	3	3	6	0	1	7	0	0
8	51724371	.	A	T	2	2	4	0	0	4	0	0
8	51724389	.	T	A	2	2	4	0	0	4	0	0
8	51724748	.	G	C	0	2	2	0	2	4	0	0
8	51724857	.	G	A	6	4	10	0	0	10	0	0
8	51724928	.	G	T	3	3	6	0	1	7	0	0
8	51724974	.	G	A	3	3	6	0	1	7	0	0
8	51725237	.	C	G	13	3	16	0	0	16	0	0
8	51725241	.	G	T	14	4	18	0	0	18	0	0
8	51726166	.	C	T	6	2	8	0	0	8	0	0
8	51726299	.	T	A	3	2	5	0	0	5	0	0
8	52292515	.	T	C	7	6	13	0	0	13	0	0
8	52314637	.	G	T	0	2	2	0	5	7	0	0
8	52322189	.	C	G	3	0	3	0	2	5	0	0
8	52324918	.	A	G	4	5	9	0	0	9	0	0
8	52336870	.	T	C	2	3	5	0	0	5	0	0
8	52342586	.	A	C	7	4	11	0	0	11	0	0
8	52345733	.	T	C	9	5	14	0	1	15	0	0
8	52345751	.	T	C	11	8	19	0	0	19	0	0
8	52345915	.	T	C	3	10	13	0	0	13	0	0
8	52346035	.	T	C	4	4	8	0	2	10	0	0
8	52346072	.	A	T	2	8	10	0	0	10	0	0
8	52346111	.	A	C	2	7	9	0	0	9	0	0
8	52346225	.	A	T	6	6	12	0	0	12	0	0
8	52347460	.	C	T	7	4	11	0	3	14	0	0
8	52347772	.	A	G	4	5	9	0	1	10	0	0
8	52348159	.	A	G	7	4	11	0	1	12	0	0
8	52348237	.	A	G	2	6	8	0	0	8	0	0
8	52348575	.	A	G	4	3	7	0	0	7	0	0
8	52348576	.	A	G	5	3	8	0	0	8	0	0
8	52348648	.	A	G	8	5	13	0	0	13	0	0
8	52348685	.	T	C	6	12	18	0	0	18	0	0
8	52349080	.	T	G	6	6	12	0	0	12	0	0
8	52349607	.	A	G	6	26	32	0	1	33	0	0
8	52349983	.	A	G	13	4	17	0	1	18	0	0
8	52350101	.	A	G	11	0	11	1	8	22	2	0
8	52350146	.	A	G	12	0	12	1	17	30	0	0
8	52350251	.	A	G	9	11	20	0	3	23	0	0
8	52350322	.	T	G	4	4	8	0	0	8	0	0
8	52402258	.	C	A	1	2	3	0	0	3	0	0
8	52408619	.	G	A	31	21	52	0	2	54	0	0
8	52411451	.	T	C	19	17	36	0	2	38	0	0
8	52412982	.	A	G	25	11	36	0	0	36	0	0
8	52412985	.	C	G	22	11	33	0	1	34	0	0
8	52453432	.	A	C	4	2	6	0	1	7	0	0
8	52453862	.	T	A	7	4	11	0	0	11	0	0
8	52455588	.	A	G	2	5	7	0	0	7	0	0
8	52455610	.	A	G	2	4	6	0	0	6	0	0
8	52455638	.	C	G	2	2	4	0	0	4	0	0
8	52463828	.	T	A	2	3	5	0	1	6	0	0
8	52463855	.	C	T	0	3	3	0	1	4	0	0
8	52491586	.	G	A	8	3	11	0	0	11	0	0
8	52509762	.	A	T	6	2	8	0	0	8	0	0
8	52510088	.	C	T	1	3	4	0	0	4	0	0
8	52521261	.	T	C	5	3	8	0	0	8	0	0
8	52521280	.	T	G	3	3	6	0	2	8	0	0
8	52521310	.	T	A	3	4	7	0	0	7	0	0
8	52521648	.	T	C	7	7	14	0	0	14	0	0
8	52521802	.	A	T	6	9	15	0	1	16	0	0
8	52521832	.	T	G	4	0	4	0	9	13	0	0
8	52524436	.	A	T	8	6	14	0	0	14	0	0
8	52527359	.	C	G	4	9	13	0	1	14	0	0
8	52527391	.	A	T	3	6	9	0	1	10	0	0
8	52527452	.	T	C	3	3	6	0	0	6	0	0
8	52527547	.	A	C	6	5	11	0	0	11	0	0
8	52528665	.	A	G	13	6	19	0	0	19	0	0
8	52528717	.	A	G	7	13	20	0	3	23	0	0
8	52528786	.	A	G	10	3	13	0	0	13	0	0
8	52528791	.	A	G	11	0	11	0	2	13	0	0
8	52528856	.	C	G	4	7	11	0	0	11	0	0
8	52528964	.	T	A	1	2	3	0	1	4	0	0
8	52529169	.	A	G	7	4	11	0	0	11	0	0
8	52529206	.	T	C	5	8	13	0	0	13	0	0
8	52529397	.	A	G	13	7	20	0	0	20	0	0
8	52533968	.	C	G	2	3	5	0	0	5	0	0
8	52534158	.	A	G	1	5	6	0	0	6	0	0
8	52537984	.	A	G	4	0	4	0	4	8	0	0
8	52538042	.	A	T	6	3	9	0	0	9	0	0
8	52543717	.	C	A	5	7	12	0	0	12	0	0
8	52547038	.	T	G	6	10	16	0	0	16	0	0
8	52547091	.	T	C	4	5	9	0	3	12	0	0
8	52547522	.	C	T	7	6	13	0	1	14	0	0
8	52547523	.	G	A	0	6	6	0	8	14	0	0
8	52547569	.	T	A	7	9	16	0	0	16	0	0
8	52547664	.	A	C	2	4	6	0	0	6	0	0
8	52547677	.	C	T	2	4	6	0	0	6	0	0
8	52547706	.	A	T	3	6	9	0	3	12	0	0
8	52547727	.	G	C	4	6	10	0	0	10	0	0
8	52547787	.	T	A	3	4	7	0	0	7	0	0
8	52547829	.	T	G	4	4	8	0	0	8	0	0
8	52547902	.	T	A	3	2	5	0	1	6	0	0
8	52550462	.	A	G	6	3	9	0	0	9	0	0
8	52550502	.	T	A	7	2	9	0	0	9	0	0
8	52553193	.	A	T	8	3	11	0	2	13	0	0
8	52553197	.	A	G	7	6	13	0	2	15	0	0
8	52554679	.	T	C	13	0	13	0	13	26	0	0
8	52554937	.	T	G	5	6	11	0	0	11	0	0
8	52554983	.	C	T	7	8	15	0	1	16	0	0
8	52555018	.	T	G	7	8	15	0	2	17	0	0
8	52555050	.	G	A	8	6	14	0	0	14	0	0
8	52555077	.	C	G	7	7	14	0	0	14	0	0
8	52555112	.	G	T	7	9	16	0	0	16	0	0
8	52555137	.	G	A	8	10	18	0	0	18	0	0
8	52557454	.	G	T	2	4	6	0	0	6	0	0
8	52559977	.	T	C	5	4	9	0	0	9	0	0
8	52559996	.	G	T	7	2	9	0	0	9	0	0
8	52560034	.	T	C	8	5	13	1	1	15	0	0
8	52560058	.	T	C	9	7	16	1	0	17	0	0
8	52562746	.	C	T	6	3	9	0	1	10	0	0
8	52564816	.	T	C	6	9	15	0	0	15	0	0
8	52564922	.	C	T	7	4	11	0	0	11	0	0
8	52565319	.	T	C	2	5	7	0	0	7	0	0
8	52571198	.	T	C	4	4	8	0	0	8	0	0
8	52575791	.	C	T	2	5	7	0	0	7	0	0
8	52575981	.	G	A	4	3	7	0	0	7	0	0
8	52576003	.	A	G	3	5	8	0	0	8	0	0
8	52576054	.	C	T	0	4	4	0	2	6	0	0
8	52580094	.	A	G	4	5	9	0	1	10	0	0
8	52580169	.	A	G	3	4	7	0	0	7	0	0
8	52580196	.	A	T	1	3	4	0	0	4	0	0
8	52588519	.	G	A	3	1	4	0	0	4	0	0
8	52588540	.	G	A	3	2	5	0	1	6	0	0
8	52601280	.	A	G	1	2	3	0	0	3	0	0
8	52630431	.	C	A	2	1	3	0	1	4	0	0
8	52630433	.	T	A	2	1	3	0	1	4	0	0
8	53069348	.	G	A	1	2	3	0	0	3	0	0
8	53081134	.	C	T	1	2	3	0	1	4	0	0
8	53082186	.	G	C	5	3	8	0	0	8	0	0
8	53087090	.	C	T	2	3	5	0	0	5	0	0
8	53087121	.	C	A	4	3	7	0	1	8	0	0
8	53089843	.	G	A	1	2	3	0	6	9	0	0
8	53090005	.	A	G	6	2	8	0	0	8	0	0
8	53095146	.	G	A	11	7	18	0	3	21	0	0
8	53095179	.	A	G	7	9	16	0	1	17	0	0
8	53149276	.	T	C	7	3	10	0	0	10	0	0
8	53152039	.	C	G	2	3	5	0	0	5	0	0
8	53398564	.	A	G	8	6	14	0	0	14	0	0
8	53398992	.	A	G	5	4	9	0	0	9	0	0
8	53399003	.	A	G	2	5	7	0	0	7	0	0
8	53751413	.	G	A	7	4	11	0	0	11	0	0
8	53752762	.	C	T	1	4	5	0	2	7	0	0
8	53756111	.	G	T	1	5	6	0	1	7	0	0
8	53756168	.	C	T	5	2	7	0	0	7	0	0
8	53757642	.	G	T	1	2	3	0	0	3	0	0
8	53765095	.	C	T	0	3	3	0	2	5	0	0
8	53769634	.	C	T	0	2	2	0	1	3	0	0
8	53769685	.	C	A	1	2	3	0	1	4	0	0
8	53769686	.	A	T	0	2	2	0	1	3	0	0
8	53794163	.	T	A	7	9	16	0	0	16	0	0
8	53794250	.	T	C	7	11	18	0	1	19	0	0
8	53794943	.	T	G	6	4	10	0	0	10	0	0
8	53795006	.	C	T	8	13	21	0	0	21	0	0
8	53795162	.	A	G	7	3	10	0	0	10	0	0
8	53795249	.	G	A	1	2	3	0	0	3	0	0
8	53795411	.	T	C	5	3	8	0	0	8	0	0
8	53795602	.	T	A	7	9	16	0	0	16	0	0
8	53795636	.	A	T	3	8	11	0	0	11	0	0
8	53795640	.	A	G	3	8	11	0	0	11	0	0
8	53795684	.	T	C	3	1	4	0	8	12	0	0
8	53795692	.	G	A	3	8	11	0	0	11	0	0
8	53795892	.	G	T	7	14	21	0	2	23	0	0
8	53796657	.	C	T	2	3	5	0	0	5	0	0
8	53796833	.	T	C	1	5	6	0	0	6	0	0
8	53797040	.	A	G	5	2	7	0	0	7	0	0
8	53797118	.	G	T	4	5	9	0	0	9	0	0
8	53797802	.	A	C	2	3	5	0	0	5	0	0
8	53798130	.	A	G	2	4	6	0	1	7	0	0
8	53798168	.	A	G	3	6	9	0	1	10	0	0
8	53798321	.	T	A	4	2	6	0	0	6	0	0
8	53798333	.	G	A	4	2	6	0	0	6	0	0
8	53798450	.	T	G	2	3	5	0	1	6	0	0
8	53798864	.	A	G	3	3	6	0	0	6	0	0
8	53799491	.	T	A	1	2	3	0	0	3	0	0
8	53799521	.	G	A	1	2	3	0	0	3	0	0
8	53803121	.	G	T	0	2	2	0	1	3	0	0
8	53803139	.	A	T	1	5	6	0	0	6	0	0
8	53803376	.	T	C	1	3	4	0	0	4	0	0
8	53867228	.	A	G	6	5	11	0	0	11	0	0
8	53867242	.	A	G	5	7	12	0	0	12	0	0
8	53876632	.	C	T	3	2	5	0	0	5	0	0
8	53918323	.	A	T	4	5	9	0	0	9	0	0
8	53918472	.	T	C	9	11	20	0	1	21	0	0
8	53918600	.	T	A	6	3	9	3	0	12	0	0
8	53918664	.	C	T	12	7	19	0	1	20	0	0
8	53918730	.	T	C	10	6	16	0	2	18	0	0
8	53918790	.	G	T	5	5	10	0	1	11	0	0
8	53918899	.	C	T	3	3	6	0	0	6	0	0
8	53919124	.	C	A	10	5	15	0	0	15	0	0
8	53921722	.	A	G	8	6	14	0	1	15	0	0
8	53921779	.	G	A	7	6	13	0	0	13	0	0
8	53921797	.	A	G	9	9	18	0	0	18	0	0
8	53921815	.	A	G	12	9	21	0	0	21	0	0
8	53922034	.	A	G	8	10	18	0	2	20	0	0
8	53940977	.	T	C	1	7	8	0	0	8	0	0
8	53942440	.	T	C	5	4	9	0	0	9	0	0
8	53948412	.	C	T	5	5	10	0	1	11	0	0
8	53948434	.	G	A	8	5	13	0	0	13	0	0
8	53948501	.	T	C	6	8	14	0	1	15	0	0
8	53949706	.	G	A	8	17	25	0	0	25	0	0
8	53950181	.	T	C	15	0	15	0	10	25	0	0
8	53953420	.	C	G	7	16	23	0	0	23	0	0
8	53956476	.	T	G	10	10	20	0	1	21	0	0
8	53956530	.	T	G	10	11	21	0	2	23	0	0
8	53959378	.	T	C	9	8	17	0	1	18	0	0
8	53984570	.	C	T	2	3	5	0	2	7	0	0
8	53989243	.	T	C	3	0	3	0	4	7	0	0
8	54013347	.	A	T	5	9	14	0	0	14	0	0
8	54013545	.	G	A	0	20	20	1	0	21	0	0
8	54013556	.	T	A	16	6	22	1	2	25	0	0
8	54013594	.	G	T	6	6	12	0	0	12	0	0
8	54023714	.	A	G	9	0	9	0	10	19	0	0
8	54034280	.	G	A	0	2	2	0	1	3	0	0
8	54034289	.	A	G	1	2	3	0	0	3	0	0
8	54128964	.	A	G	12	0	12	0	14	26	0	0
8	54129735	.	G	A	3	11	14	0	22	36	0	0
8	54129767	.	G	A	18	18	36	0	0	36	0	0
8	54129774	.	T	C	19	17	36	0	1	37	0	0
8	54129867	.	A	C	8	7	15	0	1	16	0	0
8	54130103	.	T	G	5	8	13	0	1	14	0	0
8	54130203	.	T	G	8	6	14	0	1	15	0	0
8	54130249	.	T	C	8	5	13	3	2	18	0	0
8	54130253	.	G	A	8	6	14	3	1	18	0	0
8	54130346	.	A	G	5	0	5	0	6	12	1	0
8	54131660	.	G	T	15	6	21	0	1	22	0	0
8	54131669	.	A	G	12	5	17	0	2	19	0	0
8	54131889	.	T	G	7	8	15	0	1	16	0	0
8	54132024	.	C	G	13	5	18	0	0	18	0	0
8	54132044	.	C	T	10	9	19	0	1	20	0	0
8	54132084	.	C	G	9	10	19	0	1	20	0	0
8	54132248	.	T	A	5	3	8	2	1	11	0	0
8	54132477	.	G	T	1	2	3	0	0	3	0	0
8	54132531	.	A	G	1	3	4	0	0	4	0	0
8	54132773	.	C	T	3	2	5	0	0	5	0	0
8	54133376	.	A	G	14	21	35	0	3	38	0	0
8	54133403	.	A	T	15	14	29	0	0	29	0	0
8	54133450	.	G	A	18	12	30	0	2	32	0	0
8	54133522	.	G	A	11	14	25	0	0	25	0	0
8	54135717	.	T	C	3	4	7	0	0	7	0	0
8	54137658	.	T	C	1	2	3	0	0	3	0	0
8	54137805	.	T	G	3	5	8	0	1	9	0	0
8	54137874	.	G	C	0	5	5	0	0	6	1	0
8	54137895	.	A	G	4	0	4	0	1	5	0	0
8	54145198	.	A	G	4	3	7	0	0	7	0	0
8	54147056	.	T	C	6	4	10	0	0	10	0	0
8	54151403	.	C	T	6	5	11	0	0	11	0	0
8	54155012	.	C	A	6	10	16	0	0	16	0	0
8	54202655	.	C	T	8	8	16	0	1	17	0	0
8	54203198	.	A	G	10	6	16	0	0	16	0	0
8	54208231	.	A	G	14	7	21	0	0	21	0	0
8	54208282	.	C	T	12	15	27	0	0	28	1	0
8	54208572	.	C	T	13	20	33	0	0	33	0	0
8	54210066	.	G	A	21	12	33	0	0	33	0	0
8	54210081	.	C	T	18	16	34	0	1	35	0	0
8	54211989	.	G	A	2	2	4	0	0	4	0	0
8	54211991	.	G	A	2	2	4	0	0	4	0	0
8	54213074	.	G	A	7	5	12	0	0	12	0	0
8	54213461	.	A	G	7	8	15	0	0	15	0	0
8	54213462	.	C	T	7	8	15	0	0	15	0	0
8	54220876	.	T	A	12	26	38	0	2	40	0	0
8	54220949	.	T	C	32	11	43	0	5	48	0	0
8	54221065	.	A	T	28	21	49	1	1	51	0	0
8	54221067	.	T	C	36	15	51	1	1	53	0	0
8	54221243	.	T	C	17	1	18	0	26	44	0	0
8	54221390	.	T	C	27	10	37	0	7	44	0	0
8	54221573	.	T	C	18	0	18	0	22	40	0	0
8	54221812	.	G	C	28	23	51	0	2	53	0	0
8	54221927	.	C	T	21	25	46	0	4	50	0	0
8	54221966	.	G	A	22	22	44	0	0	44	0	0
9	24528	.	C	T	14	17	31	0	1	32	0	0
9	37058	.	G	A	22	9	31	0	4	35	0	0
9	37199	.	G	A	16	11	27	0	1	28	0	0
9	37830	.	C	T	0	12	12	0	10	22	0	0
9	54479	.	C	T	8	14	22	0	0	22	0	0
9	62336	.	T	C	21	12	33	0	2	35	0	0
9	62351	.	A	G	17	10	27	0	4	31	0	0
9	62528	.	T	G	13	23	36	0	4	40	0	0
9	63313	.	G	A	12	17	29	0	0	29	0	0
9	63418	.	G	A	10	14	24	0	1	25	0	0
9	63532	.	G	A	13	10	23	0	2	25	0	0
9	63604	.	G	A	8	8	16	0	2	18	0	0
9	64739	.	C	A	0	12	12	0	4	16	0	0
9	74903	.	T	G	2	3	5	0	0	5	0	0
9	78506	.	T	C	2	2	4	0	0	4	0	0
9	83785	.	T	C	2	2	4	0	0	4	0	0
9	84070	.	G	A	0	1	1	0	1	2	0	0
9	84216	.	G	A	2	4	6	0	0	6	0	0
9	84247	.	A	G	5	0	5	0	3	8	0	0
9	84293	.	A	G	5	3	8	0	0	8	0	0
9	84487	.	A	G	1	4	5	0	0	5	0	0
9	84617	.	A	T	2	2	4	0	0	4	0	0
9	85318	.	T	C	4	7	11	0	0	11	0	0
9	85846	.	A	G	4	5	9	0	0	9	0	0
9	86089	.	A	G	5	6	11	0	1	12	0	0
9	86107	.	C	G	6	5	11	0	0	11	0	0
9	86439	.	T	C	6	2	8	0	0	8	0	0
9	86719	.	T	C	8	4	12	0	0	12	0	0
9	86767	.	T	C	9	4	13	0	2	15	0	0
9	86830	.	T	C	6	7	13	0	0	13	0	0
9	89407	.	C	T	7	9	16	0	1	17	0	0
9	90189	.	A	G	13	5	18	2	5	25	0	0
9	90507	.	G	C	1	4	5	0	6	11	0	0
9	94276	.	T	C	7	20	27	0	1	28	0	0
9	97312	.	G	A	1	5	6	0	0	6	0	0
9	97348	.	G	A	1	4	5	0	0	5	0	0
9	97930	.	A	G	1	1	2	0	1	3	0	0
9	98499	.	G	A	1	2	3	0	0	3	0	0
9	103432	.	T	C	10	10	20	0	1	21	0	0
9	104840	.	G	A	11	8	19	0	0	19	0	0
9	104862	.	T	G	8	4	12	0	1	13	0	0
9	105091	.	C	T	1	8	9	0	8	17	0	0
9	134835	.	C	T	0	2	2	0	3	5	0	0
9	134945	.	C	T	0	6	6	0	3	9	0	0
9	134949	.	C	T	0	5	5	0	3	8	0	0
9	134999	.	C	T	0	2	2	0	1	3	0	0
9	145913	.	G	A	4	6	10	0	1	11	0	0
9	147357	.	A	G	8	7	15	0	0	15	0	0
9	148333	.	G	A	0	12	12	1	13	26	0	0
9	148339	.	A	G	12	12	24	1	1	26	0	0
9	149078	.	G	A	0	16	16	0	9	25	0	0
9	149215	.	C	A	16	9	25	0	3	28	0	0
9	149251	.	A	T	10	14	24	0	1	25	0	0
9	153001	.	C	T	11	6	17	0	4	21	0	0
9	168462	.	A	T	1	11	12	0	0	12	0	0
9	168754	.	T	C	5	1	6	0	4	10	0	0
9	168760	.	T	C	2	7	9	0	0	9	0	0
9	168848	.	T	C	10	5	15	0	0	15	0	0
9	168918	.	A	G	12	5	17	0	0	17	0	0
9	169015	.	T	C	1	8	9	0	1	10	0	0
9	169806	.	G	C	22	1	23	0	16	39	0	0
9	170845	.	G	T	18	13	31	0	2	33	0	0
9	170945	.	G	A	11	11	22	0	0	22	0	0
9	172661	.	C	T	7	14	21	0	3	24	0	0
9	180245	.	G	A	12	12	24	0	0	24	0	0
9	195259	.	A	G	1	3	4	0	0	4	0	0
9	225257	.	C	T	3	5	8	0	0	8	0	0
9	225362	.	T	C	7	5	12	0	0	12	0	0
9	225371	.	T	C	7	6	13	0	0	13	0	0
9	225599	.	C	T	2	6	8	0	1	9	0	0
9	225656	.	C	T	5	3	8	0	1	9	0	0
9	227072	.	C	T	6	4	10	0	0	10	0	0
9	233295	.	A	G	4	0	4	0	6	10	0	0
9	233922	.	C	T	13	6	19	0	2	21	0	0
9	234328	.	G	A	14	9	23	0	0	23	0	0
9	235262	.	G	T	1	11	12	0	6	18	0	0
9	235365	.	T	A	10	10	20	0	1	21	0	0
9	235567	.	C	G	4	3	7	0	0	7	0	0
9	253264	.	T	C	19	1	20	0	21	41	0	0
9	254484	.	A	G	28	31	59	0	5	64	0	0
9	257890	.	A	T	22	26	48	0	7	55	0	0
9	257926	.	G	C	25	0	25	0	31	56	0	0
9	262487	.	A	G	25	27	52	0	2	54	0	0
9	262511	.	C	T	4	26	30	0	24	54	0	0
9	266053	.	T	C	14	18	32	0	2	34	0	0
9	266227	.	T	C	28	30	58	0	0	58	0	0
9	266255	.	C	T	32	29	61	0	1	62	0	0
9	266445	.	G	C	27	28	55	0	3	58	0	0
9	266572	.	T	C	35	0	35	0	28	63	0	0
9	266721	.	A	G	18	18	36	0	1	37	0	0
9	266802	.	A	C	25	18	43	0	1	44	0	0
9	266875	.	T	C	31	10	41	0	4	45	0	0
9	266910	.	G	A	29	21	50	0	2	52	0	0
9	267081	.	A	G	38	25	63	0	2	65	0	0
9	267290	.	G	A	43	26	69	1	0	70	0	0
9	275474	.	G	A	21	25	46	1	8	55	0	0
9	276059	.	A	G	19	22	41	1	2	44	0	0
9	278150	.	A	G	24	24	48	0	1	49	0	0
9	278174	.	G	A	24	18	42	0	4	46	0	0
9	282686	.	C	T	22	19	41	0	1	42	0	0
9	282737	.	T	C	18	1	19	0	19	38	0	0
9	296052	.	G	A	21	16	37	0	1	38	0	0
9	296177	.	T	A	24	17	41	0	1	42	0	0
9	296181	.	T	C	22	3	25	0	16	41	0	0
9	298930	.	A	G	2	3	5	0	0	5	0	0
9	298970	.	A	G	2	6	8	0	0	8	0	0
9	299247	.	C	T	2	2	4	0	1	5	0	0
9	301535	.	A	T	7	4	11	0	0	11	0	0
9	302720	.	T	C	3	7	10	0	0	10	0	0
9	303032	.	C	G	3	7	10	0	0	10	0	0
9	303061	.	T	C	6	0	6	0	7	13	0	0
9	303070	.	T	C	4	6	10	0	3	13	0	0
9	303288	.	C	T	1	5	6	0	2	8	0	0
9	323588	.	A	G	9	4	13	0	0	13	0	0
9	323762	.	T	C	6	3	9	0	2	11	0	0
9	323861	.	C	T	5	3	8	0	0	8	0	0
9	326140	.	C	T	2	4	6	0	0	6	0	0
9	336102	.	C	G	4	4	8	0	0	8	0	0
9	336776	.	G	T	4	4	8	0	0	8	0	0
9	336852	.	A	T	8	3	11	0	1	12	0	0
9	336863	.	A	G	6	0	6	0	5	11	0	0
9	339332	.	T	C	6	6	12	0	0	12	0	0
9	340075	.	T	C	10	4	14	0	0	14	0	0
9	340076	.	A	T	9	4	13	0	1	14	0	0
9	340170	.	T	C	3	2	5	0	1	6	0	0
9	355324	.	A	G	2	5	7	0	0	7	0	0
9	355348	.	G	A	4	2	6	0	0	6	0	0
9	355411	.	A	C	4	3	7	0	0	7	0	0
9	360846	.	G	A	1	3	4	0	0	4	0	0
9	426448	.	A	G	1	2	3	0	0	3	0	0
9	427925	.	T	C	3	7	10	0	1	11	0	0
9	429277	.	A	T	3	3	6	0	0	6	0	0
9	430071	.	T	C	6	8	14	0	0	14	0	0
9	431089	.	C	T	2	3	5	0	0	5	0	0
9	431137	.	C	T	4	5	9	0	2	11	0	0
9	432680	.	G	C	1	2	3	0	0	3	0	0
9	433764	.	C	T	3	3	6	0	0	6	0	0
9	447026	.	T	C	3	2	5	0	0	5	0	0
9	447039	.	T	C	1	3	4	0	0	4	0	0
9	458995	.	T	A	10	11	21	0	1	22	0	0
9	459042	.	A	T	11	11	22	0	2	24	0	0
9	459754	.	C	T	15	11	26	0	1	27	0	0
9	459755	.	T	C	14	0	14	0	13	27	0	0
9	459893	.	C	T	2	18	20	0	18	38	0	0
9	462959	.	T	G	15	2	17	0	5	22	0	0
9	463005	.	A	C	8	10	18	0	1	19	0	0
9	463010	.	T	C	8	0	8	0	10	18	0	0
9	463206	.	C	T	1	3	4	0	0	4	0	0
9	468064	.	A	G	5	3	8	2	0	10	0	0
9	468067	.	A	G	5	3	8	2	0	10	0	0
9	481749	.	C	A	3	1	4	0	1	5	0	0
9	510956	.	C	G	1	2	3	0	0	3	0	0
9	527969	.	G	A	0	5	5	0	1	6	0	0
9	528441	.	T	G	1	2	3	0	1	4	0	0
9	528905	.	T	C	5	2	7	0	1	8	0	0
9	529012	.	G	T	3	3	6	0	0	6	0	0
9	529147	.	C	T	2	2	4	0	0	4	0	0
9	529824	.	C	A	2	4	6	0	1	7	0	0
9	529849	.	G	A	1	2	3	0	3	6	0	0
9	529957	.	C	T	2	2	4	0	0	4	0	0
9	531319	.	C	A	1	2	3	0	0	3	0	0
9	581466	.	G	A	2	2	4	0	0	4	0	0
9	588454	.	A	G	4	12	16	0	1	17	0	0
9	588456	.	C	T	5	11	16	0	1	17	0	0
9	595354	.	G	A	10	5	15	0	1	16	0	0
9	596596	.	G	A	1	7	8	0	1	9	0	0
9	597342	.	C	T	6	2	8	0	0	8	0	0
9	598720	.	A	G	8	6	14	0	0	14	0	0
9	598795	.	A	G	2	9	11	0	2	13	0	0
9	598819	.	G	A	3	8	11	0	1	12	0	0
9	600609	.	G	A	5	4	9	0	0	9	0	0
9	604848	.	A	G	4	4	8	0	1	9	0	0
9	609055	.	C	T	1	2	3	0	0	3	0	0
9	612636	.	G	A	1	4	5	0	0	5	0	0
9	701575	.	A	T	5	5	10	0	1	11	0	0
9	701934	.	T	C	3	3	6	0	2	8	0	0
9	704662	.	T	A	4	4	8	0	0	8	0	0
9	707682	.	A	G	6	3	9	0	0	9	0	0
9	707996	.	C	T	1	20	21	0	25	46	0	0
9	708075	.	T	C	22	5	27	0	27	54	0	0
9	712883	.	C	T	5	3	8	2	0	10	0	0
9	712898	.	T	C	7	7	14	0	0	14	0	0
9	716225	.	A	G	7	8	15	1	0	16	0	0
9	719729	.	G	A	7	6	13	0	0	13	0	0
9	719825	.	A	G	4	5	9	0	0	9	0	0
9	721472	.	C	T	0	9	9	0	16	25	0	0
9	721822	.	T	A	5	6	11	0	1	12	0	0
9	721829	.	A	G	6	5	11	0	0	11	0	0
9	721916	.	C	A	6	1	7	0	0	7	0	0
9	722965	.	A	G	4	4	8	0	1	9	0	0
9	723004	.	G	A	4	6	10	0	1	11	0	0
9	723044	.	C	T	6	4	10	0	0	10	0	0
9	724532	.	G	A	4	4	8	0	0	8	0	0
9	724592	.	G	A	6	6	12	0	1	13	0	0
9	724616	.	G	A	8	5	13	0	0	13	0	0
9	724664	.	G	C	3	9	12	0	0	12	0	0
9	726870	.	A	G	2	5	7	0	0	7	0	0
9	728531	.	C	A	0	2	2	0	1	3	0	0
9	730515	.	C	T	5	2	7	0	0	7	0	0
9	730539	.	C	A	5	3	8	0	1	9	0	0
9	731356	.	G	A	3	4	7	0	0	7	0	0
9	732191	.	C	T	0	2	2	0	6	8	0	0
9	732218	.	G	A	5	2	7	0	0	7	0	0
9	732227	.	C	T	2	4	6	0	0	6	0	0
9	746006	.	A	G	2	2	4	0	0	4	0	0
9	746040	.	A	G	5	5	10	0	0	10	0	0
9	751441	.	A	G	1	5	6	0	0	6	0	0
9	784873	.	C	T	2	2	4	0	0	4	0	0
9	784881	.	A	G	2	2	4	0	0	4	0	0
9	881678	.	A	T	3	4	7	0	1	8	0	0
9	881735	.	A	T	3	5	8	0	1	9	0	0
9	881773	.	T	A	3	3	6	0	1	7	0	0
9	881905	.	A	C	19	7	26	0	0	26	0	0
9	882143	.	T	C	11	0	11	0	12	23	0	0
9	884904	.	C	T	11	5	16	0	2	18	0	0
9	887854	.	A	G	4	7	11	0	0	11	0	0
9	889433	.	G	A	7	7	14	0	0	14	0	0
9	889514	.	G	C	4	6	10	0	1	11	0	0
9	889520	.	A	T	4	4	8	0	1	9	0	0
9	900550	.	A	T	1	6	7	0	0	7	0	0
9	901137	.	A	G	5	10	15	1	1	17	0	0
9	902265	.	T	C	5	0	5	0	4	9	0	0
9	902877	.	A	G	6	8	14	0	1	15	0	0
9	904118	.	A	T	2	14	16	0	2	18	0	0
9	907564	.	A	G	18	19	37	0	2	39	0	0
9	910882	.	C	T	31	22	53	0	2	55	0	0
9	913874	.	T	C	27	26	53	0	2	55	0	0
9	913882	.	C	T	27	25	52	0	1	53	0	0
9	913909	.	G	A	5	22	27	0	20	47	0	0
9	914097	.	G	T	7	3	10	0	0	10	0	0
9	914190	.	C	T	3	2	5	0	0	5	0	0
9	914445	.	T	C	7	4	11	0	0	11	0	0
9	914675	.	C	T	12	2	14	4	0	18	0	0
9	914702	.	A	T	15	5	20	4	0	24	0	0
9	921602	.	C	T	1	1	2	0	1	3	0	0
9	963731	.	C	T	4	3	7	0	0	7	0	0
9	1133096	.	C	T	1	2	3	0	0	3	0	0
9	1133159	.	C	T	1	5	6	0	0	6	0	0
9	1251672	.	T	G	3	7	10	0	0	10	0	0
9	1271934	.	T	C	1	2	3	0	0	3	0	0
9	1285758	.	A	G	1	0	1	0	2	3	0	0
9	1293974	.	C	T	2	3	5	0	0	5	0	0
9	1296937	.	G	A	1	3	4	0	5	9	0	0
9	1296985	.	T	C	3	5	8	0	0	8	0	0
9	1297000	.	G	A	3	3	6	0	2	8	0	0
9	1297027	.	T	C	2	4	6	0	0	6	0	0
9	1368428	.	T	A	2	6	8	0	0	8	0	0
9	1371021	.	A	G	1	3	4	0	1	5	0	0
9	1371022	.	A	G	3	2	5	0	0	5	0	0
9	1371190	.	C	G	5	3	8	0	0	8	0	0
9	1371362	.	C	T	8	9	17	0	0	17	0	0
9	1371363	.	A	G	10	7	17	0	0	17	0	0
9	1373000	.	A	G	3	4	7	0	0	7	0	0
9	1373075	.	T	G	10	6	16	0	0	16	0	0
9	1373144	.	C	A	6	9	15	0	2	17	0	0
9	1463287	.	T	C	2	2	4	0	0	4	0	0
9	1465005	.	G	A	2	2	4	0	0	4	0	0
9	1469002	.	T	C	6	3	9	0	1	10	0	0
9	1479215	.	G	A	4	3	7	0	0	7	0	0
9	1479254	.	C	T	1	2	3	0	3	6	0	0
9	1565242	.	C	T	2	2	4	0	0	4	0	0
9	1574234	.	A	G	4	2	6	0	0	6	0	0
9	1575727	.	C	T	3	2	5	0	0	5	0	0
9	1576074	.	T	C	1	2	3	0	0	3	0	0
9	1577251	.	T	A	2	2	4	0	0	4	0	0
9	1577542	.	C	A	8	15	23	0	0	23	0	0
9	1579792	.	T	C	5	12	17	0	0	17	0	0
9	1596615	.	G	T	6	2	8	0	0	8	0	0
9	1603024	.	G	A	4	6	10	0	0	10	0	0
9	1643972	.	A	T	2	0	2	0	1	3	0	0
9	1643973	.	G	A	2	1	3	0	0	3	0	0
9	1644303	.	C	A	3	3	6	0	2	8	0	0
9	1679360	.	A	C	2	3	5	0	0	5	0	0
9	1680126	.	A	C	1	2	3	0	0	3	0	0
9	1680375	.	C	T	4	2	6	0	0	6	0	0
9	1680468	.	A	G	4	2	6	0	1	7	0	0
9	1680636	.	A	G	2	9	11	0	0	11	0	0
9	1680660	.	T	A	1	8	9	0	0	9	0	0
9	1680700	.	T	A	1	2	3	0	0	3	0	0
9	1680809	.	A	C	4	3	7	0	0	7	0	0
9	1682619	.	T	C	2	3	5	5	0	10	0	0
9	1682647	.	A	T	4	4	8	0	0	8	0	0
9	1682740	.	G	C	0	7	7	0	12	19	0	0
9	1693082	.	A	C	6	4	10	0	0	10	0	0
9	1693092	.	G	A	6	4	10	0	0	10	0	0
9	1693443	.	G	A	11	11	22	0	1	23	0	0
9	1693494	.	T	G	16	7	23	0	0	23	0	0
9	1694277	.	A	G	11	4	15	0	1	16	0	0
9	1937049	.	T	A	4	3	7	0	1	8	0	0
9	1937440	.	A	T	7	8	15	0	0	15	0	0
9	1938924	.	T	G	3	5	8	0	0	8	0	0
9	1948722	.	G	A	1	2	3	0	0	3	0	0
9	1949195	.	G	T	1	2	3	0	0	3	0	0
9	1950360	.	C	G	1	3	4	0	0	4	0	0
9	1950404	.	C	A	1	2	3	0	0	3	0	0
9	1950476	.	C	T	3	2	5	0	1	6	0	0
9	1950477	.	T	A	2	3	5	0	1	6	0	0
9	2003227	.	C	A	1	4	5	0	1	6	0	0
9	2005336	.	A	G	2	0	2	0	4	6	0	0
9	2005822	.	G	A	4	4	8	0	0	8	0	0
9	2045046	.	G	T	1	3	4	0	0	4	0	0
9	2045125	.	T	G	2	2	4	0	0	4	0	0
9	2334127	.	T	A	4	3	7	0	0	7	0	0
9	2334164	.	C	T	17	18	35	2	1	38	0	0
9	2336682	.	A	G	18	2	20	0	26	46	0	0
9	2337291	.	C	T	29	21	50	0	2	52	0	0
9	2340561	.	G	A	30	25	55	1	1	57	0	0
9	2340564	.	G	A	30	21	51	1	3	55	0	0
9	2340618	.	C	T	33	24	57	0	1	58	0	0
9	2340776	.	C	T	36	30	66	0	7	73	0	0
9	2340957	.	T	A	15	14	29	1	2	32	0	0
9	2341035	.	T	C	14	18	32	0	2	34	0	0
9	2351795	.	C	G	3	2	5	0	1	6	0	0
9	2404624	.	A	C	9	7	16	0	0	16	0	0
9	2421012	.	T	A	5	9	14	0	0	14	0	0
9	2423047	.	C	T	5	3	8	0	0	8	0	0
9	2423092	.	C	A	5	6	11	0	1	12	0	0
9	2423119	.	C	T	9	6	15	0	0	15	0	0
9	2452697	.	T	C	10	14	24	0	3	27	0	0
9	2555591	.	A	G	3	3	6	0	0	6	0	0
9	2555631	.	G	A	1	4	5	0	0	5	0	0
9	2555910	.	C	T	1	3	4	0	0	4	0	0
9	2555975	.	T	G	1	2	3	0	0	3	0	0
9	2556415	.	T	A	1	2	3	0	0	3	0	0
9	2556516	.	A	T	3	6	9	0	0	9	0	0
9	2558355	.	G	T	4	4	8	0	1	9	0	0
9	2559047	.	G	A	2	2	4	0	0	4	0	0
9	2559138	.	C	T	3	4	7	0	0	7	0	0
9	2559177	.	C	T	4	5	9	0	0	9	0	0
9	2559204	.	C	T	6	10	16	0	0	16	0	0
9	2559566	.	C	A	2	4	6	0	1	7	0	0
9	2559587	.	G	C	1	1	2	0	1	3	0	0
9	2559640	.	A	T	1	4	5	0	0	5	0	0
9	2559994	.	A	T	6	2	8	0	0	8	0	0
9	2560005	.	C	T	1	5	6	0	0	6	0	0
9	2560712	.	T	A	2	17	19	0	1	20	0	0
9	2560957	.	T	C	1	4	5	0	2	7	0	0
9	2561182	.	A	G	2	6	8	0	1	9	0	0
9	2561205	.	G	T	5	6	11	0	0	11	0	0
9	2561225	.	T	A	5	3	8	0	1	9	0	0
9	2561254	.	C	T	0	7	7	0	3	10	0	0
9	2561322	.	T	A	4	2	6	0	1	7	0	0
9	2561462	.	T	C	1	0	1	0	4	5	0	0
9	2561604	.	C	T	20	11	31	0	2	33	0	0
9	2561632	.	A	T	16	13	29	0	0	29	0	0
9	2564111	.	G	A	19	17	36	0	2	38	0	0
9	2564656	.	G	T	13	19	32	0	2	34	0	0
9	2564788	.	A	T	14	16	30	0	0	30	0	0
9	2564790	.	A	T	14	13	27	0	3	30	0	0
9	2568777	.	C	T	20	17	37	0	0	37	0	0
9	2569372	.	T	G	13	9	22	0	0	22	0	0
9	2572235	.	A	T	15	11	26	0	1	27	0	0
9	2572756	.	A	T	7	16	23	0	1	24	0	0
9	2572809	.	C	T	1	8	9	0	1	10	0	0
9	2576099	.	T	C	12	8	20	0	0	20	0	0
9	2586206	.	A	G	10	0	10	0	13	23	0	0
9	2586259	.	A	G	11	8	19	0	0	19	0	0
9	2586484	.	A	G	7	3	10	0	0	10	0	0
9	2592246	.	C	T	15	10	25	0	1	26	0	0
9	2592518	.	A	T	7	9	16	0	1	17	0	0
9	2592519	.	T	A	10	7	17	0	0	17	0	0
9	2592675	.	G	A	12	17	29	0	1	30	0	0
9	2592960	.	A	G	10	4	14	0	0	14	0	0
9	2592984	.	C	A	2	4	6	0	8	14	0	0
9	2593059	.	C	T	1	5	6	0	10	16	0	0
9	2593518	.	G	A	4	3	7	0	0	7	0	0
9	2593533	.	G	A	2	4	6	0	0	6	0	0
9	2949273	.	G	A	4	4	8	0	0	8	0	0
9	2949291	.	C	A	1	4	5	0	2	7	0	0
9	2949374	.	T	A	3	6	9	0	0	9	0	0
9	2949522	.	G	A	2	5	7	0	0	7	0	0
9	2954058	.	G	C	1	0	1	0	4	5	0	0
9	2954088	.	T	C	2	0	2	0	3	5	0	0
9	2954118	.	G	A	3	3	6	0	0	6	0	0
9	2954224	.	T	C	2	2	4	0	0	4	0	0
9	2961650	.	G	A	2	3	5	0	0	5	0	0
9	3499513	.	T	C	1	0	1	0	2	3	0	0
9	4581003	.	A	G	1	8	9	0	0	9	0	0
9	5041842	.	A	T	4	3	7	0	0	7	0	0
9	5042784	.	A	G	2	1	3	0	1	4	0	0
9	5044371	.	A	T	1	2	3	0	0	3	0	0
9	5904817	.	G	A	3	3	6	0	1	7	0	0
9	6009282	.	C	T	12	9	21	0	1	22	0	0
9	6083012	.	G	A	0	9	9	0	16	25	0	0
9	6083026	.	C	T	10	12	22	0	1	23	0	0
9	6083113	.	C	T	7	11	18	0	0	18	0	0
9	6083169	.	C	T	4	7	11	0	1	12	0	0
9	6083401	.	G	A	15	10	25	0	0	25	0	0
9	6109544	.	A	G	8	9	17	0	0	17	0	0
9	6118622	.	C	T	0	2	2	0	1	3	0	0
9	6123441	.	G	A	12	13	25	0	0	25	0	0
9	6123490	.	G	T	14	8	22	0	0	22	0	0
9	6123742	.	A	C	10	14	24	0	0	24	0	0
9	6123857	.	C	T	3	8	11	0	1	12	0	0
9	6124057	.	G	A	2	7	9	0	11	20	0	0
9	6124100	.	T	C	9	9	18	0	0	18	0	0
9	6124201	.	G	A	0	6	6	0	15	21	0	0
9	6124393	.	C	T	8	4	12	0	0	12	0	0
9	6124478	.	G	A	9	9	18	0	1	19	0	0
9	6124759	.	T	A	10	12	22	0	4	26	0	0
9	6124761	.	T	G	17	9	26	0	0	26	0	0
9	6124884	.	T	C	9	12	21	0	2	23	0	0
9	6125346	.	T	A	4	4	8	0	0	8	0	0
9	6125427	.	G	C	3	4	7	0	0	7	0	0
9	6125501	.	A	C	4	4	8	0	0	8	0	0
9	6125588	.	A	C	1	3	4	0	2	6	0	0
9	6125707	.	T	C	2	5	7	0	0	7	0	0
9	6125732	.	C	T	5	2	7	0	1	8	0	0
9	6125761	.	G	T	5	2	7	0	1	8	0	0
9	6125859	.	T	A	9	17	26	1	0	27	0	0
9	6126074	.	T	A	20	12	32	0	1	33	0	0
9	6126288	.	A	C	20	16	36	0	0	36	0	0
9	6126410	.	G	A	17	17	34	1	4	39	0	0
9	6126469	.	G	A	17	15	32	0	0	32	0	0
9	6126781	.	T	G	15	18	33	0	2	35	0	0
9	6126900	.	C	T	10	11	21	0	0	21	0	0
9	6126911	.	C	A	9	7	16	0	2	18	0	0
9	6127075	.	G	A	3	22	25	0	33	58	0	0
9	6127346	.	C	A	19	9	28	0	2	30	0	0
9	6127357	.	C	T	17	16	33	0	1	34	0	0
9	6660611	.	G	A	12	8	20	0	1	21	0	0
9	6660953	.	C	T	0	6	6	0	7	13	0	0
9	6661361	.	A	T	2	1	3	0	2	5	0	0
9	7030092	.	A	G	2	2	4	0	0	4	0	0
9	7031683	.	C	T	5	6	11	1	1	13	0	0
9	7032231	.	C	A	2	2	4	0	0	4	0	0
9	7039659	.	C	T	1	5	6	0	0	6	0	0
9	7042639	.	C	T	6	6	12	0	0	12	0	0
9	7042659	.	G	A	4	7	11	0	1	12	0	0
9	7042674	.	A	G	3	1	4	0	9	13	0	0
9	7046383	.	A	G	7	6	13	0	0	14	1	0
9	7049484	.	C	G	5	9	14	1	0	15	0	0
9	7056563	.	T	C	12	8	20	0	0	20	0	0
9	7056713	.	A	C	7	9	16	0	0	16	0	0
9	7056968	.	C	T	8	4	12	0	2	14	0	0
9	7092403	.	T	C	12	0	12	0	4	16	0	0
9	7092457	.	T	C	13	5	18	0	1	19	0	0
9	7094141	.	T	C	11	8	19	0	0	19	0	0
9	7094898	.	T	C	12	12	24	0	0	24	0	0
9	7213050	.	A	G	4	8	12	0	0	12	0	0
9	7213565	.	C	T	1	2	3	0	0	3	0	0
9	7213607	.	T	C	3	2	5	0	0	5	0	0
9	7228272	.	C	A	23	12	35	0	5	40	0	0
9	7228487	.	C	A	9	9	18	0	2	20	0	0
9	7229288	.	G	T	16	13	29	1	1	31	0	0
9	7229343	.	T	G	11	16	27	0	2	29	0	0
9	7229347	.	G	A	11	17	28	0	1	29	0	0
9	7229512	.	C	T	20	15	35	0	1	36	0	0
9	7234590	.	G	A	13	10	23	0	0	23	0	0
9	7234618	.	A	C	11	1	12	0	15	27	0	0
9	7234642	.	G	A	10	17	27	0	1	28	0	0
9	7234681	.	A	C	17	11	28	0	1	29	0	0
9	7238498	.	C	T	15	14	29	0	0	29	0	0
9	7238502	.	C	A	13	13	26	0	1	27	0	0
9	7241118	.	G	A	1	3	4	0	0	4	0	0
9	7241409	.	G	T	3	4	7	0	1	8	0	0
9	7241809	.	C	T	0	3	3	0	2	5	0	0
9	7241855	.	C	T	5	4	9	0	0	9	0	0
9	7242056	.	C	T	0	4	4	0	6	10	0	0
9	7243085	.	G	A	4	3	7	0	0	7	0	0
9	7244659	.	T	C	1	3	4	0	1	5	0	0
9	7244985	.	C	T	3	5	8	0	1	9	0	0
9	7245004	.	C	T	4	4	8	0	0	8	0	0
9	7245130	.	G	A	2	7	9	0	0	9	0	0
9	7245218	.	C	T	7	2	9	0	0	9	0	0
9	7245226	.	A	G	7	2	9	0	0	9	0	0
9	7245377	.	C	T	6	2	8	0	1	9	0	0
9	7245681	.	C	G	3	4	7	0	0	7	0	0
9	7245852	.	C	T	0	3	3	0	3	6	0	0
9	7245868	.	C	T	0	3	3	0	5	8	0	0
9	7248886	.	T	C	2	0	2	0	4	6	0	0
9	7249063	.	G	C	3	3	6	0	0	6	0	0
9	7249072	.	T	A	2	3	5	0	0	5	0	0
9	7249156	.	G	A	3	5	8	0	0	8	0	0
9	7249273	.	T	C	4	5	9	0	1	10	0	0
9	7249443	.	G	T	5	4	9	0	0	9	0	0
9	7516095	.	G	T	1	5	6	0	1	7	0	0
9	7548591	.	A	G	4	4	8	0	2	10	0	0
9	7548600	.	T	A	5	4	9	0	1	10	0	0
9	7570857	.	A	G	8	0	8	0	28	36	0	0
9	7570891	.	T	A	20	9	29	0	2	31	0	0
9	7574042	.	T	A	15	16	31	0	0	31	0	0
9	7574126	.	C	T	18	17	35	0	0	35	0	0
9	7574135	.	A	T	18	17	35	0	1	36	0	0
9	7575309	.	G	A	24	17	41	0	4	45	0	0
9	7575545	.	A	C	17	19	36	0	0	36	0	0
9	7578595	.	G	C	16	18	34	0	0	34	0	0
9	7604524	.	G	A	20	23	43	0	5	48	0	0
9	7612711	.	G	A	3	21	24	1	24	55	6	0
9	7612826	.	C	T	26	26	52	1	1	54	0	0
9	7618903	.	A	C	26	30	56	0	4	60	0	0
9	7618906	.	T	C	22	32	54	0	2	56	0	0
9	7621780	.	T	A	3	2	5	0	0	5	0	0
9	7621877	.	C	T	4	4	8	0	0	8	0	0
9	7635236	.	C	G	1	2	3	0	0	3	0	0
9	7635535	.	C	A	6	4	10	0	0	10	0	0
9	7635925	.	G	A	7	5	12	0	1	13	0	0
9	7655020	.	G	A	1	3	4	0	0	4	0	0
9	7671165	.	G	A	7	10	17	0	0	17	0	0
9	7909543	.	G	A	2	3	5	0	0	5	0	0
9	7909621	.	C	A	1	3	4	0	0	4	0	0
9	7909633	.	T	C	2	3	5	0	0	5	0	0
9	7981498	.	C	G	2	0	2	0	2	4	0	0
9	8022101	.	C	T	2	2	4	0	0	4	0	0
9	8022114	.	T	C	0	4	4	0	0	4	0	0
9	8064308	.	C	T	2	2	4	0	0	4	0	0
9	8090089	.	G	T	3	2	5	0	2	7	0	0
9	8090240	.	C	T	7	7	14	0	0	14	0	0
9	8114209	.	A	G	2	3	5	0	0	5	0	0
9	8114242	.	T	C	7	2	9	0	0	9	0	0
9	8121026	.	A	C	11	3	14	0	1	15	0	0
9	8121041	.	C	T	8	5	13	0	2	15	0	0
9	8121093	.	A	G	5	9	14	0	0	14	0	0
9	8121113	.	A	G	5	7	12	0	0	12	0	0
9	8122429	.	C	T	10	7	17	0	2	19	0	0
9	8128576	.	G	A	17	11	28	0	1	29	0	0
9	8429411	.	A	C	8	3	11	0	2	13	0	0
9	8429782	.	T	C	11	11	22	0	0	22	0	0
9	8429899	.	A	G	17	11	28	0	7	35	0	0
9	8430162	.	A	G	22	14	36	0	0	36	0	0
9	8430527	.	T	C	12	0	12	0	15	27	0	0
9	8430729	.	T	A	10	3	13	0	1	14	0	0
9	8430881	.	C	T	11	14	25	0	2	27	0	0
9	8430962	.	T	C	12	8	20	0	0	20	0	0
9	8431031	.	A	G	18	16	34	0	0	34	0	0
9	8431256	.	G	A	18	15	33	0	2	35	0	0
9	8431345	.	A	C	8	0	8	0	10	18	0	0
9	8431450	.	A	G	10	9	19	1	1	21	0	0
9	8431541	.	A	T	17	10	27	0	0	27	0	0
9	8431714	.	G	T	6	7	13	0	0	13	0	0
9	8431772	.	C	T	5	9	14	0	0	14	0	0
9	8431814	.	A	G	9	9	18	0	0	18	0	0
9	8431837	.	T	C	12	9	21	0	1	22	0	0
9	8431854	.	T	C	13	6	19	0	0	19	0	0
9	8431998	.	A	C	12	0	12	0	4	16	0	0
9	8433205	.	G	A	11	8	19	0	1	20	0	0
9	8450740	.	G	A	6	9	15	0	1	16	0	0
9	8450788	.	G	A	5	9	14	0	1	15	0	0
9	8451265	.	G	A	4	5	9	0	0	9	0	0
9	8451312	.	A	G	5	6	11	0	0	11	0	0
9	8451540	.	C	T	6	6	12	0	1	13	0	0
9	8451633	.	G	A	9	5	14	0	2	16	0	0
9	8452099	.	T	C	5	0	5	0	3	8	0	0
9	8452405	.	T	C	1	0	1	0	4	5	0	0
9	8452695	.	C	T	5	3	8	0	1	9	0	0
9	8452705	.	G	A	7	2	9	0	0	9	0	0
9	8887885	.	G	A	2	2	4	0	0	4	0	0
9	8898906	.	G	A	0	3	3	0	4	7	0	0
9	8899665	.	C	T	10	8	18	0	0	18	0	0
9	8899704	.	C	T	9	8	17	0	0	17	0	0
9	8899948	.	G	A	2	4	6	0	9	15	0	0
9	8899974	.	A	G	8	9	17	0	0	17	0	0
9	8903523	.	G	C	4	10	14	0	0	14	0	0
9	8904032	.	C	T	14	13	27	0	0	27	0	0
9	8910116	.	A	T	6	6	12	0	2	14	0	0
9	8914657	.	G	C	7	10	17	0	0	17	0	0
9	8964925	.	G	T	21	9	30	0	1	31	0	0
9	8967459	.	C	T	19	18	37	0	1	38	0	0
9	8969067	.	C	T	3	9	12	0	0	12	0	0
9	8969571	.	T	C	6	10	16	0	2	18	0	0
9	8971995	.	A	C	9	6	15	0	3	18	0	0
9	8972294	.	A	G	14	14	28	0	2	30	0	0
9	8972340	.	C	G	25	14	39	0	1	40	0	0
9	8972468	.	A	G	11	10	21	0	6	27	0	0
9	8972601	.	G	A	10	14	24	0	1	25	0	0
9	8973227	.	T	C	6	2	8	0	0	8	0	0
9	8973335	.	T	G	5	5	10	1	0	11	0	0
9	8973379	.	T	G	4	3	7	0	1	8	0	0
9	8973426	.	A	C	4	2	6	0	0	6	0	0
9	8974221	.	T	C	5	6	11	0	0	11	0	0
9	8974509	.	G	A	8	5	13	0	1	14	0	0
9	9112417	.	G	T	6	3	9	0	0	9	0	0
9	9112933	.	C	A	4	4	8	0	0	8	0	0
9	9116845	.	C	A	6	10	16	0	0	16	0	0
9	9116890	.	C	T	5	6	11	0	0	11	0	0
9	9117542	.	T	C	9	5	14	0	0	14	0	0
9	9118363	.	A	C	9	11	20	0	1	22	1	0
9	9118602	.	G	A	3	6	9	0	0	9	0	0
9	9118695	.	C	T	3	8	11	0	0	11	0	0
9	9118701	.	A	G	4	7	11	0	0	11	0	0
9	9118991	.	C	T	14	11	25	0	2	27	0	0
9	9118994	.	C	T	16	12	28	0	1	29	0	0
9	9119417	.	C	T	14	8	22	0	0	22	0	0
9	9119987	.	T	C	3	9	12	0	0	12	0	0
9	9120185	.	A	G	11	8	19	0	2	21	0	0
9	9120271	.	T	C	16	5	21	0	1	22	0	0
9	9120847	.	G	A	10	10	20	1	5	26	0	0
9	9121242	.	T	C	12	9	21	0	2	23	0	0
9	9121382	.	G	A	5	10	15	0	2	17	0	0
9	9121917	.	A	T	15	7	22	0	1	23	0	0
9	9183768	.	C	A	14	13	27	0	2	29	0	0
9	9183784	.	A	T	14	15	29	0	2	31	0	0
9	9183848	.	C	A	1	13	14	0	11	25	0	0
9	9183969	.	T	A	20	13	33	0	1	34	0	0
9	9184593	.	T	C	16	11	27	0	1	28	0	0
9	9193044	.	A	C	18	19	37	0	2	39	0	0
9	9198202	.	A	C	13	9	22	0	0	22	0	0
9	9202668	.	T	C	5	10	15	0	1	16	0	0
9	9205089	.	G	A	15	6	21	0	0	21	0	0
9	9206612	.	C	G	12	8	20	0	0	20	0	0
9	9208759	.	A	T	7	6	13	0	0	13	0	0
9	9208786	.	G	A	6	6	12	0	2	14	0	0
9	9225717	.	C	T	6	8	14	0	0	14	0	0
9	9235825	.	G	C	18	0	18	0	19	37	0	0
9	9235849	.	T	C	18	0	18	0	25	43	0	0
9	9238577	.	G	A	12	15	27	0	2	29	0	0
9	9238583	.	G	A	13	14	27	0	1	28	0	0
9	9241683	.	A	G	17	15	32	0	0	32	0	0
9	9322733	.	G	A	6	7	13	0	1	14	0	0
9	9342835	.	T	A	7	5	12	0	1	13	0	0
9	9342892	.	C	T	4	10	14	0	1	15	0	0
9	9342994	.	A	G	6	3	9	0	0	9	0	0
9	9345134	.	G	A	7	4	11	0	0	11	0	0
9	9345478	.	A	G	4	4	8	0	0	8	0	0
9	9345751	.	C	T	4	3	7	0	0	7	0	0
9	9542914	.	G	A	1	2	3	0	0	3	0	0
9	9555312	.	C	T	2	2	4	0	1	5	0	0
9	9561738	.	C	T	1	2	3	0	0	3	0	0
9	9578295	.	C	A	10	13	23	0	8	31	0	0
9	9578829	.	T	A	26	19	45	0	2	47	0	0
9	9578880	.	G	A	25	27	52	0	0	52	0	0
9	9578936	.	T	G	20	20	40	3	5	48	0	0
9	9579078	.	A	T	19	18	37	0	3	40	0	0
9	9579165	.	C	T	21	22	43	0	3	46	0	0
9	9579653	.	G	A	22	11	33	0	1	34	0	0
9	9592761	.	G	A	15	8	23	0	0	23	0	0
9	9599452	.	A	G	6	7	13	0	1	14	0	0
9	9670925	.	G	C	5	4	9	0	0	9	0	0
9	9671208	.	G	A	7	12	19	0	0	19	0	0
9	9679744	.	T	C	0	0	0	0	3	3	0	0
9	9719264	.	A	G	1	4	5	0	0	5	0	0
9	9719301	.	C	T	1	2	3	0	0	3	0	0
9	9719311	.	T	A	1	2	3	0	0	3	0	0
9	9719495	.	G	T	1	2	3	0	0	3	0	0
9	9720471	.	T	C	1	0	1	0	2	3	0	0
9	9731771	.	G	A	1	4	5	0	0	5	0	0
9	9731796	.	A	C	1	0	1	0	2	3	0	0
9	9731811	.	A	G	1	2	3	0	0	3	0	0
9	9736493	.	T	C	7	21	28	0	1	29	0	0
9	9737149	.	T	C	12	4	16	0	2	18	0	0
9	9737150	.	T	C	12	0	12	0	6	18	0	0
9	9737821	.	C	T	9	8	17	0	0	17	0	0
9	9738857	.	A	C	1	5	6	0	0	6	0	0
9	9751476	.	A	T	3	5	8	0	0	8	0	0
9	9930182	.	T	A	1	2	3	0	0	3	0	0
9	9930217	.	C	T	1	3	4	0	0	4	0	0
9	9930414	.	G	T	0	2	2	0	4	6	0	0
9	9930415	.	G	C	4	2	6	0	0	6	0	0
9	9942866	.	G	A	1	3	4	0	0	4	0	0
9	9943121	.	C	T	2	3	5	0	0	5	0	0
9	9945569	.	G	C	2	4	6	0	0	6	0	0
9	9953683	.	T	A	2	3	5	0	0	5	0	0
9	9957564	.	G	T	3	2	5	0	0	5	0	0
9	10014972	.	G	A	0	3	3	0	1	4	0	0
9	10015090	.	T	C	5	5	10	0	0	10	0	0
9	10043130	.	T	C	6	4	10	0	0	10	0	0
9	10043201	.	C	G	6	4	10	0	0	10	0	0
9	10043415	.	C	T	9	5	14	0	1	15	0	0
9	10043673	.	C	T	10	7	17	0	1	18	0	0
9	10043739	.	C	T	10	4	14	0	0	14	0	0
9	10051006	.	G	A	5	3	8	0	0	8	0	0
9	10051080	.	T	A	5	11	16	0	0	16	0	0
9	10051354	.	A	G	11	4	15	0	0	15	0	0
9	10138338	.	G	A	4	9	13	0	0	13	0	0
9	10138451	.	T	C	4	0	4	0	3	7	0	0
9	10138486	.	G	A	9	4	13	0	1	14	0	0
9	10153091	.	C	T	5	3	8	0	0	8	0	0
9	10153342	.	T	A	10	8	18	1	0	19	0	0
9	10153590	.	A	C	9	11	20	0	0	20	0	0
9	10153606	.	A	G	13	10	23	0	1	24	0	0
9	10153689	.	G	C	19	6	25	0	0	25	0	0
9	10153705	.	A	T	8	15	23	0	1	24	0	0
9	10154013	.	G	T	13	14	27	0	0	27	0	0
9	10154014	.	C	T	13	13	26	0	1	27	0	0
9	10154138	.	T	C	10	8	18	0	0	18	0	0
9	10154195	.	A	T	4	2	6	0	0	6	0	0
9	10154461	.	C	T	9	7	16	0	1	17	0	0
9	10154565	.	G	A	2	2	4	0	0	4	0	0
9	10154608	.	T	A	2	2	4	0	0	4	0	0
9	10156122	.	T	A	11	3	14	0	2	17	1	0
9	10156145	.	C	A	7	10	17	0	1	18	0	0
9	10157193	.	C	G	8	5	13	0	0	13	0	0
9	10157397	.	G	A	3	5	8	0	0	8	0	0
9	10168945	.	C	T	0	5	5	0	3	8	0	0
9	10175770	.	C	G	0	5	5	0	6	11	0	0
9	10175785	.	A	G	4	6	10	0	1	11	0	0
9	10175812	.	G	A	6	5	11	0	1	12	0	0
9	10183289	.	C	T	2	4	6	0	1	7	0	0
9	10195417	.	G	A	1	2	3	0	1	4	0	0
9	10199946	.	G	A	3	2	5	0	0	5	0	0
9	10199954	.	G	A	3	2	5	0	0	5	0	0
9	11533292	.	C	T	13	8	21	0	1	22	0	0
9	11533594	.	A	G	8	6	14	0	1	15	0	0
9	11548989	.	G	A	1	2	3	0	0	3	0	0
9	11576829	.	G	C	3	4	7	0	0	7	0	0
9	11579736	.	A	C	1	2	3	0	0	3	0	0
9	11582280	.	A	C	1	0	1	0	3	4	0	0
9	11582285	.	G	A	1	3	4	0	0	4	0	0
9	11587994	.	G	A	1	4	5	0	0	5	0	0
9	11592221	.	G	A	0	6	6	0	3	9	0	0
9	11597511	.	A	C	3	9	12	0	2	14	0	0
9	11597569	.	T	A	6	4	10	0	1	11	0	0
9	11597628	.	C	A	3	5	8	0	0	8	0	0
9	11597803	.	A	T	6	3	9	0	0	9	0	0
9	11597823	.	T	A	7	2	9	0	0	9	0	0
9	11598029	.	T	C	5	1	6	0	6	12	0	0
9	11598149	.	T	C	5	3	8	0	2	10	0	0
9	11598208	.	G	A	2	4	6	0	0	6	0	0
9	11598312	.	C	T	1	6	7	0	11	18	0	0
9	11601089	.	C	T	2	10	12	0	6	18	0	0
9	11601092	.	G	A	7	10	17	0	0	17	0	0
9	11602010	.	A	C	3	0	3	0	7	10	0	0
9	11602207	.	A	G	2	5	7	0	0	7	0	0
9	11602255	.	G	A	1	3	4	0	1	5	0	0
9	11616380	.	G	A	5	4	9	0	0	9	0	0
9	11626468	.	T	C	2	3	5	0	0	5	0	0
9	11626478	.	A	G	2	3	5	0	0	5	0	0
9	11665875	.	T	C	16	9	25	0	0	25	0	0
9	11670127	.	G	A	12	8	20	0	0	20	0	0
9	11670870	.	A	G	8	14	22	0	1	23	0	0
9	11906956	.	A	G	12	9	21	0	8	30	1	0
9	11907823	.	G	A	3	3	6	0	0	6	0	0
9	11908394	.	A	T	4	3	7	0	0	7	0	0
9	11908413	.	C	A	3	3	6	0	1	7	0	0
9	11908453	.	T	C	6	4	10	0	0	10	0	0
9	11908503	.	C	T	6	4	10	0	0	10	0	0
9	11908521	.	C	T	7	5	12	0	0	12	0	0
9	11908855	.	G	A	9	8	17	0	1	18	0	0
9	11908900	.	T	C	6	8	14	0	0	14	0	0
9	11909061	.	C	T	3	3	6	0	0	6	0	0
9	11909176	.	T	A	4	4	8	0	0	8	0	0
9	11909575	.	A	G	5	4	9	0	0	9	0	0
9	12034287	.	T	C	5	4	9	0	0	9	0	0
9	12034300	.	A	G	6	3	9	0	1	10	0	0
9	12034399	.	C	T	2	4	6	0	0	6	0	0
9	12263245	.	T	A	4	3	7	0	0	7	0	0
9	12265502	.	G	A	6	2	8	0	1	9	0	0
9	12405430	.	T	C	3	7	10	0	1	11	0	0
9	12405454	.	G	T	6	4	10	0	0	10	0	0
9	12405502	.	T	C	6	8	14	0	0	14	0	0
9	12405517	.	T	C	5	9	14	0	1	15	0	0
9	12405544	.	G	T	5	9	14	0	0	14	0	0
9	12405559	.	T	A	3	7	10	0	4	14	0	0
9	12405684	.	C	G	8	5	13	0	2	15	0	0
9	12405796	.	A	C	4	14	18	0	1	19	0	0
9	12423497	.	A	G	6	9	15	0	0	15	0	0
9	12424725	.	G	T	6	6	12	0	1	13	0	0
9	12424758	.	C	T	0	5	5	0	4	9	0	0
9	12444590	.	C	T	4	4	8	0	0	8	0	0
9	12454478	.	A	C	6	2	8	0	2	10	0	0
9	12454818	.	C	T	7	5	12	0	0	12	0	0
9	12454823	.	C	T	7	5	12	0	0	12	0	0
9	12455343	.	C	T	16	16	32	0	0	32	0	0
9	12469054	.	A	C	2	3	5	0	1	6	0	0
9	12478067	.	G	C	1	0	1	0	2	3	0	0
9	12582251	.	C	T	18	23	41	0	3	44	0	0
9	12584902	.	T	C	18	0	18	0	20	39	1	0
9	12589968	.	T	C	18	9	27	0	2	29	0	0
9	12590019	.	A	G	12	13	25	0	0	25	0	0
9	12590269	.	A	T	7	7	14	0	1	16	1	0
9	12590356	.	T	G	5	10	15	0	0	15	0	0
9	12594685	.	G	T	8	8	16	0	0	16	0	0
9	12648898	.	C	T	2	10	12	0	15	27	0	0
9	12649224	.	T	C	16	11	27	0	4	31	0	0
9	12649429	.	A	C	12	9	21	0	0	21	0	0
9	12664466	.	T	G	1	5	6	0	0	6	0	0
9	12664760	.	A	G	4	3	7	0	0	7	0	0
9	12667512	.	T	C	2	2	4	0	0	4	0	0
9	12667758	.	C	T	1	6	7	0	0	7	0	0
9	12669566	.	G	A	1	2	3	0	0	3	0	0
9	12690600	.	T	C	2	2	4	0	0	4	0	0
9	12690609	.	A	G	3	2	5	0	0	5	0	0
9	12865796	.	C	T	1	6	7	0	0	7	0	0
9	12866399	.	G	A	2	3	5	0	0	5	0	0
9	12866637	.	T	G	1	2	3	0	0	3	0	0
9	12868421	.	T	C	7	0	7	0	5	12	0	0
9	12870473	.	C	G	4	8	12	0	0	12	0	0
9	12871592	.	T	A	9	4	13	0	0	13	0	0
9	12874402	.	A	T	5	5	10	0	1	11	0	0
9	12874441	.	C	A	7	6	13	0	0	13	0	0
9	12883109	.	C	T	1	2	3	0	2	5	0	0
9	12925327	.	C	T	6	2	8	0	0	8	0	0
9	12925345	.	G	C	7	3	10	0	0	10	0	0
9	12940167	.	T	G	1	2	3	0	0	3	0	0
9	12942575	.	A	C	2	2	4	0	0	4	0	0
9	12943941	.	G	C	2	3	5	0	0	5	0	0
9	12944546	.	G	C	2	2	4	0	0	4	0	0
9	12944578	.	G	A	2	2	4	0	0	4	0	0
9	12944652	.	A	G	1	3	4	0	0	4	0	0
9	12944907	.	G	A	4	2	6	0	0	6	0	0
9	12944941	.	A	G	3	1	4	0	0	4	0	0
9	12944961	.	G	A	1	2	3	0	2	5	0	0
9	12944994	.	A	G	4	2	6	0	0	6	0	0
9	12945253	.	A	G	3	3	6	0	0	6	0	0
9	12945384	.	G	T	2	4	6	0	0	6	0	0
9	12945474	.	A	G	3	4	7	0	1	8	0	0
9	12945508	.	G	A	3	3	6	0	0	6	0	0
9	12945528	.	G	A	3	2	5	0	0	5	0	0
9	12945720	.	T	G	3	6	9	0	0	9	0	0
9	12946435	.	G	A	2	2	4	0	0	4	0	0
9	12946914	.	G	A	5	4	9	0	0	9	0	0
9	12947649	.	A	C	4	3	7	0	2	9	0	0
9	12947708	.	A	G	6	5	11	0	0	11	0	0
9	12947742	.	A	G	5	6	11	0	3	14	0	0
9	12947809	.	C	A	1	2	3	0	0	3	0	0
9	12947902	.	G	T	0	3	3	0	10	13	0	0
9	12947919	.	G	T	10	3	13	0	0	13	0	0
9	12948021	.	G	A	6	9	15	0	0	15	0	0
9	12948176	.	A	T	3	5	8	0	1	9	0	0
9	12948332	.	A	T	2	4	6	0	0	6	0	0
9	12948577	.	C	T	3	3	6	0	0	6	0	0
9	12948649	.	A	G	2	9	11	0	1	12	0	0
9	12948798	.	G	T	5	6	11	0	0	11	0	0
9	12948859	.	A	C	9	8	17	0	0	17	0	0
9	12948959	.	A	C	3	5	8	0	0	8	0	0
9	12948960	.	G	A	2	5	7	0	1	8	0	0
9	12951236	.	A	C	6	8	14	0	0	14	0	0
9	12951362	.	G	A	2	5	7	0	0	7	0	0
9	12953653	.	A	C	2	3	5	0	0	5	0	0
9	12953656	.	C	G	2	3	5	0	0	5	0	0
9	12953742	.	T	C	1	4	5	1	0	6	0	0
9	12959918	.	T	C	4	4	8	0	0	8	0	0
9	12960030	.	A	C	1	2	3	0	0	3	0	0
9	12960035	.	A	C	2	2	4	0	1	5	0	0
9	13076901	.	A	G	0	0	0	0	3	3	0	0
9	13076910	.	T	C	1	3	4	0	0	4	0	0
9	13102314	.	C	T	2	3	5	0	0	5	0	0
9	13106452	.	A	C	1	3	4	0	1	5	0	0
9	13106643	.	T	C	7	6	13	0	1	14	0	0
9	13106802	.	T	C	2	3	5	0	0	5	0	0
9	13106922	.	A	G	5	4	9	0	0	9	0	0
9	13106943	.	A	T	4	5	9	0	1	10	0	0
9	13107003	.	T	C	4	7	11	0	1	12	0	0
9	13107399	.	G	T	6	4	10	0	0	10	0	0
9	13107423	.	A	G	4	5	9	0	0	9	0	0
9	13107513	.	G	A	1	4	5	0	6	11	0	0
9	13107576	.	G	A	0	6	6	0	9	15	0	0
9	13107577	.	G	T	9	6	15	0	0	15	0	0
9	13110955	.	C	T	3	3	6	0	0	6	0	0
9	13111014	.	T	C	6	2	8	0	0	8	0	0
9	13120677	.	G	A	2	2	4	0	0	4	0	0
9	13212272	.	T	C	4	3	7	0	0	7	0	0
9	13212548	.	C	T	1	4	5	0	0	5	0	0
9	13212668	.	G	C	5	2	7	0	0	7	0	0
9	13212698	.	G	A	4	3	7	0	0	7	0	0
9	13229678	.	G	C	2	4	6	0	1	7	0	0
9	13229708	.	A	G	2	4	6	0	0	6	0	0
9	13230182	.	T	C	3	2	5	0	0	5	0	0
9	13230322	.	A	G	2	5	7	0	1	8	0	0
9	13230878	.	C	A	2	4	6	0	0	6	0	0
9	13230957	.	T	C	4	3	7	0	0	7	0	0
9	13233402	.	G	A	0	4	4	0	4	8	0	0
9	13241833	.	G	A	14	7	21	0	0	21	0	0
9	13246442	.	G	T	10	6	16	0	1	17	0	0
9	13352499	.	A	T	6	6	12	0	0	12	0	0
9	13352687	.	A	G	11	9	20	0	1	21	0	0
9	13352720	.	C	A	8	8	16	0	0	16	0	0
9	13353097	.	A	G	8	7	15	0	0	15	0	0
9	13354066	.	A	G	3	2	5	0	1	6	0	0
9	13720291	.	A	G	3	2	5	0	2	7	0	0
9	13722630	.	A	G	15	0	15	0	5	20	0	0
9	13765232	.	T	C	16	11	27	0	0	27	0	0
9	13774639	.	T	C	11	10	21	0	1	22	0	0
9	13797720	.	T	G	19	0	19	0	14	33	0	0
9	13799301	.	T	C	12	12	24	0	1	25	0	0
9	13799463	.	G	A	21	6	27	0	2	29	0	0
9	13799540	.	T	A	18	16	34	0	0	34	0	0
9	13803002	.	G	A	16	12	28	0	2	30	0	0
9	13815245	.	G	C	11	2	13	0	15	28	0	0
9	13815415	.	A	T	14	13	27	0	10	37	0	0
9	13815485	.	A	G	18	17	35	0	0	35	0	0
9	13815575	.	A	G	20	16	36	0	0	36	0	0
9	13815875	.	T	C	7	8	15	0	0	15	0	0
9	13816130	.	A	G	13	9	22	0	0	22	0	0
9	13816505	.	A	G	11	8	19	0	0	19	0	0
9	13816708	.	T	C	5	7	12	0	1	13	0	0
9	13816758	.	G	A	4	8	12	0	0	12	0	0
9	13816784	.	T	C	4	1	5	0	6	11	0	0
9	13816829	.	C	T	5	5	10	0	0	10	0	0
9	13816925	.	G	T	10	2	12	0	1	13	0	0
9	13816949	.	A	G	8	4	12	0	5	17	0	0
9	14136851	.	T	C	4	2	6	0	0	6	0	0
9	14136979	.	C	T	2	3	5	0	1	6	0	0
9	14171851	.	C	A	1	2	3	0	0	3	0	0
9	14195252	.	C	A	5	3	8	0	1	9	0	0
9	14195262	.	G	A	0	4	4	0	5	9	0	0
9	14195700	.	A	G	5	0	5	0	4	9	0	0
9	14196513	.	G	A	1	3	4	0	1	5	0	0
9	14196665	.	G	C	4	2	6	0	0	6	0	0
9	14196666	.	G	A	4	2	6	0	0	6	0	0
9	14196763	.	A	C	2	2	4	1	0	5	0	0
9	14196978	.	A	T	6	2	8	0	0	8	0	0
9	14197063	.	A	G	9	4	13	0	0	13	0	0
9	14367775	.	C	T	6	6	12	0	1	13	0	0
9	14367837	.	T	G	9	8	17	0	1	18	0	0
9	14367878	.	C	T	8	11	19	0	2	21	0	0
9	14368350	.	T	C	5	10	15	0	0	15	0	0
9	14368378	.	A	T	5	9	14	0	0	14	0	0
9	14368432	.	T	C	4	1	5	0	2	7	0	0
9	14368527	.	A	G	5	1	6	0	0	6	0	0
9	14368676	.	A	G	5	4	9	0	1	10	0	0
9	14368788	.	T	C	17	6	23	1	1	25	0	0
9	14368892	.	C	T	9	9	18	0	0	18	0	0
9	14368988	.	G	A	17	8	25	1	3	29	0	0
9	14369084	.	G	A	14	10	24	0	0	24	0	0
9	14369150	.	T	A	15	7	22	0	3	25	0	0
9	14381060	.	G	A	6	12	18	0	1	19	0	0
9	14381116	.	G	A	9	7	16	0	0	16	0	0
9	14381240	.	A	C	6	7	13	0	0	13	0	0
9	14411677	.	C	A	5	6	11	0	0	11	0	0
9	14433931	.	A	T	5	5	10	0	0	10	0	0
9	14442341	.	A	G	1	3	4	0	0	4	0	0
9	14443229	.	G	A	6	3	9	0	0	9	0	0
9	14446405	.	A	T	3	3	6	0	0	6	0	0
9	14446421	.	T	C	3	0	3	0	4	7	0	0
9	14469989	.	C	T	0	2	2	0	3	5	0	0
9	14469995	.	T	C	3	2	5	0	0	5	0	0
9	14504685	.	T	A	3	3	6	0	0	6	0	0
9	15363530	.	T	C	1	3	4	0	0	4	0	0
9	15363558	.	A	C	1	4	5	0	0	5	0	0
9	16127776	.	T	C	5	0	5	0	6	11	0	0
9	16128736	.	C	T	3	5	8	0	0	8	0	0
9	16128742	.	T	A	3	4	7	0	0	7	0	0
9	16132709	.	C	A	3	2	5	0	0	5	0	0
9	16247916	.	C	T	1	5	6	0	0	6	0	0
9	16581214	.	A	G	1	2	3	0	0	3	0	0
9	16853423	.	C	T	2	4	6	0	0	6	0	0
9	16867489	.	C	T	4	4	8	0	0	8	0	0
9	16867495	.	G	C	5	4	9	0	0	9	0	0
9	16867634	.	C	T	6	4	10	0	1	11	0	0
9	16867646	.	G	A	6	3	9	0	1	10	0	0
9	16867806	.	A	G	10	5	15	1	2	18	0	0
9	16867909	.	A	G	12	14	26	0	1	27	0	0
9	16868233	.	A	G	12	8	20	0	0	20	0	0
9	16868242	.	G	A	10	9	19	0	0	19	0	0
9	16868326	.	T	C	8	0	8	0	9	17	0	0
9	16872592	.	G	A	4	5	9	0	0	9	0	0
9	16872764	.	T	C	5	7	12	0	0	12	0	0
9	16872767	.	T	C	5	6	11	0	0	11	0	0
9	16877287	.	C	T	6	4	10	0	0	10	0	0
9	16877408	.	G	A	8	8	16	0	0	16	0	0
9	17046020	.	T	C	16	20	36	0	1	37	0	0
9	17046736	.	A	G	20	20	40	0	2	42	0	0
9	17047014	.	A	G	20	18	38	2	2	42	0	0
9	17057365	.	T	C	14	20	34	0	2	36	0	0
9	17060311	.	G	A	12	11	23	0	3	26	0	0
9	17067934	.	C	T	16	15	31	0	1	32	0	0
9	17068057	.	T	G	17	12	29	0	2	31	0	0
9	17073498	.	T	C	14	18	32	0	1	33	0	0
9	17074714	.	T	C	9	13	22	0	3	25	0	0
9	17074720	.	T	C	11	16	27	0	0	27	0	0
9	17074792	.	G	A	16	10	26	0	1	27	0	0
9	17077376	.	A	G	11	15	26	0	0	26	0	0
9	17077430	.	C	T	0	8	8	0	11	19	0	0
9	17077439	.	A	G	12	8	20	0	2	22	0	0
9	17080224	.	G	T	12	14	26	0	1	27	0	0
9	17080517	.	G	A	17	7	24	0	3	27	0	0
9	17080970	.	A	G	9	9	18	0	1	19	0	0
9	17082273	.	A	T	12	14	26	0	0	26	0	0
9	17082926	.	G	T	11	6	17	0	1	18	0	0
9	17083053	.	G	A	10	4	14	0	0	14	0	0
9	17083221	.	T	C	4	7	11	0	0	11	0	0
9	17083278	.	G	A	8	6	14	0	1	15	0	0
9	17083296	.	T	A	8	7	15	0	1	16	0	0
9	17083434	.	C	T	8	5	13	0	0	13	0	0
9	17083581	.	G	T	4	10	14	0	0	14	0	0
9	17083908	.	T	C	8	0	8	0	10	18	0	0
9	17083989	.	G	A	3	8	11	0	0	11	0	0
9	17084127	.	T	C	3	0	3	0	6	9	0	0
9	17084229	.	T	C	2	0	2	0	12	14	0	0
9	17084253	.	G	A	6	6	12	0	0	12	0	0
9	17094362	.	A	T	6	6	12	0	0	12	0	0
9	17119143	.	G	A	4	5	9	0	0	9	0	0
9	17119789	.	G	A	6	2	8	0	1	9	0	0
9	17119982	.	A	G	6	6	12	0	0	12	0	0
9	17127011	.	G	T	4	4	8	0	0	8	0	0
9	17127025	.	C	T	5	1	6	0	3	9	0	0
9	17129876	.	A	G	6	6	12	0	0	12	0	0
9	17130282	.	G	A	3	4	7	0	0	7	0	0
9	17139140	.	A	C	1	2	3	0	0	3	0	0
9	17145508	.	T	C	2	2	4	0	0	4	0	0
9	17348855	.	C	A	7	5	12	0	2	14	0	0
9	17348977	.	G	A	7	3	10	0	0	10	0	0
9	17349073	.	T	C	2	3	5	0	1	6	0	0
9	17349103	.	G	T	0	2	2	0	6	8	0	0
9	17349125	.	G	A	0	3	3	0	6	9	0	0
9	17364337	.	C	G	4	8	12	1	0	13	0	0
9	17368825	.	C	T	5	9	14	0	0	14	0	0
9	17378276	.	A	T	11	10	21	0	0	21	0	0
9	17379954	.	C	T	16	14	30	0	0	30	0	0
9	17386091	.	G	A	0	7	7	0	7	14	0	0
9	17386092	.	A	T	7	7	14	0	0	14	0	0
9	17386148	.	C	T	5	4	9	0	0	9	0	0
9	17386152	.	C	A	5	3	8	0	0	8	0	0
9	17386338	.	A	G	9	1	10	0	12	22	0	0
9	17424820	.	A	T	5	3	8	0	0	8	0	0
9	17425845	.	C	T	1	2	3	0	0	3	0	0
9	17429258	.	G	A	0	6	6	0	3	9	0	0
9	17431348	.	C	T	1	4	5	0	0	5	0	0
9	17431709	.	T	A	1	4	5	0	0	5	0	0
9	17431798	.	A	G	9	3	12	0	1	13	0	0
9	17432155	.	C	T	5	2	7	0	0	7	0	0
9	17432450	.	A	G	8	2	10	0	0	10	0	0
9	17432470	.	T	C	8	3	11	0	1	12	0	0
9	17432962	.	A	C	2	4	6	0	0	6	0	0
9	17433251	.	C	T	2	4	6	0	0	6	0	0
9	17433769	.	T	G	7	3	10	0	1	11	0	0
9	17434082	.	A	G	1	2	3	0	0	3	0	0
9	17445217	.	A	G	8	5	13	0	0	13	0	0
9	17449399	.	T	C	14	10	24	0	2	26	0	0
9	17542985	.	A	G	2	4	6	0	1	7	0	0
9	17548502	.	T	C	2	7	9	0	0	9	0	0
9	17560343	.	A	G	6	7	13	0	0	13	0	0
9	17563079	.	C	T	4	5	9	0	0	9	0	0
9	17583192	.	G	A	5	4	9	0	1	10	0	0
9	17600571	.	C	T	1	3	4	0	4	8	0	0
9	17647072	.	C	A	1	4	5	0	0	5	0	0
9	17747719	.	A	G	1	1	2	0	1	3	0	0
9	17747795	.	T	C	2	0	2	0	2	4	0	0
9	17772295	.	A	G	1	2	3	0	0	3	0	0
9	17772325	.	T	C	1	2	3	0	0	3	0	0
9	17862887	.	G	A	0	3	3	0	2	5	0	0
9	17908818	.	G	A	1	2	3	0	1	4	0	0
9	17908958	.	A	C	3	7	10	0	0	10	0	0
9	17912372	.	C	G	5	5	10	0	0	10	0	0
9	17918461	.	C	A	2	3	5	0	0	5	0	0
9	17918485	.	A	G	4	3	7	0	0	7	0	0
9	17918627	.	G	A	5	2	7	0	0	7	0	0
9	17922191	.	G	C	4	8	12	0	0	12	0	0
9	17934202	.	T	G	6	4	10	0	0	10	0	0
9	17934232	.	G	A	5	5	10	0	1	11	0	0
9	17934262	.	T	C	5	6	11	0	0	11	0	0
9	17940161	.	C	T	8	5	13	0	0	13	0	0
9	17979350	.	A	C	3	4	7	0	0	7	0	0
9	17979389	.	G	A	2	4	6	0	0	6	0	0
9	17979603	.	T	A	2	0	2	0	2	4	0	0
9	17984877	.	G	T	1	5	6	0	1	7	0	0
9	17984914	.	G	T	1	2	3	0	1	4	0	0
9	17987998	.	A	G	10	6	16	0	2	18	0	0
9	17988011	.	C	A	10	8	18	0	0	18	0	0
9	17988072	.	A	C	6	8	14	0	2	16	0	0
9	17988091	.	A	G	11	8	19	0	0	19	0	0
9	18001200	.	A	C	11	14	25	0	2	27	0	0
9	18003290	.	G	A	2	18	20	1	12	33	0	0
9	18003487	.	C	A	20	13	33	0	1	34	0	0
9	18003807	.	C	T	17	26	43	0	0	43	0	0
9	18003823	.	G	A	0	21	21	0	20	41	0	0
9	18005655	.	T	A	6	15	21	0	0	21	0	0
9	18005708	.	A	G	17	4	21	0	0	21	0	0
9	18005806	.	A	G	22	7	29	0	1	30	0	0
9	18005818	.	A	G	10	16	26	0	1	27	0	0
9	18005864	.	G	A	22	12	34	0	1	35	0	0
9	18215989	.	T	G	5	12	17	0	3	20	0	0
9	18235382	.	A	T	10	16	26	0	1	27	0	0
9	18235383	.	A	G	10	16	26	0	1	27	0	0
9	18277985	.	T	A	11	7	18	0	1	19	0	0
9	18278009	.	A	G	9	0	9	0	6	15	0	0
9	18278366	.	G	T	8	3	11	0	2	13	0	0
9	18333107	.	A	G	12	11	23	0	0	23	0	0
9	18390631	.	T	C	5	2	7	0	0	7	0	0
9	18390683	.	C	T	6	5	11	0	0	11	0	0
9	18424739	.	A	T	2	3	5	0	0	5	0	0
9	18424775	.	C	T	4	5	9	0	0	9	0	0
9	18568875	.	T	C	3	0	3	0	14	17	0	0
9	18716630	.	T	A	17	15	32	0	3	35	0	0
9	18721152	.	A	G	9	7	16	0	0	16	0	0
9	18732819	.	T	C	20	30	50	1	5	56	0	0
9	18732878	.	C	T	3	30	33	0	24	57	0	0
9	18732899	.	G	A	28	28	56	0	2	58	0	0
9	18733062	.	G	T	35	31	66	1	0	67	0	0
9	18733545	.	G	T	41	29	70	0	9	79	0	0
9	18733592	.	T	C	35	3	38	0	40	78	0	0
9	18735081	.	A	G	27	24	51	0	2	53	0	0
9	18742401	.	G	T	3	7	10	0	0	10	0	0
9	18812765	.	A	G	9	4	13	0	2	15	0	0
9	18812824	.	G	C	6	8	14	0	3	17	0	0
9	18876266	.	G	A	16	17	33	0	3	36	0	0
9	18876332	.	A	T	23	14	37	0	2	39	0	0
9	18876402	.	C	A	19	11	30	0	1	31	0	0
9	18876403	.	C	A	20	11	31	0	0	31	0	0
9	18876545	.	G	T	20	16	36	0	2	38	0	0
9	18876592	.	G	T	18	23	41	0	5	46	0	0
9	18876937	.	C	G	3	24	27	0	16	44	1	0
9	18909235	.	A	T	5	3	8	0	0	8	0	0
9	18909242	.	A	T	5	5	10	0	0	10	0	0
9	18909748	.	A	C	2	3	5	0	1	6	0	0
9	19027491	.	A	G	1	2	3	0	0	3	0	0
9	19027630	.	T	A	3	2	5	0	1	6	0	0
9	19027637	.	G	T	2	2	4	0	2	6	0	0
9	19027681	.	C	T	6	6	12	0	1	13	0	0
9	19027685	.	T	C	8	0	8	0	6	14	0	0
9	19027748	.	T	C	10	3	13	0	0	13	0	0
9	19040846	.	C	T	2	8	10	0	1	11	0	0
9	19074196	.	C	T	2	4	6	0	0	6	0	0
9	19074628	.	T	C	4	3	7	0	0	7	0	0
9	19074642	.	G	T	4	3	7	0	0	7	0	0
9	19074687	.	G	A	2	3	5	0	0	5	0	0
9	19075002	.	C	T	1	4	5	0	2	7	0	0
9	19075015	.	C	A	2	5	7	0	0	7	0	0
9	19118853	.	T	C	1	3	4	0	0	4	0	0
9	19118903	.	T	G	2	0	2	0	4	6	0	0
9	19118929	.	G	A	3	5	8	0	0	8	0	0
9	19118990	.	G	A	1	4	5	0	0	5	0	0
9	19119000	.	G	A	2	3	5	0	0	5	0	0
9	19119285	.	T	C	4	3	7	0	1	8	0	0
9	19305044	.	T	C	1	2	3	0	0	3	0	0
9	19305097	.	A	G	1	0	1	0	2	3	0	0
9	19351953	.	C	T	4	3	7	0	0	7	0	0
9	19366353	.	A	T	1	4	5	0	0	5	0	0
9	19401830	.	C	T	1	2	3	4	0	7	0	0
9	19405989	.	C	G	6	0	6	0	5	11	0	0
9	19406130	.	G	A	4	2	6	0	0	6	0	0
9	19406131	.	G	T	4	2	6	0	0	6	0	0
9	19406310	.	A	G	4	0	4	0	4	8	0	0
9	19406425	.	T	A	5	3	8	0	0	8	0	0
9	19406607	.	T	C	1	3	4	0	3	7	0	0
9	19406681	.	T	G	1	2	3	0	1	4	0	0
9	19407229	.	C	T	1	3	4	0	0	4	0	0
9	19407284	.	C	T	1	3	4	0	0	4	0	0
9	19407546	.	G	T	5	7	12	0	1	13	0	0
9	19407587	.	G	T	3	3	6	0	1	7	0	0
9	19407614	.	G	T	6	3	9	0	1	10	0	0
9	19408038	.	A	G	1	2	3	0	0	3	0	0
9	19408248	.	A	G	4	3	7	0	1	8	0	0
9	19408327	.	C	G	3	3	6	0	0	6	0	0
9	19408345	.	G	A	3	3	6	0	1	7	0	0
9	19433721	.	C	G	1	3	4	0	0	4	0	0
9	19469133	.	C	T	6	6	12	0	0	12	0	0
9	19469175	.	C	T	6	3	9	0	0	9	0	0
9	19477882	.	T	G	1	1	2	0	1	3	0	0
9	19477913	.	T	C	2	3	5	0	0	5	0	0
9	19480912	.	T	C	1	0	1	0	3	4	0	0
9	19484382	.	G	A	1	2	3	0	0	3	0	0
9	19486262	.	A	C	1	4	5	0	0	5	0	0
9	19488371	.	C	T	0	2	2	0	1	3	0	0
9	19496840	.	G	A	1	2	3	0	0	3	0	0
9	19496868	.	A	T	1	2	3	0	0	3	0	0
9	19510699	.	G	A	13	9	22	0	0	22	0	0
9	19510853	.	A	T	6	8	14	0	0	14	0	0
9	19510854	.	T	G	5	7	12	0	2	14	0	0
9	19518690	.	A	T	4	8	12	0	0	12	0	0
9	19527981	.	T	C	3	5	8	0	0	8	0	0
9	19539222	.	C	T	4	3	7	0	0	7	0	0
9	19539770	.	C	A	5	4	9	0	1	10	0	0
9	19539800	.	T	C	3	3	6	2	0	8	0	0
9	19539840	.	T	C	1	7	8	2	0	10	0	0
9	19549346	.	A	G	7	0	7	0	7	14	0	0
9	19549868	.	A	T	2	3	5	0	1	6	0	0
9	19549958	.	C	A	7	3	10	0	0	10	0	0
9	19549989	.	G	A	5	2	7	0	0	7	0	0
9	19623931	.	T	C	3	2	5	0	0	5	0	0
9	19636474	.	G	A	0	2	2	0	3	5	0	0
9	19636483	.	C	G	4	3	7	0	0	7	0	0
9	19636514	.	G	A	1	6	7	0	1	8	0	0
9	19641168	.	T	C	1	4	5	0	1	6	0	0
9	19642709	.	A	G	2	8	10	0	0	10	0	0
9	19642724	.	T	C	3	8	11	0	0	11	0	0
9	19646511	.	A	G	6	7	13	0	0	13	0	0
9	19646535	.	T	G	11	0	11	0	7	18	0	0
9	19648268	.	G	T	7	3	10	0	1	11	0	0
9	19652691	.	A	C	18	5	23	0	3	26	0	0
9	19652706	.	G	A	19	6	25	0	3	28	0	0
9	19652993	.	C	T	3	4	7	0	7	14	0	0
9	19652994	.	G	A	7	3	10	0	4	14	0	0
9	19653115	.	G	A	4	2	6	0	0	6	0	0
9	19653130	.	T	A	4	3	7	0	0	7	0	0
9	19653188	.	C	T	4	9	13	0	1	14	0	0
9	19653200	.	C	T	4	9	13	0	0	13	0	0
9	19653284	.	A	G	5	2	7	0	0	7	0	0
9	20076615	.	G	A	17	10	27	0	3	30	0	0
9	20076799	.	A	G	14	8	22	0	1	23	0	0
9	20076847	.	A	G	8	9	17	0	1	18	0	0
9	20076850	.	A	G	8	11	19	0	0	19	0	0
9	20076913	.	T	C	10	0	10	0	19	29	0	0
9	20077971	.	A	G	12	10	22	0	0	22	0	0
9	20078072	.	G	T	12	7	19	0	2	21	0	0
9	20095605	.	A	G	4	12	16	0	0	16	0	0
9	20174733	.	G	C	3	2	5	0	0	5	0	0
9	20499009	.	G	C	0	2	2	0	1	3	0	0
9	20499502	.	T	A	2	2	4	0	0	4	0	0
9	20499918	.	C	T	4	4	8	0	0	8	0	0
9	20500337	.	A	C	3	2	5	0	0	5	0	0
9	20500510	.	G	T	2	2	4	0	0	4	0	0
9	20500920	.	A	C	3	2	5	0	0	5	0	0
9	20500967	.	G	A	4	2	6	0	1	7	0	0
9	20500972	.	G	A	0	3	3	0	4	7	0	0
9	20501158	.	C	T	2	2	4	0	0	4	0	0
9	20558247	.	C	T	9	11	20	0	0	20	0	0
9	20663995	.	C	T	4	2	6	0	0	6	0	0
9	20700130	.	T	C	2	2	4	0	0	4	0	0
9	20731311	.	A	G	5	12	17	0	2	19	0	0
9	20734036	.	T	C	12	5	17	0	2	19	0	0
9	20749770	.	A	T	6	20	26	0	1	27	0	0
9	20763830	.	G	C	10	14	24	1	2	27	0	0
9	20763834	.	G	A	3	15	18	1	10	29	0	0
9	20763878	.	G	A	0	16	16	0	15	31	0	0
9	20763907	.	A	T	17	12	29	0	2	31	0	0
9	20764004	.	G	A	8	15	23	0	3	26	0	0
9	20764019	.	T	A	10	16	26	0	0	26	0	0
9	20764183	.	C	T	19	13	32	0	4	36	0	0
9	20764229	.	G	C	18	11	29	0	1	30	0	0
9	20764231	.	T	A	17	10	27	0	3	30	0	0
9	20764271	.	C	A	20	13	33	0	3	36	0	0
9	20764877	.	T	C	16	8	24	0	1	26	1	0
9	20764994	.	G	A	18	18	36	0	1	37	0	0
9	20765193	.	A	G	13	13	26	0	1	27	0	0
9	20806656	.	A	T	6	2	8	0	0	8	0	0
9	20806657	.	A	G	6	2	8	0	0	8	0	0
9	20833676	.	G	A	7	4	11	0	0	11	0	0
9	20849415	.	G	A	4	3	7	0	0	7	0	0
9	20850584	.	A	G	4	2	6	0	0	6	0	0
9	20858676	.	G	T	1	4	5	0	1	6	0	0
9	20859226	.	A	T	1	3	4	0	0	4	0	0
9	20859690	.	A	G	2	2	4	0	0	4	0	0
9	20860161	.	G	C	2	4	6	0	0	6	0	0
9	20860187	.	A	C	1	2	3	0	2	5	0	0
9	20863300	.	A	T	3	4	7	0	1	8	0	0
9	20863342	.	T	C	2	5	7	0	1	8	0	0
9	20868978	.	T	A	7	4	11	0	0	11	0	0
9	20870521	.	T	C	1	2	3	0	1	4	0	0
9	20870779	.	T	C	4	5	9	0	0	9	0	0
9	20872331	.	T	C	6	6	12	0	0	12	0	0
9	20872390	.	G	A	6	4	10	0	0	10	0	0
9	21072922	.	T	C	5	3	8	0	0	8	0	0
9	21076209	.	A	T	1	2	3	0	0	3	0	0
9	21084783	.	A	G	2	5	7	0	0	7	0	0
9	21084813	.	A	G	1	7	8	0	0	8	0	0
9	21084858	.	A	C	4	3	7	0	0	7	0	0
9	21098324	.	T	G	2	2	4	0	0	4	0	0
9	21203845	.	T	A	2	2	4	0	0	4	0	0
9	21204244	.	T	G	8	9	17	0	0	17	0	0
9	21204666	.	T	C	0	2	2	1	1	4	0	0
9	21204667	.	T	C	1	2	3	1	0	4	0	0
9	21205123	.	T	A	3	4	7	0	0	7	0	0
9	21205138	.	A	G	2	4	6	0	0	6	0	0
9	21216897	.	T	C	3	14	17	0	1	18	0	0
9	21216898	.	T	C	3	14	17	0	1	18	0	0
9	21217434	.	G	T	4	5	9	0	0	9	0	0
9	21217438	.	A	G	4	7	11	0	1	12	0	0
9	21224703	.	T	C	4	20	24	0	1	25	0	0
9	21224725	.	G	A	4	11	15	0	7	22	0	0
9	21224768	.	T	G	3	19	22	0	1	23	0	0
9	21224866	.	A	G	2	16	18	0	0	18	0	0
9	21225412	.	C	A	2	2	4	0	0	4	0	0
9	21225467	.	C	A	3	4	7	0	0	7	0	0
9	21225751	.	T	G	2	2	4	0	0	4	0	0
9	21225795	.	T	A	0	2	2	0	1	3	0	0
9	21225904	.	A	G	4	3	7	0	0	7	0	0
9	21225987	.	C	A	3	3	6	0	0	6	0	0
9	21235737	.	C	A	2	4	6	0	1	7	0	0
9	21235770	.	A	T	7	9	16	0	1	17	0	0
9	21235926	.	T	G	2	1	3	0	1	4	0	0
9	21254266	.	C	G	1	3	4	0	0	4	0	0
9	21266854	.	A	G	14	10	24	0	1	25	0	0
9	21266878	.	C	T	1	11	12	0	11	23	0	0
9	21267133	.	C	T	22	19	41	0	2	43	0	0
9	21267323	.	C	T	19	17	36	0	2	38	0	0
9	21271683	.	G	A	3	3	6	0	1	7	0	0
9	22797851	.	G	A	9	2	11	0	0	11	0	0
9	24189407	.	A	G	22	8	30	0	3	33	0	0
9	24190767	.	A	G	14	0	14	0	18	32	0	0
9	24190792	.	A	G	17	13	30	0	2	32	0	0
9	24948911	.	G	T	8	2	10	0	1	11	0	0
9	25337511	.	C	T	2	2	4	0	0	4	0	0
9	25837206	.	A	T	6	3	9	0	1	10	0	0
9	28207647	.	C	T	1	3	4	0	0	4	0	0
9	30764537	.	G	A	2	3	5	0	0	5	0	0
9	30780786	.	G	A	1	3	4	0	3	7	0	0
9	30783661	.	A	G	1	3	4	0	0	4	0	0
9	30783828	.	A	T	4	2	6	0	0	6	0	0
9	30800990	.	C	T	4	4	8	0	1	9	0	0
9	30806101	.	C	T	0	3	3	0	5	8	0	0
9	30806428	.	G	A	4	3	7	0	0	7	0	0
9	30806630	.	G	A	4	2	6	0	0	6	0	0
9	30806662	.	T	G	2	2	4	0	0	4	0	0
9	30807944	.	C	T	4	2	6	0	1	7	0	0
9	31042584	.	T	C	27	17	44	1	0	45	0	0
9	31062301	.	A	G	15	17	32	0	2	34	0	0
9	31214307	.	T	G	3	6	9	0	0	9	0	0
9	31214442	.	A	C	5	7	12	0	0	12	0	0
9	31248923	.	C	T	7	8	15	0	0	15	0	0
9	31258832	.	G	A	9	5	14	1	1	16	0	0
9	31268856	.	G	T	3	2	5	0	0	5	0	0
9	31274993	.	T	C	12	0	12	3	9	24	0	0
9	31276912	.	C	T	17	19	36	0	0	36	0	0
9	31497304	.	G	A	1	2	3	0	1	4	0	0
9	31510724	.	T	A	7	7	14	0	0	14	0	0
9	31518804	.	C	T	6	3	9	0	0	9	0	0
9	31524633	.	G	T	2	2	4	0	0	4	0	0
9	31595634	.	C	T	13	23	36	0	7	43	0	0
9	31604943	.	G	A	10	6	16	0	1	17	0	0
9	31605235	.	A	G	11	6	17	0	0	17	0	0
9	31605260	.	T	C	10	0	10	0	10	20	0	0
9	31605281	.	C	A	1	8	9	0	8	17	0	0
9	31606333	.	C	T	9	4	13	0	1	14	0	0
9	31612184	.	C	T	6	7	13	0	0	13	0	0
9	31617687	.	A	G	7	4	11	0	1	12	0	0
9	31619998	.	A	G	5	2	7	0	0	7	0	0
9	31639107	.	C	T	1	7	8	0	3	11	0	0
9	31716932	.	G	A	2	2	4	0	0	4	0	0
9	31735673	.	A	G	3	3	6	0	0	6	0	0
9	31735676	.	A	C	3	4	7	0	0	7	0	0
9	31759780	.	A	C	2	4	6	3	0	9	0	0
9	31795397	.	G	A	3	2	5	0	1	6	0	0
9	32432696	.	T	C	1	2	3	0	0	3	0	0
9	33411227	.	C	A	9	8	17	0	0	17	0	0
9	33411228	.	A	G	9	7	16	0	1	17	0	0
9	33416479	.	C	T	12	2	14	0	1	15	0	0
9	33861813	.	A	T	7	4	11	0	1	12	0	0
9	34112936	.	A	T	7	3	10	0	0	10	0	0
9	34112981	.	T	C	8	6	14	0	0	14	0	0
9	34113008	.	A	T	5	7	12	0	0	12	0	0
9	34113140	.	G	A	2	5	7	0	0	7	0	0
9	34116933	.	A	G	3	2	5	0	0	5	0	0
9	34117293	.	A	C	6	4	10	0	1	11	0	0
9	34117471	.	C	G	2	3	5	0	0	5	0	0
9	34119936	.	A	G	5	4	9	0	0	9	0	0
9	34120207	.	T	A	2	5	7	0	0	7	0	0
9	34120732	.	C	T	0	2	2	0	2	4	0	0
9	34161749	.	G	A	6	2	8	0	0	8	0	0
9	34161912	.	G	A	1	1	2	0	3	5	0	0
9	34161933	.	C	T	3	2	5	0	0	5	0	0
9	34174561	.	C	T	15	6	21	0	1	22	0	0
9	34174682	.	G	A	7	12	19	0	2	21	0	0
9	34179700	.	G	T	2	6	8	0	0	8	0	0
9	34179782	.	C	T	1	4	5	0	5	10	0	0
9	34189270	.	C	T	2	6	8	0	0	8	0	0
9	34189378	.	C	T	11	7	18	0	1	19	0	0
9	34189435	.	C	A	11	8	19	0	0	19	0	0
9	34189571	.	C	A	8	4	12	0	2	14	0	0
9	34191603	.	G	A	3	3	6	0	0	6	0	0
9	34200253	.	T	C	7	3	10	0	0	10	0	0
9	34201249	.	C	T	3	4	7	0	0	7	0	0
9	34204487	.	G	A	2	3	5	0	1	6	0	0
9	34204490	.	A	G	3	4	7	0	0	7	0	0
9	34212456	.	G	A	4	4	8	0	0	8	0	0
9	34218953	.	A	G	1	2	3	0	0	3	0	0
9	34225055	.	A	G	12	17	29	0	0	29	0	0
9	34225250	.	T	C	26	24	50	0	1	51	0	0
9	34225316	.	G	C	19	25	44	0	0	44	0	0
9	34226955	.	C	A	21	16	37	0	0	37	0	0
9	34226960	.	A	C	22	18	40	0	0	40	0	0
9	34227195	.	G	T	14	9	23	0	0	23	0	0
9	34227323	.	A	T	1	1	2	0	1	3	0	0
9	34232718	.	G	T	3	2	5	0	0	5	0	0
9	34238825	.	T	A	4	4	8	0	0	8	0	0
9	34242433	.	T	C	3	5	8	0	0	8	0	0
9	34242953	.	G	T	2	2	4	0	0	4	0	0
9	34243019	.	A	G	5	0	5	0	3	8	0	0
9	34243196	.	C	G	6	3	9	0	1	10	0	0
9	34243310	.	A	G	4	5	9	0	1	10	0	0
9	34243352	.	C	T	5	6	11	0	0	11	0	0
9	34243681	.	C	T	9	7	16	0	1	17	0	0
9	34243701	.	C	G	10	9	19	0	0	19	0	0
9	34243775	.	T	C	5	2	7	0	0	9	2	0
9	34246564	.	A	G	10	7	17	0	0	17	0	0
9	34246762	.	G	A	4	12	16	0	2	18	0	0
9	34247035	.	A	T	20	0	20	0	0	32	12	0
9	34247042	.	G	A	20	15	35	0	0	35	0	0
9	34247145	.	A	T	22	9	31	0	2	33	0	0
9	34247356	.	G	A	16	12	28	0	0	28	0	0
9	34251632	.	G	A	14	9	23	0	1	24	0	0
9	34251635	.	C	A	1	8	9	0	15	24	0	0
9	34251707	.	C	G	14	16	30	0	2	32	0	0
9	34254325	.	C	T	9	5	14	0	1	15	0	0
9	34254851	.	A	G	10	3	13	0	0	13	0	0
9	34256016	.	A	C	7	5	12	0	0	12	0	0
9	34257954	.	T	A	3	7	10	0	0	10	0	0
9	34258106	.	C	T	7	4	11	0	0	11	0	0
9	34258565	.	T	G	0	3	3	0	1	4	0	0
9	34258580	.	C	T	0	2	2	0	2	4	0	0
9	34258642	.	G	A	2	2	4	0	0	4	0	0
9	34259406	.	T	A	3	2	5	0	0	5	0	0
9	34259418	.	T	A	4	2	6	0	1	7	0	0
9	34334173	.	T	G	5	0	5	0	8	13	0	0
9	34334323	.	C	T	3	4	7	0	0	7	0	0
9	34335327	.	G	T	0	6	6	0	3	9	0	0
9	34335510	.	G	T	2	6	8	0	1	9	0	0
9	34343912	.	T	C	5	2	7	0	3	10	0	0
9	34343983	.	A	G	6	4	10	0	0	10	0	0
9	34344039	.	C	T	7	7	14	0	0	14	0	0
9	34346443	.	T	C	3	2	5	0	0	5	0	0
9	34349889	.	G	A	1	4	5	0	0	5	0	0
9	34350372	.	A	T	2	2	4	0	0	4	0	0
9	34351171	.	G	A	3	5	8	0	1	9	0	0
9	34351273	.	T	G	5	3	8	0	1	9	0	0
9	34351277	.	T	C	6	3	9	0	0	9	0	0
9	34351416	.	A	C	5	5	10	0	0	10	0	0
9	34351811	.	A	G	5	6	11	0	0	11	0	0
9	34351845	.	T	A	6	9	15	0	0	15	0	0
9	34351916	.	C	T	4	4	8	0	0	8	0	0
9	34380457	.	A	G	7	7	14	0	0	14	0	0
9	34382946	.	A	C	15	9	24	0	0	24	0	0
9	34382994	.	G	A	3	10	13	0	4	17	0	0
9	34383041	.	C	A	4	9	13	0	2	15	0	0
9	34385364	.	G	T	10	16	26	0	2	28	0	0
9	34385421	.	A	C	11	18	29	0	0	29	0	0
9	34388784	.	T	G	24	17	41	0	1	42	0	0
9	34388798	.	T	G	22	0	22	0	17	39	0	0
9	34388882	.	G	A	17	12	29	0	0	29	0	0
9	34388969	.	A	G	8	5	13	0	2	15	0	0
9	34389317	.	T	A	21	9	30	0	1	31	0	0
9	34389379	.	C	T	18	17	35	0	2	37	0	0
9	34389457	.	C	A	15	21	36	0	3	39	0	0
9	34389602	.	A	G	17	1	18	0	27	45	0	0
9	34389734	.	G	C	3	12	15	2	15	32	0	0
9	34401101	.	A	G	1	0	1	0	2	3	0	0
9	34404830	.	T	G	5	3	8	0	0	8	0	0
9	34405155	.	A	G	2	2	4	0	0	4	0	0
9	34407893	.	C	A	4	5	9	0	0	9	0	0
9	34409578	.	G	A	2	7	9	0	0	9	0	0
9	34410237	.	T	C	4	3	7	0	1	8	0	0
9	34412701	.	G	C	0	2	2	0	6	8	0	0
9	34415308	.	T	C	3	9	12	0	2	14	0	0
9	34419094	.	T	C	4	8	12	0	2	14	0	0
9	34425996	.	G	A	8	8	16	0	1	17	0	0
9	34435063	.	A	T	3	2	5	0	0	5	0	0
9	34437712	.	G	A	5	5	10	0	0	10	0	0
9	34438607	.	C	A	1	3	4	0	0	4	0	0
9	34438861	.	T	G	7	3	10	0	1	11	0	0
9	34449246	.	C	A	5	4	9	0	2	11	0	0
9	34451168	.	C	A	4	5	9	0	0	9	0	0
9	34461340	.	A	G	10	0	10	0	3	13	0	0
9	34466229	.	G	A	2	6	8	0	6	14	0	0
9	34470776	.	T	C	8	9	17	0	0	17	0	0
9	34472180	.	C	T	10	7	17	0	1	18	0	0
9	34474434	.	G	T	15	7	22	0	1	23	0	0
9	34484660	.	C	A	0	3	3	0	1	4	0	0
9	34484669	.	C	T	2	3	5	0	0	5	0	0
9	34484859	.	T	A	4	2	6	0	0	6	0	0
9	34484949	.	T	C	4	4	8	0	1	9	0	0
9	34484959	.	T	C	3	3	6	0	1	7	0	0
9	34484997	.	A	T	4	4	8	0	0	8	0	0
9	34485105	.	G	T	6	9	15	0	2	17	0	0
9	34485123	.	T	C	6	11	17	0	0	17	0	0
9	34485168	.	C	T	1	8	9	0	6	15	0	0
9	34490692	.	A	G	3	3	6	0	1	7	0	0
9	34647349	.	T	C	12	19	31	0	3	34	0	0
9	34647352	.	G	A	13	19	32	0	1	33	0	0
9	34647415	.	A	G	11	1	12	0	14	26	0	0
9	34647427	.	A	C	12	13	25	0	2	27	0	0
9	34866579	.	T	G	10	12	22	0	0	22	0	0
9	34866684	.	T	A	4	11	15	0	0	15	0	0
9	34866888	.	C	T	10	15	25	0	1	26	0	0
9	34867007	.	C	A	1	13	14	0	12	26	0	0
9	34867015	.	T	C	9	0	9	0	15	24	0	0
9	34869699	.	A	G	5	17	22	0	0	22	0	0
9	34869813	.	G	A	16	6	22	0	0	22	0	0
9	34869945	.	G	A	10	12	22	0	1	23	0	0
9	34871796	.	G	C	9	9	18	0	0	18	0	0
9	34877024	.	G	A	1	4	5	0	0	5	0	0
9	34877042	.	G	A	3	3	6	0	0	6	0	0
9	34877074	.	C	T	3	4	7	0	0	7	0	0
9	34878209	.	C	T	2	3	5	0	0	5	0	0
9	34878371	.	T	C	2	2	4	0	0	4	0	0
9	34880471	.	T	C	4	2	6	0	2	8	0	0
9	34903218	.	T	G	30	20	50	0	2	52	0	0
9	34906337	.	C	G	30	29	59	0	3	62	0	0
9	34912215	.	G	T	1	2	3	0	0	3	0	0
9	34912216	.	G	A	1	2	3	0	0	3	0	0
9	34912626	.	A	T	16	27	43	0	2	45	0	0
9	34912695	.	T	C	17	0	17	0	26	43	0	0
9	34912895	.	T	A	18	18	36	0	3	39	0	0
9	34920395	.	G	A	3	4	7	0	1	8	0	0
9	34922670	.	C	T	0	4	4	0	5	9	0	0
9	34922898	.	A	G	5	3	8	0	1	9	0	0
9	34937099	.	G	A	1	2	3	0	0	3	0	0
9	34938795	.	C	T	10	12	22	0	1	23	0	0
9	34939336	.	A	G	10	16	26	0	0	26	0	0
9	34939800	.	T	C	13	6	19	0	0	19	0	0
9	34967565	.	A	G	7	4	11	0	0	11	0	0
9	34967647	.	C	T	2	5	7	0	0	7	0	0
9	34967649	.	C	T	2	5	7	0	0	7	0	0
9	34967733	.	A	G	8	5	13	0	0	13	0	0
9	34967743	.	A	C	7	6	13	0	0	13	0	0
9	34968005	.	A	G	3	6	9	0	0	9	0	0
9	35022050	.	A	G	2	4	6	0	0	6	0	0
9	35025183	.	C	T	8	10	18	0	1	19	0	0
9	35025243	.	A	T	8	5	13	0	0	13	0	0
9	35025430	.	C	T	2	4	6	0	0	6	0	0
9	35026736	.	T	A	29	24	53	0	2	55	0	0
9	35026941	.	T	C	32	26	58	0	7	65	0	0
9	35027262	.	A	G	37	30	67	0	1	68	0	0
9	35027309	.	T	C	34	0	34	0	24	58	0	0
9	35027333	.	A	G	34	23	57	0	1	58	0	0
9	35027365	.	G	T	34	24	58	0	3	61	0	0
9	35027371	.	G	T	35	24	59	0	3	63	1	0
9	35027402	.	G	A	38	23	61	0	2	63	0	0
9	35027549	.	T	G	29	34	63	0	0	63	0	0
9	35027705	.	G	A	23	7	30	0	4	41	7	0
9	35028086	.	T	C	32	3	35	0	42	77	0	0
9	35028282	.	T	C	43	6	49	0	35	84	0	0
9	35030977	.	G	A	39	23	62	1	2	65	0	0
9	35032640	.	A	G	25	32	57	0	0	57	0	0
9	35032643	.	A	G	23	31	54	0	2	56	0	0
9	35033347	.	C	T	22	23	45	0	4	49	0	0
9	35039175	.	T	C	17	24	41	1	1	43	0	0
9	35048839	.	G	C	19	24	43	0	0	43	0	0
9	35048840	.	A	C	21	24	45	0	0	45	0	0
9	35170671	.	G	A	8	12	20	0	1	21	0	0
9	35176030	.	A	G	19	19	38	0	0	38	0	0
9	35228165	.	G	A	17	6	23	0	1	24	0	0
9	35230740	.	G	A	9	7	16	0	1	17	0	0
9	35254679	.	G	A	4	4	8	0	0	8	0	0
9	35266330	.	C	T	1	3	4	0	5	9	0	0
9	35296835	.	C	T	2	3	5	0	0	5	0	0
9	35836674	.	T	G	4	6	10	0	0	10	0	0
9	35836721	.	T	A	4	6	10	0	1	11	0	0
9	35837194	.	C	G	5	0	5	0	8	13	0	0
9	35837404	.	C	A	3	5	8	0	0	8	0	0
9	35838477	.	T	A	9	22	31	0	0	31	0	0
9	35840713	.	G	A	7	7	14	0	0	14	0	0
9	35840782	.	T	C	12	7	19	0	0	19	0	0
9	35841279	.	G	T	7	9	16	0	0	16	0	0
9	35841282	.	A	G	7	8	15	0	0	15	0	0
9	35841663	.	G	T	4	9	13	0	0	13	0	0
9	35841994	.	A	G	10	4	14	0	1	15	0	0
9	35842164	.	T	A	7	14	21	0	0	21	0	0
9	35842209	.	G	T	7	9	16	0	0	16	0	0
9	35860982	.	G	A	1	6	7	0	0	7	0	0
9	35860983	.	A	T	1	6	7	0	0	7	0	0
9	35863132	.	C	T	10	19	29	0	2	31	0	0
9	35863555	.	T	C	15	9	24	0	2	26	0	0
9	35863603	.	T	C	14	17	31	0	3	34	0	0
9	35863798	.	C	T	20	13	33	0	0	33	0	0
9	35863968	.	A	T	10	18	28	0	3	31	0	0
9	35864155	.	A	T	4	10	14	0	1	15	0	0
9	35864210	.	C	T	7	13	20	0	1	21	0	0
9	35864266	.	C	A	3	11	14	0	2	16	0	0
9	35864277	.	C	T	2	14	16	0	1	17	0	0
9	35864356	.	A	G	4	5	9	0	0	9	0	0
9	35864416	.	A	C	2	3	5	0	0	5	0	0
9	35864486	.	C	T	4	7	11	0	1	12	0	0
9	35864565	.	A	G	5	7	12	0	0	12	0	0
9	35864598	.	C	T	6	9	15	0	0	15	0	0
9	35864916	.	G	A	7	2	9	0	0	9	0	0
9	35865073	.	C	T	20	17	37	0	1	38	0	0
9	35865162	.	G	T	13	12	25	0	1	26	0	0
9	35865270	.	C	G	13	17	30	1	0	31	0	0
9	35872927	.	G	A	6	4	10	0	0	10	0	0
9	35872942	.	G	A	7	4	11	0	2	13	0	0
9	35872993	.	A	T	8	5	13	0	0	13	0	0
9	35901654	.	T	A	4	6	10	0	0	10	0	0
9	35909794	.	T	C	6	5	11	0	0	11	0	0
9	35909842	.	A	G	3	3	6	0	0	6	0	0
9	35910390	.	C	G	5	8	13	0	0	13	0	0
9	35910672	.	T	C	2	2	4	0	0	4	0	0
9	35912459	.	G	A	6	4	10	0	0	10	0	0
9	35912661	.	G	C	2	5	7	0	0	7	0	0
9	35915327	.	C	A	1	5	6	0	1	7	0	0
9	35915548	.	C	T	2	10	12	0	1	13	0	0
9	35915557	.	G	A	0	9	9	0	2	11	0	0
9	35916518	.	T	G	11	14	25	0	1	26	0	0
9	35916786	.	G	A	10	18	28	0	3	31	0	0
9	35922046	.	T	G	7	31	38	0	1	39	0	0
9	36577315	.	T	C	1	2	3	0	0	3	0	0
9	36580205	.	A	G	2	5	7	0	0	7	0	0
9	36595278	.	G	A	1	2	3	0	1	4	0	0
9	36656011	.	A	G	7	2	9	0	1	10	0	0
9	36896432	.	T	C	5	4	9	0	0	9	0	0
9	36896791	.	C	T	2	5	7	0	1	8	0	0
9	36898724	.	C	T	8	8	16	0	0	16	0	0
9	36899065	.	C	T	1	8	9	0	7	16	0	0
9	36974233	.	A	T	2	4	6	0	0	6	0	0
9	36974460	.	C	T	3	3	6	0	0	6	0	0
9	37296124	.	A	G	1	2	3	0	0	3	0	0
9	37354220	.	A	G	1	3	4	0	0	4	0	0
9	37371515	.	A	T	3	2	5	0	0	5	0	0
9	37390314	.	C	T	2	2	4	0	0	4	0	0
9	37416605	.	C	T	6	4	10	0	0	10	0	0
9	37416617	.	C	T	5	4	9	0	0	9	0	0
9	37431935	.	G	A	0	3	3	0	5	8	0	0
9	37451609	.	T	G	9	5	14	0	1	15	0	0
9	37451809	.	A	G	11	8	19	0	0	19	0	0
9	37452012	.	A	T	11	11	22	0	0	22	0	0
9	37452223	.	C	T	11	4	15	0	2	17	0	0
9	37452432	.	G	A	5	12	17	0	1	18	0	0
9	37452499	.	T	G	13	6	19	0	1	20	0	0
9	37452515	.	G	T	13	8	21	0	0	21	0	0
9	37452616	.	T	G	17	12	29	0	4	33	0	0
9	37452819	.	G	C	9	7	16	0	1	17	0	0
9	37452862	.	T	C	8	7	15	0	0	15	0	0
9	37452924	.	C	G	8	8	16	0	0	16	0	0
9	37492798	.	G	A	3	4	7	0	1	8	0	0
9	37492807	.	A	G	3	7	10	0	0	10	0	0
9	37517008	.	C	G	1	2	3	0	0	3	0	0
9	37815520	.	A	T	2	3	5	0	1	6	0	0
9	37815548	.	A	G	5	0	5	0	3	8	0	0
9	37839770	.	G	A	0	4	4	0	5	9	0	0
9	37839776	.	A	T	4	2	6	0	0	6	0	0
9	37850479	.	G	C	5	2	7	0	0	7	0	0
9	37850559	.	T	A	9	5	14	0	1	15	0	0
9	37850574	.	A	G	8	1	9	0	3	12	0	0
9	37853970	.	A	C	8	7	15	0	0	15	0	0
9	37856541	.	C	T	10	10	20	0	1	21	0	0
9	37856895	.	T	A	10	8	18	0	1	19	0	0
9	37859807	.	G	T	13	9	22	0	1	23	0	0
9	37859881	.	T	G	17	11	28	0	0	28	0	0
9	37860116	.	T	C	2	4	6	1	0	7	0	0
9	37861834	.	G	A	3	5	8	0	0	8	0	0
9	37861844	.	G	A	5	3	8	0	1	9	0	0
9	37862065	.	T	G	6	0	6	0	4	10	0	0
9	37862121	.	A	G	8	0	8	0	4	12	0	0
9	37862124	.	C	T	5	3	8	0	1	9	0	0
9	37862333	.	C	A	1	2	3	0	0	3	0	0
9	37941602	.	C	T	4	2	6	0	0	6	0	0
9	38030131	.	A	T	15	11	26	0	3	29	0	0
9	38030366	.	A	T	10	7	17	0	0	17	0	0
9	38030485	.	A	T	7	8	15	0	0	15	0	0
9	38030503	.	C	T	0	4	4	0	11	15	0	0
9	38030574	.	G	A	6	13	19	0	0	19	0	0
9	38033363	.	T	C	16	1	17	0	15	32	0	0
9	38033578	.	A	G	7	15	22	0	1	23	0	0
9	38042752	.	G	A	6	4	10	0	1	11	0	0
9	38058608	.	T	C	2	2	4	0	0	4	0	0
9	38061311	.	G	A	3	5	8	0	0	8	0	0
9	38061525	.	G	T	0	11	11	0	3	14	0	0
9	38061699	.	T	C	9	7	16	0	0	17	1	0
9	38061788	.	T	C	9	9	18	0	0	18	0	0
9	38063688	.	C	A	3	7	10	0	1	11	0	0
9	38063689	.	C	A	3	7	10	0	1	11	0	0
9	38064165	.	A	T	0	6	6	0	1	8	1	0
9	38064268	.	T	C	9	4	13	0	0	13	0	0
9	38064420	.	T	G	9	9	18	0	0	18	0	0
9	38064421	.	C	A	10	9	19	0	0	19	0	0
9	38064672	.	A	C	2	10	12	0	0	12	0	0
9	38129632	.	A	G	2	0	2	0	4	6	0	0
9	38142493	.	A	G	2	3	5	0	0	5	0	0
9	38161177	.	A	G	4	0	4	0	7	11	0	0
9	38161842	.	C	T	4	6	10	0	1	11	0	0
9	38161905	.	G	A	2	2	4	0	0	4	0	0
9	38161975	.	T	G	2	3	5	0	0	5	0	0
9	38168065	.	G	A	1	2	3	0	1	4	0	0
9	38238917	.	G	A	1	4	5	0	2	7	0	0
9	38251409	.	T	C	7	4	11	0	1	12	0	0
9	38266131	.	T	C	8	4	12	0	0	12	0	0
9	38269630	.	A	G	4	5	9	0	0	9	0	0
9	38273171	.	G	A	19	15	34	0	1	35	0	0
9	38273264	.	T	A	20	14	34	0	4	38	0	0
9	38276558	.	T	G	8	0	8	0	6	14	0	0
9	38277513	.	A	G	7	8	15	0	2	17	0	0
9	38278121	.	A	G	12	12	24	0	1	25	0	0
9	38278289	.	C	T	16	9	25	0	0	25	0	0
9	38278301	.	T	C	19	9	28	0	0	28	0	0
9	38278337	.	T	C	18	9	27	0	0	27	0	0
9	38283647	.	G	A	9	10	19	0	1	20	0	0
9	38283659	.	C	T	10	12	22	0	1	23	0	0
9	38284317	.	A	G	12	0	12	0	16	28	0	0
9	38285598	.	A	G	15	14	29	0	5	34	0	0
9	38286823	.	G	A	18	19	37	0	0	37	0	0
9	38290165	.	C	T	17	9	26	0	0	26	0	0
9	38290210	.	A	G	19	10	29	0	0	29	0	0
9	38290220	.	T	G	19	0	19	0	10	29	0	0
9	38290245	.	C	T	15	12	27	0	1	28	0	0
9	38290414	.	A	G	14	7	21	0	1	22	0	0
9	38290517	.	A	C	17	7	24	0	0	24	0	0
9	38290530	.	A	T	14	6	20	2	4	26	0	0
9	38290561	.	C	T	9	4	13	2	0	15	0	0
9	38290777	.	G	T	1	13	14	0	14	28	0	0
9	38290959	.	A	C	22	26	48	0	0	48	0	0
9	38291033	.	C	T	20	11	31	0	2	33	0	0
9	38291439	.	G	T	27	14	41	0	1	42	0	0
9	38291616	.	C	T	8	14	22	0	2	24	0	0
9	38291737	.	C	A	10	3	13	0	2	15	0	0
9	38315128	.	T	G	3	6	9	0	1	10	0	0
9	38316758	.	G	A	6	2	8	0	1	9	0	0
9	38316769	.	T	C	5	2	7	0	0	7	0	0
9	38348252	.	G	A	4	4	8	0	0	8	0	0
9	38348458	.	G	A	5	4	9	0	0	9	0	0
9	38351016	.	T	C	3	5	8	0	1	9	0	0
9	38353794	.	T	C	14	8	22	0	0	22	0	0
9	38354000	.	T	C	5	8	13	0	2	15	0	0
9	38354224	.	A	G	14	13	27	0	0	27	0	0
9	38354689	.	G	A	10	10	20	0	2	22	0	0
9	38359027	.	A	C	7	1	8	0	5	13	0	0
9	38359737	.	G	A	7	4	11	0	0	11	0	0
9	38360102	.	C	T	0	4	4	0	4	8	0	0
9	38362354	.	G	A	12	7	19	0	1	20	0	0
9	38362380	.	C	T	9	7	16	0	0	16	0	0
9	38366653	.	T	C	3	2	5	0	0	5	0	0
9	38366656	.	C	A	0	2	2	0	3	5	0	0
9	38368055	.	A	G	4	2	6	0	0	6	0	0
9	38376006	.	G	A	1	2	3	0	0	3	0	0
9	38376129	.	A	T	1	5	6	0	0	6	0	0
9	38376231	.	T	C	7	4	11	0	0	11	0	0
9	38376248	.	A	T	7	4	11	0	0	11	0	0
9	38385734	.	G	A	6	4	10	0	2	12	0	0
9	38386066	.	A	G	1	0	1	0	5	6	0	0
9	38386205	.	C	T	4	6	10	0	0	10	0	0
9	38386615	.	C	A	5	5	10	0	0	10	0	0
9	38388492	.	C	T	10	6	16	0	0	16	0	0
9	38388493	.	C	T	5	6	11	0	5	16	0	0
9	38388703	.	T	C	11	3	14	0	5	19	0	0
9	38389026	.	T	A	5	5	10	0	0	10	0	0
9	38389194	.	C	T	8	7	15	0	1	16	0	0
9	38389426	.	G	A	14	11	25	0	1	26	0	0
9	38389603	.	A	G	14	0	14	0	6	20	0	0
9	38389616	.	C	T	16	8	24	0	0	24	0	0
9	38389644	.	A	T	10	5	15	1	2	18	0	0
9	38389722	.	G	T	9	5	14	0	0	14	0	0
9	38389746	.	T	C	12	7	19	0	0	19	0	0
9	38389886	.	C	T	7	9	16	0	0	16	0	0
9	38391549	.	C	T	3	2	5	0	0	5	0	0
9	38400232	.	T	A	1	4	5	0	1	6	0	0
9	38400233	.	T	C	1	5	6	0	0	6	0	0
9	38405238	.	A	G	4	2	6	0	0	6	0	0
9	38405271	.	G	C	2	3	5	0	0	5	0	0
9	38413298	.	C	T	6	5	11	0	1	12	0	0
9	38418864	.	T	C	5	3	8	0	0	8	0	0
9	38429707	.	T	C	12	4	16	1	0	17	0	0
9	38429716	.	A	C	11	5	16	1	0	17	0	0
9	38456091	.	A	C	5	2	7	0	0	7	0	0
9	38456111	.	T	C	3	2	5	1	0	6	0	0
9	38462702	.	G	A	1	2	3	0	2	5	0	0
9	38470376	.	C	T	4	2	6	0	0	6	0	0
9	38470665	.	T	G	4	2	6	0	0	6	0	0
9	38473937	.	T	C	1	3	4	0	0	4	0	0
9	38476780	.	G	C	3	3	6	0	0	6	0	0
9	38476810	.	T	G	3	3	6	0	0	6	0	0
9	38476842	.	G	T	1	4	5	0	3	8	0	0
9	38478643	.	A	T	5	3	8	0	0	8	0	0
9	38479579	.	A	G	6	0	6	0	4	10	0	0
9	38495985	.	C	T	2	4	6	0	0	6	0	0
9	38497393	.	C	T	3	3	6	0	0	6	0	0
9	38550889	.	T	C	4	2	6	0	1	7	0	0
9	38550910	.	T	C	5	3	8	0	0	8	0	0
9	38600006	.	G	A	0	4	4	0	3	7	0	0
9	38603338	.	A	T	14	8	22	0	1	23	0	0
9	38603742	.	T	C	8	9	17	1	1	19	0	0
9	38620058	.	C	T	6	9	15	0	0	15	0	0
9	38620308	.	C	A	4	8	12	0	1	13	0	0
9	38620673	.	A	G	16	14	30	0	1	31	0	0
9	38636170	.	A	G	4	3	7	0	0	7	0	0
9	38636413	.	G	T	0	7	7	0	3	10	0	0
9	38636722	.	T	C	4	3	7	0	1	8	0	0
9	38636797	.	T	C	3	3	6	0	2	8	0	0
9	38637438	.	T	A	6	2	8	0	0	8	0	0
9	38637445	.	A	G	5	0	5	0	2	7	0	0
9	38637872	.	T	C	2	4	6	0	1	7	0	0
9	38637879	.	A	C	1	4	5	0	1	6	0	0
9	38638197	.	C	T	3	3	6	0	0	6	0	0
9	38638452	.	A	T	9	3	12	0	1	13	0	0
9	38638461	.	C	G	10	4	14	0	0	14	0	0
9	38638492	.	A	G	9	0	9	0	4	13	0	0
9	38638518	.	T	C	12	6	18	0	1	19	0	0
9	38638743	.	T	C	6	4	10	0	0	10	0	0
9	38638862	.	C	T	5	4	9	0	2	11	0	0
9	38638863	.	C	A	5	5	10	0	1	11	0	0
9	38638970	.	G	A	3	5	8	0	1	9	0	0
9	38639799	.	T	C	3	7	10	0	0	10	0	0
9	38639846	.	C	T	5	6	11	0	1	12	0	0
9	38639907	.	A	C	6	5	11	0	0	11	0	0
9	38639999	.	C	T	6	4	10	0	1	11	0	0
9	38640114	.	T	A	6	8	14	0	0	14	0	0
9	38640186	.	T	C	5	8	13	0	1	14	0	0
9	38640193	.	T	C	5	8	13	0	0	13	0	0
9	38640598	.	A	G	2	0	2	0	4	6	0	0
9	38640773	.	A	T	3	5	8	0	3	11	0	0
9	38641111	.	C	T	5	5	10	0	1	11	0	0
9	38765158	.	C	T	1	4	5	0	0	5	0	0
9	38765179	.	A	G	1	0	1	0	2	3	0	0
9	38948420	.	C	T	8	4	12	0	0	12	0	0
9	38962017	.	A	C	15	17	32	0	2	34	0	0
9	38962081	.	T	G	8	10	18	0	1	19	0	0
9	40928284	.	T	C	9	0	9	0	9	19	1	0
9	40928706	.	T	C	2	3	5	0	0	5	0	0
9	40930354	.	T	C	7	4	11	0	1	12	0	0
9	40930914	.	T	C	5	0	5	1	4	10	0	0
9	40930931	.	T	C	1	5	6	1	1	8	0	0
9	41480010	.	A	G	3	0	3	0	2	5	0	0
9	41638122	.	A	G	5	2	7	0	0	7	0	0
9	41679615	.	A	T	2	2	4	0	0	4	0	0
9	42360743	.	C	G	3	9	12	0	1	13	0	0
9	42360893	.	C	T	2	4	6	0	8	14	0	0
9	42360899	.	G	A	7	4	11	0	1	12	0	0
9	42430358	.	A	G	2	2	4	0	0	4	0	0
9	42430359	.	T	C	2	2	4	0	0	4	0	0
9	42644892	.	A	G	10	0	10	0	12	22	0	0
9	42649636	.	T	A	4	5	9	0	0	9	0	0
9	42649653	.	T	C	4	8	12	0	0	12	0	0
9	42649739	.	C	T	6	7	13	0	0	13	0	0
9	42649743	.	A	G	6	7	13	0	0	13	0	0
9	42649923	.	A	G	5	5	10	0	1	11	0	0
9	42653475	.	A	T	1	3	4	0	0	4	0	0
9	42653737	.	T	C	6	4	10	0	0	10	0	0
9	42660036	.	T	C	3	7	10	0	0	10	0	0
9	42662977	.	A	T	1	2	3	0	0	3	0	0
9	42728866	.	C	A	1	3	4	0	0	4	0	0
9	42733509	.	G	A	2	3	5	0	0	5	0	0
9	43082373	.	A	T	5	3	8	0	0	8	0	0
9	43082398	.	A	G	2	2	4	0	0	4	0	0
9	43082541	.	A	C	2	1	3	0	0	3	0	0
9	43082717	.	T	G	3	2	5	0	0	5	0	0
9	43085369	.	G	T	3	3	6	0	1	7	0	0
9	43085471	.	G	C	8	5	13	0	0	13	0	0
9	43085527	.	A	T	7	7	14	0	0	14	0	0
9	43085728	.	A	C	8	5	13	0	0	13	0	0
9	43085879	.	C	T	6	4	10	0	0	10	0	0
9	43085949	.	A	C	2	2	4	0	0	4	0	0
9	43088984	.	A	G	4	5	9	0	0	9	0	0
9	43089038	.	C	G	2	2	4	0	1	5	0	0
9	43091409	.	T	C	1	0	1	0	5	6	0	0
9	43107318	.	A	T	3	2	5	0	0	5	0	0
9	43107351	.	T	C	2	2	4	0	1	5	0	0
9	43150018	.	T	A	10	7	17	0	0	17	0	0
9	43150278	.	T	G	8	14	22	0	2	24	0	0
9	43150604	.	A	G	21	18	39	5	1	45	0	0
9	43150817	.	C	T	1	15	16	0	20	36	0	0
9	43153287	.	C	T	10	18	28	0	1	29	0	0
9	43154841	.	C	T	18	10	28	0	0	28	0	0
9	43175527	.	C	T	0	9	9	0	14	23	0	0
9	43202097	.	T	C	9	0	9	0	9	18	0	0
9	43207727	.	G	A	11	9	20	0	1	21	0	0
9	43287748	.	G	A	5	2	7	0	2	9	0	0
9	43375106	.	T	A	1	1	2	0	1	3	0	0
9	43375122	.	G	A	2	2	4	0	1	5	0	0
9	43552604	.	C	A	2	3	5	0	1	6	0	0
9	43552687	.	A	C	9	6	15	3	2	20	0	0
9	43553036	.	G	T	18	13	31	0	2	33	0	0
9	43559501	.	A	C	12	10	22	0	1	23	0	0
9	43612482	.	T	G	3	6	9	0	0	9	0	0
9	43617899	.	A	G	8	6	14	0	1	15	0	0
9	43617962	.	A	G	3	11	14	0	2	16	0	0
9	43630057	.	C	T	0	2	2	0	3	5	0	0
9	44080166	.	G	A	2	2	4	0	0	4	0	0
9	44080411	.	C	T	1	2	3	0	0	3	0	0
9	44097854	.	C	T	1	4	5	0	8	13	0	0
9	44109260	.	A	G	1	6	7	0	0	7	0	0
9	44109589	.	T	C	1	0	1	0	4	5	0	0
9	44109595	.	T	C	0	0	0	0	4	4	0	0
9	44192300	.	G	A	3	2	5	0	0	5	0	0
9	44221174	.	C	T	1	3	4	0	0	4	0	0
9	44292285	.	A	C	26	0	26	0	24	50	0	0
9	44292737	.	T	C	34	20	54	0	1	55	0	0
9	44292909	.	C	T	2	35	37	0	19	56	0	0
9	44293488	.	C	T	27	22	49	0	0	49	0	0
9	44294792	.	A	G	9	11	20	0	0	20	0	0
9	44398141	.	G	A	1	2	3	0	0	3	0	0
9	44399521	.	C	T	2	2	4	0	0	4	0	0
9	44400091	.	T	G	7	3	10	0	0	10	0	0
9	44400580	.	G	A	8	4	12	0	1	13	0	0
9	44400706	.	C	A	3	2	5	0	0	5	0	0
9	44411647	.	A	G	5	5	10	0	1	11	0	0
9	44411652	.	C	A	7	6	13	0	0	13	0	0
9	44411828	.	A	C	7	9	16	0	1	17	0	0
9	44419652	.	T	A	5	6	11	0	1	12	0	0
9	44419793	.	C	A	7	3	10	0	0	10	0	0
9	44431117	.	G	A	3	5	8	0	0	8	0	0
9	44443998	.	T	C	18	11	29	0	1	30	0	0
9	44469318	.	A	G	18	0	18	1	19	38	0	0
9	44488578	.	T	A	6	9	15	0	0	15	0	0
9	44488620	.	G	A	6	3	9	0	1	10	0	0
9	44489843	.	G	A	1	5	6	0	1	7	0	0
9	44489844	.	T	A	2	5	7	0	0	7	0	0
9	44498332	.	T	C	5	7	12	0	2	14	0	0
9	44509181	.	G	A	5	7	12	0	2	14	0	0
9	44511218	.	C	T	5	2	7	0	0	7	0	0
9	44515937	.	G	A	1	3	4	0	0	4	0	0
9	44526546	.	G	A	2	8	10	0	1	11	0	0
9	44641974	.	A	T	5	5	10	0	0	10	0	0
9	44642017	.	G	A	5	5	10	0	1	11	0	0
9	44642057	.	T	C	4	0	4	0	7	11	0	0
9	44961166	.	A	G	4	4	8	0	0	8	0	0
9	45504357	.	A	C	2	3	5	0	0	5	0	0
9	45523256	.	T	C	3	4	7	0	0	7	0	0
9	45523262	.	C	T	3	4	7	0	1	8	0	0
9	45541036	.	C	A	1	3	4	0	0	4	0	0
9	45551078	.	A	T	18	20	38	0	2	40	0	0
9	45551273	.	T	C	21	9	30	0	3	33	0	0
9	45551368	.	T	A	8	6	14	0	0	14	0	0
9	45552338	.	T	G	8	9	17	0	1	18	0	0
9	45552364	.	G	A	1	9	10	0	6	16	0	0
9	45552386	.	C	G	10	13	23	0	0	23	0	0
9	45552567	.	G	A	2	13	15	0	25	40	0	0
9	45552806	.	G	A	1	17	18	0	13	31	0	0
9	45552881	.	T	C	13	15	28	0	1	29	0	0
9	45552924	.	C	A	13	16	29	0	1	30	0	0
9	45552957	.	C	T	23	9	32	0	2	34	0	0
9	45623346	.	C	T	3	3	6	1	0	7	0	0
9	45623446	.	A	G	7	3	10	0	1	11	0	0
9	45637090	.	G	A	2	9	11	0	0	11	0	0
9	45934131	.	A	G	2	2	4	0	0	4	0	0
9	45945935	.	A	C	2	2	4	0	1	5	0	0
9	45968318	.	A	G	1	2	3	0	0	3	0	0
9	45969254	.	C	T	0	2	2	0	2	4	0	0
9	45990874	.	C	T	0	5	5	0	3	8	0	0
9	46029269	.	G	T	0	2	2	0	0	2	0	0
9	46029285	.	T	C	3	0	3	0	1	4	0	0
9	46409427	.	C	T	0	2	2	0	1	3	0	0
9	46525673	.	A	G	1	2	3	0	0	3	0	0
9	46598134	.	T	C	3	2	5	0	0	5	0	0
9	46603999	.	A	G	3	0	3	0	2	5	0	0
9	46650764	.	T	C	2	3	5	0	0	5	0	0
9	46667831	.	A	T	1	3	4	0	1	5	0	0
9	46671108	.	G	A	0	4	4	0	1	5	0	0
9	46676385	.	C	T	1	2	3	0	0	3	0	0
9	46676393	.	C	G	1	2	3	0	0	3	0	0
9	46678159	.	A	C	7	4	11	0	0	11	0	0
9	46678255	.	T	C	3	3	6	0	0	6	0	0
9	46678279	.	A	T	2	3	5	0	0	5	0	0
9	46683760	.	C	A	4	6	10	0	0	10	0	0
9	46683861	.	A	C	5	8	13	0	0	13	0	0
9	46684311	.	A	G	2	4	6	0	0	6	0	0
9	46684356	.	A	C	2	2	4	0	1	5	0	0
9	46692261	.	T	G	20	17	37	0	1	38	0	0
9	46821464	.	C	T	15	7	22	0	2	24	0	0
9	46821685	.	A	G	5	4	9	0	0	9	0	0
9	46821803	.	A	C	2	2	4	0	0	4	0	0
9	46821810	.	C	G	3	3	6	0	0	6	0	0
9	46821853	.	G	A	2	6	8	0	1	9	0	0
9	46821855	.	G	T	3	5	8	0	1	9	0	0
9	46821905	.	A	G	9	5	14	0	0	14	0	0
9	46821916	.	A	T	9	3	12	0	4	16	0	0
9	46822002	.	T	C	3	7	10	3	1	14	0	0
9	46822079	.	C	T	9	9	18	0	0	18	0	0
9	46822120	.	C	T	1	5	6	0	8	14	0	0
9	46822144	.	T	C	4	7	11	0	4	15	0	0
9	46822417	.	C	T	0	7	7	0	4	11	0	0
9	46823198	.	C	T	16	18	34	0	2	36	0	0
9	46823325	.	G	A	13	16	29	0	0	29	0	0
9	46823366	.	T	C	13	12	25	0	1	26	0	0
9	46823524	.	A	G	8	15	23	0	1	24	0	0
9	46824110	.	A	G	14	13	27	0	2	29	0	0
9	46824160	.	T	A	9	11	20	0	2	22	0	0
9	46825094	.	A	T	6	7	13	0	2	15	0	0
9	46841787	.	C	G	3	5	8	0	0	8	0	0
9	47436078	.	C	T	10	7	17	0	0	17	0	0
9	47436338	.	G	C	3	4	7	0	0	7	0	0
9	47465670	.	G	C	5	2	7	0	1	8	0	0
9	48054753	.	G	A	24	27	51	0	4	55	0	0
9	48060592	.	G	C	26	15	41	0	1	42	0	0
9	48060631	.	G	A	13	25	38	0	1	39	0	0
9	48076978	.	T	C	16	19	35	0	0	35	0	0
9	48123595	.	C	T	7	3	10	0	0	10	0	0
9	48127200	.	G	A	5	4	9	0	0	9	0	0
9	48127889	.	G	T	3	5	8	0	0	8	0	0
9	48129019	.	G	C	8	3	11	0	0	11	0	0
9	48129157	.	T	C	5	2	7	0	1	8	0	0
9	48131637	.	T	A	5	2	7	0	0	7	0	0
9	48131971	.	C	G	3	2	5	0	0	5	0	0
9	48131997	.	C	T	2	5	7	0	4	11	0	0
9	48132029	.	T	C	5	0	5	0	11	16	0	0
9	48132037	.	T	A	6	10	16	0	0	16	0	0
9	48132127	.	C	T	11	5	16	0	0	16	0	0
9	48132245	.	A	T	8	6	14	0	0	14	0	0
9	48132336	.	C	T	2	3	5	0	10	15	0	0
9	48132363	.	C	T	6	5	11	0	1	12	0	0
9	48132381	.	T	G	5	5	10	0	0	10	0	0
9	48132406	.	G	A	7	4	11	0	0	11	0	0
9	48132439	.	G	A	5	5	10	0	0	10	0	0
9	48132531	.	G	A	5	7	12	0	0	12	0	0
9	48132592	.	G	T	8	8	16	0	0	16	0	0
9	48133056	.	C	T	1	5	6	0	5	11	0	0
9	48133105	.	G	T	7	6	13	0	0	13	0	0
9	48133791	.	G	C	5	5	10	0	1	11	0	0
9	48133802	.	A	T	5	4	9	0	1	10	0	0
9	48133868	.	C	A	5	8	13	1	0	14	0	0
9	48134174	.	A	G	6	3	9	0	0	9	0	0
9	48134468	.	C	T	3	12	15	0	2	17	0	0
9	48134499	.	C	A	5	15	20	0	1	21	0	0
9	48134568	.	G	A	5	3	8	0	5	13	0	0
9	48178990	.	C	T	0	2	2	0	1	3	0	0
9	48189322	.	A	T	6	5	11	0	0	11	0	0
9	48219223	.	T	A	1	2	3	0	0	3	0	0
9	48225779	.	T	C	3	2	5	0	1	6	0	0
9	48225782	.	C	T	2	4	6	0	0	6	0	0
9	48226002	.	C	A	6	2	8	0	1	9	0	0
9	48227799	.	G	C	6	2	8	0	0	8	0	0
9	48227953	.	T	C	1	6	7	0	0	7	0	0
9	48229002	.	G	A	0	3	3	0	2	5	0	0
9	48230669	.	C	T	4	4	8	0	0	8	0	0
9	48255267	.	C	T	3	2	5	0	1	6	0	0
9	48255315	.	A	T	2	2	4	0	0	4	0	0
9	48262228	.	A	G	3	0	3	0	3	6	0	0
9	48266227	.	A	G	2	0	2	0	2	4	0	0
9	48266716	.	T	C	1	3	4	0	0	4	0	0
9	48266904	.	G	A	1	1	2	0	1	3	0	0
9	48267012	.	C	A	1	2	3	0	0	3	0	0
9	48284901	.	T	C	12	9	21	0	0	21	0	0
9	48284917	.	C	A	2	6	8	0	9	17	0	0
9	48284972	.	T	C	5	14	19	1	0	20	0	0
9	48285019	.	G	A	8	11	19	1	0	20	0	0
9	48286702	.	G	A	9	3	12	0	0	12	0	0
9	48287441	.	G	A	8	3	11	0	1	12	0	0
9	48293492	.	T	C	5	2	7	0	0	7	0	0
9	48295210	.	G	A	3	2	5	0	0	5	0	0
9	48295211	.	T	G	1	2	3	0	2	5	0	0
9	48296337	.	G	T	3	4	7	0	0	7	0	0
9	48386964	.	T	C	1	2	3	0	0	3	0	0
9	48387299	.	T	C	2	3	5	0	0	5	0	0
9	48389871	.	C	T	0	4	4	0	1	5	0	0
9	48390855	.	G	A	4	2	6	0	0	6	0	0
9	48397396	.	A	T	1	1	2	0	0	2	0	0
9	48397409	.	G	A	2	2	4	0	0	4	0	0
9	48397526	.	G	A	2	2	4	0	0	4	0	0
9	48609109	.	G	T	2	1	3	0	1	4	0	0
9	48645813	.	G	C	1	3	4	0	0	4	0	0
9	48650859	.	C	T	2	2	4	0	0	4	0	0
9	48665419	.	A	T	2	2	4	0	1	5	0	0
9	48666890	.	A	G	2	2	4	1	0	5	0	0
9	48668834	.	C	G	3	6	9	0	0	9	0	0
9	48670113	.	G	A	0	4	4	0	3	7	0	0
9	48670316	.	C	T	2	2	4	0	0	4	0	0
9	48670395	.	A	C	3	4	7	0	0	7	0	0
9	48670454	.	T	G	2	3	5	0	1	6	0	0
9	48670525	.	T	C	1	2	3	0	0	3	0	0
9	48670747	.	T	G	7	0	7	1	8	16	0	0
9	48670748	.	T	C	7	8	15	1	0	16	0	0
9	48706302	.	C	T	3	4	7	0	1	8	0	0
9	48706305	.	C	T	4	4	8	0	1	9	0	0
9	48718225	.	C	A	1	3	4	0	1	5	0	0
9	48718229	.	C	G	2	3	5	0	0	5	0	0
9	48721088	.	C	T	2	3	5	0	0	5	0	0
9	48870578	.	T	C	11	1	12	0	10	22	0	0
9	48870593	.	A	T	10	14	24	0	3	27	0	0
9	48870627	.	T	A	8	8	16	0	2	18	0	0
9	48870680	.	A	G	5	4	9	0	0	9	0	0
9	48870732	.	T	G	4	2	6	0	0	6	0	0
9	48870886	.	C	T	10	11	21	0	0	21	0	0
9	48871080	.	G	C	6	6	12	0	0	12	0	0
9	48871966	.	T	G	9	6	15	3	2	20	0	0
9	48871973	.	A	C	8	8	16	6	0	22	0	0
9	48872039	.	C	G	0	3	3	4	8	15	0	0
9	48872050	.	C	T	8	3	11	2	0	13	0	0
9	48872688	.	A	T	7	4	11	0	0	11	0	0
9	48872694	.	A	G	5	4	9	0	0	9	0	0
9	48872890	.	C	A	9	7	16	0	2	18	0	0
9	48872924	.	A	G	6	12	18	0	0	18	0	0
9	48872926	.	C	T	0	10	10	0	7	17	0	0
9	48873371	.	A	G	2	3	5	0	0	5	0	0
9	48873522	.	C	G	3	5	8	0	0	8	0	0
9	48873853	.	G	A	1	3	4	0	0	4	0	0
9	48874562	.	G	A	6	6	12	0	0	12	0	0
9	48874577	.	G	A	8	5	13	0	1	14	0	0
9	48874728	.	T	C	3	3	6	0	1	7	0	0
9	48875171	.	C	T	2	2	4	0	0	4	0	0
9	48875208	.	C	G	2	3	5	0	0	5	0	0
9	48875218	.	G	T	3	2	5	0	0	5	0	0
9	48875510	.	T	C	3	3	6	0	0	6	0	0
9	48875516	.	G	A	3	2	5	0	0	5	0	0
9	48875595	.	A	C	1	2	3	0	0	3	0	0
9	48876199	.	T	C	4	2	6	0	0	6	0	0
9	48876544	.	C	T	4	5	9	0	1	10	0	0
9	48877348	.	A	G	2	3	5	0	0	5	0	0
9	50194812	.	G	A	0	2	2	0	1	3	0	0
9	50205609	.	C	T	4	2	6	0	0	6	0	0
9	50750269	.	G	A	1	2	3	0	0	3	0	0
9	50751505	.	T	C	1	2	3	0	1	4	0	0
9	51292956	.	A	G	23	11	34	0	0	34	0	0
9	51302422	.	A	G	19	18	37	0	1	38	0	0
9	51307238	.	T	C	10	5	15	0	2	17	0	0
9	51307387	.	G	T	6	7	13	0	0	13	0	0
9	51317030	.	T	C	7	0	7	0	5	12	0	0
9	51340645	.	A	G	2	5	7	0	0	7	0	0
9	51996246	.	C	T	1	6	7	0	5	12	0	0
9	51996280	.	T	A	9	5	14	0	0	14	0	0
9	51996281	.	G	A	9	5	14	0	0	14	0	0
9	51996444	.	T	G	11	11	22	0	1	23	0	0
9	51996788	.	A	G	6	2	8	0	0	8	0	0
9	51996800	.	T	C	3	2	5	0	0	5	0	0
9	51996974	.	C	T	5	7	12	0	1	13	0	0
9	51998330	.	T	C	8	3	11	0	0	11	0	0
9	51998495	.	A	C	7	0	7	0	3	10	0	0
9	51998648	.	C	T	7	3	10	0	0	10	0	0
9	51998784	.	T	G	6	5	11	0	0	11	0	0
9	51998841	.	G	T	7	4	11	0	0	11	0	0
9	51998866	.	A	T	9	4	13	0	0	13	0	0
9	51999842	.	C	G	3	2	5	0	0	5	0	0
9	51999855	.	T	G	4	3	7	0	0	7	0	0
9	51999885	.	C	T	7	2	9	0	1	10	0	0
9	51999924	.	T	A	9	3	12	0	1	13	0	0
9	52000032	.	C	T	0	3	3	0	3	6	0	0
9	52000127	.	C	G	4	2	6	0	0	6	0	0
9	52000139	.	G	A	4	2	6	0	0	6	0	0
9	52000164	.	G	A	4	3	7	0	0	7	0	0
9	52000293	.	T	C	9	0	9	0	3	12	0	0
9	52000335	.	A	T	8	3	11	0	0	11	0	0
9	52000623	.	C	T	0	2	2	0	3	5	0	0
9	52037940	.	G	T	4	4	8	0	0	8	0	0
9	52057708	.	C	T	3	2	5	0	0	5	0	0
9	52378697	.	A	G	17	11	28	0	3	31	0	0
9	52378832	.	T	A	28	13	41	1	1	43	0	0
9	52433132	.	T	C	1	3	4	0	0	4	0	0
9	52435020	.	C	A	2	3	5	0	0	5	0	0
9	52435028	.	T	C	4	3	7	0	0	7	0	0
9	52435058	.	G	C	3	4	7	0	1	8	0	0
9	52435100	.	G	A	4	2	6	0	0	6	0	0
9	52435112	.	C	T	2	2	4	0	1	5	0	0
9	52479199	.	T	C	1	2	3	0	0	3	0	0
9	52479815	.	C	T	0	6	6	0	1	7	0	0
9	52479822	.	C	G	0	6	6	0	1	7	0	0
9	52479901	.	C	T	1	3	4	0	1	5	0	0
9	52487535	.	T	C	2	0	2	0	3	5	0	0
9	52489838	.	C	A	2	6	8	0	1	9	0	0
9	52489899	.	T	C	2	1	3	0	1	4	0	0
9	52490015	.	A	G	1	2	3	0	0	3	0	0
9	52490121	.	A	T	1	3	4	0	0	4	0	0
9	52490127	.	A	G	1	3	4	0	0	4	0	0
9	52490175	.	T	G	1	2	3	0	0	3	0	0
9	52490201	.	T	G	1	2	3	0	0	3	0	0
9	52490210	.	G	A	1	1	2	0	1	3	0	0
9	52492641	.	A	C	5	3	8	0	1	9	0	0
9	52492688	.	C	G	13	0	13	0	7	20	0	0
9	52492705	.	A	G	7	14	21	0	0	21	0	0
9	52493231	.	A	T	3	11	14	0	0	15	1	0
9	52493406	.	C	T	11	3	14	0	0	14	0	0
9	52539290	.	G	A	4	6	10	0	8	18	0	0
9	52539453	.	C	T	7	19	26	0	1	27	0	0
9	52539629	.	C	T	10	10	20	0	4	24	0	0
9	52564578	.	T	C	4	0	4	0	4	8	0	0
9	52564622	.	T	C	7	4	11	0	0	11	0	0
9	52570629	.	A	G	6	5	11	0	0	11	0	0
9	52572555	.	C	T	6	4	10	0	0	10	0	0
9	52572573	.	G	A	7	4	11	0	1	12	0	0
9	52572609	.	C	G	7	5	12	0	0	12	0	0
9	52577701	.	A	G	2	5	7	0	0	7	0	0
9	52608099	.	C	T	0	2	2	0	1	3	0	0
9	52629113	.	C	T	5	9	14	0	2	16	0	0
9	52629119	.	C	T	9	5	14	0	1	15	0	0
9	52629155	.	T	C	4	13	17	0	0	17	0	0
9	52631620	.	G	A	12	4	16	0	0	16	0	0
9	52633184	.	C	G	3	2	5	0	0	5	0	0
9	52642012	.	G	A	6	5	11	0	0	11	0	0
9	52645687	.	C	T	0	7	7	0	3	10	0	0
9	52649704	.	C	T	0	3	3	0	1	4	0	0
9	52649794	.	A	G	3	2	5	0	0	5	0	0
9	52649941	.	G	A	4	2	6	0	0	6	0	0
9	52651985	.	T	C	1	6	7	0	0	7	0	0
9	52695091	.	A	G	1	6	7	0	0	7	0	0
9	53276550	.	A	C	6	5	11	0	1	12	0	0
9	53276681	.	G	A	0	5	5	0	9	14	0	0
9	53276976	.	C	T	7	9	16	0	2	18	0	0
9	53276978	.	A	G	10	7	17	0	1	18	0	0
9	53277068	.	C	G	7	0	7	1	6	14	0	0
9	53277131	.	A	T	9	7	16	0	1	17	0	0
9	53277453	.	G	A	0	5	5	0	9	14	0	0
9	53277493	.	A	T	7	10	17	0	1	18	0	0
9	53535713	.	C	T	5	2	7	0	0	7	0	0
9	53707638	.	G	C	0	1	1	0	3	4	0	0
9	53707653	.	A	T	2	2	4	0	1	5	0	0
9	53707761	.	A	G	2	2	4	0	0	4	0	0
9	53708037	.	G	A	1	3	4	0	0	4	0	0
9	53708055	.	T	C	2	3	5	0	1	6	0	0
9	53708316	.	G	A	1	2	3	0	2	5	0	0
9	53709003	.	C	T	7	6	13	0	0	13	0	0
9	53709184	.	T	C	4	6	10	0	0	10	0	0
9	53709365	.	C	T	3	10	13	0	1	14	0	0
9	53719342	.	T	C	9	14	23	0	0	23	0	0
9	53843404	.	C	T	12	9	21	0	0	21	0	0
9	53843590	.	A	T	9	7	16	0	0	16	0	0
9	53843813	.	G	A	6	6	12	0	0	12	0	0
9	53843909	.	C	T	0	7	7	0	5	12	0	0
9	53844188	.	T	C	6	0	6	0	6	12	0	0
9	53845537	.	A	G	10	7	17	0	1	18	0	0
9	53849440	.	G	A	15	6	21	0	1	22	0	0
9	53851676	.	C	T	7	8	15	0	2	17	0	0
9	53853614	.	C	T	8	5	13	0	0	13	0	0
9	53853615	.	T	C	7	5	12	0	0	12	0	0
9	53853662	.	G	C	8	0	8	0	9	17	0	0
9	53867508	.	A	G	3	4	7	0	0	7	0	0
9	53867511	.	A	G	3	4	7	0	1	8	0	0
9	53869247	.	G	A	4	4	8	0	0	8	0	0
9	53869344	.	T	C	5	4	9	1	0	10	0	0
9	53890451	.	T	C	2	0	2	0	2	4	0	0
9	53896187	.	C	T	1	3	4	0	3	7	0	0
9	53909815	.	C	A	0	2	2	0	2	4	0	0
9	54112151	.	T	A	6	2	8	0	0	8	0	0
9	54112168	.	G	C	5	3	8	0	0	8	0	0
9	54112469	.	T	C	7	4	11	0	0	11	0	0
9	54112526	.	T	A	3	5	8	0	0	8	0	0
9	54112571	.	A	G	1	8	9	0	0	9	0	0
9	54113324	.	C	T	2	2	4	0	1	5	0	0
9	54113481	.	C	T	6	2	8	0	1	9	0	0
9	54113954	.	C	T	4	7	11	0	0	11	0	0
9	54114050	.	A	G	2	0	2	0	8	10	0	0
9	54114242	.	T	G	3	0	3	0	6	9	0	0
9	54247370	.	T	G	1	0	1	0	5	6	0	0
9	54247374	.	T	G	1	0	1	0	4	5	0	0
9	54696118	.	G	A	3	2	5	0	0	5	0	0
9	54696137	.	T	C	2	2	4	0	0	4	0	0
9	54711020	.	G	T	11	10	21	0	0	21	0	0
9	54711512	.	T	C	5	3	8	2	1	11	0	0
9	54711513	.	T	C	4	5	9	2	0	11	0	0
9	54712644	.	T	C	20	6	26	0	2	28	0	0
9	54712650	.	T	C	7	15	22	0	4	26	0	0
9	54712704	.	A	G	16	9	25	0	2	27	0	0
9	54712745	.	T	C	14	14	28	0	5	33	0	0
9	54712751	.	C	T	18	13	31	0	0	31	0	0
9	54712917	.	A	T	9	11	20	0	1	21	0	0
9	54712945	.	G	A	13	16	29	0	0	29	0	0
9	54712985	.	A	C	11	15	26	0	1	27	0	0
9	54715157	.	T	C	7	9	16	0	1	17	0	0
9	54716349	.	G	A	6	11	17	0	0	17	0	0
9	54716542	.	A	G	1	2	3	0	1	4	0	0
9	54722532	.	T	G	3	0	3	0	2	5	0	0
9	54722553	.	T	C	2	4	6	0	0	6	0	0
9	54723323	.	G	A	3	3	6	0	0	6	0	0
9	54725594	.	A	G	1	0	1	0	6	7	0	0
9	54725631	.	C	T	4	4	8	0	1	9	0	0
9	54728274	.	T	A	3	2	5	0	0	5	0	0
9	54728780	.	A	G	2	4	6	0	0	6	0	0
9	54734620	.	G	C	4	6	10	0	0	10	0	0
9	54738987	.	C	T	2	4	6	0	1	7	0	0
9	54739015	.	A	T	4	3	7	0	2	9	0	0
9	54739181	.	C	G	4	2	6	0	0	6	0	0
9	54739182	.	C	A	3	2	5	0	1	6	0	0
9	54739539	.	C	A	1	5	6	0	0	6	0	0
9	54739605	.	C	A	6	5	11	0	0	11	0	0
9	54763880	.	C	A	4	9	13	0	0	13	0	0
9	54763930	.	A	T	7	2	9	0	0	9	0	0
9	54763977	.	T	A	6	3	9	0	1	10	0	0
9	54764102	.	C	T	8	3	11	0	0	11	0	0
9	54764143	.	G	A	7	10	17	0	0	17	0	0
9	54764349	.	G	A	9	10	19	0	0	19	0	0
9	54769705	.	T	C	6	0	6	0	4	10	0	0
9	54775967	.	A	G	3	2	5	0	0	5	0	0
9	54775995	.	G	A	2	2	4	0	0	4	0	0
9	54776055	.	T	C	1	0	1	0	2	3	0	0
9	55413485	.	C	A	1	5	6	0	0	6	0	0
9	55418067	.	C	T	1	4	5	0	0	5	0	0
9	55730341	.	G	A	3	5	8	0	0	8	0	0
9	55748586	.	T	C	5	3	8	0	0	8	0	0
9	55748631	.	T	C	2	0	2	0	11	13	0	0
9	55748676	.	T	A	0	5	5	0	0	5	0	0
9	55748691	.	A	G	1	3	4	0	0	4	0	0
9	55748855	.	C	A	2	7	9	1	2	12	0	0
9	55748983	.	G	A	3	2	5	0	1	6	0	0
9	55749040	.	A	G	8	3	11	0	0	11	0	0
9	55749083	.	T	C	4	0	4	0	8	12	0	0
9	55749108	.	T	C	4	4	8	0	0	8	0	0
9	55749151	.	T	C	5	0	5	0	4	9	0	0
9	55749194	.	C	T	0	7	7	0	2	9	0	0
9	55750092	.	G	T	4	2	6	0	0	6	0	0
9	55750255	.	C	G	1	9	10	0	3	13	0	0
9	55750357	.	A	C	1	0	1	0	3	4	0	0
9	55750367	.	G	A	1	2	3	0	1	4	0	0
9	55750649	.	G	C	5	4	9	0	0	9	0	0
9	55750756	.	C	T	10	3	13	0	1	14	0	0
9	55750792	.	C	T	0	4	4	1	12	17	0	0
9	55756519	.	A	T	3	5	8	0	0	8	0	0
9	55756582	.	T	A	5	5	10	0	0	10	0	0
9	55771721	.	G	C	3	2	5	0	0	5	0	0
9	55771841	.	C	T	5	2	7	0	0	7	0	0
9	55784001	.	C	T	0	3	3	0	1	4	0	0
9	55784148	.	C	T	2	3	5	0	0	5	0	0
9	55860036	.	T	C	1	4	5	0	0	5	0	0
9	55860096	.	G	A	0	3	3	0	2	5	0	0
9	55860127	.	C	T	2	4	6	0	1	7	0	0
9	55860460	.	C	T	2	5	7	0	0	7	0	0
9	55870475	.	G	A	0	3	3	3	9	15	0	0
9	55870562	.	C	A	4	10	14	0	1	15	0	0
9	55874434	.	T	A	0	6	6	0	2	8	0	0
9	55874548	.	A	T	11	6	17	0	2	19	0	0
9	56205024	.	A	G	2	0	2	0	2	4	0	0
9	56225580	.	A	G	12	0	12	0	6	18	0	0
9	56225591	.	C	T	9	8	17	0	1	18	0	0
9	56225620	.	C	T	9	4	13	0	1	14	0	0
9	56225740	.	T	A	5	11	16	0	1	17	0	0
9	56225849	.	A	G	9	6	15	0	0	15	0	0
9	56225850	.	A	G	9	5	14	0	1	15	0	0
9	56226132	.	T	C	3	11	14	0	0	14	0	0
9	56230655	.	A	G	33	30	63	0	1	64	0	0
9	56230676	.	G	T	32	33	65	0	0	65	0	0
9	56231322	.	T	C	33	35	68	0	6	74	0	0
9	56231325	.	A	G	37	33	70	0	4	74	0	0
9	56232588	.	C	G	4	3	7	0	0	7	0	0
9	56237883	.	T	C	6	7	13	0	0	13	0	0
9	56251743	.	G	A	1	2	3	6	0	9	0	0
9	56350968	.	C	T	1	7	8	0	6	14	0	0
9	56351059	.	C	T	15	7	22	0	0	22	0	0
9	56353479	.	G	A	11	12	23	0	1	24	0	0
9	56363292	.	T	A	4	9	13	0	0	13	0	0
9	56369168	.	G	T	9	13	22	0	1	23	0	0
9	56369252	.	G	A	13	9	22	0	0	22	0	0
9	56369319	.	C	A	8	4	12	0	1	13	0	0
9	56389303	.	A	G	3	8	11	0	1	12	0	0
9	56451482	.	C	A	1	2	3	0	0	3	0	0
9	56451669	.	G	A	0	3	3	0	2	5	0	0
9	56456064	.	C	T	2	7	9	0	0	9	0	0
9	56456065	.	G	C	0	6	6	0	3	9	0	0
9	56456882	.	C	A	1	2	3	0	0	3	0	0
9	56457309	.	A	T	8	7	15	0	0	15	0	0
