contig	position	variantID	refAllele	altAllele	refCount	altCount	totalCount	lowMAPQDepth	lowBaseQDepth	rawDepth	otherBases	improperPairs
1	6698	.	G	A	14	25	39	0	3	42	0	0
1	6746	.	T	C	35	6	41	0	30	71	0	0
1	10093	.	C	T	45	26	71	0	2	73	0	0
1	14083	.	G	A	0	7	7	0	10	17	0	0
1	15050	.	G	A	1	8	9	0	7	16	0	0
1	15772	.	G	A	0	5	5	0	9	14	0	0
1	15828	.	G	A	1	7	8	0	4	12	0	0
1	16072	.	C	T	5	5	10	0	0	10	0	0
1	32450	.	T	C	9	12	21	0	1	22	0	0
1	33036	.	C	T	10	6	16	0	2	18	0	0
1	38106	.	C	T	16	18	34	0	1	35	0	0
1	38814	.	G	A	3	13	16	0	22	38	0	0
1	39620	.	C	A	0	5	5	0	6	11	0	0
1	39621	.	G	C	6	5	11	0	0	11	0	0
1	39717	.	T	G	5	4	9	0	3	12	0	0
1	40409	.	T	C	7	6	13	0	0	13	0	0
1	41287	.	C	T	2	4	6	0	3	9	0	0
1	41560	.	G	A	6	2	8	0	0	8	0	0
1	45214	.	G	T	1	2	3	0	0	3	0	0
1	61090	.	A	G	3	12	15	0	0	15	0	0
1	62771	.	G	A	4	8	12	0	0	12	0	0
1	62838	.	C	T	6	3	9	0	2	11	0	0
1	153527	.	A	G	8	9	17	0	0	17	0	0
1	154104	.	G	C	9	9	18	0	0	18	0	0
1	154113	.	G	A	8	9	17	0	1	18	0	0
1	154140	.	C	A	1	10	11	0	8	19	0	0
1	157915	.	T	A	8	5	13	0	0	13	0	0
1	176642	.	C	T	8	14	22	0	1	23	0	0
1	176774	.	C	T	9	10	19	5	1	25	0	0
1	181717	.	T	C	16	22	38	0	2	40	0	0
1	181754	.	C	T	16	25	41	0	0	41	0	0
1	181763	.	A	G	13	25	38	0	0	38	0	0
1	185010	.	A	G	2	3	5	0	0	5	0	0
1	185057	.	G	A	6	5	11	0	1	12	0	0
1	185126	.	G	A	4	4	8	0	0	8	0	0
1	185191	.	C	T	2	4	6	0	0	6	0	0
1	191914	.	C	G	8	4	12	0	0	12	0	0
1	208262	.	G	A	10	3	13	0	0	13	0	0
1	208265	.	G	A	11	3	14	0	0	14	0	0
1	208408	.	T	A	14	18	32	0	0	32	0	0
1	208564	.	T	C	17	6	23	0	2	25	0	0
1	208570	.	T	C	10	14	24	0	3	27	0	0
1	209162	.	T	C	15	14	29	0	0	29	0	0
1	212162	.	G	A	4	7	11	0	0	11	0	0
1	218551	.	C	T	5	4	9	0	0	9	0	0
1	218775	.	G	A	5	4	9	0	0	9	0	0
1	219437	.	C	T	3	2	5	0	0	5	0	0
1	223511	.	T	C	3	4	7	0	0	7	0	0
1	225044	.	G	A	1	10	11	0	8	19	0	0
1	225083	.	C	T	6	9	15	0	0	15	0	0
1	230372	.	G	A	4	7	11	0	0	11	0	0
1	442456	.	T	C	9	3	12	2	0	14	0	0
1	474398	.	C	A	1	6	7	0	5	12	0	0
1	474465	.	C	T	11	6	17	0	0	17	0	0
1	474473	.	A	G	10	6	16	0	1	17	0	0
1	476034	.	G	A	7	5	12	0	0	12	0	0
1	477001	.	C	T	0	6	6	0	9	15	0	0
1	477013	.	G	T	7	6	13	0	0	13	0	0
1	477046	.	G	A	9	6	15	0	0	15	0	0
1	477070	.	C	T	2	6	8	0	9	17	0	0
1	477109	.	C	T	0	7	7	0	6	13	0	0
1	477817	.	C	T	6	2	8	0	1	9	0	0
1	477823	.	G	C	5	4	9	0	1	10	0	0
1	477951	.	C	T	1	7	8	0	0	8	0	0
1	479986	.	A	G	4	7	11	0	0	11	0	0
1	483862	.	A	T	5	3	8	0	0	8	0	0
1	483873	.	C	T	7	3	10	0	1	11	0	0
1	484418	.	G	A	4	5	9	0	0	9	0	0
1	484434	.	C	T	6	6	12	0	0	12	0	0
1	486775	.	T	C	3	5	8	0	0	8	0	0
1	488342	.	C	G	9	3	12	0	0	12	0	0
1	488390	.	G	A	2	7	9	0	1	10	0	0
1	492141	.	T	C	2	4	6	0	0	6	0	0
1	492222	.	C	T	0	3	3	0	3	6	0	0
1	492231	.	C	A	3	3	6	0	0	6	0	0
1	494246	.	A	T	3	8	11	0	0	11	0	0
1	496303	.	A	G	5	10	15	1	2	18	0	0
1	496305	.	A	C	7	10	17	1	0	18	0	0
1	496760	.	A	G	4	0	4	0	4	8	0	0
1	497054	.	G	A	6	3	9	0	0	9	0	0
1	499220	.	A	G	11	4	15	0	0	15	0	0
1	501303	.	G	A	1	4	5	0	7	12	0	0
1	501381	.	T	A	5	7	12	0	0	12	0	0
1	502079	.	C	A	4	8	12	0	1	13	0	0
1	503900	.	C	T	8	11	19	0	0	19	0	0
1	504073	.	A	G	12	0	12	0	10	22	0	0
1	504696	.	A	G	13	0	13	0	6	19	0	0
1	505178	.	G	A	7	7	14	0	0	14	0	0
1	505260	.	A	G	4	0	4	0	6	10	0	0
1	505298	.	C	T	10	6	16	0	0	16	0	0
1	505403	.	G	A	13	4	17	0	0	17	0	0
1	505499	.	C	G	1	5	6	0	0	6	0	0
1	509387	.	A	G	6	4	10	0	1	11	0	0
1	509718	.	T	A	2	6	8	0	0	8	0	0
1	509769	.	G	T	2	4	6	0	0	6	0	0
1	511525	.	G	A	4	8	12	0	1	13	0	0
1	511544	.	C	T	7	8	15	0	0	15	0	0
1	511957	.	G	A	4	8	12	0	0	12	0	0
1	512127	.	C	T	4	2	6	0	1	7	0	0
1	514114	.	G	A	0	5	5	0	7	12	0	0
1	514202	.	C	T	11	4	15	0	1	16	0	0
1	515549	.	G	A	7	7	14	0	1	15	0	0
1	515575	.	G	C	6	9	15	0	1	16	0	0
1	517515	.	C	T	12	7	19	0	4	23	0	0
1	524806	.	G	A	11	6	17	0	0	17	0	0
1	524828	.	C	T	10	6	16	0	0	16	0	0
1	528522	.	G	A	1	17	18	0	17	35	0	0
1	528552	.	A	C	21	11	32	0	2	34	0	0
1	530497	.	T	A	5	5	10	0	3	13	0	0
1	546147	.	A	G	1	4	5	0	0	5	0	0
1	546198	.	C	T	3	4	7	0	0	7	0	0
1	553154	.	A	G	1	0	1	0	2	3	0	0
1	586161	.	G	A	0	6	6	0	11	17	0	0
1	586165	.	C	T	10	6	16	0	1	17	0	0
1	586765	.	C	T	11	4	15	0	0	15	0	0
1	587200	.	G	T	9	7	16	0	0	16	0	0
1	589044	.	A	T	12	11	23	0	3	27	1	0
1	589056	.	C	T	14	12	26	0	1	27	0	0
1	589115	.	G	A	1	11	12	0	16	28	0	0
1	594664	.	C	G	2	3	5	0	0	5	0	0
1	601873	.	C	T	10	3	13	0	0	13	0	0
1	601882	.	G	A	9	4	13	0	0	13	0	0
1	601954	.	C	T	4	2	6	0	0	6	0	0
1	603292	.	A	G	5	8	13	0	4	17	0	0
1	606128	.	A	C	9	8	17	0	1	18	0	0
1	610606	.	C	T	1	7	8	0	0	8	0	0
1	610722	.	T	C	12	11	23	0	0	23	0	0
1	611267	.	T	C	34	25	59	0	1	60	0	0
1	614568	.	C	G	0	15	15	0	12	27	0	0
1	617950	.	C	T	6	21	27	0	28	55	0	0
1	618190	.	A	C	30	1	31	0	29	60	0	0
1	618210	.	G	A	28	30	58	0	3	61	0	0
1	618277	.	A	G	29	24	53	0	3	56	0	0
1	618434	.	C	T	39	23	62	0	4	66	0	0
1	618760	.	C	T	1	7	8	0	14	22	0	0
1	618776	.	C	A	12	15	27	0	1	28	0	0
1	618826	.	C	T	17	14	31	0	1	32	0	0
1	618918	.	A	T	20	42	62	0	2	64	0	0
1	618932	.	A	G	16	43	59	0	3	62	0	0
1	619679	.	T	A	17	11	28	0	1	29	0	0
1	619703	.	C	T	1	19	20	0	14	34	0	0
1	619764	.	C	T	16	15	31	0	0	31	0	0
1	620244	.	A	T	29	30	59	0	5	64	0	0
1	620314	.	G	A	24	33	57	0	5	62	0	0
1	620516	.	A	T	26	28	54	0	2	56	0	0
1	620517	.	T	G	29	26	55	0	2	57	0	0
1	621027	.	C	T	3	23	26	0	21	47	0	0
1	621063	.	T	A	19	24	43	0	1	44	0	0
1	621069	.	G	A	20	22	42	0	0	42	0	0
1	621102	.	A	T	14	29	43	0	2	45	0	0
1	621283	.	C	T	2	20	22	0	25	47	0	0
1	621389	.	C	T	33	25	58	0	2	60	0	0
1	621440	.	C	T	29	28	57	0	4	61	0	0
1	626601	.	G	A	29	22	51	0	4	55	0	0
1	629610	.	G	A	23	17	40	0	2	42	0	0
1	629619	.	A	G	20	19	39	0	3	42	0	0
1	634882	.	T	C	27	19	46	1	0	47	0	0
1	634933	.	T	C	30	12	42	1	4	53	6	0
1	638431	.	C	T	3	20	23	0	26	49	0	0
1	658850	.	A	G	1	2	3	0	0	3	0	0
1	658942	.	G	A	3	2	5	0	1	6	0	0
1	659542	.	A	T	3	3	6	0	0	6	0	0
1	669650	.	A	G	1	3	4	0	0	4	0	0
1	669651	.	G	A	1	3	4	0	0	4	0	0
1	673768	.	C	T	0	2	2	0	2	4	0	0
1	673847	.	C	T	0	3	3	0	2	5	0	0
1	680657	.	T	C	1	0	1	0	2	3	0	0
1	692338	.	A	G	3	2	5	0	0	5	0	0
1	700301	.	G	T	2	2	4	0	0	4	0	0
1	5273659	.	G	A	5	3	8	0	1	9	0	0
1	5273712	.	A	T	6	4	10	0	1	11	0	0
1	5273808	.	A	G	9	5	14	0	0	14	0	0
1	5273826	.	G	A	6	6	12	0	1	13	0	0
1	5273889	.	C	A	6	5	11	0	2	13	0	0
1	5275892	.	G	A	6	11	17	0	1	18	0	0
1	5276189	.	G	A	14	8	22	0	1	23	0	0
1	5276257	.	T	C	14	10	24	0	0	24	0	0
1	5276343	.	G	A	14	8	22	0	0	22	0	0
1	5354765	.	C	A	15	21	36	0	0	36	0	0
1	5354768	.	A	G	15	20	35	0	1	36	0	0
1	5354929	.	T	C	19	21	40	0	0	40	0	0
1	5355024	.	G	T	24	21	45	0	2	47	0	0
1	5355334	.	G	A	30	27	57	0	3	60	0	0
1	5355435	.	C	T	3	10	13	3	39	55	0	0
1	5355514	.	G	A	31	30	61	1	1	63	0	0
1	5355707	.	T	A	35	25	60	2	2	64	0	0
1	5355804	.	C	T	5	27	32	1	26	59	0	0
1	5356001	.	C	A	21	17	38	0	0	38	0	0
1	5356002	.	A	C	19	0	19	0	19	38	0	0
1	5356075	.	A	T	20	25	45	0	1	46	0	0
1	5356087	.	C	T	18	19	37	1	1	39	0	0
1	5356455	.	T	G	20	16	36	0	3	39	0	0
1	5356497	.	C	A	18	17	35	0	0	35	0	0
1	5356499	.	G	T	18	17	35	0	0	35	0	0
1	5356667	.	A	T	20	12	32	0	1	33	0	0
1	5356681	.	T	C	18	3	21	0	12	33	0	0
1	5357053	.	T	C	21	6	27	0	0	27	0	0
1	5357203	.	G	A	4	19	23	1	2	26	0	0
1	5357405	.	T	C	11	14	25	0	4	29	0	0
1	5357528	.	C	G	16	15	31	1	1	33	0	0
1	5357541	.	T	C	9	18	27	1	6	34	0	0
1	5357742	.	C	A	18	17	35	0	1	36	0	0
1	5357772	.	C	G	24	15	39	2	1	42	0	0
1	5357845	.	C	A	26	20	46	0	2	49	1	0
1	5357967	.	T	G	21	9	30	0	1	31	0	0
1	5358265	.	C	T	4	14	18	0	22	40	0	0
1	5358448	.	A	G	14	15	29	0	0	29	0	0
1	5358480	.	G	T	10	17	27	0	0	27	0	0
1	5358528	.	T	C	3	12	15	0	0	15	0	0
1	5358531	.	A	C	4	12	16	0	0	16	0	0
1	5358792	.	C	A	11	13	24	0	0	25	1	0
1	5365350	.	G	A	18	23	41	0	0	41	0	0
1	5365368	.	C	T	17	16	33	0	3	36	0	0
1	5375285	.	C	T	21	21	42	0	1	43	0	0
1	5378957	.	T	G	11	19	30	0	0	30	0	0
1	5402605	.	T	A	11	9	20	0	0	20	0	0
1	5414300	.	T	C	18	7	25	0	0	25	0	0
1	5414327	.	C	T	21	12	33	0	2	35	0	0
1	5415859	.	T	C	15	12	27	0	1	28	0	0
1	5415970	.	C	G	12	16	28	0	2	30	0	0
1	5418692	.	C	T	23	9	32	0	0	32	0	0
1	5418971	.	A	T	17	20	37	0	2	39	0	0
1	5419043	.	G	T	8	4	12	0	0	12	0	0
1	5433554	.	C	T	7	7	14	0	1	15	0	0
1	5433709	.	C	T	7	8	15	0	0	15	0	0
1	5433712	.	T	C	8	8	16	0	0	16	0	0
1	5433890	.	T	C	5	5	10	0	0	10	0	0
1	5499059	.	T	A	0	2	2	0	1	3	0	0
1	5503701	.	T	C	3	2	5	0	0	5	0	0
1	5503722	.	G	T	2	2	4	0	0	4	0	0
1	5503778	.	T	G	3	4	7	0	0	7	0	0
1	5503809	.	T	C	4	4	8	0	1	9	0	0
1	5503828	.	T	C	2	3	5	0	0	5	0	0
1	5504733	.	A	C	5	2	7	0	0	7	0	0
1	5504792	.	C	A	3	2	5	0	0	5	0	0
1	5504793	.	T	C	2	2	4	0	0	4	0	0
1	5505119	.	G	A	4	4	8	0	0	8	0	0
1	5507298	.	A	G	1	3	4	0	0	4	0	0
1	5507440	.	C	T	1	4	5	0	0	5	0	0
1	5512075	.	G	A	1	2	3	0	0	3	0	0
1	5584450	.	A	G	1	0	1	0	2	3	0	0
1	5586908	.	G	C	2	2	4	0	0	4	0	0
1	5606790	.	C	A	18	20	38	0	1	39	0	0
1	5607137	.	G	T	13	4	17	0	1	18	0	0
1	5607181	.	A	G	9	7	16	0	1	17	0	0
1	5607349	.	T	A	7	7	14	0	0	14	0	0
1	5607597	.	G	A	7	7	14	0	2	16	0	0
1	5607668	.	T	C	12	12	24	1	3	28	0	0
1	5607914	.	G	T	6	6	12	0	1	13	0	0
1	5607929	.	C	A	6	4	10	0	1	11	0	0
1	5607970	.	T	C	3	6	9	0	0	9	0	0
1	5608215	.	G	T	10	9	19	0	0	19	0	0
1	5631812	.	A	G	3	4	7	0	1	8	0	0
1	5631815	.	G	C	3	0	3	0	5	8	0	0
1	5632031	.	A	G	5	2	7	0	0	7	0	0
1	5638713	.	G	A	2	2	4	0	0	4	0	0
1	5671710	.	A	G	5	3	8	0	0	8	0	0
1	5671728	.	G	T	3	5	8	0	0	8	0	0
1	5675514	.	A	G	6	6	12	0	1	13	0	0
1	5681042	.	C	T	0	4	4	0	3	7	0	0
1	5681072	.	G	A	4	2	6	0	1	7	0	0
1	5745572	.	G	A	1	2	3	0	0	3	0	0
1	5745902	.	C	G	5	5	10	0	0	10	0	0
1	6137622	.	G	A	1	2	3	0	0	3	0	0
1	6137629	.	G	A	0	2	2	0	1	3	0	0
1	6137829	.	A	G	3	4	7	0	0	7	0	0
1	6138027	.	A	T	1	3	4	0	0	4	0	0
1	6144223	.	A	G	3	2	5	0	0	5	0	0
1	6146698	.	G	T	2	3	5	0	0	5	0	0
1	6153251	.	T	C	1	5	6	0	0	6	0	0
1	6153397	.	A	G	1	0	1	0	3	4	0	0
1	6153451	.	G	A	1	4	5	0	0	5	0	0
1	6158360	.	G	T	1	8	9	0	2	11	0	0
1	6158557	.	T	G	1	2	3	0	0	3	0	0
1	6165150	.	A	G	9	14	23	0	0	23	0	0
1	6165213	.	C	T	9	7	16	0	1	17	0	0
1	6165318	.	A	C	5	7	12	0	0	12	0	0
1	6167421	.	A	G	4	0	4	0	13	17	0	0
1	6168264	.	G	A	10	8	18	0	0	18	0	0
1	6168346	.	T	A	11	13	24	0	1	25	0	0
1	6168411	.	G	C	20	9	29	0	1	30	0	0
1	6168417	.	G	T	4	8	12	0	17	29	0	0
1	6168568	.	C	G	9	10	19	0	1	20	0	0
1	6168858	.	A	G	11	0	11	0	15	26	0	0
1	6168875	.	G	A	14	12	26	1	0	27	0	0
1	6168925	.	T	C	13	6	19	1	0	20	0	0
1	6169155	.	C	T	4	7	11	0	1	12	0	0
1	6169208	.	C	T	10	7	17	0	2	19	0	0
1	6169232	.	T	C	11	5	16	0	0	16	0	0
1	6169279	.	G	A	11	8	19	0	1	20	0	0
1	6169317	.	C	T	14	8	22	0	0	22	0	0
1	6169378	.	C	T	12	8	20	0	0	20	0	0
1	6169387	.	G	C	11	10	21	0	2	23	0	0
1	6169688	.	A	T	3	3	6	0	0	6	0	0
1	6169691	.	C	T	3	3	6	0	0	6	0	0
1	6173631	.	T	C	5	6	11	0	1	12	0	0
1	6175280	.	G	A	1	6	7	0	8	15	0	0
1	6185280	.	T	A	11	10	21	1	3	25	0	0
1	6185320	.	T	A	9	10	19	0	3	22	0	0
1	6185326	.	A	C	12	9	21	0	0	21	0	0
1	6185411	.	C	T	2	4	6	0	0	6	0	0
1	6185461	.	C	T	3	2	5	0	0	5	0	0
1	6190003	.	A	G	1	5	6	0	1	7	0	0
1	6190127	.	A	G	4	5	9	0	0	9	0	0
1	6199003	.	T	C	14	9	23	0	2	25	0	0
1	6201976	.	C	T	10	8	18	0	0	18	0	0
1	6206978	.	C	T	8	3	11	0	0	11	0	0
1	6207041	.	A	G	9	8	17	0	0	18	1	0
1	6209632	.	G	A	2	10	12	0	10	22	0	0
1	6209662	.	T	G	13	7	20	0	1	21	0	0
1	6209743	.	A	T	8	8	16	0	2	18	0	0
1	6209746	.	G	A	2	8	10	0	9	19	0	0
1	6210190	.	T	G	6	1	7	0	10	17	0	0
1	6210243	.	T	C	8	18	26	0	0	26	0	0
1	6210471	.	T	C	6	10	16	0	1	17	0	0
1	6225563	.	G	A	0	4	4	0	3	7	0	0
1	6225909	.	A	C	2	4	6	0	0	6	0	0
1	6226084	.	A	G	2	3	5	0	0	5	0	0
1	6231293	.	T	C	6	5	11	0	0	11	0	0
1	6231305	.	G	A	5	4	9	0	0	9	0	0
1	6240444	.	T	G	2	2	4	0	0	4	0	0
1	6240474	.	A	C	3	2	5	0	0	5	0	0
1	6241379	.	G	T	0	7	7	0	5	12	0	0
1	6243549	.	A	G	8	0	8	0	7	15	0	0
1	6243975	.	T	G	3	3	6	0	0	6	0	0
1	6244279	.	A	T	3	3	6	0	0	6	0	0
1	6244281	.	G	C	3	3	6	0	0	6	0	0
1	6252839	.	T	C	2	3	5	0	1	6	0	0
1	6262842	.	G	A	0	3	3	0	2	5	0	0
1	6264973	.	C	A	4	2	6	0	0	6	0	0
1	6269116	.	T	C	2	4	6	0	1	7	0	0
1	6271664	.	A	G	4	6	10	0	2	12	0	0
1	6271712	.	T	C	3	5	8	0	0	8	0	0
1	6357164	.	A	C	13	7	20	0	1	21	0	0
1	6357840	.	A	G	7	7	14	0	2	16	0	0
1	6364196	.	T	C	5	5	10	0	1	11	0	0
1	6365673	.	A	G	8	5	13	0	1	14	0	0
1	6365793	.	A	C	4	5	9	0	0	9	0	0
1	6404145	.	G	C	6	5	11	0	1	12	0	0
1	6404205	.	A	T	4	9	13	0	1	14	0	0
1	6404250	.	G	A	3	8	11	0	1	12	0	0
1	6404659	.	G	A	11	7	18	0	1	19	0	0
1	6429608	.	A	G	7	8	15	0	1	16	0	0
1	6429646	.	A	G	6	7	13	0	0	13	0	0
1	6494181	.	G	A	7	3	10	0	0	10	0	0
1	6494215	.	T	G	5	3	8	0	0	8	0	0
1	6494227	.	C	T	0	2	2	0	5	7	0	0
1	6646688	.	T	G	5	0	5	0	10	15	0	0
1	6648724	.	T	C	4	4	8	0	0	8	0	0
1	6662858	.	A	T	8	11	19	0	0	19	0	0
1	6663946	.	A	G	3	5	8	0	2	10	0	0
1	6884604	.	G	A	0	4	4	0	1	5	0	0
1	6884625	.	C	A	2	3	5	0	0	5	0	0
1	6887969	.	G	T	3	4	7	0	0	7	0	0
1	6909761	.	T	C	3	3	6	0	1	7	0	0
1	6918865	.	G	A	1	6	7	0	0	7	0	0
1	6924361	.	A	G	7	4	11	0	0	11	0	0
1	6924761	.	G	A	0	6	6	0	8	14	0	0
1	6924858	.	G	C	5	4	9	0	0	9	0	0
1	6925300	.	A	C	1	3	4	0	0	4	0	0
1	6925307	.	G	T	2	3	5	0	0	5	0	0
1	7447340	.	C	T	2	2	4	0	0	4	0	0
1	7447374	.	T	C	1	2	3	0	0	3	0	0
1	7447598	.	C	T	2	2	4	0	0	4	0	0
1	7518644	.	C	T	24	13	37	0	1	38	0	0
1	7522455	.	T	C	10	14	24	0	0	24	0	0
1	7523258	.	A	C	16	16	32	0	1	33	0	0
1	7523264	.	C	T	17	16	33	0	0	33	0	0
1	7526839	.	G	A	19	20	39	0	2	41	0	0
1	7528289	.	G	C	2	21	23	0	24	47	0	0
1	7529833	.	G	C	3	28	31	0	23	54	0	0
1	7530123	.	C	T	23	15	38	0	4	42	0	0
1	7538822	.	C	T	36	18	54	0	3	57	0	0
1	7539053	.	G	C	21	17	38	0	0	38	0	0
1	7539531	.	G	A	10	5	15	0	0	15	0	0
1	7546298	.	C	T	2	2	4	0	0	4	0	0
1	7559902	.	G	A	2	12	14	1	34	49	0	0
1	7632221	.	C	T	6	2	8	0	1	9	0	0
1	7662571	.	T	C	20	21	41	0	1	42	0	0
1	7662628	.	G	A	19	19	38	0	0	38	0	0
1	7662723	.	T	A	14	21	35	0	0	35	0	0
1	7662728	.	G	A	14	23	37	0	1	38	0	0
1	7662880	.	A	T	13	19	32	0	0	32	0	0
1	7670535	.	C	T	29	24	53	0	4	57	0	0
1	7672794	.	T	C	27	24	51	0	5	56	0	0
1	7672809	.	C	T	28	25	53	0	3	56	0	0
1	7673070	.	C	T	26	24	50	0	1	51	0	0
1	7673129	.	C	A	14	23	37	0	1	38	0	0
1	7673198	.	A	G	17	17	34	0	2	36	0	0
1	7682949	.	G	A	8	5	13	0	0	13	0	0
1	7847890	.	T	A	1	3	4	7	0	11	0	0
1	7864780	.	A	G	4	2	6	0	1	7	0	0
1	7874950	.	A	G	4	3	7	0	0	7	0	0
1	7875057	.	G	A	1	3	4	0	0	4	0	0
1	7894186	.	C	T	4	2	6	0	0	6	0	0
1	8022495	.	C	T	10	10	20	0	1	21	0	0
1	8022532	.	A	G	10	15	25	0	1	26	0	0
1	8022606	.	T	C	7	8	15	0	0	15	0	0
1	8022682	.	C	T	0	20	20	0	12	32	0	0
1	8023433	.	C	T	12	11	23	0	1	24	0	0
1	8023587	.	A	G	8	14	22	0	1	23	0	0
1	8023730	.	C	T	20	10	30	0	1	31	0	0
1	8024087	.	G	A	24	10	34	1	1	36	0	0
1	8025863	.	C	T	16	16	32	0	1	33	0	0
1	8026146	.	C	T	19	13	32	0	1	33	0	0
1	8026148	.	T	G	19	13	32	0	2	34	0	0
1	8026293	.	G	T	12	16	28	0	3	31	0	0
1	8026345	.	C	T	15	19	34	0	1	35	0	0
1	8026415	.	C	T	0	18	18	0	20	38	0	0
1	8026521	.	C	A	2	24	26	0	19	46	1	0
1	8026565	.	C	T	23	22	45	0	1	46	0	0
1	8026924	.	T	A	13	12	25	0	3	28	0	0
1	8028177	.	T	A	14	9	23	0	1	24	0	0
1	8028652	.	G	A	19	14	33	0	0	33	0	0
1	8028688	.	C	A	12	18	30	0	1	31	0	0
1	8028727	.	G	A	15	19	34	0	0	34	0	0
1	8028811	.	C	T	2	15	17	0	16	33	0	0
1	8032800	.	T	C	5	6	11	0	0	11	0	0
1	8032947	.	G	A	21	19	40	0	0	40	0	0
1	8032986	.	A	G	15	13	28	0	0	28	0	0
1	8047508	.	C	T	7	10	17	0	0	17	0	0
1	8049495	.	C	T	0	8	8	0	6	14	0	0
1	8051513	.	G	A	14	7	21	0	0	21	0	0
1	8055927	.	T	C	16	0	16	0	6	22	0	0
1	8055954	.	A	G	12	9	21	0	0	21	0	0
1	8058005	.	A	G	11	7	18	0	0	18	0	0
1	8159982	.	C	T	2	2	4	0	1	5	0	0
1	8162990	.	G	A	3	2	5	0	0	5	0	0
1	8165443	.	A	C	2	5	7	0	0	7	0	0
1	8165609	.	C	T	6	8	14	0	2	16	0	0
1	8165643	.	T	C	5	4	9	0	1	10	0	0
1	8165667	.	T	C	4	5	9	0	1	10	0	0
1	8165741	.	T	C	2	4	6	0	0	6	0	0
1	8166788	.	A	T	12	8	20	0	0	20	0	0
1	8166992	.	A	G	6	6	12	0	1	13	0	0
1	8167194	.	G	T	5	2	7	0	1	8	0	0
1	8167218	.	C	T	0	2	2	0	2	4	0	0
1	8167319	.	A	G	5	2	7	0	0	7	0	0
1	8167368	.	G	A	5	9	14	0	0	14	0	0
1	8167508	.	A	G	14	9	23	0	1	24	0	0
1	8167526	.	C	T	14	7	21	0	0	21	0	0
1	8167570	.	C	G	10	7	17	0	0	17	0	0
1	8167668	.	G	A	7	9	16	0	0	16	0	0
1	8169262	.	C	T	5	7	12	0	0	12	0	0
1	8169268	.	C	T	5	6	11	0	1	12	0	0
1	8169361	.	G	A	8	7	15	0	0	15	0	0
1	8185072	.	G	A	5	9	14	0	0	14	0	0
1	8185103	.	G	A	6	8	14	0	1	15	0	0
1	8189518	.	G	T	10	8	18	0	2	20	0	0
1	8192188	.	C	G	5	4	9	0	0	9	0	0
1	8192192	.	A	G	5	4	9	0	0	9	0	0
1	8192344	.	A	C	3	15	18	0	0	18	0	0
1	8192382	.	T	A	2	5	7	0	1	8	0	0
1	8403141	.	C	A	1	2	3	0	0	3	0	0
1	8403299	.	G	A	0	3	3	0	5	8	0	0
1	8416565	.	T	A	27	28	55	0	1	56	0	0
1	8416629	.	T	G	26	22	48	0	2	50	0	0
1	8416820	.	C	T	6	6	12	0	1	13	0	0
1	8417768	.	T	C	2	2	4	0	0	4	0	0
1	8417821	.	A	T	8	2	10	0	1	12	1	0
1	8417823	.	T	G	7	5	12	0	0	12	0	0
1	8417896	.	T	C	16	27	43	0	2	45	0	0
1	8417943	.	A	G	18	16	34	0	3	37	0	0
1	8418118	.	C	G	14	7	21	0	2	24	1	0
1	8418126	.	A	C	7	1	8	0	13	21	0	0
1	8422521	.	A	G	27	26	53	1	0	54	0	0
1	8424738	.	C	T	4	25	29	0	17	46	0	0
1	8424804	.	C	T	18	18	36	0	5	41	0	0
1	8424813	.	A	G	17	24	41	0	0	41	0	0
1	8508755	.	G	A	1	5	6	0	4	10	0	0
1	8508809	.	G	T	7	6	13	0	0	13	0	0
1	8508950	.	T	C	8	7	15	0	0	15	0	0
1	8511602	.	C	T	9	16	25	0	0	25	0	0
1	8511778	.	G	T	1	16	17	0	13	30	0	0
1	8516407	.	G	A	0	14	14	0	18	32	0	0
1	8516443	.	C	G	12	12	24	0	1	25	0	0
1	8516552	.	A	G	13	8	21	0	0	21	0	0
1	8527205	.	G	T	2	9	11	0	1	12	0	0
1	8529745	.	G	A	1	3	4	0	5	9	0	0
1	8530234	.	G	T	0	2	2	0	3	5	0	0
1	8530336	.	G	A	0	2	2	0	3	5	0	0
1	8530544	.	T	A	3	4	7	0	0	7	0	0
1	8530548	.	T	G	3	4	7	0	0	7	0	0
1	8531155	.	G	A	2	3	5	0	0	5	0	0
1	8531311	.	C	T	3	3	6	0	0	6	0	0
1	8531494	.	A	G	2	1	3	0	0	3	0	0
1	8531653	.	T	C	3	4	7	0	1	8	0	0
1	8543337	.	T	A	4	3	7	0	0	7	0	0
1	8543380	.	G	A	3	4	7	0	0	7	0	0
1	8543390	.	C	T	3	3	6	0	0	6	0	0
1	8543707	.	A	G	1	6	7	0	0	7	0	0
1	8544457	.	C	T	3	5	8	0	1	9	0	0
1	8544483	.	G	A	2	7	9	0	0	9	0	0
1	8547315	.	G	C	3	0	3	0	2	5	0	0
1	8548647	.	T	A	2	3	5	0	0	5	0	0
1	8555456	.	A	G	1	1	2	0	1	3	0	0
1	8555582	.	C	G	8	5	13	0	0	13	0	0
1	8557099	.	C	T	1	8	9	0	4	13	0	0
1	8559950	.	G	T	2	2	4	0	0	4	0	0
1	8559967	.	A	G	2	3	5	0	0	5	0	0
1	8560208	.	G	A	3	3	6	0	0	6	0	0
1	8560237	.	C	T	4	3	7	0	1	8	0	0
1	8560266	.	C	T	3	4	7	0	0	7	0	0
1	8563728	.	C	T	4	7	11	0	0	11	0	0
1	8563755	.	A	G	3	7	10	0	0	10	0	0
1	8563792	.	G	A	5	2	7	0	1	8	0	0
1	8564058	.	C	T	3	4	7	0	0	7	0	0
1	8566237	.	G	A	5	4	9	0	0	9	0	0
1	8566545	.	T	C	2	2	4	0	0	4	0	0
1	8601971	.	A	T	15	4	19	0	0	19	0	0
1	8601990	.	A	T	17	6	23	0	0	23	0	0
1	8604175	.	C	T	9	3	12	0	0	12	0	0
1	8606561	.	C	T	4	14	18	0	0	18	0	0
1	8606611	.	T	C	6	9	15	0	0	15	0	0
1	8606644	.	G	A	12	6	18	0	0	18	0	0
1	8607487	.	C	T	4	18	22	0	1	23	0	0
1	8607547	.	C	T	1	14	15	0	0	15	0	0
1	8608008	.	T	C	12	8	20	0	2	22	0	0
1	8608180	.	G	A	1	11	12	0	8	20	0	0
1	8610451	.	G	A	0	13	13	0	9	22	0	0
1	8638537	.	T	G	3	7	10	0	2	12	0	0
1	8639883	.	G	A	1	2	3	0	0	3	0	0
1	8642800	.	C	T	6	5	11	0	2	13	0	0
1	8642824	.	A	T	5	5	10	0	0	10	0	0
1	8642938	.	A	G	4	2	6	0	1	7	0	0
1	8642953	.	C	T	1	2	3	0	2	5	0	0
1	8643661	.	T	A	3	4	7	0	0	7	0	0
1	8649726	.	A	G	45	43	88	3	4	95	0	0
1	8649865	.	C	T	58	18	76	1	5	82	0	0
1	8649988	.	A	G	36	32	68	0	9	77	0	0
1	8649994	.	A	T	36	36	72	0	2	75	1	0
1	8650317	.	G	A	33	32	65	0	2	67	0	0
1	8650371	.	C	T	32	35	67	0	2	69	0	0
1	8650544	.	G	A	1	2	3	0	0	3	0	0
1	8651036	.	G	A	39	31	70	0	2	72	0	0
1	8651060	.	T	C	35	35	70	0	3	73	0	0
1	8651576	.	G	A	35	33	68	2	3	73	0	0
1	8662553	.	G	A	17	27	44	0	0	44	0	0
1	8663048	.	G	A	1	17	18	0	17	35	0	0
1	8663195	.	T	G	18	21	39	0	2	41	0	0
1	8663295	.	T	C	11	22	33	0	2	35	0	0
1	8667377	.	G	A	27	12	39	0	0	39	0	0
1	8667606	.	C	T	16	20	36	0	2	38	0	0
1	8668166	.	T	C	24	26	50	0	1	51	0	0
1	8668238	.	G	T	25	21	46	0	1	47	0	0
1	8668532	.	C	A	2	3	5	0	0	5	0	0
1	8668886	.	T	C	1	3	4	0	0	6	2	0
1	8668930	.	A	T	3	4	7	0	0	7	0	0
1	8669669	.	A	G	15	9	24	0	0	24	0	0
1	8669673	.	A	G	17	5	22	0	1	23	0	0
1	8669717	.	T	G	14	15	29	0	2	31	0	0
1	8669718	.	T	C	13	16	29	0	2	31	0	0
1	8669753	.	T	A	23	15	38	0	2	40	0	0
1	8669847	.	G	T	34	16	50	0	2	52	0	0
1	8670031	.	T	C	25	33	58	0	3	61	0	0
1	8670032	.	G	T	2	27	29	0	32	61	0	0
1	8670402	.	G	A	19	14	33	0	1	34	0	0
1	8694404	.	G	A	14	13	27	0	2	29	0	0
1	8698765	.	T	C	22	21	43	0	1	44	0	0
1	8699065	.	G	A	1	2	3	0	0	3	0	0
1	8701548	.	A	G	28	0	28	0	24	52	0	0
1	8702325	.	G	T	17	23	40	0	0	40	0	0
1	8702400	.	T	C	27	23	50	0	1	51	0	0
1	8764123	.	C	T	4	6	10	0	0	10	0	0
1	8764612	.	T	C	1	0	1	0	11	12	0	0
1	8764812	.	G	A	14	6	20	0	1	21	0	0
1	8765028	.	G	A	8	14	22	0	2	24	0	0
1	8765491	.	T	A	14	13	27	0	0	27	0	0
1	8765493	.	G	T	10	12	22	0	2	24	0	0
1	8766453	.	C	T	18	19	37	0	1	38	0	0
1	8766471	.	C	T	2	21	23	0	16	39	0	0
1	8766501	.	C	T	12	22	34	0	1	35	0	0
1	8766693	.	G	A	14	13	27	0	2	29	0	0
1	8766903	.	G	C	10	13	23	0	1	24	0	0
1	8770773	.	G	A	3	7	10	0	0	10	0	0
1	8771020	.	T	G	12	13	25	0	0	25	0	0
1	8773257	.	G	A	9	9	18	0	0	18	0	0
1	8773269	.	T	C	9	9	18	0	1	19	0	0
1	8773320	.	G	A	9	8	17	0	0	17	0	0
1	8776506	.	G	A	8	7	15	0	1	16	0	0
1	8777796	.	C	A	4	10	14	0	0	14	0	0
1	8917623	.	C	T	10	13	23	0	0	23	0	0
1	9044526	.	C	T	15	8	23	0	1	24	0	0
1	9044745	.	C	T	11	13	24	0	0	24	0	0
1	9051092	.	T	C	16	11	27	0	1	28	0	0
1	9064781	.	T	G	4	3	7	0	1	8	0	0
1	9064791	.	C	A	4	5	9	0	1	10	0	0
1	9064885	.	C	A	2	4	6	0	1	7	0	0
1	9074335	.	C	T	18	12	30	0	2	32	0	0
1	9118497	.	T	A	22	18	40	0	0	40	0	0
1	9123289	.	C	G	18	17	35	3	1	39	0	0
1	9156228	.	T	C	1	3	4	0	0	4	0	0
1	9261903	.	A	C	13	0	13	0	10	23	0	0
1	9261930	.	G	A	10	9	19	0	3	22	0	0
1	9262173	.	G	A	15	19	34	0	1	35	0	0
1	9262221	.	A	G	13	10	23	0	2	25	0	0
1	9265578	.	T	C	7	12	19	0	1	20	0	0
1	9270885	.	G	A	8	8	16	0	0	16	0	0
1	9270933	.	C	T	8	11	19	0	0	19	0	0
1	9273011	.	C	T	9	5	14	0	5	19	0	0
1	9273037	.	A	G	9	8	17	0	2	19	0	0
1	9273173	.	G	A	14	7	21	0	0	21	0	0
1	9278150	.	G	A	6	13	19	0	0	19	0	0
1	9290319	.	A	G	5	8	13	0	0	13	0	0
1	9290432	.	T	A	6	4	10	0	0	10	0	0
1	9290500	.	G	T	5	2	7	0	0	7	0	0
1	9292975	.	A	T	7	4	11	0	0	11	0	0
1	9293002	.	T	C	10	9	19	0	1	20	0	0
1	9293495	.	A	G	7	6	13	0	3	16	0	0
1	9499764	.	C	T	9	9	18	0	1	19	0	0
1	9500312	.	A	T	2	10	12	0	2	14	0	0
1	9500502	.	G	T	3	3	6	0	1	7	0	0
1	9500508	.	C	A	2	4	6	0	1	7	0	0
1	9500585	.	T	G	6	2	8	0	0	8	0	0
1	9500598	.	T	G	5	2	7	0	1	8	0	0
1	9500835	.	A	G	5	5	10	0	1	11	0	0
1	9500947	.	G	T	5	5	10	0	1	11	0	0
1	9500984	.	A	T	3	6	9	0	0	9	0	0
1	9501031	.	C	T	10	4	14	0	1	15	0	0
1	9501229	.	C	T	12	16	28	0	0	28	0	0
1	9501231	.	G	A	15	10	25	0	1	26	0	0
1	9501365	.	T	C	11	0	11	0	11	22	0	0
1	9501394	.	T	A	9	11	20	0	0	20	0	0
1	9508752	.	T	A	3	12	15	0	2	17	0	0
1	9510571	.	A	G	4	3	7	0	0	7	0	0
1	9510574	.	G	A	5	3	8	0	0	8	0	0
1	9512342	.	C	T	3	15	18	0	0	18	0	0
1	9516905	.	A	C	7	8	15	0	1	16	0	0
1	9517048	.	A	G	5	9	14	0	1	15	0	0
1	9517102	.	G	A	7	11	18	0	0	18	0	0
1	9519935	.	G	A	3	2	5	0	0	5	0	0
1	9523283	.	C	T	0	6	6	0	3	9	0	0
1	9527076	.	T	A	7	6	13	0	0	13	0	0
1	9527108	.	T	C	5	4	9	0	0	9	0	0
1	9557456	.	T	C	3	4	7	0	0	7	0	0
1	9618201	.	C	T	1	2	3	0	0	3	0	0
1	9708747	.	C	A	1	2	3	0	0	3	0	0
1	9709340	.	C	T	2	3	5	0	0	5	0	0
1	9709500	.	G	A	1	4	5	0	0	5	0	0
1	9710759	.	C	T	6	3	9	0	1	10	0	0
1	9710853	.	T	C	7	3	10	0	0	10	0	0
1	9711158	.	G	A	5	4	9	0	0	9	0	0
1	9711161	.	G	A	4	5	9	0	0	9	0	0
1	9711405	.	T	A	2	3	5	0	1	6	0	0
1	9712111	.	G	A	1	3	4	0	9	13	0	0
1	9712291	.	T	C	1	4	5	0	2	7	0	0
1	9740960	.	A	T	2	4	6	0	0	6	0	0
1	9740989	.	T	A	2	4	6	0	0	6	0	0
1	9741123	.	G	A	3	2	5	0	0	5	0	0
1	9793219	.	C	T	1	5	6	0	1	7	0	0
1	9793220	.	T	C	1	6	7	0	0	7	0	0
1	9793286	.	C	T	1	2	3	0	2	5	0	0
1	9808324	.	A	G	1	7	8	0	0	8	0	0
1	9808345	.	T	A	2	7	9	0	0	9	0	0
1	9808365	.	C	T	2	4	6	0	0	6	0	0
1	9808691	.	A	T	5	3	8	0	0	8	0	0
1	9856270	.	T	C	1	3	4	0	0	4	0	0
1	9858447	.	C	T	0	2	2	0	2	4	0	0
1	9858451	.	G	A	2	2	4	0	0	4	0	0
1	9865364	.	G	T	2	3	5	0	0	5	0	0
1	9873485	.	G	A	3	5	8	0	0	8	0	0
1	9873509	.	G	A	6	4	10	0	0	10	0	0
1	9873538	.	G	A	6	4	10	0	0	10	0	0
1	9873607	.	A	T	4	7	11	0	4	15	0	0
1	9873616	.	T	C	5	0	5	0	12	17	0	0
1	9873787	.	G	A	5	7	12	0	1	13	0	0
1	9877335	.	A	G	1	3	4	1	0	5	0	0
1	9877426	.	C	T	0	3	3	0	1	4	0	0
1	9877576	.	C	T	0	4	4	0	3	7	0	0
1	9883339	.	T	C	1	2	3	0	0	3	0	0
1	9920038	.	A	G	4	4	8	0	0	8	0	0
1	9920359	.	G	A	6	5	11	0	0	11	0	0
1	9920631	.	G	A	6	5	11	0	0	11	0	0
1	10667832	.	C	T	0	2	2	0	7	9	0	0
1	10667856	.	A	G	7	3	10	0	0	10	0	0
1	10669212	.	C	T	7	2	9	0	0	9	0	0
1	10675585	.	A	T	3	3	6	0	1	7	0	0
1	10675629	.	A	T	4	3	7	0	0	7	0	0
1	10680513	.	A	G	5	2	7	0	0	7	0	0
1	10680518	.	C	T	0	2	2	0	5	7	0	0
1	10680585	.	T	C	9	3	12	0	0	12	0	0
1	10683868	.	A	T	20	10	30	2	2	34	0	0
1	10683955	.	A	G	17	14	31	0	4	35	0	0
1	10683974	.	A	C	14	17	31	0	1	32	0	0
1	10684037	.	A	G	18	0	18	0	18	36	0	0
1	10684105	.	G	A	3	16	19	0	20	39	0	0
1	10688731	.	T	G	15	0	15	0	17	32	0	0
1	10692078	.	T	C	32	9	41	1	1	43	0	0
1	10736181	.	G	A	33	30	63	0	6	69	0	0
1	10738176	.	A	G	30	12	42	0	0	42	0	0
1	10738177	.	A	G	26	15	41	0	2	43	0	0
1	10738509	.	T	C	27	37	64	0	1	65	0	0
1	10738535	.	G	A	35	29	64	0	3	67	0	0
1	10738568	.	A	G	34	1	35	0	32	67	0	0
1	10739190	.	A	G	51	17	68	0	1	69	0	0
1	10841254	.	T	C	7	18	25	0	0	25	0	0
1	10841275	.	T	C	9	15	24	0	0	24	0	0
1	10841356	.	G	A	7	9	16	0	0	16	0	0
1	10885173	.	A	C	6	4	10	0	0	10	0	0
1	10885266	.	T	A	5	3	8	0	1	9	0	0
1	10912132	.	C	T	4	4	8	0	0	8	0	0
1	10914197	.	A	G	1	3	4	0	0	4	0	0
1	10950594	.	C	T	1	4	5	0	2	7	0	0
1	10950747	.	C	A	2	3	5	0	0	5	0	0
1	10950751	.	G	A	2	3	5	0	0	5	0	0
1	11124918	.	C	T	1	3	4	0	1	5	0	0
1	11125149	.	C	T	1	3	4	0	4	8	0	0
1	11125177	.	C	T	4	6	10	0	0	10	0	0
1	11125195	.	C	T	5	7	12	0	1	13	0	0
1	11125237	.	G	A	3	6	9	0	0	9	0	0
1	11125249	.	A	C	3	5	8	0	1	9	0	0
1	11127938	.	G	A	5	7	12	0	1	13	0	0
1	11128515	.	C	A	1	4	5	0	5	10	0	0
1	11130713	.	G	A	2	6	8	0	0	8	0	0
1	11136648	.	G	A	4	3	7	0	1	8	0	0
1	11141082	.	C	T	3	3	6	0	0	6	0	0
1	11144295	.	T	C	5	3	8	0	0	8	0	0
1	11150984	.	G	A	3	2	5	0	0	5	0	0
1	11155084	.	A	T	1	3	4	0	1	6	1	0
1	11157060	.	T	C	1	2	3	0	0	3	0	0
1	11216633	.	A	G	2	1	3	0	1	4	0	0
1	11275073	.	A	G	5	3	8	0	0	8	0	0
1	11671059	.	A	G	4	4	8	0	2	10	0	0
1	11671355	.	C	A	5	2	7	0	0	7	0	0
1	11671527	.	G	A	6	6	12	0	1	13	0	0
1	11671580	.	C	T	9	3	12	0	0	12	0	0
1	11671651	.	A	C	3	2	5	0	0	5	0	0
1	11695068	.	C	A	6	0	6	0	0	6	0	0
1	11783388	.	T	C	15	19	34	0	2	36	0	0
1	11783410	.	T	C	24	10	34	0	1	35	0	0
1	11783504	.	T	C	23	15	38	0	0	38	0	0
1	11783650	.	T	C	25	20	45	0	3	48	0	0
1	11784522	.	T	C	42	15	57	0	1	58	0	0
1	11784668	.	T	C	36	11	47	0	0	47	0	0
1	11784679	.	T	C	15	28	43	0	4	47	0	0
1	15254068	.	A	G	6	2	8	1	1	10	0	0
1	15254124	.	A	G	5	2	7	0	0	7	0	0
1	15254249	.	A	G	10	0	10	0	13	23	0	0
1	16675263	.	A	T	1	7	8	0	0	8	0	0
1	17523030	.	A	G	23	0	23	0	7	30	0	0
1	17523636	.	A	G	20	8	28	0	0	28	0	0
1	17535858	.	A	G	8	0	8	0	5	13	0	0
1	17535859	.	A	G	5	7	12	0	1	13	0	0
1	17538085	.	T	C	3	0	3	1	6	10	0	0
1	19742745	.	C	T	3	2	5	0	0	5	0	0
1	19742779	.	A	C	1	2	3	0	0	3	0	0
1	19762901	.	C	T	5	6	11	0	0	11	0	0
1	19785208	.	A	C	3	2	5	0	0	5	0	0
1	19815977	.	T	C	3	2	5	0	0	5	0	0
1	19862011	.	G	A	3	4	7	0	0	7	0	0
1	19862012	.	C	A	3	4	7	0	0	7	0	0
1	19866347	.	C	T	2	5	7	0	0	7	0	0
1	19872148	.	C	T	4	3	7	0	0	7	0	0
1	19872269	.	C	T	6	6	12	0	0	12	0	0
1	19874550	.	G	A	9	4	13	0	0	13	0	0
1	19879890	.	A	T	6	5	11	0	0	11	0	0
1	19882538	.	C	A	4	3	7	0	0	7	0	0
1	19886159	.	A	C	1	5	6	0	0	6	0	0
1	19886292	.	T	A	5	6	11	0	0	11	0	0
1	19936259	.	G	T	0	8	8	0	7	15	0	0
1	19936298	.	G	A	6	5	11	0	1	12	0	0
1	19936358	.	T	C	12	9	21	0	0	21	0	0
1	19936418	.	T	A	10	10	20	0	1	21	0	0
1	19936511	.	T	C	9	9	18	0	0	18	0	0
1	19936682	.	C	T	6	5	11	0	0	11	0	0
1	19937090	.	A	G	10	0	10	0	15	25	0	0
1	19950478	.	A	T	14	12	26	0	2	28	0	0
1	19955634	.	A	G	10	10	20	0	1	21	0	0
1	19955706	.	C	T	9	4	13	0	0	13	0	0
1	19966416	.	C	T	15	13	28	0	1	29	0	0
1	19978049	.	A	G	6	1	7	0	12	19	0	0
1	19984448	.	C	T	18	11	29	0	1	30	0	0
1	19988952	.	C	G	16	12	28	0	0	28	0	0
1	19989008	.	T	G	14	17	31	0	1	32	0	0
1	19989023	.	G	A	2	15	17	0	14	31	0	0
1	19989323	.	A	C	7	21	28	0	0	28	0	0
1	19989355	.	G	A	4	13	17	0	3	20	0	0
1	20063678	.	A	G	1	3	4	0	0	4	0	0
1	20063843	.	C	A	0	4	4	0	3	7	0	0
1	20065156	.	A	G	5	6	11	0	0	11	0	0
1	20094234	.	G	A	9	3	12	0	0	12	0	0
1	20094327	.	G	T	6	3	9	0	0	9	0	0
1	20095274	.	A	G	5	8	13	0	0	13	0	0
1	20106516	.	A	C	1	2	3	3	0	6	0	0
1	20112454	.	C	T	2	3	5	5	1	11	0	0
1	20112574	.	C	T	3	1	4	12	2	18	0	0
1	20112598	.	A	G	4	4	8	7	0	15	0	0
1	20129562	.	C	T	4	4	8	0	0	8	0	0
1	20129652	.	T	C	5	5	10	0	0	10	0	0
1	20138674	.	C	A	4	3	7	0	0	7	0	0
1	20138901	.	A	G	10	4	14	1	1	16	0	0
1	20139168	.	T	C	5	5	10	0	0	10	0	0
1	20139187	.	A	C	4	5	9	0	0	9	0	0
1	20139488	.	T	C	3	3	6	0	0	6	0	0
1	20139522	.	A	G	3	1	4	0	1	5	0	0
1	20139551	.	G	A	4	6	10	0	0	10	0	0
1	20139566	.	A	G	6	6	12	0	0	12	0	0
1	20139636	.	A	C	4	3	7	0	1	8	0	0
1	20139658	.	T	A	5	6	11	0	0	11	0	0
1	20139962	.	A	T	9	8	17	0	1	18	0	0
1	20140042	.	G	T	0	4	4	0	5	9	0	0
1	20140048	.	A	T	4	4	8	0	1	9	0	0
1	20140120	.	C	T	8	8	16	0	1	17	0	0
1	20140133	.	T	C	8	7	15	0	0	15	0	0
1	20140200	.	C	T	13	4	17	0	1	18	0	0
1	20140363	.	T	G	5	5	10	0	1	11	0	0
1	20140419	.	G	A	8	3	11	0	0	11	0	0
1	20140568	.	A	C	2	2	4	0	0	4	0	0
1	20140569	.	A	T	2	2	4	0	0	4	0	0
1	20140951	.	G	A	2	11	13	0	20	33	0	0
1	20140952	.	G	A	21	11	32	0	1	33	0	0
1	20141070	.	C	A	9	8	17	0	1	18	0	0
1	20141106	.	A	G	10	8	18	0	2	20	0	0
1	20141218	.	T	G	13	6	19	0	0	19	0	0
1	20141232	.	T	A	13	11	24	0	0	24	0	0
1	20141253	.	G	A	16	11	27	0	1	28	0	0
1	20141310	.	G	A	20	11	31	0	1	32	0	0
1	20141378	.	C	G	11	0	11	0	16	27	0	0
1	20141411	.	A	T	13	14	27	0	0	27	0	0
1	20141572	.	G	A	1	9	10	1	9	20	0	0
1	20141611	.	T	C	5	10	15	1	1	17	0	0
1	20141661	.	A	C	3	15	18	0	1	19	0	0
1	20141834	.	G	C	3	3	6	0	0	6	0	0
1	20147248	.	T	A	7	9	16	0	0	16	0	0
1	20160882	.	T	A	14	10	24	0	2	26	0	0
1	20166536	.	C	A	10	15	25	0	2	27	0	0
1	20166600	.	A	G	8	11	19	0	0	19	0	0
1	20173954	.	A	G	9	11	20	0	0	20	0	0
1	20194118	.	C	T	7	7	14	0	0	14	0	0
1	20212239	.	G	A	9	9	18	0	0	18	0	0
1	20212284	.	C	T	10	8	18	0	2	20	0	0
1	20212362	.	G	A	7	17	24	0	1	25	0	0
1	20221498	.	G	A	9	7	16	0	0	16	0	0
1	20270080	.	G	A	6	4	10	0	0	10	0	0
1	20270486	.	A	T	7	4	11	0	0	11	0	0
1	20270779	.	G	A	10	5	15	0	0	15	0	0
1	20557447	.	G	A	12	15	27	0	0	27	0	0
1	20557625	.	A	C	10	0	10	0	7	17	0	0
1	20557650	.	C	T	11	7	18	0	0	18	0	0
1	20557788	.	A	C	3	0	3	0	2	5	0	0
1	20557938	.	C	T	4	4	8	0	0	8	0	0
1	20558143	.	T	C	8	9	17	0	0	17	0	0
1	20558523	.	G	A	3	4	7	0	0	7	0	0
1	20558594	.	C	A	1	2	3	0	4	7	0	0
1	20558691	.	A	C	4	4	8	0	0	8	0	0
1	20558888	.	C	A	2	2	4	0	0	4	0	0
1	20559010	.	A	G	5	4	9	0	1	10	0	0
1	20559093	.	A	G	5	9	14	0	0	14	0	0
1	20559321	.	T	C	4	0	4	0	6	10	0	0
1	20559324	.	T	A	4	6	10	0	0	10	0	0
1	20559538	.	G	A	11	5	16	0	1	17	0	0
1	20559830	.	G	A	2	7	9	0	0	9	0	0
1	20559902	.	A	G	2	7	9	0	0	9	0	0
1	20564770	.	T	G	2	9	11	0	0	11	0	0
1	20581101	.	A	G	2	3	5	0	1	6	0	0
1	20678674	.	G	C	16	20	36	0	1	37	0	0
1	20694916	.	G	A	3	21	24	0	23	47	0	0
1	20694955	.	A	G	25	19	44	0	1	45	0	0
1	20695073	.	G	A	4	22	26	0	29	55	0	0
1	20700473	.	T	C	37	35	72	0	1	73	0	0
1	20700524	.	G	A	4	36	40	0	33	73	0	0
1	20704896	.	T	C	28	25	53	0	5	58	0	0
1	20705237	.	C	T	26	17	43	0	2	45	0	0
1	20705863	.	A	G	33	19	52	1	1	54	0	0
1	20866886	.	C	T	10	12	22	0	2	24	0	0
1	20866996	.	T	G	29	27	56	0	2	58	0	0
1	20867057	.	A	T	30	29	59	0	2	61	0	0
1	20867092	.	C	T	31	28	59	0	2	61	0	0
1	20867185	.	A	T	28	23	51	0	4	55	0	0
1	20867186	.	G	T	25	22	47	0	6	53	0	0
1	20867321	.	C	T	5	19	24	0	34	58	0	0
1	20867345	.	C	T	43	18	61	0	0	61	0	0
1	20867359	.	C	T	42	16	58	0	2	60	0	0
1	20867623	.	T	C	33	35	68	0	5	73	0	0
1	20867968	.	T	G	36	31	67	0	2	69	0	0
1	20868165	.	C	G	35	35	70	1	2	73	0	0
1	20868242	.	T	A	28	42	70	0	4	74	0	0
1	20868258	.	T	A	45	25	70	0	2	72	0	0
1	20868301	.	A	G	41	26	67	0	2	69	0	0
1	20868309	.	C	G	26	40	66	0	5	71	0	0
1	20868338	.	G	T	44	27	71	0	2	73	0	0
1	20868504	.	T	C	29	39	68	0	3	71	0	0
1	20868530	.	C	T	40	28	68	0	2	70	0	0
1	20868546	.	G	A	23	29	52	0	6	58	0	0
1	20868684	.	A	T	37	30	67	1	3	72	1	0
1	20868802	.	T	G	49	10	59	2	0	61	0	0
1	20868825	.	G	A	42	18	60	0	3	63	0	0
1	20868850	.	G	A	41	22	63	0	0	63	0	0
1	20868927	.	A	G	39	28	67	0	2	69	0	0
1	20868953	.	C	T	4	24	28	0	39	67	0	0
1	20869064	.	T	A	35	11	46	0	1	47	0	0
1	20870387	.	T	C	24	17	41	1	0	42	0	0
1	20870632	.	T	C	29	18	47	8	3	58	0	0
1	20870846	.	C	T	23	35	58	1	3	62	0	0
1	20871144	.	C	G	32	30	62	0	3	65	0	0
1	20886924	.	G	A	40	28	68	0	0	68	0	0
1	20886936	.	G	A	39	25	64	0	1	65	0	0
1	20910967	.	A	G	26	32	58	0	5	63	0	0
1	20911171	.	G	T	38	31	69	0	4	73	0	0
1	20916898	.	G	A	2	3	5	0	0	5	0	0
1	20916995	.	T	C	3	2	5	0	0	5	0	0
1	20925896	.	A	G	5	4	9	0	1	10	0	0
1	20932137	.	T	A	5	6	11	0	0	11	0	0
1	20932138	.	C	T	5	6	11	0	0	11	0	0
1	20932376	.	A	G	0	14	14	0	1	15	0	0
1	20932378	.	G	A	5	9	14	0	1	15	0	0
1	20941573	.	G	A	4	4	8	0	0	8	0	0
1	20946897	.	A	G	5	12	17	0	0	17	0	0
1	20956239	.	G	A	2	7	9	0	0	9	0	0
1	20959028	.	T	C	4	4	8	1	0	9	0	0
1	20970002	.	T	A	5	2	7	0	0	7	0	0
1	20970109	.	G	T	5	6	11	0	0	11	0	0
1	20970202	.	G	A	8	5	13	0	0	13	0	0
1	21138623	.	T	C	2	2	4	0	0	4	0	0
1	21139142	.	G	A	5	9	14	0	0	14	0	0
1	21139355	.	G	A	4	3	7	0	0	7	0	0
1	21139367	.	G	A	3	4	7	0	0	7	0	0
1	21139456	.	G	C	6	4	10	0	0	10	0	0
1	21141701	.	A	G	7	5	12	0	1	13	0	0
1	21141894	.	C	T	1	9	10	0	5	15	0	0
1	21141930	.	T	G	8	5	13	0	1	14	0	0
1	21141999	.	G	A	10	6	16	0	0	16	0	0
1	21146729	.	C	G	1	11	12	0	2	14	0	0
1	21151784	.	A	G	8	4	12	0	0	12	0	0
1	21151826	.	C	G	2	5	7	0	0	7	0	0
1	21154156	.	C	T	2	5	7	0	1	8	0	0
1	21159366	.	T	C	3	0	3	0	6	9	0	0
1	21159908	.	T	C	2	2	4	0	1	5	0	0
1	21160853	.	G	A	3	4	7	0	0	7	0	0
1	21163422	.	C	T	1	4	5	0	0	5	0	0
1	21178391	.	T	C	1	0	1	0	2	3	0	0
1	21312067	.	A	G	10	12	22	0	0	22	0	0
1	21312112	.	C	T	12	11	23	0	2	26	1	0
1	21312393	.	C	T	7	3	10	0	0	10	0	0
1	21312398	.	A	G	6	3	9	0	1	10	0	0
1	21313861	.	T	A	1	4	5	0	0	5	0	0
1	21314009	.	A	T	1	2	3	0	0	3	0	0
1	21319516	.	A	T	1	3	4	0	0	4	0	0
1	21333205	.	C	G	0	23	23	0	20	43	0	0
1	21333223	.	A	T	27	14	41	0	0	41	0	0
1	21333337	.	G	C	26	12	38	2	1	41	0	0
1	21341577	.	T	C	10	33	43	1	0	44	0	0
1	21344500	.	G	A	21	20	41	0	0	41	0	0
1	21344518	.	C	G	2	20	22	0	15	37	0	0
1	21346015	.	T	C	24	20	44	0	0	44	0	0
1	21346051	.	C	T	20	19	39	0	3	42	0	0
1	21368014	.	C	A	28	20	48	0	2	50	0	0
1	21368074	.	C	A	27	9	36	0	1	38	1	0
1	21368206	.	G	T	13	14	27	0	1	28	0	0
1	21423093	.	A	T	4	4	8	0	1	9	0	0
1	21423307	.	C	T	9	6	15	0	0	15	0	0
1	21423756	.	A	G	17	8	25	0	0	25	0	0
1	21423765	.	C	A	10	16	26	0	0	26	0	0
1	21449804	.	A	G	8	6	14	0	0	14	0	0
1	21500209	.	T	A	1	6	7	0	1	8	0	0
1	21500451	.	G	T	8	9	17	0	0	17	0	0
1	21513826	.	G	A	8	7	15	0	0	15	0	0
1	21514069	.	G	A	8	3	11	0	0	11	0	0
1	21515903	.	G	T	3	8	11	0	0	11	0	0
1	21516249	.	C	G	7	7	14	0	0	14	0	0
1	21518503	.	G	A	2	2	4	0	0	4	0	0
1	21527348	.	C	A	7	5	12	0	0	12	0	0
1	21529374	.	G	A	7	3	10	0	0	10	0	0
1	21529506	.	A	C	3	0	3	0	3	6	0	0
1	21532624	.	C	T	1	3	4	0	0	4	0	0
1	21537356	.	G	A	2	5	7	0	0	7	0	0
1	21537546	.	T	A	2	4	6	0	0	6	0	0
1	21537554	.	G	A	2	4	6	0	0	6	0	0
1	21545449	.	C	T	2	2	4	0	0	4	0	0
1	21576919	.	G	A	3	3	6	0	0	6	0	0
1	21576958	.	A	G	2	2	4	0	0	4	0	0
1	21579197	.	T	C	1	4	5	0	0	5	0	0
1	21579242	.	T	G	1	2	3	0	0	3	0	0
1	21581746	.	C	T	1	3	4	0	0	4	0	0
1	21593731	.	C	T	1	3	4	0	2	6	0	0
1	21610564	.	T	C	4	5	9	0	0	9	0	0
1	21610651	.	A	G	3	2	5	0	0	5	0	0
1	21611043	.	T	C	2	6	8	0	0	8	0	0
1	21612127	.	C	T	4	3	7	0	0	7	0	0
1	21612153	.	T	G	4	5	9	0	0	9	0	0
1	21612400	.	G	A	9	5	14	0	1	15	0	0
1	21612418	.	G	C	10	3	13	0	2	15	0	0
1	21648641	.	G	A	1	8	9	0	0	9	0	0
1	21944731	.	C	T	3	6	9	0	0	9	0	0
1	22217780	.	T	C	2	2	4	0	0	4	0	0
1	22236735	.	T	G	2	4	6	0	0	6	0	0
1	22236891	.	A	T	5	8	13	0	0	13	0	0
1	22236990	.	G	A	3	7	10	0	0	10	0	0
1	22389122	.	C	T	8	5	13	0	0	13	0	0
1	22389246	.	C	T	3	9	12	1	8	21	0	0
1	22389264	.	T	A	8	11	19	1	2	22	0	0
1	22389395	.	T	C	18	13	31	0	2	33	0	0
1	22401851	.	A	G	10	8	18	0	0	18	0	0
1	22412005	.	G	A	16	11	27	0	0	27	0	0
1	22484544	.	C	A	4	4	8	0	0	8	0	0
1	22490565	.	C	T	0	6	6	0	6	12	0	0
1	22490795	.	C	T	0	3	3	0	1	4	0	0
1	22511963	.	T	A	3	3	6	0	0	6	0	0
1	22542770	.	C	A	4	2	6	0	0	6	0	0
1	22542771	.	T	C	3	0	3	0	3	6	0	0
1	22543084	.	A	G	1	2	3	0	1	4	0	0
1	22543235	.	A	G	1	2	3	0	0	3	0	0
1	22555442	.	A	G	1	2	3	0	0	3	0	0
1	22555451	.	G	A	1	2	3	0	0	3	0	0
1	22647772	.	T	C	4	2	6	0	2	8	0	0
1	22648037	.	T	A	25	27	52	0	6	58	0	0
1	22648038	.	A	C	28	28	56	0	2	58	0	0
1	22651348	.	C	A	4	22	26	0	21	47	0	0
1	22651934	.	T	A	35	18	53	0	0	53	0	0
1	22713143	.	A	G	5	1	6	0	0	6	0	0
1	22713635	.	T	C	2	3	5	0	1	6	0	0
1	22713974	.	G	A	4	5	9	0	0	9	0	0
1	22723821	.	T	A	2	7	9	0	0	9	0	0
1	22770608	.	A	T	10	15	25	0	0	25	0	0
1	22770723	.	C	T	8	7	15	0	0	15	0	0
1	22770810	.	C	T	8	6	14	0	1	15	0	0
1	22771305	.	T	G	13	16	29	1	1	31	0	0
1	22771437	.	G	A	10	7	17	0	0	17	0	0
1	22771677	.	C	T	3	7	10	0	5	15	0	0
1	22771911	.	A	T	6	11	17	0	1	18	0	0
1	22771936	.	C	T	7	16	23	0	0	23	0	0
1	22771952	.	A	T	18	8	26	0	0	26	0	0
1	22772213	.	C	A	13	7	20	0	1	21	0	0
1	22772308	.	C	T	5	17	22	0	0	22	0	0
1	22772545	.	A	T	11	13	24	0	1	25	0	0
1	22772711	.	G	A	12	6	18	0	1	19	0	0
1	22777201	.	G	A	8	10	18	0	0	18	0	0
1	22777862	.	A	C	11	10	21	0	0	21	0	0
1	22803001	.	A	T	6	2	8	0	0	8	0	0
1	22805615	.	C	T	13	12	25	0	1	26	0	0
1	22805630	.	G	C	11	9	20	0	0	20	0	0
1	22805750	.	T	A	4	7	11	0	0	11	0	0
1	22805766	.	C	T	4	3	7	0	0	7	0	0
1	22805880	.	G	T	5	2	7	0	0	7	0	0
1	22805906	.	A	C	5	5	10	0	0	10	0	0
1	22805927	.	C	A	4	3	7	0	2	9	0	0
1	22806089	.	C	T	18	10	28	0	0	28	0	0
1	22806108	.	A	G	13	18	31	0	4	35	0	0
1	22806166	.	G	A	12	4	16	0	0	16	0	0
1	22806254	.	T	C	8	10	18	0	1	19	0	0
1	22806643	.	C	A	14	19	33	0	1	34	0	0
1	22806825	.	C	T	2	6	8	0	13	21	0	0
1	22806845	.	C	A	9	5	14	0	1	15	0	0
1	22806917	.	C	A	10	6	16	0	1	17	0	0
1	22806936	.	C	T	1	7	8	0	10	18	0	0
1	22806980	.	G	A	8	7	15	0	0	15	0	0
1	22807043	.	G	A	12	4	16	0	0	16	0	0
1	22807169	.	A	G	6	10	16	0	0	16	0	0
1	22807238	.	G	A	9	11	20	0	2	22	0	0
1	22807275	.	C	G	19	8	27	0	1	28	0	0
1	22807304	.	C	G	20	10	30	0	1	31	0	0
1	22807321	.	G	A	22	11	33	0	0	33	0	0
1	22807632	.	C	T	11	13	24	0	0	24	0	0
1	22807639	.	G	A	10	13	23	0	0	23	0	0
1	22807744	.	G	T	10	9	19	0	0	19	0	0
1	22808009	.	G	T	5	7	12	0	0	12	0	0
1	22808149	.	T	A	8	13	21	0	0	21	0	0
1	22808181	.	T	C	10	0	10	1	8	19	0	0
1	22808264	.	T	G	13	6	19	0	0	19	0	0
1	22808296	.	A	T	10	5	15	0	0	15	0	0
1	22808301	.	C	G	1	4	5	0	12	17	0	0
1	22808384	.	C	T	0	9	9	0	4	13	0	0
1	22808444	.	G	A	2	8	10	0	0	10	0	0
1	22808479	.	G	T	4	5	9	0	0	9	0	0
1	22808514	.	A	T	4	7	11	0	1	12	0	0
1	22808665	.	C	T	8	7	15	0	0	15	0	0
1	22814910	.	A	G	11	10	21	0	2	23	0	0
1	22829325	.	G	A	5	6	11	0	1	12	0	0
1	22845919	.	A	G	5	3	8	1	1	10	0	0
1	22851065	.	G	T	15	5	20	1	1	22	0	0
1	22851422	.	T	A	1	6	7	0	0	7	0	0
1	22851828	.	A	T	10	6	16	0	0	16	0	0
1	22856087	.	C	T	7	6	13	0	0	13	0	0
1	22857979	.	C	T	10	11	21	0	0	21	0	0
1	22857995	.	A	G	10	8	18	0	1	19	0	0
1	22858194	.	G	A	24	15	39	0	0	39	0	0
1	22858275	.	T	C	21	24	45	0	1	46	0	0
1	22858397	.	G	A	20	22	42	0	1	43	0	0
1	22858478	.	G	A	24	17	41	0	0	41	0	0
1	22861253	.	G	A	20	14	34	0	0	34	0	0
1	22861267	.	G	A	16	15	31	0	0	31	0	0
1	22864011	.	C	T	6	8	14	0	3	17	0	0
1	22943748	.	G	A	9	11	20	0	0	20	0	0
1	22944056	.	C	T	3	24	27	0	20	47	0	0
1	22944068	.	C	T	29	22	51	0	2	53	0	0
1	22944386	.	A	C	20	20	40	0	3	44	1	0
1	22945054	.	T	C	21	18	39	0	0	39	0	0
1	22945173	.	T	G	22	19	41	0	0	41	0	0
1	22945190	.	G	T	22	15	37	0	2	39	0	0
1	22945444	.	G	A	15	29	44	0	3	48	1	0
1	22945519	.	C	T	20	19	39	0	2	41	0	0
1	22945888	.	G	C	20	1	21	0	31	52	0	0
1	22945903	.	T	C	22	27	49	0	2	51	0	0
1	22946108	.	C	T	20	24	44	0	1	45	0	0
1	22956429	.	C	T	2	18	20	1	20	41	0	0
1	22966877	.	C	A	12	13	25	0	1	26	0	0
1	22987960	.	A	G	11	17	28	0	0	28	0	0
1	22992058	.	G	A	12	12	24	0	1	25	0	0
1	22996606	.	G	A	17	11	28	0	0	28	0	0
1	23072224	.	G	A	10	17	27	0	0	27	0	0
1	23072278	.	G	A	9	9	18	0	1	19	0	0
1	23072304	.	G	T	7	3	10	0	2	12	0	0
1	23072461	.	G	A	10	9	19	0	1	20	0	0
1	23072533	.	G	A	13	7	20	0	1	21	0	0
1	23072683	.	T	C	14	0	14	0	12	26	0	0
1	23072746	.	T	A	11	5	16	0	0	16	0	0
1	23094638	.	C	T	7	6	13	0	0	13	0	0
1	23094677	.	G	A	10	6	16	0	0	16	0	0
1	23110816	.	T	C	9	5	14	0	1	15	0	0
1	23172379	.	A	T	2	2	4	0	0	4	0	0
1	23243733	.	C	T	4	5	9	0	0	9	0	0
1	23251104	.	C	T	2	3	5	0	1	6	0	0
1	23251338	.	T	C	3	4	7	0	0	7	0	0
1	23258049	.	C	T	2	4	6	0	0	6	0	0
1	23261829	.	C	T	0	2	2	0	4	6	0	0
1	23261838	.	A	G	4	2	6	0	0	6	0	0
1	23261992	.	G	T	3	2	5	0	1	6	0	0
1	23265710	.	C	A	5	2	7	0	0	7	0	0
1	23265711	.	C	T	1	2	3	0	3	6	0	0
1	23268471	.	G	A	4	4	8	0	0	8	0	0
1	23271345	.	G	A	38	31	69	0	3	72	0	0
1	23271500	.	G	A	41	25	66	0	2	68	0	0
1	23271608	.	G	A	37	40	77	0	0	77	0	0
1	23271612	.	T	A	1	5	6	0	0	6	0	0
1	23271770	.	T	G	36	32	68	0	3	71	0	0
1	23274820	.	G	A	8	12	20	0	0	20	0	0
1	23275228	.	C	G	11	10	21	0	0	21	0	0
1	23277619	.	A	G	7	0	7	0	11	18	0	0
1	23283819	.	G	A	3	2	5	0	0	5	0	0
1	23283864	.	G	A	7	6	13	0	0	13	0	0
1	23283878	.	C	T	7	3	10	0	0	10	0	0
1	23291132	.	G	A	1	3	4	1	0	5	0	0
1	23298642	.	A	T	7	4	11	0	0	11	0	0
1	23298892	.	A	G	2	11	13	0	0	13	0	0
1	23298921	.	G	A	4	9	13	0	1	14	0	0
1	23301687	.	A	T	6	5	11	0	0	11	0	0
1	23301873	.	G	T	5	5	10	0	0	10	0	0
1	23308208	.	A	C	2	5	7	0	0	7	0	0
1	23311756	.	T	A	3	6	9	0	0	9	0	0
1	23323181	.	G	C	5	3	8	0	0	8	0	0
1	23377975	.	A	G	2	2	4	0	0	4	0	0
1	23388325	.	C	T	3	3	6	0	0	6	0	0
1	23390453	.	C	T	3	2	5	0	0	5	0	0
1	23393122	.	A	T	3	3	6	0	0	6	0	0
1	23395760	.	T	A	1	3	4	0	0	4	0	0
1	23506660	.	C	A	7	14	21	0	1	22	0	0
1	23506711	.	A	T	11	6	17	1	2	20	0	0
1	23506787	.	A	T	18	16	34	0	3	37	0	0
1	23506865	.	C	A	14	23	37	0	4	41	0	0
1	23508009	.	G	T	23	22	45	0	3	48	0	0
1	23526644	.	T	C	19	13	32	0	3	35	0	0
1	23528066	.	C	T	12	10	22	0	3	25	0	0
1	23530438	.	C	T	9	9	18	0	1	19	0	0
1	23535880	.	C	T	0	16	16	0	13	29	0	0
1	23536012	.	T	C	9	8	17	0	1	18	0	0
1	23536222	.	T	A	13	13	26	0	0	26	0	0
1	23573582	.	C	T	7	3	10	1	0	11	0	0
1	23573823	.	A	T	10	8	18	0	0	18	0	0
1	23574567	.	G	C	1	3	4	0	0	4	0	0
1	23578157	.	C	T	8	5	13	0	0	13	0	0
1	23578839	.	A	C	1	3	4	0	0	4	0	0
1	23579202	.	G	A	3	3	6	0	0	6	0	0
1	23579365	.	C	T	3	2	5	0	1	6	0	0
1	23579592	.	T	G	2	4	6	0	0	6	0	0
1	23579714	.	C	T	0	6	6	0	2	8	0	0
1	23580196	.	G	A	3	3	6	0	1	7	0	0
1	23581737	.	T	C	3	0	3	0	2	5	0	0
1	23581960	.	T	G	2	4	6	0	2	8	0	0
1	23582189	.	G	T	1	3	4	0	0	4	0	0
1	23585275	.	C	T	1	5	6	0	0	6	0	0
1	23585802	.	C	A	1	8	9	0	5	14	0	0
1	23586025	.	C	T	1	5	6	0	2	8	0	0
1	23586133	.	A	G	7	3	10	0	0	10	0	0
1	23586581	.	G	A	4	6	10	0	0	10	0	0
1	23586780	.	C	T	0	8	8	0	3	11	0	0
1	23589017	.	C	T	2	9	11	0	0	11	0	0
1	23589080	.	G	T	7	4	11	0	0	11	0	0
1	23589162	.	T	C	4	0	4	0	6	10	0	0
1	23873516	.	T	C	1	2	3	0	0	3	0	0
1	23889642	.	T	A	5	2	7	0	0	7	0	0
1	23908940	.	T	G	7	11	18	1	1	20	0	0
1	23909090	.	A	G	11	21	32	0	0	32	0	0
1	23909522	.	A	C	3	6	9	0	1	10	0	0
1	23909748	.	A	T	12	6	18	0	1	19	0	0
1	23920983	.	C	T	1	6	7	0	7	14	0	0
1	23921071	.	A	T	13	11	24	0	0	24	0	0
1	23921284	.	T	C	10	5	15	0	0	15	0	0
1	23921302	.	C	A	5	6	11	0	0	11	0	0
1	23921427	.	T	C	6	0	6	0	10	16	0	0
1	23921793	.	A	C	4	3	7	0	0	7	0	0
1	23936154	.	C	T	6	7	13	0	0	13	0	0
1	23943609	.	A	T	3	5	8	0	2	10	0	0
1	23943726	.	G	A	6	8	14	0	0	14	0	0
1	23945132	.	T	A	3	3	6	0	0	6	0	0
1	23947833	.	A	C	9	0	9	0	4	13	0	0
1	23947881	.	T	A	7	2	9	0	0	9	0	0
1	23975366	.	A	G	4	3	7	0	0	7	0	0
1	24023560	.	T	C	2	2	4	0	0	4	0	0
1	24045920	.	G	T	6	6	12	0	1	13	0	0
1	24050482	.	C	T	0	4	4	0	3	7	0	0
1	24076890	.	A	G	13	9	22	0	1	23	0	0
1	24077274	.	A	G	10	1	11	0	15	26	0	0
1	24077791	.	G	A	2	23	25	0	13	38	0	0
1	24077902	.	A	G	3	7	10	0	0	10	0	0
1	24079229	.	C	T	0	3	3	0	2	5	0	0
1	24079262	.	A	T	2	2	4	0	0	4	0	0
1	24092454	.	G	A	2	4	6	0	0	6	0	0
1	24163638	.	G	A	6	4	10	0	0	10	0	0
1	24197375	.	C	T	0	2	2	0	2	4	0	0
1	24227531	.	C	T	1	3	4	0	0	4	0	0
1	24357931	.	C	T	36	34	70	0	6	76	0	0
1	24513594	.	A	C	3	2	5	0	1	6	0	0
1	24520701	.	G	A	3	4	7	0	1	8	0	0
1	24523415	.	T	C	6	9	15	0	0	15	0	0
1	24540619	.	C	T	2	8	10	0	1	11	0	0
1	24540785	.	A	G	4	4	8	0	1	9	0	0
1	24540959	.	A	G	4	4	8	0	0	8	0	0
1	24557100	.	A	G	1	4	5	0	0	5	0	0
1	24557510	.	G	A	4	7	11	0	1	12	0	0
1	24558336	.	C	G	1	6	7	0	0	7	0	0
1	24558410	.	T	A	1	3	4	0	0	4	0	0
1	24871075	.	A	G	8	6	14	0	0	14	0	0
1	24871079	.	A	G	8	6	14	0	1	15	0	0
1	24879994	.	C	T	11	16	27	0	3	30	0	0
1	24902745	.	T	C	9	1	10	0	9	19	0	0
1	24908001	.	T	C	13	0	13	0	8	21	0	0
1	25024060	.	T	C	2	0	2	0	2	4	0	0
1	25024066	.	C	T	0	2	2	0	2	4	0	0
1	25143988	.	G	T	2	2	4	0	0	4	0	0
1	25281601	.	A	C	8	6	14	0	1	15	0	0
1	25296797	.	C	T	7	9	16	0	1	17	0	0
1	25296831	.	C	T	4	10	14	0	1	15	0	0
1	25305290	.	A	T	10	9	19	0	2	21	0	0
1	25305446	.	T	G	11	0	11	0	10	21	0	0
1	25310899	.	C	A	13	6	19	0	1	20	0	0
1	25310912	.	T	A	5	10	15	0	0	15	0	0
1	25313056	.	C	T	16	8	24	0	3	27	0	0
1	25313261	.	T	C	14	15	29	0	1	30	0	0
1	25313300	.	G	A	2	8	10	0	16	26	0	0
1	25322892	.	G	A	1	4	5	0	1	6	0	0
1	25322961	.	A	G	3	2	5	0	0	5	0	0
1	25327222	.	G	A	2	3	5	0	1	6	0	0
1	25340311	.	G	A	1	5	6	0	0	6	0	0
1	25399574	.	G	A	6	3	9	0	0	9	0	0
1	25399634	.	G	A	1	2	3	0	0	3	0	0
1	25400247	.	C	T	5	3	8	0	0	8	0	0
1	25400814	.	T	A	1	3	4	0	0	4	0	0
1	25400842	.	A	T	1	5	6	0	0	6	0	0
1	25401181	.	G	A	2	3	5	0	0	5	0	0
1	25401290	.	T	A	2	3	5	0	0	5	0	0
1	25402203	.	C	T	0	9	9	0	3	12	0	0
1	25402229	.	T	C	1	6	7	0	0	7	0	0
1	25403244	.	G	C	6	4	10	0	0	10	0	0
1	25419911	.	T	G	3	3	6	0	0	6	0	0
1	25419936	.	A	G	4	3	7	0	0	7	0	0
1	25419962	.	G	A	3	3	6	0	0	6	0	0
1	25419973	.	T	G	4	3	7	0	0	7	0	0
1	25442760	.	G	A	1	3	4	0	0	4	0	0
1	25443085	.	G	A	1	3	4	0	1	5	0	0
1	25654976	.	C	T	3	6	9	0	0	10	1	0
1	25660719	.	C	T	5	6	11	0	0	11	0	0
1	25741901	.	A	G	4	3	7	0	0	7	0	0
1	25798792	.	T	A	6	8	14	0	1	15	0	0
1	25798863	.	G	C	7	6	13	0	0	13	0	0
1	25798983	.	A	C	5	2	7	0	0	7	0	0
1	25811411	.	T	C	8	4	12	0	0	12	0	0
1	25812658	.	C	T	9	4	13	0	0	13	0	0
1	25863511	.	G	A	9	7	16	0	1	17	0	0
1	25863638	.	A	T	15	8	23	0	1	24	0	0
1	26012748	.	G	T	1	1	2	0	1	3	0	0
1	26012755	.	G	A	1	2	3	0	0	3	0	0
1	26044934	.	G	T	5	4	9	0	0	9	0	0
1	26046323	.	A	G	11	14	25	0	2	27	0	0
1	26046950	.	T	A	16	8	24	0	1	25	0	0
1	26046996	.	A	T	18	7	25	0	0	25	0	0
1	26063007	.	G	T	7	8	15	0	0	15	0	0
1	26063030	.	G	A	7	4	11	0	1	12	0	0
1	26096055	.	T	A	1	2	3	0	0	3	0	0
1	26096124	.	A	T	5	2	7	0	0	7	0	0
1	26096270	.	C	T	1	3	4	0	0	4	0	0
1	26096522	.	G	T	7	8	15	0	0	15	0	0
1	26127339	.	A	G	14	12	26	0	0	26	0	0
1	26127856	.	A	T	15	11	26	0	0	26	0	0
1	26251906	.	T	G	1	2	3	0	0	3	0	0
1	26252215	.	T	C	9	6	15	0	0	15	0	0
1	26252308	.	G	C	3	5	8	0	0	8	0	0
1	26252323	.	A	T	5	2	7	0	2	9	0	0
1	26252688	.	A	G	3	3	6	0	0	6	0	0
1	26252814	.	C	T	5	6	11	0	0	11	0	0
1	26252877	.	G	A	3	5	8	0	0	8	0	0
1	26252931	.	A	T	1	4	5	0	0	5	0	0
1	26293231	.	T	A	2	8	10	0	1	11	0	0
1	26375404	.	C	A	12	6	18	0	0	18	0	0
1	26376176	.	G	A	6	6	12	0	1	13	0	0
1	26376327	.	C	T	4	4	8	0	0	8	0	0
1	26376816	.	A	T	6	7	13	0	1	14	0	0
1	26377593	.	G	A	5	5	10	0	0	10	0	0
1	26382809	.	A	T	19	9	28	0	3	31	0	0
1	26383281	.	G	T	0	8	8	0	7	15	0	0
1	26383466	.	G	A	4	7	11	0	0	11	0	0
1	26384629	.	C	T	3	4	7	0	0	7	0	0
1	26384638	.	G	A	4	4	8	0	0	8	0	0
1	26384682	.	G	A	7	8	15	0	0	15	0	0
1	26384721	.	A	G	5	7	12	0	0	12	0	0
1	26384774	.	C	T	4	4	8	0	0	8	0	0
1	26384779	.	C	A	4	3	7	0	0	7	0	0
1	26385006	.	G	T	3	6	9	0	0	9	0	0
1	26385222	.	C	G	7	9	16	0	0	17	1	0
1	26385939	.	A	G	7	12	19	0	1	20	0	0
1	26386153	.	T	C	1	2	3	0	1	4	0	0
1	26391649	.	C	T	0	2	2	0	4	6	0	0
1	26392422	.	G	A	3	5	8	0	0	8	0	0
1	26394436	.	A	C	6	0	6	0	3	9	0	0
1	26445032	.	C	A	7	6	13	0	0	13	0	0
1	26454576	.	G	C	9	11	20	0	0	20	0	0
1	26463671	.	T	A	2	8	10	0	2	12	0	0
1	26463692	.	C	T	11	4	15	0	0	15	0	0
1	26463779	.	T	A	5	14	19	0	0	19	0	0
1	26463878	.	C	A	7	12	19	0	0	19	0	0
1	26463931	.	A	T	13	8	21	2	2	25	0	0
1	26463956	.	A	T	9	8	17	2	1	20	0	0
1	26464175	.	G	A	6	4	10	0	1	11	0	0
1	26464259	.	C	T	5	5	10	1	1	12	0	0
1	26464353	.	A	G	8	11	19	0	1	20	0	0
1	26464446	.	G	A	10	9	19	0	2	21	0	0
1	26464758	.	T	A	17	8	25	0	1	26	0	0
1	26465041	.	G	T	9	13	22	0	0	22	0	0
1	26465047	.	A	C	16	6	22	0	2	24	0	0
1	26465224	.	T	A	10	9	19	0	1	20	0	0
1	26467125	.	T	A	5	8	13	0	1	14	0	0
1	26467243	.	G	A	4	4	8	0	1	9	0	0
1	26473634	.	G	A	8	3	11	0	0	11	0	0
1	26473790	.	C	T	1	5	6	0	0	6	0	0
1	26480970	.	G	C	0	9	9	0	3	12	0	0
1	26489854	.	G	A	8	7	15	0	0	15	0	0
1	26498400	.	C	T	9	13	22	0	2	24	0	0
1	26498657	.	G	A	0	13	13	0	15	28	0	0
1	26504998	.	G	A	18	13	31	0	0	31	0	0
1	26505282	.	T	C	8	17	25	0	0	25	0	0
1	26505291	.	C	T	11	18	29	0	1	30	0	0
1	26507356	.	G	A	6	9	15	0	0	15	0	0
1	26507392	.	T	A	4	9	13	0	0	13	0	0
1	26507582	.	G	A	7	6	13	0	0	13	0	0
1	26507764	.	A	G	7	0	7	0	12	19	0	0
1	26638053	.	G	C	3	2	5	0	2	7	0	0
1	26827238	.	A	G	1	2	3	0	0	3	0	0
1	26827449	.	T	C	3	2	5	0	0	5	0	0
1	26827519	.	G	A	9	7	16	0	0	16	0	0
1	26881523	.	C	T	1	2	3	0	1	4	0	0
1	27207986	.	A	G	2	0	2	0	5	7	0	0
1	27209628	.	A	C	6	4	10	0	1	11	0	0
1	27209904	.	T	G	4	7	11	0	0	11	0	0
1	27210057	.	T	C	4	6	10	0	1	11	0	0
1	27210073	.	T	C	7	5	12	0	1	13	0	0
1	27210231	.	C	T	8	3	11	0	0	11	0	0
1	27210578	.	G	A	5	4	9	0	1	10	0	0
1	27210929	.	C	T	14	8	22	0	1	23	0	0
1	27809162	.	T	C	11	7	18	0	1	19	0	0
1	27826090	.	C	A	8	8	16	0	2	18	0	0
1	27826198	.	C	T	8	11	19	0	0	19	0	0
1	27826651	.	T	C	23	18	41	1	1	43	0	0
1	27842373	.	G	A	1	14	15	0	22	37	0	0
1	27860743	.	T	A	4	5	9	0	0	9	0	0
1	27860876	.	A	T	3	2	5	0	0	5	0	0
1	27893097	.	T	C	15	7	22	0	0	22	0	0
1	27893920	.	A	T	1	5	6	0	0	7	1	0
1	27993191	.	A	G	11	0	11	0	4	15	0	0
1	28018821	.	C	T	12	14	26	0	0	26	0	0
1	28018988	.	T	A	5	4	9	0	0	9	0	0
1	28035590	.	T	C	4	5	9	0	0	9	0	0
1	28035786	.	C	T	5	6	11	0	1	12	0	0
1	28036159	.	A	C	7	3	10	0	0	10	0	0
1	28046218	.	T	C	11	13	24	0	0	24	0	0
1	28046224	.	A	G	9	1	10	0	15	25	0	0
1	28046717	.	T	A	3	1	4	0	1	5	0	0
1	28067910	.	G	T	2	2	4	0	1	5	0	0
1	28067918	.	T	A	1	3	4	0	1	5	0	0
1	28067976	.	T	A	5	4	9	0	1	10	0	0
1	28391882	.	C	G	10	7	17	0	0	17	0	0
1	28391914	.	C	T	0	8	8	0	4	12	0	0
1	28422569	.	C	T	7	9	16	0	0	16	0	0
1	28788272	.	G	A	5	7	12	0	2	14	0	0
1	28808541	.	T	C	12	8	20	0	1	21	0	0
1	28809127	.	A	C	3	0	3	0	2	5	0	0
1	28833709	.	A	G	2	2	4	0	0	4	0	0
1	28833827	.	A	C	2	5	7	0	1	8	0	0
1	28834156	.	C	T	3	2	5	0	0	5	0	0
1	28835669	.	T	C	7	7	14	0	0	14	0	0
1	28847677	.	C	T	0	9	9	0	15	24	0	0
1	28874819	.	C	T	2	5	7	0	0	7	0	0
1	28899350	.	G	A	3	4	7	0	1	8	0	0
1	28899483	.	G	A	5	4	9	0	0	9	0	0
1	28900661	.	A	G	5	3	8	0	0	8	0	0
1	28965095	.	G	A	20	21	41	0	1	42	0	0
1	28979080	.	A	C	20	1	21	0	20	41	0	0
1	28979161	.	G	C	21	0	21	0	24	45	0	0
1	28986486	.	C	T	18	16	34	0	0	34	0	0
1	29045226	.	G	A	21	18	39	0	2	41	0	0
1	29162674	.	G	A	1	10	11	0	2	13	0	0
1	29178897	.	C	T	15	5	20	1	2	23	0	0
1	29201933	.	G	C	6	8	14	0	0	14	0	0
1	29202110	.	T	C	4	12	16	0	0	16	0	0
1	29202379	.	A	G	1	0	1	0	5	6	0	0
1	29202618	.	G	T	3	3	6	0	0	6	0	0
1	29211619	.	T	A	8	5	13	0	0	13	0	0
1	29211636	.	T	C	12	5	17	0	0	17	0	0
1	29211895	.	T	A	4	7	11	0	3	14	0	0
1	29212165	.	T	C	9	7	16	0	0	16	0	0
1	29213107	.	A	G	11	0	11	0	12	23	0	0
1	29227642	.	T	A	4	6	10	0	0	10	0	0
1	29227770	.	C	T	4	5	9	0	0	9	0	0
1	29227880	.	G	T	10	5	15	0	0	15	0	0
1	29228261	.	A	G	4	0	4	0	9	13	0	0
1	29228390	.	A	T	0	4	4	0	1	5	0	0
1	29268970	.	C	T	1	2	3	0	0	3	0	0
1	29268975	.	A	G	1	2	3	0	0	3	0	0
1	29282836	.	C	T	3	3	6	0	0	6	0	0
1	29389975	.	T	C	3	5	8	0	0	8	0	0
1	29389987	.	C	T	6	4	10	0	0	10	0	0
1	29618331	.	A	G	1	3	4	0	1	5	0	0
1	29653090	.	C	T	0	2	2	0	5	7	0	0
1	29653338	.	C	A	2	2	4	0	0	4	0	0
1	29718827	.	A	C	6	2	8	0	0	8	0	0
1	29731965	.	T	G	3	7	10	0	0	10	0	0
1	29732217	.	C	T	5	7	12	0	0	12	0	0
1	29742624	.	A	T	2	3	5	0	0	5	0	0
1	29751529	.	T	G	2	3	5	0	3	8	0	0
1	29751594	.	T	G	4	2	6	0	0	6	0	0
1	29752319	.	T	C	6	7	13	0	0	13	0	0
1	29752421	.	A	G	12	6	18	0	1	19	0	0
1	29754673	.	A	G	5	7	12	0	0	12	0	0
1	29754963	.	G	A	6	3	9	0	0	9	0	0
1	29770360	.	T	A	8	12	20	0	0	20	0	0
1	29772024	.	T	C	6	5	11	0	0	11	0	0
1	29772391	.	A	G	7	6	13	0	1	14	0	0
1	29772615	.	T	C	5	12	17	0	0	17	0	0
1	29772741	.	C	T	12	13	25	0	0	25	0	0
1	29775664	.	C	A	7	7	14	0	3	17	0	0
1	29779300	.	G	C	14	10	24	0	1	25	0	0
1	29779402	.	G	A	1	10	11	0	8	19	0	0
1	29781462	.	G	A	14	10	24	0	0	24	0	0
1	29781597	.	A	T	7	11	18	0	1	19	0	0
1	29786570	.	G	A	11	8	19	0	3	22	0	0
1	29786659	.	T	G	11	1	12	0	13	25	0	0
1	29786704	.	A	G	8	9	17	0	1	18	0	0
1	29787397	.	G	A	8	8	16	0	0	16	0	0
1	29789889	.	C	T	13	13	26	0	1	27	0	0
1	29790030	.	A	T	10	13	23	0	1	24	0	0
1	29795692	.	G	A	13	14	27	0	1	28	0	0
1	29797191	.	T	C	11	13	24	0	1	25	0	0
1	29797344	.	G	T	10	15	25	0	0	25	0	0
1	29797345	.	A	T	10	13	23	0	1	25	1	0
1	29797387	.	A	C	12	9	21	0	1	22	0	0
1	29797699	.	T	G	2	3	5	0	0	5	0	0
1	29798203	.	A	G	13	8	21	0	1	22	0	0
1	29798262	.	T	C	8	3	11	0	0	11	0	0
1	29798324	.	G	T	0	5	5	0	6	11	0	0
1	29798340	.	G	A	2	4	6	0	8	14	0	0
1	29804658	.	A	T	11	7	18	0	0	18	0	0
1	29804682	.	A	G	5	9	14	0	0	14	0	0
1	29805251	.	C	T	12	11	23	0	1	24	0	0
1	29806547	.	C	T	9	4	13	0	1	14	0	0
1	29813246	.	C	A	19	10	29	0	1	30	0	0
1	29813276	.	C	T	19	15	34	0	1	35	0	0
1	29817451	.	C	A	12	16	28	0	1	29	0	0
1	29820831	.	C	T	25	13	38	0	1	39	0	0
1	29823603	.	T	C	21	7	28	0	2	30	0	0
1	29823690	.	T	A	19	20	39	0	3	42	0	0
1	29823701	.	A	G	22	22	44	0	2	46	0	0
1	29858127	.	G	T	4	3	7	0	0	7	0	0
1	29858300	.	A	T	4	3	7	0	0	7	0	0
1	29860326	.	T	A	3	3	6	0	0	6	0	0
1	29862155	.	A	C	6	4	10	0	0	10	0	0
1	29872653	.	T	G	3	0	3	0	4	7	0	0
1	29891937	.	C	T	2	3	5	0	0	5	0	0
1	29896769	.	A	C	5	4	9	0	0	9	0	0
1	29900692	.	G	A	4	7	11	0	0	11	0	0
1	29900931	.	A	G	3	0	3	0	7	10	0	0
1	29908013	.	A	G	4	7	11	0	0	11	0	0
1	29909502	.	C	T	4	5	9	0	1	10	0	0
1	29916178	.	G	A	7	5	12	0	1	13	0	0
1	29952918	.	A	T	4	6	10	0	0	10	0	0
1	29953115	.	C	A	4	13	17	0	1	18	0	0
1	29953239	.	G	T	1	3	4	0	10	14	0	0
1	29953433	.	A	T	11	4	15	0	0	15	0	0
1	29953616	.	A	T	2	4	6	0	0	6	0	0
1	29954795	.	A	C	3	4	7	0	2	9	0	0
1	29954844	.	T	C	4	12	16	0	0	16	0	0
1	29954972	.	C	T	9	8	17	0	0	17	0	0
1	29955006	.	G	A	7	8	15	0	1	16	0	0
1	29955171	.	G	A	10	13	23	0	1	24	0	0
1	29955179	.	A	G	10	14	24	0	0	24	0	0
1	29955228	.	C	T	13	10	23	0	0	23	0	0
1	29955249	.	A	G	11	8	19	0	1	20	0	0
1	30038844	.	A	C	8	10	18	0	1	19	0	0
1	30039302	.	T	A	4	7	11	0	0	11	0	0
1	30103483	.	C	A	4	4	8	0	0	8	0	0
1	30118166	.	C	T	7	4	11	0	0	11	0	0
1	30178635	.	C	A	3	3	6	0	0	6	0	0
1	30180924	.	G	A	5	3	8	0	1	9	0	0
1	30180929	.	T	A	5	4	9	0	1	10	0	0
1	30183309	.	C	G	7	5	12	0	0	12	0	0
1	30212461	.	G	A	11	3	14	0	0	14	0	0
1	30212793	.	G	A	6	4	10	0	0	10	0	0
1	30250557	.	T	C	11	7	18	0	0	18	0	0
1	30255365	.	G	A	16	11	27	0	0	27	0	0
1	30255458	.	A	C	20	8	28	0	1	29	0	0
1	30270683	.	T	C	7	8	15	0	1	16	0	0
1	30282841	.	G	T	5	8	13	0	0	13	0	0
1	30343967	.	T	G	7	14	21	0	2	23	0	0
1	30344842	.	A	G	4	6	10	0	0	10	0	0
1	30345026	.	T	C	8	6	14	0	2	16	0	0
1	30345029	.	C	T	10	6	16	0	1	17	0	0
1	30345075	.	G	T	11	8	19	0	0	19	0	0
1	30345131	.	C	T	1	7	8	0	5	13	0	0
1	30345239	.	G	C	10	3	13	0	0	13	0	0
1	30345243	.	T	C	9	2	11	0	0	11	0	0
1	30345485	.	A	C	5	3	8	0	0	8	0	0
1	30345531	.	A	G	5	5	10	0	0	10	0	0
1	30345635	.	T	G	4	7	11	0	2	13	0	0
1	30345669	.	T	G	12	6	18	0	1	19	0	0
1	30346042	.	G	A	8	8	16	0	1	17	0	0
1	30346112	.	T	C	9	8	17	0	1	18	0	0
1	30346124	.	T	A	12	8	20	0	0	20	0	0
1	30346233	.	G	A	6	10	16	0	0	16	0	0
1	30346377	.	G	A	8	7	15	0	0	15	0	0
1	30346385	.	G	A	7	6	13	0	1	14	0	0
1	30346432	.	T	G	5	7	12	0	1	13	0	0
1	30346456	.	G	A	6	4	10	0	1	11	0	0
1	30346624	.	G	T	10	3	13	0	0	13	0	0
1	30346845	.	G	T	5	5	10	0	0	10	0	0
1	30346906	.	C	A	6	6	12	0	1	13	0	0
1	30346977	.	C	A	9	13	22	0	0	22	0	0
1	30347027	.	C	A	10	9	19	0	2	21	0	0
1	30347043	.	T	C	11	0	11	0	7	18	0	0
1	30347586	.	C	T	8	2	10	0	2	12	0	0
1	30366800	.	T	A	5	11	16	0	1	17	0	0
1	30439970	.	C	T	1	1	2	0	2	4	0	0
1	30440803	.	C	T	0	3	3	0	2	5	0	0
1	30441057	.	G	A	1	5	6	0	0	6	0	0
1	30540092	.	T	A	1	3	4	0	0	4	0	0
1	30540535	.	C	T	5	2	7	0	0	7	0	0
1	30568183	.	C	T	0	5	5	0	5	10	0	0
1	30589258	.	C	A	15	8	23	0	0	23	0	0
1	30641002	.	G	A	2	3	5	0	0	5	0	0
1	30641077	.	C	A	0	6	6	0	7	13	0	0
1	30688453	.	G	A	2	5	7	0	0	7	0	0
1	30688606	.	C	T	1	2	3	0	1	4	0	0
1	30688802	.	G	A	4	4	8	0	0	8	0	0
1	30688901	.	G	A	5	2	7	0	0	7	0	0
1	30688924	.	G	T	3	5	8	0	1	9	0	0
1	30718463	.	T	A	1	6	7	0	1	8	0	0
1	30718538	.	C	G	8	14	22	0	0	22	0	0
1	30718567	.	A	C	10	1	11	0	11	22	0	0
1	30747216	.	C	T	0	4	4	0	2	6	0	0
1	30955972	.	C	A	1	1	2	0	2	4	0	0
1	31061337	.	G	T	2	2	4	0	0	4	0	0
1	31063836	.	T	C	2	2	4	0	0	4	0	0
1	31063923	.	T	C	2	3	5	0	1	6	0	0
1	31063928	.	G	A	4	3	7	0	0	7	0	0
1	31063975	.	G	A	0	5	5	0	4	9	0	0
1	31063982	.	G	A	0	3	3	0	4	7	0	0
1	31064011	.	A	C	2	2	4	0	1	5	0	0
1	31072098	.	T	C	5	3	8	0	0	8	0	0
1	31072348	.	A	C	5	4	9	0	0	9	0	0
1	31072589	.	C	T	5	2	7	0	0	7	0	0
1	31072604	.	A	C	1	5	6	0	0	6	0	0
1	31072843	.	C	T	3	3	6	0	0	6	0	0
1	31072863	.	A	G	3	4	7	0	0	7	0	0
1	31075158	.	C	T	0	8	8	0	3	11	0	0
1	31079822	.	C	T	8	3	11	0	0	11	0	0
1	31083271	.	G	A	8	5	13	0	0	13	0	0
1	31085882	.	C	T	4	7	11	0	1	12	0	0
1	31088744	.	C	T	3	5	8	0	1	9	0	0
1	31091120	.	A	G	2	3	5	0	0	5	0	0
1	31091313	.	T	C	2	3	5	0	1	6	0	0
1	31091473	.	C	T	2	5	7	0	1	8	0	0
1	31091995	.	T	A	1	6	7	0	1	8	0	0
1	31102305	.	G	A	2	3	5	0	0	5	0	0
1	31102986	.	C	T	6	3	9	0	1	10	0	0
1	31103376	.	G	A	1	4	5	0	0	5	0	0
1	31103584	.	A	T	2	2	4	0	0	4	0	0
1	31104069	.	T	C	5	3	8	0	0	8	0	0
1	31112466	.	G	C	2	12	14	0	0	14	0	0
1	31112468	.	G	A	2	12	14	0	0	14	0	0
1	31117686	.	G	A	20	11	31	0	0	31	0	0
1	31117695	.	T	C	18	10	28	0	1	29	0	0
1	31119296	.	C	T	22	23	45	0	2	47	0	0
1	31122596	.	G	A	27	24	51	0	5	56	0	0
1	31130005	.	T	C	26	20	46	0	1	47	0	0
1	31130028	.	T	C	24	18	42	0	3	45	0	0
1	31130094	.	G	A	3	12	15	0	17	32	0	0
1	31130176	.	T	C	4	7	11	0	3	14	0	0
1	31136018	.	G	A	4	5	9	0	0	9	0	0
1	31136477	.	A	G	6	3	9	0	0	9	0	0
1	31146286	.	G	A	0	1	1	0	2	3	0	0
1	31374780	.	A	T	19	14	33	0	0	33	0	0
1	31386255	.	T	C	16	7	23	0	1	24	0	0
1	31423014	.	C	T	2	10	12	0	21	33	0	0
1	31423099	.	G	T	21	14	35	0	1	36	0	0
1	31428150	.	G	A	7	6	13	0	0	13	0	0
1	31430665	.	A	G	10	10	20	0	1	21	0	0
1	31445770	.	A	G	6	8	14	0	0	14	0	0
1	31445874	.	T	A	9	7	16	0	0	16	0	0
1	31472033	.	A	G	8	16	24	0	1	25	0	0
1	31654289	.	A	C	2	2	4	0	0	4	0	0
1	31657604	.	T	C	5	8	13	0	0	13	0	0
1	31659981	.	A	C	1	3	4	0	0	4	0	0
1	31661165	.	T	C	5	2	7	0	0	7	0	0
1	31664892	.	C	T	8	5	13	0	0	13	0	0
1	31667491	.	C	T	3	5	8	0	0	8	0	0
1	31671721	.	C	T	5	5	10	0	0	10	0	0
1	31671746	.	C	A	10	4	14	0	0	14	0	0
1	31671958	.	G	A	1	6	7	0	5	12	0	0
1	31672078	.	G	A	4	5	9	0	0	9	0	0
1	31793920	.	A	G	1	0	1	0	2	3	0	0
1	31793998	.	A	G	2	8	10	1	0	11	0	0
1	31797386	.	A	G	2	6	8	0	0	8	0	0
1	31797459	.	G	A	2	8	10	0	1	11	0	0
1	31797503	.	G	A	1	5	6	0	2	8	0	0
1	31797533	.	C	T	5	4	9	0	0	9	0	0
1	31797597	.	G	A	4	4	8	0	1	9	0	0
1	31798794	.	T	C	1	3	4	0	1	5	0	0
1	31798821	.	C	T	2	3	5	0	0	5	0	0
1	31798974	.	G	C	6	4	10	0	2	12	0	0
1	31798980	.	C	T	6	5	11	0	0	11	0	0
1	31799112	.	C	A	1	4	5	0	1	6	0	0
1	31799185	.	T	A	1	2	3	0	0	3	0	0
1	31809184	.	A	T	6	5	11	1	1	13	0	0
1	31809302	.	G	A	2	9	11	0	0	11	0	0
1	31809332	.	G	A	4	9	13	0	0	13	0	0
1	31809496	.	G	A	13	9	22	0	0	22	0	0
1	31813229	.	A	G	11	12	23	0	1	24	0	0
1	31813283	.	A	G	12	11	23	0	1	24	0	0
1	31813355	.	T	C	5	5	10	0	0	10	0	0
1	31818237	.	G	A	6	3	9	0	0	9	0	0
1	31823629	.	T	C	4	7	11	0	1	12	0	0
1	31865172	.	G	A	6	5	11	0	2	13	0	0
1	31865387	.	G	A	9	4	13	0	1	14	0	0
1	31866684	.	G	A	15	12	27	0	0	27	0	0
1	31867264	.	T	A	15	6	21	0	2	23	0	0
1	31867314	.	C	T	11	9	20	0	0	20	0	0
1	31867449	.	C	T	11	7	18	0	0	18	0	0
1	31867589	.	G	A	7	5	12	0	1	13	0	0
1	31943042	.	T	G	8	0	8	0	6	14	0	0
1	33281948	.	A	G	3	4	7	0	0	7	0	0
1	33331648	.	C	T	2	2	4	0	0	4	0	0
1	33355834	.	T	G	5	3	8	0	0	8	0	0
1	33356004	.	C	T	2	2	4	0	0	4	0	0
1	33356259	.	A	T	8	1	9	1	1	11	0	0
1	33356316	.	A	C	1	2	3	1	0	4	0	0
1	33356430	.	A	G	5	5	10	1	0	11	0	0
1	33374063	.	C	G	3	2	5	0	0	5	0	0
1	33384062	.	G	A	7	10	17	0	0	17	0	0
1	33449334	.	C	A	6	8	14	0	0	14	0	0
1	33484129	.	C	G	12	8	20	0	0	20	0	0
1	33484288	.	T	C	6	12	18	0	1	19	0	0
1	33484293	.	C	A	6	13	19	0	0	19	0	0
1	33484404	.	C	T	16	5	21	0	0	21	0	0
1	33484652	.	T	C	20	12	32	0	0	32	0	0
1	33485692	.	A	G	6	1	7	0	12	19	0	0
1	33556056	.	G	A	3	9	12	0	1	13	0	0
1	33561520	.	A	G	9	1	10	0	14	24	0	0
1	33561544	.	C	T	9	11	20	0	1	21	0	0
1	33568153	.	A	T	7	13	20	0	2	22	0	0
1	33568211	.	A	G	6	0	6	0	8	14	0	0
1	33568260	.	A	C	6	6	12	0	0	12	0	0
1	33568266	.	G	A	9	6	15	0	0	15	0	0
1	33568303	.	G	A	1	5	6	0	10	16	0	0
1	33568454	.	G	T	7	8	15	0	2	17	0	0
1	33568520	.	G	A	7	12	19	0	1	20	0	0
1	33568836	.	T	G	0	19	19	3	2	24	0	0
1	33568976	.	G	T	0	11	11	0	10	21	0	0
1	33634191	.	T	C	1	2	3	0	0	3	0	0
1	33634227	.	T	C	1	2	3	0	0	3	0	0
1	33654170	.	G	A	2	3	5	0	0	5	0	0
1	33656317	.	A	T	5	5	10	0	0	10	0	0
1	33656560	.	C	G	4	3	7	0	0	7	0	0
1	33656831	.	G	A	3	3	6	0	0	6	0	0
1	33656900	.	T	G	3	2	5	0	0	5	0	0
1	33657793	.	A	G	7	3	10	0	0	10	0	0
1	33657904	.	G	A	1	5	6	0	2	8	0	0
1	33658030	.	G	A	0	6	6	0	8	14	0	0
1	33658065	.	T	G	7	6	13	0	0	13	0	0
1	33658537	.	C	T	3	4	7	0	0	7	0	0
1	33658669	.	A	G	4	0	4	0	7	11	0	0
1	33658852	.	C	A	6	6	12	0	0	12	0	0
1	33658945	.	C	T	12	7	19	0	0	19	0	0
1	33658971	.	C	T	4	12	16	0	0	16	0	0
1	33659374	.	C	T	5	7	12	0	0	12	0	0
1	33686477	.	G	A	6	9	15	0	0	15	0	0
1	33686513	.	G	T	12	9	21	0	0	21	0	0
1	33687177	.	A	T	6	10	16	0	2	18	0	0
1	33693919	.	C	A	7	4	11	0	1	12	0	0
1	33694165	.	A	T	3	6	9	0	0	9	0	0
1	33694198	.	T	A	4	3	7	0	0	7	0	0
1	33694327	.	C	T	11	7	18	0	1	19	0	0
1	33694357	.	T	A	5	12	17	0	0	17	0	0
1	33694517	.	T	A	1	4	5	0	0	5	0	0
1	33697597	.	G	A	3	2	5	0	0	5	0	0
1	33698327	.	C	A	3	4	7	0	0	7	0	0
1	33701368	.	C	T	3	3	6	0	1	7	0	0
1	33701445	.	C	T	4	4	8	0	0	8	0	0
1	33722181	.	C	A	1	3	4	0	0	4	0	0
1	33969170	.	C	G	10	5	15	0	1	16	0	0
1	33969389	.	A	T	6	5	11	0	0	11	0	0
1	33969445	.	G	T	5	3	8	0	1	9	0	0
1	34043394	.	T	C	10	9	19	0	0	19	0	0
1	34134691	.	G	A	2	7	9	0	12	21	0	0
1	34137711	.	T	C	10	11	21	0	0	21	0	0
1	34137741	.	T	C	11	8	19	1	1	21	0	0
1	34137768	.	A	C	8	6	14	1	0	15	0	0
1	34176504	.	C	T	4	9	13	0	0	13	0	0
1	34176808	.	A	T	12	11	23	0	0	23	0	0
1	34199906	.	G	T	17	12	29	0	5	34	0	0
1	34199913	.	C	T	17	18	35	0	3	38	0	0
1	34232407	.	A	G	9	12	21	0	1	22	0	0
1	34232514	.	G	A	7	6	13	0	0	13	0	0
1	34232551	.	A	C	10	8	18	0	1	19	0	0
1	34232744	.	T	A	6	19	25	0	1	26	0	0
1	34232761	.	A	G	9	17	26	0	1	27	0	0
1	34232879	.	T	C	16	9	25	0	0	25	0	0
1	34232929	.	C	T	18	5	23	0	2	25	0	0
1	34232931	.	G	A	19	7	26	0	1	27	0	0
1	34233096	.	C	A	16	11	27	0	0	27	0	0
1	34233145	.	G	T	13	6	19	0	0	19	0	0
1	34233198	.	C	A	12	3	15	0	0	15	0	0
1	34233238	.	A	G	11	5	16	0	0	16	0	0
1	34233301	.	A	G	15	0	15	0	7	22	0	0
1	34233548	.	T	G	6	4	10	0	1	11	0	0
1	34243701	.	T	A	2	8	10	0	0	10	0	0
1	34258077	.	C	A	6	3	9	0	1	10	0	0
1	34258971	.	C	T	5	7	12	0	0	12	0	0
1	34259098	.	C	A	7	2	9	0	0	9	0	0
1	34259411	.	A	T	5	2	7	0	0	7	0	0
1	34259863	.	T	G	5	4	9	2	1	12	0	0
1	34260100	.	C	T	6	2	8	0	2	10	0	0
1	34260853	.	T	A	4	7	11	0	0	11	0	0
1	34260887	.	A	T	9	7	16	0	1	17	0	0
1	34260914	.	C	T	8	9	17	1	0	18	0	0
1	34261230	.	A	T	11	11	22	0	2	24	0	0
1	34261358	.	A	G	22	0	22	0	12	34	0	0
1	34261393	.	G	A	3	11	14	1	13	28	0	0
1	34261654	.	T	C	5	2	7	0	0	7	0	0
1	34296606	.	A	T	14	22	36	0	1	37	0	0
1	34297112	.	C	A	17	9	26	0	2	28	0	0
1	34297135	.	C	T	8	16	24	1	1	26	0	0
1	34497021	.	G	T	3	6	9	0	0	9	0	0
1	34540552	.	C	G	5	0	5	0	4	9	0	0
1	34540564	.	G	A	0	4	4	0	4	8	0	0
1	34540606	.	G	A	5	4	9	0	0	9	0	0
1	34540639	.	A	G	3	3	6	0	0	6	0	0
1	34556148	.	T	A	4	6	10	0	0	10	0	0
1	34556241	.	A	C	3	5	8	0	0	8	0	0
1	34556298	.	G	A	1	2	3	0	6	9	0	0
1	34556301	.	G	T	1	2	3	0	7	10	0	0
1	34597348	.	T	G	2	2	4	0	0	4	0	0
1	34617680	.	C	A	2	2	4	0	0	4	0	0
1	34679431	.	A	G	4	3	7	0	0	7	0	0
1	34695423	.	G	A	12	17	29	0	2	31	0	0
1	34695476	.	G	A	16	14	30	0	1	31	0	0
1	34696017	.	G	A	11	8	19	0	0	19	0	0
1	34703048	.	T	A	15	8	23	0	1	24	0	0
1	34703272	.	A	G	12	15	27	0	1	28	0	0
1	34706526	.	G	A	10	9	19	0	1	20	0	0
1	34707958	.	T	C	7	11	18	0	1	19	0	0
1	34708145	.	C	T	6	25	31	0	27	58	0	0
1	34712097	.	A	G	34	33	67	0	5	72	0	0
1	34806975	.	A	T	2	2	4	0	0	4	0	0
1	35212086	.	A	G	4	4	8	2	0	10	0	0
1	35232521	.	A	C	3	6	9	0	0	9	0	0
1	35232834	.	C	A	2	7	9	0	1	10	0	0
1	35473473	.	T	A	3	2	5	0	0	5	0	0
1	35473479	.	A	T	0	4	4	0	0	4	0	0
1	35475728	.	G	A	3	3	6	0	1	7	0	0
1	35475879	.	G	A	1	3	4	0	0	4	0	0
1	35476056	.	A	G	2	0	2	0	5	7	0	0
1	35479501	.	A	G	1	0	1	0	2	3	0	0
1	35481768	.	T	C	3	5	8	0	0	8	0	0
1	35481777	.	G	A	3	5	8	0	0	8	0	0
1	35482482	.	G	A	1	3	4	0	3	7	0	0
1	35482485	.	C	T	4	3	7	0	0	7	0	0
1	35484358	.	C	T	4	8	12	0	1	13	0	0
1	35484931	.	T	C	6	3	9	0	1	10	0	0
1	35484977	.	A	T	4	3	7	0	1	9	1	0
1	35485056	.	G	A	3	3	6	0	0	6	0	0
1	35485105	.	G	A	0	2	2	0	5	7	0	0
1	35485263	.	C	A	2	3	5	0	0	5	0	0
1	35485378	.	C	T	8	7	15	0	1	16	0	0
1	35488211	.	A	T	8	4	12	0	1	13	0	0
1	35488332	.	G	A	1	5	6	0	0	6	0	0
1	35586563	.	C	T	1	5	6	0	0	6	0	0
1	35597542	.	A	G	4	5	9	0	0	9	0	0
1	35608041	.	G	A	3	3	6	0	5	11	0	0
1	35608308	.	C	T	1	3	4	0	0	4	0	0
1	35608405	.	G	A	0	4	4	0	4	8	0	0
1	35608619	.	T	C	5	2	7	0	0	7	0	0
1	35608821	.	G	A	4	4	8	0	0	8	0	0
1	35608826	.	G	T	4	3	7	0	0	7	0	0
1	35609192	.	A	G	6	3	9	0	0	9	0	0
1	35609431	.	T	C	5	6	11	0	0	11	0	0
1	35609474	.	G	A	4	4	8	0	0	8	0	0
1	35609530	.	T	A	3	3	6	0	0	6	0	0
1	35793852	.	T	C	7	5	12	0	1	13	0	0
1	35810172	.	C	A	1	2	3	0	0	3	0	0
1	35811779	.	C	A	6	7	13	0	0	13	0	0
1	35811854	.	C	T	2	10	12	0	2	14	0	0
1	35812128	.	T	C	7	8	15	0	0	15	0	0
1	35812155	.	T	C	8	9	17	0	0	17	0	0
1	35815706	.	A	C	6	3	9	0	1	10	0	0
1	35834307	.	T	A	4	5	9	0	0	9	0	0
1	35834554	.	G	T	2	7	9	0	0	9	0	0
1	35835125	.	T	G	7	0	7	0	11	19	1	0
1	35835237	.	G	A	0	14	14	0	9	23	0	0
1	35835371	.	A	C	12	19	31	0	0	31	0	0
1	35835502	.	C	T	6	11	17	0	0	17	0	0
1	35897450	.	G	C	6	3	9	0	0	9	0	0
1	35897622	.	T	A	4	6	10	0	0	10	0	0
1	35897623	.	G	A	4	6	10	0	0	10	0	0
1	35898075	.	G	A	1	3	4	0	0	4	0	0
1	35908381	.	T	C	4	1	5	0	2	7	0	0
1	35908404	.	T	A	8	3	11	0	0	11	0	0
1	35908492	.	G	T	0	4	4	0	2	6	0	0
1	35949969	.	C	A	5	5	10	0	0	10	0	0
1	35950082	.	T	G	2	7	9	0	1	10	0	0
1	35950100	.	T	G	3	6	9	0	1	10	0	0
1	35956508	.	C	G	4	6	10	0	0	10	0	0
1	35956549	.	C	T	9	5	14	0	1	15	0	0
1	35959327	.	G	C	2	2	4	0	0	4	0	0
1	35959826	.	T	C	8	8	16	0	1	17	0	0
1	35962990	.	C	T	8	4	12	0	1	13	0	0
1	35963306	.	G	A	2	8	10	0	10	20	0	0
1	35963822	.	C	T	6	10	16	0	1	17	0	0
1	35969716	.	G	A	14	9	23	0	1	24	0	0
1	35969836	.	G	C	16	11	27	0	0	27	0	0
1	35969878	.	C	T	14	11	25	0	1	26	0	0
1	35970118	.	C	G	1	2	3	0	0	3	0	0
1	36018610	.	T	A	6	7	13	0	1	14	0	0
1	36018708	.	A	C	10	2	12	0	0	12	0	0
1	36018817	.	T	C	5	0	5	0	14	19	0	0
1	36019227	.	C	T	14	4	18	1	1	20	0	0
1	36019361	.	T	C	11	1	12	0	13	25	0	0
1	36019416	.	G	T	23	12	35	0	1	36	0	0
1	36020092	.	A	T	10	8	18	0	0	18	0	0
1	36020097	.	A	C	14	2	16	0	0	16	0	0
1	36020154	.	T	C	3	7	10	0	0	10	0	0
1	36020492	.	T	G	10	9	19	0	3	22	0	0
1	36020642	.	T	A	6	13	19	0	0	19	0	0
1	36021110	.	G	A	6	13	19	0	0	19	0	0
1	36021158	.	C	G	8	8	16	0	1	17	0	0
1	36021399	.	A	G	20	14	34	0	4	39	1	0
1	36057147	.	G	A	6	8	14	0	0	14	0	0
1	36057303	.	A	G	7	10	17	1	0	18	0	0
1	36057306	.	C	T	7	10	17	1	0	18	0	0
1	36104830	.	C	T	1	6	7	0	3	10	0	0
1	36105018	.	A	C	8	0	8	0	7	15	0	0
1	36105117	.	C	T	1	5	6	0	11	17	0	0
1	36119094	.	C	T	0	4	4	0	6	10	0	0
1	36119106	.	A	G	7	4	11	0	0	11	0	0
1	36194799	.	G	T	0	10	10	0	17	27	0	0
1	36200014	.	C	T	12	16	28	0	2	30	0	0
1	36438671	.	T	A	9	16	25	0	1	26	0	0
1	36438882	.	T	A	14	20	34	0	1	35	0	0
1	36439186	.	T	A	19	8	27	0	2	30	1	0
1	36439204	.	G	T	12	14	26	1	1	28	0	0
1	36439248	.	G	A	14	12	26	1	0	27	0	0
1	36439380	.	G	T	14	14	28	0	0	28	0	0
1	36693181	.	G	A	1	3	4	0	0	4	0	0
1	36693184	.	T	C	1	3	4	0	0	4	0	0
1	36701999	.	C	T	10	5	15	0	0	15	0	0
1	36722161	.	G	A	4	3	7	0	0	7	0	0
1	36722559	.	A	G	1	0	1	0	3	4	0	0
1	36725468	.	T	C	2	2	4	0	0	4	0	0
1	36735123	.	C	T	4	3	7	0	0	7	0	0
1	36735144	.	G	A	3	2	5	0	0	5	0	0
1	36738164	.	T	C	2	3	5	0	0	5	0	0
1	36738356	.	C	T	2	7	9	0	0	9	0	0
1	36738434	.	A	C	3	4	7	0	1	8	0	0
1	36738459	.	G	A	0	3	3	0	2	5	0	0
1	36738574	.	C	A	4	4	8	0	1	9	0	0
1	36738595	.	A	T	5	7	12	0	0	12	0	0
1	36738747	.	T	A	4	3	7	0	0	7	0	0
1	36738810	.	C	T	6	5	11	0	0	11	0	0
1	36739086	.	A	T	3	4	7	0	0	7	0	0
1	36739104	.	C	T	2	3	5	0	1	6	0	0
1	36739124	.	G	A	0	3	3	0	1	4	0	0
1	36740107	.	G	A	1	2	3	0	0	3	0	0
1	36740125	.	A	C	2	1	3	0	0	3	0	0
1	36740157	.	G	T	2	2	4	0	0	4	0	0
1	36740167	.	G	C	2	2	4	0	0	4	0	0
1	36740359	.	C	A	3	3	6	0	0	6	0	0
1	36740365	.	T	G	3	3	6	0	0	6	0	0
1	36740764	.	C	A	9	4	13	0	2	15	0	0
1	36740995	.	G	C	3	5	8	0	0	8	0	0
1	36741087	.	T	A	6	12	18	0	1	19	0	0
1	36741110	.	G	T	4	14	18	1	0	19	0	0
1	36741581	.	C	T	7	3	10	1	0	11	0	0
1	36741602	.	A	C	7	3	10	1	1	12	0	0
1	36741642	.	T	C	8	4	12	1	0	13	0	0
1	36741796	.	T	G	5	3	8	0	0	8	0	0
1	36741863	.	A	C	8	7	15	0	0	15	0	0
1	36742139	.	T	A	1	3	4	0	0	4	0	0
1	36742261	.	T	C	5	2	7	0	0	7	0	0
1	36755693	.	G	A	2	2	4	0	0	4	0	0
1	36763332	.	C	T	5	1	6	0	1	7	0	0
1	36768983	.	C	T	1	2	3	0	0	3	0	0
1	36771622	.	A	C	3	2	5	0	0	5	0	0
1	36836390	.	T	C	2	2	4	0	0	4	0	0
1	36841058	.	G	A	1	2	3	0	1	4	0	0
1	36887811	.	C	A	5	6	11	0	0	11	0	0
1	36887880	.	C	A	9	5	14	0	1	15	0	0
1	36903175	.	T	A	9	8	17	0	0	17	0	0
1	36911491	.	A	C	6	2	8	0	0	8	0	0
1	36911647	.	A	T	3	5	8	0	0	8	0	0
1	36911788	.	G	A	0	2	2	0	2	4	0	0
1	36912176	.	G	A	5	6	11	0	0	11	0	0
1	36912346	.	T	A	3	2	5	0	1	6	0	0
1	36938228	.	T	G	5	6	11	0	1	12	0	0
1	36963429	.	T	A	7	8	15	0	0	15	0	0
1	36969133	.	C	T	6	6	12	0	0	12	0	0
1	37083319	.	G	A	4	3	7	0	0	7	0	0
1	37083463	.	G	A	4	6	10	0	0	10	0	0
1	37083706	.	C	T	0	3	3	0	6	9	0	0
1	37083817	.	C	T	1	4	5	0	7	12	0	0
1	37083876	.	G	A	7	3	10	0	1	11	0	0
1	37083879	.	C	T	3	7	10	0	1	11	0	0
1	37087670	.	G	A	3	7	10	0	0	10	0	0
1	37087725	.	G	C	6	4	10	0	1	11	0	0
1	37195941	.	T	A	3	4	7	0	0	7	0	0
1	37195950	.	G	A	4	5	9	0	0	9	0	0
1	37196220	.	T	A	7	7	14	0	0	14	0	0
1	37196228	.	A	G	6	5	11	0	1	12	0	0
1	37212301	.	T	A	7	8	15	0	1	16	0	0
1	37212331	.	C	T	7	3	10	0	1	11	0	0
1	37284382	.	C	T	8	7	15	0	0	15	0	0
1	37287291	.	A	T	6	10	16	0	1	17	0	0
1	37287294	.	G	A	8	9	17	0	1	18	0	0
1	37291884	.	A	C	14	5	19	0	1	20	0	0
1	37304354	.	C	A	17	12	29	0	0	29	0	0
1	37304439	.	C	T	13	10	23	0	1	24	0	0
1	37304494	.	T	A	12	11	23	0	3	26	0	0
1	37304510	.	T	G	12	14	26	0	0	26	0	0
1	37304536	.	G	A	12	12	24	0	0	24	0	0
1	37304929	.	G	A	10	8	18	0	2	20	0	0
1	37305148	.	C	T	6	8	14	0	0	14	0	0
1	37306726	.	G	T	3	13	16	0	16	32	0	0
1	37306913	.	T	A	13	12	25	0	2	27	0	0
1	37306942	.	A	C	15	13	28	0	0	28	0	0
1	37339689	.	T	C	5	4	9	0	0	9	0	0
1	37339817	.	G	T	3	2	5	0	0	5	0	0
1	37344832	.	T	C	11	5	16	0	1	17	0	0
1	37353355	.	C	T	5	6	11	0	1	12	0	0
1	37355591	.	G	A	4	8	12	0	1	13	0	0
1	37355606	.	C	T	10	5	15	0	1	16	0	0
1	37359071	.	C	T	6	4	10	0	0	10	0	0
1	37359221	.	G	C	2	4	6	0	0	6	0	0
1	37359352	.	A	G	5	8	13	0	1	14	0	0
1	37361554	.	A	G	6	8	14	0	1	15	0	0
1	37361759	.	C	T	13	5	18	0	0	19	1	0
1	37361879	.	T	A	3	3	6	0	0	6	0	0
1	37361919	.	T	C	1	5	6	0	0	6	0	0
1	37361960	.	C	T	5	7	12	0	0	12	0	0
1	37399683	.	C	T	5	2	7	0	0	7	0	0
1	37399696	.	G	A	0	2	2	0	3	5	0	0
1	37399725	.	G	C	2	2	4	0	0	4	0	0
1	37399731	.	A	G	2	0	2	0	2	4	0	0
1	37399943	.	A	C	1	2	3	0	0	3	0	0
1	37752392	.	A	G	6	0	6	0	10	16	0	0
1	37752478	.	G	C	5	6	11	0	1	12	0	0
1	37753024	.	G	A	3	6	9	0	0	9	0	0
1	38125431	.	C	A	13	13	26	0	1	27	0	0
1	38125684	.	T	C	16	14	30	0	1	31	0	0
1	38131058	.	C	T	14	12	26	0	1	27	0	0
1	38131073	.	T	C	13	13	26	0	0	26	0	0
1	38131094	.	G	A	13	13	26	0	1	27	0	0
1	38131288	.	G	A	18	10	28	0	0	28	0	0
1	38131360	.	G	A	20	25	45	0	2	47	0	0
1	38131486	.	G	A	9	18	27	0	3	30	0	0
1	38131812	.	T	C	3	2	5	0	0	5	0	0
1	38131873	.	C	T	3	2	5	0	0	5	0	0
1	38142998	.	G	T	4	8	12	0	0	12	0	0
1	38150605	.	A	C	8	8	16	0	0	16	0	0
1	38163017	.	C	T	15	20	35	0	1	36	0	0
1	38163132	.	G	A	16	14	30	0	3	33	0	0
1	38166009	.	G	C	6	13	19	0	0	19	0	0
1	38166268	.	A	C	26	15	41	0	0	41	0	0
1	38166429	.	T	C	23	20	43	0	0	43	0	0
1	38166431	.	T	G	21	18	39	0	3	42	0	0
1	38166520	.	A	G	18	16	34	0	0	34	0	0
1	38169972	.	T	G	20	13	33	0	1	34	0	0
1	38170553	.	G	A	15	20	35	0	1	36	0	0
1	38346065	.	T	C	1	2	3	0	0	3	0	0
1	38346162	.	C	T	0	8	8	3	8	19	0	0
1	38346578	.	G	T	3	8	11	0	1	12	0	0
1	38346649	.	C	T	0	5	5	0	7	12	0	0
1	38346739	.	G	A	10	9	19	0	0	19	0	0
1	38354049	.	G	A	3	6	9	0	1	10	0	0
1	38372101	.	G	A	0	4	4	0	2	6	0	0
1	38374317	.	G	A	4	5	9	0	0	9	0	0
1	38416477	.	G	A	7	4	11	0	0	11	0	0
1	38416536	.	A	G	1	7	8	0	0	8	0	0
1	38417116	.	A	T	2	1	3	0	1	4	0	0
1	38417229	.	G	A	2	3	5	0	0	5	0	0
1	38417268	.	A	T	2	2	4	0	0	4	0	0
1	38417332	.	A	G	3	7	10	0	0	10	0	0
1	38417370	.	G	A	6	8	14	0	1	15	0	0
1	38417531	.	G	T	2	3	5	0	0	5	0	0
1	38417571	.	G	T	2	4	6	0	1	7	0	0
1	38417588	.	T	G	6	4	10	0	1	11	0	0
1	38417617	.	A	T	9	1	10	0	1	11	0	0
1	38417625	.	A	T	8	5	13	0	0	13	0	0
1	38417680	.	T	A	2	4	6	0	1	7	0	0
1	38418087	.	C	T	6	8	14	0	0	14	0	0
1	38466714	.	G	A	2	6	8	0	0	8	0	0
1	38649340	.	A	G	35	29	64	0	2	66	0	0
1	38649947	.	G	A	42	25	67	0	8	75	0	0
1	38650132	.	G	T	31	36	67	0	1	68	0	0
1	38650298	.	G	A	32	25	57	0	2	59	0	0
1	38650382	.	G	C	30	39	69	0	2	71	0	0
1	38650467	.	A	G	28	38	66	0	4	70	0	0
1	38650510	.	G	C	36	30	66	1	2	69	0	0
1	38650516	.	T	C	35	33	68	1	1	70	0	0
1	38650545	.	T	C	42	32	74	1	3	78	0	0
1	38651063	.	G	T	47	25	72	0	3	75	0	0
1	38651065	.	T	A	46	25	71	0	5	76	0	0
1	38651361	.	C	T	18	17	35	0	1	36	0	0
1	38651370	.	G	A	17	14	31	0	1	32	0	0
1	38651469	.	C	A	18	24	42	0	2	44	0	0
1	38651822	.	G	A	14	14	28	0	0	28	0	0
1	38655522	.	C	T	5	28	33	1	38	72	0	0
1	38657689	.	G	A	31	35	66	0	3	69	0	0
1	38660240	.	T	C	33	2	35	0	32	67	0	0
1	38660252	.	A	G	34	32	66	0	3	69	0	0
1	38660369	.	G	A	30	33	63	0	1	64	0	0
1	38709351	.	A	C	21	1	22	0	13	35	0	0
1	38709381	.	G	C	21	7	28	2	1	31	0	0
1	38709480	.	G	A	14	14	28	0	2	30	0	0
1	38709535	.	T	A	10	10	20	0	1	21	0	0
1	38787039	.	C	T	6	3	9	0	2	11	0	0
1	38791569	.	C	T	6	13	19	0	0	19	0	0
1	38793983	.	G	A	5	5	10	0	0	10	0	0
1	38797663	.	A	C	12	16	28	0	0	28	0	0
1	38799513	.	G	A	15	16	31	0	1	32	0	0
1	38799585	.	A	G	17	10	27	0	0	27	0	0
1	38799588	.	T	A	10	16	26	0	1	27	0	0
1	38802537	.	G	A	7	11	18	1	0	19	0	0
1	38802703	.	A	G	7	12	19	0	3	22	0	0
1	38802718	.	G	A	16	9	25	0	1	26	0	0
1	38802747	.	A	G	17	0	17	0	8	25	0	0
1	38802855	.	C	A	10	10	20	0	1	21	0	0
1	38803092	.	C	T	7	6	13	0	0	13	0	0
1	38803127	.	C	T	10	6	16	0	0	16	0	0
1	38803154	.	T	A	9	8	17	0	1	18	0	0
1	38803205	.	A	T	10	9	19	0	0	19	0	0
1	38803404	.	A	G	12	11	23	0	1	24	0	0
1	38805128	.	G	T	8	9	17	0	1	18	0	0
1	38805135	.	C	T	8	8	16	0	2	18	0	0
1	38805439	.	G	A	9	15	24	0	1	25	0	0
1	38805450	.	A	G	11	14	25	0	0	25	0	0
1	38805506	.	G	A	15	10	25	0	1	26	0	0
1	38807255	.	G	C	14	12	26	0	0	26	0	0
1	38808259	.	C	A	6	10	16	0	0	16	0	0
1	38808379	.	C	T	2	11	13	0	9	22	0	0
1	38808723	.	T	A	7	12	19	0	0	19	0	0
1	38810061	.	T	G	10	6	16	0	0	16	0	0
1	38820219	.	G	A	0	6	6	0	13	19	0	0
1	38822092	.	A	T	5	4	9	0	1	10	0	0
1	38851111	.	C	T	1	3	4	0	0	4	0	0
1	38851225	.	C	T	1	2	3	0	0	3	0	0
1	39388332	.	A	C	3	2	5	0	0	5	0	0
1	39388363	.	C	T	2	3	5	0	0	5	0	0
1	39482532	.	C	T	1	2	3	0	0	3	0	0
1	39639723	.	C	T	8	5	13	0	0	13	0	0
1	39680758	.	G	A	0	3	3	0	4	7	0	0
1	39680794	.	C	A	2	4	6	0	0	6	0	0
1	39700498	.	T	C	7	5	12	0	1	13	0	0
1	39732544	.	C	T	8	9	17	0	0	17	0	0
1	39735491	.	T	C	14	13	27	0	0	27	0	0
1	39770416	.	C	T	10	11	21	0	1	22	0	0
1	39771429	.	T	A	19	8	27	0	1	28	0	0
1	39772010	.	T	C	13	15	28	0	2	30	0	0
1	39772042	.	A	G	16	14	30	0	0	30	0	0
1	39772135	.	C	A	12	11	23	0	1	24	0	0
1	39772225	.	C	T	21	17	38	0	0	38	0	0
1	39774096	.	C	T	11	17	28	0	1	29	0	0
1	39774225	.	C	T	18	15	33	0	2	35	0	0
1	39774363	.	G	A	8	17	25	0	1	26	0	0
1	39774618	.	A	G	12	9	21	0	2	23	0	0
1	39774690	.	A	G	18	8	26	0	2	28	0	0
1	39774727	.	C	A	10	13	23	0	4	27	0	0
1	39774891	.	C	T	12	16	28	0	5	33	0	0
1	39774915	.	G	A	17	16	33	0	1	34	0	0
1	39775089	.	C	T	12	11	23	0	0	23	0	0
1	39775131	.	C	T	15	13	28	0	0	29	1	0
1	39775227	.	C	T	13	8	21	0	1	22	0	0
1	39776356	.	A	C	20	18	38	0	1	39	0	0
1	39777089	.	G	A	13	14	27	0	2	29	0	0
1	39777836	.	G	A	0	8	8	0	19	27	0	0
1	39777975	.	A	T	12	12	24	0	2	26	0	0
1	39778047	.	A	G	13	1	14	0	14	28	0	0
1	39778075	.	T	G	15	11	26	0	1	27	0	0
1	39778332	.	G	C	16	31	47	0	0	47	0	0
1	39778661	.	G	A	11	8	19	0	0	19	0	0
1	39778663	.	G	A	10	8	18	0	1	19	0	0
1	39778949	.	G	C	21	22	43	0	1	44	0	0
1	39779225	.	G	C	15	9	24	0	1	25	0	0
1	39779518	.	T	G	15	6	21	1	0	22	0	0
1	39869783	.	C	T	1	2	3	0	0	3	0	0
1	39869860	.	T	A	4	3	7	0	0	7	0	0
1	39869974	.	G	A	2	4	6	0	0	6	0	0
1	39870008	.	T	C	4	6	10	0	0	10	0	0
1	39879980	.	C	T	2	2	4	0	0	4	0	0
1	39880038	.	G	A	3	2	5	0	0	5	0	0
1	39880815	.	T	G	1	0	1	0	2	3	0	0
1	39882764	.	A	T	1	3	4	0	0	4	0	0
1	39882899	.	A	G	3	4	7	0	0	7	0	0
1	39882906	.	T	A	5	3	8	0	0	8	0	0
1	39883259	.	C	G	2	2	4	0	1	5	0	0
1	39899477	.	G	C	19	17	36	0	0	36	0	0
1	39899494	.	A	G	19	18	37	0	1	38	0	0
1	39899663	.	G	A	19	24	43	0	2	45	0	0
1	39900056	.	G	A	21	27	48	0	4	52	0	0
1	39900129	.	G	A	30	17	47	0	0	47	0	0
1	39900137	.	G	T	28	17	45	0	2	47	0	0
1	39900360	.	G	A	8	14	22	0	0	22	0	0
1	39900432	.	C	T	1	23	24	0	11	35	0	0
1	39900750	.	C	T	1	16	17	0	14	31	0	0
1	39901269	.	G	A	7	5	12	0	1	13	0	0
1	39901378	.	T	A	10	8	18	0	2	20	0	0
1	39901500	.	T	C	12	14	26	0	0	26	0	0
1	39901501	.	G	A	12	14	26	0	0	26	0	0
1	39901729	.	T	C	15	0	15	0	16	31	0	0
1	39905278	.	C	T	2	2	4	0	0	4	0	0
1	39907291	.	A	C	9	7	16	0	0	16	0	0
1	39907492	.	T	C	17	1	18	0	17	35	0	0
1	39907611	.	C	T	1	9	10	0	4	14	0	0
1	39908047	.	G	A	12	15	27	0	1	28	0	0
1	39908680	.	C	T	16	10	26	0	2	28	0	0
1	39908854	.	A	G	12	19	31	0	0	31	0	0
1	39908881	.	C	T	9	15	24	0	3	27	0	0
1	39908926	.	A	G	10	8	18	0	1	19	0	0
1	39909003	.	A	T	16	12	28	0	0	28	0	0
1	39909247	.	A	T	13	26	39	0	1	40	0	0
1	39909274	.	A	T	11	23	34	0	3	37	0	0
1	39977098	.	G	A	2	3	5	2	0	7	0	0
1	39995100	.	C	T	12	11	23	0	0	23	0	0
1	39998875	.	G	A	10	12	22	0	1	23	0	0
1	40001853	.	A	T	14	7	21	0	3	24	0	0
1	40001873	.	C	A	12	10	22	0	1	23	0	0
1	40002113	.	G	A	23	5	28	0	2	30	0	0
1	40002148	.	C	G	20	8	28	0	0	28	0	0
1	40008905	.	T	C	21	25	46	0	1	47	0	0
1	40008906	.	G	A	19	26	45	0	2	47	0	0
1	40009227	.	T	A	19	15	34	0	1	35	0	0
1	40009258	.	C	T	17	11	28	0	2	30	0	0
1	40009291	.	A	G	17	10	27	0	1	28	0	0
1	40009382	.	G	A	17	11	28	0	0	28	0	0
1	40009526	.	T	C	3	5	8	0	1	9	0	0
1	40009625	.	T	C	5	9	14	0	0	14	0	0
1	40009671	.	C	A	13	9	22	0	0	22	0	0
1	40009697	.	C	T	13	9	22	0	1	23	0	0
1	40015189	.	A	G	10	8	18	0	0	18	0	0
1	40015219	.	C	T	11	13	24	0	0	24	0	0
1	40015265	.	C	T	1	9	10	0	13	23	0	0
1	40015553	.	A	G	9	7	16	0	1	17	0	0
1	40015697	.	A	G	8	10	18	0	1	19	0	0
1	40023692	.	T	C	3	2	5	0	0	5	0	0
1	40028089	.	T	C	4	2	6	0	0	6	0	0
1	40028208	.	C	A	7	4	11	0	0	11	0	0
1	40028424	.	C	T	8	3	11	0	1	12	0	0
1	40028508	.	C	T	10	5	15	0	2	17	0	0
1	40028568	.	G	T	4	4	8	0	1	9	0	0
1	40028613	.	G	A	2	5	7	0	1	8	0	0
1	40028680	.	G	A	1	2	3	0	0	3	0	0
1	40041528	.	C	T	12	7	19	0	0	19	0	0
1	40042241	.	G	A	6	4	10	0	0	10	0	0
1	40044562	.	G	A	9	7	16	0	0	16	0	0
1	40044578	.	C	T	9	7	16	0	0	16	0	0
1	40046859	.	G	A	4	10	14	0	0	14	0	0
1	40047070	.	T	A	6	12	18	0	0	18	0	0
1	40051918	.	T	C	8	6	14	1	0	15	0	0
1	40051923	.	G	C	9	7	16	1	0	17	0	0
1	40051988	.	G	C	0	12	12	0	15	27	0	0
1	40052033	.	A	G	9	13	22	0	0	22	0	0
1	40052066	.	G	C	11	10	21	0	1	22	0	0
1	40052083	.	G	A	11	13	24	0	1	25	0	0
1	40052481	.	A	C	9	14	23	0	1	24	0	0
1	40052550	.	A	C	10	7	17	0	1	18	0	0
1	40052562	.	A	G	7	7	14	0	1	15	0	0
1	40052965	.	T	A	3	4	7	0	0	7	0	0
1	40057604	.	A	G	6	8	14	0	0	14	0	0
1	40057655	.	C	T	7	5	12	0	0	12	0	0
1	40057805	.	C	T	5	9	14	0	2	16	0	0
1	40060968	.	A	C	3	7	10	0	0	10	0	0
1	40060992	.	C	T	0	5	5	0	5	10	0	0
1	40061061	.	C	T	1	6	7	0	5	12	0	0
1	40061169	.	G	A	9	6	15	0	0	15	0	0
1	40061285	.	C	T	10	6	16	0	1	17	0	0
1	40062593	.	T	G	4	3	7	0	0	7	0	0
1	40066299	.	G	A	4	4	8	0	0	8	0	0
1	40095541	.	C	T	0	2	2	0	3	5	0	0
1	40107874	.	T	G	8	16	24	0	0	24	0	0
1	40107961	.	C	T	10	5	15	0	0	15	0	0
1	40111679	.	C	G	9	16	25	0	1	26	0	0
1	40111702	.	T	G	13	20	33	0	2	35	0	0
1	40111737	.	A	C	17	20	37	0	1	39	1	0
1	40111738	.	G	A	18	19	37	0	2	39	0	0
1	40111776	.	C	T	12	11	23	0	2	25	0	0
1	40111918	.	C	T	10	11	21	0	0	21	0	0
1	40112206	.	T	C	10	4	14	0	5	19	0	0
1	40112347	.	C	T	5	10	15	0	0	15	0	0
1	40112410	.	C	T	5	5	10	0	4	14	0	0
1	40112500	.	A	G	6	3	9	0	0	9	0	0
1	40112713	.	A	G	3	2	5	0	2	7	0	0
1	40112760	.	T	A	4	9	13	0	0	13	0	0
1	40112822	.	A	T	12	5	17	2	0	19	0	0
1	40112837	.	C	T	6	11	17	2	0	19	0	0
1	40112869	.	C	T	13	6	19	2	1	22	0	0
1	40112879	.	A	G	11	6	17	2	0	19	0	0
1	40112938	.	G	C	4	11	15	0	2	17	0	0
1	40113259	.	A	T	2	3	5	0	0	5	0	0
1	40113272	.	G	C	5	3	8	0	0	8	0	0
1	40113374	.	T	A	6	5	11	0	0	11	0	0
1	40113486	.	A	G	4	4	8	0	0	8	0	0
1	40114155	.	T	A	3	5	8	0	0	8	0	0
1	40114527	.	T	A	3	2	5	0	1	6	0	0
1	40115065	.	T	C	5	3	8	0	0	8	0	0
1	40116747	.	G	A	6	6	12	0	0	12	0	0
1	40116823	.	C	T	1	4	5	0	6	11	0	0
1	40116889	.	G	A	4	4	8	0	0	8	0	0
1	40116915	.	T	G	6	4	10	0	1	11	0	0
1	40116946	.	C	T	1	6	7	0	5	12	0	0
1	40117345	.	G	A	16	9	25	0	1	26	0	0
1	40123964	.	C	T	1	10	11	0	5	16	0	0
1	40126279	.	T	C	11	6	17	0	0	17	0	0
1	40126281	.	T	G	11	6	17	0	0	17	0	0
1	40132692	.	G	C	4	4	8	0	0	8	0	0
1	40210865	.	G	T	19	15	34	0	0	34	0	0
1	40211048	.	C	T	0	4	4	0	11	15	0	0
1	40211065	.	T	C	8	5	13	0	1	14	0	0
1	40211217	.	A	C	6	11	17	0	1	18	0	0
1	40211465	.	T	C	13	0	13	0	6	19	0	0
1	40211645	.	C	G	1	8	9	0	10	19	0	0
1	40212065	.	C	T	17	11	28	0	0	28	0	0
1	40212084	.	C	A	0	10	10	0	17	27	0	0
1	40212305	.	C	T	11	18	29	0	1	30	0	0
1	40221359	.	A	G	7	11	18	0	0	18	0	0
1	40221458	.	A	T	5	5	10	0	2	12	0	0
1	40226289	.	G	A	14	7	21	0	0	21	0	0
1	40226292	.	G	C	7	13	20	0	0	20	0	0
1	40227029	.	T	G	8	8	16	0	0	16	0	0
1	40242922	.	C	A	2	5	7	0	0	7	0	0
1	40248173	.	C	T	6	6	12	0	0	12	0	0
1	40248383	.	C	T	4	6	10	0	0	10	0	0
1	40252219	.	T	A	10	14	24	0	0	24	0	0
1	40257631	.	C	T	14	10	24	0	1	25	0	0
1	40257751	.	C	T	7	10	17	0	1	18	0	0
1	40257834	.	T	G	9	0	9	0	5	14	0	0
1	40258340	.	G	T	3	2	5	0	1	6	0	0
1	40263675	.	C	A	3	8	11	0	0	11	0	0
1	40266618	.	C	T	35	21	56	0	4	60	0	0
1	40270028	.	G	T	5	2	7	0	0	7	0	0
1	40270054	.	C	T	32	31	63	0	7	70	0	0
1	40270094	.	G	A	4	25	29	0	33	62	0	0
1	40270095	.	G	A	34	26	60	0	3	63	0	0
1	40336234	.	C	G	6	5	11	0	0	11	0	0
1	40336317	.	A	T	6	7	13	0	0	13	0	0
1	40336372	.	T	A	7	4	11	0	0	11	0	0
1	40336396	.	A	C	4	1	5	0	3	8	0	0
1	40336789	.	G	A	2	5	7	0	1	8	0	0
1	40337314	.	C	T	16	6	22	0	1	23	0	0
1	40337464	.	C	A	0	9	9	0	8	17	0	0
1	40340571	.	C	T	6	6	12	0	2	14	0	0
1	40340598	.	C	T	4	8	12	0	1	13	0	0
1	40410608	.	C	T	3	6	9	0	5	14	0	0
1	40410839	.	A	T	11	7	18	0	2	20	0	0
1	40410908	.	C	T	7	9	16	0	1	17	0	0
1	40411091	.	T	A	6	9	15	0	2	17	0	0
1	40411928	.	T	C	9	8	17	0	0	17	0	0
1	40567094	.	G	A	7	9	16	0	3	19	0	0
1	40568601	.	G	A	6	13	19	0	1	20	0	0
1	40568707	.	A	G	13	0	13	0	9	22	0	0
1	40568883	.	G	A	1	11	12	0	16	28	0	0
1	40568990	.	A	G	17	11	28	0	3	31	0	0
1	40569153	.	C	T	12	5	17	0	0	17	0	0
1	40569168	.	C	T	13	7	20	0	0	20	0	0
1	40569231	.	G	A	14	13	27	0	1	28	0	0
1	40569295	.	A	T	10	10	20	0	0	20	0	0
1	40569386	.	T	A	18	10	28	2	0	30	0	0
1	40569466	.	A	T	15	15	30	0	2	32	0	0
1	40569538	.	G	A	12	7	19	0	0	19	0	0
1	40569548	.	T	C	11	5	16	0	1	17	0	0
1	40573703	.	G	T	21	17	38	0	2	40	0	0
1	40590967	.	T	G	23	25	48	0	1	49	0	0
1	40591262	.	T	C	24	22	46	0	1	47	0	0
1	40591272	.	T	C	24	22	46	0	1	47	0	0
1	40594373	.	C	T	14	19	33	0	2	35	0	0
1	40594415	.	C	T	1	17	18	0	12	30	0	0
1	40594517	.	T	C	21	0	21	0	17	38	0	0
1	40594526	.	G	A	21	15	36	0	2	38	0	0
1	40597332	.	A	C	12	0	12	0	20	32	0	0
1	40600992	.	A	T	14	11	25	0	3	28	0	0
1	40601547	.	G	A	15	17	32	0	3	35	0	0
1	40601595	.	G	C	12	1	13	0	10	23	0	0
1	40618861	.	C	T	6	8	14	0	1	15	0	0
1	40627291	.	G	A	6	5	11	0	0	11	0	0
1	40638246	.	A	T	4	8	12	0	2	14	0	0
1	40794437	.	T	C	3	2	5	0	0	5	0	0
1	40795231	.	A	T	1	3	4	0	0	4	0	0
1	40796779	.	G	T	4	3	7	0	0	7	0	0
1	40796791	.	G	A	3	4	7	0	2	9	0	0
1	40796942	.	C	T	3	2	5	0	0	5	0	0
1	40797178	.	C	T	2	3	5	0	0	5	0	0
1	40799492	.	A	G	3	2	5	0	0	5	0	0
1	40910231	.	T	C	3	3	6	0	0	6	0	0
1	40992716	.	T	A	9	8	17	0	1	18	0	0
1	40992823	.	A	G	8	15	23	0	0	23	0	0
1	40992878	.	C	G	7	3	10	0	0	10	0	0
1	40993349	.	C	T	3	7	10	0	15	25	0	0
1	40993714	.	G	A	6	3	9	0	0	9	0	0
1	40994068	.	T	A	4	3	7	0	0	7	0	0
1	41131608	.	C	T	13	17	30	1	0	31	0	0
1	41133944	.	G	A	9	10	19	0	2	21	0	0
1	41136245	.	T	C	13	14	27	0	1	28	0	0
1	41138638	.	A	G	10	15	25	0	2	27	0	0
1	41138641	.	C	T	16	12	28	0	0	28	0	0
1	41140465	.	T	C	11	16	27	0	1	28	0	0
1	41140640	.	C	T	12	11	23	0	0	23	0	0
1	41215289	.	T	A	12	10	22	0	3	25	0	0
1	41215312	.	T	G	14	12	26	0	2	28	0	0
1	41215547	.	G	A	11	10	21	0	0	21	0	0
1	41215746	.	T	A	16	9	25	0	0	25	0	0
1	41215868	.	T	G	12	7	19	0	0	19	0	0
1	41215869	.	G	T	7	11	18	0	1	19	0	0
1	41215998	.	T	C	14	4	18	0	0	18	0	0
1	41222341	.	T	C	3	7	10	0	1	11	0	0
1	41230927	.	C	T	6	4	10	0	0	10	0	0
1	41294719	.	A	G	5	12	17	0	2	19	0	0
1	41294760	.	T	C	9	8	17	0	0	17	0	0
1	41294790	.	G	T	9	5	14	0	1	15	0	0
1	41297453	.	C	T	1	9	10	0	11	21	0	0
1	41297495	.	G	A	13	9	22	0	1	23	0	0
1	41297561	.	C	T	13	10	23	0	1	24	0	0
1	41297564	.	A	T	12	13	25	0	0	25	0	0
1	41300133	.	C	T	13	7	20	0	1	21	0	0
1	41309208	.	C	G	8	11	19	0	0	19	0	0
1	41310074	.	A	G	6	4	10	0	0	10	0	0
1	41312210	.	G	A	4	5	9	0	0	9	0	0
1	41318203	.	T	G	6	4	10	0	0	10	0	0
1	41320781	.	A	G	4	9	13	0	0	13	0	0
1	41324327	.	C	T	0	3	3	0	10	13	0	0
1	41324444	.	C	T	0	6	6	0	3	9	0	0
1	41327484	.	A	T	2	2	4	0	0	4	0	0
1	41330594	.	G	C	9	7	16	0	0	16	0	0
1	41331692	.	G	A	4	4	8	0	0	8	0	0
1	41332989	.	T	C	3	1	4	0	5	9	0	0
1	41333321	.	A	G	3	3	6	0	0	6	0	0
1	41333503	.	A	G	1	4	5	0	1	6	0	0
1	41335135	.	G	A	3	6	9	0	2	11	0	0
1	41335147	.	T	A	4	5	9	0	0	9	0	0
1	41335270	.	G	A	4	3	7	0	0	7	0	0
1	41337314	.	G	A	3	2	5	0	0	5	0	0
1	41339963	.	C	T	0	4	4	0	4	8	0	0
1	41340128	.	C	G	2	2	4	0	0	4	0	0
1	41340133	.	T	G	1	2	3	0	0	3	0	0
1	41352634	.	G	C	3	2	5	0	0	5	0	0
1	41360074	.	A	G	2	4	6	0	0	6	0	0
1	41374028	.	G	T	1	2	3	0	0	3	0	0
1	41470524	.	T	C	26	22	48	0	1	49	0	0
1	41471129	.	A	T	9	3	12	0	0	12	0	0
1	41471529	.	T	C	29	20	49	0	1	50	0	0
1	41487459	.	C	A	3	4	7	0	1	8	0	0
1	41487811	.	C	T	5	3	8	0	0	8	0	0
1	41487960	.	A	T	2	3	5	0	0	5	0	0
1	41487973	.	T	C	1	4	5	0	0	5	0	0
1	41488030	.	T	C	2	3	5	0	0	5	0	0
1	41488643	.	A	C	4	3	7	0	0	7	0	0
1	41489068	.	C	T	2	4	6	0	0	6	0	0
1	41489274	.	G	C	1	2	3	0	0	3	0	0
1	41489343	.	G	A	2	2	4	0	0	4	0	0
1	41489433	.	C	T	2	2	4	0	0	4	0	0
1	41512895	.	C	T	4	2	6	0	0	6	0	0
1	41513332	.	G	A	4	5	9	0	1	10	0	0
1	41513497	.	G	A	5	9	14	0	0	14	0	0
1	41530370	.	C	T	6	2	8	0	0	8	0	0
1	41596182	.	A	G	3	5	8	0	0	8	0	0
1	41596199	.	A	G	3	4	7	0	0	7	0	0
1	41596220	.	A	G	0	0	0	0	6	6	0	0
1	41596291	.	C	T	4	7	11	0	0	11	0	0
1	41600339	.	T	C	5	3	8	0	0	8	0	0
1	41600533	.	A	G	2	2	4	0	0	4	0	0
1	41604931	.	C	G	5	0	5	0	6	11	0	0
1	41604934	.	C	G	5	0	5	0	6	11	0	0
1	41604985	.	G	A	0	2	2	0	5	7	0	0
1	41605011	.	T	C	4	6	10	0	0	10	0	0
1	41605065	.	C	A	8	4	12	0	0	12	0	0
1	41605203	.	C	T	4	6	10	0	0	10	0	0
1	41605675	.	G	A	6	3	9	0	0	9	0	0
1	41615874	.	C	T	5	5	10	0	2	12	0	0
1	41615904	.	T	C	6	5	11	0	0	11	0	0
1	41615949	.	T	C	2	8	10	0	0	10	0	0
1	41616081	.	T	G	7	4	11	0	0	11	0	0
1	41616186	.	A	C	5	6	11	0	0	11	0	0
1	41616902	.	A	T	2	3	5	0	1	6	0	0
1	41690506	.	C	T	8	11	19	0	0	19	0	0
1	41730609	.	C	T	12	17	29	0	1	30	0	0
1	41730669	.	G	A	16	16	32	0	1	33	0	0
1	41744103	.	C	T	12	10	22	0	1	23	0	0
1	41755157	.	C	T	14	14	28	0	0	28	0	0
1	41755158	.	A	T	14	14	28	0	0	28	0	0
1	41755195	.	C	T	18	11	29	0	1	30	0	0
1	41770847	.	T	A	6	16	22	0	1	24	1	0
1	41770872	.	T	C	17	10	27	0	0	27	0	0
1	41770959	.	T	C	7	5	12	0	1	13	0	0
1	41817556	.	G	A	2	4	6	0	1	7	0	0
1	41817574	.	T	C	4	3	7	0	0	7	0	0
1	41849293	.	A	G	11	7	18	0	1	19	0	0
1	41849310	.	A	G	10	15	25	0	2	27	0	0
1	41865471	.	C	T	28	27	55	0	1	56	0	0
1	41958356	.	C	T	1	3	4	0	0	4	0	0
1	42375005	.	C	A	11	8	19	0	1	20	0	0
1	42375071	.	C	T	11	13	24	0	2	26	0	0
1	42386349	.	T	C	5	9	14	0	0	14	0	0
1	42386364	.	C	A	5	8	13	0	0	13	0	0
1	42388351	.	T	C	8	8	16	0	0	16	0	0
1	42391172	.	T	C	7	7	14	0	1	15	0	0
1	42391194	.	T	C	7	8	15	0	0	15	0	0
1	42391214	.	G	A	5	9	14	0	1	15	0	0
1	42776652	.	T	C	23	17	40	0	1	41	0	0
1	42776787	.	C	T	1	16	17	0	13	30	0	0
1	42776806	.	A	T	17	13	30	0	3	33	0	0
1	42776853	.	T	C	25	17	42	0	0	42	0	0
1	42776906	.	A	G	26	15	41	0	0	41	0	0
1	42777116	.	G	A	10	19	29	0	1	30	0	0
1	42777146	.	C	G	3	17	20	0	11	31	0	0
1	42777383	.	A	G	20	14	34	0	3	37	0	0
1	42777593	.	T	G	12	12	24	0	0	24	0	0
1	42777674	.	G	A	11	12	23	0	0	23	0	0
1	42882955	.	C	T	7	7	14	0	2	16	0	0
1	43023630	.	G	A	17	12	29	0	1	30	0	0
1	43034947	.	C	T	23	19	42	0	1	43	0	0
1	43035178	.	T	C	14	18	32	0	0	32	0	0
1	43035546	.	T	A	10	3	13	0	0	13	0	0
1	44209059	.	C	T	4	2	6	0	0	6	0	0
1	44571206	.	C	T	0	19	19	0	4	23	0	0
1	44571352	.	T	C	13	4	17	0	1	18	0	0
1	45016216	.	G	A	6	2	8	1	1	10	0	0
1	45016221	.	G	T	7	3	10	1	0	11	0	0
1	45094987	.	G	A	1	6	7	0	1	8	0	0
1	45095019	.	T	C	7	4	11	6	0	17	0	0
1	45095150	.	C	A	3	21	24	1	2	27	0	0
1	45743268	.	A	G	2	0	2	0	4	6	0	0
1	45833501	.	A	G	4	1	5	0	0	5	0	0
1	45833509	.	A	G	4	2	6	0	0	6	0	0
1	45835001	.	A	G	5	2	7	0	0	7	0	0
1	45868178	.	C	T	12	15	27	39	1	67	0	0
1	47120514	.	A	T	5	8	13	1	0	14	0	0
1	47120622	.	G	C	7	7	14	3	1	18	0	0
1	47120627	.	C	T	7	9	16	3	0	19	0	0
1	48470316	.	G	A	1	4	5	0	0	5	0	0
1	48474316	.	T	C	1	3	4	0	0	4	0	0
1	48486543	.	A	G	2	2	4	0	0	4	0	0
1	48486962	.	G	A	1	2	3	0	1	4	0	0
1	48487228	.	T	C	1	2	3	0	0	3	0	0
1	48487671	.	G	A	0	2	2	0	1	3	0	0
1	48487729	.	T	A	2	4	6	0	0	6	0	0
1	48488243	.	T	G	7	4	11	0	1	12	0	0
1	48488362	.	T	A	4	4	8	0	0	8	0	0
1	48488377	.	G	A	2	5	7	0	4	11	0	0
1	48488398	.	C	T	5	5	10	0	0	10	0	0
1	48488436	.	C	T	9	4	13	0	0	13	0	0
1	48488496	.	C	T	4	5	9	0	2	11	0	0
1	48488619	.	A	C	1	4	5	0	0	5	0	0
1	48489123	.	G	T	2	4	6	0	0	6	0	0
1	48581919	.	C	T	5	4	9	0	2	11	0	0
1	48583000	.	T	C	8	7	15	0	1	16	0	0
1	48583057	.	C	A	5	2	7	0	1	8	0	0
1	48583098	.	C	G	3	5	8	0	0	8	0	0
1	48583521	.	A	C	4	4	8	0	0	8	0	0
1	48583528	.	C	T	4	4	8	0	1	9	0	0
1	48583844	.	G	C	8	6	14	0	1	15	0	0
1	48587725	.	T	A	12	7	19	0	0	19	0	0
1	48607361	.	A	G	2	6	8	0	0	8	0	0
1	48614986	.	T	C	3	3	6	0	0	6	0	0
1	48921983	.	G	A	1	5	6	0	0	6	0	0
1	49271317	.	G	A	18	36	54	1	1	56	0	0
1	49289663	.	G	A	3	25	28	0	28	56	0	0
1	49293733	.	C	T	27	22	49	1	2	52	0	0
1	49293808	.	T	C	32	12	44	0	1	45	0	0
1	49293891	.	G	A	35	15	50	0	1	51	0	0
1	49293956	.	G	T	19	24	43	0	1	44	0	0
1	49293965	.	G	A	30	15	45	0	1	46	0	0
1	49294003	.	G	A	29	11	40	3	2	45	0	0
1	49294654	.	G	A	22	8	30	0	1	31	0	0
1	49294686	.	A	G	5	23	28	0	1	29	0	0
1	49294727	.	G	C	9	21	30	0	1	32	1	0
1	49294765	.	T	C	16	18	34	0	0	34	0	0
1	49374392	.	A	G	3	3	6	0	0	6	0	0
1	49379904	.	T	C	1	0	1	0	4	5	0	0
1	49409520	.	G	A	4	6	10	0	0	10	0	0
1	49418122	.	T	C	9	3	12	0	0	12	0	0
1	49418156	.	T	C	6	2	8	0	0	8	0	0
1	49420026	.	T	C	6	4	10	0	0	10	0	0
1	49420044	.	G	A	4	5	9	0	1	10	0	0
1	49420637	.	G	A	4	6	10	0	0	10	0	0
1	49420658	.	A	G	2	5	7	0	0	7	0	0
1	49423200	.	G	A	5	7	12	1	0	13	0	0
1	49424516	.	G	A	1	5	6	0	5	11	0	0
1	49424543	.	T	A	4	5	9	0	0	9	0	0
1	49425668	.	C	T	5	7	12	0	0	12	0	0
1	49425737	.	C	T	3	2	5	0	0	5	0	0
1	49427972	.	G	C	0	5	5	0	3	8	0	0
1	49429878	.	G	A	0	12	12	0	9	21	0	0
1	49429917	.	C	A	6	10	16	0	1	17	0	0
1	49429944	.	T	A	8	5	13	0	0	13	0	0
1	49447611	.	A	G	2	3	5	0	0	5	0	0
1	49457751	.	G	A	2	3	5	0	0	5	0	0
1	49461033	.	C	A	10	3	13	0	0	13	0	0
1	49461225	.	A	G	3	2	5	0	0	5	0	0
1	49466190	.	G	A	2	3	5	0	0	5	0	0
1	49473716	.	G	T	3	7	10	0	1	11	0	0
1	49473970	.	G	C	12	6	18	0	0	18	0	0
1	49474079	.	G	A	0	10	10	0	5	15	0	0
1	49474993	.	T	C	8	7	15	0	0	15	0	0
1	49474995	.	C	T	7	7	14	0	0	14	0	0
1	49475714	.	C	T	12	3	15	0	0	15	0	0
1	49475769	.	A	C	5	6	11	0	2	13	0	0
1	49480825	.	T	G	8	3	11	0	0	11	0	0
1	49481007	.	A	T	4	2	6	0	0	6	0	0
1	49481546	.	T	A	13	17	30	0	0	30	0	0
1	49481567	.	T	G	15	17	32	0	0	32	0	0
1	49481649	.	T	C	16	10	26	0	1	27	0	0
1	49481787	.	A	G	16	15	31	0	0	31	0	0
1	49481866	.	T	G	14	18	32	0	1	33	0	0
1	49481886	.	A	T	11	15	26	0	2	29	1	0
1	49482059	.	T	C	9	9	18	1	2	21	0	0
1	49482393	.	T	A	12	12	24	3	2	29	0	0
1	49482742	.	C	T	10	8	18	0	2	20	0	0
1	49482755	.	C	T	11	12	23	0	0	23	0	0
1	49482984	.	T	A	8	11	19	0	1	20	0	0
1	49483217	.	C	G	5	5	10	0	0	10	0	0
1	49483242	.	T	C	11	3	14	0	0	14	0	0
1	49483270	.	C	T	4	11	15	0	1	16	0	0
1	49483300	.	A	G	6	10	16	0	2	18	0	0
1	49483679	.	G	A	12	13	25	0	1	26	0	0
1	49483721	.	T	G	12	11	23	0	1	24	0	0
1	49483901	.	T	A	21	11	32	0	1	33	0	0
1	49484002	.	A	T	26	16	42	0	4	46	0	0
1	49484096	.	G	T	22	18	40	0	2	42	0	0
1	49484146	.	G	A	17	18	35	0	3	38	0	0
1	49492396	.	G	A	13	9	22	0	4	26	0	0
1	49497590	.	T	G	7	10	17	0	1	18	0	0
1	49606724	.	A	G	5	3	8	0	1	9	0	0
1	49606801	.	A	G	2	10	12	0	0	12	0	0
1	49607102	.	A	T	2	4	6	0	0	6	0	0
1	49607156	.	T	G	9	4	13	0	1	14	0	0
1	49607223	.	T	A	5	3	8	0	0	8	0	0
1	49607251	.	T	C	1	5	6	0	0	6	0	0
1	49607370	.	G	A	4	7	11	0	0	11	0	0
1	49607490	.	A	C	4	2	6	0	0	6	0	0
1	49607706	.	C	T	0	6	6	0	2	8	0	0
1	49607806	.	A	G	2	8	10	0	0	10	0	0
1	49607861	.	A	G	1	13	14	0	1	15	0	0
1	49608014	.	T	C	7	4	11	0	0	11	0	0
1	49608027	.	T	C	4	0	4	0	4	8	0	0
1	49608218	.	A	T	1	2	3	0	0	3	0	0
1	49608222	.	A	T	1	2	3	0	0	3	0	0
1	49608784	.	A	C	6	3	9	0	0	9	0	0
1	49608803	.	C	T	3	3	6	0	0	6	0	0
1	49609011	.	C	T	8	2	10	0	0	10	0	0
1	49609024	.	C	T	1	2	3	0	6	9	0	0
1	49609048	.	A	G	3	2	5	0	0	5	0	0
1	49609065	.	A	G	5	4	9	0	0	9	0	0
1	49609113	.	G	C	4	1	5	0	5	10	0	0
1	49609191	.	G	A	4	3	7	0	0	7	0	0
1	49609247	.	G	A	8	4	12	0	1	13	0	0
1	49613880	.	C	T	7	4	11	0	0	11	0	0
1	49626456	.	C	T	4	4	8	0	1	9	0	0
1	49626514	.	A	G	6	2	8	0	0	8	0	0
1	49627769	.	C	A	1	5	6	0	0	6	0	0
1	49648823	.	G	T	2	2	4	0	0	4	0	0
1	49648979	.	G	T	1	4	5	0	0	5	0	0
1	49648996	.	A	T	1	3	4	0	0	4	0	0
1	49649030	.	C	T	0	2	2	0	3	5	0	0
1	49693244	.	T	C	1	2	3	0	1	4	0	0
1	49693996	.	C	T	3	2	5	0	0	5	0	0
1	49694765	.	T	A	9	5	14	0	4	18	0	0
1	49694773	.	T	C	10	8	18	0	0	18	0	0
1	49696076	.	G	A	5	7	12	0	0	12	0	0
1	49814732	.	C	T	13	14	27	0	1	28	0	0
1	49814844	.	C	T	13	16	29	0	1	30	0	0
1	49869672	.	G	A	17	17	34	0	1	35	0	0
1	49903376	.	A	C	3	2	5	0	0	5	0	0
1	49909911	.	A	C	4	7	11	0	0	11	0	0
1	49910164	.	A	G	10	14	24	0	0	24	0	0
1	49910173	.	G	A	9	16	25	0	1	26	0	0
1	49912827	.	A	G	4	18	22	0	0	22	0	0
1	49912990	.	T	C	10	9	19	0	2	21	0	0
1	49913062	.	A	G	7	9	16	0	2	18	0	0
1	49913101	.	T	G	10	10	20	0	0	20	0	0
1	49913110	.	T	C	6	6	12	0	3	15	0	0
1	49915208	.	G	A	6	9	15	0	1	16	0	0
1	49915278	.	G	C	2	9	11	0	0	11	0	0
1	49918779	.	T	C	5	7	12	0	1	13	0	0
1	50178612	.	T	C	8	4	12	0	2	14	0	0
1	50178643	.	A	G	10	0	10	0	8	18	0	0
1	50178921	.	T	C	9	14	23	0	0	23	0	0
1	50178963	.	G	A	7	9	16	0	2	18	0	0
1	50178988	.	A	G	4	1	5	0	3	8	0	0
1	50183822	.	C	A	3	7	10	0	0	10	0	0
1	50187511	.	C	T	11	10	21	0	0	21	0	0
1	50187688	.	A	G	5	6	11	0	0	11	0	0
1	50187733	.	A	T	3	8	11	0	0	11	0	0
1	50187782	.	A	G	4	4	8	0	0	8	0	0
1	50198792	.	T	C	5	5	10	0	0	10	0	0
1	50199416	.	G	A	7	2	9	0	0	9	0	0
1	50265198	.	T	C	4	0	4	0	6	10	0	0
1	50270154	.	G	A	2	3	5	0	0	5	0	0
1	50270166	.	A	G	2	2	4	0	0	4	0	0
1	50270234	.	C	G	3	4	7	0	0	7	0	0
1	50270241	.	T	A	2	4	6	0	1	7	0	0
1	50270280	.	A	G	4	4	8	0	0	8	0	0
1	50272240	.	T	A	5	4	9	0	0	9	0	0
1	50273133	.	G	A	5	5	10	0	0	10	0	0
1	50284907	.	A	G	7	4	11	0	0	11	0	0
1	50303960	.	C	T	17	6	23	0	1	24	0	0
1	50317687	.	G	A	1	5	6	0	13	19	0	0
1	50317723	.	A	C	13	7	20	0	2	22	0	0
1	50437827	.	C	T	4	4	8	0	0	8	0	0
1	50437929	.	C	A	2	2	4	0	0	4	0	0
1	50437939	.	G	A	1	2	3	0	0	3	0	0
1	50487649	.	G	T	6	8	14	0	0	15	1	0
1	50487762	.	G	C	8	0	8	0	7	15	0	0
1	50487895	.	T	C	8	1	9	0	7	16	0	0
1	50487938	.	A	C	10	4	14	0	0	14	0	0
1	50503237	.	G	A	8	6	14	0	1	15	0	0
1	50519961	.	T	C	5	3	8	0	1	9	0	0
1	50554335	.	T	G	3	3	6	0	0	6	0	0
1	50554362	.	A	C	2	5	7	0	0	7	0	0
1	50566360	.	A	G	1	2	3	0	0	3	0	0
1	50594217	.	T	C	20	16	36	0	1	37	0	0
1	50594239	.	T	A	20	16	36	0	0	36	0	0
1	50594318	.	T	G	14	17	31	0	1	32	0	0
1	50594346	.	A	G	13	12	25	0	1	26	0	0
1	50594771	.	C	A	16	4	20	0	2	22	0	0
1	50594777	.	C	T	17	5	22	0	0	22	0	0
1	50595288	.	T	C	11	0	11	0	14	25	0	0
1	50595387	.	C	T	21	15	36	0	0	36	0	0
1	50595530	.	A	G	9	7	16	0	0	16	0	0
1	50595809	.	T	A	13	16	29	0	1	30	0	0
1	50596694	.	A	G	11	13	24	0	0	24	0	0
1	50596748	.	G	T	10	14	24	0	2	26	0	0
1	50598793	.	C	T	4	18	22	0	12	34	0	0
1	50598872	.	A	G	8	19	27	0	0	27	0	0
1	50608232	.	T	C	13	14	27	0	1	28	0	0
1	50608373	.	G	A	16	20	36	0	1	37	0	0
1	50608505	.	T	C	7	9	16	0	2	18	0	0
1	50608584	.	G	A	8	17	25	0	0	25	0	0
1	50608691	.	A	T	15	12	27	0	0	27	0	0
1	50608692	.	T	C	14	12	26	0	0	26	0	0
1	50610919	.	T	A	11	10	21	0	0	21	0	0
1	50646922	.	G	A	0	4	4	0	2	6	0	0
1	50652102	.	G	A	1	2	3	0	0	3	0	0
1	50656594	.	T	C	3	4	7	0	0	7	0	0
1	50657063	.	T	G	3	4	7	0	0	7	0	0
1	50657093	.	T	C	4	6	10	0	0	10	0	0
1	50659858	.	G	A	0	3	3	0	6	9	0	0
1	50666916	.	C	T	6	4	10	0	0	10	0	0
1	50666985	.	T	A	6	6	12	0	0	12	0	0
1	50668883	.	C	T	4	4	8	0	0	8	0	0
1	50668915	.	C	T	4	4	8	0	0	8	0	0
1	50670799	.	T	C	5	6	11	0	0	11	0	0
1	50673407	.	T	C	3	3	6	0	0	6	0	0
1	50688646	.	A	G	2	0	2	0	5	7	0	0
1	50688682	.	A	T	4	6	10	0	0	10	0	0
1	50691194	.	G	C	1	3	4	0	3	7	0	0
1	50694993	.	T	C	22	15	37	0	0	37	0	0
1	50694994	.	G	T	22	15	37	0	0	37	0	0
1	50698089	.	G	A	7	4	11	0	0	11	0	0
1	50702736	.	C	T	12	11	23	0	0	23	0	0
1	50703007	.	A	G	12	8	20	0	0	20	0	0
1	50805372	.	G	A	2	2	4	0	0	4	0	0
1	50808548	.	T	A	0	3	3	0	1	4	0	0
1	50808551	.	A	T	2	3	5	0	0	5	0	0
1	50813468	.	A	G	2	2	4	0	0	4	0	0
1	50848106	.	A	G	11	12	23	0	1	24	0	0
1	50848115	.	A	G	13	9	22	0	2	24	0	0
1	50848484	.	C	T	15	7	22	0	2	24	0	0
1	50848504	.	C	T	15	10	25	0	2	27	0	0
1	50848532	.	G	A	11	9	20	0	7	28	1	0
1	50848595	.	T	C	14	12	26	0	3	29	0	0
1	50848609	.	A	C	17	10	27	0	0	27	0	0
1	50848647	.	C	T	1	17	18	1	23	43	1	0
1	50848659	.	A	G	21	20	41	1	0	42	0	0
1	50848815	.	A	G	8	10	18	0	9	27	0	0
1	50848911	.	A	G	8	15	23	0	0	23	0	0
1	50848961	.	C	T	19	9	28	0	1	29	0	0
1	50849055	.	T	C	16	0	16	0	11	27	0	0
1	50849078	.	A	T	17	10	27	0	2	29	0	0
1	50849125	.	T	C	23	15	38	0	2	40	0	0
1	50849163	.	A	G	17	16	33	0	3	36	0	0
1	50849173	.	C	T	18	14	32	0	3	35	0	0
1	50849282	.	A	G	7	17	24	0	0	24	0	0
1	50849331	.	G	A	6	13	19	0	0	19	0	0
1	50849456	.	G	A	14	11	25	0	3	28	0	0
1	50849670	.	A	T	5	9	14	0	1	15	0	0
1	50849697	.	T	C	9	1	10	0	11	21	0	0
1	50849705	.	C	G	9	14	23	0	0	23	0	0
1	50849839	.	T	C	13	9	22	0	1	23	0	0
1	50849938	.	T	A	17	11	28	0	0	28	0	0
1	50849942	.	G	A	13	13	26	0	4	30	0	0
1	50850170	.	C	T	20	10	30	0	2	32	0	0
1	50858891	.	A	T	5	6	11	0	0	12	1	0
1	50929212	.	C	A	1	2	3	0	0	3	0	0
1	50968923	.	A	G	1	2	3	0	0	3	0	0
1	50969073	.	A	C	13	22	35	0	2	37	0	0
1	50969081	.	T	C	12	23	35	0	1	36	0	0
1	50969209	.	G	A	18	7	25	0	2	27	0	0
1	50976985	.	A	T	2	2	4	0	0	4	0	0
1	50977008	.	C	A	2	2	4	0	0	4	0	0
1	50977072	.	C	A	6	8	14	0	0	14	0	0
1	50979925	.	T	C	30	27	57	1	1	60	1	0
1	50983906	.	T	C	31	34	65	0	2	67	0	0
1	50986092	.	T	C	31	35	66	0	6	72	0	0
1	50986110	.	A	G	36	35	71	0	3	74	0	0
1	50986197	.	C	A	27	39	66	0	2	68	0	0
1	50987507	.	A	C	37	33	70	0	3	73	0	0
1	50987742	.	C	A	36	33	69	0	1	70	0	0
1	50990593	.	A	G	30	3	33	0	29	62	0	0
1	50990605	.	G	A	28	33	61	0	2	63	0	0
1	50990709	.	T	C	32	18	50	0	3	56	3	0
1	51015493	.	G	A	3	2	5	0	0	5	0	0
1	51015594	.	T	A	2	2	4	0	0	4	0	0
1	51021591	.	C	A	1	5	6	0	1	7	0	0
1	51021701	.	A	G	5	7	12	0	2	14	0	0
1	51021731	.	G	A	5	5	10	0	0	10	0	0
1	51023877	.	C	T	6	7	13	0	2	15	0	0
1	51024992	.	A	G	4	7	11	0	0	11	0	0
1	51029529	.	A	G	2	5	7	0	0	7	0	0
1	51031234	.	G	A	7	4	11	0	0	11	0	0
1	51038546	.	T	G	5	7	12	0	1	13	0	0
1	51038570	.	A	G	5	4	9	0	1	10	0	0
1	51040428	.	T	C	22	32	54	0	0	54	0	0
1	51041255	.	T	G	13	0	13	0	17	30	0	0
1	51042228	.	G	A	2	11	13	0	13	26	0	0
1	51042230	.	G	C	15	11	26	0	0	26	0	0
1	51049131	.	A	G	5	3	8	0	1	9	0	0
1	51056766	.	C	A	0	3	3	0	5	8	0	0
1	51073083	.	A	C	2	4	6	0	0	6	0	0
1	51073118	.	T	C	2	4	6	0	0	6	0	0
1	51105411	.	T	A	3	4	7	0	0	7	0	0
1	51105448	.	T	C	4	0	4	0	4	8	0	0
1	51105513	.	G	A	4	6	10	0	0	10	0	0
1	51110048	.	A	G	4	3	7	0	0	7	0	0
1	51192069	.	C	T	8	2	10	0	1	11	0	0
1	51192074	.	C	A	6	5	11	0	1	12	0	0
1	51196071	.	G	C	6	2	8	0	0	8	0	0
1	51196095	.	G	A	6	3	9	0	0	9	0	0
1	51196161	.	C	T	3	3	6	0	0	6	0	0
1	51196233	.	T	C	1	4	5	0	0	5	0	0
1	51196311	.	G	A	1	3	4	0	1	5	0	0
1	51196435	.	T	G	1	3	4	0	0	4	0	0
1	51196563	.	A	C	4	3	7	0	0	7	0	0
1	51196863	.	G	A	1	5	6	0	4	10	0	0
1	51197082	.	G	A	1	3	4	0	0	4	0	0
1	51197171	.	C	T	4	4	8	0	0	8	0	0
1	51197193	.	G	T	3	3	6	0	0	6	0	0
1	51197316	.	A	G	7	3	10	0	0	10	0	0
1	51207210	.	A	C	6	6	12	0	1	13	0	0
1	51210562	.	T	C	4	6	10	0	0	10	0	0
1	51211052	.	A	G	6	10	16	0	1	17	0	0
1	51211139	.	C	A	0	9	9	0	5	14	0	0
1	51211334	.	G	A	5	7	12	0	0	12	0	0
1	51211393	.	T	A	1	6	7	0	0	7	0	0
1	51211394	.	C	T	1	5	6	0	1	7	0	0
1	51215290	.	G	A	3	2	5	0	0	5	0	0
1	51215441	.	T	C	1	0	1	0	5	6	0	0
1	51217048	.	C	A	5	4	9	0	0	9	0	0
1	51217063	.	C	A	0	5	5	0	4	9	0	0
1	51217156	.	T	A	6	6	12	0	1	13	0	0
1	51217822	.	T	C	5	6	11	0	1	12	0	0
1	51217888	.	A	C	4	5	9	1	0	10	0	0
1	51221347	.	A	G	6	0	6	0	13	19	0	0
1	51221349	.	A	T	6	12	18	0	1	19	0	0
1	51229464	.	C	G	7	7	14	0	1	15	0	0
1	51229471	.	C	T	1	7	8	0	6	14	0	0
1	51230106	.	T	C	3	7	10	0	0	10	0	0
1	51230277	.	C	G	6	7	13	0	0	13	0	0
1	51230324	.	G	A	5	3	8	0	0	8	0	0
1	51230328	.	C	A	5	2	7	0	1	8	0	0
1	51230404	.	A	G	3	6	9	0	1	10	0	0
1	51230427	.	A	G	3	7	10	0	0	10	0	0
1	51230467	.	T	C	2	3	5	0	0	5	0	0
1	51230487	.	A	T	2	3	5	0	1	6	0	0
1	51230957	.	C	A	1	12	13	0	6	19	0	0
1	51233996	.	C	T	0	5	5	0	9	14	0	0
1	51242401	.	G	T	9	8	17	0	1	18	0	0
1	51244814	.	C	T	2	7	9	1	0	10	0	0
1	51246693	.	T	C	3	7	10	0	0	10	0	0
1	51262273	.	G	A	4	6	10	0	0	10	0	0
1	51263352	.	C	T	6	6	12	0	0	12	0	0
1	51263367	.	C	G	4	5	9	0	0	9	0	0
1	51264192	.	T	A	2	3	5	0	0	5	0	0
1	51264198	.	A	G	2	3	5	0	0	5	0	0
1	51264261	.	C	T	1	3	4	0	0	4	0	0
1	51264981	.	G	T	2	5	7	0	0	7	0	0
1	51266226	.	G	A	3	4	7	0	0	7	0	0
1	51349146	.	G	A	0	9	9	0	2	11	0	0
1	51355086	.	G	A	3	4	7	0	0	7	0	0
1	51365905	.	T	G	3	4	7	0	0	7	0	0
1	51366000	.	A	C	3	2	5	0	1	6	0	0
1	51368758	.	T	G	4	4	8	0	0	8	0	0
1	51368776	.	C	A	4	4	8	0	0	8	0	0
1	51369612	.	A	G	6	4	10	0	0	10	0	0
1	51371090	.	G	A	3	5	8	0	1	9	0	0
1	51371165	.	T	C	4	3	7	0	0	7	0	0
1	51371166	.	A	C	4	3	7	0	0	7	0	0
1	51372625	.	C	T	8	6	14	0	1	15	0	0
1	51372688	.	C	T	7	3	10	0	0	10	0	0
1	51374087	.	G	A	4	3	7	0	0	7	0	0
1	51374844	.	C	T	6	10	16	0	0	16	0	0
1	51374905	.	A	G	8	7	15	0	0	15	0	0
1	51374976	.	G	A	8	6	14	0	0	14	0	0
1	51375006	.	C	G	4	8	12	0	2	14	0	0
1	51375149	.	T	C	3	4	7	0	0	7	0	0
1	51375170	.	A	T	4	4	8	0	0	8	0	0
1	51375361	.	C	A	3	9	12	0	0	12	0	0
1	51377558	.	T	C	5	5	10	0	1	11	0	0
1	51377708	.	C	A	6	10	16	0	1	17	0	0
1	51377781	.	A	C	8	11	19	0	6	25	0	0
1	51386764	.	C	G	4	6	10	0	0	10	0	0
1	51395366	.	G	T	6	2	8	0	0	8	0	0
1	51395384	.	A	G	4	2	6	0	0	6	0	0
1	51397595	.	C	T	7	3	10	0	0	10	0	0
1	51397596	.	A	C	7	3	10	0	0	10	0	0
1	51397646	.	C	T	3	4	7	0	0	7	0	0
1	51397677	.	G	A	2	3	5	0	1	6	0	0
1	51397713	.	C	A	4	3	7	0	0	7	0	0
1	51397730	.	T	C	8	5	13	0	0	13	0	0
1	51398024	.	C	T	7	11	18	0	1	19	0	0
1	51398373	.	T	C	5	8	13	0	0	13	0	0
1	51400205	.	T	C	6	9	15	0	0	15	0	0
1	51403499	.	C	A	6	5	11	0	1	12	0	0
1	51403544	.	G	C	5	5	10	0	0	10	0	0
1	51403562	.	C	T	7	3	10	0	0	10	0	0
1	51403599	.	T	A	7	2	9	0	0	9	0	0
1	51403756	.	T	A	5	11	16	0	0	16	0	0
1	51403763	.	C	A	5	7	12	0	0	12	0	0
1	51404181	.	T	A	3	4	7	0	1	8	0	0
1	51404638	.	G	A	0	2	2	0	1	3	0	0
1	51404941	.	A	G	5	2	7	0	1	13	5	0
1	51405087	.	C	T	9	3	12	0	0	12	0	0
1	51405636	.	A	C	3	3	6	0	0	6	0	0
1	51405684	.	G	A	1	5	6	0	3	9	0	0
1	51405721	.	G	A	5	2	7	1	1	9	0	0
1	51405986	.	G	T	14	7	21	0	0	21	0	0
1	51406142	.	G	A	4	9	13	0	1	14	0	0
1	51406191	.	G	A	1	4	5	0	13	18	0	0
1	51406288	.	C	T	8	7	15	0	0	15	0	0
1	51406358	.	A	C	4	4	8	0	0	8	0	0
1	51406371	.	T	G	3	3	6	0	0	6	0	0
1	51406425	.	A	C	2	4	6	0	0	6	0	0
1	51406450	.	G	A	3	3	6	0	1	7	0	0
1	51416963	.	C	T	8	16	24	0	1	25	0	0
1	51424779	.	A	T	6	11	17	0	0	17	0	0
1	51424813	.	G	A	0	8	8	0	6	14	0	0
1	51424937	.	T	A	3	7	10	1	0	12	1	0
1	51425296	.	G	A	5	7	12	0	1	13	0	0
1	51425476	.	T	A	2	5	7	0	0	7	0	0
1	51426134	.	T	G	1	2	3	0	0	3	0	0
1	51426834	.	A	T	1	2	3	0	0	3	0	0
1	51426859	.	C	A	1	2	3	0	0	3	0	0
1	51426956	.	T	C	2	4	6	1	0	7	0	0
1	51427231	.	A	G	20	0	20	0	13	33	0	0
1	51427671	.	G	T	16	11	27	0	2	29	0	0
1	51427981	.	T	C	14	12	26	0	1	27	0	0
1	51444718	.	G	A	7	9	16	0	0	16	0	0
1	51445120	.	A	T	9	14	23	0	3	26	0	0
1	51445140	.	T	G	10	13	23	0	2	25	0	0
1	51445217	.	A	T	9	6	15	0	1	16	0	0
1	51445450	.	A	T	13	5	18	0	1	19	0	0
1	51445628	.	A	G	8	7	15	0	1	16	0	0
1	51445777	.	T	A	15	8	23	0	0	23	0	0
1	51446030	.	C	A	12	7	19	0	0	19	0	0
1	51446195	.	T	C	9	0	9	0	7	16	0	0
1	51446230	.	T	A	4	6	10	0	0	10	0	0
1	51446287	.	C	T	4	3	7	0	0	7	0	0
1	51446366	.	T	C	4	5	9	0	1	10	0	0
1	51446451	.	C	T	4	9	13	0	1	14	0	0
1	51446728	.	A	C	0	2	2	0	1	4	1	0
1	51446962	.	C	T	7	2	9	0	1	10	0	0
1	51446969	.	A	C	6	2	8	0	0	8	0	0
1	51447506	.	T	C	6	4	10	0	0	10	0	0
1	51447573	.	C	T	4	6	10	0	0	11	1	0
1	51447884	.	T	G	2	5	7	0	0	7	0	0
1	51448105	.	A	G	3	2	5	0	0	5	0	0
1	51448367	.	A	G	6	2	8	0	1	9	0	0
1	51448485	.	C	T	8	11	19	0	0	19	0	0
1	51448603	.	C	A	9	6	15	0	0	15	0	0
1	51448635	.	T	C	8	5	13	0	1	14	0	0
1	51448696	.	C	A	4	4	8	0	0	8	0	0
1	51448807	.	C	T	3	7	10	0	1	11	0	0
1	51448810	.	C	T	2	7	9	0	1	10	0	0
1	51449354	.	G	A	2	3	5	0	0	5	0	0
1	51449543	.	G	A	3	3	6	0	0	6	0	0
1	51449556	.	G	A	4	3	7	0	0	7	0	0
1	51449673	.	G	C	10	5	15	0	0	15	0	0
1	51449895	.	T	C	6	3	9	0	1	10	0	0
1	51450018	.	C	T	0	2	2	0	5	7	0	0
1	51450713	.	G	A	7	9	16	0	0	16	0	0
1	51558008	.	T	C	21	16	37	0	2	39	0	0
1	51558036	.	G	A	21	10	31	0	3	34	0	0
1	51558463	.	G	A	34	16	50	0	1	51	0	0
1	51558604	.	C	T	20	23	43	0	5	48	0	0
1	51558730	.	G	T	16	23	39	0	4	43	0	0
1	51558903	.	A	C	20	22	42	0	0	42	0	0
1	51559060	.	C	G	25	29	54	0	7	61	0	0
1	51562800	.	A	G	32	21	53	1	2	56	0	0
1	51567367	.	A	G	22	21	43	0	0	43	0	0
1	51591352	.	A	G	23	20	43	0	3	46	0	0
1	51594068	.	A	C	14	11	25	0	1	26	0	0
1	51594447	.	A	G	17	15	32	0	2	34	0	0
1	51594453	.	A	G	20	14	34	0	1	35	0	0
1	51594485	.	A	C	16	14	30	0	1	31	0	0
1	51594883	.	C	T	1	14	15	0	22	37	0	0
1	51608856	.	C	A	6	6	12	0	1	13	0	0
1	51609002	.	A	T	19	19	38	0	1	39	0	0
1	51612371	.	G	T	22	20	42	0	1	43	0	0
1	51612408	.	C	G	20	21	41	0	0	41	0	0
1	51615110	.	T	C	19	1	20	0	20	40	0	0
1	51615436	.	G	T	5	7	12	0	0	12	0	0
1	51627122	.	T	A	4	2	6	0	0	6	0	0
1	51627123	.	A	T	4	2	6	0	0	6	0	0
1	51673380	.	G	T	2	2	4	0	0	4	0	0
1	51702154	.	A	G	6	2	8	0	0	8	0	0
1	51703824	.	C	T	6	6	12	0	1	13	0	0
1	51709481	.	G	A	8	6	14	0	0	14	0	0
1	51712919	.	G	T	3	2	5	0	0	5	0	0
1	51712934	.	G	A	4	5	9	0	0	9	0	0
1	51712960	.	G	A	4	5	9	0	0	9	0	0
1	51712983	.	A	G	4	5	9	0	0	9	0	0
1	51713077	.	G	A	6	3	9	0	1	10	0	0
1	51713468	.	C	T	6	3	9	0	0	9	0	0
1	51718980	.	A	G	5	5	10	0	0	10	0	0
1	51719005	.	G	A	6	8	14	0	0	14	0	0
1	51719037	.	A	C	5	0	5	0	5	10	0	0
1	51721923	.	T	G	19	17	36	0	0	37	1	0
1	51723093	.	T	G	20	0	20	1	24	45	0	0
1	51723440	.	T	C	16	29	45	0	2	47	0	0
1	51723461	.	A	T	20	31	51	0	2	53	0	0
1	51726524	.	C	T	25	26	51	0	1	52	0	0
1	51727432	.	C	A	26	14	40	0	5	46	1	0
1	51729506	.	C	T	37	15	52	0	2	54	0	0
1	51729572	.	A	G	24	0	24	0	18	42	0	0
1	51729605	.	G	A	25	11	36	0	0	36	0	0
1	51729608	.	G	T	23	9	32	0	2	34	0	0
1	51729750	.	C	A	13	15	28	0	1	29	0	0
1	51729825	.	C	T	5	3	8	0	1	9	0	0
1	51733129	.	T	A	8	6	14	0	1	15	0	0
1	51733284	.	T	A	15	9	24	0	0	24	0	0
1	51734087	.	T	C	14	11	25	0	0	25	0	0
1	51734449	.	C	T	0	17	17	0	12	29	0	0
1	51876733	.	G	T	4	4	8	0	0	8	0	0
1	51896185	.	A	G	2	0	2	0	3	5	0	0
1	51960576	.	G	C	6	6	12	0	0	12	0	0
1	51960615	.	T	C	5	5	10	0	1	11	0	0
1	51961020	.	T	C	8	9	17	0	0	17	0	0
1	52073807	.	C	G	18	13	31	0	1	32	0	0
1	52150674	.	A	G	15	5	20	0	0	20	0	0
1	52150974	.	A	G	14	5	19	0	0	19	0	0
1	52151387	.	A	G	2	5	7	0	0	7	0	0
1	52151985	.	A	G	3	11	14	0	0	14	0	0
1	52152043	.	A	G	6	5	11	0	0	11	0	0
1	52152046	.	A	G	8	4	12	0	0	12	0	0
1	52452275	.	G	T	7	8	15	0	2	17	0	0
1	52452332	.	C	T	8	9	17	0	0	17	0	0
1	52455908	.	G	A	11	6	17	0	1	18	0	0
1	52455960	.	C	T	8	12	20	0	1	21	0	0
1	52456002	.	G	A	9	11	20	0	0	20	0	0
1	52460737	.	C	T	12	3	15	0	2	17	0	0
1	52460739	.	T	C	13	3	16	0	2	18	0	0
1	52460906	.	T	C	7	6	13	2	0	15	0	0
1	52460944	.	G	T	4	12	16	0	1	17	0	0
1	52465412	.	C	T	1	3	4	0	1	5	0	0
1	52474335	.	G	A	1	2	3	0	2	5	0	0
1	52476026	.	C	T	2	7	9	0	0	9	0	0
1	52476041	.	T	C	0	7	7	0	0	7	0	0
1	52478381	.	C	T	2	5	7	0	0	7	0	0
1	52482703	.	G	A	3	3	6	0	1	7	0	0
1	52482720	.	G	A	2	5	7	0	0	7	0	0
1	52482756	.	C	T	1	6	7	0	0	7	0	0
1	52483416	.	A	T	5	2	7	0	0	7	0	0
1	52485177	.	G	A	0	3	3	0	1	4	0	0
1	52486008	.	G	A	0	4	4	0	4	8	0	0
1	52486125	.	T	C	11	5	16	0	0	16	0	0
1	52486198	.	A	G	10	0	10	0	11	21	0	0
1	52486209	.	A	G	9	11	20	0	3	23	0	0
1	52489974	.	G	A	0	6	6	0	4	10	0	0
1	52492427	.	A	G	1	2	3	0	0	3	0	0
1	52495004	.	T	A	3	2	5	2	0	7	0	0
1	52495045	.	C	T	3	2	5	0	4	9	0	0
1	52495082	.	C	G	1	3	4	0	0	4	0	0
1	52495088	.	G	A	1	3	4	0	0	4	0	0
1	52501213	.	A	C	5	0	5	0	4	9	0	0
1	52535611	.	C	T	3	2	5	0	0	5	0	0
1	52535623	.	C	T	1	2	3	0	1	4	0	0
1	52538170	.	G	T	3	3	6	0	0	6	0	0
1	52560607	.	G	A	1	2	3	0	3	6	0	0
1	52577777	.	G	A	4	4	8	0	0	8	0	0
1	52595043	.	C	A	5	3	8	0	0	8	0	0
1	52598538	.	C	T	3	4	7	0	0	7	0	0
1	52598549	.	A	G	3	2	5	0	1	6	0	0
1	52599189	.	G	A	1	3	4	0	4	8	0	0
1	52600378	.	T	C	3	2	5	0	0	5	0	0
1	52603345	.	T	C	5	5	10	0	0	10	0	0
1	52609221	.	G	A	8	6	14	0	2	16	0	0
1	52609347	.	C	T	9	4	13	0	1	14	0	0
1	52609392	.	C	T	7	5	12	0	0	12	0	0
1	52609654	.	T	G	3	1	4	0	7	11	0	0
1	52610546	.	C	G	4	0	4	0	5	9	0	0
1	52610788	.	G	A	11	5	16	0	2	18	0	0
1	52611963	.	A	G	6	6	12	0	0	12	0	0
1	52612987	.	T	C	7	8	15	0	0	15	0	0
1	52614253	.	C	T	7	10	17	0	0	17	0	0
1	52614926	.	T	A	8	13	21	0	0	21	0	0
1	52615031	.	C	T	8	7	15	0	1	16	0	0
1	52618138	.	G	A	0	11	11	0	8	19	0	0
1	52618168	.	G	A	1	9	10	0	8	18	0	0
1	52618204	.	T	C	13	10	23	0	1	24	0	0
1	52621542	.	C	T	6	15	21	0	1	22	0	0
1	52621545	.	C	T	7	15	22	0	2	24	0	0
1	52623591	.	G	A	16	8	24	0	2	26	0	0
1	52623681	.	G	A	10	16	26	0	2	28	0	0
1	52623783	.	C	T	12	15	27	0	0	27	0	0
1	52625807	.	C	T	7	5	12	4	0	16	0	0
1	52626360	.	T	A	11	8	19	0	3	22	0	0
1	52626704	.	A	G	7	4	11	0	1	12	0	0
1	52626782	.	A	T	10	7	17	0	0	17	0	0
1	52626790	.	C	T	9	6	15	0	1	16	0	0
1	52626857	.	A	G	6	0	6	0	9	15	0	0
1	52626865	.	C	T	9	6	15	0	0	15	0	0
1	52626998	.	A	T	14	3	17	0	0	17	0	0
1	52627007	.	T	G	15	3	18	0	1	19	0	0
1	52627044	.	T	G	20	7	27	0	1	28	0	0
1	52627290	.	C	T	17	6	23	2	1	26	0	0
1	52627301	.	T	C	13	9	22	1	1	24	0	0
1	52627568	.	A	T	25	17	42	2	0	44	0	0
1	52627697	.	T	G	17	18	35	0	1	36	0	0
1	52628178	.	G	A	2	7	9	1	16	26	0	0
1	52628205	.	T	C	14	10	24	0	0	24	0	0
1	52628322	.	A	T	6	10	16	0	0	16	0	0
1	52646627	.	C	T	1	3	4	0	1	5	0	0
1	52649141	.	T	C	2	5	7	0	0	7	0	0
1	52651276	.	C	T	1	3	4	0	0	4	0	0
1	52658972	.	C	A	1	3	4	0	4	8	0	0
1	52659620	.	G	C	3	2	5	0	0	5	0	0
1	52659643	.	T	C	4	2	6	0	0	6	0	0
1	52673464	.	A	T	7	2	9	0	1	10	0	0
1	52676405	.	A	G	7	7	14	0	1	15	0	0
1	52679960	.	G	A	1	3	4	0	0	4	0	0
1	52680016	.	C	T	4	3	7	0	0	7	0	0
1	52682847	.	C	T	4	4	8	0	0	8	0	0
1	52682850	.	T	C	4	5	9	0	0	9	0	0
1	52685145	.	A	C	12	6	18	0	1	19	0	0
1	52688223	.	G	A	1	6	7	0	8	15	0	0
1	52688274	.	G	A	7	6	13	0	0	13	0	0
1	52688355	.	C	T	16	6	22	0	1	23	0	0
1	52698955	.	C	T	14	13	27	1	1	29	0	0
1	52764873	.	G	T	9	7	16	0	0	16	0	0
1	52765120	.	T	A	6	13	19	0	0	19	0	0
1	52773239	.	G	A	14	16	30	0	1	31	0	0
1	52780566	.	C	T	15	8	23	0	0	23	0	0
1	52782090	.	C	T	18	5	23	0	1	24	0	0
1	52784483	.	C	A	7	13	20	0	0	20	0	0
1	52784527	.	C	T	0	6	6	0	12	18	0	0
1	52784600	.	G	A	5	2	7	0	0	7	0	0
1	52784624	.	T	A	7	4	11	0	0	11	0	0
1	52784679	.	G	C	7	4	11	0	0	11	0	0
1	52784702	.	G	A	9	8	17	0	0	17	0	0
1	52792557	.	A	T	4	8	12	0	2	14	0	0
1	52792564	.	A	T	2	9	11	0	1	12	0	0
1	52792613	.	C	A	4	8	12	0	0	12	0	0
1	52794568	.	T	C	5	8	13	0	0	13	0	0
1	52796142	.	T	C	6	8	14	0	1	15	0	0
1	52796148	.	A	G	5	9	14	0	0	14	0	0
1	52796844	.	T	G	7	8	15	0	1	16	0	0
1	52796850	.	C	T	7	6	13	0	0	13	0	0
1	52797110	.	C	T	4	5	9	0	1	10	0	0
1	52797239	.	C	T	2	9	11	0	0	11	0	0
1	52798991	.	T	C	9	10	19	0	0	19	0	0
1	52798994	.	C	T	8	7	15	0	3	18	0	0
1	52800088	.	A	C	7	5	12	0	0	12	0	0
1	52811937	.	A	T	10	8	18	0	1	19	0	0
1	52811940	.	C	T	9	9	18	0	0	18	0	0
1	52812162	.	G	A	10	18	28	0	0	28	0	0
1	52816085	.	G	A	9	9	18	0	5	23	0	0
1	52816438	.	C	T	9	19	28	0	0	28	0	0
1	52816740	.	A	T	16	17	33	0	2	35	0	0
1	52816749	.	G	A	2	15	17	0	15	32	0	0
1	52817949	.	C	G	17	15	32	0	3	35	0	0
1	52817988	.	C	T	13	22	35	0	3	38	0	0
1	52820489	.	C	T	17	18	35	0	5	40	0	0
1	53007848	.	G	A	0	9	9	3	8	20	0	0
1	53025666	.	C	T	13	9	22	0	2	24	0	0
1	53025708	.	C	G	20	11	31	0	0	31	0	0
1	53025711	.	C	T	20	9	29	0	1	30	0	0
1	53061153	.	C	G	14	11	25	0	1	26	0	0
1	53065587	.	G	A	1	5	6	0	8	14	0	0
1	53065611	.	G	T	9	4	13	0	1	14	0	0
1	53099687	.	A	G	9	9	18	0	1	19	0	0
1	53099735	.	C	A	11	9	20	0	0	20	0	0
1	53132842	.	G	C	6	13	19	0	2	21	0	0
1	53156413	.	C	T	11	10	21	0	3	24	0	0
1	53166056	.	G	T	17	13	30	0	0	30	0	0
1	53166094	.	A	G	15	18	33	0	1	34	0	0
1	53185877	.	A	C	21	14	35	0	1	36	0	0
1	53185906	.	T	C	20	12	32	0	1	33	0	0
1	53193288	.	C	T	16	14	30	0	2	32	0	0
1	53198739	.	C	A	18	10	28	0	0	28	0	0
1	53201918	.	G	A	2	12	14	0	19	33	0	0
1	53269670	.	A	C	11	9	20	0	1	21	0	0
1	53334424	.	T	G	10	8	18	0	0	18	0	0
1	53334460	.	C	T	10	7	17	0	1	18	0	0
1	53338602	.	T	C	5	9	14	0	1	15	0	0
1	53338623	.	C	T	6	12	18	0	0	18	0	0
1	53341634	.	A	G	8	6	14	0	1	15	0	0
1	53343124	.	G	A	6	11	17	0	0	17	0	0
1	53343530	.	T	C	11	9	20	0	1	21	0	0
1	53344250	.	T	A	9	5	14	0	1	15	0	0
1	53344259	.	T	A	9	5	14	0	0	14	0	0
1	53348848	.	T	C	12	7	19	0	1	20	0	0
1	53348920	.	A	G	15	6	21	0	0	21	0	0
1	53350703	.	T	C	8	8	16	0	1	17	0	0
1	53359002	.	C	T	10	8	18	1	2	21	0	0
1	53359867	.	T	G	11	8	19	0	1	20	0	0
1	53359876	.	A	G	8	0	8	0	14	22	0	0
1	53360243	.	C	A	14	10	24	0	2	26	0	0
1	53360308	.	G	A	8	16	24	0	1	25	0	0
1	53360342	.	C	T	6	14	20	0	0	20	0	0
1	53360369	.	C	T	2	12	14	0	2	16	0	0
1	53360474	.	G	T	13	24	37	0	0	37	0	0
1	53360821	.	G	A	1	7	8	0	10	18	0	0
1	53360871	.	G	A	4	5	9	0	2	11	0	0
1	53364716	.	A	G	18	17	35	0	10	45	0	0
1	53364929	.	A	G	21	11	32	0	0	32	0	0
1	53364948	.	C	A	20	13	33	0	1	34	0	0
1	53374494	.	G	T	1	3	4	0	0	4	0	0
1	53378728	.	G	A	1	10	11	0	13	24	0	0
1	53380062	.	T	C	8	12	20	0	0	20	0	0
1	53381877	.	T	C	13	11	24	0	0	24	0	0
1	53385017	.	G	A	1	12	13	1	15	29	0	0
1	53387673	.	C	T	7	7	14	0	0	14	0	0
1	53387829	.	C	T	21	17	38	0	0	38	0	0
1	53387954	.	A	G	18	8	26	2	1	29	0	0
1	53388053	.	G	A	4	15	19	0	25	44	0	0
1	53388309	.	G	C	25	15	40	0	0	40	0	0
1	53388367	.	T	A	17	16	33	0	3	36	0	0
1	53388540	.	T	A	21	17	38	0	0	38	0	0
1	53391669	.	A	C	13	11	24	0	2	26	0	0
1	53391760	.	G	A	11	10	21	2	1	24	0	0
1	53391860	.	G	T	10	8	18	1	0	19	0	0
1	53392064	.	T	C	5	1	6	0	14	20	0	0
1	53392227	.	A	T	11	4	15	0	1	16	0	0
1	53392266	.	T	A	5	3	8	2	0	10	0	0
1	53394200	.	T	A	2	3	5	0	1	6	0	0
1	53394306	.	A	T	3	3	6	0	0	6	0	0
1	53394806	.	T	A	7	2	9	0	0	9	0	0
1	53394826	.	T	C	8	3	11	0	1	12	0	0
1	53394847	.	T	C	8	5	13	0	0	13	0	0
1	53395828	.	G	A	10	9	19	0	0	19	0	0
1	53401794	.	T	C	5	7	12	0	0	12	0	0
1	53491799	.	T	G	6	3	9	0	2	11	0	0
1	53492000	.	C	A	5	9	14	0	2	16	0	0
1	53501909	.	C	G	10	14	24	0	2	26	0	0
1	53501918	.	G	A	12	11	23	0	1	24	0	0
1	53568515	.	G	T	13	10	23	0	0	23	0	0
1	53568846	.	A	T	13	8	21	0	1	22	0	0
1	53570142	.	T	C	9	6	15	0	1	16	0	0
1	53572772	.	T	A	1	3	4	0	2	6	0	0
1	53575478	.	C	A	6	8	14	0	1	15	0	0
1	53579023	.	A	G	5	8	13	0	1	14	0	0
1	53581312	.	G	A	9	7	16	0	1	17	0	0
1	53581492	.	G	A	4	3	7	0	0	7	0	0
1	53584411	.	C	A	5	5	10	0	0	10	0	0
1	53585575	.	A	C	4	0	4	0	5	9	0	0
1	53585593	.	A	G	3	3	6	0	0	6	0	0
1	53586376	.	C	T	0	2	2	0	0	2	0	0
1	53586387	.	A	G	2	3	5	0	0	5	0	0
1	53594734	.	T	C	2	6	8	0	0	8	0	0
1	53595753	.	G	A	4	5	9	0	0	9	0	0
1	53597404	.	G	A	6	5	11	0	0	11	0	0
1	53604461	.	A	T	2	3	5	0	0	5	0	0
1	53605290	.	G	A	2	2	4	0	0	4	0	0
1	53613208	.	A	G	2	2	4	0	0	4	0	0
1	53613215	.	C	T	2	2	4	0	0	4	0	0
1	53613790	.	G	A	2	2	4	0	0	4	0	0
1	53659267	.	A	C	7	12	19	0	0	19	0	0
1	53661577	.	T	G	5	13	18	0	0	18	0	0
1	53663391	.	G	A	16	8	24	0	1	25	0	0
1	53663478	.	G	T	11	13	24	0	0	24	0	0
1	53663487	.	C	T	13	12	25	0	0	25	0	0
1	53664677	.	C	G	12	10	22	0	0	22	0	0
1	53665339	.	C	T	4	5	9	0	1	10	0	0
1	53666888	.	A	G	5	7	12	0	1	13	0	0
1	53666936	.	A	G	4	1	5	0	1	6	0	0
1	53666993	.	T	G	2	5	7	0	0	7	0	0
1	53667026	.	A	T	4	11	15	0	0	15	0	0
1	53667080	.	T	C	4	9	13	0	0	13	0	0
1	53668926	.	C	A	3	2	5	0	0	5	0	0
1	53671009	.	A	G	3	7	10	0	0	10	0	0
1	53674825	.	G	A	4	4	8	0	1	9	0	0
1	53676679	.	C	T	1	7	8	0	4	12	0	0
1	53676715	.	G	A	2	8	10	0	0	10	0	0
1	53676727	.	G	C	3	8	11	0	0	11	0	0
1	53677131	.	C	T	4	3	7	0	0	7	0	0
1	53680473	.	A	G	4	3	7	0	0	7	0	0
1	53684632	.	A	G	3	3	6	0	1	7	0	0
1	53684729	.	C	T	5	8	13	0	1	14	0	0
1	53688769	.	T	A	1	2	3	0	0	3	0	0
1	53689067	.	A	G	1	2	3	0	1	4	0	0
1	53703149	.	G	A	28	13	41	0	0	41	0	0
1	53704485	.	C	A	29	26	55	0	2	57	0	0
1	53704530	.	A	G	26	28	54	0	2	56	0	0
1	53707177	.	G	C	18	0	18	0	16	34	0	0
1	53709762	.	C	T	18	17	35	0	0	35	0	0
1	53709858	.	A	T	22	9	31	0	1	32	0	0
1	53709882	.	G	A	21	12	33	0	1	34	0	0
1	53714586	.	A	G	8	11	19	0	1	20	0	0
1	53714727	.	C	A	22	14	36	0	0	36	0	0
1	53714733	.	C	T	20	14	34	0	1	35	0	0
1	53714790	.	T	A	16	25	41	0	2	43	0	0
1	53715083	.	G	A	3	3	6	0	0	6	0	0
1	53717050	.	T	C	2	3	5	0	1	6	0	0
1	53718266	.	A	G	4	2	6	0	0	6	0	0
1	53718294	.	A	T	2	4	6	0	1	7	0	0
1	53722489	.	A	T	9	5	14	0	0	14	0	0
1	53724724	.	T	A	7	7	14	0	0	14	0	0
1	53724775	.	G	A	0	4	4	0	3	7	0	0
1	53726457	.	G	A	9	11	20	0	2	22	0	0
1	53727755	.	C	T	3	6	9	1	0	10	0	0
1	53735245	.	C	T	7	6	13	1	0	14	0	0
1	53735702	.	T	G	16	10	26	0	0	26	0	0
1	53735712	.	G	A	16	10	26	0	1	27	0	0
1	53735977	.	G	C	12	1	13	0	18	31	0	0
1	53737199	.	G	A	15	21	36	0	4	40	0	0
1	53739397	.	G	A	16	15	31	0	1	32	0	0
1	53756723	.	C	T	0	16	16	0	13	29	0	0
1	53866075	.	C	T	8	8	16	0	0	16	0	0
1	53866223	.	A	T	2	6	8	0	0	8	0	0
1	53866319	.	C	T	2	8	10	1	4	15	0	0
1	53868941	.	A	G	6	10	16	0	0	16	0	0
1	53871338	.	C	A	7	6	13	3	0	16	0	0
1	53871362	.	A	T	13	3	16	3	1	20	0	0
1	53871383	.	A	G	7	6	13	0	0	13	0	0
1	53872061	.	C	T	3	8	11	0	3	14	0	0
1	53872067	.	T	C	3	1	4	0	10	14	0	0
1	53873154	.	A	G	8	8	16	0	0	16	0	0
1	53880610	.	T	C	5	6	11	0	0	11	0	0
1	53912148	.	A	G	2	2	4	0	0	4	0	0
1	53912418	.	G	T	4	10	14	0	2	16	0	0
1	53912637	.	A	G	4	5	9	0	0	9	0	0
1	53912670	.	A	G	3	2	5	0	0	5	0	0
1	53913202	.	T	C	3	3	6	0	0	6	0	0
1	53914976	.	A	G	2	2	4	0	1	5	0	0
1	53914977	.	T	A	3	2	5	0	0	5	0	0
1	53918671	.	C	T	2	3	5	0	3	8	0	0
1	53919219	.	C	G	2	2	4	0	0	4	0	0
1	53923793	.	A	G	2	0	2	0	7	9	0	0
1	53923883	.	A	T	4	2	6	0	0	6	0	0
1	53929218	.	G	A	7	3	10	0	0	10	0	0
1	53929219	.	C	A	7	3	10	0	0	10	0	0
1	53929295	.	C	T	5	4	9	0	0	9	0	0
1	53929298	.	A	G	5	3	8	0	0	8	0	0
1	53930468	.	T	C	2	7	9	0	0	9	0	0
1	53934495	.	C	A	6	3	9	0	0	9	0	0
1	53953068	.	A	C	2	2	4	0	2	6	0	0
1	54206955	.	T	C	1	2	3	0	0	3	0	0
1	54219453	.	A	C	4	4	8	0	0	8	0	0
1	54220446	.	G	A	1	4	5	0	3	8	0	0
1	54221930	.	T	C	5	5	10	2	0	12	0	0
1	54221936	.	T	C	5	3	8	2	0	10	0	0
1	54244041	.	T	C	2	4	6	0	1	7	0	0
1	54244432	.	T	C	10	5	15	0	0	15	0	0
1	54255786	.	A	G	12	11	23	0	1	24	0	0
1	54255804	.	G	C	2	13	15	0	14	29	0	0
1	54255822	.	C	T	17	11	28	0	0	28	0	0
1	54264832	.	G	A	1	11	12	0	17	29	0	0
1	54264835	.	G	T	17	13	30	0	0	30	0	0
1	54271276	.	A	G	10	0	10	0	15	25	0	0
1	54271282	.	C	T	11	16	27	0	0	27	0	0
1	54273753	.	A	G	18	1	19	0	11	30	0	0
1	54273824	.	A	G	14	4	18	0	1	19	0	0
1	54274038	.	G	C	18	8	26	0	2	29	1	0
1	54274049	.	G	A	16	8	24	0	2	26	0	0
1	54274125	.	T	C	15	8	23	0	0	23	0	0
1	54274143	.	T	A	17	9	26	0	1	28	1	0
1	54274378	.	T	C	2	5	7	0	0	7	0	0
1	54274509	.	A	T	7	6	13	0	0	13	0	0
1	54274611	.	T	G	12	4	16	0	1	17	0	0
1	54355963	.	G	T	1	2	3	0	0	3	0	0
1	54356003	.	C	T	0	2	2	0	1	3	0	0
1	54618763	.	G	A	1	3	4	0	0	4	0	0
1	54674086	.	C	T	3	6	9	0	0	9	0	0
1	54674255	.	A	G	4	10	14	0	0	14	0	0
1	54674384	.	G	T	6	10	16	0	0	16	0	0
1	54674388	.	A	G	6	9	15	0	0	15	0	0
1	54677415	.	C	G	13	16	29	0	0	29	0	0
1	54677616	.	C	T	15	13	28	0	1	29	0	0
1	54677752	.	C	T	16	22	38	0	2	40	0	0
1	54677757	.	A	G	13	23	36	0	4	40	0	0
1	54677907	.	T	C	8	17	25	0	3	28	0	0
1	54677928	.	T	C	12	14	26	0	2	28	0	0
1	54677958	.	T	C	10	16	26	0	0	26	0	0
1	54677981	.	T	C	10	17	27	0	2	29	0	0
1	54678030	.	C	T	22	13	35	0	1	36	0	0
1	54678036	.	T	C	23	14	37	0	1	38	0	0
1	54678144	.	T	A	19	12	31	0	5	36	0	0
1	54679715	.	T	C	22	13	35	0	2	37	0	0
1	54685500	.	G	A	2	11	13	0	1	14	0	0
1	54685742	.	A	G	2	0	2	0	6	8	0	0
1	54687598	.	A	G	5	6	11	0	0	11	0	0
1	54687624	.	T	A	6	5	11	0	1	12	0	0
1	54687639	.	A	G	6	4	10	0	1	11	0	0
1	54687715	.	C	A	6	5	11	0	1	12	0	0
1	54687747	.	T	C	5	8	13	0	0	13	0	0
1	54689359	.	A	G	7	0	7	0	9	16	0	0
1	54693613	.	C	T	13	4	17	0	0	17	0	0
1	54693838	.	A	C	3	2	5	0	0	5	0	0
1	54693968	.	T	G	2	3	5	0	0	5	0	0
1	54701338	.	G	A	9	9	18	0	0	18	0	0
1	54701782	.	C	T	2	2	4	0	4	8	0	0
1	54703400	.	G	A	5	7	12	0	0	12	0	0
1	54703424	.	A	C	9	10	19	0	1	20	0	0
1	54703469	.	C	T	0	8	8	0	10	18	0	0
1	54707719	.	T	C	11	10	21	0	2	23	0	0
1	54707846	.	A	G	35	19	54	0	4	58	0	0
1	54707885	.	C	G	5	21	26	0	38	64	0	0
1	54707894	.	T	G	39	23	62	0	1	63	0	0
1	54707937	.	A	G	42	12	54	0	1	55	0	0
1	54708057	.	C	G	2	20	22	0	35	57	0	0
1	54708096	.	C	G	4	30	34	0	27	61	0	0
1	54708098	.	G	T	29	27	56	0	4	60	0	0
1	54708191	.	C	A	31	28	59	0	1	60	0	0
1	54708281	.	A	T	29	31	60	0	6	66	0	0
1	54708301	.	A	C	35	33	68	0	1	69	0	0
1	54708317	.	C	T	32	33	65	0	1	66	0	0
1	54708365	.	T	C	31	25	56	0	1	57	0	0
1	54708416	.	T	G	17	19	36	0	4	42	2	0
1	54708450	.	A	G	24	12	36	0	2	38	0	0
1	54708465	.	T	C	23	6	29	0	3	33	1	0
1	54708632	.	T	C	15	1	16	0	18	34	0	0
1	54708636	.	T	C	19	12	31	0	3	34	0	0
1	54708759	.	T	C	16	10	26	0	0	26	0	0
1	54708773	.	A	C	13	14	27	0	1	28	0	0
1	54708846	.	T	C	9	20	29	0	0	29	0	0
1	54708886	.	C	T	2	10	12	0	24	36	0	0
1	54708935	.	T	C	21	7	28	0	1	29	0	0
1	54708946	.	T	C	7	14	21	0	1	22	0	0
1	54709239	.	A	T	20	24	44	0	0	44	0	0
1	54709334	.	G	A	29	31	60	0	2	62	0	0
1	54709456	.	G	A	31	28	59	0	3	62	0	0
1	54711853	.	G	A	28	24	52	0	2	54	0	0
1	54714955	.	G	A	38	24	62	0	2	64	0	0
1	54715009	.	T	C	30	1	31	0	33	64	0	0
1	54715027	.	T	C	30	3	33	0	28	61	0	0
1	54715155	.	G	T	32	26	58	0	4	62	0	0
1	54715183	.	A	G	32	24	56	0	4	60	0	0
1	54726184	.	G	A	0	4	4	0	1	5	0	0
1	54726221	.	A	G	1	3	4	0	0	4	0	0
1	54726225	.	G	A	1	3	4	0	0	4	0	0
1	54731849	.	T	G	2	3	5	0	0	5	0	0
1	54737684	.	A	G	6	0	6	0	6	12	0	0
1	54737747	.	C	T	3	2	5	0	0	5	0	0
1	54747729	.	A	G	3	0	3	0	3	6	0	0
1	54747786	.	A	C	3	2	5	0	0	5	0	0
1	54747993	.	T	G	5	2	7	0	0	7	0	0
1	54750500	.	G	A	0	6	6	0	6	12	0	0
1	54753047	.	G	A	9	9	18	1	0	19	0	0
1	54753095	.	T	G	11	0	11	1	10	22	0	0
1	54753101	.	T	C	11	7	18	1	2	21	0	0
1	54753167	.	A	G	7	7	14	0	1	15	0	0
1	54753366	.	A	G	12	13	25	0	0	25	0	0
1	54753401	.	A	T	13	9	22	0	0	22	0	0
1	54753445	.	T	A	11	8	19	0	0	19	0	0
1	54753490	.	C	T	8	5	13	0	1	14	0	0
1	54753623	.	T	G	4	4	8	0	0	8	0	0
1	54753654	.	A	C	2	2	4	0	0	4	0	0
1	54753694	.	A	G	1	3	4	0	0	4	0	0
1	54753731	.	A	G	1	4	5	0	0	5	0	0
1	54754550	.	C	A	8	3	11	0	1	12	0	0
1	54754565	.	C	T	6	3	9	0	2	11	0	0
1	54754709	.	C	T	9	4	13	0	1	14	0	0
1	54754744	.	C	T	5	5	10	0	2	12	0	0
1	54754754	.	T	C	8	5	13	0	1	14	0	0
1	54754795	.	T	C	6	7	13	0	1	14	0	0
1	54754799	.	G	A	7	6	13	0	1	14	0	0
1	54754834	.	C	T	9	7	16	0	2	18	0	0
1	54754839	.	C	T	10	7	17	0	0	17	0	0
1	54755335	.	T	A	1	2	3	0	0	3	0	0
1	54755373	.	T	C	2	4	6	0	0	6	0	0
1	54755416	.	T	A	4	4	8	0	0	8	0	0
1	54758581	.	T	C	5	1	6	0	5	11	0	0
1	54758634	.	T	C	15	5	20	0	0	20	0	0
1	54758783	.	T	G	20	11	31	0	1	32	0	0
1	54758877	.	C	A	1	13	14	0	17	31	0	0
1	54758975	.	T	C	14	10	24	0	1	25	0	0
1	54759028	.	A	G	29	11	40	0	0	40	0	0
1	54762997	.	G	T	23	15	38	0	0	38	0	0
1	54763133	.	T	C	3	5	8	0	0	8	0	0
1	54763182	.	A	G	12	5	17	0	1	18	0	0
1	54895010	.	C	T	3	3	6	0	0	6	0	0
1	54898489	.	A	T	7	6	13	0	1	14	0	0
1	54900783	.	C	T	13	4	17	0	1	18	0	0
1	54906069	.	T	C	8	6	14	0	0	14	0	0
1	54906081	.	A	C	9	7	16	0	0	16	0	0
1	54906452	.	T	C	11	4	15	0	1	16	0	0
1	54906476	.	G	C	0	5	5	0	10	15	0	0
1	54906619	.	T	A	5	7	12	0	0	12	0	0
1	54906662	.	T	C	10	3	13	0	0	13	0	0
1	54906820	.	T	C	5	10	15	0	0	15	0	0
1	54907043	.	G	T	2	8	10	0	0	10	0	0
1	54907534	.	T	C	10	5	15	0	1	16	0	0
1	54907693	.	G	T	7	4	11	0	0	11	0	0
1	54907733	.	T	A	4	2	6	1	2	9	0	0
1	54907744	.	G	A	4	2	6	1	1	8	0	0
1	54911551	.	A	T	1	5	6	0	0	6	0	0
1	54911619	.	T	C	2	5	7	0	0	7	0	0
1	54927198	.	T	C	11	21	32	0	1	33	0	0
1	54929078	.	C	T	22	27	49	0	1	50	0	0
1	54929256	.	T	C	7	17	24	0	0	24	0	0
1	54929373	.	C	G	7	5	12	0	0	12	0	0
1	54929450	.	A	G	5	9	14	0	2	16	0	0
1	54929575	.	C	T	7	8	15	0	0	15	0	0
1	54929647	.	A	C	6	12	18	0	1	19	0	0
1	54929681	.	C	A	7	13	20	0	0	20	0	0
1	54929733	.	T	G	15	11	26	0	1	27	0	0
1	54929985	.	C	T	13	15	28	0	0	28	0	0
1	54930082	.	G	A	6	3	9	0	1	10	0	0
1	54930087	.	G	A	7	2	9	0	1	10	0	0
1	54930229	.	C	T	16	5	21	0	0	21	0	0
1	54930376	.	C	G	4	2	6	0	1	7	0	0
1	54930439	.	T	A	10	8	18	0	2	20	0	0
1	54930598	.	A	G	12	4	16	0	0	16	0	0
1	54930607	.	C	A	11	3	14	0	0	14	0	0
1	54930930	.	T	G	8	19	27	0	1	28	0	0
1	54931380	.	A	C	20	11	31	0	1	32	0	0
1	54931487	.	G	T	2	17	19	0	19	38	0	0
1	54934690	.	T	C	2	2	4	0	1	5	0	0
1	54934694	.	G	T	3	2	5	0	0	5	0	0
1	54936235	.	G	T	13	15	28	0	1	29	0	0
1	54936471	.	T	C	23	21	44	0	0	44	0	0
1	54936472	.	G	A	20	21	41	0	3	44	0	0
1	54938208	.	C	T	0	28	28	0	8	36	0	0
1	54938261	.	C	T	1	21	22	2	10	34	0	0
1	54939536	.	A	T	12	31	43	0	2	45	0	0
1	54939563	.	C	G	10	27	37	0	0	37	0	0
1	54939709	.	T	G	11	18	29	0	0	29	0	0
1	54941036	.	G	A	10	20	30	0	0	30	0	0
1	54942609	.	C	T	1	14	15	0	9	24	0	0
1	54943082	.	G	T	7	9	16	0	3	19	0	0
1	54944372	.	T	A	7	3	10	0	0	10	0	0
1	54944882	.	A	G	6	9	15	0	0	15	0	0
1	54945039	.	A	G	4	11	15	0	0	15	0	0
1	54945066	.	G	T	2	9	11	0	0	11	0	0
1	54945195	.	A	C	3	9	12	0	0	12	0	0
1	54947527	.	G	A	3	3	6	0	0	6	0	0
1	54948145	.	T	C	17	9	26	0	1	27	0	0
1	54950379	.	G	C	20	20	40	1	1	42	0	0
1	54950410	.	T	C	17	13	30	1	1	32	0	0
1	54950534	.	T	C	11	11	22	0	0	22	0	0
1	54950685	.	A	G	15	12	27	0	2	29	0	0
1	54950689	.	C	A	15	13	28	0	3	31	0	0
1	54950747	.	C	T	7	14	21	0	1	22	0	0
1	54950801	.	A	G	7	8	15	0	1	16	0	0
1	54955234	.	A	G	14	12	26	0	3	29	0	0
1	54958039	.	G	T	5	3	8	0	0	8	0	0
1	54958123	.	A	G	6	3	9	0	1	10	0	0
1	54958146	.	T	A	6	4	10	0	1	11	0	0
1	54958211	.	C	T	5	3	8	0	0	8	0	0
1	54958242	.	T	A	10	2	12	0	1	13	0	0
1	54958249	.	G	A	10	2	12	0	0	12	0	0
1	54958278	.	T	A	6	7	13	0	0	13	0	0
1	54960368	.	T	G	11	9	20	0	0	20	0	0
1	54960431	.	G	T	21	12	33	0	4	37	0	0
1	54960438	.	G	A	15	14	29	0	5	35	1	0
1	54962466	.	A	G	17	21	38	0	0	38	0	0
1	54963251	.	C	T	19	17	36	0	1	37	0	0
1	54964682	.	C	T	3	9	12	0	20	32	0	0
1	54964685	.	T	C	20	0	20	0	12	32	0	0
1	54964724	.	A	G	22	11	33	0	0	33	0	0
1	54964799	.	C	T	11	13	24	0	1	25	0	0
1	54974321	.	C	T	3	3	6	0	1	7	0	0
1	54974500	.	T	A	8	11	19	0	1	20	0	0
1	54974538	.	A	G	8	7	15	0	0	15	0	0
1	54974558	.	C	T	9	8	17	0	0	17	0	0
1	54974791	.	A	T	10	9	19	0	0	19	0	0
1	54974810	.	G	T	8	6	14	0	2	16	0	0
1	54975051	.	G	T	18	14	32	0	1	33	0	0
1	54975404	.	C	T	1	2	3	0	5	8	0	0
1	54975553	.	T	C	11	0	11	0	17	28	0	0
1	54975762	.	A	T	5	10	15	0	0	15	0	0
1	54975847	.	T	A	7	2	9	1	0	10	0	0
1	54975884	.	A	G	5	6	11	1	0	12	0	0
1	54976026	.	T	A	7	11	18	0	0	18	0	0
1	54976035	.	T	A	5	9	14	0	2	16	0	0
1	54976178	.	T	C	15	1	16	0	8	24	0	0
1	54976249	.	T	A	14	9	23	0	0	23	0	0
1	54976256	.	C	T	10	9	19	0	2	21	0	0
1	54976497	.	T	C	9	9	18	0	1	19	0	0
1	54976500	.	T	C	12	6	18	0	0	18	0	0
1	54976784	.	T	A	4	5	9	0	0	9	0	0
1	54976798	.	C	A	3	4	7	0	0	7	0	0
1	54977057	.	A	G	10	6	16	0	0	16	0	0
1	54977308	.	C	A	1	6	7	0	1	8	0	0
1	54977329	.	A	G	3	10	13	0	0	13	0	0
1	54977697	.	G	A	3	8	11	0	0	11	0	0
1	54977719	.	T	A	2	9	11	0	0	11	0	0
1	54977767	.	A	T	10	4	14	0	1	15	0	0
1	54977929	.	G	A	4	4	8	0	0	8	0	0
1	54977945	.	T	C	5	3	8	0	0	8	0	0
1	54978010	.	A	C	5	0	5	1	3	9	0	0
1	54978022	.	T	G	4	4	8	0	1	9	0	0
1	54978049	.	A	G	6	4	10	0	0	10	0	0
1	54978058	.	C	A	5	4	9	0	0	9	0	0
1	54978260	.	G	A	8	3	11	0	0	11	0	0
1	54978405	.	C	A	5	6	11	0	0	11	0	0
1	54978408	.	C	T	5	4	9	0	1	10	0	0
1	54978478	.	T	C	3	3	6	0	0	6	0	0
1	54981571	.	C	T	0	9	9	0	3	12	0	0
1	54985341	.	T	C	10	0	10	0	8	18	0	0
1	54986910	.	T	C	8	0	8	0	6	14	0	0
1	54988190	.	T	A	7	2	9	0	2	11	0	0
1	54997275	.	T	C	6	0	6	0	8	14	0	0
1	54997327	.	T	C	8	6	14	0	0	14	0	0
1	54997382	.	A	T	5	6	11	0	1	12	0	0
1	54997422	.	G	C	7	7	14	0	1	15	0	0
1	54997624	.	T	G	1	3	4	0	0	4	0	0
1	55007554	.	T	C	1	0	1	0	2	3	0	0
1	55007685	.	A	G	3	6	9	0	0	9	0	0
1	55007759	.	T	C	5	7	12	0	2	14	0	0
1	55007820	.	A	C	5	3	8	0	1	9	0	0
1	55008286	.	G	A	17	12	29	0	1	30	0	0
1	55008331	.	A	T	15	16	31	0	0	31	0	0
1	55008594	.	A	T	20	11	31	0	4	35	0	0
1	55008772	.	T	C	17	11	28	0	5	33	0	0
1	55009497	.	G	A	1	1	2	0	1	3	0	0
1	55009513	.	C	A	2	3	5	0	0	5	0	0
1	55009649	.	G	A	5	3	8	0	0	8	0	0
1	55009728	.	T	A	3	2	5	0	0	5	0	0
1	55009734	.	T	C	3	2	5	0	1	6	0	0
1	55010914	.	A	T	7	10	17	0	0	17	0	0
1	55011112	.	A	T	3	3	6	0	0	6	0	0
1	55011117	.	T	C	4	3	7	0	0	7	0	0
1	55011232	.	A	G	4	2	6	0	0	6	0	0
1	55011473	.	G	A	9	6	15	0	0	15	0	0
1	55011514	.	C	T	6	7	13	0	1	14	0	0
1	55011539	.	A	T	7	8	15	0	0	15	0	0
1	55011603	.	G	A	13	11	24	0	0	24	0	0
1	55013828	.	A	G	3	4	7	0	0	7	0	0
1	55013968	.	G	C	4	4	8	0	0	8	0	0
1	55015819	.	A	T	5	4	9	0	2	11	0	0
1	55015846	.	A	G	5	7	12	0	0	12	0	0
1	55018914	.	A	G	3	2	5	0	0	5	0	0
1	55021862	.	A	T	3	3	6	0	0	6	0	0
1	55021886	.	G	A	6	4	10	0	0	10	0	0
1	55021952	.	G	A	4	3	7	0	1	9	1	0
1	55022075	.	T	C	4	0	4	0	5	9	0	0
1	55022162	.	T	A	3	2	5	1	0	6	0	0
1	55032777	.	C	T	1	4	5	0	0	5	0	0
1	55032802	.	C	T	0	3	3	0	1	4	0	0
1	55032909	.	A	G	3	3	6	0	0	6	0	0
1	55038249	.	A	G	3	3	6	0	0	6	0	0
1	55046053	.	A	G	1	4	5	0	0	5	0	0
1	55046061	.	T	C	2	3	5	0	0	5	0	0
1	55046461	.	G	T	3	3	6	0	0	6	0	0
1	55046573	.	C	T	3	3	6	0	0	6	0	0
1	55046591	.	G	A	2	3	5	0	0	5	0	0
1	55046635	.	C	G	1	3	4	0	0	4	0	0
1	55048414	.	G	A	1	5	6	0	0	6	0	0
1	55048452	.	A	C	2	3	5	0	0	5	0	0
1	55048453	.	G	C	1	3	4	0	1	5	0	0
1	55049129	.	C	T	2	3	5	0	0	5	0	0
1	55080832	.	A	G	1	4	5	0	0	5	0	0
1	55080840	.	A	G	1	0	1	0	6	7	0	0
1	55080905	.	A	G	4	7	11	0	0	11	0	0
1	55085782	.	A	G	2	0	2	0	7	9	0	0
1	55085830	.	A	T	2	3	5	0	2	7	0	0
1	55088074	.	G	T	6	2	8	0	0	8	0	0
1	55088075	.	A	G	7	2	9	0	0	9	0	0
1	55088490	.	C	A	2	4	6	0	0	6	0	0
1	55088805	.	A	T	4	2	6	0	0	6	0	0
1	55088807	.	A	T	4	2	6	0	0	6	0	0
1	55089078	.	T	A	1	7	8	0	1	9	0	0
1	55089115	.	G	T	0	4	4	0	1	5	0	0
1	55089120	.	G	T	1	2	3	0	0	3	0	0
1	55089294	.	T	C	5	2	7	0	0	7	0	0
1	55089328	.	G	A	4	7	11	0	2	13	0	0
1	55089378	.	G	T	5	12	17	0	0	17	0	0
1	55089384	.	T	A	4	10	14	0	1	15	0	0
1	55089890	.	A	T	2	2	4	1	0	5	0	0
1	55089904	.	C	A	3	2	5	1	1	7	0	0
1	55089938	.	C	T	6	2	8	0	1	9	0	0
1	55095331	.	T	C	5	3	8	0	0	8	0	0
1	55099160	.	G	T	1	8	9	0	10	19	0	0
1	55099214	.	A	C	10	10	20	0	1	21	0	0
1	55099316	.	T	C	11	4	15	0	1	16	0	0
1	55099411	.	G	A	11	6	17	0	0	17	0	0
1	55099472	.	T	C	8	14	22	0	0	22	0	0
1	55100018	.	T	C	4	10	14	0	1	15	0	0
1	55100286	.	G	T	20	15	35	0	2	37	0	0
1	55100422	.	T	A	9	13	22	0	2	24	0	0
1	55100456	.	T	C	12	9	21	0	0	21	0	0
1	55101376	.	C	T	16	13	29	0	1	30	0	0
1	55101409	.	C	A	11	12	23	0	2	25	0	0
1	55103160	.	A	G	10	13	23	0	2	25	0	0
1	55105727	.	T	C	10	6	16	0	1	17	0	0
1	55108059	.	A	T	7	10	17	0	0	17	0	0
1	55108065	.	T	C	8	10	18	0	0	18	0	0
1	55113137	.	G	A	2	2	4	0	0	4	0	0
1	55113465	.	A	G	4	2	6	0	0	6	0	0
1	55127910	.	C	T	5	4	9	0	1	10	0	0
1	55129864	.	A	C	5	0	5	0	12	17	0	0
1	55131388	.	G	A	7	2	9	0	0	9	0	0
1	55161431	.	A	G	3	7	10	0	1	11	0	0
1	55162449	.	A	G	6	7	13	0	0	13	0	0
1	55169384	.	G	T	10	9	19	0	1	20	0	0
1	55169662	.	A	G	19	10	29	0	1	30	0	0
1	55169756	.	A	G	12	13	25	0	0	25	0	0
1	55169789	.	A	T	9	11	20	1	2	23	0	0
1	55169961	.	T	C	6	0	6	0	12	18	0	0
1	55169980	.	A	G	7	12	19	0	0	19	0	0
1	55169999	.	C	T	8	12	20	0	0	20	0	0
1	55170042	.	A	C	13	8	21	1	0	22	0	0
1	55170056	.	G	T	11	7	18	1	1	20	0	0
1	55170161	.	C	A	15	5	20	0	0	20	0	0
1	55170189	.	C	A	11	7	18	1	0	19	0	0
1	55170328	.	C	A	9	2	11	3	0	14	0	0
1	55170342	.	A	C	9	3	12	2	1	15	0	0
1	55170856	.	T	C	6	0	6	0	7	13	0	0
1	55170866	.	T	C	5	0	5	0	8	13	0	0
1	55171249	.	G	A	9	19	28	0	0	28	0	0
1	55173006	.	T	A	13	10	23	0	2	25	0	0
1	55174744	.	C	T	7	7	14	0	1	15	0	0
1	55176698	.	A	G	8	8	16	0	1	17	0	0
1	55177447	.	C	T	10	6	16	0	1	17	0	0
1	55178763	.	C	G	8	10	18	0	0	18	0	0
1	55178808	.	A	G	3	3	6	0	0	6	0	0
1	55180229	.	A	G	5	7	12	0	0	12	0	0
1	55180268	.	T	G	5	3	8	0	0	8	0	0
1	55180278	.	G	C	5	0	5	0	3	8	0	0
1	55182617	.	G	T	8	3	11	0	0	11	0	0
1	55182626	.	G	T	7	3	10	0	0	11	1	0
1	55182656	.	T	C	5	5	10	0	0	10	0	0
1	55182685	.	T	C	4	6	10	0	0	10	0	0
1	55182699	.	A	C	6	5	11	0	0	11	0	0
1	55182720	.	T	C	6	8	14	0	0	14	0	0
1	55182743	.	C	T	6	8	14	0	1	15	0	0
1	55182811	.	A	G	8	4	12	0	1	13	0	0
1	55182876	.	A	T	6	8	14	0	0	14	0	0
1	55182964	.	T	C	2	11	13	0	2	15	0	0
1	55183041	.	C	T	5	5	10	0	0	10	0	0
1	55191201	.	G	T	8	4	12	0	1	14	1	0
1	55191219	.	T	A	9	7	16	0	0	16	0	0
1	55191256	.	A	T	7	11	18	0	0	18	0	0
1	55191675	.	A	G	14	10	24	0	1	25	0	0
1	55195273	.	G	A	11	11	22	0	0	22	0	0
1	55195309	.	T	C	11	0	11	0	18	29	0	0
1	55195414	.	G	A	10	9	19	0	2	21	0	0
1	55195952	.	T	G	6	16	22	0	0	22	0	0
1	55195997	.	A	T	7	10	17	0	2	19	0	0
1	55196045	.	T	C	12	0	12	0	8	20	0	0
1	55197685	.	G	A	9	8	17	0	1	18	0	0
1	55197805	.	T	C	10	11	21	0	0	21	0	0
1	55197826	.	G	A	10	10	20	0	0	20	0	0
1	55198952	.	A	G	10	11	21	0	0	21	0	0
1	55218563	.	G	A	3	11	14	1	1	16	0	0
1	55223213	.	C	T	3	3	6	0	0	6	0	0
1	55226063	.	T	C	6	1	7	0	5	12	0	0
1	55226080	.	C	G	5	4	9	0	0	9	0	0
1	55226931	.	T	C	7	4	11	0	0	11	0	0
1	55228550	.	G	T	2	5	7	0	1	8	0	0
1	55228601	.	C	T	0	5	5	0	2	7	0	0
1	55229456	.	A	G	1	3	4	0	1	5	0	0
1	55229531	.	T	A	4	2	6	0	0	6	0	0
1	55229812	.	G	A	3	6	9	0	1	10	0	0
1	55233259	.	A	G	5	2	7	0	1	8	0	0
1	55234077	.	C	T	3	7	10	0	1	11	0	0
1	55234125	.	C	T	5	4	9	0	2	11	0	0
1	55234147	.	G	A	7	5	12	0	0	12	0	0
1	55234161	.	A	G	5	3	8	0	0	8	0	0
1	55234188	.	A	G	5	2	7	0	0	7	0	0
1	55234200	.	G	C	4	2	6	0	0	6	0	0
1	55235177	.	G	A	5	4	9	0	0	9	0	0
1	55235203	.	T	C	3	3	6	0	0	6	0	0
1	55235228	.	T	G	3	2	5	0	0	5	0	0
1	55236266	.	A	G	2	6	8	0	0	8	0	0
1	55264294	.	C	T	1	7	8	0	6	14	0	0
1	55264314	.	C	A	8	9	17	0	0	17	0	0
1	55264366	.	C	T	14	7	21	0	1	22	0	0
1	55264575	.	T	A	15	17	32	0	2	34	0	0
1	55745816	.	C	T	1	3	4	0	0	4	0	0
1	55746613	.	G	A	2	2	4	0	0	4	0	0
1	55762664	.	C	A	5	15	20	1	0	21	0	0
1	55772026	.	C	T	21	22	43	0	2	45	0	0
1	55776813	.	G	A	1	23	24	0	19	43	0	0
1	55776858	.	G	A	1	17	18	0	19	37	0	0
1	55776909	.	A	C	12	14	26	0	5	34	3	0
1	55776962	.	T	A	18	20	38	0	3	41	0	0
1	55777008	.	A	T	13	19	32	0	1	33	0	0
1	55783978	.	T	C	39	24	63	1	1	65	0	0
1	55785527	.	C	A	8	24	32	0	33	65	0	0
1	55785577	.	A	G	40	26	66	0	0	66	0	0
1	55785596	.	T	C	20	21	41	0	2	44	1	0
1	55785654	.	C	T	11	20	31	0	0	31	0	0
1	55785697	.	C	T	9	4	13	0	0	13	0	0
1	55787219	.	A	C	1	3	4	0	1	5	0	0
1	55787236	.	C	T	1	2	3	0	1	4	0	0
1	55787276	.	G	A	2	3	5	0	0	5	0	0
1	55787300	.	C	T	0	3	3	0	2	5	0	0
1	55787507	.	A	G	3	3	6	0	0	6	0	0
1	55789456	.	C	T	5	5	10	0	0	10	0	0
1	55789504	.	A	C	4	0	4	0	5	9	0	0
1	55791438	.	A	G	5	2	7	0	0	7	0	0
1	55793044	.	A	G	3	2	5	0	0	5	0	0
1	55793055	.	A	G	1	2	3	0	0	3	0	0
1	55799444	.	A	G	1	1	2	0	1	3	0	0
1	55817728	.	C	T	3	3	6	0	0	6	0	0
1	55817753	.	G	A	3	3	6	1	0	7	0	0
1	55824892	.	C	G	5	7	12	0	0	12	0	0
1	55833276	.	C	T	3	5	8	0	0	8	0	0
1	55833281	.	C	T	3	5	8	0	0	8	0	0
1	55843902	.	C	T	30	17	47	0	3	50	0	0
1	55843968	.	G	A	21	20	41	0	1	42	0	0
1	55844044	.	T	A	17	20	37	0	0	37	0	0
1	55844143	.	T	G	20	15	35	0	0	35	0	0
1	55851968	.	T	C	12	0	12	0	10	23	1	0
1	55853320	.	G	A	9	15	24	0	2	26	0	0
1	55872892	.	C	G	9	15	24	0	1	25	0	0
1	55873073	.	C	T	9	12	21	0	1	22	0	0
1	55878257	.	T	A	1	7	8	0	0	8	0	0
1	55878342	.	T	A	6	2	8	0	2	10	0	0
1	55878431	.	T	A	4	9	13	0	3	16	0	0
1	55878457	.	C	T	7	11	18	0	0	18	0	0
1	55878496	.	T	C	8	1	9	0	6	15	0	0
1	55878558	.	G	A	6	8	14	0	1	15	0	0
1	55885938	.	A	T	2	10	12	0	0	12	0	0
1	55888690	.	A	G	9	4	13	0	0	13	0	0
1	55888693	.	T	A	8	4	12	0	0	12	0	0
1	55888852	.	A	C	5	4	9	0	0	9	0	0
1	55888857	.	A	C	6	0	6	0	4	10	0	0
1	55888892	.	A	G	5	5	10	0	0	10	0	0
1	56217457	.	G	A	8	10	18	0	1	19	0	0
1	56217510	.	A	G	33	20	53	0	0	53	0	0
1	56217925	.	G	A	27	37	64	0	7	71	0	0
1	56218189	.	C	T	3	30	33	0	36	69	0	0
1	56218258	.	A	C	30	43	73	0	1	74	0	0
1	56220668	.	A	G	43	16	59	0	0	59	0	0
1	56223902	.	T	G	3	5	8	0	0	8	0	0
1	56422781	.	T	A	7	4	11	0	0	11	0	0
1	56422962	.	A	T	5	6	11	0	0	11	0	0
1	56422967	.	T	C	5	6	11	0	0	11	0	0
1	56423002	.	T	G	4	6	10	0	3	13	0	0
1	56423554	.	T	C	1	3	4	0	0	4	0	0
1	56423641	.	T	A	7	7	14	0	1	15	0	0
1	56423664	.	T	C	5	0	5	0	10	15	0	0
1	56425843	.	T	C	9	0	9	0	11	20	0	0
1	56425864	.	C	T	7	10	17	0	0	17	0	0
1	56428320	.	G	A	3	10	13	0	0	13	0	0
1	57278215	.	G	C	11	6	17	0	0	17	0	0
1	57278405	.	A	T	6	7	13	0	0	13	0	0
1	57278452	.	C	T	8	5	13	0	0	13	0	0
1	57278610	.	T	G	7	8	15	0	1	16	0	0
1	57278669	.	A	G	7	8	15	0	0	15	0	0
1	57278690	.	G	A	8	7	15	0	0	15	0	0
1	57278753	.	T	C	7	12	19	0	1	20	0	0
1	57278783	.	T	C	6	7	13	0	3	16	0	0
1	57278915	.	G	A	10	16	26	0	1	27	0	0
1	57278979	.	G	A	8	15	23	0	1	24	0	0
1	57279073	.	T	C	11	2	13	0	9	22	0	0
1	57280108	.	G	A	5	10	15	0	1	16	0	0
1	57280184	.	G	T	14	6	20	0	0	20	0	0
1	57280292	.	T	C	10	6	16	0	0	16	0	0
1	57280454	.	A	T	11	8	19	0	2	21	0	0
1	57280502	.	T	C	14	12	26	0	1	27	0	0
1	57306744	.	G	T	3	3	6	0	0	6	0	0
1	57309400	.	T	A	1	2	3	0	0	3	0	0
1	57309403	.	G	A	1	2	3	0	0	3	0	0
1	57317706	.	C	T	2	2	4	0	1	5	0	0
1	57332495	.	A	T	2	3	5	0	0	5	0	0
1	57332744	.	C	T	2	3	5	0	1	6	0	0
1	57333094	.	G	A	0	4	4	0	2	6	0	0
1	57337050	.	A	G	3	9	12	0	0	12	0	0
1	57337107	.	T	C	3	3	6	0	0	6	0	0
1	57337110	.	C	T	2	3	5	0	1	6	0	0
1	57338143	.	C	T	5	4	9	0	1	10	0	0
1	57338226	.	G	A	1	3	4	0	7	11	0	0
1	57340049	.	T	C	6	8	14	0	1	15	0	0
1	57340108	.	C	T	6	3	9	0	0	9	0	0
1	57340164	.	T	A	10	4	14	0	0	14	0	0
1	57352530	.	A	G	2	2	4	0	0	4	0	0
1	57364655	.	A	T	5	3	8	0	0	8	0	0
1	58013096	.	A	G	12	2	14	0	2	16	0	0
1	58013102	.	A	T	12	3	15	0	0	15	0	0
1	58013308	.	C	A	8	6	14	0	0	14	0	0
1	58013309	.	A	G	8	6	14	0	0	14	0	0
1	58014867	.	T	C	13	8	21	0	0	21	0	0
1	58014933	.	T	C	9	0	9	0	6	15	0	0
1	58015053	.	A	G	5	3	8	0	0	8	0	0
1	58015448	.	G	T	8	6	14	0	1	15	0	0
1	58015580	.	T	C	1	0	1	0	6	7	0	0
1	58015604	.	C	T	2	2	4	0	2	6	0	0
1	58017698	.	T	A	1	2	3	0	2	5	0	0
1	58017733	.	T	C	2	1	3	0	4	7	0	0
1	58019805	.	A	G	2	4	6	0	0	6	0	0
1	58020740	.	C	G	0	4	4	0	4	8	0	0
1	58020767	.	T	C	2	1	3	0	4	7	0	0
1	58020829	.	A	G	2	5	7	0	0	7	0	0
1	58020842	.	A	G	3	2	5	0	1	6	0	0
1	58023960	.	T	A	3	2	5	0	1	6	0	0
1	58036348	.	A	C	2	4	6	0	1	7	0	0
1	58036450	.	G	A	3	2	5	0	0	5	0	0
1	58036478	.	C	A	1	2	3	0	0	3	0	0
1	58092700	.	T	A	13	4	17	0	0	17	0	0
1	58092750	.	G	A	1	6	7	0	15	22	0	0
1	58092795	.	A	T	11	8	19	0	0	19	0	0
1	58092820	.	C	G	7	7	14	0	1	15	0	0
1	58092836	.	T	C	7	5	12	0	2	14	0	0
1	58094708	.	C	T	5	10	15	0	0	15	0	0
1	58094744	.	A	G	11	8	19	0	1	20	0	0
1	58094775	.	A	G	9	6	15	0	3	18	0	0
1	58095111	.	C	T	10	9	19	0	1	20	0	0
1	58095116	.	G	C	11	7	18	0	1	19	0	0
1	58098105	.	A	C	16	10	26	0	0	26	0	0
1	58098137	.	T	A	14	10	24	1	1	26	0	0
1	58102932	.	T	G	6	14	20	0	0	20	0	0
1	58226101	.	C	T	2	2	4	1	0	5	0	0
1	58305831	.	G	C	1	2	3	2	0	5	0	0
1	58357850	.	T	A	2	8	10	3	0	13	0	0
1	58545752	.	A	T	10	4	14	0	0	14	0	0
1	58547747	.	C	T	0	2	2	0	6	8	0	0
1	58547772	.	A	T	6	2	8	0	0	8	0	0
1	58573353	.	T	A	2	2	4	0	0	4	0	0
1	58573382	.	C	T	0	3	3	0	3	6	0	0
1	58593457	.	G	T	2	2	4	0	0	4	0	0
1	58593490	.	C	G	1	5	6	0	1	7	0	0
1	58593494	.	T	A	2	5	7	0	0	7	0	0
1	58593542	.	G	A	2	4	6	0	0	6	0	0
1	58593547	.	A	T	2	4	6	0	0	6	0	0
1	58593586	.	C	A	2	2	4	0	0	4	0	0
1	58593593	.	A	T	2	2	4	0	0	4	0	0
1	58593685	.	A	C	4	4	8	0	0	8	0	0
1	58593699	.	A	G	4	2	6	0	0	6	0	0
1	58593768	.	T	G	9	5	14	2	0	16	0	0
1	58593833	.	C	A	2	8	10	0	1	11	0	0
1	58593835	.	T	C	2	9	11	0	0	11	0	0
1	58593912	.	C	T	7	5	12	0	0	12	0	0
1	58593976	.	G	A	6	2	8	0	0	8	0	0
1	58594066	.	T	C	4	1	5	0	6	11	0	0
1	58594106	.	G	A	6	3	9	0	0	9	0	0
1	58594219	.	T	C	4	6	10	0	0	10	0	0
1	58594220	.	T	C	4	6	10	0	0	10	0	0
1	58594521	.	T	C	2	6	8	0	0	8	0	0
1	58594689	.	A	G	6	3	9	0	1	10	0	0
1	58594693	.	C	G	5	4	9	0	0	9	0	0
1	58594753	.	C	T	1	2	3	0	3	6	0	0
1	58595018	.	C	T	10	10	20	0	1	21	0	0
1	58598607	.	T	G	5	5	10	0	0	10	0	0
1	58598663	.	G	T	9	5	14	0	1	15	0	0
1	58598802	.	T	C	4	0	4	0	4	8	0	0
1	58606051	.	G	A	0	2	2	3	1	6	0	0
1	58610453	.	G	A	4	2	6	0	1	8	1	0
1	58612519	.	T	C	4	4	8	0	1	9	0	0
1	58612726	.	G	A	1	4	5	0	4	9	0	0
1	58612762	.	A	G	3	4	7	0	0	7	0	0
1	58612915	.	A	T	5	2	7	1	0	8	0	0
1	58613008	.	T	C	2	2	4	1	0	5	0	0
1	58613027	.	A	G	3	2	5	1	2	8	0	0
1	58613091	.	A	C	3	2	5	0	0	5	0	0
1	58617870	.	C	T	3	2	5	2	1	8	0	0
1	58618220	.	C	A	1	2	3	1	0	4	0	0
1	58618343	.	A	G	1	2	3	1	0	4	0	0
1	58631350	.	C	T	2	5	7	0	0	7	0	0
1	58631374	.	A	G	3	3	6	0	0	6	0	0
1	58631509	.	A	G	2	2	4	0	1	5	0	0
1	58631559	.	A	T	2	2	4	0	0	4	0	0
1	58631695	.	A	T	1	4	5	0	0	5	0	0
1	58631713	.	A	G	1	0	1	0	3	4	0	0
1	58631878	.	G	A	1	3	4	0	1	5	0	0
1	58632016	.	G	A	2	3	5	0	1	6	0	0
1	58677909	.	A	C	2	6	8	0	0	8	0	0
1	58677949	.	A	C	2	7	9	0	0	9	0	0
1	58677993	.	A	G	2	12	14	0	0	14	0	0
1	58678017	.	T	C	2	9	11	0	1	12	0	0
1	58678077	.	T	A	10	6	16	2	0	18	0	0
1	58680432	.	T	A	3	19	22	0	2	24	0	0
1	58680469	.	C	A	17	8	25	0	1	26	0	0
1	58680499	.	C	A	14	14	28	0	1	29	0	0
1	58680553	.	C	A	17	7	24	0	0	26	2	0
1	58680566	.	T	C	13	8	21	0	0	22	1	0
1	58680591	.	C	T	10	10	20	0	0	20	0	0
1	58680792	.	T	C	8	7	15	0	0	15	0	0
1	58681095	.	A	G	5	8	13	0	0	13	0	0
1	58681278	.	A	C	20	6	26	0	1	27	0	0
1	58762955	.	T	C	12	0	12	0	16	28	0	0
1	58762985	.	T	G	13	12	25	0	0	25	0	0
1	58766341	.	G	A	7	9	16	0	0	16	0	0
1	58850500	.	T	G	5	8	13	0	0	13	0	0
1	58850525	.	T	A	3	8	11	0	0	13	2	0
1	58850562	.	C	T	1	5	6	0	0	6	0	0
1	58857688	.	C	G	1	3	4	0	0	5	1	0
1	58978436	.	A	C	3	2	5	0	0	5	0	0
1	58978454	.	C	T	5	2	7	0	0	7	0	0
1	58982147	.	G	A	0	9	9	0	3	12	0	0
1	58982195	.	C	G	7	9	16	0	0	16	0	0
1	58984239	.	G	T	2	4	6	0	0	6	0	0
1	58984368	.	G	A	0	4	4	0	4	8	0	0
1	58984478	.	T	C	4	6	10	0	0	10	0	0
1	58984640	.	C	T	5	6	11	0	0	11	0	0
1	58985530	.	G	A	9	8	17	0	1	18	0	0
1	58985579	.	T	G	10	5	15	0	1	16	0	0
1	58985730	.	C	A	5	3	8	0	0	8	0	0
1	58992846	.	C	T	3	5	8	0	0	8	0	0
1	58998156	.	C	G	3	3	6	0	1	7	0	0
1	58998157	.	T	G	4	3	7	0	0	7	0	0
1	58999960	.	T	A	4	6	10	0	0	10	0	0
1	59009732	.	A	G	18	1	19	0	22	41	0	0
1	59010618	.	G	A	25	22	47	1	0	48	0	0
1	59018886	.	C	T	2	4	6	0	13	19	0	0
1	59019006	.	C	G	2	6	8	0	1	9	0	0
1	59019084	.	T	A	4	5	9	0	0	9	0	0
1	59019093	.	A	G	3	6	9	0	1	10	0	0
1	59062665	.	T	C	31	26	57	0	1	58	0	0
1	59065889	.	G	A	3	13	16	0	12	28	0	0
1	59140788	.	G	C	2	2	4	0	0	4	0	0
1	59141116	.	T	A	6	3	9	0	0	9	0	0
1	59141415	.	C	A	4	2	6	0	1	7	0	0
1	59142891	.	A	G	5	0	5	0	6	11	0	0
1	59143004	.	T	C	6	6	12	0	1	13	0	0
1	59143499	.	T	A	2	2	4	0	0	4	0	0
1	59143503	.	A	G	2	2	4	0	0	4	0	0
1	59146013	.	C	T	3	3	6	0	0	6	0	0
1	59146790	.	A	G	8	9	17	0	0	17	0	0
1	59148341	.	T	C	5	11	16	0	0	16	0	0
1	59149117	.	C	T	12	16	28	0	2	30	0	0
1	59149968	.	T	C	12	13	25	0	0	25	0	0
1	59150450	.	A	G	9	7	16	0	0	16	0	0
1	59150518	.	T	C	8	10	18	0	2	20	0	0
1	59150559	.	T	G	9	11	20	0	3	23	0	0
1	59150583	.	T	A	6	11	17	0	1	18	0	0
1	59150683	.	T	C	5	17	22	0	1	23	0	0
1	59150737	.	T	C	13	8	21	0	0	21	0	0
1	59150762	.	G	T	17	9	26	0	1	27	0	0
1	59150781	.	T	C	17	10	27	0	1	28	0	0
1	59154748	.	A	T	8	2	10	0	0	10	0	0
1	59156827	.	T	G	5	6	11	0	0	11	0	0
1	59157536	.	T	C	9	8	17	0	0	17	0	0
1	59157888	.	T	C	10	9	19	0	0	19	0	0
1	59157977	.	A	C	12	12	24	1	3	28	0	0
1	59158035	.	C	A	11	12	23	0	0	23	0	0
1	59158062	.	A	T	16	14	30	0	1	31	0	0
1	59158070	.	G	A	15	12	27	0	1	28	0	0
1	59172876	.	A	G	17	5	22	0	2	24	0	0
1	59172900	.	A	G	18	10	28	0	3	31	0	0
1	59172969	.	G	A	18	18	36	0	0	36	0	0
1	59173358	.	G	T	12	17	29	0	0	29	0	0
1	59173563	.	C	T	22	9	31	0	2	33	0	0
1	59173701	.	G	T	22	5	27	0	3	30	0	0
1	59173758	.	A	G	16	10	26	0	0	26	0	0
1	59173866	.	T	G	17	9	26	0	6	32	0	0
1	59173896	.	T	C	15	0	15	0	17	32	0	0
1	59174387	.	A	G	10	10	20	0	2	22	0	0
1	59174408	.	G	A	12	7	19	0	0	19	0	0
1	59174492	.	T	G	6	9	15	0	2	17	0	0
1	59174525	.	A	C	11	6	17	0	1	18	0	0
1	59174576	.	C	T	8	8	16	0	2	18	0	0
1	59174645	.	G	A	17	9	26	0	0	26	0	0
1	59174797	.	A	C	21	8	29	0	0	29	0	0
1	59174962	.	T	C	16	18	34	0	1	35	0	0
1	59175511	.	T	C	5	18	23	0	1	24	0	0
1	59175572	.	A	G	8	13	21	0	0	21	0	0
1	59175626	.	G	A	16	6	22	0	0	22	0	0
1	59175635	.	G	A	17	7	24	0	0	24	0	0
1	59175740	.	G	T	8	9	17	0	0	17	0	0
1	59175983	.	T	C	12	6	18	0	0	18	0	0
1	59175989	.	A	G	10	6	16	0	1	17	0	0
1	59176636	.	C	T	6	8	14	0	0	14	0	0
1	59176887	.	G	T	15	11	26	2	0	28	0	0
1	59176935	.	A	C	14	0	14	1	11	26	0	0
1	59218594	.	A	G	10	7	17	0	2	19	0	0
1	59226049	.	T	C	22	32	54	0	4	58	0	0
1	59226052	.	A	G	26	32	58	0	1	59	0	0
1	59226374	.	A	G	36	10	46	0	0	46	0	0
1	59228311	.	G	A	33	17	50	0	2	52	0	0
1	59228322	.	C	T	33	22	55	0	2	57	0	0
1	59228569	.	A	C	25	0	25	0	27	52	0	0
1	59229211	.	G	A	7	5	12	0	0	12	0	0
1	59232206	.	A	G	14	19	33	0	1	34	0	0
1	59232509	.	G	A	16	21	37	0	0	37	0	0
1	59235016	.	T	G	23	13	36	0	2	38	0	0
1	59238037	.	T	C	1	5	6	0	0	6	0	0
1	59238038	.	A	C	0	5	5	0	1	6	0	0
1	59244312	.	A	G	8	10	18	0	1	19	0	0
1	59244635	.	A	T	15	24	39	0	1	40	0	0
1	59244768	.	G	T	25	6	31	0	3	34	0	0
1	59244916	.	T	A	43	17	60	3	1	64	0	0
1	59244928	.	C	T	37	16	53	3	4	60	0	0
1	59245142	.	C	G	24	33	57	0	2	59	0	0
1	59245658	.	G	A	16	20	36	0	1	37	0	0
1	59245873	.	T	C	19	15	34	0	1	35	0	0
1	59245900	.	C	T	19	17	36	0	1	37	0	0
1	59246189	.	T	C	20	1	21	0	15	36	0	0
1	59246363	.	A	T	1	4	5	0	0	5	0	0
1	59247893	.	T	G	20	13	33	0	0	33	0	0
1	59247944	.	C	T	17	14	31	0	0	31	0	0
1	59248138	.	T	A	15	15	30	0	0	30	0	0
1	59251658	.	C	G	18	11	29	0	2	31	0	0
1	59251839	.	T	C	18	0	18	0	17	35	0	0
1	59293937	.	T	C	2	10	12	0	0	12	0	0
1	59293966	.	A	G	3	10	13	0	2	15	0	0
1	59297557	.	T	G	4	2	6	0	0	6	0	0
1	59297937	.	C	T	2	3	5	0	0	5	0	0
1	59298069	.	T	C	1	3	4	0	0	4	0	0
1	59298261	.	T	G	3	7	10	0	0	10	0	0
1	59302210	.	G	A	1	5	6	0	9	15	0	0
1	59302276	.	C	T	3	9	12	0	1	13	0	0
1	59302372	.	T	G	4	10	14	0	1	15	0	0
1	59302813	.	C	A	2	3	5	0	0	5	0	0
1	59303024	.	C	A	2	7	9	0	0	9	0	0
1	59303149	.	A	C	2	2	4	0	0	4	0	0
1	59303294	.	C	G	3	0	3	0	2	5	0	0
1	59304427	.	T	C	3	2	5	0	0	5	0	0
1	59304609	.	T	A	3	2	5	0	0	5	0	0
1	59305059	.	A	C	5	0	5	0	11	16	0	0
1	59305116	.	T	C	8	0	8	0	6	14	0	0
1	59305200	.	T	C	8	6	14	0	0	14	0	0
1	59309988	.	A	G	1	2	3	0	1	4	0	0
1	59310630	.	C	G	0	3	3	0	3	6	0	0
1	59312211	.	C	A	6	2	8	0	0	9	1	0
1	59313365	.	T	C	3	4	7	0	0	7	0	0
1	59314966	.	A	G	10	6	16	0	2	18	0	0
1	59318886	.	A	G	7	0	7	0	6	13	0	0
1	59321447	.	A	G	18	1	19	0	10	29	0	0
1	59324067	.	T	C	19	20	39	0	1	40	0	0
1	59328110	.	T	G	4	0	4	0	4	8	0	0
1	59328287	.	C	T	8	10	18	0	1	19	0	0
1	59328486	.	C	T	2	9	11	0	0	11	0	0
1	59329950	.	A	G	6	4	10	0	0	10	0	0
1	59329957	.	T	C	6	5	11	0	0	11	0	0
1	59330135	.	T	C	4	5	9	0	1	10	0	0
1	59330169	.	C	T	6	7	13	0	0	13	0	0
1	59409455	.	A	G	2	4	6	0	0	6	0	0
1	59411110	.	A	G	2	2	4	0	0	4	0	0
1	59542739	.	A	T	1	6	7	4	0	11	0	0
1	59555999	.	G	A	2	15	17	0	1	18	0	0
1	59566166	.	C	T	1	7	8	0	1	9	0	0
10	590087	.	A	G	2	5	7	0	1	8	0	0
10	590925	.	A	G	13	5	18	0	1	19	0	0
10	591476	.	A	G	6	0	6	0	8	14	0	0
10	1226809	.	T	C	2	7	9	0	0	9	0	0
10	1275715	.	G	T	2	3	5	0	2	7	0	0
10	1450286	.	G	A	6	7	13	0	0	13	0	0
10	1541357	.	G	C	3	1	4	0	16	20	0	0
10	1541359	.	T	C	3	1	4	0	17	21	0	0
10	1541499	.	C	T	1	18	19	0	3	22	0	0
10	1549384	.	G	A	9	3	12	0	2	14	0	0
10	1549406	.	A	G	11	4	15	0	1	16	0	0
10	1550478	.	G	C	4	2	6	0	0	6	0	0
10	1550499	.	G	T	6	3	9	0	0	9	0	0
10	1552657	.	T	C	6	4	10	0	0	10	0	0
10	1552767	.	G	A	7	2	9	0	0	9	0	0
10	1597332	.	A	G	6	10	16	0	0	16	0	0
10	1597396	.	G	A	9	12	21	0	1	22	0	0
10	1599468	.	C	T	3	6	9	0	1	10	0	0
10	1603967	.	T	C	2	5	7	0	1	8	0	0
10	1609683	.	T	C	4	3	7	0	0	7	0	0
10	1617480	.	C	A	1	4	5	0	0	5	0	0
10	1648044	.	T	C	8	9	17	0	1	18	0	0
10	1649691	.	T	C	11	7	18	0	1	19	0	0
10	1656257	.	C	T	3	5	8	0	0	8	0	0
10	1658184	.	T	C	11	8	19	0	0	19	0	0
10	1663101	.	T	C	9	11	20	0	2	22	0	0
10	1665572	.	A	G	10	0	10	0	11	21	0	0
10	1668159	.	C	T	17	15	32	0	2	34	0	0
10	1671442	.	A	T	8	7	15	0	0	15	0	0
10	1674291	.	C	T	10	11	21	0	0	21	0	0
10	1681712	.	A	T	7	7	14	0	0	14	0	0
10	1684563	.	T	G	6	12	18	0	0	18	0	0
10	1684742	.	A	G	1	4	5	0	0	5	0	0
10	1687078	.	C	T	3	3	6	0	0	6	0	0
10	1687094	.	C	T	3	4	7	0	0	7	0	0
10	1687547	.	C	T	21	23	44	0	2	46	0	0
10	1694456	.	T	A	17	12	29	1	3	33	0	0
10	1708197	.	T	A	16	20	36	0	1	37	0	0
10	1708230	.	T	C	19	19	38	0	1	39	0	0
10	1708239	.	A	T	18	19	37	0	2	39	0	0
10	1708412	.	A	T	22	27	49	0	4	53	0	0
10	1709165	.	T	A	29	21	50	0	2	52	0	0
10	1709331	.	T	G	24	23	47	0	0	48	1	0
10	1709731	.	G	A	32	20	52	0	3	55	0	0
10	1709783	.	G	A	30	27	57	0	3	60	0	0
10	1709836	.	T	G	26	18	44	0	5	49	0	0
10	1709855	.	C	T	29	19	48	0	1	49	0	0
10	1709871	.	G	A	28	17	45	0	2	47	0	0
10	1710270	.	A	G	26	16	42	0	2	44	0	0
10	1710358	.	C	T	23	11	34	0	2	36	0	0
10	1711061	.	T	C	18	1	19	0	13	32	0	0
10	1711136	.	T	C	23	23	46	0	0	46	0	0
10	1711188	.	T	A	17	19	36	0	3	39	0	0
10	1711211	.	C	T	21	14	35	0	2	37	0	0
10	1711599	.	T	C	12	0	12	0	13	25	0	0
10	1711623	.	G	A	12	17	29	0	0	29	0	0
10	1711711	.	G	A	19	18	37	0	2	39	0	0
10	1711780	.	C	T	3	13	16	1	13	30	0	0
10	1711854	.	G	T	7	13	20	0	18	38	0	0
10	1712091	.	G	A	17	8	25	1	3	29	0	0
10	1712100	.	T	A	23	7	30	1	1	32	0	0
10	1712306	.	G	A	13	21	34	0	0	34	0	0
10	1712316	.	C	T	11	17	28	0	2	30	0	0
10	1712570	.	C	A	23	7	30	0	3	33	0	0
10	1712658	.	G	A	20	14	34	1	2	37	0	0
10	1712757	.	A	G	14	22	36	0	1	37	0	0
10	1712899	.	A	T	26	14	40	0	1	41	0	0
10	1712964	.	T	G	43	2	45	0	2	47	0	0
10	1713418	.	T	C	11	20	31	0	3	34	0	0
10	1718294	.	C	A	24	20	44	0	2	46	0	0
10	1745541	.	A	T	6	4	10	0	0	10	0	0
10	1745738	.	T	A	6	5	11	0	0	11	0	0
10	1752122	.	C	A	4	6	10	0	0	10	0	0
10	1776112	.	G	A	3	4	7	0	0	7	0	0
10	1798869	.	T	G	2	4	6	0	2	8	0	0
10	1866818	.	G	A	2	7	9	0	1	10	0	0
10	1869266	.	G	A	9	9	18	0	1	19	0	0
10	1869313	.	G	T	8	10	18	0	1	19	0	0
10	1869328	.	C	T	7	9	16	0	1	17	0	0
10	1871634	.	G	T	0	12	12	0	4	16	0	0
10	1880470	.	A	G	12	12	24	0	0	24	0	0
10	1880734	.	C	T	6	6	12	0	0	12	0	0
10	1885891	.	A	C	7	10	17	0	0	17	0	0
10	1886182	.	C	T	8	7	15	0	0	15	0	0
10	1886265	.	C	G	12	11	23	0	0	23	0	0
10	1886587	.	T	C	10	12	22	0	0	22	0	0
10	1886590	.	T	A	11	10	21	0	3	24	0	0
10	1886764	.	T	C	14	11	25	0	1	26	0	0
10	1887238	.	C	T	13	11	24	0	0	24	0	0
10	1887364	.	C	T	18	6	24	0	1	25	0	0
10	1887496	.	A	G	12	1	13	0	17	30	0	0
10	1887811	.	A	G	11	14	25	0	1	26	0	0
10	1888135	.	G	C	14	15	29	0	1	30	0	0
10	1888222	.	C	T	15	14	29	0	0	29	0	0
10	1888225	.	G	A	15	13	28	0	1	29	0	0
10	1888303	.	C	T	18	13	31	0	0	31	0	0
10	1888414	.	T	C	19	17	36	0	3	39	0	0
10	1888438	.	C	T	15	20	35	0	3	38	0	0
10	1888487	.	T	C	15	17	32	0	1	33	0	0
10	1888515	.	C	T	19	13	32	0	1	33	0	0
10	1888824	.	C	T	15	14	29	0	0	29	0	0
10	1888893	.	C	T	19	15	34	0	0	34	0	0
10	1889171	.	G	T	23	13	36	0	1	37	0	0
10	1889179	.	A	G	19	1	20	0	14	34	0	0
10	1889255	.	C	T	12	13	25	0	1	26	0	0
10	1889296	.	C	T	13	16	29	0	1	30	0	0
10	1889882	.	A	C	23	17	40	0	0	40	0	0
10	1890313	.	A	G	21	22	43	0	0	43	0	0
10	1890949	.	T	C	19	19	38	0	1	39	0	0
10	1890961	.	G	A	15	24	39	0	0	39	0	0
10	1891018	.	G	A	2	17	19	0	20	39	0	0
10	1891660	.	G	C	21	15	36	0	0	36	0	0
10	1891724	.	G	C	28	27	55	0	1	56	0	0
10	1892516	.	G	A	20	11	31	0	1	32	0	0
10	2234379	.	C	T	5	7	12	0	0	12	0	0
10	2255014	.	T	C	6	5	11	0	2	13	0	0
10	2261897	.	A	T	2	4	6	0	0	6	0	0
10	2261921	.	G	C	6	2	8	0	0	8	0	0
10	2283925	.	C	T	3	9	12	0	0	12	0	0
10	2286689	.	G	A	6	5	11	0	0	11	0	0
10	2292380	.	G	T	12	8	20	0	1	21	0	0
10	2294325	.	G	A	12	8	20	0	0	20	0	0
10	2328740	.	C	A	5	11	16	0	1	17	0	0
10	2339274	.	C	T	8	8	16	2	0	18	0	0
10	2354973	.	C	A	5	9	14	0	0	14	0	0
10	2393715	.	G	A	16	9	25	0	2	27	0	0
10	2393763	.	G	C	11	22	33	0	3	36	0	0
10	2504174	.	G	T	21	9	30	0	5	35	0	0
10	2504210	.	C	T	4	12	16	0	23	39	0	0
10	2506081	.	G	A	21	20	41	0	2	43	0	0
10	2508347	.	T	C	17	1	18	0	6	24	0	0
10	2510397	.	C	G	1	14	15	0	15	30	0	0
10	2515351	.	T	G	19	10	29	0	1	30	0	0
10	2515447	.	T	C	13	0	13	0	14	27	0	0
10	2526413	.	A	G	19	14	33	0	0	34	1	0
10	2542000	.	C	T	1	2	3	0	0	3	0	0
10	2547663	.	A	G	1	2	3	0	0	3	0	0
10	2575204	.	A	G	15	0	15	0	12	27	0	0
10	2575369	.	T	C	7	9	16	0	0	16	0	0
10	2663002	.	C	T	1	2	3	0	1	4	0	0
10	2663216	.	C	T	3	2	5	0	0	5	0	0
10	2666335	.	T	C	2	2	4	0	1	5	0	0
10	2666387	.	A	G	5	0	5	0	4	9	0	0
10	2666480	.	A	G	2	3	5	0	0	5	0	0
10	2666537	.	A	C	1	3	4	0	0	4	0	0
10	2681622	.	C	T	13	6	19	0	0	19	0	0
10	2681771	.	G	A	6	7	13	0	1	14	0	0
10	2681800	.	C	T	0	9	9	0	7	16	0	0
10	2697449	.	C	T	0	3	3	0	1	4	0	0
10	2704653	.	C	T	2	5	7	0	0	7	0	0
10	2704752	.	G	T	7	9	16	0	1	17	0	0
10	2759276	.	G	A	16	9	25	0	1	26	0	0
10	2759329	.	T	G	13	11	24	0	1	25	0	0
10	2759381	.	G	C	14	14	28	0	2	30	0	0
10	2759391	.	A	T	16	17	33	0	2	35	0	0
10	2772036	.	G	A	7	7	14	0	0	14	0	0
10	2772057	.	G	A	7	7	14	0	1	15	0	0
10	2778444	.	G	A	8	11	19	0	1	20	0	0
10	2782761	.	G	A	8	7	15	0	2	17	0	0
10	2788649	.	A	T	12	8	20	0	1	21	0	0
10	2836139	.	T	A	1	2	3	0	0	3	0	0
10	2837968	.	C	T	1	2	3	0	0	3	0	0
10	2843022	.	G	A	10	4	14	0	1	15	0	0
10	2846887	.	C	T	6	5	11	0	0	11	0	0
10	2848976	.	A	G	5	2	7	0	0	7	0	0
10	2850332	.	A	G	5	2	7	0	0	7	0	0
10	2850416	.	G	A	3	7	10	0	0	10	0	0
10	2850608	.	G	C	2	2	4	1	0	5	0	0
10	2850614	.	G	T	1	2	3	1	1	5	0	0
10	2850675	.	A	G	2	0	2	0	5	7	0	0
10	2856558	.	G	A	2	2	4	0	5	9	0	0
10	2856584	.	G	T	9	6	15	0	0	15	0	0
10	2860806	.	G	A	4	10	14	0	0	14	0	0
10	2861679	.	T	C	2	0	2	0	8	10	0	0
10	2862538	.	T	A	1	6	7	0	1	8	0	0
10	2880537	.	A	G	1	3	4	0	0	4	0	0
10	2882230	.	C	T	2	2	4	0	0	4	0	0
10	2882422	.	T	G	3	5	8	0	0	8	0	0
10	2884136	.	G	C	0	3	3	0	7	10	0	0
10	2885852	.	C	T	5	11	16	0	2	18	0	0
10	2888166	.	C	A	8	5	13	0	0	13	0	0
10	2891893	.	C	T	11	7	18	0	0	18	0	0
10	2891981	.	A	T	3	11	14	0	1	15	0	0
10	2894451	.	G	A	1	9	10	0	10	20	0	0
10	2894545	.	C	T	15	11	26	0	0	26	0	0
10	2894610	.	G	C	13	14	27	0	0	27	0	0
10	2907413	.	A	G	1	4	5	0	0	5	0	0
10	2907422	.	T	C	3	2	5	0	2	7	0	0
10	2908907	.	G	A	0	4	4	0	1	5	0	0
10	2909135	.	G	A	2	3	5	0	0	5	0	0
10	2910471	.	C	T	1	4	5	0	0	5	0	0
10	2910570	.	T	A	2	5	7	0	0	7	0	0
10	2910605	.	C	T	2	6	8	0	0	8	0	0
10	2914955	.	G	A	0	5	5	0	3	8	0	0
10	2915426	.	C	T	3	8	11	0	0	11	0	0
10	2915462	.	G	A	1	3	4	0	7	11	0	0
10	2916931	.	A	T	3	3	6	0	0	6	0	0
10	2921163	.	A	G	3	2	5	0	0	5	0	0
10	2925196	.	T	A	2	5	7	0	2	9	0	0
10	2925639	.	G	A	2	12	14	0	0	14	0	0
10	2981146	.	T	C	3	2	5	0	0	5	0	0
10	2983370	.	T	C	1	3	4	0	0	4	0	0
10	2983543	.	C	T	2	2	4	0	0	4	0	0
10	2983662	.	G	A	0	2	2	0	1	3	0	0
10	2984003	.	A	G	2	0	2	0	3	5	0	0
10	2984171	.	A	T	1	3	4	0	0	4	0	0
10	2984435	.	C	T	4	2	6	0	0	6	0	0
10	2984596	.	G	A	3	2	5	0	0	5	0	0
10	2984819	.	G	C	0	3	3	0	1	4	0	0
10	2985032	.	G	T	0	2	2	0	2	4	0	0
10	3010820	.	C	G	8	4	12	0	0	12	0	0
10	3012802	.	T	C	2	3	5	0	0	5	0	0
10	3016263	.	T	C	7	4	11	0	0	11	0	0
10	3016329	.	C	T	6	3	9	0	0	9	0	0
10	3022076	.	G	T	10	6	16	0	0	16	0	0
10	3026376	.	A	G	3	5	8	0	1	9	0	0
10	3026521	.	A	C	4	5	9	0	0	9	0	0
10	3031760	.	A	G	10	3	13	0	0	13	0	0
10	3032731	.	G	C	4	2	6	0	0	6	0	0
10	3032743	.	T	C	3	3	6	0	0	6	0	0
10	3032806	.	T	C	1	6	7	0	0	7	0	0
10	3085477	.	C	T	1	3	4	0	0	4	0	0
10	3088308	.	C	G	3	4	7	0	0	7	0	0
10	3088343	.	G	A	3	3	6	0	0	6	0	0
10	3133204	.	T	A	6	7	13	0	1	14	0	0
10	3133251	.	G	A	7	7	14	0	0	14	0	0
10	3133598	.	A	C	6	6	12	0	1	13	0	0
10	3154576	.	C	T	6	3	9	0	1	10	0	0
10	3154684	.	A	G	4	5	9	0	0	9	0	0
10	3154825	.	C	G	2	2	4	0	0	4	0	0
10	3155314	.	T	C	5	3	8	0	0	8	0	0
10	3155882	.	G	A	2	3	5	0	0	5	0	0
10	3189081	.	G	A	16	22	38	0	0	38	0	0
10	3191133	.	A	C	15	1	16	0	6	22	0	0
10	3192786	.	G	A	9	7	16	0	0	16	0	0
10	3194054	.	T	C	8	7	15	0	1	16	0	0
10	3197593	.	A	G	17	5	22	0	1	23	0	0
10	3201871	.	G	A	11	8	19	0	0	19	0	0
10	3204658	.	A	G	4	8	12	0	0	12	0	0
10	3207591	.	A	G	7	6	13	0	0	13	0	0
10	3207612	.	A	G	9	6	15	0	0	15	0	0
10	3207646	.	C	T	7	3	10	0	0	10	0	0
10	3212906	.	A	G	4	2	6	0	1	7	0	0
10	3228531	.	A	G	5	7	12	0	0	12	0	0
10	3230096	.	G	A	2	5	7	0	0	7	0	0
10	3230144	.	C	A	1	3	4	0	3	7	0	0
10	3232637	.	T	C	4	4	8	0	1	9	0	0
10	3242885	.	G	A	4	6	10	0	0	10	0	0
10	3247444	.	A	G	4	3	7	0	0	7	0	0
10	3250167	.	T	C	1	2	3	0	0	3	0	0
10	3252985	.	G	A	6	7	13	0	0	13	0	0
10	3268729	.	A	C	2	4	6	0	0	6	0	0
10	3269607	.	G	A	2	5	7	0	0	7	0	0
10	3302798	.	C	T	4	8	12	0	0	12	0	0
10	3308482	.	G	A	1	8	9	0	5	14	0	0
10	3314596	.	T	C	8	13	21	0	0	21	0	0
10	3317675	.	C	T	14	12	26	0	0	26	0	0
10	3317800	.	C	A	13	6	19	0	1	20	0	0
10	3317823	.	G	T	13	9	22	0	2	24	0	0
10	3318005	.	G	C	3	4	7	0	11	18	0	0
10	3318060	.	G	A	10	3	13	0	0	13	0	0
10	3318112	.	G	C	9	12	21	0	0	21	0	0
10	3318729	.	A	T	5	3	8	0	0	8	0	0
10	3319352	.	A	G	8	11	19	1	3	23	0	0
10	3319515	.	A	G	9	2	11	0	0	11	0	0
10	3319830	.	C	T	8	10	18	0	0	18	0	0
10	3319938	.	C	T	8	11	19	0	2	21	0	0
10	3319970	.	G	A	7	11	18	0	3	21	0	0
10	3320072	.	T	G	18	16	34	0	0	34	0	0
10	3320151	.	A	G	10	23	33	0	0	33	0	0
10	3320194	.	G	A	11	16	27	0	0	27	0	0
10	3320355	.	A	T	7	12	19	0	0	19	0	0
10	3320776	.	C	T	11	19	30	0	1	31	0	0
10	3320834	.	A	C	16	11	27	0	1	28	0	0
10	3321262	.	A	G	8	23	31	0	3	34	0	0
10	3321273	.	A	G	18	15	33	0	1	34	0	0
10	3321416	.	T	G	14	9	23	0	0	23	0	0
10	3322004	.	C	G	12	12	24	0	0	24	0	0
10	3322012	.	C	T	11	13	24	0	1	25	0	0
10	3322276	.	G	C	4	3	7	0	2	9	0	0
10	3341367	.	C	T	6	7	13	0	0	13	0	0
10	3342716	.	G	T	4	3	7	0	0	7	0	0
10	3342795	.	T	C	7	9	16	0	0	16	0	0
10	3345554	.	C	T	9	5	14	0	0	14	0	0
10	3353607	.	C	T	10	9	19	0	2	21	0	0
10	3353622	.	A	G	8	7	15	0	0	15	0	0
10	3354048	.	A	G	4	11	15	0	1	16	0	0
10	3355651	.	T	C	10	11	21	0	0	21	0	0
10	3358897	.	A	T	9	10	19	0	4	23	0	0
10	3364772	.	A	T	2	6	8	0	0	8	0	0
10	3365063	.	C	T	1	11	12	2	12	26	0	0
10	3365726	.	A	C	23	0	23	1	0	24	0	0
10	3365834	.	A	T	6	14	20	0	0	20	0	0
10	3366125	.	G	A	10	9	19	0	2	21	0	0
10	3366126	.	A	T	11	9	20	0	1	21	0	0
10	3367810	.	C	T	10	9	19	0	1	20	0	0
10	3370680	.	G	A	3	8	11	0	1	12	0	0
10	3375418	.	T	C	9	3	12	0	0	12	0	0
10	3377207	.	T	A	6	5	11	0	0	11	0	0
10	3377222	.	T	C	4	0	4	0	6	10	0	0
10	3385835	.	T	C	4	5	9	0	0	9	0	0
10	3385886	.	T	C	9	0	9	0	3	12	0	0
10	3385895	.	C	T	8	2	10	0	1	11	0	0
10	3386121	.	A	G	2	3	5	0	0	5	0	0
10	3388200	.	T	G	8	5	13	0	0	13	0	0
10	3403832	.	C	A	1	2	3	0	0	3	0	0
10	3403878	.	C	G	0	2	2	0	3	5	0	0
10	3420097	.	A	T	13	20	33	0	0	33	0	0
10	3420148	.	G	A	17	12	29	0	3	32	0	0
10	3420358	.	T	C	10	8	18	1	2	21	0	0
10	3426363	.	G	A	20	20	40	0	3	43	0	0
10	3430894	.	C	G	7	3	10	0	0	10	0	0
10	3434883	.	C	T	3	3	6	0	0	6	0	0
10	3435321	.	T	A	4	2	6	0	1	7	0	0
10	3438991	.	T	C	4	4	8	0	0	8	0	0
10	3439018	.	A	G	5	3	8	0	0	8	0	0
10	3441753	.	T	A	3	6	9	0	0	9	0	0
10	3441980	.	T	C	7	5	12	0	1	13	0	0
10	3442030	.	T	C	9	5	14	0	1	15	0	0
10	3450825	.	G	C	5	9	14	1	0	15	0	0
10	3450863	.	A	T	11	8	19	0	0	19	0	0
10	3451091	.	G	A	7	6	13	0	0	13	0	0
10	3451325	.	G	C	8	12	20	0	1	21	0	0
10	3451333	.	G	A	8	9	17	0	0	17	0	0
10	3451864	.	C	T	7	6	13	0	2	15	0	0
10	3452007	.	A	T	5	7	12	0	0	12	0	0
10	3452124	.	A	G	9	6	15	0	0	15	0	0
10	3452265	.	C	A	3	5	8	0	4	12	0	0
10	3452314	.	T	C	9	4	13	0	0	13	0	0
10	3884936	.	G	A	1	5	6	0	0	6	0	0
10	3943248	.	G	A	1	5	6	0	3	9	0	0
10	3969326	.	G	A	4	2	6	0	0	6	0	0
10	3969491	.	G	T	3	2	5	0	0	5	0	0
10	3969786	.	C	T	3	3	6	0	0	6	0	0
10	3969887	.	C	T	3	3	6	0	1	7	0	0
10	3969956	.	T	C	5	5	10	0	4	14	0	0
10	3980002	.	C	T	4	6	10	0	1	11	0	0
10	3987505	.	T	C	2	3	5	0	0	5	0	0
10	3987526	.	A	G	4	4	8	0	0	8	0	0
10	3999676	.	C	T	6	7	13	1	1	15	0	0
10	4010297	.	G	A	4	5	9	0	0	9	0	0
10	4024798	.	G	A	5	4	9	0	2	11	0	0
10	4029507	.	T	C	10	3	13	0	0	13	0	0
10	4029634	.	A	G	7	4	11	0	0	11	0	0
10	4029813	.	C	T	8	8	16	0	1	17	0	0
10	4030211	.	A	T	5	3	8	0	0	8	0	0
10	4034098	.	T	C	13	6	19	0	0	19	0	0
10	4037794	.	T	C	8	12	20	0	1	21	0	0
10	4038334	.	G	A	10	5	15	0	3	18	0	0
10	4038697	.	C	T	9	11	20	0	0	20	0	0
10	4038721	.	G	A	1	11	12	0	10	22	0	0
10	4038898	.	A	G	10	11	21	0	1	22	0	0
10	4039094	.	G	A	16	11	27	0	4	31	0	0
10	4039315	.	A	T	16	17	33	0	0	33	0	0
10	4039636	.	T	C	9	11	20	0	0	20	0	0
10	4039714	.	T	C	10	15	25	0	1	26	0	0
10	4060322	.	T	C	3	5	8	0	0	8	0	0
10	4067500	.	T	G	2	3	5	0	0	5	0	0
10	4096039	.	T	C	2	7	9	0	0	9	0	0
10	4096159	.	A	G	3	0	3	0	6	9	0	0
10	4096198	.	C	G	3	6	9	0	0	9	0	0
10	4096417	.	T	C	1	2	3	0	0	3	0	0
10	4096436	.	T	C	1	4	5	0	0	5	0	0
10	4096744	.	C	G	3	3	6	0	0	6	0	0
10	4096840	.	T	C	2	6	8	0	3	11	0	0
10	4096885	.	T	C	6	3	9	0	1	10	0	0
10	4098235	.	C	T	10	12	22	0	0	22	0	0
10	4098355	.	A	T	4	5	9	0	1	10	0	0
10	4253636	.	C	T	14	24	38	0	1	39	0	0
10	4279695	.	T	C	1	3	4	0	0	4	0	0
10	4290771	.	A	G	1	3	4	0	0	4	0	0
10	4299285	.	C	T	1	2	3	0	0	3	0	0
10	4369890	.	A	C	1	2	3	0	0	3	0	0
10	4500050	.	G	A	13	9	22	0	0	22	0	0
10	4500134	.	G	A	8	7	15	0	1	16	0	0
10	4501609	.	C	T	10	5	15	0	1	16	0	0
10	4501733	.	G	A	8	11	19	0	0	19	0	0
10	4502929	.	C	T	14	7	21	0	0	21	0	0
10	4503606	.	A	T	11	10	21	0	0	21	0	0
10	4503736	.	C	T	12	10	22	0	2	24	0	0
10	4503901	.	C	G	16	11	27	0	0	27	0	0
10	4505886	.	T	A	13	13	26	0	2	28	0	0
10	4505887	.	T	A	13	14	27	0	1	28	0	0
10	4508492	.	T	A	15	9	24	0	0	24	0	0
10	4808047	.	G	A	4	2	6	0	0	6	0	0
10	4888387	.	C	A	5	4	9	0	0	9	0	0
10	4888457	.	A	G	6	3	9	0	0	9	0	0
10	4888582	.	A	G	4	0	4	0	5	9	0	0
10	4888666	.	A	G	3	0	3	0	6	9	0	0
10	4888808	.	C	T	3	3	6	0	0	6	0	0
10	4888832	.	G	A	0	4	4	0	4	8	0	0
10	4889119	.	A	T	3	4	7	0	0	7	0	0
10	4889228	.	C	T	3	5	8	0	0	8	0	0
10	4889248	.	T	C	4	4	8	0	0	8	0	0
10	4889302	.	C	A	2	6	8	0	0	8	0	0
10	4889704	.	A	G	13	10	23	0	1	24	0	0
10	4889923	.	A	G	2	0	2	0	4	6	0	0
10	4890027	.	C	T	4	5	9	0	0	9	0	0
10	4890082	.	G	C	2	4	6	0	0	6	0	0
10	4896742	.	G	A	9	4	13	0	0	13	0	0
10	4896766	.	G	A	7	4	11	0	0	11	0	0
10	4940895	.	A	G	3	8	11	0	0	11	0	0
10	4941113	.	A	G	6	9	15	0	0	15	0	0
10	4941342	.	G	C	9	10	19	0	1	20	0	0
10	4941421	.	T	G	9	3	12	0	1	13	0	0
10	4950914	.	T	C	7	0	7	0	14	21	0	0
10	4953443	.	C	T	9	5	14	0	1	15	0	0
10	4953461	.	C	A	6	6	12	0	0	12	0	0
10	4953987	.	A	C	10	0	10	0	15	25	0	0
10	4954125	.	T	C	4	6	10	0	0	10	0	0
10	4956942	.	C	T	1	4	5	0	7	12	0	0
10	4956966	.	G	A	6	4	10	0	0	10	0	0
10	4956987	.	C	T	0	6	6	0	5	11	0	0
10	5093140	.	T	C	2	5	7	1	0	8	0	0
10	5535047	.	A	T	10	3	13	1	0	14	0	0
10	5535048	.	C	G	11	3	14	1	0	15	0	0
10	5789806	.	C	T	9	8	17	0	1	18	0	0
10	5789995	.	C	T	4	7	11	0	1	12	0	0
10	5790135	.	T	C	7	3	10	1	0	11	0	0
10	6004615	.	C	A	1	4	5	0	1	6	0	0
10	6016242	.	G	A	2	2	4	0	1	5	0	0
10	6016342	.	G	T	1	4	5	0	0	5	0	0
10	6016545	.	G	T	4	4	8	0	0	8	0	0
10	6016578	.	A	T	4	2	6	0	0	6	0	0
10	6022033	.	A	C	4	2	6	0	0	6	0	0
10	6028157	.	A	G	10	6	16	0	0	16	0	0
10	6033612	.	G	A	0	12	12	0	5	17	0	0
10	6033627	.	A	T	5	10	15	0	0	15	0	0
10	6034194	.	A	T	1	3	4	0	0	4	0	0
10	6255082	.	C	T	1	3	4	0	0	4	0	0
10	6263593	.	G	A	2	3	5	0	0	5	0	0
10	6265475	.	A	G	2	5	7	0	1	8	0	0
10	6265478	.	G	T	0	3	3	0	5	8	0	0
10	6280939	.	G	A	0	5	5	0	2	7	0	0
10	6280948	.	G	A	0	4	4	0	2	6	0	0
10	6301828	.	C	T	6	4	10	0	1	11	0	0
10	6301930	.	C	T	9	11	20	0	1	21	0	0
10	6313001	.	A	T	7	6	13	0	0	13	0	0
10	6313003	.	C	T	7	5	12	0	1	13	0	0
10	6340597	.	T	C	9	7	16	0	2	18	0	0
10	6340715	.	T	G	9	13	22	0	1	23	0	0
10	6348571	.	C	A	3	12	15	1	2	18	0	0
10	6350148	.	C	T	9	11	20	0	0	20	0	0
10	6372501	.	C	T	7	13	20	0	0	20	0	0
10	6372915	.	G	A	11	8	19	0	0	19	0	0
10	6372964	.	T	C	11	7	18	0	0	18	0	0
10	6372965	.	G	A	0	11	11	0	6	17	0	0
10	6373003	.	T	C	7	2	9	0	1	10	0	0
10	6373060	.	A	T	4	6	10	0	1	11	0	0
10	6373079	.	C	G	8	4	12	0	1	13	0	0
10	6373332	.	A	T	10	5	15	0	0	15	0	0
10	6373336	.	C	G	10	5	15	0	0	15	0	0
10	6373378	.	A	C	8	6	14	0	0	14	0	0
10	6373430	.	G	A	2	5	7	0	0	7	0	0
10	6373522	.	A	T	7	4	11	0	1	16	4	0
10	6373524	.	A	G	8	5	13	0	2	15	0	0
10	6373708	.	A	G	7	0	7	0	4	11	0	0
10	6373891	.	C	G	8	6	14	0	0	14	0	0
10	6373931	.	C	T	9	5	14	0	0	14	0	0
10	6374279	.	G	A	1	14	15	0	11	26	0	0
10	6374352	.	C	T	11	18	29	0	2	31	0	0
10	6374372	.	A	G	20	16	36	0	1	37	0	0
10	6374501	.	A	G	10	8	18	0	0	18	0	0
10	6374771	.	C	A	9	8	17	0	0	17	0	0
10	6374906	.	C	T	16	10	26	0	1	27	0	0
10	6374982	.	A	G	4	3	7	0	2	9	0	0
10	6375041	.	T	A	2	4	6	0	0	6	0	0
10	6400925	.	A	T	1	3	4	0	0	4	0	0
10	6401834	.	G	A	2	4	6	0	0	6	0	0
10	6401879	.	C	T	2	3	5	0	0	5	0	0
10	6401884	.	T	A	2	3	5	0	0	5	0	0
10	6401968	.	T	A	2	2	4	0	0	4	0	0
10	6401969	.	C	T	2	2	4	0	0	4	0	0
10	6402110	.	C	T	2	5	7	0	0	7	0	0
10	6402111	.	A	G	2	5	7	0	0	7	0	0
10	6402146	.	C	T	4	3	7	0	0	7	0	0
10	6402162	.	C	A	3	3	6	0	0	6	0	0
10	6402658	.	G	A	0	6	6	1	1	8	0	0
10	6402660	.	C	G	1	1	2	1	5	8	0	0
10	6402706	.	C	T	1	5	6	0	0	6	0	0
10	6402742	.	C	G	3	2	5	0	0	5	0	0
10	6402882	.	C	A	1	2	3	0	0	3	0	0
10	6404358	.	T	A	1	5	6	0	0	6	0	0
10	6404864	.	A	G	4	0	4	0	4	8	0	0
10	6404899	.	G	T	5	5	10	0	0	10	0	0
10	6404900	.	G	T	5	5	10	0	0	10	0	0
10	6404938	.	G	A	2	1	3	0	1	4	0	0
10	6405275	.	A	T	2	3	5	0	0	5	0	0
10	6405430	.	A	T	6	3	9	0	0	9	0	0
10	6405742	.	A	G	2	4	6	0	0	6	0	0
10	6406647	.	C	G	1	0	1	0	2	3	0	0
10	6407457	.	T	G	4	4	8	0	0	8	0	0
10	6407559	.	A	T	1	6	7	0	1	8	0	0
10	6407904	.	C	T	3	4	7	1	0	8	0	0
10	6408843	.	G	A	2	2	4	0	4	8	0	0
10	6408955	.	T	G	13	0	13	0	8	21	0	0
10	6408986	.	A	G	14	6	20	0	0	20	0	0
10	6409067	.	T	C	10	6	16	0	0	16	0	0
10	6409095	.	G	A	1	9	10	0	7	17	0	0
10	6409120	.	G	A	7	6	13	0	0	13	0	0
10	6409145	.	G	C	4	8	12	0	0	12	0	0
10	6409171	.	T	C	4	5	9	0	0	9	0	0
10	6409183	.	G	A	0	4	4	0	3	7	0	0
10	6409219	.	G	A	5	3	8	0	0	8	0	0
10	6409224	.	A	G	6	3	9	0	0	9	0	0
10	6409267	.	C	A	5	4	9	0	0	9	0	0
10	6409380	.	A	C	3	6	9	0	0	9	0	0
10	6409453	.	G	A	1	5	6	0	1	7	0	0
10	6409455	.	T	A	1	6	7	0	0	7	0	0
10	6409488	.	C	G	5	4	9	0	0	9	0	0
10	6409515	.	T	A	5	6	11	0	1	12	0	0
10	6473293	.	A	C	5	3	8	0	0	8	0	0
10	6473412	.	C	T	0	12	12	0	14	26	0	0
10	6473544	.	T	C	8	16	24	0	0	24	0	0
10	6473553	.	G	A	14	6	20	0	2	22	0	0
10	6473685	.	T	C	11	11	22	0	0	22	0	0
10	6473704	.	C	G	15	13	28	0	0	28	0	0
10	6473851	.	A	G	16	14	30	0	1	31	0	0
10	6473908	.	A	G	12	14	26	0	1	27	0	0
10	6473996	.	T	C	9	14	23	0	0	23	0	0
10	6474014	.	C	T	8	11	19	0	3	22	0	0
10	6474057	.	T	A	11	9	20	0	1	21	0	0
10	6486330	.	T	C	6	10	16	0	0	16	0	0
10	6490083	.	A	G	16	7	23	0	0	23	0	0
10	6496294	.	C	A	28	24	52	0	6	58	0	0
10	6517593	.	T	A	36	32	68	0	0	68	0	0
10	6517726	.	C	T	23	14	37	0	0	37	0	0
10	6518039	.	T	C	3	5	8	0	1	9	0	0
10	6521716	.	C	T	0	7	7	0	5	12	0	0
10	6521877	.	A	C	5	6	11	0	1	12	0	0
10	6522232	.	A	T	4	6	10	1	0	11	0	0
10	6522297	.	C	T	1	8	9	0	5	14	0	0
10	6531014	.	A	G	7	7	14	0	0	14	0	0
10	6536350	.	C	T	6	2	8	0	0	8	0	0
10	6549276	.	T	C	3	2	5	0	1	6	0	0
10	6553319	.	G	A	4	4	8	0	1	9	0	0
10	6560202	.	C	A	4	3	7	0	0	7	0	0
10	6569432	.	G	T	1	6	7	0	0	7	0	0
10	6582700	.	T	G	1	2	3	0	1	4	0	0
10	6781372	.	T	A	11	15	26	0	0	26	0	0
10	6781786	.	A	T	6	4	10	0	1	11	0	0
10	6781976	.	C	T	16	7	23	0	1	24	0	0
10	6782020	.	G	C	7	11	18	3	0	21	0	0
10	6782220	.	A	G	9	5	14	3	1	18	0	0
10	6782454	.	C	G	6	15	21	0	1	22	0	0
10	6782489	.	T	G	8	17	25	0	1	26	0	0
10	6782636	.	T	A	21	17	38	0	1	39	0	0
10	6786326	.	C	T	2	24	26	0	12	38	0	0
10	6786386	.	G	A	22	11	33	0	3	36	0	0
10	6804756	.	T	C	8	0	8	0	12	20	0	0
10	6809640	.	A	T	12	16	28	0	0	28	0	0
10	6809681	.	C	T	1	13	14	0	16	30	0	0
10	6824845	.	A	T	5	16	21	0	0	21	0	0
10	6824877	.	T	G	4	7	11	0	0	11	0	0
10	6825172	.	A	G	11	7	18	0	0	18	0	0
10	6831298	.	C	T	2	8	10	0	4	14	0	0
10	6831446	.	T	C	2	9	11	0	0	11	0	0
10	6831455	.	G	A	8	2	10	0	0	10	0	0
10	6834065	.	A	T	6	6	12	0	0	12	0	0
10	6834341	.	G	A	6	10	16	0	0	16	0	0
10	6834380	.	C	A	2	10	12	1	5	18	0	0
10	6849279	.	A	G	8	4	12	0	0	12	0	0
10	6850866	.	G	A	9	5	14	0	0	14	0	0
10	6853641	.	A	G	7	9	16	0	1	17	0	0
10	6858115	.	G	C	9	8	17	0	0	17	0	0
10	6858160	.	C	T	6	6	12	0	0	12	0	0
10	6865347	.	C	A	9	4	13	0	0	13	0	0
10	6865350	.	T	G	8	4	12	0	1	13	0	0
10	6928055	.	C	A	1	2	3	0	0	3	0	0
10	7050408	.	A	G	11	11	22	0	1	23	0	0
10	7050476	.	C	T	10	9	19	0	1	20	0	0
10	7050618	.	A	G	4	4	8	0	6	14	0	0
10	7050718	.	A	T	12	9	21	0	0	21	0	0
10	7051093	.	A	T	7	9	16	0	1	17	0	0
10	7057746	.	C	T	10	5	15	0	1	16	0	0
10	7057800	.	C	T	6	3	9	0	3	12	0	0
10	7057881	.	T	C	5	4	9	0	0	9	0	0
10	7057984	.	C	A	9	9	18	0	1	19	0	0
10	7058082	.	A	T	3	6	9	0	0	9	0	0
10	7102468	.	T	G	5	3	8	1	0	9	0	0
10	7210001	.	G	A	0	21	21	0	25	46	0	0
10	7221810	.	A	G	18	16	34	0	5	39	0	0
10	7222187	.	T	C	20	24	44	0	1	45	0	0
10	7222213	.	T	C	21	19	40	0	1	41	0	0
10	7222289	.	C	T	26	19	45	0	1	46	0	0
10	7224964	.	A	G	26	20	46	0	3	49	0	0
10	7231914	.	A	C	26	24	50	0	6	56	0	0
10	7231964	.	G	C	27	19	46	0	2	48	0	0
10	7232083	.	C	T	16	22	38	0	0	38	0	0
10	7232640	.	C	T	27	18	45	0	0	45	0	0
10	7232896	.	A	T	16	10	26	0	1	27	0	0
10	7232897	.	A	G	17	10	27	0	0	27	0	0
10	7232971	.	C	T	25	15	40	1	0	41	0	0
10	7233203	.	G	A	23	21	44	0	1	45	0	0
10	7233440	.	A	T	35	27	62	0	1	63	0	0
10	7233631	.	T	C	25	28	53	0	2	55	0	0
10	7233649	.	A	T	27	29	56	0	3	59	0	0
10	7233747	.	A	G	23	1	24	3	33	60	0	0
10	7233854	.	A	T	7	19	26	0	5	31	0	0
10	7284282	.	A	T	3	4	7	0	0	7	0	0
10	7284371	.	A	G	10	8	18	0	0	18	0	0
10	7284403	.	C	T	9	7	16	0	0	16	0	0
10	7284423	.	G	T	6	11	17	0	0	17	0	0
10	7284442	.	A	G	4	10	14	0	1	15	0	0
10	7285429	.	G	A	10	9	19	0	1	20	0	0
10	7311979	.	G	A	1	6	7	0	1	8	0	0
10	7311997	.	T	G	2	6	8	0	1	9	0	0
10	7312057	.	A	G	6	4	10	0	0	10	0	0
10	7346820	.	A	C	5	9	14	0	0	14	0	0
10	7347192	.	C	A	0	2	2	0	2	4	0	0
10	7493863	.	G	A	3	3	6	0	0	6	0	0
10	7496953	.	G	A	2	3	5	0	0	5	0	0
10	7498921	.	C	T	2	3	5	0	0	5	0	0
10	7498939	.	G	A	2	2	4	0	0	4	0	0
10	7502071	.	G	A	3	4	7	0	0	7	0	0
10	7519387	.	A	G	2	3	5	0	0	5	0	0
10	7519477	.	A	C	1	0	1	0	4	5	0	0
10	7555305	.	T	C	3	2	5	0	0	5	0	0
10	7555560	.	C	A	1	2	3	0	0	3	0	0
10	7564255	.	C	T	6	11	17	0	3	20	0	0
10	7564294	.	C	T	11	5	16	0	5	21	0	0
10	7564804	.	G	A	2	5	7	0	4	11	0	0
10	7601552	.	G	A	22	20	42	0	0	42	0	0
10	7617113	.	A	T	24	31	55	0	3	58	0	0
10	7617241	.	T	G	36	19	55	2	4	61	0	0
10	7617242	.	G	A	23	34	57	2	1	60	0	0
10	7617327	.	A	C	19	23	42	0	8	50	0	0
10	7617636	.	A	G	17	2	19	0	18	37	0	0
10	7624022	.	T	G	2	5	7	0	0	7	0	0
10	7624362	.	C	A	1	4	5	0	0	5	0	0
10	7629422	.	C	T	1	2	3	0	0	3	0	0
10	7629505	.	C	A	1	3	4	0	0	4	0	0
10	7653663	.	C	T	0	2	2	0	3	5	0	0
10	7653750	.	T	C	2	0	2	0	4	6	0	0
10	7671425	.	G	A	6	15	21	0	0	21	0	0
10	7671473	.	A	T	9	2	11	0	4	15	0	0
10	7674079	.	T	G	7	7	14	0	0	14	0	0
10	7674136	.	C	T	6	7	13	0	0	13	0	0
10	7674220	.	C	T	1	2	3	0	1	4	0	0
10	7674393	.	C	T	2	2	4	0	0	4	0	0
10	7674429	.	C	T	4	7	11	0	0	11	0	0
10	7678121	.	T	C	9	15	24	0	2	26	0	0
10	7678393	.	G	A	10	7	17	0	0	17	0	0
10	7678525	.	C	T	1	15	16	0	12	28	0	0
10	7700615	.	A	G	6	4	10	0	0	10	0	0
10	7700676	.	G	A	11	6	17	0	1	18	0	0
10	7701903	.	G	A	7	4	11	0	0	11	0	0
10	7701950	.	G	A	7	9	16	0	0	16	0	0
10	7703338	.	A	G	10	7	17	0	0	17	0	0
10	7704436	.	G	A	2	2	4	0	3	7	0	0
10	7704548	.	C	T	0	3	3	0	2	5	0	0
10	7704574	.	C	T	4	2	6	0	0	6	0	0
10	7709761	.	T	C	14	10	24	0	1	25	0	0
10	7709800	.	C	A	15	10	25	0	0	25	0	0
10	7709975	.	A	G	5	6	11	0	0	11	0	0
10	7710022	.	C	T	10	4	14	0	0	14	0	0
10	7712206	.	G	A	6	9	15	0	0	15	0	0
10	7712228	.	C	T	4	8	12	0	1	13	0	0
10	7713952	.	A	C	7	12	19	0	1	20	0	0
10	7721459	.	A	G	8	5	13	0	0	13	0	0
10	7721746	.	G	A	9	9	18	0	1	19	0	0
10	7722595	.	A	G	6	5	11	0	1	12	0	0
10	7722649	.	C	T	2	3	5	0	0	5	0	0
10	7722653	.	C	T	1	3	4	0	0	4	0	0
10	7722797	.	T	A	2	2	4	0	0	4	0	0
10	7722936	.	C	T	3	5	8	0	0	8	0	0
10	7723004	.	T	C	9	7	16	1	1	18	0	0
10	7723061	.	C	A	11	8	19	0	1	20	0	0
10	7723157	.	A	G	16	15	31	0	1	32	0	0
10	7723218	.	T	C	16	5	21	0	0	21	0	0
10	7723275	.	C	A	15	11	26	0	0	26	0	0
10	7723337	.	C	G	9	7	16	0	0	16	0	0
10	7727393	.	T	C	1	4	5	0	0	5	0	0
10	7727505	.	T	A	1	3	4	0	0	4	0	0
10	7727598	.	A	T	5	6	11	0	1	12	0	0
10	7727704	.	T	A	12	6	18	0	0	18	0	0
10	7734316	.	T	G	1	6	7	0	0	7	0	0
10	7734401	.	G	A	5	6	11	0	0	11	0	0
10	7734465	.	C	T	6	10	16	0	0	16	0	0
10	7738962	.	T	C	1	0	1	0	2	3	0	0
10	7770111	.	G	A	4	3	7	0	0	7	0	0
10	7770425	.	T	C	1	1	2	0	4	6	0	0
10	7771634	.	T	A	1	5	6	0	1	7	0	0
10	7771705	.	T	C	6	2	8	0	0	8	0	0
10	7772012	.	T	G	4	3	7	0	0	7	0	0
10	7779557	.	G	A	2	2	4	0	1	5	0	0
10	7782098	.	G	A	1	2	3	0	0	3	0	0
10	7784221	.	G	C	2	2	4	0	0	4	0	0
10	7804460	.	T	C	1	4	5	0	0	5	0	0
10	7804461	.	T	C	1	4	5	0	0	5	0	0
10	7810461	.	A	T	24	21	45	0	0	45	0	0
10	7810565	.	G	A	18	21	39	0	3	42	0	0
10	7811062	.	T	A	8	7	15	0	0	15	0	0
10	7811075	.	T	C	6	6	12	0	0	12	0	0
10	7811935	.	A	G	14	16	30	0	3	33	0	0
10	7815118	.	G	A	17	21	38	0	0	38	0	0
10	7815187	.	G	A	21	15	36	0	1	37	0	0
10	7909209	.	G	A	5	3	8	0	0	8	0	0
10	7909224	.	G	T	6	2	8	0	2	10	0	0
10	7909308	.	C	T	3	4	7	0	0	7	0	0
10	7909326	.	C	T	4	4	8	0	0	8	0	0
10	7916820	.	G	A	6	6	12	0	0	12	0	0
10	7916888	.	A	G	16	5	21	0	0	21	0	0
10	7916966	.	A	T	13	7	20	0	0	20	0	0
10	7917036	.	A	T	14	13	27	0	1	29	1	0
10	7917072	.	A	C	14	10	24	0	4	28	0	0
10	7917331	.	A	T	15	12	27	0	0	27	0	0
10	7917411	.	C	A	1	7	8	0	10	18	0	0
10	7917538	.	G	A	10	11	21	2	1	24	0	0
10	7917551	.	A	G	14	13	27	2	1	30	0	0
10	7917592	.	T	C	19	17	36	0	3	39	0	0
10	7917686	.	T	C	14	24	38	0	0	38	0	0
10	7917690	.	A	T	15	24	39	0	0	39	0	0
10	7920865	.	G	C	11	0	11	0	22	33	0	0
10	7922294	.	C	A	17	11	28	0	0	28	0	0
10	7922309	.	G	A	8	19	27	0	0	27	0	0
10	7922514	.	A	G	14	24	38	0	4	42	0	0
10	7929469	.	A	G	15	16	31	0	1	32	0	0
10	7929611	.	C	A	0	15	15	0	12	27	0	0
10	7933434	.	G	A	11	13	24	0	1	25	0	0
10	7938629	.	C	T	16	10	26	0	3	29	0	0
10	7968274	.	G	T	7	9	16	0	2	18	0	0
10	7974090	.	A	C	8	0	8	0	7	15	0	0
10	7974093	.	G	A	7	7	14	0	1	15	0	0
10	7975692	.	T	C	23	23	46	0	2	48	0	0
10	7976105	.	C	G	32	16	48	0	3	51	0	0
10	7976118	.	C	T	35	9	44	0	3	47	0	0
10	7976316	.	G	C	23	34	57	0	0	57	0	0
10	7976343	.	C	T	20	34	54	0	4	58	0	0
10	7976574	.	A	C	25	2	27	0	34	61	0	0
10	7976851	.	G	A	22	37	59	0	4	63	0	0
10	7979229	.	A	G	19	21	40	0	1	41	0	0
10	7984479	.	C	T	2	17	19	0	21	40	0	0
10	7984482	.	A	G	15	22	37	0	3	40	0	0
10	7984677	.	A	T	25	23	48	0	0	48	0	0
10	7989000	.	C	T	4	4	8	0	0	8	0	0
10	7989082	.	T	A	8	9	17	0	0	17	0	0
10	7989132	.	T	A	9	8	17	0	0	17	0	0
10	7989162	.	T	G	6	5	11	0	0	11	0	0
10	7989237	.	G	A	4	9	13	0	2	15	0	0
10	7989287	.	G	A	12	12	24	0	0	24	0	0
10	7989290	.	G	A	12	12	24	0	0	24	0	0
10	7989576	.	C	T	8	10	18	0	1	19	0	0
10	7996021	.	G	A	8	3	11	0	1	12	0	0
10	7996022	.	C	G	3	8	11	0	0	11	0	0
10	8001365	.	A	G	9	13	22	0	0	22	0	0
10	8005785	.	T	A	4	7	11	0	0	11	0	0
10	8009996	.	A	C	5	7	12	0	0	12	0	0
10	8010064	.	A	G	3	7	10	0	0	10	0	0
10	8014445	.	T	C	1	6	7	0	0	7	0	0
10	8032838	.	G	A	5	9	14	0	0	14	0	0
10	8032910	.	C	T	0	2	2	0	2	4	0	0
10	8033224	.	T	A	8	4	12	0	2	14	0	0
10	8033234	.	T	C	6	9	15	0	0	15	0	0
10	8035058	.	T	G	2	3	5	0	0	5	0	0
10	8035093	.	G	A	2	4	6	0	0	6	0	0
10	8035592	.	A	C	2	2	4	0	0	4	0	0
10	8035604	.	C	T	0	2	2	0	2	4	0	0
10	8035653	.	A	G	3	2	5	0	0	5	0	0
10	8035657	.	T	A	2	2	4	0	0	4	0	0
10	8035752	.	A	T	1	2	3	0	0	3	0	0
10	8036799	.	T	C	3	0	3	1	4	8	0	0
10	8036813	.	C	T	2	3	5	1	0	6	0	0
10	8036839	.	G	A	2	5	7	1	0	8	0	0
10	8037351	.	C	T	2	4	6	1	0	7	0	0
10	8037797	.	T	C	5	4	9	0	0	9	0	0
10	8037820	.	A	T	4	8	12	0	0	12	0	0
10	8037866	.	T	G	4	4	8	0	0	8	0	0
10	8041412	.	G	C	3	2	5	0	0	5	0	0
10	8041806	.	T	C	2	4	6	0	0	6	0	0
10	8041837	.	C	A	6	2	8	0	0	8	0	0
10	8041863	.	C	G	6	3	9	0	0	9	0	0
10	8041874	.	C	T	2	4	6	0	0	6	0	0
10	8091212	.	G	A	16	32	48	0	0	48	0	0
10	8154892	.	C	T	2	4	6	0	0	6	0	0
10	8161028	.	G	A	7	4	11	0	0	11	0	0
10	8164925	.	C	T	4	5	9	0	0	9	0	0
10	8170269	.	A	G	7	3	10	0	0	10	0	0
10	8174712	.	A	C	3	1	4	0	3	7	0	0
10	8175056	.	G	T	2	4	6	0	0	6	0	0
10	8184599	.	C	T	4	7	11	0	2	13	0	0
10	8188485	.	C	T	1	3	4	0	3	7	0	0
10	8188503	.	G	A	4	2	6	0	0	6	0	0
10	8190734	.	C	T	1	3	4	0	1	5	0	0
10	8194893	.	G	A	9	3	12	0	0	12	0	0
10	8196965	.	C	A	1	4	5	0	0	5	0	0
10	8213187	.	T	C	9	3	12	0	0	12	0	0
10	8213224	.	C	T	4	4	8	0	1	9	0	0
10	8213229	.	G	A	5	4	9	0	0	9	0	0
10	8217029	.	T	C	7	2	9	0	0	9	0	0
10	8217056	.	T	C	3	5	8	0	0	8	0	0
10	8228235	.	T	C	4	3	7	0	0	7	0	0
10	8233255	.	C	T	4	3	7	0	0	7	0	0
10	8233267	.	C	T	2	3	5	0	0	5	0	0
10	8236048	.	T	C	2	5	7	0	0	7	0	0
10	8239318	.	T	C	5	7	12	0	0	12	0	0
10	8263045	.	G	A	8	10	18	0	0	18	0	0
10	8263081	.	T	C	10	8	18	0	0	18	0	0
10	8263919	.	C	T	11	6	17	0	1	18	0	0
10	8266248	.	C	T	1	24	25	0	15	40	0	0
10	8269224	.	G	A	17	22	39	0	2	41	0	0
10	8269439	.	C	T	0	2	2	0	2	4	0	0
10	8282705	.	T	A	9	3	12	0	1	13	0	0
10	8288983	.	A	G	2	4	6	0	0	6	0	0
10	8299143	.	G	C	4	4	8	0	0	8	0	0
10	8306677	.	G	C	2	3	5	0	0	5	0	0
10	8357874	.	G	T	3	5	8	0	0	8	0	0
10	8358339	.	A	G	3	4	7	0	0	7	0	0
10	8950022	.	T	C	5	0	5	0	7	12	0	0
10	8950055	.	G	A	5	7	12	0	0	12	0	0
10	8950108	.	A	G	5	5	10	0	0	10	0	0
10	8952018	.	T	C	5	2	7	0	0	7	0	0
10	8955356	.	C	A	1	2	3	0	0	3	0	0
10	9006634	.	T	C	11	12	23	0	1	24	0	0
10	9089524	.	A	C	5	0	5	0	7	12	0	0
10	9089569	.	T	A	14	13	27	0	0	27	0	0
10	9089602	.	T	C	7	0	7	0	11	18	0	0
10	9164807	.	T	C	9	8	17	0	0	17	0	0
10	9168991	.	C	T	9	4	13	0	0	13	0	0
10	9169574	.	T	G	8	6	14	0	1	15	0	0
10	9169613	.	C	T	7	6	13	0	1	14	0	0
10	9173473	.	A	G	8	4	12	0	0	12	0	0
10	9177175	.	T	C	13	6	19	0	0	19	0	0
10	9177608	.	C	T	11	10	21	0	0	21	0	0
10	9184533	.	C	T	8	9	17	0	0	17	0	0
10	9184556	.	A	G	7	7	14	0	1	15	0	0
10	9199955	.	T	C	3	2	5	0	1	6	0	0
10	9202444	.	G	A	1	2	3	0	0	3	0	0
10	9205505	.	A	T	1	2	3	0	1	4	0	0
10	9219628	.	A	C	1	3	4	0	0	4	0	0
10	9233892	.	T	C	6	2	8	0	0	8	0	0
10	9235026	.	A	G	4	3	7	0	0	7	0	0
10	9255670	.	G	A	9	11	20	0	0	20	0	0
10	9268272	.	T	G	5	10	15	0	0	15	0	0
10	9268540	.	G	T	4	6	10	0	1	11	0	0
10	9269228	.	G	A	7	15	22	0	1	23	0	0
10	9305232	.	T	C	4	0	4	0	4	8	0	0
10	9305246	.	T	C	3	0	3	0	5	8	0	0
10	9305277	.	G	A	4	6	10	0	0	10	0	0
10	9305305	.	C	T	1	5	6	0	0	6	0	0
10	9305465	.	T	C	8	0	8	0	7	15	0	0
10	9305534	.	A	C	7	3	10	0	0	10	0	0
10	9305543	.	C	T	4	3	7	0	1	8	0	0
10	9308057	.	C	T	4	4	8	0	0	8	0	0
10	9370210	.	T	A	11	4	15	0	0	15	0	0
10	9370274	.	G	A	16	3	19	0	3	22	0	0
10	9388783	.	G	A	1	2	3	0	1	4	0	0
10	9390726	.	C	T	2	3	5	0	1	6	0	0
10	9390746	.	T	C	3	3	6	0	0	6	0	0
10	9390767	.	T	C	3	5	8	0	0	8	0	0
10	9394918	.	G	C	1	7	8	0	0	8	0	0
10	9419821	.	G	A	17	11	28	0	0	28	0	0
10	9419901	.	T	A	7	9	16	0	0	16	0	0
10	9419902	.	A	G	7	8	15	0	1	16	0	0
10	9601542	.	T	C	2	6	8	0	0	8	0	0
10	9601620	.	T	C	4	3	7	0	0	7	0	0
10	9610268	.	T	C	1	5	6	0	0	6	0	0
10	9610388	.	A	C	2	6	8	0	0	8	0	0
10	9612572	.	T	A	5	8	13	0	1	14	0	0
10	9618055	.	G	A	1	7	8	0	5	13	0	0
10	9618271	.	T	G	2	5	7	0	0	7	0	0
10	9618295	.	G	A	2	6	8	0	1	9	0	0
10	9618313	.	T	G	3	6	9	0	0	9	0	0
10	9618348	.	A	C	3	5	8	0	0	8	0	0
10	9626988	.	C	T	3	3	6	0	0	6	0	0
10	9627603	.	T	C	6	6	12	0	1	13	0	0
10	9629268	.	G	T	1	6	7	0	4	11	0	0
10	9629301	.	A	G	9	0	9	0	4	13	0	0
10	9638888	.	A	G	3	6	9	0	0	9	0	0
10	9639172	.	T	C	4	9	13	0	1	14	0	0
10	9642717	.	T	C	5	8	13	0	1	14	0	0
10	9642769	.	A	C	3	3	6	0	0	6	0	0
10	9642832	.	T	G	2	0	2	0	4	6	0	0
10	9697243	.	C	A	8	10	18	0	1	19	0	0
10	9697270	.	A	T	7	9	16	0	0	16	0	0
10	9704514	.	A	T	11	9	20	0	0	20	0	0
10	9714801	.	C	T	8	9	17	0	0	17	0	0
10	9729611	.	G	A	1	14	15	0	19	34	0	0
10	9776699	.	C	T	14	21	35	0	1	36	0	0
10	9781455	.	G	A	20	13	33	0	2	35	0	0
10	9784238	.	G	A	0	21	21	0	14	35	0	0
10	9789262	.	C	T	17	16	33	0	1	34	0	0
10	9802804	.	C	T	12	17	29	0	0	29	0	0
10	9836923	.	A	G	2	2	4	0	0	4	0	0
10	9837024	.	G	T	2	5	7	1	0	8	0	0
10	9837191	.	A	G	8	6	14	0	0	14	0	0
10	9846285	.	T	G	10	16	26	0	4	30	0	0
10	9846602	.	C	G	1	7	8	0	9	17	0	0
10	9856390	.	T	C	4	0	4	0	12	16	0	0
10	9856416	.	A	G	8	5	13	0	0	13	0	0
10	9861038	.	A	T	4	6	10	0	1	11	0	0
10	9861103	.	G	T	4	8	12	0	1	13	0	0
10	9899215	.	G	T	10	5	15	0	1	16	0	0
10	9899308	.	G	A	9	8	17	0	0	17	0	0
10	9961471	.	A	T	12	12	24	1	1	26	0	0
10	10210583	.	C	T	6	6	12	0	1	13	0	0
10	10254913	.	G	A	0	10	10	0	7	17	0	0
10	10261887	.	G	C	3	16	19	0	1	20	0	0
10	10261893	.	C	A	4	17	21	0	0	21	0	0
10	10262013	.	T	C	10	7	17	0	2	19	0	0
10	10262157	.	A	G	10	6	16	0	0	16	0	0
10	10269930	.	T	C	7	5	12	0	0	12	0	0
10	10270959	.	G	A	15	5	20	0	0	20	0	0
10	10270977	.	G	A	10	6	16	0	1	17	0	0
10	10271061	.	C	T	10	9	19	0	1	20	0	0
10	10317392	.	A	T	11	5	16	0	2	18	0	0
10	10325451	.	T	C	7	5	12	0	0	12	0	0
10	10393754	.	G	T	0	2	2	0	2	4	0	0
10	10545496	.	C	T	2	3	5	0	0	5	0	0
10	10561043	.	A	C	3	4	7	0	0	7	0	0
10	10561112	.	T	A	2	5	7	0	0	7	0	0
10	10561304	.	T	G	0	3	3	0	1	4	0	0
10	10561310	.	T	C	1	1	2	0	1	3	0	0
10	10567262	.	A	G	5	4	9	0	0	9	0	0
10	10636263	.	A	G	8	4	12	0	0	12	0	0
10	10636283	.	T	C	7	4	11	0	1	12	0	0
10	10636330	.	A	G	8	3	11	0	0	11	0	0
10	10636558	.	A	T	8	6	14	0	0	14	0	0
10	10636799	.	C	A	4	3	7	0	0	7	0	0
10	10636896	.	G	A	0	5	5	0	7	12	0	0
10	10636946	.	A	G	8	11	19	0	0	19	0	0
10	10700463	.	A	G	4	0	4	0	6	10	0	0
10	10700532	.	C	T	13	15	28	0	1	29	0	0
10	10700583	.	C	T	14	17	31	0	1	32	0	0
10	10729041	.	A	T	3	3	6	0	0	6	0	0
10	10731381	.	C	A	3	3	6	0	1	7	0	0
10	10739153	.	C	A	2	4	6	0	0	6	0	0
10	10758431	.	A	G	4	9	13	0	0	13	0	0
10	10766873	.	T	C	2	4	6	0	1	7	0	0
10	10772092	.	T	C	3	3	6	0	0	6	0	0
10	10775374	.	A	T	3	3	6	0	0	6	0	0
10	10780483	.	T	C	7	10	17	0	0	17	0	0
10	10782513	.	G	A	13	8	21	0	0	21	0	0
10	10782786	.	C	T	5	3	8	0	0	8	0	0
10	10860852	.	A	G	2	4	6	0	0	6	0	0
10	10861085	.	G	T	5	6	11	0	0	11	0	0
10	10861504	.	G	A	1	5	6	0	0	6	0	0
10	10861610	.	T	C	4	2	6	0	2	8	0	0
10	10861847	.	T	A	1	6	7	0	2	9	0	0
10	10862202	.	A	C	2	4	6	0	0	6	0	0
10	10862232	.	C	G	4	3	7	0	1	8	0	0
10	10862276	.	A	C	6	0	6	0	4	10	0	0
10	10880393	.	A	G	1	5	6	0	0	6	0	0
10	10880397	.	C	A	1	5	6	0	0	6	0	0
10	10880453	.	C	T	2	4	6	0	0	6	0	0
10	10880490	.	A	G	5	2	7	0	0	7	0	0
10	10880611	.	A	T	3	1	4	0	1	5	0	0
10	10880628	.	G	A	3	6	9	0	1	10	0	0
10	10880671	.	G	A	3	6	9	0	1	10	0	0
10	10880692	.	C	T	1	5	6	0	3	9	0	0
10	10880779	.	G	A	4	2	6	0	1	7	0	0
10	10935974	.	C	T	1	4	5	0	1	6	0	0
10	10937960	.	T	A	2	2	4	0	0	4	0	0
10	10987263	.	T	C	1	3	4	0	0	4	0	0
10	10997671	.	T	G	7	0	7	0	4	11	0	0
10	10997711	.	T	C	4	3	7	0	0	7	0	0
10	10997892	.	G	T	1	2	3	0	0	3	0	0
10	10998496	.	T	G	2	3	5	0	0	5	0	0
10	11001649	.	G	A	4	3	7	0	0	7	0	0
10	11001883	.	T	A	5	6	11	0	0	11	0	0
10	11001967	.	T	G	5	3	8	0	1	9	0	0
10	11001968	.	A	G	5	3	8	0	0	8	0	0
10	11009954	.	T	G	5	8	13	0	0	13	0	0
10	11009975	.	A	G	3	4	7	0	0	7	0	0
10	11011914	.	T	A	10	3	13	0	0	13	0	0
10	11052908	.	C	G	2	0	2	0	6	8	0	0
10	11092936	.	C	T	18	8	26	0	1	27	0	0
10	11093251	.	G	A	10	7	17	0	1	18	0	0
10	11093626	.	C	T	13	6	19	0	0	19	0	0
10	11093968	.	T	C	7	13	20	0	0	20	0	0
10	11149391	.	G	A	5	2	7	0	3	10	0	0
10	11183242	.	A	G	7	7	14	0	0	14	0	0
10	11183301	.	C	T	0	9	9	0	8	17	0	0
10	11280118	.	C	T	12	11	23	0	1	24	0	0
10	11280146	.	C	T	13	12	25	0	0	25	0	0
10	11280883	.	T	C	4	2	6	0	0	6	0	0
10	11281492	.	G	A	4	4	8	0	0	8	0	0
10	11281731	.	T	G	3	3	6	0	0	6	0	0
10	11281821	.	A	G	4	3	7	0	0	7	0	0
10	11282178	.	A	G	10	0	10	0	3	13	0	0
10	11282933	.	T	A	7	19	26	0	1	27	0	0
10	11286674	.	C	T	8	9	17	0	2	19	0	0
10	11286830	.	C	T	15	9	24	0	0	24	0	0
10	11286902	.	C	T	6	13	19	0	0	19	0	0
10	11286911	.	C	A	5	13	18	0	1	19	0	0
10	11298852	.	G	A	5	6	11	0	1	12	0	0
10	11322659	.	C	T	7	7	14	0	0	14	0	0
10	11323092	.	G	A	9	9	18	0	0	18	0	0
10	11327406	.	T	A	1	5	6	0	0	6	0	0
10	11327484	.	C	T	1	5	6	0	6	12	0	0
10	11327521	.	C	A	5	8	13	0	0	13	0	0
10	11327674	.	G	A	4	12	16	0	0	16	0	0
10	11327703	.	C	T	7	6	13	0	0	13	0	0
10	11328246	.	G	C	12	6	18	0	0	18	0	0
10	11328334	.	G	A	12	7	19	0	0	19	0	0
10	11331922	.	C	T	1	5	6	0	2	8	0	0
10	11339235	.	G	A	9	8	17	0	1	18	0	0
10	11339283	.	G	A	9	10	19	0	1	20	0	0
10	11343169	.	C	T	8	7	15	0	0	15	0	0
10	11347929	.	T	G	8	8	16	0	0	16	0	0
10	11359991	.	A	G	10	0	10	0	8	18	0	0
10	11362275	.	C	T	23	20	43	0	0	43	0	0
10	11367979	.	C	T	18	12	30	0	1	31	0	0
10	11367980	.	T	C	17	12	29	0	2	31	0	0
10	11368106	.	T	C	10	5	15	0	0	15	0	0
10	11368195	.	G	A	9	4	13	0	1	14	0	0
10	11368249	.	A	G	7	7	14	0	0	14	0	0
10	11501181	.	C	A	1	2	3	0	0	3	0	0
10	11769166	.	G	A	2	2	4	0	0	4	0	0
10	11773751	.	T	C	4	8	12	0	0	12	0	0
10	11774203	.	C	T	8	6	14	0	1	15	0	0
10	12517256	.	G	C	0	2	2	0	2	4	0	0
10	12556390	.	C	T	2	2	4	0	0	4	0	0
10	12609148	.	T	C	2	2	4	1	1	6	0	0
10	12659015	.	A	G	4	0	4	0	6	10	0	0
10	12659048	.	C	A	3	3	6	0	0	6	0	0
10	12664210	.	T	A	5	3	8	0	0	8	0	0
10	12720969	.	C	T	3	3	6	0	0	6	0	0
10	12729309	.	C	T	6	3	9	0	1	10	0	0
10	12729361	.	C	T	4	6	10	0	0	10	0	0
10	12730352	.	T	C	4	6	10	0	0	10	0	0
10	12730433	.	C	T	5	4	9	0	0	9	0	0
10	13000764	.	C	T	1	2	3	0	0	3	0	0
10	13037833	.	G	A	2	3	5	0	0	5	0	0
10	13037884	.	G	A	3	4	7	0	0	7	0	0
10	13038022	.	T	C	3	6	9	0	0	9	0	0
10	13038025	.	A	C	2	6	8	0	1	9	0	0
10	13238028	.	A	G	11	10	21	0	2	23	0	0
10	13238055	.	G	T	13	10	23	0	0	23	0	0
10	13239089	.	G	A	12	17	29	0	0	29	0	0
10	13283720	.	C	T	11	5	16	0	0	16	0	0
10	13460494	.	A	C	7	8	15	0	0	15	0	0
10	13460615	.	C	T	9	11	20	0	3	23	0	0
10	13460730	.	C	T	20	15	35	0	0	35	0	0
10	13460765	.	C	T	16	15	31	0	1	32	0	0
10	13460813	.	A	T	16	12	28	0	1	29	0	0
10	13529250	.	C	G	14	13	27	0	3	30	0	0
10	14326834	.	C	T	1	3	4	0	0	4	0	0
10	14337841	.	T	C	7	0	7	0	5	12	0	0
10	14337853	.	A	G	7	3	10	0	1	11	0	0
10	14478899	.	A	G	3	2	5	0	0	5	0	0
10	14478929	.	A	G	3	2	5	0	0	5	0	0
10	14484443	.	T	C	2	0	2	0	2	4	0	0
10	14491139	.	C	T	15	19	34	0	1	35	0	0
10	14532271	.	T	C	5	8	13	0	1	14	0	0
10	14532398	.	T	C	8	0	8	0	8	16	0	0
10	14533352	.	A	G	9	8	17	0	0	17	0	0
10	14536393	.	G	A	8	7	15	0	0	15	0	0
10	14545572	.	A	G	16	15	31	0	1	32	0	0
10	14871245	.	T	A	12	6	18	0	3	21	0	0
10	14871292	.	G	A	11	6	17	0	1	18	0	0
10	14871758	.	C	G	19	9	28	0	1	29	0	0
10	14871768	.	A	G	18	10	28	0	1	29	0	0
10	14871801	.	A	C	18	12	30	0	1	31	0	0
10	14872258	.	T	G	2	4	6	0	0	6	0	0
10	14872796	.	T	G	3	0	3	0	12	15	0	0
10	14873175	.	T	G	13	14	27	0	2	29	0	0
10	14873220	.	A	G	21	17	38	0	0	38	0	0
10	14878863	.	C	G	15	7	22	0	2	24	0	0
10	14878890	.	T	C	14	0	14	0	11	25	0	0
10	14879027	.	G	A	6	12	18	0	0	18	0	0
10	14885337	.	A	G	13	6	19	0	0	19	0	0
10	14885957	.	C	A	0	11	11	1	20	32	0	0
10	14892211	.	C	T	1	12	13	0	16	29	0	0
10	14920909	.	G	A	16	6	22	0	1	23	0	0
10	14920912	.	T	C	17	1	18	0	6	24	0	0
10	14921002	.	G	A	13	8	21	0	0	21	0	0
10	14921053	.	G	C	16	0	16	0	7	23	0	0
10	14921086	.	A	C	10	0	10	0	17	27	0	0
10	15073096	.	C	T	1	3	4	0	0	4	0	0
10	15075575	.	G	T	2	3	5	0	0	5	0	0
10	15277481	.	T	C	21	8	29	0	0	29	0	0
10	15285696	.	C	T	20	11	31	0	0	31	0	0
10	15285852	.	T	G	16	1	17	0	13	30	0	0
10	15287463	.	T	C	11	8	19	0	1	20	0	0
10	15287883	.	C	A	12	8	20	0	5	25	0	0
10	15287933	.	C	T	21	15	36	0	0	36	0	0
10	15291157	.	G	A	2	19	21	0	15	36	0	0
10	15295913	.	T	C	12	16	28	0	1	29	0	0
10	15296219	.	G	A	1	22	23	0	12	35	0	0
10	15298458	.	G	C	13	21	34	0	4	39	1	0
10	15298518	.	G	A	17	20	37	0	2	39	0	0
10	15303975	.	A	T	23	24	47	0	2	49	0	0
10	15304167	.	A	G	4	13	17	0	0	17	0	0
10	15304331	.	C	A	11	16	27	0	1	28	0	0
10	15304408	.	C	G	13	1	14	0	40	54	0	0
10	15304782	.	A	G	20	10	30	0	1	31	0	0
10	15338917	.	T	G	7	2	9	0	1	10	0	0
10	15372708	.	G	T	11	10	21	0	2	23	0	0
10	15372726	.	G	A	13	10	23	0	0	23	0	0
10	15372889	.	G	A	16	16	32	0	0	32	0	0
10	15382352	.	A	G	12	19	31	0	2	33	0	0
10	15382546	.	A	G	12	19	31	0	0	31	0	0
10	15382630	.	T	C	21	6	27	0	2	29	0	0
10	15382669	.	G	A	13	12	25	0	1	27	1	0
10	15382681	.	A	T	15	12	27	0	2	29	0	0
10	15400027	.	G	A	27	25	52	0	3	55	0	0
10	15400692	.	T	G	19	15	34	0	1	35	0	0
10	15405509	.	T	G	1	4	5	0	0	5	0	0
10	15434330	.	T	C	2	4	6	0	0	6	0	0
10	15434345	.	T	C	2	4	6	0	0	6	0	0
10	15438451	.	G	A	2	2	4	0	0	4	0	0
10	15511974	.	C	T	4	3	7	0	0	7	0	0
10	15533107	.	T	C	3	3	6	0	1	7	0	0
10	15551580	.	C	T	6	5	11	0	0	11	0	0
10	15553178	.	A	G	5	3	8	0	0	8	0	0
10	15569027	.	G	A	0	10	10	0	3	13	0	0
10	15575364	.	C	T	5	4	9	0	0	9	0	0
10	15575627	.	T	C	8	4	12	0	0	12	0	0
10	15575633	.	C	T	9	3	12	0	0	12	0	0
10	15580988	.	T	G	8	0	8	0	4	12	0	0
10	15581078	.	G	A	5	3	8	0	1	9	0	0
10	15582371	.	C	G	5	8	13	0	0	13	0	0
10	15582744	.	A	C	11	9	20	0	2	22	0	0
10	15582746	.	A	T	12	8	20	0	2	22	0	0
10	15582799	.	C	T	13	9	22	0	0	22	0	0
10	15582906	.	C	T	13	10	23	0	1	24	0	0
10	15583060	.	C	T	7	7	14	0	2	16	0	0
10	15583105	.	C	T	10	5	15	0	0	15	0	0
10	15583153	.	G	C	10	4	14	0	1	15	0	0
10	15596503	.	A	C	6	7	13	0	0	13	0	0
10	15596752	.	C	T	6	4	10	0	0	10	0	0
10	15596767	.	C	G	9	6	15	0	0	15	0	0
10	15596958	.	G	C	6	7	13	0	0	13	0	0
10	15596995	.	C	T	8	5	13	0	0	13	0	0
10	15597103	.	T	A	10	5	15	0	0	15	0	0
10	15597822	.	G	A	6	6	12	0	0	12	0	0
10	15597834	.	A	T	7	6	13	0	0	13	0	0
10	15597927	.	T	A	8	2	10	0	0	10	0	0
10	15597942	.	T	C	6	3	9	0	0	9	0	0
10	15598303	.	A	T	6	4	10	0	1	11	0	0
10	15598358	.	T	G	9	4	13	0	1	14	0	0
10	15598412	.	T	C	5	7	12	0	1	13	0	0
10	15598598	.	T	G	6	7	13	0	1	14	0	0
10	15598681	.	G	A	1	9	10	0	8	18	0	0
10	15608373	.	T	C	17	12	29	0	0	29	0	0
10	15608756	.	T	C	27	19	46	0	1	47	0	0
10	15612238	.	C	T	18	15	33	0	1	34	0	0
10	15612602	.	G	A	29	14	43	0	0	43	0	0
10	15612675	.	T	A	28	13	41	0	2	43	0	0
10	15612705	.	C	T	18	20	38	0	2	40	0	0
10	15612758	.	G	A	21	18	39	0	2	41	0	0
10	15612859	.	G	T	2	15	17	0	16	33	0	0
10	15613076	.	G	A	0	7	7	0	17	24	0	0
10	15613174	.	A	C	7	8	15	0	0	15	0	0
10	15618411	.	A	G	2	6	8	0	0	8	0	0
10	15618606	.	A	G	2	4	6	0	1	7	0	0
10	15621499	.	A	G	2	4	6	0	0	6	0	0
10	15621529	.	C	T	1	2	3	0	2	5	0	0
10	15623124	.	T	C	3	5	8	0	0	8	0	0
10	15629642	.	C	T	4	3	7	0	0	7	0	0
10	15631408	.	C	T	0	4	4	0	4	8	0	0
10	15637205	.	A	T	5	2	7	0	0	7	0	0
10	15637207	.	T	C	5	2	7	0	0	7	0	0
10	15637338	.	C	T	1	4	5	0	5	10	0	0
10	15637405	.	C	T	1	2	3	0	0	3	0	0
10	15637563	.	T	C	2	2	4	0	0	4	0	0
10	15637696	.	T	C	1	3	4	0	0	4	0	0
10	15644841	.	A	C	1	4	5	0	1	6	0	0
10	15783637	.	A	G	11	1	12	0	15	27	0	0
10	15783721	.	A	G	7	15	22	0	0	22	0	0
10	15783777	.	G	A	6	15	21	0	0	21	0	0
10	15783934	.	T	C	9	12	21	0	0	21	0	0
10	15784613	.	G	A	0	17	17	0	7	24	0	0
10	15788562	.	A	T	17	13	30	0	2	32	0	0
10	15795197	.	A	G	11	0	11	0	18	29	0	0
10	15809215	.	C	T	11	16	27	0	0	27	0	0
10	15812950	.	A	G	16	0	16	0	18	34	0	0
10	15815952	.	A	C	0	3	3	0	1	4	0	0
10	15815984	.	A	T	2	2	4	0	1	5	0	0
10	15816029	.	T	A	1	2	3	0	1	4	0	0
10	15816879	.	G	A	6	2	8	0	0	8	0	0
10	15826749	.	G	A	2	6	8	0	0	8	0	0
10	15826947	.	C	T	2	7	9	0	0	9	0	0
10	15827288	.	A	G	2	6	8	0	0	8	0	0
10	15827390	.	A	G	3	3	6	0	0	6	0	0
10	15830921	.	G	A	2	4	6	0	0	6	0	0
10	15838597	.	G	A	2	2	4	0	0	4	0	0
10	15839025	.	G	A	3	2	5	0	0	5	0	0
10	15881732	.	G	T	6	4	10	0	0	10	0	0
10	15881819	.	T	G	12	6	18	0	0	18	0	0
10	15884833	.	G	A	9	10	19	0	1	20	0	0
10	15884872	.	T	C	10	0	10	0	14	24	0	0
10	15885056	.	C	G	13	6	19	0	0	19	0	0
10	15893297	.	A	T	4	4	8	0	0	8	0	0
10	15893347	.	G	A	7	4	11	0	0	11	0	0
10	15893372	.	G	T	9	5	14	0	1	15	0	0
10	15919753	.	T	A	2	4	6	0	0	6	0	0
10	15937655	.	G	C	2	3	5	0	0	5	0	0
10	15960967	.	T	A	6	6	12	0	0	12	0	0
10	15967713	.	T	A	8	11	19	0	2	21	0	0
10	15967715	.	G	A	10	12	22	0	0	22	0	0
10	15975308	.	G	A	0	5	5	0	15	20	0	0
10	15980805	.	A	T	14	11	25	0	0	25	0	0
10	15984366	.	C	T	10	11	21	0	0	21	0	0
10	15992712	.	T	A	12	10	22	0	2	24	0	0
10	15992731	.	A	T	14	11	25	0	0	25	0	0
10	15992968	.	A	C	19	12	31	0	1	32	0	0
10	15997600	.	A	G	12	0	12	0	10	22	0	0
10	15997729	.	C	T	15	11	26	0	0	26	0	0
10	15997804	.	G	A	0	13	13	0	8	21	0	0
10	16015332	.	G	A	15	21	36	0	0	36	0	0
10	16015509	.	C	A	2	10	12	0	12	24	0	0
10	16017676	.	A	T	11	16	27	0	2	29	0	0
10	16019482	.	G	A	6	11	17	0	0	17	0	0
10	16019881	.	A	G	7	4	11	0	1	12	0	0
10	16019902	.	C	T	8	8	16	0	0	16	0	0
10	16031378	.	T	C	12	7	19	0	0	19	0	0
10	16031555	.	C	T	6	8	14	0	2	16	0	0
10	16031648	.	C	G	13	6	19	0	0	19	0	0
10	16031690	.	A	G	12	7	19	0	0	19	0	0
10	16034782	.	A	G	9	8	17	0	0	17	0	0
10	16034796	.	C	T	6	9	15	0	0	16	1	0
10	16034887	.	G	A	3	5	8	0	0	8	0	0
10	16034901	.	A	C	5	5	10	0	0	10	0	0
10	16035084	.	G	A	5	4	9	0	0	9	0	0
10	16036615	.	T	C	4	8	12	0	1	13	0	0
10	16036728	.	T	A	4	5	9	0	0	9	0	0
10	16036818	.	C	T	4	9	13	0	0	13	0	0
10	16036929	.	G	A	3	6	9	0	1	10	0	0
10	16043700	.	A	G	11	0	11	0	12	23	0	0
10	16049522	.	T	C	8	5	13	0	1	14	0	0
10	16052536	.	T	C	3	8	11	0	1	12	0	0
10	16055878	.	C	T	12	3	15	0	1	16	0	0
10	16055906	.	C	T	12	5	17	0	1	18	0	0
10	16056137	.	T	A	7	5	12	0	0	12	0	0
10	16056145	.	A	G	9	5	14	0	1	15	0	0
10	16056181	.	T	A	8	5	13	0	3	16	0	0
10	16056739	.	A	G	4	5	9	0	0	9	0	0
10	16061731	.	T	C	3	0	3	0	4	7	0	0
10	16061913	.	T	C	1	2	3	0	0	3	0	0
10	16173297	.	A	G	5	5	10	0	0	10	0	0
10	16173552	.	G	A	8	4	12	0	1	13	0	0
10	16176685	.	G	A	2	3	5	0	1	6	0	0
10	16176720	.	C	T	3	6	9	0	0	9	0	0
10	16176906	.	G	A	6	9	15	0	0	15	0	0
10	16176915	.	G	A	7	9	16	0	0	16	0	0
10	16181904	.	T	C	4	7	11	0	0	11	0	0
10	16185500	.	T	C	6	8	14	0	0	14	0	0
10	16185611	.	A	G	12	0	12	0	9	21	0	0
10	16185685	.	A	G	3	5	8	0	0	8	0	0
10	16185915	.	T	G	5	5	10	0	0	10	0	0
10	16185927	.	C	G	6	6	12	0	1	13	0	0
10	16185984	.	T	G	5	7	12	0	0	12	0	0
10	16186405	.	T	A	6	6	12	0	0	12	0	0
10	16192385	.	G	A	6	6	12	0	0	12	0	0
10	16225872	.	C	T	5	5	10	0	0	10	0	0
10	16226250	.	A	C	7	9	16	0	0	16	0	0
10	16263919	.	G	A	3	2	5	0	0	5	0	0
10	16264257	.	A	T	3	3	6	0	0	6	0	0
10	16273333	.	C	T	1	7	8	0	1	9	0	0
10	16273683	.	C	T	4	5	9	0	0	9	0	0
10	16287073	.	C	T	2	5	7	0	0	7	0	0
10	16303060	.	A	T	12	14	26	0	1	27	0	0
10	16307128	.	A	G	4	1	5	0	2	7	0	0
10	16307210	.	C	T	4	2	6	0	0	6	0	0
10	16307651	.	T	A	10	23	33	0	0	33	0	0
10	16307679	.	T	A	8	20	28	0	1	29	0	0
10	16307952	.	A	G	9	11	20	0	1	21	0	0
10	16307979	.	A	T	5	8	13	0	0	13	0	0
10	16308206	.	T	C	4	6	10	0	0	10	0	0
10	16308272	.	A	G	6	9	15	0	2	17	0	0
10	16308643	.	G	A	1	8	9	0	10	19	0	0
10	16308648	.	G	T	0	8	8	0	11	19	0	0
10	16308923	.	G	A	1	10	11	0	14	25	0	0
10	16309001	.	T	A	10	10	20	2	1	23	0	0
10	16309017	.	G	A	12	5	17	2	2	21	0	0
10	16309167	.	T	C	18	9	27	0	0	27	0	0
10	16309364	.	A	G	7	3	10	0	0	10	0	0
10	16309434	.	T	C	2	2	4	0	0	4	0	0
10	16309498	.	C	T	7	11	18	0	9	27	0	0
10	16476113	.	C	T	3	5	8	0	0	8	0	0
10	16476122	.	G	A	3	5	8	0	0	8	0	0
10	16476352	.	A	G	2	4	6	0	0	6	0	0
10	16476480	.	G	A	4	3	7	0	0	7	0	0
10	16476742	.	A	T	2	6	8	0	3	11	0	0
10	16477049	.	T	C	1	0	1	0	8	9	0	0
10	16477230	.	T	C	2	3	5	0	0	5	0	0
10	16477469	.	G	A	3	2	5	0	0	5	0	0
10	16477575	.	T	C	4	2	6	0	0	6	0	0
10	16477631	.	T	C	6	6	12	0	0	12	0	0
10	16477780	.	G	A	1	3	4	0	0	4	0	0
10	16478237	.	T	C	2	0	2	0	3	5	0	0
10	16480353	.	G	A	2	2	4	0	0	4	0	0
10	16563035	.	A	C	5	4	9	0	0	9	0	0
10	16746334	.	A	G	3	4	7	0	0	7	0	0
10	16746706	.	C	A	6	6	12	0	1	13	0	0
10	16746790	.	C	T	9	8	17	0	0	17	0	0
10	16747465	.	A	C	2	4	6	0	0	6	0	0
10	16867505	.	G	T	4	2	6	0	1	7	0	0
10	17102971	.	C	T	28	25	53	0	4	57	0	0
10	17132501	.	C	T	25	27	52	0	4	56	0	0
10	17166889	.	C	T	1	14	15	0	17	32	0	0
10	17166955	.	A	G	25	19	44	0	0	44	0	0
10	17166982	.	A	G	20	19	39	0	1	40	0	0
10	17167637	.	A	G	30	28	58	0	3	61	0	0
10	17167733	.	T	C	30	30	60	0	5	65	0	0
10	17167757	.	G	A	25	29	54	0	5	59	0	0
10	17168039	.	C	T	31	24	55	0	4	59	0	0
10	17168096	.	A	G	31	30	61	0	3	64	0	0
10	17169948	.	C	G	28	28	56	1	1	58	0	0
10	17174687	.	C	T	1	7	8	0	2	10	0	0
10	17179400	.	G	A	2	2	4	0	0	4	0	0
10	17179557	.	C	T	6	3	9	0	0	9	0	0
10	17183147	.	T	A	3	4	7	0	1	8	0	0
10	17211858	.	C	A	4	5	9	0	0	9	0	0
10	17211903	.	G	A	5	6	11	0	0	11	0	0
10	17213961	.	T	C	1	3	4	0	0	4	0	0
10	17214930	.	T	A	1	2	3	0	0	3	0	0
10	17214945	.	A	G	1	2	3	0	0	3	0	0
10	17221982	.	C	A	0	4	4	0	2	6	0	0
10	17221998	.	T	C	2	2	4	0	0	4	0	0
10	17223867	.	T	A	2	4	6	0	0	6	0	0
10	17224218	.	G	A	3	4	7	0	1	8	0	0
10	17282810	.	C	G	4	5	9	0	0	9	0	0
10	17282903	.	G	A	14	7	21	0	1	22	0	0
10	17283170	.	A	G	9	8	17	0	0	17	0	0
10	17283386	.	A	G	14	7	21	0	4	25	0	0
10	17283720	.	T	A	14	9	23	0	0	23	0	0
10	17283905	.	A	G	10	8	18	0	1	19	0	0
10	17283955	.	G	A	11	6	17	0	0	17	0	0
10	17372187	.	G	A	0	7	7	0	6	13	0	0
10	17460743	.	A	G	2	2	4	0	0	4	0	0
10	17473642	.	T	G	1	2	3	0	1	4	0	0
10	17552889	.	A	T	2	2	4	0	0	4	0	0
10	17552976	.	T	C	2	4	6	0	0	6	0	0
10	17552994	.	T	C	1	2	3	0	0	3	0	0
10	17553184	.	T	C	4	4	8	0	0	8	0	0
10	17553271	.	G	A	5	12	17	0	1	18	0	0
10	17560030	.	G	A	4	7	11	0	0	11	0	0
10	17560390	.	T	C	5	4	9	0	0	9	0	0
10	17562978	.	G	C	3	3	6	0	1	7	0	0
10	17563180	.	A	G	7	3	10	0	0	10	0	0
10	17568855	.	T	C	5	3	8	0	0	8	0	0
10	17568878	.	C	T	4	4	8	0	0	8	0	0
10	17572866	.	C	A	1	4	5	0	5	10	0	0
10	17577348	.	T	C	5	5	10	0	0	10	0	0
10	17579465	.	C	T	0	3	3	0	4	7	0	0
10	17579948	.	T	A	3	6	9	0	0	9	0	0
10	17583426	.	T	C	2	0	2	0	4	6	0	0
10	17587553	.	G	A	2	2	4	0	1	5	0	0
10	17587628	.	A	T	4	2	6	0	0	6	0	0
10	17587742	.	G	A	4	3	7	0	0	7	0	0
10	17587789	.	G	A	5	7	12	0	0	12	0	0
10	17587795	.	T	C	9	0	9	0	6	15	0	0
10	17638857	.	A	G	2	0	2	0	3	5	0	0
10	17642514	.	A	G	1	4	5	0	0	5	0	0
10	17681174	.	A	T	8	5	13	0	1	14	0	0
10	17681183	.	T	A	9	8	17	0	0	17	0	0
10	17681252	.	G	A	9	7	16	0	0	16	0	0
10	17684736	.	C	T	8	9	17	0	0	17	0	0
10	17684739	.	C	T	8	10	18	0	0	18	0	0
10	17686174	.	T	C	9	12	21	0	1	22	0	0
10	17686216	.	T	C	14	12	26	0	1	27	0	0
10	17690998	.	C	T	5	7	12	0	1	13	0	0
10	17691127	.	T	G	9	4	13	0	1	14	0	0
10	17700237	.	T	C	7	0	7	0	3	10	0	0
10	17700365	.	A	T	4	7	11	0	1	12	0	0
10	17700458	.	T	C	10	15	25	0	0	25	0	0
10	17700484	.	A	T	13	11	24	0	1	25	0	0
10	17700775	.	G	A	1	3	4	0	0	4	0	0
10	17701002	.	C	G	14	14	28	0	1	29	0	0
10	17701003	.	C	A	2	15	17	0	12	29	0	0
10	17701222	.	C	T	1	4	5	0	10	15	0	0
10	17851033	.	T	G	11	8	19	0	1	20	0	0
10	17876862	.	A	G	12	0	12	1	18	31	0	0
10	17890850	.	G	A	16	18	34	0	0	34	0	0
10	17911220	.	C	T	8	13	21	0	0	21	0	0
10	17913424	.	A	C	19	9	28	0	0	28	0	0
10	17922444	.	A	G	15	21	36	0	1	37	0	0
10	17922540	.	A	T	16	18	34	0	1	35	0	0
10	17922582	.	C	T	16	21	37	0	0	37	0	0
10	17922651	.	G	C	11	17	28	0	2	30	0	0
10	17922718	.	C	T	14	12	26	0	0	26	0	0
10	17922807	.	A	G	19	0	19	0	12	31	0	0
10	17922894	.	T	G	9	16	25	0	0	25	0	0
10	17922955	.	A	T	10	4	14	0	0	14	0	0
10	17922973	.	T	C	8	4	12	0	0	12	0	0
10	17923490	.	A	T	9	17	26	0	1	27	0	0
10	17923867	.	A	C	7	6	13	0	0	13	0	0
10	17923912	.	T	A	5	12	17	0	0	17	0	0
10	17924398	.	A	C	2	6	8	0	1	9	0	0
10	17924740	.	T	G	13	12	25	0	0	25	0	0
10	17924779	.	G	A	14	7	21	0	3	24	0	0
10	17924836	.	T	A	16	10	26	0	3	29	0	0
10	17925146	.	T	C	12	21	33	0	2	35	0	0
10	17925301	.	T	A	6	10	16	0	0	16	0	0
10	17925302	.	G	T	6	10	16	0	0	16	0	0
10	17940303	.	G	A	2	9	11	0	40	51	0	0
10	17940352	.	G	A	36	19	55	0	4	59	0	0
10	17940356	.	A	G	38	19	57	0	2	59	0	0
10	17943696	.	G	A	38	24	62	0	4	66	0	0
10	17943714	.	T	C	36	25	61	0	2	63	0	0
10	17944017	.	C	T	29	19	48	0	3	51	0	0
10	17945447	.	A	G	31	17	48	0	2	50	0	0
10	17945522	.	C	T	19	12	31	2	5	38	0	0
10	17945581	.	G	T	31	20	51	0	0	51	0	0
10	17945629	.	T	C	28	21	49	0	2	51	0	0
10	17945725	.	A	G	18	24	42	0	1	43	0	0
10	17945738	.	T	A	20	20	40	0	2	42	0	0
10	17945779	.	T	A	21	17	38	0	1	39	0	0
10	17946030	.	A	T	5	5	10	0	0	10	0	0
10	17988019	.	G	T	1	2	3	0	1	4	0	0
10	18463614	.	C	G	2	6	8	0	0	8	0	0
10	18877441	.	C	A	3	2	5	0	0	5	0	0
10	18877465	.	A	T	2	2	4	0	0	4	0	0
10	18887816	.	C	T	13	8	21	0	1	22	0	0
10	18896228	.	A	C	7	12	19	0	1	20	0	0
10	18906613	.	C	G	7	0	7	0	13	22	2	0
10	18911166	.	A	G	5	6	11	0	0	11	0	0
10	18924407	.	C	G	15	12	27	0	1	28	0	0
10	18927910	.	C	T	10	10	20	0	1	21	0	0
10	18930403	.	T	C	7	22	29	1	0	30	0	0
10	18934119	.	A	T	10	5	15	0	3	18	0	0
10	18934291	.	T	C	15	11	26	0	0	26	0	0
10	18934393	.	T	G	5	0	5	0	9	14	0	0
10	18934409	.	T	A	6	8	14	0	0	14	0	0
10	18934590	.	A	C	5	18	23	0	3	26	0	0
10	18934683	.	T	C	13	13	26	0	1	27	0	0
10	18934963	.	G	A	2	8	10	0	3	13	0	0
10	18935271	.	C	T	16	14	30	0	0	30	0	0
10	18935874	.	T	A	2	5	7	0	0	7	0	0
10	18970742	.	G	T	11	7	18	0	1	19	0	0
10	18973124	.	A	G	12	1	13	0	4	17	0	0
10	18983512	.	C	A	21	14	35	0	2	37	0	0
10	18989018	.	C	G	17	17	34	0	2	36	0	0
10	18989047	.	T	C	22	14	36	0	2	38	0	0
10	19006671	.	C	T	0	2	2	0	1	3	0	0
10	19017284	.	C	T	9	6	15	0	0	15	0	0
10	19020475	.	A	G	13	8	21	0	1	22	0	0
10	19020537	.	G	A	13	7	20	0	1	21	0	0
10	19021102	.	C	G	4	9	13	0	1	14	0	0
10	19021211	.	G	T	2	7	9	0	0	9	0	0
10	19310775	.	C	G	5	3	8	0	0	8	0	0
10	19338576	.	G	A	0	6	6	0	6	12	0	0
10	19338735	.	G	C	1	4	5	0	0	6	1	0
10	19339280	.	C	G	1	3	4	0	1	5	0	0
10	19339364	.	G	A	0	2	2	0	6	8	0	0
10	19339367	.	T	C	5	2	7	0	1	8	0	0
10	19339538	.	G	C	2	15	17	0	11	28	0	0
10	19339647	.	C	T	4	10	14	0	2	16	0	0
10	19428274	.	C	A	1	3	4	0	0	4	0	0
10	19428509	.	T	C	1	2	3	0	0	3	0	0
10	19428743	.	T	A	4	6	10	0	0	10	0	0
10	19428789	.	C	T	4	3	7	0	0	7	0	0
10	19428791	.	G	T	4	3	7	0	0	7	0	0
10	19428830	.	A	C	6	2	8	0	1	9	0	0
10	19428835	.	C	A	0	2	2	0	7	9	0	0
10	19428949	.	T	C	1	2	3	0	0	3	0	0
10	19429634	.	A	T	2	3	5	0	0	5	0	0
10	19558489	.	C	A	22	18	40	0	4	44	0	0
10	19558558	.	T	A	19	22	41	0	1	43	1	0
10	19559274	.	C	T	21	16	37	0	1	38	0	0
10	19561232	.	C	A	25	19	44	0	3	47	0	0
10	19561837	.	G	A	29	30	59	0	3	62	0	0
10	19562006	.	T	G	30	22	52	0	3	55	0	0
10	19562015	.	A	T	32	23	55	0	0	55	0	0
10	19565704	.	A	T	25	25	50	2	2	54	0	0
10	19566142	.	A	T	28	30	58	0	1	59	0	0
10	19566373	.	C	T	16	17	33	1	0	34	0	0
10	19574298	.	T	C	2	2	4	0	0	4	0	0
10	19801737	.	C	A	5	7	12	0	0	12	0	0
10	19801759	.	A	C	3	5	8	0	1	9	0	0
10	19801779	.	C	T	5	4	9	0	0	9	0	0
10	19801808	.	A	G	6	3	9	0	0	9	0	0
10	20075445	.	A	G	2	1	3	0	1	4	0	0
10	20075544	.	A	G	4	0	4	0	3	7	0	0
10	20080481	.	A	G	6	0	6	0	5	11	0	0
10	20080671	.	C	T	3	5	8	0	2	11	1	0
10	20082038	.	C	T	5	3	8	0	0	8	0	0
10	20083053	.	C	T	9	5	14	1	0	15	0	0
10	20083140	.	A	G	3	3	6	0	1	7	0	0
10	20083200	.	C	T	8	3	11	0	0	11	0	0
10	20093368	.	C	T	4	4	8	0	0	8	0	0
10	20093914	.	C	T	10	7	17	0	1	18	0	0
10	20093959	.	A	G	10	8	18	0	0	18	0	0
10	20100205	.	C	T	11	9	20	0	1	21	0	0
10	20100234	.	C	T	13	14	27	0	0	27	0	0
10	20100269	.	A	C	13	15	28	0	1	29	0	0
10	20103242	.	G	T	1	2	3	0	0	3	0	0
10	20103359	.	C	T	9	6	15	1	0	16	0	0
10	20103392	.	A	G	7	7	14	1	1	16	0	0
10	20103601	.	G	T	11	7	18	0	0	18	0	0
10	20103662	.	C	T	8	9	17	0	1	18	0	0
10	20103731	.	C	T	7	10	17	0	0	17	0	0
10	20105210	.	T	C	19	10	29	0	0	29	0	0
10	20105347	.	A	G	14	21	35	0	0	35	0	0
10	20108575	.	T	A	16	24	40	0	1	41	0	0
10	20113892	.	T	C	1	2	3	0	0	3	0	0
10	20128245	.	A	C	12	16	28	0	1	29	0	0
10	20128640	.	G	A	1	6	7	0	17	24	0	0
10	20128643	.	T	A	15	9	24	0	1	25	0	0
10	20131937	.	G	A	19	13	32	0	1	33	0	0
10	20132663	.	T	C	1	3	4	0	0	4	0	0
10	20140930	.	T	A	2	3	5	0	0	5	0	0
10	20141099	.	T	A	1	3	4	0	0	4	0	0
10	20143822	.	T	A	6	3	9	0	0	9	0	0
10	20146535	.	C	T	27	23	50	0	1	51	0	0
10	20159474	.	G	A	1	2	3	0	0	3	0	0
10	20159531	.	G	A	1	1	2	0	1	3	0	0
10	20215064	.	G	T	9	6	15	0	2	17	0	0
10	20221281	.	C	T	14	12	26	0	2	28	0	0
10	20233964	.	A	G	19	0	19	0	21	40	0	0
10	20234074	.	C	T	28	18	46	0	4	50	0	0
10	20276868	.	T	G	2	5	7	0	0	7	0	0
10	20276898	.	A	G	2	4	6	0	0	6	0	0
10	20276904	.	G	A	3	4	7	0	0	7	0	0
10	20287188	.	A	G	3	6	9	0	0	9	0	0
10	20338998	.	G	C	2	3	5	0	0	5	0	0
10	20339024	.	C	T	6	2	8	0	2	10	0	0
10	20351632	.	C	T	4	2	6	0	0	6	0	0
10	20351756	.	C	T	0	7	7	0	4	11	0	0
10	20351785	.	C	G	3	8	11	0	0	11	0	0
10	20351975	.	C	T	2	6	8	0	0	8	0	0
10	20354622	.	A	T	2	7	9	0	0	9	0	0
10	20354633	.	A	T	2	8	10	0	0	10	0	0
10	20356700	.	C	T	3	2	5	0	0	5	0	0
10	20356812	.	G	A	4	2	6	0	0	6	0	0
10	20356822	.	G	T	5	2	7	0	0	7	0	0
10	20368862	.	T	A	25	12	37	0	1	38	0	0
10	20371402	.	A	T	14	15	29	0	0	29	0	0
10	20371419	.	A	C	15	13	28	0	1	29	0	0
10	20371478	.	C	A	21	13	34	0	1	35	0	0
10	20371715	.	T	C	11	14	25	0	1	26	0	0
10	20371723	.	A	C	12	10	22	0	0	22	0	0
10	20371827	.	C	T	16	13	29	0	0	29	0	0
10	20372029	.	G	A	1	2	3	0	6	9	0	0
10	20392903	.	G	A	2	3	5	0	0	5	0	0
10	20398930	.	T	C	11	5	16	0	0	16	0	0
10	20401418	.	T	C	5	2	7	1	1	9	0	0
10	20401649	.	G	T	7	7	14	0	0	14	0	0
10	20401699	.	A	C	4	4	8	0	0	8	0	0
10	20401702	.	C	G	4	4	8	0	1	9	0	0
10	20449009	.	C	T	2	4	6	0	1	7	0	0
10	20462884	.	G	A	15	17	32	0	0	32	0	0
10	20463890	.	G	A	24	16	40	0	2	42	0	0
10	20464238	.	A	G	13	15	28	0	2	30	0	0
10	20464245	.	A	G	14	15	29	0	0	29	0	0
10	20468843	.	T	A	9	9	18	0	2	21	1	0
10	20468868	.	T	C	11	0	11	0	12	23	0	0
10	20469878	.	G	C	10	10	20	0	2	22	0	0
10	20472600	.	G	T	9	11	20	0	0	20	0	0
10	20472614	.	C	T	9	11	20	0	1	21	0	0
10	20472926	.	T	C	12	11	23	0	0	23	0	0
10	20473147	.	C	G	0	14	14	0	11	25	0	0
10	20473366	.	C	T	8	10	18	0	0	18	0	0
10	20473409	.	G	A	15	8	23	0	0	23	0	0
10	20481653	.	C	T	0	5	5	0	9	14	0	0
10	20481656	.	G	A	9	6	15	0	0	15	0	0
10	20481740	.	T	C	7	13	20	0	2	22	0	0
10	20505467	.	T	C	11	0	11	0	7	18	0	0
10	20505679	.	T	G	5	2	7	0	1	8	0	0
10	20506482	.	T	A	5	3	8	0	1	9	0	0
10	20508791	.	T	A	5	5	10	0	0	10	0	0
10	20517889	.	A	G	4	8	12	0	0	12	0	0
10	20519543	.	T	C	8	4	12	0	0	12	0	0
10	20519549	.	T	C	8	0	8	0	4	12	0	0
10	20527571	.	C	T	2	2	4	0	0	4	0	0
10	20527653	.	C	T	11	3	14	0	1	15	0	0
10	20527736	.	C	T	1	5	6	0	13	19	0	0
10	20527837	.	C	A	1	14	15	0	5	20	0	0
10	20529384	.	G	A	13	7	20	0	3	23	0	0
10	20529389	.	G	T	15	7	22	0	0	22	0	0
10	20533079	.	A	C	7	6	13	0	0	13	0	0
10	20546530	.	G	A	14	7	21	0	1	23	1	0
10	20558156	.	G	C	7	14	21	0	0	21	0	0
10	20558270	.	G	A	10	14	24	0	1	25	0	0
10	20558300	.	G	C	8	0	8	0	9	17	0	0
10	20562894	.	C	T	13	15	28	0	1	29	0	0
10	20563086	.	T	C	10	10	20	0	2	22	0	0
10	20586604	.	A	G	12	13	25	0	0	25	0	0
10	20586613	.	A	T	13	14	27	0	0	27	0	0
10	20590317	.	T	C	12	11	23	0	1	24	0	0
10	20590372	.	T	A	21	11	32	0	1	33	0	0
10	20590436	.	A	C	25	10	35	0	2	37	0	0
10	20590461	.	G	T	23	12	35	0	3	38	0	0
10	20590547	.	T	C	13	13	26	0	0	26	0	0
10	20590569	.	C	T	13	16	29	0	0	29	0	0
10	20591833	.	G	A	0	12	12	1	13	26	0	0
10	20592598	.	G	T	5	7	12	0	2	14	0	0
10	20596178	.	C	G	11	12	23	0	1	24	0	0
10	20598177	.	C	A	10	16	26	0	0	26	0	0
10	20598270	.	G	A	3	8	11	1	0	12	0	0
10	20598345	.	C	G	10	6	16	14	1	31	0	0
10	20604548	.	A	G	12	16	28	0	1	29	0	0
10	20604703	.	G	T	13	11	24	0	1	25	0	0
10	20605150	.	C	T	14	12	26	0	1	27	0	0
10	20605171	.	A	T	8	13	21	0	3	24	0	0
10	20636072	.	A	C	27	13	40	0	0	40	0	0
10	20636082	.	C	T	24	13	37	0	2	39	0	0
10	20636211	.	G	A	11	17	28	0	1	29	0	0
10	20636262	.	T	A	20	10	30	0	1	31	0	0
10	20636479	.	T	C	6	11	17	0	0	17	0	0
10	20636600	.	T	C	9	0	9	0	4	13	0	0
10	20637069	.	C	T	13	22	35	0	3	38	0	0
10	20654817	.	A	T	2	2	4	0	0	4	0	0
10	20660387	.	G	A	2	6	8	0	1	9	0	0
10	20661288	.	A	G	3	9	12	0	1	13	0	0
10	20696429	.	G	A	1	3	4	0	0	4	0	0
10	21043461	.	G	A	19	16	35	0	1	36	0	0
10	21043934	.	A	G	7	7	14	0	0	14	0	0
10	21043944	.	A	G	8	8	16	0	0	16	0	0
10	21044037	.	G	A	6	15	21	0	1	22	0	0
10	21044064	.	G	A	18	5	23	0	2	25	0	0
10	21044094	.	T	A	4	19	23	0	1	24	0	0
10	21044136	.	G	A	7	13	20	0	1	21	0	0
10	21044193	.	A	G	10	7	17	0	1	18	0	0
10	21044235	.	A	C	12	6	18	0	0	18	0	0
10	21044286	.	A	G	8	8	16	0	0	16	0	0
10	21044337	.	T	C	8	0	8	0	9	17	0	0
10	21044361	.	A	T	5	7	12	0	1	13	0	0
10	21044385	.	G	T	5	5	10	0	0	10	0	0
10	21044645	.	G	A	3	7	10	0	1	11	0	0
10	21044964	.	T	A	10	8	18	0	0	18	0	0
10	21045123	.	A	T	15	9	24	0	1	25	0	0
10	21046033	.	C	T	4	3	7	0	0	7	0	0
10	21046442	.	G	A	8	9	17	0	0	17	0	0
10	21046493	.	T	C	12	4	16	0	1	17	0	0
10	21053932	.	A	C	4	6	10	0	0	10	0	0
10	21053945	.	C	T	6	5	11	0	0	11	0	0
10	21053967	.	T	C	6	4	10	0	0	10	0	0
10	21440173	.	T	C	12	10	22	0	1	23	0	0
10	21440486	.	T	A	14	17	31	0	0	31	0	0
10	21440786	.	A	G	13	19	32	0	0	32	0	0
10	21441305	.	C	T	11	16	27	0	0	27	0	0
10	21442994	.	T	A	19	24	43	0	0	43	0	0
10	21443135	.	G	A	0	16	16	0	13	30	1	0
10	21443193	.	T	G	16	15	31	0	2	34	1	0
10	21443476	.	T	C	16	21	37	0	1	38	0	0
10	21451996	.	C	T	15	10	25	0	0	25	0	0
10	21456498	.	T	C	16	9	25	0	0	25	0	0
10	21459017	.	G	A	3	15	18	0	9	27	0	0
10	21459403	.	G	A	0	15	15	0	16	31	0	0
10	21462585	.	A	G	16	18	34	0	1	35	0	0
10	21462612	.	T	C	18	17	35	0	1	36	0	0
10	21469977	.	G	A	2	14	16	0	13	29	0	0
10	21469997	.	A	C	17	13	30	0	1	31	0	0
10	21470192	.	G	A	2	10	12	0	13	25	0	0
10	21513583	.	G	A	1	4	5	0	1	6	0	0
10	21523014	.	C	T	7	12	19	0	0	19	0	0
10	21523578	.	C	A	6	4	10	0	0	10	0	0
10	21523720	.	T	C	5	6	11	0	0	11	0	0
10	21523827	.	A	G	3	4	7	0	0	7	0	0
10	21524016	.	G	A	1	4	5	0	6	11	0	0
10	21524121	.	A	T	12	7	19	0	1	20	0	0
10	21524244	.	C	A	8	8	16	0	2	18	0	0
10	21524319	.	G	T	7	4	11	0	1	12	0	0
10	21524337	.	C	T	7	3	10	0	0	10	0	0
10	21524472	.	C	T	10	6	16	0	0	16	0	0
10	21524679	.	G	A	11	8	19	0	0	19	0	0
10	21524919	.	C	G	12	0	12	0	8	20	0	0
10	21525243	.	A	G	11	8	19	0	0	19	0	0
10	21525276	.	T	A	10	3	13	0	1	15	1	0
10	21588009	.	G	T	1	3	4	0	0	4	0	0
10	21588036	.	C	T	1	3	4	0	0	4	0	0
10	21588763	.	A	C	2	2	4	0	0	4	0	0
10	21588812	.	A	G	1	3	4	0	0	4	0	0
10	21588814	.	A	T	1	3	4	0	0	4	0	0
10	21622317	.	G	A	40	36	76	3	1	80	0	0
10	21645994	.	G	A	33	21	54	0	3	57	0	0
10	21646216	.	T	C	29	6	35	0	1	36	0	0
10	21646225	.	G	A	27	6	33	0	3	36	0	0
10	21646400	.	C	G	23	22	45	0	1	46	0	0
10	21646621	.	C	T	33	23	56	0	3	59	0	0
10	21646668	.	T	A	32	23	55	0	4	59	0	0
10	21646797	.	C	T	33	18	51	0	1	52	0	0
10	21646802	.	A	G	34	18	52	0	1	53	0	0
10	21646848	.	A	G	25	22	47	0	3	50	0	0
10	21646908	.	C	A	23	23	46	0	3	49	0	0
10	21647008	.	A	C	24	22	46	0	1	47	0	0
10	21647539	.	T	C	37	35	72	0	2	74	0	0
10	21647582	.	C	A	37	34	71	0	1	72	0	0
10	21647614	.	A	C	36	26	62	0	7	69	0	0
10	21647691	.	G	A	33	17	50	0	3	53	0	0
10	21647898	.	C	T	31	28	59	1	3	63	0	0
10	21651602	.	T	C	1	7	8	0	0	8	0	0
10	21657070	.	T	C	1	2	3	0	0	3	0	0
10	21657565	.	C	T	1	2	3	0	0	3	0	0
10	21658567	.	G	A	3	3	6	0	0	6	0	0
10	21660469	.	T	C	1	2	3	0	0	3	0	0
10	21677518	.	G	C	0	2	2	0	0	2	0	0
10	21677525	.	C	T	1	3	4	0	0	4	0	0
10	21679442	.	T	C	3	5	8	2	1	11	0	0
10	21679496	.	G	A	7	4	11	0	0	11	0	0
10	21679497	.	C	A	4	7	11	0	0	11	0	0
10	21701576	.	T	C	3	2	5	0	0	5	0	0
10	21701758	.	C	T	4	2	6	0	0	6	0	0
10	21702304	.	A	T	4	5	9	0	1	10	0	0
10	21702390	.	C	T	2	4	6	0	0	6	0	0
10	21702397	.	C	T	1	5	6	0	0	6	0	0
10	21702846	.	A	G	1	2	3	0	0	3	0	0
10	21703011	.	C	T	1	2	3	0	0	3	0	0
10	21703705	.	T	C	5	3	8	0	0	8	0	0
10	21703735	.	C	A	8	4	12	1	0	13	0	0
10	21719004	.	A	C	4	2	6	0	0	6	0	0
10	21719065	.	A	T	1	2	3	0	0	3	0	0
10	21719115	.	A	G	4	0	4	0	2	6	0	0
10	21719125	.	G	A	4	2	6	0	0	6	0	0
10	21720798	.	T	C	5	7	12	1	0	13	0	0
10	21723014	.	C	A	5	2	7	2	0	9	0	0
10	21723023	.	G	A	1	2	3	2	4	9	0	0
10	21723083	.	G	A	5	2	7	0	1	8	0	0
10	21723092	.	A	T	3	4	7	0	1	8	0	0
10	21723140	.	A	G	2	3	5	0	1	6	0	0
10	21723263	.	C	A	3	5	8	0	0	8	0	0
10	21723293	.	C	T	1	5	6	0	0	6	0	0
10	21723536	.	A	G	3	0	3	0	3	6	0	0
10	21723620	.	C	T	2	2	4	0	0	4	0	0
10	21723674	.	G	A	1	4	5	0	0	5	0	0
10	21723878	.	C	T	2	2	4	0	0	4	0	0
10	21723887	.	A	G	2	0	2	0	1	3	0	0
10	21724095	.	A	T	3	2	5	0	0	5	0	0
10	21724118	.	A	G	4	2	6	0	0	6	0	0
10	21724154	.	C	T	4	3	7	0	0	7	0	0
10	21729191	.	T	C	2	4	6	0	0	6	0	0
10	21729232	.	G	A	7	4	11	1	0	12	0	0
10	21732066	.	C	G	1	5	6	1	0	7	0	0
10	21776931	.	G	T	0	5	5	0	3	8	0	0
10	21776952	.	T	C	4	3	7	0	0	7	0	0
10	21777924	.	G	A	1	2	3	0	0	3	0	0
10	21778125	.	G	A	5	3	8	0	1	9	0	0
10	21778980	.	C	T	5	5	10	6	0	16	0	0
10	21778997	.	T	C	4	3	7	3	0	10	0	0
10	21779022	.	A	C	3	2	5	0	0	5	0	0
10	21779067	.	C	T	2	6	8	0	0	8	0	0
10	21779073	.	T	A	2	7	9	0	0	9	0	0
10	21780310	.	G	A	2	4	6	1	10	17	0	0
10	21780571	.	A	G	19	13	32	1	0	33	0	0
10	21780579	.	C	T	19	11	30	1	3	34	0	0
10	21781308	.	A	G	9	0	9	6	18	33	0	0
10	21781313	.	C	T	12	11	23	9	1	33	0	0
10	21785677	.	C	T	11	8	19	3	2	24	0	0
10	21785734	.	C	T	7	3	10	11	1	22	0	0
10	21786934	.	G	T	1	4	5	0	0	5	0	0
10	21790121	.	C	A	8	13	21	0	2	23	0	0
10	21790137	.	G	A	8	14	22	0	1	23	0	0
10	21791375	.	G	A	9	10	19	0	1	20	0	0
10	21791690	.	G	A	0	5	5	20	2	27	0	0
10	21791699	.	T	C	2	5	7	22	0	29	0	0
10	21791745	.	G	A	1	4	5	6	0	11	0	0
10	21791801	.	G	A	0	6	6	3	1	10	0	0
10	21792024	.	A	C	14	12	26	9	0	35	0	0
10	21794302	.	G	A	0	3	3	0	3	6	0	0
10	21794410	.	T	A	3	7	10	0	0	10	0	0
10	21794598	.	A	C	6	7	13	0	0	13	0	0
10	21794797	.	A	C	6	10	16	0	0	16	0	0
10	21794800	.	A	T	6	9	15	0	1	16	0	0
10	21795065	.	C	T	2	5	7	0	0	7	0	0
10	21795190	.	T	A	10	3	13	0	0	13	0	0
10	21795216	.	G	C	6	3	9	10	0	19	0	0
10	21795337	.	C	T	4	4	8	12	0	20	0	0
10	21795412	.	A	T	13	3	16	1	0	17	0	0
10	21795421	.	G	A	11	2	13	1	0	14	0	0
10	21795655	.	A	T	6	3	9	1	0	10	0	0
10	21795805	.	G	A	3	4	7	16	1	24	0	0
10	21797207	.	G	C	14	7	21	0	0	21	0	0
10	21797247	.	C	A	8	5	13	0	1	14	0	0
10	21797502	.	G	A	4	5	9	10	0	19	0	0
10	21797665	.	C	T	5	4	9	0	0	9	0	0
10	21797710	.	A	G	4	2	6	0	0	6	0	0
10	21797914	.	G	A	2	5	7	0	0	7	0	0
10	21798215	.	C	A	5	12	17	2	1	20	0	0
10	21799320	.	A	C	1	3	4	6	0	10	0	0
10	21799408	.	T	A	4	5	9	22	0	31	0	0
10	21801856	.	C	T	9	8	17	0	1	18	0	0
10	21806789	.	G	A	11	4	15	0	0	15	0	0
10	21818916	.	C	T	35	23	58	0	1	59	0	0
10	21818978	.	G	T	37	31	68	0	3	71	0	0
10	21819019	.	G	A	5	32	37	0	31	68	0	0
10	21819038	.	C	A	29	36	65	0	0	65	0	0
10	21819105	.	G	T	23	38	61	0	1	62	0	0
10	21819214	.	G	C	28	29	57	0	3	61	1	0
10	21819506	.	G	A	42	11	53	0	6	59	0	0
10	21819653	.	T	C	44	35	79	0	0	79	0	0
10	21917713	.	T	C	1	0	1	0	3	4	0	0
10	21919255	.	G	A	1	2	3	0	0	3	0	0
10	21944787	.	T	C	1	4	5	0	0	6	1	0
10	21944814	.	C	T	1	3	4	0	2	6	0	0
10	21944836	.	T	C	4	2	6	1	0	7	0	0
10	22003847	.	T	C	21	29	50	0	1	51	0	0
10	22003874	.	A	G	14	24	38	0	2	40	0	0
10	22012534	.	G	A	9	13	22	0	0	22	0	0
10	22030798	.	C	T	22	20	42	0	1	44	1	0
10	22030827	.	G	A	17	21	38	0	1	39	0	0
10	22030887	.	T	G	27	20	47	0	1	48	0	0
10	22030985	.	T	C	21	20	41	0	1	42	0	0
10	22030986	.	C	T	17	21	38	0	2	40	0	0
10	22031034	.	C	T	23	20	43	0	2	45	0	0
10	22031375	.	A	C	29	12	41	0	4	45	0	0
10	22031805	.	G	C	10	14	24	0	1	25	0	0
10	22031806	.	G	A	10	12	22	0	3	25	0	0
10	22031854	.	G	A	9	7	16	0	4	20	0	0
10	22035638	.	A	G	7	5	12	0	2	14	0	0
10	22036033	.	A	G	6	0	6	0	7	13	0	0
10	22036169	.	A	G	11	5	16	1	0	17	0	0
10	22036235	.	T	A	17	9	26	0	3	29	0	0
10	22041546	.	C	T	8	10	18	0	0	18	0	0
10	22041717	.	T	C	11	11	22	0	0	22	0	0
10	22044982	.	C	T	6	6	12	0	1	13	0	0
10	22045014	.	G	T	6	4	10	0	0	10	0	0
10	22051436	.	A	G	6	2	8	0	0	8	0	0
10	22051465	.	G	C	3	3	6	0	0	6	0	0
10	22051474	.	A	C	3	3	6	0	0	6	0	0
10	22051548	.	C	T	0	2	2	0	1	3	0	0
10	22051854	.	C	T	1	3	4	0	0	4	0	0
10	22051880	.	T	A	3	2	5	0	0	5	0	0
10	22051933	.	A	G	1	2	3	0	0	3	0	0
10	22052133	.	T	C	1	5	6	0	0	6	0	0
10	22052247	.	C	T	0	3	3	0	1	4	0	0
10	22052361	.	C	T	1	2	3	0	2	5	0	0
10	22054149	.	T	C	1	2	3	0	2	5	0	0
10	22054158	.	A	G	2	3	5	0	0	5	0	0
10	22056675	.	C	T	2	2	4	0	0	4	0	0
10	22134695	.	G	A	3	4	7	0	0	7	0	0
10	22162187	.	T	C	13	0	13	0	18	31	0	0
10	22162576	.	A	G	6	6	12	0	1	13	0	0
10	22162673	.	T	G	8	5	13	0	0	13	0	0
10	22163235	.	C	T	0	5	5	0	7	12	0	0
10	22163244	.	C	G	7	3	10	0	0	10	0	0
10	22163660	.	C	T	10	9	19	0	0	19	0	0
10	22163801	.	A	T	7	4	11	0	0	11	0	0
10	22163867	.	T	C	7	7	14	0	1	15	0	0
10	22163928	.	C	A	5	10	15	0	1	16	0	0
10	22164144	.	A	T	4	6	10	0	0	10	0	0
10	22164276	.	T	C	2	2	4	0	0	4	0	0
10	22164421	.	T	A	5	4	9	0	0	9	0	0
10	22164518	.	T	A	9	6	15	0	1	16	0	0
10	22164621	.	T	G	5	6	11	0	1	12	0	0
10	22164622	.	G	A	6	6	12	0	0	12	0	0
10	22164672	.	G	A	5	7	12	0	0	12	0	0
10	22164686	.	A	T	4	7	11	0	0	11	0	0
10	22164756	.	T	C	5	7	12	0	1	13	0	0
10	22165383	.	C	G	4	4	8	0	0	8	0	0
10	22165607	.	T	G	6	2	8	0	0	8	0	0
10	22165644	.	T	C	5	3	8	0	1	9	0	0
10	22165709	.	G	A	5	2	7	0	0	7	0	0
10	22165719	.	C	A	2	2	4	0	4	8	0	0
10	22165768	.	T	A	7	5	12	0	1	13	0	0
10	22165879	.	T	A	5	3	8	0	0	8	0	0
10	22165880	.	T	C	5	3	8	0	0	8	0	0
10	22165953	.	C	T	11	4	15	0	0	15	0	0
10	22166010	.	T	A	5	5	10	0	2	12	0	0
10	22166128	.	C	T	6	7	13	0	0	13	0	0
10	22166182	.	A	C	4	0	4	0	8	12	0	0
10	22166184	.	G	A	5	6	11	0	1	12	0	0
10	22166504	.	C	T	9	9	18	0	1	19	0	0
10	22205038	.	G	A	6	7	13	1	0	14	0	0
10	22248334	.	C	T	0	2	2	0	4	6	0	0
10	22381847	.	A	G	3	3	6	0	2	8	0	0
10	22382427	.	T	C	8	9	17	0	0	17	0	0
10	22382454	.	C	T	5	11	16	0	1	17	0	0
10	22439796	.	G	A	0	5	5	0	9	14	0	0
10	22471425	.	C	T	9	12	21	3	1	25	0	0
10	22475679	.	C	A	6	9	15	0	0	15	0	0
10	22477580	.	C	T	15	5	20	0	0	20	0	0
10	22477694	.	C	A	9	6	15	0	2	17	0	0
10	22477724	.	G	A	7	9	16	0	2	18	0	0
10	22477952	.	A	T	19	19	38	0	0	38	0	0
10	22510354	.	C	A	3	2	5	0	0	5	0	0
10	22510670	.	T	A	5	6	11	0	0	11	0	0
10	22516643	.	C	G	5	12	17	0	1	18	0	0
10	22516758	.	T	C	9	5	14	0	0	14	0	0
10	22516903	.	A	G	5	6	11	0	1	12	0	0
10	22518293	.	C	T	16	13	29	0	3	32	0	0
10	22518294	.	C	T	15	13	28	0	3	31	0	0
10	22519465	.	A	G	9	15	24	0	0	24	0	0
10	22519668	.	A	T	6	9	15	0	0	15	0	0
10	22519737	.	C	T	8	5	13	0	1	14	0	0
10	22519749	.	G	C	7	3	10	0	0	10	0	0
10	22519931	.	C	T	6	6	12	0	0	12	0	0
10	22528077	.	C	T	7	6	13	0	0	13	0	0
10	22530043	.	C	T	10	6	16	0	0	16	0	0
10	22530812	.	T	C	12	4	16	0	0	16	0	0
10	22531422	.	A	G	13	0	13	0	9	22	0	0
10	22531472	.	T	C	9	5	14	0	1	15	0	0
10	22531946	.	T	G	11	12	23	0	1	24	0	0
10	22532139	.	C	T	7	8	15	0	2	17	0	0
10	22532211	.	G	A	11	9	20	0	0	20	0	0
10	22532287	.	T	A	11	15	26	0	1	27	0	0
10	22532918	.	A	T	15	14	29	0	2	31	0	0
10	22605394	.	T	A	1	4	5	0	0	5	0	0
10	22747289	.	G	C	1	13	14	0	5	19	0	0
10	22747995	.	T	C	7	7	14	0	1	15	0	0
10	22748964	.	G	C	2	10	12	0	0	12	0	0
10	22749361	.	T	G	11	0	11	0	6	17	0	0
10	22749623	.	C	T	6	4	10	0	0	10	0	0
10	22749824	.	A	C	2	8	10	0	0	10	0	0
10	22754289	.	C	T	7	7	14	0	0	14	0	0
10	22782648	.	A	C	8	14	22	0	1	23	0	0
10	22785632	.	C	T	11	8	19	0	1	20	0	0
10	22785820	.	C	A	16	16	32	0	1	33	0	0
10	22785983	.	C	T	12	5	17	0	0	17	0	0
10	22786044	.	C	A	5	5	10	0	1	11	0	0
10	22786054	.	A	G	5	6	11	0	1	12	0	0
10	22786227	.	C	T	6	8	14	0	0	14	0	0
10	22791899	.	T	C	1	0	1	0	3	4	0	0
10	22791906	.	A	G	2	2	4	0	0	4	0	0
10	22811141	.	C	A	9	2	11	0	0	11	0	0
10	22811144	.	C	A	8	3	11	0	1	12	0	0
10	22811197	.	C	T	7	4	11	0	0	11	0	0
10	22811542	.	A	G	14	4	18	0	0	18	0	0
10	22811633	.	C	T	12	4	16	0	2	18	0	0
10	22811857	.	G	A	10	3	13	0	0	13	0	0
10	22811860	.	T	A	10	3	13	0	0	13	0	0
10	22812333	.	T	A	6	2	8	0	0	8	0	0
10	22812381	.	C	T	8	2	10	0	0	10	0	0
10	22812572	.	C	T	3	2	5	0	6	11	0	0
10	22812716	.	A	G	11	9	20	0	0	20	0	0
10	22813194	.	C	T	11	5	16	0	0	16	0	0
10	22814722	.	A	C	14	8	22	0	0	22	0	0
10	22814833	.	G	A	8	6	14	0	2	16	0	0
10	22814847	.	A	T	7	9	16	0	1	17	0	0
10	22814905	.	C	T	8	4	12	0	0	12	0	0
10	22815243	.	T	C	9	0	9	0	5	14	0	0
10	22821603	.	A	G	2	4	6	0	0	6	0	0
10	22824197	.	C	T	1	5	6	0	10	16	0	0
10	22828439	.	A	T	6	3	9	0	0	9	0	0
10	22845286	.	C	A	28	32	60	0	2	62	0	0
10	22854976	.	A	T	9	3	12	0	0	12	0	0
10	22854977	.	G	A	9	3	12	0	0	12	0	0
10	22855033	.	G	T	7	3	10	0	0	10	0	0
10	22858361	.	T	C	5	6	11	0	0	11	0	0
10	22891212	.	A	G	9	9	18	0	1	19	0	0
10	22891237	.	A	T	7	12	19	0	3	22	0	0
10	22893992	.	A	G	14	10	24	0	1	25	0	0
10	22895327	.	T	C	6	10	16	0	0	16	0	0
10	22896775	.	C	T	11	5	16	0	0	16	0	0
10	22906434	.	C	T	11	16	27	1	0	28	0	0
10	22906587	.	T	C	9	11	20	1	1	22	0	0
10	22906783	.	T	C	8	14	22	0	1	23	0	0
10	22907242	.	A	T	12	6	18	0	1	19	0	0
10	22907330	.	G	A	4	6	10	0	0	10	0	0
10	22912268	.	T	G	1	2	3	0	0	3	0	0
10	22912283	.	G	T	2	5	7	0	1	8	0	0
10	22915777	.	T	C	9	7	16	0	1	17	0	0
10	22916422	.	A	C	22	39	61	0	2	63	0	0
10	22916426	.	T	A	21	38	59	0	3	62	0	0
10	22916490	.	G	A	24	24	48	0	3	51	0	0
10	22916520	.	T	C	30	20	50	0	1	51	0	0
10	22916661	.	G	C	43	20	63	0	0	63	0	0
10	22916664	.	C	T	41	19	60	0	3	63	0	0
10	22916730	.	A	G	41	26	67	0	4	71	0	0
10	22916739	.	G	A	42	27	69	0	0	69	0	0
10	22918122	.	A	T	34	26	60	0	4	64	0	0
10	22918124	.	A	C	33	0	33	0	29	62	0	0
10	22918164	.	T	C	19	26	45	0	5	50	0	0
10	22918174	.	G	A	14	25	39	0	4	43	0	0
10	22918490	.	T	G	1	4	5	0	1	6	0	0
10	22921942	.	T	C	11	3	14	0	0	14	0	0
10	22921976	.	A	T	7	5	12	0	0	12	0	0
10	22925851	.	T	C	2	2	4	0	0	4	0	0
10	22955718	.	A	G	5	5	10	0	0	10	0	0
10	23024360	.	C	T	14	19	33	0	4	37	0	0
10	23024405	.	T	C	13	16	29	0	1	30	0	0
10	23024584	.	A	C	26	21	47	0	1	48	0	0
10	23024660	.	A	G	23	19	42	0	3	45	0	0
10	23024708	.	T	C	19	22	41	0	2	43	0	0
10	23024762	.	A	G	24	24	48	0	0	48	0	0
10	23026025	.	T	C	21	17	38	0	3	41	0	0
10	23026490	.	A	G	3	0	3	0	3	6	0	0
10	23060643	.	C	T	8	9	17	0	0	17	0	0
10	23065084	.	G	A	9	13	22	0	0	22	0	0
10	23065247	.	T	C	6	14	20	0	1	21	0	0
10	23065295	.	C	T	9	9	18	0	0	18	0	0
10	23065777	.	T	C	9	15	24	0	0	24	0	0
10	23068630	.	A	G	6	13	19	0	0	19	0	0
10	23068962	.	A	G	7	12	19	0	1	20	0	0
10	23068963	.	C	T	8	12	20	0	0	20	0	0
10	23069068	.	C	T	7	8	15	0	1	16	0	0
10	23069120	.	T	C	7	6	13	1	0	14	0	0
10	23069253	.	T	C	1	6	7	0	0	7	0	0
10	23070890	.	A	G	2	4	6	0	0	6	0	0
10	23071465	.	T	C	4	0	4	0	6	10	0	0
10	23071697	.	G	A	2	5	7	0	0	7	0	0
10	23071705	.	G	C	2	4	6	0	0	6	0	0
10	23076290	.	A	G	1	8	9	0	0	9	0	0
10	23076327	.	G	A	4	5	9	0	0	9	0	0
10	23079799	.	C	T	3	3	6	0	0	7	1	0
10	23099548	.	A	G	2	5	7	0	0	7	0	0
10	23114696	.	T	G	1	2	3	0	0	3	0	0
10	23126678	.	T	C	1	6	7	0	0	7	0	0
10	23131977	.	C	A	1	5	6	0	0	6	0	0
10	23135655	.	C	T	3	5	8	0	0	8	0	0
10	23135800	.	G	T	0	4	4	0	4	8	0	0
10	23138486	.	A	G	1	5	6	0	0	6	0	0
10	23139227	.	C	A	0	2	2	0	1	3	0	0
10	23139237	.	A	T	1	3	4	0	0	4	0	0
10	23139994	.	G	A	0	2	2	0	3	5	0	0
10	23139997	.	G	A	3	1	4	0	1	5	0	0
10	23220530	.	T	A	11	11	22	0	3	25	0	0
10	23246073	.	G	T	10	8	18	0	0	18	0	0
10	23275265	.	G	A	6	8	14	1	2	17	0	0
10	23358248	.	C	T	1	8	9	0	7	16	0	0
10	24324014	.	G	T	27	21	48	0	1	49	0	0
10	24326236	.	C	T	23	21	44	0	0	44	0	0
10	24326242	.	C	T	23	20	43	0	2	45	0	0
10	24334810	.	G	A	21	24	45	0	1	46	0	0
10	24335002	.	C	T	17	22	39	0	0	39	0	0
10	24335402	.	C	T	16	5	21	0	2	23	0	0
10	24340993	.	T	C	13	0	13	1	19	33	0	0
10	24373125	.	C	T	1	4	5	0	1	6	0	0
10	24373701	.	A	T	2	4	6	0	0	6	0	0
10	24373721	.	G	T	3	3	6	0	0	6	0	0
10	24424363	.	G	C	1	9	10	0	6	16	0	0
10	24426038	.	A	T	10	13	23	0	2	25	0	0
10	24429342	.	T	C	6	5	11	0	0	11	0	0
10	24429357	.	T	C	4	6	10	0	0	10	0	0
10	24431479	.	C	T	8	14	22	0	0	22	0	0
10	24439910	.	A	G	14	0	14	0	11	25	0	0
10	24441916	.	C	T	16	16	32	1	0	33	0	0
10	24442373	.	C	A	19	7	26	0	1	27	0	0
10	24563892	.	T	G	14	12	26	0	0	26	0	0
10	24564040	.	T	C	18	11	29	0	2	31	0	0
10	24564904	.	G	A	2	13	15	0	11	26	0	0
10	24564935	.	C	A	12	13	25	0	0	25	0	0
10	24565366	.	A	T	13	15	28	0	0	28	0	0
10	24565424	.	G	A	15	14	29	0	3	32	0	0
10	24565435	.	G	T	3	11	14	0	15	29	0	0
10	24565587	.	C	A	8	9	17	0	0	17	0	0
10	24566124	.	T	C	15	11	26	0	0	26	0	0
10	24573827	.	C	T	11	15	26	0	0	26	0	0
10	24600110	.	A	G	13	2	15	0	18	33	0	0
10	24600128	.	A	G	16	13	29	0	0	29	0	0
10	24605406	.	A	C	14	14	28	0	1	29	0	0
10	24609362	.	C	A	13	8	21	0	0	21	0	0
10	24614505	.	A	T	12	9	21	0	1	22	0	0
10	24616839	.	C	A	13	9	22	0	0	22	0	0
10	24616944	.	T	C	13	8	21	0	0	21	0	0
10	24617156	.	G	A	6	11	17	0	1	18	0	0
10	24617621	.	G	C	0	10	10	0	11	21	0	0
10	24617624	.	G	A	11	9	20	0	1	21	0	0
10	24621543	.	G	A	15	13	28	0	5	33	0	0
10	24621687	.	G	A	9	8	17	0	0	17	0	0
10	24621730	.	A	T	5	3	8	0	1	9	0	0
10	24621757	.	T	A	7	6	13	0	0	13	0	0
10	24649813	.	T	G	10	4	14	0	1	15	0	0
10	24650194	.	A	G	3	6	9	0	0	9	0	0
10	24650696	.	C	A	5	3	8	0	0	8	0	0
10	24650889	.	T	A	3	5	8	0	2	10	0	0
10	24653833	.	G	A	5	8	13	0	3	16	0	0
10	24653920	.	C	T	9	6	15	0	0	15	0	0
10	24653989	.	T	A	6	2	8	0	1	9	0	0
10	24654319	.	A	C	11	10	21	0	0	21	0	0
10	24654501	.	C	T	1	7	8	0	11	19	0	0
10	24654607	.	A	T	6	5	11	0	0	11	0	0
10	24654765	.	C	T	7	11	18	0	0	18	0	0
10	24655146	.	A	T	12	15	27	0	2	29	0	0
10	24655984	.	C	T	5	7	12	0	1	13	0	0
10	24656449	.	T	A	5	9	14	0	0	14	0	0
10	24659100	.	A	G	5	3	8	0	0	8	0	0
10	24659461	.	C	T	1	2	3	0	0	3	0	0
10	24659492	.	T	A	2	3	5	0	0	5	0	0
10	24659507	.	C	T	2	3	5	0	0	5	0	0
10	24659661	.	A	C	6	3	9	0	0	9	0	0
10	24659717	.	G	C	6	7	13	0	0	13	0	0
10	24659769	.	T	A	5	3	8	0	1	9	0	0
10	24660215	.	T	G	6	6	12	0	1	13	0	0
10	24662642	.	T	C	8	8	16	0	0	16	0	0
10	24666069	.	A	C	6	8	14	0	0	14	0	0
10	24677119	.	A	G	1	3	4	0	0	4	0	0
10	24677136	.	T	G	1	3	4	0	0	4	0	0
10	24677867	.	C	T	1	2	3	0	0	3	0	0
10	24685624	.	T	A	4	2	6	0	0	6	0	0
10	24686143	.	G	A	0	4	4	0	4	8	0	0
10	24700125	.	T	G	1	2	3	0	0	3	0	0
10	24707271	.	T	C	1	2	3	0	0	3	0	0
10	24707594	.	G	T	0	5	5	0	0	5	0	0
10	24707595	.	T	A	1	5	6	0	0	6	0	0
10	24710282	.	A	T	2	4	6	0	0	6	0	0
10	24710510	.	C	A	7	2	9	0	0	9	0	0
10	24710771	.	C	G	0	4	4	0	2	6	0	0
10	24710777	.	G	T	2	5	7	0	0	7	0	0
10	24710938	.	T	G	1	5	6	0	0	6	0	0
10	24710981	.	T	G	2	6	8	0	0	8	0	0
10	24720910	.	C	T	1	2	3	0	3	6	0	0
10	24724281	.	T	G	2	2	4	0	0	4	0	0
10	24726059	.	A	C	9	9	18	0	0	18	0	0
10	24726413	.	C	T	0	4	4	0	3	7	0	0
10	24726453	.	G	A	4	2	6	0	0	6	0	0
10	24726532	.	T	C	1	4	5	0	0	5	0	0
10	24727085	.	G	A	3	8	11	0	2	13	0	0
10	24736924	.	G	A	3	3	6	0	0	6	0	0
10	24762377	.	G	A	3	2	5	0	0	5	0	0
10	24762427	.	C	T	3	5	8	0	0	8	0	0
10	24762510	.	A	G	5	8	13	0	0	13	0	0
10	24762579	.	T	C	9	1	10	0	2	12	0	0
10	24762589	.	G	A	6	4	10	0	0	10	0	0
10	24762615	.	T	C	3	1	4	0	5	9	0	0
10	24762759	.	T	A	6	8	14	0	0	14	0	0
10	24762774	.	T	G	5	7	12	0	0	12	0	0
10	24765589	.	A	C	4	1	5	0	1	6	0	0
10	24765893	.	A	G	5	6	11	0	1	12	0	0
10	25035544	.	C	T	3	7	10	0	0	10	0	0
10	25109234	.	C	T	2	6	8	0	0	8	0	0
10	25109288	.	G	A	1	3	4	0	0	4	0	0
10	25121905	.	A	T	1	3	4	0	1	5	0	0
10	25122052	.	G	A	1	4	5	0	0	5	0	0
10	25152489	.	C	T	1	2	3	0	0	3	0	0
10	25152498	.	T	C	1	2	3	0	0	3	0	0
10	25155579	.	T	C	2	2	4	0	0	4	0	0
10	25205338	.	C	A	11	3	14	0	0	14	0	0
10	25209935	.	C	T	9	7	16	0	1	17	0	0
10	25219804	.	A	C	5	5	10	0	1	11	0	0
10	25219805	.	A	G	6	0	6	0	5	11	0	0
10	25222392	.	G	T	9	4	13	0	0	13	0	0
10	25222426	.	T	C	8	6	14	0	1	15	0	0
10	25250493	.	T	G	6	0	6	0	15	21	0	0
10	25252522	.	C	T	5	8	13	0	0	13	0	0
10	25252591	.	A	G	11	8	19	0	1	20	0	0
10	25252899	.	T	C	5	8	13	0	0	13	0	0
10	25255215	.	T	C	12	8	20	0	0	20	0	0
10	25261406	.	C	T	7	9	16	0	0	16	0	0
10	25261968	.	A	C	10	8	18	0	1	19	0	0
10	25262003	.	C	T	7	8	15	0	0	15	0	0
10	25267863	.	C	T	11	27	38	0	4	42	0	0
10	25268191	.	C	A	4	20	24	0	0	24	0	0
10	25268389	.	T	C	6	16	22	0	2	24	0	0
10	25268394	.	C	T	5	16	21	0	1	22	0	0
10	25268827	.	C	T	4	3	7	0	1	8	0	0
10	25268998	.	T	C	1	2	3	0	0	3	0	0
10	25269001	.	T	G	1	2	3	0	0	3	0	0
10	25269159	.	T	A	9	5	14	0	0	14	0	0
10	25269310	.	G	T	23	19	42	0	1	43	0	0
10	25269325	.	T	G	24	17	41	0	1	42	0	0
10	25269530	.	T	A	49	4	53	1	1	55	0	0
10	25269592	.	A	G	26	1	27	0	25	52	0	0
10	25269742	.	C	T	33	20	53	0	2	55	0	0
10	25269946	.	G	A	5	16	21	1	27	49	0	0
10	25270124	.	A	G	24	8	32	2	2	36	0	0
10	25270125	.	A	G	29	6	35	2	0	37	0	0
10	25270395	.	A	G	24	10	34	0	1	35	0	0
10	25270618	.	C	G	25	16	41	0	4	45	0	0
10	25270803	.	A	T	24	16	40	0	2	42	0	0
10	25270942	.	G	C	18	18	36	0	1	37	0	0
10	25271051	.	T	A	16	11	27	0	1	29	1	0
10	25271121	.	G	A	18	20	38	0	1	39	0	0
10	25271338	.	T	C	8	12	20	0	1	21	0	0
10	25312828	.	T	G	9	9	18	0	3	21	0	0
10	25312906	.	A	C	2	5	7	0	0	7	0	0
10	25317306	.	A	G	7	3	10	0	0	10	0	0
10	25318957	.	A	G	9	4	13	0	2	15	0	0
10	25325361	.	A	G	2	3	5	0	0	5	0	0
10	25328680	.	A	T	3	5	8	0	0	8	0	0
10	25328686	.	A	G	4	5	9	0	2	11	0	0
10	25329648	.	G	T	7	11	18	1	13	32	0	0
10	25329649	.	A	T	16	14	30	1	2	33	0	0
10	25330408	.	A	G	1	2	3	0	0	3	0	0
10	25330646	.	G	A	24	23	47	0	0	47	0	0
10	25333961	.	C	T	3	27	30	0	23	53	0	0
10	25334178	.	T	C	18	27	45	0	1	46	0	0
10	25336095	.	G	A	20	19	39	0	1	40	0	0
10	25338585	.	C	G	19	19	38	0	2	40	0	0
10	25342889	.	A	G	17	13	30	0	1	31	0	0
10	25342915	.	A	T	12	13	25	0	2	27	0	0
10	26225398	.	T	C	4	0	4	0	8	12	0	0
10	26225479	.	T	C	8	0	8	0	6	14	0	0
10	26269728	.	G	A	2	3	5	0	1	6	0	0
10	26269842	.	T	C	4	9	13	0	0	13	0	0
10	26270847	.	T	C	7	1	8	0	14	22	0	0
10	26271357	.	C	A	3	2	5	0	0	5	0	0
10	26271522	.	T	C	2	8	10	0	2	12	0	0
10	26271672	.	G	C	7	4	11	0	0	11	0	0
10	26271765	.	C	G	0	4	4	0	2	6	0	0
10	26272062	.	G	T	3	2	5	0	0	5	0	0
10	26272338	.	C	G	0	5	5	0	2	7	0	0
10	26272756	.	T	C	2	0	2	0	3	5	0	0
10	26279001	.	G	A	3	2	5	0	1	6	0	0
10	26279519	.	T	C	4	3	7	0	0	7	0	0
10	26280339	.	T	C	5	1	6	0	4	10	0	0
10	26285271	.	G	T	2	4	6	0	0	6	0	0
10	26285280	.	C	T	2	3	5	0	0	5	0	0
10	26294979	.	T	G	3	2	5	0	0	5	0	0
10	26296608	.	T	C	1	2	3	0	0	3	0	0
10	26409356	.	G	A	2	3	5	0	0	5	0	0
10	26409362	.	C	T	2	3	5	0	0	5	0	0
10	26410253	.	G	A	2	3	5	0	0	5	0	0
10	26504840	.	G	A	1	5	6	0	0	6	0	0
10	26508081	.	T	C	3	0	3	0	5	8	0	0
10	26517557	.	C	A	6	2	8	0	0	8	0	0
10	26536177	.	C	T	14	12	26	0	0	26	0	0
10	26536231	.	A	G	9	1	10	0	9	19	0	0
10	26540432	.	A	G	9	5	14	0	1	15	0	0
10	26541145	.	G	A	17	12	29	0	0	29	0	0
10	26543567	.	A	G	11	12	23	0	0	23	0	0
10	26544599	.	G	A	9	11	20	0	0	20	0	0
10	26544626	.	C	A	9	8	17	0	0	17	0	0
10	26547356	.	C	T	15	16	31	0	1	32	0	0
10	26551191	.	T	A	19	17	36	0	2	38	0	0
10	26551197	.	T	C	17	21	38	0	0	38	0	0
10	26551242	.	A	G	18	19	37	0	0	37	0	0
10	26551492	.	A	G	20	27	47	0	7	54	0	0
10	26553007	.	T	A	20	9	29	0	14	43	0	0
10	26558704	.	C	T	24	19	43	1	2	46	0	0
10	26560260	.	C	T	26	26	52	0	2	54	0	0
10	26560366	.	G	A	5	11	16	2	28	46	0	0
10	26560392	.	C	A	21	19	40	1	5	46	0	0
10	26567127	.	G	A	3	14	17	0	10	27	0	0
10	26578528	.	T	C	9	11	20	0	1	21	0	0
10	26589072	.	C	T	15	16	31	0	0	31	0	0
10	26656240	.	C	T	13	14	27	0	0	27	0	0
10	26656500	.	G	A	12	7	19	0	1	20	0	0
10	26656527	.	A	G	15	12	27	0	1	28	0	0
10	26659245	.	C	T	14	20	34	0	1	35	0	0
10	26661469	.	T	C	11	14	25	0	0	25	0	0
10	26662046	.	G	A	10	18	28	0	0	28	0	0
10	26666823	.	C	T	18	12	30	0	2	32	0	0
10	26717156	.	T	A	17	17	34	0	1	35	0	0
10	26717237	.	C	T	13	13	26	0	6	32	0	0
10	26717582	.	T	A	14	11	25	0	0	25	0	0
10	26717687	.	G	A	11	14	25	0	4	29	0	0
10	26717783	.	A	G	15	15	30	0	0	30	0	0
10	26717954	.	G	T	13	18	31	0	0	31	0	0
10	26717963	.	G	A	19	14	33	0	1	34	0	0
10	26723422	.	C	T	0	17	17	0	14	31	0	0
10	26762944	.	T	C	7	18	25	0	2	27	0	0
10	26765526	.	T	C	18	5	23	0	1	24	0	0
10	26766154	.	C	T	13	3	16	0	0	16	0	0
10	26766727	.	C	T	3	2	5	0	0	5	0	0
10	26777774	.	T	C	5	4	9	0	0	9	0	0
10	26790577	.	A	G	3	3	6	0	0	6	0	0
10	26790603	.	G	A	7	2	9	0	0	9	0	0
10	26791027	.	G	A	4	5	9	0	0	9	0	0
10	26831923	.	G	A	10	2	12	0	0	12	0	0
10	26831965	.	G	T	11	5	16	0	2	18	0	0
10	26831989	.	A	C	4	12	16	0	0	16	0	0
10	26835316	.	G	C	6	10	16	0	1	17	0	0
10	26835389	.	A	T	10	7	17	0	0	18	1	0
10	26835595	.	G	A	12	12	24	0	2	26	0	0
10	26924028	.	A	G	2	2	4	0	0	4	0	0
10	26924042	.	A	G	2	1	3	0	0	3	0	0
10	26924086	.	A	T	2	3	5	0	0	5	0	0
10	26924133	.	G	C	3	2	5	0	2	7	0	0
10	26926741	.	A	G	18	15	33	0	0	33	0	0
10	26929459	.	C	T	19	19	38	0	0	38	0	0
10	26932632	.	C	T	11	13	24	0	0	24	0	0
10	26944522	.	T	G	5	5	10	0	0	10	0	0
10	26945274	.	A	C	3	2	5	0	0	5	0	0
10	26950584	.	G	A	0	5	5	0	4	9	0	0
10	26950644	.	T	C	3	2	5	0	2	7	0	0
10	26950662	.	A	G	3	3	6	0	1	7	0	0
10	26950683	.	G	T	4	4	8	0	0	8	0	0
10	26950702	.	T	C	2	5	7	0	1	8	0	0
10	26958321	.	T	G	4	0	4	0	5	9	0	0
10	26958779	.	A	G	1	7	8	0	0	8	0	0
10	26958972	.	C	A	2	4	6	0	0	6	0	0
10	26959662	.	T	G	5	5	10	0	1	11	0	0
10	26959744	.	G	A	4	4	8	0	1	9	0	0
10	26959827	.	C	T	3	3	6	0	0	6	0	0
10	26960058	.	G	A	7	5	12	0	0	12	0	0
10	26960065	.	G	A	0	5	5	0	8	13	0	0
10	26960212	.	A	T	2	7	9	0	0	9	0	0
10	26960399	.	T	A	1	1	2	0	1	3	0	0
10	26961970	.	T	C	1	5	6	0	0	6	0	0
10	26966130	.	T	C	6	2	8	0	0	8	0	0
10	26966163	.	T	A	3	5	8	0	0	8	0	0
10	26969077	.	G	T	1	5	6	0	7	13	0	0
10	26971300	.	T	A	9	10	19	0	0	19	0	0
10	26971782	.	C	T	8	5	13	0	0	13	0	0
10	26971982	.	C	T	13	7	20	0	0	20	0	0
10	26972009	.	T	C	13	8	21	0	0	21	0	0
10	26972018	.	C	T	12	8	20	0	1	21	0	0
10	26972409	.	G	A	5	6	11	0	0	11	0	0
10	26972429	.	A	T	3	3	6	0	0	6	0	0
10	26973334	.	C	T	8	7	15	0	1	16	0	0
10	26973340	.	C	T	8	6	14	0	1	15	0	0
10	26973406	.	C	T	3	5	8	0	0	8	0	0
10	26974414	.	T	C	1	2	3	0	0	3	0	0
10	26976990	.	G	A	5	6	11	0	2	13	0	0
10	26977154	.	G	A	9	4	13	0	0	13	0	0
10	26978031	.	C	T	11	11	22	0	0	22	0	0
10	26982338	.	T	C	2	3	5	0	0	5	0	0
10	26982572	.	C	G	6	2	8	0	0	8	0	0
10	26982786	.	C	T	0	4	4	0	4	8	0	0
10	26982953	.	A	G	4	4	8	0	0	8	0	0
10	26983012	.	A	T	5	5	10	0	0	10	0	0
10	26987399	.	T	C	16	1	17	0	13	30	0	0
10	26990140	.	C	G	5	5	10	0	1	11	0	0
10	26990173	.	C	T	10	8	18	0	1	19	0	0
10	26990287	.	C	T	12	6	18	0	1	19	0	0
10	26990333	.	G	C	14	8	22	0	0	22	0	0
10	26991514	.	C	T	21	12	33	0	2	35	0	0
10	26991811	.	G	A	3	4	7	0	0	7	0	0
10	26991835	.	G	T	5	6	11	0	1	12	0	0
10	26991917	.	A	G	4	4	8	0	0	8	0	0
10	26997218	.	G	A	19	8	27	0	0	27	0	0
10	26997222	.	A	T	18	8	26	0	1	27	0	0
10	26999102	.	C	T	1	9	10	0	7	17	0	0
10	26999359	.	T	C	15	25	40	0	4	44	0	0
10	26999360	.	T	A	17	24	41	0	3	44	0	0
10	27006447	.	T	C	13	16	29	0	0	29	0	0
10	27006490	.	A	G	16	11	27	0	1	28	0	0
10	27028146	.	A	G	25	15	40	0	0	40	0	0
10	27028334	.	G	T	13	17	30	0	2	32	0	0
10	27028346	.	A	G	17	18	35	0	0	35	0	0
10	27046400	.	T	A	21	15	36	0	2	38	0	0
10	27052736	.	T	C	1	3	4	0	0	4	0	0
10	27053149	.	C	G	4	3	7	0	2	9	0	0
10	27058341	.	C	A	4	12	16	0	1	17	0	0
10	27058740	.	C	A	4	2	6	0	0	6	0	0
10	27058756	.	A	T	4	3	7	0	0	7	0	0
10	27091840	.	C	T	2	2	4	0	0	4	0	0
10	27091930	.	C	T	2	3	5	0	0	5	0	0
10	27092149	.	G	A	3	2	5	0	0	5	0	0
10	27092509	.	G	T	1	7	8	0	0	8	0	0
10	27096202	.	G	T	1	3	4	0	0	4	0	0
10	27183328	.	T	G	15	9	24	0	3	27	0	0
10	27183580	.	T	C	12	2	14	0	15	29	0	0
10	27183685	.	A	T	8	17	25	0	1	26	0	0
10	27184069	.	G	A	26	17	43	0	7	50	0	0
10	27184237	.	A	G	24	18	42	0	2	44	0	0
10	27184351	.	C	T	16	8	24	0	10	34	0	0
10	27184384	.	C	T	24	13	37	0	0	37	0	0
10	27184678	.	C	T	1	12	13	2	13	28	0	0
10	27184864	.	T	C	14	0	14	0	19	33	0	0
10	27184905	.	C	T	2	17	19	0	13	32	0	0
10	27185104	.	G	A	17	17	34	0	3	37	0	0
10	27185134	.	A	G	14	15	29	0	1	30	0	0
10	27190002	.	C	T	12	8	20	1	4	25	0	0
10	27190783	.	G	A	8	7	15	0	2	17	0	0
10	27196699	.	G	T	15	12	27	0	4	31	0	0
10	27196704	.	C	T	1	11	12	0	20	32	0	0
10	27738752	.	G	A	2	2	4	0	1	5	0	0
10	27738769	.	A	T	1	4	5	0	0	5	0	0
10	27977673	.	C	T	4	3	7	0	1	8	0	0
10	27978002	.	A	T	1	6	7	0	1	8	0	0
10	27978055	.	T	C	2	3	5	0	0	5	0	0
10	27978084	.	T	A	3	2	5	0	0	5	0	0
10	27994527	.	C	G	1	2	3	0	0	3	0	0
10	28014380	.	T	C	0	0	0	0	4	4	0	0
10	28025392	.	A	G	3	3	6	0	0	6	0	0
10	28030729	.	T	C	9	0	9	0	10	19	0	0
10	28030753	.	A	G	11	11	22	0	1	23	0	0
10	28030843	.	C	T	9	9	18	0	0	18	0	0
10	28036119	.	G	A	8	13	21	0	2	23	0	0
10	28036370	.	G	A	12	10	22	0	0	22	0	0
10	28038008	.	A	G	16	5	21	0	0	21	0	0
10	28038926	.	G	A	10	5	15	0	0	15	0	0
10	28041152	.	T	A	6	5	11	0	5	16	0	0
10	28043421	.	T	C	6	5	11	0	0	11	0	0
10	28043454	.	T	G	7	9	16	0	0	16	0	0
10	28043769	.	C	T	1	6	7	0	12	19	0	0
10	28057286	.	A	G	4	3	7	0	0	7	0	0
10	28057325	.	C	T	0	4	4	0	6	10	0	0
10	28063928	.	G	A	6	6	12	0	0	12	0	0
10	28063976	.	G	A	7	7	14	0	0	14	0	0
10	28066605	.	T	G	7	4	11	0	0	11	0	0
10	28089637	.	A	G	5	5	10	0	0	10	0	0
10	28117228	.	C	T	5	2	7	0	0	7	0	0
10	28162146	.	G	A	0	4	4	0	2	6	0	0
10	28163002	.	T	A	3	3	6	0	0	6	0	0
10	28165150	.	T	A	1	3	4	1	0	5	0	0
10	28166640	.	G	A	0	4	4	0	5	9	0	0
10	28168295	.	C	G	7	5	12	0	1	13	0	0
10	28168779	.	A	G	1	0	1	0	2	3	0	0
10	28168968	.	G	A	5	3	8	0	1	9	0	0
10	28172354	.	C	T	0	5	5	0	3	8	0	0
10	28172501	.	T	G	2	4	6	0	0	6	0	0
10	28172672	.	A	C	4	4	8	0	1	9	0	0
10	28183429	.	A	C	1	3	4	0	0	4	0	0
10	28193354	.	C	T	1	2	3	0	0	3	0	0
10	28308418	.	G	T	1	5	6	0	3	9	0	0
10	28308419	.	T	G	4	5	9	0	0	9	0	0
10	28308710	.	A	T	3	2	5	0	0	5	0	0
10	28308799	.	C	T	2	2	4	0	0	4	0	0
10	28309136	.	C	A	2	4	6	0	0	6	0	0
10	28311301	.	C	T	18	19	37	0	0	37	0	0
10	28311553	.	G	T	26	22	48	3	0	51	0	0
10	28312156	.	T	A	21	25	46	0	3	49	0	0
10	28315096	.	A	G	25	18	43	0	2	45	0	0
10	28315149	.	G	A	23	25	48	0	1	49	0	0
10	28319441	.	A	G	21	15	36	0	1	37	0	0
10	28319489	.	A	G	16	24	40	0	0	40	0	0
10	28319552	.	G	A	14	17	31	0	0	31	0	0
10	28320381	.	A	G	23	20	43	0	1	44	0	0
10	28320654	.	G	C	14	0	14	0	11	25	0	0
10	28320675	.	G	A	15	15	30	0	1	31	0	0
10	28321051	.	G	A	21	18	39	0	1	40	0	0
10	28323048	.	T	G	15	18	33	0	1	34	0	0
10	28323054	.	A	G	16	19	35	0	2	37	0	0
10	28323325	.	A	T	10	11	21	0	1	22	0	0
10	28328219	.	A	G	16	15	31	0	3	34	0	0
10	28328231	.	A	G	18	17	35	0	1	36	0	0
10	28350055	.	G	A	13	9	22	0	0	22	0	0
10	28351457	.	A	G	13	11	24	0	0	24	0	0
10	28351484	.	C	T	2	15	17	0	10	27	0	0
10	28351520	.	G	T	7	14	21	0	1	22	0	0
10	28370974	.	T	G	3	3	6	0	2	8	0	0
10	28371045	.	A	G	6	9	15	0	0	15	0	0
10	28371284	.	G	A	17	12	29	0	0	29	0	0
10	28371407	.	C	T	1	23	24	0	18	42	0	0
10	28376814	.	T	C	20	0	20	0	17	37	0	0
10	28376895	.	C	T	14	15	29	0	2	31	0	0
10	28730128	.	C	T	4	2	6	0	1	7	0	0
10	29705444	.	G	T	9	3	12	0	0	12	0	0
10	31633314	.	T	C	1	1	2	0	0	2	0	0
10	32265193	.	T	A	5	2	7	0	0	7	0	0
10	32265259	.	C	T	3	4	7	0	1	8	0	0
10	32265331	.	A	C	4	4	8	0	0	8	0	0
10	32413438	.	T	C	2	4	6	0	3	9	0	0
10	32561338	.	G	A	6	5	11	0	0	11	0	0
10	32561392	.	A	T	16	7	23	0	1	24	0	0
10	32561398	.	G	A	1	7	8	0	18	26	0	0
10	32561427	.	A	C	22	7	29	0	1	30	0	0
10	32561437	.	T	A	24	8	32	0	0	33	1	0
10	32561615	.	C	G	13	8	21	1	0	22	0	0
10	32562267	.	C	T	16	11	27	0	0	27	0	0
10	32577621	.	G	A	16	12	28	0	1	29	0	0
10	32581221	.	G	A	9	17	26	0	1	27	0	0
10	32600927	.	C	T	30	16	46	0	2	48	0	0
10	32601319	.	G	T	3	2	5	0	0	5	0	0
10	32648649	.	C	T	3	5	8	0	0	8	0	0
10	32648799	.	C	T	6	4	10	0	0	10	0	0
10	32657586	.	A	G	5	2	7	0	1	8	0	0
10	32657591	.	C	A	5	5	10	0	0	10	0	0
10	32657893	.	G	A	13	19	32	0	1	33	0	0
10	32657980	.	A	G	17	11	28	0	0	28	0	0
10	32660658	.	A	C	2	6	8	0	0	8	0	0
10	32670068	.	G	A	1	2	3	0	0	3	0	0
10	32780271	.	A	C	10	15	25	0	0	25	0	0
10	32783974	.	A	C	10	8	18	0	0	18	0	0
10	32787910	.	C	T	11	8	19	0	2	21	0	0
10	32788457	.	A	T	3	14	17	0	1	18	0	0
10	32788504	.	A	T	5	10	15	0	1	16	0	0
10	32788633	.	T	C	13	16	29	0	0	29	0	0
10	32788663	.	T	C	17	19	36	0	4	40	0	0
10	32809986	.	G	C	10	18	28	0	0	28	0	0
10	32810279	.	T	A	10	11	21	0	1	22	0	0
10	32810340	.	A	T	9	10	19	0	1	21	1	0
10	32810579	.	T	C	8	0	8	0	5	13	0	0
10	32810593	.	A	T	3	6	9	0	2	11	0	0
10	32811010	.	C	T	1	5	6	0	9	15	0	0
10	32811102	.	T	A	12	4	16	0	2	18	0	0
10	32817924	.	C	A	1	9	10	0	7	17	0	0
10	32820412	.	A	G	8	8	16	0	0	16	0	0
10	32820426	.	T	A	10	9	19	0	0	19	0	0
10	32820451	.	G	T	9	8	17	0	2	19	0	0
10	32820577	.	T	C	7	0	7	0	9	16	0	0
10	32823131	.	C	T	13	8	21	0	2	23	0	0
10	32823146	.	G	A	10	17	27	0	0	27	0	0
10	32831269	.	G	A	5	14	19	0	0	19	0	0
10	32831671	.	T	C	9	1	10	0	7	17	0	0
10	32831683	.	C	G	6	10	16	0	1	17	0	0
10	32840835	.	C	T	1	6	7	0	14	21	0	0
10	32843827	.	C	G	8	11	19	0	0	19	0	0
10	32856993	.	C	A	5	2	7	0	0	7	0	0
10	32856999	.	T	A	6	6	12	0	0	12	0	0
10	32857034	.	C	G	11	8	19	0	0	19	0	0
10	32857329	.	T	C	16	0	16	1	6	23	0	0
10	32857382	.	T	C	22	1	23	1	11	35	0	0
10	32857419	.	T	C	21	0	21	1	23	45	0	0
10	32857557	.	T	C	15	11	26	0	1	27	0	0
10	32857738	.	A	G	10	7	17	0	1	18	0	0
10	32857746	.	A	T	10	10	20	0	0	20	0	0
10	32857898	.	C	T	5	11	16	0	0	16	0	0
10	32857948	.	T	G	4	11	15	0	1	16	0	0
10	32858107	.	A	G	13	11	24	2	0	26	0	0
10	32858158	.	C	G	9	15	24	2	2	28	0	0
10	32858215	.	T	A	17	15	32	1	0	34	1	0
10	32858361	.	T	C	15	15	30	0	2	32	0	0
10	32858425	.	G	C	12	17	29	0	1	30	0	0
10	32858607	.	C	T	17	9	26	0	0	26	0	0
10	32858612	.	T	A	11	16	27	0	1	28	0	0
10	32858642	.	G	C	11	14	25	0	0	25	0	0
10	32861106	.	G	A	19	6	25	0	1	26	0	0
10	32861118	.	T	G	18	5	23	0	4	27	0	0
10	32874849	.	G	A	23	13	36	0	2	38	0	0
10	32881787	.	C	T	3	10	13	0	10	23	0	0
10	32881823	.	G	A	14	11	25	0	1	26	0	0
10	32881884	.	C	T	12	9	21	0	2	23	0	0
10	32881904	.	A	G	18	9	27	0	1	28	0	0
10	32882022	.	A	G	6	4	10	0	0	10	0	0
10	32882056	.	G	A	4	7	11	0	1	12	0	0
10	32882080	.	A	T	6	13	19	0	1	20	0	0
10	32882156	.	T	G	15	14	29	0	1	31	1	0
10	32882495	.	T	C	9	5	14	0	1	15	0	0
10	32882515	.	C	T	7	6	13	0	0	13	0	0
10	32882683	.	G	T	9	14	23	0	1	24	0	0
10	32882686	.	A	T	9	13	22	0	1	23	0	0
10	32882732	.	C	A	12	10	22	0	0	22	0	0
10	32882977	.	C	A	1	19	20	0	8	28	0	0
10	32890201	.	C	T	2	11	13	0	13	26	0	0
10	32899276	.	T	A	12	3	15	0	0	15	0	0
10	32899807	.	T	C	10	3	13	1	2	16	0	0
10	32899986	.	T	G	11	9	20	0	1	21	0	0
10	32899988	.	T	C	11	0	11	0	10	21	0	0
10	32900021	.	T	C	10	8	18	0	1	19	0	0
10	32900469	.	T	G	13	3	16	0	2	18	0	0
10	32900642	.	A	T	6	7	13	0	0	13	0	0
10	32901915	.	A	T	4	7	11	0	0	11	0	0
10	32902159	.	T	C	3	1	4	0	6	10	0	0
10	32902481	.	G	C	5	5	10	0	0	10	0	0
10	32903589	.	C	T	0	3	3	0	8	11	0	0
10	32907193	.	G	T	4	4	8	1	2	11	0	0
10	32912847	.	T	G	3	8	11	0	0	11	0	0
10	32912883	.	C	G	5	4	9	0	0	9	0	0
10	32920415	.	A	G	4	5	9	0	0	9	0	0
10	32920529	.	C	A	0	7	7	0	3	10	0	0
10	32920574	.	G	T	4	7	11	0	0	11	0	0
10	32920649	.	A	G	1	7	8	0	2	10	0	0
10	32939399	.	C	T	0	4	4	0	4	8	0	0
10	32939426	.	G	A	3	8	11	0	0	11	0	0
10	32939610	.	T	C	4	5	9	0	0	9	0	0
10	32944113	.	A	T	4	2	6	0	0	6	0	0
10	32950508	.	C	T	1	6	7	0	4	11	0	0
10	32955561	.	C	T	4	3	7	0	0	7	0	0
10	32963501	.	C	T	0	8	8	0	3	11	0	0
10	32963546	.	A	G	6	2	8	0	0	8	0	0
10	32963555	.	T	C	6	2	8	0	0	8	0	0
10	32963722	.	C	A	6	5	11	0	1	12	0	0
10	32963924	.	G	A	6	6	12	0	0	12	0	0
10	32963960	.	C	G	4	5	9	0	2	11	0	0
10	32964089	.	C	T	0	3	3	0	6	9	0	0
10	33009985	.	T	A	6	2	8	0	0	8	0	0
10	33254930	.	G	A	4	3	7	0	0	7	0	0
10	33260487	.	G	T	4	4	8	0	0	8	0	0
10	33260681	.	G	T	1	5	6	0	0	6	0	0
10	33269688	.	G	T	5	3	8	0	1	9	0	0
10	33274884	.	C	T	2	2	4	0	0	4	0	0
10	33274974	.	C	T	0	2	2	0	3	5	0	0
10	33274998	.	G	A	3	3	6	0	0	6	0	0
10	33286859	.	T	G	1	2	3	0	0	3	0	0
10	33314237	.	T	A	2	5	7	0	0	7	0	0
10	33370260	.	G	T	6	9	15	0	1	16	0	0
10	33370284	.	A	G	10	6	16	0	0	16	0	0
10	33373568	.	C	G	2	19	21	0	10	31	0	0
10	33375478	.	C	T	19	6	25	0	3	28	0	0
10	33379580	.	G	A	4	10	14	0	1	15	0	0
10	33385363	.	G	A	33	18	51	0	2	53	0	0
10	33386316	.	G	A	30	29	59	0	0	59	0	0
10	33392111	.	T	C	22	6	28	0	1	29	0	0
10	33392199	.	A	G	9	16	25	0	1	26	0	0
10	33392263	.	A	G	6	23	29	2	1	32	0	0
10	33392396	.	T	G	14	7	21	0	1	22	0	0
10	33574191	.	C	T	6	8	14	0	0	14	0	0
10	33576423	.	T	C	1	8	9	0	0	9	0	0
10	33576509	.	T	C	5	7	12	0	0	12	0	0
10	33576518	.	T	C	7	7	14	0	0	14	0	0
10	33576551	.	T	C	9	5	14	0	0	14	0	0
10	33577656	.	A	G	7	8	15	0	0	15	0	0
10	33578981	.	T	G	5	2	7	0	0	7	0	0
10	33580632	.	C	T	2	2	4	0	0	4	0	0
10	33614968	.	G	A	8	4	12	0	1	13	0	0
10	33616256	.	C	G	2	6	8	0	0	8	0	0
10	33646917	.	G	T	1	4	5	0	1	6	0	0
10	33659447	.	T	C	3	2	5	0	0	5	0	0
10	33698487	.	G	C	1	4	5	0	0	5	0	0
10	33850580	.	T	G	2	5	7	0	1	8	0	0
10	33866987	.	T	A	6	6	12	0	0	12	0	0
10	33867032	.	G	A	4	2	6	0	0	6	0	0
10	33867160	.	G	A	0	3	3	0	4	7	0	0
10	33867394	.	G	A	4	3	7	0	0	7	0	0
10	33908183	.	C	A	6	5	11	0	0	11	0	0
10	33908264	.	A	G	3	4	7	0	0	7	0	0
10	33908291	.	C	T	5	6	11	0	0	11	0	0
10	33909979	.	G	A	8	6	14	0	1	15	0	0
10	33912179	.	C	T	9	4	13	0	0	13	0	0
10	33917015	.	G	A	2	4	6	0	0	6	0	0
10	33917187	.	C	A	2	2	4	0	0	4	0	0
10	33917190	.	C	T	2	2	4	0	0	4	0	0
10	33919504	.	G	A	0	4	4	0	9	13	0	0
10	33924255	.	G	A	2	4	6	0	7	13	0	0
10	33928201	.	G	A	3	3	6	0	8	14	0	0
10	33930351	.	T	C	8	8	16	1	0	17	0	0
10	33930780	.	T	G	8	5	13	0	1	14	0	0
10	33932844	.	G	A	6	6	12	0	0	12	0	0
10	33932859	.	C	T	4	6	10	0	0	10	0	0
10	33943456	.	T	C	8	7	15	1	2	18	0	0
10	33943820	.	C	T	9	12	21	0	1	22	0	0
10	33943856	.	A	T	8	10	18	0	1	19	0	0
10	33948176	.	C	T	4	5	9	0	0	9	0	0
10	33952766	.	C	T	9	9	18	0	0	18	0	0
10	33956690	.	G	A	0	8	8	0	10	18	0	0
10	33956714	.	T	C	10	5	15	0	0	15	0	0
10	33958750	.	T	C	12	12	24	0	0	24	0	0
10	33958813	.	T	C	11	14	25	0	0	25	0	0
10	33958993	.	C	T	10	17	27	0	0	27	0	0
10	33960793	.	C	T	16	9	25	0	0	25	0	0
10	33960814	.	A	G	16	1	17	0	4	21	0	0
10	33960829	.	C	A	14	5	19	0	1	20	0	0
10	33961048	.	G	A	1	17	18	0	4	22	0	0
10	33961132	.	T	A	5	6	11	0	0	11	0	0
10	33982141	.	G	C	24	10	34	4	1	39	0	0
10	33982165	.	G	A	14	22	36	0	1	37	0	0
10	33983870	.	A	G	21	24	45	0	1	46	0	0
10	33989820	.	G	A	14	19	33	0	1	34	0	0
10	33990957	.	C	T	25	11	36	0	1	37	0	0
10	33994475	.	C	T	12	17	29	0	0	29	0	0
10	33997759	.	A	T	26	18	44	0	2	46	0	0
10	33997970	.	T	C	13	5	18	0	1	19	0	0
10	33998010	.	C	T	16	9	25	0	0	25	0	0
10	33998106	.	G	C	2	4	6	0	0	6	0	0
10	34021619	.	G	T	1	2	3	0	0	3	0	0
10	34025104	.	C	T	3	3	6	0	1	7	0	0
10	34031696	.	T	A	4	4	8	0	0	8	0	0
10	34033394	.	C	T	6	4	10	0	0	10	0	0
10	34361639	.	G	A	0	3	3	0	2	5	0	0
10	34378005	.	G	A	6	7	13	0	1	14	0	0
10	34378053	.	G	A	2	4	6	0	0	6	0	0
10	34378110	.	T	G	2	0	2	0	4	6	0	0
10	34378113	.	C	T	1	4	5	0	1	6	0	0
10	34378302	.	A	C	7	5	12	0	2	14	0	0
10	34380603	.	C	A	2	8	10	0	0	10	0	0
10	34383783	.	A	T	2	6	8	0	0	8	0	0
10	34388882	.	T	G	6	5	11	0	1	12	0	0
10	34389617	.	C	T	4	7	11	0	2	13	0	0
10	34394653	.	G	A	1	6	7	0	0	7	0	0
10	34399775	.	G	T	0	6	6	0	9	15	0	0
10	34402546	.	C	T	8	3	11	0	1	12	0	0
10	34402852	.	A	G	6	9	15	0	0	15	0	0
10	34402853	.	A	G	5	10	15	0	0	15	0	0
10	34403094	.	T	A	6	2	8	0	0	8	0	0
10	34403114	.	T	A	6	2	8	0	1	9	0	0
10	34403157	.	G	A	7	6	13	0	1	14	0	0
10	34403349	.	C	G	7	8	15	0	0	15	0	0
10	34403495	.	C	T	11	6	17	0	0	17	0	0
10	34403615	.	A	G	4	9	13	0	0	13	0	0
10	34403668	.	A	T	13	6	19	0	0	19	0	0
10	34403965	.	A	T	12	9	21	0	1	22	0	0
10	34404149	.	G	A	1	0	1	0	4	5	0	0
10	34404158	.	T	A	4	3	7	0	0	7	0	0
10	34404552	.	T	G	6	6	12	0	2	14	0	0
10	34565246	.	C	T	1	4	5	0	0	5	0	0
10	34565381	.	G	A	0	7	7	0	5	12	0	0
10	34565402	.	G	A	4	7	11	0	1	12	0	0
10	34580529	.	C	T	8	7	15	0	0	15	0	0
10	34588818	.	G	T	0	7	7	0	8	15	0	0
10	34588872	.	C	T	8	9	17	0	0	17	0	0
10	34588881	.	C	T	9	7	16	0	0	16	0	0
10	34606549	.	T	C	4	13	17	0	0	17	0	0
10	34657676	.	C	T	8	7	15	0	0	15	0	0
10	34661857	.	A	G	6	5	11	0	2	13	0	0
10	34662184	.	C	T	8	4	12	0	1	13	0	0
10	34662223	.	C	A	14	5	19	0	0	19	0	0
10	34662724	.	C	A	9	12	21	0	0	21	0	0
10	34665053	.	G	A	2	5	7	0	6	13	0	0
10	34676094	.	A	G	5	0	5	0	5	10	0	0
10	34676266	.	G	T	9	12	21	0	0	21	0	0
10	34676338	.	C	T	6	7	13	0	0	13	0	0
10	34677614	.	C	A	4	8	12	0	1	13	0	0
10	34691122	.	C	T	8	8	16	0	1	17	0	0
10	34701365	.	T	C	7	9	16	0	0	16	0	0
10	34707043	.	C	T	4	12	16	0	2	18	0	0
10	34707546	.	A	T	16	5	21	0	1	22	0	0
10	34707549	.	G	T	5	17	22	0	0	22	0	0
10	34709708	.	G	C	13	10	23	0	0	23	0	0
10	34714789	.	C	T	17	10	27	0	2	29	0	0
10	34731660	.	C	T	21	22	43	0	0	43	0	0
10	34734714	.	A	T	17	32	49	0	2	51	0	0
10	34734743	.	T	G	14	19	33	0	4	37	0	0
10	34734784	.	G	T	3	11	14	0	21	35	0	0
10	34737599	.	G	A	24	21	45	0	3	48	0	0
10	34737919	.	T	C	22	19	41	0	1	42	0	0
10	34737959	.	G	A	12	21	33	0	5	38	0	0
10	34738213	.	C	T	3	20	23	0	35	58	0	0
10	34738378	.	T	G	26	33	59	1	1	61	0	0
10	34743910	.	G	A	16	20	36	0	1	37	0	0
10	34768109	.	A	T	2	3	5	0	0	5	0	0
10	34768261	.	T	C	3	3	6	0	0	6	0	0
10	34870579	.	C	T	10	8	18	0	0	18	0	0
10	34871672	.	G	T	13	10	23	0	2	25	0	0
10	34878326	.	A	G	1	4	5	0	0	5	0	0
10	34913407	.	G	A	1	4	5	0	0	5	0	0
10	34958584	.	C	G	2	2	4	0	0	4	0	0
10	34961309	.	A	G	13	10	23	0	0	23	0	0
10	34961311	.	T	C	14	10	24	0	0	24	0	0
10	34961403	.	T	C	12	4	16	0	1	17	0	0
10	34961405	.	C	T	10	4	14	0	1	15	0	0
10	34961480	.	C	A	6	4	10	0	0	10	0	0
10	34961520	.	T	C	11	7	18	0	1	19	0	0
10	34961669	.	A	G	9	9	18	0	0	18	0	0
10	34962116	.	G	A	1	4	5	0	0	5	0	0
10	34962155	.	G	A	2	4	6	0	0	6	0	0
10	34969984	.	A	G	1	4	5	0	0	5	0	0
10	34976855	.	C	T	0	2	2	0	3	5	0	0
10	34976884	.	G	C	2	4	6	0	0	6	0	0
10	34989149	.	T	C	11	0	11	0	14	25	0	0
10	34992565	.	A	G	19	14	33	0	0	33	0	0
10	34998281	.	G	C	10	5	15	0	1	16	0	0
10	35006385	.	C	T	12	6	18	0	0	18	0	0
10	35008963	.	C	T	11	8	19	0	0	19	0	0
10	35011337	.	A	G	5	8	13	0	0	13	0	0
10	35029172	.	G	A	4	6	10	0	0	10	0	0
10	35032792	.	A	G	5	2	7	0	1	8	0	0
10	35046093	.	C	T	5	2	7	0	0	7	0	0
10	35051681	.	C	G	1	2	3	0	0	3	0	0
10	35059880	.	G	C	2	3	5	0	0	5	0	0
10	35063944	.	C	T	3	6	9	0	1	10	0	0
10	35064268	.	T	G	4	4	8	0	0	8	0	0
10	35108561	.	A	G	4	2	6	0	0	6	0	0
10	35108590	.	G	T	5	4	9	0	0	9	0	0
10	35156268	.	C	T	2	4	6	0	0	6	0	0
10	35156473	.	C	T	6	4	10	0	0	10	0	0
10	35156485	.	A	C	5	5	10	0	0	10	0	0
10	35160454	.	T	G	4	0	4	0	5	9	0	0
10	35163358	.	T	A	6	4	10	0	2	12	0	0
10	35163406	.	G	A	5	8	13	0	1	14	0	0
10	35169884	.	T	C	3	4	7	0	0	7	0	0
10	35170265	.	A	G	2	2	4	1	1	6	0	0
10	35177270	.	A	T	6	8	14	0	0	14	0	0
10	35177324	.	A	G	2	11	13	0	0	13	0	0
10	35177357	.	G	A	6	11	17	0	0	17	0	0
10	35177375	.	G	C	8	0	8	0	8	16	0	0
10	35177537	.	G	A	6	8	14	0	2	16	0	0
10	35178518	.	A	T	13	7	20	0	1	21	0	0
10	35180627	.	C	T	1	4	5	0	10	15	0	0
10	35185979	.	G	C	7	3	10	0	0	10	0	0
10	35300764	.	C	T	9	13	22	0	0	22	0	0
10	35302425	.	T	C	12	12	24	0	0	24	0	0
10	35304014	.	C	T	8	4	12	0	3	15	0	0
10	35311926	.	C	G	9	19	28	0	3	31	0	0
10	35312021	.	A	C	13	21	34	0	2	36	0	0
10	35312143	.	A	G	8	0	8	0	5	13	0	0
10	35312190	.	A	G	11	7	18	0	1	19	0	0
10	35312253	.	C	T	7	7	14	0	1	15	0	0
10	35314868	.	G	T	3	4	7	0	0	7	0	0
10	35314958	.	G	A	3	2	5	0	0	5	0	0
10	35314974	.	T	A	3	2	5	0	0	5	0	0
10	35315060	.	A	C	2	0	2	0	2	4	0	0
10	35436687	.	G	A	1	4	5	0	0	5	0	0
10	35538349	.	A	C	18	9	27	0	1	28	0	0
10	35538350	.	C	A	17	10	27	0	1	28	0	0
10	35538879	.	T	A	17	15	32	0	3	35	0	0
10	35539607	.	A	G	19	15	34	0	0	34	0	0
10	35539631	.	G	A	19	14	33	0	2	35	0	0
10	35540422	.	T	A	14	21	35	0	1	36	0	0
10	35540603	.	C	T	28	14	42	0	3	45	0	0
10	35540675	.	T	G	12	17	29	0	5	34	0	0
10	35540705	.	T	A	20	17	37	0	2	39	0	0
10	35540732	.	T	G	23	15	38	0	3	41	0	0
10	35540847	.	T	G	7	11	18	0	1	19	0	0
10	35541245	.	T	C	10	7	17	0	0	17	0	0
10	35541290	.	A	G	15	9	24	0	0	24	0	0
10	35541735	.	C	T	4	4	8	0	0	8	0	0
10	35541760	.	C	T	5	1	6	0	1	7	0	0
10	35554345	.	G	T	0	6	6	0	3	9	0	0
10	35560733	.	A	G	3	3	6	0	0	6	0	0
10	35573836	.	C	T	3	3	6	0	0	6	0	0
10	35579500	.	C	A	5	2	7	0	0	7	0	0
10	35579598	.	T	C	1	2	3	0	0	3	0	0
10	35579985	.	C	T	5	5	10	0	0	10	0	0
10	35580002	.	A	C	4	4	8	0	2	10	0	0
10	35584806	.	T	G	12	9	21	0	3	24	0	0
10	35584855	.	T	A	7	7	14	1	0	15	0	0
10	35585057	.	A	T	5	8	13	0	0	13	0	0
10	35585195	.	G	A	4	8	12	0	3	15	0	0
10	35585197	.	A	G	7	6	13	0	2	15	0	0
10	35585257	.	C	T	7	8	15	0	3	18	0	0
10	35585284	.	C	T	3	9	12	0	8	20	0	0
10	35590076	.	T	A	4	10	14	0	0	14	0	0
10	35595335	.	C	T	6	9	15	0	1	16	0	0
10	35595653	.	C	T	8	11	19	0	0	19	0	0
10	35600397	.	T	C	4	8	12	0	0	12	0	0
10	35600529	.	G	T	2	2	4	0	0	4	0	0
10	35602678	.	G	A	4	4	8	0	0	8	0	0
10	35603179	.	G	T	3	2	5	0	0	5	0	0
10	35603233	.	A	G	3	6	9	0	0	9	0	0
10	35609501	.	T	C	2	0	2	0	4	6	0	0
10	35609808	.	G	A	4	3	7	0	0	7	0	0
10	35610820	.	G	C	3	4	7	0	0	7	0	0
10	35610852	.	C	A	0	2	2	0	2	4	0	0
10	35610899	.	T	C	1	4	5	0	0	5	0	0
10	35611800	.	C	A	3	2	5	0	0	5	0	0
10	35654268	.	C	T	4	9	13	0	0	13	0	0
10	35654290	.	A	C	4	4	8	0	3	11	0	0
10	35654305	.	T	C	7	6	13	0	1	14	0	0
10	35664217	.	T	A	1	2	3	0	0	3	0	0
10	35664575	.	C	A	1	2	3	0	0	3	0	0
10	35953370	.	G	A	2	3	5	0	1	6	0	0
10	35953491	.	T	C	5	3	8	0	0	8	0	0
10	35959133	.	C	A	7	5	12	0	1	13	0	0
10	35959163	.	T	C	10	5	15	0	0	15	0	0
10	35959223	.	T	C	10	8	18	0	0	18	0	0
10	35959400	.	T	C	2	4	6	0	0	6	0	0
10	36029893	.	T	C	34	34	68	0	2	70	0	0
10	36031298	.	A	C	3	2	5	0	0	5	0	0
10	36031316	.	C	A	4	2	6	0	0	6	0	0
10	36040404	.	T	C	6	4	10	0	0	10	0	0
10	36049738	.	G	A	9	9	18	0	0	18	0	0
10	36054226	.	C	T	6	6	12	0	0	12	0	0
10	36093267	.	T	C	1	3	4	0	0	4	0	0
10	36095614	.	T	C	2	3	5	0	0	5	0	0
10	36096022	.	T	A	3	2	5	0	0	5	0	0
10	36097946	.	C	T	1	2	3	0	0	3	0	0
10	36098253	.	A	C	3	3	6	0	0	6	0	0
10	36101022	.	A	G	1	0	1	0	4	5	0	0
10	36159159	.	A	T	4	4	8	0	0	8	0	0
10	36159166	.	G	A	4	4	8	0	0	8	0	0
10	36159219	.	G	A	2	2	4	0	0	4	0	0
10	36159432	.	G	C	2	3	5	0	0	5	0	0
10	36159502	.	G	A	3	2	5	0	1	6	0	0
10	36160041	.	G	A	1	2	3	0	0	3	0	0
10	36363557	.	A	G	9	17	26	1	0	27	0	0
10	36363611	.	C	T	21	14	35	1	1	37	0	0
10	36363818	.	G	T	12	18	30	1	2	33	0	0
10	36363937	.	G	A	21	24	45	0	1	46	0	0
10	36363971	.	C	T	1	19	20	0	19	39	0	0
10	36364172	.	A	G	22	20	42	0	2	44	0	0
10	36405921	.	C	T	24	16	40	0	3	43	0	0
10	36406039	.	G	T	14	17	31	0	5	36	0	0
10	36406106	.	T	A	4	8	12	0	1	13	0	0
10	36406210	.	G	A	21	9	30	0	2	32	0	0
10	36443018	.	T	C	18	9	27	0	0	27	0	0
10	36443541	.	T	C	9	15	24	0	2	26	0	0
10	36443676	.	G	A	0	14	14	0	4	18	0	0
10	36443714	.	G	A	5	12	17	0	1	18	0	0
10	36443818	.	T	G	4	0	4	0	5	9	0	0
10	36446799	.	A	T	11	9	20	0	0	20	0	0
10	36451615	.	T	C	18	12	30	0	0	30	0	0
10	36451661	.	G	A	22	13	35	0	1	36	0	0
10	36454567	.	C	A	11	16	27	0	2	29	0	0
10	36454649	.	A	G	12	0	12	0	27	39	0	0
10	36454650	.	C	A	13	21	34	0	5	39	0	0
10	36454902	.	G	T	13	17	30	0	2	32	0	0
10	36455146	.	C	T	22	9	31	0	1	32	0	0
10	36455215	.	T	C	11	11	22	0	0	22	0	0
10	36455229	.	C	G	9	11	20	0	1	22	1	0
10	36455344	.	A	G	15	13	28	0	3	31	0	0
10	36476481	.	C	T	1	17	18	0	13	31	0	0
10	36476529	.	C	T	22	15	37	0	0	37	0	0
10	36476639	.	C	T	2	12	14	0	9	23	0	0
10	36476717	.	A	G	7	20	27	0	2	29	0	0
10	36476834	.	G	A	18	21	39	0	2	41	0	0
10	36476852	.	A	G	16	22	38	0	1	40	1	0
10	36476922	.	C	T	19	9	28	0	2	30	0	0
10	36481915	.	A	C	14	12	26	0	1	27	0	0
10	36482588	.	G	A	16	13	29	0	0	29	0	0
10	36487530	.	G	A	8	5	13	0	2	15	0	0
10	36489882	.	A	G	12	11	23	0	0	23	0	0
10	36489893	.	A	G	12	11	23	0	0	23	0	0
10	36492091	.	C	T	9	7	16	0	0	16	0	0
10	36494336	.	G	A	4	5	9	0	0	9	0	0
10	36494590	.	C	G	7	5	12	0	0	12	0	0
10	36496544	.	A	G	9	4	13	0	1	14	0	0
10	36496595	.	G	A	9	6	15	0	0	15	0	0
10	36498379	.	C	T	1	8	9	0	7	16	0	0
10	36498397	.	G	A	9	7	16	0	1	17	0	0
10	36500581	.	C	T	5	5	10	0	0	10	0	0
10	36500674	.	G	A	9	9	18	0	0	18	0	0
10	36504163	.	C	T	0	4	4	0	1	5	0	0
10	36506103	.	G	A	2	3	5	0	0	5	0	0
10	36506290	.	C	T	0	5	5	0	5	10	0	0
10	36506630	.	T	A	4	7	11	0	0	11	0	0
10	36518643	.	C	T	7	4	11	0	0	11	0	0
10	36519788	.	T	C	4	3	7	0	0	7	0	0
10	36520003	.	C	T	1	6	7	0	2	9	0	0
10	36520024	.	C	A	4	4	8	0	0	8	0	0
10	36520711	.	G	A	8	9	17	0	0	17	0	0
10	36522302	.	G	A	2	2	4	0	0	4	0	0
10	36522602	.	A	C	2	0	2	0	2	4	0	0
10	36522713	.	A	C	1	0	1	0	3	4	0	0
10	36523826	.	G	A	8	7	15	0	0	15	0	0
10	36558839	.	A	G	9	6	15	0	0	15	0	0
10	36558895	.	G	A	12	18	30	0	0	30	0	0
10	36570469	.	A	G	16	11	27	0	0	27	0	0
10	36572622	.	G	A	12	16	28	0	0	28	0	0
10	36572640	.	C	A	1	11	12	0	13	25	0	0
10	36572814	.	A	T	7	9	16	0	0	16	0	0
10	36575980	.	G	A	5	5	10	0	0	10	0	0
10	36575992	.	C	T	5	2	7	0	2	9	0	0
10	36584462	.	T	C	4	6	10	0	0	10	0	0
10	36613095	.	T	C	12	13	25	0	0	25	0	0
10	36613145	.	G	T	12	9	21	0	1	22	0	0
10	36613164	.	C	T	2	6	8	0	13	21	0	0
10	36613276	.	C	T	6	9	15	0	0	15	0	0
10	36615367	.	G	A	11	8	19	0	0	19	0	0
10	36615907	.	C	A	8	8	16	0	0	16	0	0
10	36618435	.	C	T	0	11	11	0	8	19	0	0
10	36618787	.	C	T	15	8	23	0	0	23	0	0
10	36625258	.	C	A	1	11	12	0	11	23	0	0
10	36625534	.	G	A	5	10	15	0	5	20	0	0
10	36625602	.	C	G	10	6	16	0	1	17	0	0
10	36625761	.	T	A	9	3	12	0	0	12	0	0
10	36626201	.	C	T	5	4	9	0	0	9	0	0
10	36627009	.	G	C	3	5	8	0	1	10	1	0
10	36627314	.	C	T	11	6	17	0	1	18	0	0
10	36627390	.	A	G	6	9	15	0	1	16	0	0
10	36627414	.	C	A	10	6	16	0	1	17	0	0
10	36627517	.	C	T	11	9	20	1	0	21	0	0
10	36627820	.	C	T	7	5	12	0	1	13	0	0
10	36628009	.	C	A	5	5	10	0	1	11	0	0
10	36628012	.	G	A	5	5	10	0	1	11	0	0
10	36628569	.	C	T	0	8	8	0	4	12	0	0
10	36628626	.	G	A	4	2	6	0	0	6	0	0
10	36628804	.	G	T	2	4	6	0	1	7	0	0
10	36654283	.	G	A	1	3	4	0	0	4	0	0
10	36662718	.	A	G	1	2	3	0	0	3	0	0
10	36665829	.	C	T	2	5	7	0	1	8	0	0
10	36670106	.	T	C	6	7	13	0	0	13	0	0
10	36673237	.	G	T	2	4	6	0	0	6	0	0
10	36679577	.	C	A	1	4	5	0	1	6	0	0
10	36679609	.	G	A	4	4	8	0	0	8	0	0
10	36688455	.	C	T	6	12	18	0	1	19	0	0
10	36689850	.	G	T	6	7	13	0	2	15	0	0
10	36689893	.	A	G	4	9	13	0	2	15	0	0
10	36691372	.	C	A	2	10	12	0	11	23	0	0
10	36691636	.	G	A	11	5	16	0	0	16	0	0
10	36695781	.	G	C	16	11	27	0	1	28	0	0
10	36695785	.	C	T	14	9	23	0	2	25	0	0
10	36704842	.	A	G	20	13	33	6	2	41	0	0
10	36706217	.	T	A	14	16	30	0	1	31	0	0
10	36708401	.	A	G	19	1	20	0	28	48	0	0
10	36708453	.	C	T	13	19	32	0	2	34	0	0
10	36710559	.	A	C	18	13	31	0	2	33	0	0
10	36710599	.	C	T	20	15	35	0	2	37	0	0
10	36710871	.	G	A	7	14	21	0	20	41	0	0
10	36710893	.	G	T	0	24	24	0	14	38	0	0
10	36711260	.	T	A	9	12	21	0	0	21	0	0
10	36711329	.	T	A	14	12	26	0	0	26	0	0
10	36711613	.	C	T	10	7	17	0	3	20	0	0
10	36755022	.	A	G	2	2	4	0	0	4	0	0
10	36774339	.	A	C	2	4	6	0	1	7	0	0
10	36774379	.	T	A	1	3	4	0	0	4	0	0
10	36778302	.	C	A	5	2	7	0	0	7	0	0
10	36796083	.	A	G	1	3	4	0	0	4	0	0
10	36796131	.	T	A	3	3	6	0	0	6	0	0
10	36800465	.	G	A	11	8	19	0	0	19	0	0
10	36800518	.	C	T	10	9	19	0	0	19	0	0
10	36800600	.	G	A	9	3	12	0	0	12	0	0
10	36800642	.	A	G	6	3	9	0	0	9	0	0
10	36807986	.	G	A	2	7	9	0	0	9	0	0
10	36808032	.	G	A	2	9	11	0	0	11	0	0
10	36811815	.	A	G	13	6	19	0	2	21	0	0
10	36812214	.	A	C	11	12	23	0	0	23	0	0
10	36814912	.	G	A	9	14	23	0	0	23	0	0
10	36815330	.	T	C	6	1	7	0	3	10	0	0
10	36817197	.	A	C	6	13	19	0	0	19	0	0
10	36817530	.	C	T	13	6	19	0	2	21	0	0
10	36817940	.	T	C	8	4	12	0	0	12	0	0
10	36817979	.	T	G	6	9	15	0	0	15	0	0
10	36819664	.	G	T	7	6	13	0	2	15	0	0
10	36819671	.	C	T	6	10	16	0	1	17	0	0
10	36820601	.	C	T	0	8	8	0	4	12	0	0
10	36820611	.	A	G	6	6	12	0	1	13	0	0
10	36820664	.	C	T	7	7	14	0	1	15	0	0
10	36820688	.	C	G	1	8	9	0	8	17	0	0
10	36820736	.	G	A	6	7	13	0	0	13	0	0
10	36820769	.	T	A	5	10	15	0	2	17	0	0
10	36820892	.	G	A	8	4	12	0	0	12	0	0
10	36825650	.	C	T	1	3	4	0	2	6	0	0
10	36825818	.	T	C	4	4	8	0	0	8	0	0
10	36825880	.	G	A	4	2	6	0	1	7	0	0
10	36828110	.	A	T	1	2	3	0	0	3	0	0
10	36828227	.	T	C	5	9	14	0	2	16	0	0
10	36828265	.	G	A	9	3	12	0	0	12	0	0
10	36828295	.	G	T	3	4	7	0	4	11	0	0
10	36828469	.	T	C	5	0	5	0	8	13	0	0
10	36828475	.	C	T	9	5	14	0	0	14	0	0
10	36835641	.	A	T	9	5	14	0	0	14	0	0
10	36835740	.	G	A	6	6	12	0	0	12	0	0
10	36838768	.	C	T	3	4	7	0	0	7	0	0
10	36841230	.	G	T	5	2	7	0	0	7	0	0
10	36848872	.	G	A	2	7	9	0	0	9	0	0
10	36848938	.	A	G	8	6	14	0	2	16	0	0
10	36850674	.	C	T	1	5	6	0	7	13	0	0
10	36850752	.	A	G	5	8	13	0	0	13	0	0
10	36876162	.	A	C	1	0	1	0	6	7	0	0
10	36878340	.	G	T	2	2	4	0	0	4	0	0
10	36878362	.	C	A	2	2	4	0	0	4	0	0
10	36878568	.	C	T	5	6	11	0	0	11	0	0
10	36878638	.	T	C	6	0	6	0	4	10	0	0
10	36927345	.	A	T	2	4	6	0	1	7	0	0
10	36927349	.	C	T	0	3	3	0	4	7	0	0
10	36950935	.	A	T	3	4	7	0	0	7	0	0
10	36951044	.	A	T	6	11	17	0	2	19	0	0
10	36951076	.	G	C	8	13	21	0	2	23	0	0
10	36951223	.	A	C	7	13	20	0	0	20	0	0
10	36951378	.	A	G	8	6	14	0	1	15	0	0
10	36951582	.	C	G	5	11	16	0	2	18	0	0
10	36951660	.	T	A	10	5	15	0	2	17	0	0
10	36963456	.	G	A	4	6	10	0	0	10	0	0
10	36967206	.	T	C	15	14	29	0	1	30	0	0
10	36969510	.	T	C	4	14	18	0	0	18	0	0
10	36969519	.	A	G	4	14	18	0	0	18	0	0
10	36974901	.	G	A	10	7	17	0	0	17	0	0
10	36976271	.	C	T	1	9	10	0	5	15	0	0
10	36976318	.	G	A	10	7	17	0	0	17	0	0
10	36987831	.	T	G	7	9	16	0	1	17	0	0
10	36994398	.	G	A	1	7	8	0	0	8	0	0
10	37007508	.	G	C	5	6	11	0	0	11	0	0
10	37011570	.	G	T	5	3	8	0	0	8	0	0
10	37016458	.	T	C	2	1	3	0	2	5	0	0
10	37070412	.	T	C	2	3	5	0	0	5	0	0
10	37070656	.	A	T	1	4	5	0	0	5	0	0
10	37107171	.	T	C	0	3	3	0	0	3	0	0
10	37107174	.	C	T	1	2	3	0	0	3	0	0
10	37126295	.	C	T	5	5	10	0	0	10	0	0
10	37126307	.	C	T	5	6	11	0	0	11	0	0
10	37137549	.	G	A	1	9	10	0	16	26	0	0
10	37145178	.	G	A	13	6	19	0	1	20	0	0
10	37152081	.	G	A	14	23	37	0	2	39	0	0
10	37152105	.	A	G	28	0	28	0	13	41	0	0
10	37155072	.	G	A	1	8	9	0	7	16	0	0
10	37163252	.	C	A	12	14	26	0	0	26	0	0
10	37167151	.	G	C	10	9	19	0	0	19	0	0
10	37227524	.	C	T	9	9	18	0	0	18	0	0
10	37234093	.	A	G	2	0	2	0	9	11	0	0
10	37236672	.	T	G	6	0	6	0	6	13	1	0
10	37236857	.	A	G	3	0	3	0	8	11	0	0
10	37239229	.	G	A	6	4	10	0	0	10	0	0
10	37252054	.	G	A	0	10	10	0	6	16	0	0
10	37253986	.	A	G	9	11	20	0	0	20	0	0
10	37334291	.	G	T	4	3	7	0	0	7	0	0
10	37334908	.	T	A	3	2	5	0	0	5	0	0
10	37360308	.	G	A	1	4	5	0	0	5	0	0
10	37361681	.	G	A	0	3	3	0	1	4	0	0
10	37367451	.	T	C	2	2	4	0	0	4	0	0
10	37367481	.	C	T	4	2	6	0	0	6	0	0
10	37378252	.	A	T	4	4	8	0	1	9	0	0
10	37394478	.	G	A	8	4	12	0	0	12	0	0
10	37394486	.	G	A	7	4	11	0	0	11	0	0
10	37764473	.	C	T	9	16	25	0	0	25	0	0
10	37779765	.	A	C	16	10	26	0	1	27	0	0
10	37779778	.	T	A	16	7	23	0	1	24	0	0
10	37783114	.	A	G	15	9	24	0	1	25	0	0
10	37783179	.	A	G	15	0	15	0	12	27	0	0
10	37783323	.	A	G	12	13	25	0	0	25	0	0
10	37783575	.	C	A	1	3	4	0	0	4	0	0
10	37783669	.	C	A	4	4	8	0	0	8	0	0
10	37992653	.	C	T	4	2	6	0	1	7	0	0
10	37992679	.	G	A	0	3	3	0	4	7	0	0
10	37992839	.	A	T	6	5	11	0	0	11	0	0
10	37994630	.	C	T	7	4	11	0	0	11	0	0
10	37997567	.	C	G	3	7	10	0	0	10	0	0
10	38000082	.	C	G	9	3	12	0	0	12	0	0
10	38000084	.	G	T	0	9	9	0	3	12	0	0
10	38003011	.	A	G	12	10	22	0	0	22	0	0
10	38006002	.	T	C	1	2	3	0	0	3	0	0
10	38006057	.	T	C	2	3	5	0	0	5	0	0
10	38040372	.	A	G	12	8	20	0	0	20	0	0
10	38040378	.	A	G	8	8	16	0	2	18	0	0
10	38074570	.	G	T	7	11	18	0	0	18	0	0
10	38171149	.	G	C	8	0	8	0	5	13	0	0
10	38171196	.	G	A	11	7	18	0	0	18	0	0
10	38171207	.	C	A	7	12	19	0	1	20	0	0
10	38171356	.	A	T	11	10	21	0	0	21	0	0
10	38171490	.	T	A	18	9	27	0	0	27	0	0
10	38173383	.	C	A	0	10	10	0	15	25	0	0
10	38177999	.	C	T	3	10	13	0	15	28	0	0
10	38178357	.	G	A	8	7	15	0	1	16	0	0
10	38180732	.	A	T	10	7	17	0	2	19	0	0
10	38199097	.	G	A	8	4	12	0	0	12	0	0
10	38199169	.	T	C	7	10	17	0	1	18	0	0
10	38205149	.	T	C	5	0	5	0	9	14	0	0
10	38211810	.	C	G	7	5	12	0	0	12	0	0
10	38218990	.	C	T	1	6	7	0	6	13	0	0
10	38231165	.	C	T	0	4	4	0	6	10	0	0
10	38235957	.	G	C	11	4	15	0	0	15	0	0
10	38243449	.	G	A	3	7	10	0	0	10	0	0
10	38243543	.	G	A	3	5	8	0	0	8	0	0
10	38257295	.	G	A	7	5	12	0	2	14	0	0
10	38257509	.	C	G	0	8	8	0	8	16	0	0
10	38257558	.	C	T	4	7	11	0	1	12	0	0
10	38257870	.	T	C	13	14	27	0	0	27	0	0
10	38258729	.	C	G	12	11	23	0	0	23	0	0
10	38259033	.	C	T	10	7	17	0	1	18	0	0
10	38259034	.	A	G	9	8	17	0	1	18	0	0
10	38259204	.	G	A	6	5	11	0	1	12	0	0
10	38259217	.	A	G	9	7	16	0	0	16	0	0
10	38259268	.	G	C	3	11	14	2	0	16	0	0
10	38259339	.	A	T	10	5	15	0	0	15	0	0
10	38259449	.	A	C	13	1	14	0	8	22	0	0
10	38259451	.	A	G	13	9	22	0	0	22	0	0
10	38259900	.	T	C	14	0	14	0	7	21	0	0
10	38260002	.	G	A	7	9	16	0	1	17	0	0
10	38260210	.	T	A	9	13	22	0	0	22	0	0
10	38260626	.	A	T	8	9	17	0	3	20	0	0
10	38261453	.	G	A	5	7	12	0	0	12	0	0
10	38261485	.	C	T	7	8	15	0	0	15	0	0
10	38261495	.	T	G	6	9	15	0	0	15	0	0
10	38261638	.	G	A	8	3	11	0	0	11	0	0
10	38261696	.	C	T	5	4	9	0	1	10	0	0
10	38665994	.	C	T	17	19	36	0	0	36	0	0
10	38666063	.	T	C	16	13	29	0	1	30	0	0
10	38686126	.	T	C	26	17	43	0	0	43	0	0
10	38695152	.	A	C	27	15	42	0	2	44	0	0
10	38695510	.	A	G	24	6	30	0	1	31	0	0
10	38695656	.	A	G	15	7	22	0	3	25	0	0
10	38695877	.	C	T	11	10	21	0	3	24	0	0
10	38695888	.	C	T	9	10	19	0	0	19	0	0
10	38712403	.	A	G	1	0	1	0	9	10	0	0
10	38712431	.	C	T	3	3	6	0	2	8	0	0
10	38723491	.	T	C	3	3	6	0	0	6	0	0
10	38723539	.	T	C	1	4	5	0	0	5	0	0
10	38724101	.	C	T	1	2	3	0	0	3	0	0
10	38726441	.	C	T	2	3	5	0	0	5	0	0
10	38775780	.	C	G	4	7	11	0	0	11	0	0
10	38885821	.	T	C	8	3	11	0	0	11	0	0
10	38891454	.	C	A	12	5	17	0	0	17	0	0
10	38922043	.	G	A	1	10	11	0	10	21	0	0
10	38924557	.	C	T	9	7	16	0	0	16	0	0
10	38924560	.	T	C	10	8	18	0	0	18	0	0
10	38934391	.	A	G	10	8	18	0	0	18	0	0
10	38940232	.	A	G	5	10	15	0	2	17	0	0
10	38943265	.	C	G	10	13	23	0	0	23	0	0
10	38950115	.	T	C	6	9	15	0	1	16	0	0
10	38950430	.	G	A	1	13	14	0	9	23	0	0
10	38950484	.	A	G	9	22	31	0	0	31	0	0
10	38950538	.	T	C	16	12	28	0	2	30	0	0
10	38954126	.	C	T	19	13	32	0	7	39	0	0
10	38954141	.	T	C	26	12	38	0	2	40	0	0
10	38954798	.	T	C	14	17	31	0	0	31	0	0
10	38954801	.	C	T	14	17	31	0	0	31	0	0
10	38957061	.	T	C	17	10	27	0	3	30	0	0
10	38957127	.	G	A	1	11	12	0	20	32	0	0
10	38957193	.	C	T	14	14	28	0	0	28	0	0
10	38957748	.	A	C	11	12	23	1	0	24	0	0
10	38957754	.	A	C	12	13	25	1	0	26	0	0
10	38969552	.	A	C	42	14	56	0	2	58	0	0
10	38969598	.	A	C	28	22	50	0	1	51	0	0
10	38969629	.	C	T	25	25	50	0	1	51	0	0
10	38969685	.	A	G	29	21	50	0	0	50	0	0
10	38969778	.	C	T	24	16	40	0	3	43	0	0
10	39011484	.	C	T	19	17	36	0	5	41	0	0
10	39086981	.	G	A	24	26	50	0	3	53	0	0
10	39087391	.	A	G	37	0	37	0	28	65	0	0
10	39087625	.	T	A	27	28	55	0	3	58	0	0
10	39087659	.	T	A	23	31	54	0	2	56	0	0
10	39091684	.	C	A	1	2	3	0	2	5	0	0
10	39091792	.	A	G	4	0	4	0	9	13	0	0
10	39098798	.	C	T	3	3	6	0	0	6	0	0
10	39102776	.	T	C	6	8	14	0	0	14	0	0
10	39110452	.	G	C	2	5	7	0	0	7	0	0
10	39115595	.	G	T	5	5	10	0	0	10	0	0
10	39115596	.	T	C	5	5	10	0	0	10	0	0
10	39120132	.	T	C	10	8	18	0	1	19	0	0
10	39130460	.	C	T	48	28	76	0	1	77	0	0
10	39140465	.	A	G	4	4	8	0	0	8	0	0
10	39140741	.	T	C	10	4	14	0	0	14	0	0
10	39153470	.	G	A	1	4	5	0	0	5	0	0
10	39153494	.	A	G	1	3	4	0	0	4	0	0
10	39170798	.	A	C	4	2	6	0	0	6	0	0
10	39175139	.	T	C	5	6	11	0	0	11	0	0
10	39175418	.	T	C	5	3	8	0	0	8	0	0
10	39175452	.	C	T	4	2	6	0	0	6	0	0
10	39175475	.	G	A	0	3	3	0	3	6	0	0
10	39179439	.	G	A	1	2	3	0	2	5	0	0
10	39179525	.	G	A	2	4	6	0	0	6	0	0
10	39179696	.	C	T	5	2	7	0	1	8	0	0
10	39179925	.	T	A	5	2	7	0	1	8	0	0
10	39181140	.	C	T	4	7	11	2	0	13	0	0
10	39181145	.	C	A	4	7	11	2	0	13	0	0
10	39181257	.	T	A	2	2	4	0	1	5	0	0
10	39181274	.	C	T	5	1	6	0	1	7	0	0
10	39181325	.	G	T	0	7	7	0	7	14	0	0
10	39182173	.	A	G	13	6	19	0	0	19	0	0
10	39182310	.	C	A	8	9	17	0	0	17	0	0
10	39182342	.	A	T	8	6	14	0	0	14	0	0
10	39182401	.	C	A	11	5	16	0	1	17	0	0
10	39182497	.	C	T	11	6	17	0	2	19	0	0
10	39182659	.	G	T	5	2	7	0	0	7	0	0
10	39199639	.	G	A	0	4	4	0	5	9	0	0
10	39205021	.	C	T	7	6	13	0	0	13	0	0
10	39205256	.	C	G	8	5	13	0	0	13	0	0
10	39206945	.	A	G	6	7	13	0	0	13	0	0
10	39206990	.	A	T	9	4	13	0	0	13	0	0
10	39207104	.	C	A	7	2	9	0	0	9	0	0
10	39207114	.	C	A	5	2	7	0	1	8	0	0
10	39207708	.	A	T	4	4	8	0	0	8	0	0
10	39207720	.	A	G	4	3	7	0	0	7	0	0
10	39207749	.	C	T	3	3	6	0	0	6	0	0
10	39207812	.	T	A	2	2	4	0	0	4	0	0
10	39212932	.	G	A	5	3	8	0	0	8	0	0
10	39216625	.	C	T	6	9	15	0	0	15	0	0
10	39219390	.	T	C	14	10	24	0	0	24	0	0
10	39219540	.	T	A	13	14	27	0	2	29	0	0
10	39222134	.	A	C	21	12	33	0	0	33	0	0
10	39222182	.	A	G	15	17	32	0	2	34	0	0
10	39225504	.	A	C	18	14	32	0	0	32	0	0
10	39225555	.	T	C	27	12	39	0	2	41	0	0
10	39231387	.	G	A	19	21	40	0	1	41	0	0
10	39249061	.	G	T	2	3	5	0	0	5	0	0
10	39249103	.	T	C	3	2	5	0	0	5	0	0
10	39265766	.	G	A	1	3	4	0	0	4	0	0
10	39265954	.	G	A	1	3	4	0	0	4	0	0
10	39266350	.	G	T	0	3	3	0	4	7	0	0
10	39266422	.	C	T	2	2	4	0	0	4	0	0
10	39266669	.	A	C	1	3	4	0	0	4	0	0
10	39266702	.	A	G	3	0	3	0	5	8	0	0
10	39266862	.	T	C	1	1	2	0	1	3	0	0
10	39267045	.	G	C	2	3	5	0	2	7	0	0
10	39274864	.	A	G	3	4	7	0	0	7	0	0
10	39277087	.	C	G	3	2	5	0	0	5	0	0
10	39284032	.	A	G	2	2	4	0	0	4	0	0
10	39285246	.	A	G	8	4	12	0	0	12	0	0
10	39286967	.	C	T	2	3	5	0	0	5	0	0
10	39287100	.	C	T	4	5	9	0	0	9	0	0
10	39289006	.	A	G	3	0	3	0	5	8	0	0
10	39289036	.	A	C	2	6	8	0	0	8	0	0
10	39294545	.	T	A	1	3	4	0	0	4	0	0
10	39294562	.	T	A	1	3	4	0	0	4	0	0
10	39306817	.	T	C	1	2	3	0	0	3	0	0
10	39307378	.	T	C	1	2	3	0	0	3	0	0
10	39476639	.	A	G	4	5	9	0	0	9	0	0
10	39904774	.	G	A	1	7	8	1	8	17	0	0
10	39904780	.	C	T	7	7	14	1	3	18	0	0
10	39904851	.	A	T	3	8	11	0	0	11	0	0
10	39904915	.	A	G	8	12	20	0	1	21	0	0
10	39904966	.	T	C	2	7	9	0	1	10	0	0
10	39905085	.	A	T	2	7	9	0	0	9	0	0
10	39905089	.	T	G	2	8	10	0	0	10	0	0
10	39953560	.	T	C	6	2	8	0	0	8	0	0
10	39953561	.	T	C	6	2	8	0	0	8	0	0
10	39953689	.	T	C	3	4	7	0	1	8	0	0
10	40086018	.	A	G	8	4	12	0	0	12	0	0
10	40086024	.	T	C	8	4	12	0	0	12	0	0
10	40089829	.	C	A	5	3	8	0	0	8	0	0
10	40089838	.	C	T	5	2	7	0	0	7	0	0
10	40089941	.	T	C	4	2	6	0	2	8	0	0
10	40109378	.	C	T	6	8	14	0	0	14	0	0
10	40109439	.	G	A	1	7	8	0	5	13	0	0
10	40110226	.	T	C	3	4	7	0	0	7	0	0
10	40110243	.	A	T	3	2	5	0	0	5	0	0
10	40110397	.	A	G	3	4	7	0	0	7	0	0
10	40110599	.	G	A	0	5	5	0	3	8	0	0
10	40110616	.	G	T	2	6	8	0	0	8	0	0
10	40110666	.	T	A	3	4	7	0	0	7	0	0
10	40110726	.	C	A	3	2	5	0	0	5	0	0
10	40110741	.	G	A	1	2	3	0	0	3	0	0
10	40110782	.	A	T	1	2	3	0	0	3	0	0
10	40111412	.	G	A	6	4	10	0	0	10	0	0
10	40111437	.	T	A	6	6	12	0	0	12	0	0
10	40111549	.	T	C	9	6	15	0	0	15	0	0
10	40111610	.	C	T	4	3	7	0	0	7	0	0
10	40111666	.	G	C	5	3	8	0	2	10	0	0
10	40111706	.	A	G	5	4	9	0	1	10	0	0
10	40111732	.	C	T	3	5	8	0	2	10	0	0
10	40111904	.	G	T	3	4	7	0	0	7	0	0
10	40111952	.	C	T	6	3	9	0	0	9	0	0
10	40111964	.	C	A	6	4	10	0	0	10	0	0
10	40112121	.	A	G	4	3	7	0	0	7	0	0
10	40112157	.	G	A	5	5	10	0	0	10	0	0
10	40112159	.	T	A	5	5	10	0	0	10	0	0
10	40112347	.	A	T	7	3	10	0	1	11	0	0
10	40112638	.	C	T	6	3	9	0	1	10	0	0
10	40112834	.	G	A	4	3	7	0	2	9	0	0
10	40113032	.	T	A	3	5	8	0	0	8	0	0
10	40113045	.	A	G	7	2	9	0	1	10	0	0
10	40113082	.	T	C	3	4	7	0	1	8	0	0
10	40113113	.	C	G	3	6	9	0	0	9	0	0
10	40113161	.	C	A	2	6	8	0	0	8	0	0
10	40113197	.	G	A	0	8	8	0	4	12	0	0
10	40113408	.	A	G	13	6	19	0	0	19	0	0
10	40113446	.	T	C	5	5	10	0	1	11	0	0
10	40113592	.	G	A	2	4	6	0	0	6	0	0
10	40113832	.	G	A	1	2	3	0	0	3	0	0
10	40167670	.	C	T	1	2	3	0	0	3	0	0
10	40167788	.	A	G	1	0	1	0	2	3	0	0
10	40167908	.	C	T	2	2	4	0	0	4	0	0
10	40236068	.	A	G	6	0	6	0	4	10	0	0
10	40253228	.	C	T	6	2	8	0	0	8	0	0
10	40262052	.	T	C	3	9	12	0	0	12	0	0
10	40262338	.	T	C	5	3	8	0	0	8	0	0
10	40262347	.	A	G	6	0	6	0	2	8	0	0
10	40266160	.	A	G	6	5	11	0	0	11	0	0
10	40266259	.	A	C	4	2	6	0	0	6	0	0
10	40274541	.	G	A	0	9	9	0	11	20	0	0
10	40274626	.	C	T	6	3	9	0	0	9	0	0
10	40274963	.	A	C	2	2	4	0	1	5	0	0
10	40275055	.	G	C	0	3	3	0	3	6	0	0
10	40275070	.	T	G	3	4	7	0	0	7	0	0
10	40290969	.	G	A	4	5	9	0	1	10	0	0
10	40296841	.	G	A	0	5	5	0	2	7	0	0
10	40296896	.	C	T	4	4	8	0	0	8	0	0
10	40303924	.	G	C	8	6	14	0	1	15	0	0
10	40303980	.	A	G	5	4	9	0	0	9	0	0
10	40307553	.	T	C	6	3	9	0	1	10	0	0
10	40307622	.	C	T	3	5	8	0	0	8	0	0
10	40311286	.	G	T	0	8	8	0	7	15	0	0
10	40314175	.	A	C	7	8	15	0	0	15	0	0
10	40314177	.	A	C	6	7	13	0	2	15	0	0
10	40317095	.	G	T	9	5	14	0	1	15	0	0
10	40317190	.	T	G	6	2	8	0	1	9	0	0
10	40317192	.	G	T	5	2	7	0	2	9	0	0
10	40317285	.	A	T	4	8	12	0	2	14	0	0
10	40317323	.	A	G	3	0	3	0	3	6	0	0
10	40822252	.	C	T	1	7	8	0	13	21	0	0
10	40825192	.	T	C	11	14	25	0	1	26	0	0
10	40826436	.	A	G	2	8	10	0	1	11	0	0
10	40826494	.	A	G	4	5	9	0	1	10	0	0
10	40826516	.	A	G	14	5	19	0	0	19	0	0
10	40826589	.	C	T	23	7	30	0	0	30	0	0
10	40826590	.	A	G	22	6	28	0	1	29	0	0
10	40859633	.	C	T	4	3	7	0	0	7	0	0
10	40859647	.	A	C	3	3	6	0	0	6	0	0
10	40859722	.	A	G	3	4	7	0	1	8	0	0
10	40859885	.	A	G	13	7	20	0	0	20	0	0
10	40859968	.	T	C	8	7	15	0	1	16	0	0
10	40861563	.	C	A	8	11	19	0	0	19	0	0
10	40861650	.	G	A	7	4	11	0	0	11	0	0
10	40861701	.	G	T	3	3	6	0	0	6	0	0
10	40866244	.	T	C	4	0	4	0	5	9	0	0
10	40872771	.	G	A	1	2	3	0	0	3	0	0
10	41837039	.	T	C	7	12	19	0	0	19	0	0
10	41837425	.	G	C	8	8	16	0	0	16	0	0
10	41837486	.	T	C	10	11	21	0	2	23	0	0
10	41837528	.	A	G	6	7	13	0	1	14	0	0
10	41841119	.	G	A	12	7	19	0	0	19	0	0
10	41841209	.	C	G	5	15	20	0	1	21	0	0
10	41843743	.	C	A	2	7	9	0	7	16	0	0
10	41846770	.	A	G	5	9	14	0	0	14	0	0
10	41865722	.	G	A	5	5	10	0	1	11	0	0
10	41879500	.	A	G	4	2	6	0	0	6	0	0
10	41879509	.	T	A	4	2	6	0	0	6	0	0
10	41894792	.	T	C	5	2	7	0	0	7	0	0
10	41902817	.	A	G	3	4	7	0	2	9	0	0
10	41902826	.	C	T	3	5	8	0	1	9	0	0
10	41914189	.	C	G	4	3	7	0	0	7	0	0
10	41920994	.	A	G	1	2	3	0	0	3	0	0
10	41933286	.	T	A	1	3	4	0	0	4	0	0
10	41939700	.	A	G	2	3	5	0	0	5	0	0
10	41951235	.	C	T	3	2	5	0	1	6	0	0
10	41954644	.	T	A	2	2	4	0	0	4	0	0
10	41983371	.	A	G	2	2	4	0	0	4	0	0
10	41983482	.	A	C	4	8	12	0	0	12	0	0
10	41983494	.	T	C	5	0	5	0	5	10	0	0
10	41984045	.	G	A	5	2	7	0	0	7	0	0
10	41984251	.	G	A	4	2	6	0	0	6	0	0
10	41985396	.	T	C	2	2	4	0	0	4	0	0
10	41988149	.	C	A	1	2	3	0	0	3	0	0
10	41995252	.	C	T	2	2	4	0	0	4	0	0
10	41995506	.	G	C	8	4	12	0	0	12	0	0
10	41995555	.	C	T	8	3	11	0	0	11	0	0
10	41995573	.	C	T	7	3	10	0	0	10	0	0
10	41995741	.	A	G	2	0	2	0	5	7	0	0
10	41995897	.	A	G	2	2	4	0	0	4	0	0
10	41996150	.	G	C	2	3	5	0	0	5	0	0
10	41996153	.	A	G	2	0	2	0	3	5	0	0
10	42002429	.	G	A	0	3	3	0	4	7	0	0
10	42002903	.	C	T	2	4	6	0	0	6	0	0
10	42006943	.	A	G	3	2	5	1	0	6	0	0
10	42007836	.	G	T	5	4	9	0	0	9	0	0
10	42011128	.	T	C	9	3	12	0	0	12	0	0
10	42011245	.	C	T	7	3	10	0	0	10	0	0
10	42011293	.	G	A	7	7	14	0	0	14	0	0
10	42019966	.	A	C	6	5	11	0	0	11	0	0
10	42020285	.	G	A	5	5	10	0	0	10	0	0
10	42020422	.	C	T	4	6	10	0	1	11	0	0
10	42020565	.	C	T	12	9	21	0	0	21	0	0
10	42020684	.	A	G	6	0	6	0	13	19	0	0
10	42021194	.	A	G	2	3	5	0	2	7	0	0
10	42021611	.	C	A	4	8	12	0	0	12	0	0
10	42022014	.	C	G	11	4	15	0	0	15	0	0
10	42030956	.	C	T	4	4	8	0	0	8	0	0
10	42044337	.	C	T	12	7	19	0	0	19	0	0
10	42044409	.	A	G	14	14	28	0	2	30	0	0
10	42044497	.	A	G	14	13	27	0	0	27	0	0
10	42044745	.	T	G	11	15	26	0	0	26	0	0
10	42044746	.	C	T	12	14	26	0	1	27	0	0
10	42044809	.	T	A	22	12	34	0	2	37	1	0
10	42044859	.	G	A	20	14	34	0	3	37	0	0
10	42045041	.	G	C	15	15	30	0	2	32	0	0
10	42045370	.	G	A	10	9	19	0	0	19	0	0
10	42045534	.	A	T	5	2	7	0	0	7	0	0
10	42045578	.	C	T	3	1	4	0	1	5	0	0
10	42047442	.	T	A	6	2	8	0	0	8	0	0
10	42048156	.	A	T	4	2	6	0	0	6	0	0
10	42050806	.	T	C	6	0	6	0	4	10	0	0
10	42060191	.	T	C	3	0	3	0	4	7	0	0
10	42087172	.	C	T	1	2	3	0	0	3	0	0
10	42089835	.	G	A	2	2	4	0	0	4	0	0
10	42104361	.	T	G	10	5	15	0	1	16	0	0
10	42104371	.	C	T	0	1	1	0	13	14	0	0
10	42105921	.	C	T	11	4	15	0	0	15	0	0
10	42111610	.	A	T	6	4	10	0	0	10	0	0
10	42111669	.	C	A	9	9	18	0	0	18	0	0
10	42111673	.	G	A	8	11	19	0	0	19	0	0
10	42111895	.	G	A	6	9	15	0	1	16	0	0
10	42112062	.	T	A	3	4	7	0	2	9	0	0
10	42112075	.	T	C	4	0	4	0	5	9	0	0
10	42112227	.	G	T	5	6	11	0	1	12	0	0
10	42114366	.	G	A	14	6	20	0	0	20	0	0
10	42119810	.	C	T	8	3	11	0	1	12	0	0
10	42128886	.	A	G	10	8	18	0	2	20	0	0
10	42128898	.	C	T	10	9	19	0	0	19	0	0
10	42134649	.	T	C	6	2	8	0	0	8	0	0
10	42135272	.	A	C	1	0	1	0	2	3	0	0
10	42135436	.	T	C	8	0	8	0	3	11	0	0
10	42136474	.	T	C	2	0	2	0	3	5	0	0
10	42136500	.	A	C	2	2	4	0	0	4	0	0
10	42136570	.	A	G	3	2	5	0	1	6	0	0
10	42136576	.	G	A	4	3	7	0	0	7	0	0
10	42136663	.	T	C	3	0	3	1	2	6	0	0
10	42137050	.	G	C	7	5	12	2	0	14	0	0
10	42137091	.	G	C	10	3	13	1	0	14	0	0
10	42138103	.	G	A	1	2	3	0	0	3	0	0
10	42138380	.	T	C	3	0	3	0	6	9	0	0
10	42140224	.	A	T	6	2	8	0	0	8	0	0
10	42196374	.	C	T	0	3	3	0	9	12	0	0
10	42196404	.	T	C	5	0	5	0	9	14	0	0
10	42196524	.	A	G	7	8	15	0	2	17	0	0
10	42199935	.	A	G	4	2	6	0	2	8	0	0
10	42297811	.	G	T	1	3	4	0	0	4	0	0
10	42378334	.	A	T	43	29	72	0	2	75	1	0
10	42423366	.	T	A	3	2	5	0	0	5	0	0
10	42463138	.	C	G	1	0	1	0	4	5	0	0
10	42463198	.	G	A	0	3	3	0	2	5	0	0
10	42463797	.	T	G	1	2	3	0	0	3	0	0
10	42501067	.	A	G	8	6	14	0	0	14	0	0
10	42501175	.	T	A	8	12	20	0	1	21	0	0
10	42501365	.	A	G	8	12	20	0	3	23	0	0
10	42505845	.	T	C	12	4	16	0	3	19	0	0
10	42507081	.	T	C	9	6	15	0	0	15	0	0
10	42507120	.	T	C	8	7	15	0	0	15	0	0
10	42507141	.	A	G	9	5	14	0	1	15	0	0
10	42519641	.	C	T	12	10	22	0	1	23	0	0
10	42522016	.	T	C	13	9	22	0	1	23	0	0
10	42526213	.	C	T	17	15	32	0	3	35	0	0
10	42531713	.	C	T	21	16	37	0	2	39	0	0
10	42539630	.	C	T	30	29	59	0	3	62	0	0
10	42539849	.	C	T	22	20	42	0	0	42	0	0
10	42539955	.	T	C	21	17	38	0	1	39	0	0
10	42540132	.	A	T	17	17	34	0	0	34	0	0
10	42540172	.	A	C	13	19	32	0	2	34	0	0
10	42540726	.	A	G	11	3	14	0	1	15	0	0
10	42542568	.	A	C	5	7	12	0	0	12	0	0
10	42542660	.	A	C	3	7	10	0	0	10	0	0
10	42542883	.	C	T	5	3	8	0	0	8	0	0
10	42548171	.	T	G	6	0	6	0	4	10	0	0
10	42548210	.	A	T	6	6	12	0	1	13	0	0
10	42548213	.	A	G	6	0	6	0	6	12	0	0
10	42549515	.	A	G	6	0	6	0	6	12	0	0
10	42555504	.	A	G	3	1	4	0	1	5	0	0
10	42555728	.	G	A	0	4	4	0	5	10	1	0
10	42555732	.	G	T	4	5	9	0	1	10	0	0
10	42555764	.	C	A	6	6	12	0	0	12	0	0
10	42652166	.	A	G	3	2	5	0	0	5	0	0
10	42691349	.	T	C	7	6	13	0	0	13	0	0
10	42694471	.	A	G	8	0	8	0	7	15	0	0
10	42694477	.	T	C	7	8	15	0	0	15	0	0
10	42694552	.	C	A	7	7	14	0	0	14	0	0
10	42694573	.	A	G	5	0	5	0	6	11	0	0
10	42700932	.	C	T	10	3	13	0	0	13	0	0
10	42701006	.	C	T	10	9	19	0	0	19	0	0
10	42701027	.	C	G	8	9	17	0	0	17	0	0
10	42701051	.	T	C	11	7	18	0	1	19	0	0
10	42701129	.	A	G	4	0	4	0	6	10	0	0
10	42701216	.	C	T	4	7	11	0	1	12	0	0
10	42701317	.	A	G	3	0	3	0	10	13	0	0
10	42704661	.	G	T	9	6	15	0	1	16	0	0
10	42704671	.	G	A	6	4	10	0	1	12	1	0
10	42704848	.	T	C	9	8	17	0	0	17	0	0
10	42704988	.	T	C	5	7	12	0	2	14	0	0
10	42708084	.	A	G	8	5	13	2	0	15	0	0
10	42715679	.	C	T	30	14	44	2	4	50	0	0
10	42715688	.	T	C	28	15	43	4	4	51	0	0
10	42715853	.	C	T	24	17	41	0	0	41	0	0
10	42733678	.	A	G	5	9	14	0	1	15	0	0
10	42738094	.	A	G	6	8	14	0	0	14	0	0
10	42738095	.	C	T	6	8	14	0	0	14	0	0
10	42738176	.	T	C	9	3	12	0	0	12	0	0
10	42738256	.	A	G	6	4	10	0	0	10	0	0
10	42738261	.	A	G	4	6	10	0	0	10	0	0
10	42739589	.	G	A	17	9	26	0	1	27	0	0
10	42739593	.	T	C	19	9	28	0	0	28	0	0
10	42739822	.	C	A	8	4	12	0	0	12	0	0
10	42739840	.	G	A	7	5	12	0	1	13	0	0
10	42739938	.	C	T	7	4	11	1	1	13	0	0
10	42740111	.	G	A	2	9	11	0	11	22	0	0
10	42741199	.	G	T	20	14	34	0	2	36	0	0
10	42741417	.	T	A	25	18	43	0	4	47	0	0
10	42741469	.	T	A	28	20	48	0	2	50	0	0
10	42741519	.	G	T	31	21	52	0	1	53	0	0
10	42741661	.	C	A	1	9	10	0	36	46	0	0
10	42741840	.	T	A	27	22	49	1	4	54	0	0
10	42741872	.	A	G	25	17	42	0	4	46	0	0
10	42741938	.	A	C	13	0	13	0	30	43	0	0
10	42742058	.	T	C	6	0	6	0	5	11	0	0
10	42742135	.	C	T	1	8	9	0	1	10	0	0
10	42742140	.	T	A	1	6	7	0	1	8	0	0
10	42742319	.	A	T	10	4	14	1	2	17	0	0
10	42742600	.	C	T	12	14	26	0	0	26	0	0
10	42742744	.	C	A	10	5	15	7	0	22	0	0
10	42743711	.	T	C	14	0	14	1	8	23	0	0
10	42744585	.	C	T	17	4	21	0	0	21	0	0
10	42744598	.	C	A	17	4	21	0	1	22	0	0
10	42744705	.	A	T	10	11	21	0	0	21	0	0
10	42744720	.	G	C	9	13	22	0	1	23	0	0
10	42744831	.	T	G	12	6	18	2	2	22	0	0
10	42744912	.	C	A	10	7	17	0	1	18	0	0
10	42744951	.	G	C	9	9	18	0	1	19	0	0
10	42744970	.	T	A	9	6	15	0	0	15	0	0
10	42745018	.	T	A	5	6	11	0	1	12	0	0
10	42745147	.	A	G	10	7	17	0	1	18	0	0
10	42745151	.	C	T	9	7	16	0	0	16	0	0
10	42767123	.	G	A	24	20	44	0	1	45	0	0
10	42767252	.	C	T	2	13	15	0	18	33	0	0
10	42771558	.	A	T	13	6	19	0	0	19	0	0
10	42873937	.	T	C	2	2	4	0	1	5	0	0
10	42876420	.	A	G	1	3	4	0	0	4	0	0
10	42876681	.	C	T	0	4	4	0	2	6	0	0
10	42882121	.	G	A	3	2	5	0	0	5	0	0
10	42882124	.	A	C	3	2	5	0	0	5	0	0
10	42900713	.	G	C	6	6	12	0	0	12	0	0
10	42900909	.	G	A	1	7	8	0	5	13	0	0
10	42901141	.	T	C	2	2	4	0	0	4	0	0
10	42902618	.	T	C	3	3	6	0	1	7	0	0
10	42902666	.	G	A	4	4	8	0	1	9	0	0
10	42902792	.	T	C	4	5	9	0	0	9	0	0
10	42903745	.	T	C	5	2	7	0	0	7	0	0
10	42903854	.	G	A	2	2	4	0	0	4	0	0
10	42930776	.	T	C	14	0	14	0	11	25	0	0
10	42930781	.	T	C	14	0	14	0	11	25	0	0
10	42930814	.	T	C	14	9	23	0	2	25	0	0
10	42930828	.	T	C	5	12	17	0	1	18	0	0
10	42930933	.	T	C	8	4	12	0	0	12	0	0
10	42931224	.	T	A	3	3	6	0	0	8	2	0
10	42931278	.	T	C	4	7	11	0	0	11	0	0
10	42931315	.	T	A	8	6	14	0	0	14	0	0
10	42935346	.	C	T	0	6	6	0	10	16	0	0
10	42949713	.	A	G	9	12	21	0	0	21	0	0
10	42992977	.	T	C	4	0	4	0	7	11	0	0
10	43057598	.	C	T	5	4	9	0	0	9	0	0
10	43072843	.	A	G	1	2	3	0	0	3	0	0
10	43117721	.	A	G	1	3	4	0	1	5	0	0
10	43117724	.	C	T	2	3	5	0	0	5	0	0
10	43126994	.	T	C	2	5	7	0	0	7	0	0
10	43127066	.	T	G	5	0	5	0	3	8	0	0
10	43149237	.	A	G	3	0	3	0	5	8	0	0
10	43151516	.	G	A	0	4	4	0	2	6	0	0
10	43157401	.	C	G	8	5	13	0	0	13	0	0
10	43183798	.	A	T	2	2	4	0	0	4	0	0
10	43231345	.	T	C	1	2	3	0	0	3	0	0
10	43232048	.	G	A	1	3	4	0	0	4	0	0
10	43232065	.	A	T	1	4	5	0	0	5	0	0
10	43232158	.	G	A	1	2	3	0	6	9	0	0
10	43232170	.	T	C	7	2	9	0	0	9	0	0
10	43232434	.	A	T	1	3	4	0	0	4	0	0
10	43232452	.	T	C	1	2	3	0	0	3	0	0
10	43232470	.	G	C	1	3	4	0	0	4	0	0
10	43294835	.	G	T	1	1	2	0	1	3	0	0
10	43365046	.	A	G	6	9	15	0	0	15	0	0
10	43372035	.	A	G	6	4	10	0	1	11	0	0
10	43372466	.	C	T	7	7	14	0	0	14	0	0
10	43372493	.	G	A	6	7	13	0	1	14	0	0
10	43375468	.	G	A	6	3	9	0	0	9	0	0
10	43545284	.	A	C	4	6	10	0	0	10	0	0
10	43545288	.	C	T	2	6	8	0	0	8	0	0
10	43545434	.	G	C	13	5	18	0	0	18	0	0
10	43545475	.	A	C	7	13	20	0	0	20	0	0
10	43545577	.	C	A	0	7	7	0	8	15	0	0
10	43545681	.	C	T	10	7	17	0	0	17	0	0
10	43545747	.	A	G	4	5	9	0	1	10	0	0
10	43545757	.	C	T	0	0	0	0	9	9	0	0
10	43546062	.	C	T	6	3	9	0	0	9	0	0
10	43547905	.	G	A	3	4	7	0	0	7	0	0
10	43547937	.	A	G	4	4	8	0	0	8	0	0
10	43547972	.	T	C	2	0	2	0	6	8	0	0
10	43548194	.	C	A	5	6	11	0	0	11	0	0
10	43548195	.	C	A	5	6	11	0	0	11	0	0
10	43548301	.	A	G	4	5	9	0	0	9	0	0
10	43548495	.	C	T	5	4	9	0	0	9	0	0
10	43548517	.	G	A	3	2	5	0	1	6	0	0
10	43548671	.	T	C	5	0	5	0	3	8	0	0
10	43549062	.	G	T	6	5	11	0	0	11	0	0
10	43549393	.	C	T	7	2	9	0	0	9	0	0
10	43549403	.	T	C	4	3	7	0	1	8	0	0
10	43549559	.	G	C	7	8	15	0	0	15	0	0
10	43549734	.	A	C	5	7	12	0	0	12	0	0
10	43549744	.	T	A	4	7	11	0	1	12	0	0
10	43549782	.	G	A	7	7	14	0	0	14	0	0
10	43549798	.	G	A	6	6	12	0	0	12	0	0
10	43550123	.	G	A	6	4	10	0	0	10	0	0
10	43550156	.	G	C	3	4	7	0	1	8	0	0
10	43568222	.	G	A	5	2	7	0	0	7	0	0
10	43709042	.	A	T	2	4	6	0	0	6	0	0
10	43709084	.	T	C	7	4	11	0	0	11	0	0
10	43709085	.	G	C	7	4	11	0	0	11	0	0
10	43709204	.	A	G	7	11	18	0	0	18	0	0
10	43711059	.	T	A	17	11	28	0	0	28	0	0
10	43715981	.	G	A	20	18	38	0	0	38	0	0
10	43721415	.	C	T	14	12	26	0	2	28	0	0
10	43761719	.	T	A	3	3	6	0	2	8	0	0
10	43761755	.	A	G	7	7	14	0	1	15	0	0
10	43761996	.	G	A	5	8	13	0	0	13	0	0
10	43762021	.	C	T	6	6	12	0	0	12	0	0
10	43762142	.	C	T	0	2	2	0	3	5	0	0
10	43762519	.	A	G	5	7	12	0	0	12	0	0
10	43762654	.	A	G	8	12	20	0	1	21	0	0
10	43762717	.	A	G	10	10	20	0	0	20	0	0
10	43762755	.	A	C	11	9	20	1	0	21	0	0
10	43765291	.	G	C	5	5	10	0	0	10	0	0
10	43766589	.	T	C	4	0	4	0	3	7	0	0
10	43766688	.	T	G	6	6	12	0	0	12	0	0
10	43766733	.	G	A	5	9	14	0	0	14	0	0
10	43766817	.	A	C	7	2	9	0	10	19	0	0
10	43771238	.	G	A	3	3	6	0	1	7	0	0
10	43771302	.	G	A	1	3	4	0	1	5	0	0
10	43807253	.	A	G	3	2	5	0	0	5	0	0
10	43863512	.	G	A	2	2	4	0	0	4	0	0
10	43863837	.	C	T	2	2	4	0	0	4	0	0
10	43863846	.	G	A	2	3	5	0	0	5	0	0
10	43864312	.	C	T	0	5	5	0	2	7	0	0
10	43865118	.	G	A	1	2	3	0	0	3	0	0
10	43928632	.	C	A	0	2	2	0	1	3	0	0
10	43936313	.	A	T	13	14	27	0	4	31	0	0
10	43937850	.	A	G	13	16	29	0	0	29	0	0
10	43950092	.	T	G	10	10	20	0	0	20	0	0
10	43958439	.	A	C	6	12	18	0	2	20	0	0
10	43964021	.	C	A	0	3	3	0	4	7	0	0
10	43999328	.	G	A	1	3	4	0	0	4	0	0
10	43999511	.	T	C	3	2	5	0	0	5	0	0
10	44010073	.	C	T	0	7	7	0	5	12	0	0
10	44011744	.	A	G	8	5	13	0	0	13	0	0
10	44057415	.	C	A	4	5	9	0	4	13	0	0
10	44134118	.	A	G	10	0	10	0	11	21	0	0
10	44137259	.	G	A	2	5	7	0	14	21	0	0
10	44155446	.	G	C	4	17	21	0	11	32	0	0
10	44176257	.	C	T	18	11	29	0	0	29	0	0
10	44180320	.	C	T	16	12	28	0	2	30	0	0
10	44189322	.	G	T	20	10	30	0	0	30	0	0
10	44297245	.	G	T	7	6	13	0	5	18	0	0
10	44314569	.	C	T	7	12	19	0	0	19	0	0
10	44314579	.	A	G	11	8	19	0	2	21	0	0
10	44320823	.	G	C	6	9	15	0	0	15	0	0
10	44337487	.	C	G	5	3	8	0	1	9	0	0
10	44337652	.	G	T	4	5	9	0	1	10	0	0
10	44337710	.	G	A	2	4	6	0	1	7	0	0
10	44340944	.	C	T	5	10	15	0	0	15	0	0
10	44345005	.	C	T	0	4	4	0	9	13	0	0
10	44346449	.	T	C	3	0	3	0	5	8	0	0
10	44353914	.	G	A	5	4	9	0	0	9	0	0
10	44354053	.	G	C	2	5	7	0	0	7	0	0
10	44363242	.	G	T	10	9	19	0	1	20	0	0
10	44364604	.	A	T	10	7	17	0	2	19	0	0
10	44364610	.	C	T	13	7	20	0	2	22	0	0
10	44371710	.	G	T	2	13	15	0	13	28	0	0
10	44373367	.	T	C	5	5	10	0	0	10	0	0
10	44375738	.	T	G	4	0	4	0	4	8	0	0
10	44375785	.	G	A	1	6	7	0	3	10	0	0
10	44377942	.	G	C	11	8	19	1	4	24	0	0
10	44409402	.	C	G	3	2	5	0	2	7	0	0
10	44410082	.	C	T	14	4	18	0	0	18	0	0
10	44410088	.	G	A	4	13	17	0	0	17	0	0
10	44410241	.	G	A	6	6	12	0	0	12	0	0
10	44410975	.	T	C	1	6	7	0	0	7	0	0
10	44437145	.	T	C	12	17	29	0	2	31	0	0
10	44465477	.	C	T	1	3	4	0	3	7	0	0
10	44466844	.	G	A	5	8	13	0	0	13	0	0
10	44503882	.	G	A	11	9	20	0	0	20	0	0
10	44506313	.	C	T	0	3	3	0	8	11	0	0
10	44513232	.	T	C	1	4	5	0	0	5	0	0
10	44513270	.	T	C	2	0	2	0	5	8	1	0
10	44513307	.	T	C	3	7	10	0	0	10	0	0
10	44513402	.	T	C	4	0	4	0	5	9	0	0
10	44513421	.	C	T	0	4	4	0	4	8	0	0
10	44516270	.	G	T	2	2	4	0	1	5	0	0
10	44516535	.	A	T	4	4	8	0	0	8	0	0
10	44516559	.	T	C	4	0	4	0	3	7	0	0
10	44516907	.	G	T	3	3	6	0	0	6	0	0
10	44516908	.	T	C	4	0	4	0	3	7	0	0
10	44516955	.	C	T	7	4	11	0	0	11	0	0
10	44640688	.	A	C	8	13	21	0	7	28	0	0
10	44640700	.	C	T	14	13	27	0	2	29	0	0
10	44640832	.	G	A	10	7	17	0	0	17	0	0
10	44640843	.	T	C	5	10	15	0	0	15	0	0
10	44640873	.	G	A	7	8	15	0	0	15	0	0
10	44640965	.	G	A	15	5	20	0	0	20	0	0
10	44641025	.	G	A	6	10	16	0	2	18	0	0
10	44648115	.	G	T	0	8	8	0	6	14	0	0
10	44648627	.	C	T	11	11	22	0	0	22	0	0
10	44648746	.	T	A	5	7	12	0	0	12	0	0
10	44650913	.	G	A	2	12	14	0	10	24	0	0
10	44652510	.	C	T	9	9	18	0	0	18	0	0
10	44652561	.	G	A	0	5	5	0	18	23	0	0
10	44656821	.	C	G	10	10	20	0	0	20	0	0
10	44656905	.	G	A	14	7	21	0	1	22	0	0
10	44663025	.	C	T	12	17	29	0	1	30	0	0
10	44663082	.	A	G	21	14	35	0	0	35	0	0
10	44663109	.	A	G	18	16	34	0	0	34	0	0
10	44665345	.	G	T	0	7	7	0	9	16	0	0
10	44665536	.	A	T	10	8	18	0	0	18	0	0
10	44665620	.	C	T	14	9	23	0	2	25	0	0
10	44669263	.	G	A	12	14	26	0	2	28	0	0
10	44669660	.	G	A	8	11	19	0	0	19	0	0
10	44669668	.	C	A	10	11	21	0	0	21	0	0
10	44669779	.	A	G	14	0	14	0	21	35	0	0
10	44669825	.	T	G	12	13	25	0	0	25	0	0
10	44669937	.	G	A	6	6	12	0	0	12	0	0
10	44670081	.	A	T	6	4	10	0	0	10	0	0
10	44670437	.	A	G	14	10	24	2	3	29	0	0
10	44670894	.	C	T	8	21	29	0	0	29	0	0
10	44670923	.	T	C	8	15	23	0	0	23	0	0
10	44671818	.	A	C	16	11	27	0	1	28	0	0
10	44672009	.	T	A	22	16	38	0	3	41	0	0
10	44672036	.	T	A	19	22	41	0	1	42	0	0
10	44692308	.	A	T	11	12	23	0	1	24	0	0
10	44692314	.	C	A	14	16	30	0	2	32	0	0
10	44693523	.	T	G	35	1	36	3	25	64	0	0
10	44693556	.	C	T	15	14	29	10	2	41	0	0
10	44693769	.	C	T	36	19	55	33	16	104	0	0
10	44693799	.	T	C	30	8	38	66	2	106	0	0
10	44693868	.	G	A	39	10	49	12	2	63	0	0
10	44694162	.	T	C	15	24	39	6	4	49	0	0
10	44694354	.	G	A	56	17	73	8	4	85	0	0
10	44738221	.	G	A	1	6	7	0	2	9	0	0
10	44738290	.	C	T	6	3	9	0	0	9	0	0
10	44746456	.	A	T	1	2	3	0	0	3	0	0
10	44898957	.	A	G	2	0	2	0	4	6	0	0
10	44900254	.	G	A	2	3	5	0	0	5	0	0
10	44900856	.	C	T	2	5	7	0	0	7	0	0
10	44900901	.	T	G	5	2	7	0	0	7	0	0
10	44914623	.	A	G	15	0	15	0	5	20	0	0
10	44914685	.	G	T	8	10	18	0	2	20	0	0
10	44914761	.	T	A	5	9	14	0	0	15	1	0
10	44979593	.	A	T	4	8	12	0	1	13	0	0
10	44979767	.	A	G	2	3	5	0	0	5	0	0
10	44979792	.	T	C	4	3	7	0	1	8	0	0
10	44980379	.	T	C	5	2	7	0	0	7	0	0
10	44980391	.	C	T	3	7	10	0	0	10	0	0
10	44980913	.	C	T	7	7	14	0	1	15	0	0
10	44989378	.	C	T	27	20	47	0	1	48	0	0
10	44989384	.	T	C	25	22	47	0	2	49	0	0
10	44990917	.	C	T	22	21	43	0	1	44	0	0
10	45045896	.	C	T	2	3	5	0	0	5	0	0
10	45055879	.	G	A	11	10	21	0	0	21	0	0
10	45055948	.	G	A	10	7	17	0	2	19	0	0
10	45059822	.	C	T	6	13	19	0	0	19	0	0
10	45064957	.	C	T	15	14	29	0	1	30	0	0
10	45085679	.	C	T	6	6	12	0	0	12	0	0
10	45089826	.	A	G	7	0	7	0	3	10	0	0
10	45099498	.	T	C	10	7	17	0	2	19	0	0
10	45099522	.	T	C	11	8	19	0	0	19	0	0
10	45101543	.	G	A	0	6	6	0	5	11	0	0
10	45103519	.	C	T	7	5	12	0	1	13	0	0
10	45105244	.	T	C	10	7	17	0	1	18	0	0
10	45175496	.	G	A	2	3	5	0	0	5	0	0
10	45180335	.	C	T	1	2	3	0	0	3	0	0
10	45187450	.	T	C	3	3	6	0	0	6	0	0
10	45189611	.	C	G	1	3	4	0	0	4	0	0
10	45190629	.	C	T	4	4	8	0	0	8	0	0
10	45203109	.	T	C	7	8	15	0	1	16	0	0
10	45203154	.	A	G	8	7	15	0	2	17	0	0
10	45203271	.	T	A	4	7	11	0	0	11	0	0
10	45203385	.	T	A	6	2	8	0	0	8	0	0
10	45203645	.	A	G	1	4	5	0	0	5	0	0
10	45203646	.	A	G	1	3	4	0	1	5	0	0
10	45203700	.	A	C	2	6	8	0	1	9	0	0
10	45203704	.	T	G	2	6	8	0	0	8	0	0
10	45203793	.	G	A	2	6	8	0	6	14	0	0
10	45203856	.	G	A	8	5	13	1	0	14	0	0
10	45203882	.	A	G	9	4	13	0	2	15	0	0
10	45204024	.	A	G	5	4	9	0	0	9	0	0
10	45204029	.	A	T	4	6	10	0	0	10	0	0
10	45204151	.	A	G	4	2	6	0	1	7	0	0
10	45204185	.	T	C	5	3	8	0	0	8	0	0
10	45204218	.	A	G	2	0	2	0	3	5	0	0
10	45204527	.	A	G	4	5	9	0	0	9	0	0
10	45204568	.	G	T	3	4	7	0	0	7	0	0
10	45204621	.	T	C	5	3	8	0	0	8	0	0
10	45204786	.	A	C	1	3	4	0	0	4	0	0
10	45205166	.	A	C	9	8	17	2	2	21	0	0
10	45205175	.	A	G	8	1	9	1	8	18	0	0
10	45205226	.	A	G	5	0	5	0	6	11	0	0
10	45205237	.	C	G	5	0	5	0	7	12	0	0
10	45205284	.	A	C	8	6	14	0	1	15	0	0
10	45205295	.	A	G	7	0	7	0	8	15	0	0
10	45205400	.	C	A	4	9	13	0	1	14	0	0
10	45205757	.	C	A	1	2	3	0	0	3	0	0
10	45205758	.	A	G	1	2	3	0	0	3	0	0
10	45206103	.	C	G	5	5	10	0	0	11	1	0
10	45206289	.	G	C	9	0	9	0	4	13	0	0
10	45206450	.	T	C	7	0	7	0	15	22	0	0
10	45206478	.	G	T	15	6	21	0	0	21	0	0
10	45208153	.	A	G	5	7	12	0	1	13	0	0
10	45208667	.	C	T	0	5	5	0	6	11	0	0
10	45208875	.	G	A	5	8	13	0	2	15	0	0
10	45208899	.	C	A	6	7	13	0	0	13	0	0
10	45213798	.	C	T	0	6	6	0	7	13	0	0
10	45222613	.	T	C	2	0	2	0	7	9	0	0
10	45248527	.	A	C	5	6	11	0	1	12	0	0
10	45248638	.	G	A	6	9	15	0	0	15	0	0
10	45313560	.	C	T	6	11	17	0	0	17	0	0
10	45313623	.	G	A	0	6	6	0	7	13	0	0
10	45313671	.	C	T	7	7	14	0	1	15	0	0
10	45322668	.	A	G	8	0	8	0	14	22	0	0
10	45325302	.	G	A	1	8	9	0	8	17	0	0
10	45334688	.	C	T	6	6	12	0	1	13	0	0
10	45336565	.	T	C	8	13	21	0	0	21	0	0
10	45340105	.	G	T	0	5	5	0	10	15	0	0
10	45340625	.	A	C	2	3	5	4	0	9	0	0
10	45340654	.	A	G	6	5	11	1	0	12	0	0
10	45340835	.	G	C	7	11	18	0	0	18	0	0
10	45340930	.	G	T	3	12	15	0	0	15	0	0
10	45341210	.	T	A	4	3	7	0	0	7	0	0
10	45341403	.	A	G	4	9	13	0	0	13	0	0
10	45341410	.	A	G	3	0	3	0	11	14	0	0
10	45341452	.	T	G	5	8	13	0	1	14	0	0
10	45341537	.	A	C	11	9	20	0	0	20	0	0
10	45341546	.	A	C	9	10	19	0	1	20	0	0
10	45341572	.	G	C	0	10	10	0	15	25	0	0
10	45341596	.	C	T	11	7	18	0	0	18	0	0
10	45341762	.	A	T	5	5	10	1	0	11	0	0
10	45349924	.	G	A	41	36	77	1	4	82	0	0
10	45351037	.	C	T	49	31	80	1	2	83	0	0
10	45352231	.	C	T	17	13	30	0	10	40	0	0
10	45375714	.	G	T	19	16	35	0	0	35	0	0
10	45375732	.	C	T	17	12	29	0	2	31	0	0
11	71435	.	G	T	5	3	8	1	1	10	0	0
11	126334	.	G	A	17	20	37	0	1	38	0	0
11	126595	.	A	T	16	21	37	0	7	44	0	0
11	155176	.	C	T	2	3	5	0	0	5	0	0
11	158688	.	C	T	4	5	9	0	0	9	0	0
11	185396	.	C	T	0	3	3	0	2	5	0	0
11	185624	.	T	A	18	18	36	0	0	36	0	0
11	185678	.	G	A	8	11	19	0	2	21	0	0
11	185775	.	C	T	0	18	18	0	15	33	0	0
11	185890	.	A	G	13	19	32	0	0	32	0	0
11	185902	.	A	G	16	18	34	0	0	34	0	0
11	186235	.	G	A	13	9	22	0	0	22	0	0
11	186526	.	A	T	6	4	10	0	0	10	0	0
11	186580	.	G	A	9	5	14	0	1	15	0	0
11	186745	.	G	T	9	13	22	0	1	23	0	0
11	186798	.	T	G	9	11	20	0	2	22	0	0
11	186939	.	A	G	14	14	28	0	4	32	0	0
11	187022	.	C	A	17	14	31	0	0	31	0	0
11	187104	.	T	A	18	18	36	0	0	36	0	0
11	187399	.	A	C	9	15	24	0	1	25	0	0
11	221929	.	T	C	19	0	19	0	11	30	0	0
11	222488	.	C	G	7	7	14	0	1	15	0	0
11	222722	.	C	T	0	5	5	0	13	19	1	0
11	222729	.	C	T	1	6	7	0	14	21	0	0
11	222776	.	C	T	13	9	22	0	1	23	0	0
11	222787	.	A	G	11	9	20	0	0	20	0	0
11	223101	.	G	A	6	10	16	0	1	17	0	0
11	223174	.	A	G	12	6	18	1	0	19	0	0
11	223176	.	G	A	16	2	18	1	0	19	0	0
11	223319	.	G	A	8	10	18	0	0	18	0	0
11	223806	.	A	G	13	18	31	0	0	31	0	0
11	233672	.	A	T	7	9	16	0	1	17	0	0
11	233674	.	G	A	6	8	14	0	2	16	0	0
11	236437	.	C	T	8	9	17	0	0	17	0	0
11	236515	.	T	C	5	6	11	0	2	13	0	0
11	236551	.	G	A	8	6	14	0	1	15	0	0
11	236602	.	A	C	7	0	7	0	4	11	0	0
11	260909	.	G	A	14	7	21	0	2	23	0	0
11	265097	.	T	G	21	16	37	0	0	37	0	0
11	265404	.	G	A	18	14	32	0	0	32	0	0
11	265497	.	C	T	2	17	19	0	14	33	0	0
11	265506	.	G	C	11	20	31	0	0	32	1	0
11	268887	.	G	A	12	6	18	0	1	19	0	0
11	270090	.	A	G	10	17	27	0	1	28	0	0
11	281887	.	A	T	2	6	8	0	0	8	0	0
11	281961	.	A	G	4	5	9	0	0	9	0	0
11	282193	.	T	G	3	10	13	0	1	14	0	0
11	282279	.	A	T	5	11	16	0	0	16	0	0
11	282546	.	G	T	7	8	15	0	0	15	0	0
11	282553	.	A	G	7	8	15	0	0	15	0	0
11	282602	.	T	G	10	8	18	0	1	19	0	0
11	284424	.	G	T	7	11	18	0	0	18	0	0
11	322076	.	G	A	2	8	10	0	6	16	0	0
11	675382	.	G	C	37	15	52	0	1	53	0	0
11	676856	.	T	C	31	19	50	0	7	57	0	0
11	677100	.	A	G	5	18	23	0	2	25	0	0
11	677264	.	T	C	26	25	51	0	10	61	0	0
11	677341	.	T	C	22	23	45	0	2	47	0	0
11	682905	.	C	T	33	19	52	0	3	55	0	0
11	682926	.	A	G	33	15	48	0	2	50	0	0
11	682943	.	G	A	31	12	43	0	4	47	0	0
11	687501	.	G	A	28	19	47	2	2	51	0	0
11	718214	.	G	A	15	19	34	0	1	35	0	0
11	718404	.	A	C	11	5	16	0	0	16	0	0
11	718454	.	A	G	5	11	16	1	0	17	0	0
11	718721	.	A	T	3	2	5	0	0	5	0	0
11	762445	.	A	G	9	12	21	0	8	29	0	0
11	779785	.	C	A	3	8	11	0	1	12	0	0
11	779863	.	T	A	3	3	6	0	0	6	0	0
11	780405	.	T	A	5	4	9	0	0	9	0	0
11	781714	.	G	A	0	2	2	0	4	6	0	0
11	813851	.	T	C	1	0	1	0	11	12	0	0
11	814073	.	A	G	1	6	7	0	0	7	0	0
11	1083008	.	G	A	2	3	5	0	0	5	0	0
11	1083017	.	T	A	2	3	5	0	0	5	0	0
11	1095064	.	G	A	15	13	28	0	0	28	0	0
11	1099702	.	G	T	8	4	12	0	0	12	0	0
11	1148869	.	G	A	16	19	35	0	1	36	0	0
11	1148889	.	G	A	18	16	34	0	2	36	0	0
11	1149105	.	C	T	23	22	45	0	1	46	0	0
11	1149593	.	A	G	31	14	45	4	3	52	0	0
11	1149812	.	C	T	5	22	27	1	36	64	0	0
11	1163295	.	C	T	35	34	69	0	0	69	0	0
11	1165993	.	G	A	35	29	64	0	2	66	0	0
11	1166326	.	G	C	21	1	22	0	25	47	0	0
11	1177389	.	C	A	5	21	26	0	22	48	0	0
11	1183007	.	G	A	28	14	42	0	2	44	0	0
11	1183602	.	C	T	3	22	25	0	30	55	0	0
11	1183739	.	G	T	21	18	39	0	2	41	0	0
11	1198390	.	G	C	22	24	46	0	2	48	0	0
11	1198419	.	G	A	26	22	48	0	2	50	0	0
11	1198450	.	G	A	26	18	44	0	2	46	0	0
11	1198507	.	G	T	28	18	46	0	2	48	0	0
11	1203619	.	G	A	19	20	39	0	0	39	0	0
11	1221865	.	A	G	20	24	44	0	0	44	0	0
11	1222025	.	T	G	21	19	40	0	1	41	0	0
11	1337621	.	C	G	2	2	4	0	0	4	0	0
11	1339419	.	C	T	0	7	7	0	3	10	0	0
11	1341402	.	C	T	0	5	5	0	8	13	0	0
11	1342778	.	G	A	4	5	9	0	0	9	0	0
11	1342826	.	A	G	6	8	14	0	0	14	0	0
11	1348596	.	A	G	5	12	17	0	1	18	0	0
11	1348821	.	A	C	5	10	15	0	1	16	0	0
11	1351563	.	T	G	6	2	8	0	1	9	0	0
11	1351611	.	A	G	3	3	6	0	0	6	0	0
11	1356637	.	A	G	6	5	11	0	0	11	0	0
11	1356640	.	A	G	5	5	10	0	0	10	0	0
11	1359391	.	G	T	4	2	6	0	0	6	0	0
11	1365078	.	T	C	10	4	14	0	0	14	0	0
11	1366800	.	T	A	2	3	5	0	0	5	0	0
11	1368265	.	G	A	3	5	8	0	0	8	0	0
11	1389850	.	C	T	0	5	5	0	4	9	0	0
11	1391141	.	G	C	2	0	2	0	8	10	0	0
11	1396343	.	T	C	19	16	35	0	4	39	0	0
11	1400624	.	G	A	1	2	3	0	0	3	0	0
11	1400632	.	G	A	2	1	3	0	0	3	0	0
11	1403797	.	T	C	6	1	7	0	8	15	0	0
11	1403821	.	A	C	6	7	13	0	0	13	0	0
11	1403921	.	A	C	5	2	7	0	0	7	0	0
11	1404031	.	A	C	5	5	10	0	0	10	0	0
11	1404165	.	C	T	3	3	6	0	0	6	0	0
11	1404481	.	C	A	5	4	9	0	2	11	0	0
11	1404640	.	T	C	7	0	7	0	4	11	0	0
11	1404642	.	A	G	8	3	11	0	0	11	0	0
11	1407178	.	A	C	1	4	5	0	0	5	0	0
11	1408791	.	G	T	4	2	6	0	0	6	0	0
11	1408802	.	G	T	4	2	6	0	0	6	0	0
11	1409157	.	T	C	2	5	7	0	0	7	0	0
11	1409162	.	G	A	2	4	6	0	0	6	0	0
11	1427981	.	T	C	11	0	11	0	11	22	0	0
11	1435736	.	A	G	6	4	10	0	0	10	0	0
11	1467114	.	T	C	8	1	9	0	18	28	1	0
11	1467130	.	C	A	0	16	16	0	11	27	0	0
11	1469842	.	C	T	8	12	20	0	1	21	0	0
11	1469859	.	A	G	10	14	24	0	1	25	0	0
11	1469895	.	A	G	6	13	19	0	1	20	0	0
11	1470503	.	G	A	8	11	19	0	1	20	0	0
11	1470535	.	G	C	9	12	21	0	0	21	0	0
11	1474629	.	C	T	14	5	19	0	0	19	0	0
11	1512626	.	A	G	3	5	8	0	0	8	0	0
11	1512660	.	A	T	4	5	9	0	0	9	0	0
11	1512684	.	A	T	4	2	6	0	0	6	0	0
11	1512947	.	T	C	2	4	6	0	0	6	0	0
11	1512950	.	A	C	2	3	5	0	0	5	0	0
11	1516755	.	T	G	5	4	9	0	0	9	0	0
11	1517289	.	C	A	5	8	13	0	0	13	0	0
11	1520436	.	A	G	3	4	7	0	0	7	0	0
11	1520512	.	A	G	1	2	3	0	0	3	0	0
11	1520583	.	A	C	4	4	8	0	0	8	0	0
11	1522194	.	C	G	16	0	16	0	23	39	0	0
11	1522205	.	G	T	19	22	41	0	0	41	0	0
11	1522291	.	T	C	13	13	26	0	1	27	0	0
11	1523846	.	T	C	3	6	9	0	1	10	0	0
11	1523912	.	T	C	4	3	7	0	0	7	0	0
11	1524079	.	T	C	6	10	16	0	1	17	0	0
11	1524108	.	C	T	5	10	15	0	0	15	0	0
11	1525081	.	G	C	8	12	20	0	0	20	0	0
11	1525389	.	G	T	14	28	42	2	0	44	0	0
11	1525416	.	T	A	18	27	45	0	3	48	0	0
11	1526749	.	A	G	20	16	36	0	1	37	0	0
11	1529260	.	A	G	19	19	38	0	0	38	0	0
11	1529526	.	G	A	18	13	31	0	0	31	0	0
11	1529743	.	G	A	20	16	36	0	0	36	0	0
11	1529789	.	A	C	19	12	31	0	1	32	0	0
11	1529796	.	A	T	17	12	29	0	2	31	0	0
11	1529838	.	A	G	15	4	19	0	3	22	0	0
11	1530027	.	G	A	9	7	16	0	1	17	0	0
11	1530295	.	A	C	16	20	36	0	1	37	0	0
11	1530363	.	A	G	10	19	29	0	1	30	0	0
11	1530489	.	A	G	17	0	17	0	19	36	0	0
11	1530541	.	A	G	13	19	32	0	1	33	0	0
11	1530584	.	G	A	0	13	13	0	17	30	0	0
11	1530593	.	G	T	16	14	30	0	0	30	0	0
11	1530642	.	G	A	10	11	21	0	0	21	0	0
11	1535427	.	C	A	7	7	14	0	0	14	0	0
11	1535471	.	T	C	2	5	7	0	0	7	0	0
11	1535877	.	G	A	2	6	8	0	1	9	0	0
11	1542605	.	A	G	9	0	9	0	6	15	0	0
11	1543974	.	A	G	10	6	16	0	0	16	0	0
11	1628608	.	A	T	2	2	4	0	0	4	0	0
11	1701929	.	C	T	5	4	9	0	0	9	0	0
11	1732124	.	T	C	2	3	5	0	0	5	0	0
11	1741883	.	C	T	2	4	6	0	0	6	0	0
11	1745796	.	T	G	1	0	1	0	5	6	0	0
11	1751589	.	T	A	6	3	9	0	0	9	0	0
11	1754419	.	G	C	2	4	6	0	0	6	0	0
11	1754548	.	T	G	3	1	4	0	5	9	0	0
11	1764225	.	C	T	1	2	3	0	0	3	0	0
11	1764291	.	C	T	5	5	10	0	0	10	0	0
11	1764381	.	C	T	3	2	5	0	0	5	0	0
11	1764415	.	A	G	5	4	9	0	0	9	0	0
11	1764731	.	C	T	5	3	8	0	0	8	0	0
11	1764776	.	T	C	6	4	10	0	1	11	0	0
11	1767448	.	A	G	5	4	9	0	0	9	0	0
11	1769188	.	A	G	3	0	3	0	4	7	0	0
11	1769218	.	C	A	3	7	10	0	0	10	0	0
11	1771294	.	T	C	5	3	8	0	0	8	0	0
11	1771741	.	C	A	6	6	12	0	0	12	0	0
11	1773801	.	C	T	4	4	8	0	1	9	0	0
11	1776672	.	G	A	3	7	10	0	2	12	0	0
11	1786312	.	C	T	4	4	8	0	1	9	0	0
11	1796482	.	C	T	3	3	6	0	0	6	0	0
11	1796835	.	C	T	5	8	13	0	0	13	0	0
11	1799763	.	G	A	1	3	4	0	5	9	0	0
11	1799778	.	C	T	7	4	11	0	0	11	0	0
11	1799838	.	C	T	8	8	16	0	0	16	0	0
11	1805726	.	G	T	1	8	9	0	3	12	0	0
11	1810104	.	C	T	10	4	14	0	0	14	0	0
11	1812288	.	A	G	7	1	8	0	6	14	0	0
11	1812951	.	T	A	4	7	11	0	0	11	0	0
11	1812961	.	C	T	7	3	10	0	0	10	0	0
11	1813240	.	A	G	15	10	25	0	1	26	0	0
11	1815978	.	C	T	13	7	20	0	0	20	0	0
11	1818005	.	C	T	8	11	19	0	1	20	0	0
11	1823329	.	T	G	10	0	10	0	12	22	0	0
11	1829952	.	C	T	8	6	14	0	0	14	0	0
11	1830621	.	T	C	8	10	18	0	1	19	0	0
11	1834124	.	T	C	7	11	18	0	3	21	0	0
11	1836100	.	C	A	12	13	25	0	2	27	0	0
11	1836995	.	C	G	8	1	9	0	21	30	0	0
11	1838725	.	G	C	0	16	16	0	16	32	0	0
11	1841961	.	G	C	11	14	25	0	2	27	0	0
11	1843339	.	G	T	8	16	24	0	1	25	0	0
11	1843771	.	C	A	24	14	38	0	0	38	0	0
11	1863846	.	T	G	16	19	35	0	4	39	0	0
11	1864095	.	C	A	21	17	38	0	2	40	0	0
11	1864216	.	C	T	15	12	27	0	0	27	0	0
11	1919016	.	T	A	2	3	5	0	0	5	0	0
11	1919054	.	T	G	9	0	9	0	3	12	0	0
11	1919963	.	T	G	3	0	3	0	3	6	0	0
11	1920009	.	C	T	1	2	3	0	0	3	0	0
11	1920069	.	A	T	2	3	5	0	0	5	0	0
11	1945034	.	T	A	15	15	30	0	1	31	0	0
11	1945036	.	C	T	16	15	31	0	1	32	0	0
11	1945229	.	C	T	17	16	33	0	0	33	0	0
11	1947965	.	A	G	6	4	10	0	0	10	0	0
11	1948373	.	A	T	12	9	21	0	0	21	0	0
11	1967076	.	C	A	13	13	26	0	0	26	0	0
11	1967111	.	T	A	14	13	27	0	0	27	0	0
11	1967187	.	T	C	9	5	14	1	0	15	0	0
11	2112267	.	C	T	1	2	3	0	0	3	0	0
11	2217862	.	G	A	2	2	4	0	0	4	0	0
11	2240120	.	A	C	16	10	26	0	2	28	0	0
11	2249884	.	A	G	30	28	58	0	5	63	0	0
11	2249920	.	C	T	29	28	57	0	7	64	0	0
11	2254346	.	T	C	11	2	13	0	0	13	0	0
11	2255025	.	T	G	5	7	12	0	0	12	0	0
11	2255027	.	T	G	5	7	12	0	0	12	0	0
11	2263484	.	T	G	4	6	10	0	0	10	0	0
11	2267377	.	A	G	5	3	8	0	0	8	0	0
11	2290246	.	T	C	2	10	12	0	0	12	0	0
11	2292997	.	G	A	4	10	14	0	0	14	0	0
11	2295604	.	A	G	7	4	11	0	0	11	0	0
11	2440690	.	T	A	1	2	3	0	0	3	0	0
11	2458371	.	T	G	5	7	12	0	0	12	0	0
11	2462623	.	T	C	2	3	5	0	0	5	0	0
11	2462625	.	C	A	2	3	5	0	0	5	0	0
11	2462791	.	A	G	8	4	12	0	1	13	0	0
11	2462830	.	A	G	4	2	6	0	0	6	0	0
11	2462831	.	G	A	4	2	6	0	0	6	0	0
11	2506878	.	C	T	7	3	10	0	0	10	0	0
11	2507001	.	G	A	0	4	4	0	10	14	0	0
11	2507539	.	C	T	4	8	12	0	0	12	0	0
11	2541635	.	A	G	1	2	3	0	0	3	0	0
11	2542391	.	C	T	5	5	10	0	0	10	0	0
11	2543188	.	A	C	4	1	5	0	2	7	0	0
11	2545012	.	C	T	0	7	7	0	3	10	0	0
11	2545018	.	A	G	6	3	9	0	1	10	0	0
11	2545462	.	C	G	4	3	7	0	0	7	0	0
11	2545487	.	G	A	4	3	7	0	0	7	0	0
11	2566191	.	C	T	1	4	5	0	0	5	0	0
11	2571562	.	T	A	4	3	7	0	0	7	0	0
11	2571635	.	A	G	7	6	13	0	0	13	0	0
11	2571685	.	C	A	7	2	9	0	0	9	0	0
11	2571686	.	A	T	6	2	8	0	0	8	0	0
11	2576843	.	T	C	4	0	4	0	8	12	0	0
11	2576876	.	C	T	4	4	8	0	2	10	0	0
11	2584328	.	C	T	0	5	5	0	8	13	0	0
11	2585371	.	T	C	9	5	14	0	0	14	0	0
11	2587205	.	T	C	7	5	12	0	0	12	0	0
11	2587664	.	T	C	4	0	4	0	3	7	0	0
11	2587928	.	A	T	7	6	13	0	0	13	0	0
11	2593620	.	T	A	3	4	7	0	1	8	0	0
11	2593645	.	T	G	2	2	4	0	1	5	0	0
11	2593659	.	A	T	1	3	4	0	1	5	0	0
11	2597009	.	G	A	4	3	7	0	0	7	0	0
11	2597028	.	T	G	3	0	3	0	3	6	0	0
11	2601114	.	T	A	4	3	7	0	0	7	0	0
11	2601202	.	T	A	3	2	5	0	0	5	0	0
11	2601792	.	C	T	1	3	4	0	0	4	0	0
11	2601803	.	A	G	1	4	5	0	0	5	0	0
11	2603052	.	C	T	4	2	6	0	0	6	0	0
11	2603073	.	G	T	3	3	6	0	0	6	0	0
11	2605981	.	A	G	3	5	8	0	0	8	0	0
11	2615588	.	A	G	4	3	7	1	0	8	0	0
11	2616956	.	T	C	8	9	17	0	0	17	0	0
11	2617031	.	T	A	11	15	26	2	0	28	0	0
11	2617072	.	A	G	6	7	13	2	1	16	0	0
11	2618036	.	A	G	10	4	14	0	0	14	0	0
11	2618114	.	C	A	10	2	12	0	0	12	0	0
11	2618653	.	C	A	11	6	17	0	0	17	0	0
11	2619089	.	G	A	15	8	23	0	0	23	0	0
11	2619129	.	C	A	11	8	19	0	0	19	0	0
11	2619515	.	T	A	7	12	19	0	0	19	0	0
11	2619538	.	T	A	11	11	22	0	1	23	0	0
11	2619588	.	G	C	16	0	16	0	7	23	0	0
11	2621839	.	G	A	4	9	13	0	2	15	0	0
11	2625178	.	G	A	7	14	21	0	0	21	0	0
11	2625224	.	T	A	9	13	22	0	0	22	0	0
11	2625247	.	T	C	6	9	15	0	1	16	0	0
11	2628038	.	T	G	10	3	13	0	0	13	0	0
11	2650018	.	T	G	10	7	17	0	0	17	0	0
11	2655888	.	G	C	5	6	11	0	0	11	0	0
11	2655957	.	G	C	0	7	7	0	6	13	0	0
11	2656062	.	C	G	3	5	8	0	0	8	0	0
11	2656830	.	T	C	4	3	7	0	0	7	0	0
11	2660602	.	T	C	4	6	10	0	0	10	0	0
11	2664585	.	A	C	7	15	22	0	5	27	0	0
11	2665236	.	T	A	14	4	18	0	1	19	0	0
11	2673624	.	T	C	11	10	21	0	1	22	0	0
11	2675447	.	C	A	6	15	21	0	2	23	0	0
11	2677377	.	G	C	11	6	17	0	0	17	0	0
11	2677404	.	G	A	1	7	8	0	5	13	0	0
11	2677428	.	A	G	6	5	11	0	2	13	0	0
11	2677440	.	C	T	9	7	16	0	0	16	0	0
11	2677538	.	C	T	7	10	17	0	1	18	0	0
11	2678064	.	G	A	13	9	22	0	1	23	0	0
11	2678088	.	G	A	9	12	21	0	0	21	0	0
11	2680570	.	G	A	0	3	3	0	5	8	0	0
11	2680747	.	C	T	7	11	18	0	0	18	0	0
11	2680797	.	G	C	9	4	13	0	0	13	0	0
11	2681432	.	A	G	4	3	7	0	0	7	0	0
11	2681799	.	T	C	3	2	5	0	0	5	0	0
11	2681885	.	T	A	2	6	8	1	2	11	0	0
11	2681894	.	A	G	3	5	8	1	1	10	0	0
11	2681953	.	A	G	2	0	2	0	6	8	0	0
11	2681974	.	T	A	4	4	8	0	0	8	0	0
11	2681998	.	A	G	4	3	7	0	0	7	0	0
11	2682257	.	T	A	1	6	7	0	0	7	0	0
11	2682313	.	G	T	3	4	7	0	1	8	0	0
11	2682441	.	A	T	4	7	11	0	0	11	0	0
11	2682470	.	A	T	4	7	11	0	0	12	1	0
11	2682483	.	T	C	7	5	12	0	1	13	0	0
11	2682551	.	C	T	4	3	7	0	1	8	0	0
11	2682555	.	A	T	3	4	7	0	0	7	0	0
11	2682644	.	A	T	2	6	8	0	0	8	0	0
11	2682693	.	A	C	5	5	10	0	0	10	0	0
11	2682866	.	T	C	8	3	11	0	0	11	0	0
11	2683038	.	G	T	3	7	10	0	0	10	0	0
11	2683092	.	A	C	1	2	3	0	0	3	0	0
11	2683509	.	T	C	6	21	27	0	0	27	0	0
11	2687421	.	C	T	6	9	15	0	0	15	0	0
11	2687472	.	C	T	5	7	12	0	0	12	0	0
11	2687526	.	G	A	8	3	11	0	1	12	0	0
11	2687550	.	A	C	12	5	17	0	0	17	0	0
11	2688119	.	G	A	4	8	12	0	0	12	0	0
11	2688582	.	A	C	3	7	10	0	1	11	0	0
11	2689079	.	A	G	9	3	12	4	0	16	0	0
11	2689170	.	T	G	11	3	14	3	1	18	0	0
11	2689336	.	G	A	3	2	5	0	2	7	0	0
11	2689337	.	G	A	3	2	5	0	2	7	0	0
11	2690143	.	A	G	4	3	7	0	0	7	0	0
11	2690233	.	G	T	4	8	12	0	0	12	0	0
11	2690303	.	G	C	8	6	14	0	0	14	0	0
11	2690445	.	G	T	15	4	19	0	2	21	0	0
11	2690499	.	C	T	7	5	12	0	0	12	0	0
11	2690564	.	G	T	6	2	8	0	0	8	0	0
11	2690612	.	A	C	6	4	10	0	0	10	0	0
11	2690869	.	C	A	7	6	13	0	0	13	0	0
11	2690873	.	G	A	1	5	6	0	5	11	0	0
11	2702718	.	T	C	11	8	19	0	1	20	0	0
11	2702766	.	C	T	14	4	18	0	0	18	0	0
11	2705206	.	C	T	9	8	17	0	1	18	0	0
11	2705215	.	G	T	2	11	13	0	6	19	0	0
11	2705273	.	A	G	9	0	9	0	8	17	0	0
11	2705325	.	G	A	10	9	19	0	1	20	0	0
11	2705355	.	T	A	11	9	20	0	0	20	0	0
11	2705780	.	A	G	12	6	18	0	0	18	0	0
11	2706517	.	T	G	6	11	17	0	0	17	0	0
11	2706734	.	T	C	11	11	22	0	1	23	0	0
11	2706838	.	A	G	7	6	13	0	1	14	0	0
11	2710611	.	A	T	11	9	20	0	0	20	0	0
11	2710642	.	G	A	6	8	14	0	0	14	0	0
11	2710770	.	A	T	4	3	7	0	0	7	0	0
11	2743631	.	A	G	8	0	8	0	5	13	0	0
11	2743661	.	C	T	9	8	17	0	1	18	0	0
11	2745110	.	A	T	6	7	13	0	0	13	0	0
11	2755120	.	A	T	11	5	16	0	0	16	0	0
11	2756250	.	C	T	10	5	15	0	1	16	0	0
11	2757582	.	T	C	5	9	14	0	0	14	0	0
11	2758204	.	C	T	10	15	25	0	0	25	0	0
11	2758706	.	T	A	1	2	3	0	1	4	0	0
11	2758737	.	T	A	1	3	4	0	0	4	0	0
11	2759003	.	C	A	5	3	8	10	1	19	0	0
11	2759007	.	C	T	4	5	9	10	0	19	0	0
11	2759043	.	A	T	6	12	18	0	0	18	0	0
11	2759461	.	T	C	7	8	15	4	0	19	0	0
11	2759475	.	G	T	10	9	19	7	0	26	0	0
11	2759498	.	G	A	10	15	25	4	2	31	0	0
11	2759525	.	A	G	15	5	20	8	1	29	0	0
11	2759541	.	C	A	6	7	13	7	2	22	0	0
11	2759833	.	G	A	1	10	11	0	10	21	0	0
11	2759843	.	G	A	2	11	13	0	13	26	0	0
11	2759901	.	T	G	16	9	25	0	1	26	0	0
11	2759903	.	A	T	9	16	25	0	1	26	0	0
11	2759938	.	A	G	11	7	18	0	0	19	1	0
11	2760240	.	C	T	7	5	12	0	0	12	0	0
11	2805410	.	C	A	16	8	24	0	1	25	0	0
11	2809744	.	C	T	15	10	25	0	2	27	0	0
11	2809777	.	A	G	15	0	15	0	14	29	0	0
11	2809804	.	A	G	12	18	30	0	0	30	0	0
11	2813856	.	G	C	21	11	32	0	1	33	0	0
11	2815790	.	C	G	31	16	47	0	0	47	0	0
11	2815845	.	C	T	28	19	47	0	0	47	0	0
11	2820876	.	T	G	14	27	41	0	0	41	0	0
11	2820900	.	A	C	10	23	33	0	3	36	0	0
11	2821427	.	T	C	17	14	31	0	0	31	0	0
11	2821430	.	C	G	17	1	18	0	13	31	0	0
11	2826184	.	T	C	28	16	44	1	5	50	0	0
11	2826338	.	G	T	17	17	34	0	2	37	1	0
11	2826485	.	C	A	12	12	24	0	3	27	0	0
11	2828113	.	A	G	16	0	16	0	8	27	3	0
11	2828174	.	A	G	6	24	30	0	1	31	0	0
11	2828276	.	C	A	13	10	23	0	0	23	0	0
11	2828388	.	G	A	17	16	33	0	0	33	0	0
11	2855507	.	A	G	1	2	3	0	0	3	0	0
11	2855530	.	C	T	1	3	4	0	0	4	0	0
11	2918143	.	T	C	1	4	5	0	0	5	0	0
11	2922443	.	A	G	1	2	3	0	0	3	0	0
11	2922515	.	C	G	1	0	1	1	6	8	0	0
11	2962078	.	T	G	1	0	1	0	2	3	0	0
11	2968279	.	C	A	2	2	4	0	0	4	0	0
11	2968410	.	A	G	2	7	9	0	0	9	0	0
11	3148157	.	C	A	2	6	8	0	1	9	0	0
11	3172677	.	G	A	1	3	4	0	5	9	0	0
11	3195739	.	G	T	1	6	7	0	3	10	0	0
11	3195757	.	A	C	2	6	8	0	0	8	0	0
11	3212009	.	T	C	5	5	10	0	0	10	0	0
11	3217970	.	C	T	3	5	8	0	0	8	0	0
11	3221014	.	C	T	3	7	10	0	0	10	0	0
11	3222083	.	A	G	4	4	8	0	1	9	0	0
11	3222192	.	T	C	3	7	10	0	0	10	0	0
11	3227302	.	A	T	4	5	9	0	0	9	0	0
11	3227343	.	G	A	3	2	5	0	0	5	0	0
11	3227451	.	C	T	3	2	5	0	0	5	0	0
11	3230284	.	G	A	6	5	11	0	0	11	0	0
11	3230820	.	G	A	0	2	2	0	2	4	0	0
11	3235543	.	C	T	10	4	14	0	0	14	0	0
11	3238484	.	A	G	10	7	17	0	2	19	0	0
11	3238651	.	C	T	5	7	12	0	2	14	0	0
11	3238720	.	T	C	4	14	18	0	1	19	0	0
11	3240457	.	G	A	1	8	9	0	9	18	0	0
11	3246120	.	A	G	11	9	20	0	0	20	0	0
11	3246133	.	A	G	12	9	21	0	0	21	0	0
11	3246590	.	A	C	5	8	13	14	0	27	0	0
11	3249253	.	C	T	8	6	14	0	1	15	0	0
11	3249346	.	C	T	4	5	9	0	1	10	0	0
11	3249370	.	A	G	2	0	2	0	6	8	0	0
11	3303697	.	G	A	2	2	4	0	0	4	0	0
11	3317226	.	T	C	9	13	22	0	1	23	0	0
11	3317229	.	G	T	11	12	23	0	0	23	0	0
11	3317389	.	A	T	17	12	29	0	0	29	0	0
11	3320963	.	C	G	2	3	5	0	0	5	0	0
11	3320972	.	A	G	2	3	5	0	0	5	0	0
11	3321115	.	A	G	7	2	9	0	0	9	0	0
11	3321141	.	A	T	8	3	11	0	0	11	0	0
11	3321152	.	C	T	0	3	3	0	9	12	0	0
11	3323377	.	G	T	7	3	10	0	0	10	0	0
11	3327451	.	G	A	6	2	8	0	0	8	0	0
11	3333841	.	T	C	3	5	8	0	0	8	0	0
11	3333854	.	A	G	4	4	8	0	0	8	0	0
11	3336700	.	T	G	35	20	55	0	1	56	0	0
11	3336793	.	C	T	32	35	67	0	2	69	0	0
11	3337038	.	A	G	38	26	64	0	2	66	0	0
11	3337253	.	A	G	33	32	65	0	2	67	0	0
11	3337256	.	T	C	32	0	32	0	34	66	0	0
11	3337481	.	T	G	31	23	54	0	4	58	0	0
11	3337482	.	A	T	33	24	57	0	1	58	0	0
11	3337718	.	G	C	19	24	43	0	1	44	0	0
11	3338060	.	C	G	25	16	41	0	1	42	0	0
11	3338144	.	T	C	38	25	63	0	4	67	0	0
11	3338236	.	T	C	33	0	33	1	28	62	0	0
11	3338288	.	T	A	38	25	63	1	0	64	0	0
11	3338299	.	T	G	33	21	54	1	1	56	0	0
11	3338420	.	A	T	32	20	52	0	4	56	0	0
11	3338431	.	C	T	3	19	22	0	34	56	0	0
11	3338491	.	G	A	25	28	53	0	0	53	0	0
11	3338514	.	C	A	29	28	57	0	2	59	0	0
11	3338618	.	T	C	40	27	67	1	0	68	0	0
11	3338638	.	A	G	39	27	66	1	2	69	0	0
11	3338933	.	A	G	27	25	52	0	3	55	0	0
11	3339098	.	T	C	28	1	29	0	25	54	0	0
11	3339152	.	C	T	28	20	48	0	1	49	0	0
11	3341296	.	G	A	26	26	52	0	5	57	0	0
11	3345676	.	A	G	3	5	8	0	1	9	0	0
11	3345716	.	T	C	3	4	7	0	0	7	0	0
11	3345855	.	A	C	2	2	4	0	1	5	0	0
11	3345952	.	T	C	6	6	12	0	0	12	0	0
11	3346128	.	T	G	7	4	11	0	0	11	0	0
11	3346797	.	T	C	7	0	7	0	5	12	0	0
11	3347351	.	T	C	6	3	9	0	0	9	0	0
11	3347414	.	C	A	0	3	3	0	5	8	0	0
11	3347727	.	T	C	1	0	1	0	2	3	0	0
11	3347779	.	C	T	2	2	4	0	1	5	0	0
11	3348004	.	T	G	2	2	4	0	2	6	0	0
11	3348148	.	C	A	1	2	3	0	0	3	0	0
11	3351405	.	C	T	0	2	2	0	4	6	0	0
11	3367789	.	T	C	4	0	4	0	5	9	0	0
11	3367924	.	G	C	13	8	21	0	0	21	0	0
11	3367937	.	T	C	11	6	17	0	0	17	0	0
11	3369843	.	G	A	5	6	11	0	0	11	0	0
11	3373418	.	A	G	7	9	16	0	0	16	0	0
11	3373448	.	G	A	9	13	22	0	0	22	0	0
11	3373996	.	C	T	1	11	12	0	7	19	0	0
11	3377127	.	T	C	2	0	2	0	4	6	0	0
11	3379999	.	G	T	5	5	10	0	2	12	0	0
11	3380012	.	C	G	6	4	10	0	0	10	0	0
11	3380135	.	A	G	6	8	14	0	0	14	0	0
11	3381261	.	C	A	3	8	11	0	0	11	0	0
11	3395069	.	G	A	16	11	27	0	1	28	0	0
11	3395070	.	A	T	16	12	28	0	0	28	0	0
11	3395303	.	G	A	15	13	28	0	0	28	0	0
11	3395324	.	C	T	14	20	34	0	1	35	0	0
11	3395501	.	A	G	12	13	25	0	0	25	0	0
11	3398738	.	A	C	4	1	5	0	17	22	0	0
11	3401899	.	C	A	8	11	19	0	0	19	0	0
11	3422086	.	T	C	11	4	15	0	0	15	0	0
11	3423390	.	G	A	4	7	11	0	1	12	0	0
11	3423411	.	A	G	5	7	12	0	0	12	0	0
11	3425175	.	G	A	5	4	9	0	0	9	0	0
11	3425579	.	C	T	8	7	15	0	1	16	0	0
11	3494891	.	A	G	13	10	23	0	1	24	0	0
11	3494930	.	T	A	2	7	9	0	2	11	0	0
11	3520631	.	A	G	4	3	7	0	0	7	0	0
11	3520670	.	T	C	2	3	5	0	0	5	0	0
11	3520694	.	C	A	4	2	6	0	0	6	0	0
11	3523724	.	A	G	9	13	22	0	1	23	0	0
11	3523826	.	G	A	4	7	11	0	3	14	0	0
11	3523976	.	A	C	8	0	8	1	7	16	0	0
11	3523991	.	C	T	8	7	15	1	0	16	0	0
11	3524064	.	G	T	8	6	14	1	2	17	0	0
11	3524111	.	G	A	11	10	21	0	1	22	0	0
11	3524121	.	A	G	14	9	23	0	2	25	0	0
11	3524236	.	C	T	11	11	22	0	1	23	0	0
11	3524397	.	T	C	12	7	19	0	2	21	0	0
11	3524462	.	C	T	10	10	20	0	0	20	0	0
11	3524541	.	A	T	10	7	17	0	0	17	0	0
11	3524724	.	T	A	5	6	11	0	2	13	0	0
11	3524849	.	G	A	10	10	20	0	0	20	0	0
11	3526521	.	A	G	9	10	19	0	0	19	0	0
11	3526605	.	C	G	17	8	25	0	2	27	0	0
11	3528320	.	A	T	10	12	22	0	4	26	0	0
11	3530791	.	C	G	2	6	8	0	1	9	0	0
11	3532836	.	A	G	4	4	8	0	1	9	0	0
11	3535326	.	A	G	9	4	13	0	1	14	0	0
11	3535397	.	A	G	5	2	7	0	1	8	0	0
11	3535431	.	T	C	7	5	12	0	1	13	0	0
11	3535434	.	A	G	8	5	13	0	0	13	0	0
11	3550448	.	A	G	8	6	14	0	1	15	0	0
11	3550454	.	T	A	11	7	18	0	2	20	0	0
11	3550588	.	T	C	19	0	19	0	19	38	0	0
11	3551309	.	A	G	30	30	60	0	3	63	0	0
11	3551944	.	G	A	32	24	56	1	2	59	0	0
11	3563124	.	G	A	6	4	10	0	0	10	0	0
11	3563644	.	C	T	0	4	4	0	4	8	0	0
11	3563647	.	G	A	4	5	9	0	0	9	0	0
11	3563680	.	A	G	5	4	9	0	0	9	0	0
11	3579430	.	T	A	3	2	5	0	0	5	0	0
11	3593309	.	T	C	1	8	9	0	0	9	0	0
11	3593490	.	A	C	10	8	18	0	0	18	0	0
11	3593716	.	C	T	16	3	19	0	1	20	0	0
11	3593748	.	A	G	15	6	21	0	1	22	0	0
11	3593863	.	T	C	9	4	13	1	0	14	0	0
11	3593878	.	T	C	5	0	5	0	9	14	0	0
11	3593988	.	G	T	8	10	18	0	3	21	0	0
11	3594217	.	G	T	11	14	25	0	2	27	0	0
11	3594277	.	T	G	10	9	19	0	2	21	0	0
11	3594321	.	T	C	13	1	14	0	9	23	0	0
11	3594327	.	T	A	12	9	21	0	2	23	0	0
11	3594366	.	A	G	9	13	22	0	4	26	0	0
11	3594419	.	A	G	3	9	12	0	2	14	0	0
11	3594452	.	T	G	2	2	4	2	9	15	0	0
11	3594828	.	T	C	2	0	2	0	6	8	0	0
11	3595308	.	G	A	10	4	14	0	0	14	0	0
11	3595579	.	A	G	12	8	20	0	1	21	0	0
11	3603392	.	A	G	4	4	8	0	0	8	0	0
11	3603434	.	T	C	5	7	12	0	0	12	0	0
11	3604729	.	T	G	2	3	5	0	0	5	0	0
11	3604732	.	C	G	0	3	3	0	2	5	0	0
11	3604825	.	G	A	7	3	10	0	0	10	0	0
11	3606897	.	C	T	8	4	12	0	1	13	0	0
11	3606914	.	T	C	6	0	6	0	8	14	0	0
11	3606957	.	C	T	10	5	15	0	1	16	0	0
11	3608704	.	A	C	7	5	12	0	1	13	0	0
11	3609427	.	A	G	5	3	8	0	0	8	0	0
11	3609448	.	A	T	2	2	4	0	0	4	0	0
11	3632213	.	C	T	6	5	11	0	0	11	0	0
11	3632643	.	C	T	1	2	3	1	0	4	0	0
11	3633946	.	A	G	1	2	3	0	0	3	0	0
11	3848283	.	G	A	14	18	32	0	0	32	0	0
11	3848323	.	C	T	1	16	17	0	12	29	0	0
11	3848656	.	C	T	14	5	19	0	1	20	0	0
11	3860159	.	A	T	2	2	4	0	0	4	0	0
11	3893635	.	C	T	19	23	42	0	2	44	0	0
11	3893636	.	T	G	22	22	44	0	1	45	0	0
11	3893918	.	G	A	18	20	38	0	1	39	0	0
11	3893928	.	G	C	19	17	36	0	3	39	0	0
11	3894023	.	T	C	18	31	49	0	0	49	0	0
11	3898730	.	C	A	4	14	18	0	14	32	0	0
11	3898736	.	A	G	17	16	33	0	1	34	0	0
11	3899066	.	C	A	2	14	16	1	15	32	0	0
11	3899117	.	G	A	18	14	32	1	0	33	0	0
11	3901733	.	C	G	3	12	15	0	13	28	0	0
11	3904469	.	A	G	14	19	33	0	0	33	0	0
11	3904517	.	C	G	1	24	25	0	13	38	0	0
11	3904564	.	C	T	13	27	40	0	3	43	0	0
11	3904666	.	A	G	20	16	36	0	2	38	0	0
11	3904674	.	T	G	20	12	32	0	1	33	0	0
11	3905928	.	A	G	12	16	28	0	2	30	0	0
11	3917723	.	A	G	15	15	30	0	0	30	0	0
11	3921491	.	A	G	18	13	31	0	1	32	0	0
11	3921563	.	T	A	19	13	32	0	2	34	0	0
11	3922983	.	G	A	9	9	18	0	1	19	0	0
11	3925822	.	T	C	13	0	13	0	8	21	0	0
11	3925906	.	A	G	8	4	12	0	2	14	0	0
11	3925939	.	T	C	13	6	19	0	1	20	0	0
11	3931773	.	C	T	13	5	18	0	2	20	0	0
11	3933807	.	G	A	7	8	15	0	1	16	0	0
11	3934190	.	A	G	4	10	14	0	1	15	0	0
11	3934319	.	T	G	8	8	16	0	0	16	0	0
11	3936378	.	T	A	5	7	12	0	1	13	0	0
11	3938816	.	G	A	4	4	8	0	1	9	0	0
11	3939291	.	C	G	0	3	3	0	8	11	0	0
11	3941180	.	C	T	6	4	10	0	2	12	0	0
11	3963581	.	C	T	2	8	10	0	0	10	0	0
11	3963608	.	G	T	1	7	8	0	2	10	0	0
11	3963639	.	T	A	2	3	5	0	1	6	0	0
11	3964193	.	T	A	6	7	13	0	0	13	0	0
11	3965837	.	G	A	6	10	16	0	0	16	0	0
11	3965867	.	C	T	8	4	12	0	0	12	0	0
11	3965984	.	T	A	7	7	14	0	1	15	0	0
11	3966360	.	G	C	0	5	5	0	5	10	0	0
11	3967408	.	A	G	6	0	6	0	5	11	0	0
11	3967445	.	A	G	4	6	10	0	2	12	0	0
11	3968866	.	T	C	9	11	20	0	0	20	0	0
11	3968877	.	G	A	7	8	15	0	2	17	0	0
11	3968915	.	T	G	5	13	18	0	0	18	0	0
11	3968930	.	A	G	6	1	7	0	12	19	0	0
11	3970703	.	T	A	2	2	4	0	0	4	0	0
11	3971943	.	T	A	3	2	5	0	0	5	0	0
11	3971953	.	A	G	3	1	4	0	0	4	0	0
11	3993452	.	G	A	2	6	8	0	9	17	0	0
11	3993470	.	A	T	5	4	9	0	0	9	0	0
11	3994901	.	C	A	1	2	3	0	0	3	0	0
11	3995459	.	G	A	4	2	6	0	0	6	0	0
11	3995479	.	G	T	4	4	8	0	0	8	0	0
11	3997023	.	T	C	4	0	4	0	3	7	0	0
11	3997029	.	C	A	2	3	5	0	3	8	0	0
11	4004042	.	G	C	2	4	6	0	1	7	0	0
11	4006924	.	C	T	0	8	8	0	3	11	0	0
11	4006956	.	C	T	3	5	8	0	0	8	0	0
11	4010696	.	G	T	2	3	5	0	2	7	0	0
11	4010895	.	C	T	4	4	8	0	0	8	0	0
11	4011001	.	T	C	3	0	3	0	6	9	0	0
11	4014428	.	A	T	3	3	6	0	0	6	0	0
11	4014458	.	A	G	3	2	5	0	0	5	0	0
11	4014634	.	A	G	2	4	6	0	0	6	0	0
11	4014737	.	C	T	1	2	3	0	0	3	0	0
11	4014758	.	T	C	1	0	1	0	2	3	0	0
11	4021231	.	G	A	1	3	4	0	0	4	0	0
11	4023804	.	G	A	1	4	5	0	0	5	0	0
11	4023813	.	T	G	1	4	5	0	0	5	0	0
11	4026308	.	C	T	7	8	15	0	1	16	0	0
11	4113825	.	G	A	0	8	8	0	6	14	0	0
11	4128836	.	A	T	13	22	35	0	0	35	0	0
11	4131300	.	A	T	13	9	22	0	0	22	0	0
11	4131423	.	T	A	12	9	21	0	1	22	0	0
11	4132110	.	G	T	21	7	28	0	1	29	0	0
11	4132296	.	A	C	26	25	51	0	1	52	0	0
11	4132378	.	G	C	12	9	21	0	2	23	0	0
11	4132440	.	A	G	13	13	26	0	0	26	0	0
11	4132599	.	T	C	8	3	11	0	0	11	0	0
11	4175530	.	T	A	1	3	4	0	0	4	0	0
11	4205612	.	T	A	5	10	15	0	0	15	0	0
11	4209004	.	T	C	13	11	24	0	0	24	0	0
11	4219556	.	A	C	7	3	10	0	0	10	0	0
11	5674346	.	A	G	1	5	6	0	0	6	0	0
11	6199176	.	T	C	2	2	4	0	0	4	0	0
11	6942501	.	A	G	8	6	14	0	0	14	0	0
11	7295999	.	T	C	4	3	7	0	0	7	0	0
11	7298890	.	C	T	10	6	16	0	1	17	0	0
11	7298972	.	G	A	11	7	18	0	0	18	0	0
11	7299005	.	A	T	9	6	15	0	3	18	0	0
11	7299022	.	C	T	8	7	15	0	0	15	0	0
11	7299040	.	A	G	7	5	12	0	1	13	0	0
11	7305923	.	G	A	8	10	18	0	0	18	0	0
11	7340143	.	A	G	32	30	62	0	1	63	0	0
11	7341031	.	G	A	32	24	56	0	2	58	0	0
11	7529109	.	C	T	6	8	14	0	1	15	0	0
11	7580158	.	C	T	4	5	9	0	0	9	0	0
11	7628282	.	T	C	7	1	8	0	1	9	0	0
11	7628285	.	T	C	8	4	12	0	0	12	0	0
11	7640718	.	T	C	2	7	9	0	0	9	0	0
11	7640769	.	T	C	4	3	7	0	1	8	0	0
11	7652612	.	C	T	8	11	19	0	0	19	0	0
11	7652642	.	T	C	13	9	22	0	0	22	0	0
11	7652648	.	G	C	12	8	20	0	2	22	0	0
11	7670739	.	G	T	9	11	20	0	2	22	0	0
11	7673091	.	C	T	6	7	13	0	0	13	0	0
11	7686796	.	T	C	11	5	16	0	0	16	0	0
11	7692036	.	T	C	5	3	8	0	1	9	0	0
11	7696584	.	G	T	9	12	21	0	0	21	0	0
11	7734898	.	A	G	7	0	7	0	23	30	0	0
11	7735869	.	C	G	21	15	36	0	1	37	0	0
11	7735905	.	T	A	17	21	38	0	0	39	1	0
11	7735937	.	T	A	11	17	28	0	1	29	0	0
11	7736482	.	T	G	9	0	9	0	7	16	0	0
11	7736576	.	G	A	18	20	38	0	0	38	0	0
11	7736589	.	G	T	18	21	39	0	0	39	0	0
11	7981303	.	A	C	3	5	8	0	0	8	0	0
11	7981427	.	C	T	1	3	4	0	1	5	0	0
11	7981613	.	T	C	17	15	32	0	2	34	0	0
11	7981912	.	T	C	13	0	13	0	10	23	0	0
11	7981915	.	T	A	14	10	24	0	0	24	0	0
11	7982114	.	C	T	6	5	11	0	0	11	0	0
11	7982122	.	T	A	7	4	11	0	0	11	0	0
11	7982205	.	T	C	7	0	7	0	4	11	0	0
11	7982263	.	T	G	5	5	10	0	3	13	0	0
11	7982321	.	T	A	7	8	15	0	0	15	0	0
11	7982566	.	T	A	5	3	8	0	2	10	0	0
11	7982774	.	T	A	11	10	21	0	0	21	0	0
11	7982791	.	C	T	13	10	23	0	1	24	0	0
11	7982835	.	C	T	8	8	16	0	1	17	0	0
11	7982869	.	C	T	10	8	18	0	0	18	0	0
11	7983236	.	T	A	13	7	20	0	1	21	0	0
11	7983270	.	T	G	17	11	28	0	0	28	0	0
11	7983348	.	C	A	16	7	23	0	3	27	1	0
11	7983631	.	C	T	2	19	21	0	7	28	0	0
11	7983709	.	T	A	14	8	22	0	0	22	0	0
11	7983734	.	A	G	13	4	17	0	0	17	0	0
11	7983757	.	A	T	9	4	13	0	0	13	0	0
11	7984181	.	A	T	5	5	10	0	1	11	0	0
11	7984264	.	A	T	4	9	13	0	0	13	0	0
11	7984350	.	A	T	4	3	7	0	0	7	0	0
11	7984666	.	T	A	8	11	19	0	0	19	0	0
11	8003638	.	A	G	6	5	11	0	0	11	0	0
11	8012466	.	T	A	13	7	20	0	0	20	0	0
11	8012535	.	A	G	11	8	19	0	0	19	0	0
11	8097547	.	A	G	6	7	13	0	1	14	0	0
11	8104328	.	A	G	4	3	7	0	1	8	0	0
11	8104334	.	T	A	4	3	7	0	0	7	0	0
11	8104629	.	T	C	1	0	1	0	3	4	0	0
11	8115252	.	A	G	5	6	11	0	0	11	0	0
11	8115263	.	T	C	7	0	7	0	7	14	0	0
11	8153771	.	C	T	7	8	15	0	2	17	0	0
11	8156967	.	C	T	16	11	27	0	0	27	0	0
11	8156972	.	C	T	15	8	23	0	0	23	0	0
11	8157002	.	C	G	14	9	23	0	0	23	0	0
11	8304652	.	C	G	0	1	1	0	1	2	0	0
11	8304906	.	A	C	1	2	3	0	0	3	0	0
11	8305367	.	A	G	4	4	8	0	0	8	0	0
11	8305395	.	A	C	5	4	9	0	0	9	0	0
11	8305425	.	A	G	1	3	4	0	1	5	0	0
11	8305435	.	G	T	1	2	3	0	1	4	0	0
11	8305900	.	T	A	1	2	3	0	0	3	0	0
11	8305923	.	C	T	0	2	2	0	1	3	0	0
11	8565961	.	T	C	5	4	9	0	1	10	0	0
11	8662864	.	G	A	1	8	9	0	15	24	0	0
11	8672749	.	A	C	8	10	18	0	0	18	0	0
11	8672992	.	G	T	0	9	9	0	9	18	0	0
11	8673002	.	T	C	7	8	15	0	0	15	0	0
11	8673455	.	A	C	2	2	4	0	0	4	0	0
11	8681619	.	G	T	21	11	32	0	2	34	0	0
11	8681714	.	T	C	13	17	30	0	1	31	0	0
11	8681750	.	G	A	9	10	19	0	0	19	0	0
11	8682248	.	T	A	6	6	12	0	0	12	0	0
11	8682273	.	G	A	4	9	13	0	0	13	0	0
11	8682331	.	T	C	8	7	15	0	0	15	0	0
11	8697473	.	T	C	4	3	7	0	2	9	0	0
11	9521168	.	T	G	2	2	4	0	0	4	0	0
11	9521169	.	A	G	2	2	4	0	0	4	0	0
11	9564328	.	T	G	10	11	21	0	1	22	0	0
11	9564746	.	G	A	12	5	17	0	0	17	0	0
11	9948161	.	G	C	1	7	8	0	0	8	0	0
11	9948278	.	G	A	2	3	5	0	0	5	0	0
11	10388980	.	G	A	1	3	4	0	0	4	0	0
11	10389003	.	C	A	2	2	4	0	0	4	0	0
11	10389284	.	A	G	5	4	9	0	0	9	0	0
11	10402081	.	G	A	2	9	11	0	0	11	0	0
11	10467404	.	G	A	4	2	6	0	1	7	0	0
11	10468569	.	C	T	1	2	3	0	3	6	0	0
11	10468862	.	T	G	3	3	6	0	0	6	0	0
11	10468872	.	C	T	4	4	8	0	1	9	0	0
11	10469281	.	A	C	2	2	4	0	0	4	0	0
11	10469401	.	G	A	2	3	5	0	0	5	0	0
11	10483198	.	A	C	6	2	8	0	0	8	0	0
11	10501370	.	T	C	2	0	2	0	3	5	0	0
11	10536890	.	G	A	2	3	5	0	0	5	0	0
11	10658836	.	T	G	1	3	4	0	0	4	0	0
11	10658845	.	A	G	1	0	1	0	3	4	0	0
11	10669933	.	G	T	21	40	61	0	1	62	0	0
11	10670112	.	T	A	16	12	28	1	4	33	0	0
11	10670394	.	C	T	24	23	47	0	1	48	0	0
11	10671166	.	T	C	30	32	62	0	2	64	0	0
11	10671525	.	A	G	34	26	60	0	0	60	0	0
11	10671546	.	A	G	26	26	52	0	1	53	0	0
11	10671578	.	A	T	25	22	47	0	1	48	0	0
11	10671636	.	C	T	2	18	20	0	17	37	0	0
11	10672136	.	C	T	9	6	15	0	0	16	1	0
11	10672250	.	T	C	5	0	5	1	11	17	0	0
11	10672707	.	T	G	12	22	34	0	3	37	0	0
11	10672726	.	T	A	10	30	40	0	0	40	0	0
11	10672750	.	T	C	15	29	44	0	0	44	0	0
11	10713757	.	G	A	17	10	27	0	1	28	0	0
11	10713796	.	C	T	8	9	17	0	2	19	0	0
11	10720178	.	C	T	14	14	28	0	1	29	0	0
11	10720232	.	G	C	8	18	26	0	0	26	0	0
11	10720271	.	C	T	0	15	15	0	12	27	0	0
11	10720295	.	A	G	12	14	26	0	2	28	0	0
11	10725775	.	G	A	15	18	33	0	0	33	0	0
11	10725880	.	G	A	16	11	27	0	1	28	0	0
11	10832957	.	G	T	19	14	33	0	1	34	0	0
11	10835571	.	T	C	17	0	17	0	16	33	0	0
11	10842537	.	T	C	11	1	12	0	15	27	0	0
11	10842714	.	A	C	12	0	12	0	14	26	0	0
11	10909461	.	G	A	0	5	5	0	8	13	0	0
11	10958321	.	A	G	10	0	10	0	6	16	0	0
11	10958507	.	A	G	7	0	7	0	4	11	0	0
11	10959499	.	T	A	9	7	16	0	0	16	0	0
11	11274911	.	G	A	3	2	5	0	0	5	0	0
11	11274915	.	G	A	2	2	4	0	1	5	0	0
11	11516279	.	T	C	2	0	2	0	3	5	0	0
11	11517450	.	T	G	2	2	4	0	0	4	0	0
11	11517480	.	G	C	4	1	5	0	1	6	0	0
11	11597221	.	T	C	4	5	9	0	0	9	0	0
11	11597240	.	T	C	6	5	11	0	2	13	0	0
11	11597374	.	A	G	8	14	22	0	0	22	0	0
11	11597401	.	C	A	8	11	19	0	1	20	0	0
11	11597523	.	A	G	12	14	26	0	2	28	0	0
11	11597798	.	A	T	10	17	27	0	1	28	0	0
11	11597985	.	A	T	9	17	26	0	1	27	0	0
11	11598334	.	G	C	11	12	23	0	1	24	0	0
11	11598692	.	C	A	27	18	45	0	1	46	0	0
11	11605172	.	T	C	14	1	15	0	16	31	0	0
11	11605744	.	C	T	2	12	14	0	11	25	0	0
11	11607492	.	G	A	10	9	19	0	1	20	0	0
11	11607498	.	C	G	10	8	18	0	0	18	0	0
11	11607579	.	A	C	5	0	5	0	10	15	0	0
11	11607594	.	G	A	9	12	21	0	1	22	0	0
11	11607705	.	C	T	7	17	24	0	2	26	0	0
11	11614681	.	T	G	9	6	15	0	0	15	0	0
11	11624909	.	C	T	5	10	15	0	1	16	0	0
11	11625229	.	T	A	3	5	8	0	0	8	0	0
11	11773662	.	A	G	1	2	3	0	0	3	0	0
11	11777535	.	A	T	6	5	11	0	0	11	0	0
11	11777540	.	G	A	6	4	10	0	1	11	0	0
11	11780816	.	A	T	5	6	11	0	0	11	0	0
11	11893258	.	C	T	1	2	3	0	0	3	0	0
11	11894224	.	A	G	1	3	4	0	0	4	0	0
11	11918439	.	T	C	4	0	4	0	3	7	0	0
11	11918712	.	T	G	5	2	7	0	0	7	0	0
11	11922424	.	G	C	1	5	6	0	0	6	0	0
11	11922512	.	A	G	3	3	6	0	0	6	0	0
11	11929271	.	C	G	4	2	6	0	0	6	0	0
11	11932967	.	C	T	0	4	4	0	3	7	0	0
11	11932998	.	A	G	2	3	5	0	0	5	0	0
11	11933558	.	G	A	1	2	3	0	0	3	0	0
11	11934052	.	T	G	3	3	6	0	1	7	0	0
11	11934062	.	C	T	4	2	6	0	1	7	0	0
11	11951584	.	A	T	1	4	5	0	0	5	0	0
11	11979620	.	G	C	1	2	3	0	0	3	0	0
11	11983710	.	T	C	13	0	13	0	4	17	0	0
11	11983713	.	A	C	11	5	16	0	2	18	0	0
11	11983748	.	A	C	7	1	8	0	6	14	0	0
11	11983789	.	G	T	9	11	20	0	2	22	0	0
11	11983827	.	C	T	13	10	23	0	0	23	0	0
11	11983937	.	T	C	11	6	17	0	1	18	0	0
11	11984227	.	G	A	3	5	8	0	2	10	0	0
11	11984408	.	A	C	16	6	22	0	1	23	0	0
11	11984409	.	G	C	17	6	23	0	0	23	0	0
11	11984480	.	T	C	6	0	6	0	8	14	0	0
11	11984505	.	G	A	7	5	12	0	1	13	0	0
11	11984522	.	A	G	12	4	16	0	0	16	0	0
11	11984548	.	C	T	11	7	18	0	1	19	0	0
11	11984666	.	A	G	13	10	23	0	0	23	0	0
11	12004040	.	T	C	10	4	14	0	0	14	0	0
11	12004070	.	A	G	7	3	10	0	0	10	0	0
11	12004277	.	A	G	4	5	9	0	0	9	0	0
11	12004304	.	G	T	3	8	11	0	0	11	0	0
11	12004652	.	A	G	11	9	20	0	1	21	0	0
11	12011325	.	G	A	6	4	10	0	0	10	0	0
11	12016638	.	A	G	12	8	20	0	0	20	0	0
11	12050039	.	T	C	6	10	16	0	0	16	0	0
11	12050265	.	A	G	4	6	10	0	0	10	0	0
11	12050291	.	G	A	4	4	8	0	0	8	0	0
11	12051505	.	G	T	8	6	14	0	0	14	0	0
11	12118079	.	C	T	11	18	29	0	2	31	0	0
11	12118097	.	T	A	14	17	31	0	0	31	0	0
11	12136025	.	A	C	9	0	9	0	10	19	0	0
11	12141467	.	T	C	8	7	15	0	1	16	0	0
11	12141482	.	A	G	9	7	16	0	0	16	0	0
11	12145328	.	G	A	5	6	11	0	0	11	0	0
11	12727225	.	A	G	20	21	41	0	1	42	0	0
11	12727446	.	C	T	21	24	45	0	1	46	0	0
11	12727504	.	A	G	20	21	41	0	2	43	0	0
11	12727708	.	C	A	14	18	32	0	0	32	0	0
11	12727829	.	T	A	7	10	17	0	1	18	0	0
11	12727990	.	T	A	10	16	26	0	1	27	0	0
11	12727999	.	C	T	11	14	25	0	1	26	0	0
11	12732505	.	A	T	2	9	11	0	0	11	0	0
11	12732521	.	T	C	2	0	2	0	10	12	0	0
11	12732556	.	G	C	2	7	9	0	1	10	0	0
11	12732638	.	G	A	1	2	3	0	1	4	0	0
11	12732655	.	C	T	0	2	2	0	2	4	0	0
11	12732950	.	G	T	9	3	12	0	0	12	0	0
11	12733004	.	C	T	3	3	6	0	0	6	0	0
11	12733235	.	T	C	3	0	3	0	4	7	0	0
11	12733261	.	T	C	3	4	7	0	0	7	0	0
11	12733443	.	T	A	2	2	4	0	0	4	0	0
11	12733502	.	C	T	5	5	10	0	0	10	0	0
11	12733741	.	C	T	1	3	4	0	0	4	0	0
11	12733743	.	G	A	1	2	3	0	1	4	0	0
11	12733815	.	C	T	2	4	6	0	0	6	0	0
11	12733824	.	T	C	2	0	2	0	4	6	0	0
11	12734072	.	G	A	1	3	4	0	1	5	0	0
11	12734223	.	G	A	2	6	8	0	0	8	0	0
11	12738852	.	A	T	2	6	8	0	0	8	0	0
11	12743172	.	T	C	3	3	6	0	0	6	0	0
11	12743801	.	T	G	4	4	8	0	0	8	0	0
11	12743983	.	C	T	4	3	7	0	0	7	0	0
11	12744646	.	G	A	2	2	4	0	0	4	0	0
11	12744740	.	T	C	5	12	17	0	1	18	0	0
11	12751500	.	G	A	10	5	15	0	0	15	0	0
11	12751831	.	T	C	11	10	21	1	0	22	0	0
11	12759409	.	G	A	5	4	9	0	1	10	0	0
11	12759728	.	G	T	6	7	13	0	0	13	0	0
11	12759737	.	C	T	6	6	12	0	0	12	0	0
11	12767982	.	T	C	6	6	12	0	1	13	0	0
11	12768214	.	G	A	0	13	13	0	9	22	0	0
11	12768299	.	C	T	23	9	32	0	0	32	0	0
11	12782503	.	G	A	6	3	9	0	0	9	0	0
11	12782524	.	A	C	6	6	12	1	0	13	0	0
11	12782593	.	T	C	5	0	5	0	4	9	0	0
11	12782802	.	G	A	2	2	4	0	0	4	0	0
11	12782897	.	T	A	4	4	8	0	0	8	0	0
11	12782908	.	T	G	5	4	9	0	0	9	0	0
11	12783139	.	T	A	4	4	8	0	0	8	0	0
11	12784430	.	A	T	2	5	7	0	0	7	0	0
11	12792707	.	C	T	2	4	6	0	0	6	0	0
11	12792776	.	C	T	3	3	6	0	0	6	0	0
11	12833895	.	A	G	2	0	2	0	2	4	0	0
11	12835833	.	C	A	1	2	3	0	0	3	0	0
11	12835848	.	T	C	0	1	1	0	2	3	0	0
11	12845101	.	T	A	2	2	4	0	0	4	0	0
11	12858798	.	G	A	1	4	5	0	1	6	0	0
11	12864070	.	C	T	4	6	10	0	0	10	0	0
11	12872439	.	G	A	1	2	3	0	0	3	0	0
11	12872752	.	C	T	1	2	3	0	0	3	0	0
11	12872756	.	C	T	2	2	4	0	0	4	0	0
11	12872962	.	T	A	1	3	4	0	0	4	0	0
11	12872971	.	A	G	1	0	1	0	3	4	0	0
11	12987798	.	A	C	1	2	3	0	0	3	0	0
11	12987981	.	G	T	2	3	5	0	1	6	0	0
11	12988038	.	G	A	5	3	8	0	1	9	0	0
11	13062000	.	T	C	1	3	4	0	0	4	0	0
11	13062201	.	C	G	12	5	17	0	0	17	0	0
11	13067750	.	A	T	4	3	7	0	1	8	0	0
11	13071855	.	C	T	11	5	16	0	0	16	0	0
11	13079183	.	C	A	5	4	9	0	1	10	0	0
11	13082107	.	C	T	8	6	14	0	1	15	0	0
11	13085294	.	G	A	9	3	12	0	2	14	0	0
11	13088062	.	G	T	1	9	10	0	13	23	0	0
11	13094203	.	C	T	12	5	17	0	0	17	0	0
11	13094247	.	A	G	10	5	15	0	0	15	0	0
11	13094581	.	C	T	2	28	30	0	16	46	0	0
11	13094884	.	G	A	19	24	43	0	2	45	0	0
11	13094913	.	A	G	27	22	49	0	0	49	0	0
11	13094938	.	G	T	26	20	46	0	3	49	0	0
11	13101333	.	C	T	7	9	16	1	0	17	0	0
11	13101378	.	A	G	5	8	13	1	0	14	0	0
11	13104057	.	C	A	0	3	3	0	7	10	0	0
11	13176674	.	C	A	5	6	11	0	0	11	0	0
11	13181238	.	T	C	5	5	10	0	0	10	0	0
11	13181415	.	G	A	2	4	6	0	0	6	0	0
11	13181747	.	G	A	0	4	4	0	4	8	0	0
11	13182847	.	C	T	4	5	9	0	1	10	0	0
11	13185920	.	C	T	4	3	7	0	0	7	0	0
11	13186187	.	A	G	5	6	11	0	1	12	0	0
11	13186214	.	A	G	6	5	11	0	0	11	0	0
11	13208839	.	C	G	38	30	68	0	2	70	0	0
11	13209037	.	T	G	37	38	75	0	1	76	0	0
11	13209085	.	G	C	34	33	67	0	3	70	0	0
11	13210604	.	G	A	38	28	66	0	4	70	0	0
11	13210667	.	C	T	31	31	62	0	3	65	0	0
11	13210906	.	C	T	37	23	60	0	5	65	0	0
11	13212186	.	A	T	35	43	78	0	4	82	0	0
11	13212234	.	T	C	36	35	71	0	8	80	1	0
11	13212333	.	T	C	27	29	56	0	7	63	0	0
11	13212357	.	T	C	25	40	65	0	1	66	0	0
11	13212567	.	T	C	39	31	70	0	4	74	0	0
11	13212908	.	T	A	22	32	54	0	0	54	0	0
11	13281238	.	A	G	4	4	8	2	2	12	0	0
11	13281398	.	G	C	6	9	15	0	1	16	0	0
11	13281653	.	C	T	11	19	30	0	2	32	0	0
11	13281734	.	G	A	12	11	23	0	0	23	0	0
11	13282016	.	T	C	11	12	23	0	0	23	0	0
11	13282130	.	T	C	7	9	16	0	0	16	0	0
11	13282225	.	T	C	8	1	9	0	5	14	0	0
11	13282660	.	C	T	9	9	18	0	0	18	0	0
11	13282881	.	T	C	10	6	16	0	1	17	0	0
11	13282883	.	A	G	11	5	16	0	1	17	0	0
11	13283156	.	T	A	5	18	23	0	1	24	0	0
11	13283181	.	C	T	7	15	22	0	0	22	0	0
11	13283220	.	C	G	2	14	16	0	10	26	0	0
11	13283243	.	T	C	13	0	13	0	13	26	0	0
11	13283335	.	A	G	9	10	19	0	1	21	1	0
11	13283398	.	G	C	11	10	21	0	0	21	0	0
11	13283569	.	G	A	8	6	14	0	0	14	0	0
11	13292012	.	C	T	7	5	12	0	0	12	0	0
11	13292027	.	A	T	4	5	9	0	0	9	0	0
11	13297711	.	T	C	10	4	14	0	2	16	0	0
11	13304426	.	G	A	3	8	11	0	1	12	0	0
11	13305874	.	T	C	3	7	10	0	0	10	0	0
11	13305949	.	G	A	9	8	17	0	0	17	0	0
11	13341189	.	G	A	2	3	5	0	0	5	0	0
11	13424543	.	G	A	1	3	4	0	0	4	0	0
11	13445944	.	A	T	2	5	7	0	0	7	0	0
11	13445981	.	T	C	6	4	10	0	0	10	0	0
11	13446023	.	C	T	5	5	10	0	0	10	0	0
11	13480257	.	A	T	4	2	6	0	1	7	0	0
11	13485098	.	G	A	2	2	4	0	1	5	0	0
11	13494666	.	T	A	2	4	6	0	1	7	0	0
11	13503124	.	T	G	2	0	2	0	3	5	0	0
11	13503351	.	A	G	3	3	6	0	0	6	0	0
11	13503834	.	A	G	1	2	3	0	0	3	0	0
11	13503840	.	A	G	1	2	3	0	0	3	0	0
11	13503938	.	A	G	1	3	4	0	0	4	0	0
11	13504343	.	A	C	4	5	9	0	0	9	0	0
11	13504403	.	C	T	4	2	6	0	0	6	0	0
11	13504563	.	A	C	2	3	5	0	0	5	0	0
11	13504645	.	C	T	3	3	6	0	0	6	0	0
11	13504702	.	C	T	2	2	4	0	0	4	0	0
11	13505186	.	C	A	12	4	16	0	0	16	0	0
11	13505247	.	A	T	3	2	5	0	0	5	0	0
11	13529975	.	G	T	9	4	13	0	0	13	0	0
11	13530498	.	G	A	6	4	10	0	1	11	0	0
11	13531730	.	C	T	6	14	20	0	0	20	0	0
11	13531954	.	C	T	10	8	18	0	0	18	0	0
11	13532567	.	T	C	6	7	13	0	1	14	0	0
11	13532922	.	C	T	2	5	7	0	1	8	0	0
11	13533072	.	A	G	4	15	19	0	0	19	0	0
11	13533214	.	A	G	9	0	9	0	2	11	0	0
11	13533388	.	T	A	11	7	18	0	0	18	0	0
11	14015301	.	C	T	3	2	5	0	1	6	0	0
11	14017690	.	C	T	1	2	3	0	0	3	0	0
11	14035391	.	T	C	3	2	5	0	0	5	0	0
11	14062138	.	T	C	1	3	4	0	0	4	0	0
11	14062357	.	C	T	2	2	4	0	0	4	0	0
11	14062453	.	C	G	2	2	4	0	0	4	0	0
11	14062583	.	C	T	2	2	4	0	0	4	0	0
11	14063625	.	C	A	4	4	8	0	0	8	0	0
11	14063678	.	T	A	1	4	5	0	0	5	0	0
11	14063679	.	T	A	1	4	5	0	0	5	0	0
11	14064156	.	A	T	1	2	3	0	1	4	0	0
11	14073049	.	T	A	8	3	11	0	1	12	0	0
11	14073444	.	C	T	8	10	18	0	2	20	0	0
11	14073857	.	C	A	12	5	17	0	1	18	0	0
11	14073858	.	A	T	12	5	17	0	0	18	1	0
11	14074174	.	T	C	10	7	17	0	0	17	0	0
11	14074397	.	A	G	6	3	9	0	0	9	0	0
11	14074843	.	A	C	6	5	11	1	2	14	0	0
11	14102018	.	C	T	5	2	7	0	0	7	0	0
11	14104571	.	T	A	1	3	4	0	0	4	0	0
11	14112316	.	G	A	0	1	1	0	2	3	0	0
11	14112328	.	A	G	2	2	4	0	0	4	0	0
11	14112469	.	T	C	1	6	7	0	1	8	0	0
11	14132176	.	C	G	4	0	4	0	4	8	0	0
11	14137901	.	C	A	3	5	8	0	0	8	0	0
11	14137988	.	C	T	6	9	15	0	0	15	0	0
11	14138006	.	T	G	6	9	15	0	2	17	0	0
11	14143498	.	T	C	3	2	5	0	0	5	0	0
11	14148179	.	A	G	8	6	14	0	1	15	0	0
11	14148341	.	T	A	12	13	25	0	3	28	0	0
11	14149964	.	T	C	16	12	28	0	0	28	0	0
11	14159425	.	C	T	17	17	34	0	2	36	0	0
11	14159513	.	A	G	10	19	29	0	0	29	0	0
11	14159555	.	A	G	9	19	28	0	0	28	0	0
11	14159622	.	T	C	16	12	28	0	1	29	0	0
11	14159979	.	T	C	18	20	38	0	0	38	0	0
11	14160131	.	A	G	19	18	37	0	0	37	0	0
11	14160941	.	C	A	7	13	20	0	2	22	0	0
11	14161073	.	A	G	22	15	37	0	1	38	0	0
11	14161077	.	C	A	20	10	30	0	5	35	0	0
11	14161291	.	A	T	12	18	30	0	0	30	0	0
11	14161304	.	A	G	11	18	29	1	1	31	0	0
11	14199913	.	G	C	1	15	16	0	7	23	0	0
11	14249012	.	A	G	6	10	16	1	1	18	0	0
11	14267236	.	A	G	9	0	9	0	8	17	0	0
11	14267686	.	A	G	2	3	5	0	0	5	0	0
11	14291221	.	T	C	1	2	3	0	0	3	0	0
11	14291244	.	T	C	2	2	4	0	0	4	0	0
11	14318637	.	A	G	7	4	11	0	0	11	0	0
11	14318647	.	C	G	5	4	9	0	0	9	0	0
11	14326929	.	T	A	1	3	4	0	0	4	0	0
11	14333489	.	T	C	1	2	3	0	0	3	0	0
11	14338397	.	C	G	5	9	14	0	0	14	0	0
11	14338460	.	G	A	2	4	6	0	0	6	0	0
11	14341498	.	T	A	5	2	7	0	0	7	0	0
11	14341510	.	A	C	5	3	8	0	0	8	0	0
11	14341557	.	G	A	5	3	8	0	0	8	0	0
11	14341610	.	C	A	4	2	6	0	1	7	0	0
11	14341669	.	C	A	2	4	6	0	0	6	0	0
11	14342379	.	A	C	2	3	5	0	0	5	0	0
11	14343567	.	A	C	10	4	14	0	0	14	0	0
11	14343612	.	T	G	8	3	11	0	0	11	0	0
11	14344976	.	G	T	1	4	5	0	0	5	0	0
11	14344989	.	G	A	0	3	3	0	1	4	0	0
11	14345062	.	T	A	1	6	7	0	0	7	0	0
11	14345064	.	C	T	1	6	7	0	0	7	0	0
11	14345156	.	C	A	3	2	5	0	0	5	0	0
11	14345562	.	T	G	9	4	13	0	1	14	0	0
11	14345638	.	C	T	4	3	7	0	0	7	0	0
11	14345753	.	A	G	7	14	21	0	1	22	0	0
11	14345830	.	T	C	6	3	9	0	0	9	0	0
11	14345884	.	T	G	4	8	12	0	0	12	0	0
11	14345910	.	A	T	3	6	9	0	0	9	0	0
11	14345922	.	T	G	2	4	6	0	0	6	0	0
11	14346028	.	A	C	2	2	4	0	0	4	0	0
11	14346039	.	A	G	1	1	2	0	1	3	0	0
11	14431519	.	G	C	3	6	9	0	0	9	0	0
11	14431661	.	G	A	3	2	5	0	1	6	0	0
11	14431750	.	A	G	3	0	3	0	5	8	0	0
11	14432169	.	C	A	2	3	5	0	1	6	0	0
11	14639030	.	T	C	14	8	22	0	0	22	0	0
11	14640002	.	G	T	0	6	6	0	2	8	0	0
11	14640155	.	A	G	3	3	6	0	0	6	0	0
11	14676340	.	T	C	7	15	22	0	1	23	0	0
11	14676365	.	G	T	5	15	20	0	0	20	0	0
11	14676541	.	A	G	2	0	2	0	4	6	0	0
11	14676604	.	A	T	7	3	10	0	0	10	0	0
11	14749156	.	G	A	9	5	14	0	0	14	0	0
11	14751068	.	T	C	7	7	14	0	0	14	0	0
11	14957155	.	A	T	21	10	31	0	2	33	0	0
11	15000991	.	C	A	18	18	36	0	0	36	0	0
11	15250544	.	T	C	16	9	25	0	0	25	0	0
11	15281992	.	G	A	4	7	11	0	0	11	0	0
11	15833846	.	T	C	7	6	13	0	0	13	0	0
11	15910604	.	G	C	4	3	7	0	0	7	0	0
11	15915274	.	G	T	3	7	10	0	0	10	0	0
11	15972599	.	T	C	3	2	5	0	0	5	0	0
11	15972646	.	C	A	2	2	4	0	3	7	0	0
11	15975556	.	C	T	5	7	12	0	1	13	0	0
11	16005711	.	C	T	6	14	20	0	0	20	0	0
11	16005862	.	G	A	1	3	4	0	0	4	0	0
11	16005883	.	G	T	2	3	5	0	0	5	0	0
11	16005985	.	A	T	6	2	8	0	0	8	0	0
11	16006016	.	C	T	7	3	10	0	0	10	0	0
11	16006030	.	C	T	6	3	9	0	0	9	0	0
11	16006149	.	C	T	1	9	10	0	0	10	0	0
11	16006154	.	T	A	2	8	10	0	0	10	0	0
11	16006429	.	G	T	1	3	4	0	0	4	0	0
11	16006740	.	G	C	3	2	5	0	0	5	0	0
11	16007461	.	A	G	3	2	5	1	0	6	0	0
11	16010502	.	A	G	3	0	3	0	10	13	0	0
11	16010656	.	T	C	14	14	28	0	0	28	0	0
11	16010799	.	G	C	11	4	15	0	0	15	0	0
11	16010842	.	C	T	10	6	16	0	2	18	0	0
11	16010849	.	A	G	12	0	12	0	6	18	0	0
11	16010978	.	G	A	5	7	12	0	1	13	0	0
11	16010986	.	A	T	4	8	12	0	0	12	0	0
11	16011185	.	C	A	4	5	9	0	0	9	0	0
11	16011414	.	G	A	1	4	5	0	0	5	0	0
11	16011622	.	T	C	9	8	17	1	0	18	0	0
11	16011632	.	T	G	8	0	8	2	8	18	0	0
11	16011705	.	T	C	14	10	24	0	6	30	0	0
11	16011745	.	C	G	21	11	32	0	1	33	0	0
11	16011770	.	T	C	22	17	39	0	3	42	0	0
11	16011807	.	T	C	16	16	32	0	0	32	0	0
11	16011895	.	A	C	16	4	20	0	1	21	0	0
11	16012021	.	G	A	12	10	22	0	0	22	0	0
11	16012117	.	G	T	2	10	12	0	18	30	0	0
11	16012140	.	G	A	1	9	10	0	17	27	0	0
11	16012152	.	A	G	15	1	16	0	12	28	0	0
11	16012191	.	C	T	11	14	25	0	1	26	0	0
11	16012201	.	C	T	8	13	21	0	1	22	0	0
11	16012251	.	T	A	11	5	16	0	0	16	0	0
11	16012256	.	C	T	11	4	15	0	1	16	0	0
11	16012316	.	T	G	9	4	13	0	1	14	0	0
11	16012364	.	G	T	1	7	8	0	7	15	0	0
11	16012414	.	T	C	10	9	19	0	0	19	0	0
11	16012654	.	A	G	11	0	11	0	13	24	0	0
11	16012785	.	T	G	10	16	26	0	0	26	0	0
11	16012786	.	A	G	9	16	25	0	0	26	1	0
11	16012829	.	G	T	13	20	33	0	0	33	0	0
11	16012882	.	G	A	13	11	24	0	1	25	0	0
11	16013018	.	T	C	4	8	12	0	0	12	0	0
11	16013036	.	T	A	3	4	7	0	0	7	0	0
11	16099700	.	G	A	13	11	24	0	0	24	0	0
11	16104175	.	T	C	7	12	19	0	1	20	0	0
11	16115692	.	C	T	6	8	14	0	1	15	0	0
11	16143781	.	T	C	17	20	37	0	1	38	0	0
11	16143829	.	T	C	21	24	45	0	2	47	0	0
11	16152718	.	A	T	1	2	3	0	1	4	0	0
11	16153290	.	C	T	10	11	21	0	0	21	0	0
11	16158555	.	G	A	14	7	21	0	1	22	0	0
11	16159056	.	A	G	12	9	21	0	0	21	0	0
11	16159316	.	C	T	14	9	23	0	1	24	0	0
11	16159875	.	T	C	14	12	26	0	0	26	0	0
11	16159903	.	C	T	10	12	22	0	0	22	0	0
11	16160137	.	A	G	13	0	13	0	16	29	0	0
11	16165293	.	T	C	8	11	19	0	0	19	0	0
11	16165298	.	G	A	1	11	12	0	6	18	0	0
11	16165605	.	T	A	17	7	24	0	0	24	0	0
11	16165665	.	A	G	19	12	31	0	0	31	0	0
11	16165710	.	T	A	15	7	22	0	1	23	0	0
11	16165756	.	G	A	14	5	19	0	0	19	0	0
11	16166137	.	C	G	1	2	3	0	0	3	0	0
11	16168391	.	G	A	2	4	6	0	0	6	0	0
11	16169352	.	T	C	1	3	4	0	0	4	0	0
11	16169412	.	G	T	1	5	6	0	0	6	0	0
11	16179136	.	A	T	2	2	4	0	0	4	0	0
11	16180033	.	G	A	32	26	58	0	1	59	0	0
11	16184739	.	A	G	17	25	42	0	1	43	0	0
11	16184865	.	A	T	17	19	36	1	5	42	0	0
11	16237915	.	C	G	2	3	5	0	1	6	0	0
11	16238173	.	C	T	1	4	5	0	1	6	0	0
11	16586747	.	A	G	1	2	3	0	0	3	0	0
11	16587715	.	A	G	4	7	11	0	1	12	0	0
11	16738849	.	C	T	0	3	3	0	1	4	0	0
11	16739039	.	C	T	2	7	9	0	4	13	0	0
11	16849887	.	T	G	5	7	12	0	0	12	0	0
11	16849896	.	G	A	2	8	10	0	1	11	0	0
11	16974989	.	C	T	0	2	2	0	3	5	0	0
11	17511788	.	T	C	9	5	14	0	0	14	0	0
11	17511902	.	C	A	3	8	11	0	0	11	0	0
11	17511964	.	C	G	4	0	4	0	5	9	0	0
11	17512139	.	T	C	11	10	21	0	0	21	0	0
11	17512289	.	T	C	15	9	24	0	2	26	0	0
11	17512667	.	A	T	5	3	8	0	0	8	0	0
11	17512831	.	T	A	2	4	6	0	0	6	0	0
11	17513174	.	A	G	4	2	6	0	0	6	0	0
11	17513371	.	G	T	2	3	5	0	0	5	0	0
11	17513405	.	C	T	2	3	5	0	1	6	0	0
11	17513424	.	T	A	3	3	6	0	0	6	0	0
11	17513526	.	G	A	2	2	4	0	2	6	0	0
11	17513554	.	T	A	5	3	8	0	0	8	0	0
11	17597424	.	G	A	5	3	8	0	1	9	0	0
11	17713672	.	T	C	7	3	10	0	0	10	0	0
11	17726651	.	A	T	3	3	6	0	0	6	0	0
11	17757767	.	T	C	11	10	21	0	1	22	0	0
11	17757859	.	T	C	4	9	13	0	0	13	0	0
11	17758113	.	T	A	3	3	6	0	0	6	0	0
11	17763137	.	A	G	16	13	29	0	0	29	0	0
11	17763160	.	T	C	13	22	35	0	2	37	0	0
11	17763173	.	C	A	12	21	33	0	1	35	1	0
11	17763393	.	C	T	15	12	27	1	0	28	0	0
11	17765170	.	C	T	6	7	13	0	0	13	0	0
11	17765618	.	T	C	9	0	9	0	8	17	0	0
11	17769238	.	C	T	6	9	15	0	0	15	0	0
11	17769801	.	A	T	7	8	15	0	0	15	0	0
11	17770594	.	C	T	10	7	17	0	0	17	0	0
11	17770627	.	T	C	3	7	10	0	0	10	0	0
11	17771185	.	T	C	7	4	11	0	2	13	0	0
11	17771248	.	T	C	6	6	12	0	1	13	0	0
11	17774893	.	G	A	11	3	14	0	0	14	0	0
11	17778492	.	T	A	9	7	16	0	0	16	0	0
11	17778528	.	T	C	10	0	10	0	6	16	0	0
11	17778597	.	A	G	2	4	6	0	0	6	0	0
11	17778618	.	T	G	5	5	10	0	0	10	0	0
11	17778690	.	G	T	5	6	11	0	2	13	0	0
11	17778819	.	G	A	3	2	5	0	0	5	0	0
11	17778978	.	A	T	2	3	5	0	1	6	0	0
11	17779023	.	T	C	5	3	8	0	0	8	0	0
11	17779028	.	T	G	4	3	7	0	0	7	0	0
11	17779159	.	A	G	8	6	14	0	0	14	0	0
11	17779197	.	A	T	8	5	13	0	0	13	0	0
11	17779254	.	T	C	6	1	7	0	4	11	0	0
11	17779279	.	C	A	5	7	12	0	0	12	0	0
11	17779599	.	A	T	5	5	10	0	1	11	0	0
11	17779630	.	G	A	7	7	14	0	2	16	0	0
11	17779656	.	C	T	0	7	7	0	6	13	0	0
11	17782529	.	A	C	6	0	6	0	9	15	0	0
11	17782683	.	G	A	5	8	13	0	0	13	0	0
11	17782699	.	G	C	3	6	9	0	1	10	0	0
11	17782738	.	A	G	1	3	4	0	0	4	0	0
11	17782845	.	C	T	7	4	11	0	2	13	0	0
11	17782849	.	A	G	9	4	13	0	0	13	0	0
11	17785280	.	C	T	0	2	2	0	2	4	0	0
11	17785402	.	T	G	11	12	23	0	0	23	0	0
11	17785412	.	C	A	12	9	21	0	0	21	0	0
11	17785591	.	A	G	17	13	30	0	0	30	0	0
11	17789069	.	G	T	10	14	24	0	2	26	0	0
11	17789210	.	T	C	17	10	27	0	0	27	0	0
11	17789550	.	A	G	13	8	21	0	1	22	0	0
11	17792991	.	C	T	1	7	8	0	10	18	0	0
11	17793676	.	G	A	7	10	17	0	1	18	0	0
11	17796869	.	C	T	1	11	12	0	9	21	0	0
11	17797072	.	T	C	9	0	9	0	8	17	0	0
11	17797280	.	G	A	13	12	25	0	0	25	0	0
11	17984308	.	T	C	2	5	7	0	1	8	0	0
11	17984405	.	G	A	2	3	5	0	5	10	0	0
11	17984426	.	G	C	1	4	5	0	4	9	0	0
11	17987289	.	C	A	3	6	9	0	0	9	0	0
11	18223383	.	C	T	11	7	18	0	1	19	0	0
11	18238076	.	C	T	8	10	18	0	0	18	0	0
11	18244388	.	T	C	6	8	14	0	3	17	0	0
11	18271303	.	G	A	12	7	19	0	1	20	0	0
11	18277370	.	C	T	0	5	5	0	6	11	0	0
11	18277388	.	G	A	7	6	13	0	0	13	0	0
11	18283013	.	G	A	4	4	8	0	0	8	0	0
11	18283268	.	T	C	2	3	5	0	0	5	0	0
11	18283440	.	A	G	3	3	6	0	0	6	0	0
11	18283525	.	T	C	4	0	4	0	9	13	0	0
11	18287280	.	A	G	3	8	11	0	1	12	0	0
11	18287283	.	A	T	5	8	13	0	0	13	0	0
11	18287693	.	A	G	5	12	17	0	0	17	0	0
11	18287779	.	G	A	3	9	12	0	2	14	0	0
11	18287895	.	T	G	6	3	9	0	0	9	0	0
11	18288018	.	T	C	9	8	17	0	0	17	0	0
11	18288212	.	T	C	7	9	16	0	0	16	0	0
11	18289425	.	T	G	8	7	15	0	0	15	0	0
11	18290095	.	G	A	4	7	11	0	1	12	0	0
11	18291865	.	A	G	9	11	20	0	0	20	0	0
11	18291961	.	C	T	0	8	8	0	6	14	0	0
11	18292595	.	C	T	1	9	10	0	5	15	0	0
11	18292633	.	A	G	8	5	13	0	0	13	0	0
11	18292699	.	T	A	7	5	12	0	0	12	0	0
11	18293166	.	A	G	7	10	17	0	0	17	0	0
11	18294857	.	A	G	8	3	11	0	0	11	0	0
11	18295057	.	T	C	10	5	15	0	0	15	0	0
11	18297113	.	A	G	2	3	5	0	0	5	0	0
11	18299674	.	A	G	4	7	11	0	0	11	0	0
11	18304271	.	T	A	7	2	9	0	0	9	0	0
11	18305756	.	G	A	4	3	7	0	1	8	0	0
11	18305804	.	C	G	9	4	13	0	0	13	0	0
11	18309570	.	T	C	4	4	8	0	0	8	0	0
11	18315937	.	G	A	2	3	5	0	0	5	0	0
11	18315955	.	C	T	1	5	6	0	0	6	0	0
11	18345580	.	T	C	4	3	7	0	0	7	0	0
11	18345825	.	A	T	2	2	4	0	1	5	0	0
11	18345887	.	C	G	3	3	6	0	1	7	0	0
11	18346827	.	C	T	0	2	2	0	3	5	0	0
11	18347229	.	G	A	7	3	10	0	0	10	0	0
11	18347895	.	T	A	1	2	3	0	1	4	0	0
11	18348039	.	C	A	1	2	3	0	0	3	0	0
11	18397265	.	T	C	5	2	7	0	0	7	0	0
11	18397705	.	A	T	1	2	3	0	0	3	0	0
11	18397706	.	T	C	1	2	3	0	0	3	0	0
11	18397744	.	T	C	2	3	5	0	0	5	0	0
11	18397847	.	C	T	2	3	5	0	0	5	0	0
11	18397848	.	C	T	2	1	3	0	2	5	0	0
11	18397890	.	C	A	1	1	2	1	1	4	0	0
11	18398269	.	A	T	2	1	3	0	1	4	0	0
11	18398279	.	G	A	2	4	6	0	0	6	0	0
11	18398441	.	T	C	1	0	1	0	3	4	0	0
11	18398470	.	T	C	4	0	4	0	3	7	0	0
11	18398517	.	T	C	7	4	11	0	0	11	0	0
11	18398555	.	T	G	3	4	7	0	1	8	0	0
11	18398741	.	T	C	2	3	5	0	0	5	0	0
11	18398944	.	T	C	6	0	6	0	3	9	0	0
11	18399303	.	A	G	2	3	5	0	0	5	0	0
11	18399346	.	T	A	2	2	4	0	0	4	0	0
11	18535666	.	C	T	11	21	32	0	0	32	0	0
11	18535761	.	G	C	14	14	28	0	2	30	0	0
11	18537180	.	A	G	11	5	16	0	1	17	0	0
11	18537244	.	G	A	16	5	21	0	1	22	0	0
11	18537447	.	T	C	7	7	14	0	0	14	0	0
11	18537561	.	T	A	10	6	16	0	2	18	0	0
11	18537636	.	T	A	11	12	23	0	0	23	0	0
11	18538219	.	A	T	10	9	19	0	0	19	0	0
11	18538259	.	G	T	17	13	30	0	2	32	0	0
11	18538336	.	A	C	20	0	20	0	10	30	0	0
11	18538362	.	T	C	15	0	15	0	13	28	0	0
11	18541931	.	C	T	1	5	6	0	4	10	0	0
11	18542168	.	T	C	5	10	15	0	0	15	0	0
11	18542585	.	A	G	8	7	15	0	0	15	0	0
11	18543520	.	T	A	6	6	12	0	3	15	0	0
11	18543543	.	T	A	7	6	13	0	1	14	0	0
11	18543828	.	T	C	8	6	14	0	2	16	0	0
11	18543870	.	A	G	3	3	6	0	1	7	0	0
11	18546088	.	G	T	2	4	6	0	0	6	0	0
11	18546276	.	T	A	2	2	4	0	0	4	0	0
11	18546378	.	T	A	4	4	8	0	1	9	0	0
11	18547125	.	A	G	15	16	31	0	0	31	0	0
11	18551011	.	C	A	1	10	11	0	5	16	0	0
11	18551077	.	G	A	8	3	11	0	1	12	0	0
11	18551089	.	G	A	5	5	10	0	1	11	0	0
11	18551605	.	C	T	1	6	7	0	13	20	0	0
11	18561493	.	G	A	5	4	9	0	0	9	0	0
11	18568971	.	G	A	9	5	14	0	0	14	0	0
11	18572364	.	T	C	9	0	9	0	15	24	0	0
11	18572574	.	G	A	15	8	23	0	1	24	0	0
11	18572586	.	C	T	15	11	26	0	1	27	0	0
11	18572640	.	T	G	12	9	21	0	2	23	0	0
11	18572648	.	G	A	11	10	21	0	1	22	0	0
11	18572751	.	G	A	15	11	26	0	0	26	0	0
11	18575095	.	C	A	4	11	15	1	0	16	0	0
11	18575161	.	C	G	9	10	19	0	0	19	0	0
11	18575173	.	G	T	9	9	18	0	0	18	0	0
11	18575258	.	T	G	7	5	12	0	1	13	0	0
11	18575326	.	G	T	9	3	12	0	0	12	0	0
11	18577787	.	A	G	4	9	13	0	1	15	1	0
11	18579921	.	C	T	1	6	7	0	7	14	0	0
11	18580059	.	C	T	0	5	5	0	4	9	0	0
11	18580293	.	T	C	5	0	5	0	10	15	0	0
11	18586264	.	T	C	6	0	6	0	9	15	0	0
11	18586445	.	T	C	4	6	10	0	0	10	0	0
11	18587719	.	T	G	5	7	12	0	2	14	0	0
11	18587720	.	A	G	6	7	13	0	1	14	0	0
11	18592065	.	A	G	11	5	16	0	0	16	0	0
11	18665791	.	A	T	3	5	8	1	0	9	0	0
11	18678321	.	T	C	5	2	7	0	0	7	0	0
11	18678344	.	T	G	4	2	6	0	0	6	0	0
11	18681078	.	C	G	3	2	5	0	0	5	0	0
11	18681103	.	G	A	0	3	3	0	3	6	0	0
11	18681382	.	A	G	5	1	6	0	5	11	0	0
11	18681607	.	G	A	6	4	10	0	0	10	0	0
11	18682694	.	A	G	3	9	12	0	2	14	0	0
11	18682826	.	T	C	4	4	8	0	2	10	0	0
11	18697720	.	A	G	15	9	24	0	3	27	0	0
11	18697817	.	T	G	5	9	14	0	0	14	0	0
11	18697822	.	A	G	6	0	6	0	9	15	0	0
11	18698138	.	A	G	2	0	2	0	9	11	0	0
11	18698184	.	G	A	0	3	3	0	2	5	0	0
11	18698526	.	G	A	11	3	14	0	1	15	0	0
11	18699104	.	T	C	9	12	21	0	0	21	0	0
11	18704378	.	G	C	5	0	5	0	6	11	0	0
11	18704500	.	G	A	17	10	27	0	0	27	0	0
11	18704620	.	C	T	1	10	11	0	29	40	0	0
11	18705108	.	A	G	19	27	46	0	1	47	0	0
11	18784949	.	A	T	9	11	20	0	1	21	0	0
11	18785130	.	A	G	14	17	31	0	2	33	0	0
11	18785250	.	C	T	1	20	21	0	14	35	0	0
11	18785294	.	T	G	16	15	31	0	0	31	0	0
11	18785296	.	C	T	15	15	30	0	1	31	0	0
11	18785346	.	A	T	16	11	27	0	3	30	0	0
11	18785410	.	G	A	8	15	23	0	1	24	0	0
11	18785421	.	A	G	7	16	23	0	1	24	0	0
11	18785570	.	T	A	10	7	17	0	0	17	0	0
11	18785600	.	A	T	13	8	21	0	0	21	0	0
11	18785623	.	A	T	13	10	23	0	0	23	0	0
11	18785749	.	C	G	5	3	8	0	0	8	0	0
11	18785921	.	G	A	13	14	27	0	0	27	0	0
11	18785975	.	T	C	15	22	37	0	0	37	0	0
11	18785997	.	T	A	16	18	34	0	0	34	0	0
11	18786085	.	A	T	9	12	21	0	1	22	0	0
11	18786250	.	A	C	11	28	39	0	1	40	0	0
11	18786329	.	C	A	2	21	23	0	13	36	0	0
11	18794157	.	C	A	0	7	7	0	8	15	0	0
11	18799800	.	C	T	8	4	12	0	2	14	0	0
11	18799873	.	G	A	4	11	15	0	0	15	0	0
11	18802815	.	G	C	8	3	11	0	0	11	0	0
11	18802865	.	C	G	3	2	5	0	0	5	0	0
11	18802879	.	A	G	1	3	4	0	0	4	0	0
11	18803069	.	A	G	6	2	8	0	0	8	0	0
11	18803621	.	A	G	5	7	12	0	0	12	0	0
11	18805988	.	A	T	5	5	10	0	1	11	0	0
11	18806030	.	A	G	4	6	10	0	0	10	0	0
11	18809354	.	G	A	1	3	4	0	0	4	0	0
11	18816379	.	G	T	1	2	3	0	0	3	0	0
11	19062652	.	A	C	2	6	8	0	8	16	0	0
11	19062655	.	A	C	6	5	11	0	6	17	0	0
11	19502363	.	G	T	9	3	12	0	1	13	0	0
11	19512681	.	T	C	2	2	4	0	0	4	0	0
11	20017802	.	A	G	5	6	11	0	0	11	0	0
11	21281657	.	T	C	23	6	29	0	0	29	0	0
11	21281673	.	T	C	22	6	28	0	0	28	0	0
11	21281726	.	T	C	15	4	19	0	0	19	0	0
11	21281811	.	T	C	7	2	9	0	0	9	0	0
11	21281812	.	T	C	7	2	9	0	0	9	0	0
11	23856426	.	A	G	10	5	15	0	1	16	0	0
11	23856440	.	A	G	6	12	18	0	0	18	0	0
11	24054894	.	A	G	9	6	15	0	0	15	0	0
11	24055425	.	A	G	8	3	11	0	0	11	0	0
11	24340295	.	T	G	6	1	7	0	7	14	0	0
11	24340299	.	C	G	5	0	5	0	8	13	0	0
11	25561030	.	A	T	2	4	6	3	0	9	0	0
11	25668940	.	T	C	4	2	6	0	0	6	0	0
11	25713728	.	T	C	7	7	14	0	1	15	0	0
11	25713820	.	T	C	6	7	13	0	1	14	0	0
11	25713913	.	T	C	5	9	14	0	0	14	0	0
11	26229587	.	T	C	5	2	7	1	3	11	0	0
11	26229589	.	T	C	12	1	13	1	0	14	0	0
11	26230551	.	A	T	1	4	5	0	0	5	0	0
11	26233522	.	A	T	4	7	11	0	3	14	0	0
11	26545779	.	A	G	4	2	6	0	0	6	0	0
11	28125275	.	A	T	5	2	7	0	0	7	0	0
11	28597465	.	T	A	8	2	10	0	0	10	0	0
11	29818613	.	T	C	9	4	13	0	0	13	0	0
11	29918069	.	T	C	6	4	10	0	0	10	0	0
11	29918070	.	T	C	5	4	9	0	0	9	0	0
11	29918109	.	A	T	9	2	11	0	0	11	0	0
11	29918110	.	A	G	9	2	11	0	0	11	0	0
11	29918203	.	T	C	5	5	10	0	0	10	0	0
11	30367029	.	C	A	4	3	7	0	0	7	0	0
11	30640954	.	A	G	3	2	5	0	0	5	0	0
11	30642065	.	A	G	4	3	7	0	0	7	0	0
11	30642164	.	A	G	5	3	8	0	0	8	0	0
11	30946960	.	A	G	6	6	12	0	0	12	0	0
11	31024887	.	A	G	15	5	20	0	0	20	0	0
11	31558251	.	G	A	1	4	5	0	9	14	0	0
11	31558634	.	C	A	23	13	36	0	1	37	0	0
11	31558782	.	C	T	5	9	14	0	1	15	0	0
11	31602828	.	G	T	8	7	15	0	1	16	0	0
11	31603346	.	G	A	0	2	2	0	4	6	0	0
11	31611648	.	C	T	2	2	4	0	0	4	0	0
11	31616735	.	A	C	1	3	4	0	0	4	0	0
11	31620834	.	A	G	1	3	4	0	0	4	0	0
11	31620837	.	T	A	1	3	4	0	0	4	0	0
11	31621001	.	C	G	7	2	9	0	0	9	0	0
11	31621018	.	T	C	6	4	10	0	0	10	0	0
11	31621528	.	G	T	1	2	3	0	0	3	0	0
11	31621545	.	G	A	0	2	2	0	1	3	0	0
11	31647283	.	A	C	13	7	20	0	0	20	0	0
11	31649781	.	G	A	1	9	10	0	13	23	0	0
11	31653670	.	T	G	5	0	5	0	9	14	0	0
11	31653700	.	T	C	8	8	16	0	0	16	0	0
11	31664070	.	T	C	7	17	24	0	0	24	0	0
11	31664108	.	T	C	8	14	22	0	3	25	0	0
11	31667490	.	C	A	12	12	24	0	0	24	0	0
11	31667592	.	C	T	17	13	30	0	2	32	0	0
11	31667658	.	C	T	21	15	36	0	1	37	0	0
11	31667946	.	G	A	17	5	22	0	2	24	0	0
11	31668186	.	A	G	8	4	12	0	0	17	5	0
11	31668191	.	A	T	6	4	10	0	0	15	5	0
11	31668330	.	C	A	5	9	14	0	2	16	0	0
11	31668394	.	T	G	5	12	17	0	1	18	0	0
11	31668540	.	T	A	4	6	10	0	0	10	0	0
11	31668588	.	C	A	4	2	6	0	0	6	0	0
11	31668737	.	T	A	4	4	8	0	1	9	0	0
11	31668759	.	T	C	5	4	9	0	0	9	0	0
11	31668824	.	T	A	13	4	17	0	2	19	0	0
11	31668893	.	T	C	3	4	7	0	0	7	0	0
11	31668964	.	G	C	1	5	6	0	0	6	0	0
11	31669336	.	G	T	3	4	7	0	1	8	0	0
11	31669343	.	A	G	3	0	3	0	6	9	0	0
11	31670216	.	A	T	6	8	14	0	1	15	0	0
11	31670534	.	T	C	2	7	9	0	0	9	0	0
11	31670605	.	T	A	1	5	6	0	0	6	0	0
11	31670610	.	A	T	0	7	7	0	0	7	0	0
11	31670724	.	A	G	8	0	8	0	5	13	0	0
11	31670749	.	C	A	7	4	11	0	0	11	0	0
11	31670789	.	C	T	14	3	17	0	2	19	0	0
11	31670808	.	C	A	18	5	23	0	1	24	0	0
11	31670830	.	T	C	18	6	24	0	1	25	0	0
11	31670868	.	T	C	16	6	22	0	0	22	0	0
11	31670881	.	T	A	12	6	18	0	0	18	0	0
11	31671072	.	T	C	4	2	6	0	0	6	0	0
11	31671165	.	G	C	3	7	10	0	0	10	0	0
11	31671189	.	A	G	1	6	7	0	0	7	0	0
11	31671326	.	G	T	0	12	12	0	4	16	0	0
11	31671328	.	T	G	3	12	15	0	1	16	0	0
11	32576695	.	C	T	13	10	23	0	2	25	0	0
11	32577076	.	T	A	6	5	11	0	0	11	0	0
11	32577258	.	C	T	3	15	18	0	9	27	0	0
11	32577404	.	A	G	13	17	30	0	3	33	0	0
11	32577439	.	G	A	10	16	26	3	4	33	0	0
11	32577800	.	G	A	16	10	26	0	0	26	0	0
11	32577830	.	G	A	13	13	26	0	1	27	0	0
11	32578082	.	C	T	9	17	26	0	3	29	0	0
11	32578172	.	G	A	18	8	26	0	2	28	0	0
11	32720124	.	C	T	19	10	29	0	1	30	0	0
11	32720427	.	A	T	15	11	26	0	1	27	0	0
11	32720505	.	C	T	13	9	22	0	0	22	0	0
11	32720730	.	C	G	8	11	19	0	1	20	0	0
11	32720856	.	A	G	9	5	14	0	0	14	0	0
11	32721057	.	T	A	7	6	13	0	0	13	0	0
11	32721144	.	A	G	9	17	26	0	0	26	0	0
11	32721168	.	A	G	14	16	30	0	1	31	0	0
11	32721333	.	A	G	7	7	14	0	1	15	0	0
11	32721492	.	A	C	9	0	9	0	1	10	0	0
11	32721498	.	T	G	9	3	12	0	1	13	0	0
11	32721765	.	A	G	7	5	12	0	1	13	0	0
11	32721843	.	G	A	6	11	17	0	2	19	0	0
11	32722547	.	A	G	6	7	13	0	0	13	0	0
11	32723520	.	G	A	3	6	9	0	0	9	0	0
11	32723691	.	C	T	6	11	17	0	0	17	0	0
11	33477594	.	T	C	1	2	3	0	0	3	0	0
11	33514693	.	T	G	2	2	4	0	0	4	0	0
11	33517742	.	T	C	2	2	4	0	0	4	0	0
11	33530170	.	T	C	3	3	6	0	1	7	0	0
11	33532289	.	A	G	1	2	3	0	0	3	0	0
11	33537289	.	G	T	0	2	2	0	4	6	0	0
11	33537327	.	A	G	3	2	5	0	1	6	0	0
11	33537435	.	C	T	6	2	8	0	0	8	0	0
11	33539693	.	T	C	5	3	8	0	1	9	0	0
11	33551200	.	T	C	6	13	19	0	0	19	0	0
11	33553873	.	T	C	10	6	16	0	0	16	0	0
11	33554087	.	G	A	11	8	19	0	0	19	0	0
11	33554116	.	G	A	12	10	22	0	1	23	0	0
11	33554535	.	T	C	4	4	8	0	0	8	0	0
11	33599038	.	T	C	5	4	9	0	3	12	0	0
11	33599148	.	T	C	15	9	24	0	2	26	0	0
11	33599187	.	T	C	15	0	15	0	14	29	0	0
11	33599223	.	A	G	17	15	32	0	0	32	0	0
11	33599240	.	A	T	17	10	27	0	2	29	0	0
11	33599464	.	C	T	2	4	6	0	7	13	0	0
11	33599900	.	C	T	0	6	6	0	9	15	0	0
11	33600015	.	G	A	4	4	8	0	0	8	0	0
11	33600215	.	A	G	22	13	35	0	1	36	0	0
11	33600350	.	T	G	19	3	22	0	2	24	0	0
11	33600551	.	C	A	3	2	5	0	0	5	0	0
11	33600572	.	T	A	3	3	6	0	0	6	0	0
11	33600646	.	T	C	4	0	4	1	7	12	0	0
11	33600742	.	A	T	11	7	18	0	2	20	0	0
11	33600862	.	G	A	5	3	8	0	2	10	0	0
11	33600918	.	C	A	1	3	4	0	3	7	0	0
11	33610214	.	A	G	4	3	7	0	0	7	0	0
11	33751546	.	A	G	1	6	7	0	0	7	0	0
11	33751572	.	A	G	2	4	6	0	0	6	0	0
11	33763007	.	C	T	1	3	4	0	0	4	0	0
11	33772552	.	C	T	2	3	5	0	0	5	0	0
11	33827023	.	G	A	4	8	12	0	0	12	0	0
11	33829443	.	A	G	8	9	17	0	0	17	0	0
11	33829515	.	A	G	6	5	11	0	0	11	0	0
11	33832679	.	C	T	6	13	19	0	0	19	0	0
11	33834700	.	A	G	11	17	28	0	0	28	0	0
11	33835385	.	C	A	8	13	21	0	1	22	0	0
11	33835542	.	T	C	9	10	19	0	0	19	0	0
11	33839169	.	C	T	14	19	33	0	1	34	0	0
11	33841788	.	C	T	11	18	29	0	2	31	0	0
11	33841984	.	C	T	12	13	25	0	1	26	0	0
11	33842542	.	C	T	1	3	4	0	1	5	0	0
11	33846497	.	T	C	8	7	15	0	1	16	0	0
11	33846519	.	T	C	11	6	17	0	3	20	0	0
11	33846566	.	T	C	5	12	17	0	2	19	0	0
11	33846583	.	A	G	7	8	15	0	0	15	0	0
11	33846657	.	G	A	7	8	15	0	0	15	0	0
11	33846729	.	T	C	6	0	6	0	7	13	0	0
11	33847080	.	T	G	6	4	10	0	0	10	0	0
11	33847123	.	C	T	1	5	6	0	1	7	0	0
11	33847293	.	G	A	6	3	9	0	0	9	0	0
11	33855666	.	G	A	7	6	13	0	1	14	0	0
11	33857576	.	A	C	4	7	11	0	0	11	0	0
11	33857580	.	G	A	5	7	12	0	0	12	0	0
11	33857833	.	T	C	8	10	18	0	0	18	0	0
11	33870434	.	A	G	1	2	3	0	0	3	0	0
11	33870464	.	A	T	4	5	9	0	0	9	0	0
11	33871099	.	G	A	7	2	9	1	0	10	0	0
11	33871197	.	T	C	3	0	3	0	4	7	0	0
11	33871210	.	A	G	4	3	7	0	0	7	0	0
11	33871466	.	A	G	17	12	29	3	1	33	0	0
11	33871575	.	A	G	27	15	42	0	0	42	0	0
11	33871897	.	C	T	18	6	24	0	3	27	0	0
11	33871931	.	G	C	15	7	22	0	0	22	0	0
11	33871932	.	C	A	14	7	21	0	0	21	0	0
11	33872289	.	T	C	12	0	12	0	7	19	0	0
11	33872411	.	A	C	9	5	14	0	0	14	0	0
11	33872442	.	A	G	7	3	10	0	1	11	0	0
11	33872564	.	G	T	16	11	27	1	0	28	0	0
11	33872829	.	C	T	0	5	5	0	7	12	0	0
11	33873408	.	T	C	4	2	6	0	0	6	0	0
11	33873578	.	A	C	14	8	22	0	1	23	0	0
11	33880086	.	A	G	13	3	16	0	1	17	0	0
11	33880089	.	C	T	3	4	7	0	10	17	0	0
11	33887086	.	C	T	1	3	4	0	2	6	0	0
11	33888884	.	G	A	4	6	10	0	0	10	0	0
11	33900436	.	G	C	3	4	7	0	0	7	0	0
11	33902283	.	C	A	4	2	6	0	0	6	0	0
11	33905668	.	G	A	1	2	3	0	1	4	0	0
11	33912597	.	C	A	4	4	8	0	0	8	0	0
11	33912645	.	T	G	4	6	10	0	0	10	0	0
11	33996987	.	A	C	3	2	5	0	0	5	0	0
11	33996989	.	A	G	3	2	5	0	0	5	0	0
11	33997540	.	T	C	3	2	5	0	1	6	0	0
11	33998153	.	G	T	2	2	4	0	0	4	0	0
11	33998436	.	A	T	2	2	4	0	0	4	0	0
11	33998450	.	T	C	1	2	3	0	0	3	0	0
11	33998475	.	G	C	0	2	2	0	1	3	0	0
11	34133717	.	A	G	2	2	4	0	0	4	0	0
11	34139447	.	A	G	5	2	7	0	0	7	0	0
11	34158307	.	T	A	1	2	3	0	0	3	0	0
11	34158346	.	T	C	1	2	3	0	0	3	0	0
11	34220436	.	T	C	6	0	6	0	6	12	0	0
11	34230613	.	A	C	8	3	11	0	1	12	0	0
11	34230661	.	C	T	10	4	14	0	0	14	0	0
11	34231302	.	G	A	8	3	11	0	0	11	0	0
11	34232662	.	A	G	4	2	6	0	0	6	0	0
11	34235427	.	C	A	16	10	26	0	0	26	0	0
11	34235498	.	C	G	12	6	18	0	0	18	0	0
11	34235528	.	T	C	10	4	14	0	0	14	0	0
11	34235825	.	A	T	14	9	23	0	3	26	0	0
11	34235858	.	A	C	19	16	35	0	0	35	0	0
11	34235918	.	A	G	16	1	17	0	17	34	0	0
11	34236092	.	G	T	15	6	21	0	0	21	0	0
11	34236769	.	C	T	2	2	4	0	0	4	0	0
11	34236848	.	G	A	3	3	6	0	0	6	0	0
11	34237150	.	C	T	4	10	14	0	1	15	0	0
11	34237217	.	A	G	13	4	17	0	0	17	0	0
11	34237521	.	C	G	7	6	13	0	0	13	0	0
11	34779198	.	T	C	2	3	5	0	0	5	0	0
11	34779244	.	T	A	2	4	6	0	0	6	0	0
11	34780009	.	T	C	5	0	5	0	8	13	0	0
11	34824331	.	G	A	8	6	14	0	0	14	0	0
11	34856424	.	A	G	9	5	14	0	0	14	0	0
11	34859637	.	C	T	2	3	5	0	0	5	0	0
11	34860908	.	C	T	4	6	10	0	1	11	0	0
11	34890099	.	A	G	10	9	19	0	1	20	0	0
11	34899393	.	A	G	12	16	28	1	1	30	0	0
11	34900464	.	C	T	11	10	21	0	0	21	0	0
11	34900516	.	A	G	5	7	12	0	0	12	0	0
11	34900521	.	C	T	5	7	12	0	0	12	0	0
11	34907104	.	C	A	5	5	10	1	2	13	0	0
11	34907118	.	G	T	6	6	12	1	0	13	0	0
11	34907287	.	G	C	10	11	21	0	2	23	0	0
11	34907537	.	A	G	11	0	11	0	5	16	0	0
11	34907682	.	A	G	7	6	13	0	0	13	0	0
11	34907726	.	T	A	6	9	15	0	0	15	0	0
11	34907876	.	T	A	16	9	25	0	0	25	0	0
11	34908165	.	C	T	10	10	20	0	0	20	0	0
11	34908187	.	G	C	11	13	24	0	0	24	0	0
11	34908201	.	C	T	8	10	18	0	0	18	0	0
11	34908431	.	G	A	8	13	21	0	2	23	0	0
11	34908448	.	T	A	20	11	31	0	0	31	0	0
11	34908516	.	C	A	15	6	21	0	0	21	0	0
11	34908545	.	A	T	5	2	7	0	1	8	0	0
11	34908597	.	T	C	7	10	17	0	0	17	0	0
11	34908854	.	T	G	2	5	7	0	0	7	0	0
11	34909268	.	T	A	12	8	20	0	1	21	0	0
11	34909288	.	G	T	0	10	10	0	7	17	0	0
11	34909353	.	C	A	9	7	16	0	0	16	0	0
11	34909489	.	A	G	8	6	14	0	0	14	0	0
11	34909513	.	G	T	10	8	18	0	0	18	0	0
11	34909560	.	T	C	6	3	9	0	0	9	0	0
11	34909618	.	A	G	6	8	14	0	4	18	0	0
11	34909868	.	C	T	11	8	19	0	0	19	0	0
11	34909916	.	C	T	10	15	25	0	1	26	0	0
11	34909997	.	G	T	14	13	27	1	0	28	0	0
11	34910349	.	C	T	11	16	27	0	1	28	0	0
11	34910468	.	T	C	12	12	24	0	0	24	0	0
11	34910487	.	T	C	12	12	24	0	1	25	0	0
11	34910503	.	C	T	11	12	23	0	2	25	0	0
11	34910644	.	C	T	3	7	10	1	3	14	0	0
11	34910654	.	C	T	8	9	17	1	0	18	0	0
11	34910867	.	T	A	16	8	24	0	1	25	0	0
11	34910897	.	A	G	19	14	33	0	1	34	0	0
11	34911192	.	A	G	2	2	4	0	0	4	0	0
11	34911229	.	G	A	16	9	25	0	1	26	0	0
11	34911445	.	A	G	18	12	30	0	0	30	0	0
11	34911451	.	T	A	16	12	28	0	1	29	0	0
11	34912481	.	G	A	21	18	39	0	0	39	0	0
11	34912616	.	G	A	20	16	36	0	0	36	0	0
11	34912850	.	G	A	21	12	33	2	0	35	0	0
11	34913101	.	C	A	17	10	27	0	0	27	0	0
11	34914190	.	G	A	17	23	40	0	2	42	0	0
11	35034669	.	G	A	14	17	31	0	1	32	0	0
11	35038124	.	G	C	1	14	15	0	8	23	0	0
11	35056344	.	A	G	0	4	4	0	0	4	0	0
11	35438612	.	A	C	5	9	14	0	4	18	0	0
11	36158379	.	A	C	7	6	13	0	0	13	0	0
11	36158839	.	G	T	3	6	9	0	0	9	0	0
11	36180612	.	C	T	7	12	19	0	1	20	0	0
11	36180666	.	C	T	5	5	10	0	2	12	0	0
11	36180774	.	A	G	7	4	11	0	1	12	0	0
11	36180775	.	T	C	7	5	12	0	0	12	0	0
11	36180831	.	G	T	2	6	8	0	7	15	0	0
11	36205992	.	C	T	9	8	17	0	1	18	0	0
11	36206090	.	C	T	6	8	14	0	1	15	0	0
11	36208199	.	G	A	10	16	26	0	0	26	0	0
11	36208328	.	G	A	1	5	6	0	9	15	0	0
11	36214517	.	C	T	22	20	42	0	2	44	0	0
11	36214815	.	G	A	1	16	17	0	15	32	0	0
11	36214859	.	C	T	14	16	30	0	1	31	0	0
11	36214955	.	A	T	10	13	23	0	3	26	0	0
11	36215346	.	G	A	14	10	24	0	2	26	0	0
11	36215399	.	A	G	15	12	27	0	3	30	0	0
11	36218548	.	G	C	3	5	8	0	0	8	0	0
11	36219658	.	C	T	0	5	5	0	1	6	0	0
11	36224573	.	G	A	2	4	6	0	2	8	0	0
11	36224767	.	G	A	2	2	4	0	1	5	0	0
11	36224780	.	T	C	2	0	2	0	3	5	0	0
11	36224833	.	C	T	1	3	4	0	0	4	0	0
11	36231440	.	A	C	2	4	6	0	0	6	0	0
11	36237094	.	C	T	2	3	5	0	0	5	0	0
11	36237421	.	T	C	2	6	8	0	0	8	0	0
11	36254653	.	C	A	0	3	3	0	6	9	0	0
11	36269682	.	G	A	10	7	17	0	1	18	0	0
11	36269768	.	A	G	15	9	24	0	1	25	0	0
11	36269788	.	A	G	22	11	33	0	0	33	0	0
11	36281939	.	T	G	7	12	19	0	1	20	0	0
11	36281943	.	G	A	7	12	19	0	1	20	0	0
11	36282417	.	G	T	6	15	21	0	0	21	0	0
11	36282450	.	G	T	10	14	24	0	1	25	0	0
11	36282494	.	G	T	12	9	21	0	0	21	0	0
11	36282501	.	C	T	13	8	21	0	1	22	0	0
11	36282612	.	G	A	9	6	15	0	0	15	0	0
11	36282621	.	T	C	8	0	8	0	2	10	0	0
11	36282792	.	G	C	3	2	5	0	1	6	0	0
11	36282809	.	T	C	4	2	6	0	0	6	0	0
11	36282961	.	G	A	3	3	6	0	0	6	0	0
11	36283061	.	A	G	2	5	7	0	0	7	0	0
11	36283255	.	T	C	2	0	2	0	2	4	0	0
11	36283262	.	T	C	2	1	3	0	0	3	0	0
11	36291207	.	G	A	6	7	13	0	1	14	0	0
11	36291208	.	T	C	5	7	12	0	1	13	0	0
11	36340738	.	C	T	2	2	4	0	0	4	0	0
11	36340801	.	C	T	2	6	8	0	0	8	0	0
11	36340961	.	A	G	5	3	8	0	0	8	0	0
11	36340991	.	T	C	3	3	6	0	0	6	0	0
11	36343167	.	G	C	15	14	29	0	0	29	0	0
11	36343339	.	A	T	15	17	32	0	1	33	0	0
11	36346578	.	A	T	10	13	23	0	2	25	0	0
11	36372685	.	A	G	1	2	3	0	0	3	0	0
11	36372937	.	A	G	2	4	6	0	0	6	0	0
11	36372961	.	G	A	2	5	7	0	0	7	0	0
11	36373148	.	A	T	1	3	4	0	0	4	0	0
11	36373645	.	G	A	0	3	3	1	1	5	0	0
11	36373685	.	G	A	1	3	4	0	1	5	0	0
11	36373738	.	T	C	6	2	8	0	0	8	0	0
11	36373746	.	T	C	6	3	9	0	0	9	0	0
11	36374083	.	G	A	3	3	6	0	0	6	0	0
11	36374703	.	C	G	3	8	11	0	0	11	0	0
11	36374944	.	T	G	7	5	12	0	0	12	0	0
11	36374958	.	T	C	10	5	15	0	0	15	0	0
11	36374993	.	G	T	6	6	12	0	0	12	0	0
11	36375028	.	A	G	5	0	5	0	3	8	0	0
11	36375120	.	T	G	6	3	9	3	0	12	0	0
11	36375177	.	G	A	3	3	6	0	1	7	0	0
11	36375367	.	T	C	5	6	11	0	0	11	0	0
11	36375671	.	C	T	5	10	15	0	1	16	0	0
11	36375708	.	A	G	7	7	14	0	0	14	0	0
11	36375774	.	A	T	6	10	16	0	2	18	0	0
11	36375852	.	T	G	6	8	14	0	0	14	0	0
11	36393111	.	A	G	3	0	3	0	4	7	0	0
11	36393150	.	T	A	5	6	11	0	1	12	0	0
11	36395136	.	A	T	7	3	10	0	1	11	0	0
11	36395728	.	T	C	6	5	11	0	0	11	0	0
11	36398192	.	G	A	1	4	5	0	6	11	0	0
11	36398318	.	A	G	7	4	11	0	0	11	0	0
11	36398531	.	A	G	9	0	9	0	7	16	0	0
11	36398558	.	T	A	9	4	13	0	1	14	0	0
11	36398624	.	C	T	5	5	10	0	0	10	0	0
11	36415190	.	T	C	2	3	5	0	0	5	0	0
11	36422342	.	C	G	6	3	9	0	0	9	0	0
11	36422351	.	G	A	5	3	8	0	0	8	0	0
11	36425270	.	G	A	2	2	4	0	1	5	0	0
11	36429500	.	T	C	1	2	3	0	0	3	0	0
11	36430045	.	A	G	1	4	5	0	0	5	0	0
11	36430149	.	C	A	2	4	6	0	0	6	0	0
11	36430150	.	C	A	0	4	4	0	2	6	0	0
11	36434733	.	C	G	1	2	3	0	0	3	0	0
11	36446409	.	C	T	0	2	2	0	1	3	0	0
11	36452688	.	A	G	6	9	15	0	1	16	0	0
11	36456011	.	C	T	0	3	3	0	3	6	0	0
11	36456101	.	T	A	5	13	18	0	0	18	0	0
11	36456125	.	A	C	4	0	4	0	13	17	0	0
11	36460829	.	G	A	12	9	21	0	0	21	0	0
11	36463965	.	T	C	4	7	11	0	1	12	0	0
11	36464541	.	T	A	5	2	7	0	0	7	0	0
11	36467948	.	C	T	4	7	11	0	0	11	0	0
11	36468047	.	G	A	4	9	13	0	0	13	0	0
11	36470493	.	C	T	1	5	6	0	5	11	0	0
11	36470651	.	G	A	3	9	12	0	1	13	0	0
11	36470678	.	G	A	6	8	14	0	0	14	0	0
11	36471901	.	C	T	3	4	7	0	1	8	0	0
11	36472383	.	G	A	4	7	11	0	0	11	0	0
11	36472395	.	C	T	4	8	12	0	0	12	0	0
11	36473924	.	G	A	2	6	8	0	0	8	0	0
11	36477626	.	G	A	6	7	13	0	2	15	0	0
11	36477777	.	C	T	4	2	6	0	0	6	0	0
11	36482269	.	A	G	4	8	12	0	2	14	0	0
11	36482311	.	C	T	10	6	16	0	0	16	0	0
11	36484836	.	G	A	12	4	16	0	0	16	0	0
11	36489169	.	G	C	8	5	13	0	0	13	0	0
11	36489205	.	T	C	4	9	13	0	1	14	0	0
11	36489428	.	A	T	3	8	11	0	0	11	0	0
11	36489706	.	T	C	2	4	6	0	0	6	0	0
11	36689254	.	C	T	0	5	5	0	4	9	0	0
11	36695076	.	A	G	4	2	6	0	0	6	0	0
11	36695094	.	A	G	2	3	5	0	0	5	0	0
11	36708711	.	T	A	2	3	5	0	0	5	0	0
11	36719259	.	G	A	1	4	5	0	0	5	0	0
11	36795564	.	G	T	8	9	17	0	1	18	0	0
11	36797149	.	C	T	2	13	15	0	9	24	0	0
11	36801796	.	G	A	10	11	21	1	0	22	0	0
11	36806296	.	A	G	14	11	25	0	0	25	0	0
11	36816163	.	T	C	6	7	13	0	4	17	0	0
11	36816171	.	T	C	3	11	14	0	2	16	0	0
11	36819529	.	C	T	6	4	10	0	1	11	0	0
11	36819904	.	G	A	5	3	8	0	0	8	0	0
11	36822599	.	G	A	2	3	5	0	0	5	0	0
11	36847056	.	A	G	5	3	8	0	0	8	0	0
11	36852890	.	G	A	6	5	11	0	0	11	0	0
11	36854225	.	C	G	2	2	4	0	0	4	0	0
11	36865581	.	C	T	2	3	5	0	0	5	0	0
11	37001740	.	C	T	5	5	10	0	0	10	0	0
11	37004565	.	G	A	5	7	12	0	0	12	0	0
11	37015968	.	T	C	9	11	20	0	0	20	0	0
11	37020723	.	C	T	8	10	18	0	1	19	0	0
11	37020807	.	G	T	7	3	10	0	1	11	0	0
11	37031950	.	C	T	6	7	13	0	0	13	0	0
11	37032269	.	G	T	7	3	10	0	0	10	0	0
11	37032391	.	A	G	7	2	9	0	0	9	0	0
11	37032420	.	G	A	2	5	7	0	0	7	0	0
11	37032474	.	A	G	3	3	6	0	0	6	0	0
11	37032546	.	C	T	12	4	16	0	0	16	0	0
11	37032626	.	T	C	13	4	17	0	0	17	0	0
11	37032880	.	G	T	4	3	7	0	0	7	0	0
11	37033356	.	G	T	6	7	13	0	0	13	0	0
11	37033431	.	G	A	4	3	7	0	0	7	0	0
11	37033516	.	G	A	1	4	5	0	0	5	0	0
11	37033552	.	A	G	1	0	1	0	5	6	0	0
11	37033603	.	T	A	6	4	10	1	0	11	0	0
11	37033676	.	C	T	5	6	11	0	0	11	0	0
11	37033767	.	C	T	8	4	12	0	0	12	0	0
11	37033813	.	C	G	11	7	18	0	2	20	0	0
11	37033846	.	G	C	8	9	17	0	2	19	0	0
11	37033855	.	T	A	9	10	19	0	1	20	0	0
11	37033900	.	A	T	5	2	7	0	3	10	0	0
11	37034475	.	T	C	4	5	9	0	0	9	0	0
11	37034963	.	A	G	2	4	6	0	0	6	0	0
11	37035176	.	A	T	6	4	10	0	0	10	0	0
11	37035240	.	T	A	7	5	12	0	8	20	0	0
11	37035454	.	A	G	13	0	13	0	10	23	0	0
11	37049469	.	A	T	3	5	8	0	0	8	0	0
11	37049729	.	G	A	3	2	5	0	0	5	0	0
11	37070083	.	T	C	2	2	4	0	1	5	0	0
11	37070236	.	C	T	4	2	6	0	0	6	0	0
11	37070284	.	G	T	1	4	5	0	0	5	0	0
11	37080971	.	G	T	1	4	5	0	0	5	0	0
11	37088827	.	C	T	1	4	5	0	0	5	0	0
11	37088847	.	A	T	0	6	6	0	0	6	0	0
11	37096571	.	T	A	1	2	3	0	0	3	0	0
11	37101235	.	T	C	4	3	7	0	0	7	0	0
11	37101236	.	T	C	4	3	7	0	0	7	0	0
11	37101270	.	A	C	3	2	5	0	1	6	0	0
11	37109432	.	C	T	3	2	5	0	0	5	0	0
11	37137676	.	G	T	2	4	6	0	1	7	0	0
11	37137762	.	A	T	1	3	4	0	0	4	0	0
11	37137768	.	A	G	1	2	3	0	0	3	0	0
11	37137829	.	A	T	2	6	8	0	0	8	0	0
11	37144864	.	C	T	6	3	9	0	0	9	0	0
11	37152812	.	G	C	3	9	12	0	0	12	0	0
11	37155215	.	A	G	9	0	9	0	10	19	0	0
11	37155394	.	A	G	8	14	22	0	0	22	0	0
11	37155400	.	T	A	11	7	18	0	3	21	0	0
11	37159289	.	T	A	9	14	23	0	0	23	0	0
11	37159902	.	G	A	4	9	13	0	0	13	0	0
11	37159961	.	A	T	8	7	15	0	0	15	0	0
11	37159994	.	T	A	11	0	11	0	0	11	0	0
11	37160052	.	T	A	10	11	21	1	0	22	0	0
11	37162183	.	A	G	8	7	15	0	0	15	0	0
11	37162563	.	C	A	5	9	14	0	1	15	0	0
11	37162564	.	A	T	6	9	15	0	0	15	0	0
11	37162657	.	C	A	13	9	22	0	2	24	0	0
11	37162666	.	G	T	0	21	21	0	0	21	0	0
11	37163874	.	A	G	6	10	16	0	1	17	0	0
11	37163997	.	T	A	10	10	20	0	1	21	0	0
11	37167699	.	A	T	8	9	17	0	0	17	0	0
11	37167834	.	T	C	12	6	18	0	1	19	0	0
11	37168039	.	A	T	5	8	13	0	1	14	0	0
11	37168147	.	T	C	6	6	12	0	0	12	0	0
11	37168162	.	T	A	5	8	13	0	1	14	0	0
11	37169144	.	G	A	7	12	19	0	1	20	0	0
11	37169238	.	G	A	15	13	28	0	0	28	0	0
11	37297678	.	C	T	19	6	25	1	0	26	0	0
11	37297681	.	A	G	16	6	22	1	2	28	3	0
11	37297811	.	A	T	16	23	39	0	1	40	0	0
11	37297951	.	T	C	24	13	37	0	3	40	0	0
11	37298028	.	T	A	9	11	20	1	4	25	0	0
11	37298569	.	A	G	17	20	37	1	1	39	0	0
11	37298718	.	G	A	11	17	28	0	0	28	0	0
11	37298755	.	G	A	15	15	30	0	1	31	0	0
11	37299378	.	A	T	14	9	23	0	1	24	0	0
11	37315716	.	G	C	7	8	15	0	0	15	0	0
11	37322273	.	G	T	5	2	7	0	2	9	0	0
11	37337360	.	C	T	3	10	13	0	1	14	0	0
11	37411070	.	G	A	4	4	8	0	1	9	0	0
11	37431953	.	C	T	29	26	55	2	2	59	0	0
11	37434255	.	T	G	16	22	38	0	4	42	0	0
11	37434259	.	T	G	16	25	41	0	4	45	0	0
11	37434533	.	A	G	14	22	36	0	2	38	0	0
11	37442671	.	G	A	18	20	38	0	2	40	0	0
11	37442752	.	C	G	13	18	31	0	0	31	0	0
11	37442772	.	G	T	14	19	33	0	0	33	0	0
11	37445219	.	A	G	24	19	43	0	3	46	0	0
11	37445502	.	T	C	20	0	20	0	12	32	0	0
11	37445774	.	G	A	15	13	28	0	1	29	0	0
11	37445825	.	G	A	15	18	33	0	2	35	0	0
11	37446107	.	G	A	5	6	11	0	0	11	0	0
11	37446173	.	T	A	7	13	20	0	5	25	0	0
11	37446736	.	C	G	16	15	31	0	1	32	0	0
11	37447754	.	C	T	0	8	8	0	11	19	0	0
11	37450619	.	A	C	4	11	15	0	1	16	0	0
11	37450777	.	T	C	6	5	11	0	0	11	0	0
11	37451040	.	C	T	0	6	6	0	4	10	0	0
11	37452021	.	G	A	8	7	15	0	0	15	0	0
11	37548381	.	C	T	11	4	15	1	0	16	0	0
11	37613515	.	G	A	26	17	43	0	1	44	0	0
11	37613577	.	G	A	23	21	44	0	0	44	0	0
11	37613641	.	A	G	24	21	45	0	1	46	0	0
11	37616775	.	T	C	21	18	39	0	1	40	0	0
11	37616823	.	A	G	16	14	30	0	3	33	0	0
11	37710327	.	A	G	1	3	4	0	0	4	0	0
11	37710386	.	G	C	4	0	4	1	3	8	0	0
11	37859678	.	C	A	0	2	2	0	1	3	0	0
11	37859693	.	C	A	1	2	3	0	0	3	0	0
11	37868358	.	C	T	3	5	8	0	0	8	0	0
11	38033419	.	C	T	0	5	5	0	3	8	0	0
11	38048836	.	G	A	4	4	8	0	1	9	0	0
11	38050905	.	G	A	3	3	6	0	0	6	0	0
11	38055627	.	C	T	0	5	5	0	7	12	0	0
11	38083026	.	T	C	4	4	8	0	0	8	0	0
11	38332405	.	T	A	5	10	15	0	0	15	0	0
11	38375925	.	C	G	14	0	14	0	14	28	0	0
11	38393213	.	G	A	0	9	9	0	7	16	0	0
11	38413037	.	G	A	16	7	23	0	0	23	0	0
11	38477219	.	G	A	5	3	8	0	0	8	0	0
11	38477252	.	C	T	1	2	3	0	5	8	0	0
11	38480493	.	T	A	3	3	6	0	0	6	0	0
11	38480665	.	A	G	1	3	4	0	0	4	0	0
11	38505453	.	T	C	6	7	13	0	0	13	0	0
11	38505781	.	A	G	7	6	13	0	0	13	0	0
11	38506401	.	A	T	8	3	11	0	0	11	0	0
11	38506404	.	A	T	3	7	10	0	0	10	0	0
11	38506543	.	A	G	2	4	6	0	0	6	0	0
11	38507042	.	C	T	0	5	5	0	1	6	0	0
11	38507080	.	G	A	3	6	9	0	0	9	0	0
11	38507151	.	G	A	1	5	6	0	0	6	0	0
11	38507322	.	T	C	3	8	11	0	0	11	0	0
11	38507918	.	A	G	4	2	6	0	1	7	0	0
11	38508728	.	C	T	3	2	5	0	0	5	0	0
11	38509151	.	C	T	7	4	11	1	4	16	0	0
11	38509205	.	G	A	6	10	16	0	0	16	0	0
11	38509219	.	T	C	6	9	15	0	0	15	0	0
11	38509736	.	C	T	5	7	12	0	0	12	0	0
11	38509901	.	A	C	5	6	11	0	0	12	1	0
11	38509922	.	G	A	6	7	13	0	0	13	0	0
11	38510228	.	A	G	3	7	10	0	0	10	0	0
11	38540870	.	G	A	21	20	41	0	1	42	0	0
11	38541063	.	T	A	19	25	44	1	2	47	0	0
11	38541100	.	A	C	19	19	38	0	0	38	0	0
11	38541371	.	T	C	28	0	28	0	17	45	0	0
11	38541401	.	C	G	23	15	38	0	1	39	0	0
11	38541484	.	A	G	21	13	34	2	2	38	0	0
11	38541708	.	A	C	16	13	29	0	0	29	0	0
11	38542003	.	G	A	19	24	43	1	3	47	0	0
11	38542088	.	A	T	19	16	35	0	0	35	0	0
11	38542171	.	G	T	18	20	38	0	3	41	0	0
11	38542218	.	G	A	16	18	34	0	3	37	0	0
11	38542305	.	C	T	26	18	44	0	3	47	0	0
11	38542308	.	G	A	25	21	46	0	0	46	0	0
11	38542655	.	T	C	23	1	24	0	26	50	0	0
11	38545826	.	G	T	20	21	41	0	1	42	0	0
11	38545874	.	C	G	3	29	32	0	27	59	0	0
11	38807879	.	G	A	1	13	14	0	6	20	0	0
11	38808113	.	C	T	5	10	15	0	0	15	0	0
11	38846046	.	C	T	5	7	12	0	0	12	0	0
11	38846301	.	T	G	16	0	16	0	11	28	1	0
11	38846316	.	T	A	12	14	26	0	0	26	0	0
11	38850244	.	G	A	1	6	7	0	11	18	0	0
11	38853397	.	A	T	9	13	22	0	0	22	0	0
11	38853511	.	A	G	8	9	17	0	1	18	0	0
11	38868012	.	G	T	18	11	29	0	1	30	0	0
11	38874937	.	G	A	16	17	33	0	2	35	0	0
11	38875221	.	A	G	19	12	31	0	1	32	0	0
11	38875283	.	A	T	12	18	30	0	0	30	0	0
11	38875352	.	G	A	19	15	34	0	0	34	0	0
11	38875397	.	T	G	19	14	33	0	0	33	0	0
11	38875484	.	A	C	11	16	27	0	1	28	0	0
11	38875498	.	C	A	14	11	25	0	1	26	0	0
11	38875660	.	T	C	15	17	32	0	2	34	0	0
11	38875867	.	T	C	7	9	16	0	0	16	0	0
11	38875897	.	T	C	3	7	10	0	0	10	0	0
11	38875912	.	A	G	3	5	8	0	0	8	0	0
11	39014553	.	G	A	13	14	27	0	3	30	0	0
11	39044451	.	T	A	7	6	13	0	0	13	0	0
11	39076138	.	C	T	0	2	2	0	7	9	0	0
11	39104871	.	G	A	1	2	3	0	0	3	0	0
11	39107156	.	C	T	11	9	20	0	0	20	0	0
11	39109555	.	C	T	5	7	12	0	1	13	0	0
11	39110046	.	C	T	11	6	17	0	1	18	0	0
11	39112035	.	A	G	6	6	12	0	1	13	0	0
11	39112068	.	C	T	4	8	12	0	0	12	0	0
11	39113986	.	C	T	0	2	2	0	1	3	0	0
11	39114164	.	C	G	1	3	4	0	0	4	0	0
11	39115034	.	G	A	2	2	4	0	0	4	0	0
11	39135393	.	C	T	23	24	47	0	0	47	0	0
11	39141527	.	A	G	33	18	51	0	4	55	0	0
11	39141732	.	T	G	19	16	35	0	0	35	0	0
11	39141924	.	G	T	9	11	20	0	2	22	0	0
11	39147065	.	T	C	18	13	31	0	0	31	0	0
11	39147085	.	C	T	19	11	30	0	0	30	0	0
11	39147387	.	T	C	16	17	33	1	0	34	0	0
11	39147445	.	G	C	17	22	39	0	1	40	0	0
11	39147857	.	G	C	10	20	30	0	1	31	0	0
11	39147905	.	C	A	18	20	38	0	1	39	0	0
11	39147906	.	A	T	17	20	37	0	2	39	0	0
11	39147947	.	G	T	22	12	34	0	1	35	0	0
11	39147989	.	T	C	22	17	39	0	4	43	0	0
11	39148015	.	C	T	11	20	31	0	7	38	0	0
11	39168201	.	T	A	1	4	5	0	0	5	0	0
11	39168202	.	C	G	1	4	5	0	0	5	0	0
11	39168255	.	C	G	2	5	7	0	0	7	0	0
11	39168309	.	T	C	1	2	3	0	0	3	0	0
11	39168400	.	G	C	1	4	5	0	0	5	0	0
11	39877711	.	C	T	4	8	12	0	0	12	0	0
11	39878200	.	A	G	12	0	12	0	10	22	0	0
11	39878442	.	A	C	16	8	24	0	1	25	0	0
11	39878503	.	C	A	14	6	20	0	0	20	0	0
11	39878515	.	G	T	2	5	7	0	14	21	0	0
11	39878558	.	A	C	9	13	22	0	2	24	0	0
11	39878740	.	G	A	13	17	30	0	0	30	0	0
11	39878788	.	T	A	13	12	25	0	1	26	0	0
11	39878980	.	C	T	2	8	10	0	1	11	0	0
11	39879009	.	C	G	2	5	7	0	0	7	0	0
11	39879242	.	C	A	9	6	15	0	1	16	0	0
11	39879316	.	A	G	8	16	24	0	1	25	0	0
11	39888410	.	T	A	9	8	17	0	1	18	0	0
11	39905164	.	C	T	16	13	29	0	1	30	0	0
11	39906110	.	C	T	15	11	26	0	1	27	0	0
11	39907021	.	C	G	23	18	41	0	2	43	0	0
11	39907585	.	G	A	12	16	28	0	1	29	0	0
11	39907618	.	C	G	18	16	34	0	1	35	0	0
11	39908020	.	T	G	16	4	20	0	2	23	1	0
11	39916450	.	G	A	18	11	29	0	3	32	0	0
11	39922402	.	G	A	1	14	15	0	21	36	0	0
11	39922407	.	G	A	23	13	36	0	0	36	0	0
11	39922714	.	A	C	15	12	27	0	1	28	0	0
11	39923551	.	T	A	19	14	33	0	2	35	0	0
11	39923653	.	C	T	14	11	25	0	3	29	1	0
11	39924083	.	A	T	20	22	42	0	1	43	0	0
11	39924235	.	G	C	13	8	21	2	2	25	0	0
11	39924243	.	G	T	13	8	21	2	1	24	0	0
11	39924341	.	C	G	17	13	30	0	2	32	0	0
11	39924358	.	T	C	14	14	28	0	2	30	0	0
11	39924413	.	G	A	24	18	42	0	0	42	0	0
11	39924639	.	C	T	24	15	39	0	2	41	0	0
11	39924652	.	C	T	13	25	38	0	1	39	0	0
11	39924711	.	A	T	13	25	38	0	2	40	0	0
11	39924736	.	A	G	21	20	41	0	1	42	0	0
11	39924783	.	T	A	22	20	42	0	1	43	0	0
11	39924784	.	A	T	22	20	42	0	3	45	0	0
11	39924929	.	G	A	14	13	27	0	1	28	0	0
11	39924946	.	C	T	14	16	30	0	2	32	0	0
11	39924989	.	G	T	24	14	38	0	0	38	0	0
11	39924999	.	C	T	17	23	40	0	0	40	0	0
11	39925225	.	C	A	17	18	35	0	1	36	0	0
11	39925458	.	G	A	21	13	34	0	3	37	0	0
11	39925529	.	C	T	16	22	38	0	0	38	0	0
11	39926041	.	C	T	28	14	42	0	0	42	0	0
11	39926216	.	A	G	18	15	33	0	1	34	0	0
11	39941661	.	A	G	16	0	16	0	12	28	0	0
11	39949703	.	C	T	14	4	18	0	0	18	0	0
11	39954026	.	T	G	10	16	26	0	2	28	0	0
11	39954319	.	G	A	1	8	9	0	9	18	0	0
11	39969048	.	G	A	4	8	12	0	2	14	0	0
11	39969082	.	A	T	7	6	13	0	0	13	0	0
11	39969093	.	A	G	3	0	3	0	8	11	0	0
11	39969260	.	A	C	6	3	9	0	1	10	0	0
11	39976568	.	G	T	4	9	13	0	0	13	0	0
11	39985311	.	A	G	3	3	6	0	0	6	0	0
11	39986402	.	T	C	2	6	8	0	0	8	0	0
11	39998695	.	T	G	2	4	6	0	0	6	0	0
11	39998697	.	T	G	2	0	2	0	4	6	0	0
11	40002096	.	A	T	8	5	13	0	0	13	0	0
11	40002228	.	T	G	6	5	11	0	0	11	0	0
11	40004643	.	G	A	4	4	8	0	0	8	0	0
11	40009040	.	T	C	9	7	16	0	0	16	0	0
11	40009094	.	A	G	10	9	19	0	0	19	0	0
11	40014079	.	A	G	9	6	15	0	0	15	0	0
11	40014346	.	G	A	8	8	16	0	0	16	0	0
11	40015113	.	G	A	7	6	13	0	0	13	0	0
11	40015380	.	C	G	9	6	15	0	0	15	0	0
11	40015529	.	T	C	8	4	12	0	0	12	0	0
11	40015537	.	G	A	9	4	13	0	0	13	0	0
11	40015696	.	C	T	4	6	10	0	1	11	0	0
11	40015849	.	A	C	3	4	7	0	1	9	1	0
11	40016032	.	A	G	5	8	13	0	0	13	0	0
11	40016125	.	C	T	4	2	6	0	0	6	0	0
11	40016253	.	C	T	5	5	10	0	0	10	0	0
11	40016261	.	A	T	6	5	11	0	0	11	0	0
11	40016477	.	T	C	3	2	5	0	0	5	0	0
11	40016524	.	G	A	0	5	5	0	8	13	0	0
11	40016528	.	T	C	7	5	12	0	1	13	0	0
11	40016649	.	A	C	8	7	15	0	0	15	0	0
11	40017183	.	G	T	12	9	21	1	0	22	0	0
11	40017290	.	G	C	8	4	12	0	1	13	0	0
11	40017333	.	A	T	6	5	11	0	0	11	0	0
11	40017501	.	A	T	10	9	19	0	0	19	0	0
11	40017504	.	T	A	10	9	19	0	0	19	0	0
11	40017604	.	T	C	7	10	17	0	1	18	0	0
11	40017698	.	T	C	6	6	12	0	0	12	0	0
11	40017829	.	A	G	4	3	7	0	1	8	0	0
11	40017865	.	T	A	2	3	5	0	0	5	0	0
11	40017885	.	G	A	3	6	9	0	0	9	0	0
11	40017949	.	A	T	6	10	16	0	1	17	0	0
11	40017994	.	T	C	10	8	18	0	0	18	0	0
11	40018042	.	T	C	10	10	20	0	2	22	0	0
11	40018633	.	G	A	5	9	14	0	3	17	0	0
11	40018668	.	A	T	9	11	20	0	1	21	0	0
11	40018799	.	G	T	2	4	6	0	7	13	0	0
11	40020303	.	A	G	8	4	12	0	3	15	0	0
11	40020304	.	G	C	8	4	12	0	3	15	0	0
11	40020354	.	T	C	9	4	13	0	0	13	0	0
11	40020441	.	G	A	2	2	4	0	0	4	0	0
11	40020460	.	T	C	2	4	6	0	0	6	0	0
11	40020683	.	G	T	5	8	13	0	0	13	0	0
11	40020928	.	G	A	14	12	26	0	0	26	0	0
11	40020950	.	A	G	11	9	20	0	1	21	0	0
11	40617932	.	C	T	3	2	5	0	0	5	0	0
11	40617935	.	T	A	3	2	5	0	0	5	0	0
11	40653819	.	G	A	2	7	9	0	0	9	0	0
11	40657839	.	G	A	21	10	31	0	2	33	0	0
11	40657905	.	G	A	12	10	22	0	4	26	0	0
11	40658022	.	C	T	19	12	31	0	3	34	0	0
11	40658232	.	C	T	12	7	19	0	0	19	0	0
11	40658352	.	G	A	1	10	11	0	3	14	0	0
11	40661378	.	T	C	7	9	16	0	0	16	0	0
11	40665494	.	C	T	14	10	24	0	1	25	0	0
11	40665602	.	G	T	2	20	22	0	12	34	0	0
11	40673658	.	T	G	12	26	38	0	0	38	0	0
11	40673797	.	C	T	11	11	22	0	0	22	0	0
11	40677967	.	T	C	42	11	53	0	0	53	0	0
11	40678445	.	A	C	29	0	29	0	33	62	0	0
11	40831754	.	A	G	6	0	6	0	5	12	1	0
11	40840238	.	T	C	5	8	13	0	0	13	0	0
11	40843028	.	A	G	2	5	7	0	6	13	0	0
11	40843055	.	G	T	0	6	6	0	11	17	0	0
11	40843064	.	C	A	11	3	14	0	1	15	0	0
11	40843439	.	A	G	5	0	5	0	16	21	0	0
11	40843502	.	C	T	9	10	19	0	1	20	0	0
11	40843835	.	G	A	0	12	12	0	11	23	0	0
11	40844085	.	T	G	6	5	11	0	0	11	0	0
11	40844094	.	C	T	4	5	9	0	0	9	0	0
11	40844195	.	A	T	3	9	12	1	1	14	0	0
11	40845006	.	C	T	12	11	23	0	4	27	0	0
11	40845071	.	C	T	6	5	11	0	1	12	0	0
11	40845080	.	G	A	0	3	3	0	6	9	0	0
11	40845117	.	T	C	3	4	7	0	0	7	0	0
11	41066190	.	T	G	20	0	20	0	17	37	0	0
11	41066765	.	T	G	17	17	34	1	1	36	0	0
11	41066871	.	C	T	10	16	26	0	0	26	0	0
11	41066888	.	C	T	9	19	28	0	0	28	0	0
11	41066950	.	A	G	13	22	35	0	0	35	0	0
11	41067275	.	G	A	2	16	18	0	0	18	0	0
11	41067430	.	A	T	5	15	20	0	0	20	0	0
11	41067442	.	C	T	5	18	23	0	0	23	0	0
11	41067488	.	A	C	4	9	13	0	0	13	0	0
11	41067502	.	G	A	3	10	13	0	0	13	0	0
11	41078522	.	C	A	7	9	16	0	0	16	0	0
11	41078578	.	A	T	12	12	24	0	0	24	0	0
11	41078762	.	A	T	22	12	34	0	0	34	0	0
11	41084325	.	T	G	29	10	39	0	1	40	0	0
11	41089631	.	G	T	5	7	12	0	1	13	0	0
11	41089641	.	T	C	4	7	11	0	1	12	0	0
11	41090478	.	A	C	3	3	6	0	1	7	0	0
11	41090479	.	A	C	3	4	7	0	0	7	0	0
11	41101666	.	A	G	9	9	18	0	2	20	0	0
11	41101760	.	A	T	8	7	15	0	0	15	0	0
11	41101800	.	T	A	3	3	6	0	1	7	0	0
11	41101866	.	C	T	1	8	9	0	0	9	0	0
11	41101910	.	G	A	1	6	7	0	2	9	0	0
11	41101918	.	C	T	2	6	8	0	1	9	0	0
11	41102013	.	A	G	4	1	5	0	2	7	0	0
11	41102026	.	T	C	5	2	7	0	1	8	0	0
11	41102205	.	A	G	7	5	12	0	0	12	0	0
11	41104549	.	A	G	5	4	9	0	0	9	0	0
11	41104934	.	G	A	3	10	13	0	1	14	0	0
11	41104954	.	C	T	2	11	13	0	1	14	0	0
11	41105030	.	G	A	0	5	5	0	4	9	0	0
11	41105144	.	T	G	5	0	5	0	5	10	0	0
11	41111301	.	A	G	4	12	16	0	0	16	0	0
11	41111334	.	T	C	6	5	11	0	2	13	0	0
11	41111370	.	C	T	7	7	14	0	0	14	0	0
11	41111422	.	A	G	2	6	8	0	0	8	0	0
11	41111431	.	A	C	2	3	5	0	0	5	0	0
11	41111561	.	T	A	5	3	8	0	0	8	0	0
11	41111603	.	T	A	3	5	8	0	0	8	0	0
11	41111735	.	G	A	4	9	13	0	0	13	0	0
11	41112989	.	T	C	2	4	6	0	0	6	0	0
11	41113412	.	C	T	2	2	4	0	0	4	0	0
11	41114055	.	C	T	0	3	3	0	6	9	0	0
11	41114090	.	G	T	5	7	12	0	0	12	0	0
11	41114186	.	A	C	1	5	6	0	1	7	0	0
11	41122665	.	T	C	3	1	4	0	7	11	0	0
11	41125040	.	A	G	7	5	12	0	2	14	0	0
11	41132195	.	A	G	7	8	15	0	1	16	0	0
11	41216315	.	C	T	0	6	6	0	4	10	0	0
11	41216445	.	A	C	7	3	10	0	0	10	0	0
11	41216455	.	T	C	3	0	3	0	6	9	0	0
11	41216505	.	G	C	5	5	10	0	0	10	0	0
11	41216586	.	C	T	3	4	7	0	0	7	0	0
11	41222940	.	A	G	13	11	24	0	1	25	0	0
11	41284762	.	C	T	8	9	17	0	0	17	0	0
11	41306035	.	G	A	0	7	7	0	10	17	0	0
11	41363814	.	T	C	6	8	14	0	4	18	0	0
11	41459981	.	G	C	4	13	17	0	29	46	0	0
11	41461369	.	T	C	17	28	45	0	2	47	0	0
11	41461417	.	C	G	19	27	46	0	1	47	0	0
11	41463534	.	C	G	18	28	46	3	2	51	0	0
11	41468791	.	C	T	24	25	49	1	2	52	0	0
11	41474041	.	T	A	11	2	13	0	0	13	0	0
11	41474042	.	G	T	11	2	13	0	0	13	0	0
11	41651124	.	G	T	0	11	11	0	6	17	0	0
11	41666612	.	A	C	3	14	17	0	1	18	0	0
11	41699856	.	C	G	7	7	14	0	0	14	0	0
11	41714491	.	C	T	3	2	5	0	0	5	0	0
11	41838999	.	G	T	3	6	9	0	0	9	0	0
11	41840490	.	A	G	3	0	3	0	3	6	0	0
11	41840493	.	T	C	2	3	5	0	0	5	0	0
11	41844192	.	C	A	6	10	16	0	0	16	0	0
11	41844342	.	T	C	6	9	15	0	1	16	0	0
11	41844396	.	A	G	7	0	7	0	11	18	0	0
11	41846151	.	C	A	1	6	7	0	1	8	0	0
11	41846429	.	C	A	10	5	15	0	1	16	0	0
11	41846430	.	C	A	2	5	7	0	10	17	0	0
11	41849977	.	C	T	0	6	6	0	11	17	0	0
11	41938546	.	A	G	6	3	9	0	0	9	0	0
11	41938594	.	G	A	5	4	9	0	0	9	0	0
11	41940293	.	G	A	3	5	8	0	0	8	0	0
11	41942440	.	T	C	2	6	8	0	0	8	0	0
11	41946225	.	A	G	3	3	6	0	0	6	0	0
11	41948344	.	C	T	5	4	9	0	0	9	0	0
11	41952555	.	C	T	4	4	8	0	0	8	0	0
11	41958013	.	C	T	5	4	9	0	0	9	0	0
11	41958058	.	C	T	8	3	11	0	0	11	0	0
11	41958278	.	A	T	7	8	15	0	1	16	0	0
11	41958317	.	T	C	8	11	19	0	0	19	0	0
11	41960058	.	A	C	9	13	22	0	3	25	0	0
11	41960059	.	C	T	10	14	24	0	0	24	0	0
11	41960101	.	A	G	10	15	25	0	0	25	0	0
11	41960111	.	C	T	8	13	21	0	1	22	0	0
11	41982511	.	A	C	1	2	3	0	0	3	0	0
11	41982546	.	G	A	0	4	4	0	5	9	0	0
11	42083436	.	T	C	3	0	3	0	2	5	0	0
11	42128555	.	T	A	4	5	9	0	1	10	0	0
11	42128561	.	G	A	5	4	9	0	0	9	0	0
11	42128627	.	T	C	13	7	20	0	1	21	0	0
11	42128633	.	C	T	17	7	24	0	0	24	0	0
11	42134733	.	C	G	3	5	8	0	1	9	0	0
11	42150929	.	A	G	2	4	6	0	0	6	0	0
11	42181864	.	G	A	1	2	3	0	0	3	0	0
11	42305824	.	C	T	7	7	14	0	0	14	0	0
11	42305868	.	C	A	0	4	4	0	9	13	0	0
11	42306057	.	C	T	6	2	8	4	0	12	0	0
11	42306414	.	A	G	2	2	4	0	0	4	0	0
11	42307344	.	T	G	10	9	19	0	0	19	0	0
11	42307671	.	G	A	14	11	25	0	2	27	0	0
11	42307816	.	C	T	2	16	18	0	15	33	0	0
11	42315366	.	G	C	13	6	19	0	0	19	0	0
11	42315414	.	A	C	7	0	7	0	12	19	0	0
11	42319372	.	C	A	10	14	24	0	2	26	0	0
11	42325520	.	G	A	14	10	24	0	0	24	0	0
11	42325535	.	C	T	12	12	24	0	0	24	0	0
11	42329113	.	C	T	13	6	19	0	0	19	0	0
11	42338894	.	T	C	11	1	12	0	7	19	0	0
11	42350787	.	G	A	11	10	21	0	0	21	0	0
11	42350793	.	G	A	10	12	22	0	0	22	0	0
11	42350847	.	C	T	9	10	19	0	2	21	0	0
11	42353054	.	G	A	12	10	22	0	0	22	0	0
11	42356032	.	C	T	14	11	25	0	0	25	0	0
11	42363236	.	G	A	9	10	19	0	0	19	0	0
11	42385761	.	A	T	8	4	12	0	1	13	0	0
11	42417409	.	T	C	4	6	10	0	0	10	0	0
11	42417628	.	A	C	3	14	17	0	0	17	0	0
11	42417956	.	C	T	1	4	5	0	5	10	0	0
11	42418042	.	G	A	3	7	10	0	0	10	0	0
11	42418246	.	C	T	5	7	12	0	0	12	0	0
11	42418268	.	A	G	8	6	14	0	0	14	0	0
11	42418310	.	A	T	5	8	13	0	1	14	0	0
11	42437064	.	C	T	3	3	6	0	0	6	0	0
11	42447346	.	G	A	2	5	7	0	0	7	0	0
11	42447389	.	C	T	2	5	7	0	0	7	0	0
11	42447415	.	G	T	1	2	3	0	0	4	1	0
11	42457216	.	C	T	4	5	9	0	0	9	0	0
11	42457261	.	T	C	2	3	5	0	0	5	0	0
11	42457325	.	T	C	5	3	8	0	0	8	0	0
11	42457328	.	A	C	2	5	7	0	1	8	0	0
11	42495961	.	C	T	3	3	6	0	0	6	0	0
11	42500674	.	G	A	0	1	1	1	4	6	0	0
11	42500691	.	G	A	5	3	8	1	0	9	0	0
11	42500906	.	C	A	1	2	3	0	0	3	0	0
11	42500924	.	A	T	1	2	3	0	0	3	0	0
11	42501982	.	T	G	4	5	9	0	1	10	0	0
11	42502031	.	C	T	9	5	14	0	0	14	0	0
11	42502080	.	G	A	1	2	3	0	6	9	0	0
11	42502108	.	T	A	2	2	4	0	0	4	0	0
11	42502164	.	C	T	4	3	7	0	0	7	0	0
11	42502212	.	A	G	7	6	13	0	0	13	0	0
11	42502313	.	G	T	3	3	6	0	0	6	0	0
11	42502883	.	A	C	1	2	3	0	0	3	0	0
11	42506137	.	A	G	1	2	3	0	0	3	0	0
11	42506171	.	T	G	2	2	4	0	0	4	0	0
11	42521958	.	T	A	4	6	10	0	0	10	0	0
11	42521985	.	G	A	5	9	14	0	0	14	0	0
11	42521999	.	G	A	8	5	13	0	1	14	0	0
11	42522076	.	C	A	3	2	5	0	0	5	0	0
11	42522118	.	C	T	2	2	4	0	0	4	0	0
11	42522135	.	C	A	3	2	5	0	0	5	0	0
11	42522162	.	A	T	2	3	5	0	0	5	0	0
11	42522689	.	G	C	3	2	5	0	0	5	0	0
11	42525232	.	T	A	1	4	5	0	0	5	0	0
11	42525345	.	A	T	4	7	11	0	0	11	0	0
11	42525399	.	C	A	0	5	5	0	1	6	0	0
11	42532625	.	T	C	4	0	4	1	3	8	0	0
11	42532751	.	T	A	2	3	5	0	1	6	0	0
11	42532938	.	G	C	4	7	11	0	1	12	0	0
11	42532943	.	C	T	5	7	12	0	1	13	0	0
11	42533180	.	C	G	0	7	7	0	9	16	0	0
11	42533237	.	G	A	9	8	17	0	0	17	0	0
11	42537988	.	G	C	13	5	18	0	0	18	0	0
11	42560439	.	G	A	34	38	72	0	1	73	0	0
11	42560475	.	C	T	31	39	70	0	2	72	0	0
11	42600856	.	A	T	6	10	16	0	0	16	0	0
11	42600867	.	A	T	10	8	18	0	0	18	0	0
11	42608394	.	T	C	3	7	10	0	0	10	0	0
11	42613179	.	G	T	1	10	11	0	9	20	0	0
11	42615091	.	A	T	10	9	19	0	0	19	0	0
11	42618675	.	A	G	15	1	16	0	6	22	0	0
11	42618726	.	C	T	6	7	13	0	0	13	0	0
11	42621491	.	G	A	1	4	5	0	7	12	0	0
11	42626276	.	C	T	8	12	20	0	0	20	0	0
11	42715934	.	T	C	3	2	5	0	0	5	0	0
11	42721347	.	G	A	1	2	3	0	0	3	0	0
11	42730834	.	C	G	21	16	37	0	2	39	0	0
11	42730895	.	C	T	25	12	37	0	0	37	0	0
11	42730901	.	C	T	21	12	33	0	1	34	0	0
11	42730931	.	C	T	12	18	30	0	2	32	0	0
11	42730974	.	T	A	14	14	28	0	0	28	0	0
11	42730982	.	T	C	14	15	29	0	0	29	0	0
11	42766088	.	T	C	4	3	7	0	0	7	0	0
11	42771442	.	G	A	2	4	6	0	0	6	0	0
11	42783985	.	G	A	6	5	11	0	0	11	0	0
11	42798519	.	A	G	7	0	7	0	6	13	0	0
11	42801451	.	A	T	6	9	15	0	1	16	0	0
11	42808988	.	C	T	10	5	15	0	3	18	0	0
11	42809162	.	G	A	0	6	6	0	1	7	0	0
11	42809233	.	A	G	7	6	13	0	2	15	0	0
11	42809288	.	T	C	13	7	20	0	0	20	0	0
11	42809300	.	T	C	13	4	17	0	2	19	0	0
11	42809345	.	T	C	6	8	14	0	2	16	0	0
11	42809438	.	G	C	7	4	11	2	0	13	0	0
11	42809558	.	A	G	5	10	15	0	0	15	0	0
11	42809579	.	T	G	12	4	16	0	0	16	0	0
11	42809657	.	G	T	0	5	5	0	5	10	0	0
11	42809683	.	T	A	3	2	5	0	1	6	0	0
11	42809717	.	G	A	0	7	7	0	3	10	0	0
11	42814965	.	C	A	3	3	6	0	0	7	1	0
11	42814967	.	C	A	4	1	5	0	2	7	0	0
11	42815207	.	C	A	6	6	12	0	0	12	0	0
11	42816262	.	C	G	6	0	6	3	6	15	0	0
11	42816263	.	G	C	6	5	11	3	1	15	0	0
11	42817067	.	A	G	3	2	5	0	2	7	0	0
11	42817075	.	T	G	0	0	0	0	8	8	0	0
11	42817257	.	T	G	4	4	8	0	1	9	0	0
11	42817359	.	A	T	3	7	10	0	0	10	0	0
11	42817411	.	T	C	10	5	15	0	0	15	0	0
11	42817459	.	A	T	7	7	14	0	0	15	1	0
11	42817476	.	G	C	1	5	6	0	4	10	0	0
11	42817534	.	G	A	9	5	14	0	1	15	0	0
11	42817552	.	A	G	10	5	15	0	0	15	0	0
11	42817604	.	G	T	4	4	8	0	0	8	0	0
11	42912098	.	T	C	1	3	4	0	0	4	0	0
11	42912594	.	A	T	2	3	5	0	0	5	0	0
11	42912723	.	A	G	4	3	7	0	0	7	0	0
11	42912870	.	G	C	5	4	9	0	0	9	0	0
11	42915887	.	G	A	3	3	6	0	0	6	0	0
11	42933696	.	A	G	11	4	15	0	0	15	0	0
11	42933703	.	T	C	11	2	13	0	0	13	0	0
11	42933813	.	A	G	7	8	15	0	0	15	0	0
11	42933832	.	C	T	2	6	8	0	1	9	0	0
11	42940748	.	C	T	8	4	12	0	1	13	0	0
11	42942852	.	T	C	9	9	18	0	0	18	0	0
11	42942930	.	G	A	7	2	9	0	0	9	0	0
11	42949086	.	T	C	7	0	7	0	11	18	0	0
11	42949819	.	G	A	2	6	8	0	0	8	0	0
11	42949828	.	T	G	1	5	6	0	1	7	0	0
11	42954479	.	G	A	5	5	10	0	0	10	0	0
11	42956694	.	A	G	3	5	8	0	2	10	0	0
11	42958993	.	A	G	3	2	5	0	0	5	0	0
11	42971336	.	A	G	4	2	6	0	0	6	0	0
11	42971408	.	A	C	1	0	1	0	3	4	0	0
11	42974959	.	G	T	5	3	8	0	2	10	0	0
11	42974962	.	G	A	6	4	10	0	0	10	0	0
11	42975395	.	A	T	8	3	11	0	0	11	0	0
11	42975432	.	C	G	3	3	6	0	0	6	0	0
11	42978318	.	A	T	2	2	4	0	0	4	0	0
11	42980091	.	A	G	2	2	4	0	0	4	0	0
11	43045604	.	G	A	7	12	19	0	0	19	0	0
11	43102460	.	C	A	1	2	3	0	0	3	0	0
11	43104424	.	G	C	3	0	3	0	2	5	0	0
11	43114403	.	A	G	2	0	2	0	2	4	0	0
11	43114600	.	T	C	3	2	5	0	0	5	0	0
11	43114618	.	T	C	5	3	8	0	0	8	0	0
11	43137659	.	C	T	31	29	60	0	0	60	0	0
11	43151260	.	C	T	24	24	48	0	2	50	0	0
11	43164302	.	G	T	28	11	39	0	1	40	0	0
11	43170699	.	A	G	24	25	49	0	1	50	0	0
11	43170804	.	G	A	32	22	54	0	0	54	0	0
11	43170924	.	A	G	25	20	45	0	3	48	0	0
11	43170992	.	G	T	30	25	55	0	2	57	0	0
11	43171230	.	T	A	18	16	34	0	2	36	0	0
11	43171263	.	G	A	20	13	33	0	1	35	1	0
11	43171281	.	A	G	15	16	31	0	3	34	0	0
11	43171314	.	A	G	22	12	34	0	0	34	0	0
11	43178811	.	T	A	24	20	44	0	1	45	0	0
11	43178823	.	G	A	21	19	40	0	2	42	0	0
11	43178958	.	C	T	23	14	37	0	0	37	0	0
11	43178991	.	G	A	11	19	30	0	0	30	0	0
11	43179248	.	T	G	14	15	29	0	1	30	0	0
11	43179639	.	G	A	20	20	40	0	0	40	0	0
11	43179651	.	A	G	17	19	36	0	0	36	0	0
11	43189115	.	G	A	17	13	30	1	4	35	0	0
11	43189118	.	G	A	20	13	33	1	1	35	0	0
11	43190846	.	G	A	10	20	30	0	0	30	0	0
11	43200347	.	C	T	17	17	34	0	0	34	0	0
11	43200419	.	T	A	7	21	28	0	1	29	0	0
11	43375570	.	A	T	1	3	4	0	0	4	0	0
11	43381243	.	A	G	2	2	4	0	0	4	0	0
11	43387562	.	C	T	5	4	9	0	0	9	0	0
11	43387576	.	T	C	1	4	5	0	0	5	0	0
11	43387641	.	G	A	1	3	4	0	1	5	0	0
11	43401675	.	T	A	3	3	6	0	0	6	0	0
11	43406657	.	T	C	3	4	7	0	1	8	0	0
11	43411231	.	C	T	8	11	19	1	0	20	0	0
11	43470473	.	T	A	6	5	11	0	0	11	0	0
11	43470619	.	C	T	2	6	8	1	0	9	0	0
11	43470740	.	C	T	0	6	6	0	4	10	0	0
11	43470764	.	T	C	0	0	0	0	5	5	0	0
11	43470803	.	G	C	1	2	3	0	2	5	0	0
11	43741068	.	G	A	1	3	4	0	0	4	0	0
11	43782303	.	T	C	3	4	7	0	1	8	0	0
11	44019868	.	A	G	8	7	15	0	0	15	0	0
11	44022321	.	G	A	6	4	10	0	1	11	0	0
11	44023888	.	A	G	0	8	8	0	0	8	0	0
11	44024006	.	C	T	0	9	9	0	3	12	0	0
11	44025903	.	T	A	6	8	14	0	1	15	0	0
11	44026179	.	A	G	6	5	11	0	1	12	0	0
11	44027836	.	T	G	7	3	10	0	0	10	0	0
11	44104111	.	T	C	5	3	8	0	0	8	0	0
11	44104132	.	T	C	6	0	6	0	4	10	0	0
11	44144749	.	A	C	10	12	22	1	0	23	0	0
11	44144820	.	A	G	16	20	36	0	3	39	0	0
11	44144928	.	G	A	26	22	48	0	5	53	0	0
11	44145001	.	T	A	35	19	54	0	1	55	0	0
11	44148453	.	A	G	23	22	45	0	1	46	0	0
11	44149701	.	T	C	13	0	13	0	21	34	0	0
11	44152693	.	T	G	29	16	45	0	1	46	0	0
11	44152750	.	A	G	30	19	49	0	2	51	0	0
11	44153038	.	G	A	24	11	35	0	0	35	0	0
11	44155583	.	T	C	18	11	29	0	1	30	0	0
11	44155640	.	C	A	12	14	26	0	0	26	0	0
11	44155703	.	C	A	12	15	27	0	3	30	0	0
11	44155766	.	G	T	14	15	29	0	2	31	0	0
11	44157752	.	G	A	23	14	37	0	1	38	0	0
11	44157872	.	C	T	12	16	28	1	4	33	0	0
11	44159320	.	G	C	20	13	33	0	1	34	0	0
11	44161525	.	A	G	14	18	32	0	0	32	0	0
11	44183247	.	T	G	1	2	3	0	0	3	0	0
11	44189682	.	T	C	1	2	3	0	0	3	0	0
11	44189690	.	C	T	2	2	4	0	0	4	0	0
11	44226545	.	G	T	0	6	6	0	5	11	0	0
11	44236394	.	A	G	12	8	20	0	1	21	0	0
11	44244880	.	T	C	7	8	15	0	2	17	0	0
11	44244895	.	T	C	9	6	15	0	2	17	0	0
11	44304360	.	G	A	1	13	14	0	11	25	0	0
11	44324817	.	C	T	4	4	8	21	1	30	0	0
11	44329172	.	C	T	21	22	43	0	0	43	0	0
11	44334915	.	C	T	23	21	44	0	3	47	0	0
11	44335201	.	A	T	6	3	9	0	0	9	0	0
11	44337158	.	A	G	1	2	3	0	0	3	0	0
11	44337303	.	C	T	1	2	3	0	0	3	0	0
11	44337497	.	A	G	3	2	5	0	0	5	0	0
11	44356772	.	T	A	16	11	27	0	1	28	0	0
11	44356791	.	A	G	13	19	32	0	1	33	0	0
11	44358904	.	C	T	14	12	26	0	1	27	0	0
11	44359735	.	C	T	16	16	32	0	2	34	0	0
11	44361701	.	C	T	15	4	19	0	0	19	0	0
11	44400918	.	G	A	6	7	13	0	0	13	0	0
11	44400960	.	G	T	7	9	16	0	0	16	0	0
11	44445095	.	T	A	11	4	15	0	1	16	0	0
11	44445314	.	A	G	5	5	10	0	0	10	0	0
11	44445316	.	T	G	5	4	9	0	1	10	0	0
11	44445500	.	G	A	6	5	11	0	1	12	0	0
11	44445554	.	A	G	12	8	20	0	1	21	0	0
11	44445561	.	C	T	13	9	22	0	1	23	0	0
11	44445733	.	A	G	11	0	11	0	7	18	0	0
11	44445736	.	C	T	11	7	18	0	0	18	0	0
11	44445828	.	T	C	3	7	10	0	0	10	0	0
11	44452668	.	G	A	7	8	15	0	0	15	0	0
11	44452732	.	T	C	7	10	17	0	2	19	0	0
11	44452849	.	G	A	10	9	19	0	1	20	0	0
11	44452886	.	A	G	11	7	18	1	0	19	0	0
11	44455901	.	C	T	6	19	25	0	1	26	0	0
11	44457239	.	G	A	18	8	26	0	1	27	0	0
11	44461386	.	G	C	14	19	33	0	0	33	0	0
11	44461458	.	G	A	19	10	29	0	0	29	0	0
11	44466697	.	C	A	5	3	8	0	1	9	0	0
11	44466931	.	T	C	5	5	10	0	1	11	0	0
11	44468838	.	G	A	6	13	19	0	0	19	0	0
11	44468842	.	T	C	7	10	17	0	0	17	0	0
11	44478403	.	T	C	2	3	5	1	2	8	0	0
11	44483622	.	G	T	6	2	8	0	1	9	0	0
11	44483647	.	G	T	4	3	7	0	0	7	0	0
11	44484460	.	A	G	3	2	5	0	0	5	0	0
11	44484927	.	C	G	6	2	8	0	0	8	0	0
11	44484950	.	A	C	7	4	11	0	0	12	1	0
11	44485675	.	T	G	5	6	11	0	1	12	0	0
11	44502515	.	T	G	2	2	4	0	0	4	0	0
11	44502592	.	G	A	2	2	4	0	0	4	0	0
11	44502630	.	T	A	3	3	6	0	0	6	0	0
11	44502770	.	G	A	0	2	2	0	4	6	0	0
11	44522882	.	A	G	4	5	9	0	2	11	0	0
11	44523553	.	A	G	2	2	4	0	0	4	0	0
11	44606717	.	T	G	3	2	5	0	0	5	0	0
11	44606732	.	T	C	4	4	8	0	0	8	0	0
11	44606844	.	G	T	7	5	12	0	0	12	0	0
11	44607019	.	T	A	9	2	11	0	0	11	0	0
11	44612357	.	A	G	9	5	14	0	1	15	0	0
11	44617164	.	G	A	7	5	12	0	0	12	0	0
11	44617166	.	C	A	1	2	3	0	0	3	0	0
11	44619132	.	A	T	5	2	7	0	0	7	0	0
11	44622594	.	C	T	4	4	8	0	0	8	0	0
11	44624723	.	A	C	3	3	6	0	0	6	0	0
11	44633294	.	T	C	13	9	22	0	0	22	0	0
11	44634908	.	G	A	1	3	4	0	3	7	0	0
11	44637569	.	T	A	4	3	7	0	0	7	0	0
11	44637950	.	A	G	24	27	51	1	3	55	0	0
11	44643882	.	C	T	23	22	45	0	4	49	0	0
11	44647227	.	A	C	31	0	31	0	19	50	0	0
11	44647269	.	T	G	15	15	30	0	3	33	0	0
11	44723130	.	C	G	14	9	23	0	0	23	0	0
11	44723353	.	G	A	1	20	21	0	20	41	0	0
11	44723374	.	T	C	16	18	34	0	2	36	0	0
11	44723416	.	T	G	14	0	14	0	28	42	0	0
11	44723653	.	T	G	21	20	41	0	4	45	0	0
11	44723746	.	A	G	26	23	49	0	3	52	0	0
11	44725596	.	C	T	29	19	48	0	0	48	0	0
11	44725926	.	G	A	1	22	23	0	27	50	0	0
11	44805701	.	G	A	6	8	14	0	1	15	0	0
11	44834268	.	G	A	1	4	5	0	6	11	0	0
11	44838743	.	G	A	1	5	6	0	14	20	0	0
11	44843706	.	A	G	4	0	4	0	13	17	0	0
11	44852248	.	A	G	15	1	16	0	8	24	0	0
11	44852285	.	C	A	10	5	15	0	0	15	0	0
11	44852732	.	G	A	1	4	5	0	4	9	0	0
11	44852756	.	A	T	6	4	10	0	1	11	0	0
11	44852771	.	T	A	7	4	11	0	0	11	0	0
11	44852988	.	T	A	6	3	9	0	0	9	0	0
11	44853021	.	G	C	6	2	8	0	0	8	0	0
11	44853126	.	C	A	5	7	12	0	0	12	0	0
11	44853172	.	C	A	9	5	14	0	1	15	0	0
11	44853325	.	T	C	4	11	15	0	1	16	0	0
11	44853670	.	C	T	2	3	5	0	0	5	0	0
11	44853908	.	A	T	8	9	17	0	1	18	0	0
11	44854055	.	A	T	5	3	8	0	0	8	0	0
11	44854146	.	T	A	2	2	4	0	0	4	0	0
11	44854631	.	C	T	6	4	10	0	0	10	0	0
11	44854636	.	G	T	6	4	10	0	0	10	0	0
11	44854894	.	T	G	12	6	18	0	2	21	1	0
11	44854918	.	G	A	0	10	10	0	17	27	0	0
11	44854996	.	T	C	17	6	23	0	0	23	0	0
11	44855027	.	G	A	1	10	11	0	15	26	0	0
11	44880288	.	A	G	15	13	28	0	2	30	0	0
11	44880291	.	T	A	15	14	29	0	1	30	0	0
11	44880332	.	G	A	15	16	31	0	1	32	0	0
11	44880345	.	C	G	14	17	31	0	0	31	0	0
11	44887200	.	G	A	24	14	38	0	0	38	0	0
11	44887224	.	T	C	19	1	20	0	24	44	0	0
11	44887612	.	G	T	25	17	42	0	1	43	0	0
11	44891507	.	G	A	18	16	34	0	3	37	0	0
11	44892859	.	T	A	26	22	48	0	1	49	0	0
11	44892883	.	G	A	24	20	44	0	1	45	0	0
11	44892943	.	G	A	25	10	35	0	1	36	0	0
11	44892979	.	T	A	17	10	27	0	2	29	0	0
11	44894409	.	T	C	10	1	11	3	10	24	0	0
11	44897584	.	C	T	12	18	30	0	0	30	0	0
11	44897647	.	A	C	11	12	23	0	0	23	0	0
11	44901315	.	C	T	2	5	7	0	8	15	0	0
11	44901373	.	C	A	21	38	59	0	4	64	1	0
11	44906468	.	A	G	6	3	9	0	0	9	0	0
11	44910758	.	T	G	13	18	31	0	2	34	1	0
11	44912485	.	C	A	2	8	10	0	16	26	0	0
11	44913176	.	C	A	2	15	17	0	16	33	0	0
11	44914943	.	G	C	11	21	32	0	0	32	0	0
11	44922524	.	T	G	10	7	17	0	0	17	0	0
11	44927159	.	C	A	9	8	17	0	1	18	0	0
11	44927833	.	G	T	7	13	20	0	0	20	0	0
11	44935375	.	A	G	5	5	10	0	2	12	0	0
11	44953608	.	C	T	4	2	6	0	1	7	0	0
11	44953620	.	C	T	3	3	6	0	0	6	0	0
11	44960620	.	G	A	6	4	10	0	0	10	0	0
11	45097195	.	T	C	3	5	8	0	0	8	0	0
11	45098121	.	A	C	4	2	6	0	0	6	0	0
11	45100902	.	C	G	4	3	7	3	0	10	0	0
11	45125829	.	C	T	3	2	5	0	0	5	0	0
11	45125831	.	A	T	3	2	5	0	0	5	0	0
11	45126658	.	C	T	0	9	9	0	7	16	0	0
11	45126985	.	A	G	3	4	7	0	0	7	0	0
11	45127029	.	C	T	4	3	7	0	1	8	0	0
11	45127191	.	G	A	7	11	18	0	0	18	0	0
11	45127266	.	A	G	10	11	21	0	0	21	0	0
11	45127329	.	G	A	8	5	13	0	1	14	0	0
11	45127335	.	C	T	2	5	7	0	6	13	0	0
11	45127374	.	G	A	6	5	11	0	0	11	0	0
11	45129287	.	G	A	2	4	6	0	1	7	0	0
11	45129347	.	C	A	4	2	6	0	0	6	0	0
11	45131119	.	C	T	6	6	12	0	0	12	0	0
11	45139866	.	C	A	1	3	4	1	0	5	0	0
11	45140116	.	C	G	8	8	16	0	1	17	0	0
11	45140210	.	G	C	6	8	14	0	0	14	0	0
11	45141286	.	T	C	15	10	25	0	0	25	0	0
11	45143417	.	G	T	10	7	17	0	1	18	0	0
11	45192692	.	C	G	1	2	3	0	1	4	0	0
11	45233971	.	G	A	1	3	4	0	3	7	0	0
11	45235063	.	A	G	3	0	3	0	5	8	0	0
11	45240568	.	C	T	1	8	9	0	0	9	0	0
11	45242360	.	T	C	4	8	12	0	2	14	0	0
11	45242450	.	C	T	7	10	17	0	0	17	0	0
11	45242912	.	T	C	9	7	16	0	1	17	0	0
11	45245862	.	G	A	2	3	5	0	1	6	0	0
11	45245964	.	C	T	1	2	3	0	5	8	0	0
11	45262079	.	C	T	15	12	27	0	1	28	0	0
11	45262138	.	C	G	12	0	12	0	14	26	0	0
11	45262178	.	C	T	12	10	22	0	0	22	0	0
11	45262186	.	G	A	1	10	11	0	11	22	0	0
11	45262342	.	C	T	6	16	22	0	1	23	0	0
11	45265829	.	G	A	0	6	6	0	12	18	0	0
11	45265898	.	C	T	8	9	17	0	0	17	0	0
11	45269752	.	T	C	16	9	25	0	3	28	0	0
11	45272686	.	G	A	1	4	5	0	6	11	0	0
11	45287575	.	G	A	2	10	12	0	1	13	0	0
11	45290463	.	A	G	11	9	20	0	0	20	0	0
11	45291926	.	G	A	12	7	19	0	0	19	0	0
11	45294734	.	T	C	5	7	12	0	0	12	0	0
11	45294760	.	G	T	3	5	8	0	0	8	0	0
11	45326553	.	C	T	3	4	7	0	1	8	0	0
11	45327319	.	T	C	4	3	7	0	0	7	0	0
11	45327456	.	C	T	6	4	10	0	0	10	0	0
11	45327609	.	T	C	5	5	10	0	0	10	0	0
11	45327997	.	A	G	5	4	9	0	0	9	0	0
11	45328046	.	C	T	5	2	7	0	0	7	0	0
11	45343231	.	T	A	4	4	8	0	0	8	0	0
11	45343264	.	A	T	4	6	10	0	0	10	0	0
11	45343492	.	G	C	0	5	5	0	7	12	0	0
11	45344090	.	C	T	7	5	12	0	0	12	0	0
11	45348465	.	G	A	2	4	6	0	0	6	0	0
11	45350708	.	G	T	1	1	2	0	1	3	0	0
11	45350728	.	C	T	3	10	13	0	0	13	0	0
11	45351717	.	G	T	5	5	10	0	1	11	0	0
11	45355022	.	C	G	10	10	20	2	1	23	0	0
11	45355155	.	C	T	2	6	8	0	0	8	0	0
11	45355436	.	C	G	14	19	33	0	0	33	0	0
11	45355473	.	C	T	2	18	20	0	16	36	0	0
11	45356352	.	G	A	6	9	15	0	1	16	0	0
11	45356666	.	A	G	15	16	31	0	1	32	0	0
11	45359878	.	C	T	7	8	15	0	0	15	0	0
11	45362172	.	A	T	8	6	14	0	1	15	0	0
11	45362862	.	T	C	2	10	12	0	0	12	0	0
11	45366720	.	C	T	7	5	12	0	3	15	0	0
11	45370259	.	G	A	9	7	16	0	1	17	0	0
11	45370529	.	G	A	7	6	13	0	0	13	0	0
11	45371831	.	A	G	3	5	8	0	0	8	0	0
11	45371868	.	A	G	3	9	12	0	0	12	0	0
11	45375266	.	G	T	4	4	8	0	0	8	0	0
11	45389508	.	A	T	4	2	6	0	0	6	0	0
11	45389599	.	C	G	3	2	5	0	1	6	0	0
11	45389891	.	G	A	10	8	18	1	0	19	0	0
11	45389922	.	G	A	2	7	9	0	0	9	0	0
11	45390057	.	G	A	8	9	17	0	1	18	0	0
11	45391683	.	G	A	1	12	13	0	16	29	0	0
11	45391725	.	A	G	16	8	24	0	2	26	0	0
11	45391727	.	T	C	14	10	24	0	0	24	0	0
11	45391788	.	C	T	13	11	24	0	1	25	0	0
11	45393395	.	C	T	13	15	28	0	3	31	0	0
11	45398744	.	A	G	32	32	64	0	5	69	0	0
11	45398804	.	T	C	29	32	61	0	3	64	0	0
11	45399589	.	A	G	17	25	42	0	2	44	0	0
11	45399799	.	G	T	21	10	31	0	3	34	0	0
11	45402861	.	G	A	13	12	25	0	1	26	0	0
11	45402945	.	G	A	14	15	29	0	2	31	0	0
11	45403209	.	A	T	16	11	27	0	0	27	0	0
11	45403712	.	G	A	16	21	37	0	2	39	0	0
11	45403733	.	G	A	19	15	34	0	0	34	0	0
11	45403854	.	G	A	21	20	41	0	3	44	0	0
11	45403866	.	G	A	20	22	42	0	1	43	0	0
11	45403914	.	C	T	2	22	24	0	24	48	0	0
11	45407215	.	G	A	16	14	30	0	2	32	0	0
11	45419948	.	C	G	0	7	7	0	18	25	0	0
11	45428466	.	A	T	3	3	6	0	0	6	0	0
11	45429190	.	A	T	6	2	8	0	0	8	0	0
11	45430220	.	C	T	0	2	2	0	1	3	0	0
11	45432027	.	A	G	3	2	5	0	0	5	0	0
11	45433369	.	C	T	1	2	3	0	0	3	0	0
11	45439858	.	C	A	5	7	12	0	0	12	0	0
11	45448187	.	G	A	4	4	8	0	1	9	0	0
11	45448277	.	G	A	0	7	7	0	4	11	0	0
11	45448289	.	C	T	4	8	12	0	1	13	0	0
11	45452373	.	C	T	4	5	9	0	0	9	0	0
11	45452786	.	G	A	1	4	5	0	1	6	0	0
11	45460337	.	G	A	7	5	12	0	1	13	0	0
11	45461318	.	G	A	0	14	14	0	20	34	0	0
11	45463352	.	T	C	15	11	26	0	2	28	0	0
11	45463490	.	G	T	1	13	14	0	22	36	0	0
11	45463661	.	G	A	3	3	6	0	29	35	0	0
11	45463730	.	G	A	2	11	13	1	18	32	0	0
11	45464132	.	A	G	6	5	11	0	1	12	0	0
11	45464188	.	G	C	1	6	7	0	0	7	0	0
11	45464673	.	C	T	4	7	11	0	0	11	0	0
11	45465080	.	T	A	13	8	21	0	0	21	0	0
11	45468821	.	A	C	2	2	4	0	0	4	0	0
11	45468899	.	C	T	2	4	6	0	0	6	0	0
11	45469689	.	C	T	4	2	6	0	0	6	0	0
11	45469766	.	A	G	8	3	11	0	1	12	0	0
11	45469914	.	G	T	3	7	10	0	0	10	0	0
11	45470243	.	C	T	4	10	14	0	8	22	0	0
11	45470277	.	C	T	7	13	20	0	6	26	0	0
11	45470279	.	C	A	8	11	19	0	8	28	1	0
12	465732	.	G	A	1	14	15	0	12	27	0	0
12	466221	.	G	C	7	12	19	0	1	20	0	0
12	497201	.	C	T	18	6	24	0	1	25	0	0
12	499855	.	C	T	14	13	27	0	0	27	0	0
12	499865	.	C	T	11	10	21	0	3	24	0	0
12	502221	.	C	T	17	18	35	0	0	35	0	0
12	503308	.	G	A	22	14	36	0	1	37	0	0
12	516845	.	C	T	19	18	37	0	2	39	0	0
12	518107	.	T	C	21	23	44	0	3	47	0	0
12	527402	.	A	C	19	11	30	0	1	31	0	0
12	527693	.	T	G	10	28	38	0	1	39	0	0
12	527712	.	T	C	13	21	34	0	0	34	0	0
12	532019	.	C	G	6	5	11	0	1	12	0	0
12	532054	.	C	G	2	3	5	0	0	5	0	0
12	534252	.	A	T	5	6	11	0	1	12	0	0
12	534258	.	C	G	6	5	11	0	0	11	0	0
12	534297	.	A	G	2	2	4	0	0	4	0	0
12	534642	.	C	T	5	3	8	0	0	8	0	0
12	534927	.	T	C	8	4	12	0	0	12	0	0
12	540021	.	G	C	2	7	9	0	0	9	0	0
12	540114	.	G	A	1	3	4	0	0	4	0	0
12	549605	.	T	C	9	0	9	0	3	12	0	0
12	550387	.	G	T	10	11	21	1	1	23	0	0
12	550513	.	T	A	11	6	17	0	0	17	0	0
12	550516	.	C	T	1	6	7	0	10	17	0	0
12	550973	.	T	C	14	14	28	0	2	30	0	0
12	550985	.	T	C	11	0	11	0	14	25	0	0
12	551098	.	A	G	15	11	26	0	1	27	0	0
12	551192	.	A	G	11	10	21	0	1	22	0	0
12	551372	.	C	T	12	14	26	0	3	29	0	0
12	551398	.	C	T	12	7	19	0	5	24	0	0
12	551549	.	T	C	17	0	17	0	16	33	0	0
12	551892	.	T	C	11	0	11	0	23	34	0	0
12	551927	.	A	G	13	19	32	0	0	32	0	0
12	554210	.	T	C	19	0	19	0	17	36	0	0
12	558142	.	A	C	10	14	24	0	1	25	0	0
12	561131	.	G	T	6	3	9	0	0	9	0	0
12	561350	.	G	T	4	6	10	0	0	10	0	0
12	562200	.	C	T	4	5	9	0	0	9	0	0
12	562203	.	C	T	1	4	5	0	4	9	0	0
12	564552	.	C	T	0	3	3	0	4	7	0	0
12	564553	.	G	A	4	3	7	0	0	7	0	0
12	564650	.	G	T	6	4	10	0	2	12	0	0
12	565571	.	C	G	5	5	10	1	1	12	0	0
12	566983	.	A	G	3	6	9	0	1	10	0	0
12	567012	.	T	C	2	0	2	0	8	10	0	0
12	568872	.	G	A	3	3	6	0	0	6	0	0
12	571873	.	T	C	5	6	11	0	0	11	0	0
12	573390	.	G	A	2	2	4	0	0	4	0	0
12	573414	.	C	T	1	2	3	0	0	3	0	0
12	573431	.	G	A	2	3	5	0	0	5	0	0
12	573456	.	A	G	1	2	3	0	0	3	0	0
12	577838	.	A	C	5	5	10	0	1	11	0	0
12	584003	.	C	T	1	4	5	0	0	5	0	0
12	589527	.	G	A	2	3	5	0	0	5	0	0
12	592777	.	G	A	2	2	4	0	0	4	0	0
12	598468	.	C	G	0	2	2	0	3	5	0	0
12	602294	.	A	C	1	2	3	0	0	3	0	0
12	602782	.	C	T	1	4	5	0	0	5	0	0
12	613178	.	T	C	1	2	3	0	0	3	0	0
12	617914	.	A	G	1	2	3	0	0	3	0	0
12	619509	.	C	T	1	2	3	0	0	3	0	0
12	630412	.	A	G	1	2	3	0	0	3	0	0
12	630445	.	T	A	2	3	5	0	0	5	0	0
12	630495	.	G	A	2	2	4	0	0	4	0	0
12	630634	.	A	C	5	0	5	0	4	9	0	0
12	632298	.	C	T	4	3	7	0	0	7	0	0
12	634241	.	A	G	4	5	9	0	1	10	0	0
12	634292	.	C	T	1	5	6	0	5	11	0	0
12	645760	.	T	C	3	2	5	0	0	5	0	0
12	662669	.	C	A	1	2	3	0	0	3	0	0
12	726557	.	G	A	0	2	2	0	1	3	0	0
12	732011	.	T	C	2	3	5	0	0	5	0	0
12	760750	.	C	T	2	2	4	1	0	5	0	0
12	763635	.	C	T	1	4	5	0	0	5	0	0
12	770346	.	A	T	2	3	5	0	0	5	0	0
12	786410	.	G	C	1	2	3	0	0	3	0	0
12	786450	.	G	A	1	3	4	0	0	4	0	0
12	847787	.	T	C	14	18	32	0	0	32	0	0
12	848846	.	T	C	22	2	24	0	22	46	0	0
12	850303	.	T	C	30	20	50	0	2	52	0	0
12	906722	.	A	G	7	10	17	0	0	17	0	0
12	907584	.	G	A	6	11	17	0	3	20	0	0
12	910704	.	T	C	5	1	6	0	12	18	0	0
12	911042	.	C	T	1	9	10	0	15	25	0	0
12	911162	.	G	C	9	10	19	0	0	19	0	0
12	911180	.	A	C	8	7	15	0	0	15	0	0
12	912274	.	G	C	12	17	29	0	1	30	0	0
12	927844	.	G	C	12	10	22	0	0	22	0	0
12	927853	.	G	A	12	8	20	0	2	22	0	0
12	931371	.	G	A	9	11	20	0	1	21	0	0
12	931410	.	C	A	1	14	15	0	8	23	0	0
12	931437	.	A	G	7	7	14	0	2	16	0	0
12	932092	.	G	T	8	5	13	0	0	13	0	0
12	943314	.	C	T	1	3	4	0	11	15	0	0
12	964877	.	T	C	11	0	11	0	27	38	0	0
12	964888	.	T	G	11	26	37	0	0	37	0	0
12	972975	.	C	T	1	9	10	0	9	19	0	0
12	979718	.	G	A	14	6	20	0	0	20	0	0
12	982979	.	T	A	5	6	11	0	0	11	0	0
12	983074	.	C	T	4	5	9	0	2	11	0	0
12	983176	.	T	A	4	9	13	0	0	13	0	0
12	983222	.	G	A	2	3	5	0	1	6	0	0
12	983340	.	C	T	10	11	21	0	0	21	0	0
12	986792	.	T	G	5	2	7	0	0	7	0	0
12	986834	.	A	G	2	2	4	0	1	5	0	0
12	989974	.	G	C	6	4	10	0	1	11	0	0
12	993237	.	C	G	1	3	4	0	0	4	0	0
12	997320	.	G	A	4	4	8	0	0	8	0	0
12	997834	.	T	C	9	5	14	0	0	14	0	0
12	997849	.	T	C	10	5	15	0	0	15	0	0
12	997909	.	A	G	4	8	12	0	0	12	0	0
12	997917	.	G	A	4	7	11	0	0	11	0	0
12	999579	.	C	G	2	4	6	0	0	6	0	0
12	1014553	.	C	T	0	14	14	0	3	17	0	0
12	1015197	.	C	T	0	15	15	0	8	23	0	0
12	1015845	.	G	A	10	13	23	0	0	23	0	0
12	1019123	.	C	T	1	5	6	0	4	10	0	0
12	1019243	.	G	T	3	6	9	0	1	10	0	0
12	1019311	.	C	G	3	10	13	0	1	14	0	0
12	1019503	.	G	A	3	3	6	0	0	6	0	0
12	1021152	.	G	A	2	4	6	0	0	6	0	0
12	1021194	.	G	A	1	2	3	0	0	3	0	0
12	1021200	.	C	T	1	2	3	0	1	4	0	0
12	1026131	.	T	C	6	7	13	0	0	13	0	0
12	1030048	.	A	G	2	4	6	0	3	9	0	0
12	1387913	.	A	G	3	2	5	0	0	5	0	0
12	1947596	.	T	C	5	0	5	0	8	13	0	0
12	1947645	.	G	A	4	5	9	0	0	9	0	0
12	1947656	.	A	T	2	5	7	0	2	9	0	0
12	1947751	.	T	C	4	4	8	0	0	8	0	0
12	1947822	.	A	G	4	5	9	0	0	9	0	0
12	1947999	.	G	A	13	6	19	0	3	22	0	0
12	1950141	.	C	A	5	8	13	0	1	14	0	0
12	2638968	.	C	T	1	3	4	0	0	4	0	0
12	2744279	.	G	T	4	2	6	0	0	6	0	0
12	2744291	.	A	T	5	2	7	0	0	7	0	0
12	2744495	.	T	G	3	3	6	0	1	7	0	0
12	2744549	.	A	G	1	4	5	0	0	5	0	0
12	2781427	.	C	A	1	2	3	0	0	3	0	0
12	2849970	.	A	G	2	4	6	0	0	6	0	0
12	2849974	.	A	G	3	3	6	0	1	7	0	0
12	2851355	.	C	T	1	3	4	0	0	4	0	0
12	3270731	.	T	C	3	5	8	0	0	8	0	0
12	3271124	.	A	G	4	4	8	0	0	8	0	0
12	3271125	.	A	G	3	5	8	0	0	8	0	0
12	3271553	.	G	A	5	5	10	0	0	10	0	0
12	3271646	.	T	A	6	2	8	0	1	9	0	0
12	3271747	.	A	G	8	3	11	0	3	14	0	0
12	3271785	.	A	G	9	3	12	1	0	13	0	0
12	3272111	.	A	C	0	8	8	0	0	8	0	0
12	3272114	.	A	G	1	8	9	0	0	9	0	0
12	3272385	.	A	G	6	0	6	2	1	9	0	0
12	3272396	.	A	G	8	2	10	0	1	11	0	0
12	3272421	.	A	G	6	10	16	0	0	16	0	0
12	3272454	.	A	G	10	4	14	0	1	15	0	0
12	3272484	.	A	G	10	4	14	0	0	14	0	0
12	3272753	.	A	G	3	2	5	1	1	7	0	0
12	3452712	.	C	T	0	2	2	0	3	5	0	0
12	3453378	.	C	T	2	2	4	0	0	4	0	0
12	3571986	.	C	T	12	12	24	0	1	25	0	0
12	3574398	.	C	G	8	16	24	0	2	26	0	0
12	3714149	.	G	T	5	6	11	0	1	12	0	0
12	3714183	.	G	A	11	8	19	0	0	19	0	0
12	3714213	.	T	A	8	11	19	0	1	20	0	0
12	3714315	.	C	T	8	13	21	0	1	22	0	0
12	3714330	.	A	T	10	13	23	0	0	23	0	0
12	3714425	.	C	A	6	9	15	0	0	15	0	0
12	3714578	.	T	C	9	1	10	0	11	21	0	0
12	3714783	.	T	C	3	4	7	1	1	9	0	0
12	3714784	.	T	C	4	4	8	1	0	9	0	0
12	3715016	.	A	G	12	4	16	0	0	16	0	0
12	3715201	.	T	C	3	5	8	0	0	8	0	0
12	3715544	.	T	C	5	5	10	0	0	10	0	0
12	3715585	.	T	C	3	4	7	0	0	7	0	0
12	3715586	.	T	C	5	2	7	0	0	7	0	0
12	3715697	.	T	C	3	2	5	0	0	5	0	0
12	3715730	.	T	C	5	1	6	0	7	13	0	0
12	3715904	.	G	A	7	8	15	0	1	16	0	0
12	3719297	.	T	G	8	5	13	0	0	13	0	0
12	3719312	.	T	C	7	0	7	0	6	13	0	0
12	3721941	.	A	G	1	2	3	0	2	5	0	0
12	3726646	.	T	A	8	10	18	0	0	18	0	0
12	3731590	.	G	A	1	15	16	0	12	28	0	0
12	3731602	.	C	A	15	12	27	0	1	28	0	0
12	3740940	.	G	A	10	12	22	0	0	22	0	0
12	3740958	.	C	A	8	10	18	0	1	19	0	0
12	3747640	.	G	A	14	7	21	0	3	24	0	0
12	3749502	.	A	G	12	4	16	0	1	17	0	0
12	3756203	.	G	C	13	14	27	0	0	27	0	0
12	3756215	.	G	A	11	14	25	0	0	25	0	0
12	3756297	.	G	T	12	5	17	0	0	17	0	0
12	3756303	.	C	T	1	10	11	0	6	17	0	0
12	3766657	.	T	G	4	3	7	0	0	7	0	0
12	3767021	.	G	A	2	4	6	0	1	7	0	0
12	3767321	.	G	T	7	8	15	0	0	15	0	0
12	3778422	.	A	G	3	3	6	0	2	8	0	0
12	3789409	.	T	C	6	0	6	0	16	23	1	0
12	3789489	.	T	A	6	4	10	0	0	10	0	0
12	3791925	.	C	A	3	3	6	0	0	6	0	0
12	3806732	.	C	T	9	7	16	0	0	16	0	0
12	3806810	.	C	T	10	8	18	0	0	18	0	0
12	3806825	.	T	G	7	9	16	0	1	17	0	0
12	3807920	.	T	G	5	7	12	0	0	12	0	0
12	3808038	.	T	C	4	3	7	0	1	8	0	0
12	3808704	.	A	G	9	6	15	0	0	15	0	0
12	3808728	.	C	T	9	7	16	0	0	16	0	0
12	3840324	.	C	T	3	7	10	0	1	11	0	0
12	3840515	.	C	A	0	4	4	0	7	11	0	0
12	3848176	.	A	G	5	8	13	0	0	13	0	0
12	3855125	.	G	A	3	4	7	0	0	7	0	0
12	3861279	.	A	G	1	0	1	0	8	9	0	0
12	3871480	.	C	T	7	3	10	0	0	10	0	0
12	3875667	.	A	G	2	5	7	0	0	7	0	0
12	3875727	.	T	C	1	4	5	0	0	5	0	0
12	3877941	.	G	A	5	4	9	0	0	9	0	0
12	3880610	.	A	G	7	2	9	0	0	9	0	0
12	3880612	.	G	T	7	2	9	0	0	9	0	0
12	3880646	.	C	A	6	5	11	0	0	11	0	0
12	3880661	.	A	G	1	0	1	0	7	8	0	0
12	3885358	.	C	T	4	4	8	0	0	8	0	0
12	3921474	.	A	G	2	0	2	0	4	6	0	0
12	3921684	.	A	G	4	2	6	0	1	7	0	0
12	3922047	.	A	G	2	7	9	0	2	11	0	0
12	3922068	.	A	T	4	5	9	0	0	9	0	0
12	3922086	.	A	C	5	6	11	0	0	11	0	0
12	3922536	.	A	G	3	5	8	0	0	8	0	0
12	3922549	.	G	A	0	6	6	0	5	11	0	0
12	3922725	.	A	T	4	2	6	0	1	7	0	0
12	3922764	.	A	G	1	5	6	0	0	6	0	0
12	3944265	.	T	C	4	6	10	0	1	11	0	0
12	3946833	.	G	A	29	25	54	0	4	58	0	0
12	3948593	.	C	T	26	19	45	0	1	46	0	0
12	3949212	.	G	A	29	24	53	0	2	55	0	0
12	3951117	.	C	T	15	13	28	1	1	30	0	0
12	3953155	.	T	A	16	18	34	0	2	36	0	0
12	3954003	.	T	G	9	12	21	0	1	22	0	0
12	3954072	.	C	T	16	10	26	0	1	27	0	0
12	3955573	.	A	C	32	0	32	0	19	51	0	0
12	3956864	.	A	G	22	18	40	0	3	43	0	0
12	3958476	.	A	G	16	21	37	0	0	37	0	0
12	3964537	.	T	C	11	6	17	0	3	20	0	0
12	3964552	.	C	A	7	10	17	0	1	18	0	0
12	3964936	.	C	A	0	9	9	0	15	24	0	0
12	3965002	.	G	T	12	10	22	1	5	28	0	0
12	3965168	.	T	C	19	19	38	0	2	40	0	0
12	3965237	.	G	A	15	17	32	0	0	32	0	0
12	3974755	.	C	T	0	11	11	0	14	25	0	0
12	3978242	.	T	G	14	10	24	0	0	24	0	0
12	3998833	.	A	T	3	3	6	0	0	6	0	0
12	3999071	.	C	T	2	3	5	0	0	5	0	0
12	3999115	.	G	A	5	7	12	0	0	12	0	0
12	4002687	.	C	A	10	8	18	0	0	18	0	0
12	4002709	.	A	G	10	13	23	0	0	23	0	0
12	4004448	.	C	T	1	8	9	0	4	13	0	0
12	4004466	.	C	T	0	7	7	0	8	15	0	0
12	4009150	.	G	A	10	5	15	0	1	16	0	0
12	4009194	.	C	T	10	6	16	0	0	16	0	0
12	4009337	.	G	A	5	7	12	0	0	12	0	0
12	4009392	.	C	A	3	8	11	0	0	11	0	0
12	4009393	.	G	C	8	3	11	0	0	11	0	0
12	4009462	.	A	T	11	7	18	0	2	20	0	0
12	4012111	.	A	G	5	7	12	0	0	12	0	0
12	4016206	.	C	T	4	6	10	0	0	10	0	0
12	4020275	.	C	G	1	4	5	0	0	5	0	0
12	4022458	.	A	G	7	7	14	0	0	14	0	0
12	4024074	.	C	T	0	2	2	0	6	8	0	0
12	4024112	.	A	G	4	3	7	0	0	7	0	0
12	4057769	.	G	A	4	2	6	0	1	7	0	0
12	4061544	.	T	A	0	2	2	0	3	5	0	0
12	4133321	.	A	G	3	3	6	0	0	6	0	0
12	4144291	.	T	C	3	8	11	0	0	11	0	0
12	4144321	.	G	A	6	3	9	0	1	10	0	0
12	4144477	.	T	G	1	2	3	0	0	3	0	0
12	4144645	.	C	T	3	4	7	2	0	9	0	0
12	4144707	.	G	A	2	1	3	0	0	3	0	0
12	4144715	.	C	G	2	2	4	0	0	4	0	0
12	4144869	.	G	T	1	4	5	0	1	6	0	0
12	4217418	.	T	C	1	5	6	0	0	6	0	0
12	4220453	.	A	G	4	5	9	0	2	11	0	0
12	4220656	.	T	C	4	3	7	0	0	7	0	0
12	4222907	.	T	A	2	2	4	0	0	4	0	0
12	4225361	.	A	T	3	2	5	0	0	5	0	0
12	4226053	.	G	A	1	2	3	0	4	7	0	0
12	4226080	.	C	T	4	3	7	0	0	7	0	0
12	4226089	.	G	A	4	4	8	0	0	8	0	0
12	4226140	.	C	G	2	0	2	0	5	7	0	0
12	4226155	.	A	G	5	0	5	0	3	8	0	0
12	4226699	.	A	G	3	4	7	0	1	8	0	0
12	4226846	.	T	A	2	4	6	0	1	7	0	0
12	4227248	.	A	C	3	5	8	0	0	8	0	0
12	4227308	.	C	G	4	3	7	0	1	8	0	0
12	4227632	.	G	A	0	7	7	0	1	8	0	0
12	4231775	.	A	G	6	6	12	0	0	12	0	0
12	4231776	.	G	A	7	5	12	0	1	13	0	0
12	4231884	.	C	A	4	4	8	0	1	9	0	0
12	4231902	.	A	G	4	0	4	0	6	10	0	0
12	4232001	.	C	T	2	2	4	0	0	4	0	0
12	4232028	.	G	A	0	3	3	0	3	6	0	0
12	4232055	.	G	C	4	8	12	0	0	12	0	0
12	4232208	.	C	G	11	5	16	0	1	17	0	0
12	4232210	.	T	A	10	6	16	0	1	17	0	0
12	4232320	.	C	T	5	4	9	0	0	9	0	0
12	4232369	.	G	T	9	10	19	0	0	19	0	0
12	4232434	.	C	A	6	14	20	0	0	20	0	0
12	4234489	.	G	C	6	7	13	0	1	14	0	0
12	4238122	.	T	C	6	4	10	0	0	10	0	0
12	4238464	.	A	G	9	0	9	0	7	16	0	0
12	4238519	.	C	A	11	10	21	0	0	21	0	0
12	4238720	.	T	C	3	3	6	0	0	6	0	0
12	4601361	.	G	A	4	4	8	0	0	8	0	0
12	4602047	.	T	A	12	7	19	1	0	20	0	0
12	4602245	.	G	A	15	18	33	0	1	34	0	0
12	4602322	.	G	A	18	9	27	0	3	30	0	0
12	4602399	.	A	T	21	18	39	0	1	40	0	0
12	4602464	.	G	C	17	0	17	0	17	34	0	0
12	4602503	.	C	A	12	12	24	0	3	27	0	0
12	4606669	.	C	T	19	18	37	0	1	38	0	0
12	4606693	.	G	A	14	18	32	0	1	33	0	0
12	4609143	.	C	T	23	10	33	0	0	33	0	0
12	4609172	.	T	G	12	21	33	0	2	35	0	0
12	4609364	.	A	G	14	18	32	0	0	32	0	0
12	4609391	.	T	C	13	21	34	0	2	36	0	0
12	4609409	.	C	T	13	21	34	0	0	34	0	0
12	4611128	.	C	T	16	18	34	0	0	34	0	0
12	4615329	.	G	A	14	12	26	0	2	28	0	0
12	4616967	.	C	G	14	14	28	0	0	28	0	0
12	4617243	.	G	A	18	22	40	0	2	42	0	0
12	4618033	.	C	T	9	14	23	0	0	23	0	0
12	4618087	.	T	G	13	18	31	0	0	31	0	0
12	4618588	.	G	A	7	5	12	0	0	12	0	0
12	4619179	.	A	G	10	6	16	0	2	18	0	0
12	4619230	.	G	T	15	8	23	0	0	23	0	0
12	4619553	.	C	T	10	13	23	0	2	25	0	0
12	4619718	.	C	T	9	10	19	0	0	19	0	0
12	4619895	.	G	A	11	14	25	0	1	26	0	0
12	4620211	.	T	A	8	13	21	0	5	26	0	0
12	4620483	.	C	T	0	17	17	0	7	24	0	0
12	4621108	.	A	T	6	5	11	0	1	12	0	0
12	4621363	.	C	G	0	6	6	0	3	9	0	0
12	4621480	.	G	A	11	10	21	0	3	24	0	0
12	4621782	.	A	G	10	8	18	0	1	19	0	0
12	4622344	.	G	A	11	7	18	0	0	18	0	0
12	4622899	.	A	G	15	11	26	0	0	26	0	0
12	4631461	.	G	A	3	6	9	0	0	9	0	0
12	4631996	.	C	A	1	5	6	0	0	6	0	0
12	4632019	.	T	A	1	3	4	0	0	4	0	0
12	4644090	.	C	T	7	4	11	0	1	12	0	0
12	4645262	.	C	G	4	6	10	0	0	10	0	0
12	4645291	.	G	T	6	4	10	0	1	11	0	0
12	4648491	.	C	T	3	4	7	0	0	7	0	0
12	4648530	.	G	A	5	6	11	0	1	12	0	0
12	4653986	.	C	T	2	11	13	0	7	20	0	0
12	4661410	.	C	T	3	6	9	0	1	10	0	0
12	4686330	.	T	A	3	6	9	0	0	9	0	0
12	4690311	.	A	G	5	9	14	0	2	16	0	0
12	4690425	.	G	A	0	11	11	0	8	19	0	0
12	4690572	.	T	C	4	10	14	0	0	14	0	0
12	4690668	.	G	C	7	4	11	0	0	11	0	0
12	4690785	.	T	C	3	6	9	0	0	9	0	0
12	4691043	.	G	A	0	5	5	0	5	10	0	0
12	4691146	.	A	G	3	6	9	0	1	10	0	0
12	4712234	.	T	C	8	9	17	0	1	18	0	0
12	4713010	.	C	A	11	11	22	0	1	23	0	0
12	4715953	.	A	G	12	2	14	1	10	25	0	0
12	4715968	.	G	A	13	12	25	1	1	27	0	0
12	4716061	.	A	C	11	11	22	0	1	23	0	0
12	4716064	.	T	G	12	0	12	0	9	21	0	0
12	4716361	.	A	G	8	5	13	0	0	13	0	0
12	4716375	.	T	C	8	8	16	0	0	16	0	0
12	4720264	.	T	C	6	8	14	0	1	15	0	0
12	4722415	.	C	T	12	14	26	0	1	27	0	0
12	4724553	.	G	A	11	8	19	0	0	19	0	0
12	4724765	.	G	A	0	5	5	0	5	10	0	0
12	4725114	.	A	C	8	8	16	0	1	17	0	0
12	4725170	.	A	T	11	9	20	0	0	21	1	0
12	4733912	.	T	C	3	1	4	0	1	5	0	0
12	4733968	.	C	T	13	17	30	0	0	30	0	0
12	4734008	.	G	T	17	27	44	0	0	44	0	0
12	4734068	.	G	T	19	19	38	0	1	39	0	0
12	4734306	.	A	T	24	19	43	0	0	43	0	0
12	4734312	.	A	G	23	17	40	0	1	41	0	0
12	4734418	.	T	G	19	19	38	0	2	40	0	0
12	4734476	.	T	C	12	1	13	0	27	40	0	0
12	4734925	.	C	T	25	31	56	0	1	57	0	0
12	4734967	.	G	A	23	31	54	0	3	57	0	0
12	4734979	.	C	T	3	30	33	0	27	60	0	0
12	4751860	.	C	T	20	17	37	0	0	37	0	0
12	4752981	.	G	A	10	26	36	0	0	37	1	0
12	4753014	.	A	G	18	22	40	0	0	40	0	0
12	4753020	.	A	G	17	21	38	0	4	42	0	0
12	4753095	.	C	T	21	24	45	0	2	47	0	0
12	4753104	.	C	T	4	24	28	0	21	49	0	0
12	4754639	.	G	T	12	20	32	0	1	33	0	0
12	4920541	.	A	G	2	0	2	0	3	5	0	0
12	4935876	.	G	A	1	2	3	0	0	3	0	0
12	4941748	.	C	T	1	2	3	0	0	3	0	0
12	4944911	.	G	A	0	3	3	0	4	7	0	0
12	4945209	.	T	C	1	2	3	0	0	3	0	0
12	4949825	.	A	G	4	0	4	0	3	7	0	0
12	4949876	.	T	C	2	2	4	0	0	4	0	0
12	4950356	.	C	T	1	2	3	0	0	3	0	0
12	4957095	.	A	G	6	4	10	0	1	11	0	0
12	4960945	.	A	T	1	2	3	0	1	4	0	0
12	4960949	.	G	A	2	1	3	0	1	4	0	0
12	4961162	.	C	T	2	3	5	0	0	5	0	0
12	4961256	.	A	G	3	2	5	0	1	6	0	0
12	4961930	.	A	G	1	5	6	0	1	7	0	0
12	4961955	.	A	C	1	5	6	0	0	6	0	0
12	4962027	.	A	G	3	5	8	0	0	8	0	0
12	4962640	.	C	A	5	5	10	0	0	10	0	0
12	4962643	.	G	T	0	5	5	0	5	10	0	0
12	5021183	.	A	G	1	0	1	0	5	6	0	0
12	5032676	.	A	G	2	0	2	0	3	5	0	0
12	5038141	.	C	T	1	4	5	0	0	5	0	0
12	5038363	.	A	C	3	3	6	0	0	6	0	0
12	5044104	.	A	G	7	1	8	0	7	15	0	0
12	5044106	.	G	A	7	8	15	0	0	15	0	0
12	5044338	.	A	T	6	7	13	0	1	14	0	0
12	5044396	.	T	C	6	5	11	0	0	11	0	0
12	5044462	.	A	T	3	7	10	0	0	10	0	0
12	5044545	.	A	G	3	0	3	0	5	8	0	0
12	5044737	.	A	G	5	0	5	0	4	9	0	0
12	5071637	.	A	T	3	4	7	0	0	7	0	0
12	5071640	.	T	C	1	4	5	0	0	5	0	0
12	5084514	.	C	T	14	15	29	0	0	29	0	0
12	5090591	.	T	C	10	16	26	0	0	26	0	0
12	5091368	.	A	T	11	7	18	0	0	18	0	0
12	5116192	.	A	G	32	23	55	0	0	55	0	0
12	5119802	.	T	C	21	21	42	0	1	43	0	0
12	5180489	.	G	A	4	7	11	0	0	11	0	0
12	5180626	.	G	A	6	8	14	1	0	15	0	0
12	5180662	.	T	A	7	5	12	1	1	14	0	0
12	5182460	.	T	C	3	5	8	0	2	10	0	0
12	5182718	.	G	A	2	8	10	0	1	11	0	0
12	5185627	.	G	A	4	9	13	0	0	13	0	0
12	5189940	.	C	T	2	4	6	0	0	6	0	0
12	5223386	.	C	T	2	1	3	0	1	4	0	0
12	5358435	.	G	A	1	2	3	0	0	3	0	0
12	5382286	.	G	A	1	3	4	0	4	8	0	0
12	5388700	.	C	T	1	2	3	0	0	3	0	0
12	5389889	.	G	A	3	4	7	1	0	8	0	0
12	5389940	.	T	C	2	2	4	1	0	5	0	0
12	5399803	.	G	A	5	3	8	0	1	9	0	0
12	5399832	.	G	C	6	7	13	0	0	13	0	0
12	5402235	.	G	T	2	3	5	0	0	5	0	0
12	5404160	.	T	C	3	0	3	0	9	12	0	0
12	5404181	.	G	C	2	0	2	0	6	8	0	0
12	5404403	.	C	T	0	4	4	0	3	7	0	0
12	5407930	.	A	T	5	2	7	0	0	7	0	0
12	5412179	.	C	T	5	2	7	0	0	7	0	0
12	5412235	.	C	G	3	3	6	0	0	6	0	0
12	5424239	.	G	A	2	2	4	0	0	4	0	0
12	5424264	.	A	G	3	4	7	0	0	7	0	0
12	5424499	.	G	T	4	4	8	0	0	8	0	0
12	5424785	.	A	T	10	6	16	0	0	16	0	0
12	5427456	.	T	A	8	10	18	0	0	18	0	0
12	5427491	.	T	G	6	7	13	0	0	13	0	0
12	5434072	.	G	A	5	10	15	0	0	15	0	0
12	5451783	.	A	G	6	7	13	0	0	13	0	0
12	5451926	.	G	A	1	6	7	0	0	7	0	0
12	5452362	.	A	T	2	2	4	0	2	6	0	0
12	5452367	.	T	C	4	2	6	0	0	6	0	0
12	5455688	.	T	C	3	0	3	0	4	7	0	0
12	5459580	.	G	C	1	2	3	0	0	3	0	0
12	5576096	.	C	T	2	2	4	0	1	5	0	0
12	5581617	.	G	C	3	3	6	0	0	6	0	0
12	5599378	.	G	T	2	2	4	0	0	4	0	0
12	5599399	.	T	G	1	2	3	0	0	3	0	0
12	5599421	.	C	G	1	3	4	0	0	4	0	0
12	6445359	.	T	C	2	2	4	0	0	4	0	0
12	6451410	.	C	G	2	2	4	0	0	4	0	0
12	6451522	.	T	C	1	3	4	0	0	4	0	0
12	6451528	.	C	T	1	2	3	0	0	3	0	0
12	6465617	.	G	C	1	2	3	0	0	3	0	0
12	6465919	.	T	C	2	2	4	0	0	4	0	0
12	6543350	.	G	A	1	6	7	0	1	8	0	0
12	6543458	.	C	G	2	4	6	0	0	6	0	0
12	6543906	.	G	C	12	3	15	0	2	17	0	0
12	6547163	.	C	T	0	4	4	0	10	14	0	0
12	6547214	.	A	G	6	5	11	0	0	11	0	0
12	6576130	.	A	T	3	2	5	0	0	5	0	0
12	6576298	.	C	T	3	4	7	0	0	7	0	0
12	6584481	.	C	T	0	4	4	0	3	7	0	0
12	6587222	.	T	C	4	0	4	0	6	10	0	0
12	6600355	.	T	C	3	0	3	0	3	6	0	0
12	6612714	.	C	T	0	5	5	0	3	8	0	0
12	6612744	.	T	C	1	0	1	0	3	4	0	0
12	6658743	.	C	G	0	2	2	0	3	5	0	0
12	7193865	.	C	T	2	6	8	0	3	11	0	0
12	7193874	.	A	G	3	8	11	0	2	13	0	0
12	7194410	.	A	G	16	8	24	0	0	24	0	0
12	7194423	.	T	C	15	1	16	0	12	28	0	0
12	7194505	.	T	C	10	7	17	0	2	19	0	0
12	7194522	.	T	C	13	8	21	0	0	21	0	0
12	7194587	.	G	A	5	5	10	0	0	10	0	0
12	7194677	.	G	C	3	5	8	0	1	9	0	0
12	7194843	.	C	A	3	6	9	0	0	9	0	0
12	7194932	.	G	A	7	13	20	0	0	20	0	0
12	7195024	.	T	C	11	10	21	0	1	22	0	0
12	7195081	.	G	T	11	11	22	0	1	23	0	0
12	7195192	.	G	T	25	18	43	0	2	45	0	0
12	7195518	.	A	T	12	10	22	0	1	23	0	0
12	7195588	.	G	A	15	11	26	4	0	30	0	0
12	7195816	.	C	A	1	4	5	0	0	5	0	0
12	7195942	.	C	T	7	4	11	0	0	11	0	0
12	7195951	.	T	C	6	0	6	0	4	10	0	0
12	7196125	.	A	G	9	10	19	0	1	20	0	0
12	7196230	.	A	T	5	4	9	0	1	10	0	0
12	7196249	.	G	T	6	4	10	0	0	10	0	0
12	7196346	.	G	A	7	3	10	0	0	10	0	0
12	7196416	.	T	A	6	3	9	0	0	9	0	0
12	7196425	.	A	C	5	0	5	0	3	8	0	0
12	7196619	.	T	C	5	3	8	0	0	8	0	0
12	7196735	.	C	G	0	3	3	0	6	9	0	0
12	7196785	.	A	T	10	6	16	0	0	16	0	0
12	7196992	.	C	T	2	2	4	0	0	4	0	0
12	7196993	.	T	G	2	2	4	0	0	4	0	0
12	7197152	.	G	A	5	2	7	0	1	8	0	0
12	7197264	.	G	T	7	3	10	0	1	11	0	0
12	7197407	.	T	C	4	5	9	0	0	9	0	0
12	7197590	.	G	T	5	2	7	0	0	7	0	0
12	7197777	.	G	A	5	2	7	0	0	7	0	0
12	7197782	.	T	G	4	2	6	0	0	6	0	0
12	7198317	.	T	A	19	5	24	0	1	25	0	0
12	7198335	.	C	T	1	5	6	0	21	27	0	0
12	7198409	.	G	A	4	7	11	0	1	12	0	0
12	7198667	.	C	T	1	2	3	1	6	10	0	0
12	7198684	.	C	T	3	3	6	1	0	7	0	0
12	7198757	.	T	C	5	0	5	0	3	8	0	0
12	7199229	.	C	A	4	6	10	0	0	10	0	0
12	7199447	.	C	T	4	6	10	0	1	11	0	0
12	7199738	.	A	G	6	8	14	0	2	16	0	0
12	7199759	.	T	C	8	7	15	0	2	17	0	0
12	7223665	.	C	T	12	3	15	0	0	15	0	0
12	7234692	.	G	A	5	7	12	0	0	12	0	0
12	7234790	.	G	A	7	2	9	0	0	9	0	0
12	7235030	.	G	A	11	8	19	0	3	22	0	0
12	7254324	.	A	T	8	7	15	0	0	15	0	0
12	7254352	.	G	C	11	6	17	0	1	18	0	0
12	7263657	.	G	T	1	4	5	0	6	11	0	0
12	7263665	.	G	T	0	3	3	0	5	8	0	0
12	7268905	.	G	A	2	2	4	0	0	4	0	0
12	7269266	.	G	A	4	8	12	0	0	12	0	0
12	7269673	.	G	A	7	8	15	0	1	16	0	0
12	7271805	.	A	C	7	8	15	0	1	16	0	0
12	7271895	.	A	G	6	10	16	0	0	16	0	0
12	7275695	.	T	C	6	5	11	0	2	13	0	0
12	7491712	.	A	G	2	2	4	0	0	4	0	0
12	7504066	.	C	T	8	6	14	0	0	14	0	0
12	7507047	.	C	T	14	7	21	0	0	21	0	0
12	7512637	.	T	C	19	15	34	0	0	34	0	0
12	7512641	.	T	A	16	19	35	0	0	35	0	0
12	7512675	.	G	A	14	16	30	0	0	30	0	0
12	7512682	.	A	G	15	15	30	0	0	30	0	0
12	7512921	.	A	G	9	11	20	0	1	21	0	0
12	7512965	.	C	A	10	11	21	0	2	23	0	0
12	7513106	.	C	A	7	12	19	1	0	20	0	0
12	7513480	.	C	T	22	8	30	0	0	30	0	0
12	7513555	.	G	A	23	5	28	0	1	29	0	0
12	7513637	.	G	A	15	9	24	0	0	24	0	0
12	7513658	.	C	T	16	8	24	0	0	24	0	0
12	7513685	.	C	A	14	7	21	0	0	21	0	0
12	7611390	.	T	C	2	5	7	1	0	8	0	0
12	7611526	.	T	C	8	5	13	0	0	13	0	0
12	7611527	.	T	C	9	0	9	0	4	13	0	0
12	7612106	.	T	C	1	6	7	0	1	8	0	0
12	8822836	.	C	T	3	3	6	0	0	6	0	0
12	8822961	.	T	C	1	5	6	0	0	6	0	0
12	8863228	.	G	A	0	7	7	0	2	9	0	0
12	8863240	.	A	T	7	3	10	0	1	11	0	0
12	8866077	.	A	G	7	3	10	0	1	11	0	0
12	8877343	.	A	C	9	3	12	0	1	13	0	0
12	8877412	.	T	C	6	12	18	0	0	18	0	0
12	8881469	.	G	A	6	4	10	0	1	11	0	0
12	8881470	.	C	G	5	5	10	0	0	10	0	0
12	8881575	.	C	T	5	9	14	0	1	15	0	0
12	8882062	.	G	T	2	6	8	0	2	10	0	0
12	8955284	.	C	T	0	5	5	0	1	6	0	0
12	8968456	.	T	A	10	15	25	0	0	25	0	0
12	8968487	.	T	A	12	9	21	0	1	22	0	0
12	8968512	.	T	G	8	9	17	0	0	17	0	0
12	8968721	.	A	G	9	10	19	0	2	21	0	0
12	8968979	.	C	A	10	7	17	0	0	17	0	0
12	8969084	.	T	C	15	15	30	0	0	30	0	0
12	8969102	.	C	T	3	16	19	0	13	32	0	0
12	8969155	.	C	G	11	14	25	0	0	25	0	0
12	8969426	.	T	C	7	8	15	1	1	17	0	0
12	8969485	.	T	C	14	12	26	0	1	27	0	0
12	8969499	.	G	A	15	16	31	0	0	31	0	0
12	8987502	.	T	C	14	10	24	0	0	24	0	0
12	8997654	.	A	G	11	12	23	0	2	25	0	0
12	9010979	.	G	A	15	16	31	0	0	31	0	0
12	9010988	.	C	T	0	17	17	0	17	34	0	0
12	9039610	.	G	A	12	3	15	0	1	16	0	0
12	9048811	.	G	A	7	12	19	0	1	20	0	0
12	9049343	.	C	T	9	6	15	0	3	18	0	0
12	9064504	.	G	A	12	12	24	0	0	24	0	0
12	9084590	.	T	C	16	12	28	0	0	28	0	0
12	9184305	.	T	C	3	5	8	0	0	8	0	0
12	9187209	.	A	G	6	5	11	0	1	12	0	0
12	9188422	.	T	C	6	3	9	0	2	11	0	0
12	9188488	.	A	G	7	3	10	0	1	11	0	0
12	9190882	.	T	C	5	12	17	0	1	18	0	0
12	9200402	.	C	T	6	4	10	0	0	10	0	0
12	9206038	.	T	C	6	9	15	0	0	15	0	0
12	9206044	.	C	T	5	7	12	0	1	13	0	0
12	9208468	.	T	G	11	0	11	0	9	20	0	0
12	9210441	.	G	A	8	10	18	1	0	19	0	0
12	9210489	.	T	C	11	6	17	1	0	18	0	0
12	9210504	.	A	G	11	7	18	1	0	19	0	0
12	9210528	.	C	T	11	6	17	0	0	17	0	0
12	9218054	.	T	C	5	7	12	0	0	12	0	0
12	9218095	.	A	T	3	5	8	0	0	8	0	0
12	9218098	.	T	C	3	4	7	0	0	7	0	0
12	9218142	.	A	G	2	2	4	0	0	4	0	0
12	9218176	.	T	C	2	2	4	0	0	4	0	0
12	9218183	.	G	A	1	2	3	0	0	3	0	0
12	9363856	.	A	G	1	3	4	0	0	4	0	0
12	9395021	.	G	A	1	2	3	0	0	3	0	0
12	9452838	.	T	C	2	0	2	0	3	5	0	0
12	9452880	.	G	C	3	4	7	0	0	7	0	0
12	9463660	.	G	A	7	6	13	0	0	13	0	0
12	9463678	.	T	C	7	6	13	0	1	14	0	0
12	9463840	.	A	G	4	2	6	0	1	7	0	0
12	9463879	.	G	A	5	2	7	0	0	7	0	0
12	9463885	.	G	A	3	2	5	0	1	6	0	0
12	9468373	.	C	T	1	3	4	0	5	9	0	0
12	9617651	.	G	A	3	2	5	0	0	5	0	0
12	9623751	.	T	C	7	5	12	0	2	14	0	0
12	9626057	.	A	C	3	4	7	0	0	7	0	0
12	9627980	.	A	G	3	3	6	0	0	6	0	0
12	9628007	.	T	C	3	2	5	0	0	5	0	0
12	9630745	.	G	A	4	8	12	0	1	13	0	0
12	9633827	.	G	A	11	11	22	0	0	22	0	0
12	9636532	.	A	C	1	7	8	0	0	8	0	0
12	9636544	.	C	T	1	7	8	0	0	8	0	0
12	9636616	.	A	G	5	13	18	0	0	18	0	0
12	9636967	.	C	A	0	4	4	0	4	8	0	0
12	9640309	.	C	T	4	3	7	0	1	8	0	0
12	9640474	.	T	C	3	3	6	0	0	6	0	0
12	9640492	.	G	A	3	3	6	0	0	6	0	0
12	9642605	.	C	T	2	2	4	0	1	5	0	0
12	9642671	.	A	G	5	4	9	0	1	10	0	0
12	9654101	.	T	A	2	2	4	0	0	4	0	0
12	9654155	.	C	G	0	2	2	0	7	9	0	0
12	9654373	.	A	G	1	2	3	0	1	4	0	0
12	9658137	.	A	G	2	4	6	0	1	7	0	0
12	9658168	.	C	T	5	3	8	0	0	8	0	0
12	9667755	.	G	A	2	2	4	0	0	4	0	0
12	9674357	.	T	C	0	2	2	0	1	3	0	0
12	9674442	.	C	T	3	2	5	0	0	5	0	0
12	9676454	.	A	T	0	3	3	0	1	4	0	0
12	9677745	.	C	T	0	2	2	0	1	3	0	0
12	9703831	.	C	T	14	12	26	0	1	27	0	0
12	9703843	.	A	G	12	14	26	0	1	27	0	0
12	9704233	.	T	C	5	10	15	0	1	16	0	0
12	9704254	.	G	T	6	14	20	0	1	21	0	0
12	9704431	.	C	T	9	12	21	1	1	23	0	0
12	9704443	.	G	T	1	10	11	1	12	24	0	0
12	9744544	.	C	T	8	10	18	0	0	18	0	0
12	9749830	.	A	G	17	17	34	0	0	34	0	0
12	9755833	.	C	T	15	18	33	0	1	34	0	0
12	9755869	.	A	G	13	13	26	0	2	28	0	0
12	9761792	.	C	T	17	9	26	0	0	26	0	0
12	9769880	.	A	T	9	14	23	0	1	24	0	0
12	9773157	.	G	A	4	8	12	0	0	12	0	0
12	9773281	.	C	T	8	7	15	0	2	17	0	0
12	9773308	.	G	A	5	12	17	0	1	18	0	0
12	9773465	.	G	A	1	11	12	2	19	33	0	0
12	9781701	.	T	G	3	5	8	0	0	8	0	0
12	9781789	.	C	T	4	3	7	0	0	7	0	0
12	9782041	.	G	A	2	6	8	0	0	8	0	0
12	9782230	.	C	T	2	6	8	0	0	8	0	0
12	9782404	.	G	A	2	6	8	0	0	8	0	0
12	9782428	.	T	C	5	7	12	0	0	12	0	0
12	9782623	.	G	A	8	3	11	0	0	11	0	0
12	9782635	.	A	G	5	4	9	0	0	9	0	0
12	9782743	.	C	T	0	3	3	0	1	4	0	0
12	9783596	.	G	A	2	5	7	0	0	7	0	0
12	9786549	.	G	T	5	4	9	0	0	9	0	0
12	9789874	.	A	T	1	4	5	0	0	5	0	0
12	9817737	.	A	T	12	10	22	0	0	22	0	0
12	9817771	.	C	T	7	12	19	0	1	20	0	0
12	9817883	.	T	A	16	20	36	0	1	37	0	0
12	9824735	.	C	T	23	20	43	0	2	45	0	0
12	9824762	.	C	A	16	24	40	0	2	42	0	0
12	9829697	.	C	T	20	17	37	0	1	38	0	0
12	9830983	.	G	A	30	26	56	0	0	56	0	0
12	9830986	.	G	A	26	30	56	0	0	56	0	0
12	9875875	.	C	T	1	2	3	0	0	3	0	0
12	9883526	.	G	A	18	44	62	0	1	63	0	0
12	9883849	.	C	T	31	35	66	0	1	67	0	0
12	9883944	.	C	T	42	23	65	0	1	66	0	0
12	9953545	.	G	A	3	5	8	0	0	8	0	0
12	9955481	.	T	G	1	3	4	0	0	4	0	0
12	9981026	.	T	G	2	5	7	0	0	7	0	0
12	9981077	.	G	A	1	4	5	0	0	5	0	0
12	10117236	.	G	A	4	8	12	0	0	12	0	0
12	10117329	.	C	T	8	4	12	0	0	12	0	0
12	10124815	.	T	G	10	10	20	0	0	20	0	0
12	10124819	.	C	T	6	9	15	0	1	16	0	0
12	10124976	.	C	T	7	4	11	0	0	11	0	0
12	10125030	.	G	T	0	4	4	0	4	8	0	0
12	10125031	.	C	A	3	4	7	0	1	8	0	0
12	10125479	.	T	A	3	2	5	0	0	5	0	0
12	10125569	.	T	G	2	0	2	0	4	10	4	0
12	10125573	.	A	G	3	6	9	0	0	9	0	0
12	10151274	.	C	T	1	2	3	0	0	3	0	0
12	10160213	.	T	C	2	2	4	0	0	4	0	0
12	10160232	.	G	T	2	2	4	0	0	4	0	0
12	10160249	.	T	A	2	2	4	0	0	4	0	0
12	10167070	.	A	G	19	14	33	1	0	34	0	0
12	10169521	.	T	C	16	16	32	0	1	33	0	0
12	10169614	.	G	A	13	10	23	0	0	23	0	0
12	10169884	.	G	T	22	16	38	0	2	40	0	0
12	10175161	.	C	T	13	10	23	0	2	25	0	0
12	10199695	.	A	G	20	12	32	0	2	34	0	0
12	10199760	.	A	T	21	14	35	0	0	35	0	0
12	10199869	.	C	T	6	16	22	0	12	34	0	0
12	10200028	.	A	G	20	22	42	0	1	43	0	0
12	10209431	.	A	G	28	20	48	0	0	48	0	0
12	10209452	.	T	A	17	22	39	0	4	43	0	0
12	10210959	.	G	A	1	3	4	0	0	4	0	0
12	10210963	.	C	T	1	3	4	0	0	4	0	0
12	10217660	.	C	T	23	22	45	0	0	45	0	0
12	10217708	.	C	T	22	16	38	0	1	39	0	0
12	10220000	.	G	T	15	15	30	0	2	32	0	0
12	10220117	.	A	G	15	17	32	0	2	34	0	0
12	10243911	.	C	T	18	8	26	0	3	29	0	0
12	10243926	.	C	T	21	9	30	1	1	32	0	0
12	10243971	.	A	C	9	20	29	1	2	32	0	0
12	10304660	.	T	A	4	6	10	0	0	10	0	0
12	10304706	.	G	A	5	7	12	0	0	12	0	0
12	10313241	.	G	A	15	4	19	0	0	19	0	0
12	10339014	.	G	A	1	2	3	0	0	3	0	0
12	10347026	.	A	G	2	2	4	0	0	4	0	0
12	10351860	.	G	A	2	2	4	0	0	4	0	0
12	10368969	.	T	C	3	0	3	0	2	5	0	0
12	10368978	.	A	G	3	2	5	0	0	5	0	0
12	10369153	.	T	G	3	4	7	0	0	7	0	0
12	10369780	.	A	G	3	4	7	0	0	7	0	0
12	10370034	.	T	A	1	2	3	0	0	3	0	0
12	10371240	.	A	T	1	2	3	0	0	3	0	0
12	10371247	.	A	G	1	2	3	0	0	3	0	0
12	10382220	.	C	T	6	4	10	0	1	11	0	0
12	10382588	.	C	T	9	6	15	0	1	16	0	0
12	10384982	.	G	A	10	13	23	0	1	24	0	0
12	10387071	.	A	G	2	6	8	0	1	9	0	0
12	10391883	.	C	T	7	7	14	1	0	15	0	0
12	10393538	.	G	T	4	6	10	0	2	12	0	0
12	10398820	.	A	G	3	2	5	0	0	5	0	0
12	10399471	.	G	A	2	10	12	0	0	12	0	0
12	10399766	.	T	C	4	5	9	0	0	9	0	0
12	10412513	.	C	A	2	2	4	0	0	4	0	0
12	10412825	.	A	C	3	3	6	0	1	7	0	0
12	10412861	.	T	A	5	5	10	0	0	10	0	0
12	10421810	.	C	T	3	5	8	0	0	8	0	0
12	10424741	.	C	G	0	13	13	0	15	28	0	0
12	10425346	.	T	C	25	18	43	0	1	44	0	0
12	10425465	.	C	T	14	18	32	0	5	37	0	0
12	10425586	.	G	T	13	25	38	0	2	40	0	0
12	10425630	.	A	T	31	15	46	0	0	46	0	0
12	10429054	.	G	A	29	16	45	0	2	47	0	0
12	10429105	.	C	A	19	23	42	0	2	44	0	0
12	10430611	.	G	A	16	17	33	0	2	35	0	0
12	10439619	.	C	A	15	13	28	0	0	28	0	0
12	10439641	.	T	G	15	16	31	0	0	31	0	0
12	10439662	.	G	A	12	22	34	0	1	35	0	0
12	10439686	.	T	C	27	17	44	0	0	44	0	0
12	10443916	.	G	T	2	10	12	0	1	13	0	0
12	10443923	.	T	C	4	7	11	0	0	11	0	0
12	10444321	.	A	T	12	9	21	0	1	22	0	0
12	10465000	.	A	C	9	8	17	0	1	18	0	0
12	10465182	.	A	C	8	6	14	0	0	15	1	0
12	10471105	.	A	G	10	12	22	0	0	22	0	0
12	10471120	.	T	C	11	1	12	0	9	21	0	0
12	10471159	.	G	A	10	13	23	1	2	26	0	0
12	10471174	.	A	C	16	0	16	1	10	27	0	0
12	10475310	.	G	A	8	13	21	0	0	21	0	0
12	10478961	.	G	T	6	3	9	0	0	9	0	0
12	10482792	.	T	G	7	2	9	1	0	10	0	0
12	10487662	.	G	C	1	0	1	0	2	3	0	0
12	10492349	.	C	T	1	3	4	0	0	4	0	0
12	10492438	.	C	T	0	5	5	0	4	9	0	0
12	10493597	.	G	A	3	4	7	0	0	7	0	0
12	10495882	.	G	A	1	3	4	0	1	5	0	0
12	10503774	.	A	T	2	2	4	0	0	4	0	0
12	10608951	.	C	A	1	2	3	0	0	3	0	0
12	10651761	.	A	G	7	3	10	0	0	10	0	0
12	10658483	.	C	T	6	2	8	0	0	8	0	0
12	10662152	.	G	T	2	2	4	0	1	5	0	0
12	10666750	.	C	T	1	2	3	0	0	3	0	0
12	10668340	.	A	G	5	3	8	0	0	8	0	0
12	10668545	.	G	C	2	3	5	0	0	5	0	0
12	10679153	.	G	A	2	3	5	0	0	5	0	0
12	10679279	.	T	G	10	12	22	0	2	24	0	0
12	10679289	.	G	A	11	9	20	0	1	21	0	0
12	10682392	.	A	G	11	9	20	0	0	20	0	0
12	10685867	.	C	T	10	7	17	0	0	17	0	0
12	10688640	.	C	T	11	6	17	0	0	17	0	0
12	10688704	.	G	A	9	9	18	0	2	20	0	0
12	10688890	.	G	A	12	8	20	0	1	21	0	0
12	10705765	.	T	A	7	11	18	0	0	18	0	0
12	10705775	.	C	G	6	13	19	0	0	19	0	0
12	10733464	.	C	T	1	4	5	0	0	5	0	0
12	10733494	.	C	A	2	2	4	0	0	4	0	0
12	11124934	.	C	G	1	0	1	0	4	5	0	0
12	11389229	.	T	C	7	4	11	0	0	11	0	0
12	11390365	.	T	C	5	8	13	0	1	14	0	0
12	11762849	.	A	T	7	7	14	0	0	14	0	0
12	13473179	.	A	G	2	4	6	1	0	7	0	0
12	13473314	.	A	G	4	5	9	1	0	10	0	0
12	13474461	.	A	G	16	8	24	0	0	24	0	0
12	13475225	.	A	G	14	6	20	0	2	22	0	0
12	16089950	.	G	A	7	2	9	0	0	9	0	0
12	16446462	.	C	A	2	2	4	0	0	4	0	0
12	18692675	.	T	C	5	8	13	0	0	13	0	0
12	18694220	.	A	C	10	4	14	0	0	14	0	0
12	18701608	.	C	T	3	4	7	0	1	8	0	0
12	18713926	.	C	T	9	5	14	0	1	15	0	0
12	18714000	.	C	T	10	16	26	0	0	26	0	0
12	18716985	.	C	T	11	8	19	0	1	21	1	0
12	18717085	.	A	G	4	5	9	0	0	9	0	0
12	18717471	.	T	C	2	6	8	0	0	8	0	0
12	18717477	.	T	A	3	6	9	0	0	9	0	0
12	18779450	.	T	A	6	10	16	0	0	16	0	0
12	18779648	.	T	C	11	9	20	0	0	21	1	0
12	18782541	.	G	A	9	9	18	0	1	19	0	0
12	18782763	.	G	A	11	9	20	0	1	21	0	0
12	18786773	.	T	C	15	10	25	0	0	25	0	0
12	18786917	.	T	C	9	5	14	0	0	14	0	0
12	18787009	.	G	A	13	6	19	0	0	19	0	0
12	18787205	.	C	T	5	7	12	0	0	12	0	0
12	18793982	.	C	A	1	2	3	0	0	3	0	0
12	18795943	.	T	C	2	0	2	0	2	4	0	0
12	18913584	.	A	G	11	4	15	0	1	16	0	0
12	18913602	.	A	G	9	9	18	0	0	18	0	0
12	18913938	.	A	G	9	5	14	0	1	15	0	0
12	19317745	.	G	A	23	16	39	0	0	39	0	0
12	19317791	.	G	A	22	25	47	1	1	49	0	0
12	19317875	.	G	A	24	14	38	0	3	41	0	0
12	19317930	.	G	T	2	15	17	0	17	34	0	0
12	19318157	.	T	C	22	17	39	0	2	41	0	0
12	19318158	.	G	A	24	15	39	0	2	41	0	0
12	19318194	.	G	C	16	20	36	0	0	36	0	0
12	19318210	.	T	C	15	21	36	0	0	36	0	0
12	19318441	.	A	T	3	8	11	0	2	13	0	0
12	19318475	.	G	A	3	10	13	0	0	13	0	0
12	19318487	.	C	A	4	10	14	0	1	15	0	0
12	19318539	.	G	A	7	16	23	0	0	23	0	0
12	19318615	.	A	T	11	9	20	0	3	23	0	0
12	19318823	.	A	G	12	0	12	0	13	25	0	0
12	19318855	.	C	T	15	16	31	0	1	32	0	0
12	19319085	.	T	G	3	3	6	0	0	6	0	0
12	19319105	.	C	T	2	3	5	0	0	5	0	0
12	19320741	.	G	A	5	6	11	0	1	12	0	0
12	19320778	.	G	A	7	7	14	0	0	14	0	0
12	19320821	.	C	A	4	6	10	0	0	10	0	0
12	19332921	.	T	A	1	4	5	0	0	5	0	0
12	19337850	.	G	A	6	10	16	0	0	16	0	0
12	19338280	.	G	A	8	6	14	1	1	16	0	0
12	19338387	.	T	G	6	8	14	0	0	14	0	0
12	19338819	.	T	A	4	1	5	0	0	5	0	0
12	19338821	.	G	T	4	1	5	0	0	5	0	0
12	19338935	.	T	C	2	5	7	0	0	7	0	0
12	19339022	.	G	T	3	2	5	0	0	5	0	0
12	19339065	.	G	T	2	2	4	0	1	5	0	0
12	19339257	.	A	G	1	5	6	0	1	7	0	0
12	19339403	.	C	A	3	4	7	0	3	10	0	0
12	19339490	.	T	A	7	8	15	0	0	15	0	0
12	19339492	.	C	T	6	8	14	0	0	14	0	0
12	19340033	.	G	A	4	3	7	0	0	7	0	0
12	19340039	.	A	C	4	3	7	0	1	8	0	0
12	19340086	.	A	G	5	3	8	0	0	8	0	0
12	19341869	.	G	A	17	19	36	0	0	36	0	0
12	19348622	.	A	G	23	23	46	0	2	48	0	0
12	19348678	.	T	C	17	21	38	0	1	39	0	0
12	19353091	.	C	T	31	16	47	0	0	47	0	0
12	19353174	.	C	T	8	19	27	0	1	28	0	0
12	19353203	.	A	C	12	23	35	0	1	36	0	0
12	19353622	.	A	T	14	15	29	0	2	31	0	0
12	19362426	.	T	C	6	7	13	0	0	13	0	0
12	19362500	.	C	T	8	3	11	0	0	11	0	0
12	19369292	.	G	A	13	8	21	0	1	22	0	0
12	19369414	.	A	G	7	5	12	0	1	13	0	0
12	19371801	.	A	G	6	0	6	0	5	11	0	0
12	19373175	.	G	A	13	6	19	0	0	19	0	0
12	19375729	.	T	C	7	12	19	0	0	19	0	0
12	19375741	.	C	T	9	14	23	0	1	24	0	0
12	19379564	.	G	C	0	10	10	0	14	24	0	0
12	19379642	.	C	T	9	5	14	0	0	14	0	0
12	19380120	.	A	G	9	11	20	0	0	20	0	0
12	19383137	.	A	G	12	8	20	0	2	22	0	0
12	19383139	.	T	C	12	10	22	0	0	22	0	0
12	19383217	.	T	C	5	9	14	0	0	14	0	0
12	19383242	.	T	A	7	5	12	0	0	12	0	0
12	19383260	.	A	T	6	3	9	0	0	9	0	0
12	19383417	.	T	C	9	10	19	0	1	20	0	0
12	19383539	.	C	T	8	9	17	0	1	18	0	0
12	19383843	.	G	A	5	3	8	0	0	8	0	0
12	19385072	.	G	A	8	11	19	0	1	20	0	0
12	19385287	.	T	C	13	4	17	0	2	19	0	0
12	19385664	.	C	T	8	7	15	0	1	16	0	0
12	19393795	.	A	G	3	4	7	0	0	7	0	0
12	19408489	.	A	T	1	2	3	0	0	3	0	0
12	19408503	.	A	G	1	2	3	0	0	3	0	0
12	19419880	.	C	T	7	2	9	0	0	9	0	0
12	19422112	.	C	T	4	2	6	0	1	7	0	0
12	19422124	.	G	A	6	2	8	0	0	8	0	0
12	19422271	.	T	C	7	4	11	0	0	11	0	0
12	19422319	.	T	C	3	4	7	0	0	7	0	0
12	19422410	.	G	A	0	6	6	0	4	10	0	0
12	19430068	.	G	A	0	7	7	0	5	12	0	0
12	19433542	.	C	G	4	7	11	0	0	11	0	0
12	19433953	.	T	C	4	7	11	0	0	11	0	0
12	19447036	.	C	T	4	6	10	0	0	10	0	0
12	19637039	.	T	G	4	13	17	0	0	17	0	0
12	19658488	.	G	T	4	5	9	0	0	9	0	0
12	19658505	.	T	C	3	6	9	0	0	9	0	0
12	19658587	.	A	G	2	3	5	0	0	5	0	0
12	19658626	.	C	T	3	9	12	0	0	12	0	0
12	19658691	.	A	G	6	0	6	0	11	17	0	0
12	19658735	.	A	T	5	11	16	0	1	17	0	0
12	19658836	.	G	A	13	5	18	0	0	18	0	0
12	19792566	.	T	C	5	12	17	0	2	19	0	0
12	19792945	.	C	G	14	10	24	0	1	25	0	0
12	19792970	.	G	A	15	15	30	0	1	31	0	0
12	19793001	.	G	A	22	11	33	0	1	34	0	0
12	19793039	.	T	A	25	7	32	0	0	32	0	0
12	19793470	.	C	G	28	19	47	0	0	47	0	0
12	19793534	.	T	A	28	10	38	0	0	38	0	0
12	19793657	.	G	A	19	11	30	0	2	32	0	0
12	19793693	.	A	G	14	9	23	0	2	25	0	0
12	19865090	.	T	C	8	1	9	0	16	25	0	0
12	19865347	.	C	T	10	12	22	0	1	23	0	0
12	19865567	.	G	A	6	9	15	0	1	16	0	0
12	19877890	.	A	G	1	0	1	0	3	4	0	0
12	19907100	.	A	T	7	2	9	0	0	9	0	0
12	19931421	.	T	C	3	2	5	0	1	6	0	0
12	19931572	.	A	T	1	2	3	0	0	3	0	0
12	19931609	.	G	A	1	2	3	0	2	5	0	0
12	19931614	.	A	G	4	0	4	0	2	6	0	0
12	19931970	.	A	T	5	5	10	0	0	10	0	0
12	19932072	.	T	C	5	3	8	0	0	8	0	0
12	19932122	.	C	A	4	4	8	0	2	10	0	0
12	19932195	.	A	T	4	3	7	0	0	7	0	0
12	19970187	.	T	C	2	3	5	0	0	5	0	0
12	19970250	.	G	A	4	2	6	0	0	6	0	0
12	19970362	.	T	A	3	4	7	0	0	7	0	0
12	19973564	.	T	C	7	4	11	0	1	12	0	0
12	19973939	.	A	G	3	0	3	0	3	6	0	0
12	19973942	.	A	G	4	3	7	0	0	7	0	0
12	19974092	.	G	A	2	4	6	0	10	17	1	0
12	19974196	.	G	A	3	3	6	0	0	6	0	0
12	19992192	.	A	T	1	3	4	0	0	4	0	0
12	20018682	.	A	T	2	2	4	0	0	4	0	0
12	20025633	.	C	T	3	2	5	1	0	6	0	0
12	20026573	.	T	G	1	4	5	0	0	5	0	0
12	20026597	.	G	A	3	4	7	0	0	7	0	0
12	20029667	.	T	C	2	4	6	0	0	6	0	0
12	20034735	.	T	C	5	7	12	0	1	13	0	0
12	20034744	.	T	C	5	7	12	0	0	12	0	0
12	20036061	.	T	G	2	0	2	0	3	5	0	0
12	20036100	.	C	T	3	2	5	0	0	5	0	0
12	20036106	.	A	G	3	2	5	0	0	5	0	0
12	20040321	.	C	A	5	5	10	0	0	10	0	0
12	20043897	.	G	C	2	3	5	0	0	5	0	0
12	20043971	.	C	T	4	6	10	0	0	10	0	0
12	20044661	.	C	T	2	3	5	0	0	5	0	0
12	20044684	.	T	A	5	2	7	0	0	7	0	0
12	20045067	.	G	T	1	2	3	0	4	7	0	0
12	20045068	.	T	C	4	3	7	0	0	7	0	0
12	20099085	.	A	G	13	8	21	0	1	22	0	0
12	20099478	.	A	G	10	15	25	0	1	26	0	0
12	20099657	.	T	C	9	8	17	0	2	19	0	0
12	20099708	.	T	A	9	13	22	0	0	22	0	0
12	20100109	.	A	G	17	10	27	0	2	29	0	0
12	20100169	.	A	G	8	17	25	0	2	27	0	0
12	20100190	.	T	C	6	0	6	0	15	21	0	0
12	20100391	.	G	A	23	18	41	0	0	41	0	0
12	20122600	.	G	C	14	10	24	0	1	25	0	0
12	20122709	.	A	T	16	9	25	0	0	25	0	0
12	20122785	.	T	C	9	5	14	0	2	16	0	0
12	20123320	.	G	A	8	5	13	0	0	13	0	0
12	20123881	.	A	C	9	10	19	0	0	19	0	0
12	20125561	.	A	G	8	0	8	0	10	18	0	0
12	20145111	.	A	C	6	8	14	0	1	15	0	0
12	20147218	.	G	C	24	8	32	0	1	33	0	0
12	20147229	.	A	G	22	5	27	0	0	27	0	0
12	20147260	.	G	A	17	8	25	0	0	25	0	0
12	20147428	.	G	A	17	12	29	1	1	31	0	0
12	20147486	.	A	G	19	1	20	0	11	31	0	0
12	20147504	.	T	C	16	11	27	0	0	27	0	0
12	20147564	.	A	T	9	7	16	0	2	18	0	0
12	20149786	.	G	A	0	1	1	0	3	4	0	0
12	20155804	.	T	A	1	2	3	0	0	3	0	0
12	20155907	.	G	C	0	2	2	0	2	4	0	0
12	20156045	.	T	C	1	3	4	0	0	4	0	0
12	20156168	.	G	A	0	5	5	0	3	8	0	0
12	20156177	.	G	A	3	4	7	0	1	8	0	0
12	20156546	.	A	G	3	3	6	0	0	6	0	0
12	20227724	.	A	G	4	2	6	0	1	7	0	0
12	20227766	.	C	T	0	3	3	0	3	6	0	0
12	20245820	.	A	T	1	3	4	0	0	4	0	0
12	20251213	.	T	C	1	2	3	0	0	3	0	0
12	20251240	.	A	T	2	2	4	0	0	4	0	0
12	20336821	.	A	G	1	2	3	0	0	3	0	0
12	20378889	.	C	A	1	2	3	0	0	3	0	0
12	20379018	.	G	A	1	2	3	0	0	3	0	0
12	20379323	.	A	T	3	3	6	0	0	6	0	0
12	20379356	.	A	C	2	4	6	0	1	7	0	0
12	20379586	.	G	C	4	4	8	0	0	8	0	0
12	20380050	.	C	G	13	8	21	0	0	21	0	0
12	20396459	.	T	A	13	14	27	0	0	27	0	0
12	20406815	.	T	C	11	0	11	0	5	16	0	0
12	20406818	.	G	A	10	5	15	0	0	15	0	0
12	20407789	.	A	G	8	3	11	0	1	12	0	0
12	20409495	.	G	T	6	7	13	0	0	13	0	0
12	20409523	.	A	G	7	6	13	0	0	13	0	0
12	20409585	.	G	C	3	0	3	0	7	10	0	0
12	20409600	.	A	G	3	6	9	0	0	9	0	0
12	20409680	.	T	A	10	3	13	0	3	16	0	0
12	20454269	.	G	A	1	2	3	0	0	3	0	0
12	20478367	.	T	C	4	2	6	0	1	7	0	0
12	20607308	.	C	T	5	5	10	0	0	10	0	0
12	20607417	.	C	T	6	4	10	0	0	10	0	0
12	20607515	.	G	A	9	3	12	0	0	12	0	0
12	20608370	.	T	A	12	6	18	0	0	18	0	0
12	20608397	.	G	A	9	6	15	0	0	15	0	0
12	20608518	.	C	T	5	8	13	0	0	13	0	0
12	20651602	.	G	A	2	2	4	0	0	4	0	0
12	20651623	.	C	A	2	1	3	0	0	3	0	0
12	20652227	.	C	T	1	3	4	0	0	4	0	0
12	20652732	.	G	A	3	3	6	0	0	6	0	0
12	20653128	.	C	T	4	7	11	2	0	13	0	0
12	20653159	.	G	A	2	2	4	0	1	5	0	0
12	20653244	.	A	T	6	3	9	0	0	9	0	0
12	20653301	.	T	C	10	0	10	0	5	15	0	0
12	20658037	.	T	C	3	11	14	0	0	14	0	0
12	20676252	.	C	T	4	7	11	0	0	11	0	0
12	20677026	.	A	T	20	4	24	0	0	24	0	0
12	20677202	.	C	A	10	6	16	0	1	17	0	0
12	20677706	.	T	A	3	8	11	0	0	11	0	0
12	20736276	.	A	C	3	3	6	0	0	6	0	0
12	20772675	.	C	G	2	0	2	0	6	8	0	0
12	20780971	.	C	T	2	2	4	0	0	4	0	0
12	21298583	.	G	A	3	3	6	0	1	7	0	0
12	21298689	.	C	T	4	2	6	0	0	6	0	0
12	21298701	.	G	A	1	2	3	0	0	3	0	0
12	21539855	.	T	C	19	25	44	0	2	46	0	0
12	21549172	.	G	A	7	18	25	0	10	35	0	0
12	21687757	.	T	C	7	12	19	0	0	19	0	0
12	21799194	.	G	T	5	6	11	0	0	11	0	0
12	21801877	.	C	G	2	2	4	0	0	4	0	0
12	22230868	.	C	G	4	1	5	0	1	6	0	0
12	22230872	.	C	A	4	2	6	0	0	6	0	0
12	22233938	.	C	G	1	2	3	0	7	10	0	0
12	22237749	.	T	C	4	5	9	0	0	9	0	0
12	22310722	.	T	C	4	2	6	0	0	6	0	0
12	22311500	.	G	A	5	4	9	0	0	9	0	0
12	22361648	.	T	C	0	2	2	0	1	3	0	0
12	22361827	.	A	T	1	3	4	0	0	4	0	0
12	22361842	.	C	A	1	2	3	0	0	3	0	0
12	22367020	.	A	G	2	3	5	0	0	5	0	0
12	22367067	.	A	G	1	2	3	0	0	3	0	0
12	22372902	.	A	G	1	2	3	0	0	3	0	0
12	22378877	.	G	C	1	0	1	0	2	3	0	0
12	22407920	.	G	A	2	3	5	0	0	5	0	0
12	22409332	.	G	A	4	5	9	0	0	9	0	0
12	22410014	.	C	T	4	4	8	0	0	8	0	0
12	22410077	.	G	T	5	4	9	0	0	9	0	0
12	22412290	.	T	C	3	4	7	0	0	7	0	0
12	22412630	.	A	G	4	5	9	0	0	9	0	0
12	22415849	.	T	C	6	2	8	0	0	8	0	0
12	22418297	.	T	C	6	9	15	0	1	16	0	0
12	22420645	.	A	G	11	4	15	0	0	15	0	0
12	22420669	.	T	C	11	8	19	0	1	20	0	0
12	22431304	.	G	A	10	9	19	0	0	19	0	0
12	22433246	.	G	A	2	7	9	0	7	16	0	0
12	22435203	.	T	C	11	12	23	0	1	24	0	0
12	22437160	.	T	C	14	5	19	0	1	20	0	0
12	22444470	.	C	T	2	2	4	0	2	6	0	0
12	22444613	.	A	T	8	13	21	0	1	22	0	0
12	22451304	.	T	C	5	5	10	0	0	10	0	0
12	22451793	.	A	C	5	10	15	0	1	16	0	0
12	22451811	.	A	G	7	11	18	0	1	20	1	0
12	22456934	.	A	G	12	7	19	0	0	19	0	0
12	22460101	.	C	G	5	6	11	0	2	13	0	0
12	22460316	.	G	T	6	3	9	0	1	10	0	0
12	22462021	.	C	G	0	11	11	0	8	19	0	0
12	22467995	.	C	T	1	6	7	0	0	7	0	0
12	22468075	.	G	A	8	6	14	0	0	14	0	0
12	22468118	.	A	T	7	4	11	0	0	11	0	0
12	22468286	.	C	G	3	6	9	0	0	9	0	0
12	22470282	.	T	C	2	8	10	0	0	10	0	0
12	22471139	.	G	A	6	3	9	0	1	10	0	0
12	22473380	.	C	G	7	4	11	0	0	11	0	0
12	22473640	.	A	G	3	4	7	0	1	8	0	0
12	22473736	.	G	A	10	9	19	0	0	19	0	0
12	22480599	.	A	G	6	5	11	0	0	11	0	0
12	22480610	.	A	G	7	5	12	0	1	13	0	0
12	22480850	.	T	C	5	6	11	0	0	11	0	0
12	22480862	.	T	C	2	8	10	0	2	12	0	0
12	22480955	.	C	A	5	2	7	0	1	8	0	0
12	22481012	.	C	T	4	2	6	0	0	6	0	0
12	22487415	.	T	C	1	5	6	0	1	7	0	0
12	22487472	.	T	C	7	0	7	0	5	12	0	0
12	22487625	.	A	T	1	2	3	0	0	3	0	0
12	22528869	.	G	A	13	22	35	0	1	36	0	0
12	22529407	.	C	T	19	18	37	0	0	37	0	0
12	22529560	.	T	A	26	26	52	0	3	55	0	0
12	22529655	.	C	G	14	18	32	0	3	35	0	0
12	22529952	.	T	C	6	12	18	0	0	18	0	0
12	22530053	.	A	G	11	12	23	0	1	24	0	0
12	22530056	.	G	A	11	13	24	0	1	25	0	0
12	22530352	.	G	A	17	20	37	0	2	39	0	0
12	22530362	.	C	T	4	22	26	0	19	45	0	0
12	22530849	.	C	G	17	12	29	0	0	29	0	0
12	22531212	.	T	A	21	13	34	0	1	35	0	0
12	22531929	.	T	A	23	16	39	0	1	40	0	0
12	22532594	.	C	T	2	16	18	2	25	45	0	0
12	22533319	.	G	A	14	9	23	0	4	27	0	0
12	22533884	.	A	T	18	14	32	0	2	34	0	0
12	22534389	.	T	C	17	0	17	0	15	32	0	0
12	22534794	.	C	T	15	14	29	0	0	29	0	0
12	22535121	.	C	G	15	15	30	0	0	30	0	0
12	22535186	.	C	T	16	15	31	0	3	34	0	0
12	22535380	.	C	T	0	11	11	0	13	24	0	0
12	22535640	.	G	A	14	8	22	0	0	22	0	0
12	22536969	.	C	T	11	12	23	0	1	24	0	0
12	22537244	.	T	C	12	7	19	0	0	19	0	0
12	22537485	.	G	A	9	10	19	0	0	19	0	0
12	22560249	.	A	G	5	9	14	0	0	14	0	0
12	22562808	.	C	T	9	4	13	0	0	13	0	0
12	22562906	.	G	A	6	6	12	0	0	12	0	0
12	22563891	.	G	T	5	5	10	0	1	11	0	0
12	22568263	.	T	C	5	9	14	0	2	16	0	0
12	22569785	.	C	T	8	10	18	0	0	18	0	0
12	22570379	.	A	T	20	17	37	0	1	38	0	0
12	22570499	.	T	C	17	17	34	0	2	36	0	0
12	22571368	.	G	C	6	8	14	0	0	14	0	0
12	22571592	.	A	T	5	15	20	0	0	20	0	0
12	22572367	.	C	T	16	17	33	0	0	33	0	0
12	22572528	.	T	G	13	14	27	0	2	29	0	0
12	22572585	.	G	A	20	19	39	0	1	40	0	0
12	22572650	.	T	C	13	12	25	0	1	26	0	0
12	22572660	.	G	A	14	13	27	0	1	28	0	0
12	22572738	.	C	T	14	18	32	0	0	32	0	0
12	22572756	.	C	T	12	14	26	0	1	27	0	0
12	22572937	.	C	T	21	11	32	4	0	36	0	0
12	22573185	.	G	A	3	5	8	0	0	8	0	0
12	22628731	.	G	T	0	4	4	0	3	7	0	0
12	22634783	.	T	C	4	2	6	0	0	6	0	0
12	22643556	.	C	G	5	5	10	0	0	10	0	0
12	22643876	.	T	C	4	4	8	0	0	8	0	0
12	22644038	.	C	A	5	3	8	1	1	10	0	0
12	22644208	.	T	C	7	3	10	0	1	11	0	0
12	22644209	.	T	C	7	3	10	0	1	11	0	0
12	22644406	.	C	T	7	6	13	0	0	13	0	0
12	22644429	.	T	C	6	3	9	0	0	9	0	0
12	22644505	.	C	A	2	3	5	0	0	6	1	0
12	22644506	.	A	G	3	2	5	0	1	6	0	0
12	22644576	.	A	G	4	0	4	0	5	9	0	0
12	22644634	.	T	C	7	11	18	0	1	19	0	0
12	22644852	.	C	T	7	6	13	0	0	13	0	0
12	22644878	.	G	A	7	3	10	0	0	10	0	0
12	22645184	.	G	A	2	2	4	0	0	4	0	0
12	22645192	.	T	G	1	2	3	0	0	3	0	0
12	22645691	.	C	T	3	2	5	0	0	5	0	0
12	22648402	.	T	C	2	3	5	0	0	5	0	0
12	22648723	.	G	C	2	2	4	0	2	6	0	0
12	22670217	.	A	T	2	2	4	0	0	4	0	0
12	22680337	.	C	T	4	5	9	0	0	9	0	0
12	22680352	.	C	A	5	3	8	0	0	8	0	0
12	22774778	.	C	T	6	11	17	0	0	17	0	0
12	22774793	.	C	T	7	11	18	0	0	18	0	0
12	22780905	.	G	A	4	5	9	0	2	11	0	0
12	22788151	.	A	C	5	6	11	0	1	12	0	0
12	22800097	.	A	G	7	14	21	0	1	22	0	0
12	22809614	.	C	T	7	10	17	0	0	17	0	0
12	22814994	.	A	G	7	17	24	0	0	24	0	0
12	22815672	.	G	A	6	4	10	0	1	11	0	0
12	22907660	.	T	A	2	3	5	0	0	5	0	0
12	22915831	.	A	G	2	0	2	0	2	4	0	0
12	22916038	.	T	C	2	2	4	0	0	4	0	0
12	22916277	.	T	A	3	2	5	0	0	5	0	0
12	22916281	.	A	C	3	2	5	0	0	5	0	0
12	22921525	.	T	A	6	6	12	0	0	12	0	0
12	22927981	.	T	C	17	13	30	0	0	30	0	0
12	22932674	.	T	A	15	13	28	0	0	28	0	0
12	22932675	.	A	T	14	13	27	0	1	28	0	0
12	22932737	.	A	G	11	0	11	0	15	26	0	0
12	22962175	.	G	A	3	2	5	0	0	5	0	0
12	22962764	.	T	C	12	4	16	0	1	17	0	0
12	22962864	.	G	A	4	5	9	0	0	9	0	0
12	22962911	.	C	A	4	3	7	0	1	8	0	0
12	22963104	.	A	C	3	3	6	0	0	6	0	0
12	22963141	.	G	C	4	2	6	0	0	6	0	0
12	22963197	.	G	A	3	5	8	0	1	9	0	0
12	22963308	.	C	T	0	2	2	0	2	4	0	0
12	22963309	.	G	A	1	3	4	0	0	4	0	0
12	22963667	.	C	G	2	3	5	0	0	5	0	0
12	23008283	.	T	G	2	3	5	0	1	6	0	0
12	23039995	.	A	G	2	2	4	0	0	4	0	0
12	23385168	.	G	A	13	13	26	0	1	27	0	0
12	23400469	.	C	T	15	19	34	0	0	34	0	0
12	23403091	.	T	C	13	15	28	0	3	31	0	0
12	23403149	.	T	C	27	18	45	0	0	45	0	0
12	23406439	.	A	G	19	19	38	0	6	44	0	0
12	23415280	.	C	T	14	15	29	0	0	29	0	0
12	23415347	.	C	T	23	9	32	0	1	33	0	0
12	23415672	.	C	A	16	25	41	0	0	41	0	0
12	23415715	.	T	C	11	23	34	0	5	39	0	0
12	23415878	.	G	A	18	9	27	0	1	28	0	0
12	23424190	.	C	T	5	4	9	0	1	10	0	0
12	23427149	.	T	C	2	3	5	0	0	5	0	0
12	23429619	.	G	A	2	2	4	0	0	4	0	0
12	23429917	.	A	G	4	0	4	0	5	9	0	0
12	23665167	.	C	T	4	2	6	0	0	6	0	0
12	23665562	.	G	A	0	2	2	0	2	4	0	0
12	23674331	.	T	A	2	4	6	0	0	6	0	0
12	23674354	.	T	C	2	5	7	0	0	7	0	0
12	23787989	.	T	A	2	2	4	0	1	5	0	0
12	23788528	.	G	A	4	4	8	0	1	9	0	0
12	23788649	.	C	A	5	3	8	0	1	9	0	0
12	23788682	.	G	A	4	3	7	0	0	7	0	0
12	23794034	.	G	A	0	5	5	0	2	7	0	0
12	23794826	.	A	G	1	2	3	0	0	3	0	0
12	23795221	.	C	G	1	2	3	0	0	3	0	0
12	23795226	.	G	A	1	2	3	0	0	3	0	0
12	23795325	.	T	C	1	3	4	0	0	4	0	0
12	23795418	.	T	C	2	4	6	0	0	6	0	0
12	23795447	.	A	G	2	3	5	0	0	5	0	0
12	23871061	.	G	A	1	3	4	0	0	4	0	0
12	23871064	.	T	A	1	3	4	0	0	4	0	0
12	23875641	.	A	G	1	0	1	0	4	5	0	0
12	23875679	.	T	G	1	3	4	0	1	5	0	0
12	23885932	.	G	A	0	2	2	0	2	4	0	0
12	23889658	.	A	G	5	2	7	0	0	7	0	0
12	23904642	.	C	T	1	2	3	0	0	3	0	0
12	23908617	.	T	C	2	4	6	0	0	6	0	0
12	23912037	.	A	G	2	2	4	0	1	5	0	0
12	23913566	.	T	C	3	3	6	0	0	6	0	0
12	23916491	.	A	G	2	9	11	0	0	11	0	0
12	23916502	.	T	C	1	9	10	0	0	10	0	0
12	23917156	.	T	G	3	0	3	0	2	5	0	0
12	23917160	.	T	G	3	2	5	0	0	5	0	0
12	23917279	.	T	C	3	2	5	0	0	5	0	0
12	23917460	.	G	C	6	6	12	0	0	12	0	0
12	23925093	.	A	G	7	4	11	0	0	11	0	0
12	23932067	.	T	G	6	13	19	0	1	20	0	0
12	23991524	.	A	T	9	3	12	0	0	12	0	0
12	24007733	.	A	C	5	2	7	0	0	7	0	0
12	24010977	.	T	G	2	4	6	0	0	6	0	0
12	24030454	.	C	T	1	3	4	0	0	4	0	0
12	24030846	.	A	G	3	5	8	0	0	8	0	0
12	24036870	.	T	C	4	6	10	0	0	10	0	0
12	24038339	.	A	C	7	5	12	0	0	12	0	0
12	24038517	.	A	G	10	5	15	0	0	15	0	0
12	24038542	.	T	C	10	5	15	0	0	15	0	0
12	24041322	.	T	A	7	3	10	0	0	10	0	0
12	24041367	.	A	T	9	3	12	0	0	12	0	0
12	24041561	.	T	C	3	2	5	0	1	6	0	0
12	24041600	.	A	G	3	0	3	0	5	8	0	0
12	24043679	.	A	G	4	0	4	0	6	10	0	0
12	24043703	.	C	T	5	8	13	0	0	13	0	0
12	24043736	.	C	T	5	6	11	0	0	11	0	0
12	24043909	.	C	T	6	7	13	0	0	13	0	0
12	24045914	.	T	G	13	0	13	0	9	22	0	0
12	24051717	.	C	G	9	11	20	0	0	20	0	0
12	24051737	.	C	G	9	10	19	0	0	19	0	0
12	24051755	.	T	A	6	6	12	0	0	12	0	0
12	24051894	.	G	T	6	8	14	0	0	14	0	0
12	24051944	.	T	G	6	6	12	0	0	12	0	0
12	24052133	.	A	G	2	2	4	0	3	7	0	0
12	24052196	.	A	G	1	4	5	0	0	5	0	0
12	24052219	.	A	C	2	3	5	0	3	8	0	0
12	24052256	.	G	C	3	4	7	0	2	9	0	0
12	24052288	.	T	C	1	5	6	0	0	6	0	0
12	24342518	.	T	A	9	7	16	0	0	16	0	0
12	24342531	.	G	A	9	5	14	0	1	15	0	0
12	24342556	.	T	C	8	7	15	0	0	15	0	0
12	24345339	.	T	C	5	4	9	0	0	9	0	0
12	24345427	.	C	A	12	9	21	0	1	22	0	0
12	24345832	.	G	A	3	16	19	0	13	32	0	0
12	24465454	.	C	T	9	16	25	0	3	28	0	0
12	24465466	.	T	C	9	19	28	0	0	28	0	0
12	24465541	.	C	T	11	20	31	0	1	32	0	0
12	24465565	.	T	C	18	15	33	0	0	33	0	0
12	24465607	.	C	T	25	13	38	0	0	38	0	0
12	24484131	.	G	T	23	17	40	0	0	40	0	0
12	24484134	.	C	T	22	17	39	0	1	40	0	0
12	24484215	.	T	C	10	10	20	0	3	23	0	0
12	24561971	.	G	A	3	3	6	0	0	6	0	0
12	24562909	.	C	T	7	8	15	0	0	15	0	0
12	24606963	.	C	T	28	28	56	0	2	58	0	0
12	24635925	.	A	G	43	3	46	0	21	67	0	0
12	24636261	.	C	A	24	19	43	0	5	48	0	0
12	24636746	.	A	G	32	27	59	0	6	65	0	0
12	24637239	.	G	A	1	2	3	0	0	3	0	0
12	24796653	.	G	A	6	4	10	0	0	10	0	0
12	24797128	.	A	T	10	4	14	2	1	17	0	0
12	24797351	.	C	T	8	6	14	0	1	15	0	0
12	24797413	.	C	T	8	15	23	0	0	23	0	0
12	24797541	.	G	A	8	15	23	0	1	24	0	0
12	24797603	.	T	C	7	19	26	0	1	27	0	0
12	24797908	.	C	T	10	6	16	1	0	17	0	0
12	24798358	.	A	G	4	6	10	0	1	11	0	0
12	24811423	.	G	A	9	4	13	0	1	14	0	0
12	24811441	.	C	A	7	6	13	0	1	14	0	0
12	24811468	.	G	A	5	2	7	0	0	7	0	0
12	24832098	.	G	A	11	3	14	0	0	14	0	0
12	24842121	.	G	A	16	11	27	0	1	28	0	0
12	24842267	.	T	G	11	14	25	0	0	25	0	0
12	24843292	.	C	T	2	16	18	0	18	36	0	0
12	24843424	.	T	C	18	1	19	0	17	36	0	0
12	24843451	.	C	T	16	16	32	0	2	34	0	0
12	24847330	.	T	G	18	15	33	0	2	35	0	0
12	24848399	.	G	A	8	10	18	0	1	19	0	0
12	24851165	.	T	C	14	17	31	0	0	31	0	0
12	24851264	.	G	A	10	6	16	0	0	16	0	0
12	24851297	.	G	A	10	11	21	0	1	22	0	0
12	24857033	.	G	A	11	7	18	0	1	19	0	0
12	24857814	.	T	C	3	14	17	0	0	17	0	0
12	24906618	.	T	C	8	9	17	0	0	17	0	0
12	24910116	.	C	G	2	6	8	0	3	11	0	0
12	24910492	.	A	C	5	6	11	0	1	12	0	0
12	24913442	.	C	G	3	10	13	0	0	13	0	0
12	24913609	.	C	A	5	2	7	0	0	7	0	0
12	24917917	.	C	A	2	6	8	0	1	9	0	0
12	24918034	.	C	T	2	3	5	0	1	6	0	0
12	24920788	.	A	G	2	3	5	0	0	5	0	0
12	24922646	.	A	T	2	2	4	0	0	4	0	0
12	24953532	.	C	G	11	10	21	0	2	23	0	0
12	24957267	.	A	G	36	40	76	0	2	78	0	0
12	24957416	.	T	C	38	37	75	0	13	88	0	0
12	24957572	.	C	T	1	3	4	0	0	4	0	0
12	24957607	.	A	T	1	3	4	0	1	5	0	0
12	24957806	.	A	G	37	44	81	0	3	84	0	0
12	25043221	.	A	G	10	5	15	0	0	15	0	0
12	25043324	.	C	T	2	6	8	0	3	11	0	0
12	25043594	.	C	T	3	9	12	0	0	12	0	0
12	25044516	.	A	G	11	3	14	0	0	14	0	0
12	25044540	.	C	T	10	5	15	0	0	15	0	0
12	25044786	.	T	G	14	7	21	0	0	21	0	0
12	25045074	.	T	C	8	3	11	0	1	12	0	0
12	25045174	.	C	T	5	5	10	0	1	11	0	0
12	25045315	.	C	T	1	5	6	0	11	17	0	0
12	25065680	.	A	G	7	7	14	0	0	14	0	0
12	25091674	.	T	A	1	2	3	0	0	3	0	0
12	25092501	.	C	A	2	2	4	0	0	4	0	0
12	25094107	.	T	G	6	11	17	0	1	18	0	0
12	25094201	.	T	C	5	9	14	0	1	15	0	0
12	25094359	.	T	C	5	10	15	0	1	16	0	0
12	25094401	.	C	T	9	8	17	3	0	20	0	0
12	25094520	.	T	C	12	4	16	0	1	17	0	0
12	25149179	.	C	G	4	9	13	0	0	13	0	0
12	25149203	.	G	A	3	3	6	0	0	6	0	0
12	25205542	.	A	T	2	5	7	0	0	7	0	0
12	25210501	.	G	A	1	1	2	0	2	4	0	0
12	25224067	.	G	T	11	3	14	0	0	14	0	0
12	25230976	.	A	G	8	10	18	0	1	19	0	0
12	25251716	.	G	A	6	3	9	0	2	11	0	0
12	25254891	.	T	C	11	6	17	0	0	17	0	0
12	25271404	.	T	G	9	13	22	0	1	23	0	0
12	25271409	.	C	A	8	14	22	0	0	22	0	0
12	25271598	.	C	T	15	15	30	0	2	32	0	0
12	25284375	.	G	A	19	13	32	0	0	32	0	0
12	25284414	.	T	C	23	13	36	0	0	36	0	0
12	25284423	.	G	A	24	14	38	0	1	39	0	0
12	25377318	.	A	C	2	0	2	0	8	10	0	0
12	25377345	.	A	T	2	5	7	0	1	8	0	0
12	25377354	.	A	C	3	7	10	0	0	10	0	0
12	25377690	.	T	A	5	3	8	0	2	10	0	0
12	25378351	.	G	A	14	14	28	0	1	29	0	0
12	25378354	.	C	T	2	10	12	0	16	28	0	0
12	25378420	.	A	G	13	11	24	0	1	25	0	0
12	25378475	.	G	A	9	10	19	0	0	19	0	0
12	25378506	.	C	A	1	11	12	0	12	24	0	0
12	25378555	.	T	C	14	10	24	0	1	25	0	0
12	25378848	.	G	T	10	3	13	0	0	13	0	0
12	25378882	.	G	T	9	4	13	0	0	13	0	0
12	25467742	.	C	T	9	9	18	0	0	18	0	0
12	25467823	.	T	C	9	8	17	0	2	19	0	0
12	25467887	.	T	C	11	5	16	0	0	16	0	0
12	25468312	.	C	T	11	14	25	0	1	26	0	0
12	25472281	.	C	T	16	29	45	0	0	45	0	0
12	25472290	.	A	G	15	1	16	0	25	41	0	0
12	25483514	.	T	C	2	3	5	0	0	5	0	0
12	25483527	.	T	C	0	1	1	0	2	3	0	0
12	25484586	.	G	A	14	20	34	0	2	36	0	0
12	25484676	.	T	G	15	20	35	0	0	35	0	0
12	25485203	.	C	T	9	9	18	0	1	19	0	0
12	25600834	.	A	G	5	7	12	0	0	12	0	0
12	25602616	.	T	A	12	7	19	0	0	19	0	0
12	25602820	.	T	A	4	6	10	0	1	11	0	0
12	25602828	.	T	A	8	3	11	0	0	11	0	0
12	25703490	.	A	G	14	0	14	0	15	29	0	0
12	25705600	.	G	A	9	12	21	0	1	22	0	0
12	25713629	.	G	C	11	8	19	0	2	21	0	0
12	25714409	.	T	C	12	7	19	0	0	19	0	0
12	25714480	.	T	G	15	16	31	0	1	32	0	0
12	25754150	.	C	T	9	12	21	1	0	22	0	0
12	25754225	.	C	T	17	16	33	0	0	33	0	0
12	25768096	.	C	T	25	21	46	0	1	47	0	0
12	25768326	.	T	A	23	27	50	1	6	57	0	0
12	25768580	.	G	A	1	15	16	0	19	35	0	0
12	25768695	.	T	A	2	5	7	1	1	9	0	0
12	25768707	.	T	A	3	4	7	1	0	8	0	0
12	25768830	.	T	C	7	11	18	0	1	19	0	0
12	25769012	.	G	A	20	19	39	0	2	41	0	0
12	25769177	.	A	T	9	17	26	0	3	29	0	0
12	25769752	.	G	A	25	19	44	0	1	45	0	0
12	25769889	.	G	A	15	11	26	0	1	27	0	0
12	25811519	.	G	A	0	3	3	0	1	4	0	0
12	25820377	.	T	G	1	0	1	0	2	3	0	0
12	25820448	.	T	C	1	8	9	0	0	9	0	0
12	25825960	.	A	T	1	2	3	0	2	5	0	0
12	25826171	.	T	G	3	2	5	0	0	5	0	0
12	25826208	.	G	A	7	2	9	0	0	9	0	0
12	25826606	.	G	A	1	2	3	0	0	3	0	0
12	25826647	.	T	A	1	3	4	0	0	4	0	0
12	25826710	.	A	C	2	2	4	0	0	4	0	0
12	25826940	.	A	G	2	2	4	0	0	4	0	0
12	25826945	.	C	G	2	0	2	0	3	5	0	0
12	25827117	.	A	T	2	2	4	0	0	4	0	0
12	25828308	.	C	T	4	3	7	0	1	8	0	0
12	25828718	.	C	A	4	3	7	0	0	7	0	0
12	25828721	.	T	C	3	3	6	0	0	6	0	0
12	25828816	.	A	T	2	5	7	0	1	8	0	0
12	25829025	.	G	A	5	6	11	0	0	11	0	0
12	25829046	.	T	C	7	5	12	0	0	12	0	0
12	25829105	.	T	C	4	2	6	0	0	6	0	0
12	25829168	.	A	G	7	2	9	0	1	10	0	0
12	25845511	.	T	C	8	4	12	0	0	12	0	0
12	25845512	.	G	A	8	4	12	0	0	12	0	0
12	25846021	.	T	C	25	12	37	0	1	38	0	0
12	25856178	.	T	A	12	17	29	0	1	30	0	0
12	25861006	.	T	C	14	16	30	0	1	31	0	0
12	25866543	.	G	A	17	15	32	0	3	35	0	0
12	25872834	.	C	A	17	9	26	0	0	27	1	0
12	25872933	.	C	T	20	5	25	0	2	27	0	0
12	25872938	.	C	A	21	8	29	0	2	31	0	0
12	25873241	.	C	T	16	16	32	0	0	32	0	0
12	25873289	.	C	T	14	16	30	0	0	30	0	0
12	25881185	.	G	C	1	23	24	0	17	41	0	0
12	25881254	.	A	C	21	11	32	0	2	34	0	0
12	25881778	.	T	C	12	22	34	0	0	34	0	0
12	25894625	.	T	G	59	11	70	4	10	84	0	0
12	25948331	.	C	T	1	2	3	0	0	3	0	0
12	25950895	.	G	C	3	0	3	0	4	7	0	0
12	25951057	.	A	G	3	6	9	0	0	9	0	0
12	25951101	.	C	T	5	7	12	0	1	13	0	0
12	25951761	.	C	T	1	3	4	0	7	11	0	0
12	25951781	.	C	A	5	3	8	0	0	8	0	0
12	25952026	.	A	G	4	10	14	0	1	15	0	0
12	25952027	.	C	G	6	9	15	0	0	15	0	0
12	25953565	.	G	A	3	2	5	0	1	6	0	0
12	25953817	.	T	C	4	6	10	0	0	10	0	0
12	25954447	.	A	G	3	3	6	0	0	6	0	0
12	25958674	.	G	A	1	2	3	0	0	3	0	0
12	25982664	.	A	T	2	2	4	0	0	4	0	0
12	26093964	.	T	C	3	2	5	0	0	5	0	0
12	26203891	.	C	T	1	8	9	0	11	20	0	0
12	26203900	.	A	T	15	7	22	0	0	22	0	0
12	26226655	.	C	G	1	8	9	0	9	18	0	0
12	26227042	.	C	T	10	10	20	0	0	20	0	0
12	26235368	.	T	C	10	3	13	0	0	13	0	0
12	26241724	.	G	A	5	4	9	0	0	9	0	0
12	26241745	.	G	A	5	2	7	0	0	7	0	0
12	26318397	.	C	T	0	5	5	0	5	10	0	0
12	26318515	.	A	G	11	9	20	0	1	21	0	0
12	26318625	.	G	A	6	8	14	0	0	14	0	0
12	26318702	.	A	G	9	7	16	0	1	17	0	0
12	26409797	.	C	A	3	5	8	0	0	8	0	0
12	26410697	.	T	A	1	4	5	0	0	5	0	0
12	26411633	.	T	C	0	6	6	0	1	7	0	0
12	26412554	.	T	G	1	3	4	0	0	4	0	0
12	26412689	.	C	A	0	7	7	0	1	8	0	0
12	26412694	.	T	C	1	7	8	0	0	8	0	0
12	26412787	.	T	C	2	4	6	0	0	6	0	0
12	26476093	.	C	G	11	13	24	0	1	25	0	0
12	26476319	.	A	G	16	9	25	0	0	25	0	0
12	26476424	.	A	G	13	10	23	0	0	23	0	0
12	26486421	.	C	G	26	22	48	0	2	51	1	0
12	26486446	.	A	C	20	22	42	0	5	47	0	0
12	26486580	.	T	C	21	8	29	0	1	30	0	0
12	26486753	.	T	C	12	13	25	0	1	26	0	0
12	26486934	.	T	A	13	13	26	0	1	27	0	0
12	26487002	.	A	T	5	14	19	1	2	22	0	0
12	26487044	.	G	A	9	11	20	0	1	21	0	0
12	26487292	.	T	G	3	9	12	0	0	12	0	0
12	26491761	.	C	A	3	2	5	0	0	5	0	0
12	26493734	.	T	C	3	2	5	0	0	5	0	0
12	26493755	.	G	A	0	4	4	0	5	9	0	0
12	26493806	.	C	T	6	11	17	0	0	17	0	0
12	26493836	.	G	A	0	9	9	0	7	16	0	0
12	26493870	.	G	T	4	4	8	0	0	8	0	0
12	26545121	.	A	G	1	4	5	0	0	5	0	0
12	26546851	.	G	T	1	2	3	0	0	3	0	0
12	26546855	.	C	T	1	1	2	0	1	3	0	0
12	26546965	.	A	G	4	5	9	0	0	9	0	0
12	26546966	.	A	G	4	5	9	0	0	9	0	0
12	26547276	.	A	C	2	3	5	0	0	5	0	0
12	26547631	.	C	T	4	2	6	0	0	6	0	0
12	26547688	.	A	T	4	4	8	0	1	9	0	0
12	26549505	.	G	T	7	3	10	0	0	10	0	0
12	26549628	.	T	C	2	0	2	0	3	5	0	0
12	26559492	.	T	A	2	2	4	0	0	4	0	0
12	26559495	.	C	T	2	2	4	0	0	4	0	0
12	26582535	.	A	T	1	2	3	0	0	3	0	0
12	26586957	.	C	T	3	8	11	0	0	11	0	0
12	26587065	.	T	C	3	2	5	0	0	5	0	0
12	26587216	.	G	A	0	4	4	0	2	6	0	0
12	26594165	.	C	T	1	5	6	0	5	11	0	0
12	26594216	.	G	A	9	9	18	0	1	19	0	0
12	26597512	.	C	T	1	9	10	0	6	16	0	0
12	26608882	.	C	T	2	8	10	0	3	13	0	0
12	26611673	.	A	T	5	5	10	0	0	10	0	0
12	26612038	.	A	G	9	11	20	0	0	20	0	0
12	26612188	.	T	C	7	1	8	0	7	15	0	0
12	26612225	.	C	G	11	6	17	0	0	17	0	0
12	26612390	.	G	C	9	7	16	0	0	16	0	0
12	26617621	.	C	A	6	6	12	0	0	12	0	0
12	26617882	.	G	A	5	6	11	0	0	11	0	0
12	26620426	.	A	G	2	8	10	0	3	13	0	0
12	26620612	.	T	G	2	4	6	0	0	6	0	0
12	26638166	.	G	A	2	7	9	0	0	9	0	0
12	26638274	.	G	A	3	8	11	0	0	11	0	0
12	26638640	.	C	T	6	4	10	0	0	10	0	0
12	26693547	.	G	A	9	5	14	0	1	15	0	0
12	26704300	.	C	T	5	4	9	0	2	11	0	0
12	26708821	.	G	A	1	8	9	0	12	21	0	0
12	26724285	.	A	T	11	7	18	0	0	18	0	0
12	26724327	.	C	A	8	3	11	0	1	12	0	0
12	26724413	.	G	T	3	8	11	0	0	11	0	0
12	26724762	.	A	G	13	0	13	0	15	28	0	0
12	26724975	.	A	G	8	1	9	0	12	21	0	0
12	26724984	.	A	T	9	10	19	0	0	19	0	0
12	26725079	.	C	A	6	8	14	0	0	14	0	0
12	26725402	.	A	G	13	5	18	0	1	19	0	0
12	26750431	.	G	A	9	5	14	0	0	14	0	0
12	26750619	.	A	G	10	21	31	0	1	32	0	0
12	26751414	.	G	A	15	13	28	0	1	29	0	0
12	26751489	.	A	G	17	8	25	0	1	26	0	0
12	26752074	.	A	C	9	4	13	0	0	13	0	0
12	26752391	.	T	C	5	0	5	0	11	16	0	0
12	26752400	.	C	T	6	10	16	0	0	16	0	0
12	26752528	.	C	T	7	20	27	0	1	28	0	0
12	26752730	.	C	T	0	8	8	0	16	24	0	0
12	26752871	.	G	A	13	6	19	0	1	20	0	0
12	26752946	.	G	A	8	12	20	0	1	21	0	0
12	26758251	.	A	G	6	10	16	0	0	16	0	0
12	26758521	.	A	G	5	11	16	0	0	16	0	0
12	26758710	.	A	C	5	6	11	0	0	11	0	0
12	26758722	.	T	C	4	6	10	0	0	10	0	0
12	26758793	.	G	T	8	3	11	0	0	11	0	0
12	26761017	.	G	A	2	7	9	0	0	9	0	0
12	26764315	.	C	T	0	5	5	0	4	9	0	0
12	26764416	.	C	T	0	6	6	0	5	12	1	0
12	26774720	.	A	G	11	7	18	0	2	20	0	0
12	26960845	.	T	G	1	0	1	0	2	3	0	0
12	26961184	.	C	T	2	4	6	0	1	7	0	0
12	27023301	.	C	T	5	5	10	0	0	10	0	0
12	27023677	.	C	T	6	13	19	0	0	19	0	0
12	27024941	.	A	G	13	7	20	0	0	20	0	0
12	27025481	.	C	T	8	8	16	0	2	18	0	0
12	27026528	.	A	C	4	6	10	0	0	10	0	0
12	27029347	.	T	C	14	0	14	0	14	28	0	0
12	27029648	.	C	T	15	16	31	0	2	33	0	0
12	27030917	.	T	C	12	0	12	0	18	30	0	0
12	27036570	.	A	C	3	5	8	0	2	10	0	0
12	27037804	.	C	T	5	4	9	0	0	9	0	0
12	27037813	.	C	T	5	2	7	0	1	8	0	0
12	27050766	.	A	G	4	6	10	0	4	14	0	0
12	27059070	.	A	G	13	13	26	0	2	28	0	0
12	27059581	.	T	C	10	9	19	0	0	19	0	0
12	27059901	.	A	T	20	11	31	0	1	32	0	0
12	27059910	.	A	T	21	10	31	0	2	33	0	0
12	27060018	.	C	T	9	9	18	0	1	19	0	0
12	27060087	.	C	A	14	9	23	0	0	23	0	0
12	27060572	.	G	A	12	8	20	0	1	21	0	0
12	27064684	.	T	G	1	3	4	0	0	4	0	0
12	27065056	.	C	A	5	2	7	0	0	7	0	0
12	27065470	.	A	C	3	3	6	0	0	6	0	0
12	27065471	.	C	A	2	3	5	0	0	5	0	0
12	27065942	.	T	C	1	4	5	0	1	6	0	0
12	27066169	.	C	G	1	4	5	0	0	5	0	0
12	27066614	.	T	C	3	2	5	0	0	5	0	0
12	27068492	.	G	A	3	5	8	0	1	9	0	0
12	27068513	.	C	A	2	8	10	0	0	10	0	0
12	27072033	.	T	C	2	6	8	0	0	8	0	0
12	27073084	.	A	G	5	8	13	0	0	13	0	0
12	27073135	.	T	C	3	4	7	0	1	8	0	0
12	27078324	.	A	T	4	9	13	0	1	14	0	0
12	27086658	.	C	T	12	10	22	0	1	23	0	0
12	27086943	.	T	C	10	10	20	0	1	21	0	0
12	27086958	.	C	T	12	10	22	0	2	24	0	0
12	27087235	.	T	G	10	7	17	0	0	17	0	0
12	27087261	.	A	G	10	3	13	0	0	13	0	0
12	27087342	.	C	A	7	3	10	0	0	10	0	0
12	27087570	.	A	T	9	12	21	0	0	21	0	0
12	27087635	.	T	C	9	7	16	0	0	16	0	0
12	27087844	.	G	A	15	8	23	0	2	25	0	0
12	27088199	.	T	C	6	10	16	0	2	18	0	0
12	27088286	.	G	T	13	13	26	0	2	28	0	0
12	27088304	.	T	C	14	13	27	0	1	28	0	0
12	27088357	.	C	T	16	11	27	0	0	27	0	0
12	27088383	.	A	C	15	12	27	0	0	27	0	0
12	27088646	.	T	A	8	16	24	0	0	24	0	0
12	27088758	.	A	C	5	12	17	0	1	18	0	0
12	27088767	.	G	A	7	13	20	0	0	20	0	0
12	27088821	.	A	G	9	1	10	0	17	27	0	0
12	27088836	.	T	C	7	17	24	0	2	26	0	0
12	27089531	.	G	C	14	6	20	0	0	20	0	0
12	27089857	.	T	C	11	16	27	0	1	28	0	0
12	27090630	.	A	C	14	14	28	0	1	29	0	0
12	27090663	.	G	A	1	14	15	0	13	28	0	0
12	27090696	.	A	T	8	17	25	0	3	28	0	0
12	27090756	.	A	G	13	6	19	0	1	20	0	0
12	27090824	.	T	G	14	11	25	0	2	27	0	0
12	27090856	.	A	T	13	11	24	0	2	26	0	0
12	27090864	.	G	C	15	12	27	0	1	28	0	0
12	27090918	.	G	A	10	14	24	0	0	24	0	0
12	27091163	.	C	A	3	6	9	0	1	10	0	0
12	27091305	.	T	C	14	9	23	0	0	23	0	0
12	27110426	.	C	A	2	2	4	0	0	4	0	0
12	27110448	.	C	A	2	3	5	0	0	5	0	0
12	27128299	.	T	A	1	2	3	0	0	3	0	0
12	27128305	.	A	G	1	2	3	0	0	3	0	0
12	27128611	.	G	A	3	5	8	0	0	8	0	0
12	27130237	.	G	A	1	8	9	0	9	18	0	0
12	27131224	.	T	C	2	5	7	0	0	7	0	0
12	27142089	.	T	A	1	1	2	0	1	3	0	0
12	27207050	.	T	G	9	3	12	0	4	16	0	0
12	27207053	.	C	T	12	4	16	0	0	16	0	0
12	27207130	.	G	A	7	8	15	0	0	15	0	0
12	27207466	.	T	C	16	18	34	0	0	34	0	0
12	27218781	.	C	T	10	12	22	3	0	25	0	0
12	27219143	.	C	T	11	8	19	0	1	20	0	0
12	27219450	.	T	C	3	5	8	0	0	8	0	0
12	27219761	.	T	A	7	10	17	0	0	17	0	0
12	27219818	.	G	A	1	9	10	0	10	20	0	0
12	27220582	.	T	C	9	13	22	0	1	23	0	0
12	27221491	.	G	A	15	13	28	0	0	28	0	0
12	27221505	.	A	T	15	14	29	0	0	29	0	0
12	27224057	.	G	A	6	9	15	0	1	16	0	0
12	27224090	.	C	G	9	0	9	0	8	17	0	0
12	27224727	.	T	C	12	9	21	0	0	21	0	0
12	27229078	.	A	G	19	6	25	0	0	25	0	0
12	27229216	.	T	A	14	17	31	0	1	32	0	0
12	27229438	.	T	G	5	10	15	0	1	16	0	0
12	27229647	.	C	A	9	9	18	0	0	18	0	0
12	27232225	.	A	C	3	3	6	0	1	7	0	0
12	27236496	.	C	A	4	3	7	0	0	8	1	0
12	27236500	.	A	T	4	4	8	0	0	8	0	0
12	27241657	.	A	G	5	6	11	0	0	11	0	0
12	27242416	.	G	A	5	5	10	0	2	12	0	0
12	27243208	.	A	G	12	9	21	0	0	21	0	0
12	27243236	.	T	C	16	9	25	0	0	25	0	0
12	27303000	.	A	G	5	2	7	0	0	7	0	0
12	27303211	.	C	T	9	3	12	0	0	12	0	0
12	27303288	.	C	T	10	4	14	0	0	14	0	0
12	27303295	.	A	C	9	4	13	0	1	14	0	0
12	27303328	.	T	C	11	7	18	0	0	18	0	0
12	27303486	.	A	T	10	14	24	0	1	25	0	0
12	27303496	.	T	C	11	15	26	0	0	26	0	0
12	27303521	.	C	T	10	13	23	0	1	24	0	0
12	27304064	.	C	T	4	7	11	0	0	11	0	0
12	27304215	.	G	A	2	9	11	0	7	18	0	0
12	27304316	.	A	T	12	11	23	0	1	24	0	0
12	27304596	.	T	A	8	13	21	0	0	21	0	0
12	27304650	.	A	G	5	1	6	0	8	14	0	0
12	27304704	.	A	C	7	8	15	0	0	15	0	0
12	27305054	.	G	A	22	10	32	0	0	32	0	0
12	27305495	.	C	A	10	14	24	0	1	25	0	0
12	27305503	.	A	G	11	15	26	0	1	27	0	0
12	27334024	.	A	G	1	0	1	0	3	4	0	0
12	27557809	.	C	T	2	3	5	0	0	5	0	0
12	27558619	.	G	C	6	5	11	0	0	11	0	0
12	27558705	.	G	T	4	5	9	0	0	9	0	0
12	27559653	.	T	C	3	7	10	0	0	10	0	0
12	27563459	.	C	T	3	12	15	0	0	15	0	0
12	27566659	.	T	C	6	4	10	0	0	10	0	0
12	27568288	.	T	A	6	6	12	0	0	12	0	0
12	27570675	.	A	G	4	3	7	0	2	9	0	0
12	27570725	.	T	A	3	8	11	0	2	13	0	0
12	27570759	.	T	G	5	9	14	0	0	14	0	0
12	27570838	.	C	G	8	10	18	0	1	19	0	0
12	27570869	.	A	T	8	7	15	0	0	15	0	0
12	27571076	.	C	A	4	6	10	0	0	10	0	0
12	27571142	.	A	C	8	5	13	0	2	15	0	0
12	27571151	.	A	T	9	8	17	0	1	18	0	0
12	27571213	.	T	C	15	0	15	0	5	20	0	0
12	27571224	.	C	T	18	5	23	0	1	24	0	0
12	27571625	.	G	A	10	7	17	0	0	17	0	0
12	27573030	.	G	A	5	11	16	0	0	16	0	0
12	27573072	.	G	A	6	8	14	0	1	15	0	0
12	27575444	.	T	C	8	4	12	0	0	12	0	0
12	27575776	.	T	G	4	5	9	0	0	9	0	0
12	27580100	.	A	C	2	4	6	0	0	6	0	0
12	27580166	.	T	C	4	5	9	0	0	9	0	0
12	27584590	.	A	T	6	3	9	0	0	9	0	0
12	27584827	.	C	T	0	4	4	0	7	11	0	0
12	27591232	.	G	A	5	6	11	0	0	11	0	0
12	27593678	.	T	C	5	3	8	0	1	9	0	0
12	27593856	.	G	A	1	6	7	1	2	10	0	0
12	27593868	.	A	C	2	6	8	1	0	9	0	0
12	27593892	.	C	T	3	8	11	1	0	12	0	0
12	27593922	.	T	G	6	4	10	1	0	11	0	0
12	27595297	.	T	A	4	2	6	0	0	6	0	0
12	27602080	.	A	T	4	5	9	0	0	9	0	0
12	27615642	.	A	G	7	0	7	0	8	15	0	0
12	27622254	.	C	T	8	11	19	0	0	19	0	0
12	27622321	.	G	A	7	6	13	0	0	13	0	0
12	27622336	.	C	A	6	5	11	0	1	12	0	0
12	27627528	.	G	C	8	8	16	1	3	20	0	0
12	27665035	.	T	C	17	15	32	0	2	34	0	0
12	27665289	.	G	C	9	17	26	0	1	27	0	0
12	27665502	.	T	A	5	3	8	0	0	8	0	0
12	27665539	.	T	C	3	3	6	0	0	6	0	0
12	27889992	.	T	C	1	5	6	0	0	6	0	0
12	27902711	.	A	C	6	4	10	0	0	10	0	0
12	27902871	.	A	G	2	0	2	0	2	4	0	0
12	27906193	.	A	C	4	6	10	0	0	10	0	0
12	27925629	.	C	T	2	2	4	0	0	4	0	0
12	27926395	.	A	C	5	6	11	0	1	12	0	0
12	27926619	.	C	T	0	3	3	0	1	4	0	0
12	27926674	.	T	C	2	2	4	0	0	4	0	0
12	27943009	.	T	C	5	5	10	0	0	10	0	0
12	27999503	.	C	T	3	4	7	0	0	7	0	0
12	28003340	.	C	T	3	3	6	0	1	7	0	0
12	28003358	.	C	T	4	3	7	0	0	7	0	0
12	28033169	.	C	T	7	3	10	0	0	10	0	0
12	28049096	.	G	A	10	5	15	0	0	15	0	0
12	28120243	.	T	A	3	2	5	0	0	5	0	0
12	28120585	.	C	T	1	2	3	0	0	3	0	0
12	28120615	.	A	G	2	0	2	0	3	5	0	0
12	28179377	.	A	T	2	2	4	0	0	4	0	0
12	28180193	.	A	G	4	0	4	0	3	7	0	0
12	28350566	.	A	G	6	13	19	0	0	19	0	0
12	28351092	.	A	G	5	3	8	0	2	10	0	0
12	28351160	.	G	C	7	7	14	0	1	15	0	0
12	28354243	.	C	T	11	7	18	0	2	20	0	0
12	28355486	.	G	A	10	10	20	0	2	22	0	0
12	28359161	.	G	A	8	7	15	0	1	16	0	0
12	28367757	.	T	A	22	11	33	0	1	34	0	0
12	28369391	.	G	A	1	12	13	0	26	39	0	0
12	28369412	.	G	T	30	10	40	0	2	42	0	0
12	28369540	.	C	A	27	16	43	0	3	46	0	0
12	28369615	.	G	C	0	22	22	0	26	48	0	0
12	28369909	.	G	T	2	21	23	0	24	47	0	0
12	28369981	.	C	T	27	17	44	0	0	44	0	0
12	28370062	.	G	C	5	19	24	0	26	50	0	0
12	28370335	.	A	C	26	25	51	0	3	54	0	0
12	28370474	.	T	G	11	1	12	0	20	32	0	0
12	28377796	.	A	G	2	2	4	0	0	4	0	0
12	28377797	.	G	C	2	2	4	0	0	4	0	0
12	28377909	.	T	A	3	2	5	0	0	5	0	0
12	28377976	.	G	A	6	4	10	0	0	10	0	0
12	28377990	.	G	A	5	2	7	0	0	7	0	0
12	28378139	.	G	A	2	6	8	0	1	9	0	0
12	28378200	.	T	G	8	4	12	0	0	12	0	0
12	28378237	.	A	C	7	5	12	0	0	12	0	0
12	28378342	.	T	C	2	2	4	0	0	4	0	0
12	28378394	.	C	A	1	9	10	0	5	15	0	0
12	28378418	.	G	A	8	10	18	0	1	19	0	0
12	28378645	.	C	T	1	5	6	0	0	6	0	0
12	28378788	.	C	T	1	5	6	0	0	6	0	0
12	28379042	.	T	C	1	2	3	0	0	3	0	0
12	28379215	.	C	T	7	5	12	0	0	12	0	0
12	28379218	.	C	T	7	5	12	0	0	12	0	0
12	28379471	.	A	C	1	0	1	0	3	4	0	0
12	28379473	.	G	T	1	2	3	0	1	4	0	0
12	28379593	.	T	A	1	5	6	0	1	7	0	0
12	28379860	.	C	T	4	6	10	0	0	10	0	0
12	28380460	.	C	T	2	3	5	0	0	5	0	0
12	28380803	.	G	A	2	2	4	0	0	4	0	0
12	28449032	.	G	T	3	5	8	0	0	8	0	0
12	28477963	.	G	A	2	2	4	0	0	4	0	0
12	28496082	.	T	C	3	3	6	0	1	7	0	0
12	28497933	.	A	G	3	2	5	0	0	5	0	0
12	28559939	.	T	C	3	12	15	0	3	18	0	0
12	28559973	.	A	C	5	10	15	0	0	16	1	0
12	28560354	.	T	A	5	8	13	0	0	13	0	0
12	28560370	.	G	T	2	8	10	0	1	11	0	0
12	28560494	.	T	C	9	5	14	0	4	18	0	0
12	28560734	.	T	C	8	10	18	0	1	19	0	0
12	28560990	.	T	C	10	14	24	0	1	25	0	0
12	28561253	.	G	A	4	3	7	0	0	7	0	0
12	28561420	.	C	T	8	7	15	1	1	17	0	0
12	28561778	.	A	T	10	5	15	0	0	15	0	0
12	28561875	.	A	C	6	0	6	0	9	15	0	0
12	28566224	.	T	C	8	6	14	0	2	16	0	0
12	28568138	.	T	A	5	10	15	0	0	15	0	0
12	28568350	.	G	A	5	4	9	0	1	10	0	0
12	28570908	.	G	A	11	6	17	0	0	17	0	0
12	28668713	.	A	T	19	12	31	0	0	31	0	0
12	28676131	.	C	T	13	7	20	0	4	24	0	0
12	28676551	.	A	G	10	0	10	0	14	24	0	0
12	28676844	.	A	T	8	6	14	0	2	16	0	0
12	28677202	.	C	T	12	14	26	0	1	27	0	0
12	28677314	.	A	G	14	9	23	0	1	24	0	0
12	28677576	.	A	T	10	11	21	1	0	22	0	0
12	28797777	.	T	C	7	5	12	0	1	13	0	0
12	28799604	.	G	C	5	2	7	0	0	7	0	0
12	28800029	.	A	G	7	4	11	0	1	12	0	0
12	28801271	.	A	G	14	0	14	0	8	22	0	0
12	28802016	.	T	C	16	14	30	0	1	31	0	0
12	28806022	.	G	A	1	14	15	0	4	19	0	0
12	28806062	.	C	T	3	20	23	0	0	23	0	0
12	28806180	.	C	T	12	7	19	0	0	19	0	0
12	28806220	.	G	T	7	9	16	0	3	19	0	0
12	28806241	.	T	G	10	7	17	0	0	17	0	0
12	28806285	.	G	A	11	5	16	0	0	16	0	0
12	28806396	.	C	A	6	4	10	0	3	13	0	0
12	28806459	.	A	T	6	12	18	0	2	20	0	0
12	28806494	.	G	A	12	7	19	0	1	20	0	0
12	28806530	.	G	C	14	7	21	0	1	22	0	0
12	28806584	.	T	G	17	8	25	0	0	25	0	0
12	28806586	.	A	T	17	8	25	0	1	26	0	0
12	28806857	.	T	A	3	13	16	0	0	16	0	0
12	28806861	.	T	G	3	13	16	0	0	16	0	0
12	28807006	.	C	T	1	3	4	0	0	4	0	0
12	28826191	.	T	C	6	5	11	0	0	11	0	0
12	28827553	.	T	A	2	4	6	0	0	6	0	0
12	28827899	.	A	G	4	0	4	0	9	13	0	0
12	28828016	.	A	C	7	6	13	0	1	14	0	0
12	28828207	.	A	T	8	3	11	0	0	11	0	0
12	28828358	.	G	A	3	5	8	0	0	8	0	0
12	28844171	.	T	C	5	11	16	0	0	16	0	0
12	28847439	.	A	C	2	8	10	0	1	11	0	0
12	28856200	.	T	C	6	6	12	0	1	13	0	0
12	28856227	.	T	C	8	6	14	0	0	14	0	0
12	28863046	.	A	T	5	13	18	0	0	18	0	0
12	28863086	.	T	A	9	10	19	0	2	21	0	0
12	28863101	.	T	C	8	9	17	0	1	18	0	0
12	28863582	.	A	G	13	12	25	0	1	26	0	0
12	28863711	.	T	C	6	11	17	0	0	17	0	0
12	28863783	.	A	C	18	8	26	0	0	26	0	0
12	28863811	.	T	C	16	7	23	0	0	23	0	0
12	28864217	.	T	C	11	9	20	0	1	21	0	0
12	28864575	.	T	G	15	0	15	0	12	27	0	0
12	28864719	.	G	C	9	13	22	0	1	23	0	0
12	28864778	.	C	G	8	19	27	0	1	28	0	0
12	28864792	.	A	C	8	18	26	0	1	27	0	0
12	28864847	.	T	C	21	10	31	0	1	32	0	0
12	28865106	.	G	T	19	6	25	0	0	26	1	0
12	28865298	.	T	A	17	17	34	0	2	37	1	0
12	28865668	.	T	G	12	20	32	0	0	32	0	0
12	28865679	.	G	A	15	18	33	0	2	35	0	0
12	28865805	.	A	C	10	14	24	0	0	24	0	0
12	28870626	.	T	C	13	12	25	0	0	25	0	0
12	28870797	.	T	C	16	1	17	1	21	39	0	0
12	28870801	.	T	A	19	15	34	2	2	39	1	0
12	28870912	.	C	A	14	23	37	0	2	39	0	0
12	28871068	.	G	T	15	18	33	0	1	34	0	0
12	28871433	.	C	A	2	27	29	0	9	38	0	0
12	28878343	.	C	T	20	19	39	0	1	40	0	0
12	28889025	.	A	G	2	0	2	0	3	5	0	0
12	28900299	.	C	T	1	3	4	0	0	4	0	0
12	28912644	.	T	C	8	9	17	0	0	17	0	0
12	28912659	.	C	T	7	8	15	0	0	15	0	0
12	28916846	.	A	T	5	4	9	1	0	10	0	0
12	28918699	.	G	A	5	7	12	0	0	12	0	0
12	28924363	.	G	A	10	6	16	0	0	16	0	0
12	28927051	.	G	A	7	6	13	0	1	14	0	0
12	28930455	.	T	C	5	3	8	0	0	8	0	0
12	28932389	.	C	T	5	5	10	0	2	12	0	0
12	28932428	.	C	T	5	4	9	0	0	9	0	0
12	28932571	.	G	A	6	3	9	0	1	10	0	0
12	28932581	.	T	A	8	8	16	0	0	16	0	0
12	28948117	.	T	C	4	6	10	0	0	10	0	0
12	28949067	.	A	G	4	4	8	0	0	8	0	0
12	28949112	.	C	A	7	2	9	0	0	9	0	0
12	28950009	.	T	C	6	0	6	0	4	10	0	0
12	28950678	.	G	T	3	2	5	0	1	6	0	0
12	28951019	.	C	T	0	5	5	0	5	10	0	0
12	28955614	.	T	C	5	0	5	0	6	11	0	0
12	28956566	.	T	C	5	3	8	0	2	10	0	0
12	28956615	.	A	G	2	7	9	0	0	9	0	0
12	28958548	.	A	G	1	0	1	0	3	4	0	0
12	28959943	.	G	T	1	3	4	0	1	5	0	0
12	28960284	.	T	C	4	7	11	0	0	11	0	0
12	28960321	.	G	A	3	2	5	0	3	8	0	0
12	28960357	.	G	A	0	4	4	0	3	7	0	0
12	28960441	.	C	T	3	2	5	0	0	5	0	0
12	29054940	.	A	G	1	5	6	0	0	6	0	0
12	29054941	.	A	G	1	5	6	0	0	6	0	0
12	29063346	.	G	A	8	11	19	1	1	21	0	0
12	29084032	.	T	C	11	11	22	0	1	23	0	0
12	29102585	.	T	C	15	12	27	0	0	27	0	0
12	29103004	.	T	C	5	9	14	0	1	15	0	0
12	29103041	.	T	A	6	6	12	0	2	14	0	0
12	29173678	.	C	G	4	4	8	0	0	8	0	0
12	29173712	.	T	C	3	4	7	0	0	7	0	0
12	29207473	.	G	A	1	3	4	0	10	14	0	0
12	29207533	.	T	C	7	8	15	0	1	16	0	0
12	29207590	.	G	A	1	8	9	0	7	16	0	0
12	29207683	.	G	T	14	9	23	0	0	23	0	0
12	29208099	.	T	G	9	5	14	0	0	14	0	0
12	29209834	.	G	A	8	7	15	0	0	15	0	0
12	29209840	.	A	T	6	7	13	0	0	13	0	0
12	29209947	.	T	G	5	4	9	0	1	10	0	0
12	29210200	.	A	G	2	0	2	0	4	6	0	0
12	29210220	.	T	C	3	4	7	0	0	7	0	0
12	29210371	.	C	A	14	9	23	0	1	24	0	0
12	29210435	.	C	G	11	8	19	0	1	20	0	0
12	29210600	.	C	T	9	6	15	0	1	16	0	0
12	29210719	.	T	A	16	13	29	0	1	30	0	0
12	29210873	.	T	A	7	4	11	0	2	13	0	0
12	29210917	.	T	C	10	6	16	0	1	17	0	0
12	29211017	.	C	T	3	2	5	0	1	6	0	0
12	29211082	.	G	A	9	4	13	0	2	15	0	0
12	29211195	.	T	A	8	12	20	0	2	22	0	0
12	29211232	.	G	A	0	15	15	0	11	26	0	0
12	29211289	.	T	A	17	14	31	0	0	31	0	0
12	29211292	.	A	G	14	12	26	0	3	29	0	0
12	29223498	.	A	G	5	3	8	0	0	8	0	0
12	29223612	.	T	G	6	2	8	0	0	8	0	0
12	29223689	.	G	A	4	1	5	0	1	6	0	0
12	29223969	.	A	T	1	4	5	0	0	5	0	0
12	29224065	.	G	A	4	4	8	0	0	8	0	0
12	29224182	.	T	C	3	2	5	0	0	5	0	0
12	29224310	.	A	G	4	3	7	0	0	7	0	0
12	29224521	.	A	T	4	3	7	0	0	7	0	0
12	29224609	.	A	C	3	2	5	0	0	5	0	0
12	29226152	.	T	C	2	3	5	0	1	6	0	0
12	29226690	.	A	G	2	2	4	0	0	4	0	0
12	29226752	.	T	A	1	3	4	0	0	4	0	0
12	29226876	.	C	A	0	2	2	0	1	3	0	0
12	29227014	.	T	G	2	3	5	0	0	5	0	0
12	29227044	.	G	A	1	4	5	0	0	5	0	0
12	29229299	.	A	G	1	2	3	0	0	3	0	0
12	29233284	.	C	T	1	2	3	0	0	3	0	0
12	29244139	.	T	C	1	2	3	0	0	3	0	0
12	29251251	.	T	C	1	5	6	0	1	7	0	0
12	29251408	.	T	C	2	3	5	0	0	5	0	0
12	29251446	.	T	C	2	3	5	0	0	5	0	0
12	29258629	.	G	T	3	7	10	0	0	10	0	0
12	29262564	.	A	G	1	0	1	0	2	3	0	0
12	29266917	.	T	C	6	5	11	0	0	11	0	0
12	29269576	.	C	A	1	2	3	0	0	3	0	0
12	29269689	.	G	A	5	2	7	0	0	7	0	0
12	29269695	.	A	G	6	0	6	0	2	8	0	0
12	29269726	.	C	G	4	2	6	0	1	7	0	0
12	29269770	.	G	T	0	3	3	0	2	5	0	0
12	29269774	.	T	G	2	3	5	0	0	5	0	0
12	29351320	.	A	G	16	15	31	0	0	31	0	0
12	29351810	.	A	G	18	12	30	0	1	31	0	0
12	29358277	.	T	C	17	12	29	0	1	30	0	0
12	29358370	.	G	C	8	1	9	0	14	23	0	0
12	29358384	.	A	G	6	12	18	0	1	19	0	0
12	29358418	.	A	G	9	12	21	0	1	22	0	0
12	29624017	.	G	A	14	16	30	0	1	31	0	0
12	29624272	.	C	A	9	5	14	0	1	15	0	0
12	29624611	.	T	C	4	0	4	0	7	11	0	0
12	29764201	.	C	T	1	2	3	0	0	3	0	0
12	29764222	.	G	T	0	2	2	0	1	3	0	0
12	29806358	.	C	G	3	0	3	0	4	7	0	0
12	29806445	.	G	A	4	5	9	0	0	9	0	0
12	29811009	.	A	G	4	1	5	0	2	7	0	0
12	29843460	.	A	G	15	17	32	0	1	33	0	0
12	29844434	.	T	C	5	4	9	0	0	9	0	0
12	29873273	.	C	G	12	13	25	1	0	26	0	0
12	29921114	.	T	G	12	11	23	0	1	24	0	0
12	29947132	.	A	G	7	9	16	0	2	18	0	0
12	29947147	.	C	A	5	11	16	0	0	16	0	0
12	29957074	.	C	T	9	13	22	0	1	23	0	0
12	29957164	.	C	T	9	7	16	0	0	16	0	0
12	29965655	.	G	A	7	4	11	0	0	11	0	0
12	29965724	.	G	A	9	4	13	0	0	13	0	0
12	29965928	.	C	T	5	2	7	0	0	7	0	0
12	29965967	.	G	A	4	5	9	0	0	9	0	0
12	29966039	.	T	C	6	6	12	0	1	13	0	0
12	29966048	.	T	C	8	0	8	0	6	14	0	0
12	29968087	.	T	C	6	0	6	0	11	17	0	0
12	29973800	.	G	A	5	5	10	0	0	10	0	0
12	29976936	.	G	A	6	7	13	0	1	14	0	0
12	29976978	.	T	C	6	4	10	0	0	10	0	0
12	30031290	.	C	A	5	4	9	0	0	9	0	0
12	30031293	.	T	C	4	5	9	0	0	9	0	0
12	30031336	.	T	C	4	3	7	0	0	7	0	0
12	30031338	.	G	A	4	3	7	0	0	7	0	0
12	30031677	.	T	C	4	5	9	0	0	9	0	0
12	30031680	.	T	C	4	5	9	0	0	9	0	0
12	30129351	.	C	T	3	3	6	0	0	6	0	0
12	30153676	.	G	A	0	2	2	0	1	3	0	0
12	30153772	.	T	C	4	5	9	0	0	9	0	0
12	30156449	.	T	C	4	5	9	0	0	9	0	0
12	30192526	.	A	T	11	5	16	0	0	16	0	0
12	30200741	.	C	T	12	9	21	0	1	22	0	0
12	30207912	.	G	A	7	5	12	0	0	12	0	0
12	30211165	.	T	A	4	9	13	0	0	13	0	0
12	30216090	.	G	T	4	2	6	0	1	7	0	0
12	30216248	.	C	T	9	10	19	0	1	20	0	0
12	30216436	.	T	C	7	4	11	0	0	11	0	0
12	30216490	.	T	C	6	7	13	0	0	13	0	0
12	30216693	.	C	T	5	2	7	0	0	7	0	0
12	30216697	.	G	A	2	2	4	0	4	8	0	0
12	30217423	.	T	C	2	2	4	0	0	4	0	0
12	30217467	.	C	A	1	2	3	0	0	3	0	0
12	30217569	.	A	G	2	4	6	0	0	6	0	0
12	30217589	.	A	T	2	4	6	0	0	6	0	0
12	30217705	.	G	A	1	7	8	0	5	13	0	0
12	30217747	.	C	T	5	4	9	0	1	10	0	0
12	30217783	.	C	A	1	5	6	0	2	8	0	0
12	30217893	.	C	A	2	7	9	0	0	9	0	0
12	30217898	.	T	A	2	7	9	0	0	9	0	0
12	30217966	.	G	A	4	3	7	0	2	9	0	0
12	30217986	.	C	T	5	4	9	0	2	11	0	0
12	30218135	.	C	A	5	2	7	0	0	7	0	0
12	30218150	.	G	A	4	7	11	0	0	11	0	0
12	30218173	.	C	T	7	4	11	0	0	11	0	0
12	30219306	.	A	T	15	15	30	0	1	31	0	0
12	30219739	.	G	A	8	6	14	0	2	16	0	0
12	30219804	.	C	T	10	11	21	2	0	23	0	0
12	30272647	.	T	C	1	4	5	0	0	5	0	0
12	30287333	.	C	T	2	10	12	0	0	12	0	0
12	30292275	.	G	A	0	6	6	0	1	7	0	0
12	30292463	.	A	G	1	0	1	0	4	5	0	0
12	30296150	.	C	T	4	2	6	0	0	6	0	0
12	30299061	.	T	C	4	4	8	0	0	8	0	0
12	30299073	.	C	T	3	8	11	0	0	11	0	0
12	30302941	.	A	T	6	11	17	0	2	19	0	0
12	30303081	.	C	A	9	5	14	0	1	15	0	0
12	30304883	.	C	T	8	6	14	0	0	14	0	0
12	30304909	.	A	G	14	5	19	0	0	19	0	0
12	30305983	.	T	C	4	15	19	0	0	19	0	0
12	30307010	.	C	T	5	6	11	0	0	11	0	0
12	30307788	.	G	T	5	2	7	0	0	7	0	0
12	30372463	.	G	A	0	8	8	0	4	12	0	0
12	30372763	.	G	A	4	5	9	0	0	9	0	0
12	30382341	.	C	T	3	8	11	0	0	11	0	0
12	30382705	.	G	A	0	3	3	0	4	7	0	0
12	30383960	.	G	A	0	6	6	0	4	10	0	0
12	30385562	.	C	T	15	6	21	0	0	21	0	0
12	30391136	.	G	A	9	11	20	0	0	20	0	0
12	30418108	.	T	C	6	11	17	0	0	17	0	0
12	30418513	.	C	G	11	12	23	0	0	23	0	0
12	30419123	.	A	T	7	4	11	0	5	16	0	0
12	30419134	.	C	A	5	6	11	0	0	12	1	0
12	30419260	.	T	G	11	13	24	0	0	24	0	0
12	30419646	.	T	C	10	2	12	0	1	13	0	0
12	30419655	.	T	C	9	3	12	0	0	12	0	0
12	30419695	.	T	C	7	5	12	0	1	13	0	0
12	30419727	.	A	G	2	7	9	0	0	9	0	0
12	30442406	.	C	A	14	7	21	0	0	21	0	0
12	30442783	.	G	A	10	9	19	0	1	20	0	0
12	30443462	.	T	C	7	9	16	0	0	16	0	0
12	30458945	.	A	T	2	4	6	0	1	7	0	0
12	30459235	.	T	C	1	2	3	0	1	4	0	0
12	30459250	.	G	A	3	4	7	0	0	7	0	0
12	30459404	.	G	A	4	3	7	0	1	8	0	0
12	30459422	.	A	C	2	4	6	0	1	7	0	0
12	30459615	.	T	C	4	2	6	0	0	6	0	0
12	30467666	.	G	T	3	3	6	0	0	6	0	0
12	30569921	.	G	A	3	2	5	0	0	5	0	0
12	30706173	.	T	A	4	4	8	0	0	8	0	0
12	30706176	.	T	C	4	4	8	0	0	8	0	0
12	30712031	.	T	G	4	2	6	0	0	6	0	0
12	30712099	.	T	A	5	4	9	0	0	9	0	0
12	30737025	.	T	C	3	2	5	0	2	7	0	0
12	30740917	.	C	T	2	2	4	0	0	4	0	0
12	30741328	.	T	G	2	3	5	0	0	5	0	0
12	30788993	.	G	A	4	3	7	0	0	7	0	0
12	30793107	.	C	T	6	3	9	0	0	9	0	0
12	30796306	.	C	T	1	5	6	0	0	6	0	0
12	30796322	.	C	A	5	2	7	0	0	7	0	0
12	30796345	.	C	T	4	3	7	0	0	7	0	0
12	30798079	.	G	A	4	3	7	0	3	10	0	0
12	30798085	.	A	T	7	5	12	0	1	13	0	0
12	30800128	.	G	A	3	6	9	0	0	9	0	0
12	30803166	.	G	A	0	3	3	0	10	13	0	0
12	30803196	.	T	C	9	5	14	0	0	14	0	0
12	30803629	.	A	G	3	7	10	0	0	10	0	0
12	30805335	.	T	C	8	5	13	0	0	13	0	0
12	30805359	.	T	C	8	5	13	0	0	13	0	0
12	30805455	.	C	T	5	8	13	0	0	13	0	0
12	30806928	.	G	T	2	8	10	0	7	17	0	0
12	30807038	.	A	G	9	15	24	0	0	24	0	0
12	30807245	.	A	G	1	2	3	0	2	5	0	0
12	30807290	.	A	G	4	4	8	0	0	8	0	0
12	30807330	.	T	A	4	9	13	0	0	13	0	0
12	30807458	.	C	T	6	10	16	0	1	17	0	0
12	30807494	.	G	A	10	13	23	0	0	23	0	0
12	30807504	.	A	C	8	11	19	0	1	20	0	0
12	30807835	.	A	C	2	12	14	0	0	14	0	0
12	30808094	.	C	T	2	5	7	0	0	7	0	0
12	30808150	.	T	A	8	7	15	0	0	15	0	0
12	30808342	.	A	T	6	9	15	0	0	15	0	0
12	30808531	.	G	C	4	6	10	0	0	10	0	0
12	30808766	.	C	T	7	7	14	0	0	14	0	0
12	30808812	.	A	G	8	0	8	0	5	13	0	0
12	30808817	.	T	G	5	6	11	0	0	11	0	0
12	30979815	.	A	C	9	15	24	0	5	29	0	0
12	30979890	.	T	A	16	5	21	0	8	29	0	0
12	30979923	.	T	A	10	4	14	0	2	16	0	0
12	30980566	.	G	A	27	26	53	0	2	55	0	0
12	30981795	.	G	A	22	26	48	0	1	49	0	0
12	30986452	.	G	A	24	27	51	0	1	52	0	0
12	31012667	.	C	T	1	3	4	0	1	5	0	0
12	31102981	.	A	G	14	9	23	0	0	23	0	0
12	31435977	.	T	A	5	5	10	0	0	10	0	0
12	31438056	.	G	T	10	9	19	0	0	19	0	0
12	31509602	.	A	T	4	2	6	0	0	6	0	0
12	31516149	.	T	C	6	4	10	0	1	11	0	0
12	31520814	.	T	A	4	3	7	0	0	7	0	0
12	31520850	.	C	T	4	2	6	0	0	6	0	0
12	31531950	.	T	G	12	6	18	0	0	19	1	0
12	31532342	.	A	C	4	4	8	0	0	8	0	0
12	31532371	.	G	A	1	3	4	0	3	7	0	0
12	31532397	.	G	C	2	2	4	0	1	5	0	0
12	31532577	.	T	C	10	8	18	0	0	18	0	0
12	31532638	.	A	C	10	7	17	0	0	17	0	0
12	31532715	.	T	C	6	5	11	0	0	11	0	0
12	31533849	.	G	A	0	2	2	0	4	6	0	0
12	31629611	.	C	T	5	3	8	0	0	8	0	0
12	31630829	.	G	A	0	3	3	0	12	15	0	0
12	31631082	.	T	C	4	3	7	0	1	8	0	0
12	31631116	.	A	T	3	2	5	0	0	5	0	0
12	31631124	.	A	T	3	1	4	0	0	4	0	0
12	31664441	.	C	T	2	2	4	0	1	5	0	0
12	31664770	.	T	A	3	4	7	0	0	7	0	0
12	31664846	.	A	T	1	3	4	0	1	5	0	0
12	31665007	.	G	A	2	2	4	0	0	4	0	0
12	31665351	.	C	T	4	5	9	0	0	9	0	0
12	31689567	.	T	A	4	3	7	0	0	7	0	0
12	31694713	.	C	T	5	5	10	0	0	10	0	0
12	31704077	.	A	C	3	7	10	0	0	10	0	0
12	31704458	.	G	A	1	2	3	0	2	5	0	0
12	31704485	.	A	G	4	0	4	0	4	8	0	0
12	31704548	.	T	C	3	4	7	0	0	7	0	0
12	31708020	.	C	T	5	3	8	0	0	8	0	0
12	31708025	.	G	A	3	4	7	0	1	8	0	0
12	31708082	.	G	A	3	5	8	0	0	8	0	0
12	31708125	.	C	A	5	4	9	0	0	9	0	0
12	31709852	.	A	T	1	3	4	0	1	5	0	0
12	31709902	.	G	A	3	2	5	0	0	5	0	0
12	31709964	.	G	T	2	4	6	0	1	7	0	0
12	31720799	.	C	T	19	12	31	0	2	33	0	0
12	31722593	.	G	T	6	15	21	0	2	23	0	0
12	31722811	.	G	T	12	9	21	0	0	21	0	0
12	31722875	.	A	C	19	2	21	0	15	36	0	0
12	31724245	.	A	C	23	23	46	0	1	47	0	0
12	31724252	.	C	T	23	27	50	0	0	50	0	0
12	31729236	.	G	A	12	12	24	1	1	26	0	0
12	31729441	.	A	C	4	10	14	0	3	17	0	0
12	31729455	.	G	T	3	15	18	0	1	19	0	0
12	31740733	.	T	C	12	9	21	0	0	21	0	0
12	31740822	.	C	T	9	14	23	0	0	23	0	0
12	31741463	.	C	T	16	10	26	0	0	26	0	0
12	31743995	.	C	T	8	10	18	0	0	18	0	0
12	31753752	.	C	T	8	12	20	0	0	20	0	0
12	31753755	.	C	T	8	11	19	0	0	19	0	0
12	31764523	.	T	C	10	17	27	0	1	28	0	0
12	31764526	.	C	A	11	17	28	0	1	29	0	0
12	31765407	.	G	A	16	13	29	0	0	29	0	0
12	31765485	.	G	A	10	9	19	0	0	19	0	0
12	31765517	.	T	C	14	8	22	0	0	22	0	0
12	31765540	.	T	G	13	7	20	0	1	21	0	0
12	31783185	.	G	A	5	6	11	0	0	11	0	0
12	31785545	.	G	A	3	4	7	0	0	7	0	0
12	31787394	.	G	C	1	4	5	0	0	5	0	0
12	31789799	.	C	T	9	18	27	0	1	28	0	0
12	31794655	.	G	A	14	14	28	0	1	29	0	0
12	31919122	.	C	T	4	2	6	0	0	6	0	0
12	31919143	.	T	G	3	3	6	0	0	6	0	0
12	32039443	.	C	T	2	12	14	0	11	25	0	0
12	32039527	.	A	G	10	12	22	0	2	24	0	0
12	32039546	.	G	A	16	8	24	0	3	27	0	0
12	32039635	.	A	C	12	20	32	0	1	33	0	0
12	32039678	.	C	T	21	27	48	0	0	48	0	0
12	32039937	.	G	A	15	20	35	0	3	38	0	0
12	32039958	.	T	C	22	0	22	0	16	38	0	0
12	32040093	.	G	A	23	18	41	1	2	44	0	0
12	32045155	.	G	A	18	16	34	0	3	37	0	0
12	32045212	.	T	C	19	0	19	0	15	34	0	0
12	32051434	.	C	A	25	10	35	0	3	38	0	0
12	32051488	.	G	A	21	13	34	0	1	35	0	0
12	32066061	.	C	A	16	11	27	0	1	28	0	0
12	32068700	.	A	T	5	2	7	0	0	7	0	0
12	32100900	.	A	G	2	2	4	0	0	4	0	0
12	33245714	.	A	C	0	0	0	0	12	12	0	0
12	33604491	.	A	C	1	2	3	0	1	4	0	0
12	33966790	.	T	G	28	20	48	0	3	51	0	0
12	33966886	.	A	G	22	22	44	0	2	46	0	0
12	33966905	.	C	T	22	17	39	0	1	40	0	0
12	33967283	.	C	T	18	15	33	0	0	33	0	0
12	33968073	.	T	A	26	22	48	0	1	49	0	0
12	33971333	.	G	T	12	19	31	0	0	32	1	0
12	33972748	.	G	A	18	14	32	0	0	32	0	0
12	33975235	.	C	T	4	3	7	0	0	7	0	0
12	33982344	.	C	T	2	6	8	0	0	8	0	0
12	33982506	.	T	A	8	2	10	0	0	10	0	0
12	33984160	.	A	T	1	3	4	0	0	4	0	0
12	33988266	.	C	T	2	2	4	0	2	6	0	0
12	33988374	.	T	C	2	4	6	0	0	6	0	0
12	33988623	.	G	C	5	9	14	0	0	14	0	0
12	33988737	.	T	A	3	1	4	0	0	4	0	0
12	33991521	.	G	A	16	15	31	0	0	31	0	0
12	33991622	.	T	C	14	16	30	0	3	33	0	0
12	33991781	.	T	C	24	25	49	0	2	51	0	0
12	33991867	.	A	T	21	23	44	0	1	45	0	0
12	33991882	.	T	A	28	19	47	0	1	48	0	0
12	33991987	.	A	C	20	32	52	0	0	52	0	0
12	33992208	.	A	C	10	10	20	0	6	26	0	0
12	33992813	.	C	A	20	23	43	0	1	44	0	0
12	33993008	.	T	A	25	19	44	2	1	47	0	0
12	33993152	.	A	T	20	21	41	0	3	44	0	0
12	33993320	.	C	T	2	21	23	0	17	40	0	0
12	33997324	.	G	A	17	23	40	0	1	41	0	0
12	34180040	.	C	A	10	3	13	0	0	13	0	0
12	34180771	.	C	T	4	7	11	1	1	13	0	0
12	34187407	.	A	G	6	0	6	0	12	18	0	0
12	34192041	.	G	A	1	11	12	0	10	22	0	0
12	34192387	.	C	A	2	2	4	0	0	4	0	0
12	34192454	.	C	T	6	2	8	0	0	8	0	0
12	34192551	.	C	T	8	6	14	0	2	16	0	0
12	34192679	.	T	C	6	8	14	0	0	14	0	0
12	34192869	.	C	T	1	2	3	0	0	3	0	0
12	34192870	.	G	A	0	2	2	0	1	3	0	0
12	34209402	.	T	A	7	8	15	0	1	16	0	0
12	34219445	.	A	T	2	3	5	0	0	5	0	0
12	34219622	.	G	A	3	3	6	0	0	6	0	0
12	34219670	.	C	T	1	2	3	0	2	5	0	0
12	34427449	.	T	C	2	2	4	0	0	4	0	0
12	34563459	.	G	T	8	1	9	0	0	14	5	0
12	34563469	.	T	C	8	5	13	0	1	14	0	0
12	34564123	.	A	G	10	11	21	0	1	22	0	0
12	34564343	.	C	T	3	4	7	0	0	7	0	0
12	34564416	.	A	G	4	3	7	0	0	7	0	0
12	34564646	.	T	C	4	0	4	0	4	8	0	0
12	34564786	.	G	A	2	5	7	0	0	7	0	0
12	34564904	.	A	T	6	3	9	0	1	10	0	0
12	34565200	.	A	C	2	3	5	0	0	5	0	0
12	34565223	.	T	C	2	4	6	0	0	6	0	0
12	34565311	.	C	T	2	2	4	0	0	4	0	0
12	34565354	.	C	G	7	5	12	0	0	12	0	0
12	34565441	.	A	G	9	7	16	0	0	16	0	0
12	34565504	.	A	G	5	5	10	0	2	12	0	0
12	34566022	.	C	T	3	9	12	0	1	13	0	0
12	34566547	.	T	A	2	5	7	0	0	7	0	0
12	34566715	.	C	T	3	3	6	0	1	7	0	0
12	34566766	.	C	T	8	5	13	0	0	13	0	0
12	34568320	.	A	C	7	4	11	0	0	11	0	0
12	34568321	.	C	A	6	4	10	0	1	11	0	0
12	34568383	.	T	C	5	5	10	0	0	10	0	0
12	34574380	.	T	C	3	3	6	0	0	6	0	0
12	34574413	.	G	A	4	4	8	0	1	9	0	0
12	34574416	.	T	A	6	4	10	0	0	10	0	0
12	34580590	.	C	T	1	5	6	0	1	7	0	0
12	34581049	.	C	T	2	3	5	0	0	5	0	0
12	34581051	.	C	T	3	3	6	0	0	6	0	0
12	34583025	.	C	A	1	2	3	0	3	6	0	0
12	34597779	.	C	T	0	4	4	0	5	9	0	0
12	34606935	.	C	A	3	4	7	0	0	7	0	0
12	34607231	.	C	G	5	2	7	0	0	7	0	0
12	34609981	.	G	T	2	5	7	0	0	7	0	0
12	34638681	.	T	C	5	0	5	0	3	8	0	0
12	34732862	.	A	T	5	2	7	0	0	7	0	0
12	34768596	.	C	T	1	2	3	0	0	3	0	0
12	34810833	.	A	G	5	2	7	0	0	7	0	0
12	34819657	.	A	C	3	5	8	0	0	8	0	0
12	34819719	.	T	G	3	6	9	0	0	9	0	0
12	34820013	.	G	A	8	5	13	0	0	13	0	0
12	34820214	.	G	A	0	6	6	0	4	10	0	0
12	34820574	.	C	A	4	4	8	0	1	9	0	0
12	34821051	.	C	T	8	4	12	0	0	12	0	0
12	34821418	.	A	C	2	2	4	0	1	5	0	0
12	34821557	.	T	C	2	2	4	0	0	4	0	0
12	34826663	.	G	T	5	2	7	0	0	7	0	0
12	34830863	.	T	C	1	2	3	0	0	3	0	0
12	34834943	.	A	G	3	3	6	0	0	6	0	0
12	34840201	.	C	T	3	3	6	0	0	6	0	0
12	34841852	.	C	T	7	5	12	0	0	12	0	0
12	34841886	.	A	T	5	6	11	0	1	12	0	0
12	34841897	.	C	G	7	4	11	0	0	11	0	0
12	34841996	.	A	G	2	0	2	0	9	11	0	0
12	34845018	.	A	T	1	2	3	0	0	3	0	0
12	34845413	.	T	A	3	2	5	0	0	5	0	0
12	34845669	.	T	G	3	6	9	0	0	9	0	0
12	34845923	.	C	A	5	4	9	0	0	9	0	0
12	34846820	.	G	A	1	2	3	0	0	3	0	0
12	34847077	.	T	G	2	6	8	0	1	9	0	0
12	34847234	.	A	T	4	2	6	0	0	6	0	0
12	34847949	.	G	A	11	6	17	0	0	17	0	0
12	34847978	.	T	C	9	6	15	0	0	15	0	0
12	34851117	.	G	A	4	10	14	0	0	14	0	0
12	34869654	.	G	T	1	3	4	0	0	4	0	0
12	34876712	.	A	G	5	5	10	0	0	10	0	0
12	34876827	.	A	G	7	7	14	0	1	15	0	0
12	34877048	.	T	A	6	8	14	0	0	14	0	0
12	34883556	.	A	C	7	7	14	0	0	14	0	0
12	34883557	.	G	A	7	7	14	0	0	14	0	0
12	34883640	.	G	A	8	8	16	0	0	16	0	0
12	34884062	.	T	A	4	2	6	0	0	6	0	0
12	34884446	.	C	T	0	2	2	0	4	6	0	0
12	34891681	.	C	T	12	13	25	0	0	25	0	0
12	34891911	.	A	T	11	8	19	0	2	21	0	0
12	34892024	.	A	G	8	4	12	0	0	12	0	0
12	34892089	.	C	T	4	7	11	0	0	11	0	0
12	34892590	.	T	A	10	10	20	0	1	21	0	0
12	34953641	.	G	T	0	9	9	0	11	20	0	0
12	34981205	.	G	A	1	6	7	1	16	24	0	0
12	35012004	.	C	T	11	13	24	1	0	25	0	0
12	35012127	.	T	C	19	13	32	1	0	33	0	0
12	35018127	.	C	T	19	13	32	0	2	34	0	0
12	35018320	.	T	G	13	2	15	0	10	25	0	0
12	35021590	.	G	T	2	3	5	0	0	5	0	0
12	35021593	.	G	A	2	2	4	0	1	5	0	0
12	35051265	.	C	T	6	13	19	0	1	20	0	0
12	35085548	.	A	C	0	3	3	0	2	5	0	0
12	35085550	.	A	C	0	4	4	0	1	5	0	0
12	35085585	.	A	T	2	2	4	0	0	4	0	0
12	35087799	.	T	C	1	2	3	0	0	3	0	0
12	35099775	.	C	A	0	6	6	0	6	12	0	0
12	35103300	.	C	T	2	7	9	0	0	9	0	0
12	35103606	.	T	C	8	0	8	0	7	15	0	0
12	35119833	.	C	A	17	14	31	0	0	31	0	0
12	35120000	.	C	T	8	6	14	0	0	14	0	0
12	35146537	.	G	A	0	2	2	0	6	8	0	0
12	35158344	.	C	T	6	7	13	0	0	13	0	0
12	35167333	.	A	G	15	13	28	0	4	32	0	0
12	35178914	.	G	A	9	16	25	0	0	25	0	0
12	35189264	.	G	T	13	12	25	0	1	26	0	0
12	35189295	.	C	T	19	8	27	0	1	28	0	0
12	35189471	.	T	A	14	12	26	0	0	26	0	0
12	35191841	.	T	A	22	8	30	0	0	30	0	0
12	35191856	.	C	T	11	15	26	0	0	26	0	0
12	35270489	.	C	T	2	4	6	0	1	7	0	0
12	35270529	.	C	T	5	2	7	0	0	7	0	0
12	35316791	.	C	A	5	3	8	0	1	9	0	0
12	35317147	.	G	A	5	8	13	0	0	13	0	0
12	35317222	.	A	G	6	3	9	0	0	9	0	0
12	35317294	.	A	G	7	0	7	0	6	13	0	0
12	35317520	.	C	A	7	5	12	0	0	12	0	0
12	35317609	.	C	T	3	7	10	0	0	10	0	0
12	35317654	.	C	T	3	4	7	0	0	7	0	0
12	35328139	.	C	T	8	5	13	0	1	14	0	0
12	35332283	.	T	A	6	5	11	0	0	11	0	0
12	35334652	.	C	G	4	11	15	0	0	15	0	0
12	35339212	.	A	G	16	4	20	0	0	20	0	0
12	35339263	.	A	T	12	5	17	0	0	17	0	0
12	35339395	.	C	T	7	3	10	0	0	10	0	0
12	35346498	.	G	A	24	24	48	0	4	52	0	0
12	35346597	.	A	T	38	18	56	0	3	59	0	0
12	35346842	.	T	C	25	14	39	0	2	41	0	0
12	35346873	.	C	T	27	27	54	0	0	54	0	0
12	35347002	.	A	T	20	25	45	0	0	45	0	0
12	35347078	.	G	A	24	23	47	0	2	49	0	0
12	35347084	.	C	T	2	22	24	0	25	49	0	0
12	35347318	.	C	T	26	23	49	0	7	56	0	0
12	35347485	.	T	G	26	18	44	0	4	48	0	0
12	35347795	.	C	T	1	12	13	0	5	18	0	0
12	35347951	.	A	G	22	29	51	0	1	52	0	0
12	35350686	.	G	A	16	26	42	0	1	43	0	0
12	35351392	.	G	T	28	11	39	1	1	41	0	0
12	35381726	.	T	C	24	0	24	0	13	37	0	0
12	35381729	.	T	C	7	0	7	0	27	34	0	0
12	35386919	.	A	G	11	13	24	0	3	27	0	0
12	35543736	.	T	G	6	13	19	0	0	19	0	0
12	35543971	.	T	G	15	11	26	0	0	26	0	0
12	35544320	.	T	G	12	6	18	0	1	19	0	0
12	35544460	.	A	G	6	11	17	0	1	18	0	0
12	35544596	.	C	A	7	5	12	0	2	14	0	0
12	35544968	.	A	G	8	12	20	0	1	21	0	0
12	35551120	.	G	A	3	7	10	0	1	11	0	0
12	35556821	.	G	C	2	3	5	0	0	5	0	0
12	35559393	.	G	A	6	2	8	0	0	8	0	0
12	35559614	.	T	G	7	5	12	0	0	12	0	0
12	35568231	.	G	A	10	15	25	0	2	27	0	0
12	35568249	.	C	T	1	14	15	0	18	33	0	0
12	35568270	.	T	A	21	9	30	0	1	31	0	0
12	35568303	.	C	G	10	18	28	0	0	28	0	0
12	35568691	.	A	G	3	8	11	0	1	12	0	0
12	35568787	.	G	A	5	5	10	0	0	10	0	0
12	35568793	.	A	G	6	4	10	0	0	10	0	0
12	35593188	.	C	T	20	22	42	0	1	43	0	0
12	35593469	.	T	A	10	8	18	0	0	18	0	0
12	35593729	.	A	G	12	0	12	0	6	18	0	0
12	35594069	.	T	A	23	11	34	0	2	36	0	0
12	35594154	.	C	T	14	10	24	0	1	25	0	0
12	35594169	.	C	T	14	9	23	0	2	25	0	0
12	35594436	.	C	T	19	14	33	0	0	33	0	0
12	35594474	.	A	G	17	12	29	0	1	30	0	0
12	35594605	.	C	T	22	13	35	0	2	37	0	0
12	35594623	.	T	A	24	12	36	0	0	36	0	0
12	35674952	.	G	A	16	9	25	0	0	25	0	0
12	35689209	.	C	T	20	13	33	0	1	34	0	0
12	35689210	.	A	G	20	14	34	0	0	34	0	0
12	35704426	.	G	T	22	18	40	0	3	43	0	0
12	35704435	.	G	T	26	20	46	0	1	47	0	0
12	35704735	.	A	G	15	14	29	0	0	29	0	0
12	35704852	.	G	A	13	19	32	0	1	33	0	0
12	35704921	.	A	C	21	19	40	0	0	40	0	0
12	35704996	.	T	G	23	17	40	0	2	42	0	0
12	35705131	.	C	T	19	14	33	0	5	38	0	0
12	35705140	.	A	C	19	0	19	0	16	35	0	0
12	35705224	.	A	G	14	11	25	0	4	29	0	0
12	35705252	.	T	G	18	18	36	0	0	36	0	0
12	35705323	.	G	A	17	12	29	0	2	31	0	0
12	35705367	.	C	T	2	16	18	0	16	34	0	0
12	35705565	.	C	T	3	12	15	0	10	25	0	0
12	35705606	.	A	T	8	9	17	0	0	17	0	0
12	35705661	.	T	C	13	12	25	0	0	25	0	0
12	35705926	.	C	T	22	15	37	0	3	40	0	0
12	35706091	.	C	T	11	17	28	0	0	28	0	0
12	35706124	.	A	G	14	13	27	0	0	27	0	0
12	35706253	.	A	T	11	16	27	0	2	29	0	0
12	35706304	.	A	G	14	12	26	0	2	28	0	0
12	35706524	.	G	A	16	22	38	0	0	38	0	0
12	35706568	.	C	T	18	15	33	0	2	35	0	0
12	35706859	.	C	T	0	17	17	0	17	34	0	0
12	35706970	.	G	T	9	11	20	0	1	21	0	0
12	35707155	.	C	T	14	9	23	0	1	24	0	0
12	35707171	.	T	C	14	8	22	0	1	23	0	0
12	35707225	.	G	A	20	9	29	0	3	32	0	0
12	35707537	.	A	G	13	8	21	0	0	21	0	0
12	35707636	.	G	A	6	9	15	0	1	16	0	0
12	35707660	.	A	C	2	7	9	0	1	10	0	0
12	35707747	.	A	G	9	7	16	0	1	17	0	0
12	35707963	.	T	C	14	0	14	0	9	23	0	0
12	35707987	.	G	A	14	11	25	0	0	25	0	0
12	35708139	.	T	G	15	13	28	0	1	29	0	0
12	35708235	.	A	G	14	10	24	0	0	24	0	0
12	35708272	.	C	T	12	10	22	0	3	25	0	0
12	35708950	.	G	A	15	13	28	0	1	29	0	0
12	35709007	.	G	A	16	15	31	0	0	31	0	0
12	35709028	.	A	G	13	17	30	0	1	31	0	0
12	35710837	.	T	C	14	9	23	0	0	23	0	0
12	35715339	.	A	G	4	12	16	0	1	17	0	0
12	35716116	.	T	G	4	8	12	0	1	13	0	0
12	35740605	.	G	T	6	8	14	0	0	14	0	0
12	35837425	.	T	A	3	5	8	0	2	10	0	0
12	35837468	.	C	A	3	4	7	0	0	7	0	0
12	35837499	.	G	C	5	4	9	0	0	9	0	0
12	35837503	.	T	G	4	4	8	0	1	9	0	0
12	35837751	.	G	A	5	7	12	0	0	12	0	0
12	35837828	.	T	A	10	4	14	0	0	14	0	0
12	35837842	.	G	A	11	5	16	0	0	16	0	0
12	35838537	.	G	C	3	3	6	0	0	6	0	0
12	35838542	.	A	C	3	2	5	0	0	5	0	0
12	35838882	.	A	C	7	4	11	0	0	11	0	0
12	35839090	.	C	T	0	3	3	0	7	10	0	0
12	35839159	.	C	T	5	5	10	0	0	10	0	0
12	35839165	.	C	G	6	6	12	0	0	12	0	0
12	35839261	.	C	A	9	11	20	0	0	20	0	0
12	35839680	.	G	A	3	5	8	0	0	8	0	0
12	35839879	.	C	A	0	7	7	0	10	17	0	0
12	35839942	.	C	T	4	2	6	0	2	8	0	0
12	35840003	.	T	C	3	0	3	0	5	8	0	0
12	35840008	.	C	A	2	5	7	0	1	8	0	0
12	35840244	.	G	A	4	2	6	0	0	6	0	0
12	35840245	.	A	G	4	2	6	0	0	6	0	0
12	35840543	.	A	C	5	9	14	0	0	14	0	0
12	35840717	.	A	G	4	8	12	0	0	12	0	0
12	35841438	.	G	A	3	2	5	0	1	6	0	0
12	35841457	.	G	A	6	5	11	0	1	12	0	0
12	35853732	.	C	A	9	4	13	0	1	14	0	0
12	35864581	.	T	A	2	3	5	0	0	5	0	0
12	35865689	.	C	T	6	5	11	0	1	12	0	0
12	35867935	.	G	A	5	5	10	0	0	10	0	0
12	35868203	.	A	G	2	3	5	0	0	5	0	0
12	35872597	.	C	T	5	2	7	0	1	8	0	0
12	35873158	.	C	T	5	3	8	0	0	8	0	0
12	35875707	.	A	G	4	5	9	0	0	9	0	0
12	35875766	.	A	G	2	6	8	0	0	8	0	0
12	35963575	.	T	C	12	10	22	0	0	22	0	0
12	35976771	.	C	A	8	3	11	0	1	12	0	0
12	35980632	.	T	C	1	3	4	0	0	4	0	0
12	35980758	.	C	T	1	5	6	1	0	7	0	0
12	35980764	.	T	C	1	5	6	1	0	7	0	0
12	35980817	.	T	A	2	4	6	0	0	6	0	0
12	35980917	.	T	G	5	11	16	0	1	17	0	0
12	35981206	.	T	C	6	0	6	0	7	13	0	0
12	35981260	.	T	A	4	7	11	0	0	11	0	0
12	35981303	.	T	G	2	7	9	0	0	9	0	0
12	35981304	.	G	C	2	7	9	0	0	9	0	0
12	35981478	.	A	G	5	2	7	0	0	7	0	0
12	35981627	.	C	T	1	7	8	1	2	11	0	0
12	35981795	.	T	A	5	13	18	0	2	20	0	0
12	35981832	.	A	G	3	10	13	0	0	13	0	0
12	35988544	.	A	G	5	12	17	0	1	18	0	0
12	35988553	.	G	A	5	11	16	0	0	16	0	0
12	36105341	.	A	G	4	2	6	0	0	6	0	0
12	36135764	.	C	T	8	5	13	1	2	16	0	0
12	36158056	.	A	C	18	15	33	1	2	36	0	0
12	36158098	.	G	C	24	14	38	1	0	39	0	0
12	36158099	.	T	C	24	13	37	1	1	39	0	0
12	36158225	.	T	C	13	18	31	0	0	31	0	0
12	36158349	.	G	A	1	16	17	0	13	30	0	0
12	36158538	.	C	T	8	5	13	0	0	13	0	0
12	36159597	.	C	G	9	7	16	1	1	18	0	0
12	36413937	.	A	T	7	7	14	0	0	14	0	0
12	36416669	.	T	C	6	3	9	0	0	9	0	0
12	36416675	.	T	C	4	4	8	0	0	8	0	0
12	36416714	.	G	A	4	5	9	0	0	9	0	0
12	36416732	.	G	C	5	6	11	0	0	11	0	0
12	36420141	.	T	C	4	4	8	0	0	8	0	0
12	36420420	.	G	A	2	4	6	0	0	6	0	0
12	36424613	.	G	A	6	8	14	0	0	14	0	0
12	36424618	.	G	A	10	7	17	0	1	18	0	0
12	36452380	.	C	T	2	3	5	0	0	5	0	0
12	36452452	.	T	A	2	3	5	0	0	5	0	0
12	36462038	.	G	A	2	8	10	0	0	10	0	0
12	36468999	.	G	T	1	2	3	0	0	3	0	0
12	36469011	.	T	A	1	2	3	0	0	3	0	0
12	36471149	.	A	C	1	2	3	0	1	4	0	0
12	36670276	.	A	G	1	2	3	0	0	3	0	0
12	36739494	.	C	T	2	2	4	0	0	4	0	0
12	36891583	.	C	T	6	3	9	0	0	9	0	0
12	36895025	.	A	G	6	10	16	0	0	16	0	0
12	36895057	.	T	C	2	6	8	0	0	8	0	0
12	36895067	.	G	A	1	4	5	0	0	5	0	0
12	36952648	.	T	G	7	0	7	1	3	11	0	0
12	36952744	.	C	T	5	4	9	0	0	9	0	0
12	36960197	.	T	C	1	3	4	0	0	4	0	0
12	36960200	.	A	T	1	2	3	0	0	3	0	0
12	37002957	.	G	A	0	3	3	0	1	4	0	0
12	37003282	.	C	T	1	5	6	0	0	6	0	0
12	37003291	.	A	G	1	5	6	0	0	6	0	0
12	37003386	.	T	G	1	0	1	0	2	3	0	0
12	37003391	.	T	C	1	3	4	0	0	4	0	0
12	37004290	.	A	C	2	4	6	0	1	7	0	0
12	37004295	.	C	T	3	2	5	0	0	5	0	0
12	37004801	.	G	T	1	3	4	0	1	5	0	0
12	37005350	.	T	C	2	1	3	0	2	5	0	0
12	37275712	.	A	T	3	3	6	0	0	6	0	0
12	37275719	.	G	T	3	3	6	0	0	6	0	0
12	37275799	.	T	G	1	2	3	0	0	3	0	0
12	37275800	.	T	G	1	2	3	0	0	3	0	0
12	37407249	.	G	T	2	6	8	0	0	8	0	0
12	37407392	.	T	A	8	8	16	0	1	17	0	0
12	37407477	.	T	C	5	5	10	0	1	11	0	0
12	37407524	.	C	A	8	4	12	0	0	12	0	0
12	37407632	.	T	A	4	8	12	0	1	13	0	0
12	37407813	.	C	T	6	6	12	0	2	14	0	0
12	37408206	.	A	G	3	11	14	0	0	14	0	0
12	37408232	.	T	A	3	11	14	0	0	14	0	0
12	37408442	.	G	C	6	6	12	0	0	12	0	0
12	37408690	.	T	C	0	0	0	5	9	14	0	0
12	37409037	.	C	T	1	4	5	1	0	6	0	0
12	37409269	.	C	T	4	5	9	0	0	9	0	0
12	37409315	.	C	T	0	6	6	0	4	10	0	0
12	37409481	.	G	A	5	9	14	0	0	14	0	0
12	37409611	.	A	G	4	6	10	0	0	10	0	0
12	37409802	.	C	T	4	7	11	0	0	11	0	0
12	37409836	.	T	G	4	6	10	0	0	10	0	0
12	37410018	.	T	C	5	0	5	0	8	13	0	0
12	37410034	.	C	T	2	8	10	0	0	10	0	0
12	37410111	.	T	C	2	4	6	0	0	6	0	0
12	37410469	.	T	G	2	5	7	0	0	7	0	0
12	37410519	.	C	T	3	7	10	0	0	10	0	0
12	37410546	.	T	C	2	0	2	0	6	8	0	0
12	37410816	.	A	G	3	6	9	0	0	9	0	0
12	37410966	.	T	C	4	6	10	0	0	10	0	0
12	37411041	.	T	C	4	0	4	0	4	8	0	0
12	37449300	.	C	T	3	2	5	0	0	5	0	0
12	37463606	.	T	C	5	0	5	0	12	17	0	0
12	37497149	.	G	A	5	6	11	0	0	11	0	0
12	37503881	.	G	A	6	3	9	0	0	9	0	0
12	37530848	.	A	G	4	3	7	0	1	8	0	0
12	37531008	.	G	A	3	4	7	0	0	7	0	0
12	37531014	.	A	G	3	3	6	0	1	7	0	0
12	37531071	.	G	T	5	2	7	0	3	10	0	0
12	37545850	.	G	A	4	3	7	0	0	7	0	0
12	38556545	.	A	G	2	4	6	0	0	6	0	0
12	38556562	.	G	T	3	6	9	0	0	9	0	0
12	38561258	.	C	A	6	16	22	1	1	24	0	0
12	38563219	.	T	A	2	4	6	0	1	7	0	0
12	38563233	.	G	A	2	6	8	0	0	8	0	0
12	38605005	.	C	T	4	3	7	0	0	7	0	0
12	38651329	.	C	T	3	2	5	0	0	5	0	0
12	38655310	.	C	A	1	3	4	0	0	4	0	0
12	38675121	.	A	T	1	2	3	0	0	3	0	0
12	38687907	.	T	A	5	2	7	0	0	7	0	0
12	38787630	.	G	A	3	5	8	0	0	8	0	0
12	38799627	.	C	T	5	6	11	0	0	11	0	0
12	38799678	.	C	G	5	7	12	0	0	12	0	0
12	38799732	.	G	A	7	6	13	0	0	13	0	0
12	38799759	.	C	T	8	7	15	0	1	16	0	0
12	38799822	.	A	C	5	10	15	0	1	16	0	0
12	38802875	.	T	C	10	3	13	0	1	14	0	0
12	38803148	.	T	A	3	4	7	1	0	8	0	0
12	38803238	.	C	T	6	4	10	0	0	10	0	0
12	38803411	.	A	G	6	0	6	0	6	12	0	0
12	38803586	.	T	C	2	3	5	0	0	5	0	0
12	38804166	.	G	T	2	2	4	0	0	4	0	0
12	38804305	.	A	G	5	5	10	0	0	10	0	0
12	38804314	.	C	T	7	4	11	0	0	11	0	0
12	38804350	.	G	A	10	5	15	0	0	15	0	0
12	38804405	.	A	G	4	9	13	0	1	14	0	0
12	38804406	.	T	C	9	5	14	0	0	14	0	0
12	38804466	.	G	A	6	4	10	0	0	10	0	0
12	38804538	.	A	C	2	4	6	0	1	7	0	0
12	38804965	.	T	C	5	2	7	0	1	8	0	0
12	38809283	.	C	T	3	2	5	0	0	5	0	0
12	38819679	.	C	T	2	2	4	0	0	4	0	0
12	38828655	.	C	A	1	6	7	0	0	7	0	0
12	38836784	.	T	G	5	0	5	0	9	14	0	0
12	38842158	.	G	A	2	4	6	0	1	7	0	0
12	38842188	.	C	T	2	4	6	0	1	7	0	0
12	38843587	.	A	G	2	4	6	0	0	6	0	0
12	38847925	.	C	T	5	5	10	0	0	10	0	0
12	38849546	.	C	A	6	3	9	0	0	9	0	0
12	38850285	.	T	A	7	5	12	0	0	12	0	0
12	38850889	.	C	T	6	4	10	0	0	10	0	0
12	38855015	.	A	T	3	3	6	0	0	6	0	0
12	38855049	.	G	A	0	3	3	0	4	7	0	0
12	38855255	.	T	C	4	2	6	1	0	7	0	0
12	38855344	.	G	A	0	2	2	0	14	16	0	0
12	38855596	.	T	G	2	0	2	0	11	13	0	0
12	38855859	.	T	A	3	2	5	0	0	5	0	0
12	38855861	.	C	T	3	3	6	0	0	6	0	0
12	38910511	.	G	C	2	2	4	0	0	4	0	0
12	38971950	.	C	T	1	5	6	0	0	6	0	0
12	39744954	.	G	C	0	8	8	0	7	15	0	0
12	40206716	.	G	A	0	2	2	0	5	7	0	0
12	40348899	.	G	T	0	4	4	0	6	10	0	0
12	40497143	.	T	C	4	5	9	0	0	9	0	0
12	40518043	.	T	C	10	11	21	0	0	21	0	0
12	40518088	.	C	T	10	9	19	0	0	19	0	0
12	40518094	.	T	C	10	8	18	0	0	18	0	0
12	40905584	.	G	C	0	5	5	0	0	5	0	0
12	40945980	.	C	T	5	6	11	0	1	12	0	0
12	41000900	.	G	A	1	6	7	0	6	13	0	0
12	41000969	.	A	G	6	0	6	1	11	18	0	0
12	41000993	.	A	C	6	10	16	1	0	17	0	0
12	41028550	.	A	G	7	5	12	1	1	14	0	0
12	41028626	.	G	A	2	8	10	0	6	16	0	0
12	41037024	.	A	C	11	11	22	0	0	22	0	0
12	41071775	.	T	C	15	9	24	0	0	24	0	0
12	41071841	.	T	C	6	8	14	0	1	15	0	0
12	41112962	.	C	T	10	3	13	0	1	14	0	0
12	41113007	.	T	C	9	8	17	0	1	18	0	0
12	41113040	.	G	A	12	9	21	0	1	22	0	0
12	41113049	.	C	A	10	13	23	0	1	24	0	0
12	41113313	.	A	T	14	14	28	0	1	29	0	0
12	41113489	.	G	T	0	5	5	0	5	10	0	0
12	41437046	.	G	A	9	14	23	0	1	24	0	0
12	41449931	.	C	T	18	9	27	1	1	29	0	0
12	41455861	.	T	C	5	4	9	0	0	9	0	0
12	41458264	.	G	A	6	3	9	0	0	9	0	0
12	41461321	.	A	T	11	7	18	0	0	18	0	0
12	41530062	.	C	T	8	10	18	0	0	18	0	0
12	41530095	.	T	C	7	18	25	0	2	27	0	0
12	41535844	.	C	T	9	8	17	0	1	18	0	0
12	41535886	.	A	C	10	8	18	0	1	19	0	0
12	41535898	.	C	T	9	8	17	0	0	17	0	0
12	41535937	.	T	A	19	6	25	0	1	26	0	0
12	41539161	.	C	T	20	18	38	0	0	38	0	0
12	41541259	.	C	T	14	19	33	0	2	35	0	0
12	41547505	.	A	G	13	13	26	0	3	29	0	0
12	41549214	.	G	A	0	15	15	0	18	33	0	0
12	41549404	.	C	G	14	16	30	0	1	31	0	0
12	41549413	.	G	T	17	15	32	0	1	33	0	0
12	41549476	.	T	C	17	26	43	0	0	43	0	0
12	41581092	.	A	G	6	8	14	0	2	16	0	0
12	41581257	.	A	T	7	12	19	1	0	20	0	0
12	41593093	.	T	A	8	11	19	0	2	21	0	0
12	41606683	.	T	C	8	0	8	0	11	19	0	0
12	41606686	.	G	T	8	11	19	0	0	19	0	0
12	41612061	.	A	G	7	10	17	0	1	18	0	0
12	41631703	.	A	T	4	2	6	0	0	6	0	0
12	41632117	.	A	G	8	27	35	0	0	35	0	0
12	41633644	.	C	A	0	25	25	0	12	37	0	0
12	41636655	.	C	T	13	9	22	0	1	23	0	0
12	41636658	.	G	T	13	9	22	0	2	24	0	0
12	41643177	.	T	A	10	13	23	0	0	23	0	0
12	41643178	.	C	T	10	13	23	0	0	23	0	0
12	41643214	.	C	T	8	12	20	0	1	21	0	0
12	41643217	.	G	A	7	14	21	0	0	21	0	0
12	41647273	.	T	C	19	5	24	0	2	26	0	0
12	41647312	.	C	T	16	7	23	0	1	24	0	0
12	41653151	.	G	A	14	9	23	0	2	25	0	0
12	41656554	.	G	A	14	10	24	0	1	25	0	0
12	41684634	.	G	A	9	10	19	0	0	19	0	0
12	41698056	.	G	A	30	20	50	0	0	50	0	0
12	41702044	.	A	C	21	26	47	0	1	48	0	0
12	41723148	.	T	A	8	6	14	0	0	14	0	0
12	41723310	.	C	T	1	16	17	0	8	25	0	0
12	41723457	.	G	A	13	9	22	0	1	23	0	0
12	41723477	.	C	T	7	6	13	0	1	14	0	0
12	41723501	.	A	T	0	2	2	0	2	4	0	0
12	41723516	.	G	A	1	2	3	0	0	3	0	0
12	41723608	.	T	A	15	11	26	0	0	26	0	0
12	41723747	.	C	T	15	9	24	0	0	24	0	0
12	41731908	.	G	A	10	7	17	0	2	19	0	0
12	41732013	.	C	T	1	10	11	0	6	17	0	0
12	41735790	.	T	C	9	8	17	1	1	19	0	0
12	41739297	.	G	T	10	12	22	0	1	23	0	0
12	41739345	.	C	G	0	16	16	0	10	26	0	0
12	41759621	.	A	C	7	0	7	0	15	23	1	0
12	41759669	.	C	T	1	7	8	0	16	24	0	0
12	41991744	.	T	G	6	8	14	0	0	14	0	0
12	41991796	.	A	C	9	3	12	0	0	12	0	0
12	41991797	.	C	T	9	3	12	0	0	12	0	0
12	41992005	.	A	C	3	4	7	0	1	8	0	0
12	41992094	.	G	A	2	3	5	0	0	5	0	0
12	41992971	.	A	T	3	10	13	0	4	17	0	0
12	42007693	.	A	G	9	0	9	0	7	16	0	0
12	42153216	.	A	G	10	4	14	0	0	14	0	0
12	42182963	.	G	A	6	7	13	0	0	13	0	0
12	42186478	.	A	G	5	6	11	0	3	14	0	0
12	42186504	.	A	G	3	0	3	0	8	11	0	0
12	42195697	.	A	T	10	9	19	0	1	20	0	0
12	42196136	.	T	A	4	3	7	0	1	8	0	0
12	42196571	.	T	A	3	5	8	0	0	8	0	0
12	42196924	.	A	G	6	4	10	0	0	10	0	0
12	42196933	.	T	G	5	5	10	0	0	10	0	0
12	42197558	.	G	T	4	5	9	0	0	9	0	0
12	42197759	.	G	A	4	2	6	0	0	6	0	0
12	42364840	.	G	T	2	2	4	0	0	4	0	0
12	42365661	.	A	G	1	2	3	0	0	3	0	0
12	42366523	.	A	G	1	3	4	0	0	4	0	0
12	42369685	.	C	T	2	7	9	0	10	19	0	0
12	42369848	.	G	A	17	11	28	0	0	28	0	0
12	42369912	.	A	G	14	9	23	0	2	25	0	0
12	42384900	.	G	T	9	12	21	0	0	21	0	0
12	42384924	.	T	C	3	0	3	0	4	7	0	0
12	42405834	.	T	G	3	3	6	0	0	6	0	0
12	42406178	.	C	T	5	3	8	0	1	9	0	0
12	42576815	.	C	T	21	20	41	1	1	43	0	0
12	42577187	.	C	T	22	19	41	0	3	44	0	0
12	42578117	.	A	T	12	13	25	0	0	25	0	0
12	42578505	.	A	T	28	25	53	0	0	53	0	0
12	42578698	.	A	G	10	2	12	0	10	22	0	0
12	42578958	.	A	G	9	9	18	0	3	22	1	0
12	42578996	.	T	A	16	12	28	0	3	31	0	0
12	43376709	.	C	T	1	13	14	0	9	23	0	0
12	43376960	.	A	T	3	7	10	0	0	10	0	0
12	43377049	.	G	T	12	4	16	0	3	19	0	0
12	43377281	.	G	C	7	11	18	0	1	19	0	0
12	43377505	.	A	T	12	7	19	0	2	21	0	0
12	43377558	.	T	C	4	8	12	0	0	12	0	0
12	43378839	.	T	A	2	1	3	0	1	4	0	0
12	43379033	.	T	A	1	3	4	0	0	4	0	0
12	43379744	.	T	A	2	3	5	0	0	5	0	0
12	43384898	.	G	T	9	7	16	0	1	17	0	0
12	43384921	.	G	A	9	10	19	0	0	19	0	0
12	43391390	.	T	C	7	0	7	0	7	14	0	0
12	43395597	.	G	A	7	8	15	0	0	15	0	0
12	43395955	.	A	G	6	14	20	0	1	21	0	0
12	43415173	.	T	A	5	10	15	0	0	15	0	0
12	43426072	.	A	G	8	5	13	0	0	13	0	0
12	44368836	.	C	G	4	8	12	0	0	12	0	0
12	44372784	.	C	T	4	7	11	0	0	11	0	0
12	44378608	.	T	G	2	6	8	0	0	8	0	0
12	44416254	.	A	G	2	2	4	0	0	4	0	0
12	44416269	.	A	G	2	2	4	0	0	4	0	0
12	44558811	.	C	A	1	3	4	0	0	4	0	0
12	44611465	.	G	A	1	5	6	0	3	9	0	0
12	44611570	.	C	A	1	2	3	0	0	3	0	0
12	44611771	.	C	T	4	2	6	0	0	6	0	0
12	44611943	.	G	A	0	7	7	0	4	11	0	0
12	44611963	.	G	A	0	3	3	0	3	6	0	0
12	44635123	.	C	A	1	4	5	0	0	5	0	0
12	46608946	.	C	G	2	8	10	0	1	11	0	0
12	46616449	.	C	T	3	2	5	1	0	6	0	0
12	46620187	.	A	G	9	3	12	0	0	12	0	0
12	46620220	.	T	C	6	5	11	0	1	12	0	0
12	46624466	.	C	T	2	5	7	0	0	7	0	0
12	46629215	.	A	T	5	7	12	0	0	12	0	0
12	46629345	.	A	G	6	3	9	0	0	9	0	0
12	46630805	.	C	T	13	9	22	0	0	22	0	0
12	46631267	.	G	T	4	5	9	0	0	9	0	0
12	46631329	.	T	A	3	6	9	0	1	10	0	0
12	46688007	.	C	T	5	4	9	0	1	10	0	0
12	46688078	.	C	T	12	4	16	0	1	17	0	0
12	46688224	.	T	C	11	5	16	0	1	17	0	0
12	46693103	.	C	T	14	6	20	0	1	21	0	0
12	46695674	.	A	G	5	11	16	0	0	16	0	0
12	46695714	.	A	G	3	6	9	0	1	10	0	0
12	46695765	.	T	A	5	3	8	0	0	8	0	0
12	46696895	.	T	C	1	2	3	0	0	3	0	0
12	46696908	.	G	A	0	3	3	0	2	5	0	0
12	46698280	.	G	T	0	10	10	0	5	15	0	0
12	46698283	.	T	A	5	10	15	0	0	15	0	0
12	46699492	.	A	G	5	0	5	0	7	12	0	0
12	46699624	.	C	T	9	9	18	0	0	18	0	0
12	46733790	.	G	A	0	14	14	0	17	31	0	0
12	46738259	.	A	T	20	0	20	1	2	23	0	0
12	46738288	.	C	A	6	8	14	1	0	15	0	0
12	46738325	.	T	G	5	1	6	0	9	15	0	0
12	46738363	.	G	A	2	5	7	0	0	7	0	0
12	46821411	.	C	T	3	2	5	0	0	5	0	0
12	46821456	.	A	T	2	2	4	0	0	4	0	0
12	46848643	.	G	T	6	8	14	1	0	15	0	0
12	46852982	.	C	T	3	5	8	0	1	9	0	0
12	46852988	.	T	C	5	4	9	0	1	10	0	0
12	46855065	.	A	G	3	0	3	0	7	10	0	0
12	46855074	.	C	T	3	6	9	0	0	9	0	0
12	46867324	.	C	T	14	4	18	6	1	25	0	0
12	46872795	.	T	C	2	3	5	1	0	6	0	0
12	46872815	.	A	G	3	0	3	0	5	8	0	0
12	46915362	.	C	T	7	7	14	0	0	14	0	0
12	46915452	.	T	C	11	3	14	0	0	14	0	0
12	46930650	.	A	G	4	5	9	0	0	9	0	0
12	46937292	.	A	C	9	6	15	0	1	16	0	0
12	46937351	.	T	C	8	11	19	0	0	19	0	0
12	46937422	.	A	T	9	8	17	0	1	18	0	0
12	46937711	.	A	G	6	0	6	0	6	12	0	0
12	46937814	.	A	C	2	2	4	0	0	4	0	0
12	46953552	.	A	G	5	5	10	0	0	10	0	0
12	46953609	.	C	A	2	8	10	0	0	10	0	0
12	46956898	.	C	T	0	3	3	0	2	5	0	0
12	46956916	.	G	A	4	3	7	0	0	7	0	0
12	46956985	.	C	T	2	2	4	0	0	4	0	0
12	46959885	.	T	G	1	4	5	0	0	5	0	0
12	46959935	.	T	C	2	6	8	0	0	8	0	0
12	46967967	.	C	T	9	9	18	0	0	18	0	0
12	46969482	.	T	C	7	10	17	0	1	18	0	0
12	46969488	.	G	A	0	10	10	0	8	18	0	0
12	46969557	.	C	T	13	10	23	0	0	23	0	0
12	46969602	.	T	C	11	12	23	0	2	25	0	0
12	46975549	.	T	G	10	11	21	0	1	22	0	0
12	46976075	.	A	G	16	11	27	0	1	28	0	0
12	46985337	.	A	C	9	16	25	0	5	30	0	0
12	46985461	.	C	T	18	14	32	0	3	35	0	0
12	46985509	.	C	A	10	11	21	0	0	21	0	0
12	46985540	.	T	A	8	12	20	0	0	20	0	0
12	46985648	.	G	A	5	9	14	0	1	15	0	0
12	46985666	.	T	C	9	6	15	0	0	15	0	0
12	46985691	.	A	T	9	6	15	0	0	15	0	0
12	46985740	.	T	A	8	4	12	0	0	12	0	0
12	46985749	.	T	G	8	2	10	0	0	10	0	0
12	46985884	.	G	T	9	14	23	0	0	23	0	0
12	46985886	.	C	A	8	14	22	0	0	22	0	0
12	47044878	.	A	T	18	15	33	0	4	37	0	0
12	47044890	.	C	A	20	13	33	0	3	36	0	0
12	47044920	.	G	A	1	13	14	0	12	26	0	0
12	47044952	.	G	A	11	10	21	0	3	24	0	0
12	47051363	.	A	G	7	20	27	0	3	30	0	0
12	47051481	.	C	T	13	19	32	0	0	32	0	0
12	47055396	.	T	A	18	19	37	0	5	42	0	0
12	47055513	.	T	C	21	14	35	0	0	35	0	0
12	47055546	.	C	T	14	17	31	0	0	31	0	0
12	47062488	.	C	T	15	14	29	0	1	30	0	0
12	47062513	.	C	A	16	13	29	0	2	31	0	0
12	47062548	.	T	C	15	13	28	0	2	30	0	0
12	47064466	.	G	A	8	17	25	0	0	25	0	0
12	47064654	.	C	T	17	12	29	0	0	29	0	0
12	47064657	.	G	C	17	12	29	0	1	30	0	0
12	47064864	.	G	T	12	15	27	0	0	27	0	0
12	47064888	.	G	A	15	16	31	1	0	32	0	0
12	47068624	.	C	T	16	14	30	0	1	31	0	0
12	47068720	.	C	A	14	11	25	0	1	26	0	0
12	47099646	.	G	T	1	3	4	0	0	4	0	0
12	47100378	.	G	A	0	2	2	0	2	4	0	0
12	47100471	.	T	C	3	4	7	0	0	7	0	0
12	47102770	.	T	C	1	3	4	0	1	5	0	0
12	47109480	.	C	T	2	3	5	0	0	5	0	0
12	47199750	.	C	G	5	5	10	0	0	10	0	0
12	47210442	.	C	G	4	4	8	0	0	8	0	0
12	47210460	.	A	G	3	0	3	0	4	7	0	0
12	47218060	.	C	G	2	2	4	0	0	4	0	0
12	47218066	.	G	T	0	1	1	0	3	4	0	0
12	47218252	.	G	A	5	2	7	0	0	7	0	0
12	47225058	.	C	T	3	6	9	0	0	9	0	0
12	47233215	.	C	A	6	6	12	0	0	12	0	0
12	47233520	.	T	A	4	2	6	0	0	6	0	0
12	47241639	.	T	C	4	11	15	0	0	15	0	0
12	47247816	.	C	T	14	7	21	0	1	22	0	0
12	47247858	.	C	T	9	7	16	0	3	19	0	0
12	47248184	.	G	A	0	2	2	0	3	5	0	0
12	47251230	.	T	C	4	4	8	0	0	8	0	0
12	47251242	.	C	T	4	4	8	0	0	8	0	0
12	47255257	.	T	C	3	5	8	0	0	8	0	0
12	47255278	.	C	T	0	8	8	0	0	8	0	0
12	47257184	.	G	C	5	9	14	0	0	14	0	0
12	47258306	.	G	C	0	6	6	0	9	15	0	0
12	47262385	.	A	T	2	5	7	0	0	7	0	0
12	47262817	.	C	T	3	8	11	0	1	12	0	0
12	47263246	.	C	T	7	4	11	0	0	11	0	0
12	47263258	.	G	C	1	8	9	0	5	14	0	0
12	47267408	.	C	T	5	9	14	0	0	14	0	0
12	47270288	.	C	T	5	9	14	0	1	15	0	0
12	47275118	.	T	A	15	8	23	0	0	23	0	0
12	47275326	.	C	G	12	7	19	0	0	19	0	0
12	47276192	.	C	T	4	10	14	0	1	15	0	0
12	47282131	.	G	A	3	10	13	0	10	23	0	0
12	47282137	.	G	A	11	10	21	0	2	23	0	0
12	47283506	.	C	T	12	4	16	0	0	16	0	0
12	47283514	.	A	G	12	3	15	0	2	17	0	0
12	47283544	.	G	C	9	7	16	0	2	18	0	0
12	47291529	.	G	C	1	12	13	0	11	24	0	0
12	47291685	.	G	A	13	15	28	0	1	29	0	0
12	47296608	.	T	A	14	19	33	0	0	33	0	0
12	47302810	.	G	A	9	13	22	0	2	24	0	0
12	47641659	.	C	T	0	6	6	10	13	29	0	0
12	47644855	.	C	A	3	4	7	22	0	29	0	0
12	47645851	.	G	A	18	14	32	0	0	32	0	0
12	47646485	.	G	A	10	11	21	0	0	21	0	0
12	47724434	.	G	A	1	3	4	0	0	4	0	0
12	47782583	.	G	A	2	2	4	0	0	4	0	0
12	47807469	.	C	T	3	2	5	0	0	5	0	0
12	47808289	.	C	A	2	3	5	0	0	5	0	0
12	47816586	.	C	A	1	1	2	0	1	3	0	0
12	47816654	.	C	T	2	3	5	0	0	5	0	0
12	47830328	.	T	C	5	5	10	0	0	10	0	0
12	47835355	.	G	A	0	2	2	0	3	5	0	0
12	47838894	.	G	A	1	3	4	0	0	4	0	0
12	47842232	.	T	C	7	5	12	0	0	12	0	0
12	47847414	.	G	C	2	2	4	0	0	4	0	0
12	47847543	.	C	T	1	3	4	0	0	4	0	0
12	47847892	.	G	A	1	2	3	0	0	3	0	0
12	47857113	.	C	T	8	3	11	0	0	11	0	0
12	47857125	.	T	C	5	3	8	0	1	9	0	0
12	47860342	.	T	C	5	4	9	0	1	10	0	0
12	47860351	.	C	T	5	5	10	0	1	11	0	0
12	47862044	.	G	A	4	4	8	0	2	10	0	0
12	47862172	.	G	C	2	2	4	0	0	4	0	0
12	47862195	.	T	A	1	1	2	0	1	3	0	0
12	47918804	.	G	A	1	3	4	0	0	4	0	0
12	47919665	.	C	T	3	7	10	0	1	11	0	0
12	47925952	.	A	G	3	1	4	0	4	8	0	0
12	47967906	.	C	A	1	2	3	0	0	3	0	0
12	48094293	.	G	T	9	10	19	0	0	19	0	0
12	48094308	.	G	A	10	8	18	0	0	18	0	0
12	48094399	.	A	T	7	5	12	0	1	13	0	0
12	48118581	.	T	C	1	3	4	0	0	4	0	0
12	48118598	.	A	T	1	4	5	0	0	5	0	0
12	48119048	.	G	A	4	2	6	0	0	6	0	0
12	48119153	.	T	G	5	4	9	0	0	9	0	0
12	48119934	.	C	T	3	3	6	0	0	6	0	0
12	48119941	.	A	G	3	3	6	0	0	6	0	0
12	48122106	.	C	G	0	2	2	0	2	4	0	0
12	48122232	.	C	T	3	3	6	0	0	6	0	0
12	48133239	.	G	A	9	7	16	0	1	17	0	0
12	48137949	.	G	A	9	6	15	0	0	15	0	0
12	48138307	.	A	G	5	7	12	0	0	12	0	0
12	48139236	.	G	A	5	7	12	0	2	14	0	0
12	48143336	.	G	A	6	7	13	0	2	15	0	0
12	48143427	.	C	T	6	5	11	0	2	13	0	0
12	48146371	.	C	T	0	4	4	0	0	4	0	0
12	48146395	.	G	T	3	3	6	0	0	6	0	0
12	48157055	.	C	T	0	5	5	0	1	6	0	0
12	48157135	.	G	A	8	4	12	0	0	12	0	0
12	48161625	.	C	T	3	5	8	0	0	8	0	0
12	48162237	.	G	A	3	6	9	0	0	9	0	0
12	48162291	.	T	A	5	2	7	0	0	7	0	0
12	48168094	.	G	A	5	3	8	0	0	8	0	0
12	48198910	.	G	T	6	8	14	0	0	14	0	0
12	48211403	.	C	G	1	2	3	0	0	3	0	0
12	48216789	.	A	T	7	3	10	0	1	11	0	0
12	48220624	.	C	G	4	12	16	0	1	17	0	0
12	48228265	.	A	C	6	8	14	0	0	14	0	0
12	48231108	.	G	T	7	6	13	0	1	14	0	0
12	48312526	.	G	A	2	3	5	0	1	6	0	0
12	48319235	.	A	T	14	5	19	0	0	19	0	0
12	48327550	.	T	G	14	7	21	0	0	21	0	0
12	48340578	.	G	A	17	14	31	0	3	34	0	0
12	48341936	.	G	A	1	11	12	0	18	30	0	0
12	48346807	.	C	T	2	10	12	0	0	12	0	0
12	48349836	.	C	T	3	14	17	0	10	27	0	0
12	48367360	.	C	T	1	8	9	0	19	28	0	0
12	48367442	.	T	G	11	14	25	0	0	25	0	0
12	48401980	.	G	T	4	3	7	0	0	7	0	0
12	48419228	.	T	A	8	3	11	0	0	11	0	0
12	48419234	.	T	A	7	3	10	0	0	10	0	0
12	48419359	.	T	G	5	6	11	0	0	11	0	0
12	48419420	.	A	G	5	5	10	0	0	10	0	0
12	48419568	.	T	G	3	3	6	0	0	6	0	0
12	48419579	.	A	T	2	2	4	0	0	4	0	0
12	48419645	.	A	C	3	2	5	0	1	6	0	0
12	48419683	.	A	T	3	3	6	0	0	6	0	0
12	48419704	.	G	A	1	2	3	0	0	3	0	0
12	48419805	.	C	T	3	5	8	0	1	9	0	0
12	48419867	.	C	T	0	3	3	0	4	7	0	0
12	48419921	.	T	C	3	2	5	0	0	5	0	0
12	48419936	.	T	C	3	0	3	0	4	7	0	0
12	48420640	.	A	G	4	9	13	0	0	13	0	0
12	48432078	.	C	T	0	15	15	0	5	20	0	0
12	48432126	.	A	G	4	9	13	0	3	16	0	0
12	48432716	.	G	T	8	7	15	0	1	16	0	0
12	48440345	.	A	G	2	4	6	0	0	6	0	0
12	48512050	.	G	T	4	5	9	0	0	9	0	0
12	48519898	.	C	G	7	2	9	0	0	9	0	0
12	48519899	.	T	C	7	1	8	0	1	9	0	0
12	48674880	.	T	A	1	5	6	0	1	7	0	0
12	48678396	.	G	A	1	7	8	0	11	19	0	0
12	48680163	.	A	T	8	4	12	0	2	14	0	0
12	48681658	.	T	C	9	8	17	0	0	17	0	0
12	48681663	.	G	A	1	9	10	0	8	18	0	0
12	48681708	.	C	T	10	11	21	0	1	22	0	0
12	48681826	.	A	T	5	12	17	0	0	17	0	0
12	48681827	.	T	A	5	10	15	0	2	17	0	0
12	48681942	.	A	T	9	5	14	0	0	14	0	0
12	48682228	.	G	T	0	4	4	0	6	10	0	0
12	48682419	.	A	G	5	7	12	0	1	13	0	0
12	48682629	.	T	G	7	6	13	0	0	13	0	0
12	48789831	.	C	T	1	3	4	0	0	4	0	0
12	48790891	.	G	A	0	2	2	0	3	5	0	0
12	48794578	.	T	C	2	3	5	0	0	5	0	0
12	48796831	.	C	T	2	7	9	0	0	9	0	0
12	48810338	.	C	T	16	16	32	0	1	33	0	0
12	48810690	.	C	T	11	5	16	0	0	16	0	0
12	48810879	.	C	T	5	7	12	0	0	12	0	0
12	48810960	.	G	A	0	3	3	0	12	15	0	0
12	48816218	.	A	G	10	0	10	0	12	22	0	0
12	48826364	.	C	T	10	19	29	0	0	29	0	0
12	48828350	.	C	T	6	5	11	0	1	12	0	0
12	48828356	.	C	G	7	6	13	0	0	13	0	0
12	48828461	.	C	T	8	10	18	0	0	18	0	0
12	48830367	.	T	G	9	0	9	0	10	19	0	0
12	48832417	.	C	A	9	5	14	0	1	15	0	0
12	48833090	.	T	C	18	12	30	0	3	33	0	0
12	48833165	.	C	T	12	16	28	0	0	28	0	0
12	48835113	.	C	T	7	19	26	0	1	27	0	0
12	48836141	.	T	C	14	17	31	0	0	31	0	0
12	48836348	.	A	G	6	15	21	0	1	22	0	0
12	48836482	.	G	A	13	17	30	0	1	31	0	0
12	48836576	.	A	G	8	0	8	0	10	18	0	0
12	48836627	.	T	C	5	7	12	0	0	12	0	0
12	49158090	.	T	C	11	0	11	0	12	23	0	0
12	49158104	.	T	C	14	4	18	0	1	19	0	0
13	343567	.	G	T	2	8	10	0	0	10	0	0
13	343581	.	C	G	0	5	5	1	4	10	0	0
13	808361	.	A	G	5	4	9	0	0	9	0	0
13	809305	.	A	G	5	2	7	0	1	8	0	0
13	2427331	.	T	C	3	9	12	0	0	12	0	0
13	2427537	.	T	C	11	6	17	0	0	17	0	0
13	2981378	.	T	A	4	4	8	0	1	9	0	0
13	3109224	.	T	C	1	5	6	0	0	6	0	0
13	3127930	.	G	A	4	6	10	0	0	10	0	0
13	3128038	.	T	C	10	0	10	0	4	14	0	0
13	3154901	.	T	A	5	6	11	0	0	11	0	0
13	3154904	.	A	G	5	6	11	0	0	11	0	0
13	3154956	.	G	C	4	4	8	0	0	8	0	0
13	3155005	.	C	T	5	6	11	0	0	11	0	0
13	3264323	.	C	A	7	3	10	0	2	12	0	0
13	3264406	.	C	T	4	2	6	0	0	6	0	0
13	3269340	.	G	A	11	14	25	0	1	26	0	0
13	3270123	.	A	G	12	6	18	0	0	18	0	0
13	3272706	.	C	A	1	4	5	0	5	10	0	0
13	3275094	.	T	C	5	0	5	0	4	9	0	0
13	3277401	.	G	A	2	4	6	0	0	6	0	0
13	3277423	.	G	C	1	3	4	0	0	4	0	0
13	3279525	.	A	G	2	3	5	0	2	7	0	0
13	3279588	.	C	T	1	3	4	0	1	5	0	0
13	3282127	.	T	C	10	12	22	0	0	22	0	0
13	3283761	.	A	G	5	2	7	0	0	7	0	0
13	3284747	.	G	A	8	2	10	0	0	10	0	0
13	3287268	.	C	A	5	4	9	0	0	9	0	0
13	3291953	.	G	A	1	5	6	0	0	6	0	0
13	3299514	.	C	G	7	5	12	0	0	12	0	0
13	3299562	.	G	A	4	7	11	0	1	12	0	0
13	3313102	.	G	A	2	4	6	0	0	6	0	0
13	3357683	.	C	T	0	4	4	0	1	5	0	0
13	3369252	.	T	C	4	4	8	0	0	8	0	0
13	3370583	.	T	C	1	4	5	0	0	5	0	0
13	3370596	.	T	C	1	0	1	0	5	6	0	0
13	3874618	.	T	C	8	5	13	0	0	13	0	0
13	3874815	.	T	C	7	0	7	0	7	14	0	0
13	3874831	.	T	C	11	6	17	0	0	17	0	0
13	3874903	.	C	A	2	6	8	0	6	14	0	0
13	3874909	.	G	A	6	7	13	0	0	13	0	0
13	3874983	.	A	G	6	3	9	0	1	10	0	0
13	3875113	.	C	G	4	3	7	0	1	8	0	0
13	3881152	.	T	G	1	6	7	0	0	7	0	0
13	3881204	.	T	C	6	4	10	1	0	11	0	0
13	3881208	.	G	T	6	4	10	1	0	11	0	0
13	3881269	.	C	G	5	6	11	1	2	14	0	0
13	3885350	.	A	C	3	10	13	1	2	16	0	0
13	3885359	.	G	T	5	13	18	1	0	19	0	0
13	3916150	.	A	G	15	16	31	0	1	32	0	0
13	3916198	.	A	G	16	11	27	0	1	28	0	0
13	3916377	.	G	A	14	13	27	0	1	28	0	0
13	3919020	.	T	C	19	1	20	0	22	42	0	0
13	3919057	.	A	C	21	21	42	0	3	45	0	0
13	3919136	.	A	T	16	16	32	0	3	35	0	0
13	3919167	.	A	G	14	13	27	0	3	30	0	0
13	3919555	.	T	C	16	12	28	0	0	28	0	0
13	3919632	.	A	G	18	9	27	0	1	28	0	0
13	3919672	.	T	G	17	11	28	0	0	28	0	0
13	3919686	.	G	A	19	10	29	0	0	29	0	0
13	3920759	.	C	T	1	11	12	0	11	23	0	0
13	3922791	.	T	C	15	12	27	0	1	28	0	0
13	3942055	.	G	A	1	12	13	0	12	25	0	0
13	3945643	.	C	T	20	12	32	0	0	32	0	0
13	3950007	.	G	A	11	11	22	0	0	22	0	0
13	3950044	.	A	G	15	11	26	0	0	26	0	0
13	3950307	.	A	G	8	12	20	0	0	20	0	0
13	3950577	.	C	G	12	11	23	0	0	23	0	0
13	3950669	.	T	A	2	7	9	0	0	9	0	0
13	3954695	.	G	T	7	3	10	0	0	10	0	0
13	3958895	.	C	T	14	4	18	1	2	21	0	0
13	3960979	.	A	C	6	5	11	0	0	11	0	0
13	3962569	.	C	T	3	2	5	0	0	5	0	0
13	3965910	.	T	C	10	5	15	0	1	16	0	0
13	3966055	.	T	A	6	5	11	0	1	12	0	0
13	3980164	.	C	T	2	3	5	0	0	5	0	0
13	3980349	.	C	T	1	6	7	0	9	16	0	0
13	3980947	.	T	C	8	0	8	0	13	21	0	0
13	3980962	.	G	A	8	12	20	0	0	20	0	0
13	3980993	.	C	T	1	6	7	0	11	18	0	0
13	3981579	.	G	T	4	5	9	0	0	9	0	0
13	3982429	.	A	G	1	3	4	0	0	4	0	0
13	3982679	.	A	G	5	6	11	0	0	11	0	0
13	3983250	.	A	G	1	4	5	0	0	5	0	0
13	3983754	.	A	C	3	0	3	0	2	5	0	0
13	3983760	.	G	A	3	2	5	0	1	6	0	0
13	4000601	.	G	A	1	2	3	0	0	3	0	0
13	4018624	.	A	T	1	2	3	0	0	3	0	0
13	4205733	.	C	T	2	2	4	0	1	5	0	0
13	4213291	.	A	C	4	5	9	0	0	9	0	0
13	4213300	.	C	T	9	3	12	0	1	13	0	0
13	4213477	.	C	A	3	11	14	0	0	14	0	0
13	4213594	.	G	T	5	5	10	0	2	12	0	0
13	4213598	.	C	T	8	5	13	0	1	14	0	0
13	4213861	.	T	C	9	17	26	0	1	27	0	0
13	4226678	.	C	A	15	13	28	0	1	29	0	0
13	4231368	.	G	T	3	17	20	0	19	39	0	0
13	4231396	.	C	T	18	17	35	0	1	36	0	0
13	4231438	.	T	A	12	13	25	0	2	27	0	0
13	4231787	.	A	G	5	13	18	0	3	21	0	0
13	4231819	.	G	A	13	9	22	0	2	24	0	0
13	4232112	.	A	G	18	7	25	0	0	25	0	0
13	4232171	.	C	T	15	19	34	0	1	35	0	0
13	4232737	.	A	G	14	10	24	0	1	25	0	0
13	4233030	.	C	T	0	19	19	0	13	32	0	0
13	4233033	.	G	A	21	10	31	0	0	31	0	0
13	4233361	.	G	T	15	10	25	0	0	25	0	0
13	4233365	.	G	A	9	15	24	0	1	25	0	0
13	4233625	.	T	A	14	8	22	0	1	23	0	0
13	4233779	.	G	A	19	12	31	0	1	32	0	0
13	4233889	.	G	A	3	9	12	0	1	13	0	0
13	4233911	.	G	C	6	12	18	0	0	18	0	0
13	4233970	.	A	G	11	12	23	0	0	23	0	0
13	4234139	.	A	T	14	6	20	1	0	21	0	0
13	4234337	.	G	A	12	8	20	0	0	20	0	0
13	4234349	.	G	T	10	8	18	0	1	19	0	0
13	4234402	.	A	T	9	8	17	0	1	18	0	0
13	4238449	.	T	C	12	8	20	0	1	21	0	0
13	4247007	.	G	A	12	5	17	0	0	17	0	0
13	4249120	.	T	C	7	4	11	0	1	12	0	0
13	4256617	.	A	G	10	9	19	0	1	20	0	0
13	4302690	.	A	T	8	10	18	0	0	18	0	0
13	4307782	.	C	T	14	6	20	0	0	20	0	0
13	4308714	.	C	A	14	13	27	0	0	27	0	0
13	4308948	.	C	T	13	11	24	0	2	26	0	0
13	4308983	.	G	C	9	0	9	0	16	25	0	0
13	4309166	.	T	G	19	10	29	0	1	30	0	0
13	4309607	.	T	C	14	9	23	0	1	24	0	0
13	4309746	.	A	G	7	11	18	0	0	18	0	0
13	4309778	.	T	A	9	7	16	0	0	16	0	0
13	4309866	.	T	C	7	8	15	0	0	15	0	0
13	4310247	.	G	A	11	13	24	0	1	25	0	0
13	4310349	.	T	A	19	12	31	0	4	35	0	0
13	4310367	.	C	G	2	14	16	0	21	37	0	0
13	4310511	.	C	T	0	11	11	0	25	36	0	0
13	4310565	.	G	A	28	15	43	0	0	43	0	0
13	4310610	.	C	T	24	16	40	0	2	42	0	0
13	4310976	.	T	C	5	0	5	0	6	11	0	0
13	4311114	.	A	G	15	5	20	0	0	20	0	0
13	4311912	.	C	T	12	14	26	0	0	26	0	0
13	4314226	.	T	G	7	6	13	0	0	13	0	0
13	4314227	.	C	T	7	6	13	0	0	13	0	0
13	4317721	.	T	C	6	8	14	0	0	14	0	0
13	4320781	.	G	C	5	3	8	0	0	8	0	0
13	4325371	.	T	C	8	9	17	0	1	18	0	0
13	4325443	.	C	G	10	9	19	0	0	19	0	0
13	4330240	.	G	A	4	4	8	0	0	8	0	0
13	4332807	.	G	A	6	2	8	0	0	8	0	0
13	4332851	.	T	G	2	2	4	0	1	5	0	0
13	4333087	.	T	G	7	8	15	0	1	16	0	0
13	4339139	.	A	C	5	3	8	0	0	8	0	0
13	4339638	.	T	C	12	0	12	0	11	23	0	0
13	4343183	.	C	T	1	6	7	0	4	11	0	0
13	4343437	.	C	T	1	8	9	0	8	17	0	0
13	4343468	.	T	A	9	10	19	0	1	20	0	0
13	4343490	.	G	A	12	9	21	0	0	21	0	0
13	4344100	.	C	G	5	4	9	0	0	9	0	0
13	4344378	.	A	T	9	7	16	0	2	18	0	0
13	4344800	.	T	C	8	12	20	0	1	21	0	0
13	4344872	.	G	C	12	4	16	0	0	16	0	0
13	4344938	.	T	C	6	8	14	0	1	15	0	0
13	4347474	.	T	G	4	3	7	0	1	8	0	0
13	4347531	.	T	C	6	4	10	0	0	10	0	0
13	4349830	.	G	T	2	2	4	0	1	5	0	0
13	4354457	.	A	G	5	3	8	0	0	8	0	0
13	4354596	.	T	A	1	4	5	0	0	5	0	0
13	4354649	.	T	C	1	0	1	0	4	5	0	0
13	4361847	.	A	G	4	2	6	0	0	6	0	0
13	4364700	.	C	T	2	4	6	0	0	6	0	0
13	4364916	.	A	G	2	6	8	0	0	8	0	0
13	4366180	.	C	A	3	3	6	0	0	6	0	0
13	4366741	.	G	T	3	4	7	0	0	7	0	0
13	4366805	.	T	C	2	2	4	0	1	5	0	0
13	4399345	.	A	G	1	4	5	0	0	5	0	0
13	4589992	.	A	G	2	0	2	0	5	7	0	0
13	4602243	.	G	A	2	8	10	0	0	10	0	0
13	4606072	.	T	A	4	4	8	0	1	9	0	0
13	4608482	.	C	T	6	5	11	0	0	11	0	0
13	4615130	.	G	T	3	7	10	0	1	11	0	0
13	4615169	.	T	C	6	6	12	0	0	12	0	0
13	4714017	.	C	A	2	6	8	0	0	8	0	0
13	4951747	.	T	C	16	11	27	0	0	27	0	0
13	4956118	.	G	A	17	9	26	0	2	28	0	0
13	4956151	.	C	T	20	10	30	0	1	31	0	0
13	4968421	.	A	G	21	9	30	0	2	32	0	0
13	4968583	.	T	A	11	8	19	0	0	19	0	0
13	4968849	.	A	G	18	9	27	0	1	28	0	0
13	4968890	.	T	C	16	12	28	0	1	29	0	0
13	4968905	.	T	C	16	10	26	0	2	28	0	0
13	4973701	.	T	A	9	4	13	1	1	15	0	0
13	4973775	.	C	A	7	9	16	0	0	16	0	0
13	4973856	.	C	T	0	7	7	0	12	19	0	0
13	4973979	.	A	G	1	4	5	0	0	5	0	0
13	4977950	.	C	T	0	8	8	0	19	27	0	0
13	4977962	.	A	G	14	10	24	0	2	26	0	0
13	4978620	.	G	A	12	8	20	0	0	20	0	0
13	4978680	.	A	G	13	11	24	0	3	27	0	0
13	4978821	.	T	C	17	0	17	0	14	31	0	0
13	4979150	.	C	T	9	9	18	0	1	19	0	0
13	4979163	.	A	T	8	7	15	0	2	17	0	0
13	4979190	.	T	C	10	6	16	0	2	18	0	0
13	4979550	.	A	G	13	10	23	0	1	24	0	0
13	4979754	.	A	G	7	13	20	0	0	20	0	0
13	4982091	.	C	T	0	3	3	0	7	10	0	0
13	4982199	.	T	C	9	9	18	0	0	18	0	0
13	4982217	.	A	C	11	0	11	0	9	20	0	0
13	4982336	.	T	C	6	6	12	0	0	12	0	0
13	4984377	.	T	G	5	7	12	0	0	12	0	0
13	4984464	.	G	A	6	4	10	0	1	11	0	0
13	4986095	.	A	G	6	3	9	0	0	9	0	0
13	4986110	.	G	A	6	4	10	0	1	11	0	0
13	4986361	.	C	T	6	5	11	0	0	11	0	0
13	4986386	.	A	G	4	4	8	0	0	8	0	0
13	4987706	.	T	C	5	0	5	0	3	8	0	0
13	4992374	.	C	G	1	2	3	0	1	4	0	0
13	4995638	.	G	T	1	9	10	0	19	29	0	0
13	4995902	.	A	G	15	12	27	0	0	27	0	0
13	4995916	.	T	A	12	9	21	0	1	22	0	0
13	5000490	.	G	A	2	12	14	0	8	22	0	0
13	5000606	.	G	A	4	7	11	0	2	13	0	0
13	5000615	.	T	A	2	7	9	0	0	9	0	0
13	5013813	.	T	C	22	22	44	0	1	45	0	0
13	5013999	.	A	G	24	19	43	1	1	45	0	0
13	5017657	.	A	G	23	24	47	0	0	47	0	0
13	5017699	.	G	A	27	25	52	0	3	55	0	0
13	5017866	.	T	C	21	26	47	0	2	49	0	0
13	5251175	.	G	T	3	4	7	0	1	8	0	0
13	5257291	.	A	G	1	2	3	0	1	4	0	0
13	5491234	.	G	A	31	22	53	0	3	56	0	0
13	5531709	.	A	G	28	21	49	0	1	50	0	0
13	5568993	.	G	A	11	14	25	0	1	26	0	0
13	5569344	.	C	T	7	4	11	0	1	12	0	0
13	5572367	.	C	T	0	2	2	0	1	3	0	0
13	5871084	.	C	A	4	4	8	0	2	10	0	0
13	5871145	.	C	G	8	5	13	0	0	13	0	0
13	5871196	.	T	C	5	3	8	0	0	8	0	0
13	5871211	.	A	G	6	2	8	0	0	8	0	0
13	5871271	.	C	A	2	3	5	0	8	13	0	0
13	5871281	.	A	T	8	3	11	0	1	12	0	0
13	5871377	.	G	A	9	3	12	0	0	12	0	0
13	5871538	.	A	G	4	5	9	0	0	9	0	0
13	5871834	.	C	T	0	3	3	0	3	6	0	0
13	5872027	.	G	A	6	2	8	0	0	8	0	0
13	5872126	.	G	A	2	4	6	0	0	6	0	0
13	5872300	.	G	A	4	3	7	0	0	7	0	0
13	5872354	.	T	C	3	5	8	0	0	8	0	0
13	5872355	.	T	C	2	0	2	0	6	8	0	0
13	5872596	.	G	C	9	13	22	0	1	23	0	0
13	5872704	.	A	G	10	12	22	0	0	22	0	0
13	5872717	.	A	G	12	11	23	0	0	23	0	0
13	5936742	.	A	T	1	2	3	0	1	4	0	0
13	5936945	.	T	G	8	4	12	0	2	14	0	0
13	5953766	.	G	C	4	3	7	0	0	7	0	0
13	5974373	.	C	G	6	12	18	0	0	18	0	0
13	5978865	.	T	C	14	5	19	0	0	19	0	0
13	5978871	.	A	G	13	0	13	0	7	20	0	0
13	5979677	.	C	T	7	8	15	0	1	16	0	0
13	5985772	.	A	G	8	3	11	0	0	11	0	0
13	5987702	.	T	C	16	11	27	0	1	28	0	0
13	5987712	.	A	G	17	7	24	0	1	25	0	0
13	5988145	.	A	G	4	6	10	0	1	11	0	0
13	6089983	.	A	G	1	0	1	0	1	2	0	0
13	6089989	.	C	A	1	2	3	0	0	3	0	0
13	6091985	.	T	C	1	4	5	0	0	5	0	0
13	6092064	.	G	A	5	1	6	0	1	7	0	0
13	6092065	.	A	C	5	2	7	0	1	8	0	0
13	6095996	.	A	C	2	3	5	0	0	5	0	0
13	6099153	.	G	C	1	5	6	0	0	6	0	0
13	6099644	.	G	T	5	3	8	0	0	8	0	0
13	6270984	.	C	T	0	5	5	0	1	6	0	0
13	7049405	.	T	C	4	2	6	0	0	6	0	0
13	7050772	.	G	C	4	2	6	0	0	6	0	0
13	7054454	.	G	A	2	4	6	0	1	7	0	0
13	7061380	.	C	T	2	6	8	0	0	8	0	0
13	7061413	.	G	A	3	8	11	0	0	11	0	0
13	7061687	.	G	A	0	2	2	0	3	5	0	0
13	7062882	.	C	T	6	3	9	0	0	9	0	0
13	7062883	.	T	A	6	3	9	0	0	9	0	0
13	7062945	.	A	T	6	5	11	0	0	11	0	0
13	7063446	.	T	C	3	3	6	0	0	6	0	0
13	7063494	.	G	T	0	4	4	0	6	10	0	0
13	7063602	.	C	G	12	7	19	0	0	19	0	0
13	7063708	.	T	A	5	4	9	0	0	9	0	0
13	7063709	.	G	A	5	4	9	0	0	9	0	0
13	7107142	.	T	G	2	2	4	0	0	4	0	0
13	7130882	.	G	A	0	4	4	0	6	10	0	0
13	7144754	.	G	A	6	2	8	0	0	8	0	0
13	7156984	.	A	G	1	0	1	0	4	5	0	0
13	7156987	.	A	G	2	0	2	0	4	6	0	0
13	7179763	.	C	T	0	3	3	0	3	6	0	0
13	7241234	.	A	C	6	8	14	0	0	14	0	0
13	7243397	.	T	C	4	8	12	0	0	12	0	0
13	7243431	.	A	G	5	8	13	0	0	13	0	0
13	7243445	.	T	G	6	0	6	0	9	15	0	0
13	7243484	.	C	T	10	9	19	0	0	19	0	0
13	7243610	.	C	G	9	0	9	0	7	16	0	0
13	7258946	.	T	C	2	7	9	0	0	9	0	0
13	7302819	.	G	A	0	2	2	0	1	3	0	0
13	7305556	.	C	T	4	7	11	0	1	12	0	0
13	7305802	.	G	A	0	4	4	0	3	7	0	0
13	7305985	.	C	G	1	2	3	0	0	3	0	0
13	7306144	.	T	A	4	5	9	0	0	9	0	0
13	7307082	.	A	G	3	6	9	0	0	9	0	0
13	7307087	.	T	C	3	6	9	0	0	9	0	0
13	7307382	.	A	C	3	2	5	0	0	5	0	0
13	7307949	.	T	C	3	2	5	0	0	5	0	0
13	7307954	.	T	A	3	2	5	0	0	5	0	0
13	7308279	.	T	C	0	5	5	0	0	5	0	0
13	7308285	.	T	C	2	4	6	0	0	6	0	0
13	7308855	.	C	T	1	2	3	0	0	3	0	0
13	7308947	.	A	T	7	2	9	0	0	9	0	0
13	7309073	.	C	T	4	4	8	0	0	8	0	0
13	7309140	.	T	C	2	6	8	0	0	8	0	0
13	7309392	.	C	T	2	3	5	0	1	6	0	0
13	7309507	.	A	T	5	4	9	0	0	9	0	0
13	7310288	.	A	G	13	7	20	0	1	21	0	0
13	7310386	.	C	A	5	2	7	0	0	7	0	0
13	7311324	.	T	G	5	2	7	0	1	8	0	0
13	7311327	.	A	C	2	5	7	0	1	8	0	0
13	7312170	.	C	T	7	12	19	0	1	20	0	0
13	7312323	.	A	T	0	6	6	0	0	6	0	0
13	7312325	.	G	A	2	5	7	0	0	7	0	0
13	7312527	.	G	A	1	6	7	0	13	20	0	0
13	7312931	.	A	G	7	9	16	0	0	16	0	0
13	7313324	.	T	A	9	6	15	0	2	17	0	0
13	7313436	.	T	C	7	9	16	0	0	16	0	0
13	7313443	.	A	T	9	6	15	0	1	16	0	0
13	7313613	.	C	T	9	7	16	0	1	17	0	0
13	7313703	.	C	T	11	17	28	0	0	28	0	0
13	7313898	.	C	T	15	8	23	0	2	25	0	0
13	7314451	.	A	G	9	0	9	0	11	20	0	0
13	7314509	.	C	T	11	7	18	0	0	18	0	0
13	7314736	.	A	C	13	21	34	0	2	36	0	0
13	7314859	.	C	A	14	11	25	0	0	25	0	0
13	7315123	.	C	T	20	15	35	0	1	36	0	0
13	7315174	.	C	A	14	19	33	0	0	33	0	0
13	7315197	.	A	G	16	1	17	0	18	35	0	0
13	7315234	.	A	G	20	18	38	0	1	39	0	0
13	7316463	.	G	A	5	10	15	0	0	15	0	0
13	7316603	.	A	T	17	7	24	0	1	25	0	0
13	7316746	.	A	G	9	0	9	0	8	17	0	0
13	7316784	.	G	A	9	5	14	0	0	14	0	0
13	7316830	.	C	G	11	9	20	1	0	21	0	0
13	7316849	.	A	T	10	6	16	1	0	17	0	0
13	7322456	.	T	A	2	7	9	0	1	10	0	0
13	7333342	.	G	T	14	12	26	0	1	27	0	0
13	7340207	.	A	T	2	4	6	0	0	6	0	0
13	7340264	.	C	G	6	2	8	0	0	8	0	0
13	7340289	.	A	C	8	2	10	0	0	10	0	0
13	7346655	.	C	A	14	6	20	1	0	21	0	0
13	7346683	.	A	G	16	12	28	1	0	29	0	0
13	7346798	.	A	G	19	12	31	0	0	31	0	0
13	7346965	.	A	G	14	6	20	0	1	21	0	0
13	7346966	.	A	T	15	6	21	0	0	21	0	0
13	7347026	.	A	G	8	8	16	0	1	17	0	0
13	7347060	.	G	T	8	9	17	0	0	17	0	0
13	7347061	.	A	T	8	9	17	0	0	17	0	0
13	7347125	.	G	A	2	8	10	0	1	11	0	0
13	7693681	.	C	T	2	5	7	0	0	7	0	0
13	7696509	.	C	T	2	4	6	0	0	6	0	0
13	7698480	.	C	T	2	4	6	0	0	6	0	0
13	7698498	.	C	T	3	2	5	0	0	5	0	0
13	7698537	.	T	C	4	4	8	0	0	8	0	0
13	7711335	.	G	T	3	2	5	0	1	6	0	0
13	7718477	.	C	T	1	4	5	0	0	5	0	0
13	7718784	.	C	T	3	4	7	0	0	7	0	0
13	7721511	.	C	T	2	4	6	0	0	6	0	0
13	7725965	.	C	T	8	5	13	0	1	14	0	0
13	7728958	.	C	T	5	3	8	0	0	8	0	0
13	7744319	.	A	G	6	6	12	0	0	12	0	0
13	7744443	.	G	A	11	7	18	0	3	21	0	0
13	7744624	.	T	G	13	21	34	0	0	34	0	0
13	7745259	.	C	G	10	4	14	0	9	23	0	0
13	7745463	.	C	G	5	5	10	0	3	13	0	0
13	7747513	.	C	G	6	6	12	0	0	12	0	0
13	7747760	.	T	C	3	13	16	0	1	17	0	0
13	7747831	.	T	G	12	8	20	0	0	20	0	0
13	7747963	.	G	A	3	2	5	0	1	6	0	0
13	7747964	.	A	G	2	2	4	0	2	6	0	0
13	7748021	.	G	T	7	5	12	0	0	12	0	0
13	7748164	.	A	G	3	0	3	0	8	11	0	0
13	7748218	.	T	C	5	14	19	0	0	19	0	0
13	7748424	.	T	C	6	8	14	4	0	18	0	0
13	7748497	.	T	G	5	6	11	0	1	12	0	0
13	7748533	.	T	G	8	10	18	0	0	18	0	0
13	7748882	.	A	T	10	7	17	0	0	17	0	0
13	7748995	.	T	A	3	11	14	0	2	16	0	0
13	7749000	.	G	C	2	12	14	0	2	16	0	0
13	7755764	.	A	C	17	0	17	0	28	45	0	0
13	7759403	.	T	C	26	25	51	0	1	52	0	0
13	7766936	.	C	T	4	12	16	0	19	35	0	0
13	7767013	.	C	T	3	2	5	0	0	5	0	0
13	8135212	.	A	G	2	2	4	0	0	4	0	0
13	8142558	.	A	G	4	4	8	0	0	8	0	0
13	8169139	.	T	A	1	3	4	0	0	4	0	0
13	8169143	.	G	A	1	2	3	0	0	3	0	0
13	8170795	.	A	G	1	2	3	0	0	3	0	0
13	8171986	.	A	G	2	2	4	0	0	4	0	0
13	8172002	.	G	A	2	2	4	0	0	4	0	0
13	8377334	.	A	G	1	11	12	0	0	12	0	0
13	8380555	.	T	C	2	3	5	0	0	5	0	0
13	8626503	.	G	A	9	3	12	0	0	12	0	0
13	8685228	.	G	C	1	4	5	0	1	6	0	0
13	8777998	.	A	G	20	17	37	0	5	42	0	0
13	9755583	.	G	A	1	6	7	0	0	7	0	0
13	9759133	.	G	T	1	3	4	0	0	4	0	0
13	9759700	.	G	T	0	5	5	0	1	6	0	0
13	9819251	.	T	A	8	3	11	0	0	11	0	0
13	9825710	.	T	A	2	3	5	0	1	6	0	0
13	9825852	.	G	A	4	3	7	0	1	8	0	0
13	9825882	.	G	A	0	3	3	0	9	12	0	0
13	9828780	.	G	A	6	9	15	0	3	18	0	0
13	9828849	.	G	A	3	8	11	0	0	11	0	0
13	9828933	.	G	T	9	7	16	0	1	17	0	0
13	9829007	.	A	G	3	2	5	0	0	5	0	0
13	9829013	.	C	T	2	2	4	0	0	4	0	0
13	9829245	.	G	A	2	3	5	0	0	5	0	0
13	9829274	.	C	A	4	2	6	0	0	6	0	0
13	9829361	.	G	T	5	5	10	0	0	10	0	0
13	9829855	.	C	T	6	5	11	0	0	11	0	0
13	9830066	.	A	T	8	5	13	0	0	13	0	0
13	9830089	.	T	C	4	10	14	0	1	15	0	0
13	9844440	.	G	A	18	19	37	0	0	37	0	0
13	9844527	.	A	G	22	0	22	0	12	34	0	0
13	9848385	.	G	A	24	17	41	0	2	43	0	0
13	9848577	.	A	G	25	24	49	0	3	52	0	0
13	9855508	.	G	T	8	10	18	0	3	21	0	0
13	9855874	.	G	A	10	19	29	0	0	29	0	0
13	9856319	.	A	G	13	12	25	0	1	26	0	0
13	9856427	.	A	G	16	11	27	0	1	28	0	0
13	9856493	.	A	T	16	25	41	0	1	42	0	0
13	9856658	.	A	G	29	15	44	0	0	44	0	0
13	9856993	.	T	A	4	10	14	0	2	16	0	0
13	9863888	.	G	A	11	11	22	0	1	23	0	0
13	9866911	.	A	G	8	3	11	0	1	12	0	0
13	9870586	.	G	T	3	8	11	0	0	11	0	0
13	9896848	.	C	T	2	3	5	0	0	5	0	0
13	9896850	.	C	T	2	3	5	0	0	5	0	0
13	9903744	.	G	T	2	1	3	0	2	5	0	0
13	9910623	.	G	A	1	1	2	0	1	3	0	0
13	10235120	.	A	G	1	0	1	0	3	4	0	0
13	10235142	.	T	A	1	3	4	0	0	4	0	0
13	10361660	.	G	A	2	2	4	0	0	4	0	0
13	10362407	.	A	T	1	3	4	0	0	4	0	0
13	10362422	.	A	G	1	3	4	0	0	4	0	0
13	10362715	.	G	A	2	2	4	0	0	4	0	0
13	10363084	.	A	G	1	2	3	0	0	3	0	0
13	10363418	.	A	G	4	2	6	0	0	6	0	0
13	10380372	.	A	G	1	1	2	0	1	3	0	0
13	12624860	.	C	T	8	9	17	0	1	18	0	0
13	12628901	.	C	T	11	11	22	0	1	23	0	0
13	12633376	.	T	A	5	1	6	0	1	7	0	0
13	12633387	.	C	A	3	2	5	0	0	5	0	0
13	12635770	.	C	T	3	3	6	0	1	7	0	0
13	12635858	.	T	A	3	3	6	1	0	7	0	0
13	12635862	.	C	A	4	2	6	1	0	7	0	0
13	12642077	.	C	A	1	3	4	0	0	4	0	0
13	12646682	.	A	T	1	2	3	0	0	3	0	0
13	12665227	.	C	A	5	3	8	0	1	9	0	0
13	12665411	.	T	A	3	2	5	0	0	5	0	0
13	12665595	.	T	C	7	3	10	0	1	11	0	0
13	12665749	.	C	T	6	3	9	0	1	10	0	0
13	12665761	.	T	C	3	5	8	0	0	8	0	0
13	12665859	.	A	T	3	2	5	0	0	5	0	0
13	12665990	.	C	A	6	4	10	0	1	11	0	0
13	12666017	.	T	C	7	0	7	0	5	12	0	0
13	12666038	.	G	A	7	7	14	0	0	14	0	0
13	12666182	.	C	T	8	3	11	0	0	11	0	0
13	12666183	.	G	A	3	7	10	0	0	10	0	0
13	12672495	.	A	T	2	2	4	0	0	4	0	0
13	12681386	.	A	T	2	3	5	0	0	5	0	0
13	12681700	.	T	C	1	0	1	0	1	2	0	0
13	12681716	.	T	C	0	4	4	0	0	4	0	0
13	12681777	.	G	C	1	3	4	0	0	4	0	0
13	12739359	.	A	T	1	5	6	1	0	7	0	0
13	12739444	.	G	T	4	7	11	0	0	11	0	0
13	12739894	.	T	A	12	5	17	0	0	17	0	0
13	12739939	.	C	T	6	5	11	0	0	11	0	0
13	12740092	.	G	T	0	9	9	0	8	17	0	0
13	12740113	.	A	T	7	8	15	0	1	16	0	0
13	12740129	.	C	T	6	7	13	0	0	13	0	0
13	12740236	.	A	G	8	9	17	0	3	20	0	0
13	12740971	.	T	G	15	12	27	0	0	27	0	0
13	12762350	.	G	A	3	6	9	0	0	9	0	0
13	12762486	.	T	G	2	4	6	0	0	6	0	0
13	12769323	.	T	C	4	5	9	0	0	9	0	0
13	12769359	.	A	G	6	1	7	0	3	10	0	0
13	12778091	.	C	T	5	2	7	0	0	7	0	0
13	12778142	.	T	C	1	6	7	0	0	7	0	0
13	12778247	.	T	G	1	4	5	0	1	6	0	0
13	12834047	.	G	A	2	2	4	0	0	4	0	0
13	12834071	.	G	A	1	4	5	0	2	7	0	0
13	12847609	.	C	T	3	4	7	0	0	7	0	0
13	12865979	.	A	T	1	2	3	0	0	3	0	0
13	12865992	.	A	G	1	0	1	0	1	2	0	0
13	12866276	.	G	A	5	4	9	0	0	9	0	0
13	12868435	.	G	A	0	4	4	0	5	9	0	0
13	12868492	.	A	G	4	2	6	0	0	6	0	0
13	12874147	.	C	T	4	4	8	0	0	8	0	0
13	12874309	.	A	T	5	5	10	0	1	11	0	0
13	12874972	.	G	A	2	6	8	0	0	8	0	0
13	12883529	.	G	A	0	2	2	0	4	6	0	0
13	12891860	.	A	G	1	6	7	0	2	9	0	0
13	12891881	.	A	G	3	6	9	0	1	10	0	0
13	12899310	.	G	C	7	7	14	0	0	14	0	0
13	12899356	.	C	T	5	5	10	0	2	12	0	0
13	12904744	.	G	T	10	7	17	0	1	18	0	0
13	12906773	.	T	C	5	6	11	0	1	12	0	0
13	12911384	.	G	A	1	2	3	0	4	7	0	0
13	12915909	.	T	C	4	4	8	0	0	8	0	0
13	12915927	.	A	T	5	3	8	0	0	8	0	0
13	12916079	.	A	C	2	6	8	0	2	10	0	0
13	12917364	.	G	C	3	5	8	0	1	9	0	0
13	12917382	.	C	T	5	6	11	0	1	12	0	0
13	12917424	.	G	A	8	6	14	0	2	16	0	0
13	12917427	.	T	C	8	7	15	0	0	15	0	0
13	12918227	.	G	C	9	5	14	0	1	15	0	0
13	12920837	.	T	C	8	7	15	0	0	15	0	0
13	12920924	.	C	T	9	5	14	0	2	16	0	0
13	12940084	.	C	T	7	9	16	0	0	16	0	0
13	12946108	.	G	A	7	8	15	0	1	16	0	0
13	12955335	.	C	T	12	9	21	0	1	22	0	0
13	12955377	.	C	T	14	10	24	0	0	24	0	0
13	12955413	.	C	T	13	10	23	0	0	23	0	0
13	12955549	.	C	T	12	13	25	0	0	25	0	0
13	12962979	.	G	A	0	13	13	0	13	26	0	0
13	12963052	.	C	T	8	12	20	0	1	21	0	0
13	12967432	.	G	C	16	14	30	0	1	31	0	0
13	12967438	.	C	T	14	16	30	0	1	31	0	0
13	12970797	.	C	T	12	9	21	0	0	21	0	0
13	12971856	.	G	A	15	15	30	0	0	30	0	0
13	12985114	.	C	T	20	18	38	0	0	38	0	0
13	12985193	.	T	A	20	16	36	1	0	37	0	0
13	12985253	.	G	A	5	11	16	1	17	34	0	0
13	12985291	.	G	A	24	8	32	0	2	34	0	0
13	12985376	.	G	A	0	21	21	0	15	36	0	0
13	12985539	.	T	C	19	11	30	0	1	31	0	0
13	12985540	.	A	G	21	0	21	0	11	32	0	0
13	12985822	.	T	G	13	3	16	2	0	18	0	0
13	12994738	.	A	T	10	7	17	0	0	17	0	0
13	12994743	.	G	T	7	10	17	0	0	17	0	0
13	12997845	.	C	T	7	7	14	0	1	15	0	0
13	13001540	.	G	T	3	3	6	0	0	6	0	0
13	13004739	.	G	A	4	4	8	0	0	8	0	0
13	13004748	.	G	A	4	4	8	0	0	8	0	0
13	13008496	.	G	A	2	3	5	0	0	5	0	0
13	13008910	.	C	T	4	3	7	0	0	7	0	0
13	13008939	.	C	T	5	5	10	0	0	10	0	0
13	13019109	.	C	G	3	2	5	0	0	5	0	0
13	13019148	.	C	T	7	3	10	0	0	10	0	0
13	13019277	.	C	G	3	3	6	0	0	6	0	0
13	13072658	.	G	T	4	5	9	0	0	9	0	0
13	13091046	.	C	A	9	11	20	0	0	20	0	0
13	13091079	.	T	C	4	10	14	0	0	14	0	0
13	13094191	.	A	G	9	4	13	0	0	13	0	0
13	13096526	.	T	C	8	9	17	0	0	17	0	0
13	13099710	.	A	T	3	5	8	0	0	8	0	0
13	13213863	.	G	A	3	5	8	0	1	9	0	0
13	13214412	.	G	A	11	17	28	0	2	30	0	0
13	13214571	.	T	A	4	10	14	0	0	14	0	0
13	13214648	.	C	T	2	2	4	0	0	4	0	0
13	13214883	.	A	T	6	7	13	0	0	13	0	0
13	13215010	.	A	G	4	9	13	0	0	13	0	0
13	13215474	.	C	T	2	5	7	0	0	7	0	0
13	13215984	.	T	C	3	2	5	0	1	6	0	0
13	13216071	.	A	T	10	8	18	0	1	19	0	0
13	13216156	.	G	A	1	5	6	0	0	6	0	0
13	13216424	.	T	C	2	0	2	0	3	5	0	0
13	13216495	.	A	C	3	7	10	0	0	10	0	0
13	13216515	.	T	G	3	6	9	0	0	9	0	0
13	13216593	.	C	T	4	2	6	0	0	6	0	0
13	13217045	.	C	A	5	6	11	0	1	12	0	0
13	13218334	.	G	T	5	3	8	0	0	8	0	0
13	13218594	.	C	T	3	2	5	0	1	6	0	0
13	13221482	.	C	T	2	3	5	0	1	6	0	0
13	13228465	.	G	A	5	2	7	0	0	7	0	0
13	13228489	.	T	C	2	1	3	0	6	9	0	0
13	13693781	.	A	T	2	11	13	0	2	15	0	0
13	13697957	.	G	A	0	20	20	0	5	25	0	0
13	13698240	.	G	T	14	4	18	0	0	18	0	0
13	13703298	.	T	C	14	5	19	0	4	23	0	0
13	13708562	.	C	T	19	5	24	0	0	24	0	0
13	13708567	.	T	C	19	5	24	0	0	24	0	0
13	13711149	.	A	G	22	0	22	0	8	30	0	0
13	13712633	.	T	C	24	7	31	0	0	31	0	0
13	13713106	.	C	G	12	13	25	0	0	25	0	0
13	13733417	.	G	T	30	26	56	0	1	57	0	0
13	13771020	.	G	A	1	5	6	0	1	7	0	0
13	13846362	.	G	A	4	6	10	1	2	13	0	0
13	13917976	.	C	T	12	8	20	0	1	21	0	0
13	13917991	.	C	T	9	12	21	0	0	21	0	0
13	13930392	.	G	A	2	2	4	0	0	4	0	0
13	13933605	.	G	T	6	4	10	0	1	11	0	0
13	13938461	.	G	A	1	4	5	0	4	9	0	0
13	13942374	.	G	A	2	2	4	0	0	4	0	0
13	13943562	.	G	T	3	5	8	0	0	8	0	0
13	13943788	.	T	C	1	5	6	0	0	6	0	0
13	13944064	.	A	G	3	6	9	0	0	9	0	0
13	13945276	.	T	A	2	4	6	0	0	6	0	0
13	13970036	.	G	A	4	2	6	0	1	7	0	0
13	13982693	.	T	C	2	4	6	0	0	6	0	0
13	13982696	.	G	T	0	4	4	0	2	6	0	0
13	13984582	.	G	A	2	2	4	0	2	6	0	0
13	13988395	.	A	C	1	4	5	0	0	5	0	0
13	13988647	.	G	A	4	2	6	0	0	6	0	0
13	13997097	.	C	T	3	7	10	0	0	10	0	0
13	13997101	.	C	T	7	3	10	0	0	10	0	0
13	13997299	.	C	T	5	6	11	0	0	11	0	0
13	13997383	.	T	G	5	1	6	0	5	11	0	0
13	13997446	.	G	T	0	3	3	0	2	5	0	0
13	13997545	.	G	A	5	3	8	0	0	8	0	0
13	13997829	.	G	A	1	6	7	0	0	7	0	0
13	13999004	.	C	G	3	5	8	0	0	8	0	0
13	13999037	.	A	T	2	3	5	0	0	5	0	0
13	13999082	.	G	A	1	3	4	0	0	4	0	0
13	14002936	.	A	T	5	6	11	0	0	11	0	0
13	14003099	.	A	G	7	6	13	0	0	13	0	0
13	14004141	.	C	T	9	5	14	0	0	14	0	0
13	14004209	.	C	T	6	3	9	0	0	9	0	0
13	14004246	.	T	A	5	6	11	0	0	11	0	0
13	14023838	.	G	A	0	3	3	0	3	6	0	0
13	14070774	.	A	T	1	5	6	0	0	6	0	0
13	14070868	.	C	T	2	5	7	0	0	7	0	0
13	14070961	.	C	T	2	2	4	0	0	4	0	0
13	14078691	.	G	A	1	3	4	0	6	10	0	0
13	14078752	.	T	C	6	4	10	0	0	10	0	0
13	14081204	.	A	T	5	2	7	0	0	7	0	0
13	14088909	.	G	T	6	5	11	0	0	11	0	0
13	14092489	.	C	T	4	9	13	0	1	14	0	0
13	14092573	.	G	A	12	9	21	0	0	21	0	0
13	14094405	.	C	T	8	8	16	0	0	16	0	0
13	14094441	.	G	A	6	3	9	0	1	10	0	0
13	14102253	.	C	T	9	7	16	0	0	16	0	0
13	14103916	.	C	T	10	11	21	0	2	23	0	0
13	14116632	.	C	T	9	12	21	0	0	21	0	0
13	14116869	.	T	C	10	5	15	0	0	15	0	0
13	14137061	.	C	T	6	8	14	0	3	17	0	0
13	14181846	.	A	T	11	9	20	0	1	21	0	0
13	14181912	.	A	C	9	9	18	0	2	20	0	0
13	14181952	.	T	C	10	8	18	0	0	18	0	0
13	14190780	.	C	T	0	19	19	0	14	33	0	0
13	14191033	.	T	C	16	17	33	0	1	34	0	0
13	14191045	.	G	C	16	15	31	0	0	31	0	0
13	14191724	.	G	A	10	8	18	0	2	20	0	0
13	14192110	.	T	C	7	10	17	0	0	17	0	0
13	14192131	.	G	A	6	9	15	0	0	15	0	0
13	14192178	.	A	T	7	11	18	0	2	20	0	0
13	14192376	.	A	G	12	9	21	0	0	21	0	0
13	14192511	.	A	T	8	4	12	0	0	12	0	0
13	14194640	.	C	T	4	11	15	0	0	15	0	0
13	14194836	.	C	T	0	15	15	0	12	27	0	0
13	14194968	.	T	A	9	11	20	0	1	21	0	0
13	14195100	.	A	G	5	13	18	0	0	18	0	0
13	14199220	.	A	T	15	12	27	0	0	27	0	0
13	14220900	.	G	A	11	9	20	1	1	22	0	0
13	14241819	.	C	T	12	9	21	0	0	21	0	0
13	14251160	.	G	A	3	9	12	0	0	12	0	0
13	14251280	.	C	T	0	7	7	0	9	16	0	0
13	14251313	.	C	A	6	9	15	0	1	16	0	0
13	14487429	.	T	A	7	6	13	0	0	13	0	0
13	14487445	.	T	C	5	0	5	0	7	12	0	0
13	15194711	.	T	C	1	3	4	0	0	4	0	0
13	15848895	.	C	T	7	34	41	3	0	44	0	0
13	17470079	.	C	T	6	13	19	0	1	20	0	0
13	17470112	.	A	G	9	0	9	0	11	20	0	0
13	17470430	.	T	C	11	10	21	0	0	21	0	0
13	17702657	.	C	T	4	2	6	0	0	6	0	0
13	17703164	.	A	T	3	3	6	0	1	7	0	0
13	17703453	.	T	A	7	2	9	0	0	9	0	0
13	17703454	.	C	A	8	2	10	0	0	10	0	0
13	17714510	.	G	T	17	29	46	0	1	47	0	0
13	17714881	.	C	T	28	19	47	0	1	48	0	0
13	17714942	.	A	G	19	31	50	0	3	53	0	0
13	17717608	.	G	A	23	27	50	1	0	51	0	0
13	17752932	.	A	T	7	8	15	0	0	15	0	0
13	17753144	.	A	C	8	0	8	0	10	18	0	0
13	17753668	.	A	C	19	10	29	0	0	29	0	0
13	17753732	.	A	T	9	7	16	0	2	18	0	0
13	17753821	.	A	T	14	8	22	0	3	25	0	0
13	17754071	.	T	G	2	6	8	0	0	8	0	0
13	17754275	.	G	T	14	4	18	0	0	18	0	0
13	17754466	.	C	T	2	2	4	0	0	4	0	0
13	17754510	.	T	C	6	2	8	0	0	8	0	0
13	17754720	.	A	T	3	3	6	0	0	6	0	0
13	17754889	.	C	G	5	5	10	0	0	10	0	0
13	17754897	.	C	T	1	5	6	0	5	11	0	0
13	17755221	.	C	T	6	4	10	0	1	11	0	0
13	17755579	.	A	G	11	5	16	0	0	16	0	0
13	17755743	.	G	C	6	0	6	0	11	17	0	0
13	17755758	.	C	T	1	6	7	0	6	13	0	0
13	17755830	.	C	A	7	8	15	0	0	15	0	0
13	17755898	.	G	A	5	10	15	0	0	15	0	0
13	17756043	.	G	A	8	5	13	0	0	13	0	0
13	17756112	.	G	A	6	6	12	0	1	13	0	0
13	17756131	.	A	T	6	7	13	0	0	13	0	0
13	17756186	.	C	A	3	7	10	0	0	10	0	0
13	17756235	.	G	A	6	11	17	0	0	17	0	0
13	17756322	.	G	A	7	6	13	0	2	15	0	0
13	17822777	.	A	T	2	9	11	0	0	11	0	0
13	17943071	.	C	T	1	2	3	0	0	3	0	0
13	18011130	.	T	G	6	3	9	0	0	9	0	0
13	18011158	.	G	T	5	3	8	0	0	8	0	0
13	18019724	.	T	C	3	3	6	0	0	6	0	0
13	18019786	.	C	T	2	3	5	0	3	8	0	0
13	18024418	.	C	T	5	8	13	0	1	14	0	0
13	18024419	.	A	G	4	8	12	0	2	14	0	0
13	18033053	.	A	G	2	5	7	0	0	7	0	0
13	18033073	.	T	G	2	5	7	0	0	7	0	0
13	18046210	.	G	A	2	5	7	0	0	7	0	0
13	18064536	.	C	T	0	4	4	0	5	9	0	0
13	18073433	.	A	G	9	19	28	0	0	28	0	0
13	18073524	.	G	T	8	10	18	0	1	19	0	0
13	18073582	.	G	T	7	4	11	0	0	11	0	0
13	18073706	.	G	A	9	8	17	0	0	17	0	0
13	18076710	.	T	G	7	15	22	0	1	23	0	0
13	18076788	.	G	C	17	13	30	0	1	31	0	0
13	18076818	.	G	A	11	17	28	0	1	29	0	0
13	18076996	.	C	T	11	10	21	0	2	23	0	0
13	18077056	.	G	T	13	17	30	0	4	34	0	0
13	18077116	.	G	A	13	21	34	0	2	36	0	0
13	18077191	.	C	G	18	9	27	0	1	28	0	0
13	18080348	.	G	A	12	9	21	0	0	21	0	0
13	18080411	.	G	T	5	15	20	0	0	20	0	0
13	18083391	.	C	T	1	8	9	0	15	24	0	0
13	18083415	.	G	A	9	11	20	0	0	20	0	0
13	18087946	.	G	A	9	10	19	0	0	19	0	0
13	18088276	.	T	G	5	12	17	0	1	18	0	0
13	18092062	.	G	T	9	8	17	0	0	17	0	0
13	18092084	.	A	G	4	5	9	0	2	11	0	0
13	18092108	.	T	C	4	4	8	0	1	9	0	0
13	18092266	.	C	T	6	7	13	0	0	13	0	0
13	18092279	.	A	G	6	5	11	0	0	11	0	0
13	18092417	.	A	G	8	9	17	0	0	17	0	0
13	18099947	.	T	C	10	0	10	0	7	17	0	0
13	18104890	.	C	T	9	12	21	0	0	21	0	0
13	18104929	.	A	T	8	11	19	2	0	21	0	0
13	18105382	.	A	G	8	5	13	1	1	15	0	0
13	18107562	.	C	T	2	3	5	0	1	6	0	0
13	18107622	.	A	G	5	5	10	0	0	10	0	0
13	18110003	.	T	C	5	0	5	0	9	14	0	0
13	18119488	.	T	C	2	4	6	0	0	6	0	0
13	18119489	.	C	T	2	4	6	0	0	6	0	0
13	18122193	.	C	T	9	5	14	0	0	14	0	0
13	18122263	.	C	G	0	9	9	0	4	13	0	0
13	18179151	.	C	A	2	3	5	0	0	5	0	0
13	18179391	.	G	C	4	0	4	0	6	10	0	0
13	18179521	.	A	G	4	6	10	0	0	10	0	0
13	18179535	.	G	T	3	7	10	0	0	10	0	0
13	18179757	.	T	C	7	18	25	0	2	27	0	0
13	18179859	.	C	A	15	19	34	0	1	35	0	0
13	18185457	.	A	C	7	1	8	0	8	16	0	0
13	18185463	.	C	A	6	8	14	0	1	15	0	0
13	18195926	.	G	A	2	9	11	0	0	11	0	0
13	18274914	.	A	C	3	4	7	0	0	7	0	0
13	18275320	.	G	A	2	3	5	0	0	5	0	0
13	18275801	.	C	A	3	2	5	0	0	5	0	0
13	18275935	.	T	C	3	6	9	0	0	9	0	0
13	18276043	.	T	A	4	1	5	0	1	6	0	0
13	18276195	.	A	G	2	5	7	0	0	7	0	0
13	18276387	.	T	G	4	3	7	0	0	7	0	0
13	18295423	.	G	A	0	6	6	0	4	10	0	0
13	18295680	.	T	C	7	5	12	0	2	14	0	0
13	18295718	.	A	G	6	3	9	0	0	9	0	0
13	18295760	.	A	G	4	0	4	0	6	10	0	0
13	18314113	.	T	G	10	0	10	0	11	21	0	0
13	18321156	.	T	C	11	6	17	0	0	17	0	0
13	18323464	.	A	G	11	11	22	0	1	23	0	0
13	18323595	.	G	A	2	11	13	0	15	28	0	0
13	18323653	.	A	G	12	1	13	0	9	22	0	0
13	18323787	.	T	A	19	11	30	0	1	31	0	0
13	18358890	.	G	C	12	19	31	0	0	31	0	0
13	18359112	.	G	C	27	10	37	0	2	39	0	0
13	18359304	.	A	T	11	9	20	0	0	20	0	0
13	18359374	.	C	T	13	16	29	0	3	32	0	0
13	18359507	.	A	T	9	16	25	0	0	25	0	0
13	18371186	.	A	C	2	3	5	0	0	5	0	0
13	18375465	.	C	A	9	4	13	0	0	14	1	0
13	18375512	.	T	A	7	6	13	0	1	14	0	0
13	18382132	.	A	C	5	5	10	0	0	10	0	0
13	18382192	.	T	C	3	6	9	0	0	9	0	0
13	18385497	.	C	T	7	7	14	0	0	14	0	0
13	18385512	.	C	T	8	8	16	0	0	16	0	0
13	18385797	.	T	A	3	4	7	0	2	9	0	0
13	18394755	.	T	A	9	10	19	0	1	20	0	0
13	18397138	.	C	G	13	5	18	0	0	18	0	0
13	18397189	.	A	G	4	2	6	0	0	6	0	0
13	18409776	.	T	A	5	4	9	0	0	9	0	0
13	18410799	.	G	C	2	3	5	0	7	12	0	0
13	18418337	.	C	A	4	6	10	0	2	12	0	0
13	18418528	.	G	A	8	6	14	0	1	15	0	0
13	18428103	.	A	G	17	13	30	0	2	32	0	0
13	18431278	.	T	A	20	11	31	0	0	31	0	0
13	18431301	.	C	T	17	9	26	0	0	26	0	0
13	18431430	.	C	T	8	4	12	0	0	12	0	0
13	18434354	.	T	C	8	7	15	0	0	15	0	0
13	18434427	.	C	T	11	5	16	0	0	16	0	0
13	18434519	.	C	A	4	10	14	0	0	14	0	0
13	18434520	.	G	C	1	10	11	0	3	14	0	0
13	18434818	.	C	G	6	8	14	0	1	15	0	0
13	18434902	.	C	T	3	10	13	0	0	13	0	0
13	18434957	.	G	A	8	4	12	0	0	12	0	0
13	18434962	.	A	G	7	3	10	0	1	11	0	0
13	18499773	.	A	T	2	4	6	0	0	6	0	0
13	18499807	.	A	G	2	2	4	0	0	4	0	0
13	18507735	.	A	G	10	10	20	0	1	21	0	0
13	18509592	.	G	A	2	14	16	0	17	33	0	0
13	18509925	.	T	C	16	15	31	0	1	32	0	0
13	18509940	.	C	T	12	16	28	0	1	29	0	0
13	18510319	.	C	A	12	11	23	0	2	25	0	0
13	18510324	.	A	G	15	12	27	0	1	28	0	0
13	18510540	.	G	A	2	13	15	0	12	27	0	0
13	18511023	.	C	T	9	15	24	0	1	25	0	0
13	18511140	.	A	G	15	2	17	0	17	34	0	0
13	18511637	.	A	C	13	10	23	0	0	23	0	0
13	18511763	.	T	A	10	13	23	0	0	23	0	0
13	18511996	.	A	T	12	14	26	0	2	28	0	0
13	18512030	.	A	T	15	10	25	0	0	25	0	0
13	18512082	.	C	G	12	13	25	0	0	25	0	0
13	18624124	.	G	C	0	3	3	0	4	7	0	0
13	18663103	.	G	A	4	3	7	0	0	7	0	0
13	18663619	.	A	T	27	19	46	0	0	46	0	0
13	18663620	.	T	C	28	17	45	0	2	47	0	0
13	18663947	.	G	A	26	22	48	0	4	52	0	0
13	18677726	.	T	C	7	5	12	0	0	12	0	0
13	18677749	.	C	A	9	4	13	1	1	15	0	0
13	18677761	.	C	T	9	5	14	1	0	15	0	0
13	18677925	.	A	T	8	12	20	0	0	20	0	0
13	18680027	.	G	A	6	9	15	0	1	16	0	0
13	18685598	.	A	G	14	8	22	0	0	22	0	0
13	18685673	.	G	A	8	12	20	1	2	23	0	0
13	18801820	.	T	C	2	8	10	0	0	10	0	0
13	19304688	.	A	G	20	13	33	0	2	35	0	0
13	19306817	.	C	G	17	7	24	0	1	25	0	0
13	19316930	.	G	C	13	17	30	0	0	30	0	0
13	19317016	.	T	A	7	13	20	0	0	20	0	0
13	19317018	.	C	G	7	13	20	0	0	20	0	0
13	19317051	.	T	G	6	11	17	0	1	18	0	0
13	19627150	.	A	G	4	2	6	0	0	6	0	0
13	19627266	.	A	C	3	4	7	0	1	8	0	0
13	19629266	.	C	G	6	7	13	0	0	13	0	0
13	19639198	.	A	G	4	2	6	0	1	7	0	0
13	19639205	.	G	A	5	3	8	0	0	8	0	0
13	19799192	.	A	G	18	12	30	1	1	32	0	0
13	19799467	.	G	A	13	17	30	0	0	30	0	0
13	19799522	.	C	T	12	10	22	0	3	25	0	0
13	19799535	.	T	A	13	8	21	0	2	23	0	0
13	19799623	.	T	C	12	11	23	0	2	25	0	0
13	19799646	.	C	A	3	10	13	0	13	26	0	0
13	19799705	.	A	G	11	15	26	0	0	26	0	0
13	20007841	.	C	T	2	4	6	0	0	6	0	0
13	20401263	.	C	A	1	20	21	1	13	35	0	0
13	20425396	.	C	T	0	8	8	0	12	20	0	0
13	20518620	.	C	T	1	12	13	0	12	25	0	0
13	20518711	.	C	T	6	6	12	0	0	12	0	0
13	21638541	.	G	A	5	2	7	0	1	8	0	0
13	21638916	.	G	A	7	10	17	0	1	18	0	0
13	21638955	.	C	A	8	5	13	0	2	15	0	0
13	21677621	.	T	C	6	2	8	0	0	8	0	0
13	21680844	.	A	T	2	5	7	0	0	7	0	0
13	21683057	.	A	C	7	6	13	0	2	15	0	0
13	21683077	.	T	C	6	5	11	0	0	11	0	0
13	21683488	.	A	T	24	16	40	0	1	41	0	0
13	21683511	.	T	G	22	11	33	0	1	34	0	0
13	21683546	.	C	T	13	17	30	0	0	30	0	0
13	21689373	.	G	A	3	2	5	0	0	5	0	0
13	21689438	.	A	C	6	12	18	0	2	20	0	0
13	21689439	.	C	T	6	13	19	0	1	20	0	0
13	21689839	.	C	T	7	9	16	0	1	17	0	0
13	21689854	.	C	T	9	6	15	0	1	16	0	0
13	21689982	.	G	A	3	6	9	0	1	10	0	0
13	21690096	.	C	G	7	3	10	0	0	10	0	0
13	21690229	.	A	C	7	6	13	1	0	14	0	0
13	21690374	.	G	A	10	10	20	3	0	23	0	0
13	21690530	.	C	T	2	6	8	1	10	19	0	0
13	21690724	.	A	T	8	6	14	0	1	15	0	0
13	21690877	.	A	C	8	0	8	1	10	19	0	0
13	21690907	.	G	A	8	6	14	2	0	17	1	0
13	21691324	.	G	A	6	6	12	0	0	12	0	0
13	21691611	.	G	A	1	2	3	0	1	4	0	0
13	21691794	.	G	A	7	5	12	0	1	13	0	0
13	21692328	.	C	A	2	14	16	0	0	16	0	0
13	21692338	.	C	T	3	13	16	0	0	16	0	0
13	21692705	.	C	G	0	9	9	0	7	16	0	0
13	21692859	.	C	T	9	5	14	0	1	15	0	0
13	21693187	.	A	G	10	11	21	0	1	22	0	0
13	21693208	.	A	C	10	0	10	0	9	19	0	0
13	21693285	.	A	T	6	6	12	0	0	12	0	0
13	21693342	.	C	T	10	11	21	0	0	21	0	0
13	21693361	.	C	T	11	12	23	0	0	23	0	0
13	21693410	.	G	C	11	8	19	0	0	19	0	0
13	21695438	.	G	T	9	9	18	0	0	18	0	0
13	21712507	.	G	A	11	24	35	0	2	37	0	0
13	21712526	.	G	A	8	23	31	0	1	32	0	0
13	21712755	.	G	C	6	17	23	0	2	25	0	0
13	21716581	.	T	C	6	16	22	0	0	22	0	0
13	21722470	.	G	A	6	15	21	0	0	21	0	0
13	21725502	.	G	T	7	4	11	0	0	11	0	0
13	21725526	.	T	C	10	5	15	0	0	15	0	0
13	21727796	.	T	A	5	2	7	0	0	7	0	0
13	21727799	.	G	A	3	2	5	0	1	6	0	0
13	21735278	.	C	T	3	4	7	0	0	7	0	0
13	21738992	.	T	G	5	3	8	0	1	9	0	0
13	21739036	.	A	T	7	4	11	0	1	12	0	0
13	21770891	.	T	C	7	20	27	0	1	28	0	0
13	21775469	.	C	T	15	7	22	0	2	24	0	0
13	21775697	.	C	T	7	8	15	0	0	15	0	0
13	21776039	.	C	T	4	2	6	0	0	6	0	0
13	21776046	.	G	C	3	2	5	0	0	5	0	0
13	21776615	.	C	T	1	4	5	0	0	5	0	0
13	21776650	.	C	A	2	2	4	0	0	4	0	0
13	21818793	.	C	T	1	3	4	0	0	4	0	0
13	21821299	.	G	T	1	2	3	0	0	3	0	0
13	21826470	.	G	A	0	3	3	0	6	9	0	0
13	21852008	.	G	A	0	5	5	0	10	15	0	0
13	21853237	.	A	G	4	9	13	0	0	13	0	0
13	21853240	.	C	T	6	10	16	0	0	16	0	0
13	21855811	.	C	T	3	2	5	0	0	5	0	0
13	21855829	.	G	A	4	3	7	0	0	7	0	0
13	21855868	.	C	T	4	10	14	0	0	14	0	0
13	21856741	.	G	A	5	2	7	0	1	8	0	0
13	21856849	.	G	A	0	5	5	0	4	9	0	0
13	21860111	.	G	A	1	6	7	0	0	7	0	0
13	21861775	.	A	C	4	4	8	0	0	8	0	0
13	21861777	.	G	A	3	4	7	0	1	8	0	0
13	21862288	.	T	A	8	9	17	0	1	18	0	0
13	21864182	.	T	A	9	9	18	0	0	18	0	0
13	21866357	.	A	C	12	8	20	0	0	20	0	0
13	21869927	.	C	T	2	8	10	0	1	11	0	0
13	21870467	.	G	C	1	17	18	0	15	33	0	0
13	21870575	.	A	G	15	5	20	0	17	37	0	0
13	21870608	.	A	T	13	16	29	0	2	31	0	0
13	21874107	.	C	T	12	15	27	0	1	28	0	0
13	21874149	.	G	T	0	21	21	0	15	36	0	0
13	21874649	.	C	T	7	10	17	0	2	19	0	0
13	21884298	.	C	T	18	10	28	0	2	30	0	0
13	21884328	.	G	A	14	12	26	0	3	29	0	0
13	21884407	.	T	C	9	10	19	0	2	21	0	0
13	21884408	.	C	T	10	11	21	0	0	21	0	0
13	21884979	.	T	C	6	9	15	0	1	16	0	0
13	21884980	.	C	T	6	9	15	0	1	16	0	0
13	21885143	.	C	A	19	16	35	0	1	36	0	0
13	21885198	.	T	A	16	15	31	0	2	33	0	0
13	22064678	.	G	A	3	8	11	0	1	12	0	0
13	22064775	.	G	A	1	5	6	0	0	6	0	0
13	22065406	.	G	A	5	5	10	0	0	10	0	0
13	22065631	.	A	G	6	3	9	0	1	10	0	0
13	22065661	.	G	A	4	4	8	0	0	8	0	0
13	22066024	.	C	T	5	5	10	0	0	10	0	0
13	22066042	.	T	C	5	6	11	0	0	11	0	0
13	22066066	.	C	T	5	5	10	0	0	10	0	0
13	22066078	.	T	G	5	5	10	0	0	10	0	0
13	22076892	.	C	T	4	9	13	0	0	13	0	0
13	22087098	.	C	T	5	12	17	0	1	18	0	0
13	22087508	.	C	T	7	12	19	0	1	20	0	0
13	22088061	.	T	G	8	0	8	0	7	15	0	0
13	22094800	.	T	C	10	8	18	0	0	18	0	0
13	22094871	.	T	G	11	9	20	0	3	23	0	0
13	22095589	.	G	A	4	3	7	0	0	7	0	0
13	22095594	.	T	A	5	4	9	0	0	9	0	0
13	22119935	.	T	C	18	17	35	1	2	38	0	0
13	22198502	.	G	A	10	15	25	0	0	25	0	0
13	22207003	.	C	T	18	17	35	0	1	36	0	0
13	22238125	.	C	A	25	19	44	0	1	45	0	0
13	22238209	.	T	C	17	13	30	0	3	33	0	0
13	22238233	.	G	A	21	15	36	0	1	37	0	0
13	22240672	.	T	A	28	28	56	0	1	57	0	0
13	22241103	.	T	A	23	20	43	0	0	43	0	0
13	22241123	.	G	T	1	15	16	0	17	34	1	0
13	22241374	.	A	C	20	19	39	0	4	43	0	0
13	22241482	.	G	C	14	21	35	0	0	35	0	0
13	22241648	.	T	G	20	24	44	0	3	47	0	0
13	22241730	.	G	C	29	23	52	0	0	52	0	0
13	22241731	.	A	T	28	23	51	0	1	52	0	0
13	22242197	.	G	C	17	17	34	0	0	34	0	0
13	22242299	.	C	G	17	16	33	0	1	34	0	0
13	22242394	.	C	G	20	20	40	0	0	40	0	0
13	22242837	.	T	G	29	18	47	0	2	49	0	0
13	22243211	.	A	C	15	10	25	1	2	28	0	0
13	22281119	.	C	T	2	3	5	0	1	6	0	0
13	22317066	.	T	C	3	4	7	0	0	7	0	0
13	22317136	.	A	T	7	4	11	0	2	13	0	0
13	22317347	.	A	G	8	9	17	0	0	17	0	0
13	22328575	.	C	T	3	5	8	0	1	9	0	0
13	22340444	.	C	T	5	3	8	0	1	9	0	0
13	22340456	.	G	A	4	4	8	0	0	8	0	0
13	22347443	.	C	A	8	5	13	0	1	14	0	0
13	22351817	.	G	A	8	8	16	0	0	16	0	0
13	22351910	.	A	G	7	5	12	0	0	12	0	0
13	22354938	.	G	A	8	4	12	0	0	12	0	0
13	22355025	.	C	A	8	5	13	0	2	15	0	0
13	22357236	.	T	G	9	5	14	0	0	14	0	0
13	22357850	.	A	G	9	0	9	0	8	17	0	0
13	22358021	.	A	G	8	5	13	0	0	13	0	0
13	22361332	.	G	A	8	11	19	0	0	19	0	0
13	22361718	.	A	C	13	9	22	0	0	22	0	0
13	22364908	.	T	C	10	11	21	0	2	23	0	0
13	22365016	.	C	T	20	23	43	0	2	45	0	0
13	22365404	.	C	T	14	12	26	0	1	27	0	0
13	22365461	.	A	G	14	13	27	0	1	28	0	0
13	22367600	.	C	A	15	17	32	0	2	34	0	0
13	22369262	.	C	T	11	12	23	1	2	26	0	0
13	22369295	.	T	C	13	24	37	1	1	39	0	0
13	22369349	.	C	T	15	19	34	0	1	35	0	0
13	22369399	.	A	C	9	19	28	0	2	30	0	0
13	22369445	.	C	T	8	13	21	0	4	25	0	0
13	22371981	.	G	A	3	18	21	0	22	43	0	0
13	22372015	.	C	G	23	26	49	0	1	50	0	0
13	22372075	.	T	C	24	13	37	0	0	37	0	0
13	22372105	.	G	A	4	16	20	0	21	41	0	0
13	22372126	.	C	T	18	23	41	0	0	41	0	0
13	22372205	.	A	G	25	14	39	0	4	43	0	0
13	22463785	.	C	T	1	2	3	0	0	3	0	0
13	22463794	.	A	G	1	1	2	0	1	3	0	0
13	22463897	.	A	G	1	0	1	0	2	3	0	0
13	22502582	.	G	A	0	4	4	0	1	5	0	0
13	22555909	.	G	A	2	3	5	0	0	5	0	0
13	22618320	.	A	G	0	0	0	0	6	6	0	0
13	22618393	.	T	A	2	4	6	0	1	8	1	0
13	22619067	.	G	A	5	7	12	0	3	15	0	0
13	22619157	.	C	T	9	15	24	0	1	25	0	0
13	22620302	.	C	G	5	2	7	0	0	7	0	0
13	22659195	.	C	G	18	0	18	0	17	35	0	0
13	22659196	.	A	G	17	17	34	0	1	35	0	0
13	22659231	.	G	A	2	27	29	0	24	53	0	0
13	22659291	.	A	G	29	21	50	0	0	50	0	0
13	22659363	.	G	A	16	17	33	2	2	37	0	0
13	22659375	.	A	C	20	16	36	2	2	40	0	0
13	22667102	.	G	A	18	23	41	0	0	41	0	0
13	22667111	.	T	C	18	25	43	0	1	44	0	0
13	22669319	.	T	C	19	31	50	0	0	50	0	0
13	22679837	.	G	A	6	4	10	0	0	10	0	0
13	22683416	.	A	T	4	5	9	0	0	9	0	0
13	22694363	.	C	T	3	4	7	0	0	7	0	0
13	22705172	.	G	C	2	2	4	0	0	4	0	0
13	22705395	.	C	T	1	2	3	0	0	3	0	0
13	22724123	.	T	A	1	3	4	0	0	4	0	0
13	22728509	.	T	C	4	3	7	0	0	7	0	0
13	22728891	.	A	T	2	3	5	0	0	5	0	0
13	22735063	.	T	C	5	8	13	0	1	14	0	0
13	22735139	.	A	G	8	6	14	0	0	14	0	0
13	22742791	.	G	A	18	8	26	0	2	28	0	0
13	22744359	.	A	G	8	14	22	0	0	22	0	0
13	22867910	.	A	G	7	3	10	0	0	10	0	0
13	22867953	.	G	T	2	5	7	0	0	7	0	0
13	22868017	.	G	A	7	5	12	0	0	12	0	0
13	22868456	.	T	C	4	3	7	0	0	7	0	0
13	22871900	.	C	A	3	3	6	0	0	6	0	0
13	22871989	.	A	G	5	2	7	0	0	7	0	0
13	22872538	.	C	T	6	3	9	0	0	9	0	0
13	22872862	.	A	G	4	3	7	0	1	8	0	0
13	22876576	.	T	C	9	0	9	0	7	16	0	0
13	22876623	.	G	A	9	10	19	0	0	19	0	0
13	22876678	.	A	T	11	4	15	0	0	15	0	0
13	22877076	.	C	T	12	14	26	0	0	26	0	0
13	22877130	.	G	T	15	8	23	0	2	25	0	0
13	22878754	.	G	A	20	22	42	0	2	44	0	0
13	22879149	.	A	T	16	11	27	0	3	30	0	0
13	22890835	.	A	C	27	1	28	0	18	47	1	0
13	22898042	.	A	G	13	19	32	0	0	32	0	0
13	22900733	.	G	A	15	16	31	0	1	32	0	0
13	22900742	.	A	T	15	18	33	0	0	33	0	0
13	22902882	.	A	C	14	8	22	0	1	23	0	0
13	22902987	.	G	A	19	14	33	0	0	33	0	0
13	22925392	.	G	A	3	3	6	0	0	6	0	0
13	22970688	.	T	C	2	4	6	0	0	6	0	0
13	22970816	.	T	G	2	2	4	0	1	5	0	0
13	22973314	.	A	G	24	25	49	0	5	54	0	0
13	22973348	.	A	G	28	16	44	0	3	47	0	0
13	22973531	.	T	C	25	1	26	0	19	45	0	0
13	22973895	.	A	G	25	17	42	0	2	44	0	0
13	22974033	.	A	G	22	27	49	0	0	49	0	0
13	22974108	.	C	T	24	23	47	0	2	49	0	0
13	22976067	.	C	A	27	19	46	0	0	46	0	0
13	22976070	.	G	A	24	20	44	0	1	45	0	0
13	22976383	.	T	C	18	1	19	0	13	32	0	0
13	22977283	.	G	A	28	20	48	0	1	49	0	0
13	22977319	.	A	G	27	18	45	0	0	45	0	0
13	22977343	.	A	G	22	14	36	0	0	36	0	0
13	22978059	.	T	C	16	1	17	0	22	39	0	0
13	22978062	.	G	A	19	19	38	0	3	41	0	0
13	22983106	.	A	G	9	6	15	0	0	15	0	0
13	22983109	.	A	G	8	5	13	0	0	13	0	0
13	23002697	.	G	A	7	12	19	0	1	20	0	0
13	23007677	.	A	G	11	8	19	0	0	19	0	0
13	23018204	.	A	G	1	2	3	0	0	3	0	0
13	23018211	.	C	T	0	2	2	0	1	3	0	0
13	23019955	.	C	T	4	2	6	0	1	7	0	0
13	23037831	.	C	A	8	4	12	0	0	12	0	0
13	23042321	.	A	G	7	6	13	0	0	13	0	0
13	23042387	.	C	G	10	4	14	0	0	14	0	0
13	23042676	.	A	G	10	5	15	0	1	16	0	0
13	23042745	.	G	A	15	7	22	0	0	22	0	0
13	23042929	.	G	T	10	2	12	0	1	13	0	0
13	23043112	.	T	C	9	3	12	0	0	12	0	0
13	23043117	.	A	G	9	3	12	0	0	12	0	0
13	23045229	.	G	A	5	6	11	0	0	11	0	0
13	23064735	.	T	C	8	10	18	0	1	19	0	0
13	23070787	.	C	T	5	4	9	0	1	10	0	0
13	23070895	.	T	C	6	15	21	0	1	22	0	0
13	23084177	.	C	G	19	14	33	1	1	35	0	0
13	23084841	.	G	C	6	15	21	0	2	23	0	0
13	23090190	.	A	C	13	16	29	0	0	29	0	0
13	23094356	.	T	C	10	0	10	0	16	26	0	0
13	23094895	.	G	T	10	16	26	0	0	26	0	0
13	23166921	.	A	C	2	5	7	0	0	7	0	0
13	23166988	.	T	A	1	5	6	0	1	7	0	0
13	23169172	.	G	T	1	3	4	0	0	4	0	0
13	23169247	.	C	A	1	3	4	0	0	4	0	0
13	23169809	.	C	T	3	5	8	0	1	9	0	0
13	23170025	.	C	G	4	2	6	0	0	6	0	0
13	23196207	.	C	T	6	7	13	0	2	15	0	0
13	23201307	.	T	A	10	7	17	0	0	17	0	0
13	23204849	.	A	C	6	4	10	0	0	10	0	0
13	23211195	.	A	T	8	7	15	0	1	16	0	0
13	23222899	.	A	T	5	3	8	0	0	8	0	0
13	23223122	.	A	G	6	10	16	0	0	16	0	0
13	23223422	.	G	A	7	5	12	0	1	13	0	0
13	23223428	.	C	T	11	2	13	0	2	15	0	0
13	23223469	.	T	A	10	8	18	0	0	18	0	0
13	23223486	.	C	T	10	7	17	0	0	17	0	0
13	23223567	.	C	T	9	5	14	0	0	14	0	0
13	23223572	.	C	T	9	6	15	0	0	15	0	0
13	23223675	.	C	A	2	5	7	0	0	7	0	0
13	23223875	.	C	A	6	7	13	0	1	14	0	0
13	23224087	.	G	A	11	6	17	0	1	18	0	0
13	23224113	.	A	T	8	7	15	0	0	15	0	0
13	23224360	.	A	G	5	11	16	0	0	16	0	0
13	23224363	.	T	G	5	11	16	0	0	16	0	0
13	23224427	.	C	T	16	7	23	0	0	23	0	0
13	23224470	.	G	A	14	9	23	0	1	24	0	0
13	23224605	.	G	T	10	10	20	0	1	21	0	0
13	23224727	.	C	T	11	8	19	0	2	21	0	0
13	23224735	.	A	G	13	8	21	0	0	21	0	0
13	23224821	.	T	A	11	15	26	0	0	26	0	0
13	23224860	.	T	A	12	13	25	0	0	25	0	0
13	23225541	.	T	C	9	14	23	0	0	23	0	0
13	23225776	.	T	A	10	11	21	0	2	23	0	0
13	23226114	.	G	A	2	9	11	0	12	23	0	0
13	23226213	.	A	C	5	9	14	0	0	14	0	0
13	23314904	.	T	G	9	5	14	0	1	15	0	0
13	23382393	.	G	A	9	14	23	0	1	24	0	0
13	23382572	.	T	C	13	19	32	0	2	34	0	0
13	23387252	.	T	C	8	11	19	0	2	21	0	0
13	23387337	.	C	T	8	4	12	0	2	14	0	0
13	23669773	.	C	T	12	6	18	0	1	19	0	0
13	23669870	.	T	G	6	2	8	0	1	9	0	0
13	23669916	.	C	A	8	3	11	0	0	11	0	0
13	23675183	.	C	T	13	10	23	0	0	23	0	0
13	23675510	.	T	C	7	7	14	0	1	15	0	0
13	23675892	.	G	C	1	7	8	0	10	18	0	0
13	23676856	.	G	A	1	9	10	0	12	22	0	0
13	23676913	.	C	A	13	7	20	0	1	21	0	0
13	23678001	.	G	A	1	6	7	0	10	17	0	0
13	23679546	.	G	A	0	7	7	0	9	16	0	0
13	23679888	.	G	A	8	6	14	0	0	14	0	0
13	23685075	.	G	A	5	6	11	0	0	11	0	0
13	23685301	.	G	A	3	5	8	0	0	8	0	0
13	23685361	.	T	G	9	0	9	0	10	19	0	0
13	23692515	.	C	T	12	12	24	0	0	24	0	0
13	23692572	.	C	T	20	8	28	0	0	28	0	0
13	23703048	.	G	C	11	13	24	0	2	26	0	0
13	23703053	.	T	C	10	16	26	0	1	27	0	0
13	23709532	.	C	T	10	14	24	0	2	26	0	0
13	23709562	.	T	C	15	17	32	0	1	33	0	0
13	23709592	.	A	G	16	18	34	0	0	34	0	0
13	23711937	.	G	A	21	13	34	0	1	35	0	0
13	23728490	.	T	A	6	8	14	0	1	15	0	0
13	23730801	.	G	A	9	10	19	0	0	19	0	0
13	23731988	.	T	A	2	3	5	0	0	5	0	0
13	23733294	.	A	C	1	2	3	0	0	3	0	0
13	23876610	.	A	G	3	0	3	0	5	8	0	0
13	23876697	.	T	C	5	4	9	0	0	9	0	0
13	23876784	.	C	T	4	5	9	0	0	9	0	0
13	23876865	.	C	T	3	4	7	0	0	7	0	0
13	23882377	.	A	G	6	4	10	0	0	10	0	0
13	23882615	.	T	C	3	8	11	0	1	12	0	0
13	23882629	.	T	C	7	4	11	0	0	11	0	0
13	23882686	.	C	T	8	7	15	0	2	17	0	0
13	23898045	.	T	G	15	19	34	0	0	34	0	0
13	23901334	.	C	T	12	13	25	0	0	25	0	0
13	23901349	.	T	C	11	13	24	0	0	24	0	0
13	23901502	.	A	G	8	13	21	0	1	22	0	0
13	23901555	.	A	G	9	0	9	0	7	16	0	0
13	23901570	.	T	C	10	5	15	0	2	17	0	0
13	23920791	.	A	G	13	5	18	0	1	19	0	0
13	23931192	.	T	C	12	1	13	0	7	20	0	0
13	23932450	.	G	A	4	2	6	0	0	6	0	0
13	23940708	.	T	C	8	0	8	0	8	16	0	0
13	23940754	.	C	A	5	6	11	0	1	12	0	0
13	23943040	.	T	G	6	6	12	0	0	12	0	0
13	23993705	.	C	T	1	1	2	0	1	3	0	0
13	23996192	.	G	A	4	2	6	0	0	6	0	0
13	23999129	.	G	A	4	5	9	0	0	9	0	0
13	23999264	.	G	C	3	5	8	0	1	9	0	0
13	23999274	.	T	A	4	4	8	0	1	9	0	0
13	24010630	.	C	T	3	2	5	0	0	5	0	0
13	24010663	.	A	G	3	3	6	0	0	6	0	0
13	24014332	.	A	G	4	5	9	0	0	9	0	0
13	24014341	.	G	A	4	4	8	0	1	9	0	0
13	24014578	.	T	C	3	4	7	0	0	7	0	0
13	24023036	.	G	T	9	8	17	0	0	17	0	0
13	24033958	.	G	T	1	6	7	0	2	9	0	0
13	24034092	.	T	G	3	6	9	0	0	9	0	0
13	24034158	.	A	G	6	2	8	0	1	9	0	0
13	24034206	.	A	G	5	6	11	0	1	12	0	0
13	24034215	.	G	A	8	4	12	0	1	13	0	0
13	24045342	.	C	T	4	3	7	0	4	11	0	0
13	24046953	.	G	A	0	7	7	0	3	10	0	0
13	24056221	.	C	T	8	12	20	0	1	21	0	0
13	24068790	.	C	T	0	16	16	0	8	24	0	0
13	24069624	.	C	A	13	13	26	0	0	26	0	0
13	24069902	.	A	T	13	13	26	0	0	26	0	0
13	24070242	.	C	T	1	8	9	0	12	21	0	0
13	24070730	.	C	T	5	9	14	0	0	14	0	0
13	24096437	.	G	T	7	6	13	0	0	13	0	0
13	24234815	.	C	A	3	4	7	0	0	7	0	0
13	24249913	.	A	T	3	4	7	0	0	7	0	0
13	24251122	.	T	C	1	2	3	0	0	3	0	0
13	24266756	.	G	C	1	4	5	0	0	5	0	0
13	24269693	.	T	G	3	4	7	0	1	8	0	0
13	24269697	.	C	T	4	3	7	0	0	7	0	0
13	24269784	.	G	C	3	2	5	0	0	5	0	0
13	24271061	.	C	A	1	3	4	0	0	4	0	0
13	24276128	.	T	A	3	5	8	0	0	8	0	0
13	24276241	.	C	A	1	2	3	0	0	3	0	0
13	24276354	.	A	G	4	2	6	0	0	6	0	0
13	24276366	.	C	T	3	2	5	0	0	5	0	0
13	24276497	.	A	G	7	0	7	0	5	12	0	0
13	24287895	.	C	T	6	7	13	0	0	13	0	0
13	24290132	.	A	T	3	13	16	0	0	16	0	0
13	24290140	.	A	G	4	14	18	0	0	18	0	0
13	24290169	.	T	G	9	0	9	0	12	21	0	0
13	24292398	.	G	A	4	3	7	0	0	7	0	0
13	24292675	.	A	G	9	4	13	0	2	15	0	0
13	24292727	.	G	A	17	9	26	0	0	26	0	0
13	24292796	.	T	A	10	19	29	0	0	29	0	0
13	24292800	.	A	T	9	18	27	0	1	28	0	0
13	24292947	.	A	T	9	13	22	0	2	24	0	0
13	24293381	.	A	T	25	14	39	0	1	40	0	0
13	24293465	.	C	T	10	18	28	0	18	46	0	0
13	24293516	.	G	A	15	24	39	0	6	45	0	0
13	24293518	.	C	A	20	22	42	0	3	45	0	0
13	24293615	.	G	A	23	13	36	0	14	50	0	0
13	24293698	.	C	T	43	9	52	0	0	52	0	0
13	24293793	.	A	G	19	17	36	0	3	39	0	0
13	24294046	.	A	G	9	14	23	0	0	24	1	0
13	24295907	.	A	T	5	9	14	0	0	14	0	0
13	24295921	.	C	A	3	6	9	0	1	10	0	0
13	24295999	.	T	C	8	3	11	0	1	12	0	0
13	24296071	.	G	A	4	12	16	0	1	17	0	0
13	24296094	.	A	C	6	5	11	0	0	11	0	0
13	24296141	.	G	A	2	3	5	0	0	5	0	0
13	24296198	.	A	T	7	6	13	0	0	13	0	0
13	24296250	.	A	G	2	7	9	0	0	9	0	0
13	24303840	.	G	A	8	9	17	0	2	19	0	0
13	24305975	.	T	G	15	9	24	0	1	25	0	0
13	24311510	.	G	A	11	9	20	0	0	20	0	0
13	24371848	.	G	T	0	1	1	0	1	2	0	0
13	24371898	.	C	T	3	5	8	0	0	8	0	0
13	24371933	.	A	C	3	0	3	0	6	9	0	0
13	24372197	.	C	T	6	4	10	1	0	11	0	0
13	24372392	.	A	G	3	2	5	0	0	5	0	0
13	24372943	.	C	T	4	2	6	0	0	6	0	0
13	24373081	.	A	G	1	2	3	0	1	4	0	0
13	24378764	.	A	G	4	2	6	0	0	6	0	0
13	24382137	.	G	A	0	5	5	0	3	8	0	0
13	24382152	.	T	C	2	5	7	0	0	7	0	0
13	24395373	.	G	A	5	4	9	0	0	9	0	0
13	24401618	.	A	G	3	4	7	0	0	7	0	0
13	24401626	.	G	C	0	3	3	0	5	8	0	0
13	24401860	.	A	C	2	2	4	0	0	4	0	0
13	24401864	.	C	A	2	2	4	0	0	4	0	0
13	24402560	.	T	C	7	9	16	0	2	18	0	0
13	24411029	.	A	G	15	20	35	0	4	39	0	0
13	24423602	.	C	T	0	4	4	0	2	6	0	0
13	24423930	.	T	C	2	4	6	0	0	6	0	0
13	24424014	.	C	T	4	6	10	0	0	10	0	0
13	24424051	.	G	A	5	5	10	0	0	10	0	0
13	24424511	.	A	C	1	0	1	0	2	3	0	0
13	24425019	.	G	A	1	2	3	0	0	3	0	0
13	24425682	.	A	T	1	3	4	0	0	4	0	0
13	24431365	.	T	G	6	7	13	0	1	14	0	0
13	24432096	.	C	T	15	9	24	0	0	24	0	0
13	24432162	.	G	C	13	12	25	0	0	25	0	0
13	24432350	.	C	T	0	7	7	0	18	25	0	0
13	24436011	.	C	G	14	11	25	0	1	26	0	0
13	24436054	.	G	A	15	14	29	0	1	30	0	0
13	24437225	.	G	A	10	14	24	0	1	25	0	0
13	24439481	.	G	A	5	7	12	1	0	13	0	0
13	24439487	.	G	T	5	7	12	1	0	13	0	0
13	24447235	.	T	G	4	3	7	0	0	7	0	0
13	24447364	.	G	C	9	7	16	0	2	18	0	0
13	24519762	.	T	C	2	1	3	0	1	4	0	0
13	24519798	.	G	A	0	4	4	0	4	8	0	0
13	24519911	.	G	A	3	4	7	0	1	8	0	0
13	24519921	.	G	T	0	4	4	0	4	8	0	0
13	24520591	.	T	C	2	2	4	0	0	4	0	0
13	24521858	.	T	A	4	2	6	0	0	6	0	0
13	24521927	.	G	A	4	3	7	0	1	8	0	0
13	24522025	.	A	G	3	3	6	0	0	6	0	0
13	24522356	.	T	C	1	2	3	0	0	3	0	0
13	24523469	.	G	A	1	7	8	0	8	16	0	0
13	24524206	.	G	A	6	6	12	0	0	12	0	0
13	24552508	.	C	T	9	4	13	0	0	13	0	0
13	24580372	.	G	A	15	22	37	1	1	39	0	0
13	24580411	.	G	A	15	25	40	1	0	41	0	0
13	24580705	.	C	T	10	18	28	0	1	29	0	0
13	24580756	.	G	C	2	16	18	0	20	38	0	0
13	24580869	.	T	C	17	15	32	0	1	33	0	0
13	24580941	.	T	C	16	15	31	0	2	33	0	0
13	24581274	.	G	A	26	17	43	0	0	43	0	0
13	24581316	.	C	A	22	21	43	0	3	46	0	0
13	24581334	.	G	C	21	21	42	0	3	45	0	0
13	24581358	.	T	C	18	19	37	0	2	39	0	0
13	24581748	.	A	C	11	17	28	0	1	29	0	0
13	24581798	.	T	A	10	8	18	0	2	20	0	0
13	24581840	.	T	G	20	14	34	0	0	34	0	0
13	24581854	.	C	T	21	16	37	0	0	37	0	0
13	24582047	.	A	G	11	9	20	0	0	20	0	0
13	24582110	.	C	T	8	8	16	0	0	16	0	0
13	24582122	.	T	C	8	6	14	0	0	14	0	0
13	24582211	.	C	T	6	7	13	0	1	14	0	0
13	24582213	.	G	A	7	6	13	0	0	13	0	0
13	24585402	.	T	A	1	4	5	0	0	5	0	0
13	24585753	.	G	T	2	5	7	0	0	7	0	0
13	24662438	.	T	G	1	4	5	0	0	5	0	0
13	24663222	.	G	C	0	4	4	0	4	8	0	0
13	24663407	.	T	A	2	4	6	0	0	6	0	0
13	24663414	.	C	A	4	2	6	0	0	6	0	0
13	24663456	.	A	G	2	4	6	0	0	6	0	0
13	24663504	.	C	A	1	1	2	0	1	3	0	0
13	24663673	.	A	T	2	2	4	0	0	4	0	0
13	24663899	.	C	A	2	2	4	0	0	4	0	0
13	24663901	.	A	G	2	2	4	0	0	4	0	0
13	24664144	.	T	A	0	4	4	0	1	5	0	0
13	24664367	.	A	G	0	2	2	0	1	3	0	0
13	24664371	.	C	G	0	2	2	0	1	3	0	0
13	24665759	.	T	G	7	4	11	0	0	11	0	0
13	24665869	.	C	T	2	5	7	0	0	7	0	0
13	24702033	.	C	A	2	5	7	0	9	16	0	0
13	24702114	.	T	C	8	7	15	0	1	16	0	0
13	24702198	.	T	C	9	3	12	0	0	12	0	0
13	24702220	.	T	C	7	3	10	0	0	10	0	0
13	24702415	.	T	C	10	9	19	0	1	20	0	0
13	24702478	.	T	G	10	7	17	0	1	18	0	0
13	24702602	.	T	A	10	6	16	0	2	18	0	0
13	24702652	.	A	T	9	4	13	0	0	13	0	0
13	24702724	.	C	T	2	3	5	0	1	6	0	0
13	24702883	.	A	T	8	13	21	0	3	24	0	0
13	24703276	.	C	T	2	3	5	0	0	5	0	0
13	24703354	.	C	A	5	5	10	0	0	10	0	0
13	24703362	.	C	A	6	3	9	0	0	9	0	0
13	24703411	.	A	T	3	10	13	0	1	14	0	0
13	24704102	.	C	A	9	9	18	0	1	19	0	0
13	24716363	.	T	C	6	2	8	0	0	8	0	0
13	24740248	.	T	C	1	2	3	0	0	3	0	0
13	24743201	.	A	G	1	2	3	0	0	3	0	0
13	24743206	.	T	C	1	2	3	0	0	3	0	0
13	24744587	.	C	T	1	4	5	0	0	5	0	0
13	24744704	.	A	T	2	4	6	0	0	6	0	0
13	24781536	.	G	A	12	11	23	0	0	23	0	0
13	24781580	.	T	C	8	13	21	0	2	23	0	0
13	24781605	.	T	C	12	15	27	0	0	27	0	0
13	24781640	.	G	A	11	14	25	0	0	25	0	0
13	24781713	.	A	G	10	10	20	0	0	20	0	0
13	24781885	.	G	A	16	9	25	0	0	25	0	0
13	24786900	.	T	A	20	11	31	0	5	36	0	0
13	24791077	.	G	T	4	2	6	0	0	6	0	0
13	24804104	.	C	T	9	5	14	0	1	15	0	0
13	24804224	.	G	C	3	10	13	0	0	13	0	0
13	24804765	.	C	T	3	6	9	0	2	11	0	0
13	24804804	.	A	G	3	6	9	0	0	9	0	0
13	24805068	.	A	C	8	6	14	0	1	15	0	0
13	24805148	.	A	C	4	4	8	0	0	8	0	0
13	24805257	.	T	C	5	0	5	0	3	8	0	0
13	24805687	.	G	A	6	6	12	0	0	12	0	0
13	24806423	.	T	C	4	0	4	0	7	11	0	0
13	24834446	.	C	T	15	8	23	0	0	24	1	0
13	24837627	.	A	G	13	19	32	0	0	32	0	0
13	24837876	.	T	C	4	9	13	0	0	13	0	0
13	24837940	.	T	C	2	3	5	0	1	6	0	0
13	24871866	.	A	G	14	9	23	0	1	24	0	0
13	24872667	.	A	G	11	10	21	0	2	23	0	0
13	24872733	.	G	A	11	9	20	0	0	20	0	0
13	24873141	.	C	A	1	13	14	0	5	19	0	0
13	24873186	.	A	T	7	9	16	0	0	16	0	0
13	24873480	.	A	G	15	10	25	0	0	25	0	0
13	24873579	.	C	T	11	8	19	0	0	19	0	0
13	24874897	.	G	A	12	10	22	0	0	22	0	0
13	24875948	.	A	C	10	9	19	0	0	19	0	0
13	24878633	.	A	T	5	4	9	0	0	9	0	0
13	24878687	.	T	C	3	5	8	0	0	8	0	0
13	24885195	.	G	A	4	4	8	0	1	9	0	0
13	24905897	.	G	A	4	6	10	0	0	10	0	0
13	24906196	.	A	T	5	2	7	0	0	7	0	0
13	24918814	.	T	A	8	8	16	0	2	18	0	0
13	24918820	.	T	C	6	9	15	0	2	17	0	0
13	24986203	.	G	A	9	15	24	0	0	24	0	0
13	24986238	.	G	T	6	18	24	0	0	24	0	0
13	24986272	.	T	C	4	0	4	0	14	18	0	0
13	25199240	.	T	C	1	0	1	0	7	8	0	0
13	25207064	.	G	C	8	2	10	0	0	10	0	0
13	25207068	.	C	T	5	2	7	0	0	7	0	0
13	25208177	.	A	G	4	2	6	0	0	6	0	0
13	25208276	.	A	G	2	8	10	0	0	10	0	0
13	25208484	.	T	G	2	4	6	0	0	6	0	0
13	25208545	.	T	A	5	4	9	0	0	9	0	0
13	25208605	.	A	T	3	3	6	0	0	6	0	0
13	25208692	.	A	T	2	3	5	0	0	5	0	0
13	25212429	.	T	C	5	2	7	0	0	7	0	0
13	25214739	.	G	A	6	4	10	0	1	11	0	0
13	25222407	.	C	T	2	4	6	0	0	6	0	0
13	25242602	.	C	T	3	3	6	0	0	6	0	0
13	25365034	.	G	A	4	10	14	0	0	14	0	0
13	25366380	.	T	G	3	6	9	0	0	9	0	0
13	25369449	.	C	T	12	7	19	0	0	19	0	0
13	25371436	.	A	G	14	7	21	0	0	21	0	0
13	25371475	.	C	A	11	7	18	0	0	18	0	0
13	25371918	.	A	G	13	7	20	0	1	21	0	0
13	25378924	.	T	G	14	10	24	0	0	24	0	0
13	25379263	.	A	T	21	18	39	0	0	39	0	0
13	25379304	.	A	G	15	1	16	0	10	26	0	0
13	25379352	.	A	C	11	14	25	0	1	26	0	0
13	25384281	.	T	C	8	6	14	0	0	14	0	0
13	25386904	.	C	T	14	4	18	0	0	18	0	0
13	25388764	.	T	G	5	0	5	0	5	10	0	0
13	25429048	.	T	A	8	13	21	0	0	21	0	0
13	25429145	.	G	A	7	4	11	0	0	11	0	0
13	25429158	.	G	A	4	7	11	0	0	11	0	0
13	25436360	.	A	T	9	6	15	0	1	16	0	0
13	25449688	.	A	C	3	3	6	0	0	6	0	0
13	25449867	.	C	A	2	3	5	0	0	5	0	0
13	25450114	.	G	A	1	3	4	0	1	5	0	0
13	25472084	.	C	T	6	4	10	0	0	10	0	0
13	25472336	.	G	A	25	14	39	0	1	40	0	0
13	25472735	.	G	A	14	16	30	0	1	31	0	0
13	25472859	.	G	A	17	17	34	0	0	34	0	0
13	25473084	.	T	A	26	26	52	0	0	52	0	0
13	25473325	.	G	A	18	9	27	0	2	29	0	0
13	25474019	.	G	T	14	17	31	0	0	31	0	0
13	25475904	.	A	G	17	23	40	0	0	40	0	0
13	25477304	.	A	G	10	4	14	0	0	14	0	0
13	25478897	.	G	A	5	5	10	0	0	10	0	0
13	25495556	.	C	T	6	8	14	0	0	14	0	0
13	25495781	.	G	A	16	10	26	0	1	27	0	0
13	25497320	.	A	G	14	0	14	0	11	25	0	0
13	25497575	.	T	C	11	7	18	0	1	19	0	0
13	25497581	.	C	T	11	8	19	0	0	19	0	0
13	25497700	.	G	C	12	11	23	0	0	23	0	0
13	25497769	.	T	A	10	13	23	0	1	24	0	0
13	25516204	.	T	C	9	6	15	0	0	15	0	0
13	25519063	.	G	A	0	5	5	0	4	9	0	0
13	25521858	.	T	C	4	4	8	0	0	8	0	0
13	25523629	.	T	C	6	8	14	0	0	14	0	0
13	25523677	.	G	A	2	11	13	0	9	22	0	0
13	25523680	.	T	A	11	10	21	0	1	22	0	0
13	25525989	.	G	A	5	7	12	0	0	12	0	0
13	25531776	.	T	C	10	13	23	0	1	24	0	0
13	25532352	.	C	T	18	12	30	0	0	30	0	0
13	25532574	.	C	A	15	13	28	0	1	29	0	0
13	25532857	.	A	G	9	7	16	0	1	17	0	0
13	25533233	.	G	A	12	19	31	0	0	31	0	0
13	25533258	.	T	A	9	17	26	0	1	27	0	0
13	25533452	.	A	T	14	3	17	0	2	19	0	0
13	25533657	.	C	G	12	0	12	0	12	24	0	0
13	25533767	.	G	T	12	15	27	0	0	27	0	0
13	25533846	.	G	A	13	9	22	0	0	22	0	0
13	25533897	.	C	T	5	3	8	0	0	8	0	0
13	25534172	.	T	A	13	7	20	0	1	21	0	0
13	25534368	.	A	G	26	1	27	0	11	38	0	0
13	25534551	.	G	A	3	5	8	0	0	8	0	0
13	25534897	.	G	A	0	2	2	0	2	4	0	0
13	25542772	.	C	T	1	2	3	0	0	3	0	0
13	25549516	.	A	G	4	0	4	0	9	13	0	0
13	25551722	.	A	G	3	0	3	0	5	8	0	0
13	25551781	.	C	A	6	4	10	0	1	11	0	0
13	25551865	.	T	C	11	9	20	1	0	21	0	0
13	25552219	.	T	C	4	5	9	0	0	9	0	0
13	25560411	.	C	A	1	8	9	0	1	10	0	0
13	25560458	.	A	T	6	7	13	0	2	15	0	0
13	25560471	.	G	A	0	2	2	0	11	13	0	0
13	25563221	.	C	A	3	3	6	0	1	7	0	0
13	25565379	.	T	C	10	9	19	0	1	20	0	0
13	25565985	.	G	A	4	6	10	0	1	11	0	0
13	25565988	.	A	C	4	7	11	0	0	11	0	0
13	25569940	.	A	C	8	5	13	0	1	14	0	0
13	25570044	.	C	T	1	3	4	0	3	7	0	0
13	25570104	.	C	T	6	7	13	0	0	13	0	0
13	25570341	.	T	C	3	0	3	0	5	8	0	0
13	25570410	.	A	G	11	10	21	0	0	21	0	0
13	25570477	.	G	A	9	8	17	0	1	18	0	0
13	25570532	.	A	C	12	0	12	0	6	18	0	0
13	25570618	.	A	T	6	7	13	0	0	13	0	0
13	25570709	.	T	C	8	0	8	0	7	15	0	0
13	25570715	.	C	T	8	6	14	0	0	14	0	0
13	25570854	.	A	T	10	7	17	1	2	20	0	0
13	25571038	.	T	C	11	3	14	0	1	15	0	0
13	25571113	.	A	T	9	3	12	0	1	13	0	0
13	25571274	.	C	T	8	11	19	0	1	20	0	0
13	25573146	.	T	C	8	0	8	0	4	12	0	0
13	25575396	.	C	T	9	6	15	0	0	15	0	0
13	25575411	.	A	C	9	5	14	0	0	14	0	0
13	25580764	.	C	A	6	5	11	0	1	12	0	0
13	25584983	.	T	G	2	1	3	0	2	5	0	0
13	25584993	.	A	T	3	2	5	0	0	5	0	0
13	25586031	.	C	T	1	4	5	0	0	5	0	0
13	25589241	.	G	A	7	4	11	0	1	12	0	0
13	25592311	.	C	A	2	2	4	0	0	4	0	0
13	25592347	.	T	C	5	2	7	0	0	7	0	0
13	25593832	.	T	C	1	3	4	0	0	4	0	0
13	25726201	.	C	T	6	7	13	0	1	14	0	0
13	25728453	.	A	C	6	7	13	0	1	14	0	0
13	25728606	.	A	T	7	5	12	0	0	12	0	0
13	25729076	.	C	T	3	2	5	0	0	5	0	0
13	25735324	.	C	A	0	2	2	0	1	3	0	0
13	25737993	.	G	A	2	5	7	0	0	7	0	0
13	25740472	.	G	A	1	2	3	0	0	3	0	0
13	25763104	.	T	A	1	3	4	0	0	4	0	0
13	25819790	.	A	T	2	2	4	0	0	4	0	0
13	25824718	.	C	T	16	16	32	0	2	34	0	0
13	25825016	.	G	A	17	24	41	0	1	42	0	0
13	25825445	.	A	T	8	7	15	0	0	15	0	0
13	25826426	.	G	C	1	2	3	0	0	3	0	0
13	25827421	.	G	A	18	17	35	0	0	35	0	0
13	25849511	.	T	C	4	1	5	0	2	7	0	0
13	25923392	.	A	G	15	11	26	0	7	33	0	0
13	25923450	.	A	T	9	15	24	0	3	27	0	0
13	25924388	.	C	T	14	6	20	0	0	20	0	0
13	25924523	.	C	T	13	5	18	0	2	20	0	0
13	27036582	.	T	C	5	0	5	0	4	9	0	0
13	27036660	.	T	C	8	8	16	0	1	17	0	0
13	27107520	.	C	T	7	13	20	0	1	21	0	0
13	27189877	.	A	T	5	11	16	0	1	17	0	0
13	27190435	.	C	T	10	14	24	0	0	24	0	0
13	27201552	.	G	A	6	4	10	0	0	10	0	0
13	27201624	.	A	T	8	7	15	0	1	16	0	0
13	27209852	.	T	C	12	15	27	0	0	27	0	0
13	27227407	.	C	A	6	6	12	1	0	13	0	0
13	27227449	.	A	G	3	5	8	0	0	8	0	0
13	27232456	.	A	G	2	4	6	0	0	6	0	0
13	27232479	.	C	A	2	2	4	0	0	4	0	0
13	27277351	.	A	G	3	0	3	0	4	7	0	0
13	27277579	.	C	T	3	4	7	0	0	7	0	0
13	27294016	.	A	T	1	2	3	0	1	4	0	0
13	27294029	.	G	A	0	2	2	0	1	3	0	0
13	27294107	.	A	T	5	4	9	0	0	9	0	0
13	27294108	.	T	A	5	4	9	0	0	9	0	0
13	27294656	.	G	A	2	2	4	0	1	5	0	0
13	27294663	.	C	T	3	4	7	0	0	7	0	0
13	27294762	.	C	T	3	3	6	0	0	6	0	0
13	27294763	.	A	G	3	3	6	0	0	6	0	0
13	27294824	.	G	A	2	2	4	0	0	4	0	0
13	27295080	.	T	C	4	2	6	0	0	6	0	0
13	27295138	.	G	A	2	1	3	0	1	4	0	0
13	27295149	.	A	G	2	2	4	0	0	4	0	0
13	27295173	.	C	T	5	2	7	0	0	7	0	0
13	27295459	.	T	C	3	5	8	0	0	8	0	0
13	27295488	.	C	T	3	7	10	0	0	10	0	0
13	27295576	.	G	A	4	4	8	0	0	8	0	0
13	27295578	.	C	T	4	4	8	0	0	8	0	0
13	27296278	.	A	G	2	7	9	0	0	10	1	0
13	27296291	.	T	C	4	8	12	0	1	13	0	0
13	27296396	.	G	A	3	6	9	0	0	9	0	0
13	27296415	.	T	A	5	5	10	0	1	11	0	0
13	27296433	.	A	G	9	4	13	0	0	13	0	0
13	27296576	.	C	T	9	3	12	0	0	12	0	0
13	27296616	.	T	C	9	3	12	0	1	13	0	0
13	27296869	.	T	C	1	2	3	0	0	3	0	0
13	27309128	.	T	G	7	0	7	0	11	18	0	0
13	27312888	.	G	A	5	4	9	0	1	10	0	0
13	27312938	.	C	T	1	6	7	0	0	7	0	0
13	27313044	.	A	C	3	2	5	0	0	5	0	0
13	27313066	.	G	T	4	4	8	0	0	8	0	0
13	27313310	.	T	A	9	10	19	0	1	20	0	0
13	27316778	.	G	T	5	2	7	0	1	8	0	0
13	27317026	.	C	T	31	21	52	0	1	53	0	0
13	27320771	.	C	T	27	21	48	0	1	49	0	0
13	27320996	.	G	A	5	22	27	0	39	66	0	0
13	27321211	.	C	T	31	33	64	0	7	71	0	0
13	27323976	.	G	A	6	39	45	0	31	76	0	0
13	27324341	.	A	T	30	28	58	0	2	60	0	0
13	27324346	.	T	C	30	29	59	0	2	61	0	0
13	27379181	.	C	T	0	2	2	0	2	4	0	0
13	27379214	.	T	A	1	2	3	0	0	3	0	0
13	27634324	.	T	C	16	22	38	0	0	38	0	0
13	27634789	.	A	G	17	14	31	0	3	34	0	0
13	27641472	.	T	C	12	27	39	0	1	40	0	0
13	27675462	.	T	C	10	0	10	0	11	21	0	0
13	27685329	.	C	T	1	8	9	0	17	26	0	0
13	27685363	.	G	A	8	18	26	0	0	26	0	0
13	27685446	.	C	T	16	10	26	0	1	27	0	0
13	27685552	.	G	A	14	15	29	0	4	33	0	0
13	27685583	.	C	T	2	13	15	0	19	34	0	0
13	27686252	.	G	A	10	18	28	0	1	29	0	0
13	27686405	.	G	A	23	28	51	0	0	51	0	0
13	27771607	.	T	G	6	0	6	0	9	15	0	0
13	27782402	.	A	T	9	8	17	0	0	17	0	0
13	27951758	.	T	A	9	13	22	0	3	25	0	0
13	27951827	.	G	A	0	5	5	0	8	13	0	0
13	27951883	.	A	G	9	0	9	0	8	17	0	0
13	27952156	.	C	T	13	16	29	0	0	29	0	0
13	27952414	.	A	G	22	12	34	0	0	34	0	0
13	27952441	.	G	T	26	13	39	0	0	39	0	0
13	28009108	.	C	T	18	11	29	0	1	30	0	0
13	28009159	.	G	A	14	19	33	2	1	36	0	0
13	28009178	.	A	C	12	19	31	2	2	35	0	0
13	28009246	.	A	T	19	14	33	0	0	33	0	0
13	28009567	.	G	A	18	7	25	0	3	28	0	0
13	28010183	.	G	A	18	25	43	0	1	44	0	0
13	28010214	.	C	A	8	27	35	0	24	59	0	0
13	28495945	.	C	T	2	4	6	0	0	6	0	0
13	28500674	.	T	C	6	4	10	0	1	11	0	0
13	28561116	.	T	C	1	4	5	0	0	5	0	0
13	28561184	.	T	C	5	3	8	0	0	8	0	0
13	28561190	.	A	T	5	3	8	0	1	9	0	0
13	28561244	.	G	C	7	7	14	0	0	14	0	0
13	28596166	.	T	C	8	6	14	0	1	15	0	0
13	28615556	.	C	T	3	10	13	0	0	13	0	0
13	28615622	.	T	C	2	5	7	0	0	7	0	0
13	28619373	.	T	G	2	2	4	0	0	4	0	0
13	28619558	.	T	C	2	3	5	0	0	5	0	0
13	28632432	.	A	G	1	3	4	0	0	4	0	0
13	28642816	.	A	C	2	5	7	0	0	7	0	0
13	28642825	.	C	A	5	2	7	0	0	7	0	0
13	28642876	.	C	T	2	2	4	0	0	4	0	0
13	28643087	.	C	T	11	5	16	0	0	16	0	0
13	28649848	.	A	C	10	9	19	0	1	20	0	0
13	28650239	.	A	T	13	14	27	0	0	27	0	0
13	28650416	.	G	C	17	6	23	0	0	23	0	0
13	28650683	.	A	G	14	19	33	0	0	33	0	0
13	28650731	.	A	C	8	0	8	0	13	22	1	0
13	28650945	.	T	C	16	13	29	0	1	31	1	0
13	28650954	.	T	G	14	15	29	0	1	30	0	0
13	28650984	.	A	G	12	15	27	0	1	28	0	0
13	28651214	.	C	A	3	16	19	0	23	42	0	0
13	28668942	.	G	C	2	6	8	0	1	9	0	0
13	28676134	.	G	C	5	9	14	0	0	14	0	0
13	28676241	.	A	G	6	6	12	0	1	13	0	0
13	28676358	.	G	A	9	7	16	0	0	16	0	0
13	28676472	.	C	G	8	0	8	0	10	18	0	0
13	28680634	.	T	A	7	11	18	0	0	18	0	0
13	28680847	.	T	A	4	5	9	0	0	9	0	0
13	28692778	.	C	T	4	9	13	1	0	14	0	0
13	28694384	.	C	A	2	12	14	0	2	16	0	0
13	28694390	.	C	T	2	11	13	0	0	13	0	0
13	28694664	.	T	C	2	9	11	0	0	11	0	0
13	28701246	.	G	A	2	7	9	0	9	18	0	0
13	28743835	.	C	T	15	16	31	0	1	32	0	0
13	28744061	.	C	A	5	3	8	0	0	8	0	0
13	28744495	.	G	A	4	16	20	0	21	41	0	0
13	28744775	.	C	T	7	13	20	0	1	21	0	0
13	28744831	.	C	T	13	9	22	0	1	23	0	0
13	28744976	.	C	T	6	7	13	0	0	13	0	0
13	28745801	.	T	G	6	22	28	1	0	30	1	0
13	28745934	.	C	A	2	8	10	0	1	11	0	0
13	28746033	.	G	A	7	11	18	0	1	19	0	0
13	28773967	.	G	A	0	2	2	0	1	3	0	0
13	28786409	.	G	A	4	5	9	0	2	11	0	0
13	28786565	.	T	C	1	2	3	0	0	3	0	0
13	28827315	.	T	A	6	5	11	0	1	12	0	0
13	28841987	.	C	T	16	11	27	0	1	28	0	0
13	28841990	.	G	T	17	11	28	0	0	28	0	0
13	28848209	.	C	G	15	6	21	0	3	24	0	0
13	28848220	.	G	A	14	9	23	0	2	25	0	0
13	28848473	.	C	T	14	17	31	0	1	32	0	0
13	28865700	.	T	C	15	19	34	0	6	40	0	0
13	28866413	.	A	T	24	24	48	0	3	51	0	0
13	28866518	.	C	T	29	13	42	0	5	47	0	0
13	28866590	.	A	G	28	14	42	0	1	43	0	0
13	28866615	.	C	T	30	14	44	0	1	45	0	0
13	28866722	.	T	C	19	25	44	0	1	45	0	0
13	28866810	.	G	A	22	21	43	0	2	45	0	0
13	28866857	.	G	A	4	21	25	0	21	46	0	0
13	28867159	.	G	A	3	17	20	0	29	49	0	0
13	28867367	.	C	T	17	22	39	0	3	42	0	0
13	28867382	.	A	T	24	17	41	0	4	45	0	0
13	28870917	.	T	C	33	40	73	0	6	79	0	0
13	28871055	.	T	C	21	28	49	0	0	49	0	0
13	28901714	.	T	A	18	36	54	0	1	55	0	0
13	28902058	.	C	T	19	16	35	0	5	40	0	0
13	28902169	.	C	T	15	14	29	0	0	29	0	0
13	28902170	.	C	G	15	14	29	0	1	30	0	0
13	28902215	.	T	C	13	16	29	0	1	30	0	0
13	29208737	.	T	C	3	6	9	0	0	9	0	0
13	29208761	.	G	A	1	6	7	0	1	8	0	0
13	29223894	.	G	A	0	2	2	0	2	4	0	0
13	29295759	.	A	C	4	3	7	0	0	7	0	0
13	29296028	.	T	C	3	2	5	0	0	5	0	0
13	29296096	.	G	C	8	6	14	0	0	14	0	0
13	29298856	.	G	T	0	2	2	0	4	6	0	0
13	29346927	.	G	A	1	5	6	0	7	13	0	0
13	29347156	.	G	A	2	6	8	0	4	12	0	0
13	29347170	.	G	A	6	7	13	0	0	13	0	0
13	29347745	.	A	C	8	14	22	0	0	22	0	0
13	29357115	.	T	A	3	4	7	0	0	7	0	0
13	29374514	.	C	T	5	5	10	0	0	10	0	0
13	29381047	.	A	C	5	10	15	0	0	15	0	0
13	29385786	.	A	G	14	9	23	0	0	23	0	0
13	29385894	.	G	A	8	7	15	0	1	16	0	0
13	29392238	.	C	T	7	5	12	0	1	13	0	0
13	29395207	.	C	A	11	13	24	0	0	24	0	0
13	29395236	.	C	T	12	11	23	0	0	23	0	0
13	29402613	.	T	G	11	5	16	0	0	16	0	0
13	29402669	.	C	T	9	11	20	0	0	20	0	0
13	29402681	.	A	C	7	13	20	0	0	20	0	0
13	29403957	.	C	T	11	9	20	0	3	23	0	0
13	29404003	.	G	A	6	8	14	0	1	15	0	0
13	29404145	.	T	C	7	5	12	0	2	14	0	0
13	29404218	.	T	A	11	6	17	0	0	17	0	0
13	29404399	.	A	T	9	13	22	0	3	26	1	0
13	29404400	.	C	T	9	15	24	0	2	26	0	0
13	29404754	.	T	A	8	3	11	0	0	11	0	0
13	29404997	.	C	T	1	1	2	0	1	3	0	0
13	29407802	.	T	G	8	8	16	0	2	19	1	0
13	29408226	.	T	C	4	8	12	0	0	12	0	0
13	29408499	.	G	A	12	13	25	2	2	29	0	0
13	29408530	.	C	T	7	5	12	2	1	15	0	0
13	29408650	.	A	G	13	4	17	0	0	17	0	0
13	29408989	.	G	A	9	11	20	0	0	20	0	0
13	29409239	.	G	A	4	12	16	0	0	16	0	0
13	29409265	.	C	T	1	10	11	0	1	12	0	0
13	29412299	.	G	A	15	9	24	0	1	25	0	0
13	29414441	.	G	C	8	9	17	0	0	17	0	0
13	29414546	.	A	G	6	9	15	0	1	16	0	0
13	29415202	.	G	A	5	10	15	0	0	15	0	0
13	29417091	.	G	A	10	9	19	0	0	19	0	0
13	29420849	.	A	T	6	7	13	0	0	13	0	0
13	29421211	.	G	T	8	8	16	0	0	16	0	0
13	29421296	.	C	T	8	7	15	0	1	16	0	0
13	29422112	.	G	A	1	3	4	0	0	4	0	0
13	29422459	.	C	T	8	3	11	0	0	11	0	0
13	29422499	.	C	G	1	6	7	0	5	12	0	0
13	29422808	.	G	A	4	9	13	0	0	13	0	0
13	29449256	.	G	A	15	14	29	0	0	29	0	0
13	29450479	.	T	C	3	4	7	0	0	7	0	0
13	29455199	.	C	T	9	6	15	0	0	15	0	0
13	29455573	.	A	G	7	4	11	0	1	12	0	0
13	29771323	.	T	C	5	2	7	0	0	7	0	0
13	29802607	.	C	A	15	9	24	0	1	25	0	0
13	29802633	.	A	G	7	13	20	0	0	20	0	0
13	29803253	.	C	T	3	8	11	0	0	11	0	0
13	29803801	.	G	A	8	3	11	0	0	11	0	0
13	29804178	.	T	A	13	4	17	0	0	17	0	0
13	29804362	.	T	C	6	4	10	0	0	10	0	0
13	29804800	.	G	A	1	2	3	0	1	4	0	0
13	29925560	.	A	T	3	3	6	0	3	9	0	0
13	29926221	.	G	A	4	4	8	0	0	8	0	0
13	29926242	.	C	T	5	4	9	0	1	10	0	0
13	29928675	.	A	G	7	4	11	0	0	11	0	0
13	29935371	.	A	G	3	5	8	0	3	11	0	0
13	29935678	.	T	G	3	5	8	0	1	9	0	0
13	29935682	.	T	C	4	5	9	0	0	9	0	0
13	29935885	.	C	A	1	3	4	0	0	4	0	0
13	29952902	.	C	T	7	5	12	0	1	13	0	0
13	29952914	.	G	A	8	5	13	0	1	14	0	0
13	29953265	.	T	G	6	5	11	0	2	13	0	0
13	29953267	.	C	A	7	6	13	0	1	14	0	0
13	29953383	.	G	T	8	7	15	0	0	15	0	0
13	29953522	.	T	C	9	0	9	0	6	15	0	0
13	29958513	.	T	A	13	14	27	0	2	29	0	0
13	29958551	.	G	A	11	17	28	0	2	30	0	0
13	29958725	.	A	G	10	11	21	0	0	21	0	0
13	29965856	.	G	A	9	4	13	0	1	14	0	0
13	29979966	.	T	C	9	8	17	0	0	17	0	0
13	29991558	.	G	A	1	2	3	0	0	3	0	0
13	30008147	.	G	A	1	3	4	0	0	4	0	0
13	30008596	.	A	T	29	22	51	0	1	52	0	0
13	30008631	.	T	C	24	19	43	0	3	46	0	0
13	30008737	.	T	C	24	23	47	0	0	47	0	0
13	30009128	.	G	C	4	5	9	0	0	9	0	0
13	30009818	.	A	C	18	33	51	0	1	52	0	0
13	30010059	.	C	A	27	17	44	0	1	45	0	0
13	30010137	.	T	C	41	12	53	1	0	54	0	0
13	30021321	.	T	A	21	25	46	0	1	47	0	0
13	30027133	.	T	G	20	18	38	0	2	40	0	0
13	30027372	.	G	A	2	10	12	0	0	12	0	0
13	30027378	.	G	A	2	10	12	0	0	12	0	0
13	30027523	.	T	A	21	18	39	0	0	39	0	0
13	30027659	.	C	T	7	6	13	0	0	13	0	0
13	30033597	.	C	T	2	2	4	0	0	4	0	0
13	30039013	.	C	T	12	5	17	0	0	17	0	0
13	30041662	.	G	A	8	13	21	0	1	22	0	0
13	30043579	.	A	G	9	8	17	0	1	18	0	0
13	30055098	.	C	T	2	8	10	0	1	11	0	0
13	30083348	.	A	C	19	18	37	0	5	42	0	0
13	30106137	.	C	G	22	0	22	0	18	40	0	0
13	30112396	.	C	T	22	27	49	0	4	53	0	0
13	30112414	.	T	A	27	27	54	0	0	54	0	0
13	30115125	.	A	G	27	27	54	0	4	58	0	0
13	30115217	.	C	T	29	23	52	0	0	52	0	0
13	30125106	.	G	A	25	16	41	0	8	49	0	0
13	30125107	.	T	C	27	22	49	0	1	50	0	0
13	30128388	.	A	T	31	25	56	0	1	57	0	0
13	30131722	.	G	T	17	26	43	0	1	44	0	0
13	30131804	.	G	A	24	23	47	0	0	47	0	0
13	30132190	.	T	C	30	25	55	0	3	58	0	0
13	30138763	.	T	A	2	3	5	0	0	5	0	0
13	30138790	.	C	T	2	3	5	0	0	5	0	0
13	30145217	.	A	G	3	4	7	0	0	7	0	0
13	30145514	.	T	A	3	4	7	0	0	7	0	0
13	30145616	.	T	A	2	6	8	0	0	8	0	0
13	30145660	.	T	C	1	5	6	0	1	7	0	0
13	30145662	.	C	A	0	5	5	0	2	7	0	0
13	30146199	.	C	A	3	3	6	0	0	6	0	0
13	30146447	.	T	A	4	7	11	0	0	11	0	0
13	30152310	.	A	C	6	6	12	0	0	12	0	0
13	30152502	.	G	C	22	15	37	0	1	38	0	0
13	30155934	.	C	T	12	18	30	1	3	34	0	0
13	30155973	.	T	A	11	15	26	0	1	27	0	0
13	30156176	.	T	C	16	12	28	0	0	28	0	0
13	30156347	.	A	T	14	15	29	0	1	30	0	0
13	30158975	.	A	G	8	12	20	0	0	20	0	0
13	30159823	.	C	T	11	13	24	0	3	27	0	0
13	30161553	.	T	A	12	9	21	0	4	25	0	0
13	30166340	.	C	A	22	20	42	0	0	42	0	0
13	30167430	.	T	G	17	15	32	0	1	33	0	0
13	30167432	.	A	G	18	15	33	0	1	34	0	0
13	30167711	.	G	A	19	24	43	0	0	43	0	0
13	30167716	.	T	C	19	22	41	0	2	43	0	0
13	30167807	.	G	A	1	17	18	0	26	44	0	0
13	30168662	.	T	A	24	16	40	0	0	40	0	0
13	30181124	.	T	G	1	2	3	0	0	3	0	0
13	30181125	.	T	G	1	2	3	0	0	3	0	0
13	30186853	.	G	A	2	6	8	0	1	9	0	0
13	30186857	.	A	G	2	0	2	0	7	9	0	0
13	30186997	.	C	T	4	6	10	0	1	11	0	0
13	30190019	.	A	T	4	3	7	0	1	8	0	0
13	30190031	.	C	T	3	5	8	0	1	9	0	0
13	30199107	.	T	G	10	12	22	0	0	23	1	0
13	30199148	.	G	A	11	9	20	0	0	20	0	0
13	30199190	.	T	C	6	8	14	0	0	14	0	0
13	30199210	.	T	C	5	8	13	0	0	13	0	0
13	30199225	.	T	C	2	8	10	0	1	11	0	0
13	30199255	.	C	T	5	3	8	0	1	9	0	0
13	30199424	.	A	T	4	2	6	0	0	6	0	0
13	30229090	.	A	G	31	2	33	0	33	67	1	0
13	30233273	.	T	A	2	2	4	0	0	4	0	0
13	30233353	.	A	G	2	3	5	0	0	5	0	0
13	30234351	.	A	C	14	16	30	0	2	32	0	0
13	30235107	.	G	C	2	6	8	0	0	8	0	0
13	30474859	.	A	T	8	8	16	0	0	16	0	0
13	30498325	.	A	G	8	0	8	0	7	15	0	0
13	30551479	.	T	C	6	11	17	0	0	17	0	0
13	30552253	.	A	G	5	1	6	0	7	13	0	0
13	30552504	.	T	A	8	5	13	0	0	13	0	0
13	30552605	.	C	G	7	5	12	0	0	12	0	0
13	30552915	.	T	C	9	7	16	0	0	16	0	0
13	30553002	.	C	T	8	10	18	0	3	21	0	0
13	30553404	.	T	C	3	6	9	1	0	10	0	0
13	30553682	.	C	T	7	12	19	0	2	21	0	0
13	30555751	.	G	A	10	15	25	0	0	25	0	0
13	30556278	.	C	T	13	10	23	0	0	23	0	0
13	30558555	.	C	A	10	8	18	0	2	20	0	0
13	30558896	.	T	C	5	9	14	0	0	14	0	0
13	30559044	.	A	G	8	5	13	0	0	13	0	0
13	30561686	.	G	T	3	12	15	0	14	29	0	0
13	30562079	.	T	G	6	10	16	0	0	16	0	0
13	30562673	.	T	C	19	14	33	0	1	34	0	0
13	30565066	.	T	G	2	1	3	0	2	5	0	0
13	30568158	.	T	C	5	9	14	0	0	14	0	0
13	30568176	.	A	G	6	0	6	0	12	18	0	0
13	30568316	.	T	A	10	10	20	0	0	20	0	0
13	30568875	.	A	G	13	10	23	0	3	26	0	0
13	30569650	.	A	C	4	3	7	0	0	7	0	0
13	30569687	.	A	G	7	6	13	0	0	13	0	0
13	30572778	.	C	T	9	3	12	0	0	12	0	0
13	30575206	.	G	A	10	10	20	0	0	20	0	0
13	30575325	.	A	G	4	9	13	0	2	15	0	0
13	30575452	.	C	A	6	5	11	0	0	11	0	0
13	30575637	.	T	A	7	3	10	0	1	11	0	0
13	30579552	.	A	G	7	3	10	0	1	11	0	0
13	30579565	.	A	G	7	4	11	0	0	11	0	0
13	30579792	.	T	C	2	0	2	0	4	6	0	0
13	30580465	.	T	G	3	5	8	0	0	8	0	0
13	30580493	.	T	C	3	4	7	0	1	8	0	0
13	30580641	.	C	G	1	4	5	0	0	5	0	0
13	30580935	.	T	C	3	0	3	0	9	12	0	0
13	30580966	.	T	G	6	5	11	0	1	12	0	0
13	30581329	.	C	T	0	6	6	0	4	10	0	0
13	30581334	.	A	T	3	7	10	0	0	10	0	0
13	30581686	.	A	T	4	6	10	0	0	10	0	0
13	30581755	.	C	T	4	7	11	0	0	11	0	0
13	30582174	.	C	T	1	3	4	0	3	7	0	0
13	30582347	.	T	C	4	0	4	0	4	8	0	0
13	30582393	.	A	G	3	1	4	0	1	5	0	0
13	30582397	.	A	G	5	2	7	0	0	7	0	0
13	30582461	.	T	C	8	0	8	0	3	11	0	0
13	30582468	.	A	G	8	3	11	0	0	11	0	0
13	30582729	.	G	A	2	5	7	0	0	7	0	0
13	30582746	.	C	T	0	6	6	0	2	8	0	0
13	30582781	.	G	A	4	2	6	0	0	6	0	0
13	30582931	.	T	C	3	3	6	0	0	6	0	0
13	30583036	.	C	G	3	4	7	0	0	7	0	0
13	30583056	.	A	G	3	2	5	0	0	5	0	0
13	30583140	.	G	C	2	4	6	0	1	7	0	0
13	30583293	.	T	G	2	2	4	0	0	4	0	0
13	30583306	.	T	C	2	3	5	0	0	5	0	0
13	30583336	.	A	G	3	4	7	0	0	7	0	0
13	30583514	.	T	C	2	3	5	0	0	5	0	0
13	30583573	.	A	G	2	2	4	0	0	4	0	0
13	30583664	.	T	A	4	3	7	0	0	7	0	0
13	30584007	.	G	A	2	2	4	0	0	4	0	0
13	30669296	.	C	A	2	5	7	3	0	10	0	0
13	30817617	.	G	T	6	12	18	0	1	19	0	0
13	30817633	.	G	A	7	11	18	0	0	18	0	0
13	30817786	.	A	G	5	5	10	2	0	12	0	0
13	30817790	.	A	G	5	1	6	2	3	11	0	0
13	30817872	.	A	G	7	0	7	0	10	17	0	0
13	30817951	.	C	T	13	9	22	0	0	22	0	0
13	30817983	.	T	C	16	6	22	0	0	22	0	0
13	30818107	.	C	G	14	10	24	0	1	25	0	0
13	30818246	.	C	T	13	19	32	0	1	33	0	0
13	30818319	.	A	T	5	9	14	0	0	14	0	0
13	30818674	.	G	A	0	2	2	0	2	4	0	0
13	30818849	.	A	G	14	9	23	2	0	25	0	0
13	30818876	.	C	T	11	14	25	0	2	27	0	0
13	30818986	.	T	A	16	17	33	0	2	35	0	0
13	30819133	.	G	C	21	25	46	0	1	47	0	0
13	30819334	.	T	C	19	14	33	1	5	39	0	0
13	30819444	.	A	T	12	11	23	0	4	27	0	0
13	30819445	.	T	G	16	10	26	0	1	27	0	0
13	30819645	.	T	C	4	8	12	0	0	12	0	0
13	30875163	.	T	C	2	2	4	0	0	4	0	0
13	30878624	.	A	T	2	3	5	0	0	5	0	0
13	30878744	.	T	C	1	3	4	0	0	4	0	0
13	30878903	.	A	G	3	5	8	0	0	8	0	0
13	30879062	.	G	A	4	7	11	0	0	11	0	0
13	30888494	.	T	C	3	4	7	0	0	7	0	0
13	30903345	.	A	G	5	3	8	0	0	8	0	0
13	30905716	.	T	C	11	5	16	0	0	16	0	0
13	30905827	.	G	A	0	7	7	0	7	14	0	0
13	30906016	.	A	G	4	2	6	1	0	7	0	0
13	30906190	.	A	T	5	3	8	0	1	9	0	0
13	30908977	.	T	C	10	3	13	0	0	13	0	0
13	30909200	.	C	T	5	2	7	0	1	8	0	0
13	30917890	.	C	A	1	2	3	1	0	4	0	0
13	32795615	.	G	A	1	2	3	0	0	3	0	0
13	33109560	.	A	G	2	2	4	0	0	4	0	0
13	33109593	.	G	A	2	3	5	0	0	5	0	0
13	33122120	.	G	A	4	12	16	0	0	16	0	0
13	33122276	.	T	A	6	5	11	0	0	11	0	0
13	33122429	.	C	G	10	6	16	0	0	16	0	0
13	33122524	.	C	T	6	5	11	0	1	12	0	0
13	33122554	.	A	T	7	5	12	0	1	13	0	0
13	33122586	.	G	A	12	2	14	0	0	14	0	0
13	33122756	.	A	G	11	14	25	0	0	25	0	0
13	33122773	.	G	T	12	15	27	0	0	27	0	0
13	33122795	.	C	A	8	13	21	0	1	22	0	0
13	33122941	.	C	T	15	7	22	0	1	23	0	0
13	33122949	.	G	C	17	5	22	0	0	22	0	0
13	33122986	.	A	G	7	0	7	0	13	20	0	0
13	33123031	.	T	A	6	12	18	0	0	18	0	0
13	33123154	.	C	A	10	6	16	0	1	17	0	0
13	33155746	.	T	G	2	2	4	0	0	4	0	0
13	33155750	.	T	C	2	2	4	0	0	4	0	0
13	33155907	.	T	C	2	3	5	0	1	6	0	0
13	33158301	.	A	G	4	3	7	0	0	7	0	0
13	33158304	.	C	A	1	3	4	0	3	7	0	0
13	33158352	.	T	C	2	2	4	0	0	4	0	0
13	33159446	.	C	T	0	2	2	0	1	3	0	0
13	33174415	.	A	T	5	4	9	0	2	11	0	0
13	33174865	.	T	G	5	7	12	0	0	12	0	0
13	33175097	.	A	C	8	7	15	0	0	15	0	0
13	33175190	.	A	G	10	12	22	0	0	22	0	0
13	33175202	.	T	C	8	0	8	0	10	18	0	0
13	33175314	.	A	G	5	7	12	0	0	12	0	0
13	33177425	.	G	T	9	5	14	0	2	16	0	0
13	33177637	.	A	G	16	12	28	0	1	29	0	0
13	33177682	.	C	G	1	8	9	0	7	16	0	0
13	33187199	.	G	A	3	5	8	0	0	8	0	0
13	33187388	.	T	C	3	9	12	0	0	12	0	0
13	33187760	.	G	A	10	5	15	0	0	15	0	0
13	33190245	.	A	G	7	2	9	0	0	9	0	0
13	33192619	.	C	A	1	3	4	0	1	5	0	0
13	33194242	.	C	T	6	5	11	0	0	11	0	0
13	33194245	.	A	G	5	4	9	0	1	10	0	0
13	33194458	.	G	A	3	7	10	0	0	10	0	0
13	33194490	.	A	C	5	5	10	0	0	10	0	0
13	33194527	.	G	C	7	4	11	0	1	12	0	0
13	33194854	.	A	T	9	3	12	0	1	13	0	0
13	33195115	.	C	T	5	5	10	0	1	11	0	0
13	33195489	.	C	T	0	5	5	0	3	8	0	0
13	33195529	.	T	C	1	7	8	0	0	8	0	0
13	33195964	.	C	T	2	5	7	0	0	7	0	0
13	33195979	.	T	C	1	4	5	0	0	5	0	0
13	33196395	.	T	C	2	4	6	0	0	6	0	0
13	33196656	.	A	G	1	2	3	0	1	4	0	0
13	33196749	.	G	A	4	3	7	0	1	8	0	0
13	33196771	.	T	G	5	2	7	0	1	8	0	0
13	33197051	.	G	C	1	3	4	0	0	4	0	0
13	33197897	.	C	T	3	5	8	0	1	9	0	0
13	33198000	.	C	T	3	2	5	0	3	8	0	0
13	33198070	.	G	A	2	3	5	0	0	5	0	0
13	33200187	.	C	T	1	4	5	0	0	5	0	0
13	33200432	.	A	G	6	3	9	0	0	9	0	0
13	33207311	.	C	T	3	2	5	0	0	5	0	0
13	33211445	.	A	T	10	9	19	0	0	19	0	0
13	33214492	.	T	C	10	5	15	0	0	15	0	0
13	33214664	.	C	T	1	10	11	0	8	19	0	0
13	33214706	.	C	T	9	20	29	0	1	30	0	0
13	33214709	.	T	C	11	19	30	0	0	30	0	0
13	33214804	.	G	A	12	18	30	0	0	30	0	0
13	33214985	.	C	T	8	11	19	0	1	20	0	0
13	33216341	.	G	A	16	11	27	0	1	28	0	0
13	33218037	.	T	C	2	12	14	0	0	14	0	0
13	33218214	.	C	T	12	10	22	0	1	23	0	0
13	33219988	.	C	A	0	10	10	0	10	20	0	0
13	33220164	.	A	G	9	13	22	0	0	22	0	0
13	33222342	.	C	A	3	5	8	0	9	17	0	0
13	33222396	.	G	A	11	7	18	0	0	18	0	0
13	33224678	.	G	A	2	7	9	0	0	9	0	0
13	33224706	.	T	G	6	8	14	0	1	15	0	0
13	33224716	.	G	A	8	7	15	0	0	15	0	0
13	33224742	.	G	T	11	5	16	0	1	17	0	0
13	33225049	.	A	G	7	3	10	0	0	10	0	0
13	33227271	.	G	C	7	11	18	0	3	21	0	0
13	33229502	.	T	G	8	5	13	0	0	13	0	0
13	33229739	.	T	C	17	17	34	0	0	34	0	0
13	33229753	.	C	T	15	16	31	0	2	33	0	0
13	33230024	.	A	T	16	21	37	0	0	37	0	0
13	33230163	.	G	C	15	24	39	0	1	40	0	0
13	33230177	.	G	A	10	27	37	0	1	38	0	0
13	33230253	.	C	T	11	10	21	1	1	23	0	0
13	33230281	.	T	C	6	4	10	1	3	14	0	0
13	33230518	.	T	C	4	0	4	0	24	28	0	0
13	33234866	.	T	C	11	22	33	0	3	36	0	0
13	33236111	.	T	C	16	19	35	0	0	35	0	0
13	33236482	.	G	T	12	9	21	0	3	24	0	0
13	33236902	.	C	T	11	15	26	0	1	27	0	0
13	33238960	.	G	A	11	28	39	0	4	43	0	0
13	33239237	.	T	C	11	0	11	0	16	27	0	0
13	33242878	.	C	T	9	16	25	1	2	28	0	0
13	33246227	.	T	A	7	9	16	0	0	16	0	0
13	33246249	.	T	A	7	14	21	0	0	21	0	0
13	33247147	.	A	C	2	4	6	0	1	7	0	0
13	33248255	.	T	C	7	9	16	0	0	16	0	0
13	33248308	.	C	T	7	10	17	0	1	18	0	0
13	33248443	.	T	C	5	10	15	0	1	16	0	0
13	33250992	.	T	A	6	15	21	0	0	21	0	0
13	33251058	.	C	G	8	1	9	0	11	20	0	0
13	33252236	.	C	T	1	2	3	0	0	3	0	0
13	33253722	.	G	A	2	3	5	0	0	5	0	0
13	33261198	.	A	G	15	17	32	0	1	33	0	0
13	33261620	.	T	C	20	20	40	0	1	41	0	0
13	33261637	.	G	A	21	7	28	0	3	36	5	0
13	33261889	.	C	T	21	29	50	0	0	50	0	0
13	33262909	.	G	T	14	27	41	0	1	42	0	0
13	33262944	.	C	G	11	29	40	0	1	41	0	0
13	33262956	.	C	A	13	27	40	0	0	40	0	0
13	33262997	.	A	G	12	22	34	0	1	35	0	0
13	33263138	.	C	A	6	5	11	0	2	13	0	0
13	33263203	.	C	T	1	3	4	1	4	9	0	0
13	33263213	.	G	A	4	1	5	1	0	6	0	0
13	33263320	.	A	C	9	3	12	0	0	12	0	0
13	33263385	.	G	A	4	19	23	0	3	26	0	0
13	33263568	.	G	A	21	21	42	0	0	42	0	0
13	33263670	.	T	A	30	9	39	0	2	41	0	0
13	33263685	.	T	C	26	12	38	0	1	39	0	0
13	33263774	.	G	A	16	11	27	2	1	30	0	0
13	33263860	.	A	T	25	2	27	1	2	30	0	0
13	33263940	.	T	C	6	17	23	0	2	25	0	0
13	33263985	.	C	A	10	12	22	0	2	24	0	0
13	33264001	.	G	A	14	17	31	0	0	31	0	0
13	33264483	.	T	A	21	12	33	0	5	38	0	0
13	33264519	.	C	T	3	11	14	0	22	36	0	0
13	33264550	.	T	C	18	10	28	0	2	30	0	0
13	33264635	.	A	T	16	13	29	0	1	30	0	0
13	33264772	.	A	T	10	17	27	0	1	28	0	0
13	33265128	.	T	C	19	1	20	0	22	42	0	0
13	33265210	.	T	G	20	18	38	0	1	39	0	0
13	33267095	.	T	C	24	15	39	0	0	39	0	0
13	33271252	.	G	A	1	2	3	0	4	7	0	0
13	33271332	.	C	T	2	3	5	0	0	5	0	0
13	33276011	.	G	A	5	3	8	0	0	8	0	0
13	33276156	.	T	C	5	3	8	0	0	8	0	0
13	33276192	.	C	G	4	0	4	0	3	7	0	0
13	33282138	.	G	T	0	5	5	0	6	11	0	0
13	33286963	.	G	C	6	5	11	0	0	11	0	0
13	33293037	.	A	G	5	6	11	0	0	11	0	0
13	33295894	.	T	A	2	4	6	0	0	6	0	0
13	33310619	.	C	T	2	3	5	0	0	5	0	0
13	33310635	.	C	A	1	2	3	0	0	3	0	0
13	33313085	.	C	G	2	3	5	0	0	5	0	0
13	33314821	.	T	G	3	2	5	0	0	5	0	0
13	33314946	.	T	C	2	5	7	0	0	7	0	0
13	33314974	.	T	A	1	5	6	0	1	7	0	0
13	33315099	.	T	C	5	0	5	0	7	12	0	0
13	33315112	.	C	G	3	6	9	0	0	9	0	0
13	33394476	.	A	C	14	21	35	0	1	36	0	0
13	33394887	.	G	A	23	23	46	0	1	47	0	0
13	33395174	.	C	G	15	26	41	0	2	43	0	0
13	33395256	.	T	G	14	20	34	0	0	34	0	0
13	33396026	.	A	C	6	1	7	0	21	28	0	0
13	33398365	.	C	T	17	22	39	0	2	41	0	0
13	33398445	.	C	A	1	30	31	0	23	54	0	0
13	33398498	.	G	A	10	6	16	0	2	18	0	0
13	33398668	.	C	A	8	11	19	0	1	20	0	0
13	33406569	.	T	C	3	3	6	0	0	6	0	0
13	33411068	.	C	T	4	5	9	0	0	9	0	0
13	33411082	.	G	A	2	5	7	0	0	7	0	0
13	33447088	.	C	G	1	2	3	0	0	3	0	0
13	33447137	.	A	G	2	7	9	0	0	9	0	0
13	33447168	.	T	A	0	7	7	0	0	7	0	0
13	33447175	.	A	G	1	0	1	0	6	7	0	0
13	33447260	.	C	T	2	5	7	0	0	7	0	0
13	33447281	.	A	G	1	4	5	0	1	6	0	0
13	33447389	.	T	C	4	4	8	0	0	8	0	0
13	33614712	.	C	A	7	5	12	0	1	13	0	0
13	33614751	.	T	C	7	8	15	0	2	17	0	0
13	33616880	.	T	C	8	0	8	0	4	12	0	0
13	33617129	.	T	A	8	5	13	0	0	13	0	0
13	33619849	.	A	G	8	10	18	0	0	18	0	0
13	33622519	.	T	C	4	3	7	1	0	8	0	0
13	33624713	.	C	G	2	3	5	0	0	5	0	0
13	33625095	.	T	C	4	6	10	0	0	10	0	0
13	33633271	.	T	A	4	3	7	0	0	7	0	0
13	33633303	.	A	C	5	3	8	0	0	8	0	0
13	33633313	.	T	C	3	3	6	0	1	7	0	0
13	33635645	.	A	G	3	4	7	0	0	7	0	0
13	33636073	.	G	T	7	3	10	0	1	11	0	0
13	33636434	.	T	G	2	3	5	0	0	5	0	0
13	33636505	.	T	G	9	3	12	0	1	13	0	0
13	33636814	.	G	A	4	4	8	0	0	8	0	0
13	33638956	.	C	A	1	5	6	0	0	6	0	0
13	33638957	.	A	C	1	5	6	0	0	6	0	0
13	33638992	.	C	T	1	4	5	0	0	5	0	0
13	33645569	.	C	T	7	2	9	0	0	9	0	0
13	33645754	.	T	C	2	4	6	0	1	7	0	0
13	33645838	.	A	C	7	4	11	0	0	11	0	0
13	33645839	.	A	T	7	4	11	0	0	11	0	0
13	33645922	.	C	T	7	4	11	0	0	11	0	0
13	33645931	.	C	T	6	4	10	0	0	10	0	0
13	33646059	.	A	G	5	4	9	0	0	9	0	0
13	33646063	.	C	G	5	5	10	0	0	10	0	0
13	33646285	.	G	A	5	4	9	0	0	9	0	0
13	33646333	.	T	C	6	0	6	0	4	10	0	0
13	33646401	.	G	A	1	4	5	0	0	5	0	0
13	33646403	.	G	A	1	4	5	0	0	5	0	0
13	33646458	.	T	G	3	4	7	0	0	7	0	0
13	33646545	.	A	G	6	2	8	0	0	8	0	0
13	33646615	.	G	A	6	6	12	0	1	13	0	0
13	33649184	.	T	G	5	9	14	0	0	14	0	0
13	33652588	.	A	G	6	4	10	0	1	11	0	0
13	33682048	.	C	A	28	22	50	0	1	51	0	0
13	33682474	.	T	G	9	4	13	0	0	13	0	0
13	33682482	.	A	T	9	4	13	0	1	14	0	0
13	33682617	.	T	C	12	3	15	0	2	17	0	0
13	33682682	.	G	A	32	21	53	0	1	54	0	0
13	33682731	.	G	A	23	28	51	0	2	53	0	0
13	33683609	.	T	C	25	44	69	0	1	70	0	0
13	33683696	.	A	G	25	37	62	0	7	69	0	0
13	33683701	.	G	C	23	43	66	0	3	69	0	0
13	33813428	.	A	C	5	11	16	0	2	18	0	0
13	33816509	.	A	G	7	6	13	0	1	14	0	0
13	33968506	.	T	C	9	11	20	0	1	21	0	0
13	33968509	.	C	T	9	12	21	0	0	21	0	0
13	34217398	.	C	T	13	8	21	0	1	22	0	0
13	34519607	.	T	A	18	17	35	0	1	36	0	0
13	34523224	.	G	A	13	16	29	0	1	30	0	0
13	34556374	.	C	A	18	14	32	0	3	35	0	0
13	34689727	.	C	T	4	2	6	0	0	6	0	0
13	34689756	.	C	A	5	4	9	0	0	9	0	0
13	34746713	.	C	G	4	0	4	0	5	9	0	0
13	34746735	.	A	T	3	2	5	0	0	5	0	0
13	34746752	.	A	G	3	0	3	0	3	6	0	0
13	34746941	.	A	G	5	0	5	0	3	8	0	0
13	34747058	.	G	A	4	3	7	0	1	8	0	0
13	34747073	.	G	T	2	3	5	0	2	7	0	0
13	34747254	.	C	T	2	3	5	0	0	5	0	0
13	34747260	.	G	T	2	4	6	0	0	6	0	0
13	34747291	.	G	C	4	5	9	0	1	10	0	0
13	34747498	.	A	T	4	3	7	0	0	7	0	0
13	34747916	.	A	C	5	4	9	0	0	9	0	0
13	34748062	.	A	T	5	4	9	0	0	9	0	0
13	34748086	.	G	T	6	5	11	0	0	11	0	0
13	34748479	.	A	G	3	8	11	0	0	11	0	0
13	34748527	.	G	A	7	5	12	0	0	12	0	0
13	34748570	.	C	A	10	7	17	0	0	17	0	0
13	34748642	.	T	A	7	6	13	0	1	14	0	0
13	34748891	.	A	T	4	4	8	0	2	10	0	0
13	34748892	.	G	A	4	4	8	0	2	10	0	0
13	34749366	.	T	C	7	7	14	0	0	14	0	0
13	34749693	.	C	T	12	8	20	0	0	20	0	0
13	34749751	.	C	T	7	5	12	0	1	13	0	0
13	34749786	.	A	C	7	9	16	0	0	16	0	0
13	34749819	.	C	T	7	10	17	0	0	17	0	0
13	34749833	.	A	G	8	11	19	0	0	19	0	0
13	34749936	.	T	A	8	6	14	0	0	14	0	0
13	34765383	.	G	A	1	3	4	0	0	4	0	0
13	34765480	.	G	A	6	2	8	0	0	8	0	0
13	34765569	.	T	G	2	2	4	0	0	4	0	0
13	34766034	.	C	A	0	2	2	0	4	6	0	0
13	34766238	.	G	A	3	3	6	0	0	6	0	0
13	34792975	.	A	G	3	4	7	0	0	7	0	0
13	35049461	.	A	G	6	9	15	0	1	16	0	0
13	35389195	.	A	G	4	2	6	0	1	7	0	0
13	35389612	.	A	T	2	4	6	0	0	6	0	0
13	35389670	.	C	T	1	6	7	0	0	7	0	0
13	35481452	.	T	C	1	2	3	0	0	3	0	0
13	35481503	.	C	T	1	3	4	0	0	4	0	0
13	35511074	.	A	G	3	3	6	0	0	6	0	0
13	35511612	.	C	T	2	3	5	0	0	5	0	0
13	35522132	.	A	G	5	4	9	0	0	9	0	0
13	35527647	.	G	T	5	3	8	0	0	8	0	0
13	35672184	.	T	G	1	2	3	0	0	3	0	0
13	35715365	.	G	A	1	2	3	0	0	3	0	0
13	35716409	.	A	G	0	2	2	0	1	3	0	0
13	35723405	.	T	A	4	3	7	0	0	7	0	0
13	35723494	.	G	A	0	2	2	0	3	5	0	0
13	35728714	.	A	G	4	2	6	0	0	6	0	0
13	35728973	.	G	A	1	4	5	0	0	5	0	0
13	35730449	.	A	G	2	3	5	0	0	5	0	0
13	35745657	.	T	C	7	8	15	0	1	16	0	0
13	35745686	.	T	C	9	8	17	0	0	17	0	0
13	35746775	.	T	C	6	9	15	0	3	18	0	0
13	35746838	.	T	C	12	8	20	0	2	22	0	0
13	35747420	.	T	C	13	11	24	0	0	24	0	0
13	35747510	.	G	A	14	14	28	0	2	30	0	0
13	35747564	.	A	G	19	12	31	0	2	33	0	0
13	35747690	.	A	G	23	1	24	0	22	46	0	0
13	35747918	.	T	C	23	25	48	0	3	51	0	0
13	35747954	.	T	C	22	20	42	0	0	42	0	0
13	35748096	.	C	G	18	0	18	0	11	29	0	0
13	35748109	.	C	G	19	10	29	0	1	30	0	0
13	35748144	.	A	G	18	11	29	0	2	31	0	0
13	35748238	.	T	A	16	14	30	0	1	31	0	0
13	35748319	.	T	C	11	13	24	0	0	24	0	0
13	35748412	.	A	C	19	16	35	0	1	36	0	0
13	35750836	.	G	A	7	7	14	0	1	15	0	0
13	35751047	.	T	C	10	6	16	0	0	16	0	0
13	35751162	.	T	A	12	12	24	0	2	26	0	0
13	35751211	.	T	C	12	13	25	0	1	26	0	0
13	35752964	.	T	C	6	8	14	0	2	16	0	0
13	35756029	.	G	T	11	10	21	0	0	21	0	0
13	35757260	.	G	A	8	4	12	0	1	13	0	0
13	35757338	.	T	G	5	6	11	0	0	11	0	0
13	35758223	.	G	A	8	9	17	1	1	19	0	0
13	35787722	.	G	A	0	2	2	0	2	4	0	0
13	35787735	.	T	C	1	2	3	0	0	3	0	0
13	35788128	.	G	T	9	11	20	0	1	21	0	0
13	35788497	.	T	G	14	13	27	0	0	27	0	0
13	35788503	.	T	C	12	11	23	0	2	25	0	0
13	35788562	.	C	G	2	16	18	0	11	29	0	0
13	35791419	.	C	G	10	16	26	0	0	26	0	0
13	35791455	.	A	G	15	14	29	0	0	29	0	0
13	35791539	.	G	A	10	4	14	0	1	15	0	0
13	35798915	.	A	G	8	6	14	0	0	14	0	0
13	35799146	.	G	A	6	5	11	0	0	11	0	0
13	35799194	.	C	T	7	2	9	0	1	10	0	0
13	35799200	.	G	T	4	6	10	0	2	12	0	0
13	35799230	.	A	G	8	7	15	0	1	16	0	0
13	35801413	.	C	G	11	10	21	0	0	21	0	0
13	35801419	.	A	G	13	10	23	0	0	23	0	0
13	35801452	.	A	G	10	12	22	0	3	25	0	0
13	35801473	.	A	G	11	15	26	0	1	27	0	0
13	35801501	.	T	C	8	0	8	0	11	19	0	0
13	35803109	.	T	C	7	0	7	0	11	18	0	0
13	35808197	.	G	T	8	6	14	0	0	14	0	0
13	35808949	.	T	C	3	6	9	0	0	9	0	0
13	35811400	.	A	G	5	5	10	0	0	10	0	0
13	35820971	.	G	A	2	4	6	0	0	6	0	0
13	35821781	.	G	A	3	3	6	0	0	6	0	0
13	35824278	.	A	G	3	3	6	0	1	7	0	0
13	35824488	.	G	C	3	4	7	0	0	7	0	0
13	35824515	.	T	C	1	6	7	0	0	7	0	0
13	35824599	.	A	G	2	3	5	0	0	5	0	0
13	35824905	.	G	A	3	2	5	0	0	5	0	0
13	35844912	.	A	G	6	5	11	0	0	11	0	0
13	35856492	.	C	G	3	6	9	0	0	9	0	0
13	35856785	.	C	T	7	4	11	0	0	11	0	0
13	35856826	.	T	C	8	7	15	0	0	15	0	0
13	35866351	.	T	C	3	7	10	0	0	10	0	0
13	35866381	.	A	G	5	5	10	0	0	10	0	0
13	35866465	.	G	C	9	4	13	0	0	13	0	0
13	35866561	.	G	T	4	9	13	0	0	13	0	0
13	35866675	.	T	G	3	9	12	0	0	12	0	0
13	35871825	.	C	T	14	8	22	0	0	22	0	0
13	35872125	.	A	T	6	8	14	0	1	15	0	0
13	35872385	.	C	A	3	2	5	0	0	5	0	0
13	35872418	.	G	C	2	4	6	0	0	6	0	0
13	35904738	.	C	T	0	3	3	0	2	5	0	0
13	35904775	.	C	G	3	5	8	0	0	8	0	0
13	35904964	.	G	A	2	3	5	0	0	5	0	0
13	35940059	.	A	T	3	2	5	0	0	5	0	0
13	35941320	.	G	C	0	4	4	0	1	5	0	0
13	35945281	.	A	G	0	2	2	0	1	3	0	0
13	35945633	.	G	A	3	2	5	0	0	5	0	0
13	35950431	.	A	G	7	7	14	0	0	15	1	0
13	35950440	.	C	T	6	7	13	0	0	13	0	0
13	36039711	.	C	T	5	3	8	0	1	9	0	0
13	36039807	.	T	C	13	14	27	0	1	28	0	0
13	36039828	.	T	C	14	2	16	0	11	27	0	0
13	36040061	.	G	T	13	22	35	0	5	40	0	0
13	36040127	.	A	T	25	22	47	0	2	49	0	0
13	36040429	.	C	T	13	6	19	0	0	19	0	0
13	36040473	.	A	C	6	4	10	0	1	11	0	0
13	36040635	.	C	A	18	14	32	3	0	35	0	0
13	36044370	.	C	T	11	13	24	0	0	24	0	0
13	36047444	.	G	A	8	14	22	0	0	22	0	0
13	36048658	.	A	C	8	12	20	0	0	20	0	0
13	36054289	.	A	G	2	7	9	0	2	11	0	0
13	36054432	.	A	C	8	5	13	0	1	14	0	0
13	36054962	.	T	C	15	19	34	0	1	35	0	0
13	36079184	.	T	C	2	0	2	0	7	9	0	0
13	36079205	.	G	A	4	4	8	0	0	8	0	0
13	36084138	.	C	A	0	7	7	0	4	11	0	0
13	36084749	.	G	A	3	4	7	0	0	7	0	0
13	36084756	.	C	T	3	4	7	0	0	7	0	0
13	36086466	.	T	C	10	6	16	0	4	20	0	0
13	36088851	.	A	G	4	6	10	0	1	11	0	0
13	36098884	.	G	A	3	5	8	0	0	8	0	0
13	36102785	.	T	C	5	2	7	0	0	7	0	0
13	36103044	.	G	T	2	4	6	0	0	6	0	0
13	36103064	.	C	T	1	5	6	0	1	7	0	0
13	36103082	.	A	G	1	4	5	0	0	5	0	0
13	36103461	.	C	T	3	4	7	0	0	7	0	0
13	36103760	.	G	A	6	3	9	0	0	9	0	0
13	36103985	.	C	A	1	4	5	0	3	8	0	0
13	36134325	.	G	A	1	3	4	0	1	5	0	0
13	36135416	.	A	G	5	7	12	0	1	13	0	0
13	36136585	.	A	G	14	8	22	0	1	23	0	0
13	36136669	.	C	G	2	5	7	0	17	24	0	0
13	36138360	.	G	A	7	14	21	0	3	24	0	0
13	36139749	.	T	C	8	0	8	0	6	14	0	0
13	36146596	.	G	A	5	13	18	0	1	19	0	0
13	36151234	.	G	A	2	13	15	0	9	24	0	0
13	36151462	.	G	A	5	10	15	0	2	17	0	0
13	36151635	.	T	C	7	11	18	0	1	19	0	0
13	36151858	.	G	C	20	10	30	0	0	30	0	0
13	36151868	.	A	G	16	10	26	0	2	28	0	0
13	36151894	.	G	C	13	10	23	0	0	23	0	0
13	36151929	.	C	T	10	13	23	0	0	23	0	0
13	36152030	.	C	A	19	22	41	0	0	41	0	0
13	36152069	.	A	C	26	17	43	0	2	45	0	0
13	36152102	.	T	A	24	23	47	0	0	47	0	0
13	36152108	.	T	C	22	19	41	0	2	43	0	0
13	36152202	.	T	C	23	15	38	0	2	40	0	0
13	36152269	.	T	G	20	17	37	0	4	41	0	0
13	36152364	.	T	C	12	20	32	0	3	35	0	0
13	36152402	.	C	T	10	31	41	0	1	42	0	0
13	36152415	.	A	G	11	29	40	0	0	40	0	0
13	36152440	.	T	G	15	2	17	0	25	42	0	0
13	36152700	.	T	A	14	11	25	0	1	26	0	0
13	36152733	.	A	G	16	9	25	0	0	25	0	0
13	36152758	.	C	T	18	12	30	0	2	32	0	0
13	36152778	.	A	G	18	13	31	0	1	32	0	0
13	36152795	.	A	C	12	11	23	0	0	23	0	0
13	36152838	.	A	G	8	0	8	0	12	20	0	0
13	36152874	.	C	T	6	9	15	0	0	15	0	0
13	36152952	.	C	A	4	11	15	0	0	15	0	0
13	36153021	.	T	G	2	3	5	0	1	6	0	0
13	36153098	.	G	A	3	2	5	0	0	5	0	0
13	36153112	.	G	T	4	2	6	0	0	6	0	0
13	36153183	.	A	T	5	7	12	0	0	12	0	0
13	36153313	.	T	C	9	21	30	0	1	31	0	0
13	36153382	.	C	T	13	10	23	0	2	25	0	0
13	36164668	.	G	A	10	10	20	0	0	20	0	0
13	36168740	.	G	A	6	8	14	0	0	14	0	0
13	36168770	.	C	T	8	5	13	0	1	14	0	0
13	36168788	.	C	T	0	7	7	0	6	13	0	0
13	36168846	.	T	C	4	2	6	0	10	16	0	0
13	36170636	.	A	G	6	6	12	0	0	12	0	0
13	36175915	.	A	G	3	8	11	0	0	11	0	0
13	36179661	.	G	C	7	7	14	0	0	14	0	0
13	36179697	.	C	T	4	4	8	0	1	9	0	0
13	36179838	.	C	T	4	4	8	0	0	8	0	0
13	36179844	.	A	T	3	5	8	0	0	8	0	0
13	36264265	.	A	G	2	3	5	0	0	5	0	0
13	36312193	.	G	T	13	10	23	0	0	23	0	0
13	36312361	.	C	A	5	2	7	0	0	7	0	0
13	36312447	.	A	G	9	5	14	0	0	14	0	0
13	36312469	.	T	G	9	4	13	0	0	13	0	0
13	36312497	.	C	T	2	5	7	0	10	17	0	0
13	36312682	.	G	A	15	12	27	0	0	27	0	0
13	36321256	.	C	T	2	3	5	0	0	5	0	0
13	36322099	.	C	T	1	11	12	0	9	21	0	0
13	36322133	.	A	G	18	12	30	0	0	30	0	0
13	36335033	.	G	A	2	5	7	0	1	8	0	0
13	36335057	.	A	G	2	6	8	0	0	8	0	0
13	36335206	.	A	G	4	5	9	0	0	9	0	0
13	36337349	.	T	C	9	0	9	0	6	15	0	0
13	36338262	.	A	G	9	6	15	0	2	17	0	0
13	36349674	.	G	A	2	4	6	0	0	6	0	0
13	36409233	.	A	T	3	4	7	0	1	8	0	0
13	36409246	.	C	T	4	5	9	0	0	9	0	0
13	36409522	.	T	C	11	0	11	0	8	19	0	0
13	36409691	.	A	G	4	9	13	0	0	13	0	0
13	36410339	.	T	C	8	9	17	0	2	19	0	0
13	36410671	.	T	C	3	3	6	0	0	6	0	0
13	36418735	.	A	T	5	5	10	0	0	10	0	0
13	36424414	.	G	A	6	6	12	0	1	13	0	0
13	36438831	.	C	T	4	5	9	0	3	12	0	0
13	36450109	.	C	T	4	3	7	0	1	8	0	0
13	36452977	.	A	G	7	4	11	0	1	12	0	0
13	36461642	.	T	C	5	0	5	0	5	10	0	0
13	36465595	.	C	T	2	1	3	0	1	4	0	0
13	36465604	.	A	G	2	2	4	0	1	5	0	0
13	36466321	.	C	G	2	3	5	0	1	6	0	0
13	36467504	.	G	A	2	4	6	0	0	6	0	0
13	36467558	.	G	A	4	5	9	0	0	10	1	0
13	36471262	.	A	G	2	3	5	0	0	5	0	0
13	36484865	.	A	G	3	4	7	0	0	7	0	0
13	36530629	.	A	G	38	22	60	0	3	63	0	0
13	36531957	.	A	G	36	33	69	0	1	70	0	0
13	36532607	.	G	T	42	22	64	0	1	65	0	0
13	36532752	.	G	A	33	24	57	3	5	65	0	0
13	36533174	.	C	T	28	13	41	1	4	46	0	0
13	36534273	.	T	C	36	23	59	0	2	61	0	0
13	36537510	.	T	A	16	7	23	0	0	23	0	0
13	36558152	.	C	T	12	4	16	0	0	16	0	0
13	36560808	.	G	A	9	4	13	0	0	13	0	0
13	36568867	.	A	G	14	13	27	0	2	29	0	0
13	36568897	.	G	A	15	17	32	0	2	34	0	0
13	36569330	.	G	A	16	21	37	0	4	41	0	0
13	36579281	.	G	A	15	16	31	0	1	32	0	0
13	36579356	.	G	C	18	18	36	0	1	37	0	0
13	36589020	.	G	A	25	20	45	0	3	48	0	0
13	36589365	.	C	T	16	15	31	0	1	32	0	0
13	36589401	.	A	G	16	13	29	0	2	31	0	0
13	36589556	.	A	G	13	22	35	0	4	39	0	0
13	36592521	.	A	G	28	0	28	0	23	51	0	0
13	36592619	.	G	T	19	18	37	0	1	39	1	0
13	36592732	.	T	C	14	18	32	0	1	33	0	0
13	36592952	.	A	G	20	15	35	0	0	35	0	0
13	36592969	.	T	C	21	17	38	0	2	40	0	0
13	36593052	.	G	A	29	8	37	0	3	40	0	0
13	36593121	.	C	T	12	16	28	0	1	29	0	0
13	36593278	.	T	C	26	24	50	0	1	51	0	0
13	36593478	.	C	A	17	10	27	0	0	27	0	0
13	36605649	.	G	A	4	8	12	0	19	31	0	0
13	36605682	.	T	C	18	15	33	0	2	36	1	0
13	36605811	.	T	C	21	6	27	0	1	28	0	0
13	36605851	.	G	A	4	12	16	0	15	31	0	0
13	36606012	.	C	T	12	8	20	0	1	21	0	0
13	36606023	.	T	C	14	6	20	0	0	20	0	0
13	36606073	.	C	A	8	7	15	0	1	16	0	0
13	36606422	.	C	T	14	14	28	0	1	29	0	0
13	36606632	.	A	T	4	8	12	0	3	15	0	0
13	36606657	.	C	T	8	10	18	0	1	19	0	0
13	36606724	.	C	A	14	7	21	0	1	22	0	0
13	36606725	.	A	G	15	6	21	0	1	22	0	0
13	36625784	.	T	C	8	13	21	0	0	21	0	0
13	36625821	.	G	A	11	7	18	0	1	19	0	0
13	36636464	.	A	G	16	0	16	0	18	34	0	0
13	36636491	.	C	T	13	14	27	0	2	29	0	0
13	36638783	.	C	T	21	15	36	0	0	36	0	0
13	36638906	.	C	A	5	2	7	0	0	7	0	0
13	36639424	.	A	G	8	16	24	0	0	24	0	0
13	36639598	.	C	T	9	9	18	0	0	18	0	0
13	36640032	.	A	G	10	9	19	0	1	20	0	0
13	36640063	.	G	C	9	7	16	0	0	16	0	0
13	36640555	.	T	G	10	10	20	0	8	28	0	0
13	36647159	.	T	C	5	5	10	0	0	10	0	0
13	36647442	.	A	G	3	2	5	0	0	5	0	0
13	36647553	.	C	T	4	5	9	0	2	11	0	0
13	36655240	.	C	T	10	9	19	1	0	20	0	0
13	36655258	.	T	C	10	6	16	1	1	18	0	0
13	36655884	.	T	C	1	6	7	0	0	7	0	0
13	36657721	.	G	A	4	3	7	0	0	7	0	0
13	37076269	.	T	C	13	13	26	0	3	29	0	0
13	37076337	.	T	C	15	5	20	0	1	21	0	0
13	37090618	.	G	A	5	2	7	0	0	7	0	0
13	38304824	.	A	G	6	7	13	0	2	15	0	0
13	38446709	.	A	G	11	0	11	0	17	28	0	0
13	38466196	.	G	A	8	12	20	0	0	20	0	0
13	38466247	.	C	T	6	11	17	0	0	17	0	0
13	38466343	.	T	C	12	13	25	0	0	25	0	0
13	38566611	.	A	G	18	0	18	0	11	29	0	0
13	38583699	.	C	A	23	18	41	0	4	45	0	0
13	38583714	.	A	G	21	17	38	0	1	39	0	0
13	38593559	.	A	G	31	20	51	0	1	52	0	0
13	38593574	.	A	T	29	18	47	0	1	48	0	0
13	38621607	.	G	T	4	5	9	0	0	9	0	0
13	38622184	.	C	T	0	9	9	0	10	19	0	0
13	38666128	.	G	A	19	15	34	0	3	37	0	0
13	39111237	.	A	G	1	2	3	0	0	3	0	0
13	39112052	.	T	C	1	2	3	0	0	3	0	0
13	39112053	.	T	A	1	2	3	0	0	3	0	0
13	39112210	.	C	T	1	2	3	0	0	3	0	0
13	39112211	.	A	G	1	2	3	0	0	3	0	0
13	39112434	.	C	T	1	5	6	0	0	6	0	0
13	39112664	.	T	C	1	2	3	0	0	3	0	0
13	39113101	.	G	T	2	3	5	0	0	5	0	0
13	39114730	.	G	T	1	2	3	1	0	4	0	0
13	39114751	.	A	T	1	2	3	0	0	3	0	0
13	39115534	.	A	G	1	0	1	0	4	5	0	0
13	39214527	.	A	G	2	5	7	0	2	9	0	0
13	39214557	.	G	A	6	5	11	0	0	11	0	0
13	39217377	.	C	T	6	4	10	0	0	10	0	0
13	39217506	.	C	T	5	8	13	0	1	14	0	0
13	39217657	.	C	T	8	6	14	0	1	15	0	0
13	39218060	.	T	C	9	10	19	0	1	20	0	0
13	39218097	.	A	G	7	4	11	0	3	14	0	0
13	39218133	.	C	A	8	4	12	0	0	12	0	0
13	39218292	.	C	T	12	9	21	0	0	21	0	0
13	39218602	.	A	G	11	2	13	0	13	26	0	0
13	39218706	.	T	C	7	11	18	0	1	19	0	0
13	39218843	.	G	A	2	14	16	0	7	23	0	0
13	39221960	.	T	C	8	8	16	0	0	16	0	0
13	39223774	.	A	G	12	12	24	1	0	25	0	0
13	39224003	.	C	T	6	17	23	0	0	23	0	0
13	39226666	.	T	C	8	10	18	1	1	20	0	0
13	39227275	.	G	A	3	13	16	0	15	31	0	0
13	39227590	.	A	T	6	3	9	0	0	9	0	0
13	39269998	.	T	G	3	2	5	0	0	5	0	0
13	39270032	.	A	T	3	2	5	0	0	5	0	0
13	39270178	.	A	G	3	2	5	0	0	5	0	0
13	39270686	.	T	C	3	2	5	0	0	5	0	0
13	39270697	.	C	T	2	2	4	0	0	4	0	0
13	39277401	.	T	C	1	2	3	0	0	3	0	0
13	39277522	.	G	A	0	2	2	0	1	3	0	0
13	39277635	.	C	T	3	2	5	0	0	5	0	0
13	39292443	.	T	C	1	2	3	0	0	3	0	0
13	39297760	.	A	G	1	3	4	0	0	4	0	0
13	39297919	.	C	G	2	2	4	0	0	4	0	0
13	39301051	.	G	A	3	2	5	0	0	5	0	0
13	39302539	.	C	T	2	3	5	0	0	5	0	0
13	39303070	.	A	G	2	2	4	0	0	4	0	0
13	39303161	.	A	C	6	2	8	0	0	8	0	0
13	39304213	.	A	G	4	4	8	0	1	9	0	0
13	39305208	.	C	G	4	4	8	0	0	8	0	0
13	39364580	.	G	A	3	2	5	0	1	6	0	0
13	39533216	.	A	G	1	2	3	0	0	3	0	0
13	39657068	.	A	G	12	11	23	0	1	24	0	0
13	39657285	.	T	C	4	2	6	0	0	6	0	0
13	39657625	.	A	C	7	3	10	0	0	10	0	0
13	39657652	.	A	G	5	3	8	0	1	9	0	0
13	40249366	.	T	C	1	0	1	0	2	3	0	0
13	40335087	.	T	G	8	9	17	0	1	18	0	0
13	40335135	.	T	G	9	0	9	0	8	17	0	0
13	40344258	.	C	T	13	9	22	0	0	22	0	0
13	40344303	.	G	A	1	8	9	0	11	20	0	0
13	40351869	.	G	A	12	13	25	0	0	25	0	0
13	40351914	.	G	A	0	12	12	0	15	27	0	0
13	40351953	.	C	T	13	13	26	0	5	31	0	0
13	40352345	.	C	T	15	12	27	0	2	29	0	0
13	40352349	.	C	G	17	11	28	0	1	29	0	0
13	40352415	.	T	G	11	10	21	0	0	21	0	0
13	40352476	.	A	G	10	5	15	0	0	15	0	0
13	40353512	.	G	T	10	15	25	0	0	25	0	0
13	40353736	.	A	C	10	11	21	0	1	22	0	0
13	40354235	.	C	T	7	6	13	0	0	13	0	0
13	40445253	.	C	T	18	21	39	0	4	43	0	0
13	40463048	.	T	A	7	5	12	0	0	12	0	0
13	40463116	.	C	T	3	4	7	0	0	7	0	0
13	40463310	.	C	A	4	3	7	0	0	7	0	0
13	40463732	.	C	T	0	8	8	0	6	14	0	0
13	40463784	.	G	C	11	0	11	0	4	15	0	0
13	40481324	.	A	T	8	9	17	0	1	18	0	0
13	40482568	.	T	A	5	6	11	0	1	12	0	0
13	40486656	.	G	A	6	4	10	0	3	13	0	0
13	40497631	.	G	A	7	4	11	0	0	11	0	0
13	40497802	.	A	G	3	5	8	0	0	8	0	0
13	40498129	.	C	G	0	6	6	0	6	12	0	0
13	40498267	.	A	G	5	6	11	0	1	12	0	0
13	40498294	.	G	A	4	7	11	0	0	11	0	0
13	40498630	.	G	A	3	3	6	0	0	6	0	0
13	40498759	.	G	A	6	5	11	0	0	11	0	0
13	40714660	.	T	C	1	2	3	0	0	3	0	0
13	40714983	.	A	G	1	3	4	0	0	4	0	0
13	40715038	.	G	T	2	3	5	0	0	5	0	0
13	40716473	.	A	G	1	3	4	0	0	4	0	0
13	40716477	.	A	T	1	2	3	0	0	3	0	0
13	40747151	.	T	C	4	4	8	0	1	9	0	0
13	40747256	.	T	A	7	3	10	0	1	11	0	0
13	40747274	.	T	C	5	0	5	0	5	10	0	0
13	40747337	.	T	A	9	6	15	0	1	16	0	0
13	40747467	.	C	T	0	4	4	0	2	6	0	0
13	40747607	.	G	T	4	3	7	0	0	7	0	0
13	40747791	.	G	C	6	3	9	0	0	9	0	0
13	40747839	.	T	C	3	2	5	0	1	6	0	0
13	40747841	.	T	C	4	0	4	0	2	6	0	0
13	40748074	.	A	G	7	3	10	0	0	10	0	0
13	40748246	.	A	C	8	13	21	0	0	21	0	0
13	40748248	.	C	A	7	13	20	0	0	20	0	0
13	40748310	.	T	G	6	2	8	0	1	9	0	0
13	40748356	.	G	T	9	4	13	0	1	14	0	0
13	40748408	.	C	T	6	4	10	0	2	12	0	0
13	40748431	.	G	A	7	4	11	0	0	11	0	0
13	40748582	.	G	A	2	7	9	0	0	9	0	0
13	40748620	.	C	T	5	3	8	0	0	8	0	0
13	40748621	.	T	A	5	3	8	0	0	8	0	0
13	40749082	.	T	C	9	3	12	0	0	12	0	0
13	40749104	.	T	C	6	3	9	0	0	9	0	0
13	40749577	.	G	A	4	3	7	0	0	7	0	0
13	40754367	.	T	G	7	3	10	0	0	10	0	0
13	40754433	.	A	T	7	7	14	0	0	14	0	0
13	40754441	.	G	T	7	4	11	0	1	12	0	0
13	41125475	.	C	T	4	10	14	0	0	14	0	0
13	41125652	.	C	T	6	14	20	0	0	20	0	0
13	41125766	.	A	G	9	5	14	0	1	15	0	0
13	41128286	.	G	A	4	7	11	0	0	11	0	0
13	41214782	.	A	G	3	3	6	0	0	6	0	0
13	41214812	.	G	A	3	3	6	0	1	7	0	0
13	41214863	.	G	A	6	4	10	0	0	10	0	0
13	41222908	.	G	A	3	3	6	0	0	6	0	0
13	41222971	.	A	G	3	7	10	0	0	10	0	0
13	41249277	.	T	C	3	4	7	0	0	7	0	0
13	41288990	.	A	G	3	2	5	0	0	5	0	0
13	41289112	.	C	T	0	4	4	0	4	8	0	0
13	41289189	.	T	C	2	7	9	0	0	9	0	0
13	41297057	.	A	G	2	7	9	0	0	9	0	0
13	41306803	.	G	T	3	2	5	0	0	5	0	0
13	41320070	.	G	C	5	3	8	0	0	8	0	0
13	41320196	.	A	G	2	6	8	0	0	8	0	0
13	41388480	.	A	G	2	3	5	0	0	5	0	0
13	41910428	.	G	A	8	6	14	0	1	15	0	0
13	41911090	.	G	A	26	10	36	1	2	39	0	0
13	41911092	.	C	A	12	25	37	0	2	39	0	0
13	41911265	.	G	A	10	17	27	0	0	27	0	0
13	41911276	.	T	C	10	20	30	0	1	31	0	0
13	41911402	.	T	A	24	9	33	0	0	33	0	0
13	41911597	.	G	T	22	6	28	0	1	29	0	0
13	41911771	.	A	G	14	6	20	1	1	22	0	0
13	41911788	.	C	T	9	4	13	0	3	16	0	0
13	41911932	.	A	G	10	7	17	0	2	19	0	0
13	41915604	.	A	G	23	12	35	0	1	36	0	0
13	41917003	.	C	A	6	8	14	0	1	15	0	0
13	41917031	.	T	A	1	2	3	0	0	3	0	0
13	41932476	.	T	A	1	3	4	0	0	4	0	0
13	41936615	.	A	G	2	2	4	0	1	5	0	0
13	41940198	.	G	A	0	2	2	0	3	5	0	0
13	41944479	.	G	A	1	3	4	0	0	4	0	0
13	41944815	.	C	A	1	7	8	0	4	12	0	0
13	41945455	.	C	T	4	2	6	0	0	6	0	0
13	41945464	.	C	T	0	4	4	0	2	6	0	0
13	41945632	.	C	T	0	6	6	0	5	11	0	0
13	41945737	.	A	G	7	4	11	0	0	11	0	0
13	41945762	.	T	A	3	6	9	0	1	10	0	0
13	41947874	.	C	T	3	3	6	0	0	6	0	0
13	41947882	.	C	T	0	2	2	0	3	5	0	0
13	42018012	.	C	T	3	5	8	0	0	8	0	0
13	42018175	.	A	C	1	4	5	0	0	5	0	0
13	42018304	.	A	T	3	3	6	0	1	7	0	0
13	42018734	.	G	T	2	3	5	0	0	5	0	0
13	42066135	.	T	C	3	0	3	0	6	9	0	0
13	42142194	.	C	A	7	7	14	0	0	14	0	0
13	42142296	.	T	C	11	10	21	0	2	23	0	0
13	42142854	.	G	A	18	9	27	0	0	27	0	0
13	42143118	.	G	A	1	5	6	0	8	14	0	0
13	42143285	.	A	T	8	7	15	0	1	16	0	0
13	42143294	.	T	G	9	6	15	0	0	16	1	0
13	42143572	.	T	A	1	6	7	0	0	7	0	0
13	42143581	.	T	A	1	4	5	0	0	5	0	0
13	42309890	.	C	A	3	4	7	0	0	7	0	0
13	42319544	.	G	A	1	3	4	0	0	4	0	0
13	42320084	.	G	C	5	4	9	0	1	10	0	0
13	42321191	.	C	T	2	6	8	0	0	8	0	0
13	42321831	.	G	A	4	3	7	0	0	7	0	0
13	42349499	.	C	T	4	6	10	0	1	11	0	0
13	42349683	.	C	T	6	7	13	0	1	14	0	0
13	42361795	.	A	G	11	10	21	0	1	22	0	0
13	42365043	.	A	G	6	14	20	0	2	22	0	0
13	42365121	.	T	C	12	7	19	0	0	19	0	0
13	42365139	.	T	C	11	0	11	0	9	20	0	0
13	42365374	.	C	T	10	14	24	0	1	25	0	0
13	42400391	.	T	A	9	11	20	0	0	20	0	0
13	42400473	.	C	T	10	9	19	0	1	20	0	0
13	42406908	.	A	G	2	3	5	0	0	5	0	0
13	42407519	.	C	T	6	7	13	0	3	16	0	0
13	42407526	.	A	G	8	7	15	0	1	16	0	0
13	42414459	.	A	G	5	2	7	0	0	7	0	0
13	42443487	.	T	C	3	4	7	0	0	7	0	0
13	42443517	.	T	C	4	4	8	0	0	8	0	0
13	42467430	.	T	C	6	5	11	0	1	12	0	0
13	42471886	.	A	C	6	5	11	0	0	11	0	0
13	42481169	.	T	C	5	10	15	0	0	15	0	0
13	42481256	.	A	G	11	7	18	0	2	20	0	0
13	42481267	.	G	A	11	9	20	0	1	21	0	0
13	42481306	.	T	C	9	10	19	0	2	21	0	0
13	42481512	.	A	G	10	14	24	0	1	25	0	0
13	42481538	.	A	G	14	16	30	0	3	33	0	0
13	42481575	.	T	C	17	16	33	0	1	34	0	0
13	42481599	.	A	G	16	12	28	0	3	31	0	0
13	42483050	.	A	G	11	15	26	1	1	28	0	0
13	42483082	.	A	G	7	16	23	1	0	24	0	0
13	42483089	.	T	C	9	14	23	1	2	26	0	0
13	42488440	.	C	T	5	11	16	0	0	16	0	0
13	42490778	.	T	C	7	3	10	0	0	10	0	0
13	42491406	.	G	A	6	5	11	0	0	11	0	0
13	42491448	.	C	T	2	6	8	0	8	16	0	0
13	42500513	.	A	T	3	5	8	0	0	8	0	0
13	42502659	.	T	A	1	4	5	0	0	5	0	0
13	42516915	.	C	G	0	4	4	0	5	9	0	0
13	42517113	.	C	T	4	3	7	0	0	7	0	0
13	42521407	.	T	C	7	0	7	0	5	12	0	0
13	42523723	.	A	T	4	6	10	0	1	11	0	0
13	42523951	.	A	G	7	7	14	0	1	15	0	0
13	42523969	.	G	C	5	6	11	0	0	11	0	0
13	42523987	.	T	C	6	4	10	0	0	10	0	0
13	42524107	.	C	T	2	4	6	0	0	6	0	0
13	42526316	.	C	T	0	3	3	0	6	9	0	0
13	42526376	.	C	T	3	2	5	0	0	5	0	0
13	42602533	.	A	T	1	3	4	0	0	4	0	0
13	42606862	.	T	G	6	3	9	0	0	9	0	0
13	42607276	.	C	G	1	5	6	0	1	7	0	0
13	42610900	.	C	T	2	4	6	0	0	6	0	0
13	42610961	.	A	T	1	6	7	0	0	7	0	0
13	42611117	.	G	C	1	3	4	0	0	4	0	0
13	42614968	.	G	T	0	3	3	0	3	6	0	0
13	42615004	.	A	T	4	3	7	0	0	7	0	0
13	42615073	.	T	G	3	6	9	0	0	9	0	0
13	42615094	.	G	A	4	5	9	0	1	10	0	0
13	42616301	.	A	C	2	6	8	0	0	8	0	0
13	42616527	.	C	A	4	4	8	0	0	8	0	0
13	42616563	.	T	C	6	3	9	0	1	10	0	0
13	42617552	.	C	T	2	3	5	0	0	5	0	0
13	42621864	.	A	G	3	4	7	0	1	8	0	0
13	42621870	.	A	C	3	2	5	0	1	6	0	0
13	42622006	.	C	T	3	14	17	0	0	17	0	0
13	42622013	.	C	T	2	12	14	0	0	14	0	0
13	42626622	.	C	T	0	4	4	0	3	7	0	0
13	42630536	.	C	T	0	2	2	0	2	4	0	0
13	42632966	.	A	G	7	8	15	0	0	15	0	0
13	42672885	.	T	G	8	7	15	0	0	15	0	0
13	42676262	.	T	A	17	10	27	0	1	28	0	0
13	42681759	.	G	T	3	6	9	0	0	9	0	0
13	42681856	.	T	G	13	6	19	0	0	19	0	0
13	42682033	.	T	A	11	12	23	1	0	24	0	0
13	42686420	.	G	T	5	4	9	0	0	9	0	0
13	42693030	.	G	A	3	4	7	0	0	7	0	0
13	42698930	.	A	T	4	10	14	0	0	14	0	0
13	42702811	.	T	G	4	4	8	0	0	8	0	0
13	42702835	.	T	C	3	3	6	0	0	6	0	0
13	42721011	.	G	A	3	4	7	1	0	8	0	0
13	42726708	.	A	T	4	2	6	0	1	7	0	0
13	42727003	.	A	T	1	2	3	0	0	3	0	0
13	42727017	.	G	T	1	2	3	0	0	3	0	0
13	42728506	.	G	C	1	2	3	0	0	3	0	0
13	43131829	.	A	G	2	5	7	0	0	7	0	0
13	43141134	.	G	A	1	2	3	0	0	3	0	0
13	43141148	.	A	T	2	3	5	0	0	5	0	0
13	43212657	.	A	T	1	2	3	0	0	3	0	0
13	43212717	.	A	G	1	0	1	0	4	5	0	0
13	43212840	.	C	T	1	2	3	0	0	3	0	0
13	43223679	.	G	A	14	22	36	0	0	36	0	0
13	43223722	.	T	G	16	29	45	0	1	46	0	0
13	43225093	.	C	T	12	20	32	0	1	33	0	0
13	43225201	.	T	C	20	1	21	0	14	35	0	0
13	43226423	.	T	A	23	14	37	0	0	37	0	0
13	43226429	.	C	T	2	13	15	0	24	39	0	0
13	43229872	.	A	C	17	17	34	0	2	36	0	0
13	43229923	.	G	A	16	12	28	0	0	28	0	0
13	43237237	.	T	C	16	11	27	0	0	27	0	0
13	43237255	.	A	C	15	1	16	0	10	26	0	0
13	43238513	.	C	A	18	17	35	0	3	38	0	0
13	44340254	.	C	T	1	2	3	0	0	3	0	0
13	44340388	.	T	G	3	3	6	0	0	6	0	0
13	44355466	.	C	A	3	3	6	0	0	6	0	0
13	44413144	.	A	G	1	2	3	0	0	3	0	0
13	44498613	.	T	A	1	3	4	0	0	4	0	0
13	44498640	.	G	A	1	2	3	0	0	3	0	0
13	44629339	.	G	A	1	5	6	0	1	7	0	0
13	44702469	.	T	C	12	0	12	0	10	22	0	0
13	44715290	.	G	A	15	22	37	0	0	37	0	0
13	44738328	.	G	A	18	15	33	0	0	33	0	0
13	44767765	.	T	C	13	8	21	0	1	22	0	0
13	44772073	.	A	G	6	6	12	0	1	13	0	0
13	44775714	.	G	A	4	8	12	0	0	12	0	0
13	44775895	.	C	T	1	11	12	1	3	16	0	0
13	44779071	.	A	G	9	9	18	0	1	19	0	0
13	44779083	.	A	G	8	11	19	0	1	20	0	0
13	44779107	.	C	T	7	12	19	0	0	19	0	0
13	44788217	.	C	T	12	7	19	0	0	19	0	0
13	44788358	.	G	A	13	5	18	0	0	18	0	0
13	44788361	.	T	A	12	5	17	0	0	17	0	0
13	44788539	.	G	A	18	8	26	0	3	29	0	0
13	44788815	.	C	T	25	10	35	0	1	36	0	0
13	44788827	.	A	C	26	9	35	0	2	37	0	0
13	44808582	.	A	C	12	0	12	0	10	22	0	0
13	44808632	.	A	G	13	7	20	0	3	23	0	0
13	44827840	.	T	C	1	0	1	0	2	3	0	0
13	44827845	.	T	G	1	2	3	0	0	3	0	0
13	44828232	.	T	C	1	3	4	0	0	4	0	0
13	44832508	.	A	C	1	2	3	1	0	4	0	0
13	44841248	.	T	C	2	3	5	0	0	5	0	0
13	44842117	.	T	C	5	0	5	0	4	9	0	0
13	44842810	.	G	T	8	3	11	1	2	14	0	0
13	44843760	.	T	A	4	3	7	0	0	7	0	0
13	44843773	.	G	A	3	3	6	0	0	6	0	0
13	44843806	.	C	A	2	2	4	0	0	4	0	0
13	44848699	.	A	T	2	2	4	0	0	4	0	0
13	44869386	.	G	T	12	9	21	0	1	22	0	0
13	44888282	.	C	T	12	8	20	0	0	20	0	0
13	45010064	.	A	G	13	6	19	1	3	23	0	0
13	45012835	.	A	T	15	33	48	0	3	51	0	0
13	45015355	.	A	T	24	19	43	0	3	46	0	0
13	45015443	.	T	C	21	31	52	0	0	52	0	0
13	45015503	.	T	C	19	25	44	0	2	46	0	0
13	45018600	.	A	G	40	37	77	0	16	93	0	0
13	45018732	.	G	A	25	47	72	0	7	79	0	0
13	45019001	.	A	C	27	5	32	0	38	70	0	0
13	45035991	.	A	G	13	5	18	0	1	19	0	0
13	45036033	.	A	C	14	0	14	0	12	26	0	0
13	45432170	.	A	G	19	11	30	0	1	31	0	0
13	45434952	.	T	G	16	22	38	0	0	38	0	0
13	45436554	.	A	G	19	19	38	0	0	38	0	0
13	45436561	.	G	T	18	20	38	0	1	39	0	0
13	45468567	.	A	T	14	36	50	3	0	53	0	0
13	45468827	.	G	C	32	3	35	0	30	65	0	0
13	45470601	.	A	G	27	32	59	2	3	64	0	0
13	45470815	.	A	T	20	28	48	0	2	50	0	0
13	45470926	.	G	C	19	14	33	0	1	34	0	0
13	45470983	.	A	G	9	19	28	1	1	30	0	0
13	45471048	.	A	G	6	13	19	1	1	21	0	0
13	45471052	.	A	G	6	17	23	1	0	24	0	0
13	45471086	.	T	A	19	5	24	0	2	26	0	0
13	45471243	.	G	A	27	17	44	0	1	45	0	0
13	45471367	.	A	T	31	13	44	0	1	45	0	0
13	45471475	.	C	A	16	19	35	0	2	37	0	0
13	45471669	.	C	T	33	26	59	0	0	59	0	0
13	45471888	.	C	T	0	19	19	0	18	37	0	0
13	45472124	.	T	G	13	6	19	0	0	19	0	0
13	45472215	.	G	C	30	18	48	0	0	48	0	0
13	45472653	.	G	A	31	37	68	0	2	70	0	0
13	45472924	.	G	A	42	39	81	0	2	83	0	0
13	45472954	.	G	A	41	39	80	0	4	84	0	0
13	45476360	.	A	C	16	13	29	0	0	29	0	0
13	45476711	.	C	T	16	19	35	0	1	36	0	0
13	45476731	.	A	T	20	19	39	0	1	40	0	0
13	45481475	.	G	A	16	19	35	0	1	36	0	0
13	45481792	.	A	G	2	7	9	0	0	9	0	0
13	45494912	.	G	C	23	22	45	0	6	51	0	0
13	45495227	.	C	A	21	20	41	0	3	44	0	0
13	45495442	.	G	T	4	5	9	0	0	9	0	0
13	45524500	.	T	C	10	7	17	0	0	17	0	0
13	45553072	.	G	A	13	7	20	0	0	20	0	0
13	45553168	.	G	A	15	7	22	1	0	23	0	0
13	45565508	.	C	T	15	11	26	0	1	27	0	0
13	45565637	.	G	A	11	11	22	0	2	24	0	0
13	45565646	.	G	A	1	10	11	0	14	25	0	0
13	45570300	.	A	C	6	9	15	0	0	15	0	0
13	45644646	.	G	A	1	3	4	0	0	4	0	0
13	45991772	.	T	C	24	24	48	0	3	51	0	0
13	45991801	.	C	T	21	26	47	0	3	50	0	0
13	45999530	.	G	A	0	16	16	0	18	34	0	0
13	45999723	.	C	T	14	21	35	0	1	36	0	0
13	46000060	.	G	A	2	2	4	0	3	7	0	0
13	46179340	.	C	T	28	35	63	0	2	65	0	0
13	46179387	.	C	T	33	30	63	0	1	64	0	0
13	46179392	.	G	A	33	23	56	0	8	64	0	0
13	46179806	.	T	A	36	15	51	0	5	56	0	0
13	46179814	.	A	G	35	19	54	0	4	58	0	0
13	46298734	.	G	A	8	9	17	0	2	19	0	0
13	46298973	.	T	C	8	5	13	0	0	13	0	0
13	46299389	.	T	A	2	3	5	0	0	5	0	0
13	46299677	.	G	T	6	9	15	0	1	16	0	0
13	46299812	.	C	T	1	6	7	0	11	18	0	0
13	46299827	.	A	G	12	8	20	0	0	20	0	0
13	46299873	.	T	A	9	6	15	0	0	15	0	0
13	46299875	.	T	G	9	5	14	0	1	15	0	0
13	46299934	.	G	A	7	6	13	0	0	13	0	0
13	46300224	.	T	A	7	9	16	0	0	16	0	0
13	46300247	.	A	T	6	7	13	0	0	13	0	0
13	46300259	.	T	G	7	7	14	0	0	14	0	0
13	46300421	.	C	T	11	12	23	0	1	24	0	0
13	46300450	.	C	T	12	7	19	0	0	19	0	0
13	46300694	.	T	A	8	17	25	0	0	25	0	0
13	46300737	.	G	A	8	13	21	0	6	27	0	0
13	46343432	.	T	C	10	0	10	0	10	20	0	0
13	46343471	.	G	A	9	10	19	0	0	19	0	0
13	46343486	.	G	A	7	12	19	0	3	22	0	0
13	46343525	.	G	A	16	14	30	0	0	30	0	0
13	46346306	.	G	A	13	8	21	0	0	21	0	0
13	46356661	.	G	T	5	3	8	0	0	8	0	0
13	46384311	.	A	G	3	3	6	0	0	6	0	0
13	46520845	.	T	C	3	2	5	0	0	5	0	0
13	46520924	.	T	C	4	6	10	0	0	10	0	0
13	46521542	.	C	T	0	2	2	0	4	6	0	0
13	46521633	.	G	A	5	9	14	0	1	15	0	0
13	46521664	.	C	A	7	9	16	0	1	17	0	0
13	46521762	.	T	A	7	4	11	0	2	13	0	0
13	46674815	.	A	G	4	8	12	0	0	12	0	0
13	46686936	.	T	C	6	3	9	3	0	12	0	0
13	46687008	.	C	G	5	4	9	0	0	9	0	0
13	46687037	.	G	T	5	7	12	0	0	12	0	0
13	46687086	.	G	A	2	4	6	0	0	6	0	0
13	46718871	.	A	C	6	3	9	0	1	10	0	0
13	46718930	.	T	C	2	2	4	1	0	5	0	0
13	46771366	.	A	C	4	6	10	0	0	10	0	0
13	46793193	.	G	A	0	5	5	0	2	7	0	0
13	46795515	.	G	A	0	12	12	0	11	23	0	0
13	46804112	.	G	A	1	2	3	0	0	3	0	0
13	46831698	.	C	T	1	4	5	0	7	12	0	0
13	46832315	.	T	C	7	0	7	1	5	13	0	0
13	46832371	.	A	C	12	5	17	0	3	20	0	0
13	46832374	.	T	C	15	5	20	0	0	20	0	0
13	46832449	.	A	T	17	5	22	0	2	24	0	0
13	46832471	.	A	C	20	7	27	0	0	27	0	0
13	46832724	.	C	A	0	8	8	0	9	17	0	0
13	46833050	.	C	G	8	5	13	0	0	13	0	0
13	46833064	.	C	T	7	6	13	0	0	13	0	0
13	46833197	.	A	G	4	3	7	0	0	7	0	0
13	46834054	.	T	C	4	4	8	0	0	8	0	0
13	46834504	.	G	A	4	3	7	0	0	7	0	0
13	46834550	.	G	A	6	6	12	0	0	12	0	0
13	46834815	.	C	T	10	6	16	0	0	16	0	0
13	46834860	.	T	A	4	7	11	0	0	11	0	0
13	46835270	.	C	G	4	2	6	0	0	6	0	0
13	46835304	.	C	T	4	5	9	0	0	9	0	0
13	46835344	.	C	T	1	6	7	1	0	8	0	0
13	46857629	.	A	T	3	7	10	0	0	10	0	0
13	46860158	.	T	C	5	0	5	0	4	9	0	0
13	46864873	.	C	A	0	4	4	0	5	9	0	0
13	46929067	.	G	T	0	2	2	0	1	3	0	0
13	46929071	.	T	C	1	1	2	0	0	2	0	0
13	46935014	.	T	G	2	4	6	0	1	7	0	0
13	46935089	.	C	T	1	3	4	0	0	4	0	0
13	46936916	.	G	A	2	5	7	0	0	7	0	0
13	46988299	.	C	T	16	17	33	0	2	35	0	0
13	46988390	.	T	C	10	2	12	0	19	31	0	0
13	46988457	.	C	A	2	12	14	0	15	29	0	0
13	46988561	.	A	G	17	16	33	0	0	33	0	0
13	46988588	.	A	G	20	24	44	0	0	44	0	0
13	46988638	.	T	G	15	20	35	0	1	36	0	0
13	46989607	.	C	T	2	21	23	0	21	44	0	0
13	47007223	.	C	A	1	2	3	0	1	4	0	0
13	47030514	.	A	G	1	3	4	0	1	5	0	0
13	47045212	.	G	T	1	2	3	0	0	3	0	0
13	47045234	.	C	A	2	3	5	0	0	5	0	0
13	47099900	.	A	T	1	5	6	0	1	7	0	0
13	47100347	.	C	T	2	4	6	0	2	8	0	0
13	47127266	.	T	C	3	4	7	0	0	7	0	0
13	47130927	.	A	G	1	0	1	0	3	4	0	0
13	47135882	.	C	T	4	3	7	0	0	7	0	0
13	47135885	.	G	A	0	3	3	0	3	6	0	0
13	47146860	.	C	T	6	2	8	0	1	9	0	0
13	47163748	.	A	G	5	0	5	0	7	12	0	0
13	47388633	.	A	G	1	3	4	0	0	4	0	0
13	47507121	.	A	G	1	3	4	0	2	6	0	0
13	47507154	.	A	C	1	2	3	0	2	5	0	0
13	47556374	.	T	C	1	2	3	0	0	3	0	0
13	47683807	.	T	C	1	5	6	0	0	6	0	0
13	47684293	.	T	C	1	2	3	0	0	3	0	0
13	47689136	.	T	C	1	2	3	0	0	3	0	0
13	47689220	.	C	T	2	2	4	0	0	4	0	0
13	47689478	.	A	C	1	2	3	0	0	3	0	0
13	47690269	.	A	T	2	8	10	0	0	10	0	0
13	47690300	.	A	T	2	4	6	0	0	6	0	0
13	47690329	.	T	A	2	3	5	0	0	5	0	0
13	47690434	.	A	G	2	4	6	0	0	6	0	0
13	47690766	.	T	C	3	1	4	0	0	4	0	0
13	47690779	.	G	A	1	2	3	0	3	6	0	0
13	47691316	.	G	A	1	2	3	0	0	3	0	0
13	47691328	.	T	C	1	3	4	0	0	4	0	0
13	47723765	.	C	T	5	8	13	0	0	13	0	0
13	47723778	.	A	G	6	0	6	0	6	12	0	0
13	47752108	.	T	G	2	3	5	0	0	5	0	0
13	47834276	.	C	A	2	4	6	0	0	6	0	0
13	47835638	.	G	T	3	8	11	0	1	12	0	0
13	47838024	.	G	A	5	11	16	0	0	16	0	0
13	47838052	.	G	A	0	11	11	0	7	18	0	0
13	47838650	.	G	C	3	2	5	0	0	5	0	0
13	47839071	.	C	T	6	8	14	0	1	15	0	0
13	47839119	.	A	T	6	8	14	0	0	14	0	0
13	48533161	.	A	G	1	1	2	0	2	4	0	0
13	48549008	.	C	T	8	6	14	0	0	14	0	0
13	48748722	.	A	G	2	4	6	0	0	6	0	0
13	48755035	.	A	G	5	3	8	0	1	9	0	0
13	48755122	.	T	C	12	6	18	0	1	19	0	0
13	48758775	.	T	C	1	0	1	0	2	3	0	0
13	48760177	.	C	A	2	5	7	0	0	7	0	0
13	48760180	.	T	C	1	4	5	0	1	6	0	0
13	48763258	.	T	C	1	2	3	0	0	3	0	0
13	48766270	.	C	T	5	5	10	0	0	10	0	0
13	49153904	.	T	C	8	6	14	0	0	14	0	0
13	49153938	.	G	A	5	3	8	0	1	9	0	0
13	49153953	.	A	G	6	4	10	0	0	10	0	0
13	49154048	.	G	A	8	10	18	0	0	18	0	0
13	49154249	.	C	T	6	2	8	0	0	8	0	0
13	49154257	.	G	A	6	3	9	0	0	9	0	0
13	49154631	.	T	C	17	0	17	0	10	27	0	0
13	49158734	.	G	A	9	6	15	0	1	16	0	0
13	49167185	.	T	G	5	8	13	0	0	13	0	0
13	49167195	.	C	T	5	8	13	0	0	13	0	0
13	49169071	.	A	T	7	6	13	0	0	13	0	0
13	49169121	.	G	C	8	9	17	0	0	17	0	0
13	49169455	.	C	A	1	2	3	0	4	7	0	0
13	49176009	.	G	C	3	2	5	0	0	5	0	0
13	49176036	.	T	C	3	2	5	0	0	5	0	0
13	49176144	.	C	T	3	2	5	0	0	5	0	0
13	49176171	.	T	C	2	3	5	0	1	6	0	0
13	49443721	.	C	T	24	27	51	0	0	51	0	0
13	49443868	.	T	C	23	2	25	0	24	49	0	0
13	49444090	.	C	T	28	23	51	0	3	54	0	0
13	49444177	.	C	A	2	27	29	0	21	50	0	0
13	49444224	.	G	A	20	20	40	0	2	42	0	0
13	49444446	.	C	A	19	19	38	0	3	41	0	0
13	49542966	.	T	C	1	4	5	0	0	5	0	0
13	49543145	.	A	T	1	5	6	0	1	7	0	0
13	49544535	.	G	A	1	2	3	0	0	3	0	0
13	49544700	.	T	C	1	7	8	0	0	8	0	0
13	49544833	.	C	T	18	21	39	0	0	39	0	0
13	49544873	.	T	A	17	17	34	0	1	35	0	0
13	49544973	.	G	T	20	19	39	0	0	39	0	0
13	49545039	.	A	G	22	24	46	0	1	47	0	0
13	49583976	.	A	G	19	25	44	0	2	46	0	0
13	49585341	.	T	A	20	16	36	0	1	37	0	0
13	49585344	.	A	T	20	16	36	0	0	36	0	0
13	49585384	.	T	G	9	6	15	0	0	15	0	0
13	49597297	.	C	T	0	6	6	0	9	15	0	0
13	49599521	.	G	A	8	7	15	0	0	15	0	0
13	49605897	.	T	C	3	0	3	0	2	5	0	0
13	49605904	.	A	G	2	2	4	0	0	4	0	0
13	49608888	.	T	C	4	3	7	0	0	7	0	0
13	49609056	.	T	C	2	0	2	0	4	6	0	0
13	49609268	.	C	T	2	7	9	0	1	10	0	0
13	49636115	.	G	T	8	4	12	0	0	12	0	0
13	49636240	.	C	T	6	3	9	0	0	9	0	0
13	49642805	.	G	T	3	5	8	0	1	9	0	0
13	49666565	.	T	C	2	2	4	0	0	4	0	0
13	49727463	.	T	G	4	2	6	0	0	6	0	0
13	49727548	.	A	G	1	3	4	0	0	4	0	0
13	49727550	.	A	G	1	3	4	0	0	4	0	0
13	49765806	.	C	T	2	4	6	0	0	6	0	0
13	49765815	.	G	T	0	4	4	0	3	7	0	0
13	49765896	.	T	C	7	10	17	0	0	17	0	0
13	49766022	.	T	C	5	6	11	0	0	11	0	0
13	49766268	.	G	A	2	8	10	0	7	17	0	0
13	49767539	.	A	G	8	12	20	0	4	24	0	0
13	49767570	.	G	A	19	6	25	0	0	25	0	0
13	49767736	.	T	G	8	11	19	0	0	19	0	0
13	49767806	.	T	A	6	7	13	0	0	13	0	0
13	49767807	.	G	T	6	7	13	0	0	13	0	0
13	49768095	.	A	G	6	10	16	0	1	17	0	0
13	49768207	.	C	T	7	11	18	0	0	18	0	0
13	49768401	.	C	T	17	14	31	0	0	31	0	0
13	49768402	.	A	C	17	14	31	0	0	31	0	0
13	49768592	.	A	T	8	6	14	0	1	15	0	0
13	49768646	.	A	G	8	4	12	0	0	12	0	0
13	49768917	.	T	A	3	4	7	0	0	7	0	0
13	49769060	.	C	T	10	8	18	1	0	19	0	0
13	49769141	.	G	C	6	7	13	1	0	14	0	0
13	49769274	.	G	A	0	3	3	0	2	5	0	0
13	49775018	.	T	G	2	8	10	0	0	10	0	0
13	49775048	.	C	G	5	3	8	0	0	8	0	0
13	49775075	.	T	G	7	4	11	0	0	11	0	0
13	49785412	.	C	T	5	9	14	0	0	14	0	0
13	49785417	.	T	C	5	9	14	0	0	14	0	0
13	49785455	.	C	G	9	5	14	0	0	14	0	0
13	49785456	.	A	G	9	5	14	0	0	14	0	0
13	49786114	.	A	G	12	7	19	0	1	20	0	0
13	49788102	.	A	T	14	11	25	0	0	25	0	0
13	49802010	.	C	A	7	5	12	0	0	12	0	0
13	49802025	.	T	G	6	4	10	0	0	10	0	0
13	49818982	.	A	G	7	10	17	0	0	17	0	0
13	49819001	.	C	A	1	9	10	0	8	18	0	0
13	49819019	.	A	G	8	11	19	0	0	19	0	0
13	49904236	.	T	C	4	3	7	0	0	7	0	0
13	49907480	.	A	G	3	5	8	0	0	8	0	0
13	49907549	.	C	T	3	4	7	0	0	7	0	0
13	49915484	.	C	A	6	5	11	0	0	11	0	0
13	49915580	.	A	G	4	3	7	0	1	8	0	0
13	49917748	.	T	C	4	5	9	0	0	9	0	0
13	49922870	.	G	T	3	6	9	0	0	9	0	0
13	49922904	.	A	G	2	4	6	0	0	6	0	0
13	49922970	.	C	T	0	3	3	0	2	5	0	0
13	49923678	.	C	A	1	5	6	0	0	6	0	0
13	49931689	.	C	T	5	4	9	0	1	10	0	0
13	49940894	.	C	A	2	3	5	0	0	5	0	0
13	49951965	.	G	A	1	2	3	0	0	3	0	0
13	50169004	.	C	T	11	13	24	2	2	28	0	0
13	50670846	.	A	T	8	7	15	0	0	15	0	0
13	50670911	.	G	C	9	7	16	1	0	17	0	0
13	50672297	.	T	C	5	1	6	0	9	15	0	0
13	50712066	.	G	T	6	3	9	0	0	9	0	0
13	50712093	.	T	C	6	3	9	0	0	9	0	0
13	50712125	.	A	G	3	4	7	0	1	8	0	0
13	50715205	.	A	G	6	3	9	0	0	9	0	0
13	50715615	.	T	C	3	0	3	0	4	7	0	0
13	51140665	.	A	G	22	10	32	0	1	33	0	0
13	51140782	.	A	G	16	13	29	0	1	30	0	0
13	51145614	.	T	G	19	14	33	0	2	35	0	0
13	51147152	.	G	A	15	13	28	0	2	30	0	0
13	51147164	.	A	G	17	10	27	0	0	27	0	0
13	51162561	.	A	G	15	11	26	0	1	27	0	0
13	51162579	.	T	G	13	11	24	0	2	26	0	0
13	51169874	.	C	G	10	13	23	2	1	26	0	0
13	52010822	.	C	T	1	6	7	0	0	7	0	0
14	355425	.	T	A	2	2	4	0	0	4	0	0
14	547023	.	T	C	2	0	2	0	2	4	0	0
14	547170	.	A	G	3	2	5	0	0	5	0	0
14	548928	.	C	T	3	2	5	0	1	6	0	0
14	557740	.	C	T	1	2	3	0	0	3	0	0
14	557761	.	A	G	2	2	4	0	0	4	0	0
14	565193	.	T	G	4	4	8	0	0	8	0	0
14	565260	.	A	T	3	3	6	0	0	6	0	0
14	565350	.	G	C	3	3	6	1	0	7	0	0
14	565354	.	T	A	4	3	7	1	0	8	0	0
14	606255	.	A	G	9	6	15	0	1	16	0	0
14	616648	.	G	A	4	2	6	0	1	7	0	0
14	620200	.	C	A	3	2	5	0	0	5	0	0
14	684179	.	G	A	17	17	34	0	3	37	0	0
14	699369	.	G	A	1	2	3	0	0	3	0	0
14	699370	.	T	G	1	2	3	0	0	3	0	0
14	699646	.	C	T	2	3	5	0	3	8	0	0
14	715123	.	G	C	6	11	17	0	0	17	0	0
14	715126	.	T	C	6	11	17	0	0	17	0	0
14	715201	.	C	T	6	2	8	0	0	8	0	0
14	715207	.	A	G	6	0	6	0	3	9	0	0
14	716714	.	C	T	1	3	4	0	0	4	0	0
14	717927	.	G	A	5	1	6	0	2	8	0	0
14	718194	.	A	C	4	4	8	0	0	8	0	0
14	719447	.	A	G	6	9	15	0	0	15	0	0
14	719926	.	A	G	5	6	11	0	0	11	0	0
14	723539	.	T	C	8	10	18	0	0	18	0	0
14	723542	.	T	C	8	8	16	0	0	16	0	0
14	761064	.	A	G	1	2	3	0	0	3	0	0
14	790989	.	C	T	4	5	9	0	0	9	0	0
14	791067	.	C	G	6	0	6	0	3	9	0	0
14	791696	.	T	A	3	3	6	0	0	6	0	0
14	791707	.	T	A	3	2	5	0	1	6	0	0
14	791913	.	A	T	5	3	8	0	0	8	0	0
14	791989	.	G	T	2	3	5	0	0	5	0	0
14	792133	.	C	A	5	3	8	0	1	9	0	0
14	792142	.	T	C	3	2	5	0	1	6	0	0
14	792499	.	C	G	1	0	1	0	2	3	0	0
14	792686	.	G	A	3	5	8	0	0	8	0	0
14	839313	.	C	T	1	2	3	0	0	3	0	0
14	863188	.	T	C	3	5	8	0	0	8	0	0
14	863767	.	A	G	7	5	12	0	1	13	0	0
14	863807	.	A	T	16	9	25	0	1	26	0	0
14	863868	.	G	T	17	9	26	0	0	26	0	0
14	863949	.	T	C	12	4	16	0	0	16	0	0
14	868838	.	G	A	20	7	27	0	1	28	0	0
14	868855	.	A	G	17	8	25	0	2	27	0	0
14	937399	.	A	T	1	2	3	0	0	3	0	0
14	937849	.	A	C	2	3	5	0	0	5	0	0
14	938683	.	C	T	0	4	4	0	1	5	0	0
14	938688	.	T	C	1	3	4	0	1	5	0	0
14	938744	.	A	G	1	2	3	0	0	3	0	0
14	938803	.	C	T	2	3	5	0	0	5	0	0
14	940424	.	G	A	1	2	3	0	0	3	0	0
14	941408	.	C	G	1	3	4	0	1	5	0	0
14	941678	.	A	T	1	4	5	0	0	5	0	0
14	942312	.	A	G	1	2	3	0	0	3	0	0
14	944384	.	G	A	2	2	4	0	0	4	0	0
14	944393	.	C	G	0	2	2	0	2	4	0	0
14	994353	.	G	T	0	4	4	0	1	6	1	0
14	994413	.	C	T	2	3	5	0	2	7	0	0
14	994437	.	T	C	4	5	9	0	0	9	0	0
14	997484	.	A	G	1	0	1	0	2	3	0	0
14	997603	.	T	C	1	4	5	0	0	5	0	0
14	997651	.	A	C	1	2	3	0	0	3	0	0
14	997705	.	C	A	5	6	11	0	0	11	0	0
14	997765	.	T	C	4	6	10	0	0	10	0	0
14	997783	.	A	G	2	6	8	0	0	8	0	0
14	1040207	.	C	A	1	3	4	0	0	4	0	0
14	1119141	.	C	T	3	2	5	0	0	5	0	0
14	1119225	.	C	T	8	7	15	0	2	17	0	0
14	1119423	.	A	G	6	4	10	0	6	16	0	0
14	1119432	.	T	C	5	6	11	0	4	15	0	0
14	1119993	.	T	C	7	9	16	0	0	16	0	0
14	1120017	.	T	C	10	8	18	0	0	18	0	0
14	1120072	.	C	A	8	12	20	1	1	22	0	0
14	1120154	.	T	C	7	12	19	0	0	19	0	0
14	1120178	.	C	T	5	9	14	0	0	14	0	0
14	1120196	.	T	G	5	0	5	0	6	11	0	0
14	1120236	.	C	T	6	5	11	0	1	12	0	0
14	1120452	.	G	T	0	5	5	0	5	10	0	0
14	1120598	.	T	C	3	3	6	0	0	6	0	0
14	1121029	.	A	G	4	6	10	0	1	11	0	0
14	1121068	.	C	T	9	3	12	0	1	13	0	0
14	1121297	.	T	G	4	3	7	0	0	7	0	0
14	1121303	.	G	C	4	5	9	0	0	9	0	0
14	1124602	.	C	G	8	10	18	0	0	18	0	0
14	1127693	.	G	A	9	8	17	0	1	18	0	0
14	1128800	.	C	G	13	6	19	0	0	19	0	0
14	1128836	.	A	C	5	5	10	0	1	11	0	0
14	1138611	.	C	A	9	6	15	0	1	16	0	0
14	1138626	.	G	A	1	4	5	0	10	15	0	0
14	1139509	.	C	T	9	7	16	0	0	16	0	0
14	1145203	.	C	A	4	7	11	0	0	11	0	0
14	1146630	.	G	A	4	8	12	0	0	12	0	0
14	1150594	.	A	G	6	6	12	0	1	13	0	0
14	1152544	.	C	A	14	11	25	0	4	29	0	0
14	1153665	.	T	C	11	6	17	0	0	18	1	0
14	1153830	.	T	A	16	8	24	0	0	24	0	0
14	1159869	.	A	G	7	0	7	0	14	21	0	0
14	1160333	.	C	T	16	7	23	1	1	25	0	0
14	1160427	.	T	G	9	18	27	0	0	27	0	0
14	1171023	.	T	C	9	9	18	0	2	20	0	0
14	1171052	.	T	A	12	14	26	0	0	26	0	0
14	1171081	.	T	A	10	10	20	0	1	21	0	0
14	1192445	.	T	C	12	1	13	0	2	15	0	0
14	1192448	.	G	A	10	3	13	0	1	14	0	0
14	1192681	.	C	T	5	6	11	1	1	13	0	0
14	1194090	.	C	T	2	8	10	0	8	18	0	0
14	1194133	.	G	A	6	8	14	0	0	14	0	0
14	1194154	.	C	T	1	7	8	0	6	14	0	0
14	1196568	.	C	G	6	6	12	0	1	13	0	0
14	1196658	.	T	G	4	8	12	0	2	14	0	0
14	1200460	.	T	G	3	8	11	0	1	12	0	0
14	1200545	.	G	T	5	6	11	0	1	12	0	0
14	1200615	.	A	G	5	3	8	1	2	11	0	0
14	1200676	.	C	T	2	5	7	0	5	12	0	0
14	1203713	.	A	G	28	13	41	0	2	43	0	0
14	1203770	.	G	T	23	14	37	0	3	40	0	0
14	1204197	.	A	T	21	16	37	0	2	39	0	0
14	1204299	.	G	A	12	15	27	0	2	29	0	0
14	1225227	.	C	T	2	11	13	0	9	22	0	0
14	1947457	.	G	A	2	2	4	0	0	4	0	0
14	1956470	.	C	T	7	3	10	0	1	11	0	0
14	2003514	.	A	G	3	3	6	0	0	6	0	0
14	2049794	.	C	A	0	5	5	0	1	6	0	0
14	2203058	.	G	T	1	3	4	0	1	5	0	0
14	2203092	.	T	C	1	5	6	0	0	6	0	0
14	2205747	.	A	G	1	2	3	0	0	3	0	0
14	2212826	.	C	A	1	3	4	0	2	6	0	0
14	2212983	.	G	A	1	2	3	0	0	3	0	0
14	2213276	.	T	C	1	2	3	2	0	5	0	0
14	2262917	.	A	G	6	2	8	0	0	8	0	0
14	2264144	.	C	T	2	2	4	0	0	4	0	0
14	2264174	.	A	T	2	2	4	0	0	4	0	0
14	2322320	.	A	G	2	2	4	0	0	4	0	0
14	2351565	.	A	T	2	8	10	2	1	13	0	0
14	2351566	.	G	T	1	9	10	2	1	13	0	0
14	2351762	.	G	A	3	9	12	3	1	16	0	0
14	2352132	.	C	T	1	8	9	0	1	10	0	0
14	2352280	.	T	G	6	3	9	2	1	12	0	0
14	2360116	.	T	A	2	11	13	2	0	15	0	0
14	3451275	.	C	G	3	0	3	0	4	7	0	0
14	3451300	.	T	A	2	2	4	0	0	4	0	0
14	3576057	.	T	A	18	10	28	4	1	33	0	0
14	4183908	.	A	G	8	3	11	0	1	12	0	0
14	4291577	.	A	G	4	6	10	0	0	10	0	0
14	4611041	.	G	A	4	4	8	0	8	16	0	0
14	4813280	.	A	G	1	0	1	0	3	4	0	0
14	4813497	.	T	A	2	4	6	0	1	7	0	0
14	5628538	.	T	A	0	12	12	1	0	13	0	0
14	6332872	.	T	C	9	7	16	0	0	16	0	0
14	6341993	.	C	T	1	2	3	0	1	4	0	0
14	6624558	.	A	G	18	0	18	0	12	30	0	0
14	6624621	.	A	G	8	23	31	0	1	32	0	0
14	6625336	.	T	A	36	10	46	6	3	55	0	0
14	6625521	.	G	C	29	29	58	1	4	63	0	0
14	6625794	.	A	G	4	16	20	1	1	22	0	0
14	6625805	.	A	G	16	9	25	1	1	27	0	0
14	7168648	.	T	C	2	2	4	0	0	4	0	0
14	7172126	.	A	T	1	2	3	0	0	3	0	0
14	8267919	.	A	T	2	3	5	0	0	5	0	0
14	8496257	.	A	G	4	2	6	1	1	8	0	0
14	8770589	.	C	T	5	6	11	0	0	11	0	0
14	8771516	.	C	T	1	2	3	0	0	3	0	0
14	8806587	.	A	C	4	0	4	0	5	9	0	0
14	8806590	.	A	G	5	4	9	0	0	9	0	0
14	8806680	.	T	C	11	5	16	0	1	17	0	0
14	8806722	.	A	G	14	4	18	0	0	18	0	0
14	8806730	.	G	T	13	4	17	0	2	19	0	0
14	8809693	.	A	G	12	7	19	0	6	25	0	0
14	8816113	.	T	C	4	9	13	0	1	14	0	0
14	8816135	.	A	T	6	8	14	0	0	14	0	0
14	8816194	.	C	T	15	8	23	0	0	23	0	0
14	8816261	.	G	A	15	7	22	0	0	22	0	0
14	8816283	.	T	G	15	6	21	0	0	21	0	0
14	8816339	.	A	G	7	7	14	0	1	15	0	0
14	8816457	.	A	G	4	9	13	0	0	13	0	0
14	8816482	.	A	T	5	10	15	0	0	15	0	0
14	8816695	.	C	G	4	3	7	0	0	7	0	0
14	8816848	.	A	G	17	11	28	0	0	28	0	0
14	8816877	.	C	A	0	7	7	0	11	18	0	0
14	8819082	.	T	C	4	0	4	0	7	11	0	0
14	8821677	.	G	A	4	9	13	0	0	13	0	0
14	8830236	.	G	T	3	4	7	0	3	11	1	0
14	8830302	.	C	T	1	11	12	0	6	18	0	0
14	8832736	.	A	C	5	7	12	0	0	12	0	0
14	8836160	.	G	A	8	7	15	0	0	15	0	0
14	8836298	.	T	C	4	11	15	0	0	15	0	0
14	8841352	.	A	T	7	12	19	0	1	20	0	0
14	8844045	.	G	A	3	4	7	0	0	7	0	0
14	8849344	.	A	G	1	2	3	0	0	3	0	0
14	8860664	.	A	G	1	3	4	0	0	4	0	0
14	8860702	.	G	A	3	3	6	0	1	7	0	0
14	8862221	.	G	T	3	5	8	0	0	8	0	0
14	8868956	.	C	T	0	4	4	0	2	6	0	0
14	8878190	.	A	T	2	4	6	0	0	6	0	0
14	8882437	.	T	C	1	0	1	0	2	3	0	0
14	8882464	.	C	T	1	3	4	0	0	4	0	0
14	8951108	.	A	G	7	0	7	0	8	15	0	0
14	8982390	.	C	T	13	15	28	0	0	28	0	0
14	8991718	.	A	T	11	21	32	0	2	34	0	0
14	8991823	.	T	C	16	14	30	0	1	31	0	0
14	9001411	.	G	A	17	11	28	0	0	28	0	0
14	9001426	.	C	T	17	10	27	0	1	28	0	0
14	9001752	.	C	G	15	1	16	0	12	28	0	0
14	9001875	.	T	C	17	13	30	0	1	31	0	0
14	9033783	.	G	A	5	2	7	0	1	8	0	0
14	9034114	.	A	G	3	7	10	0	0	10	0	0
14	9034128	.	T	G	3	7	10	0	1	11	0	0
14	9034161	.	C	T	5	11	16	0	0	16	0	0
14	9034307	.	G	A	5	3	8	0	0	8	0	0
14	9034430	.	T	C	10	11	21	0	0	21	0	0
14	9034701	.	C	T	0	8	8	0	11	19	0	0
14	9034742	.	C	T	10	3	13	0	1	14	0	0
14	9034743	.	T	C	9	0	9	0	5	14	0	0
14	9034932	.	A	G	10	11	21	0	1	22	0	0
14	9035051	.	C	G	10	7	17	0	0	17	0	0
14	9035100	.	C	T	10	7	17	0	2	19	0	0
14	9035110	.	C	T	1	10	11	0	6	17	0	0
14	9035175	.	G	A	6	4	10	0	0	10	0	0
14	9035249	.	G	T	8	7	15	0	0	15	0	0
14	9035337	.	A	C	2	3	5	0	0	5	0	0
14	9035541	.	C	T	0	3	3	0	1	4	0	0
14	9035740	.	A	G	6	7	13	0	1	14	0	0
14	9035786	.	C	G	3	5	8	0	0	8	0	0
14	9035866	.	A	G	8	9	17	0	0	17	0	0
14	9035873	.	T	C	7	7	14	0	2	16	0	0
14	9036219	.	A	T	3	2	5	0	0	5	0	0
14	9036255	.	T	C	3	2	5	0	0	5	0	0
14	9036323	.	T	G	1	2	3	0	0	3	0	0
14	9036480	.	C	T	4	4	8	0	0	8	0	0
14	9036530	.	C	T	7	4	11	0	0	11	0	0
14	9036624	.	C	T	1	4	5	0	2	7	0	0
14	9040928	.	C	A	6	11	17	0	0	17	0	0
14	9050440	.	G	C	6	0	6	0	6	12	0	0
14	9142412	.	A	T	9	6	15	0	0	15	0	0
14	9142602	.	A	T	20	16	36	0	4	40	0	0
14	9142795	.	T	C	17	9	26	0	4	30	0	0
14	9142893	.	T	C	19	0	19	0	13	32	0	0
14	9142911	.	T	C	20	0	20	0	13	33	0	0
14	9142952	.	C	T	4	18	22	0	16	38	0	0
14	9143081	.	G	C	22	0	22	0	21	43	0	0
14	9143150	.	A	C	24	1	25	2	15	42	0	0
14	9143179	.	C	T	2	17	19	2	24	45	0	0
14	9143427	.	A	T	19	17	36	0	0	36	0	0
14	9143446	.	T	C	18	0	18	0	12	30	0	0
14	9143878	.	T	C	15	15	30	1	1	32	0	0
14	9144099	.	T	C	16	15	31	0	1	33	1	0
14	9144191	.	A	G	16	11	27	0	2	29	0	0
14	9144248	.	A	G	8	15	23	0	0	23	0	0
14	9144361	.	A	G	4	11	15	0	0	15	0	0
14	9144658	.	A	G	9	9	18	0	0	18	0	0
14	9145050	.	G	A	23	12	35	1	1	37	0	0
14	9157880	.	T	A	13	19	32	1	2	35	0	0
14	9158367	.	A	G	26	9	35	0	0	35	0	0
14	9159845	.	A	G	13	15	28	0	1	29	0	0
14	9159860	.	G	C	13	0	13	0	16	29	0	0
14	9163286	.	G	A	16	13	29	0	1	30	0	0
14	9173909	.	C	T	16	17	33	0	1	34	0	0
14	9177619	.	G	A	20	12	32	0	1	33	0	0
14	9344247	.	G	A	9	11	20	0	0	20	0	0
14	9344250	.	C	T	7	12	19	0	2	21	0	0
14	9344366	.	T	G	8	9	17	0	2	19	0	0
14	9405728	.	G	C	10	0	10	0	9	19	0	0
14	9405760	.	T	C	10	9	19	0	1	20	0	0
14	9405927	.	C	T	4	5	9	0	0	9	0	0
14	9405940	.	A	C	2	3	5	0	0	5	0	0
14	9406070	.	A	G	2	5	7	0	0	7	0	0
14	9406320	.	T	C	11	0	11	0	9	20	0	0
14	9406453	.	A	T	9	7	16	0	1	17	0	0
14	9406485	.	A	G	10	11	21	0	0	21	0	0
14	9406509	.	T	C	9	12	21	0	1	22	0	0
14	9406607	.	T	C	8	4	12	0	0	12	0	0
14	9406773	.	T	A	8	10	18	0	0	18	0	0
14	9406791	.	A	G	7	10	17	0	0	17	0	0
14	9407074	.	A	T	5	4	9	0	0	9	0	0
14	9407193	.	A	T	0	2	2	0	1	3	0	0
14	9407199	.	C	A	1	2	3	0	0	3	0	0
14	9407425	.	A	C	3	2	5	1	0	6	0	0
14	9407707	.	C	T	1	7	8	0	2	10	0	0
14	9408019	.	C	T	3	3	6	0	0	6	0	0
14	9408260	.	C	G	11	10	21	0	2	23	0	0
14	9408320	.	T	G	6	6	12	0	0	12	0	0
14	9420810	.	G	A	4	3	7	0	1	8	0	0
14	9420871	.	C	A	5	6	11	0	0	11	0	0
14	9421768	.	C	A	1	2	3	0	0	3	0	0
14	9424668	.	C	A	40	18	58	0	3	61	0	0
14	9475796	.	T	A	1	3	4	0	0	4	0	0
14	9481647	.	C	A	7	3	10	1	0	11	0	0
14	9481924	.	C	T	1	9	10	0	0	10	0	0
14	9481926	.	G	T	1	9	10	0	0	10	0	0
14	9482062	.	A	G	3	5	8	0	0	8	0	0
14	9485121	.	A	T	7	5	12	0	0	12	0	0
14	9485366	.	T	A	8	11	19	0	0	19	0	0
14	9494939	.	A	G	5	1	6	0	11	17	0	0
14	9495107	.	G	A	1	7	8	0	14	22	0	0
14	9498163	.	C	T	9	11	20	0	0	20	0	0
14	9498308	.	G	A	5	6	11	0	0	11	0	0
14	9498570	.	C	T	10	6	16	0	1	17	0	0
14	9498728	.	A	T	7	5	12	0	0	12	0	0
14	9498841	.	C	G	18	6	24	0	0	24	0	0
14	9498879	.	T	A	17	5	22	0	1	23	0	0
14	9499048	.	G	T	7	7	14	0	0	14	0	0
14	9516565	.	C	T	2	3	5	0	0	5	0	0
14	9521905	.	A	C	2	0	2	0	2	4	0	0
14	9522061	.	C	T	3	4	7	0	1	8	0	0
14	9584592	.	C	T	3	3	6	0	0	6	0	0
14	9584653	.	C	T	2	2	4	0	0	4	0	0
14	9587418	.	C	T	2	2	4	0	0	4	0	0
14	9587639	.	A	G	5	4	9	0	0	9	0	0
14	9587796	.	G	C	4	3	7	0	0	7	0	0
14	9588102	.	T	A	2	5	7	0	1	8	0	0
14	9588145	.	G	A	3	3	6	0	0	6	0	0
14	9588210	.	G	A	0	3	3	0	4	7	0	0
14	9588221	.	G	C	4	3	7	0	0	7	0	0
14	9589719	.	G	A	0	2	2	0	1	3	0	0
14	9589731	.	G	T	0	2	2	0	1	3	0	0
14	9590716	.	T	C	2	2	4	0	0	4	0	0
14	9590909	.	A	G	3	2	5	1	1	7	0	0
14	9591144	.	T	C	2	1	3	0	1	4	0	0
14	9592608	.	A	G	3	2	5	0	0	5	0	0
14	9593505	.	A	G	27	12	39	0	1	40	0	0
14	9593610	.	T	A	15	14	29	0	1	30	0	0
14	9593622	.	A	T	16	16	32	0	1	33	0	0
14	9593974	.	C	T	26	16	42	0	1	43	0	0
14	9594466	.	G	A	8	9	17	0	0	17	0	0
14	9594577	.	C	T	15	10	25	0	2	27	0	0
14	9594578	.	A	G	14	11	25	0	2	27	0	0
14	9594623	.	C	T	14	8	22	0	2	24	0	0
14	9594677	.	G	C	10	13	23	0	1	24	0	0
14	9595086	.	A	C	16	7	23	0	0	23	0	0
14	9595119	.	G	A	6	16	22	0	0	22	0	0
14	9595593	.	T	G	6	10	16	1	1	18	0	0
14	9595890	.	C	T	9	12	21	0	2	23	0	0
14	9595992	.	C	A	20	10	30	0	2	32	0	0
14	9596338	.	C	T	11	10	21	0	2	23	0	0
14	9639768	.	G	A	1	2	3	0	0	3	0	0
14	9717978	.	C	A	1	7	8	0	7	15	0	0
14	9739987	.	G	T	3	5	8	0	0	8	0	0
14	9821794	.	C	T	0	5	5	0	3	8	0	0
14	10338507	.	G	C	8	3	11	0	0	11	0	0
14	10338942	.	A	G	5	5	10	0	0	10	0	0
14	10339081	.	T	G	8	5	13	0	0	13	0	0
14	10339883	.	A	C	16	13	29	0	1	30	0	0
14	10339943	.	A	G	17	11	28	0	2	30	0	0
14	10340068	.	G	A	14	14	28	0	0	28	0	0
14	10340096	.	G	A	12	14	26	0	0	26	0	0
14	10340189	.	T	A	16	6	22	0	1	23	0	0
14	10340193	.	C	G	17	5	22	0	1	23	0	0
14	10340288	.	C	A	18	8	26	0	1	27	0	0
14	10340358	.	G	A	11	10	21	0	0	21	0	0
14	10340606	.	A	G	15	10	25	0	1	26	0	0
14	10340642	.	T	A	17	7	24	0	0	24	0	0
14	10340840	.	C	A	16	17	33	0	0	33	0	0
14	10341076	.	T	C	7	3	10	0	3	13	0	0
14	10341237	.	A	T	7	8	15	0	0	15	0	0
14	10341293	.	C	T	5	2	7	0	0	7	0	0
14	10341586	.	C	T	1	9	10	0	8	18	0	0
14	10341627	.	A	T	8	10	18	0	0	18	0	0
14	10341690	.	G	T	13	6	19	0	1	20	0	0
14	10341703	.	T	C	13	0	13	0	8	21	0	0
14	10342246	.	G	T	4	5	9	0	2	11	0	0
14	10342379	.	A	C	14	1	15	0	7	22	0	0
14	10342570	.	G	A	12	5	17	0	0	17	0	0
14	10342591	.	C	A	0	8	8	0	9	17	0	0
14	10342726	.	A	G	9	4	13	0	0	13	0	0
14	10342926	.	G	A	16	4	20	0	0	20	0	0
14	10342929	.	T	A	14	2	16	0	1	18	1	0
14	10342971	.	G	T	11	8	19	1	0	20	0	0
14	10343112	.	C	T	8	3	11	0	0	11	0	0
14	10343180	.	T	A	3	2	5	0	0	5	0	0
14	10343185	.	G	T	5	2	7	0	1	8	0	0
14	10343232	.	T	C	8	3	11	0	1	12	0	0
14	10343266	.	C	A	0	4	4	0	4	8	0	0
14	10343678	.	A	T	2	7	9	0	0	9	0	0
14	10343686	.	T	C	3	0	3	0	7	10	0	0
14	10343866	.	G	A	10	7	17	0	0	17	0	0
14	10344032	.	A	C	11	6	17	1	0	18	0	0
14	10344218	.	G	A	6	7	13	0	0	13	0	0
14	10344451	.	C	T	7	10	17	0	0	17	0	0
14	10348091	.	T	C	8	5	13	0	1	14	0	0
14	10356522	.	A	G	11	5	16	0	0	16	0	0
14	10356817	.	A	C	4	0	4	0	5	9	0	0
14	10356826	.	G	C	5	5	10	0	0	10	0	0
14	10365369	.	A	T	6	6	12	0	0	12	0	0
14	10365510	.	T	C	6	6	12	0	0	12	0	0
14	10374709	.	T	A	2	2	4	0	0	4	0	0
14	10374716	.	G	T	3	2	5	0	0	5	0	0
14	10374951	.	T	C	1	1	2	0	2	4	0	0
14	10374973	.	T	A	1	3	4	0	0	4	0	0
14	10379652	.	G	A	2	4	6	0	0	6	0	0
14	10384607	.	T	A	2	4	6	0	0	6	0	0
14	10987761	.	C	A	2	3	5	0	0	5	0	0
14	11042937	.	A	G	5	2	7	0	1	8	0	0
14	11048599	.	A	G	6	2	8	0	0	8	0	0
14	11053934	.	G	C	2	4	6	0	2	8	0	0
14	11069560	.	C	T	7	11	18	0	0	19	1	0
14	11069593	.	C	T	6	11	17	0	1	18	0	0
14	11069774	.	G	A	4	6	10	0	0	10	0	0
14	11070008	.	C	T	3	4	7	0	0	7	0	0
14	11070018	.	T	A	3	3	6	0	0	6	0	0
14	11261691	.	C	T	10	6	16	0	0	16	0	0
14	11261718	.	T	C	10	6	16	0	0	16	0	0
14	11262084	.	T	C	4	5	9	0	0	9	0	0
14	11262733	.	C	T	6	4	10	0	1	11	0	0
14	11262765	.	C	A	7	6	13	0	1	14	0	0
14	11263017	.	A	G	5	0	5	0	6	11	0	0
14	11263084	.	C	G	5	7	12	0	0	12	0	0
14	11263096	.	C	A	5	3	8	0	0	8	0	0
14	11263147	.	G	A	0	4	4	0	5	9	0	0
14	11263479	.	T	A	3	10	13	0	1	14	0	0
14	11263899	.	A	G	8	0	8	0	7	15	0	0
14	11264058	.	C	T	6	2	8	0	0	8	0	0
14	11264726	.	A	T	10	12	22	0	0	22	0	0
14	11265310	.	A	G	8	5	13	0	0	13	0	0
14	11265312	.	T	C	9	5	14	0	0	14	0	0
14	11265567	.	C	T	7	7	14	0	0	14	0	0
14	11265966	.	A	G	1	2	3	0	0	3	0	0
14	11266644	.	A	T	11	6	17	0	1	18	0	0
14	11267900	.	A	T	12	16	28	0	0	28	0	0
14	11268145	.	G	A	6	5	11	0	1	12	0	0
14	11268224	.	A	T	2	4	6	0	0	6	0	0
14	11290986	.	T	C	2	6	8	0	0	8	0	0
14	11299563	.	G	A	0	3	3	0	1	4	0	0
14	11300058	.	T	C	8	6	14	0	2	16	0	0
14	11300154	.	G	A	4	5	9	0	0	9	0	0
14	11300179	.	T	G	3	5	8	0	1	9	0	0
14	11300238	.	G	A	8	7	15	0	0	15	0	0
14	11300298	.	C	T	8	7	15	0	0	15	0	0
14	11301027	.	G	A	9	13	22	0	3	25	0	0
14	11301069	.	A	G	17	1	18	0	10	28	0	0
14	11302190	.	C	A	9	10	19	0	2	21	0	0
14	11302392	.	G	A	3	2	5	0	1	6	0	0
14	11302427	.	T	G	6	0	6	0	4	10	0	0
14	11302492	.	G	A	3	2	5	0	0	5	0	0
14	11302565	.	T	A	2	1	3	0	0	3	0	0
14	11302662	.	C	A	4	1	5	0	0	5	0	0
14	11302744	.	G	A	4	2	6	0	1	7	0	0
14	11303025	.	A	G	2	0	2	0	3	5	0	0
14	11303231	.	T	C	2	2	4	0	0	4	0	0
14	11303867	.	G	T	2	3	5	0	0	5	0	0
14	11303895	.	G	T	1	2	3	0	0	3	0	0
14	11979356	.	C	G	1	6	7	0	5	12	0	0
14	11979548	.	A	G	5	5	10	0	0	10	0	0
14	12003430	.	T	G	2	2	4	0	0	4	0	0
14	12021308	.	C	G	3	10	13	0	0	13	0	0
14	12021366	.	T	C	8	3	11	0	1	12	0	0
14	12021550	.	T	C	5	3	8	0	0	8	0	0
14	12021610	.	T	G	3	6	9	0	1	10	0	0
14	12021926	.	A	T	12	7	19	0	0	19	0	0
14	12022056	.	C	T	5	7	12	0	0	12	0	0
14	12036538	.	C	G	5	10	15	0	0	15	0	0
14	12036731	.	A	G	9	5	14	0	2	16	0	0
14	12036768	.	A	C	7	0	7	0	7	14	0	0
14	12050577	.	T	C	1	3	4	0	0	4	0	0
14	12050868	.	A	C	3	0	3	0	5	8	0	0
14	12069754	.	C	T	21	19	40	0	1	41	0	0
14	12071446	.	A	G	11	12	23	0	0	23	0	0
14	12077109	.	C	T	5	4	9	0	2	11	0	0
14	12085165	.	T	C	11	10	21	0	1	22	0	0
14	12085267	.	G	A	11	4	15	0	1	16	0	0
14	12099566	.	G	T	3	9	12	0	2	14	0	0
14	12099605	.	T	G	5	8	13	0	0	13	0	0
14	12110493	.	A	G	1	3	4	0	2	6	0	0
14	12110747	.	A	C	2	2	4	0	0	4	0	0
14	12110887	.	A	C	1	4	5	0	0	5	0	0
14	12111019	.	C	T	2	2	4	0	0	4	0	0
14	12157456	.	C	T	16	16	32	0	0	32	0	0
14	12159384	.	C	G	20	21	41	0	2	43	0	0
14	12162692	.	C	T	14	24	38	0	1	39	0	0
14	12162731	.	A	C	21	16	37	0	2	39	0	0
14	12164364	.	C	A	36	24	60	0	2	62	0	0
14	12166656	.	A	G	18	30	48	0	1	49	0	0
14	12166956	.	C	T	21	16	37	0	0	37	0	0
14	12166974	.	A	G	20	17	37	0	3	40	0	0
14	12167321	.	T	A	18	17	35	0	2	37	0	0
14	12167615	.	G	A	0	9	9	0	18	27	0	0
14	12167670	.	C	T	5	8	13	0	0	13	0	0
14	12167679	.	A	T	5	8	13	0	0	13	0	0
14	12175914	.	A	G	3	3	6	0	0	6	0	0
14	12176008	.	G	A	3	2	5	0	0	5	0	0
14	12179114	.	T	C	6	4	10	0	0	10	0	0
14	12179124	.	T	A	3	3	6	0	2	8	0	0
14	12189019	.	T	C	9	7	16	0	0	16	0	0
14	12189856	.	C	T	7	7	14	0	1	15	0	0
14	12191579	.	T	A	9	4	13	0	0	13	0	0
14	12191615	.	A	G	8	0	8	0	7	15	0	0
14	12195119	.	T	A	12	8	20	0	1	21	0	0
14	12205329	.	T	C	8	7	15	0	0	15	0	0
14	12205521	.	C	T	17	7	24	0	0	24	0	0
14	12428324	.	G	T	6	5	11	0	1	12	0	0
14	12429901	.	A	G	4	13	17	0	0	17	0	0
14	12436410	.	G	A	7	6	13	0	1	14	0	0
14	12436937	.	T	C	5	8	13	0	0	13	0	0
14	12452477	.	C	T	8	8	16	0	0	16	0	0
14	12452516	.	G	A	0	7	7	0	10	17	0	0
14	12465519	.	C	A	13	12	25	0	1	26	0	0
14	12472233	.	C	T	13	12	25	0	2	27	0	0
14	12473599	.	T	A	8	4	12	0	4	16	0	0
14	12473932	.	T	C	4	10	14	0	1	15	0	0
14	12473992	.	A	T	1	4	5	0	0	5	0	0
14	12474159	.	T	C	4	8	12	0	1	13	0	0
14	12481591	.	C	T	1	5	6	0	0	6	0	0
14	12481600	.	T	C	2	4	6	0	1	7	0	0
14	12486294	.	C	T	4	9	13	0	3	16	0	0
14	12535403	.	T	G	27	11	38	0	1	39	0	0
14	12535622	.	G	T	22	15	37	0	2	39	0	0
14	12535775	.	G	T	15	10	25	0	2	27	0	0
14	12535901	.	A	G	13	5	18	0	0	18	0	0
14	12536004	.	T	A	3	8	11	0	2	13	0	0
14	12536163	.	G	A	3	3	6	0	0	6	0	0
14	12536229	.	G	A	22	12	34	0	2	36	0	0
14	12536420	.	T	G	25	22	47	0	3	50	0	0
14	12554812	.	T	C	9	21	30	0	1	31	0	0
14	12605791	.	T	C	13	7	20	0	2	22	0	0
14	12605900	.	T	C	19	6	25	0	0	25	0	0
14	12636012	.	A	T	4	4	8	0	0	8	0	0
14	12837003	.	C	T	10	5	15	0	0	15	0	0
14	12837079	.	A	G	9	10	19	0	0	19	0	0
14	12837120	.	G	A	4	4	8	0	0	8	0	0
14	12837130	.	A	C	3	0	3	0	3	6	0	0
14	13354594	.	G	A	1	9	10	9	0	19	0	0
14	13524092	.	A	G	6	8	14	0	0	14	0	0
14	13525082	.	A	G	5	5	10	0	1	11	0	0
14	14094032	.	C	T	5	5	10	0	1	11	0	0
14	14225233	.	C	G	7	4	11	0	0	11	0	0
14	14315233	.	C	T	7	3	10	0	1	11	0	0
14	14502450	.	C	T	6	7	13	0	1	14	0	0
14	14502708	.	T	C	12	13	25	0	1	26	0	0
14	14502846	.	C	T	12	11	23	0	1	24	0	0
14	14502885	.	C	T	15	7	22	0	0	22	0	0
14	14532450	.	T	C	22	18	40	0	1	41	0	0
14	14532696	.	T	G	20	15	35	0	2	37	0	0
14	14532831	.	A	G	14	7	21	0	1	22	0	0
14	14534219	.	G	A	10	13	23	0	0	23	0	0
14	14566166	.	C	T	6	4	10	0	0	10	0	0
14	14582432	.	A	G	3	6	9	0	0	9	0	0
14	14593175	.	T	C	5	2	7	0	0	7	0	0
14	14593624	.	A	G	1	6	7	0	0	7	0	0
14	14593889	.	G	A	9	7	16	0	0	16	0	0
14	14594453	.	C	T	4	2	6	0	0	6	0	0
14	14594950	.	A	G	4	2	6	0	0	6	0	0
14	14594966	.	A	G	1	0	1	0	2	3	0	0
14	14595535	.	A	G	4	4	8	0	0	8	0	0
14	14595576	.	T	G	3	3	6	0	1	7	0	0
14	14595695	.	A	C	5	5	10	0	0	10	0	0
14	14595734	.	C	G	9	3	12	0	0	12	0	0
14	14604317	.	G	A	4	3	7	0	0	7	0	0
14	14604525	.	G	A	3	5	8	0	0	8	0	0
14	14617370	.	G	T	3	2	5	0	1	6	0	0
14	14617778	.	T	G	1	3	4	0	0	4	0	0
14	14617796	.	T	C	1	3	4	0	0	4	0	0
14	14622414	.	A	C	1	2	3	0	0	3	0	0
14	14622469	.	T	C	3	2	5	0	0	5	0	0
14	14662597	.	A	T	22	20	42	0	5	47	0	0
14	14662606	.	A	G	23	20	43	0	2	45	0	0
14	14662663	.	C	T	25	16	41	0	1	42	0	0
14	14662684	.	C	T	21	15	36	0	3	39	0	0
14	14664974	.	T	C	14	11	25	0	2	27	0	0
14	14664998	.	G	A	12	13	25	0	1	26	0	0
14	14665175	.	T	C	13	17	30	0	1	31	0	0
14	14665229	.	A	G	16	8	24	0	1	25	0	0
14	14665270	.	T	G	8	6	14	0	1	15	0	0
14	14665432	.	A	G	6	3	9	0	0	9	0	0
14	14665502	.	C	G	10	5	15	0	0	15	0	0
14	14666173	.	A	T	5	9	14	0	0	14	0	0
14	14666394	.	G	A	13	14	27	0	0	27	0	0
14	14690710	.	G	T	15	12	27	5	0	32	0	0
14	14690831	.	C	A	14	12	26	44	0	70	0	0
14	14690837	.	G	A	12	9	21	47	0	68	0	0
14	14694930	.	A	G	28	19	47	0	1	48	0	0
14	14695136	.	A	G	20	16	36	0	0	36	0	0
14	14695181	.	A	G	20	17	37	0	1	38	0	0
14	14695864	.	T	C	16	0	16	0	19	35	0	0
14	14722530	.	A	T	7	12	19	0	0	19	0	0
14	14722556	.	T	C	8	14	22	0	1	23	0	0
14	14722929	.	G	A	6	13	19	0	2	21	0	0
14	14723381	.	A	T	9	5	14	0	0	14	0	0
14	14723410	.	G	T	8	6	14	0	0	14	0	0
14	14724026	.	C	T	5	4	9	0	0	9	0	0
14	14724493	.	T	G	1	4	5	0	0	5	0	0
14	14724951	.	G	A	27	22	49	0	6	55	0	0
14	14724953	.	A	G	34	20	54	0	3	57	0	0
14	14724987	.	G	A	28	25	53	0	0	53	0	0
14	14725132	.	A	T	30	15	45	1	5	51	0	0
14	14725314	.	G	A	35	26	61	0	2	63	0	0
14	14728192	.	G	T	15	13	28	26	1	55	0	0
14	14729069	.	G	A	24	33	57	1	1	59	0	0
14	14739116	.	T	C	10	11	21	0	1	22	0	0
14	14836656	.	T	C	5	3	8	0	0	8	0	0
14	14837681	.	A	G	2	2	4	0	1	5	0	0
14	14837693	.	T	C	4	3	7	0	2	9	0	0
14	14844346	.	A	C	1	2	3	0	0	3	0	0
14	14844529	.	A	G	3	4	7	0	1	8	0	0
14	14844658	.	T	G	4	3	7	0	1	8	0	0
14	14845532	.	G	A	1	3	4	0	6	10	0	0
14	14852142	.	T	A	4	5	9	0	1	10	0	0
14	14854201	.	G	C	1	4	5	0	0	5	0	0
14	14854654	.	G	A	0	5	5	0	7	12	0	0
14	14855017	.	T	C	6	7	13	0	0	13	0	0
14	14855057	.	C	T	6	4	10	0	0	10	0	0
14	14855139	.	T	A	4	5	9	0	0	9	0	0
14	14855205	.	C	G	3	3	6	0	0	6	0	0
14	14855456	.	C	T	7	2	9	0	0	9	0	0
14	14864897	.	A	G	1	0	1	0	2	3	0	0
14	15064962	.	A	G	3	0	3	0	2	5	0	0
14	15070793	.	A	T	1	3	4	0	0	4	0	0
14	15070912	.	A	G	1	2	3	0	0	3	0	0
14	15071502	.	C	T	3	2	5	0	0	5	0	0
14	15086220	.	G	A	7	5	12	0	0	12	0	0
14	15087088	.	C	T	3	3	6	0	0	6	0	0
14	15087121	.	T	C	6	0	6	0	3	9	0	0
14	15099780	.	T	C	2	2	4	0	0	4	0	0
14	15155866	.	C	T	2	2	4	0	0	4	0	0
14	15155901	.	A	G	1	0	1	0	3	4	0	0
14	15662731	.	G	A	4	3	7	0	0	7	0	0
14	15662795	.	G	C	3	4	7	0	1	8	0	0
14	15662836	.	A	T	7	6	13	0	0	13	0	0
14	15663014	.	C	T	7	4	11	0	0	11	0	0
14	15663680	.	A	G	4	2	6	0	1	7	0	0
14	15663910	.	G	A	6	4	10	0	0	10	0	0
14	15663925	.	C	T	2	3	5	0	6	11	0	0
14	15664251	.	T	A	13	2	15	0	1	16	0	0
14	15664263	.	T	C	10	2	12	0	2	14	0	0
14	15664288	.	C	T	10	3	13	0	0	13	0	0
14	15664532	.	T	A	1	4	5	0	0	5	0	0
14	15664843	.	A	G	2	6	8	0	0	8	0	0
14	15677790	.	C	T	0	2	2	0	4	6	0	0
14	15677831	.	G	A	3	2	5	0	0	5	0	0
14	15677882	.	C	T	1	2	3	0	0	3	0	0
14	15677907	.	A	G	1	2	3	0	1	4	0	0
14	15677931	.	T	C	2	3	5	0	0	5	0	0
14	15678111	.	A	G	3	3	6	0	0	6	0	0
14	15678291	.	A	G	5	5	10	0	1	11	0	0
14	15678362	.	G	A	4	5	9	0	0	9	0	0
14	15687193	.	C	T	8	4	12	0	1	13	0	0
14	15760375	.	A	C	3	2	5	1	0	6	0	0
14	15801784	.	T	C	1	2	3	0	0	3	0	0
14	15808004	.	C	A	4	4	8	0	1	9	0	0
14	15812577	.	A	G	9	6	15	0	1	16	0	0
14	15812685	.	C	T	1	5	6	0	1	7	0	0
14	15813702	.	G	T	7	3	10	0	0	10	0	0
14	15813985	.	G	A	1	6	7	0	5	12	0	0
14	15814770	.	C	T	6	4	10	0	1	11	0	0
14	15972435	.	C	A	8	6	14	0	0	14	0	0
14	15972491	.	T	A	2	6	8	0	1	9	0	0
14	15973920	.	G	A	5	4	9	0	0	9	0	0
14	15973981	.	C	A	5	6	11	0	0	11	0	0
14	15974188	.	T	A	3	4	7	0	0	7	0	0
14	15974232	.	G	A	1	6	7	0	0	7	0	0
14	15974313	.	A	G	5	5	10	0	0	10	0	0
14	15980828	.	T	A	2	3	5	0	0	5	0	0
14	15983792	.	G	A	1	3	4	0	0	4	0	0
14	16042530	.	C	A	6	6	12	0	1	13	0	0
14	16069264	.	A	C	4	4	8	0	0	8	0	0
14	16072889	.	G	C	9	3	12	0	1	13	0	0
14	16084339	.	C	T	7	6	13	0	0	13	0	0
14	16090261	.	C	T	13	8	21	0	0	21	0	0
14	16090764	.	T	C	6	10	16	0	2	18	0	0
14	16090939	.	A	C	14	11	25	0	0	25	0	0
14	16091586	.	T	A	8	10	18	0	2	20	0	0
14	16091709	.	T	G	11	5	16	0	1	17	0	0
14	16091765	.	T	C	9	7	16	0	0	16	0	0
14	16093983	.	G	A	21	15	36	0	1	37	0	0
14	16095683	.	A	G	15	8	23	0	0	23	0	0
14	16097204	.	T	A	13	4	17	0	1	18	0	0
14	16115353	.	A	G	10	9	19	0	1	20	0	0
14	16122866	.	T	C	22	18	40	0	0	40	0	0
14	16122913	.	G	A	1	13	14	0	26	40	0	0
14	16127308	.	C	T	9	5	14	0	0	14	0	0
14	16127346	.	G	T	8	4	12	0	0	12	0	0
14	16127362	.	C	A	1	5	6	0	6	12	0	0
14	16130167	.	C	G	14	15	29	0	1	30	0	0
14	16145112	.	T	A	4	8	12	0	3	15	0	0
14	16178079	.	A	G	3	3	6	0	0	6	0	0
14	16208059	.	T	G	5	4	9	0	0	9	0	0
14	16370199	.	C	A	0	2	2	0	1	3	0	0
14	16383196	.	G	A	1	2	3	0	0	3	0	0
14	16384226	.	A	G	1	2	3	0	0	3	0	0
14	16434363	.	C	A	20	5	25	0	0	25	0	0
14	16435150	.	G	A	27	23	50	0	1	51	0	0
14	16484577	.	G	A	6	4	10	0	0	10	0	0
14	16484633	.	G	T	3	2	5	0	0	5	0	0
14	16484713	.	A	G	5	5	10	0	0	10	0	0
14	16484763	.	C	T	2	7	9	0	1	10	0	0
14	16485222	.	C	T	0	6	6	0	11	17	0	0
14	16606649	.	C	A	0	10	10	0	8	18	0	0
14	16754060	.	C	T	0	7	7	0	7	14	0	0
14	16754192	.	A	C	10	8	18	0	0	18	0	0
14	16769067	.	A	G	20	15	35	0	4	39	0	0
14	16769109	.	T	C	20	13	33	0	1	34	0	0
14	16769189	.	C	T	12	13	25	1	0	26	0	0
14	16769246	.	C	T	11	20	31	0	1	32	0	0
14	16769478	.	A	G	21	5	26	0	3	29	0	0
14	16769481	.	T	C	20	8	28	0	0	28	0	0
14	16769550	.	A	G	14	0	14	0	19	33	0	0
14	16770338	.	T	A	18	15	33	0	1	34	0	0
14	16770646	.	C	A	24	14	38	0	0	38	0	0
14	16770847	.	C	T	24	18	42	0	2	44	0	0
14	16770959	.	T	A	15	7	22	0	2	24	0	0
14	16771265	.	A	T	11	16	27	0	0	27	0	0
14	16777865	.	A	G	1	2	3	1	0	4	0	0
14	16778086	.	G	A	3	4	7	0	0	7	0	0
14	16801708	.	G	T	3	2	5	0	0	5	0	0
14	16801807	.	C	T	1	3	4	0	0	4	0	0
14	16801813	.	A	T	1	3	4	0	0	4	0	0
14	16947242	.	G	A	11	5	16	0	0	16	0	0
14	16968227	.	T	C	3	4	7	0	0	7	0	0
14	16968260	.	C	T	2	3	5	0	0	5	0	0
14	16968302	.	T	C	2	8	10	1	0	11	0	0
14	16996869	.	T	C	7	4	11	0	0	11	0	0
14	16996870	.	G	A	7	4	11	0	0	11	0	0
14	17003333	.	G	A	10	7	17	0	1	18	0	0
14	17003628	.	G	A	7	6	13	0	0	13	0	0
14	17016521	.	G	A	7	10	17	0	2	19	0	0
14	17016650	.	C	T	11	11	22	0	1	23	0	0
14	17025109	.	A	T	16	4	20	0	1	21	0	0
14	17025116	.	G	A	18	5	23	0	1	24	0	0
14	17025176	.	C	A	10	3	13	0	3	16	0	0
14	17025200	.	G	A	8	3	11	0	0	11	0	0
14	17025353	.	G	C	2	4	6	0	0	6	0	0
14	17025388	.	A	T	3	3	6	0	0	6	0	0
14	17025472	.	T	A	4	3	7	0	0	7	0	0
14	17025539	.	A	G	7	3	10	2	0	12	0	0
14	17025807	.	T	C	8	11	19	0	1	20	0	0
14	17025960	.	A	T	7	12	19	0	1	20	0	0
14	17026001	.	A	G	4	4	8	0	0	8	0	0
14	17026534	.	G	A	11	6	17	0	0	17	0	0
14	17026550	.	C	T	12	8	20	0	0	20	0	0
14	17026724	.	T	C	11	15	26	0	1	27	0	0
14	17026840	.	T	C	7	6	13	0	0	13	0	0
14	17197240	.	A	C	7	9	16	0	0	17	1	0
14	17198928	.	A	G	17	11	28	0	0	28	0	0
14	17198953	.	G	A	12	10	22	0	0	23	1	0
14	17198988	.	T	G	12	12	24	0	3	27	0	0
14	17199349	.	C	T	18	13	31	0	0	31	0	0
14	17199990	.	A	G	19	23	42	0	3	45	0	0
14	17200159	.	C	T	17	12	29	0	1	30	0	0
14	17200174	.	G	T	1	14	15	0	15	30	0	0
14	17200407	.	C	A	13	13	26	0	0	26	0	0
14	17200482	.	T	C	12	11	23	0	0	23	0	0
14	17200653	.	A	C	13	17	30	0	2	32	0	0
14	17230601	.	A	G	5	4	9	0	0	9	0	0
14	17233541	.	C	T	13	14	27	0	0	27	0	0
14	17266013	.	A	T	7	14	21	0	1	22	0	0
14	17275609	.	T	A	9	10	19	0	0	19	0	0
14	17275708	.	C	G	11	9	20	0	1	21	0	0
14	17278972	.	C	T	6	2	8	0	5	13	0	0
14	17279197	.	G	A	3	6	9	0	0	9	0	0
14	17279305	.	T	C	7	7	14	0	0	14	0	0
14	17281713	.	G	A	8	4	12	0	1	13	0	0
14	17281727	.	C	G	11	7	18	0	0	18	0	0
14	17281818	.	T	C	4	5	9	0	1	10	0	0
14	17281831	.	G	A	1	8	9	0	0	9	0	0
14	17282058	.	G	A	5	4	9	0	0	9	0	0
14	17282061	.	C	T	6	4	10	0	0	10	0	0
14	17282095	.	C	G	5	4	9	0	0	9	0	0
14	17282100	.	C	T	0	4	4	0	5	9	0	0
14	17282160	.	C	T	6	8	14	0	0	14	0	0
14	17329967	.	A	T	2	2	4	0	0	4	0	0
14	17348286	.	T	C	5	2	7	0	2	9	0	0
14	17348794	.	A	G	1	2	3	0	0	3	0	0
14	17349069	.	G	C	2	3	5	0	0	5	0	0
14	17349104	.	G	T	3	3	6	0	0	6	0	0
14	17349464	.	T	C	14	12	26	0	0	26	0	0
14	17349472	.	C	T	11	13	24	0	1	25	0	0
14	17349639	.	T	C	3	5	8	0	0	8	0	0
14	17349656	.	T	C	5	4	9	0	0	9	0	0
14	17349757	.	C	T	4	3	7	0	0	7	0	0
14	17443682	.	A	T	2	2	4	0	0	4	0	0
14	17444047	.	A	C	4	2	6	0	0	6	0	0
14	17447733	.	G	T	1	3	4	0	0	4	0	0
14	17568072	.	T	A	9	8	17	0	0	18	1	0
14	17568099	.	A	G	9	7	16	0	1	17	0	0
14	17572743	.	T	C	11	7	18	0	0	18	0	0
14	17575834	.	C	G	7	15	22	0	2	24	0	0
14	17575868	.	G	A	8	15	23	0	2	25	0	0
14	17575872	.	C	T	8	17	25	0	0	25	0	0
14	17580662	.	G	A	11	10	21	0	1	22	0	0
14	17580917	.	G	A	25	26	51	1	2	54	0	0
14	17580922	.	C	A	28	23	51	1	1	53	0	0
14	17581036	.	C	A	23	19	42	0	2	44	0	0
14	17586527	.	A	G	17	12	29	0	3	32	0	0
14	17586693	.	G	A	14	28	42	0	0	42	0	0
14	17588131	.	G	T	18	15	33	0	0	33	0	0
14	17593654	.	T	A	5	10	15	0	0	15	0	0
14	17593685	.	G	C	9	9	18	0	0	18	0	0
14	17593767	.	A	T	14	8	22	1	1	24	0	0
14	17593783	.	T	A	16	9	25	1	0	26	0	0
14	17593803	.	A	T	18	5	23	0	0	23	0	0
14	17593823	.	A	T	12	5	17	0	0	17	0	0
14	17593992	.	T	A	11	12	23	0	3	26	0	0
14	17594137	.	G	A	7	11	18	0	0	18	0	0
14	17594556	.	C	T	6	10	16	0	1	17	0	0
14	17594685	.	A	G	7	3	10	0	1	11	0	0
14	17594686	.	A	T	7	3	10	0	1	11	0	0
14	17595063	.	G	A	5	3	8	0	1	9	0	0
14	17595121	.	G	A	6	2	8	0	0	8	0	0
14	17595192	.	A	T	7	2	9	0	0	9	0	0
14	17595264	.	T	A	8	7	15	0	0	15	0	0
14	18667559	.	T	C	15	17	32	0	0	32	0	0
14	18667852	.	T	C	14	11	25	0	2	27	0	0
14	18668731	.	A	G	2	5	7	0	0	7	0	0
14	18669481	.	C	A	14	21	35	0	1	36	0	0
14	18670446	.	C	T	15	12	27	1	0	28	0	0
14	18670582	.	T	A	14	9	23	0	0	23	0	0
14	18670665	.	A	G	19	8	27	0	1	28	0	0
14	18672491	.	C	T	12	7	19	0	4	23	0	0
14	19258995	.	C	T	7	9	16	0	2	18	0	0
14	19259292	.	A	G	9	10	19	0	4	23	0	0
14	19260261	.	A	G	8	17	25	0	3	28	0	0
14	19261044	.	C	T	24	23	47	1	1	49	0	0
14	20159151	.	T	C	12	5	17	0	0	17	0	0
14	20188941	.	G	A	3	12	15	0	13	28	0	0
14	20189180	.	T	C	17	10	27	0	1	28	0	0
14	20189188	.	G	A	18	11	29	0	0	29	0	0
14	20189339	.	T	A	6	5	11	0	1	12	0	0
14	20190023	.	A	C	10	8	18	0	0	18	0	0
14	20190297	.	C	G	20	15	35	0	3	38	0	0
14	20190494	.	G	T	1	18	19	0	14	33	0	0
14	20190532	.	G	A	19	15	34	0	2	36	0	0
14	20342750	.	C	T	7	3	10	0	0	10	0	0
14	20694640	.	A	C	2	2	4	0	0	4	0	0
14	20695409	.	A	C	3	3	6	0	0	6	0	0
14	20706109	.	A	C	5	3	8	0	0	8	0	0
14	20728551	.	T	A	4	1	5	0	1	6	0	0
14	20728633	.	A	G	7	5	12	0	0	12	0	0
14	20729908	.	A	G	5	2	7	0	0	7	0	0
14	20730152	.	C	T	3	3	6	0	1	7	0	0
14	20730907	.	T	A	8	5	13	0	0	13	0	0
14	20730958	.	A	T	4	6	10	0	3	13	0	0
14	20731633	.	A	T	6	2	8	0	0	8	0	0
14	20731656	.	T	A	6	3	9	0	0	9	0	0
14	20731675	.	A	T	5	4	9	0	0	9	0	0
14	20731756	.	G	A	4	3	7	0	0	7	0	0
14	20731797	.	C	T	6	3	9	0	0	9	0	0
14	20731904	.	T	C	3	2	5	0	0	5	0	0
14	20732426	.	T	C	6	7	13	0	0	13	0	0
14	20732457	.	T	C	7	6	13	0	0	13	0	0
14	20732474	.	G	C	0	4	4	0	8	12	0	0
14	20732546	.	G	C	3	4	7	0	0	7	0	0
14	20732793	.	A	T	2	4	6	0	0	6	0	0
14	20733078	.	A	G	2	3	5	0	0	5	0	0
14	20733101	.	A	G	4	3	7	0	0	7	0	0
14	20733160	.	A	G	4	2	6	0	0	6	0	0
14	20733486	.	T	C	3	4	7	0	0	7	0	0
14	20734823	.	A	G	4	4	8	0	0	8	0	0
14	20734827	.	G	A	5	4	9	0	0	9	0	0
14	20735084	.	C	G	1	3	4	0	0	4	0	0
14	20735388	.	T	G	9	10	19	0	0	19	0	0
14	20735481	.	T	C	12	14	26	1	0	27	0	0
14	20735525	.	T	A	8	8	16	1	0	17	0	0
14	20735585	.	G	T	7	7	14	0	0	14	0	0
14	20735626	.	G	T	10	5	15	0	0	16	1	0
14	20735841	.	A	G	9	0	9	0	12	21	0	0
14	20736251	.	A	G	14	12	26	0	1	27	0	0
14	20736829	.	A	G	1	0	1	0	8	9	0	0
14	20869943	.	T	C	3	0	3	0	7	10	0	0
14	20869949	.	G	A	4	7	11	0	0	11	0	0
14	20870141	.	G	T	3	7	10	0	1	11	0	0
14	20870153	.	A	G	4	7	11	0	0	11	0	0
14	20870257	.	A	G	4	7	11	0	0	11	0	0
14	20870321	.	G	T	7	9	16	0	0	16	0	0
14	20881464	.	C	A	1	6	7	0	0	7	0	0
14	20881493	.	C	T	1	5	6	0	0	6	0	0
14	20891291	.	T	G	1	2	3	0	0	3	0	0
14	20891461	.	G	T	3	2	5	0	1	6	0	0
14	20891506	.	G	A	3	2	5	0	0	5	0	0
14	20896049	.	T	G	5	0	5	0	8	13	0	0
14	20896058	.	C	T	5	6	11	0	2	13	0	0
14	20898296	.	C	T	7	6	13	0	0	13	0	0
14	20898373	.	G	T	2	4	6	0	0	6	0	0
14	20966505	.	A	G	2	0	2	0	2	4	0	0
14	20966529	.	A	C	1	4	5	0	1	6	0	0
14	20973364	.	T	C	2	3	5	0	0	5	0	0
14	20988121	.	T	C	2	5	7	0	0	7	0	0
14	20991244	.	A	C	2	4	6	0	1	7	0	0
14	20994047	.	A	G	4	0	4	0	5	9	0	0
14	20994051	.	G	A	0	4	4	0	4	8	0	0
14	20994167	.	C	T	3	4	7	0	1	8	0	0
14	20994249	.	G	A	1	4	5	0	2	7	0	0
14	20994493	.	G	A	0	3	3	0	2	5	0	0
14	20994695	.	G	A	3	5	8	1	0	9	0	0
14	20994967	.	T	C	4	4	8	0	0	8	0	0
14	20999918	.	C	T	1	2	3	0	0	3	0	0
14	21000044	.	A	G	2	2	4	0	0	4	0	0
14	21000170	.	C	G	9	5	14	0	1	15	0	0
14	21000193	.	T	C	10	5	15	0	2	17	0	0
14	21000375	.	A	G	1	0	1	0	2	3	0	0
14	21067455	.	G	A	5	4	9	0	1	10	0	0
14	21067935	.	A	G	10	9	19	0	0	19	0	0
14	21067938	.	T	C	10	8	18	0	0	18	0	0
14	21071965	.	T	C	10	14	24	0	1	25	0	0
14	21072037	.	G	A	12	9	21	0	0	21	0	0
14	21072729	.	A	G	10	20	30	0	1	31	0	0
14	21072792	.	C	T	5	12	17	0	1	18	0	0
14	21072834	.	C	T	7	12	19	0	0	19	0	0
14	21072852	.	G	A	9	7	16	0	1	17	0	0
14	21078274	.	G	A	2	7	9	0	0	9	0	0
14	21078277	.	T	C	2	7	9	0	0	9	0	0
14	21079937	.	G	C	6	0	6	0	3	9	0	0
14	21079991	.	A	T	7	4	11	0	0	11	0	0
14	21090848	.	A	C	2	0	2	0	4	6	0	0
14	21098305	.	A	G	6	4	10	0	0	10	0	0
14	21098316	.	A	C	3	3	6	0	0	6	0	0
14	21111973	.	C	T	2	2	4	0	0	4	0	0
14	21124321	.	T	C	12	6	18	0	0	18	0	0
14	21124360	.	G	T	14	6	20	0	0	20	0	0
14	21124469	.	A	G	5	6	11	0	1	12	0	0
14	21129362	.	T	G	8	12	20	0	2	22	0	0
14	21129629	.	G	T	10	12	22	0	2	24	0	0
14	21132180	.	G	A	9	9	18	0	0	18	0	0
14	21159943	.	T	G	16	0	16	0	12	28	0	0
14	21159949	.	A	T	15	12	27	0	2	29	0	0
14	21183865	.	G	A	11	14	25	0	0	25	0	0
14	21183910	.	A	G	10	11	21	0	0	21	0	0
14	21187563	.	C	T	13	14	27	0	0	27	0	0
14	21187631	.	C	T	14	19	33	0	1	34	0	0
14	21195795	.	C	T	15	18	33	0	1	34	0	0
14	21198689	.	T	A	9	8	17	0	3	21	1	0
14	21198818	.	C	T	15	13	28	0	4	32	0	0
14	21199092	.	G	T	10	12	22	0	2	24	0	0
14	21204542	.	G	A	5	2	7	0	0	7	0	0
14	21204553	.	T	A	4	3	7	0	0	7	0	0
14	21204814	.	T	A	2	5	7	0	2	9	0	0
14	21205297	.	T	C	3	8	11	0	0	11	0	0
14	21205429	.	T	C	10	1	11	0	14	25	0	0
14	21205471	.	G	A	14	17	31	0	0	31	0	0
14	21205623	.	G	T	9	13	22	0	1	23	0	0
14	21211802	.	A	C	3	11	14	0	1	15	0	0
14	21211859	.	T	A	6	10	16	0	0	16	0	0
14	21219450	.	A	G	3	5	8	0	1	9	0	0
14	21238759	.	T	C	10	4	14	0	3	17	0	0
14	21238782	.	T	A	11	8	19	0	0	19	0	0
14	21241695	.	G	A	2	10	12	0	16	28	0	0
14	21241870	.	T	A	6	9	15	0	0	15	0	0
14	21241899	.	A	G	6	9	15	0	0	15	0	0
14	21242082	.	T	A	9	7	16	3	0	19	0	0
14	21242148	.	C	T	6	7	13	0	0	13	0	0
14	21245050	.	T	G	3	4	7	0	0	7	0	0
14	21245315	.	G	T	7	3	10	0	0	10	0	0
14	21245545	.	G	A	0	2	2	0	3	5	0	0
14	21245657	.	A	C	4	2	6	0	0	6	0	0
14	21332964	.	G	A	34	19	53	0	3	56	0	0
14	21333795	.	G	A	32	36	68	0	1	69	0	0
14	21333867	.	C	A	4	34	38	0	30	68	0	0
14	21333957	.	G	A	36	39	75	0	4	79	0	0
14	21334257	.	G	T	33	25	58	0	2	60	0	0
14	21334338	.	A	G	33	31	64	0	1	65	0	0
14	21334840	.	G	C	35	21	56	0	12	68	0	0
14	21334968	.	G	A	28	28	56	0	4	60	0	0
14	21334985	.	G	T	24	31	55	0	3	58	0	0
14	21597044	.	A	G	24	12	36	0	3	39	0	0
14	21597140	.	C	A	26	16	42	0	6	48	0	0
14	21597264	.	G	A	20	20	40	0	1	41	0	0
14	21597363	.	A	G	22	9	31	0	1	32	0	0
14	21597451	.	T	C	19	5	24	0	1	25	0	0
14	21597469	.	T	C	16	6	22	0	0	22	0	0
14	21597671	.	T	C	14	13	27	0	0	27	0	0
14	21597730	.	C	T	18	20	38	0	1	39	0	0
14	21597755	.	T	A	15	16	31	1	1	33	0	0
14	21597814	.	C	T	15	14	29	0	0	29	0	0
14	21598035	.	C	T	16	13	29	0	1	30	0	0
14	21598354	.	T	C	20	0	20	0	10	30	0	0
14	21598372	.	G	A	19	12	31	0	0	31	0	0
14	21598402	.	C	A	11	14	25	0	0	25	0	0
14	21598488	.	C	T	19	9	28	0	1	29	0	0
14	21598724	.	T	G	22	18	40	0	2	42	0	0
14	21598831	.	G	T	29	27	56	0	1	57	0	0
14	21603294	.	G	C	30	23	53	0	0	53	0	0
14	21603335	.	A	G	34	20	54	0	2	56	0	0
14	21609707	.	A	G	26	19	45	0	1	46	0	0
14	21609733	.	A	G	28	18	46	0	0	46	0	0
14	21616066	.	T	C	4	6	10	2	0	12	0	0
14	21617939	.	G	A	15	11	26	0	0	26	0	0
14	21617947	.	G	C	14	10	24	0	1	25	0	0
14	21623128	.	A	T	18	5	23	0	1	24	0	0
14	21623324	.	C	T	4	5	9	0	1	10	0	0
14	21630153	.	A	G	11	20	31	0	0	31	0	0
14	21636953	.	G	A	14	11	25	0	0	25	0	0
14	21636965	.	A	G	14	14	28	0	1	29	0	0
14	21639583	.	A	G	8	11	19	0	0	19	0	0
14	21643550	.	T	C	8	16	24	0	0	24	0	0
14	21643647	.	T	A	11	5	16	0	0	16	0	0
14	21646054	.	C	T	12	4	16	0	0	16	0	0
14	21646110	.	G	A	15	14	29	0	0	29	0	0
14	21652399	.	G	T	3	8	11	0	0	11	0	0
14	21652864	.	C	T	5	4	9	0	0	9	0	0
14	21654600	.	G	A	5	7	12	0	1	13	0	0
14	21654748	.	G	C	5	7	12	0	1	13	0	0
14	21654808	.	A	G	8	7	15	0	0	15	0	0
14	21655086	.	C	T	0	3	3	0	5	8	0	0
14	21655274	.	A	G	3	4	7	0	0	7	0	0
14	21655284	.	T	A	2	3	5	0	0	5	0	0
14	21655533	.	T	C	5	4	9	0	0	9	0	0
14	21656452	.	C	G	3	5	8	0	0	8	0	0
14	21660213	.	T	C	2	3	5	0	0	5	0	0
14	21660484	.	A	G	5	10	15	0	0	15	0	0
14	21685744	.	T	G	5	3	8	0	1	9	0	0
14	21689852	.	C	T	28	31	59	0	0	59	0	0
14	21693251	.	G	A	41	30	71	0	4	75	0	0
14	21693584	.	T	G	19	31	50	0	3	53	0	0
14	21745784	.	G	A	3	4	7	0	0	7	0	0
14	21745871	.	C	A	3	6	9	0	0	9	0	0
14	21745879	.	A	T	2	5	7	0	1	8	0	0
14	21745917	.	G	C	6	4	10	0	1	11	0	0
14	21746076	.	C	T	3	2	5	0	0	5	0	0
14	21746096	.	A	T	2	5	7	0	0	7	0	0
14	21746148	.	T	C	4	7	11	0	0	11	0	0
14	21746226	.	T	G	3	6	9	0	0	9	0	0
14	21746255	.	G	C	1	4	5	0	0	5	0	0
14	21750970	.	C	T	1	5	6	0	0	6	0	0
14	21766410	.	C	T	7	6	13	0	0	13	0	0
14	21766428	.	A	G	7	6	13	0	1	14	0	0
14	21768244	.	G	A	0	2	2	0	3	5	0	0
14	21768418	.	G	A	4	1	5	0	1	6	0	0
14	21770666	.	C	G	2	6	8	0	0	8	0	0
14	21771915	.	G	A	6	6	12	0	1	13	0	0
14	21772412	.	C	T	10	4	14	0	1	15	0	0
14	21779102	.	C	T	9	8	17	1	0	18	0	0
14	21779141	.	G	A	4	5	9	2	7	18	0	0
14	21779241	.	G	A	10	12	22	0	1	23	0	0
14	21779518	.	C	T	7	8	15	0	0	15	0	0
14	21779633	.	T	C	5	5	10	0	0	10	0	0
14	21779975	.	C	A	5	3	8	0	1	9	0	0
14	21779977	.	G	A	3	6	9	0	0	9	0	0
14	21780155	.	C	G	12	7	19	0	0	19	0	0
14	21780206	.	A	G	10	11	21	0	0	21	0	0
14	21780274	.	A	C	4	8	12	0	2	14	0	0
14	21780321	.	T	C	4	5	9	0	1	10	0	0
14	21790748	.	C	T	5	12	17	0	0	17	0	0
14	21801383	.	G	A	7	12	19	0	0	19	0	0
14	21804912	.	T	C	14	10	24	1	0	25	0	0
14	21806190	.	C	T	13	12	25	0	1	26	0	0
14	21806196	.	G	C	2	12	14	0	13	27	0	0
14	21813696	.	G	A	27	12	39	0	0	39	0	0
14	21816388	.	T	C	19	10	29	0	0	29	0	0
14	21821229	.	G	T	7	3	10	0	1	11	0	0
14	21834912	.	C	T	11	7	18	0	1	19	0	0
14	21838379	.	T	C	12	7	19	6	0	25	0	0
14	21840858	.	A	G	10	0	10	0	10	20	0	0
14	21842804	.	T	C	13	28	41	0	2	43	0	0
14	21843726	.	G	A	2	17	19	0	14	33	0	0
14	21844187	.	T	A	19	16	35	0	1	36	0	0
14	21844486	.	C	T	10	5	15	0	1	16	0	0
14	21923934	.	A	C	3	4	7	0	1	8	0	0
14	21924273	.	A	G	3	3	6	0	0	6	0	0
14	21924382	.	A	G	6	6	12	0	0	12	0	0
14	21924547	.	G	A	3	2	5	0	0	5	0	0
14	21928788	.	C	A	0	2	2	0	1	3	0	0
14	21999177	.	C	T	4	2	6	0	0	6	0	0
14	22012883	.	G	A	2	2	4	0	0	4	0	0
14	22104906	.	T	C	12	8	20	0	2	22	0	0
14	22104948	.	G	A	13	21	34	0	2	36	0	0
14	22108215	.	C	T	10	16	26	0	1	27	0	0
14	22132510	.	A	T	19	22	41	0	2	43	0	0
14	22132536	.	A	T	25	19	44	0	1	45	0	0
14	22134069	.	G	A	28	14	42	0	0	42	0	0
14	22139160	.	T	C	31	27	58	0	2	60	0	0
14	22139194	.	C	T	31	25	56	0	1	57	0	0
14	22139254	.	G	A	42	27	69	0	4	73	0	0
14	22139308	.	C	T	33	35	68	0	3	71	0	0
14	22139358	.	G	A	34	28	62	0	2	64	0	0
14	22139392	.	G	T	32	18	50	0	3	53	0	0
14	22139668	.	G	A	2	23	25	0	34	59	0	0
14	22139816	.	G	A	4	33	37	0	21	58	0	0
14	22140150	.	G	A	15	6	21	0	0	21	0	0
14	22140158	.	T	C	11	6	17	0	0	17	0	0
14	22140417	.	T	C	8	8	16	0	0	16	0	0
14	22140542	.	G	A	11	11	22	0	0	22	0	0
14	22145661	.	G	C	12	0	12	0	11	23	0	0
14	22151827	.	A	T	9	11	20	0	1	21	0	0
14	22151913	.	C	T	12	13	25	0	0	25	0	0
14	22151958	.	T	A	10	12	22	0	1	23	0	0
14	22151966	.	A	C	10	12	22	0	0	22	0	0
14	22152004	.	T	G	3	5	8	0	0	8	0	0
14	22172138	.	C	T	16	20	36	0	0	36	0	0
14	22249344	.	G	A	13	19	32	0	1	33	0	0
14	22254184	.	T	C	26	20	46	0	3	49	0	0
14	22272340	.	G	A	22	33	55	0	0	55	0	0
14	22272351	.	G	A	25	28	53	0	3	56	0	0
14	22272749	.	A	G	20	2	22	0	22	44	0	0
14	22366550	.	C	T	1	2	3	0	0	3	0	0
14	22367485	.	A	G	4	4	8	0	1	9	0	0
14	22368042	.	C	T	3	2	5	0	2	7	0	0
14	22368043	.	A	T	5	1	6	0	1	7	0	0
14	22368451	.	G	A	1	2	3	0	0	3	0	0
14	22369474	.	C	T	1	2	3	0	0	3	0	0
14	22371556	.	G	T	2	2	4	0	0	4	0	0
14	22397671	.	C	T	2	4	6	0	0	6	0	0
14	22416536	.	C	T	5	3	8	0	0	8	0	0
14	22418519	.	C	T	9	4	13	0	0	13	0	0
14	22420941	.	G	A	3	2	5	0	0	5	0	0
14	22421001	.	G	T	0	2	2	0	3	5	0	0
14	22426797	.	G	A	4	4	8	0	1	9	0	0
14	22426800	.	G	A	0	4	4	0	4	8	0	0
14	22426836	.	C	T	3	3	6	0	0	6	0	0
14	22428122	.	G	T	1	2	3	0	3	6	0	0
14	22432004	.	G	A	0	3	3	0	8	11	0	0
14	22437413	.	G	T	4	7	11	0	1	12	0	0
14	22438924	.	A	G	4	10	14	0	1	15	0	0
14	22439183	.	C	G	3	5	8	0	0	8	0	0
14	22439210	.	G	T	4	5	9	0	0	9	0	0
14	22439258	.	G	T	2	6	8	0	0	8	0	0
14	22439302	.	A	G	2	5	7	0	2	9	0	0
14	22439455	.	A	T	4	5	9	0	0	9	0	0
14	22439725	.	T	A	1	2	3	0	1	4	0	0
14	22439955	.	T	A	2	2	4	0	0	4	0	0
14	22440115	.	A	G	1	0	1	0	3	4	0	0
14	22440918	.	G	A	3	4	7	0	0	7	0	0
14	22441000	.	G	C	1	5	6	0	0	6	0	0
14	22441057	.	T	C	1	7	8	0	0	8	0	0
14	22441110	.	G	A	4	4	8	0	0	8	0	0
14	22441179	.	C	A	2	4	6	0	0	6	0	0
14	22441532	.	T	C	5	9	14	0	0	14	0	0
14	22441581	.	C	A	7	3	10	0	1	11	0	0
14	22441612	.	T	A	10	3	13	0	0	13	0	0
14	22441650	.	C	T	12	3	15	0	0	15	0	0
14	22441730	.	A	G	8	3	11	0	0	11	0	0
14	22441793	.	G	A	1	10	11	0	7	18	0	0
14	22441873	.	T	C	4	2	6	0	1	7	0	0
14	22469900	.	C	T	3	4	7	0	0	7	0	0
14	22470213	.	T	C	2	3	5	0	0	5	0	0
14	22478294	.	T	C	1	3	4	0	0	4	0	0
14	22478348	.	C	T	4	3	7	0	0	7	0	0
14	22478380	.	C	T	3	4	7	0	0	7	0	0
14	22478913	.	T	C	3	1	4	0	2	6	0	0
14	22479381	.	T	A	1	4	5	0	0	5	0	0
14	22481851	.	T	C	1	3	4	0	0	4	0	0
14	22482132	.	T	C	1	3	4	0	0	4	0	0
14	22482173	.	A	T	2	4	6	0	0	6	0	0
14	22482233	.	C	T	1	5	6	0	0	6	0	0
14	22482539	.	G	C	3	3	6	0	0	6	0	0
14	22482681	.	C	A	0	2	2	0	1	3	0	0
14	22499368	.	A	G	1	3	4	0	0	4	0	0
14	22523608	.	C	A	7	5	12	0	1	13	0	0
14	22689737	.	A	G	5	0	5	0	4	9	0	0
14	22696456	.	C	T	3	5	8	0	0	8	0	0
14	22696522	.	T	C	2	3	5	0	0	5	0	0
14	22699771	.	C	A	5	6	11	0	1	12	0	0
14	22708325	.	A	G	4	5	9	0	0	9	0	0
14	22708446	.	C	T	2	6	8	0	0	8	0	0
14	23076277	.	G	A	2	4	6	0	0	6	0	0
14	23076349	.	A	T	1	4	5	0	0	5	0	0
14	23405034	.	G	A	1	6	7	0	0	7	0	0
14	23411619	.	C	G	5	0	5	0	5	10	0	0
14	23455989	.	G	A	9	4	13	0	0	13	0	0
14	23463681	.	G	A	0	5	5	0	1	6	0	0
14	23463760	.	C	A	5	7	12	0	0	12	0	0
14	23478997	.	G	C	12	6	18	0	0	18	0	0
14	24094722	.	G	A	3	4	7	0	0	7	0	0
14	24097523	.	C	T	12	16	28	0	2	30	0	0
14	24097686	.	A	G	13	14	27	0	2	29	0	0
14	24097734	.	G	A	13	9	22	0	1	23	0	0
14	24098408	.	C	G	7	9	16	0	2	18	0	0
14	24098912	.	C	T	0	7	7	0	10	17	0	0
14	24108731	.	G	A	8	12	20	0	0	20	0	0
14	24108983	.	G	A	12	13	25	0	0	25	0	0
14	24109031	.	A	G	15	10	25	0	1	26	0	0
14	24109067	.	G	C	17	2	19	0	13	32	0	0
14	24109184	.	G	A	24	11	35	0	0	35	0	0
14	24109355	.	C	G	10	10	20	0	0	20	0	0
14	24109451	.	A	G	9	12	21	0	0	21	0	0
14	24109706	.	T	G	15	9	24	0	2	26	0	0
14	24215187	.	C	G	4	8	12	0	1	13	0	0
14	24215231	.	G	A	6	12	18	0	0	18	0	0
14	24217550	.	C	T	7	6	13	0	0	13	0	0
14	24220467	.	A	G	13	0	13	0	19	32	0	0
14	24220659	.	A	C	2	5	7	0	0	7	0	0
14	24221356	.	G	A	1	15	16	0	10	26	0	0
14	24243246	.	T	C	2	2	4	0	0	4	0	0
14	24243278	.	A	G	2	2	4	0	0	4	0	0
14	24243925	.	G	A	1	2	3	0	0	3	0	0
14	24248575	.	C	T	3	2	5	0	0	5	0	0
14	24250463	.	C	T	2	4	6	0	1	7	0	0
14	24250583	.	G	A	3	8	11	0	0	11	0	0
14	24268222	.	G	T	4	4	8	0	1	9	0	0
14	24268262	.	A	G	9	9	18	0	3	21	0	0
14	24268332	.	A	C	7	0	7	0	9	16	0	0
14	24268374	.	G	A	6	8	14	0	0	14	0	0
14	24268505	.	G	A	8	5	13	0	0	13	0	0
14	24268712	.	C	T	2	11	13	0	14	27	0	0
14	24274521	.	T	G	10	9	19	0	0	19	0	0
14	24274575	.	C	T	12	6	18	0	0	18	0	0
14	24274783	.	G	A	8	15	23	0	0	23	0	0
14	24276634	.	C	T	8	10	18	0	1	19	0	0
14	24278144	.	C	G	27	28	55	0	2	57	0	0
14	24278162	.	C	G	25	25	50	0	5	55	0	0
14	24278831	.	T	C	21	17	38	0	0	38	0	0
14	24278882	.	C	A	14	18	32	0	1	33	0	0
14	24278917	.	G	A	22	20	42	0	1	43	0	0
14	24279126	.	A	G	31	16	47	0	1	48	0	0
14	24279148	.	G	A	37	7	44	2	6	52	0	0
14	24279305	.	A	T	7	7	14	0	1	15	0	0
14	24279326	.	A	C	10	11	21	0	0	21	0	0
14	24279367	.	A	T	12	13	25	0	2	27	0	0
14	24279383	.	T	A	11	16	27	0	0	27	0	0
14	24279682	.	T	C	8	16	24	0	2	26	0	0
14	24279701	.	C	G	5	15	20	0	2	22	0	0
14	24280452	.	T	C	17	8	25	0	1	26	0	0
14	24280517	.	A	C	16	17	33	0	0	33	0	0
14	24280842	.	T	C	16	20	36	0	1	37	0	0
14	24280904	.	T	G	11	30	41	0	1	42	0	0
14	24280918	.	T	G	8	28	36	0	3	39	0	0
14	24280975	.	A	G	21	14	35	0	0	35	0	0
14	24281118	.	T	A	23	18	41	0	1	42	0	0
14	24281149	.	A	C	21	16	37	0	1	38	0	0
14	24281292	.	T	C	34	12	46	0	1	47	0	0
14	24283536	.	C	T	39	14	53	3	0	56	0	0
14	24283609	.	G	A	11	14	25	1	1	27	0	0
14	24284089	.	T	C	4	3	7	0	0	7	0	0
14	24288567	.	G	A	2	5	7	0	0	7	0	0
14	24301658	.	G	A	2	3	5	0	9	14	0	0
14	24301750	.	G	T	12	5	17	0	0	17	0	0
14	24301946	.	C	A	2	6	8	0	2	10	0	0
14	24302052	.	T	C	9	5	14	0	0	14	0	0
14	24302089	.	A	T	5	3	8	0	0	9	1	0
14	24302177	.	A	T	3	7	10	0	0	10	0	0
14	24302214	.	T	C	4	6	10	0	1	11	0	0
14	24302236	.	A	C	3	4	7	0	0	7	0	0
14	24302280	.	G	T	5	3	8	0	0	8	0	0
14	24302310	.	A	C	4	3	7	0	0	7	0	0
14	24302363	.	T	A	4	5	9	0	1	10	0	0
14	24302428	.	T	C	4	4	8	0	1	9	0	0
14	24302560	.	G	A	6	8	14	0	1	15	0	0
14	24302766	.	T	G	4	5	9	0	0	9	0	0
14	24302825	.	T	C	5	8	13	0	0	13	0	0
14	24302920	.	C	T	7	3	10	0	0	10	0	0
14	24303102	.	A	G	9	4	13	0	0	13	0	0
14	24303103	.	A	G	7	5	12	0	1	13	0	0
14	24303205	.	T	A	7	4	11	1	0	12	0	0
14	24303465	.	G	T	1	9	10	0	7	17	0	0
14	24303523	.	G	T	17	8	25	0	2	27	0	0
14	24303660	.	T	C	4	3	7	0	0	7	0	0
14	24303665	.	C	A	4	3	7	0	0	7	0	0
14	24303735	.	G	C	5	7	12	0	1	13	0	0
14	24303786	.	A	T	6	8	14	0	1	15	0	0
14	24303851	.	C	A	3	4	7	0	1	8	0	0
14	24303873	.	C	A	2	4	6	0	2	8	0	0
14	24304271	.	T	A	10	15	25	0	0	25	0	0
14	24304298	.	A	C	12	13	25	0	0	25	0	0
14	24304518	.	T	C	9	8	17	0	0	17	0	0
14	24304753	.	T	C	4	2	6	0	0	6	0	0
14	24317226	.	G	A	30	28	58	0	0	58	0	0
14	24317301	.	G	T	28	21	49	0	2	51	0	0
14	24317751	.	C	A	2	22	24	0	25	49	0	0
14	24318041	.	A	T	26	10	36	0	1	37	0	0
14	24318102	.	A	T	21	20	41	0	1	42	0	0
14	24318160	.	T	G	24	14	38	0	1	39	0	0
14	24318196	.	G	A	27	18	45	0	1	46	0	0
14	24318232	.	G	C	36	14	50	0	2	53	1	0
14	24318335	.	G	T	17	14	31	0	2	33	0	0
14	24318631	.	C	T	20	24	44	0	2	46	0	0
14	24318652	.	G	A	22	22	44	0	1	45	0	0
14	24318709	.	A	T	13	16	29	0	3	32	0	0
14	24318723	.	T	C	15	18	33	0	0	33	0	0
14	24369500	.	C	T	15	12	27	0	0	27	0	0
14	24369578	.	A	G	14	23	37	0	0	37	0	0
14	24376787	.	G	A	27	17	44	0	2	46	0	0
14	24391397	.	G	A	16	9	25	0	0	25	0	0
14	24406609	.	C	G	1	21	22	0	17	39	0	0
14	24410450	.	A	C	20	18	38	0	1	39	0	0
14	24410553	.	C	A	12	18	30	0	1	31	0	0
14	24497832	.	G	T	4	4	8	0	0	8	0	0
14	24497868	.	T	C	2	0	2	0	6	8	0	0
14	24512823	.	G	A	2	4	6	0	1	7	0	0
14	24536966	.	A	G	5	4	9	0	0	9	0	0
14	24840805	.	T	C	2	2	4	0	0	4	0	0
14	24852639	.	T	C	8	3	11	0	0	11	0	0
14	24853036	.	A	G	1	4	5	0	0	5	0	0
14	24853292	.	A	G	1	3	4	0	0	4	0	0
14	24857317	.	T	C	3	3	6	0	0	6	0	0
14	24867270	.	T	C	6	5	11	0	0	11	0	0
14	24873327	.	A	G	3	0	3	0	3	6	0	0
14	24873487	.	A	G	1	6	7	0	2	9	0	0
14	24973441	.	A	T	6	7	13	0	0	13	0	0
14	24985474	.	T	C	5	9	14	0	0	14	0	0
14	24985478	.	C	T	5	8	13	0	1	14	0	0
14	24985582	.	C	A	8	7	15	0	0	15	0	0
14	24987643	.	G	T	12	10	22	0	1	23	0	0
14	24990428	.	G	T	5	16	21	0	1	22	0	0
14	24992574	.	G	A	1	6	7	0	8	15	0	0
14	24994819	.	G	A	1	7	8	0	10	18	0	0
14	24997850	.	G	A	1	5	6	0	4	10	0	0
14	24997910	.	C	T	4	6	10	0	1	11	0	0
14	24997911	.	C	T	5	6	11	0	0	11	0	0
14	24997954	.	C	A	3	7	10	0	1	11	0	0
14	24998019	.	A	T	8	10	18	0	0	18	0	0
14	24998076	.	A	G	21	0	21	0	8	29	0	0
14	24998345	.	C	A	8	6	14	0	1	15	0	0
14	24998359	.	C	A	10	9	19	0	0	19	0	0
14	24998430	.	G	A	1	6	7	0	11	18	0	0
14	24998737	.	A	C	11	15	26	0	1	27	0	0
14	24998765	.	A	T	13	13	26	0	1	27	0	0
14	24999546	.	T	A	14	11	25	0	0	25	0	0
14	24999573	.	A	G	16	1	17	0	8	25	0	0
14	24999722	.	T	C	12	12	24	1	3	28	0	0
14	25000492	.	A	T	3	12	15	0	1	16	0	0
14	25040313	.	G	A	6	4	10	0	0	10	0	0
14	25063607	.	G	T	13	1	14	0	0	14	0	0
14	25066002	.	C	A	4	18	22	0	18	40	0	0
14	25066722	.	T	A	19	14	33	0	0	33	0	0
14	25067471	.	C	T	14	9	23	0	3	26	0	0
14	25067665	.	C	T	20	9	29	0	0	29	0	0
14	25067700	.	C	A	16	8	24	0	1	25	0	0
14	25067857	.	G	A	17	11	28	0	2	30	0	0
14	25067862	.	A	C	18	11	29	0	0	29	0	0
14	25067984	.	C	T	22	8	30	0	0	30	0	0
14	25068206	.	G	T	21	14	35	0	1	36	0	0
14	25068215	.	T	G	21	15	36	0	0	36	0	0
14	25071338	.	C	T	4	20	24	0	15	39	0	0
14	25072307	.	G	T	19	14	33	0	1	34	0	0
14	25072351	.	C	T	24	15	39	0	0	39	0	0
14	25072447	.	A	G	12	21	33	0	0	33	0	0
14	25072468	.	C	T	12	22	34	0	1	35	0	0
14	25072489	.	T	G	9	22	31	0	0	31	0	0
14	25072662	.	T	C	9	0	9	0	15	24	0	0
14	25072737	.	C	T	7	8	15	0	0	15	0	0
14	25073178	.	C	G	1	6	7	0	15	22	0	0
14	25073412	.	G	A	5	17	22	0	0	22	0	0
14	25073511	.	C	T	14	7	21	0	0	21	0	0
14	25075173	.	G	A	9	7	16	0	0	16	0	0
14	25075992	.	C	T	1	3	4	0	0	4	0	0
14	25076578	.	G	A	1	0	1	0	3	4	0	0
14	25080035	.	A	G	17	18	35	0	2	37	0	0
14	25080687	.	C	G	22	19	41	0	0	41	0	0
14	25090999	.	T	G	16	14	30	0	1	31	0	0
14	25091063	.	A	G	19	18	37	0	1	38	0	0
14	25091467	.	C	T	18	9	27	0	1	28	0	0
14	25091840	.	C	T	10	11	21	0	2	23	0	0
14	25095719	.	G	A	5	3	8	0	0	8	0	0
14	25101126	.	A	G	3	2	5	0	0	5	0	0
14	25102078	.	G	A	2	4	6	3	0	9	0	0
14	25200220	.	G	A	1	3	4	0	0	4	0	0
14	25467064	.	C	T	3	2	5	0	0	5	0	0
14	25480228	.	A	G	4	0	4	0	2	6	0	0
14	25483989	.	T	C	5	5	10	0	0	10	0	0
14	25495423	.	A	G	4	7	11	0	1	12	0	0
14	25496045	.	A	T	1	9	10	0	2	12	0	0
14	25496076	.	G	T	0	10	10	0	6	16	0	0
14	25498423	.	T	C	8	9	17	0	0	17	0	0
14	25498930	.	A	G	1	3	4	0	0	4	0	0
14	25498932	.	A	T	1	3	4	0	0	4	0	0
14	25499141	.	T	G	1	3	4	0	0	4	0	0
14	25499275	.	A	G	1	0	1	0	2	3	0	0
14	25499293	.	C	A	3	2	5	0	0	5	0	0
14	25499695	.	G	A	1	2	3	0	6	9	0	0
14	25499974	.	C	T	2	3	5	0	0	5	0	0
14	25500093	.	A	T	5	4	9	0	0	9	0	0
14	25500110	.	G	A	1	4	5	0	6	11	0	0
14	25500594	.	T	A	4	7	11	0	0	11	0	0
14	25500779	.	T	A	5	3	8	0	0	8	0	0
14	25500793	.	A	G	2	2	4	0	2	6	0	0
14	25501405	.	C	T	2	5	7	0	0	7	0	0
14	25501581	.	T	C	4	5	9	1	0	10	0	0
14	25501851	.	T	G	11	7	18	0	1	19	0	0
14	25502142	.	T	C	11	12	23	0	0	23	0	0
14	25510803	.	A	G	4	3	7	0	0	7	0	0
14	25535003	.	C	T	2	17	19	0	4	23	0	0
14	25535005	.	T	C	5	16	21	0	1	22	0	0
14	25535067	.	A	T	11	23	34	0	0	34	0	0
14	25535167	.	T	G	10	9	19	0	0	19	0	0
14	25535607	.	G	A	19	18	37	0	2	39	0	0
14	25535706	.	G	T	22	30	52	0	0	53	1	0
14	25535742	.	T	A	20	18	38	2	2	42	0	0
14	25535768	.	G	T	19	14	33	3	1	37	0	0
14	25535820	.	C	T	1	9	10	0	16	26	0	0
14	25535836	.	G	A	14	5	19	0	2	21	0	0
14	25536132	.	T	C	16	8	24	0	2	26	0	0
14	25536148	.	G	A	16	10	26	0	2	28	0	0
14	25536187	.	G	T	22	6	28	0	2	30	0	0
14	25536198	.	A	G	24	5	29	0	1	30	0	0
14	25536422	.	A	G	23	6	29	0	0	29	0	0
14	25536531	.	T	G	22	9	31	0	0	32	1	0
14	25536577	.	G	C	18	18	36	0	0	36	0	0
14	25536619	.	A	G	26	23	49	0	0	49	0	0
14	25536657	.	A	C	26	25	51	0	2	53	0	0
14	25536770	.	A	T	29	10	39	0	0	39	0	0
14	25536782	.	C	T	1	10	11	0	24	35	0	0
14	25537019	.	C	A	12	17	29	0	0	29	0	0
14	25537068	.	G	A	13	17	30	0	0	30	0	0
14	25537136	.	T	C	21	10	31	0	2	33	0	0
14	25537145	.	G	A	21	14	35	0	1	36	0	0
14	25537189	.	A	T	24	17	41	0	2	43	0	0
14	25537200	.	C	T	25	17	42	0	1	43	0	0
14	25537307	.	A	T	19	12	31	0	2	33	0	0
14	25537332	.	T	A	18	12	30	0	0	30	0	0
14	25537345	.	A	G	15	10	25	0	1	26	0	0
14	25537405	.	A	G	16	16	32	0	1	33	0	0
14	25537700	.	C	T	2	15	17	0	11	28	0	0
14	25537975	.	G	T	15	16	31	0	3	34	0	0
14	25538121	.	T	C	12	17	29	0	3	32	0	0
14	25538355	.	A	T	19	13	32	0	1	33	0	0
14	25538364	.	A	C	20	14	34	0	0	34	0	0
14	25538433	.	T	A	6	12	18	0	1	19	0	0
14	25538490	.	T	C	5	7	12	0	0	12	0	0
14	25538497	.	C	A	4	6	10	0	0	10	0	0
14	25538618	.	T	A	17	15	32	0	0	33	1	0
14	25539423	.	C	T	0	18	18	0	14	32	0	0
14	25591182	.	C	T	1	8	9	0	6	15	0	0
14	25874600	.	G	A	4	2	6	0	2	8	0	0
14	25885793	.	G	C	0	5	5	0	3	8	0	0
14	25904733	.	C	T	7	4	11	0	0	11	0	0
14	25904739	.	C	T	7	4	11	0	0	11	0	0
14	25904781	.	C	T	6	5	11	0	2	13	0	0
14	25904811	.	C	T	5	8	13	0	0	13	0	0
14	25904868	.	C	T	7	9	16	0	0	16	0	0
14	25905091	.	C	T	7	7	14	0	1	15	0	0
14	25905281	.	A	G	2	2	4	0	1	5	0	0
14	25905808	.	C	T	2	6	8	0	0	8	0	0
14	25906079	.	G	A	2	3	5	0	2	7	0	0
14	25906539	.	C	T	7	2	9	0	0	9	0	0
14	25906572	.	G	A	4	6	10	0	0	10	0	0
14	25906652	.	G	T	8	9	17	0	2	19	0	0
14	25906727	.	A	G	4	14	18	0	0	18	0	0
14	25907006	.	T	C	4	7	11	1	0	12	0	0
14	25907045	.	A	T	8	2	10	0	1	11	0	0
14	25907051	.	G	C	7	2	9	0	0	9	0	0
14	25907143	.	A	G	5	2	7	0	13	20	0	0
14	25907233	.	T	C	5	5	10	1	0	11	0	0
14	25907335	.	A	G	2	2	4	0	0	4	0	0
14	25907541	.	C	T	4	11	15	0	0	15	0	0
14	25907578	.	T	A	6	7	13	0	0	13	0	0
14	25907737	.	T	C	3	3	6	0	0	6	0	0
14	25907893	.	G	A	2	7	9	1	7	17	0	0
14	25908021	.	T	A	8	6	14	0	0	14	0	0
14	25908113	.	A	C	6	3	9	0	0	9	0	0
14	25908640	.	G	A	3	1	4	0	2	6	0	0
14	25908659	.	G	C	3	4	7	0	0	7	0	0
14	25908680	.	A	T	5	4	9	0	1	10	0	0
14	25908753	.	A	C	7	7	14	0	1	15	0	0
14	25908802	.	A	C	16	11	27	0	2	29	0	0
14	25908843	.	A	T	17	8	25	0	0	25	0	0
14	25908901	.	C	T	10	12	22	0	0	22	0	0
14	25908984	.	T	G	12	6	18	0	0	18	0	0
14	25909103	.	C	A	4	4	8	0	0	8	0	0
14	25909567	.	T	C	1	9	10	0	0	10	0	0
14	25909582	.	T	C	1	11	12	0	0	12	0	0
14	25909736	.	G	A	3	6	9	0	2	11	0	0
14	25910037	.	T	A	5	6	11	0	1	12	0	0
14	25910186	.	C	A	6	8	14	0	0	14	0	0
14	25910296	.	A	G	15	5	20	0	0	20	0	0
14	25910314	.	A	T	7	17	24	0	0	24	0	0
14	25910414	.	C	G	5	8	13	0	3	16	0	0
14	25910636	.	G	C	15	10	25	0	0	25	0	0
14	25910715	.	T	C	14	7	21	0	2	23	0	0
14	25910747	.	C	T	8	12	20	0	2	22	0	0
14	25910825	.	A	C	19	17	36	0	2	38	0	0
14	25910834	.	T	A	18	20	38	0	1	39	0	0
14	25911097	.	C	T	10	12	22	0	1	23	0	0
14	25911098	.	G	A	13	10	23	0	0	23	0	0
14	25923510	.	C	G	6	2	8	0	2	10	0	0
14	25924369	.	T	A	5	5	10	0	1	11	0	0
14	25924429	.	C	T	0	6	6	0	4	10	0	0
14	25924661	.	T	C	4	3	7	0	0	7	0	0
14	25924868	.	A	T	5	3	8	0	0	8	0	0
14	25924931	.	G	A	8	5	13	0	0	13	0	0
14	25925081	.	G	T	3	5	8	0	0	8	0	0
14	25925118	.	A	T	3	3	6	0	0	6	0	0
14	25925600	.	C	T	1	2	3	0	0	3	0	0
14	25925973	.	T	A	7	7	14	0	0	14	0	0
14	25926134	.	G	A	11	13	24	0	1	25	0	0
14	25926195	.	G	A	8	15	23	0	0	23	0	0
14	25926276	.	G	A	21	9	30	0	1	32	1	0
14	25932650	.	C	A	5	7	12	0	0	12	0	0
14	25935090	.	G	T	10	4	14	0	0	14	0	0
14	25939622	.	G	A	23	10	33	0	2	35	0	0
14	25942653	.	G	A	7	8	15	0	0	15	0	0
14	25985448	.	A	C	16	12	28	0	0	30	2	0
14	25985733	.	T	A	3	6	9	0	1	10	0	0
14	25986978	.	G	C	2	2	4	0	1	5	0	0
14	25993160	.	G	A	4	5	9	0	0	9	0	0
14	25994749	.	A	G	3	2	5	0	4	9	0	0
14	25994755	.	T	G	6	3	9	0	0	9	0	0
14	25997985	.	A	G	3	3	6	0	0	6	0	0
14	26002310	.	T	C	4	5	9	0	0	9	0	0
14	26002514	.	G	C	10	4	14	0	0	14	0	0
14	26008943	.	A	G	3	2	5	0	9	14	0	0
14	26008951	.	G	A	0	7	7	0	5	12	0	0
14	26009146	.	A	G	6	2	8	0	2	10	0	0
14	26009201	.	T	C	3	2	5	0	0	5	0	0
14	26009202	.	C	T	4	2	6	0	0	6	0	0
14	26009267	.	G	A	0	2	2	0	8	10	0	0
14	26011975	.	C	T	4	5	9	0	0	9	0	0
14	26011987	.	G	A	1	4	5	0	3	8	0	0
14	26012017	.	G	A	6	5	11	0	0	11	0	0
14	26012026	.	A	G	5	0	5	0	4	9	0	0
14	26065818	.	T	G	1	4	5	0	0	5	0	0
14	26066617	.	A	G	7	7	14	0	0	14	0	0
14	26066969	.	T	C	2	3	5	0	1	6	0	0
14	26067378	.	T	G	3	3	6	0	0	6	0	0
14	26067757	.	T	A	4	5	9	0	1	10	0	0
14	26103439	.	A	T	4	2	6	0	0	6	0	0
14	26103547	.	T	A	13	10	23	0	2	25	0	0
14	26104350	.	C	A	0	17	17	0	18	35	0	0
14	26104442	.	C	T	21	18	39	0	1	40	0	0
14	26104503	.	C	T	18	17	35	0	2	37	0	0
14	26104614	.	A	C	20	10	30	1	0	31	0	0
14	26104674	.	A	T	5	15	20	0	0	21	1	0
14	26104679	.	A	C	5	0	5	0	15	20	0	0
14	26104710	.	G	T	2	16	18	0	0	18	0	0
14	26104801	.	C	A	6	13	19	0	1	20	0	0
14	26104854	.	C	T	8	9	17	0	0	17	0	0
14	26105221	.	A	G	16	4	20	0	0	20	0	0
14	26105762	.	A	T	3	5	8	0	6	14	0	0
14	26105787	.	A	G	14	3	17	0	2	19	0	0
14	26106082	.	A	T	16	11	27	0	0	27	0	0
14	26106091	.	C	G	1	15	16	0	14	30	0	0
14	26106231	.	G	T	6	23	29	0	0	29	0	0
14	26106493	.	C	T	13	23	36	0	0	36	0	0
14	26106697	.	C	T	1	18	19	0	19	38	0	0
14	26108958	.	T	G	21	18	39	0	0	39	0	0
14	26109353	.	T	G	13	16	29	0	1	30	0	0
14	26109356	.	G	A	14	16	30	0	0	30	0	0
14	26111237	.	T	C	11	16	27	1	1	29	0	0
14	26114037	.	A	T	15	10	25	0	0	25	0	0
14	26114044	.	A	C	13	10	23	0	0	23	0	0
14	26114277	.	G	A	16	12	28	0	0	28	0	0
14	26114286	.	T	C	13	2	15	0	15	30	0	0
14	26127373	.	G	A	16	14	30	0	2	32	0	0
14	26127561	.	G	A	8	17	25	0	1	26	0	0
14	26127736	.	G	A	7	9	16	0	2	18	0	0
14	26127754	.	T	A	10	9	19	0	1	20	0	0
14	26127845	.	C	T	10	12	22	0	0	22	0	0
14	26127856	.	G	A	11	11	22	0	1	23	0	0
14	26147181	.	A	G	12	12	24	0	0	24	0	0
14	26147418	.	A	G	11	5	16	0	0	16	0	0
14	26149915	.	G	T	14	5	19	0	2	21	0	0
14	26152751	.	C	T	11	13	24	0	0	24	0	0
14	26153474	.	T	C	4	9	13	0	0	13	0	0
14	26153604	.	A	G	5	6	11	0	0	11	0	0
14	26153903	.	G	A	6	5	11	0	1	12	0	0
14	26154376	.	C	T	0	8	8	0	1	9	0	0
14	26154533	.	G	A	6	5	11	0	0	11	0	0
14	26154623	.	T	C	3	0	3	0	3	6	0	0
14	26155016	.	A	G	6	4	10	0	0	10	0	0
14	26155267	.	T	C	5	0	5	0	6	11	0	0
14	26155435	.	T	G	2	3	5	0	0	5	0	0
14	26156156	.	G	A	4	2	6	0	0	6	0	0
14	26157519	.	G	A	5	5	10	0	0	10	0	0
14	26163156	.	T	C	10	1	11	0	4	15	0	0
14	26165027	.	A	G	8	3	11	0	1	12	0	0
14	26165223	.	G	A	3	3	6	0	1	7	0	0
14	26168133	.	A	T	4	6	10	0	1	11	0	0
14	26169255	.	G	A	4	2	6	0	0	6	0	0
14	26169477	.	C	A	0	3	3	0	4	7	0	0
14	26169722	.	C	T	0	5	5	0	2	7	0	0
14	26170768	.	C	T	0	2	2	0	2	4	0	0
14	26177050	.	T	G	4	5	9	0	3	12	0	0
14	26224807	.	T	G	12	7	19	0	0	19	0	0
14	26227681	.	G	A	2	3	5	0	0	5	0	0
14	26227791	.	A	C	4	5	9	0	0	10	1	0
14	26364833	.	G	A	2	4	6	0	0	6	0	0
14	26364988	.	A	T	1	2	3	0	0	3	0	0
14	26364993	.	A	T	1	2	3	0	0	3	0	0
14	26376434	.	G	A	2	4	6	0	0	6	0	0
14	26376464	.	C	A	2	2	4	0	2	6	0	0
14	26376473	.	T	A	2	5	7	0	0	7	0	0
14	26380798	.	C	T	1	3	4	0	0	4	0	0
14	26381396	.	T	C	3	2	5	0	0	5	0	0
14	26381406	.	A	G	2	2	4	0	1	5	0	0
14	26381948	.	T	C	11	3	14	2	0	16	0	0
14	26404641	.	T	G	1	2	3	0	0	3	0	0
14	26404803	.	C	T	16	8	24	0	1	25	0	0
14	26404830	.	C	A	17	9	26	0	1	27	0	0
14	26405027	.	G	A	9	9	18	0	1	19	0	0
14	26405330	.	C	T	6	6	12	0	1	13	0	0
14	26413771	.	C	T	19	9	28	0	1	29	0	0
14	26414115	.	C	A	20	21	41	0	1	42	0	0
14	26414157	.	C	T	18	15	33	0	1	34	0	0
14	26414692	.	C	T	15	11	26	0	2	28	0	0
14	26559685	.	A	G	2	2	4	0	0	4	0	0
14	26718587	.	A	G	8	11	19	0	1	20	0	0
14	27281038	.	C	G	18	16	34	0	1	35	0	0
14	27281182	.	T	C	15	11	26	0	1	27	0	0
14	27281407	.	T	C	5	0	5	0	4	9	0	0
14	27281529	.	A	G	5	3	8	0	1	9	0	0
14	27281665	.	G	A	6	6	12	0	1	13	0	0
14	27288491	.	C	T	11	3	14	0	0	14	0	0
14	27288737	.	T	G	13	11	24	0	1	25	0	0
14	27288832	.	A	G	9	4	13	0	0	13	0	0
14	27998933	.	T	A	19	22	41	0	2	43	0	0
14	28001490	.	G	A	32	25	57	0	3	60	0	0
14	28282150	.	G	A	2	7	9	0	10	19	0	0
14	28282192	.	A	G	8	1	9	0	6	15	0	0
14	28282528	.	A	G	6	8	14	0	0	14	0	0
14	28351739	.	C	T	23	10	33	0	0	33	0	0
14	28351745	.	G	A	21	10	31	0	1	32	0	0
14	28351793	.	C	T	15	14	29	0	1	30	0	0
14	28385289	.	C	T	11	12	23	0	1	24	0	0
14	28385564	.	G	A	9	12	21	0	0	21	0	0
14	28426615	.	G	A	2	2	4	0	0	4	0	0
14	28437306	.	A	G	7	1	8	0	2	10	0	0
14	28437309	.	T	C	7	2	9	0	0	9	0	0
14	28437362	.	A	G	4	2	6	0	0	6	0	0
14	28438975	.	G	A	6	6	12	0	2	14	0	0
14	28443175	.	C	T	6	15	21	0	2	23	0	0
14	28448925	.	T	C	13	7	20	0	1	21	0	0
14	28449193	.	A	C	12	21	33	0	0	33	0	0
14	28452247	.	C	T	11	18	29	0	3	32	0	0
14	28452270	.	T	C	12	14	26	0	0	26	0	0
14	28454613	.	A	T	16	24	40	0	0	40	0	0
14	28458110	.	T	C	20	10	30	0	1	31	0	0
14	28458175	.	G	A	17	12	29	0	1	30	0	0
14	28458199	.	T	C	15	10	25	0	0	25	0	0
14	28458345	.	G	A	2	12	14	0	15	29	0	0
14	28458533	.	G	A	19	11	30	0	0	30	0	0
14	28458656	.	A	T	13	22	35	0	3	38	0	0
14	28458980	.	C	G	7	5	12	0	1	13	0	0
14	28459275	.	A	C	13	16	29	0	0	29	0	0
14	28459292	.	G	C	2	12	14	0	9	23	0	0
14	28459324	.	T	A	15	12	27	0	0	27	0	0
14	28459664	.	A	G	7	7	14	0	0	14	0	0
14	28459703	.	C	A	0	5	5	0	9	14	0	0
14	28463860	.	T	A	6	7	13	0	0	13	0	0
14	28464821	.	C	T	5	6	11	0	0	11	0	0
14	28464889	.	A	G	3	5	8	0	0	8	0	0
14	28464895	.	T	A	3	5	8	0	1	9	0	0
14	28473556	.	C	T	8	6	14	0	0	14	0	0
14	28476860	.	G	A	3	3	6	0	5	11	0	0
14	28476977	.	C	T	9	5	14	0	0	14	0	0
14	28477115	.	A	G	14	5	19	0	2	21	0	0
14	28477384	.	C	T	7	5	12	0	0	12	0	0
14	28477400	.	A	G	10	0	10	0	7	17	0	0
14	28483121	.	T	A	1	3	4	0	0	4	0	0
14	28492934	.	A	G	7	0	7	0	10	17	0	0
14	28492940	.	A	G	9	0	9	0	9	18	0	0
14	28493222	.	T	C	5	4	9	0	0	9	0	0
14	28497349	.	C	T	5	9	14	0	0	14	0	0
14	28497472	.	A	G	9	0	9	0	10	19	0	0
14	28497490	.	C	T	10	11	21	0	0	21	0	0
14	28497705	.	C	T	7	9	16	0	1	17	0	0
14	28501311	.	T	C	5	7	12	0	1	13	0	0
14	28501798	.	C	T	8	7	15	0	1	16	0	0
14	28502502	.	G	A	5	11	16	0	0	16	0	0
14	28502783	.	C	T	8	11	19	0	1	20	0	0
14	28504579	.	A	G	8	7	15	0	1	16	0	0
14	28507764	.	C	T	8	12	20	0	0	20	0	0
14	28512717	.	C	T	10	15	25	0	0	25	0	0
14	28514094	.	T	C	9	8	17	0	0	17	0	0
14	28514289	.	G	C	10	7	17	0	1	18	0	0
14	28514295	.	C	T	10	6	16	0	0	16	0	0
14	28514328	.	C	G	5	5	10	0	1	11	0	0
14	28520068	.	C	T	11	12	23	0	1	24	0	0
14	28520213	.	T	C	6	16	22	0	3	25	0	0
14	28525002	.	A	C	13	12	25	0	1	26	0	0
14	28525367	.	G	A	15	11	26	0	1	27	0	0
14	28525731	.	T	A	7	3	10	0	0	10	0	0
14	28526081	.	G	A	11	14	25	0	2	27	0	0
14	28526110	.	A	G	22	4	26	0	1	27	0	0
14	28526281	.	A	G	10	1	11	0	19	30	0	0
14	28526797	.	C	T	9	15	24	0	0	24	0	0
14	28526815	.	G	T	12	11	23	0	0	23	0	0
14	28526950	.	T	C	17	16	33	0	1	34	0	0
14	28527130	.	T	G	12	10	22	0	1	23	0	0
14	29582372	.	A	G	5	0	5	0	6	11	0	0
14	29609369	.	G	T	6	6	12	0	0	12	0	0
14	29746331	.	T	C	6	2	8	0	0	8	0	0
14	30106305	.	T	A	1	3	4	0	0	4	0	0
14	30107029	.	G	A	1	3	4	0	0	4	0	0
14	30156943	.	T	A	5	5	10	0	1	11	0	0
14	30157004	.	T	G	7	6	13	0	0	13	0	0
14	30157030	.	A	T	7	6	13	0	0	13	0	0
14	30158365	.	A	G	1	2	3	0	0	3	0	0
14	30158528	.	T	C	3	2	5	0	0	5	0	0
14	30158555	.	C	T	2	2	4	0	0	4	0	0
14	30159101	.	T	C	0	6	6	0	0	6	0	0
14	30159105	.	T	C	3	3	6	0	0	6	0	0
14	30161897	.	A	G	1	3	4	0	2	6	0	0
14	30199715	.	G	C	3	2	5	0	0	5	0	0
14	30200057	.	C	T	1	2	3	0	0	3	0	0
14	30272965	.	C	A	6	3	9	0	0	9	0	0
14	30273272	.	T	C	2	4	6	0	0	6	0	0
14	30276438	.	A	C	9	6	15	0	1	16	0	0
14	30276441	.	A	G	9	6	15	0	1	16	0	0
14	30276522	.	A	G	3	0	3	0	5	8	0	0
14	30277652	.	G	A	0	2	2	0	1	3	0	0
14	30278045	.	A	T	1	2	3	0	0	3	0	0
14	30356947	.	T	A	3	2	5	0	0	5	0	0
14	30360991	.	G	A	3	8	11	0	0	11	0	0
14	30361224	.	C	A	4	3	7	0	1	8	0	0
14	30368712	.	T	A	3	2	5	0	0	5	0	0
14	30368762	.	A	T	1	3	4	0	0	4	0	0
14	30368785	.	T	A	1	2	3	0	0	3	0	0
14	30369018	.	T	C	2	1	3	0	0	3	0	0
14	30369026	.	A	G	2	2	4	0	0	4	0	0
14	30369448	.	A	T	2	2	4	0	0	4	0	0
14	30369572	.	C	T	3	2	5	0	0	5	0	0
14	30369675	.	G	A	2	3	5	0	0	5	0	0
14	30398672	.	C	T	4	3	7	0	0	7	0	0
14	30401100	.	C	T	5	3	8	0	0	8	0	0
14	30403813	.	A	G	10	6	16	0	1	17	0	0
14	30403830	.	G	A	6	9	15	0	0	15	0	0
14	30407638	.	C	A	8	9	17	0	0	17	0	0
14	30410882	.	G	A	0	4	4	0	8	12	0	0
14	30410911	.	G	A	7	8	15	0	1	16	0	0
14	30411292	.	T	C	12	12	24	0	0	24	0	0
14	30411707	.	C	T	4	3	7	0	0	7	0	0
14	30411724	.	T	C	7	3	10	0	0	10	0	0
14	30411774	.	G	A	10	12	22	0	0	22	0	0
14	30411937	.	A	G	3	2	5	0	0	5	0	0
14	30424213	.	C	A	2	2	4	0	0	4	0	0
14	30424342	.	G	C	0	2	2	0	3	5	0	0
14	30427682	.	T	C	3	3	6	0	0	6	0	0
14	30427688	.	A	G	3	3	6	0	0	6	0	0
14	30427780	.	C	A	3	3	6	0	0	6	0	0
14	30427834	.	G	A	6	4	10	0	1	11	0	0
14	30428031	.	C	T	6	4	10	0	0	10	0	0
14	30428193	.	G	T	5	7	12	0	1	13	0	0
14	30435578	.	G	A	8	6	14	0	0	14	0	0
14	30452156	.	C	T	5	7	12	0	0	12	0	0
14	30454979	.	A	T	9	4	13	0	0	13	0	0
14	30455833	.	T	A	3	3	6	0	0	6	0	0
14	30456463	.	C	T	0	8	8	0	8	16	0	0
14	30460630	.	G	A	10	8	18	0	0	18	0	0
14	30488546	.	A	T	3	6	9	0	0	9	0	0
14	30551452	.	A	T	12	4	16	0	0	16	0	0
14	30551488	.	C	T	7	7	14	0	1	15	0	0
14	30551712	.	G	T	12	17	29	0	1	30	0	0
14	30551775	.	C	T	2	8	10	2	25	37	0	0
14	30551790	.	G	A	26	10	36	2	0	38	0	0
14	30569108	.	G	A	3	12	15	0	14	29	0	0
14	30580844	.	C	T	4	3	7	0	0	7	0	0
14	30580906	.	A	G	3	7	10	0	0	10	0	0
14	30581910	.	A	G	3	6	9	0	0	9	0	0
14	30587436	.	C	T	1	4	5	0	0	5	0	0
14	30587717	.	A	G	5	5	10	0	1	11	0	0
14	30588022	.	C	A	6	5	11	0	1	12	0	0
14	30613469	.	C	A	13	20	33	0	0	33	0	0
14	30620229	.	G	C	12	12	24	0	0	24	0	0
14	30637866	.	T	C	20	0	20	0	25	45	0	0
14	30637907	.	G	A	25	25	50	0	1	51	0	0
14	30638071	.	G	A	18	16	34	0	2	36	0	0
14	30638087	.	G	A	21	15	36	0	1	37	0	0
14	30638336	.	C	T	13	19	32	0	5	37	0	0
14	30638599	.	G	A	14	20	34	0	3	37	0	0
14	30642513	.	A	G	14	13	27	0	1	28	0	0
14	30642529	.	A	T	15	10	25	0	0	25	0	0
14	30642757	.	T	G	21	19	40	0	2	42	0	0
14	30670017	.	C	A	2	3	5	0	0	5	0	0
14	30670618	.	C	T	2	2	4	1	0	5	0	0
14	30713964	.	T	C	25	23	48	0	0	48	0	0
14	30720354	.	C	T	0	10	10	0	11	21	0	0
14	30720372	.	T	G	8	15	23	0	1	24	0	0
14	30720399	.	C	T	0	9	9	0	11	20	0	0
14	30731046	.	T	C	12	8	20	0	0	20	0	0
14	30731174	.	C	T	10	12	22	0	1	23	0	0
14	30731565	.	T	C	8	16	24	0	1	25	0	0
14	30731577	.	A	G	10	12	22	0	2	24	0	0
14	30732136	.	C	G	10	16	26	0	2	28	0	0
14	30732828	.	T	G	10	12	22	0	2	24	0	0
14	30732899	.	C	T	16	6	22	0	2	24	0	0
14	30733008	.	C	T	15	10	25	0	1	26	0	0
14	30733164	.	G	A	14	18	32	0	1	33	0	0
14	30733279	.	C	A	19	12	31	0	4	35	0	0
14	30733411	.	A	G	19	16	35	0	3	38	0	0
14	30733685	.	G	A	20	13	33	0	2	35	0	0
14	30733689	.	G	A	17	13	30	0	5	35	0	0
14	30733779	.	G	A	4	9	13	0	14	27	0	0
14	30733783	.	C	A	10	19	29	0	0	29	0	0
14	30733964	.	C	T	18	15	33	0	1	34	0	0
14	30734183	.	C	T	13	15	28	0	2	30	0	0
14	30734215	.	A	T	16	16	32	0	2	34	0	0
14	30734221	.	A	G	16	0	16	0	19	35	0	0
14	30734295	.	A	G	18	22	40	0	6	46	0	0
14	30734347	.	A	G	22	24	46	0	2	48	0	0
14	30734389	.	A	T	16	19	35	0	0	35	0	0
14	30734390	.	T	A	16	17	33	0	2	35	0	0
14	30734516	.	T	C	20	19	39	0	2	41	0	0
14	30740454	.	T	A	1	3	4	0	1	5	0	0
14	30757309	.	C	T	5	9	14	0	1	15	0	0
14	30791109	.	C	T	2	4	6	0	1	7	0	0
14	30791127	.	C	T	2	4	6	0	0	6	0	0
14	30792931	.	A	T	3	2	5	0	0	5	0	0
14	30793161	.	C	T	3	2	5	0	0	5	0	0
14	30793397	.	G	A	2	6	8	0	1	9	0	0
14	30793398	.	C	T	2	6	8	0	1	9	0	0
14	30793465	.	G	T	2	3	5	0	1	6	0	0
14	30800528	.	T	C	19	11	30	0	0	30	0	0
14	30800809	.	A	C	34	30	64	0	7	71	0	0
14	30801329	.	G	A	23	13	36	1	2	39	0	0
14	30801379	.	G	A	16	12	28	0	3	31	0	0
14	30801389	.	A	G	22	11	33	0	0	33	0	0
14	30801451	.	G	C	14	12	26	0	1	27	0	0
14	30803394	.	G	T	6	2	8	0	0	8	0	0
14	30803469	.	T	A	3	2	5	0	0	5	0	0
14	30803472	.	T	G	3	2	5	0	0	5	0	0
14	30803537	.	G	A	1	3	4	0	0	4	0	0
14	30803662	.	G	A	4	3	7	0	0	7	0	0
14	30803794	.	C	G	3	3	6	0	0	6	0	0
14	30803902	.	T	C	1	4	5	0	0	5	0	0
14	30803904	.	G	C	1	0	1	0	4	5	0	0
14	30805051	.	G	T	1	2	3	0	1	4	0	0
14	30808046	.	G	A	1	2	3	0	0	3	0	0
14	30854710	.	A	T	23	14	37	0	1	38	0	0
14	30854742	.	A	C	13	17	30	1	1	33	1	0
14	30855218	.	A	G	22	13	35	0	4	39	0	0
14	30855303	.	C	T	2	17	19	0	17	36	0	0
14	30855649	.	C	A	21	18	39	0	0	39	0	0
14	30855767	.	G	T	21	22	43	0	0	43	0	0
14	30855824	.	T	A	16	24	40	0	2	42	0	0
14	30876425	.	A	G	11	8	19	0	0	20	1	0
14	30876670	.	A	T	13	11	24	0	0	24	0	0
14	30878226	.	T	G	4	4	8	0	0	8	0	0
14	30878357	.	C	A	2	2	4	0	0	4	0	0
14	30878587	.	G	A	10	7	17	0	1	18	0	0
14	30878604	.	C	T	9	4	13	0	0	13	0	0
14	30879932	.	T	A	4	3	7	0	0	7	0	0
14	30880091	.	A	C	5	6	11	0	0	11	0	0
14	30880477	.	C	T	0	10	10	0	7	17	0	0
14	30880497	.	C	T	3	8	11	0	0	11	0	0
14	30880532	.	A	G	1	2	3	0	1	4	0	0
14	30880534	.	A	G	2	2	4	0	0	4	0	0
14	30880817	.	A	G	7	8	15	0	1	16	0	0
14	30880973	.	G	A	3	4	7	0	0	7	0	0
14	30880980	.	T	C	5	1	6	0	4	10	0	0
14	30881073	.	A	T	3	4	7	0	0	7	0	0
14	30881162	.	C	G	4	2	6	0	1	7	0	0
14	30881337	.	C	T	2	5	7	0	6	13	0	0
14	30883321	.	G	A	1	3	4	0	0	4	0	0
14	30886625	.	C	A	0	2	2	0	3	5	0	0
14	30886637	.	G	A	3	2	5	0	0	5	0	0
14	30910227	.	G	A	1	3	4	0	0	4	0	0
14	30912058	.	T	C	12	5	17	0	1	18	0	0
14	30912925	.	C	T	5	5	10	0	1	11	0	0
14	30913330	.	T	C	6	4	10	0	0	10	0	0
14	30913423	.	G	A	2	5	7	0	1	8	0	0
14	30914894	.	C	T	2	2	4	0	0	4	0	0
14	30914895	.	T	A	2	1	3	0	1	4	0	0
14	30915103	.	A	G	10	6	16	0	1	17	0	0
14	30915268	.	C	T	5	3	8	0	0	8	0	0
14	30915322	.	G	A	3	2	5	0	1	6	0	0
14	30915417	.	A	T	2	5	7	0	0	7	0	0
14	30915608	.	T	A	9	7	16	0	0	16	0	0
14	30916033	.	A	T	3	3	6	0	0	6	0	0
14	30916902	.	G	A	3	7	10	0	2	12	0	0
14	30925570	.	A	C	8	0	8	0	12	20	0	0
14	30927430	.	G	A	8	5	13	0	1	14	0	0
14	30929684	.	G	A	5	10	15	0	0	15	0	0
14	30929846	.	T	A	3	4	7	0	1	8	0	0
14	30929861	.	C	T	2	2	4	0	1	5	0	0
14	30967732	.	C	T	0	5	5	0	4	9	0	0
14	30967975	.	T	G	2	5	7	0	1	8	0	0
14	30970827	.	G	C	4	3	7	0	2	9	0	0
14	30970834	.	A	C	5	5	10	0	0	10	0	0
14	30970895	.	C	T	3	3	6	0	1	7	0	0
14	30975479	.	G	T	21	23	44	0	2	47	1	0
14	30978661	.	T	C	18	13	31	0	0	31	0	0
14	30982468	.	A	G	16	12	28	0	1	29	0	0
14	30987167	.	G	T	15	19	34	1	1	36	0	0
14	30987702	.	T	A	17	17	34	0	0	34	0	0
14	30987930	.	G	A	17	18	35	0	2	37	0	0
14	30987985	.	A	G	25	12	37	0	0	37	0	0
14	30988280	.	T	C	13	0	13	0	15	28	0	0
14	30988494	.	G	A	11	16	27	0	2	29	0	0
14	30988707	.	T	G	10	10	20	0	0	20	0	0
14	30988756	.	G	T	6	7	13	0	2	15	0	0
14	30989523	.	G	A	2	3	5	2	1	8	0	0
14	30989535	.	A	G	2	4	6	2	1	9	0	0
14	30990436	.	C	A	9	10	19	0	0	19	0	0
14	30991272	.	C	T	0	11	11	0	12	23	0	0
14	30991311	.	A	G	12	9	21	0	1	22	0	0
14	30992515	.	A	T	8	4	12	0	0	12	0	0
14	30992593	.	A	G	1	7	8	0	0	8	0	0
14	31014047	.	G	A	14	14	28	0	1	29	0	0
14	31014113	.	T	A	8	16	24	0	1	25	0	0
14	31024014	.	G	A	9	7	16	0	1	17	0	0
14	31024077	.	C	A	12	6	18	0	0	18	0	0
14	31060036	.	A	C	3	3	6	0	0	6	0	0
14	31060078	.	A	G	3	3	6	0	0	6	0	0
14	31060079	.	G	A	3	3	6	0	0	6	0	0
14	31082249	.	C	T	4	5	9	0	0	9	0	0
14	31082474	.	G	T	4	2	6	0	1	7	0	0
14	31082537	.	C	T	2	2	4	0	0	4	0	0
14	31082569	.	C	T	3	4	7	0	0	7	0	0
14	31082717	.	G	A	5	6	11	0	0	11	0	0
14	31082745	.	A	T	9	8	17	0	0	17	0	0
14	31082857	.	C	T	13	12	25	0	1	26	0	0
14	31083206	.	C	A	8	6	14	0	0	14	0	0
14	31083227	.	G	A	6	6	12	0	1	13	0	0
14	31083242	.	C	A	1	4	5	0	7	12	0	0
14	31087509	.	A	C	1	4	5	0	0	5	0	0
14	31087513	.	A	C	2	4	6	0	0	6	0	0
14	31090935	.	C	T	6	8	14	0	1	15	0	0
14	31091264	.	C	T	2	4	6	0	2	8	0	0
14	31091589	.	T	A	4	8	12	0	0	12	0	0
14	31091757	.	A	G	5	3	8	0	0	8	0	0
14	31092404	.	G	A	3	3	6	0	1	7	0	0
14	31177744	.	T	C	6	0	6	0	5	11	0	0
14	31474255	.	A	G	1	0	1	0	3	4	0	0
14	31474338	.	A	G	2	2	4	0	0	4	0	0
14	31474500	.	G	C	3	3	6	0	0	6	0	0
14	31474700	.	G	T	1	2	3	0	0	3	0	0
14	31474941	.	G	T	5	2	7	0	1	8	0	0
14	31477482	.	A	G	6	9	15	0	0	15	0	0
14	31478444	.	A	T	5	8	13	0	1	14	0	0
14	31479318	.	A	T	2	3	5	0	0	5	0	0
14	31493317	.	C	T	10	8	18	0	1	19	0	0
14	31497559	.	C	T	7	12	19	0	1	20	0	0
14	31498368	.	C	G	8	1	9	0	12	21	0	0
14	31498392	.	G	A	0	10	10	0	7	17	0	0
14	31507444	.	G	A	4	5	9	0	2	11	0	0
14	31510055	.	G	A	0	6	6	0	5	11	0	0
14	31514394	.	G	A	1	4	5	0	11	16	0	0
14	31516765	.	A	T	8	12	20	0	0	20	0	0
14	31518812	.	T	A	7	6	13	0	0	13	0	0
14	31519018	.	A	C	11	6	17	0	0	17	0	0
14	31519213	.	C	T	11	8	19	0	0	19	0	0
14	31519777	.	T	A	7	15	22	0	0	22	0	0
14	31520371	.	A	T	9	6	15	0	0	15	0	0
14	31520590	.	A	G	10	0	10	0	7	17	0	0
14	31520626	.	A	T	6	4	10	0	0	10	0	0
14	31520750	.	T	C	3	8	11	0	1	12	0	0
14	31530046	.	C	T	10	7	17	0	1	18	0	0
14	31530171	.	G	T	12	8	20	0	0	20	0	0
14	31530186	.	A	G	9	12	21	0	0	21	0	0
14	31530421	.	G	A	10	13	23	0	1	24	0	0
14	31530439	.	G	A	16	6	22	0	3	25	0	0
14	31541122	.	A	T	14	13	27	0	0	27	0	0
14	31541318	.	C	T	15	25	40	0	2	42	0	0
14	31544922	.	A	T	8	14	22	0	1	23	0	0
14	31544947	.	C	T	6	17	23	0	1	24	0	0
14	31545181	.	A	T	14	8	22	0	1	23	0	0
14	31545272	.	C	T	12	10	22	0	0	22	0	0
14	31545433	.	A	T	10	8	18	0	0	19	1	0
14	31545794	.	A	G	7	7	14	0	0	14	0	0
14	31545795	.	G	A	7	7	14	0	0	14	0	0
14	31545902	.	T	A	18	12	30	0	0	30	0	0
14	31545919	.	A	T	17	10	27	0	0	27	0	0
14	31546107	.	T	G	9	0	9	0	16	25	0	0
14	31546137	.	T	A	14	16	30	0	0	30	0	0
14	31546320	.	C	T	9	11	20	0	0	20	0	0
14	31551477	.	G	A	7	7	14	1	2	17	0	0
14	31556308	.	G	A	13	10	23	0	0	23	0	0
14	31556326	.	T	C	15	0	15	0	14	29	0	0
14	31556371	.	A	G	14	12	26	0	0	26	0	0
14	31559062	.	A	G	7	6	13	0	0	13	0	0
14	31562713	.	G	A	11	13	24	1	1	26	0	0
14	31587697	.	G	A	3	3	6	0	0	6	0	0
14	31592151	.	G	C	1	3	4	0	0	4	0	0
14	31601268	.	G	T	4	4	8	0	0	8	0	0
14	31601312	.	T	C	3	2	5	0	0	5	0	0
14	31607859	.	A	T	3	7	10	0	0	10	0	0
14	31607860	.	G	A	3	7	10	0	0	10	0	0
14	31607997	.	A	G	1	0	1	0	2	3	0	0
14	31608037	.	G	T	1	5	6	0	0	6	0	0
14	31615629	.	G	A	6	7	13	0	1	14	0	0
14	31615658	.	C	T	8	9	17	0	0	17	0	0
14	31616139	.	G	T	11	24	35	0	5	40	0	0
14	31616151	.	C	T	13	27	40	0	2	42	0	0
14	31635358	.	T	C	7	4	11	0	0	11	0	0
14	31636382	.	T	C	9	4	13	0	1	14	0	0
14	31636502	.	T	G	12	6	18	0	1	19	0	0
14	31641799	.	G	A	1	10	11	0	16	27	0	0
14	31641847	.	A	G	7	8	15	0	0	15	0	0
14	31641886	.	G	A	1	9	10	0	5	15	0	0
14	31641962	.	A	G	9	4	13	0	4	17	0	0
14	31642991	.	C	T	4	5	9	0	0	9	0	0
14	31643177	.	G	A	7	3	10	0	0	10	0	0
14	31643437	.	C	T	6	3	9	0	1	10	0	0
14	31644291	.	C	T	17	13	30	0	0	30	0	0
14	31644520	.	T	G	5	7	12	0	2	14	0	0
14	31644646	.	A	G	7	5	12	3	0	15	0	0
14	31644859	.	T	A	11	6	17	0	1	18	0	0
14	31645022	.	C	T	6	8	14	0	0	14	0	0
14	31645450	.	C	T	2	3	5	0	0	5	0	0
14	31645473	.	C	G	4	2	6	0	0	6	0	0
14	31646016	.	T	A	6	9	15	0	0	15	0	0
14	31646121	.	G	A	9	8	17	0	0	17	0	0
14	31646224	.	G	A	4	14	18	0	1	19	0	0
14	31646275	.	C	A	16	7	23	0	1	24	0	0
14	31646307	.	G	T	8	4	12	0	0	12	0	0
14	31646443	.	A	C	1	4	5	0	0	5	0	0
14	31646650	.	A	G	5	0	5	0	12	17	0	0
14	31646869	.	A	G	6	6	12	2	0	14	0	0
14	31647217	.	A	G	9	7	16	0	0	16	0	0
14	31647730	.	T	C	11	7	18	0	0	18	0	0
14	31647829	.	C	A	6	6	12	0	0	12	0	0
14	31668646	.	G	A	4	7	11	0	0	11	0	0
14	31668719	.	C	T	1	12	13	0	8	21	0	0
14	31668758	.	G	A	8	17	25	1	0	26	0	0
14	31669376	.	T	G	7	5	12	0	0	12	0	0
14	31669377	.	G	T	6	5	11	0	1	12	0	0
14	31669466	.	C	G	15	7	22	0	0	22	0	0
14	31669488	.	A	G	16	10	26	0	0	26	0	0
14	31669551	.	T	C	15	11	26	0	0	26	0	0
14	31669558	.	C	A	14	14	28	0	2	30	0	0
14	31669907	.	A	T	11	8	19	0	0	19	0	0
14	31670364	.	G	A	3	3	6	0	0	6	0	0
14	31670800	.	T	A	6	4	10	0	0	10	0	0
14	31670831	.	T	G	6	3	9	0	0	9	0	0
14	31673856	.	A	C	5	1	6	1	5	12	0	0
14	31677036	.	A	T	6	8	14	0	1	15	0	0
14	31677655	.	C	T	11	8	19	0	2	21	0	0
14	31681840	.	T	G	1	1	2	0	8	10	0	0
14	31777104	.	A	G	0	2	2	0	1	3	0	0
14	31779690	.	G	A	0	5	5	0	2	7	0	0
14	31779785	.	C	T	1	3	4	0	0	4	0	0
14	31779933	.	G	A	0	2	2	0	1	3	0	0
14	31780174	.	T	C	2	1	3	0	0	3	0	0
14	31780186	.	C	A	4	3	7	0	0	7	0	0
14	31780273	.	G	T	0	4	4	0	6	10	0	0
14	31780311	.	A	G	3	0	3	0	5	8	0	0
14	31780398	.	T	A	7	3	10	0	0	10	0	0
14	31799878	.	G	A	3	3	6	0	0	6	0	0
14	31799879	.	A	T	3	3	6	0	0	6	0	0
14	31800090	.	T	C	9	7	16	0	0	16	0	0
14	31800175	.	G	T	9	13	22	0	0	22	0	0
14	31800206	.	T	A	6	11	17	0	0	17	0	0
14	31800870	.	C	G	7	8	15	0	1	16	0	0
14	31801159	.	G	A	5	3	8	0	0	8	0	0
14	31801168	.	A	G	5	3	8	0	0	8	0	0
14	31801454	.	C	T	1	12	13	0	4	17	0	0
14	31802067	.	A	T	12	9	21	0	0	21	0	0
14	31802156	.	T	C	3	3	6	0	2	8	0	0
14	31802541	.	C	A	1	2	3	0	0	3	0	0
14	31803148	.	A	G	3	3	6	0	1	7	0	0
14	31803191	.	T	C	3	0	3	0	2	5	0	0
14	31803337	.	G	A	5	2	7	0	0	7	0	0
14	31806317	.	C	T	7	2	9	0	0	9	0	0
14	31806744	.	G	A	3	4	7	0	0	7	0	0
14	31820008	.	T	A	6	3	9	0	0	9	0	0
14	31822578	.	C	A	0	7	7	0	4	11	0	0
14	31822694	.	C	T	4	9	13	0	0	13	0	0
14	31822751	.	A	G	3	7	10	1	0	11	0	0
14	31860525	.	C	T	16	18	34	0	8	42	0	0
14	31861179	.	A	G	12	15	27	0	2	29	0	0
14	31881728	.	A	G	5	6	11	0	0	11	0	0
14	31881740	.	A	G	5	5	10	0	0	10	0	0
14	31882252	.	C	A	2	5	7	0	0	7	0	0
14	31882268	.	C	A	4	7	11	0	0	11	0	0
14	31882481	.	A	G	1	0	1	0	5	6	0	0
14	31882587	.	T	C	8	8	16	0	1	17	0	0
14	31882656	.	C	T	4	8	12	0	0	12	0	0
14	31882672	.	G	T	9	4	13	0	0	13	0	0
14	31882709	.	A	T	7	4	11	0	0	11	0	0
14	31882714	.	A	T	6	4	10	0	1	11	0	0
14	31882802	.	C	T	3	4	7	0	0	7	0	0
14	31882840	.	A	G	5	0	5	0	3	8	0	0
14	31883231	.	G	C	5	2	7	0	0	7	0	0
14	31883426	.	C	T	3	2	5	0	0	5	0	0
14	31883475	.	A	T	4	5	9	0	0	9	0	0
14	31883519	.	G	C	0	3	3	0	6	9	0	0
14	31883735	.	G	A	1	4	5	0	7	12	0	0
14	31884011	.	T	A	3	3	6	0	0	6	0	0
14	31890334	.	G	A	9	5	14	0	0	14	0	0
14	31890748	.	T	C	4	0	4	0	7	11	0	0
14	31890757	.	C	G	1	5	6	0	4	10	0	0
14	31890817	.	G	A	5	4	9	0	0	9	0	0
14	31890874	.	G	A	5	9	14	0	1	15	0	0
14	31936927	.	G	A	2	8	10	0	0	10	0	0
14	31936928	.	A	G	2	7	9	0	1	10	0	0
14	31936994	.	T	C	2	7	9	0	2	11	0	0
14	31973439	.	C	T	8	4	12	0	0	12	0	0
14	32011929	.	C	G	1	16	17	0	8	25	0	0
14	32013167	.	C	A	2	10	12	0	12	24	0	0
14	32023213	.	T	C	8	3	11	0	0	11	0	0
14	32025381	.	T	C	5	6	11	0	2	13	0	0
14	32025466	.	T	G	4	8	12	0	0	12	0	0
14	32057333	.	G	A	1	2	3	0	6	9	0	0
14	32184469	.	C	T	13	19	32	1	0	33	0	0
14	32184927	.	C	A	23	14	37	0	1	38	0	0
14	32184937	.	C	T	16	19	35	0	0	35	0	0
14	32185036	.	C	A	1	18	19	0	24	43	0	0
14	32185284	.	T	A	5	3	8	0	0	8	0	0
14	32185291	.	C	T	5	4	9	0	0	9	0	0
14	32185374	.	C	T	10	6	16	0	1	17	0	0
14	32254770	.	C	T	4	5	9	0	1	10	0	0
14	32255124	.	C	T	6	4	10	0	0	10	0	0
14	32403754	.	G	A	5	3	8	0	0	8	0	0
14	32443572	.	A	C	8	6	14	0	2	17	1	0
14	32443727	.	C	T	2	8	10	0	9	19	0	0
14	32443811	.	A	C	8	8	16	0	0	16	0	0
14	32444064	.	C	G	8	15	23	0	0	23	0	0
14	32444114	.	C	G	3	13	16	0	0	16	0	0
14	32444168	.	T	G	12	8	20	0	1	21	0	0
14	32444379	.	T	C	5	2	7	0	0	7	0	0
14	32444392	.	C	T	4	4	8	0	0	8	0	0
14	32444496	.	G	T	4	7	11	0	0	11	0	0
14	32444651	.	G	A	8	13	21	0	0	21	0	0
14	32444878	.	C	A	9	8	17	0	0	17	0	0
14	32455602	.	T	C	3	2	5	0	8	13	0	0
14	32475280	.	G	A	6	2	8	0	0	8	0	0
14	32475417	.	T	C	5	5	10	0	0	10	0	0
14	32477810	.	T	C	4	0	4	0	6	10	0	0
14	32479378	.	G	A	3	5	8	0	0	8	0	0
14	32486708	.	T	A	1	2	3	0	1	4	0	0
14	32491026	.	G	A	1	2	3	0	0	3	0	0
14	32515783	.	C	T	7	3	10	0	0	10	0	0
14	32518852	.	G	A	3	6	9	0	0	9	0	0
14	32518873	.	C	T	4	2	6	0	0	6	0	0
14	32524195	.	C	T	6	3	9	0	1	10	0	0
14	32525127	.	G	A	3	6	9	0	0	9	0	0
14	32526271	.	C	T	2	2	4	0	0	4	0	0
14	32526370	.	G	A	4	4	8	0	0	8	0	0
14	32526677	.	A	G	3	7	10	0	1	11	0	0
14	32534834	.	G	A	2	10	12	0	1	13	0	0
14	32549257	.	G	A	5	5	10	0	0	10	0	0
14	32549305	.	G	A	3	3	6	0	1	7	0	0
14	32631370	.	T	C	3	3	6	0	0	6	0	0
14	32631384	.	C	T	0	3	3	0	3	6	0	0
14	32943224	.	C	A	4	3	7	0	0	7	0	0
14	32945536	.	C	T	2	6	8	0	0	8	0	0
14	32952180	.	T	A	2	6	8	0	1	9	0	0
14	32952467	.	C	T	9	9	18	0	0	18	0	0
14	32952493	.	G	A	7	5	12	0	3	15	0	0
14	32952606	.	C	T	1	4	5	0	11	16	0	0
14	32952665	.	C	T	0	4	4	0	5	9	0	0
14	32952825	.	C	T	0	7	7	0	7	14	0	0
14	32952857	.	T	A	6	5	11	0	1	12	0	0
14	32953035	.	T	C	3	4	7	0	1	8	0	0
14	32984047	.	G	A	6	6	12	0	0	12	0	0
14	32984128	.	C	A	15	7	22	0	0	22	0	0
14	32984139	.	A	C	8	12	20	0	0	20	0	0
14	32984239	.	G	A	5	8	13	0	0	13	0	0
14	32984574	.	T	C	2	4	6	0	0	6	0	0
14	32984675	.	A	T	7	3	10	0	0	10	0	0
14	32984958	.	A	C	1	2	3	0	0	3	0	0
14	32985012	.	T	C	3	3	6	0	1	7	0	0
14	32994966	.	G	A	4	3	7	0	0	7	0	0
14	32995014	.	C	T	0	2	2	0	1	3	0	0
14	33071522	.	A	G	18	15	33	0	11	44	0	0
14	33071814	.	G	A	20	22	42	0	0	42	0	0
14	33073954	.	G	A	15	17	32	0	2	34	0	0
14	33120461	.	G	A	14	13	27	0	1	28	0	0
14	33120875	.	A	G	17	21	38	0	3	41	0	0
14	33177681	.	A	G	9	14	23	0	1	24	0	0
14	33177949	.	G	C	12	0	12	0	13	25	0	0
14	33264600	.	A	C	3	2	5	0	2	7	0	0
14	33268211	.	T	A	10	4	14	0	1	15	0	0
14	33268219	.	A	G	6	9	15	0	1	16	0	0
14	33268254	.	C	A	6	11	17	0	1	18	0	0
14	33268297	.	T	C	8	8	16	0	1	17	0	0
14	33268330	.	C	A	7	6	13	0	1	14	0	0
14	33268388	.	A	G	9	0	9	0	6	15	0	0
14	33270733	.	G	C	1	2	3	0	0	3	0	0
14	33270750	.	T	C	0	2	2	0	1	3	0	0
14	33280738	.	C	T	3	2	5	0	0	5	0	0
14	33280818	.	C	T	15	18	33	0	0	33	0	0
14	33281240	.	T	A	31	20	51	0	2	53	0	0
14	33281690	.	A	G	19	11	30	0	2	32	0	0
14	33281777	.	C	T	2	11	13	0	13	26	0	0
14	33281816	.	C	T	2	23	25	0	16	41	0	0
14	33281856	.	T	A	19	30	49	0	1	50	0	0
14	33281964	.	T	C	17	19	36	0	0	36	0	0
14	33282050	.	C	T	22	21	43	0	3	46	0	0
14	33288448	.	A	G	31	26	57	0	2	59	0	0
14	33297882	.	A	T	14	10	24	0	2	26	0	0
14	33298098	.	C	A	15	15	30	1	1	32	0	0
14	33298397	.	T	C	10	16	26	0	1	27	0	0
14	33298436	.	C	T	13	17	30	0	1	31	0	0
14	33298637	.	C	T	23	24	47	0	2	49	0	0
14	33302331	.	G	A	3	7	10	0	0	10	0	0
14	33302381	.	G	A	4	3	7	0	0	7	0	0
14	33302416	.	A	T	4	4	8	0	0	8	0	0
14	33302745	.	T	C	10	4	14	0	0	14	0	0
14	33306505	.	C	T	23	28	51	0	0	51	0	0
14	33307831	.	C	T	24	27	51	0	2	53	0	0
14	33308039	.	A	G	26	27	53	0	4	57	0	0
14	33308120	.	G	A	25	21	46	0	4	50	0	0
14	33330644	.	T	A	1	2	3	0	0	3	0	0
14	33331072	.	T	A	2	2	4	0	0	4	0	0
14	33333741	.	A	G	25	42	67	2	4	73	0	0
14	33333986	.	G	A	15	24	39	0	1	40	0	0
14	33339472	.	T	C	3	4	7	0	0	7	0	0
14	33339761	.	G	C	7	2	9	0	1	10	0	0
14	33340099	.	C	T	4	9	13	0	0	13	0	0
14	33414015	.	G	T	2	2	4	0	0	4	0	0
14	33414060	.	G	C	2	5	7	0	2	9	0	0
14	33414105	.	T	A	14	18	32	0	2	34	0	0
14	33414590	.	G	A	16	5	21	0	5	26	0	0
14	33414596	.	C	T	16	5	21	0	1	22	0	0
14	33414707	.	C	T	19	4	23	0	0	23	0	0
14	33414894	.	C	T	2	21	23	0	0	23	0	0
14	33419714	.	G	A	22	20	42	0	2	44	0	0
14	33423037	.	C	T	4	11	15	0	0	15	0	0
14	33424626	.	T	C	22	17	39	0	0	39	0	0
14	33424869	.	C	T	25	19	44	0	2	46	0	0
14	33424931	.	T	C	28	23	51	0	1	52	0	0
14	33425013	.	C	T	1	22	23	0	11	34	0	0
14	33431674	.	G	A	1	2	3	0	0	3	0	0
14	33431815	.	A	C	3	4	7	0	1	8	0	0
14	33431823	.	C	A	3	4	7	0	1	8	0	0
14	33432060	.	C	T	6	2	8	0	0	8	0	0
14	33432078	.	G	A	0	6	6	0	4	10	0	0
14	33432594	.	T	G	6	0	6	0	6	12	0	0
14	33433589	.	C	G	4	2	6	0	0	6	0	0
14	33434018	.	A	T	5	4	9	0	0	9	0	0
14	33434076	.	A	T	3	7	10	0	0	10	0	0
14	33434218	.	G	A	2	3	5	0	0	5	0	0
14	33434940	.	G	A	5	4	9	0	0	9	0	0
14	33435384	.	G	A	10	5	15	0	0	15	0	0
14	33435415	.	A	G	8	2	10	0	10	20	0	0
14	33435460	.	G	T	7	12	19	0	1	20	0	0
14	33435598	.	C	T	7	8	15	0	0	15	0	0
14	33435768	.	C	A	2	3	5	0	0	5	0	0
14	33436514	.	G	A	12	14	26	0	2	28	0	0
14	33437009	.	G	T	22	12	34	0	1	35	0	0
14	33437056	.	C	A	16	18	34	0	1	35	0	0
14	33441928	.	C	T	25	30	55	0	2	57	0	0
14	33442006	.	A	G	34	29	63	0	0	63	0	0
14	33442069	.	C	T	25	21	46	0	3	49	0	0
14	33454561	.	T	C	22	1	23	0	18	41	0	0
14	33454570	.	C	T	2	19	21	0	23	44	0	0
14	33469026	.	C	A	29	24	53	0	3	56	0	0
14	33469094	.	T	A	29	27	56	0	1	58	1	0
14	33469177	.	C	A	19	13	32	0	1	33	0	0
14	33469180	.	A	G	19	1	20	0	12	32	0	0
14	33469241	.	A	G	18	0	18	0	13	31	0	0
14	33469268	.	A	G	21	12	33	0	0	33	0	0
14	33469356	.	C	T	18	10	28	0	0	28	0	0
14	33469636	.	A	G	5	6	11	0	0	11	0	0
14	33474119	.	C	A	3	3	6	0	0	6	0	0
14	33474168	.	G	A	4	2	6	0	0	6	0	0
14	33474745	.	T	C	15	0	15	0	11	26	0	0
14	33474762	.	G	C	13	10	23	0	0	23	0	0
14	33474869	.	A	C	13	0	13	0	6	19	0	0
14	33475273	.	G	C	6	7	13	0	0	13	0	0
14	33475445	.	A	C	5	4	9	0	0	9	0	0
14	33475767	.	C	T	11	2	13	0	0	13	0	0
14	33486539	.	A	C	13	7	20	0	0	20	0	0
14	33486543	.	C	G	12	7	19	0	2	21	0	0
14	33487022	.	A	T	8	5	13	0	0	13	0	0
14	33497008	.	C	T	11	6	17	0	1	18	0	0
14	33498960	.	G	A	10	10	20	0	0	20	0	0
14	33499239	.	A	T	11	7	18	0	0	18	0	0
14	33501772	.	C	A	15	9	24	0	0	24	0	0
14	33504633	.	C	A	11	13	24	0	2	26	0	0
14	33505055	.	G	C	12	14	26	0	1	27	0	0
14	33507743	.	C	T	17	11	28	0	0	28	0	0
14	33515838	.	A	G	1	2	3	0	0	3	0	0
14	33515983	.	C	T	3	12	15	0	0	15	0	0
14	33516015	.	G	A	6	9	15	0	2	17	0	0
14	33516131	.	A	G	9	8	17	1	0	18	0	0
14	33516218	.	G	C	4	0	4	0	3	7	0	0
14	33516237	.	C	T	6	5	11	0	1	12	0	0
14	33516603	.	T	C	9	0	9	0	5	14	0	0
14	33516619	.	A	G	8	4	12	0	0	12	0	0
14	33516706	.	T	C	11	1	12	0	3	15	0	0
14	33516905	.	G	A	5	3	8	0	0	8	0	0
14	33517203	.	A	C	3	4	7	0	0	7	0	0
14	33517333	.	T	C	3	3	6	0	0	6	0	0
14	33517334	.	T	A	3	3	6	0	0	6	0	0
14	33517377	.	G	C	7	5	12	0	0	12	0	0
14	33517654	.	C	A	5	4	9	0	0	9	0	0
14	33517746	.	C	T	6	3	9	0	0	9	0	0
14	33518128	.	C	T	5	2	7	0	0	7	0	0
14	33518164	.	C	G	2	4	6	0	0	6	0	0
14	33518323	.	G	A	3	5	8	0	0	8	0	0
14	33518341	.	G	A	2	3	5	0	1	6	0	0
14	33518461	.	A	G	2	2	4	0	0	4	0	0
14	33518679	.	A	G	2	3	5	0	0	5	0	0
14	33518722	.	A	G	9	4	13	0	0	13	0	0
14	33525236	.	C	T	10	7	17	0	2	19	0	0
14	33525250	.	A	T	8	10	18	0	1	19	0	0
14	33549786	.	G	A	7	5	12	0	1	13	0	0
14	33554764	.	C	T	7	8	15	0	0	15	0	0
14	33564916	.	C	T	21	17	38	0	3	41	0	0
14	33564994	.	A	G	13	17	30	0	0	30	0	0
14	33565054	.	C	A	11	13	24	0	5	29	0	0
14	33565209	.	C	T	19	7	26	0	0	26	0	0
14	33565794	.	A	C	5	7	12	0	1	13	0	0
14	33566128	.	A	G	10	3	13	0	0	13	0	0
14	33566515	.	G	A	1	18	19	0	11	30	0	0
14	33566542	.	A	T	14	14	28	0	2	30	0	0
14	33566578	.	G	C	18	7	25	0	0	25	0	0
14	33566613	.	G	A	13	9	22	0	0	22	0	0
14	33566617	.	C	T	7	13	20	0	1	21	0	0
14	33566651	.	A	G	12	7	19	0	6	25	0	0
14	33566744	.	G	T	11	11	22	0	1	23	0	0
14	33566945	.	C	T	18	12	30	0	6	36	0	0
14	33567023	.	T	A	14	11	25	0	0	25	0	0
14	33567024	.	T	A	14	11	25	0	0	25	0	0
14	33567085	.	A	G	7	5	12	0	0	12	0	0
14	33567261	.	A	G	1	2	3	0	0	3	0	0
14	33591985	.	T	A	4	3	7	0	1	8	0	0
14	33592099	.	T	C	4	2	6	0	0	6	0	0
14	33599034	.	T	C	1	0	1	0	3	4	0	0
14	33754549	.	G	A	16	14	30	0	0	30	0	0
14	33754581	.	C	T	9	17	26	0	1	27	0	0
14	33754587	.	C	T	9	15	24	0	2	26	0	0
14	33754710	.	T	G	18	14	32	0	1	33	0	0
14	33755677	.	C	A	21	23	44	0	1	45	0	0
14	33755810	.	A	C	41	9	50	0	3	53	0	0
14	33755813	.	C	A	25	18	43	0	5	48	0	0
14	33755847	.	T	C	26	18	44	0	4	48	0	0
14	33756950	.	G	A	16	25	41	1	1	43	0	0
14	33757152	.	A	C	21	33	54	0	2	56	0	0
14	33826267	.	A	T	5	7	12	0	0	12	0	0
14	33826491	.	T	G	7	6	13	0	1	14	0	0
14	33826580	.	T	A	8	6	14	1	1	16	0	0
14	33826655	.	T	G	9	8	17	0	0	17	0	0
14	33826682	.	G	A	8	8	16	0	0	16	0	0
14	33826707	.	C	T	1	4	5	0	10	15	0	0
14	33826767	.	T	A	15	9	24	0	1	25	0	0
14	33826827	.	C	T	12	3	15	0	1	16	0	0
14	33827434	.	T	C	6	2	8	0	0	8	0	0
14	33827532	.	T	C	5	5	10	0	0	10	0	0
14	33827698	.	A	T	9	9	18	0	2	20	0	0
14	33827732	.	C	A	9	9	18	0	0	18	0	0
14	33827771	.	G	A	7	7	14	0	1	15	0	0
14	33827791	.	A	T	9	7	16	0	1	17	0	0
14	33827869	.	C	A	8	5	13	0	0	13	0	0
14	33827903	.	C	T	0	6	6	0	8	14	0	0
14	33827940	.	C	A	8	5	13	0	0	13	0	0
14	33827966	.	T	A	6	7	13	0	0	13	0	0
14	33828707	.	C	T	10	7	17	0	0	17	0	0
14	33828919	.	A	G	2	6	8	0	0	8	0	0
14	33829143	.	C	T	1	9	10	0	16	26	0	0
14	33830689	.	G	A	7	10	17	0	2	19	0	0
14	33835891	.	C	T	7	6	13	0	0	13	0	0
14	33838587	.	T	C	4	9	13	0	0	13	0	0
14	33838779	.	T	G	2	6	8	0	1	9	0	0
14	33838806	.	C	G	6	4	10	0	0	10	0	0
14	33842685	.	A	T	1	4	5	0	0	5	0	0
14	33842968	.	G	A	6	3	9	0	0	9	0	0
14	33843449	.	A	T	5	2	7	0	0	7	0	0
14	33847307	.	C	T	0	5	5	0	2	7	0	0
14	33848540	.	C	A	3	6	9	0	0	9	0	0
14	33848593	.	C	T	3	5	8	0	0	8	0	0
14	33850298	.	C	T	0	3	3	0	5	8	0	0
14	33860183	.	G	C	8	5	13	0	0	13	0	0
14	33860250	.	T	A	13	8	21	0	0	21	0	0
14	33860262	.	C	T	2	13	15	0	7	22	0	0
14	33860372	.	T	C	16	11	27	0	2	29	0	0
14	33860567	.	C	A	22	23	45	0	1	46	0	0
14	33864388	.	G	A	23	15	38	0	3	41	0	0
14	33865764	.	C	T	19	11	30	0	2	32	0	0
14	33865954	.	C	T	22	7	29	0	3	32	0	0
14	33866024	.	T	C	25	13	38	0	1	39	0	0
14	33872095	.	G	C	9	5	14	0	0	14	0	0
14	33883119	.	G	A	0	7	7	0	14	21	0	0
14	33883120	.	A	C	12	8	20	0	1	21	0	0
14	33883167	.	A	C	10	3	13	0	4	17	0	0
14	33883191	.	T	A	2	10	12	0	1	13	0	0
14	33889544	.	T	C	10	7	17	0	1	18	0	0
14	33891711	.	G	A	0	27	27	0	17	44	0	0
14	33891981	.	A	T	6	9	15	0	0	15	0	0
14	33892126	.	A	T	18	9	27	0	1	28	0	0
14	33892388	.	A	G	7	1	8	0	3	11	0	0
14	33892501	.	C	T	14	14	28	0	0	28	0	0
14	33893406	.	G	A	10	3	13	0	0	13	0	0
14	33894793	.	A	C	4	4	8	0	0	8	0	0
14	33894794	.	G	T	4	4	8	0	0	8	0	0
14	33899145	.	T	A	5	7	12	0	0	12	0	0
14	33899178	.	T	G	3	7	10	0	0	10	0	0
14	33899786	.	G	A	7	18	25	0	3	28	0	0
14	33899912	.	C	A	3	16	19	0	20	39	0	0
14	33900150	.	A	C	20	17	37	0	1	38	0	0
14	33900155	.	T	C	21	1	22	0	15	37	0	0
14	33900229	.	C	A	13	13	26	1	0	27	0	0
14	33900278	.	A	C	11	3	14	0	0	14	0	0
14	33900289	.	C	T	10	6	16	0	2	18	0	0
14	33900561	.	T	A	18	15	33	0	1	34	0	0
14	33900575	.	A	T	18	14	32	0	1	33	0	0
14	33900611	.	G	A	26	14	40	0	0	40	0	0
14	33900663	.	T	A	24	16	40	0	0	40	0	0
14	33900955	.	A	T	9	25	34	0	0	34	0	0
14	33901129	.	C	T	20	8	28	3	5	36	0	0
14	33901267	.	C	A	22	9	31	0	0	31	0	0
14	33901293	.	A	C	20	16	36	0	0	36	0	0
14	33901445	.	T	G	7	13	20	0	1	21	0	0
14	33901591	.	T	C	12	7	19	0	2	21	0	0
14	33901704	.	G	A	23	9	32	1	1	34	0	0
14	33901766	.	G	C	15	12	27	0	1	28	0	0
14	33901790	.	C	G	4	13	17	0	13	30	0	0
14	33901807	.	A	G	15	11	26	0	1	27	0	0
14	33901865	.	C	A	16	16	32	0	1	33	0	0
14	33901907	.	G	A	18	16	34	0	0	34	0	0
14	33901946	.	A	T	8	15	23	0	0	23	0	0
14	33901957	.	C	A	14	9	23	0	0	23	0	0
14	33901993	.	G	A	12	9	21	0	1	22	0	0
14	33902094	.	G	A	21	13	34	0	2	36	0	0
14	33903090	.	G	A	14	13	27	0	0	27	0	0
14	33909978	.	C	T	11	13	24	0	0	24	0	0
14	33916050	.	A	G	6	13	19	0	1	20	0	0
14	33916539	.	G	A	19	11	30	0	0	30	0	0
14	33936378	.	T	A	13	14	27	0	1	28	0	0
14	33936502	.	A	G	10	8	18	0	1	19	0	0
14	33941266	.	G	A	11	4	15	0	0	15	0	0
14	33941274	.	T	C	9	3	12	0	1	13	0	0
14	33941436	.	C	T	1	2	3	0	6	9	0	0
14	33941519	.	G	A	6	4	10	0	1	11	0	0
14	33943652	.	G	A	2	3	5	0	0	5	0	0
14	33945059	.	T	G	2	5	7	0	0	7	0	0
14	33945285	.	C	A	3	3	6	0	0	6	0	0
14	33945303	.	T	A	2	3	5	0	0	5	0	0
14	33983966	.	G	A	30	32	62	0	0	62	0	0
14	33984308	.	A	T	10	14	24	0	6	36	6	0
14	33984436	.	A	T	14	13	27	0	0	27	0	0
14	33984610	.	A	G	30	22	52	0	1	53	0	0
14	33989580	.	G	A	19	25	44	0	2	46	0	0
14	33991784	.	G	A	27	13	40	2	0	42	0	0
14	33991799	.	G	T	29	10	39	2	4	45	0	0
14	33997606	.	G	A	14	14	28	0	3	31	0	0
14	33997681	.	G	A	16	12	28	0	2	30	0	0
14	33997861	.	A	G	12	14	26	0	0	26	0	0
14	33997873	.	G	A	15	14	29	0	0	29	0	0
14	33998078	.	G	A	18	16	34	1	0	35	0	0
14	33998090	.	A	G	16	18	34	0	0	34	0	0
14	34002325	.	G	A	11	9	20	0	0	20	0	0
14	34002571	.	T	A	24	15	39	0	0	39	0	0
14	34013110	.	A	G	5	10	15	0	0	15	0	0
14	34044318	.	C	T	3	12	15	0	20	35	0	0
14	34064401	.	G	A	11	9	20	0	0	20	0	0
14	34065115	.	A	T	12	8	20	0	0	20	0	0
14	34065244	.	A	G	6	11	17	0	2	19	0	0
14	34065442	.	A	G	11	10	21	0	1	22	0	0
14	34065586	.	G	A	8	7	15	0	0	15	0	0
14	34065596	.	T	G	5	5	10	0	0	10	0	0
14	34065785	.	G	A	10	4	14	0	0	15	1	0
14	34068458	.	C	T	8	7	15	0	1	16	0	0
14	34068760	.	G	A	14	13	27	0	0	27	0	0
14	34075094	.	T	G	11	0	11	0	15	26	0	0
14	34077401	.	C	A	14	13	27	0	0	27	0	0
14	34082694	.	T	A	9	18	27	0	0	27	0	0
14	34089508	.	A	G	20	2	22	0	9	31	0	0
14	34089559	.	C	A	12	9	21	0	1	22	0	0
14	34089597	.	T	C	7	10	17	0	1	18	0	0
14	34089636	.	A	G	9	0	9	0	11	20	0	0
14	34089653	.	G	A	9	13	22	0	0	22	0	0
14	34089676	.	C	T	13	14	27	0	0	27	0	0
14	34089707	.	T	C	9	13	22	0	1	23	0	0
14	34090034	.	A	T	5	11	16	0	0	16	0	0
14	34090093	.	A	C	12	11	23	1	0	24	0	0
14	34090169	.	T	C	7	10	17	0	0	17	0	0
14	34090228	.	G	A	14	6	20	0	1	21	0	0
14	34090248	.	C	G	15	9	24	0	1	25	0	0
14	34090315	.	T	G	18	9	27	0	1	28	0	0
14	34090342	.	G	A	15	7	22	0	2	24	0	0
14	34090422	.	A	G	13	4	17	0	1	18	0	0
14	34090647	.	G	A	0	13	13	0	17	30	0	0
14	34090784	.	A	T	7	5	12	0	0	12	0	0
14	34090822	.	A	G	3	2	5	0	0	5	0	0
14	34091123	.	G	T	4	9	13	0	0	13	0	0
14	34091238	.	C	A	16	15	31	0	0	31	0	0
14	34091423	.	C	T	10	12	22	0	0	22	0	0
14	34091461	.	G	T	14	10	24	0	0	24	0	0
14	34091717	.	T	G	12	15	27	0	1	28	0	0
14	34091787	.	T	A	11	17	28	0	0	28	0	0
14	34092369	.	C	T	9	17	26	1	0	27	0	0
14	34092507	.	T	G	13	11	24	0	1	25	0	0
14	34125983	.	T	A	1	3	4	0	1	5	0	0
14	34126353	.	A	T	34	18	52	0	1	53	0	0
14	34127925	.	T	A	13	6	19	0	1	20	0	0
14	34128023	.	C	T	7	3	10	0	0	10	0	0
14	34128066	.	T	A	2	4	6	0	0	6	0	0
14	34128223	.	C	A	3	3	6	0	0	6	0	0
14	34128399	.	A	C	15	15	30	0	1	31	0	0
14	34128477	.	A	C	16	0	16	0	15	31	0	0
14	34128528	.	C	T	9	17	26	0	0	26	0	0
14	34128744	.	G	A	5	18	23	0	2	25	0	0
14	34128796	.	G	T	14	10	24	0	0	24	0	0
14	34128799	.	C	T	0	13	13	0	11	24	0	0
14	34129092	.	C	T	0	8	8	0	7	15	0	0
14	34129433	.	T	G	8	12	20	0	0	20	0	0
14	34129502	.	G	T	12	14	26	0	1	27	0	0
14	34129644	.	T	A	5	8	13	0	2	15	0	0
14	34129724	.	C	T	12	10	22	0	0	22	0	0
14	34129780	.	T	C	11	9	20	0	0	20	0	0
14	34129822	.	A	G	8	6	14	0	0	14	0	0
14	34129848	.	G	A	6	5	11	0	0	11	0	0
14	34129878	.	A	G	4	5	9	0	0	9	0	0
14	34129937	.	G	A	10	10	20	0	1	21	0	0
14	34129946	.	G	A	12	10	22	1	0	23	0	0
14	34130042	.	A	G	1	5	6	5	0	11	0	0
14	34130372	.	C	T	1	4	5	0	3	8	0	0
14	34130458	.	G	A	2	3	5	0	0	5	0	0
14	34130548	.	G	A	3	2	5	0	0	5	0	0
14	34130690	.	C	T	6	3	9	0	1	10	0	0
14	34131056	.	T	C	14	12	26	0	2	28	0	0
14	34139713	.	G	A	10	8	18	0	0	18	0	0
14	34154746	.	C	T	3	9	12	0	8	20	0	0
14	34180461	.	A	G	4	5	9	0	0	9	0	0
14	34180491	.	G	A	4	6	10	0	0	10	0	0
14	34180530	.	T	C	8	0	8	0	8	16	0	0
14	34180557	.	T	G	8	6	14	0	0	14	0	0
14	34191157	.	G	A	9	3	12	0	1	13	0	0
14	34194564	.	A	G	5	7	12	0	0	12	0	0
14	34195879	.	C	T	0	8	8	0	8	16	0	0
14	34210820	.	G	A	4	7	11	0	0	11	0	0
14	34210874	.	C	A	0	9	9	0	2	11	0	0
14	34210898	.	C	T	3	5	8	0	0	8	0	0
14	34240889	.	C	T	6	2	8	0	1	9	0	0
14	34486720	.	A	G	10	0	10	0	15	25	0	0
14	34487972	.	C	T	33	49	82	0	1	83	0	0
14	34488456	.	T	C	12	15	27	0	2	29	0	0
14	34488655	.	A	G	27	15	42	0	5	47	0	0
14	34488687	.	C	A	23	17	40	0	4	44	0	0
14	34488787	.	G	T	41	15	56	0	2	58	0	0
14	34488819	.	C	A	34	10	44	0	1	45	0	0
14	34488929	.	C	T	5	3	8	0	0	8	0	0
14	34550829	.	C	T	5	3	8	0	0	8	0	0
14	34553535	.	G	A	1	2	3	0	0	3	0	0
14	34556758	.	C	T	4	9	13	0	0	13	0	0
14	34556986	.	C	T	12	6	18	0	0	18	0	0
14	34566932	.	C	T	1	2	3	0	0	3	0	0
14	34634788	.	G	A	5	2	7	0	0	7	0	0
14	34635347	.	T	C	2	0	2	0	4	6	0	0
14	34637134	.	A	T	5	9	14	0	0	14	0	0
14	34648339	.	C	A	3	4	7	0	0	7	0	0
14	34657047	.	G	A	5	2	7	0	0	7	0	0
14	34658139	.	G	T	2	2	4	0	1	5	0	0
14	34672611	.	C	T	6	2	8	0	0	8	0	0
14	34787870	.	G	T	1	3	4	0	0	4	0	0
14	34790404	.	A	G	1	4	5	0	1	6	0	0
14	34790762	.	G	A	0	2	2	0	2	4	0	0
14	34791301	.	T	C	2	4	6	0	1	7	0	0
14	34794940	.	A	T	1	4	5	0	0	5	0	0
14	34797681	.	G	T	4	6	10	0	0	10	0	0
14	34797711	.	T	C	9	6	15	0	0	15	0	0
14	34797810	.	C	A	7	3	10	0	1	11	0	0
14	34797972	.	C	T	8	3	11	0	1	12	0	0
14	34798017	.	C	T	7	3	10	0	0	10	0	0
14	34798031	.	C	T	7	2	9	0	0	9	0	0
14	34825745	.	T	C	3	8	11	0	0	11	0	0
14	34825761	.	A	G	2	7	9	0	0	9	0	0
14	34826842	.	A	C	2	2	4	0	0	4	0	0
14	34826860	.	T	A	2	2	4	0	0	4	0	0
14	34826951	.	T	A	3	5	8	0	0	8	0	0
14	34828113	.	G	T	6	5	11	0	0	11	0	0
14	35003880	.	C	T	8	10	18	0	0	18	0	0
14	35008665	.	C	T	8	6	14	0	0	14	0	0
14	35008780	.	T	A	8	7	15	0	0	15	0	0
14	35008804	.	T	C	7	9	16	0	1	17	0	0
14	35008885	.	G	A	4	5	9	0	0	9	0	0
14	35008887	.	C	A	4	5	9	0	0	9	0	0
14	35008974	.	T	G	3	3	6	0	1	7	0	0
14	35009182	.	T	A	2	5	7	0	0	7	0	0
14	35009326	.	C	T	5	4	9	0	0	9	0	0
14	35009651	.	T	C	19	16	35	0	3	38	0	0
14	35009652	.	G	T	21	17	38	0	1	39	0	0
14	35009736	.	A	T	8	21	29	1	4	34	0	0
14	35009739	.	A	G	9	23	32	1	0	33	0	0
14	35010026	.	A	T	9	11	20	0	1	21	0	0
14	35010230	.	C	T	13	7	20	0	3	23	0	0
14	35010236	.	A	T	15	11	26	0	0	26	0	0
14	35010936	.	T	A	8	4	12	0	0	12	0	0
14	35011140	.	G	A	8	4	12	0	4	16	0	0
14	35011174	.	C	T	11	5	16	0	0	16	0	0
14	35011195	.	A	T	10	2	12	0	1	13	0	0
14	35011213	.	A	T	11	4	15	0	0	15	0	0
14	35011301	.	C	T	14	5	19	0	0	19	0	0
14	35011398	.	G	T	8	5	13	0	0	13	0	0
14	35011570	.	C	T	12	14	26	0	1	27	0	0
14	35011857	.	G	A	15	9	24	0	0	24	0	0
14	35011944	.	G	A	10	12	22	0	1	23	0	0
14	35024387	.	G	A	0	3	3	0	4	7	0	0
14	35025428	.	C	T	3	4	7	0	0	7	0	0
14	35227456	.	C	T	7	4	11	1	0	12	0	0
14	35246469	.	G	A	0	3	3	0	4	7	0	0
14	35246495	.	G	A	1	2	3	0	1	4	0	0
14	35377690	.	T	C	0	2	2	0	1	3	0	0
14	35387478	.	T	C	5	5	10	0	0	10	0	0
14	35387769	.	G	A	2	2	4	0	0	4	0	0
14	35393022	.	G	A	3	3	6	0	0	6	0	0
14	35393061	.	G	C	1	2	3	0	0	3	0	0
14	35400356	.	T	C	3	3	6	0	0	6	0	0
14	35407463	.	A	C	2	7	9	0	0	9	0	0
14	35407835	.	A	G	1	4	5	0	0	5	0	0
14	35408040	.	T	C	1	1	2	0	1	3	0	0
14	35409510	.	A	G	6	2	8	0	0	8	0	0
14	35409635	.	G	C	7	0	7	0	3	10	0	0
14	35409643	.	A	G	6	3	9	0	0	9	0	0
14	35409838	.	A	T	5	6	11	0	1	12	0	0
14	35409903	.	A	T	2	7	9	0	0	9	0	0
14	35410583	.	G	A	10	13	23	0	1	24	0	0
14	35410992	.	G	A	6	8	14	0	0	14	0	0
14	35411076	.	C	T	9	4	13	0	0	13	0	0
14	35414291	.	A	T	1	2	3	0	0	3	0	0
14	35418290	.	A	C	4	1	5	0	0	5	0	0
14	35418300	.	C	A	4	2	6	0	0	6	0	0
14	35422383	.	G	A	1	5	6	0	0	6	0	0
14	35422417	.	T	C	3	2	5	0	0	5	0	0
14	35478466	.	G	A	1	5	6	0	4	10	0	0
14	35495820	.	T	C	3	3	6	1	0	7	0	0
14	35500249	.	G	T	14	14	28	0	0	28	0	0
14	35500300	.	A	C	14	0	14	0	7	21	0	0
14	35505312	.	C	A	0	8	8	0	14	22	0	0
14	35505376	.	C	A	9	11	20	0	0	20	0	0
14	35692149	.	A	G	21	17	38	0	0	38	0	0
14	35699039	.	G	A	22	12	34	0	1	35	0	0
14	35699109	.	C	A	13	16	29	0	1	30	0	0
14	35715815	.	T	C	21	12	33	0	1	34	0	0
14	35719354	.	G	A	17	21	38	0	0	38	0	0
14	35731558	.	C	T	29	30	59	0	2	61	0	0
14	35732110	.	C	T	14	14	28	0	1	29	0	0
14	35732189	.	C	T	2	2	4	0	1	5	0	0
14	35732195	.	C	T	2	2	4	0	0	4	0	0
14	35780186	.	G	A	0	18	18	0	18	36	0	0
14	35780249	.	G	A	12	13	25	0	1	26	0	0
14	35796120	.	C	T	12	19	31	0	4	35	0	0
14	35797645	.	T	A	19	17	36	0	1	38	1	0
14	35797654	.	G	A	1	14	15	0	25	40	0	0
14	35799400	.	G	A	13	20	33	0	2	35	0	0
14	35799409	.	C	T	11	22	33	0	2	35	0	0
14	35800228	.	T	C	18	15	33	0	0	33	0	0
14	35804592	.	T	C	27	27	54	0	1	55	0	0
14	35804688	.	G	A	24	22	46	0	1	47	0	0
14	35804833	.	A	G	22	15	37	1	1	39	0	0
14	35811971	.	C	T	30	27	57	0	3	60	0	0
14	35812355	.	G	A	28	26	54	0	3	57	0	0
14	35812718	.	C	A	26	20	46	0	6	52	0	0
14	35813367	.	C	A	32	24	56	0	4	60	0	0
14	35813384	.	G	A	2	29	31	0	33	64	0	0
14	35813407	.	C	T	31	34	65	0	4	69	0	0
14	35813424	.	C	T	32	33	65	0	2	67	0	0
14	35813479	.	T	A	28	20	48	0	2	50	0	0
14	35895960	.	C	A	1	3	4	0	1	5	0	0
14	35895983	.	G	A	4	2	6	0	0	6	0	0
14	35896005	.	T	C	3	3	6	0	0	6	0	0
14	35896106	.	A	G	5	5	10	0	0	10	0	0
14	35897751	.	A	T	2	4	6	0	0	6	0	0
14	35900037	.	C	T	5	2	7	0	0	7	0	0
14	35905907	.	T	C	1	4	5	0	0	5	0	0
14	35906312	.	T	C	6	3	9	1	0	10	0	0
14	35906345	.	C	A	2	4	6	0	0	6	0	0
14	35906399	.	A	G	1	3	4	0	0	4	0	0
14	36229211	.	T	A	3	6	9	0	0	9	0	0
14	36229227	.	T	G	5	5	10	0	0	10	0	0
14	36246854	.	C	T	17	16	33	0	0	33	0	0
14	36259377	.	G	A	0	10	10	0	18	28	0	0
14	36267395	.	C	A	18	27	45	0	1	46	0	0
14	36268152	.	C	T	15	9	24	0	0	24	0	0
14	36268339	.	C	T	12	14	26	0	1	27	0	0
14	36268424	.	T	C	3	6	9	0	0	9	0	0
14	36268426	.	T	C	15	9	24	0	0	24	0	0
14	36329525	.	G	A	1	3	4	0	0	4	0	0
14	36329549	.	C	T	1	2	3	0	0	3	0	0
14	36329753	.	G	A	2	2	4	0	0	4	0	0
14	36332527	.	G	C	3	0	3	0	2	5	0	0
14	36348793	.	A	G	7	18	25	0	0	26	1	0
14	36348878	.	G	A	13	31	44	0	1	45	0	0
14	36349387	.	A	T	30	42	72	0	8	80	0	0
14	36349409	.	A	G	29	35	64	0	16	80	0	0
14	36349607	.	C	G	7	36	43	0	37	80	0	0
14	36350639	.	G	T	36	26	62	0	4	66	0	0
14	36350669	.	T	C	30	1	31	0	31	62	0	0
14	36350917	.	A	T	32	36	68	0	0	68	0	0
14	36350932	.	T	A	38	26	64	0	3	67	0	0
14	36350980	.	T	C	35	0	35	1	26	62	0	0
14	36351004	.	C	T	23	39	62	1	2	67	2	0
14	36351064	.	G	A	44	22	66	0	1	67	0	0
14	36351143	.	A	G	54	21	75	0	3	78	0	0
14	36351148	.	C	T	51	22	73	0	2	75	0	0
14	36351209	.	G	A	35	29	64	0	2	66	0	0
14	36351217	.	A	G	33	30	63	0	2	65	0	0
14	36351347	.	G	A	17	44	61	0	1	62	0	0
14	36351350	.	C	T	46	15	61	0	1	62	0	0
14	36352148	.	T	C	27	3	30	0	42	72	0	0
14	36352265	.	G	A	39	46	85	0	3	88	0	0
14	36363689	.	G	A	27	36	63	0	4	67	0	0
14	36394359	.	C	T	2	3	5	0	0	5	0	0
14	36394378	.	C	T	0	3	3	0	0	3	0	0
14	36428665	.	T	G	3	2	5	0	0	5	0	0
14	36428910	.	A	T	4	4	8	0	0	8	0	0
14	36430603	.	G	T	11	8	19	0	0	19	0	0
14	36433568	.	T	C	11	0	11	0	8	19	0	0
14	36434258	.	C	T	6	10	16	0	1	17	0	0
14	36437002	.	T	C	13	10	23	1	0	24	0	0
14	36437217	.	C	A	4	3	7	0	0	7	0	0
14	36497589	.	A	G	2	0	2	0	5	7	0	0
14	36497659	.	C	T	3	5	8	0	1	9	0	0
14	36633786	.	T	G	4	3	7	0	0	7	0	0
14	36638417	.	C	T	6	3	9	0	0	9	0	0
14	36655991	.	C	T	4	3	7	0	2	9	0	0
14	36655994	.	C	T	5	4	9	0	0	9	0	0
14	36676112	.	T	G	1	7	8	0	0	8	0	0
14	36676187	.	A	T	1	3	4	0	1	5	0	0
14	36681650	.	G	A	4	3	7	0	0	7	0	0
14	36708609	.	T	C	5	7	12	0	0	12	0	0
14	36708741	.	T	C	4	2	6	0	0	6	0	0
14	36708909	.	A	G	5	4	9	0	2	11	0	0
14	36713653	.	A	G	2	0	2	0	4	6	0	0
14	36716843	.	T	C	3	6	9	0	0	9	0	0
14	36717230	.	T	C	7	4	11	0	0	11	0	0
14	36717315	.	A	G	12	0	12	0	5	17	0	0
14	36717320	.	A	G	14	5	19	0	0	19	0	0
14	36717629	.	T	C	4	4	8	0	0	8	0	0
14	36717689	.	C	T	7	6	13	0	1	14	0	0
14	36717800	.	G	A	3	10	13	0	0	13	0	0
14	36717974	.	A	G	8	0	8	0	7	15	0	0
14	36718265	.	C	T	5	6	11	0	0	11	0	0
14	36720770	.	C	T	8	14	22	0	0	22	0	0
14	36720985	.	A	G	10	6	16	0	0	16	0	0
14	36721033	.	A	G	5	0	5	0	10	15	0	0
14	36721102	.	T	A	4	9	13	0	3	16	0	0
14	36721153	.	G	A	3	7	10	0	1	11	0	0
14	36721175	.	C	G	4	8	12	0	0	12	0	0
14	36721229	.	G	A	4	8	12	0	0	12	0	0
14	36721379	.	G	C	3	11	14	0	0	14	0	0
14	36721437	.	G	A	0	10	10	0	4	14	0	0
14	36721497	.	C	G	4	12	16	0	0	16	0	0
14	36721564	.	G	A	4	4	8	0	0	8	0	0
14	36721599	.	C	A	4	2	6	0	0	6	0	0
14	36721675	.	T	C	10	6	16	0	0	16	0	0
14	36721676	.	G	A	9	6	15	0	0	15	0	0
14	36721724	.	T	A	3	6	9	0	1	10	0	0
14	36721730	.	T	A	5	6	11	0	0	11	0	0
14	36722095	.	T	C	4	2	6	0	1	7	0	0
14	36722140	.	C	A	4	2	6	0	0	6	0	0
14	36722364	.	C	T	8	7	15	0	0	15	0	0
14	36722405	.	G	A	9	6	15	0	2	17	0	0
14	36722568	.	A	T	13	4	17	0	0	17	0	0
14	36722601	.	T	G	9	0	9	0	4	13	0	0
14	36722904	.	G	A	0	4	4	0	6	10	0	0
14	36723134	.	A	T	6	7	13	0	0	13	0	0
14	36723213	.	G	A	7	6	13	0	0	13	0	0
14	36723270	.	A	G	14	0	14	0	6	20	0	0
14	36723276	.	T	C	15	7	22	0	0	22	0	0
14	36723326	.	C	T	12	7	19	0	0	19	0	0
14	36723402	.	C	G	13	8	21	0	1	22	0	0
14	36723690	.	C	G	5	10	15	0	0	15	0	0
14	36723694	.	C	A	4	8	12	0	2	14	0	0
14	36752047	.	T	C	5	2	7	0	0	7	0	0
14	36752477	.	T	C	4	5	9	0	0	9	0	0
14	36758452	.	T	C	2	2	4	0	0	4	0	0
14	36763156	.	A	T	3	3	6	0	0	6	0	0
14	36763191	.	A	T	6	3	9	0	0	9	0	0
14	36763225	.	A	G	10	3	13	0	0	13	0	0
14	36763261	.	C	T	7	2	9	0	0	9	0	0
14	36763276	.	C	T	3	2	5	0	1	6	0	0
14	36765662	.	G	A	9	3	12	0	2	14	0	0
14	36765721	.	C	T	20	6	26	0	0	26	0	0
14	36766273	.	A	T	14	13	27	0	1	28	0	0
14	36766394	.	A	C	8	8	16	0	0	16	0	0
14	36766624	.	T	A	9	8	17	0	2	19	0	0
14	36777121	.	A	G	16	12	28	0	1	29	0	0
14	36803100	.	G	T	14	4	18	0	0	18	0	0
14	36803178	.	G	A	8	10	18	0	0	18	0	0
14	36863407	.	T	C	4	0	4	0	3	7	0	0
14	36890020	.	G	T	2	3	5	0	0	5	0	0
14	37553282	.	C	A	5	4	9	0	1	10	0	0
14	37553438	.	C	T	1	5	6	0	0	6	0	0
14	37553480	.	G	A	2	3	5	0	0	5	0	0
14	37553618	.	T	C	2	6	8	0	1	9	0	0
14	37556752	.	T	A	8	9	17	0	0	17	0	0
14	38659002	.	G	A	1	3	4	0	0	4	0	0
14	38663969	.	A	C	1	4	5	0	2	7	0	0
14	38663972	.	C	T	2	5	7	0	1	8	0	0
14	38668543	.	G	C	0	5	5	0	5	10	0	0
14	38668546	.	T	C	5	4	9	0	1	10	0	0
14	38668815	.	C	T	4	5	9	0	1	10	0	0
14	38668863	.	T	C	1	3	4	0	0	4	0	0
14	38669487	.	A	G	1	3	4	0	0	4	0	0
14	38670016	.	C	T	3	8	11	0	0	11	0	0
14	38672310	.	A	G	4	0	4	0	10	14	0	0
14	38672521	.	G	T	5	8	13	0	0	13	0	0
14	38688730	.	G	A	3	8	11	0	1	12	0	0
14	38688829	.	G	C	1	10	11	0	1	12	0	0
14	38689174	.	G	A	2	9	11	0	0	11	0	0
14	38689332	.	A	G	7	3	10	0	0	10	0	0
14	38689409	.	A	C	2	7	9	0	0	9	0	0
14	38689428	.	G	C	5	4	9	0	0	9	0	0
14	38763334	.	A	C	16	13	29	1	0	30	0	0
14	38763381	.	G	A	24	17	41	0	1	42	0	0
14	38763394	.	G	A	15	26	41	0	1	42	0	0
14	38783272	.	T	C	7	16	23	3	2	28	0	0
14	38796156	.	C	G	7	7	14	0	1	15	0	0
14	38799419	.	G	A	2	3	5	1	2	8	0	0
14	38802662	.	G	T	6	4	10	0	1	11	0	0
14	38802884	.	C	T	6	6	12	0	1	13	0	0
14	38802904	.	A	T	8	7	15	0	0	15	0	0
14	38802960	.	G	A	12	5	17	0	1	18	0	0
14	38802967	.	T	G	11	6	17	0	1	18	0	0
14	38803085	.	G	A	4	9	13	0	0	13	0	0
14	38806916	.	G	T	3	6	9	0	1	10	0	0
14	38809356	.	G	A	3	3	6	0	0	6	0	0
14	38809512	.	C	T	7	8	15	0	0	15	0	0
14	38809528	.	T	C	6	4	10	0	0	10	0	0
14	38845762	.	T	C	10	15	25	0	1	26	0	0
14	38845912	.	A	G	35	25	60	0	1	61	0	0
14	38846587	.	A	T	40	25	65	0	1	66	0	0
14	38847235	.	A	G	22	6	28	0	1	29	0	0
14	38847497	.	A	G	3	0	3	0	4	7	0	0
14	38849729	.	C	T	21	30	51	0	0	51	0	0
14	38849946	.	A	C	28	23	51	3	3	57	0	0
14	38853381	.	C	G	1	4	5	0	1	6	0	0
14	38853397	.	A	G	5	2	7	0	0	7	0	0
14	38853821	.	C	T	2	4	6	0	0	6	0	0
14	38865589	.	C	T	4	6	10	0	0	10	0	0
14	38872410	.	C	T	6	4	10	0	0	10	0	0
14	38872541	.	A	G	6	2	8	0	1	9	0	0
14	38872552	.	A	G	4	2	6	0	2	8	0	0
14	38878552	.	T	C	9	5	14	0	0	14	0	0
14	38881363	.	G	A	1	2	3	0	2	5	0	0
14	38882982	.	T	C	1	5	6	0	0	6	0	0
14	38937085	.	T	C	3	0	3	0	10	13	0	0
14	38937099	.	T	C	4	8	12	0	1	13	0	0
14	38937305	.	C	T	2	3	5	0	0	5	0	0
14	38941498	.	A	G	4	2	6	0	0	6	0	0
14	38946708	.	A	G	2	3	5	0	0	5	0	0
14	39002433	.	G	C	9	4	13	0	0	13	0	0
14	39002555	.	C	T	5	3	8	0	1	9	0	0
14	39002562	.	C	T	5	4	9	0	0	9	0	0
14	39002739	.	G	C	2	0	2	0	8	10	0	0
14	39002752	.	A	G	4	8	12	0	0	12	0	0
14	39002820	.	A	T	10	7	17	0	0	17	0	0
14	39002883	.	A	G	7	12	19	0	0	19	0	0
14	39003039	.	T	G	6	5	11	0	1	12	0	0
14	39258889	.	T	C	2	3	5	0	0	5	0	0
14	39458488	.	C	T	4	0	4	0	2	6	0	0
14	39600176	.	G	A	1	2	3	0	0	3	0	0
14	39608657	.	G	A	1	4	5	0	0	5	0	0
14	39651463	.	C	T	4	4	8	0	0	8	0	0
14	39953174	.	C	T	2	7	9	0	1	10	0	0
14	39953208	.	G	T	1	4	5	0	3	8	0	0
14	39953242	.	T	C	6	3	9	0	0	9	0	0
14	39953291	.	G	A	5	5	10	0	1	11	0	0
14	39953293	.	C	T	5	5	10	0	1	11	0	0
14	39953337	.	T	A	4	4	8	0	0	8	0	0
14	39954169	.	C	T	3	5	8	0	0	8	0	0
14	39954272	.	A	G	8	6	14	0	0	14	0	0
14	39954356	.	T	C	9	5	14	0	0	14	0	0
14	39954423	.	A	T	7	2	9	0	0	9	0	0
14	39954493	.	A	G	3	5	8	0	0	8	0	0
14	39954513	.	C	T	6	3	9	0	0	9	0	0
14	39954572	.	C	T	2	3	5	0	0	5	0	0
14	39954716	.	A	G	3	7	10	0	0	10	0	0
14	39954789	.	C	T	2	2	4	0	1	5	0	0
14	39955172	.	A	T	6	2	8	0	0	8	0	0
14	39955231	.	T	A	5	3	8	0	0	8	0	0
14	39955448	.	C	T	7	7	14	0	0	14	0	0
14	39955457	.	C	A	9	7	16	0	1	17	0	0
14	39955612	.	A	T	6	7	13	0	2	15	0	0
14	39955646	.	T	C	6	3	9	1	0	10	0	0
14	39955772	.	T	A	11	7	18	0	0	18	0	0
14	39955823	.	T	C	10	3	13	0	1	14	0	0
14	39956035	.	C	G	6	0	6	1	3	10	0	0
14	39956037	.	A	T	5	3	8	1	0	9	0	0
14	39956075	.	G	A	7	6	13	0	0	13	0	0
14	39956380	.	T	C	5	13	18	0	0	18	0	0
14	39956690	.	A	C	2	5	7	0	0	7	0	0
14	39956804	.	G	T	1	5	6	0	0	6	0	0
14	39956825	.	T	C	4	3	7	0	0	7	0	0
14	39957077	.	C	G	6	12	18	0	0	18	0	0
14	39957304	.	T	G	2	3	5	0	0	5	0	0
14	40303348	.	A	T	26	10	36	0	1	37	0	0
14	40303366	.	C	T	22	11	33	0	5	38	0	0
14	40304488	.	C	G	1	14	15	1	12	28	0	0
14	40305230	.	G	A	19	15	34	0	3	37	0	0
14	40305287	.	C	A	0	24	24	0	23	47	0	0
14	40305635	.	C	T	3	16	19	0	20	39	0	0
14	40305659	.	C	T	0	21	21	0	18	39	0	0
14	40387603	.	C	T	12	20	32	0	1	33	0	0
14	40387627	.	G	A	17	4	21	0	1	22	0	0
14	40388107	.	A	G	7	28	35	0	0	35	0	0
14	40388185	.	A	G	17	9	26	0	0	26	0	0
14	40388440	.	G	A	17	13	30	0	0	30	0	0
14	40388460	.	T	G	18	11	29	0	2	31	0	0
14	40388629	.	T	C	11	22	33	0	0	33	0	0
14	40389145	.	C	G	11	16	27	0	0	27	0	0
14	40389789	.	A	T	12	7	19	0	0	19	0	0
14	40389823	.	T	A	6	10	16	0	0	16	0	0
14	40389978	.	C	T	5	6	11	0	1	12	0	0
14	40389988	.	T	A	7	4	11	0	0	11	0	0
14	40390192	.	T	G	3	3	6	0	0	6	0	0
14	40390587	.	G	T	6	6	12	0	0	12	0	0
14	40745939	.	G	A	0	2	2	0	2	4	0	0
14	40745944	.	C	T	1	3	4	0	0	4	0	0
14	40746261	.	G	C	2	3	5	0	0	5	0	0
14	40852670	.	A	T	11	8	19	0	0	19	0	0
14	40852732	.	T	C	13	12	25	0	0	25	0	0
14	40853268	.	C	G	12	10	22	0	1	23	0	0
14	40857654	.	T	G	17	8	25	0	1	26	0	0
14	40857711	.	G	A	19	8	27	0	0	27	0	0
14	40857881	.	T	C	13	18	31	0	1	32	0	0
14	40857977	.	C	T	13	17	30	0	0	30	0	0
14	40859179	.	A	G	22	2	24	1	11	36	0	0
14	40860291	.	T	A	16	15	31	0	1	32	0	0
14	40860354	.	C	T	22	22	44	0	1	45	0	0
14	40863062	.	A	G	22	17	39	0	1	40	0	0
14	40863161	.	T	C	24	14	38	0	1	39	0	0
14	40863176	.	A	G	24	15	39	0	2	41	0	0
14	40869331	.	C	A	15	21	36	0	4	40	0	0
14	40869895	.	T	C	19	25	44	0	2	46	0	0
14	40874026	.	G	T	4	4	8	0	0	8	0	0
14	41276516	.	T	A	9	7	16	0	2	18	0	0
14	41276608	.	G	A	2	9	11	0	1	12	0	0
14	41277391	.	A	T	9	17	26	0	1	27	0	0
14	41277424	.	C	A	7	12	19	0	2	21	0	0
14	41277556	.	A	G	30	27	57	0	1	58	0	0
14	41277624	.	A	T	22	29	51	0	3	54	0	0
14	41278238	.	T	A	24	23	47	1	2	50	0	0
14	41278255	.	A	G	17	23	40	1	0	41	0	0
14	41278658	.	T	G	14	6	20	0	0	20	0	0
14	41279133	.	C	T	23	16	39	0	1	40	0	0
14	41279214	.	C	T	19	21	40	3	1	44	0	0
14	41279277	.	G	C	21	29	50	0	1	51	0	0
14	41279479	.	T	A	12	9	21	0	1	22	0	0
14	41279527	.	C	T	2	12	14	0	11	25	0	0
14	41279542	.	C	A	4	15	19	1	13	33	0	0
14	41279624	.	G	A	30	13	43	2	1	46	0	0
14	41279974	.	T	G	17	11	28	0	0	28	0	0
14	41279977	.	G	T	17	10	27	0	1	28	0	0
14	41280013	.	G	A	17	17	34	0	1	35	0	0
14	41280149	.	G	A	27	23	50	0	1	51	0	0
14	41280228	.	A	G	24	24	48	0	1	49	0	0
14	41280517	.	G	C	26	20	46	0	0	46	0	0
14	41318672	.	G	C	2	3	5	0	4	9	0	0
14	41318808	.	T	G	2	1	3	0	3	6	0	0
14	41319073	.	C	T	2	5	7	0	0	7	0	0
14	41333519	.	A	G	3	3	6	0	1	7	0	0
14	41339309	.	T	C	6	6	12	0	0	12	0	0
14	41339820	.	G	C	1	3	4	0	1	5	0	0
14	41339972	.	G	A	0	5	5	0	3	8	0	0
14	41340054	.	T	A	3	3	6	0	1	7	0	0
14	41340081	.	A	T	6	4	10	0	0	10	0	0
14	41340172	.	A	C	2	5	7	0	0	7	0	0
14	41340231	.	G	A	5	3	8	0	0	8	0	0
14	41340284	.	C	T	0	2	2	0	1	3	0	0
14	41361985	.	C	T	1	11	12	0	9	21	0	0
14	41362007	.	G	A	8	22	30	0	1	31	0	0
14	41362060	.	C	T	13	7	20	0	0	20	0	0
14	41366823	.	G	A	19	13	32	0	1	33	0	0
14	41366889	.	C	A	16	13	29	0	2	31	0	0
14	41385823	.	G	A	11	15	26	0	0	26	0	0
14	41385895	.	C	T	3	12	15	0	10	25	0	0
14	41406491	.	G	A	1	5	6	0	0	6	0	0
14	41406558	.	G	T	2	3	5	0	0	5	0	0
14	41414242	.	C	A	4	4	8	0	0	8	0	0
14	41414483	.	C	A	5	2	7	0	0	7	0	0
14	41414857	.	C	T	2	2	4	0	1	5	0	0
14	41428500	.	C	T	8	5	13	0	1	14	0	0
14	41435662	.	C	T	10	6	16	0	0	16	0	0
14	41436773	.	T	A	5	6	11	0	2	13	0	0
14	41436943	.	C	T	5	7	12	0	0	12	0	0
14	41438005	.	G	A	3	2	5	0	0	5	0	0
14	41466483	.	T	A	4	5	9	1	0	10	0	0
14	41466522	.	G	A	8	11	19	1	0	20	0	0
14	41466922	.	T	A	13	18	31	0	0	31	0	0
14	41467152	.	T	C	18	21	39	0	0	39	0	0
14	41467155	.	C	T	22	16	38	0	3	41	0	0
14	41467356	.	C	G	14	15	29	0	1	30	0	0
14	41469662	.	C	A	6	3	9	0	0	9	0	0
14	41469761	.	G	T	3	2	5	0	0	5	0	0
14	41469827	.	T	C	7	4	11	0	0	11	0	0
14	41469829	.	T	C	7	4	11	0	0	11	0	0
14	41469925	.	T	A	4	6	10	0	0	10	0	0
14	41469935	.	C	T	4	3	7	0	0	7	0	0
14	41470032	.	C	T	0	9	9	0	3	12	0	0
14	41470037	.	A	T	2	8	10	0	1	11	0	0
14	41490627	.	C	T	1	2	3	0	0	3	0	0
14	41513448	.	G	A	4	2	6	0	0	6	0	0
14	41514074	.	T	G	1	2	3	0	0	3	0	0
14	41514842	.	C	T	1	2	3	1	0	4	0	0
14	41529876	.	T	G	1	3	4	0	0	4	0	0
14	41529895	.	G	T	3	2	5	0	0	5	0	0
14	41921397	.	C	A	2	2	4	0	0	4	0	0
14	44589624	.	C	T	8	18	26	0	0	26	0	0
14	44589834	.	A	G	12	9	21	0	0	21	0	0
14	44589972	.	T	A	5	10	15	0	1	16	0	0
14	44589978	.	G	A	5	10	15	0	1	16	0	0
14	44590297	.	G	C	8	13	21	0	1	22	0	0
14	44590301	.	A	G	9	0	9	0	16	25	0	0
14	44590644	.	C	T	14	15	29	0	2	31	0	0
14	44590935	.	G	A	0	13	13	0	14	27	0	0
14	44590992	.	A	G	9	9	18	0	2	20	0	0
14	44773795	.	C	G	1	2	3	0	0	3	0	0
14	44773805	.	A	C	1	2	3	0	0	3	0	0
14	44824766	.	A	G	1	3	4	1	0	5	0	0
14	45032173	.	C	T	3	2	5	0	0	5	0	0
14	45034567	.	C	A	2	3	5	0	0	5	0	0
14	45034654	.	G	A	1	3	4	0	0	4	0	0
14	45294988	.	A	G	6	4	10	0	0	10	0	0
14	45294989	.	A	G	8	3	11	0	0	11	0	0
14	45435592	.	T	C	3	2	5	0	0	5	0	0
14	45435739	.	T	A	2	3	5	0	1	6	0	0
14	45636070	.	G	A	3	29	32	0	33	65	0	0
14	45925763	.	A	G	1	2	3	0	0	3	0	0
14	45925764	.	A	G	1	2	3	0	0	3	0	0
14	45925992	.	A	C	2	3	5	0	0	5	0	0
14	45926229	.	G	A	0	1	1	0	3	4	0	0
14	45926238	.	C	T	3	2	5	0	0	5	0	0
14	45926364	.	C	T	2	2	4	0	1	5	0	0
14	45926559	.	T	C	2	2	4	0	0	4	0	0
14	45926910	.	C	T	3	3	6	0	0	6	0	0
14	45927130	.	T	G	1	0	1	0	2	3	0	0
14	45927282	.	A	T	5	2	7	0	0	7	0	0
14	45927364	.	G	A	2	3	5	0	0	5	0	0
14	45927624	.	T	A	6	5	11	0	0	11	0	0
14	45927849	.	C	T	3	5	8	0	1	9	0	0
14	45927861	.	T	C	4	4	8	0	0	8	0	0
14	45928059	.	T	A	4	3	7	0	0	7	0	0
14	45928224	.	A	T	2	2	4	0	0	4	0	0
14	45928241	.	G	A	2	3	5	0	1	6	0	0
14	45928803	.	A	C	4	2	6	0	0	6	0	0
14	45928853	.	T	G	2	3	5	0	1	6	0	0
14	45929100	.	A	T	3	4	7	0	0	7	0	0
14	45929137	.	T	G	2	2	4	0	0	4	0	0
14	45929140	.	T	A	2	2	4	0	0	4	0	0
14	45929280	.	C	T	5	4	9	0	0	9	0	0
14	45929409	.	C	T	9	4	13	0	0	13	0	0
14	45929591	.	T	A	4	2	6	0	0	6	0	0
14	45929837	.	T	A	6	6	12	0	0	12	0	0
14	45929974	.	T	C	2	4	6	0	0	6	0	0
14	45930135	.	T	C	4	4	8	0	0	8	0	0
14	45930196	.	A	C	4	5	9	0	1	10	0	0
14	45930399	.	C	T	7	4	11	0	0	11	0	0
14	45930508	.	A	G	3	4	7	0	0	7	0	0
14	45930515	.	G	A	3	4	7	0	0	7	0	0
14	45930572	.	A	G	6	3	9	0	0	9	0	0
14	45930573	.	T	G	7	3	10	0	0	10	0	0
14	45930669	.	A	G	8	3	11	0	0	11	0	0
14	45930690	.	A	G	7	4	11	0	0	11	0	0
14	45931079	.	C	G	5	9	14	0	0	14	0	0
14	45931194	.	G	T	6	10	16	0	0	16	0	0
14	45931504	.	C	G	6	7	13	0	1	14	0	0
14	45931637	.	C	T	11	9	20	0	1	21	0	0
14	45931899	.	C	T	7	6	13	0	0	13	0	0
14	45932128	.	T	G	8	3	11	0	1	12	0	0
14	45967618	.	T	C	4	4	8	0	0	8	0	0
14	45994354	.	T	C	1	5	6	0	0	6	0	0
14	46007306	.	A	G	16	9	25	0	2	27	0	0
14	46007321	.	G	A	12	8	20	0	3	23	0	0
14	46009611	.	G	A	7	12	19	0	0	19	0	0
14	46009683	.	A	T	10	7	17	0	1	18	0	0
14	46010711	.	C	T	14	11	25	0	0	25	0	0
14	46010909	.	T	C	13	15	28	0	1	29	0	0
14	46012960	.	T	C	8	9	17	0	1	18	0	0
14	46013121	.	A	T	11	16	27	0	0	27	0	0
14	46013402	.	C	T	22	9	31	1	0	32	0	0
14	46015888	.	C	A	14	16	30	0	1	31	0	0
14	46016107	.	A	G	14	19	33	0	2	35	0	0
14	46017969	.	G	A	17	13	30	0	1	31	0	0
14	46018029	.	C	T	15	16	31	0	1	33	1	0
14	46018548	.	A	G	8	16	24	4	0	28	0	0
14	46028329	.	G	T	8	12	20	0	0	20	0	0
14	46028330	.	T	A	8	12	20	0	0	20	0	0
14	46028376	.	G	A	5	9	14	0	0	14	0	0
14	46028548	.	G	C	1	7	8	0	6	14	0	0
14	46037489	.	T	C	6	5	11	0	0	11	0	0
14	46039751	.	T	C	10	9	19	0	0	19	0	0
14	46039904	.	C	G	5	0	5	0	6	11	0	0
14	46040771	.	T	C	1	2	3	0	0	3	0	0
14	46040967	.	A	T	1	3	4	0	0	4	0	0
14	46041036	.	G	A	3	2	5	0	0	5	0	0
14	46041701	.	T	A	4	3	7	0	1	8	0	0
14	46041763	.	T	G	5	4	9	0	0	9	0	0
14	46041800	.	C	T	2	7	9	0	1	10	0	0
14	46041861	.	A	T	11	7	18	0	1	19	0	0
14	46042005	.	T	C	1	2	3	0	0	3	0	0
14	46048396	.	A	G	5	8	13	0	1	14	0	0
14	46048644	.	C	T	0	8	8	0	3	11	0	0
14	46048704	.	C	G	1	19	20	0	4	24	0	0
14	46048875	.	T	C	14	14	28	0	2	30	0	0
14	46052172	.	T	A	10	10	20	0	2	22	0	0
14	46052244	.	G	T	11	8	19	0	0	19	0	0
14	46067317	.	A	T	7	10	17	0	0	17	0	0
14	46074433	.	C	T	6	2	8	0	1	9	0	0
14	46074473	.	T	A	5	5	10	0	0	10	0	0
14	46074489	.	A	G	4	4	8	0	0	8	0	0
14	46075085	.	T	C	2	2	4	0	0	4	0	0
14	46075640	.	A	C	6	3	9	0	0	9	0	0
14	46075749	.	A	G	5	2	7	0	0	7	0	0
14	46076858	.	T	C	5	3	8	0	0	8	0	0
14	46077677	.	T	C	1	2	3	0	0	3	0	0
14	46077997	.	T	C	5	2	7	1	1	9	0	0
14	46078000	.	T	A	6	2	8	1	0	9	0	0
14	46088921	.	A	G	3	6	9	0	0	9	0	0
14	46089176	.	C	T	3	6	9	0	1	10	0	0
14	46089433	.	T	G	2	5	7	0	0	7	0	0
14	46089508	.	T	C	6	3	9	0	0	9	0	0
14	46090084	.	T	C	3	3	6	0	0	6	0	0
14	46090508	.	T	A	4	4	8	0	1	9	0	0
14	46090636	.	A	G	2	2	4	0	0	4	0	0
14	46090653	.	T	A	1	3	4	0	1	5	0	0
14	46091627	.	T	C	3	3	6	0	0	6	0	0
14	46094922	.	C	T	10	4	14	0	4	18	0	0
14	46095043	.	A	G	17	14	31	0	1	32	0	0
14	46095058	.	A	G	24	13	37	0	1	38	0	0
14	46095108	.	A	G	27	22	49	0	2	51	0	0
14	46104150	.	C	T	22	21	43	0	7	50	0	0
14	46104222	.	C	T	6	27	33	0	25	58	0	0
14	46104935	.	G	A	26	25	51	0	3	54	0	0
14	46113296	.	T	G	25	15	40	0	1	41	0	0
14	46113309	.	C	G	0	12	12	0	23	35	0	0
14	46114929	.	G	A	17	8	25	0	0	25	0	0
14	46116576	.	A	G	21	17	38	0	1	39	0	0
14	46117279	.	G	T	5	7	12	0	1	13	0	0
14	46118878	.	T	A	3	4	7	0	0	7	0	0
14	46128948	.	A	C	5	4	9	0	0	9	0	0
14	46129955	.	C	A	5	5	10	0	0	10	0	0
14	46134040	.	A	G	8	0	8	0	7	15	0	0
14	46140707	.	C	G	5	7	12	0	0	12	0	0
14	46140812	.	C	A	6	4	10	0	0	11	1	0
14	46146715	.	G	A	6	12	18	0	1	19	0	0
14	46154358	.	C	A	8	6	14	0	1	15	0	0
14	46154713	.	A	G	6	8	14	0	0	14	0	0
14	46154899	.	A	C	4	7	11	0	1	12	0	0
14	46154966	.	T	A	3	3	6	0	0	6	0	0
14	46154969	.	T	A	3	3	6	0	0	6	0	0
14	46183610	.	A	G	5	0	5	0	4	9	0	0
14	46183623	.	A	G	2	7	9	0	0	9	0	0
14	46183663	.	A	G	3	0	3	0	2	5	0	0
14	46184737	.	A	G	7	2	9	0	0	9	0	0
14	46184738	.	A	G	4	5	9	0	0	9	0	0
14	46187317	.	A	G	1	6	7	0	0	7	0	0
14	46187365	.	A	G	4	2	6	0	0	6	0	0
14	46187391	.	A	G	4	2	6	0	1	7	0	0
14	46188019	.	A	G	4	3	7	0	0	7	0	0
14	46224479	.	T	C	1	4	5	1	0	6	0	0
14	46679356	.	T	C	7	5	12	0	0	12	0	0
14	46873350	.	A	T	8	2	10	0	0	10	0	0
14	47003023	.	T	G	9	6	15	0	0	15	0	0
14	47003330	.	A	C	16	23	39	0	0	39	0	0
14	47003696	.	G	T	18	19	37	0	1	38	0	0
14	47003908	.	C	T	5	21	26	0	18	44	0	0
14	47003958	.	T	A	25	13	38	0	2	40	0	0
14	47004090	.	T	G	19	19	38	0	1	39	0	0
14	47004187	.	C	A	13	10	23	0	0	23	0	0
14	47004365	.	G	A	11	9	20	0	1	21	0	0
14	47004734	.	G	A	16	20	36	0	0	36	0	0
14	47004959	.	T	G	15	13	28	1	0	29	0	0
14	47027767	.	G	A	16	19	35	1	1	37	0	0
14	47066764	.	G	A	6	8	14	0	0	14	0	0
14	47074234	.	A	G	11	6	17	0	0	17	0	0
14	47085624	.	A	G	14	10	24	0	2	26	0	0
14	47096209	.	T	C	11	1	12	1	9	22	0	0
14	47142032	.	C	T	9	5	14	0	0	15	1	0
14	47264962	.	T	C	5	0	5	0	10	15	0	0
14	47265031	.	A	G	12	9	21	0	0	21	0	0
14	48933772	.	G	A	1	5	6	3	0	9	0	0
14	48934010	.	T	C	27	10	37	0	0	37	0	0
14	48934639	.	T	C	23	0	23	0	9	32	0	0
14	48998277	.	G	A	2	6	8	0	0	8	0	0
14	49022071	.	A	G	11	0	11	0	8	19	0	0
14	49022145	.	A	G	2	1	3	0	6	9	0	0
14	49030348	.	A	G	2	6	8	0	0	8	0	0
14	49031249	.	T	A	0	7	7	0	0	11	4	0
14	49210955	.	A	G	5	6	11	0	1	12	0	0
14	49211000	.	A	G	12	0	12	0	4	16	0	0
14	49211001	.	A	G	6	9	15	0	1	16	0	0
14	49211172	.	A	G	2	6	8	0	1	9	0	0
14	49212183	.	A	G	2	3	5	0	0	5	0	0
14	49212184	.	A	G	2	3	5	0	0	5	0	0
14	49430817	.	A	G	16	14	30	0	0	30	0	0
14	49442729	.	A	T	1	7	8	0	0	8	0	0
14	49734011	.	C	G	4	5	9	0	0	9	0	0
14	49738358	.	C	T	2	5	7	0	0	7	0	0
14	49738424	.	C	T	4	11	15	0	0	15	0	0
14	49750311	.	C	T	4	13	17	0	0	17	0	0
14	49756700	.	A	T	7	5	12	0	0	12	0	0
14	49757069	.	G	T	5	3	8	0	0	8	0	0
14	49757225	.	G	A	5	6	11	0	0	11	0	0
14	49757320	.	A	G	3	2	5	0	1	6	0	0
14	49757359	.	C	G	5	0	5	0	4	9	0	0
14	49757802	.	G	A	3	3	6	0	1	7	0	0
14	49757811	.	A	G	1	3	4	0	0	4	0	0
14	50808169	.	C	G	1	2	3	0	0	3	0	0
14	50815277	.	T	C	1	2	3	0	0	3	0	0
14	50815344	.	C	A	2	3	5	0	0	5	0	0
14	50815375	.	A	T	2	3	5	0	0	5	0	0
14	50815384	.	A	G	1	0	1	0	3	4	0	0
14	50857973	.	T	C	1	1	2	0	1	3	0	0
14	50964215	.	A	G	6	3	9	0	0	9	0	0
14	50964260	.	C	T	6	9	15	0	0	15	0	0
14	50968017	.	T	C	7	4	11	0	1	12	0	0
14	50972822	.	T	C	5	2	7	0	0	7	0	0
14	50972921	.	G	A	0	3	3	0	3	6	0	0
14	50973322	.	A	G	3	5	8	0	2	10	0	0
14	50973374	.	C	A	2	4	6	0	1	7	0	0
14	50973437	.	T	C	7	3	10	0	2	12	0	0
14	50973665	.	A	T	5	2	7	0	0	7	0	0
14	50974729	.	G	A	8	2	10	0	0	10	0	0
14	50974739	.	G	T	1	0	1	0	11	14	2	0
14	50974817	.	A	G	4	4	8	0	0	8	0	0
14	50974827	.	A	G	4	3	7	0	0	7	0	0
14	50974870	.	T	G	8	3	11	0	0	11	0	0
14	50974874	.	C	T	7	5	12	0	0	12	0	0
14	50975094	.	A	G	4	7	11	0	1	12	0	0
14	50975486	.	C	T	7	2	9	1	0	10	0	0
14	50975501	.	G	A	0	5	5	1	5	11	0	0
14	50994282	.	A	C	5	7	12	0	0	12	0	0
14	50994361	.	A	G	2	4	6	0	0	6	0	0
14	50994687	.	G	T	17	17	34	0	0	34	0	0
14	50994695	.	G	C	15	22	37	0	0	37	0	0
14	50999698	.	A	G	5	16	21	0	0	21	0	0
14	51002874	.	G	A	17	9	26	0	2	28	0	0
14	51014221	.	T	G	8	16	24	0	2	26	0	0
14	51017771	.	G	A	0	13	13	0	16	29	0	0
14	51017841	.	A	G	11	11	22	0	1	23	0	0
14	51017952	.	G	A	1	9	10	0	6	16	0	0
14	51038976	.	A	G	4	4	8	0	0	8	0	0
14	51038980	.	G	T	4	3	7	0	0	7	0	0
14	51039042	.	A	G	1	3	4	0	0	4	0	0
14	51084600	.	C	T	2	2	4	0	0	4	0	0
14	51084606	.	T	C	2	2	4	0	0	4	0	0
14	51829341	.	G	A	35	32	67	1	0	68	0	0
14	51829377	.	A	G	36	35	71	1	4	76	0	0
14	51830952	.	G	A	40	29	69	0	2	71	0	0
14	52325261	.	G	A	0	2	2	0	1	3	0	0
14	52358842	.	A	C	5	3	8	0	0	8	0	0
14	52358971	.	G	C	5	10	15	0	0	15	0	0
14	52361399	.	C	T	10	9	19	0	2	21	0	0
14	52366401	.	G	A	6	7	13	0	1	14	0	0
14	52366464	.	C	T	5	8	13	0	0	13	0	0
14	52369558	.	C	A	4	6	10	0	2	12	0	0
14	52376418	.	G	A	0	5	5	0	2	7	0	0
14	52379686	.	G	A	2	2	4	2	0	6	0	0
14	52379732	.	C	A	6	7	13	2	0	16	1	0
14	52379740	.	T	A	8	7	15	2	0	17	0	0
14	52379876	.	T	C	5	6	11	0	0	11	0	0
14	52381762	.	G	A	7	4	11	10	2	23	0	0
14	52383817	.	G	A	13	11	24	0	2	26	0	0
14	52383871	.	G	A	11	10	21	0	0	21	0	0
14	52386667	.	G	A	15	9	24	0	1	25	0	0
14	52386736	.	C	T	19	18	37	0	0	37	0	0
14	52386750	.	G	A	18	19	37	0	2	39	0	0
14	52388115	.	G	A	12	9	21	0	1	22	0	0
14	52388136	.	G	C	14	7	21	0	2	23	0	0
14	52388297	.	T	C	12	0	12	0	6	18	0	0
14	52391664	.	G	A	10	16	26	0	0	26	0	0
14	52392238	.	G	A	9	8	17	0	1	18	0	0
14	52395438	.	T	C	11	0	11	0	12	23	0	0
14	52395492	.	G	A	7	11	18	0	0	18	0	0
14	52395552	.	C	T	9	5	14	0	1	15	0	0
14	52395558	.	G	A	11	4	15	0	1	16	0	0
14	52397293	.	C	T	10	6	16	0	0	16	0	0
14	52399977	.	A	G	7	6	13	0	0	13	0	0
14	52400426	.	G	C	5	2	7	0	0	7	0	0
14	52404637	.	G	A	5	4	9	9	0	18	0	0
14	52408723	.	T	C	2	3	5	0	0	5	0	0
14	52411315	.	C	G	6	8	14	0	0	14	0	0
14	52413205	.	G	A	0	5	5	0	7	12	0	0
14	52414357	.	A	G	8	0	8	0	10	18	0	0
14	52417462	.	T	A	3	3	6	0	1	7	0	0
14	52417470	.	A	T	3	4	7	0	1	8	0	0
14	52417537	.	C	T	4	3	7	0	1	8	0	0
14	52418127	.	T	A	7	4	11	0	1	12	0	0
14	52418274	.	C	A	6	7	13	0	0	13	0	0
14	52418565	.	T	G	8	0	8	0	4	12	0	0
14	52418701	.	C	G	8	1	9	0	4	13	0	0
14	52418772	.	G	T	14	5	19	0	0	19	0	0
14	52418818	.	A	G	14	4	18	0	0	18	0	0
14	52418943	.	A	T	5	4	9	0	0	9	0	0
14	52419007	.	C	G	3	5	8	0	0	8	0	0
14	52419048	.	T	A	1	2	3	0	0	3	0	0
14	52476624	.	T	C	4	4	8	0	0	8	0	0
14	52476640	.	A	G	5	2	7	0	0	7	0	0
14	52494442	.	T	C	5	7	12	0	1	13	0	0
14	52497733	.	G	A	1	7	8	0	7	15	0	0
14	52497766	.	G	C	0	6	6	0	9	15	0	0
14	52512529	.	G	A	2	10	12	0	10	22	0	0
14	52513561	.	C	T	9	9	18	0	2	20	0	0
14	52517782	.	T	A	5	4	9	0	0	10	1	0
14	52517784	.	A	C	4	5	9	0	0	9	0	0
14	52517870	.	A	G	12	4	16	0	0	16	0	0
14	52517957	.	T	C	11	11	22	3	1	26	0	0
14	52518002	.	A	G	11	9	20	0	0	20	0	0
14	52518030	.	G	A	1	9	10	0	15	25	0	0
14	52518125	.	C	A	8	10	18	0	0	18	0	0
14	52520270	.	G	A	7	6	13	0	1	14	0	0
14	52520367	.	T	C	7	9	16	0	2	18	0	0
14	52520626	.	T	A	5	2	7	0	0	7	0	0
14	52520823	.	A	G	4	4	8	0	2	10	0	0
14	52520969	.	C	T	3	4	7	0	1	8	0	0
14	52521077	.	A	G	2	4	6	0	1	7	0	0
14	52521314	.	A	C	3	5	8	0	0	8	0	0
14	52521365	.	G	T	2	4	6	0	3	9	0	0
14	52521368	.	C	T	6	3	9	0	1	10	0	0
14	52521440	.	C	T	4	4	8	0	0	8	0	0
14	52522820	.	T	C	8	9	17	0	0	17	0	0
14	52522822	.	C	T	8	8	16	0	1	17	0	0
14	52522876	.	C	T	10	12	22	0	0	22	0	0
14	52523237	.	G	C	2	3	5	0	1	6	0	0
14	52523290	.	C	T	1	3	4	0	11	15	0	0
14	52523529	.	T	C	6	17	23	0	0	23	0	0
14	52523562	.	T	C	24	5	29	0	0	29	0	0
14	52523648	.	G	T	8	6	14	0	1	15	0	0
14	52523707	.	A	G	11	10	21	0	1	22	0	0
14	52524072	.	T	C	1	2	3	0	0	3	0	0
14	52524091	.	A	G	3	2	5	0	0	5	0	0
14	52524364	.	C	T	1	4	5	0	11	16	0	0
14	52524525	.	A	T	5	4	9	0	0	9	0	0
14	52524651	.	A	T	8	4	12	0	0	12	0	0
14	52524653	.	G	T	7	4	11	0	0	11	0	0
14	52524687	.	T	A	9	6	15	0	0	15	0	0
14	52524767	.	A	G	9	14	23	0	1	24	0	0
14	52524792	.	A	G	12	5	17	0	2	19	0	0
14	52524889	.	G	A	1	2	3	3	0	6	0	0
14	52524890	.	A	T	1	2	3	3	0	6	0	0
14	52525016	.	C	T	1	10	11	0	10	21	0	0
14	52525673	.	G	A	18	5	23	0	3	26	0	0
14	52525812	.	C	T	0	20	20	1	11	32	0	0
14	52528210	.	G	A	12	9	21	0	0	21	0	0
14	52533500	.	G	A	16	15	31	0	1	32	0	0
14	52536303	.	G	C	14	5	19	0	1	20	0	0
14	52538887	.	G	A	13	6	19	0	0	19	0	0
14	52552852	.	A	G	16	17	33	0	1	37	3	0
14	52552863	.	G	A	30	19	49	0	2	51	0	0
14	52574954	.	C	G	1	2	3	0	0	3	0	0
14	52574979	.	C	T	0	2	2	0	1	3	0	0
14	52575707	.	C	T	6	9	15	0	0	15	0	0
14	52575754	.	T	C	9	11	20	0	1	21	0	0
14	52575878	.	A	G	5	5	10	0	1	11	0	0
14	52575879	.	T	A	5	6	11	0	0	11	0	0
14	52576139	.	C	T	4	15	19	0	13	32	0	0
14	52576142	.	C	T	7	15	22	0	10	32	0	0
14	52577036	.	G	A	3	2	5	0	2	7	0	0
14	52577042	.	A	G	4	4	8	0	0	8	0	0
14	52580849	.	G	A	4	9	13	0	0	13	0	0
14	52582987	.	G	T	2	2	4	0	0	4	0	0
14	52583001	.	C	A	5	3	8	0	0	8	0	0
15	642976	.	C	T	1	7	8	0	0	8	0	0
15	870948	.	A	G	0	2	2	1	0	3	0	0
15	870955	.	A	G	3	2	5	1	0	6	0	0
15	894804	.	G	A	0	3	3	7	1	11	0	0
15	908257	.	T	C	1	3	4	9	0	13	0	0
15	1026323	.	A	G	2	3	5	0	0	5	0	0
15	1033435	.	A	T	9	4	13	0	0	13	0	0
15	1033479	.	T	G	5	5	10	0	0	10	0	0
15	1033564	.	G	T	2	6	8	0	1	9	0	0
15	1033853	.	A	G	5	5	10	0	0	10	0	0
15	1033955	.	C	T	1	2	3	0	2	5	0	0
15	1036614	.	C	T	3	3	6	0	0	6	0	0
15	1036677	.	C	T	0	4	4	0	4	8	0	0
15	1036825	.	T	C	3	4	7	0	1	8	0	0
15	1148129	.	A	G	5	3	8	0	0	8	0	0
15	1152067	.	T	C	4	3	7	0	0	7	0	0
15	1167166	.	G	A	0	3	3	1	6	10	0	0
15	1167179	.	C	T	5	2	7	1	1	9	0	0
15	1167229	.	G	T	1	2	3	0	3	6	0	0
15	1173016	.	A	G	5	0	5	0	7	12	0	0
15	1173067	.	C	T	6	2	8	0	0	8	0	0
15	1173542	.	C	T	9	8	17	0	0	17	0	0
15	1176447	.	G	A	1	6	7	0	7	14	0	0
15	1178927	.	C	A	13	7	20	0	0	20	0	0
15	1181477	.	G	T	6	3	9	0	1	10	0	0
15	1181480	.	C	T	1	4	5	0	6	11	0	0
15	1183930	.	G	T	9	9	18	0	0	18	0	0
15	1183984	.	C	T	0	7	7	0	12	19	0	0
15	1186181	.	A	G	4	9	13	0	0	13	0	0
15	1186202	.	C	T	0	10	10	0	7	17	0	0
15	1189664	.	C	T	17	12	29	0	0	29	0	0
15	1191750	.	A	G	18	10	28	0	1	29	0	0
15	1191792	.	G	A	4	7	11	0	13	24	0	0
15	1191822	.	A	G	14	0	14	0	7	21	0	0
15	1194590	.	A	G	13	7	20	0	0	20	0	0
15	1194619	.	G	A	1	9	10	0	11	21	0	0
15	1194633	.	A	G	12	8	20	0	0	20	0	0
15	1194670	.	G	A	18	8	26	0	1	27	0	0
15	1194754	.	T	C	9	3	12	0	0	12	0	0
15	1204941	.	T	C	1	2	3	0	0	3	0	0
15	1209060	.	G	A	0	2	2	0	4	6	0	0
15	1730619	.	G	A	4	5	9	0	0	9	0	0
15	1730643	.	A	G	4	6	10	0	1	11	0	0
15	1733125	.	G	C	3	6	9	0	0	9	0	0
15	1749984	.	A	T	2	3	5	0	0	5	0	0
15	1753501	.	A	G	5	4	9	0	0	9	0	0
15	1758037	.	C	T	2	3	5	0	0	5	0	0
15	1758675	.	T	C	2	0	2	0	5	7	0	0
15	1766675	.	C	T	9	3	12	0	2	14	0	0
15	1774489	.	G	A	1	10	11	0	8	19	0	0
15	1777913	.	C	A	10	3	13	0	0	13	0	0
15	1782156	.	T	C	5	5	10	0	1	11	0	0
15	1828401	.	C	T	5	8	13	0	0	13	0	0
15	1830323	.	A	G	8	7	15	0	1	16	0	0
15	1847246	.	C	G	7	13	20	0	0	20	0	0
15	1847358	.	A	G	13	6	19	0	1	20	0	0
15	1847432	.	A	C	17	8	25	0	2	27	0	0
15	1847588	.	A	T	9	12	21	0	2	23	0	0
15	1847693	.	A	G	11	15	26	0	0	27	1	0
15	1847908	.	A	C	16	8	24	0	0	24	0	0
15	1847951	.	G	A	13	7	20	0	0	20	0	0
15	1848188	.	T	C	11	0	11	0	9	20	0	0
15	1848202	.	G	T	8	8	16	0	0	16	0	0
15	1848308	.	G	A	3	3	6	0	0	6	0	0
15	1848320	.	G	A	2	4	6	0	0	6	0	0
15	1848349	.	A	C	2	3	5	0	0	5	0	0
15	1850540	.	A	C	8	1	9	0	8	17	0	0
15	1853010	.	A	C	12	6	18	0	1	19	0	0
15	1853028	.	G	A	11	7	18	0	0	18	0	0
15	1858625	.	A	G	10	5	15	0	1	16	0	0
15	1858638	.	C	G	9	4	13	0	1	14	0	0
15	1858914	.	G	C	10	0	10	0	5	15	0	0
15	1859013	.	G	A	9	3	12	0	0	12	0	0
15	1862024	.	C	T	0	6	6	0	5	11	0	0
15	1869631	.	A	T	11	4	15	0	0	15	0	0
15	1869712	.	C	T	8	6	14	0	0	14	0	0
15	1871188	.	A	G	6	4	10	0	2	12	0	0
15	1871197	.	T	C	5	7	12	0	0	12	0	0
15	1871245	.	A	G	5	7	12	0	2	14	0	0
15	1871248	.	G	A	5	8	13	0	0	13	0	0
15	1893276	.	C	T	14	12	26	0	1	27	0	0
15	1893293	.	C	G	13	12	25	0	1	26	0	0
15	1893323	.	G	A	0	10	10	0	11	21	0	0
15	1893356	.	A	G	9	0	9	0	12	21	0	0
15	1894694	.	A	G	11	7	18	0	0	18	0	0
15	1895469	.	G	A	18	8	26	0	0	26	0	0
15	1895505	.	G	C	15	10	25	0	1	26	0	0
15	1897576	.	T	C	19	12	31	0	0	31	0	0
15	1898173	.	T	A	5	3	8	0	0	8	0	0
15	1898384	.	T	C	3	2	5	0	0	5	0	0
15	1899203	.	G	A	0	4	4	1	4	9	0	0
15	1899217	.	A	T	4	5	9	1	1	11	0	0
15	1899304	.	A	C	2	4	6	0	0	6	0	0
15	1899395	.	G	A	1	4	5	1	2	8	0	0
15	1899878	.	T	C	13	6	19	0	0	19	0	0
15	1902259	.	A	G	7	6	13	0	2	15	0	0
15	1905364	.	T	G	9	6	15	0	0	15	0	0
15	2182569	.	G	A	7	11	18	0	0	18	0	0
15	2182752	.	G	C	11	9	20	0	0	20	0	0
15	2182848	.	C	T	8	2	10	0	1	11	0	0
15	2413923	.	T	G	5	4	9	0	0	9	0	0
15	2413970	.	T	G	6	0	6	0	3	9	0	0
15	2414114	.	T	A	2	2	4	0	0	4	0	0
15	2414140	.	T	A	5	2	7	0	0	7	0	0
15	2414160	.	C	T	5	3	8	0	1	9	0	0
15	2414177	.	G	A	7	4	11	0	2	13	0	0
15	2414254	.	A	G	6	2	8	0	0	8	0	0
15	2414276	.	A	G	5	5	10	0	0	10	0	0
15	2414635	.	T	C	5	3	8	0	2	10	0	0
15	2414652	.	T	G	5	3	8	0	1	9	0	0
15	2414764	.	A	G	6	2	8	0	0	8	0	0
15	2414839	.	A	G	7	2	9	0	0	9	0	0
15	2414840	.	T	A	7	2	9	0	0	9	0	0
15	2435805	.	C	T	1	3	4	0	0	4	0	0
15	2435850	.	G	A	2	3	5	0	0	5	0	0
15	2444024	.	C	T	2	2	4	0	0	4	0	0
15	2451348	.	G	A	4	4	8	0	0	8	0	0
15	2451358	.	C	G	4	0	4	0	5	9	0	0
15	2458640	.	A	G	1	0	1	0	7	8	0	0
15	2458641	.	G	T	1	7	8	0	0	8	0	0
15	2459656	.	A	G	6	5	11	1	0	12	0	0
15	2459773	.	G	A	5	3	8	0	1	9	0	0
15	2459903	.	A	G	3	5	8	0	0	8	0	0
15	2459963	.	C	T	5	3	8	0	0	8	0	0
15	2463308	.	T	C	12	8	20	0	1	21	0	0
15	2463309	.	G	C	12	9	21	0	0	21	0	0
15	2485111	.	T	C	3	4	7	0	0	7	0	0
15	2502722	.	T	C	1	5	6	0	0	6	0	0
15	2502741	.	C	T	1	6	7	0	0	7	0	0
15	2502967	.	C	G	4	2	6	0	0	6	0	0
15	2502992	.	A	G	6	0	6	0	3	9	0	0
15	2515421	.	C	T	11	7	18	0	2	20	0	0
15	2524365	.	A	G	2	0	2	0	3	5	0	0
15	2524401	.	C	T	5	2	7	0	0	7	0	0
15	2524684	.	T	C	4	8	12	0	2	14	0	0
15	2527072	.	T	C	4	8	12	0	0	12	0	0
15	2527105	.	G	A	5	2	7	0	0	7	0	0
15	2530457	.	A	G	4	0	4	0	5	9	0	0
15	2533340	.	A	G	8	6	14	0	0	14	0	0
15	2533397	.	A	G	4	6	10	0	0	10	0	0
15	2533468	.	C	G	4	4	8	0	0	8	0	0
15	2534772	.	T	G	3	0	3	0	3	6	0	0
15	2538060	.	A	G	3	5	8	0	0	8	0	0
15	2539821	.	G	A	7	4	11	0	3	14	0	0
15	2539958	.	C	A	5	3	8	0	1	9	0	0
15	2543388	.	G	T	9	7	16	0	0	16	0	0
15	2543418	.	G	C	1	9	10	0	6	16	0	0
15	2543476	.	C	T	7	4	11	0	1	12	0	0
15	2543478	.	T	C	6	4	10	0	2	12	0	0
15	2543548	.	T	G	4	3	7	0	0	7	0	0
15	2543675	.	A	G	1	6	7	0	0	7	0	0
15	2560436	.	A	G	2	4	6	0	1	7	0	0
15	2560484	.	C	T	3	5	8	0	0	8	0	0
15	2560694	.	G	A	2	2	4	0	0	4	0	0
15	2572481	.	C	T	6	8	14	0	0	14	0	0
15	2572910	.	G	A	1	4	5	0	6	11	0	0
15	2578043	.	C	A	6	5	11	0	0	11	0	0
15	2590271	.	T	A	1	2	3	0	0	3	0	0
15	2590559	.	A	T	2	2	4	0	0	4	0	0
15	2590856	.	C	T	0	4	4	0	4	8	0	0
15	2593089	.	C	T	4	4	8	0	0	8	0	0
15	2593092	.	T	C	3	5	8	0	0	8	0	0
15	2656891	.	T	C	1	9	10	0	0	10	0	0
15	2656894	.	T	C	1	0	1	0	9	10	0	0
15	2657130	.	C	T	2	2	4	0	0	4	0	0
15	2728221	.	C	T	2	13	15	0	11	26	0	0
15	2728330	.	A	G	14	15	29	0	1	30	0	0
15	2728573	.	C	T	14	11	25	0	3	28	0	0
15	2728641	.	A	C	14	12	26	0	0	26	0	0
15	2728652	.	C	T	14	12	26	0	0	26	0	0
15	2728678	.	G	A	14	7	21	0	0	21	0	0
15	2728806	.	T	G	14	17	31	0	0	31	0	0
15	2728880	.	C	T	2	12	14	0	21	35	0	0
15	2729971	.	T	C	2	5	7	0	0	7	0	0
15	2730321	.	C	T	4	9	13	0	0	13	0	0
15	2730533	.	T	C	12	16	28	0	1	29	0	0
15	2730536	.	G	C	7	0	7	0	20	27	0	0
15	2730744	.	T	C	3	2	5	0	0	5	0	0
15	2730794	.	T	G	2	1	3	0	0	3	0	0
15	2730798	.	T	G	2	2	4	0	0	4	0	0
15	2730927	.	C	T	3	12	15	0	12	27	0	0
15	2739915	.	G	C	13	7	20	0	0	20	0	0
15	2742070	.	A	T	2	11	13	0	0	13	0	0
15	2744699	.	G	A	7	8	15	0	1	16	0	0
15	2746309	.	A	G	11	6	17	0	0	17	0	0
15	2746467	.	A	G	5	9	14	0	1	15	0	0
15	2747608	.	G	A	4	11	15	0	0	15	0	0
15	2747614	.	A	G	3	12	15	0	0	15	0	0
15	2747650	.	C	T	4	5	9	0	0	9	0	0
15	2747686	.	A	G	1	5	6	0	0	6	0	0
15	2750638	.	G	T	8	13	21	0	1	22	0	0
15	2750671	.	A	G	9	16	25	0	0	25	0	0
15	2750716	.	G	T	8	11	19	0	0	19	0	0
15	2778479	.	T	C	1	1	2	0	1	3	0	0
15	2778803	.	G	A	6	2	8	1	0	9	0	0
15	2779311	.	A	C	3	2	5	0	0	5	0	0
15	2851511	.	A	G	4	3	7	0	2	9	0	0
15	2851550	.	G	A	5	2	7	0	1	8	0	0
15	2851569	.	A	C	7	3	10	0	1	11	0	0
15	2851934	.	A	G	1	3	4	0	0	4	0	0
15	2851936	.	C	A	1	2	3	0	1	4	0	0
15	2852074	.	A	G	1	2	3	0	0	3	0	0
15	2852199	.	T	C	1	4	5	0	0	5	0	0
15	2852436	.	T	C	7	6	13	0	0	13	0	0
15	2855289	.	T	C	7	4	11	0	0	11	0	0
15	2855303	.	G	A	7	5	12	0	0	12	0	0
15	2855334	.	T	A	7	3	10	0	0	10	0	0
15	2857425	.	A	G	2	7	9	0	1	10	0	0
15	2862156	.	G	T	2	2	4	0	0	4	0	0
15	2862169	.	A	G	1	0	1	0	2	3	0	0
15	2863891	.	T	A	2	2	4	0	0	4	0	0
15	2875501	.	A	T	4	5	9	0	0	9	0	0
15	2876720	.	T	C	3	2	5	0	0	5	0	0
15	2876938	.	A	G	7	3	10	0	0	10	0	0
15	2876956	.	G	T	0	4	4	0	3	7	0	0
15	2877011	.	T	A	2	2	4	0	0	4	0	0
15	2988126	.	T	A	13	9	22	0	1	23	0	0
15	2988136	.	T	G	18	8	26	0	0	26	0	0
15	2988414	.	C	A	14	6	20	0	1	21	0	0
15	2988420	.	C	T	1	6	7	0	13	20	0	0
15	2989361	.	T	G	7	12	19	0	0	19	0	0
15	2994265	.	C	T	1	12	13	0	10	23	0	0
15	2994309	.	T	G	15	9	24	0	1	25	0	0
15	2995080	.	T	C	16	10	26	0	0	26	0	0
15	2999113	.	C	A	0	13	13	0	10	23	0	0
15	2999209	.	G	A	12	9	21	0	1	22	0	0
15	3000194	.	T	C	12	10	22	0	2	24	0	0
15	3000311	.	C	T	12	8	20	3	0	23	0	0
15	3000347	.	T	C	10	0	10	3	10	23	0	0
15	3000472	.	C	A	14	9	23	0	0	23	0	0
15	3003682	.	T	C	10	0	10	0	8	18	0	0
15	3005511	.	C	T	9	7	16	0	2	18	0	0
15	3005538	.	G	A	12	9	21	0	0	21	0	0
15	3005556	.	C	A	1	6	7	0	9	16	0	0
15	3005578	.	A	G	6	8	14	0	0	14	0	0
15	3008831	.	C	T	0	7	7	0	4	11	0	0
15	3008833	.	T	A	4	7	11	0	0	11	0	0
15	3009497	.	T	A	11	6	17	0	1	18	0	0
15	3011241	.	C	T	0	8	8	0	9	17	0	0
15	3020470	.	G	A	3	7	10	0	2	12	0	0
15	3020475	.	G	A	4	7	11	0	2	13	0	0
15	3020598	.	T	A	6	7	13	0	1	14	0	0
15	3024971	.	G	T	6	7	13	0	0	13	0	0
15	3027321	.	T	A	9	4	13	0	0	13	0	0
15	3027378	.	T	C	6	0	6	0	7	13	0	0
15	3037393	.	T	C	8	0	8	0	12	20	0	0
15	3134816	.	T	G	4	0	4	0	2	6	0	0
15	3138744	.	C	T	5	5	10	0	0	10	0	0
15	3144060	.	C	T	7	3	10	0	0	10	0	0
15	3146653	.	A	G	5	0	5	0	4	9	0	0
15	3150705	.	T	C	6	3	9	0	0	9	0	0
15	3150717	.	T	G	7	2	9	0	2	11	0	0
15	3154785	.	C	T	8	4	12	0	0	12	0	0
15	3154872	.	C	A	5	5	10	0	1	11	0	0
15	3156844	.	T	C	3	6	9	0	0	9	0	0
15	3156847	.	T	A	3	8	11	0	0	11	0	0
15	3170088	.	T	C	2	2	4	0	0	4	0	0
15	3170096	.	C	A	2	2	4	0	0	4	0	0
15	3189425	.	T	C	1	3	4	0	0	4	0	0
15	3190432	.	C	G	2	4	6	0	0	6	0	0
15	3191981	.	A	T	1	2	3	0	1	4	0	0
15	3223085	.	T	A	3	2	5	0	0	5	0	0
15	3223091	.	C	G	2	3	5	0	0	5	0	0
15	3223139	.	T	C	1	5	6	0	0	6	0	0
15	3372220	.	A	T	2	2	4	0	0	4	0	0
15	3372223	.	A	C	2	2	4	0	0	4	0	0
15	3375493	.	G	A	3	2	5	0	0	5	0	0
15	3376685	.	A	C	4	4	8	0	0	8	0	0
15	3376700	.	T	C	3	3	6	0	0	6	0	0
15	3376837	.	T	C	11	5	16	1	0	17	0	0
15	3376850	.	T	G	12	4	16	1	0	17	0	0
15	3377050	.	C	G	5	4	9	0	0	10	1	0
15	3377106	.	C	T	5	3	8	0	0	8	0	0
15	3377453	.	G	A	0	4	4	0	4	8	0	0
15	3377481	.	T	G	4	3	7	0	0	7	0	0
15	3377539	.	T	G	7	3	10	0	0	10	0	0
15	3377562	.	A	C	6	3	9	0	0	9	0	0
15	3377727	.	T	G	4	4	8	0	0	8	0	0
15	3378164	.	A	C	4	6	10	0	1	11	0	0
15	3378189	.	C	T	9	7	16	0	0	16	0	0
15	3456168	.	A	G	14	6	20	0	0	20	0	0
15	3456169	.	C	T	14	6	20	0	0	20	0	0
15	3456223	.	T	C	8	0	8	0	3	11	0	0
15	3456306	.	T	A	3	6	9	0	1	10	0	0
15	3456353	.	G	A	6	7	13	0	0	13	0	0
15	3477016	.	C	T	1	3	4	0	2	6	0	0
15	3494111	.	G	A	6	4	10	0	0	11	1	0
15	3494132	.	A	G	5	4	9	0	0	9	0	0
15	3503008	.	A	T	4	3	7	0	0	7	0	0
15	3529573	.	T	G	3	6	9	0	0	9	0	0
15	3531087	.	T	C	2	3	5	0	0	5	0	0
15	3534556	.	G	A	5	4	9	0	0	9	0	0
15	3534558	.	T	G	4	4	8	0	1	9	0	0
15	3539174	.	G	A	6	7	13	0	0	13	0	0
15	3651308	.	C	G	12	5	17	0	0	17	0	0
15	3651359	.	T	C	8	8	16	0	0	16	0	0
15	3674902	.	A	T	1	4	5	0	0	5	0	0
15	3676818	.	A	G	2	7	9	0	0	9	0	0
15	3680515	.	T	C	4	2	6	0	0	6	0	0
15	3685012	.	T	C	2	6	8	0	1	9	0	0
15	3686983	.	T	A	3	4	7	0	0	7	0	0
15	3734944	.	C	A	6	8	14	0	0	14	0	0
15	3734950	.	G	A	4	8	12	0	1	13	0	0
15	3735338	.	T	C	5	0	5	0	7	12	0	0
15	3735635	.	A	G	1	3	4	0	0	4	0	0
15	3825514	.	A	T	1	2	3	0	0	3	0	0
15	3825638	.	T	A	2	2	4	0	0	4	0	0
15	3900035	.	T	C	1	4	5	0	0	5	0	0
15	3900258	.	A	G	2	3	5	0	0	5	0	0
15	3900550	.	T	C	1	3	4	0	0	4	0	0
15	3920926	.	A	G	3	1	4	0	1	5	0	0
15	3921218	.	C	T	3	6	9	0	1	10	0	0
15	3921247	.	G	A	0	3	3	0	4	7	0	0
15	3921292	.	A	G	3	0	3	0	3	6	0	0
15	3921308	.	A	G	3	3	6	0	0	6	0	0
15	3922638	.	C	T	1	2	3	0	0	3	0	0
15	3922718	.	T	C	2	5	7	0	0	7	0	0
15	3922752	.	C	A	4	4	8	0	2	10	0	0
15	3922776	.	A	G	4	4	8	0	1	9	0	0
15	3923082	.	T	G	2	2	4	0	0	4	0	0
15	3923094	.	T	G	3	1	4	0	1	5	0	0
15	3924312	.	A	T	8	4	12	0	0	12	0	0
15	3924349	.	C	G	5	4	9	0	0	9	0	0
15	3924381	.	T	C	1	6	7	0	1	8	0	0
15	3924542	.	G	A	6	4	10	0	1	11	0	0
15	3924600	.	T	G	4	2	6	0	0	6	0	0
15	3924601	.	T	G	2	2	4	0	1	5	0	0
15	3928300	.	T	C	1	3	4	0	0	4	0	0
15	3929811	.	C	A	1	2	3	0	0	3	0	0
15	4104889	.	T	A	2	3	5	0	0	5	0	0
15	4105164	.	C	T	1	6	7	0	9	16	0	0
15	4105168	.	T	G	8	7	15	0	0	15	0	0
15	4105235	.	T	C	4	5	9	0	2	11	0	0
15	4111649	.	T	C	2	2	4	0	1	5	0	0
15	4112123	.	A	T	3	5	8	0	2	10	0	0
15	4112132	.	T	C	6	3	9	0	1	10	0	0
15	4119284	.	A	G	3	7	10	0	0	10	0	0
15	4119323	.	G	A	3	8	11	0	0	11	0	0
15	4119329	.	A	G	2	8	10	0	0	10	0	0
15	4172470	.	A	G	6	9	15	0	0	15	0	0
15	4180093	.	C	A	1	10	11	0	5	16	0	0
15	4182667	.	T	C	3	0	3	0	15	18	0	0
15	4182718	.	A	G	8	6	14	0	1	15	0	0
15	4202222	.	G	A	1	3	4	0	0	4	0	0
15	4202300	.	T	C	7	4	11	0	0	11	0	0
15	4210264	.	C	G	5	6	11	0	0	11	0	0
15	4210315	.	G	A	5	6	11	0	1	12	0	0
15	4214109	.	A	G	5	4	9	0	0	9	0	0
15	4214139	.	T	C	4	6	10	0	0	10	0	0
15	4214178	.	C	T	1	11	12	0	6	18	0	0
15	4214223	.	A	G	5	8	13	0	1	14	0	0
15	4314014	.	C	A	4	8	12	0	0	12	0	0
15	4353353	.	C	T	12	27	39	0	2	41	0	0
15	4353858	.	C	T	21	30	51	0	4	55	0	0
15	4354071	.	G	A	37	29	66	0	2	68	0	0
15	4354082	.	G	A	34	29	63	0	2	65	0	0
15	4367594	.	T	C	34	26	60	0	1	61	0	0
15	4376110	.	C	T	4	24	28	0	23	51	0	0
15	4422128	.	G	T	2	5	7	0	0	7	0	0
15	4422580	.	A	G	3	4	7	0	0	7	0	0
15	4426474	.	C	T	5	3	8	0	0	8	0	0
15	4429003	.	C	T	1	3	4	0	1	5	0	0
15	4429004	.	G	A	2	3	5	0	0	5	0	0
15	4445081	.	A	G	4	4	8	0	0	8	0	0
15	4475630	.	A	C	2	3	5	0	0	5	0	0
15	4528309	.	G	A	1	2	3	0	1	4	0	0
15	4585517	.	T	C	7	1	8	0	8	16	0	0
15	4585771	.	T	A	14	8	22	0	0	22	0	0
15	4586190	.	C	G	1	21	22	0	11	34	1	0
15	4586235	.	A	G	13	16	29	0	2	31	0	0
15	4586299	.	G	T	5	12	17	0	1	18	0	0
15	4632798	.	C	A	1	2	3	0	0	3	0	0
15	4633700	.	C	G	22	0	22	0	27	49	0	0
15	4634063	.	C	T	18	31	49	0	3	52	0	0
15	4634196	.	T	C	20	19	39	0	0	39	0	0
15	4634354	.	A	G	14	25	39	0	4	43	0	0
15	4634454	.	A	G	25	24	49	0	0	49	0	0
15	4634627	.	A	G	24	18	42	0	4	46	0	0
15	4634698	.	C	A	31	7	38	2	2	42	0	0
15	4635055	.	G	A	5	26	31	0	24	55	0	0
15	4635073	.	T	C	32	22	54	0	3	57	0	0
15	4635179	.	C	A	28	22	50	0	4	54	0	0
15	4635387	.	C	T	28	18	46	0	2	48	0	0
15	4635573	.	C	T	32	12	44	2	0	46	0	0
15	4635730	.	G	A	15	5	20	0	0	20	0	0
15	4969267	.	T	C	3	3	6	0	2	8	0	0
15	4969331	.	C	T	1	4	5	0	0	5	0	0
15	4969522	.	C	G	2	3	5	0	0	5	0	0
15	4969558	.	C	T	3	4	7	0	1	8	0	0
15	4976106	.	G	A	0	3	3	0	1	4	0	0
15	4976152	.	A	C	1	3	4	0	0	4	0	0
15	4981675	.	G	T	3	3	6	0	1	7	0	0
15	4981727	.	A	G	2	0	2	0	3	5	0	0
15	4981963	.	C	T	6	2	8	0	0	8	0	0
15	4982614	.	T	C	3	7	10	0	1	11	0	0
15	4982744	.	C	A	5	4	9	0	0	9	0	0
15	4982828	.	A	T	4	3	7	0	2	9	0	0
15	4983533	.	A	T	2	5	7	0	0	7	0	0
15	4983708	.	A	T	3	2	5	0	0	5	0	0
15	4983781	.	T	C	3	2	5	0	0	5	0	0
15	4984277	.	G	T	2	3	5	0	0	5	0	0
15	4984303	.	T	C	3	6	9	0	0	9	0	0
15	4984740	.	T	C	5	9	14	0	1	15	0	0
15	4984759	.	T	C	9	8	17	0	0	17	0	0
15	4991716	.	T	C	16	19	35	0	1	36	0	0
15	4991722	.	A	G	17	0	17	0	17	34	0	0
15	4995166	.	A	G	9	17	26	1	6	33	0	0
15	4999347	.	G	C	10	10	20	0	0	20	0	0
15	4999572	.	G	C	16	19	35	0	0	35	0	0
15	5067369	.	T	C	3	2	5	0	0	5	0	0
15	5067463	.	T	A	3	3	6	0	0	6	0	0
15	5069917	.	A	T	2	2	4	0	0	4	0	0
15	5073626	.	T	C	2	2	4	0	1	5	0	0
15	5073641	.	G	A	2	5	7	0	0	7	0	0
15	5073848	.	A	G	3	0	3	0	5	8	0	0
15	5074033	.	G	A	6	3	9	0	0	9	0	0
15	5074208	.	G	A	1	3	4	0	0	4	0	0
15	5074281	.	G	T	1	2	3	0	0	3	0	0
15	5074372	.	G	A	3	4	7	0	0	7	0	0
15	5074439	.	G	A	1	2	3	0	0	3	0	0
15	5074454	.	A	G	1	2	3	0	0	3	0	0
15	5074793	.	T	G	2	4	6	0	1	7	0	0
15	5074799	.	T	C	2	5	7	0	0	7	0	0
15	5074873	.	A	G	6	8	14	0	0	14	0	0
15	5116298	.	C	T	1	2	3	0	0	3	0	0
15	5116335	.	T	C	2	2	4	0	2	6	0	0
15	5133457	.	G	A	4	4	8	0	0	8	0	0
15	5133469	.	C	T	3	3	6	0	1	7	0	0
15	5140246	.	A	G	4	0	4	0	4	8	0	0
15	5140578	.	A	G	5	4	9	0	0	9	0	0
15	5140807	.	G	A	3	4	7	0	0	7	0	0
15	5140867	.	A	T	1	3	4	0	0	4	0	0
15	5142205	.	C	T	2	8	10	0	0	10	0	0
15	5144775	.	T	C	3	7	10	0	0	10	0	0
15	5144805	.	A	C	4	6	10	0	2	12	0	0
15	5144931	.	G	A	4	5	9	0	0	9	0	0
15	5145104	.	C	A	6	3	9	0	0	9	0	0
15	5145137	.	A	C	5	4	9	0	0	9	0	0
15	5147722	.	T	C	7	4	11	0	0	11	0	0
15	5147723	.	A	T	8	4	12	0	0	12	0	0
15	5147843	.	C	T	4	2	6	0	0	6	0	0
15	5147987	.	T	C	3	5	8	0	1	9	0	0
15	5148387	.	T	A	3	2	5	0	0	5	0	0
15	5148519	.	T	A	1	2	3	0	0	3	0	0
15	5148562	.	G	A	1	3	4	0	0	4	0	0
15	5148700	.	T	C	1	2	3	0	0	3	0	0
15	5148710	.	C	A	1	2	3	0	0	3	0	0
15	5403687	.	A	C	10	11	21	0	0	21	0	0
15	5406334	.	A	G	13	7	20	0	1	21	0	0
15	5412406	.	C	T	8	6	14	0	0	14	0	0
15	5467178	.	T	G	5	2	7	0	1	8	0	0
15	5467289	.	C	T	2	4	6	0	11	17	0	0
15	5556782	.	C	T	0	2	2	0	2	4	0	0
15	5563346	.	G	A	2	2	4	0	0	4	0	0
15	5568926	.	G	A	3	2	5	0	0	5	0	0
15	5570295	.	G	A	5	2	7	0	0	7	0	0
15	5591078	.	T	C	1	2	3	0	0	3	0	0
15	5632736	.	G	A	2	3	5	0	0	5	0	0
15	5648119	.	G	A	6	2	8	0	0	8	0	0
15	5660030	.	G	A	5	2	7	0	0	7	0	0
15	5660306	.	G	C	6	3	9	0	0	9	0	0
15	5708735	.	T	C	1	0	1	0	2	3	0	0
15	5719484	.	A	G	1	3	4	0	0	4	0	0
15	5723734	.	C	A	4	4	8	0	0	8	0	0
15	5723938	.	T	G	7	4	11	0	2	13	0	0
15	5723980	.	C	G	0	3	3	0	7	10	0	0
15	5726178	.	T	A	9	3	12	0	0	12	0	0
15	5728461	.	A	G	3	4	7	0	2	9	0	0
15	5738967	.	A	G	6	3	9	0	0	9	0	0
15	5829662	.	A	C	5	0	5	0	8	13	0	0
15	5829881	.	A	C	5	0	5	0	3	8	0	0
15	5829922	.	C	T	8	7	15	0	0	15	0	0
15	5830106	.	G	T	6	5	11	0	0	11	0	0
15	5830218	.	T	C	6	6	12	0	0	12	0	0
15	5830443	.	T	G	17	5	22	0	0	22	0	0
15	5830492	.	C	T	1	5	6	0	7	13	0	0
15	5830513	.	C	T	2	6	8	0	0	8	0	0
15	5830655	.	C	T	1	7	8	0	7	15	0	0
15	5830691	.	T	C	11	8	19	0	0	19	0	0
15	5830696	.	C	T	1	13	14	0	8	22	0	0
15	5830740	.	G	T	6	12	18	0	0	18	0	0
15	5831004	.	G	A	6	11	17	0	0	17	0	0
15	5831199	.	G	A	9	6	15	0	0	15	0	0
15	5836499	.	G	A	5	8	13	0	0	13	0	0
15	5836532	.	C	T	5	8	13	0	0	13	0	0
15	5836542	.	C	T	6	6	12	0	0	13	1	0
15	5836610	.	G	T	14	6	20	0	0	20	0	0
15	5837181	.	T	C	3	0	3	0	3	6	0	0
15	5842163	.	T	A	3	6	9	0	0	9	0	0
15	5853041	.	T	C	2	4	6	0	0	6	0	0
15	5853119	.	A	T	1	5	6	0	0	6	0	0
15	5857224	.	A	G	5	7	12	0	0	12	0	0
15	5862571	.	C	T	2	2	4	0	0	4	0	0
15	5862639	.	A	T	1	7	8	0	1	9	0	0
15	5865261	.	A	G	7	3	10	0	1	11	0	0
15	5870890	.	G	A	1	2	3	0	0	3	0	0
15	5898511	.	T	A	7	9	16	0	2	18	0	0
15	5898856	.	A	G	21	21	42	0	1	43	0	0
15	5898920	.	A	C	15	16	31	0	1	32	0	0
15	5899083	.	C	T	0	15	15	0	27	42	0	0
15	5899113	.	G	A	1	36	37	0	1	40	2	0
15	5899237	.	C	A	0	9	9	0	13	22	0	0
15	5899277	.	A	G	9	2	11	0	5	16	0	0
15	5904761	.	T	C	22	13	35	0	0	35	0	0
15	5914994	.	G	A	2	15	17	0	26	43	0	0
15	5916387	.	C	A	14	18	32	0	0	32	0	0
15	5916389	.	G	C	14	17	31	0	1	32	0	0
15	5916442	.	G	A	13	12	25	0	1	26	0	0
15	5916651	.	A	T	4	3	7	0	1	8	0	0
15	6139624	.	G	C	16	10	26	0	1	27	0	0
15	6139800	.	G	A	18	20	38	0	5	43	0	0
15	6139803	.	C	T	17	21	38	0	5	43	0	0
15	6154439	.	T	A	20	17	37	0	1	38	0	0
15	6161235	.	A	G	17	7	24	0	1	25	0	0
15	6161789	.	A	G	9	12	21	0	0	21	0	0
15	6161804	.	C	T	3	8	11	0	7	18	0	0
15	6174544	.	T	G	8	6	14	0	1	15	0	0
15	6186503	.	A	G	6	9	15	0	0	15	0	0
15	6217600	.	A	G	6	6	12	0	0	12	0	0
15	6957221	.	C	G	6	10	16	0	0	16	0	0
15	7300826	.	T	C	6	3	9	0	1	10	0	0
15	8437030	.	A	G	5	2	7	0	1	8	0	0
15	8437062	.	T	G	3	2	5	0	0	5	0	0
15	8442793	.	T	G	1	3	4	0	0	4	0	0
15	8485026	.	T	C	2	2	4	0	0	4	0	0
15	8485104	.	T	G	1	2	3	0	0	3	0	0
15	8485185	.	T	C	2	2	4	0	1	5	0	0
15	8485191	.	T	C	4	1	5	0	1	6	0	0
15	8604835	.	A	C	15	12	27	1	0	28	0	0
15	8605259	.	C	A	13	11	24	0	2	26	0	0
15	8605318	.	G	A	13	16	29	0	1	30	0	0
15	8605452	.	C	A	11	8	19	0	0	19	0	0
15	8605838	.	T	A	11	9	20	0	2	22	0	0
15	8605839	.	A	T	11	11	22	0	1	23	0	0
15	8605972	.	T	A	8	15	23	0	2	25	0	0
15	8606207	.	A	T	8	5	13	0	1	14	0	0
15	8606224	.	G	A	4	5	9	0	0	9	0	0
15	8606256	.	A	C	7	8	15	0	0	15	0	0
15	8606464	.	A	G	12	14	26	0	0	26	0	0
15	8606501	.	G	A	10	11	21	0	1	22	0	0
15	8606507	.	G	A	10	12	22	0	0	22	0	0
15	8606555	.	C	T	11	8	19	0	0	19	0	0
15	8606601	.	A	C	10	8	18	0	0	18	0	0
15	8606619	.	A	G	10	9	19	0	1	20	0	0
15	8606799	.	T	G	7	8	15	0	3	18	0	0
15	8606872	.	C	A	12	9	21	0	0	21	0	0
15	8606897	.	T	C	14	5	19	0	0	19	0	0
15	8606940	.	T	G	9	13	22	0	0	22	0	0
15	8606943	.	T	G	8	13	21	0	0	21	0	0
15	8607025	.	T	A	8	13	21	0	1	22	0	0
15	8607182	.	T	A	8	10	18	0	2	20	0	0
15	8607365	.	G	T	12	19	31	0	5	36	0	0
15	8607846	.	T	A	8	17	25	0	2	27	0	0
15	8661671	.	C	T	11	11	22	0	0	22	0	0
15	8663798	.	A	G	3	3	6	0	1	7	0	0
15	8665317	.	A	C	3	4	7	0	1	8	0	0
15	8665414	.	G	A	2	9	11	0	0	11	0	0
15	8665459	.	C	T	0	7	7	0	3	10	0	0
15	8665481	.	G	A	2	8	10	0	1	11	0	0
15	8665506	.	A	G	4	6	10	0	0	10	0	0
15	8797850	.	T	C	22	26	48	0	2	50	0	0
15	8799060	.	T	G	26	23	49	0	0	50	1	0
15	8799065	.	A	G	19	28	47	0	1	48	0	0
15	8799141	.	T	A	18	20	38	0	1	39	0	0
15	8799462	.	T	A	19	14	33	2	0	35	0	0
15	8799713	.	G	A	19	25	44	0	4	48	0	0
15	8799730	.	T	G	14	1	15	0	35	50	0	0
15	8799831	.	T	C	17	13	30	0	0	30	0	0
15	8799856	.	G	A	14	16	30	0	0	30	0	0
15	8799872	.	C	A	19	13	32	0	0	32	0	0
15	8799892	.	C	T	17	10	27	0	1	28	0	0
15	8799916	.	T	C	15	10	25	0	1	26	0	0
15	8813971	.	G	A	1	5	6	0	0	6	0	0
15	8814221	.	G	T	4	3	7	0	0	7	0	0
15	8856248	.	C	T	0	3	3	0	2	5	0	0
15	8856283	.	G	T	5	3	8	0	1	9	0	0
15	8856293	.	C	T	8	2	10	0	2	12	0	0
15	8991952	.	T	G	1	2	3	0	0	3	0	0
15	9001912	.	A	T	1	2	3	0	0	3	0	0
15	9020621	.	C	T	3	3	6	0	0	6	0	0
15	9022711	.	A	G	3	2	5	0	0	5	0	0
15	9022736	.	C	T	0	3	3	0	4	7	0	0
15	9234102	.	A	C	15	18	33	0	3	36	0	0
15	9234114	.	A	G	18	21	39	0	3	43	1	0
15	9234156	.	A	C	33	17	50	0	3	53	0	0
15	9234634	.	A	T	21	22	43	0	0	43	0	0
15	9234885	.	A	G	40	29	69	0	1	70	0	0
15	9234960	.	C	T	31	30	61	0	4	65	0	0
15	9234972	.	T	C	34	28	62	0	2	64	0	0
15	9235081	.	C	G	37	32	69	0	3	72	0	0
15	9235128	.	A	C	31	28	59	0	2	61	0	0
15	9235254	.	A	G	32	31	63	0	0	63	0	0
15	9235319	.	C	T	30	32	62	0	0	62	0	0
15	9235461	.	T	G	47	14	61	0	2	64	1	0
15	9249293	.	G	A	37	30	67	1	2	70	0	0
15	9249344	.	C	T	31	35	66	1	2	69	0	0
15	9249346	.	A	G	33	34	67	1	1	69	0	0
15	9272219	.	G	T	17	14	31	6	3	40	0	0
15	9315612	.	C	A	2	6	8	0	0	8	0	0
15	9319051	.	T	C	9	0	9	0	12	21	0	0
15	9321930	.	C	A	1	2	3	0	0	3	0	0
15	9367812	.	G	A	8	8	16	0	0	16	0	0
15	9367842	.	T	C	3	11	14	0	0	14	0	0
15	9368757	.	G	A	6	9	15	0	2	17	0	0
15	9368834	.	A	G	14	7	21	1	0	22	0	0
15	9369114	.	T	C	11	12	23	0	1	24	0	0
15	9369293	.	T	A	5	10	15	0	0	15	0	0
15	9369571	.	A	T	3	3	6	0	0	6	0	0
15	9369610	.	A	T	2	5	7	0	0	7	0	0
15	9369651	.	G	C	8	4	12	0	0	12	0	0
15	9369689	.	G	A	9	9	18	0	0	18	0	0
15	9369733	.	C	T	8	10	18	0	0	18	0	0
15	9369737	.	C	G	10	8	18	0	1	19	0	0
15	9370096	.	T	C	8	10	18	0	1	19	0	0
15	9370115	.	G	A	15	6	21	0	0	21	0	0
15	9370131	.	C	T	14	6	20	0	1	21	0	0
15	9370400	.	T	C	5	3	8	0	0	8	0	0
15	9370477	.	A	G	1	6	7	0	1	8	0	0
15	9370492	.	C	G	3	7	10	0	0	10	0	0
15	9370534	.	T	A	3	10	13	0	0	13	0	0
15	9370553	.	C	T	7	6	13	0	0	13	0	0
15	9370919	.	G	T	9	8	17	0	2	19	0	0
15	9370967	.	T	C	11	0	11	0	9	20	0	0
15	9371303	.	G	A	10	5	15	0	0	15	0	0
15	9371564	.	A	G	9	5	14	0	1	15	0	0
15	9371657	.	T	C	9	4	13	0	0	13	0	0
15	9371678	.	A	G	9	5	14	0	0	14	0	0
15	9372281	.	C	T	6	8	14	0	2	16	0	0
15	9372356	.	T	A	6	5	11	0	2	13	0	0
15	9372470	.	A	G	1	11	12	0	0	12	0	0
15	9372500	.	G	A	5	10	15	0	1	16	0	0
15	9372539	.	G	A	6	4	10	0	0	10	0	0
15	9372730	.	G	A	4	5	9	0	0	9	0	0
15	9372929	.	C	T	3	5	8	0	0	8	0	0
15	9373205	.	G	A	1	7	8	0	0	8	0	0
15	9373698	.	T	C	4	2	6	0	0	6	0	0
15	9373801	.	C	T	3	2	5	0	0	5	0	0
15	9373901	.	G	T	3	2	5	0	0	5	0	0
15	9373967	.	A	G	2	2	4	0	0	4	0	0
15	9374174	.	T	C	1	3	4	0	1	5	0	0
15	9374363	.	G	A	3	2	5	0	1	6	0	0
15	9374527	.	G	T	1	4	5	0	0	5	0	0
15	9374627	.	A	T	2	4	6	0	0	6	0	0
15	9374860	.	A	T	1	4	5	0	0	5	0	0
15	9375002	.	G	T	1	7	8	0	0	8	0	0
15	9375542	.	C	T	1	2	3	0	0	3	0	0
15	9375767	.	C	G	3	4	7	0	0	7	0	0
15	9375773	.	A	G	3	4	7	0	0	7	0	0
15	9377192	.	A	G	2	4	6	0	0	6	0	0
15	9378090	.	A	T	2	4	6	0	0	6	0	0
15	9379178	.	A	G	1	2	3	0	0	3	0	0
15	9379868	.	A	G	4	2	6	0	0	6	0	0
15	9380101	.	A	G	2	2	4	0	0	4	0	0
15	9382293	.	G	T	4	3	7	0	0	7	0	0
15	9382388	.	A	G	2	2	4	0	0	4	0	0
15	9393808	.	G	A	2	2	4	0	1	5	0	0
15	9393874	.	T	C	1	0	1	0	2	3	0	0
15	9419198	.	A	C	2	2	4	0	0	4	0	0
15	9459460	.	C	T	1	4	5	0	1	6	0	0
15	9466497	.	T	C	2	0	2	0	2	4	0	0
15	9466500	.	T	C	2	0	2	0	1	3	0	0
15	9466908	.	A	G	3	2	5	0	0	5	0	0
15	9608255	.	G	T	2	3	5	0	0	5	0	0
15	9608264	.	A	T	2	3	5	0	0	5	0	0
15	9608617	.	A	G	1	2	3	0	0	3	0	0
15	9608710	.	A	C	5	0	5	0	4	9	0	0
15	9613343	.	G	T	1	3	4	0	0	4	0	0
15	9617134	.	T	C	2	1	3	0	2	5	0	0
15	10001851	.	A	G	14	17	31	0	0	31	0	0
15	10002281	.	G	A	11	7	18	0	0	18	0	0
15	10002317	.	G	A	7	3	10	0	0	10	0	0
15	10002478	.	T	C	10	6	16	0	0	16	0	0
15	10002480	.	T	A	8	6	14	0	1	15	0	0
15	10002524	.	T	C	5	2	7	0	0	7	0	0
15	10002545	.	C	T	5	4	9	0	0	9	0	0
15	10002591	.	A	G	7	10	17	0	0	17	0	0
15	10003274	.	C	T	9	14	23	0	2	25	0	0
15	10003357	.	G	A	13	6	19	0	0	19	0	0
15	10003379	.	G	A	10	6	16	0	1	17	0	0
15	10003647	.	C	T	0	7	7	0	11	18	0	0
15	10003767	.	C	T	1	4	5	0	6	11	0	0
15	10025010	.	T	C	8	6	14	0	0	14	0	0
15	10025185	.	A	G	3	6	9	0	0	9	0	0
15	10025508	.	A	G	3	6	9	0	1	10	0	0
15	10025601	.	G	C	6	1	7	0	10	17	0	0
15	10025688	.	G	A	5	5	10	0	0	10	0	0
15	10025760	.	T	G	5	8	13	0	0	13	0	0
15	10027257	.	T	C	5	5	10	0	1	11	0	0
15	10027296	.	A	G	6	7	13	0	0	13	0	0
15	10039622	.	T	C	3	5	8	0	1	9	0	0
15	10039643	.	T	C	5	5	10	0	0	10	0	0
15	10039775	.	A	G	6	3	9	0	0	9	0	0
15	10065534	.	T	A	8	4	12	0	0	12	0	0
15	10065645	.	A	G	4	11	15	0	0	15	0	0
15	10065663	.	A	G	5	9	14	0	0	14	0	0
15	10065735	.	G	A	9	5	14	0	2	16	0	0
15	10065786	.	T	C	9	0	9	0	5	14	0	0
15	10065843	.	T	G	5	4	9	0	0	9	0	0
15	10065846	.	A	G	4	4	8	0	1	9	0	0
15	10066074	.	G	A	5	2	7	0	0	7	0	0
15	10066080	.	G	A	4	1	5	0	1	6	0	0
15	10066203	.	G	T	2	3	5	0	0	5	0	0
15	10066212	.	T	C	4	2	6	0	1	7	0	0
15	10066287	.	A	G	7	2	9	0	0	9	0	0
15	10081882	.	G	A	2	2	4	0	1	5	0	0
15	10081902	.	G	A	4	5	9	0	0	9	0	0
15	10081966	.	G	A	2	4	6	0	0	6	0	0
15	10088507	.	G	A	2	6	8	0	0	8	0	0
15	10088588	.	C	T	4	3	7	0	1	8	0	0
15	10109991	.	G	A	5	3	8	0	0	8	0	0
15	10114779	.	G	A	3	3	6	0	0	6	0	0
15	10114788	.	A	G	4	3	7	0	0	7	0	0
15	10114854	.	T	C	2	0	2	0	6	8	0	0
15	10114884	.	G	A	2	7	9	1	0	10	0	0
15	10114932	.	C	T	2	4	6	1	0	7	0	0
15	10215720	.	G	A	2	3	5	0	1	6	0	0
15	10341020	.	A	G	1	1	2	0	1	3	0	0
15	10455411	.	G	A	2	2	4	0	0	4	0	0
15	11668065	.	A	G	6	4	10	0	0	10	0	0
15	11668633	.	C	T	8	5	13	0	0	13	0	0
15	11669761	.	C	T	2	3	5	0	0	5	0	0
15	11670283	.	A	C	5	6	11	1	0	12	0	0
15	11680132	.	C	T	5	4	9	0	0	9	0	0
15	11681447	.	A	G	5	7	12	0	0	12	0	0
15	11690967	.	T	C	6	2	8	0	0	8	0	0
15	11691008	.	T	G	3	0	3	0	6	9	0	0
15	11757580	.	T	A	13	13	26	0	4	30	0	0
15	11872666	.	T	C	2	2	4	0	0	4	0	0
15	11874021	.	A	G	6	0	6	0	5	11	0	0
15	11874022	.	A	T	5	4	9	0	1	10	0	0
15	11874077	.	T	C	2	5	7	0	0	7	0	0
15	11984084	.	C	T	1	2	3	1	0	4	0	0
15	12096078	.	C	T	6	3	9	0	0	9	0	0
15	12098649	.	C	A	7	4	11	0	0	11	0	0
15	12101952	.	G	A	5	11	16	0	0	16	0	0
15	12103781	.	G	T	5	6	11	0	0	11	0	0
15	12104338	.	C	T	0	6	6	0	6	12	0	0
15	12105681	.	A	G	7	5	12	0	0	12	0	0
15	12105687	.	T	C	8	7	15	0	1	16	0	0
15	12110547	.	A	G	3	5	8	0	0	8	0	0
15	12110755	.	A	C	3	2	5	0	1	6	0	0
15	12110785	.	G	A	5	2	7	0	0	7	0	0
15	12111076	.	A	G	3	2	5	0	1	6	0	0
15	12111160	.	C	A	4	3	7	0	1	8	0	0
15	12112902	.	A	T	5	2	7	0	1	8	0	0
15	12112941	.	T	C	4	2	6	0	0	6	0	0
15	12117601	.	T	A	4	5	9	0	1	10	0	0
15	12118786	.	G	A	2	3	5	0	1	6	0	0
15	12118838	.	T	C	3	7	10	0	0	10	0	0
15	12121443	.	G	A	6	6	12	0	0	12	0	0
15	12293289	.	G	A	29	12	41	0	0	41	0	0
15	12319008	.	C	A	15	25	40	0	1	41	0	0
15	12385876	.	C	G	1	0	1	0	3	4	0	0
15	12500814	.	T	C	6	6	12	0	0	12	0	0
15	12521382	.	T	G	13	12	25	2	0	27	0	0
15	12521405	.	T	G	10	19	29	2	3	34	0	0
15	12521472	.	G	A	14	15	29	0	1	30	0	0
15	12521506	.	A	G	10	17	27	0	2	29	0	0
15	12521680	.	A	C	13	26	39	0	5	44	0	0
15	12521745	.	A	G	11	25	36	0	1	37	0	0
15	12521964	.	A	T	10	9	19	0	2	21	0	0
15	12522031	.	A	T	8	7	15	0	0	15	0	0
15	12522094	.	A	T	9	11	20	0	0	20	0	0
15	12522104	.	T	C	8	13	21	0	0	21	0	0
15	12522132	.	T	G	12	17	29	0	0	29	0	0
15	12522179	.	A	G	13	12	25	0	0	25	0	0
15	12522353	.	T	A	20	13	33	0	0	33	0	0
15	12522514	.	G	A	10	20	30	0	2	32	0	0
15	12522673	.	A	G	10	12	22	0	2	24	0	0
15	12522736	.	C	G	13	21	34	0	0	34	0	0
15	12526710	.	G	A	17	15	32	0	3	35	0	0
15	12545614	.	G	T	12	15	27	0	1	28	0	0
15	14113670	.	T	C	1	6	7	0	0	7	0	0
15	15445876	.	T	C	2	2	4	0	0	4	0	0
15	15445899	.	T	C	1	6	7	0	0	7	0	0
15	15886461	.	A	T	4	17	21	0	0	21	0	0
15	16073139	.	G	A	0	23	23	1	0	24	0	0
15	16073154	.	G	A	34	2	36	0	2	38	0	0
15	16937375	.	T	C	7	9	16	0	0	16	0	0
15	16937405	.	T	C	10	3	13	0	1	14	0	0
15	16937653	.	T	C	5	8	13	0	0	13	0	0
15	17124283	.	A	G	6	9	15	0	0	15	0	0
15	17124296	.	A	G	13	5	18	0	0	18	0	0
15	17125030	.	A	G	2	6	8	0	1	9	0	0
15	17487277	.	A	G	7	4	11	0	0	11	0	0
15	17487293	.	A	G	6	4	10	0	0	10	0	0
15	18019701	.	G	A	7	2	9	0	0	9	0	0
15	18368983	.	G	A	2	2	4	0	1	5	0	0
15	19039830	.	C	A	1	7	8	0	1	9	0	0
15	21716856	.	C	T	1	6	7	0	0	7	0	0
15	23273421	.	C	T	0	3	3	0	1	4	0	0
15	23640678	.	A	C	4	2	6	0	33	39	0	0
15	23745753	.	G	A	0	5	5	0	0	5	0	0
15	23746595	.	A	G	0	2	2	0	0	2	0	0
15	23746603	.	A	G	1	1	2	0	0	2	0	0
15	23818422	.	T	C	16	6	22	0	0	22	0	0
15	24736413	.	A	G	6	6	12	0	0	12	0	0
15	25398157	.	T	C	5	0	5	0	5	10	0	0
15	25485394	.	A	G	2	5	7	0	0	7	0	0
15	25592668	.	T	C	13	4	17	0	1	18	0	0
15	25595702	.	T	C	17	5	22	0	1	23	0	0
15	26400693	.	T	G	0	0	0	0	6	6	0	0
15	26400697	.	T	C	1	0	1	0	4	5	0	0
15	28351656	.	A	G	6	2	8	0	0	8	0	0
15	28539639	.	A	G	15	0	15	0	8	23	0	0
15	30300771	.	A	C	4	1	5	0	13	18	0	0
15	30838991	.	C	A	7	5	12	0	4	16	0	0
15	31866308	.	C	T	3	3	6	0	0	6	0	0
15	31870691	.	T	C	0	4	4	0	1	5	0	0
15	31870694	.	G	A	2	3	5	0	1	6	0	0
15	31877363	.	C	T	7	3	10	0	0	10	0	0
15	31881825	.	G	A	5	4	9	0	1	10	0	0
15	31881873	.	G	A	1	13	14	0	3	17	0	0
15	31881954	.	T	C	3	9	12	0	0	12	0	0
15	31882044	.	A	G	10	3	13	0	0	13	0	0
15	31882167	.	G	A	1	4	5	0	1	6	0	0
15	31882176	.	A	G	3	6	9	0	0	9	0	0
15	31882269	.	G	A	3	4	7	0	0	7	0	0
15	31882272	.	A	G	3	4	7	0	0	7	0	0
15	31882342	.	C	T	7	6	13	0	0	13	0	0
15	31884219	.	A	C	3	3	6	0	1	7	0	0
15	31889086	.	A	G	6	7	13	0	1	14	0	0
15	31889332	.	C	T	2	8	10	0	0	10	0	0
15	31890902	.	T	G	3	5	8	0	0	8	0	0
15	31893536	.	A	C	7	10	17	0	2	19	0	0
15	31893599	.	C	T	11	9	20	0	0	20	0	0
15	31895248	.	A	G	11	0	11	0	9	20	0	0
15	31905040	.	G	A	22	12	34	0	1	35	0	0
15	31905097	.	A	G	13	15	28	0	3	32	1	0
15	31909454	.	A	C	12	11	23	0	2	25	0	0
15	32193250	.	C	T	2	5	7	0	0	7	0	0
15	32193967	.	T	C	1	2	3	0	0	3	0	0
15	32193975	.	A	G	1	1	2	0	1	3	0	0
15	32194286	.	G	A	1	3	4	0	0	4	0	0
15	32194438	.	C	A	1	2	3	0	0	3	0	0
15	32194550	.	A	C	4	3	7	0	0	7	0	0
15	32195432	.	G	A	3	6	9	0	0	9	0	0
15	32195718	.	G	A	4	2	6	0	0	6	0	0
15	32195729	.	A	G	2	2	4	0	0	4	0	0
15	32196412	.	C	T	1	1	2	0	0	2	0	0
15	32197453	.	A	G	1	3	4	0	0	4	0	0
15	32197458	.	T	C	2	3	5	0	0	5	0	0
15	32249188	.	G	A	15	12	27	0	1	28	0	0
15	32259056	.	G	A	16	11	27	0	1	28	0	0
15	32261461	.	G	C	3	12	15	1	16	32	0	0
15	32261464	.	T	C	14	17	31	1	1	33	0	0
15	32265889	.	T	C	12	15	27	0	0	27	0	0
15	32266557	.	A	T	8	9	17	0	1	18	0	0
15	32266921	.	G	A	1	12	13	0	12	25	0	0
15	32267078	.	A	G	3	4	7	0	1	8	0	0
15	32349742	.	A	G	10	8	18	2	0	20	0	0
15	32350000	.	A	G	5	4	9	15	0	24	0	0
15	32350116	.	G	T	12	7	19	0	0	19	0	0
15	32350743	.	A	G	11	0	11	0	9	20	0	0
15	32351476	.	A	G	10	7	17	0	1	18	0	0
15	32351534	.	A	G	3	18	21	0	1	22	0	0
15	32351575	.	A	G	15	6	21	0	1	22	0	0
15	32887739	.	A	G	10	0	10	1	5	16	0	0
15	32887858	.	A	G	6	6	12	0	0	12	0	0
15	33608123	.	T	A	1	2	3	0	0	3	0	0
15	33853701	.	C	T	3	9	12	1	1	14	0	0
15	33864152	.	A	G	5	8	13	0	0	13	0	0
15	33864266	.	G	A	4	6	10	0	0	10	0	0
15	33864373	.	T	C	1	3	4	0	0	4	0	0
15	33864585	.	G	A	9	10	19	0	0	19	0	0
15	33864713	.	T	C	3	3	6	2	0	8	0	0
15	33891825	.	G	A	27	15	42	0	2	44	0	0
15	33891826	.	G	A	29	15	44	0	2	46	0	0
15	33891869	.	G	T	25	13	38	1	2	41	0	0
15	33891979	.	T	C	37	10	47	0	1	48	0	0
15	33896117	.	G	T	25	22	47	0	2	49	0	0
15	33896177	.	T	C	23	25	48	0	2	50	0	0
15	33896213	.	T	C	25	1	26	0	27	53	0	0
15	33896303	.	T	A	24	24	48	0	3	51	0	0
15	33896306	.	A	G	27	22	49	0	3	52	0	0
15	33896832	.	T	C	17	22	39	0	1	40	0	0
15	33899556	.	C	G	19	12	31	1	2	34	0	0
15	33899808	.	T	A	27	22	49	0	2	51	0	0
15	33902388	.	C	G	4	7	11	0	14	25	0	0
15	33910546	.	G	C	21	20	41	0	1	42	0	0
15	33942094	.	G	A	1	2	3	0	0	3	0	0
15	33970841	.	A	G	20	0	20	0	20	40	0	0
15	33970854	.	C	T	23	15	38	0	2	40	0	0
15	33970907	.	C	T	20	20	40	0	2	42	0	0
15	33971097	.	G	C	23	13	36	0	3	39	0	0
15	33977716	.	A	T	12	18	30	0	2	32	0	0
15	33977760	.	A	G	20	1	21	0	15	36	0	0
15	33977942	.	A	C	8	12	20	0	1	21	0	0
15	34174635	.	T	C	13	10	23	0	0	23	0	0
15	34175101	.	T	C	23	22	45	0	0	45	0	0
15	34175359	.	G	A	9	10	19	0	1	20	0	0
15	34175426	.	T	A	9	15	24	0	5	29	0	0
15	34175718	.	G	A	8	6	14	0	0	14	0	0
15	34175917	.	C	T	12	7	19	2	0	21	0	0
15	34175929	.	C	T	9	13	22	0	0	22	0	0
15	34176203	.	A	T	8	17	25	0	1	26	0	0
15	34176214	.	C	T	16	8	24	0	0	24	0	0
15	34176336	.	G	T	1	6	7	0	0	7	0	0
15	34176379	.	A	C	11	12	23	0	1	24	0	0
15	34176841	.	A	T	10	14	24	0	1	25	0	0
15	34176993	.	G	A	8	8	16	0	0	16	0	0
15	34182135	.	G	A	12	12	24	0	1	25	0	0
15	34186690	.	A	T	16	11	27	1	2	30	0	0
15	34189452	.	G	A	19	15	34	0	1	35	0	0
15	34212903	.	G	A	5	3	8	0	0	8	0	0
15	34215835	.	A	T	4	2	6	0	0	6	0	0
15	34326178	.	G	A	1	3	4	0	0	4	0	0
15	34335044	.	T	A	3	2	5	0	2	7	0	0
15	34335272	.	C	T	3	4	7	0	1	8	0	0
15	34418346	.	A	T	1	3	4	0	0	4	0	0
15	34534245	.	C	G	10	3	13	0	0	13	0	0
15	34534265	.	C	T	2	12	14	0	0	14	0	0
15	34558428	.	G	A	5	5	10	0	0	10	0	0
15	34558438	.	G	T	5	2	7	0	0	7	0	0
15	34573337	.	C	T	3	4	7	0	0	7	0	0
15	34573343	.	A	G	2	5	7	0	0	7	0	0
15	34573454	.	A	C	3	4	7	0	0	7	0	0
15	34573597	.	A	T	5	3	8	0	1	9	0	0
15	34573952	.	T	A	1	7	8	0	0	8	0	0
15	34573959	.	A	T	1	8	9	0	0	9	0	0
15	34574116	.	G	A	10	7	17	0	0	17	0	0
15	34590674	.	A	C	1	5	6	0	0	6	0	0
15	34590772	.	A	G	2	3	5	0	1	6	0	0
15	34618456	.	T	G	6	2	8	0	0	8	0	0
15	34618669	.	A	T	16	17	33	0	0	33	0	0
15	34618906	.	C	A	9	16	25	0	0	25	0	0
15	34618948	.	T	G	15	11	26	0	2	28	0	0
15	34618958	.	G	A	14	13	27	0	2	29	0	0
15	34621868	.	G	A	20	12	32	0	0	32	0	0
15	34621875	.	G	A	14	18	32	0	1	33	0	0
15	34627792	.	T	A	7	13	20	0	0	20	0	0
15	34627874	.	T	C	16	18	34	0	0	34	0	0
15	34635321	.	C	A	12	5	17	0	2	19	0	0
15	34635336	.	A	C	11	0	11	0	6	17	0	0
15	34637582	.	C	T	2	9	11	0	13	24	0	0
15	34638847	.	C	T	3	13	16	0	8	24	0	0
15	34641252	.	G	C	4	0	4	0	9	13	0	0
15	34641276	.	G	A	7	6	13	0	0	13	0	0
15	34641300	.	G	A	7	5	12	0	0	12	0	0
15	34641384	.	G	A	10	13	23	0	0	23	0	0
15	34657370	.	C	T	6	6	12	0	0	12	0	0
15	34657919	.	T	A	3	9	12	0	0	12	0	0
15	35004856	.	G	A	1	6	7	0	1	8	0	0
15	35076003	.	C	T	7	5	12	0	1	13	0	0
15	35091591	.	A	G	4	2	6	0	0	6	0	0
15	35103129	.	T	C	4	4	8	0	0	8	0	0
15	35103145	.	T	C	2	4	6	0	0	6	0	0
15	35157052	.	T	A	11	6	17	0	0	17	0	0
15	35157054	.	G	A	11	6	17	0	0	17	0	0
15	35158661	.	T	G	11	8	19	0	0	19	0	0
15	35163492	.	T	G	11	5	16	0	1	17	0	0
15	35167298	.	A	G	3	4	7	0	0	7	0	0
15	35172285	.	C	T	0	3	3	0	1	4	0	0
15	35187682	.	C	T	0	3	3	0	1	4	0	0
15	35212147	.	C	G	0	7	7	0	1	8	0	0
15	35212177	.	G	A	4	6	10	0	0	10	0	0
15	35212318	.	A	T	3	7	10	0	0	10	0	0
15	35212386	.	T	C	5	4	9	0	0	9	0	0
15	35212418	.	G	C	2	4	6	0	0	6	0	0
15	35214784	.	T	A	10	3	13	0	0	13	0	0
15	35214859	.	A	C	14	1	15	0	13	28	0	0
15	35214901	.	G	A	12	12	24	0	1	25	0	0
15	35217424	.	G	A	6	8	14	0	0	14	0	0
15	35217475	.	T	C	9	7	16	0	2	18	0	0
15	35217487	.	C	A	1	7	8	0	14	22	0	0
15	35221304	.	A	T	8	9	17	0	2	19	0	0
15	35224269	.	G	C	10	7	17	0	0	17	0	0
15	35227221	.	A	T	13	5	18	0	3	21	0	0
15	35247678	.	A	T	18	18	36	0	5	41	0	0
15	35247687	.	A	G	19	22	41	0	2	43	0	0
15	35247729	.	A	G	20	20	40	0	0	40	0	0
15	35247762	.	T	C	18	15	33	0	2	35	0	0
15	35709983	.	G	A	0	4	4	0	4	8	0	0
15	35709988	.	C	T	4	4	8	0	0	8	0	0
15	35718398	.	A	C	3	8	11	0	0	11	0	0
15	35737680	.	T	C	4	4	8	0	1	9	0	0
15	35760664	.	C	T	9	5	14	0	0	14	0	0
15	35760925	.	T	C	6	5	11	0	0	11	0	0
15	35760943	.	C	T	4	4	8	0	0	8	0	0
15	35760970	.	G	A	3	5	8	0	2	10	0	0
15	35761024	.	T	C	8	7	15	0	0	15	0	0
15	35761027	.	A	G	6	8	14	0	1	15	0	0
15	35761126	.	G	A	1	6	7	0	6	13	0	0
15	35761225	.	G	A	6	7	13	0	0	13	0	0
15	35761516	.	T	C	6	9	15	0	0	15	0	0
15	35889183	.	C	A	3	2	5	0	0	5	0	0
15	35889215	.	C	A	2	2	4	0	0	4	0	0
15	35889443	.	G	T	4	6	10	0	0	10	0	0
15	35889474	.	G	A	9	5	14	0	1	15	0	0
15	35889516	.	A	C	3	5	8	0	0	8	0	0
15	35889517	.	C	A	1	5	6	0	2	8	0	0
15	35889793	.	G	A	2	3	5	0	0	5	0	0
15	35889810	.	G	A	1	3	4	0	0	4	0	0
15	35889865	.	A	G	4	2	6	0	0	6	0	0
15	35890046	.	G	A	4	5	9	0	0	9	0	0
15	35890148	.	C	T	3	2	5	0	2	7	0	0
15	35890372	.	T	A	5	4	9	0	0	9	0	0
15	35890419	.	T	G	3	4	7	0	0	7	0	0
15	35891203	.	A	T	1	2	3	0	0	3	0	0
15	35926711	.	G	C	2	3	5	0	0	5	0	0
15	35927375	.	A	G	2	3	5	0	0	5	0	0
15	35929004	.	C	A	1	4	5	0	0	5	0	0
15	36501446	.	G	A	1	2	3	0	0	3	0	0
15	37458499	.	G	A	2	3	5	0	6	11	0	0
15	37459062	.	T	C	5	0	5	0	5	10	0	0
15	37459369	.	T	C	4	7	11	0	1	12	0	0
15	37459438	.	T	C	5	0	5	0	4	9	0	0
15	37459443	.	T	C	2	7	9	0	0	9	0	0
15	37459819	.	T	C	9	6	15	0	0	15	0	0
15	37460405	.	T	C	3	3	6	0	0	6	0	0
15	38221243	.	C	A	8	13	21	0	1	22	0	0
15	38221279	.	T	C	16	11	27	0	2	29	0	0
15	38221433	.	A	C	13	6	19	0	0	19	0	0
15	38223632	.	C	T	7	12	19	0	1	20	0	0
15	38223672	.	T	A	8	13	21	0	0	21	0	0
15	38223685	.	C	G	5	9	14	0	1	15	0	0
15	38239605	.	G	A	18	11	29	1	1	31	0	0
15	38239641	.	C	T	11	8	19	0	0	19	0	0
15	38239692	.	C	A	6	7	13	0	0	13	0	0
15	38254283	.	A	G	9	4	13	0	1	14	0	0
15	38258644	.	A	G	10	0	10	0	13	23	0	0
15	38268705	.	T	A	5	11	16	0	0	17	1	0
15	38282687	.	T	C	18	13	31	1	0	32	0	0
15	38287983	.	G	A	16	18	34	1	0	35	0	0
15	38287995	.	A	G	15	13	28	1	2	31	0	0
15	38288104	.	A	C	9	11	20	0	1	21	0	0
15	38289831	.	A	G	18	6	24	0	1	25	0	0
15	38295122	.	T	C	23	20	43	0	1	44	0	0
15	38295158	.	T	C	18	11	29	0	1	30	0	0
15	38295347	.	G	A	19	14	33	0	0	33	0	0
15	38295485	.	C	G	22	14	36	0	0	36	0	0
15	38295545	.	C	T	13	8	21	0	0	21	0	0
15	38295679	.	C	A	6	5	11	0	1	12	0	0
15	38295771	.	G	A	5	4	9	0	0	9	0	0
15	38296305	.	A	G	11	17	28	0	1	29	0	0
15	38296377	.	A	G	14	11	25	0	1	26	0	0
15	38296449	.	T	C	9	9	18	0	1	19	0	0
15	38296885	.	A	G	12	0	12	0	8	20	0	0
15	38296900	.	T	A	11	8	19	0	1	20	0	0
15	38297071	.	T	C	16	16	32	0	2	34	0	0
15	38297214	.	C	T	18	22	40	0	0	40	0	0
15	38297364	.	C	T	12	23	35	0	2	37	0	0
15	38297372	.	A	G	13	22	35	0	2	37	0	0
15	38859746	.	C	T	3	5	8	0	0	8	0	0
15	38859753	.	A	C	3	5	8	0	0	8	0	0
15	38892060	.	T	C	10	5	15	0	1	16	0	0
15	39123012	.	T	C	6	5	11	0	2	13	0	0
15	39140568	.	G	A	1	11	12	0	9	21	0	0
15	39141498	.	A	G	6	14	20	0	0	20	0	0
15	39156787	.	T	G	12	0	12	0	11	23	0	0
15	39190103	.	T	G	7	0	7	1	19	27	0	0
15	39207024	.	T	A	9	15	24	0	3	27	0	0
15	39208087	.	G	A	1	15	16	0	14	30	0	0
15	39210450	.	G	A	2	14	16	0	19	35	0	0
15	39223884	.	A	T	21	14	35	0	3	38	0	0
15	39223980	.	T	G	16	22	38	0	1	39	0	0
15	39226661	.	A	T	15	15	30	0	2	32	0	0
15	39228113	.	A	T	18	24	42	0	1	43	0	0
15	39228120	.	A	C	18	21	39	0	4	43	0	0
15	39228174	.	A	G	24	16	40	0	2	42	0	0
15	39281843	.	T	G	8	7	15	0	0	15	0	0
15	39281875	.	A	C	6	5	11	0	1	12	0	0
15	39282007	.	G	C	9	0	9	0	17	26	0	0
15	39282070	.	A	G	10	9	19	0	3	22	0	0
15	39296706	.	A	G	15	10	25	0	0	25	0	0
15	39296751	.	C	T	0	6	6	0	17	23	0	0
15	39296790	.	C	T	0	9	9	0	7	16	0	0
15	39296841	.	A	G	4	5	9	0	0	9	0	0
15	39296982	.	T	C	3	12	15	0	0	15	0	0
15	39296997	.	T	C	3	9	12	0	1	13	0	0
15	39297051	.	G	A	10	8	18	0	0	18	0	0
15	39305598	.	G	A	3	9	12	0	0	12	0	0
15	39312461	.	G	A	2	3	5	0	3	8	0	0
15	39326908	.	A	T	5	3	8	0	0	8	0	0
15	39326914	.	T	C	5	0	5	0	3	8	0	0
15	39345641	.	G	A	2	5	7	0	1	8	0	0
15	39354759	.	A	T	5	2	7	0	0	7	0	0
15	39358944	.	C	A	3	3	6	0	0	6	0	0
15	39368952	.	A	C	2	2	4	0	0	4	0	0
15	39387308	.	T	G	3	6	9	0	0	9	0	0
15	39387311	.	A	G	3	6	9	0	0	9	0	0
15	39558928	.	A	C	3	2	5	0	0	5	0	0
15	39559045	.	A	G	4	3	7	0	1	8	0	0
15	39629834	.	G	A	2	3	5	0	0	5	0	0
15	39629856	.	A	T	2	2	4	0	0	4	0	0
15	39977506	.	C	T	4	2	6	0	0	6	0	0
15	39994313	.	T	C	14	12	26	0	1	27	0	0
15	40002242	.	C	T	9	12	21	0	1	22	0	0
15	40002319	.	C	T	12	13	25	0	2	27	0	0
15	40002325	.	C	T	13	14	27	0	1	28	0	0
15	40002561	.	T	A	8	11	19	0	0	19	0	0
15	40004820	.	G	A	3	5	8	0	0	8	0	0
15	40005174	.	T	G	2	6	8	0	2	10	0	0
15	40005279	.	C	T	6	5	11	0	0	11	0	0
15	40005318	.	T	A	12	6	18	0	0	18	0	0
15	40005342	.	A	T	12	9	21	0	0	22	1	0
15	40005527	.	T	A	6	15	21	0	1	22	0	0
15	40006090	.	A	C	8	7	15	0	1	17	1	0
15	40006136	.	T	C	4	8	12	0	0	12	0	0
15	40008449	.	C	T	25	20	45	0	1	46	0	0
15	40008454	.	C	A	26	18	44	0	4	48	0	0
15	40008537	.	G	T	0	30	30	0	19	49	0	0
15	40008544	.	C	A	18	32	50	0	0	50	0	0
15	40017144	.	A	G	25	31	56	0	3	59	0	0
15	40018500	.	T	C	26	38	64	1	7	72	0	0
15	40027138	.	C	T	30	41	71	0	5	76	0	0
15	40027194	.	A	T	29	37	66	0	6	73	1	0
15	40027279	.	T	C	57	22	79	0	3	82	0	0
15	40027484	.	T	G	32	0	32	0	26	58	0	0
15	40027540	.	A	C	21	26	47	0	6	54	1	0
15	40028457	.	T	G	35	31	66	1	1	68	0	0
15	40028568	.	G	A	36	21	57	0	4	61	0	0
15	40028574	.	A	G	33	24	57	0	10	67	0	0
15	40130355	.	A	G	11	3	14	0	0	14	0	0
15	40130431	.	A	G	4	4	8	0	0	8	0	0
15	40130456	.	A	G	6	3	9	0	0	9	0	0
15	40130540	.	A	G	12	5	17	2	0	19	0	0
15	40130563	.	A	G	15	0	15	1	7	23	0	0
15	40130730	.	A	G	12	8	20	0	0	20	0	0
15	40162827	.	C	T	0	6	6	0	8	14	0	0
15	40217543	.	T	C	5	3	8	0	1	9	0	0
15	40217590	.	T	C	4	3	7	0	0	7	0	0
15	41210670	.	T	G	1	4	5	0	0	5	0	0
15	41210721	.	G	A	7	6	13	0	0	13	0	0
15	41210739	.	A	G	11	6	17	0	0	17	0	0
15	41211365	.	C	T	2	6	8	0	0	8	0	0
15	41227123	.	C	T	7	2	9	0	1	10	0	0
15	41227168	.	T	C	2	4	6	0	1	7	0	0
15	41234895	.	G	A	11	5	16	0	1	17	0	0
15	41238388	.	G	C	3	3	6	0	0	6	0	0
15	41238715	.	C	T	8	5	13	0	0	13	0	0
15	41238764	.	T	A	8	6	14	0	0	14	0	0
15	41262083	.	C	T	1	2	3	0	0	3	0	0
15	41262120	.	A	T	1	1	2	0	1	3	0	0
15	41269440	.	C	T	1	2	3	0	0	3	0	0
15	41269443	.	T	G	2	2	4	0	0	4	0	0
15	41296910	.	T	C	4	0	4	0	4	8	0	0
15	41296953	.	A	G	4	4	8	0	0	8	0	0
15	41298905	.	A	G	1	3	4	0	0	4	0	0
15	41298937	.	T	A	3	2	5	0	0	5	0	0
15	41299073	.	G	A	7	3	10	0	0	10	0	0
15	41299096	.	T	C	4	3	7	0	0	7	0	0
15	41299108	.	C	T	5	4	9	0	0	9	0	0
15	41299141	.	T	G	3	3	6	0	1	7	0	0
15	41302523	.	A	G	4	2	6	0	0	6	0	0
15	41303339	.	T	C	2	2	4	0	0	4	0	0
15	41303550	.	C	G	1	2	3	0	0	3	0	0
15	41303747	.	G	A	3	1	4	0	1	5	0	0
15	41303773	.	A	C	4	3	7	0	0	7	0	0
15	41303839	.	A	G	5	4	9	0	1	10	0	0
15	41303846	.	G	A	6	4	10	0	0	10	0	0
15	41303886	.	A	T	2	2	4	0	0	4	0	0
15	41311253	.	A	T	4	3	7	0	0	7	0	0
15	41311271	.	G	A	4	3	7	0	0	7	0	0
15	41617230	.	G	A	0	2	2	0	1	3	0	0
15	41635530	.	A	T	1	3	4	1	0	5	0	0
15	41657648	.	G	A	0	2	2	0	1	3	0	0
15	41664144	.	T	A	2	4	6	0	0	6	0	0
15	41664145	.	A	C	1	4	5	0	1	6	0	0
15	41676929	.	G	A	12	6	18	0	0	18	0	0
15	41676968	.	A	T	10	5	15	0	1	16	0	0
15	41677058	.	C	T	4	3	7	0	0	7	0	0
15	41677130	.	G	A	10	7	17	0	1	18	0	0
15	41677699	.	G	C	2	2	4	0	0	4	0	0
15	41683071	.	G	A	2	4	6	0	0	6	0	0
15	41694132	.	C	T	3	7	10	0	0	10	0	0
15	41694163	.	T	A	1	3	4	0	1	5	0	0
15	41694230	.	A	C	2	2	4	0	1	5	0	0
15	41694316	.	T	A	6	3	9	0	0	9	0	0
15	41694483	.	T	G	2	2	4	0	0	4	0	0
15	41694484	.	T	C	2	2	4	0	0	4	0	0
15	41694617	.	A	T	5	5	10	0	0	10	0	0
15	41694894	.	T	A	5	2	7	0	0	7	0	0
15	41695120	.	T	C	1	4	5	0	0	5	0	0
15	41695179	.	T	A	4	3	7	0	0	7	0	0
15	41695270	.	A	T	5	3	8	0	0	8	0	0
15	41695274	.	C	T	5	2	7	0	0	7	0	0
15	41695429	.	G	A	7	4	11	0	0	11	0	0
15	41695481	.	A	T	8	3	11	0	1	12	0	0
15	41695549	.	G	A	4	4	8	1	0	9	0	0
15	41695554	.	C	T	6	4	10	1	0	11	0	0
15	41695682	.	A	G	3	4	7	0	0	7	0	0
15	41695683	.	C	T	3	3	6	0	1	7	0	0
15	41695725	.	T	C	2	3	5	0	0	5	0	0
15	41695901	.	A	T	7	7	14	0	0	14	0	0
15	41696344	.	C	A	6	2	8	0	0	8	0	0
15	41696410	.	G	A	8	3	11	0	1	12	0	0
15	41696500	.	G	A	6	3	9	0	0	9	0	0
15	41696804	.	C	A	0	3	3	0	3	6	0	0
15	41697124	.	A	C	2	3	5	0	0	5	0	0
15	41697130	.	T	A	2	3	5	0	0	5	0	0
15	41697161	.	C	T	0	2	2	0	2	4	0	0
15	41697691	.	C	T	4	2	6	0	0	6	0	0
15	41697742	.	T	A	3	5	8	0	0	8	0	0
15	41697779	.	A	T	3	5	8	0	0	8	0	0
15	41697791	.	C	A	0	6	6	0	3	9	0	0
15	41698703	.	G	C	3	0	3	0	2	5	0	0
15	41700377	.	T	C	2	0	2	0	4	6	0	0
15	41700394	.	A	T	2	3	5	0	0	5	0	0
15	41753287	.	T	C	1	0	1	1	2	4	0	0
15	41767883	.	C	T	2	3	5	0	0	5	0	0
15	41768064	.	T	C	4	3	7	0	0	7	0	0
15	41768169	.	G	A	5	4	9	0	0	9	0	0
15	41828235	.	C	T	4	6	10	0	0	10	0	0
15	41838683	.	A	G	5	0	5	0	4	9	0	0
15	41843107	.	C	T	5	3	8	0	0	8	0	0
15	41843134	.	T	A	4	4	8	0	1	9	0	0
15	41843144	.	C	T	4	5	9	0	0	9	0	0
15	41845038	.	G	C	11	6	17	0	0	17	0	0
15	41845059	.	A	C	7	5	12	0	0	12	0	0
15	41845139	.	C	T	7	6	13	0	0	13	0	0
15	41845253	.	A	T	4	7	11	0	0	11	0	0
15	41845310	.	G	T	4	6	10	0	1	11	0	0
15	41845526	.	G	A	1	10	11	0	2	13	0	0
15	41845678	.	A	T	1	3	4	0	0	4	0	0
15	41845681	.	C	A	1	2	3	0	0	3	0	0
15	41949768	.	C	T	1	3	4	0	8	12	0	0
15	41949842	.	T	A	4	2	6	0	0	6	0	0
15	41950245	.	G	T	2	4	6	0	1	7	0	0
15	41950896	.	G	A	7	3	10	0	0	10	0	0
15	41951048	.	T	G	5	2	7	0	0	7	0	0
15	41951049	.	G	A	3	2	5	0	1	6	0	0
15	41960443	.	A	G	2	2	4	0	0	4	0	0
15	41972628	.	A	G	3	2	5	0	0	5	0	0
15	41972631	.	G	A	3	2	5	0	0	5	0	0
15	41972676	.	G	T	3	2	5	0	0	5	0	0
15	41990096	.	T	C	1	1	2	0	1	3	0	0
15	41990194	.	T	C	1	2	3	0	0	3	0	0
15	41990196	.	A	G	1	2	3	0	0	3	0	0
15	42264934	.	C	T	6	4	10	0	0	10	0	0
15	42264955	.	C	T	0	4	4	0	10	14	0	0
15	42265263	.	A	G	23	13	36	0	1	37	0	0
15	42267408	.	T	A	20	12	32	0	0	32	0	0
15	42278936	.	T	A	12	9	21	0	0	21	0	0
15	42280689	.	G	A	10	13	23	1	0	24	0	0
15	42280719	.	T	A	11	11	22	0	1	23	0	0
15	42283746	.	C	T	9	10	19	0	1	20	0	0
15	42285766	.	A	G	13	0	13	0	7	20	0	0
15	42285767	.	G	T	13	7	20	0	0	20	0	0
15	42296654	.	A	G	14	0	14	0	14	28	0	0
15	42296717	.	T	G	14	0	14	0	14	28	0	0
15	42296753	.	C	T	12	7	19	0	0	19	0	0
15	42297528	.	A	G	4	0	4	0	11	15	0	0
15	42302990	.	A	G	16	12	28	0	0	28	0	0
15	42303020	.	A	T	12	9	21	0	1	22	0	0
15	42304851	.	C	T	12	10	22	0	0	22	0	0
15	42317072	.	T	A	3	11	14	0	0	14	0	0
15	42344874	.	C	G	5	8	13	0	0	13	0	0
15	42346771	.	C	A	6	4	10	0	0	10	0	0
15	42346818	.	A	T	4	7	11	0	1	12	0	0
15	42346902	.	C	T	4	10	14	0	0	14	0	0
15	42346951	.	A	T	3	14	17	0	1	18	0	0
15	42346958	.	C	T	4	15	19	0	0	19	0	0
15	42434256	.	A	C	2	4	6	0	1	7	0	0
15	42434265	.	A	T	4	5	9	0	1	10	0	0
15	42434556	.	T	C	2	3	5	0	0	5	0	0
15	42434568	.	A	G	3	2	5	0	0	5	0	0
15	42436972	.	T	A	5	1	6	0	1	7	0	0
15	42443122	.	C	T	2	3	5	0	0	5	0	0
15	42445035	.	C	T	2	3	5	0	0	5	0	0
15	42449785	.	T	C	1	3	4	0	0	4	0	0
15	42449809	.	C	T	1	3	4	0	0	4	0	0
15	42467418	.	A	G	1	4	5	0	2	7	0	0
15	42480915	.	T	A	3	2	5	0	0	5	0	0
15	42486260	.	C	T	1	3	4	0	0	4	0	0
15	42522032	.	C	T	3	4	7	0	0	7	0	0
15	42522033	.	C	T	3	4	7	0	0	7	0	0
15	42538243	.	A	G	2	2	4	0	0	4	0	0
15	42538267	.	C	T	4	3	7	0	0	7	0	0
15	42543850	.	G	A	0	4	4	0	2	6	0	0
15	42545582	.	G	A	5	5	10	0	1	11	0	0
15	42550856	.	G	A	3	6	9	0	1	10	0	0
15	42550961	.	C	T	5	4	9	0	0	9	0	0
15	42551067	.	G	A	0	8	8	0	5	13	0	0
15	42637709	.	T	C	2	2	4	0	0	4	0	0
15	42661052	.	C	T	2	7	9	0	0	9	0	0
15	42664670	.	A	C	2	5	7	0	0	7	0	0
15	42674141	.	T	C	1	3	4	0	0	4	0	0
15	42676209	.	G	A	0	4	4	0	2	6	0	0
15	42676401	.	T	C	2	6	8	0	0	8	0	0
15	42741413	.	T	C	4	2	6	0	1	7	0	0
15	42758927	.	T	C	1	0	1	0	3	4	0	0
15	42920246	.	T	G	3	4	7	0	0	7	0	0
15	42920332	.	G	T	1	4	5	0	0	5	0	0
15	42933283	.	C	T	4	3	7	0	0	7	0	0
15	42933343	.	G	A	0	5	5	0	1	6	0	0
15	42947514	.	C	T	4	4	8	0	2	10	0	0
15	42947664	.	C	G	2	7	9	0	0	9	0	0
15	42947700	.	C	A	3	4	7	0	0	7	0	0
15	42953018	.	T	C	2	4	6	0	0	6	0	0
15	42958548	.	T	C	1	5	6	0	0	6	0	0
15	42958677	.	C	T	4	9	13	0	0	13	0	0
15	42976197	.	C	G	5	7	12	0	0	12	0	0
15	42976395	.	C	T	3	4	7	0	2	9	0	0
15	42980862	.	T	C	7	7	14	0	0	14	0	0
15	42981137	.	C	A	6	12	18	0	0	18	0	0
15	42981281	.	A	T	5	10	15	0	1	16	0	0
15	42981303	.	T	A	5	7	12	0	1	13	0	0
15	42981345	.	A	G	3	1	4	0	5	9	0	0
15	43099991	.	C	T	1	3	4	0	0	4	0	0
15	43100035	.	G	A	1	3	4	0	0	4	0	0
15	43100049	.	C	A	1	2	3	0	0	3	0	0
15	43187423	.	T	C	26	46	72	0	1	73	0	0
15	43195924	.	G	A	39	44	83	1	1	85	0	0
15	43196102	.	A	T	24	38	62	0	3	65	0	0
15	43196106	.	A	G	22	3	25	0	37	62	0	0
15	43196202	.	C	A	25	43	68	0	4	72	0	0
15	43196306	.	C	T	22	45	67	0	1	68	0	0
15	43196341	.	T	A	29	35	64	0	4	68	0	0
15	43196483	.	C	A	22	45	67	0	4	71	0	0
15	43196491	.	T	C	23	45	68	0	2	70	0	0
15	43196977	.	C	T	1	2	3	0	0	3	0	0
15	43216326	.	G	T	10	8	18	0	1	19	0	0
15	43216350	.	A	G	9	9	18	0	2	20	0	0
15	43237625	.	G	T	9	6	15	0	1	16	0	0
15	43241989	.	A	C	3	3	6	0	0	6	0	0
15	43242006	.	G	A	2	4	6	0	0	6	0	0
15	43245362	.	A	G	20	29	49	0	0	49	0	0
15	43245371	.	T	A	20	26	46	0	0	46	0	0
15	43257039	.	T	C	18	18	36	0	2	38	0	0
15	43260531	.	G	A	13	12	25	0	0	25	0	0
15	43260609	.	A	G	10	15	25	0	0	25	0	0
15	43268484	.	T	A	3	14	17	0	0	17	0	0
15	43287371	.	C	G	2	2	4	0	0	4	0	0
15	43287431	.	G	A	2	4	6	0	0	6	0	0
15	43287481	.	T	G	7	4	11	0	0	11	0	0
15	43398335	.	A	C	5	9	14	0	0	14	0	0
15	43457873	.	T	A	2	3	5	0	1	6	0	0
15	43480486	.	T	A	5	7	12	0	1	13	0	0
15	43480543	.	T	C	3	7	10	0	1	11	0	0
15	43487794	.	C	T	7	7	14	0	0	14	0	0
15	43488094	.	C	T	4	13	17	0	0	17	0	0
15	43489679	.	T	C	13	7	20	0	1	21	0	0
15	43509743	.	A	G	7	0	7	0	10	17	0	0
15	43509864	.	T	C	10	3	13	0	1	14	0	0
15	43509961	.	C	A	4	3	7	0	0	7	0	0
15	43510116	.	A	C	6	8	14	0	0	14	0	0
15	43510448	.	A	T	10	9	19	0	0	19	0	0
15	43510452	.	T	G	9	9	18	0	0	18	0	0
15	43604150	.	G	C	1	4	5	0	1	6	0	0
15	43604190	.	G	A	3	2	5	0	0	5	0	0
15	43604224	.	G	A	6	5	11	0	1	12	0	0
15	43604325	.	G	A	6	4	10	0	0	10	0	0
15	43604903	.	C	G	4	4	8	0	2	10	0	0
15	43604928	.	A	G	7	4	11	0	0	11	0	0
15	43604988	.	G	C	3	5	8	0	0	8	0	0
15	43604996	.	A	G	3	5	8	0	0	8	0	0
15	43620173	.	C	T	1	2	3	0	0	3	0	0
15	43651693	.	G	A	4	4	8	0	0	8	0	0
15	43656334	.	T	C	2	0	2	0	5	7	0	0
15	43656352	.	G	A	1	4	5	0	0	5	0	0
15	43656519	.	G	T	3	3	6	0	0	6	0	0
15	43656619	.	C	T	1	4	5	0	0	5	0	0
15	43662995	.	G	A	2	2	4	0	0	4	0	0
15	43768318	.	C	T	0	3	3	0	2	5	0	0
15	43917471	.	C	T	1	1	2	0	1	3	0	0
15	43931233	.	G	A	1	7	8	0	1	9	0	0
15	43931714	.	C	T	1	9	10	0	2	12	0	0
15	43966993	.	C	T	2	2	4	0	0	4	0	0
15	43977993	.	A	T	2	2	4	0	0	4	0	0
15	43977995	.	A	T	2	2	4	0	0	4	0	0
15	43982146	.	T	C	4	2	6	0	1	7	0	0
15	43982517	.	T	C	5	4	9	0	0	9	0	0
15	43982925	.	T	C	3	2	5	0	0	5	0	0
15	43983039	.	A	G	3	2	5	0	0	5	0	0
15	43983402	.	G	A	1	3	4	0	0	4	0	0
15	43983585	.	G	A	4	5	9	0	0	9	0	0
15	43984034	.	T	C	3	2	5	0	0	5	0	0
15	43984470	.	T	C	2	4	6	0	0	6	0	0
15	43984495	.	C	A	2	7	9	0	0	9	0	0
15	43988698	.	T	A	1	1	2	0	0	2	0	0
15	43988716	.	C	T	1	2	3	0	1	4	0	0
15	43988767	.	G	T	4	4	8	0	1	9	0	0
15	44029488	.	A	C	1	3	4	0	0	4	0	0
15	44072776	.	T	C	10	0	10	2	7	19	0	0
15	44072782	.	G	A	9	11	20	2	0	22	0	0
15	44074653	.	A	G	13	9	22	1	0	23	0	0
15	44075125	.	C	T	0	4	4	0	9	13	0	0
15	44077766	.	A	T	13	11	24	0	1	25	0	0
15	44113320	.	T	C	1	2	3	0	0	3	0	0
15	44140324	.	T	G	3	0	3	0	6	9	0	0
15	44140360	.	G	A	6	3	9	0	0	9	0	0
15	44140583	.	C	T	5	3	8	0	0	8	0	0
15	44141311	.	A	G	2	5	7	0	0	7	0	0
15	44209147	.	T	G	2	3	5	2	1	8	0	0
15	44252374	.	T	C	1	7	8	0	1	9	0	0
15	44254986	.	A	C	1	2	3	0	0	3	0	0
15	44255001	.	G	A	2	5	7	0	0	7	0	0
15	44255130	.	A	T	4	9	13	0	0	13	0	0
15	44255438	.	A	G	2	0	2	0	3	5	0	0
15	44255467	.	C	T	3	4	7	0	0	7	0	0
15	44255473	.	T	C	3	4	7	0	0	7	0	0
15	44283812	.	A	G	1	2	3	0	0	3	0	0
15	44290546	.	C	T	7	2	9	0	0	9	0	0
15	44295044	.	G	A	4	6	10	0	0	10	0	0
15	44323442	.	G	A	4	2	6	0	0	6	0	0
15	44336923	.	A	T	7	5	12	0	0	12	0	0
15	44340093	.	C	T	3	4	7	0	0	7	0	0
15	44344283	.	G	A	1	5	6	0	6	12	0	0
15	44370890	.	C	A	6	5	11	0	0	11	0	0
15	44371058	.	T	C	9	13	22	0	0	22	0	0
15	44371076	.	C	T	13	7	20	0	0	20	0	0
15	44371129	.	C	T	8	10	18	0	0	18	0	0
15	44371289	.	C	T	11	6	17	0	0	17	0	0
15	44371484	.	T	C	4	7	11	0	0	11	0	0
15	44385117	.	T	C	10	6	16	0	1	17	0	0
15	44440352	.	G	A	2	4	6	0	0	6	0	0
15	44445243	.	C	T	4	9	13	0	0	13	0	0
15	44465352	.	G	A	5	2	7	0	0	7	0	0
15	44472532	.	T	A	3	4	7	0	0	7	0	0
15	44475020	.	G	A	1	2	3	0	0	3	0	0
15	44475038	.	C	T	1	3	4	0	0	4	0	0
15	44499653	.	T	A	19	17	36	0	3	39	0	0
15	44530288	.	T	C	6	0	6	0	8	14	0	0
15	44534976	.	G	A	11	12	23	0	1	24	0	0
15	44559576	.	C	G	12	16	28	0	3	31	0	0
15	44559636	.	T	C	17	0	17	0	11	28	0	0
15	44559646	.	T	A	14	5	19	0	0	19	0	0
15	44559749	.	A	G	4	14	18	0	1	19	0	0
15	44560414	.	T	G	13	17	30	0	0	30	0	0
15	44565727	.	T	A	11	20	31	0	0	31	0	0
15	44625286	.	G	A	1	4	5	0	0	5	0	0
15	44646664	.	G	A	8	6	14	0	1	15	0	0
15	44646676	.	T	C	7	6	13	0	0	13	0	0
15	44647485	.	A	G	9	8	17	0	0	17	0	0
15	44660651	.	C	T	3	7	10	0	0	10	0	0
15	44663021	.	G	A	5	7	12	0	0	12	0	0
15	44676962	.	T	C	4	0	4	0	10	14	0	0
15	44676968	.	G	A	9	5	14	0	0	14	0	0
15	44677292	.	G	T	4	4	8	0	0	8	0	0
15	44677302	.	T	C	4	5	9	0	0	9	0	0
15	44714650	.	A	G	9	3	12	0	0	12	0	0
15	44717704	.	A	G	4	3	7	0	1	8	0	0
15	44721553	.	G	A	1	6	7	0	0	7	0	0
15	44721559	.	G	A	1	6	7	0	0	7	0	0
15	44755886	.	C	T	1	5	6	0	6	12	0	0
15	45088596	.	C	T	0	3	3	0	1	4	0	0
15	45103853	.	C	A	4	2	6	0	0	6	0	0
15	45110056	.	G	A	5	6	11	0	0	11	0	0
15	45118674	.	A	C	3	0	3	0	5	8	0	0
15	45122466	.	C	T	2	3	5	0	0	5	0	0
15	45129375	.	C	T	1	2	3	0	6	9	0	0
15	45131436	.	T	G	2	3	5	0	0	5	0	0
15	45136517	.	A	G	1	3	4	0	0	4	0	0
15	45136538	.	T	C	3	4	7	0	0	7	0	0
15	45136556	.	T	C	3	2	5	0	0	5	0	0
15	45149048	.	T	C	2	0	2	0	2	4	0	0
15	45169200	.	T	A	1	3	4	0	0	4	0	0
15	45418610	.	G	A	23	23	46	0	1	47	0	0
15	45510169	.	T	A	17	17	34	0	3	37	0	0
15	45527282	.	C	T	5	3	8	0	0	8	0	0
15	45527830	.	C	T	0	2	2	0	5	7	0	0
15	45528385	.	C	A	0	4	4	0	3	7	0	0
15	45544630	.	T	C	11	7	18	0	0	18	0	0
15	45544687	.	C	T	10	4	14	0	0	14	0	0
15	45544759	.	C	A	1	2	3	0	0	3	0	0
15	45555001	.	G	A	1	5	6	0	4	10	0	0
15	45555208	.	A	T	5	9	14	0	0	14	0	0
15	45591739	.	G	C	11	12	23	0	1	24	0	0
15	45591753	.	C	G	11	15	26	0	1	27	0	0
15	45595456	.	A	T	12	5	17	0	0	17	0	0
15	45602730	.	T	C	12	7	19	0	1	20	0	0
15	45602878	.	G	A	7	12	19	0	0	19	0	0
15	45612497	.	G	A	1	5	6	0	10	16	0	0
15	45617140	.	G	T	0	2	2	1	2	5	0	0
15	45621750	.	C	T	8	7	15	0	0	15	0	0
15	45628074	.	G	A	7	9	16	0	5	21	0	0
15	45634793	.	G	A	12	17	29	0	0	29	0	0
15	45634864	.	T	G	9	5	14	0	2	16	0	0
15	45634865	.	C	T	10	5	15	0	1	16	0	0
15	45634995	.	T	C	4	4	8	0	0	8	0	0
15	45635165	.	G	C	2	3	5	1	0	6	0	0
15	45635178	.	G	A	0	3	3	1	2	6	0	0
15	45635375	.	A	G	7	7	14	0	0	14	0	0
15	45635848	.	C	T	15	6	21	0	1	22	0	0
15	45635952	.	T	C	9	7	16	0	0	16	0	0
15	45635999	.	G	A	7	13	20	0	0	20	0	0
15	45636196	.	A	T	2	0	2	0	1	3	0	0
15	45636204	.	T	C	4	2	6	0	0	6	0	0
15	45636336	.	A	C	1	4	5	0	0	5	0	0
15	45636504	.	G	T	8	6	14	0	1	15	0	0
15	45637224	.	A	G	10	19	29	0	2	31	0	0
15	45637406	.	C	T	3	5	8	0	0	8	0	0
15	45994139	.	G	T	7	3	10	0	0	10	0	0
15	45994177	.	C	T	11	7	18	0	0	18	0	0
15	46034372	.	T	C	11	5	16	0	0	16	0	0
15	46108618	.	G	A	0	3	3	0	7	10	0	0
15	46108696	.	T	C	12	6	18	0	0	18	0	0
15	46108922	.	A	G	11	0	11	0	6	17	0	0
15	46111047	.	T	A	15	5	20	0	1	21	0	0
15	46111152	.	A	G	7	1	8	0	8	16	0	0
15	46111254	.	A	G	7	4	11	0	1	12	0	0
15	46111410	.	A	G	10	5	15	0	2	17	0	0
15	46116133	.	G	A	5	9	14	0	1	15	0	0
15	46116136	.	T	G	6	0	6	0	10	16	0	0
15	46116352	.	A	G	10	7	17	0	1	18	0	0
15	46643768	.	T	C	13	13	26	0	1	27	0	0
15	46649525	.	A	G	14	22	36	0	3	39	0	0
15	46652124	.	A	G	10	10	20	0	1	21	0	0
15	46662143	.	C	T	14	5	19	0	0	19	0	0
15	46662353	.	T	C	12	13	25	0	0	25	0	0
15	46666181	.	T	C	9	1	10	0	12	22	0	0
15	46668250	.	T	A	8	14	22	0	0	22	0	0
15	46687210	.	G	A	4	5	9	0	0	9	0	0
15	46687234	.	T	C	4	0	4	0	5	9	0	0
15	46687290	.	A	C	5	9	14	0	1	15	0	0
15	46687341	.	T	G	4	10	14	0	0	14	0	0
15	46687586	.	A	G	4	7	11	0	0	11	0	0
15	46691237	.	A	G	4	3	7	0	0	7	0	0
15	46694399	.	A	C	3	3	6	0	0	6	0	0
15	46699146	.	G	T	4	6	10	0	1	11	0	0
15	46699268	.	G	A	3	5	8	0	0	8	0	0
15	46704595	.	T	C	1	4	5	0	0	5	0	0
15	46704623	.	G	A	1	5	6	0	0	6	0	0
15	46727382	.	G	A	8	7	15	0	0	15	0	0
15	46727571	.	G	A	4	4	8	0	1	9	0	0
15	46797290	.	C	A	0	2	2	0	2	4	0	0
15	46797335	.	G	A	1	2	3	0	0	3	0	0
15	47022620	.	A	G	1	0	1	0	2	3	0	0
15	47044434	.	G	T	0	2	2	0	2	4	0	0
15	47100599	.	C	T	0	9	9	0	14	23	0	0
15	47107256	.	A	G	12	7	19	0	0	19	0	0
15	47113654	.	T	G	8	11	19	0	1	20	0	0
15	47336295	.	G	A	14	14	28	0	0	28	0	0
15	47386982	.	T	A	16	15	31	2	1	34	0	0
15	47410231	.	C	A	12	6	18	0	1	19	0	0
15	47418607	.	G	A	0	10	10	0	13	23	0	0
15	47418627	.	G	A	16	14	30	0	0	30	0	0
15	47419090	.	G	A	2	13	15	0	25	40	0	0
15	47419096	.	C	T	17	20	37	0	2	39	0	0
15	47419240	.	C	T	18	28	46	0	0	46	0	0
15	47419394	.	C	T	23	28	51	0	2	53	0	0
15	47419395	.	A	T	24	29	53	0	0	53	0	0
15	47420838	.	T	A	21	22	43	0	0	43	0	0
15	47420920	.	G	C	0	32	32	0	0	32	0	0
15	47421203	.	T	C	22	6	28	0	0	28	0	0
15	47421329	.	A	G	13	5	18	0	0	18	0	0
15	47421669	.	C	T	22	16	38	0	0	38	0	0
15	47421675	.	G	C	15	22	37	0	1	38	0	0
15	47447601	.	G	A	1	5	6	0	2	8	0	0
15	47448596	.	G	C	3	3	6	0	0	6	0	0
15	47452875	.	G	A	4	3	7	0	1	8	0	0
15	47452895	.	C	A	5	2	7	0	0	7	0	0
15	47453074	.	G	C	1	4	5	0	0	5	0	0
15	47453236	.	C	T	1	6	7	0	1	8	0	0
15	47453251	.	A	T	1	7	8	0	0	8	0	0
15	47453734	.	T	G	5	4	9	0	0	9	0	0
15	47464347	.	G	A	1	2	3	0	0	3	0	0
15	47583292	.	G	A	0	6	6	0	2	8	0	0
15	47830783	.	C	T	2	3	5	0	0	5	0	0
15	47830973	.	C	A	9	5	14	0	0	14	0	0
15	47831096	.	C	T	13	16	29	0	0	29	0	0
15	47831195	.	G	C	6	8	14	0	1	15	0	0
15	47831249	.	C	T	5	10	15	0	1	16	0	0
15	47831265	.	T	A	4	10	14	0	0	14	0	0
15	47831495	.	C	G	12	16	28	0	0	28	0	0
15	47831511	.	C	T	1	12	13	0	14	27	0	0
15	47831565	.	C	A	18	5	23	0	2	25	0	0
15	47831731	.	T	G	14	4	18	0	0	18	0	0
15	47832424	.	T	G	2	3	5	0	0	5	0	0
15	47832681	.	G	A	4	2	6	1	0	7	0	0
15	47832930	.	C	T	8	3	11	1	0	12	0	0
15	47832931	.	C	T	1	3	4	1	7	12	0	0
15	47832999	.	A	G	13	4	17	0	1	18	0	0
15	47833083	.	G	A	8	8	16	0	0	16	0	0
15	47833392	.	G	A	9	5	14	0	0	14	0	0
15	47833395	.	C	T	1	5	6	0	7	13	0	0
15	47833436	.	C	T	1	3	4	0	7	11	0	0
15	47833493	.	C	T	1	8	9	0	5	14	0	0
15	47833875	.	A	G	2	7	9	0	0	9	0	0
15	47834327	.	C	G	6	6	12	0	0	12	0	0
15	47834487	.	C	T	0	4	4	0	4	8	0	0
15	47834559	.	G	A	2	2	4	0	0	4	0	0
15	47839080	.	G	A	1	1	2	0	1	3	0	0
15	47845908	.	A	G	21	18	39	0	2	41	0	0
15	47847180	.	T	C	16	0	16	0	20	36	0	0
15	47847373	.	G	A	17	20	37	0	0	37	0	0
15	47848495	.	C	T	17	21	38	0	2	40	0	0
15	47851205	.	T	A	31	25	56	1	0	57	0	0
15	47851340	.	C	G	32	19	51	2	1	63	9	0
15	47851342	.	C	G	41	18	59	2	3	65	1	0
15	47851455	.	T	G	34	31	65	0	2	67	0	0
15	47851486	.	G	A	37	31	68	0	1	69	0	0
15	47851522	.	C	T	4	24	28	0	34	62	0	0
15	47851751	.	A	G	36	21	57	0	1	58	0	0
15	47851828	.	G	A	31	15	46	0	1	47	0	0
15	47851978	.	C	T	14	6	20	0	2	22	0	0
15	47851979	.	A	G	15	6	21	0	1	22	0	0
15	47852049	.	G	T	14	7	21	0	3	24	0	0
15	47855085	.	A	G	33	21	54	1	5	60	0	0
15	47855169	.	G	A	40	13	53	2	3	58	0	0
15	47856418	.	T	C	54	19	73	3	3	79	0	0
15	47860443	.	C	T	1	14	15	0	9	24	0	0
16	50458	.	C	A	6	8	14	0	1	15	0	0
16	68254	.	A	G	10	7	17	0	4	21	0	0
16	68355	.	T	C	7	8	15	0	0	15	0	0
16	68356	.	C	T	6	8	14	0	1	15	0	0
16	68404	.	A	G	10	8	18	0	0	18	0	0
16	68477	.	G	A	2	11	13	0	6	19	0	0
16	68513	.	G	C	0	12	12	0	9	21	0	0
16	68635	.	A	G	9	11	20	0	1	21	0	0
16	68812	.	A	G	14	8	22	0	0	22	0	0
16	68854	.	T	C	12	11	23	0	0	23	0	0
16	69005	.	T	A	20	5	25	0	6	31	0	0
16	69428	.	A	C	16	12	28	0	0	28	0	0
16	70697	.	T	C	12	14	26	0	0	26	0	0
16	70839	.	A	G	13	0	13	0	7	20	0	0
16	70881	.	A	G	6	6	12	0	3	15	0	0
16	221747	.	G	A	23	32	55	1	0	56	0	0
16	221828	.	C	T	19	28	47	0	0	47	0	0
16	224707	.	A	G	29	14	43	0	0	43	0	0
16	224734	.	C	G	25	14	39	0	2	41	0	0
16	224743	.	C	A	27	15	42	0	1	43	0	0
16	224837	.	A	C	30	18	48	0	1	49	0	0
16	224886	.	G	A	3	22	25	0	34	59	0	0
16	224974	.	A	T	34	17	51	0	0	51	0	0
16	225005	.	T	C	26	26	52	0	4	56	0	0
16	225304	.	C	A	25	27	52	0	1	53	0	0
16	225564	.	T	C	16	28	44	0	5	49	0	0
16	225615	.	A	G	27	24	51	0	1	52	0	0
16	225660	.	C	G	20	30	50	0	2	52	0	0
16	226361	.	C	G	21	25	46	0	0	46	0	0
16	226374	.	T	A	20	25	45	0	1	46	0	0
16	226526	.	A	G	9	10	19	0	2	21	0	0
16	227590	.	A	T	2	3	5	0	0	5	0	0
16	227797	.	T	C	5	1	6	0	4	10	0	0
16	250422	.	T	A	10	7	17	0	1	18	0	0
16	253879	.	G	C	6	0	6	0	3	10	1	0
16	253885	.	C	T	0	3	3	0	6	9	0	0
16	257920	.	G	A	2	3	5	0	0	5	0	0
16	257961	.	A	T	2	2	4	0	0	4	0	0
16	263460	.	A	T	2	2	4	0	0	4	0	0
16	277917	.	T	C	14	0	14	0	16	30	0	0
16	277949	.	G	T	17	8	25	0	0	25	0	0
16	278750	.	C	T	2	8	10	0	15	25	0	0
16	278978	.	A	G	11	5	16	0	0	16	0	0
16	379342	.	A	G	4	2	6	0	0	6	0	0
16	559050	.	T	A	4	3	7	0	1	8	0	0
16	560755	.	G	A	4	6	10	0	2	12	0	0
16	815859	.	C	T	5	15	20	0	3	23	0	0
16	815967	.	G	A	10	9	19	0	0	19	0	0
16	816096	.	A	G	9	8	17	0	2	19	0	0
16	817431	.	T	C	12	5	17	0	0	17	0	0
16	1199273	.	C	T	1	4	5	0	1	6	0	0
16	1199324	.	C	T	5	6	11	0	2	13	0	0
16	1199357	.	T	C	7	4	11	1	0	12	0	0
16	1199740	.	A	G	7	4	11	0	0	11	0	0
16	1199741	.	C	T	4	4	8	0	2	10	0	0
16	1204061	.	G	A	1	2	3	0	0	3	0	0
16	1205135	.	G	A	9	5	14	0	0	14	0	0
16	1207124	.	C	T	10	5	15	0	0	15	0	0
16	1207149	.	T	A	5	11	16	0	1	17	0	0
16	1207227	.	G	A	7	7	14	0	0	14	0	0
16	1209528	.	C	T	5	9	14	0	0	14	0	0
16	1210280	.	G	A	6	6	12	0	2	14	0	0
16	1210403	.	C	T	10	12	22	0	1	23	0	0
16	1228093	.	A	C	7	14	21	0	4	25	0	0
16	1230470	.	C	T	10	4	14	0	4	18	0	0
16	1234138	.	A	T	14	8	22	0	1	23	0	0
16	1334452	.	C	T	16	7	23	1	3	27	0	0
16	1354513	.	A	G	10	11	21	0	0	21	0	0
16	1355316	.	A	T	18	12	30	0	1	31	0	0
16	1355720	.	T	C	22	13	35	0	1	36	0	0
16	1359119	.	T	C	16	15	31	0	3	34	0	0
16	1398530	.	A	G	8	4	12	0	0	12	0	0
16	1398604	.	A	G	6	0	6	0	5	11	0	0
16	1466850	.	A	G	3	2	5	0	0	5	0	0
16	1523911	.	G	C	7	0	7	0	4	11	0	0
16	1549920	.	A	G	1	3	4	0	0	4	0	0
16	1551146	.	T	G	2	9	11	0	0	11	0	0
16	1569758	.	A	G	2	7	9	0	0	9	0	0
16	1572508	.	C	T	6	5	11	0	0	11	0	0
16	1573215	.	C	T	2	3	5	0	0	5	0	0
16	1573259	.	T	G	3	6	9	0	0	9	0	0
16	1577676	.	G	A	2	4	6	0	0	6	0	0
16	1580006	.	G	C	2	0	2	0	2	4	0	0
16	1602584	.	G	C	5	3	8	0	0	8	0	0
16	1884215	.	C	T	6	11	17	1	0	18	0	0
16	1884218	.	C	T	6	10	16	1	0	18	1	0
16	1996533	.	A	G	4	5	9	0	0	9	0	0
16	1996569	.	A	C	2	7	9	0	1	10	0	0
16	1996577	.	C	T	3	8	11	0	1	12	0	0
16	2009844	.	T	G	8	8	16	0	0	16	0	0
16	2009949	.	A	G	13	6	19	0	0	19	0	0
16	2033947	.	A	G	2	0	2	0	6	8	0	0
16	2043021	.	C	T	12	5	17	0	0	17	0	0
16	2043122	.	G	C	2	11	13	0	15	28	0	0
16	2071535	.	G	A	0	7	7	0	11	18	0	0
16	2102037	.	T	C	8	7	15	0	0	15	0	0
16	2102245	.	A	G	4	5	9	0	0	9	0	0
16	2102256	.	T	G	5	0	5	0	3	8	0	0
16	2102349	.	C	T	6	3	9	0	2	11	0	0
16	2102468	.	A	T	7	6	13	0	0	13	0	0
16	2102743	.	A	T	5	3	8	0	4	12	0	0
16	2103052	.	C	T	15	14	29	0	0	29	0	0
16	2103058	.	G	T	15	13	28	0	0	28	0	0
16	2103088	.	G	A	4	9	13	0	14	27	0	0
16	2103167	.	C	T	13	4	17	0	0	17	0	0
16	2103209	.	C	T	11	13	24	0	1	25	0	0
16	2103241	.	T	A	9	17	26	0	0	26	0	0
16	2103268	.	A	T	9	14	23	0	1	24	0	0
16	2103307	.	T	C	15	9	24	0	2	26	0	0
16	2103714	.	A	T	3	6	9	0	0	9	0	0
16	2104181	.	T	A	3	3	6	0	0	6	0	0
16	2104312	.	A	C	13	7	20	0	0	20	0	0
16	2104400	.	T	C	10	9	19	0	0	19	0	0
16	2104597	.	T	C	24	17	41	0	3	44	0	0
16	2104604	.	A	G	23	2	25	0	20	45	0	0
16	2105035	.	A	G	5	3	8	0	0	8	0	0
16	2353020	.	C	A	4	2	6	0	1	7	0	0
16	2353023	.	T	C	3	2	5	0	2	7	0	0
16	2353191	.	C	A	4	3	7	0	0	7	0	0
16	2353224	.	A	T	4	2	6	0	0	6	0	0
16	2353226	.	C	A	4	2	6	0	0	6	0	0
16	2365716	.	G	A	4	5	9	0	0	9	0	0
16	2368422	.	T	C	2	0	2	0	6	8	0	0
16	2373689	.	T	C	3	2	5	0	0	5	0	0
16	2380596	.	T	G	1	3	4	0	1	5	0	0
16	2380735	.	G	A	3	4	7	0	0	7	0	0
16	2388237	.	A	C	2	0	2	0	2	4	0	0
16	2388306	.	T	A	1	2	3	0	0	3	0	0
16	2388309	.	A	T	1	2	3	0	0	3	0	0
16	2472263	.	G	A	14	8	22	0	1	23	0	0
16	2472284	.	T	C	11	7	18	0	4	22	0	0
16	2484064	.	C	T	3	7	10	0	15	25	0	0
16	2485904	.	G	A	13	9	22	0	0	22	0	0
16	2494323	.	T	C	11	0	11	0	13	24	0	0
16	2495649	.	G	C	9	9	18	0	1	19	0	0
16	2517184	.	G	T	11	3	14	0	0	14	0	0
16	2519056	.	T	C	11	10	21	0	0	21	0	0
16	2519071	.	T	C	6	11	17	0	0	17	0	0
16	2525891	.	A	G	7	5	12	0	1	13	0	0
16	2526035	.	C	T	12	6	18	0	1	19	0	0
16	2528209	.	A	G	7	3	10	0	0	10	0	0
16	2539405	.	G	A	4	4	8	0	0	8	0	0
16	2542782	.	G	C	8	7	15	0	1	16	0	0
16	2544487	.	G	T	9	4	13	0	0	13	0	0
16	2545290	.	C	T	2	4	6	0	0	6	0	0
16	2557990	.	A	G	4	4	8	0	0	8	0	0
16	2558252	.	G	C	3	5	8	0	0	8	0	0
16	2567316	.	A	G	14	0	14	0	16	30	0	0
16	2568847	.	G	A	0	8	8	0	14	22	0	0
16	2574963	.	C	T	5	7	12	0	3	15	0	0
16	2577717	.	T	A	9	3	12	0	1	13	0	0
16	2580255	.	T	A	16	5	21	0	1	22	0	0
16	2580950	.	A	G	1	2	3	0	0	3	0	0
16	2638472	.	A	C	4	3	7	0	0	7	0	0
16	2807453	.	A	T	1	3	4	0	0	4	0	0
16	2824645	.	G	C	2	2	4	0	0	4	0	0
16	2827474	.	C	T	2	5	7	0	0	7	0	0
16	2827483	.	G	A	2	4	6	0	0	6	0	0
16	2833409	.	G	C	2	3	5	0	0	5	0	0
16	2843739	.	A	C	3	3	6	0	0	6	0	0
16	2843932	.	T	C	6	8	14	0	0	14	0	0
16	2843950	.	A	C	6	7	13	0	0	13	0	0
16	2844077	.	T	A	2	2	4	0	0	4	0	0
16	2970563	.	T	C	2	3	5	0	0	5	0	0
16	3089158	.	C	T	4	3	7	0	0	7	0	0
16	3091150	.	C	T	2	3	5	0	0	5	0	0
16	3091178	.	C	T	4	4	8	0	0	8	0	0
16	3091195	.	A	G	3	3	6	0	0	6	0	0
16	3091279	.	A	C	3	6	9	0	0	9	0	0
16	3091288	.	G	A	3	6	9	0	1	10	0	0
16	3093794	.	C	T	1	3	4	0	0	4	0	0
16	3095897	.	T	C	2	4	6	0	1	7	0	0
16	3096160	.	C	G	3	2	5	0	0	5	0	0
16	3096166	.	T	C	3	3	6	0	0	6	0	0
16	3096319	.	T	C	2	9	11	0	1	12	0	0
16	3096384	.	C	T	4	5	9	0	0	9	0	0
16	3096420	.	T	C	3	3	6	0	0	6	0	0
16	3096516	.	G	A	6	6	12	0	0	12	0	0
16	3463895	.	A	G	6	8	14	0	1	15	0	0
16	3470212	.	G	A	11	6	17	0	1	18	0	0
16	3470332	.	A	G	6	8	14	0	0	14	0	0
16	3499306	.	G	A	2	7	9	0	0	9	0	0
16	3499423	.	A	C	2	0	2	0	8	10	0	0
16	3523597	.	T	A	4	2	6	0	0	6	0	0
16	3548551	.	T	C	5	0	5	0	9	14	0	0
16	3576790	.	A	G	2	5	7	0	0	7	0	0
16	3579786	.	T	G	5	2	7	0	0	7	0	0
16	4059568	.	C	T	4	3	7	0	1	8	0	0
16	4067675	.	C	T	3	2	5	0	0	5	0	0
16	4067809	.	G	T	2	3	5	0	1	6	0	0
16	4070156	.	G	A	0	4	4	0	3	7	0	0
16	4071409	.	T	A	2	1	3	0	0	3	0	0
16	4071414	.	G	T	2	2	4	0	0	4	0	0
16	4071460	.	T	C	1	4	5	0	0	5	0	0
16	4103494	.	G	A	4	3	7	0	0	7	0	0
16	4105539	.	C	A	1	2	3	0	0	3	0	0
16	4115198	.	C	T	6	6	12	0	0	12	0	0
16	4115237	.	A	G	4	2	6	0	0	6	0	0
16	4117624	.	G	A	6	5	11	0	1	12	0	0
16	4117682	.	G	C	7	4	11	0	0	11	0	0
16	4117843	.	A	G	8	8	16	0	0	16	0	0
16	4118991	.	G	A	2	4	6	0	1	7	0	0
16	4119048	.	C	T	3	3	6	0	0	6	0	0
16	4124384	.	C	T	6	4	10	0	0	10	0	0
16	4126464	.	C	T	9	11	20	1	0	21	0	0
16	4126903	.	C	A	8	4	12	0	2	14	0	0
16	4126927	.	C	T	5	7	12	0	0	12	0	0
16	4128322	.	C	T	3	6	9	0	1	10	0	0
16	4129136	.	T	A	4	5	9	0	0	9	0	0
16	4131062	.	T	C	4	9	13	0	3	16	0	0
16	4131167	.	G	A	0	2	2	0	2	4	0	0
16	4131174	.	T	A	2	3	5	0	0	5	0	0
16	4138638	.	G	A	2	2	4	0	0	4	0	0
16	4138776	.	C	T	1	3	4	1	0	5	0	0
16	4160307	.	G	A	3	3	6	0	0	6	0	0
16	4163503	.	C	T	7	3	10	0	1	11	0	0
16	4163671	.	A	G	2	0	2	0	7	9	0	0
16	4168036	.	T	A	5	6	11	3	1	15	0	0
16	4168139	.	A	G	2	6	8	0	0	8	0	0
16	4190052	.	A	T	2	2	4	0	0	4	0	0
16	4190091	.	T	A	6	3	9	0	1	10	0	0
16	4190094	.	C	A	6	4	10	0	0	10	0	0
16	4190170	.	A	T	3	2	5	0	0	5	0	0
16	4190477	.	T	C	3	3	6	0	0	6	0	0
16	4190599	.	G	A	2	2	4	0	0	4	0	0
16	4197130	.	T	A	11	4	15	0	0	15	0	0
16	4200749	.	G	T	5	11	16	1	0	17	0	0
16	4201948	.	C	G	9	10	19	0	2	21	0	0
16	4202038	.	C	T	13	11	24	0	0	24	0	0
16	4202128	.	A	G	11	11	22	0	1	23	0	0
16	4287936	.	C	T	0	6	6	0	5	11	0	0
16	4287961	.	G	A	5	5	10	0	0	10	0	0
16	4288656	.	T	A	2	5	7	0	2	9	0	0
16	4293419	.	G	T	4	3	7	0	0	7	0	0
16	4317365	.	G	A	3	6	9	0	1	10	0	0
16	4513775	.	A	G	1	3	4	0	0	4	0	0
16	4513876	.	A	T	6	8	14	0	1	15	0	0
16	4513901	.	T	C	7	12	19	0	0	19	0	0
16	4513920	.	C	G	7	10	17	0	0	17	0	0
16	4514467	.	A	T	5	5	10	0	0	10	0	0
16	4514592	.	A	C	7	9	16	0	0	16	0	0
16	4514594	.	T	A	6	9	15	0	0	15	0	0
16	4514633	.	T	C	10	9	19	0	0	19	0	0
16	4514666	.	T	C	9	0	9	0	10	19	0	0
16	4514746	.	T	C	1	0	1	0	3	4	0	0
16	4514795	.	T	C	5	4	9	0	1	10	0	0
16	4515614	.	G	T	2	3	5	0	0	5	0	0
16	4515770	.	G	C	1	3	4	0	0	4	0	0
16	4515798	.	G	T	1	3	4	0	0	4	0	0
16	4515808	.	A	T	1	3	4	0	0	4	0	0
16	4516940	.	G	T	1	3	4	0	0	4	0	0
16	4516957	.	T	C	1	3	4	0	0	4	0	0
16	4517456	.	C	T	5	2	7	0	0	7	0	0
16	4517477	.	G	A	6	2	8	0	0	8	0	0
16	4517606	.	A	G	7	9	16	0	0	16	0	0
16	4517704	.	C	T	3	3	6	0	0	6	0	0
16	4520595	.	C	T	1	6	7	0	0	7	0	0
16	4520609	.	G	A	1	7	8	0	0	8	0	0
16	4531827	.	A	G	9	7	16	0	0	16	0	0
16	4533768	.	T	C	8	9	17	0	1	18	0	0
16	4538422	.	A	G	7	7	14	0	1	15	0	0
16	4540864	.	G	C	5	10	15	0	2	17	0	0
16	4541061	.	T	G	2	4	6	0	2	8	0	0
16	4541085	.	T	C	5	5	10	1	1	12	0	0
16	4541233	.	T	C	9	4	13	0	1	14	0	0
16	4541250	.	C	T	8	6	14	0	1	15	0	0
16	4541281	.	A	T	6	4	10	0	0	10	0	0
16	4541931	.	A	C	6	2	8	1	3	13	1	0
16	4541936	.	G	C	6	6	12	1	0	13	0	0
16	4542051	.	T	C	3	5	8	0	1	9	0	0
16	4542054	.	T	C	4	5	9	0	0	9	0	0
16	4542211	.	A	G	6	4	10	0	0	10	0	0
16	4542252	.	A	G	5	2	7	0	0	7	0	0
16	4542273	.	T	A	4	4	8	0	0	8	0	0
16	4542518	.	C	T	3	16	19	0	7	26	0	0
16	4545454	.	T	C	10	7	17	1	2	20	0	0
16	4546606	.	A	C	9	0	9	0	11	20	0	0
16	4546651	.	G	A	2	8	10	0	1	11	0	0
16	4573450	.	G	T	3	2	5	0	1	6	0	0
16	4573458	.	C	T	5	3	8	0	0	8	0	0
16	4573556	.	A	T	7	9	16	0	4	20	0	0
16	4573588	.	A	G	4	8	12	0	4	16	0	0
16	4575940	.	G	A	3	7	10	0	0	10	0	0
16	4583847	.	A	T	5	3	8	0	0	8	0	0
16	4583864	.	A	G	4	3	7	0	0	7	0	0
16	4587184	.	C	T	3	4	7	0	0	7	0	0
16	4587187	.	G	A	3	4	7	0	0	7	0	0
16	4591911	.	T	C	1	0	1	0	4	5	0	0
16	4615993	.	C	A	10	11	21	0	0	21	0	0
16	4616071	.	A	T	14	15	29	1	0	30	0	0
16	4619598	.	A	T	15	16	31	0	2	33	0	0
16	4619614	.	A	G	14	16	30	0	1	31	0	0
16	4628953	.	T	C	5	7	12	0	0	12	0	0
16	4630127	.	G	T	6	6	12	0	1	13	0	0
16	4630143	.	C	T	9	7	16	0	0	16	0	0
16	4695172	.	G	C	2	6	8	0	5	13	0	0
16	4695323	.	A	C	4	3	7	0	1	8	0	0
16	4695368	.	T	A	6	2	8	0	0	8	0	0
16	4695530	.	A	G	3	6	9	0	3	12	0	0
16	4697566	.	C	G	3	3	6	0	0	6	0	0
16	4697821	.	G	A	7	2	9	0	0	9	0	0
16	4700766	.	T	C	9	5	14	0	1	15	0	0
16	4707211	.	G	T	0	4	4	0	8	12	0	0
16	4707381	.	A	T	1	4	5	0	2	7	0	0
16	4707544	.	G	A	4	5	9	0	0	9	0	0
16	4715613	.	T	A	2	3	5	0	0	5	0	0
16	4755816	.	A	T	10	11	21	0	0	21	0	0
16	4759113	.	G	A	4	11	15	0	0	15	0	0
16	4761133	.	T	C	5	0	5	0	10	15	0	0
16	4769909	.	A	C	2	0	2	0	6	8	0	0
16	4770454	.	A	C	4	5	9	0	0	9	0	0
16	4772790	.	G	A	3	2	5	0	0	5	0	0
16	4772837	.	G	A	0	3	3	0	2	5	0	0
16	4842308	.	A	G	6	3	9	0	0	9	0	0
16	4858779	.	G	T	0	5	5	0	13	18	0	0
16	4860516	.	A	G	3	7	10	0	0	10	0	0
16	4867445	.	C	T	12	10	22	0	0	22	0	0
16	4867487	.	C	T	12	11	23	0	0	23	0	0
16	4869973	.	G	A	8	13	21	0	0	21	0	0
16	4870180	.	C	T	11	11	22	0	1	23	0	0
16	4872260	.	C	T	7	9	16	0	1	17	0	0
16	4872281	.	G	A	9	6	15	0	0	15	0	0
16	4872320	.	G	A	9	5	14	0	1	15	0	0
16	4872453	.	C	T	5	7	12	0	0	12	0	0
16	4875417	.	C	T	10	7	17	0	1	18	0	0
16	4876470	.	C	T	11	7	18	0	1	19	0	0
16	4879768	.	T	C	7	4	11	0	0	11	0	0
16	4882206	.	C	T	11	12	23	0	0	23	0	0
16	4882491	.	C	T	8	11	19	0	0	19	0	0
16	4882492	.	G	A	2	10	12	0	7	19	0	0
16	4885458	.	T	A	8	11	19	0	0	19	0	0
16	4895423	.	T	C	10	13	23	0	1	24	0	0
16	4907977	.	A	G	1	2	3	0	0	3	0	0
16	5086725	.	G	A	8	9	17	0	0	17	0	0
16	5091076	.	G	A	12	9	21	0	0	21	0	0
16	5105119	.	T	G	10	7	17	0	2	19	0	0
16	5105291	.	C	A	4	3	7	0	0	7	0	0
16	5145459	.	T	C	11	15	26	0	0	26	0	0
16	5145599	.	C	A	16	18	34	0	1	35	0	0
16	5145622	.	G	A	15	26	41	0	0	41	0	0
16	5149298	.	T	C	19	14	33	0	1	34	0	0
16	5150817	.	G	A	1	2	3	0	1	4	0	0
16	5153956	.	T	C	22	14	36	0	4	40	0	0
16	5153996	.	T	G	9	3	12	0	2	14	0	0
16	5154004	.	C	T	6	2	8	0	0	8	0	0
16	5156563	.	G	A	1	8	9	0	9	18	0	0
16	5159283	.	A	G	6	7	13	0	2	15	0	0
16	5159289	.	C	T	8	8	16	0	0	16	0	0
16	5159328	.	T	C	15	8	23	0	0	23	0	0
16	5163275	.	T	C	8	4	12	0	0	12	0	0
16	5164569	.	C	T	11	5	16	0	1	17	0	0
16	5166015	.	G	A	1	17	18	0	12	30	0	0
16	5166030	.	C	T	13	14	27	0	1	28	0	0
16	5166288	.	G	A	15	18	33	0	1	34	0	0
16	5166332	.	T	A	15	18	33	0	0	34	1	0
16	5166351	.	T	C	18	13	31	0	2	33	0	0
16	5166546	.	G	A	12	14	26	0	1	27	0	0
16	5166719	.	A	G	6	8	14	1	1	16	0	0
16	5166805	.	A	G	7	1	8	0	17	25	0	0
16	5166889	.	G	T	10	8	18	0	2	20	0	0
16	5166977	.	G	T	10	14	24	0	0	24	0	0
16	5167010	.	A	G	14	0	14	0	8	22	0	0
16	5167030	.	G	A	12	9	21	0	1	22	0	0
16	5167050	.	A	G	14	0	14	0	7	21	0	0
16	5167257	.	A	G	12	8	20	0	0	20	0	0
16	5188029	.	A	C	13	7	20	0	1	21	0	0
16	5190168	.	C	T	5	5	10	0	1	11	0	0
16	5190210	.	C	T	8	7	15	0	0	15	0	0
16	5193644	.	G	A	7	4	11	0	0	11	0	0
16	5193682	.	C	T	4	7	11	0	0	11	0	0
16	5196813	.	C	A	5	9	14	0	0	14	0	0
16	5199381	.	C	T	7	5	12	0	0	12	0	0
16	5199399	.	C	T	5	3	8	0	0	8	0	0
16	5199442	.	C	T	4	5	9	0	0	9	0	0
16	5199503	.	C	T	11	7	18	0	1	19	0	0
16	5221622	.	T	A	6	11	17	0	0	17	0	0
16	5221680	.	A	C	4	8	12	0	0	12	0	0
16	5221888	.	T	C	6	3	9	0	0	9	0	0
16	5223206	.	G	A	12	11	23	0	2	25	0	0
16	5223740	.	C	T	6	13	19	0	0	19	0	0
16	5223880	.	G	C	1	13	14	0	9	23	0	0
16	5224375	.	G	C	0	23	23	0	13	36	0	0
16	5224429	.	A	T	9	25	34	0	1	35	0	0
16	5230627	.	G	A	0	11	11	0	10	21	0	0
16	5230782	.	A	T	4	8	12	0	1	13	0	0
16	5251797	.	C	G	2	3	5	0	0	5	0	0
16	5251798	.	T	C	2	3	5	0	0	5	0	0
16	5475143	.	G	A	1	2	3	0	0	3	0	0
16	5475151	.	C	A	1	1	2	0	0	2	0	0
16	5490663	.	A	G	1	2	3	0	0	3	0	0
16	5492649	.	C	T	3	2	5	0	0	5	0	0
16	5492736	.	T	C	2	2	4	0	0	4	0	0
16	5492743	.	G	A	2	2	4	0	0	4	0	0
16	5496522	.	T	C	3	7	10	0	0	10	0	0
16	5496874	.	C	A	3	5	8	0	0	8	0	0
16	5496904	.	T	G	4	4	8	0	0	8	0	0
16	5601098	.	G	C	3	3	6	0	0	6	0	0
16	5601113	.	A	G	3	0	3	0	3	6	0	0
16	5604534	.	C	T	3	3	6	0	0	6	0	0
16	5604846	.	T	C	4	3	7	0	1	8	0	0
16	5604865	.	A	G	2	4	6	0	1	7	0	0
16	5604915	.	C	T	3	2	5	0	0	5	0	0
16	5612617	.	A	T	7	9	16	0	1	17	0	0
16	5612631	.	A	T	9	8	17	0	0	17	0	0
16	5620883	.	C	T	3	6	9	0	1	10	0	0
16	5623099	.	T	C	3	3	6	0	0	6	0	0
16	5623120	.	T	C	3	6	9	0	0	9	0	0
16	5624209	.	C	T	5	3	8	0	0	8	0	0
16	5633503	.	G	C	0	5	5	0	4	9	0	0
16	5687499	.	T	C	5	13	18	0	0	18	0	0
16	5687520	.	G	A	4	9	13	0	0	13	0	0
16	5693532	.	T	C	6	7	13	0	0	13	0	0
16	5697039	.	C	T	5	8	13	0	0	13	0	0
16	5700534	.	C	T	20	9	29	0	0	29	0	0
16	5700577	.	T	A	8	15	23	0	1	24	0	0
16	5700578	.	T	C	8	15	23	0	1	24	0	0
16	5700646	.	T	C	12	11	23	0	1	24	0	0
16	5700689	.	G	A	2	7	9	0	10	19	0	0
16	5702807	.	C	T	9	10	19	0	0	19	0	0
16	5702891	.	T	G	14	7	21	0	0	21	0	0
16	5702906	.	T	C	18	6	24	0	1	25	0	0
16	5705811	.	G	T	0	8	8	0	13	21	0	0
16	5710369	.	C	T	17	9	26	0	0	26	0	0
16	5710652	.	G	T	12	3	15	0	0	15	0	0
16	5710672	.	G	A	7	2	9	0	0	9	0	0
16	5776274	.	T	C	18	23	41	0	3	44	0	0
16	5776356	.	C	T	22	24	46	0	0	46	0	0
16	5776371	.	T	G	16	25	41	0	1	42	0	0
16	5778882	.	A	G	16	19	35	0	0	35	0	0
16	5778913	.	T	C	23	19	42	0	1	43	0	0
16	5786945	.	G	A	9	6	15	0	0	15	0	0
16	5786989	.	C	T	0	13	13	0	6	19	0	0
16	5787185	.	A	T	8	5	13	0	1	14	0	0
16	5787396	.	A	G	6	2	8	0	5	13	0	0
16	5787399	.	T	A	7	7	14	0	2	16	0	0
16	5787435	.	T	C	10	7	17	0	0	17	0	0
16	5787506	.	T	A	8	10	18	0	0	18	0	0
16	5787562	.	G	A	5	11	16	0	0	16	0	0
16	5787671	.	G	C	8	6	14	0	0	14	0	0
16	5787870	.	T	G	5	7	12	0	0	12	0	0
16	5787872	.	A	T	5	6	11	0	1	12	0	0
16	5787931	.	A	G	7	2	9	0	1	10	0	0
16	5787981	.	T	C	3	5	8	0	1	9	0	0
16	5788079	.	A	G	4	8	12	0	0	12	0	0
16	5788405	.	A	T	7	6	13	0	0	13	0	0
16	5788410	.	A	T	5	6	11	0	0	11	0	0
16	5788655	.	T	C	6	6	12	0	0	12	0	0
16	5788705	.	T	C	5	9	14	0	0	14	0	0
16	5788716	.	C	T	1	10	11	0	5	16	0	0
16	5795721	.	C	T	0	10	10	0	4	14	0	0
16	5808789	.	C	T	1	3	4	0	3	7	0	0
16	5808802	.	A	G	4	3	7	0	0	7	0	0
16	5808910	.	T	C	12	7	19	0	0	19	0	0
16	5808931	.	G	A	8	10	18	0	0	18	0	0
16	5812610	.	C	T	0	4	4	0	2	6	0	0
16	5812703	.	G	A	2	6	8	0	0	8	0	0
16	5819209	.	T	A	5	7	12	0	0	12	0	0
16	5819970	.	T	A	5	9	14	0	0	14	0	0
16	6174231	.	T	C	1	4	5	0	0	5	0	0
16	6183022	.	A	C	23	23	46	0	4	50	0	0
16	6183658	.	T	G	39	33	72	0	1	74	1	0
16	6191622	.	C	G	31	34	65	1	1	67	0	0
16	6192811	.	A	G	29	23	52	0	3	55	0	0
16	6197212	.	T	C	29	22	51	0	1	52	0	0
16	6197593	.	G	A	25	29	54	0	2	56	0	0
16	6376437	.	C	G	0	2	2	0	2	4	0	0
16	6376446	.	A	G	1	2	3	0	0	3	0	0
16	6387037	.	G	A	17	20	37	0	2	39	0	0
16	6387121	.	G	A	27	25	52	0	1	53	0	0
16	6387143	.	A	C	30	3	33	0	22	55	0	0
16	6387157	.	A	C	39	24	63	0	1	64	0	0
16	6395740	.	T	A	4	7	11	0	0	11	0	0
16	6395904	.	A	G	8	4	12	0	2	14	0	0
16	6395906	.	A	G	11	5	16	0	0	16	0	0
16	6405013	.	C	G	0	2	2	0	2	4	0	0
16	6405067	.	A	G	3	2	5	0	1	6	0	0
16	6409553	.	T	C	3	0	3	0	3	6	0	0
16	6409570	.	C	A	1	3	4	0	0	4	0	0
16	6649968	.	T	G	4	0	4	0	3	7	0	0
16	6650049	.	T	C	2	4	6	0	0	6	0	0
16	6650087	.	C	T	2	3	5	0	0	5	0	0
16	6650394	.	T	C	2	2	4	0	0	4	0	0
16	6650415	.	T	C	3	2	5	0	0	5	0	0
16	6650631	.	C	A	7	3	10	0	1	11	0	0
16	6650793	.	T	A	1	3	4	0	0	4	0	0
16	6653139	.	G	T	1	5	6	0	0	6	0	0
16	6653508	.	C	A	3	3	6	0	1	7	0	0
16	6653587	.	T	A	3	3	6	0	0	6	0	0
16	6653875	.	G	T	6	4	10	0	1	11	0	0
16	6653883	.	A	G	7	2	9	0	0	9	0	0
16	6654152	.	T	C	2	5	7	0	0	7	0	0
16	6733608	.	C	G	2	2	4	0	0	4	0	0
16	6735410	.	G	A	2	2	4	0	0	4	0	0
16	6740784	.	C	T	1	2	3	0	0	3	0	0
16	6742797	.	T	C	2	3	5	0	0	5	0	0
16	6745636	.	T	C	3	3	6	0	0	6	0	0
16	6758494	.	C	T	3	2	5	0	0	5	0	0
16	6762166	.	A	C	3	2	5	0	0	5	0	0
16	6763131	.	C	T	4	2	6	0	0	6	0	0
16	6763134	.	C	T	4	2	6	0	0	6	0	0
16	6764962	.	T	C	6	5	11	0	1	12	0	0
16	6765015	.	T	C	4	4	8	0	0	8	0	0
16	6769286	.	A	G	3	4	7	0	0	7	0	0
16	6771841	.	T	C	3	3	6	0	3	9	0	0
16	6778545	.	C	T	6	2	8	0	0	8	0	0
16	6779823	.	C	T	2	2	4	0	0	4	0	0
16	6782653	.	T	C	1	3	4	0	0	4	0	0
16	6782896	.	A	T	2	5	7	0	0	7	0	0
16	6782918	.	T	C	3	4	7	0	1	8	0	0
16	6782948	.	T	C	3	3	6	0	0	6	0	0
16	6784609	.	C	G	3	5	8	0	0	8	0	0
16	6784791	.	T	C	4	3	7	0	0	7	0	0
16	6787491	.	G	A	2	4	6	0	3	9	0	0
16	6793312	.	C	T	10	8	18	0	0	18	0	0
16	6793333	.	C	G	9	4	13	0	0	13	0	0
16	6796096	.	C	T	6	3	9	0	0	9	0	0
16	6796105	.	G	A	0	4	4	0	5	9	0	0
16	6796195	.	A	G	9	5	14	0	2	16	0	0
16	6796279	.	T	C	6	2	8	0	0	8	0	0
16	6800033	.	G	A	4	3	7	0	0	7	0	0
16	6800140	.	C	T	6	2	8	0	0	8	0	0
16	6800263	.	G	A	4	2	6	0	0	6	0	0
16	6800289	.	G	A	3	2	5	0	0	5	0	0
16	6803429	.	T	C	9	8	17	0	2	19	0	0
16	6803725	.	T	C	20	21	41	0	1	42	0	0
16	6803736	.	G	C	24	21	45	0	0	45	0	0
16	6803887	.	A	G	19	16	35	0	1	36	0	0
16	6809872	.	A	G	19	25	44	0	2	46	0	0
16	6820725	.	G	A	7	10	17	0	0	17	0	0
16	6821332	.	A	G	5	6	11	0	0	11	0	0
16	6821465	.	C	T	1	8	9	0	10	19	0	0
16	6821995	.	T	C	13	0	13	0	12	25	0	0
16	6849625	.	A	G	6	4	10	0	2	12	0	0
16	6864716	.	T	C	4	3	7	0	0	7	0	0
16	6903350	.	T	A	5	3	8	0	0	8	0	0
16	6903599	.	G	A	2	2	4	0	0	4	0	0
16	6903680	.	A	G	4	0	4	0	5	9	0	0
16	6909982	.	A	G	6	2	8	0	0	8	0	0
16	6923646	.	A	T	6	4	10	0	0	10	0	0
16	6926751	.	C	T	5	4	9	0	1	10	0	0
16	6929812	.	C	T	6	3	9	0	0	9	0	0
16	6929832	.	G	A	5	3	8	0	0	8	0	0
16	6929860	.	G	A	3	3	6	0	0	6	0	0
16	6929886	.	C	G	5	2	7	0	0	7	0	0
16	6932384	.	A	T	3	3	6	0	0	6	0	0
16	6932420	.	G	A	4	5	9	0	0	9	0	0
16	6932423	.	C	T	4	5	9	0	0	9	0	0
16	6932477	.	G	A	9	3	12	0	0	12	0	0
16	6932820	.	T	A	6	3	9	0	0	9	0	0
16	6932886	.	A	T	5	3	8	0	0	8	0	0
16	6933016	.	T	C	10	3	13	0	0	13	0	0
16	6937543	.	T	C	1	0	1	0	2	3	0	0
16	6938057	.	C	T	0	4	4	0	1	5	0	0
16	6940345	.	C	T	6	2	8	0	0	8	0	0
16	6943853	.	T	C	4	2	6	0	0	6	0	0
16	6944603	.	G	T	2	2	4	0	0	4	0	0
16	6944766	.	T	C	9	18	27	0	2	29	0	0
16	6947998	.	T	C	19	23	42	0	0	42	0	0
16	6972704	.	G	C	1	2	3	0	0	3	0	0
16	7376648	.	C	T	2	2	4	0	0	4	0	0
16	7376900	.	A	G	7	6	13	0	0	13	0	0
16	7385689	.	C	T	6	7	13	0	0	13	0	0
16	7385705	.	A	G	5	6	11	0	0	11	0	0
16	7385807	.	C	T	8	10	18	0	0	18	0	0
16	7415215	.	G	A	14	6	20	0	0	20	0	0
16	7415254	.	T	A	14	10	24	0	2	26	0	0
16	7415423	.	C	A	11	14	25	0	1	26	0	0
16	7415435	.	G	A	11	15	26	0	1	27	0	0
16	7415542	.	A	T	9	15	24	0	2	26	0	0
16	7415559	.	C	A	8	17	25	0	3	28	0	0
16	7415761	.	G	A	12	10	22	0	1	23	0	0
16	7415793	.	G	A	13	8	21	0	1	22	0	0
16	7416236	.	C	T	9	5	14	0	0	14	0	0
16	7416320	.	C	T	11	9	20	0	0	20	0	0
16	7416352	.	T	A	7	6	13	0	0	13	0	0
16	7626589	.	T	C	19	11	30	0	0	30	0	0
16	7630612	.	T	C	23	13	36	0	0	36	0	0
16	7635527	.	C	T	19	18	37	0	0	37	0	0
16	7635721	.	T	A	17	19	36	1	1	38	0	0
16	7638788	.	T	C	19	17	36	0	0	36	0	0
16	7638815	.	A	T	24	21	45	0	0	45	0	0
16	7638828	.	A	G	24	1	25	0	20	45	0	0
16	7638866	.	A	T	30	9	39	0	1	40	0	0
16	7638979	.	C	T	27	16	43	0	2	45	0	0
16	7638984	.	C	A	22	15	37	0	6	43	0	0
16	7639085	.	A	C	24	21	45	0	2	47	0	0
16	7639100	.	T	A	26	20	46	0	2	48	0	0
16	7639401	.	A	C	29	20	49	0	0	49	0	0
16	7639527	.	C	T	19	19	38	0	2	40	0	0
16	7639534	.	G	C	3	21	24	0	18	42	0	0
16	7639621	.	C	T	29	13	42	0	2	45	1	0
16	7639643	.	A	T	26	11	37	0	0	37	0	0
16	7639684	.	A	G	15	14	29	0	2	31	0	0
16	7639774	.	T	A	16	12	28	0	0	28	0	0
16	7639856	.	T	C	14	28	42	0	1	43	0	0
16	7640116	.	A	G	22	23	45	0	2	47	0	0
16	7640127	.	G	A	3	24	27	0	23	50	0	0
16	7640410	.	A	G	30	15	45	0	0	45	0	0
16	7640425	.	T	A	30	19	49	0	2	51	0	0
16	7640757	.	T	A	16	11	27	0	0	27	0	0
16	7705796	.	T	C	2	2	4	0	0	4	0	0
16	7711556	.	C	A	4	5	9	0	0	9	0	0
16	7716184	.	C	G	5	3	8	0	1	9	0	0
16	7725555	.	A	T	5	6	11	0	0	11	0	0
16	7728408	.	C	T	6	5	11	0	0	11	0	0
16	7743398	.	C	T	0	4	4	0	9	13	0	0
16	7743598	.	T	A	2	4	6	0	1	7	0	0
16	7743687	.	A	G	5	6	11	0	0	11	0	0
16	7745027	.	C	A	5	2	7	0	1	8	0	0
16	7745053	.	C	G	5	6	11	0	0	11	0	0
16	7745398	.	A	G	3	2	5	0	0	5	0	0
16	7746040	.	G	C	1	2	3	0	1	4	0	0
16	7746152	.	A	T	5	2	7	0	0	7	0	0
16	7746153	.	G	A	4	2	6	0	0	6	0	0
16	7746193	.	G	A	5	4	9	0	0	9	0	0
16	7746947	.	G	A	1	3	4	0	0	4	0	0
16	7748346	.	G	A	1	4	5	0	0	5	0	0
16	7748364	.	G	A	2	4	6	0	0	6	0	0
16	7758386	.	C	T	3	6	9	0	0	9	0	0
16	7803023	.	T	C	6	9	15	0	2	17	0	0
16	7803298	.	T	C	6	3	9	0	0	9	0	0
16	7803340	.	T	C	1	4	5	0	0	5	0	0
16	7803401	.	A	G	3	0	3	0	0	6	3	0
16	7803418	.	G	C	2	4	6	0	0	6	0	0
16	7803560	.	A	G	7	5	12	0	3	15	0	0
16	7803627	.	T	A	8	4	12	0	0	12	0	0
16	7803765	.	C	G	14	8	22	0	0	22	0	0
16	7803782	.	C	A	1	5	6	0	11	17	0	0
16	7803825	.	A	T	4	3	7	0	0	7	0	0
16	7803905	.	G	C	8	0	8	0	3	11	0	0
16	7803923	.	T	A	6	5	11	0	0	11	0	0
16	7803971	.	T	A	6	5	11	0	1	12	0	0
16	7804081	.	T	A	3	3	6	0	0	6	0	0
16	7804196	.	A	G	4	3	7	0	0	7	0	0
16	7804209	.	C	A	0	3	3	0	4	7	0	0
16	7804269	.	A	T	8	6	14	0	2	16	0	0
16	7804270	.	C	T	9	7	16	0	0	16	0	0
16	7804458	.	A	C	2	4	6	0	0	6	0	0
16	7804569	.	C	A	8	3	11	0	0	11	0	0
16	7804588	.	C	A	6	3	9	0	0	9	0	0
16	7804914	.	C	T	3	2	5	0	0	5	0	0
16	7804990	.	A	C	4	2	6	0	1	7	0	0
16	7805051	.	A	G	4	2	6	0	1	7	0	0
16	7805423	.	C	T	0	8	8	0	7	15	0	0
16	7805524	.	C	A	0	3	3	0	7	10	0	0
16	7821241	.	C	T	6	6	12	0	0	12	0	0
16	7821244	.	G	A	6	6	12	0	0	12	0	0
16	7828792	.	G	T	5	2	7	0	0	8	1	0
16	7985896	.	T	A	3	6	9	0	0	9	0	0
16	7994808	.	T	G	3	4	7	0	0	7	0	0
16	7998969	.	A	G	2	2	4	0	0	4	0	0
16	7999368	.	A	G	3	4	7	0	1	8	0	0
16	7999499	.	C	A	2	3	5	0	0	5	0	0
16	8001064	.	C	A	2	2	4	0	2	6	0	0
16	8041234	.	G	A	1	4	5	0	4	9	0	0
16	8041261	.	T	A	6	2	8	0	0	8	0	0
16	8051564	.	G	T	15	5	20	0	2	22	0	0
16	8051941	.	T	C	10	0	10	0	15	25	0	0
16	8052033	.	T	C	11	14	25	0	3	28	0	0
16	8052049	.	G	A	12	16	28	0	1	29	0	0
16	8052145	.	C	A	15	13	28	0	0	28	0	0
16	8052537	.	C	T	9	14	23	0	1	24	0	0
16	8052606	.	T	C	9	0	9	0	19	28	0	0
16	8052651	.	T	C	13	14	27	0	2	29	0	0
16	8052673	.	G	C	20	1	21	0	12	33	0	0
16	8052747	.	A	G	8	8	16	0	1	17	0	0
16	8052831	.	T	A	10	10	20	0	0	20	0	0
16	8052866	.	C	A	1	5	6	3	6	15	0	0
16	8052883	.	T	C	9	3	12	7	0	19	0	0
16	8052909	.	T	A	6	6	12	5	0	17	0	0
16	8052982	.	T	C	5	9	14	2	0	16	0	0
16	8053206	.	T	G	5	8	13	0	1	14	0	0
16	8053403	.	C	T	15	10	25	1	0	26	0	0
16	8053485	.	C	T	12	7	19	0	0	19	0	0
16	8053716	.	A	G	23	9	32	0	3	35	0	0
16	8053717	.	T	C	22	12	34	0	1	35	0	0
16	8054260	.	T	G	1	6	7	0	0	7	0	0
16	8054389	.	C	T	0	6	6	0	3	9	0	0
16	8054434	.	T	C	7	1	8	0	13	21	0	0
16	8055037	.	A	G	6	8	14	0	1	15	0	0
16	8059585	.	T	C	8	11	19	0	0	19	0	0
16	8066237	.	A	C	8	9	17	0	0	17	0	0
16	8066318	.	A	G	8	8	16	0	0	16	0	0
16	8119672	.	G	A	9	7	16	0	1	17	0	0
16	8119976	.	A	G	11	11	22	0	1	23	0	0
16	8120033	.	G	A	13	7	20	0	1	21	0	0
16	8120171	.	C	T	13	7	20	0	1	21	0	0
16	8139585	.	G	A	2	3	5	0	2	7	0	0
16	8139752	.	A	T	1	3	4	0	0	4	0	0
16	8139786	.	T	C	3	4	7	0	0	7	0	0
16	8160484	.	T	C	6	4	10	0	1	11	0	0
16	8160589	.	T	C	5	2	7	0	0	7	0	0
16	8161573	.	C	A	1	3	4	0	0	4	0	0
16	8161591	.	G	A	1	4	5	0	0	5	0	0
16	8161708	.	G	A	0	6	6	0	4	10	0	0
16	8299123	.	T	A	10	4	14	0	1	15	0	0
16	8299302	.	G	A	6	4	10	0	0	10	0	0
16	8299308	.	T	A	5	5	10	0	0	10	0	0
16	8299410	.	T	A	1	3	4	0	0	4	0	0
16	8299705	.	G	A	6	3	9	0	0	9	0	0
16	8299968	.	G	A	3	2	5	0	0	5	0	0
16	8299970	.	G	A	3	2	5	0	0	5	0	0
16	8300218	.	T	A	5	3	8	0	0	8	0	0
16	8300225	.	C	T	1	3	4	0	5	9	0	0
16	8300255	.	G	A	4	4	8	0	0	8	0	0
16	8300269	.	T	C	4	1	5	0	0	5	0	0
16	8300543	.	C	A	1	2	3	0	0	3	0	0
16	8300823	.	T	A	3	5	8	0	0	8	0	0
16	8310813	.	A	G	1	2	3	0	0	3	0	0
16	8323386	.	T	C	1	3	4	0	1	5	0	0
16	8339352	.	G	C	2	0	2	0	2	4	0	0
16	8531299	.	C	T	4	2	6	0	2	8	0	0
16	8532240	.	G	C	3	2	5	0	0	5	0	0
16	8540664	.	G	T	1	4	5	0	0	5	0	0
16	8752017	.	T	A	19	17	36	0	3	39	0	0
16	8752091	.	A	G	20	19	39	0	1	40	0	0
16	8752223	.	C	T	13	12	25	0	1	26	0	0
16	8752316	.	G	T	19	13	32	0	0	32	0	0
16	8752334	.	C	T	2	13	15	0	18	33	0	0
16	8759975	.	G	A	17	22	39	0	0	39	0	0
16	8771091	.	A	G	4	7	11	0	0	11	0	0
16	8788386	.	T	C	9	5	14	0	4	18	0	0
16	8788446	.	A	G	10	12	22	0	0	22	0	0
16	8788629	.	T	C	12	0	12	0	7	19	0	0
16	8788659	.	G	C	12	6	18	0	1	19	0	0
16	8816122	.	G	A	9	9	18	0	1	19	0	0
16	8818958	.	T	C	8	13	21	0	1	22	0	0
16	8819113	.	T	C	4	8	12	0	0	12	0	0
16	8834219	.	G	T	9	11	20	0	1	21	0	0
16	8844580	.	A	G	10	13	23	1	0	24	0	0
16	8844586	.	C	A	12	13	25	1	1	27	0	0
16	8845738	.	T	G	9	16	25	0	1	26	0	0
16	8847272	.	T	C	4	12	16	0	1	17	0	0
16	8862269	.	G	A	4	10	14	0	0	14	0	0
16	9265947	.	A	G	2	2	4	0	0	4	0	0
16	9276038	.	T	A	6	9	15	0	1	16	0	0
16	9281297	.	T	C	13	12	25	0	1	26	0	0
16	9281534	.	G	A	14	8	22	0	0	22	0	0
16	9286987	.	A	G	6	5	11	0	0	11	0	0
16	9292698	.	T	C	6	0	6	0	9	15	0	0
16	9297728	.	C	T	10	6	16	0	1	17	0	0
16	9299700	.	C	T	5	4	9	0	0	9	0	0
16	9348891	.	C	T	3	6	9	0	0	9	0	0
16	9400820	.	T	C	1	3	4	0	1	5	0	0
16	9408337	.	T	C	1	5	6	0	0	6	0	0
16	9409013	.	C	A	4	5	9	0	0	9	0	0
16	9410978	.	C	G	2	4	6	0	0	6	0	0
16	9411331	.	T	G	1	2	3	0	0	3	0	0
16	9411737	.	T	G	2	2	4	0	0	4	0	0
16	9411749	.	G	A	3	3	6	0	0	6	0	0
16	9412024	.	A	T	2	2	4	0	1	5	0	0
16	9412048	.	T	C	3	4	7	0	0	7	0	0
16	9412125	.	A	G	4	3	7	0	1	8	0	0
16	9412151	.	T	C	5	4	9	0	0	9	0	0
16	9412348	.	C	T	4	4	8	0	0	8	0	0
16	9412350	.	C	T	3	4	7	0	0	7	0	0
16	9412401	.	C	T	2	5	7	0	0	7	0	0
16	9412994	.	G	T	2	2	4	0	0	4	0	0
16	9415176	.	A	G	5	4	9	0	0	9	0	0
16	9415749	.	G	A	3	5	8	0	0	8	0	0
16	9415793	.	C	T	4	3	7	0	0	7	0	0
16	9416017	.	A	G	1	4	5	0	1	6	0	0
16	9434023	.	G	A	4	7	11	0	1	12	0	0
16	9434036	.	G	A	5	8	13	0	2	15	0	0
16	9437789	.	G	A	12	6	18	0	2	20	0	0
16	9438075	.	A	G	7	5	12	0	0	12	0	0
16	9526186	.	G	A	1	6	7	0	0	7	0	0
16	9581981	.	T	C	5	6	11	0	0	11	0	0
16	9584145	.	A	G	8	3	11	0	0	11	0	0
16	9585301	.	A	C	3	6	9	0	0	9	0	0
16	9587606	.	T	C	1	4	5	0	0	5	0	0
16	9590394	.	G	T	4	2	6	0	0	6	0	0
16	9590406	.	A	G	4	4	8	0	0	8	0	0
16	9596127	.	C	T	4	7	11	0	1	12	0	0
16	9603382	.	T	C	3	8	11	0	0	11	0	0
16	9605806	.	A	G	7	4	11	0	1	12	0	0
16	9605947	.	A	G	12	6	18	0	0	18	0	0
16	9606011	.	G	T	8	5	13	0	0	13	0	0
16	9606024	.	C	T	7	4	11	0	0	11	0	0
16	9606048	.	G	A	5	3	8	0	0	8	0	0
16	9661592	.	G	A	1	2	3	0	0	3	0	0
16	9714080	.	G	A	8	7	15	0	0	15	0	0
16	9714474	.	T	G	8	3	11	0	1	12	0	0
16	9714483	.	A	G	2	8	10	0	0	10	0	0
16	9716237	.	C	A	2	3	5	0	1	6	0	0
16	9716258	.	T	C	2	4	6	0	0	6	0	0
16	9724878	.	A	T	2	10	12	0	0	12	0	0
16	9724909	.	T	A	4	7	11	0	0	11	0	0
16	9725137	.	A	T	1	5	6	0	0	6	0	0
16	9725196	.	C	G	2	4	6	0	0	6	0	0
16	9748874	.	C	G	4	4	8	0	0	8	0	0
16	9751693	.	A	C	2	7	9	0	1	10	0	0
16	9752999	.	A	G	7	4	11	0	0	11	0	0
16	9753005	.	C	G	7	4	11	0	0	11	0	0
16	9753083	.	A	T	8	4	12	0	0	12	0	0
16	9755701	.	G	A	9	9	18	0	0	18	0	0
16	9755719	.	G	T	0	10	10	0	9	19	0	0
16	9758164	.	C	T	10	6	16	1	0	17	0	0
16	9758906	.	C	A	2	3	5	0	2	7	0	0
16	9758911	.	T	A	3	2	5	0	1	6	0	0
16	9758944	.	G	A	0	5	5	0	3	8	0	0
16	9758958	.	T	C	2	7	9	0	0	9	0	0
16	9759090	.	T	C	0	9	9	0	1	10	0	0
16	9759244	.	A	G	8	7	15	0	1	16	0	0
16	9759336	.	C	T	7	3	10	0	0	10	0	0
16	9759376	.	C	T	7	4	11	0	0	11	0	0
16	9759464	.	C	G	8	6	14	0	1	15	0	0
16	9759554	.	G	A	2	3	5	0	9	14	0	0
16	9759605	.	A	T	5	3	8	0	0	8	0	0
16	9760006	.	C	T	6	9	15	0	1	16	0	0
16	9760564	.	C	T	1	8	9	0	0	9	0	0
16	9760597	.	A	G	3	0	3	0	6	9	0	0
16	9760718	.	T	C	1	4	5	0	0	5	0	0
16	9760839	.	A	T	4	4	8	0	0	8	0	0
16	9761004	.	A	G	7	6	13	0	2	15	0	0
16	9761141	.	G	A	0	8	8	0	9	17	0	0
16	9761246	.	A	G	11	0	11	0	8	19	0	0
16	9761339	.	A	C	7	6	13	0	1	14	0	0
16	9766586	.	A	C	6	10	16	0	0	16	0	0
16	9769846	.	C	T	12	8	20	0	3	23	0	0
16	9777613	.	A	G	14	11	25	0	0	25	0	0
16	9781031	.	T	C	23	15	38	0	1	39	0	0
16	9785860	.	G	A	21	23	44	0	0	44	0	0
16	9785868	.	T	G	21	25	46	0	1	47	0	0
16	9785990	.	G	A	16	7	23	0	0	23	0	0
16	9787620	.	G	A	5	4	9	0	0	9	0	0
16	9787642	.	C	A	6	5	11	0	0	11	0	0
16	9788005	.	C	T	25	23	48	0	1	49	0	0
16	9788019	.	T	A	24	22	46	0	3	49	0	0
16	9788110	.	C	T	9	7	16	0	0	16	0	0
16	9788194	.	A	C	3	2	5	0	0	5	0	0
16	9788486	.	G	A	10	5	15	0	2	17	0	0
16	9789007	.	A	T	12	10	22	2	4	28	0	0
16	9789317	.	T	C	9	16	25	0	1	26	0	0
16	9789984	.	T	C	11	13	24	0	1	25	0	0
16	9797177	.	A	G	4	4	8	0	0	8	0	0
16	9801943	.	A	G	2	4	6	0	0	6	0	0
16	9801970	.	C	G	0	4	4	0	2	6	0	0
16	9807425	.	C	A	3	6	9	0	0	9	0	0
16	9811675	.	G	A	1	8	9	0	0	9	0	0
16	9813388	.	G	A	1	6	7	0	0	7	0	0
16	9813415	.	C	T	1	3	4	0	0	4	0	0
16	9833887	.	T	A	26	23	49	1	3	53	0	0
16	9833889	.	C	A	29	23	52	1	0	53	0	0
16	9833936	.	A	G	26	23	49	0	2	51	0	0
16	9833974	.	G	A	26	25	51	0	2	53	0	0
16	9834135	.	A	C	21	23	44	0	4	48	0	0
16	9835250	.	C	G	24	23	47	0	0	47	0	0
16	9847182	.	T	C	30	12	42	0	0	42	0	0
16	9868953	.	C	T	28	20	48	0	1	49	0	0
16	9980299	.	A	T	11	13	24	1	3	28	0	0
16	10031572	.	C	A	1	4	5	0	0	5	0	0
16	10031590	.	G	A	1	3	4	0	0	4	0	0
16	10045361	.	T	C	1	0	1	0	4	5	0	0
16	10055557	.	C	T	0	3	3	0	1	4	0	0
16	10055799	.	A	T	1	3	4	0	0	4	0	0
16	10055838	.	C	T	1	3	4	0	0	4	0	0
16	10056127	.	T	G	8	8	16	0	0	16	0	0
16	10098423	.	A	T	1	2	3	0	0	3	0	0
16	10098447	.	A	G	2	2	4	0	0	4	0	0
16	10199573	.	C	A	4	6	10	0	0	10	0	0
16	10199957	.	A	G	1	2	3	0	1	4	0	0
16	10207205	.	G	A	2	3	5	0	0	5	0	0
16	10210208	.	C	T	1	2	3	0	0	3	0	0
16	10210996	.	T	G	1	2	3	0	0	3	0	0
16	10213523	.	A	T	2	2	4	0	0	4	0	0
16	10213529	.	A	G	2	2	4	0	0	4	0	0
16	10245193	.	T	C	1	2	3	0	0	3	0	0
16	10271336	.	G	T	1	2	3	0	1	4	0	0
16	10275694	.	C	T	1	3	4	0	0	4	0	0
16	10284582	.	A	T	3	5	8	0	0	8	0	0
16	10284593	.	T	A	2	3	5	0	0	5	0	0
16	10287677	.	T	G	4	4	8	0	1	9	0	0
16	10287699	.	A	G	5	4	9	0	0	9	0	0
16	10288311	.	G	C	6	8	14	0	1	15	0	0
16	10288746	.	T	A	1	10	11	0	0	11	0	0
16	10288754	.	G	A	1	7	8	0	1	9	0	0
16	10288859	.	A	T	1	11	12	0	0	12	0	0
16	10288882	.	T	A	1	12	13	0	0	13	0	0
16	10288951	.	G	A	7	4	11	0	0	11	0	0
16	10292715	.	C	T	5	4	9	0	1	10	0	0
16	10292716	.	T	C	5	0	5	0	5	10	0	0
16	10292782	.	A	G	3	3	6	0	0	6	0	0
16	10300046	.	C	T	5	4	9	0	1	10	0	0
16	10300493	.	A	G	5	6	11	0	0	11	0	0
16	10303374	.	A	G	4	2	6	0	0	6	0	0
16	10304255	.	A	G	2	2	4	0	0	4	0	0
16	10325723	.	G	A	1	11	12	0	14	26	0	0
16	10325732	.	T	C	11	12	23	0	2	25	0	0
16	10325870	.	C	T	14	15	29	0	2	31	0	0
16	10325960	.	G	A	3	11	14	0	18	32	0	0
16	10326305	.	G	A	4	20	24	0	20	44	0	0
16	10326704	.	C	T	31	27	58	0	3	61	0	0
16	10326737	.	A	G	29	27	56	0	0	56	0	0
16	10326990	.	G	A	4	23	27	1	13	41	0	0
16	10326993	.	A	T	25	14	39	1	1	41	0	0
16	10327128	.	C	T	20	10	30	0	1	31	0	0
16	10327530	.	C	A	12	14	26	0	1	27	0	0
16	10337858	.	T	C	3	2	5	0	0	5	0	0
16	10337988	.	C	T	2	3	5	0	0	5	0	0
16	10338134	.	A	G	4	4	8	0	0	8	0	0
16	10338166	.	A	C	3	4	7	0	0	7	0	0
16	10338171	.	G	A	3	4	7	0	0	7	0	0
16	10338255	.	C	G	4	3	7	0	0	7	0	0
16	10338384	.	G	A	1	2	3	0	1	4	0	0
16	10338593	.	A	G	6	5	11	0	1	12	0	0
16	10339196	.	A	G	1	0	1	0	4	5	0	0
16	10339436	.	T	C	5	2	7	0	0	7	0	0
16	10339682	.	G	A	4	2	6	0	0	6	0	0
16	10339709	.	A	C	2	2	4	0	0	4	0	0
16	10339872	.	G	T	5	4	9	0	0	9	0	0
16	10340008	.	C	G	7	3	10	0	0	10	0	0
16	10340050	.	A	T	2	4	6	0	0	6	0	0
16	10340060	.	A	T	2	4	6	0	0	6	0	0
16	10340349	.	G	A	3	5	8	0	0	8	0	0
16	10340399	.	A	T	2	4	6	0	0	6	0	0
16	10340840	.	G	A	6	5	11	0	2	13	0	0
16	10340935	.	G	C	8	5	13	0	0	13	0	0
16	10340941	.	T	C	5	6	11	0	0	11	0	0
16	10341355	.	G	A	4	2	6	0	1	7	0	0
16	10341377	.	A	T	7	3	10	0	0	10	0	0
16	10341470	.	G	A	2	5	7	0	0	7	0	0
16	10341508	.	A	G	3	5	8	0	0	8	0	0
16	10341548	.	G	A	1	6	7	0	0	7	0	0
16	10341778	.	C	A	9	6	15	0	0	15	0	0
16	10341816	.	A	C	3	8	11	0	0	11	0	0
16	10341881	.	A	G	5	3	8	0	0	8	0	0
16	10342275	.	C	T	9	6	15	0	0	15	0	0
16	10345223	.	T	C	6	8	14	0	0	14	0	0
16	10345720	.	A	G	5	8	13	0	1	14	0	0
16	10346378	.	A	T	4	10	14	0	0	14	0	0
16	10360911	.	T	C	3	2	5	0	0	5	0	0
16	10360935	.	T	C	1	3	4	0	0	4	0	0
16	10367171	.	G	A	10	7	17	0	4	21	0	0
16	10367475	.	C	A	13	20	33	0	2	35	0	0
16	10367499	.	C	T	20	11	31	0	1	32	0	0
16	10367674	.	C	T	15	14	29	0	0	29	0	0
16	10413724	.	A	C	3	5	8	0	4	12	0	0
16	10413726	.	G	T	5	5	10	0	1	11	0	0
16	10413777	.	T	A	3	2	5	0	2	7	0	0
16	10413815	.	C	A	10	6	16	0	0	16	0	0
16	10413957	.	T	C	9	8	17	0	1	18	0	0
16	10417124	.	G	C	13	17	30	0	1	31	0	0
16	10426247	.	T	A	3	2	5	0	0	5	0	0
16	10426378	.	C	T	2	4	6	0	0	6	0	0
16	10426612	.	T	A	4	2	6	0	0	6	0	0
16	10426975	.	A	T	2	5	7	0	0	7	0	0
16	10427576	.	G	A	0	7	7	0	1	8	0	0
16	10427590	.	G	C	4	4	8	0	0	8	0	0
16	10427722	.	A	T	3	4	7	0	0	7	0	0
16	10427746	.	T	G	4	4	8	0	0	8	0	0
16	10431931	.	G	A	1	6	7	0	4	11	0	0
16	10431964	.	G	A	1	3	4	0	6	10	0	0
16	10432015	.	C	A	3	4	7	0	0	7	0	0
16	10434856	.	G	T	3	6	9	0	1	10	0	0
16	10439032	.	A	C	4	6	10	0	0	10	0	0
16	10444033	.	C	A	5	7	12	0	0	12	0	0
16	10445228	.	C	T	2	7	9	0	0	9	0	0
16	10447477	.	T	C	1	4	5	0	0	5	0	0
16	10447923	.	C	A	6	5	11	0	0	11	0	0
16	10447983	.	C	T	4	4	8	0	1	9	0	0
16	10448008	.	G	C	8	3	11	0	1	12	0	0
16	10458749	.	A	G	2	4	6	0	0	6	0	0
16	10459006	.	C	A	6	4	10	0	0	10	0	0
16	10464534	.	A	C	4	6	10	0	2	12	0	0
16	10464570	.	T	C	8	4	12	0	0	12	0	0
16	10464571	.	C	T	5	7	12	0	0	12	0	0
16	10464609	.	A	G	7	5	12	0	1	13	0	0
16	10468283	.	T	C	6	5	11	0	0	11	0	0
16	10472192	.	T	C	10	8	18	0	0	18	0	0
16	10475006	.	C	T	15	8	23	0	0	23	0	0
16	10475645	.	C	T	11	6	17	0	0	17	0	0
16	10477905	.	A	G	12	14	26	0	1	27	0	0
16	10478061	.	G	T	11	18	29	0	0	29	0	0
16	10481425	.	C	T	25	17	42	0	1	43	0	0
16	10485445	.	G	A	20	14	34	0	1	35	0	0
16	10502065	.	A	G	11	10	21	0	2	23	0	0
16	10502069	.	A	G	14	10	24	0	1	25	0	0
16	10502169	.	G	A	14	10	24	0	1	25	0	0
16	10557948	.	C	T	3	3	6	0	1	7	0	0
16	10617196	.	C	T	3	3	6	0	0	6	0	0
16	10620018	.	G	A	1	5	6	0	6	12	0	0
16	10620129	.	T	C	5	5	10	0	0	10	0	0
16	10620183	.	T	C	9	6	15	0	0	15	0	0
16	10633215	.	A	G	8	5	13	0	0	13	0	0
16	10633287	.	C	A	10	8	18	0	0	18	0	0
16	10634013	.	A	G	14	0	14	0	13	27	0	0
16	10634027	.	A	G	5	0	5	0	17	22	0	0
16	10634460	.	T	C	6	2	8	0	0	8	0	0
16	10634510	.	C	T	5	4	9	0	1	10	0	0
16	10635148	.	G	A	3	8	11	0	1	12	0	0
16	10635927	.	A	G	4	4	8	0	2	10	0	0
16	10636168	.	C	T	7	9	16	0	0	16	0	0
16	10636534	.	A	G	5	17	22	0	3	25	0	0
16	10636621	.	A	G	4	11	15	0	1	16	0	0
16	10636947	.	T	G	7	0	7	0	7	14	0	0
16	10637050	.	C	T	9	11	20	0	1	21	0	0
16	10637259	.	A	G	13	10	23	0	2	25	0	0
16	10637510	.	T	C	11	10	21	0	1	22	0	0
16	10637629	.	T	C	1	4	5	0	1	6	0	0
16	10637701	.	T	A	1	4	5	0	0	5	0	0
16	10637705	.	A	C	2	4	6	0	0	6	0	0
16	10724517	.	C	T	5	4	9	0	0	9	0	0
16	10724845	.	G	C	2	6	8	0	0	8	0	0
16	10724876	.	G	A	1	4	5	0	0	5	0	0
16	10724883	.	A	G	1	4	5	0	0	5	0	0
16	10724941	.	T	C	1	2	3	0	0	3	0	0
16	10724995	.	C	G	5	1	6	0	6	12	0	0
16	10731333	.	C	T	9	6	15	0	1	16	0	0
16	10731388	.	G	C	8	5	13	0	1	14	0	0
16	10731717	.	C	G	2	5	7	0	0	7	0	0
16	10731819	.	T	G	4	2	6	0	0	6	0	0
16	10732162	.	T	C	2	3	5	0	0	5	0	0
16	10732174	.	C	A	2	4	6	0	0	6	0	0
16	10732197	.	T	A	2	4	6	0	0	6	0	0
16	10732407	.	G	A	0	2	2	0	4	6	0	0
16	10732429	.	A	T	3	3	6	0	0	6	0	0
16	10732450	.	C	T	2	2	4	0	1	5	0	0
16	10733662	.	A	G	3	3	6	0	0	6	0	0
16	10733751	.	A	G	3	4	7	0	1	8	0	0
16	10733829	.	G	C	4	2	6	0	0	6	0	0
16	10734190	.	T	C	7	5	12	0	1	13	0	0
16	10776922	.	A	C	9	15	24	0	0	24	0	0
16	10777025	.	G	A	3	4	7	0	0	7	0	0
16	10795620	.	G	A	16	19	35	0	0	35	0	0
16	10795647	.	T	C	18	17	35	0	2	37	0	0
16	10798995	.	A	T	11	19	30	0	3	33	0	0
16	10801121	.	G	A	19	17	36	0	1	37	0	0
16	10801374	.	T	C	11	28	39	0	0	39	0	0
16	10801422	.	G	A	18	17	35	0	1	36	0	0
16	10801682	.	C	T	18	16	34	0	0	34	0	0
16	10801772	.	C	T	20	13	33	1	1	35	0	0
16	10804843	.	T	C	31	22	53	0	1	54	0	0
16	10804862	.	A	T	29	26	55	0	2	57	0	0
16	10804878	.	C	T	29	27	56	0	1	57	0	0
16	10806318	.	C	T	22	22	44	1	2	47	0	0
16	10807471	.	A	G	26	20	46	0	5	51	0	0
16	10813138	.	A	C	30	24	54	0	3	57	0	0
16	10815877	.	T	C	27	37	64	0	1	65	0	0
16	10815907	.	A	G	46	0	46	0	24	70	0	0
16	10820667	.	T	C	31	31	62	0	3	65	0	0
16	10828887	.	T	C	8	5	13	0	1	14	0	0
16	10829019	.	T	C	7	18	25	0	2	27	0	0
16	10829139	.	A	G	9	9	18	0	0	18	0	0
16	10829872	.	G	C	7	17	24	0	1	25	0	0
16	10830309	.	T	A	9	6	15	0	3	18	0	0
16	10830431	.	G	A	7	21	28	0	1	29	0	0
16	10832217	.	C	T	6	5	11	0	2	13	0	0
16	10833987	.	G	A	11	5	16	0	2	18	0	0
16	10833993	.	C	T	2	12	14	0	6	20	0	0
16	10834715	.	A	C	5	20	25	0	1	26	0	0
16	10841177	.	A	G	8	12	20	0	0	20	0	0
16	10843402	.	A	G	14	0	14	0	8	22	0	0
16	10856130	.	A	G	10	11	21	0	1	22	0	0
16	10859434	.	C	T	26	19	45	0	2	47	0	0
16	10859435	.	T	C	23	19	42	0	5	47	0	0
16	10862159	.	T	A	11	19	30	0	0	30	0	0
16	10862162	.	T	A	9	20	29	0	1	30	0	0
16	10862279	.	A	G	12	11	23	0	1	24	0	0
16	10862280	.	G	T	11	12	23	0	0	23	0	0
16	10862331	.	C	G	12	6	18	0	2	20	0	0
16	10862773	.	T	C	21	14	35	0	3	38	0	0
16	10918985	.	A	G	5	2	7	0	0	7	0	0
16	10919019	.	G	A	3	2	5	0	0	5	0	0
16	10919290	.	C	T	1	7	8	0	2	10	0	0
16	10919317	.	C	T	0	4	4	0	5	9	0	0
16	10919482	.	C	A	2	2	4	0	2	6	0	0
16	10979967	.	C	G	2	0	2	0	4	6	0	0
16	10987838	.	G	C	3	3	6	0	0	6	0	0
16	10989815	.	C	T	2	3	5	0	0	5	0	0
16	10990177	.	G	A	2	5	7	0	4	11	0	0
16	10990490	.	G	A	4	3	7	0	1	8	0	0
16	10990633	.	A	G	1	2	3	0	0	3	0	0
16	11140431	.	A	G	16	4	20	0	0	20	0	0
16	11140435	.	A	G	15	5	20	0	0	20	0	0
16	11140994	.	A	G	1	2	3	0	0	3	0	0
16	11965673	.	G	T	23	15	38	0	1	39	0	0
16	11965803	.	G	T	27	20	47	0	0	47	0	0
16	11965931	.	T	C	17	0	17	0	26	43	0	0
16	11970239	.	C	T	13	12	25	0	1	26	0	0
16	11974658	.	G	A	16	9	25	0	0	25	0	0
16	11974703	.	G	A	11	11	22	0	1	23	0	0
16	11974720	.	G	T	11	10	21	0	0	21	0	0
16	11978045	.	G	A	22	13	35	0	1	36	0	0
16	11980484	.	C	T	0	12	12	0	19	31	0	0
16	11982471	.	G	A	12	11	23	0	1	24	0	0
16	11982519	.	G	T	13	7	20	0	0	20	0	0
16	11985606	.	C	T	13	9	22	0	1	23	0	0
16	12064771	.	T	A	6	6	12	0	1	13	0	0
16	12064946	.	C	T	10	6	16	0	0	16	0	0
16	12065025	.	G	A	11	6	17	0	1	18	0	0
16	12065201	.	C	T	15	18	33	0	1	34	0	0
16	12065392	.	G	A	11	12	23	1	1	25	0	0
16	12073577	.	G	A	5	9	14	0	0	14	0	0
16	12078916	.	A	G	14	4	18	0	0	18	0	0
16	12078976	.	C	T	7	5	12	0	0	12	0	0
16	12078982	.	C	T	7	6	13	0	0	13	0	0
16	12092428	.	A	G	1	8	9	0	0	9	0	0
16	12097241	.	T	C	4	8	12	0	0	12	0	0
16	12097325	.	G	A	9	5	14	0	1	15	0	0
16	12097354	.	G	T	10	5	15	0	1	16	0	0
16	12102412	.	A	T	18	19	37	0	1	38	0	0
16	12102671	.	T	C	32	41	73	1	2	76	0	0
16	12102708	.	A	G	41	28	69	0	2	71	0	0
16	12103083	.	T	C	37	3	40	0	28	68	0	0
16	12103331	.	T	A	27	30	57	0	3	60	0	0
16	12103344	.	A	G	32	28	60	0	1	62	1	0
16	12103530	.	G	A	26	32	58	0	3	61	0	0
16	12103540	.	G	A	37	24	61	0	3	64	0	0
16	12103598	.	G	A	28	25	53	0	4	57	0	0
16	12103732	.	C	T	3	13	16	0	29	45	0	0
16	12103749	.	C	T	24	15	39	0	3	42	0	0
16	12103982	.	G	A	22	31	53	0	3	56	0	0
16	12104042	.	C	T	29	25	54	0	1	55	0	0
16	12104043	.	A	T	27	26	53	0	2	55	0	0
16	12104083	.	C	T	26	28	54	2	1	57	0	0
16	12104209	.	A	C	32	15	47	2	2	51	0	0
16	12104281	.	C	T	28	8	36	0	0	36	0	0
16	12104290	.	T	C	26	7	33	0	1	34	0	0
16	12104316	.	T	A	27	18	45	5	1	51	0	0
16	12104601	.	G	A	41	18	59	1	1	61	0	0
16	12104665	.	A	G	36	18	54	3	1	59	1	0
16	12104794	.	C	T	19	13	32	1	2	35	0	0
16	12105206	.	A	G	22	19	41	0	2	43	0	0
16	12105265	.	T	A	36	13	49	0	1	50	0	0
16	12105443	.	A	T	9	6	15	3	0	18	0	0
16	12105796	.	C	T	6	36	42	0	22	64	0	0
16	12114975	.	G	A	27	29	56	0	2	58	0	0
16	12117537	.	G	A	20	19	39	0	2	41	0	0
16	12117645	.	G	A	28	13	41	0	1	42	0	0
16	12117648	.	G	A	27	13	40	0	1	41	0	0
16	12118207	.	G	A	27	20	47	0	2	49	0	0
16	12118210	.	C	T	29	20	49	0	0	49	0	0
16	12135754	.	G	A	21	17	38	0	2	40	0	0
16	12138841	.	G	A	20	17	37	0	0	37	0	0
16	12138940	.	A	G	16	21	37	0	4	41	0	0
16	12143710	.	C	T	10	4	14	0	5	19	0	0
16	12150856	.	C	A	2	11	13	0	13	26	0	0
16	12162370	.	A	C	9	0	9	0	15	25	1	0
16	12173511	.	T	A	13	11	24	0	1	26	1	0
16	12175377	.	T	C	1	4	5	0	0	5	0	0
16	12175483	.	A	G	3	3	6	0	0	6	0	0
16	12175594	.	A	G	7	4	11	0	0	11	0	0
16	12245751	.	T	C	29	30	59	0	4	63	0	0
16	12245954	.	C	T	38	28	66	0	3	69	0	0
16	12254457	.	C	T	35	32	67	0	4	71	0	0
16	12254469	.	T	C	38	31	69	0	1	70	0	0
16	12254592	.	T	C	30	25	55	0	3	58	0	0
16	12254674	.	C	T	22	21	43	0	0	43	0	0
16	12254776	.	A	T	18	27	45	0	1	46	0	0
16	12256585	.	C	T	5	9	14	0	0	14	0	0
16	12256614	.	G	A	14	16	30	0	1	31	0	0
16	12256629	.	A	G	16	18	34	0	2	36	0	0
16	12256681	.	C	A	2	23	25	0	31	56	0	0
16	12256801	.	C	T	28	26	54	0	2	56	0	0
16	12256816	.	G	T	30	16	46	0	3	49	0	0
16	12257154	.	T	C	17	26	43	0	0	43	0	0
16	12257216	.	A	T	22	32	54	0	0	54	0	0
16	12257506	.	G	A	19	18	37	0	3	40	0	0
16	12257904	.	C	T	22	32	54	0	3	57	0	0
16	12257921	.	T	G	22	28	50	0	4	54	0	0
16	12258044	.	C	T	11	11	22	0	3	25	0	0
16	12258128	.	A	T	7	18	25	0	1	26	0	0
16	12258264	.	G	C	15	8	23	1	0	24	0	0
16	12258268	.	C	T	14	9	23	1	0	24	0	0
16	12258302	.	A	T	9	12	21	0	0	21	0	0
16	12258593	.	T	G	6	9	15	0	2	17	0	0
16	12258733	.	A	T	16	12	28	0	0	28	0	0
16	12258999	.	G	C	8	28	36	0	0	36	0	0
16	12259298	.	G	C	28	17	45	0	1	46	0	0
16	12259302	.	A	T	27	17	44	0	2	46	0	0
16	12259589	.	G	A	21	22	43	0	2	45	0	0
16	12259678	.	T	C	18	22	40	0	1	41	0	0
16	12259737	.	A	T	15	18	33	0	4	37	0	0
16	12260002	.	T	G	14	22	36	0	4	40	0	0
16	12260134	.	A	T	17	15	32	0	0	32	0	0
16	12260291	.	G	T	13	19	32	0	1	34	1	0
16	12261211	.	A	G	16	18	34	0	0	34	0	0
16	12261625	.	A	G	12	16	28	0	1	29	0	0
16	12262453	.	T	G	17	12	29	0	0	29	0	0
16	12262762	.	T	A	11	14	25	0	0	25	0	0
16	12263047	.	C	T	3	21	24	0	22	46	0	0
16	12263385	.	G	A	11	14	25	0	2	27	0	0
16	12264912	.	A	T	22	21	43	0	3	46	0	0
16	12264999	.	T	C	22	0	22	0	14	36	0	0
16	12265237	.	A	G	13	20	33	0	2	35	0	0
16	12265917	.	C	G	24	10	34	0	1	35	0	0
16	12266073	.	G	A	12	17	29	0	1	30	0	0
16	12273636	.	G	A	3	23	26	0	26	52	0	0
16	12276030	.	G	A	17	21	38	0	2	40	0	0
16	12276033	.	A	T	17	21	38	0	0	38	0	0
16	12276065	.	A	T	22	14	36	0	1	37	0	0
16	12276102	.	G	A	12	6	18	0	1	19	0	0
16	12286264	.	C	A	7	18	25	0	0	26	1	0
16	12292467	.	G	A	2	34	36	0	13	49	0	0
16	12292599	.	T	C	17	35	52	0	2	54	0	0
16	12292622	.	G	A	20	31	51	0	2	53	0	0
16	12292648	.	T	C	11	30	41	0	3	44	0	0
16	12294316	.	C	A	7	5	12	0	0	12	0	0
16	12340701	.	T	C	7	0	7	0	4	11	0	0
16	12346425	.	G	T	0	2	2	0	1	3	0	0
16	12346516	.	A	C	1	0	1	0	4	5	0	0
16	12347591	.	A	G	5	3	8	0	0	8	0	0
16	12356458	.	G	A	1	2	3	0	0	3	0	0
16	12367016	.	C	G	2	3	5	0	1	6	0	0
16	12475737	.	T	C	2	3	5	0	0	5	0	0
16	12478727	.	G	A	1	4	5	0	0	5	0	0
16	12557392	.	T	C	2	2	4	0	0	4	0	0
16	12560246	.	C	T	1	3	4	0	0	4	0	0
16	12632593	.	G	C	5	6	11	0	0	11	0	0
16	12632664	.	T	C	10	4	14	0	0	14	0	0
16	12636347	.	T	C	6	6	12	0	0	12	0	0
16	12636546	.	T	C	6	6	12	0	1	13	0	0
16	12637160	.	A	T	5	2	7	0	1	8	0	0
16	12637271	.	G	A	1	3	4	0	3	7	0	0
16	12637284	.	T	C	2	3	5	0	0	5	0	0
16	12637498	.	A	G	8	3	11	0	0	11	0	0
16	12637552	.	A	T	4	2	6	0	0	6	0	0
16	12637681	.	T	G	4	10	14	0	1	15	0	0
16	12637779	.	C	T	12	8	20	0	2	22	0	0
16	12637822	.	T	C	7	9	16	0	2	18	0	0
16	12637824	.	G	A	0	10	10	0	8	18	0	0
16	12638502	.	C	T	1	2	3	0	0	3	0	0
16	12638527	.	C	A	1	4	5	0	0	5	0	0
16	12638612	.	C	G	4	3	7	0	1	8	0	0
16	12638622	.	A	G	3	4	7	0	0	7	0	0
16	12639125	.	A	T	8	3	11	0	0	11	0	0
16	12639184	.	C	G	5	7	12	1	0	13	0	0
16	12639285	.	T	A	6	5	11	0	1	12	0	0
16	12639291	.	C	T	5	6	11	0	0	11	0	0
16	12639320	.	C	G	5	4	9	0	1	10	0	0
16	12670085	.	G	A	1	2	3	0	0	3	0	0
16	12730380	.	A	G	10	10	20	0	1	21	0	0
16	12738324	.	G	A	7	8	15	0	2	17	0	0
16	12738351	.	T	C	12	5	17	0	1	18	0	0
16	12740779	.	C	T	18	15	33	0	1	34	0	0
16	12740949	.	C	G	12	15	27	0	0	27	0	0
16	12743927	.	G	A	1	16	17	0	12	29	0	0
16	12744270	.	T	C	3	4	7	0	0	7	0	0
16	12748058	.	A	G	4	1	5	1	21	27	0	0
16	12755992	.	C	T	14	19	33	0	2	35	0	0
16	12756094	.	A	C	11	11	22	0	0	22	0	0
16	12756255	.	C	T	13	10	23	0	0	23	0	0
16	12773123	.	G	T	1	2	3	0	0	3	0	0
16	12773209	.	C	T	2	5	7	0	0	7	0	0
16	12794075	.	C	G	5	4	9	0	0	9	0	0
16	12807038	.	G	A	7	6	13	0	1	14	0	0
16	12807129	.	C	G	2	6	8	0	1	9	0	0
16	12812496	.	T	C	9	4	13	0	1	14	0	0
16	12814102	.	A	T	8	14	22	0	2	25	1	0
16	12816486	.	T	C	10	13	23	0	1	24	0	0
16	12816745	.	A	C	14	6	20	0	1	21	0	0
16	12816975	.	G	A	8	14	22	0	0	22	0	0
16	12818220	.	G	T	17	15	32	0	1	33	0	0
16	12820952	.	C	T	5	14	19	0	3	22	0	0
16	12821091	.	C	A	21	19	40	0	1	42	1	0
16	12821106	.	C	T	24	21	45	0	0	45	0	0
16	12821221	.	G	A	16	24	40	0	0	40	0	0
16	12821300	.	G	C	1	12	13	0	18	31	0	0
16	12821449	.	G	A	14	23	37	1	1	39	0	0
16	12821459	.	A	G	13	23	36	1	2	39	0	0
16	12821611	.	A	G	12	9	21	0	1	22	0	0
16	12821618	.	C	T	12	6	18	0	1	19	0	0
16	12882612	.	C	T	4	18	22	0	28	50	0	0
16	12883126	.	G	A	19	18	37	0	3	40	0	0
16	12883618	.	C	T	12	17	29	0	0	29	0	0
16	12884054	.	A	T	17	12	29	0	1	31	1	0
16	12884510	.	A	T	17	15	32	0	0	32	0	0
16	12884513	.	G	A	14	15	29	0	2	31	0	0
16	12953670	.	C	T	21	13	34	0	0	34	0	0
16	12963064	.	T	C	1	2	3	0	2	5	0	0
16	12963079	.	A	T	1	3	4	0	1	5	0	0
16	12963274	.	A	T	12	10	22	0	1	23	0	0
16	12963368	.	G	A	12	14	26	0	0	26	0	0
16	12963384	.	C	T	1	12	13	0	14	27	0	0
16	12963975	.	A	G	19	22	41	0	1	42	0	0
16	12967855	.	G	A	17	10	27	0	0	27	0	0
16	12981637	.	G	A	18	10	28	0	0	28	0	0
16	12984488	.	C	G	10	11	21	0	2	23	0	0
16	13023601	.	A	G	4	3	7	0	0	7	0	0
16	13038004	.	T	C	6	1	7	0	4	11	0	0
16	13049162	.	A	G	4	2	6	0	1	7	0	0
16	13072076	.	G	A	1	4	5	0	0	5	0	0
16	13179335	.	G	A	4	7	11	0	0	11	0	0
16	13180298	.	T	C	2	4	6	0	1	7	0	0
16	13180389	.	T	C	4	5	9	0	1	10	0	0
16	13181465	.	T	C	6	10	16	0	1	17	0	0
16	13242669	.	T	G	2	3	5	0	0	5	0	0
16	13568841	.	A	G	2	3	5	0	0	5	0	0
16	13568844	.	A	T	2	3	5	0	0	5	0	0
16	13569831	.	C	T	2	1	3	0	1	4	0	0
16	13600680	.	A	C	11	16	27	0	1	28	0	0
16	13601013	.	A	G	16	12	28	0	1	29	0	0
16	13601026	.	T	C	15	10	25	0	1	26	0	0
16	13601228	.	A	T	8	15	23	0	2	25	0	0
16	13601286	.	G	T	6	6	12	0	1	13	0	0
16	13601328	.	C	T	4	2	6	0	0	6	0	0
16	13601964	.	T	C	16	0	16	0	16	32	0	0
16	13602164	.	T	C	12	18	30	0	1	31	0	0
16	13602454	.	T	A	13	8	21	0	0	21	0	0
16	13602488	.	T	C	6	8	14	0	1	15	0	0
16	13602800	.	T	A	6	15	21	0	1	22	0	0
16	13602922	.	A	G	14	6	20	0	0	20	0	0
16	13603007	.	T	G	12	20	32	0	7	39	0	0
16	13606896	.	A	T	12	7	19	0	0	19	0	0
16	13610651	.	A	T	18	19	37	0	1	38	0	0
16	13610966	.	A	G	15	23	38	0	0	38	0	0
16	13611035	.	G	A	12	15	27	0	1	28	0	0
16	13612999	.	T	A	12	9	21	0	0	21	0	0
16	13613104	.	T	C	9	5	14	0	1	15	0	0
16	13613148	.	C	T	6	4	10	0	1	11	0	0
16	13613208	.	A	T	8	7	15	0	3	18	0	0
16	13613210	.	C	A	9	8	17	0	1	18	0	0
16	13616698	.	A	T	9	16	25	0	2	27	0	0
16	13616862	.	G	C	14	9	23	0	0	23	0	0
16	13617152	.	C	T	6	15	21	0	0	21	0	0
16	13617291	.	G	A	10	5	15	0	1	16	0	0
16	13618172	.	C	G	11	9	20	1	1	22	0	0
16	13618374	.	A	T	17	11	28	0	1	29	0	0
16	13618662	.	T	A	12	11	23	0	0	23	0	0
16	13620832	.	T	C	3	6	9	0	1	10	0	0
16	13621056	.	G	A	3	6	9	0	0	9	0	0
16	13622769	.	T	A	5	8	13	0	1	14	0	0
16	13622770	.	G	T	6	7	13	0	1	14	0	0
16	13623642	.	T	A	9	3	12	0	1	13	0	0
16	13643504	.	C	T	0	22	22	0	18	41	1	0
16	13643974	.	C	T	4	13	17	0	14	31	0	0
16	13644781	.	T	A	6	15	21	0	0	21	0	0
16	13645495	.	C	T	10	8	18	0	0	18	0	0
16	13673660	.	T	A	3	5	8	0	0	8	0	0
16	13673734	.	A	C	8	6	14	0	1	15	0	0
16	13674176	.	T	G	10	10	20	0	1	21	0	0
16	13679037	.	A	G	4	5	9	0	0	9	0	0
16	13680487	.	T	G	4	3	7	0	1	8	0	0
16	13685800	.	G	A	14	9	23	0	0	23	0	0
16	13701482	.	C	T	11	18	29	0	1	30	0	0
16	13701599	.	A	G	6	5	11	0	2	13	0	0
16	13706207	.	G	C	6	12	18	0	0	18	0	0
16	13721408	.	C	T	7	13	20	0	1	21	0	0
16	13729810	.	C	T	14	6	20	0	2	22	0	0
16	13741610	.	G	A	9	11	20	0	1	21	0	0
16	13743390	.	G	A	17	15	32	0	1	33	0	0
16	13780375	.	G	A	10	16	26	0	0	26	0	0
16	13789765	.	G	A	6	12	18	0	2	20	0	0
16	13810372	.	G	A	2	3	5	0	0	5	0	0
16	13810417	.	G	A	1	2	3	0	0	3	0	0
16	13810985	.	G	A	1	2	3	0	0	3	0	0
16	13811007	.	T	C	1	2	3	0	0	3	0	0
16	13818640	.	T	A	6	4	10	0	1	11	0	0
16	13818644	.	G	A	7	6	13	0	0	13	0	0
16	13826195	.	C	T	12	10	22	0	0	22	0	0
16	13833484	.	T	A	4	2	6	0	0	6	0	0
16	13841360	.	T	A	13	7	20	0	1	21	0	0
16	13845350	.	G	A	14	19	33	0	0	33	0	0
16	13845368	.	G	A	0	11	11	0	19	30	0	0
16	13845571	.	T	A	5	8	13	0	2	15	0	0
16	13855121	.	C	T	7	10	17	0	0	17	0	0
16	13855142	.	T	C	13	8	21	0	2	23	0	0
16	13855179	.	A	G	16	1	17	0	16	33	0	0
16	13855482	.	T	A	11	16	27	0	1	28	0	0
16	13856554	.	T	C	2	2	4	0	0	4	0	0
16	13858356	.	C	A	19	18	37	0	1	38	0	0
16	13858436	.	C	A	10	17	27	0	2	29	0	0
16	13858570	.	C	T	14	19	33	0	0	33	0	0
16	13858673	.	T	C	12	18	30	0	1	31	0	0
16	13858866	.	T	A	22	6	28	1	2	31	0	0
16	13860459	.	G	A	0	3	3	0	8	11	0	0
16	13866763	.	G	A	4	2	6	0	0	6	0	0
16	13870827	.	C	T	2	3	5	0	0	5	0	0
16	13883968	.	C	A	6	7	13	0	0	13	0	0
16	13883980	.	A	C	8	6	14	0	2	16	0	0
16	14010693	.	G	T	12	4	16	0	0	16	0	0
16	14010794	.	C	T	4	4	8	0	0	8	0	0
16	14021817	.	G	T	11	10	21	0	0	21	0	0
16	14022252	.	G	A	3	7	10	0	9	19	0	0
16	14022520	.	G	A	5	6	11	0	1	12	0	0
16	14022842	.	A	G	3	4	7	0	0	7	0	0
16	14029329	.	A	T	14	9	23	0	0	23	0	0
16	14029424	.	A	C	9	9	18	0	0	18	0	0
16	14029437	.	T	C	12	10	22	0	0	22	0	0
16	14055048	.	G	C	9	12	21	0	1	22	0	0
16	14055284	.	A	T	8	10	18	0	2	20	0	0
16	14095097	.	C	T	1	9	10	0	6	17	1	0
16	14115928	.	G	T	14	14	28	0	2	30	0	0
16	14115931	.	G	A	12	12	24	0	4	28	0	0
16	14133851	.	G	A	7	8	15	0	0	15	0	0
16	14133907	.	C	T	5	6	11	0	0	11	0	0
16	14154226	.	C	T	6	7	13	0	0	13	0	0
16	14154240	.	T	A	10	6	16	0	0	16	0	0
16	14154708	.	G	A	10	8	18	0	1	19	0	0
16	14154798	.	C	T	1	8	9	0	12	21	0	0
16	14154870	.	A	G	9	12	21	0	3	24	0	0
16	14154944	.	C	T	7	7	14	0	0	14	0	0
16	14155038	.	G	A	6	8	14	0	0	14	0	0
16	14155169	.	C	T	8	8	16	0	0	16	0	0
16	14155563	.	T	C	10	6	16	0	5	21	0	0
16	14155684	.	G	A	6	10	16	0	0	16	0	0
16	14155686	.	C	T	6	9	15	0	0	16	1	0
16	14156157	.	T	C	8	8	16	0	0	16	0	0
16	14156646	.	G	A	4	7	11	0	0	11	0	0
16	14156695	.	C	T	0	6	6	0	7	13	0	0
16	14156865	.	A	G	1	4	5	0	0	5	0	0
16	14156881	.	G	A	5	2	7	0	0	7	0	0
16	14157055	.	C	T	2	5	7	0	0	7	0	0
16	14157112	.	C	T	3	5	8	0	0	8	0	0
16	14157371	.	G	A	11	7	18	0	2	20	0	0
16	14157508	.	G	A	4	4	8	0	0	8	0	0
16	14158417	.	G	A	2	4	6	0	2	8	0	0
16	14202197	.	T	A	16	9	25	0	1	26	0	0
16	14206289	.	G	A	8	5	13	0	0	13	0	0
16	14209195	.	G	A	11	16	27	0	0	27	0	0
16	14209348	.	T	C	12	11	23	0	0	23	0	0
16	14210949	.	A	C	10	15	25	0	1	26	0	0
16	14212079	.	G	C	1	11	12	0	6	18	0	0
16	14214534	.	G	A	8	4	12	0	0	12	0	0
16	14214543	.	A	G	9	5	14	0	0	14	0	0
16	14215451	.	G	A	3	2	5	0	0	5	0	0
16	14215475	.	T	C	4	2	6	0	0	6	0	0
16	14220363	.	C	T	2	2	4	0	0	4	0	0
16	14220429	.	T	C	1	4	5	0	0	5	0	0
16	14223186	.	A	C	4	5	9	0	0	9	0	0
16	14227913	.	C	T	3	7	10	0	1	11	0	0
16	14228033	.	A	G	4	1	5	0	1	6	0	0
16	14228668	.	A	G	6	10	16	0	0	16	0	0
16	14228677	.	C	T	11	7	18	0	0	18	0	0
16	14228743	.	C	T	5	5	10	0	0	10	0	0
16	14228902	.	C	T	2	3	5	0	0	5	0	0
16	14228979	.	A	G	2	3	5	0	1	6	0	0
16	14229539	.	C	T	5	3	8	0	0	8	0	0
16	14229585	.	G	A	0	3	3	0	7	10	0	0
16	14229614	.	A	G	4	2	6	0	1	7	0	0
16	14229857	.	G	T	3	4	7	0	0	7	0	0
16	14229946	.	T	C	5	6	11	0	0	11	0	0
16	14229947	.	A	T	4	6	10	0	1	11	0	0
16	14230143	.	A	G	5	0	5	0	11	16	0	0
16	14230222	.	A	G	11	3	14	0	0	14	0	0
16	14230570	.	C	T	3	3	6	0	0	6	0	0
16	14230693	.	G	A	6	4	10	0	0	10	0	0
16	14230719	.	A	T	8	4	12	0	0	12	0	0
16	14231038	.	A	G	12	8	20	0	2	22	0	0
16	14231063	.	G	A	1	9	10	0	13	23	0	0
16	14231079	.	G	A	0	8	8	0	13	21	0	0
16	14231207	.	T	A	9	7	16	0	0	16	0	0
16	14231250	.	T	A	1	5	6	0	1	7	0	0
16	14231941	.	A	G	11	9	20	0	2	22	0	0
16	14231952	.	A	T	13	9	22	0	1	23	0	0
16	14232005	.	G	A	19	13	32	0	3	35	0	0
16	14266152	.	G	A	1	3	4	0	0	4	0	0
16	14266647	.	A	T	5	2	7	0	0	7	0	0
16	14277577	.	G	A	4	2	6	0	0	6	0	0
16	14281006	.	T	C	1	3	4	0	0	4	0	0
16	14416520	.	C	T	3	3	6	0	0	6	0	0
16	14416599	.	C	T	3	7	10	0	1	11	0	0
16	14416876	.	T	G	6	4	10	0	1	11	0	0
16	14588209	.	G	A	8	6	14	0	1	16	1	0
16	14588430	.	A	G	4	5	9	0	0	9	0	0
16	14597927	.	A	C	4	3	7	0	0	7	0	0
16	14627294	.	G	A	6	7	13	0	2	15	0	0
16	14638413	.	G	A	6	5	11	1	0	12	0	0
16	14638476	.	C	T	9	5	14	0	0	14	0	0
16	14664767	.	T	A	4	12	16	0	0	16	0	0
16	14670907	.	G	T	6	1	7	0	1	8	0	0
16	14670994	.	T	A	1	2	3	0	0	3	0	0
16	14671097	.	A	T	6	8	14	0	1	15	0	0
16	14671099	.	A	T	8	7	15	0	0	15	0	0
16	14671135	.	A	G	5	6	11	0	0	11	0	0
16	14675175	.	C	T	7	2	9	0	2	11	0	0
16	14675373	.	A	C	9	11	20	0	1	21	0	0
16	14675413	.	G	T	1	9	10	0	4	14	0	0
16	14675487	.	T	A	2	7	9	0	2	11	0	0
16	14675572	.	G	A	9	10	19	0	1	20	0	0
16	14675780	.	A	G	1	6	7	0	0	7	0	0
16	14710495	.	T	A	3	2	5	0	0	5	0	0
16	14865602	.	G	T	4	4	8	0	0	8	0	0
16	14871176	.	T	C	2	2	4	0	1	5	0	0
16	14901812	.	C	T	6	4	10	0	1	11	0	0
16	14908825	.	C	T	4	4	8	0	0	8	0	0
16	14933174	.	G	A	5	3	8	0	0	8	0	0
16	14958952	.	T	C	3	2	5	1	0	6	0	0
16	14973890	.	G	A	0	5	5	0	1	6	0	0
16	14973968	.	A	T	6	3	9	0	1	10	0	0
16	14973989	.	A	T	8	4	12	0	0	12	0	0
16	15019105	.	T	G	9	0	9	0	6	15	0	0
16	15031839	.	C	T	4	3	7	0	1	8	0	0
16	15034797	.	G	A	1	10	11	0	12	23	0	0
16	15037778	.	C	T	12	11	23	0	0	23	0	0
16	15048645	.	G	A	2	5	7	0	0	7	0	0
16	15048659	.	A	G	6	1	7	0	2	9	0	0
16	15048737	.	A	T	6	4	10	0	1	11	0	0
16	15049133	.	A	G	4	7	11	0	0	11	0	0
16	15049278	.	A	T	4	4	8	0	0	8	0	0
16	15050112	.	C	G	7	13	20	0	0	20	0	0
16	15050135	.	C	T	10	7	17	0	0	17	0	0
16	15050277	.	G	A	11	7	18	0	0	18	0	0
16	15050623	.	C	T	7	8	15	0	1	16	0	0
16	15141050	.	C	T	3	3	6	0	0	6	0	0
16	15143512	.	G	A	1	3	4	0	0	4	0	0
16	15165052	.	T	C	2	0	2	0	2	4	0	0
16	15165262	.	G	A	4	3	7	0	2	9	0	0
16	15168740	.	G	A	3	4	7	0	1	8	0	0
16	15184543	.	C	T	1	3	4	0	4	8	0	0
16	15193716	.	G	A	2	2	4	0	0	4	0	0
16	15262870	.	G	A	2	2	4	0	0	4	0	0
16	15944980	.	A	T	5	5	10	0	1	11	0	0
16	16041698	.	A	T	9	7	16	0	3	19	0	0
16	16042240	.	G	A	8	5	13	0	0	13	0	0
16	16043191	.	T	G	14	11	25	0	1	26	0	0
16	16043218	.	A	G	12	11	23	0	1	24	0	0
16	16069884	.	A	G	11	7	18	0	0	18	0	0
16	16103927	.	C	T	5	5	10	0	1	11	0	0
16	16113853	.	G	A	7	5	12	0	0	12	0	0
16	16120849	.	C	T	10	8	18	0	1	19	0	0
16	16165179	.	T	A	25	30	55	0	1	57	1	0
16	16165418	.	C	T	38	33	71	0	1	72	0	0
16	16182195	.	T	C	38	27	65	0	0	65	0	0
16	16210469	.	T	A	6	2	8	0	0	8	0	0
16	16210784	.	T	C	2	5	7	0	0	7	0	0
16	16232902	.	A	T	8	8	16	0	1	17	0	0
16	16232911	.	A	G	7	11	18	0	0	18	0	0
16	16233124	.	T	G	5	5	10	0	0	10	0	0
16	16233250	.	T	G	13	4	17	0	0	17	0	0
16	16233715	.	T	C	7	0	7	0	6	13	0	0
16	16233907	.	A	T	4	10	14	0	1	15	0	0
16	16233937	.	G	T	7	17	24	0	0	24	0	0
16	16233952	.	C	A	0	16	16	0	9	25	0	0
16	16234297	.	C	T	3	5	8	0	0	8	0	0
16	16234516	.	A	C	11	6	17	0	0	17	0	0
16	16234633	.	T	C	7	0	7	0	12	19	0	0
16	16234642	.	C	T	7	10	17	0	1	18	0	0
16	16234747	.	T	A	12	5	17	0	1	18	0	0
16	16234948	.	C	T	0	6	6	0	5	11	0	0
16	16235056	.	G	C	6	8	14	0	1	15	0	0
16	16237745	.	G	C	2	6	8	0	0	8	0	0
16	16266593	.	C	T	6	5	11	0	0	11	0	0
16	16266645	.	A	G	4	3	7	0	2	9	0	0
16	16266653	.	A	T	5	5	10	0	0	10	0	0
16	16266774	.	A	G	4	3	7	0	0	7	0	0
16	16266844	.	C	T	2	3	5	0	0	5	0	0
16	16267073	.	A	G	2	4	6	0	1	7	0	0
16	16267189	.	A	G	2	2	4	0	0	4	0	0
16	16267267	.	G	A	4	3	7	0	0	7	0	0
16	16267355	.	T	C	4	2	6	2	0	8	0	0
16	16267631	.	G	A	1	4	5	0	1	6	0	0
16	16267673	.	C	T	5	5	10	0	0	10	0	0
16	16267814	.	C	G	2	6	8	0	0	8	0	0
16	16267823	.	T	C	3	8	11	0	0	11	0	0
16	16268037	.	A	T	1	8	9	0	0	9	0	0
16	16268205	.	A	T	2	4	6	0	0	6	0	0
16	16268208	.	G	A	0	4	4	0	2	6	0	0
16	16268284	.	C	T	2	3	5	0	0	5	0	0
16	16268590	.	C	T	1	1	2	0	1	3	0	0
16	16268851	.	T	A	1	7	8	0	1	9	0	0
16	16268956	.	G	C	3	4	7	0	1	8	0	0
16	16269118	.	C	T	1	3	4	0	0	4	0	0
16	16269502	.	C	T	2	2	4	0	0	4	0	0
16	16269508	.	C	T	3	2	5	0	0	5	0	0
16	16269593	.	G	C	5	5	10	0	0	10	0	0
16	16269690	.	G	A	0	4	4	0	5	9	0	0
16	16269724	.	G	A	10	3	13	0	0	13	0	0
16	16269926	.	G	C	1	3	4	0	0	4	0	0
16	16269964	.	T	C	1	6	7	0	0	7	0	0
16	16270163	.	C	A	3	8	11	0	0	11	0	0
16	16270326	.	G	A	2	4	6	0	0	6	0	0
16	16270358	.	A	G	3	6	9	0	0	9	0	0
16	16270361	.	T	C	3	5	8	0	1	9	0	0
16	16270424	.	T	C	3	4	7	0	1	8	0	0
16	16270448	.	T	G	5	0	5	0	3	8	0	0
16	16271683	.	G	A	2	5	7	0	1	8	0	0
16	16275288	.	T	C	4	7	11	0	0	11	0	0
16	16276678	.	G	A	4	6	10	0	0	10	0	0
16	16276938	.	T	C	3	4	7	0	1	8	0	0
16	16277689	.	A	G	6	6	12	0	1	13	0	0
16	16277728	.	G	A	4	8	12	0	0	12	0	0
16	16277810	.	G	A	5	4	9	0	0	9	0	0
16	16277954	.	G	A	2	8	10	0	0	10	0	0
16	16278013	.	A	T	8	4	12	0	0	12	0	0
16	16278172	.	G	T	1	9	10	0	9	19	0	0
16	16281479	.	A	C	7	9	16	1	1	18	0	0
16	16281740	.	A	C	2	6	8	0	0	9	1	0
16	16281869	.	T	A	9	10	19	0	2	21	0	0
16	16284057	.	T	C	12	10	22	0	1	23	0	0
16	16284159	.	G	A	0	9	9	0	18	27	0	0
16	16284192	.	C	A	16	10	26	0	0	26	0	0
16	16289121	.	C	T	9	22	31	0	2	33	0	0
16	16297057	.	G	A	12	7	19	0	0	19	0	0
16	16302166	.	T	C	7	9	16	0	0	16	0	0
16	16302244	.	A	G	9	0	9	0	12	21	0	0
16	16302247	.	A	T	10	12	22	0	0	22	0	0
16	16302371	.	A	C	8	7	15	0	1	16	0	0
16	16302426	.	T	A	8	14	22	0	0	22	0	0
16	16302477	.	G	A	0	9	9	0	6	15	0	0
16	16302835	.	T	C	12	6	18	0	1	19	0	0
16	16303025	.	C	T	14	17	31	0	1	32	0	0
16	16303065	.	A	G	14	15	29	0	0	29	0	0
16	16303086	.	T	A	14	11	25	0	1	26	0	0
16	16303163	.	G	A	2	9	11	0	6	17	0	0
16	16303196	.	A	G	12	1	13	0	5	18	0	0
16	16303293	.	T	G	6	4	10	0	3	13	0	0
16	16547388	.	C	T	4	6	10	0	1	11	0	0
16	16553899	.	C	T	4	9	13	0	1	14	0	0
16	16554693	.	A	T	3	4	7	0	0	7	0	0
16	16554695	.	T	C	3	3	6	0	1	7	0	0
16	16555484	.	A	C	9	5	14	0	0	14	0	0
16	16555611	.	A	G	10	11	21	0	0	21	0	0
16	16555628	.	A	T	12	7	19	0	0	19	0	0
16	16555975	.	T	A	7	6	13	0	0	13	0	0
16	16556223	.	C	A	7	10	17	0	1	18	0	0
16	16565998	.	C	T	10	14	24	0	0	24	0	0
16	16569578	.	C	G	9	6	15	0	0	15	0	0
16	16586232	.	C	T	17	6	23	0	4	27	0	0
16	16586290	.	G	A	22	7	29	0	1	30	0	0
16	16589462	.	G	A	4	11	15	0	0	15	0	0
16	16589552	.	G	A	10	4	14	0	0	14	0	0
16	16590439	.	C	T	1	7	8	0	16	24	0	0
16	16597649	.	C	T	0	2	2	0	1	3	0	0
16	16597660	.	T	C	1	2	3	0	1	4	0	0
16	16598043	.	G	A	2	2	4	0	0	4	0	0
16	16598049	.	T	C	2	2	4	0	0	4	0	0
16	16598179	.	G	A	6	3	9	0	0	9	0	0
16	16598232	.	C	T	1	6	7	0	5	12	0	0
16	16598430	.	C	T	0	2	2	0	3	5	0	0
16	16603081	.	C	A	2	3	5	0	0	5	0	0
16	16849326	.	C	T	3	8	11	0	0	11	0	0
16	16849374	.	G	C	2	5	7	0	1	8	0	0
16	16887359	.	C	T	2	4	6	0	0	6	0	0
16	16887371	.	T	C	2	3	5	0	1	6	0	0
16	16898762	.	G	A	2	2	4	0	0	4	0	0
16	16902097	.	G	A	3	2	5	0	0	5	0	0
16	16908229	.	C	T	4	2	6	0	1	7	0	0
16	16908238	.	G	A	3	4	7	0	0	7	0	0
16	16912252	.	T	G	4	2	6	0	0	6	0	0
16	16913096	.	C	T	7	5	12	0	0	12	0	0
16	16913102	.	G	A	5	8	13	0	0	13	0	0
16	16920424	.	C	T	5	6	11	0	0	11	0	0
16	16921088	.	C	T	5	6	11	0	0	11	0	0
16	16921134	.	G	A	6	4	10	0	1	11	0	0
16	16923519	.	A	G	3	2	5	0	0	5	0	0
16	16923663	.	G	A	7	5	12	0	1	13	0	0
16	16924638	.	T	C	11	4	15	0	1	16	0	0
16	16928396	.	T	C	9	8	17	0	1	18	0	0
16	16928424	.	A	G	7	9	16	0	1	17	0	0
16	16928437	.	C	T	4	11	15	0	0	15	0	0
16	16932986	.	C	T	8	8	16	0	3	19	0	0
16	16940592	.	A	T	3	3	6	0	0	6	0	0
16	16940700	.	A	G	6	7	13	0	1	14	0	0
16	16940824	.	A	C	9	11	20	0	0	20	0	0
16	16941019	.	T	C	9	12	21	0	0	21	0	0
16	16941162	.	T	C	14	6	20	0	3	23	0	0
16	16941270	.	G	A	1	9	10	0	10	20	0	0
16	16941343	.	G	A	9	9	18	0	0	18	0	0
16	16941527	.	A	C	8	7	15	0	0	15	0	0
16	16941533	.	G	T	5	7	12	0	2	14	0	0
16	16941741	.	C	T	15	4	19	0	1	20	0	0
16	16941776	.	A	T	6	12	18	0	0	18	0	0
16	16941979	.	C	A	4	5	9	0	0	9	0	0
16	16942001	.	G	A	2	6	8	0	6	14	0	0
16	16942097	.	C	T	6	4	10	0	2	12	0	0
16	16942293	.	T	A	9	8	17	0	0	17	0	0
16	16942906	.	C	G	14	11	25	2	0	27	0	0
16	16943024	.	C	T	8	9	17	0	0	17	0	0
16	16943111	.	A	G	9	11	20	0	1	21	0	0
16	16943348	.	C	A	15	11	26	0	1	27	0	0
16	16943720	.	G	A	9	8	17	0	0	17	0	0
16	16943930	.	G	T	15	11	26	0	3	29	0	0
16	16944259	.	A	T	16	7	23	0	2	25	0	0
16	16944260	.	C	T	16	7	23	0	2	25	0	0
16	16944348	.	G	A	11	11	22	0	1	23	0	0
16	16944941	.	G	T	12	6	18	0	1	19	0	0
16	16945128	.	T	G	6	8	14	0	0	14	0	0
16	16945261	.	A	G	3	4	7	0	0	7	0	0
16	16945585	.	A	C	4	8	12	0	0	12	0	0
16	16985499	.	C	T	27	31	58	1	2	61	0	0
16	16985511	.	A	T	29	35	64	1	2	67	0	0
16	17070845	.	A	G	2	3	5	0	0	5	0	0
16	17120136	.	C	T	14	14	28	0	0	28	0	0
16	17122132	.	C	A	0	8	8	0	4	12	0	0
16	17137034	.	T	A	7	3	10	0	0	10	0	0
16	17161580	.	T	C	12	0	12	0	8	20	0	0
16	17161739	.	G	A	8	7	15	0	1	16	0	0
16	17161877	.	A	G	11	11	22	0	1	23	0	0
16	17162558	.	G	A	8	3	11	0	0	11	0	0
16	17162788	.	A	T	2	4	6	0	0	6	0	0
16	17192957	.	G	A	1	7	8	0	0	8	0	0
16	17193489	.	C	G	3	2	5	0	0	5	0	0
16	17195142	.	A	G	4	2	6	0	0	6	0	0
16	17195160	.	G	A	3	3	6	0	0	6	0	0
16	17195343	.	A	G	5	3	8	0	0	8	0	0
16	17234683	.	G	T	2	4	6	0	0	6	0	0
16	17235251	.	G	A	1	4	5	0	0	5	0	0
16	17235677	.	C	T	1	3	4	0	0	4	0	0
16	17252774	.	G	T	10	5	15	0	0	15	0	0
16	17253023	.	G	A	0	10	10	0	8	18	0	0
16	17253105	.	C	A	9	5	14	0	0	14	0	0
16	17253223	.	A	G	4	10	14	0	0	14	0	0
16	17253293	.	C	T	9	9	18	0	0	18	0	0
16	17253377	.	C	T	6	4	10	0	1	11	0	0
16	17256113	.	C	T	4	3	7	0	0	7	0	0
16	17256243	.	G	C	3	2	5	0	0	5	0	0
16	17302526	.	T	C	6	5	11	0	0	11	0	0
16	17302821	.	A	G	6	10	16	0	1	17	0	0
16	17305481	.	T	C	5	12	17	0	1	18	0	0
16	17305579	.	G	A	11	4	15	0	0	15	0	0
16	17305597	.	C	T	5	7	12	0	1	13	0	0
16	17305620	.	A	G	4	7	11	0	0	11	0	0
16	17311420	.	A	G	2	2	4	0	0	4	0	0
16	17316782	.	G	A	5	6	11	0	1	12	0	0
16	17442933	.	G	A	3	11	14	0	8	22	0	0
16	17465977	.	T	A	14	7	21	0	1	22	0	0
16	17466824	.	A	T	7	11	18	0	0	18	0	0
16	17466839	.	T	G	7	10	17	0	0	17	0	0
16	17549087	.	G	A	3	2	5	0	0	5	0	0
16	17578203	.	A	G	1	2	3	0	0	3	0	0
16	17580036	.	C	T	5	2	7	0	0	7	0	0
16	17585730	.	T	A	5	4	9	0	0	9	0	0
16	17586579	.	T	C	3	0	3	0	3	6	0	0
16	17646269	.	T	C	10	12	22	0	1	23	0	0
16	17798055	.	T	C	3	9	12	0	0	12	0	0
16	17798056	.	C	T	3	8	11	0	1	12	0	0
16	18142759	.	C	T	6	3	9	0	1	10	0	0
16	18142765	.	A	G	7	3	10	0	0	10	0	0
16	18535689	.	G	A	8	8	16	0	2	18	0	0
16	18568933	.	C	T	4	7	11	0	1	12	0	0
16	18696888	.	T	A	3	2	5	0	0	5	0	0
16	18960387	.	G	C	1	1	2	0	1	3	0	0
16	19100141	.	C	T	9	3	12	0	0	12	0	0
16	19100144	.	T	A	5	2	7	0	0	7	0	0
16	19124404	.	T	C	8	4	12	0	1	13	0	0
16	19124452	.	A	G	5	3	8	0	1	9	0	0
16	19126439	.	A	G	3	0	3	0	9	12	0	0
16	19136123	.	A	G	9	6	15	0	0	15	0	0
16	19136328	.	C	T	3	3	6	0	2	8	0	0
16	19141337	.	T	C	1	3	4	0	0	4	0	0
16	19143714	.	G	T	5	7	12	0	1	13	0	0
16	19145102	.	C	T	9	4	13	0	0	13	0	0
16	19150643	.	A	T	7	5	12	0	1	13	0	0
16	19150678	.	C	T	7	6	13	0	0	13	0	0
16	19151174	.	C	A	3	5	8	0	0	8	0	0
16	19151534	.	T	C	3	5	8	0	0	8	0	0
16	19151656	.	G	T	5	10	15	1	0	16	0	0
16	19151699	.	C	T	6	5	11	1	0	12	0	0
16	19182201	.	G	T	0	5	5	0	1	6	0	0
16	19182230	.	G	A	2	3	5	0	0	5	0	0
16	19538923	.	G	A	1	2	3	0	0	3	0	0
16	19538936	.	A	G	0	2	2	0	0	2	0	0
16	19733820	.	T	G	2	2	4	0	0	4	0	0
16	19733832	.	G	A	0	2	2	0	3	5	0	0
16	19840562	.	T	C	14	12	26	0	1	27	0	0
16	19840645	.	T	A	15	13	28	0	1	29	0	0
16	19840658	.	A	C	19	11	30	0	2	32	0	0
16	19840792	.	C	T	13	19	32	0	0	32	0	0
16	19841213	.	G	A	17	10	27	0	1	28	0	0
16	19841215	.	C	T	15	11	26	0	0	26	0	0
16	19841443	.	G	C	6	8	14	0	1	15	0	0
16	19841501	.	T	C	6	9	15	0	1	16	0	0
16	19841502	.	A	T	10	7	17	0	0	17	0	0
16	19841591	.	A	G	10	13	23	0	0	23	0	0
16	19841720	.	A	G	14	8	22	0	1	23	0	0
16	19841786	.	A	T	10	7	17	0	1	18	0	0
16	19841890	.	G	A	9	5	14	0	0	14	0	0
16	19841922	.	G	A	6	6	12	0	2	14	0	0
16	19842493	.	G	A	14	13	27	2	0	29	0	0
16	19842530	.	A	G	13	6	19	1	2	22	0	0
16	19843053	.	G	T	14	23	37	0	1	38	0	0
16	19843056	.	G	T	24	12	36	0	1	37	0	0
16	19850746	.	G	A	15	22	37	0	3	40	0	0
16	19853074	.	G	A	17	18	35	0	2	37	0	0
16	19853098	.	C	T	20	17	37	0	5	42	0	0
16	19853125	.	A	T	19	16	35	0	5	40	0	0
16	19853230	.	A	C	14	10	24	0	1	25	0	0
16	19854886	.	C	T	0	10	10	0	12	22	0	0
16	19861463	.	A	G	7	13	20	0	0	20	0	0
16	19861475	.	G	A	10	8	18	0	1	19	0	0
16	19864588	.	G	T	12	9	21	0	2	23	0	0
16	19878856	.	G	A	8	14	22	0	0	22	0	0
16	20055913	.	G	A	4	2	6	0	0	6	0	0
16	20121122	.	T	C	3	4	7	0	0	7	0	0
16	20126448	.	G	T	0	4	4	0	7	11	0	0
16	20134015	.	A	G	3	3	6	0	0	6	0	0
16	20135013	.	G	C	0	3	3	0	2	5	0	0
16	20140877	.	T	G	2	4	6	0	0	6	0	0
16	20151309	.	C	T	8	9	17	0	1	18	0	0
16	20151397	.	C	T	12	11	23	0	1	24	0	0
16	20151460	.	C	T	7	10	17	0	0	17	0	0
16	20151841	.	T	C	14	6	20	0	1	21	0	0
16	20151991	.	G	A	14	5	19	0	1	20	0	0
16	20152044	.	C	A	9	6	15	0	0	18	3	0
16	20152128	.	G	A	0	10	10	0	2	12	0	0
16	20152474	.	A	G	2	6	8	0	0	8	0	0
16	20152693	.	T	C	1	2	3	0	0	3	0	0
16	20164230	.	A	G	5	3	8	0	0	8	0	0
16	20183444	.	G	A	2	3	5	0	0	5	0	0
16	20187253	.	G	T	2	5	7	0	0	7	0	0
16	20234503	.	G	A	2	3	5	0	0	5	0	0
16	20236803	.	T	C	1	2	3	1	0	4	0	0
16	20237016	.	T	C	1	1	2	0	0	2	0	0
16	20238498	.	C	T	2	2	4	0	0	4	0	0
16	20238911	.	C	T	3	5	8	0	0	8	0	0
16	20265655	.	T	C	0	4	4	0	3	7	0	0
16	20265702	.	G	A	1	4	5	1	1	7	0	0
16	20265928	.	C	T	2	2	4	0	0	4	0	0
16	20266055	.	T	C	1	4	5	0	0	5	0	0
16	20266109	.	T	A	6	4	10	0	0	10	0	0
16	20266321	.	T	C	3	2	5	0	1	6	0	0
16	20266799	.	A	C	7	5	12	0	0	12	0	0
16	20266840	.	T	A	5	7	12	0	0	12	0	0
16	20267347	.	T	C	2	0	2	0	10	12	0	0
16	20267604	.	T	A	2	2	4	0	0	4	0	0
16	20267909	.	A	T	8	7	15	0	0	15	0	0
16	20268143	.	T	A	3	2	5	0	0	5	0	0
16	20268145	.	T	A	3	2	5	0	0	5	0	0
16	20268322	.	A	G	1	3	4	0	0	4	0	0
16	20268328	.	A	T	0	4	4	0	0	4	0	0
16	20268470	.	C	T	4	3	7	0	0	7	0	0
16	20289511	.	T	C	1	4	5	0	0	5	0	0
16	20289537	.	T	C	1	4	5	0	0	5	0	0
16	20291223	.	G	C	3	4	7	0	0	7	0	0
16	20292156	.	T	C	1	4	5	0	0	5	0	0
16	20298802	.	C	T	4	2	6	0	0	6	0	0
16	20318550	.	G	A	7	6	13	0	0	13	0	0
16	20324870	.	C	T	10	7	17	0	1	18	0	0
16	20324891	.	A	G	9	8	17	0	0	17	0	0
16	20328092	.	C	T	0	10	10	0	10	20	0	0
16	20402034	.	A	C	5	0	5	0	7	12	0	0
16	20492447	.	G	T	8	7	15	0	1	16	0	0
16	20497242	.	C	T	1	5	6	0	0	6	0	0
16	20499859	.	G	A	4	4	8	0	0	8	0	0
16	20500142	.	A	G	4	4	8	0	1	9	0	0
16	20512387	.	G	C	2	5	7	0	0	7	0	0
16	20512408	.	A	C	1	5	6	0	0	6	0	0
16	20512661	.	T	C	10	7	17	0	2	19	0	0
16	20513103	.	T	G	10	0	10	0	11	21	0	0
16	20513152	.	A	G	11	4	15	0	3	18	0	0
16	20514738	.	G	A	4	5	9	0	1	10	0	0
16	20540040	.	G	A	2	3	5	0	0	5	0	0
16	20800347	.	C	T	20	5	25	0	1	26	0	0
16	20806487	.	C	T	27	15	42	0	1	43	0	0
16	20813628	.	C	T	4	12	16	0	29	45	0	0
16	20822881	.	T	C	22	14	36	0	1	37	0	0
16	20824508	.	C	G	20	11	31	1	3	35	0	0
16	20824566	.	C	T	25	18	43	0	0	43	0	0
16	20826697	.	T	C	19	23	42	0	2	44	0	0
16	20826703	.	G	A	26	16	42	0	1	43	0	0
16	20836206	.	C	T	21	19	40	0	1	41	0	0
16	20836218	.	G	A	21	18	39	0	3	42	0	0
16	20855582	.	G	A	19	9	28	0	0	28	0	0
16	20855636	.	C	T	16	19	35	0	0	35	0	0
16	20889325	.	C	T	5	7	12	0	0	12	0	0
16	20889432	.	G	A	0	5	5	0	0	5	0	0
16	20889436	.	C	A	1	4	5	0	0	5	0	0
16	21038585	.	A	T	2	5	7	0	2	9	0	0
16	21038697	.	A	C	7	7	14	0	0	14	0	0
16	21038801	.	T	A	7	12	19	0	0	19	0	0
16	21038832	.	T	A	6	12	18	0	0	18	0	0
16	21038924	.	G	A	11	6	17	0	0	17	0	0
16	21039939	.	G	C	10	12	22	0	0	22	0	0
16	21166857	.	C	T	2	2	4	0	0	4	0	0
16	21167011	.	A	G	1	2	3	0	0	3	0	0
16	21180758	.	T	C	2	1	3	0	2	5	0	0
16	21242865	.	T	A	3	2	5	0	1	6	0	0
16	21341328	.	A	G	2	0	2	0	3	5	0	0
16	21417168	.	C	G	5	3	8	0	0	8	0	0
16	21442772	.	A	T	3	4	7	0	1	8	0	0
16	21443326	.	C	A	1	3	4	0	0	4	0	0
16	21444410	.	A	G	1	2	3	0	1	4	0	0
16	21444613	.	C	T	2	2	4	0	1	5	0	0
16	21445456	.	G	T	1	1	2	0	1	3	0	0
16	21445474	.	G	T	1	2	3	0	0	3	0	0
16	21451492	.	G	A	1	3	4	0	0	4	0	0
16	21455946	.	T	C	3	2	5	0	0	5	0	0
16	21456668	.	G	T	1	2	3	0	0	3	0	0
16	21548398	.	T	C	7	4	11	0	0	11	0	0
16	21548456	.	C	T	9	3	12	0	0	12	0	0
16	21548547	.	G	A	13	13	26	0	0	26	0	0
16	21548556	.	G	A	11	10	21	0	2	23	0	0
16	21548776	.	C	T	5	9	14	0	1	15	0	0
16	21548881	.	T	C	9	6	15	0	0	15	0	0
16	21548891	.	A	T	10	5	15	0	0	15	0	0
16	21549022	.	C	T	1	9	10	0	14	24	0	0
16	21549231	.	T	A	6	3	9	0	0	9	0	0
16	21549520	.	C	T	0	7	7	0	14	21	0	0
16	21549539	.	A	C	8	12	20	0	0	20	0	0
16	21549600	.	T	A	7	4	11	0	2	13	0	0
16	21549822	.	T	A	6	5	11	0	0	11	0	0
16	21549924	.	C	T	7	9	16	0	0	16	0	0
16	21549984	.	C	T	0	2	2	0	5	7	0	0
16	21550043	.	G	A	0	6	6	0	1	7	0	0
16	21550058	.	G	C	2	5	7	0	0	7	0	0
16	21550251	.	C	A	11	4	15	0	0	15	0	0
16	21550255	.	T	A	11	4	15	0	0	15	0	0
16	21550318	.	C	T	2	4	6	0	1	7	0	0
16	21551609	.	G	C	3	3	6	0	0	6	0	0
16	21551659	.	T	C	1	2	3	0	0	3	0	0
16	21551743	.	C	T	8	6	14	0	0	14	0	0
16	21551749	.	T	G	6	6	12	0	1	13	0	0
16	21551819	.	T	G	4	4	8	0	0	8	0	0
16	21552026	.	C	T	0	2	2	0	3	5	0	0
16	21552029	.	T	C	3	2	5	0	0	5	0	0
16	21552107	.	G	T	3	2	5	0	0	5	0	0
16	21552405	.	G	A	2	3	5	0	0	5	0	0
16	21552561	.	G	A	1	4	5	0	0	5	0	0
16	21553079	.	C	T	5	2	7	0	0	7	0	0
16	21554846	.	C	T	3	3	6	0	0	6	0	0
16	21576928	.	T	C	3	4	7	0	0	7	0	0
16	21651780	.	T	C	7	0	7	0	10	17	0	0
16	21652059	.	T	A	9	17	26	0	2	28	0	0
16	21655336	.	C	T	7	15	22	0	0	22	0	0
16	21655611	.	G	A	6	15	21	0	1	22	0	0
16	21663023	.	G	A	4	8	12	0	1	13	0	0
16	21665403	.	G	C	5	5	10	0	0	10	0	0
16	21665605	.	G	T	12	7	19	0	0	19	0	0
16	21668067	.	T	C	1	0	1	0	6	7	0	0
16	21673726	.	A	G	4	4	8	0	0	8	0	0
16	21673735	.	G	A	4	4	8	0	0	8	0	0
16	21691065	.	T	G	3	2	5	0	1	6	0	0
16	21691087	.	G	T	3	0	3	0	1	4	0	0
16	21691101	.	T	C	3	2	5	0	1	6	0	0
16	21738666	.	A	T	14	12	26	0	4	30	0	0
16	21739233	.	G	A	17	18	35	0	1	36	0	0
16	21763843	.	G	A	17	10	27	0	2	29	0	0
16	21769044	.	G	A	13	18	31	0	3	34	0	0
16	21777508	.	G	C	10	0	10	0	9	19	0	0
16	21780023	.	G	A	4	3	7	0	0	7	0	0
16	21782076	.	C	A	4	5	9	0	1	10	0	0
16	21892068	.	G	A	3	3	6	0	1	7	0	0
16	21892173	.	G	A	4	7	11	0	0	11	0	0
16	21892304	.	T	C	19	1	20	0	8	28	0	0
16	21892312	.	C	A	20	7	27	0	2	29	0	0
16	21898159	.	T	A	7	4	11	0	0	11	0	0
16	21898267	.	A	T	7	5	12	0	0	12	0	0
16	21898279	.	C	T	6	5	11	0	0	11	0	0
16	21899211	.	C	T	12	6	18	0	0	18	0	0
16	21899384	.	C	G	2	6	8	0	11	19	0	0
16	21900294	.	A	G	12	9	21	0	0	21	0	0
16	21900333	.	C	A	3	13	16	0	16	32	0	0
16	21901015	.	G	A	5	3	8	0	0	8	0	0
16	21902949	.	G	A	9	12	21	0	1	22	0	0
16	21903803	.	A	G	5	6	11	0	2	13	0	0
16	21903911	.	C	A	1	4	5	0	6	11	0	0
16	21904091	.	G	A	7	3	10	0	0	10	0	0
16	21905681	.	A	G	4	9	13	0	0	13	0	0
16	21905814	.	G	A	13	10	23	0	1	24	0	0
16	21906282	.	A	C	13	0	13	0	9	22	0	0
16	21907744	.	A	G	4	3	7	0	1	8	0	0
16	21908775	.	T	C	5	2	7	0	0	7	0	0
16	21908890	.	A	G	5	3	8	0	0	8	0	0
16	21909747	.	A	T	4	4	8	0	0	8	0	0
16	21912189	.	A	G	5	3	8	0	0	8	0	0
16	21912997	.	G	A	5	2	7	0	0	7	0	0
16	21913069	.	T	A	2	6	8	0	0	8	0	0
16	21917148	.	A	C	8	4	12	0	1	13	0	0
16	21921116	.	C	A	2	2	4	0	0	4	0	0
16	21922155	.	C	T	1	2	3	0	1	4	0	0
16	21922245	.	T	G	2	3	5	0	0	5	0	0
16	21922356	.	A	T	3	6	9	0	1	10	0	0
16	21928360	.	G	A	1	3	4	0	0	4	0	0
16	21928619	.	A	T	4	2	6	0	0	6	0	0
16	21933946	.	G	A	1	2	3	0	2	5	0	0
16	21934042	.	T	C	1	4	5	0	0	5	0	0
16	21934562	.	C	A	2	3	5	0	0	5	0	0
16	21934604	.	A	G	2	3	5	0	0	5	0	0
16	21935398	.	G	T	5	2	7	0	0	7	0	0
16	21937991	.	G	T	0	2	2	0	5	7	0	0
16	22217835	.	T	C	6	0	6	0	6	12	0	0
16	22218117	.	A	G	4	2	6	0	1	7	0	0
16	22218355	.	C	A	3	2	5	0	0	5	0	0
16	22218451	.	A	G	5	2	7	0	0	7	0	0
16	22224698	.	A	G	6	3	9	0	3	12	0	0
16	22224707	.	C	G	7	6	13	0	0	13	0	0
16	22225094	.	C	T	5	7	12	0	2	14	0	0
16	22245156	.	A	G	1	7	8	1	0	9	0	0
16	22249080	.	A	C	5	2	7	0	1	8	0	0
16	22345652	.	T	G	6	7	13	0	1	14	0	0
16	22351659	.	A	G	3	0	3	2	2	7	0	0
16	22354677	.	A	G	6	4	10	0	0	10	0	0
16	22358841	.	T	A	5	13	18	0	0	18	0	0
16	22358944	.	A	T	4	3	7	0	1	8	0	0
16	22358947	.	T	A	5	4	9	0	1	10	0	0
16	22360552	.	G	A	10	11	21	0	2	23	0	0
16	22360577	.	G	A	12	17	29	0	1	30	0	0
16	22361101	.	T	C	10	9	19	0	0	19	0	0
16	22363956	.	G	A	12	11	23	0	0	23	0	0
16	22363957	.	G	A	12	11	23	0	0	23	0	0
16	22364064	.	C	T	15	19	34	0	2	36	0	0
16	22364067	.	T	G	16	19	35	0	2	37	0	0
16	22364241	.	A	C	32	14	46	1	3	50	0	0
16	22364501	.	A	C	4	3	7	0	0	7	0	0
16	22364602	.	A	T	3	4	7	0	0	7	0	0
16	22365562	.	C	G	6	3	9	1	0	10	0	0
16	22368962	.	T	A	19	8	27	0	1	28	0	0
16	22374908	.	C	T	3	3	6	0	0	6	0	0
16	22522589	.	T	A	3	2	5	0	0	5	0	0
16	22522601	.	T	A	2	1	3	0	1	4	0	0
16	22599719	.	C	T	1	1	2	0	0	2	0	0
16	22599728	.	A	G	2	2	4	0	0	4	0	0
16	22600222	.	A	C	0	2	2	0	1	3	0	0
16	22603212	.	C	T	2	3	5	0	0	5	0	0
16	22649862	.	T	G	8	6	14	0	0	14	0	0
16	22659905	.	A	G	13	6	19	0	0	19	0	0
16	22660094	.	C	A	9	13	22	0	1	23	0	0
16	22673219	.	C	T	10	6	16	0	0	16	0	0
16	22673234	.	C	T	11	7	18	0	0	18	0	0
16	22673528	.	C	G	9	21	30	0	0	30	0	0
16	22673804	.	G	T	5	8	13	0	0	13	0	0
16	22673817	.	G	T	6	7	13	0	1	14	0	0
16	22674181	.	A	C	5	6	11	0	0	11	0	0
16	22674317	.	A	G	4	6	10	0	0	10	0	0
16	22674427	.	C	T	6	3	9	0	0	9	0	0
16	22675081	.	T	A	11	10	21	0	0	21	0	0
16	22675110	.	A	T	9	15	24	0	0	24	0	0
16	22675253	.	C	T	10	8	18	0	0	18	0	0
16	22675310	.	T	A	11	13	24	0	0	24	0	0
16	22675367	.	C	A	4	9	13	0	0	13	0	0
16	22675418	.	T	C	6	10	16	0	2	18	0	0
16	22675574	.	T	C	9	12	21	0	0	21	0	0
16	22675663	.	T	C	7	12	19	0	1	20	0	0
16	22675795	.	G	A	0	7	7	0	4	11	0	0
16	22676527	.	C	T	13	3	16	2	0	18	0	0
16	22676589	.	G	T	12	5	17	0	2	19	0	0
16	22676671	.	T	A	9	12	21	0	0	21	0	0
16	22677037	.	C	A	9	5	14	0	0	14	0	0
16	22677086	.	G	A	8	18	26	0	0	26	0	0
16	22677206	.	C	A	10	9	19	0	1	20	0	0
16	22677276	.	A	G	14	10	24	0	2	26	0	0
16	22677537	.	A	G	1	5	6	0	0	6	0	0
16	22677658	.	T	C	3	3	6	0	0	6	0	0
16	22750244	.	A	T	12	8	20	0	1	21	0	0
16	22750506	.	A	G	17	22	39	0	4	43	0	0
16	22750566	.	G	A	26	21	47	0	2	49	0	0
16	22750579	.	A	G	21	23	44	0	0	44	0	0
16	22750610	.	A	T	23	17	40	0	1	41	0	0
16	22750693	.	G	A	31	7	38	0	2	40	0	0
16	22750718	.	A	T	30	7	37	0	1	38	0	0
16	22750754	.	G	A	18	14	32	0	0	32	0	0
16	22750781	.	A	G	16	16	32	0	0	32	0	0
16	22750839	.	A	G	10	14	24	0	0	24	0	0
16	22751093	.	C	A	13	7	20	0	0	20	0	0
16	22751101	.	C	T	11	2	13	0	3	16	0	0
16	22751129	.	T	A	12	3	15	0	1	16	0	0
16	22751141	.	T	G	7	5	12	0	1	13	0	0
16	22751167	.	T	A	7	8	15	0	0	15	0	0
16	22751181	.	C	T	7	9	16	0	0	16	0	0
16	22751221	.	G	C	4	7	11	0	1	12	0	0
16	22751266	.	T	A	4	2	6	0	0	6	0	0
16	22751268	.	G	A	2	3	5	0	1	6	0	0
16	22751325	.	T	C	3	2	5	0	0	5	0	0
16	22751376	.	A	C	8	7	15	0	0	15	0	0
16	22751426	.	T	C	9	7	16	0	1	17	0	0
16	22751926	.	C	T	7	12	19	0	0	19	0	0
16	22752009	.	T	C	10	0	10	0	10	20	0	0
16	22752154	.	G	A	15	21	36	0	0	36	0	0
16	22752182	.	G	T	21	8	29	0	7	36	0	0
16	22752274	.	G	C	15	8	23	0	1	26	2	0
16	22752279	.	T	C	16	8	24	0	1	25	0	0
16	22752328	.	G	A	13	2	15	0	0	15	0	0
16	22752531	.	T	C	12	7	19	0	2	21	0	0
16	22752624	.	C	T	3	11	14	0	0	14	0	0
16	22752779	.	A	G	8	2	10	0	1	11	0	0
16	22752829	.	C	A	5	4	9	0	3	12	0	0
16	22752868	.	C	T	7	5	12	0	1	13	0	0
16	22752889	.	G	A	8	8	16	0	2	18	0	0
16	22752954	.	T	C	11	10	21	0	1	22	0	0
16	22753017	.	G	A	1	3	4	0	0	4	0	0
16	22753068	.	G	A	1	4	5	0	0	5	0	0
16	22753116	.	C	A	0	8	8	0	11	19	0	0
16	22753185	.	C	T	21	6	27	0	3	30	0	0
16	22753380	.	T	G	20	16	36	0	2	38	0	0
16	22753452	.	G	A	22	17	39	0	0	39	0	0
16	22753574	.	C	T	1	15	16	0	17	33	0	0
16	22753583	.	T	C	18	0	18	0	18	36	0	0
16	22753626	.	C	T	20	19	39	0	1	41	1	0
16	22753631	.	C	T	14	22	36	0	1	37	0	0
16	22753784	.	T	C	19	0	19	0	17	36	0	0
16	22767597	.	A	G	6	6	12	0	0	12	0	0
16	22767646	.	G	A	6	3	9	0	0	9	0	0
16	22767732	.	A	G	5	12	17	0	0	17	0	0
16	22767796	.	C	G	4	7	11	0	0	11	0	0
16	22769586	.	G	T	5	5	10	0	1	11	0	0
16	22771212	.	T	A	8	9	17	0	2	19	0	0
16	22782175	.	G	T	2	4	6	0	0	6	0	0
16	22782306	.	A	T	6	13	19	0	1	20	0	0
16	22782308	.	A	T	7	13	20	0	0	20	0	0
16	22782422	.	C	T	3	16	19	0	11	30	0	0
16	22782443	.	A	T	11	16	27	0	0	27	0	0
16	22782458	.	T	C	13	12	25	0	1	26	0	0
16	22782682	.	T	G	8	7	15	0	2	17	0	0
16	22782904	.	G	C	8	12	20	0	2	22	0	0
16	22783338	.	C	G	0	11	11	0	9	20	0	0
16	22783978	.	A	G	10	13	23	0	0	23	0	0
16	22783995	.	T	C	7	1	8	0	12	20	0	0
16	22796434	.	T	G	10	9	19	0	1	20	0	0
16	22866015	.	T	C	6	5	11	0	0	11	0	0
16	22866017	.	C	A	6	5	11	0	0	11	0	0
16	22868973	.	T	C	2	8	10	0	1	11	0	0
16	22872011	.	A	G	8	0	8	0	4	12	0	0
16	22872317	.	A	C	14	9	23	0	1	24	0	0
16	22872602	.	G	A	6	8	14	0	2	16	0	0
16	22872657	.	A	C	12	6	18	0	1	19	0	0
16	22872693	.	T	C	16	2	18	0	1	19	0	0
16	22872694	.	C	T	16	3	19	0	0	19	0	0
16	22872927	.	T	C	12	10	22	0	0	22	0	0
16	22878965	.	T	A	8	8	16	0	0	16	0	0
16	22879035	.	A	G	6	0	6	0	6	12	0	0
16	22879055	.	G	T	2	3	5	0	0	5	0	0
16	22879071	.	A	G	4	1	5	0	2	7	0	0
16	22879128	.	G	C	2	2	4	0	0	4	0	0
16	23087656	.	G	A	5	2	7	0	1	8	0	0
16	23087803	.	G	A	4	5	9	0	0	9	0	0
16	23547295	.	A	G	12	0	12	0	4	16	0	0
16	23557414	.	A	G	3	3	6	0	1	7	0	0
16	23557634	.	A	G	2	2	4	0	0	4	0	0
16	23961572	.	C	G	13	1	14	0	23	37	0	0
16	23961950	.	C	A	24	24	48	0	2	50	0	0
16	23962010	.	T	C	31	20	51	0	1	52	0	0
16	23963246	.	C	T	32	25	57	0	1	58	0	0
16	23963315	.	G	T	22	23	45	0	3	48	0	0
16	23972939	.	G	A	24	7	31	0	0	31	0	0
16	23973477	.	G	A	26	28	54	0	5	61	2	0
16	24135445	.	T	C	4	3	7	0	1	8	0	0
16	24191564	.	G	A	35	41	76	0	7	83	0	0
16	24213444	.	T	A	17	13	30	1	2	34	1	0
16	24213446	.	T	A	21	14	35	1	0	36	0	0
16	24213538	.	G	T	32	8	40	0	5	45	0	0
16	24213657	.	G	A	18	22	40	1	3	44	0	0
16	24213666	.	T	G	18	22	40	1	0	41	0	0
16	24213793	.	T	C	23	24	47	0	3	50	0	0
16	24214023	.	A	G	32	28	60	0	4	64	0	0
16	24214106	.	T	C	21	0	21	0	28	49	0	0
16	24214468	.	T	C	31	28	59	0	0	59	0	0
16	24261594	.	C	G	22	17	39	1	1	41	0	0
16	24277750	.	C	T	16	25	41	0	3	44	0	0
16	24302164	.	G	A	17	15	32	0	1	33	0	0
16	24523352	.	C	A	0	2	2	0	2	4	0	0
16	24526656	.	A	T	2	2	4	0	0	4	0	0
16	24552032	.	G	A	1	5	6	0	0	6	0	0
16	24552081	.	C	T	7	6	13	0	2	15	0	0
16	24553018	.	G	T	7	3	10	0	0	10	0	0
16	24553082	.	T	A	2	6	8	0	0	8	0	0
16	24553141	.	T	A	3	4	7	0	0	7	0	0
16	24553225	.	C	G	7	9	16	0	0	16	0	0
16	24553450	.	T	C	5	6	11	0	2	13	0	0
16	24553621	.	C	T	6	4	10	0	0	10	0	0
16	24553633	.	A	G	7	5	12	0	0	12	0	0
16	24553843	.	A	G	3	1	4	0	0	4	0	0
16	24553861	.	T	C	5	3	8	0	0	8	0	0
16	24554438	.	T	A	14	9	23	0	1	24	0	0
16	24554475	.	A	G	16	10	26	0	2	28	0	0
16	24590767	.	T	A	13	11	24	0	0	24	0	0
16	24590823	.	C	T	16	17	33	0	2	35	0	0
16	24591172	.	A	G	13	19	32	0	2	34	0	0
16	24591245	.	A	T	9	13	22	0	0	22	0	0
16	24591258	.	A	G	7	15	22	0	1	23	0	0
16	24591330	.	A	G	20	6	26	0	0	26	0	0
16	24591360	.	G	A	13	6	19	0	0	19	0	0
16	24591410	.	G	A	8	4	12	0	1	13	0	0
16	24591693	.	G	C	29	20	49	0	2	51	0	0
16	24591751	.	C	T	30	15	45	0	3	48	0	0
16	24591794	.	G	T	13	24	37	0	1	38	0	0
16	24632121	.	G	T	8	6	14	0	0	14	0	0
16	24632231	.	C	T	15	10	25	0	1	26	0	0
16	24645448	.	C	G	16	9	25	0	1	26	0	0
16	24645620	.	T	G	9	11	20	0	0	20	0	0
16	24665547	.	G	A	1	2	3	0	0	3	0	0
16	24695160	.	G	T	13	22	35	0	0	35	0	0
16	24695301	.	T	C	35	16	51	0	3	54	0	0
16	24695322	.	G	T	4	21	25	0	35	61	1	0
16	24695520	.	G	A	43	19	62	0	2	64	0	0
16	24695525	.	A	C	40	19	59	0	5	64	0	0
16	24695681	.	A	T	38	24	62	0	2	64	0	0
16	24732602	.	A	G	2	0	2	0	4	6	0	0
16	24740401	.	A	G	1	2	3	0	0	3	0	0
16	24819515	.	A	T	2	4	6	0	0	6	0	0
16	24819613	.	C	T	0	3	3	1	3	7	0	0
16	24820061	.	A	G	2	2	4	0	0	4	0	0
16	24820551	.	T	C	0	2	2	0	0	2	0	0
16	24820566	.	T	C	1	2	3	0	0	3	0	0
16	24842880	.	G	A	0	4	4	0	2	6	0	0
16	24916108	.	T	C	2	4	6	0	0	6	0	0
16	24918604	.	T	C	1	4	5	0	0	5	0	0
16	24918619	.	C	T	1	4	5	0	0	5	0	0
16	24918719	.	A	T	2	2	4	0	0	4	0	0
16	24918722	.	G	C	2	2	4	0	0	4	0	0
16	24980276	.	A	T	2	5	7	0	0	7	0	0
16	24989469	.	T	A	2	2	4	0	0	4	0	0
16	24990255	.	T	A	1	5	6	0	0	6	0	0
16	24990261	.	A	G	1	3	4	0	0	4	0	0
16	24990672	.	C	T	4	3	7	0	1	8	0	0
16	24990850	.	C	T	2	7	9	0	0	9	0	0
16	24991164	.	G	T	2	4	6	0	4	10	0	0
16	24991225	.	C	G	5	8	13	0	1	14	0	0
16	24991239	.	G	A	0	7	7	0	6	13	0	0
16	24991333	.	T	C	5	8	13	0	0	13	0	0
16	24991593	.	A	T	5	8	13	0	2	15	0	0
16	24991636	.	G	A	4	7	11	0	2	13	0	0
16	24991637	.	C	T	4	7	11	0	2	13	0	0
16	24991741	.	T	C	2	2	4	0	0	4	0	0
16	24991763	.	G	C	1	3	4	0	0	4	0	0
16	24991919	.	T	A	7	7	14	0	0	14	0	0
16	24991940	.	T	A	11	4	15	0	0	15	0	0
16	24992017	.	A	C	4	10	14	0	0	14	0	0
16	24992080	.	A	G	2	4	6	0	0	6	0	0
16	25012003	.	T	A	2	2	4	0	0	4	0	0
16	25012143	.	T	A	6	5	11	0	0	11	0	0
16	25012935	.	T	A	4	5	9	0	1	10	0	0
16	25032037	.	C	T	5	6	11	0	1	12	0	0
16	25033173	.	G	A	9	5	14	0	0	14	0	0
16	25033191	.	C	T	11	3	14	0	0	14	0	0
16	25033809	.	G	A	10	8	18	0	0	18	0	0
16	25034683	.	A	T	16	9	25	0	0	25	0	0
16	25034715	.	C	T	11	11	22	0	0	22	0	0
16	25036217	.	C	T	8	12	20	0	1	21	0	0
16	25038185	.	A	T	6	6	12	0	4	16	0	0
16	25038429	.	C	T	13	4	17	0	0	17	0	0
16	25038696	.	A	T	5	3	8	0	1	9	0	0
16	25068507	.	C	T	4	4	8	0	0	8	0	0
16	25068699	.	G	A	4	4	8	0	0	8	0	0
16	25068711	.	C	T	4	4	8	0	0	8	0	0
16	25068794	.	A	G	3	0	3	0	2	5	0	0
16	25068857	.	A	G	3	0	3	0	2	5	0	0
16	25071019	.	G	A	6	3	9	0	0	9	0	0
16	25071614	.	C	T	4	9	13	0	1	14	0	0
16	25071782	.	G	A	1	8	9	0	2	11	0	0
16	25072355	.	G	A	7	5	12	0	0	12	0	0
16	25076311	.	C	T	2	2	4	0	1	5	0	0
16	25076919	.	G	C	5	4	9	0	0	9	0	0
16	25077410	.	G	A	1	4	5	0	3	8	0	0
16	25077608	.	C	T	4	3	7	0	1	8	0	0
16	25077819	.	C	T	2	6	8	0	0	8	0	0
16	25078397	.	G	T	6	2	8	0	0	8	0	0
16	25078715	.	A	G	6	6	12	0	0	12	0	0
16	25078907	.	T	A	3	5	8	0	1	9	0	0
16	25079407	.	A	C	5	6	11	0	2	13	0	0
16	25080042	.	G	T	4	4	8	0	0	8	0	0
16	25080190	.	T	A	4	5	9	0	0	9	0	0
16	25080207	.	C	T	2	4	6	0	0	6	0	0
16	25080236	.	G	T	3	3	6	0	0	6	0	0
16	25104031	.	T	C	21	13	34	0	2	36	0	0
16	25104454	.	C	G	19	11	30	0	0	30	0	0
16	25104543	.	C	T	11	9	20	0	0	20	0	0
16	25104850	.	A	C	12	15	27	0	0	27	0	0
16	25104899	.	T	G	13	12	25	0	0	25	0	0
16	25104941	.	T	C	16	10	26	0	1	27	0	0
16	25111794	.	G	A	6	3	9	0	1	10	0	0
16	25112001	.	A	G	1	4	5	0	0	5	0	0
16	25112316	.	G	A	2	3	5	0	0	5	0	0
16	25112769	.	C	T	6	6	12	0	0	12	0	0
16	25113741	.	G	A	2	4	6	0	6	12	0	0
16	25119126	.	C	T	2	2	4	0	0	4	0	0
16	25119501	.	T	A	1	2	3	0	0	3	0	0
16	25120023	.	T	G	2	2	4	0	0	4	0	0
16	25121958	.	C	T	4	2	6	0	0	6	0	0
16	25121970	.	C	T	4	5	9	0	0	9	0	0
16	25122240	.	C	T	2	8	10	0	0	10	0	0
16	25122387	.	C	T	6	4	10	0	1	11	0	0
16	25122798	.	C	T	4	3	7	0	1	8	0	0
16	25123129	.	A	G	4	10	14	0	0	14	0	0
16	25123130	.	A	G	6	7	13	0	1	14	0	0
16	25123382	.	G	T	8	6	14	0	0	14	0	0
16	25123610	.	T	A	1	3	4	0	0	4	0	0
16	25123832	.	A	G	5	4	9	0	1	10	0	0
16	25123843	.	T	A	5	8	13	0	0	13	0	0
16	25123884	.	C	G	4	5	9	0	0	9	0	0
16	25124500	.	G	A	8	2	10	0	0	10	0	0
16	25124662	.	G	T	7	5	12	0	0	12	0	0
16	25124750	.	G	A	1	4	5	0	0	5	0	0
16	25124832	.	C	T	2	5	7	0	0	7	0	0
16	25142116	.	T	C	3	3	6	0	0	6	0	0
16	25142302	.	G	A	1	3	4	0	1	5	0	0
16	25142562	.	C	T	2	7	9	0	0	9	0	0
16	25145978	.	G	A	0	3	3	0	5	8	0	0
16	25146020	.	T	C	2	2	4	0	0	4	0	0
16	25146107	.	A	T	1	2	3	0	0	3	0	0
16	25148515	.	C	T	2	4	6	0	1	7	0	0
16	25148565	.	G	A	1	2	3	0	5	8	0	0
16	25148725	.	C	T	2	4	6	0	0	6	0	0
16	25148748	.	G	A	1	4	5	0	1	6	0	0
16	25149254	.	G	T	3	1	4	0	1	5	0	0
16	25149294	.	T	A	4	3	7	0	0	7	0	0
16	25149433	.	C	T	2	6	8	0	0	8	0	0
16	25149474	.	C	T	2	5	7	0	0	7	0	0
16	25149563	.	T	G	1	2	3	0	0	3	0	0
16	25149654	.	T	C	1	6	7	0	0	7	0	0
16	25149819	.	T	C	5	5	10	0	0	10	0	0
16	25149889	.	A	G	1	4	5	0	2	7	0	0
16	25149939	.	G	A	6	2	8	0	0	8	0	0
16	25150329	.	A	G	6	5	11	0	0	11	0	0
16	25151012	.	T	C	2	7	9	0	0	9	0	0
16	25151059	.	G	A	0	7	7	0	2	9	0	0
16	25151079	.	A	G	2	0	2	0	6	8	0	0
16	25151456	.	G	A	1	3	4	0	0	4	0	0
16	25151757	.	G	C	2	4	6	0	1	7	0	0
16	25154081	.	A	C	3	8	11	0	0	11	0	0
16	25154115	.	C	T	4	4	8	0	0	8	0	0
16	25160922	.	A	T	3	4	7	0	0	7	0	0
16	25160985	.	G	A	0	5	5	0	3	8	0	0
16	25161315	.	T	C	5	10	15	0	1	16	0	0
16	25161693	.	G	A	8	7	15	0	0	15	0	0
16	25161873	.	G	A	2	12	14	0	10	24	0	0
16	25161876	.	T	C	10	9	19	0	3	22	0	0
16	25162320	.	T	A	1	2	3	0	1	4	0	0
16	25164326	.	C	A	11	8	19	0	0	19	0	0
16	25168548	.	G	A	15	9	24	0	0	24	0	0
16	25168765	.	C	A	7	16	23	0	1	24	0	0
16	25169336	.	G	A	7	11	18	0	0	18	0	0
16	25169616	.	A	T	3	8	11	0	0	11	0	0
16	25180397	.	A	C	5	5	10	0	0	10	0	0
16	25180415	.	C	T	4	6	10	0	0	10	0	0
16	25180775	.	G	A	5	3	8	0	0	8	0	0
16	25180942	.	A	G	5	0	5	0	3	8	0	0
16	25181046	.	A	G	3	5	8	0	1	9	0	0
16	25181095	.	C	T	2	8	10	0	1	11	0	0
16	25181194	.	G	C	3	2	5	0	0	5	0	0
16	25181213	.	A	G	1	3	4	0	0	4	0	0
16	25181350	.	A	T	2	3	5	0	0	5	0	0
16	25232203	.	T	C	2	4	6	0	0	6	0	0
16	25232250	.	T	C	1	4	5	0	0	5	0	0
16	25232288	.	C	A	1	2	3	0	5	8	0	0
16	25232421	.	T	C	6	3	9	0	0	9	0	0
16	25232433	.	C	T	0	7	7	0	2	9	0	0
16	25232707	.	C	T	1	5	6	0	1	7	0	0
16	25232712	.	C	T	1	2	3	0	4	7	0	0
16	25232967	.	G	A	2	2	4	0	0	4	0	0
16	25232973	.	C	T	0	2	2	0	2	4	0	0
16	25259332	.	T	C	2	2	4	0	0	4	0	0
16	25259477	.	T	A	2	3	5	0	1	6	0	0
16	25260382	.	T	C	1	2	3	0	0	3	0	0
16	25272148	.	G	T	0	3	3	0	2	5	0	0
16	25272149	.	A	G	2	2	4	0	1	5	0	0
16	25272196	.	C	G	3	3	6	0	0	6	0	0
16	25272351	.	C	T	2	3	5	0	0	5	0	0
16	25272413	.	C	T	2	3	5	1	0	6	0	0
16	25272429	.	G	T	2	3	5	1	0	6	0	0
16	25272529	.	A	C	3	3	6	0	0	6	0	0
16	25275848	.	T	C	1	5	6	0	0	6	0	0
16	25275909	.	A	C	10	14	24	0	1	25	0	0
16	25275957	.	C	T	24	10	34	0	3	37	0	0
16	25276281	.	G	A	14	17	31	0	0	31	0	0
16	25276387	.	T	A	6	10	16	0	2	18	0	0
16	25285506	.	G	A	19	19	38	0	0	38	0	0
16	25285507	.	G	A	19	19	38	0	0	38	0	0
16	25308516	.	C	T	5	3	8	0	0	8	0	0
16	25308986	.	G	A	2	2	4	0	0	4	0	0
16	25311000	.	T	C	2	7	9	0	0	9	0	0
16	25311038	.	A	T	1	5	6	0	0	7	1	0
16	25311772	.	G	A	5	5	10	0	0	10	0	0
16	25317000	.	G	A	7	3	10	0	0	10	0	0
16	25327155	.	C	A	10	12	22	0	0	22	0	0
16	25327181	.	C	T	11	10	21	0	0	21	0	0
16	25327202	.	G	A	12	17	29	0	0	29	0	0
16	25327730	.	C	T	10	6	16	0	0	16	0	0
16	25329319	.	C	T	5	5	10	0	1	11	0	0
16	25333270	.	A	G	9	16	25	0	0	25	0	0
16	25337248	.	C	A	17	22	39	0	3	42	0	0
16	25337286	.	C	T	20	21	41	0	0	41	0	0
16	25337319	.	G	A	18	10	28	0	0	28	0	0
16	25345649	.	A	G	2	0	2	0	3	5	0	0
16	25348407	.	T	C	1	3	4	0	0	4	0	0
16	25348767	.	G	A	4	4	8	0	0	8	0	0
16	25348860	.	C	T	1	3	4	0	0	4	0	0
16	25349471	.	C	T	5	5	10	0	0	10	0	0
16	25349581	.	G	T	5	4	9	0	2	11	0	0
16	25351283	.	A	T	4	6	10	0	0	10	0	0
16	25354571	.	A	G	3	0	3	0	3	6	0	0
16	25360557	.	T	A	9	6	15	0	0	15	0	0
16	25360762	.	G	A	4	3	7	0	0	7	0	0
16	25364479	.	T	C	6	5	11	0	1	12	0	0
16	25364742	.	T	C	6	0	6	0	12	18	0	0
16	25365156	.	C	T	4	6	10	0	0	10	0	0
16	25367674	.	A	T	7	1	8	0	1	9	0	0
16	25367683	.	A	G	7	2	9	0	0	9	0	0
16	25367788	.	A	G	7	3	10	0	0	11	1	0
16	25367902	.	C	T	0	2	2	0	5	7	0	0
16	25367917	.	C	G	4	6	10	0	0	10	0	0
16	25367938	.	G	C	7	0	7	0	7	14	0	0
16	25373823	.	C	T	2	2	4	0	0	4	0	0
16	25373979	.	T	A	8	3	11	0	0	11	0	0
16	25374275	.	T	C	3	7	10	0	0	10	0	0
16	25374507	.	T	C	13	0	13	0	7	20	0	0
16	25375019	.	T	C	5	0	5	0	5	11	1	0
16	25375521	.	C	A	2	5	7	0	0	7	0	0
16	25376046	.	T	A	6	6	12	0	0	12	0	0
16	25376673	.	C	T	1	2	3	0	6	9	0	0
16	25376700	.	A	G	2	5	7	0	0	7	0	0
16	25376808	.	T	C	2	4	6	0	0	6	0	0
16	25380325	.	C	G	2	3	5	0	3	8	0	0
16	25380786	.	T	G	7	2	9	0	1	10	0	0
16	25389094	.	G	A	13	12	25	0	0	25	0	0
16	25389106	.	C	T	9	12	21	0	1	22	0	0
16	25394879	.	C	A	3	3	6	0	0	6	0	0
16	25394883	.	C	T	3	3	6	0	0	6	0	0
16	25395702	.	G	T	4	8	12	0	1	13	0	0
16	25399585	.	A	T	8	6	14	0	0	14	0	0
16	25399588	.	A	T	7	6	13	0	0	13	0	0
16	25400055	.	G	C	1	12	13	0	0	13	0	0
16	25400061	.	A	T	1	11	12	0	1	13	0	0
16	25407426	.	A	T	1	4	5	0	0	5	0	0
16	25445746	.	G	A	5	5	10	0	1	11	0	0
16	25463401	.	C	A	5	6	11	0	0	11	0	0
16	25470975	.	A	G	7	9	16	0	0	16	0	0
16	25477428	.	G	A	7	7	14	0	0	14	0	0
16	25477736	.	A	G	6	3	9	0	0	9	0	0
16	25487775	.	C	T	4	5	9	0	1	10	0	0
16	25490833	.	A	G	7	0	7	0	4	11	0	0
16	25492951	.	C	T	2	2	4	0	1	5	0	0
16	25498402	.	T	A	5	8	13	0	0	13	0	0
16	25500137	.	A	G	3	10	13	0	2	15	0	0
16	25500223	.	T	C	5	2	7	0	0	7	0	0
16	25504192	.	G	C	12	10	22	0	0	22	0	0
16	25504337	.	G	A	12	13	25	0	2	27	0	0
16	25504466	.	C	T	14	12	26	0	1	27	0	0
16	25504467	.	G	A	13	14	27	0	0	27	0	0
16	25504792	.	G	C	27	27	54	0	1	55	0	0
16	25504900	.	G	A	18	30	48	0	3	52	1	0
16	25535229	.	C	T	1	9	10	0	5	15	0	0
16	25556650	.	T	A	14	17	31	0	1	32	0	0
16	25556697	.	A	G	13	14	27	0	0	27	0	0
16	25556710	.	C	T	11	10	21	0	0	21	0	0
16	25556766	.	C	G	0	11	11	0	4	15	0	0
16	25556780	.	A	G	4	12	16	0	1	17	0	0
16	25556802	.	C	A	7	11	18	0	0	18	0	0
16	25556930	.	A	G	11	7	18	0	1	19	0	0
16	25556966	.	T	A	16	12	28	0	1	29	0	0
16	25557352	.	C	T	2	11	13	0	4	17	0	0
16	25557400	.	A	G	5	5	10	0	0	10	0	0
16	25557403	.	T	C	5	5	10	0	0	10	0	0
16	25557690	.	C	T	7	7	14	0	0	14	0	0
16	25558135	.	C	T	17	6	23	0	0	23	0	0
16	25558223	.	A	G	7	9	16	0	1	17	0	0
16	25558351	.	C	T	1	7	8	0	10	18	0	0
16	25558439	.	G	T	12	4	16	0	1	17	0	0
16	25558892	.	G	A	6	4	10	0	0	10	0	0
16	25558986	.	A	G	9	7	16	0	1	17	0	0
16	25559193	.	A	G	6	14	20	0	2	22	0	0
16	25559274	.	C	T	1	5	6	0	1	7	0	0
16	25559495	.	T	A	3	5	8	0	0	8	0	0
16	25559632	.	G	A	5	8	13	0	1	14	0	0
16	25559743	.	A	T	6	9	15	0	0	15	0	0
16	25560135	.	T	C	2	1	3	0	10	13	0	0
16	25560184	.	A	G	9	4	13	0	0	13	0	0
16	25560322	.	G	A	7	6	13	0	1	14	0	0
16	25560526	.	T	C	5	3	8	0	0	8	0	0
16	25561175	.	A	G	6	7	13	0	0	13	0	0
16	25561471	.	C	G	1	7	8	0	11	19	0	0
16	25561795	.	C	A	5	16	21	0	1	22	0	0
16	25562480	.	G	A	9	7	16	0	0	16	0	0
16	25562549	.	G	A	9	5	14	0	1	15	0	0
16	25597510	.	G	A	8	8	16	0	0	16	0	0
16	25642663	.	G	A	16	12	28	0	1	29	0	0
16	25642673	.	C	T	20	15	35	0	0	35	0	0
16	25643038	.	G	A	12	11	23	0	1	24	0	0
16	25643041	.	G	A	5	12	17	0	9	26	0	0
16	25643113	.	G	C	10	4	14	0	2	16	0	0
16	25643452	.	T	A	8	9	17	0	0	17	0	0
16	25643818	.	G	T	12	10	22	0	1	23	0	0
16	25644357	.	C	A	11	11	22	0	0	22	0	0
16	25644378	.	A	T	12	10	22	0	0	22	0	0
16	25673249	.	T	A	8	4	12	0	1	13	0	0
16	25683018	.	T	C	8	5	13	0	1	14	0	0
16	25683387	.	C	T	0	10	10	0	13	23	0	0
16	25698449	.	A	C	6	4	10	0	1	11	0	0
16	25761574	.	C	T	1	3	4	0	0	4	0	0
16	26043044	.	T	A	11	10	21	0	1	22	0	0
16	26141785	.	C	A	0	6	6	0	6	12	0	0
16	26141817	.	T	G	9	8	17	0	0	17	0	0
16	26142105	.	C	T	8	4	12	0	0	12	0	0
16	26142311	.	A	C	10	7	17	0	0	17	0	0
16	26142773	.	G	A	6	9	15	0	0	15	0	0
16	26142779	.	C	T	5	6	11	0	0	11	0	0
16	26142900	.	T	C	12	1	13	0	5	18	0	0
16	26143082	.	A	G	5	2	7	0	0	7	0	0
16	26143332	.	T	C	7	13	20	0	0	20	0	0
16	26143371	.	T	G	4	11	15	0	1	16	0	0
16	26143538	.	C	T	5	5	10	0	0	10	0	0
16	26143561	.	C	T	4	6	10	0	1	11	0	0
16	26146174	.	G	A	7	9	16	0	3	19	0	0
16	26146736	.	G	A	9	5	14	0	0	14	0	0
16	26148741	.	C	T	4	5	9	0	1	10	0	0
16	26148962	.	C	A	4	4	8	0	1	9	0	0
16	26148963	.	C	A	5	4	9	0	0	9	0	0
16	26149005	.	A	T	3	8	11	0	0	11	0	0
16	26169515	.	T	G	4	4	8	0	2	10	0	0
16	26170400	.	A	G	4	6	10	0	0	10	0	0
16	26170412	.	G	A	3	6	9	0	1	10	0	0
16	26236259	.	C	T	3	4	7	0	0	7	0	0
16	26378655	.	T	C	4	0	4	0	4	8	0	0
16	26378665	.	G	T	5	2	7	0	1	8	0	0
16	26378706	.	G	T	2	3	5	0	0	5	0	0
16	26379249	.	T	A	1	2	3	0	1	4	0	0
16	26379397	.	G	A	2	5	7	0	1	8	0	0
16	26379437	.	T	C	1	0	1	0	3	4	0	0
16	26380517	.	G	T	1	2	3	0	0	3	0	0
16	26380536	.	A	G	4	3	7	0	0	7	0	0
16	26380784	.	C	T	2	9	11	0	10	21	0	0
16	26380866	.	G	A	5	15	20	0	2	22	0	0
16	26381192	.	T	G	12	10	22	0	1	23	0	0
16	26381271	.	C	T	14	10	24	0	1	25	0	0
16	26381344	.	T	G	5	8	13	0	5	18	0	0
16	26381416	.	C	T	3	24	27	0	13	40	0	0
16	26381463	.	C	T	3	15	18	0	19	37	0	0
16	26381768	.	C	T	1	10	11	0	11	22	0	0
16	26382084	.	T	C	13	9	22	0	1	23	0	0
16	26382225	.	A	T	18	18	36	0	2	38	0	0
16	26382243	.	G	A	23	15	38	0	0	38	0	0
16	26382308	.	T	C	20	23	43	0	4	47	0	0
16	26382453	.	T	C	12	0	12	0	9	21	0	0
16	26382585	.	A	G	12	9	21	0	1	22	0	0
16	26382942	.	T	C	20	17	37	0	0	37	0	0
16	26383016	.	C	T	4	24	28	0	23	51	0	0
16	26384188	.	C	G	8	7	15	0	0	15	0	0
16	26384219	.	G	A	12	9	21	0	0	21	0	0
16	26384417	.	G	A	15	6	21	0	1	22	0	0
16	26388840	.	A	G	9	6	15	0	1	16	0	0
16	26391447	.	A	G	12	3	15	0	1	16	0	0
16	26391450	.	C	T	13	3	16	0	0	16	0	0
16	26391970	.	C	A	1	9	10	0	10	21	1	0
16	26393459	.	G	T	4	4	8	0	0	8	0	0
16	26393525	.	G	A	4	5	9	0	0	9	0	0
16	26396381	.	A	C	6	7	13	0	0	13	0	0
16	26398268	.	C	T	0	6	6	0	3	9	0	0
16	26404077	.	A	G	1	5	6	0	0	6	0	0
16	26406028	.	A	G	3	4	7	0	0	7	0	0
16	26406074	.	A	G	4	5	9	0	0	9	0	0
16	26408819	.	G	A	7	2	9	0	0	9	0	0
16	26408847	.	C	T	7	4	11	0	2	13	0	0
16	26410903	.	G	A	4	2	6	0	0	6	0	0
16	26413746	.	T	C	1	0	1	0	4	5	0	0
16	26420512	.	C	G	2	3	5	0	0	5	0	0
16	26435481	.	A	C	1	0	1	0	3	4	0	0
16	26437254	.	A	C	1	4	5	0	0	5	0	0
16	26437569	.	T	C	0	2	2	0	1	3	0	0
16	26439576	.	A	G	1	4	5	0	1	6	0	0
16	26439617	.	C	A	4	4	8	0	0	8	0	0
16	26439809	.	T	G	4	5	9	0	0	9	0	0
16	26440252	.	G	A	2	7	9	0	0	9	0	0
16	26441526	.	T	A	2	3	5	0	0	5	0	0
16	26441532	.	T	C	2	3	5	0	1	6	0	0
16	26441561	.	G	A	1	5	6	0	0	6	0	0
16	26441624	.	A	T	3	4	7	0	1	8	0	0
16	26443781	.	G	A	4	3	7	0	0	7	0	0
16	26443958	.	A	T	6	2	8	0	0	8	0	0
16	26443976	.	C	T	2	8	10	0	0	10	0	0
16	26444135	.	T	C	3	3	6	0	0	6	0	0
16	26444165	.	A	T	2	3	5	0	0	5	0	0
16	26444189	.	A	G	1	3	4	0	1	5	0	0
16	26444431	.	T	A	5	7	12	0	0	12	0	0
16	26444443	.	A	G	6	6	12	0	0	12	0	0
16	26444505	.	C	T	8	7	15	0	1	16	0	0
16	26444668	.	C	T	3	2	5	0	0	5	0	0
16	26444680	.	G	T	4	4	8	0	0	8	0	0
16	26444748	.	G	A	3	6	9	0	0	9	0	0
16	26444776	.	G	A	5	4	9	0	0	9	0	0
16	26445484	.	T	C	4	6	10	0	0	10	0	0
16	26445512	.	A	C	4	4	8	0	0	8	0	0
16	26445593	.	G	C	1	2	3	0	1	4	0	0
16	26445614	.	G	C	1	6	7	0	0	7	0	0
16	26481169	.	G	A	0	4	4	0	1	5	0	0
16	26483363	.	T	A	1	2	3	0	0	3	0	0
16	26517226	.	G	A	3	3	6	0	0	6	0	0
16	26517227	.	T	G	4	3	7	0	0	7	0	0
16	26588140	.	A	G	1	2	3	0	0	3	0	0
16	26588156	.	A	G	1	2	3	0	0	3	0	0
16	26643598	.	G	C	6	9	15	0	0	15	0	0
16	26688229	.	T	C	5	8	13	0	0	13	0	0
16	26689957	.	G	A	4	2	6	0	0	6	0	0
16	26690047	.	A	T	7	7	14	0	0	14	0	0
16	26691145	.	T	A	3	3	6	0	0	6	0	0
16	26691491	.	C	T	5	5	10	0	2	12	0	0
16	26691622	.	G	A	5	6	11	0	0	11	0	0
16	26691646	.	T	C	4	3	7	0	0	7	0	0
16	26691665	.	C	T	6	3	9	0	0	9	0	0
16	26691832	.	A	T	4	7	11	0	0	11	0	0
16	26691880	.	C	T	4	2	6	0	0	6	0	0
16	26694669	.	C	T	5	2	7	0	0	7	0	0
16	26702648	.	A	C	6	6	12	0	0	12	0	0
16	26702780	.	G	T	2	9	11	0	13	24	0	0
16	26702786	.	G	A	0	13	13	0	10	23	0	0
16	26706875	.	C	T	9	4	13	0	1	14	0	0
16	26707494	.	A	G	10	12	22	0	0	22	0	0
16	26710900	.	C	A	16	14	30	0	1	31	0	0
16	26710954	.	A	T	12	12	24	0	1	25	0	0
16	26710957	.	G	A	12	12	24	0	1	25	0	0
16	26713964	.	G	T	14	14	28	0	1	29	0	0
16	26717318	.	C	T	6	11	17	0	1	18	0	0
16	26717457	.	C	A	3	5	8	0	1	9	0	0
16	26766926	.	G	A	2	3	5	0	0	5	0	0
16	26769118	.	C	T	3	5	8	0	1	9	0	0
16	26816799	.	A	G	10	5	15	2	0	17	0	0
16	26816806	.	G	T	8	4	12	2	0	14	0	0
16	26816852	.	G	T	3	8	11	0	0	11	0	0
16	26816885	.	A	G	8	2	10	0	2	12	0	0
16	26816918	.	T	A	8	7	15	0	1	16	0	0
16	26817046	.	T	G	10	8	18	0	0	18	0	0
16	26817069	.	C	T	2	10	12	0	10	22	0	0
16	26817178	.	T	A	8	11	19	0	0	19	0	0
16	26817358	.	C	T	9	12	21	0	0	21	0	0
16	26817631	.	C	T	0	6	6	0	3	9	0	0
16	26817754	.	C	T	0	12	12	0	4	16	0	0
16	26818658	.	C	T	7	3	10	0	0	10	0	0
16	26818666	.	A	C	3	5	8	0	1	9	0	0
16	26850833	.	C	T	7	7	14	0	0	14	0	0
16	26850845	.	T	C	5	11	16	0	1	17	0	0
16	26850885	.	C	T	6	13	19	0	0	19	0	0
16	26851025	.	C	G	1	4	5	0	0	5	0	0
16	26851036	.	T	A	1	3	4	0	1	5	0	0
16	26851149	.	T	C	1	4	5	0	1	6	0	0
16	26851161	.	C	T	0	5	5	0	3	8	0	0
16	26851191	.	C	T	2	11	13	0	1	14	0	0
16	26851236	.	C	T	1	3	4	0	11	15	0	0
16	26851445	.	T	A	8	9	17	0	1	18	0	0
16	26855729	.	C	A	6	12	18	0	1	19	0	0
16	26855786	.	G	A	9	10	19	0	2	21	0	0
16	26855833	.	C	A	1	4	5	0	10	15	0	0
16	26855859	.	C	A	1	9	10	0	16	26	0	0
16	27064864	.	A	G	9	9	18	0	0	18	0	0
16	27069608	.	A	G	13	0	13	0	6	19	0	0
16	27072488	.	G	A	0	8	8	0	10	18	0	0
16	27080221	.	T	C	9	6	15	0	1	16	0	0
16	27089100	.	T	G	11	5	16	0	1	17	0	0
16	27098305	.	T	C	11	15	26	0	1	27	0	0
16	27098530	.	A	G	11	11	22	0	0	22	0	0
16	27098549	.	A	T	10	11	21	0	1	22	0	0
16	27099121	.	A	T	3	6	9	0	1	10	0	0
16	27099508	.	G	A	7	7	14	0	0	14	0	0
16	27100042	.	T	G	4	4	8	0	1	9	0	0
16	27100133	.	A	C	9	7	16	0	0	16	0	0
16	27100139	.	A	T	8	8	16	0	1	17	0	0
16	27100198	.	T	A	13	16	29	0	1	30	0	0
16	27100222	.	T	C	17	15	32	0	0	32	0	0
16	27126647	.	C	T	1	16	17	0	9	26	0	0
16	27126998	.	A	G	8	8	16	0	0	16	0	0
16	27126999	.	T	A	8	8	16	0	0	16	0	0
16	27127157	.	G	C	15	21	36	0	1	37	0	0
16	27127158	.	C	A	17	19	36	0	2	38	0	0
16	27127576	.	T	C	14	14	28	0	0	28	0	0
16	27127959	.	G	A	18	21	39	0	1	40	0	0
16	27131005	.	C	T	1	11	12	0	11	23	0	0
16	27136541	.	A	G	19	11	30	0	0	30	0	0
16	27138207	.	C	G	15	13	28	0	0	28	0	0
16	27138391	.	C	G	18	11	29	0	1	30	0	0
16	27148691	.	C	T	12	12	24	0	0	24	0	0
16	27148861	.	G	T	9	6	15	0	0	15	0	0
16	27158741	.	A	T	11	15	26	0	0	26	0	0
16	27159124	.	G	C	8	0	8	0	10	18	0	0
16	27169529	.	G	A	21	15	36	0	2	38	0	0
16	27169586	.	G	A	18	11	29	0	2	31	0	0
16	27169664	.	A	T	8	19	27	0	0	27	0	0
16	27169809	.	G	A	20	11	31	0	1	32	0	0
16	27170206	.	A	G	15	6	21	0	1	22	0	0
16	27216353	.	G	A	3	6	9	0	1	10	0	0
16	27216701	.	C	T	4	5	9	0	0	9	0	0
16	27216845	.	C	T	1	7	8	0	3	11	0	0
16	27216970	.	G	A	5	3	8	0	0	8	0	0
16	27217103	.	G	C	2	3	5	0	0	5	0	0
16	27224450	.	G	C	22	10	32	3	4	39	0	0
16	27225215	.	C	A	11	20	31	0	3	34	0	0
16	27231337	.	T	A	28	13	41	0	1	42	0	0
16	27231416	.	C	T	23	30	53	0	1	54	0	0
16	27345418	.	C	T	6	4	10	0	0	10	0	0
16	27345748	.	C	T	6	3	9	0	5	14	0	0
16	27354980	.	G	A	6	4	10	0	0	10	0	0
16	27356127	.	G	A	10	11	21	0	0	21	0	0
16	27368175	.	G	A	8	15	23	0	0	23	0	0
16	27368290	.	G	A	1	15	16	0	13	29	0	0
16	27368315	.	G	A	1	13	14	0	13	27	0	0
16	27368577	.	A	G	16	13	29	0	0	29	0	0
16	27368688	.	A	C	17	16	33	0	3	36	0	0
16	27368756	.	A	G	8	8	16	0	0	16	0	0
16	27368823	.	T	G	12	12	24	0	0	24	0	0
16	27368863	.	C	T	13	5	18	0	1	19	0	0
16	27417415	.	C	A	2	7	9	0	0	9	0	0
16	27417573	.	T	C	12	9	21	0	2	23	0	0
16	27417659	.	T	G	17	9	26	0	1	27	0	0
16	27417925	.	A	T	14	14	28	0	0	28	0	0
16	27427064	.	A	G	9	8	17	0	0	17	0	0
16	27427760	.	G	A	7	11	18	0	1	19	0	0
16	27428048	.	G	A	12	6	18	0	0	18	0	0
16	27430189	.	G	A	11	7	18	0	0	18	0	0
16	27431597	.	G	A	8	16	24	1	1	26	0	0
16	27493437	.	C	T	2	2	4	0	0	4	0	0
16	27508505	.	G	A	5	3	8	0	0	8	0	0
16	27524890	.	A	T	5	7	12	0	0	12	0	0
16	27524893	.	A	T	5	6	11	0	1	12	0	0
16	27529856	.	G	A	7	2	9	0	0	9	0	0
16	27532506	.	C	T	0	10	10	0	2	12	0	0
16	27536796	.	C	A	0	4	4	0	2	6	0	0
16	27539462	.	G	T	3	3	6	0	1	7	0	0
16	27542452	.	C	G	2	2	4	0	1	5	0	0
16	27542489	.	C	T	3	3	6	0	0	6	0	0
16	27547540	.	A	C	1	2	3	0	0	3	0	0
16	27547545	.	A	T	1	2	3	0	0	3	0	0
16	27554909	.	C	G	12	14	26	0	1	27	0	0
16	27555010	.	T	C	19	5	24	0	2	26	0	0
16	27555011	.	A	C	19	7	26	0	0	26	0	0
16	27555069	.	C	T	26	12	38	0	1	39	0	0
16	27555221	.	C	T	21	10	31	0	0	31	0	0
16	27555395	.	G	A	12	9	21	0	0	21	0	0
16	27558676	.	C	T	5	2	7	0	0	7	0	0
16	27564387	.	C	T	2	3	5	0	0	5	0	0
16	27568431	.	T	C	1	2	3	0	0	3	0	0
16	27569746	.	C	T	3	3	6	0	0	6	0	0
16	27573661	.	C	T	1	1	2	0	1	3	0	0
16	27578193	.	A	G	3	4	7	0	0	7	0	0
16	27578391	.	T	C	3	8	11	0	0	11	0	0
16	27578538	.	C	A	6	6	12	0	1	13	0	0
16	27621786	.	A	T	10	4	14	0	1	15	0	0
16	27622109	.	G	A	2	3	5	0	0	5	0	0
16	27626240	.	A	G	27	27	54	0	0	55	1	0
16	27626566	.	G	T	22	30	52	0	5	57	0	0
16	27627051	.	T	C	32	20	52	0	2	54	0	0
16	27629038	.	C	T	1	24	25	0	17	42	0	0
16	27629343	.	A	G	23	22	45	0	1	46	0	0
16	27629365	.	G	T	20	20	40	0	0	40	0	0
16	27629639	.	C	A	19	24	43	0	0	43	0	0
16	27629798	.	A	T	26	9	35	0	1	36	0	0
16	27630174	.	A	T	22	25	47	0	1	48	0	0
16	27630207	.	C	T	23	19	42	0	2	44	0	0
16	27630302	.	A	T	22	18	40	0	1	41	0	0
16	27630552	.	G	A	23	12	35	0	0	35	0	0
16	27630663	.	G	A	15	18	33	0	1	34	0	0
16	27631229	.	A	T	15	10	25	0	1	26	0	0
16	27631585	.	T	A	12	15	27	0	1	28	0	0
16	27631690	.	T	G	13	12	25	0	0	25	0	0
16	27631695	.	T	C	13	13	26	0	0	26	0	0
16	27631741	.	C	A	16	13	29	0	0	29	0	0
16	27631751	.	T	A	15	12	27	0	2	29	0	0
16	27632153	.	C	T	8	11	19	0	3	22	0	0
16	27632189	.	G	A	13	14	27	0	1	28	0	0
16	27632228	.	C	T	13	17	30	0	0	30	0	0
16	27632520	.	A	T	14	7	21	0	0	21	0	0
16	27632814	.	G	A	8	4	12	0	1	13	0	0
16	27632934	.	T	C	10	6	16	0	0	16	0	0
16	27633002	.	G	A	8	9	17	0	1	18	0	0
16	27633180	.	C	T	2	10	12	0	11	23	0	0
16	27633812	.	C	T	11	10	21	0	0	21	0	0
16	27633839	.	T	C	11	0	11	0	10	21	0	0
16	27633950	.	G	T	10	7	17	0	0	17	0	0
16	27669917	.	T	G	7	5	12	0	1	13	0	0
16	27670010	.	A	T	2	6	8	0	0	8	0	0
16	27670032	.	T	C	7	3	10	0	0	10	0	0
16	27672033	.	A	G	4	2	6	0	0	6	0	0
16	27675950	.	G	A	3	3	6	0	1	7	0	0
16	27676008	.	G	A	3	3	6	0	0	6	0	0
16	27735389	.	A	G	2	4	6	0	0	6	0	0
16	27735648	.	A	G	1	4	5	0	0	5	0	0
16	27735663	.	T	C	4	5	9	0	0	9	0	0
16	27736007	.	T	A	1	4	5	0	0	5	0	0
16	27736247	.	G	A	1	3	4	0	0	4	0	0
16	27998807	.	G	A	1	4	5	0	0	5	0	0
16	28112772	.	G	A	2	6	8	0	0	8	0	0
16	28113049	.	G	A	9	5	14	0	0	14	0	0
16	28245545	.	G	A	12	8	20	0	0	20	0	0
16	28256800	.	G	T	8	7	15	0	0	15	0	0
16	28263526	.	G	A	3	10	13	0	0	13	0	0
16	28264350	.	C	T	5	4	9	0	0	9	0	0
16	28265687	.	T	C	7	5	12	0	0	12	0	0
16	28268273	.	C	A	4	4	8	0	0	8	0	0
16	28270067	.	G	T	0	5	5	0	2	7	0	0
16	28270118	.	C	T	4	8	12	0	0	12	0	0
16	28270443	.	T	C	8	4	12	0	1	13	0	0
16	28270561	.	C	T	7	5	12	0	1	13	0	0
16	28270695	.	G	A	3	3	6	0	0	6	0	0
16	28272554	.	T	C	9	10	19	0	1	20	0	0
16	28272555	.	G	A	9	9	18	0	2	20	0	0
16	28276389	.	C	T	13	7	20	0	0	20	0	0
16	28278360	.	T	C	2	6	8	0	1	9	0	0
16	28280057	.	T	C	6	4	10	0	0	10	0	0
16	28305482	.	G	T	6	4	10	0	0	10	0	0
16	28370872	.	T	A	5	3	8	0	0	8	0	0
16	28370943	.	A	T	5	5	10	0	0	11	1	0
16	28511709	.	C	T	1	2	3	0	1	4	0	0
16	28557842	.	A	G	1	0	1	0	4	5	0	0
16	28557889	.	G	A	3	2	5	0	1	6	0	0
16	28557909	.	G	A	0	3	3	1	2	6	0	0
16	28570615	.	A	G	5	2	7	0	0	7	0	0
16	28573328	.	G	C	0	4	4	0	8	12	0	0
16	28573665	.	C	A	9	9	18	0	1	19	0	0
16	28573871	.	A	C	9	7	16	0	0	16	0	0
16	28573928	.	C	T	5	7	12	0	0	12	0	0
16	28573957	.	T	A	5	4	9	0	0	9	0	0
16	28574531	.	T	G	10	13	23	0	1	24	0	0
16	28574664	.	G	A	2	8	10	0	0	10	0	0
16	28591186	.	T	A	14	7	21	0	0	21	0	0
16	28591277	.	A	G	5	19	24	0	1	25	0	0
16	28591312	.	G	A	2	13	15	0	11	26	0	0
16	28591353	.	A	C	12	9	21	0	1	22	0	0
16	28591385	.	C	G	7	13	20	0	0	20	0	0
16	28592758	.	A	T	6	3	9	0	0	9	0	0
16	28593394	.	G	A	4	2	6	0	1	7	0	0
16	28593430	.	G	A	8	4	12	0	1	13	0	0
16	28593679	.	T	C	6	0	6	0	3	9	0	0
16	28593705	.	C	T	4	6	10	0	1	11	0	0
16	28594086	.	T	A	7	6	13	0	0	13	0	0
16	28594102	.	G	T	7	9	16	0	0	16	0	0
16	28607658	.	T	C	2	2	4	0	0	4	0	0
16	28620694	.	T	A	2	3	5	0	0	5	0	0
16	28622321	.	G	A	1	3	4	0	2	6	0	0
16	28624580	.	T	C	2	3	5	0	0	5	0	0
16	28624646	.	C	T	8	6	14	0	0	14	0	0
16	28624648	.	G	C	1	5	6	0	8	14	0	0
16	28626282	.	G	A	2	6	8	0	0	8	0	0
16	28626629	.	G	A	0	5	5	0	3	8	0	0
16	28626997	.	C	T	4	6	10	0	0	10	0	0
16	28627005	.	C	T	5	4	9	0	0	9	0	0
16	28627127	.	C	T	3	4	7	0	0	7	0	0
16	28627198	.	T	A	4	5	9	0	0	9	0	0
16	28627341	.	T	G	7	7	14	0	1	15	0	0
16	28627342	.	T	A	7	8	15	0	0	15	0	0
16	28629299	.	C	T	1	9	10	0	2	12	0	0
16	28629504	.	C	T	8	3	11	0	1	12	0	0
16	28634954	.	G	A	7	6	13	0	0	13	0	0
16	28640907	.	G	A	3	3	6	0	0	6	0	0
16	28664708	.	G	C	2	2	4	0	0	4	0	0
16	28664970	.	T	G	7	3	10	0	0	10	0	0
16	28665912	.	G	T	4	2	6	0	0	6	0	0
16	28665925	.	C	T	4	2	6	0	0	6	0	0
16	28666161	.	G	A	1	2	3	0	0	3	0	0
16	28666168	.	C	T	1	2	3	0	0	3	0	0
16	28666202	.	C	T	0	2	2	0	1	3	0	0
16	28674282	.	G	A	1	4	5	0	0	5	0	0
16	28678327	.	T	C	3	0	3	0	2	5	0	0
16	28678847	.	G	A	1	3	4	0	1	5	0	0
16	28678868	.	G	A	1	2	3	0	1	4	0	0
16	28681496	.	G	A	3	3	6	0	0	6	0	0
16	28842438	.	C	T	25	23	48	0	2	50	0	0
16	28856026	.	G	A	26	17	43	0	2	45	0	0
16	28909020	.	C	T	1	2	3	0	0	3	0	0
16	28932204	.	C	G	2	3	5	0	0	5	0	0
16	28943162	.	T	C	1	2	3	0	0	3	0	0
16	28971711	.	G	A	1	3	4	0	0	4	0	0
16	28983644	.	G	A	2	7	9	0	2	11	0	0
16	28983897	.	G	A	5	5	10	0	1	11	0	0
16	28990523	.	C	G	3	3	6	0	0	6	0	0
16	28994776	.	C	A	3	3	6	0	1	7	0	0
16	28995628	.	A	T	5	3	8	0	2	10	0	0
16	29003349	.	C	T	5	4	9	0	0	9	0	0
16	29009092	.	G	T	6	5	11	0	0	11	0	0
16	29010125	.	C	T	7	3	10	0	0	10	0	0
16	29010155	.	T	A	3	6	9	0	2	11	0	0
16	29012933	.	G	T	1	7	8	0	7	15	0	0
16	29012961	.	C	T	11	7	18	0	0	18	0	0
16	29012992	.	A	G	11	0	11	0	6	17	0	0
16	29013039	.	C	G	7	5	12	0	1	13	0	0
16	29013126	.	C	T	8	5	13	0	0	13	0	0
16	29013134	.	C	A	8	6	14	0	0	14	0	0
16	29013188	.	C	T	6	5	11	0	0	11	0	0
16	29013377	.	C	T	10	3	13	0	0	13	0	0
16	29014091	.	A	T	4	9	13	0	2	15	0	0
16	29014109	.	T	C	5	8	13	0	0	13	0	0
16	29016659	.	C	T	8	10	18	0	0	18	0	0
16	29016904	.	T	C	13	8	21	0	0	21	0	0
16	29017221	.	T	C	7	6	13	0	0	13	0	0
16	29019039	.	G	A	18	7	25	0	1	26	0	0
16	29020482	.	G	T	14	14	28	0	0	28	0	0
16	29022955	.	C	A	3	9	12	0	0	12	0	0
16	29023266	.	A	T	7	12	19	0	0	19	0	0
16	29024181	.	A	G	8	4	12	0	0	12	0	0
16	29024280	.	T	G	6	1	7	0	7	14	0	0
16	29024341	.	T	C	4	4	8	0	1	9	0	0
16	29024512	.	A	T	7	5	12	0	1	13	0	0
16	29024551	.	A	T	6	1	7	0	1	8	0	0
16	29024552	.	T	G	6	2	8	0	0	8	0	0
16	29027161	.	C	T	3	4	7	0	1	8	0	0
16	29029444	.	G	A	5	2	7	0	0	7	0	0
16	29044453	.	G	A	3	3	6	0	0	6	0	0
16	29044488	.	T	C	1	2	3	0	0	3	0	0
16	29050827	.	C	T	4	2	6	0	0	6	0	0
16	29052030	.	C	T	1	6	7	0	0	7	0	0
16	29052096	.	G	T	0	8	8	0	1	9	0	0
16	29052120	.	A	G	1	9	10	0	1	11	0	0
16	29052137	.	A	G	0	7	7	0	1	8	0	0
16	29052156	.	A	G	1	4	5	0	0	5	0	0
16	29052245	.	G	T	1	2	3	0	0	3	0	0
16	29052279	.	C	T	2	3	5	0	0	5	0	0
16	29052293	.	A	T	2	2	4	0	0	4	0	0
16	29052653	.	A	T	3	5	8	0	0	8	0	0
16	29052914	.	G	A	4	9	13	0	0	13	0	0
16	29052991	.	C	T	5	8	13	0	0	13	0	0
16	29053045	.	T	A	4	9	13	0	0	13	0	0
16	29053534	.	A	G	3	3	6	1	0	7	0	0
16	29053798	.	C	G	3	0	3	1	15	19	0	0
16	29054122	.	G	A	6	2	8	0	0	8	0	0
16	29054129	.	T	G	7	2	9	0	0	9	0	0
16	29073621	.	T	A	5	3	8	1	0	9	0	0
16	29074254	.	G	A	28	24	52	0	2	54	0	0
16	29074459	.	T	A	11	10	21	0	2	23	0	0
16	29075137	.	C	T	11	18	29	1	0	30	0	0
16	29075195	.	A	G	16	11	27	0	3	30	0	0
16	29075222	.	T	A	15	10	25	0	0	25	0	0
16	29075305	.	G	A	21	7	28	0	1	29	0	0
16	29075343	.	G	A	8	16	24	0	0	24	0	0
16	29075347	.	C	G	16	6	22	0	1	23	0	0
16	29075674	.	C	A	22	16	38	0	0	38	0	0
16	29075870	.	G	T	13	14	27	0	0	27	0	0
16	29075959	.	C	T	12	15	27	0	2	29	0	0
16	29075962	.	C	T	17	12	29	0	1	30	0	0
16	29076270	.	G	T	20	26	46	1	7	54	0	0
16	29076407	.	C	T	0	22	22	0	19	41	0	0
16	29076471	.	G	A	15	19	34	0	1	35	0	0
16	29076575	.	C	G	3	25	28	0	17	45	0	0
16	29076633	.	G	A	21	20	41	0	1	42	0	0
16	29076669	.	A	G	23	23	46	0	0	46	0	0
16	29076678	.	T	C	23	0	23	0	24	47	0	0
16	29111066	.	T	C	9	0	9	0	16	25	0	0
16	29225676	.	C	T	2	3	5	0	0	5	0	0
16	29225873	.	C	G	7	9	16	0	0	16	0	0
16	29226129	.	A	T	5	6	11	0	0	11	0	0
16	29226151	.	C	A	4	7	11	0	0	11	0	0
16	29226241	.	A	T	1	4	5	0	0	5	0	0
16	29226538	.	G	T	6	4	10	0	0	10	0	0
16	29226588	.	A	T	2	7	9	0	1	10	0	0
16	29265958	.	A	G	8	5	13	0	0	13	0	0
16	29265992	.	A	C	8	6	14	0	1	15	0	0
16	29266014	.	G	T	8	5	13	0	0	13	0	0
16	29266042	.	G	A	10	4	14	0	0	14	0	0
16	29303976	.	C	A	3	2	5	0	0	5	0	0
16	29306111	.	C	T	3	5	8	0	0	8	0	0
16	29310150	.	T	A	8	4	12	0	0	13	1	0
16	29310455	.	C	T	17	13	30	0	0	30	0	0
16	29310530	.	C	A	26	13	39	0	0	39	0	0
16	29310541	.	A	G	25	9	34	0	1	35	0	0
16	29310760	.	C	A	14	16	30	0	0	30	0	0
16	29310893	.	G	A	17	7	24	0	1	25	0	0
16	29310917	.	G	T	21	5	26	0	0	26	0	0
16	29311381	.	G	A	12	17	29	0	1	31	1	0
16	29311493	.	A	G	26	14	40	0	1	41	0	0
16	29311720	.	T	C	12	12	24	0	2	26	0	0
16	29313828	.	T	C	13	6	19	0	3	22	0	0
16	29314147	.	C	A	17	11	28	0	2	30	0	0
16	29320647	.	A	G	13	9	22	0	2	24	0	0
16	29320674	.	T	G	18	6	24	0	0	24	0	0
16	29320870	.	T	C	8	0	8	0	8	16	0	0
16	29321013	.	G	A	15	6	21	0	0	21	0	0
16	29321269	.	C	T	10	6	16	0	1	17	0	0
16	29321290	.	C	T	12	8	20	0	0	20	0	0
16	29321310	.	C	T	12	8	20	0	1	21	0	0
16	29323307	.	T	C	15	5	20	0	1	21	0	0
16	29323394	.	T	C	9	8	17	0	0	17	0	0
16	29324828	.	T	C	10	4	14	0	2	16	0	0
16	29328509	.	G	A	8	3	11	0	1	12	0	0
16	29330456	.	A	C	3	0	3	0	5	8	0	0
16	29330481	.	G	A	4	4	8	0	0	8	0	0
16	29330493	.	A	G	5	4	9	0	0	9	0	0
16	29370064	.	G	A	1	2	3	0	0	3	0	0
16	29370972	.	A	G	2	3	5	0	0	5	0	0
16	29371164	.	A	G	3	2	5	0	0	5	0	0
16	29371187	.	T	C	2	2	4	0	0	4	0	0
16	29374075	.	A	C	6	5	11	0	0	11	0	0
16	29381076	.	A	C	4	2	6	0	1	7	0	0
16	29381204	.	G	T	2	3	5	0	1	6	0	0
16	29381369	.	G	A	1	2	3	0	0	3	0	0
16	29381391	.	T	C	2	2	4	0	0	4	0	0
16	29383844	.	C	T	5	2	7	0	0	7	0	0
16	29384090	.	T	C	1	7	8	0	0	8	0	0
16	29384139	.	G	A	3	6	9	0	0	9	0	0
16	29384182	.	C	T	3	7	10	0	0	10	0	0
16	29384187	.	T	C	3	7	10	0	0	10	0	0
16	29407754	.	C	T	4	6	10	0	0	10	0	0
16	29407791	.	C	A	14	8	22	0	0	22	0	0
16	29408024	.	A	C	24	12	36	0	0	36	0	0
16	29408926	.	A	T	22	18	40	0	2	42	0	0
16	29408948	.	T	A	13	23	36	0	1	37	0	0
16	29409134	.	A	G	5	5	10	0	2	12	0	0
16	29409181	.	T	A	4	4	8	0	0	8	0	0
16	29409341	.	T	C	23	7	30	0	1	31	0	0
16	29409361	.	T	C	29	8	37	0	2	39	0	0
16	29409476	.	T	C	34	10	44	1	3	48	0	0
16	29409480	.	T	C	33	11	44	1	4	49	0	0
16	29409544	.	T	C	23	12	35	1	0	36	0	0
16	29409571	.	A	T	14	13	27	0	0	27	0	0
16	29409646	.	T	G	20	21	41	0	2	43	0	0
16	29410425	.	A	G	26	27	53	0	1	54	0	0
16	29410520	.	A	G	9	24	33	0	0	33	0	0
16	29411209	.	G	A	21	36	57	0	2	59	0	0
16	29411830	.	T	G	3	5	8	0	3	11	0	0
16	29412264	.	T	A	2	2	4	0	0	4	0	0
16	29413193	.	C	T	2	16	18	0	28	46	0	0
16	29414004	.	A	C	10	10	20	0	1	21	0	0
16	29419266	.	T	C	13	12	25	0	0	25	0	0
16	29420803	.	T	C	8	17	25	0	1	26	0	0
16	29421026	.	C	T	8	11	19	0	0	19	0	0
16	29424985	.	T	A	18	12	30	0	0	30	0	0
16	29425278	.	G	A	10	18	28	0	1	29	0	0
16	29427615	.	T	A	12	10	22	0	0	22	0	0
16	29456052	.	A	G	4	5	9	0	0	9	0	0
16	29456131	.	T	A	4	2	6	0	1	7	0	0
16	29456519	.	G	T	2	2	4	0	0	4	0	0
16	29456630	.	A	C	1	0	1	0	7	8	0	0
16	29456655	.	C	T	8	3	11	0	0	11	0	0
16	29456966	.	G	A	3	9	12	0	1	13	0	0
16	29456996	.	A	G	4	7	11	0	0	11	0	0
16	29457158	.	A	G	6	8	14	0	1	15	0	0
16	29457473	.	T	A	10	8	18	0	0	18	0	0
16	29457819	.	C	T	1	3	4	0	1	5	0	0
16	29458226	.	C	G	3	6	9	0	0	9	0	0
16	29460996	.	C	T	3	4	7	0	0	7	0	0
16	29502383	.	T	G	3	2	5	0	0	5	0	0
16	29516162	.	C	A	3	2	5	1	0	6	0	0
16	29516163	.	C	A	3	2	5	1	0	6	0	0
16	29522025	.	G	T	1	3	4	0	3	7	0	0
16	29526432	.	C	T	1	2	3	0	0	3	0	0
16	29526822	.	C	T	3	4	7	0	0	7	0	0
16	29526886	.	C	A	1	2	3	0	0	3	0	0
16	29586680	.	A	G	11	15	26	0	0	26	0	0
16	29587278	.	T	A	7	4	11	0	1	12	0	0
16	29642184	.	T	C	15	6	21	0	1	22	0	0
16	29644223	.	C	T	8	9	17	0	3	20	0	0
16	29671259	.	G	A	1	2	3	0	0	3	0	0
16	29686304	.	A	G	1	2	3	0	0	3	0	0
16	29686355	.	G	C	3	4	7	0	0	7	0	0
16	29686370	.	G	T	4	4	8	0	1	9	0	0
16	29691334	.	G	A	2	4	6	0	0	6	0	0
16	29693871	.	A	G	3	0	3	0	3	6	0	0
16	29693999	.	A	G	4	2	6	0	1	7	0	0
16	29695845	.	T	C	2	4	6	0	0	6	0	0
16	29695989	.	G	T	2	2	4	0	0	4	0	0
16	29696018	.	A	G	3	2	5	0	0	5	0	0
16	29696626	.	T	A	5	2	7	0	0	7	0	0
16	29696627	.	C	T	4	2	6	0	1	7	0	0
16	30002867	.	G	T	2	5	7	0	0	7	0	0
16	30174474	.	A	G	1	3	4	0	0	4	0	0
16	30184648	.	C	T	5	2	7	0	0	7	0	0
16	30199947	.	A	G	8	5	13	0	1	14	0	0
16	30202951	.	T	C	3	4	7	0	0	7	0	0
16	30205225	.	T	C	4	2	6	0	0	6	0	0
16	30266844	.	G	A	9	3	12	0	2	14	0	0
16	30267228	.	A	G	18	1	19	0	12	31	0	0
16	30267841	.	T	C	6	5	11	0	1	12	0	0
16	30268145	.	C	T	8	11	19	0	4	23	0	0
16	30268242	.	T	C	7	5	12	0	1	13	0	0
16	30268290	.	G	A	5	7	12	0	0	12	0	0
16	30268475	.	A	C	8	8	16	0	0	16	0	0
16	30269159	.	A	C	11	4	15	0	0	15	0	0
16	30270332	.	G	T	1	5	6	0	12	18	0	0
16	30270381	.	T	G	12	6	18	0	1	19	0	0
16	30270601	.	C	T	17	10	27	0	1	28	0	0
16	30316181	.	T	A	1	2	3	0	0	3	0	0
16	30323168	.	T	G	1	2	3	0	0	3	0	0
16	30323212	.	T	A	1	2	3	0	0	3	0	0
16	30408725	.	A	T	1	4	5	0	0	5	0	0
16	30408765	.	T	A	0	2	2	0	1	3	0	0
16	30408786	.	A	T	1	2	3	0	0	3	0	0
16	30408917	.	A	G	13	28	41	0	1	42	0	0
16	30409055	.	A	T	22	31	53	0	2	55	0	0
16	30409313	.	A	T	29	27	56	0	0	56	0	0
16	30415027	.	C	T	25	16	41	0	2	43	0	0
16	30417511	.	A	G	20	24	44	0	0	44	0	0
16	30417977	.	A	G	20	16	36	0	2	38	0	0
16	30417986	.	A	G	21	17	38	0	1	39	0	0
16	30419504	.	A	G	16	19	35	0	0	35	0	0
16	30420547	.	C	T	13	13	26	0	1	27	0	0
16	30422582	.	C	G	14	10	24	0	0	24	0	0
16	30422807	.	T	C	9	0	9	0	10	19	0	0
16	30422891	.	G	A	15	6	21	0	0	21	0	0
16	30423297	.	A	C	1	7	8	0	1	9	0	0
16	30423313	.	C	T	1	6	7	0	0	7	0	0
16	30423339	.	T	C	1	5	6	0	0	6	0	0
16	30423348	.	T	C	1	4	5	0	0	5	0	0
16	30423511	.	T	C	1	3	4	0	0	4	0	0
16	30423521	.	T	C	1	1	2	0	0	2	0	0
16	30423680	.	G	C	3	4	7	0	1	8	0	0
16	30423953	.	G	A	15	12	27	0	2	29	0	0
16	30426496	.	T	A	9	8	17	0	0	17	0	0
16	30427042	.	A	G	7	5	12	0	1	13	0	0
16	30429159	.	A	G	7	10	17	0	0	17	0	0
16	30429384	.	G	A	7	3	10	0	0	10	0	0
16	30432287	.	A	G	7	4	11	0	0	11	0	0
16	30434127	.	A	G	1	2	3	0	1	4	0	0
16	30434156	.	C	T	2	5	7	0	0	7	0	0
16	30434215	.	T	A	9	11	20	0	0	20	0	0
16	30521704	.	A	T	2	6	8	0	1	9	0	0
16	30522108	.	T	A	2	4	6	0	0	6	0	0
16	30522109	.	T	G	2	4	6	0	0	6	0	0
16	30522176	.	G	C	7	9	16	0	0	16	0	0
16	30522317	.	G	C	3	6	9	0	0	10	1	0
16	30522334	.	C	T	4	4	8	0	1	9	0	0
16	30522471	.	T	G	0	4	4	0	2	6	0	0
16	30522494	.	T	G	1	3	4	0	0	4	0	0
16	30522688	.	A	T	1	4	5	0	0	5	0	0
16	30522724	.	T	C	1	3	4	0	0	4	0	0
16	30522809	.	C	T	1	2	3	0	1	4	0	0
16	30522923	.	C	T	0	3	3	0	5	8	0	0
16	30523253	.	C	G	5	5	10	0	0	10	0	0
16	30525458	.	A	G	4	4	8	0	1	9	0	0
16	30525499	.	A	G	5	7	12	0	0	12	0	0
16	30530401	.	C	T	5	2	7	0	1	8	0	0
16	30531304	.	C	T	3	11	14	0	0	14	0	0
16	30531358	.	T	C	3	5	8	0	0	8	0	0
16	30537612	.	G	A	3	3	6	0	0	6	0	0
16	30537749	.	C	A	5	8	13	0	0	13	0	0
16	30562816	.	T	G	3	2	5	0	1	6	0	0
16	30562958	.	C	T	1	2	3	0	0	3	0	0
16	30584024	.	G	A	1	2	3	0	0	3	0	0
16	30609849	.	C	G	1	2	3	0	2	5	0	0
16	30737594	.	A	G	15	6	21	0	1	22	0	0
16	30737638	.	C	T	9	12	21	0	2	23	0	0
16	30737770	.	A	G	18	14	32	0	0	32	0	0
16	30738108	.	C	T	2	13	15	0	10	25	0	0
16	30740719	.	T	G	6	10	16	0	2	18	0	0
16	30760879	.	A	C	14	0	14	0	13	27	0	0
16	30772417	.	C	T	2	13	15	0	9	24	0	0
16	30785451	.	T	C	13	6	19	0	2	21	0	0
16	30788182	.	A	G	4	7	11	0	0	11	0	0
16	30800501	.	G	A	8	4	12	0	0	12	0	0
16	30826525	.	A	G	9	5	14	0	0	14	0	0
16	30826614	.	A	C	9	9	18	0	1	19	0	0
16	30846517	.	G	A	3	4	7	0	1	8	0	0
16	30869623	.	A	T	7	7	14	0	0	14	0	0
16	30908529	.	G	A	1	2	3	0	0	3	0	0
16	30908705	.	G	C	5	3	8	0	0	8	0	0
16	30908825	.	A	C	2	2	4	0	0	4	0	0
16	30909346	.	C	T	2	5	7	0	1	8	0	0
16	30909367	.	A	G	1	7	8	0	0	8	0	0
16	30910272	.	A	G	3	3	6	0	0	6	0	0
16	30914543	.	C	G	3	2	5	0	0	5	0	0
16	30918883	.	C	G	1	3	4	0	0	4	0	0
16	30918951	.	A	T	1	3	4	0	1	5	0	0
16	30919291	.	T	A	3	2	5	0	0	5	0	0
16	30948583	.	A	C	1	2	3	0	0	3	0	0
16	30948902	.	G	T	2	2	4	0	0	4	0	0
16	30949188	.	A	G	1	3	4	0	1	5	0	0
16	30949239	.	C	T	1	3	4	0	0	4	0	0
16	30980501	.	G	A	3	4	7	0	0	7	0	0
16	30983131	.	C	T	0	4	4	0	1	5	0	0
16	30983137	.	T	A	1	3	4	0	0	4	0	0
16	31186631	.	A	T	16	11	27	0	2	29	0	0
16	31187097	.	C	T	0	10	10	0	9	19	0	0
16	31187322	.	A	G	9	15	24	0	4	28	0	0
16	31188654	.	G	A	4	4	8	0	0	8	0	0
16	31260754	.	G	A	5	5	10	0	1	11	0	0
16	31261003	.	A	T	3	5	8	0	4	12	0	0
16	31261213	.	C	A	0	7	7	0	8	15	0	0
16	31261344	.	C	T	9	5	14	0	0	14	0	0
16	31266548	.	G	A	4	4	8	0	3	11	0	0
16	31267559	.	C	T	1	4	5	0	4	9	0	0
16	31268860	.	G	C	6	0	6	0	7	13	0	0
16	31268893	.	C	A	9	8	17	0	0	17	0	0
16	31272424	.	C	G	17	9	26	0	0	26	0	0
16	31274289	.	T	A	5	8	13	0	0	13	0	0
16	31274491	.	G	A	4	8	12	0	0	12	0	0
16	31280355	.	G	A	7	5	12	0	0	12	0	0
16	31303616	.	T	C	5	0	5	0	7	12	0	0
16	31306646	.	A	G	2	3	5	0	0	5	0	0
16	31314157	.	G	A	10	3	13	0	0	13	0	0
16	31342344	.	C	T	9	6	15	0	1	16	0	0
16	31351268	.	A	T	8	4	12	0	1	13	0	0
16	31428751	.	C	G	9	3	12	0	1	13	0	0
16	31428813	.	T	G	12	3	15	0	0	15	0	0
16	31428861	.	C	G	7	5	12	0	0	12	0	0
16	31429409	.	A	G	4	3	7	0	0	7	0	0
16	31435660	.	G	T	1	2	3	0	0	3	0	0
16	31436182	.	T	C	1	3	4	0	0	4	0	0
16	31437115	.	A	G	19	6	25	0	1	26	0	0
16	31437955	.	A	G	26	29	55	2	3	60	0	0
16	31444428	.	G	A	18	13	31	0	2	33	0	0
16	31444843	.	A	T	24	9	33	0	0	33	0	0
16	31445516	.	T	C	12	13	25	0	2	27	0	0
16	31454274	.	T	A	4	2	6	0	0	6	0	0
16	31454495	.	G	T	2	5	7	0	0	8	1	0
16	31454548	.	A	G	4	3	7	0	0	7	0	0
16	31455092	.	T	C	4	6	10	0	0	10	0	0
16	31516398	.	A	G	6	3	9	0	1	10	0	0
16	31516536	.	T	C	5	3	8	0	0	8	0	0
16	31519146	.	G	A	1	2	3	0	0	3	0	0
16	31602170	.	A	G	4	3	7	0	0	7	0	0
16	31608012	.	A	G	10	5	15	0	0	15	0	0
16	31608101	.	C	T	0	6	6	0	4	10	0	0
16	31608967	.	G	T	4	8	12	0	0	12	0	0
16	31609241	.	C	T	0	10	10	0	5	15	0	0
16	31610375	.	C	T	5	4	9	0	1	10	0	0
16	31613619	.	A	G	6	4	10	0	0	10	0	0
16	31614272	.	C	G	4	8	12	0	2	14	0	0
16	31615114	.	G	A	5	5	10	0	1	11	0	0
16	31627155	.	C	T	1	2	3	0	0	3	0	0
16	31627167	.	A	G	1	2	3	0	1	4	0	0
16	31717646	.	G	A	6	5	11	0	0	11	0	0
16	31723863	.	T	C	3	6	9	0	1	10	0	0
16	31728192	.	A	G	5	3	8	0	0	8	0	0
16	31762960	.	C	T	15	13	28	0	1	29	0	0
16	31763316	.	T	C	17	14	31	0	2	33	0	0
16	31763318	.	C	T	18	14	32	0	1	33	0	0
16	31763668	.	C	G	11	17	28	0	3	31	0	0
16	31763743	.	T	A	19	18	37	0	0	37	0	0
16	31763751	.	A	C	20	20	40	0	2	42	0	0
16	31763785	.	G	A	26	12	38	0	1	39	0	0
16	31763786	.	C	A	26	13	39	0	0	39	0	0
16	31763880	.	A	G	15	22	37	0	1	38	0	0
16	31764987	.	C	T	15	10	25	0	1	26	0	0
16	31766937	.	T	A	14	5	19	0	0	19	0	0
16	31767116	.	T	C	10	1	11	0	15	26	0	0
16	31767152	.	A	G	17	15	32	0	1	33	0	0
16	31767163	.	G	A	18	15	33	0	2	35	0	0
16	31767191	.	T	C	17	15	32	0	2	34	0	0
16	31768343	.	C	G	14	13	27	0	0	27	0	0
16	31768394	.	T	C	16	11	27	0	1	28	0	0
16	31768436	.	T	C	22	16	38	0	2	40	0	0
16	31769317	.	G	A	15	15	30	0	2	32	0	0
16	31769395	.	A	G	16	12	28	0	1	29	0	0
16	31769428	.	G	A	12	15	27	0	0	27	0	0
16	31770050	.	T	C	9	0	9	0	7	16	0	0
16	31776125	.	C	T	10	7	17	0	2	19	0	0
16	31780108	.	C	T	0	7	7	0	5	12	0	0
16	31782938	.	C	T	6	4	10	0	1	11	0	0
16	31789327	.	C	T	4	5	9	0	0	9	0	0
16	31790262	.	C	T	15	5	20	0	0	20	0	0
16	31815638	.	C	T	16	11	27	0	0	27	0	0
16	31815878	.	G	A	13	11	24	0	0	24	0	0
16	31816005	.	C	A	9	11	20	0	2	22	0	0
16	31816205	.	C	T	14	1	15	0	0	15	0	0
16	31816336	.	C	T	0	11	11	0	4	15	0	0
16	31816596	.	C	T	15	19	34	0	0	34	0	0
16	31827642	.	T	A	25	12	37	0	0	37	0	0
16	31827703	.	C	T	27	15	42	0	3	45	0	0
16	31832606	.	A	G	23	0	23	0	36	59	0	0
16	31835692	.	G	T	1	2	3	0	0	3	0	0
16	31836146	.	G	A	1	2	3	0	0	3	0	0
16	31853932	.	T	A	10	10	20	0	1	21	0	0
16	31854325	.	C	A	11	6	17	0	1	18	0	0
16	31855327	.	G	A	5	8	13	0	1	14	0	0
16	31855351	.	G	C	9	6	15	0	0	15	0	0
16	31855575	.	C	T	12	11	23	0	2	25	0	0
16	31855576	.	C	T	13	11	24	0	0	24	0	0
16	31856239	.	A	G	5	2	7	0	0	7	0	0
16	31856276	.	G	A	0	6	6	0	9	15	0	0
16	31859227	.	T	C	14	23	37	0	3	40	0	0
16	31859310	.	A	G	27	16	43	0	2	45	0	0
16	31859341	.	C	T	23	27	50	0	2	52	0	0
16	31859371	.	T	C	18	27	45	0	2	47	0	0
16	31859416	.	T	C	7	33	40	0	7	47	0	0
16	31859425	.	C	T	3	35	38	0	4	42	0	0
16	31859536	.	A	C	10	4	14	0	16	30	0	0
16	31859541	.	T	C	10	2	12	0	19	32	1	0
16	31859686	.	G	A	8	11	19	0	0	19	0	0
16	31868443	.	G	A	16	15	31	0	1	32	0	0
16	31922892	.	A	G	36	27	63	1	3	67	0	0
16	31923083	.	G	A	37	32	69	0	4	73	0	0
16	31923435	.	A	G	35	30	65	0	0	65	0	0
16	31924485	.	T	C	31	26	57	0	1	58	0	0
16	31924501	.	A	C	28	21	49	0	5	54	0	0
16	31924836	.	A	T	1	2	3	0	0	3	0	0
16	31925727	.	G	A	4	3	7	0	0	7	0	0
16	31926853	.	A	G	3	3	6	0	0	6	0	0
16	31927369	.	C	A	3	2	5	0	1	6	0	0
16	31928878	.	T	C	4	2	6	1	0	7	0	0
16	31942728	.	C	A	2	2	4	0	0	4	0	0
16	31942734	.	C	G	2	2	4	0	0	4	0	0
16	31951694	.	G	C	1	2	3	0	0	3	0	0
16	31952252	.	G	C	4	2	6	0	0	6	0	0
16	31955226	.	C	G	3	2	5	0	0	5	0	0
16	31959098	.	G	A	0	2	2	0	1	3	0	0
16	31959156	.	G	A	2	4	6	0	0	6	0	0
16	31959225	.	G	A	3	3	6	0	0	6	0	0
16	31959231	.	A	T	4	3	7	0	0	7	0	0
16	31959428	.	C	T	4	4	8	0	1	9	0	0
16	31959612	.	G	A	2	3	5	0	0	5	0	0
16	31959845	.	A	G	2	0	2	0	5	7	0	0
16	31960037	.	G	A	1	3	4	0	4	8	0	0
16	31960064	.	G	C	6	7	13	0	0	13	0	0
16	31960145	.	C	T	8	6	14	0	1	15	0	0
16	31960152	.	C	T	7	5	12	0	3	15	0	0
16	32009736	.	A	T	2	6	8	0	1	9	0	0
16	32011649	.	C	T	9	16	25	0	1	26	0	0
16	32011673	.	A	G	9	9	18	0	0	18	0	0
16	32013272	.	G	A	8	6	14	0	0	14	0	0
16	32013766	.	T	G	4	3	7	0	0	7	0	0
16	32013861	.	G	A	5	3	8	0	0	8	0	0
16	32013891	.	G	A	4	3	7	0	0	7	0	0
16	32014627	.	T	A	2	5	7	0	1	8	0	0
16	32014633	.	A	T	3	6	9	0	0	9	0	0
16	32018590	.	C	T	6	5	11	0	0	11	0	0
16	32019695	.	G	A	4	4	8	0	0	8	0	0
16	32021999	.	C	T	5	3	8	0	0	8	0	0
16	32023124	.	T	A	4	5	9	0	2	11	0	0
16	32025648	.	T	A	11	9	20	0	0	20	0	0
16	32025978	.	G	A	14	7	21	0	0	21	0	0
16	32025987	.	T	A	13	9	22	0	0	22	0	0
16	32026063	.	G	A	1	6	7	2	9	18	0	0
16	32026203	.	C	T	1	4	5	0	0	5	0	0
16	32026206	.	A	G	1	4	5	0	0	5	0	0
16	32051854	.	A	C	8	8	16	0	1	17	0	0
16	32052004	.	T	G	10	10	20	0	1	21	0	0
16	32052283	.	T	A	6	8	14	0	5	19	0	0
16	32052307	.	T	C	6	10	16	0	1	17	0	0
16	32052328	.	T	A	7	8	15	0	0	15	0	0
16	32052404	.	G	T	4	5	9	0	5	14	0	0
16	32055726	.	T	G	8	13	21	0	0	21	0	0
16	32057809	.	T	C	4	5	9	0	0	9	0	0
16	32057853	.	G	A	0	4	4	0	8	12	0	0
16	32060021	.	G	A	1	6	7	0	18	25	0	0
16	32060121	.	G	T	8	10	18	0	0	18	0	0
16	32060130	.	C	A	8	8	16	0	0	16	0	0
16	32063433	.	C	T	8	10	18	0	0	18	0	0
16	32066465	.	T	C	4	2	6	0	0	6	0	0
16	32067316	.	A	C	4	8	12	0	0	12	0	0
16	32068332	.	G	A	8	13	21	0	2	23	0	0
16	32068452	.	C	A	6	4	10	0	1	11	0	0
16	32068503	.	T	C	7	9	16	0	3	19	0	0
16	32068824	.	G	C	9	6	15	0	2	17	0	0
16	32069310	.	T	A	16	11	27	0	5	32	0	0
16	32069653	.	A	G	13	10	23	0	2	25	0	0
16	32070489	.	A	G	14	0	14	0	8	22	0	0
16	32070570	.	C	T	14	12	26	0	2	28	0	0
16	32070981	.	G	C	13	19	32	0	1	33	0	0
16	32071965	.	G	C	10	9	19	0	1	20	0	0
16	32071997	.	C	A	7	13	20	0	1	21	0	0
16	32072334	.	A	G	8	16	24	0	2	26	0	0
16	32073301	.	A	C	15	19	34	0	0	34	0	0
16	32073507	.	A	C	21	22	43	0	0	43	0	0
16	32073555	.	A	G	22	25	47	0	1	48	0	0
16	32073760	.	G	A	23	16	39	0	4	43	0	0
16	32074041	.	G	A	25	15	40	0	2	42	0	0
16	32074257	.	A	G	29	1	30	0	17	47	0	0
16	32074293	.	T	A	28	19	47	0	1	48	0	0
16	32074294	.	A	G	28	19	47	0	2	49	0	0
16	32080069	.	G	T	1	6	7	0	13	20	0	0
16	32080099	.	G	A	8	2	10	0	1	11	0	0
16	32080196	.	T	C	2	6	8	0	0	8	0	0
16	32080206	.	T	C	1	6	7	0	1	8	0	0
16	32080306	.	T	A	8	6	14	0	1	15	0	0
16	32080508	.	T	A	11	12	23	0	1	24	0	0
16	32080738	.	G	A	4	3	7	0	0	7	0	0
16	32082397	.	T	C	10	11	21	0	0	21	0	0
16	32082589	.	G	A	4	8	12	0	0	12	0	0
16	32082597	.	G	A	5	8	13	0	0	13	0	0
16	32082642	.	G	A	6	3	9	0	2	11	0	0
16	32085319	.	T	A	5	5	10	0	2	12	0	0
16	32085631	.	A	G	4	7	11	0	0	11	0	0
16	32085778	.	A	C	4	4	8	0	0	8	0	0
16	32086136	.	C	T	7	7	14	0	0	14	0	0
16	32088580	.	T	A	8	9	17	0	1	18	0	0
16	32090349	.	C	T	17	5	22	0	0	22	0	0
16	32090425	.	G	C	10	6	16	1	1	18	0	0
16	32110659	.	A	G	5	18	23	0	0	23	0	0
16	32110766	.	T	A	17	5	22	1	1	24	0	0
16	32111246	.	G	T	8	20	28	0	1	29	0	0
16	32113155	.	G	A	15	12	27	0	1	28	0	0
16	32113218	.	G	A	11	4	15	0	2	17	0	0
16	32116790	.	A	T	15	11	26	0	0	26	0	0
16	32117345	.	T	A	10	10	20	0	9	29	0	0
16	32119581	.	C	A	6	8	14	0	1	15	0	0
16	32119618	.	C	T	5	4	9	0	0	9	0	0
16	32119895	.	G	T	7	13	20	0	1	21	0	0
16	32120138	.	G	T	8	7	15	0	4	19	0	0
16	32120141	.	T	C	7	0	7	0	11	18	0	0
16	32120173	.	G	A	11	11	22	0	0	22	0	0
16	32120204	.	G	T	11	9	20	0	2	22	0	0
16	32120279	.	A	C	10	13	23	0	1	24	0	0
16	32131692	.	T	G	2	3	5	0	0	5	0	0
16	32140638	.	G	C	1	4	5	0	0	5	0	0
16	32140977	.	C	T	1	5	6	0	0	6	0	0
16	32140999	.	A	G	1	3	4	0	0	4	0	0
16	32141036	.	G	A	4	2	6	0	0	6	0	0
16	32141058	.	A	G	5	2	7	0	0	7	0	0
16	32141075	.	G	A	6	2	8	0	0	8	0	0
16	32141544	.	A	G	10	0	10	0	11	21	0	0
16	32141565	.	A	C	9	7	16	0	1	17	0	0
16	32141604	.	A	T	9	6	15	0	0	15	0	0
16	32144337	.	T	C	11	6	17	0	0	17	0	0
16	32144377	.	T	C	6	3	9	0	0	9	0	0
16	32144854	.	G	T	0	8	8	0	2	10	0	0
16	32144989	.	T	C	6	2	8	0	1	9	0	0
16	32145547	.	T	C	2	2	4	0	1	5	0	0
16	32145636	.	A	G	5	7	12	0	0	12	0	0
16	32184563	.	T	C	2	2	4	0	0	4	0	0
16	32197969	.	C	T	18	13	31	0	2	33	0	0
16	32252878	.	A	G	2	5	7	0	0	7	0	0
16	32257179	.	T	A	4	3	7	0	0	7	0	0
16	32267128	.	G	A	10	5	15	0	1	16	0	0
16	32267203	.	G	A	1	7	8	0	8	16	0	0
16	32273066	.	G	T	3	4	7	0	1	8	0	0
16	32273192	.	G	A	1	8	9	0	5	14	0	0
16	32274935	.	G	A	5	11	16	1	0	17	0	0
16	32275601	.	T	A	3	4	7	0	0	7	0	0
16	32275628	.	A	T	4	3	7	0	1	8	0	0
16	32289737	.	G	A	1	2	3	0	0	3	0	0
16	32561618	.	T	C	3	4	7	0	0	7	0	0
16	33027082	.	C	T	21	5	26	0	0	26	0	0
16	33735481	.	G	A	5	7	12	0	0	12	0	0
16	33735503	.	C	T	9	6	15	0	0	15	0	0
16	33735849	.	A	T	1	1	2	1	1	4	0	0
16	33736196	.	A	C	1	5	6	0	0	6	0	0
16	33905018	.	C	T	1	2	3	0	2	5	0	0
16	33909384	.	G	A	0	3	3	0	2	5	0	0
16	33910029	.	C	T	2	2	4	0	0	4	0	0
16	33910305	.	G	A	5	2	7	0	1	8	0	0
16	33915011	.	C	T	2	5	7	0	0	7	0	0
16	33919623	.	G	A	1	5	6	0	0	6	0	0
16	33923448	.	G	T	4	6	10	1	1	12	0	0
16	33923514	.	G	A	8	10	18	0	0	18	0	0
16	33925132	.	G	C	3	13	16	0	1	17	0	0
16	33925356	.	G	A	2	4	6	0	3	9	0	0
16	33925565	.	T	G	3	5	8	0	0	8	0	0
16	33925789	.	G	A	3	3	6	0	0	6	0	0
16	33926074	.	C	T	4	4	8	0	0	8	0	0
16	33928015	.	G	A	2	5	7	0	0	7	0	0
16	33933213	.	C	T	15	6	21	0	0	21	0	0
16	33933496	.	G	C	4	2	6	0	0	6	0	0
16	33933498	.	C	T	2	4	6	0	0	6	0	0
16	33933732	.	G	A	1	10	11	0	4	15	0	0
16	33939824	.	T	C	5	7	12	0	0	12	0	0
16	33939859	.	C	T	4	4	8	0	0	8	0	0
16	33940098	.	G	A	2	3	5	0	0	5	0	0
16	33940364	.	A	G	9	0	9	0	8	17	0	0
16	33940379	.	T	A	9	7	16	0	1	17	0	0
16	33953968	.	C	T	8	13	21	0	1	22	0	0
16	33964788	.	G	T	3	2	5	0	2	7	0	0
16	33971993	.	G	A	1	6	7	0	9	16	0	0
16	33972008	.	G	A	10	8	18	0	0	18	0	0
16	33972037	.	A	C	8	12	20	0	2	22	0	0
16	33972067	.	A	G	9	10	19	0	2	21	0	0
16	33972193	.	G	A	2	5	7	2	13	22	0	0
16	33972242	.	G	T	14	6	20	4	1	25	0	0
16	33972249	.	C	T	11	7	18	3	0	21	0	0
16	33972454	.	C	T	8	9	17	0	0	17	0	0
16	33978019	.	A	G	8	1	9	0	2	11	0	0
16	33979746	.	A	T	10	5	15	0	0	15	0	0
16	33981439	.	C	T	6	8	14	0	1	15	0	0
16	33981873	.	A	G	5	0	5	0	10	15	0	0
16	33983784	.	T	G	9	5	14	0	0	14	0	0
16	33983904	.	C	T	6	7	13	0	1	14	0	0
16	33984178	.	C	T	6	8	14	0	2	16	0	0
16	33984190	.	C	T	7	7	14	0	2	16	0	0
16	33985050	.	G	T	0	12	12	0	13	25	0	0
16	33985362	.	C	T	15	17	32	0	2	34	0	0
16	33986179	.	A	T	14	12	26	0	2	28	0	0
16	33986452	.	T	G	18	20	38	0	4	42	0	0
16	33988021	.	C	T	1	3	4	0	0	4	0	0
16	33988049	.	T	C	1	3	4	0	0	4	0	0
16	33988069	.	C	A	1	5	6	0	0	6	0	0
16	33989606	.	G	T	0	3	3	0	1	4	0	0
16	33989933	.	G	A	0	2	2	0	2	4	0	0
16	33994640	.	G	A	1	5	6	0	6	12	0	0
16	33995754	.	G	A	0	4	4	0	6	10	0	0
16	33996739	.	C	T	3	6	9	0	0	9	0	0
16	34004562	.	G	A	1	9	10	0	11	21	0	0
16	34004595	.	T	C	11	13	24	0	0	24	0	0
16	34004862	.	C	T	4	10	14	0	1	15	0	0
16	34005290	.	C	T	7	6	13	0	0	13	0	0
16	34005415	.	C	T	9	6	15	0	0	15	0	0
16	34005500	.	C	A	5	3	8	0	0	8	0	0
16	34005577	.	A	G	12	3	15	0	2	17	0	0
16	34005669	.	C	T	6	7	13	0	0	13	0	0
16	34005686	.	C	T	10	7	17	0	0	17	0	0
16	34005812	.	T	A	12	2	14	0	0	14	0	0
16	34005845	.	A	G	4	4	8	0	1	9	0	0
16	34006020	.	G	C	2	2	4	0	0	4	0	0
16	34006051	.	G	A	2	2	4	0	0	4	0	0
16	34053917	.	A	G	4	3	7	0	0	7	0	0
16	34054141	.	A	G	3	3	6	0	0	6	0	0
16	34054171	.	A	G	3	2	5	0	0	5	0	0
16	34054345	.	A	G	2	0	2	0	6	8	0	0
16	34054464	.	C	A	4	4	8	0	0	8	0	0
16	34054712	.	T	G	3	0	3	0	4	7	0	0
16	34054778	.	G	A	2	3	5	0	0	5	0	0
16	34054786	.	T	G	2	4	6	0	1	7	0	0
16	34055747	.	A	T	1	2	3	0	1	4	0	0
16	34055754	.	C	T	2	3	5	0	0	5	0	0
16	34055788	.	T	C	2	2	4	0	0	4	0	0
16	34055965	.	A	T	2	2	4	0	1	5	0	0
16	34055966	.	T	G	2	2	4	0	1	5	0	0
16	34056324	.	T	G	2	3	5	0	1	6	0	0
16	34160860	.	T	G	4	4	8	0	0	8	0	0
16	34172916	.	G	A	4	6	10	0	0	10	0	0
16	34173000	.	T	C	6	6	12	0	0	12	0	0
16	34173331	.	G	A	3	4	7	0	0	7	0	0
16	34173624	.	G	A	4	4	8	0	0	8	0	0
16	34173821	.	G	A	5	2	7	0	0	7	0	0
16	34173834	.	C	T	3	3	6	0	0	6	0	0
16	34173954	.	G	T	2	2	4	0	0	4	0	0
16	34185709	.	A	C	7	4	11	0	0	11	0	0
16	34185906	.	A	T	9	4	13	0	2	15	0	0
16	34193926	.	C	T	2	3	5	0	1	6	0	0
16	34193984	.	A	G	1	2	3	0	2	5	0	0
16	34194826	.	A	G	2	3	5	0	0	5	0	0
16	34200704	.	C	T	21	16	37	0	2	39	0	0
16	34201023	.	A	G	10	18	28	0	1	29	0	0
16	34208582	.	T	C	14	1	15	0	13	28	0	0
16	34208696	.	A	G	19	18	37	0	2	39	0	0
16	34212477	.	A	G	8	8	16	0	0	16	0	0
16	34212516	.	A	G	12	11	23	0	0	23	0	0
16	34212565	.	G	A	19	15	34	0	1	35	0	0
16	34212567	.	G	C	18	14	32	0	1	33	0	0
16	34212630	.	T	C	28	3	31	0	22	53	0	0
16	34212676	.	G	C	13	3	16	0	13	29	0	0
16	34212711	.	T	G	2	6	8	0	15	23	0	0
16	34222439	.	T	G	15	11	26	0	3	29	0	0
16	34225173	.	T	C	22	13	35	0	1	36	0	0
16	34225392	.	A	G	13	17	30	0	0	30	0	0
16	34225472	.	G	A	22	14	36	0	1	37	0	0
16	34267938	.	C	T	0	7	7	0	12	19	0	0
16	34267991	.	G	C	5	7	12	0	1	13	0	0
16	34302339	.	C	T	0	2	2	0	1	3	0	0
16	34321568	.	A	T	8	8	16	0	0	17	1	0
16	34322036	.	G	T	8	6	14	0	1	15	0	0
16	34322346	.	G	A	16	15	31	0	0	31	0	0
16	34322372	.	C	T	3	16	19	0	16	35	0	0
16	34331489	.	A	G	4	13	17	0	3	20	0	0
16	34337976	.	A	T	16	11	27	0	1	28	0	0
16	34338475	.	A	G	12	13	25	0	1	26	0	0
16	34339168	.	A	C	13	13	26	0	0	26	0	0
16	34339432	.	A	T	16	7	23	0	2	25	0	0
16	34339693	.	C	T	11	10	21	0	1	22	0	0
16	34339808	.	A	G	12	9	21	0	0	21	0	0
16	34339857	.	T	G	11	7	18	0	0	18	0	0
16	34340179	.	A	T	7	12	19	0	2	21	0	0
16	34340311	.	T	C	10	0	10	0	11	21	0	0
16	34340397	.	A	C	7	11	18	0	1	19	0	0
16	34340520	.	G	T	8	9	17	0	2	19	0	0
16	34340538	.	C	T	11	8	19	0	1	20	0	0
16	34340965	.	C	T	6	3	9	0	0	9	0	0
16	34340967	.	A	G	6	3	9	0	0	9	0	0
16	34341012	.	C	T	5	10	15	0	0	15	0	0
16	34341021	.	C	T	4	11	15	0	1	16	0	0
16	34341080	.	T	C	5	8	13	0	2	15	0	0
16	34342182	.	T	C	5	13	18	0	2	20	0	0
16	34342541	.	C	T	5	5	10	0	2	12	0	0
16	34342542	.	A	G	5	6	11	0	1	12	0	0
16	34461347	.	A	T	3	2	5	0	0	5	0	0
16	34497550	.	T	C	5	4	9	0	1	10	0	0
16	34498320	.	A	T	1	4	5	0	0	5	0	0
16	34499701	.	G	A	0	5	5	0	2	7	0	0
16	34499892	.	A	C	2	2	4	0	0	4	0	0
16	34499940	.	A	G	5	4	9	0	0	9	0	0
16	34500283	.	A	G	4	2	6	0	0	6	0	0
16	34500542	.	G	C	8	8	16	0	1	17	0	0
16	34500589	.	G	C	1	5	6	2	0	8	0	0
16	34500899	.	G	A	15	8	23	0	0	23	0	0
16	34501348	.	C	T	6	6	12	1	0	13	0	0
16	34501380	.	C	T	5	7	12	1	1	14	0	0
16	34501496	.	G	A	2	7	9	0	10	19	0	0
16	34525621	.	C	A	48	41	89	0	6	95	0	0
16	34526092	.	C	G	41	26	67	0	1	68	0	0
16	34526093	.	A	C	33	25	58	0	10	68	0	0
16	34526795	.	A	T	30	36	66	0	1	67	0	0
16	34526926	.	A	T	27	31	58	0	17	75	0	0
16	34532040	.	C	T	11	5	16	0	3	19	0	0
16	34532205	.	G	A	2	18	20	0	12	32	0	0
16	34532782	.	C	G	5	11	16	0	1	17	0	0
16	34532843	.	T	C	12	5	17	0	0	17	0	0
16	34930635	.	A	G	9	16	25	0	1	26	0	0
16	34930719	.	C	T	0	12	12	0	11	23	0	0
16	34948262	.	C	T	10	11	21	0	2	23	0	0
16	34953166	.	C	T	11	11	22	0	1	23	0	0
16	34975908	.	A	G	12	22	34	0	1	35	0	0
16	34989800	.	C	T	0	10	10	0	8	18	0	0
16	34993814	.	T	C	11	0	11	0	7	18	0	0
16	35022679	.	G	A	11	13	24	0	0	24	0	0
16	35023920	.	C	T	5	2	7	0	2	9	0	0
16	35023934	.	T	C	5	4	9	0	0	9	0	0
16	35023967	.	T	A	3	2	5	0	1	6	0	0
16	35043863	.	C	T	6	10	16	1	1	18	0	0
16	35053907	.	C	G	4	4	8	0	1	9	0	0
16	35353949	.	A	C	1	3	4	0	0	4	0	0
16	35354005	.	A	C	2	2	4	0	0	4	0	0
16	35367140	.	C	G	4	3	7	0	0	7	0	0
16	35367144	.	C	T	3	4	7	0	0	7	0	0
16	35372069	.	C	T	6	4	10	0	0	10	0	0
16	35376598	.	G	T	6	3	9	0	1	10	0	0
16	35376825	.	C	T	5	11	16	0	0	16	0	0
16	35376902	.	A	T	2	3	5	0	2	7	0	0
16	35409483	.	C	T	1	19	20	1	16	37	0	0
16	35409783	.	G	A	19	14	33	0	2	35	0	0
16	35414455	.	A	G	21	11	32	0	0	32	0	0
16	35414470	.	T	C	20	14	34	0	0	34	0	0
16	35414991	.	C	T	10	21	31	0	0	31	0	0
16	35416113	.	A	G	21	13	34	0	0	34	0	0
16	35416158	.	C	T	17	20	37	0	0	37	0	0
16	35416786	.	A	G	19	11	30	0	0	30	0	0
16	35418744	.	T	C	17	0	17	0	19	36	0	0
16	35420600	.	T	C	20	0	20	0	19	39	0	0
16	35423585	.	C	T	1	9	10	0	12	22	0	0
16	35426998	.	T	C	9	0	9	0	18	27	0	0
16	35536574	.	C	A	11	11	22	0	3	25	0	0
16	35536576	.	G	A	3	13	16	0	11	27	0	0
16	35536848	.	G	A	7	9	16	0	3	19	0	0
16	35536900	.	A	G	11	7	18	0	1	19	0	0
16	35536960	.	T	C	10	5	15	1	0	16	0	0
16	35536990	.	C	T	5	11	16	1	0	17	0	0
16	35537153	.	G	A	12	9	21	0	0	21	0	0
16	35537270	.	C	A	16	9	25	0	1	26	0	0
16	35556303	.	C	T	5	4	9	0	0	9	0	0
16	35562804	.	A	G	2	9	11	0	0	11	0	0
16	35563494	.	T	C	3	0	3	0	3	6	0	0
16	35563507	.	G	A	3	4	7	0	0	7	0	0
16	35569142	.	G	A	4	3	7	0	0	7	0	0
16	35661979	.	A	G	7	9	16	0	1	17	0	0
16	35662078	.	T	G	5	6	11	0	0	11	0	0
16	35662132	.	A	C	6	8	14	0	1	15	0	0
16	35718538	.	A	G	3	7	10	0	2	12	0	0
16	35743849	.	A	T	9	7	16	0	0	16	0	0
16	35750714	.	T	A	14	18	32	0	2	34	0	0
16	35752670	.	C	T	14	14	28	0	2	30	0	0
16	35752785	.	T	C	18	10	28	0	2	30	0	0
16	35762009	.	C	A	10	8	18	0	2	20	0	0
16	35762010	.	A	C	10	9	19	0	1	20	0	0
16	35764580	.	C	T	12	9	21	0	1	22	0	0
16	35773005	.	A	G	6	7	13	0	0	13	0	0
16	35944980	.	C	G	1	1	2	0	0	2	0	0
16	35944987	.	C	A	2	2	4	0	0	4	0	0
16	36041247	.	G	A	9	18	27	0	1	28	0	0
16	36062265	.	T	C	4	0	4	0	4	8	0	0
16	36075471	.	G	A	9	5	14	0	1	15	0	0
16	36075478	.	T	A	6	6	12	0	0	12	0	0
16	36075677	.	C	A	9	7	16	0	0	16	0	0
16	36076082	.	G	A	7	8	15	0	0	15	0	0
16	36080364	.	C	T	9	14	23	0	0	23	0	0
16	36080376	.	A	C	5	17	22	0	2	24	0	0
16	36087550	.	A	C	6	0	6	0	11	17	0	0
16	36118070	.	T	C	5	0	5	0	9	14	0	0
16	36118166	.	T	C	5	1	6	0	7	13	0	0
16	36150707	.	C	T	14	8	22	0	3	25	0	0
16	36150949	.	C	T	21	18	39	0	3	42	0	0
16	36150964	.	C	T	25	20	45	0	1	46	0	0
16	36151000	.	C	A	15	22	37	0	1	38	0	0
16	36159928	.	T	C	20	19	39	0	1	40	0	0
16	36162013	.	C	T	13	19	32	0	1	33	0	0
16	36162201	.	A	G	8	4	12	0	0	12	0	0
16	36162584	.	G	C	0	8	8	0	7	15	0	0
16	36162650	.	T	C	14	11	25	0	1	26	0	0
16	36162727	.	A	G	15	5	20	0	0	20	0	0
16	36162754	.	A	G	13	11	24	0	0	24	0	0
16	36162938	.	G	T	9	5	14	0	0	14	0	0
16	36163005	.	G	A	10	5	15	0	0	15	0	0
16	36163006	.	A	C	10	5	15	0	0	15	0	0
16	36168251	.	C	T	5	4	9	0	0	9	0	0
16	36168317	.	G	C	7	4	11	0	0	11	0	0
16	36168416	.	T	C	7	4	11	0	2	13	0	0
16	36168450	.	A	T	6	5	11	0	1	12	0	0
16	36168510	.	A	T	5	7	12	0	3	15	0	0
16	36168575	.	T	G	8	3	11	0	2	13	0	0
16	36168787	.	T	A	4	2	6	0	0	6	0	0
16	36168994	.	C	T	2	3	5	0	0	5	0	0
16	36169007	.	T	C	5	3	8	0	0	8	0	0
16	36169057	.	T	G	7	6	13	0	3	16	0	0
16	36169150	.	T	C	9	5	14	0	0	14	0	0
16	36169568	.	G	T	4	6	10	0	0	10	0	0
16	36171552	.	A	G	6	4	10	0	0	10	0	0
16	36172961	.	A	G	5	9	14	0	0	14	0	0
16	36172982	.	C	T	3	11	14	0	0	14	0	0
16	36173406	.	A	T	5	5	10	0	0	10	0	0
16	36180540	.	G	A	4	5	9	0	1	10	0	0
16	36180591	.	A	G	2	6	8	0	0	8	0	0
16	36180753	.	A	G	5	2	7	0	0	7	0	0
16	36180810	.	T	A	1	3	4	0	0	4	0	0
16	36183047	.	A	G	6	4	10	0	0	10	0	0
16	36184666	.	T	C	2	0	2	0	3	5	0	0
16	36185315	.	G	A	2	4	6	0	0	6	0	0
16	36195921	.	C	T	2	2	4	0	0	4	0	0
16	36196411	.	T	C	4	2	6	0	0	6	0	0
16	36718873	.	T	C	1	2	3	0	0	3	0	0
16	36721560	.	A	T	2	9	11	0	2	13	0	0
16	36721589	.	T	G	2	11	13	0	0	13	0	0
16	36724010	.	C	G	2	14	16	1	14	31	0	0
16	36729322	.	A	T	5	7	12	0	4	16	0	0
16	36729352	.	G	T	5	9	14	0	2	16	0	0
16	36729373	.	A	G	6	12	18	0	0	18	0	0
16	36731307	.	A	G	7	7	14	0	1	15	0	0
16	36735751	.	T	C	9	10	19	0	0	19	0	0
16	36735760	.	T	C	6	0	6	0	9	15	0	0
16	36743328	.	G	A	5	4	9	0	1	10	0	0
16	36743351	.	G	A	5	2	7	0	0	7	0	0
16	36743757	.	T	C	4	4	8	0	0	8	0	0
16	36743787	.	A	G	2	4	6	0	0	6	0	0
16	36745973	.	C	T	1	7	8	0	6	14	0	0
16	36746103	.	C	T	4	4	8	0	0	8	0	0
16	36746466	.	G	A	1	5	6	0	0	6	0	0
16	36746484	.	A	G	3	4	7	0	0	7	0	0
16	36748214	.	T	G	2	6	8	0	1	9	0	0
16	36748366	.	T	C	6	0	6	0	6	12	0	0
16	36752254	.	A	G	1	6	7	0	0	7	0	0
16	36752278	.	T	C	3	6	9	0	1	10	0	0
16	36759756	.	A	G	2	4	6	0	0	6	0	0
16	36759763	.	G	T	2	3	5	0	1	6	0	0
16	36759834	.	T	C	2	2	4	0	0	4	0	0
16	36759908	.	A	T	4	2	6	0	0	6	0	0
16	36759937	.	A	G	6	3	9	0	0	9	0	0
16	36759999	.	C	A	4	2	6	0	1	7	0	0
16	36760007	.	G	A	6	2	8	0	0	8	0	0
16	36766180	.	T	G	20	13	33	2	1	36	0	0
16	36766467	.	G	T	11	9	20	0	2	22	0	0
16	36906757	.	A	G	5	4	9	0	0	9	0	0
16	36906805	.	C	T	5	3	8	0	0	8	0	0
16	36908492	.	A	G	1	0	1	0	3	4	0	0
16	36908630	.	C	T	6	3	9	0	1	10	0	0
16	36908844	.	C	A	5	4	9	0	1	10	0	0
16	36911214	.	C	A	5	7	12	0	0	12	0	0
16	36911257	.	A	G	11	1	12	0	7	19	0	0
16	36914935	.	T	C	7	4	11	0	1	12	0	0
16	36918992	.	G	A	5	8	13	0	0	13	0	0
16	36923298	.	C	T	9	3	12	0	0	12	0	0
16	36925462	.	G	A	0	8	8	0	12	20	0	0
16	36926775	.	C	A	16	8	24	0	1	25	0	0
16	36926779	.	A	C	16	10	26	0	0	26	0	0
16	36928169	.	A	T	16	9	25	0	1	26	0	0
16	36928179	.	A	C	12	10	22	0	2	24	0	0
16	36928429	.	A	G	16	12	28	0	1	29	0	0
16	36931728	.	T	C	13	10	23	0	1	24	0	0
16	36931822	.	T	C	12	4	16	2	0	18	0	0
16	36934191	.	T	A	8	4	12	0	1	13	0	0
16	36934340	.	C	A	1	3	4	0	3	7	0	0
16	36934398	.	G	C	9	5	14	1	3	18	0	0
16	36939973	.	T	C	8	1	9	0	11	20	0	0
16	36939982	.	A	G	10	11	21	0	0	21	0	0
16	36940045	.	C	T	13	10	23	0	0	23	0	0
16	36941706	.	T	C	8	12	20	0	0	20	0	0
16	36941790	.	T	C	4	6	10	0	0	10	0	0
16	36941961	.	T	C	3	0	3	0	10	13	0	0
16	36942068	.	C	A	10	8	18	0	1	19	0	0
16	36945182	.	T	G	2	10	12	0	0	12	0	0
16	36945288	.	G	A	7	9	16	0	0	16	0	0
16	36945564	.	T	C	5	7	12	0	1	13	0	0
16	36945566	.	T	A	5	7	12	0	1	13	0	0
16	36975141	.	G	A	18	12	30	0	0	30	0	0
16	36975146	.	C	T	3	13	16	0	16	32	0	0
16	36975183	.	G	C	16	7	23	0	2	25	0	0
16	36975318	.	T	A	12	8	20	0	0	21	1	0
16	36976721	.	A	G	3	7	10	0	1	11	0	0
16	36977268	.	G	A	3	2	5	0	0	5	0	0
16	36977289	.	C	T	5	2	7	0	0	7	0	0
16	36979518	.	G	A	12	12	24	0	0	24	0	0
16	36979521	.	A	G	11	11	22	0	2	24	0	0
16	37167442	.	G	C	5	10	15	0	0	15	0	0
16	37167545	.	T	A	4	7	11	0	1	12	0	0
16	37167589	.	T	G	2	7	9	0	2	11	0	0
16	37167784	.	C	G	4	6	10	0	1	11	0	0
16	37167968	.	G	A	3	8	11	0	0	11	0	0
16	37306905	.	G	A	9	13	22	0	1	23	0	0
16	37323594	.	A	C	6	12	18	0	1	19	0	0
16	37470964	.	T	C	5	2	7	0	0	7	0	0
16	37470975	.	C	T	6	2	8	0	0	8	0	0
16	37471169	.	A	T	2	3	5	0	1	6	0	0
16	37520597	.	T	C	5	3	8	0	1	9	0	0
16	37520679	.	T	A	2	2	4	0	0	4	0	0
16	37521130	.	A	G	7	5	12	0	0	12	0	0
16	37521301	.	G	C	0	5	5	0	5	10	0	0
16	37543114	.	T	C	3	5	8	0	0	8	0	0
16	37543137	.	A	C	3	5	8	0	0	8	0	0
16	37552348	.	A	C	8	3	11	0	0	11	0	0
16	37552966	.	G	A	8	11	19	0	0	19	0	0
16	37554821	.	C	T	9	13	22	0	0	22	0	0
16	37563601	.	G	A	9	10	19	0	1	20	0	0
16	37563643	.	T	G	6	0	6	0	18	24	0	0
16	37565676	.	C	G	7	9	16	0	2	18	0	0
16	37593444	.	G	A	20	6	26	0	2	28	0	0
16	37596645	.	C	T	10	9	19	0	0	19	0	0
16	37596669	.	G	A	15	7	22	0	1	23	0	0
16	37614071	.	A	G	9	11	20	0	1	21	0	0
16	37617219	.	A	G	17	0	17	0	18	35	0	0
16	37617304	.	A	G	23	0	23	0	21	44	0	0
16	37617738	.	T	C	25	18	43	0	0	43	0	0
16	37627218	.	T	G	18	12	30	0	4	34	0	0
16	37627762	.	G	A	2	18	20	0	16	36	0	0
16	37627997	.	T	G	17	27	44	0	3	47	0	0
16	37947769	.	T	C	2	3	5	0	0	5	0	0
16	37948242	.	C	G	4	4	8	0	0	8	0	0
16	37948256	.	G	T	4	6	10	0	0	10	0	0
16	37948355	.	C	T	8	5	13	0	1	14	0	0
16	37948389	.	G	T	8	9	17	0	1	18	0	0
16	37948624	.	G	A	5	3	8	0	0	8	0	0
16	37948625	.	G	A	5	3	8	0	0	8	0	0
16	37963955	.	T	A	8	7	15	0	0	15	0	0
16	37964100	.	C	T	2	9	11	0	0	11	0	0
16	37964222	.	T	A	3	5	8	1	1	10	0	0
16	38017652	.	G	A	3	4	7	0	0	7	0	0
16	38017933	.	T	G	3	3	6	0	0	6	0	0
16	38017964	.	A	G	3	3	6	0	1	7	0	0
16	38018128	.	C	T	1	2	3	0	0	3	0	0
16	38018279	.	T	C	3	0	3	0	4	7	0	0
16	38018644	.	A	T	1	5	6	0	0	6	0	0
16	38018672	.	T	A	1	7	8	0	0	8	0	0
16	38067856	.	G	A	2	3	5	0	0	5	0	0
16	38067881	.	G	A	2	2	4	0	0	4	0	0
16	38119696	.	T	A	1	3	4	0	0	4	0	0
16	38119973	.	C	T	2	2	4	0	0	4	0	0
16	38120228	.	G	A	6	5	11	0	0	11	0	0
16	38121528	.	G	A	0	4	4	0	6	10	0	0
16	38121981	.	C	T	3	5	8	0	0	8	0	0
16	38124907	.	T	G	6	0	6	0	5	11	0	0
16	38125293	.	G	C	8	6	14	0	0	14	0	0
16	38125299	.	G	C	8	5	13	0	0	13	0	0
16	38125370	.	C	T	2	3	5	0	1	6	0	0
16	38125650	.	T	C	5	3	8	0	0	8	0	0
16	38125662	.	A	G	3	2	5	0	0	5	0	0
16	38127708	.	T	A	9	8	17	0	0	17	0	0
16	38129689	.	T	C	5	3	8	0	0	8	0	0
16	38130471	.	T	C	1	5	6	0	0	6	0	0
16	38130661	.	T	C	4	5	9	0	1	10	0	0
16	38135699	.	T	C	7	5	12	0	0	12	0	0
16	38135763	.	A	G	9	3	12	0	0	12	0	0
16	38136117	.	C	T	2	12	14	0	1	15	0	0
16	38136278	.	C	T	12	9	21	0	0	21	0	0
16	38136317	.	G	A	11	13	24	0	0	24	0	0
16	38136346	.	C	T	11	12	23	0	0	23	0	0
16	38136491	.	G	C	8	4	12	0	0	12	0	0
16	38148116	.	T	C	3	3	6	0	0	6	0	0
16	38148155	.	G	A	0	3	3	0	3	6	0	0
16	38152095	.	G	A	0	3	3	0	2	5	0	0
16	38154203	.	G	A	6	3	9	0	2	11	0	0
16	38154236	.	A	G	3	4	7	0	1	8	0	0
16	38157102	.	T	A	2	7	9	0	0	9	0	0
16	38157153	.	T	A	2	2	4	0	0	4	0	0
16	38159817	.	C	A	7	6	13	0	0	13	0	0
16	38167493	.	G	C	8	8	16	0	1	17	0	0
16	38167511	.	C	T	8	8	16	0	1	17	0	0
16	38167904	.	A	G	11	0	11	0	9	20	0	0
16	38168009	.	A	G	17	6	23	0	2	25	0	0
16	38168095	.	G	A	1	7	8	0	5	13	0	0
16	38188955	.	G	A	1	7	8	0	11	19	0	0
16	38189099	.	T	C	8	11	19	0	2	21	0	0
16	38199647	.	G	A	6	9	15	0	0	15	0	0
16	38266221	.	A	C	1	2	3	0	0	3	0	0
16	38266242	.	T	C	1	4	5	0	1	6	0	0
16	38266613	.	T	A	2	2	4	0	0	4	0	0
16	38266664	.	C	T	2	2	4	0	0	4	0	0
16	38312494	.	A	T	1	3	4	0	0	4	0	0
16	38312697	.	C	T	0	3	3	0	1	4	0	0
16	38313144	.	C	A	2	2	4	0	1	5	0	0
16	38313176	.	G	T	1	3	4	0	0	4	0	0
16	38313341	.	A	T	2	3	5	0	0	5	0	0
16	38313405	.	A	G	1	3	4	0	0	4	0	0
16	38350766	.	C	A	2	4	6	1	0	7	0	0
16	38350796	.	G	T	2	3	5	1	0	6	0	0
16	38351061	.	T	A	5	6	11	0	0	11	0	0
16	38355299	.	G	A	5	5	10	0	1	11	0	0
16	38499053	.	C	T	0	5	5	0	2	7	0	0
16	38553647	.	C	T	3	2	5	0	0	5	0	0
16	38556912	.	G	A	14	7	21	0	0	21	0	0
16	38556922	.	C	G	2	6	8	0	14	22	0	0
16	38557876	.	G	C	27	2	29	0	22	51	0	0
16	38568644	.	G	C	23	21	44	0	0	44	0	0
16	38824958	.	T	G	1	2	3	0	0	3	0	0
16	38943253	.	C	T	6	5	11	0	2	13	0	0
16	38943547	.	A	G	8	0	8	0	3	11	0	0
16	39146871	.	A	C	17	22	39	0	0	39	0	0
16	39147060	.	C	G	21	0	21	0	10	31	0	0
16	39147355	.	G	C	25	18	43	0	0	43	0	0
16	39147386	.	C	A	31	23	54	0	0	54	0	0
16	39154953	.	G	A	23	13	36	0	1	38	1	0
16	39157751	.	C	A	26	24	50	0	0	50	0	0
16	39157885	.	T	A	28	22	50	0	1	51	0	0
16	39160458	.	A	C	31	23	54	0	2	56	0	0
16	39162786	.	C	T	28	24	52	0	2	54	0	0
16	39164213	.	G	A	28	17	45	1	3	49	0	0
16	39166773	.	C	T	26	21	47	0	0	48	1	0
16	39166854	.	C	T	21	35	56	0	0	56	0	0
16	39167028	.	C	A	10	24	34	0	1	35	0	0
16	39167088	.	C	T	11	12	23	0	0	23	0	0
16	39185271	.	T	G	3	2	5	0	0	5	0	0
16	39185580	.	G	A	13	13	26	0	2	28	0	0
16	39191557	.	T	C	16	0	16	0	14	30	0	0
16	39196850	.	A	C	5	5	10	0	0	10	0	0
16	39196890	.	A	C	6	5	11	0	0	11	0	0
16	39196956	.	A	G	7	3	10	0	0	10	0	0
16	39213237	.	G	A	3	4	7	0	8	15	0	0
16	39213314	.	G	A	4	2	6	0	0	6	0	0
16	39238437	.	A	C	2	0	2	0	6	8	0	0
16	39238630	.	G	A	1	2	3	0	0	3	0	0
16	39244286	.	T	C	19	26	45	0	0	45	0	0
16	39248745	.	T	A	5	4	9	1	0	10	0	0
16	39248765	.	G	C	4	7	11	0	0	11	0	0
16	39248811	.	C	G	4	10	14	0	0	14	0	0
16	39248813	.	T	A	4	10	14	0	0	14	0	0
16	39248864	.	G	A	4	5	9	0	0	9	0	0
16	39248886	.	C	A	4	4	8	0	1	9	0	0
16	39248976	.	G	A	10	9	19	0	2	21	0	0
16	39249056	.	G	A	10	4	14	0	1	15	0	0
16	39249229	.	C	T	5	5	10	0	2	12	0	0
16	39249350	.	A	C	7	5	12	0	0	12	0	0
16	39249475	.	C	A	3	4	7	0	1	8	0	0
16	39249506	.	G	A	5	3	8	0	0	8	0	0
16	39249527	.	A	T	6	3	9	0	0	9	0	0
16	39250197	.	C	T	4	4	8	0	0	8	0	0
16	39250574	.	G	A	6	3	9	0	0	9	0	0
16	39253200	.	G	A	5	3	8	0	0	8	0	0
16	39256291	.	A	G	5	3	8	0	0	8	0	0
16	39256303	.	T	C	4	3	7	0	0	7	0	0
16	39271329	.	A	C	11	7	18	0	0	18	0	0
16	39271394	.	G	C	5	2	7	0	1	8	0	0
16	39297336	.	C	A	6	5	11	0	0	11	0	0
16	39297344	.	A	T	5	6	11	0	0	11	0	0
16	39297378	.	C	T	6	4	10	0	0	10	0	0
16	39323626	.	T	G	7	0	7	0	4	11	0	0
16	39323716	.	C	T	8	3	11	0	0	11	0	0
16	39323809	.	T	C	2	3	5	0	1	6	0	0
16	39325084	.	A	G	5	1	6	0	5	11	0	0
16	39325121	.	G	A	6	4	10	0	0	10	0	0
16	39361889	.	C	T	3	6	9	0	0	9	0	0
16	39362312	.	G	T	1	3	4	0	7	11	0	0
16	39372345	.	G	A	8	6	14	0	0	14	0	0
16	39372372	.	T	C	10	9	19	0	0	19	0	0
16	39372735	.	G	C	1	13	14	0	4	18	0	0
16	39372780	.	C	A	12	9	21	0	2	23	0	0
16	39378744	.	A	G	14	0	14	0	15	29	0	0
16	39382047	.	C	G	9	12	21	0	0	21	0	0
16	39382084	.	C	T	7	13	20	0	0	20	0	0
16	39382098	.	G	A	7	10	17	0	0	17	0	0
16	39382208	.	T	C	4	4	8	0	2	10	0	0
16	39385568	.	T	G	6	0	6	0	0	6	0	0
16	39385755	.	T	C	16	0	16	0	9	25	0	0
16	39386184	.	T	C	18	11	29	0	2	31	0	0
16	39386239	.	T	A	14	19	33	0	4	37	0	0
16	39386915	.	C	T	15	13	28	0	1	29	0	0
16	39390139	.	T	C	18	0	18	1	20	39	0	0
16	39390175	.	G	A	18	19	37	1	1	39	0	0
16	39393370	.	A	G	20	15	35	0	1	36	0	0
16	39394630	.	A	G	20	16	36	0	2	38	0	0
16	39399140	.	A	C	7	0	7	0	17	24	0	0
16	39413514	.	C	T	10	7	17	0	1	18	0	0
16	39433472	.	A	G	3	6	9	0	0	9	0	0
16	39643512	.	G	A	2	5	7	0	0	7	0	0
16	39742484	.	A	G	4	4	8	0	0	8	0	0
16	39830006	.	C	T	1	5	6	0	3	9	0	0
16	39901274	.	G	A	4	4	8	0	0	8	0	0
16	40026573	.	A	G	3	0	3	0	6	9	0	0
16	40031649	.	A	G	5	4	9	0	0	9	0	0
16	40066964	.	C	T	2	3	5	0	0	5	0	0
16	40153135	.	A	T	2	2	4	0	0	4	0	0
16	40153313	.	G	C	3	5	8	0	0	8	0	0
16	40153505	.	A	G	1	0	1	0	2	3	0	0
16	40340558	.	T	C	2	1	3	0	0	3	0	0
16	40340565	.	A	T	3	2	5	0	0	5	0	0
16	40340706	.	T	G	3	2	5	0	0	5	0	0
16	40340844	.	C	A	2	2	4	0	0	4	0	0
16	40340847	.	A	G	2	0	2	0	3	5	0	0
16	40341024	.	T	C	2	2	4	0	0	4	0	0
16	40343747	.	T	C	5	2	7	0	0	7	0	0
16	40346775	.	T	G	1	3	4	0	1	5	0	0
16	40347546	.	T	A	4	3	7	0	0	7	0	0
16	40352092	.	A	G	1	1	2	0	4	6	0	0
16	40425996	.	C	G	7	3	10	0	0	10	0	0
16	40491931	.	A	G	6	6	12	0	0	12	0	0
16	40495482	.	C	T	1	8	9	0	3	12	0	0
16	40503994	.	G	A	7	7	14	0	0	14	0	0
16	40560713	.	C	T	4	8	12	0	0	12	0	0
16	40563673	.	G	T	7	4	11	0	1	12	0	0
16	40563811	.	G	A	3	7	10	0	0	10	0	0
16	40568162	.	A	G	5	0	5	1	5	11	0	0
16	40568274	.	G	A	2	7	9	0	1	10	0	0
16	40568336	.	A	G	8	0	8	0	6	14	0	0
16	40569480	.	C	G	4	3	7	0	0	7	0	0
16	40569558	.	A	C	2	4	6	0	0	6	0	0
16	40582960	.	C	T	2	3	5	0	0	5	0	0
16	40602823	.	G	A	6	2	8	0	0	8	0	0
16	40602886	.	G	A	2	4	6	0	0	6	0	0
16	40606678	.	G	A	2	4	6	0	0	6	0	0
16	40606844	.	T	A	4	4	8	0	0	8	0	0
16	40606883	.	G	A	4	2	6	0	0	6	0	0
16	40607300	.	G	C	3	4	7	0	0	7	0	0
16	40607318	.	G	A	5	4	9	0	1	10	0	0
16	40616981	.	C	T	2	2	4	0	0	4	0	0
16	40616983	.	T	G	3	2	5	0	0	5	0	0
16	40619531	.	G	T	3	5	8	0	0	8	0	0
16	40619643	.	C	A	5	2	7	0	0	7	0	0
16	40619668	.	A	G	4	2	6	0	0	6	0	0
16	40625168	.	G	A	1	5	6	0	0	6	0	0
16	40632787	.	A	C	2	0	2	0	4	6	0	0
16	40632907	.	T	C	3	0	3	0	2	5	0	0
16	40632915	.	A	T	2	3	5	0	0	5	0	0
16	40632952	.	C	T	1	4	5	0	2	7	0	0
16	40633066	.	C	G	1	3	4	0	0	4	0	0
16	40639762	.	G	A	1	2	3	0	0	3	0	0
16	40672891	.	C	T	1	6	7	0	0	7	0	0
16	40954538	.	C	T	13	11	24	0	0	24	0	0
16	40954866	.	T	C	10	15	25	0	0	25	0	0
16	40954983	.	A	C	7	14	21	0	1	22	0	0
16	40955515	.	G	T	6	12	18	0	0	18	0	0
16	40955525	.	C	T	9	7	16	0	3	19	0	0
16	40955722	.	G	C	3	4	7	0	1	8	0	0
16	40991986	.	G	T	5	2	7	0	0	7	0	0
16	40992009	.	G	A	4	3	7	0	0	7	0	0
16	40992277	.	C	A	1	3	4	0	1	5	0	0
16	40992490	.	A	G	6	4	10	0	0	10	0	0
16	40992529	.	G	A	5	4	9	0	0	9	0	0
16	40992713	.	C	G	4	6	10	1	0	11	0	0
16	41003692	.	T	C	5	0	5	0	3	8	0	0
16	41003845	.	G	T	3	3	6	0	0	6	0	0
16	41003923	.	G	A	2	2	4	0	0	4	0	0
16	41023779	.	A	T	8	5	13	12	0	25	0	0
16	41029443	.	G	A	5	4	9	0	1	10	0	0
16	41029588	.	G	A	0	6	6	0	3	9	0	0
16	41029626	.	G	T	3	2	5	0	0	5	0	0
16	41029649	.	T	C	1	2	3	0	0	3	0	0
16	41029795	.	C	T	3	5	8	0	0	8	0	0
16	41029836	.	A	G	4	2	6	0	0	6	0	0
16	41030017	.	A	C	11	6	17	0	2	19	0	0
16	41030085	.	A	C	3	3	6	0	0	6	0	0
16	41030114	.	A	G	2	4	6	0	2	8	0	0
16	41030137	.	A	G	12	2	14	0	1	15	0	0
16	41030560	.	T	C	3	4	7	0	1	8	0	0
16	41084891	.	C	T	3	3	6	0	0	6	0	0
16	41112493	.	C	T	1	4	5	0	1	6	0	0
16	41112571	.	T	C	3	4	7	0	0	7	0	0
16	41112861	.	G	C	5	0	5	0	4	9	0	0
16	41113676	.	T	G	12	7	19	0	2	21	0	0
16	41113698	.	A	T	11	8	19	0	1	20	0	0
16	41113752	.	G	A	14	12	26	0	0	26	0	0
16	41113755	.	C	T	12	11	23	0	2	25	0	0
16	41114779	.	G	A	8	9	17	0	3	20	0	0
16	41114800	.	A	T	11	8	19	0	0	19	0	0
16	41114890	.	C	T	7	5	12	0	0	12	0	0
16	41114976	.	G	T	7	8	15	0	1	16	0	0
16	41115079	.	T	G	8	5	13	0	0	13	0	0
16	41115997	.	A	T	16	9	25	0	1	26	0	0
16	41115998	.	C	T	3	9	12	0	14	26	0	0
16	41116367	.	G	A	11	9	20	0	3	23	0	0
16	41116548	.	G	A	6	4	10	0	0	10	0	0
16	41116571	.	G	A	6	4	10	0	0	10	0	0
16	41116613	.	G	C	3	10	13	0	0	13	0	0
16	41116783	.	C	T	9	6	15	0	0	15	0	0
16	41117169	.	G	A	4	5	9	0	0	9	0	0
16	41119347	.	T	C	2	3	5	0	0	5	0	0
16	41120943	.	G	T	2	3	5	0	0	5	0	0
16	41121628	.	T	C	2	3	5	0	0	5	0	0
16	41127542	.	C	T	2	3	5	0	0	5	0	0
16	41131471	.	G	A	4	4	8	0	0	8	0	0
16	41131574	.	A	T	1	4	5	0	0	5	0	0
16	41345826	.	G	T	7	4	11	0	0	11	0	0
16	41346007	.	C	A	0	10	10	0	9	19	0	0
16	41353140	.	G	A	11	11	22	0	0	22	0	0
16	41393773	.	C	T	9	9	18	0	0	18	0	0
16	41468848	.	T	G	11	5	16	0	1	17	0	0
16	41469008	.	G	A	1	8	9	0	1	10	0	0
16	41469029	.	C	A	1	7	8	0	1	9	0	0
16	41469130	.	T	A	10	7	17	0	1	18	0	0
16	41469265	.	A	G	3	4	7	0	0	7	0	0
16	41469271	.	G	A	5	3	8	0	0	8	0	0
16	41469305	.	A	G	4	3	7	0	0	7	0	0
16	41469329	.	G	A	5	6	11	0	1	12	0	0
16	41469390	.	A	C	8	9	17	0	0	17	0	0
16	41469508	.	G	C	3	3	6	0	0	6	0	0
16	41469581	.	A	C	3	3	6	0	0	6	0	0
16	41469617	.	G	T	5	1	6	0	0	6	0	0
16	41470404	.	A	T	3	2	5	0	1	6	0	0
16	41471881	.	C	T	0	2	2	0	5	7	0	0
16	41472975	.	T	C	5	1	6	0	1	7	0	0
16	41473020	.	C	T	2	2	4	0	2	6	0	0
16	41473099	.	G	T	1	2	3	0	0	3	0	0
16	41487452	.	C	T	2	2	4	0	1	5	0	0
16	41503836	.	A	G	3	2	5	0	0	5	0	0
16	41514958	.	A	G	1	3	4	0	0	4	0	0
16	41535603	.	G	T	6	5	11	0	0	11	0	0
16	41585743	.	C	T	0	4	4	0	1	5	0	0
16	41589214	.	A	G	5	5	10	0	0	10	0	0
16	41621428	.	G	A	1	2	3	0	1	4	0	0
16	41622460	.	A	C	1	0	1	0	6	7	0	0
16	41637931	.	G	A	1	2	3	0	0	3	0	0
16	41646081	.	C	T	3	3	6	0	1	7	0	0
16	41691307	.	C	T	2	2	4	0	0	4	0	0
16	41691462	.	C	T	3	3	6	0	1	7	0	0
16	41701149	.	G	A	1	4	5	0	0	5	0	0
16	41704056	.	T	A	3	2	5	0	0	5	0	0
16	41717479	.	G	A	15	7	22	0	0	22	0	0
16	41717482	.	A	G	14	6	20	0	0	20	0	0
16	41717666	.	G	A	0	14	14	0	23	37	0	0
16	41720533	.	G	T	10	9	19	0	1	20	0	0
16	41720536	.	T	G	10	8	18	0	0	19	1	0
16	41720587	.	T	C	12	17	29	0	0	29	0	0
16	41723228	.	T	G	12	0	12	0	21	33	0	0
16	41723280	.	A	G	9	2	11	0	9	20	0	0
16	41723778	.	C	G	4	1	5	0	12	17	0	0
16	41725215	.	T	C	12	8	20	0	0	20	0	0
16	41725238	.	T	C	11	8	19	0	1	20	0	0
16	41727162	.	T	G	15	8	23	0	0	24	1	0
16	41727376	.	C	A	11	16	27	0	0	27	0	0
16	41730407	.	G	A	12	10	22	1	0	23	0	0
16	41730625	.	C	G	21	16	37	0	0	37	0	0
16	41731928	.	A	T	5	8	13	0	2	15	0	0
16	41731929	.	C	A	6	9	15	0	0	15	0	0
16	41732009	.	G	T	7	7	14	0	0	14	0	0
16	41732031	.	G	T	0	4	4	0	7	11	0	0
16	41732067	.	T	C	7	6	13	0	0	13	0	0
16	41732158	.	C	A	7	2	9	0	0	9	0	0
16	41732262	.	T	C	8	11	19	0	0	19	0	0
16	41732295	.	G	T	6	12	18	0	0	18	0	0
16	41732343	.	C	T	6	7	13	0	1	14	0	0
16	41732366	.	A	G	6	7	13	0	0	13	0	0
16	41740704	.	A	T	7	10	17	0	1	18	0	0
16	41740815	.	T	A	1	8	9	0	1	10	0	0
16	41740924	.	A	G	5	1	6	0	3	9	0	0
16	41741050	.	C	T	1	6	7	0	2	9	0	0
16	41741199	.	A	T	1	4	5	0	0	5	0	0
16	41741398	.	A	G	2	2	4	0	0	4	0	0
16	41742460	.	T	C	1	2	3	0	0	3	0	0
16	41742481	.	C	T	1	2	3	0	0	3	0	0
16	41742703	.	A	G	2	3	5	0	0	5	0	0
16	41750501	.	G	A	1	2	3	0	0	3	0	0
16	41794900	.	C	A	2	10	12	0	18	30	0	0
16	41801525	.	G	T	17	15	32	0	2	34	0	0
16	41873717	.	T	A	11	13	24	0	3	27	0	0
16	41873797	.	G	A	7	9	16	0	1	17	0	0
16	41873992	.	C	T	5	6	11	0	0	11	0	0
16	41874039	.	G	C	11	6	17	0	0	17	0	0
16	41882490	.	G	T	0	2	2	0	4	6	0	0
16	41882512	.	A	G	3	3	6	0	0	6	0	0
16	41891572	.	C	T	19	17	36	0	0	36	0	0
16	41891662	.	A	C	15	22	37	0	0	37	0	0
16	41896361	.	G	A	13	14	27	0	4	31	0	0
16	41897244	.	A	G	16	14	30	0	2	32	0	0
16	41897332	.	A	G	15	18	33	0	1	34	0	0
16	41897347	.	G	A	15	19	34	0	6	40	0	0
16	41897375	.	A	T	15	21	36	0	0	36	0	0
16	41897452	.	C	A	15	14	29	0	1	30	0	0
16	41897599	.	A	T	9	10	19	0	1	20	0	0
16	41903475	.	A	T	15	10	25	0	0	25	0	0
16	41903686	.	G	A	10	7	17	0	0	17	0	0
16	41903770	.	T	C	18	9	27	0	1	28	0	0
16	41903801	.	T	G	13	10	23	0	0	23	0	0
16	41903957	.	T	C	6	13	19	0	2	21	0	0
16	41904121	.	T	G	8	11	19	0	0	19	0	0
16	41904209	.	T	C	14	8	22	0	2	24	0	0
16	41904261	.	G	A	13	8	21	0	0	21	0	0
16	41904430	.	C	A	19	8	27	0	0	27	0	0
16	41904440	.	C	A	1	10	11	0	16	27	0	0
16	41904615	.	T	C	17	0	17	0	7	24	0	0
16	41904650	.	G	A	11	5	16	0	0	16	0	0
16	41904680	.	A	T	6	2	8	3	1	12	0	0
16	41904879	.	A	T	4	4	8	0	0	8	0	0
16	41904961	.	A	G	6	8	14	0	1	15	0	0
16	41905631	.	A	G	4	9	13	0	2	15	0	0
16	41905666	.	A	G	11	7	18	0	0	18	0	0
16	41905682	.	G	T	13	9	22	0	1	23	0	0
16	41905720	.	T	A	12	8	20	0	1	21	0	0
16	41905807	.	G	C	4	15	19	0	0	19	0	0
16	41912225	.	G	A	14	10	24	0	1	25	0	0
16	41916819	.	A	G	17	14	31	1	2	34	0	0
16	41925227	.	G	C	21	1	22	0	8	30	0	0
16	41929993	.	T	G	16	11	27	0	0	27	0	0
16	41933222	.	A	C	8	8	16	0	1	17	0	0
16	41933411	.	G	A	9	7	16	0	0	16	0	0
16	41987249	.	C	A	1	2	3	0	0	3	0	0
16	41989534	.	G	A	1	2	3	0	0	3	0	0
16	42046274	.	A	C	3	2	5	0	0	5	0	0
16	42072207	.	T	A	15	18	33	0	0	33	0	0
16	42072719	.	A	C	18	20	38	0	0	38	0	0
16	42073086	.	A	G	7	3	10	0	1	11	0	0
16	42073488	.	T	C	24	0	24	0	22	46	0	0
16	42083039	.	G	A	10	10	20	0	0	20	0	0
16	42091814	.	A	G	14	18	32	0	1	33	0	0
16	42156594	.	C	T	3	5	8	0	1	9	0	0
16	42156619	.	C	T	3	5	8	0	0	8	0	0
16	42156640	.	T	C	5	1	6	0	0	6	0	0
16	42161312	.	G	A	1	2	3	0	0	3	0	0
16	42177840	.	C	T	6	2	8	0	0	8	0	0
16	42178002	.	C	T	0	5	5	1	10	16	0	0
16	42178012	.	A	G	10	3	13	1	0	14	0	0
16	42179879	.	C	A	13	10	23	0	0	23	0	0
16	42180079	.	A	G	18	11	29	0	1	30	0	0
16	42180271	.	G	A	10	17	27	0	0	27	0	0
16	42186022	.	G	A	6	7	13	0	0	13	0	0
16	42186043	.	A	T	5	3	8	0	2	10	0	0
16	42186063	.	A	G	2	2	4	0	0	4	0	0
16	42193489	.	G	A	1	3	4	0	0	4	0	0
16	42207600	.	A	G	3	4	7	0	0	7	0	0
16	42238095	.	G	A	1	3	4	0	0	4	0	0
16	42322458	.	T	G	42	40	82	0	2	85	1	0
16	42373933	.	A	C	26	27	53	0	1	55	1	0
16	42374020	.	C	T	2	26	28	0	15	43	0	0
16	42374080	.	G	T	25	31	56	0	2	58	0	0
16	42374254	.	C	T	23	37	60	0	0	60	0	0
16	42374290	.	G	A	27	33	60	0	2	62	0	0
16	42374425	.	A	G	21	31	52	0	2	54	0	0
16	42374434	.	A	C	20	32	52	0	2	54	0	0
16	42390176	.	T	C	17	0	17	0	19	36	0	0
16	42424189	.	G	A	18	9	27	0	0	27	0	0
16	42424240	.	G	A	9	12	21	0	1	22	0	0
16	42424348	.	T	C	13	8	21	0	1	22	0	0
16	42424352	.	G	A	13	7	20	0	1	21	0	0
16	42424504	.	C	A	8	5	13	0	2	15	0	0
16	42424505	.	A	C	8	5	13	0	1	14	0	0
16	42424653	.	G	C	10	8	18	0	0	18	0	0
16	42424762	.	G	A	17	13	30	0	0	30	0	0
16	42441986	.	T	C	6	11	17	0	0	17	0	0
16	42443965	.	G	A	8	12	20	0	0	20	0	0
16	42452554	.	T	C	6	3	9	0	1	10	0	0
16	42452557	.	G	A	5	4	9	0	0	9	0	0
16	42452591	.	C	G	2	4	6	0	0	6	0	0
16	42452592	.	T	A	2	4	6	0	0	6	0	0
16	42453542	.	C	T	1	4	5	0	6	11	0	0
16	42454027	.	G	C	8	7	15	0	1	16	0	0
16	42459378	.	T	C	1	3	4	0	0	4	0	0
16	42461066	.	A	G	5	4	9	0	0	9	0	0
16	42461121	.	T	C	9	0	9	0	8	17	0	0
16	42472146	.	G	T	1	3	4	0	0	4	0	0
16	42472294	.	C	G	3	5	8	0	0	8	0	0
16	42472715	.	C	T	3	3	6	0	0	6	0	0
16	42487947	.	A	G	7	15	22	0	9	31	0	0
16	42490255	.	C	T	10	7	17	0	1	18	0	0
16	42490264	.	T	C	10	9	19	0	0	19	0	0
16	42493796	.	G	C	0	17	17	0	8	25	0	0
16	42493900	.	A	T	10	5	15	5	0	20	0	0
16	42494084	.	G	A	1	4	5	0	5	10	0	0
16	42667643	.	C	T	2	2	4	0	0	4	0	0
16	42678537	.	G	A	0	4	4	0	4	8	0	0
16	42679327	.	G	C	0	2	2	0	4	6	0	0
16	42681256	.	C	A	6	5	11	0	0	11	0	0
16	42681270	.	G	C	6	3	9	0	0	9	0	0
16	42833084	.	T	C	11	11	22	0	0	22	0	0
16	42842991	.	G	C	7	14	21	0	0	21	0	0
16	42842995	.	A	G	7	14	21	0	0	21	0	0
16	42843128	.	G	A	10	3	13	0	0	13	0	0
16	42900598	.	G	A	1	4	5	0	1	6	0	0
16	42938992	.	G	T	9	4	13	0	3	16	0	0
16	42939061	.	A	T	4	6	10	0	0	10	0	0
16	42939088	.	C	A	2	4	6	0	1	7	0	0
16	42939097	.	A	G	3	2	5	0	0	5	0	0
16	42939124	.	T	A	2	5	7	0	0	7	0	0
16	42939343	.	C	T	0	8	8	0	21	29	0	0
16	42939351	.	T	C	9	12	21	0	5	26	0	0
16	42939443	.	A	C	8	1	9	0	12	22	1	0
16	42939479	.	A	G	19	12	31	0	1	32	0	0
16	42939480	.	C	T	1	8	9	0	24	33	0	0
16	42939561	.	G	C	13	10	23	0	2	25	0	0
16	42939695	.	A	G	6	8	14	0	1	15	0	0
16	42939993	.	A	C	1	6	7	0	0	7	0	0
16	42940157	.	G	A	2	2	4	0	0	4	0	0
16	42940259	.	A	G	6	3	9	0	2	11	0	0
16	42940336	.	A	G	6	7	13	0	0	13	0	0
16	42940490	.	T	C	4	3	7	0	0	7	0	0
16	42940609	.	G	T	2	2	4	0	0	4	0	0
16	42940836	.	A	C	3	3	6	0	0	6	0	0
16	42940916	.	G	A	3	2	5	0	0	5	0	0
16	42941124	.	C	A	7	13	20	0	2	22	0	0
16	42941189	.	C	A	9	4	13	0	0	13	0	0
16	42949149	.	G	A	6	4	10	0	0	10	0	0
16	42949151	.	C	T	1	5	6	0	3	9	0	0
16	42951876	.	G	A	9	4	13	0	0	13	0	0
16	42975371	.	C	T	1	1	2	0	2	4	0	0
16	42975376	.	G	A	2	2	4	0	0	4	0	0
16	42993052	.	G	A	4	2	6	0	0	6	0	0
16	42993845	.	C	T	2	2	4	0	0	4	0	0
16	43001246	.	G	C	7	0	7	0	8	15	0	0
16	43001354	.	C	T	3	17	20	0	14	34	0	0
16	43003080	.	A	G	10	16	26	0	0	26	0	0
16	43026201	.	G	T	4	3	7	0	1	8	0	0
16	43028153	.	T	A	2	8	10	0	0	10	0	0
16	43028156	.	G	A	2	9	11	0	0	11	0	0
16	43028295	.	T	C	9	7	16	0	2	18	0	0
16	43028303	.	C	T	10	6	16	0	0	16	0	0
16	43028353	.	G	A	5	3	8	0	0	8	0	0
16	43028369	.	A	G	5	4	9	0	0	9	0	0
16	43028453	.	C	T	3	9	12	0	1	13	0	0
16	43028542	.	A	T	12	19	31	0	0	31	0	0
16	43028546	.	C	T	12	19	31	0	1	32	0	0
16	43028626	.	A	C	18	10	28	0	0	28	0	0
16	43032146	.	A	C	9	0	9	0	6	15	0	0
16	43032175	.	C	A	9	4	13	0	0	13	0	0
16	43039176	.	G	T	4	2	6	0	0	6	0	0
16	43039305	.	T	C	4	3	7	0	0	7	0	0
16	43126424	.	A	T	3	5	8	0	0	8	0	0
16	43126425	.	C	T	3	5	8	0	0	8	0	0
16	43126502	.	G	T	7	4	11	0	1	12	0	0
16	43126546	.	A	C	6	0	6	0	10	16	0	0
16	43126566	.	G	A	7	9	16	0	0	16	0	0
16	43126886	.	A	G	6	15	21	0	1	22	0	0
16	43126887	.	C	T	0	11	11	0	11	22	0	0
16	43145476	.	T	A	4	2	6	0	0	6	0	0
16	43149940	.	G	C	2	2	4	0	0	4	0	0
16	43153076	.	C	A	5	5	10	0	0	10	0	0
16	43153537	.	C	A	6	5	11	0	0	11	0	0
16	43198921	.	C	T	9	6	15	0	0	15	0	0
16	43392033	.	A	G	4	2	6	0	0	6	0	0
16	43971245	.	T	C	11	13	24	0	1	25	0	0
16	43971248	.	G	A	11	14	25	0	0	25	0	0
16	44044497	.	C	T	7	12	19	0	0	19	0	0
16	44338921	.	T	A	22	34	56	0	1	57	0	0
16	44339284	.	C	T	4	32	36	1	16	53	0	0
16	44339466	.	A	G	13	31	44	0	1	45	0	0
16	44339475	.	A	G	16	32	48	0	0	48	0	0
16	44342679	.	C	T	26	25	51	0	2	53	0	0
16	44379120	.	A	G	25	14	39	0	0	39	0	0
16	44379168	.	T	C	21	16	37	0	1	38	0	0
16	44379219	.	T	A	19	22	41	0	0	41	0	0
16	44984622	.	A	G	2	6	8	1	0	9	0	0
16	45355564	.	C	T	2	0	2	0	1	3	0	0
16	46082003	.	T	C	2	0	2	0	1	3	0	0
16	46082014	.	G	A	0	2	2	0	0	2	0	0
16	46198406	.	A	G	23	21	44	0	2	46	0	0
16	46200655	.	G	A	3	55	58	0	6	64	0	0
16	48746783	.	A	T	1	4	5	0	1	6	0	0
16	51094706	.	G	A	1	3	4	0	0	4	0	0
16	51094724	.	G	A	1	5	6	0	0	6	0	0
16	51183892	.	A	T	8	6	14	0	1	15	0	0
16	51244464	.	T	C	6	2	8	0	1	9	0	0
16	51244487	.	T	C	6	2	8	0	0	8	0	0
16	51244500	.	T	C	4	2	6	0	0	6	0	0
16	51370110	.	T	C	2	0	2	0	3	5	0	0
16	51559317	.	T	G	3	0	3	0	3	6	0	0
16	51559527	.	C	T	4	7	11	0	0	11	0	0
16	51885808	.	G	A	34	26	60	3	5	68	0	0
16	51885855	.	A	T	43	29	72	3	6	81	0	0
16	51888929	.	C	T	30	24	54	0	2	56	0	0
16	51941865	.	T	C	3	0	3	0	6	9	0	0
16	51941885	.	C	G	5	2	7	0	0	7	0	0
16	51942108	.	G	A	3	4	7	0	0	7	0	0
16	51942155	.	G	A	2	2	4	0	0	4	0	0
16	51942375	.	T	C	4	3	7	0	2	9	0	0
16	51950697	.	T	A	30	10	40	0	1	41	0	0
16	51950726	.	C	A	17	33	50	0	0	50	0	0
16	51950754	.	C	T	18	37	55	0	2	57	0	0
16	51950814	.	A	T	28	0	28	0	0	28	0	0
16	51950877	.	G	C	17	21	38	2	1	41	0	0
16	51951690	.	T	C	4	16	20	0	0	20	0	0
16	51951691	.	T	C	9	11	20	0	0	20	0	0
16	51951861	.	G	C	21	12	33	0	0	33	0	0
16	51952002	.	T	G	5	19	24	0	1	25	0	0
16	51952023	.	A	T	9	21	30	0	1	31	0	0
16	51952063	.	A	C	9	19	28	0	2	30	0	0
16	51952826	.	C	A	10	5	15	0	0	15	0	0
16	51953009	.	G	A	24	19	43	0	2	45	0	0
16	51953048	.	T	C	22	28	50	0	4	54	0	0
16	51953057	.	T	A	23	30	53	0	2	55	0	0
16	51953189	.	G	T	27	16	43	0	1	44	0	0
16	51954683	.	C	T	2	23	25	0	18	43	0	0
16	51955675	.	G	A	18	25	43	0	2	45	0	0
16	51955696	.	G	A	18	23	41	0	0	41	0	0
16	51962068	.	A	G	17	18	35	0	2	37	0	0
16	51962089	.	C	T	19	20	39	0	1	40	0	0
16	51966774	.	C	G	22	10	32	0	0	32	0	0
16	52105324	.	G	A	1	6	7	0	0	7	0	0
16	52130690	.	G	A	1	3	4	0	3	7	0	0
16	52214476	.	C	T	4	5	9	0	1	10	0	0
16	52223760	.	C	G	6	4	10	0	1	11	0	0
16	53152935	.	C	T	1	2	3	0	0	3	0	0
16	53153280	.	C	A	1	2	3	0	0	3	0	0
16	53191089	.	T	C	1	3	4	0	0	4	0	0
16	53203416	.	T	C	5	3	8	0	0	8	0	0
16	53203455	.	C	T	5	3	8	0	0	8	0	0
16	53212009	.	G	A	9	4	13	0	1	14	0	0
16	53213713	.	C	T	3	4	7	0	0	7	0	0
16	53224473	.	G	C	2	6	8	0	15	23	0	0
16	53224629	.	C	T	8	6	14	0	4	18	0	0
16	53247109	.	T	A	13	5	18	0	0	18	0	0
16	53247178	.	C	T	6	13	19	0	0	19	0	0
16	53278513	.	A	G	9	0	9	0	9	18	0	0
16	53285758	.	A	C	6	4	10	0	0	10	0	0
16	53290842	.	G	A	0	11	11	0	6	17	0	0
16	53302337	.	T	C	1	3	4	0	1	5	0	0
16	53302385	.	T	A	1	2	3	0	0	3	0	0
16	53393023	.	C	T	1	3	4	0	0	4	0	0
16	53401050	.	G	A	0	3	3	0	2	5	0	0
16	53449751	.	C	T	1	5	6	0	0	6	0	0
16	53449799	.	C	G	2	1	3	0	2	5	0	0
16	53495455	.	G	A	2	3	5	0	8	13	0	0
16	53495521	.	C	T	11	3	14	0	1	15	0	0
16	53502390	.	C	T	6	3	9	0	1	10	0	0
16	53513549	.	C	T	10	3	13	0	1	14	0	0
16	53513618	.	C	G	10	0	10	0	6	16	0	0
16	53516147	.	T	G	12	9	21	0	1	22	0	0
16	53516232	.	G	A	13	13	26	0	1	27	0	0
16	53516303	.	T	C	9	5	14	1	3	18	0	0
16	53519091	.	T	G	4	4	8	0	0	8	0	0
16	53530047	.	G	C	1	6	7	0	6	13	0	0
16	53530490	.	A	T	5	8	13	0	0	13	0	0
16	53537205	.	C	T	10	8	18	0	1	19	0	0
16	53538806	.	G	A	1	6	7	0	9	16	0	0
16	53539389	.	G	A	8	6	14	0	0	14	0	0
16	53539399	.	T	C	5	7	12	0	1	13	0	0
16	53541879	.	A	G	14	6	20	0	0	20	0	0
16	53541963	.	T	A	7	8	15	0	0	15	0	0
16	53590609	.	C	T	1	2	3	0	0	3	0	0
16	53591908	.	C	G	7	16	23	0	0	23	0	0
16	53592058	.	T	A	11	10	21	0	2	23	0	0
16	53592375	.	C	T	9	10	19	7	5	31	0	0
16	53596689	.	C	T	3	9	12	0	1	13	0	0
16	53596872	.	C	T	3	3	6	0	0	6	0	0
16	53601486	.	A	G	5	0	5	0	8	13	0	0
16	53609415	.	A	G	8	3	11	0	0	11	0	0
16	53610144	.	C	T	2	2	4	0	0	4	0	0
16	53618899	.	C	T	6	4	10	0	0	10	0	0
16	53621578	.	A	G	9	0	9	0	10	19	0	0
16	53623357	.	G	A	2	5	7	0	3	10	0	0
16	53624284	.	C	T	5	5	10	0	0	10	0	0
16	53624296	.	G	A	5	3	8	0	2	10	0	0
16	53626853	.	T	C	6	7	13	1	0	14	0	0
16	53629202	.	G	A	5	10	15	0	0	15	0	0
16	53633125	.	G	A	0	6	6	0	7	13	0	0
16	53701171	.	A	C	23	45	68	0	2	70	0	0
16	53708312	.	C	G	32	38	70	0	1	71	0	0
16	53708537	.	G	T	8	3	11	0	0	11	0	0
16	53708564	.	T	C	3	4	7	0	3	10	0	0
16	53734044	.	C	T	1	2	3	0	0	3	0	0
16	53734522	.	A	C	1	3	4	0	0	4	0	0
16	54186911	.	C	T	4	5	9	0	1	10	0	0
16	54209554	.	A	G	3	2	5	0	0	5	0	0
16	54212731	.	A	G	3	0	3	0	2	5	0	0
16	54213399	.	G	A	3	2	5	0	0	5	0	0
16	54217347	.	A	C	4	7	11	0	0	11	0	0
16	54217408	.	G	A	0	5	5	0	3	8	0	0
16	54222382	.	C	T	2	6	8	0	1	9	0	0
16	54222433	.	T	C	2	6	8	0	0	8	0	0
16	54222448	.	G	A	2	5	7	0	0	7	0	0
16	54239233	.	C	T	4	4	8	0	0	8	0	0
16	54245580	.	T	A	3	3	6	0	0	6	0	0
16	54245609	.	C	T	3	4	7	0	0	7	0	0
16	54245812	.	T	C	1	5	6	0	0	6	0	0
16	54245832	.	A	C	2	5	7	0	0	7	0	0
16	54313643	.	T	A	6	4	10	0	0	10	0	0
16	54314226	.	G	A	1	6	7	0	6	13	0	0
16	54314463	.	C	G	8	5	13	0	0	13	0	0
16	54349225	.	T	C	1	2	3	0	0	3	0	0
16	54805173	.	G	A	4	2	6	0	0	6	0	0
16	54829650	.	C	T	25	31	56	0	1	57	0	0
16	54829656	.	A	G	26	32	58	0	1	59	0	0
16	54837250	.	T	C	39	31	70	0	5	75	0	0
16	54843723	.	C	T	40	30	70	0	3	73	0	0
16	54843798	.	A	G	33	2	35	0	44	79	0	0
16	54846250	.	G	A	3	36	39	0	29	68	0	0
16	54930903	.	A	G	2	2	4	0	0	4	0	0
16	54930916	.	T	A	2	2	4	0	0	4	0	0
16	54932914	.	C	A	3	3	6	0	0	6	0	0
16	54932963	.	T	C	4	2	6	0	1	7	0	0
16	54940615	.	A	G	3	7	10	0	0	10	0	0
16	54947978	.	G	A	4	8	12	0	0	12	0	0
16	54948227	.	A	G	8	10	18	1	0	19	0	0
16	54948369	.	T	A	4	5	9	0	0	9	0	0
16	54948467	.	C	A	6	3	9	0	0	9	0	0
16	54948483	.	T	A	8	3	11	0	1	12	0	0
16	54948538	.	A	T	7	4	11	0	2	13	0	0
16	54948571	.	T	C	6	4	10	0	0	10	0	0
16	54949140	.	G	A	19	11	30	0	2	32	0	0
16	54952935	.	G	A	16	14	30	0	0	30	0	0
16	54953031	.	C	T	3	9	12	0	10	22	0	0
16	54953067	.	G	A	10	13	23	0	1	24	0	0
16	54956620	.	C	T	11	10	21	0	0	21	0	0
16	54956777	.	T	C	8	5	13	0	0	13	0	0
16	54957387	.	A	G	8	12	20	1	2	23	0	0
16	54957388	.	C	G	8	13	21	1	1	23	0	0
16	54958913	.	G	A	3	7	10	0	2	12	0	0
16	54960951	.	A	C	9	6	15	0	2	17	0	0
16	54964146	.	A	G	5	3	8	0	1	9	0	0
16	55004634	.	C	A	2	7	9	0	1	10	0	0
16	55004655	.	A	T	7	13	20	0	0	20	0	0
16	55004716	.	T	C	14	0	14	0	20	34	0	0
16	55007670	.	G	A	18	18	36	0	1	37	0	0
16	55009894	.	T	C	6	0	6	0	6	12	0	0
16	55012538	.	G	T	5	9	14	0	1	15	0	0
16	55095633	.	T	C	3	3	6	0	0	6	0	0
16	55095692	.	T	A	5	3	8	0	3	11	0	0
16	55102314	.	T	C	4	7	11	0	0	11	0	0
16	55102320	.	C	G	4	7	11	0	0	11	0	0
16	55102387	.	C	T	9	9	18	0	0	18	0	0
16	55102467	.	G	A	6	5	11	0	2	13	0	0
16	55102568	.	T	C	5	3	8	0	0	8	0	0
16	55102608	.	T	C	2	2	4	0	0	4	0	0
16	55106058	.	T	A	2	11	13	0	0	13	0	0
16	55106111	.	A	C	3	5	8	0	0	8	0	0
16	55106207	.	T	C	8	11	19	0	0	19	0	0
16	55106223	.	A	G	9	11	20	0	0	20	0	0
16	55106279	.	C	A	11	23	34	0	2	36	0	0
16	55106367	.	A	C	12	23	35	0	0	35	0	0
16	55106405	.	G	A	7	10	17	0	0	17	0	0
16	55106443	.	C	T	5	17	22	0	0	22	0	0
16	55106474	.	C	T	2	12	14	0	4	19	1	0
16	55108828	.	C	T	14	22	36	0	1	37	0	0
16	55122779	.	T	C	11	22	33	0	1	34	0	0
16	55174925	.	T	C	3	3	6	0	0	6	0	0
16	55181458	.	C	A	1	2	3	0	0	3	0	0
16	55181459	.	C	G	1	2	3	0	0	3	0	0
16	55181504	.	T	C	3	5	8	0	0	8	0	0
16	55181507	.	C	A	4	5	9	0	0	9	0	0
16	55181565	.	G	A	0	3	3	0	9	12	0	0
16	55182146	.	T	G	12	4	16	0	0	16	0	0
16	55182217	.	G	A	5	3	8	1	0	9	0	0
16	55182249	.	A	T	4	4	8	0	0	8	0	0
17	1353439	.	G	A	0	3	3	0	0	3	0	0
17	1353930	.	A	G	1	0	1	0	2	3	0	0
17	1354412	.	A	G	1	4	5	0	1	6	0	0
17	2698083	.	C	T	1	2	3	0	0	3	0	0
17	2711282	.	A	G	1	7	8	0	0	8	0	0
17	3183970	.	A	G	4	2	6	0	0	6	0	0
17	3184390	.	T	C	2	2	4	0	0	4	0	0
17	3184396	.	G	A	2	3	5	0	0	5	0	0
17	3189916	.	G	A	1	2	3	0	0	3	0	0
17	3190017	.	A	G	3	3	6	0	0	6	0	0
17	3446847	.	T	C	8	7	15	0	0	15	0	0
17	3556184	.	C	A	5	4	9	0	1	10	0	0
17	3566811	.	A	G	6	9	15	0	0	15	0	0
17	3566844	.	T	A	7	9	16	0	1	17	0	0
17	3569047	.	T	C	6	10	16	0	0	16	0	0
17	3569050	.	A	C	6	11	17	0	0	17	0	0
17	3569169	.	A	G	12	10	22	0	1	23	0	0
17	3569264	.	A	C	6	7	13	0	0	13	0	0
17	3841153	.	A	G	12	13	25	0	1	26	0	0
17	3850524	.	G	A	7	12	19	0	2	21	0	0
17	3854266	.	T	C	11	22	33	0	1	34	0	0
17	3854287	.	C	T	2	14	16	0	14	30	0	0
17	3855403	.	G	A	10	10	20	0	2	22	0	0
17	3855436	.	T	C	12	2	14	0	13	27	0	0
17	3855697	.	C	T	0	12	12	0	11	23	0	0
17	3860794	.	C	G	9	13	22	0	1	23	0	0
17	3860797	.	T	C	6	0	6	0	15	21	0	0
17	3868759	.	A	C	12	0	12	0	14	26	0	0
17	3868765	.	T	C	13	0	13	0	12	25	0	0
17	3878982	.	T	C	6	0	6	0	3	9	0	0
17	4017132	.	C	A	3	2	5	0	0	5	0	0
17	4017277	.	T	C	1	6	7	0	0	7	0	0
17	4240188	.	G	T	13	4	17	0	0	17	0	0
17	4240385	.	T	A	7	4	11	0	0	11	0	0
17	4245126	.	A	G	6	4	10	0	2	12	0	0
17	4297232	.	G	A	31	11	42	1	2	45	0	0
17	4297546	.	C	T	22	18	40	0	3	43	0	0
17	4297551	.	A	C	23	14	37	0	4	41	0	0
17	4297600	.	T	C	29	14	43	0	1	44	0	0
17	4297608	.	G	C	28	0	28	0	16	44	0	0
17	4297697	.	A	T	12	11	23	0	1	24	0	0
17	4297957	.	G	C	19	2	21	0	16	37	0	0
17	4298174	.	C	T	13	25	38	0	1	39	0	0
17	4298190	.	T	A	13	25	38	0	4	42	0	0
17	4298221	.	T	A	16	18	34	0	1	35	0	0
17	4298307	.	A	T	24	11	35	3	2	40	0	0
17	4298326	.	T	G	23	16	39	3	5	47	0	0
17	4298349	.	T	A	26	15	41	2	3	46	0	0
17	4298768	.	T	G	6	14	20	0	2	22	0	0
17	4298876	.	A	G	7	3	10	0	0	10	0	0
17	4298945	.	G	A	20	8	28	0	0	28	0	0
17	4298990	.	A	G	16	20	36	0	0	36	0	0
17	4298996	.	C	T	20	17	37	0	1	38	0	0
17	4299030	.	C	G	18	15	33	0	2	35	0	0
17	4299031	.	C	T	18	16	34	1	1	36	0	0
17	4304841	.	G	A	27	29	56	0	1	57	0	0
17	4307242	.	T	C	24	0	24	0	28	52	0	0
17	4313342	.	G	A	14	19	33	0	2	35	0	0
17	4368935	.	A	T	2	4	6	0	1	7	0	0
17	4368968	.	G	A	2	3	5	0	0	5	0	0
17	4369199	.	A	T	3	5	8	0	0	8	0	0
17	4369200	.	C	T	3	5	8	0	0	8	0	0
17	4369379	.	G	T	3	4	7	0	1	8	0	0
17	4378210	.	G	A	2	6	8	0	0	8	0	0
17	4378219	.	C	T	3	7	10	0	0	10	0	0
17	4385982	.	C	T	4	3	7	0	0	7	0	0
17	4852500	.	C	T	0	2	2	0	1	3	0	0
17	5061184	.	G	C	10	8	18	0	0	18	0	0
17	5599356	.	C	T	0	1	1	0	2	3	0	0
17	5606386	.	G	A	2	2	4	0	0	4	0	0
17	5616839	.	C	T	2	3	5	0	0	5	0	0
17	5769127	.	T	A	4	8	12	0	1	13	0	0
17	5769140	.	T	A	3	8	11	0	0	11	0	0
17	5817582	.	G	T	2	2	4	0	0	4	0	0
17	5818501	.	G	T	1	2	3	0	0	3	0	0
17	5819186	.	G	A	3	3	6	0	0	6	0	0
17	5820083	.	C	T	2	4	6	0	1	7	0	0
17	5820572	.	A	G	2	2	4	0	0	4	0	0
17	5821476	.	G	A	1	5	6	0	1	7	0	0
17	5821578	.	C	T	1	3	4	0	0	4	0	0
17	5895704	.	G	C	1	2	3	0	0	3	0	0
17	5896025	.	G	A	12	12	24	0	0	24	0	0
17	5916392	.	A	G	22	13	35	0	3	38	0	0
17	5926722	.	T	C	18	18	36	0	1	37	0	0
17	5926981	.	A	T	15	10	25	0	2	27	0	0
17	5927085	.	C	A	8	17	25	0	1	26	0	0
17	5927101	.	T	C	2	14	16	0	0	16	0	0
17	5927172	.	G	A	2	4	6	0	0	6	0	0
17	5927214	.	G	A	0	4	4	0	4	8	0	0
17	5927228	.	A	G	6	2	8	0	1	9	0	0
17	6016243	.	T	A	3	2	5	0	0	5	0	0
17	6016386	.	C	T	3	2	5	0	0	5	0	0
17	6016640	.	T	C	3	3	6	0	0	6	0	0
17	6065590	.	G	T	3	2	5	0	0	5	0	0
17	6079976	.	A	T	3	5	8	0	1	9	0	0
17	6088559	.	C	T	1	2	3	0	0	3	0	0
17	6097623	.	A	G	2	2	4	0	0	4	0	0
17	6279806	.	C	A	13	5	18	0	0	18	0	0
17	6279876	.	G	T	1	6	7	0	16	23	0	0
17	6394106	.	C	T	8	8	16	0	0	16	0	0
17	6394301	.	C	T	1	5	6	0	14	20	0	0
17	6394744	.	C	T	6	3	9	0	0	9	0	0
17	6395381	.	G	C	9	11	20	0	1	21	0	0
17	6395560	.	T	C	9	1	10	0	7	17	0	0
17	6395971	.	G	T	2	4	6	0	0	6	0	0
17	6396090	.	G	A	9	4	13	0	0	13	0	0
17	6396349	.	T	C	2	5	7	0	0	7	0	0
17	6396474	.	A	T	6	10	16	0	1	17	0	0
17	6396513	.	A	G	5	2	7	0	0	7	0	0
17	6397618	.	C	T	8	3	11	0	0	11	0	0
17	6397654	.	A	T	4	2	6	0	2	8	0	0
17	6397883	.	G	A	4	13	17	0	0	17	0	0
17	6397926	.	C	A	6	7	13	0	0	13	0	0
17	6398456	.	G	C	2	3	5	0	0	5	0	0
17	6398570	.	G	A	2	3	5	0	0	5	0	0
17	6398621	.	G	A	2	3	5	0	0	5	0	0
17	6398704	.	G	T	5	4	9	0	1	10	0	0
17	6398916	.	C	G	3	4	7	0	1	8	0	0
17	6398949	.	G	A	4	3	7	0	1	8	0	0
17	6398956	.	G	A	2	4	6	0	1	7	0	0
17	6438226	.	C	T	5	5	10	0	0	10	0	0
17	6438334	.	A	G	5	2	7	0	0	7	0	0
17	6438387	.	T	C	4	4	8	0	0	8	0	0
17	6438630	.	T	A	2	6	8	0	1	9	0	0
17	6444514	.	T	A	6	4	10	0	0	10	0	0
17	6447234	.	A	G	5	7	12	0	0	12	0	0
17	6447418	.	G	T	11	5	16	0	0	16	0	0
17	6449404	.	C	T	2	2	4	0	4	8	0	0
17	6451687	.	A	G	2	3	5	0	0	5	0	0
17	6451702	.	A	G	2	3	5	0	0	5	0	0
17	6460449	.	A	C	6	9	15	0	0	15	0	0
17	6462023	.	A	T	6	4	10	0	0	10	0	0
17	6462228	.	G	A	4	4	8	0	0	8	0	0
17	6462331	.	C	T	5	2	7	0	0	7	0	0
17	6491338	.	A	C	2	4	6	0	0	6	0	0
17	6544615	.	T	C	1	3	4	0	0	4	0	0
17	6555836	.	G	A	3	3	6	0	1	7	0	0
17	6555837	.	C	T	4	3	7	0	0	7	0	0
17	6715755	.	T	A	35	24	59	0	1	61	1	0
17	6716412	.	G	T	34	30	64	0	1	65	0	0
17	6716472	.	G	A	41	33	74	0	1	75	0	0
17	6730114	.	G	A	39	33	72	0	2	74	0	0
17	6737970	.	C	A	6	31	37	0	28	65	0	0
17	6738212	.	C	A	1	3	4	0	8	12	0	0
17	6754428	.	C	T	1	9	10	0	6	16	0	0
17	6754437	.	T	C	5	8	13	0	0	13	0	0
17	6758867	.	T	G	11	15	26	0	0	26	0	0
17	6808341	.	A	G	7	5	12	0	2	14	0	0
17	6937536	.	G	A	2	2	4	0	0	4	0	0
17	7780518	.	C	T	1	2	3	0	0	3	0	0
17	7780632	.	A	T	0	2	2	0	1	4	1	0
17	7781599	.	G	A	5	3	8	0	0	8	0	0
17	7781609	.	A	T	2	3	5	0	1	6	0	0
17	7781847	.	A	C	1	2	3	0	0	3	0	0
17	7783524	.	G	C	1	2	3	0	0	3	0	0
17	7802799	.	A	G	4	4	8	0	0	8	0	0
17	7818872	.	T	A	5	2	7	0	0	7	0	0
17	7844994	.	G	A	6	3	9	0	0	9	0	0
17	7845364	.	G	C	16	16	32	0	1	33	0	0
17	7845412	.	T	C	14	14	28	0	1	29	0	0
17	7845566	.	C	T	11	20	31	0	0	31	0	0
17	7861124	.	C	T	20	20	40	0	1	41	0	0
17	7868632	.	G	A	28	24	52	0	0	52	0	0
17	7879348	.	T	C	20	21	41	0	1	42	0	0
17	7882941	.	G	A	17	13	30	0	1	31	0	0
17	7882998	.	G	A	17	11	28	0	0	28	0	0
17	7885662	.	A	G	14	10	24	1	1	26	0	0
17	7894976	.	T	A	9	11	20	0	1	21	0	0
17	7895023	.	G	A	14	11	25	0	1	26	0	0
17	7896356	.	C	T	2	13	15	0	13	28	0	0
17	7896390	.	C	T	2	15	17	0	17	34	0	0
17	7896478	.	C	T	19	12	31	0	0	31	0	0
17	7901137	.	C	T	25	14	39	0	0	39	0	0
17	7906568	.	G	T	15	12	27	0	1	28	0	0
17	7906610	.	C	T	15	13	28	0	0	28	0	0
17	7906612	.	G	A	12	15	27	0	1	28	0	0
17	7906646	.	T	A	12	11	23	0	0	23	0	0
17	7907851	.	C	T	8	14	22	0	1	23	0	0
17	7917997	.	G	A	12	11	23	0	1	24	0	0
17	7926040	.	G	A	7	11	18	0	1	19	0	0
17	7926076	.	C	T	11	6	17	0	2	19	0	0
17	7928263	.	A	G	9	6	15	0	1	16	0	0
17	7928600	.	C	A	2	6	8	0	16	24	0	0
17	7931737	.	G	A	3	8	11	0	0	11	0	0
17	7942122	.	G	A	9	4	13	0	0	13	0	0
17	7942127	.	T	C	8	4	12	0	1	13	0	0
17	7942191	.	T	G	4	6	10	0	1	11	0	0
17	7942366	.	T	G	10	9	19	0	3	22	0	0
17	7945421	.	C	G	8	10	18	0	3	21	0	0
17	7945485	.	A	G	7	8	15	1	0	16	0	0
17	7949042	.	G	A	6	11	17	0	0	17	0	0
17	7949066	.	G	A	5	14	19	0	1	20	0	0
17	7950372	.	C	T	9	7	16	0	0	16	0	0
17	7963202	.	G	C	7	3	10	0	1	11	0	0
17	7963236	.	G	A	5	6	11	0	0	11	0	0
17	7963282	.	G	A	5	6	11	0	0	11	0	0
17	7963294	.	G	A	6	6	12	0	0	12	0	0
17	7974804	.	T	C	5	9	14	0	0	14	0	0
17	7977746	.	A	T	3	2	5	0	0	5	0	0
17	7977806	.	C	T	4	2	6	0	0	6	0	0
17	7983068	.	A	G	4	3	7	0	1	8	0	0
17	7984355	.	G	A	9	3	12	0	0	12	0	0
17	7985543	.	A	G	1	3	4	0	0	4	0	0
17	7986359	.	T	C	5	6	11	0	0	11	0	0
17	7991338	.	G	A	7	9	16	0	1	17	0	0
17	8000049	.	T	C	3	3	6	0	1	7	0	0
17	8000122	.	C	A	3	3	6	0	0	6	0	0
17	8002978	.	G	A	4	4	8	0	0	8	0	0
17	8003009	.	G	A	5	4	9	0	0	9	0	0
17	8003027	.	T	C	4	5	9	0	1	10	0	0
17	8006696	.	T	C	4	3	7	0	1	8	0	0
17	8012299	.	T	C	5	2	7	0	0	7	0	0
17	8015404	.	G	A	5	4	9	0	0	9	0	0
17	8022605	.	G	A	1	2	3	0	0	3	0	0
17	8024338	.	C	T	3	3	6	0	0	6	0	0
17	8024551	.	G	A	4	3	7	0	0	7	0	0
17	8032895	.	C	T	2	6	8	0	0	8	0	0
17	8036263	.	C	T	0	4	4	0	3	7	0	0
17	8041978	.	C	T	2	5	7	0	0	7	0	0
17	8042148	.	G	A	4	3	7	0	0	7	0	0
17	8044522	.	C	T	0	2	2	0	1	3	0	0
17	8048934	.	A	G	2	2	4	0	0	4	0	0
17	8054868	.	A	T	1	4	5	0	0	5	0	0
17	8056251	.	A	T	3	4	7	0	0	7	0	0
17	8060057	.	G	A	2	2	4	0	0	4	0	0
17	8060110	.	G	A	1	3	4	0	0	4	0	0
17	8060288	.	T	C	1	3	4	0	0	4	0	0
17	8071617	.	A	G	2	2	4	0	0	4	0	0
17	8071629	.	G	A	2	2	4	0	0	4	0	0
17	8178864	.	T	C	2	4	6	0	0	6	0	0
17	8178878	.	G	A	2	2	4	0	1	5	0	0
17	8184435	.	A	G	6	0	6	0	4	10	0	0
17	8188963	.	G	T	1	7	8	0	3	11	0	0
17	8191475	.	A	G	6	15	21	0	0	21	0	0
17	8197141	.	G	A	4	11	15	0	0	15	0	0
17	8197569	.	C	A	10	5	15	0	1	16	0	0
17	8199812	.	C	T	8	3	11	0	0	11	0	0
17	8199824	.	G	A	5	10	15	0	0	15	0	0
17	8199896	.	T	C	6	4	10	0	1	11	0	0
17	8202712	.	G	A	1	12	13	0	18	31	0	0
17	8202742	.	G	A	2	15	17	0	18	35	0	0
17	8202778	.	T	C	20	12	32	0	1	33	0	0
17	8203468	.	G	A	19	14	33	0	1	34	0	0
17	8203498	.	G	A	18	13	31	0	1	32	0	0
17	8204086	.	G	C	14	7	21	0	0	21	0	0
17	8204087	.	C	T	12	7	19	0	0	19	0	0
17	8204248	.	A	G	16	0	16	0	14	30	0	0
17	8204533	.	C	T	11	18	29	0	1	30	0	0
17	8204755	.	A	G	19	30	49	0	1	50	0	0
17	8204818	.	A	G	15	18	33	0	2	35	0	0
17	8204935	.	T	C	27	14	41	0	0	41	0	0
17	8204962	.	C	T	26	9	35	0	1	36	0	0
17	8205340	.	A	T	15	18	33	0	1	34	0	0
17	8205697	.	A	G	18	17	35	0	3	38	0	0
17	8209315	.	T	C	13	8	21	0	2	23	0	0
17	8209327	.	C	T	9	13	22	0	0	22	0	0
17	8209837	.	T	A	6	23	29	0	1	30	0	0
17	8209931	.	C	A	11	16	27	0	0	27	0	0
17	8209944	.	A	G	14	9	23	0	1	24	0	0
17	8210203	.	G	A	7	10	17	0	0	17	0	0
17	8210242	.	C	T	10	12	22	0	2	24	0	0
17	8210411	.	A	G	7	16	23	0	3	26	0	0
17	8210466	.	A	G	9	0	9	0	10	19	0	0
17	8245790	.	C	A	2	3	5	0	8	13	0	0
17	8246281	.	G	A	4	3	7	0	0	7	0	0
17	8246329	.	T	C	8	5	13	0	1	14	0	0
17	8246341	.	A	G	9	5	14	0	0	14	0	0
17	8248987	.	A	G	3	4	7	0	1	8	0	0
17	8249153	.	A	T	3	7	10	0	0	10	0	0
17	8253455	.	T	A	2	2	4	0	0	4	0	0
17	8253479	.	G	T	1	2	3	0	1	4	0	0
17	8256663	.	G	A	3	2	5	0	0	5	0	0
17	8261565	.	G	A	2	4	6	0	1	7	0	0
17	8261762	.	C	T	2	6	8	0	0	8	0	0
17	8261769	.	G	A	2	6	8	0	0	8	0	0
17	8265406	.	G	A	3	2	5	0	0	5	0	0
17	8272459	.	T	C	2	3	5	0	0	5	0	0
17	8283891	.	T	C	2	3	5	0	0	5	0	0
17	8283892	.	G	T	2	3	5	0	0	5	0	0
17	8286619	.	G	C	6	2	8	0	2	10	0	0
17	8286877	.	A	G	3	2	5	0	0	5	0	0
17	8286879	.	C	A	3	2	5	0	0	5	0	0
17	8287082	.	A	C	4	2	6	0	0	6	0	0
17	8419191	.	A	G	1	3	4	0	0	4	0	0
17	8502883	.	G	A	6	5	11	0	0	11	0	0
17	8502934	.	A	G	7	7	14	0	1	15	0	0
17	8514634	.	G	A	2	3	5	0	0	5	0	0
17	8514648	.	A	G	1	3	4	0	2	6	0	0
17	8515222	.	C	A	3	2	5	0	0	5	0	0
17	8515462	.	A	G	5	7	12	0	1	13	0	0
17	8518938	.	T	C	6	0	6	0	6	12	0	0
17	8519109	.	A	G	1	2	3	0	0	3	0	0
17	8562349	.	A	G	2	2	4	0	0	4	0	0
17	8562551	.	G	C	3	0	3	0	5	8	0	0
17	8562560	.	T	A	4	2	6	0	0	6	0	0
17	8562646	.	A	G	1	2	3	0	0	3	0	0
17	8570141	.	T	C	2	3	5	0	0	5	0	0
17	8597174	.	T	A	16	11	27	0	0	27	0	0
17	8597702	.	A	T	16	9	25	1	0	26	0	0
17	8597871	.	T	C	21	11	32	0	0	32	0	0
17	8597965	.	T	A	25	20	45	1	2	48	0	0
17	8611580	.	G	A	20	21	41	0	2	43	0	0
17	8620866	.	A	G	29	9	38	2	1	41	0	0
17	8623396	.	G	A	15	23	38	0	0	38	0	0
17	8623456	.	T	C	23	19	42	0	3	45	0	0
17	8727654	.	A	T	4	2	6	0	0	6	0	0
17	8754343	.	T	C	2	3	5	0	0	5	0	0
17	8760493	.	T	C	3	3	6	0	0	6	0	0
17	8766176	.	G	A	2	4	6	0	0	6	0	0
17	8770161	.	C	G	6	4	10	0	0	10	0	0
17	8772665	.	C	T	3	3	6	0	0	6	0	0
17	8772776	.	C	T	1	3	4	0	0	4	0	0
17	8772800	.	G	A	2	2	4	0	0	4	0	0
17	8780716	.	G	A	3	5	8	0	0	8	0	0
17	8782396	.	C	T	2	2	4	0	1	5	0	0
17	8784682	.	T	C	5	4	9	0	0	9	0	0
17	8785801	.	T	C	6	3	9	0	0	9	0	0
17	8785804	.	T	C	5	3	8	0	0	8	0	0
17	8789449	.	G	A	4	2	6	0	0	6	0	0
17	8791573	.	A	T	1	7	8	0	1	9	0	0
17	8791841	.	T	G	3	4	7	0	0	7	0	0
17	8791863	.	C	T	5	2	7	0	0	7	0	0
17	8927638	.	A	G	7	20	27	0	1	28	0	0
17	8927641	.	A	G	9	19	28	0	0	28	0	0
17	8934223	.	G	A	18	13	31	0	2	33	0	0
17	8934307	.	C	T	20	15	35	0	0	35	0	0
17	8937918	.	G	A	16	11	27	0	2	29	0	0
17	8937954	.	G	A	16	15	31	0	2	33	0	0
17	8938023	.	C	T	20	10	30	0	0	30	0	0
17	8938249	.	T	C	14	23	37	0	0	37	0	0
17	8938269	.	G	A	22	15	37	0	1	38	0	0
17	8938305	.	T	A	17	22	39	0	0	39	0	0
17	8941309	.	T	C	9	7	16	0	0	16	0	0
17	8941320	.	C	T	10	6	16	0	0	16	0	0
17	8951606	.	C	G	1	13	14	0	11	25	0	0
17	8951644	.	C	T	1	12	13	0	18	31	0	0
17	8951655	.	T	C	19	15	34	0	0	34	0	0
17	8951867	.	C	T	3	15	18	0	20	38	0	0
17	8964520	.	G	A	21	11	32	0	1	33	0	0
17	8969278	.	A	G	12	19	31	0	1	32	0	0
17	8969296	.	G	A	10	24	34	0	1	35	0	0
17	9018124	.	C	T	1	4	5	0	0	5	0	0
17	9018199	.	G	C	2	2	4	0	0	4	0	0
17	9041364	.	C	T	3	7	10	0	0	10	0	0
17	9041409	.	A	T	3	4	7	0	0	7	0	0
17	9041419	.	C	T	3	6	9	0	0	9	0	0
17	9041460	.	A	G	3	8	11	0	0	11	0	0
17	9041916	.	C	G	4	0	4	0	5	9	0	0
17	9042223	.	A	G	5	7	12	0	0	12	0	0
17	9042447	.	C	T	7	6	13	0	0	13	0	0
17	9042608	.	G	C	12	5	17	0	0	17	0	0
17	9042652	.	T	C	2	12	14	0	0	14	0	0
17	9143323	.	G	A	6	7	13	0	1	14	0	0
17	9157385	.	A	G	7	4	11	0	2	13	0	0
17	9225184	.	G	A	0	9	9	0	16	25	0	0
17	9225223	.	A	G	8	10	18	0	1	19	0	0
17	9248656	.	A	G	8	0	8	1	6	15	0	0
17	9253504	.	A	T	9	5	14	0	0	14	0	0
17	9253705	.	T	C	5	9	14	0	0	14	0	0
17	9254269	.	T	A	5	7	12	0	0	12	0	0
17	9255547	.	G	C	14	12	26	0	0	26	0	0
17	9255703	.	C	T	17	12	29	0	1	30	0	0
17	9266298	.	C	T	10	19	29	0	1	30	0	0
17	9266501	.	G	T	2	12	14	0	16	30	0	0
17	9501615	.	G	A	1	5	6	0	6	12	0	0
17	9601121	.	G	C	9	4	13	0	0	13	0	0
17	9601133	.	C	T	8	7	15	0	0	15	0	0
17	9847212	.	C	T	6	7	13	0	2	15	0	0
17	9847215	.	C	T	8	6	14	0	2	16	0	0
17	9884342	.	A	G	10	9	19	0	1	20	0	0
17	9888958	.	C	G	7	15	22	0	0	22	0	0
17	9889127	.	T	A	9	8	17	0	3	20	0	0
17	9889223	.	C	T	17	10	27	0	0	27	0	0
17	9889313	.	T	A	15	6	21	0	4	25	0	0
17	9889427	.	G	A	6	14	20	0	1	21	0	0
17	9889728	.	A	T	7	8	15	0	2	17	0	0
17	9889745	.	A	G	7	1	8	0	12	20	0	0
17	9891721	.	C	T	13	3	16	0	0	16	0	0
17	9944647	.	T	C	1	3	4	0	1	5	0	0
17	9944848	.	T	A	8	5	13	0	0	13	0	0
17	9944996	.	G	T	3	3	6	0	0	6	0	0
17	9944999	.	G	A	4	3	7	0	0	7	0	0
17	9945176	.	T	A	4	7	11	0	1	12	0	0
17	9945178	.	T	G	3	6	9	0	3	12	0	0
17	9951885	.	G	A	3	7	10	0	0	10	0	0
17	9952033	.	C	T	2	6	8	0	8	16	0	0
17	9955952	.	C	T	3	4	7	0	0	7	0	0
17	9957913	.	T	A	3	3	6	0	0	6	0	0
17	9962399	.	C	A	4	8	12	0	1	13	0	0
17	9963519	.	G	A	3	3	6	0	1	7	0	0
17	9964019	.	G	A	3	2	5	0	1	6	0	0
17	9964072	.	A	G	5	2	7	3	0	10	0	0
17	9964334	.	T	A	3	2	5	0	1	6	0	0
17	9964437	.	A	T	4	5	9	0	0	9	0	0
17	9964663	.	C	A	1	4	5	0	0	5	0	0
17	9964912	.	G	A	5	5	10	0	1	11	0	0
17	9964944	.	C	A	6	4	10	0	0	10	0	0
17	9964954	.	T	A	3	2	5	0	0	5	0	0
17	9965231	.	T	C	3	0	3	0	3	6	0	0
17	9967566	.	G	A	3	7	10	0	0	10	0	0
17	9972748	.	C	T	3	2	5	0	1	6	0	0
17	9975334	.	C	G	3	2	5	0	0	5	0	0
17	10143801	.	A	G	13	1	14	0	8	22	0	0
17	10143808	.	A	G	7	10	17	0	2	19	0	0
17	10144377	.	A	G	1	3	4	0	0	4	0	0
17	12021802	.	C	T	1	2	3	0	1	4	0	0
17	12021813	.	C	T	1	2	3	0	3	6	0	0
17	12058522	.	G	T	2	6	8	0	11	19	0	0
17	12060478	.	G	A	0	6	6	0	1	7	0	0
17	12060545	.	C	T	4	4	8	0	0	8	0	0
17	12060587	.	A	G	8	7	15	0	1	16	0	0
17	12060627	.	C	T	10	8	18	0	0	18	0	0
17	12060631	.	G	A	0	9	9	0	9	18	0	0
17	12060799	.	A	G	6	7	13	0	1	14	0	0
17	12068675	.	G	C	12	7	19	0	0	19	0	0
17	12072890	.	C	T	9	9	18	0	1	19	0	0
17	12072977	.	T	C	11	9	20	0	1	21	0	0
17	12073037	.	C	T	4	13	17	0	0	17	0	0
17	12073324	.	G	A	1	2	3	0	1	4	0	0
17	12088799	.	G	A	1	3	4	0	4	8	0	0
17	12089069	.	G	C	3	2	5	0	0	5	0	0
17	12134673	.	T	G	6	5	11	0	0	11	0	0
17	12134693	.	C	A	3	4	7	0	0	7	0	0
17	12134709	.	C	T	4	4	8	0	1	9	0	0
17	12135206	.	G	A	2	7	9	0	0	9	0	0
17	12135322	.	A	T	5	5	10	0	0	10	0	0
17	12135432	.	A	G	1	4	5	0	0	5	0	0
17	12221666	.	T	C	2	2	4	0	1	5	0	0
17	12221788	.	C	A	0	3	3	0	1	4	0	0
17	12221891	.	G	A	8	3	11	0	0	11	0	0
17	12221903	.	C	T	0	3	3	0	8	11	0	0
17	12222005	.	T	G	4	3	7	0	0	7	0	0
17	12222226	.	A	G	8	5	13	0	0	13	0	0
17	12222235	.	G	T	10	3	13	0	0	13	0	0
17	12223514	.	G	A	12	10	22	0	0	22	0	0
17	12223743	.	G	A	12	12	24	0	0	24	0	0
17	12223883	.	C	G	6	7	13	0	0	13	0	0
17	12223884	.	T	A	6	7	13	0	0	13	0	0
17	12223971	.	G	A	7	6	13	0	0	13	0	0
17	12223989	.	C	A	0	5	5	0	9	14	0	0
17	12224581	.	T	C	7	0	7	0	8	15	0	0
17	12224976	.	G	A	12	6	18	0	0	18	0	0
17	12225070	.	G	A	15	6	21	0	1	22	0	0
17	12225271	.	G	A	4	7	11	0	0	11	0	0
17	12225292	.	C	T	0	7	7	0	2	9	0	0
17	12225418	.	T	G	7	8	15	0	0	15	0	0
17	12225756	.	C	A	4	3	7	0	0	7	0	0
17	12225843	.	T	G	10	4	14	0	0	15	1	0
17	12225867	.	C	T	1	5	6	0	13	19	0	0
17	12226404	.	C	T	5	4	9	0	0	9	0	0
17	12226594	.	G	A	8	7	15	0	2	17	0	0
17	12227034	.	C	T	1	2	3	0	3	6	0	0
17	12227340	.	T	A	2	3	5	0	0	5	0	0
17	12227730	.	G	C	1	0	1	0	3	4	0	0
17	12227909	.	G	A	5	4	9	0	0	9	0	0
17	12228177	.	G	A	5	7	12	0	0	12	0	0
17	12229800	.	G	T	3	6	9	0	0	9	0	0
17	12235791	.	A	G	2	2	4	0	1	5	0	0
17	12236457	.	G	T	2	3	5	0	0	5	0	0
17	12236460	.	G	A	3	2	5	0	0	5	0	0
17	12236571	.	G	A	1	5	6	0	0	6	0	0
17	12239955	.	T	C	4	0	4	0	5	9	0	0
17	12249880	.	C	T	7	5	12	0	0	12	0	0
17	12249882	.	A	T	6	5	11	0	1	12	0	0
17	12298106	.	G	T	31	31	62	0	6	68	0	0
17	12302409	.	G	A	29	41	70	0	2	72	0	0
17	12302496	.	C	T	46	42	88	3	2	93	0	0
17	12385303	.	T	C	1	0	1	0	3	4	0	0
17	12408447	.	C	T	10	9	19	0	0	19	0	0
17	12408454	.	G	C	8	9	17	0	2	19	0	0
17	12418130	.	C	A	6	9	15	0	1	16	0	0
17	12422810	.	A	G	4	0	4	0	6	10	0	0
17	12700653	.	A	G	20	31	51	0	1	52	0	0
17	12702780	.	C	T	16	18	34	0	0	34	0	0
17	12702801	.	A	G	18	1	19	0	17	36	0	0
17	12702831	.	C	A	18	18	36	0	2	38	0	0
17	12708393	.	A	G	5	8	13	0	0	13	0	0
17	12708404	.	C	A	5	5	10	0	0	10	0	0
17	12708903	.	T	C	16	22	38	0	0	38	0	0
17	12709244	.	T	G	7	13	20	0	2	22	0	0
17	12737483	.	G	A	0	4	4	0	6	10	0	0
17	12741500	.	T	C	4	4	8	0	1	9	0	0
17	12741518	.	C	T	5	4	9	0	0	9	0	0
17	12742971	.	A	G	2	7	9	0	0	9	0	0
17	12742974	.	C	T	1	6	7	0	0	7	0	0
17	12747827	.	C	T	6	2	8	0	0	8	0	0
17	12753717	.	A	C	8	3	11	0	0	11	0	0
17	12753792	.	G	A	8	10	18	0	0	18	0	0
17	12753823	.	A	G	7	8	15	0	0	15	0	0
17	12753916	.	T	A	12	3	15	0	1	16	0	0
17	12753940	.	A	T	15	3	18	0	1	19	0	0
17	12754071	.	A	G	14	8	22	0	0	22	0	0
17	12754158	.	A	T	9	9	18	0	1	19	0	0
17	12754198	.	A	T	9	6	15	0	0	15	0	0
17	12758472	.	T	G	14	4	18	0	0	18	0	0
17	12758823	.	T	C	16	8	24	0	1	25	0	0
17	12759072	.	G	A	13	6	19	0	1	20	0	0
17	12759135	.	C	T	14	9	23	0	0	23	0	0
17	12761221	.	G	C	11	5	16	0	2	18	0	0
17	12762852	.	T	C	12	5	17	0	1	18	0	0
17	12764004	.	C	T	1	9	10	0	11	21	0	0
17	12764090	.	G	T	10	6	16	0	0	16	0	0
17	12764244	.	A	T	9	3	12	0	0	12	0	0
17	12764247	.	G	T	5	2	7	0	4	11	0	0
17	12797241	.	C	G	3	4	7	0	0	7	0	0
17	12797280	.	C	T	1	5	6	0	1	7	0	0
17	12799132	.	C	T	4	3	7	0	0	7	0	0
17	12806340	.	C	G	6	4	10	0	0	10	0	0
17	12806360	.	C	T	5	4	9	0	0	9	0	0
17	12806381	.	T	C	3	4	7	0	0	7	0	0
17	12809332	.	T	C	7	2	9	0	0	9	0	0
17	12811215	.	C	T	2	7	9	0	1	10	0	0
17	12812661	.	C	T	2	7	9	0	0	9	0	0
17	12818580	.	T	C	6	6	12	0	1	13	0	0
17	12818664	.	A	G	5	6	11	0	0	11	0	0
17	12818718	.	C	A	5	6	11	0	0	11	0	0
17	12825732	.	C	T	6	4	10	0	2	12	0	0
17	12825741	.	G	A	3	4	7	0	5	12	0	0
17	12851473	.	T	G	7	4	11	0	0	11	0	0
17	12851518	.	G	A	0	6	6	0	10	16	0	0
17	12851831	.	T	G	9	7	16	0	2	18	0	0
17	12858173	.	C	T	9	14	23	0	0	23	0	0
17	12858658	.	G	C	14	10	24	0	0	24	0	0
17	12858765	.	A	G	8	12	20	0	0	20	0	0
17	12865807	.	C	T	13	7	20	0	0	20	0	0
17	12867975	.	G	A	7	14	21	0	2	23	0	0
17	12881532	.	G	A	12	18	30	0	0	30	0	0
17	12881590	.	G	A	1	12	13	0	12	25	0	0
17	12922410	.	A	T	18	7	25	0	1	26	0	0
17	12922678	.	A	G	8	9	17	0	2	19	0	0
17	12923028	.	A	G	10	19	29	0	0	29	0	0
17	12923131	.	A	G	9	1	10	0	8	18	0	0
17	12923303	.	A	G	10	2	12	0	14	26	0	0
17	12923509	.	A	T	5	6	11	0	0	11	0	0
17	12925020	.	G	A	6	4	10	0	0	10	0	0
17	12958744	.	G	A	9	8	17	0	1	18	0	0
17	12963487	.	A	C	10	1	11	0	20	31	0	0
17	12963571	.	G	A	13	17	30	0	0	30	0	0
17	12965499	.	A	G	7	10	17	0	0	17	0	0
17	12972969	.	A	G	3	2	5	0	0	5	0	0
17	12977682	.	T	C	5	0	5	0	5	10	0	0
17	13005936	.	T	C	4	3	7	0	0	7	0	0
17	13006372	.	A	G	1	4	5	0	0	5	0	0
17	13006550	.	A	G	3	2	5	0	0	5	0	0
17	13006859	.	G	A	3	2	5	0	0	5	0	0
17	13006874	.	A	T	3	3	6	0	0	6	0	0
17	13013109	.	T	C	3	3	6	0	0	6	0	0
17	13019988	.	T	A	15	18	33	0	1	34	0	0
17	13020090	.	G	A	9	9	18	0	0	18	0	0
17	13020187	.	A	C	17	11	28	0	0	28	0	0
17	13020472	.	T	C	13	9	22	0	1	23	0	0
17	13020476	.	T	A	13	11	24	0	1	25	0	0
17	13020601	.	C	T	1	9	10	0	13	23	0	0
17	13020733	.	C	G	14	13	27	1	2	30	0	0
17	13023022	.	G	A	12	9	21	0	0	21	0	0
17	13023289	.	T	C	11	11	22	0	2	24	0	0
17	13023407	.	A	C	12	15	27	0	0	27	0	0
17	13026599	.	A	T	4	5	9	0	1	10	0	0
17	13032557	.	A	G	5	0	5	0	7	12	0	0
17	13032558	.	A	G	6	5	11	0	2	13	0	0
17	13045540	.	G	T	11	6	17	0	0	17	0	0
17	13045559	.	A	C	10	6	16	0	0	16	0	0
17	13045794	.	T	A	11	6	17	0	1	18	0	0
17	13045882	.	A	T	13	8	21	0	0	21	0	0
17	13046058	.	T	G	12	3	15	0	0	15	0	0
17	13046099	.	G	A	13	5	18	0	0	18	0	0
17	13052081	.	C	T	0	8	8	0	12	20	0	0
17	13057986	.	T	A	10	7	17	0	0	17	0	0
17	13058349	.	T	A	10	5	15	0	1	16	0	0
17	13058354	.	G	A	7	7	14	0	1	15	0	0
17	13061715	.	G	A	7	6	13	0	1	14	0	0
17	13061726	.	G	T	7	8	15	0	0	15	0	0
17	13061839	.	T	C	8	0	8	0	8	16	0	0
17	13061849	.	C	G	8	8	16	0	1	17	0	0
17	13064531	.	C	T	6	13	19	0	1	20	0	0
17	13066963	.	T	A	6	9	15	0	1	16	0	0
17	13067015	.	G	C	8	7	15	0	0	15	0	0
17	13067018	.	C	T	0	7	7	0	9	16	0	0
17	13068561	.	G	A	6	8	14	0	0	14	0	0
17	13070504	.	T	C	6	6	12	0	0	12	0	0
17	13071678	.	T	A	5	6	11	0	1	12	0	0
17	13091660	.	T	G	9	10	19	0	0	19	0	0
17	13094135	.	G	A	6	11	17	0	1	18	0	0
17	13097239	.	C	T	1	5	6	0	1	7	0	0
17	13102057	.	A	G	20	15	35	0	1	36	0	0
17	13107061	.	A	G	15	1	16	0	16	32	0	0
17	13108626	.	G	T	15	20	35	0	2	37	0	0
17	13109010	.	A	G	23	23	46	0	0	46	0	0
17	13109042	.	T	C	27	13	40	3	0	43	0	0
17	13109097	.	A	T	14	16	30	0	3	33	0	0
17	13109409	.	C	T	21	15	36	0	0	36	0	0
17	13109793	.	A	C	19	8	27	0	0	27	0	0
17	13109818	.	T	C	16	9	25	0	0	25	0	0
17	13109910	.	A	G	14	0	14	1	10	25	0	0
17	13109928	.	G	T	2	13	15	1	13	29	0	0
17	13109990	.	T	A	18	15	33	0	1	34	0	0
17	13110003	.	C	G	15	18	33	0	1	34	0	0
17	13110043	.	C	T	7	9	16	0	1	17	0	0
17	13110090	.	A	T	3	2	5	0	0	5	0	0
17	15633530	.	C	T	8	4	12	1	0	13	0	0
17	15633721	.	T	C	7	6	13	0	1	14	0	0
17	15635459	.	A	T	1	2	3	0	0	4	1	0
17	15741117	.	A	G	9	3	12	0	0	12	0	0
17	15741554	.	A	G	5	2	7	0	2	9	0	0
17	16804700	.	A	G	3	15	18	0	0	18	0	0
17	16804958	.	C	A	4	2	6	0	6	12	0	0
17	18179927	.	T	C	11	5	16	0	6	22	0	0
17	19420197	.	C	T	14	11	25	0	0	25	0	0
17	19420434	.	C	T	2	5	7	0	7	14	0	0
17	19420563	.	T	G	8	11	19	0	0	19	0	0
17	19421109	.	C	G	6	8	14	0	3	17	0	0
17	19421248	.	T	G	12	11	23	0	1	24	0	0
17	19421636	.	T	C	10	0	10	0	13	23	0	0
17	19421667	.	A	G	9	11	20	0	2	22	0	0
17	19421948	.	C	T	4	11	15	0	1	16	0	0
17	19421955	.	A	T	5	12	17	0	0	17	0	0
17	19422452	.	C	T	1	3	4	0	6	10	0	0
17	19423145	.	C	T	6	5	11	0	1	12	0	0
17	19423375	.	A	T	4	6	10	0	1	11	0	0
17	19423586	.	A	T	6	6	12	0	1	13	0	0
17	19423713	.	G	A	6	3	9	0	0	9	0	0
17	19429290	.	T	C	8	0	8	0	9	17	0	0
17	19431175	.	C	A	0	7	7	0	6	13	0	0
17	19431439	.	C	T	1	4	5	0	4	9	0	0
17	19431481	.	G	A	3	8	11	0	0	11	0	0
17	19431718	.	G	A	5	8	13	0	0	13	0	0
17	19440149	.	T	G	6	3	9	0	0	9	0	0
17	19440460	.	T	C	4	0	4	0	11	15	0	0
17	19440492	.	G	A	8	7	15	0	1	16	0	0
17	19440500	.	T	G	8	7	15	0	0	15	0	0
17	19443394	.	A	G	5	7	12	0	0	12	0	0
17	19446034	.	C	G	1	5	6	0	0	6	0	0
17	19448648	.	G	A	1	3	4	0	0	4	0	0
17	19448684	.	G	T	1	4	5	0	0	5	0	0
17	19448792	.	C	T	4	2	6	0	0	6	0	0
17	19451644	.	G	A	2	5	7	0	0	7	0	0
17	19451650	.	A	G	2	5	7	0	0	7	0	0
17	19451892	.	C	A	0	3	3	0	1	4	0	0
17	19452120	.	G	T	3	3	6	0	0	6	0	0
17	19452235	.	C	T	1	2	3	0	0	3	0	0
17	19454491	.	A	G	6	2	8	0	1	9	0	0
17	19454791	.	C	T	5	3	8	0	1	9	0	0
17	19454806	.	A	G	6	3	9	0	1	10	0	0
17	19455080	.	C	T	1	4	5	0	1	6	0	0
17	19455386	.	C	G	1	3	4	0	0	4	0	0
17	19460026	.	T	C	4	4	8	0	0	8	0	0
17	19460095	.	G	A	1	5	6	0	0	6	0	0
17	19499276	.	A	T	5	3	8	0	1	9	0	0
17	19499281	.	G	C	5	4	9	0	0	9	0	0
17	19499326	.	C	T	5	2	7	0	0	7	0	0
17	19502407	.	T	C	6	2	8	0	1	9	0	0
17	19506474	.	C	T	1	6	7	0	0	7	0	0
17	19506575	.	A	C	2	3	5	0	0	5	0	0
17	19506934	.	G	A	2	4	6	0	4	10	0	0
17	19506943	.	A	C	6	5	11	0	0	11	0	0
17	19510714	.	G	A	8	5	13	0	1	14	0	0
17	19527229	.	G	A	1	2	3	0	0	3	0	0
17	19607654	.	A	T	6	7	13	0	0	13	0	0
17	19607835	.	T	A	6	9	15	0	0	15	0	0
17	19607950	.	C	G	1	4	5	0	0	5	0	0
17	19607983	.	T	G	1	4	5	0	0	5	0	0
17	19608105	.	G	A	1	2	3	0	0	3	0	0
17	19608255	.	A	T	1	2	3	0	0	3	0	0
17	19608612	.	C	T	0	4	4	0	1	5	0	0
17	19608741	.	A	G	6	5	11	0	0	11	0	0
17	19608758	.	C	T	5	4	9	0	0	9	0	0
17	19609013	.	C	T	0	5	5	0	3	8	0	0
17	19609276	.	C	T	3	5	8	0	1	9	0	0
17	19609286	.	T	A	4	3	7	0	0	7	0	0
17	19609311	.	G	A	3	3	6	0	0	6	0	0
17	19692573	.	A	C	12	12	24	0	0	24	0	0
17	19715899	.	T	C	13	20	33	0	2	35	0	0
17	19755158	.	C	G	1	3	4	0	2	6	0	0
17	19755320	.	T	C	1	0	1	0	2	3	0	0
17	19755324	.	T	C	1	1	2	0	0	2	0	0
17	19755922	.	C	T	0	2	2	0	1	3	0	0
17	19756009	.	A	C	5	4	9	0	0	9	0	0
17	19756046	.	T	C	4	3	7	0	0	7	0	0
17	19756051	.	T	C	1	5	6	0	0	6	0	0
17	19756277	.	A	G	3	2	5	0	0	5	0	0
17	19756437	.	G	A	2	2	4	0	0	4	0	0
17	19757177	.	T	A	2	3	5	0	0	5	0	0
17	19757193	.	A	G	3	3	6	0	0	6	0	0
17	19757408	.	G	A	2	3	5	0	0	5	0	0
17	19757450	.	G	T	1	2	3	0	0	3	0	0
17	19757456	.	C	T	1	1	2	0	0	2	0	0
17	19827623	.	G	A	1	1	2	0	1	3	0	0
17	19831852	.	C	T	0	3	3	0	5	8	0	0
17	19831910	.	G	C	2	4	6	0	0	6	0	0
17	19831968	.	T	C	4	3	7	0	0	7	0	0
17	19831980	.	A	T	5	4	9	0	0	9	0	0
17	19833222	.	A	G	4	6	10	0	0	10	0	0
17	19833918	.	G	A	2	2	4	0	0	4	0	0
17	19834038	.	G	T	1	5	6	0	0	6	0	0
17	19834314	.	G	A	2	3	5	0	0	5	0	0
17	20147756	.	A	C	2	6	8	0	0	8	0	0
17	20147771	.	A	G	3	7	10	0	0	10	0	0
17	20147804	.	C	A	1	3	4	0	0	4	0	0
17	20149668	.	G	A	4	5	9	0	0	9	0	0
17	20151769	.	G	T	2	3	5	0	0	5	0	0
17	20188819	.	T	G	1	3	4	0	0	4	0	0
17	20188836	.	C	T	1	2	3	0	0	3	0	0
17	20189047	.	A	T	3	11	14	0	1	15	0	0
17	20191569	.	T	C	3	0	3	0	9	12	0	0
17	20191941	.	A	G	4	4	8	0	0	8	0	0
17	20191956	.	A	G	4	4	8	0	0	8	0	0
17	20196194	.	A	G	7	3	10	0	0	10	0	0
17	20196770	.	G	A	6	3	9	0	0	9	0	0
17	20196784	.	C	T	4	2	6	0	1	7	0	0
17	20196809	.	A	G	5	4	9	0	0	9	0	0
17	20198764	.	G	T	9	3	12	0	2	14	0	0
17	20198914	.	T	C	6	0	6	0	4	10	0	0
17	20202365	.	C	G	1	5	6	0	4	10	0	0
17	20202391	.	G	A	5	4	9	0	0	9	0	0
17	20207216	.	G	T	4	2	6	0	0	6	0	0
17	20207260	.	T	A	2	2	4	0	1	5	0	0
17	20214550	.	C	T	2	4	6	0	1	7	0	0
17	20214570	.	C	A	7	3	10	0	0	10	0	0
17	20214757	.	T	C	4	6	10	0	0	10	0	0
17	20214766	.	T	C	5	1	6	0	4	10	0	0
17	20215498	.	G	A	4	4	8	0	0	8	0	0
17	20215570	.	A	C	5	0	5	0	4	9	0	0
17	20215739	.	T	C	3	3	6	0	0	6	0	0
17	20218318	.	T	C	1	0	1	0	3	4	0	0
17	20226226	.	T	C	1	2	3	0	0	3	0	0
17	20232143	.	C	T	2	3	5	0	1	6	0	0
17	20232144	.	C	A	2	3	5	0	1	6	0	0
17	20232189	.	T	A	3	3	6	0	0	6	0	0
17	20232267	.	C	A	2	2	4	0	0	4	0	0
17	20232526	.	G	T	2	6	8	0	0	8	0	0
17	20235494	.	G	A	3	4	7	0	0	7	0	0
17	20243035	.	A	G	12	1	13	0	20	33	0	0
17	20243375	.	C	A	24	25	49	0	2	51	0	0
17	20243564	.	G	A	13	12	25	0	1	26	0	0
17	20243611	.	G	A	14	12	26	0	0	26	0	0
17	20248398	.	A	G	26	18	44	0	0	44	0	0
17	20248455	.	A	T	20	19	39	0	0	39	0	0
17	20248479	.	T	C	16	20	36	0	6	42	0	0
17	20248500	.	C	G	3	17	20	0	21	41	0	0
17	20248705	.	T	C	22	1	23	0	15	38	0	0
17	20251987	.	T	C	14	11	25	0	0	25	0	0
17	20256603	.	A	C	20	6	26	0	3	29	0	0
17	20256669	.	A	G	14	11	25	0	0	25	0	0
17	20256894	.	T	C	11	9	20	0	0	20	0	0
17	20256921	.	A	G	10	6	16	0	0	16	0	0
17	20256948	.	G	C	14	0	14	0	9	23	0	0
17	20259679	.	A	C	3	8	11	0	0	11	0	0
17	20264097	.	C	T	7	12	19	0	1	20	0	0
17	20268379	.	G	A	10	6	16	0	0	16	0	0
17	20268442	.	C	T	8	15	23	0	0	23	0	0
17	20287338	.	C	T	8	8	16	0	1	17	0	0
17	20321569	.	G	A	5	4	9	0	0	9	0	0
17	20321614	.	C	T	0	3	3	0	7	10	0	0
17	20321730	.	C	T	9	7	16	0	1	17	0	0
17	20324012	.	T	C	6	7	13	0	0	13	0	0
17	20324036	.	C	T	1	8	9	0	8	17	0	0
17	20324051	.	A	G	6	8	14	0	1	15	0	0
17	20324084	.	T	C	10	0	10	0	10	20	0	0
17	20324114	.	C	T	0	11	11	0	13	24	0	0
17	20324144	.	G	A	12	10	22	0	2	24	0	0
17	20326784	.	C	T	0	3	3	0	5	8	0	0
17	20330433	.	T	G	3	2	5	0	0	5	0	0
17	20336983	.	G	A	3	2	5	0	1	6	0	0
17	20354894	.	G	T	3	4	7	0	0	7	0	0
17	20380992	.	G	A	5	3	8	0	1	9	0	0
17	20429652	.	A	G	0	3	3	1	0	4	0	0
17	20429662	.	G	C	2	0	2	1	1	4	0	0
17	20429758	.	G	A	5	7	12	0	0	12	0	0
17	20429980	.	A	G	6	4	10	0	0	10	0	0
17	20429983	.	C	T	0	4	4	0	5	9	0	0
17	20517393	.	T	A	1	3	4	0	0	4	0	0
17	20517926	.	A	G	3	3	6	0	0	6	0	0
17	20517968	.	G	A	3	3	6	0	0	6	0	0
17	20517973	.	G	A	0	3	3	0	3	6	0	0
17	20518101	.	T	G	1	2	3	0	0	3	0	0
17	20518147	.	G	A	1	3	4	0	0	4	0	0
17	20518389	.	A	G	2	0	2	2	2	6	0	0
17	20577476	.	T	A	2	6	8	0	0	8	0	0
17	20577585	.	C	A	3	6	9	0	0	9	0	0
17	20577656	.	A	G	2	4	6	0	0	6	0	0
17	20577672	.	G	C	1	4	5	0	0	5	0	0
17	20577761	.	G	A	1	2	3	0	0	3	0	0
17	20582140	.	T	C	1	4	5	0	1	6	0	0
17	20585284	.	C	T	1	2	3	0	0	3	0	0
17	20585362	.	T	C	3	17	20	0	0	20	0	0
17	20587321	.	A	C	3	2	5	0	0	5	0	0
17	20587947	.	T	A	2	2	4	0	0	4	0	0
17	20605277	.	C	T	2	3	5	0	0	5	0	0
17	20654140	.	G	A	8	7	15	0	0	15	0	0
17	20654286	.	T	A	2	2	4	0	0	4	0	0
17	20654291	.	G	T	2	3	5	0	0	5	0	0
17	20654332	.	G	A	5	3	8	0	0	8	0	0
17	20654802	.	A	G	3	3	6	0	0	6	0	0
17	20655086	.	T	A	5	6	11	0	0	11	0	0
17	20655106	.	C	T	1	5	6	0	1	7	0	0
17	20674063	.	C	T	5	4	9	0	1	10	0	0
17	20674489	.	T	C	8	1	9	0	20	30	1	0
17	20674755	.	A	T	3	3	6	0	0	6	0	0
17	20674794	.	C	T	9	9	18	0	0	18	0	0
17	20674889	.	T	A	15	14	29	0	0	29	0	0
17	20684685	.	A	T	19	16	35	0	1	36	0	0
17	20695604	.	G	A	14	14	28	0	1	29	0	0
17	20695941	.	C	A	3	7	10	0	11	21	0	0
17	20701602	.	A	G	30	21	51	0	2	53	0	0
17	20701999	.	G	A	19	22	41	0	1	42	0	0
17	20702030	.	C	T	2	19	21	0	17	38	0	0
17	20702056	.	G	A	23	12	35	0	0	35	0	0
17	20719067	.	G	C	21	17	38	0	2	40	0	0
17	20719232	.	A	G	11	15	26	0	0	26	0	0
17	20719248	.	C	T	14	4	18	0	1	19	0	0
17	20719746	.	G	T	10	12	22	0	0	22	0	0
17	20720046	.	C	T	2	12	14	1	18	33	0	0
17	20720121	.	G	T	20	22	42	0	1	43	0	0
17	20720334	.	C	T	17	20	37	0	2	39	0	0
17	20720581	.	G	A	25	12	37	0	1	38	0	0
17	20720739	.	G	T	15	16	31	0	3	34	0	0
17	20721597	.	A	G	7	6	13	0	1	14	0	0
17	20722113	.	C	A	12	16	28	0	1	29	0	0
17	20722389	.	A	G	8	5	13	0	0	13	0	0
17	20722955	.	A	G	11	9	20	0	1	21	0	0
17	20723081	.	A	T	9	6	15	0	1	16	0	0
17	20723407	.	A	G	9	10	19	0	1	20	0	0
17	20724187	.	A	T	7	4	11	0	0	11	0	0
17	20724318	.	C	T	8	13	21	0	0	21	0	0
17	20724675	.	A	G	15	17	32	0	0	32	0	0
17	20725107	.	G	A	12	12	24	0	1	25	0	0
17	20725296	.	T	C	10	8	18	0	4	22	0	0
17	20725474	.	A	C	12	14	26	0	0	26	0	0
17	20725554	.	G	A	9	13	22	0	1	23	0	0
17	20729433	.	C	T	5	6	11	0	0	11	0	0
17	20731031	.	G	A	11	6	17	0	2	19	0	0
17	20731097	.	C	T	10	8	18	0	1	19	0	0
17	20734207	.	G	A	8	13	21	1	0	22	0	0
17	20763022	.	C	T	0	5	5	0	15	20	0	0
17	20770456	.	G	A	10	10	20	0	0	20	0	0
17	20772115	.	C	T	8	4	12	0	1	13	0	0
17	20772383	.	A	G	4	5	9	0	0	9	0	0
17	20782062	.	G	A	4	5	9	0	1	10	0	0
17	20784676	.	G	A	6	4	10	0	0	10	0	0
17	20784718	.	G	A	2	9	11	1	0	12	0	0
17	20795953	.	G	A	8	4	12	0	0	12	0	0
17	20795992	.	G	A	4	3	7	0	1	8	0	0
17	20796115	.	C	T	0	10	10	0	4	14	0	0
17	20806988	.	C	T	5	9	14	0	2	16	0	0
17	20849868	.	C	T	0	4	4	1	1	6	0	0
17	20924745	.	C	T	2	2	4	0	0	4	0	0
17	20963653	.	T	C	20	16	36	0	2	38	0	0
17	20963664	.	T	C	19	17	36	0	1	37	0	0
17	20964056	.	A	T	6	5	11	0	0	11	0	0
17	20964611	.	G	A	9	5	14	0	2	16	0	0
17	20964669	.	A	G	13	5	18	0	1	19	0	0
17	20964978	.	A	G	17	10	27	0	0	27	0	0
17	20965143	.	G	A	20	17	37	0	1	38	0	0
17	20965182	.	C	T	3	17	20	0	18	38	0	0
17	20965194	.	G	T	23	16	39	0	2	41	0	0
17	20965295	.	T	G	20	16	36	1	0	37	0	0
17	20978673	.	A	G	18	13	31	0	0	31	0	0
17	20978822	.	A	G	6	4	10	2	0	12	0	0
17	20978823	.	G	A	4	6	10	2	0	12	0	0
17	20978972	.	G	A	12	11	23	0	0	23	0	0
17	21102352	.	T	A	2	7	9	0	0	9	0	0
17	21104883	.	A	G	6	3	9	0	2	11	0	0
17	21107316	.	T	C	4	4	8	0	0	8	0	0
17	21120781	.	G	A	16	7	23	0	1	24	0	0
17	21123435	.	G	A	6	3	9	0	1	10	0	0
17	21123461	.	A	T	2	5	7	0	2	9	0	0
17	21123537	.	T	C	1	4	5	0	0	5	0	0
17	21132043	.	G	A	2	2	4	0	0	4	0	0
17	21141630	.	G	A	8	7	15	0	0	15	0	0
17	21147021	.	C	T	3	6	9	0	0	9	0	0
17	21151945	.	C	A	8	8	16	0	0	16	0	0
17	21151996	.	C	T	1	4	5	0	1	6	0	0
17	21152038	.	T	C	2	2	4	0	0	4	0	0
17	21152059	.	T	A	3	3	6	0	0	6	0	0
17	21152106	.	G	A	2	7	9	0	0	9	0	0
17	21152145	.	A	C	2	8	10	0	1	11	0	0
17	21154691	.	A	G	4	7	11	0	0	11	0	0
17	21154957	.	C	A	8	12	20	1	2	23	0	0
17	21155425	.	C	A	14	7	21	0	1	22	0	0
17	21155625	.	T	G	3	3	6	0	0	6	0	0
17	21155817	.	T	C	15	5	20	0	3	23	0	0
17	21156091	.	A	G	5	3	8	0	3	11	0	0
17	21156140	.	G	T	10	6	16	0	2	18	0	0
17	21156162	.	A	G	16	9	25	0	1	26	0	0
17	21156207	.	A	C	16	8	24	0	2	26	0	0
17	21156220	.	C	T	18	6	24	0	1	25	0	0
17	21156265	.	T	A	12	9	21	0	0	21	0	0
17	21156299	.	T	C	9	1	10	0	8	18	0	0
17	21156342	.	C	T	6	3	9	0	0	9	0	0
17	21156352	.	C	T	4	2	6	0	1	7	0	0
17	21156590	.	C	A	1	5	6	0	9	15	0	0
17	21156720	.	A	C	11	6	17	0	0	17	0	0
17	21156808	.	A	T	8	4	12	0	0	12	0	0
17	21157737	.	A	T	1	2	3	0	0	3	0	0
17	21158231	.	T	A	3	3	6	0	0	6	0	0
17	21158291	.	A	T	10	6	16	0	0	16	0	0
17	21158438	.	C	A	6	3	9	0	0	9	0	0
17	21158439	.	C	A	6	3	9	0	0	9	0	0
17	21158527	.	G	A	3	5	8	0	0	8	0	0
17	21158549	.	T	G	4	4	8	0	0	8	0	0
17	21158629	.	C	G	7	4	11	0	0	11	0	0
17	21160083	.	G	A	8	7	15	0	0	15	0	0
17	21160107	.	G	A	4	11	15	0	0	15	0	0
17	21162573	.	T	C	5	5	10	0	0	10	0	0
17	21166028	.	T	C	8	0	8	0	7	15	0	0
17	21198633	.	C	T	4	5	9	0	0	9	0	0
17	21245326	.	A	G	10	5	15	0	0	15	0	0
17	21245410	.	T	C	6	1	7	0	6	13	0	0
17	21251211	.	G	A	3	4	7	0	0	7	0	0
17	21372616	.	C	T	5	22	27	0	15	42	0	0
17	21372810	.	G	T	25	27	52	0	2	54	0	0
17	21373062	.	G	A	19	23	42	0	0	42	0	0
17	21373105	.	C	G	1	21	22	0	12	34	0	0
17	21377133	.	G	A	20	13	33	0	1	34	0	0
17	21396399	.	A	G	11	18	29	0	0	29	0	0
17	21396444	.	A	G	11	10	21	0	0	21	0	0
17	21396462	.	A	G	16	8	24	0	0	24	0	0
17	21433014	.	C	T	0	6	6	0	2	8	0	0
17	21433074	.	G	A	3	10	13	0	0	13	0	0
17	21433396	.	C	T	0	5	5	0	3	8	0	0
17	21433680	.	C	A	4	5	9	0	0	9	0	0
17	21433750	.	C	T	0	4	4	0	6	10	0	0
17	21547643	.	A	G	2	3	5	0	1	6	0	0
17	21547779	.	A	G	3	2	5	0	0	5	0	0
17	21550216	.	T	C	5	9	14	0	0	14	0	0
17	21560706	.	A	T	3	3	6	0	0	6	0	0
17	21560738	.	A	G	2	4	6	0	1	7	0	0
17	21560763	.	T	C	5	4	9	0	0	9	0	0
17	21607429	.	G	A	3	4	7	0	0	7	0	0
17	21607781	.	C	T	4	5	9	0	0	9	0	0
17	21617536	.	T	C	8	4	12	0	0	12	0	0
17	21617586	.	C	T	5	8	13	0	0	13	0	0
17	21617588	.	A	T	8	5	13	0	0	13	0	0
17	21791668	.	T	C	4	0	4	0	4	8	0	0
17	21791974	.	C	T	1	3	4	0	0	4	0	0
17	21818245	.	C	T	5	6	11	0	0	11	0	0
17	21818266	.	T	C	6	9	15	0	0	15	0	0
17	21820366	.	C	T	14	7	21	0	0	21	0	0
17	21820378	.	C	T	12	8	20	0	0	20	0	0
17	21820583	.	G	A	4	4	8	0	0	8	0	0
17	21820657	.	C	A	9	5	14	0	3	17	0	0
17	21820744	.	A	T	8	10	18	0	0	18	0	0
17	21820772	.	A	G	9	10	19	0	0	19	0	0
17	21820879	.	C	T	13	12	25	0	2	27	0	0
17	21821381	.	A	G	9	6	15	0	0	15	0	0
17	21821405	.	T	C	6	7	13	0	1	14	0	0
17	21821627	.	C	T	6	3	9	0	0	9	0	0
17	21821653	.	T	C	4	4	8	0	0	8	0	0
17	21821856	.	C	T	7	7	14	0	3	17	0	0
17	21821958	.	C	T	5	2	7	0	0	7	0	0
17	21904009	.	G	A	2	7	9	0	21	30	0	0
17	21905752	.	A	C	6	9	15	10	0	25	0	0
17	21911999	.	T	C	26	19	45	0	1	46	0	0
17	21912381	.	T	C	7	9	16	0	0	16	0	0
17	21912489	.	T	C	21	10	31	0	1	32	0	0
17	21912517	.	T	C	23	5	28	0	2	30	0	0
17	21912554	.	G	T	18	7	25	0	0	25	0	0
17	21912597	.	C	A	13	7	20	0	1	21	0	0
17	21912622	.	C	A	10	7	17	0	1	18	0	0
17	21912676	.	A	T	6	7	13	0	1	14	0	0
17	21912708	.	T	A	11	14	25	0	0	25	0	0
17	21912797	.	T	C	14	12	26	0	0	26	0	0
17	21912874	.	A	G	10	23	33	0	0	33	0	0
17	21912890	.	G	T	7	20	27	0	3	30	0	0
17	21919541	.	C	G	4	3	7	0	1	8	0	0
17	21919655	.	G	A	3	2	5	0	1	6	0	0
17	21952787	.	G	A	1	3	4	0	6	10	0	0
17	21954957	.	C	T	9	7	16	0	0	16	0	0
17	21955115	.	T	C	8	9	17	0	0	18	1	0
17	21958945	.	A	G	8	0	8	0	12	20	0	0
17	21959239	.	A	T	5	8	13	0	0	13	0	0
17	21975525	.	G	A	2	14	16	0	12	28	0	0
17	21975528	.	C	G	14	13	27	0	2	29	0	0
17	21982062	.	T	C	8	7	15	2	1	18	0	0
17	22003324	.	A	T	4	2	6	0	0	6	0	0
17	22003417	.	C	T	1	3	4	0	1	5	0	0
17	22016661	.	T	C	1	2	3	0	0	3	0	0
17	22032345	.	T	A	7	3	10	0	4	14	0	0
17	22032679	.	A	C	3	3	6	0	0	6	0	0
17	22033020	.	G	A	6	6	12	0	0	12	0	0
17	22033142	.	T	C	7	0	7	0	7	14	0	0
17	22035770	.	T	C	12	0	12	0	10	22	0	0
17	22035945	.	C	T	3	9	12	0	12	24	0	0
17	22036427	.	C	T	8	4	12	0	1	13	0	0
17	22036460	.	C	A	7	7	14	0	0	15	1	0
17	22036602	.	A	C	8	0	8	0	8	16	0	0
17	22036659	.	G	T	9	8	17	0	0	17	0	0
17	22036686	.	A	G	14	8	22	0	1	23	0	0
17	22036896	.	G	A	7	2	9	0	0	9	0	0
17	22037014	.	G	A	2	8	10	0	1	11	0	0
17	22044272	.	T	C	5	1	6	0	6	12	0	0
17	22047883	.	C	T	0	9	9	0	15	24	0	0
17	22051176	.	A	G	6	11	17	0	0	17	0	0
17	22052074	.	G	A	9	7	16	0	1	17	0	0
17	22058188	.	C	T	14	10	24	0	0	24	0	0
17	22062275	.	C	T	15	12	27	0	1	28	0	0
17	22063318	.	T	C	7	4	11	0	0	11	0	0
17	22072375	.	G	A	1	2	3	0	0	3	0	0
17	22072435	.	T	G	2	3	5	0	1	6	0	0
17	22072485	.	C	G	4	3	7	0	0	7	0	0
17	22072673	.	A	C	8	3	11	0	0	11	0	0
17	22072838	.	G	A	2	2	4	0	0	4	0	0
17	22088716	.	T	G	3	3	6	0	0	6	0	0
17	22090673	.	C	T	2	2	4	0	0	4	0	0
17	22090897	.	T	G	3	0	3	0	6	9	0	0
17	22091044	.	T	G	4	3	7	0	0	7	0	0
17	22091067	.	G	A	4	2	6	0	0	6	0	0
17	22091118	.	T	A	3	2	5	0	0	5	0	0
17	22091120	.	A	T	2	2	4	0	0	4	0	0
17	22108065	.	G	A	8	10	18	0	0	18	0	0
17	22108207	.	A	T	12	7	19	0	0	19	0	0
17	22111379	.	T	G	11	10	21	0	0	21	0	0
17	22111386	.	T	C	12	0	12	0	8	20	0	0
17	22111610	.	G	A	12	8	20	0	0	20	0	0
17	22113050	.	T	C	4	5	9	0	0	9	0	0
17	22381310	.	T	G	6	2	8	0	0	8	0	0
17	22381658	.	C	G	3	0	3	0	3	6	0	0
17	22382652	.	G	A	0	5	5	0	4	9	0	0
17	22382726	.	C	T	3	5	8	0	1	9	0	0
17	22382885	.	A	G	3	0	3	0	8	11	0	0
17	22471649	.	G	A	1	10	11	0	7	18	0	0
17	22489033	.	A	C	9	6	15	0	1	16	0	0
17	22489072	.	G	C	1	3	4	0	6	10	0	0
17	22500507	.	C	A	10	14	24	0	0	24	0	0
17	22500600	.	G	A	11	11	22	0	0	22	0	0
17	22500627	.	C	T	14	14	28	0	1	29	0	0
17	22500898	.	T	G	10	1	11	0	9	20	0	0
17	22500937	.	G	A	0	9	9	0	10	19	0	0
17	22500972	.	A	C	14	9	23	0	0	23	0	0
17	22501063	.	G	A	2	8	10	0	10	20	0	0
17	22501309	.	G	A	6	4	10	0	1	11	0	0
17	22501353	.	G	A	7	6	13	0	0	13	0	0
17	22501447	.	T	A	11	10	21	0	1	22	0	0
17	22501490	.	T	C	10	12	22	0	0	22	0	0
17	22501493	.	C	A	10	11	21	0	0	21	0	0
17	22501547	.	C	A	7	16	23	0	0	23	0	0
17	22501645	.	G	T	10	7	17	0	0	18	1	0
17	22501858	.	C	T	6	8	14	0	1	15	0	0
17	22582313	.	C	T	18	16	34	0	1	35	0	0
17	22584847	.	G	A	20	19	39	0	3	42	0	0
17	22585264	.	T	A	25	17	42	0	1	43	0	0
17	22585273	.	C	T	17	24	41	0	0	41	0	0
17	22585337	.	T	A	12	16	28	0	0	28	0	0
17	22617413	.	G	A	0	3	3	0	4	7	0	0
17	22618542	.	G	C	1	3	4	0	0	4	0	0
17	22619244	.	T	G	2	0	2	0	6	8	0	0
17	22619289	.	C	T	4	4	8	0	0	8	0	0
17	22621065	.	C	T	1	2	3	0	0	3	0	0
17	22630437	.	G	A	4	2	6	0	0	6	0	0
17	22632033	.	T	C	5	3	8	0	0	8	0	0
17	22632128	.	C	T	6	3	9	0	2	11	0	0
17	22633908	.	A	G	1	4	5	0	1	6	0	0
17	22635334	.	G	A	1	5	6	0	0	6	0	0
17	22635346	.	C	T	5	4	9	0	0	9	0	0
17	22637335	.	C	A	4	2	6	0	0	6	0	0
17	22646861	.	T	C	4	5	9	0	0	9	0	0
17	22647001	.	C	T	3	5	8	0	1	9	0	0
17	22648087	.	T	C	4	5	9	0	0	9	0	0
17	22649721	.	G	A	1	7	8	0	11	19	0	0
17	22650505	.	G	T	0	8	8	0	6	14	0	0
17	22650586	.	C	T	5	5	10	0	1	11	0	0
17	22650641	.	C	A	7	6	13	0	0	13	0	0
17	22650760	.	C	T	7	7	14	0	0	14	0	0
17	22650979	.	C	T	4	7	11	0	0	11	0	0
17	22651351	.	C	T	8	8	16	0	2	18	0	0
17	22651375	.	T	C	10	9	19	0	1	20	0	0
17	22652799	.	T	A	5	9	14	0	2	16	0	0
17	22652825	.	G	T	8	6	14	0	0	14	0	0
17	22653491	.	C	T	9	8	17	0	2	19	0	0
17	22653710	.	C	T	13	7	20	0	1	21	0	0
17	22654096	.	C	T	5	11	16	0	1	17	0	0
17	22658245	.	A	G	12	10	22	0	0	22	0	0
17	22659176	.	G	T	0	6	6	0	9	15	0	0
17	22659206	.	G	A	5	3	8	0	0	8	0	0
17	22659957	.	A	G	12	0	12	0	11	23	0	0
17	22662759	.	T	C	8	7	15	0	0	15	0	0
17	22669012	.	G	A	0	11	11	0	12	23	0	0
17	22669060	.	C	T	14	16	30	0	1	31	0	0
17	22669511	.	A	C	9	6	15	0	2	17	0	0
17	22687408	.	C	A	7	9	16	0	1	17	0	0
17	22687409	.	C	G	7	10	17	0	0	17	0	0
17	22687451	.	T	C	9	12	21	0	0	21	0	0
17	22687500	.	T	G	9	6	15	0	1	16	0	0
17	22687558	.	T	A	16	13	29	0	1	30	0	0
17	22687561	.	G	A	17	14	31	0	1	32	0	0
17	22687729	.	T	C	21	17	38	0	2	40	0	0
17	22687842	.	T	A	13	15	28	0	1	29	0	0
17	22713696	.	C	T	13	16	29	0	3	32	0	0
17	22723479	.	T	C	8	14	22	0	0	22	0	0
17	22723515	.	C	T	7	13	20	0	1	21	0	0
17	22729079	.	T	C	7	15	22	0	2	24	0	0
17	22729772	.	T	A	16	11	27	0	0	27	0	0
17	22729796	.	G	A	1	15	16	0	18	34	0	0
17	22729886	.	C	T	12	12	24	0	0	24	0	0
17	22738350	.	G	A	11	14	25	0	3	28	0	0
17	22741044	.	C	T	6	15	21	0	2	23	0	0
17	22741070	.	G	A	0	9	9	0	8	17	0	0
17	22741096	.	A	T	7	5	12	0	0	12	0	0
17	22741437	.	A	T	11	9	20	0	0	20	0	0
17	22800422	.	C	T	1	2	3	0	0	3	0	0
17	22804934	.	A	T	1	6	7	0	0	7	0	0
17	22805016	.	G	A	5	3	8	0	0	8	0	0
17	22916905	.	C	T	6	3	9	0	0	9	0	0
17	22918230	.	G	A	4	6	10	0	0	10	0	0
17	22918258	.	A	G	4	4	8	0	1	9	0	0
17	22937684	.	A	T	4	5	9	0	3	12	0	0
17	22937719	.	A	T	8	4	12	0	0	12	0	0
17	22944875	.	A	G	9	7	16	0	0	16	0	0
17	22944887	.	A	G	8	5	13	0	0	13	0	0
17	23103224	.	T	A	5	2	7	0	0	7	0	0
17	23161395	.	C	T	2	2	4	0	0	4	0	0
17	23185251	.	G	A	0	3	3	0	1	4	0	0
17	23185253	.	G	A	1	3	4	0	0	4	0	0
17	23194040	.	T	C	2	3	5	0	0	5	0	0
17	23200509	.	G	A	2	3	5	0	1	6	0	0
17	23200630	.	G	T	1	2	3	0	0	3	0	0
17	23200637	.	T	A	1	2	3	0	0	3	0	0
17	23200949	.	A	C	1	4	5	0	2	7	0	0
17	23215411	.	T	C	3	4	7	0	1	8	0	0
17	23215612	.	G	A	3	7	10	0	0	10	0	0
17	23215678	.	A	T	4	4	8	0	0	8	0	0
17	23216461	.	C	T	4	5	9	0	0	9	0	0
17	23220627	.	A	G	7	5	12	0	2	14	0	0
17	23220698	.	T	A	9	6	15	0	0	15	0	0
17	23222460	.	C	G	6	11	17	0	0	17	0	0
17	23223166	.	C	G	9	8	17	0	0	17	0	0
17	23224626	.	C	T	9	8	17	0	0	17	0	0
17	23224680	.	G	A	12	8	20	0	2	22	0	0
17	23224743	.	A	G	10	1	11	0	18	29	0	0
17	23224800	.	G	A	8	14	22	0	1	23	0	0
17	23226667	.	C	T	10	9	19	0	0	19	0	0
17	23231130	.	C	T	15	13	28	0	0	28	0	0
17	23258050	.	C	T	1	2	3	0	1	4	0	0
17	23300837	.	C	G	17	8	25	0	0	25	0	0
17	23300879	.	G	A	23	10	33	0	1	34	0	0
17	23300888	.	T	C	23	8	31	0	1	32	0	0
17	23301102	.	C	T	12	15	27	0	3	30	0	0
17	23301303	.	G	A	29	24	53	0	1	54	0	0
17	23301372	.	C	T	18	29	47	0	0	47	0	0
17	23301390	.	G	A	3	20	23	0	26	49	0	0
17	23301433	.	G	T	27	22	49	0	2	51	0	0
17	23301484	.	G	A	30	22	52	0	0	52	0	0
17	23301799	.	A	G	9	6	15	0	0	15	0	0
17	23434216	.	G	A	8	12	20	0	0	20	0	0
17	23434264	.	A	G	12	9	21	0	0	21	0	0
17	23434389	.	T	C	10	0	10	0	5	15	0	0
17	23437102	.	A	G	6	3	9	0	2	11	0	0
17	23437629	.	C	A	5	6	11	0	0	11	0	0
17	23437641	.	A	G	5	6	11	0	0	11	0	0
17	23441680	.	C	T	9	5	14	0	1	15	0	0
17	23441698	.	A	G	12	6	18	0	0	18	0	0
17	23444362	.	G	C	1	7	8	0	0	8	0	0
17	23444415	.	A	G	10	8	18	0	0	18	0	0
17	23542123	.	G	A	3	2	5	0	1	6	0	0
17	23542264	.	T	A	4	5	9	0	1	10	0	0
17	23542322	.	C	A	6	4	10	0	0	10	0	0
17	23542616	.	A	G	3	3	6	0	0	6	0	0
17	23542662	.	C	T	2	6	8	0	0	8	0	0
17	23542677	.	G	A	1	5	6	0	0	6	0	0
17	23542752	.	A	G	4	2	6	0	1	7	0	0
17	23542770	.	A	G	3	2	5	0	0	5	0	0
17	23542890	.	C	G	2	2	4	0	0	4	0	0
17	23549232	.	A	G	2	0	2	0	8	10	0	0
17	23549416	.	G	A	5	3	8	0	1	9	0	0
17	23549710	.	G	T	4	6	10	0	0	10	0	0
17	23551512	.	T	C	6	6	12	0	0	12	0	0
17	23551536	.	C	T	5	6	11	0	0	11	0	0
17	23551928	.	G	A	0	2	2	0	2	4	0	0
17	23554980	.	T	C	6	7	13	0	1	14	0	0
17	23555032	.	T	C	6	5	11	0	0	11	0	0
17	23555150	.	C	T	5	3	8	0	0	8	0	0
17	23555278	.	A	T	10	3	13	0	1	14	0	0
17	23555403	.	A	T	6	7	13	0	1	14	0	0
17	23574682	.	G	A	2	3	5	0	0	5	0	0
17	23656034	.	A	C	22	0	22	0	24	46	0	0
17	23656112	.	C	T	4	23	27	0	19	46	0	0
17	23659853	.	C	T	22	16	38	0	6	44	0	0
17	23711065	.	A	T	2	6	8	0	0	8	0	0
17	23711184	.	A	T	8	4	12	0	0	12	0	0
17	23711421	.	A	C	13	9	22	0	1	23	0	0
17	23711775	.	C	T	1	11	12	0	8	20	0	0
17	23722882	.	A	T	9	7	16	0	2	18	0	0
17	23727637	.	G	T	11	11	22	0	0	22	0	0
17	23757541	.	G	A	0	4	4	0	4	8	0	0
17	23757882	.	C	T	5	2	7	0	0	7	0	0
17	23757906	.	C	T	3	5	8	0	0	8	0	0
17	23762847	.	G	A	0	6	6	0	3	9	0	0
17	23762900	.	T	A	3	5	8	0	0	8	0	0
17	23764591	.	T	C	3	5	8	0	2	10	0	0
17	23811260	.	G	C	0	3	3	0	2	5	0	0
17	23820614	.	A	G	7	5	12	0	0	12	0	0
17	23821410	.	C	T	8	8	16	0	0	16	0	0
17	23821480	.	T	A	5	3	8	0	0	8	0	0
17	23822235	.	G	T	3	4	7	0	0	7	0	0
17	23822323	.	G	A	1	5	6	0	0	6	0	0
17	23822749	.	C	T	3	5	8	0	0	8	0	0
17	23822856	.	G	A	1	8	9	0	0	9	0	0
17	23823650	.	G	A	5	7	12	0	0	12	0	0
17	23824026	.	A	G	5	2	7	0	0	7	0	0
17	23824244	.	C	T	11	4	15	0	0	15	0	0
17	23824504	.	A	G	8	2	10	1	1	12	0	0
17	23894146	.	C	T	2	2	4	0	0	4	0	0
17	23894359	.	G	A	4	4	8	0	0	8	0	0
17	23894378	.	C	T	2	1	3	0	2	5	0	0
17	23929692	.	A	G	6	0	6	0	5	11	0	0
17	23935259	.	C	T	2	2	4	0	0	4	0	0
17	23937626	.	T	G	6	15	21	0	0	21	0	0
17	23940102	.	C	A	11	18	29	0	0	29	0	0
17	23948365	.	A	G	23	8	31	0	1	32	0	0
17	23948396	.	C	T	23	9	32	0	1	33	0	0
17	23952672	.	G	C	8	30	38	0	0	38	0	0
17	23956882	.	G	A	6	11	17	0	0	17	0	0
17	23956925	.	G	A	0	13	13	0	6	19	0	0
17	23964452	.	G	T	1	4	5	0	0	5	0	0
17	23964568	.	A	T	4	4	8	0	0	8	0	0
17	23964576	.	G	T	4	2	6	0	0	6	0	0
17	23964690	.	T	A	4	3	7	0	0	7	0	0
17	23964719	.	A	G	5	2	7	0	1	8	0	0
17	23964732	.	T	C	3	3	6	0	2	8	0	0
17	23965241	.	G	T	2	6	8	0	0	8	0	0
17	23965475	.	G	C	4	6	10	0	0	10	0	0
17	23965983	.	C	A	8	9	17	0	2	19	0	0
17	23986153	.	A	G	8	0	8	0	8	16	0	0
17	23986585	.	T	C	16	16	32	0	0	32	0	0
17	24080561	.	T	C	1	2	3	0	0	3	0	0
17	24080609	.	T	A	1	2	3	0	0	3	0	0
17	24080615	.	T	G	1	0	1	0	2	3	0	0
17	24081209	.	A	G	4	3	7	0	1	8	0	0
17	24111400	.	G	A	0	3	3	0	3	6	0	0
17	24178449	.	G	C	10	8	18	0	0	18	0	0
17	24182184	.	T	A	4	11	15	0	0	15	0	0
17	24186029	.	C	T	8	8	16	0	0	16	0	0
17	24186042	.	T	C	7	6	13	0	2	15	0	0
17	24186129	.	C	T	4	3	7	0	0	7	0	0
17	24222649	.	G	A	14	10	24	0	2	26	0	0
17	24222730	.	T	A	15	8	23	0	0	23	0	0
17	24222752	.	A	T	14	7	21	0	2	23	0	0
17	24222771	.	G	T	13	11	24	0	0	24	0	0
17	24247670	.	G	T	5	6	11	0	0	11	0	0
17	24254467	.	G	A	2	10	12	0	5	17	0	0
17	24268278	.	G	A	15	14	29	1	1	31	0	0
17	24313974	.	T	A	3	6	9	0	0	9	0	0
17	24314068	.	G	A	6	3	9	0	0	9	0	0
17	24314173	.	G	T	2	3	5	0	0	5	0	0
17	24314331	.	A	G	8	10	18	0	3	21	0	0
17	24314468	.	A	T	6	3	9	0	0	9	0	0
17	24314986	.	G	A	0	9	9	0	11	20	0	0
17	24319071	.	A	C	5	8	13	0	0	13	0	0
17	24364368	.	G	A	3	2	5	0	1	6	0	0
17	24398751	.	T	A	1	3	4	0	0	4	0	0
17	24438995	.	C	T	2	2	4	0	0	4	0	0
17	24439623	.	T	A	4	3	7	0	0	7	0	0
17	24440579	.	G	A	2	3	5	0	0	5	0	0
17	24442526	.	G	A	1	7	8	0	4	12	0	0
17	24442888	.	C	T	7	13	20	0	0	20	0	0
17	24444239	.	T	G	2	6	8	0	2	10	0	0
17	24452168	.	A	G	8	12	20	0	1	21	0	0
17	24463526	.	G	A	11	8	19	1	0	20	0	0
17	24464939	.	A	C	17	8	25	0	1	26	0	0
17	24464987	.	A	T	6	12	18	0	2	20	0	0
17	24469255	.	G	A	11	12	23	0	2	25	0	0
17	24469752	.	A	C	16	8	24	0	2	26	0	0
17	24470146	.	C	A	16	18	34	0	1	35	0	0
17	24470875	.	G	T	0	2	2	0	2	4	0	0
17	24480111	.	T	C	8	10	18	0	0	18	0	0
17	24480273	.	C	T	0	2	2	0	4	6	0	0
17	24484184	.	T	A	2	7	9	0	1	10	0	0
17	24484202	.	G	T	7	2	9	0	0	9	0	0
17	24487410	.	A	T	6	5	11	0	2	13	0	0
17	24537442	.	G	T	4	5	9	0	0	9	0	0
17	24537450	.	T	A	4	4	8	0	1	9	0	0
17	24540672	.	G	T	3	2	5	0	1	6	0	0
17	24550541	.	G	A	2	4	6	0	0	6	0	0
17	24551263	.	C	T	2	5	7	0	0	7	0	0
17	24579158	.	T	C	1	6	7	0	0	7	0	0
17	24579251	.	G	A	8	5	13	0	1	14	0	0
17	24579293	.	T	C	3	4	7	0	0	7	0	0
17	24579422	.	G	A	3	9	12	0	0	12	0	0
17	24579518	.	T	C	3	8	11	0	1	12	0	0
17	24579519	.	A	C	4	8	12	0	0	12	0	0
17	24579587	.	A	G	1	4	5	0	0	5	0	0
17	24580268	.	G	A	4	4	8	0	1	9	0	0
17	24580328	.	A	C	5	0	5	0	7	12	0	0
17	24597770	.	C	T	2	3	5	0	0	5	0	0
17	24597853	.	T	C	2	3	5	0	0	5	0	0
17	24599488	.	C	G	3	6	9	0	0	9	0	0
17	24599509	.	T	G	6	3	9	0	0	9	0	0
17	24600150	.	A	C	4	4	8	0	0	8	0	0
17	24600595	.	G	A	1	3	4	0	7	11	0	0
17	24600767	.	G	A	6	5	11	0	0	11	0	0
17	24600976	.	G	A	6	8	14	0	1	15	0	0
17	24601072	.	G	A	0	3	3	0	8	11	0	0
17	24601579	.	T	A	8	11	19	0	2	21	0	0
17	24601924	.	C	T	7	6	13	0	0	13	0	0
17	24604523	.	A	T	5	6	11	0	0	11	0	0
17	24604619	.	G	T	0	5	5	0	4	9	0	0
17	24612661	.	G	T	8	4	12	0	1	13	0	0
17	24612726	.	A	G	5	6	11	0	1	12	0	0
17	24614468	.	C	T	31	30	61	0	1	62	0	0
17	24615181	.	C	T	3	3	6	0	0	6	0	0
17	24615205	.	A	G	9	12	21	0	0	21	0	0
17	24616518	.	T	A	1	1	2	0	1	3	0	0
17	24616526	.	T	A	1	2	3	0	0	3	0	0
17	24617888	.	C	A	7	26	33	0	3	36	0	0
17	24618912	.	C	T	8	4	12	0	0	12	0	0
17	24618945	.	C	T	7	4	11	0	1	12	0	0
17	24619650	.	A	G	7	3	10	0	0	10	0	0
17	24619693	.	A	G	3	0	3	0	7	10	0	0
17	24622623	.	G	T	6	10	16	0	1	17	0	0
17	24622644	.	G	A	6	9	15	0	1	16	0	0
17	24624477	.	G	C	5	6	11	0	0	11	0	0
17	24624612	.	G	A	2	2	4	0	0	4	0	0
17	24626513	.	T	G	3	4	7	0	0	7	0	0
17	24631128	.	T	C	1	4	5	1	0	6	0	0
17	24640959	.	A	T	5	5	10	0	0	10	0	0
17	24643614	.	C	T	4	2	6	0	1	7	0	0
17	24644783	.	G	A	4	11	15	0	0	15	0	0
17	24652987	.	C	T	10	11	21	0	1	22	0	0
17	24653089	.	C	T	3	5	8	0	3	11	0	0
17	24658244	.	G	A	1	6	7	0	0	7	0	0
17	24672415	.	C	G	1	2	3	0	0	3	0	0
17	24685850	.	C	T	17	10	27	0	1	28	0	0
17	24686352	.	C	T	6	5	11	0	0	11	0	0
17	24686443	.	A	T	4	7	11	0	0	11	0	0
17	24686511	.	G	A	3	6	9	0	0	9	0	0
17	24686574	.	A	G	1	2	3	0	0	3	0	0
17	24686575	.	C	G	1	2	3	0	0	3	0	0
17	24687392	.	C	A	2	2	4	0	1	5	0	0
17	24687602	.	G	C	5	7	12	0	0	12	0	0
17	24690050	.	G	A	0	8	8	0	8	16	0	0
17	24690119	.	C	T	7	8	15	0	0	15	0	0
17	24690615	.	G	A	6	10	16	0	0	16	0	0
17	24691987	.	C	T	6	11	17	0	0	17	0	0
17	24692030	.	A	C	6	6	12	0	0	12	0	0
17	24693207	.	T	C	13	8	21	0	1	22	0	0
17	24694145	.	A	G	7	9	16	0	1	17	0	0
17	24694573	.	T	A	3	3	6	0	0	6	0	0
17	24694695	.	G	A	0	2	2	0	2	4	0	0
17	24694742	.	C	A	1	4	5	0	0	5	0	0
17	24694877	.	C	G	4	4	8	0	1	9	0	0
17	24695096	.	C	A	3	4	7	2	0	9	0	0
17	24695683	.	T	A	6	2	8	0	1	9	0	0
17	24695743	.	G	A	9	9	18	0	1	19	0	0
17	24695815	.	G	C	7	0	7	0	10	17	0	0
17	24695968	.	G	C	8	9	17	0	1	18	0	0
17	24696047	.	G	T	13	14	27	0	0	27	0	0
17	24696142	.	A	C	10	6	16	0	2	18	0	0
17	24696274	.	T	C	9	6	15	0	0	15	0	0
17	24696658	.	C	A	12	8	20	0	0	20	0	0
17	24696716	.	A	G	10	8	18	0	2	20	0	0
17	24699483	.	G	A	5	9	14	0	1	15	0	0
17	24701496	.	C	T	3	2	5	0	0	5	0	0
17	24701767	.	T	C	7	4	11	0	0	11	0	0
17	24701793	.	C	G	1	4	5	0	5	10	0	0
17	24702981	.	T	C	3	3	6	0	1	7	0	0
17	24709204	.	C	T	15	11	26	0	0	26	0	0
17	24709292	.	T	C	13	0	13	0	7	20	0	0
17	24709443	.	T	G	10	5	15	2	0	17	0	0
17	24712929	.	C	T	5	8	13	0	0	13	0	0
17	24712985	.	C	T	2	9	11	0	9	20	0	0
17	24715189	.	A	G	11	4	15	0	1	16	0	0
17	24720907	.	T	C	7	12	19	2	1	22	0	0
17	24720964	.	G	C	7	14	21	0	0	21	0	0
17	24721345	.	G	A	6	12	18	0	3	21	0	0
17	24721378	.	C	A	10	9	19	0	0	19	0	0
17	24721384	.	G	A	9	10	19	0	2	21	0	0
17	24721462	.	G	A	0	12	12	0	12	24	0	0
17	24722402	.	C	T	10	9	19	0	1	20	0	0
17	24722441	.	A	G	9	6	15	0	1	16	0	0
17	24725877	.	C	A	22	16	38	0	1	39	0	0
17	24726035	.	A	T	15	11	26	0	2	28	0	0
17	24726134	.	A	G	9	0	9	0	10	19	0	0
17	24726239	.	G	T	19	6	25	0	0	25	0	0
17	24726276	.	A	G	9	13	22	0	0	22	0	0
17	24726533	.	T	A	9	8	17	0	1	18	0	0
17	24726585	.	C	T	13	15	28	0	1	29	0	0
17	24726613	.	G	A	12	8	20	0	3	23	0	0
17	24726637	.	A	G	19	6	25	0	0	25	0	0
17	24726737	.	T	C	15	10	25	0	3	28	0	0
17	24726753	.	G	A	15	10	25	0	2	27	0	0
17	24726996	.	A	G	13	11	24	0	0	24	0	0
17	24727037	.	C	T	9	12	21	0	0	21	0	0
17	24727130	.	T	G	5	0	5	0	12	17	0	0
17	24727186	.	C	G	5	5	10	0	0	10	0	0
17	24747328	.	A	C	3	4	7	0	0	7	0	0
17	24747412	.	C	T	5	3	8	0	0	8	0	0
17	24747485	.	C	T	1	2	3	0	1	4	0	0
17	24757422	.	T	G	6	1	7	0	10	17	0	0
17	24757443	.	G	A	0	5	5	0	12	17	0	0
17	24757572	.	G	C	10	6	16	0	1	17	0	0
17	24757587	.	G	A	0	5	5	0	9	14	0	0
17	24775642	.	A	G	5	2	7	0	0	7	0	0
17	24787248	.	G	A	8	8	16	0	0	16	0	0
17	24787519	.	G	A	1	3	4	0	0	4	0	0
17	24787736	.	C	A	3	5	8	0	0	8	0	0
17	24787774	.	A	T	4	5	9	0	2	11	0	0
17	24817636	.	A	G	3	2	5	0	0	5	0	0
17	24820044	.	C	T	5	5	10	0	0	10	0	0
17	24820052	.	T	C	5	6	11	0	0	11	0	0
17	24820134	.	T	C	4	6	10	0	0	10	0	0
17	24820136	.	G	C	4	6	10	0	0	10	0	0
17	24820469	.	T	C	3	2	5	0	2	7	0	0
17	24820502	.	G	T	3	4	7	0	1	8	0	0
17	24820559	.	C	T	3	5	8	0	0	8	0	0
17	24820587	.	C	T	3	2	5	0	0	5	0	0
17	24820621	.	G	T	2	5	7	0	2	9	0	0
17	24821697	.	T	C	9	7	16	0	0	16	0	0
17	24821720	.	G	A	5	7	12	0	0	12	0	0
17	24834743	.	C	T	14	11	25	0	0	25	0	0
17	24835251	.	G	C	10	11	21	0	2	23	0	0
17	24835547	.	A	T	5	3	8	0	0	8	0	0
17	24855867	.	T	G	9	3	12	1	1	14	0	0
17	24856019	.	G	A	25	9	34	0	0	34	0	0
17	24856088	.	C	G	12	19	31	0	1	32	0	0
17	24856338	.	T	C	12	5	17	0	0	17	0	0
17	24856648	.	G	T	6	9	15	0	1	16	0	0
17	24858939	.	A	C	8	0	8	0	9	17	0	0
17	24861176	.	C	T	0	15	15	0	14	29	0	0
17	24861252	.	G	A	11	14	25	0	1	26	0	0
17	24861558	.	A	G	4	13	17	0	3	20	0	0
17	24863929	.	C	G	16	7	23	0	1	24	0	0
17	24866585	.	G	T	7	5	12	0	1	13	0	0
17	24869990	.	T	A	3	2	5	0	0	5	0	0
17	24872642	.	G	A	7	11	18	0	0	18	0	0
17	24872714	.	T	A	4	7	11	0	0	11	0	0
17	24874858	.	C	T	4	4	8	0	0	8	0	0
17	24880613	.	G	A	1	4	5	0	1	6	0	0
17	24883569	.	T	C	2	0	2	0	4	6	0	0
17	24887419	.	G	A	3	2	5	0	0	5	0	0
17	24889338	.	T	G	1	2	3	0	0	3	0	0
17	24889365	.	C	A	1	3	4	0	1	5	0	0
17	24926623	.	G	A	3	2	5	0	0	5	0	0
17	24929215	.	A	T	2	7	9	0	1	11	1	0
17	24936154	.	A	T	3	3	6	0	0	6	0	0
17	24936160	.	G	A	4	5	9	0	0	9	0	0
17	24937260	.	A	G	2	2	4	0	0	4	0	0
17	24937305	.	A	T	1	1	2	0	1	3	0	0
17	25104984	.	T	A	2	7	9	0	0	9	0	0
17	25105119	.	C	T	4	5	9	0	0	9	0	0
17	25125576	.	A	G	3	1	4	0	2	6	0	0
17	25125612	.	T	C	3	6	9	0	0	9	0	0
17	25140974	.	C	T	2	7	9	0	1	10	0	0
17	25155779	.	C	T	1	6	7	0	1	8	0	0
17	25155836	.	G	A	1	5	6	0	0	6	0	0
17	25167346	.	G	A	6	4	10	0	0	10	0	0
17	25167454	.	C	A	2	3	5	0	1	6	0	0
17	25167709	.	G	A	1	3	4	0	0	4	0	0
17	25173643	.	A	G	7	0	7	0	7	14	0	0
17	25173803	.	T	C	4	4	8	0	2	10	0	0
17	25173899	.	A	T	9	7	16	0	0	16	0	0
17	25174031	.	C	A	5	2	7	0	0	7	0	0
17	25174052	.	A	G	1	0	1	0	5	6	0	0
17	25174567	.	A	T	3	5	8	0	0	8	0	0
17	25175100	.	T	A	1	5	6	0	0	6	0	0
17	25175134	.	T	C	3	6	9	0	0	9	0	0
17	25187798	.	C	T	2	2	4	0	0	4	0	0
17	25189080	.	A	G	1	0	1	0	2	3	0	0
17	25191422	.	C	A	3	2	5	0	0	5	0	0
17	25191936	.	C	G	1	2	3	0	1	4	0	0
17	25191962	.	T	C	2	3	5	0	0	5	0	0
17	25192133	.	C	T	3	6	9	0	0	9	0	0
17	25192169	.	A	G	3	0	3	0	3	6	0	0
17	25237776	.	C	T	1	4	5	0	0	5	0	0
17	25244933	.	A	T	0	2	2	0	1	3	0	0
17	25253847	.	C	T	2	4	6	0	0	6	0	0
17	25254376	.	A	G	2	0	2	0	3	5	0	0
17	25254488	.	G	A	3	2	5	0	0	5	0	0
17	25259252	.	C	T	5	5	10	0	1	11	0	0
17	25289571	.	C	A	16	12	28	0	0	28	0	0
17	25289889	.	C	T	18	5	23	0	0	23	0	0
17	25289930	.	A	T	17	5	22	0	0	22	0	0
17	25289955	.	C	T	13	4	17	0	0	17	0	0
17	25290396	.	C	T	10	13	23	0	0	23	0	0
17	25290481	.	G	A	0	9	9	0	12	21	0	0
17	25290657	.	C	T	14	7	21	0	3	24	0	0
17	25291068	.	A	G	14	1	15	0	5	21	1	0
17	25297908	.	C	T	5	4	9	0	1	10	0	0
17	25298003	.	T	G	1	5	6	0	0	6	0	0
17	25301622	.	C	T	2	6	8	0	0	8	0	0
17	25302715	.	C	T	2	4	6	0	1	7	0	0
17	25302891	.	G	A	5	3	8	0	0	8	0	0
17	25302909	.	G	A	7	6	13	0	0	13	0	0
17	25303189	.	C	T	2	3	5	0	0	5	0	0
17	25306107	.	G	A	3	2	5	0	0	5	0	0
17	25336507	.	T	C	3	2	5	0	0	5	0	0
17	25337466	.	C	T	2	4	6	0	0	6	0	0
17	25392813	.	C	A	3	6	9	2	0	11	0	0
17	25392917	.	G	A	12	10	22	0	0	22	0	0
17	25393034	.	A	C	11	9	20	0	0	20	0	0
17	25393073	.	C	T	2	9	11	0	5	16	0	0
17	25404575	.	G	A	0	7	7	0	1	8	0	0
17	25404868	.	A	G	1	7	8	0	0	8	0	0
17	25418707	.	T	G	2	3	5	0	0	5	0	0
17	25418727	.	C	A	3	4	7	0	1	8	0	0
17	25420151	.	A	G	4	5	9	0	0	9	0	0
17	25420937	.	C	T	2	8	10	0	0	10	0	0
17	25424205	.	C	A	13	5	18	0	0	18	0	0
17	25424239	.	C	T	11	8	19	0	0	19	0	0
17	25424330	.	T	A	6	10	16	0	2	18	0	0
17	25424331	.	C	A	7	10	17	0	1	18	0	0
17	25424462	.	G	T	5	4	9	0	1	10	0	0
17	25424568	.	A	G	11	15	26	0	4	30	0	0
17	25424597	.	C	T	14	15	29	0	0	29	0	0
17	25424664	.	G	A	18	5	23	0	0	23	0	0
17	25425081	.	G	T	7	7	14	0	0	14	0	0
17	25425094	.	A	G	7	7	14	0	1	15	0	0
17	25425146	.	T	A	6	7	13	0	2	15	0	0
17	25428842	.	A	C	2	6	8	0	1	9	0	0
17	25428936	.	A	T	5	4	9	0	0	9	0	0
17	25431447	.	C	T	4	6	10	0	0	10	0	0
17	25431492	.	G	A	4	6	10	0	1	11	0	0
17	25431493	.	A	T	6	4	10	0	1	11	0	0
17	25434250	.	G	T	17	22	39	0	0	39	0	0
17	25435992	.	A	G	16	28	44	0	2	46	0	0
17	25436073	.	T	C	33	26	59	0	2	61	0	0
17	25436591	.	A	T	21	22	43	0	1	44	0	0
17	25437384	.	A	G	26	0	26	0	22	48	0	0
17	25439909	.	G	A	27	25	52	0	1	53	0	0
17	25439949	.	C	T	24	17	41	2	1	44	0	0
17	25439950	.	C	A	25	16	41	2	2	45	0	0
17	25444580	.	T	A	5	3	8	0	0	8	0	0
17	25474195	.	A	G	8	3	11	0	2	13	0	0
17	25474261	.	C	T	5	4	9	0	0	9	0	0
17	25475601	.	C	T	5	4	9	0	0	9	0	0
17	25478710	.	A	G	4	2	6	0	1	7	0	0
17	25478896	.	C	T	4	4	8	0	0	8	0	0
17	25478897	.	T	G	4	4	8	0	0	8	0	0
17	25479147	.	T	A	3	4	7	0	0	7	0	0
17	25479151	.	A	C	3	4	7	0	0	7	0	0
17	25479438	.	T	G	5	3	8	0	1	9	0	0
17	25479594	.	T	A	6	10	16	0	0	16	0	0
17	25479640	.	A	G	9	16	25	0	0	25	0	0
17	25479792	.	G	A	19	15	34	0	0	34	0	0
17	25479874	.	T	A	14	9	23	0	0	23	0	0
17	25479920	.	A	G	7	12	19	0	1	20	0	0
17	25479980	.	C	T	8	4	12	0	4	16	0	0
17	25480129	.	T	G	12	9	21	0	0	21	0	0
17	25480158	.	G	T	5	0	5	0	7	12	0	0
17	25548939	.	C	T	1	2	3	0	0	3	0	0
17	25548992	.	G	A	1	3	4	0	1	5	0	0
17	25549001	.	G	T	1	2	3	0	0	3	0	0
17	25550055	.	A	G	2	2	4	0	0	4	0	0
17	25555209	.	G	A	10	5	15	0	1	16	0	0
17	25558916	.	G	A	9	6	15	0	0	15	0	0
17	25559072	.	G	A	11	3	14	0	0	14	0	0
17	25559162	.	A	T	9	2	11	0	2	13	0	0
17	25559491	.	A	G	7	4	11	0	0	11	0	0
17	25562160	.	A	G	8	5	13	0	0	13	0	0
17	25562198	.	G	T	11	6	17	0	1	18	0	0
17	25563524	.	T	A	9	4	13	0	0	13	0	0
17	25563542	.	G	A	8	5	13	0	2	15	0	0
17	25563667	.	C	T	0	4	4	0	4	8	0	0
17	25563738	.	G	A	8	4	12	0	0	12	0	0
17	25563843	.	A	T	2	3	5	0	0	5	0	0
17	25564794	.	C	G	3	3	6	0	0	6	0	0
17	25565231	.	A	G	1	2	3	0	0	3	0	0
17	25565267	.	A	G	3	2	5	0	1	6	0	0
17	25565938	.	G	T	6	3	9	0	0	9	0	0
17	25567927	.	G	C	3	3	6	0	0	6	0	0
17	25567936	.	G	T	0	3	3	0	3	6	0	0
17	25575804	.	A	T	2	2	4	0	0	4	0	0
17	25585750	.	G	T	14	10	24	0	0	24	0	0
17	25585755	.	A	C	14	10	24	0	0	24	0	0
17	25585926	.	G	A	10	10	20	0	0	20	0	0
17	25590202	.	T	A	5	3	8	0	0	8	0	0
17	25593557	.	G	A	2	3	5	0	1	6	0	0
17	25593566	.	A	G	3	5	8	0	0	8	0	0
17	25593705	.	G	A	0	5	5	0	3	8	0	0
17	25593945	.	G	A	0	2	2	0	6	8	0	0
17	25594390	.	C	A	3	6	9	0	0	9	0	0
17	25595611	.	A	G	4	1	5	0	4	9	0	0
17	25595618	.	G	A	4	6	10	0	0	10	0	0
17	25595697	.	G	A	2	4	6	0	0	6	0	0
17	25595731	.	T	C	4	4	8	0	0	8	0	0
17	25596801	.	C	T	7	4	11	0	1	12	0	0
17	25600129	.	A	C	6	7	13	0	0	13	0	0
17	25600571	.	G	A	4	5	9	0	0	9	0	0
17	25602744	.	C	T	6	6	12	0	0	12	0	0
17	25606154	.	G	A	2	12	14	0	14	28	0	0
17	25606161	.	C	T	11	15	26	0	2	28	0	0
17	25606421	.	T	A	12	7	19	0	0	19	0	0
17	25606765	.	G	T	4	2	6	0	0	6	0	0
17	25610895	.	G	T	9	9	18	0	0	18	0	0
17	25610975	.	C	T	2	3	5	0	8	13	0	0
17	25610989	.	C	T	8	3	11	0	1	12	0	0
17	25611011	.	A	G	10	3	13	0	0	13	0	0
17	25611067	.	A	C	13	6	19	0	0	19	0	0
17	25611091	.	C	A	0	5	5	0	12	17	0	0
17	25612941	.	G	C	12	12	24	0	0	24	0	0
17	25612978	.	G	A	7	9	16	0	0	16	0	0
17	25615493	.	A	G	6	6	12	0	0	12	0	0
17	25615609	.	T	A	3	9	12	0	0	12	0	0
17	25615894	.	A	G	4	6	10	0	0	10	0	0
17	25616374	.	C	T	6	7	13	0	1	14	0	0
17	25617760	.	G	T	7	7	14	0	0	14	0	0
17	25617950	.	G	T	10	12	22	0	0	22	0	0
17	25617967	.	T	A	10	8	18	0	1	19	0	0
17	25618850	.	G	T	6	7	13	0	1	14	0	0
17	25618961	.	C	A	1	5	6	0	0	6	0	0
17	25621178	.	C	T	5	5	10	0	2	12	0	0
17	25623841	.	A	T	6	3	9	0	1	10	0	0
17	25625764	.	A	G	7	7	14	0	0	14	0	0
17	25630550	.	C	T	2	3	5	0	0	5	0	0
17	25636167	.	G	A	24	23	47	0	2	49	0	0
17	25636381	.	C	T	4	28	32	0	28	60	0	0
17	25636412	.	A	G	35	24	59	0	3	62	0	0
17	25636539	.	T	C	24	8	32	0	41	73	0	0
17	25636594	.	C	T	3	35	38	0	34	72	0	0
17	25636679	.	C	T	2	29	31	0	38	69	0	0
17	25637106	.	A	C	37	28	65	0	1	66	0	0
17	25637676	.	T	C	36	1	37	0	28	65	0	0
17	25640476	.	G	A	31	20	51	1	1	53	0	0
17	25654294	.	G	A	1	2	3	0	0	3	0	0
17	25689422	.	A	G	1	0	1	0	2	3	0	0
17	25738601	.	T	C	1	3	4	0	3	7	0	0
17	25765287	.	A	G	1	2	3	0	0	3	0	0
17	25765683	.	G	A	2	3	5	0	0	5	0	0
17	25788385	.	C	A	0	3	3	0	2	5	0	0
17	25813992	.	C	G	1	2	3	0	0	3	0	0
17	25851505	.	G	T	2	3	5	0	0	5	0	0
17	25858362	.	A	G	1	6	7	0	0	7	0	0
17	25858593	.	T	A	2	1	3	0	1	4	0	0
17	25858625	.	G	A	0	1	1	0	2	3	0	0
17	25861496	.	A	G	3	5	8	0	0	8	0	0
17	25861501	.	C	T	4	5	9	0	0	9	0	0
17	25861552	.	G	T	2	4	6	0	2	8	0	0
17	25861682	.	T	G	2	4	6	0	0	6	0	0
17	25861766	.	A	C	1	4	5	0	0	5	0	0
17	25864632	.	T	C	5	3	8	0	1	9	0	0
17	25871375	.	G	A	0	3	3	0	4	7	0	0
17	25873224	.	G	A	3	5	8	0	1	9	0	0
17	25877526	.	A	G	7	3	10	0	1	11	0	0
17	25877694	.	G	A	1	5	6	0	1	7	0	0
17	25884610	.	T	C	2	2	4	0	1	5	0	0
17	25884620	.	G	T	3	4	7	0	0	7	0	0
17	25885012	.	T	G	4	2	6	0	0	6	0	0
17	25885415	.	T	A	3	3	6	0	1	7	0	0
17	25885418	.	C	G	3	4	7	0	0	7	0	0
17	26285347	.	A	G	2	0	2	1	3	6	0	0
17	26285350	.	G	T	3	2	5	1	0	6	0	0
17	26325286	.	C	T	1	4	5	0	0	5	0	0
17	26335000	.	G	A	7	3	10	0	0	10	0	0
17	26346175	.	T	A	10	4	14	0	0	14	0	0
17	26362130	.	G	A	7	5	12	0	5	17	0	0
17	26362500	.	C	T	4	5	9	0	1	10	0	0
17	26362512	.	A	C	5	3	8	0	0	8	0	0
17	26362539	.	C	T	5	3	8	0	0	8	0	0
17	26362741	.	C	T	5	3	8	0	0	8	0	0
17	26362985	.	T	A	2	2	4	0	0	4	0	0
17	26477795	.	A	C	11	7	18	0	0	18	0	0
17	26477857	.	T	C	6	9	15	0	1	16	0	0
17	26477860	.	C	T	4	9	13	0	0	13	0	0
17	26478023	.	T	C	12	6	18	0	0	18	0	0
17	26478403	.	T	G	5	6	11	0	3	14	0	0
17	26478592	.	A	G	10	18	28	1	0	29	0	0
17	26478818	.	T	C	12	0	12	0	14	26	0	0
17	26478952	.	G	A	12	8	20	0	0	20	0	0
17	26478986	.	A	G	7	10	17	0	1	18	0	0
17	26479063	.	A	G	9	9	18	0	0	18	0	0
17	26479145	.	T	C	10	17	27	1	0	28	0	0
17	26479916	.	G	T	7	7	14	0	0	14	0	0
17	26479960	.	C	T	7	6	13	0	0	13	0	0
17	26479997	.	A	T	7	3	10	0	0	10	0	0
17	26480086	.	G	T	2	9	11	0	0	11	0	0
17	26480622	.	A	T	9	7	16	0	1	17	0	0
17	26480683	.	A	G	3	7	10	0	0	10	0	0
17	26502013	.	A	G	5	7	12	0	0	12	0	0
17	26502107	.	G	A	7	7	14	0	0	14	0	0
17	26507294	.	G	A	2	7	9	0	1	10	0	0
17	26516745	.	G	C	8	3	11	0	0	11	0	0
17	26516748	.	G	C	3	8	11	0	0	11	0	0
17	26516878	.	G	A	6	2	8	0	0	8	0	0
17	26517310	.	A	C	3	0	3	0	5	8	0	0
17	26519364	.	A	G	3	6	9	0	0	9	0	0
17	26519475	.	T	C	4	0	4	0	7	11	0	0
17	26519681	.	C	T	8	4	12	0	0	12	0	0
17	26519823	.	T	C	6	0	6	0	5	11	0	0
17	26537805	.	A	T	2	2	4	0	0	4	0	0
17	26577293	.	T	C	7	8	15	0	0	15	0	0
17	26585135	.	G	T	6	12	18	0	1	19	0	0
17	26585163	.	A	T	10	4	14	0	0	14	0	0
17	26585298	.	G	T	1	8	9	0	3	12	0	0
17	26585316	.	C	T	6	6	12	0	0	12	0	0
17	26585646	.	C	T	18	10	28	0	0	28	0	0
17	26585727	.	C	T	9	14	23	0	0	23	0	0
17	26585748	.	A	G	20	0	20	0	9	29	0	0
17	26585763	.	T	A	21	8	29	0	0	29	0	0
17	26590001	.	T	G	15	6	21	0	1	22	0	0
17	26590054	.	C	T	10	4	14	0	1	15	0	0
17	26590091	.	C	T	4	11	15	0	1	16	0	0
17	26590170	.	A	T	6	4	10	0	0	10	0	0
17	26590330	.	T	C	11	5	16	0	1	17	0	0
17	26590495	.	A	G	7	4	11	0	0	11	0	0
17	26590536	.	G	A	5	6	11	0	2	13	0	0
17	26590650	.	G	T	3	6	9	0	0	9	0	0
17	26594931	.	C	T	11	10	21	0	2	23	0	0
17	26594968	.	G	C	11	8	19	0	1	20	0	0
17	26599208	.	C	T	1	5	6	0	11	17	0	0
17	26600555	.	T	A	7	7	14	0	1	15	0	0
17	26600639	.	G	A	6	5	11	0	1	12	0	0
17	26600667	.	C	T	6	9	15	0	0	15	0	0
17	26600785	.	G	A	10	8	18	0	1	19	0	0
17	26600881	.	G	A	2	10	12	0	0	12	0	0
17	26603369	.	A	T	3	4	7	0	0	7	0	0
17	26604572	.	A	G	1	4	5	0	1	6	0	0
17	26604751	.	G	C	6	11	17	0	0	17	0	0
17	26604758	.	C	T	5	12	17	0	0	17	0	0
17	26604801	.	C	A	9	4	13	0	0	13	0	0
17	26604917	.	G	A	4	3	7	0	0	7	0	0
17	26630909	.	C	T	9	9	18	0	0	18	0	0
17	26639659	.	C	T	11	9	20	0	0	20	0	0
17	26639725	.	A	G	7	0	7	0	6	13	0	0
17	26642817	.	T	G	14	0	14	0	7	21	0	0
17	26642818	.	T	C	14	5	19	0	2	21	0	0
17	26657852	.	T	C	11	14	25	0	2	27	0	0
17	26662347	.	C	T	8	12	20	0	0	20	0	0
17	26683526	.	C	T	20	11	31	1	1	33	0	0
17	26689753	.	G	A	18	19	37	0	10	47	0	0
17	26689768	.	C	A	26	10	36	0	2	38	0	0
17	26689792	.	C	A	23	12	35	0	3	38	0	0
17	26690112	.	T	A	14	14	28	0	1	29	0	0
17	26690250	.	C	T	7	10	17	0	0	17	0	0
17	26690276	.	C	T	13	11	24	0	0	24	0	0
17	26690478	.	C	T	12	14	26	0	0	26	0	0
17	26690558	.	G	A	1	11	12	0	13	25	0	0
17	26714009	.	C	T	30	35	65	0	8	74	1	0
17	26722954	.	A	C	1	5	6	0	0	6	0	0
17	26741227	.	C	T	2	4	6	0	0	6	0	0
17	26741254	.	T	C	3	2	5	0	1	6	0	0
17	26741362	.	A	G	1	0	1	0	5	6	0	0
17	26743948	.	T	C	1	2	3	0	0	3	0	0
17	26744174	.	G	A	2	4	6	0	0	6	0	0
17	26744516	.	A	G	1	0	1	0	2	3	0	0
17	26744706	.	T	C	3	2	5	0	0	5	0	0
17	26744927	.	A	G	1	1	2	0	1	3	0	0
17	26744930	.	A	C	1	2	3	0	0	3	0	0
17	26744981	.	C	T	3	6	9	0	0	9	0	0
17	26745106	.	T	C	3	4	7	0	0	7	0	0
17	26745110	.	C	T	3	4	7	0	0	7	0	0
17	26747392	.	G	T	3	3	6	0	0	6	0	0
17	26747552	.	G	C	3	4	7	0	0	7	0	0
17	26749836	.	G	A	1	4	5	0	0	5	0	0
17	26810380	.	C	T	26	22	48	0	1	49	0	0
17	26813285	.	T	C	12	23	35	2	3	40	0	0
17	26831861	.	G	A	3	4	7	0	0	7	0	0
17	26832713	.	C	T	5	6	11	0	0	11	0	0
17	26832738	.	A	G	3	6	9	0	1	10	0	0
17	26846203	.	C	T	19	11	30	0	2	32	0	0
17	26846650	.	G	A	8	7	15	0	1	16	0	0
17	26846707	.	G	A	1	5	6	0	7	13	0	0
17	26846901	.	T	G	8	8	16	0	1	17	0	0
17	26879854	.	A	C	11	17	28	0	0	28	0	0
17	26879869	.	A	G	14	16	30	0	0	30	0	0
17	26879893	.	A	G	23	13	36	0	1	37	0	0
17	26880107	.	G	A	19	18	37	0	4	41	0	0
17	26880231	.	T	C	29	25	54	0	0	54	0	0
17	26880424	.	T	C	33	21	54	0	1	55	0	0
17	26880926	.	T	C	23	2	25	0	20	45	0	0
17	26880964	.	A	G	26	23	49	0	2	51	0	0
17	26881131	.	T	A	26	17	43	0	1	44	0	0
17	26881354	.	A	G	21	17	38	0	5	43	0	0
17	26881777	.	A	G	27	17	44	1	2	47	0	0
17	26911747	.	A	G	17	20	37	0	1	38	0	0
17	26928765	.	C	T	2	7	9	0	0	9	0	0
17	26928994	.	C	T	2	2	4	0	0	4	0	0
17	26929475	.	T	C	4	4	8	0	0	8	0	0
17	26929577	.	C	A	8	5	13	0	0	13	0	0
17	26929649	.	A	G	8	7	15	0	0	15	0	0
17	26929654	.	T	A	6	6	12	0	3	15	0	0
17	26929776	.	C	T	5	7	12	0	0	12	0	0
17	26929893	.	G	A	3	9	12	0	2	14	0	0
17	26933328	.	C	T	7	3	10	0	1	11	0	0
17	26934417	.	C	T	0	10	10	0	7	17	0	0
17	26935160	.	C	T	7	6	13	0	0	13	0	0
17	26935254	.	G	T	6	5	11	0	0	11	0	0
17	26935274	.	G	T	6	8	14	0	0	14	0	0
17	26935331	.	G	C	1	2	3	0	0	3	0	0
17	26985158	.	G	A	3	9	12	0	14	26	0	0
17	26985544	.	T	A	4	3	7	0	1	8	0	0
17	26985561	.	T	G	5	0	5	0	10	15	0	0
17	26985586	.	C	T	7	12	19	0	0	19	0	0
17	26985638	.	T	G	7	13	20	0	0	20	0	0
17	26985656	.	T	A	8	12	20	0	2	22	0	0
17	26985692	.	G	T	15	9	24	0	0	24	0	0
17	27064523	.	T	A	1	5	6	0	0	6	0	0
17	27064840	.	G	C	0	5	5	0	8	13	0	0
17	27152597	.	T	C	5	4	9	0	0	9	0	0
17	27154580	.	C	A	9	7	16	0	0	16	0	0
17	27154695	.	A	G	7	6	13	0	0	13	0	0
17	27158692	.	C	T	5	7	12	0	1	13	0	0
17	27160846	.	C	T	8	6	14	0	0	14	0	0
17	27160912	.	G	A	5	5	10	0	0	10	0	0
17	27162479	.	C	T	5	5	10	0	1	11	0	0
17	27163266	.	T	C	3	4	7	0	0	7	0	0
17	27164497	.	T	C	8	10	18	0	0	18	0	0
17	27164530	.	C	T	7	8	15	0	0	15	0	0
17	27166221	.	T	C	3	7	10	0	0	10	0	0
17	27166257	.	T	C	5	6	11	0	0	11	0	0
17	27166521	.	C	T	5	4	9	0	0	9	0	0
17	27168957	.	G	T	2	6	8	0	6	14	0	0
17	27169783	.	A	C	5	4	9	0	0	9	0	0
17	27170017	.	G	A	2	5	7	0	3	10	0	0
17	27170153	.	A	T	3	6	9	0	0	9	0	0
17	27170390	.	G	T	2	2	4	0	0	4	0	0
17	27170516	.	G	A	0	5	5	0	5	10	0	0
17	27170549	.	G	A	5	5	10	0	0	10	0	0
17	27170605	.	T	G	6	7	13	0	0	13	0	0
17	27170678	.	C	A	7	9	16	0	0	16	0	0
17	27170730	.	T	G	5	9	14	0	1	15	0	0
17	27170746	.	A	T	5	9	14	0	0	14	0	0
17	27171314	.	A	C	0	4	4	0	1	5	0	0
17	27176640	.	G	A	6	4	10	0	0	10	0	0
17	27176871	.	G	A	7	6	13	0	0	13	0	0
17	27176967	.	G	C	5	6	11	0	0	11	0	0
17	27176991	.	C	T	5	8	13	0	1	14	0	0
17	27177064	.	C	T	6	4	10	0	0	11	1	0
17	27177083	.	G	A	1	4	5	0	6	11	0	0
17	27177251	.	A	G	2	6	8	0	0	8	0	0
17	27177302	.	A	G	2	0	2	0	2	4	0	0
17	27177473	.	C	T	10	9	19	0	1	20	0	0
17	27177745	.	G	A	8	4	12	0	1	13	0	0
17	27177776	.	G	T	7	4	11	0	0	11	0	0
17	27177945	.	G	T	7	6	13	0	1	14	0	0
17	27178088	.	T	A	3	5	8	0	0	8	0	0
17	27178191	.	G	A	6	6	12	0	0	12	0	0
17	27178232	.	A	G	8	5	13	0	0	13	0	0
17	27178254	.	C	A	4	6	10	0	0	10	0	0
17	27178296	.	G	A	1	7	8	0	4	12	0	0
17	27178356	.	T	A	2	12	14	0	0	14	0	0
17	27178557	.	C	T	10	7	17	0	0	17	0	0
17	27178638	.	C	G	7	7	14	0	0	14	0	0
17	27178730	.	C	A	8	6	14	0	1	15	0	0
17	27178870	.	T	C	7	9	16	0	1	17	0	0
17	27179189	.	A	G	9	7	16	0	0	16	0	0
17	27179203	.	G	T	0	5	5	0	9	14	0	0
17	27179434	.	G	T	8	3	11	0	1	12	0	0
17	27179848	.	A	G	11	4	15	0	1	16	0	0
17	27180407	.	T	A	5	7	12	0	0	12	0	0
17	27180447	.	A	T	5	3	8	0	1	9	0	0
17	27180847	.	A	G	4	8	12	0	0	12	0	0
17	27181021	.	T	C	10	4	14	0	1	15	0	0
17	27181048	.	C	G	6	9	15	0	1	16	0	0
17	27181129	.	G	A	11	7	18	0	3	21	0	0
17	27181130	.	G	A	11	10	21	0	0	21	0	0
17	27181257	.	A	C	12	12	24	0	0	24	0	0
17	27181323	.	A	G	7	1	8	0	7	15	0	0
17	27181411	.	A	G	7	0	7	0	11	18	0	0
17	27181427	.	C	T	9	11	20	0	1	21	0	0
17	27181463	.	A	G	7	0	7	0	6	13	0	0
17	27181481	.	A	G	4	4	8	0	1	9	0	0
17	27181618	.	C	A	1	3	4	0	1	5	0	0
17	27181680	.	C	T	5	2	7	0	1	8	0	0
17	27182006	.	G	T	13	5	18	0	2	20	0	0
17	27182039	.	T	C	11	9	20	0	1	21	0	0
17	27182114	.	A	G	4	8	12	0	2	14	0	0
17	27182146	.	C	T	3	9	12	0	0	12	0	0
17	27182331	.	T	G	2	7	9	0	0	9	0	0
17	27182340	.	C	T	3	5	8	0	1	9	0	0
17	27182449	.	G	T	6	13	19	0	0	19	0	0
17	27182484	.	T	C	5	16	21	0	0	21	0	0
17	27182645	.	G	T	11	15	26	0	1	27	0	0
17	27182649	.	A	G	9	16	25	0	2	27	0	0
17	27182769	.	A	G	10	10	20	0	1	21	0	0
17	27182894	.	T	C	12	9	21	0	2	23	0	0
17	27182925	.	A	T	11	9	20	0	1	21	0	0
17	27182979	.	C	T	12	8	20	0	0	20	0	0
17	27191528	.	C	T	1	2	3	0	0	3	0	0
17	27192033	.	G	C	2	3	5	0	0	5	0	0
17	27192048	.	G	A	2	4	6	0	0	6	0	0
17	27192756	.	G	C	3	2	5	0	0	5	0	0
17	27194087	.	G	A	1	3	4	0	0	4	0	0
17	27194669	.	C	T	1	3	4	0	1	5	0	0
17	27194867	.	A	G	2	3	5	0	0	5	0	0
17	27272913	.	T	C	8	9	17	0	1	18	0	0
17	27273013	.	C	T	13	10	23	0	2	25	0	0
17	27401038	.	A	T	9	3	12	0	5	17	0	0
17	27408386	.	A	G	12	12	24	0	2	26	0	0
17	27408472	.	C	T	10	18	28	0	4	32	0	0
17	27408523	.	G	T	5	11	16	0	0	16	0	0
17	27408531	.	T	A	2	8	10	0	1	11	0	0
17	27408836	.	T	G	11	12	23	0	1	24	0	0
17	27408889	.	T	C	10	12	22	1	0	23	0	0
17	27413564	.	T	C	7	19	26	0	1	27	0	0
17	27413705	.	T	C	8	14	22	0	0	22	0	0
17	27414035	.	G	A	5	7	12	0	0	12	0	0
17	27414098	.	C	A	7	14	21	0	2	23	0	0
17	27414203	.	G	A	7	17	24	0	1	25	0	0
17	27414215	.	C	T	0	13	13	0	11	24	0	0
17	27414367	.	A	G	7	19	26	0	0	26	0	0
17	27414658	.	T	C	4	6	10	0	2	12	0	0
17	27414701	.	A	G	5	11	16	0	0	16	0	0
17	27414791	.	A	G	3	11	14	0	0	14	0	0
17	27414815	.	G	A	4	15	19	0	0	19	0	0
17	27415010	.	C	T	0	8	8	0	6	14	0	0
17	27435896	.	G	A	0	3	3	0	3	6	0	0
17	27435923	.	T	A	1	3	4	0	0	4	0	0
17	27723800	.	G	T	15	15	30	0	3	33	0	0
17	27807455	.	T	C	32	19	51	0	0	51	0	0
17	27808190	.	A	G	13	0	13	0	12	25	0	0
17	27808335	.	A	G	15	17	32	0	1	33	0	0
17	27808686	.	G	A	10	6	16	0	0	16	0	0
17	27808700	.	G	A	14	7	21	0	1	22	0	0
17	27808987	.	G	T	3	27	30	0	26	56	0	0
17	27809548	.	T	A	13	16	29	0	1	30	0	0
17	27809631	.	G	T	1	6	7	0	15	22	0	0
17	27809779	.	C	A	32	19	51	0	1	52	0	0
17	27809885	.	A	G	24	18	42	0	1	43	0	0
17	27811199	.	T	A	9	7	16	0	0	16	0	0
17	27811209	.	A	G	12	6	18	0	0	18	0	0
17	27811254	.	T	C	12	4	16	0	0	16	0	0
17	27811277	.	C	G	10	3	13	0	0	13	0	0
17	27812525	.	A	C	24	11	35	0	0	35	0	0
17	27812562	.	G	A	2	10	12	0	19	31	0	0
17	27812702	.	A	T	21	6	27	0	2	29	0	0
17	27812885	.	C	T	4	5	9	0	0	9	0	0
17	27813221	.	C	T	13	4	17	0	1	18	0	0
17	27813222	.	A	G	13	5	18	0	0	18	0	0
17	28049663	.	A	T	5	4	9	0	0	9	0	0
17	28049804	.	G	T	8	5	13	0	0	13	0	0
17	28050500	.	T	A	6	9	15	0	0	15	0	0
17	28050530	.	A	G	8	8	16	0	2	18	0	0
17	28050954	.	G	A	4	5	9	0	0	9	0	0
17	28051073	.	C	T	4	3	7	0	0	7	0	0
17	28051129	.	G	A	6	5	11	0	0	11	0	0
17	28051222	.	C	T	1	2	3	0	0	3	0	0
17	28051247	.	T	A	5	2	7	0	0	7	0	0
17	28051465	.	T	C	5	5	10	0	1	11	0	0
17	28051504	.	G	T	3	4	7	0	0	7	0	0
17	28051605	.	A	G	3	9	12	0	0	12	0	0
17	28051739	.	A	G	2	11	13	0	1	14	0	0
17	28052322	.	C	A	9	8	17	0	0	17	0	0
17	28067389	.	C	T	11	15	26	0	1	27	0	0
17	28067472	.	A	C	9	8	17	0	4	21	0	0
17	28067618	.	A	G	4	9	13	0	0	13	0	0
17	28067856	.	C	T	14	8	22	0	1	23	0	0
17	28068083	.	T	C	5	9	14	0	0	14	0	0
17	28068087	.	G	T	6	8	14	0	0	14	0	0
17	28068168	.	G	A	5	6	11	0	0	11	0	0
17	28068262	.	T	G	13	1	14	0	7	21	0	0
17	28068276	.	C	T	12	7	19	0	0	19	0	0
17	28068507	.	A	G	5	5	10	0	1	11	0	0
17	28068514	.	T	C	5	5	10	0	1	11	0	0
17	28068832	.	T	A	8	8	16	0	0	16	0	0
17	28068916	.	C	T	5	11	16	0	1	17	0	0
17	28069170	.	G	A	10	20	30	0	1	31	0	0
17	28069341	.	G	T	10	8	18	0	0	18	0	0
17	28069342	.	T	C	10	8	18	0	1	19	0	0
17	28069645	.	G	T	8	11	19	0	1	20	0	0
17	28069716	.	G	C	20	17	37	0	0	37	0	0
17	28069787	.	G	A	5	20	25	0	13	38	0	0
17	28070078	.	G	C	6	5	11	0	0	11	0	0
17	28070167	.	C	T	10	15	25	0	0	25	0	0
17	28070284	.	G	A	6	9	15	0	0	15	0	0
17	28070286	.	A	C	7	9	16	0	0	16	0	0
17	28070481	.	T	A	18	13	31	0	0	31	0	0
17	28070600	.	C	A	18	11	29	0	1	30	0	0
17	28070840	.	G	A	14	9	23	0	1	24	0	0
17	28070879	.	T	G	14	6	20	0	0	20	0	0
17	28070897	.	T	A	10	5	15	0	1	16	0	0
17	28071260	.	A	G	8	8	16	0	1	17	0	0
17	28084592	.	C	T	7	15	22	0	0	22	0	0
17	28084733	.	T	C	19	17	36	4	1	41	0	0
17	28084869	.	A	C	19	21	40	0	0	40	0	0
17	28084996	.	A	T	21	16	37	0	1	38	0	0
17	28097235	.	G	A	13	17	30	0	1	31	0	0
17	28097672	.	T	C	14	14	28	0	1	29	0	0
17	28100598	.	C	T	2	14	16	0	15	31	0	0
17	28166980	.	C	T	4	4	8	0	2	10	0	0
17	28167235	.	T	C	6	0	6	0	4	10	0	0
17	28168054	.	A	G	6	4	10	0	0	10	0	0
17	28168363	.	G	A	3	3	6	0	0	6	0	0
17	28168366	.	G	A	3	3	6	0	0	6	0	0
17	28340358	.	C	A	4	4	8	0	0	8	0	0
17	28340385	.	C	T	6	5	11	0	0	11	0	0
17	28340549	.	C	T	5	4	9	0	1	10	0	0
17	28408024	.	A	C	3	2	5	0	1	6	0	0
17	28423698	.	T	C	2	5	7	0	0	7	0	0
17	28433043	.	A	G	6	6	12	0	0	12	0	0
17	28440296	.	T	C	5	3	8	0	0	8	0	0
17	28461857	.	G	A	0	4	4	0	9	13	0	0
17	28466228	.	T	C	3	4	7	0	2	9	0	0
17	28466273	.	C	T	3	7	10	0	0	10	0	0
17	28497878	.	T	C	8	6	14	0	0	14	0	0
17	28560736	.	T	C	7	8	15	0	2	17	0	0
17	28563725	.	G	A	11	14	25	0	0	25	0	0
17	28628439	.	G	A	1	3	4	0	0	4	0	0
17	28637139	.	G	A	0	2	2	0	3	5	0	0
17	28637157	.	T	C	2	2	4	0	0	4	0	0
17	28638008	.	G	A	2	3	5	0	0	5	0	0
17	28639089	.	C	T	1	4	5	0	0	5	0	0
17	28639333	.	T	G	2	3	5	0	0	5	0	0
17	28642220	.	C	G	1	2	3	0	1	4	0	0
17	28642352	.	C	T	2	2	4	0	0	4	0	0
17	28643635	.	C	T	6	4	10	0	0	10	0	0
17	28643730	.	A	G	3	0	3	0	2	5	0	0
17	28655195	.	G	A	0	3	3	0	5	8	0	0
17	28657421	.	G	T	5	6	11	0	0	11	0	0
17	28661628	.	C	G	8	0	8	0	5	13	0	0
17	28661931	.	G	T	1	4	5	0	1	6	0	0
17	28668465	.	T	C	10	8	18	0	1	19	0	0
17	28668627	.	C	T	7	3	10	0	0	10	0	0
17	28669185	.	G	A	1	3	4	0	0	4	0	0
17	28670428	.	C	T	5	9	14	0	0	14	0	0
17	28680051	.	C	T	8	4	12	0	0	12	0	0
17	28680258	.	C	T	3	3	6	0	0	6	0	0
17	28680634	.	G	A	9	4	13	0	1	14	0	0
17	28695753	.	C	T	12	11	23	0	0	23	0	0
17	28701100	.	G	A	7	8	15	0	2	17	0	0
17	28707268	.	T	A	9	12	21	0	1	22	0	0
17	28724530	.	A	G	5	0	5	0	14	19	0	0
17	28724539	.	A	T	7	11	18	0	1	19	0	0
17	28724833	.	T	C	14	14	28	0	1	29	0	0
17	28725346	.	A	G	8	1	9	0	8	17	0	0
17	28730705	.	C	T	5	9	14	0	0	14	0	0
17	28738387	.	C	T	5	8	13	0	0	13	0	0
17	28738675	.	A	G	13	0	13	0	11	24	0	0
17	28738714	.	T	C	10	8	18	0	1	19	0	0
17	28741442	.	G	A	12	6	18	0	1	19	0	0
17	28741467	.	G	A	1	13	14	0	9	23	0	0
17	28741540	.	A	G	13	0	13	0	7	21	1	0
17	28741752	.	C	T	10	6	16	0	1	17	0	0
17	28741934	.	C	T	7	9	16	0	1	17	0	0
17	28742263	.	G	C	15	13	28	0	3	31	0	0
17	28742385	.	T	A	7	9	16	0	0	16	0	0
17	28742505	.	T	G	23	11	34	0	0	34	0	0
17	28742559	.	C	T	17	15	32	0	1	33	0	0
17	28742681	.	C	T	3	9	12	0	0	12	0	0
17	28742755	.	C	A	3	3	6	0	1	7	0	0
17	28761064	.	A	G	2	2	4	0	0	4	0	0
17	28761069	.	T	A	2	3	5	0	0	5	0	0
17	28771228	.	T	A	15	10	25	0	2	27	0	0
17	28778186	.	C	T	5	10	15	0	2	17	0	0
17	28784090	.	G	T	10	9	19	0	0	19	0	0
17	28785010	.	G	A	11	9	20	0	1	21	0	0
17	28786873	.	G	A	8	12	20	0	0	20	0	0
17	28789014	.	C	T	2	5	7	0	13	20	0	0
17	28939316	.	T	C	6	3	9	0	0	9	0	0
17	28948905	.	G	A	6	4	10	0	0	10	0	0
17	28968461	.	T	C	23	15	38	0	1	39	0	0
17	28968668	.	A	T	6	2	8	0	0	8	0	0
17	29117383	.	G	A	6	2	8	0	0	8	0	0
17	29196480	.	G	A	1	3	4	0	0	4	0	0
17	29196555	.	G	A	1	2	3	0	0	3	0	0
17	29227594	.	G	A	2	2	4	0	0	4	0	0
17	29227600	.	G	A	2	2	4	0	0	4	0	0
17	29227691	.	T	A	2	2	4	0	0	4	0	0
17	29228114	.	G	A	3	4	7	0	1	9	1	0
17	29228222	.	A	G	3	4	7	0	0	7	0	0
17	29251810	.	G	C	6	3	9	0	0	9	0	0
17	29252043	.	C	T	3	8	11	0	2	13	0	0
17	29252122	.	C	A	10	6	16	0	1	17	0	0
17	29252218	.	C	T	10	5	15	0	0	15	0	0
17	29252254	.	C	T	3	10	13	0	0	13	0	0
17	29252295	.	T	C	6	3	9	0	1	10	0	0
17	29252308	.	T	G	4	3	7	0	0	7	0	0
17	29252352	.	C	T	4	3	7	0	1	8	0	0
17	29252754	.	C	G	0	5	5	0	2	7	0	0
17	29270021	.	C	T	5	7	12	0	1	13	0	0
17	29270939	.	C	T	0	4	4	0	4	8	0	0
17	29276615	.	T	G	2	2	4	0	0	4	0	0
17	29276674	.	A	G	2	2	4	0	0	4	0	0
17	29282893	.	A	T	9	4	13	0	0	13	0	0
17	29282901	.	C	A	10	3	13	0	0	13	0	0
17	29283096	.	T	C	5	5	10	0	0	10	0	0
17	29283126	.	T	A	3	9	12	0	0	12	0	0
17	29283296	.	C	T	5	3	8	1	0	9	0	0
17	29283300	.	T	C	3	0	3	1	4	8	0	0
17	29283723	.	A	T	5	2	7	0	0	7	0	0
17	29283866	.	T	C	6	8	14	0	0	14	0	0
17	29283902	.	G	A	7	4	11	0	0	11	0	0
17	29283920	.	A	C	7	0	7	2	8	17	0	0
17	29283943	.	A	G	8	12	20	2	0	22	0	0
17	29283962	.	A	G	8	13	21	2	0	23	0	0
17	29288057	.	G	T	7	10	17	0	1	18	0	0
17	29288718	.	A	G	8	16	24	0	0	24	0	0
17	29298224	.	A	G	3	7	10	0	0	10	0	0
17	29300641	.	A	T	4	4	8	0	0	8	0	0
17	29300650	.	A	G	7	4	11	0	0	11	0	0
17	29301058	.	G	C	3	3	6	0	0	6	0	0
17	29306749	.	C	A	6	4	10	0	0	10	0	0
17	29308706	.	G	A	8	5	13	0	0	13	0	0
17	29309024	.	G	A	6	5	11	0	1	12	0	0
17	29311761	.	A	G	3	4	7	0	0	7	0	0
17	29334520	.	T	A	9	13	22	0	4	26	0	0
17	29335645	.	G	A	8	11	19	0	2	21	0	0
17	29339149	.	T	G	11	17	28	0	2	30	0	0
17	29341079	.	C	T	15	7	22	0	1	23	0	0
17	29341118	.	C	T	11	20	31	0	1	32	0	0
17	29341597	.	T	C	15	12	27	0	1	28	0	0
17	29342904	.	G	A	2	8	10	0	10	20	0	0
17	29342947	.	C	T	9	11	20	0	2	22	0	0
17	29343143	.	T	C	8	18	26	0	0	26	0	0
17	29343153	.	G	A	8	16	24	0	0	24	0	0
17	29343358	.	A	G	14	15	29	0	0	29	0	0
17	29343494	.	A	G	2	6	8	0	0	8	0	0
17	29345725	.	T	G	7	5	12	0	1	13	0	0
17	29349739	.	G	A	1	9	10	0	3	13	0	0
17	29364518	.	G	A	5	7	12	0	1	13	0	0
17	29364713	.	C	T	3	6	9	0	0	9	0	0
17	29367320	.	T	C	9	10	19	0	0	19	0	0
17	29369029	.	C	T	8	9	17	1	0	18	0	0
17	29369072	.	T	C	6	9	15	1	3	19	0	0
17	29369114	.	T	C	5	9	14	0	0	14	0	0
17	29369213	.	T	G	7	15	22	0	0	22	0	0
17	29369414	.	G	A	9	11	20	0	0	20	0	0
17	29369612	.	A	G	9	17	26	0	1	27	0	0
17	29369713	.	A	C	8	11	19	0	2	21	0	0
17	29369748	.	C	T	13	11	24	0	0	24	0	0
17	29369780	.	C	A	6	12	18	0	2	20	0	0
17	29369831	.	A	T	10	2	12	0	0	12	0	0
17	29369851	.	A	G	4	0	4	0	2	6	0	0
17	29370260	.	T	A	5	4	9	0	1	10	0	0
17	29798098	.	A	G	3	9	12	0	0	12	0	0
17	29798312	.	C	A	1	16	17	0	13	30	0	0
17	29804291	.	G	C	12	5	17	0	0	17	0	0
17	29841590	.	A	T	8	14	22	0	3	25	0	0
17	29877079	.	C	T	0	4	4	0	6	10	0	0
17	29877094	.	A	G	3	5	8	0	0	8	0	0
17	30052097	.	T	C	2	3	5	0	0	5	0	0
17	30409291	.	G	A	2	3	5	0	0	5	0	0
17	30411205	.	C	T	2	3	5	0	0	5	0	0
17	30411208	.	A	G	2	3	5	0	0	5	0	0
17	30411474	.	C	T	2	2	4	0	0	4	0	0
17	30411498	.	C	T	2	3	5	0	0	5	0	0
17	30414430	.	C	T	3	2	5	0	0	5	0	0
17	30458569	.	C	T	12	6	18	0	0	18	0	0
17	30459602	.	C	A	3	3	6	0	0	6	0	0
17	30460216	.	T	C	6	7	13	0	2	15	0	0
17	30460217	.	G	C	6	9	15	0	0	15	0	0
17	30464806	.	A	T	4	13	17	0	1	18	0	0
17	30465779	.	T	A	3	5	8	0	0	8	0	0
17	30466186	.	G	A	10	6	16	0	0	16	0	0
17	30466395	.	T	C	8	7	15	0	1	16	0	0
17	30468428	.	C	T	9	7	16	0	2	18	0	0
17	30468889	.	T	G	4	0	4	0	2	6	0	0
17	30469200	.	C	A	10	4	14	0	1	15	0	0
17	30469350	.	A	T	5	7	12	0	0	12	0	0
17	30469364	.	T	C	5	5	10	0	0	10	0	0
17	30470034	.	C	T	4	4	8	0	1	9	0	0
17	30474161	.	A	G	6	9	15	0	0	15	0	0
17	30474226	.	A	G	3	7	10	0	1	11	0	0
17	30476939	.	C	A	0	8	8	0	3	11	0	0
17	30476978	.	A	G	3	5	8	0	0	8	0	0
17	30478808	.	A	G	11	4	15	0	0	15	0	0
17	30478897	.	G	A	4	7	11	0	0	11	0	0
17	30478943	.	A	G	6	5	11	0	0	11	0	0
17	30479161	.	A	G	5	7	12	0	1	13	0	0
17	30479359	.	T	C	4	11	15	0	0	15	0	0
17	30479647	.	T	C	5	4	9	0	0	9	0	0
17	30486671	.	T	C	9	0	9	0	6	15	0	0
17	30486971	.	G	A	5	4	9	0	1	10	0	0
17	30487040	.	G	A	6	4	10	0	0	10	0	0
17	30487094	.	G	C	7	7	14	0	0	14	0	0
17	30492088	.	C	T	4	6	10	0	0	10	0	0
17	30492999	.	A	C	5	1	6	0	4	10	0	0
17	30493478	.	T	G	1	3	4	0	1	5	0	0
17	30493500	.	C	T	1	6	7	0	0	7	0	0
17	30493518	.	C	T	2	6	8	0	0	8	0	0
17	30494073	.	T	G	6	5	11	0	1	12	0	0
17	30497848	.	G	C	3	8	11	0	0	11	0	0
17	30498084	.	C	T	6	8	14	0	1	15	0	0
17	30503154	.	T	C	1	2	3	0	0	3	0	0
17	30505439	.	T	C	6	0	6	0	5	11	0	0
17	30505493	.	T	C	6	7	13	0	0	13	0	0
17	30506673	.	A	C	4	5	9	0	1	10	0	0
17	30506896	.	A	G	2	3	5	0	0	5	0	0
17	30506899	.	G	A	2	3	5	0	0	5	0	0
17	30574072	.	T	A	4	2	6	0	0	6	0	0
17	30583641	.	A	T	1	2	3	0	0	3	0	0
17	30584232	.	C	A	2	3	5	0	0	5	0	0
17	30584301	.	T	C	3	2	5	0	0	5	0	0
17	30584929	.	A	C	1	2	3	0	0	3	0	0
17	30585020	.	G	C	4	2	6	0	0	6	0	0
17	30585604	.	C	T	7	6	13	0	0	13	0	0
17	30585682	.	A	T	3	4	7	0	0	7	0	0
17	30586485	.	C	T	4	3	7	0	0	7	0	0
17	30586521	.	A	G	2	0	2	0	2	4	0	0
17	30587288	.	T	C	4	5	9	0	0	9	0	0
17	30589166	.	T	C	5	3	8	0	0	8	0	0
17	30589379	.	A	G	7	9	16	0	0	16	0	0
17	30589732	.	G	A	0	4	4	0	10	14	0	0
17	30589740	.	G	A	9	4	13	0	0	13	0	0
17	30590020	.	A	G	9	6	15	0	0	15	0	0
17	30590271	.	G	T	7	10	17	0	1	18	0	0
17	30590273	.	C	G	6	11	17	0	0	17	0	0
17	30590325	.	C	T	8	8	16	0	0	16	0	0
17	30590367	.	G	A	6	7	13	0	1	14	0	0
17	30590838	.	T	C	9	4	13	0	0	13	0	0
17	30590842	.	C	A	8	3	11	0	0	11	0	0
17	30749304	.	C	A	6	4	10	0	0	10	0	0
17	30816937	.	T	C	4	6	10	0	0	10	0	0
17	30817044	.	G	A	2	5	7	0	0	7	0	0
17	30817119	.	T	A	1	6	7	0	1	8	0	0
17	30817170	.	A	G	2	2	4	0	0	4	0	0
17	30855667	.	A	G	1	2	3	0	0	3	0	0
17	30857288	.	A	G	12	14	26	0	0	26	0	0
17	30858809	.	C	T	2	13	15	0	17	32	0	0
17	30860630	.	G	T	18	13	31	0	2	33	0	0
17	30862909	.	A	G	10	12	22	0	1	23	0	0
17	30900986	.	C	A	4	3	7	0	0	7	0	0
17	30912562	.	C	A	12	14	26	0	0	26	0	0
17	30936802	.	C	T	0	9	9	0	8	17	0	0
17	30979170	.	T	C	11	5	16	0	0	16	0	0
17	30979208	.	T	C	9	4	13	0	0	13	0	0
17	30979339	.	T	C	9	9	18	0	0	18	0	0
17	30979391	.	T	C	5	0	5	0	19	24	0	0
17	30979465	.	T	C	4	6	10	0	0	10	0	0
17	30979518	.	G	A	4	9	13	0	1	14	0	0
17	30980336	.	A	G	8	10	18	0	0	18	0	0
17	30986665	.	T	C	8	17	25	0	0	25	0	0
17	30986712	.	G	T	11	13	24	0	0	24	0	0
17	30992178	.	T	C	3	8	11	0	0	11	0	0
17	30995008	.	G	A	4	9	13	0	0	13	0	0
17	31014189	.	G	A	10	8	18	0	0	18	0	0
17	31014192	.	T	C	8	7	15	0	4	19	0	0
17	31021588	.	A	G	6	10	16	0	1	17	0	0
17	31058673	.	T	A	3	3	6	0	0	6	0	0
17	31058772	.	G	A	11	5	16	0	0	16	0	0
17	31058780	.	G	C	11	3	14	0	2	16	0	0
17	31058807	.	C	A	9	4	13	0	0	13	0	0
17	31195800	.	G	T	1	3	4	0	4	8	0	0
17	31195824	.	T	C	4	5	9	0	0	9	0	0
17	31198945	.	C	T	4	11	15	0	0	15	0	0
17	31199717	.	G	A	0	11	11	0	7	18	0	0
17	31200222	.	T	C	10	3	13	0	1	14	0	0
17	31200247	.	C	A	9	4	13	0	3	16	0	0
17	31200394	.	G	C	6	6	12	0	0	12	0	0
17	31200475	.	A	T	11	12	23	0	0	23	0	0
17	31200481	.	C	T	9	12	21	0	2	23	0	0
17	31200621	.	C	T	8	9	17	0	1	18	0	0
17	31201207	.	C	T	9	8	17	0	0	17	0	0
17	31201348	.	A	G	10	0	10	0	12	22	0	0
17	31201523	.	A	T	11	7	18	0	2	20	0	0
17	31201894	.	A	C	9	8	17	0	0	17	0	0
17	31201954	.	A	G	13	14	27	0	4	31	0	0
17	31205360	.	G	A	5	2	7	0	0	7	0	0
17	31205375	.	T	A	3	2	5	0	0	5	0	0
17	31205508	.	G	A	2	2	4	0	0	4	0	0
17	31205579	.	G	A	4	2	6	0	0	6	0	0
17	31205600	.	T	C	4	0	4	0	4	8	0	0
17	31205614	.	G	A	4	4	8	0	0	8	0	0
17	31205727	.	G	A	6	3	9	0	0	9	0	0
17	31205775	.	T	C	3	3	6	0	0	6	0	0
17	31205865	.	G	A	3	2	5	0	0	5	0	0
17	31214409	.	A	T	4	5	9	0	0	9	0	0
17	31214459	.	A	T	10	5	15	0	0	15	0	0
17	31214665	.	G	C	5	0	5	0	6	11	0	0
17	31217113	.	T	A	11	8	19	0	0	19	0	0
17	31219140	.	C	T	1	5	6	0	8	14	0	0
17	31219208	.	T	C	5	0	5	0	9	14	0	0
17	31222505	.	A	T	16	11	27	0	1	28	0	0
17	31228767	.	G	C	19	9	28	0	0	28	0	0
17	31228801	.	C	T	14	4	18	0	0	18	0	0
17	31228837	.	G	A	2	7	9	0	12	21	0	0
17	31228900	.	T	C	5	7	12	0	0	12	0	0
17	31228942	.	G	A	2	3	5	0	0	5	0	0
17	31277169	.	A	T	8	9	17	0	1	18	0	0
17	31277443	.	A	G	15	14	29	0	3	32	0	0
17	31277820	.	C	A	8	6	14	0	1	15	0	0
17	31277855	.	G	A	13	11	24	0	1	25	0	0
17	31277987	.	T	C	10	0	10	0	15	25	0	0
17	31278022	.	G	A	12	16	28	0	0	28	0	0
17	31278433	.	C	A	13	19	32	0	2	34	0	0
17	31283510	.	C	G	1	12	13	0	9	22	0	0
17	31286221	.	G	A	4	7	11	0	1	12	0	0
17	31297284	.	G	A	11	9	20	0	1	21	0	0
17	31297768	.	G	T	6	3	9	0	1	10	0	0
17	31297791	.	C	T	9	4	13	0	1	14	0	0
17	31298042	.	A	C	9	9	18	0	1	19	0	0
17	31298055	.	T	C	8	8	16	0	0	16	0	0
17	31298349	.	C	T	0	3	3	0	7	10	0	0
17	31307837	.	A	G	3	7	10	0	0	10	0	0
17	31307882	.	T	C	5	5	10	0	1	11	0	0
17	31346653	.	C	T	6	10	16	0	0	16	0	0
17	31346695	.	A	G	8	8	16	0	0	16	0	0
17	31346712	.	G	A	7	10	17	0	2	19	0	0
17	31346840	.	A	G	10	12	22	0	0	22	0	0
17	31347029	.	T	A	12	18	30	0	0	30	0	0
17	31347046	.	T	G	14	19	33	0	1	34	0	0
17	31347193	.	A	C	12	17	29	0	1	30	0	0
17	31347254	.	A	G	15	15	30	0	0	30	0	0
17	31347344	.	C	G	16	12	28	0	0	28	0	0
17	31355841	.	C	T	10	14	24	0	1	25	0	0
17	31357531	.	C	T	11	12	23	0	0	23	0	0
17	31360631	.	T	C	10	15	25	0	1	26	0	0
17	31360763	.	G	A	6	5	11	0	0	11	0	0
17	31360786	.	G	A	9	5	14	1	1	16	0	0
17	31360804	.	C	T	11	9	20	1	1	22	0	0
17	31360854	.	G	A	9	12	21	0	0	21	0	0
17	31376521	.	T	C	1	3	4	0	0	4	0	0
17	31376532	.	C	T	1	4	5	0	0	5	0	0
17	31376560	.	C	A	1	4	5	0	0	5	0	0
17	31385042	.	A	G	2	2	4	0	0	4	0	0
17	31393730	.	A	T	1	2	3	0	0	3	0	0
17	31393786	.	T	C	1	4	5	0	0	5	0	0
17	31393845	.	A	G	5	1	6	0	3	9	0	0
17	31393855	.	T	A	5	1	6	0	2	8	0	0
17	31394023	.	T	C	2	2	4	0	0	4	0	0
17	31401193	.	C	T	0	3	3	0	1	4	0	0
17	31415992	.	T	A	1	2	3	0	1	4	0	0
17	31545776	.	C	G	1	2	3	0	2	5	0	0
17	31545935	.	A	G	3	7	10	0	1	11	0	0
17	31545971	.	C	A	1	9	10	0	4	14	0	0
17	31546169	.	G	A	7	7	14	1	0	15	0	0
17	31548807	.	G	A	2	3	5	0	1	6	0	0
17	31550834	.	G	A	1	2	3	0	0	3	0	0
17	31565642	.	G	A	0	2	2	0	1	3	0	0
17	31579362	.	G	A	3	2	5	0	0	5	0	0
17	31586481	.	A	T	2	3	5	0	0	5	0	0
17	31586484	.	C	T	3	3	6	0	0	6	0	0
17	31586688	.	C	T	3	2	5	0	0	5	0	0
17	31587926	.	A	C	1	2	3	0	0	3	0	0
17	31588923	.	C	T	2	3	5	0	0	5	0	0
17	31590143	.	G	T	0	2	2	0	2	4	0	0
17	31606944	.	A	C	2	3	5	0	0	5	0	0
17	31611632	.	C	T	0	3	3	0	3	6	0	0
17	31611895	.	G	C	2	2	4	0	0	4	0	0
17	31611902	.	T	A	5	3	8	0	0	8	0	0
17	31612019	.	A	G	7	6	13	0	0	13	0	0
17	31612027	.	A	G	6	0	6	0	5	11	0	0
17	31616799	.	T	C	13	10	23	0	0	23	0	0
17	31618624	.	C	T	17	14	31	0	0	31	0	0
17	31618636	.	T	C	14	16	30	0	1	31	0	0
17	31618953	.	T	C	12	17	29	0	4	33	0	0
17	31618962	.	A	G	16	16	32	0	1	33	0	0
17	31621894	.	C	T	10	4	14	0	1	15	0	0
17	31621921	.	C	A	7	6	13	0	0	13	0	0
17	31622024	.	C	A	5	16	21	0	1	22	0	0
17	31622083	.	A	C	6	17	23	0	3	26	0	0
17	31622123	.	C	A	9	15	24	0	0	24	0	0
17	31622233	.	T	A	7	10	17	0	0	17	0	0
17	31622367	.	A	G	13	9	22	0	0	22	0	0
17	31622662	.	C	T	5	11	16	0	0	16	0	0
17	31622690	.	A	C	4	6	10	0	1	11	0	0
17	31622715	.	T	C	5	4	9	0	0	9	0	0
17	31623191	.	C	T	1	2	3	0	1	4	0	0
17	31623588	.	A	G	7	3	10	0	0	10	0	0
17	31623829	.	G	C	15	7	22	0	2	24	0	0
17	31624119	.	A	T	5	3	8	0	2	10	0	0
17	31624604	.	A	G	9	13	22	0	0	22	0	0
17	31624652	.	C	T	1	12	13	0	7	20	0	0
17	31624682	.	A	G	11	7	18	0	1	19	0	0
17	31624716	.	T	A	10	10	20	0	1	21	0	0
17	31628812	.	C	A	0	11	11	0	8	19	0	0
17	31628953	.	G	T	10	14	24	0	0	24	0	0
17	31632288	.	T	C	3	6	9	0	0	9	0	0
17	31632330	.	A	G	7	9	16	0	0	16	0	0
17	31632751	.	C	T	7	5	12	0	0	12	0	0
17	31633027	.	A	G	8	7	15	0	1	16	0	0
17	31633186	.	C	T	13	17	30	0	2	32	0	0
17	31639721	.	T	C	3	6	9	0	0	9	0	0
17	31697158	.	A	G	2	3	5	0	0	5	0	0
17	31699881	.	G	T	3	3	6	0	0	6	0	0
17	31699931	.	A	G	2	2	4	0	1	5	0	0
17	31700087	.	T	C	1	2	3	0	0	3	0	0
17	31704999	.	G	A	3	5	8	0	0	8	0	0
17	31718997	.	A	T	1	2	3	0	0	3	0	0
17	31721451	.	G	A	1	9	10	0	8	18	0	0
17	31739475	.	C	T	12	8	20	0	0	20	0	0
17	31743088	.	T	C	5	3	8	0	1	9	0	0
17	31744553	.	G	A	0	8	8	0	8	16	0	0
17	31744849	.	C	T	5	3	8	0	0	8	0	0
17	31745597	.	C	A	9	10	19	0	1	20	0	0
17	31746341	.	T	A	13	11	24	0	0	24	0	0
17	31746553	.	T	C	10	15	25	0	0	25	0	0
17	31746833	.	G	A	17	5	22	0	3	25	0	0
17	31796240	.	C	T	14	10	24	0	1	25	0	0
17	31796481	.	T	G	15	6	21	0	0	21	0	0
17	31796576	.	G	A	9	8	17	0	2	19	0	0
17	31796821	.	T	A	7	5	12	0	0	13	1	0
17	31805929	.	A	C	5	4	9	0	0	9	0	0
17	31806005	.	T	A	2	3	5	0	1	6	0	0
17	31806207	.	A	T	4	4	8	0	0	9	1	0
17	31806710	.	T	C	3	3	6	0	1	7	0	0
17	31806994	.	T	A	1	4	5	0	4	9	0	0
17	31807063	.	G	A	8	9	17	0	0	17	0	0
17	31807085	.	G	A	7	3	10	0	0	10	0	0
17	31809546	.	G	T	3	2	5	0	1	6	0	0
17	31816422	.	T	C	3	4	7	0	2	9	0	0
17	31820558	.	G	A	3	3	6	0	0	6	0	0
17	31820605	.	T	C	11	6	17	0	0	17	0	0
17	31823533	.	G	A	1	4	5	0	1	6	0	0
17	31823547	.	C	T	3	2	5	0	0	5	0	0
17	31935486	.	C	T	3	2	5	0	0	5	0	0
17	31935889	.	A	G	2	3	5	0	0	5	0	0
17	32322129	.	A	G	2	0	2	0	3	5	0	0
17	32322173	.	T	G	3	3	6	0	0	6	0	0
17	32322192	.	T	C	2	4	6	0	0	6	0	0
17	32333457	.	G	A	2	2	4	0	0	4	0	0
17	32333463	.	C	A	2	2	4	0	0	4	0	0
17	32333968	.	G	C	1	2	3	0	0	3	0	0
17	32359673	.	T	C	3	1	4	0	1	5	0	0
17	32366387	.	A	G	4	6	10	0	1	11	0	0
17	32366543	.	A	G	5	7	12	0	0	12	0	0
17	32367193	.	A	G	2	8	10	0	0	10	0	0
17	32367238	.	A	C	3	7	10	0	0	10	0	0
17	32401112	.	T	A	1	3	4	0	0	4	0	0
17	32408601	.	G	T	1	3	4	0	0	4	0	0
17	32500495	.	G	A	23	25	48	0	9	57	0	0
17	32503110	.	G	A	3	41	44	1	32	77	0	0
17	32516973	.	T	C	30	26	56	0	2	58	0	0
17	32524654	.	C	T	36	19	55	1	1	57	0	0
17	32524851	.	T	G	27	34	61	2	5	68	0	0
17	32532056	.	A	G	2	5	7	0	0	7	0	0
17	32532062	.	A	C	2	3	5	0	0	5	0	0
17	32532099	.	G	A	2	3	5	0	0	5	0	0
17	32532794	.	G	T	3	4	7	0	0	7	0	0
17	32532795	.	C	T	3	4	7	0	0	7	0	0
17	32535870	.	C	A	6	9	15	0	0	15	0	0
17	32535977	.	T	C	2	4	6	0	0	6	0	0
17	32536067	.	G	C	1	3	4	0	1	5	0	0
17	32536401	.	C	T	1	4	5	0	0	5	0	0
17	32538360	.	C	G	2	4	6	0	0	6	0	0
17	32538608	.	A	G	1	0	1	0	7	8	0	0
17	32538638	.	A	G	2	4	6	0	0	6	0	0
17	32542518	.	A	C	2	2	4	0	0	4	0	0
17	32542884	.	C	T	2	3	5	0	0	5	0	0
17	32549402	.	T	C	3	6	9	0	0	9	0	0
17	32549416	.	G	A	6	6	12	0	0	12	0	0
17	32549725	.	C	G	5	3	8	0	0	8	0	0
17	32606904	.	T	G	2	3	5	0	0	5	0	0
17	32607414	.	A	G	3	2	5	0	0	5	0	0
17	32607443	.	A	T	2	2	4	0	0	4	0	0
17	32623004	.	T	G	27	0	27	0	13	40	0	0
17	32623009	.	T	G	24	11	35	0	2	37	0	0
17	32624451	.	C	T	21	7	28	0	0	28	0	0
17	32624460	.	T	C	19	4	23	0	2	25	0	0
17	32624653	.	A	C	19	9	28	0	1	29	0	0
17	32624668	.	A	T	18	9	27	0	1	28	0	0
17	32624707	.	T	C	19	17	36	0	0	36	0	0
17	32624725	.	C	T	18	16	34	0	2	36	0	0
17	32624910	.	T	C	19	10	29	0	2	31	0	0
17	32624916	.	A	T	15	11	26	0	3	29	0	0
17	32629918	.	G	T	30	9	39	0	2	41	0	0
17	32631513	.	A	T	11	4	15	0	0	15	0	0
17	32631533	.	A	G	9	6	15	0	1	16	0	0
17	32631560	.	G	T	8	17	25	0	2	27	0	0
17	32634254	.	C	T	8	4	12	0	1	13	0	0
17	32636025	.	A	T	3	10	13	0	0	13	0	0
17	32636179	.	T	C	6	0	6	0	7	13	0	0
17	33306121	.	A	G	4	10	14	0	0	14	0	0
17	35248121	.	T	A	3	13	16	0	1	17	0	0
17	36938893	.	T	C	14	2	16	0	5	21	0	0
17	37163059	.	A	G	1	4	5	0	0	5	0	0
17	37216469	.	C	A	1	1	2	0	0	2	0	0
17	37216478	.	C	T	0	2	2	0	0	2	0	0
17	37362398	.	A	G	1	2	3	6	0	9	0	0
17	37363495	.	T	C	3	3	6	1	1	8	0	0
17	37363503	.	A	T	3	3	6	1	1	8	0	0
17	37363938	.	A	G	3	0	3	1	6	10	0	0
17	37445790	.	T	C	5	9	14	0	0	14	0	0
17	37445924	.	G	A	9	7	16	0	0	16	0	0
17	37445926	.	A	T	9	9	18	0	0	18	0	0
17	37446208	.	A	T	7	7	14	0	0	14	0	0
17	37446379	.	T	C	4	4	8	0	1	9	0	0
17	37446443	.	T	G	9	5	14	0	0	14	0	0
17	37446555	.	T	A	13	8	21	0	0	21	0	0
17	37446563	.	G	A	13	8	21	0	0	21	0	0
17	37446735	.	G	A	13	16	29	0	2	31	0	0
17	37446789	.	A	C	20	3	23	0	4	27	0	0
17	37449200	.	G	C	4	4	8	0	0	8	0	0
17	37449823	.	C	T	2	2	4	0	0	4	0	0
17	37450132	.	C	T	8	4	12	0	0	12	0	0
17	37450135	.	A	T	4	8	12	0	0	12	0	0
17	37450180	.	T	G	3	5	8	0	0	8	0	0
17	37570871	.	A	G	9	4	13	0	0	13	0	0
17	37585002	.	A	G	2	3	5	0	0	5	0	0
17	37590024	.	C	T	8	4	12	0	0	12	0	0
17	37593662	.	C	T	8	8	16	0	0	16	0	0
17	37603748	.	G	A	2	4	6	0	12	19	1	0
17	37605870	.	A	G	21	0	21	0	10	31	0	0
17	37606011	.	G	A	2	12	14	0	13	27	0	0
17	37606101	.	G	A	1	14	15	0	15	30	0	0
17	37606116	.	G	A	15	15	30	0	0	30	0	0
17	37618028	.	C	G	8	8	16	1	0	17	0	0
17	37618143	.	T	C	4	5	9	0	0	9	0	0
17	37618157	.	A	C	4	3	7	0	1	8	0	0
17	37618316	.	C	T	4	2	6	0	0	6	0	0
17	37618485	.	C	T	6	8	14	0	2	16	0	0
17	37624913	.	A	T	6	12	18	0	0	18	0	0
17	37792745	.	A	G	11	5	16	0	2	18	0	0
17	37793456	.	C	T	1	6	7	0	11	18	0	0
17	37793606	.	T	A	4	2	6	0	9	15	0	0
17	37793627	.	G	A	6	8	14	0	2	16	0	0
17	37794035	.	G	A	3	5	8	0	1	9	0	0
17	37795730	.	C	T	5	4	9	0	0	9	0	0
17	37795756	.	A	T	4	3	7	0	1	8	0	0
17	38021502	.	C	T	3	3	6	0	0	6	0	0
17	38021526	.	A	G	2	3	5	0	1	6	0	0
17	38021778	.	G	A	1	2	3	0	0	3	0	0
17	38022797	.	C	T	1	2	3	0	0	3	0	0
17	38232211	.	A	T	3	2	5	0	1	6	0	0
17	38232237	.	T	C	4	5	9	0	0	9	0	0
17	38263804	.	A	G	6	8	14	0	2	16	0	0
17	38264044	.	G	T	9	4	13	0	1	14	0	0
17	38295925	.	C	A	2	7	9	0	1	10	0	0
17	38295927	.	T	A	7	3	10	0	1	11	0	0
17	38295991	.	C	T	5	7	12	0	0	12	0	0
17	38296642	.	G	A	3	5	8	0	0	8	0	0
17	38296644	.	T	G	6	3	9	0	0	9	0	0
17	38303423	.	C	T	8	8	16	0	1	17	0	0
17	38303607	.	A	G	5	5	10	0	2	12	0	0
17	38303652	.	G	A	1	6	7	0	6	13	0	0
17	38394013	.	G	T	3	2	5	1	0	6	0	0
17	38394057	.	A	T	1	1	2	1	1	4	0	0
17	38394860	.	T	C	1	4	5	0	0	5	0	0
17	38395070	.	C	T	0	2	2	0	1	3	0	0
17	38395266	.	A	G	2	2	4	0	2	6	0	0
17	38395290	.	C	T	1	4	5	0	0	5	0	0
17	38397845	.	C	T	2	2	4	0	0	4	0	0
17	38408826	.	G	A	3	4	7	0	0	7	0	0
17	38408838	.	C	T	1	3	4	0	3	7	0	0
17	38471298	.	G	C	2	2	4	0	1	5	0	0
17	38471456	.	G	T	0	4	4	0	2	6	0	0
17	38471564	.	C	T	2	3	5	0	0	5	0	0
17	38548174	.	T	C	4	2	6	0	0	6	0	0
17	38548468	.	C	A	1	4	5	0	0	5	0	0
17	38678498	.	T	C	3	2	5	0	0	5	0	0
17	38712775	.	T	G	4	5	9	0	1	10	0	0
17	38712855	.	C	T	2	4	6	0	0	6	0	0
17	38713174	.	G	T	0	3	3	0	3	6	0	0
17	38713334	.	G	T	3	4	7	0	0	7	0	0
17	38713709	.	C	T	2	6	8	0	0	8	0	0
17	38714125	.	A	T	4	2	6	0	1	7	0	0
17	38714133	.	G	T	3	3	6	0	0	6	0	0
17	38714216	.	A	C	3	4	7	0	0	7	0	0
17	38740684	.	T	C	4	6	10	0	0	10	0	0
17	38740698	.	A	T	3	9	12	0	0	12	0	0
17	38749800	.	G	A	13	6	19	0	0	19	0	0
17	38749807	.	G	A	9	11	20	0	0	20	0	0
17	38751711	.	T	A	9	7	16	0	3	19	0	0
17	38754825	.	C	A	9	12	21	1	0	22	0	0
17	38755038	.	A	G	7	14	21	0	0	21	0	0
17	38756777	.	T	G	13	8	21	0	3	24	0	0
17	38758682	.	G	A	7	12	19	0	0	19	0	0
17	38760619	.	G	A	3	8	11	0	0	11	0	0
17	38760931	.	T	C	16	4	20	0	1	21	0	0
17	38761035	.	A	G	7	5	12	0	0	12	0	0
17	38761069	.	T	C	4	2	6	0	3	9	0	0
17	38768370	.	G	T	8	5	13	0	0	13	0	0
17	38768483	.	G	A	6	10	16	1	0	17	0	0
17	38769924	.	T	A	13	4	17	0	0	17	0	0
17	38769935	.	T	C	10	4	14	0	0	14	0	0
17	38769975	.	G	A	13	6	19	0	0	19	0	0
17	38784385	.	G	A	10	7	17	0	0	17	0	0
17	38784477	.	T	C	20	7	27	0	3	30	0	0
17	38784545	.	G	T	10	6	16	0	0	16	0	0
17	38784642	.	T	C	11	14	25	0	1	26	0	0
17	38787327	.	G	A	5	6	11	0	1	12	0	0
17	38787498	.	G	A	5	6	11	0	0	11	0	0
17	38787540	.	A	T	5	3	8	0	0	8	0	0
17	38804808	.	C	T	3	7	10	0	1	11	0	0
17	38804853	.	A	T	4	7	11	0	0	11	0	0
17	38804868	.	T	C	9	0	9	0	3	12	0	0
17	38887156	.	C	T	0	5	5	0	3	8	0	0
17	38887271	.	T	G	4	4	8	0	1	9	0	0
17	38927932	.	T	C	6	3	9	0	0	9	0	0
17	38928073	.	A	T	4	4	8	0	1	9	0	0
17	38928447	.	T	C	3	1	4	0	4	8	0	0
17	38928947	.	A	T	3	2	5	0	0	5	0	0
17	38929142	.	T	G	5	8	13	0	0	13	0	0
17	38929437	.	C	T	8	4	12	0	1	13	0	0
17	38938727	.	G	A	4	4	8	0	0	8	0	0
17	38941109	.	C	T	0	8	8	0	5	13	0	0
17	38941286	.	G	A	7	4	11	0	0	11	0	0
17	38946619	.	G	A	3	4	7	0	0	7	0	0
17	39184067	.	G	A	4	4	8	0	0	8	0	0
17	39184073	.	G	A	4	4	8	0	0	8	0	0
17	39184321	.	G	C	2	2	4	0	0	4	0	0
17	39184823	.	T	C	4	3	7	0	0	7	0	0
17	39697690	.	T	C	6	4	10	0	0	10	0	0
17	39707421	.	C	T	6	8	14	0	0	14	0	0
17	39717616	.	T	C	11	6	17	0	1	18	0	0
17	39717645	.	A	G	8	0	8	0	8	16	0	0
17	39720791	.	T	C	3	6	9	0	0	9	0	0
17	39728239	.	C	T	14	9	23	0	1	24	0	0
17	39728261	.	G	T	14	11	25	0	0	25	0	0
17	39728423	.	T	A	16	14	30	0	0	30	0	0
17	39729014	.	G	A	12	9	21	0	0	21	0	0
17	39732512	.	C	T	11	13	24	0	0	24	0	0
17	39732573	.	C	A	8	8	16	0	0	16	0	0
17	39732584	.	G	A	9	7	16	0	0	16	0	0
17	39736088	.	T	A	16	11	27	0	0	27	0	0
17	39736103	.	G	A	14	6	20	0	3	23	0	0
17	39739842	.	A	T	5	7	12	0	0	12	0	0
17	39862334	.	A	G	6	7	13	0	0	13	0	0
17	39862536	.	C	G	5	4	9	0	1	10	0	0
17	39863633	.	C	T	5	7	12	0	1	13	0	0
17	40397668	.	G	C	1	2	3	0	1	4	0	0
17	40879510	.	A	G	5	3	8	0	0	8	0	0
17	40880042	.	G	A	5	4	9	0	0	9	0	0
17	40883596	.	C	T	4	4	8	0	0	8	0	0
17	40884249	.	C	A	1	3	4	0	0	4	0	0
17	40887272	.	T	C	6	6	12	0	0	12	0	0
17	40887285	.	G	T	10	8	18	0	0	18	0	0
17	40889011	.	A	G	4	4	8	0	0	8	0	0
17	40889017	.	C	T	4	4	8	0	0	8	0	0
17	40889613	.	C	A	7	3	10	0	0	10	0	0
17	40889697	.	A	G	6	6	12	0	0	12	0	0
17	40890396	.	C	T	6	6	12	0	0	12	0	0
17	40890433	.	G	A	4	6	10	0	0	10	0	0
17	40890443	.	C	T	3	5	8	0	0	8	0	0
17	40893919	.	A	T	4	4	8	0	0	8	0	0
17	40899873	.	T	G	2	4	6	0	0	6	0	0
17	40899880	.	C	T	2	5	7	0	0	7	0	0
17	40900354	.	C	T	2	5	7	0	1	8	0	0
17	40900414	.	T	C	4	5	9	0	0	9	0	0
17	40900415	.	G	A	4	5	9	0	0	9	0	0
17	40900686	.	T	G	6	12	18	0	0	18	0	0
17	40900953	.	A	G	0	1	1	0	2	3	0	0
17	40901389	.	A	G	4	3	7	0	0	7	0	0
17	40901439	.	T	C	1	5	6	0	0	6	0	0
17	40901695	.	G	C	7	10	17	0	1	19	1	0
17	40901712	.	C	G	8	9	17	0	0	17	0	0
17	40901752	.	G	A	6	8	14	0	0	14	0	0
17	40901799	.	A	C	7	5	12	0	0	12	0	0
17	40901804	.	A	T	5	5	10	0	1	11	0	0
17	40902005	.	C	A	2	8	10	0	3	13	0	0
17	40902065	.	G	A	6	6	12	0	0	12	0	0
17	40902148	.	G	T	6	6	12	0	0	12	0	0
17	40902180	.	G	C	7	4	11	0	0	11	0	0
17	40902256	.	G	T	5	7	12	0	0	12	0	0
17	40902347	.	C	T	7	8	15	0	1	16	0	0
17	40902368	.	T	G	7	5	12	0	0	12	0	0
17	40902598	.	G	A	8	6	14	0	1	15	0	0
17	40902629	.	A	T	10	4	14	0	0	14	0	0
17	40902657	.	A	C	9	7	16	0	0	16	0	0
17	40902830	.	A	T	6	8	14	0	0	14	0	0
17	40903162	.	C	T	9	9	18	0	2	20	0	0
17	40932270	.	G	A	1	3	4	0	1	5	0	0
17	40990061	.	T	A	14	21	35	0	0	35	0	0
17	40990097	.	T	A	19	14	33	0	2	35	0	0
17	40999460	.	A	G	12	6	18	0	1	19	0	0
17	40999697	.	C	G	5	6	11	0	0	11	0	0
17	40999700	.	C	A	6	6	12	0	0	12	0	0
17	40999732	.	A	G	8	6	14	0	0	14	0	0
17	41084623	.	C	T	9	5	14	0	2	16	0	0
17	41084670	.	T	C	5	10	15	0	1	16	0	0
17	41092465	.	C	T	11	7	18	0	0	18	0	0
17	41121783	.	C	G	4	7	11	0	1	12	0	0
17	41220064	.	T	A	9	4	13	0	0	13	0	0
17	41254741	.	C	T	11	10	21	0	0	21	0	0
17	41314040	.	G	T	2	13	15	0	16	31	0	0
17	41314097	.	T	C	17	9	26	0	5	31	0	0
17	41314471	.	G	A	15	10	25	0	2	27	0	0
17	41314501	.	A	G	6	8	14	0	0	14	0	0
17	41317234	.	A	G	10	0	10	0	19	29	0	0
17	41317494	.	G	A	9	13	22	0	1	23	0	0
17	41317999	.	G	A	13	9	22	0	1	23	0	0
17	41318310	.	A	G	13	16	29	0	2	31	0	0
17	41318392	.	G	A	3	6	9	0	1	10	0	0
17	41368018	.	C	T	5	3	8	0	0	8	0	0
17	41464090	.	G	A	5	6	11	0	6	17	0	0
17	41465504	.	A	C	7	7	14	0	0	14	0	0
17	41465922	.	G	A	2	2	4	0	0	4	0	0
17	41475863	.	T	C	9	16	25	0	2	27	0	0
17	41476104	.	T	C	19	0	19	1	17	37	0	0
17	41476161	.	A	G	23	14	37	2	2	41	0	0
17	41476279	.	G	A	13	19	32	0	1	33	0	0
17	41476298	.	T	A	10	19	29	0	0	29	0	0
17	41476393	.	G	T	15	10	25	0	1	26	0	0
17	41476833	.	T	C	6	6	12	0	0	12	0	0
17	41476906	.	A	C	6	0	6	0	3	9	0	0
17	41476994	.	G	A	13	4	17	0	1	18	0	0
17	41477007	.	C	T	0	3	3	0	14	17	0	0
17	41477157	.	T	C	9	7	16	0	2	18	0	0
17	41477324	.	G	A	15	10	25	0	0	25	0	0
17	41558269	.	G	C	6	5	11	0	0	11	0	0
17	41571328	.	T	A	9	5	14	0	0	14	0	0
17	41583555	.	C	G	0	5	5	0	7	13	1	0
17	41583747	.	G	T	12	14	26	0	1	27	0	0
17	41583768	.	T	C	10	0	10	0	11	21	0	0
17	41583786	.	A	G	13	9	22	0	0	22	0	0
17	41592172	.	A	C	10	6	16	0	0	16	0	0
17	41601633	.	G	A	5	7	12	1	1	14	0	0
17	41601916	.	G	A	6	10	16	0	1	17	0	0
17	41602081	.	T	C	4	5	9	0	0	9	0	0
17	41610991	.	G	A	3	4	7	0	0	7	0	0
17	41635632	.	T	C	3	0	3	0	3	6	0	0
17	41635635	.	T	C	4	0	4	0	3	7	0	0
17	41639674	.	A	G	4	3	7	0	0	7	0	0
17	41639675	.	G	A	4	3	7	0	0	7	0	0
17	41659641	.	C	T	0	3	3	0	1	4	0	0
17	41666581	.	G	A	6	2	8	0	0	8	0	0
17	41667069	.	G	A	3	5	8	0	0	8	0	0
17	41667109	.	C	T	0	9	9	0	4	13	0	0
17	41669288	.	G	A	2	2	4	0	0	4	0	0
17	41673488	.	C	T	6	2	8	0	0	8	0	0
17	41673513	.	G	A	7	3	10	0	0	10	0	0
17	41675511	.	T	C	3	6	9	0	0	9	0	0
17	41685644	.	G	A	5	4	9	0	0	9	0	0
17	41798753	.	C	T	2	3	5	0	2	7	0	0
17	41992262	.	T	G	3	0	3	1	7	11	0	0
17	41994768	.	G	T	2	3	5	0	0	5	0	0
17	41994868	.	A	G	2	1	3	0	4	7	0	0
17	42003872	.	C	T	6	5	11	0	0	11	0	0
17	42027915	.	C	T	6	9	15	0	2	17	0	0
17	42030083	.	A	G	15	0	15	0	9	24	0	0
17	42032119	.	T	C	5	8	13	0	1	14	0	0
17	42095602	.	A	G	2	2	4	0	0	4	0	0
17	42095620	.	C	T	1	3	4	0	1	5	0	0
17	42096960	.	C	G	1	4	5	0	4	9	0	0
17	42871419	.	G	T	20	8	28	0	1	29	0	0
17	43006105	.	A	G	1	2	3	0	0	3	0	0
17	43013675	.	G	A	26	34	60	0	2	62	0	0
17	43017672	.	C	T	15	14	29	0	2	31	0	0
17	43017687	.	G	A	14	14	28	0	1	29	0	0
17	43017830	.	A	G	13	16	29	0	1	30	0	0
17	43017863	.	A	C	19	12	31	0	1	32	0	0
17	43018037	.	G	A	3	16	19	0	20	39	0	0
17	43018124	.	A	G	21	1	22	0	10	32	0	0
17	43018273	.	G	A	13	26	39	0	4	43	0	0
17	43018382	.	T	G	18	13	31	0	1	32	0	0
17	43018502	.	T	A	17	26	43	0	0	43	0	0
17	43018549	.	C	G	19	16	35	0	2	37	0	0
17	43018638	.	A	T	21	13	34	0	0	34	0	0
17	43018815	.	A	G	19	15	34	0	3	37	0	0
17	43018899	.	T	A	12	23	35	0	0	35	0	0
17	43030696	.	T	C	6	11	17	0	2	19	0	0
17	43030737	.	T	G	14	15	29	0	0	29	0	0
17	43030828	.	G	A	13	12	25	0	0	25	0	0
17	43031495	.	G	A	11	9	20	0	1	21	0	0
17	43033177	.	G	A	16	12	28	0	2	30	0	0
17	43035798	.	T	C	17	15	32	0	3	35	0	0
17	43035996	.	G	T	9	16	25	0	0	25	0	0
17	43036025	.	A	G	12	8	20	0	0	20	0	0
17	43036055	.	T	C	6	10	16	0	0	16	0	0
17	43040422	.	T	A	4	4	8	0	0	8	0	0
17	43082871	.	G	A	2	2	4	0	0	4	0	0
17	43082976	.	A	T	5	10	15	0	1	16	0	0
17	43087252	.	A	T	2	4	6	0	0	6	0	0
17	43104590	.	T	A	1	5	6	0	0	6	0	0
17	43146508	.	C	T	1	2	3	0	1	4	0	0
17	43174889	.	G	A	2	4	6	0	1	7	0	0
17	43220001	.	A	G	3	3	6	0	0	6	0	0
17	43220058	.	G	A	5	3	8	0	0	8	0	0
17	43286920	.	C	T	5	2	7	0	0	7	0	0
17	43297465	.	T	C	1	6	7	0	0	7	0	0
17	43297561	.	T	G	3	7	10	0	0	10	0	0
17	43297946	.	G	C	20	12	32	0	1	33	0	0
17	43298011	.	G	A	22	15	37	0	0	37	0	0
17	43298068	.	G	A	16	15	31	0	0	31	0	0
17	43302492	.	G	A	11	12	23	0	0	23	0	0
17	43309095	.	A	G	13	8	21	0	1	22	0	0
17	43309164	.	C	T	2	16	18	0	10	28	0	0
17	43315085	.	C	T	14	4	18	0	0	18	0	0
17	43348986	.	T	C	8	8	16	0	0	16	0	0
17	43391434	.	G	T	9	7	16	0	0	16	0	0
17	43391442	.	C	T	10	8	18	0	0	18	0	0
17	43436782	.	T	C	19	0	19	0	22	41	0	0
17	43437305	.	G	C	24	20	44	1	2	47	0	0
17	43437365	.	C	G	24	19	43	0	2	45	0	0
17	43439720	.	G	T	19	21	40	0	5	45	0	0
17	43441575	.	A	T	21	13	34	0	3	37	0	0
17	43453507	.	T	C	8	14	22	0	0	22	0	0
17	43453531	.	G	A	8	14	22	0	0	22	0	0
17	43456825	.	C	T	9	15	24	0	1	25	0	0
17	43456900	.	G	A	7	11	18	0	0	18	0	0
17	43456921	.	T	C	10	9	19	0	0	19	0	0
17	43461181	.	G	A	9	10	19	0	1	20	0	0
17	43469204	.	A	C	8	12	20	0	0	20	0	0
17	43469377	.	G	A	10	8	18	0	0	18	0	0
17	43473913	.	T	C	10	10	20	0	0	20	0	0
17	43475577	.	G	A	1	13	14	0	12	26	0	0
17	43475619	.	A	G	11	1	12	0	11	23	0	0
17	43475691	.	T	A	4	7	11	0	0	11	0	0
17	43475712	.	A	G	3	0	3	0	4	7	0	0
17	43476046	.	C	T	4	2	6	0	0	6	0	0
17	43476137	.	T	A	12	5	17	0	0	17	0	0
17	43476241	.	A	G	2	3	5	0	0	5	0	0
17	43497404	.	A	T	3	13	16	0	1	17	0	0
17	43513109	.	G	A	7	8	15	0	0	15	0	0
17	43516464	.	T	A	12	3	15	0	0	15	0	0
17	43516502	.	G	T	8	5	13	0	0	13	0	0
17	43516506	.	A	C	9	5	14	0	1	15	0	0
17	43516548	.	A	G	9	12	21	0	0	21	0	0
17	43516579	.	T	C	7	0	7	0	9	16	0	0
17	43519741	.	C	T	5	2	7	0	0	7	0	0
17	43520136	.	G	A	3	7	10	0	0	10	0	0
17	43520158	.	A	G	8	5	13	0	0	13	0	0
17	43520191	.	G	A	5	7	12	0	1	13	0	0
17	43529446	.	G	A	1	2	3	0	0	3	0	0
17	43537865	.	C	T	6	6	12	0	1	13	0	0
17	43538018	.	A	C	8	5	13	0	0	13	0	0
17	43538035	.	C	T	0	5	5	0	9	14	0	0
17	43538131	.	G	A	2	6	8	0	0	8	0	0
17	43538209	.	C	T	5	4	9	0	3	12	0	0
17	43547945	.	A	G	5	7	12	0	0	12	0	0
17	43551547	.	G	T	7	5	12	0	0	12	0	0
17	43551835	.	A	G	5	4	9	0	0	9	0	0
17	43551841	.	G	C	4	4	8	0	0	8	0	0
17	43558275	.	T	A	7	12	19	0	0	19	0	0
17	43565680	.	A	T	6	11	17	0	1	18	0	0
17	43565697	.	C	A	7	9	16	0	0	16	0	0
17	43575521	.	A	T	3	4	7	0	1	8	0	0
17	43575545	.	C	A	3	5	8	0	1	9	0	0
17	43575585	.	C	A	5	4	9	0	1	10	0	0
17	43575782	.	C	T	2	7	9	0	0	9	0	0
17	43575924	.	G	C	5	3	8	0	0	8	0	0
17	43576550	.	A	G	6	5	11	0	1	12	0	0
17	43576551	.	G	A	6	4	10	0	2	12	0	0
17	43576657	.	G	A	1	3	4	0	1	5	0	0
17	43581769	.	G	A	1	4	5	0	0	5	0	0
17	43584364	.	A	G	5	4	9	0	0	9	0	0
17	43584403	.	T	C	6	3	9	0	1	10	0	0
17	43594789	.	A	T	6	5	11	0	0	11	0	0
17	43594806	.	T	C	3	4	7	0	0	7	0	0
17	43612005	.	G	T	1	3	4	0	0	4	0	0
17	43612007	.	T	A	1	3	4	0	0	4	0	0
17	43612302	.	G	A	2	3	5	0	0	5	0	0
17	43615454	.	G	A	3	2	5	0	0	5	0	0
17	43615478	.	A	G	3	3	6	0	0	6	0	0
17	43615504	.	T	G	2	3	5	0	0	5	0	0
17	43623744	.	T	G	1	4	5	0	0	5	0	0
17	43629223	.	C	T	7	3	10	0	1	11	0	0
17	43629295	.	C	T	2	3	5	0	0	5	0	0
17	43629319	.	C	A	4	3	7	0	1	8	0	0
17	43629342	.	T	C	4	5	9	0	0	9	0	0
17	43629388	.	G	T	3	1	4	0	1	5	0	0
17	43629550	.	T	A	5	5	10	0	0	10	0	0
17	43629622	.	C	T	1	3	4	0	0	4	0	0
17	43629673	.	G	A	3	1	4	0	1	5	0	0
17	43629682	.	G	A	2	4	6	0	0	6	0	0
17	43660232	.	G	A	9	9	18	0	2	20	0	0
17	43660779	.	T	C	9	9	18	0	0	18	0	0
17	43661106	.	T	G	6	5	11	0	0	11	0	0
17	43661291	.	G	T	15	4	19	0	4	23	0	0
17	43661293	.	A	T	14	4	18	0	5	23	0	0
17	43663611	.	T	G	9	8	17	0	0	17	0	0
17	43663789	.	A	C	13	16	29	0	0	29	0	0
17	43663870	.	G	A	11	24	35	0	2	37	0	0
17	43664128	.	G	C	12	20	32	0	0	32	0	0
17	43664580	.	A	G	19	9	28	0	0	28	0	0
17	43664605	.	G	A	12	8	20	0	1	21	0	0
17	43708546	.	C	T	10	9	19	0	0	19	0	0
17	43708563	.	A	G	6	10	16	0	0	16	0	0
17	43708649	.	T	C	6	12	18	0	0	18	0	0
17	43711557	.	C	T	0	3	3	0	5	8	0	0
17	43715607	.	C	T	2	5	7	0	0	7	0	0
17	43715851	.	T	C	6	9	15	0	0	15	0	0
17	43716633	.	C	T	1	3	4	0	0	4	0	0
17	43716648	.	T	A	1	5	6	0	0	6	0	0
17	43717878	.	G	T	5	2	7	0	0	7	0	0
17	43851013	.	A	G	14	12	26	0	1	27	0	0
17	43853538	.	G	A	12	15	27	0	0	27	0	0
17	43853767	.	A	G	14	9	23	0	2	25	0	0
17	43853778	.	C	T	3	15	18	0	11	29	0	0
17	43854007	.	G	A	6	14	20	0	1	21	0	0
17	43854010	.	T	G	17	5	22	0	1	23	0	0
17	43856232	.	T	C	10	10	20	0	2	22	0	0
17	43859282	.	T	C	8	6	14	1	1	16	0	0
17	43863609	.	A	C	12	15	27	0	0	27	0	0
17	43863655	.	G	C	3	7	10	0	0	10	0	0
17	43863656	.	C	T	4	6	10	0	0	10	0	0
17	43879340	.	C	T	1	1	2	0	0	2	0	0
17	43879346	.	A	G	1	2	3	0	0	3	0	0
17	43946901	.	C	T	9	10	19	0	0	19	0	0
17	43951868	.	G	T	8	8	16	0	0	16	0	0
17	43952984	.	C	T	6	6	12	0	0	12	0	0
17	43953000	.	G	A	1	7	8	0	4	12	0	0
17	43954926	.	A	C	6	8	14	0	0	14	0	0
17	43987048	.	A	G	19	15	34	0	0	34	0	0
17	43996483	.	G	A	29	16	45	0	2	47	0	0
17	43996485	.	G	A	27	16	43	0	2	45	0	0
17	43996620	.	A	T	27	18	45	0	0	45	0	0
17	43996667	.	G	A	21	8	29	0	1	30	0	0
17	44001540	.	A	G	26	11	37	0	0	37	0	0
17	44001584	.	T	C	22	15	37	0	1	38	0	0
17	44002032	.	A	T	9	10	19	0	2	21	0	0
17	44006654	.	A	G	4	2	6	0	0	6	0	0
17	44006942	.	C	A	2	4	6	0	0	6	0	0
17	44007047	.	A	T	5	2	7	0	0	7	0	0
17	44007262	.	G	T	1	3	4	0	0	4	0	0
17	44007271	.	T	G	2	4	6	0	0	6	0	0
17	44007351	.	T	C	7	3	10	0	1	11	0	0
17	44030764	.	T	A	2	2	4	0	0	4	0	0
17	44030906	.	C	T	1	5	6	0	1	7	0	0
17	44030943	.	C	T	5	4	9	0	0	9	0	0
17	44046144	.	G	A	3	6	9	0	0	9	0	0
17	44767732	.	T	C	3	9	12	0	0	12	0	0
17	44767740	.	T	C	6	7	13	0	0	13	0	0
17	44848443	.	G	A	0	5	5	0	1	6	0	0
17	45138586	.	T	C	6	2	8	0	1	10	1	0
17	45138733	.	T	C	9	17	26	0	1	27	0	0
17	45138741	.	T	C	16	12	28	0	1	29	0	0
17	45138796	.	T	C	23	8	31	0	1	32	0	0
17	45139291	.	T	C	9	4	13	0	1	14	0	0
17	45139423	.	T	C	18	6	24	0	0	24	0	0
17	45139429	.	T	C	14	10	24	0	1	25	0	0
17	45402422	.	A	G	5	3	8	0	1	9	0	0
17	45402602	.	A	T	4	9	13	0	0	13	0	0
17	45402640	.	C	A	5	5	10	0	0	10	0	0
17	45402713	.	T	A	1	7	8	0	1	9	0	0
17	45402714	.	C	T	1	8	9	0	0	9	0	0
17	45402811	.	A	G	2	4	6	0	0	6	0	0
17	45402895	.	A	C	2	2	4	0	0	4	0	0
17	45455161	.	C	T	1	3	4	0	0	4	0	0
17	45455329	.	C	T	7	2	9	0	0	9	0	0
17	45455365	.	C	T	1	2	3	0	1	4	0	0
17	45458154	.	C	G	1	0	1	0	3	4	0	0
17	45458931	.	A	G	3	2	5	0	1	6	0	0
17	45482377	.	T	C	0	5	5	0	1	6	0	0
17	45482409	.	C	T	1	3	4	0	0	4	0	0
17	45482486	.	T	C	1	5	6	0	0	6	0	0
17	45482615	.	T	A	1	2	3	0	1	4	0	0
17	45731991	.	T	C	6	5	11	0	0	11	0	0
17	45732147	.	T	C	11	10	21	0	0	21	0	0
17	45732173	.	C	T	1	11	12	0	12	24	0	0
17	45732327	.	G	A	16	12	28	0	1	29	0	0
17	45733632	.	T	G	3	5	8	0	2	10	0	0
17	45733752	.	G	A	10	7	17	0	0	17	0	0
17	45738138	.	A	G	4	5	9	0	1	10	0	0
17	45744138	.	C	T	4	7	11	0	0	11	0	0
17	45744187	.	C	T	5	2	7	0	1	8	0	0
17	45748623	.	C	T	8	5	13	0	0	13	0	0
17	45750485	.	C	T	1	7	8	1	0	9	0	0
17	45751404	.	T	C	9	7	16	0	2	18	0	0
17	45756484	.	A	G	6	4	10	0	0	10	0	0
17	45756610	.	T	C	11	3	14	0	0	14	0	0
17	45756652	.	T	C	8	6	14	0	0	14	0	0
17	45762487	.	G	A	3	7	10	0	1	11	0	0
17	45765234	.	G	A	9	8	17	0	1	19	1	0
17	45766167	.	A	G	9	0	9	0	7	16	0	0
17	45774378	.	G	A	0	3	3	0	6	9	0	0
17	45774425	.	C	A	2	6	8	0	1	9	0	0
17	45979069	.	C	T	1	2	3	0	0	3	0	0
17	45980743	.	A	G	2	3	5	0	0	5	0	0
17	45981067	.	C	T	1	3	4	0	0	4	0	0
17	45983269	.	C	T	4	5	9	0	0	9	0	0
17	45983392	.	G	A	2	6	8	0	0	8	0	0
17	45983410	.	C	T	2	6	8	0	0	8	0	0
17	45983439	.	C	G	2	2	4	0	1	5	0	0
17	45983626	.	G	A	2	3	5	0	0	5	0	0
17	45984415	.	A	G	4	0	4	0	7	11	0	0
17	45984465	.	G	T	0	7	7	0	3	10	0	0
17	45987075	.	G	A	0	7	7	0	5	12	0	0
17	45987120	.	C	T	2	6	8	0	0	8	0	0
17	45987143	.	A	T	2	3	5	0	1	6	0	0
17	45987358	.	G	A	6	5	11	0	0	11	0	0
17	45987591	.	G	A	0	6	6	0	2	8	0	0
17	45988188	.	A	G	6	0	6	0	5	11	0	0
17	45988742	.	T	C	8	6	14	0	1	15	0	0
17	45988864	.	C	T	8	4	12	0	0	12	0	0
17	45988991	.	G	C	1	6	7	0	0	7	0	0
17	45989003	.	A	G	1	0	1	0	6	7	0	0
17	45989032	.	G	T	7	2	9	0	1	10	0	0
17	46387291	.	C	A	11	4	15	0	0	15	0	0
17	46387490	.	C	T	10	3	13	0	1	14	0	0
17	46387499	.	A	G	10	3	13	0	1	14	0	0
17	46439098	.	G	A	7	6	13	0	0	13	0	0
17	46439102	.	C	T	7	6	13	0	0	13	0	0
17	46457321	.	G	C	17	10	27	0	0	27	0	0
17	46457326	.	C	A	1	8	9	0	17	26	0	0
17	47134996	.	C	T	3	2	5	0	0	5	0	0
17	47135071	.	G	T	6	6	12	0	0	12	0	0
17	47140969	.	G	A	0	3	3	0	6	9	0	0
17	47164815	.	G	A	0	3	3	0	1	4	0	0
17	47169696	.	G	A	2	6	8	0	1	9	0	0
17	47175837	.	C	T	1	4	5	0	0	5	0	0
17	47175854	.	T	C	4	3	7	0	0	7	0	0
17	47176349	.	G	A	0	5	5	0	1	6	0	0
17	47188563	.	T	C	3	2	5	0	0	5	0	0
17	47189003	.	A	G	7	10	17	0	0	17	0	0
17	47189025	.	C	A	6	9	15	0	0	15	0	0
17	47189283	.	A	T	5	6	11	0	1	12	0	0
17	47189725	.	G	A	7	6	13	0	0	13	0	0
17	47189765	.	G	T	5	4	9	0	0	9	0	0
17	47189790	.	A	G	3	2	5	0	0	5	0	0
17	47189810	.	C	T	0	4	4	0	3	7	0	0
17	47189919	.	G	T	9	10	19	0	2	21	0	0
17	47190032	.	C	T	13	5	18	0	0	18	0	0
17	47190045	.	C	A	1	13	14	0	7	21	0	0
17	47190118	.	A	G	7	6	13	1	0	14	0	0
17	47190149	.	G	C	5	5	10	1	1	12	0	0
17	47190492	.	G	A	3	4	7	0	2	9	0	0
17	47190892	.	T	C	5	0	5	0	4	9	0	0
17	47190904	.	G	A	6	6	12	0	0	12	0	0
17	47190941	.	G	T	4	7	11	0	0	11	0	0
17	47190967	.	T	G	5	6	11	0	0	11	0	0
17	47191186	.	T	A	6	3	9	0	0	9	0	0
17	47191229	.	G	A	5	3	8	0	0	8	0	0
17	47191248	.	G	A	3	4	7	0	0	7	0	0
17	47191286	.	A	T	1	3	4	0	0	4	0	0
17	47191842	.	T	C	1	2	3	0	0	3	0	0
17	47192766	.	C	T	1	4	5	0	0	5	0	0
17	47192872	.	A	G	7	4	11	1	0	12	0	0
17	47193651	.	A	G	5	10	15	0	0	15	0	0
17	47193872	.	C	T	7	3	10	0	0	10	0	0
17	47193902	.	C	T	1	2	3	0	5	8	0	0
17	47193941	.	T	G	3	4	7	0	2	9	0	0
17	47220767	.	T	C	3	6	9	0	0	9	0	0
17	47220857	.	C	A	4	3	7	0	0	7	0	0
17	47220868	.	A	G	5	3	8	0	1	9	0	0
17	47232308	.	G	A	2	4	6	0	0	6	0	0
17	47232377	.	A	G	1	5	6	0	0	6	0	0
17	47238604	.	T	A	5	4	9	0	1	10	0	0
17	47238840	.	C	T	2	5	7	0	0	7	0	0
17	47289395	.	C	A	1	4	5	0	0	5	0	0
17	47304951	.	G	T	1	3	4	0	0	4	0	0
17	48127320	.	A	C	5	4	9	0	0	9	0	0
17	48138510	.	T	A	3	3	6	0	0	6	0	0
17	48139427	.	T	C	7	5	12	0	1	13	0	0
17	48862694	.	C	T	2	2	4	0	0	4	0	0
17	48867219	.	C	T	3	4	7	0	0	7	0	0
17	48867268	.	C	T	4	8	12	0	0	12	0	0
17	48872339	.	A	G	4	0	4	1	4	9	0	0
17	48892732	.	T	C	3	3	6	0	0	6	0	0
17	48908911	.	A	G	5	9	14	0	0	14	0	0
17	48911097	.	T	G	2	10	12	0	1	13	0	0
17	48915387	.	A	T	6	15	21	0	1	22	0	0
17	48928852	.	T	A	1	3	4	0	0	4	0	0
17	48970221	.	T	A	3	4	7	0	2	9	0	0
17	49003651	.	A	G	7	7	14	0	0	14	0	0
17	49006619	.	A	T	5	3	8	0	0	8	0	0
17	49010678	.	T	C	7	4	11	0	0	11	0	0
17	49010727	.	T	C	5	4	9	0	0	9	0	0
17	49011174	.	A	G	6	12	18	0	1	19	0	0
17	49011177	.	C	A	7	11	18	0	1	19	0	0
17	49011627	.	T	C	3	9	12	0	0	12	0	0
17	49016534	.	C	T	8	9	17	0	0	17	0	0
17	49016858	.	C	T	8	7	15	0	2	17	0	0
17	49018224	.	G	A	4	10	14	0	14	28	0	0
17	49018508	.	C	G	14	12	26	0	0	26	0	0
17	49018575	.	G	A	13	9	22	0	0	22	0	0
17	49019177	.	C	A	17	18	35	0	0	35	0	0
17	49132083	.	T	G	1	2	3	0	0	3	0	0
17	49132293	.	C	T	3	3	6	0	0	6	0	0
17	49137269	.	G	T	1	2	3	0	0	3	0	0
17	49137274	.	C	T	1	2	3	0	0	3	0	0
17	49137313	.	C	T	2	3	5	0	0	5	0	0
17	49275618	.	T	G	2	2	4	0	0	4	0	0
17	49278857	.	G	A	4	3	7	0	0	7	0	0
17	49306256	.	C	T	14	4	18	0	0	18	0	0
17	49306334	.	G	A	1	2	3	0	7	11	1	0
17	49306341	.	T	C	4	1	5	0	6	11	0	0
17	49363051	.	A	G	4	2	6	0	0	6	0	0
17	49416044	.	T	G	8	10	18	0	1	19	0	0
17	49416151	.	T	C	8	0	8	2	7	17	0	0
17	49416259	.	T	C	10	1	11	0	12	23	0	0
17	49416327	.	T	C	9	12	21	0	1	22	0	0
17	49416992	.	G	A	2	5	7	0	1	8	0	0
17	49417137	.	C	T	4	6	10	0	1	11	0	0
17	49417148	.	A	T	5	6	11	0	1	12	0	0
17	49417414	.	T	A	7	5	12	0	5	17	0	0
17	49417569	.	T	C	9	9	18	0	0	18	0	0
17	49417599	.	G	C	10	8	18	0	2	20	0	0
17	49417835	.	G	A	11	12	23	0	0	23	0	0
17	49417838	.	A	G	13	11	24	0	0	24	0	0
17	49417961	.	A	C	6	9	15	0	0	15	0	0
17	49417974	.	C	A	6	10	16	0	0	16	0	0
17	49418940	.	T	A	3	4	7	0	0	7	0	0
17	49419311	.	C	T	2	7	9	0	1	10	0	0
17	49419323	.	G	A	2	5	7	0	1	8	0	0
17	49419410	.	T	C	1	4	5	0	0	5	0	0
17	49419491	.	A	G	2	2	4	0	0	4	0	0
17	49419545	.	A	G	3	3	6	0	0	6	0	0
17	49419761	.	G	T	9	6	15	0	0	15	0	0
17	49419887	.	C	T	2	7	9	0	5	14	0	0
17	49419954	.	C	T	6	3	9	0	3	12	0	0
17	49420049	.	T	G	7	4	11	0	0	11	0	0
17	49420243	.	A	G	5	2	7	0	1	8	0	0
17	49420454	.	A	T	4	5	9	0	1	10	0	0
17	49420655	.	A	C	3	2	5	0	0	5	0	0
17	49420677	.	G	A	2	4	6	0	0	6	0	0
17	49420727	.	C	A	3	8	11	0	3	14	0	0
17	49421056	.	A	T	1	3	4	0	0	4	0	0
17	49421083	.	T	C	2	3	5	0	0	5	0	0
17	49421117	.	A	G	2	2	4	0	0	4	0	0
17	49421141	.	A	G	1	4	5	0	0	5	0	0
17	49421751	.	C	A	2	2	4	0	0	4	0	0
17	49425030	.	G	A	1	4	5	0	0	5	0	0
17	49429844	.	T	C	4	3	7	0	0	7	0	0
17	49429877	.	C	T	4	4	8	0	0	8	0	0
17	49434723	.	T	C	1	6	7	0	1	8	0	0
17	49438631	.	G	A	4	9	13	0	0	13	0	0
17	49983202	.	A	T	12	9	21	0	0	21	0	0
17	49983273	.	C	T	20	21	41	0	2	43	0	0
17	49983315	.	C	T	25	20	45	0	0	45	0	0
17	49992629	.	G	A	27	35	62	0	2	64	0	0
17	49998171	.	T	C	21	13	34	0	0	34	0	0
17	49998221	.	G	A	16	14	30	0	1	31	0	0
17	49998658	.	G	A	10	7	17	0	0	17	0	0
17	49998734	.	G	A	19	20	39	0	0	39	0	0
17	49998804	.	C	A	24	26	50	0	1	51	0	0
17	49999037	.	G	T	20	23	43	0	1	44	0	0
17	50002381	.	A	G	27	28	55	0	2	57	0	0
17	50007340	.	G	A	22	10	32	0	0	32	0	0
17	50009829	.	T	C	24	0	24	1	10	35	0	0
17	50009832	.	T	A	22	10	32	1	4	37	0	0
17	50010078	.	T	C	25	17	42	0	3	45	0	0
17	50010087	.	C	A	4	14	18	0	24	42	0	0
17	50083535	.	A	T	1	2	3	0	0	3	0	0
17	50083565	.	A	G	3	2	5	0	0	5	0	0
17	50097181	.	C	T	2	5	7	0	0	7	0	0
17	50097195	.	C	T	2	4	6	0	1	7	0	0
17	50099985	.	A	C	1	3	4	0	2	6	0	0
17	50101438	.	C	A	6	11	17	0	0	17	0	0
17	50107391	.	G	A	6	3	9	0	0	9	0	0
17	50107394	.	C	A	4	6	10	0	0	10	0	0
17	50110215	.	C	T	2	14	16	0	2	18	0	0
17	50110391	.	G	T	7	6	13	0	0	13	0	0
17	50110461	.	G	A	5	7	12	0	0	12	0	0
17	50110479	.	C	G	3	8	11	0	0	11	0	0
17	50110613	.	C	T	6	2	8	0	0	8	0	0
17	50110702	.	A	G	2	5	7	0	0	7	0	0
17	50110787	.	G	A	2	2	4	1	0	5	0	0
17	50110893	.	G	A	4	2	6	0	0	6	0	0
17	50110966	.	T	C	3	2	5	0	0	5	0	0
17	50111287	.	A	C	1	3	4	3	0	7	0	0
17	50111397	.	A	G	4	6	10	0	1	11	0	0
17	50111680	.	A	T	4	4	8	1	0	9	0	0
17	50112054	.	T	A	4	4	8	0	0	8	0	0
17	50112153	.	T	C	5	3	8	0	0	8	0	0
17	50113141	.	G	A	9	6	15	0	0	15	0	0
17	50113148	.	C	T	6	10	16	0	0	16	0	0
17	50113196	.	G	A	0	11	11	0	4	15	0	0
17	50113404	.	C	T	3	4	7	0	0	7	0	0
17	50141759	.	A	T	7	8	15	0	1	16	0	0
17	50141766	.	T	A	7	7	14	0	0	14	0	0
17	50141806	.	A	G	8	1	9	0	6	15	0	0
17	50141904	.	A	T	12	9	21	0	2	23	0	0
17	50172581	.	T	G	18	9	27	0	1	28	0	0
17	50176483	.	G	A	11	10	21	0	0	21	0	0
17	50176519	.	C	A	9	17	26	0	0	26	0	0
17	50180672	.	C	T	13	11	24	0	1	25	0	0
17	50185665	.	T	A	11	11	22	0	2	24	0	0
17	50185841	.	A	T	13	7	20	0	0	20	0	0
17	50185930	.	T	C	13	11	24	0	0	24	0	0
17	50185964	.	G	A	2	8	10	0	15	25	0	0
17	50186011	.	G	A	2	15	17	0	6	23	0	0
17	50186097	.	G	A	7	4	11	0	2	13	0	0
17	50186148	.	C	T	7	5	12	0	0	12	0	0
17	50186238	.	A	G	1	12	13	0	1	14	0	0
17	50186241	.	T	A	6	5	11	0	4	15	0	0
17	50195613	.	G	T	2	2	4	0	0	4	0	0
17	50229135	.	A	C	14	12	26	0	3	29	0	0
17	50229301	.	G	T	18	14	32	0	1	33	0	0
17	50229718	.	A	G	9	27	36	0	0	36	0	0
17	50245400	.	G	A	4	5	9	0	0	9	0	0
17	50245580	.	G	A	10	16	26	0	1	27	0	0
17	50245673	.	T	C	22	12	34	0	2	36	0	0
17	50245715	.	C	G	19	23	42	0	0	42	0	0
17	50245772	.	C	T	11	26	37	0	0	37	0	0
17	50247886	.	T	C	14	0	14	0	23	37	0	0
17	50272729	.	G	A	5	5	10	0	2	12	0	0
17	50275229	.	C	A	7	11	18	0	1	19	0	0
17	50278271	.	G	A	7	9	16	0	2	18	0	0
17	50278808	.	C	T	11	7	18	0	1	19	0	0
17	50278884	.	C	A	10	6	16	0	1	17	0	0
17	50284899	.	T	A	16	11	27	0	1	28	0	0
17	50285009	.	A	T	5	11	16	1	3	20	0	0
17	50285052	.	C	T	7	5	12	0	1	13	0	0
17	50285221	.	A	T	6	4	10	0	0	10	0	0
17	50285401	.	A	C	14	0	14	0	0	14	0	0
17	50391769	.	C	G	1	2	3	0	0	3	0	0
17	50405682	.	C	T	1	2	3	0	0	3	0	0
17	50415805	.	C	A	3	5	8	0	0	8	0	0
17	50415806	.	G	A	5	3	8	0	0	8	0	0
17	50415844	.	C	T	5	3	8	0	1	9	0	0
17	50415858	.	A	G	5	2	7	0	2	9	0	0
17	50415921	.	G	A	6	2	8	0	2	10	0	0
17	50416079	.	T	C	2	2	4	0	0	4	0	0
17	50416238	.	C	T	0	2	2	0	1	3	0	0
17	50416269	.	C	T	0	3	3	0	1	4	0	0
17	50416392	.	T	C	4	2	6	0	0	6	0	0
17	50416456	.	C	T	5	5	10	0	1	11	0	0
17	50416686	.	G	A	1	6	7	1	1	9	0	0
17	50416712	.	T	G	0	8	8	1	0	9	0	0
17	50416789	.	G	A	2	6	8	0	0	8	0	0
17	50416814	.	G	A	5	4	9	0	1	10	0	0
17	50417324	.	G	A	2	4	6	1	0	7	0	0
17	50417534	.	C	T	3	2	5	0	0	5	0	0
17	50417537	.	C	T	3	3	6	0	0	6	0	0
17	50424455	.	T	C	1	0	1	0	3	4	0	0
17	50424555	.	A	T	4	5	9	1	0	10	0	0
17	50424556	.	A	T	4	5	9	1	0	10	0	0
17	50424596	.	A	T	2	5	7	1	0	8	0	0
17	50424662	.	A	G	1	5	6	2	0	8	0	0
17	50424663	.	A	G	1	5	6	2	0	8	0	0
17	50424697	.	A	G	3	7	10	2	3	15	0	0
17	50425042	.	C	G	1	6	7	0	0	7	0	0
17	50425171	.	A	T	2	5	7	0	0	7	0	0
17	50425321	.	C	T	1	8	9	0	0	9	0	0
17	50425478	.	C	T	0	2	2	0	2	4	0	0
17	50425488	.	A	G	1	3	4	0	0	4	0	0
17	50425854	.	C	T	1	7	8	0	4	12	0	0
17	50425858	.	T	A	5	7	12	0	1	13	0	0
17	50426275	.	A	G	5	3	8	0	0	8	0	0
17	50426303	.	A	G	3	3	6	1	0	7	0	0
17	50434423	.	G	A	3	2	5	0	0	5	0	0
17	50450315	.	C	G	2	4	6	0	0	6	0	0
17	50450336	.	C	G	0	3	3	0	0	3	0	0
17	50450603	.	G	T	2	2	4	1	0	5	0	0
17	50453678	.	G	A	1	4	5	1	0	6	0	0
17	50461077	.	T	G	2	2	4	0	0	4	0	0
17	50461443	.	G	A	1	3	4	0	1	5	0	0
17	50564106	.	G	C	2	2	4	0	0	4	0	0
17	50585905	.	A	T	3	2	5	0	0	5	0	0
17	50656237	.	A	C	3	3	6	0	1	7	0	0
17	50656925	.	G	A	1	3	4	0	0	4	0	0
17	50657255	.	A	G	1	2	3	0	0	3	0	0
17	50657663	.	G	A	1	2	3	0	0	3	0	0
17	50657829	.	T	C	5	3	8	0	0	8	0	0
17	50664473	.	A	C	1	3	4	0	1	5	0	0
17	50679790	.	C	T	4	6	10	0	0	10	0	0
17	50679791	.	T	A	4	6	10	0	0	10	0	0
17	50682945	.	C	T	4	4	8	0	1	9	0	0
17	50688480	.	T	C	6	7	13	0	1	14	0	0
17	50688775	.	A	G	2	0	2	0	3	5	0	0
17	50689755	.	G	A	1	3	4	0	6	10	0	0
17	50689787	.	T	A	3	7	10	0	0	10	0	0
17	50689811	.	A	C	5	5	10	0	1	11	0	0
17	50689842	.	A	G	5	5	10	0	1	11	0	0
17	50690440	.	C	T	4	2	6	0	1	7	0	0
17	50690448	.	C	T	3	5	8	0	0	8	0	0
17	50785539	.	T	C	3	2	5	0	0	5	0	0
17	50839928	.	C	T	3	6	9	0	0	9	0	0
17	50840514	.	A	G	1	8	9	0	0	9	0	0
17	50840575	.	C	G	2	2	4	0	0	4	0	0
17	50976567	.	C	T	21	9	30	0	1	31	0	0
17	51206851	.	T	C	20	5	25	0	3	28	0	0
17	51231980	.	T	C	6	6	12	0	0	12	0	0
17	51232547	.	T	C	6	4	10	0	0	10	0	0
17	51720546	.	A	G	7	2	9	0	0	9	0	0
17	51776369	.	C	T	0	7	7	0	0	7	0	0
17	51776388	.	G	C	1	5	6	0	2	8	0	0
17	51797531	.	T	G	7	11	18	0	1	19	0	0
17	51823617	.	G	T	16	8	24	0	2	26	0	0
17	51823836	.	T	C	17	0	17	1	8	26	0	0
17	51823989	.	G	T	9	6	15	2	0	17	0	0
17	51824046	.	C	T	11	4	15	0	0	15	0	0
17	51824061	.	G	A	10	5	15	0	0	15	0	0
17	51824096	.	T	C	6	5	11	3	0	14	0	0
17	51824117	.	A	C	4	0	4	6	4	14	0	0
17	51824496	.	A	C	3	2	5	0	0	5	0	0
17	51893050	.	T	G	3	3	6	0	1	7	0	0
17	52002690	.	C	G	1	2	3	0	0	3	0	0
17	52006019	.	T	A	1	2	3	0	1	4	0	0
17	52067291	.	A	G	2	2	4	0	0	4	0	0
17	52070314	.	G	A	2	3	5	0	0	5	0	0
17	52070335	.	G	A	4	3	7	0	0	7	0	0
17	52300202	.	T	G	4	2	6	0	0	6	0	0
17	52385779	.	C	T	1	2	3	0	0	3	0	0
17	52385969	.	T	A	3	2	5	0	0	5	0	0
17	52528662	.	G	C	16	20	36	0	1	37	0	0
17	52533036	.	C	G	12	15	27	0	0	27	0	0
17	52533073	.	C	T	18	13	31	0	0	31	0	0
17	52534241	.	G	A	0	20	20	0	18	38	0	0
17	52534343	.	G	A	28	11	39	0	3	42	0	0
17	52541342	.	G	A	1	21	22	0	17	39	0	0
17	52553107	.	C	A	20	22	42	0	0	42	0	0
17	52553141	.	T	C	16	23	39	0	0	40	1	0
17	52553270	.	G	A	22	19	41	0	2	43	0	0
17	52840328	.	A	C	24	25	49	0	1	50	0	0
17	52856614	.	T	C	26	17	43	0	5	48	0	0
17	52919954	.	C	T	29	33	62	0	2	64	0	0
17	52920291	.	A	T	20	23	43	0	0	43	0	0
17	52920588	.	A	G	18	1	19	0	19	38	0	0
17	52940864	.	C	T	1	5	6	0	5	11	0	0
17	52940898	.	T	C	4	4	8	0	0	8	0	0
17	53304308	.	C	G	5	2	7	0	2	9	0	0
17	53304309	.	C	T	4	2	6	0	3	9	0	0
18	1689	.	A	C	13	7	20	0	1	21	0	0
18	1983	.	T	C	10	7	17	0	1	18	0	0
18	2725	.	G	A	20	6	26	0	1	27	0	0
18	11295	.	A	G	6	2	8	0	0	8	0	0
18	17639	.	G	A	13	13	26	0	0	26	0	0
18	17786	.	G	A	13	8	21	0	1	22	0	0
18	17795	.	G	A	14	9	23	0	3	26	0	0
18	18731	.	A	G	16	8	24	0	2	26	0	0
18	22746	.	A	G	13	10	23	0	1	24	0	0
18	22891	.	G	A	11	8	19	0	0	19	0	0
18	35921	.	A	G	1	2	3	0	1	4	0	0
18	36167	.	G	A	2	10	12	0	1	13	0	0
18	54387	.	C	G	1	2	3	0	0	3	0	0
18	54502	.	C	T	2	3	5	0	0	5	0	0
18	54600	.	C	T	2	3	5	0	0	5	0	0
18	55219	.	C	A	2	3	5	0	0	5	0	0
18	58631	.	C	T	4	3	7	0	0	7	0	0
18	73510	.	G	T	2	5	7	0	0	7	0	0
18	73543	.	T	A	5	4	9	0	0	9	0	0
18	73584	.	G	A	11	7	18	0	0	18	0	0
18	73740	.	A	C	11	0	11	0	6	17	0	0
18	73839	.	A	G	9	1	10	0	0	10	0	0
18	74866	.	C	T	12	6	18	0	1	19	0	0
18	74994	.	A	G	10	3	13	0	0	13	0	0
18	81944	.	A	T	4	2	6	0	2	8	0	0
18	82705	.	C	T	8	16	24	0	0	24	0	0
18	95776	.	T	A	3	3	6	0	1	7	0	0
18	97588	.	C	T	8	12	20	0	0	20	0	0
18	97762	.	G	A	8	6	14	0	0	14	0	0
18	97789	.	C	T	8	4	12	0	1	13	0	0
18	98622	.	G	A	8	11	19	0	2	21	0	0
18	100483	.	A	G	8	0	8	0	25	33	0	0
18	100944	.	G	A	3	18	21	0	13	34	0	0
18	102350	.	T	G	11	0	11	0	14	25	0	0
18	102353	.	A	G	11	12	23	0	0	23	0	0
18	103101	.	G	C	4	9	13	0	8	21	0	0
18	104405	.	G	A	0	9	9	0	14	23	0	0
18	106814	.	T	C	12	18	30	0	0	30	0	0
18	107015	.	T	C	12	15	27	0	1	28	0	0
18	107135	.	A	T	17	13	30	1	0	31	0	0
18	107345	.	A	G	18	0	18	2	20	40	0	0
18	114089	.	A	C	11	7	18	0	0	18	0	0
18	114425	.	C	T	5	2	7	0	1	8	0	0
18	114713	.	A	T	11	15	26	0	1	27	0	0
18	117788	.	G	A	14	9	23	0	0	24	1	0
18	118729	.	G	A	14	10	24	0	0	24	0	0
18	118912	.	G	A	11	7	18	0	0	18	0	0
18	123917	.	T	C	3	12	15	0	1	16	0	0
18	127438	.	G	A	5	6	11	0	0	11	0	0
18	127444	.	A	G	5	5	10	0	1	11	0	0
18	127513	.	A	G	5	3	8	0	1	9	0	0
18	127678	.	A	G	2	5	7	0	0	7	0	0
18	130779	.	T	A	7	7	14	0	0	14	0	0
18	131065	.	T	C	2	0	2	0	5	7	0	0
18	131092	.	C	T	1	7	8	0	3	11	0	0
18	137781	.	A	G	2	2	4	0	0	4	0	0
18	139365	.	A	G	6	5	11	0	2	13	0	0
18	144447	.	G	A	5	7	12	0	0	12	0	0
18	148197	.	A	G	4	4	8	0	1	9	0	0
18	148200	.	A	G	5	4	9	0	1	10	0	0
18	173660	.	C	T	16	10	26	0	2	28	0	0
18	173694	.	C	T	14	7	21	0	0	21	0	0
18	173903	.	C	A	13	7	20	0	1	21	0	0
18	184917	.	T	C	7	16	23	0	0	23	0	0
18	193689	.	A	C	13	8	21	0	1	22	0	0
18	193982	.	C	T	16	13	29	0	1	30	0	0
18	194006	.	A	G	12	0	12	0	19	31	0	0
18	194078	.	C	T	23	14	37	0	0	37	0	0
18	194162	.	G	C	1	28	29	0	16	45	0	0
18	194318	.	A	G	8	6	14	0	3	17	0	0
18	194460	.	C	G	11	8	19	0	0	19	0	0
18	194464	.	C	T	9	9	18	0	0	18	0	0
18	194799	.	T	C	3	5	8	0	0	8	0	0
18	204678	.	A	C	7	4	11	0	1	12	0	0
18	204742	.	G	A	10	8	18	0	0	18	0	0
18	204828	.	G	A	16	18	34	0	1	35	0	0
18	204866	.	T	A	14	19	33	0	8	41	0	0
18	204980	.	C	T	17	16	33	0	2	35	0	0
18	204982	.	G	A	18	15	33	0	2	35	0	0
18	205095	.	C	T	1	22	23	0	18	41	0	0
18	205105	.	A	G	19	21	40	0	1	41	0	0
18	205152	.	G	A	28	13	41	0	0	41	0	0
18	205179	.	G	A	18	22	40	0	5	45	0	0
18	207172	.	T	C	12	12	24	0	1	25	0	0
18	207184	.	G	A	14	11	25	0	0	25	0	0
18	207314	.	T	A	8	7	15	1	2	18	0	0
18	209114	.	G	A	20	12	32	0	1	33	0	0
18	209118	.	A	G	21	14	35	0	2	37	0	0
18	209321	.	T	G	15	19	34	0	0	34	0	0
18	209382	.	A	G	15	14	29	0	0	29	0	0
18	210385	.	T	A	25	14	39	0	0	39	0	0
18	210899	.	T	A	2	2	4	0	0	4	0	0
18	211186	.	T	A	18	21	39	0	1	40	0	0
18	211304	.	T	C	12	0	12	0	11	23	0	0
18	211346	.	C	T	1	11	12	0	9	21	0	0
18	211380	.	G	A	13	16	29	0	1	30	0	0
18	211399	.	T	C	17	20	37	0	0	37	0	0
18	211438	.	T	A	13	14	27	0	0	27	0	0
18	211469	.	C	A	13	11	24	0	1	25	0	0
18	211483	.	A	T	15	8	23	0	1	24	0	0
18	211605	.	A	G	17	12	29	0	2	31	0	0
18	211610	.	T	C	18	0	18	0	15	33	0	0
18	211812	.	T	A	7	11	18	0	0	18	0	0
18	212305	.	A	G	25	18	43	0	0	43	0	0
18	214688	.	A	G	10	22	32	0	1	33	0	0
18	214717	.	T	C	12	23	35	0	2	37	0	0
18	216775	.	G	A	13	10	23	0	1	24	0	0
18	216779	.	G	A	12	12	24	0	0	24	0	0
18	220144	.	G	A	10	10	20	0	2	22	0	0
18	222448	.	T	C	16	0	16	0	14	30	0	0
18	334298	.	T	C	4	4	8	0	1	9	0	0
18	334361	.	T	C	3	4	7	0	1	8	0	0
18	336586	.	T	C	11	9	20	0	3	23	0	0
18	493779	.	T	C	3	0	3	0	2	5	0	0
18	507687	.	G	A	0	3	3	0	1	4	0	0
18	577515	.	G	A	0	4	4	0	5	9	0	0
18	580961	.	G	A	0	4	4	0	2	6	0	0
18	581075	.	G	A	2	4	6	0	7	13	0	0
18	586067	.	A	G	3	0	3	0	8	11	0	0
18	597148	.	C	T	5	7	12	0	0	12	0	0
18	600337	.	C	T	2	6	8	0	0	8	0	0
18	609280	.	G	A	1	5	6	0	0	6	0	0
18	609322	.	A	G	4	0	4	0	4	8	0	0
18	609365	.	A	G	5	6	11	0	0	11	0	0
18	609877	.	G	A	11	6	17	0	0	17	0	0
18	609935	.	G	A	0	8	8	0	11	19	0	0
18	610126	.	A	T	15	8	23	0	0	23	0	0
18	610148	.	A	T	14	5	19	0	0	19	0	0
18	610184	.	G	T	9	6	15	0	1	16	0	0
18	610187	.	G	T	8	7	15	0	0	15	0	0
18	610291	.	T	C	3	5	8	0	1	9	0	0
18	610631	.	T	A	3	3	6	0	0	6	0	0
18	642918	.	T	C	6	12	18	1	1	20	0	0
18	643164	.	C	T	10	8	18	0	0	18	0	0
18	643517	.	C	T	17	10	27	0	0	27	0	0
18	660616	.	A	G	1	2	3	0	0	3	0	0
18	660688	.	T	C	7	4	11	0	1	12	0	0
18	660752	.	G	C	0	3	3	0	3	6	0	0
18	660846	.	C	A	5	5	10	0	0	10	0	0
18	714517	.	A	G	5	5	10	0	0	10	0	0
18	789974	.	T	A	9	5	14	0	0	14	0	0
18	790247	.	T	C	6	9	15	0	0	16	1	0
18	790301	.	T	A	9	12	21	0	2	23	0	0
18	790451	.	T	G	15	1	16	0	16	32	0	0
18	790962	.	T	G	8	13	21	0	4	25	0	0
18	791069	.	A	G	9	0	9	0	11	20	0	0
18	791076	.	G	C	8	9	17	0	1	18	0	0
18	791137	.	T	A	12	11	23	0	0	23	0	0
18	791171	.	G	C	10	12	22	0	0	22	0	0
18	791246	.	G	A	8	12	20	0	0	20	0	0
18	791449	.	T	G	3	2	5	0	0	5	0	0
18	809012	.	G	T	19	22	41	0	3	44	0	0
18	824270	.	T	C	4	2	6	0	0	6	0	0
18	824278	.	A	G	4	1	5	0	0	5	0	0
18	824994	.	G	A	5	2	7	0	0	7	0	0
18	824998	.	C	T	5	2	7	0	0	7	0	0
18	825078	.	A	T	8	4	12	0	0	12	0	0
18	825448	.	T	A	4	2	6	0	0	6	0	0
18	825457	.	T	C	3	2	5	0	0	5	0	0
18	826116	.	G	A	1	5	6	0	0	6	0	0
18	826190	.	A	T	7	8	15	0	1	16	0	0
18	826488	.	A	T	4	3	7	0	1	8	0	0
18	826574	.	C	T	2	4	6	0	0	6	0	0
18	826998	.	A	T	5	2	7	1	0	8	0	0
18	888440	.	G	A	11	9	20	0	0	20	0	0
18	891534	.	C	A	9	8	17	0	1	18	0	0
18	891586	.	G	A	18	7	25	0	1	26	0	0
18	911036	.	C	A	4	6	10	0	1	11	0	0
18	911076	.	A	G	24	0	24	0	20	44	0	0
18	925088	.	C	T	28	28	56	0	2	58	0	0
18	925100	.	A	C	29	22	51	0	4	55	0	0
18	933299	.	G	A	24	33	57	0	1	58	0	0
18	936728	.	C	T	33	37	70	0	0	70	0	0
18	939430	.	C	T	29	27	56	0	3	59	0	0
18	951004	.	A	T	34	36	70	1	2	73	0	0
18	951005	.	T	C	30	38	68	1	4	73	0	0
18	964060	.	A	C	1	3	4	0	0	4	0	0
18	1152220	.	G	A	2	2	4	0	0	4	0	0
18	1154270	.	A	G	1	2	3	0	0	3	0	0
18	1154278	.	A	G	1	3	4	0	0	4	0	0
18	1161085	.	A	G	10	10	20	0	0	20	0	0
18	1161750	.	A	G	31	26	57	0	2	59	0	0
18	1173819	.	G	A	26	23	49	0	1	50	0	0
18	1173856	.	G	A	31	27	58	0	1	59	0	0
18	1173898	.	A	G	27	24	51	0	3	54	0	0
18	1292100	.	C	T	1	7	8	0	3	11	0	0
18	1292164	.	G	A	8	4	12	0	1	13	0	0
18	1292668	.	T	C	9	0	9	0	10	19	0	0
18	1293182	.	G	A	6	6	12	0	0	12	0	0
18	1363189	.	G	A	1	4	5	0	0	5	0	0
18	1391653	.	A	G	1	3	4	0	0	4	0	0
18	1391674	.	T	C	4	0	4	0	4	8	0	0
18	2173327	.	A	C	3	2	5	0	0	5	0	0
18	2180603	.	A	G	4	2	6	0	1	7	0	0
18	2190731	.	G	A	0	3	3	0	5	8	0	0
18	2197638	.	A	C	6	7	13	0	0	13	0	0
18	2204386	.	T	C	1	2	3	0	0	3	0	0
18	2205302	.	T	A	4	2	6	0	1	7	0	0
18	2208642	.	A	C	5	5	10	0	0	10	0	0
18	2210570	.	C	T	5	7	12	0	1	13	0	0
18	2211091	.	T	C	6	3	9	0	3	12	0	0
18	2215557	.	C	T	5	2	7	0	0	7	0	0
18	2215642	.	A	G	3	2	5	0	0	5	0	0
18	2219142	.	C	A	2	4	6	0	0	6	0	0
18	2225632	.	C	T	12	12	24	2	2	28	0	0
18	2225661	.	C	T	14	12	26	2	2	30	0	0
18	2225947	.	T	C	2	4	6	0	0	6	0	0
18	2377645	.	T	C	8	0	8	0	16	24	0	0
18	2377860	.	G	A	16	9	25	0	1	26	0	0
18	2378462	.	A	T	7	5	12	0	0	12	0	0
18	2378510	.	C	A	3	10	13	0	0	13	0	0
18	2378619	.	T	G	6	4	10	0	0	10	0	0
18	2378625	.	G	T	6	4	10	0	0	10	0	0
18	2378687	.	A	C	15	6	21	0	3	24	0	0
18	2378713	.	T	G	7	17	24	0	1	25	0	0
18	2378722	.	C	T	2	7	9	0	15	24	0	0
18	2379073	.	G	A	4	4	8	2	1	11	0	0
18	2408681	.	C	A	13	10	23	0	0	23	0	0
18	2408886	.	G	A	8	12	20	0	0	20	0	0
18	2412660	.	T	C	4	8	12	0	2	14	0	0
18	2412726	.	G	C	11	14	25	0	0	25	0	0
18	2443977	.	A	T	2	3	5	0	0	5	0	0
18	2443998	.	C	T	2	1	3	0	3	6	0	0
18	2533358	.	T	C	4	2	6	0	3	9	0	0
18	2548878	.	G	A	2	3	5	0	0	5	0	0
18	2603576	.	T	G	6	4	10	0	0	10	0	0
18	2603786	.	A	G	3	5	8	0	1	9	0	0
18	2612259	.	A	G	4	4	8	0	0	8	0	0
18	2612293	.	A	G	6	2	8	0	0	8	0	0
18	2619228	.	A	G	5	4	9	0	0	9	0	0
18	2629272	.	G	C	4	3	7	0	0	7	0	0
18	2634309	.	T	G	2	3	5	0	1	6	0	0
18	2668603	.	G	A	3	3	6	0	0	6	0	0
18	2681965	.	G	A	9	8	17	0	1	18	0	0
18	2682182	.	C	T	1	14	15	0	11	26	0	0
18	2682203	.	A	T	10	12	22	0	0	22	0	0
18	2682610	.	T	C	8	16	24	0	0	24	0	0
18	2682793	.	C	T	1	5	6	0	5	11	0	0
18	2683175	.	T	G	4	2	6	1	0	7	0	0
18	2683181	.	C	T	4	2	6	1	0	7	0	0
18	2683365	.	G	T	3	9	12	0	1	13	0	0
18	2683985	.	T	C	5	9	14	0	0	14	0	0
18	2684031	.	T	C	4	9	13	0	0	13	0	0
18	2684322	.	T	C	8	7	15	0	0	15	0	0
18	2684456	.	T	C	1	4	5	0	1	6	0	0
18	2684458	.	A	G	3	4	7	0	0	7	0	0
18	2684872	.	A	G	9	6	15	0	2	17	0	0
18	2684889	.	A	T	9	5	14	0	1	15	0	0
18	2685127	.	C	A	10	2	12	0	0	12	0	0
18	2685138	.	C	T	1	4	5	0	9	14	0	0
18	2685162	.	T	C	18	1	19	0	5	24	0	0
18	2685263	.	A	G	12	11	23	0	0	23	0	0
18	2685297	.	A	G	10	8	18	0	0	18	0	0
18	2685348	.	C	T	0	3	3	0	12	15	0	0
18	2687992	.	C	T	6	13	19	0	0	19	0	0
18	2692381	.	A	C	10	5	15	0	0	15	0	0
18	2702458	.	G	A	12	8	20	0	0	20	0	0
18	2702524	.	C	T	6	14	20	0	1	21	0	0
18	2702536	.	A	G	5	12	17	0	2	19	0	0
18	2702569	.	C	T	0	8	8	0	15	23	0	0
18	2702888	.	T	C	13	0	13	0	16	29	0	0
18	2702976	.	A	C	10	7	17	0	0	17	0	0
18	2703120	.	A	G	3	7	10	0	1	11	0	0
18	2707108	.	G	A	4	10	14	0	0	14	0	0
18	2708467	.	G	A	6	8	14	0	0	14	0	0
18	2708505	.	C	T	7	5	12	0	0	12	0	0
18	2709356	.	T	C	3	4	7	0	0	7	0	0
18	2709395	.	G	A	4	2	6	0	0	6	0	0
18	2710216	.	A	G	7	3	10	0	0	10	0	0
18	2710231	.	T	C	6	0	6	0	4	10	0	0
18	2711894	.	C	G	1	7	8	0	5	13	0	0
18	2713199	.	C	T	9	7	16	0	1	17	0	0
18	2721518	.	T	C	5	4	9	0	0	9	0	0
18	2721565	.	A	G	8	7	15	0	0	15	0	0
18	2727714	.	G	A	2	4	6	1	1	8	0	0
18	2902985	.	A	G	12	0	12	1	16	29	0	0
18	2934856	.	A	G	8	7	15	0	1	16	0	0
18	2935243	.	G	C	9	5	14	0	0	14	0	0
18	2935265	.	A	T	8	7	15	0	2	17	0	0
18	2935480	.	C	T	18	16	34	0	0	34	0	0
18	3006843	.	C	T	7	3	10	0	1	11	0	0
18	3039440	.	A	G	30	34	64	0	3	67	0	0
18	3049662	.	T	A	1	4	5	0	0	5	0	0
18	3049752	.	T	G	21	20	41	0	3	44	0	0
18	3049756	.	A	G	21	18	39	0	4	43	0	0
18	3049869	.	G	A	0	5	5	0	3	8	0	0
18	3049973	.	A	G	1	0	1	0	2	3	0	0
18	3078582	.	C	T	9	5	14	0	0	14	0	0
18	3078672	.	C	T	5	9	14	0	1	15	0	0
18	3078684	.	C	T	9	7	16	0	0	16	0	0
18	3084660	.	G	C	7	3	10	0	0	10	0	0
18	3084698	.	G	A	3	6	9	0	0	9	0	0
18	3087662	.	G	A	4	7	11	0	0	11	0	0
18	3087695	.	T	G	4	7	11	0	0	11	0	0
18	3087704	.	T	A	3	8	11	0	1	12	0	0
18	3087776	.	G	A	10	6	16	0	0	16	0	0
18	3089906	.	T	C	4	4	8	0	1	9	0	0
18	3096656	.	T	A	1	4	5	0	0	5	0	0
18	3096661	.	T	A	0	4	4	0	1	5	0	0
18	3096698	.	A	G	2	3	5	0	0	5	0	0
18	3096718	.	A	G	1	3	4	0	0	4	0	0
18	3096739	.	C	T	3	2	5	0	0	5	0	0
18	3096926	.	C	T	3	5	8	0	0	8	0	0
18	3100651	.	A	G	5	14	19	0	0	19	0	0
18	3140747	.	G	A	4	3	7	0	1	8	0	0
18	3142685	.	A	G	6	10	16	0	0	16	0	0
18	3144677	.	G	A	0	8	8	0	9	17	0	0
18	3144742	.	A	T	15	14	29	0	0	29	0	0
18	3153072	.	G	C	5	2	7	0	0	7	0	0
18	3153231	.	A	T	1	2	3	0	0	3	0	0
18	3158739	.	A	G	3	17	20	0	0	20	0	0
18	3158776	.	G	A	12	4	16	0	1	17	0	0
18	3158896	.	C	T	8	7	15	2	0	17	0	0
18	3159140	.	C	A	3	10	13	0	0	13	0	0
18	3159193	.	G	A	9	3	12	0	1	13	0	0
18	3159249	.	C	A	4	3	7	1	0	8	0	0
18	3159324	.	C	G	4	2	6	1	0	7	0	0
18	3159326	.	C	A	4	2	6	0	0	6	0	0
18	3159711	.	A	C	6	4	10	0	0	10	0	0
18	3159712	.	C	A	6	4	10	0	0	10	0	0
18	3159965	.	A	T	3	3	6	0	1	7	0	0
18	3160148	.	C	G	0	5	5	1	7	13	0	0
18	3160308	.	A	G	7	5	12	0	0	12	0	0
18	3160354	.	C	T	1	4	5	0	8	13	0	0
18	3160406	.	T	C	1	0	1	0	4	5	0	0
18	3160422	.	A	G	1	2	3	0	0	3	0	0
18	3166045	.	C	G	0	2	2	0	3	6	1	0
18	3166180	.	G	A	5	5	10	0	0	10	0	0
18	3259736	.	C	T	23	23	46	0	2	48	0	0
18	3259807	.	C	A	13	17	30	3	1	34	0	0
18	3259847	.	C	T	22	19	41	0	2	43	0	0
18	3265657	.	T	C	11	12	23	1	1	25	0	0
18	3276085	.	G	C	15	26	41	0	3	44	0	0
18	3276187	.	A	G	15	1	16	0	16	32	0	0
18	3283882	.	T	C	19	19	38	0	3	41	0	0
18	3323557	.	A	G	2	0	2	0	3	5	0	0
18	3327571	.	G	A	0	3	3	0	4	7	0	0
18	3334609	.	C	T	10	5	15	0	0	15	0	0
18	3339152	.	G	C	6	4	10	0	1	11	0	0
18	3345141	.	T	A	4	7	11	0	0	11	0	0
18	3349011	.	T	C	4	9	13	0	0	13	0	0
18	3501282	.	C	T	1	3	4	0	0	4	0	0
18	3501283	.	C	G	0	3	3	0	0	3	0	0
18	3535934	.	C	G	1	3	4	0	1	5	0	0
18	3535953	.	G	A	3	5	8	0	0	8	0	0
18	3536868	.	A	T	14	9	23	0	1	26	2	0
18	3536937	.	T	C	10	7	17	0	0	17	0	0
18	3539989	.	C	T	1	8	9	0	5	14	0	0
18	3540027	.	C	T	8	8	16	0	0	16	0	0
18	3556542	.	A	G	11	15	26	0	1	27	0	0
18	3556626	.	C	T	2	9	11	0	7	18	0	0
18	3556935	.	C	T	3	7	10	0	0	10	0	0
18	3557043	.	A	T	5	2	7	0	1	8	0	0
18	3562608	.	A	G	3	6	9	0	1	10	0	0
18	3569275	.	C	T	0	9	9	0	6	15	0	0
18	3572547	.	G	A	5	6	11	0	1	12	0	0
18	3572878	.	T	C	7	6	13	0	0	13	0	0
18	3575938	.	C	A	8	9	17	0	0	17	0	0
18	3576104	.	C	T	15	7	22	0	0	22	0	0
18	3576212	.	A	C	1	5	6	0	1	7	0	0
18	3617759	.	C	T	4	4	8	0	0	8	0	0
18	3618015	.	C	G	2	7	9	0	0	9	0	0
18	3620556	.	A	C	2	4	6	0	0	6	0	0
18	5167603	.	A	G	27	10	37	0	0	37	0	0
18	5167604	.	A	G	23	14	37	0	0	37	0	0
18	5170063	.	A	G	32	16	48	1	3	52	0	0
18	5170069	.	A	G	17	0	17	1	33	51	0	0
18	5234937	.	C	A	0	16	16	1	17	34	0	0
18	5234990	.	T	G	18	25	43	0	1	44	0	0
18	5235033	.	C	T	17	22	39	0	1	40	0	0
18	5242329	.	G	A	17	17	34	0	0	34	0	0
18	5243234	.	A	G	14	9	23	0	1	24	0	0
18	5243255	.	T	C	15	15	30	0	0	30	0	0
18	5244632	.	G	A	3	3	6	0	1	7	0	0
18	5244986	.	G	A	4	8	12	0	0	12	0	0
18	5245467	.	G	A	3	3	6	0	0	6	0	0
18	5245503	.	G	A	3	2	5	0	1	6	0	0
18	5245615	.	G	A	1	4	5	0	0	5	0	0
18	5245806	.	T	C	11	22	33	0	2	35	0	0
18	5245818	.	C	T	1	22	23	0	13	36	0	0
18	5308441	.	T	G	8	6	14	0	3	17	0	0
18	5310018	.	A	G	2	7	9	2	2	13	0	0
18	5316537	.	A	G	2	4	6	0	0	6	0	0
18	5316708	.	C	G	2	3	5	0	0	5	0	0
18	5318496	.	C	T	1	2	3	0	0	3	0	0
18	5375143	.	A	G	8	7	15	0	0	15	0	0
18	5378093	.	C	A	0	8	8	0	10	18	0	0
18	5454381	.	G	A	2	4	6	0	1	7	0	0
18	5455161	.	C	T	6	7	13	0	0	13	0	0
18	5455347	.	G	T	0	8	8	0	4	12	0	0
18	5456883	.	C	T	3	3	6	0	0	6	0	0
18	5491697	.	G	A	22	31	53	0	1	54	0	0
18	5494980	.	A	G	12	25	37	0	4	41	0	0
18	5495903	.	T	C	14	12	26	0	6	32	0	0
18	5506578	.	C	T	22	31	53	0	3	56	0	0
18	5509426	.	G	C	16	15	31	0	1	32	0	0
18	5514321	.	T	G	6	6	12	0	0	12	0	0
18	5514544	.	T	A	7	6	13	0	0	13	0	0
18	5516984	.	T	C	7	5	12	0	1	13	0	0
18	5518108	.	C	T	18	8	26	0	0	26	0	0
18	5518128	.	T	C	16	11	27	0	0	27	0	0
18	5518749	.	T	C	13	7	20	0	0	20	0	0
18	5518809	.	T	G	5	4	9	0	1	10	0	0
18	5519052	.	C	T	3	5	8	0	0	8	0	0
18	5519119	.	A	G	2	6	8	0	0	8	0	0
18	5519138	.	A	G	6	3	9	0	0	9	0	0
18	5519269	.	T	C	8	11	19	0	1	20	0	0
18	5519534	.	T	A	4	5	9	0	0	9	0	0
18	5519622	.	G	A	0	2	2	0	3	5	0	0
18	5524952	.	C	A	0	3	3	0	1	4	0	0
18	5524973	.	G	C	1	0	1	0	3	4	0	0
18	5526964	.	T	A	1	2	3	0	0	3	0	0
18	5531611	.	A	T	2	7	9	1	0	10	0	0
18	5533186	.	A	C	6	0	6	0	6	12	0	0
18	5534295	.	T	C	3	0	3	0	8	11	0	0
18	5535127	.	C	T	1	3	4	0	1	5	0	0
18	5535203	.	C	T	0	2	2	0	2	4	0	0
18	5535243	.	G	A	2	2	4	0	0	4	0	0
18	5537129	.	G	C	2	6	8	0	0	8	0	0
18	5537138	.	C	T	2	6	8	0	0	8	0	0
18	5537171	.	A	C	1	1	2	0	1	3	0	0
18	5537255	.	T	C	1	6	7	0	0	7	0	0
18	5537530	.	A	G	2	4	6	0	1	7	0	0
18	5539488	.	T	C	4	0	4	0	3	7	0	0
18	5539517	.	T	C	2	0	2	0	4	6	0	0
18	5619919	.	G	A	0	3	3	0	8	11	0	0
18	5619922	.	G	A	8	3	11	0	0	11	0	0
18	5624614	.	A	G	6	6	12	0	1	13	0	0
18	5624654	.	T	A	7	8	15	0	0	15	0	0
18	5626583	.	G	A	9	8	17	0	1	18	0	0
18	5626661	.	A	C	7	5	12	0	0	12	0	0
18	5692205	.	A	G	21	12	33	0	1	34	0	0
18	5692222	.	A	T	19	12	31	0	0	31	0	0
18	6079364	.	T	C	6	2	8	0	0	8	0	0
18	6868454	.	A	G	27	10	37	0	0	37	0	0
18	7099981	.	A	G	3	3	6	0	0	6	0	0
18	7571359	.	G	A	0	2	2	0	6	8	0	0
18	7571381	.	C	T	6	6	12	0	0	12	0	0
18	7571412	.	A	G	14	5	19	0	0	19	0	0
18	7571478	.	G	T	13	4	17	0	1	18	0	0
18	7571628	.	C	T	12	16	28	0	5	33	0	0
18	7571657	.	A	G	10	11	21	0	2	23	0	0
18	7571684	.	A	C	6	17	23	0	1	24	0	0
18	7571712	.	G	T	4	19	23	0	3	26	0	0
18	7810148	.	G	A	3	2	5	0	0	5	0	0
18	10693077	.	G	A	7	3	10	0	1	11	0	0
18	10693085	.	T	A	6	4	10	0	0	10	0	0
18	10693123	.	C	T	4	3	7	0	2	9	0	0
18	10693155	.	T	A	2	4	6	0	0	6	0	0
18	10693322	.	A	T	14	6	20	0	0	20	0	0
18	10698083	.	T	C	5	8	13	0	0	13	0	0
18	10698161	.	T	G	10	4	14	0	1	15	0	0
18	10703669	.	A	G	2	4	6	0	0	6	0	0
18	10708346	.	G	A	4	5	9	0	0	9	0	0
18	10709870	.	C	A	4	2	6	0	0	6	0	0
18	10709876	.	C	A	4	2	6	0	0	6	0	0
18	10710190	.	C	T	1	3	4	0	2	6	0	0
18	10820428	.	A	C	10	4	14	0	0	14	0	0
18	10825951	.	A	G	6	13	19	0	1	20	0	0
18	10840094	.	C	A	6	6	12	0	0	12	0	0
18	10840722	.	C	G	11	4	15	0	0	15	0	0
18	10846601	.	T	C	14	9	23	0	1	24	0	0
18	10847743	.	C	T	17	9	26	0	1	27	0	0
18	10847872	.	A	G	5	17	22	0	1	23	0	0
18	10867181	.	A	C	9	17	26	0	1	27	0	0
18	10870806	.	T	C	11	19	30	0	0	30	0	0
18	10877499	.	G	A	7	13	20	0	0	20	0	0
18	10879495	.	G	A	7	9	16	0	0	16	0	0
18	10887826	.	A	G	12	7	19	0	0	19	0	0
18	10888245	.	A	C	7	9	16	0	2	18	0	0
18	10888551	.	T	C	15	8	23	0	2	25	0	0
18	10888836	.	T	C	15	6	21	0	1	22	0	0
18	10889049	.	C	G	7	0	7	0	7	14	0	0
18	10889880	.	G	A	2	6	8	0	10	18	0	0
18	10889901	.	T	A	9	4	13	0	1	14	0	0
18	10889951	.	G	A	11	10	21	1	1	23	0	0
18	10890432	.	G	A	7	8	15	0	1	16	0	0
18	10921408	.	A	T	13	12	25	0	0	25	0	0
18	10921630	.	A	T	5	13	18	0	0	19	1	0
18	10921734	.	T	C	7	12	19	0	1	20	0	0
18	10921791	.	T	C	8	11	19	0	4	23	0	0
18	10921855	.	T	C	7	17	24	1	1	26	0	0
18	10921857	.	G	A	1	14	15	1	10	26	0	0
18	10921927	.	C	T	8	8	16	0	0	16	0	0
18	11016209	.	G	A	3	7	10	1	0	11	0	0
18	11507028	.	T	G	5	4	9	0	0	9	0	0
18	11507253	.	T	G	4	6	10	0	0	10	0	0
18	11507263	.	G	A	6	5	11	0	0	11	0	0
18	11515830	.	C	T	7	2	9	0	0	9	0	0
18	11541046	.	A	G	4	4	8	0	0	8	0	0
18	11558187	.	G	A	1	2	3	0	0	3	0	0
18	11558197	.	T	C	1	3	4	0	0	4	0	0
18	11558350	.	G	T	1	2	3	0	0	3	0	0
18	11558360	.	G	A	1	2	3	0	0	3	0	0
18	11567278	.	G	T	2	2	4	0	0	4	0	0
18	11579521	.	A	C	2	3	5	0	0	5	0	0
18	11878643	.	G	C	0	3	3	0	2	5	0	0
18	12058480	.	T	A	6	3	9	0	0	9	0	0
18	12105432	.	T	C	8	6	14	0	0	14	0	0
18	12105548	.	G	A	0	3	3	0	3	6	0	0
18	12111431	.	A	C	3	8	11	0	0	11	0	0
18	12111625	.	A	G	5	6	11	0	1	12	0	0
18	12111628	.	A	T	5	6	11	0	1	12	0	0
18	12111772	.	A	C	6	3	9	0	0	9	0	0
18	12111784	.	G	T	4	4	8	0	1	9	0	0
18	12111925	.	G	A	5	3	8	0	1	9	0	0
18	12112105	.	T	C	7	7	14	0	2	16	0	0
18	12112153	.	T	C	10	4	14	0	2	16	0	0
18	12112219	.	C	T	5	6	11	0	0	11	0	0
18	12112246	.	A	G	7	0	7	0	6	13	0	0
18	12112726	.	C	T	7	3	10	0	0	10	0	0
18	12112750	.	G	A	8	4	12	0	0	12	0	0
18	12113515	.	C	A	7	6	13	0	0	13	0	0
18	12113516	.	C	T	7	6	13	0	0	13	0	0
18	12148050	.	T	G	6	0	6	0	2	8	0	0
18	12148056	.	C	T	5	3	8	0	0	8	0	0
18	12171277	.	C	T	2	3	5	0	0	5	0	0
18	12171313	.	A	G	4	0	4	0	6	10	0	0
18	12196939	.	G	A	1	3	4	0	5	9	0	0
18	12207046	.	A	G	5	8	13	0	0	13	0	0
18	12207070	.	C	A	11	4	15	0	0	15	0	0
18	12214299	.	A	G	4	6	10	0	0	10	0	0
18	12228217	.	C	A	13	8	21	0	0	21	0	0
18	12228758	.	C	T	4	8	12	0	0	12	0	0
18	12228834	.	G	C	4	4	8	0	0	8	0	0
18	12229120	.	A	T	2	7	9	0	0	9	0	0
18	12229223	.	A	C	5	5	10	0	0	10	0	0
18	12229245	.	C	T	4	7	11	0	0	11	0	0
18	12236126	.	T	A	1	2	3	0	0	3	0	0
18	12236351	.	C	T	9	12	21	0	0	21	0	0
18	12238082	.	G	A	10	8	18	0	0	18	0	0
18	12240681	.	C	T	16	5	21	0	1	22	0	0
18	12240740	.	G	C	8	8	16	0	0	16	0	0
18	12242967	.	C	T	1	10	11	0	8	19	0	0
18	12244667	.	G	A	3	4	7	0	0	7	0	0
18	12245576	.	A	G	4	7	11	0	0	11	0	0
18	12250727	.	G	A	3	3	6	0	0	6	0	0
18	12251352	.	G	A	3	2	5	0	0	5	0	0
18	12254398	.	A	G	0	4	4	0	1	5	0	0
18	12254409	.	G	A	3	4	7	0	0	7	0	0
18	12256444	.	G	A	3	2	5	0	0	5	0	0
18	12256647	.	A	G	4	5	9	0	0	9	0	0
18	12264032	.	A	G	1	3	4	0	1	5	0	0
18	12276859	.	C	T	20	9	29	0	1	30	0	0
18	12277052	.	A	G	17	8	25	0	0	25	0	0
18	12277206	.	G	C	12	13	25	0	5	30	0	0
18	12277490	.	G	A	24	18	42	0	0	42	0	0
18	12280269	.	C	T	30	15	45	0	0	45	0	0
18	12292017	.	G	A	25	20	45	0	1	46	0	0
18	12327321	.	C	A	0	5	5	0	5	10	0	0
18	12364876	.	G	A	4	2	6	0	0	6	0	0
18	12366171	.	C	G	6	5	11	0	0	11	0	0
18	12366855	.	A	T	4	4	8	0	0	8	0	0
18	12374108	.	C	A	5	2	7	0	0	7	0	0
18	12374168	.	A	G	1	6	7	0	0	7	0	0
18	12374521	.	A	G	2	2	4	0	0	4	0	0
18	12385129	.	G	A	3	2	5	0	0	5	0	0
18	12416623	.	C	T	4	6	10	0	0	10	0	0
18	12416835	.	C	A	3	4	7	0	1	8	0	0
18	12417035	.	T	G	1	2	3	0	1	4	0	0
18	12451778	.	G	A	1	2	3	0	0	3	0	0
18	12464794	.	C	T	0	2	2	0	3	5	0	0
18	12464867	.	C	A	3	5	8	0	0	8	0	0
18	12465290	.	G	A	14	10	24	0	0	24	0	0
18	12465316	.	C	T	11	8	19	0	2	21	0	0
18	12467834	.	G	C	10	0	10	0	13	23	0	0
18	12470013	.	G	T	11	4	15	0	1	16	0	0
18	12470136	.	G	A	13	8	21	0	1	22	0	0
18	12470148	.	A	G	12	13	25	0	0	25	0	0
18	12470211	.	C	T	1	9	10	0	14	24	0	0
18	12471210	.	T	C	7	5	12	0	3	15	0	0
18	12471225	.	G	A	5	5	10	0	0	10	0	0
18	12495185	.	C	T	10	6	16	0	0	16	0	0
18	12611569	.	T	C	3	5	8	0	1	9	0	0
18	12612031	.	C	T	0	2	2	0	3	5	0	0
18	12612160	.	A	G	7	9	16	0	1	17	0	0
18	12653846	.	G	C	2	2	4	0	0	4	0	0
18	12659197	.	C	T	6	9	15	0	0	15	0	0
18	12659226	.	C	T	5	6	11	0	0	11	0	0
18	12776727	.	C	T	9	6	15	1	0	16	0	0
18	12779357	.	T	A	14	10	24	1	0	25	0	0
18	12828500	.	C	T	5	9	14	0	0	14	0	0
18	13124606	.	T	C	4	4	8	0	0	8	0	0
18	14772522	.	G	A	5	10	15	0	1	16	0	0
18	14772747	.	C	T	1	5	6	0	9	15	0	0
18	14772889	.	A	G	10	4	14	0	0	14	0	0
18	14773050	.	C	T	17	4	21	0	1	22	0	0
18	14774568	.	T	C	6	0	6	0	7	13	0	0
18	14774646	.	C	G	12	5	17	0	0	17	0	0
18	14779213	.	C	T	9	12	21	0	1	22	0	0
18	14780581	.	G	A	8	6	14	0	0	14	0	0
18	14782677	.	C	T	2	3	5	1	1	7	0	0
18	14825239	.	G	A	4	3	7	0	0	7	0	0
18	14836678	.	C	T	9	3	12	0	0	12	0	0
18	14836706	.	C	T	8	2	10	0	1	11	0	0
18	14866506	.	G	A	6	4	10	0	0	10	0	0
18	14866508	.	C	T	6	4	10	0	0	10	0	0
18	14867144	.	A	C	5	1	6	0	4	10	0	0
18	14867153	.	C	T	4	5	9	0	0	9	0	0
18	14871145	.	A	G	1	4	5	0	0	5	0	0
18	14871280	.	A	C	1	0	1	0	5	6	0	0
18	14878790	.	A	G	4	6	10	0	0	10	0	0
18	14885652	.	A	T	1	2	3	0	0	3	0	0
18	14886129	.	C	T	3	3	6	0	0	6	0	0
18	14886151	.	G	A	5	3	8	0	0	8	0	0
18	14891794	.	T	C	3	2	5	0	0	5	0	0
18	14893764	.	A	G	1	2	3	0	0	3	0	0
18	14901176	.	G	A	4	2	6	0	0	6	0	0
18	14901390	.	T	G	1	2	3	0	0	3	0	0
18	14901410	.	T	G	1	2	3	0	0	3	0	0
18	14906635	.	A	C	3	2	5	0	0	5	0	0
18	14909768	.	G	A	4	3	7	0	0	7	0	0
18	14917016	.	T	C	2	0	2	0	4	6	0	0
18	14917126	.	C	T	2	3	5	0	0	5	0	0
18	14928654	.	C	T	16	7	23	0	0	23	0	0
18	14928681	.	T	C	16	7	23	0	2	25	0	0
18	14930095	.	T	C	7	2	9	0	1	10	0	0
18	14933334	.	T	C	5	0	5	0	8	13	0	0
18	14936995	.	A	G	2	2	4	0	0	4	0	0
18	14941817	.	C	A	3	2	5	0	0	5	0	0
18	14956171	.	A	G	4	2	6	0	0	6	0	0
18	14956177	.	G	A	4	2	6	0	0	6	0	0
18	14969855	.	G	A	3	2	5	0	0	5	0	0
18	14969931	.	C	A	0	2	2	0	3	5	0	0
18	14975502	.	G	C	2	3	5	0	0	5	0	0
18	14979233	.	A	G	3	3	6	0	0	6	0	0
18	14979242	.	C	T	0	2	2	0	5	7	0	0
18	15010757	.	T	C	3	3	6	0	0	6	0	0
18	15100812	.	T	A	3	6	9	0	0	9	0	0
18	15100866	.	A	G	4	4	8	0	0	8	0	0
18	15107012	.	C	A	3	6	9	0	1	10	0	0
18	15121484	.	G	A	4	5	9	0	0	9	0	0
18	15123008	.	C	A	5	3	8	0	2	10	0	0
18	15123011	.	A	G	7	3	10	0	0	10	0	0
18	15125122	.	G	A	7	5	12	0	0	12	0	0
18	15125193	.	A	C	3	4	7	0	1	8	0	0
18	15125418	.	C	A	10	5	15	0	0	15	0	0
18	15128960	.	T	C	7	3	10	0	0	10	0	0
18	15129248	.	A	T	4	2	6	0	0	6	0	0
18	15129522	.	T	A	2	2	4	0	0	4	0	0
18	15132372	.	T	C	13	10	23	0	0	23	0	0
18	15132383	.	T	C	11	8	19	0	2	21	0	0
18	15136657	.	A	G	2	0	2	0	6	8	0	0
18	15139004	.	T	A	5	2	7	0	0	7	0	0
18	15139049	.	A	G	4	0	4	0	4	8	0	0
18	15139150	.	G	A	5	6	11	0	1	12	0	0
18	15139540	.	C	T	8	6	14	0	1	15	0	0
18	15139757	.	G	A	5	4	9	0	0	9	0	0
18	15139784	.	T	C	3	2	5	0	0	5	0	0
18	15148021	.	T	C	3	4	7	1	1	9	0	0
18	15148063	.	A	C	3	0	3	0	3	6	0	0
18	15148199	.	T	C	9	4	13	0	0	13	0	0
18	15148207	.	A	C	8	5	13	0	1	14	0	0
18	15148248	.	T	C	5	5	10	0	2	12	0	0
18	15148259	.	A	C	5	5	10	0	0	10	0	0
18	15148482	.	A	G	5	5	10	0	0	10	0	0
18	15148912	.	A	G	3	3	6	0	0	6	0	0
18	15148954	.	T	C	4	2	6	0	0	6	0	0
18	15149813	.	T	A	0	2	2	0	1	3	0	0
18	15150165	.	A	T	3	3	6	0	1	7	0	0
18	15150207	.	G	A	4	4	8	0	2	10	0	0
18	15150261	.	A	G	4	2	6	0	0	6	0	0
18	15150327	.	C	T	1	2	3	0	0	3	0	0
18	15150330	.	G	A	1	2	3	0	0	3	0	0
18	15150442	.	C	T	5	4	9	0	0	9	0	0
18	15155939	.	G	A	3	2	5	0	0	5	0	0
18	15175672	.	A	G	1	2	3	0	0	3	0	0
18	15175675	.	T	G	1	0	1	0	2	3	0	0
18	15285346	.	C	T	4	6	10	0	0	10	0	0
18	15289895	.	G	A	0	2	2	0	2	4	0	0
18	15295925	.	C	T	0	5	5	0	9	14	0	0
18	15295976	.	G	T	7	3	10	0	0	10	0	0
18	15309513	.	T	C	7	0	7	0	10	17	0	0
18	15334703	.	C	T	1	2	3	0	0	3	0	0
18	15334856	.	G	A	6	3	9	0	0	9	0	0
18	15345012	.	A	G	3	3	6	0	0	6	0	0
18	15348633	.	A	G	2	3	5	0	0	5	0	0
18	15358344	.	A	T	3	2	5	0	0	6	1	0
18	15383683	.	C	T	3	2	5	0	0	5	0	0
18	15393324	.	G	A	4	2	6	0	1	7	0	0
18	15394086	.	G	C	2	4	6	0	1	7	0	0
18	15394143	.	T	C	2	2	4	0	1	5	0	0
18	15395535	.	A	G	8	3	11	2	0	13	0	0
18	15399135	.	T	C	4	4	8	0	0	8	0	0
18	15403754	.	C	T	3	3	6	0	0	6	0	0
18	15404498	.	A	G	4	4	8	0	0	8	0	0
18	15408140	.	G	A	6	2	8	0	0	8	0	0
18	15408185	.	T	C	2	2	4	0	1	5	0	0
18	15410687	.	G	A	4	2	6	0	0	6	0	0
18	15418358	.	T	G	2	4	6	0	0	6	0	0
18	15418379	.	T	A	2	3	5	0	0	5	0	0
18	15459835	.	T	A	4	13	17	0	1	18	0	0
18	15459871	.	C	T	4	10	14	0	0	14	0	0
18	15461092	.	T	C	1	2	3	0	0	3	0	0
18	15467318	.	A	G	1	3	4	0	0	4	0	0
18	15467373	.	A	G	1	4	5	0	0	5	0	0
18	15469907	.	T	C	5	7	12	0	0	12	0	0
18	15470114	.	T	G	6	3	9	0	0	9	0	0
18	15478391	.	T	G	10	4	14	0	0	14	0	0
18	15478394	.	G	A	11	4	15	0	0	15	0	0
18	15478597	.	A	G	7	2	9	0	0	9	0	0
18	15481364	.	T	G	5	5	10	0	1	11	0	0
18	15481636	.	C	T	3	2	5	0	0	5	0	0
18	15483345	.	A	G	3	5	8	0	0	8	0	0
18	15483351	.	C	T	2	6	8	0	0	8	0	0
18	15483994	.	C	T	0	4	4	0	1	5	0	0
18	15484021	.	C	T	0	5	5	0	1	6	0	0
18	15484036	.	G	A	2	4	6	0	0	6	0	0
18	15490146	.	G	A	2	4	6	0	1	7	0	0
18	15514894	.	C	T	2	3	5	0	0	5	0	0
18	15569644	.	T	C	2	4	6	0	0	6	0	0
18	15570793	.	C	T	2	3	5	0	0	5	0	0
18	15571066	.	A	G	1	3	4	1	0	5	0	0
18	15573490	.	G	T	2	2	4	0	0	4	0	0
18	15584670	.	T	G	6	4	10	0	0	10	0	0
18	15589490	.	C	T	0	2	2	0	5	7	0	0
18	15792294	.	T	G	19	20	39	0	0	39	0	0
18	15792368	.	G	C	22	20	42	0	2	44	0	0
18	15792459	.	A	C	23	17	40	0	1	41	0	0
18	15792596	.	T	A	21	22	43	0	1	44	0	0
18	15792611	.	A	G	22	22	44	0	0	44	0	0
18	15792743	.	T	A	12	29	41	0	1	42	0	0
18	15793064	.	A	G	7	7	14	0	0	14	0	0
18	15836835	.	A	G	7	4	11	0	0	11	0	0
18	15836917	.	A	G	5	2	7	0	1	8	0	0
18	15836961	.	C	T	4	4	8	0	1	9	0	0
18	15849413	.	T	C	3	6	9	0	0	9	0	0
18	15858916	.	G	A	6	5	11	0	1	12	0	0
18	15863558	.	G	A	2	3	5	0	0	5	0	0
18	15865085	.	G	C	0	4	4	0	4	8	0	0
18	15865154	.	T	C	4	6	10	0	1	11	0	0
18	15865196	.	C	G	6	6	12	0	0	12	0	0
18	15866874	.	T	G	8	5	13	0	0	13	0	0
18	15866876	.	G	T	8	5	13	0	0	13	0	0
18	15869816	.	C	A	5	2	7	0	2	9	0	0
18	15869854	.	T	G	7	0	7	0	3	10	0	0
18	15872092	.	A	G	3	3	6	0	1	7	0	0
18	15872435	.	A	G	6	4	10	0	0	10	0	0
18	15874454	.	T	C	4	3	7	0	0	7	0	0
18	15874550	.	C	T	8	4	12	1	1	14	0	0
18	15875196	.	G	A	6	4	10	0	1	11	0	0
18	16111467	.	C	G	1	2	3	0	4	7	0	0
18	16127885	.	A	G	19	15	34	0	1	35	0	0
18	16127927	.	A	C	17	22	39	0	1	40	0	0
18	16128730	.	A	G	9	6	15	1	1	17	0	0
18	16128960	.	T	G	24	13	37	0	1	38	0	0
18	16129210	.	A	C	17	14	31	0	3	34	0	0
18	16129583	.	T	A	19	15	34	0	3	37	0	0
18	16129862	.	C	T	15	19	34	0	0	34	0	0
18	16133772	.	C	G	12	11	23	0	1	24	0	0
18	16133773	.	T	A	12	12	24	0	0	24	0	0
18	16133822	.	T	C	10	9	19	0	1	20	0	0
18	16140047	.	G	A	14	6	20	0	1	21	0	0
18	16140337	.	G	T	2	15	17	0	24	41	0	0
18	16145618	.	T	G	22	31	53	0	1	54	0	0
18	16145621	.	C	T	21	31	52	0	0	52	0	0
18	16145994	.	C	G	12	8	20	0	0	20	0	0
18	16151809	.	T	A	5	5	10	0	0	10	0	0
18	16151936	.	G	A	12	6	18	0	1	19	0	0
18	16152149	.	G	A	15	11	26	0	1	27	0	0
18	16153487	.	T	C	14	0	14	0	16	30	0	0
18	16157998	.	T	C	7	0	7	0	5	12	0	0
18	16196481	.	A	G	1	0	1	0	4	5	0	0
18	16215514	.	A	G	0	2	2	0	0	2	0	0
18	16215523	.	A	G	1	3	4	0	0	4	0	0
18	16388195	.	G	A	6	7	13	0	0	13	0	0
18	16388294	.	G	C	6	0	6	0	6	12	0	0
18	16388342	.	G	A	4	2	6	0	0	6	0	0
18	16388579	.	A	G	7	5	12	0	1	13	0	0
18	16388747	.	T	C	5	7	12	0	1	13	0	0
18	16388825	.	A	G	6	4	10	0	0	10	0	0
18	16388864	.	C	T	6	4	10	0	0	10	0	0
18	16391712	.	G	A	3	2	5	0	0	5	0	0
18	16490700	.	A	C	1	4	5	0	1	6	0	0
18	16719963	.	T	C	13	17	30	0	0	30	0	0
18	16720197	.	G	A	12	17	29	0	0	29	0	0
18	16721705	.	G	A	19	16	35	0	6	41	0	0
18	16721741	.	G	A	20	18	38	0	3	41	0	0
18	16722124	.	G	A	24	26	50	0	2	52	0	0
18	16722584	.	G	A	14	17	31	0	1	32	0	0
18	16723514	.	T	C	13	16	29	0	0	29	0	0
18	16723520	.	A	G	15	1	16	0	14	30	0	0
18	16723785	.	A	G	15	0	15	0	21	36	0	0
18	16725225	.	G	A	2	27	29	0	13	42	0	0
18	16725309	.	C	T	16	8	24	0	1	25	0	0
18	16725917	.	A	G	15	15	30	0	1	31	0	0
18	16726011	.	C	T	10	15	25	0	0	25	0	0
18	16755962	.	C	A	21	26	47	0	2	49	0	0
18	16756001	.	C	T	16	20	36	0	2	38	0	0
18	16756058	.	T	A	15	16	31	0	4	35	0	0
18	16756065	.	G	A	19	14	33	0	0	33	0	0
18	16876903	.	A	G	4	5	9	0	1	10	0	0
18	16877282	.	C	T	8	6	14	0	0	14	0	0
18	16877283	.	A	G	7	6	13	0	1	14	0	0
18	16885979	.	T	G	6	7	13	0	0	13	0	0
18	16886079	.	C	T	11	8	19	0	0	19	0	0
18	16894571	.	T	A	8	7	15	0	2	17	0	0
18	16894594	.	T	G	13	7	20	0	0	20	0	0
18	16894630	.	A	G	14	7	21	0	0	21	0	0
18	16906522	.	A	G	3	4	7	0	0	7	0	0
18	16929772	.	G	A	9	14	23	1	0	24	0	0
18	16936429	.	G	A	2	3	5	0	1	6	0	0
18	16936758	.	T	C	3	2	5	0	0	5	0	0
18	16936787	.	A	G	3	3	6	0	0	6	0	0
18	16961046	.	A	G	16	13	29	6	0	35	0	0
18	16962778	.	A	G	19	8	27	1	2	30	0	0
18	16962783	.	C	T	17	11	28	1	2	31	0	0
18	16962823	.	C	T	18	16	34	0	2	36	0	0
18	16963091	.	C	G	13	13	26	0	3	29	0	0
18	16964002	.	G	A	1	7	8	0	10	18	0	0
18	16966911	.	T	C	18	11	29	0	1	30	0	0
18	16968314	.	T	C	19	16	35	0	3	38	0	0
18	16970455	.	A	T	12	6	18	0	0	18	0	0
18	16970459	.	G	A	1	8	9	0	13	22	0	0
18	16970598	.	C	T	12	6	18	1	0	19	0	0
18	16970795	.	A	T	3	3	6	0	0	6	0	0
18	16970912	.	T	C	3	5	8	0	0	8	0	0
18	16970916	.	T	C	4	4	8	0	0	8	0	0
18	16970997	.	G	C	0	15	15	0	10	25	0	0
18	16971129	.	C	T	10	11	21	0	0	21	0	0
18	16971155	.	A	T	10	6	16	0	0	16	0	0
18	16971255	.	T	A	2	2	4	0	0	4	0	0
18	16990122	.	C	T	0	4	4	0	5	9	0	0
18	16990150	.	G	T	6	3	9	0	0	9	0	0
18	16990385	.	A	C	7	0	7	0	6	13	0	0
18	16990520	.	C	T	6	9	15	0	0	15	0	0
18	16990550	.	A	G	6	10	16	0	0	16	0	0
18	16993352	.	A	T	0	5	5	0	1	6	0	0
18	17001024	.	A	T	5	3	8	0	0	8	0	0
18	17002614	.	T	C	5	0	5	0	8	13	0	0
18	17002653	.	A	G	10	6	16	0	0	16	0	0
18	17003602	.	A	G	9	8	17	0	0	17	0	0
18	17005917	.	T	C	6	4	10	0	0	10	0	0
18	17007458	.	G	A	2	4	6	0	0	6	0	0
18	17007521	.	G	A	6	3	9	0	0	9	0	0
18	17007527	.	C	T	6	4	10	0	0	10	0	0
18	17007720	.	T	C	2	2	4	0	0	4	0	0
18	17016613	.	G	A	2	3	5	0	0	5	0	0
18	17016697	.	T	C	5	3	8	0	0	8	0	0
18	17016721	.	G	T	2	2	4	0	0	4	0	0
18	17016890	.	G	A	2	2	4	0	0	4	0	0
18	17018541	.	C	G	1	6	7	0	0	7	0	0
18	17021499	.	C	T	3	2	5	0	0	5	0	0
18	17021521	.	C	T	1	2	3	0	0	3	0	0
18	17062226	.	G	A	2	2	4	0	0	4	0	0
18	17062227	.	G	A	2	2	4	0	0	4	0	0
18	17062323	.	G	A	5	4	9	0	1	10	0	0
18	17062336	.	T	C	4	4	8	0	1	9	0	0
18	17062364	.	T	G	4	4	8	0	0	8	0	0
18	17062487	.	G	T	5	2	7	0	0	7	0	0
18	17070214	.	C	A	2	3	5	0	0	5	0	0
18	17074061	.	C	T	1	2	3	0	2	5	0	0
18	17078575	.	A	T	1	3	4	0	0	4	0	0
18	17079541	.	T	C	15	8	23	4	1	28	0	0
18	17079724	.	C	T	0	13	13	0	10	23	0	0
18	17080089	.	G	C	7	12	19	0	1	20	0	0
18	17080122	.	A	G	4	10	14	0	0	14	0	0
18	17080131	.	T	C	3	0	3	0	11	14	0	0
18	17084489	.	C	T	1	8	9	0	11	20	0	0
18	17097893	.	T	C	8	17	25	0	5	30	0	0
18	17098009	.	G	T	6	11	17	0	5	22	0	0
18	17098317	.	T	A	6	6	12	0	1	13	0	0
18	17098562	.	T	A	8	4	12	0	4	16	0	0
18	17102046	.	C	T	1	15	16	0	10	26	0	0
18	17131006	.	A	G	11	10	21	0	0	21	0	0
18	17134780	.	A	G	5	5	10	0	1	11	0	0
18	17139446	.	G	A	3	6	9	0	0	9	0	0
18	17139461	.	T	C	4	5	9	0	0	9	0	0
18	17144659	.	C	T	8	2	10	0	0	10	0	0
18	17144909	.	T	A	5	6	11	0	0	11	0	0
18	17173465	.	T	G	1	3	4	0	0	4	0	0
18	17173474	.	A	C	1	3	4	0	0	4	0	0
18	17173629	.	A	G	1	1	2	0	1	3	0	0
18	17173638	.	C	T	1	3	4	0	0	4	0	0
18	17173687	.	G	T	0	3	3	0	2	5	0	0
18	17535748	.	A	T	10	12	22	0	2	24	0	0
18	17616856	.	G	A	0	4	4	0	1	5	0	0
18	17657141	.	C	T	4	2	6	0	1	7	0	0
18	17994415	.	A	G	3	24	27	0	1	28	0	0
18	19405533	.	G	A	2	4	6	0	0	6	0	0
18	19419200	.	A	T	14	10	24	0	0	24	0	0
18	19419307	.	C	T	6	19	25	0	2	27	0	0
18	19441492	.	C	G	19	20	39	0	2	41	0	0
18	19441561	.	T	C	15	20	35	0	1	36	0	0
18	19441585	.	C	A	12	20	32	0	0	32	0	0
18	19450486	.	T	C	29	29	58	0	1	59	0	0
18	19450563	.	A	T	30	27	57	0	3	60	0	0
18	19450642	.	A	T	26	28	54	0	1	55	0	0
18	19450692	.	A	G	26	18	44	0	0	44	0	0
18	19450755	.	A	G	28	25	53	2	1	56	0	0
18	19451023	.	C	T	19	18	37	0	0	37	0	0
18	19451117	.	C	T	9	11	20	0	5	25	0	0
18	19451427	.	G	A	46	25	71	0	3	74	0	0
18	19451430	.	T	C	45	5	50	0	23	73	0	0
18	19451477	.	G	A	42	43	85	0	1	86	0	0
18	19452126	.	T	A	37	36	73	0	2	75	0	0
18	19452594	.	G	A	25	43	68	0	2	70	0	0
18	19452639	.	A	G	34	37	71	1	3	75	0	0
18	19454313	.	A	G	1	2	3	0	0	3	0	0
18	19487779	.	G	A	15	10	25	0	0	25	0	0
18	19490515	.	C	T	20	21	41	0	0	41	0	0
18	19698539	.	C	T	3	4	7	1	0	8	0	0
18	19698833	.	T	C	6	6	12	0	0	12	0	0
18	19698854	.	G	A	6	6	12	0	0	12	0	0
18	19805440	.	T	C	2	4	6	0	0	6	0	0
18	19805464	.	C	T	2	5	7	0	0	7	0	0
18	19806014	.	A	G	2	0	2	0	3	5	0	0
18	19806135	.	T	G	3	2	5	0	0	5	0	0
18	19812943	.	A	T	9	7	16	0	1	17	0	0
18	19813002	.	A	G	15	12	27	0	0	27	0	0
18	19814181	.	A	G	7	12	19	0	0	19	0	0
18	19815743	.	A	T	8	8	16	0	1	17	0	0
18	19817682	.	G	A	9	6	15	0	0	15	0	0
18	19817717	.	G	A	2	3	5	0	1	6	0	0
18	19819719	.	C	A	4	9	13	0	0	13	0	0
18	19836969	.	C	T	2	2	4	0	0	4	0	0
18	19883812	.	G	T	1	4	5	0	10	15	0	0
18	20006910	.	C	T	6	7	13	0	0	13	0	0
18	20020108	.	A	T	6	3	9	0	0	9	0	0
18	20022806	.	T	C	6	6	12	0	0	12	0	0
18	20024856	.	T	C	3	3	6	0	0	7	1	0
18	20024889	.	G	A	5	3	8	0	1	9	0	0
18	20031213	.	G	A	1	2	3	0	0	3	0	0
18	20034058	.	T	A	3	5	8	0	0	8	0	0
18	20041825	.	T	C	18	9	27	0	1	28	0	0
18	20042088	.	C	T	16	13	29	0	1	30	0	0
18	20044847	.	T	C	14	5	19	0	0	19	0	0
18	20226051	.	A	T	4	4	8	0	0	8	0	0
18	20226131	.	G	T	2	10	12	0	0	12	0	0
18	20226288	.	G	A	6	5	11	0	1	12	0	0
18	20228760	.	C	T	8	5	13	0	1	14	0	0
18	20249005	.	G	T	2	13	15	0	17	32	0	0
18	20249735	.	T	C	9	10	19	0	0	19	0	0
18	20252129	.	C	T	10	9	19	0	0	19	0	0
18	20254384	.	C	T	7	6	13	0	1	14	0	0
18	20254398	.	G	A	0	4	4	0	10	14	0	0
18	20256275	.	C	T	7	15	22	0	0	22	0	0
18	20256379	.	A	G	3	6	9	0	1	10	0	0
18	20256491	.	T	A	4	7	11	0	1	12	0	0
18	20256492	.	A	T	8	5	13	0	0	13	0	0
18	20256539	.	G	A	13	5	18	0	0	18	0	0
18	20256671	.	T	C	12	5	17	1	1	19	0	0
18	20257005	.	G	A	2	16	18	0	7	25	0	0
18	20257159	.	C	G	9	5	14	0	1	15	0	0
18	20257200	.	A	T	8	10	18	0	0	18	0	0
18	20468514	.	G	T	0	9	9	0	2	11	0	0
18	20469150	.	G	A	2	3	5	0	0	5	0	0
18	20469275	.	T	A	3	2	5	0	0	5	0	0
18	20475854	.	C	T	4	4	8	0	1	9	0	0
18	20479008	.	A	G	8	8	16	0	1	17	0	0
18	20479773	.	G	T	0	2	2	0	1	3	0	0
18	20482479	.	A	C	2	3	5	0	0	5	0	0
18	20482672	.	T	C	3	2	5	0	0	5	0	0
18	20482681	.	C	G	2	0	2	0	3	5	0	0
18	20489224	.	G	A	2	2	4	0	0	4	0	0
18	20490370	.	A	C	3	4	7	0	0	7	0	0
18	20490510	.	A	T	1	4	5	0	0	5	0	0
18	20490672	.	G	A	1	2	3	0	0	3	0	0
18	20491073	.	C	A	1	2	3	0	0	3	0	0
18	20491095	.	T	C	2	3	5	0	0	5	0	0
18	20516618	.	C	A	4	3	7	0	0	7	0	0
18	20516628	.	T	C	4	3	7	0	0	7	0	0
18	20516811	.	T	C	2	4	6	0	0	6	0	0
18	20516863	.	A	C	3	3	6	0	0	6	0	0
18	20516869	.	T	G	3	3	6	0	0	6	0	0
18	20517000	.	G	A	5	4	9	0	0	9	0	0
18	20518915	.	C	G	4	2	6	0	0	6	0	0
18	20518961	.	A	C	5	2	7	0	0	7	0	0
18	20520964	.	A	G	2	2	4	0	0	4	0	0
18	20520982	.	G	T	2	2	4	0	0	4	0	0
18	20521053	.	T	G	4	2	6	0	0	6	0	0
18	20521431	.	A	T	2	2	4	0	0	4	0	0
18	20521558	.	T	G	1	5	6	0	0	6	0	0
18	20521680	.	G	A	1	5	6	0	0	6	0	0
18	20532660	.	G	A	6	3	9	0	0	9	0	0
18	20532685	.	T	C	8	3	11	0	1	12	0	0
18	20533934	.	G	A	12	6	18	0	0	18	0	0
18	20534277	.	A	T	6	4	10	0	0	10	0	0
18	20535074	.	T	A	8	8	16	0	0	16	0	0
18	20539548	.	G	A	0	4	4	0	10	14	0	0
18	20539703	.	T	A	2	5	7	0	0	7	0	0
18	20539844	.	T	A	4	5	9	1	0	10	0	0
18	20539979	.	T	A	3	3	6	0	0	6	0	0
18	20540144	.	G	A	1	6	7	0	1	8	0	0
18	20540216	.	A	G	2	5	7	0	0	7	0	0
18	20540313	.	G	T	6	4	10	0	1	11	0	0
18	20540581	.	G	T	1	4	5	0	0	5	0	0
18	20541575	.	A	C	10	4	14	0	0	14	0	0
18	20541735	.	A	G	7	5	12	0	3	15	0	0
18	20541863	.	C	G	5	3	8	0	0	8	0	0
18	20542107	.	C	T	1	17	18	0	15	33	0	0
18	20542128	.	T	G	17	13	30	0	2	32	0	0
18	20542214	.	A	T	5	8	13	0	0	13	0	0
18	20542388	.	T	G	22	10	32	0	1	33	0	0
18	20542398	.	A	C	19	7	26	0	3	29	0	0
18	20542503	.	G	A	12	14	26	0	1	27	0	0
18	20542562	.	T	G	16	11	27	0	0	27	0	0
18	20542647	.	C	T	14	12	26	0	0	26	0	0
18	20543466	.	T	A	17	15	32	0	0	32	0	0
18	20544691	.	G	A	11	9	20	0	2	22	0	0
18	20544901	.	G	C	12	9	21	0	2	23	0	0
18	20553607	.	T	C	13	12	25	0	0	25	0	0
18	20554066	.	C	T	0	9	9	0	10	19	0	0
18	20559518	.	C	T	14	13	27	0	3	30	0	0
18	20582109	.	G	A	9	7	16	1	1	18	0	0
18	20582222	.	G	A	9	7	16	0	0	16	0	0
18	20582303	.	C	T	1	4	5	0	7	12	0	0
18	20582314	.	C	G	6	4	10	0	0	10	0	0
18	20582356	.	C	T	5	3	8	0	1	9	0	0
18	20582361	.	T	C	5	4	9	0	0	9	0	0
18	20582392	.	C	T	0	3	3	0	3	6	0	0
18	20582629	.	T	C	8	9	17	0	1	18	0	0
18	20583127	.	C	T	5	4	9	0	0	9	0	0
18	20583154	.	G	T	6	4	10	0	1	11	0	0
18	20583610	.	A	T	1	4	5	0	0	5	0	0
18	20583763	.	A	G	5	7	12	0	0	12	0	0
18	20583820	.	A	T	4	5	9	0	0	9	0	0
18	20584077	.	G	A	1	5	6	0	1	7	0	0
18	20584098	.	T	A	4	2	6	0	0	6	0	0
18	20584340	.	C	T	1	7	8	0	2	10	0	0
18	20584986	.	T	G	5	2	7	0	0	7	0	0
18	20585314	.	C	T	13	9	22	0	0	22	0	0
18	20585435	.	T	C	7	0	7	0	4	11	0	0
18	20585495	.	C	T	4	4	8	0	0	8	0	0
18	20585837	.	G	A	2	6	8	0	0	8	0	0
18	20585883	.	G	A	5	5	10	0	1	11	0	0
18	20607160	.	G	A	1	2	3	0	0	3	0	0
18	20608212	.	A	T	5	2	7	0	0	7	0	0
18	20726304	.	T	C	32	2	34	0	26	60	0	0
18	20729281	.	C	T	1	25	26	0	13	39	0	0
18	20739268	.	G	T	11	6	17	0	2	19	0	0
18	20739298	.	C	T	8	7	15	0	0	15	0	0
18	20742029	.	C	G	11	18	29	0	1	30	0	0
18	20744164	.	T	C	11	8	19	0	6	25	0	0
18	20752848	.	G	A	10	24	34	0	0	34	0	0
18	20755763	.	G	A	8	13	21	0	0	21	0	0
18	20755787	.	G	T	7	13	20	0	0	20	0	0
18	20755843	.	G	C	10	10	20	0	0	20	0	0
18	20755844	.	C	A	12	10	22	0	0	22	0	0
18	20755971	.	G	T	3	13	16	0	1	17	0	0
18	20757663	.	G	A	8	8	16	0	0	16	0	0
18	20757934	.	C	T	6	19	25	0	3	28	0	0
18	20757977	.	A	C	9	0	9	0	13	22	0	0
18	20757979	.	G	A	10	9	19	0	3	22	0	0
18	20768254	.	T	C	10	0	10	0	9	19	0	0
18	20768407	.	C	T	19	6	25	0	8	33	0	0
18	20768818	.	T	A	11	14	25	0	2	28	1	0
18	20768977	.	C	T	6	4	10	0	2	12	0	0
18	20771078	.	T	C	5	0	5	0	9	14	0	0
18	20771085	.	A	G	8	5	13	0	0	13	0	0
18	20821793	.	G	A	7	3	10	0	0	10	0	0
18	20821863	.	G	A	1	3	4	0	0	4	0	0
18	20838864	.	A	T	1	4	5	0	0	5	0	0
18	20838888	.	T	G	1	2	3	0	0	3	0	0
18	20859991	.	G	T	5	6	11	0	0	11	0	0
18	20859992	.	G	A	6	4	10	0	1	11	0	0
18	20860651	.	T	C	1	3	4	0	0	4	0	0
18	20861647	.	G	A	3	2	5	0	0	5	0	0
18	20865543	.	T	C	1	2	3	0	0	3	0	0
18	20868503	.	C	G	3	3	6	0	0	6	0	0
18	20869089	.	C	T	0	2	2	0	2	4	0	0
18	20869128	.	T	C	1	2	3	0	0	3	0	0
18	20881800	.	G	A	5	4	9	0	1	10	0	0
18	20882057	.	G	A	2	6	8	0	0	8	0	0
18	20882062	.	T	C	1	1	2	0	7	9	0	0
18	20882098	.	C	T	3	7	10	0	0	10	0	0
18	20882237	.	C	G	2	2	4	0	0	4	0	0
18	20883090	.	A	G	2	4	6	0	0	6	0	0
18	20894485	.	G	A	3	2	5	0	0	5	0	0
18	20914388	.	C	T	2	4	6	0	0	6	0	0
18	20917327	.	T	G	3	3	6	1	0	7	0	0
18	21071085	.	A	G	7	1	8	0	12	20	0	0
18	21073091	.	A	G	3	5	8	0	0	8	0	0
18	21075715	.	A	C	2	7	9	0	1	10	0	0
18	21075858	.	A	T	3	4	7	0	0	7	0	0
18	21075867	.	G	T	2	3	5	0	0	5	0	0
18	21102019	.	A	C	2	9	11	0	0	11	0	0
18	21102023	.	C	T	0	8	8	0	2	10	0	0
18	21102764	.	C	T	1	6	7	0	3	10	0	0
18	21102797	.	G	T	6	4	10	0	0	10	0	0
18	21102914	.	G	A	1	7	8	0	1	9	0	0
18	21103079	.	G	A	3	6	9	0	0	9	0	0
18	21103334	.	A	C	2	4	6	0	0	6	0	0
18	21113258	.	G	A	0	7	7	0	6	13	0	0
18	21113273	.	T	C	6	7	13	0	1	14	0	0
18	21113462	.	T	A	4	2	6	0	0	6	0	0
18	21113533	.	G	A	12	4	16	0	0	16	0	0
18	21114475	.	T	C	8	8	16	0	0	16	0	0
18	21116381	.	C	A	8	7	15	0	0	15	0	0
18	21117589	.	C	A	9	5	14	0	0	14	0	0
18	21118232	.	C	G	8	9	17	0	0	17	0	0
18	21119498	.	G	A	10	8	18	0	1	19	0	0
18	21119562	.	G	A	7	5	12	0	0	12	0	0
18	21119579	.	A	T	7	5	12	0	1	13	0	0
18	21119854	.	T	C	9	6	15	0	2	17	0	0
18	21136729	.	C	T	14	15	29	0	2	31	0	0
18	21136948	.	C	T	21	12	33	0	4	37	0	0
18	21143473	.	A	T	22	16	38	0	0	38	0	0
18	21143787	.	C	A	18	13	31	0	0	31	0	0
18	21143938	.	C	G	21	12	33	0	0	33	0	0
18	21143998	.	C	T	16	22	38	1	1	40	0	0
18	21144005	.	C	A	15	21	36	1	1	38	0	0
18	21144060	.	G	A	3	23	26	0	15	41	0	0
18	21144502	.	A	T	2	2	4	0	0	4	0	0
18	21144800	.	A	T	6	7	13	0	0	13	0	0
18	21144880	.	G	T	10	10	20	0	1	21	0	0
18	21144965	.	G	C	1	9	10	0	10	20	0	0
18	21145142	.	A	G	9	16	25	0	1	26	0	0
18	21145290	.	G	T	8	8	16	0	0	16	0	0
18	21179325	.	T	C	12	0	12	0	7	19	0	0
18	21179730	.	A	G	12	10	22	5	0	27	0	0
18	21185167	.	A	G	6	12	18	0	1	19	0	0
18	21198961	.	G	T	17	14	31	0	2	33	0	0
18	21199165	.	G	T	15	9	24	0	7	31	0	0
18	21199515	.	T	C	23	27	50	1	2	53	0	0
18	21214976	.	T	C	15	19	34	0	0	34	0	0
18	21218734	.	G	A	28	17	45	0	1	46	0	0
18	21257600	.	A	T	20	7	27	0	1	28	0	0
18	21257657	.	T	C	5	21	26	0	0	26	0	0
18	21257786	.	G	A	16	7	23	0	1	24	0	0
18	21257867	.	G	A	10	13	23	0	0	23	0	0
18	21257946	.	C	T	21	7	28	0	0	28	0	0
18	21258083	.	G	A	15	9	24	0	0	24	0	0
18	21263120	.	G	A	9	13	22	0	0	22	0	0
18	21266815	.	A	G	8	12	20	0	0	20	0	0
18	21266885	.	G	A	3	5	8	0	1	9	0	0
18	21400505	.	G	C	1	1	2	0	1	3	0	0
18	21400506	.	C	T	1	1	2	0	1	3	0	0
18	21492325	.	T	C	18	15	33	0	1	34	0	0
18	21617864	.	G	A	3	17	20	0	35	55	0	0
18	21618343	.	C	T	21	28	49	0	1	50	0	0
18	21618379	.	A	G	23	26	49	0	0	49	0	0
18	21618496	.	G	A	25	21	46	0	1	47	0	0
18	21618659	.	C	A	17	14	31	0	2	33	0	0
18	21618731	.	G	T	29	28	57	0	2	59	0	0
18	21618910	.	G	T	22	21	43	1	2	46	0	0
18	21619011	.	C	T	23	20	43	0	0	43	0	0
18	21619018	.	A	T	21	19	40	0	0	40	0	0
18	21619055	.	G	T	24	12	36	0	0	36	0	0
18	21619260	.	C	T	24	17	41	0	0	41	0	0
18	21619284	.	G	T	18	17	35	1	2	38	0	0
18	21619672	.	A	G	18	27	45	2	3	50	0	0
18	21619686	.	G	A	17	35	52	2	0	54	0	0
18	21619777	.	A	G	24	30	54	1	4	59	0	0
18	21619799	.	T	G	26	29	55	0	2	57	0	0
18	21619948	.	C	T	24	17	41	2	0	43	0	0
18	21620082	.	A	T	24	15	39	0	1	40	0	0
18	21620376	.	A	C	22	23	45	0	0	45	0	0
18	21620426	.	G	A	5	16	21	0	26	47	0	0
18	21645327	.	G	A	1	2	3	0	0	3	0	0
18	21645492	.	G	A	9	3	12	0	2	14	0	0
18	21645627	.	A	G	7	7	14	0	0	14	0	0
18	21645902	.	G	C	11	0	11	0	16	27	0	0
18	21645965	.	G	A	12	17	29	0	4	33	0	0
18	21645989	.	T	G	14	13	27	0	1	28	0	0
18	21647419	.	T	C	7	5	12	0	1	13	0	0
18	21648522	.	C	T	12	9	21	0	1	22	0	0
18	21648582	.	A	G	12	4	16	0	0	16	0	0
18	21648627	.	C	T	6	7	13	0	0	13	0	0
18	21648633	.	A	T	6	7	13	0	0	13	0	0
18	21653937	.	C	T	13	14	27	0	0	27	0	0
18	21654124	.	A	C	8	1	9	0	10	19	0	0
18	21654145	.	C	T	9	10	19	0	0	19	0	0
18	21654375	.	C	A	8	6	14	0	0	14	0	0
18	21654432	.	T	C	9	8	17	0	1	18	0	0
18	21654489	.	C	T	14	7	21	0	0	21	0	0
18	21656271	.	C	A	4	8	12	0	0	12	0	0
18	21656274	.	G	A	7	3	10	0	1	11	0	0
18	21656605	.	C	T	4	7	11	0	1	12	0	0
18	21657642	.	T	G	8	5	13	0	2	15	0	0
18	21664864	.	G	A	8	3	11	0	0	11	0	0
18	21674320	.	G	T	10	4	14	0	0	14	0	0
18	21678723	.	G	A	7	5	12	0	0	12	0	0
18	21689043	.	G	C	8	4	12	0	0	12	0	0
18	21689052	.	A	G	7	3	10	0	0	10	0	0
18	21689079	.	G	A	5	7	12	0	1	13	0	0
18	21693120	.	A	G	4	4	8	0	0	8	0	0
18	21693213	.	G	A	5	8	13	0	0	14	1	0
18	21693441	.	G	A	8	5	13	0	0	13	0	0
18	21697776	.	C	T	5	9	14	0	1	15	0	0
18	21698855	.	G	T	7	5	12	0	0	12	0	0
18	21699581	.	A	T	3	6	9	0	2	11	0	0
18	21704498	.	C	T	1	4	5	0	4	9	0	0
18	21724220	.	G	T	2	5	7	0	0	7	0	0
18	21724407	.	C	T	2	3	5	0	1	6	0	0
18	21724480	.	A	G	1	5	6	0	0	6	0	0
18	21724533	.	G	A	5	2	7	0	2	9	0	0
18	21724534	.	A	T	6	3	9	0	0	9	0	0
18	21728604	.	A	G	1	2	3	0	0	3	0	0
18	21732024	.	T	A	1	2	3	0	0	3	0	0
18	21732027	.	C	A	1	2	3	0	0	3	0	0
18	21782445	.	T	G	2	3	5	0	2	7	0	0
18	21782467	.	A	C	4	3	7	0	0	7	0	0
18	21782908	.	G	A	6	5	11	0	0	11	0	0
18	21783009	.	T	G	4	5	9	0	0	9	0	0
18	21783010	.	A	C	4	5	9	0	0	9	0	0
18	21783049	.	G	C	5	4	9	0	0	9	0	0
18	21783077	.	C	T	6	5	11	0	0	11	0	0
18	21783087	.	G	A	5	4	9	0	0	9	0	0
18	21783257	.	G	T	5	8	13	0	0	13	0	0
18	21783279	.	G	A	4	6	10	0	0	10	0	0
18	21783325	.	A	T	2	6	8	0	0	8	0	0
18	21783368	.	G	A	3	6	9	0	0	9	0	0
18	21784127	.	T	C	3	3	6	0	1	7	0	0
18	21860755	.	C	T	6	3	9	0	1	10	0	0
18	21861134	.	T	A	8	10	18	0	0	18	0	0
18	21861225	.	T	A	13	14	27	0	0	27	0	0
18	21861381	.	G	T	8	7	15	0	1	16	0	0
18	21861688	.	C	A	5	6	11	0	0	11	0	0
18	21861934	.	C	T	7	2	9	0	1	10	0	0
18	21862000	.	G	C	7	8	15	0	0	15	0	0
18	21862076	.	C	T	3	9	12	0	10	22	0	0
18	21862237	.	G	T	8	9	17	0	2	19	0	0
18	21862346	.	T	A	11	7	18	0	0	18	0	0
18	21880098	.	T	C	5	0	5	0	9	14	0	0
18	21880191	.	T	C	5	0	5	0	6	11	0	0
18	21888256	.	C	T	6	4	10	0	0	10	0	0
18	21890428	.	G	C	1	2	3	0	0	3	0	0
18	21891024	.	G	T	5	7	12	0	2	14	0	0
18	21900940	.	A	G	5	4	9	0	0	9	0	0
18	21900961	.	G	A	4	4	8	0	0	8	0	0
18	21905255	.	T	C	1	0	1	0	2	3	0	0
18	21906745	.	G	A	4	3	7	0	0	7	0	0
18	21906838	.	C	T	4	2	6	0	0	6	0	0
18	21913799	.	A	T	15	11	26	0	1	27	0	0
18	21913907	.	G	C	15	13	28	0	1	29	0	0
18	21913988	.	C	A	19	8	27	0	1	28	0	0
18	21914018	.	C	A	16	8	24	0	0	24	0	0
18	21914225	.	C	T	1	14	15	0	14	29	0	0
18	21914281	.	G	A	16	15	31	0	0	31	0	0
18	21914283	.	C	A	16	14	30	0	1	31	0	0
18	21940928	.	G	A	2	2	4	0	0	4	0	0
18	21943185	.	A	C	2	3	5	0	0	5	0	0
18	21943208	.	C	T	3	3	6	0	0	6	0	0
18	21983530	.	G	C	4	3	7	0	0	7	0	0
18	22002476	.	G	A	10	10	20	0	1	21	0	0
18	22002508	.	C	T	12	12	24	0	1	25	0	0
18	22029828	.	A	C	1	0	1	0	8	9	0	0
18	22030435	.	C	T	1	3	4	0	1	5	0	0
18	22030853	.	T	C	5	2	7	0	0	7	0	0
18	22030862	.	T	C	3	4	7	0	1	8	0	0
18	22030967	.	G	A	2	8	10	0	0	10	0	0
18	22030995	.	A	C	1	5	6	0	1	7	0	0
18	22031018	.	T	G	1	5	6	0	0	6	0	0
18	22082366	.	T	C	4	6	10	0	1	11	0	0
18	22232712	.	G	T	0	5	5	0	3	8	0	0
18	22232775	.	T	C	4	6	10	0	0	10	0	0
18	22255005	.	C	T	3	9	12	0	0	12	0	0
18	22261064	.	C	A	7	4	11	0	0	11	0	0
18	22272969	.	C	A	8	7	15	0	0	15	0	0
18	22275051	.	T	C	11	9	20	0	0	20	0	0
18	22282766	.	A	T	13	7	20	0	0	20	0	0
18	22282809	.	A	T	9	9	18	0	1	19	0	0
18	22282923	.	G	T	16	12	28	0	1	29	0	0
18	22282960	.	C	T	11	11	22	0	0	22	0	0
18	22282961	.	A	G	11	11	22	0	0	22	0	0
18	22283087	.	C	A	9	8	17	0	1	18	0	0
18	22283116	.	T	A	8	8	16	0	0	16	0	0
18	22288650	.	T	C	12	9	21	0	0	21	0	0
18	22288659	.	C	T	12	10	22	0	1	23	0	0
18	22289075	.	T	C	7	13	20	0	1	21	0	0
18	22289314	.	C	T	13	19	32	0	0	32	0	0
18	22290900	.	G	A	16	15	31	0	3	34	0	0
18	22290933	.	C	T	15	13	28	0	2	30	0	0
18	22292215	.	A	T	15	7	22	0	0	22	0	0
18	22292286	.	G	A	15	16	31	0	1	32	0	0
18	22292339	.	A	T	11	16	27	0	2	29	0	0
18	22293191	.	T	G	4	2	6	0	0	6	0	0
18	22356989	.	C	T	13	17	30	0	0	30	0	0
18	22377096	.	A	T	22	25	47	0	1	48	0	0
18	22377372	.	G	A	4	22	26	0	29	55	0	0
18	22377471	.	C	T	18	27	45	0	2	47	0	0
18	22385900	.	G	A	28	23	51	0	4	55	0	0
18	22405895	.	A	T	5	8	13	0	1	14	0	0
18	22406162	.	C	T	0	8	8	0	2	10	0	0
18	22406187	.	T	A	3	7	10	0	1	11	0	0
18	22406311	.	T	A	3	3	6	0	0	6	0	0
18	22406324	.	G	A	1	6	7	0	1	8	0	0
18	22406375	.	T	A	5	9	14	0	1	15	0	0
18	22406379	.	G	A	8	5	13	0	1	14	0	0
18	22406728	.	A	T	1	7	8	0	1	9	0	0
18	22406797	.	A	T	1	5	6	0	0	6	0	0
18	22407365	.	C	T	2	3	5	0	4	9	0	0
18	22414504	.	A	C	5	3	8	0	0	8	0	0
18	22414542	.	T	G	4	4	8	0	1	9	0	0
18	22417058	.	C	T	8	4	12	0	1	13	0	0
18	22417082	.	G	A	0	7	7	0	10	17	0	0
18	22417103	.	C	A	10	10	20	0	0	20	0	0
18	22420551	.	A	T	5	5	10	0	0	10	0	0
18	22420558	.	C	A	6	6	12	0	0	12	0	0
18	22424532	.	T	C	5	3	8	0	1	9	0	0
18	22424536	.	A	G	6	0	6	0	5	11	0	0
18	22424601	.	A	G	10	0	10	0	13	23	0	0
18	22486229	.	C	T	2	2	4	0	0	4	0	0
18	22486243	.	C	A	0	3	3	0	0	3	0	0
18	22486579	.	A	T	9	7	16	0	1	17	0	0
18	22631092	.	C	T	4	2	6	0	3	9	0	0
18	22669708	.	C	G	6	3	9	0	0	9	0	0
18	22679786	.	C	T	7	7	14	0	0	14	0	0
18	22679834	.	C	T	6	3	9	0	0	9	0	0
18	22679852	.	C	T	1	3	4	0	0	4	0	0
18	22685266	.	G	A	0	7	7	0	5	12	0	0
18	22685278	.	C	T	10	4	14	0	1	15	0	0
18	22685329	.	T	C	4	11	15	0	3	18	0	0
18	22685380	.	A	T	7	10	17	0	1	18	0	0
18	22685608	.	C	A	5	11	16	0	0	16	0	0
18	22686269	.	A	T	15	12	27	0	0	27	0	0
18	22686320	.	G	A	7	6	13	0	0	13	0	0
18	22686358	.	G	A	3	4	7	0	0	7	0	0
18	22686588	.	C	A	5	7	12	0	0	12	0	0
18	22686723	.	C	T	7	4	11	0	1	12	0	0
18	22686789	.	G	A	10	6	16	0	1	17	0	0
18	22686795	.	C	G	9	9	18	0	0	18	0	0
18	22686927	.	G	A	0	4	4	0	0	4	0	0
18	22687116	.	T	C	8	6	14	0	0	14	0	0
18	22687131	.	G	T	1	3	4	0	9	13	0	0
18	22687312	.	G	A	6	9	15	0	0	15	0	0
18	22687439	.	A	G	14	0	14	0	7	21	0	0
18	22687527	.	G	C	15	15	30	0	0	30	0	0
18	22687575	.	T	A	15	18	33	0	1	34	0	0
18	22687599	.	A	T	17	14	31	0	0	31	0	0
18	22687666	.	C	T	16	13	29	1	0	30	0	0
18	22728794	.	A	G	10	14	24	0	0	24	0	0
18	22732391	.	A	G	18	13	31	0	0	31	0	0
18	22921942	.	C	T	21	28	49	0	2	51	0	0
18	22921950	.	T	C	20	27	47	0	3	50	0	0
18	22975090	.	T	C	26	40	66	0	1	67	0	0
18	22975297	.	A	C	34	23	57	0	3	60	0	0
18	23071049	.	A	G	3	3	6	0	0	6	0	0
18	23071190	.	G	A	1	2	3	0	0	3	0	0
18	23071396	.	T	G	2	2	4	0	0	4	0	0
18	23071467	.	C	G	2	0	2	0	3	5	0	0
18	23071744	.	C	A	2	2	4	0	0	4	0	0
18	23071884	.	A	C	1	2	3	0	1	4	0	0
18	23200303	.	G	A	0	7	7	0	8	15	0	0
18	23249388	.	G	A	0	6	6	0	6	12	0	0
18	23270093	.	C	T	4	7	11	0	0	11	0	0
18	23869784	.	T	A	26	18	44	0	1	45	0	0
18	23875111	.	A	C	10	9	19	0	0	19	0	0
18	23887958	.	A	G	3	0	3	0	7	10	0	0
18	23888223	.	G	A	1	3	4	0	1	5	0	0
18	24563713	.	C	T	2	2	4	0	0	4	0	0
18	24922149	.	G	A	5	2	7	0	0	7	0	0
18	24926768	.	A	G	7	1	8	0	15	23	0	0
18	24926925	.	T	C	11	14	25	0	1	26	0	0
18	24928941	.	A	G	11	18	29	0	1	30	0	0
18	24929079	.	T	G	8	12	20	0	0	20	0	0
18	24929406	.	A	G	6	0	6	0	7	13	0	0
18	24929413	.	G	A	5	8	13	0	0	13	0	0
18	24929465	.	T	C	7	12	19	0	0	19	0	0
18	24929633	.	C	T	11	13	24	0	1	25	0	0
18	24929720	.	C	T	15	11	26	0	0	26	0	0
18	24930530	.	T	C	12	12	24	0	0	24	0	0
18	24931326	.	G	A	10	12	22	0	0	22	0	0
18	24931699	.	T	C	12	15	27	1	1	29	0	0
18	24933638	.	C	G	6	8	14	0	1	16	1	0
18	24933769	.	C	A	10	10	20	0	1	21	0	0
18	24933799	.	A	G	8	10	18	0	3	21	0	0
18	24934333	.	A	T	8	7	15	0	0	15	0	0
18	24934719	.	G	C	9	9	18	0	0	18	0	0
18	24934950	.	G	A	8	5	13	0	0	13	0	0
18	24935099	.	A	G	18	13	31	0	0	31	0	0
18	24938805	.	A	G	9	13	22	0	0	22	0	0
18	24938871	.	T	C	16	11	27	0	1	28	0	0
18	24938919	.	C	T	13	5	18	0	0	18	0	0
18	24944039	.	A	T	13	10	23	0	0	23	0	0
18	24944045	.	T	C	13	10	23	0	0	23	0	0
18	24946637	.	T	C	7	8	15	0	1	16	0	0
18	24946727	.	T	A	8	6	14	0	1	15	0	0
18	24947678	.	A	G	12	5	17	0	1	18	0	0
18	24950214	.	C	T	7	2	9	1	1	11	0	0
18	24952182	.	G	A	10	10	20	0	2	22	0	0
18	24959289	.	G	A	4	3	7	0	0	7	0	0
18	24964401	.	T	C	4	4	8	0	0	8	0	0
18	25003359	.	A	T	2	14	16	0	1	17	0	0
18	25003448	.	G	C	10	12	22	0	0	22	0	0
18	25009233	.	C	T	16	11	27	0	1	28	0	0
18	25009253	.	C	T	15	11	26	0	1	27	0	0
18	25009326	.	C	A	17	10	27	0	0	27	0	0
18	25009407	.	T	C	16	13	29	0	0	29	0	0
18	25028181	.	C	A	1	2	3	0	6	9	0	0
18	25046163	.	G	A	2	2	4	0	0	4	0	0
18	25602029	.	G	A	3	3	6	0	0	6	0	0
18	25602032	.	G	A	3	3	6	0	0	6	0	0
18	25602074	.	A	C	1	0	1	0	4	5	0	0
18	25752722	.	G	A	17	16	33	0	1	34	0	0
18	25754551	.	G	A	8	7	15	0	0	15	0	0
18	25754580	.	G	T	8	4	12	0	0	12	0	0
18	25754690	.	T	G	5	1	6	0	0	6	0	0
18	25754693	.	A	G	4	1	5	0	2	7	0	0
18	25754770	.	G	A	2	3	5	0	5	10	0	0
18	25783812	.	T	A	4	3	7	0	0	7	0	0
18	25783851	.	C	G	4	5	9	0	0	9	0	0
18	25784196	.	A	T	1	2	3	0	2	5	0	0
18	25792097	.	A	G	2	2	4	0	0	4	0	0
18	25796565	.	G	A	2	3	5	0	0	5	0	0
18	25825005	.	A	G	4	2	6	0	0	6	0	0
18	26088814	.	G	A	0	3	3	0	6	9	0	0
18	26089028	.	C	G	7	4	11	0	0	11	0	0
18	26089254	.	A	T	6	5	11	0	0	11	0	0
18	26089305	.	G	C	4	7	11	0	0	11	0	0
18	26097091	.	G	T	31	40	71	0	0	71	0	0
18	26097428	.	G	A	37	28	65	0	5	70	0	0
18	26099274	.	A	T	34	37	71	0	0	71	0	0
18	26338420	.	C	T	10	8	18	0	1	19	0	0
18	26389326	.	G	A	12	10	22	0	0	22	0	0
18	26389401	.	C	T	15	23	38	0	0	38	0	0
18	26393716	.	C	A	25	27	52	0	5	57	0	0
18	26401680	.	T	C	19	26	45	0	3	48	0	0
18	26401719	.	T	C	24	20	44	0	1	45	0	0
18	26401938	.	A	C	21	13	34	0	2	36	0	0
18	26410176	.	T	C	14	6	20	0	1	21	0	0
18	26412001	.	A	G	16	5	21	0	1	22	0	0
18	26417753	.	G	A	0	16	16	0	16	32	0	0
18	26425376	.	G	A	1	3	4	0	1	5	0	0
18	26425485	.	A	G	4	4	8	0	1	9	0	0
18	26426448	.	G	A	3	7	10	0	0	10	0	0
18	26460723	.	G	T	7	9	16	0	0	16	0	0
18	26460747	.	G	T	6	3	9	0	1	10	0	0
18	26460773	.	A	T	5	2	7	0	3	10	0	0
18	26460822	.	G	C	14	5	19	0	2	21	0	0
18	26460846	.	C	A	14	6	20	0	1	21	0	0
18	26479092	.	C	T	5	5	10	0	0	10	0	0
18	26492859	.	A	G	6	3	9	0	1	10	0	0
18	26502584	.	A	G	5	4	9	0	0	9	0	0
18	26785160	.	A	C	2	3	5	0	0	5	0	0
18	26785162	.	T	A	2	3	5	0	0	5	0	0
18	26790510	.	A	T	5	10	15	0	2	17	0	0
18	26797112	.	G	A	12	7	19	0	0	19	0	0
18	26800148	.	A	C	3	5	8	0	1	9	0	0
18	26800167	.	C	G	4	5	9	0	1	10	0	0
18	26804218	.	G	A	3	8	11	0	0	11	0	0
18	26804233	.	T	A	3	6	9	0	0	9	0	0
18	26807229	.	T	A	3	5	8	0	0	8	0	0
18	26807304	.	C	T	6	3	9	0	0	9	0	0
18	26809791	.	G	T	8	4	12	0	0	12	0	0
18	26810019	.	T	C	5	2	7	0	0	7	0	0
18	26810073	.	G	A	3	3	6	0	0	6	0	0
18	26810434	.	G	C	7	5	12	0	1	13	0	0
18	26863515	.	C	T	2	1	3	0	1	4	0	0
18	26863602	.	A	T	1	1	2	0	0	2	0	0
18	26863666	.	T	C	6	0	6	0	5	11	0	0
18	26870137	.	G	A	4	6	10	0	1	11	0	0
18	26876449	.	A	C	3	3	6	0	0	6	0	0
18	26885649	.	A	G	3	3	6	0	0	6	0	0
18	26891744	.	A	G	3	3	6	0	0	6	0	0
18	26891752	.	A	G	4	2	6	0	0	6	0	0
18	26891823	.	G	C	1	8	9	0	0	9	0	0
18	26894677	.	G	A	2	3	5	0	0	5	0	0
18	26896160	.	G	C	1	4	5	0	7	12	0	0
18	26896277	.	T	C	10	10	20	0	0	20	0	0
18	26896571	.	C	T	10	4	14	0	1	15	0	0
18	26899453	.	T	C	19	19	38	0	0	38	0	0
18	26919226	.	C	T	15	11	26	1	0	27	0	0
18	26919227	.	T	A	15	10	25	1	1	27	0	0
18	26919865	.	T	C	8	4	12	0	1	13	0	0
18	26919989	.	T	A	15	17	32	0	6	38	0	0
18	26920116	.	T	C	1	2	3	0	1	4	0	0
18	26968799	.	G	A	6	5	11	0	0	11	0	0
18	26968822	.	T	C	5	0	5	0	7	12	0	0
18	26971513	.	G	A	9	6	15	0	0	15	0	0
18	26977837	.	C	T	4	5	9	0	0	9	0	0
18	27007750	.	C	A	4	3	7	0	0	7	0	0
18	27038177	.	G	C	2	2	4	0	0	4	0	0
18	27054937	.	G	A	2	2	4	0	1	5	0	0
18	27063809	.	C	T	1	3	4	0	0	4	0	0
18	27065952	.	T	C	2	2	4	0	0	4	0	0
18	27081050	.	C	T	2	3	5	0	0	5	0	0
18	27081056	.	T	C	2	2	4	0	0	4	0	0
18	27081088	.	A	T	2	2	4	0	0	4	0	0
18	27081275	.	A	G	2	3	5	0	0	5	0	0
18	27085023	.	A	C	5	3	8	0	0	8	0	0
18	27085060	.	A	G	2	2	4	0	1	5	0	0
18	27085217	.	A	T	4	3	7	0	0	7	0	0
18	27085467	.	T	G	4	2	6	0	0	6	0	0
18	27252533	.	G	A	3	3	6	0	0	6	0	0
18	27254538	.	G	A	3	5	8	0	0	8	0	0
18	27254709	.	A	C	3	8	11	0	1	12	0	0
18	27254726	.	T	C	4	7	11	0	0	11	0	0
18	27254774	.	T	C	2	4	6	0	0	6	0	0
18	27259047	.	A	G	2	0	2	0	2	4	0	0
18	27283304	.	C	T	2	2	4	0	0	4	0	0
18	27285741	.	C	T	3	4	7	0	0	7	0	0
18	27309512	.	T	C	5	8	13	0	0	13	0	0
18	27309873	.	C	T	17	9	26	0	3	29	0	0
18	27320484	.	T	C	1	5	6	0	0	6	0	0
18	27335583	.	T	C	9	19	28	0	2	30	0	0
18	27335597	.	G	A	9	20	29	0	3	32	0	0
18	27335780	.	A	T	6	10	16	0	0	16	0	0
18	27335828	.	A	G	7	13	20	0	2	22	0	0
18	27335935	.	T	A	2	5	7	0	0	7	0	0
18	27336066	.	C	A	2	2	4	0	0	4	0	0
18	27340996	.	A	T	4	7	11	0	0	11	0	0
18	27341433	.	A	G	2	2	4	0	0	4	0	0
18	27357391	.	T	A	3	2	5	0	0	5	0	0
18	27358388	.	A	C	5	4	9	0	0	9	0	0
18	27358787	.	T	C	3	4	7	0	0	7	0	0
18	27358841	.	C	T	1	5	6	0	0	6	0	0
18	27358844	.	C	T	1	5	6	0	0	6	0	0
18	27439981	.	T	A	12	8	20	0	0	21	1	0
18	27568157	.	A	G	1	3	4	0	1	5	0	0
18	35236998	.	T	C	2	2	4	0	0	4	0	0
18	36598439	.	A	G	8	3	11	0	0	11	0	0
18	36869842	.	A	G	14	5	19	0	4	23	0	0
18	39523000	.	G	T	1	2	3	0	0	3	0	0
18	40370564	.	A	G	5	8	13	0	0	13	0	0
18	40373365	.	C	T	3	4	7	0	0	7	0	0
18	40375564	.	C	T	5	8	13	0	0	13	0	0
18	40379477	.	G	T	1	6	7	0	3	10	0	0
18	40379516	.	C	T	3	5	8	0	2	10	0	0
18	40379560	.	C	T	3	5	8	0	3	11	0	0
18	40379612	.	G	A	3	4	7	0	0	7	0	0
18	40383282	.	T	A	10	10	20	0	0	20	0	0
18	40383665	.	T	A	5	7	12	0	4	16	0	0
18	40384022	.	G	T	0	15	15	0	9	24	0	0
18	40384160	.	C	T	9	8	17	0	1	18	0	0
18	40384214	.	T	C	7	7	14	0	0	14	0	0
18	40384253	.	A	G	4	8	12	0	2	14	0	0
18	40384277	.	T	A	5	8	13	0	1	14	0	0
18	40387506	.	C	T	13	16	29	0	0	29	0	0
18	40387606	.	G	A	9	3	12	0	1	13	0	0
18	40387650	.	T	A	14	14	28	0	0	28	0	0
18	40387811	.	T	A	5	7	12	0	0	12	0	0
18	40476366	.	T	A	1	2	3	0	0	3	0	0
18	40480336	.	T	C	3	3	6	0	0	6	0	0
18	40480383	.	A	G	3	5	8	0	1	9	0	0
18	40480416	.	A	G	2	5	7	0	0	7	0	0
18	40480440	.	C	T	1	6	7	0	0	7	0	0
18	40486532	.	T	C	1	2	3	0	0	3	0	0
18	40486632	.	A	G	1	5	6	0	0	6	0	0
18	40489539	.	G	A	9	10	19	0	0	19	0	0
18	40492253	.	T	C	5	11	16	0	1	17	0	0
18	40493076	.	T	G	5	5	10	0	0	10	0	0
18	40669727	.	T	C	3	3	6	0	1	7	0	0
18	40669734	.	T	C	4	3	7	0	0	7	0	0
18	41267668	.	A	G	6	4	10	0	1	11	0	0
18	41267988	.	T	A	7	3	10	0	0	10	0	0
18	41278299	.	G	A	4	5	9	0	0	9	0	0
18	41278644	.	T	C	7	6	13	0	1	14	0	0
18	41284700	.	C	T	4	6	10	0	0	10	0	0
18	41293901	.	A	T	5	7	12	0	0	12	0	0
18	41295246	.	C	T	10	11	21	0	0	21	0	0
18	41297082	.	C	T	8	7	15	0	1	16	0	0
18	41305867	.	C	T	11	3	14	0	0	14	0	0
18	41309305	.	G	A	19	20	39	0	2	41	0	0
18	41309589	.	C	G	1	0	1	0	7	10	2	0
18	41310196	.	A	G	4	0	4	0	4	8	0	0
18	41310464	.	G	A	0	10	10	0	13	23	0	0
18	41364697	.	T	C	3	0	3	0	7	10	0	0
18	41364768	.	G	A	1	2	3	0	0	3	0	0
18	41365011	.	A	G	2	3	5	0	0	5	0	0
18	41365023	.	C	T	2	4	6	0	0	6	0	0
18	41365051	.	A	T	2	6	8	0	0	8	0	0
18	41365125	.	G	A	5	7	12	0	0	12	0	0
18	41365434	.	G	A	2	2	4	0	0	4	0	0
18	41365482	.	C	T	2	4	6	0	0	6	0	0
18	41365649	.	G	T	2	2	4	0	0	4	0	0
18	41372345	.	G	A	6	2	8	0	0	8	0	0
18	41495859	.	A	G	17	18	35	0	3	38	0	0
18	41495865	.	A	T	15	16	31	0	6	37	0	0
18	41499590	.	T	C	26	18	44	1	0	45	0	0
18	41499679	.	A	G	19	7	26	1	0	27	0	0
18	41499683	.	T	C	18	6	24	1	0	25	0	0
18	41499789	.	C	T	15	13	28	0	0	28	0	0
18	41503578	.	C	A	19	21	40	0	2	42	0	0
18	41505624	.	A	G	23	0	23	0	11	34	0	0
18	41509564	.	C	G	20	9	29	0	1	30	0	0
18	41512217	.	C	T	9	13	22	0	1	23	0	0
18	41512370	.	G	A	9	15	24	0	1	25	0	0
18	41514977	.	C	A	3	6	9	0	0	9	0	0
18	41524354	.	G	A	26	24	50	0	3	53	0	0
18	41524364	.	C	A	28	23	51	0	1	52	0	0
18	41525864	.	T	C	20	24	44	0	2	46	0	0
18	41525880	.	G	A	1	19	20	0	22	42	0	0
18	41526014	.	C	G	16	0	16	0	21	37	0	0
18	41526026	.	A	G	21	15	36	0	0	36	0	0
18	41526247	.	T	A	14	18	32	0	1	33	0	0
18	41526299	.	T	A	11	11	22	0	2	24	0	0
18	41526318	.	A	G	13	11	24	0	1	25	0	0
18	41526380	.	C	T	9	6	15	0	1	16	0	0
18	41526381	.	T	C	10	4	14	0	2	16	0	0
18	41533072	.	C	T	8	7	15	0	1	16	0	0
18	41538770	.	G	A	6	18	24	0	1	25	0	0
18	41538795	.	A	G	7	14	21	0	0	21	0	0
18	41538856	.	G	A	5	5	10	0	1	11	0	0
18	41539099	.	T	A	2	2	4	0	0	4	0	0
18	41542632	.	A	G	1	5	6	0	0	6	0	0
18	41542661	.	A	T	1	3	4	0	0	4	0	0
18	41542669	.	T	A	2	2	4	0	0	4	0	0
18	41542790	.	T	G	7	5	12	0	0	12	0	0
18	41543076	.	C	T	7	7	14	0	2	16	0	0
18	41546938	.	C	G	6	5	11	0	0	12	1	0
18	41547308	.	C	T	1	3	4	1	0	5	0	0
18	41549817	.	T	A	7	5	12	0	0	12	0	0
18	41556239	.	G	A	0	6	6	0	8	14	0	0
18	41558711	.	C	T	6	8	14	0	0	14	0	0
18	41558956	.	C	T	2	2	4	0	0	4	0	0
18	41559028	.	C	T	3	4	7	0	0	7	0	0
18	41560857	.	G	T	2	3	5	0	0	5	0	0
18	41560923	.	C	T	4	7	11	0	0	11	0	0
18	41561127	.	T	C	2	5	7	0	0	7	0	0
18	41561248	.	C	T	3	6	9	0	1	10	0	0
18	41565692	.	T	C	4	4	8	0	1	9	0	0
18	41565731	.	G	A	4	6	10	0	0	10	0	0
18	41565746	.	G	A	0	8	8	0	5	13	0	0
18	41571740	.	A	G	6	7	13	0	0	13	0	0
18	41572423	.	A	C	4	5	9	0	0	9	0	0
18	41572445	.	T	C	4	7	11	0	1	12	0	0
18	41573681	.	T	C	5	5	10	0	0	10	0	0
18	41573696	.	A	G	6	5	11	0	0	11	0	0
18	41573813	.	A	G	1	0	1	0	8	9	0	0
18	41573948	.	G	A	0	2	2	0	5	7	0	0
18	41574155	.	A	G	6	5	11	0	0	11	0	0
18	41574287	.	T	C	5	3	8	0	0	8	0	0
18	41574340	.	C	T	5	4	9	0	0	9	0	0
18	41574557	.	T	C	6	5	11	0	0	11	0	0
18	41574608	.	T	C	9	8	17	0	0	17	0	0
18	41579975	.	T	A	9	8	17	0	0	17	0	0
18	41580151	.	A	T	9	8	17	0	0	17	0	0
18	41586440	.	T	C	12	11	23	0	0	23	0	0
18	41588148	.	A	G	12	1	13	0	10	23	0	0
18	41588166	.	C	T	14	6	20	0	0	20	0	0
18	41589613	.	A	C	14	5	19	0	3	22	0	0
18	41591256	.	G	T	14	8	22	0	0	22	0	0
18	41648941	.	T	C	9	7	16	0	1	17	0	0
18	41649061	.	C	T	7	4	11	0	0	11	0	0
18	41649571	.	A	G	6	5	11	0	0	11	0	0
18	41650171	.	C	T	4	6	10	0	0	10	0	0
18	41650222	.	C	T	12	8	20	0	0	20	0	0
18	41650396	.	G	A	5	8	13	0	0	13	0	0
18	41757350	.	C	A	9	16	25	0	1	26	0	0
18	41757373	.	G	C	8	19	27	0	2	29	0	0
18	41757449	.	G	A	22	17	39	0	1	40	0	0
18	41757454	.	G	A	24	18	42	0	0	42	0	0
18	41757669	.	C	T	32	19	51	0	3	54	0	0
18	41764434	.	G	A	28	23	51	0	2	53	0	0
18	41764452	.	G	C	29	1	30	0	27	57	0	0
18	42151412	.	A	C	8	0	8	0	15	23	0	0
18	42171988	.	T	C	6	0	6	0	7	13	0	0
18	42189660	.	G	A	12	7	19	2	0	21	0	0
18	42189675	.	A	C	10	0	10	2	7	19	0	0
18	42201141	.	C	G	10	7	17	0	0	17	0	0
18	42215403	.	C	T	3	5	8	0	0	8	0	0
18	42276336	.	T	C	6	5	11	0	2	13	0	0
18	42333382	.	C	T	4	3	7	0	0	7	0	0
18	42394968	.	A	G	1	4	5	0	1	6	0	0
18	43162650	.	T	C	15	14	29	0	1	30	0	0
18	43183845	.	T	C	12	11	23	0	1	24	0	0
18	43225614	.	T	C	11	16	27	0	0	27	0	0
18	43225650	.	C	T	21	16	37	0	0	37	0	0
18	43225683	.	C	T	25	20	45	0	4	49	0	0
18	43225896	.	C	T	26	24	50	0	0	51	1	0
18	44321063	.	A	G	2	3	5	0	0	5	0	0
18	44321260	.	T	A	10	12	22	0	0	22	0	0
18	44321323	.	C	T	9	3	12	1	0	13	0	0
18	44321812	.	A	T	3	5	8	0	0	8	0	0
18	44321909	.	G	A	3	2	5	0	0	5	0	0
18	44321949	.	T	C	1	5	6	0	0	6	0	0
18	44321950	.	T	C	4	3	7	0	0	7	0	0
18	44322043	.	T	A	4	4	8	0	0	8	0	0
18	44322377	.	T	C	2	2	4	0	0	4	0	0
18	44322381	.	T	A	2	2	4	0	0	4	0	0
18	44322481	.	C	T	0	8	8	0	6	14	0	0
18	44325470	.	A	G	10	11	21	0	0	21	0	0
18	44325526	.	A	T	7	4	11	0	0	11	0	0
18	44327944	.	A	G	5	4	9	0	0	9	0	0
18	44327953	.	G	A	5	3	8	0	0	8	0	0
18	44332725	.	C	T	7	6	13	0	1	14	0	0
18	44334889	.	C	T	5	4	9	0	0	9	0	0
18	44346102	.	C	T	5	4	9	0	0	9	0	0
18	44346150	.	C	A	0	2	2	0	5	7	0	0
18	44351202	.	C	A	6	2	8	0	0	8	0	0
18	44354930	.	A	G	3	2	5	0	0	5	0	0
18	44355473	.	A	G	2	4	6	0	0	6	0	0
18	44355485	.	G	A	2	4	6	0	0	6	0	0
18	44359312	.	T	C	3	4	7	0	1	8	0	0
18	44364647	.	C	A	23	23	46	0	2	48	0	0
18	44365064	.	C	A	21	32	53	0	2	55	0	0
18	44365114	.	T	A	28	31	59	1	1	61	0	0
18	44365650	.	T	C	25	13	38	0	1	39	0	0
18	44365714	.	C	A	27	28	55	0	1	56	0	0
18	44365717	.	A	G	28	28	56	0	1	57	0	0
18	44365977	.	T	C	9	28	37	0	2	39	0	0
18	44365987	.	T	A	12	28	40	0	2	42	0	0
18	44367241	.	A	T	27	14	41	0	2	43	0	0
18	44367426	.	C	T	31	22	53	0	1	54	0	0
18	44367488	.	G	A	29	23	52	0	1	53	0	0
18	44377404	.	C	A	19	11	30	1	0	31	0	0
18	44377417	.	C	T	19	10	29	1	2	32	0	0
18	44388421	.	C	T	19	15	34	0	2	36	0	0
18	44397330	.	G	A	13	16	29	0	0	29	0	0
18	44404609	.	C	T	26	17	43	0	2	45	0	0
18	44404872	.	C	T	15	25	40	0	2	42	0	0
18	44408841	.	G	A	17	18	35	2	2	39	0	0
18	44418164	.	C	T	23	18	41	0	0	41	0	0
18	44425093	.	A	G	20	18	38	0	2	41	1	0
18	44425105	.	C	T	17	20	37	0	0	37	0	0
18	44425150	.	A	C	14	23	37	0	0	37	0	0
18	44453365	.	G	A	15	14	29	1	1	31	0	0
18	44453377	.	G	C	13	1	14	1	16	31	0	0
18	44560603	.	T	C	3	2	5	0	0	5	0	0
18	44567334	.	G	T	2	2	4	0	0	4	0	0
18	44567352	.	C	A	1	2	3	0	0	3	0	0
18	44568226	.	G	T	3	3	6	0	0	6	0	0
18	44569758	.	A	C	4	3	7	0	0	7	0	0
18	44576790	.	C	T	4	2	6	0	0	6	0	0
18	44576845	.	C	T	1	2	3	0	0	3	0	0
18	44579965	.	G	A	2	2	4	0	1	5	0	0
18	44587696	.	C	A	2	5	7	0	1	8	0	0
18	44587777	.	C	A	6	5	11	0	0	11	0	0
18	44589770	.	G	C	1	3	4	0	0	4	0	0
18	44597308	.	C	A	16	27	43	0	4	47	0	0
18	44597850	.	A	G	12	10	22	0	2	24	0	0
18	44597884	.	G	A	17	5	22	0	1	23	0	0
18	44598234	.	C	T	2	12	14	0	16	30	0	0
18	44598371	.	C	T	10	9	19	0	0	19	0	0
18	44599837	.	G	A	22	24	46	4	0	50	0	0
18	44606194	.	G	A	13	15	28	0	1	29	0	0
18	44615685	.	G	A	5	4	9	0	1	10	0	0
18	44615770	.	G	A	7	15	22	0	1	23	0	0
18	44615819	.	T	C	10	8	18	0	1	19	0	0
18	44615861	.	A	T	8	8	16	0	0	16	0	0
18	44618795	.	G	T	19	18	37	0	3	40	0	0
18	44619049	.	T	G	10	15	25	0	1	26	0	0
18	44623527	.	G	A	16	18	34	0	2	36	0	0
18	44632604	.	C	T	3	5	8	0	0	8	0	0
18	44633195	.	C	T	2	2	4	0	0	4	0	0
18	44633387	.	G	A	0	4	4	0	1	5	0	0
18	44633615	.	T	A	2	4	6	0	0	6	0	0
18	44637835	.	A	T	8	6	14	0	2	16	0	0
18	44637898	.	G	A	9	8	17	0	0	17	0	0
18	44638087	.	G	T	1	4	5	0	3	8	0	0
18	44640663	.	C	G	6	6	12	0	0	12	0	0
18	44642287	.	A	G	1	0	1	0	2	3	0	0
18	44644443	.	C	A	10	9	19	0	0	19	0	0
18	44645008	.	A	T	7	13	20	0	4	24	0	0
18	44645485	.	A	G	3	2	5	0	0	5	0	0
18	44645617	.	G	A	0	12	12	0	4	16	0	0
18	44645782	.	G	C	9	11	20	0	0	20	0	0
18	44645870	.	T	A	5	8	13	0	1	14	0	0
18	44646048	.	C	T	5	7	12	0	0	12	0	0
18	44646215	.	C	T	5	6	11	0	1	12	0	0
18	44646467	.	A	C	8	7	15	0	0	15	0	0
18	44646504	.	C	T	9	10	19	0	0	19	0	0
18	44646587	.	G	A	0	10	10	0	9	19	0	0
18	44646678	.	C	T	7	9	16	0	1	17	0	0
18	44646781	.	A	G	7	8	15	0	0	15	0	0
18	44662792	.	G	A	0	4	4	0	4	8	0	0
18	44674019	.	A	T	5	4	9	0	0	9	0	0
18	44682124	.	C	T	2	5	7	0	1	8	0	0
18	44692777	.	T	C	10	3	13	0	1	14	0	0
18	44696096	.	C	T	9	7	16	0	0	16	0	0
18	44696319	.	A	C	5	5	10	0	0	10	0	0
18	44763419	.	T	C	4	2	6	0	0	6	0	0
18	44765491	.	A	G	1	0	1	0	8	9	0	0
18	44779016	.	C	T	4	2	6	0	0	6	0	0
18	44779219	.	C	A	3	2	5	0	0	5	0	0
18	44781653	.	A	G	5	0	5	0	4	9	0	0
18	44782413	.	G	A	2	2	4	0	0	4	0	0
18	44783771	.	C	T	5	2	7	0	1	8	0	0
18	44790506	.	T	C	1	4	5	0	0	5	0	0
18	44790722	.	G	A	3	6	9	0	0	9	0	0
18	44791251	.	A	C	2	3	5	0	1	6	0	0
18	44791318	.	C	A	1	3	4	0	0	4	0	0
18	44791362	.	T	A	3	2	5	0	0	5	0	0
18	44791774	.	A	G	1	3	4	0	0	4	0	0
18	44826427	.	C	T	2	18	20	0	9	29	0	0
18	44826554	.	T	G	12	13	25	0	0	25	0	0
18	44826910	.	C	T	8	9	17	5	1	23	0	0
18	44830217	.	C	T	14	8	22	0	1	23	0	0
18	44830247	.	G	A	12	10	22	0	3	25	0	0
18	44830283	.	G	A	14	9	23	0	2	25	0	0
18	44832693	.	C	A	11	10	21	0	0	21	0	0
18	44834165	.	T	C	8	0	8	0	9	17	0	0
18	44837085	.	T	C	7	12	19	0	2	21	0	0
18	44838285	.	G	A	11	20	31	0	0	31	0	0
18	44838342	.	G	A	11	14	25	0	1	26	0	0
18	44840994	.	C	T	12	17	29	0	1	30	0	0
18	44843407	.	G	A	15	17	32	0	0	32	0	0
18	44843531	.	C	A	13	13	26	0	0	26	0	0
18	44852404	.	C	T	4	2	6	0	0	6	0	0
18	44857803	.	C	A	10	14	24	0	2	26	0	0
18	44866841	.	C	T	18	17	35	0	0	36	1	0
18	44870505	.	G	A	0	17	17	0	11	28	0	0
18	44870526	.	G	A	1	9	10	0	18	28	0	0
18	44870541	.	G	A	1	12	13	0	14	27	0	0
18	44873083	.	C	T	7	12	19	0	0	19	0	0
18	44873993	.	G	T	21	17	38	0	2	40	0	0
18	44874249	.	T	G	10	0	10	0	13	24	1	0
18	44874252	.	C	T	10	13	23	0	1	24	0	0
18	44905874	.	C	T	1	2	3	0	0	3	0	0
18	44913653	.	G	T	6	8	14	0	0	14	0	0
18	44913993	.	T	C	2	0	2	0	6	8	0	0
18	44927864	.	C	T	3	2	5	0	0	5	0	0
18	44935070	.	C	G	2	2	4	0	0	4	0	0
18	45231137	.	G	A	2	5	7	0	1	8	0	0
18	45231215	.	G	A	0	3	3	0	3	6	0	0
18	45231227	.	C	T	2	2	4	0	0	4	0	0
18	45235903	.	G	T	0	5	5	0	3	8	0	0
18	45235924	.	T	C	3	4	7	0	0	7	0	0
18	45248042	.	T	G	1	6	7	0	0	7	0	0
18	45257475	.	C	T	8	5	13	0	0	13	0	0
18	45259886	.	T	C	5	4	9	0	0	9	0	0
18	45260228	.	T	C	5	6	11	0	0	11	0	0
18	45260316	.	A	C	6	2	8	0	1	9	0	0
18	45260321	.	G	T	0	7	7	0	2	9	0	0
18	45260529	.	G	A	0	3	3	0	4	7	0	0
18	45261085	.	G	A	4	3	7	0	1	8	0	0
18	45261319	.	A	T	6	2	8	0	1	9	0	0
18	45261369	.	G	T	7	5	12	0	0	12	0	0
18	45261438	.	G	A	4	7	11	0	0	11	0	0
18	45261845	.	T	A	5	4	9	0	0	9	0	0
18	45261882	.	T	C	8	6	14	0	0	14	0	0
18	45262227	.	C	T	7	4	11	0	0	11	0	0
18	45262351	.	C	T	8	6	14	0	0	14	0	0
18	45262687	.	G	T	7	10	17	0	1	18	0	0
18	45262855	.	A	C	3	10	13	0	0	13	0	0
18	45262865	.	T	C	3	11	14	0	2	16	0	0
18	45543559	.	G	A	1	2	3	0	0	3	0	0
18	45550831	.	G	C	1	9	10	1	16	27	0	0
18	45550839	.	A	C	16	9	25	1	0	26	0	0
18	45561677	.	G	T	16	15	31	0	3	34	0	0
18	45569037	.	G	A	4	7	11	1	11	24	1	0
18	45569075	.	C	A	14	8	22	0	2	24	0	0
18	45569092	.	A	G	12	0	12	0	7	19	0	0
18	45574140	.	A	G	14	17	31	0	0	31	0	0
18	45574275	.	A	T	14	11	25	0	1	26	0	0
18	45575079	.	G	A	2	15	17	0	9	26	0	0
18	45581704	.	C	A	11	12	23	0	2	25	0	0
18	45581784	.	C	T	26	9	35	0	1	36	0	0
18	45583038	.	A	C	20	18	38	0	0	38	0	0
18	45583042	.	G	A	1	18	19	0	20	39	0	0
18	45584036	.	C	T	14	15	29	0	2	31	0	0
18	45584368	.	T	C	27	17	44	0	0	44	0	0
18	45588336	.	C	T	17	25	42	0	1	43	0	0
18	45591836	.	A	T	12	11	23	0	3	26	0	0
18	45591929	.	G	A	16	16	32	0	2	34	0	0
18	45647838	.	G	A	2	13	15	1	22	38	0	0
18	45647940	.	C	T	16	16	32	0	1	33	0	0
18	45649613	.	C	T	20	12	32	0	0	32	0	0
18	45649658	.	G	T	21	13	34	0	0	34	0	0
18	45651032	.	C	T	30	14	44	0	0	44	0	0
18	45651559	.	T	A	24	15	39	0	2	41	0	0
18	45656062	.	T	C	27	11	38	0	4	42	0	0
18	45656089	.	T	C	13	22	35	0	1	36	0	0
18	45677259	.	T	C	2	2	4	0	0	4	0	0
18	45677520	.	G	T	1	3	4	0	3	7	0	0
18	45681884	.	C	G	1	3	4	0	0	4	0	0
18	45682029	.	G	A	0	3	3	0	3	6	0	0
18	45682041	.	C	T	5	2	7	0	1	8	0	0
18	45684425	.	G	A	0	4	4	0	1	5	0	0
18	45684539	.	T	A	2	3	5	0	0	5	0	0
18	45684542	.	T	C	3	2	5	0	0	5	0	0
18	45685659	.	T	A	2	3	5	0	2	7	0	0
18	45686500	.	A	G	2	7	9	0	0	9	0	0
18	45686840	.	T	C	3	5	8	0	0	8	0	0
18	45686882	.	G	A	1	4	5	0	4	9	0	0
18	45687097	.	A	G	2	4	6	0	0	6	0	0
18	45687258	.	G	C	3	3	6	0	0	6	0	0
18	45687882	.	C	T	2	6	8	0	0	8	0	0
18	45689081	.	C	T	8	3	11	0	0	11	0	0
18	45691123	.	G	A	5	3	8	0	0	8	0	0
18	45697623	.	A	G	3	4	7	0	0	7	0	0
18	45697833	.	A	T	5	6	11	0	0	11	0	0
18	45697999	.	T	C	3	3	6	0	0	6	0	0
18	45698032	.	A	G	6	0	6	0	3	9	0	0
18	45734477	.	T	C	7	12	19	0	0	19	0	0
18	45742051	.	C	A	18	12	30	0	0	30	0	0
18	45742059	.	G	A	18	10	28	0	1	29	0	0
18	45743004	.	G	C	9	0	9	0	12	21	0	0
18	45743518	.	G	A	6	10	16	0	2	18	0	0
18	45743522	.	G	A	6	11	17	0	1	18	0	0
18	45743555	.	C	A	4	9	13	0	1	14	0	0
18	45745504	.	A	T	6	9	15	0	0	15	0	0
18	45750912	.	A	C	11	0	11	0	4	15	0	0
18	45750915	.	A	G	12	4	16	0	0	16	0	0
18	45752094	.	C	T	3	5	8	0	7	15	0	0
18	45759309	.	G	T	13	13	26	0	0	26	0	0
18	45784225	.	A	G	25	49	74	0	3	77	0	0
18	45807903	.	C	G	10	0	10	0	10	21	1	0
18	45807942	.	G	C	0	5	5	0	11	16	0	0
18	45809872	.	A	G	5	0	5	0	12	17	0	0
18	45809892	.	T	C	8	4	12	0	0	12	0	0
18	45818602	.	C	T	18	23	41	0	1	42	0	0
18	45820510	.	G	A	0	10	10	0	13	23	0	0
18	45820588	.	A	G	13	14	27	0	1	28	0	0
18	45824315	.	C	T	16	18	34	0	0	34	0	0
18	45824467	.	G	A	3	8	11	0	16	27	0	0
18	45835115	.	C	T	19	19	38	0	4	42	0	0
18	45840471	.	T	A	20	12	32	0	2	34	0	0
18	45840504	.	C	T	16	19	35	0	1	36	0	0
18	45842491	.	T	C	21	13	34	0	3	37	0	0
18	45842679	.	G	A	2	22	24	0	21	45	0	0
18	45844458	.	C	T	24	21	45	0	0	45	0	0
18	45844473	.	A	T	27	20	47	0	0	47	0	0
18	45848355	.	C	T	22	19	41	1	0	42	0	0
18	45849283	.	C	T	20	14	34	0	1	35	0	0
18	45851540	.	G	A	3	13	16	0	31	47	0	0
18	45862909	.	G	A	3	2	5	0	0	5	0	0
18	45885408	.	A	G	2	3	5	0	0	5	0	0
18	45886458	.	T	A	1	2	3	0	0	3	0	0
18	45886470	.	A	T	1	3	4	0	0	4	0	0
18	45914958	.	C	A	1	2	3	0	0	3	0	0
18	45932349	.	A	G	3	0	3	0	3	6	0	0
18	45932359	.	C	T	3	2	5	0	1	6	0	0
18	45932384	.	G	A	4	1	5	0	0	5	0	0
18	45932401	.	C	A	3	2	5	0	0	5	0	0
18	45934646	.	G	A	1	7	8	0	6	14	0	0
18	45934691	.	G	T	8	4	12	0	0	12	0	0
18	45936773	.	G	A	3	3	6	0	0	6	0	0
18	45944522	.	G	A	6	4	10	0	0	10	0	0
18	45944546	.	C	T	5	3	8	0	0	8	0	0
18	45944903	.	G	T	6	7	13	0	0	13	0	0
18	45947835	.	C	T	3	8	11	0	0	11	0	0
18	45947880	.	C	A	3	4	7	0	1	8	0	0
18	45948071	.	C	A	3	4	7	0	0	7	0	0
18	45948213	.	G	A	4	6	10	0	0	10	0	0
18	45949307	.	A	C	1	2	3	0	0	3	0	0
18	45949332	.	G	A	1	4	5	0	0	5	0	0
18	45962500	.	A	G	28	18	46	0	4	50	0	0
18	45962581	.	T	C	25	9	34	3	0	37	0	0
18	45962593	.	G	C	23	10	33	3	3	39	0	0
18	45962668	.	C	T	24	19	43	0	1	44	0	0
18	45969252	.	C	A	22	25	47	0	2	49	0	0
18	45979887	.	C	T	21	23	44	0	3	47	0	0
18	45983268	.	A	C	25	14	39	0	0	39	0	0
18	46005023	.	T	A	1	5	6	1	0	7	0	0
18	46012631	.	C	T	5	9	14	0	1	15	0	0
18	46015830	.	G	A	7	3	10	1	0	11	0	0
18	46057023	.	G	T	9	6	15	0	0	15	0	0
18	46059425	.	A	C	9	9	18	0	0	18	0	0
18	46061242	.	G	A	12	8	20	0	0	20	0	0
18	46061326	.	C	A	9	7	16	0	0	16	0	0
18	46063648	.	C	T	8	9	17	0	0	17	0	0
18	46367691	.	G	C	18	10	28	0	0	28	0	0
18	46367733	.	G	A	9	9	18	0	0	18	0	0
18	46367772	.	C	G	1	14	15	0	10	25	0	0
18	46368513	.	T	C	10	0	10	0	15	25	0	0
18	46368771	.	C	T	1	5	6	0	7	13	0	0
18	46368924	.	C	A	5	6	11	0	0	11	0	0
18	46369173	.	T	C	3	10	13	0	0	13	0	0
18	46417181	.	C	T	16	20	36	0	0	36	0	0
18	46417342	.	A	G	20	18	38	0	0	38	0	0
18	46417402	.	G	A	14	15	29	0	1	30	0	0
18	46417624	.	T	C	12	12	24	0	3	27	0	0
18	46417714	.	G	C	14	13	27	0	0	27	0	0
18	46417775	.	T	C	21	0	21	0	15	36	0	0
18	46418632	.	G	A	16	18	34	0	1	35	0	0
18	46418818	.	C	A	8	16	24	0	0	25	1	0
18	46418860	.	C	T	0	11	11	0	16	27	0	0
18	46418932	.	T	A	22	9	31	0	1	32	0	0
18	46419056	.	C	T	12	11	23	0	1	24	0	0
18	46419124	.	T	C	11	10	21	0	1	22	0	0
18	46419275	.	T	C	11	19	30	0	2	32	0	0
18	46419451	.	A	T	10	11	21	0	0	21	0	0
18	46419616	.	T	C	10	10	20	0	0	20	0	0
18	46635390	.	G	C	4	4	8	0	2	10	0	0
18	46635591	.	C	T	12	12	24	0	1	25	0	0
18	46635805	.	C	G	9	6	15	0	1	16	0	0
18	46653344	.	G	A	8	4	12	1	0	13	0	0
18	46684230	.	A	T	7	5	12	0	1	13	0	0
18	46684258	.	G	T	7	7	14	0	2	16	0	0
18	46699773	.	G	A	31	29	60	0	2	62	0	0
18	46702492	.	G	A	18	31	49	0	2	51	0	0
18	46714896	.	A	G	20	9	29	0	0	29	0	0
18	46729044	.	A	G	9	14	23	0	1	24	0	0
18	46729321	.	A	G	15	14	29	0	0	29	0	0
18	46732406	.	C	G	11	15	26	0	2	28	0	0
18	46732417	.	T	A	9	15	24	0	0	24	0	0
18	46735972	.	T	C	8	5	13	0	0	13	0	0
18	46738862	.	C	A	2	15	17	0	11	28	0	0
18	46738955	.	A	C	12	22	34	0	1	36	1	0
18	46738990	.	A	T	17	18	35	0	1	36	0	0
18	47095635	.	G	A	2	3	5	0	0	5	0	0
18	47301204	.	T	C	5	12	17	0	0	17	0	0
18	47305433	.	A	G	6	8	14	0	0	14	0	0
18	47306677	.	T	G	3	2	5	0	0	5	0	0
18	47523393	.	A	G	9	4	13	0	0	13	0	0
18	47531502	.	G	A	7	6	13	0	0	13	0	0
18	47566919	.	A	T	7	5	12	0	0	12	0	0
18	47567902	.	C	T	3	3	6	0	0	6	0	0
18	48485570	.	T	C	2	3	5	0	0	5	0	0
18	48486246	.	C	T	4	9	13	0	0	13	0	0
18	48486342	.	C	T	2	3	5	0	0	5	0	0
18	48487073	.	T	A	4	5	9	0	0	9	0	0
18	48620675	.	G	A	4	7	11	0	0	11	0	0
18	48640143	.	G	C	0	6	6	1	1	8	0	0
18	48640155	.	G	C	0	6	6	0	1	7	0	0
18	48640284	.	C	G	9	0	9	0	5	14	0	0
18	48640323	.	G	A	0	3	3	0	10	13	0	0
18	48640348	.	A	G	4	0	4	0	9	13	0	0
18	48640417	.	G	T	11	6	17	0	0	17	0	0
18	48640596	.	T	C	2	4	6	0	0	6	0	0
18	48640687	.	T	C	2	2	4	0	0	4	0	0
18	48641507	.	T	A	1	3	4	0	0	4	0	0
18	48642077	.	T	A	4	2	6	0	1	7	0	0
18	48642270	.	G	A	1	2	3	0	0	3	0	0
18	48642278	.	G	A	1	2	3	0	0	3	0	0
18	48642742	.	C	A	4	2	6	0	0	6	0	0
18	48642868	.	A	T	5	5	10	0	0	10	0	0
18	48643030	.	C	A	4	8	12	0	0	12	0	0
18	48643055	.	A	G	3	8	11	0	0	11	0	0
18	48643711	.	A	G	3	0	3	0	2	5	0	0
18	48696464	.	G	A	2	2	4	0	0	4	0	0
18	48715931	.	A	C	2	3	5	0	0	5	0	0
18	48803064	.	G	A	2	3	5	0	0	5	0	0
18	48803191	.	C	T	2	7	9	0	0	9	0	0
18	48807200	.	C	G	1	0	1	0	4	5	0	0
18	48807521	.	T	C	2	2	4	0	0	4	0	0
18	48807623	.	C	T	4	3	7	0	0	7	0	0
18	48807941	.	A	G	6	2	8	0	0	8	0	0
18	48807962	.	C	T	5	2	7	0	0	7	0	0
18	48808043	.	A	G	3	4	7	0	0	7	0	0
18	48808099	.	A	G	2	5	7	0	0	7	0	0
18	48808185	.	C	T	2	4	6	0	0	6	0	0
18	48808237	.	T	A	2	3	5	0	1	6	0	0
18	48808372	.	G	A	3	2	5	0	1	6	0	0
18	48808708	.	T	A	5	3	8	0	1	9	0	0
18	48808849	.	T	G	3	2	5	0	0	5	0	0
18	48809189	.	G	A	9	6	15	0	0	15	0	0
18	48809268	.	T	A	2	4	6	0	0	6	0	0
18	48809276	.	A	G	1	0	1	0	3	4	0	0
18	48864453	.	C	A	7	11	18	0	0	18	0	0
18	48864702	.	T	C	3	4	7	0	0	7	0	0
18	48898641	.	C	T	10	7	17	0	0	17	0	0
18	48920871	.	A	G	10	0	10	0	8	18	0	0
18	48921166	.	C	G	12	9	21	0	2	23	0	0
18	48921175	.	A	C	12	9	21	0	0	21	0	0
18	48923068	.	C	T	9	10	19	0	0	19	0	0
18	48928342	.	A	G	14	0	14	0	18	32	0	0
18	48928387	.	T	A	22	8	30	1	1	32	0	0
18	48928552	.	C	T	16	15	31	0	1	32	0	0
18	48928843	.	C	T	19	12	31	0	0	31	0	0
18	48934524	.	T	C	15	19	34	0	0	34	0	0
18	48934593	.	T	C	15	18	33	0	0	33	0	0
18	48934805	.	A	G	13	19	32	0	0	32	0	0
18	48934833	.	T	C	12	14	26	0	2	28	0	0
18	48934951	.	A	G	12	1	13	0	16	29	0	0
18	48935279	.	T	G	14	18	32	1	1	34	0	0
18	48951073	.	T	C	1	2	3	0	0	3	0	0
18	48951382	.	C	T	1	3	4	0	2	6	0	0
18	48954004	.	G	A	2	3	5	0	0	5	0	0
18	48957768	.	C	T	2	5	7	0	0	7	0	0
18	48957791	.	G	T	0	5	5	0	2	7	0	0
18	48960846	.	G	C	3	4	7	0	0	7	0	0
18	48960969	.	A	C	1	2	3	0	0	3	0	0
18	48971165	.	T	C	8	9	17	0	0	17	0	0
18	48971192	.	A	G	5	11	16	0	1	17	0	0
18	48972490	.	A	T	6	6	12	0	0	12	0	0
18	49002070	.	T	G	3	2	5	0	0	5	0	0
18	49002199	.	T	G	6	3	9	1	2	12	0	0
18	49002215	.	G	C	6	3	9	1	0	10	0	0
18	49004685	.	T	C	1	2	3	0	1	4	0	0
18	49006805	.	G	A	1	3	4	0	0	4	0	0
18	49014540	.	G	A	1	2	3	0	0	3	0	0
18	49024734	.	C	T	3	2	5	0	0	5	0	0
18	49039726	.	C	T	0	1	1	0	2	3	0	0
18	49124999	.	T	C	8	3	11	0	1	12	0	0
18	49125038	.	C	G	5	3	8	0	0	8	0	0
18	49125315	.	C	T	4	2	6	0	0	6	0	0
18	49125397	.	A	G	2	0	2	0	4	6	0	0
18	49125442	.	G	C	2	5	7	0	0	7	0	0
18	49125996	.	A	C	4	6	10	0	1	11	0	0
18	49126052	.	T	C	2	3	5	0	0	5	0	0
18	49126363	.	A	C	8	5	13	0	0	13	0	0
18	49126732	.	G	A	4	4	8	0	1	9	0	0
18	49126745	.	A	G	6	3	9	0	0	9	0	0
18	49126845	.	C	G	6	4	10	0	0	10	0	0
18	49126958	.	C	T	13	4	17	0	1	18	0	0
18	49153651	.	T	C	16	6	22	0	1	23	0	0
18	49153710	.	A	C	6	5	11	0	0	11	0	0
18	49153735	.	G	A	1	6	7	0	4	11	0	0
18	49153900	.	C	T	11	13	24	0	0	24	0	0
18	49153977	.	G	C	4	4	8	0	12	20	0	0
18	49153984	.	G	T	3	4	7	0	11	18	0	0
18	49154079	.	A	G	8	3	11	0	0	11	0	0
18	49154215	.	A	G	12	6	18	0	1	19	0	0
18	49154328	.	G	A	4	12	16	0	3	19	0	0
18	49154458	.	G	T	12	12	24	0	0	24	0	0
18	49154483	.	G	T	1	16	17	0	12	29	0	0
18	49154525	.	C	T	13	16	29	0	2	31	0	0
18	49154527	.	T	C	14	15	29	0	2	31	0	0
18	49154722	.	A	G	12	11	23	0	0	23	0	0
18	49155045	.	A	G	5	0	5	0	5	10	0	0
18	49155190	.	C	G	9	9	18	0	0	18	0	0
18	49155211	.	C	A	7	12	19	0	0	19	0	0
18	49155278	.	G	T	4	3	7	0	1	8	0	0
18	49155491	.	T	C	12	5	17	0	2	19	0	0
18	49155941	.	C	T	19	11	30	0	0	30	0	0
18	49156444	.	G	A	6	3	9	0	0	9	0	0
18	49156481	.	T	C	8	4	12	0	0	12	0	0
18	49156567	.	T	C	7	15	22	0	0	22	0	0
18	49156773	.	G	T	11	4	15	0	0	15	0	0
18	49214441	.	C	T	2	4	6	0	0	6	0	0
18	49225608	.	T	C	3	2	5	0	0	5	0	0
18	49239450	.	T	A	4	7	11	0	0	11	0	0
18	49239994	.	G	C	2	2	4	0	0	4	0	0
18	49244821	.	C	A	6	8	14	0	1	15	0	0
18	49245256	.	G	C	6	2	8	0	0	8	0	0
18	49246438	.	A	G	4	2	6	0	0	6	0	0
18	49247099	.	G	A	1	4	5	0	0	5	0	0
18	49247102	.	A	G	1	4	5	0	0	5	0	0
18	49248524	.	G	T	8	8	16	0	0	16	0	0
18	49261736	.	C	T	11	7	18	0	1	19	0	0
18	49265220	.	G	C	1	2	3	0	3	6	0	0
18	49265400	.	C	T	5	2	7	0	0	7	0	0
18	49266171	.	A	G	1	4	5	0	1	6	0	0
18	49266182	.	A	G	4	3	7	0	1	8	0	0
18	49266575	.	G	A	5	6	11	0	0	11	0	0
18	49266589	.	A	G	5	8	13	0	0	13	0	0
18	49266646	.	C	A	4	8	12	0	0	12	0	0
18	49266649	.	A	G	4	0	4	0	8	12	0	0
18	49266932	.	A	G	1	3	4	3	0	7	0	0
18	49266998	.	A	G	8	10	18	0	0	18	0	0
18	49267041	.	G	A	7	8	15	0	1	16	0	0
18	49267115	.	A	G	6	0	6	0	6	12	0	0
18	49267701	.	A	T	5	4	9	0	2	11	0	0
18	49267832	.	A	G	1	3	4	0	0	4	0	0
18	49274050	.	C	T	1	2	3	0	0	3	0	0
18	49274093	.	C	A	0	2	2	0	1	3	0	0
18	49274688	.	A	T	2	2	4	0	0	4	0	0
18	49275170	.	G	C	1	2	3	0	0	3	0	0
18	49310570	.	T	G	1	4	5	0	1	6	0	0
18	49310871	.	T	A	2	2	4	0	0	4	0	0
18	49311122	.	T	A	1	4	5	0	0	5	0	0
18	49314564	.	C	T	0	1	1	0	2	3	0	0
18	49314600	.	A	G	1	2	3	0	0	3	0	0
18	49412259	.	T	C	4	3	7	0	0	7	0	0
18	49412367	.	G	T	2	2	4	0	0	4	0	0
18	49412394	.	A	G	2	6	8	0	1	9	0	0
18	49412514	.	T	C	5	6	11	0	1	12	0	0
18	49412709	.	G	A	0	5	5	0	6	11	0	0
18	49428280	.	G	A	5	8	13	0	0	13	0	0
18	49428793	.	T	C	4	11	15	0	1	16	0	0
18	49446190	.	G	T	6	5	11	0	0	11	0	0
18	49446254	.	T	G	7	7	14	0	1	15	0	0
18	49446293	.	C	G	6	7	13	0	0	13	0	0
18	49446312	.	G	A	7	5	12	0	0	12	0	0
18	49446398	.	G	A	6	5	11	0	1	12	0	0
18	49446456	.	A	G	4	0	4	0	7	11	0	0
18	49446796	.	C	A	7	4	11	0	0	11	0	0
18	49446803	.	T	A	6	4	10	0	0	10	0	0
18	49446881	.	T	C	5	4	9	0	0	9	0	0
18	49447008	.	C	A	7	11	18	0	1	19	0	0
18	49447041	.	G	A	2	13	15	0	10	25	0	0
18	50028566	.	C	T	4	4	8	0	2	10	0	0
18	50037401	.	C	T	12	3	15	0	1	16	0	0
18	50037820	.	C	T	0	5	5	0	1	6	0	0
18	50037850	.	C	T	5	2	7	0	0	7	0	0
18	50039536	.	G	A	1	6	7	0	6	13	0	0
18	50039852	.	G	T	5	9	14	0	1	15	0	0
18	50039939	.	C	T	3	3	6	0	1	7	0	0
18	50089055	.	G	A	3	3	6	0	0	6	0	0
18	50089090	.	G	A	0	3	3	0	3	6	0	0
18	50090649	.	C	A	1	4	5	0	1	6	0	0
18	50093398	.	C	A	1	4	5	0	0	5	0	0
18	50099876	.	T	A	3	2	5	0	0	5	0	0
18	50124802	.	G	A	11	3	14	0	0	14	0	0
18	50124803	.	T	A	11	3	14	0	0	14	0	0
18	50124843	.	A	T	4	3	7	0	0	7	0	0
18	50124847	.	T	C	4	3	7	0	0	7	0	0
18	50125048	.	G	T	6	3	9	0	0	9	0	0
18	50125099	.	T	G	3	6	9	0	1	10	0	0
18	50125981	.	G	C	1	0	1	0	2	3	0	0
18	50127479	.	T	C	2	2	4	0	0	4	0	0
18	50127483	.	T	C	1	2	3	0	1	4	0	0
18	50276476	.	C	G	12	8	20	0	1	21	0	0
18	50276681	.	T	G	10	10	20	0	1	21	0	0
18	50279044	.	T	C	13	22	35	0	0	35	0	0
18	50279182	.	G	A	2	15	17	0	19	36	0	0
18	50353568	.	A	C	20	25	45	0	5	50	0	0
18	50353598	.	C	T	19	27	46	0	1	47	0	0
18	50356632	.	T	C	16	24	40	0	1	41	0	0
18	50443786	.	T	C	1	2	3	0	1	4	0	0
18	50443787	.	G	T	2	2	4	0	0	4	0	0
18	50443851	.	G	A	4	4	8	0	0	8	0	0
18	50443981	.	C	G	0	2	2	0	2	4	0	0
18	50537645	.	A	G	14	2	16	1	0	17	0	0
18	50538289	.	T	C	17	6	23	0	2	25	0	0
18	50538340	.	T	C	7	11	18	0	2	20	0	0
18	50688774	.	A	G	0	2	2	0	0	2	0	0
18	50689577	.	T	C	3	4	7	1	1	9	0	0
18	50689583	.	G	A	4	0	4	0	1	5	0	0
18	50709147	.	C	A	1	2	3	0	15	18	0	0
18	50823328	.	G	A	0	12	12	0	2	14	0	0
18	50911943	.	C	G	9	4	13	3	1	17	0	0
18	50911951	.	T	C	4	9	13	3	0	16	0	0
19	372768	.	A	G	10	0	10	0	9	19	0	0
19	372777	.	A	G	5	10	15	0	0	15	0	0
19	433665	.	T	C	4	3	7	0	0	7	0	0
19	1009031	.	C	T	0	6	6	0	3	9	0	0
19	1185281	.	G	A	5	5	10	0	0	10	0	0
19	1618967	.	G	A	1	4	5	0	1	6	0	0
19	1855354	.	A	G	1	1	2	0	3	5	0	0
19	1953569	.	A	G	2	50	52	0	1	53	0	0
19	2000142	.	C	G	4	4	8	0	0	8	0	0
19	2001557	.	T	C	2	4	6	0	1	7	0	0
19	2001618	.	A	C	6	8	14	0	0	14	0	0
19	2002992	.	A	G	5	0	5	0	5	10	0	0
19	2003150	.	T	C	5	5	10	0	1	11	0	0
19	2003158	.	C	T	4	6	10	0	0	10	0	0
19	2003634	.	T	C	5	4	9	0	2	11	0	0
19	2003767	.	C	T	9	5	14	0	0	14	0	0
19	2003803	.	C	G	8	0	8	0	4	12	0	0
19	2003902	.	A	T	9	5	14	0	0	14	0	0
19	2003962	.	G	T	0	8	8	0	12	20	0	0
19	2004046	.	G	C	6	11	17	0	0	17	0	0
19	2019147	.	C	T	0	8	8	0	9	17	0	0
19	2019430	.	G	A	12	8	20	0	0	20	0	0
19	2019480	.	C	T	1	6	7	0	7	14	0	0
19	2028006	.	T	C	2	3	5	0	0	5	0	0
19	2064629	.	G	A	2	3	5	0	0	5	0	0
19	2064762	.	G	C	3	3	6	0	0	6	0	0
19	2071597	.	T	C	1	2	3	0	1	4	0	0
19	2071672	.	A	G	6	3	9	0	0	9	0	0
19	2079996	.	A	G	3	3	6	0	0	6	0	0
19	2083254	.	C	T	1	4	5	0	0	5	0	0
19	2084982	.	G	A	2	4	6	0	0	6	0	0
19	2279284	.	C	T	5	5	10	0	0	10	0	0
19	2292831	.	T	C	4	3	7	0	0	7	0	0
19	2294971	.	G	C	4	4	8	0	1	9	0	0
19	2296760	.	A	T	8	8	16	0	0	16	0	0
19	2307248	.	C	A	6	8	14	0	1	15	0	0
19	2307268	.	C	T	7	5	12	0	0	12	0	0
19	2315511	.	C	T	0	2	2	1	3	6	0	0
19	2315531	.	G	C	0	4	4	0	0	4	0	0
19	2315666	.	A	G	4	3	7	0	0	7	0	0
19	2315752	.	A	T	8	6	14	0	0	14	0	0
19	2315936	.	C	T	3	4	7	0	0	7	0	0
19	2315961	.	G	A	3	3	6	0	0	6	0	0
19	2316510	.	T	C	2	4	6	0	0	6	0	0
19	2316765	.	T	C	2	4	6	0	0	6	0	0
19	2316894	.	T	C	2	2	4	0	0	4	0	0
19	2396492	.	C	A	2	7	9	0	0	9	0	0
19	2397559	.	T	C	3	3	6	0	2	8	0	0
19	2400403	.	G	A	6	4	10	0	0	10	0	0
19	2402609	.	T	A	1	6	7	0	0	7	0	0
19	2402611	.	T	A	1	6	7	0	0	7	0	0
19	2403804	.	C	G	6	2	8	0	0	8	0	0
19	2403807	.	C	T	3	5	8	0	0	8	0	0
19	2403906	.	T	C	1	0	1	0	2	3	0	0
19	2420904	.	G	A	2	2	4	0	0	4	0	0
19	2421147	.	G	A	1	2	3	1	0	4	0	0
19	2546871	.	T	A	4	6	10	0	0	10	0	0
19	2547046	.	C	T	2	4	6	0	0	6	0	0
19	2550676	.	G	A	8	4	12	0	1	13	0	0
19	2550839	.	C	T	8	6	14	0	1	15	0	0
19	2551178	.	A	G	15	6	21	0	0	21	0	0
19	2551214	.	C	T	11	5	16	0	0	16	0	0
19	2551727	.	C	T	7	9	16	0	0	16	0	0
19	2560950	.	A	G	6	9	15	0	0	15	0	0
19	2561048	.	A	C	7	5	12	0	0	12	0	0
19	2561739	.	G	A	3	10	13	0	8	21	0	0
19	2562198	.	T	C	4	3	7	0	0	7	0	0
19	2570645	.	A	T	2	2	4	0	0	4	0	0
19	2570654	.	G	A	2	3	5	0	0	5	0	0
19	2575308	.	A	G	1	3	4	0	0	4	0	0
19	2602934	.	G	A	4	9	13	0	1	14	0	0
19	2645115	.	C	T	5	8	13	0	1	14	0	0
19	2651272	.	A	G	3	7	10	1	1	12	0	0
19	2651344	.	G	A	1	16	17	0	3	20	0	0
19	2654388	.	A	T	9	9	18	0	3	21	0	0
19	2654424	.	C	T	8	11	19	0	0	19	0	0
19	2663609	.	A	G	9	16	25	0	1	26	0	0
19	2664125	.	G	A	1	6	7	0	1	8	0	0
19	2664394	.	C	T	15	6	21	0	0	21	0	0
19	2685839	.	T	C	1	3	4	0	0	4	0	0
19	2695030	.	T	C	16	20	36	0	2	38	0	0
19	2695314	.	G	A	6	13	19	0	0	19	0	0
19	2695351	.	A	G	6	0	6	0	8	14	0	0
19	2695358	.	G	A	5	5	10	0	0	10	0	0
19	2731100	.	C	T	7	11	18	0	0	18	0	0
19	2732833	.	C	T	12	11	23	0	0	23	0	0
19	2732836	.	G	A	13	11	24	0	0	24	0	0
19	2744169	.	C	G	8	4	12	0	0	12	0	0
19	2746008	.	G	A	1	9	10	0	15	26	1	0
19	2746134	.	C	T	16	15	31	0	0	31	0	0
19	2750162	.	G	A	2	12	14	0	16	30	0	0
19	2750973	.	C	T	8	9	17	0	1	18	0	0
19	2857849	.	T	C	1	2	3	0	0	3	0	0
19	2871511	.	A	G	8	3	11	0	0	11	0	0
19	2871553	.	C	T	8	7	15	0	0	15	0	0
19	2871559	.	G	A	8	7	15	0	2	17	0	0
19	2874618	.	T	C	6	4	10	0	0	10	0	0
19	2877359	.	C	T	2	4	6	0	0	6	0	0
19	2877371	.	C	T	2	4	6	0	0	6	0	0
19	2880138	.	C	T	1	2	3	0	1	4	0	0
19	2886952	.	G	A	4	5	9	0	0	9	0	0
19	2887046	.	G	C	0	3	3	0	2	5	0	0
19	2930597	.	A	G	7	5	12	0	0	12	0	0
19	2934321	.	A	G	3	4	7	0	0	7	0	0
19	2967894	.	A	G	4	4	8	0	0	8	0	0
19	3001601	.	C	A	2	2	4	0	0	4	0	0
19	3009193	.	C	A	3	2	5	0	0	5	0	0
19	3009196	.	C	A	3	3	6	0	0	6	0	0
19	3037074	.	G	A	4	3	7	0	0	7	0	0
19	3037075	.	G	C	4	3	7	0	0	7	0	0
19	3037184	.	T	C	2	4	6	0	0	6	0	0
19	3037186	.	T	A	2	4	6	0	0	6	0	0
19	3053041	.	C	T	4	2	6	0	0	6	0	0
19	3056629	.	C	T	3	9	12	0	0	12	0	0
19	3080477	.	A	G	10	5	15	0	0	15	0	0
19	3080712	.	T	A	6	7	13	0	1	14	0	0
19	3080907	.	A	T	10	4	14	0	1	15	0	0
19	3080938	.	A	G	4	4	8	0	1	9	0	0
19	3081154	.	G	C	6	4	10	0	0	10	0	0
19	3081206	.	G	T	8	4	12	0	0	12	0	0
19	3081605	.	A	G	8	6	14	2	1	17	0	0
19	3081628	.	T	C	7	4	11	2	0	13	0	0
19	3081704	.	A	G	1	3	4	0	0	5	1	0
19	3081718	.	A	G	4	0	4	0	4	8	0	0
19	3081927	.	G	A	8	5	13	0	0	13	0	0
19	3081933	.	G	A	2	5	7	0	7	14	0	0
19	3082102	.	C	T	10	6	16	0	0	16	0	0
19	3087025	.	A	G	2	6	8	0	1	9	0	0
19	3087180	.	C	A	0	2	2	0	1	3	0	0
19	3093504	.	G	A	1	2	3	0	0	3	0	0
19	3137727	.	C	T	3	37	40	0	24	64	0	0
19	3137761	.	C	A	30	28	58	0	3	62	1	0
19	3137803	.	A	T	38	18	56	0	8	64	0	0
19	3137888	.	T	C	30	0	30	0	29	59	0	0
19	3138325	.	A	C	28	19	47	0	4	51	0	0
19	3138355	.	T	G	30	17	47	0	3	50	0	0
19	3138638	.	T	C	21	0	21	0	20	41	0	0
19	3142240	.	T	C	23	20	43	0	0	43	0	0
19	3142260	.	T	C	25	0	25	0	20	45	0	0
19	3142286	.	C	G	23	20	43	1	1	45	0	0
19	3144567	.	A	G	26	18	44	0	1	45	0	0
19	3144841	.	T	A	24	16	40	0	1	41	0	0
19	3144859	.	C	T	18	21	39	0	3	42	0	0
19	3149296	.	A	C	18	16	34	0	1	35	0	0
19	3149320	.	T	G	13	14	27	0	2	29	0	0
19	3149368	.	A	T	13	11	24	0	0	24	0	0
19	3149515	.	T	C	3	6	9	0	0	9	0	0
19	3149516	.	T	C	2	0	2	0	7	9	0	0
19	3149692	.	A	G	10	6	16	0	0	16	0	0
19	3152069	.	C	T	0	7	7	0	5	12	0	0
19	3152091	.	A	T	5	7	12	0	0	12	0	0
19	3152108	.	T	A	2	7	9	0	0	9	0	0
19	3163598	.	C	A	1	3	4	0	0	4	0	0
19	3206382	.	G	A	16	17	33	0	3	36	0	0
19	3215468	.	A	G	15	14	29	0	0	29	0	0
19	3222241	.	G	A	5	14	19	0	1	20	0	0
19	3229424	.	A	G	16	19	35	0	0	35	0	0
19	3238395	.	T	A	26	19	45	0	1	46	0	0
19	3238425	.	T	C	23	21	44	0	1	45	0	0
19	3238721	.	T	A	26	35	61	0	1	62	0	0
19	3240409	.	G	C	34	22	56	1	2	59	0	0
19	3376893	.	G	C	3	1	4	0	2	6	0	0
19	3379718	.	A	G	3	2	5	0	0	5	0	0
19	3379817	.	G	A	2	2	4	0	0	4	0	0
19	3386258	.	T	A	8	17	25	0	0	25	0	0
19	3386358	.	A	G	12	11	23	0	4	27	0	0
19	3386485	.	C	A	9	16	25	0	1	26	0	0
19	3386580	.	T	A	7	4	11	0	0	11	0	0
19	3386873	.	C	T	10	11	21	0	6	27	0	0
19	3387040	.	C	A	7	14	21	0	15	36	0	0
19	3387068	.	A	C	15	14	29	0	4	33	0	0
19	3387097	.	C	G	15	20	35	0	1	36	0	0
19	3387506	.	G	A	19	21	40	0	3	43	0	0
19	3387713	.	G	A	28	22	50	0	0	50	0	0
19	3388376	.	T	C	20	20	40	0	0	40	0	0
19	3388467	.	T	C	25	19	44	0	1	45	0	0
19	3388617	.	G	A	14	14	28	0	0	28	0	0
19	3390203	.	G	A	14	18	32	0	1	33	0	0
19	3390283	.	G	T	9	11	20	0	0	20	0	0
19	3390506	.	C	G	11	20	31	0	1	32	0	0
19	3391479	.	G	A	10	7	17	0	0	17	0	0
19	3391530	.	G	T	11	12	23	0	2	25	0	0
19	3391608	.	T	A	11	6	17	0	0	17	0	0
19	3391669	.	A	G	10	11	21	0	1	22	0	0
19	3391805	.	T	G	11	24	35	0	1	36	0	0
19	3392127	.	G	A	9	11	20	0	0	20	0	0
19	3392178	.	C	T	8	5	13	0	0	13	0	0
19	3392415	.	G	T	12	10	22	0	0	22	0	0
19	3392481	.	A	G	11	13	24	0	0	25	1	0
19	3393128	.	A	T	12	13	25	0	0	25	0	0
19	3393343	.	G	C	12	10	22	0	1	23	0	0
19	3393437	.	T	A	7	6	13	0	2	15	0	0
19	3393924	.	G	A	12	9	21	0	0	21	0	0
19	3395277	.	C	G	1	4	5	0	8	13	0	0
19	3395435	.	C	T	5	5	10	0	0	10	0	0
19	3395457	.	T	A	6	4	10	0	0	10	0	0
19	3395523	.	G	A	9	5	14	0	0	14	0	0
19	3395763	.	T	A	5	12	17	0	0	17	0	0
19	3395889	.	A	G	8	8	16	0	0	16	0	0
19	3396103	.	A	G	4	5	9	0	0	9	0	0
19	3396288	.	T	C	5	6	11	0	0	11	0	0
19	3396338	.	T	C	6	0	6	0	6	12	0	0
19	3540280	.	G	C	2	2	4	0	0	4	0	0
19	3573971	.	A	G	2	5	7	0	2	9	0	0
19	3577907	.	C	A	1	2	3	0	0	3	0	0
19	3577953	.	A	C	2	3	5	0	0	5	0	0
19	3578157	.	A	G	1	3	4	0	0	4	0	0
19	3578162	.	T	C	1	3	4	0	0	4	0	0
19	3653989	.	C	T	2	3	5	0	0	5	0	0
19	3654052	.	T	A	5	6	11	0	0	11	0	0
19	3681077	.	T	C	3	5	8	0	1	9	0	0
19	3681134	.	C	T	6	5	11	0	0	11	0	0
19	3698060	.	A	G	4	3	7	0	1	8	0	0
19	3698249	.	C	G	3	4	7	0	0	7	0	0
19	3702476	.	A	T	2	3	5	0	1	6	0	0
19	3702509	.	G	C	1	2	3	0	4	7	0	0
19	3702941	.	G	A	1	5	6	0	7	13	0	0
19	3703149	.	A	G	8	3	11	0	0	11	0	0
19	3703178	.	C	T	4	9	13	0	0	13	0	0
19	3706875	.	C	T	2	2	4	0	0	4	0	0
19	3706902	.	C	G	2	0	2	0	4	6	0	0
19	3707235	.	A	G	7	10	17	0	1	18	0	0
19	3707334	.	G	A	3	7	10	0	0	10	0	0
19	3707562	.	T	A	3	1	4	0	0	4	0	0
19	3707576	.	C	T	3	2	5	0	0	5	0	0
19	3707625	.	G	A	1	5	6	0	5	11	0	0
19	3718110	.	A	T	19	9	28	0	1	29	0	0
19	3718222	.	G	A	13	16	29	0	3	32	0	0
19	3718251	.	C	A	16	17	33	0	1	34	0	0
19	3718330	.	G	A	16	26	42	0	0	42	0	0
19	3718415	.	G	T	18	20	38	0	2	41	1	0
19	3718675	.	C	A	25	16	41	0	1	42	0	0
19	3865928	.	C	T	1	15	16	0	10	26	0	0
19	3866029	.	C	T	8	18	26	0	0	26	0	0
19	3866031	.	G	A	8	18	26	0	0	26	0	0
19	3866075	.	T	C	14	15	29	0	0	29	0	0
19	3866102	.	A	G	13	18	31	0	0	31	0	0
19	3866165	.	T	C	17	9	26	0	3	29	0	0
19	3866179	.	T	C	16	0	16	0	7	23	0	0
19	3866206	.	T	A	10	4	14	0	0	14	0	0
19	3866289	.	C	G	9	11	20	0	0	20	0	0
19	3866424	.	A	T	14	14	28	0	4	32	0	0
19	3866727	.	C	T	1	7	8	0	19	27	0	0
19	3868535	.	T	C	8	20	28	0	3	31	0	0
19	3868541	.	C	T	0	18	18	0	12	30	0	0
19	3872386	.	G	A	7	5	12	0	1	13	0	0
19	3872419	.	C	T	8	8	16	0	1	17	0	0
19	3872833	.	C	T	17	5	22	0	1	23	0	0
19	3873019	.	C	T	14	14	28	0	1	29	0	0
19	3873055	.	C	T	13	11	24	0	0	24	0	0
19	3873847	.	A	C	6	9	15	0	1	16	0	0
19	3873955	.	G	A	8	15	23	0	0	23	0	0
19	3874195	.	A	G	15	8	23	0	0	23	0	0
19	3874277	.	C	A	7	9	16	0	0	16	0	0
19	3874339	.	G	A	7	5	12	0	0	12	0	0
19	3874381	.	G	A	8	6	14	0	0	14	0	0
19	3876226	.	T	G	9	2	11	0	1	12	0	0
19	3876227	.	C	T	0	2	2	0	10	12	0	0
19	3876296	.	C	T	6	9	15	1	1	17	0	0
19	3878548	.	C	T	7	11	18	0	0	18	0	0
19	3878565	.	G	C	4	9	13	0	0	13	0	0
19	3937971	.	T	C	18	31	49	0	6	55	0	0
19	3939887	.	C	T	33	17	50	0	1	51	0	0
19	3939902	.	G	T	33	17	50	0	3	53	0	0
19	3940022	.	C	T	1	15	16	0	31	47	0	0
19	3945750	.	G	T	26	22	48	0	5	53	0	0
19	4010175	.	C	A	9	12	21	1	3	25	0	0
19	4024467	.	T	C	1	5	6	0	0	6	0	0
19	4089974	.	T	C	7	5	12	0	1	13	0	0
19	4090283	.	C	T	5	3	8	0	0	8	0	0
19	4090292	.	A	T	4	3	7	0	0	7	0	0
19	4092828	.	G	A	1	1	2	0	0	2	0	0
19	4092834	.	G	A	1	2	3	0	0	3	0	0
19	4127217	.	G	A	3	4	7	0	0	7	0	0
19	4127286	.	T	C	3	3	6	0	0	6	0	0
19	4128384	.	C	T	2	3	5	0	0	5	0	0
19	4128405	.	C	T	1	2	3	0	0	3	0	0
19	4142777	.	G	A	1	5	6	0	0	6	0	0
19	4142918	.	A	G	3	0	3	0	4	7	0	0
19	4143053	.	A	T	2	5	7	0	0	7	0	0
19	4160385	.	T	C	5	2	7	0	0	7	0	0
19	4160401	.	T	C	4	2	6	0	0	6	0	0
19	4194072	.	T	C	6	8	14	0	1	15	0	0
19	4279835	.	A	C	5	3	8	0	0	8	0	0
19	4291716	.	C	T	4	5	9	0	0	9	0	0
19	4341539	.	T	C	10	7	17	0	0	17	0	0
19	4443334	.	T	C	7	6	13	0	1	14	0	0
19	4443403	.	T	C	7	12	19	0	0	19	0	0
19	4445154	.	T	C	5	8	13	0	0	13	0	0
19	4445317	.	T	C	2	4	6	0	0	6	0	0
19	4445329	.	T	A	3	3	6	0	0	6	0	0
19	4445782	.	A	G	5	2	7	0	0	7	0	0
19	4447236	.	C	T	6	2	8	0	0	8	0	0
19	4447347	.	G	A	7	2	9	0	0	9	0	0
19	4447403	.	A	T	10	3	13	0	0	13	0	0
19	4447502	.	T	A	9	5	14	0	0	14	0	0
19	4447683	.	T	G	2	0	2	0	3	5	0	0
19	4463452	.	G	A	1	2	3	0	0	3	0	0
19	4463460	.	C	T	0	2	2	0	1	3	0	0
19	4463535	.	C	T	2	3	5	0	1	6	0	0
19	4828379	.	T	G	2	8	10	0	0	10	0	0
19	4828395	.	T	C	1	7	8	0	0	8	0	0
19	4828428	.	A	T	4	4	8	0	0	8	0	0
19	4828463	.	A	G	3	4	7	0	0	7	0	0
19	4828464	.	A	T	3	4	7	0	0	7	0	0
19	4828696	.	G	A	2	3	5	0	0	5	0	0
19	4828967	.	G	T	1	4	5	0	1	6	0	0
19	4833274	.	A	G	2	2	4	0	0	4	0	0
19	4840428	.	A	C	1	0	1	0	5	6	0	0
19	4857547	.	G	A	8	8	16	0	2	18	0	0
19	4857910	.	A	G	13	7	20	0	0	20	0	0
19	4857967	.	T	C	6	10	16	0	0	16	0	0
19	4866919	.	T	C	15	10	25	0	2	27	0	0
19	4867128	.	C	T	13	9	22	0	5	27	0	0
19	4867132	.	G	A	3	12	15	0	10	25	0	0
19	4875595	.	A	G	12	6	18	0	0	18	0	0
19	4877141	.	T	C	15	5	20	0	0	20	0	0
19	4878742	.	G	T	9	5	14	0	1	15	0	0
19	4878751	.	C	T	6	10	16	0	0	16	0	0
19	4881345	.	G	T	13	8	21	0	0	21	0	0
19	4888756	.	G	A	0	8	8	0	12	20	0	0
19	4892154	.	G	A	17	14	31	0	1	32	0	0
19	4892530	.	G	T	3	16	19	0	17	36	0	0
19	4892946	.	A	T	5	8	13	0	1	14	0	0
19	4903907	.	C	T	14	10	24	0	0	24	0	0
19	4903971	.	A	T	10	14	24	0	1	26	1	0
19	4904041	.	C	T	10	8	18	0	2	20	0	0
19	4904042	.	A	T	8	6	14	0	4	18	0	0
19	4904467	.	G	A	4	3	7	0	0	7	0	0
19	4904529	.	T	A	1	4	5	0	0	5	0	0
19	4904569	.	T	C	4	4	8	0	0	8	0	0
19	4905088	.	G	T	12	4	16	0	0	16	0	0
19	4905239	.	C	T	6	6	12	0	0	12	0	0
19	4912828	.	T	C	0	1	1	0	0	1	0	0
19	4912841	.	G	A	3	3	6	0	0	6	0	0
19	4951138	.	C	T	6	5	11	2	1	14	0	0
19	4951183	.	C	A	6	4	10	2	4	16	0	0
19	4960897	.	C	T	6	3	9	0	0	9	0	0
19	4960903	.	A	G	6	3	9	0	0	9	0	0
19	4961950	.	A	T	8	13	21	0	0	21	0	0
19	4961977	.	A	T	8	13	21	0	0	21	0	0
19	4962019	.	C	T	7	9	16	0	1	17	0	0
19	4962109	.	A	G	2	4	6	0	0	6	0	0
19	4970776	.	C	T	13	7	20	0	1	21	0	0
19	4973136	.	G	A	0	3	3	0	5	8	0	0
19	4976906	.	C	T	6	7	13	0	0	13	0	0
19	4976925	.	C	G	6	6	12	0	1	13	0	0
19	4977053	.	A	G	5	0	5	0	5	10	0	0
19	4978660	.	G	T	5	5	10	0	0	10	0	0
19	4978716	.	A	G	3	3	6	0	0	6	0	0
19	4981062	.	C	A	4	4	8	0	0	8	0	0
19	4984668	.	T	G	3	4	7	0	0	7	0	0
19	4984739	.	G	A	10	4	14	0	1	15	0	0
19	4985181	.	G	A	1	2	3	0	1	4	0	0
19	4998412	.	C	T	1	3	4	0	0	4	0	0
19	5000997	.	A	T	4	3	7	0	0	7	0	0
19	5001119	.	C	T	1	13	14	0	23	37	0	0
19	5003359	.	T	G	22	21	43	0	0	43	0	0
19	5007465	.	G	A	11	20	31	0	0	31	0	0
19	5007549	.	G	A	14	18	32	0	0	32	0	0
19	5009353	.	G	A	14	17	31	0	0	32	1	0
19	5009489	.	G	A	15	14	29	0	0	29	0	0
19	5016257	.	G	C	14	0	14	0	10	24	0	0
19	5018307	.	A	G	15	10	25	0	0	25	0	0
19	5019697	.	G	C	14	6	20	0	0	20	0	0
19	5019712	.	A	T	16	4	20	0	0	20	0	0
19	5019736	.	A	G	13	9	22	0	0	22	0	0
19	5022301	.	C	T	12	9	21	0	2	23	0	0
19	5024424	.	G	A	9	8	17	0	0	17	0	0
19	5024436	.	C	T	9	4	13	0	2	15	0	0
19	5024541	.	C	T	9	11	20	0	1	21	0	0
19	5024685	.	T	C	9	5	14	0	2	16	0	0
19	5025813	.	T	C	6	0	6	0	10	16	0	0
19	5030032	.	T	C	9	9	18	0	0	18	0	0
19	5030214	.	G	T	5	9	14	0	1	15	0	0
19	5030274	.	G	A	7	5	12	0	0	12	0	0
19	5031455	.	A	C	4	5	9	0	1	10	0	0
19	5031461	.	G	A	6	5	11	0	0	11	0	0
19	5034965	.	G	A	9	6	15	0	0	15	0	0
19	5035253	.	G	A	3	7	10	0	0	10	0	0
19	5037382	.	T	C	5	0	5	0	9	14	0	0
19	5048361	.	T	C	2	3	5	0	0	5	0	0
19	5048954	.	T	A	8	8	16	0	0	16	0	0
19	5054876	.	C	T	6	2	8	0	0	8	0	0
19	5058188	.	C	T	0	5	5	0	8	13	0	0
19	5058763	.	G	A	4	3	7	0	0	7	0	0
19	5077167	.	A	G	32	27	59	0	2	61	0	0
19	5077173	.	C	T	26	34	60	0	2	62	0	0
19	5081758	.	T	C	26	27	53	1	3	57	0	0
19	5089900	.	C	G	43	3	46	0	25	71	0	0
19	5090035	.	C	G	23	22	45	0	1	46	0	0
19	5091587	.	G	C	26	21	47	1	1	49	0	0
19	5091769	.	G	T	3	3	6	0	0	6	0	0
19	5094389	.	C	T	5	6	11	0	1	12	0	0
19	5094405	.	C	A	1	6	7	0	8	15	0	0
19	5094471	.	T	C	10	11	21	0	0	21	0	0
19	5094504	.	A	G	11	12	23	0	0	23	0	0
19	5094591	.	C	T	13	13	26	0	1	27	0	0
19	5094616	.	C	T	3	14	17	0	14	31	0	0
19	5100191	.	G	A	15	18	33	0	0	33	0	0
19	5135247	.	T	G	17	9	26	0	1	27	0	0
19	5135258	.	C	G	17	7	24	0	0	24	0	0
19	5144107	.	C	T	5	4	9	0	0	9	0	0
19	5146708	.	C	T	12	16	28	0	1	29	0	0
19	5149867	.	C	T	13	15	28	0	0	28	0	0
19	5158572	.	G	A	28	33	61	3	5	69	0	0
19	5158657	.	G	A	38	35	73	0	6	79	0	0
19	5158795	.	A	G	39	33	72	0	6	78	0	0
19	5159120	.	C	T	42	32	74	1	6	81	0	0
19	5159399	.	T	A	30	30	60	0	2	62	0	0
19	5160048	.	C	G	33	33	66	0	7	73	0	0
19	5160121	.	T	C	32	1	33	0	26	59	0	0
19	5160133	.	C	A	1	29	30	0	28	58	0	0
19	5160201	.	A	G	33	22	55	1	4	60	0	0
19	5160302	.	T	C	35	0	35	0	13	48	0	0
19	5160310	.	C	T	4	16	20	0	33	53	0	0
19	5160379	.	T	A	40	15	55	0	1	56	0	0
19	5160996	.	A	T	26	22	48	2	1	51	0	0
19	5161750	.	A	G	22	26	48	0	5	53	0	0
19	5162521	.	G	A	29	23	52	0	1	53	0	0
19	5162679	.	A	G	29	20	49	0	2	51	0	0
19	5163409	.	G	A	29	23	52	0	1	53	0	0
19	5163910	.	T	C	27	35	62	0	1	63	0	0
19	5300108	.	T	G	7	5	12	0	0	12	0	0
19	5300120	.	T	C	7	7	14	0	0	14	0	0
19	5302286	.	A	G	6	2	8	0	3	11	0	0
19	5302463	.	A	C	3	6	9	0	0	9	0	0
19	5305193	.	T	C	7	6	13	0	1	14	0	0
19	5305418	.	A	G	5	8	13	0	1	14	0	0
19	5305530	.	A	G	4	2	6	0	0	6	0	0
19	5305870	.	G	C	5	10	15	0	0	15	0	0
19	5316439	.	T	C	12	12	24	1	0	25	0	0
19	5611772	.	G	A	17	22	39	0	4	43	0	0
19	5611856	.	A	T	24	17	41	0	1	42	0	0
19	5619892	.	G	A	15	9	24	0	0	24	0	0
19	5619926	.	G	A	1	13	14	0	10	24	0	0
19	5620094	.	A	T	12	8	20	0	3	23	0	0
19	5620175	.	T	G	8	9	17	0	1	18	0	0
19	5620208	.	G	T	11	12	23	0	0	23	0	0
19	5620370	.	T	C	14	19	33	0	1	34	0	0
19	5620419	.	G	A	13	19	32	0	1	33	0	0
19	5620459	.	T	C	16	15	31	0	0	31	0	0
19	5620636	.	T	G	19	7	26	0	1	27	0	0
19	5620640	.	G	T	14	12	26	0	1	27	0	0
19	5621165	.	G	A	16	12	28	0	1	29	0	0
19	5621269	.	C	T	7	3	10	0	0	10	0	0
19	5779151	.	A	G	2	2	4	0	0	4	0	0
19	5779170	.	C	T	5	4	9	0	0	9	0	0
19	5779271	.	A	G	10	9	19	0	0	19	0	0
19	5779829	.	G	T	10	9	19	0	0	19	0	0
19	5779835	.	C	T	10	9	19	0	0	19	0	0
19	5779897	.	T	C	12	14	26	0	0	26	0	0
19	5780032	.	C	G	0	6	6	0	11	18	1	0
19	5780293	.	A	T	14	10	24	0	0	24	0	0
19	5780312	.	A	T	8	12	20	0	3	23	0	0
19	5780429	.	C	A	2	2	4	2	0	6	0	0
19	5780585	.	G	T	4	7	11	0	0	11	0	0
19	5780989	.	G	A	7	6	13	2	0	15	0	0
19	5781259	.	A	T	8	6	14	0	0	14	0	0
19	5781316	.	G	T	5	5	10	0	1	11	0	0
19	5781367	.	T	C	6	11	17	0	0	17	0	0
19	5793484	.	C	G	5	6	11	0	0	11	0	0
19	5793532	.	T	C	5	10	15	0	0	15	0	0
19	5801151	.	G	A	10	6	16	0	2	18	0	0
19	5805833	.	G	A	4	10	14	0	0	14	0	0
19	5805839	.	G	A	5	9	14	0	0	14	0	0
19	5849563	.	T	G	0	0	0	0	3	3	0	0
19	6060281	.	T	A	10	14	24	0	0	24	0	0
19	6060309	.	A	T	14	13	27	0	2	29	0	0
19	6060415	.	C	A	1	9	10	0	9	19	0	0
19	6076813	.	C	A	5	4	9	0	0	9	0	0
19	6085957	.	A	T	8	8	16	0	1	17	0	0
19	6086441	.	C	G	8	20	28	0	1	29	0	0
19	6086577	.	C	T	0	17	17	0	15	32	0	0
19	6087130	.	T	A	10	4	14	0	0	14	0	0
19	6087146	.	C	T	0	4	4	0	7	11	0	0
19	6087186	.	A	T	6	11	17	0	0	17	0	0
19	6087619	.	T	C	5	0	5	0	9	14	0	0
19	6087894	.	G	A	8	7	15	1	1	17	0	0
19	6087948	.	A	T	18	9	27	1	0	28	0	0
19	6088000	.	C	T	1	14	15	1	14	30	0	0
19	6088166	.	T	C	10	10	20	0	0	20	0	0
19	6088259	.	A	C	9	22	31	0	1	32	0	0
19	6088368	.	A	G	16	16	32	0	1	33	0	0
19	6090702	.	T	C	15	11	26	0	2	28	0	0
19	6090732	.	T	A	13	11	24	0	0	24	0	0
19	6094162	.	A	C	12	12	24	0	0	24	0	0
19	6097473	.	C	A	16	17	33	0	2	35	0	0
19	6100295	.	A	G	13	16	29	0	1	30	0	0
19	6102594	.	A	T	13	14	27	0	0	27	0	0
19	6102732	.	T	C	9	10	19	0	1	20	0	0
19	6105528	.	A	T	6	9	15	0	1	16	0	0
19	6111085	.	G	A	8	11	19	0	1	20	0	0
19	6111214	.	A	G	10	18	28	0	3	31	0	0
19	6111223	.	A	G	11	20	31	0	2	33	0	0
19	6111268	.	G	A	14	13	27	0	2	29	0	0
19	6111544	.	A	G	8	10	18	0	1	19	0	0
19	6111724	.	T	C	5	8	13	0	1	14	0	0
19	6111793	.	G	A	13	5	18	0	0	18	0	0
19	6116477	.	A	G	6	9	15	0	1	16	0	0
19	6116638	.	A	G	6	3	9	0	2	11	0	0
19	6122614	.	A	G	6	6	12	0	1	13	0	0
19	6124000	.	T	C	7	0	7	0	10	17	0	0
19	6125329	.	G	T	5	11	16	0	1	17	0	0
19	6125350	.	A	G	5	9	14	0	0	14	0	0
19	6125425	.	A	T	3	7	10	0	0	10	0	0
19	6125656	.	G	C	10	13	23	0	0	23	0	0
19	6125926	.	G	A	7	17	24	0	2	26	0	0
19	6125941	.	C	T	6	18	24	0	1	25	0	0
19	6126001	.	G	A	8	14	22	0	1	23	0	0
19	6126046	.	A	T	3	11	14	0	6	20	0	0
19	6126277	.	G	A	5	4	9	0	0	9	0	0
19	6126403	.	C	G	4	4	8	0	0	8	0	0
19	6126544	.	A	G	3	4	7	0	0	7	0	0
19	6126625	.	G	A	5	4	9	0	3	12	0	0
19	6126645	.	T	C	5	5	10	0	1	11	0	0
19	6127108	.	C	A	4	5	9	0	0	9	0	0
19	6127669	.	C	A	5	3	8	0	0	8	0	0
19	6127696	.	T	C	5	4	9	0	0	9	0	0
19	6127764	.	A	G	5	4	9	0	1	10	0	0
19	6127768	.	A	G	6	3	9	0	0	9	0	0
19	6127847	.	G	T	2	4	6	0	0	6	0	0
19	6128416	.	G	A	4	7	11	0	0	11	0	0
19	6142669	.	T	A	17	8	25	0	3	28	0	0
19	6142714	.	A	T	16	14	30	0	1	31	0	0
19	6142802	.	G	T	5	9	14	0	0	14	0	0
19	6142803	.	A	G	4	9	13	0	1	14	0	0
19	6143608	.	C	T	1	3	4	0	8	12	0	0
19	6143825	.	C	T	8	6	14	0	0	14	0	0
19	6143919	.	T	C	6	3	9	0	0	9	0	0
19	6144267	.	C	A	5	9	14	0	0	14	0	0
19	6144468	.	G	T	4	3	7	0	0	7	0	0
19	6144659	.	G	A	7	3	10	0	0	10	0	0
19	6144722	.	C	T	8	6	14	0	0	14	0	0
19	6144822	.	C	G	4	4	8	0	0	8	0	0
19	6145382	.	T	A	3	3	6	0	0	6	0	0
19	6145406	.	G	A	4	2	6	0	0	6	0	0
19	6145736	.	G	A	12	6	18	0	0	18	0	0
19	6145964	.	A	G	8	5	13	0	0	13	0	0
19	6146170	.	T	C	2	0	2	0	5	7	0	0
19	6152613	.	C	T	0	1	1	0	2	3	0	0
19	6193178	.	T	C	3	4	7	0	0	7	0	0
19	6214598	.	G	A	2	6	8	0	1	9	0	0
19	6214884	.	T	A	1	3	4	0	0	4	0	0
19	6216813	.	G	A	8	3	11	0	2	13	0	0
19	6217133	.	T	A	6	2	8	0	0	8	0	0
19	6217667	.	A	G	5	7	12	0	0	12	0	0
19	6232242	.	T	C	4	0	4	0	3	7	0	0
19	6235425	.	C	T	2	2	4	0	0	4	0	0
19	6242954	.	T	C	3	2	5	0	1	6	0	0
19	6328442	.	T	C	30	15	45	0	48	93	0	0
19	6328514	.	A	C	43	39	82	0	5	87	0	0
19	6328533	.	A	G	55	39	94	0	0	94	0	0
19	6328830	.	T	G	42	32	74	0	10	84	0	0
19	6328859	.	G	A	32	35	67	0	2	71	2	0
19	6328889	.	C	T	4	31	35	1	34	70	0	0
19	6328906	.	G	A	39	27	66	1	4	71	0	0
19	6328963	.	T	C	42	40	82	0	0	82	0	0
19	6329062	.	A	T	36	29	65	2	1	68	0	0
19	6329381	.	A	T	43	10	53	0	1	54	0	0
19	6329382	.	T	G	41	11	52	0	2	54	0	0
19	6329533	.	C	T	5	38	43	0	32	75	0	0
19	6329813	.	G	A	43	32	75	0	1	76	0	0
19	6330194	.	A	C	36	4	40	1	41	82	0	0
19	6330239	.	C	A	2	42	44	1	34	79	0	0
19	6332902	.	C	A	8	33	41	0	41	82	0	0
19	6332947	.	C	T	9	33	42	0	43	85	0	0
19	6332973	.	G	A	35	41	76	0	4	80	0	0
19	6338207	.	A	G	35	32	67	0	5	72	0	0
19	6338261	.	A	G	34	27	61	0	0	61	0	0
19	6342278	.	G	T	33	31	64	0	1	65	0	0
19	6344522	.	G	C	36	3	39	0	29	68	0	0
19	6346506	.	C	G	30	27	57	0	2	59	0	0
19	6346587	.	C	T	2	24	26	0	28	54	0	0
19	6347662	.	C	T	23	23	46	0	4	50	0	0
19	6352379	.	A	G	27	17	44	0	7	51	0	0
19	6352448	.	G	A	31	16	47	0	1	48	0	0
19	6352511	.	G	A	26	24	50	0	3	53	0	0
19	6358232	.	A	G	19	22	41	0	4	45	0	0
19	6365777	.	G	A	31	16	47	0	0	47	0	0
19	6606673	.	T	A	9	6	15	0	1	17	1	0
19	6606725	.	T	C	7	7	14	0	1	15	0	0
19	6606764	.	A	T	3	5	8	0	1	9	0	0
19	6612432	.	T	C	1	7	8	0	0	8	0	0
19	6618293	.	A	G	7	5	12	0	0	12	0	0
19	6869005	.	A	G	7	2	9	0	0	9	0	0
19	6869051	.	T	C	2	2	4	0	0	4	0	0
19	6871741	.	C	T	3	2	5	8	0	13	0	0
19	6872539	.	T	C	8	6	14	0	0	14	0	0
19	6872595	.	C	T	3	8	11	0	1	12	0	0
19	6901116	.	A	T	1	2	3	0	0	3	0	0
19	6901174	.	G	T	0	3	3	0	3	6	0	0
19	6907203	.	A	G	3	2	5	0	0	5	0	0
19	6907209	.	G	A	1	2	3	0	0	3	0	0
19	6907957	.	G	A	0	1	1	1	3	5	0	0
19	6907959	.	G	T	2	2	4	1	0	5	0	0
19	6908155	.	T	G	3	1	4	0	3	7	0	0
19	6908520	.	T	C	1	2	3	0	0	3	0	0
19	6908566	.	A	G	1	2	3	1	0	4	0	0
19	6908574	.	T	A	1	1	2	1	0	3	0	0
19	6914280	.	A	T	2	2	4	0	1	5	0	0
19	6914319	.	T	A	4	2	6	0	0	6	0	0
19	6914370	.	A	C	2	3	5	0	0	5	0	0
19	6914415	.	T	C	6	3	9	1	1	11	0	0
19	6914871	.	G	A	1	2	3	2	2	7	0	0
19	6915114	.	C	T	2	3	5	0	0	5	0	0
19	6915175	.	A	C	2	3	5	0	0	5	0	0
19	6915177	.	A	G	2	3	5	0	0	5	0	0
19	6916019	.	T	C	1	4	5	0	0	5	0	0
19	6916029	.	G	A	2	4	6	0	1	7	0	0
19	6916158	.	C	A	3	2	5	0	0	5	0	0
19	6921535	.	G	A	0	3	3	0	4	7	0	0
19	6922387	.	A	G	2	2	4	0	1	5	0	0
19	6922645	.	T	C	1	2	3	0	0	3	0	0
19	6922749	.	A	T	0	2	2	1	1	4	0	0
19	6922883	.	A	G	2	0	2	0	2	4	0	0
19	6923014	.	A	G	6	2	8	0	0	8	0	0
19	6923033	.	A	C	5	2	7	0	0	7	0	0
19	6928346	.	T	G	2	3	5	0	1	6	0	0
19	6928350	.	A	C	3	4	7	0	1	8	0	0
19	6933469	.	G	A	3	3	6	0	0	6	0	0
19	6934166	.	C	T	1	2	3	0	0	3	0	0
19	6934188	.	G	T	2	2	4	0	0	4	0	0
19	6938364	.	A	T	16	12	28	0	3	31	0	0
19	6938377	.	A	T	18	12	30	0	1	31	0	0
19	6940213	.	C	T	12	8	20	0	0	20	0	0
19	6949256	.	G	A	1	18	19	0	19	38	0	0
19	6949316	.	C	A	16	25	41	0	2	43	0	0
19	6950393	.	G	A	21	14	35	0	5	40	0	0
19	6952600	.	T	C	24	18	42	0	2	44	0	0
19	6955061	.	C	T	35	16	51	0	1	52	0	0
19	6955130	.	C	T	22	15	37	0	1	38	0	0
19	6955131	.	C	T	19	14	33	0	4	37	0	0
19	6955198	.	C	A	16	19	35	0	2	37	0	0
19	6955411	.	C	T	9	12	21	0	3	24	0	0
19	6955475	.	T	C	13	9	22	0	0	22	0	0
19	6955609	.	C	G	15	9	24	0	1	25	0	0
19	6955620	.	G	A	1	8	9	0	15	24	0	0
19	6955920	.	G	A	16	8	24	0	0	24	0	0
19	6956259	.	C	A	3	7	10	0	0	10	0	0
19	6956291	.	T	C	3	5	8	0	0	8	0	0
19	6956509	.	A	G	3	2	5	0	1	6	0	0
19	6956553	.	A	C	5	6	11	0	1	12	0	0
19	6956555	.	A	T	5	6	11	0	1	12	0	0
19	6956665	.	C	A	16	15	31	0	1	32	0	0
19	6956728	.	T	A	21	11	32	0	1	33	0	0
19	6956829	.	T	A	19	6	25	0	1	26	0	0
19	6956835	.	C	G	19	4	23	0	1	24	0	0
19	6956881	.	T	C	16	4	20	0	1	21	0	0
19	6957127	.	A	T	28	14	42	0	3	45	0	0
19	6957131	.	C	A	30	14	44	0	1	45	0	0
19	6960531	.	A	T	3	5	8	0	0	8	0	0
19	6960653	.	C	A	5	4	9	0	0	9	0	0
19	6960921	.	T	A	4	4	8	1	0	9	0	0
19	6961095	.	G	A	9	8	17	0	1	18	0	0
19	6961120	.	T	C	9	7	16	0	0	16	0	0
19	6961130	.	T	C	8	0	8	0	7	15	0	0
19	6961211	.	T	C	4	3	7	2	0	9	0	0
19	6961421	.	T	A	12	7	19	0	0	20	1	0
19	6961610	.	G	A	5	3	8	1	1	10	0	0
19	6961674	.	A	G	7	5	12	0	1	13	0	0
19	6962786	.	T	C	13	5	18	0	0	18	0	0
19	6963020	.	C	T	3	3	6	0	1	7	0	0
19	6963708	.	G	T	3	3	6	0	0	6	0	0
19	6963996	.	G	A	4	4	8	0	0	8	0	0
19	6964273	.	C	A	8	10	18	0	1	19	0	0
19	6964364	.	C	T	9	3	12	0	0	12	0	0
19	6964381	.	T	C	9	5	14	0	0	14	0	0
19	6964417	.	A	G	4	9	13	0	0	13	0	0
19	6964636	.	C	T	3	6	9	0	1	10	0	0
19	6964641	.	T	C	3	0	3	0	7	10	0	0
19	6965235	.	A	G	3	2	5	0	0	5	0	0
19	6965250	.	G	A	2	2	4	0	0	4	0	0
19	6965382	.	A	T	2	3	5	0	1	6	0	0
19	6965420	.	A	T	5	4	9	0	0	9	0	0
19	6965456	.	T	C	6	3	9	0	0	9	0	0
19	6965493	.	T	C	2	3	5	0	0	5	0	0
19	6965656	.	T	C	3	2	5	0	1	6	0	0
19	6965687	.	T	A	3	3	6	0	0	6	0	0
19	6965717	.	A	G	5	4	9	0	1	10	0	0
19	6965752	.	A	T	5	5	10	0	0	10	0	0
19	6965767	.	G	A	5	4	9	0	0	9	0	0
19	6965790	.	G	T	5	1	6	0	0	6	0	0
19	6965894	.	C	A	0	2	2	0	4	6	0	0
19	6965897	.	C	T	4	2	6	0	0	6	0	0
19	6966003	.	C	A	4	3	7	0	0	7	0	0
19	6966022	.	A	G	7	4	11	0	0	11	0	0
19	6966208	.	G	A	4	10	14	0	0	14	0	0
19	6966271	.	T	G	2	9	11	0	0	11	0	0
19	6966781	.	A	T	9	4	13	0	0	13	0	0
19	6975261	.	A	C	9	0	9	0	5	14	0	0
19	6980493	.	C	T	5	4	9	0	1	10	0	0
19	6988778	.	T	C	6	7	13	0	0	13	0	0
19	6998402	.	A	G	2	0	2	0	2	4	0	0
19	7003167	.	C	T	3	3	6	0	0	6	0	0
19	7003228	.	C	A	2	2	4	0	0	4	0	0
19	7005030	.	C	T	5	3	8	0	0	8	0	0
19	7005032	.	G	C	5	3	8	0	0	8	0	0
19	7005198	.	A	G	2	3	5	0	0	5	0	0
19	7005249	.	G	A	0	2	2	0	5	7	0	0
19	7005282	.	T	C	3	2	5	0	1	6	0	0
19	7005462	.	G	A	1	3	4	0	6	10	0	0
19	7005630	.	C	T	1	2	3	0	0	3	0	0
19	7005821	.	A	G	1	2	3	0	0	3	0	0
19	7005881	.	C	T	4	4	8	0	0	8	0	0
19	7006215	.	C	T	2	7	9	0	0	9	0	0
19	7006682	.	G	A	2	4	6	0	0	6	0	0
19	7006709	.	G	T	0	4	4	0	2	6	0	0
19	7006826	.	C	A	4	3	7	0	0	7	0	0
19	7006837	.	A	C	3	2	5	0	1	6	0	0
19	7006928	.	C	T	3	4	7	0	0	7	0	0
19	7014570	.	C	A	2	2	4	0	0	4	0	0
19	7014743	.	G	A	6	3	9	0	0	9	0	0
19	7014778	.	T	A	6	3	9	0	0	10	1	0
19	7014815	.	C	T	6	3	9	0	0	9	0	0
19	7014863	.	T	G	3	3	6	0	0	6	0	0
19	7014909	.	C	A	2	4	6	0	0	6	0	0
19	7014912	.	G	A	2	3	5	0	1	6	0	0
19	7015034	.	T	A	2	7	9	0	0	9	0	0
19	7020179	.	G	A	5	6	11	0	0	11	0	0
19	7020775	.	T	C	2	2	4	0	0	4	0	0
19	7022107	.	G	A	4	4	8	0	1	9	0	0
19	7022128	.	G	A	3	7	10	0	0	10	0	0
19	7024591	.	T	G	3	4	7	0	0	7	0	0
19	7024593	.	C	T	3	3	6	0	1	7	0	0
19	7024627	.	T	C	3	3	6	0	0	6	0	0
19	7027810	.	A	T	2	5	7	0	0	7	0	0
19	7027927	.	G	A	4	2	6	0	0	6	0	0
19	7028011	.	C	T	4	4	8	0	2	10	0	0
19	7029769	.	A	G	2	2	4	0	0	4	0	0
19	7029770	.	C	G	2	2	4	0	0	4	0	0
19	7029806	.	C	G	2	4	6	0	0	6	0	0
19	7029811	.	G	A	2	2	4	0	2	6	0	0
19	7029883	.	C	A	4	2	6	0	1	7	0	0
19	7031333	.	A	G	2	2	4	0	1	5	0	0
19	7031350	.	G	A	3	2	5	0	0	5	0	0
19	7031368	.	T	G	2	2	4	0	1	5	0	0
19	7038901	.	A	C	1	2	3	0	0	3	0	0
19	7039113	.	G	A	1	3	4	0	0	4	0	0
19	7039335	.	T	C	5	0	5	0	6	11	0	0
19	7039344	.	G	A	5	5	10	0	0	10	0	0
19	7048439	.	T	A	1	4	5	0	0	5	0	0
19	7048468	.	G	A	2	5	7	0	0	7	0	0
19	7106920	.	G	C	5	2	7	0	0	7	0	0
19	7112337	.	G	C	2	0	2	0	2	4	0	0
19	7112358	.	C	T	0	2	2	0	2	4	0	0
19	7120539	.	G	A	5	3	8	0	0	8	0	0
19	7120577	.	T	A	5	3	8	0	0	8	0	0
19	7120680	.	C	T	2	2	4	0	0	4	0	0
19	7120696	.	G	A	3	1	4	0	1	5	0	0
19	7121014	.	G	C	0	3	3	0	2	5	0	0
19	7121786	.	C	T	2	3	5	0	0	5	0	0
19	7121807	.	C	G	1	3	4	0	0	4	0	0
19	7128538	.	T	C	4	2	6	0	0	6	0	0
19	7128540	.	G	C	2	2	4	0	1	5	0	0
19	7130255	.	T	C	2	2	4	0	0	4	0	0
19	7130264	.	G	A	3	2	5	0	0	5	0	0
19	7131154	.	G	C	0	4	4	0	9	13	0	0
19	7152971	.	G	T	1	10	11	0	9	20	0	0
19	7152974	.	G	A	9	9	18	0	0	18	0	0
19	7154729	.	A	G	13	16	29	0	5	34	0	0
19	7154770	.	A	C	18	13	31	0	0	31	0	0
19	7155001	.	A	T	8	18	26	0	1	27	0	0
19	7155034	.	A	G	11	18	29	0	1	30	0	0
19	7155065	.	T	C	10	19	29	0	1	30	0	0
19	7158469	.	C	T	11	9	20	0	2	22	0	0
19	7158546	.	A	G	12	0	12	0	5	17	0	0
19	7159062	.	G	A	2	8	10	0	12	22	0	0
19	7159107	.	T	C	12	14	26	0	0	26	0	0
19	7161452	.	G	A	9	8	17	0	0	17	0	0
19	7161527	.	A	G	4	0	4	0	9	13	0	0
19	7161539	.	G	T	7	11	18	0	0	18	0	0
19	7163872	.	C	T	6	15	21	0	0	21	0	0
19	7163908	.	A	G	10	9	19	0	2	21	0	0
19	7164022	.	G	A	8	15	23	0	0	23	0	0
19	7166211	.	C	T	15	11	26	0	0	26	0	0
19	7166454	.	C	A	5	7	12	0	1	13	0	0
19	7169204	.	A	C	10	10	20	0	5	25	0	0
19	7169228	.	C	T	15	10	25	0	2	27	0	0
19	7169304	.	G	A	15	3	18	0	5	23	0	0
19	7169587	.	A	G	5	4	9	0	0	9	0	0
19	7169588	.	G	A	5	4	9	0	0	9	0	0
19	7169770	.	A	C	13	9	22	1	0	23	0	0
19	7169809	.	C	T	8	13	21	0	0	21	0	0
19	7169880	.	T	C	6	12	18	0	1	19	0	0
19	7169886	.	G	A	7	13	20	0	1	21	0	0
19	7169929	.	G	A	7	14	21	0	0	21	0	0
19	7170014	.	A	C	6	8	14	0	1	15	0	0
19	7170015	.	T	C	6	8	14	0	1	15	0	0
19	7170128	.	A	G	3	7	10	0	0	10	0	0
19	7170191	.	A	C	8	3	11	0	0	11	0	0
19	7170228	.	A	T	7	4	11	0	0	11	0	0
19	7174417	.	C	A	3	5	8	0	1	9	0	0
19	7249800	.	A	G	7	17	24	0	2	26	0	0
19	7249811	.	T	C	8	16	24	0	1	25	0	0
19	7250372	.	T	C	2	9	11	0	0	11	0	0
19	7258085	.	A	G	5	11	16	0	1	17	0	0
19	7258118	.	C	T	3	11	14	0	0	14	0	0
19	7265377	.	T	C	14	4	18	0	0	18	0	0
19	7270102	.	G	A	7	13	20	0	1	21	0	0
19	7270156	.	C	A	1	9	10	0	11	21	0	0
19	7272224	.	C	A	11	9	20	0	0	20	0	0
19	7272935	.	G	A	12	5	17	0	0	17	0	0
19	7276063	.	A	T	1	3	4	0	0	4	0	0
19	7276106	.	G	A	11	10	21	0	1	22	0	0
19	7276149	.	A	G	26	18	44	0	1	45	0	0
19	7276194	.	T	A	19	26	45	0	2	47	0	0
19	7276559	.	G	A	42	25	67	0	1	69	1	0
19	7276610	.	G	A	39	27	66	0	7	73	0	0
19	7279235	.	A	G	34	27	61	3	1	65	0	0
19	7279721	.	A	G	30	22	52	0	6	58	0	0
19	7282541	.	C	T	35	27	62	0	4	66	0	0
19	7282554	.	G	A	37	26	63	0	1	64	0	0
19	7283427	.	C	A	37	23	60	0	0	60	0	0
19	7283499	.	A	G	31	18	49	2	1	52	0	0
19	7284840	.	C	T	2	27	29	0	24	53	0	0
19	7286301	.	A	G	25	24	49	0	1	50	0	0
19	7286355	.	A	G	32	24	56	0	0	56	0	0
19	7286421	.	T	A	25	25	50	0	0	50	0	0
19	7286742	.	A	G	29	31	60	0	2	62	0	0
19	7287600	.	T	C	29	23	52	0	0	52	0	0
19	7287603	.	G	A	30	21	51	0	0	51	0	0
19	7288195	.	A	G	27	25	52	0	0	52	0	0
19	7290175	.	A	G	25	26	51	0	3	54	0	0
19	7290214	.	A	G	20	30	50	0	1	51	0	0
19	7291642	.	A	T	19	20	39	0	0	39	0	0
19	7293138	.	A	G	2	5	7	0	0	7	0	0
19	7295279	.	G	A	5	5	10	0	0	10	0	0
19	7295572	.	G	C	4	6	10	0	0	10	0	0
19	7309154	.	G	A	11	7	18	0	0	18	0	0
19	7309391	.	C	A	31	18	49	0	1	50	0	0
19	7309522	.	G	C	24	16	40	0	1	41	0	0
19	7309556	.	T	A	16	16	32	0	0	32	0	0
19	7309557	.	T	A	15	15	30	0	2	32	0	0
19	7309754	.	T	G	11	14	25	0	0	25	0	0
19	7309929	.	A	T	18	16	34	1	1	36	0	0
19	7309968	.	G	T	18	11	29	0	1	30	0	0
19	7310117	.	T	C	19	0	19	0	11	31	1	0
19	7310131	.	C	T	15	13	28	0	0	28	0	0
19	7310154	.	A	T	13	16	29	0	0	29	0	0
19	7311678	.	T	G	20	7	27	0	1	28	0	0
19	7313933	.	C	G	23	21	44	0	3	47	0	0
19	7327462	.	A	G	14	13	27	1	1	29	0	0
19	7327519	.	C	T	16	8	24	0	1	25	0	0
19	7327564	.	G	T	15	10	25	0	2	28	1	0
19	7327570	.	T	C	14	9	23	0	3	26	0	0
19	7337862	.	C	A	13	6	19	0	3	22	0	0
19	7338033	.	C	T	3	13	16	0	11	27	0	0
19	7338125	.	C	T	10	16	26	0	2	28	0	0
19	7338150	.	G	A	9	10	19	0	0	19	0	0
19	7338309	.	C	T	1	13	14	0	10	24	0	0
19	7338402	.	C	T	1	13	14	0	12	26	0	0
19	7338425	.	T	C	7	15	22	0	1	23	0	0
19	7338444	.	T	C	8	0	8	0	14	22	0	0
19	7338969	.	C	T	17	15	32	0	0	32	0	0
19	7338978	.	T	C	15	0	15	0	16	31	0	0
19	7339008	.	T	G	16	11	27	0	1	28	0	0
19	7341300	.	G	A	10	13	23	0	2	25	0	0
19	7341385	.	A	G	10	9	19	0	0	19	0	0
19	7358131	.	A	G	7	16	23	1	0	24	0	0
19	7379601	.	C	T	6	4	10	0	1	11	0	0
19	7379637	.	T	C	6	0	6	0	5	11	0	0
19	7408277	.	C	T	1	3	4	0	0	4	0	0
19	7408360	.	T	G	12	6	18	0	1	19	0	0
19	7409961	.	A	G	8	7	15	0	0	15	0	0
19	7411975	.	T	C	1	7	8	0	1	9	0	0
19	7412062	.	T	C	8	7	15	0	2	17	0	0
19	7412320	.	C	T	11	10	21	0	1	22	0	0
19	7412358	.	A	T	6	7	13	0	0	13	0	0
19	7412432	.	C	A	4	5	9	0	0	9	0	0
19	7412441	.	C	A	3	5	8	0	0	8	0	0
19	7412490	.	T	C	5	4	9	0	0	9	0	0
19	7424794	.	G	A	12	6	18	0	1	19	0	0
19	7426637	.	C	T	10	4	14	0	1	15	0	0
19	7426814	.	C	T	5	8	13	0	0	13	0	0
19	7426832	.	G	A	5	8	13	0	0	13	0	0
19	7426967	.	T	C	11	14	25	0	1	26	0	0
19	7427099	.	C	A	11	16	27	0	0	27	0	0
19	7430160	.	T	C	11	9	20	0	0	20	0	0
19	7430607	.	G	A	2	14	16	0	13	29	0	0
19	7430652	.	C	T	13	9	22	0	2	24	0	0
19	7430700	.	A	G	8	1	9	0	8	17	0	0
19	7430715	.	C	A	7	6	13	0	2	15	0	0
19	7432922	.	G	A	6	3	9	0	0	9	0	0
19	7433149	.	A	T	1	5	6	0	0	6	0	0
19	7433339	.	C	T	1	2	3	0	0	3	0	0
19	7433357	.	A	G	1	2	3	0	0	3	0	0
19	7433454	.	G	A	1	2	3	0	0	3	0	0
19	7433637	.	C	A	2	3	5	0	0	5	0	0
19	7433746	.	A	C	2	4	6	0	0	6	0	0
19	7434010	.	T	C	2	2	4	0	0	4	0	0
19	7434139	.	T	C	1	3	4	0	0	4	0	0
19	7434161	.	G	T	2	3	5	0	0	5	0	0
19	7434555	.	C	T	3	2	5	0	0	5	0	0
19	7434731	.	G	C	7	2	9	1	0	10	0	0
19	7434753	.	A	G	6	3	9	0	1	10	0	0
19	7434813	.	G	A	1	4	5	0	1	6	0	0
19	7434866	.	C	T	6	2	8	0	0	8	0	0
19	7434881	.	C	T	0	2	2	0	6	8	0	0
19	7435078	.	A	G	2	3	5	0	0	5	0	0
19	7435083	.	A	C	2	2	4	0	0	4	0	0
19	7435237	.	A	G	3	5	8	0	0	8	0	0
19	7435252	.	G	A	4	4	8	0	0	8	0	0
19	7435535	.	C	A	4	4	8	0	1	9	0	0
19	7437053	.	A	G	1	4	5	0	0	5	0	0
19	7438363	.	C	A	3	4	7	0	0	7	0	0
19	7438384	.	C	T	3	3	6	0	0	6	0	0
19	7439799	.	C	T	2	2	4	0	0	4	0	0
19	7441832	.	T	A	2	2	4	0	0	4	0	0
19	7445676	.	G	A	3	2	5	6	4	15	0	0
19	7445897	.	C	T	26	29	55	0	4	59	0	0
19	7446050	.	T	C	29	24	53	0	0	53	0	0
19	7446137	.	G	T	18	32	50	0	2	52	0	0
19	7446286	.	G	T	32	24	56	0	1	57	0	0
19	7446495	.	G	T	32	25	57	0	8	65	0	0
19	7446621	.	C	A	41	29	70	0	4	74	0	0
19	7446702	.	T	C	32	33	65	0	3	68	0	0
19	7450572	.	G	A	38	32	70	0	1	71	0	0
19	7450658	.	T	C	16	11	27	0	0	27	0	0
19	7450750	.	A	G	6	8	14	0	1	15	0	0
19	7456364	.	T	C	7	5	12	0	0	12	0	0
19	7456371	.	A	C	9	4	13	0	1	14	0	0
19	7456722	.	C	G	9	10	19	0	0	19	0	0
19	7456793	.	A	G	6	7	13	0	1	14	0	0
19	7456816	.	C	G	7	6	13	0	1	14	0	0
19	7468556	.	G	T	6	8	14	0	0	14	0	0
19	7468580	.	C	T	7	9	16	0	0	16	0	0
19	7468746	.	T	A	6	6	12	0	0	12	0	0
19	7474242	.	T	C	11	9	20	0	0	20	0	0
19	7474245	.	T	G	9	0	9	0	12	22	1	0
19	7478159	.	A	G	13	12	25	0	0	25	0	0
19	7478283	.	C	T	7	4	11	0	0	11	0	0
19	7478356	.	G	A	7	3	10	0	0	10	0	0
19	7482931	.	C	T	6	7	13	0	3	16	0	0
19	7482993	.	G	A	6	7	13	0	0	13	0	0
19	7483059	.	A	T	7	5	12	0	0	12	0	0
19	7483469	.	T	G	7	6	13	0	1	14	0	0
19	7484313	.	T	A	5	3	8	0	0	8	0	0
19	7484354	.	A	T	5	4	9	0	0	9	0	0
19	7484357	.	G	A	5	3	8	0	0	8	0	0
19	7484536	.	G	T	8	3	11	0	0	11	0	0
19	7484668	.	A	T	4	4	8	1	0	9	0	0
19	7484763	.	T	A	5	3	8	0	0	8	0	0
19	7484770	.	T	C	5	5	10	0	1	11	0	0
19	7484834	.	A	G	3	4	7	0	0	7	0	0
19	7484856	.	C	G	0	4	4	0	3	7	0	0
19	7485117	.	C	T	2	4	6	0	2	8	0	0
19	7485298	.	A	C	1	6	7	0	0	7	0	0
19	7485457	.	C	T	4	2	6	0	1	7	0	0
19	7485503	.	G	A	3	4	7	0	0	7	0	0
19	7485528	.	T	C	1	0	1	0	2	3	0	0
19	7485890	.	G	A	3	3	6	0	1	7	0	0
19	7486022	.	T	C	1	2	3	0	0	3	0	0
19	7486087	.	G	A	1	5	6	0	0	6	0	0
19	7486314	.	A	T	2	3	5	0	0	5	0	0
19	7486353	.	G	A	2	2	4	0	0	4	0	0
19	7486791	.	T	C	6	3	9	0	1	10	0	0
19	7487096	.	G	A	3	2	5	0	0	5	0	0
19	7487103	.	G	A	3	2	5	0	0	5	0	0
19	7487163	.	A	G	1	5	6	0	0	6	0	0
19	7487321	.	C	T	5	8	13	0	2	15	0	0
19	7487592	.	T	A	3	4	7	0	0	7	0	0
19	7489552	.	G	A	3	3	6	0	1	7	0	0
19	7490873	.	T	A	2	7	9	0	0	9	0	0
19	7495867	.	A	T	17	13	30	0	2	32	0	0
19	7498046	.	T	C	10	18	28	0	1	29	0	0
19	7498079	.	A	G	9	17	26	0	4	30	0	0
19	7498103	.	A	G	13	15	28	0	0	28	0	0
19	7505591	.	A	G	15	8	23	0	1	24	0	0
19	7505907	.	A	G	13	2	15	0	11	26	0	0
19	7506036	.	A	G	2	0	2	0	6	8	0	0
19	7507833	.	A	T	9	6	15	0	2	17	0	0
19	7510223	.	T	C	15	7	22	0	1	23	0	0
19	7510348	.	T	C	14	5	19	0	3	22	0	0
19	7510501	.	G	A	0	7	7	0	11	18	0	0
19	7510567	.	C	T	14	13	27	0	0	27	0	0
19	7512406	.	C	G	13	18	31	0	1	32	0	0
19	7513085	.	C	T	9	8	17	0	0	17	0	0
19	7513291	.	A	C	11	9	20	0	1	21	0	0
19	7513406	.	A	T	12	12	24	0	1	25	0	0
19	7513631	.	A	G	6	8	14	0	1	15	0	0
19	7513651	.	A	G	10	5	15	0	0	15	0	0
19	7513669	.	A	G	3	0	3	0	8	11	0	0
19	7514025	.	T	C	8	8	16	1	0	17	0	0
19	7514216	.	A	G	3	2	5	0	0	5	0	0
19	7514512	.	T	C	6	6	12	0	0	12	0	0
19	7514544	.	A	G	3	4	7	0	0	7	0	0
19	7514697	.	A	G	8	0	8	0	7	15	0	0
19	7514852	.	A	G	6	9	15	0	0	15	0	0
19	7515260	.	T	A	5	4	9	0	0	9	0	0
19	7515336	.	A	T	14	9	23	0	2	25	0	0
19	7515356	.	G	A	14	10	24	1	1	26	0	0
19	7515787	.	A	T	14	9	23	0	0	23	0	0
19	7515829	.	C	T	16	13	29	0	0	29	0	0
19	7515845	.	A	T	15	16	31	0	0	31	0	0
19	7516035	.	A	G	10	13	23	0	1	24	0	0
19	7516063	.	A	C	6	14	20	0	1	21	0	0
19	7516169	.	C	A	13	7	20	0	1	21	0	0
19	7516183	.	T	G	12	6	18	0	0	19	1	0
19	7518664	.	T	C	2	2	4	0	0	4	0	0
19	7525148	.	C	T	2	8	10	0	9	19	0	0
19	7525222	.	T	G	5	4	9	0	0	9	0	0
19	7525337	.	C	A	6	7	13	0	0	13	0	0
19	7525381	.	G	A	2	3	5	0	0	5	0	0
19	7525386	.	G	C	1	3	4	0	0	4	0	0
19	7529896	.	T	A	1	2	3	0	0	3	0	0
19	7529948	.	A	G	1	5	6	1	0	7	0	0
19	7530813	.	T	A	1	2	3	0	0	3	0	0
19	7530865	.	C	G	1	2	3	0	1	4	0	0
19	7530949	.	G	T	1	4	5	0	0	5	0	0
19	7540717	.	G	A	1	2	3	0	0	3	0	0
19	7540734	.	T	G	1	2	3	0	0	3	0	0
19	7549916	.	G	A	17	14	31	0	1	32	0	0
19	7552736	.	C	G	16	16	32	0	1	33	0	0
19	7552737	.	G	T	3	15	18	0	16	34	0	0
19	7552875	.	G	C	0	14	14	0	19	33	0	0
19	7552887	.	A	G	18	11	29	0	1	30	0	0
19	7553368	.	T	C	17	13	30	0	1	31	0	0
19	7553416	.	C	T	11	14	25	0	3	28	0	0
19	7557447	.	C	A	14	13	27	0	1	28	0	0
19	7557538	.	T	C	14	18	32	0	0	32	0	0
19	7557589	.	T	G	14	0	14	0	21	35	0	0
19	7557619	.	A	T	13	21	34	0	2	36	0	0
19	7557773	.	A	T	17	12	29	1	4	34	0	0
19	7557793	.	G	C	17	17	34	1	2	37	0	0
19	7557992	.	C	T	18	13	31	0	1	32	0	0
19	7558009	.	G	A	19	15	34	0	1	35	0	0
19	7559818	.	G	T	18	19	37	0	1	38	0	0
19	7559905	.	A	G	14	18	32	0	0	32	0	0
19	7564073	.	A	G	10	10	20	0	2	22	0	0
19	7565142	.	G	A	20	20	40	0	0	40	0	0
19	7565244	.	A	G	13	25	38	0	3	41	0	0
19	7567021	.	T	A	21	16	37	0	0	37	0	0
19	7567196	.	A	C	3	4	7	0	0	7	0	0
19	7590695	.	A	T	3	2	5	0	0	5	0	0
19	7590964	.	G	A	0	2	2	0	3	5	0	0
19	7627524	.	T	C	4	2	6	0	0	6	0	0
19	7630329	.	T	A	1	8	9	0	0	9	0	0
19	7630359	.	T	A	1	5	6	0	0	6	0	0
19	7630689	.	A	T	6	2	8	0	0	8	0	0
19	7631700	.	G	A	2	15	17	0	10	27	0	0
19	7631784	.	A	G	9	12	21	0	0	21	0	0
19	7631829	.	C	A	14	9	23	0	0	23	0	0
19	7631860	.	T	C	18	8	26	0	0	26	0	0
19	7632056	.	C	T	4	5	9	0	0	9	0	0
19	7632216	.	C	T	13	10	23	0	2	25	0	0
19	7632348	.	G	A	1	6	7	0	11	18	0	0
19	7632470	.	C	T	3	11	14	0	0	14	0	0
19	7632526	.	T	C	7	11	18	0	0	18	0	0
19	7632837	.	C	T	7	8	15	0	3	18	0	0
19	7668592	.	G	A	1	2	3	0	1	4	0	0
19	7761855	.	C	T	12	5	17	0	1	18	0	0
19	7765259	.	G	A	9	12	21	0	1	22	0	0
19	7771431	.	G	A	2	5	7	0	7	14	0	0
19	7784681	.	T	A	17	11	28	0	4	32	0	0
19	7784684	.	T	A	19	15	34	0	0	34	0	0
19	7785138	.	C	T	21	18	39	0	0	39	0	0
19	7794887	.	C	T	18	15	33	0	5	38	0	0
19	7796398	.	C	T	25	20	45	0	1	46	0	0
19	7796842	.	C	A	9	23	32	0	4	36	0	0
19	7796888	.	G	A	19	13	32	0	2	34	0	0
19	7796986	.	A	T	23	9	32	0	0	32	0	0
19	7797259	.	T	A	23	13	36	0	2	38	0	0
19	7797534	.	C	T	15	14	29	0	2	31	0	0
19	7797651	.	G	T	3	16	19	0	0	19	0	0
19	7802700	.	G	A	11	8	19	0	0	19	0	0
19	7802873	.	G	A	2	9	11	0	1	12	0	0
19	7803424	.	C	A	13	5	18	0	1	19	0	0
19	7803685	.	C	A	5	13	18	0	1	19	0	0
19	7804785	.	A	C	15	9	24	0	0	24	0	0
19	7819991	.	G	A	6	13	19	0	1	20	0	0
19	7820031	.	T	A	7	8	15	0	1	16	0	0
19	7820040	.	T	C	6	8	14	0	1	15	0	0
19	7820079	.	T	A	5	12	17	0	0	17	0	0
19	7820107	.	G	A	4	8	12	0	0	12	0	0
19	7820466	.	C	A	1	5	6	0	7	13	0	0
19	7820665	.	T	A	19	11	30	0	0	30	0	0
19	7820980	.	C	T	7	13	20	0	0	20	0	0
19	7822581	.	T	C	6	1	7	0	10	17	0	0
19	7823306	.	G	A	13	10	23	0	0	23	0	0
19	7827016	.	G	A	13	13	26	0	0	26	0	0
19	7827031	.	T	G	15	13	28	0	0	28	0	0
19	7827377	.	C	T	1	7	8	0	8	16	0	0
19	7827579	.	G	A	4	3	7	0	0	7	0	0
19	7827672	.	G	C	2	5	7	0	0	7	0	0
19	7828576	.	G	A	6	8	14	0	1	15	0	0
19	7828621	.	C	A	9	7	16	0	1	17	0	0
19	7828672	.	C	G	6	3	9	0	0	9	0	0
19	7828674	.	G	A	3	4	7	0	1	8	0	0
19	7828774	.	A	G	2	9	11	0	0	11	0	0
19	7828912	.	G	A	4	11	15	0	1	16	0	0
19	7828930	.	T	G	8	8	16	0	1	17	0	0
19	7829080	.	G	A	3	4	7	0	1	8	0	0
19	7829124	.	T	C	2	0	2	0	3	5	0	0
19	7829174	.	C	G	1	3	4	0	0	4	0	0
19	7829175	.	C	T	1	1	2	0	2	4	0	0
19	7829333	.	C	A	2	5	7	0	0	7	0	0
19	7830013	.	G	A	8	4	12	0	0	12	0	0
19	7830253	.	A	G	2	4	6	0	0	6	0	0
19	7830261	.	G	A	2	4	6	0	0	6	0	0
19	7830295	.	G	A	4	7	11	0	0	11	0	0
19	7830622	.	C	T	3	5	8	0	0	8	0	0
19	7830625	.	C	T	5	2	7	0	0	7	0	0
19	7830700	.	G	A	8	8	16	0	0	16	0	0
19	7835774	.	G	A	1	3	4	0	0	4	0	0
19	7967063	.	C	T	1	4	5	2	0	7	0	0
19	7967067	.	T	C	1	4	5	3	0	8	0	0
19	8144609	.	G	A	7	4	11	0	1	12	0	0
19	8315385	.	A	G	7	1	8	0	4	12	0	0
19	8315418	.	G	A	2	4	6	0	4	10	0	0
19	8315478	.	C	T	5	4	9	0	0	9	0	0
19	8336054	.	A	G	6	0	6	0	8	14	0	0
19	8336208	.	C	T	7	8	15	0	0	15	0	0
19	8336335	.	C	A	5	5	10	0	0	10	0	0
19	8336642	.	C	T	19	7	26	0	1	27	0	0
19	8336689	.	G	A	8	9	17	0	0	17	0	0
19	8336930	.	C	G	3	5	8	1	0	9	0	0
19	8337115	.	T	C	1	4	5	0	0	5	0	0
19	8338417	.	A	T	1	3	4	0	0	4	0	0
19	8338559	.	A	G	5	9	14	0	0	14	0	0
19	8338616	.	T	A	10	14	24	0	2	26	0	0
19	8338649	.	T	A	5	13	18	0	2	20	0	0
19	8339202	.	T	A	16	11	27	0	0	27	0	0
19	8481852	.	A	G	2	3	5	0	0	5	0	0
19	8500928	.	A	T	4	7	11	0	0	11	0	0
19	8500960	.	A	T	9	7	16	0	0	16	0	0
19	8501019	.	G	A	2	8	10	0	6	16	0	0
19	8501218	.	G	A	7	15	22	0	0	22	0	0
19	8501490	.	G	T	8	16	24	2	3	29	0	0
19	8501660	.	G	T	1	3	4	0	13	17	0	0
19	8501663	.	C	T	14	4	18	0	1	19	0	0
19	8501703	.	A	C	11	5	16	0	3	19	0	0
19	8501961	.	G	A	2	12	14	0	14	28	0	0
19	8501962	.	G	A	16	11	27	0	2	29	0	0
19	8502104	.	C	G	5	8	13	0	2	15	0	0
19	8502133	.	C	T	8	11	19	0	1	20	0	0
19	8502166	.	G	T	0	13	13	0	14	27	0	0
19	8502225	.	T	A	21	17	38	0	1	39	0	0
19	8502244	.	G	A	18	17	35	0	2	37	0	0
19	8534126	.	G	C	4	6	10	0	0	10	0	0
19	8534996	.	A	G	5	4	9	0	0	9	0	0
19	8535005	.	T	G	4	4	8	0	0	8	0	0
19	8582763	.	T	C	5	5	10	0	0	10	0	0
19	8583065	.	A	G	3	8	11	0	2	13	0	0
19	8583131	.	G	A	12	9	21	0	0	21	0	0
19	8583170	.	G	T	5	6	11	0	0	11	0	0
19	8587075	.	T	C	10	1	11	0	6	17	0	0
19	8589693	.	C	T	3	5	8	0	1	10	1	0
19	8589714	.	C	T	4	2	6	0	0	6	0	0
19	8592973	.	T	A	5	11	16	0	0	16	0	0
19	8598667	.	A	G	6	5	11	0	1	12	0	0
19	8600156	.	G	A	6	6	12	0	0	12	0	0
19	8604172	.	G	A	3	9	12	0	0	12	0	0
19	8604268	.	C	A	0	2	2	0	2	4	0	0
19	8612844	.	T	G	2	2	4	0	0	4	0	0
19	8612981	.	G	C	0	11	11	0	7	18	0	0
19	8613041	.	G	C	8	7	15	0	2	17	0	0
19	8628830	.	G	T	0	5	5	0	3	8	0	0
19	8637657	.	T	C	11	7	18	0	1	19	0	0
19	8645192	.	A	C	16	8	24	0	2	26	0	0
19	8647747	.	T	A	5	14	19	0	1	21	1	0
19	8680667	.	C	T	0	3	3	0	6	9	0	0
19	8681443	.	A	G	3	5	8	0	0	8	0	0
19	8681470	.	G	A	5	9	14	0	1	15	0	0
19	8681509	.	G	A	6	8	14	0	1	15	0	0
19	8724451	.	A	G	4	5	9	0	0	9	0	0
19	8724452	.	C	T	0	4	4	0	5	9	0	0
19	8747688	.	G	A	39	35	74	0	0	74	0	0
19	8817608	.	G	A	22	23	45	0	0	45	0	0
19	8831895	.	T	C	22	0	22	0	18	40	0	0
19	8831907	.	C	T	1	17	18	0	19	37	0	0
19	8834529	.	A	G	17	19	36	0	0	36	0	0
19	8834583	.	T	C	23	24	47	0	0	47	0	0
19	8836805	.	C	T	17	12	29	0	7	36	0	0
19	8880614	.	C	G	19	13	32	0	2	34	0	0
19	8894119	.	T	A	7	6	13	0	1	14	0	0
19	8894138	.	A	G	6	6	12	0	1	13	0	0
19	8895514	.	C	A	0	6	6	0	2	8	0	0
19	8895546	.	C	T	7	5	12	0	0	12	0	0
19	8895630	.	C	T	4	7	11	0	0	11	0	0
19	8897625	.	A	C	4	0	4	0	6	10	0	0
19	8898125	.	G	A	6	2	8	0	0	8	0	0
19	8898184	.	G	A	9	9	18	0	0	18	0	0
19	8898188	.	G	A	10	9	19	0	0	19	0	0
19	8898597	.	A	C	7	0	7	0	4	11	0	0
19	8901030	.	T	C	4	4	8	0	0	8	0	0
19	8901419	.	A	G	1	4	5	0	0	5	0	0
19	8901446	.	T	G	2	3	5	0	0	5	0	0
19	8928718	.	G	A	11	11	22	0	0	22	0	0
19	8928767	.	G	C	14	7	21	0	2	23	0	0
19	8929057	.	G	A	9	7	16	0	0	16	0	0
19	8929708	.	A	T	11	10	21	0	0	22	1	0
19	8929839	.	G	A	16	10	26	0	1	27	0	0
19	8929860	.	T	C	19	10	29	0	0	29	0	0
19	8932643	.	T	C	11	0	11	0	11	22	0	0
19	8939917	.	C	T	19	12	31	0	1	32	0	0
19	8958797	.	C	T	9	7	16	0	1	17	0	0
19	8958892	.	A	G	14	16	30	0	1	31	0	0
19	8962835	.	C	T	9	7	16	0	1	17	0	0
19	8978304	.	A	T	2	2	4	0	0	4	0	0
19	8978334	.	G	A	3	2	5	0	0	5	0	0
19	8979018	.	T	C	3	3	6	0	0	6	0	0
19	8979221	.	T	G	3	1	4	0	1	5	0	0
19	8985221	.	G	A	11	6	17	0	1	18	0	0
19	8985408	.	C	T	9	6	15	0	0	15	0	0
19	8985564	.	G	A	2	16	18	0	14	32	0	0
19	8989992	.	G	A	5	9	14	0	15	29	0	0
19	8997629	.	G	A	10	13	23	0	0	23	0	0
19	8997903	.	C	T	18	19	37	0	1	38	0	0
19	9000665	.	C	T	28	23	51	0	1	52	0	0
19	9000674	.	T	C	30	23	53	0	2	55	0	0
19	9000907	.	A	G	16	1	17	0	21	38	0	0
19	9001058	.	C	T	8	24	32	0	1	33	0	0
19	9001100	.	C	T	20	7	27	1	2	30	0	0
19	9001151	.	C	T	12	16	28	1	0	29	0	0
19	9001246	.	C	T	13	12	25	0	1	26	0	0
19	9001315	.	C	T	12	16	28	0	0	28	0	0
19	9001317	.	G	A	17	12	29	0	0	29	0	0
19	9033383	.	A	T	4	4	8	0	0	8	0	0
19	9033453	.	C	A	5	3	8	2	0	10	0	0
19	9043035	.	C	T	8	6	14	0	4	18	0	0
19	9045651	.	A	T	5	5	10	0	0	10	0	0
19	9046119	.	G	C	9	5	14	0	0	14	0	0
19	9046230	.	T	G	9	6	15	0	3	18	0	0
19	9046327	.	C	T	10	8	18	0	2	20	0	0
19	9046383	.	T	A	13	5	18	0	3	21	0	0
19	9046467	.	G	A	7	16	23	0	1	24	0	0
19	9046542	.	A	C	8	9	17	0	3	20	0	0
19	9046551	.	T	C	12	8	20	0	0	20	0	0
19	9047004	.	G	A	0	13	13	0	6	19	0	0
19	9047283	.	A	G	4	6	10	0	1	11	0	0
19	9047806	.	T	A	13	12	25	0	2	27	0	0
19	9048345	.	C	T	4	15	19	0	1	20	0	0
19	9048538	.	A	C	11	10	21	0	0	21	0	0
19	9048614	.	C	T	15	10	25	0	1	26	0	0
19	9050305	.	G	A	18	17	35	0	3	38	0	0
19	9050319	.	C	T	17	17	34	0	0	34	0	0
19	9050737	.	G	C	7	13	20	0	0	20	0	0
19	9050745	.	A	G	7	14	21	0	0	21	0	0
19	9055793	.	C	T	10	19	29	0	1	30	0	0
19	9058454	.	T	C	14	12	26	0	0	26	0	0
19	9064759	.	T	C	16	9	25	0	0	25	0	0
19	9064777	.	C	A	16	11	27	0	2	29	0	0
19	9064822	.	A	G	17	15	32	0	0	32	0	0
19	9064853	.	T	C	19	16	35	0	0	35	0	0
19	9064885	.	G	A	20	12	32	0	0	32	0	0
19	9067211	.	G	A	18	12	30	0	0	30	0	0
19	9070546	.	T	G	11	1	12	0	11	23	0	0
19	9072451	.	C	T	19	12	31	0	1	32	0	0
19	9077465	.	C	T	16	18	34	0	0	34	0	0
19	9084688	.	T	C	14	18	32	0	2	34	0	0
19	9085423	.	G	A	7	11	18	0	3	21	0	0
19	9085730	.	A	G	9	0	9	0	1	13	3	0
19	9085757	.	A	C	17	11	28	0	1	29	0	0
19	9086084	.	T	A	19	23	42	0	0	42	0	0
19	9086132	.	C	A	22	18	40	2	0	42	0	0
19	9086416	.	T	A	4	3	7	0	0	7	0	0
19	9086429	.	G	T	4	9	13	0	0	13	0	0
19	9111649	.	T	G	2	3	5	0	0	5	0	0
19	9111711	.	G	T	3	3	6	1	1	8	0	0
19	9111712	.	T	A	4	3	7	1	0	8	0	0
19	9116534	.	A	G	4	0	4	0	4	8	0	0
19	9117473	.	T	G	6	7	13	0	1	14	0	0
19	9125062	.	G	A	9	7	16	0	2	18	0	0
19	9130205	.	T	A	1	4	5	0	1	6	0	0
19	9135053	.	C	T	7	5	12	0	1	13	0	0
19	9135754	.	A	T	5	11	16	0	0	16	0	0
19	9138850	.	C	A	10	8	18	0	1	19	0	0
19	9140507	.	A	G	11	16	27	0	0	27	0	0
19	9140618	.	C	T	11	16	27	0	0	27	0	0
19	9140675	.	A	T	14	13	27	0	0	27	0	0
19	9144234	.	C	T	7	3	10	0	1	11	0	0
19	9161595	.	G	A	22	15	37	0	3	40	0	0
19	9161621	.	C	T	23	18	41	0	1	42	0	0
19	9161631	.	T	G	21	20	41	0	0	41	0	0
19	9161824	.	T	C	12	20	32	0	2	34	0	0
19	9161830	.	C	T	23	13	36	0	0	36	0	0
19	9166374	.	G	A	18	23	41	0	2	43	0	0
19	9168513	.	C	T	15	26	41	0	3	44	0	0
19	9168947	.	G	T	1	9	10	0	22	32	0	0
19	9169099	.	G	A	8	16	24	0	1	25	0	0
19	9169162	.	G	C	6	4	10	0	0	10	0	0
19	9216201	.	T	A	18	9	27	0	13	40	0	0
19	9216221	.	A	C	18	20	38	0	2	40	0	0
19	9216367	.	G	A	17	15	32	0	1	33	0	0
19	9217143	.	C	T	24	15	39	0	2	41	0	0
19	9218405	.	G	A	25	13	38	0	2	40	0	0
19	9220813	.	C	T	23	16	39	1	2	42	0	0
19	9220828	.	C	T	23	16	39	1	1	41	0	0
19	9220849	.	T	C	17	16	33	1	2	36	0	0
19	9220939	.	T	C	14	20	34	0	1	35	0	0
19	9223369	.	T	C	17	26	43	0	1	44	0	0
19	9228196	.	T	G	21	22	43	0	2	45	0	0
19	9228378	.	A	G	16	0	16	0	12	28	0	0
19	9228380	.	C	T	17	10	27	0	1	28	0	0
19	9228428	.	G	T	21	5	26	0	2	28	0	0
19	9240536	.	C	T	3	6	9	0	1	10	0	0
19	9240607	.	G	T	1	3	4	0	0	4	0	0
19	9240882	.	G	A	4	5	9	0	0	9	0	0
19	9244492	.	G	T	0	2	2	0	1	3	0	0
19	9245752	.	A	G	2	2	4	0	0	4	0	0
19	9247534	.	C	G	5	0	5	0	3	8	0	0
19	9247543	.	C	T	5	3	8	0	0	8	0	0
19	9247724	.	C	T	2	2	4	0	0	4	0	0
19	9251136	.	G	A	0	2	2	0	4	6	0	0
19	9252173	.	A	T	0	4	4	0	1	5	0	0
19	9252183	.	C	A	1	4	5	0	0	5	0	0
19	9254877	.	C	T	4	3	7	0	0	7	0	0
19	9255906	.	C	T	7	5	12	0	1	13	0	0
19	9255915	.	C	A	6	4	10	0	2	12	0	0
19	9257536	.	G	A	1	2	3	0	6	9	0	0
19	9257885	.	A	G	3	3	6	0	0	6	0	0
19	9262519	.	C	T	2	3	5	0	1	6	0	0
19	9262904	.	C	T	3	4	7	0	1	8	0	0
19	9263000	.	A	G	2	4	6	0	0	6	0	0
19	9265267	.	G	A	0	4	4	0	5	9	0	0
19	9265297	.	G	A	5	4	9	0	0	9	0	0
19	9265377	.	C	T	2	4	6	0	0	6	0	0
19	9265417	.	C	T	4	4	8	0	0	8	0	0
19	9265429	.	G	T	3	4	7	0	2	9	0	0
19	9265516	.	A	C	3	4	7	0	0	7	0	0
19	9265517	.	G	A	4	3	7	0	1	8	0	0
19	9266121	.	T	C	6	6	12	0	0	12	0	0
19	9266326	.	C	T	9	9	18	0	0	18	0	0
19	9266793	.	A	C	7	3	10	0	1	11	0	0
19	9266963	.	C	T	5	7	12	0	1	13	0	0
19	9268379	.	G	A	4	8	12	0	0	12	0	0
19	9268433	.	C	T	4	6	10	0	1	11	0	0
19	9268458	.	G	A	5	6	11	0	0	11	0	0
19	9268468	.	A	C	6	6	12	0	0	12	0	0
19	9268589	.	A	G	5	1	6	0	6	12	0	0
19	9268619	.	C	A	4	7	11	0	0	11	0	0
19	9273768	.	T	A	10	4	14	0	1	15	0	0
19	9274070	.	G	A	4	6	10	0	3	13	0	0
19	9274095	.	G	T	6	7	13	0	0	13	0	0
19	9274248	.	T	A	7	5	12	0	2	14	0	0
19	9274574	.	C	T	3	3	6	0	0	6	0	0
19	9274666	.	T	C	2	6	8	0	0	8	0	0
19	9274705	.	C	T	3	2	5	0	0	5	0	0
19	9458166	.	A	G	23	0	23	0	30	53	0	0
19	9458181	.	A	C	20	29	49	0	2	51	0	0
19	9458304	.	G	A	12	18	30	0	0	30	0	0
19	9458328	.	T	C	14	17	31	0	1	32	0	0
19	9458421	.	G	A	14	12	26	0	3	29	0	0
19	9458463	.	C	T	22	22	44	0	0	44	0	0
19	9459325	.	T	A	23	17	40	0	1	41	0	0
19	9459330	.	C	T	25	9	34	0	1	35	0	0
19	9459378	.	A	G	32	0	32	0	20	52	0	0
19	9459597	.	G	A	4	13	17	0	20	37	0	0
19	9459673	.	G	A	3	13	16	0	24	40	0	0
19	9459820	.	T	C	18	22	40	0	2	42	0	0
19	9460128	.	A	C	22	6	28	0	2	30	0	0
19	9460196	.	A	G	16	19	35	0	0	35	0	0
19	9460499	.	A	G	18	20	38	0	1	39	0	0
19	9460531	.	G	T	21	24	45	0	3	48	0	0
19	9461072	.	A	G	32	22	54	0	1	55	0	0
19	9461141	.	T	G	20	30	50	0	0	50	0	0
19	9461376	.	A	G	33	25	58	0	4	62	0	0
19	9461841	.	A	G	36	38	74	0	2	76	0	0
19	9462810	.	T	A	33	40	73	0	5	78	0	0
19	9471066	.	G	A	41	29	70	0	3	73	0	0
19	9472368	.	T	A	8	7	15	1	0	16	0	0
19	9472405	.	A	G	7	4	11	1	1	13	0	0
19	9472865	.	G	A	31	12	43	0	2	45	0	0
19	9481706	.	T	C	4	2	6	0	0	6	0	0
19	9481710	.	T	C	1	3	4	0	0	4	0	0
19	9481781	.	T	G	5	4	9	0	1	10	0	0
19	9481997	.	A	G	1	4	5	0	0	5	0	0
19	9482033	.	A	C	1	7	8	0	0	8	0	0
19	9482071	.	A	G	3	5	8	0	0	8	0	0
19	9482261	.	A	G	6	11	17	0	1	18	0	0
19	9485543	.	A	G	9	14	23	0	0	23	0	0
19	9502229	.	T	G	7	5	12	0	1	13	0	0
19	9502456	.	A	C	11	9	20	0	1	21	0	0
19	9502640	.	T	C	15	12	27	0	0	27	0	0
19	9502656	.	A	G	16	13	29	0	0	29	0	0
19	9502968	.	C	T	11	8	19	0	2	21	0	0
19	9503303	.	A	G	5	5	10	0	0	10	0	0
19	9503356	.	T	G	6	7	13	0	0	13	0	0
19	9513443	.	T	C	9	7	16	0	1	17	0	0
19	9513572	.	A	C	6	12	18	0	0	18	0	0
19	9513863	.	A	C	9	10	19	0	0	19	0	0
19	9513869	.	A	C	11	10	21	0	0	21	0	0
19	9516869	.	A	G	10	9	19	0	3	22	0	0
19	9519284	.	G	A	5	9	14	0	0	14	0	0
19	9533299	.	C	G	11	5	16	1	2	19	0	0
19	9585421	.	C	T	8	10	18	0	0	18	0	0
19	9585436	.	G	A	6	10	16	0	2	18	0	0
19	9598053	.	C	T	9	10	19	0	1	20	0	0
19	9598080	.	A	G	7	10	17	0	2	19	0	0
19	9598119	.	C	A	12	14	26	0	1	27	0	0
19	9603062	.	C	T	5	7	12	0	0	12	0	0
19	9603160	.	G	A	1	17	18	0	7	25	0	0
19	9603233	.	G	T	3	4	7	0	12	20	1	0
19	9603425	.	C	T	13	13	26	0	0	26	0	0
19	9603432	.	T	A	13	13	26	0	0	26	0	0
19	9603752	.	C	T	4	5	9	0	2	11	0	0
19	9603975	.	G	T	3	7	10	0	2	12	0	0
19	9604050	.	T	A	7	5	12	0	0	12	0	0
19	9604073	.	T	A	2	5	7	0	0	7	0	0
19	9604114	.	A	G	1	4	5	0	0	5	0	0
19	9685506	.	A	G	17	15	32	0	0	32	0	0
19	9685695	.	A	G	28	22	50	0	0	50	0	0
19	9686123	.	G	T	19	9	28	0	4	32	0	0
19	9686128	.	A	G	25	11	36	0	1	37	0	0
19	9686160	.	T	C	26	13	39	0	2	41	0	0
19	9686163	.	C	A	27	13	40	0	1	41	0	0
19	9686421	.	G	T	14	15	29	0	2	31	0	0
19	9686515	.	T	A	16	13	29	1	1	31	0	0
19	9686519	.	G	A	14	13	27	1	2	30	0	0
19	9686615	.	T	C	17	17	34	0	1	35	0	0
19	9686627	.	T	C	14	19	33	0	1	34	0	0
19	9686678	.	T	A	24	16	40	0	0	40	0	0
19	9686806	.	T	C	16	9	25	1	1	27	0	0
19	9686807	.	C	T	17	8	25	1	1	27	0	0
19	9686902	.	T	A	7	13	20	0	0	20	0	0
19	9686905	.	T	C	6	1	7	0	12	19	0	0
19	9687001	.	T	G	15	7	22	0	0	22	0	0
19	9687146	.	T	C	28	18	46	0	1	47	0	0
19	9687206	.	T	A	24	17	41	0	1	42	0	0
19	9687306	.	G	A	19	22	41	0	1	42	0	0
19	9691780	.	A	G	27	13	40	0	1	41	0	0
19	9700886	.	T	C	8	0	8	0	8	16	0	0
19	9711421	.	T	C	8	9	17	0	1	18	0	0
19	9711444	.	G	A	10	10	20	0	0	20	0	0
19	9712337	.	G	A	14	9	23	0	1	24	0	0
19	9712357	.	T	A	17	8	25	0	2	27	0	0
19	9712444	.	G	A	10	10	20	0	2	22	0	0
19	9712514	.	C	T	11	4	15	0	0	15	0	0
19	9813905	.	A	G	9	15	24	0	2	26	0	0
19	9813942	.	A	G	8	14	22	0	2	24	0	0
19	9814291	.	C	T	3	20	23	0	20	43	0	0
19	9814336	.	T	C	21	23	44	0	2	46	0	0
19	9814423	.	A	G	20	25	45	0	1	46	0	0
19	9814444	.	G	A	18	21	39	0	4	43	0	0
19	9814504	.	G	A	19	25	44	0	1	45	0	0
19	9814516	.	A	G	16	29	45	0	1	46	0	0
19	9814549	.	T	C	20	30	50	0	3	53	0	0
19	9814611	.	A	G	11	9	20	0	2	22	0	0
19	9814621	.	C	T	1	6	7	0	12	19	0	0
19	9822566	.	G	C	14	23	37	0	1	38	0	0
19	9822610	.	G	A	15	20	35	0	1	36	0	0
19	9840924	.	C	T	11	15	26	0	2	28	0	0
19	9841006	.	A	G	15	19	34	0	1	35	0	0
19	9841035	.	G	A	11	8	19	0	0	19	0	0
19	9841054	.	T	C	9	0	9	0	7	16	0	0
19	9841077	.	T	A	7	5	12	0	0	12	0	0
19	9841203	.	A	T	15	12	27	0	0	27	0	0
19	9841450	.	C	G	14	9	23	0	0	23	0	0
19	9841523	.	G	A	15	12	27	0	2	29	0	0
19	9842252	.	T	C	17	22	39	0	4	43	0	0
19	9859170	.	A	G	7	10	17	0	1	18	0	0
19	9866930	.	C	G	6	9	15	0	1	16	0	0
19	9910842	.	G	A	10	9	19	0	1	20	0	0
19	9911566	.	T	A	5	9	14	0	0	14	0	0
19	9911587	.	T	G	5	7	12	0	0	12	0	0
19	9911904	.	A	T	5	4	9	0	1	10	0	0
19	9911948	.	G	A	7	6	13	0	0	13	0	0
19	9911955	.	T	A	6	4	10	0	3	13	0	0
19	9912040	.	G	A	14	8	22	1	1	24	0	0
19	9912113	.	A	C	7	7	14	0	0	14	0	0
19	9912117	.	C	T	8	6	14	0	1	15	0	0
19	9912561	.	A	C	1	7	8	2	0	10	0	0
19	9912663	.	G	C	5	0	5	0	6	11	0	0
19	9912665	.	G	T	4	4	8	0	2	10	0	0
19	9912844	.	A	C	11	4	15	1	1	17	0	0
19	9914424	.	T	A	4	7	11	0	0	11	0	0
19	9914737	.	A	G	2	6	8	0	1	9	0	0
19	9914866	.	T	A	6	8	14	0	2	16	0	0
19	9916197	.	C	T	2	5	7	0	0	7	0	0
19	9916597	.	C	T	4	2	6	0	1	7	0	0
19	9916630	.	G	T	5	3	8	0	1	9	0	0
19	9916786	.	A	G	6	3	9	0	1	10	0	0
19	9916840	.	G	A	4	5	9	0	0	9	0	0
19	9916918	.	A	G	2	5	7	0	0	7	0	0
19	9917581	.	G	A	3	9	12	0	0	12	0	0
19	9919114	.	G	T	1	2	3	0	1	4	0	0
19	9919150	.	C	A	0	2	2	0	2	4	0	0
19	10007696	.	T	A	2	2	4	0	0	4	0	0
19	10177382	.	C	A	20	14	34	0	0	34	0	0
19	10177951	.	A	G	21	17	38	0	0	38	0	0
19	10190085	.	A	G	4	6	10	0	0	10	0	0
19	10195375	.	C	G	3	5	8	0	0	8	0	0
19	10195376	.	A	C	2	0	2	0	5	7	0	0
19	10195432	.	T	C	7	4	11	0	0	11	0	0
19	10196049	.	T	A	9	6	15	0	0	15	0	0
19	10201566	.	T	G	10	14	24	0	1	25	0	0
19	10201719	.	A	G	13	17	30	0	1	31	0	0
19	10202598	.	T	C	11	0	11	0	15	26	0	0
19	10203420	.	T	C	17	12	29	0	1	30	0	0
19	10203480	.	C	T	2	12	14	0	16	30	0	0
19	10203936	.	T	G	14	14	28	0	0	28	0	0
19	10204023	.	G	A	10	12	22	0	0	22	0	0
19	10204476	.	C	T	9	4	13	0	1	14	0	0
19	10205409	.	T	A	8	9	17	0	1	18	0	0
19	10205804	.	T	C	3	0	3	0	3	6	0	0
19	10205813	.	T	C	2	3	5	0	0	5	0	0
19	10205949	.	G	A	5	5	10	0	1	11	0	0
19	10206414	.	G	A	8	10	18	0	0	18	0	0
19	10206420	.	G	A	9	8	17	0	0	17	0	0
19	10206552	.	A	G	5	6	11	0	2	13	0	0
19	10207704	.	A	T	7	3	10	0	0	10	0	0
19	10218136	.	T	A	21	10	31	1	0	32	0	0
19	10218807	.	C	T	3	6	9	0	5	14	0	0
19	10219051	.	T	A	7	6	13	0	0	13	0	0
19	10219186	.	C	A	18	14	32	0	1	33	0	0
19	10219209	.	T	G	16	12	28	0	1	29	0	0
19	10219387	.	T	C	19	13	32	0	1	33	0	0
19	10220013	.	G	A	18	29	47	1	4	52	0	0
19	10220283	.	T	G	16	22	38	0	0	38	0	0
19	10235373	.	T	C	18	16	34	0	1	35	0	0
19	10235899	.	G	C	19	24	43	0	0	43	0	0
19	10236249	.	C	T	16	11	27	0	1	28	0	0
19	10236490	.	C	A	14	10	24	1	0	25	0	0
19	10236569	.	T	C	7	18	25	0	4	29	0	0
19	10236853	.	A	G	6	6	12	0	0	12	0	0
19	10237198	.	G	C	4	9	13	0	2	15	0	0
19	10237241	.	G	A	8	8	16	0	2	18	0	0
19	10237394	.	A	G	18	9	27	0	0	27	0	0
19	10237446	.	A	T	28	16	44	0	1	45	0	0
19	10237815	.	A	T	6	6	12	0	1	13	0	0
19	10237950	.	T	C	8	0	8	0	13	21	0	0
19	10238011	.	G	C	9	0	9	0	12	21	0	0
19	10238045	.	C	G	10	11	21	0	0	21	0	0
19	10238348	.	G	A	3	6	9	0	0	9	0	0
19	10238350	.	C	G	2	6	8	0	0	8	0	0
19	10238580	.	G	A	13	6	19	0	0	19	0	0
19	10252413	.	T	C	4	8	12	0	0	12	0	0
19	10252630	.	G	C	2	1	3	0	2	5	0	0
19	10252650	.	A	G	5	1	6	0	1	7	0	0
19	10252679	.	A	T	5	5	10	0	0	10	0	0
19	10252792	.	T	C	2	4	6	0	0	6	0	0
19	10252803	.	T	C	4	3	7	0	0	7	0	0
19	10252999	.	A	G	2	2	4	0	0	4	0	0
19	10253058	.	A	T	5	6	11	0	0	11	0	0
19	10253087	.	T	G	5	6	11	0	0	11	0	0
19	10253140	.	A	T	7	3	10	0	0	10	0	0
19	10253160	.	G	A	8	5	13	0	0	13	0	0
19	10253516	.	T	A	3	4	7	0	0	7	0	0
19	10253517	.	C	A	3	4	7	0	0	7	0	0
19	10253759	.	A	G	5	6	11	0	0	11	0	0
19	10253812	.	T	A	4	6	10	0	0	10	0	0
19	10253915	.	T	C	2	8	10	0	0	10	0	0
19	10253977	.	T	C	3	0	3	0	3	6	0	0
19	10253985	.	G	A	4	2	6	0	0	6	0	0
19	10254048	.	C	T	4	3	7	0	0	7	0	0
19	10254063	.	T	A	4	2	6	0	1	7	0	0
19	10254128	.	T	G	3	2	5	0	0	5	0	0
19	10254146	.	A	C	5	2	7	0	1	8	0	0
19	10254556	.	T	C	3	1	4	0	0	4	0	0
19	10254580	.	G	A	4	2	6	0	0	6	0	0
19	10254690	.	A	C	6	5	11	0	0	11	0	0
19	10254772	.	C	T	5	5	10	0	0	10	0	0
19	10254840	.	C	T	2	4	6	0	3	9	0	0
19	10255527	.	C	T	0	2	2	0	2	4	0	0
19	10255680	.	G	A	6	5	11	1	0	12	0	0
19	10255702	.	A	C	6	6	12	1	0	13	0	0
19	10264727	.	T	G	6	3	9	0	0	9	0	0
19	10272803	.	T	C	1	0	1	0	2	3	0	0
19	10273753	.	C	T	0	5	5	0	4	9	0	0
19	10274118	.	T	C	1	3	4	0	1	5	0	0
19	10299174	.	A	C	11	10	21	0	1	22	0	0
19	10299383	.	G	A	19	10	29	0	1	30	0	0
19	10299579	.	C	A	8	11	19	0	0	19	0	0
19	10299593	.	A	G	7	7	14	0	0	14	0	0
19	10299706	.	C	T	1	21	22	0	18	40	0	0
19	10301236	.	T	C	17	20	37	0	0	37	0	0
19	10318746	.	G	A	4	4	8	0	1	9	0	0
19	10376610	.	A	C	18	13	31	0	2	33	0	0
19	10377097	.	C	T	13	25	38	0	0	38	0	0
19	10377534	.	G	T	17	12	29	0	0	29	0	0
19	10377633	.	A	G	7	17	24	0	1	25	0	0
19	10377777	.	T	C	19	7	26	0	0	26	0	0
19	10377815	.	A	C	12	19	31	0	0	31	0	0
19	10377892	.	A	C	19	21	40	1	0	41	0	0
19	10377911	.	A	T	18	20	38	1	0	39	0	0
19	10378192	.	G	A	23	17	40	0	0	40	0	0
19	10378457	.	A	T	10	9	19	0	2	21	0	0
19	10378544	.	C	T	11	13	24	0	2	26	0	0
19	10378599	.	T	C	17	11	28	0	2	30	0	0
19	10378618	.	C	T	12	18	30	0	2	32	0	0
19	10378700	.	A	G	12	9	21	0	0	21	0	0
19	10378848	.	C	T	12	14	26	0	0	26	0	0
19	10378868	.	T	C	13	1	14	0	11	25	0	0
19	10378889	.	C	T	12	12	24	0	1	25	0	0
19	10378959	.	C	A	10	18	28	0	3	31	0	0
19	10379011	.	T	C	6	6	12	0	2	14	0	0
19	10379183	.	C	A	9	9	18	1	0	19	0	0
19	10379192	.	C	T	10	8	18	1	0	19	0	0
19	10379314	.	C	T	4	12	16	0	14	30	0	0
19	10379321	.	C	T	17	12	29	0	0	29	0	0
19	10379369	.	C	T	11	10	21	0	1	22	0	0
19	10379555	.	T	G	16	11	27	0	0	27	0	0
19	10379575	.	A	G	14	8	22	0	1	23	0	0
19	10379821	.	T	A	22	18	40	0	2	42	0	0
19	10379833	.	T	G	21	18	39	0	2	41	0	0
19	10379873	.	A	G	19	17	36	0	2	38	0	0
19	10379965	.	T	C	18	11	29	0	1	30	0	0
19	10383100	.	A	G	16	19	35	0	1	36	0	0
19	10383112	.	G	T	19	14	33	0	3	36	0	0
19	10383532	.	G	A	10	13	23	0	0	23	0	0
19	10383533	.	T	A	9	13	22	0	1	23	0	0
19	10386619	.	C	T	18	13	31	0	1	32	0	0
19	10388285	.	C	T	9	12	21	0	1	22	0	0
19	10393034	.	G	A	8	3	11	0	0	11	0	0
19	10393072	.	A	G	11	7	18	0	0	18	0	0
19	10394835	.	T	G	11	8	19	0	1	20	0	0
19	10407312	.	C	T	21	24	45	0	2	47	0	0
19	10407546	.	A	T	31	19	50	0	2	52	0	0
19	10407732	.	T	A	28	26	54	0	4	58	0	0
19	10407767	.	G	T	23	33	56	0	0	56	0	0
19	10496749	.	G	A	2	2	4	0	0	4	0	0
19	10496767	.	G	T	0	2	2	0	2	4	0	0
19	10558602	.	T	C	5	7	12	0	0	12	0	0
19	10558604	.	G	A	5	7	12	0	0	12	0	0
19	10561001	.	A	G	11	19	30	0	1	31	0	0
19	10562737	.	T	C	6	10	16	0	1	17	0	0
19	10565385	.	C	T	16	7	23	0	0	23	0	0
19	10569122	.	T	C	11	14	25	0	0	25	0	0
19	10575315	.	T	C	8	10	18	0	1	19	0	0
19	10575318	.	G	T	8	9	17	0	2	19	0	0
19	10575565	.	G	C	1	7	8	1	4	13	0	0
19	10575824	.	T	G	13	8	21	0	1	22	0	0
19	10576120	.	G	T	4	7	11	0	0	11	0	0
19	10576138	.	G	T	4	7	11	0	0	11	0	0
19	10576289	.	C	G	1	9	10	0	1	11	0	0
19	10576297	.	A	T	1	9	10	0	0	10	0	0
19	10576442	.	A	G	7	3	10	0	0	10	0	0
19	10576482	.	C	T	1	7	8	0	1	9	0	0
19	10576520	.	T	C	5	5	10	0	1	11	0	0
19	10576909	.	G	A	7	9	16	0	0	16	0	0
19	10576970	.	A	T	9	12	21	0	0	21	0	0
19	10577011	.	T	G	13	0	13	0	11	24	0	0
19	10577194	.	T	A	5	4	9	0	0	9	0	0
19	10577253	.	T	A	3	8	11	0	1	12	0	0
19	10649711	.	T	A	4	8	12	0	0	12	0	0
19	10649722	.	T	C	4	7	11	0	0	11	0	0
19	10649830	.	G	T	7	5	12	0	0	12	0	0
19	10654540	.	G	A	6	2	8	0	0	8	0	0
19	10654553	.	C	A	0	5	5	0	3	8	0	0
19	10656436	.	A	G	1	3	4	0	0	4	0	0
19	10668840	.	G	A	2	6	8	0	0	8	0	0
19	10671730	.	A	G	1	2	3	0	0	3	0	0
19	10673220	.	A	G	1	4	5	0	1	6	0	0
19	10678222	.	T	C	1	2	3	0	0	3	0	0
19	10681344	.	C	T	3	6	9	0	0	9	0	0
19	10826032	.	G	A	1	6	7	0	0	7	0	0
19	10826564	.	A	G	2	7	9	0	0	9	0	0
19	10841477	.	G	T	6	15	21	0	1	22	0	0
19	10864729	.	C	A	1	2	3	0	0	3	0	0
19	10865312	.	C	T	1	2	3	0	0	3	0	0
19	10867358	.	T	G	1	2	3	0	0	3	0	0
19	10867365	.	G	T	1	2	3	0	0	3	0	0
19	10868522	.	G	A	1	2	3	0	0	3	0	0
19	10869001	.	A	C	5	3	8	0	0	8	0	0
19	10869022	.	C	A	2	3	5	0	0	5	0	0
19	10869501	.	C	A	1	2	3	0	0	3	0	0
19	10870305	.	A	G	4	1	5	0	3	8	0	0
19	10870361	.	C	T	5	4	9	0	0	9	0	0
19	10870602	.	G	A	4	4	8	0	0	8	0	0
19	10870737	.	A	G	2	3	5	0	1	6	0	0
19	10870845	.	C	T	5	2	7	0	0	7	0	0
19	10871719	.	A	G	6	8	14	0	0	14	0	0
19	10871803	.	C	T	0	8	8	0	11	19	0	0
19	10871823	.	A	G	8	13	21	0	0	21	0	0
19	10872397	.	C	T	14	15	29	0	1	30	0	0
19	10875854	.	A	G	14	15	29	0	1	30	0	0
19	10876446	.	C	T	13	15	28	0	2	30	0	0
19	10893284	.	G	A	4	5	9	0	0	9	0	0
19	10893374	.	C	T	1	7	8	0	4	12	0	0
19	10901501	.	A	G	5	2	7	0	0	7	0	0
19	10908308	.	T	C	2	2	4	0	0	4	0	0
19	10989189	.	A	C	13	8	21	0	0	21	0	0
19	10989343	.	T	A	15	18	33	0	1	34	0	0
19	10989457	.	T	C	17	16	33	0	3	36	0	0
19	10989511	.	A	G	18	12	30	0	1	31	0	0
19	10989653	.	C	A	19	12	31	0	3	34	0	0
19	10999786	.	G	T	13	18	31	0	1	32	0	0
19	11014636	.	G	A	15	20	35	0	0	35	0	0
19	11014675	.	A	G	17	8	25	0	1	26	0	0
19	11015010	.	G	C	5	3	8	0	1	9	0	0
19	11015047	.	T	C	4	1	5	0	4	9	0	0
19	11039539	.	A	C	3	2	5	0	0	5	0	0
19	11039829	.	G	C	6	7	13	0	0	13	0	0
19	11040493	.	A	T	13	11	24	0	0	24	0	0
19	11045254	.	G	A	22	6	28	0	0	28	0	0
19	11045311	.	C	A	2	10	12	0	19	31	0	0
19	11045323	.	C	T	18	10	28	0	1	29	0	0
19	11045864	.	A	C	13	10	23	0	0	23	0	0
19	11048822	.	C	T	4	10	14	0	19	33	0	0
19	11051581	.	T	C	6	14	20	0	0	20	0	0
19	11063846	.	C	T	10	4	14	0	1	15	0	0
19	11070738	.	A	G	2	6	8	0	2	10	0	0
19	11070794	.	G	A	5	9	14	0	1	15	0	0
19	11078869	.	T	C	4	3	7	0	0	7	0	0
19	11079087	.	T	C	3	5	8	0	0	8	0	0
19	11079284	.	C	G	4	5	9	0	0	9	0	0
19	11093564	.	T	C	8	4	12	0	0	12	0	0
19	11093567	.	A	G	7	4	11	0	0	11	0	0
19	11174774	.	C	T	0	2	2	0	7	9	0	0
19	11174797	.	G	A	3	3	6	0	0	6	0	0
19	11191427	.	T	A	1	1	2	0	1	3	0	0
19	11231386	.	C	A	8	14	22	0	0	22	0	0
19	11237043	.	A	G	5	16	21	0	0	21	0	0
19	11237049	.	T	C	7	14	21	0	3	24	0	0
19	12937792	.	T	C	9	4	13	0	0	13	0	0
19	13151155	.	A	G	8	0	8	0	18	26	0	0
19	13413683	.	A	G	8	7	15	0	1	16	0	0
19	17377598	.	G	A	11	3	14	0	0	14	0	0
19	17515297	.	T	A	4	3	7	0	0	7	0	0
19	17517136	.	T	C	8	3	11	0	1	12	0	0
19	20753194	.	G	T	7	4	11	0	2	13	0	0
19	24388333	.	T	C	5	1	6	0	1	7	0	0
19	24916543	.	A	T	3	3	6	0	1	7	0	0
19	25971310	.	G	A	1	2	3	0	1	4	0	0
19	27469130	.	A	G	4	6	10	0	0	10	0	0
19	28289039	.	T	C	2	3	5	0	0	5	0	0
19	30521443	.	C	A	12	4	16	0	0	16	0	0
19	30521782	.	T	A	7	3	10	0	1	11	0	0
19	31517478	.	T	C	13	7	20	0	4	24	0	0
19	31532236	.	T	A	2	2	4	0	0	4	0	0
19	31551580	.	G	A	1	1	2	0	1	3	0	0
19	31555871	.	T	A	3	2	5	0	0	5	0	0
19	31560775	.	G	A	7	5	12	0	1	13	0	0
19	31569338	.	A	G	3	2	5	0	0	5	0	0
19	31569535	.	C	T	2	4	6	0	0	6	0	0
19	31571563	.	T	C	1	6	7	0	0	7	0	0
19	31571572	.	G	A	1	6	7	0	1	8	0	0
19	31575705	.	A	G	2	2	4	0	0	4	0	0
19	31576024	.	T	A	6	3	9	0	0	9	0	0
19	31576954	.	A	G	3	14	17	0	1	18	0	0
19	31579783	.	T	A	20	10	30	0	1	31	0	0
19	31579860	.	G	T	21	28	49	0	1	50	0	0
19	31580071	.	C	A	1	16	17	0	21	38	0	0
19	31580103	.	A	T	25	20	45	0	3	48	0	0
19	31580160	.	T	A	22	25	47	0	3	50	0	0
19	31580186	.	T	G	23	21	44	0	1	46	1	0
19	31580328	.	A	C	25	2	27	0	26	53	0	0
19	31582349	.	C	T	33	12	45	0	1	46	0	0
19	31583137	.	A	G	9	11	20	0	2	22	0	0
19	31583179	.	C	T	15	13	28	0	4	32	0	0
19	31583289	.	C	T	13	11	24	1	2	27	0	0
19	31583305	.	A	G	13	10	23	1	1	25	0	0
19	31584018	.	T	G	18	30	48	0	1	49	0	0
19	31585392	.	T	G	2	2	4	0	0	4	0	0
19	31585399	.	C	G	1	2	3	0	1	4	0	0
19	31593550	.	A	G	7	3	10	0	0	10	0	0
19	31593594	.	C	A	10	5	15	0	0	15	0	0
19	31593595	.	C	A	10	4	14	0	1	15	0	0
19	31593706	.	G	C	11	5	16	0	0	16	0	0
19	31593762	.	G	A	12	5	17	0	1	18	0	0
19	31593957	.	C	T	13	4	17	0	0	17	0	0
19	31596948	.	C	G	4	5	9	0	0	9	0	0
19	31598108	.	G	T	3	4	7	0	0	7	0	0
19	31598113	.	G	A	5	3	8	0	0	8	0	0
19	31603398	.	C	T	0	7	7	0	3	10	0	0
19	31603416	.	G	C	4	1	5	0	9	14	0	0
19	31612876	.	A	G	1	5	6	0	1	7	0	0
19	31613176	.	G	A	3	7	10	0	1	11	0	0
19	31621507	.	G	A	3	8	11	0	0	11	0	0
19	31621891	.	G	T	4	2	6	0	0	6	0	0
19	31621903	.	C	T	3	5	8	0	0	8	0	0
19	31771335	.	T	A	25	25	50	0	0	50	0	0
19	31789666	.	C	T	19	19	38	0	11	49	0	0
19	31790042	.	C	A	36	25	61	2	2	65	0	0
19	31790079	.	A	G	42	18	60	1	2	63	0	0
19	31790097	.	C	T	36	20	56	1	3	60	0	0
19	31790115	.	C	A	22	33	55	1	3	59	0	0
19	31790283	.	G	C	42	24	66	0	3	69	0	0
19	31790385	.	A	G	14	26	40	2	7	49	0	0
19	31797778	.	G	A	5	5	10	0	0	10	0	0
19	31797834	.	G	T	5	3	8	0	1	9	0	0
19	31798162	.	T	C	2	3	5	0	0	5	0	0
19	31798203	.	C	G	4	5	9	0	1	10	0	0
19	31798420	.	T	A	2	4	6	0	0	6	0	0
19	31798437	.	T	C	1	3	4	0	1	5	0	0
19	31798456	.	G	T	1	2	3	0	0	3	0	0
19	31798479	.	C	T	2	2	4	0	0	4	0	0
19	31798660	.	G	A	3	6	9	0	1	10	0	0
19	31798713	.	A	T	6	6	12	0	2	14	0	0
19	31798722	.	C	A	0	5	5	0	6	11	0	0
19	31798885	.	T	C	2	1	3	0	3	6	0	0
19	31799026	.	T	A	7	2	9	0	0	9	0	0
19	31800271	.	A	G	2	2	4	1	0	5	0	0
19	31800283	.	T	C	2	2	4	0	0	4	0	0
19	31878656	.	G	A	1	2	3	0	1	4	0	0
19	31891350	.	A	G	2	7	9	0	0	9	0	0
19	31938817	.	T	C	5	10	15	0	0	15	0	0
19	32041686	.	T	C	5	2	7	0	1	8	0	0
19	32041747	.	T	C	1	6	7	0	1	8	0	0
19	32049055	.	A	G	13	10	23	0	0	23	0	0
19	32049443	.	T	C	15	10	25	0	0	25	0	0
19	32049485	.	A	T	13	10	23	0	0	23	0	0
19	32049775	.	G	A	10	11	21	0	0	21	0	0
19	32049850	.	A	G	19	15	34	0	1	35	0	0
19	32049891	.	A	G	15	9	24	0	2	26	0	0
19	32050174	.	T	G	6	14	20	0	1	21	0	0
19	32050535	.	A	T	21	14	35	0	0	35	0	0
19	32050536	.	T	A	20	12	32	0	2	34	0	0
19	32050593	.	A	T	15	15	30	0	0	30	0	0
19	32050679	.	C	A	7	11	18	0	0	18	0	0
19	32050702	.	G	A	11	3	14	0	0	14	0	0
19	32050944	.	A	T	19	14	33	0	2	35	0	0
19	32051218	.	C	A	12	9	21	0	0	21	0	0
19	32051226	.	G	A	10	9	19	0	1	20	0	0
19	32051541	.	T	G	14	10	24	0	1	25	0	0
19	32051566	.	G	C	10	13	23	0	0	23	0	0
19	32064557	.	T	G	17	16	33	0	0	33	0	0
19	32064872	.	C	T	2	13	15	0	7	22	0	0
19	32079110	.	G	A	14	14	28	1	0	29	0	0
19	32149988	.	A	C	16	11	27	0	3	30	0	0
19	32150105	.	T	G	3	2	5	0	0	5	0	0
19	32169087	.	T	G	2	0	2	0	2	4	0	0
19	32169089	.	A	G	2	0	2	0	2	4	0	0
19	32202141	.	G	A	0	2	2	0	5	7	0	0
19	32202179	.	A	C	2	4	6	0	0	6	0	0
19	32202296	.	C	T	5	2	7	0	1	8	0	0
19	32456894	.	A	G	3	0	3	0	2	5	0	0
19	32457087	.	G	T	2	4	6	0	0	6	0	0
19	32457264	.	C	G	7	9	16	0	0	16	0	0
19	32457390	.	T	C	10	6	16	0	1	17	0	0
19	32457564	.	T	C	10	4	14	0	1	15	0	0
19	32458152	.	C	T	10	3	13	0	0	13	0	0
19	32458158	.	T	C	10	2	12	0	0	12	0	0
19	32458422	.	G	A	1	1	2	0	2	4	0	0
19	32458431	.	G	A	1	3	4	0	1	5	0	0
19	32461473	.	C	T	3	3	6	0	1	7	0	0
19	32473770	.	C	T	2	2	4	0	0	4	0	0
19	32473812	.	C	T	5	3	8	0	0	8	0	0
19	32474093	.	G	A	2	2	4	0	0	4	0	0
19	32474102	.	C	T	2	2	4	0	0	4	0	0
19	32474685	.	A	G	2	2	4	0	0	4	0	0
19	32474723	.	G	T	2	2	4	0	0	4	0	0
19	32474885	.	A	G	4	5	9	0	0	9	0	0
19	32475348	.	A	G	2	3	5	0	1	6	0	0
19	32487242	.	T	C	2	2	4	0	2	6	0	0
19	32490366	.	C	T	1	2	3	0	0	3	0	0
19	32497388	.	C	T	4	5	9	0	0	9	0	0
19	32499736	.	G	A	3	4	7	0	1	8	0	0
19	32499932	.	G	A	4	5	9	0	0	9	0	0
19	32500172	.	G	C	2	4	6	0	1	7	0	0
19	32500236	.	T	C	3	2	5	0	1	6	0	0
19	32505825	.	C	T	6	7	13	0	0	13	0	0
19	32505846	.	C	A	7	7	14	0	0	14	0	0
19	32505875	.	C	T	1	7	8	0	4	12	0	0
19	32505927	.	G	T	7	5	12	0	0	12	0	0
19	32515377	.	T	A	9	6	15	0	0	15	0	0
19	32572647	.	T	C	7	6	13	0	0	13	0	0
19	32572999	.	A	T	6	9	15	0	0	15	0	0
19	32573001	.	T	A	5	9	14	0	0	14	0	0
19	32573057	.	G	A	7	6	13	0	1	14	0	0
19	32573064	.	C	T	8	6	14	0	0	14	0	0
19	32573100	.	C	A	7	3	10	0	0	10	0	0
19	32573173	.	T	C	6	0	6	0	5	11	0	0
19	32573229	.	A	G	9	5	14	0	0	14	0	0
19	32573269	.	T	C	10	4	14	0	0	14	0	0
19	32575190	.	G	A	6	11	17	0	1	18	0	0
19	32588706	.	C	T	8	6	14	0	1	15	0	0
19	32588775	.	G	A	8	6	14	0	1	15	0	0
19	32600644	.	C	T	1	5	6	0	7	13	0	0
19	32600720	.	A	C	6	4	10	0	0	10	0	0
19	32600732	.	C	T	8	2	10	0	0	10	0	0
19	32623687	.	G	A	24	29	53	0	0	53	0	0
19	32624048	.	A	C	22	12	34	0	3	37	0	0
19	32624138	.	G	A	30	15	45	0	0	45	0	0
19	32624247	.	A	G	21	24	45	0	4	49	0	0
19	32638212	.	G	A	32	25	57	0	2	59	0	0
19	32767889	.	A	G	4	2	6	0	0	6	0	0
19	32767891	.	T	A	4	2	6	0	0	6	0	0
19	32768397	.	C	G	1	4	5	0	1	6	0	0
19	32768551	.	C	T	4	2	6	0	1	7	0	0
19	32768668	.	T	C	3	3	6	0	1	7	0	0
19	32768880	.	G	T	1	2	3	0	0	3	0	0
19	32768935	.	T	G	1	5	6	0	0	6	0	0
19	32769271	.	G	T	4	3	7	0	0	7	0	0
19	32769296	.	T	C	3	2	5	0	0	5	0	0
19	32774790	.	C	G	0	1	1	0	2	3	0	0
19	32774799	.	G	A	2	2	4	0	0	4	0	0
19	32807323	.	A	G	1	0	1	0	4	5	0	0
19	32807915	.	A	G	2	6	8	0	1	9	0	0
19	32807933	.	A	C	1	6	7	0	1	8	0	0
19	32808140	.	C	T	7	8	15	0	2	17	0	0
19	32808332	.	G	T	1	4	5	0	6	11	0	0
19	32814334	.	G	T	10	5	15	0	1	16	0	0
19	32818503	.	G	T	0	10	10	0	9	19	0	0
19	32818824	.	A	G	8	12	20	0	1	21	0	0
19	32818825	.	G	A	9	12	21	0	0	21	0	0
19	32818910	.	G	A	1	4	5	0	12	17	0	0
19	32819234	.	G	A	9	16	25	0	0	26	1	0
19	32819303	.	T	C	16	6	22	0	1	23	0	0
19	32819347	.	C	T	15	15	30	0	1	31	0	0
19	32819640	.	A	G	3	12	15	0	0	15	0	0
19	32819703	.	C	A	4	4	8	0	0	8	0	0
19	32819760	.	A	T	3	10	13	1	1	15	0	0
19	32819798	.	C	T	4	5	9	0	1	10	0	0
19	32819952	.	T	C	2	5	7	0	1	8	0	0
19	32838396	.	T	A	9	7	16	0	1	17	0	0
19	32838583	.	T	C	4	2	6	0	0	6	0	0
19	32838600	.	G	C	4	2	6	0	0	6	0	0
19	32838662	.	C	T	1	2	3	0	0	3	0	0
19	32838666	.	C	T	1	2	3	0	0	3	0	0
19	32864963	.	T	G	15	16	31	0	0	31	0	0
19	32865113	.	G	A	24	8	32	1	2	35	0	0
19	32865276	.	A	T	12	10	22	0	2	24	0	0
19	32865337	.	C	A	14	9	23	0	2	25	0	0
19	32865347	.	C	T	11	9	20	0	2	22	0	0
19	32865562	.	C	A	12	3	15	0	0	15	0	0
19	32865569	.	A	G	10	3	13	0	0	13	0	0
19	32866126	.	A	C	13	13	26	0	0	26	0	0
19	32866234	.	T	G	10	17	27	0	3	30	0	0
19	32866264	.	G	C	14	0	14	0	12	26	0	0
19	32866322	.	A	G	13	5	18	0	2	20	0	0
19	32866362	.	T	A	14	7	21	0	0	21	0	0
19	32866372	.	C	T	11	5	16	0	2	18	0	0
19	32866475	.	T	A	12	18	30	0	0	30	0	0
19	32866570	.	T	A	28	14	42	0	1	43	0	0
19	32866571	.	A	G	27	14	41	0	1	42	0	0
19	32866620	.	G	A	11	4	15	0	0	15	0	0
19	32866708	.	A	T	10	3	13	0	0	13	0	0
19	32867218	.	G	A	17	7	24	0	1	25	0	0
19	32867274	.	A	T	20	12	32	0	5	37	0	0
19	32872674	.	A	G	14	17	31	1	1	33	0	0
19	32878103	.	G	A	17	18	35	0	2	37	0	0
19	32878370	.	A	G	13	6	19	0	1	20	0	0
19	32884181	.	A	G	18	6	24	0	2	26	0	0
19	32884256	.	C	T	1	3	4	0	7	11	0	0
19	32895702	.	G	A	24	6	30	0	0	30	0	0
19	32895748	.	G	T	16	19	35	0	1	36	0	0
19	32895869	.	A	T	12	6	18	1	3	22	0	0
19	32895873	.	T	A	1	10	11	1	3	15	0	0
19	32896001	.	G	A	12	11	23	0	1	24	0	0
19	32896336	.	G	T	15	4	19	2	0	21	0	0
19	32896427	.	C	A	0	13	13	0	12	25	0	0
19	32896499	.	T	G	18	9	27	0	1	29	1	0
19	32896519	.	T	C	18	9	27	0	0	27	0	0
19	32899313	.	T	A	11	8	19	0	3	22	0	0
19	32899328	.	T	A	13	9	22	0	3	25	0	0
19	32899452	.	A	G	19	9	28	0	0	28	0	0
19	32907732	.	A	C	14	7	21	0	0	21	0	0
19	32919074	.	A	G	12	9	21	0	2	23	0	0
19	32919215	.	A	T	11	5	16	0	0	16	0	0
19	32928367	.	A	T	19	5	24	0	1	25	0	0
19	32931100	.	A	T	25	9	34	0	4	38	0	0
19	32931101	.	C	T	1	10	11	0	27	38	0	0
19	32933891	.	C	A	38	27	65	0	1	66	0	0
19	32935480	.	G	C	28	26	54	0	1	55	0	0
19	32936989	.	T	C	32	23	55	2	3	60	0	0
19	32937663	.	C	A	27	29	56	0	1	57	0	0
19	32944034	.	A	G	18	17	35	0	0	35	0	0
19	32951040	.	G	C	17	15	32	0	1	33	0	0
19	32954310	.	A	G	9	5	14	0	1	15	0	0
19	32979625	.	A	G	11	6	17	0	1	18	0	0
19	33029392	.	C	T	16	4	20	0	1	21	0	0
19	33029587	.	T	C	8	7	15	0	0	15	0	0
19	33043458	.	A	G	7	9	16	0	2	18	0	0
19	33043749	.	T	C	10	5	15	0	2	17	0	0
19	33061247	.	C	T	10	6	16	0	1	17	0	0
19	33066783	.	C	G	16	1	17	0	13	30	0	0
19	33071055	.	C	G	10	9	19	0	0	19	0	0
19	33071126	.	G	T	16	17	33	0	0	33	0	0
19	33071172	.	G	T	10	14	24	0	0	24	0	0
19	33071249	.	G	C	11	5	16	0	0	16	0	0
19	33071635	.	A	T	3	3	6	0	1	7	0	0
19	33071795	.	A	T	8	16	24	0	3	27	0	0
19	33095789	.	T	C	9	5	14	1	0	15	0	0
19	33106035	.	G	C	4	3	7	0	2	9	0	0
19	33123179	.	A	G	11	10	21	0	0	21	0	0
19	33124700	.	A	T	8	10	18	0	0	18	0	0
19	33127718	.	T	C	16	9	25	2	4	31	0	0
19	33131666	.	C	T	19	13	32	0	0	32	0	0
19	33132033	.	T	A	8	7	15	0	0	15	0	0
19	33136410	.	A	G	24	1	25	0	27	52	0	0
19	33137436	.	A	G	17	2	19	0	18	37	0	0
19	33137667	.	C	T	1	2	3	0	0	3	0	0
19	33139195	.	A	G	4	2	6	0	0	6	0	0
19	33139671	.	C	G	3	0	3	0	2	5	0	0
19	33139701	.	C	A	2	3	5	0	0	5	0	0
19	33140259	.	A	C	9	6	15	0	0	16	1	0
19	33140322	.	T	C	3	7	10	0	0	10	0	0
19	33202996	.	T	A	1	3	4	0	0	4	0	0
19	33203048	.	A	T	3	4	7	0	0	7	0	0
19	33203744	.	G	A	12	4	16	0	1	17	0	0
19	33204332	.	T	C	1	3	4	0	1	5	0	0
19	33204574	.	T	C	4	3	7	0	1	8	0	0
19	33205130	.	G	A	3	7	10	0	0	10	0	0
19	33205223	.	T	A	3	7	10	0	2	12	0	0
19	33205255	.	C	G	2	7	9	0	5	14	0	0
19	33205316	.	G	A	4	6	10	0	0	10	0	0
19	33211420	.	C	T	6	9	15	0	1	16	0	0
19	33211504	.	G	T	2	5	7	0	1	8	0	0
19	33211734	.	A	T	7	3	10	0	1	11	0	0
19	33211741	.	T	C	3	7	10	0	0	10	0	0
19	33270936	.	T	C	4	0	4	0	2	6	0	0
19	33476598	.	T	C	4	2	6	0	1	7	0	0
19	33511276	.	A	G	2	2	4	0	0	4	0	0
19	33512440	.	C	T	0	2	2	0	1	3	0	0
19	33513293	.	A	T	2	2	4	0	0	4	0	0
19	33513322	.	T	C	1	3	4	0	0	5	1	0
19	33513351	.	T	A	3	2	5	0	1	6	0	0
19	33514118	.	C	T	2	5	7	0	0	7	0	0
19	33514141	.	C	A	0	3	3	0	0	3	0	0
19	33514481	.	C	T	2	2	4	0	0	4	0	0
19	33514820	.	G	A	0	3	3	0	5	8	0	0
19	33701679	.	C	T	8	4	12	0	1	13	0	0
19	33701722	.	A	T	10	6	16	0	0	16	0	0
19	33701838	.	G	A	0	8	8	0	10	18	0	0
19	33701887	.	T	A	8	9	17	0	2	19	0	0
19	33701923	.	T	A	15	7	22	0	1	23	0	0
19	33732336	.	G	A	4	3	7	0	2	9	0	0
19	33732393	.	C	T	3	6	9	0	0	9	0	0
19	33755973	.	G	A	2	9	11	0	15	26	0	0
19	33755985	.	A	G	11	0	11	0	11	22	0	0
19	33756009	.	G	T	13	8	21	0	1	22	0	0
19	33765636	.	C	T	20	14	34	0	2	36	0	0
19	33772226	.	T	A	15	24	39	1	5	45	0	0
19	33772280	.	T	C	15	22	37	0	3	40	0	0
19	33775750	.	C	T	13	11	24	0	1	25	0	0
19	33775810	.	T	C	13	12	25	0	0	25	0	0
19	33782757	.	A	G	12	1	13	0	20	33	0	0
19	33782914	.	A	G	11	6	17	0	1	18	0	0
19	33783332	.	A	T	13	14	27	0	2	30	1	0
19	33784221	.	T	A	8	9	17	0	0	17	0	0
19	33784896	.	T	C	19	15	34	0	1	35	0	0
19	33784897	.	C	T	19	15	34	0	0	34	0	0
19	33784966	.	C	T	15	12	27	0	2	29	0	0
19	33784986	.	T	C	17	17	34	0	4	38	0	0
19	33785094	.	C	T	11	17	28	0	0	28	0	0
19	33785109	.	C	T	8	16	24	0	2	26	0	0
19	33785175	.	G	A	15	15	30	0	2	32	0	0
19	33785197	.	G	A	3	16	19	0	15	34	0	0
19	33785234	.	A	G	22	0	22	0	13	35	0	0
19	33785240	.	T	C	19	15	34	0	0	34	0	0
19	33785357	.	C	A	21	19	40	0	0	40	0	0
19	33785379	.	G	A	22	20	42	0	0	42	0	0
19	33785512	.	T	C	13	19	32	0	0	32	0	0
19	33785704	.	G	T	18	16	34	0	3	37	0	0
19	33785735	.	T	G	16	0	16	0	21	37	0	0
19	33836605	.	G	A	9	4	13	0	0	13	0	0
19	33836747	.	G	A	13	6	19	0	1	20	0	0
19	33837007	.	G	T	13	3	16	0	0	16	0	0
19	33837178	.	G	C	16	6	22	0	0	22	0	0
19	33837183	.	G	A	13	5	18	0	1	19	0	0
19	33839595	.	G	A	19	5	24	0	0	24	0	0
19	33847935	.	A	T	5	6	11	0	1	12	0	0
19	33856820	.	A	G	1	4	5	0	0	5	0	0
19	33858734	.	A	G	2	5	7	0	1	8	0	0
19	33861476	.	A	G	2	2	4	0	0	4	0	0
19	33861518	.	A	G	1	2	3	0	0	3	0	0
19	33864177	.	T	A	2	2	4	0	0	4	0	0
19	33868335	.	T	C	1	4	5	0	1	6	0	0
19	33871868	.	C	T	2	4	6	0	0	6	0	0
19	33872816	.	T	G	5	8	13	0	0	13	0	0
19	33872859	.	G	A	0	7	7	0	8	15	0	0
19	33888520	.	A	C	30	19	49	0	2	51	0	0
19	33888881	.	T	G	29	25	54	0	2	56	0	0
19	33902586	.	G	A	15	16	31	0	3	34	0	0
19	33915802	.	C	T	6	14	20	0	0	20	0	0
19	33921715	.	A	G	18	14	32	0	1	33	0	0
19	33956909	.	C	T	18	14	32	0	3	35	0	0
19	33960517	.	G	A	12	17	29	0	3	32	0	0
19	33963773	.	G	T	11	13	24	0	1	25	0	0
19	33964282	.	G	A	16	9	25	0	0	25	0	0
19	33964353	.	A	G	19	18	37	0	0	37	0	0
19	33989497	.	G	A	13	13	26	0	0	26	0	0
19	33993507	.	C	T	11	4	15	0	3	18	0	0
19	33996170	.	G	A	7	8	15	0	1	16	0	0
19	34074028	.	G	A	8	5	13	0	0	13	0	0
19	34074072	.	A	G	10	7	17	0	3	20	0	0
19	34074386	.	T	G	11	12	23	0	0	23	0	0
19	34081003	.	A	G	8	8	16	0	0	16	0	0
19	34089132	.	T	G	9	11	20	0	0	20	0	0
19	34180519	.	C	T	1	4	5	0	0	5	0	0
19	34180528	.	C	T	1	3	4	0	0	4	0	0
19	34217967	.	G	T	1	4	5	0	0	5	0	0
19	34563588	.	T	C	8	15	23	0	3	26	0	0
19	34595032	.	C	T	6	4	10	0	0	10	0	0
19	34602472	.	G	A	5	8	13	0	0	13	0	0
19	34696829	.	T	A	2	5	7	0	0	7	0	0
19	34696921	.	C	T	3	5	8	0	3	11	0	0
19	34720217	.	G	A	4	3	7	0	0	7	0	0
19	34733307	.	A	G	2	4	6	0	0	6	0	0
19	34742818	.	C	T	4	3	7	0	1	8	0	0
19	34744060	.	T	G	6	3	9	0	0	9	0	0
19	34744231	.	T	C	4	5	9	0	0	9	0	0
19	34744288	.	C	A	10	9	19	0	1	20	0	0
19	34746659	.	G	A	7	8	15	0	0	15	0	0
19	34746810	.	T	G	2	2	4	0	0	4	0	0
19	34746826	.	G	A	1	1	2	0	2	4	0	0
19	34753645	.	G	A	3	2	5	0	0	5	0	0
19	34753669	.	G	C	3	0	3	0	2	5	0	0
19	34760060	.	G	A	1	4	5	0	1	6	0	0
19	34770489	.	G	C	2	3	5	0	0	5	0	0
19	34957804	.	T	C	1	3	4	0	0	4	0	0
19	34960061	.	A	T	4	12	16	0	0	16	0	0
19	34960099	.	A	G	5	7	12	0	0	12	0	0
19	34960143	.	A	G	5	8	13	0	1	14	0	0
19	34960147	.	G	A	8	7	15	0	0	15	0	0
19	34960190	.	C	G	1	8	9	0	14	23	0	0
19	34960198	.	T	C	16	10	26	0	0	26	0	0
19	34960315	.	T	A	8	8	16	0	0	16	0	0
19	34960694	.	T	A	2	4	6	0	1	7	0	0
19	34961152	.	C	T	6	9	15	0	1	16	0	0
19	34961269	.	A	G	4	9	13	0	0	13	0	0
19	34975091	.	T	C	1	2	3	0	0	3	0	0
19	35002450	.	G	A	7	9	16	0	1	17	0	0
19	35002527	.	G	A	0	3	3	0	1	4	0	0
19	35002714	.	A	C	5	3	8	0	1	9	0	0
19	35002723	.	T	C	6	4	10	0	1	11	0	0
19	35004135	.	C	T	10	3	13	0	1	14	0	0
19	35004868	.	C	A	1	4	5	0	0	5	0	0
19	35004869	.	C	A	1	3	4	0	0	5	1	0
19	35004920	.	G	A	3	4	7	0	0	7	0	0
19	35004941	.	T	C	5	3	8	0	0	8	0	0
19	35005136	.	A	C	4	2	6	0	1	7	0	0
19	35005137	.	A	T	5	2	7	0	0	7	0	0
19	35007220	.	G	A	8	17	25	0	0	25	0	0
19	35007235	.	G	A	8	16	24	0	1	25	0	0
19	35013166	.	G	T	7	2	9	0	1	10	0	0
19	35013806	.	C	T	20	25	45	0	2	47	0	0
19	35016477	.	C	T	22	20	42	0	0	42	0	0
19	35016553	.	T	G	24	10	34	0	1	35	0	0
19	35016646	.	A	T	14	17	31	0	0	31	0	0
19	35016696	.	T	G	12	8	20	0	1	21	0	0
19	35016835	.	C	T	11	11	22	0	0	22	0	0
19	35019490	.	T	A	2	3	5	0	0	5	0	0
19	35019560	.	A	G	3	2	5	0	0	5	0	0
19	35041158	.	T	A	23	31	54	0	0	54	0	0
19	35041308	.	A	G	35	25	60	0	1	61	0	0
19	35041458	.	T	C	33	1	34	0	24	58	0	0
19	35052411	.	G	T	16	13	29	0	0	29	0	0
19	35052435	.	T	C	15	1	16	0	14	30	0	0
19	35055889	.	A	G	9	17	26	0	0	26	0	0
19	35057860	.	G	T	11	15	26	0	0	26	0	0
19	35057869	.	C	T	17	9	26	0	1	27	0	0
19	35058232	.	T	C	13	17	30	0	1	31	0	0
19	35060217	.	A	C	17	14	31	0	3	34	0	0
19	35065906	.	A	T	14	13	27	0	0	27	0	0
19	35067367	.	G	A	14	13	27	0	0	27	0	0
19	35069299	.	G	T	13	19	32	0	2	34	0	0
19	35069755	.	C	A	12	15	27	0	0	27	0	0
19	35069934	.	T	G	16	7	23	0	1	24	0	0
19	35070015	.	C	T	12	11	23	0	0	23	0	0
19	35072613	.	A	C	17	13	30	0	0	30	0	0
19	35072712	.	G	C	8	0	8	0	12	20	0	0
19	35075637	.	C	T	1	11	12	0	14	26	0	0
19	35076301	.	C	T	1	14	15	0	12	27	0	0
19	35076773	.	G	A	12	14	26	0	0	26	0	0
19	35078584	.	T	C	11	0	11	0	16	27	0	0
19	35078632	.	T	C	16	1	17	0	14	31	0	0
19	35079259	.	C	T	5	11	16	0	2	18	0	0
19	35079515	.	A	T	7	10	17	0	1	18	0	0
19	35083010	.	G	A	14	6	20	0	0	20	0	0
19	35083019	.	C	T	14	6	20	0	1	21	0	0
19	35083182	.	C	T	13	8	21	0	0	21	0	0
19	35116228	.	A	G	7	9	16	0	1	17	0	0
19	35116297	.	T	C	2	12	14	0	0	14	0	0
19	35116405	.	A	G	10	9	19	0	1	20	0	0
19	35116438	.	G	A	15	9	24	0	0	24	0	0
19	35118813	.	G	C	6	6	12	0	0	12	0	0
19	35118842	.	T	C	3	7	10	0	1	11	0	0
19	35118860	.	G	T	4	7	11	0	0	11	0	0
19	35118911	.	C	A	8	11	19	0	1	20	0	0
19	35118983	.	A	T	7	6	13	0	1	14	0	0
19	35119039	.	T	C	12	6	18	0	0	18	0	0
19	35119052	.	A	G	12	11	23	0	0	23	0	0
19	35119082	.	T	C	9	0	9	0	13	22	0	0
19	35119169	.	G	A	7	8	15	0	0	15	0	0
19	35119205	.	G	A	9	8	17	0	0	17	0	0
19	35119436	.	C	T	11	9	20	0	0	20	0	0
19	35121381	.	T	C	5	8	13	0	2	15	0	0
19	35122875	.	G	A	6	4	10	0	0	10	0	0
19	35122876	.	C	A	6	4	10	0	0	10	0	0
19	35123452	.	A	T	14	6	20	0	0	20	0	0
19	35123508	.	T	C	10	0	10	0	7	17	0	0
19	35128238	.	T	C	7	6	13	0	0	13	0	0
19	35131332	.	G	A	7	8	15	0	0	15	0	0
19	35134092	.	G	T	4	4	8	0	0	8	0	0
19	35134181	.	G	A	7	5	12	0	0	12	0	0
19	35135406	.	C	A	0	3	3	0	5	8	0	0
19	35135466	.	G	A	2	7	9	0	0	9	0	0
19	35135711	.	A	G	4	7	11	0	0	11	0	0
19	35135870	.	C	T	2	7	9	0	0	9	0	0
19	35135883	.	A	G	3	6	9	0	0	9	0	0
19	35135927	.	T	G	4	4	8	0	0	8	0	0
19	35135961	.	A	G	7	3	10	0	1	11	0	0
19	35137910	.	A	G	3	7	10	0	0	10	0	0
19	35138260	.	A	G	6	2	8	0	0	8	0	0
19	35155676	.	C	T	6	5	11	0	0	11	0	0
19	35157472	.	A	G	3	4	7	0	0	7	0	0
19	35159665	.	G	T	5	6	11	0	0	11	0	0
19	35159668	.	G	A	5	5	10	0	0	10	0	0
19	35159721	.	A	G	4	8	12	0	0	12	0	0
19	35159826	.	G	T	8	3	11	0	0	11	0	0
19	35159841	.	G	T	6	3	9	0	0	9	0	0
19	35165047	.	T	C	3	0	3	0	3	6	0	0
19	35167278	.	A	T	2	2	4	0	0	4	0	0
19	35167368	.	C	G	3	3	6	0	0	6	0	0
19	35170195	.	A	T	5	3	8	0	0	8	0	0
19	35170263	.	T	G	6	4	10	0	0	10	0	0
19	35191348	.	A	G	3	2	5	0	0	5	0	0
19	35339968	.	G	A	1	2	3	0	0	3	0	0
19	35359341	.	C	T	31	32	63	0	2	65	0	0
19	35379917	.	A	G	8	5	13	0	0	13	0	0
19	35379923	.	G	A	5	6	11	0	1	12	0	0
19	35379998	.	A	G	5	7	12	0	0	12	0	0
19	35380031	.	G	A	8	10	18	0	0	18	0	0
19	35380070	.	G	A	8	11	19	0	0	19	0	0
19	35380168	.	T	C	7	1	8	0	5	13	0	0
19	35381625	.	T	A	2	5	7	0	1	8	0	0
19	35381956	.	A	G	5	3	8	0	0	8	0	0
19	35383571	.	G	A	3	6	9	0	0	9	0	0
19	35383586	.	C	T	0	6	6	0	3	9	0	0
19	35386288	.	T	G	8	4	12	0	0	12	0	0
19	35390668	.	T	C	2	6	8	0	0	8	0	0
19	35419026	.	C	T	0	3	3	0	1	4	0	0
19	35419202	.	A	G	7	3	10	1	0	11	0	0
19	35419215	.	T	A	8	4	12	1	0	13	0	0
19	35419292	.	T	A	2	3	5	0	0	5	0	0
19	35419300	.	A	T	2	3	5	0	0	5	0	0
19	35422354	.	T	C	10	18	28	0	1	29	0	0
19	35428735	.	G	A	16	14	30	0	0	30	0	0
19	35459414	.	A	G	21	16	37	0	5	42	0	0
19	35459737	.	G	A	23	16	39	0	2	41	0	0
19	35459801	.	A	T	26	15	41	0	1	42	0	0
19	35473080	.	C	A	4	18	22	0	21	43	0	0
19	35852378	.	C	T	0	3	3	0	0	3	0	0
19	35852381	.	A	G	1	3	4	0	0	4	0	0
19	36115044	.	G	A	8	6	14	0	0	14	0	0
19	36115210	.	G	A	11	6	17	0	1	18	0	0
19	36120265	.	C	T	2	4	6	0	10	16	0	0
19	36122534	.	C	T	8	5	13	0	0	13	0	0
19	36131818	.	G	A	5	5	10	0	0	10	0	0
19	36139613	.	C	T	5	2	7	0	0	7	0	0
19	36141868	.	G	A	8	5	13	0	1	14	0	0
19	36167704	.	A	G	11	5	16	0	0	16	0	0
19	36169872	.	A	G	4	6	10	0	1	11	0	0
19	36171084	.	G	A	4	8	12	0	1	13	0	0
19	36212370	.	G	A	4	6	10	0	0	10	0	0
19	36251978	.	A	G	2	4	6	0	0	6	0	0
19	36258165	.	C	T	2	5	7	0	3	10	0	0
19	36277790	.	A	G	4	2	6	0	0	6	0	0
19	36287753	.	T	C	2	3	5	0	0	5	0	0
19	36290669	.	C	T	0	2	2	0	1	3	0	0
19	36290771	.	T	G	3	4	7	0	1	8	0	0
19	36311813	.	G	A	4	6	10	0	0	10	0	0
19	36341686	.	A	T	2	2	4	0	0	4	0	0
19	36350821	.	G	A	2	7	9	0	0	9	0	0
19	36350860	.	C	A	5	2	7	0	0	7	0	0
19	36351155	.	A	G	4	5	9	0	0	9	0	0
19	36355984	.	G	A	2	9	11	0	0	11	0	0
19	36369382	.	C	T	0	2	2	0	3	5	0	0
19	36369430	.	T	A	1	3	4	0	0	4	0	0
19	36369448	.	G	A	1	4	5	0	0	5	0	0
19	36378380	.	C	T	1	2	3	0	0	3	0	0
19	36378452	.	G	A	3	2	5	0	0	5	0	0
19	36378464	.	A	T	1	3	4	0	0	4	0	0
19	36427054	.	C	G	3	2	5	0	0	5	0	0
19	36627087	.	T	C	1	2	3	2	0	5	0	0
19	37122536	.	A	G	7	0	7	0	3	10	0	0
19	37133533	.	C	A	6	4	10	0	0	10	0	0
19	37133762	.	C	T	4	3	7	0	0	8	1	0
19	37133825	.	G	A	7	3	10	0	0	10	0	0
19	37133872	.	T	C	1	5	6	0	0	6	0	0
19	37135759	.	G	A	7	3	10	0	0	10	0	0
19	37138388	.	G	A	0	14	14	0	17	31	0	0
19	37138643	.	G	A	1	16	17	0	13	30	0	0
19	37138743	.	C	T	13	9	22	1	2	25	0	0
19	37138770	.	G	T	6	7	13	1	2	16	0	0
19	37138955	.	A	G	6	14	20	0	2	22	0	0
19	37478230	.	C	A	4	5	9	0	1	10	0	0
19	37481628	.	C	A	3	5	8	0	0	8	0	0
19	37481658	.	C	T	2	4	6	0	0	6	0	0
19	37484508	.	A	C	3	2	5	0	1	6	0	0
19	37484720	.	G	C	0	7	7	0	6	13	0	0
19	37485121	.	C	T	4	2	6	0	0	6	0	0
19	37488830	.	C	T	3	2	5	0	0	5	0	0
19	37491605	.	C	A	3	3	6	0	0	6	0	0
19	37491689	.	G	A	3	3	6	0	0	6	0	0
19	37492514	.	A	T	2	4	6	0	0	6	0	0
19	37501935	.	A	G	22	19	41	0	5	46	0	0
19	37502105	.	A	G	35	20	55	0	1	56	0	0
19	37505808	.	G	A	17	9	26	0	0	26	0	0
19	37702123	.	T	A	7	5	12	0	0	12	0	0
19	37702255	.	A	T	2	5	7	0	0	7	0	0
19	37759933	.	G	C	1	3	4	0	0	4	0	0
19	37786292	.	C	A	5	2	7	0	0	7	0	0
19	37802904	.	A	G	5	0	5	0	6	11	0	0
19	37802966	.	C	T	3	6	9	0	1	10	0	0
19	37802971	.	A	T	4	7	11	0	0	11	0	0
19	37804452	.	G	A	0	2	2	0	5	7	0	0
19	37804477	.	G	A	2	2	4	0	6	10	0	0
19	37804647	.	C	T	4	6	10	0	3	13	0	0
19	37813133	.	C	T	4	2	6	0	1	7	0	0
19	37815763	.	G	A	7	6	13	0	0	13	0	0
19	37835322	.	G	A	5	4	9	0	1	10	0	0
19	37835367	.	G	A	4	4	8	0	0	8	0	0
19	37835433	.	A	C	5	5	10	0	0	10	0	0
19	37835502	.	A	G	7	5	12	0	2	14	0	0
19	37835508	.	T	C	8	5	13	0	0	13	0	0
19	37858144	.	G	C	5	16	21	0	2	23	0	0
19	37926003	.	C	T	20	13	33	0	0	33	0	0
19	37926066	.	C	A	24	14	38	0	0	38	0	0
19	37926653	.	A	T	10	11	21	0	0	21	0	0
19	37926666	.	C	A	12	14	26	0	0	26	0	0
19	37926816	.	T	G	25	13	38	0	2	40	0	0
19	37926865	.	G	A	28	13	41	0	0	41	0	0
19	37927304	.	G	T	0	12	12	0	10	22	0	0
19	38171067	.	G	A	5	9	14	0	0	14	0	0
19	38175399	.	C	T	8	7	15	0	0	15	0	0
19	38216247	.	A	G	6	3	9	0	0	9	0	0
19	38227086	.	T	G	7	7	14	1	0	15	0	0
19	38240541	.	A	G	1	0	1	0	6	7	0	0
19	38240844	.	C	T	7	4	11	0	0	11	0	0
19	38327186	.	T	C	2	2	4	0	0	4	0	0
19	38473901	.	G	T	2	3	5	0	0	5	0	0
19	40026661	.	T	C	21	21	42	0	1	43	0	0
19	40031002	.	G	A	33	28	61	0	3	64	0	0
19	40039603	.	G	A	11	15	26	0	1	27	0	0
19	40039606	.	T	A	12	16	28	0	0	28	0	0
19	40053055	.	A	G	15	0	15	0	31	46	0	0
19	40053061	.	A	T	17	32	49	0	2	51	0	0
19	40055030	.	A	G	15	22	37	0	0	37	0	0
19	40055318	.	A	G	16	5	21	0	1	22	0	0
19	40069690	.	T	C	2	2	4	0	0	4	0	0
19	40071539	.	T	G	3	3	6	0	0	6	0	0
19	40071541	.	G	A	3	3	6	0	0	6	0	0
19	40080836	.	G	A	7	2	9	0	0	9	0	0
19	40083731	.	C	T	4	6	10	0	1	11	0	0
19	40095388	.	G	C	4	4	8	0	0	8	0	0
19	40096548	.	G	A	5	4	9	0	0	9	0	0
19	40099361	.	C	T	6	7	13	0	0	13	0	0
19	40101840	.	G	A	4	2	6	0	0	6	0	0
19	40102040	.	A	C	8	5	13	0	0	13	0	0
19	40110840	.	G	A	0	10	10	0	8	18	0	0
19	40113305	.	G	A	0	5	5	0	13	18	0	0
19	40113425	.	C	A	7	4	11	0	0	11	0	0
19	40113549	.	T	G	4	3	7	0	0	7	0	0
19	40113677	.	C	G	6	3	9	0	1	10	0	0
19	40113692	.	G	T	3	3	6	0	0	6	0	0
19	40121108	.	T	A	3	2	5	0	0	5	0	0
19	40122444	.	C	T	1	1	2	0	0	2	0	0
19	40122463	.	C	A	1	2	3	0	0	3	0	0
19	40126683	.	A	G	2	5	7	0	0	7	0	0
19	40129299	.	C	T	3	8	11	0	0	11	0	0
19	40129387	.	A	T	9	9	18	0	0	18	0	0
19	40129443	.	A	G	5	6	11	0	0	11	0	0
19	40136856	.	A	T	5	2	7	0	1	8	0	0
19	40137034	.	C	T	2	3	5	0	0	5	0	0
19	40137070	.	T	C	2	3	5	0	0	5	0	0
19	40145423	.	C	T	8	4	12	0	0	12	0	0
19	40145504	.	T	C	4	2	6	0	0	6	0	0
19	40145888	.	G	A	9	6	15	0	1	16	0	0
19	40146215	.	G	A	1	6	7	0	8	15	0	0
19	40147821	.	G	A	3	8	11	0	10	21	0	0
19	40149006	.	A	C	11	11	22	0	0	22	0	0
19	40151970	.	G	A	12	16	28	0	0	28	0	0
19	40151983	.	C	T	11	12	23	0	1	24	0	0
19	40152569	.	G	A	12	8	20	0	0	20	0	0
19	40155144	.	C	A	12	20	32	0	2	34	0	0
19	40156870	.	T	C	16	12	28	0	1	29	0	0
19	40160049	.	T	C	9	10	19	0	2	21	0	0
19	40162945	.	C	A	15	15	30	0	2	32	0	0
19	40163256	.	C	T	16	19	35	0	0	35	0	0
19	40165405	.	A	G	11	13	24	0	0	24	0	0
19	40165681	.	A	G	8	0	8	0	5	13	0	0
19	40177406	.	G	T	1	3	4	0	1	5	0	0
19	40177762	.	T	C	3	2	5	0	1	6	0	0
19	40179763	.	G	A	0	5	5	0	7	12	0	0
19	40179858	.	C	A	5	3	8	0	0	8	0	0
19	40180011	.	C	T	6	6	12	0	0	12	0	0
19	40180100	.	A	G	3	4	7	0	0	7	0	0
19	40182571	.	T	A	2	2	4	0	0	4	0	0
19	40182574	.	C	T	2	2	4	0	0	4	0	0
19	40190997	.	A	C	6	0	6	0	4	10	0	0
19	40191250	.	A	G	1	3	4	0	0	4	0	0
19	40326205	.	T	C	1	2	3	0	1	4	0	0
19	40327862	.	C	A	1	2	3	0	0	3	0	0
19	40328092	.	C	G	2	2	4	0	0	4	0	0
19	40340319	.	A	G	9	14	23	0	0	23	0	0
19	40344730	.	A	C	9	15	24	0	0	24	0	0
19	40345966	.	G	T	15	21	36	0	1	37	0	0
19	40347600	.	T	G	7	0	7	0	20	27	0	0
19	40347702	.	T	A	21	15	36	0	1	38	1	0
19	40347760	.	T	A	17	13	30	0	1	31	0	0
19	40347785	.	A	T	19	8	27	0	3	30	0	0
19	40347842	.	G	T	0	11	11	0	3	14	0	0
19	40361608	.	C	T	2	2	4	0	0	4	0	0
19	40369754	.	G	T	0	3	3	0	1	4	0	0
19	40374151	.	C	T	1	2	3	0	0	3	0	0
19	40509602	.	G	A	1	4	5	0	2	7	0	0
19	40509626	.	T	C	3	1	4	0	3	7	0	0
19	40540324	.	C	T	4	7	11	0	0	11	0	0
19	40540947	.	G	T	5	2	7	0	0	7	0	0
19	40551964	.	C	T	4	6	10	0	0	10	0	0
19	40551982	.	T	G	8	0	8	0	5	13	0	0
19	40558221	.	C	T	5	8	13	0	0	13	0	0
19	40558281	.	A	G	7	8	15	0	0	15	0	0
19	40563396	.	C	T	5	5	10	1	1	12	0	0
19	40565356	.	C	A	2	5	7	0	0	7	0	0
19	40641356	.	C	G	5	0	5	0	5	10	0	0
19	40641379	.	A	G	3	6	9	0	0	9	0	0
19	40641433	.	T	C	4	2	6	0	1	7	0	0
19	40685447	.	A	G	7	0	7	0	9	16	0	0
19	40685518	.	G	A	0	5	5	0	10	15	0	0
19	40685520	.	T	C	9	6	15	0	0	15	0	0
19	40685664	.	A	G	6	9	15	0	1	16	0	0
19	40685845	.	G	A	5	3	8	0	0	8	0	0
19	40685875	.	G	A	5	6	11	0	1	12	0	0
19	40685923	.	T	C	3	7	10	0	0	10	0	0
19	40685935	.	A	G	3	2	5	0	0	5	0	0
19	40686099	.	A	G	7	2	9	0	1	10	0	0
19	40686104	.	A	G	8	3	11	0	0	11	0	0
19	40686179	.	A	G	1	3	4	0	0	4	0	0
19	40686198	.	C	A	1	4	5	0	0	5	0	0
19	40686241	.	C	G	1	6	7	0	0	7	0	0
19	40686250	.	T	C	1	4	5	0	1	6	0	0
19	40686351	.	A	C	4	6	10	1	1	12	0	0
19	40686648	.	A	G	14	2	16	0	0	16	0	0
19	40686658	.	A	G	10	4	14	0	1	15	0	0
19	40716977	.	T	C	5	3	8	0	1	9	0	0
19	40717649	.	C	A	9	11	20	0	1	21	0	0
19	40731649	.	C	T	3	5	8	0	0	8	0	0
19	40770760	.	C	T	2	3	5	0	5	10	0	0
19	40861956	.	A	G	5	6	11	0	0	11	0	0
19	40872040	.	C	T	2	3	5	0	1	6	0	0
19	40872046	.	T	C	4	4	8	0	0	8	0	0
19	40892312	.	T	C	4	7	11	0	0	11	0	0
19	40895763	.	G	A	10	10	20	0	0	20	0	0
19	40895826	.	T	C	12	14	26	0	0	26	0	0
19	40898468	.	C	T	6	7	13	0	1	14	0	0
19	40900059	.	T	A	11	8	19	0	0	19	0	0
19	40903335	.	G	A	12	11	23	0	0	23	0	0
19	40906094	.	G	A	17	7	24	0	0	24	0	0
19	41013109	.	A	G	8	1	9	0	11	20	0	0
19	41030324	.	A	C	5	8	13	1	2	16	0	0
19	41031941	.	G	A	3	16	19	0	15	34	0	0
19	41033898	.	C	T	12	16	28	0	1	29	0	0
19	41038728	.	T	A	7	3	10	0	2	12	0	0
19	41038942	.	C	A	17	23	40	0	1	41	0	0
19	41039012	.	G	C	28	2	30	0	18	48	0	0
19	41052229	.	G	A	32	16	48	0	0	48	0	0
19	41054464	.	T	C	24	1	25	1	28	54	0	0
19	41057049	.	C	A	22	23	45	0	1	46	0	0
19	41057079	.	G	A	24	16	40	0	1	41	0	0
19	41060384	.	C	T	1	20	21	0	13	34	0	0
19	41075564	.	T	G	4	0	4	0	6	10	0	0
19	41081118	.	G	A	5	5	10	0	1	11	0	0
19	41081198	.	T	C	6	5	11	0	1	12	0	0
19	41081211	.	C	G	7	1	8	0	4	12	0	0
19	41127263	.	G	A	5	3	8	0	0	8	0	0
19	41149930	.	A	G	5	6	11	0	0	11	0	0
19	41159124	.	G	A	0	4	4	2	2	8	0	0
19	41160202	.	A	T	6	10	16	0	0	16	0	0
19	41160332	.	G	A	4	3	7	0	0	7	0	0
19	41160334	.	G	T	3	3	6	0	1	7	0	0
19	41160885	.	G	A	3	7	10	0	0	10	0	0
19	41191120	.	T	C	1	2	3	0	0	3	0	0
19	41321897	.	G	C	2	4	6	0	0	6	0	0
19	41401637	.	C	A	8	12	20	0	3	23	0	0
19	41401727	.	C	T	2	13	15	0	8	23	0	0
19	41401878	.	G	A	13	11	24	0	1	25	0	0
19	41401926	.	A	G	20	12	32	0	2	34	0	0
19	41401928	.	G	A	20	14	34	0	0	34	0	0
19	41401979	.	G	C	30	16	46	3	1	50	0	0
19	41404250	.	G	A	33	27	60	0	4	64	0	0
19	41404273	.	C	T	2	30	32	0	33	65	0	0
19	41447420	.	A	G	6	3	9	0	0	9	0	0
19	41447427	.	A	G	6	3	9	0	0	9	0	0
19	41447548	.	A	G	4	4	8	0	0	8	0	0
19	41447600	.	G	T	6	7	13	0	1	14	0	0
19	41447705	.	A	C	4	5	9	0	0	9	0	0
19	41447727	.	T	C	2	3	5	0	2	7	0	0
19	41448040	.	G	A	1	3	4	0	1	5	0	0
19	41448047	.	G	T	2	4	6	0	0	6	0	0
19	41466777	.	G	A	1	6	7	0	8	15	0	0
19	41466783	.	T	C	7	6	13	0	0	13	0	0
19	41516139	.	T	G	4	3	7	0	0	7	0	0
19	41516204	.	G	T	5	4	9	0	0	9	0	0
19	41516209	.	A	C	6	0	6	0	3	9	0	0
19	41516281	.	C	A	7	4	11	0	0	11	0	0
19	41521060	.	T	C	3	2	5	0	1	6	0	0
19	41531232	.	A	C	3	3	6	0	0	6	0	0
19	41531236	.	C	T	3	5	8	0	0	8	0	0
19	41533610	.	T	A	5	2	7	0	1	8	0	0
19	41533987	.	A	T	1	5	6	0	2	8	0	0
19	41533991	.	A	T	2	8	10	0	0	10	0	0
19	41534035	.	G	C	7	3	10	0	0	10	0	0
19	41534050	.	G	A	5	2	7	0	3	10	0	0
19	41534092	.	T	C	5	4	9	0	0	9	0	0
19	41537398	.	A	C	3	4	7	0	0	7	0	0
19	41537442	.	G	A	4	3	7	0	0	7	0	0
19	41538865	.	A	G	2	3	5	0	0	5	0	0
19	41539065	.	G	A	1	2	3	0	0	3	0	0
19	41539227	.	C	T	2	3	5	0	0	5	0	0
19	41539346	.	G	C	1	4	5	0	1	6	0	0
19	41539467	.	T	C	2	3	5	0	0	5	0	0
19	41539516	.	A	T	5	3	8	0	0	8	0	0
19	41539517	.	A	C	5	3	8	0	0	8	0	0
19	41539821	.	G	T	1	7	8	0	0	8	0	0
19	41539868	.	A	C	1	6	7	0	0	7	0	0
19	41539935	.	G	A	3	3	6	0	0	6	0	0
19	41717013	.	G	C	3	18	21	0	18	39	0	0
19	41723561	.	C	T	10	10	20	0	4	24	0	0
19	41724049	.	G	A	3	10	13	0	9	22	0	0
19	41841261	.	C	A	8	8	16	0	0	16	0	0
19	41841824	.	T	C	15	19	34	0	2	36	0	0
19	41846849	.	G	T	13	9	22	0	1	23	0	0
19	41849679	.	A	G	14	17	31	0	3	34	0	0
19	41851698	.	G	T	6	9	15	0	0	15	0	0
19	41853967	.	G	T	21	8	29	0	1	30	0	0
19	41857795	.	G	A	6	22	28	0	1	29	0	0
19	41857846	.	C	T	4	12	16	0	1	17	0	0
19	41860157	.	G	A	12	10	22	0	0	22	0	0
19	41870495	.	G	A	10	8	18	0	2	20	0	0
19	41870515	.	T	A	11	6	17	0	0	17	0	0
19	41882152	.	G	A	7	10	17	0	0	17	0	0
19	41882212	.	G	A	12	13	25	0	1	26	0	0
19	41884108	.	A	G	10	5	15	0	0	15	0	0
19	41884129	.	C	T	0	3	3	0	9	12	0	0
19	41884162	.	G	A	11	9	20	0	0	20	0	0
19	41893332	.	A	G	7	9	16	0	1	17	0	0
19	41893335	.	C	T	8	8	16	0	0	16	0	0
19	41902743	.	A	G	10	7	17	0	2	19	0	0
19	41902975	.	A	C	13	8	21	0	0	21	0	0
19	41909305	.	A	G	12	10	22	0	0	22	0	0
19	41933979	.	G	A	7	4	11	0	2	13	0	0
19	41934074	.	A	G	3	8	11	0	0	11	0	0
19	41937394	.	G	A	8	8	16	0	1	17	0	0
19	41946418	.	C	T	8	4	12	0	0	12	0	0
19	41946676	.	G	A	7	8	15	0	0	15	0	0
19	41946709	.	G	A	6	5	11	0	1	12	0	0
19	42045168	.	T	A	3	7	10	0	0	10	0	0
19	42047783	.	C	T	9	5	14	0	0	14	0	0
19	42061290	.	C	T	15	9	24	0	1	25	0	0
19	42061441	.	C	G	16	11	27	0	1	28	0	0
19	42061455	.	A	G	15	10	25	0	1	26	0	0
19	42061491	.	C	T	20	5	25	0	0	25	0	0
19	42061521	.	A	G	7	16	23	0	3	26	0	0
19	42061605	.	A	G	15	0	15	0	11	26	0	0
19	42063817	.	G	A	0	2	2	0	2	4	0	0
19	42065010	.	C	T	13	14	27	0	1	28	0	0
19	42066899	.	T	C	19	13	32	0	1	33	0	0
19	42067065	.	T	C	20	9	29	0	1	30	0	0
19	42067149	.	T	C	16	13	29	0	1	30	0	0
19	42068537	.	A	C	22	13	35	0	0	35	0	0
19	42068818	.	A	G	4	5	9	0	1	10	0	0
19	42068941	.	T	C	1	2	3	0	0	3	0	0
19	42071867	.	T	A	2	3	5	0	2	7	0	0
19	42117777	.	A	T	5	13	18	0	1	19	0	0
19	42118040	.	T	G	8	12	20	0	4	24	0	0
19	42118275	.	T	C	4	2	6	0	1	7	0	0
19	42235042	.	G	C	3	6	9	0	1	10	0	0
19	42235161	.	G	T	8	10	18	0	0	18	0	0
19	42235205	.	A	G	10	5	15	0	0	15	0	0
19	42235286	.	A	T	18	6	24	0	1	26	1	0
19	42235655	.	A	C	8	4	12	0	0	12	0	0
19	42235967	.	A	G	1	3	4	0	0	4	0	0
19	42241740	.	G	T	4	4	8	0	0	8	0	0
19	42241755	.	G	T	6	3	9	0	0	9	0	0
19	42244118	.	G	A	8	7	15	0	0	15	0	0
19	42244281	.	T	C	4	0	4	0	11	15	0	0
19	42244342	.	G	T	3	3	6	0	0	6	0	0
19	42328467	.	T	C	21	14	35	0	0	35	0	0
19	42328510	.	C	T	27	26	53	0	2	55	0	0
19	42336375	.	G	A	16	31	47	0	0	47	0	0
19	42336526	.	C	T	19	28	47	0	3	50	0	0
19	42336636	.	C	T	21	24	45	0	2	47	0	0
19	42336675	.	C	T	24	17	41	0	3	44	0	0
19	42340452	.	A	G	17	1	18	0	17	35	0	0
19	42340455	.	C	T	18	19	37	0	0	37	0	0
19	42340508	.	G	C	31	19	50	0	2	52	0	0
19	42340658	.	G	A	5	27	32	0	24	56	0	0
19	42340855	.	G	A	3	23	26	0	18	44	0	0
19	42341530	.	T	C	19	21	40	0	0	40	0	0
19	42341613	.	T	A	17	21	38	0	4	42	0	0
19	42341693	.	G	A	18	21	39	0	2	41	0	0
19	42367500	.	T	A	1	4	5	0	1	6	0	0
19	42368065	.	C	T	0	5	5	0	9	14	0	0
19	42368511	.	A	C	4	2	6	0	0	6	0	0
19	42368619	.	T	A	8	2	10	0	2	12	0	0
19	42368620	.	T	C	8	0	8	0	4	12	0	0
19	42374298	.	C	A	1	7	8	0	0	8	0	0
19	42389797	.	C	T	1	6	7	0	4	11	0	0
19	42397530	.	A	G	7	11	18	0	0	18	0	0
19	42397975	.	G	A	16	19	35	0	1	36	0	0
19	42400567	.	A	G	18	19	37	1	0	38	0	0
19	42402060	.	G	A	13	17	30	0	2	32	0	0
19	42402382	.	A	G	11	11	22	0	1	23	0	0
19	42416665	.	A	T	8	12	20	0	0	20	0	0
19	42453907	.	C	A	1	4	5	0	0	5	0	0
19	42454002	.	G	C	0	2	2	0	3	5	0	0
19	42458099	.	T	C	17	14	31	0	2	33	0	0
19	42458112	.	T	A	21	16	37	0	0	37	0	0
19	42459868	.	T	A	21	22	43	0	0	43	0	0
19	42493255	.	C	T	6	12	18	0	1	19	0	0
19	42493353	.	T	A	7	6	13	0	1	14	0	0
19	42493986	.	G	T	4	5	9	0	0	9	0	0
19	42494130	.	T	C	9	1	10	0	11	21	0	0
19	42495678	.	T	G	11	9	20	0	1	21	0	0
19	42495829	.	G	A	11	5	16	0	0	16	0	0
19	42495850	.	G	A	13	5	18	0	0	18	0	0
19	42495901	.	A	G	11	5	16	0	1	17	0	0
19	42498306	.	T	C	9	1	10	0	4	14	0	0
19	42498376	.	C	T	10	4	14	0	0	14	0	0
19	42498378	.	A	C	10	4	14	0	0	14	0	0
19	42498715	.	G	A	9	7	16	0	0	16	0	0
19	42502572	.	T	G	3	7	10	0	0	10	0	0
19	42503094	.	T	C	5	4	9	0	0	9	0	0
19	42503104	.	G	A	2	3	5	0	0	5	0	0
19	42568060	.	G	T	1	3	4	0	0	4	0	0
19	42569517	.	T	A	3	4	7	0	0	7	0	0
19	42569528	.	C	A	1	3	4	0	1	5	0	0
19	42571773	.	C	G	3	3	6	0	0	6	0	0
19	42574042	.	C	A	4	4	8	0	2	10	0	0
19	42574523	.	A	T	4	5	9	0	0	9	0	0
19	42574781	.	C	T	1	4	5	0	2	7	0	0
19	42611830	.	G	T	0	2	2	0	2	4	0	0
19	42612335	.	G	T	0	2	2	0	4	6	0	0
19	42637293	.	G	A	1	2	3	0	0	3	0	0
19	42660271	.	G	C	12	5	17	0	0	17	0	0
19	42678624	.	G	A	1	9	10	0	6	16	0	0
19	42682502	.	A	G	5	9	14	0	1	15	0	0
19	42682504	.	G	A	1	9	10	0	6	16	0	0
19	42682628	.	G	A	6	6	12	0	1	13	0	0
19	42682678	.	C	T	3	3	6	0	2	8	0	0
19	42682699	.	C	A	6	4	10	0	0	10	0	0
19	42693887	.	C	T	5	2	7	0	0	7	0	0
19	42693947	.	G	A	1	3	4	0	0	4	0	0
19	42720227	.	G	A	11	14	25	0	1	26	0	0
19	42720248	.	C	T	14	12	26	0	0	26	0	0
19	42732770	.	G	C	7	5	12	0	1	13	0	0
19	42735350	.	C	A	20	19	39	0	0	39	0	0
19	42740353	.	G	C	19	13	32	0	0	33	1	0
19	42743837	.	G	A	11	12	23	0	6	29	0	0
19	42744744	.	C	T	15	19	34	0	7	41	0	0
19	42747212	.	G	A	2	11	13	0	18	31	0	0
19	42754892	.	C	T	18	15	33	0	2	35	0	0
19	42774755	.	G	A	30	16	46	0	2	48	0	0
19	42791291	.	T	C	33	24	57	0	4	61	0	0
19	42795751	.	A	G	29	28	57	0	3	60	0	0
19	42795799	.	C	T	38	32	70	0	2	72	0	0
19	42798696	.	C	T	29	27	56	0	2	58	0	0
19	42801687	.	G	A	6	26	32	0	24	56	0	0
19	42801708	.	T	A	24	27	51	0	1	52	0	0
19	42802018	.	C	A	37	26	63	0	0	63	0	0
19	42802075	.	T	C	33	23	56	0	3	59	0	0
19	42802077	.	C	T	29	21	50	0	7	57	0	0
19	42802294	.	T	A	4	2	6	0	1	7	0	0
19	42802295	.	G	A	4	2	6	0	1	7	0	0
19	42806886	.	T	C	7	4	11	0	0	11	0	0
19	42819989	.	G	A	4	4	8	0	1	9	0	0
19	42821808	.	G	A	5	2	7	0	0	7	0	0
19	42821859	.	T	C	7	7	14	0	2	16	0	0
19	42835133	.	C	T	6	7	13	0	0	13	0	0
19	42841599	.	A	C	7	9	16	0	1	17	0	0
19	42843640	.	A	G	8	0	8	0	9	17	0	0
19	42843642	.	A	G	6	9	15	0	2	17	0	0
19	42843725	.	A	C	13	8	21	0	1	22	0	0
19	42843751	.	A	T	12	11	23	0	0	23	0	0
19	42843894	.	A	G	18	7	25	0	1	26	0	0
19	42843917	.	T	C	17	8	25	0	0	25	0	0
19	42844126	.	A	G	17	7	24	0	1	25	0	0
19	42847620	.	G	A	3	4	7	0	0	7	0	0
19	42856838	.	C	T	12	10	22	0	1	23	0	0
19	42864222	.	G	T	9	12	21	0	0	21	0	0
19	42868330	.	T	C	17	12	29	0	1	30	0	0
19	42868446	.	A	G	17	13	30	0	1	31	0	0
19	42870307	.	T	G	13	1	14	0	21	35	0	0
19	42870512	.	C	T	18	18	36	0	1	37	0	0
19	42872200	.	G	C	24	18	42	0	2	44	0	0
19	42873858	.	G	A	2	8	10	0	9	19	0	0
19	42874075	.	C	G	10	12	22	0	2	24	0	0
19	42874172	.	C	T	11	12	23	0	1	24	0	0
19	42874188	.	A	G	11	1	12	0	19	31	0	0
19	42874231	.	C	T	9	23	32	0	0	32	0	0
19	42874301	.	G	A	14	10	24	0	2	26	0	0
19	42874336	.	G	C	11	11	22	0	3	25	0	0
19	42874414	.	T	C	17	8	25	0	5	30	0	0
19	42874439	.	T	G	20	2	22	0	2	24	0	0
19	42874564	.	G	A	13	4	17	0	3	20	0	0
19	42874674	.	A	G	13	10	23	0	0	23	0	0
19	42875103	.	A	T	8	6	14	0	1	15	0	0
19	42894574	.	G	A	4	4	8	0	0	8	0	0
19	42894603	.	A	T	3	6	9	0	0	9	0	0
19	42894624	.	C	T	4	5	9	0	2	11	0	0
19	42894742	.	A	C	3	7	10	0	1	11	0	0
19	42896148	.	G	A	0	5	5	0	4	9	0	0
19	42898282	.	A	C	3	7	10	0	0	10	0	0
19	42898813	.	C	T	6	5	11	0	0	11	0	0
19	42906166	.	T	C	5	10	15	0	0	15	0	0
19	42906169	.	G	A	1	8	9	0	7	16	0	0
19	42908916	.	T	A	9	9	18	0	0	18	0	0
19	42909168	.	C	T	9	11	20	0	2	22	0	0
19	42912376	.	C	A	6	14	20	0	2	22	0	0
19	42912394	.	G	A	2	10	12	0	9	21	0	0
19	42919465	.	C	T	0	11	11	0	5	16	0	0
19	42928242	.	C	T	2	9	11	0	7	18	0	0
19	42928647	.	C	T	1	12	13	0	6	19	0	0
19	42928845	.	C	A	0	5	5	0	7	12	0	0
19	42988059	.	C	T	36	29	65	0	2	67	0	0
19	42997087	.	G	A	3	2	5	0	0	5	0	0
19	42997106	.	C	G	5	2	7	0	1	8	0	0
19	43000034	.	G	C	15	0	15	0	18	33	0	0
19	43000067	.	C	T	11	10	21	0	2	23	0	0
19	43000070	.	A	G	10	9	19	0	2	21	0	0
19	43002605	.	A	C	9	9	18	0	1	19	0	0
19	43004118	.	G	A	14	8	22	0	2	24	0	0
19	43004133	.	T	C	12	7	19	0	0	19	0	0
19	43004221	.	T	G	10	5	15	0	0	15	0	0
19	43004259	.	A	G	16	12	28	0	2	30	0	0
19	43004283	.	T	C	13	14	27	0	2	29	0	0
19	43004297	.	C	A	10	10	20	0	1	21	0	0
19	43007838	.	T	C	6	7	13	0	0	13	0	0
19	43007913	.	C	T	3	6	9	0	0	9	0	0
19	43009476	.	C	T	9	5	14	0	0	14	0	0
19	43015564	.	C	T	4	4	8	0	0	8	0	0
19	43018243	.	T	C	18	17	35	0	2	37	0	0
19	43018257	.	G	A	3	19	22	0	13	35	0	0
19	43018352	.	T	C	20	10	30	0	0	30	0	0
19	43029462	.	G	A	1	23	24	0	20	44	0	0
19	43030654	.	G	A	23	26	49	0	1	50	0	0
19	43030655	.	A	G	22	27	49	0	0	49	0	0
19	43031169	.	G	A	3	19	22	0	19	41	0	0
19	43031261	.	G	A	0	4	4	0	4	8	0	0
19	43031264	.	A	G	7	1	8	0	0	8	0	0
19	43054736	.	A	G	15	13	28	0	2	30	0	0
19	43054854	.	C	T	13	14	27	0	2	29	0	0
19	43054881	.	G	A	1	7	8	0	14	22	0	0
19	43059329	.	C	T	9	8	17	1	2	20	0	0
19	43061448	.	G	A	20	13	33	0	1	34	0	0
19	43062374	.	T	A	10	17	27	0	1	28	0	0
19	43063825	.	C	A	12	10	22	0	4	26	0	0
19	43063846	.	C	T	7	11	18	1	1	20	0	0
19	43065875	.	C	T	17	14	31	0	0	31	0	0
19	43068174	.	C	G	9	6	15	9	0	24	0	0
19	43071146	.	A	T	2	3	5	18	0	23	0	0
19	43071307	.	T	C	7	12	19	9	0	28	0	0
19	43072588	.	T	C	20	18	38	0	0	38	0	0
19	43072645	.	G	A	2	13	15	0	18	33	0	0
19	43072663	.	C	T	22	15	37	0	0	37	0	0
19	43074584	.	T	A	20	19	39	0	3	42	0	0
19	43074635	.	C	T	24	17	41	0	1	42	0	0
19	43074668	.	G	T	18	18	36	0	3	39	0	0
19	43074692	.	G	C	24	20	44	0	0	44	0	0
19	43074716	.	G	A	28	13	41	0	1	42	0	0
19	43076458	.	C	T	19	13	32	0	1	33	0	0
19	43083844	.	C	T	22	13	35	0	1	36	0	0
19	43120316	.	C	T	35	23	58	14	1	73	0	0
19	43120471	.	T	C	42	35	77	0	4	81	0	0
19	43121440	.	G	A	38	37	75	2	1	78	0	0
19	43121700	.	G	A	3	4	7	79	2	88	0	0
19	43121736	.	G	A	24	19	43	39	2	84	0	0
19	43121784	.	C	T	38	27	65	0	7	72	0	0
19	43121826	.	T	C	35	42	77	0	3	80	0	0
19	43126014	.	G	A	12	28	40	9	1	50	0	0
19	43126104	.	C	T	14	8	22	35	1	58	0	0
19	43126113	.	C	T	10	15	25	27	0	52	0	0
19	43126140	.	C	T	17	19	36	0	2	38	0	0
19	43129049	.	G	T	1	20	21	0	14	35	0	0
19	43129076	.	A	G	19	19	38	0	1	39	0	0
19	43133087	.	A	G	13	18	31	0	0	31	0	0
19	43269988	.	G	A	0	3	3	0	1	4	0	0
19	43272295	.	G	A	4	3	7	0	0	7	0	0
19	43300306	.	G	C	1	3	4	0	0	4	0	0
19	43302585	.	C	T	3	2	5	0	0	5	0	0
19	43304729	.	C	T	3	5	8	0	0	8	0	0
19	43304735	.	T	C	3	4	7	0	1	8	0	0
19	43305757	.	G	A	0	6	6	0	1	7	0	0
19	43344892	.	T	C	1	2	3	0	0	3	0	0
19	43347289	.	A	C	4	2	6	0	0	6	0	0
19	43347290	.	G	T	4	1	5	0	1	6	0	0
19	43352555	.	G	T	0	4	4	0	8	12	0	0
19	43357405	.	A	T	1	2	3	0	1	4	0	0
19	43400176	.	T	C	1	1	2	0	1	3	0	0
19	43420992	.	C	T	2	2	4	0	0	4	0	0
19	43430829	.	C	A	1	2	3	0	1	4	0	0
19	43430838	.	T	A	1	3	4	0	0	4	0	0
19	43430874	.	T	C	1	2	3	0	0	3	0	0
19	43431983	.	C	A	1	3	4	0	0	4	0	0
19	43491305	.	C	T	4	4	8	0	0	8	0	0
19	43491350	.	A	G	6	3	9	0	1	10	0	0
19	43491739	.	T	A	9	9	18	0	1	19	0	0
19	43492136	.	G	A	3	6	9	0	2	11	0	0
19	43492175	.	A	G	6	9	15	0	0	15	0	0
19	43492280	.	T	C	9	13	22	0	0	22	0	0
19	43492361	.	G	A	0	6	6	0	6	12	0	0
19	43492363	.	T	A	5	6	11	0	1	12	0	0
19	43492439	.	G	A	4	2	6	0	1	7	0	0
19	43492955	.	T	C	8	8	16	0	0	16	0	0
19	43493300	.	G	A	6	8	14	0	1	15	0	0
19	43493372	.	G	A	3	7	10	0	0	10	0	0
19	43493466	.	T	C	3	6	9	0	0	9	0	0
19	43493514	.	G	A	6	6	12	0	1	13	0	0
19	43494040	.	A	C	9	12	21	0	0	21	0	0
19	43494128	.	G	A	0	5	5	0	2	7	0	0
19	43494452	.	G	T	3	8	11	0	1	12	0	0
19	43494456	.	G	C	5	8	13	0	0	13	0	0
19	43494700	.	C	T	12	11	23	0	1	24	0	0
19	43494911	.	C	T	21	14	35	0	1	36	0	0
19	43495202	.	C	G	11	0	11	0	8	19	0	0
19	43495376	.	G	A	0	13	13	0	10	23	0	0
19	43498940	.	A	G	12	8	20	0	0	20	0	0
19	43499311	.	C	T	12	12	24	0	2	26	0	0
19	43499616	.	T	C	14	9	23	0	2	25	0	0
19	43499930	.	G	T	8	10	18	0	0	18	0	0
19	43499942	.	A	T	9	8	17	0	1	18	0	0
19	43534097	.	C	T	1	2	3	0	0	3	0	0
19	43539145	.	T	C	1	2	3	0	0	3	0	0
19	43541787	.	T	C	1	2	3	0	1	4	0	0
19	43542261	.	G	A	1	3	4	0	2	6	0	0
19	43542285	.	G	A	3	3	6	0	0	6	0	0
19	43542303	.	A	G	0	1	1	1	4	6	0	0
19	43542758	.	A	C	3	3	6	0	0	6	0	0
19	43547605	.	T	C	8	9	17	0	0	17	0	0
19	43547685	.	A	T	2	7	9	0	0	9	0	0
19	43547906	.	C	T	0	3	3	3	12	18	0	0
19	43547913	.	A	T	13	3	16	3	0	19	0	0
19	43548006	.	G	C	8	6	14	5	1	20	0	0
19	43548910	.	T	A	17	5	22	0	0	22	0	0
19	43549200	.	C	T	1	25	26	1	14	42	1	0
19	43549215	.	T	C	27	7	34	1	0	35	0	0
19	43549305	.	A	G	20	11	31	0	3	34	0	0
19	43549554	.	C	T	11	10	21	0	0	21	0	0
19	43549622	.	A	G	9	8	17	0	0	17	0	0
19	43549860	.	G	T	8	8	16	0	3	19	0	0
19	43552135	.	C	T	4	12	16	3	0	19	0	0
19	43552189	.	C	A	2	11	13	0	15	28	0	0
19	43552223	.	G	C	15	13	28	0	0	28	0	0
19	43569969	.	A	G	2	5	7	0	0	7	0	0
19	43601908	.	G	A	1	2	3	0	0	3	0	0
19	43615215	.	G	A	1	1	2	0	2	4	0	0
19	43675957	.	C	T	3	2	5	0	0	5	0	0
19	43681225	.	C	T	1	5	6	0	0	6	0	0
19	43681375	.	G	A	6	6	12	0	0	12	0	0
19	43681496	.	G	A	3	3	6	0	1	7	0	0
19	43684392	.	C	A	2	4	6	1	0	7	0	0
19	43684431	.	C	T	3	4	7	1	1	9	0	0
19	43684449	.	G	A	4	4	8	1	0	9	0	0
19	43684513	.	G	A	1	5	6	0	0	6	0	0
19	43686899	.	T	C	3	4	7	0	1	8	0	0
19	43688667	.	G	A	5	5	10	0	0	10	0	0
19	43688727	.	C	T	9	5	14	0	0	14	0	0
19	43690890	.	T	G	9	1	10	0	6	16	0	0
19	43693709	.	C	A	4	13	17	0	1	18	0	0
19	43693915	.	C	T	9	4	13	0	0	13	0	0
19	43696851	.	T	C	7	9	16	0	1	17	0	0
19	43696938	.	G	A	0	7	7	0	5	12	0	0
19	43696953	.	G	A	8	3	11	0	1	12	0	0
19	43697424	.	G	C	6	7	13	0	1	14	0	0
19	43699765	.	T	A	6	4	10	0	1	11	0	0
19	43704324	.	G	A	10	4	14	1	0	15	0	0
19	43704375	.	C	T	10	4	14	0	0	14	0	0
19	43704744	.	C	T	8	9	17	0	2	19	0	0
19	43706681	.	T	C	13	15	28	0	1	29	0	0
19	43706684	.	C	T	12	14	26	0	1	27	0	0
19	43706736	.	G	A	2	14	16	0	10	26	0	0
19	43706808	.	G	C	6	15	21	0	0	21	0	0
19	43706848	.	T	C	7	11	18	0	1	19	0	0
19	43706909	.	C	G	5	9	14	0	1	15	0	0
19	43706921	.	G	T	4	9	13	0	0	13	0	0
19	43706990	.	A	T	5	5	10	0	0	10	0	0
19	43707142	.	T	G	3	5	8	0	0	8	0	0
19	43707143	.	C	A	3	5	8	0	0	8	0	0
19	43716042	.	G	A	0	3	3	0	1	4	0	0
19	43727026	.	C	T	6	3	9	0	1	10	0	0
19	43727110	.	A	C	4	2	6	0	0	6	0	0
19	43738237	.	C	T	12	8	20	0	0	20	0	0
19	43740988	.	A	C	21	7	28	0	1	29	0	0
19	43748671	.	A	C	19	12	31	0	0	31	0	0
19	43748672	.	G	C	18	11	29	0	2	31	0	0
19	43750020	.	T	C	8	0	8	1	20	29	0	0
19	43750085	.	A	G	21	13	34	0	1	35	0	0
19	43782397	.	G	T	35	29	64	0	0	64	0	0
19	43783581	.	C	T	25	33	58	0	1	59	0	0
19	43825877	.	G	T	16	16	32	0	0	32	0	0
19	43831544	.	G	A	17	15	32	0	0	32	0	0
19	43831701	.	C	T	16	9	25	1	2	28	0	0
19	43878258	.	C	T	8	8	16	0	0	16	0	0
19	43880674	.	C	T	4	5	9	0	0	9	0	0
19	43890059	.	G	A	1	18	19	0	8	27	0	0
19	43890068	.	G	A	2	7	9	0	18	27	0	0
19	43891949	.	C	T	12	13	25	0	3	28	0	0
19	43898915	.	C	A	31	14	45	0	2	47	0	0
19	43899208	.	T	A	8	5	13	0	0	13	0	0
19	43899451	.	A	T	16	11	27	0	1	28	0	0
19	43899721	.	G	T	2	5	7	0	0	7	0	0
19	43899851	.	A	G	8	7	15	0	5	20	0	0
19	43899891	.	G	A	11	6	17	3	0	20	0	0
19	43899936	.	G	A	13	9	22	3	1	26	0	0
19	43900013	.	A	G	4	8	12	0	3	15	0	0
19	43900309	.	G	C	5	4	9	0	0	9	0	0
19	43900310	.	G	A	6	4	10	0	0	10	0	0
19	43900453	.	C	A	10	7	17	2	1	20	0	0
19	43900470	.	C	T	5	7	12	2	0	14	0	0
19	43900538	.	G	A	1	7	8	2	4	14	0	0
19	43900568	.	G	A	7	10	17	0	0	17	0	0
19	43900585	.	A	T	9	12	21	0	0	21	0	0
19	43900630	.	C	T	12	17	29	0	0	29	0	0
19	43901107	.	T	C	6	4	10	0	0	10	0	0
19	43901305	.	A	C	18	13	31	0	0	32	1	0
19	43923769	.	C	T	2	3	5	0	0	5	0	0
19	43955061	.	C	T	2	3	5	0	0	5	0	0
19	43971087	.	A	G	3	10	13	0	0	13	0	0
19	43971171	.	T	C	6	4	10	0	2	12	0	0
19	43973986	.	T	G	5	0	5	0	3	8	0	0
19	43974224	.	A	T	17	15	32	1	0	33	0	0
19	43976249	.	G	A	5	11	16	0	1	17	0	0
19	43976286	.	C	T	7	2	9	0	0	9	0	0
19	44031100	.	T	C	1	2	3	0	0	3	0	0
19	44036459	.	C	T	5	2	7	0	0	7	0	0
19	44036656	.	A	T	4	3	7	0	1	8	0	0
19	44049755	.	G	A	16	23	39	0	2	41	0	0
19	44052585	.	A	C	30	35	65	0	1	66	0	0
19	44052588	.	A	G	36	28	64	0	1	65	0	0
19	44054457	.	C	T	37	23	60	0	1	61	0	0
19	44059793	.	G	C	4	4	8	0	0	8	0	0
19	44062448	.	G	A	3	4	7	0	0	7	0	0
19	44063597	.	A	G	3	9	12	0	0	12	0	0
19	44063620	.	T	C	4	7	11	0	0	11	0	0
19	44063765	.	G	T	7	9	16	0	0	16	0	0
19	44063766	.	T	G	5	9	14	0	1	15	0	0
19	44065516	.	A	C	8	4	12	0	0	12	0	0
19	44065545	.	G	A	3	6	9	0	1	10	0	0
19	44068272	.	G	A	29	8	37	0	1	38	0	0
19	44068292	.	A	G	28	9	37	1	1	39	0	0
19	44068328	.	G	A	24	15	39	2	0	41	0	0
19	44068378	.	C	A	19	21	40	0	1	41	0	0
19	44068543	.	G	A	20	26	46	0	1	47	0	0
19	44123822	.	C	A	0	2	2	0	2	4	0	0
19	44127509	.	G	A	1	4	5	0	1	6	0	0
19	44304751	.	G	C	4	4	8	0	0	8	0	0
19	44451929	.	T	A	1	2	3	0	0	3	0	0
19	45376315	.	C	T	0	2	2	0	1	3	0	0
19	45376960	.	T	C	1	2	3	0	0	3	0	0
19	45377017	.	G	A	1	2	3	0	0	3	0	0
19	45578594	.	A	G	2	2	4	0	0	4	0	0
19	45856213	.	T	C	1	5	6	0	0	6	0	0
19	45856414	.	A	G	18	19	37	0	0	37	0	0
19	45859824	.	C	T	27	12	39	1	4	44	0	0
19	45896193	.	C	T	14	12	26	0	0	26	0	0
19	45962161	.	A	C	6	3	9	0	1	10	0	0
19	45962171	.	A	G	7	2	9	0	0	9	0	0
19	45965617	.	A	G	5	0	5	0	5	10	0	0
19	45967297	.	C	G	4	0	4	0	8	12	0	0
19	45967372	.	G	A	10	4	14	0	2	16	0	0
19	45977846	.	A	T	6	5	11	0	0	11	0	0
19	45977857	.	A	G	7	0	7	0	4	11	0	0
19	45977889	.	C	T	4	2	6	0	0	6	0	0
19	45978597	.	A	G	2	2	4	0	0	4	0	0
19	45978614	.	T	A	3	2	5	0	0	5	0	0
19	45979306	.	C	T	4	3	7	0	2	9	0	0
19	45979312	.	G	A	0	3	3	0	7	10	0	0
19	45979394	.	A	G	11	4	15	0	0	15	0	0
19	45980062	.	A	T	6	2	8	0	1	9	0	0
19	45980065	.	T	A	6	2	8	0	1	9	0	0
19	45980423	.	T	A	5	3	8	0	1	9	0	0
19	45980428	.	A	C	6	3	9	0	0	9	0	0
19	45983790	.	T	C	5	4	9	0	0	9	0	0
19	45994212	.	A	G	6	5	11	0	0	11	0	0
19	45994263	.	T	C	8	3	11	0	0	11	0	0
19	45997919	.	T	A	3	4	7	0	0	7	0	0
19	45997964	.	A	G	5	3	8	0	0	8	0	0
19	46001101	.	A	G	2	6	8	0	1	9	0	0
19	46001218	.	G	A	3	5	8	0	0	8	0	0
19	46006195	.	G	A	1	6	7	0	0	7	0	0
19	46006267	.	G	A	4	3	7	0	1	8	0	0
19	46007595	.	A	G	4	3	7	0	0	7	0	0
19	46007631	.	A	G	4	4	8	0	2	10	0	0
19	46007639	.	A	G	4	8	12	0	0	12	0	0
19	46010406	.	C	G	5	4	9	0	0	9	0	0
19	46012407	.	A	C	2	0	2	0	2	4	0	0
19	46019645	.	A	T	7	5	12	0	0	12	0	0
19	46020052	.	C	A	4	6	10	0	2	12	0	0
19	46020177	.	A	C	9	0	9	0	10	19	0	0
19	46020228	.	G	A	11	10	21	0	1	22	0	0
19	46020276	.	C	T	2	9	11	0	11	22	0	0
19	46020462	.	G	A	14	7	21	0	1	22	0	0
19	46020471	.	G	T	13	7	20	0	3	23	0	0
19	46020544	.	G	C	9	0	9	0	11	20	0	0
19	46022418	.	A	G	17	10	27	1	0	28	0	0
19	46028151	.	T	A	17	15	32	0	2	34	0	0
19	46032475	.	A	G	13	7	20	0	0	20	0	0
19	46032485	.	G	T	12	6	18	0	0	18	0	0
19	46032527	.	G	T	11	9	20	0	0	20	0	0
19	46032717	.	T	A	6	4	10	0	0	10	0	0
19	46032947	.	A	G	2	5	7	0	0	7	0	0
19	46033012	.	C	T	5	5	10	0	1	11	0	0
19	46035300	.	C	A	2	3	5	0	0	5	0	0
19	46036046	.	T	A	1	4	5	0	1	6	0	0
19	46047196	.	A	C	5	0	5	0	12	17	0	0
19	46049311	.	C	T	6	6	12	0	1	13	0	0
19	46050782	.	A	C	5	6	11	0	1	12	0	0
19	46122698	.	T	C	3	3	6	0	0	6	0	0
19	46209433	.	G	A	1	3	4	0	1	5	0	0
19	46210120	.	G	T	3	6	9	0	0	9	0	0
19	46210209	.	A	T	4	5	9	0	0	9	0	0
19	46210242	.	G	C	5	4	9	0	0	9	0	0
19	46210286	.	A	G	2	3	5	0	0	5	0	0
19	46210354	.	A	T	4	3	7	1	0	8	0	0
19	46210355	.	T	G	4	3	7	1	0	8	0	0
19	46225972	.	G	A	14	16	30	0	1	31	0	0
19	46237787	.	C	T	13	11	24	0	3	27	0	0
19	46237794	.	A	T	14	11	25	0	2	27	0	0
19	46237844	.	G	T	2	14	16	0	14	30	0	0
19	46238199	.	G	A	1	9	10	0	19	29	0	0
19	46238227	.	T	C	18	7	25	0	2	27	0	0
19	46238297	.	T	G	9	15	24	1	0	25	0	0
19	46238366	.	T	C	8	15	23	0	1	24	0	0
19	46238382	.	G	A	1	10	11	0	12	23	0	0
19	46255532	.	G	C	2	2	4	0	0	4	0	0
19	46259649	.	A	G	22	11	33	0	5	38	0	0
19	46259660	.	A	T	31	16	47	0	1	48	0	0
19	46259709	.	G	A	4	23	27	0	30	57	0	0
19	46280672	.	G	T	0	16	16	0	22	38	0	0
19	46280861	.	G	A	4	17	21	0	25	46	0	0
19	46288632	.	T	C	17	22	39	0	1	40	0	0
19	46303140	.	C	T	31	18	49	0	0	49	0	0
19	46303320	.	G	A	23	14	37	0	1	38	0	0
19	46303330	.	G	A	2	17	19	0	22	41	0	0
19	46303414	.	C	T	29	26	55	0	0	55	0	0
19	46303457	.	A	T	28	25	53	0	2	55	0	0
19	46309596	.	T	C	1	5	6	0	0	6	0	0
19	46309664	.	C	A	5	10	15	0	0	15	0	0
19	46309686	.	A	G	2	0	2	0	5	7	0	0
19	46309787	.	G	A	6	9	15	0	0	15	0	0
19	46322385	.	A	G	8	10	18	0	1	19	0	0
19	46332910	.	G	A	0	6	6	0	7	13	0	0
19	46373704	.	T	G	12	23	35	0	1	36	0	0
19	46373705	.	G	T	11	21	32	0	4	36	0	0
19	47405935	.	C	T	19	16	35	1	1	37	0	0
19	47405946	.	G	T	20	19	39	0	1	40	0	0
19	47431220	.	C	T	3	2	5	0	0	5	0	0
19	47431230	.	G	A	3	2	5	0	0	5	0	0
19	47431333	.	G	A	1	7	8	0	0	8	0	0
19	47431459	.	C	T	9	10	19	0	0	19	0	0
19	47431501	.	C	T	2	7	9	0	6	15	0	0
19	47431510	.	A	G	8	7	15	0	0	15	0	0
19	47434142	.	T	C	5	0	5	0	9	14	0	0
19	47438149	.	C	G	2	5	7	0	1	8	0	0
19	47448486	.	G	A	6	5	11	0	0	11	0	0
19	47452971	.	A	C	9	1	10	0	11	21	0	0
19	47464500	.	A	G	2	3	5	0	1	6	0	0
19	47464513	.	A	G	2	4	6	0	0	6	0	0
19	47465242	.	C	T	0	3	3	0	4	7	0	0
19	47465387	.	C	A	3	6	9	0	5	14	0	0
19	47465577	.	A	G	5	5	10	0	1	11	0	0
19	47465652	.	C	T	4	5	9	0	0	9	0	0
19	47467919	.	T	C	5	0	5	0	4	9	0	0
19	47471680	.	G	T	2	2	4	0	0	4	0	0
19	47471886	.	A	C	3	3	6	0	0	6	0	0
19	47478108	.	G	A	4	6	10	0	0	10	0	0
19	47478140	.	G	A	5	5	10	0	1	11	0	0
19	47478161	.	C	T	3	3	6	0	1	7	0	0
19	47478842	.	C	T	4	3	7	0	1	8	0	0
19	47479051	.	G	T	8	5	13	0	0	13	0	0
19	47479084	.	A	G	10	5	15	0	0	15	0	0
19	47579267	.	G	A	3	3	6	0	0	6	0	0
19	47782851	.	T	A	1	2	3	0	0	3	0	0
19	47782854	.	A	G	1	1	2	0	0	2	0	0
19	47783172	.	A	G	4	3	7	0	0	7	0	0
19	47783307	.	G	A	1	5	6	1	0	7	0	0
19	47784172	.	C	T	2	6	8	0	0	8	0	0
19	47787193	.	T	G	1	2	3	0	0	3	0	0
19	47800607	.	T	C	12	0	12	0	14	26	0	0
19	47800673	.	A	C	19	17	36	1	0	37	0	0
19	47802932	.	A	G	18	13	31	0	1	32	0	0
19	47807819	.	C	T	3	14	17	0	16	33	0	0
19	47807855	.	G	A	16	24	40	0	1	41	0	0
19	47808044	.	A	G	21	13	34	0	0	34	0	0
19	47811955	.	A	G	12	10	22	0	2	24	0	0
19	47819698	.	G	A	12	14	26	0	2	28	0	0
19	47820986	.	G	A	10	6	16	0	0	17	1	0
19	47821025	.	A	G	13	10	23	0	4	27	0	0
19	47839268	.	T	C	1	2	3	0	0	3	0	0
19	47976325	.	C	T	18	25	43	0	3	46	0	0
19	47980813	.	C	T	26	18	44	0	6	50	0	0
19	47982822	.	C	T	2	19	21	0	25	46	0	0
19	47982843	.	G	A	27	20	47	0	1	48	0	0
19	47982891	.	G	T	27	21	48	0	1	49	0	0
19	47982897	.	A	G	28	19	47	0	1	48	0	0
19	47983014	.	C	G	27	24	51	0	0	51	0	0
19	47984483	.	C	T	17	13	30	0	0	30	0	0
19	47984970	.	G	A	26	20	46	1	3	50	0	0
19	47986324	.	C	T	0	21	21	0	16	37	0	0
19	47986411	.	G	A	20	21	41	0	1	42	0	0
19	47987084	.	C	T	0	18	18	0	22	40	0	0
19	47989408	.	G	A	24	11	35	0	1	36	0	0
19	47989417	.	T	C	24	12	36	0	1	37	0	0
19	47997402	.	C	T	1	13	14	0	10	24	0	0
19	47997422	.	C	G	3	4	7	0	0	7	0	0
19	48013172	.	A	G	16	7	23	0	1	24	0	0
19	48013584	.	G	A	6	6	12	0	0	12	0	0
19	48013940	.	C	T	2	8	10	0	12	22	0	0
19	48018005	.	C	A	2	3	5	0	0	5	0	0
19	48018578	.	C	A	3	3	6	0	0	6	0	0
19	48018591	.	A	G	1	1	2	0	1	3	0	0
19	48022989	.	T	G	24	23	47	0	2	49	0	0
19	48023309	.	A	G	29	1	30	1	24	55	0	0
19	48025326	.	C	T	9	4	13	0	0	13	0	0
19	48030734	.	C	T	11	11	22	0	1	23	0	0
19	48031094	.	T	C	7	4	11	0	0	11	0	0
19	48033564	.	T	C	16	12	28	0	0	28	0	0
19	48036716	.	C	T	21	18	39	0	2	41	0	0
19	48036809	.	T	G	16	0	16	0	25	41	0	0
19	48049279	.	T	G	16	11	27	0	1	28	0	0
19	48050152	.	C	A	13	17	30	0	1	31	0	0
19	48051070	.	C	G	11	0	11	0	10	21	0	0
19	48053315	.	A	C	21	7	28	0	0	28	0	0
19	48055131	.	G	A	1	21	22	0	19	41	0	0
19	48058778	.	C	T	24	15	39	0	0	39	0	0
19	48064520	.	A	G	3	0	3	0	2	5	0	0
19	48065164	.	T	C	4	6	10	0	0	10	0	0
19	48065285	.	T	A	3	4	7	0	0	7	0	0
19	48065592	.	C	T	4	2	6	0	1	7	0	0
19	48065917	.	A	C	8	4	12	0	0	12	0	0
19	48065970	.	C	T	5	4	9	0	1	10	0	0
19	48067256	.	C	T	5	3	8	0	0	8	0	0
19	48069366	.	T	C	8	3	11	0	0	11	0	0
19	48113914	.	A	G	4	2	6	0	0	6	0	0
19	48114098	.	G	A	2	6	8	0	2	10	0	0
19	48114268	.	G	A	1	4	5	0	7	12	0	0
19	48120142	.	G	T	3	20	23	0	25	48	0	0
19	48120238	.	A	G	12	0	12	0	14	26	0	0
19	48284177	.	T	C	1	2	3	0	0	3	0	0
2	19225	.	T	C	24	26	50	0	6	56	0	0
2	19568	.	G	A	35	24	59	0	1	60	0	0
2	21074	.	A	G	35	29	64	0	3	67	0	0
2	21479	.	C	T	7	31	38	0	23	61	0	0
2	68899	.	A	G	2	5	7	0	0	7	0	0
2	98451	.	A	G	1	3	4	0	0	4	0	0
2	98517	.	G	C	2	3	5	0	0	5	0	0
2	108000	.	C	T	12	6	18	0	1	19	0	0
2	108586	.	G	A	1	11	12	0	9	21	0	0
2	109030	.	G	A	11	16	27	0	1	28	0	0
2	109075	.	T	C	3	5	8	0	0	8	0	0
2	113582	.	T	C	2	3	5	0	1	6	0	0
2	113654	.	A	G	2	3	5	0	0	5	0	0
2	136352	.	C	T	1	7	8	0	0	8	0	0
2	136368	.	C	T	4	5	9	0	1	10	0	0
2	136409	.	T	G	8	4	12	0	1	13	0	0
2	136479	.	A	G	11	11	22	0	1	23	0	0
2	137169	.	T	C	8	3	11	0	0	11	0	0
2	138603	.	G	A	9	3	12	0	1	13	0	0
2	138785	.	A	G	4	3	7	0	0	7	0	0
2	141926	.	G	A	3	3	6	0	1	7	0	0
2	145477	.	A	G	1	3	4	0	1	5	0	0
2	146199	.	T	C	1	4	5	0	0	5	0	0
2	272954	.	C	T	5	2	7	0	0	7	0	0
2	374634	.	T	C	3	3	6	0	0	6	0	0
2	1058111	.	T	C	1	5	6	0	0	6	0	0
2	1213640	.	C	T	1	2	3	0	0	3	0	0
2	1215156	.	G	A	0	4	4	0	2	6	0	0
2	1215160	.	A	G	2	4	6	0	0	6	0	0
2	1220802	.	T	C	13	8	21	0	2	23	0	0
2	1453259	.	G	A	10	12	22	0	0	22	0	0
2	1458357	.	T	C	4	6	10	0	1	11	0	0
2	1463612	.	A	C	5	0	5	0	3	8	0	0
2	1466478	.	T	C	3	0	3	0	7	10	0	0
2	1466829	.	G	A	4	6	10	0	0	10	0	0
2	1502836	.	A	G	1	3	4	0	0	4	0	0
2	1506632	.	T	C	3	4	7	0	0	7	0	0
2	1506641	.	T	G	3	4	7	0	0	7	0	0
2	1527682	.	C	G	7	3	10	0	0	10	0	0
2	1527828	.	T	C	8	0	8	0	11	19	0	0
2	1529602	.	G	C	7	0	7	0	7	14	0	0
2	1533027	.	T	A	13	6	19	0	0	19	0	0
2	1540611	.	A	C	6	0	6	0	11	17	0	0
2	1543191	.	A	G	9	4	13	0	0	13	0	0
2	1548336	.	C	T	2	4	6	0	6	12	0	0
2	1548430	.	T	A	7	5	12	0	1	13	0	0
2	1569132	.	T	C	7	4	11	0	1	12	0	0
2	1595187	.	C	T	10	3	13	0	0	13	0	0
2	1595275	.	T	C	4	26	30	1	0	31	0	0
2	1595330	.	A	G	23	9	32	1	0	33	0	0
2	1595334	.	G	A	21	8	29	1	0	30	0	0
2	1595495	.	C	T	1	7	8	0	10	18	0	0
2	1595524	.	T	G	10	10	20	0	0	20	0	0
2	1595897	.	T	C	4	7	11	0	0	11	0	0
2	1595914	.	T	C	4	7	11	0	3	14	0	0
2	1595945	.	G	C	12	9	21	0	1	22	0	0
2	1596159	.	C	T	1	7	8	0	10	18	0	0
2	1596165	.	T	C	12	4	16	0	1	17	0	0
2	1596196	.	T	A	7	11	18	0	0	18	0	0
2	1596282	.	G	T	9	4	13	0	0	13	0	0
2	1596325	.	C	A	1	7	8	0	10	18	0	0
2	1596327	.	C	T	1	5	6	0	12	18	0	0
2	1596424	.	T	A	10	5	15	0	1	16	0	0
2	1596671	.	C	T	6	5	11	0	0	11	0	0
2	1596690	.	T	C	5	4	9	0	1	10	0	0
2	1596744	.	G	A	6	3	9	0	0	9	0	0
2	1596830	.	C	T	1	2	3	0	2	5	0	0
2	1596908	.	A	T	7	4	11	0	0	11	0	0
2	1597048	.	C	T	10	5	15	0	0	15	0	0
2	1597054	.	A	G	10	6	16	0	0	16	0	0
2	1597084	.	G	A	8	4	12	0	0	12	0	0
2	1597096	.	G	A	5	3	8	0	0	8	0	0
2	1597226	.	G	A	9	4	13	0	0	13	0	0
2	1597396	.	A	C	8	10	18	0	0	18	0	0
2	1597413	.	T	C	10	8	18	0	0	18	0	0
2	1597534	.	T	C	8	0	8	0	7	15	0	0
2	1597588	.	A	G	2	6	8	0	0	8	0	0
2	1597617	.	T	C	6	5	11	0	1	12	0	0
2	1597634	.	T	A	10	8	18	0	0	18	0	0
2	1597658	.	C	T	1	5	6	0	14	20	0	0
2	1598065	.	A	G	7	5	12	0	0	12	0	0
2	1598115	.	C	A	5	10	15	0	0	15	0	0
2	1598124	.	G	A	5	11	16	0	0	16	0	0
2	1598533	.	A	C	13	0	13	0	8	21	0	0
2	1602477	.	C	T	0	6	6	0	5	11	0	0
2	1714687	.	T	C	2	4	6	0	0	6	0	0
2	1714740	.	T	G	3	3	6	0	0	6	0	0
2	1759608	.	G	T	0	3	3	0	4	7	0	0
2	1771164	.	C	T	5	3	8	0	0	8	0	0
2	1771233	.	A	T	3	3	6	0	0	6	0	0
2	1771464	.	T	C	3	2	5	0	0	5	0	0
2	1846555	.	G	A	0	4	4	0	7	11	0	0
2	1846624	.	A	G	4	3	7	0	1	8	0	0
2	1868115	.	T	C	5	3	8	0	0	8	0	0
2	1941054	.	G	A	9	3	12	0	0	12	0	0
2	1942812	.	C	T	6	5	11	0	1	12	0	0
2	1943037	.	A	G	7	0	7	0	8	15	0	0
2	1989937	.	A	C	2	2	4	0	0	4	0	0
2	2003525	.	T	C	3	3	6	0	0	6	0	0
2	2005807	.	T	C	7	7	14	0	1	15	0	0
2	2005836	.	T	A	3	3	6	0	2	8	0	0
2	2005844	.	C	A	4	5	9	0	0	9	0	0
2	2005892	.	T	C	3	3	6	0	0	6	0	0
2	2008145	.	C	T	1	2	3	0	0	3	0	0
2	2010765	.	T	C	25	0	25	0	31	56	0	0
2	2010945	.	G	C	28	24	52	0	1	53	0	0
2	2011287	.	T	A	21	19	40	0	0	40	0	0
2	2013834	.	C	T	0	17	17	0	21	39	1	0
2	2017450	.	T	C	22	14	36	1	1	38	0	0
2	2024876	.	A	G	4	4	8	0	0	8	0	0
2	2025044	.	A	G	5	9	14	0	1	15	0	0
2	2025080	.	T	C	8	8	16	0	1	17	0	0
2	2025175	.	C	A	10	10	20	0	0	20	0	0
2	2025219	.	G	T	7	9	16	0	1	17	0	0
2	2025617	.	A	G	12	12	24	0	0	24	0	0
2	2026068	.	G	A	8	12	20	0	0	20	0	0
2	2026218	.	G	A	4	4	8	0	1	9	0	0
2	2026243	.	G	C	0	10	10	0	0	10	0	0
2	2026397	.	T	C	11	11	22	0	0	22	0	0
2	2026475	.	G	T	8	10	18	0	1	19	0	0
2	2039601	.	A	G	4	4	8	0	0	8	0	0
2	2045718	.	G	A	5	7	12	0	0	12	0	0
2	2045780	.	T	C	6	0	6	0	3	9	0	0
2	2047189	.	G	A	6	3	9	0	0	9	0	0
2	2047234	.	G	A	2	6	8	0	0	8	0	0
2	2069832	.	T	C	3	5	8	0	0	8	0	0
2	2069850	.	C	T	4	4	8	0	1	9	0	0
2	2095574	.	G	C	5	5	10	0	0	10	0	0
2	2160886	.	T	C	1	2	3	0	0	3	0	0
2	2161356	.	C	T	4	3	7	0	0	7	0	0
2	2168642	.	T	A	19	23	42	0	1	43	0	0
2	2169353	.	T	C	17	29	46	0	1	47	0	0
2	2172878	.	G	A	2	8	10	0	18	28	0	0
2	2172879	.	T	A	21	8	29	0	0	29	0	0
2	2173317	.	A	T	26	23	49	0	1	50	0	0
2	2248991	.	C	A	2	4	6	0	1	7	0	0
2	2248993	.	C	T	4	3	7	0	1	8	0	0
2	2251501	.	C	T	4	9	13	0	0	14	1	0
2	2256216	.	T	C	3	7	10	0	0	10	0	0
2	2256372	.	C	G	5	6	11	0	0	11	0	0
2	2256375	.	C	T	6	5	11	0	0	11	0	0
2	2630212	.	A	G	39	21	60	0	2	62	0	0
2	2633731	.	G	A	35	30	65	1	3	69	0	0
2	2638528	.	C	T	5	23	28	0	30	58	0	0
2	2774460	.	C	T	7	6	13	0	0	13	0	0
2	2785378	.	C	T	7	11	18	0	0	18	0	0
2	2786198	.	T	A	6	8	14	0	0	14	0	0
2	2791168	.	C	T	2	12	14	0	11	25	0	0
2	2792843	.	A	G	15	7	22	0	2	24	0	0
2	2795564	.	C	T	10	12	22	0	1	23	0	0
2	2797105	.	C	T	5	6	11	0	2	13	0	0
2	2805882	.	T	C	10	0	10	0	7	17	0	0
2	2818664	.	G	A	0	3	3	0	2	5	0	0
2	2849616	.	C	T	2	3	5	0	1	6	0	0
2	2851740	.	C	A	1	3	4	0	0	4	0	0
2	2851746	.	G	T	0	3	3	0	1	4	0	0
2	2854959	.	C	G	2	4	6	0	0	6	0	0
2	2856851	.	T	A	2	6	8	0	0	8	0	0
2	2857400	.	T	C	2	7	9	0	0	9	0	0
2	2859642	.	C	T	2	7	9	0	1	10	0	0
2	2867344	.	A	G	4	7	11	0	0	11	0	0
2	2869590	.	A	G	9	6	15	0	1	16	0	0
2	2871722	.	T	C	4	7	11	0	0	11	0	0
2	2872180	.	G	T	0	4	4	0	6	10	0	0
2	2872550	.	G	A	9	10	19	0	0	19	0	0
2	2872565	.	A	G	9	8	17	0	0	17	0	0
2	2873531	.	A	G	9	0	9	0	10	19	0	0
2	2873546	.	G	A	8	7	15	0	0	15	0	0
2	2873579	.	T	A	6	5	11	0	0	11	0	0
2	2883302	.	C	T	3	4	7	0	1	8	0	0
2	2892531	.	A	G	5	10	15	0	2	17	0	0
2	2894098	.	A	T	11	8	19	0	3	22	0	0
2	2900553	.	A	T	10	3	13	0	0	13	0	0
2	2905776	.	G	A	5	9	14	0	1	15	0	0
2	2905812	.	C	G	4	0	4	0	5	9	0	0
2	2905996	.	T	C	10	10	20	0	0	20	0	0
2	2908617	.	A	G	9	0	9	0	7	16	0	0
2	2911877	.	G	T	12	6	18	0	1	19	0	0
2	2911892	.	A	T	11	9	20	0	1	21	0	0
2	2913151	.	C	T	17	12	29	0	0	29	0	0
2	2913161	.	G	A	16	16	32	0	0	32	0	0
2	2916697	.	T	C	14	7	21	0	0	21	0	0
2	2917105	.	T	C	21	7	28	0	0	28	0	0
2	2967361	.	A	C	7	5	12	0	1	13	0	0
2	2967440	.	T	G	2	6	8	0	1	9	0	0
2	2967453	.	C	T	3	4	7	0	0	7	0	0
2	2973759	.	C	A	3	10	13	0	1	14	0	0
2	2975272	.	G	A	10	10	20	0	0	20	0	0
2	2977237	.	C	A	6	12	18	0	0	18	0	0
2	2987062	.	G	A	8	10	18	0	0	18	0	0
2	2987320	.	A	G	2	4	6	0	1	7	0	0
2	2987488	.	A	C	3	7	10	6	0	16	0	0
2	3001285	.	G	C	1	3	4	0	0	4	0	0
2	3001301	.	T	A	1	2	3	0	0	3	0	0
2	3001340	.	G	T	3	6	9	0	0	9	0	0
2	3014242	.	G	C	3	5	8	0	0	8	0	0
2	3014326	.	G	A	2	3	5	0	1	6	0	0
2	3015951	.	T	C	3	4	7	0	3	10	0	0
2	3015975	.	T	C	3	5	8	0	0	8	0	0
2	3020186	.	G	T	3	6	9	0	0	9	0	0
2	3022253	.	G	A	0	5	5	0	1	6	0	0
2	3026997	.	T	C	16	5	21	0	0	21	0	0
2	3027065	.	T	A	18	3	21	0	0	21	0	0
2	3027066	.	A	T	16	3	19	0	0	19	0	0
2	3027200	.	T	A	21	17	38	0	0	38	0	0
2	3027286	.	G	A	9	10	19	0	0	19	0	0
2	3027383	.	C	T	9	5	14	0	0	14	0	0
2	3027504	.	C	T	14	10	24	0	1	25	0	0
2	3027704	.	C	G	14	13	27	0	0	27	0	0
2	3027765	.	G	T	13	9	22	0	1	24	1	0
2	3027804	.	C	T	4	9	13	0	15	28	0	0
2	3027859	.	T	C	19	0	19	0	13	32	0	0
2	3027862	.	A	G	20	14	34	0	0	34	0	0
2	3027928	.	T	C	13	11	24	0	1	25	0	0
2	3028117	.	A	G	19	7	26	0	3	29	0	0
2	3028156	.	G	T	20	8	28	0	0	28	0	0
2	3028203	.	T	C	15	14	29	0	4	33	0	0
2	3028233	.	C	T	13	17	30	0	0	30	0	0
2	3028270	.	A	T	15	12	27	0	2	29	0	0
2	3028312	.	T	G	15	9	24	0	0	24	0	0
2	3028463	.	G	A	6	4	10	0	0	10	0	0
2	3028558	.	T	C	12	5	17	6	3	26	0	0
2	3028605	.	G	A	12	9	21	0	1	22	0	0
2	3028715	.	C	T	3	7	10	0	0	10	0	0
2	3028893	.	A	G	12	7	19	0	1	20	0	0
2	3028908	.	A	T	9	7	16	0	1	17	0	0
2	3029048	.	T	C	9	0	9	0	6	15	0	0
2	3029383	.	T	A	15	8	23	0	1	24	0	0
2	3032707	.	G	A	15	7	22	0	3	25	0	0
2	3032944	.	C	T	0	11	11	0	6	17	0	0
2	3034701	.	T	C	11	0	11	0	13	24	0	0
2	3034704	.	T	A	12	11	23	0	2	25	0	0
2	3034819	.	G	A	15	13	28	0	3	31	0	0
2	3045272	.	C	G	6	6	12	0	0	12	0	0
2	3056663	.	A	C	4	4	8	0	1	9	0	0
2	3062181	.	T	G	1	4	5	0	0	5	0	0
2	3062464	.	C	A	5	2	7	0	0	7	0	0
2	3064922	.	A	G	5	6	11	0	0	11	0	0
2	3064984	.	C	G	2	2	4	0	1	5	0	0
2	3064991	.	T	C	2	2	4	0	0	4	0	0
2	3065248	.	C	T	3	4	7	0	0	7	0	0
2	3065507	.	C	T	6	9	15	0	1	16	0	0
2	3065563	.	G	A	5	6	11	0	1	12	0	0
2	3065581	.	A	T	6	5	11	0	0	11	0	0
2	3065633	.	A	T	5	4	9	0	0	9	0	0
2	3066003	.	T	A	7	4	11	0	0	11	0	0
2	3066391	.	A	T	1	2	3	0	0	3	0	0
2	3067118	.	C	A	1	3	4	0	0	4	0	0
2	3067132	.	T	C	1	0	1	0	4	5	0	0
2	3818372	.	G	A	0	2	2	1	3	6	0	0
2	3818379	.	C	T	3	2	5	1	0	6	0	0
2	4045400	.	T	C	10	5	15	0	1	16	0	0
2	4074533	.	C	T	1	6	7	0	0	7	0	0
2	4729329	.	G	A	6	3	9	0	1	10	0	0
2	4729554	.	A	G	5	8	13	0	1	14	0	0
2	4729682	.	A	T	7	6	13	0	0	13	0	0
2	4729798	.	A	T	5	7	12	0	1	13	0	0
2	4729857	.	G	T	5	9	14	0	0	14	0	0
2	4730051	.	T	C	1	4	5	0	0	5	0	0
2	4735995	.	G	A	4	3	7	0	1	8	0	0
2	4736978	.	G	A	2	3	5	0	2	7	0	0
2	4737177	.	C	G	8	4	12	0	1	13	0	0
2	4737217	.	G	T	9	4	13	0	0	13	0	0
2	4737350	.	G	T	6	4	10	0	0	10	0	0
2	4737427	.	C	T	1	3	4	0	3	7	0	0
2	4753966	.	C	A	4	3	7	0	0	7	0	0
2	4754041	.	T	G	2	2	4	0	0	4	0	0
2	4900688	.	A	C	19	15	34	1	1	36	0	0
2	4900798	.	T	C	17	21	38	0	0	38	0	0
2	4907857	.	C	T	19	12	31	0	2	33	0	0
2	4916452	.	G	A	14	15	29	0	1	30	0	0
2	4930730	.	T	C	10	7	17	0	0	17	0	0
2	4948832	.	A	G	13	8	21	0	1	22	0	0
2	4948850	.	G	A	15	6	21	0	0	21	0	0
2	4950607	.	C	T	5	15	20	0	1	21	0	0
2	4956028	.	T	G	6	9	15	0	1	17	1	0
2	4984371	.	A	T	4	2	6	0	0	6	0	0
2	4995045	.	C	G	8	8	16	0	1	17	0	0
2	4995084	.	C	T	3	4	7	0	13	20	0	0
2	5014631	.	A	C	12	13	25	0	0	25	0	0
2	5043749	.	T	A	5	3	8	0	0	8	0	0
2	5407489	.	A	G	7	3	10	0	0	10	0	0
2	5579958	.	A	G	6	0	6	0	6	12	0	0
2	5883127	.	A	G	18	10	28	0	1	29	0	0
2	5883978	.	A	G	11	9	20	0	1	21	0	0
2	5884019	.	A	G	13	5	18	0	1	19	0	0
2	6536647	.	T	C	4	2	6	0	0	6	0	0
2	6952707	.	A	G	6	3	9	0	0	9	0	0
2	6952748	.	A	G	5	3	8	0	0	8	0	0
2	7153861	.	T	C	3	1	4	0	2	6	0	0
2	7153868	.	T	C	0	0	0	0	4	4	0	0
2	7154458	.	T	C	2	1	3	0	2	5	0	0
2	7154584	.	T	C	1	5	6	0	0	6	0	0
2	7423129	.	T	C	2	9	11	0	0	11	0	0
2	7423142	.	T	C	3	0	3	0	7	10	0	0
2	7766457	.	C	T	1	7	8	0	4	12	0	0
2	7778578	.	C	T	0	2	2	0	6	8	0	0
2	10149855	.	C	A	6	0	6	2	21	33	4	0
2	10149883	.	C	A	13	0	13	1	15	38	9	0
2	10169139	.	A	G	3	0	3	0	3	6	0	0
2	10685924	.	A	G	8	0	8	0	4	12	0	0
2	11849193	.	T	C	26	7	33	0	0	33	0	0
2	11854040	.	T	C	5	6	11	0	0	11	0	0
2	13927329	.	A	G	4	2	6	0	0	6	0	0
2	14791200	.	A	T	1	4	5	0	1	6	0	0
2	15391424	.	G	A	0	5	5	0	0	5	0	0
2	15942637	.	A	G	5	2	7	0	0	7	0	0
2	16548514	.	T	C	16	8	24	0	0	24	0	0
2	16791706	.	T	C	4	2	6	0	0	6	0	0
2	16791744	.	A	G	3	2	5	0	0	5	0	0
2	16799025	.	T	C	5	2	7	0	1	8	0	0
2	17267217	.	C	T	0	2	2	0	2	4	0	0
2	17267285	.	A	G	3	2	5	0	1	6	0	0
2	17267621	.	G	A	4	2	6	0	0	6	0	0
2	17267626	.	G	A	5	2	7	0	0	7	0	0
2	17317821	.	G	A	2	5	7	0	0	7	0	0
2	17318017	.	G	A	2	4	6	0	0	6	0	0
2	17450642	.	C	T	4	5	9	0	0	9	0	0
2	17450726	.	A	T	5	6	11	0	1	12	0	0
2	17450841	.	A	T	6	3	9	0	1	10	0	0
2	17450859	.	C	A	2	4	6	0	8	14	0	0
2	17450975	.	G	A	7	2	9	0	0	9	0	0
2	17451003	.	G	A	2	8	10	0	1	11	0	0
2	17451198	.	G	A	5	7	12	0	1	13	0	0
2	17451327	.	A	G	13	11	24	0	1	25	0	0
2	17451375	.	G	A	12	11	23	0	1	24	0	0
2	17468947	.	C	T	4	4	8	0	0	8	0	0
2	17483682	.	A	C	2	0	2	0	3	5	0	0
2	17488438	.	G	T	3	2	5	0	1	6	0	0
2	17488590	.	G	A	3	2	5	0	0	5	0	0
2	17578471	.	A	T	4	3	7	0	0	7	0	0
2	17578710	.	A	G	15	23	38	0	4	42	0	0
2	17579033	.	G	A	17	7	24	0	1	25	0	0
2	17579109	.	A	C	20	0	20	0	12	33	1	0
2	17579110	.	A	G	19	12	31	0	2	34	1	0
2	17579324	.	T	C	29	16	45	0	1	46	0	0
2	17579888	.	A	C	27	0	27	0	12	39	0	0
2	17579926	.	G	C	38	1	39	0	12	51	0	0
2	17596503	.	A	G	11	12	23	0	1	24	0	0
2	17617513	.	T	C	12	5	17	0	2	19	0	0
2	17644591	.	G	A	19	15	34	0	1	35	0	0
2	17644609	.	T	C	15	0	15	0	18	33	0	0
2	17646976	.	G	A	12	20	32	0	3	35	0	0
2	17651370	.	A	G	20	16	36	0	2	38	0	0
2	17651466	.	A	G	6	30	36	0	2	38	0	0
2	17651529	.	C	T	2	27	29	0	8	37	0	0
2	17651565	.	C	T	6	25	31	0	2	33	0	0
2	17651574	.	C	T	4	25	29	0	0	29	0	0
2	17702518	.	G	A	15	6	21	0	0	21	0	0
2	17717026	.	A	G	4	16	20	0	1	21	0	0
2	17728132	.	G	A	9	4	13	0	1	14	0	0
2	17792300	.	T	C	6	0	6	0	8	14	0	0
2	18700662	.	A	T	1	6	7	0	0	7	0	0
2	19101485	.	T	G	0	4	4	0	1	5	0	0
2	20285762	.	G	A	2	2	4	0	0	4	0	0
2	20332135	.	A	G	6	4	10	0	1	11	0	0
2	20367846	.	A	C	13	12	25	0	5	30	0	0
2	20367927	.	G	T	11	15	26	0	4	30	0	0
2	20368569	.	A	C	22	11	33	0	1	34	0	0
2	20368630	.	G	A	1	13	14	0	15	29	0	0
2	20368761	.	T	C	13	24	37	0	2	39	0	0
2	20368812	.	G	A	19	17	36	0	2	38	0	0
2	20368965	.	C	T	20	23	43	0	2	45	0	0
2	20369516	.	A	G	19	14	33	0	7	40	0	0
2	20369836	.	A	T	19	24	43	0	1	44	0	0
2	20369925	.	T	A	19	20	39	0	1	40	0	0
2	20369947	.	A	C	15	14	29	1	9	39	0	0
2	20370012	.	C	T	11	14	25	0	1	26	0	0
2	20370090	.	G	C	13	24	37	0	0	37	0	0
2	20370143	.	C	T	18	18	36	1	0	37	0	0
2	20370792	.	T	C	20	20	40	0	0	40	0	0
2	20370893	.	C	T	16	15	31	1	0	32	0	0
2	20370998	.	A	G	14	18	32	0	1	33	0	0
2	20371060	.	T	A	11	13	24	0	0	24	0	0
2	20371210	.	G	C	8	3	11	0	0	11	0	0
2	20437721	.	G	A	7	10	17	0	1	18	0	0
2	20437878	.	G	A	12	5	17	0	1	18	0	0
2	20438054	.	G	A	15	14	29	0	0	29	0	0
2	20438061	.	A	T	13	13	26	0	1	27	0	0
2	20438589	.	C	T	10	7	17	0	1	18	0	0
2	20439070	.	A	G	16	0	16	0	13	29	0	0
2	20439223	.	G	T	13	15	28	0	2	30	0	0
2	20439303	.	C	T	18	6	24	0	0	24	0	0
2	20440244	.	G	A	23	17	40	0	0	40	0	0
2	20473191	.	T	G	11	7	18	0	1	19	0	0
2	20475819	.	A	G	8	7	15	0	0	15	0	0
2	20477158	.	C	T	2	7	9	0	0	9	0	0
2	20478880	.	A	T	7	5	12	0	1	13	0	0
2	20487211	.	C	T	6	4	10	0	0	10	0	0
2	20501627	.	C	A	7	7	14	0	1	15	0	0
2	20501646	.	C	T	6	9	15	0	1	16	0	0
2	20503698	.	C	A	17	11	28	0	0	28	0	0
2	20503734	.	T	G	19	0	19	0	10	29	0	0
2	20503770	.	C	T	14	10	24	0	2	26	0	0
2	20505994	.	C	T	13	7	20	1	0	21	0	0
2	20505995	.	C	T	7	13	20	1	0	21	0	0
2	20514915	.	A	G	11	10	21	1	1	23	0	0
2	20515013	.	G	A	9	14	23	0	0	23	0	0
2	20515056	.	G	A	13	11	24	0	1	25	0	0
2	20515060	.	T	G	14	11	25	0	1	26	0	0
2	20515307	.	C	T	13	11	24	0	3	27	0	0
2	20515377	.	C	T	4	6	10	0	0	10	0	0
2	20516291	.	G	A	8	9	17	0	0	17	0	0
2	20523002	.	C	T	8	18	26	0	2	28	0	0
2	20523004	.	C	T	9	18	27	0	1	28	0	0
2	20523351	.	T	A	27	17	44	0	0	44	0	0
2	20523364	.	A	G	25	16	41	0	0	41	0	0
2	20526411	.	T	C	21	18	39	0	1	40	0	0
2	20526592	.	A	G	10	0	10	0	11	21	0	0
2	20526599	.	T	A	9	12	21	0	0	21	0	0
2	20614879	.	T	C	3	1	4	0	2	6	0	0
2	20663819	.	C	T	1	3	4	0	0	4	0	0
2	20769135	.	A	G	2	2	4	0	0	4	0	0
2	20814291	.	T	G	11	15	26	0	0	26	0	0
2	20814488	.	C	T	9	3	12	0	0	12	0	0
2	20814688	.	G	C	11	0	11	0	11	22	0	0
2	20814754	.	G	T	10	8	18	0	2	20	0	0
2	20817736	.	G	A	10	8	18	0	1	19	0	0
2	20818069	.	C	T	2	4	6	1	10	17	0	0
2	20818075	.	G	A	10	4	14	1	0	15	0	0
2	20820587	.	C	T	13	16	29	0	1	30	0	0
2	20824654	.	T	C	5	0	5	0	6	11	0	0
2	20826495	.	T	C	6	7	13	0	2	15	0	0
2	20828000	.	G	A	7	2	9	0	0	9	0	0
2	20830387	.	A	G	6	10	16	0	1	17	0	0
2	20830993	.	C	G	4	11	15	0	0	15	0	0
2	20836780	.	G	A	5	7	12	0	2	14	0	0
2	20837017	.	G	A	4	5	9	0	1	10	0	0
2	20838513	.	A	G	1	3	4	2	0	6	0	0
2	20840539	.	C	A	3	8	11	0	0	11	0	0
2	20843816	.	A	G	1	3	4	0	1	5	0	0
2	20848862	.	T	C	5	2	7	0	0	7	0	0
2	20849095	.	T	C	2	7	9	0	0	9	0	0
2	20865016	.	G	C	2	3	5	0	0	5	0	0
2	20865044	.	T	C	1	4	5	0	0	5	0	0
2	20868378	.	T	C	5	2	7	0	0	7	0	0
2	20868477	.	G	A	3	2	5	0	1	6	0	0
2	20868556	.	G	T	3	6	9	0	1	10	0	0
2	20873717	.	A	G	5	0	5	0	6	11	0	0
2	20874515	.	T	C	7	6	13	0	2	15	0	0
2	20875112	.	G	A	2	7	9	0	6	15	0	0
2	20875166	.	C	T	8	10	18	0	0	18	0	0
2	20875860	.	A	G	4	9	13	0	0	13	0	0
2	20875922	.	T	A	4	10	14	0	0	14	0	0
2	20967782	.	C	G	5	6	11	0	0	11	0	0
2	20967788	.	G	A	5	4	9	0	2	11	0	0
2	20971382	.	C	T	4	2	6	0	0	6	0	0
2	20971423	.	T	C	1	3	4	0	0	4	0	0
2	20973003	.	G	A	2	2	4	0	0	4	0	0
2	20973419	.	G	A	2	3	5	0	1	6	0	0
2	20973794	.	A	T	5	3	8	0	0	8	0	0
2	20973864	.	G	A	1	2	3	0	5	8	0	0
2	20974085	.	G	A	3	4	7	0	0	7	0	0
2	20974623	.	A	T	3	2	5	0	0	5	0	0
2	20974837	.	T	G	4	0	4	0	4	8	0	0
2	20975010	.	T	C	5	5	10	0	0	10	0	0
2	20975255	.	G	C	6	4	10	0	0	10	0	0
2	20975283	.	C	T	4	7	11	0	0	11	0	0
2	20980356	.	T	C	10	4	14	0	1	15	0	0
2	21071401	.	T	A	9	2	11	0	2	13	0	0
2	21071957	.	G	A	8	4	12	0	1	13	0	0
2	21073286	.	T	A	10	4	14	0	0	14	0	0
2	21073350	.	A	C	14	7	21	0	2	23	0	0
2	21076203	.	C	T	12	10	22	0	2	24	0	0
2	21076499	.	T	G	1	7	8	0	0	8	0	0
2	21076542	.	G	A	5	1	6	0	0	6	0	0
2	21076805	.	C	A	19	5	24	0	1	25	0	0
2	21077033	.	A	G	2	3	5	0	0	5	0	0
2	21077268	.	G	T	21	9	30	0	2	32	0	0
2	21077299	.	C	T	20	13	33	0	0	33	0	0
2	21077726	.	C	T	5	6	11	0	0	11	0	0
2	21082585	.	C	G	5	4	9	0	2	11	0	0
2	21082596	.	C	A	4	4	8	0	0	8	0	0
2	21156575	.	C	T	3	3	6	0	0	6	0	0
2	21156578	.	A	T	3	2	5	0	0	5	0	0
2	21156613	.	T	A	4	5	9	0	0	9	0	0
2	21165495	.	C	G	1	7	8	0	4	12	0	0
2	21177237	.	G	A	15	10	25	0	1	26	0	0
2	21182482	.	G	T	5	4	9	0	0	9	0	0
2	21298986	.	G	C	0	3	3	0	2	5	0	0
2	21309811	.	C	T	2	5	7	0	0	7	0	0
2	21312257	.	T	C	4	7	11	0	1	12	0	0
2	21312440	.	A	C	4	4	8	0	0	8	0	0
2	21312507	.	C	T	2	4	6	0	0	6	0	0
2	21316009	.	G	A	4	3	7	0	0	7	0	0
2	21320489	.	C	A	1	2	3	0	0	3	0	0
2	21320664	.	C	T	2	2	4	0	0	4	0	0
2	21320768	.	G	A	4	6	10	0	0	10	0	0
2	21321730	.	A	G	4	0	4	0	2	6	0	0
2	21338095	.	G	A	2	4	6	0	0	6	0	0
2	21338146	.	C	A	6	4	10	0	0	10	0	0
2	21340920	.	T	C	7	1	8	0	2	10	0	0
2	21348383	.	A	G	1	3	4	0	0	4	0	0
2	21349413	.	C	T	3	4	7	0	0	7	0	0
2	21351972	.	A	G	4	3	7	0	0	7	0	0
2	21356392	.	C	T	5	8	13	0	2	15	0	0
2	21356584	.	T	G	4	7	11	0	1	12	0	0
2	21367952	.	A	G	12	8	20	0	0	20	0	0
2	21367977	.	C	T	7	7	14	0	0	14	0	0
2	21368006	.	T	C	5	4	9	0	0	9	0	0
2	21376407	.	C	T	10	8	18	0	0	18	0	0
2	21381230	.	C	T	12	12	24	0	0	24	0	0
2	21455240	.	C	T	3	6	9	0	1	10	0	0
2	21456950	.	G	A	6	8	14	0	0	14	0	0
2	21459061	.	G	A	4	8	12	0	2	14	0	0
2	21459091	.	G	T	3	11	14	0	1	15	0	0
2	21459100	.	G	A	2	10	12	0	2	14	0	0
2	21459196	.	C	T	11	10	21	0	0	21	0	0
2	21459661	.	C	G	8	5	13	0	2	15	0	0
2	21459701	.	C	A	4	6	10	0	0	10	0	0
2	21462185	.	A	G	6	10	16	0	0	16	0	0
2	21462191	.	A	G	6	8	14	0	0	14	0	0
2	21466555	.	T	C	15	7	22	0	0	22	0	0
2	21466567	.	A	T	16	11	27	0	2	29	0	0
2	21468807	.	G	A	20	22	42	0	2	44	0	0
2	21468825	.	G	A	18	21	39	0	0	39	0	0
2	21469405	.	T	C	9	7	16	0	1	17	0	0
2	21469490	.	T	C	6	10	16	0	1	17	0	0
2	21469644	.	A	G	13	9	22	0	1	23	0	0
2	21469830	.	T	A	4	6	10	1	0	11	0	0
2	21486980	.	T	G	4	6	10	0	0	10	0	0
2	21487190	.	G	A	2	3	5	0	0	5	0	0
2	21501967	.	C	G	4	4	8	0	0	8	0	0
2	21502301	.	G	T	6	4	10	0	0	10	0	0
2	21502307	.	C	T	4	5	9	0	0	9	0	0
2	21502364	.	C	T	6	6	12	0	0	12	0	0
2	21502540	.	G	C	11	10	21	0	0	21	0	0
2	21502964	.	C	T	3	2	5	0	0	5	0	0
2	21605644	.	A	T	4	3	7	0	0	7	0	0
2	21605724	.	T	C	1	4	5	0	0	5	0	0
2	21605937	.	G	T	6	2	8	0	0	8	0	0
2	21607456	.	G	C	6	6	12	0	0	12	0	0
2	21607590	.	T	A	1	2	3	0	0	3	0	0
2	21608427	.	C	G	4	7	11	0	0	11	0	0
2	21608582	.	G	A	9	13	22	0	0	22	0	0
2	21608587	.	C	T	12	13	25	0	1	26	0	0
2	21608710	.	T	A	7	10	17	0	1	18	0	0
2	21608781	.	T	G	8	3	11	0	0	11	0	0
2	21609104	.	A	T	10	4	14	0	1	15	0	0
2	21609223	.	C	T	1	6	7	0	5	12	0	0
2	21609443	.	C	A	15	8	23	0	0	23	0	0
2	21609446	.	C	T	14	8	22	0	1	23	0	0
2	21609718	.	C	T	3	4	7	0	0	7	0	0
2	21609777	.	G	A	5	2	7	0	0	7	0	0
2	21609830	.	T	G	4	3	7	0	0	7	0	0
2	21610233	.	G	A	5	9	14	0	1	15	0	0
2	21612380	.	C	T	1	8	9	0	12	21	0	0
2	21613008	.	T	C	7	4	11	0	0	11	0	0
2	21620412	.	A	G	5	6	11	0	0	11	0	0
2	21620469	.	T	C	7	0	7	0	7	14	0	0
2	21620691	.	G	A	5	7	12	0	0	12	0	0
2	21620856	.	C	T	7	4	11	0	0	11	0	0
2	21621151	.	G	A	6	2	8	0	0	8	0	0
2	21621400	.	C	T	0	7	7	0	5	12	0	0
2	21621423	.	C	T	0	8	8	0	5	13	0	0
2	21621507	.	T	C	2	7	9	0	0	9	0	0
2	21621528	.	A	G	1	5	6	0	0	6	0	0
2	21621606	.	C	T	7	5	12	0	1	13	0	0
2	21621762	.	T	C	2	5	7	0	0	7	0	0
2	21733428	.	A	G	0	3	3	0	1	4	0	0
2	21733731	.	C	T	2	3	5	0	1	6	0	0
2	21766212	.	A	G	9	6	15	0	0	15	0	0
2	21766237	.	G	A	9	10	19	0	0	19	0	0
2	21766277	.	G	A	9	10	19	0	1	20	0	0
2	21766478	.	T	A	7	7	14	0	0	14	0	0
2	21766554	.	G	A	7	8	15	0	0	15	0	0
2	21766785	.	G	A	8	8	16	0	0	17	1	0
2	21767207	.	C	T	13	10	23	0	2	25	0	0
2	21767244	.	A	T	10	8	18	0	0	18	0	0
2	21767286	.	T	C	3	9	12	0	1	13	0	0
2	21768168	.	G	A	8	10	18	0	0	18	0	0
2	21768821	.	T	A	13	11	24	0	0	24	0	0
2	21771191	.	G	T	6	9	15	0	0	15	0	0
2	21772082	.	G	A	3	3	6	0	0	6	0	0
2	21772099	.	G	A	6	4	10	0	0	10	0	0
2	21774400	.	G	A	2	6	8	0	0	8	0	0
2	21777101	.	C	A	7	3	10	0	0	10	0	0
2	21777102	.	A	G	7	3	10	0	0	10	0	0
2	21780896	.	C	T	5	5	10	0	0	10	0	0
2	21806152	.	C	T	0	3	3	0	4	7	0	0
2	21806185	.	T	C	2	0	2	0	4	6	0	0
2	21806462	.	G	T	7	6	13	0	0	13	0	0
2	21807295	.	C	T	6	4	10	0	1	11	0	0
2	21807373	.	G	A	5	7	12	0	0	12	0	0
2	21807396	.	G	A	6	5	11	0	1	12	0	0
2	21822288	.	C	A	22	33	55	0	2	57	0	0
2	21822304	.	A	G	29	15	44	0	5	49	0	0
2	21822816	.	T	A	18	16	34	1	0	35	0	0
2	21827276	.	A	G	28	28	56	0	4	60	0	0
2	21855248	.	C	G	3	10	13	0	2	15	0	0
2	21855253	.	G	A	2	3	5	0	11	16	0	0
2	21861735	.	T	G	11	0	11	0	9	20	0	0
2	21862511	.	C	T	12	7	19	0	0	19	0	0
2	21865620	.	G	C	8	19	27	0	0	27	0	0
2	21877711	.	C	G	6	9	15	0	0	15	0	0
2	21877878	.	G	A	6	8	14	0	1	15	0	0
2	21878036	.	G	C	12	11	23	0	0	23	0	0
2	21878053	.	T	C	17	7	24	0	1	25	0	0
2	21878197	.	T	C	19	11	30	0	0	30	0	0
2	21878415	.	C	T	14	14	28	0	1	29	0	0
2	21878462	.	T	C	12	9	21	0	1	22	0	0
2	21983064	.	T	G	7	0	7	0	10	17	0	0
2	22058071	.	A	G	25	0	25	0	13	38	0	0
2	22058098	.	C	T	23	12	35	0	0	35	0	0
2	22058200	.	C	T	12	10	22	0	2	24	0	0
2	22058254	.	G	A	16	13	29	0	3	32	0	0
2	22058281	.	C	T	15	17	32	0	0	32	0	0
2	22073176	.	C	T	19	16	35	1	3	39	0	0
2	22101657	.	C	T	17	23	40	0	1	41	0	0
2	22101699	.	A	C	16	29	45	0	1	46	0	0
2	22104292	.	C	T	19	15	34	2	1	37	0	0
2	22104415	.	C	A	25	10	35	0	4	39	0	0
2	22104506	.	T	C	9	10	19	0	2	21	0	0
2	22104999	.	A	G	19	17	36	0	0	36	0	0
2	22208514	.	G	T	1	5	6	0	0	6	0	0
2	22208560	.	G	A	6	5	11	0	0	11	0	0
2	22208638	.	A	G	11	4	15	0	0	15	0	0
2	22209045	.	C	A	10	15	25	0	0	25	0	0
2	22209722	.	C	T	11	13	24	0	0	24	0	0
2	22210412	.	G	A	13	10	23	0	1	24	0	0
2	22286813	.	T	A	6	3	9	0	1	10	0	0
2	22353568	.	T	C	17	11	28	0	1	29	0	0
2	22353661	.	T	A	15	13	28	0	0	28	0	0
2	22362290	.	G	A	20	17	37	0	0	37	0	0
2	22362302	.	G	A	20	18	38	0	0	38	0	0
2	22363365	.	T	C	12	16	28	0	0	28	0	0
2	22363418	.	T	A	3	5	8	0	0	8	0	0
2	22480321	.	G	T	5	5	10	0	0	10	0	0
2	22480759	.	G	A	23	20	43	0	0	43	0	0
2	22483222	.	G	A	18	15	33	0	1	34	0	0
2	22483351	.	A	G	15	15	30	0	0	30	0	0
2	22483381	.	A	G	10	16	26	0	3	29	0	0
2	22483423	.	C	T	15	10	25	0	0	25	0	0
2	22483444	.	A	G	16	11	27	0	0	27	0	0
2	22513202	.	A	G	6	2	8	0	1	9	0	0
2	22516758	.	A	G	2	3	5	0	0	5	0	0
2	22521337	.	G	A	6	5	11	0	1	12	0	0
2	22522073	.	A	G	5	3	8	0	0	8	0	0
2	22522211	.	G	T	4	2	6	0	1	7	0	0
2	22522405	.	G	A	2	2	4	0	0	4	0	0
2	22522448	.	A	G	3	3	6	0	0	6	0	0
2	22523573	.	G	A	2	2	4	0	0	4	0	0
2	22565448	.	G	T	3	4	7	0	0	7	0	0
2	22599787	.	C	T	8	15	23	0	0	23	0	0
2	22602653	.	A	G	19	16	35	0	0	35	0	0
2	22602808	.	C	T	11	19	30	0	0	30	0	0
2	22602826	.	C	T	14	10	24	0	2	26	0	0
2	22607462	.	G	A	1	13	14	0	14	28	0	0
2	22608314	.	G	T	17	14	31	0	0	31	0	0
2	22614357	.	T	A	9	4	13	0	2	15	0	0
2	22614448	.	T	A	12	5	17	0	0	17	0	0
2	22614529	.	C	T	5	9	14	2	0	16	0	0
2	22614959	.	A	T	9	9	18	0	1	19	0	0
2	22617836	.	A	G	8	2	10	0	3	13	0	0
2	22617932	.	G	A	30	20	50	1	3	54	0	0
2	22626878	.	T	A	24	13	37	0	1	38	0	0
2	22627149	.	G	A	22	19	41	0	1	42	0	0
2	22629684	.	C	T	3	13	16	0	26	42	0	0
2	22633869	.	G	A	17	21	38	0	1	39	0	0
2	22634070	.	A	G	18	18	36	1	2	40	1	0
2	22653330	.	T	A	5	4	9	0	1	10	0	0
2	22653693	.	T	A	6	13	19	1	0	20	0	0
2	22656651	.	G	A	8	5	13	0	2	15	0	0
2	22656708	.	T	C	7	10	17	0	0	17	0	0
2	22656723	.	C	T	10	5	15	0	0	15	0	0
2	22656870	.	A	G	16	13	29	0	1	30	0	0
2	22659072	.	G	A	9	11	20	0	0	20	0	0
2	22702423	.	T	C	4	21	25	1	1	27	0	0
2	22707536	.	A	C	16	11	27	0	1	28	0	0
2	22710985	.	T	C	17	8	25	0	1	26	0	0
2	22711898	.	T	G	18	20	38	0	0	38	0	0
2	22714603	.	A	G	18	15	33	0	1	34	0	0
2	22714618	.	G	A	21	15	36	0	1	37	0	0
2	22716770	.	T	C	23	18	41	0	6	47	0	0
2	22718895	.	T	A	17	18	35	0	1	36	0	0
2	22719145	.	A	G	24	0	24	0	13	37	0	0
2	22724661	.	T	C	20	19	39	0	0	39	0	0
2	22731426	.	C	T	15	11	26	0	3	29	0	0
2	22731456	.	G	A	14	11	25	0	0	25	0	0
2	22733494	.	A	T	15	15	30	0	1	31	0	0
2	22733813	.	A	G	11	26	37	0	1	38	0	0
2	22735037	.	T	A	28	19	47	0	2	49	0	0
2	22735205	.	A	T	21	27	48	0	2	50	0	0
2	22735232	.	C	T	25	23	48	0	0	48	0	0
2	22742179	.	C	T	18	22	40	0	3	43	0	0
2	22745690	.	C	T	20	19	39	1	1	41	0	0
2	22747304	.	C	T	21	29	50	0	0	50	0	0
2	22750164	.	C	T	25	29	54	0	2	56	0	0
2	22750621	.	C	T	21	23	44	0	1	45	0	0
2	22750622	.	A	G	20	22	42	0	3	45	0	0
2	22756528	.	C	T	32	21	53	0	2	55	0	0
2	22795615	.	A	G	22	20	42	0	1	43	0	0
2	22799294	.	T	A	21	17	38	0	1	39	0	0
2	22801748	.	T	C	28	23	51	0	4	55	0	0
2	22801899	.	A	T	22	10	32	1	2	35	0	0
2	22802030	.	G	A	1	24	25	1	20	46	0	0
2	22802117	.	A	T	14	23	37	0	4	41	0	0
2	22802402	.	T	C	22	15	37	0	1	38	0	0
2	22802504	.	G	A	21	20	41	0	1	42	0	0
2	22802524	.	T	A	23	20	43	0	1	44	0	0
2	22803110	.	T	A	22	29	51	0	1	53	1	0
2	22803128	.	G	T	35	17	52	0	4	56	0	0
2	22803190	.	C	T	15	27	42	0	3	45	0	0
2	22852886	.	A	G	3	5	8	0	0	8	0	0
2	22852911	.	C	A	2	5	7	0	0	7	0	0
2	22857593	.	T	C	4	2	6	0	0	6	0	0
2	22860487	.	A	G	0	2	2	0	1	3	0	0
2	22860489	.	C	A	1	1	2	0	1	3	0	0
2	22933175	.	T	G	2	4	6	0	0	6	0	0
2	22933218	.	C	A	1	2	3	0	0	3	0	0
2	22933539	.	G	A	8	6	14	0	0	14	0	0
2	22933554	.	G	A	8	5	13	0	0	13	0	0
2	22944464	.	G	A	8	7	15	0	1	16	0	0
2	22953020	.	A	C	3	0	3	0	2	5	0	0
2	22953191	.	T	C	2	0	2	0	2	4	0	0
2	22962013	.	A	G	2	10	12	0	0	12	0	0
2	22965169	.	T	C	5	4	9	0	0	9	0	0
2	22965210	.	A	T	4	5	9	0	0	9	0	0
2	22966030	.	C	T	2	4	6	0	0	6	0	0
2	22970363	.	C	A	3	4	7	1	0	8	0	0
2	22970413	.	G	A	4	7	11	0	0	11	0	0
2	22970707	.	G	A	2	3	5	0	1	6	0	0
2	22970764	.	G	A	2	2	4	0	0	4	0	0
2	22971012	.	T	A	10	10	20	0	0	20	0	0
2	22979805	.	G	A	4	7	11	0	1	12	0	0
2	22980020	.	G	C	7	0	7	0	4	11	0	0
2	22994327	.	G	A	6	7	13	0	0	13	0	0
2	22996520	.	A	T	5	7	12	0	0	12	0	0
2	23001533	.	G	A	10	11	21	0	0	22	1	0
2	23001638	.	G	T	15	15	30	0	2	32	0	0
2	23003857	.	C	G	0	4	4	0	4	8	0	0
2	23006825	.	T	A	4	2	6	0	0	6	0	0
2	23007891	.	C	G	2	0	2	0	4	6	0	0
2	23013730	.	C	A	4	6	10	0	0	10	0	0
2	23014154	.	G	A	7	4	11	0	0	11	0	0
2	23020948	.	C	T	9	3	12	0	1	13	0	0
2	23022716	.	C	T	8	3	11	0	0	11	0	0
2	23023331	.	G	A	2	7	9	0	0	9	0	0
2	23023353	.	C	A	2	5	7	0	0	7	0	0
2	23023465	.	G	A	3	8	11	0	1	12	0	0
2	23023466	.	C	G	8	4	12	0	0	12	0	0
2	23023741	.	A	C	3	3	6	0	1	7	0	0
2	23023801	.	C	T	5	3	8	0	0	8	0	0
2	23024069	.	C	A	7	5	12	0	0	12	0	0
2	23024735	.	G	T	4	4	8	0	0	8	0	0
2	23066671	.	C	T	12	15	27	0	1	28	0	0
2	23078082	.	A	G	8	8	16	1	0	17	0	0
2	23082912	.	C	T	1	4	5	0	0	5	0	0
2	23085185	.	C	T	5	3	8	0	1	9	0	0
2	23085242	.	A	G	3	1	4	1	7	12	0	0
2	23088871	.	C	T	3	4	7	0	0	7	0	0
2	23094876	.	C	T	6	3	9	0	0	9	0	0
2	23094912	.	C	T	8	6	14	0	0	14	0	0
2	23098856	.	T	A	2	7	9	0	0	9	0	0
2	23099090	.	G	T	2	3	5	0	0	5	0	0
2	23099141	.	G	A	3	5	8	0	1	9	0	0
2	23099307	.	T	C	2	2	4	0	0	4	0	0
2	23223037	.	C	T	16	8	24	0	1	25	0	0
2	23226584	.	C	T	8	8	16	0	0	16	0	0
2	23227373	.	G	A	6	6	12	0	0	12	0	0
2	23232884	.	T	C	8	6	14	0	1	15	0	0
2	23238502	.	C	T	11	11	22	0	1	23	0	0
2	23263294	.	T	A	16	15	31	0	0	31	0	0
2	23292123	.	A	T	13	21	34	0	0	34	0	0
2	23292262	.	G	A	11	8	19	0	1	20	0	0
2	23292429	.	A	T	9	9	18	1	0	19	0	0
2	23292516	.	G	A	1	11	12	0	8	20	0	0
2	23292549	.	C	A	13	5	18	0	0	18	0	0
2	23292690	.	T	A	12	11	23	0	1	24	0	0
2	23292776	.	G	A	2	7	9	0	1	10	0	0
2	23293123	.	G	C	10	6	16	0	0	16	0	0
2	23293230	.	A	T	10	8	18	0	1	19	0	0
2	23361020	.	T	G	10	17	27	1	0	28	0	0
2	23361605	.	C	T	21	11	32	0	2	34	0	0
2	23361784	.	A	T	6	6	12	0	0	12	0	0
2	23379480	.	G	C	4	5	9	0	0	9	0	0
2	23379532	.	G	A	9	5	14	0	0	14	0	0
2	23379588	.	C	T	11	12	23	0	0	23	0	0
2	23379757	.	T	A	4	2	6	0	1	7	0	0
2	23379861	.	G	A	7	4	11	0	0	11	0	0
2	23380621	.	C	A	8	10	18	0	0	18	0	0
2	23381056	.	A	G	8	9	17	0	1	18	0	0
2	23620085	.	G	C	1	3	4	0	0	4	0	0
2	23644100	.	T	C	2	0	2	0	5	7	0	0
2	23701714	.	A	C	9	9	18	0	0	18	0	0
2	23701743	.	T	A	7	5	12	0	0	12	0	0
2	23707161	.	G	T	4	8	12	0	0	12	0	0
2	23707444	.	T	A	2	4	6	0	0	6	0	0
2	23707568	.	C	T	3	5	8	0	0	8	0	0
2	23707574	.	T	A	3	3	6	0	0	6	0	0
2	23714743	.	A	T	6	7	13	0	0	13	0	0
2	23716575	.	T	C	7	9	16	0	0	16	0	0
2	23716617	.	C	T	9	8	17	0	0	17	0	0
2	23716802	.	A	G	5	0	5	0	7	12	0	0
2	23718286	.	T	C	6	5	11	0	0	11	0	0
2	23722518	.	A	G	6	0	6	0	7	13	0	0
2	23722849	.	T	C	10	7	17	0	1	18	0	0
2	23723172	.	A	C	5	6	11	0	0	11	0	0
2	23723187	.	A	G	6	4	10	0	1	11	0	0
2	23723256	.	C	T	3	3	6	0	0	6	0	0
2	23723438	.	G	T	1	2	3	0	2	5	0	0
2	23723521	.	A	T	5	4	9	0	0	9	0	0
2	23723571	.	G	A	5	6	11	0	0	11	0	0
2	23723594	.	A	G	5	0	5	0	7	12	0	0
2	23723638	.	A	T	4	7	11	0	1	12	0	0
2	23723711	.	T	G	6	5	11	0	0	11	0	0
2	23724469	.	G	A	2	3	5	0	9	14	0	0
2	23724535	.	T	G	8	8	16	0	1	18	1	0
2	23725075	.	G	A	12	2	14	0	1	15	0	0
2	23725159	.	T	C	5	10	15	0	1	16	0	0
2	23725184	.	C	A	10	4	14	0	0	14	0	0
2	23725239	.	C	T	7	3	10	0	0	10	0	0
2	23725608	.	A	T	11	7	18	0	0	18	0	0
2	23726206	.	T	A	5	11	16	0	1	17	0	0
2	23726312	.	G	A	18	11	29	0	0	29	0	0
2	23794620	.	A	G	4	3	7	0	0	7	0	0
2	23794674	.	T	G	1	5	6	0	0	6	0	0
2	23794686	.	A	T	2	5	7	0	0	7	0	0
2	23794719	.	C	G	4	2	6	0	0	6	0	0
2	23796430	.	C	T	4	2	6	0	0	6	0	0
2	23796473	.	T	A	2	2	4	0	0	4	0	0
2	23796486	.	A	G	1	0	1	0	2	3	0	0
2	23796678	.	G	A	2	4	6	0	0	6	0	0
2	23803100	.	C	T	2	2	4	0	0	4	0	0
2	23803219	.	G	A	2	3	5	0	0	5	0	0
2	23803935	.	A	C	1	2	3	0	0	3	0	0
2	23803951	.	G	C	1	1	2	0	0	2	0	0
2	23804300	.	T	C	3	6	9	0	1	10	0	0
2	23804309	.	G	A	4	5	9	0	0	9	0	0
2	23804516	.	G	A	0	7	7	0	5	12	0	0
2	23804585	.	C	T	2	4	6	0	0	6	0	0
2	23809489	.	G	A	4	3	7	0	1	8	0	0
2	23809490	.	A	G	5	3	8	0	0	8	0	0
2	23811573	.	T	C	2	4	6	0	0	6	0	0
2	23816293	.	A	C	11	3	14	0	0	14	0	0
2	23816979	.	G	A	2	2	4	0	0	4	0	0
2	23816996	.	T	C	1	1	2	0	0	2	0	0
2	23817097	.	A	T	2	2	4	0	0	4	0	0
2	23817592	.	G	A	4	2	6	1	0	7	0	0
2	23818145	.	T	C	2	2	4	0	0	4	0	0
2	23818207	.	C	A	4	2	6	0	1	7	0	0
2	23818209	.	A	T	4	3	7	0	0	7	0	0
2	23818271	.	G	A	0	2	2	0	4	6	0	0
2	23818765	.	A	G	1	2	3	1	0	4	0	0
2	23819237	.	T	G	3	2	5	0	0	5	0	0
2	23819241	.	G	C	3	2	5	0	0	5	0	0
2	23819471	.	T	G	3	0	3	0	2	5	0	0
2	23819640	.	T	A	4	2	6	0	0	6	0	0
2	23819862	.	A	C	3	5	8	0	0	8	0	0
2	23820027	.	T	G	3	2	5	0	0	5	0	0
2	23823684	.	A	T	1	5	6	0	0	6	0	0
2	23937227	.	G	A	5	2	7	0	0	7	0	0
2	23937231	.	C	G	5	1	6	0	1	7	0	0
2	23937908	.	C	T	4	2	6	0	0	6	0	0
2	23943462	.	G	A	1	2	3	0	0	3	0	0
2	23943510	.	G	A	2	4	6	0	0	6	0	0
2	23943966	.	T	C	1	0	1	0	5	6	0	0
2	23946416	.	G	T	1	5	6	0	0	6	0	0
2	23949026	.	A	C	1	4	5	0	0	5	0	0
2	24188637	.	G	A	9	7	16	0	2	18	0	0
2	24199338	.	C	A	23	27	50	0	1	51	0	0
2	24202528	.	T	C	9	5	14	0	0	14	0	0
2	24218922	.	A	T	26	31	57	0	0	57	0	0
2	24218927	.	G	A	3	23	26	0	30	56	0	0
2	24222069	.	A	C	22	36	58	0	6	64	0	0
2	24223991	.	A	G	20	33	53	0	12	65	0	0
2	24238635	.	A	T	18	26	44	0	1	45	0	0
2	24248498	.	C	T	30	26	56	0	4	60	0	0
2	24249037	.	T	A	24	23	47	1	1	49	0	0
2	24249083	.	T	A	18	16	34	0	2	36	0	0
2	24249397	.	G	T	0	29	29	0	26	55	0	0
2	24249943	.	T	A	25	16	41	0	0	41	0	0
2	24249947	.	T	A	26	13	39	0	1	40	0	0
2	24250097	.	T	C	24	24	48	0	2	50	0	0
2	24250112	.	T	A	30	13	43	0	1	44	0	0
2	24250147	.	G	A	1	21	22	0	26	48	0	0
2	24250419	.	C	T	22	13	35	0	3	43	5	0
2	24250482	.	C	T	20	21	41	0	1	42	0	0
2	24250577	.	A	T	25	30	55	0	3	58	0	0
2	24250637	.	A	G	28	28	56	0	0	56	0	0
2	24250879	.	T	G	30	28	58	0	2	60	0	0
2	24250972	.	C	A	29	28	57	0	2	59	0	0
2	24251294	.	G	A	2	28	30	0	29	59	0	0
2	24251430	.	A	G	23	29	52	1	5	59	1	0
2	24251690	.	G	A	24	30	54	0	4	58	0	0
2	24251800	.	G	A	32	28	60	0	5	65	0	0
2	24251909	.	A	T	25	34	59	0	2	61	0	0
2	24252078	.	A	T	45	21	66	0	1	67	0	0
2	24252088	.	C	T	46	19	65	0	1	66	0	0
2	24252192	.	T	A	23	33	56	0	1	57	0	0
2	24252196	.	G	T	8	31	39	0	20	59	0	0
2	24310850	.	G	C	14	15	29	0	0	29	0	0
2	24310897	.	G	A	15	21	36	0	2	38	0	0
2	24311045	.	T	C	14	1	15	0	24	39	0	0
2	24311151	.	G	A	10	5	15	0	0	15	0	0
2	24311218	.	T	A	13	11	24	0	1	26	1	0
2	24311296	.	G	C	14	15	29	0	2	31	0	0
2	24311703	.	A	G	23	15	38	0	3	41	0	0
2	24311879	.	A	G	21	27	48	0	1	49	0	0
2	24313884	.	T	C	8	10	18	0	0	18	0	0
2	24313896	.	G	A	11	7	18	0	1	19	0	0
2	24314221	.	T	C	8	3	11	0	2	13	0	0
2	24316503	.	C	T	1	9	10	0	14	24	0	0
2	24317537	.	G	A	10	11	21	0	0	21	0	0
2	24319740	.	A	G	13	10	23	0	0	23	0	0
2	24320173	.	C	T	11	12	23	0	1	24	0	0
2	24321853	.	T	C	4	2	6	0	8	14	0	0
2	24322189	.	G	C	14	15	29	0	0	29	0	0
2	24326455	.	A	G	12	9	21	0	0	21	0	0
2	24326509	.	G	A	9	10	19	0	0	19	0	0
2	24331392	.	T	A	8	5	13	0	2	15	0	0
2	24335246	.	G	A	5	2	7	0	1	8	0	0
2	24376282	.	T	A	3	2	5	0	0	5	0	0
2	24376502	.	T	C	4	7	11	0	0	11	0	0
2	24376514	.	C	T	2	5	7	0	0	7	0	0
2	24382093	.	A	G	1	7	8	0	1	9	0	0
2	24385210	.	C	T	4	3	7	0	0	7	0	0
2	24385271	.	T	G	4	4	8	0	0	8	0	0
2	24385603	.	G	A	0	8	8	0	5	13	0	0
2	24385633	.	C	T	4	8	12	0	0	12	0	0
2	24385685	.	T	C	8	3	11	1	0	12	0	0
2	24385724	.	G	A	1	3	4	0	0	4	0	0
2	24386286	.	A	T	2	3	5	0	0	5	0	0
2	24410544	.	T	C	5	0	5	0	3	8	0	0
2	24410851	.	C	T	15	16	31	0	3	34	0	0
2	24410882	.	G	A	15	22	37	0	1	38	0	0
2	24411114	.	G	C	19	11	30	0	0	30	0	0
2	24411536	.	T	C	19	0	19	0	12	31	0	0
2	24411625	.	T	C	12	13	25	0	1	26	0	0
2	24411812	.	A	T	17	17	34	0	1	35	0	0
2	24411840	.	T	C	14	14	28	0	0	28	0	0
2	24412856	.	A	G	11	8	19	0	1	20	0	0
2	24412908	.	C	A	8	3	11	0	1	12	0	0
2	24412947	.	A	T	5	7	12	0	2	14	0	0
2	24413155	.	C	T	16	11	27	0	1	28	0	0
2	24414032	.	G	C	12	12	24	0	0	24	0	0
2	24414062	.	G	A	13	15	28	0	0	28	0	0
2	24421813	.	T	C	6	0	6	0	8	14	0	0
2	24421816	.	G	A	7	7	14	0	0	14	0	0
2	24432634	.	G	T	13	9	22	0	1	23	0	0
2	24432661	.	C	T	13	8	21	0	2	23	0	0
2	24444650	.	C	T	9	9	18	0	0	18	0	0
2	24508107	.	C	T	38	25	63	0	3	66	0	0
2	24541478	.	G	A	0	2	2	0	1	3	0	0
2	24549532	.	G	A	5	3	8	1	0	9	0	0
2	24549586	.	A	T	4	2	6	0	0	6	0	0
2	24558443	.	C	T	5	4	9	0	0	9	0	0
2	24558465	.	C	T	6	3	9	0	0	9	0	0
2	24558512	.	A	T	2	3	5	2	0	7	0	0
2	24559243	.	T	G	3	2	5	0	1	6	0	0
2	24559652	.	T	A	4	4	8	0	0	8	0	0
2	24560323	.	T	A	4	9	13	0	0	13	0	0
2	24560359	.	G	A	5	7	12	0	0	12	0	0
2	24560455	.	T	C	3	2	5	0	1	6	0	0
2	24560881	.	C	T	7	8	15	0	0	15	0	0
2	24565123	.	A	G	6	4	10	0	0	10	0	0
2	24578284	.	C	T	1	3	4	0	8	12	0	0
2	24578308	.	C	T	2	10	12	0	3	15	0	0
2	24594632	.	A	T	6	3	9	0	5	14	0	0
2	24646317	.	T	C	7	3	10	0	1	11	0	0
2	24650815	.	T	C	4	6	10	0	0	10	0	0
2	24650878	.	A	T	6	5	11	0	1	12	0	0
2	24663602	.	C	G	6	1	7	0	3	10	0	0
2	24664583	.	G	A	4	3	7	0	1	8	0	0
2	24666656	.	T	G	2	3	5	0	0	5	0	0
2	24676875	.	T	C	9	5	14	0	0	14	0	0
2	24677139	.	A	G	7	10	17	0	0	17	0	0
2	24683093	.	A	G	15	6	21	0	7	28	0	0
2	24683311	.	G	A	19	16	35	0	0	35	0	0
2	24701102	.	A	G	3	4	7	0	0	7	0	0
2	24701330	.	G	A	10	4	14	0	1	15	0	0
2	24722816	.	C	G	3	0	3	0	8	11	0	0
2	24737776	.	C	T	4	4	8	0	2	10	0	0
2	24740354	.	T	C	4	7	11	0	1	12	0	0
2	24740439	.	C	T	6	4	10	0	3	13	0	0
2	24740468	.	T	A	5	7	12	0	0	12	0	0
2	24743787	.	G	A	0	5	5	0	5	10	0	0
2	24743855	.	G	A	5	3	8	0	0	8	0	0
2	24748308	.	G	T	0	4	4	0	2	6	0	0
2	24748570	.	C	T	2	3	5	0	1	6	0	0
2	24749403	.	G	A	5	6	11	0	0	11	0	0
2	24749467	.	G	A	4	3	7	0	0	7	0	0
2	24749582	.	T	C	5	14	19	0	2	21	0	0
2	24750971	.	T	A	2	3	5	0	0	5	0	0
2	24751165	.	T	C	4	2	6	0	0	6	0	0
2	24751401	.	G	A	7	3	10	0	0	10	0	0
2	24751526	.	G	A	4	7	11	0	0	11	0	0
2	24751711	.	C	A	6	4	10	0	1	11	0	0
2	24751735	.	C	G	3	4	7	0	0	7	0	0
2	24751948	.	C	T	7	14	21	0	0	21	0	0
2	24751991	.	A	G	13	7	20	0	0	20	0	0
2	24752048	.	C	T	5	4	9	0	1	10	0	0
2	24752181	.	T	A	5	13	18	0	0	18	0	0
2	24752193	.	C	T	8	15	23	0	0	23	0	0
2	24752293	.	C	T	6	7	13	0	0	13	0	0
2	24752385	.	C	T	10	13	23	0	1	24	0	0
2	24753062	.	T	C	5	6	11	0	0	11	0	0
2	24753917	.	C	T	4	4	8	0	0	8	0	0
2	24754043	.	G	T	8	8	16	0	0	16	0	0
2	24754044	.	T	A	8	7	15	0	1	16	0	0
2	24754783	.	C	T	10	16	26	0	1	27	0	0
2	24754796	.	A	C	17	15	32	0	0	32	0	0
2	24755018	.	T	C	16	8	24	0	0	24	0	0
2	24766941	.	G	A	9	6	15	0	0	15	0	0
2	24767291	.	C	T	9	5	14	0	0	14	0	0
2	24773726	.	G	A	0	2	2	0	4	6	0	0
2	24849222	.	T	C	3	2	5	0	0	5	0	0
2	24863697	.	G	T	2	3	5	0	0	5	0	0
2	24863918	.	T	G	3	2	5	0	0	5	0	0
2	24864536	.	A	T	2	5	7	0	0	7	0	0
2	24864570	.	A	T	3	2	5	0	0	5	0	0
2	24864886	.	C	T	1	3	4	0	1	5	0	0
2	24865187	.	C	A	6	3	9	0	0	9	0	0
2	24865360	.	T	C	11	6	17	0	1	18	0	0
2	24866568	.	C	T	4	6	10	0	1	11	0	0
2	24876864	.	T	A	10	12	22	0	3	25	0	0
2	24877010	.	A	G	10	13	23	0	2	25	0	0
2	24877227	.	C	T	11	6	17	0	1	18	0	0
2	24877534	.	G	A	4	3	7	0	0	7	0	0
2	24877879	.	T	C	4	8	12	0	0	12	0	0
2	24877900	.	T	A	7	8	15	0	0	15	0	0
2	24878211	.	C	T	12	11	23	0	2	25	0	0
2	24878332	.	A	G	8	5	13	0	1	14	0	0
2	24936775	.	C	T	1	3	4	0	0	4	0	0
2	24936807	.	G	A	5	3	8	0	0	8	0	0
2	24943482	.	G	T	8	9	17	0	0	17	0	0
2	24943536	.	C	T	5	8	13	0	0	13	0	0
2	24943660	.	T	C	7	7	14	0	0	14	0	0
2	24943689	.	C	T	10	7	17	0	1	18	0	0
2	24943717	.	C	T	10	11	21	0	3	24	0	0
2	24943891	.	A	T	11	15	26	0	2	28	0	0
2	24943916	.	T	C	14	12	26	0	0	26	0	0
2	24943971	.	A	T	10	10	20	0	4	24	0	0
2	24944317	.	A	G	7	7	14	0	0	14	0	0
2	24944415	.	C	T	7	12	19	0	0	19	0	0
2	24944644	.	A	G	10	5	15	0	1	16	0	0
2	24947129	.	G	T	5	11	16	0	1	17	0	0
2	24947642	.	C	T	2	12	14	0	0	14	0	0
2	24952406	.	C	A	6	6	12	0	0	12	0	0
2	24955877	.	C	T	1	2	3	0	0	3	0	0
2	24956681	.	G	A	3	4	7	0	0	7	0	0
2	24958873	.	T	C	1	5	6	0	0	6	0	0
2	24964335	.	A	G	6	2	8	0	1	9	0	0
2	24969647	.	C	T	2	3	5	0	0	5	0	0
2	24969756	.	G	A	3	4	7	0	0	7	0	0
2	24991149	.	G	A	16	11	27	0	1	28	0	0
2	24991153	.	T	C	14	12	26	0	2	28	0	0
2	24991476	.	G	A	21	9	30	0	0	30	0	0
2	24991639	.	G	A	18	11	29	0	0	29	0	0
2	24991825	.	G	A	20	14	34	0	1	36	1	0
2	24992185	.	T	C	18	7	25	1	1	27	0	0
2	24992242	.	C	T	1	14	15	0	16	31	0	0
2	24992368	.	T	C	17	15	32	0	1	33	0	0
2	24992464	.	C	T	11	20	31	0	2	33	0	0
2	24992536	.	C	G	16	15	31	0	0	31	0	0
2	24992584	.	G	A	12	13	25	0	0	25	0	0
2	24996241	.	C	T	8	13	21	0	1	22	0	0
2	24996402	.	G	C	13	16	29	2	0	31	0	0
2	25074746	.	G	A	1	5	6	0	2	8	0	0
2	25074873	.	C	T	4	3	7	0	1	8	0	0
2	25077344	.	G	T	2	3	5	0	1	6	0	0
2	25077569	.	T	C	5	3	8	0	0	8	0	0
2	25083763	.	C	A	4	2	6	0	0	6	0	0
2	25102571	.	C	T	15	9	24	0	2	26	0	0
2	25105482	.	G	A	5	5	10	0	0	10	0	0
2	25105681	.	G	T	9	4	13	0	0	13	0	0
2	25105683	.	C	T	10	4	14	0	0	14	0	0
2	25106020	.	T	C	2	8	10	0	0	10	0	0
2	25106310	.	A	T	5	8	13	0	0	13	0	0
2	25106402	.	C	A	8	6	14	0	1	15	0	0
2	25106772	.	T	A	9	3	12	0	0	12	0	0
2	25106795	.	G	A	7	4	11	0	1	12	0	0
2	25106874	.	A	C	7	5	12	0	0	12	0	0
2	25106952	.	C	T	8	5	13	1	2	16	0	0
2	25106984	.	A	T	3	4	7	1	0	8	0	0
2	25107571	.	G	T	6	2	8	0	0	8	0	0
2	25107617	.	G	T	6	6	12	0	0	12	0	0
2	25107673	.	T	G	15	7	22	0	0	22	0	0
2	25107717	.	C	G	11	17	28	0	0	28	0	0
2	25107891	.	G	T	14	16	30	0	0	30	0	0
2	25107942	.	C	A	19	8	27	0	0	28	1	0
2	25108377	.	T	A	11	6	17	0	0	17	0	0
2	25108633	.	C	T	0	6	6	0	3	9	0	0
2	25108865	.	T	C	15	5	20	0	0	20	0	0
2	25113163	.	A	G	9	9	18	0	1	19	0	0
2	25113448	.	A	G	7	9	16	1	4	21	0	0
2	25125073	.	G	A	1	2	3	0	0	3	0	0
2	25127042	.	G	T	7	5	12	0	1	13	0	0
2	25127132	.	C	A	5	4	9	0	1	10	0	0
2	25127261	.	G	T	0	4	4	0	3	7	0	0
2	25128328	.	G	A	2	3	5	0	0	5	0	0
2	25128581	.	T	C	6	6	12	0	0	12	0	0
2	25128595	.	A	T	6	7	13	0	0	13	0	0
2	25128668	.	C	T	9	4	13	0	0	13	0	0
2	25129116	.	A	T	6	6	12	0	1	13	0	0
2	25132350	.	C	T	0	1	1	0	2	3	0	0
2	25247634	.	A	G	7	5	12	0	1	13	0	0
2	25247755	.	T	A	1	7	8	0	0	8	0	0
2	25247769	.	A	C	2	5	7	0	1	8	0	0
2	25282463	.	T	G	2	0	2	0	2	4	0	0
2	25289919	.	G	T	2	5	7	0	0	7	0	0
2	25289933	.	G	A	0	4	4	0	2	6	0	0
2	25290553	.	A	G	2	0	2	0	3	5	0	0
2	25540691	.	T	A	5	4	9	0	0	9	0	0
2	25542867	.	A	T	5	3	8	0	0	8	0	0
2	25542890	.	C	A	6	1	7	0	4	11	0	0
2	25631446	.	T	A	3	2	5	0	0	5	0	0
2	25631745	.	C	A	1	2	3	0	0	3	0	0
2	25658376	.	G	T	9	4	13	0	0	13	0	0
2	25681674	.	A	G	3	5	8	0	0	8	0	0
2	25681707	.	C	A	4	2	6	0	0	6	0	0
2	25756576	.	T	C	1	5	6	0	0	6	0	0
2	25759446	.	C	A	3	2	5	0	0	5	0	0
2	25772113	.	G	A	7	8	15	0	0	15	0	0
2	25781601	.	G	A	9	7	16	0	0	16	0	0
2	25781640	.	C	T	8	4	12	0	0	12	0	0
2	25787553	.	G	C	6	6	12	0	1	13	0	0
2	25794226	.	A	G	15	8	23	0	1	24	0	0
2	25794241	.	C	A	16	7	23	0	0	23	0	0
2	25797439	.	C	T	7	5	12	0	0	12	0	0
2	25797472	.	C	T	7	6	13	0	1	14	0	0
2	25798611	.	A	G	8	4	12	0	0	12	0	0
2	25798647	.	A	G	9	8	17	0	1	18	0	0
2	25809736	.	C	T	5	6	11	0	2	13	0	0
2	25814694	.	C	T	6	9	15	0	0	15	0	0
2	25815329	.	G	C	6	10	16	0	3	19	0	0
2	25815407	.	A	T	0	10	10	0	4	14	0	0
2	25815412	.	C	G	4	0	4	0	12	16	0	0
2	25815452	.	G	A	7	7	14	0	2	16	0	0
2	25815780	.	T	G	7	4	11	0	0	11	0	0
2	25816321	.	C	T	7	10	17	0	1	18	0	0
2	25816383	.	T	C	2	2	4	0	0	4	0	0
2	25843922	.	G	A	0	15	15	0	8	23	0	0
2	25844840	.	C	T	14	20	34	0	0	34	0	0
2	25844986	.	T	A	16	11	27	0	0	27	0	0
2	25947354	.	T	A	3	10	13	0	1	14	0	0
2	25947585	.	T	C	4	4	8	0	0	8	0	0
2	25947651	.	C	T	5	3	8	0	0	8	0	0
2	25947678	.	T	C	3	5	8	0	0	8	0	0
2	25947699	.	T	C	3	3	6	0	0	6	0	0
2	25952800	.	C	T	9	7	16	0	0	16	0	0
2	25952845	.	C	T	6	3	9	0	1	10	0	0
2	25952983	.	C	T	9	8	17	0	0	17	0	0
2	25984970	.	C	T	12	4	16	0	0	16	0	0
2	25985159	.	G	A	0	9	9	0	10	19	0	0
2	25985234	.	G	A	12	7	19	0	0	19	0	0
2	25985405	.	C	T	13	11	24	0	0	24	0	0
2	25985409	.	C	T	14	12	26	0	1	27	0	0
2	25988269	.	A	G	10	16	26	0	0	26	0	0
2	25988378	.	C	A	11	13	24	0	0	24	0	0
2	25988414	.	G	A	1	15	16	0	6	22	0	0
2	25988475	.	C	T	9	6	15	0	0	15	0	0
2	25988551	.	A	T	15	7	22	3	3	28	0	0
2	25988846	.	A	G	10	0	10	0	16	26	0	0
2	25989059	.	G	A	2	4	6	0	10	16	0	0
2	25989610	.	C	T	19	14	33	0	4	37	0	0
2	25989827	.	C	T	3	6	9	0	0	9	0	0
2	25989884	.	T	A	2	9	11	0	0	11	0	0
2	25989905	.	C	A	4	9	13	0	0	13	0	0
2	25989994	.	A	G	20	8	28	0	0	29	1	0
2	25990323	.	G	A	17	10	27	2	0	29	0	0
2	25990337	.	A	G	21	11	32	2	2	36	0	0
2	25990522	.	A	C	12	11	23	3	1	27	0	0
2	25990563	.	A	G	14	8	22	2	0	24	0	0
2	25990702	.	G	A	19	20	39	0	1	40	0	0
2	25990777	.	T	G	6	4	10	2	0	12	0	0
2	25997881	.	C	G	3	4	7	0	0	7	0	0
2	26156686	.	C	T	1	2	3	0	0	3	0	0
2	26156710	.	G	T	2	3	5	0	0	5	0	0
2	26179183	.	G	A	5	7	12	0	0	12	0	0
2	26179223	.	C	T	4	6	10	0	0	10	0	0
2	26196805	.	C	T	2	3	5	0	0	5	0	0
2	26197159	.	G	C	5	3	8	0	0	8	0	0
2	26207944	.	T	C	14	11	25	0	1	26	0	0
2	26207977	.	G	A	0	7	7	0	19	26	0	0
2	26208369	.	A	G	15	9	24	0	1	25	0	0
2	26208416	.	G	A	14	8	22	0	2	24	0	0
2	26208425	.	G	A	16	7	23	0	1	24	0	0
2	26208480	.	A	C	9	4	13	0	1	15	1	0
2	26208520	.	A	G	11	5	16	0	1	17	0	0
2	26208589	.	A	G	11	12	23	0	1	24	0	0
2	26208621	.	T	C	8	13	21	0	2	23	0	0
2	26208668	.	T	G	11	0	11	0	13	24	0	0
2	26208815	.	G	T	13	8	21	0	0	21	0	0
2	26208832	.	C	G	12	0	12	0	10	22	0	0
2	26208904	.	T	C	13	16	29	1	1	31	0	0
2	26208987	.	G	A	2	6	8	0	16	24	0	0
2	26209030	.	G	A	11	5	16	0	2	18	0	0
2	26209058	.	C	T	14	4	18	0	0	18	0	0
2	26209266	.	A	C	2	6	8	0	1	9	0	0
2	26240771	.	A	T	13	24	37	0	6	43	0	0
2	26240930	.	A	T	28	21	49	0	0	50	1	0
2	26282688	.	C	T	26	29	55	0	1	56	0	0
2	26283723	.	A	G	19	16	35	0	1	36	0	0
2	26298558	.	A	C	4	3	7	0	0	7	0	0
2	26299673	.	A	T	1	4	5	0	0	5	0	0
2	26300085	.	A	G	4	2	6	0	0	6	0	0
2	26300091	.	G	A	0	2	2	0	3	5	0	0
2	26300341	.	A	G	2	3	5	0	0	5	0	0
2	26303831	.	C	T	4	6	10	0	0	10	0	0
2	26303845	.	A	C	6	6	12	0	0	12	0	0
2	26303905	.	C	A	7	4	11	0	3	14	0	0
2	26304008	.	C	A	8	5	13	0	0	13	0	0
2	26304066	.	T	C	11	5	16	0	0	16	0	0
2	26304173	.	G	A	4	3	7	0	0	7	0	0
2	26443146	.	G	T	17	17	34	0	3	37	0	0
2	26443517	.	T	C	6	5	11	0	0	11	0	0
2	26443859	.	A	G	6	9	15	0	0	15	0	0
2	26463193	.	A	C	5	0	5	0	4	9	0	0
2	26463199	.	C	A	3	5	8	0	1	9	0	0
2	26463309	.	C	T	8	5	13	0	0	13	0	0
2	26463534	.	C	A	5	6	11	0	0	11	0	0
2	26463598	.	T	C	7	0	7	0	6	13	0	0
2	26467131	.	T	G	10	4	14	0	0	14	0	0
2	26467150	.	G	A	11	3	14	0	0	14	0	0
2	26468683	.	A	G	10	12	22	0	0	22	0	0
2	26469030	.	C	T	0	4	4	0	7	11	0	0
2	26470087	.	A	G	2	6	8	0	0	8	0	0
2	26470208	.	G	A	17	18	35	0	2	37	0	0
2	26470237	.	G	T	17	13	30	0	0	30	0	0
2	26470267	.	G	A	19	8	27	0	0	27	0	0
2	26470537	.	C	T	23	18	41	0	1	42	0	0
2	26470636	.	C	T	3	16	19	0	27	46	0	0
2	26470666	.	A	G	19	25	44	0	1	45	0	0
2	26473106	.	T	C	18	24	42	0	1	43	0	0
2	26473361	.	C	T	21	24	45	0	0	45	0	0
2	26475272	.	G	A	16	23	39	0	1	40	0	0
2	26476109	.	G	A	4	3	7	0	0	7	0	0
2	26481029	.	C	T	8	4	12	0	1	13	0	0
2	26481430	.	G	A	1	3	4	0	8	12	0	0
2	26483946	.	G	T	9	3	12	0	1	13	0	0
2	26491457	.	G	C	7	10	17	1	0	18	0	0
2	26491667	.	G	A	15	13	28	0	2	30	0	0
2	26491676	.	A	T	15	13	28	0	0	28	0	0
2	26494366	.	C	T	11	10	21	0	0	21	0	0
2	26494507	.	G	A	9	8	17	0	1	18	0	0
2	26500899	.	G	A	27	40	67	0	3	70	0	0
2	26501832	.	A	G	2	4	6	0	0	6	0	0
2	26576914	.	T	C	0	2	2	0	1	3	0	0
2	26577378	.	A	G	8	4	12	0	0	12	0	0
2	26578935	.	A	G	1	2	3	0	0	3	0	0
2	26581675	.	G	C	6	5	11	0	0	11	0	0
2	26583609	.	G	A	3	6	9	0	0	9	0	0
2	26586373	.	A	G	2	5	7	0	0	7	0	0
2	26586393	.	T	C	4	3	7	0	0	7	0	0
2	26592331	.	T	C	2	0	2	0	2	4	0	0
2	26599614	.	A	G	1	3	4	0	0	4	0	0
2	26609518	.	C	A	1	3	4	0	0	4	0	0
2	26612624	.	G	C	7	5	12	0	0	12	0	0
2	26612676	.	A	T	17	11	28	0	0	28	0	0
2	26613106	.	G	A	27	26	53	0	3	56	0	0
2	26619786	.	C	T	18	16	34	1	1	36	0	0
2	26620441	.	C	T	19	23	42	0	1	43	0	0
2	26623587	.	C	T	17	15	32	0	0	32	0	0
2	26623832	.	T	C	26	28	54	0	2	56	0	0
2	26627301	.	C	A	26	18	44	0	2	46	0	0
2	26627332	.	T	A	19	21	40	0	1	41	0	0
2	26630855	.	A	G	20	12	32	0	0	32	0	0
2	26652852	.	C	T	3	3	6	0	1	7	0	0
2	26656349	.	G	A	1	15	16	0	7	23	0	0
2	26662047	.	G	C	6	7	13	0	0	13	0	0
2	26665081	.	A	G	6	7	13	0	1	14	0	0
2	26665155	.	A	T	11	7	18	0	1	19	0	0
2	26665233	.	G	A	9	6	15	0	0	15	0	0
2	26665375	.	A	G	8	7	15	0	0	15	0	0
2	26672488	.	A	G	9	7	16	3	3	22	0	0
2	26672761	.	T	G	4	0	4	0	7	11	0	0
2	26672800	.	G	A	2	3	5	0	0	5	0	0
2	26676807	.	T	A	3	4	7	0	0	7	0	0
2	26677017	.	C	A	11	4	15	0	0	15	0	0
2	26677109	.	T	A	6	8	14	0	1	15	0	0
2	26677125	.	C	G	8	11	19	0	0	19	0	0
2	26677172	.	G	A	11	6	17	0	0	17	0	0
2	26677283	.	C	G	10	8	18	0	0	18	0	0
2	26677346	.	T	G	7	4	11	0	0	11	0	0
2	26677512	.	A	T	9	9	18	0	1	19	0	0
2	26677513	.	G	A	9	9	18	0	1	19	0	0
2	26677723	.	G	A	8	5	13	0	0	13	0	0
2	26680759	.	T	A	6	5	11	0	0	11	0	0
2	26680762	.	C	T	7	5	12	0	0	12	0	0
2	26680801	.	A	T	4	5	9	0	0	9	0	0
2	26681064	.	A	T	7	11	18	0	1	19	0	0
2	26681219	.	T	A	3	5	8	0	1	9	0	0
2	26681773	.	C	T	4	2	6	0	0	6	0	0
2	26682031	.	G	T	0	8	8	0	8	16	0	0
2	26684689	.	A	G	9	16	25	0	0	25	0	0
2	26686752	.	T	C	5	3	8	0	1	9	0	0
2	26688827	.	A	T	2	2	4	0	0	4	0	0
2	26697929	.	A	G	1	3	4	0	0	4	0	0
2	26704075	.	A	G	3	2	5	0	1	6	0	0
2	26714144	.	A	G	2	7	9	0	0	9	0	0
2	27000575	.	G	T	5	4	9	0	0	9	0	0
2	27045168	.	G	T	1	8	9	0	0	9	0	0
2	27048999	.	C	A	2	3	5	1	0	6	0	0
2	27049123	.	C	A	5	4	9	0	0	9	0	0
2	27064687	.	T	C	8	8	16	0	0	16	0	0
2	27075702	.	G	A	4	4	8	0	0	8	0	0
2	27075980	.	G	A	0	7	7	0	9	16	0	0
2	27075992	.	A	T	7	7	14	0	2	16	0	0
2	27094393	.	C	T	11	6	17	0	0	17	0	0
2	27330546	.	A	C	1	2	3	0	0	3	0	0
2	27330716	.	A	C	1	3	4	0	1	5	0	0
2	27330731	.	T	G	3	2	5	0	0	5	0	0
2	27341572	.	C	A	1	4	5	0	0	5	0	0
2	27378439	.	A	G	2	0	2	0	4	6	0	0
2	27380366	.	C	A	0	5	5	0	7	12	0	0
2	27382232	.	C	G	6	6	12	0	0	12	0	0
2	27382489	.	G	A	0	2	2	0	1	3	0	0
2	27382516	.	A	G	3	4	7	0	0	7	0	0
2	27384708	.	C	T	6	3	9	0	0	9	0	0
2	27384765	.	G	C	3	1	4	0	3	7	0	0
2	27385862	.	A	G	4	6	10	0	0	10	0	0
2	27385863	.	T	C	4	6	10	0	0	10	0	0
2	27527570	.	T	C	5	7	12	0	1	13	0	0
2	27532523	.	A	G	6	5	11	0	0	11	0	0
2	27538271	.	G	A	1	4	5	0	6	11	0	0
2	27538619	.	G	A	3	5	8	0	0	8	0	0
2	27540458	.	C	T	12	15	27	0	0	27	0	0
2	27541512	.	A	G	5	3	8	0	0	8	0	0
2	27541740	.	C	T	11	7	18	0	0	18	0	0
2	27541743	.	A	G	11	8	19	0	0	19	0	0
2	27541778	.	G	T	5	9	14	0	0	14	0	0
2	27542058	.	A	G	6	0	6	0	9	15	0	0
2	27542721	.	C	T	14	7	21	0	1	22	0	0
2	27542856	.	G	A	2	9	11	0	9	20	0	0
2	27543103	.	A	T	10	9	19	0	0	20	1	0
2	27543212	.	T	A	13	19	32	0	1	34	1	0
2	27543478	.	G	A	0	2	2	0	8	10	0	0
2	27562799	.	G	A	2	2	4	0	0	4	0	0
2	27571799	.	G	A	1	2	3	0	0	3	0	0
2	27578298	.	C	T	1	2	3	0	0	3	0	0
2	27635935	.	C	T	2	5	7	0	0	7	0	0
2	27636010	.	G	C	4	5	9	0	0	9	0	0
2	27642776	.	C	G	2	3	5	0	0	5	0	0
2	27646157	.	A	C	3	6	9	0	1	10	0	0
2	27652015	.	T	C	5	2	7	0	0	7	0	0
2	27658522	.	G	A	5	3	8	0	1	9	0	0
2	27658566	.	A	G	6	4	10	0	0	10	0	0
2	27658579	.	C	T	5	7	12	0	0	12	0	0
2	27658639	.	G	A	0	5	5	0	5	10	0	0
2	27658973	.	T	G	4	7	11	0	0	11	0	0
2	27659018	.	T	C	5	4	9	0	0	9	0	0
2	27662374	.	C	T	6	6	12	0	1	13	0	0
2	27663435	.	C	T	7	3	10	0	0	10	0	0
2	27663535	.	A	G	1	0	1	1	4	6	0	0
2	27663543	.	A	G	4	0	4	1	2	7	0	0
2	27663785	.	C	A	5	6	11	0	0	11	0	0
2	27664202	.	T	C	4	4	8	0	1	9	0	0
2	27664215	.	A	C	4	5	9	0	0	9	0	0
2	27664317	.	G	T	4	2	6	0	0	6	0	0
2	27670764	.	T	C	11	3	14	0	0	14	0	0
2	27670836	.	C	T	1	16	17	0	14	31	0	0
2	27670884	.	T	G	14	11	25	0	1	26	0	0
2	27671172	.	C	T	9	13	22	0	0	22	0	0
2	27671290	.	G	T	15	10	25	0	1	26	0	0
2	27671334	.	T	C	12	8	20	0	1	21	0	0
2	27671485	.	A	T	8	5	13	0	1	14	0	0
2	27671486	.	G	A	8	6	14	0	0	14	0	0
2	27671623	.	A	T	15	10	25	0	0	25	0	0
2	27671650	.	C	A	2	9	11	0	13	24	0	0
2	27671681	.	G	T	19	10	29	0	0	29	0	0
2	27671704	.	C	T	15	10	25	0	1	26	0	0
2	27671724	.	G	A	16	8	24	0	1	25	0	0
2	27672215	.	G	T	13	12	25	0	0	25	0	0
2	27672426	.	T	C	5	7	12	0	1	13	0	0
2	27672440	.	C	T	2	7	9	0	6	15	0	0
2	27672535	.	C	T	6	11	17	0	1	18	0	0
2	27672636	.	C	T	14	5	19	0	3	22	0	0
2	27673041	.	A	G	14	6	20	0	1	21	0	0
2	27673080	.	G	A	11	7	18	0	2	20	0	0
2	27673148	.	G	A	11	12	23	0	0	23	0	0
2	27673173	.	A	G	12	11	23	0	1	24	0	0
2	27774370	.	G	A	10	11	21	0	4	25	0	0
2	27812578	.	G	A	9	7	16	0	1	17	0	0
2	27843845	.	G	A	3	4	7	0	0	7	0	0
2	27843937	.	A	G	4	8	12	0	1	13	0	0
2	27845694	.	G	A	2	5	7	0	0	7	0	0
2	27846071	.	G	A	7	4	11	0	1	12	0	0
2	27851716	.	C	T	0	2	2	0	3	5	0	0
2	27851928	.	A	T	5	5	10	0	0	10	0	0
2	27853876	.	A	T	1	5	6	0	0	6	0	0
2	27933143	.	C	T	4	3	7	0	0	7	0	0
2	27933215	.	C	A	6	4	10	0	0	10	0	0
2	27933260	.	C	A	2	3	5	0	2	7	0	0
2	27933764	.	G	T	2	2	4	0	0	4	0	0
2	27957786	.	T	A	1	2	3	0	0	3	0	0
2	27957939	.	G	A	3	3	6	1	0	7	0	0
2	27963660	.	G	A	6	4	10	0	1	11	0	0
2	27963686	.	C	T	0	6	6	0	6	12	0	0
2	27966368	.	C	T	0	4	4	0	7	11	0	0
2	27966376	.	G	C	6	5	11	0	0	11	0	0
2	27969534	.	T	C	3	4	7	0	0	7	0	0
2	27975129	.	A	T	1	4	5	1	0	6	0	0
2	27975458	.	T	C	2	2	4	0	0	4	0	0
2	27975486	.	T	A	1	2	3	0	0	3	0	0
2	28049696	.	C	T	13	5	18	0	1	19	0	0
2	28049996	.	A	G	12	9	21	0	1	22	0	0
2	28050058	.	C	A	7	5	12	0	0	13	1	0
2	28050243	.	T	C	11	0	11	0	10	21	0	0
2	28050565	.	T	A	10	9	19	0	0	19	0	0
2	28050600	.	G	C	6	1	7	0	7	14	0	0
2	28050759	.	A	G	5	7	12	0	0	12	0	0
2	28050921	.	G	T	8	8	16	0	0	16	0	0
2	28050933	.	G	A	8	7	15	0	1	16	0	0
2	28051041	.	T	A	3	11	14	0	1	16	1	0
2	28051092	.	C	T	1	7	8	0	11	20	1	0
2	28051104	.	G	A	12	6	18	0	1	19	0	0
2	28057518	.	G	A	13	15	28	0	2	30	0	0
2	28077152	.	C	A	0	5	5	0	4	9	0	0
2	28503260	.	G	A	2	1	3	0	1	4	0	0
2	28503323	.	T	A	2	3	5	0	0	5	0	0
2	28521207	.	C	G	3	3	6	0	0	6	0	0
2	28650521	.	G	A	8	1	9	0	1	11	1	0
2	28650612	.	T	G	3	8	11	0	1	12	0	0
2	28650629	.	G	T	4	12	16	0	0	16	0	0
2	28651077	.	C	G	0	7	7	0	13	20	0	0
2	28653557	.	G	A	5	5	10	0	0	10	0	0
2	28653587	.	A	G	2	8	10	0	0	10	0	0
2	28653707	.	C	G	1	2	3	0	0	3	0	0
2	28657867	.	G	A	3	3	6	0	0	6	0	0
2	28657927	.	G	T	1	2	3	0	0	3	0	0
2	28659726	.	A	C	1	2	3	0	0	3	0	0
2	28659998	.	C	G	4	5	9	0	1	10	0	0
2	28671081	.	G	A	6	3	9	0	0	9	0	0
2	28671093	.	C	A	6	2	8	0	0	8	0	0
2	28902738	.	C	T	3	2	5	0	0	5	0	0
2	28910813	.	C	G	3	6	9	0	0	9	0	0
2	28929177	.	G	A	1	5	6	0	4	10	0	0
2	28930100	.	T	C	6	5	11	0	1	12	0	0
2	28933846	.	T	G	3	6	9	0	1	10	0	0
2	28934011	.	C	T	5	9	14	0	0	14	0	0
2	28934152	.	T	C	5	6	11	0	0	11	0	0
2	29012930	.	A	T	2	2	4	0	0	4	0	0
2	29289068	.	G	T	5	6	11	0	0	11	0	0
2	29317718	.	G	A	5	8	13	0	0	13	0	0
2	29352279	.	G	A	1	9	10	0	11	21	0	0
2	29352379	.	A	C	6	8	14	0	3	17	0	0
2	29352411	.	A	C	8	5	13	0	0	13	0	0
2	29352579	.	T	C	7	8	15	0	1	16	0	0
2	29352673	.	C	T	5	10	15	0	1	16	0	0
2	29477653	.	T	C	20	9	29	0	0	29	0	0
2	29477733	.	A	T	15	15	30	0	0	31	1	0
2	29477769	.	G	T	22	10	32	0	2	34	0	0
2	29482390	.	G	A	21	12	33	0	0	33	0	0
2	29482417	.	A	G	16	13	29	0	0	29	0	0
2	29485046	.	G	A	10	17	27	0	2	29	0	0
2	29485068	.	G	T	16	8	24	0	0	24	0	0
2	29491445	.	C	T	4	4	8	0	0	8	0	0
2	30459984	.	T	A	22	3	25	0	2	27	0	0
2	30459985	.	A	C	24	3	27	0	0	27	0	0
2	30568944	.	A	T	14	14	28	0	1	29	0	0
2	30568959	.	C	T	13	17	30	0	0	30	0	0
2	30574092	.	C	T	0	3	3	1	19	24	1	0
2	30586847	.	G	C	7	6	13	0	0	13	0	0
2	30611283	.	G	T	9	9	18	0	1	19	0	0
2	30613764	.	G	A	12	17	29	0	1	30	0	0
2	30614153	.	C	A	10	13	23	0	1	24	0	0
2	30614370	.	T	G	4	9	13	0	0	13	0	0
2	30618155	.	C	T	10	4	14	1	3	18	0	0
2	30618205	.	T	C	4	0	4	0	6	10	0	0
2	30668467	.	C	G	10	5	15	0	0	15	0	0
2	30693612	.	A	G	0	6	6	0	3	9	0	0
2	30693635	.	G	A	3	6	9	0	0	9	0	0
2	30741192	.	C	T	16	12	28	0	1	29	0	0
2	30743041	.	T	C	18	11	29	0	5	34	0	0
2	30743864	.	A	G	14	10	24	0	2	26	0	0
2	30743907	.	T	C	16	11	27	0	2	29	0	0
2	30743951	.	C	A	20	15	35	0	0	35	0	0
2	30752675	.	C	T	3	3	6	0	0	6	0	0
2	30752796	.	G	A	1	2	3	0	0	3	0	0
2	30753072	.	A	T	9	13	22	0	1	23	0	0
2	30753273	.	G	A	7	10	17	0	2	19	0	0
2	30753888	.	A	G	9	8	17	0	0	17	0	0
2	30753899	.	C	T	8	10	18	0	0	18	0	0
2	30753928	.	G	A	7	6	13	0	0	13	0	0
2	30753991	.	A	G	7	4	11	0	0	11	0	0
2	30754030	.	A	T	9	10	19	0	0	19	0	0
2	30754113	.	T	C	6	16	22	0	1	23	0	0
2	30754196	.	G	A	17	16	33	0	1	34	0	0
2	30754300	.	C	T	11	22	33	0	1	34	0	0
2	30754306	.	G	A	21	10	31	0	1	32	0	0
2	30754346	.	A	G	12	13	25	0	0	25	0	0
2	30754432	.	G	T	19	11	30	0	0	30	0	0
2	30754733	.	A	G	8	8	16	0	0	16	0	0
2	30754741	.	A	G	8	9	17	0	0	17	0	0
2	30754777	.	A	T	11	8	19	0	0	19	0	0
2	30754793	.	A	T	10	9	19	0	0	19	0	0
2	30754932	.	A	G	12	3	15	0	0	15	0	0
2	30754940	.	T	A	11	3	14	0	0	14	0	0
2	30755195	.	G	A	6	5	11	1	1	13	0	0
2	30755359	.	A	T	12	6	18	2	0	20	0	0
2	30755522	.	G	T	3	5	8	0	0	8	0	0
2	31360724	.	G	A	1	4	5	1	1	7	0	0
2	31430726	.	T	C	1	3	4	0	0	4	0	0
2	31451661	.	A	G	20	5	25	0	1	26	0	0
2	31827396	.	G	A	6	7	13	1	1	15	0	0
2	31827397	.	A	G	8	6	14	1	0	15	0	0
2	31851997	.	A	G	9	4	13	0	0	13	0	0
2	31891344	.	T	A	3	21	24	0	1	28	3	0
2	32386318	.	T	C	3	2	5	0	0	5	0	0
2	32392166	.	A	G	1	3	4	0	0	4	0	0
2	32392724	.	A	G	1	2	3	0	0	3	0	0
2	32392787	.	C	A	1	2	3	0	3	6	0	0
2	32392876	.	A	T	1	3	4	0	0	4	0	0
2	32393062	.	A	T	4	2	6	0	0	6	0	0
2	32393064	.	G	T	4	2	6	0	0	6	0	0
2	32393190	.	T	C	1	2	3	0	0	3	0	0
2	32393259	.	A	G	3	2	5	0	0	5	0	0
2	32393281	.	T	A	3	2	5	0	0	5	0	0
2	32393460	.	C	T	0	4	4	0	8	12	0	0
2	32393579	.	T	C	2	3	5	0	1	6	0	0
2	32393616	.	A	G	4	2	6	0	0	6	0	0
2	32393617	.	T	G	4	2	6	0	0	6	0	0
2	32393670	.	A	G	2	5	7	0	0	7	0	0
2	32393731	.	G	A	1	2	3	0	0	3	0	0
2	32393767	.	C	T	1	2	3	0	0	3	0	0
2	32393769	.	A	G	0	2	2	0	1	3	0	0
2	32393834	.	C	T	0	5	5	0	5	10	0	0
2	32393918	.	A	T	3	4	7	0	0	7	0	0
2	32393930	.	T	C	4	3	7	0	0	7	0	0
2	32394067	.	G	C	1	4	5	0	0	5	0	0
2	32441514	.	A	G	1	1	2	0	1	3	0	0
2	32475941	.	A	T	4	2	6	0	1	7	0	0
2	32477432	.	T	C	14	13	27	0	3	30	0	0
2	32483020	.	C	G	5	10	15	0	1	16	0	0
2	32485832	.	A	G	8	13	21	0	1	22	0	0
2	32485895	.	C	T	1	7	8	0	9	17	0	0
2	32485962	.	G	A	6	12	18	0	2	20	0	0
2	32485999	.	A	G	12	10	22	0	1	23	0	0
2	32494486	.	G	A	17	16	33	0	1	34	0	0
2	32494705	.	C	T	1	13	14	0	10	24	0	0
2	32494720	.	G	A	10	7	17	0	1	18	0	0
2	32497715	.	G	A	3	4	7	0	1	8	0	0
2	32498078	.	C	T	0	2	2	0	6	8	0	0
2	32498117	.	A	G	5	3	8	0	0	8	0	0
2	32505664	.	G	A	11	12	23	0	1	24	0	0
2	32507094	.	C	T	9	12	21	0	1	22	0	0
2	32507218	.	G	A	9	12	21	0	1	22	0	0
2	32508418	.	C	A	6	16	22	0	0	22	0	0
2	32509238	.	T	G	15	7	22	0	3	25	0	0
2	32509247	.	G	A	10	16	26	0	1	27	0	0
2	32509309	.	G	T	19	10	29	0	0	29	0	0
2	32509573	.	G	A	6	13	19	0	0	19	0	0
2	32509636	.	C	T	13	8	21	0	1	22	0	0
2	32515861	.	C	T	0	6	6	0	8	14	0	0
2	32516110	.	T	C	1	11	12	0	2	14	0	0
2	32516359	.	A	T	12	7	19	0	0	19	0	0
2	32516469	.	T	C	13	0	13	0	12	25	0	0
2	32519690	.	G	A	7	9	16	0	0	16	0	0
2	32531232	.	C	T	7	9	16	0	3	19	0	0
2	32543014	.	T	A	3	4	7	0	0	7	0	0
2	32543092	.	T	A	4	6	10	0	1	11	0	0
2	32558621	.	G	A	9	9	18	0	0	18	0	0
2	32561752	.	A	G	3	6	9	0	0	9	0	0
2	32561754	.	G	A	3	5	8	0	1	9	0	0
2	32562059	.	G	A	9	5	14	0	0	14	0	0
2	32569639	.	G	A	13	8	21	0	1	22	0	0
2	32569717	.	A	G	7	6	13	0	0	13	0	0
2	32569745	.	A	G	6	8	14	0	0	14	0	0
2	32569909	.	T	C	6	0	6	0	10	16	0	0
2	32569930	.	G	A	6	8	14	0	1	15	0	0
2	32577939	.	G	A	4	5	9	0	1	10	0	0
2	32578124	.	A	T	11	7	18	0	1	19	0	0
2	32578230	.	C	T	15	9	24	0	2	26	0	0
2	32578330	.	A	G	10	6	16	0	0	16	0	0
2	32578456	.	G	A	6	2	8	0	0	8	0	0
2	32578519	.	C	T	1	4	5	0	0	5	0	0
2	32578580	.	C	A	10	12	22	0	1	23	0	0
2	32578677	.	C	A	14	5	19	0	1	20	0	0
2	32579170	.	C	A	6	0	6	0	0	6	0	0
2	32583144	.	A	G	11	8	19	0	1	20	0	0
2	32583162	.	T	A	8	13	21	0	0	21	0	0
2	32583209	.	C	T	4	12	16	0	1	17	0	0
2	32583345	.	C	T	9	7	16	0	0	16	0	0
2	32583411	.	C	A	3	9	12	0	9	21	0	0
2	32583453	.	T	A	10	9	19	0	1	20	0	0
2	32583459	.	A	G	10	9	19	0	1	20	0	0
2	32583629	.	A	C	9	1	10	0	7	17	0	0
2	32583681	.	T	A	10	5	15	0	1	16	0	0
2	32583687	.	G	A	10	5	15	0	0	15	0	0
2	32588669	.	A	G	2	2	4	0	1	5	0	0
2	32591381	.	G	A	5	4	9	0	0	9	0	0
2	32591488	.	C	A	3	2	5	0	0	6	1	0
2	32591697	.	G	T	4	8	12	0	0	12	0	0
2	32592075	.	G	T	8	3	11	0	0	11	0	0
2	32594523	.	T	G	2	2	4	0	3	7	0	0
2	32594614	.	G	A	5	3	8	0	0	8	0	0
2	32594620	.	G	A	4	4	8	0	1	9	0	0
2	32594699	.	T	A	6	7	13	0	2	15	0	0
2	32594763	.	G	A	1	3	4	0	0	4	0	0
2	32636757	.	T	C	10	45	55	4	0	59	0	0
2	32637145	.	G	C	4	19	23	20	1	44	0	0
2	32643294	.	G	C	8	2	10	0	0	10	0	0
2	32643296	.	T	A	8	2	10	1	0	11	0	0
2	32665798	.	G	A	8	19	27	0	1	28	0	0
2	32666565	.	C	T	3	18	21	0	8	29	0	0
2	32667941	.	C	A	0	16	16	0	14	30	0	0
2	32676228	.	T	A	5	10	15	0	4	19	0	0
2	32676482	.	A	C	7	4	11	0	0	11	0	0
2	32679938	.	C	T	2	5	7	0	2	9	0	0
2	32680338	.	C	T	7	6	13	0	1	14	0	0
2	32680356	.	C	T	10	12	22	0	0	22	0	0
2	32682216	.	C	T	14	8	22	0	0	22	0	0
2	32686412	.	C	T	8	9	17	0	0	17	0	0
2	32686594	.	C	T	3	5	8	0	2	10	0	0
2	32749864	.	C	G	2	3	5	0	0	5	0	0
2	32749989	.	C	T	6	3	9	0	0	9	0	0
2	32750028	.	C	T	5	2	7	0	0	7	0	0
2	32751636	.	T	C	3	3	6	0	0	6	0	0
2	32752294	.	G	A	3	4	7	0	0	7	0	0
2	32752300	.	T	C	4	3	7	0	0	7	0	0
2	32752378	.	C	T	1	4	5	0	2	7	0	0
2	32752447	.	G	A	5	5	10	0	0	10	0	0
2	32756630	.	C	T	3	8	11	0	0	11	0	0
2	32756660	.	A	C	4	6	10	0	0	10	0	0
2	32814503	.	G	A	8	12	20	0	0	20	0	0
2	32814677	.	G	C	8	11	19	0	0	19	0	0
2	32814695	.	T	C	11	7	18	0	1	19	0	0
2	32817615	.	T	A	3	10	13	0	0	13	0	0
2	32817627	.	G	A	5	11	16	0	0	16	0	0
2	32817921	.	G	A	13	8	21	0	0	21	0	0
2	32820764	.	G	A	3	5	8	0	0	8	0	0
2	32821393	.	G	A	7	7	14	0	0	14	0	0
2	32821622	.	T	G	7	10	17	0	0	17	0	0
2	32823494	.	C	G	1	3	4	0	5	9	0	0
2	32824727	.	G	A	8	6	14	0	0	14	0	0
2	32824745	.	C	A	1	7	8	0	8	16	0	0
2	32824778	.	G	A	4	11	15	0	0	15	0	0
2	32824805	.	G	A	10	3	13	0	0	13	0	0
2	32824896	.	C	T	11	7	18	0	0	18	0	0
2	32825018	.	C	G	0	11	11	0	7	18	0	0
2	32825033	.	G	A	10	7	17	0	1	18	0	0
2	32825382	.	C	T	9	8	17	0	0	17	0	0
2	32825480	.	T	G	10	6	16	0	1	17	0	0
2	32827004	.	C	T	2	2	4	0	0	4	0	0
2	32827005	.	C	T	2	2	4	0	0	4	0	0
2	32828626	.	T	C	3	2	5	0	1	6	0	0
2	32828704	.	C	T	2	2	4	0	0	4	0	0
2	32828839	.	C	A	5	2	7	0	0	7	0	0
2	32829016	.	T	C	4	5	9	0	0	9	0	0
2	32831664	.	C	A	1	5	6	0	0	6	0	0
2	32833524	.	T	C	11	8	19	0	0	19	0	0
2	32849667	.	A	G	7	4	11	0	0	11	0	0
2	32850138	.	C	T	7	7	14	0	1	15	0	0
2	32850305	.	T	C	8	4	12	0	0	12	0	0
2	32850401	.	T	C	9	4	13	0	0	13	0	0
2	32850477	.	T	A	2	5	7	0	0	7	0	0
2	32850510	.	A	T	1	4	5	0	0	5	0	0
2	33410267	.	T	A	2	3	5	0	0	5	0	0
2	33415482	.	G	A	4	3	7	0	0	7	0	0
2	33416389	.	T	C	2	3	5	0	0	5	0	0
2	33416755	.	A	G	2	0	2	0	2	4	0	0
2	33416819	.	G	A	3	2	5	0	0	5	0	0
2	33417474	.	C	T	5	4	9	0	0	9	0	0
2	33417504	.	G	T	5	4	9	0	0	9	0	0
2	33417661	.	A	T	3	7	10	0	0	10	0	0
2	33418086	.	C	A	4	8	12	0	0	12	0	0
2	33418235	.	T	A	3	3	6	0	0	6	0	0
2	33418534	.	C	A	4	5	9	0	0	9	0	0
2	33418887	.	A	G	2	0	2	0	4	6	0	0
2	33419463	.	G	C	2	6	8	0	1	9	0	0
2	33419602	.	A	G	5	7	12	0	1	13	0	0
2	33419650	.	A	G	6	4	10	0	1	11	0	0
2	33419704	.	A	G	1	0	1	1	3	5	0	0
2	33420006	.	G	A	0	2	2	0	2	4	0	0
2	33420272	.	G	T	6	6	12	0	0	12	0	0
2	33420384	.	G	A	0	6	6	0	3	9	0	0
2	33420806	.	C	T	9	7	16	0	1	17	0	0
2	33420975	.	G	A	0	14	14	0	14	28	0	0
2	33421078	.	G	T	5	7	12	0	0	12	0	0
2	33421146	.	G	A	8	7	15	0	0	15	0	0
2	33421154	.	G	A	9	7	16	0	0	16	0	0
2	33421200	.	C	T	5	10	15	0	0	15	0	0
2	33421222	.	A	C	7	11	18	0	1	19	0	0
2	33421275	.	C	G	7	13	20	0	0	20	0	0
2	33421276	.	T	C	8	12	20	0	1	21	0	0
2	33421331	.	C	A	10	8	18	0	1	19	0	0
2	33421382	.	A	T	9	11	20	0	1	21	0	0
2	33421404	.	T	A	8	9	17	0	2	19	0	0
2	33421441	.	T	G	11	1	12	0	10	22	0	0
2	33421613	.	C	T	5	9	14	0	0	14	0	0
2	33421720	.	A	G	12	9	21	0	0	21	0	0
2	33421774	.	A	G	13	13	26	0	1	27	0	0
2	33422001	.	C	T	3	4	7	0	1	8	0	0
2	33422211	.	G	A	5	15	20	0	1	21	0	0
2	33422374	.	T	G	13	0	13	0	24	37	0	0
2	33422484	.	G	A	2	8	10	0	17	27	0	0
2	33422565	.	C	A	22	17	39	0	1	40	0	0
2	33422604	.	C	T	19	23	42	0	1	43	0	0
2	33457376	.	C	A	2	2	4	0	0	4	0	0
2	33457418	.	G	T	0	3	3	0	2	5	0	0
2	33477014	.	G	T	3	4	7	0	0	7	0	0
2	33477139	.	G	A	5	10	15	0	0	15	0	0
2	33492685	.	T	C	6	0	6	0	5	11	0	0
2	33522070	.	C	T	4	2	6	0	2	8	0	0
2	33522130	.	A	T	1	5	6	0	1	7	0	0
2	33676391	.	G	A	6	7	13	0	1	14	0	0
2	33681330	.	G	A	29	22	51	0	0	51	0	0
2	33681483	.	A	G	21	21	42	0	2	44	0	0
2	33681701	.	A	T	16	16	32	0	4	36	0	0
2	33682321	.	G	A	17	26	43	0	1	44	0	0
2	33682323	.	T	A	17	25	42	0	2	44	0	0
2	33685582	.	T	A	17	21	38	0	1	39	0	0
2	33687110	.	C	A	23	28	51	0	0	51	0	0
2	33950036	.	T	A	1	3	4	0	0	4	0	0
2	33950050	.	C	A	1	3	4	0	0	4	0	0
2	33969861	.	C	A	3	3	6	0	0	6	0	0
2	33970122	.	T	C	4	3	7	0	0	7	0	0
2	34022992	.	T	A	10	6	16	0	0	16	0	0
2	34024832	.	A	G	9	4	13	0	0	13	0	0
2	34025152	.	C	A	8	6	14	0	0	14	0	0
2	34025167	.	G	A	11	6	17	0	0	17	0	0
2	34029353	.	G	A	8	8	16	0	0	16	0	0
2	34047951	.	T	C	7	8	15	1	0	16	0	0
2	34065661	.	G	A	4	3	7	0	0	7	0	0
2	34071479	.	G	T	6	8	14	0	0	14	0	0
2	34071955	.	A	T	5	3	8	0	0	8	0	0
2	34112170	.	C	G	2	0	2	0	4	6	0	0
2	34113147	.	A	G	6	3	9	0	1	10	0	0
2	34113153	.	A	G	7	3	10	0	0	10	0	0
2	34113198	.	T	C	2	5	7	0	0	7	0	0
2	34115340	.	C	A	8	4	12	0	0	12	0	0
2	34122859	.	A	G	8	5	13	0	0	13	0	0
2	34122886	.	C	A	6	5	11	0	0	11	0	0
2	34122928	.	C	T	6	3	9	0	2	11	0	0
2	34125775	.	G	A	1	5	6	0	16	22	0	0
2	34125909	.	A	T	10	9	19	0	3	22	0	0
2	34126040	.	T	C	3	8	11	0	1	12	0	0
2	34126514	.	G	T	11	4	15	0	1	16	0	0
2	34126588	.	A	T	5	5	10	1	1	12	0	0
2	34138460	.	A	T	2	6	8	0	0	8	0	0
2	34160995	.	G	A	1	4	5	0	0	5	0	0
2	34166687	.	G	C	0	2	2	0	2	4	0	0
2	34166846	.	C	G	6	0	6	0	3	9	0	0
2	34172900	.	C	T	4	4	8	0	0	8	0	0
2	34172954	.	T	C	4	3	7	0	0	7	0	0
2	34173136	.	G	A	2	2	4	0	0	4	0	0
2	34173253	.	C	T	5	2	7	0	0	7	0	0
2	34173297	.	C	A	6	6	12	0	0	12	0	0
2	34173335	.	A	C	3	6	9	0	1	10	0	0
2	34173360	.	C	T	6	7	13	0	0	13	0	0
2	34381013	.	T	G	17	11	28	0	0	28	0	0
2	34381032	.	T	C	13	11	24	0	1	25	0	0
2	34444801	.	C	T	14	5	19	0	1	20	0	0
2	34460848	.	G	A	11	11	22	0	0	22	0	0
2	34555410	.	A	G	5	11	16	0	1	17	0	0
2	34924412	.	A	G	10	30	40	0	2	42	0	0
2	35610890	.	T	G	5	16	21	1	0	22	0	0
2	37826819	.	A	C	3	3	6	10	1	17	0	0
2	37896290	.	G	A	1	0	1	0	0	13	12	0
2	38214923	.	C	T	4	25	29	15	1	46	1	0
2	38214974	.	T	G	11	5	16	19	0	35	0	0
2	41578137	.	G	T	20	6	26	1	1	29	1	0
2	41581035	.	T	A	35	11	46	4	2	52	0	0
2	41581042	.	C	G	4	8	12	2	38	52	0	0
2	41946632	.	T	C	1	0	1	3	5	9	0	0
2	42420541	.	T	C	7	4	11	0	0	11	0	0
2	44192795	.	C	T	5	2	7	0	0	7	0	0
2	44943621	.	C	A	11	4	15	0	2	17	0	0
2	44963192	.	A	G	1	2	3	0	0	3	0	0
2	44965165	.	A	T	1	3	4	0	3	7	0	0
2	46117197	.	T	C	5	7	12	0	0	12	0	0
2	46140293	.	G	C	7	11	18	0	0	18	0	0
2	46140470	.	T	C	5	9	14	0	1	15	0	0
2	46140479	.	T	C	5	7	12	0	0	12	0	0
2	46140512	.	G	A	2	7	9	0	0	9	0	0
2	46140539	.	G	A	4	5	9	0	1	10	0	0
2	46172217	.	A	G	2	6	8	0	0	8	0	0
2	46172238	.	A	G	3	1	4	0	6	10	0	0
2	46175367	.	G	T	0	6	6	1	4	11	0	0
2	46175484	.	C	T	13	4	17	0	0	17	0	0
2	46176783	.	A	G	6	7	13	0	0	13	0	0
2	46176822	.	T	C	6	11	17	0	0	17	0	0
2	46181029	.	T	C	9	13	22	0	0	22	0	0
2	46183855	.	T	C	12	8	20	0	1	21	0	0
2	46183897	.	G	A	15	12	27	0	1	28	0	0
2	46183985	.	A	T	3	9	12	0	1	13	0	0
2	46184024	.	T	A	4	16	20	0	1	21	0	0
2	46184057	.	C	A	9	19	28	0	0	28	0	0
2	46184193	.	C	T	12	19	31	0	0	31	0	0
2	46184248	.	G	C	9	8	17	0	2	19	0	0
2	46184277	.	C	A	12	6	18	0	1	19	0	0
2	46184555	.	A	G	15	12	27	0	1	28	0	0
2	46471440	.	A	G	3	0	3	0	5	8	0	0
2	46590001	.	A	G	2	0	2	0	3	5	0	0
2	46590124	.	C	T	3	2	5	0	0	5	0	0
2	46694469	.	G	C	0	2	2	0	1	3	0	0
2	46697528	.	A	C	2	3	5	0	0	5	0	0
2	46697546	.	T	C	1	5	6	0	1	7	0	0
2	46715639	.	G	A	0	6	6	0	2	8	0	0
2	47472068	.	T	A	6	10	16	0	1	17	0	0
2	47493456	.	C	G	9	1	10	0	5	15	0	0
2	47500251	.	C	T	11	6	17	0	0	17	0	0
2	47506185	.	C	T	11	11	22	0	0	22	0	0
2	47506187	.	G	A	11	11	22	0	0	22	0	0
2	47511341	.	T	C	14	14	28	0	2	30	0	0
2	47512820	.	G	A	16	14	30	0	0	30	0	0
2	47513002	.	G	T	17	11	28	0	0	28	0	0
2	47513391	.	G	A	3	4	7	0	3	10	0	0
2	47513712	.	C	A	18	15	33	0	2	35	0	0
2	47513871	.	C	A	13	18	31	0	0	31	0	0
2	47514001	.	A	G	17	21	38	0	0	38	0	0
2	47514504	.	C	A	10	5	15	0	1	16	0	0
2	47514582	.	T	G	10	7	17	0	1	18	0	0
2	47514613	.	T	A	13	6	19	0	1	20	0	0
2	47514619	.	A	T	14	6	20	0	1	21	0	0
2	47514697	.	A	G	10	19	29	0	0	29	0	0
2	47514878	.	T	G	18	14	32	0	1	33	0	0
2	47515019	.	T	C	12	17	29	0	0	29	0	0
2	47515073	.	T	C	8	9	17	0	1	18	0	0
2	47515111	.	G	A	9	7	16	0	1	17	0	0
2	47515223	.	T	A	10	11	21	0	0	21	0	0
2	47582559	.	C	G	5	6	11	0	0	11	0	0
2	47582891	.	A	G	32	31	63	0	0	63	0	0
2	47583029	.	C	A	36	31	67	0	3	70	0	0
2	47583377	.	G	A	3	36	39	0	32	71	0	0
2	47583701	.	C	T	24	36	60	0	3	63	0	0
2	47583788	.	T	A	28	36	64	0	1	65	0	0
2	47584064	.	G	A	7	30	37	0	34	71	0	0
2	47584092	.	G	A	34	39	73	0	1	74	0	0
2	47584547	.	T	A	25	21	46	0	6	52	0	0
2	47584612	.	G	A	31	20	51	0	2	53	0	0
2	47584799	.	A	T	32	35	67	1	1	69	0	0
2	47587330	.	G	T	3	4	7	0	0	7	0	0
2	47587387	.	C	A	2	3	5	0	0	5	0	0
2	47587423	.	A	T	3	4	7	0	0	7	0	0
2	47587472	.	T	C	3	0	3	0	6	9	0	0
2	47587703	.	A	G	8	5	13	0	0	13	0	0
2	47620714	.	C	T	9	3	12	0	0	12	0	0
2	47633835	.	T	A	4	4	8	0	0	8	0	0
2	47633841	.	C	T	4	4	8	0	0	8	0	0
2	47644488	.	T	G	28	17	45	0	1	46	0	0
2	47648076	.	A	G	18	21	39	0	2	41	0	0
2	47648091	.	T	G	17	20	37	0	0	37	0	0
2	47651598	.	A	G	12	13	25	0	3	28	0	0
2	47652403	.	A	G	21	19	40	0	3	43	0	0
2	47652406	.	A	G	16	20	36	0	5	41	0	0
2	47658641	.	T	G	9	11	20	0	1	21	0	0
2	47658653	.	G	A	11	10	21	0	0	21	0	0
2	47658752	.	A	G	13	15	28	0	1	29	0	0
2	47661273	.	A	C	13	1	14	0	13	27	0	0
2	47662955	.	A	G	22	11	33	0	0	34	1	0
2	47754496	.	G	T	1	6	7	0	7	14	0	0
2	47754503	.	A	C	8	5	13	0	2	16	1	0
2	47805071	.	G	C	0	5	5	0	9	14	0	0
2	47827274	.	A	G	15	13	28	0	1	29	0	0
2	47829112	.	T	C	8	7	15	0	0	15	0	0
2	47829126	.	C	T	8	7	15	0	1	16	0	0
2	47916599	.	G	A	2	4	6	0	0	6	0	0
2	47916719	.	G	A	1	3	4	0	0	4	0	0
2	47918584	.	C	T	3	4	7	0	1	8	0	0
2	47955325	.	A	G	1	3	4	0	0	4	0	0
2	47955530	.	C	G	6	4	10	0	0	10	0	0
2	47955727	.	T	G	2	2	4	0	0	4	0	0
2	47955737	.	T	G	2	3	5	0	0	5	0	0
2	47957332	.	G	A	1	2	3	0	0	3	0	0
2	48092781	.	C	G	3	2	5	0	0	5	0	0
2	48092793	.	C	A	2	2	4	0	0	4	0	0
2	48095332	.	A	C	5	3	8	0	0	8	0	0
2	48098019	.	T	A	1	2	3	0	0	3	0	0
2	48099532	.	A	T	4	4	8	0	0	8	0	0
2	48099538	.	T	C	4	4	8	0	0	8	0	0
2	48101420	.	C	G	2	0	2	0	5	7	0	0
2	48105232	.	G	T	3	4	7	0	1	8	0	0
2	48108314	.	C	A	5	3	8	0	0	8	0	0
2	48111190	.	G	A	4	3	7	0	0	7	0	0
2	48112887	.	A	T	4	4	8	0	1	9	0	0
2	48115732	.	T	A	2	5	7	0	1	8	0	0
2	48118470	.	T	C	2	2	4	0	3	7	0	0
2	48118485	.	G	A	0	7	7	0	4	11	0	0
2	48119209	.	G	A	4	5	9	0	0	9	0	0
2	48119530	.	T	A	3	3	6	1	0	7	0	0
2	48119631	.	A	C	7	6	13	0	1	14	0	0
2	48119696	.	A	T	11	4	15	0	2	17	0	0
2	48119704	.	A	T	10	6	16	0	0	16	0	0
2	48119744	.	A	G	6	7	13	0	1	14	0	0
2	48119793	.	A	C	13	13	26	0	2	28	0	0
2	48119821	.	T	A	17	13	30	0	1	31	0	0
2	48120190	.	A	T	19	4	23	0	1	24	0	0
2	48120273	.	T	C	20	8	28	0	0	28	0	0
2	48120274	.	T	A	19	7	26	0	2	28	0	0
2	48120318	.	A	T	19	9	28	0	1	30	1	0
2	48120430	.	C	T	17	6	23	0	2	25	0	0
2	48120462	.	T	A	15	10	25	0	1	26	0	0
2	48120516	.	T	C	21	14	35	0	1	36	0	0
2	48120689	.	G	A	20	11	31	0	0	31	0	0
2	48120694	.	C	G	21	9	30	0	0	31	1	0
2	48120743	.	T	C	14	8	22	0	0	22	0	0
2	48120744	.	G	A	14	8	22	0	0	22	0	0
2	48120805	.	T	A	5	5	10	0	0	10	0	0
2	48120825	.	A	C	5	5	10	0	0	10	0	0
2	48120864	.	C	A	4	5	9	0	0	9	0	0
2	48120971	.	T	C	6	3	9	0	0	9	0	0
2	48121078	.	T	C	2	3	5	0	0	5	0	0
2	48121157	.	C	A	0	3	3	0	1	4	0	0
2	48121164	.	A	T	2	2	4	0	1	5	0	0
2	48121312	.	G	A	14	5	19	0	1	20	0	0
2	48121351	.	G	C	13	11	24	0	1	25	0	0
2	48121352	.	T	C	12	10	22	0	2	24	0	0
2	48121428	.	T	A	9	9	18	0	1	19	0	0
2	48127614	.	G	A	13	9	22	0	1	23	0	0
2	48127810	.	A	G	6	6	12	0	0	12	0	0
2	48130185	.	G	A	9	3	12	0	0	12	0	0
2	48130200	.	G	A	9	2	11	0	1	12	0	0
2	48130224	.	A	G	8	3	11	0	0	11	0	0
2	48130281	.	A	G	8	3	11	0	0	11	0	0
2	48137605	.	A	G	6	4	10	0	1	11	0	0
2	48137650	.	T	G	5	4	9	0	0	9	0	0
2	48163723	.	G	A	5	3	8	0	0	8	0	0
2	48203544	.	A	G	14	8	22	0	0	22	0	0
2	48203554	.	C	T	16	9	25	0	1	26	0	0
2	48203622	.	G	A	17	11	28	0	1	29	0	0
2	48203920	.	C	A	0	13	13	0	17	30	0	0
2	48207319	.	C	T	1	15	16	0	12	28	0	0
2	48212114	.	C	A	7	11	18	0	2	21	1	0
2	48221479	.	C	T	2	4	6	0	12	18	0	0
2	48224011	.	T	C	11	4	15	0	0	15	0	0
2	48232643	.	T	A	5	6	11	0	0	11	0	0
2	48234695	.	C	T	0	5	5	0	12	17	0	0
2	48284721	.	G	A	22	20	42	0	1	43	0	0
2	48285153	.	C	G	18	18	36	0	1	37	0	0
2	48285241	.	T	G	12	14	26	0	6	35	3	0
2	48285265	.	A	C	13	15	28	0	1	29	0	0
2	48290805	.	A	T	28	38	66	0	1	67	0	0
2	48290820	.	C	T	30	33	63	0	2	65	0	0
2	48304467	.	G	A	14	17	31	0	0	31	0	0
2	48309874	.	T	A	11	17	28	0	0	28	0	0
2	48309876	.	A	T	10	17	27	0	0	27	0	0
2	48309970	.	C	A	20	19	39	0	1	40	0	0
2	48310207	.	C	T	0	7	7	0	15	22	0	0
2	48310258	.	A	T	12	7	19	0	3	22	0	0
2	48310266	.	T	C	8	1	9	0	7	16	0	0
2	48310330	.	C	G	5	15	20	0	0	20	0	0
2	48310342	.	A	G	5	15	20	0	0	20	0	0
2	48310374	.	G	A	4	8	12	0	0	12	0	0
2	48313598	.	A	G	21	20	41	0	1	42	0	0
2	48317363	.	G	T	13	21	34	0	4	38	0	0
2	48317418	.	C	G	16	17	33	0	0	33	0	0
2	48317444	.	G	T	15	15	30	0	1	31	0	0
2	48323317	.	C	T	9	15	24	0	0	24	0	0
2	48323341	.	T	C	14	12	26	0	1	27	0	0
2	48323470	.	A	T	17	18	35	0	1	36	0	0
2	48323562	.	A	T	20	15	35	0	7	42	0	0
2	48323572	.	A	G	17	22	39	0	6	45	0	0
2	48323695	.	A	G	24	21	45	0	2	47	0	0
2	48323863	.	A	G	25	15	40	0	3	43	0	0
2	48326354	.	G	A	15	12	27	0	1	28	0	0
2	48326408	.	C	T	1	7	8	0	17	25	0	0
2	48332566	.	A	G	7	10	17	0	1	18	0	0
2	48335187	.	G	A	11	13	24	0	0	24	0	0
2	48343259	.	T	G	7	5	12	0	1	13	0	0
2	48343367	.	G	A	9	10	19	0	1	20	0	0
2	48344066	.	C	G	9	9	18	0	1	19	0	0
2	48344072	.	T	C	7	0	7	0	12	19	0	0
2	48345379	.	A	G	11	10	21	0	0	21	0	0
2	48356642	.	C	T	1	6	7	0	0	7	0	0
2	48512050	.	T	A	1	2	3	0	0	3	0	0
2	48546121	.	T	A	11	4	15	0	0	15	0	0
2	48552301	.	A	G	3	9	12	0	0	12	0	0
2	48552681	.	A	T	5	5	10	0	0	10	0	0
2	48552687	.	A	T	4	5	9	0	0	9	0	0
2	48753714	.	C	T	12	5	17	0	2	19	0	0
2	48956187	.	C	A	0	3	3	0	2	5	0	0
2	48965728	.	A	T	2	5	7	0	0	7	0	0
2	49007765	.	A	G	12	6	18	0	1	19	0	0
2	49007781	.	A	T	5	15	20	0	0	20	0	0
2	49008073	.	T	A	4	6	10	0	5	15	0	0
2	49008339	.	A	T	6	3	9	0	0	9	0	0
2	49008382	.	T	G	6	6	12	0	0	12	0	0
2	49017754	.	C	T	8	11	19	0	0	19	0	0
2	49039289	.	A	T	2	3	5	0	0	5	0	0
2	49063457	.	A	G	3	4	7	0	0	7	0	0
2	49063529	.	T	C	2	3	5	0	0	5	0	0
2	49063663	.	T	C	5	2	7	0	0	7	0	0
2	49609086	.	T	C	14	6	20	0	0	20	0	0
2	49609178	.	T	C	0	4	4	1	1	6	0	0
2	49609202	.	T	C	2	0	2	0	3	5	0	0
2	50892671	.	A	G	11	6	17	0	0	17	0	0
2	50892686	.	A	G	17	0	17	0	7	24	0	0
2	52063128	.	T	C	4	6	10	0	0	10	0	0
2	53065392	.	G	A	3	7	10	0	0	10	0	0
2	53065421	.	A	G	6	5	11	0	0	11	0	0
2	53085962	.	C	T	0	5	5	0	4	9	0	0
2	53091285	.	C	T	3	7	10	0	0	10	0	0
2	53201805	.	C	T	3	3	6	0	0	6	0	0
2	53205525	.	G	A	1	6	7	0	4	11	0	0
2	53359275	.	T	A	1	3	4	0	0	4	0	0
2	53414142	.	C	T	9	6	15	1	0	16	0	0
2	53665098	.	A	G	12	16	28	0	1	29	0	0
2	53673285	.	G	A	1	19	20	0	12	32	0	0
2	53673342	.	G	A	15	22	37	0	2	39	0	0
2	53673354	.	T	G	15	17	32	0	6	38	0	0
2	53673393	.	C	A	15	15	30	0	3	33	0	0
2	53675227	.	C	T	13	12	25	0	1	26	0	0
2	54017861	.	G	T	6	4	10	0	0	10	0	0
2	54017885	.	C	A	0	8	8	0	8	16	0	0
2	54018350	.	C	T	0	8	8	0	5	13	0	0
2	54018407	.	G	A	7	6	13	0	0	13	0	0
2	54018413	.	T	A	7	8	15	0	0	15	0	0
2	54018461	.	G	A	11	7	18	0	0	18	0	0
2	54039142	.	A	G	5	8	13	0	0	13	0	0
2	54039159	.	C	T	2	10	12	0	5	17	0	0
2	54049402	.	T	C	4	8	12	0	0	12	0	0
2	54049453	.	C	A	2	8	10	0	5	15	0	0
2	54051923	.	G	A	7	5	12	0	1	13	0	0
2	54054112	.	C	T	8	4	12	0	0	12	0	0
2	54054184	.	T	A	6	11	17	0	1	18	0	0
2	54054220	.	G	C	2	3	5	0	0	5	0	0
2	54422234	.	G	A	2	2	4	0	1	5	0	0
2	54832599	.	A	G	4	6	10	0	2	12	0	0
2	54832609	.	A	G	8	0	8	0	3	11	0	0
2	54923826	.	A	C	1	2	3	0	0	3	0	0
2	54923943	.	T	G	3	3	6	0	0	6	0	0
2	54924042	.	T	A	3	4	7	0	0	8	1	0
2	54924048	.	A	G	3	4	7	0	1	8	0	0
2	55491432	.	T	C	32	13	45	0	2	47	0	0
2	55491462	.	C	T	36	10	46	1	2	49	0	0
2	55491471	.	C	T	9	38	47	1	3	51	0	0
2	55964022	.	C	T	1	5	6	0	0	6	0	0
2	55964513	.	T	G	5	2	7	2	0	9	0	0
2	55967882	.	C	T	3	3	6	3	0	9	0	0
2	55968617	.	T	A	1	4	5	0	0	5	0	0
2	56126869	.	T	A	4	2	6	0	1	7	0	0
2	56508695	.	T	C	22	11	33	0	1	34	0	0
2	57240283	.	G	T	3	3	6	0	0	6	0	0
2	57240340	.	A	T	4	3	7	0	0	7	0	0
2	57240345	.	C	T	4	4	8	0	0	8	0	0
2	57240570	.	A	T	6	9	15	0	0	15	0	0
2	57240668	.	G	T	8	4	12	0	0	12	0	0
2	57240708	.	C	T	7	3	10	0	0	10	0	0
2	57240736	.	G	A	8	6	14	0	0	14	0	0
2	57247385	.	C	G	5	7	12	0	0	12	0	0
2	57268868	.	G	A	11	17	28	0	0	28	0	0
2	57268898	.	T	A	10	14	24	0	2	27	1	0
2	57268947	.	C	A	19	29	48	0	1	49	0	0
2	57269123	.	C	A	27	23	50	0	5	55	0	0
2	57284550	.	A	T	31	17	48	0	5	53	0	0
2	57325904	.	A	G	2	2	4	0	0	4	0	0
2	57345959	.	A	G	2	2	4	0	1	5	0	0
2	57372289	.	T	C	3	0	3	0	2	5	0	0
2	57416951	.	T	A	4	2	6	0	0	6	0	0
2	57417092	.	A	C	2	2	4	0	0	4	0	0
2	57420477	.	G	A	8	7	15	0	0	15	0	0
2	57433321	.	T	C	5	6	11	0	0	11	0	0
2	57433333	.	A	G	5	4	9	0	1	10	0	0
2	57442945	.	T	C	4	6	10	0	0	10	0	0
2	57609378	.	C	T	0	3	3	0	3	6	0	0
2	57609714	.	T	C	1	5	6	0	0	6	0	0
2	57620076	.	C	T	2	3	5	0	0	5	0	0
2	57706877	.	C	A	4	5	9	0	0	9	0	0
2	57830385	.	T	C	10	2	12	0	20	32	0	0
2	57830581	.	A	G	12	19	31	0	1	32	0	0
2	57831603	.	A	T	13	14	27	0	1	28	0	0
2	57834927	.	T	C	7	22	29	0	0	29	0	0
2	57834930	.	T	C	9	22	31	0	0	31	0	0
2	57848889	.	G	C	12	9	21	0	2	23	0	0
2	57848936	.	G	C	12	6	18	0	2	20	0	0
2	57856706	.	C	T	7	7	14	0	2	16	0	0
2	57867406	.	G	A	1	6	7	0	8	15	0	0
2	57867471	.	C	T	10	3	13	0	0	13	0	0
2	57867473	.	C	T	10	2	12	0	1	13	0	0
2	57867579	.	G	T	6	12	18	0	0	18	0	0
2	57867642	.	A	T	4	5	9	0	1	10	0	0
2	57868132	.	C	T	3	1	4	0	0	4	0	0
2	57868151	.	C	T	1	5	6	0	0	6	0	0
2	57868208	.	A	G	5	6	11	0	1	12	0	0
2	57868263	.	A	G	3	3	6	0	3	9	0	0
2	57868433	.	T	C	10	8	18	4	1	23	0	0
2	57868580	.	A	G	18	11	29	0	1	30	0	0
2	57868716	.	A	G	11	5	16	0	0	16	0	0
2	57869922	.	A	G	2	2	4	0	0	4	0	0
2	57869966	.	A	T	5	5	10	0	0	10	0	0
2	57870003	.	A	G	7	4	11	0	0	11	0	0
2	57870049	.	G	A	8	5	13	2	0	15	0	0
2	57870051	.	A	G	8	0	8	2	5	15	0	0
2	57870180	.	T	C	20	8	28	0	3	31	0	0
2	57870323	.	G	T	18	4	22	0	2	24	0	0
2	57870343	.	A	G	19	2	21	0	8	29	0	0
2	57870383	.	G	A	14	5	19	0	2	21	0	0
2	57870622	.	G	C	5	3	8	2	0	10	0	0
2	57870659	.	A	T	8	5	13	0	0	13	0	0
2	57870713	.	C	G	11	8	19	0	1	20	0	0
2	57870794	.	G	T	20	14	34	0	0	34	0	0
2	57870795	.	T	A	21	14	35	0	0	35	0	0
2	57870830	.	A	G	19	14	33	0	2	35	0	0
2	57870868	.	G	A	3	15	18	0	21	39	0	0
2	57870887	.	A	G	15	4	19	0	12	31	0	0
2	57870934	.	T	C	14	3	17	0	2	19	0	0
2	57870984	.	A	T	7	7	14	0	1	15	0	0
2	57879582	.	T	C	15	16	31	0	0	31	0	0
2	57879615	.	T	C	22	0	22	0	13	35	0	0
2	57879618	.	T	C	23	13	36	0	0	36	0	0
2	57883433	.	C	T	16	23	39	0	1	40	0	0
2	57883452	.	C	T	18	20	38	0	4	42	0	0
2	57883509	.	C	T	1	32	33	0	12	45	0	0
2	57891444	.	G	A	9	13	22	0	0	22	0	0
2	57891463	.	T	C	2	5	7	0	0	7	0	0
2	57893340	.	A	T	4	6	10	5	0	15	0	0
2	57893494	.	G	A	5	4	9	0	0	9	0	0
2	57893547	.	A	G	3	2	5	0	0	5	0	0
2	57893748	.	A	G	4	2	6	1	0	7	0	0
2	57893826	.	A	G	1	3	4	0	0	4	0	0
2	57893889	.	A	T	1	5	6	0	0	6	0	0
2	57893933	.	C	G	2	5	7	0	0	7	0	0
2	57894012	.	T	C	4	1	5	0	6	11	0	0
2	57894127	.	T	G	2	9	11	0	0	11	0	0
2	57898875	.	G	A	7	3	10	2	0	12	0	0
2	57899003	.	G	A	2	2	4	0	0	4	0	0
2	57913799	.	T	C	1	4	5	0	0	5	0	0
2	57913904	.	A	G	3	4	7	0	0	7	0	0
2	57913913	.	G	A	2	4	6	0	1	7	0	0
2	57916336	.	G	C	3	2	5	6	1	12	0	0
2	57916340	.	G	C	3	2	5	6	1	12	0	0
2	57918008	.	G	A	1	2	3	0	0	3	0	0
2	57918095	.	G	A	4	2	6	0	0	6	0	0
2	57918149	.	T	C	1	3	4	0	0	4	0	0
2	57918247	.	A	T	1	5	6	0	0	6	0	0
2	57940770	.	G	A	5	4	9	0	0	9	0	0
2	57940928	.	A	G	2	4	6	0	0	6	0	0
2	57953497	.	C	G	1	2	3	0	0	3	0	0
2	57957091	.	A	G	1	2	3	0	0	3	0	0
2	58009111	.	T	C	5	5	10	0	0	10	0	0
2	58009112	.	G	C	4	3	7	0	3	10	0	0
2	58009416	.	A	G	7	6	13	2	1	16	0	0
2	58012041	.	T	G	4	10	14	0	0	14	0	0
2	58012271	.	T	C	10	15	25	0	0	25	0	0
2	58012293	.	T	C	9	15	24	0	0	24	0	0
2	58012973	.	G	T	2	2	4	0	1	5	0	0
2	58013903	.	A	G	8	0	8	1	8	17	0	0
2	58014110	.	G	T	6	6	12	0	0	12	0	0
2	58014156	.	A	T	14	7	21	0	0	21	0	0
2	58014364	.	G	A	5	10	15	0	0	15	0	0
2	58014502	.	G	A	4	4	8	0	1	9	0	0
2	58014537	.	T	C	5	5	10	0	1	11	0	0
2	58077783	.	T	G	10	2	12	0	0	12	0	0
2	58077795	.	C	A	10	4	14	0	0	15	1	0
2	58077869	.	T	C	10	14	24	0	0	24	0	0
2	58078071	.	G	C	12	14	26	0	0	26	0	0
2	58081768	.	G	A	12	15	27	0	3	30	0	0
2	58126268	.	C	T	5	6	11	0	1	12	0	0
2	58129968	.	C	G	5	4	9	0	1	10	0	0
2	58129992	.	A	G	4	1	5	0	0	5	0	0
2	58132558	.	A	C	2	4	6	0	0	6	0	0
2	58133712	.	C	A	3	5	8	0	1	9	0	0
2	58137902	.	A	C	6	8	14	0	0	14	0	0
2	58186872	.	T	C	12	2	14	0	2	16	0	0
2	58186891	.	G	T	12	6	18	0	2	20	0	0
2	58186945	.	T	C	10	9	19	0	2	21	0	0
2	58187038	.	G	A	8	4	12	0	1	13	0	0
2	58187052	.	T	A	9	6	15	0	2	17	0	0
2	58187187	.	T	C	23	0	23	0	10	33	0	0
2	58187621	.	G	T	12	9	21	0	2	23	0	0
2	58187624	.	C	T	2	10	12	0	10	22	0	0
2	58227068	.	C	T	3	5	8	0	0	8	0	0
2	58228022	.	G	C	4	2	6	0	0	6	0	0
2	58349088	.	A	G	3	6	9	0	0	9	0	0
2	58349253	.	G	A	10	3	13	0	1	14	0	0
2	58349274	.	T	C	8	3	11	0	1	12	0	0
2	58358563	.	A	T	5	2	7	0	0	7	0	0
2	58358627	.	T	G	4	3	7	0	0	7	0	0
2	58366121	.	T	C	2	2	4	0	1	5	0	0
2	58411998	.	T	C	33	20	53	1	1	55	0	0
2	58514819	.	T	C	15	19	34	0	3	37	0	0
2	58516445	.	C	A	14	20	34	1	1	36	0	0
2	58541894	.	C	T	17	13	30	0	3	33	0	0
2	58541939	.	G	A	18	16	34	0	1	35	0	0
2	58541981	.	C	G	17	17	34	1	0	35	0	0
2	58546821	.	G	T	11	16	27	0	0	27	0	0
2	58546893	.	G	A	12	21	33	0	0	33	0	0
2	58581582	.	G	C	4	13	17	0	0	17	0	0
2	58632210	.	T	C	5	0	5	1	6	12	0	0
2	58739511	.	C	T	16	6	22	0	2	24	0	0
2	58739574	.	C	T	15	6	21	0	0	21	0	0
2	58739714	.	G	A	10	14	24	0	1	25	0	0
2	58785866	.	T	C	11	18	29	0	6	35	0	0
2	58786094	.	G	A	20	17	37	1	0	38	0	0
2	58788301	.	A	G	12	14	26	0	0	26	0	0
2	58789112	.	G	A	10	14	24	0	0	24	0	0
2	58793396	.	C	T	0	15	15	0	15	30	0	0
2	58793438	.	A	G	16	11	27	0	2	29	0	0
2	58793652	.	A	G	9	13	22	0	0	22	0	0
2	58795599	.	C	T	9	5	14	0	2	16	0	0
2	58841219	.	T	C	25	23	48	0	2	50	0	0
2	58843563	.	G	A	2	14	16	14	10	40	0	0
2	58843569	.	T	C	17	10	27	11	2	40	0	0
2	58845239	.	C	T	1	2	3	0	1	4	0	0
2	58845396	.	T	C	9	19	28	0	2	30	0	0
2	58848646	.	T	G	41	1	42	0	21	64	1	0
2	58868193	.	G	A	9	8	17	0	1	18	0	0
2	58868439	.	T	C	14	0	14	0	14	28	0	0
2	58868577	.	G	C	11	0	11	0	11	22	0	0
2	58868679	.	G	A	7	7	14	0	1	15	0	0
2	58868841	.	G	A	9	6	15	0	0	15	0	0
2	58869037	.	C	G	3	2	5	0	0	5	0	0
2	58869142	.	G	A	12	13	25	0	0	25	0	0
2	58869319	.	G	T	15	3	18	0	3	21	0	0
2	58879122	.	C	G	15	0	15	0	11	26	0	0
2	58887668	.	T	C	2	2	4	0	0	4	0	0
2	58887726	.	A	G	3	4	7	0	1	8	0	0
2	58887752	.	G	A	7	3	10	1	0	11	0	0
2	58887766	.	C	G	8	2	10	1	0	11	0	0
2	58887817	.	C	T	1	7	8	0	5	13	0	0
2	58888017	.	G	A	10	7	17	2	4	23	0	0
2	58888018	.	C	T	0	9	9	2	11	22	0	0
2	58888966	.	C	A	8	9	17	0	2	19	0	0
2	58892142	.	T	C	11	1	12	0	12	24	0	0
2	58892160	.	C	T	12	11	23	0	2	25	0	0
2	58898910	.	A	G	9	3	12	0	0	12	0	0
2	58996000	.	A	T	6	5	11	0	0	11	0	0
2	59004046	.	C	T	6	10	16	0	0	16	0	0
2	59032670	.	T	C	12	8	20	0	2	22	0	0
2	59045797	.	G	A	0	6	6	0	7	13	0	0
2	59050160	.	C	T	5	5	10	0	1	11	0	0
2	59056203	.	C	T	16	25	41	0	0	41	0	0
2	59056212	.	G	A	20	18	38	0	2	40	0	0
2	59057670	.	C	T	17	25	42	0	2	44	0	0
2	59063227	.	T	C	13	11	24	0	5	29	0	0
20	66886	.	C	A	5	5	10	0	0	10	0	0
20	67036	.	T	G	10	3	13	0	0	13	0	0
20	75079	.	C	A	6	8	14	0	1	15	0	0
20	75889	.	C	T	11	11	22	0	0	22	0	0
20	76193	.	G	A	2	9	11	0	9	20	0	0
20	76209	.	A	G	13	10	23	0	0	23	0	0
20	87286	.	T	C	1	5	6	0	0	6	0	0
20	89222	.	A	T	6	12	18	0	1	19	0	0
20	89225	.	T	C	7	10	17	0	2	19	0	0
20	89567	.	G	A	9	12	21	0	0	21	0	0
20	89625	.	T	A	7	12	19	0	1	20	0	0
20	89855	.	G	C	11	13	24	0	0	24	0	0
20	90003	.	A	T	7	10	17	0	1	18	0	0
20	90242	.	T	C	6	11	17	0	1	18	0	0
20	116164	.	A	T	24	26	50	0	1	51	0	0
20	122227	.	A	T	3	3	6	0	0	6	0	0
20	122542	.	T	C	6	2	8	0	0	8	0	0
20	125470	.	G	A	3	4	7	0	0	7	0	0
20	127773	.	G	A	1	3	4	0	0	4	0	0
20	151486	.	C	T	2	4	6	0	0	6	0	0
20	151534	.	A	G	5	7	12	0	0	12	0	0
20	151548	.	C	T	1	8	9	0	5	14	0	0
20	151614	.	T	A	8	2	10	0	0	10	0	0
20	151768	.	G	T	9	12	21	0	2	23	0	0
20	151780	.	G	A	7	14	21	0	1	22	0	0
20	152496	.	G	C	12	8	20	0	2	22	0	0
20	152861	.	A	C	5	8	13	0	1	14	0	0
20	160569	.	G	A	1	3	4	0	0	4	0	0
20	186674	.	C	G	12	15	27	0	0	27	0	0
20	186675	.	T	C	11	15	26	0	0	26	0	0
20	186752	.	G	A	20	8	28	0	0	28	0	0
20	186776	.	A	G	10	17	27	0	0	27	0	0
20	186796	.	C	T	2	19	21	0	11	32	0	0
20	188638	.	T	C	7	13	20	0	0	20	0	0
20	196767	.	G	A	10	11	21	0	2	23	0	0
20	196773	.	T	A	13	11	24	0	0	24	0	0
20	196838	.	G	A	5	10	15	0	0	15	0	0
20	197031	.	C	G	9	7	16	0	1	17	0	0
20	197293	.	T	C	8	7	15	0	0	15	0	0
20	197362	.	C	T	8	10	18	0	2	20	0	0
20	197560	.	C	G	11	15	26	0	0	26	0	0
20	197572	.	C	G	13	12	25	0	2	27	0	0
20	197842	.	T	C	12	17	29	0	1	30	0	0
20	198040	.	G	T	12	5	17	0	1	18	0	0
20	198049	.	C	T	10	8	18	0	1	19	0	0
20	198112	.	G	T	18	10	28	0	1	29	0	0
20	198127	.	A	T	14	16	30	0	1	31	0	0
20	198552	.	G	T	2	7	9	0	1	10	0	0
20	198577	.	G	A	7	6	13	0	2	15	0	0
20	198622	.	A	G	7	9	16	0	1	17	0	0
20	198733	.	A	G	6	6	12	0	1	13	0	0
20	198735	.	C	A	7	6	13	0	0	13	0	0
20	199129	.	T	G	11	10	21	0	1	22	0	0
20	199168	.	C	T	0	10	10	0	11	21	0	0
20	199536	.	C	G	5	8	13	0	0	13	0	0
20	199956	.	G	A	7	7	14	0	1	15	0	0
20	199962	.	T	C	6	4	10	0	2	12	0	0
20	200245	.	C	T	0	5	5	0	8	13	0	0
20	200302	.	C	T	9	7	16	0	1	17	0	0
20	200544	.	C	T	1	7	8	0	14	22	0	0
20	201341	.	T	A	3	7	10	0	0	10	0	0
20	201628	.	T	A	8	8	16	0	0	16	0	0
20	201889	.	T	C	5	0	5	0	6	11	0	0
20	201945	.	G	T	5	7	12	0	0	12	0	0
20	201949	.	T	A	2	6	8	0	0	8	0	0
20	202012	.	A	G	9	4	13	0	1	14	0	0
20	202052	.	A	G	6	5	11	0	0	11	0	0
20	202340	.	T	A	6	9	15	0	0	15	0	0
20	202389	.	A	G	7	8	15	0	0	15	0	0
20	202480	.	T	C	8	5	13	0	0	13	0	0
20	202510	.	G	A	6	8	14	0	0	14	0	0
20	202975	.	G	A	1	4	5	0	0	5	0	0
20	202982	.	T	C	3	2	5	0	0	5	0	0
20	203122	.	G	A	5	4	9	0	0	9	0	0
20	204595	.	T	A	4	3	7	0	0	7	0	0
20	206060	.	C	T	0	2	2	0	3	5	0	0
20	207275	.	G	A	3	5	8	0	0	8	0	0
20	207299	.	T	C	2	0	2	0	4	6	0	0
20	211782	.	C	G	0	2	2	0	1	3	0	0
20	211801	.	A	G	6	2	8	0	0	8	0	0
20	231536	.	T	C	2	2	4	0	0	4	0	0
20	233161	.	T	C	1	2	3	0	0	3	0	0
20	233185	.	T	C	3	2	5	0	1	6	0	0
20	238374	.	A	C	1	2	3	0	0	3	0	0
20	239679	.	T	C	3	3	6	0	0	6	0	0
20	239684	.	T	A	3	2	5	0	1	6	0	0
20	251162	.	A	G	2	0	2	0	3	5	0	0
20	254130	.	G	A	6	3	9	0	0	9	0	0
20	254601	.	C	T	5	2	7	0	0	7	0	0
20	255431	.	C	T	6	4	10	0	0	10	0	0
20	255433	.	C	G	6	4	10	0	0	10	0	0
20	255859	.	G	A	2	6	8	0	2	10	0	0
20	259534	.	C	T	8	4	12	0	1	13	0	0
20	259602	.	T	C	10	4	14	0	0	14	0	0
20	259625	.	T	C	7	8	15	0	0	15	0	0
20	259763	.	C	T	7	5	12	0	0	12	0	0
20	259766	.	C	A	7	5	12	0	0	12	0	0
20	259847	.	C	T	6	2	8	0	0	8	0	0
20	329072	.	A	C	12	5	17	0	2	19	0	0
20	329113	.	G	A	7	9	16	0	0	16	0	0
20	343858	.	A	C	6	9	15	0	0	15	0	0
20	369583	.	A	G	6	0	6	0	6	12	0	0
20	379577	.	A	C	3	5	8	0	0	8	0	0
20	379595	.	C	T	3	2	5	0	0	5	0	0
20	390754	.	C	T	4	4	8	0	0	8	0	0
20	393304	.	A	T	5	9	14	0	1	15	0	0
20	395704	.	C	T	10	4	14	0	0	14	0	0
20	395859	.	T	A	5	7	12	0	0	12	0	0
20	395928	.	G	A	3	4	7	0	0	7	0	0
20	403752	.	T	C	2	4	6	0	1	7	0	0
20	403760	.	C	T	2	5	7	0	0	7	0	0
20	405867	.	G	A	2	8	10	0	0	10	0	0
20	405928	.	A	G	8	0	8	0	14	22	0	0
20	406221	.	T	C	6	8	14	1	0	15	0	0
20	406278	.	T	A	6	4	10	2	0	12	0	0
20	409377	.	C	A	5	9	14	0	0	14	0	0
20	409524	.	C	T	7	5	12	0	1	13	0	0
20	409629	.	T	C	7	10	17	0	0	17	0	0
20	410832	.	A	T	13	14	27	0	0	27	0	0
20	411063	.	T	A	4	4	8	0	0	8	0	0
20	423715	.	G	T	7	8	15	0	1	16	0	0
20	423977	.	G	C	9	7	16	0	0	16	0	0
20	424420	.	T	A	6	12	18	0	0	18	0	0
20	426390	.	T	C	4	6	10	0	0	10	0	0
20	429984	.	G	A	7	4	11	0	1	12	0	0
20	430080	.	A	G	7	6	13	0	0	13	0	0
20	431851	.	C	T	4	7	11	0	0	11	0	0
20	431870	.	C	G	8	4	12	0	0	12	0	0
20	436652	.	G	A	7	6	13	0	0	13	0	0
20	436661	.	T	C	7	5	12	0	1	13	0	0
20	474341	.	C	A	8	4	12	0	0	12	0	0
20	474375	.	T	A	5	11	16	0	0	16	0	0
20	479187	.	A	G	5	0	5	0	7	12	0	0
20	483692	.	C	T	10	5	15	0	0	15	0	0
20	483866	.	C	T	13	4	17	0	0	17	0	0
20	522541	.	G	A	14	13	27	0	1	28	0	0
20	522811	.	T	A	6	4	10	0	1	11	0	0
20	525663	.	G	A	15	11	26	0	0	26	0	0
20	528561	.	C	T	21	6	27	0	0	27	0	0
20	530335	.	C	T	8	10	18	1	0	19	0	0
20	530443	.	C	T	11	3	14	0	1	15	0	0
20	530445	.	T	G	12	3	15	0	0	15	0	0
20	530534	.	C	G	4	7	11	0	2	13	0	0
20	530624	.	G	T	4	6	10	0	0	10	0	0
20	555964	.	T	A	2	2	4	0	0	4	0	0
20	557255	.	A	G	4	2	6	0	0	6	0	0
20	557606	.	T	C	3	2	5	0	0	5	0	0
20	557610	.	A	T	2	2	4	0	0	4	0	0
20	565267	.	G	A	1	2	3	0	2	5	0	0
20	565863	.	G	C	4	2	6	0	0	6	0	0
20	566083	.	G	A	2	3	5	0	0	5	0	0
20	566439	.	G	T	1	2	3	1	0	4	0	0
20	592243	.	A	G	3	4	7	0	1	8	0	0
20	593880	.	C	T	3	2	5	0	0	5	0	0
20	598222	.	T	C	1	2	3	0	1	4	0	0
20	603647	.	T	C	3	6	9	0	0	9	0	0
20	605264	.	C	T	8	7	15	0	1	16	0	0
20	605291	.	C	T	4	7	11	0	1	12	0	0
20	700683	.	C	T	8	5	13	0	0	13	0	0
20	700686	.	A	T	8	5	13	0	0	13	0	0
20	700965	.	C	T	9	9	18	0	2	20	0	0
20	707767	.	C	T	6	10	16	0	0	16	0	0
20	711983	.	T	A	8	14	22	0	2	24	0	0
20	711988	.	C	T	15	9	24	0	0	24	0	0
20	712483	.	C	A	3	3	6	0	1	7	0	0
20	712497	.	A	G	4	3	7	0	0	7	0	0
20	715806	.	C	A	4	7	11	0	0	11	0	0
20	733590	.	G	A	8	5	13	0	0	13	0	0
20	742063	.	G	A	4	6	10	0	0	10	0	0
20	742111	.	A	C	3	4	7	0	1	8	0	0
20	742126	.	T	C	3	3	6	0	1	7	0	0
20	744016	.	A	C	4	7	11	0	0	11	0	0
20	745412	.	C	T	8	7	15	0	0	15	0	0
20	752624	.	G	A	0	6	6	0	4	10	0	0
20	755749	.	C	T	7	9	16	0	0	16	0	0
20	757522	.	G	A	10	10	20	0	0	20	0	0
20	761004	.	C	T	17	13	30	0	0	30	0	0
20	761006	.	G	C	14	15	29	0	3	32	0	0
20	764388	.	A	G	11	5	16	0	1	17	0	0
20	764436	.	T	C	19	13	32	0	0	32	0	0
20	764807	.	G	A	16	13	29	0	0	29	0	0
20	772700	.	C	T	14	13	27	0	1	28	0	0
20	775412	.	G	A	1	12	13	0	15	28	0	0
20	775487	.	C	T	16	12	28	0	3	31	0	0
20	775925	.	G	T	3	12	15	0	17	33	1	0
20	776171	.	C	T	18	27	45	3	1	49	0	0
20	776630	.	G	T	17	12	29	3	1	33	0	0
20	776700	.	T	C	8	15	23	1	2	26	0	0
20	776745	.	C	T	4	14	18	1	2	21	0	0
20	841264	.	C	T	6	2	8	0	0	8	0	0
20	841267	.	T	C	5	2	7	0	0	7	0	0
20	844590	.	G	A	2	3	5	0	0	5	0	0
20	844592	.	C	G	1	2	3	0	2	5	0	0
20	847779	.	G	A	2	4	6	0	0	6	0	0
20	847887	.	T	A	2	5	7	0	0	7	0	0
20	847893	.	T	A	5	2	7	0	0	7	0	0
20	851732	.	T	A	3	6	9	0	2	11	0	0
20	851843	.	T	C	6	10	16	0	0	16	0	0
20	851876	.	C	T	10	10	20	0	0	20	0	0
20	852184	.	A	G	14	12	26	0	1	27	0	0
20	852217	.	C	T	1	12	13	0	11	24	0	0
20	853669	.	C	T	16	7	23	0	1	24	0	0
20	856185	.	G	A	11	15	26	0	0	26	0	0
20	875285	.	A	G	8	6	14	0	0	14	0	0
20	880747	.	A	T	6	8	14	0	1	15	0	0
20	883106	.	C	A	8	3	11	1	0	12	0	0
20	883163	.	C	T	0	5	5	0	2	7	0	0
20	888058	.	T	C	6	3	9	0	1	10	0	0
20	892055	.	C	T	3	5	8	0	0	8	0	0
20	894295	.	T	A	7	2	9	0	0	9	0	0
20	902770	.	G	A	10	6	16	0	3	19	0	0
20	902866	.	G	A	13	17	30	0	0	30	0	0
20	902913	.	C	T	1	7	8	0	23	31	0	0
20	902937	.	G	T	18	9	27	0	2	29	0	0
20	908096	.	C	A	15	8	23	0	0	23	0	0
20	908294	.	A	G	11	6	17	0	0	17	0	0
20	943944	.	T	G	10	6	16	0	0	16	0	0
20	943974	.	T	C	9	3	12	0	0	12	0	0
20	946681	.	G	A	8	13	21	0	0	21	0	0
20	1064213	.	C	T	3	7	10	0	0	10	0	0
20	1081952	.	G	T	4	3	7	0	0	7	0	0
20	1119975	.	C	G	10	3	13	0	0	13	0	0
20	1121515	.	C	T	5	5	10	0	0	10	0	0
20	1121528	.	G	T	6	5	11	0	0	11	0	0
20	1121685	.	C	T	11	6	17	0	1	18	0	0
20	1121715	.	A	G	6	17	23	0	0	23	0	0
20	1125057	.	A	G	7	13	20	0	1	21	0	0
20	1125135	.	G	A	3	7	10	0	10	20	0	0
20	1177814	.	T	C	7	5	12	0	0	12	0	0
20	1178263	.	T	C	2	2	4	0	0	4	0	0
20	1178273	.	C	A	2	3	5	0	0	5	0	0
20	1178505	.	T	C	3	3	6	0	0	6	0	0
20	1178725	.	A	G	5	5	10	0	0	10	0	0
20	1178913	.	G	A	7	9	16	1	1	18	0	0
20	1178955	.	T	A	10	5	15	0	0	15	0	0
20	1179196	.	T	C	5	7	12	0	2	14	0	0
20	1179309	.	T	C	2	2	4	0	0	4	0	0
20	1179348	.	A	C	2	2	4	0	0	4	0	0
20	1182872	.	G	A	5	3	8	0	2	10	0	0
20	1185942	.	G	A	4	5	9	0	0	9	0	0
20	1191775	.	G	A	7	9	16	0	1	17	0	0
20	1196435	.	G	A	8	14	22	0	2	24	0	0
20	1198365	.	C	A	8	16	24	0	2	26	0	0
20	1198396	.	C	T	19	4	23	0	1	24	0	0
20	1198400	.	T	C	19	3	22	0	1	23	0	0
20	1201826	.	T	C	6	3	9	0	0	9	0	0
20	1201917	.	A	T	5	6	11	0	1	12	0	0
20	1201918	.	C	A	5	7	12	0	0	12	0	0
20	1201989	.	G	C	4	3	7	0	0	7	0	0
20	1201993	.	A	G	4	3	7	0	0	7	0	0
20	1202177	.	G	A	8	5	13	0	0	13	0	0
20	1204506	.	A	T	1	2	3	0	6	9	0	0
20	1204577	.	G	T	1	5	6	0	3	9	0	0
20	1204727	.	C	G	6	4	10	1	0	11	0	0
20	1205899	.	T	C	4	8	12	0	0	12	0	0
20	1205980	.	G	A	5	7	12	0	0	12	0	0
20	1208919	.	A	T	1	5	6	0	0	6	0	0
20	1209065	.	T	C	4	9	13	0	2	15	0	0
20	1209132	.	G	C	10	0	10	0	12	22	0	0
20	1214976	.	G	A	3	3	6	0	0	6	0	0
20	1230195	.	A	G	1	4	5	0	0	5	0	0
20	1230201	.	C	G	0	4	4	0	1	5	0	0
20	1240552	.	A	T	4	3	7	0	0	7	0	0
20	1240684	.	G	A	3	2	5	0	0	5	0	0
20	1240812	.	C	T	8	3	11	0	0	11	0	0
20	1240962	.	C	A	5	4	9	1	0	10	0	0
20	1240963	.	T	A	5	4	9	1	0	10	0	0
20	1241075	.	G	A	8	4	12	0	2	14	0	0
20	1241081	.	C	T	7	5	12	0	3	15	0	0
20	1241414	.	C	T	4	3	7	0	0	9	2	0
20	1241427	.	C	T	4	6	10	0	0	10	0	0
20	1241467	.	G	A	1	5	6	0	0	8	2	0
20	1241478	.	A	T	2	4	6	0	0	7	1	0
20	1241535	.	T	C	4	4	8	0	0	8	0	0
20	1241536	.	T	C	7	0	7	0	2	9	0	0
20	1241809	.	A	T	2	8	10	0	0	10	0	0
20	1241960	.	A	G	2	4	6	0	0	6	0	0
20	1242639	.	T	C	2	4	6	0	0	6	0	0
20	1243403	.	T	C	5	2	7	0	0	7	0	0
20	1243598	.	A	G	1	3	4	0	1	5	0	0
20	1243941	.	C	G	3	2	5	0	0	5	0	0
20	1244166	.	A	G	2	3	5	0	0	5	0	0
20	1244379	.	G	A	6	6	12	0	0	12	0	0
20	1246641	.	C	A	1	3	4	0	1	5	0	0
20	1246936	.	C	T	0	3	3	0	6	9	0	0
20	1265360	.	C	T	0	2	2	0	3	5	0	0
20	1281883	.	G	A	1	13	14	0	11	25	0	0
20	1282601	.	C	A	11	15	26	0	1	27	0	0
20	1282634	.	A	C	15	18	33	0	1	34	0	0
20	1294012	.	T	G	5	8	13	0	0	13	0	0
20	1294099	.	G	C	17	16	33	0	2	35	0	0
20	1294119	.	A	G	20	17	37	0	2	39	0	0
20	1294259	.	A	T	21	21	42	0	1	43	0	0
20	1294267	.	T	G	22	20	42	0	0	42	0	0
20	1294649	.	A	G	3	3	6	0	0	6	0	0
20	1294801	.	A	C	0	3	3	0	0	3	0	0
20	1294811	.	T	C	4	6	10	0	0	10	0	0
20	1294903	.	C	G	7	8	15	0	1	16	0	0
20	1295017	.	T	C	8	6	14	3	0	17	0	0
20	1295312	.	T	C	4	3	7	2	0	9	0	0
20	1295571	.	T	C	12	0	12	0	12	24	0	0
20	1314478	.	A	G	3	3	6	0	0	6	0	0
20	1316757	.	G	C	6	3	9	0	0	9	0	0
20	1316860	.	G	C	1	2	3	0	7	10	0	0
20	1320057	.	T	G	3	0	3	0	5	8	0	0
20	1322643	.	A	G	3	6	9	0	0	9	0	0
20	1322715	.	G	A	2	3	5	0	11	16	0	0
20	1324404	.	G	A	8	6	14	0	1	15	0	0
20	1324976	.	C	A	12	5	17	0	0	17	0	0
20	1327501	.	C	A	14	5	19	0	1	20	0	0
20	1327528	.	A	C	13	10	23	0	1	24	0	0
20	1338955	.	T	C	6	3	9	0	0	9	0	0
20	1339021	.	C	T	5	2	7	0	0	7	0	0
20	1339084	.	G	A	3	6	9	0	0	9	0	0
20	1339459	.	G	C	0	10	10	0	3	13	0	0
20	1339486	.	T	G	8	5	13	0	1	14	0	0
20	1339726	.	A	G	6	1	7	0	5	12	0	0
20	1339786	.	T	C	7	4	11	0	2	13	0	0
20	1339843	.	C	T	7	7	14	0	2	16	0	0
20	1339924	.	G	A	6	3	9	0	0	9	0	0
20	1339984	.	C	A	5	4	9	0	0	9	0	0
20	1340015	.	G	A	0	7	7	0	5	12	0	0
20	1340266	.	T	C	5	7	12	0	1	13	0	0
20	1340269	.	T	C	6	6	12	0	0	12	0	0
20	1341771	.	A	C	7	6	13	0	1	14	0	0
20	1341776	.	A	G	3	8	11	0	1	12	0	0
20	1341833	.	T	C	3	4	7	0	1	8	0	0
20	1341836	.	C	T	4	4	8	0	0	8	0	0
20	1349264	.	A	T	7	3	10	0	0	10	0	0
20	1349622	.	T	C	5	3	8	0	0	8	0	0
20	1349849	.	T	C	4	3	7	0	1	8	0	0
20	1349869	.	G	T	0	4	4	0	5	9	0	0
20	1349955	.	G	A	10	6	16	0	0	16	0	0
20	1350029	.	C	G	3	3	6	0	0	6	0	0
20	1392415	.	T	G	4	2	6	0	0	6	0	0
20	1441666	.	T	C	4	3	7	0	2	9	0	0
20	1441777	.	A	G	13	17	30	0	1	31	0	0
20	1442358	.	G	T	10	6	16	0	0	16	0	0
20	1442468	.	G	A	6	9	15	0	1	16	0	0
20	1442522	.	C	A	10	12	22	0	1	23	0	0
20	1442582	.	G	T	14	11	25	0	0	25	0	0
20	1445375	.	C	T	16	14	30	0	2	32	0	0
20	1454065	.	T	C	20	16	36	0	0	36	0	0
20	1454098	.	A	G	14	16	30	0	3	33	0	0
20	1476772	.	C	T	10	4	14	0	1	15	0	0
20	1487486	.	T	A	8	5	13	0	2	15	0	0
20	1487549	.	A	G	7	3	10	0	1	11	0	0
20	1487612	.	T	C	6	3	9	0	0	9	0	0
20	1513617	.	G	A	7	5	12	0	0	12	0	0
20	1518291	.	A	G	11	14	25	1	1	27	0	0
20	1518414	.	G	A	11	12	23	0	0	23	0	0
20	1519699	.	A	G	12	8	20	0	0	20	0	0
20	1524039	.	A	G	7	5	12	0	0	12	0	0
20	1607617	.	T	G	9	4	13	0	0	13	0	0
20	1607674	.	A	G	4	6	10	0	0	10	0	0
20	1607857	.	T	C	2	0	2	0	3	5	0	0
20	1635899	.	G	A	9	10	19	0	0	19	0	0
20	2073828	.	T	C	2	4	6	0	0	6	0	0
20	2083086	.	T	C	4	4	8	0	0	8	0	0
20	2083143	.	A	G	1	4	5	0	0	5	0	0
20	2156208	.	C	T	6	5	11	0	0	11	0	0
20	2161708	.	C	T	2	4	6	0	0	6	0	0
20	2167832	.	A	T	2	3	5	0	0	5	0	0
20	2184168	.	A	T	7	4	11	0	0	11	0	0
20	2205982	.	A	G	6	4	10	0	0	10	0	0
20	2206103	.	A	C	2	4	6	0	0	6	0	0
20	2227912	.	C	T	7	5	12	0	0	12	0	0
20	2227929	.	A	T	7	6	13	0	0	13	0	0
20	2227981	.	A	G	1	4	5	0	2	7	0	0
20	2228008	.	G	A	1	3	4	0	3	7	0	0
20	2228217	.	A	T	5	5	10	0	0	10	0	0
20	2228253	.	A	G	4	5	9	0	0	9	0	0
20	2240626	.	C	A	3	4	7	0	0	7	0	0
20	2240685	.	G	A	6	5	11	0	1	12	0	0
20	2240696	.	C	T	7	6	13	0	0	13	0	0
20	2240975	.	C	A	4	2	6	0	0	6	0	0
20	2241011	.	G	A	1	2	3	0	4	7	0	0
20	2241179	.	A	C	6	5	11	0	2	13	0	0
20	2241401	.	C	T	5	6	11	0	0	11	0	0
20	2241590	.	A	C	7	7	14	0	0	14	0	0
20	2241905	.	T	C	5	9	14	0	0	14	0	0
20	2295306	.	T	C	9	17	26	0	5	31	0	0
20	2318995	.	A	G	14	22	36	0	1	37	0	0
20	2319013	.	C	T	1	22	23	0	15	38	0	0
20	2338942	.	C	T	7	15	22	0	2	24	0	0
20	2338954	.	C	A	13	7	20	0	2	22	0	0
20	2359155	.	T	A	17	13	30	0	3	33	0	0
20	2361074	.	G	A	21	16	37	0	1	38	0	0
20	2361194	.	C	T	16	21	37	0	1	38	0	0
20	2361200	.	C	T	4	23	27	0	16	43	0	0
20	2460902	.	G	C	5	11	16	0	0	16	0	0
20	2479225	.	C	T	11	6	17	0	0	17	0	0
20	2499748	.	T	G	2	4	6	0	1	7	0	0
20	2499749	.	G	T	2	5	7	0	0	7	0	0
20	2499995	.	C	T	19	13	32	0	1	33	0	0
20	2500083	.	G	A	14	8	22	0	0	22	0	0
20	2506085	.	G	T	7	11	18	0	1	19	0	0
20	2513660	.	C	A	7	3	10	0	1	11	0	0
20	2515283	.	G	A	5	4	9	1	0	10	0	0
20	2515792	.	A	G	5	6	11	0	1	12	0	0
20	2515807	.	C	T	3	6	9	0	0	9	0	0
20	2515903	.	G	A	6	7	13	0	0	13	0	0
20	2519064	.	G	A	4	6	10	0	0	10	0	0
20	2519136	.	G	A	4	8	12	0	1	13	0	0
20	2519674	.	G	A	4	6	10	0	0	10	0	0
20	2519854	.	G	A	11	6	17	0	1	18	0	0
20	2524424	.	G	A	15	6	21	0	1	22	0	0
20	2524484	.	C	T	4	9	13	0	0	13	0	0
20	2524499	.	G	A	5	5	10	0	1	11	0	0
20	2544882	.	T	G	3	3	6	0	0	6	0	0
20	2544891	.	T	C	4	3	7	0	0	7	0	0
20	2548460	.	T	C	2	4	6	0	0	6	0	0
20	2548481	.	A	G	3	6	9	0	0	9	0	0
20	2548520	.	C	T	2	5	7	0	0	7	0	0
20	2548523	.	C	T	1	4	5	0	2	7	0	0
20	2551632	.	T	G	4	6	10	0	1	11	0	0
20	2551716	.	A	G	5	4	9	0	1	10	0	0
20	2552049	.	T	A	6	5	11	0	0	11	0	0
20	2554738	.	G	C	7	0	7	0	7	14	0	0
20	2554834	.	A	G	4	2	6	0	0	6	0	0
20	2556537	.	G	A	3	3	6	0	0	6	0	0
20	2556604	.	G	A	2	2	4	0	0	4	0	0
20	2556616	.	C	T	3	2	5	0	0	5	0	0
20	2976077	.	A	G	19	5	24	2	0	26	0	0
20	2976094	.	A	G	15	10	25	2	2	29	0	0
20	2976114	.	A	G	16	7	23	4	1	28	0	0
20	2976909	.	C	A	16	17	33	1	2	36	0	0
20	2977257	.	C	T	40	18	58	0	2	61	1	0
20	2977417	.	C	A	25	7	32	3	1	37	1	0
20	2977418	.	C	A	25	7	32	2	1	35	0	0
20	3001783	.	G	A	9	4	13	0	1	14	0	0
20	3001873	.	G	A	16	7	23	0	0	23	0	0
20	3009920	.	T	G	11	8	19	0	1	20	0	0
20	3016311	.	G	A	6	14	20	0	0	20	0	0
20	3017529	.	C	T	1	7	8	0	7	15	0	0
20	3018319	.	T	C	5	0	5	0	16	21	0	0
20	3022582	.	T	A	12	12	24	1	1	26	0	0
20	3026253	.	G	A	6	9	15	0	0	15	0	0
20	3029659	.	A	C	4	8	12	0	1	13	0	0
20	3029662	.	A	G	4	9	13	0	0	13	0	0
20	3050790	.	T	A	5	2	7	0	0	7	0	0
20	3050877	.	T	C	6	0	6	0	12	18	0	0
20	3061079	.	C	G	4	6	10	0	1	11	0	0
20	3077301	.	G	A	2	3	5	0	0	5	0	0
20	3086570	.	G	C	6	3	9	0	0	9	0	0
20	3086662	.	A	G	3	3	6	0	2	8	0	0
20	3087029	.	T	C	4	0	4	0	10	14	0	0
20	3115284	.	C	T	5	2	7	0	0	7	0	0
20	3117860	.	C	T	13	5	18	0	0	18	0	0
20	3117881	.	G	T	11	3	14	0	0	14	0	0
20	3118148	.	G	A	4	4	8	0	1	9	0	0
20	3118502	.	T	G	6	0	6	0	3	9	0	0
20	3118513	.	T	C	6	3	9	0	0	9	0	0
20	3118639	.	G	A	3	2	5	0	1	6	0	0
20	3118649	.	T	C	4	3	7	0	0	7	0	0
20	3120293	.	A	G	3	8	11	0	0	11	0	0
20	3120317	.	T	A	4	6	10	0	0	10	0	0
20	3121027	.	A	C	9	5	14	0	0	14	0	0
20	3121179	.	A	G	5	6	11	0	2	13	0	0
20	3121475	.	T	C	8	3	11	0	1	12	0	0
20	3121539	.	T	A	5	2	7	0	1	8	0	0
20	3121865	.	T	A	9	6	15	0	2	17	0	0
20	3121947	.	G	A	9	6	15	0	0	15	0	0
20	3122091	.	C	T	3	6	9	0	0	9	0	0
20	3122251	.	G	A	9	9	18	0	1	19	0	0
20	3129754	.	C	G	4	8	12	0	0	12	0	0
20	3130347	.	C	A	3	3	6	0	0	6	0	0
20	3130758	.	A	G	3	4	7	0	0	7	0	0
20	3146529	.	T	C	3	0	3	0	4	7	0	0
20	3151308	.	A	G	2	2	4	0	0	4	0	0
20	3151644	.	G	T	1	3	4	0	0	4	0	0
20	3219694	.	T	A	2	2	4	0	0	4	0	0
20	3239094	.	T	G	2	8	10	0	0	10	0	0
20	3239205	.	C	G	1	3	4	0	4	8	0	0
20	3239324	.	C	T	0	8	8	1	7	16	0	0
20	3239383	.	A	T	8	10	18	0	0	18	0	0
20	3242733	.	G	A	13	11	24	0	2	26	0	0
20	3242944	.	A	G	8	10	18	0	1	19	0	0
20	3248778	.	C	A	7	12	19	0	0	19	0	0
20	3248817	.	T	C	6	0	6	0	9	15	0	0
20	3248880	.	T	C	9	0	9	0	10	19	0	0
20	3248883	.	G	C	8	9	17	0	1	18	0	0
20	3249029	.	G	A	20	13	33	0	1	34	0	0
20	3249060	.	A	T	16	16	32	0	1	33	0	0
20	3249445	.	G	A	4	6	10	0	2	12	0	0
20	3249513	.	G	T	10	3	13	0	2	15	0	0
20	3249600	.	C	A	0	6	6	0	15	21	0	0
20	3249725	.	C	T	7	9	16	0	1	17	0	0
20	3249870	.	C	T	8	6	14	0	0	14	0	0
20	3249872	.	G	A	8	6	14	0	0	14	0	0
20	3254364	.	A	T	4	12	16	0	0	16	0	0
20	3264851	.	G	T	5	6	11	0	1	12	0	0
20	3280817	.	A	G	3	0	3	0	2	5	0	0
20	3282039	.	G	T	4	2	6	0	0	6	0	0
20	3286355	.	G	A	4	2	6	0	0	6	0	0
20	3292722	.	A	G	12	16	28	0	0	28	0	0
20	3294838	.	G	T	8	8	16	0	2	18	0	0
20	3916456	.	T	A	9	6	15	0	1	16	0	0
20	3916464	.	C	T	10	9	19	0	0	19	0	0
20	3916621	.	T	G	12	12	24	0	0	24	0	0
20	3920746	.	T	G	8	9	17	0	0	17	0	0
20	3920873	.	T	A	13	15	28	0	0	28	0	0
20	3920875	.	G	A	12	14	26	0	1	27	0	0
20	3921127	.	A	T	17	7	24	0	0	24	0	0
20	3921184	.	G	A	13	5	18	0	0	18	0	0
20	3921202	.	T	C	14	8	22	0	0	22	0	0
20	3923735	.	C	G	4	10	14	0	0	14	0	0
20	3923983	.	G	A	0	6	6	0	11	17	0	0
20	3924098	.	A	T	14	15	29	0	2	31	0	0
20	3924349	.	G	A	9	11	20	0	0	20	0	0
20	3924430	.	G	A	0	8	8	0	8	16	0	0
20	3924528	.	C	A	5	11	16	0	0	16	0	0
20	3924824	.	A	C	5	4	9	0	2	11	0	0
20	3924943	.	T	G	9	0	9	0	7	16	0	0
20	3925146	.	A	T	5	10	15	0	1	16	0	0
20	3925260	.	T	G	12	0	12	0	5	17	0	0
20	3925261	.	A	G	13	4	17	0	1	18	0	0
20	3925537	.	T	C	15	7	22	0	1	23	0	0
20	3925544	.	T	A	13	14	27	0	1	29	1	0
20	3925842	.	C	A	14	6	20	0	0	20	0	0
20	3925889	.	C	T	12	11	23	4	0	27	0	0
20	3925907	.	T	A	8	7	15	4	1	20	0	0
20	3925934	.	C	T	2	2	4	4	0	8	0	0
20	3925942	.	A	G	4	4	8	2	0	10	0	0
20	3926020	.	C	T	15	5	20	0	0	20	0	0
20	3926337	.	C	T	4	5	9	1	0	10	0	0
20	3926721	.	T	C	15	6	21	0	0	21	0	0
20	3926736	.	T	A	16	6	22	0	0	22	0	0
20	3926907	.	T	G	16	16	32	0	2	34	0	0
20	3926928	.	T	A	18	13	31	0	0	31	0	0
20	3926951	.	A	G	22	11	33	0	1	34	0	0
20	3927267	.	C	A	22	12	34	0	3	37	0	0
20	3927326	.	A	G	10	16	26	0	1	27	0	0
20	3927446	.	C	G	13	8	21	0	1	22	0	0
20	3947006	.	T	G	2	2	4	0	0	4	0	0
20	3947058	.	C	A	3	2	5	0	0	5	0	0
20	3947100	.	C	T	7	5	12	0	1	13	0	0
20	3947116	.	A	G	0	12	12	0	0	12	0	0
20	3953593	.	T	C	9	8	17	0	0	17	0	0
20	3954813	.	G	C	4	4	8	0	0	8	0	0
20	3954846	.	A	T	1	7	8	0	0	8	0	0
20	3954870	.	C	T	1	7	8	0	0	8	0	0
20	3971246	.	G	C	6	3	9	0	0	9	0	0
20	3985248	.	G	A	3	4	7	0	1	8	0	0
20	3991392	.	G	A	3	2	5	0	0	5	0	0
20	3991416	.	A	G	2	4	6	0	0	6	0	0
20	3994351	.	T	G	3	3	6	0	0	6	0	0
20	4010256	.	T	C	5	5	10	0	1	11	0	0
20	4010462	.	C	T	5	10	15	0	0	15	0	0
20	4011135	.	G	A	1	3	4	0	0	4	0	0
20	4011161	.	C	T	1	3	4	0	0	4	0	0
20	4030825	.	G	A	6	4	10	0	0	10	0	0
20	4035697	.	A	G	1	2	3	0	0	3	0	0
20	4035837	.	G	A	5	5	10	0	0	10	0	0
20	4035858	.	G	C	6	7	13	0	0	13	0	0
20	4036272	.	G	T	1	5	6	0	0	6	0	0
20	4036375	.	A	G	2	2	4	0	0	4	0	0
20	4036378	.	G	A	2	2	4	0	0	4	0	0
20	4036462	.	A	G	2	4	6	0	0	6	0	0
20	4036720	.	T	C	1	5	6	0	0	6	0	0
20	4036795	.	T	C	2	2	4	0	1	5	0	0
20	4036997	.	T	C	4	2	6	0	0	6	0	0
20	4037057	.	G	A	3	2	5	0	0	5	0	0
20	4037409	.	T	A	6	2	8	0	1	9	0	0
20	4037500	.	C	T	2	2	4	0	0	4	0	0
20	4037708	.	C	T	0	3	3	0	1	4	0	0
20	4037942	.	C	T	6	3	9	0	0	9	0	0
20	4043508	.	C	G	5	7	12	0	0	12	0	0
20	4051818	.	C	T	9	10	19	0	0	19	0	0
20	4052313	.	T	C	2	3	5	0	0	5	0	0
20	4053012	.	G	A	0	6	6	0	6	12	0	0
20	4091851	.	G	A	3	2	5	0	0	5	0	0
20	4124294	.	T	C	2	3	5	0	0	5	0	0
20	4153436	.	A	G	3	4	7	0	0	7	0	0
20	4157066	.	A	C	6	2	8	0	0	8	0	0
20	4162706	.	G	A	2	2	4	0	0	4	0	0
20	4170812	.	T	C	1	2	3	0	0	3	0	0
20	4175807	.	T	A	6	4	10	0	0	10	0	0
20	4176863	.	G	A	0	6	6	0	3	9	0	0
20	4177035	.	G	A	2	3	5	0	0	5	0	0
20	4177168	.	A	T	5	3	8	0	0	8	0	0
20	4841389	.	A	C	2	0	2	0	7	9	0	0
20	4857472	.	G	A	3	2	5	0	1	6	0	0
20	4887996	.	G	T	2	12	14	0	1	15	0	0
20	4888004	.	A	G	3	12	15	0	1	16	0	0
20	4888037	.	T	C	3	9	12	0	1	13	0	0
20	4896120	.	G	T	7	9	16	0	0	16	0	0
20	4896201	.	G	A	4	10	14	0	1	15	0	0
20	4896240	.	A	C	4	6	10	0	0	10	0	0
20	4898036	.	C	T	1	3	4	0	0	4	0	0
20	4898126	.	A	G	2	3	5	0	0	5	0	0
20	4898160	.	T	A	1	4	5	0	0	5	0	0
20	4898563	.	A	T	14	8	22	0	2	24	0	0
20	4898683	.	C	T	19	13	32	0	0	32	0	0
20	4898776	.	C	T	24	16	40	0	3	43	0	0
20	4898784	.	T	C	18	17	35	0	2	37	0	0
20	4899342	.	T	G	14	16	30	0	2	32	0	0
20	4899935	.	A	T	11	13	24	0	2	26	0	0
20	4900600	.	G	A	13	5	18	0	1	19	0	0
20	4900609	.	T	C	13	0	13	0	8	21	0	0
20	4900697	.	T	C	12	13	25	0	1	26	0	0
20	4900855	.	C	T	14	6	20	0	0	20	0	0
20	4903334	.	G	C	9	9	18	0	0	18	0	0
20	4903456	.	A	G	10	6	16	0	0	16	0	0
20	4910953	.	G	A	6	4	10	0	1	11	0	0
20	4934016	.	T	C	9	0	9	0	7	16	0	0
20	4938844	.	A	G	6	8	14	0	0	14	0	0
20	4947249	.	T	G	5	4	9	0	0	9	0	0
20	4956918	.	C	T	5	4	9	0	1	10	0	0
20	4957041	.	T	A	8	5	13	0	0	13	0	0
20	5003079	.	A	G	11	8	19	0	1	20	0	0
20	5051320	.	A	G	3	6	9	0	1	10	0	0
20	5069389	.	G	A	9	5	14	0	0	14	0	0
20	5069500	.	T	C	4	3	7	0	1	8	0	0
20	5069565	.	G	A	5	2	7	0	0	7	0	0
20	5074193	.	G	A	4	2	6	3	0	9	0	0
20	5089011	.	C	T	5	3	8	0	0	8	0	0
20	5089150	.	C	A	2	5	7	0	0	7	0	0
20	5090938	.	G	A	0	5	5	0	6	11	0	0
20	5093872	.	A	T	3	4	7	0	0	7	0	0
20	5094205	.	A	C	4	3	7	0	0	7	0	0
20	5094207	.	G	A	1	3	4	0	3	7	0	0
20	5139350	.	C	T	2	3	5	0	0	5	0	0
20	6647928	.	A	C	1	2	3	0	1	4	0	0
20	6652278	.	A	T	5	5	10	0	1	11	0	0
20	6666099	.	T	G	4	4	8	0	0	8	0	0
20	6666224	.	G	C	5	3	8	0	0	8	0	0
20	6666603	.	G	A	0	4	4	0	1	5	0	0
20	6791151	.	G	C	7	9	16	0	0	16	0	0
20	6802879	.	A	G	3	2	5	0	0	5	0	0
20	6803105	.	A	T	4	8	12	0	0	12	0	0
20	6803170	.	G	T	7	5	12	0	0	12	0	0
20	6803213	.	T	G	8	5	13	0	2	15	0	0
20	6895083	.	G	T	5	7	12	0	2	14	0	0
20	6895120	.	T	A	7	10	17	0	3	21	1	0
20	6895192	.	C	G	4	5	9	0	0	9	0	0
20	6903803	.	C	T	3	3	6	0	0	6	0	0
20	6903805	.	C	T	3	3	6	0	0	6	0	0
20	6936427	.	T	A	5	4	9	0	0	9	0	0
20	6945055	.	G	C	5	5	10	0	0	10	0	0
20	6962650	.	G	A	6	3	9	0	0	9	0	0
20	6962701	.	G	A	2	6	8	0	1	9	0	0
20	6999419	.	G	A	1	3	4	0	0	4	0	0
20	7449851	.	C	T	6	5	11	0	0	11	0	0
20	7459071	.	T	G	3	3	6	0	0	6	0	0
20	7464122	.	G	T	4	2	6	0	0	6	0	0
20	7464125	.	T	G	4	3	7	0	0	7	0	0
20	7464337	.	G	A	2	3	5	0	2	7	0	0
20	7469280	.	G	A	3	4	7	0	0	7	0	0
20	7471488	.	G	A	4	2	6	0	0	6	0	0
20	7471491	.	C	A	4	2	6	0	0	6	0	0
20	7480286	.	T	C	1	0	1	0	2	3	0	0
20	7486930	.	C	T	0	2	2	0	3	5	0	0
20	7490278	.	T	C	1	0	1	0	2	3	0	0
20	7513629	.	C	G	1	3	4	0	0	4	0	0
20	7524671	.	A	G	1	2	3	0	0	3	0	0
20	7535117	.	T	G	3	3	6	0	0	6	0	0
20	7582816	.	A	G	4	7	11	0	0	11	0	0
20	7582925	.	G	A	4	2	6	0	1	7	0	0
20	7588957	.	A	G	12	0	12	0	10	22	0	0
20	7965965	.	G	A	6	9	15	0	0	15	0	0
20	7966006	.	A	T	8	7	15	0	0	15	0	0
20	7966049	.	T	G	7	12	19	0	0	19	0	0
20	7966090	.	T	G	8	11	19	0	0	19	0	0
20	7966127	.	G	A	7	6	13	0	0	13	0	0
20	7966135	.	A	C	5	8	13	0	0	13	0	0
20	7966227	.	A	G	5	6	11	0	1	12	0	0
20	7966419	.	G	C	1	8	9	0	2	11	0	0
20	7966555	.	C	G	7	8	15	0	0	15	0	0
20	7966808	.	A	C	5	3	8	0	2	10	0	0
20	7966938	.	G	A	5	9	14	0	0	14	0	0
20	7967128	.	C	T	1	6	7	0	5	12	0	0
20	7967251	.	C	T	8	5	13	0	0	13	0	0
20	7967305	.	A	G	4	7	11	0	0	11	0	0
20	7967344	.	A	G	2	6	8	0	0	8	0	0
20	7986791	.	A	T	2	5	7	0	0	7	0	0
20	8050591	.	T	C	1	2	3	0	0	3	0	0
20	8055224	.	C	G	1	3	4	0	0	4	0	0
20	8055681	.	G	C	1	4	5	0	0	5	0	0
20	8060310	.	G	A	4	2	6	0	0	6	0	0
20	8061637	.	G	A	0	2	2	0	4	6	0	0
20	8066300	.	G	A	6	2	8	0	0	8	0	0
20	8066329	.	T	A	2	3	5	0	0	5	0	0
20	8067104	.	C	T	1	2	3	0	0	3	0	0
20	8122938	.	T	A	6	8	14	0	0	14	0	0
20	8138389	.	C	G	12	7	19	0	0	19	0	0
20	8154139	.	G	A	11	7	18	0	1	19	0	0
20	8154169	.	A	G	10	6	16	0	0	16	0	0
20	8154178	.	G	A	6	8	14	0	1	15	0	0
20	8163955	.	C	T	8	10	18	0	0	18	0	0
20	8189652	.	C	G	1	8	9	0	9	18	0	0
20	8193390	.	T	A	3	9	12	0	1	13	0	0
20	8196380	.	G	A	5	3	8	0	0	8	0	0
20	8245716	.	G	A	3	8	11	0	0	11	0	0
20	9059212	.	A	G	1	3	4	0	0	4	0	0
20	9059231	.	C	T	1	2	3	0	0	3	0	0
20	9075361	.	A	T	2	2	4	0	0	4	0	0
20	9096963	.	T	A	3	2	5	0	1	6	0	0
20	9109195	.	T	C	3	6	9	0	0	9	0	0
20	9113150	.	G	T	3	2	5	0	0	5	0	0
20	9115127	.	A	T	1	3	4	0	0	4	0	0
20	9115146	.	A	G	2	3	5	0	0	5	0	0
20	9115200	.	C	A	2	3	5	0	0	5	0	0
20	9115393	.	G	A	3	2	5	0	0	5	0	0
20	9124503	.	A	T	8	4	12	0	0	12	0	0
20	9124759	.	C	T	5	3	8	0	0	8	0	0
20	9124996	.	A	G	2	0	2	0	2	4	0	0
20	9125264	.	G	A	1	3	4	0	1	5	0	0
20	9125291	.	T	A	1	2	3	0	0	3	0	0
20	9133127	.	T	G	5	5	10	0	0	10	0	0
20	9148121	.	G	C	9	6	15	0	2	17	0	0
20	9183337	.	T	C	11	0	11	0	11	22	0	0
20	9184696	.	T	C	4	3	7	0	0	7	0	0
20	9184928	.	C	A	7	8	15	0	0	15	0	0
20	9186281	.	T	C	11	0	11	0	14	25	0	0
20	9186310	.	T	C	9	6	15	0	3	18	0	0
20	9190697	.	G	T	6	4	10	0	1	11	0	0
20	9190723	.	A	T	8	3	11	0	0	11	0	0
20	9190767	.	T	C	8	9	17	0	1	18	0	0
20	9190768	.	T	C	9	9	18	0	0	18	0	0
20	9190823	.	T	G	5	0	5	0	19	24	0	0
20	9190829	.	T	G	3	3	6	0	16	22	0	0
20	9190991	.	A	G	7	12	19	0	1	20	0	0
20	9191144	.	G	A	5	7	12	0	0	12	0	0
20	9191255	.	T	C	5	0	5	0	12	17	0	0
20	9191267	.	T	A	3	10	13	0	3	16	0	0
20	9191461	.	C	T	14	13	27	0	0	27	0	0
20	9192444	.	C	T	7	7	14	0	0	14	0	0
20	9192463	.	C	T	6	6	12	0	0	12	0	0
20	9193285	.	C	T	4	9	13	0	1	14	0	0
20	9193359	.	C	T	2	3	5	0	1	6	0	0
20	9193818	.	T	A	8	9	17	0	0	17	0	0
20	9194069	.	A	T	2	5	7	0	1	8	0	0
20	9199500	.	C	T	10	5	15	0	0	15	0	0
20	9211591	.	T	C	1	2	3	0	0	3	0	0
20	9216203	.	T	C	1	3	4	0	0	4	0	0
20	9216639	.	A	G	2	4	6	0	0	6	0	0
20	9242422	.	G	C	5	7	12	0	2	14	0	0
20	9246461	.	C	A	4	3	7	0	1	8	0	0
20	9248376	.	T	A	2	2	4	0	0	4	0	0
20	9248446	.	G	A	2	2	4	0	0	4	0	0
20	9248482	.	T	C	3	0	3	0	3	6	0	0
20	9248494	.	T	C	3	0	3	0	4	7	0	0
20	9248524	.	T	C	5	6	11	0	0	11	0	0
20	9248635	.	C	T	0	4	4	0	3	7	0	0
20	9248692	.	G	A	3	4	7	0	2	9	0	0
20	9249901	.	A	G	6	7	13	0	0	13	0	0
20	9355967	.	C	T	16	20	36	0	0	36	0	0
20	9412642	.	C	T	20	14	34	0	1	35	0	0
20	9418744	.	A	G	19	12	31	0	1	32	0	0
20	9418804	.	T	C	17	12	29	0	0	29	0	0
20	9419014	.	A	T	18	13	31	0	0	31	0	0
20	9419218	.	G	A	12	21	33	0	0	33	0	0
20	9419314	.	C	T	17	12	29	0	2	31	0	0
20	9419575	.	C	T	16	16	32	0	3	35	0	0
20	9419716	.	T	C	19	15	34	0	3	37	0	0
20	9419842	.	C	T	14	10	24	0	1	25	0	0
20	9419896	.	C	T	19	12	31	0	2	33	0	0
20	9420018	.	C	T	17	13	30	0	3	33	0	0
20	9420168	.	T	C	13	9	22	0	1	23	0	0
20	9420974	.	A	T	30	6	36	1	3	40	0	0
20	9420976	.	C	T	31	7	38	1	1	40	0	0
20	9421011	.	A	G	21	1	22	0	21	43	0	0
20	9421563	.	G	A	3	3	6	0	1	7	0	0
20	9421672	.	C	T	0	11	11	0	6	17	0	0
20	9421690	.	G	T	10	6	16	0	0	16	0	0
20	9421732	.	T	A	9	10	19	0	1	20	0	0
20	9421781	.	T	C	11	0	11	0	6	17	0	0
20	9422045	.	G	A	12	7	19	0	1	20	0	0
20	9422536	.	G	A	10	11	21	0	1	22	0	0
20	9422566	.	G	A	13	11	24	0	2	26	0	0
20	9427737	.	G	T	8	8	16	0	1	17	0	0
20	9429315	.	G	T	18	11	29	6	0	35	0	0
20	9429363	.	G	A	19	16	35	2	0	37	0	0
20	9429370	.	C	T	18	17	35	0	1	36	0	0
20	9429414	.	T	C	26	2	28	0	18	46	0	0
20	9429648	.	A	G	33	28	61	0	0	61	0	0
20	9436314	.	A	T	13	22	35	0	1	36	0	0
20	9436363	.	A	G	16	25	41	0	1	42	0	0
20	9462312	.	T	A	17	17	34	0	2	36	0	0
20	9462412	.	G	T	14	14	28	0	0	28	0	0
20	9566423	.	G	A	0	3	3	0	1	4	0	0
20	9575868	.	T	C	8	0	8	0	10	18	0	0
20	9576710	.	C	G	1	7	8	0	6	14	0	0
20	9577157	.	G	A	5	10	15	0	1	16	0	0
20	9577250	.	A	G	3	11	14	0	0	14	0	0
20	9577487	.	G	A	7	13	20	0	0	20	0	0
20	9577769	.	A	G	5	6	11	0	1	12	0	0
20	9578089	.	C	T	7	2	9	0	0	9	0	0
20	9578090	.	C	T	7	2	9	0	0	9	0	0
20	9578173	.	A	T	5	3	8	0	5	13	0	0
20	9764211	.	T	C	9	15	24	0	0	24	0	0
20	9766973	.	G	A	16	9	25	0	0	25	0	0
20	9768191	.	C	T	15	10	25	0	0	25	0	0
20	9768230	.	C	T	11	13	24	0	3	27	0	0
20	9768330	.	A	G	15	12	27	0	1	28	0	0
20	9775889	.	A	G	15	18	33	0	4	37	0	0
20	9775934	.	T	C	21	17	38	0	2	40	0	0
20	9776270	.	G	A	13	7	20	0	1	21	0	0
20	9776579	.	T	C	1	4	5	0	0	5	0	0
20	9776770	.	A	G	4	3	7	0	0	7	0	0
20	9777182	.	C	T	2	5	7	0	0	7	0	0
20	9777200	.	G	A	2	5	7	0	0	7	0	0
20	9777447	.	G	A	1	3	4	0	0	4	0	0
20	9779200	.	T	A	2	2	4	0	0	4	0	0
20	9779236	.	T	G	2	2	4	0	0	4	0	0
20	9782147	.	T	G	7	1	8	0	11	19	0	0
20	9782747	.	C	A	9	9	18	0	2	20	0	0
20	9782913	.	T	C	9	14	23	0	0	23	0	0
20	9782990	.	T	C	7	9	16	0	1	17	0	0
20	9783071	.	T	C	7	7	14	0	1	15	0	0
20	9783086	.	A	G	6	8	14	0	1	15	0	0
20	9820430	.	T	C	9	15	24	0	0	24	0	0
20	9830642	.	T	C	29	31	60	0	7	67	0	0
20	9830684	.	G	T	31	32	63	0	4	67	0	0
20	9831443	.	G	A	40	26	66	0	4	70	0	0
20	9831703	.	T	A	40	25	65	0	3	68	0	0
20	9837556	.	T	C	44	24	68	0	6	74	0	0
20	9837587	.	G	A	40	30	70	0	1	71	0	0
20	9837593	.	T	C	32	28	60	0	5	65	0	0
20	9846751	.	A	G	37	38	75	1	4	80	0	0
20	9846989	.	T	C	34	34	68	0	4	72	0	0
20	9846997	.	A	T	32	37	69	0	2	72	1	0
20	9847078	.	T	C	35	35	70	0	2	72	0	0
20	9847252	.	G	T	22	16	38	0	1	39	0	0
20	9847298	.	T	G	28	9	37	0	1	38	0	0
20	9847304	.	G	A	30	8	38	0	0	38	0	0
20	9847381	.	A	C	27	21	48	0	0	48	0	0
20	9847529	.	A	T	30	24	54	0	0	54	0	0
20	9847772	.	T	C	30	28	58	0	1	59	0	0
20	9847895	.	C	T	27	30	57	0	2	59	0	0
20	9848116	.	C	T	40	22	62	0	1	63	0	0
20	9848181	.	A	T	43	14	57	0	1	58	0	0
20	9848196	.	T	G	42	18	60	0	1	61	0	0
20	9848405	.	G	A	4	2	6	0	0	6	0	0
20	9959377	.	G	A	4	6	10	0	0	10	0	0
20	9959699	.	T	A	6	2	8	0	0	8	0	0
20	9959890	.	G	A	4	7	11	0	0	11	0	0
20	9960378	.	G	A	2	4	6	0	0	6	0	0
20	9960859	.	G	T	5	2	7	0	0	7	0	0
20	9960974	.	C	T	4	2	6	0	0	6	0	0
20	10057817	.	T	A	1	2	3	0	0	3	0	0
20	10057929	.	T	C	4	5	9	0	0	9	0	0
20	10057993	.	C	G	0	4	4	0	6	10	0	0
20	10058109	.	T	A	14	7	21	0	0	21	0	0
20	10058111	.	A	G	14	7	21	0	0	21	0	0
20	10058242	.	T	C	10	11	21	0	0	21	0	0
20	10058350	.	C	T	11	10	21	0	0	21	0	0
20	10058441	.	A	T	8	9	17	0	0	17	0	0
20	10058476	.	T	A	8	13	21	0	0	21	0	0
20	10058796	.	G	A	3	5	8	0	0	8	0	0
20	10058829	.	T	A	5	3	8	0	0	8	0	0
20	10058853	.	C	A	6	5	11	0	0	11	0	0
20	10058897	.	C	T	5	5	10	0	0	10	0	0
20	10058901	.	G	C	3	5	8	0	2	10	0	0
20	10058948	.	T	A	5	5	10	0	1	11	0	0
20	10058993	.	T	C	8	0	8	0	7	15	0	0
20	10059194	.	G	A	6	11	17	0	0	17	0	0
20	10059278	.	A	G	5	8	13	0	1	14	0	0
20	10059815	.	A	G	5	7	12	0	0	12	0	0
20	10060391	.	G	A	6	6	12	0	0	12	0	0
20	10060483	.	A	C	10	9	19	0	1	20	0	0
20	10060586	.	C	T	3	7	10	0	0	10	0	0
20	10060768	.	G	C	4	8	12	0	1	13	0	0
20	10060808	.	T	C	5	9	14	0	1	15	0	0
20	10060859	.	C	A	2	6	8	0	0	8	0	0
20	10061563	.	C	T	2	3	5	0	0	5	0	0
20	10061778	.	T	C	1	5	6	0	1	7	0	0
20	10061837	.	C	T	1	7	8	0	0	8	0	0
20	10061859	.	C	T	3	6	9	0	0	9	0	0
20	10064993	.	A	G	5	4	9	0	0	9	0	0
20	10065033	.	T	A	2	3	5	0	0	5	0	0
20	10099362	.	T	A	5	4	9	0	0	9	0	0
20	10099363	.	C	T	6	4	10	0	0	10	0	0
20	10099521	.	T	G	6	4	10	0	2	12	0	0
20	10099602	.	C	A	5	5	10	0	0	10	0	0
20	10099603	.	C	A	5	5	10	0	0	10	0	0
20	10099816	.	C	T	7	4	11	0	0	12	1	0
20	10116067	.	A	G	9	12	21	0	0	21	0	0
20	10118393	.	A	T	5	10	15	0	1	16	0	0
20	10118691	.	T	C	3	4	7	0	0	7	0	0
20	10204518	.	T	C	6	5	11	0	0	11	0	0
20	10204644	.	A	T	4	5	9	0	0	9	0	0
20	10210328	.	A	G	8	0	8	0	7	15	0	0
20	10210358	.	C	T	6	4	10	0	0	10	0	0
20	10218637	.	T	A	6	5	11	0	1	12	0	0
20	10219336	.	T	G	1	5	6	0	0	6	0	0
20	10219360	.	T	C	4	4	8	0	0	8	0	0
20	10219377	.	T	A	5	2	7	0	0	7	0	0
20	10219467	.	C	A	6	4	10	0	0	10	0	0
20	10219504	.	G	A	0	2	2	0	5	7	0	0
20	10219985	.	A	T	0	4	4	0	1	5	0	0
20	10219988	.	A	G	1	3	4	0	1	5	0	0
20	10220138	.	T	C	7	7	14	0	0	14	0	0
20	10220188	.	A	C	5	5	10	0	0	10	0	0
20	10220213	.	G	A	4	6	10	0	0	10	0	0
20	10220261	.	G	T	5	5	10	0	0	10	0	0
20	10353220	.	G	A	5	4	9	0	0	9	0	0
20	10353222	.	G	A	5	4	9	0	0	9	0	0
20	10353318	.	G	A	3	4	7	0	0	7	0	0
20	10353474	.	A	G	5	10	15	0	0	15	0	0
20	10353528	.	G	A	3	4	7	0	0	7	0	0
20	10353654	.	T	C	5	0	5	0	5	10	0	0
20	10353683	.	C	T	4	6	10	0	0	10	0	0
20	10353718	.	G	T	4	7	11	0	0	11	0	0
20	10353728	.	A	G	5	7	12	0	0	12	0	0
20	10353762	.	T	C	6	12	18	0	1	19	0	0
20	10353797	.	A	G	8	9	17	0	1	18	0	0
20	10353798	.	A	T	8	9	17	0	1	18	0	0
20	10353912	.	G	C	1	8	9	0	0	9	0	0
20	10354329	.	A	G	5	9	14	0	0	14	0	0
20	10354482	.	T	G	5	8	13	0	1	14	0	0
20	10422619	.	A	C	2	12	14	0	0	14	0	0
20	10422658	.	G	T	8	7	15	0	0	15	0	0
20	10489564	.	A	G	2	4	6	0	0	6	0	0
20	11098301	.	T	C	2	3	5	0	4	9	0	0
20	11098547	.	T	A	6	5	11	0	0	11	0	0
20	11098710	.	C	A	3	4	7	0	0	7	0	0
20	11098851	.	G	A	3	6	9	0	0	9	0	0
20	11098859	.	G	A	3	4	7	0	0	7	0	0
20	11098960	.	G	A	1	5	6	0	1	7	0	0
20	11099013	.	G	A	3	3	6	0	2	8	0	0
20	11099064	.	C	T	2	6	8	0	1	9	0	0
20	11099811	.	G	T	5	5	10	0	1	11	0	0
20	11101578	.	T	A	2	5	7	0	0	7	0	0
20	11101584	.	C	T	2	4	6	0	0	6	0	0
20	11102169	.	G	A	2	2	4	0	0	4	0	0
20	11102328	.	C	T	0	4	4	0	5	9	0	0
20	11102805	.	G	A	5	2	7	0	0	7	0	0
20	11103294	.	G	A	1	1	2	0	1	3	0	0
20	11104806	.	G	A	1	1	2	0	1	3	0	0
20	11104994	.	G	A	4	4	8	0	0	8	0	0
20	11105202	.	G	A	2	3	5	0	0	5	0	0
20	11105496	.	G	A	1	2	3	0	0	3	0	0
20	14977165	.	G	A	2	13	15	0	12	27	0	0
20	14983779	.	C	T	8	11	19	0	0	19	0	0
20	14983788	.	C	T	7	11	18	0	0	18	0	0
20	14997711	.	G	C	14	21	35	0	0	35	0	0
20	14997729	.	G	A	14	13	27	0	1	28	0	0
20	14997753	.	T	A	16	18	34	0	1	35	0	0
20	15004153	.	T	C	24	12	36	0	1	37	0	0
20	15004205	.	C	T	24	11	35	0	2	37	0	0
20	15004321	.	C	T	13	20	33	0	1	34	0	0
20	15004334	.	A	C	14	25	39	0	0	39	0	0
20	15004518	.	A	G	15	10	25	0	0	25	0	0
20	15004575	.	C	A	10	14	24	0	1	25	0	0
20	15004611	.	A	C	13	14	27	0	0	27	0	0
20	15004710	.	C	T	15	14	29	0	1	30	0	0
20	15004746	.	T	A	20	6	26	0	1	27	0	0
20	15004751	.	T	G	18	7	25	0	2	27	0	0
20	15004806	.	C	T	15	3	18	0	0	18	0	0
20	15004825	.	A	T	10	2	12	0	0	12	0	0
20	15004862	.	T	C	13	7	20	0	0	20	0	0
20	15004874	.	A	G	13	0	13	0	6	19	0	0
20	15004992	.	A	G	14	5	19	0	1	20	0	0
20	15023488	.	T	C	13	8	21	0	0	21	0	0
20	15026847	.	C	T	1	12	13	0	9	22	0	0
20	15033954	.	A	G	15	4	19	2	0	21	0	0
20	15034192	.	A	G	12	14	26	0	3	29	0	0
20	15039385	.	C	T	0	3	3	0	7	10	0	0
20	15050678	.	G	A	8	6	14	0	0	14	0	0
20	15050753	.	G	T	7	4	11	0	1	12	0	0
20	15051379	.	T	G	4	5	9	0	1	10	0	0
20	15051422	.	C	T	3	3	6	0	1	7	0	0
20	15051770	.	G	A	3	9	12	0	2	14	0	0
20	15051791	.	G	A	4	11	15	0	0	15	0	0
20	15051812	.	T	C	4	10	14	0	1	15	0	0
20	15052294	.	G	T	4	3	7	0	0	7	0	0
20	15054365	.	G	A	5	7	12	0	0	12	0	0
20	15093822	.	G	C	3	2	5	0	0	5	0	0
20	15093847	.	T	C	3	2	5	0	0	5	0	0
20	15093934	.	T	C	1	0	1	0	2	3	0	0
20	15094116	.	G	A	3	4	7	0	0	7	0	0
20	15094133	.	G	C	4	2	6	0	0	6	0	0
20	15094356	.	C	T	0	4	4	1	2	7	0	0
20	15097154	.	C	T	0	3	3	0	1	4	0	0
20	15121566	.	A	G	3	2	5	0	0	5	0	0
20	15121804	.	G	A	3	5	8	0	0	8	0	0
20	15128338	.	G	A	1	2	3	0	0	3	0	0
20	15152346	.	C	A	0	2	2	0	3	5	0	0
20	15152679	.	C	A	1	3	4	0	0	4	0	0
20	15161512	.	C	T	2	3	5	0	1	6	0	0
20	15161519	.	G	A	3	3	6	0	0	6	0	0
20	15161571	.	G	A	5	3	8	0	0	8	0	0
20	15161612	.	T	G	3	4	7	0	0	7	0	0
20	15161630	.	C	T	2	3	5	0	0	5	0	0
20	15171711	.	C	T	14	14	28	0	1	29	0	0
20	15184455	.	C	T	23	21	44	0	2	46	0	0
20	15184458	.	A	G	21	0	21	0	23	44	0	0
20	15184527	.	T	A	17	13	30	0	4	34	0	0
20	15184568	.	T	G	22	14	36	0	0	36	0	0
20	15184611	.	A	T	12	12	24	0	1	25	0	0
20	15184629	.	T	G	11	10	21	0	1	22	0	0
20	15184654	.	C	T	9	10	19	0	0	19	0	0
20	15184671	.	A	G	9	6	15	0	1	16	0	0
20	15184748	.	C	G	2	4	6	0	0	6	0	0
20	15553003	.	C	T	23	11	34	0	1	35	0	0
20	15553159	.	A	G	15	14	29	0	1	30	0	0
20	15553366	.	G	T	22	13	35	0	4	39	0	0
20	15554247	.	A	G	12	15	27	0	2	29	0	0
20	15566235	.	C	T	2	4	6	0	0	6	0	0
20	15857317	.	G	C	11	9	20	0	2	22	0	0
20	15857761	.	T	A	31	9	40	0	1	41	0	0
20	15857805	.	T	A	23	16	39	0	1	40	0	0
20	15857850	.	C	T	19	12	31	0	3	34	0	0
20	15866267	.	A	G	18	12	30	0	0	30	0	0
20	15866414	.	T	C	9	15	24	0	1	25	0	0
20	15876778	.	A	G	14	16	30	0	1	31	0	0
20	15876812	.	G	A	20	16	36	0	1	37	0	0
20	15876824	.	C	A	1	16	17	0	14	31	0	0
20	15912192	.	C	T	0	9	9	0	7	16	0	0
20	15912906	.	T	C	9	9	18	1	0	19	0	0
20	15933068	.	C	T	0	2	2	0	1	3	0	0
20	15933168	.	G	C	4	7	11	0	0	11	0	0
20	15933223	.	C	A	7	9	16	0	1	17	0	0
20	15933229	.	T	C	7	10	17	0	1	18	0	0
20	15933258	.	C	T	11	12	23	0	0	23	0	0
20	15933289	.	G	A	7	17	24	0	0	24	0	0
20	15933419	.	G	A	10	10	20	0	1	21	0	0
20	15933424	.	T	C	10	9	19	0	2	21	0	0
20	15933489	.	T	C	12	0	12	0	7	19	0	0
20	15933553	.	G	A	6	5	11	0	0	11	0	0
20	15933566	.	G	A	7	6	13	0	0	13	0	0
20	15933852	.	C	T	11	8	19	0	1	20	0	0
20	15933961	.	C	T	1	2	3	0	2	5	0	0
20	15934395	.	G	T	3	8	11	0	0	11	0	0
20	15934519	.	A	G	8	6	14	0	0	14	0	0
20	15934526	.	G	T	8	5	13	0	0	13	0	0
20	15934639	.	G	C	4	6	10	0	0	10	0	0
20	15934848	.	G	A	2	3	5	0	0	5	0	0
20	15935109	.	A	T	2	5	7	0	0	7	0	0
20	15935141	.	T	G	2	3	5	0	0	5	0	0
20	15935146	.	A	C	2	2	4	0	0	4	0	0
20	15935185	.	G	A	3	3	6	0	1	7	0	0
20	15935222	.	G	T	3	2	5	0	1	6	0	0
20	15937029	.	A	T	5	6	11	0	1	12	0	0
20	15937278	.	C	G	3	4	7	0	0	7	0	0
20	15937351	.	G	A	2	2	4	0	0	4	0	0
20	15937613	.	G	A	6	5	11	1	0	12	0	0
20	15937648	.	A	T	13	2	15	2	0	17	0	0
20	15937709	.	G	A	6	3	9	1	0	10	0	0
20	15937833	.	G	T	3	6	9	0	1	10	0	0
20	15937926	.	C	A	11	4	15	0	1	16	0	0
20	15943257	.	G	T	2	3	5	0	0	5	0	0
20	15943281	.	G	A	4	4	8	0	1	9	0	0
20	15947218	.	T	C	4	2	6	0	0	6	0	0
20	15947225	.	A	G	2	2	4	0	1	5	0	0
20	15970177	.	C	T	8	6	14	0	0	14	0	0
20	15974445	.	G	A	3	6	9	0	0	9	0	0
20	16156306	.	T	C	4	0	4	0	3	7	0	0
20	16156347	.	A	G	4	3	7	0	0	7	0	0
20	16163282	.	C	T	5	3	8	0	1	9	0	0
20	16163333	.	T	C	10	1	11	0	9	20	0	0
20	16163348	.	T	C	10	9	19	0	3	22	0	0
20	16163384	.	A	G	14	17	31	0	0	31	0	0
20	16163447	.	T	C	8	0	8	0	15	23	0	0
20	16163552	.	G	A	6	8	14	0	1	15	0	0
20	16171155	.	T	C	5	0	5	0	4	9	0	0
20	16171203	.	A	T	7	3	10	0	0	10	0	0
20	16180064	.	C	A	9	12	21	0	0	21	0	0
20	16180103	.	G	T	10	5	15	0	1	16	0	0
20	16180469	.	G	A	3	7	10	0	1	11	0	0
20	16182806	.	C	T	9	3	12	0	0	12	0	0
20	16184525	.	C	T	6	5	11	0	1	12	0	0
20	16193658	.	T	C	10	8	18	0	0	18	0	0
20	16193899	.	C	T	7	14	21	0	2	23	0	0
20	16198986	.	G	A	1	10	11	0	18	29	0	0
20	16201015	.	C	A	11	10	21	1	4	26	0	0
20	16201017	.	C	T	13	10	23	1	3	27	0	0
20	16201109	.	T	A	9	8	17	0	0	17	0	0
20	16201111	.	G	A	1	8	9	1	8	18	0	0
20	16201200	.	C	T	13	10	23	0	1	25	1	0
20	16201649	.	A	C	5	13	18	0	1	19	0	0
20	16201709	.	A	G	7	5	12	0	1	13	0	0
20	16201759	.	T	C	7	6	13	0	0	13	0	0
20	16437895	.	A	G	6	2	8	0	0	8	0	0
20	16437958	.	A	G	5	4	9	0	0	9	0	0
20	16438097	.	G	A	14	6	20	0	1	21	0	0
20	16438119	.	T	A	12	7	19	0	1	20	0	0
20	16438252	.	G	A	11	9	20	0	1	21	0	0
20	16438258	.	A	T	11	11	22	0	0	22	0	0
20	16438658	.	A	T	6	9	15	0	0	15	0	0
20	16438854	.	T	C	5	12	17	0	1	18	0	0
20	16441658	.	C	T	9	19	28	0	0	28	0	0
20	16443740	.	C	T	18	10	28	0	1	29	0	0
20	16447831	.	A	G	7	6	13	0	0	13	0	0
20	16448930	.	T	C	7	7	14	0	1	15	0	0
20	16478324	.	G	A	3	5	8	0	0	8	0	0
20	16498623	.	A	G	1	11	12	0	1	13	0	0
20	16498881	.	C	T	1	2	3	0	4	7	0	0
20	16498932	.	C	A	1	4	5	0	0	5	0	0
20	16548833	.	C	T	1	4	5	0	4	9	0	0
20	16640011	.	G	A	3	3	6	0	0	6	0	0
20	16640049	.	C	T	10	8	18	0	3	21	0	0
20	16734343	.	C	T	15	14	29	0	2	31	0	0
20	16736960	.	G	A	11	18	29	0	0	29	0	0
20	16737485	.	C	T	11	19	30	0	0	30	0	0
20	16737512	.	C	T	20	15	35	0	2	37	0	0
20	16737524	.	T	C	18	22	40	0	1	41	0	0
20	16740834	.	G	A	12	12	24	0	1	26	1	0
20	16774513	.	A	T	31	33	64	0	3	67	0	0
20	16774868	.	A	G	30	22	52	2	6	60	0	0
20	16775173	.	C	T	23	20	43	0	2	45	0	0
20	16833019	.	C	T	0	8	8	0	7	15	0	0
20	16833089	.	A	G	7	11	18	0	0	18	0	0
20	16833096	.	A	G	7	9	16	0	0	16	0	0
20	16833125	.	C	T	8	6	14	0	0	14	0	0
20	16833213	.	G	C	3	3	6	0	0	6	0	0
20	16833284	.	A	T	6	6	12	0	3	15	0	0
20	16833560	.	T	C	4	6	10	0	1	11	0	0
20	16833654	.	A	T	1	3	4	1	0	5	0	0
20	16833671	.	C	A	3	0	3	1	0	4	0	0
20	16833806	.	C	A	3	9	12	0	1	13	0	0
20	16833893	.	A	G	4	3	7	0	1	8	0	0
20	16834096	.	T	C	2	8	10	0	0	10	0	0
20	16834307	.	C	A	2	7	9	0	2	11	0	0
20	16834525	.	A	G	5	7	12	0	1	13	0	0
20	16834572	.	C	T	0	7	7	0	7	14	0	0
20	16834647	.	T	C	7	3	10	0	0	10	0	0
20	16848908	.	C	T	6	7	13	0	1	14	0	0
20	16849100	.	C	A	0	6	6	0	9	15	0	0
20	16883554	.	T	C	4	4	8	0	0	8	0	0
20	16883694	.	C	G	6	0	6	0	3	9	0	0
20	16884078	.	C	T	2	7	9	0	0	9	0	0
20	16884434	.	C	T	8	7	15	0	1	16	0	0
20	17740215	.	G	A	17	11	28	0	1	29	0	0
20	17740260	.	G	C	2	7	9	0	14	23	0	0
20	17740261	.	T	C	16	7	23	0	0	23	0	0
20	17798876	.	C	T	17	12	29	0	0	29	0	0
20	17798906	.	T	C	12	13	25	0	0	25	0	0
20	17798930	.	C	T	14	13	27	0	0	27	0	0
20	17800867	.	T	C	13	25	38	0	1	39	0	0
20	17802979	.	C	T	14	19	33	0	3	36	0	0
20	17809123	.	G	A	28	18	46	0	2	48	0	0
20	17809177	.	C	T	20	24	44	0	2	46	0	0
20	17811587	.	G	A	24	26	50	0	1	51	0	0
20	17813702	.	C	T	30	26	56	1	0	57	0	0
20	17817659	.	G	T	22	14	36	0	1	37	0	0
20	17817886	.	T	A	17	16	33	0	2	35	0	0
20	17818159	.	A	T	2	15	17	2	0	19	0	0
20	17818177	.	A	C	7	9	16	2	5	23	0	0
20	17818291	.	T	C	16	12	28	0	8	36	0	0
20	17818445	.	T	A	16	13	29	0	1	30	0	0
20	18225441	.	C	A	12	8	20	0	0	20	0	0
20	18255474	.	A	G	12	0	12	0	20	32	0	0
20	18255810	.	T	C	9	19	28	0	0	28	0	0
20	18255931	.	A	T	15	9	24	0	2	26	0	0
20	18256068	.	C	T	2	3	5	0	0	5	0	0
20	18256176	.	T	A	7	2	9	0	0	9	0	0
20	18306290	.	T	A	12	12	24	0	0	24	0	0
20	18306298	.	T	G	16	10	26	0	1	27	0	0
20	18307075	.	T	C	21	0	21	0	17	38	0	0
20	18309277	.	C	T	16	20	36	0	3	39	0	0
20	18312803	.	T	C	23	20	43	0	2	45	0	0
20	18312839	.	T	C	25	16	41	0	2	43	0	0
20	18325656	.	C	T	1	2	3	0	0	3	0	0
20	18329469	.	C	T	2	3	5	0	0	5	0	0
20	18357820	.	T	C	6	7	13	0	2	15	0	0
20	18358002	.	T	C	5	6	11	0	1	12	0	0
20	18369979	.	G	A	7	4	11	0	1	12	0	0
20	18373014	.	T	G	4	5	9	0	0	9	0	0
20	18375278	.	G	A	3	3	6	0	0	6	0	0
20	18376291	.	T	C	4	2	6	0	0	6	0	0
20	18376800	.	C	T	4	5	9	0	3	12	0	0
20	18392845	.	C	T	20	25	45	0	0	45	0	0
20	18393249	.	T	C	12	14	26	0	1	27	0	0
20	18393359	.	A	T	15	13	28	0	1	29	0	0
20	18393376	.	C	T	14	14	28	0	4	32	0	0
20	18396134	.	A	G	17	13	30	0	1	31	0	0
20	18413987	.	T	C	8	0	8	0	12	20	0	0
20	18414262	.	C	T	11	8	19	0	1	20	0	0
20	18431770	.	T	C	6	1	7	0	12	19	0	0
20	18432732	.	C	T	8	11	19	0	2	21	0	0
20	18443435	.	G	A	9	6	15	0	0	15	0	0
20	18454644	.	G	A	6	6	12	0	1	13	0	0
20	18456519	.	C	A	6	8	14	0	0	14	0	0
20	18591638	.	G	T	19	28	47	3	3	53	0	0
20	18591704	.	G	A	27	15	42	0	1	43	0	0
20	18591716	.	A	C	30	15	45	0	0	45	0	0
20	18591743	.	A	T	22	14	36	0	1	37	0	0
20	18594958	.	C	A	32	18	50	0	5	55	0	0
20	18594980	.	T	A	19	33	52	0	1	53	0	0
20	18595296	.	T	G	12	0	12	0	15	27	0	0
20	18669600	.	G	A	9	12	21	0	0	21	0	0
20	18672064	.	C	T	9	17	26	0	0	26	0	0
20	18672094	.	T	C	9	18	27	0	1	28	0	0
20	18672193	.	G	A	0	7	7	0	15	22	0	0
20	18672733	.	A	T	10	13	23	0	2	25	0	0
20	18672970	.	G	A	7	13	20	0	0	20	0	0
20	18673132	.	C	T	9	15	24	0	1	25	0	0
20	18677343	.	G	A	12	10	22	0	0	22	0	0
20	18677391	.	T	G	9	0	9	0	8	17	0	0
20	18678023	.	T	C	12	7	19	0	1	20	0	0
20	18678466	.	C	T	16	11	27	0	2	29	0	0
20	18683158	.	T	C	16	14	30	0	2	32	0	0
20	18684922	.	A	T	17	16	33	0	2	35	0	0
20	18685139	.	G	A	10	6	16	0	0	16	0	0
20	18708770	.	T	C	25	22	47	0	3	50	0	0
20	18713067	.	T	C	32	24	56	0	1	57	0	0
20	18714024	.	C	T	5	8	13	0	0	13	0	0
20	18714242	.	C	A	3	3	6	0	0	6	0	0
20	18714733	.	A	G	5	3	8	0	0	8	0	0
20	18714824	.	G	A	3	2	5	0	0	5	0	0
20	18721383	.	A	T	2	2	4	0	0	4	0	0
20	18721397	.	C	T	2	3	5	0	0	5	0	0
20	18721775	.	T	G	11	13	24	0	0	24	0	0
20	18721910	.	G	A	17	9	26	0	1	27	0	0
20	18722089	.	G	C	13	14	27	0	2	29	0	0
20	18722312	.	A	C	14	14	28	0	0	28	0	0
20	18722565	.	A	T	24	12	36	0	2	38	0	0
20	18722630	.	C	T	0	11	11	0	9	20	0	0
20	18722857	.	G	A	3	9	12	0	0	12	0	0
20	18722931	.	G	A	1	7	8	0	1	9	0	0
20	18722943	.	G	A	6	2	8	0	0	8	0	0
20	18723062	.	C	T	10	6	16	0	0	16	0	0
20	18723105	.	C	T	15	14	29	0	1	30	0	0
20	18723239	.	G	T	13	14	27	0	0	27	0	0
20	18723244	.	G	T	14	14	28	0	0	28	0	0
20	18723401	.	T	C	5	0	5	1	6	12	0	0
20	18723441	.	G	A	6	9	15	0	0	15	0	0
20	18723459	.	T	C	5	9	14	0	1	15	0	0
20	18723781	.	T	G	9	14	23	0	0	23	0	0
20	18727472	.	T	C	14	17	31	0	1	32	0	0
20	18727506	.	T	C	7	13	20	0	0	20	0	0
20	18730498	.	G	A	4	12	16	0	1	17	0	0
20	18730840	.	T	C	7	8	15	0	0	15	0	0
20	18731068	.	C	T	16	7	23	0	1	24	0	0
20	18774552	.	G	A	4	3	7	0	1	8	0	0
20	18775947	.	A	G	2	2	4	0	0	4	0	0
20	18776270	.	C	T	2	4	6	0	0	6	0	0
20	18780171	.	G	A	2	4	6	0	1	7	0	0
20	18783282	.	A	G	5	2	7	0	0	7	0	0
20	18801564	.	C	T	2	2	4	0	0	4	0	0
20	18802603	.	C	T	7	2	9	0	0	9	0	0
20	18802651	.	G	A	7	5	12	0	0	12	0	0
20	18810201	.	C	T	1	2	3	0	0	3	0	0
20	18947331	.	G	A	0	12	12	0	10	23	1	0
20	18955563	.	A	T	12	9	21	0	1	22	0	0
20	18956708	.	T	A	9	6	15	0	3	18	0	0
20	18956729	.	C	T	11	11	22	0	1	23	0	0
20	18958106	.	C	G	13	11	24	1	1	26	0	0
20	18958159	.	T	C	19	10	29	0	1	31	1	0
20	18958477	.	G	A	1	15	16	0	10	26	0	0
20	18961835	.	T	C	10	11	21	0	0	21	0	0
20	18961838	.	C	T	11	10	21	0	1	22	0	0
20	18968826	.	C	T	13	10	23	0	0	23	0	0
20	18972850	.	T	A	13	13	26	0	0	26	0	0
20	18992711	.	G	A	5	4	9	0	1	10	0	0
20	18992763	.	T	C	7	10	17	0	1	18	0	0
20	18994634	.	C	T	7	8	15	0	1	16	0	0
20	18996331	.	C	T	19	6	25	0	2	27	0	0
20	18997305	.	A	G	12	29	41	0	0	41	0	0
20	18997610	.	A	G	20	12	32	0	4	36	0	0
20	18997875	.	A	G	7	15	22	1	1	24	0	0
20	19018520	.	G	A	3	6	9	0	0	9	0	0
20	19058143	.	G	A	13	8	21	0	1	22	0	0
20	19058152	.	T	G	11	8	19	0	1	20	0	0
20	19058188	.	A	G	8	8	16	0	0	16	0	0
20	19058194	.	T	C	7	7	14	0	1	15	0	0
20	19058241	.	A	C	6	8	14	0	0	14	0	0
20	19058326	.	A	G	3	6	9	0	0	9	0	0
20	19058475	.	T	G	3	4	7	0	0	7	0	0
20	19075298	.	G	A	6	4	10	0	0	10	0	0
20	19076873	.	C	T	8	5	13	0	0	13	0	0
20	19077156	.	T	C	8	14	22	0	0	22	0	0
20	19077628	.	A	G	7	9	16	0	1	17	0	0
20	19213235	.	G	A	11	9	20	1	4	25	0	0
20	19213586	.	T	A	7	15	22	0	2	24	0	0
20	19213587	.	G	C	8	16	24	0	0	24	0	0
20	19238509	.	A	T	8	11	19	0	2	21	0	0
20	19258639	.	T	C	13	14	27	0	0	27	0	0
20	19277169	.	G	C	3	2	5	0	0	5	0	0
20	19277495	.	C	A	1	1	2	0	1	3	0	0
20	19277498	.	G	A	0	1	1	0	1	2	0	0
20	19277610	.	T	A	3	6	9	0	1	10	0	0
20	19277611	.	C	G	4	6	10	0	0	10	0	0
20	19277663	.	C	T	3	2	5	0	0	5	0	0
20	19278132	.	C	T	9	1	10	0	1	11	0	0
20	19278143	.	C	T	7	2	9	0	1	10	0	0
20	19290547	.	C	T	5	6	11	0	0	11	0	0
20	19290586	.	G	A	5	5	10	0	1	11	0	0
20	19365664	.	C	T	3	6	9	0	1	10	0	0
20	19373597	.	G	A	4	7	11	0	0	11	0	0
20	19373616	.	T	C	2	7	9	0	0	9	0	0
20	19373647	.	C	T	5	6	11	0	1	12	0	0
20	19373653	.	T	A	5	3	8	0	1	11	2	0
20	19373720	.	T	C	13	1	14	1	8	23	0	0
20	19373852	.	A	G	9	10	19	0	1	20	0	0
20	19373919	.	A	G	9	10	19	0	1	20	0	0
20	19373939	.	G	A	10	11	21	0	1	22	0	0
20	19374058	.	C	T	10	12	22	0	0	22	0	0
20	19374093	.	A	T	9	11	20	0	0	20	0	0
20	19374120	.	G	T	6	6	12	0	0	12	0	0
20	19374242	.	G	T	6	4	10	0	0	10	0	0
20	19374415	.	C	T	0	7	7	0	9	16	0	0
20	19374524	.	G	A	3	5	8	0	0	8	0	0
20	19391641	.	A	G	6	6	12	0	1	13	0	0
20	19391677	.	T	A	12	5	17	0	2	19	0	0
20	19391704	.	A	G	8	5	13	0	0	13	0	0
20	19401018	.	T	C	6	5	11	0	0	11	0	0
20	19406475	.	A	G	8	7	15	0	0	15	0	0
20	19406620	.	A	G	8	8	16	0	0	16	0	0
20	19406689	.	G	A	7	4	11	0	0	11	0	0
20	19406709	.	A	C	7	4	11	0	0	11	0	0
20	19429846	.	C	T	6	6	12	0	0	12	0	0
20	19429879	.	T	C	8	4	12	0	1	13	0	0
20	19430075	.	A	G	2	0	2	0	6	8	0	0
20	19430092	.	T	C	2	7	9	0	0	9	0	0
20	19430352	.	C	A	5	5	10	0	0	10	0	0
20	19430778	.	C	A	12	9	21	0	0	21	0	0
20	19430790	.	C	T	11	9	20	0	0	20	0	0
20	19431360	.	C	A	5	4	9	0	0	9	0	0
20	19431385	.	A	G	5	6	11	0	1	12	0	0
20	19431631	.	G	C	5	8	13	0	0	13	0	0
20	19431665	.	G	A	5	8	13	0	0	13	0	0
20	19431960	.	C	G	3	10	13	0	1	14	0	0
20	19432007	.	G	T	5	4	9	0	0	9	0	0
20	19432150	.	T	A	5	5	10	0	1	11	0	0
20	19436389	.	G	C	6	4	10	0	1	11	0	0
20	19436440	.	G	A	7	4	11	0	0	11	0	0
20	19436890	.	T	C	9	0	9	0	0	9	0	0
20	19436899	.	C	A	7	9	16	0	0	16	0	0
20	19437206	.	A	G	2	4	6	0	0	6	0	0
20	19437434	.	T	C	1	0	1	0	7	8	0	0
20	19437624	.	T	C	8	0	8	0	6	14	0	0
20	19437848	.	T	C	5	0	5	0	7	12	0	0
20	19437969	.	A	G	9	4	13	0	0	13	0	0
20	19438082	.	T	G	1	7	8	0	1	9	0	0
20	19438110	.	C	A	2	8	10	0	0	10	0	0
20	19438146	.	T	C	6	0	6	0	8	14	0	0
20	19438181	.	C	T	2	7	9	0	7	16	0	0
20	19438193	.	T	A	4	8	12	0	0	12	0	0
20	19438425	.	G	A	4	4	8	0	0	8	0	0
20	19438460	.	T	G	4	3	7	0	1	8	0	0
20	19440796	.	T	C	6	8	14	0	2	16	0	0
20	19443045	.	G	T	11	3	14	0	1	15	0	0
20	19451575	.	A	G	5	6	11	0	0	11	0	0
20	19510892	.	G	C	8	8	16	0	0	16	0	0
20	19510904	.	A	G	7	6	13	0	0	13	0	0
20	19510950	.	C	A	3	7	10	0	0	10	0	0
20	19515966	.	G	T	6	11	17	0	0	17	0	0
20	19516009	.	A	G	6	6	12	0	1	13	0	0
20	19516068	.	C	T	10	5	15	0	2	17	0	0
20	19516096	.	T	A	12	5	17	0	0	17	0	0
20	19516274	.	C	A	4	3	7	0	2	9	0	0
20	19516276	.	G	A	5	3	8	0	1	9	0	0
20	19516315	.	G	C	5	4	9	0	0	9	0	0
20	19516392	.	T	C	2	7	9	0	0	9	0	0
20	19516406	.	T	G	4	0	4	0	8	12	0	0
20	19516537	.	T	C	4	3	7	0	0	7	0	0
20	19516772	.	T	C	6	7	13	0	0	13	0	0
20	19516837	.	G	A	6	10	16	0	3	19	0	0
20	19517027	.	C	G	7	10	17	0	3	20	0	0
20	19518685	.	A	G	10	14	24	0	0	24	0	0
20	19519403	.	C	G	8	10	18	0	0	18	0	0
20	19519454	.	T	G	6	5	11	0	2	13	0	0
20	19521657	.	C	T	9	11	20	0	0	20	0	0
20	19524966	.	A	G	9	14	23	1	3	27	0	0
20	19524978	.	G	A	11	15	26	1	1	28	0	0
20	19530702	.	G	A	8	11	19	0	0	19	0	0
20	19562437	.	C	T	1	5	6	0	0	6	0	0
20	19562536	.	C	A	5	2	7	0	0	7	0	0
20	19562565	.	G	T	5	3	8	0	0	8	0	0
20	19562630	.	G	T	0	8	8	0	5	13	0	0
20	19562664	.	C	A	3	7	10	0	0	10	0	0
20	19562743	.	G	T	10	9	19	0	0	19	0	0
20	19562853	.	T	A	9	7	16	0	0	16	0	0
20	19575264	.	G	A	10	11	21	0	0	21	0	0
20	19575271	.	A	G	6	10	16	0	3	19	0	0
20	19579897	.	G	A	1	2	3	0	1	4	0	0
20	19580091	.	A	T	12	6	18	0	1	19	0	0
20	19580331	.	C	T	9	6	15	0	1	16	0	0
20	19580367	.	T	A	10	5	15	0	0	15	0	0
20	19580397	.	A	G	8	4	12	0	3	15	0	0
20	19580405	.	G	A	8	7	15	0	0	15	0	0
20	19580441	.	A	G	6	11	17	0	0	17	0	0
20	19580584	.	T	C	16	0	16	0	13	29	0	0
20	19583028	.	C	G	9	7	16	0	1	17	0	0
20	19793708	.	A	G	3	4	7	0	0	7	0	0
20	19793727	.	A	G	3	5	8	0	0	8	0	0
20	19793745	.	A	T	2	5	7	0	0	7	0	0
20	19793999	.	T	G	1	2	3	0	0	3	0	0
20	19821817	.	T	C	4	4	8	0	0	8	0	0
20	19821886	.	C	T	2	4	6	0	0	6	0	0
20	19822347	.	A	G	1	0	1	0	4	5	0	0
20	19822537	.	T	C	2	3	5	0	0	5	0	0
20	19822603	.	G	C	2	4	6	0	0	6	0	0
20	19822612	.	C	T	2	4	6	0	0	6	0	0
20	19823472	.	C	T	1	6	7	0	0	7	0	0
20	19823518	.	A	G	1	6	7	0	0	7	0	0
20	20231995	.	G	C	8	14	22	0	0	22	0	0
20	20232347	.	A	T	9	13	22	0	2	24	0	0
20	20232456	.	G	T	11	14	25	0	0	25	0	0
20	20269729	.	C	T	5	9	14	0	0	14	0	0
20	20269835	.	T	A	6	4	10	0	0	10	0	0
20	20269836	.	T	C	6	5	11	0	0	11	0	0
20	20270109	.	G	T	6	5	11	0	0	11	0	0
20	20270173	.	G	T	3	4	7	0	0	7	0	0
20	20275193	.	A	T	7	7	14	0	1	15	0	0
20	20275196	.	C	A	6	8	14	0	2	16	0	0
20	20275306	.	C	T	6	12	18	0	0	18	0	0
20	20275322	.	T	A	8	12	20	0	1	21	0	0
20	20275434	.	T	A	24	16	40	0	2	42	0	0
20	20275455	.	C	T	23	16	39	0	2	41	0	0
20	20275661	.	C	T	1	9	10	1	11	22	0	0
20	20275674	.	A	G	10	12	22	0	2	24	0	0
20	20275766	.	T	G	20	14	34	0	0	34	0	0
20	20275776	.	T	C	20	0	20	0	17	37	0	0
20	20312109	.	T	C	1	4	5	0	0	5	0	0
20	20312408	.	A	T	3	6	9	0	0	9	0	0
20	20326945	.	A	T	5	5	10	0	0	10	0	0
20	20328055	.	A	G	24	24	48	0	9	57	0	0
20	20328137	.	G	A	34	29	63	0	2	65	0	0
20	20330095	.	C	A	22	21	43	0	0	43	0	0
20	20330256	.	T	C	18	22	40	0	1	41	0	0
20	20331235	.	T	A	26	22	48	0	3	51	0	0
20	20331740	.	A	G	21	17	38	0	1	39	0	0
20	20332079	.	G	A	16	17	33	1	2	36	0	0
20	20334705	.	G	A	17	14	31	0	0	31	0	0
20	20335543	.	A	G	14	11	25	0	1	26	0	0
20	20335739	.	G	C	9	11	20	0	0	20	0	0
20	20335784	.	A	T	13	20	33	0	2	35	0	0
20	20337215	.	G	A	16	19	35	0	1	36	0	0
20	20337263	.	A	C	13	14	27	0	1	28	0	0
20	20338509	.	A	G	12	12	24	0	1	25	0	0
20	20338569	.	C	T	8	9	17	0	1	18	0	0
20	20601233	.	C	G	9	17	26	0	1	27	0	0
20	20601651	.	T	G	10	13	23	0	1	24	0	0
20	20601883	.	A	T	11	22	33	0	0	33	0	0
20	20601884	.	A	C	10	21	31	0	1	32	0	0
20	20601985	.	T	C	16	6	22	1	0	23	0	0
20	20602097	.	A	T	6	11	17	0	3	20	0	0
20	20602232	.	T	C	8	4	12	2	3	17	0	0
20	20602290	.	G	T	7	6	13	1	0	14	0	0
20	20602370	.	A	T	9	8	17	0	0	17	0	0
20	20603131	.	T	A	8	9	17	0	1	18	0	0
20	20603389	.	T	G	5	3	8	0	0	8	0	0
20	20603512	.	A	C	2	2	4	0	0	4	0	0
20	20603906	.	G	A	7	3	10	0	1	11	0	0
20	20603966	.	A	T	4	4	8	0	0	8	0	0
20	20604015	.	T	G	2	8	10	0	0	10	0	0
20	20605071	.	T	C	4	3	7	0	0	7	0	0
20	20605136	.	T	C	4	4	8	0	1	9	0	0
20	20605271	.	T	C	8	3	11	0	1	12	0	0
20	20605295	.	T	C	6	3	9	0	0	9	0	0
20	20609663	.	G	A	9	4	13	0	1	14	0	0
20	20609735	.	G	C	5	0	5	0	14	19	0	0
20	20611040	.	C	G	11	4	15	0	0	15	0	0
20	20655141	.	G	C	17	9	26	0	0	26	0	0
20	20655142	.	T	C	17	9	26	0	0	26	0	0
20	20655339	.	A	T	17	15	32	0	2	34	0	0
20	20655357	.	G	A	2	11	13	0	18	31	0	0
20	20655394	.	C	G	14	0	14	0	19	33	0	0
20	20658851	.	G	T	14	14	28	0	0	28	0	0
20	20658954	.	C	T	17	13	30	0	2	32	0	0
20	20659009	.	T	C	22	18	40	0	1	41	0	0
20	20659067	.	G	A	23	12	35	0	3	38	0	0
20	20659188	.	C	G	25	11	36	0	1	37	0	0
20	20659305	.	T	C	19	15	34	0	1	35	0	0
20	20659306	.	C	T	18	16	34	0	0	34	0	0
20	20672289	.	T	C	40	22	62	0	0	62	0	0
20	20672335	.	C	T	33	27	60	3	0	63	0	0
20	20694231	.	T	C	1	2	3	0	0	3	0	0
20	20694918	.	A	T	38	30	68	0	4	72	0	0
20	20694999	.	C	T	20	26	46	0	3	49	0	0
20	20695642	.	G	T	2	25	27	0	31	58	0	0
20	20695779	.	T	A	31	15	46	0	2	48	0	0
20	20695829	.	A	T	25	21	46	0	0	46	0	0
20	20695856	.	A	T	26	25	51	0	1	52	0	0
20	20713542	.	A	T	2	3	5	0	0	5	0	0
20	20713566	.	T	A	1	2	3	0	0	3	0	0
20	20713597	.	G	A	3	2	5	0	0	5	0	0
20	20713640	.	T	A	4	3	7	0	0	7	0	0
20	20716211	.	A	G	3	0	3	0	4	7	0	0
20	20722071	.	A	G	2	3	5	0	0	5	0	0
20	20726287	.	G	T	30	32	62	0	2	64	0	0
20	20726291	.	G	A	2	30	32	0	36	68	0	0
20	20726966	.	T	C	33	34	67	0	1	68	0	0
20	20726993	.	C	A	30	29	59	1	3	63	0	0
20	20729975	.	C	T	30	33	63	0	3	66	0	0
20	20730061	.	C	G	21	18	39	0	1	40	0	0
20	20731663	.	A	G	5	7	12	0	1	13	0	0
20	20731706	.	G	A	6	10	16	0	0	16	0	0
20	20793358	.	G	A	7	11	18	0	1	19	0	0
20	20802754	.	C	A	6	26	32	0	0	32	0	0
20	20805250	.	T	G	2	0	2	0	13	15	0	0
20	20805438	.	T	C	9	26	35	0	0	35	0	0
20	20805643	.	G	C	1	24	25	0	10	35	0	0
20	20805690	.	C	T	4	19	23	0	1	24	0	0
20	20808044	.	C	A	6	25	31	0	1	32	0	0
20	20809666	.	T	C	5	22	27	0	0	27	0	0
20	20809702	.	T	C	9	21	30	0	0	30	0	0
20	20812680	.	C	T	6	33	39	0	6	45	0	0
20	20812728	.	T	C	8	39	47	0	1	48	0	0
20	20812898	.	T	C	9	13	22	0	1	23	0	0
20	20813116	.	A	T	7	20	27	0	1	28	0	0
20	20813162	.	T	C	15	22	37	0	1	38	0	0
20	20813197	.	A	C	15	23	38	0	0	38	0	0
20	20813270	.	C	T	17	13	30	0	3	33	0	0
20	20813336	.	T	C	6	24	30	0	1	31	0	0
20	20813460	.	C	T	6	28	34	0	0	34	0	0
20	20813568	.	A	C	7	21	28	0	0	28	0	0
20	20817263	.	A	G	35	38	73	0	5	78	0	0
20	20817921	.	A	G	39	36	75	0	4	79	0	0
20	20927973	.	A	C	7	0	7	1	2	10	0	0
20	20928239	.	C	G	1	14	15	0	16	31	0	0
20	20928536	.	G	A	17	14	31	0	1	32	0	0
20	20928932	.	A	G	14	20	34	0	1	35	0	0
20	20929166	.	G	A	25	14	39	0	1	40	0	0
20	20931142	.	C	G	10	10	20	0	1	21	0	0
20	20948025	.	A	G	4	7	11	0	0	11	0	0
20	20974065	.	T	C	5	5	10	0	0	10	0	0
20	20974071	.	T	G	5	5	10	0	0	10	0	0
20	20978278	.	G	A	4	5	9	0	0	9	0	0
20	21008381	.	G	A	1	3	4	0	0	4	0	0
20	21008471	.	T	A	5	8	13	0	0	13	0	0
20	21015748	.	G	A	2	6	8	0	0	8	0	0
20	21269081	.	T	C	4	4	8	0	0	8	0	0
20	21330448	.	G	A	5	8	13	0	1	14	0	0
20	21341814	.	T	C	5	8	13	0	1	14	0	0
20	21341865	.	A	C	2	5	7	0	0	7	0	0
20	21342009	.	A	T	2	4	6	0	0	6	0	0
20	21342050	.	T	C	4	2	6	0	0	6	0	0
20	21392135	.	C	T	2	4	6	0	0	6	0	0
20	21427428	.	T	C	3	3	6	0	0	6	0	0
20	21453861	.	C	T	1	2	3	0	0	3	0	0
20	21455216	.	T	C	6	4	10	0	0	10	0	0
20	21469759	.	G	C	4	4	8	0	0	8	0	0
20	21473681	.	T	C	15	9	24	0	1	25	0	0
20	21474159	.	T	C	7	9	16	0	1	17	0	0
20	21474185	.	C	T	4	12	16	0	0	16	0	0
20	21474664	.	A	G	13	0	13	0	7	20	0	0
20	21474700	.	A	G	11	5	16	0	1	17	0	0
20	21474715	.	A	C	7	6	13	0	0	13	0	0
20	21638431	.	C	A	2	5	7	0	0	7	0	0
20	21638575	.	T	C	3	9	12	0	0	12	0	0
20	21638903	.	T	C	4	2	6	0	0	6	0	0
20	21639637	.	G	T	2	3	5	0	0	5	0	0
20	21815659	.	G	T	9	14	23	0	1	24	0	0
20	21815986	.	C	T	1	14	15	0	12	27	0	0
20	21816061	.	C	G	16	12	28	0	1	29	0	0
20	21819062	.	T	C	19	13	32	0	3	35	0	0
20	21828117	.	T	C	11	13	24	0	0	24	0	0
20	21839504	.	G	A	11	7	18	0	0	18	0	0
20	21841312	.	G	A	12	13	25	0	0	25	0	0
20	21841316	.	G	T	10	12	22	0	2	24	0	0
20	21855195	.	T	C	9	11	20	1	2	23	0	0
20	21862963	.	C	T	5	10	15	0	13	28	0	0
20	21862975	.	C	T	4	6	10	0	15	25	0	0
20	21872945	.	A	G	14	9	23	0	2	25	0	0
20	21872990	.	G	A	15	7	22	0	2	24	0	0
20	21875111	.	G	A	13	3	16	0	0	16	0	0
20	21875162	.	G	A	16	5	21	0	0	21	0	0
20	21875165	.	T	G	15	5	20	0	1	21	0	0
20	21875411	.	C	A	3	9	12	0	2	14	0	0
20	21910005	.	C	T	0	9	9	0	12	21	0	0
20	22045260	.	A	C	2	4	6	0	1	7	0	0
20	22061949	.	C	T	2	3	5	0	0	5	0	0
20	22061966	.	T	A	3	2	5	0	0	5	0	0
20	22160859	.	T	A	6	4	10	0	1	11	0	0
20	22163667	.	T	C	6	4	10	0	0	10	0	0
20	22166199	.	G	A	7	4	11	0	0	11	0	0
20	22166512	.	A	G	6	10	16	0	0	16	0	0
20	22168567	.	C	T	11	5	16	0	0	16	0	0
20	22174303	.	T	A	6	2	8	0	0	8	0	0
20	22175326	.	G	A	10	3	13	0	0	13	0	0
20	22175457	.	C	A	3	3	6	0	0	6	0	0
20	22175625	.	T	C	8	3	11	0	0	11	0	0
20	22175815	.	T	C	12	4	16	0	0	16	0	0
20	22175830	.	G	A	8	4	12	0	0	12	0	0
20	22175906	.	T	G	7	4	11	0	0	11	0	0
20	22175928	.	C	T	6	4	10	0	1	11	0	0
20	22179962	.	T	A	10	6	16	0	0	16	0	0
20	22186632	.	G	A	9	7	16	0	0	16	0	0
20	22186738	.	G	A	15	4	19	0	1	20	0	0
20	22186765	.	C	G	21	6	27	0	0	27	0	0
20	22186886	.	A	G	11	7	18	0	0	18	0	0
20	22186914	.	A	G	12	6	18	0	0	18	0	0
20	22186971	.	C	T	15	5	20	0	1	21	0	0
20	22186973	.	C	T	14	4	18	0	2	20	0	0
20	22187233	.	T	C	10	10	20	0	0	20	0	0
20	22191361	.	A	T	12	16	28	0	1	29	0	0
20	22191376	.	A	G	17	13	30	0	0	30	0	0
20	22191493	.	T	C	9	0	9	0	6	15	0	0
20	22193013	.	C	A	4	9	13	0	11	24	0	0
20	22194285	.	C	T	0	3	3	0	7	10	0	0
20	22194395	.	G	A	5	2	7	0	0	7	0	0
20	22196960	.	T	G	4	8	12	0	0	12	0	0
20	22198957	.	C	A	6	2	8	0	0	8	0	0
20	22335865	.	T	C	1	1	2	0	1	3	0	0
20	22352712	.	C	G	1	2	3	0	0	3	0	0
20	22435335	.	C	A	1	2	3	0	0	3	0	0
20	22435672	.	T	C	3	3	6	0	0	6	0	0
20	22435789	.	G	A	5	2	7	0	0	7	0	0
20	22435893	.	T	A	3	6	9	0	0	9	0	0
20	22435901	.	C	T	3	5	8	0	1	9	0	0
20	22436403	.	T	G	2	2	4	0	0	4	0	0
20	22709685	.	T	A	22	10	32	0	4	36	0	0
20	22720443	.	A	G	15	12	27	0	2	29	0	0
20	22730689	.	C	G	15	24	39	0	1	40	0	0
20	22734145	.	C	A	21	25	46	0	1	47	0	0
20	22736625	.	T	C	24	20	44	0	2	46	0	0
20	22739946	.	C	A	22	18	40	0	2	42	0	0
20	22739985	.	T	C	21	25	46	0	1	47	0	0
20	22740056	.	C	T	24	20	44	0	2	46	0	0
20	22740140	.	C	T	15	22	37	0	0	37	0	0
20	22740230	.	A	G	28	22	50	0	1	51	0	0
20	22740567	.	A	G	14	1	15	0	19	34	0	0
20	22800147	.	G	A	0	2	2	0	1	3	0	0
20	22800759	.	G	A	2	2	4	0	0	4	0	0
20	22802259	.	C	A	3	8	11	0	0	11	0	0
20	22987760	.	C	T	2	3	5	0	0	5	0	0
20	23007497	.	G	A	1	3	4	1	0	5	0	0
20	23007547	.	G	A	4	6	10	0	0	10	0	0
20	23017227	.	T	C	11	3	14	0	0	14	0	0
20	23021287	.	G	T	2	2	4	0	0	4	0	0
20	23021292	.	A	T	2	2	4	0	0	4	0	0
20	23023364	.	G	A	11	8	19	0	0	19	0	0
20	23023471	.	C	T	10	14	24	0	0	24	0	0
20	23023482	.	A	G	14	7	21	0	2	23	0	0
20	23023623	.	G	A	10	13	23	0	0	23	0	0
20	23023641	.	A	G	9	11	20	0	2	22	0	0
20	23023670	.	T	C	8	1	9	0	7	16	0	0
20	23024096	.	G	A	8	4	12	0	0	12	0	0
20	23083951	.	T	G	2	0	2	0	3	5	0	0
20	23175425	.	A	G	11	17	28	0	0	28	0	0
20	23177734	.	G	A	11	17	28	0	1	29	0	0
20	23179786	.	C	T	18	8	26	0	0	26	0	0
20	23181718	.	A	G	11	28	39	0	0	39	0	0
20	23205004	.	G	A	7	16	23	0	0	23	0	0
20	23205868	.	T	C	21	14	35	0	3	38	0	0
20	23205879	.	G	A	24	17	41	0	2	43	0	0
20	23215901	.	C	T	12	13	25	0	0	25	0	0
20	23215949	.	C	T	18	13	31	0	0	31	0	0
20	23245866	.	T	A	7	4	11	0	0	11	0	0
20	23246215	.	G	A	5	3	8	0	0	8	0	0
20	23248572	.	G	A	12	7	19	0	0	19	0	0
20	23250491	.	A	C	15	0	15	0	8	23	0	0
20	23250690	.	C	A	1	7	8	0	10	18	0	0
20	23332591	.	G	T	2	3	5	0	0	5	0	0
20	23332659	.	C	T	3	3	6	0	0	6	0	0
20	23360243	.	C	T	2	2	4	0	0	4	0	0
20	23360273	.	T	C	3	2	5	0	0	5	0	0
20	23362757	.	G	A	2	6	8	0	2	10	0	0
20	23366182	.	C	T	2	2	4	0	0	4	0	0
20	23366580	.	T	C	1	2	3	0	0	3	0	0
20	23372087	.	C	T	5	3	8	0	0	8	0	0
20	23372290	.	T	C	3	7	10	0	0	10	0	0
20	23376396	.	T	A	3	4	7	0	0	7	0	0
20	23377161	.	T	C	5	5	10	0	0	10	0	0
20	23378401	.	G	A	5	3	8	0	0	8	0	0
20	23378434	.	A	T	4	7	11	0	1	12	0	0
20	23378899	.	G	A	0	5	5	0	10	15	0	0
20	23382695	.	T	A	7	3	10	0	1	11	0	0
20	23383055	.	A	G	6	0	6	0	4	10	0	0
20	23385556	.	G	A	8	5	13	0	0	13	0	0
20	23387619	.	G	A	1	3	4	0	8	12	0	0
20	23389772	.	T	C	5	6	11	0	0	11	0	0
20	23389793	.	A	G	3	0	3	0	7	10	0	0
20	23390621	.	G	A	2	5	7	0	5	12	0	0
20	23395376	.	T	A	2	2	4	0	14	19	1	0
20	23395404	.	C	T	9	6	15	0	3	18	0	0
20	23406545	.	T	A	13	10	23	0	0	23	0	0
20	23408734	.	T	C	14	15	29	0	0	29	0	0
20	23418228	.	G	A	16	14	30	0	2	32	0	0
20	23418291	.	C	G	18	13	31	0	0	31	0	0
20	23420784	.	A	T	13	8	21	0	6	27	0	0
20	23421442	.	T	C	16	19	35	1	2	38	0	0
20	23421695	.	T	C	18	23	41	0	0	41	0	0
20	23422061	.	T	C	14	20	34	0	4	38	0	0
20	23422205	.	A	T	17	8	25	0	1	26	0	0
20	23432169	.	G	A	2	3	5	0	0	5	0	0
20	23446854	.	C	T	8	8	16	0	0	16	0	0
20	23446868	.	T	A	5	8	13	0	1	14	0	0
20	23447224	.	T	C	4	0	4	0	8	12	0	0
20	23447467	.	A	T	6	6	12	0	0	12	0	0
20	23447564	.	C	G	14	11	25	0	0	25	0	0
20	23447873	.	C	G	12	13	25	0	0	25	0	0
20	23471742	.	G	A	4	5	9	0	1	10	0	0
20	23471859	.	C	A	5	4	9	0	0	9	0	0
20	23471985	.	G	A	6	8	14	0	0	14	0	0
20	23472036	.	C	T	2	3	5	0	0	5	0	0
20	23472039	.	C	T	3	2	5	0	0	5	0	0
20	23472186	.	T	C	5	3	8	0	0	8	0	0
20	23472239	.	C	T	0	5	5	0	9	14	0	0
20	23472259	.	G	T	10	4	14	0	0	14	0	0
20	23475653	.	G	C	6	6	12	0	0	12	0	0
20	23478231	.	C	T	2	4	6	0	0	6	0	0
20	23491899	.	C	A	4	2	6	0	0	6	0	0
20	23491902	.	A	G	4	2	6	0	0	6	0	0
20	23621914	.	G	A	0	3	3	1	4	8	0	0
20	23643495	.	T	C	1	3	4	0	0	4	0	0
20	23647541	.	C	T	6	4	10	0	0	10	0	0
20	23647869	.	T	A	6	3	9	0	0	9	0	0
20	23648092	.	T	C	1	3	4	0	0	4	0	0
20	23648235	.	T	A	2	3	5	0	0	5	0	0
20	23648289	.	T	C	0	9	9	0	0	9	0	0
20	23648724	.	T	C	6	3	9	0	0	9	0	0
20	23648828	.	G	A	7	6	13	0	0	13	0	0
20	23651156	.	C	A	3	2	5	0	0	5	0	0
20	23651253	.	T	C	0	5	5	0	1	6	0	0
20	23651254	.	G	A	1	5	6	0	0	6	0	0
20	23651350	.	C	T	4	4	8	0	1	9	0	0
20	23651503	.	T	C	3	0	3	0	8	11	0	0
20	23655749	.	A	T	6	5	11	0	0	11	0	0
20	23655767	.	C	T	7	3	10	0	0	10	0	0
20	23656226	.	T	A	3	7	10	0	0	10	0	0
20	23656454	.	A	G	6	8	14	0	0	14	0	0
20	23664970	.	G	A	0	5	5	0	6	11	0	0
20	23665041	.	G	A	0	7	7	0	3	10	0	0
20	23665455	.	T	A	3	2	5	0	0	5	0	0
20	23665793	.	G	T	1	7	8	0	8	16	0	0
20	23665863	.	G	A	0	8	8	0	5	13	0	0
20	23666055	.	T	A	3	4	7	1	0	8	0	0
20	23685062	.	G	A	2	6	8	0	0	8	0	0
20	23685106	.	A	T	1	5	6	0	0	6	0	0
20	23685529	.	T	A	10	4	14	0	0	14	0	0
20	23689192	.	G	A	4	7	11	0	0	11	0	0
20	23689933	.	G	C	4	3	7	0	0	7	0	0
20	23690051	.	A	T	5	5	10	0	0	10	0	0
20	23690077	.	C	A	5	5	10	0	0	10	0	0
20	23691015	.	G	A	3	7	10	0	0	10	0	0
20	23691059	.	A	G	3	0	3	0	2	5	0	0
20	23691911	.	T	C	5	11	16	0	0	16	0	0
20	23691917	.	C	T	5	10	15	0	1	16	0	0
20	23692094	.	T	C	10	4	14	0	0	14	0	0
20	23694005	.	C	T	5	4	9	0	0	9	0	0
20	23694299	.	G	T	0	6	6	0	5	11	0	0
20	23705719	.	G	A	8	5	13	1	0	14	0	0
20	23705974	.	G	A	7	4	11	0	2	13	0	0
20	23713122	.	G	A	0	11	11	0	5	16	0	0
20	23713197	.	A	G	7	0	7	0	5	12	0	0
20	23713266	.	G	A	0	6	6	0	4	10	0	0
20	23713475	.	T	A	2	2	4	0	1	5	0	0
20	23713497	.	G	T	2	3	5	0	1	6	0	0
20	23713512	.	A	T	2	3	5	0	0	5	0	0
20	23713535	.	A	G	3	3	6	0	0	6	0	0
20	23713763	.	G	A	1	9	10	0	0	10	0	0
20	23713824	.	A	G	4	6	10	0	1	11	0	0
20	23713858	.	T	G	4	0	4	0	6	10	0	0
20	23713883	.	A	G	2	0	2	0	6	8	0	0
20	23746885	.	G	A	0	4	4	0	3	7	0	0
20	23747107	.	G	C	0	3	3	0	2	5	0	0
20	23747167	.	A	G	1	5	6	0	1	7	0	0
20	23796406	.	T	C	4	5	9	0	0	9	0	0
20	23796493	.	C	A	1	3	4	0	1	5	0	0
20	23796565	.	C	T	1	1	2	0	1	3	0	0
20	23797195	.	T	C	5	2	7	0	0	7	0	0
20	23801024	.	C	T	4	5	9	0	1	10	0	0
20	23801069	.	G	T	1	8	9	0	3	12	0	0
20	23801255	.	G	C	1	5	6	1	7	14	0	0
20	23826955	.	G	A	5	5	10	0	0	10	0	0
20	23828102	.	G	T	7	7	14	0	0	14	0	0
20	23829170	.	C	T	3	7	10	0	0	10	0	0
20	23829413	.	A	G	9	0	9	0	5	14	0	0
20	23832884	.	G	C	6	4	10	0	3	13	0	0
20	23833193	.	G	T	4	4	8	0	0	8	0	0
20	23835228	.	C	T	3	4	7	0	1	8	0	0
20	23835354	.	C	T	1	12	13	0	0	13	0	0
20	23835472	.	C	T	7	5	12	0	0	12	0	0
20	23835549	.	C	A	5	2	7	0	0	7	0	0
20	23835591	.	G	T	5	3	8	0	0	8	0	0
20	23835988	.	C	A	3	2	5	0	0	5	0	0
20	23836037	.	G	A	1	4	5	0	4	9	0	0
20	23836130	.	G	A	1	6	7	0	0	7	0	0
20	23836161	.	C	T	4	3	7	0	0	7	0	0
20	23836685	.	A	T	7	4	11	0	1	12	0	0
20	23836688	.	C	A	6	7	13	0	0	13	0	0
20	23836756	.	G	A	1	5	6	0	7	13	0	0
20	23836880	.	C	T	5	7	12	0	0	12	0	0
20	23836915	.	A	G	2	0	2	0	3	5	0	0
20	23839413	.	C	G	1	4	5	0	0	5	0	0
20	23856274	.	T	A	21	7	28	0	2	30	0	0
20	23856345	.	A	T	17	10	27	0	1	28	0	0
20	23857214	.	G	C	15	22	37	0	0	37	0	0
20	23857407	.	C	A	24	11	35	0	3	38	0	0
20	23857559	.	G	A	8	26	34	0	1	35	0	0
20	23857592	.	C	T	8	26	34	0	0	34	0	0
20	23859383	.	G	C	20	11	31	0	0	31	0	0
20	23859386	.	A	G	17	11	28	0	1	29	0	0
20	23859425	.	G	A	3	14	17	0	12	29	0	0
20	23859458	.	A	G	21	12	33	0	3	36	0	0
20	23859486	.	G	A	3	12	15	0	28	43	0	0
20	23861178	.	A	G	2	1	3	0	1	4	0	0
20	23877623	.	G	A	2	7	9	0	0	9	0	0
20	23879673	.	C	T	5	8	13	0	0	13	0	0
20	23879879	.	G	T	7	4	11	0	0	11	0	0
20	23879903	.	C	A	9	7	16	0	0	16	0	0
20	23881731	.	C	G	8	7	15	0	0	15	0	0
20	23882437	.	C	T	8	8	16	0	0	16	0	0
20	23883008	.	T	C	7	6	13	0	0	13	0	0
20	23883351	.	T	A	11	4	15	0	2	17	0	0
20	23883599	.	T	C	13	5	18	0	0	18	0	0
20	23884479	.	T	C	4	0	4	0	6	10	0	0
20	23885402	.	T	A	8	4	12	0	1	13	0	0
20	23885485	.	T	A	9	5	14	0	1	15	0	0
20	23885505	.	C	T	0	9	9	0	4	13	0	0
20	23885925	.	G	A	10	7	17	0	1	18	0	0
20	23886277	.	A	G	15	10	25	0	0	25	0	0
20	23886358	.	A	G	7	8	15	0	0	15	0	0
20	23888353	.	G	A	3	3	6	0	0	6	0	0
20	23888878	.	C	G	4	6	10	0	0	10	0	0
20	23890306	.	T	C	2	3	5	0	0	5	0	0
20	23890307	.	C	T	1	3	4	0	0	4	0	0
20	23890376	.	C	T	1	5	6	0	1	7	0	0
20	23890478	.	C	T	4	6	10	0	0	10	0	0
20	23890489	.	C	T	3	5	8	0	0	8	0	0
20	23892006	.	G	A	5	2	7	0	0	7	0	0
20	23892027	.	C	T	1	4	5	0	4	9	0	0
20	23892059	.	G	A	3	4	7	0	0	7	0	0
20	23897315	.	G	A	2	6	8	0	0	8	0	0
20	23897328	.	G	A	5	2	7	0	0	7	0	0
20	23897573	.	C	G	2	3	5	0	1	6	0	0
20	23902097	.	A	G	2	2	4	0	0	4	0	0
20	23903800	.	C	A	1	4	5	0	0	5	0	0
20	23904038	.	C	T	1	3	4	0	2	6	0	0
20	23904621	.	G	A	1	3	4	0	0	4	0	0
20	23947573	.	G	A	1	2	3	0	0	3	0	0
20	23951047	.	G	C	2	2	4	0	0	4	0	0
20	23951057	.	G	A	0	1	1	0	3	4	0	0
20	23951778	.	T	C	1	3	4	0	0	4	0	0
20	23952801	.	G	A	2	3	5	0	0	5	0	0
20	23953822	.	A	G	2	2	4	0	0	4	0	0
20	23954847	.	G	A	0	3	3	0	4	7	0	0
20	23955171	.	G	T	6	6	12	0	0	12	0	0
20	23955237	.	C	G	4	5	9	0	1	10	0	0
20	23955326	.	G	T	0	5	5	0	2	7	0	0
20	23972997	.	C	T	0	9	9	0	8	17	0	0
20	23973358	.	T	C	6	3	9	0	0	9	0	0
20	23973433	.	T	C	8	3	11	0	0	11	0	0
20	23974834	.	T	C	1	3	4	0	1	5	0	0
20	23974953	.	T	G	3	8	11	0	0	11	0	0
20	23975055	.	T	C	5	0	5	0	7	12	0	0
20	23978159	.	G	C	4	3	7	0	0	7	0	0
20	24122740	.	G	C	8	6	14	0	0	14	0	0
20	24151599	.	C	T	2	7	9	0	7	16	0	0
20	24152098	.	G	A	6	8	14	0	3	17	0	0
20	24152821	.	G	A	19	13	32	0	0	32	0	0
20	24152822	.	G	A	13	17	30	0	1	31	0	0
20	24175892	.	A	G	5	5	10	0	0	10	0	0
20	24180690	.	C	T	3	4	7	0	0	7	0	0
20	24182819	.	T	C	5	0	5	0	7	12	0	0
20	24182980	.	C	T	4	4	8	0	0	8	0	0
20	24183288	.	G	A	6	8	14	0	0	14	0	0
20	24818922	.	T	C	16	10	26	0	2	28	0	0
20	24819091	.	A	G	12	9	21	0	0	21	0	0
20	24819152	.	C	G	6	5	11	0	0	11	0	0
20	24819184	.	G	A	2	3	5	0	1	6	0	0
20	24819582	.	C	T	1	10	11	0	19	30	0	0
20	24819858	.	T	C	4	7	11	0	0	11	0	0
20	24820032	.	T	C	5	4	9	0	1	10	0	0
20	24820353	.	A	T	3	5	8	2	1	11	0	0
20	24820383	.	T	C	5	6	11	1	0	12	0	0
20	24820405	.	G	A	7	7	14	0	0	14	0	0
20	24820963	.	T	A	16	3	19	0	0	19	0	0
20	24821023	.	T	G	12	7	19	0	1	20	0	0
20	24821072	.	A	G	7	8	15	0	0	15	0	0
20	24821499	.	T	G	8	6	14	0	1	15	0	0
20	24835754	.	C	T	1	4	5	0	7	12	0	0
20	24841646	.	G	A	9	6	15	0	1	16	0	0
20	24849372	.	G	A	8	6	14	0	2	16	0	0
20	24849453	.	C	T	2	10	12	0	5	17	0	0
20	24852707	.	C	T	1	5	6	0	3	9	0	0
20	24915538	.	G	A	6	6	12	0	0	12	0	0
20	24915591	.	T	C	5	0	5	0	10	15	0	0
20	24915763	.	T	G	5	3	8	0	0	8	0	0
20	25271410	.	A	C	2	2	4	0	1	5	0	0
20	25271776	.	T	A	0	3	3	0	1	4	0	0
20	25342837	.	G	A	0	6	6	0	6	12	0	0
20	25368785	.	A	G	1	2	3	0	0	3	0	0
20	25371869	.	A	G	1	2	3	0	0	3	0	0
20	25371914	.	C	T	0	4	4	0	1	5	0	0
20	25378556	.	C	T	5	3	8	0	0	8	0	0
20	25378610	.	C	T	5	3	8	0	0	8	0	0
20	25384473	.	A	T	3	4	7	0	0	7	0	0
20	25384494	.	G	A	2	3	5	0	1	6	0	0
20	25387850	.	T	A	3	4	7	0	0	7	0	0
20	25440628	.	T	G	5	3	8	0	2	10	0	0
20	25440648	.	C	G	8	5	13	0	0	13	0	0
20	25440668	.	T	C	8	8	16	0	0	16	0	0
20	25440724	.	G	T	7	6	13	0	1	14	0	0
20	25440731	.	G	A	8	6	14	0	0	14	0	0
20	25440790	.	A	C	12	6	18	0	0	18	0	0
20	25441033	.	G	T	9	13	22	0	0	22	0	0
20	25444903	.	G	A	6	9	15	0	0	15	0	0
20	25444929	.	A	G	8	7	15	0	0	15	0	0
20	25444943	.	G	A	9	8	17	0	0	17	0	0
20	25489625	.	C	T	6	9	15	0	0	15	0	0
20	25494432	.	G	A	7	4	11	0	1	12	0	0
20	25499025	.	G	T	10	3	13	0	0	13	0	0
20	25510331	.	A	G	15	4	19	0	0	19	0	0
20	25557127	.	C	T	1	2	3	0	0	3	0	0
20	25557190	.	G	A	1	1	2	0	0	2	0	0
20	25557194	.	A	C	1	2	3	0	0	3	0	0
20	25568000	.	G	T	4	4	8	0	0	8	0	0
20	25568058	.	G	C	3	2	5	0	0	5	0	0
20	25568719	.	A	T	2	4	6	0	0	6	0	0
20	25586333	.	A	T	4	2	6	0	0	6	0	0
20	25587610	.	T	C	2	3	5	0	0	5	0	0
20	25591248	.	A	G	2	5	7	0	0	7	0	0
20	25593109	.	C	T	4	4	8	0	0	8	0	0
20	25618330	.	G	A	6	5	11	0	0	11	0	0
20	25618601	.	T	A	6	11	17	0	1	18	0	0
20	25618908	.	G	A	8	9	17	0	0	17	0	0
20	25619965	.	G	A	9	5	14	0	0	14	0	0
20	25621633	.	G	A	8	8	16	0	0	16	0	0
20	25623770	.	A	T	5	7	12	0	1	13	0	0
20	25623778	.	A	T	8	6	14	0	0	14	0	0
20	25623921	.	C	T	1	6	7	0	3	10	0	0
20	25628390	.	C	T	0	4	4	0	1	5	0	0
20	25630961	.	G	A	4	6	10	0	0	10	0	0
20	25630962	.	G	T	4	6	10	0	0	10	0	0
20	25637658	.	G	C	1	3	4	0	0	4	0	0
20	25649859	.	C	T	2	2	4	0	0	4	0	0
20	25649871	.	A	C	2	2	4	0	0	4	0	0
20	25655126	.	A	G	1	0	1	0	2	3	0	0
20	25655468	.	G	A	2	2	4	0	0	4	0	0
20	25660441	.	A	G	17	15	32	0	0	32	0	0
20	25661199	.	A	G	10	15	25	0	2	27	0	0
20	25661396	.	G	A	13	12	25	0	1	26	0	0
20	25661403	.	T	G	15	5	20	0	1	21	0	0
20	25661509	.	G	A	16	18	34	0	1	35	0	0
20	25665325	.	T	G	8	9	17	0	0	17	0	0
20	25666402	.	A	T	17	13	30	0	1	31	0	0
20	25666524	.	T	C	6	6	12	0	1	13	0	0
20	25669512	.	T	C	10	8	18	0	2	20	0	0
20	25709311	.	C	T	1	8	9	0	3	12	0	0
20	25726388	.	T	C	3	5	8	0	0	8	0	0
20	25729595	.	C	A	4	2	6	0	0	6	0	0
20	25729819	.	G	T	3	4	7	0	0	7	0	0
20	25734829	.	T	G	3	2	5	0	0	5	0	0
20	25735011	.	G	A	1	2	3	0	2	5	0	0
20	25853191	.	T	C	3	5	8	0	0	8	0	0
20	25875221	.	T	C	9	1	10	0	6	16	0	0
20	25877666	.	G	A	5	10	15	0	0	15	0	0
20	25877787	.	A	T	9	4	13	0	0	13	0	0
20	25890314	.	A	G	1	2	3	0	0	3	0	0
20	25890315	.	T	C	1	2	3	0	0	3	0	0
20	25904259	.	G	A	6	3	9	0	0	9	0	0
20	25906480	.	A	T	6	3	9	0	0	9	0	0
20	25907347	.	G	C	5	2	7	0	0	7	0	0
20	25909276	.	T	C	8	8	16	0	0	16	0	0
20	25909661	.	C	A	13	7	20	0	0	20	0	0
20	25910099	.	C	T	7	7	14	0	1	15	0	0
20	25910368	.	A	T	5	5	10	0	0	10	0	0
20	25921009	.	C	T	13	5	18	0	0	18	0	0
20	25926688	.	C	A	11	5	16	0	0	16	0	0
20	25927310	.	A	G	20	10	30	0	1	31	0	0
20	25937642	.	G	A	1	2	3	0	0	3	0	0
20	26023822	.	T	C	2	6	8	0	0	8	0	0
20	26268443	.	T	C	1	5	6	0	0	6	0	0
20	26269970	.	C	T	3	2	5	0	0	5	0	0
20	26270488	.	T	C	7	3	10	0	0	10	0	0
20	26270730	.	A	G	2	4	6	0	0	6	0	0
20	26271357	.	G	T	1	4	5	0	6	11	0	0
20	26275207	.	A	T	2	10	12	0	1	13	0	0
20	26279961	.	A	C	3	2	5	0	0	5	0	0
20	26282602	.	C	G	6	3	9	0	0	9	0	0
20	26289484	.	C	T	6	3	9	0	0	9	0	0
20	26289485	.	A	T	6	3	9	0	0	9	0	0
20	26289572	.	G	A	0	3	3	0	2	5	0	0
20	26305019	.	A	T	10	8	18	0	0	18	0	0
20	26310596	.	T	A	7	2	9	0	1	10	0	0
20	26320221	.	C	T	10	11	21	0	0	21	0	0
20	26321073	.	G	A	12	7	19	0	0	19	0	0
20	26324196	.	T	G	16	4	20	0	2	22	0	0
20	26324307	.	T	A	14	17	31	0	0	31	0	0
20	26325380	.	A	G	13	14	27	1	1	29	0	0
20	26325481	.	T	A	8	15	23	0	1	24	0	0
20	26325493	.	T	C	12	11	23	0	1	24	0	0
20	26329035	.	G	A	8	6	14	0	1	15	0	0
20	26331683	.	C	T	17	12	29	0	2	31	0	0
20	26334414	.	A	G	14	21	35	0	1	36	0	0
20	26334446	.	C	T	15	16	31	0	3	34	0	0
20	26337790	.	C	A	25	19	44	0	1	45	0	0
20	26342889	.	C	T	17	15	32	0	0	32	0	0
20	26345230	.	C	T	19	17	36	0	1	37	0	0
20	26345856	.	T	A	26	18	44	0	2	46	0	0
20	26346710	.	C	T	29	20	49	0	2	51	0	0
20	26353770	.	A	G	19	19	38	0	3	41	0	0
20	26358743	.	G	A	27	17	44	0	1	45	0	0
20	26358964	.	G	A	22	17	39	0	1	40	0	0
20	26360125	.	T	G	2	2	4	0	0	4	0	0
20	26360333	.	A	G	4	2	6	0	1	7	0	0
20	26360470	.	A	G	2	8	10	0	0	10	0	0
20	26360594	.	A	T	0	3	3	0	1	4	0	0
20	26361200	.	C	T	1	4	5	0	0	5	0	0
20	26361333	.	C	T	0	3	3	0	1	4	0	0
20	26382021	.	T	G	0	2	2	0	2	4	0	0
20	26382028	.	C	G	2	2	4	0	0	4	0	0
20	26382274	.	C	A	1	2	3	0	0	3	0	0
20	26387181	.	G	A	11	9	20	0	0	20	0	0
20	26387288	.	T	A	13	6	19	0	2	21	0	0
20	26390906	.	C	T	4	6	10	0	0	10	0	0
20	26390912	.	G	A	4	6	10	0	0	10	0	0
20	26404155	.	C	T	5	5	10	0	1	11	0	0
20	26404281	.	A	G	2	0	2	0	7	9	0	0
20	26404361	.	C	G	4	2	6	0	0	6	0	0
20	26404369	.	G	A	3	5	8	0	0	8	0	0
20	26404443	.	G	A	0	3	3	0	5	8	0	0
20	26404479	.	C	T	4	7	11	0	0	11	0	0
20	26404645	.	C	T	5	4	9	0	0	9	0	0
20	26404696	.	G	A	0	3	3	0	6	9	0	0
20	26404753	.	C	A	6	3	9	0	0	9	0	0
20	26404860	.	T	A	7	9	16	0	0	16	0	0
20	26405121	.	G	A	0	3	3	0	7	10	0	0
20	26405356	.	A	T	4	5	9	0	0	9	0	0
20	26405382	.	C	T	3	2	5	0	0	5	0	0
20	26405485	.	A	T	2	3	5	0	0	5	0	0
20	26405808	.	T	A	1	3	4	0	0	4	0	0
20	26406160	.	G	A	0	6	6	0	1	7	0	0
20	26406252	.	T	C	6	5	11	0	0	11	0	0
20	26406640	.	G	T	1	4	5	0	3	8	0	0
20	26406792	.	T	A	2	2	4	0	0	4	0	0
20	26406806	.	C	T	3	2	5	0	0	5	0	0
20	26409194	.	T	A	11	5	16	0	0	16	0	0
20	26409261	.	C	A	0	5	5	0	12	18	1	0
20	26409295	.	C	A	9	9	18	0	0	18	0	0
20	26409310	.	A	T	8	7	15	0	2	17	0	0
20	26409372	.	T	G	8	6	14	0	0	14	0	0
20	26409471	.	C	T	1	14	15	1	11	27	0	0
20	26409723	.	C	T	17	19	36	0	0	36	0	0
20	26409922	.	T	C	10	22	32	0	0	32	0	0
20	26409991	.	G	A	15	15	30	0	1	31	0	0
20	26410224	.	G	T	9	15	24	0	0	24	0	0
20	26410275	.	G	A	10	10	20	0	0	20	0	0
20	26410341	.	A	G	18	14	32	0	2	34	0	0
20	26410344	.	A	C	19	14	33	0	1	34	0	0
20	26412372	.	T	A	16	10	26	0	0	26	0	0
20	26412479	.	C	T	19	6	25	0	0	25	0	0
20	26412579	.	C	A	10	17	27	0	1	28	0	0
20	26412876	.	G	A	17	15	32	0	2	34	0	0
20	26412968	.	T	A	21	13	34	0	0	34	0	0
20	26413038	.	C	T	8	14	22	0	1	23	0	0
20	26413057	.	G	A	19	6	25	0	0	25	0	0
20	26413269	.	C	A	16	9	25	0	0	25	0	0
20	26413280	.	A	C	15	0	15	0	10	25	0	0
20	26413311	.	C	T	15	11	26	0	1	27	0	0
20	26413470	.	G	T	9	8	17	0	0	17	0	0
20	26413640	.	C	A	5	11	16	0	0	16	0	0
20	26413923	.	C	T	10	6	16	0	0	16	0	0
20	26413998	.	A	T	19	6	25	0	0	25	0	0
20	26414724	.	C	T	0	8	8	0	7	15	0	0
20	26414747	.	C	T	6	9	15	0	2	17	0	0
20	26414832	.	C	T	10	6	16	0	2	18	0	0
20	26414844	.	G	A	14	7	21	0	0	21	0	0
20	26414919	.	A	G	13	8	21	0	0	21	0	0
20	26415760	.	G	A	5	5	10	0	1	11	0	0
20	26416068	.	G	C	9	0	9	0	7	16	0	0
20	26416265	.	C	T	4	4	8	0	0	8	0	0
20	26416266	.	T	A	4	4	8	0	0	8	0	0
20	26416469	.	C	G	3	6	9	0	0	9	0	0
20	26416514	.	T	C	4	7	11	0	0	11	0	0
20	26416515	.	C	T	7	3	10	0	0	10	0	0
20	26416551	.	A	T	4	5	9	0	0	9	0	0
20	26467216	.	C	T	6	13	19	0	0	19	0	0
20	26574266	.	C	T	10	12	22	0	1	23	0	0
20	26583972	.	T	C	11	11	22	0	0	22	0	0
20	26584155	.	A	T	6	9	15	0	0	15	0	0
20	26587834	.	A	G	9	10	19	0	1	20	0	0
20	26594516	.	G	T	4	6	10	0	1	11	0	0
20	26597977	.	G	A	12	8	20	0	1	21	0	0
20	26599709	.	C	T	10	3	13	0	1	14	0	0
20	26601222	.	G	A	9	14	23	0	0	23	0	0
20	26610433	.	G	A	13	7	20	0	1	21	0	0
20	26613462	.	A	G	12	11	23	0	2	25	0	0
20	26616241	.	G	C	7	0	7	0	10	17	0	0
20	26775892	.	G	A	8	14	22	0	2	24	0	0
20	26809059	.	A	G	6	10	16	0	0	16	0	0
20	26822389	.	A	G	12	8	20	0	0	20	0	0
20	26822449	.	A	G	11	7	18	0	0	18	0	0
20	26894963	.	C	G	1	2	3	0	0	3	0	0
20	26894965	.	G	C	1	2	3	0	0	3	0	0
20	26902089	.	G	A	3	2	5	0	0	5	0	0
20	26907857	.	T	C	5	4	9	0	0	9	0	0
20	26907893	.	C	T	2	6	8	0	0	8	0	0
20	26913236	.	G	T	1	4	5	0	1	6	0	0
20	26939926	.	C	T	8	17	25	0	0	25	0	0
20	26944106	.	G	A	12	20	32	0	1	33	0	0
20	26944311	.	G	A	14	19	33	0	12	45	0	0
20	26944576	.	C	T	12	15	27	0	1	28	0	0
20	26944762	.	C	T	11	13	24	0	3	27	0	0
20	26944951	.	C	T	9	5	14	0	1	15	0	0
20	26945115	.	A	T	0	15	15	0	0	15	0	0
20	26945394	.	C	T	11	9	20	0	1	21	0	0
20	26945735	.	C	T	6	10	16	0	0	16	0	0
20	26945793	.	T	A	12	7	19	1	0	20	0	0
20	26945950	.	T	A	7	6	13	0	1	14	0	0
20	26947873	.	T	G	3	2	5	0	1	6	0	0
20	26948161	.	A	G	6	12	18	0	0	18	0	0
20	26958653	.	C	A	7	6	13	0	1	14	0	0
20	26958685	.	A	G	8	10	18	0	1	19	0	0
20	26959624	.	C	T	7	3	10	0	0	10	0	0
20	26959829	.	C	T	10	6	16	0	0	16	0	0
20	26959955	.	A	C	3	6	9	1	2	12	0	0
20	26960039	.	T	G	6	14	20	0	0	20	0	0
20	26960371	.	T	C	6	6	12	0	0	12	0	0
20	26960430	.	C	T	4	3	7	0	0	7	0	0
20	26961160	.	A	G	7	3	10	0	0	10	0	0
20	26961469	.	A	G	4	3	7	0	4	11	0	0
20	26961694	.	A	T	4	2	6	0	1	7	0	0
20	26961719	.	T	A	6	4	10	0	1	11	0	0
20	26961758	.	A	T	5	7	12	0	1	13	0	0
20	26961862	.	T	C	3	16	19	0	1	20	0	0
20	26962095	.	T	C	4	10	14	0	1	15	0	0
20	26962119	.	T	C	12	8	20	0	0	20	0	0
20	26962290	.	G	T	8	9	17	0	1	18	0	0
20	26962318	.	G	A	1	10	11	0	7	18	0	0
20	26991400	.	C	A	6	5	11	0	0	11	0	0
20	26992102	.	G	A	3	5	8	0	0	8	0	0
20	26993506	.	C	T	5	7	12	0	0	12	0	0
20	26999506	.	T	A	6	6	12	0	0	12	0	0
20	27001816	.	A	C	11	11	22	0	3	26	1	0
20	27002595	.	T	G	8	3	11	0	0	11	0	0
20	27002769	.	T	A	5	4	9	0	1	10	0	0
20	27002989	.	G	A	4	12	16	0	0	16	0	0
20	27020294	.	T	A	19	24	43	0	1	44	0	0
20	27020346	.	A	C	13	17	30	0	2	32	0	0
20	27020442	.	G	T	20	20	40	0	0	40	0	0
20	27029685	.	A	C	22	19	41	0	1	42	0	0
20	27033847	.	A	T	21	25	46	1	2	49	0	0
20	27033914	.	A	G	20	24	44	4	1	49	0	0
20	27039339	.	A	C	29	34	63	0	2	65	0	0
20	27039364	.	G	T	5	30	35	0	35	70	0	0
20	27039498	.	C	T	26	35	61	0	0	61	0	0
20	27039523	.	C	T	34	16	50	0	2	52	0	0
20	27045501	.	G	A	23	35	58	0	1	59	0	0
20	27045649	.	T	G	34	7	41	0	24	65	0	0
20	27045858	.	T	A	14	9	23	0	0	23	0	0
20	27045875	.	T	C	8	12	20	0	2	22	0	0
20	27087569	.	C	T	8	3	11	0	1	12	0	0
20	27087600	.	T	A	10	12	22	0	0	22	0	0
20	27089281	.	C	T	5	3	8	0	0	8	0	0
20	27089613	.	T	C	4	6	10	0	0	10	0	0
20	27089674	.	A	G	4	4	8	0	0	8	0	0
20	27089717	.	C	T	2	2	4	0	0	4	0	0
20	27089954	.	G	A	7	5	12	0	1	13	0	0
20	27089995	.	C	T	2	2	4	0	0	4	0	0
20	27090240	.	A	C	2	4	6	0	0	6	0	0
20	27090401	.	C	T	6	6	12	0	0	12	0	0
20	27090409	.	C	T	9	6	15	0	0	15	0	0
20	27090525	.	T	G	4	8	12	0	0	12	0	0
20	27090648	.	C	T	6	3	9	0	0	9	0	0
20	27091179	.	T	A	7	3	10	0	0	10	0	0
20	27091206	.	G	A	10	6	16	0	1	17	0	0
20	27092231	.	C	T	11	13	24	0	0	24	0	0
20	27093159	.	T	G	7	4	11	0	0	11	0	0
20	27093219	.	T	C	3	2	5	0	0	5	0	0
20	27093269	.	G	C	3	3	6	0	0	6	0	0
20	27093286	.	C	T	4	3	7	0	0	7	0	0
20	27093335	.	G	A	6	7	13	0	0	13	0	0
20	27094693	.	T	C	7	5	12	0	1	13	0	0
20	27096092	.	A	T	7	16	23	0	1	24	0	0
20	27096400	.	C	A	10	11	21	0	1	22	0	0
20	27100011	.	A	T	8	13	21	0	1	22	0	0
20	27104562	.	C	T	11	8	19	0	0	19	0	0
20	27107089	.	C	T	12	8	20	0	0	20	0	0
20	27107140	.	C	A	8	10	18	0	0	18	0	0
20	27107241	.	C	A	8	4	12	0	1	13	0	0
20	27107572	.	C	G	3	2	5	0	0	5	0	0
20	27116869	.	G	T	3	2	5	0	0	5	0	0
20	27194884	.	C	A	5	4	9	0	0	9	0	0
20	27194918	.	T	C	6	4	10	0	0	10	0	0
20	27198019	.	G	A	1	3	4	0	0	4	0	0
20	27198040	.	A	T	1	2	3	0	0	3	0	0
20	27264482	.	G	A	4	4	8	0	0	8	0	0
20	27280808	.	G	A	7	2	9	0	0	9	0	0
20	27280840	.	G	A	1	5	6	0	3	9	0	0
20	27280859	.	C	G	5	0	5	0	4	9	0	0
20	27281295	.	T	A	0	3	3	0	0	3	0	0
20	27281624	.	T	C	2	7	9	0	0	9	0	0
20	27281780	.	T	G	1	3	4	1	0	5	0	0
20	27282592	.	A	G	14	5	19	0	1	20	0	0
20	27282788	.	C	A	1	4	5	0	0	5	0	0
20	27282886	.	T	A	3	4	7	0	0	7	0	0
20	27282906	.	A	T	3	4	7	0	0	7	0	0
20	27282929	.	T	C	4	2	6	0	0	6	0	0
20	27283404	.	A	C	3	6	9	0	0	9	0	0
20	27283604	.	G	A	4	8	12	0	0	12	0	0
20	27321971	.	T	C	1	2	3	0	0	3	0	0
20	27331149	.	G	A	7	11	18	0	1	19	0	0
20	27352584	.	T	C	8	5	13	0	0	13	0	0
20	27352591	.	A	G	9	0	9	0	4	13	0	0
20	27353040	.	T	C	7	10	17	0	0	17	0	0
20	27353250	.	G	A	14	8	22	0	0	22	0	0
20	27353265	.	C	T	10	10	20	0	0	20	0	0
20	27355748	.	C	T	5	5	10	0	1	11	0	0
20	27358777	.	C	A	13	6	19	0	0	19	0	0
20	27358859	.	G	A	15	13	28	0	2	30	0	0
20	27528655	.	C	A	1	2	3	0	0	3	0	0
20	27528660	.	T	C	1	2	3	0	0	3	0	0
20	27537750	.	G	A	2	2	4	0	0	4	0	0
20	27539635	.	C	A	3	2	5	0	0	5	0	0
20	27540367	.	G	A	3	1	4	0	2	6	0	0
20	27541949	.	G	A	4	3	7	0	0	7	0	0
20	27541954	.	G	A	0	3	3	0	4	7	0	0
20	27542005	.	G	A	1	1	2	0	4	6	0	0
20	27542371	.	G	A	0	4	4	0	3	7	0	0
20	27546032	.	C	T	1	4	5	0	1	6	0	0
20	27549524	.	G	A	2	3	5	0	0	5	0	0
20	27549968	.	A	G	1	4	5	0	0	5	0	0
20	27550148	.	C	T	2	2	4	0	1	5	0	0
20	27550150	.	A	C	3	2	5	0	0	5	0	0
20	27550866	.	G	A	2	5	7	0	1	8	0	0
20	27550959	.	G	A	2	3	5	0	0	5	0	0
20	27551123	.	G	T	3	3	6	0	0	6	0	0
20	27551363	.	G	A	3	9	12	0	0	12	0	0
20	27677739	.	G	A	0	2	2	0	1	3	0	0
20	27692330	.	G	T	1	2	3	0	0	3	0	0
20	27692347	.	A	G	2	2	4	0	0	4	0	0
20	27693194	.	G	A	0	4	4	0	1	5	0	0
20	27693204	.	T	G	2	4	6	0	0	6	0	0
20	27707974	.	G	A	4	4	8	0	0	8	0	0
20	27708016	.	G	A	3	6	9	0	0	9	0	0
20	27708306	.	A	G	6	5	11	0	2	13	0	0
20	27708943	.	G	A	4	5	9	0	0	9	0	0
20	27712847	.	T	C	3	3	6	0	0	6	0	0
20	27717055	.	T	A	3	6	9	0	0	9	0	0
20	27717493	.	A	G	2	8	10	0	0	10	0	0
20	27717884	.	G	A	4	2	6	0	0	6	0	0
20	27717945	.	C	T	1	2	3	0	1	4	0	0
20	27718549	.	T	A	2	2	4	0	0	4	0	0
20	27718578	.	A	T	2	3	5	0	0	5	0	0
20	27718734	.	A	G	1	2	3	0	0	3	0	0
20	27718751	.	T	G	1	4	5	0	0	5	0	0
20	27718824	.	C	G	1	4	5	0	0	5	0	0
20	27719763	.	G	A	9	3	12	0	1	13	0	0
20	27719859	.	T	C	4	3	7	2	1	10	0	0
20	27732628	.	A	G	3	5	8	0	0	8	0	0
20	27732832	.	A	G	2	13	15	0	0	15	0	0
20	27733034	.	G	A	6	11	17	0	3	20	0	0
20	27733650	.	C	A	1	3	4	0	5	9	0	0
20	28294732	.	G	T	5	6	11	0	0	11	0	0
20	28310920	.	A	G	7	4	11	0	0	11	0	0
20	28322943	.	C	T	4	3	7	0	0	7	0	0
20	28324826	.	G	T	2	3	5	0	0	5	0	0
20	28326283	.	A	T	3	4	7	0	0	7	0	0
20	28326565	.	T	C	3	3	6	0	0	6	0	0
20	28331772	.	C	T	3	4	7	0	1	8	0	0
20	28337616	.	G	A	0	2	2	0	1	3	0	0
20	28337640	.	A	G	0	3	3	0	1	4	0	0
20	28349054	.	T	G	2	2	4	0	0	4	0	0
20	28354368	.	A	G	3	2	5	0	1	6	0	0
20	28354549	.	T	A	6	6	12	0	0	12	0	0
20	28354588	.	A	G	6	6	12	0	2	14	0	0
20	28354951	.	A	G	7	6	13	0	1	14	0	0
20	28356989	.	T	C	4	12	16	0	0	16	0	0
20	28356998	.	G	A	4	10	14	0	2	16	0	0
20	28357028	.	A	G	6	10	16	0	1	17	0	0
20	28357184	.	A	G	7	5	12	0	0	12	0	0
20	28357190	.	C	T	8	6	14	0	0	14	0	0
20	28357463	.	A	G	13	4	17	0	1	18	0	0
20	28357538	.	G	A	7	5	12	0	1	13	0	0
20	28357570	.	A	G	5	6	11	0	1	12	0	0
20	28357610	.	A	G	7	9	16	0	1	17	0	0
20	28357688	.	T	C	2	9	11	0	0	11	0	0
20	28357823	.	T	A	5	10	15	0	0	15	0	0
20	28357883	.	C	T	3	3	6	0	0	6	0	0
20	28358060	.	C	G	6	2	8	0	0	8	0	0
20	28358333	.	T	C	2	4	6	0	1	7	0	0
20	28361044	.	C	T	3	8	11	0	0	11	0	0
20	28361428	.	A	T	1	4	5	0	0	5	0	0
20	28399924	.	A	G	1	3	4	0	0	4	0	0
20	28399987	.	C	A	0	3	3	0	1	4	0	0
20	28400232	.	A	T	4	3	7	0	1	8	0	0
20	28400380	.	A	T	5	2	7	0	1	8	0	0
20	28400422	.	C	T	2	7	9	0	0	9	0	0
20	28400481	.	A	G	6	7	13	0	0	13	0	0
20	28400619	.	G	A	14	18	32	0	0	32	0	0
20	28401147	.	A	G	20	11	31	0	0	31	0	0
20	28401298	.	C	G	6	7	13	0	0	15	2	0
20	28401309	.	C	T	7	8	15	0	0	15	0	0
20	28401587	.	G	A	6	4	10	0	0	10	0	0
20	28401639	.	T	A	5	3	8	0	0	8	0	0
20	28401664	.	C	T	4	3	7	0	0	7	0	0
20	28402253	.	G	A	11	6	17	0	0	17	0	0
20	28402426	.	G	A	8	3	11	0	0	11	0	0
20	28402456	.	A	G	8	5	13	0	0	13	0	0
20	28402470	.	G	A	5	5	10	0	1	11	0	0
20	28404191	.	A	G	2	6	8	0	0	8	0	0
20	28404247	.	T	C	8	0	8	0	3	11	0	0
20	28404270	.	T	G	9	6	15	0	2	17	0	0
20	28404342	.	G	A	6	3	9	0	0	9	0	0
20	28408028	.	C	T	5	6	11	0	0	11	0	0
20	28409601	.	C	T	3	2	5	0	0	5	0	0
20	28411204	.	A	G	1	4	5	0	0	5	0	0
20	28411688	.	T	C	3	3	6	0	1	7	0	0
20	28414423	.	T	C	8	4	12	0	0	12	0	0
20	28418587	.	C	T	9	3	12	0	1	13	0	0
20	28418730	.	A	T	5	6	11	0	1	12	0	0
20	28418741	.	A	G	6	1	7	0	5	12	0	0
20	28418939	.	T	C	3	10	13	0	1	14	0	0
20	28419015	.	A	T	6	8	14	0	0	14	0	0
20	28419755	.	G	C	3	3	6	0	0	6	0	0
20	28419767	.	C	A	2	4	6	0	0	6	0	0
20	28419807	.	T	A	4	4	8	0	0	8	0	0
20	28420010	.	C	T	1	3	4	0	0	4	0	0
20	28420496	.	C	T	8	7	15	0	0	15	0	0
20	28422920	.	A	G	2	5	7	0	0	7	0	0
20	28422927	.	T	C	3	0	3	0	5	8	0	0
20	28423035	.	G	T	4	6	10	0	1	11	0	0
20	28423062	.	G	A	4	3	7	0	1	8	0	0
20	28423072	.	A	T	5	4	9	0	1	10	0	0
20	28424806	.	A	G	4	2	6	0	1	7	0	0
20	28456574	.	T	C	11	10	21	0	0	21	0	0
20	28469982	.	A	G	10	9	19	0	0	19	0	0
20	28470057	.	T	C	11	8	19	0	0	19	0	0
20	28476107	.	T	C	10	5	15	0	1	16	0	0
20	28487287	.	T	C	7	6	13	0	0	13	0	0
20	28514841	.	A	G	6	6	12	0	0	12	0	0
20	28514878	.	T	C	11	6	17	0	0	17	0	0
20	28514955	.	C	T	10	11	21	0	1	22	0	0
20	28519167	.	G	T	6	7	13	0	0	13	0	0
20	28541670	.	A	G	8	8	16	0	1	17	0	0
20	28541754	.	A	G	4	8	12	0	0	12	0	0
20	28641940	.	A	T	9	10	19	0	1	20	0	0
20	28641997	.	T	A	3	3	6	0	0	6	0	0
20	28642007	.	G	A	1	2	3	0	0	3	0	0
20	28650323	.	T	C	13	8	21	0	2	23	0	0
20	28650328	.	A	C	16	9	25	0	0	25	0	0
20	28650945	.	A	T	18	12	30	0	1	31	0	0
20	28650946	.	T	G	17	11	28	0	3	31	0	0
20	28651194	.	C	T	24	12	36	0	1	37	0	0
20	28651239	.	A	G	24	10	34	0	4	38	0	0
20	28651454	.	G	A	22	21	43	0	0	43	0	0
20	28651709	.	T	C	18	0	18	0	15	33	0	0
20	28651958	.	T	G	7	10	17	0	2	19	0	0
20	28652449	.	G	C	18	17	35	0	1	36	0	0
20	28654339	.	G	A	19	15	34	0	1	35	0	0
20	28658666	.	A	C	10	14	24	0	3	27	0	0
20	28658693	.	T	C	9	0	9	0	14	23	0	0
20	28659924	.	A	G	12	8	20	0	0	20	0	0
20	28659969	.	G	T	10	10	20	0	1	21	0	0
20	28660050	.	G	A	14	6	20	0	0	20	0	0
20	28660729	.	T	C	6	0	6	0	6	12	0	0
20	28660795	.	G	A	10	9	19	0	0	19	0	0
20	28660828	.	G	T	11	7	18	0	0	18	0	0
20	28660837	.	T	C	11	7	18	0	0	18	0	0
20	28675587	.	C	A	0	10	10	0	4	14	0	0
20	28677911	.	G	T	8	5	13	0	6	19	0	0
20	28682989	.	T	C	5	3	8	0	1	9	0	0
20	28693295	.	C	T	7	5	12	0	1	13	0	0
20	28697047	.	C	T	0	5	5	0	6	11	0	0
20	28697073	.	C	T	1	4	5	0	5	10	0	0
20	28697848	.	T	C	1	6	7	0	0	7	0	0
20	28698284	.	T	C	2	0	2	0	5	7	0	0
20	28783046	.	T	C	13	9	22	0	0	22	0	0
20	28783327	.	T	C	8	6	14	0	0	14	0	0
20	28783502	.	C	G	8	9	17	0	0	17	0	0
20	28783607	.	T	C	9	0	9	0	10	19	0	0
20	28783627	.	T	C	11	13	24	0	1	25	0	0
20	28783688	.	C	A	14	16	30	0	1	31	0	0
20	28783781	.	A	C	16	0	16	0	8	24	0	0
20	28783999	.	G	T	11	4	15	0	1	16	0	0
20	28784045	.	G	T	15	4	19	0	2	21	0	0
20	28800961	.	A	G	16	9	25	0	1	26	0	0
20	28804089	.	G	A	8	15	23	0	0	23	0	0
20	28814902	.	T	C	5	6	11	0	0	11	0	0
20	28817492	.	A	G	5	3	8	0	0	8	0	0
20	28822696	.	T	A	5	4	9	0	0	9	0	0
20	28822735	.	T	C	2	11	13	0	1	14	0	0
20	28823116	.	T	C	4	15	19	0	0	19	0	0
20	28825375	.	C	T	17	8	25	0	1	26	0	0
20	28827208	.	A	G	7	12	19	0	0	19	0	0
20	28827350	.	T	C	3	11	14	0	2	16	0	0
20	28827388	.	C	A	9	6	15	0	1	16	0	0
20	28827416	.	C	T	11	5	16	0	1	17	0	0
20	28827433	.	A	C	9	6	15	0	1	16	0	0
20	28827633	.	T	C	9	5	14	0	1	15	0	0
20	28833245	.	C	T	11	21	32	0	0	32	0	0
20	28833312	.	C	A	16	22	38	0	4	42	0	0
20	28833793	.	A	G	21	17	38	0	2	40	0	0
20	28833878	.	T	C	22	0	22	0	23	45	0	0
20	28834008	.	C	T	20	20	40	0	3	43	0	0
20	28834536	.	C	A	5	5	10	0	0	10	0	0
20	28835046	.	A	T	1	4	5	0	0	5	0	0
20	28835101	.	T	G	1	5	6	0	0	7	1	0
20	28870806	.	C	G	31	21	52	0	2	54	0	0
20	28870843	.	T	C	35	19	54	0	2	56	0	0
20	28871830	.	G	A	39	33	72	0	2	74	0	0
20	28875824	.	T	C	15	0	15	0	21	36	0	0
20	28876885	.	G	A	6	29	35	0	1	36	0	0
20	28876899	.	A	G	7	22	29	0	2	31	0	0
20	28876942	.	T	A	19	13	32	0	0	32	0	0
20	28876971	.	A	C	7	0	7	0	25	32	0	0
20	28876996	.	T	A	7	21	28	0	1	29	0	0
20	28877028	.	C	T	5	20	25	0	0	25	0	0
20	28877085	.	T	A	9	20	29	0	0	29	0	0
20	28877136	.	A	T	8	15	23	0	0	23	0	0
20	28877696	.	T	C	16	0	16	0	24	40	0	0
20	28878097	.	T	G	10	15	25	0	0	25	0	0
20	28878229	.	T	A	3	6	9	0	0	9	0	0
20	28884768	.	T	A	16	25	41	0	0	41	0	0
20	28886159	.	A	T	5	9	14	0	0	14	0	0
20	28886311	.	T	C	18	9	27	0	0	27	0	0
20	28886530	.	C	T	16	5	21	0	4	26	1	0
20	28886608	.	C	A	5	5	10	0	1	11	0	0
20	28886618	.	C	A	6	3	9	0	0	9	0	0
20	28886735	.	T	C	13	13	26	0	2	28	0	0
20	28886771	.	A	C	10	15	25	0	1	26	0	0
20	28886991	.	T	A	4	4	8	0	0	8	0	0
20	28887001	.	G	T	1	2	3	0	0	3	0	0
20	28887498	.	T	A	14	19	33	0	3	36	0	0
20	28887590	.	G	C	14	10	24	0	1	26	1	0
20	28888012	.	C	A	7	9	16	0	0	16	0	0
20	28888041	.	A	T	12	6	18	0	2	20	0	0
20	28888198	.	G	C	6	1	7	0	6	13	0	0
20	28888331	.	T	A	10	11	21	0	1	22	0	0
20	28888514	.	C	G	3	4	7	0	2	9	0	0
20	28888629	.	T	G	10	10	20	0	1	21	0	0
20	28888743	.	T	A	10	2	12	0	5	18	1	0
20	28889248	.	G	T	11	12	23	0	0	23	0	0
20	28889306	.	A	G	11	11	22	0	0	22	0	0
20	28897255	.	G	A	10	6	16	0	2	18	0	0
20	28897595	.	A	G	11	8	19	0	1	20	0	0
20	28935493	.	G	A	4	3	7	0	0	7	0	0
20	28935863	.	A	G	2	2	4	0	0	4	0	0
20	28935902	.	A	G	2	2	4	0	1	5	0	0
20	28938383	.	C	T	3	2	5	0	1	6	0	0
20	28973834	.	T	C	9	6	15	0	0	15	0	0
20	29216103	.	G	T	5	2	7	0	0	7	0	0
20	29268260	.	A	G	7	5	12	0	1	13	0	0
20	30878013	.	G	A	4	2	6	0	0	6	0	0
20	30878590	.	T	A	1	2	3	0	0	3	0	0
20	30879211	.	C	T	10	4	14	0	0	14	0	0
20	30879494	.	G	A	6	5	11	0	2	13	0	0
20	30880195	.	A	G	3	3	6	0	0	6	0	0
20	30889723	.	A	G	6	3	9	0	1	10	0	0
20	30889754	.	T	G	8	5	13	0	1	14	0	0
20	30889792	.	T	A	5	7	12	0	1	13	0	0
20	30894333	.	T	C	1	0	1	0	4	5	0	0
20	30894408	.	C	T	4	4	8	0	0	8	0	0
20	30894427	.	C	T	3	3	6	0	0	6	0	0
20	30894496	.	G	T	2	3	5	0	1	6	0	0
20	30894510	.	T	A	4	5	9	0	0	9	0	0
20	30894630	.	A	T	2	7	9	0	0	9	0	0
20	30895007	.	A	G	5	5	10	0	0	10	0	0
20	30895013	.	A	G	4	4	8	0	1	9	0	0
20	30895070	.	A	G	5	6	11	0	0	11	0	0
20	30895091	.	G	A	3	8	11	0	2	13	0	0
20	30897944	.	G	A	5	8	13	0	0	13	0	0
20	30897948	.	G	T	5	5	10	0	1	11	0	0
20	30899353	.	A	G	3	7	10	0	1	11	0	0
20	30900837	.	A	C	1	0	1	0	7	8	0	0
20	30900880	.	A	C	5	0	5	0	5	10	0	0
20	30900928	.	C	G	0	5	5	0	5	10	0	0
20	30900969	.	T	G	2	2	4	0	0	4	0	0
20	30922687	.	G	A	5	6	11	0	0	11	0	0
20	30922688	.	A	T	4	7	11	0	0	11	0	0
20	30922808	.	T	A	6	6	12	0	2	14	0	0
20	30922836	.	C	A	11	8	19	0	1	22	2	0
20	30923101	.	T	C	12	6	18	0	0	18	0	0
20	30925253	.	T	C	4	0	4	0	6	10	0	0
20	30926205	.	T	C	6	11	17	0	1	18	0	0
20	30928174	.	T	C	7	5	12	0	0	12	0	0
20	30931021	.	A	T	16	5	21	0	0	21	0	0
20	30931671	.	G	A	16	12	28	0	0	28	0	0
20	30932277	.	T	C	19	1	20	0	20	40	0	0
20	30936755	.	T	C	12	0	12	0	13	25	0	0
20	30939177	.	T	C	7	13	20	0	1	21	0	0
20	30940566	.	C	G	22	17	39	0	2	41	0	0
20	30947353	.	T	C	23	22	45	0	5	50	0	0
20	30947433	.	T	C	9	9	18	0	1	19	0	0
20	31002809	.	C	A	2	2	4	0	0	4	0	0
20	31002836	.	T	G	1	2	3	0	0	3	0	0
20	31076504	.	T	A	4	5	9	0	0	9	0	0
20	31147609	.	G	A	11	8	19	0	0	19	0	0
20	31170202	.	G	A	14	10	24	0	0	24	0	0
20	31171010	.	G	A	7	9	16	0	0	16	0	0
20	31171079	.	A	G	7	7	14	0	0	14	0	0
20	31172725	.	A	C	10	8	18	0	0	18	0	0
20	31172996	.	C	T	4	6	10	0	1	11	0	0
20	31178425	.	G	T	10	5	15	0	0	15	0	0
20	31182194	.	G	A	6	8	14	0	0	14	0	0
20	31186253	.	T	C	6	7	13	0	1	14	0	0
20	31187975	.	G	A	9	13	22	0	0	22	0	0
20	31192304	.	A	C	17	11	28	0	1	29	0	0
20	31192720	.	C	T	14	10	24	0	2	27	1	0
20	31193762	.	G	A	1	8	9	0	5	14	0	0
20	31193826	.	C	T	12	8	20	0	0	20	0	0
20	31197217	.	G	T	14	8	22	0	1	23	0	0
20	31197307	.	G	A	0	8	8	0	21	29	0	0
20	31197465	.	T	C	10	9	19	0	0	19	0	0
20	31199655	.	G	A	18	13	31	0	2	33	0	0
20	31202316	.	C	T	6	3	9	0	0	9	0	0
20	31204173	.	T	C	11	8	19	0	0	19	0	0
20	31204191	.	A	C	14	5	19	0	0	19	0	0
20	31206649	.	A	G	15	16	31	0	1	32	0	0
20	31211701	.	T	A	13	9	22	0	2	24	0	0
20	31211710	.	A	G	15	10	25	0	1	26	0	0
20	31211812	.	G	A	1	9	10	0	11	21	0	0
20	31211846	.	G	A	1	7	8	0	10	18	0	0
20	31212156	.	G	A	1	11	12	0	12	24	0	0
20	31212390	.	G	C	4	7	11	0	1	12	0	0
20	31217572	.	C	G	9	3	12	1	0	13	0	0
20	31217612	.	T	C	6	5	11	1	0	12	0	0
20	31222978	.	T	G	11	0	11	0	19	30	0	0
20	31223282	.	C	T	12	4	16	0	0	16	0	0
20	31223336	.	C	T	9	10	19	0	0	19	0	0
20	31225875	.	C	T	11	12	23	0	1	24	0	0
20	31233199	.	C	T	0	4	4	0	6	10	0	0
20	31233329	.	C	T	1	7	8	0	9	17	0	0
20	31233463	.	T	G	3	2	5	0	0	5	0	0
20	31233566	.	T	G	2	4	6	0	1	7	0	0
20	31233623	.	T	C	4	3	7	0	0	7	0	0
20	31233679	.	A	G	5	9	14	0	2	16	0	0
20	31233837	.	G	C	11	3	14	0	0	14	0	0
20	31238061	.	A	G	11	12	23	0	1	24	0	0
20	31252532	.	G	A	5	7	12	0	0	12	0	0
20	31429132	.	T	C	3	4	7	0	0	7	0	0
20	31429181	.	C	T	4	6	10	0	0	10	0	0
20	31429648	.	C	T	13	14	27	0	0	27	0	0
20	31429824	.	G	A	10	4	14	0	0	14	0	0
20	31429917	.	T	G	6	7	13	0	0	13	0	0
20	31430039	.	G	C	10	6	16	0	0	16	0	0
20	31430204	.	C	A	6	4	10	0	1	11	0	0
20	31430279	.	A	G	4	6	10	0	2	12	0	0
20	31430320	.	T	C	9	0	9	0	8	17	0	0
20	31430769	.	C	T	0	6	6	0	4	10	0	0
20	31430922	.	T	A	9	6	15	0	0	15	0	0
20	31430993	.	C	T	0	6	6	0	4	10	0	0
20	31431106	.	A	T	3	6	9	0	0	9	0	0
20	31431160	.	A	T	9	12	21	0	0	21	0	0
20	31431375	.	T	C	2	7	9	0	1	10	0	0
20	31431457	.	T	A	5	5	10	0	1	11	0	0
20	31431501	.	G	T	3	3	6	0	1	7	0	0
20	31431561	.	A	G	5	4	9	0	0	9	0	0
20	31431645	.	A	T	7	5	12	0	2	14	0	0
20	31431701	.	A	G	9	7	16	0	0	16	0	0
20	31431739	.	A	G	14	6	20	0	0	20	0	0
20	31431962	.	A	G	12	8	20	0	1	21	0	0
20	31432826	.	G	T	6	5	11	0	0	11	0	0
20	31432850	.	A	G	3	4	7	0	0	7	0	0
20	31436304	.	C	T	11	6	17	0	0	17	0	0
20	31436450	.	G	A	15	11	26	0	2	28	0	0
20	31436483	.	C	T	15	9	24	0	1	25	0	0
20	31436750	.	C	T	1	9	10	0	6	16	0	0
20	31436819	.	C	A	6	5	11	0	1	12	0	0
20	31436984	.	C	T	4	9	13	0	0	13	0	0
20	31441076	.	G	A	8	4	12	1	1	14	0	0
20	31447413	.	C	T	0	4	4	0	6	10	0	0
20	31447455	.	C	T	5	4	9	0	0	9	0	0
20	31449416	.	T	C	4	5	9	0	0	9	0	0
20	31449686	.	T	C	3	0	3	0	4	7	0	0
20	31483629	.	C	A	2	6	8	0	1	10	1	0
20	31743161	.	C	T	4	2	6	0	0	6	0	0
20	31747116	.	A	T	19	13	32	1	1	34	0	0
20	31747673	.	C	A	1	17	18	0	11	29	0	0
20	31747695	.	G	C	14	11	25	0	0	25	0	0
20	31747792	.	C	T	1	9	10	0	12	22	0	0
20	31747860	.	C	T	4	12	16	5	15	36	0	0
20	31748178	.	T	C	10	14	24	0	1	25	0	0
20	31748183	.	C	T	15	9	24	0	2	26	0	0
20	31748363	.	A	G	10	11	21	0	0	21	0	0
20	31748448	.	A	G	18	14	32	0	0	32	0	0
20	31748518	.	C	T	12	12	24	0	0	24	0	0
20	31748845	.	A	T	12	10	22	0	0	22	0	0
20	31771899	.	G	A	6	8	14	0	0	14	0	0
20	31777192	.	C	T	3	11	14	0	11	25	0	0
20	31786688	.	T	A	6	3	9	0	1	10	0	0
20	31790975	.	A	G	6	7	13	0	0	13	0	0
20	32009794	.	T	A	1	2	3	0	0	3	0	0
20	32009795	.	C	T	1	2	3	0	0	3	0	0
20	32047457	.	T	C	7	8	15	0	0	15	0	0
20	32047741	.	A	C	17	18	35	0	1	36	0	0
20	32048586	.	T	C	30	10	40	0	1	41	0	0
20	32061596	.	G	A	12	7	19	0	1	20	0	0
20	32061611	.	C	A	1	7	8	0	7	15	0	0
20	32065517	.	G	A	14	17	31	0	1	32	0	0
20	32065650	.	C	T	7	11	18	0	0	18	0	0
20	32071494	.	A	G	19	6	25	0	1	26	0	0
20	32110172	.	T	C	8	0	8	0	6	14	0	0
20	32110331	.	G	A	16	8	24	0	3	27	0	0
20	32110829	.	C	G	5	12	17	0	0	17	0	0
20	32118621	.	G	A	6	6	12	0	1	13	0	0
20	32135962	.	T	C	14	10	24	0	2	26	0	0
20	32136451	.	T	G	19	10	29	0	2	31	0	0
20	32136588	.	G	T	12	4	16	0	1	17	0	0
20	32136953	.	C	T	13	9	22	0	0	22	0	0
20	32137365	.	T	A	3	3	6	0	0	6	0	0
20	32137423	.	G	A	5	6	11	0	1	12	0	0
20	32137529	.	A	T	12	6	18	0	0	18	0	0
20	32137638	.	A	G	13	7	20	0	1	21	0	0
20	32137752	.	G	T	10	16	26	0	0	27	1	0
20	32137984	.	A	T	19	9	28	0	2	30	0	0
20	32138029	.	T	A	19	10	29	0	0	29	0	0
20	32138111	.	C	T	13	13	26	0	1	27	0	0
20	32138171	.	T	C	7	12	19	0	0	19	0	0
20	32138478	.	A	G	14	9	23	0	2	25	0	0
20	32141792	.	A	G	1	4	5	0	0	5	0	0
20	32144809	.	G	C	4	2	6	0	0	6	0	0
20	32144872	.	T	G	3	4	7	0	0	7	0	0
20	32145841	.	A	T	2	3	5	0	0	5	0	0
20	32152397	.	G	A	3	2	5	0	0	5	0	0
20	32224452	.	A	G	11	0	11	0	9	20	0	0
20	32224485	.	C	A	5	16	21	0	1	22	0	0
20	32225711	.	G	A	12	8	20	0	1	21	0	0
20	32227268	.	G	A	8	14	22	0	0	22	0	0
20	32228863	.	G	A	18	21	39	0	3	42	0	0
20	32228872	.	A	G	21	17	38	0	3	41	0	0
20	32228936	.	A	C	21	16	37	0	0	37	0	0
20	32229004	.	G	A	26	18	44	0	2	46	0	0
20	32229047	.	G	A	18	19	37	0	0	37	0	0
20	32229053	.	C	T	16	17	33	0	1	34	0	0
20	32229095	.	T	C	19	19	38	0	0	38	0	0
20	32229214	.	G	T	17	24	41	0	1	42	0	0
20	32229825	.	G	T	19	21	40	0	7	47	0	0
20	32230017	.	A	C	17	17	34	0	4	38	0	0
20	32230205	.	T	G	17	1	18	0	15	34	1	0
20	32230301	.	T	C	4	11	15	0	0	15	0	0
20	32230362	.	C	A	13	9	22	0	1	23	0	0
20	32230470	.	T	C	13	14	27	0	0	27	0	0
20	32230472	.	A	C	14	13	27	0	0	27	0	0
20	32230518	.	C	A	10	18	28	0	2	30	0	0
20	32230521	.	G	A	1	16	17	0	15	32	0	0
20	32230620	.	C	T	19	18	37	0	4	41	0	0
20	32230836	.	T	C	20	11	31	0	0	32	1	0
20	32286800	.	C	T	3	5	8	1	18	27	0	0
20	32286875	.	C	T	15	16	31	0	0	31	0	0
20	32286877	.	A	C	16	11	27	0	1	29	1	0
20	32286960	.	A	C	13	18	31	0	1	32	0	0
20	32287317	.	C	T	10	7	17	0	0	17	0	0
20	32287349	.	C	G	6	5	11	0	0	11	0	0
20	32287736	.	T	C	9	15	24	0	0	24	0	0
20	32290160	.	G	A	10	12	22	0	0	22	0	0
20	32290435	.	A	G	12	15	27	0	2	29	0	0
20	32290679	.	G	A	19	13	32	0	1	33	0	0
20	32291287	.	G	A	3	12	15	1	2	18	0	0
20	32332463	.	A	G	5	2	7	0	0	7	0	0
20	32332494	.	A	C	2	0	2	0	8	10	0	0
20	32332633	.	A	T	13	4	17	1	1	19	0	0
20	32348568	.	C	T	3	4	7	0	1	8	0	0
20	32405330	.	A	G	6	5	11	0	0	11	0	0
20	32406066	.	T	C	5	3	8	0	0	8	0	0
20	32432156	.	T	C	18	13	31	0	3	34	0	0
20	32432315	.	G	T	12	16	28	0	0	28	0	0
20	32432532	.	C	T	13	16	29	0	1	30	0	0
20	32437598	.	T	A	1	3	4	0	0	4	0	0
20	32478368	.	A	G	4	0	4	0	4	8	0	0
20	32484600	.	C	T	4	8	12	0	0	12	0	0
20	32487507	.	T	C	4	5	9	0	0	9	0	0
20	32487624	.	G	A	2	5	7	0	0	7	0	0
20	32487643	.	G	T	3	3	6	0	0	6	0	0
20	32489618	.	G	A	1	3	4	0	7	11	0	0
20	32490091	.	A	T	2	2	4	0	0	4	0	0
20	32490480	.	C	T	4	5	9	0	0	9	0	0
20	32490783	.	C	G	3	4	7	0	0	7	0	0
20	32498335	.	C	T	5	2	7	0	1	8	0	0
20	32498410	.	C	G	4	3	7	0	0	7	0	0
20	32498441	.	G	C	3	4	7	0	2	9	0	0
20	32498635	.	C	A	4	2	6	0	0	6	0	0
20	32498639	.	C	A	4	1	5	0	1	6	0	0
20	32498690	.	C	T	2	7	9	0	0	9	0	0
20	32498771	.	C	G	4	7	11	0	0	11	0	0
20	32498869	.	A	G	2	2	4	0	0	4	0	0
20	32499166	.	G	A	1	6	7	0	8	15	0	0
20	32505856	.	G	A	4	4	8	0	0	8	0	0
20	32513235	.	G	A	11	5	16	0	4	20	0	0
20	32513256	.	G	A	13	6	19	0	2	21	0	0
20	32513987	.	G	A	12	7	19	0	2	21	0	0
20	32515968	.	C	T	11	9	20	0	0	20	0	0
20	32520852	.	A	G	7	8	15	0	0	15	0	0
20	32520853	.	A	T	9	7	16	0	0	16	0	0
20	32521203	.	C	T	12	15	27	1	3	31	0	0
20	32521220	.	T	C	15	13	28	1	2	31	0	0
20	32521377	.	C	T	8	10	18	0	1	19	0	0
20	32521686	.	A	C	11	18	29	0	0	29	0	0
20	32521719	.	A	C	14	19	33	0	0	33	0	0
20	32539224	.	G	A	3	4	7	0	0	7	0	0
20	32567982	.	T	C	2	4	6	0	0	6	0	0
20	32571781	.	C	T	4	9	13	0	1	14	0	0
20	32574157	.	T	C	7	5	12	0	0	12	0	0
20	32574190	.	G	A	5	4	9	0	0	9	0	0
20	32576667	.	T	C	10	6	16	0	0	16	0	0
20	32756790	.	G	A	1	6	7	0	2	9	0	0
20	32757807	.	C	G	10	1	11	0	12	23	0	0
20	32758490	.	A	G	14	9	23	0	0	23	0	0
20	32758558	.	T	C	8	13	21	0	1	22	0	0
20	32838710	.	A	T	6	5	11	0	0	11	0	0
20	32863650	.	A	G	0	9	9	0	0	9	0	0
20	32863657	.	A	G	2	8	10	0	0	10	0	0
20	32872075	.	C	A	0	3	3	0	1	4	0	0
20	32872156	.	C	A	4	4	8	0	0	8	0	0
20	32925890	.	T	C	5	6	11	0	1	12	0	0
20	32927191	.	C	T	3	2	5	0	2	7	0	0
20	32939176	.	T	C	2	6	8	0	0	8	0	0
20	32948551	.	A	C	6	4	10	0	0	10	0	0
20	32948591	.	G	C	3	0	3	0	6	9	0	0
20	32963111	.	A	G	1	5	6	0	0	6	0	0
20	32963132	.	T	A	1	4	5	0	0	5	0	0
20	32999053	.	G	C	4	2	6	0	1	7	0	0
20	33077326	.	T	C	2	2	4	0	0	4	0	0
20	33077328	.	T	C	2	2	4	0	0	4	0	0
20	33100207	.	A	G	5	2	7	0	0	7	0	0
20	33127588	.	C	T	2	2	4	0	0	4	0	0
20	33175232	.	A	G	7	0	7	0	7	14	0	0
20	33175351	.	G	A	8	11	19	0	2	21	0	0
20	33175504	.	T	C	7	14	21	0	0	21	0	0
20	33175549	.	C	T	8	15	23	0	1	24	0	0
20	33175948	.	A	C	10	13	23	0	0	23	0	0
20	33177904	.	C	T	11	9	20	0	0	20	0	0
20	33180111	.	T	C	7	11	18	0	1	19	0	0
20	33180295	.	G	A	3	3	6	0	1	7	0	0
20	33189326	.	T	G	13	0	13	0	5	18	0	0
20	33189386	.	G	A	1	6	7	0	9	16	0	0
20	33189631	.	G	A	9	6	15	0	1	16	0	0
20	33298184	.	C	T	5	6	11	0	0	11	0	0
20	33467794	.	A	T	5	16	21	0	1	22	0	0
20	33468040	.	T	G	16	14	30	0	2	32	0	0
20	33484083	.	G	A	7	4	11	0	0	11	0	0
20	33484387	.	T	C	9	6	15	0	2	17	0	0
20	33484438	.	G	C	6	0	6	0	9	15	0	0
20	33486846	.	G	A	1	6	7	0	0	7	0	0
20	33486989	.	T	C	2	0	2	0	4	6	0	0
20	33486996	.	T	A	7	2	9	0	0	9	0	0
20	33487143	.	G	T	4	3	7	0	1	8	0	0
20	33487152	.	A	T	4	2	6	0	0	6	0	0
20	33487603	.	C	T	4	10	14	0	0	14	0	0
20	33494411	.	G	T	17	20	37	0	3	40	0	0
20	33530137	.	C	G	2	2	4	0	0	4	0	0
20	33656128	.	T	A	1	2	3	2	0	5	0	0
20	33662386	.	C	G	1	5	6	0	1	7	0	0
20	33669960	.	G	T	1	4	5	0	0	5	0	0
20	33683767	.	A	G	1	3	4	1	0	5	0	0
20	33735327	.	G	A	3	2	5	0	0	5	0	0
20	33745452	.	C	T	2	3	5	0	0	5	0	0
20	33758874	.	C	T	9	10	19	0	2	21	0	0
20	33759151	.	G	C	12	1	13	1	18	32	0	0
20	33759196	.	A	C	15	0	15	1	10	26	0	0
20	33771521	.	G	A	7	8	15	0	1	16	0	0
20	33773493	.	G	A	11	12	23	0	1	24	0	0
20	33789729	.	T	C	7	0	7	0	10	17	0	0
20	33789927	.	C	T	2	8	10	0	13	23	0	0
20	33789965	.	G	T	10	10	20	0	1	21	0	0
20	33796893	.	C	T	1	2	3	0	0	3	0	0
20	33809476	.	T	C	3	3	6	0	1	7	0	0
20	33809707	.	A	G	11	17	28	0	1	29	0	0
20	33809971	.	C	A	11	6	17	0	0	17	0	0
20	33810845	.	C	T	25	10	35	0	0	35	0	0
20	33810921	.	T	C	10	1	11	0	13	24	0	0
20	33811519	.	G	T	13	7	20	0	1	21	0	0
20	33839868	.	A	G	10	4	14	0	0	14	0	0
20	33840638	.	T	C	4	7	11	0	2	13	0	0
20	33859788	.	A	T	7	16	23	0	0	23	0	0
20	33859869	.	C	T	1	13	14	0	18	32	0	0
20	33860113	.	G	A	18	15	33	0	0	33	0	0
20	33862741	.	G	A	10	7	17	0	0	17	0	0
20	33864772	.	A	G	13	10	23	0	1	24	0	0
20	33905351	.	C	G	1	0	1	0	3	4	0	0
20	33984086	.	G	C	15	11	26	0	0	26	0	0
20	33994822	.	C	A	1	2	3	0	0	3	0	0
20	33994834	.	C	T	1	2	3	0	0	3	0	0
20	34003916	.	T	C	8	2	10	0	0	10	0	0
20	34007589	.	G	C	1	5	6	0	0	6	0	0
20	34007607	.	G	A	5	2	7	0	1	8	0	0
20	34009225	.	C	G	8	0	8	0	3	11	0	0
20	34009952	.	C	A	4	5	9	0	2	11	0	0
20	34012649	.	T	A	3	2	5	0	0	5	0	0
20	34012828	.	T	A	12	5	17	0	1	18	0	0
20	34012916	.	A	T	5	6	11	0	1	12	0	0
20	34013073	.	T	G	14	8	22	0	0	22	0	0
20	34015654	.	C	T	1	9	10	0	8	18	0	0
20	34015907	.	G	A	13	3	16	0	0	16	0	0
20	34015921	.	T	A	13	5	18	0	0	18	0	0
20	34018783	.	C	T	4	5	9	0	0	9	0	0
20	34018852	.	C	A	1	6	7	0	3	10	0	0
20	34020560	.	G	A	5	2	7	0	0	7	0	0
20	34020861	.	T	A	4	6	10	0	0	10	0	0
20	34023551	.	T	C	2	5	7	0	0	7	0	0
20	34024246	.	G	A	5	3	8	0	0	8	0	0
20	34039090	.	T	A	3	3	6	0	0	6	0	0
20	34040132	.	C	A	11	11	22	0	3	25	0	0
20	34044813	.	G	A	6	6	12	0	1	13	0	0
20	34044845	.	A	T	5	6	11	0	0	11	0	0
20	34049141	.	G	A	8	11	19	0	1	20	0	0
20	34051237	.	C	T	9	9	18	0	1	19	0	0
20	34051417	.	G	A	10	10	20	0	1	21	0	0
20	34053787	.	T	A	10	17	27	0	3	30	0	0
20	34054401	.	C	T	11	7	18	0	3	21	0	0
20	34056206	.	C	G	5	7	12	0	1	13	0	0
20	34056227	.	C	T	5	3	8	0	2	10	0	0
20	34057323	.	C	A	9	10	19	0	0	19	0	0
20	34059166	.	T	C	8	2	10	0	1	11	0	0
20	34059335	.	T	C	5	0	5	0	10	15	0	0
20	34059433	.	C	T	6	4	10	0	0	10	0	0
20	34059440	.	G	C	6	4	10	0	1	11	0	0
20	34061117	.	C	T	5	2	7	0	0	7	0	0
20	34061577	.	A	T	5	3	8	0	0	8	0	0
20	34061784	.	C	T	4	5	9	0	1	10	0	0
20	34061788	.	G	T	4	4	8	0	1	9	0	0
20	34061986	.	G	A	3	5	8	0	0	8	0	0
20	34062250	.	G	T	3	2	5	0	0	5	0	0
20	34063783	.	A	T	1	5	6	0	1	7	0	0
20	34063986	.	T	A	5	3	8	0	0	8	0	0
20	34065620	.	G	A	2	3	5	0	0	5	0	0
20	34066200	.	T	C	2	3	5	0	0	5	0	0
20	34151818	.	C	A	10	7	17	0	2	19	0	0
20	34151873	.	C	T	10	6	16	0	2	18	0	0
20	34153975	.	G	A	6	10	16	0	1	17	0	0
20	34154122	.	C	T	9	7	16	0	0	16	0	0
20	34154618	.	C	A	9	8	17	0	1	18	0	0
20	34154831	.	G	A	8	8	16	0	2	18	0	0
20	34154982	.	G	T	9	12	21	0	1	22	0	0
20	34155025	.	C	T	15	8	23	0	0	23	0	0
20	34155192	.	T	C	6	9	15	0	0	15	0	0
20	34157762	.	C	T	1	2	3	0	0	3	0	0
20	34157817	.	C	T	0	3	3	0	1	4	0	0
20	34158468	.	T	A	1	2	3	0	0	3	0	0
20	34332683	.	C	A	20	22	42	0	1	43	0	0
20	34333733	.	T	C	13	16	29	0	0	29	0	0
20	34339473	.	G	A	30	29	59	0	2	61	0	0
20	34339516	.	C	T	28	25	53	0	1	54	0	0
20	34340055	.	T	C	27	24	51	0	2	53	0	0
20	34340678	.	A	T	14	26	40	0	1	41	0	0
20	34344111	.	C	T	1	3	4	0	0	4	0	0
20	34355552	.	T	C	3	2	5	0	0	5	0	0
20	34355565	.	G	A	2	3	5	0	0	5	0	0
20	34364991	.	C	T	1	3	4	0	0	4	0	0
20	34368239	.	G	A	1	3	4	0	0	4	0	0
20	34382716	.	T	G	1	2	3	0	0	3	0	0
20	34382964	.	G	A	1	2	3	0	0	3	0	0
20	34398646	.	G	A	4	4	8	0	0	8	0	0
20	34420788	.	G	A	20	19	39	0	2	41	0	0
20	34420860	.	A	G	25	11	36	0	2	38	0	0
20	34421307	.	A	G	16	12	28	0	1	29	0	0
20	34421485	.	C	T	12	8	20	0	1	21	0	0
20	34421758	.	G	A	17	14	31	0	0	31	0	0
20	34421801	.	G	C	15	0	15	0	12	27	0	0
20	34421804	.	G	A	15	13	28	0	0	28	0	0
20	34426660	.	T	G	21	19	40	0	2	42	0	0
20	34430100	.	T	G	13	12	25	1	1	27	0	0
20	34431467	.	G	C	15	10	25	0	1	26	0	0
20	34431661	.	A	G	12	14	26	0	0	26	0	0
20	34445005	.	A	G	11	10	21	0	1	22	0	0
20	34446718	.	G	A	12	7	19	0	1	20	0	0
20	34446733	.	A	G	9	4	13	0	1	14	0	0
20	34447477	.	G	C	14	8	22	0	1	23	0	0
20	34447522	.	T	C	14	7	21	0	2	23	0	0
20	34450257	.	T	G	7	6	13	0	0	13	0	0
20	34450535	.	T	C	5	7	12	0	0	12	0	0
20	34502644	.	G	A	4	2	6	0	0	6	0	0
20	34537775	.	A	C	6	9	15	0	0	15	0	0
20	34551195	.	C	T	3	4	7	0	1	8	0	0
20	34551222	.	A	G	9	5	14	0	0	14	0	0
20	34596633	.	G	T	6	9	15	0	0	15	0	0
20	34596634	.	T	A	6	8	14	0	1	15	0	0
20	34596710	.	A	T	3	6	9	0	0	9	0	0
20	34596736	.	C	G	6	1	7	0	7	14	0	0
20	34596788	.	C	T	4	5	9	0	0	9	0	0
20	34596797	.	G	T	3	5	8	0	0	8	0	0
20	34596914	.	A	T	4	7	11	0	0	11	0	0
20	34597244	.	A	G	10	15	25	0	0	25	0	0
20	34597631	.	C	T	14	14	28	0	2	30	0	0
20	34597844	.	T	C	13	18	31	0	1	32	0	0
20	34598076	.	T	A	12	9	21	0	2	23	0	0
20	34598113	.	C	A	9	15	24	0	0	24	0	0
20	34601175	.	G	A	25	14	39	0	0	39	0	0
20	34601214	.	A	T	14	11	25	0	0	25	0	0
20	34602561	.	A	C	13	15	28	0	1	29	0	0
20	34602576	.	T	G	15	16	31	0	0	31	0	0
20	34603661	.	C	T	16	20	36	0	1	37	0	0
20	34603733	.	T	G	18	16	34	0	3	38	1	0
20	34604241	.	C	A	14	22	36	0	0	36	0	0
20	34604356	.	C	T	14	21	35	0	1	36	0	0
20	34604432	.	C	T	14	13	27	0	1	28	0	0
20	34607698	.	A	G	16	1	17	0	11	28	0	0
20	34607893	.	A	G	13	12	25	0	3	28	0	0
20	34607970	.	C	T	7	10	17	0	0	17	0	0
20	34608235	.	A	G	8	8	16	0	1	17	0	0
20	34608458	.	A	C	3	5	8	0	0	8	0	0
20	34608519	.	T	C	2	9	11	0	1	12	0	0
20	34611709	.	G	T	7	7	14	0	0	14	0	0
20	34617642	.	T	C	3	5	8	0	0	8	0	0
20	34617729	.	G	A	9	3	12	0	0	12	0	0
20	34617780	.	A	T	7	4	11	0	1	12	0	0
20	34617837	.	G	A	2	6	8	0	2	10	0	0
20	34627817	.	G	C	6	4	10	0	1	11	0	0
20	34630281	.	A	G	12	4	16	0	0	16	0	0
20	34632577	.	T	C	11	7	18	0	0	18	0	0
20	34632587	.	C	T	8	8	16	0	0	16	0	0
20	34632740	.	C	A	4	5	9	0	0	9	0	0
20	34632864	.	C	A	6	7	13	0	0	13	0	0
20	34632911	.	T	A	8	5	13	0	0	13	0	0
20	34634979	.	T	C	3	4	7	0	0	7	0	0
20	34634988	.	T	C	5	4	9	0	0	9	0	0
20	34636529	.	A	T	8	2	10	0	1	11	0	0
20	34636536	.	G	A	8	4	12	0	0	12	0	0
20	34638185	.	A	G	3	0	3	0	5	8	0	0
20	34638235	.	G	A	1	7	8	0	6	14	0	0
20	34638251	.	G	A	7	7	14	0	3	17	0	0
20	34642639	.	C	A	7	6	13	0	1	14	0	0
20	34642805	.	A	G	10	4	14	0	0	14	0	0
20	34642931	.	G	A	3	3	6	0	1	7	0	0
20	34643007	.	A	G	8	6	14	0	1	15	0	0
20	34643051	.	T	C	11	7	18	0	0	18	0	0
20	34643054	.	A	G	10	8	18	0	1	19	0	0
20	34643163	.	A	G	5	6	11	0	0	11	0	0
20	34643392	.	G	T	4	2	6	0	0	6	0	0
20	34643491	.	A	T	11	3	14	0	0	14	0	0
20	34643535	.	T	C	10	3	13	0	0	13	0	0
20	34643800	.	C	T	10	2	12	0	1	13	0	0
20	34657287	.	G	T	1	5	6	0	0	6	0	0
20	34658609	.	G	A	2	3	5	0	0	5	0	0
20	34673199	.	T	A	2	2	4	0	0	4	0	0
20	34682639	.	C	T	7	7	14	0	0	14	0	0
20	34727666	.	G	A	8	9	17	0	0	17	0	0
20	34733553	.	C	A	12	9	21	0	0	21	0	0
20	34733604	.	G	A	16	7	23	0	0	23	0	0
20	34733752	.	C	T	17	9	26	1	0	27	0	0
20	34737886	.	T	A	8	6	14	0	0	14	0	0
20	34737944	.	G	C	6	5	11	0	0	11	0	0
20	34738198	.	G	A	18	23	41	0	3	44	0	0
20	34738314	.	G	A	14	22	36	0	5	41	0	0
20	34738397	.	G	T	12	15	27	0	0	27	0	0
20	34738473	.	T	G	13	10	23	1	0	24	0	0
20	34738756	.	A	G	19	23	42	0	3	45	0	0
20	34742840	.	G	A	20	18	38	1	0	39	0	0
20	34745872	.	A	G	22	16	38	0	1	39	0	0
20	34746019	.	G	A	9	20	29	0	0	29	0	0
20	34747208	.	T	C	13	13	26	0	1	27	0	0
20	34749747	.	G	A	11	13	24	0	1	25	0	0
20	34779183	.	C	T	2	4	6	0	0	6	0	0
20	34794668	.	T	C	6	7	13	0	0	13	0	0
20	34794939	.	C	T	30	22	52	0	3	55	0	0
20	34795111	.	C	A	33	34	67	0	3	70	0	0
20	34795126	.	A	G	28	35	63	0	6	69	0	0
20	34795296	.	T	C	27	35	62	0	2	64	0	0
20	34795379	.	T	C	35	31	66	0	2	68	0	0
20	34795473	.	C	T	4	23	27	0	37	64	0	0
20	34795689	.	C	T	32	41	73	0	4	77	0	0
20	34797252	.	G	T	47	33	80	0	1	81	0	0
20	34797598	.	A	T	34	34	68	0	2	70	0	0
20	34955791	.	C	T	36	28	64	2	5	72	1	0
20	34955810	.	T	G	53	15	68	3	6	77	0	0
20	34956159	.	A	T	19	13	32	0	0	32	0	0
20	34956164	.	T	A	19	14	33	0	1	34	0	0
20	34967476	.	T	C	4	0	4	0	11	15	0	0
20	34969773	.	A	T	12	17	29	0	4	33	0	0
20	34975831	.	G	A	12	10	22	0	0	22	0	0
20	34980452	.	T	C	8	16	24	0	1	25	0	0
20	34982018	.	C	T	8	9	17	0	1	18	0	0
20	34982323	.	T	A	8	10	18	0	0	18	0	0
20	34985184	.	C	T	11	9	20	0	1	21	0	0
20	34985368	.	C	A	2	12	14	0	8	22	0	0
20	34985384	.	C	T	3	13	16	0	7	23	0	0
20	34985424	.	T	G	6	10	16	0	0	16	0	0
20	34985462	.	A	G	9	8	17	0	3	20	0	0
20	34985480	.	A	T	9	5	14	0	1	15	0	0
20	34985499	.	A	C	7	8	15	0	0	15	0	0
20	34991739	.	T	A	4	2	6	0	0	6	0	0
20	34991804	.	C	T	2	3	5	0	4	9	0	0
20	34993974	.	G	A	5	3	8	0	1	9	0	0
20	35001423	.	G	A	3	6	9	0	0	9	0	0
20	35007466	.	A	G	8	6	14	0	0	14	0	0
20	35011946	.	C	T	9	3	12	0	1	13	0	0
20	35013713	.	A	G	2	2	4	0	1	5	0	0
20	35014149	.	A	T	1	2	3	0	0	3	0	0
20	35014221	.	G	A	2	2	4	0	1	5	0	0
20	35017831	.	C	T	2	4	6	0	0	6	0	0
20	35017898	.	G	A	3	3	6	0	0	6	0	0
20	35017899	.	T	A	4	3	7	0	0	7	0	0
20	35018537	.	G	A	2	2	4	0	0	4	0	0
20	35019357	.	G	A	1	1	2	0	1	3	0	0
20	35019578	.	T	C	3	4	7	0	0	7	0	0
20	35019845	.	T	C	1	2	3	0	0	3	0	0
20	35020427	.	T	G	2	2	4	0	0	4	0	0
20	35030676	.	T	C	1	2	3	0	0	3	0	0
20	35030748	.	A	G	3	3	6	0	0	6	0	0
20	35059085	.	G	A	0	13	13	0	17	30	0	0
20	35064469	.	T	C	25	15	40	0	1	41	0	0
20	35064808	.	C	T	19	17	36	0	4	40	0	0
20	35065345	.	G	A	1	17	18	0	25	43	0	0
20	35065573	.	A	C	15	16	31	0	9	40	0	0
20	35066821	.	G	A	3	19	22	0	31	53	0	0
20	35066935	.	G	A	4	22	26	0	25	51	0	0
20	35068064	.	A	G	30	0	30	0	31	61	0	0
20	35068790	.	A	T	9	10	19	0	0	19	0	0
20	35069063	.	A	C	5	12	17	0	2	19	0	0
20	35069756	.	A	G	12	24	36	0	4	40	0	0
20	35069963	.	A	C	22	15	37	0	1	38	0	0
20	35070176	.	C	T	17	23	40	0	0	40	0	0
20	35070217	.	T	G	18	26	44	0	2	46	0	0
20	35086182	.	C	T	3	2	5	0	0	5	0	0
20	35142856	.	A	G	2	3	5	0	2	7	0	0
20	35159500	.	C	A	2	5	7	0	1	8	0	0
20	35162012	.	T	G	1	4	5	0	0	5	0	0
20	35162090	.	G	A	6	2	8	0	0	8	0	0
20	35164811	.	A	T	4	5	9	0	0	9	0	0
20	35165533	.	G	A	8	5	13	0	0	13	0	0
20	35173653	.	C	A	4	6	10	0	0	10	0	0
20	35177501	.	T	C	3	4	7	0	1	8	0	0
20	35183406	.	A	G	7	0	7	0	9	16	0	0
20	35184413	.	T	C	8	8	16	0	0	16	0	0
20	35184419	.	T	C	8	7	15	0	0	15	0	0
20	35186620	.	C	T	2	3	5	1	0	6	0	0
20	35186629	.	G	C	1	3	4	1	2	7	0	0
20	35188776	.	G	A	2	4	6	0	0	6	0	0
20	35195535	.	A	G	8	7	15	0	1	16	0	0
20	35198810	.	A	C	12	5	17	0	1	18	0	0
20	35204702	.	A	C	3	3	6	0	1	7	0	0
20	35204773	.	C	T	8	3	11	0	0	11	0	0
20	35204814	.	A	G	10	0	10	0	4	14	0	0
20	35204848	.	T	G	5	7	12	0	0	12	0	0
20	35204944	.	G	A	11	8	19	0	0	19	0	0
20	35205061	.	C	T	3	11	14	0	1	15	0	0
20	35205182	.	T	C	9	5	14	0	1	15	0	0
20	35205552	.	T	G	12	0	12	0	9	21	0	0
20	35205600	.	A	T	10	9	19	0	0	19	0	0
20	35205680	.	A	G	10	5	15	0	0	15	0	0
20	35206101	.	A	T	6	14	20	0	0	20	0	0
20	35208046	.	A	G	2	5	7	0	0	7	0	0
20	35209012	.	G	A	1	5	6	0	0	6	0	0
20	35209201	.	C	T	8	4	12	1	0	13	0	0
20	35209405	.	C	T	21	7	28	0	0	28	0	0
20	35209481	.	G	A	14	8	22	0	1	23	0	0
20	35210175	.	C	A	13	7	20	0	1	21	0	0
20	35210212	.	G	T	9	2	11	0	0	11	0	0
20	35210229	.	A	C	9	4	13	0	0	13	0	0
20	35210282	.	T	C	5	0	5	1	5	11	0	0
20	35210311	.	A	C	1	2	3	1	0	4	0	0
20	35210538	.	C	G	5	3	8	1	1	10	0	0
20	35210575	.	C	T	8	5	13	1	0	14	0	0
20	35210649	.	A	G	6	8	14	0	0	14	0	0
20	35210690	.	A	G	6	5	11	0	0	11	0	0
20	35210781	.	A	G	3	5	8	0	0	8	0	0
20	35210853	.	A	T	4	4	8	0	0	8	0	0
20	35210909	.	T	C	4	2	6	0	0	6	0	0
20	35211015	.	T	A	4	3	7	0	0	7	0	0
20	35211153	.	A	G	3	4	7	0	0	7	0	0
20	35211225	.	A	G	4	3	7	0	0	7	0	0
20	35211399	.	G	A	2	10	12	0	0	12	0	0
20	35211515	.	C	T	0	4	4	0	4	8	0	0
20	35211760	.	G	A	7	6	13	0	1	14	0	0
20	35212128	.	G	T	2	2	4	0	0	4	0	0
20	35212168	.	A	G	1	3	4	0	1	5	0	0
20	35212366	.	T	C	3	4	7	0	0	7	0	0
20	35212398	.	A	G	3	5	8	0	0	8	0	0
20	35212860	.	A	T	7	6	13	0	1	14	0	0
20	35215671	.	C	T	5	6	11	0	0	11	0	0
20	35215680	.	T	G	4	7	11	0	0	11	0	0
20	35226554	.	T	G	1	4	5	0	0	5	0	0
20	35226587	.	G	C	2	0	2	0	6	8	0	0
20	35226665	.	T	C	6	2	8	0	0	8	0	0
20	35227256	.	C	G	1	5	6	0	0	6	0	0
20	35243721	.	T	C	6	0	6	0	4	10	0	0
20	35245968	.	T	A	3	2	5	0	0	5	0	0
20	35245969	.	T	G	3	2	5	0	0	5	0	0
20	35295208	.	C	T	5	7	12	0	0	12	0	0
20	35296980	.	T	C	4	6	10	0	2	12	0	0
20	35297212	.	T	G	11	0	11	0	8	19	0	0
20	35297417	.	T	G	15	7	22	0	1	23	0	0
20	35297693	.	G	A	11	8	19	0	2	21	0	0
20	35297699	.	A	G	12	8	20	0	1	21	0	0
20	35297870	.	T	C	7	6	13	0	0	13	0	0
20	35297968	.	T	C	1	2	3	0	0	3	0	0
20	35392100	.	C	T	23	37	60	0	1	61	0	0
20	35427409	.	G	C	16	25	41	0	2	43	0	0
20	35427676	.	T	G	19	1	20	0	43	63	0	0
20	35427745	.	A	G	24	2	26	0	36	62	0	0
20	35427782	.	T	C	28	36	64	0	2	66	0	0
20	35427907	.	C	G	26	26	52	0	1	53	0	0
20	35427946	.	A	G	26	2	28	0	25	53	0	0
20	35428035	.	A	G	36	26	62	0	3	65	0	0
20	35428076	.	A	G	38	15	53	0	2	55	0	0
20	35428128	.	A	T	43	22	65	1	4	70	0	0
20	35428436	.	G	A	35	32	67	0	4	71	0	0
20	35428633	.	T	C	35	29	64	0	3	67	0	0
20	35428802	.	A	G	25	41	66	0	1	67	0	0
20	35428910	.	A	G	29	27	56	0	3	59	0	0
20	35429017	.	T	A	40	7	47	0	0	47	0	0
20	35429054	.	A	G	39	2	41	0	30	71	0	0
20	35429610	.	A	T	31	36	67	0	0	67	0	0
20	35433311	.	A	G	30	0	30	0	26	56	0	0
20	35497048	.	A	G	3	3	6	0	0	6	0	0
20	35500481	.	G	A	2	2	4	0	0	4	0	0
20	35798370	.	G	A	15	17	32	0	1	33	0	0
20	35798697	.	A	T	2	6	8	0	3	11	0	0
20	35798973	.	T	A	10	4	14	0	0	14	0	0
20	35799001	.	A	G	14	5	19	0	0	19	0	0
20	35799135	.	G	A	9	13	22	0	0	22	0	0
20	35799291	.	G	C	7	5	12	0	0	12	0	0
20	35799534	.	T	C	10	10	20	0	1	21	0	0
20	35799673	.	T	A	15	11	26	0	1	27	0	0
20	35799729	.	T	A	17	10	27	0	0	27	0	0
20	35799751	.	G	A	15	7	22	0	0	22	0	0
20	35799764	.	T	C	13	0	13	0	9	22	0	0
20	35799803	.	T	A	10	2	12	0	2	14	0	0
20	35799889	.	A	T	12	9	21	0	3	24	0	0
20	35800032	.	G	A	19	4	23	0	6	29	0	0
20	35800042	.	T	G	13	10	23	0	9	32	0	0
20	35800098	.	G	A	13	17	30	0	0	30	0	0
20	35800338	.	T	G	9	3	12	0	0	12	0	0
20	35800349	.	C	T	9	2	11	0	2	13	0	0
20	35800520	.	G	A	9	8	17	0	0	17	0	0
20	35800557	.	G	A	5	10	15	0	0	15	0	0
20	35800564	.	T	C	4	8	12	0	1	13	0	0
20	35816533	.	A	G	3	9	12	0	0	12	0	0
20	35816534	.	A	G	3	9	12	0	0	12	0	0
20	35827930	.	A	G	5	6	11	0	0	11	0	0
20	35827945	.	G	C	4	5	9	0	1	10	0	0
20	35831719	.	C	T	5	11	16	0	0	16	0	0
20	35841393	.	C	T	6	6	12	0	0	12	0	0
20	35927851	.	A	G	3	4	7	0	0	7	0	0
20	35930027	.	A	C	2	3	5	0	0	5	0	0
20	35941146	.	G	A	0	4	4	0	1	5	0	0
20	35957401	.	C	A	8	5	13	0	0	13	0	0
20	35972539	.	T	C	5	4	9	0	0	9	0	0
20	35972544	.	G	A	5	3	8	0	0	8	0	0
20	35979899	.	G	T	2	5	7	0	0	7	0	0
20	35979910	.	T	G	3	3	6	0	1	7	0	0
20	35979983	.	G	C	3	5	8	0	0	8	0	0
20	35980009	.	A	G	4	2	6	0	0	6	0	0
20	35980021	.	C	T	3	3	6	0	1	7	0	0
20	36067038	.	A	G	1	2	3	0	0	3	0	0
20	36067796	.	C	T	1	4	5	0	2	7	0	0
20	36067823	.	T	C	0	2	2	0	2	4	0	0
20	36068464	.	T	C	0	0	0	0	3	3	0	0
20	36068980	.	G	A	3	2	5	0	0	5	0	0
20	36069295	.	A	G	4	4	8	0	0	8	0	0
20	36100657	.	A	C	2	0	2	0	2	4	0	0
20	36234084	.	C	A	5	8	13	0	1	14	0	0
20	36290217	.	C	T	14	5	19	0	1	20	0	0
20	36297356	.	G	A	3	19	22	0	12	34	0	0
20	36297418	.	C	A	15	10	25	0	0	25	0	0
20	36297871	.	A	T	7	10	17	0	0	17	0	0
20	36394856	.	A	T	2	5	7	0	0	7	0	0
20	36394905	.	C	T	1	3	4	0	0	4	0	0
20	36395801	.	A	C	3	2	5	0	0	5	0	0
20	36395833	.	T	C	6	3	9	0	0	9	0	0
20	36395895	.	G	A	6	2	8	0	0	8	0	0
20	36396668	.	A	G	6	3	9	0	2	11	0	0
20	36416877	.	A	C	1	3	4	0	0	4	0	0
20	36420218	.	A	C	17	13	30	0	3	33	0	0
20	36420713	.	C	T	3	16	19	0	14	33	0	0
20	36420753	.	T	A	16	19	35	0	0	35	0	0
20	36420804	.	G	T	17	14	31	0	1	32	0	0
20	36421219	.	G	A	20	5	25	0	3	28	0	0
20	36421238	.	C	T	15	12	27	0	0	27	0	0
20	36421530	.	A	C	14	0	14	0	10	24	0	0
20	36421757	.	C	T	1	7	8	0	11	19	0	0
20	36422098	.	C	A	12	19	31	0	1	32	0	0
20	36422146	.	G	C	14	16	30	0	2	32	0	0
20	36422291	.	G	T	8	12	20	0	0	20	0	0
20	36424252	.	T	C	6	21	27	0	1	28	0	0
20	36424273	.	G	A	5	17	22	0	3	26	1	0
20	36434308	.	A	G	12	16	28	0	0	28	0	0
20	36440113	.	C	T	2	4	6	0	26	32	0	0
20	36440170	.	C	T	1	14	15	0	19	34	0	0
20	36449286	.	G	A	13	13	26	0	2	28	0	0
20	36449385	.	C	T	16	8	24	0	0	24	0	0
20	36449442	.	A	C	15	16	31	0	1	32	0	0
20	36449601	.	C	T	13	5	18	0	0	18	0	0
20	36491016	.	T	C	7	15	22	1	1	24	0	0
20	36559761	.	T	G	4	5	9	0	0	10	1	0
20	36623813	.	T	A	1	2	3	0	0	3	0	0
20	36626195	.	A	G	15	0	15	0	12	27	0	0
20	36626218	.	C	T	18	15	33	0	0	33	0	0
20	36626248	.	G	A	10	17	27	0	1	28	0	0
20	36626335	.	C	T	19	8	27	0	1	28	0	0
20	36629281	.	A	G	2	4	6	0	0	6	0	0
20	36637604	.	T	A	4	9	13	0	1	14	0	0
20	36637657	.	A	C	4	10	14	0	1	15	0	0
20	36637829	.	T	C	5	2	7	0	0	7	0	0
20	36637999	.	G	A	4	3	7	0	0	7	0	0
20	36638033	.	G	T	6	5	11	0	0	11	0	0
20	36638169	.	T	C	1	4	5	0	3	8	0	0
20	36646951	.	C	T	1	2	3	0	0	3	0	0
20	36646973	.	T	G	2	3	5	0	0	5	0	0
20	36647218	.	T	C	2	6	8	0	0	8	0	0
20	36656380	.	A	C	2	3	5	0	0	5	0	0
20	36675456	.	G	A	9	8	17	0	1	18	0	0
20	36675468	.	C	T	6	8	14	0	2	16	0	0
20	36677457	.	C	T	4	7	11	0	0	11	0	0
20	36677574	.	G	A	13	9	22	0	0	22	0	0
20	36682562	.	G	A	3	4	7	0	1	8	0	0
20	36768736	.	T	C	9	4	13	0	0	13	0	0
20	36773807	.	A	G	3	8	11	0	1	12	0	0
20	36773918	.	A	G	5	1	6	0	12	18	0	0
20	36773984	.	A	G	6	0	6	0	6	12	0	0
20	36783480	.	C	T	6	8	14	0	0	14	0	0
20	36785477	.	G	A	5	4	9	0	2	11	0	0
20	36788775	.	C	T	6	3	9	0	0	9	0	0
20	36788831	.	A	G	4	2	6	0	1	7	0	0
20	36791885	.	C	T	9	5	14	0	0	14	0	0
20	36792123	.	T	C	3	3	6	0	0	6	0	0
20	36798154	.	C	G	4	2	6	0	0	6	0	0
20	36816471	.	G	A	6	5	11	0	0	11	0	0
20	36816522	.	G	A	4	7	11	0	0	11	0	0
20	36817368	.	G	C	1	2	3	0	0	3	0	0
20	36821214	.	A	G	5	9	14	0	2	16	0	0
20	36828833	.	T	C	8	9	17	0	0	17	0	0
20	36828948	.	A	C	9	5	14	0	1	15	0	0
20	36829040	.	T	C	11	6	17	0	1	18	0	0
20	36829208	.	T	C	7	6	13	0	2	15	0	0
20	36829517	.	T	G	7	0	7	0	14	21	0	0
20	36838717	.	C	T	5	11	16	0	0	16	0	0
20	36838805	.	C	T	7	7	14	0	0	14	0	0
20	36838871	.	C	T	3	13	16	0	1	17	0	0
20	36838896	.	A	G	6	11	17	0	0	17	0	0
20	36915481	.	G	A	15	9	24	0	0	24	0	0
20	36915529	.	G	A	14	5	19	0	0	19	0	0
20	36916004	.	G	A	8	13	21	0	0	21	0	0
20	36916050	.	A	G	10	13	23	0	1	24	0	0
20	36917631	.	C	T	8	6	14	0	1	15	0	0
20	37265922	.	C	T	0	5	5	0	1	6	0	0
20	37300862	.	G	C	1	6	7	0	4	11	0	0
20	37332669	.	T	A	6	4	10	0	2	12	0	0
20	37358885	.	G	A	0	17	17	0	13	30	0	0
20	37376467	.	G	A	0	4	4	0	5	9	0	0
20	37512259	.	G	A	18	19	37	0	2	39	0	0
20	37512503	.	T	G	3	6	9	0	0	9	0	0
20	37513257	.	C	A	24	24	48	0	1	49	0	0
20	37513632	.	A	G	36	37	73	0	1	74	0	0
20	37513702	.	G	A	31	32	63	0	4	67	0	0
20	37513753	.	G	T	35	18	53	0	5	58	0	0
20	37515525	.	G	T	21	12	33	0	1	34	0	0
20	37515607	.	T	G	12	26	38	0	3	41	0	0
20	37516363	.	C	T	22	23	45	0	1	46	0	0
20	37517962	.	T	C	31	0	31	0	21	52	0	0
20	37518718	.	A	T	18	10	28	0	3	31	0	0
20	37518823	.	A	G	21	15	36	0	1	37	0	0
20	37519399	.	G	A	20	14	34	0	3	37	0	0
20	37519429	.	A	T	12	18	30	0	0	30	0	0
20	37519453	.	G	T	10	17	27	0	1	28	0	0
20	37521010	.	T	C	15	0	15	0	8	23	0	0
20	37533137	.	C	T	9	10	19	1	3	23	0	0
20	37627953	.	G	A	6	9	15	0	0	15	0	0
20	37628664	.	T	A	2	3	5	0	0	5	0	0
20	37733333	.	A	G	1	2	3	0	0	3	0	0
20	37733567	.	G	A	2	4	6	0	0	6	0	0
20	37733712	.	A	G	1	2	3	0	0	3	0	0
20	37736409	.	T	G	11	9	20	0	0	20	0	0
20	37751503	.	C	A	0	3	3	0	3	6	0	0
20	37754216	.	T	G	1	3	4	0	0	4	0	0
20	37757085	.	G	A	3	3	6	0	1	7	0	0
20	37760614	.	C	A	8	5	13	0	1	14	0	0
20	37761205	.	C	T	4	9	13	0	0	13	0	0
20	37764120	.	A	G	4	0	4	0	3	7	0	0
20	37764309	.	C	G	5	2	7	0	0	7	0	0
20	37764500	.	C	A	2	4	6	0	0	6	0	0
20	37768543	.	G	A	6	17	23	0	0	23	0	0
20	37768621	.	C	T	6	10	16	0	0	16	0	0
20	37768627	.	T	A	6	8	14	0	2	16	0	0
20	37768844	.	G	T	7	6	13	0	0	13	0	0
20	37768862	.	T	C	6	5	11	0	0	11	0	0
20	37768997	.	A	T	7	11	18	0	0	18	0	0
20	37769084	.	A	G	2	4	6	0	0	6	0	0
20	37769099	.	C	A	2	4	6	0	0	6	0	0
20	37796387	.	T	C	6	5	11	0	0	11	0	0
20	37796473	.	A	C	2	4	6	0	1	7	0	0
20	37798860	.	A	C	3	2	5	0	0	5	0	0
20	37798912	.	G	A	2	3	5	0	1	6	0	0
20	37826815	.	G	C	2	2	4	0	1	5	0	0
20	37826820	.	A	T	3	2	5	0	0	5	0	0
20	37859577	.	T	C	14	8	22	0	0	22	0	0
20	37862414	.	T	C	4	4	8	0	0	8	0	0
20	37862466	.	C	G	2	5	7	0	0	7	0	0
20	37866514	.	C	T	12	7	19	0	1	20	0	0
20	37866655	.	A	G	6	3	9	0	0	9	0	0
20	37884692	.	A	G	5	0	5	0	8	13	0	0
20	37896247	.	T	C	9	12	21	0	0	21	0	0
20	37896256	.	T	C	9	11	20	0	1	21	0	0
20	37899220	.	A	G	12	8	20	0	0	20	0	0
20	37913040	.	T	A	6	2	8	0	0	8	0	0
20	37913335	.	A	T	8	6	14	0	0	14	0	0
20	37913752	.	T	C	3	6	9	0	0	9	0	0
20	37913866	.	A	G	7	5	12	0	0	12	0	0
20	37913868	.	T	C	3	8	11	0	0	11	0	0
20	37913902	.	A	G	11	3	14	0	0	14	0	0
20	37913988	.	T	G	10	6	16	0	0	16	0	0
20	37914025	.	A	G	12	1	13	0	6	19	0	0
20	37914048	.	G	C	10	7	17	0	0	17	0	0
20	37914145	.	C	T	5	4	9	0	1	10	0	0
20	37914304	.	G	A	10	5	15	0	1	16	0	0
20	37914310	.	A	G	9	2	11	0	1	12	0	0
20	37914497	.	T	C	12	5	17	0	0	17	0	0
20	37914517	.	C	T	11	6	17	0	0	17	0	0
20	37914651	.	C	T	10	7	17	0	1	19	1	0
20	37914668	.	G	T	10	9	19	0	1	20	0	0
20	37914709	.	A	C	6	6	12	0	5	17	0	0
20	37914722	.	C	T	9	6	15	0	0	15	0	0
20	37914750	.	C	A	10	5	15	0	0	15	0	0
20	37914855	.	T	G	11	11	22	0	0	22	0	0
20	37914913	.	A	G	10	15	25	0	1	26	0	0
20	37914924	.	T	C	10	14	24	0	0	24	0	0
20	37915005	.	A	C	8	1	9	0	2	11	0	0
20	37915027	.	C	T	9	4	13	0	1	14	0	0
20	37915080	.	T	A	6	8	14	0	1	15	0	0
20	37915097	.	C	G	7	8	15	0	0	15	0	0
20	37915237	.	C	T	8	11	19	0	0	19	0	0
20	37915292	.	A	G	14	6	20	0	0	20	0	0
20	37915465	.	A	G	12	0	12	0	18	30	0	0
20	37915619	.	T	G	2	13	15	0	1	16	0	0
20	37915859	.	C	T	8	5	13	0	6	19	0	0
20	37920122	.	T	A	1	3	4	0	0	4	0	0
20	37920726	.	A	G	7	5	12	0	0	12	0	0
20	37920773	.	T	C	7	4	11	1	1	13	0	0
20	37925455	.	A	C	5	7	12	0	0	12	0	0
20	37928465	.	C	T	0	9	9	0	3	12	0	0
20	37928510	.	C	G	6	8	14	0	0	14	0	0
20	37930514	.	C	G	8	7	15	0	0	15	0	0
20	37930593	.	A	G	5	7	12	0	0	12	0	0
20	37930605	.	A	G	5	5	10	0	0	10	0	0
20	37934024	.	G	A	4	3	7	0	0	7	0	0
20	37934125	.	T	C	1	2	3	0	0	3	0	0
20	37934174	.	A	G	1	4	5	0	0	5	0	0
20	37934178	.	C	A	1	4	5	0	0	5	0	0
20	38045807	.	T	G	8	9	17	0	0	17	0	0
20	38045859	.	G	T	9	5	14	0	1	15	0	0
20	38076127	.	G	A	0	3	3	0	3	6	0	0
20	38076495	.	G	A	5	8	13	0	2	15	0	0
20	38086653	.	A	G	11	7	18	0	1	19	0	0
20	38091814	.	C	T	12	9	21	0	0	21	0	0
20	38091838	.	G	A	10	12	22	0	0	22	0	0
20	38099500	.	C	T	5	8	13	0	0	13	0	0
20	38201945	.	T	G	6	4	10	0	0	10	0	0
20	38202135	.	G	T	9	4	13	0	0	13	0	0
20	38202183	.	C	A	7	8	15	0	0	15	0	0
20	38202228	.	T	C	10	7	17	0	0	17	0	0
20	38210484	.	C	T	6	4	10	0	0	10	0	0
20	38210544	.	C	T	3	9	12	1	1	14	0	0
20	38216798	.	C	T	7	4	11	0	0	11	0	0
20	38240907	.	G	A	13	10	23	0	1	24	0	0
20	38241264	.	C	T	4	8	12	0	2	14	0	0
20	38241363	.	T	A	1	3	4	0	0	4	0	0
20	38241430	.	G	A	8	3	11	0	0	11	0	0
20	38241484	.	T	A	7	3	10	0	0	10	0	0
20	38241567	.	T	A	5	9	14	0	1	15	0	0
20	38241619	.	G	A	12	4	16	0	1	17	0	0
20	38241637	.	C	T	13	3	16	0	0	16	0	0
20	38241825	.	T	G	2	5	7	0	0	7	0	0
20	38241843	.	A	G	5	2	7	0	0	7	0	0
20	38322489	.	C	T	5	5	10	0	0	10	0	0
20	38358534	.	T	C	13	7	20	0	0	20	0	0
20	38358657	.	A	C	8	8	16	0	1	17	0	0
20	38358691	.	G	A	14	8	22	0	0	22	0	0
20	38358752	.	C	T	8	7	15	0	0	15	0	0
20	38358755	.	G	C	1	7	8	0	7	15	0	0
20	38358866	.	T	C	3	5	8	0	0	8	0	0
20	38358955	.	A	T	3	7	10	0	1	11	0	0
20	38359152	.	C	T	3	3	6	0	0	6	0	0
20	38359181	.	T	C	4	3	7	0	1	8	0	0
20	38359235	.	G	A	1	11	12	0	4	16	0	0
20	38359258	.	G	A	12	6	18	0	0	18	0	0
20	38458149	.	C	T	3	9	12	0	0	12	0	0
20	38473763	.	T	C	15	11	26	0	1	27	0	0
20	38473805	.	A	T	3	16	19	0	0	19	0	0
20	38473886	.	T	C	10	10	20	0	2	22	0	0
20	38473940	.	T	G	10	0	10	0	6	16	0	0
20	38517640	.	C	T	16	11	27	0	1	28	0	0
20	38518906	.	C	T	2	2	4	0	0	4	0	0
20	38518920	.	T	C	1	1	2	0	1	3	0	0
20	38518993	.	G	T	2	3	5	0	0	5	0	0
20	38538445	.	T	C	2	5	7	0	0	7	0	0
20	38538471	.	G	A	0	4	4	0	5	9	0	0
20	38625973	.	C	T	2	4	6	0	0	6	0	0
20	38647270	.	T	A	2	6	8	0	1	9	0	0
20	38647369	.	T	C	2	5	7	0	1	8	0	0
20	38657825	.	T	C	9	5	14	0	0	14	0	0
20	38662649	.	A	G	16	7	23	0	0	23	0	0
20	38662697	.	G	T	5	10	15	0	1	16	0	0
20	38665194	.	G	A	12	6	18	0	0	18	0	0
20	38669294	.	T	C	5	6	11	0	0	11	0	0
20	38669329	.	A	G	4	0	4	0	8	12	0	0
20	38669406	.	C	A	3	5	8	0	0	9	1	0
20	38669453	.	C	G	3	4	7	0	0	7	0	0
20	38669481	.	C	T	2	7	9	0	0	9	0	0
20	38669562	.	C	T	3	7	10	0	0	10	0	0
20	38669869	.	T	G	2	4	6	0	0	6	0	0
20	38669888	.	T	A	3	6	9	0	0	9	0	0
20	38670071	.	C	T	8	4	12	0	1	13	0	0
20	38670100	.	C	T	9	6	15	0	0	15	0	0
20	38670108	.	T	C	8	4	12	0	1	13	0	0
20	38670143	.	C	T	4	7	11	0	0	11	0	0
20	38670157	.	G	A	1	4	5	0	5	10	0	0
20	38670397	.	C	T	2	2	4	0	0	4	0	0
20	38726253	.	A	G	9	13	22	0	2	24	0	0
20	38726283	.	C	T	11	8	19	0	1	21	1	0
20	38726399	.	A	C	12	16	28	0	0	28	0	0
20	38726624	.	C	G	8	8	16	0	0	16	0	0
20	38726664	.	C	T	9	9	18	0	0	18	0	0
20	38726721	.	C	A	9	9	18	0	0	18	0	0
20	38726935	.	C	T	6	15	21	0	1	22	0	0
20	38727047	.	A	G	7	11	18	0	1	19	0	0
20	38764192	.	C	A	17	10	27	0	1	28	0	0
20	38764201	.	C	A	19	11	30	0	0	30	0	0
20	38764265	.	A	G	14	10	24	0	0	24	0	0
20	38764992	.	T	C	9	8	17	0	0	17	0	0
20	38765100	.	C	T	2	11	13	0	10	23	0	0
20	38765296	.	T	G	9	6	15	0	1	16	0	0
20	38765318	.	T	C	11	9	20	0	1	21	0	0
20	38765364	.	T	A	12	8	20	0	1	21	0	0
20	38765467	.	A	G	14	0	14	0	0	14	0	0
20	38765552	.	C	T	4	14	18	0	8	26	0	0
20	38778463	.	G	A	7	12	19	0	2	21	0	0
20	38787014	.	T	A	15	10	25	0	0	25	0	0
20	38788332	.	T	C	1	3	4	0	0	4	0	0
20	38788624	.	G	A	6	2	8	0	0	8	0	0
20	38788676	.	C	T	7	3	10	0	1	11	0	0
20	38788749	.	A	C	5	9	14	0	0	14	0	0
20	38788887	.	G	A	7	10	17	0	0	17	0	0
20	38789855	.	T	C	8	11	19	0	0	19	0	0
20	38790051	.	C	T	3	7	10	0	10	20	0	0
20	38790283	.	A	G	9	7	16	0	0	16	0	0
20	38793405	.	G	A	7	10	17	0	1	18	0	0
20	38793414	.	C	T	2	12	14	0	7	21	0	0
20	38798501	.	A	C	4	18	22	0	0	22	0	0
20	38802704	.	A	G	3	7	10	0	0	10	0	0
20	38808291	.	G	A	4	4	8	0	0	8	0	0
20	38815159	.	T	C	7	3	10	0	0	10	0	0
20	38815968	.	C	A	3	3	6	0	0	6	0	0
20	38816028	.	G	A	5	4	9	0	0	9	0	0
20	38817844	.	G	A	3	4	7	0	0	7	0	0
20	38817847	.	T	C	3	0	3	0	4	7	0	0
20	38817913	.	T	A	2	3	5	0	0	5	0	0
20	38819044	.	C	T	0	2	2	0	2	4	0	0
20	38819457	.	T	C	3	0	3	0	7	10	0	0
20	38820134	.	T	C	2	6	8	0	0	8	0	0
20	38820176	.	A	G	5	5	10	0	0	10	0	0
20	38820450	.	G	C	3	0	3	0	4	7	0	0
20	38822827	.	G	A	5	3	8	0	0	8	0	0
20	38822881	.	G	A	1	2	3	0	0	3	0	0
20	38854083	.	C	T	3	3	6	0	0	6	0	0
20	38854164	.	C	T	3	4	7	0	0	7	0	0
20	38857835	.	C	T	4	2	6	0	0	6	0	0
20	38857889	.	A	G	7	4	11	0	0	11	0	0
20	38861536	.	T	C	5	3	8	0	0	8	0	0
20	38861646	.	T	C	3	5	8	0	0	8	0	0
20	38864559	.	A	G	5	4	9	0	0	9	0	0
20	38864684	.	A	G	4	2	6	0	1	7	0	0
20	38866779	.	T	C	2	3	5	0	0	5	0	0
20	38871129	.	A	G	7	5	12	0	1	13	0	0
20	38872436	.	T	C	6	3	9	0	0	9	0	0
20	38877848	.	G	A	1	7	8	0	0	8	0	0
20	38884042	.	C	T	5	3	8	0	0	8	0	0
20	38910374	.	A	G	17	10	27	0	1	28	0	0
20	39045960	.	A	T	8	11	19	1	0	20	0	0
20	39046032	.	T	C	6	6	12	0	2	14	0	0
20	39052063	.	A	T	13	10	23	0	0	23	0	0
20	39052100	.	T	A	12	16	28	0	0	28	0	0
20	39052254	.	C	T	2	20	22	0	27	49	0	0
20	39052505	.	C	A	19	19	38	0	1	39	0	0
20	39055706	.	T	A	7	12	19	0	0	19	0	0
20	39055731	.	G	T	10	10	20	0	3	23	0	0
20	39055868	.	T	A	12	11	23	0	0	23	0	0
20	39081196	.	A	G	12	15	27	0	1	28	0	0
20	39081322	.	C	T	10	9	19	0	1	20	0	0
20	39190930	.	C	A	2	4	6	0	0	6	0	0
20	39190993	.	C	T	6	2	8	0	0	8	0	0
20	39191354	.	T	C	7	9	16	0	1	17	0	0
20	39191486	.	A	G	4	8	12	0	0	12	0	0
20	39191708	.	C	T	7	11	18	0	2	20	0	0
20	39210086	.	C	T	1	7	8	0	4	12	0	0
20	39213881	.	A	G	2	3	5	0	0	5	0	0
20	39216111	.	T	C	2	0	2	0	3	5	0	0
20	39216188	.	G	A	1	2	3	0	0	3	0	0
20	39219507	.	T	A	2	2	4	0	0	4	0	0
20	39235195	.	A	G	4	0	4	0	3	7	0	0
20	39254961	.	A	G	4	0	4	0	6	10	0	0
20	39256515	.	A	G	8	5	13	0	0	13	0	0
20	39256735	.	G	A	2	5	7	0	7	14	0	0
20	39256968	.	C	T	5	4	9	0	0	9	0	0
20	39258586	.	G	A	1	2	3	0	0	3	0	0
20	39259173	.	A	G	1	3	4	0	0	4	0	0
20	39259174	.	A	G	1	3	4	0	0	4	0	0
20	39259440	.	C	T	1	1	2	0	1	3	0	0
20	39259482	.	T	C	2	3	5	0	0	5	0	0
20	39259836	.	G	A	2	7	9	0	0	9	0	0
20	39260578	.	C	T	10	3	13	0	1	14	0	0
20	39260755	.	C	T	32	26	58	0	4	62	0	0
20	39260837	.	G	A	24	29	53	0	3	56	0	0
20	39260865	.	T	G	21	32	53	0	6	59	0	0
20	39267227	.	T	G	17	19	36	0	2	38	0	0
20	39271725	.	T	C	25	18	43	0	0	43	0	0
20	39271731	.	G	A	20	17	37	0	4	41	0	0
20	39271833	.	C	G	23	18	41	0	1	42	0	0
20	39273910	.	A	T	20	17	37	0	5	42	0	0
20	39338929	.	C	T	4	5	9	0	0	9	0	0
20	39338965	.	T	C	5	10	15	0	0	15	0	0
20	39338981	.	G	T	6	11	17	0	0	17	0	0
20	39339030	.	T	C	10	8	18	0	0	18	0	0
20	39339169	.	A	G	14	8	22	0	1	23	0	0
20	39341517	.	G	A	12	8	20	0	1	21	0	0
20	39341520	.	T	C	12	7	19	0	0	19	0	0
20	39343397	.	T	C	8	11	19	0	0	19	0	0
20	39344085	.	T	C	14	6	20	0	2	22	0	0
20	39349575	.	G	A	1	2	3	0	0	3	0	0
20	39513664	.	A	G	3	3	6	0	0	6	0	0
20	39514010	.	C	T	0	2	2	0	2	4	0	0
20	39520835	.	T	C	2	4	6	0	1	7	0	0
20	39520942	.	C	A	8	5	13	0	0	13	0	0
20	39554698	.	G	A	6	2	8	0	1	9	0	0
20	39557001	.	A	G	3	5	8	0	0	8	0	0
20	39579329	.	A	G	2	2	4	0	0	4	0	0
20	39582056	.	A	T	7	5	12	0	0	12	0	0
20	39582094	.	A	G	3	4	7	0	0	7	0	0
20	39589512	.	C	T	4	2	6	0	0	6	0	0
20	39806385	.	T	C	8	5	13	0	1	14	0	0
20	41237363	.	A	G	4	2	6	0	0	6	0	0
20	41237380	.	A	G	5	0	5	0	4	9	0	0
20	41237948	.	A	G	5	2	7	0	0	7	0	0
20	41239439	.	T	C	1	7	8	0	1	9	0	0
20	41998507	.	T	C	23	4	27	0	2	29	0	0
20	42047386	.	C	T	11	6	17	0	0	17	0	0
20	42100882	.	G	A	7	7	14	0	0	14	0	0
20	42203254	.	C	T	8	3	11	0	0	11	0	0
20	42203407	.	G	T	8	7	15	0	2	17	0	0
20	42203461	.	T	C	11	17	28	0	2	30	0	0
20	42203465	.	T	C	13	19	32	0	0	32	0	0
20	42221216	.	C	A	0	3	3	0	4	7	0	0
20	42221269	.	T	C	4	4	8	0	2	10	0	0
20	42221360	.	G	A	1	8	9	0	3	12	0	0
20	42221555	.	C	T	17	17	34	0	0	34	0	0
20	42221713	.	C	T	7	6	13	0	1	14	0	0
20	42221731	.	T	G	9	5	14	0	0	14	0	0
20	42221834	.	A	T	8	2	10	0	0	10	0	0
20	42221836	.	G	A	7	3	10	0	0	10	0	0
20	42221901	.	G	A	2	3	5	0	0	5	0	0
20	42222023	.	T	C	5	3	8	0	0	8	0	0
20	42222296	.	A	C	3	6	9	0	0	9	0	0
20	42222444	.	A	T	5	5	10	0	1	11	0	0
20	42222546	.	A	T	7	5	12	0	1	13	0	0
20	42222549	.	A	T	6	4	10	0	2	12	0	0
20	42222621	.	T	C	6	4	10	0	1	11	0	0
20	42222769	.	T	C	12	5	17	0	0	17	0	0
20	42222770	.	T	C	8	9	17	0	0	17	0	0
20	42222816	.	C	A	6	5	11	0	0	11	0	0
20	42222883	.	T	C	7	9	16	0	1	17	0	0
20	42232554	.	A	G	8	5	13	0	0	13	0	0
20	42233955	.	G	C	11	7	18	0	0	18	0	0
20	42241224	.	T	G	6	7	13	0	1	14	0	0
20	42247018	.	G	C	8	3	11	0	0	11	0	0
20	42247111	.	G	A	4	2	6	0	0	6	0	0
20	42247180	.	T	C	6	5	11	0	0	11	0	0
20	42247231	.	G	A	3	5	8	0	0	8	0	0
20	42269619	.	C	T	5	4	9	1	0	10	0	0
20	42280782	.	C	T	11	8	19	0	2	21	0	0
20	42280829	.	C	T	7	9	16	0	0	16	0	0
20	42281000	.	G	A	0	6	6	0	10	16	0	0
20	42281176	.	T	C	3	3	6	0	0	6	0	0
20	42281369	.	G	A	5	7	12	0	1	13	0	0
20	42281383	.	C	T	6	7	13	0	0	13	0	0
20	42297042	.	T	C	3	0	3	0	3	6	0	0
20	42297566	.	T	C	1	3	4	0	0	4	0	0
20	42300177	.	G	T	2	6	8	0	0	8	0	0
20	42304274	.	T	C	3	0	3	0	2	5	0	0
20	42590142	.	C	T	2	2	4	0	0	4	0	0
20	42604480	.	G	A	3	4	7	0	0	7	0	0
20	42614346	.	T	C	1	4	5	0	1	6	0	0
20	42617242	.	A	T	4	5	9	0	0	9	0	0
20	42619333	.	C	T	1	2	3	0	0	3	0	0
20	42624460	.	T	A	2	5	7	0	0	7	0	0
20	42627360	.	T	C	4	5	9	0	0	9	0	0
20	42631258	.	T	A	3	2	5	0	1	6	0	0
20	42631316	.	G	A	0	4	4	0	1	5	0	0
20	42650481	.	G	T	0	2	2	0	3	5	0	0
20	42653409	.	C	T	2	6	8	0	0	8	0	0
20	42653523	.	C	T	9	4	13	0	0	13	0	0
20	42660034	.	A	G	5	6	11	0	1	12	0	0
20	42660273	.	C	G	3	0	3	0	2	5	0	0
20	42660436	.	C	A	4	5	9	1	0	10	0	0
20	42660491	.	G	T	5	8	13	1	0	14	0	0
20	42684497	.	C	T	1	2	3	0	0	3	0	0
20	42687709	.	C	G	1	2	3	0	0	3	0	0
20	42688225	.	A	C	1	4	5	0	0	5	0	0
20	42749562	.	G	A	1	2	3	0	0	3	0	0
20	42919621	.	G	T	4	3	7	0	0	7	0	0
20	42939350	.	T	C	7	3	10	0	0	10	0	0
20	42939407	.	G	A	3	6	9	0	1	10	0	0
20	42939814	.	C	T	2	2	4	0	1	5	0	0
20	42939829	.	A	G	3	0	3	0	3	6	0	0
20	42941107	.	T	C	3	2	5	0	0	5	0	0
20	42941176	.	G	T	6	7	13	0	0	13	0	0
20	42953084	.	T	C	5	7	12	0	1	13	0	0
20	42953096	.	G	A	7	3	10	0	1	11	0	0
20	42953129	.	C	T	6	8	14	0	0	14	0	0
20	42954302	.	G	A	11	3	14	0	0	14	0	0
20	42968811	.	C	T	1	3	4	0	2	6	0	0
20	42969171	.	C	T	0	2	2	0	2	4	0	0
20	43004312	.	C	T	2	4	6	0	0	6	0	0
20	43016700	.	C	T	5	2	7	0	0	7	0	0
20	43016739	.	C	T	5	5	10	0	0	10	0	0
20	43016828	.	G	A	5	4	9	0	0	9	0	0
20	43016890	.	T	A	3	4	7	0	0	7	0	0
20	43016955	.	G	A	3	4	7	0	0	7	0	0
20	43017007	.	T	C	1	4	5	0	0	5	0	0
20	43017200	.	G	A	5	5	10	0	0	10	0	0
20	43017246	.	C	G	2	4	6	0	0	6	0	0
20	43035137	.	C	T	5	2	7	0	0	7	0	0
20	43036852	.	G	A	2	6	8	0	0	8	0	0
20	43041067	.	A	G	1	2	3	0	0	3	0	0
20	43120658	.	T	G	10	12	22	0	0	22	0	0
20	43120718	.	C	T	0	9	9	0	15	24	0	0
20	43121432	.	T	C	2	2	4	0	0	4	0	0
20	43121545	.	A	G	5	3	8	0	0	8	0	0
20	43121650	.	T	C	1	6	7	0	0	7	0	0
20	43122164	.	T	C	2	5	7	0	2	9	0	0
20	43122744	.	A	C	4	4	8	0	0	8	0	0
20	43123314	.	C	T	9	16	25	0	1	26	0	0
20	43133228	.	G	C	8	6	14	0	0	14	0	0
20	43133322	.	G	C	5	8	13	0	2	15	0	0
20	43133426	.	A	G	12	12	24	0	0	24	0	0
20	43158910	.	C	T	4	6	10	0	0	10	0	0
20	43159027	.	C	G	3	9	12	0	0	12	0	0
20	43159057	.	T	A	4	7	11	0	0	11	0	0
20	43161797	.	A	G	1	3	4	0	1	5	0	0
20	43184362	.	G	A	3	5	8	0	1	9	0	0
20	43194551	.	G	A	2	8	10	0	0	10	0	0
20	43194650	.	G	A	2	4	6	0	2	8	0	0
20	43194671	.	G	T	2	5	7	0	0	7	0	0
20	43227292	.	A	C	2	3	5	0	0	5	0	0
20	43252360	.	G	A	5	5	10	0	0	10	0	0
20	43648538	.	C	T	4	3	7	0	0	7	0	0
20	43652934	.	T	C	2	5	7	0	0	7	0	0
20	43652967	.	T	C	3	6	9	0	0	9	0	0
20	43655958	.	A	G	5	7	12	0	0	12	0	0
20	43655967	.	C	G	5	6	11	0	0	11	0	0
20	43656030	.	C	T	2	4	6	0	0	6	0	0
20	43670280	.	G	C	5	2	7	0	0	7	0	0
20	43671935	.	G	A	6	2	8	0	0	8	0	0
20	43673634	.	G	A	1	2	3	0	8	11	0	0
20	43675840	.	G	A	1	2	3	0	7	10	0	0
20	43680616	.	C	A	6	6	12	0	1	14	1	0
20	43680700	.	G	A	10	5	15	0	0	15	0	0
20	43680752	.	C	T	4	3	7	0	0	7	0	0
20	43683238	.	A	G	12	0	12	0	8	20	0	0
20	43686738	.	G	A	8	10	18	0	2	20	0	0
20	43689138	.	T	A	9	5	14	0	0	14	0	0
20	43689360	.	C	T	7	11	18	1	1	20	0	0
20	43689418	.	G	A	2	8	10	0	8	18	0	0
20	43711968	.	A	G	5	3	8	0	0	8	0	0
20	43714699	.	T	G	1	0	1	0	3	4	0	0
20	43715032	.	T	A	7	3	10	0	0	10	0	0
20	43746738	.	A	G	6	2	8	0	0	8	0	0
20	43746749	.	C	T	0	2	2	0	6	8	0	0
20	43746890	.	T	C	7	0	7	0	12	19	0	0
20	43750362	.	A	G	9	12	21	0	1	22	0	0
20	43750680	.	A	G	13	10	23	0	0	23	0	0
20	43776373	.	T	C	31	18	49	0	2	51	0	0
20	43776456	.	T	A	30	21	51	0	1	52	0	0
20	43776841	.	G	A	33	33	66	0	2	68	0	0
20	43776842	.	A	G	36	33	69	0	1	70	0	0
20	43786415	.	T	C	26	19	45	0	0	45	0	0
20	43793065	.	T	C	7	8	15	0	0	15	0	0
20	43793193	.	G	A	20	10	30	0	3	33	0	0
20	43793329	.	C	T	15	7	22	0	3	25	0	0
20	43793410	.	C	A	1	10	11	0	8	19	0	0
20	43793428	.	G	A	8	15	23	0	1	24	0	0
20	43793666	.	C	T	0	4	4	0	13	17	0	0
20	43793683	.	G	A	10	8	18	0	0	18	0	0
20	43793702	.	C	T	10	15	25	0	0	25	0	0
20	43793867	.	A	C	10	7	17	0	1	18	0	0
20	43793901	.	A	G	12	13	25	0	1	26	0	0
20	43793960	.	A	T	10	14	24	0	0	24	0	0
20	43794004	.	G	A	17	13	30	0	0	30	0	0
20	43794053	.	A	T	17	21	38	0	1	39	0	0
20	43794312	.	C	T	1	8	9	0	8	17	0	0
20	43794488	.	A	G	12	12	24	0	1	25	0	0
20	43812584	.	G	A	11	11	22	0	0	22	0	0
20	43825607	.	A	G	8	9	17	0	0	17	0	0
20	43831482	.	T	C	10	17	27	0	1	28	0	0
20	43895806	.	G	A	13	9	22	0	1	23	0	0
20	43895827	.	T	A	13	11	24	0	1	25	0	0
20	43942365	.	T	C	3	2	5	0	0	5	0	0
20	43996111	.	A	T	2	2	4	0	0	4	0	0
20	43996130	.	G	A	2	2	4	0	0	4	0	0
20	44344473	.	C	T	1	3	4	0	0	4	0	0
20	44344482	.	A	C	0	5	5	0	0	5	0	0
20	44372854	.	G	C	9	4	13	1	0	14	0	0
20	44372973	.	C	A	5	13	18	0	0	18	0	0
20	44372977	.	C	T	5	12	17	0	1	18	0	0
20	44373336	.	G	A	24	9	33	0	1	34	0	0
20	44373378	.	A	G	20	14	34	0	0	34	0	0
20	44386452	.	C	T	1	16	17	0	16	33	0	0
20	44386501	.	A	G	19	17	36	0	1	37	0	0
20	44389647	.	G	A	16	16	32	0	0	32	0	0
20	44402769	.	C	T	13	14	27	0	1	28	0	0
20	44447798	.	G	T	9	14	23	0	0	23	0	0
20	44451262	.	G	A	7	6	13	0	1	14	0	0
20	44451286	.	C	A	0	10	10	0	6	16	0	0
20	44457278	.	C	T	9	9	18	0	1	19	0	0
20	44457311	.	G	C	11	0	11	0	10	21	0	0
20	44457314	.	A	G	10	11	21	0	1	22	0	0
20	44457593	.	C	T	12	14	26	0	1	27	0	0
20	44457595	.	G	T	14	12	26	0	1	27	0	0
20	44457659	.	A	T	7	7	14	0	1	15	0	0
20	44464502	.	G	T	5	2	7	0	0	8	1	0
20	44464579	.	T	C	12	9	21	0	0	21	0	0
20	44502754	.	G	T	0	2	2	0	1	3	0	0
20	44509653	.	C	T	0	6	6	1	2	9	0	0
20	44514469	.	C	T	0	3	3	0	3	6	0	0
20	44514502	.	A	G	2	7	9	0	0	9	0	0
20	44517604	.	C	T	2	5	7	0	0	7	0	0
20	44518070	.	G	T	7	4	11	0	0	11	0	0
20	44519142	.	G	A	1	3	4	0	0	4	0	0
20	44523197	.	A	G	4	2	6	0	0	6	0	0
20	44523296	.	A	G	3	4	7	0	0	7	0	0
20	44530085	.	T	A	2	2	4	0	0	4	0	0
20	44555668	.	G	A	4	2	6	0	0	6	0	0
20	44555671	.	A	G	3	2	5	0	1	6	0	0
20	44566955	.	T	G	7	13	20	0	3	23	0	0
20	44567001	.	G	A	11	13	24	0	0	24	0	0
20	44569943	.	C	A	17	9	26	0	2	28	0	0
20	44680479	.	C	A	2	2	4	0	0	4	0	0
20	44761074	.	A	G	5	2	7	0	1	8	0	0
20	44799458	.	T	A	15	7	22	0	2	24	0	0
20	45406735	.	C	T	3	3	6	0	5	19	8	0
20	45406870	.	G	A	13	16	29	1	0	30	0	0
20	45406997	.	T	C	7	9	16	0	0	16	0	0
20	45407313	.	T	A	9	11	20	0	1	21	0	0
20	45407327	.	T	C	11	0	11	0	11	22	0	0
20	45408047	.	T	C	7	14	21	0	0	21	0	0
20	45408179	.	G	C	7	10	17	0	0	17	0	0
20	45408345	.	G	A	10	7	17	0	0	17	0	0
20	45621632	.	A	G	1	6	7	0	0	7	0	0
20	45621641	.	A	T	1	6	7	0	0	7	0	0
20	45621669	.	G	A	6	5	11	0	0	11	0	0
20	45621739	.	G	A	0	2	2	0	1	3	0	0
20	45622267	.	G	T	3	6	9	0	0	9	0	0
20	45643846	.	G	T	7	3	10	1	0	11	0	0
20	45643947	.	G	C	11	10	21	0	0	21	0	0
20	45644095	.	C	T	8	6	14	0	3	17	0	0
20	45644096	.	T	G	11	6	17	0	0	17	0	0
20	45644152	.	G	C	17	5	22	2	0	24	0	0
20	45644163	.	G	T	19	7	26	2	0	28	0	0
20	45644275	.	G	A	11	11	22	0	1	23	0	0
20	45645560	.	A	G	13	16	29	0	0	29	0	0
20	45648487	.	C	A	2	12	14	0	17	31	0	0
20	45653434	.	A	G	9	5	14	15	0	29	0	0
20	45656899	.	A	G	9	8	17	0	1	18	0	0
20	45661000	.	C	T	9	4	13	0	0	13	0	0
20	45669311	.	C	T	13	21	34	0	1	35	0	0
20	45669353	.	C	T	2	14	16	0	22	38	0	0
20	45679302	.	T	G	11	5	16	0	0	16	0	0
20	45679303	.	T	A	11	5	16	0	0	16	0	0
20	45682240	.	A	C	12	9	21	0	1	22	0	0
20	45708968	.	A	G	9	9	18	0	0	18	0	0
20	45742077	.	A	G	11	7	18	0	0	18	0	0
20	45742126	.	C	T	10	10	20	0	0	20	0	0
20	45745423	.	C	T	19	11	30	0	1	31	0	0
20	45745930	.	A	G	11	0	11	0	6	17	0	0
20	45746063	.	C	T	12	12	24	0	3	27	0	0
20	45746064	.	A	G	10	15	25	0	2	27	0	0
20	45746297	.	C	T	11	13	24	0	2	26	0	0
20	45746402	.	G	A	22	21	43	0	1	44	0	0
20	45746432	.	C	T	23	13	36	0	1	37	0	0
20	45746486	.	T	C	10	22	32	0	0	32	0	0
20	45746524	.	T	A	12	19	31	0	2	33	0	0
20	45746567	.	C	T	15	16	31	0	3	34	0	0
20	45746588	.	C	A	19	16	35	0	0	35	0	0
20	45746797	.	T	C	20	14	34	0	0	34	0	0
20	45746807	.	A	C	17	16	33	0	2	35	0	0
20	45747089	.	A	T	19	17	36	0	2	38	0	0
20	45747098	.	A	G	19	15	34	0	4	38	0	0
20	45747125	.	G	A	2	13	15	0	18	33	0	0
20	45751304	.	T	C	15	16	31	0	0	31	0	0
20	45751364	.	T	A	12	15	27	0	1	28	0	0
20	45751561	.	G	C	1	12	13	0	9	22	0	0
20	45751989	.	T	A	6	10	16	0	1	17	0	0
20	45759488	.	C	T	5	1	6	0	1	7	0	0
20	45759508	.	G	A	4	4	8	0	0	8	0	0
20	45763038	.	T	C	1	5	6	0	0	6	0	0
20	45764707	.	C	T	4	5	9	0	0	9	0	0
20	45764722	.	T	C	6	3	9	0	0	9	0	0
20	45766941	.	G	A	2	2	4	0	0	4	0	0
20	45772072	.	G	T	1	2	3	0	0	3	0	0
20	45898830	.	G	A	0	2	2	0	1	3	0	0
20	46311787	.	T	C	1	2	3	0	0	3	0	0
20	46352851	.	C	A	4	4	8	0	1	9	0	0
20	46352909	.	C	G	2	3	5	0	0	5	0	0
20	46353253	.	G	A	7	6	13	0	0	13	0	0
20	46353259	.	G	A	8	5	13	0	0	13	0	0
20	46353321	.	A	T	5	7	12	1	2	15	0	0
20	46353428	.	C	T	8	4	12	0	3	15	0	0
20	46357199	.	C	G	6	6	12	0	0	12	0	0
20	46357298	.	T	G	10	6	16	0	0	16	0	0
20	46357302	.	G	A	4	10	14	0	2	16	0	0
20	46357337	.	T	C	8	8	16	0	0	16	0	0
20	46359889	.	T	C	4	0	4	0	4	8	0	0
20	46435243	.	G	A	4	4	8	1	0	9	0	0
20	46437264	.	G	A	4	5	9	0	0	9	0	0
20	46439988	.	A	G	5	0	5	0	6	11	0	0
20	46441612	.	G	A	0	3	3	0	4	7	0	0
20	46441627	.	C	T	5	4	9	0	0	9	0	0
20	46441695	.	G	C	5	3	8	0	0	8	0	0
20	46442397	.	T	C	2	7	9	0	0	9	0	0
20	46457175	.	A	T	15	14	29	0	1	30	0	0
20	46457334	.	T	C	13	1	14	0	17	31	0	0
20	46457376	.	A	G	14	12	26	0	3	29	0	0
20	46463315	.	T	A	10	10	20	0	0	20	0	0
20	46463327	.	T	C	9	0	9	0	12	21	0	0
20	46466920	.	G	A	10	13	23	0	0	23	0	0
20	46467054	.	T	C	4	8	12	0	0	12	0	0
20	46467174	.	A	C	15	15	30	0	3	33	0	0
20	46492279	.	T	C	6	5	11	0	0	11	0	0
20	46492305	.	A	C	5	2	7	0	0	7	0	0
20	46498023	.	C	A	6	6	12	0	0	12	0	0
20	46502334	.	C	T	2	3	5	0	0	5	0	0
20	46502423	.	T	A	4	6	10	0	0	10	0	0
20	46502505	.	C	T	5	7	12	0	0	12	0	0
20	46502535	.	C	A	6	8	14	0	0	14	0	0
20	46506079	.	G	A	0	4	4	0	12	16	0	0
20	46506203	.	T	A	9	7	16	0	3	19	0	0
20	46509336	.	G	A	1	6	7	0	9	16	0	0
20	46509343	.	A	G	6	0	6	0	10	16	0	0
20	46515680	.	C	T	11	6	17	0	0	17	0	0
20	46517173	.	A	T	7	7	14	0	0	14	0	0
20	46517286	.	C	G	8	8	16	0	0	16	0	0
20	46517429	.	C	T	12	9	21	0	0	21	0	0
20	46519076	.	A	G	7	6	13	0	1	14	0	0
20	46519082	.	G	A	1	7	8	0	5	13	0	0
20	46519148	.	T	A	11	5	16	0	1	17	0	0
20	46525639	.	T	A	12	14	26	0	0	26	0	0
20	46528643	.	T	C	6	6	12	0	2	14	0	0
20	46529398	.	G	A	14	7	21	0	2	23	0	0
20	46529479	.	T	C	11	10	21	0	1	23	1	0
20	46534087	.	T	A	1	7	8	0	0	8	0	0
20	46534093	.	A	G	1	6	7	0	1	8	0	0
20	46536906	.	T	G	22	15	37	0	1	38	0	0
20	46537039	.	A	T	25	24	49	0	1	50	0	0
20	46537231	.	C	G	22	21	43	0	4	47	0	0
20	46537239	.	C	T	23	19	42	0	5	47	0	0
20	46537404	.	G	A	12	9	21	0	1	22	0	0
20	46539619	.	A	G	21	19	40	0	2	42	0	0
20	46540898	.	A	G	15	20	35	0	0	35	0	0
20	46552965	.	G	T	24	18	42	0	3	45	0	0
20	46552966	.	G	T	25	17	42	0	3	45	0	0
20	46553020	.	T	G	24	29	53	0	3	56	0	0
20	46553274	.	G	C	17	19	36	0	2	38	0	0
20	46553512	.	T	C	4	6	10	0	0	10	0	0
20	46554037	.	G	T	2	2	4	0	0	4	0	0
20	46554063	.	T	A	1	2	3	0	0	3	0	0
20	46560419	.	G	T	3	3	6	0	0	6	0	0
20	46564009	.	G	A	5	4	9	0	0	9	0	0
20	46564120	.	G	C	0	6	6	0	1	7	0	0
20	46564267	.	C	T	4	5	9	0	0	9	0	0
20	46572569	.	C	G	0	2	2	0	1	3	0	0
20	46699344	.	T	C	7	9	16	0	0	16	0	0
20	46712835	.	C	T	1	3	4	0	1	5	0	0
20	46713607	.	C	T	8	5	13	0	1	14	0	0
20	46721084	.	G	A	8	4	12	0	1	13	0	0
20	46724740	.	C	T	11	10	21	0	1	22	0	0
20	46730654	.	T	C	9	17	26	0	2	28	0	0
20	46730663	.	G	A	9	16	25	0	4	29	0	0
20	46730734	.	C	T	16	13	29	0	1	30	0	0
20	46731010	.	T	A	12	6	18	0	2	20	0	0
20	46732062	.	G	T	10	6	16	0	0	16	0	0
20	46732336	.	T	G	2	0	2	0	13	15	0	0
20	46732359	.	T	C	6	3	9	0	0	9	0	0
20	46732848	.	T	A	10	19	29	0	0	29	0	0
20	46732887	.	C	T	16	14	30	0	0	30	0	0
20	46733096	.	C	T	4	4	8	0	3	11	0	0
20	46733764	.	A	G	8	7	15	0	1	16	0	0
20	46733809	.	G	A	9	3	12	1	1	14	0	0
20	46733861	.	C	T	4	4	8	2	0	10	0	0
20	46742633	.	A	C	4	5	9	0	0	9	0	0
20	46746711	.	G	A	1	7	8	0	9	17	0	0
20	46758728	.	C	T	2	6	8	0	0	8	0	0
20	46758782	.	G	A	4	6	10	0	0	10	0	0
20	46759449	.	G	T	9	6	15	0	0	15	0	0
20	46835112	.	A	G	5	3	8	0	0	8	0	0
20	46835350	.	C	T	2	3	5	0	4	9	0	0
20	46835357	.	T	G	7	2	9	0	0	9	0	0
20	46835432	.	G	A	3	9	12	0	1	13	0	0
20	46858896	.	G	A	12	5	17	0	1	18	0	0
20	46859160	.	G	T	9	5	14	0	0	14	0	0
20	46859259	.	A	G	2	5	7	0	0	7	0	0
20	46859328	.	G	A	3	8	11	0	0	11	0	0
20	46859418	.	A	G	7	7	14	0	0	14	0	0
20	46886856	.	T	A	1	3	4	0	0	4	0	0
20	46889273	.	A	T	2	3	5	0	0	5	0	0
20	46918894	.	A	T	1	2	3	0	0	3	0	0
20	46935470	.	A	G	1	1	2	0	2	4	0	0
20	46945945	.	G	T	1	5	6	0	0	6	0	0
20	46946356	.	T	A	2	2	4	0	1	5	0	0
20	46957559	.	G	T	20	29	49	0	0	49	0	0
20	46957575	.	C	G	22	31	53	0	0	53	0	0
20	46957600	.	T	A	21	19	40	0	0	40	0	0
20	46957650	.	A	T	19	20	39	0	1	40	0	0
20	46957803	.	T	A	18	10	28	1	3	32	0	0
20	46958136	.	C	T	7	11	18	0	1	19	0	0
20	46958478	.	T	C	23	0	23	0	18	41	0	0
20	46958705	.	G	T	12	14	26	0	1	27	0	0
20	46958766	.	T	A	11	14	25	0	0	25	0	0
20	46959135	.	T	C	18	21	39	0	1	40	0	0
20	46959147	.	A	T	19	20	39	0	0	39	0	0
20	46959465	.	C	A	9	15	24	1	1	26	0	0
20	46959477	.	A	T	7	15	22	1	0	23	0	0
20	46959504	.	T	C	6	12	18	0	1	19	0	0
20	46959525	.	T	C	10	1	11	0	8	19	0	0
20	46959543	.	A	T	10	6	16	0	1	17	0	0
20	46967563	.	T	G	1	5	6	0	0	6	0	0
20	46969436	.	A	C	9	0	9	0	4	13	0	0
20	46970314	.	A	G	5	6	11	0	1	12	0	0
20	46970344	.	T	A	4	7	11	0	1	12	0	0
20	46974693	.	G	C	2	4	6	0	0	6	0	0
20	46974942	.	C	T	7	8	15	0	2	17	0	0
20	46980230	.	A	G	3	2	5	0	1	6	0	0
20	46986128	.	A	C	4	2	6	0	0	6	0	0
20	46994504	.	G	A	4	6	10	0	0	10	0	0
20	46994543	.	A	G	3	4	7	0	0	7	0	0
20	48470508	.	A	T	3	2	5	0	0	5	0	0
20	48483921	.	C	G	2	4	6	0	0	6	0	0
20	48483989	.	A	T	1	8	9	0	0	9	0	0
20	48484411	.	A	C	10	0	10	0	10	20	0	0
20	48598493	.	C	T	9	20	29	0	0	29	0	0
20	48785502	.	A	T	2	2	4	0	0	4	0	0
20	48806166	.	T	C	4	4	8	0	0	8	0	0
20	48844050	.	T	C	18	1	19	0	24	43	0	0
20	48844134	.	A	G	17	7	24	0	0	24	0	0
20	48844295	.	C	T	0	7	7	0	26	33	0	0
20	48845298	.	A	G	18	13	31	0	1	32	0	0
20	48860755	.	G	A	13	8	21	1	0	22	0	0
20	48869895	.	G	A	8	13	21	0	0	21	0	0
20	48877311	.	G	T	9	10	19	0	0	19	0	0
20	48877475	.	G	A	7	6	13	0	0	13	0	0
20	48886005	.	C	T	6	6	12	0	1	13	0	0
20	48895103	.	G	A	2	10	12	0	2	14	0	0
20	49082581	.	C	T	2	2	4	0	0	4	0	0
20	49085648	.	G	A	6	6	12	0	0	12	0	0
20	49087720	.	A	G	7	0	7	0	3	10	0	0
20	49087762	.	G	A	0	3	3	0	6	9	0	0
20	49087768	.	G	A	8	3	11	0	0	11	0	0
20	49087816	.	G	T	5	3	8	0	0	8	0	0
20	49089192	.	T	C	6	2	8	0	0	8	0	0
20	49089237	.	C	T	6	3	9	0	0	9	0	0
20	49094970	.	C	T	7	4	11	0	0	11	0	0
20	49094973	.	T	C	6	4	10	0	0	10	0	0
20	49099900	.	A	G	5	6	11	0	0	11	0	0
20	49100237	.	C	T	4	11	15	0	3	18	0	0
20	49103131	.	G	A	10	10	20	0	1	21	0	0
20	49103164	.	G	A	8	7	15	0	1	16	0	0
20	49103217	.	A	T	3	4	7	0	0	7	0	0
20	49105469	.	A	T	4	2	6	0	0	6	0	0
20	49788219	.	G	A	1	3	4	0	1	5	0	0
20	49795211	.	C	T	2	2	4	0	0	4	0	0
20	49804459	.	C	T	3	4	7	0	0	7	0	0
20	49895249	.	T	A	2	3	5	0	0	5	0	0
20	49905163	.	C	T	2	3	5	0	0	5	0	0
20	49928292	.	C	A	1	3	4	0	1	5	0	0
20	49928295	.	A	G	1	1	2	0	3	5	0	0
20	49940969	.	G	T	8	4	12	0	0	12	0	0
20	49952738	.	A	G	18	8	26	0	0	26	0	0
20	49960314	.	A	G	10	6	16	0	0	16	0	0
20	49960328	.	A	G	11	5	16	0	1	17	0	0
20	49960791	.	A	G	5	2	7	0	0	7	0	0
20	49961215	.	G	A	5	3	8	0	1	9	0	0
20	49961402	.	T	G	4	2	6	0	0	6	0	0
20	50015754	.	C	T	7	4	11	0	0	11	0	0
20	50022331	.	T	C	2	2	4	0	0	4	0	0
20	50022333	.	G	C	2	2	4	0	0	4	0	0
20	50022384	.	A	G	5	2	7	0	0	7	0	0
20	50022393	.	G	C	5	2	7	0	0	7	0	0
20	50037402	.	T	G	7	0	7	0	5	12	0	0
20	50041707	.	A	G	4	4	8	0	0	8	0	0
20	50044719	.	G	T	0	5	5	0	1	6	0	0
20	50044739	.	C	T	1	3	4	0	0	4	0	0
20	50049036	.	G	C	42	0	42	0	18	60	0	0
20	50049078	.	C	A	37	24	61	0	2	63	0	0
20	50057348	.	C	T	4	5	9	0	0	9	0	0
20	50074077	.	C	T	8	9	17	0	0	17	0	0
20	50074173	.	C	T	9	8	17	0	0	17	0	0
20	50074212	.	C	T	11	7	18	0	0	18	0	0
20	50076480	.	G	A	0	3	3	0	10	13	0	0
20	50079019	.	C	G	3	8	11	0	0	11	0	0
20	50079067	.	T	C	7	10	17	0	0	17	0	0
20	50079070	.	A	G	7	9	16	0	0	16	0	0
20	50079154	.	T	C	10	8	18	0	1	19	0	0
20	50082425	.	A	G	6	8	14	0	0	14	0	0
20	50082861	.	T	C	6	8	14	0	0	14	0	0
20	50650253	.	G	A	0	3	3	0	2	5	0	0
20	50740230	.	G	T	1	5	6	0	6	12	0	0
20	50898883	.	T	C	12	19	31	0	0	31	0	0
20	50917646	.	T	C	11	6	17	0	1	18	0	0
20	50921211	.	T	C	12	11	23	0	1	24	0	0
20	50923848	.	G	A	13	15	28	0	0	28	0	0
20	50926695	.	G	A	1	8	9	0	14	23	0	0
20	50989199	.	A	G	12	0	12	0	12	24	0	0
20	50999024	.	C	G	20	26	46	0	1	47	0	0
20	51069996	.	T	C	6	6	12	0	0	12	0	0
20	51073369	.	A	T	10	14	24	0	0	24	0	0
20	51073449	.	G	A	0	6	6	0	18	24	0	0
20	51073692	.	G	A	6	11	17	0	1	18	0	0
20	51073730	.	G	A	15	12	27	0	1	28	0	0
20	51074291	.	A	G	4	0	4	0	6	10	0	0
20	51074317	.	C	T	5	5	10	0	0	10	0	0
20	51074352	.	A	T	6	3	9	0	0	9	0	0
20	51088802	.	A	T	35	23	58	0	0	58	0	0
20	51089236	.	T	C	23	1	24	2	22	48	0	0
20	51089243	.	T	C	18	26	44	2	1	47	0	0
20	51100498	.	T	C	16	15	31	0	1	32	0	0
20	51100562	.	A	G	35	14	49	0	0	49	0	0
20	51112184	.	C	T	18	12	30	0	3	33	0	0
20	51112208	.	C	T	10	13	23	0	2	25	0	0
20	51117661	.	A	C	24	16	40	0	2	42	0	0
20	51117664	.	G	A	18	23	41	0	1	42	0	0
20	51118227	.	A	G	16	0	16	0	32	48	0	0
20	51118281	.	C	A	33	21	54	0	3	57	0	0
20	51118314	.	T	C	21	22	43	0	1	44	0	0
20	51122939	.	C	T	21	19	40	0	2	42	0	0
20	51123088	.	C	T	12	19	31	0	1	32	0	0
20	51123109	.	G	C	16	12	28	0	2	30	0	0
20	51132106	.	G	A	10	1	11	0	3	14	0	0
20	51132127	.	C	G	9	3	12	0	1	13	0	0
20	51132284	.	A	G	19	18	37	0	0	37	0	0
20	51141284	.	C	T	2	9	11	0	8	19	0	0
20	51146152	.	T	G	7	13	20	0	0	20	0	0
20	51146153	.	G	A	13	7	20	0	0	20	0	0
20	51146194	.	A	G	8	10	18	0	0	18	0	0
20	51150029	.	G	T	11	10	21	1	2	24	0	0
20	51151647	.	G	A	13	12	25	0	1	26	0	0
20	51157010	.	T	G	11	21	32	0	1	33	0	0
20	51157061	.	C	T	2	15	17	0	19	36	0	0
20	51157082	.	T	C	18	16	34	0	1	35	0	0
20	51157109	.	C	T	16	23	39	0	3	42	0	0
20	51157204	.	G	A	17	12	29	0	1	30	0	0
20	51168502	.	T	C	5	7	12	0	0	12	0	0
20	51200015	.	C	T	28	35	63	0	9	72	0	0
20	51204759	.	C	T	39	29	68	0	11	79	0	0
20	51205691	.	T	G	34	45	79	0	3	82	0	0
20	51205745	.	G	A	47	43	90	0	2	92	0	0
20	51206976	.	C	A	41	35	76	0	4	80	0	0
20	51207030	.	C	T	48	34	82	0	1	83	0	0
20	51207051	.	G	A	46	38	84	0	3	87	0	0
20	51207609	.	C	A	41	46	87	0	7	94	0	0
20	51207672	.	C	T	33	47	80	0	4	84	0	0
20	51207726	.	C	T	44	34	78	0	6	84	0	0
20	51211455	.	G	A	15	39	54	0	36	90	0	0
20	51240121	.	C	G	0	4	4	0	5	9	0	0
20	51240130	.	T	G	5	3	8	0	0	8	0	0
20	51274609	.	C	T	0	2	2	0	4	6	0	0
20	51274618	.	G	T	2	4	6	0	0	6	0	0
20	51274693	.	C	T	1	4	5	0	0	5	0	0
20	51276342	.	G	A	5	5	10	0	0	10	0	0
20	51307695	.	G	A	2	3	5	0	0	5	0	0
20	51313049	.	C	T	7	8	15	0	4	19	0	0
20	51332296	.	A	G	1	4	5	0	1	6	0	0
20	51332317	.	A	G	3	0	3	0	7	10	0	0
20	51332530	.	C	T	3	3	6	0	0	6	0	0
20	51332686	.	C	T	2	2	4	0	0	4	0	0
20	51332917	.	G	C	3	1	4	0	2	6	0	0
20	51333283	.	T	A	2	3	5	0	0	5	0	0
20	51333547	.	G	A	6	2	8	0	0	8	0	0
20	51333698	.	A	C	1	7	8	0	0	8	0	0
20	51334081	.	G	A	5	7	12	1	0	13	0	0
20	51334173	.	G	T	5	2	7	0	0	7	0	0
20	51334229	.	C	T	1	1	2	1	1	4	0	0
20	51363902	.	C	T	0	11	11	0	5	16	0	0
20	51363926	.	A	T	4	9	13	0	0	13	0	0
20	51370329	.	C	T	12	19	31	0	0	31	0	0
20	51377075	.	C	T	7	13	20	0	4	24	0	0
20	51383472	.	G	A	10	13	23	0	3	26	0	0
20	51383706	.	C	T	3	7	10	0	7	17	0	0
20	51383804	.	C	G	17	10	27	0	0	27	0	0
20	51384072	.	C	T	3	7	10	0	7	17	0	0
20	51489705	.	A	G	2	3	5	0	0	5	0	0
20	51489862	.	A	G	1	3	4	0	0	4	0	0
20	51489866	.	G	A	1	4	5	0	0	5	0	0
20	51492667	.	G	A	2	4	6	0	0	6	0	0
20	51648072	.	A	G	11	6	17	0	0	17	0	0
20	51649884	.	C	G	0	3	3	0	2	5	0	0
20	51649887	.	A	G	3	3	6	0	0	6	0	0
20	51649935	.	G	A	4	3	7	0	0	7	0	0
20	51703406	.	T	C	15	17	32	0	2	34	0	0
20	51703445	.	C	T	2	15	17	0	20	37	0	0
20	51703939	.	G	A	16	15	31	0	2	33	0	0
20	51704001	.	C	T	13	21	34	0	1	35	0	0
20	51720465	.	A	G	8	10	18	0	0	18	0	0
20	51721612	.	A	G	9	11	20	0	1	21	0	0
20	51723187	.	G	T	8	11	19	0	1	20	0	0
20	51730662	.	T	G	3	4	7	0	0	7	0	0
20	51738939	.	A	G	9	0	9	0	3	12	0	0
20	51743891	.	T	C	12	14	26	0	1	27	0	0
20	51749045	.	A	G	7	5	12	1	0	13	0	0
20	51749074	.	C	T	7	4	11	0	0	11	0	0
20	51753384	.	A	T	11	8	19	0	1	20	0	0
20	51753509	.	G	A	1	5	6	0	10	16	0	0
20	51758602	.	A	C	17	9	26	0	0	26	0	0
20	51758975	.	A	G	12	9	21	0	0	21	0	0
20	51759191	.	A	C	7	8	15	0	2	17	0	0
20	51759272	.	G	A	10	6	16	0	0	16	0	0
20	51759273	.	T	A	10	5	15	0	1	16	0	0
20	51772430	.	C	T	11	11	22	0	3	25	0	0
20	51787380	.	A	G	7	7	14	0	1	15	0	0
20	51794071	.	A	G	12	8	20	0	0	20	0	0
20	51798112	.	T	C	12	9	21	0	1	22	0	0
20	51799052	.	G	A	5	6	11	0	1	12	0	0
20	51803856	.	G	T	8	6	14	0	0	14	0	0
20	51807449	.	C	T	0	6	6	0	5	11	0	0
20	51810872	.	T	C	3	0	3	0	3	6	0	0
20	51810878	.	C	T	0	4	4	0	3	7	0	0
20	51813790	.	A	G	1	4	5	0	0	5	0	0
20	51817532	.	A	G	3	2	5	0	0	5	0	0
20	51819156	.	A	G	4	2	6	0	0	6	0	0
20	51819263	.	T	C	2	3	5	0	0	5	0	0
20	51819309	.	C	G	0	6	6	0	4	10	0	0
20	51821286	.	G	T	8	4	12	0	0	12	0	0
20	51821380	.	T	C	5	2	7	0	0	7	0	0
20	51873991	.	C	A	4	6	10	0	0	10	0	0
20	51874222	.	T	C	2	2	4	0	0	4	0	0
20	51874223	.	C	T	1	2	3	0	1	4	0	0
20	52333177	.	T	C	6	0	6	0	7	13	0	0
20	52333202	.	T	C	6	7	13	0	0	13	0	0
20	52333344	.	A	G	7	8	15	0	0	15	0	0
20	52333388	.	A	G	5	9	14	0	0	14	0	0
20	52390235	.	C	G	4	1	5	0	6	11	0	0
20	52390271	.	T	C	3	5	8	0	0	8	0	0
20	52404347	.	G	A	8	10	18	0	0	18	0	0
20	52404387	.	T	A	4	7	11	0	1	12	0	0
20	52404398	.	T	C	4	4	8	0	1	9	0	0
20	52404554	.	A	G	3	0	3	0	7	10	0	0
20	52404578	.	C	T	8	4	12	0	0	12	0	0
20	52404722	.	T	C	5	4	9	0	0	9	0	0
20	52404935	.	T	A	5	5	10	0	0	10	0	0
20	52415876	.	T	C	3	2	5	0	1	6	0	0
20	52415935	.	C	G	2	7	9	0	1	10	0	0
20	52416020	.	C	A	6	6	12	0	0	12	0	0
20	52416080	.	C	T	4	5	9	0	0	9	0	0
20	52416107	.	C	T	4	6	10	0	0	10	0	0
20	52420015	.	T	G	8	0	8	0	11	19	0	0
20	52458788	.	C	G	3	3	6	0	0	6	0	0
20	52458831	.	A	T	1	7	8	0	1	9	0	0
20	52458987	.	G	T	2	4	6	0	3	9	0	0
20	52471685	.	G	C	5	2	7	1	0	8	0	0
20	52471706	.	G	C	0	2	2	1	4	7	0	0
20	52473266	.	C	T	9	3	12	0	1	13	0	0
20	52482128	.	T	C	6	2	8	0	0	8	0	0
20	52482448	.	G	A	5	9	14	0	0	14	0	0
20	52482484	.	T	C	5	5	10	0	0	10	0	0
20	52487851	.	C	T	2	2	4	0	0	4	0	0
20	52487948	.	T	C	2	3	5	0	0	5	0	0
20	52488226	.	A	T	3	6	9	0	0	9	0	0
20	52540710	.	A	G	3	0	3	0	2	5	0	0
20	52540721	.	A	G	3	2	5	0	0	5	0	0
20	52540825	.	G	T	2	3	5	0	1	6	0	0
20	52540868	.	A	T	2	3	5	0	0	5	0	0
20	52540873	.	T	A	2	3	5	0	0	5	0	0
20	52540928	.	C	T	2	5	7	1	2	10	0	0
20	52540946	.	T	A	5	4	9	1	0	10	0	0
20	52541325	.	T	A	1	2	3	0	1	4	0	0
20	52543855	.	A	G	3	0	3	1	5	9	0	0
20	52544491	.	A	C	3	3	6	0	1	7	0	0
20	52544559	.	T	C	5	6	11	0	0	11	0	0
20	52544612	.	G	T	2	5	7	0	0	7	0	0
20	52554222	.	G	A	26	18	44	0	3	47	0	0
20	52554283	.	C	T	21	17	38	0	1	39	0	0
20	52574813	.	G	A	0	18	18	0	34	52	0	0
20	52574900	.	G	A	4	31	35	0	24	59	0	0
20	52575020	.	A	G	29	2	31	0	29	60	0	0
20	52575377	.	T	C	18	19	37	0	3	40	0	0
20	52582594	.	A	T	5	5	10	0	0	10	0	0
20	52722825	.	T	G	1	2	3	0	0	3	0	0
20	52724917	.	C	T	3	2	5	0	0	5	0	0
20	52724949	.	G	A	3	2	5	0	0	5	0	0
20	52725230	.	A	G	1	2	3	0	0	3	0	0
20	53278952	.	C	T	1	2	3	0	0	3	0	0
20	53302205	.	G	A	3	2	5	0	0	5	0	0
20	53312604	.	G	T	6	14	20	0	5	25	0	0
20	53318814	.	G	T	9	15	24	0	0	24	0	0
20	53318884	.	C	T	1	23	24	0	14	38	0	0
20	53365862	.	C	T	6	8	14	1	2	17	0	0
20	53366073	.	A	C	6	5	11	0	0	11	0	0
20	53377661	.	A	G	2	0	2	0	11	13	0	0
20	53377691	.	G	A	3	6	9	0	0	9	0	0
20	53378919	.	T	G	7	0	7	0	6	13	0	0
20	53393594	.	T	C	8	15	23	0	0	23	0	0
20	53393669	.	C	A	7	13	20	0	1	21	0	0
20	53398784	.	T	A	4	17	21	0	1	22	0	0
20	53401771	.	T	C	7	11	18	0	0	18	0	0
20	53401778	.	A	G	7	12	19	0	0	19	0	0
20	53408371	.	A	T	1	2	3	0	0	3	0	0
20	53408394	.	A	C	1	3	4	0	0	4	0	0
20	53422244	.	G	T	1	2	3	0	0	3	0	0
20	53423863	.	C	T	1	3	4	0	0	4	0	0
20	53508520	.	T	G	1	0	1	0	2	3	0	0
20	53509284	.	C	T	3	2	5	0	1	6	0	0
20	53600883	.	G	A	1	3	4	0	0	4	0	0
20	53601067	.	C	T	2	2	4	0	0	4	0	0
20	53601313	.	C	T	3	1	4	0	0	4	0	0
20	53601323	.	T	C	4	2	6	0	0	6	0	0
20	53601437	.	C	T	1	2	3	0	4	7	0	0
20	53601461	.	T	C	4	0	4	0	4	8	0	0
20	53601590	.	G	A	1	4	5	0	0	5	0	0
20	53601677	.	T	C	2	0	2	0	3	5	0	0
20	53637686	.	G	A	7	6	13	0	0	13	0	0
20	53637818	.	C	T	1	3	4	0	0	4	0	0
20	53639152	.	C	T	2	4	6	0	1	7	0	0
20	53639358	.	C	T	1	5	6	0	0	6	0	0
20	53639391	.	C	G	2	6	8	1	0	9	0	0
20	53639462	.	T	C	1	3	4	0	1	5	0	0
20	53639964	.	A	G	1	7	8	1	1	10	0	0
20	53639980	.	C	T	2	3	5	4	4	13	0	0
20	53641251	.	T	A	3	11	14	0	0	14	0	0
20	53803637	.	C	T	18	13	31	0	0	31	0	0
20	53803783	.	T	A	18	13	31	0	0	31	0	0
20	53804306	.	A	G	12	9	21	0	2	23	0	0
20	53804342	.	A	G	14	9	23	0	0	23	0	0
20	53804439	.	A	G	12	9	21	0	1	22	0	0
20	53804470	.	G	A	14	5	19	0	0	19	0	0
20	53804618	.	G	C	12	7	19	0	1	20	0	0
20	53810197	.	A	T	16	9	25	0	1	26	0	0
20	53810419	.	A	G	5	2	7	1	1	9	0	0
20	53898735	.	T	A	14	16	30	0	3	34	1	0
20	53898770	.	C	T	1	22	23	0	20	43	0	0
20	53898930	.	G	A	3	12	15	0	1	16	0	0
20	53899023	.	G	C	14	24	38	0	2	40	0	0
20	53899035	.	G	A	16	29	45	0	0	45	0	0
20	53900860	.	C	T	5	6	11	0	0	11	0	0
20	53901183	.	A	G	9	5	14	2	0	16	0	0
20	53902151	.	G	A	4	7	11	0	0	11	0	0
20	53902155	.	G	C	4	7	11	0	0	11	0	0
20	53902324	.	T	C	6	4	10	1	1	12	0	0
20	53912151	.	T	C	6	0	6	0	9	15	0	0
20	53912208	.	C	T	2	10	12	0	8	20	0	0
20	53921147	.	T	C	7	9	16	0	0	16	0	0
20	53928363	.	T	C	3	0	3	0	7	10	0	0
20	53930457	.	G	A	10	7	17	0	0	17	0	0
20	53930466	.	C	T	3	6	9	0	8	17	0	0
20	53949741	.	A	G	5	8	13	0	1	14	0	0
20	53958187	.	C	T	2	7	9	0	0	9	0	0
20	53968105	.	A	G	27	31	58	0	1	59	0	0
20	54048078	.	T	C	1	2	3	0	0	3	0	0
20	54048177	.	C	T	2	2	4	0	1	5	0	0
20	54050873	.	A	G	2	3	5	0	0	5	0	0
20	54050877	.	T	A	2	4	6	0	0	6	0	0
20	54051096	.	T	G	2	0	2	0	3	5	0	0
20	54067639	.	G	A	13	5	18	0	0	18	0	0
20	54067714	.	A	G	15	9	24	0	0	24	0	0
20	54067908	.	G	A	8	5	13	0	1	14	0	0
20	54075070	.	A	C	2	3	5	0	0	5	0	0
20	54075112	.	G	A	2	4	6	0	0	6	0	0
20	54175056	.	G	T	5	4	9	0	1	10	0	0
20	54175323	.	A	G	5	3	8	0	0	8	0	0
20	54175383	.	A	C	3	0	3	0	5	8	0	0
20	54175443	.	C	T	6	4	10	0	0	10	0	0
20	54183612	.	T	C	2	0	2	0	4	6	0	0
20	54197221	.	A	C	15	0	15	0	23	38	0	0
20	54197287	.	A	T	21	17	38	0	1	39	0	0
20	54197383	.	G	A	13	17	30	0	0	30	0	0
20	54197473	.	A	G	13	14	27	0	1	28	0	0
20	54197485	.	C	T	0	14	14	0	12	26	0	0
20	54197751	.	A	G	10	12	22	0	1	23	0	0
20	54197752	.	G	A	10	12	22	0	1	23	0	0
20	54205704	.	C	T	34	32	66	0	3	69	0	0
20	54215073	.	C	A	9	4	13	0	1	14	0	0
20	54215081	.	T	C	10	0	10	0	4	14	0	0
20	54215133	.	A	C	11	8	19	0	0	19	0	0
20	54219286	.	T	C	22	0	22	0	34	56	0	0
20	54228003	.	A	T	25	27	52	0	0	52	0	0
20	54233207	.	T	C	16	1	17	0	18	35	0	0
20	54235969	.	G	A	15	12	27	0	0	27	0	0
20	54236421	.	A	C	17	6	23	0	0	23	0	0
20	54236423	.	G	A	17	6	23	0	0	23	0	0
20	54249577	.	G	C	21	19	40	0	1	41	0	0
20	54251406	.	T	C	23	28	51	0	0	51	0	0
20	54251723	.	T	C	1	3	4	0	0	4	0	0
20	54274561	.	G	A	15	6	21	0	1	23	1	0
20	54277241	.	A	C	14	9	23	0	0	23	0	0
20	54278129	.	T	A	11	13	24	0	0	24	0	0
20	54283833	.	T	C	13	20	33	0	0	33	0	0
20	54284869	.	A	G	22	1	23	0	25	48	0	0
20	54284986	.	A	G	19	28	47	0	0	47	0	0
20	54285758	.	T	C	19	24	43	0	3	46	0	0
20	54285799	.	C	T	15	32	47	0	0	47	0	0
20	54285804	.	C	T	12	33	45	0	1	46	0	0
20	54285853	.	A	T	19	23	42	3	0	45	0	0
20	54286016	.	G	A	22	17	39	0	2	41	0	0
20	54286097	.	A	T	25	9	34	0	0	34	0	0
20	54286154	.	A	G	12	8	20	0	2	22	0	0
20	54286454	.	C	A	16	8	24	0	0	24	0	0
20	54286616	.	A	G	28	5	33	0	7	40	0	0
20	54286666	.	C	T	21	18	39	0	1	40	0	0
20	54286797	.	G	T	6	6	12	0	0	12	0	0
20	54286798	.	A	G	5	6	11	0	1	12	0	0
20	54334478	.	C	T	11	14	25	0	0	25	0	0
20	54339998	.	C	T	7	8	15	0	0	15	0	0
20	54340018	.	G	C	7	9	16	0	0	16	0	0
20	54340285	.	C	T	14	12	26	0	0	26	0	0
20	54340524	.	T	A	1	3	4	0	0	4	0	0
20	54340700	.	T	C	6	5	11	0	0	11	0	0
20	54340865	.	C	T	4	2	6	0	0	6	0	0
20	54341019	.	A	G	5	4	9	0	0	9	0	0
20	54341082	.	A	C	7	10	17	0	1	18	0	0
20	54341108	.	G	T	1	10	11	0	8	19	0	0
20	54341130	.	C	T	5	11	16	0	0	16	0	0
20	54341154	.	A	G	4	6	10	0	0	10	0	0
20	54341203	.	T	A	8	5	13	0	0	13	0	0
20	54341795	.	T	C	4	2	6	0	2	8	0	0
20	54341822	.	C	T	5	2	7	0	0	7	0	0
20	54342051	.	T	G	5	6	11	1	1	13	0	0
20	54342530	.	G	T	4	3	7	1	0	8	0	0
20	54342589	.	A	T	4	7	11	0	0	11	0	0
20	54342674	.	T	C	5	8	13	0	0	13	0	0
20	54343496	.	G	A	7	9	16	0	0	16	0	0
20	54343566	.	G	C	2	6	8	0	13	21	0	0
20	54343639	.	C	A	6	4	10	0	0	10	0	0
20	54343682	.	T	C	3	7	10	0	0	10	0	0
20	54343695	.	A	T	7	8	15	0	0	15	0	0
20	54343866	.	G	A	10	12	22	0	0	22	0	0
20	54343928	.	A	G	10	5	15	0	0	15	0	0
20	54344711	.	A	G	11	0	11	0	7	18	0	0
20	54344748	.	T	C	10	8	18	0	0	18	0	0
20	54344795	.	G	A	5	14	19	0	1	20	0	0
20	54344815	.	G	T	5	10	15	0	0	15	0	0
20	54344910	.	C	T	3	4	7	0	0	7	0	0
20	54345808	.	T	C	7	6	13	0	0	13	0	0
20	54345955	.	A	T	16	9	25	0	1	26	0	0
20	54345979	.	A	G	16	10	26	0	1	27	0	0
20	54346012	.	G	C	1	6	7	0	21	31	3	0
20	54346124	.	A	T	11	6	17	0	0	17	0	0
20	54346159	.	G	T	1	10	11	0	19	30	0	0
20	54346178	.	G	T	19	11	30	0	0	30	0	0
20	54346239	.	A	G	12	6	18	0	0	18	0	0
20	54354874	.	A	T	2	3	5	0	0	5	0	0
20	54355471	.	C	T	1	3	4	0	0	4	0	0
20	54356452	.	G	C	14	18	32	0	2	34	0	0
20	54357955	.	C	T	12	10	22	0	0	22	0	0
20	54358656	.	T	C	6	6	12	0	0	12	0	0
20	54360143	.	G	A	1	3	4	0	0	4	0	0
20	54360148	.	G	T	0	2	2	0	2	4	0	0
20	54360939	.	G	A	0	3	3	0	0	3	0	0
20	54360940	.	A	G	1	3	4	0	0	4	0	0
20	54368836	.	A	G	2	2	4	0	0	4	0	0
20	54369043	.	A	G	1	3	4	0	0	4	0	0
20	54397812	.	T	C	10	8	18	0	0	18	0	0
20	54397846	.	A	G	10	0	10	0	9	19	0	0
20	54397897	.	G	C	14	14	28	0	0	28	0	0
20	54398242	.	C	T	9	9	18	0	2	20	0	0
20	54398380	.	T	A	16	6	22	0	0	22	0	0
20	54402157	.	G	T	2	14	16	0	16	32	0	0
20	54402346	.	G	A	9	10	19	0	1	20	0	0
20	54402489	.	G	A	14	13	27	0	1	28	0	0
20	54406699	.	A	T	21	12	33	0	1	34	0	0
20	54406813	.	A	G	11	15	26	0	0	26	0	0
20	54407401	.	G	C	15	23	38	0	2	40	0	0
20	54407456	.	T	C	15	15	30	0	1	31	0	0
20	54407556	.	C	T	8	3	11	0	1	12	0	0
20	54422636	.	G	A	23	14	37	1	0	38	0	0
20	54422830	.	T	C	20	0	20	0	7	27	0	0
20	54422909	.	C	T	14	15	29	0	0	29	0	0
20	54422929	.	G	A	11	14	25	0	0	25	0	0
20	54423005	.	T	C	10	10	20	0	1	21	0	0
20	54423027	.	C	G	7	15	22	0	1	23	0	0
20	54428696	.	A	G	15	19	34	0	0	34	0	0
20	54432835	.	T	C	13	0	13	0	23	36	0	0
20	54432855	.	T	C	18	0	18	0	21	39	0	0
20	54434895	.	G	A	25	14	39	1	5	45	0	0
20	54434918	.	C	T	20	19	39	1	1	41	0	0
20	54441757	.	A	C	32	19	51	0	4	55	0	0
20	54446877	.	G	A	21	28	49	0	4	53	0	0
20	54462151	.	G	C	23	15	38	0	2	40	0	0
20	54520149	.	T	C	2	2	4	0	1	5	0	0
20	54522615	.	G	C	5	5	10	0	0	10	0	0
20	54525439	.	T	C	6	3	9	0	0	9	0	0
20	54563425	.	A	G	15	8	23	0	1	24	0	0
20	54563866	.	C	A	4	6	10	0	1	11	0	0
20	54563995	.	G	A	4	7	11	0	0	11	0	0
20	54563998	.	G	C	4	6	10	0	1	11	0	0
20	54666245	.	G	C	2	3	5	0	0	5	0	0
20	54670746	.	T	C	6	4	10	0	0	10	0	0
20	54670770	.	T	G	4	3	7	0	0	7	0	0
20	54670836	.	C	G	4	3	7	0	0	7	0	0
20	54670904	.	C	G	7	0	7	0	6	13	0	0
20	54670966	.	A	G	4	7	11	0	0	11	0	0
20	54671032	.	A	C	2	6	8	0	0	8	0	0
20	54671894	.	A	C	2	1	3	0	2	5	0	0
20	54671989	.	G	A	2	4	6	0	6	12	0	0
20	54672009	.	A	C	6	4	10	0	0	10	0	0
20	54672839	.	A	G	7	0	7	0	11	18	0	0
20	54672869	.	T	C	7	11	18	0	0	18	0	0
20	54672891	.	T	C	6	11	17	0	0	17	0	0
20	54673175	.	T	C	1	8	9	0	0	9	0	0
20	54673198	.	T	A	2	6	8	0	1	9	0	0
20	54675294	.	T	C	6	9	15	1	0	16	0	0
20	54675308	.	C	G	7	0	7	0	10	17	0	0
20	54675356	.	C	T	9	10	19	0	1	20	0	0
20	54675391	.	T	C	6	8	14	0	0	14	0	0
20	54676529	.	A	G	7	0	7	0	14	21	0	0
20	54676532	.	T	G	9	13	22	0	0	22	0	0
20	54676583	.	C	T	5	12	17	0	0	17	0	0
20	54681734	.	G	A	5	6	11	0	1	12	0	0
20	54681797	.	T	A	12	4	16	0	0	16	0	0
20	54681944	.	A	T	10	3	13	0	0	13	0	0
20	54698791	.	C	T	6	6	12	0	3	15	0	0
20	54699133	.	C	T	9	5	14	0	2	16	0	0
20	54708193	.	T	C	10	12	22	0	0	22	0	0
20	54708277	.	G	A	2	7	9	0	9	18	0	0
20	54711535	.	G	C	4	7	11	0	1	12	0	0
20	54738249	.	C	G	8	3	11	0	0	11	0	0
20	54740904	.	G	A	17	12	29	0	1	30	0	0
20	54740907	.	A	G	15	2	17	0	13	30	0	0
20	54740955	.	C	T	15	11	26	0	1	27	0	0
20	54740976	.	G	T	4	14	18	0	14	32	0	0
20	54742641	.	C	G	12	11	23	0	0	23	0	0
20	54742714	.	C	T	8	10	18	0	0	18	0	0
20	54742750	.	A	G	7	0	7	0	12	19	0	0
20	54742765	.	A	C	8	7	15	0	3	18	0	0
20	54742912	.	A	C	4	7	11	0	0	11	0	0
20	54743917	.	G	A	19	8	27	0	0	27	0	0
20	54744230	.	C	T	14	18	32	0	0	32	0	0
20	54744314	.	A	G	18	0	18	0	16	34	0	0
20	54744363	.	A	G	18	1	19	0	11	30	0	0
20	54744419	.	A	G	17	10	27	0	1	28	0	0
21	238575	.	T	C	14	11	25	0	0	25	0	0
21	734962	.	A	G	9	0	9	0	21	30	0	0
21	735222	.	A	G	47	0	47	4	21	72	0	0
21	1780794	.	C	T	3	7	10	0	1	11	0	0
21	1780912	.	A	C	5	8	13	0	0	13	0	0
21	1780964	.	T	C	2	0	2	0	4	6	0	0
21	1781007	.	A	G	1	2	3	0	0	3	0	0
21	1781050	.	T	G	2	3	5	0	0	5	0	0
21	1781051	.	G	T	2	3	5	0	0	5	0	0
21	1788234	.	A	G	3	3	6	0	0	6	0	0
21	1788255	.	T	C	5	3	8	0	0	8	0	0
21	1788474	.	G	A	6	4	10	0	1	11	0	0
21	1788621	.	G	A	2	4	6	0	0	6	0	0
21	1788624	.	G	A	2	2	4	0	2	6	0	0
21	1798961	.	C	T	3	4	7	0	0	7	0	0
21	1907038	.	C	A	10	13	23	0	1	24	0	0
21	1907080	.	C	T	1	9	10	0	12	22	0	0
21	1930112	.	A	T	5	5	10	0	0	10	0	0
21	1934091	.	T	C	13	12	25	0	0	25	0	0
21	1934156	.	A	G	13	16	29	0	1	30	0	0
21	1944766	.	A	G	6	6	12	0	0	12	0	0
21	1948578	.	T	C	9	0	9	1	18	28	0	0
21	1963391	.	G	A	8	7	15	0	2	17	0	0
21	1963433	.	A	G	10	5	15	1	1	17	0	0
21	1968842	.	T	C	6	10	16	0	2	18	0	0
21	1991007	.	G	T	16	22	38	0	1	39	0	0
21	1991097	.	A	G	20	23	43	0	3	46	0	0
21	1991118	.	G	A	22	21	43	0	7	50	0	0
21	1991160	.	G	A	30	24	54	3	1	58	0	0
21	1996944	.	T	C	22	20	42	0	5	47	0	0
21	2014639	.	G	A	21	15	36	0	0	36	0	0
21	2025607	.	C	T	12	18	30	0	0	30	0	0
21	2030212	.	C	T	12	4	16	0	0	16	0	0
21	2031843	.	A	G	9	5	14	0	1	15	0	0
21	2031849	.	A	G	10	7	17	0	0	17	0	0
21	2031894	.	A	G	13	17	30	0	1	31	0	0
21	2033854	.	G	A	7	20	27	0	1	28	0	0
21	2033964	.	T	G	7	8	15	0	1	16	0	0
21	2035056	.	C	A	0	15	15	0	15	30	0	0
21	2035059	.	C	G	10	17	27	0	2	29	0	0
21	2035146	.	T	A	7	3	10	0	2	12	0	0
21	2036975	.	G	A	8	8	16	0	0	16	0	0
21	2042005	.	C	T	1	8	9	0	13	22	0	0
21	2111615	.	A	G	1	0	1	0	3	4	0	0
21	2112595	.	A	T	1	3	4	0	0	4	0	0
21	2119973	.	G	T	2	3	5	0	0	5	0	0
21	2120038	.	T	C	4	8	12	0	0	12	0	0
21	2120061	.	C	G	0	4	4	0	6	10	0	0
21	2120073	.	G	A	4	4	8	0	0	8	0	0
21	2120193	.	A	G	2	3	5	0	0	5	0	0
21	2120217	.	T	A	1	5	6	0	0	6	0	0
21	2120237	.	C	A	2	5	7	0	0	7	0	0
21	2120361	.	G	A	2	2	4	0	0	4	0	0
21	2124147	.	A	C	2	0	2	0	2	4	0	0
21	2124201	.	G	A	2	4	6	0	0	6	0	0
21	2124206	.	T	G	2	5	7	0	0	7	0	0
21	2129890	.	A	G	2	1	3	0	1	4	0	0
21	2171521	.	T	C	1	3	4	0	0	4	0	0
21	2203455	.	C	T	1	5	6	0	1	7	0	0
21	2738221	.	C	T	20	17	37	0	0	37	0	0
21	3004333	.	A	C	1	1	2	0	1	3	0	0
21	3301916	.	C	T	3	3	6	0	1	7	0	0
21	3301931	.	C	A	3	4	7	0	2	9	0	0
21	3302296	.	A	G	4	0	4	0	4	8	0	0
21	3422565	.	T	G	9	9	18	0	0	18	0	0
21	3452462	.	A	G	9	11	20	0	0	20	0	0
21	3478014	.	A	G	7	2	9	0	0	9	0	0
21	3485351	.	T	C	9	0	9	0	4	13	0	0
21	3536050	.	A	G	7	3	10	0	0	10	0	0
21	3536056	.	T	A	6	3	9	0	1	10	0	0
21	3536597	.	C	T	1	4	5	0	5	10	0	0
21	3539275	.	C	T	6	7	13	0	1	14	0	0
21	3567722	.	A	G	6	3	9	0	1	10	0	0
21	3600561	.	T	G	4	2	6	1	0	7	0	0
21	3606571	.	C	T	2	4	6	0	2	8	0	0
21	3613482	.	A	C	4	4	8	0	0	8	0	0
21	3613551	.	G	A	2	5	7	0	0	7	0	0
21	3715950	.	A	G	9	11	20	0	0	20	0	0
21	3715986	.	T	A	15	10	25	0	1	26	0	0
21	3715989	.	A	G	15	11	26	0	0	26	0	0
21	3716058	.	T	A	19	9	28	0	1	30	1	0
21	3716512	.	T	G	1	2	3	0	0	3	0	0
21	3716517	.	C	A	1	2	3	0	0	3	0	0
21	3716732	.	G	T	15	16	31	0	1	32	0	0
21	3716845	.	G	A	7	4	11	0	6	17	0	0
21	3716846	.	A	T	5	3	8	0	9	17	0	0
21	3716930	.	G	A	22	14	36	0	3	39	0	0
21	3717055	.	G	A	30	15	45	0	1	46	0	0
21	3717505	.	T	C	16	0	16	0	14	30	0	0
21	3719779	.	G	A	5	9	14	0	0	14	0	0
21	3725881	.	A	C	6	0	6	0	8	14	0	0
21	3738181	.	C	T	2	9	11	0	12	23	0	0
21	3775605	.	G	T	3	3	6	0	0	6	0	0
21	3785401	.	C	T	3	4	7	0	0	7	0	0
21	3786377	.	C	T	10	3	13	0	0	13	0	0
21	3787070	.	G	C	1	3	4	0	1	5	0	0
21	3787071	.	A	C	2	3	5	0	0	5	0	0
21	3789922	.	T	A	11	9	20	0	1	21	0	0
21	3789930	.	C	T	13	14	27	0	0	27	0	0
21	3789998	.	A	G	16	20	36	0	4	40	0	0
21	3793211	.	G	A	18	19	37	0	2	39	0	0
21	3793309	.	T	C	19	24	43	0	0	43	0	0
21	3793413	.	C	T	23	22	45	0	2	47	0	0
21	3796376	.	G	T	14	22	36	0	0	36	0	0
21	3796398	.	G	T	9	13	22	0	1	23	0	0
21	3796732	.	A	T	6	3	9	0	0	9	0	0
21	3803384	.	C	T	1	2	3	0	0	3	0	0
21	3822666	.	T	C	5	0	5	0	4	9	0	0
21	3822827	.	T	G	8	8	16	0	0	16	0	0
21	3822841	.	A	T	8	8	16	0	1	17	0	0
21	3822896	.	T	C	6	0	6	0	8	14	0	0
21	3825019	.	T	A	7	7	14	0	1	16	1	0
21	3852524	.	A	G	3	2	5	0	0	5	0	0
21	3866706	.	A	G	2	0	2	0	3	5	0	0
21	3868983	.	T	C	3	3	6	0	1	7	0	0
21	3880834	.	C	A	6	3	9	0	0	9	0	0
21	3880885	.	G	A	0	3	3	0	5	8	0	0
21	3881003	.	G	A	4	3	7	0	0	7	0	0
21	3912699	.	C	G	5	4	9	0	0	9	0	0
21	3917912	.	C	A	8	6	14	0	1	15	0	0
21	3918186	.	G	A	5	9	14	0	0	14	0	0
21	3954932	.	A	T	2	4	6	0	0	6	0	0
21	3955290	.	T	A	2	7	9	0	0	9	0	0
21	3955319	.	C	A	2	5	7	0	1	8	0	0
21	3955445	.	G	A	2	3	5	0	0	5	0	0
21	3956467	.	T	C	1	2	3	0	0	3	0	0
21	3962692	.	T	C	1	3	4	0	0	4	0	0
21	3995529	.	A	G	6	6	12	0	0	12	0	0
21	4025201	.	T	A	4	8	12	0	1	13	0	0
21	4166110	.	C	G	3	2	5	0	0	5	0	0
21	4180976	.	G	A	0	4	4	0	4	8	0	0
21	4180985	.	C	T	5	4	9	0	0	9	0	0
21	4185028	.	C	A	2	10	12	0	0	12	0	0
21	4188200	.	G	A	6	5	11	0	0	11	0	0
21	4209062	.	G	T	4	1	5	0	0	5	0	0
21	4209078	.	T	C	4	2	6	0	0	6	0	0
21	4209156	.	T	C	1	5	6	0	1	7	0	0
21	4210998	.	A	G	3	0	3	0	3	6	0	0
21	4219450	.	C	T	3	5	8	0	0	8	0	0
21	4227387	.	C	G	8	6	14	0	2	16	0	0
21	4227392	.	T	A	8	9	17	0	0	17	0	0
21	4227433	.	T	G	4	8	12	0	0	12	0	0
21	4227788	.	G	A	11	11	22	0	1	23	0	0
21	4228026	.	G	A	18	13	31	0	1	32	0	0
21	4232774	.	A	G	6	6	12	0	0	12	0	0
21	4237466	.	T	A	3	9	12	0	1	13	0	0
21	4240010	.	A	G	3	10	13	0	0	13	0	0
21	4240016	.	A	G	4	9	13	0	1	14	0	0
21	4240121	.	T	C	6	3	9	0	0	9	0	0
21	4244348	.	T	A	12	11	23	0	0	23	0	0
21	4244377	.	C	G	16	6	22	0	2	24	0	0
21	4250360	.	T	C	3	4	7	0	0	7	0	0
21	4250463	.	G	C	7	2	9	0	0	9	0	0
21	4250465	.	T	G	7	2	9	0	0	9	0	0
21	4250583	.	C	A	3	6	9	0	0	9	0	0
21	4250596	.	C	T	0	4	4	0	5	9	0	0
21	4250634	.	G	A	3	3	6	0	0	6	0	0
21	4250642	.	T	A	3	2	5	0	0	5	0	0
21	4284321	.	G	A	1	2	3	0	0	3	0	0
21	4293557	.	C	A	4	2	6	0	0	6	0	0
21	4293620	.	C	T	3	3	6	0	0	6	0	0
21	4300254	.	T	C	4	7	11	0	0	11	0	0
21	4300257	.	T	C	4	7	11	0	0	11	0	0
21	4300290	.	G	A	6	3	9	0	0	9	0	0
21	4300308	.	G	A	6	2	8	0	0	8	0	0
21	4304262	.	A	G	1	3	4	0	0	4	0	0
21	4304471	.	T	C	5	3	8	0	0	8	0	0
21	4304489	.	A	T	2	4	6	0	0	6	0	0
21	4304725	.	G	A	0	2	2	0	3	5	0	0
21	4304744	.	T	C	1	3	4	0	0	4	0	0
21	4304822	.	G	A	5	7	12	0	2	14	0	0
21	4304848	.	C	T	4	4	8	0	1	9	0	0
21	4304875	.	T	A	3	3	6	0	0	6	0	0
21	4518181	.	A	T	1	3	4	0	0	4	0	0
21	4518209	.	A	G	1	0	1	0	4	5	0	0
21	4534374	.	A	G	1	4	5	0	0	5	0	0
21	4535232	.	A	G	3	2	5	0	0	5	0	0
21	4556490	.	C	T	2	5	7	0	1	8	0	0
21	4559567	.	C	T	1	3	4	0	0	4	0	0
21	4562238	.	G	C	4	4	8	0	1	9	0	0
21	4568499	.	T	C	2	3	5	0	0	5	0	0
21	4568502	.	C	T	2	4	6	0	0	6	0	0
21	4571398	.	T	C	3	8	11	0	3	14	0	0
21	4573597	.	A	G	3	5	8	0	0	8	0	0
21	4575674	.	T	C	4	5	9	0	0	9	0	0
21	4575688	.	C	T	4	4	8	0	0	8	0	0
21	4576310	.	G	C	5	3	8	0	1	9	0	0
21	4576319	.	G	C	0	3	3	0	5	8	0	0
21	4578122	.	G	A	2	3	5	0	0	5	0	0
21	4578137	.	G	A	0	2	2	0	3	5	0	0
21	4578352	.	G	T	0	6	6	0	3	9	0	0
21	4578428	.	C	A	3	5	8	0	0	8	0	0
21	4578520	.	T	C	4	4	8	0	0	8	0	0
21	4578892	.	T	C	2	2	4	0	0	4	0	0
21	4582249	.	T	C	2	2	4	0	0	4	0	0
21	4582270	.	T	A	2	5	7	0	0	7	0	0
21	4583663	.	A	G	5	0	5	0	9	14	0	0
21	4585012	.	A	C	4	7	11	0	0	11	0	0
21	4585027	.	A	G	1	0	1	0	5	6	0	0
21	4585189	.	C	A	4	4	8	0	0	8	0	0
21	4589787	.	G	A	1	2	3	0	6	9	0	0
21	4589826	.	A	G	2	9	11	0	1	12	0	0
21	4591407	.	C	G	6	6	12	0	0	12	0	0
21	4591410	.	A	T	6	6	12	0	0	12	0	0
21	4591443	.	A	G	6	4	10	0	0	10	0	0
21	4591502	.	A	G	4	0	4	0	5	9	0	0
21	4592959	.	T	C	4	7	11	0	0	11	0	0
21	4592984	.	A	G	1	5	6	0	1	7	0	0
21	4593008	.	A	T	1	7	8	0	1	9	0	0
21	4596883	.	G	T	11	11	22	0	0	23	1	0
21	4596970	.	A	G	5	7	12	0	1	13	0	0
21	4600889	.	A	G	6	0	6	0	10	16	0	0
21	4603372	.	C	T	4	23	27	0	0	27	0	0
21	4647939	.	C	T	3	3	6	0	1	7	0	0
21	4653403	.	C	T	4	3	7	0	1	8	0	0
21	4653578	.	A	G	3	3	6	0	0	6	0	0
21	4653590	.	T	C	3	3	6	0	0	6	0	0
21	4659003	.	T	C	4	3	7	0	0	7	0	0
21	4661022	.	G	C	6	2	8	0	0	8	0	0
21	4667092	.	C	T	2	3	5	0	0	5	0	0
21	4668144	.	T	C	5	2	7	0	0	7	0	0
21	4670307	.	T	C	1	0	1	0	2	3	0	0
21	4670308	.	T	G	1	2	3	0	0	3	0	0
21	4679623	.	T	C	6	5	11	0	0	11	0	0
21	4679703	.	C	G	4	3	7	0	0	7	0	0
21	4712215	.	A	G	3	4	7	0	0	7	0	0
21	4712743	.	A	G	5	6	11	0	0	11	0	0
21	4712756	.	T	C	5	0	5	0	7	12	0	0
21	4713252	.	T	C	13	1	14	0	9	23	0	0
21	4718518	.	G	A	8	18	26	0	2	28	0	0
21	4720325	.	C	T	7	7	14	0	2	16	0	0
21	4723670	.	G	A	19	10	29	0	0	29	0	0
21	4724351	.	C	T	3	5	8	0	5	13	0	0
21	4724428	.	A	G	4	6	10	0	0	10	0	0
21	4724564	.	G	A	8	12	20	0	0	20	0	0
21	4724810	.	T	C	5	7	12	0	0	12	0	0
21	4729876	.	G	A	11	12	23	0	0	23	0	0
21	4740850	.	A	G	8	5	13	0	0	13	0	0
21	4742721	.	A	G	3	3	6	0	1	7	0	0
21	4742793	.	G	A	5	5	10	0	2	12	0	0
21	4748802	.	G	C	4	6	10	0	0	10	0	0
21	4748841	.	A	G	4	7	11	0	0	11	0	0
21	5003101	.	T	C	5	2	7	0	0	7	0	0
21	5034442	.	T	C	2	0	2	0	5	7	0	0
21	5034791	.	G	A	1	4	5	0	0	5	0	0
21	5034793	.	A	C	0	4	4	0	1	5	0	0
21	5042647	.	G	A	1	3	4	0	0	4	0	0
21	5056600	.	T	C	3	0	3	0	2	5	0	0
21	5066371	.	A	G	7	9	16	0	0	16	0	0
21	5066417	.	T	C	5	0	5	0	10	15	0	0
21	5066425	.	T	C	8	0	8	0	6	14	0	0
21	5159695	.	T	C	4	3	7	0	0	7	0	0
21	5160219	.	T	C	2	3	5	0	1	6	0	0
21	5160428	.	G	A	2	6	8	0	1	9	0	0
21	5162305	.	T	A	3	3	6	0	0	6	0	0
21	5169217	.	T	A	20	17	37	0	2	39	0	0
21	5171036	.	C	T	31	27	58	0	2	60	0	0
21	5173402	.	T	G	40	0	40	0	34	74	0	0
21	5173447	.	C	T	37	27	64	0	1	65	0	0
21	5173638	.	T	C	27	30	57	1	0	58	0	0
21	5199875	.	G	A	37	34	71	0	2	73	0	0
21	5200683	.	C	T	39	25	64	0	4	68	0	0
21	5209585	.	A	G	18	2	20	0	7	27	0	0
21	5209666	.	C	T	12	18	30	0	1	31	0	0
21	5237137	.	G	A	9	10	19	0	0	19	0	0
21	5240259	.	C	T	14	23	37	0	1	38	0	0
21	5368346	.	G	A	5	8	13	0	0	13	0	0
21	5368417	.	C	T	3	6	9	0	5	14	0	0
21	5368461	.	C	T	1	12	13	0	6	19	0	0
21	5368510	.	C	T	0	12	12	0	7	19	0	0
21	5370451	.	T	A	5	6	11	0	0	11	0	0
21	5372598	.	G	A	5	5	10	1	1	12	0	0
21	5372643	.	T	C	6	6	12	0	0	12	0	0
21	5372673	.	G	A	8	11	19	0	0	19	0	0
21	5374209	.	C	T	1	7	8	0	4	12	0	0
21	5374528	.	T	C	13	9	22	0	0	22	0	0
21	5374788	.	G	A	4	3	7	0	0	7	0	0
21	5376720	.	A	C	6	3	9	0	0	9	0	0
21	5392941	.	T	A	7	3	10	0	0	10	0	0
21	5601622	.	C	T	1	2	3	0	0	3	0	0
21	5601792	.	C	G	4	4	8	0	0	8	0	0
21	5601835	.	C	T	4	3	7	0	0	7	0	0
21	5602006	.	A	G	1	0	1	0	4	5	0	0
21	5602507	.	C	A	5	4	9	0	0	9	0	0
21	5602619	.	G	A	0	2	2	0	8	10	0	0
21	5602646	.	C	T	6	2	8	0	0	8	0	0
21	5602843	.	T	A	5	5	10	0	0	10	0	0
21	5765431	.	T	C	1	2	3	0	0	3	0	0
21	5781134	.	C	T	29	34	63	0	2	65	0	0
21	5782043	.	T	C	27	4	31	0	42	73	0	0
21	5789938	.	G	A	44	35	79	0	1	80	0	0
21	5796060	.	T	C	31	33	64	1	2	67	0	0
21	5797960	.	T	C	49	12	61	0	4	65	0	0
21	5798978	.	T	A	28	32	60	0	1	61	0	0
21	5802878	.	A	G	8	4	12	1	0	13	0	0
21	5803474	.	C	T	11	11	22	0	0	22	0	0
21	5803495	.	T	C	16	6	22	0	0	22	0	0
21	5807177	.	A	C	9	6	15	0	1	16	0	0
21	5813676	.	C	T	3	4	7	0	1	8	0	0
21	5816912	.	T	C	7	0	7	0	3	10	0	0
21	5825405	.	C	T	6	2	8	0	0	8	0	0
21	5825408	.	T	C	5	0	5	0	2	7	0	0
21	5831364	.	G	T	4	5	9	0	0	9	0	0
21	5846996	.	T	A	1	3	4	0	0	4	0	0
21	5847147	.	C	G	4	2	6	0	0	6	0	0
21	5884836	.	G	A	4	25	29	0	26	55	0	0
21	5884897	.	T	A	25	30	55	0	0	55	0	0
21	5884945	.	G	A	25	17	42	0	0	43	1	0
21	5891343	.	G	A	4	3	7	0	0	7	0	0
21	5891394	.	C	T	6	4	10	0	1	11	0	0
21	5905143	.	T	C	5	7	12	0	0	12	0	0
21	5905330	.	A	G	6	0	6	0	4	10	0	0
21	5909979	.	C	T	5	4	9	0	0	9	0	0
21	5915055	.	C	T	5	7	12	0	0	12	0	0
21	5915707	.	G	A	1	6	7	0	7	14	0	0
21	5915813	.	T	G	4	4	8	0	0	8	0	0
21	5916374	.	A	T	6	6	12	0	0	12	0	0
21	5920348	.	G	C	5	14	19	0	0	19	0	0
21	5920426	.	C	T	14	8	22	0	1	23	0	0
21	5920559	.	T	C	13	8	21	8	0	29	0	0
21	5920586	.	A	C	18	3	21	7	1	29	0	0
21	5920604	.	T	C	13	3	16	9	3	28	0	0
21	5926982	.	A	G	2	2	4	0	0	4	0	0
21	5929144	.	A	G	8	0	8	0	4	12	0	0
21	5932610	.	C	T	6	6	12	0	0	12	0	0
21	5938303	.	A	T	2	2	4	1	0	5	0	0
21	5938399	.	G	T	2	2	4	0	0	4	0	0
21	5942661	.	G	T	7	3	10	0	0	10	0	0
21	5942868	.	T	G	8	6	14	0	1	15	0	0
21	5942906	.	C	A	10	7	17	0	1	18	0	0
21	5942927	.	C	T	6	10	16	0	0	16	0	0
21	5948087	.	G	A	0	5	5	0	1	6	0	0
21	5951423	.	T	C	2	0	2	0	2	4	0	0
21	5957793	.	G	A	5	3	8	0	0	8	0	0
21	5966657	.	G	A	0	6	6	0	5	11	0	0
21	5971630	.	C	A	15	0	15	0	0	15	0	0
21	5971638	.	C	A	11	5	16	0	0	16	0	0
21	5971949	.	A	T	9	6	15	0	1	16	0	0
21	5971983	.	C	T	13	5	18	0	2	20	0	0
21	5972087	.	G	T	2	8	10	0	8	18	0	0
21	5972092	.	T	C	10	8	18	0	0	18	0	0
21	5972252	.	A	G	10	6	16	0	0	16	0	0
21	5972543	.	C	T	7	5	12	0	0	12	0	0
21	6114465	.	C	A	3	3	6	0	0	6	0	0
21	6114776	.	G	T	1	4	5	0	0	5	0	0
21	6133434	.	G	A	0	2	2	0	3	5	0	0
21	6133588	.	T	C	7	3	10	0	0	10	0	0
21	6134154	.	A	G	1	0	1	1	3	5	0	0
21	6134155	.	A	G	1	3	4	1	0	5	0	0
21	6134234	.	T	C	1	2	3	1	0	4	0	0
21	6134238	.	G	T	0	2	2	0	2	4	0	0
21	6137579	.	C	T	13	9	22	0	1	23	0	0
21	6145991	.	G	A	10	11	21	0	3	24	0	0
21	6147499	.	C	T	17	6	23	0	0	23	0	0
21	6148091	.	G	A	1	12	13	0	15	28	0	0
21	6149938	.	T	C	23	22	45	0	1	46	0	0
21	6150113	.	T	A	8	6	14	0	0	14	0	0
21	6150504	.	A	G	3	1	4	0	2	6	0	0
21	6212959	.	C	T	6	2	8	0	1	9	0	0
21	6338245	.	A	G	2	0	2	0	4	6	0	0
21	6410810	.	G	C	0	2	2	0	1	3	0	0
21	7158080	.	C	T	1	7	8	0	1	9	0	0
21	8152013	.	G	C	2	0	2	0	2	4	0	0
21	8343954	.	T	C	11	22	33	0	1	34	0	0
21	8344326	.	T	C	19	21	40	0	1	41	0	0
21	8346125	.	T	C	18	22	40	1	0	41	0	0
21	8347256	.	C	T	15	23	38	0	4	42	0	0
21	8348920	.	G	A	2	22	24	0	11	35	0	0
21	8348959	.	T	C	14	10	24	0	1	25	0	0
21	8348980	.	A	G	17	10	27	0	0	27	0	0
21	8348998	.	T	C	14	13	27	1	1	29	0	0
21	8352010	.	T	A	10	11	21	0	0	21	0	0
21	8427115	.	G	A	0	7	7	0	11	18	0	0
21	8444173	.	C	T	3	2	5	0	0	5	0	0
21	8444176	.	C	T	2	2	4	0	0	4	0	0
21	8454802	.	T	C	7	3	10	0	0	10	0	0
21	8456034	.	T	C	4	2	6	0	0	6	0	0
21	9367281	.	A	G	1	3	4	0	0	4	0	0
21	9370684	.	C	T	0	4	4	0	8	12	0	0
21	9370780	.	G	A	7	4	11	0	0	11	0	0
21	9377080	.	G	A	6	2	8	0	2	10	0	0
21	9377107	.	T	C	6	0	6	0	4	10	0	0
21	9377421	.	G	A	4	3	7	0	0	7	0	0
21	9381158	.	G	A	3	4	7	0	0	7	0	0
21	9382258	.	G	A	3	4	7	0	0	7	0	0
21	9384250	.	T	A	1	3	4	0	0	4	0	0
21	9384281	.	C	G	1	4	5	0	0	5	0	0
21	9384316	.	T	C	1	2	3	0	0	3	0	0
21	9391712	.	C	T	0	7	7	0	4	11	0	0
21	9391847	.	A	C	4	0	4	0	3	7	0	0
21	9399918	.	G	C	7	5	12	0	0	12	0	0
21	9401182	.	T	A	3	5	8	0	0	8	0	0
21	9401191	.	C	T	0	7	7	0	3	10	0	0
21	9406459	.	C	T	0	3	3	0	2	5	0	0
21	9406468	.	G	T	3	3	6	0	0	6	0	0
21	9418214	.	A	G	6	3	9	0	0	9	0	0
21	9418217	.	A	G	4	2	6	0	1	7	0	0
21	9425950	.	G	A	1	2	3	0	2	5	0	0
21	9429698	.	A	C	1	0	1	0	2	3	0	0
21	9429749	.	G	A	1	2	3	0	0	3	0	0
21	9429878	.	A	G	2	2	4	0	0	4	0	0
21	9576315	.	A	C	8	4	12	0	1	13	0	0
21	9576316	.	T	G	7	1	8	0	4	12	0	0
21	9987923	.	C	G	7	5	12	0	0	12	0	0
21	9989373	.	A	G	8	4	12	0	0	12	0	0
21	9991332	.	T	C	5	8	13	0	1	14	0	0
21	9991340	.	A	C	5	9	14	0	0	14	0	0
21	9997550	.	A	G	1	0	1	0	3	4	0	0
21	10018330	.	C	G	2	2	4	0	0	4	0	0
21	10095584	.	G	A	1	2	3	0	5	8	0	0
21	10095647	.	A	T	4	4	8	0	1	9	0	0
21	10100311	.	C	T	4	4	8	0	0	8	0	0
21	10100892	.	C	T	1	3	4	0	0	4	0	0
21	10254231	.	A	T	13	7	20	0	2	22	0	0
21	10254246	.	C	T	2	11	13	0	11	24	0	0
21	10288926	.	G	A	4	10	14	0	1	15	0	0
21	10319303	.	G	A	4	5	9	0	0	9	0	0
21	10319372	.	A	G	6	9	15	0	1	16	0	0
21	10702074	.	T	A	6	5	11	0	0	11	0	0
21	10702117	.	G	T	12	9	21	0	1	22	0	0
21	10702132	.	C	G	11	0	11	0	7	18	0	0
21	10702215	.	G	A	5	5	10	0	1	11	0	0
21	10713176	.	G	A	8	6	14	0	1	15	0	0
21	10715837	.	G	A	5	7	12	0	2	14	0	0
21	10715855	.	T	C	5	8	13	0	1	14	0	0
21	10729109	.	C	T	12	4	16	0	1	17	0	0
21	10731101	.	A	G	7	9	16	0	0	16	0	0
21	10731133	.	A	G	6	11	17	0	0	17	0	0
21	10731142	.	G	C	7	7	14	0	1	15	0	0
21	10795402	.	T	G	3	0	3	0	2	5	0	0
21	10795892	.	A	T	2	2	4	0	0	4	0	0
21	10796440	.	A	T	4	5	9	0	1	10	0	0
21	10799550	.	T	A	5	4	9	0	1	10	0	0
21	10816486	.	A	G	2	2	4	0	0	4	0	0
21	10816487	.	A	G	2	2	4	0	0	4	0	0
21	10890736	.	G	T	9	11	20	1	0	21	0	0
21	10891065	.	T	G	4	4	8	0	0	8	0	0
21	10891085	.	T	C	5	2	7	0	4	11	0	0
21	10892031	.	A	G	9	12	21	0	2	23	0	0
21	10903625	.	T	C	4	6	10	0	0	10	0	0
21	10918101	.	G	A	8	6	14	0	0	14	0	0
21	10933016	.	G	A	7	4	11	0	0	11	0	0
21	10950890	.	C	T	2	6	8	0	0	8	0	0
21	10979718	.	G	A	3	3	6	0	0	6	0	0
21	11054774	.	T	C	1	7	8	0	0	8	0	0
21	11105227	.	T	A	1	2	3	0	0	3	0	0
21	11131773	.	T	C	1	2	3	0	0	3	0	0
21	11132176	.	A	G	2	2	4	0	0	4	0	0
21	11132193	.	A	G	2	2	4	0	0	4	0	0
21	11132216	.	C	T	2	3	5	0	0	5	0	0
21	11133471	.	A	T	4	2	6	0	0	6	0	0
21	11133544	.	C	T	7	2	9	0	0	9	0	0
21	11133547	.	T	C	7	2	9	0	0	9	0	0
21	11133798	.	G	A	2	2	4	0	0	4	0	0
21	11133895	.	G	C	1	3	4	0	0	4	0	0
21	11133944	.	A	G	1	2	3	0	0	3	0	0
21	11134595	.	G	A	5	2	7	0	1	8	0	0
21	11135186	.	C	T	2	2	4	0	0	4	0	0
21	11135188	.	T	G	2	2	4	0	0	4	0	0
21	11180201	.	T	C	9	4	13	0	0	13	0	0
21	11180215	.	C	T	9	4	13	0	0	13	0	0
21	11182127	.	G	T	7	4	11	0	1	12	0	0
21	11188405	.	A	G	2	2	4	0	0	4	0	0
21	11189725	.	C	T	2	3	5	0	0	5	0	0
21	11191971	.	A	T	5	3	8	0	0	8	0	0
21	11193317	.	A	G	3	5	8	0	0	8	0	0
21	11193391	.	C	T	7	4	11	0	0	11	0	0
21	11199079	.	T	G	1	2	3	0	0	3	0	0
21	11256641	.	T	G	1	3	4	0	0	4	0	0
21	11330670	.	T	A	6	5	11	0	0	11	0	0
21	11330874	.	C	G	6	5	11	0	1	12	0	0
21	11330903	.	T	G	4	5	9	0	1	10	0	0
21	11339191	.	C	T	3	5	8	0	0	8	0	0
21	11339654	.	A	T	6	4	10	0	0	10	0	0
21	11339704	.	T	C	6	6	12	0	1	13	0	0
21	11339710	.	T	C	7	1	8	0	6	14	0	0
21	11339870	.	A	T	3	2	5	0	1	6	0	0
21	11340011	.	G	A	3	2	5	0	0	5	0	0
21	11342305	.	T	C	3	3	6	0	0	6	0	0
21	11342333	.	A	G	4	6	10	0	0	10	0	0
21	11342740	.	A	G	4	5	9	0	1	10	0	0
21	11349676	.	T	C	3	2	5	0	0	5	0	0
21	11349836	.	G	T	6	3	9	0	1	10	0	0
21	11352470	.	G	A	2	3	5	0	0	5	0	0
21	11354025	.	T	C	5	3	8	0	0	8	0	0
21	11354077	.	A	G	5	6	11	0	0	11	0	0
21	11355508	.	A	G	2	2	4	0	1	5	0	0
21	11355532	.	G	A	3	2	5	0	1	6	0	0
21	11356652	.	G	A	1	1	2	0	1	3	0	0
21	11360429	.	A	T	3	3	6	0	0	6	0	0
21	11364065	.	C	T	4	2	6	0	0	6	0	0
21	11364114	.	A	G	3	2	5	0	0	5	0	0
21	11365321	.	G	T	1	2	3	0	0	3	0	0
21	11365441	.	G	A	4	2	6	0	0	6	0	0
21	11367396	.	T	C	5	4	9	0	0	9	0	0
21	11367444	.	C	T	3	4	7	0	0	7	0	0
21	11369788	.	G	T	0	2	2	0	3	5	0	0
21	11369857	.	A	C	3	5	8	0	0	8	0	0
21	11369871	.	A	G	3	8	11	0	0	11	0	0
21	11369899	.	A	T	1	7	8	0	0	8	0	0
21	11382887	.	C	T	8	6	14	0	0	14	0	0
21	11382899	.	T	C	6	5	11	0	0	11	0	0
21	11415249	.	T	A	2	3	5	1	0	6	0	0
21	11415494	.	G	A	1	8	9	0	6	15	0	0
21	11425152	.	C	T	9	11	20	0	2	22	0	0
21	11425182	.	G	A	7	9	16	0	0	16	0	0
21	11425218	.	T	C	6	8	14	0	0	14	0	0
21	11427850	.	T	C	7	7	14	0	0	14	0	0
21	11431070	.	G	T	9	9	18	0	0	18	0	0
21	11434022	.	C	A	9	13	22	0	1	23	0	0
21	11434116	.	T	C	9	9	18	0	0	18	0	0
21	11468957	.	A	C	30	17	47	0	2	49	0	0
21	11469119	.	A	G	37	21	58	0	0	58	0	0
21	11477418	.	A	G	26	2	28	0	32	60	0	0
21	11477496	.	T	C	23	23	46	0	2	48	0	0
21	11486933	.	T	C	24	32	56	1	2	59	0	0
21	11492826	.	C	T	32	32	64	0	2	66	0	0
21	11493661	.	A	G	44	15	59	0	4	63	0	0
21	11494536	.	A	G	38	2	40	0	27	67	0	0
21	11501308	.	T	C	26	27	53	0	3	56	0	0
21	11501618	.	T	A	19	20	39	0	1	40	0	0
21	11501665	.	C	T	26	25	51	0	2	53	0	0
21	11502120	.	T	C	36	25	61	0	4	65	0	0
21	11502143	.	A	G	24	32	56	0	0	56	0	0
21	11502807	.	G	T	2	23	25	0	22	47	0	0
21	11505250	.	C	T	1	2	3	0	0	3	0	0
21	11514360	.	A	G	2	2	4	0	1	5	0	0
21	11514386	.	A	G	2	2	4	0	0	4	0	0
21	11518424	.	G	A	3	2	5	0	0	5	0	0
21	11521251	.	T	A	2	2	4	0	0	4	0	0
21	11521268	.	T	C	3	2	5	0	0	5	0	0
21	11527709	.	G	A	3	3	6	0	0	6	0	0
21	11527950	.	A	G	2	0	2	0	3	5	0	0
21	11528040	.	A	G	3	3	6	0	0	6	0	0
21	11528047	.	A	C	4	3	7	0	0	7	0	0
21	11528094	.	G	A	7	4	11	0	1	12	0	0
21	11529213	.	T	A	1	2	3	0	0	3	0	0
21	11566285	.	T	G	9	6	15	0	0	15	0	0
21	11566478	.	G	T	7	8	15	0	1	16	0	0
21	11571108	.	G	A	7	4	11	0	0	11	0	0
21	11571147	.	T	C	7	4	11	0	1	12	0	0
21	11571159	.	G	T	6	5	11	0	1	12	0	0
21	11571279	.	C	G	9	2	11	0	0	11	0	0
21	11571287	.	T	A	8	3	11	0	0	11	0	0
21	11571353	.	G	A	9	7	16	1	0	17	0	0
21	11575596	.	T	G	6	6	12	0	0	12	0	0
21	11575611	.	T	C	8	8	16	0	0	16	0	0
21	11575632	.	T	A	10	7	17	0	0	17	0	0
21	11575748	.	G	A	7	4	11	0	1	12	0	0
21	11577590	.	T	C	2	2	4	0	0	4	0	0
21	11579624	.	T	C	3	4	7	0	1	8	0	0
21	11603878	.	C	T	0	2	2	0	2	4	0	0
21	11605674	.	A	G	2	2	4	0	0	4	0	0
21	11605710	.	C	A	0	5	5	0	2	7	0	0
21	11605801	.	C	T	1	5	6	0	0	6	0	0
21	11607758	.	T	C	2	0	2	1	2	5	0	0
21	11615331	.	G	A	1	2	3	0	0	3	0	0
21	11709084	.	G	A	14	12	26	0	2	28	0	0
21	11713042	.	G	A	4	19	23	0	20	43	0	0
21	11718420	.	T	C	19	16	35	0	0	35	0	0
21	11721310	.	T	C	15	23	38	0	0	38	0	0
21	11721984	.	A	G	18	0	18	0	16	34	0	0
21	11722262	.	C	T	7	20	27	0	0	27	0	0
21	11722277	.	C	T	9	18	27	0	0	27	0	0
21	11759242	.	A	G	3	8	11	0	0	11	0	0
21	11762308	.	A	C	1	0	1	0	5	6	0	0
21	11762314	.	T	G	3	1	4	0	2	6	0	0
21	11762387	.	G	T	2	3	5	0	0	5	0	0
21	11762456	.	T	G	1	2	3	0	0	3	0	0
21	11766523	.	A	T	5	4	9	1	0	10	0	0
21	11766535	.	G	A	0	5	5	1	4	10	0	0
21	11766663	.	T	G	4	0	4	0	5	9	0	0
21	11766664	.	T	C	5	2	7	0	3	10	0	0
21	11773106	.	G	A	5	4	9	0	0	9	0	0
21	11781541	.	A	G	5	10	15	0	0	15	0	0
21	11791937	.	A	T	3	4	7	0	2	9	0	0
21	11791948	.	G	A	4	6	10	0	0	10	0	0
21	11799553	.	A	G	4	4	8	0	1	9	0	0
21	11816763	.	C	A	2	4	6	0	0	6	0	0
21	11855947	.	C	T	5	4	9	0	0	9	0	0
21	11866057	.	A	C	7	14	21	0	1	22	0	0
21	11867908	.	T	C	6	6	12	0	1	13	0	0
21	11869495	.	C	A	6	10	16	0	1	17	0	0
21	11869774	.	G	C	0	10	10	0	10	20	0	0
21	11869870	.	C	T	17	12	29	0	2	31	0	0
21	11880927	.	G	A	8	6	14	0	3	17	0	0
21	11880996	.	G	A	11	16	27	0	0	27	0	0
21	11881129	.	G	C	12	7	19	0	1	20	0	0
21	11881140	.	C	T	11	7	18	0	2	20	0	0
21	11881344	.	G	A	8	14	22	0	0	22	0	0
21	11881715	.	C	T	12	8	20	0	1	21	0	0
21	11881875	.	A	T	5	2	7	0	0	7	0	0
21	11882712	.	A	G	6	2	8	0	1	9	0	0
21	11882902	.	T	C	1	2	3	0	0	3	0	0
21	11883699	.	G	A	1	4	5	0	0	5	0	0
21	11883850	.	A	T	3	2	5	0	0	5	0	0
21	11883896	.	C	T	3	2	5	0	0	5	0	0
21	11883901	.	A	G	3	1	4	0	0	4	0	0
21	11883984	.	C	A	4	2	6	0	0	6	0	0
21	11883991	.	A	T	3	1	4	0	2	6	0	0
21	11898772	.	A	C	3	8	11	0	0	11	0	0
21	11911722	.	A	T	7	16	23	0	0	23	0	0
21	11911730	.	A	T	7	15	22	0	0	22	0	0
21	11911921	.	C	T	11	11	22	0	1	23	0	0
21	11927113	.	C	T	14	16	30	0	1	31	0	0
21	11927809	.	G	C	1	16	17	0	10	27	0	0
21	11932372	.	T	C	16	14	30	0	0	30	0	0
21	11937522	.	A	G	16	15	31	0	3	34	0	0
21	11942334	.	T	C	20	21	41	0	6	47	0	0
21	11942407	.	T	C	15	22	37	0	1	38	0	0
21	11945863	.	C	T	26	16	42	0	1	43	0	0
21	11946133	.	C	T	14	13	27	0	0	27	0	0
21	11949317	.	C	T	21	14	35	0	3	38	0	0
21	11950217	.	C	A	27	18	45	0	1	46	0	0
21	11955208	.	A	C	4	3	7	0	8	15	0	0
21	11958852	.	A	T	11	14	25	0	0	25	0	0
21	11958928	.	A	G	12	6	18	0	0	18	0	0
21	11958971	.	G	T	18	7	25	0	0	25	0	0
21	11958982	.	C	T	15	11	26	0	0	26	0	0
21	11959034	.	G	A	8	16	24	0	1	25	0	0
21	11959061	.	T	G	13	7	20	0	0	20	0	0
21	11959185	.	A	G	8	19	27	0	0	27	0	0
21	11959309	.	T	C	10	11	21	0	2	23	0	0
21	11961122	.	C	T	16	18	34	0	0	35	1	0
21	11963068	.	G	A	2	2	4	0	1	5	0	0
21	11963090	.	T	G	4	2	6	0	0	6	0	0
21	11963648	.	C	G	2	2	4	0	0	4	0	0
21	11963778	.	C	A	9	14	23	0	0	23	0	0
21	11964981	.	C	T	3	7	10	0	0	10	0	0
21	11965035	.	T	G	6	6	12	0	1	13	0	0
21	11967077	.	T	C	8	8	16	0	1	17	0	0
21	11967857	.	A	C	9	7	16	0	1	17	0	0
21	11970139	.	C	T	0	10	10	0	11	21	0	0
21	12023854	.	C	T	3	2	5	0	1	6	0	0
21	12023880	.	A	C	4	5	9	0	0	9	0	0
21	12028080	.	G	A	15	16	31	0	0	31	0	0
21	12036013	.	C	T	7	12	19	0	0	19	0	0
21	12056633	.	G	T	3	3	6	0	0	6	0	0
21	12073944	.	T	C	1	2	3	0	0	3	0	0
21	12080051	.	C	G	1	23	24	0	18	42	0	0
21	12095798	.	A	G	24	13	37	0	3	40	0	0
21	12104957	.	C	A	14	17	31	0	1	32	0	0
21	12107367	.	A	G	20	10	30	0	2	32	0	0
21	12272375	.	T	G	14	24	38	0	1	39	0	0
21	13193928	.	C	T	22	23	45	0	0	45	0	0
21	13284495	.	A	G	2	2	4	0	0	4	0	0
21	13284514	.	C	T	2	2	4	0	0	4	0	0
21	13329495	.	C	T	18	17	35	0	2	37	0	0
21	13353301	.	T	A	7	4	11	0	0	11	0	0
21	13360446	.	C	T	26	13	39	0	1	40	0	0
21	13362830	.	A	C	19	20	39	0	4	43	0	0
21	13362896	.	C	T	20	18	38	0	3	41	0	0
21	13364790	.	T	A	21	16	37	0	2	39	0	0
21	13364802	.	T	C	21	15	36	0	2	38	0	0
21	13383459	.	T	C	3	2	5	0	0	5	0	0
21	13384359	.	T	A	4	2	6	0	1	7	0	0
21	13388223	.	T	C	2	6	8	0	0	8	0	0
21	13389733	.	T	A	2	2	4	0	0	4	0	0
21	13410331	.	A	G	3	6	9	0	1	10	0	0
21	13431198	.	G	A	9	7	16	0	1	17	0	0
21	13431261	.	G	C	6	11	17	0	0	17	0	0
21	13431309	.	A	G	9	2	11	0	10	21	0	0
21	13431363	.	A	T	3	6	9	0	0	9	0	0
21	13431379	.	T	A	1	5	6	0	0	6	0	0
21	13431470	.	A	G	1	7	8	0	0	8	0	0
21	13431573	.	T	C	5	10	15	0	1	16	0	0
21	13431620	.	T	C	8	9	17	0	0	17	0	0
21	13431639	.	C	T	10	7	17	0	2	19	0	0
21	13431668	.	T	A	8	3	11	0	0	11	0	0
21	13431720	.	T	A	2	2	4	0	0	4	0	0
21	13431924	.	A	G	7	4	11	0	0	11	0	0
21	13431947	.	A	T	10	4	14	0	0	14	0	0
21	13432049	.	A	G	3	6	9	0	1	10	0	0
21	13432071	.	A	C	4	10	14	0	1	15	0	0
21	13432117	.	T	G	6	1	7	0	6	13	0	0
21	13432315	.	T	C	11	7	18	0	2	20	0	0
21	13432369	.	C	A	8	3	11	0	1	12	0	0
21	13463160	.	T	G	3	4	7	0	1	8	0	0
21	13473775	.	A	G	2	6	8	0	0	8	0	0
21	13493234	.	A	G	5	8	13	0	0	13	0	0
21	13493762	.	A	G	3	2	5	0	0	5	0	0
21	13613532	.	C	T	2	2	4	0	0	4	0	0
21	13909005	.	T	C	43	30	73	0	0	73	0	0
21	13919482	.	C	T	27	19	46	0	4	50	0	0
21	13919498	.	C	A	20	17	37	0	10	47	0	0
21	13920204	.	G	C	6	31	37	0	37	74	0	0
21	13920308	.	C	T	34	28	62	0	8	70	0	0
21	13920510	.	G	A	8	42	50	0	27	77	0	0
21	13920648	.	G	A	6	27	33	0	33	66	0	0
21	13931143	.	C	T	2	2	4	0	0	4	0	0
21	13931145	.	C	T	2	2	4	0	0	4	0	0
21	13935981	.	C	A	1	2	3	0	0	3	0	0
21	13980445	.	T	A	5	7	12	0	2	14	0	0
21	13980490	.	T	C	6	9	15	0	0	15	0	0
21	13980516	.	G	A	4	8	12	0	0	12	0	0
21	13980628	.	G	T	4	3	7	0	0	7	0	0
21	13980743	.	A	G	2	4	6	0	0	6	0	0
21	13980834	.	G	A	1	2	3	0	0	3	0	0
21	13981620	.	C	T	0	6	6	0	7	13	0	0
21	13981746	.	G	A	1	2	3	0	0	3	0	0
21	13981973	.	C	T	1	4	5	0	3	8	0	0
21	13981980	.	T	C	3	4	7	0	0	7	0	0
21	13982111	.	C	G	2	3	5	0	0	5	0	0
21	13982154	.	G	A	3	4	7	0	0	7	0	0
21	13982163	.	C	T	0	3	3	0	3	6	0	0
21	13983757	.	G	A	1	2	3	0	0	3	0	0
21	14041092	.	A	G	4	5	9	0	0	9	0	0
21	14041194	.	C	T	0	2	2	0	3	5	0	0
21	14173820	.	T	G	5	2	7	0	0	7	0	0
21	14217519	.	C	A	4	2	6	0	0	6	0	0
21	14217595	.	T	C	8	8	16	0	0	16	0	0
21	14217612	.	T	C	12	0	12	0	6	18	0	0
21	14217657	.	T	G	11	6	17	0	2	19	0	0
21	14217664	.	T	C	4	0	4	0	13	17	0	0
21	14217762	.	G	T	9	7	16	0	0	16	0	0
21	14224135	.	A	T	17	5	22	0	1	23	0	0
21	14224168	.	C	T	9	10	19	0	1	20	0	0
21	14226528	.	C	T	2	6	8	0	4	12	0	0
21	14226571	.	T	A	12	4	16	0	2	18	0	0
21	14226601	.	C	T	1	11	12	0	7	19	0	0
21	14226685	.	C	T	10	12	22	0	0	22	0	0
21	14228943	.	C	T	5	5	10	0	0	10	0	0
21	14232498	.	G	A	4	5	9	0	1	10	0	0
21	14235495	.	A	G	7	7	14	0	1	15	0	0
21	14239956	.	C	T	8	8	16	0	1	17	0	0
21	14239988	.	C	T	10	9	19	0	0	19	0	0
21	14240025	.	G	T	8	6	14	0	1	15	0	0
21	14241936	.	C	A	8	6	14	0	0	14	0	0
21	14241982	.	G	T	9	12	21	0	0	21	0	0
21	14250993	.	T	C	3	4	7	0	0	7	0	0
21	14251128	.	G	T	3	7	10	0	0	10	0	0
21	14251160	.	T	A	3	7	10	0	0	10	0	0
21	14381440	.	G	A	6	3	9	0	0	9	0	0
21	14381547	.	T	C	7	1	8	0	6	14	0	0
21	14381740	.	A	T	9	6	15	0	0	15	0	0
21	14383767	.	T	C	4	0	4	0	11	15	0	0
21	14383809	.	C	T	1	6	7	0	7	14	0	0
21	14469501	.	A	G	2	3	5	0	0	5	0	0
21	14469505	.	G	A	3	2	5	0	0	5	0	0
21	14644287	.	A	G	1	2	3	0	0	3	0	0
21	14644558	.	G	A	2	5	7	0	1	8	0	0
21	14644567	.	G	A	2	3	5	0	0	5	0	0
21	14644702	.	A	T	8	11	19	0	0	19	0	0
21	14644814	.	C	T	7	15	22	0	0	22	0	0
21	14644917	.	T	G	13	9	22	0	1	24	1	0
21	14644949	.	C	T	3	8	11	0	6	17	0	0
21	14644981	.	G	C	13	7	20	0	0	20	0	0
21	14645238	.	C	A	12	5	17	0	0	17	0	0
21	14645239	.	C	A	11	5	16	0	1	17	0	0
21	14645399	.	C	T	8	7	15	0	1	16	0	0
21	14645401	.	C	T	7	8	15	0	1	16	0	0
21	14645490	.	C	T	6	16	22	0	0	24	2	0
21	14645641	.	C	A	4	6	10	0	0	10	0	0
21	14645642	.	A	C	4	6	10	0	0	10	0	0
21	14645724	.	G	T	12	16	28	0	2	30	0	0
21	14645728	.	A	G	10	16	26	0	2	28	0	0
21	14645873	.	C	T	10	21	31	0	0	31	0	0
21	14659421	.	C	T	6	5	11	0	0	11	0	0
21	14659828	.	A	T	9	5	14	0	0	14	0	0
21	14660057	.	C	A	4	6	10	0	1	11	0	0
21	14663464	.	C	T	4	6	10	0	1	11	0	0
21	14663911	.	T	C	10	6	16	0	0	16	0	0
21	14663932	.	C	T	1	12	13	0	0	13	0	0
21	14664752	.	G	A	8	9	17	0	0	17	0	0
21	14665152	.	G	A	5	9	14	0	0	14	0	0
21	14665312	.	T	C	3	2	5	0	0	5	0	0
21	14665343	.	C	T	1	3	4	0	3	7	0	0
21	14701803	.	G	A	14	12	26	0	0	26	0	0
21	14701890	.	A	G	10	15	25	0	2	27	0	0
21	14701953	.	T	C	12	0	12	0	13	25	0	0
21	14702076	.	C	T	7	9	16	1	1	18	0	0
21	14704871	.	G	A	11	8	19	0	0	19	0	0
21	14706677	.	C	A	9	7	16	0	2	18	0	0
21	14719613	.	G	C	2	0	2	0	4	6	0	0
21	14769344	.	C	T	1	2	3	0	2	5	0	0
21	14810906	.	T	G	4	4	8	0	0	8	0	0
21	14810988	.	T	C	1	5	6	0	0	6	0	0
21	14812964	.	G	A	8	3	11	0	1	12	0	0
21	14813064	.	A	G	6	10	16	0	0	16	0	0
21	14813138	.	A	G	7	5	12	0	1	13	0	0
21	14813282	.	C	G	14	11	25	0	2	27	0	0
21	14813380	.	G	C	13	4	17	0	1	18	0	0
21	14813402	.	T	A	16	6	22	0	0	22	0	0
21	14813479	.	T	C	15	1	16	0	7	23	0	0
21	14815804	.	A	G	10	14	24	0	0	24	0	0
21	14817425	.	C	T	1	3	4	0	0	4	0	0
21	14817434	.	A	G	1	3	4	0	0	4	0	0
21	14819421	.	C	G	0	6	6	0	5	11	0	0
21	14819766	.	G	A	3	2	5	0	0	5	0	0
21	14823023	.	G	A	1	4	5	0	0	5	0	0
21	14823035	.	T	C	1	0	1	0	4	5	0	0
21	14823792	.	T	G	2	2	4	0	0	4	0	0
21	14825952	.	T	C	1	4	5	0	0	5	0	0
21	14828692	.	C	T	1	2	3	0	2	5	0	0
21	14828722	.	A	C	2	3	5	0	0	5	0	0
21	14828848	.	T	C	3	7	10	0	0	10	0	0
21	14829081	.	C	A	0	3	3	0	3	6	0	0
21	14829091	.	G	A	3	3	6	0	0	6	0	0
21	14829145	.	A	G	3	5	8	0	1	9	0	0
21	14832141	.	C	T	3	3	6	0	1	7	0	0
21	14842944	.	T	C	15	22	37	0	1	38	0	0
21	14843085	.	C	T	11	7	18	0	0	18	0	0
21	14846607	.	T	C	8	17	25	0	0	25	0	0
21	14848426	.	A	C	16	11	27	0	1	28	0	0
21	14848427	.	T	A	16	11	27	0	1	28	0	0
21	14859396	.	C	T	12	9	21	0	0	21	0	0
21	14859447	.	A	C	16	12	28	0	1	29	0	0
21	14862981	.	G	A	12	16	28	0	0	28	0	0
21	14877995	.	C	T	2	9	11	0	6	17	0	0
21	14892293	.	A	T	1	3	4	0	1	5	0	0
21	14904837	.	G	A	2	4	6	0	0	6	0	0
21	14909372	.	C	G	3	3	6	0	2	8	0	0
21	15125603	.	A	C	17	3	20	1	0	21	0	0
21	15125661	.	G	A	21	13	34	0	1	35	0	0
21	15125667	.	G	A	26	13	39	0	1	40	0	0
21	15125825	.	T	C	12	2	14	0	7	21	0	0
21	15125859	.	T	C	7	16	23	0	0	23	0	0
21	15125867	.	C	T	8	12	20	0	2	22	0	0
21	15126048	.	G	A	15	10	25	0	2	27	0	0
21	15126068	.	G	T	13	13	26	0	1	27	0	0
21	15126088	.	G	A	12	13	25	0	0	25	0	0
21	15154547	.	A	T	15	18	33	0	0	33	0	0
21	15154625	.	A	G	14	17	31	0	1	32	0	0
21	15230556	.	C	T	3	15	18	0	21	39	0	0
21	15234284	.	T	A	29	21	50	0	0	50	0	0
21	15252402	.	G	A	19	21	40	0	0	40	0	0
21	15252491	.	C	A	2	20	22	0	18	40	0	0
21	15263962	.	C	T	3	12	15	0	17	32	0	0
21	17179255	.	T	C	9	3	12	0	0	12	0	0
21	17192940	.	C	T	8	12	20	0	0	20	0	0
21	17241789	.	G	A	15	9	24	1	0	25	0	0
21	17241810	.	T	C	10	8	18	1	0	19	0	0
21	17242441	.	C	A	7	16	23	0	3	26	0	0
21	17243160	.	C	T	7	4	11	0	0	11	0	0
21	17253496	.	T	C	8	6	14	0	2	16	0	0
21	17255815	.	C	G	10	11	21	0	0	21	0	0
21	17258421	.	T	A	7	17	24	0	2	26	0	0
21	17258576	.	T	G	9	11	20	0	1	21	0	0
21	17258670	.	A	G	10	0	10	0	12	22	0	0
21	17258771	.	G	A	0	7	7	0	7	14	0	0
21	17258784	.	A	C	7	6	13	0	0	13	0	0
21	17258864	.	T	C	4	6	10	0	0	10	0	0
21	17259113	.	G	A	8	7	15	0	0	15	0	0
21	17260532	.	C	G	7	3	10	0	0	10	0	0
21	17312347	.	T	C	2	2	4	0	1	5	0	0
21	17313776	.	G	A	2	3	5	0	0	5	0	0
21	17322641	.	G	T	9	11	20	0	0	20	0	0
21	17327124	.	G	C	1	9	10	0	9	19	0	0
21	17327163	.	T	G	7	9	16	0	1	17	0	0
21	17327359	.	C	T	4	7	11	0	0	11	0	0
21	17327389	.	C	T	3	4	7	0	0	7	0	0
21	17327599	.	C	T	3	3	6	0	0	6	0	0
21	17327646	.	G	A	11	8	19	0	0	19	0	0
21	17333807	.	G	C	9	11	20	0	1	21	0	0
21	17335595	.	T	C	13	13	26	0	0	26	0	0
21	17335664	.	G	A	10	9	19	0	0	19	0	0
21	17335676	.	G	A	2	11	13	0	7	20	0	0
21	17336042	.	A	C	14	9	23	0	0	23	0	0
21	17337694	.	G	A	2	13	15	0	9	24	0	0
21	17337807	.	C	T	11	9	20	0	2	22	0	0
21	17338101	.	A	C	13	13	26	0	2	28	0	0
21	17338352	.	A	G	5	4	9	0	0	9	0	0
21	17338963	.	T	C	8	9	17	0	3	20	0	0
21	17339001	.	C	A	10	5	15	0	0	15	0	0
21	17339002	.	A	T	10	5	15	0	0	15	0	0
21	17339044	.	C	A	5	12	17	0	0	17	0	0
21	17339384	.	C	T	18	14	32	0	3	35	0	0
21	17339664	.	C	T	14	18	32	0	2	34	0	0
21	17339716	.	G	A	7	10	17	0	1	18	0	0
21	17339767	.	A	T	3	4	7	0	1	8	0	0
21	17478936	.	C	T	0	18	18	0	21	39	0	0
21	17480167	.	G	A	21	16	37	1	0	38	0	0
21	17480216	.	C	T	13	12	25	0	2	27	0	0
21	17480251	.	T	A	12	14	26	0	3	29	0	0
21	17482201	.	A	G	12	16	28	0	1	29	0	0
21	17549205	.	C	T	11	11	22	0	0	22	0	0
21	17567289	.	G	A	22	16	38	0	1	39	0	0
21	17567593	.	T	C	8	9	17	0	3	20	0	0
21	17567612	.	C	T	10	12	22	0	1	23	0	0
21	17567642	.	T	C	12	11	23	0	2	25	0	0
21	17567649	.	T	C	10	11	21	0	1	22	0	0
21	17567857	.	C	A	13	9	22	0	0	22	0	0
21	17567880	.	A	T	14	11	25	0	0	25	0	0
21	17567911	.	C	T	14	6	20	1	1	22	0	0
21	17567940	.	C	A	14	6	20	2	0	23	1	0
21	17567994	.	A	C	6	5	11	1	1	15	2	0
21	17568027	.	G	A	3	13	16	0	2	18	0	0
21	17568482	.	A	G	16	10	26	0	0	26	0	0
21	17568507	.	A	T	17	12	29	0	1	30	0	0
21	17568543	.	A	G	9	28	37	0	0	37	0	0
21	17568655	.	G	A	2	25	27	2	17	46	0	0
21	17568819	.	G	A	1	11	12	0	13	25	0	0
21	17568825	.	T	A	12	10	22	0	1	23	0	0
21	17569200	.	A	G	15	13	28	0	1	29	0	0
21	17569587	.	C	A	15	19	34	0	5	39	0	0
21	17569647	.	T	C	16	21	37	0	4	41	0	0
21	17569745	.	T	A	17	12	29	0	0	29	0	0
21	17569747	.	T	A	16	11	27	0	1	28	0	0
21	17569808	.	A	C	14	17	31	0	0	31	0	0
21	17569812	.	C	G	12	14	26	0	1	27	0	0
21	17572916	.	C	T	1	6	7	0	2	9	0	0
21	17572988	.	C	A	6	6	12	0	0	12	0	0
21	17577997	.	G	C	10	0	10	0	9	19	0	0
21	17578010	.	G	T	12	10	22	0	0	22	0	0
21	17578655	.	C	T	1	8	9	0	8	17	0	0
21	17578717	.	G	A	6	5	11	0	0	11	0	0
21	17580509	.	G	A	1	4	5	0	0	5	0	0
21	17580599	.	C	T	9	3	12	0	0	12	0	0
21	17589992	.	G	A	6	2	8	0	0	8	0	0
21	17592446	.	C	A	2	2	4	0	0	4	0	0
21	17603075	.	T	A	3	3	6	0	0	6	0	0
21	17603098	.	C	T	0	2	2	0	3	5	0	0
21	17910473	.	A	C	4	7	11	0	0	11	0	0
21	17944772	.	C	T	5	6	11	0	0	11	0	0
21	17982663	.	T	C	1	3	4	0	0	4	0	0
21	17982666	.	T	C	1	3	4	0	0	4	0	0
21	17984484	.	C	A	14	9	23	0	0	23	0	0
21	17984685	.	G	A	10	12	22	0	0	22	0	0
21	17984919	.	G	A	8	6	14	0	0	14	0	0
21	17984965	.	G	A	7	9	16	0	1	17	0	0
21	17985047	.	C	T	4	7	11	0	0	11	0	0
21	17985548	.	G	T	1	2	3	0	0	3	0	0
21	17985557	.	G	A	1	3	4	0	0	4	0	0
21	18013155	.	T	C	5	3	8	0	0	8	0	0
21	18022981	.	C	T	8	2	10	0	1	11	0	0
21	18023170	.	G	T	7	7	14	0	0	14	0	0
21	18023283	.	G	A	6	3	9	0	0	9	0	0
21	18023504	.	A	G	11	3	14	0	2	16	0	0
21	18023792	.	G	T	6	4	10	0	2	12	0	0
21	18024032	.	A	C	7	7	14	0	0	14	0	0
21	18024633	.	C	T	1	6	7	0	8	15	0	0
21	18032121	.	G	T	3	3	6	0	0	6	0	0
21	18032981	.	T	C	3	1	4	0	2	6	0	0
21	18033292	.	A	T	4	4	8	0	3	11	0	0
21	18062056	.	C	T	1	3	4	0	0	4	0	0
21	18269653	.	C	T	0	8	8	0	9	17	0	0
21	18269695	.	C	T	7	4	11	0	0	11	0	0
21	18270975	.	T	C	2	0	2	0	2	4	0	0
21	18271138	.	C	T	12	9	21	0	2	23	0	0
21	18271650	.	T	A	16	4	20	1	0	21	0	0
21	18272195	.	T	C	14	8	22	0	0	22	0	0
21	18272435	.	T	C	10	8	18	0	1	19	0	0
21	18272507	.	C	G	0	7	7	0	3	10	0	0
21	18272687	.	T	C	3	6	9	0	1	10	0	0
21	18273434	.	G	A	13	9	22	0	0	22	0	0
21	18273485	.	A	T	10	10	20	0	0	20	0	0
21	18276073	.	A	G	12	0	12	0	9	21	0	0
21	18285868	.	C	T	14	11	25	0	1	26	0	0
21	18286641	.	C	T	25	8	33	0	0	33	0	0
21	18289749	.	T	C	13	10	23	0	2	25	0	0
21	18289909	.	G	C	11	12	23	0	1	24	0	0
21	18331963	.	G	A	1	2	3	0	0	3	0	0
21	18332010	.	A	G	1	4	5	0	0	5	0	0
21	18339622	.	G	A	7	6	13	0	0	13	0	0
21	18370570	.	G	A	1	6	7	0	13	20	0	0
21	18372902	.	G	A	10	15	25	0	5	30	0	0
21	18375442	.	A	G	7	6	13	0	1	14	0	0
21	18375662	.	G	A	0	14	14	0	11	25	0	0
21	18382501	.	T	C	9	6	15	0	0	15	0	0
21	18382546	.	C	T	4	7	11	0	1	12	0	0
21	18385061	.	C	T	18	7	25	0	0	25	0	0
21	18386613	.	C	T	7	12	19	0	0	19	0	0
21	18386704	.	A	G	8	0	8	0	8	16	0	0
21	18386849	.	C	T	12	6	18	0	1	19	0	0
21	18600495	.	G	A	3	2	5	0	0	5	0	0
21	18600505	.	G	A	3	2	5	0	0	5	0	0
21	18600750	.	T	A	5	4	9	0	0	9	0	0
21	18600764	.	A	G	4	4	8	0	0	8	0	0
21	18600880	.	C	T	0	2	2	0	8	10	0	0
21	18648803	.	A	G	3	3	6	0	0	6	0	0
21	18701475	.	A	G	4	2	6	0	0	6	0	0
21	18759677	.	T	C	1	2	3	0	1	4	0	0
21	18760100	.	A	G	1	3	4	0	0	4	0	0
21	18824034	.	A	T	2	2	4	0	0	4	0	0
21	18824042	.	C	T	2	2	4	0	0	4	0	0
21	18921035	.	C	A	2	6	8	0	0	8	0	0
21	18921053	.	T	C	2	8	10	0	0	10	0	0
21	18921092	.	A	G	4	0	4	0	6	10	0	0
21	18922940	.	T	C	5	5	10	0	0	10	0	0
21	18922973	.	G	A	7	4	11	0	0	11	0	0
21	18923115	.	A	G	6	2	8	0	0	8	0	0
21	18924082	.	G	A	2	2	4	0	4	8	0	0
21	18924676	.	C	T	8	5	13	0	0	13	0	0
21	18924712	.	T	C	6	4	10	0	0	10	0	0
21	18924716	.	A	G	4	0	4	0	5	9	0	0
21	18924751	.	T	C	3	3	6	0	0	6	0	0
21	18925278	.	A	G	3	4	7	0	0	7	0	0
21	18925521	.	A	G	7	3	10	0	0	10	0	0
21	18925531	.	A	G	6	3	9	0	0	9	0	0
21	18929509	.	T	C	8	9	17	0	1	18	0	0
21	18932088	.	A	G	13	13	26	0	1	27	0	0
21	18932287	.	C	T	3	9	12	0	11	23	0	0
21	18932717	.	G	A	11	8	19	0	2	21	0	0
21	18933748	.	G	T	7	8	15	0	2	17	0	0
21	18934265	.	C	A	4	15	19	0	12	31	0	0
21	18934289	.	C	T	1	11	12	0	23	35	0	0
21	18937216	.	C	T	3	9	12	0	6	18	0	0
21	18938388	.	A	G	2	7	9	0	1	10	0	0
21	18938391	.	C	T	3	6	9	0	1	10	0	0
21	18950633	.	C	T	6	5	11	0	0	11	0	0
21	18950754	.	G	A	9	7	16	0	0	16	0	0
21	18950997	.	T	G	12	15	27	0	2	29	0	0
21	18956779	.	C	T	8	10	18	0	0	18	0	0
21	18956883	.	T	A	10	12	22	0	2	24	0	0
21	18957259	.	G	A	18	13	31	0	1	32	0	0
21	18957601	.	C	G	15	5	20	1	0	21	0	0
21	18957624	.	T	C	12	7	19	1	1	21	0	0
21	18957776	.	T	C	7	13	20	0	1	21	0	0
21	19008193	.	A	T	18	23	41	0	1	42	0	0
21	19008272	.	C	T	18	15	33	0	3	36	0	0
21	19008368	.	C	T	13	18	31	0	3	34	0	0
21	19008602	.	G	A	23	19	42	0	1	43	0	0
21	19008689	.	G	A	25	12	37	0	0	37	0	0
21	19008736	.	G	A	19	14	33	0	3	36	0	0
21	19009693	.	A	C	19	20	39	0	3	42	0	0
21	19010069	.	G	A	19	27	46	0	0	47	1	0
21	19010097	.	A	T	27	25	52	0	5	57	0	0
21	19010108	.	G	A	27	32	59	0	2	61	0	0
21	19010830	.	T	C	3	2	5	0	1	6	0	0
21	19014179	.	C	T	15	13	28	6	2	36	0	0
21	19014256	.	T	C	22	2	24	0	35	59	0	0
21	19014298	.	C	T	34	28	62	0	3	65	0	0
21	19014341	.	C	A	24	35	59	0	4	63	0	0
21	19014420	.	C	T	35	34	69	0	2	71	0	0
21	19014567	.	C	T	24	34	58	0	3	61	0	0
21	19014634	.	A	T	27	27	54	0	4	58	0	0
21	19014714	.	G	A	25	28	53	0	3	56	0	0
21	19014980	.	C	T	23	25	48	0	2	50	0	0
21	19015035	.	A	G	25	28	53	0	1	54	0	0
21	19015460	.	C	A	16	25	41	0	2	43	0	0
21	19015461	.	C	A	16	25	41	0	2	43	0	0
21	19015508	.	C	T	22	17	39	0	0	39	0	0
21	19017370	.	T	A	18	29	47	0	2	49	0	0
21	19017819	.	G	A	19	27	46	0	2	48	0	0
21	19018116	.	A	G	22	23	45	0	0	45	0	0
21	19018224	.	A	C	31	21	52	0	0	52	0	0
21	19018362	.	A	G	26	14	40	0	1	41	0	0
21	19052979	.	G	A	0	2	2	0	1	3	0	0
21	19061809	.	C	T	1	2	3	0	0	3	0	0
21	19061852	.	A	G	1	0	1	0	3	4	0	0
21	19061861	.	C	A	1	2	3	0	0	3	0	0
21	19063304	.	G	A	27	33	60	0	6	66	0	0
21	19063325	.	T	C	31	36	67	0	3	70	0	0
21	19066878	.	C	T	35	34	69	0	1	70	0	0
21	19071919	.	C	T	4	3	7	0	1	8	0	0
21	19073505	.	C	T	4	3	7	0	0	7	0	0
21	19073629	.	T	C	6	4	10	1	0	11	0	0
21	19073718	.	T	C	1	2	3	0	0	3	0	0
21	19301698	.	G	T	1	2	3	0	0	3	0	0
21	19324534	.	T	C	2	4	6	0	0	6	0	0
21	19329072	.	C	T	4	6	10	0	0	10	0	0
21	19329135	.	C	T	9	12	21	0	1	22	0	0
21	19329285	.	C	T	4	12	16	0	11	27	0	0
21	19329813	.	G	T	18	16	34	0	1	35	0	0
21	19329971	.	C	G	2	17	19	0	18	37	0	0
21	19347416	.	A	G	1	2	3	0	0	3	0	0
21	19418953	.	T	A	1	3	4	0	0	4	0	0
21	19603399	.	G	A	3	2	5	0	0	5	0	0
21	19607006	.	C	T	1	4	5	0	0	5	0	0
21	19607018	.	A	C	1	4	5	0	0	5	0	0
21	19607552	.	C	T	4	3	7	0	0	7	0	0
21	19763715	.	T	G	26	21	47	0	0	47	0	0
21	19763755	.	G	A	27	31	58	1	3	62	0	0
21	19763785	.	A	T	33	23	56	0	2	58	0	0
21	19764316	.	T	G	29	17	46	0	2	48	0	0
21	19764397	.	G	C	24	27	51	0	0	51	0	0
21	19764431	.	C	T	6	22	28	0	26	54	0	0
21	19764516	.	G	A	18	22	40	0	4	44	0	0
21	19764674	.	C	T	8	4	12	0	0	12	0	0
21	19764676	.	T	C	8	4	12	0	0	12	0	0
21	19765039	.	G	A	22	23	45	0	0	45	0	0
21	19790527	.	A	C	25	17	42	0	0	42	0	0
21	19790590	.	G	A	21	20	41	0	0	41	0	0
21	19792803	.	G	A	12	22	34	0	0	34	0	0
21	19795075	.	T	C	10	0	10	0	16	26	0	0
21	19796215	.	G	A	20	10	30	0	0	30	0	0
21	19807356	.	C	G	19	13	32	0	3	35	0	0
21	19809122	.	T	C	12	0	12	0	16	28	0	0
21	19820016	.	G	T	7	5	12	0	1	13	0	0
21	19821323	.	C	A	1	5	6	0	18	24	0	0
21	19821449	.	A	T	21	10	31	1	1	33	0	0
21	19862670	.	C	T	2	3	5	0	0	5	0	0
21	19863205	.	G	A	1	2	3	0	0	3	0	0
21	19868489	.	C	T	8	8	16	0	0	16	0	0
21	19868674	.	G	A	10	5	15	0	0	15	0	0
21	19869129	.	C	T	13	10	23	0	0	23	0	0
21	19872772	.	G	A	6	6	12	0	1	13	0	0
21	19872904	.	C	T	8	10	18	0	0	18	0	0
21	19903584	.	G	A	10	10	20	0	1	21	0	0
21	19904713	.	G	C	8	9	17	0	1	18	0	0
21	19905105	.	G	A	2	6	8	0	0	8	0	0
21	19905153	.	G	A	3	6	9	0	0	9	0	0
21	19905553	.	C	T	8	6	14	0	1	15	0	0
21	19905564	.	G	A	6	8	14	0	0	14	0	0
21	19905762	.	T	C	4	9	13	0	0	13	0	0
21	19905915	.	A	G	4	4	8	0	0	8	0	0
21	19906513	.	T	C	5	3	8	0	0	8	0	0
21	19906589	.	G	C	3	2	5	0	0	5	0	0
21	19906590	.	A	C	2	0	2	0	3	5	0	0
21	19913445	.	G	C	2	6	8	0	0	8	0	0
21	19914241	.	C	T	1	2	3	0	0	3	0	0
21	19914263	.	T	G	2	2	4	0	0	4	0	0
21	19915594	.	T	G	6	2	8	0	0	8	0	0
21	19915703	.	C	T	0	4	4	0	0	4	0	0
21	19915724	.	T	C	2	2	4	0	1	5	0	0
21	19929996	.	T	C	2	4	6	0	0	6	0	0
21	19945680	.	C	T	1	4	5	0	0	5	0	0
21	20039621	.	G	A	0	17	17	0	4	21	0	0
21	20039687	.	G	A	1	13	14	0	7	21	0	0
21	20064720	.	T	A	7	7	14	0	0	14	0	0
21	20064747	.	G	T	6	8	14	0	0	14	0	0
21	20067528	.	C	T	12	10	22	0	0	22	0	0
21	20067531	.	C	T	9	11	20	0	2	22	0	0
21	20086915	.	C	T	18	10	28	0	0	28	0	0
21	20103068	.	G	A	16	13	29	0	2	31	0	0
21	20103249	.	T	C	9	16	25	0	0	25	0	0
21	20105111	.	A	T	12	11	23	0	1	24	0	0
21	20105129	.	C	T	12	13	25	0	0	25	0	0
21	20106524	.	G	A	10	15	25	0	1	26	0	0
21	20108363	.	C	T	12	3	15	0	3	18	0	0
21	20108782	.	G	A	5	4	9	0	0	9	0	0
21	20113519	.	C	A	11	9	20	0	0	20	0	0
21	20113912	.	A	T	5	9	14	0	0	14	0	0
21	20114094	.	G	A	15	14	29	0	1	30	0	0
21	20114148	.	G	A	13	10	23	0	1	24	0	0
21	20114385	.	G	A	9	5	14	0	2	16	0	0
21	20120057	.	A	G	7	8	15	0	0	15	0	0
21	20120404	.	G	A	12	6	18	0	0	18	0	0
21	20310421	.	G	A	1	2	3	0	0	3	0	0
21	20325441	.	C	T	2	4	6	0	0	6	0	0
21	20325629	.	C	A	2	2	4	0	0	4	0	0
21	20325630	.	A	G	2	2	4	0	0	4	0	0
21	20377931	.	C	T	11	9	20	0	2	22	0	0
21	20377944	.	C	T	11	17	28	0	1	29	0	0
21	20392829	.	C	T	1	3	4	0	0	4	0	0
21	20392831	.	A	G	1	0	1	0	3	4	0	0
21	20394306	.	C	T	0	4	4	0	0	4	0	0
21	20394321	.	C	A	2	1	3	0	0	3	0	0
21	20394348	.	C	T	2	4	6	0	0	6	0	0
21	20394396	.	T	C	4	3	7	0	1	8	0	0
21	20394397	.	C	A	5	3	8	0	0	8	0	0
21	20394687	.	C	T	1	2	3	0	0	3	0	0
21	20395011	.	G	A	0	3	3	0	2	5	0	0
21	20395038	.	C	T	4	2	6	0	0	6	0	0
21	20395336	.	C	T	2	2	4	0	0	4	0	0
21	20395560	.	T	C	2	4	6	0	0	6	0	0
21	20615173	.	T	A	2	4	6	0	0	6	0	0
21	20615197	.	T	G	1	2	3	0	1	4	0	0
21	20633020	.	G	A	4	2	6	0	0	6	0	0
21	20633065	.	C	T	2	3	5	0	0	5	0	0
21	20633152	.	A	G	5	2	7	0	0	7	0	0
21	20633230	.	A	G	5	0	5	0	4	9	0	0
21	20634217	.	G	A	4	4	8	0	0	8	0	0
21	20634252	.	A	G	2	0	2	0	6	8	0	0
21	20634266	.	A	G	2	3	5	0	0	5	0	0
21	20634474	.	A	T	1	3	4	0	0	4	0	0
21	20634486	.	G	A	1	3	4	0	0	4	0	0
21	20634883	.	T	A	3	2	5	0	0	5	0	0
21	20635183	.	A	G	4	4	8	0	0	8	0	0
21	20635186	.	A	G	2	0	2	0	6	8	0	0
21	20635369	.	T	A	3	3	6	0	0	6	0	0
21	20635428	.	T	A	2	3	5	0	1	6	0	0
21	20635546	.	T	C	2	2	4	0	0	4	0	0
21	20636403	.	C	T	4	4	8	0	0	8	0	0
21	20636690	.	C	T	2	1	3	0	1	4	0	0
21	20744903	.	C	T	1	3	4	0	0	4	0	0
21	20795641	.	C	A	1	6	7	1	1	9	0	0
21	20915065	.	C	T	15	13	28	0	0	28	0	0
21	20915152	.	C	T	3	4	7	0	0	7	0	0
21	20915736	.	C	T	2	3	5	0	0	5	0	0
21	20916023	.	C	T	0	4	4	0	1	5	0	0
21	20933504	.	A	T	7	5	12	0	0	12	0	0
21	20933759	.	G	A	12	8	20	0	1	21	0	0
21	20933798	.	C	T	10	4	14	0	0	14	0	0
21	20938270	.	G	A	18	11	29	0	2	31	0	0
21	20938354	.	T	A	17	8	25	0	1	26	0	0
21	20938976	.	T	C	19	13	32	0	0	32	0	0
21	20938981	.	C	A	3	14	17	0	15	32	0	0
21	20950835	.	G	A	1	7	8	0	1	9	0	0
21	20950841	.	A	G	7	2	9	0	0	9	0	0
21	20951231	.	G	A	1	2	3	0	3	6	0	0
21	21017484	.	G	C	14	13	27	0	0	27	0	0
21	21017606	.	G	A	21	15	36	0	2	38	0	0
21	21028097	.	G	C	17	18	35	0	0	35	0	0
21	21029465	.	G	C	6	7	13	0	0	13	0	0
21	21038891	.	G	T	15	9	24	0	1	25	0	0
21	21039092	.	C	T	12	15	27	0	1	28	0	0
21	21046882	.	C	T	17	13	30	0	3	33	0	0
21	21046960	.	G	A	10	15	25	0	0	25	0	0
21	21048363	.	G	A	12	17	29	0	0	29	0	0
21	21051358	.	G	C	10	10	20	0	0	20	0	0
21	21051391	.	A	C	13	1	14	0	7	21	0	0
21	21051688	.	G	A	10	12	22	0	0	22	0	0
21	21051715	.	C	T	11	9	20	0	0	20	0	0
21	21069858	.	A	G	7	5	12	0	1	13	0	0
21	21076065	.	G	T	4	8	12	0	0	12	0	0
21	21076080	.	C	T	1	8	9	0	4	13	0	0
21	21079840	.	G	A	11	18	29	0	0	29	0	0
21	21079852	.	C	A	1	11	12	0	16	28	0	0
21	21082623	.	G	T	7	3	10	0	0	10	0	0
21	21147779	.	C	A	9	6	15	0	0	15	0	0
21	21170882	.	C	G	3	3	6	0	0	6	0	0
21	21177120	.	T	C	10	8	18	0	0	18	0	0
21	21215895	.	G	A	1	7	8	0	0	8	0	0
21	21221016	.	T	G	7	7	14	0	0	14	0	0
21	21224343	.	T	C	3	2	5	0	0	5	0	0
21	21227308	.	A	G	2	2	4	0	1	5	0	0
21	21228207	.	T	A	5	4	9	0	0	9	0	0
21	21228247	.	C	T	2	5	7	0	0	7	0	0
21	21230016	.	C	T	7	3	10	0	0	10	0	0
21	21230088	.	G	A	1	4	5	0	6	11	0	0
21	21230137	.	C	A	5	4	9	0	0	9	0	0
21	21232768	.	G	T	3	4	7	0	1	8	0	0
21	21234939	.	C	T	3	4	7	0	1	8	0	0
21	21235061	.	C	T	3	5	8	0	0	8	0	0
21	21236883	.	G	A	7	6	13	0	0	13	0	0
21	21236900	.	A	G	5	4	9	0	2	11	0	0
21	21238404	.	C	T	3	9	12	0	0	12	0	0
21	21239977	.	A	C	3	3	6	0	2	8	0	0
21	21240046	.	G	A	0	6	6	0	4	10	0	0
21	21240651	.	C	T	10	14	24	0	0	24	0	0
21	21240776	.	G	A	6	3	9	0	0	9	0	0
21	21241133	.	A	G	1	5	6	0	1	7	0	0
21	21241364	.	T	A	7	12	19	0	0	19	0	0
21	21241598	.	A	G	8	4	12	0	0	12	0	0
21	21241747	.	T	C	13	5	18	0	1	19	0	0
21	21241802	.	C	T	4	7	11	0	1	12	0	0
21	21241900	.	C	T	10	9	19	0	0	19	0	0
21	21242132	.	A	G	4	4	8	0	0	8	0	0
21	21242320	.	T	A	2	3	5	0	0	5	0	0
21	21269834	.	G	C	5	6	11	0	0	11	0	0
21	21273096	.	A	G	8	4	12	0	0	12	0	0
21	21277052	.	C	A	6	3	9	0	0	9	0	0
21	21279360	.	A	G	13	0	13	0	7	20	0	0
21	21279396	.	C	A	10	8	18	0	3	21	0	0
21	21286183	.	G	C	8	12	20	0	0	20	0	0
21	21294272	.	C	T	13	11	24	0	1	25	0	0
21	21297358	.	G	T	10	5	15	0	0	15	0	0
21	21297635	.	C	T	4	9	13	0	0	13	0	0
21	21297849	.	C	T	8	3	11	0	1	12	0	0
21	21298158	.	G	T	11	5	16	1	0	17	0	0
21	21298249	.	T	C	12	4	16	0	2	18	0	0
21	21298340	.	G	A	10	15	25	0	1	26	0	0
21	21298387	.	A	G	10	0	10	0	12	22	0	0
21	21298427	.	G	A	9	4	13	0	0	13	0	0
21	21298488	.	C	T	5	4	9	0	0	9	0	0
21	21298633	.	G	A	14	5	19	0	0	19	0	0
21	21298703	.	C	A	6	8	14	0	0	14	0	0
21	21298811	.	A	T	8	7	15	0	1	16	0	0
21	21298824	.	G	A	8	7	15	0	0	15	0	0
21	21314012	.	G	A	4	2	6	0	0	6	0	0
21	21315761	.	G	C	1	2	3	0	0	3	0	0
21	21325628	.	T	G	9	7	16	0	0	16	0	0
21	21326118	.	C	A	6	3	9	0	0	9	0	0
21	21326139	.	C	T	3	2	5	0	1	6	0	0
21	21326220	.	A	C	1	4	5	0	0	5	0	0
21	21326222	.	A	G	1	4	5	0	0	5	0	0
21	21333080	.	T	G	2	5	7	0	0	7	0	0
21	21339410	.	A	T	9	5	14	0	1	15	0	0
21	21342595	.	A	G	5	6	11	0	1	12	0	0
21	21342797	.	A	G	3	2	5	0	1	6	0	0
21	21342798	.	A	G	4	2	6	0	0	6	0	0
21	21343061	.	A	G	2	2	4	0	1	5	0	0
21	21343266	.	A	G	2	4	6	0	0	6	0	0
21	21346850	.	C	T	17	17	34	0	0	34	0	0
21	21347039	.	G	A	6	9	15	0	1	16	0	0
21	21347053	.	T	A	9	8	17	0	0	17	0	0
21	21347180	.	G	C	10	11	21	1	0	22	0	0
21	21368363	.	A	G	14	12	26	0	0	26	0	0
21	21370406	.	T	C	20	1	21	0	14	35	0	0
21	21372874	.	T	A	20	18	38	0	1	39	0	0
21	21450616	.	A	G	6	3	9	0	0	9	0	0
21	21450625	.	T	G	5	2	7	0	0	7	0	0
21	21513960	.	A	C	4	4	8	0	0	8	0	0
21	21523167	.	A	C	2	3	5	0	0	5	0	0
21	21523303	.	T	A	4	7	11	0	0	11	0	0
21	21523344	.	A	G	6	9	15	0	1	16	0	0
21	21523465	.	A	G	7	3	10	0	0	10	0	0
21	21523612	.	G	T	2	5	7	0	0	7	0	0
21	21525664	.	T	C	6	5	11	0	0	11	0	0
21	21633386	.	A	C	2	0	2	0	2	4	0	0
21	21633496	.	C	T	4	8	12	0	0	12	0	0
21	21633558	.	A	G	1	6	7	0	2	9	0	0
21	21633559	.	C	A	1	8	9	0	0	9	0	0
21	21633668	.	G	A	3	8	11	0	0	11	0	0
21	21633825	.	T	A	2	6	8	0	1	9	0	0
21	21639625	.	C	T	0	3	3	0	1	4	0	0
21	21640787	.	T	C	4	2	6	0	1	7	0	0
21	21793873	.	A	C	1	3	4	0	0	4	0	0
21	21794238	.	C	T	5	1	6	0	1	7	0	0
21	21794262	.	G	A	5	2	7	0	1	8	0	0
21	21794277	.	T	A	7	3	10	0	0	10	0	0
21	21794361	.	A	G	3	0	3	0	2	5	0	0
21	21794443	.	G	A	3	2	5	0	2	7	0	0
21	21794494	.	G	T	0	2	2	0	6	8	0	0
21	21820167	.	C	T	4	5	9	0	0	9	0	0
21	21821291	.	C	T	3	2	5	0	1	6	0	0
21	21821378	.	G	T	4	2	6	0	0	6	0	0
21	21996637	.	G	A	14	19	33	0	1	34	0	0
21	22014223	.	A	T	5	12	17	0	0	17	0	0
21	22038369	.	T	C	28	18	46	0	0	46	0	0
21	22038375	.	C	T	22	24	46	0	2	48	0	0
21	22044690	.	T	A	20	8	28	0	3	31	0	0
21	22048143	.	G	A	10	11	21	0	4	25	0	0
21	22070486	.	A	G	11	12	23	0	2	25	0	0
21	22070522	.	C	T	15	15	30	0	0	30	0	0
21	22070591	.	G	A	0	13	13	0	11	24	0	0
21	22070633	.	C	T	13	14	27	0	0	27	0	0
21	22073477	.	A	G	2	16	18	0	1	19	0	0
21	22082184	.	C	T	15	22	37	0	2	39	0	0
21	22099698	.	A	G	18	22	40	0	3	43	0	0
21	22099727	.	A	G	21	24	45	0	2	47	0	0
21	22099869	.	G	A	35	33	68	0	1	69	0	0
21	22100026	.	A	G	31	33	64	0	2	66	0	0
21	22100156	.	A	G	40	4	44	3	11	58	0	0
21	22100453	.	C	T	30	32	62	0	1	63	0	0
21	22100511	.	G	A	27	18	45	0	2	47	0	0
21	22100594	.	A	G	31	21	52	0	1	53	0	0
21	22100767	.	C	T	30	32	62	0	2	64	0	0
21	22101056	.	C	A	24	22	46	0	0	46	0	0
21	22101271	.	A	G	23	35	58	0	0	58	0	0
21	22101304	.	G	A	29	24	53	0	2	55	0	0
21	22101387	.	A	T	25	29	54	0	1	55	0	0
21	22101423	.	C	T	4	24	28	1	37	66	0	0
21	22101460	.	C	T	26	25	51	1	5	57	0	0
21	22101471	.	G	A	29	28	57	1	3	61	0	0
21	22101665	.	G	C	21	31	52	0	0	52	0	0
21	22101835	.	C	T	26	24	50	0	1	51	0	0
21	22102044	.	C	T	3	32	35	0	27	62	0	0
21	22102261	.	G	T	33	22	55	0	1	56	0	0
21	22102405	.	C	T	24	25	49	0	4	53	0	0
21	22102416	.	C	T	2	23	25	0	29	54	0	0
21	22102515	.	T	A	21	22	43	0	0	43	0	0
21	22102586	.	C	A	25	19	44	0	1	45	0	0
21	22102930	.	C	T	9	28	37	0	23	60	0	0
21	22102931	.	A	G	33	20	53	0	7	60	0	0
21	22110005	.	C	T	29	25	54	0	2	56	0	0
21	22110113	.	C	T	30	22	52	0	3	55	0	0
21	22110288	.	T	C	17	1	18	0	30	48	0	0
21	22110303	.	G	A	16	32	48	0	2	50	0	0
21	22111880	.	G	A	19	22	41	0	3	44	0	0
21	22111982	.	C	A	24	17	41	0	1	42	0	0
21	22116192	.	G	A	1	2	3	0	0	3	0	0
21	22116228	.	A	G	1	2	3	0	0	3	0	0
21	22116233	.	A	T	2	2	4	0	0	4	0	0
21	22116586	.	G	A	5	5	10	0	0	10	0	0
21	22116611	.	C	T	5	6	11	0	1	12	0	0
21	22116684	.	A	T	2	5	7	0	1	8	0	0
21	22121201	.	C	T	3	3	6	0	1	7	0	0
21	22127204	.	C	T	5	4	9	0	0	9	0	0
21	22138508	.	T	C	7	2	9	0	0	9	0	0
21	22194401	.	C	T	3	3	6	0	0	6	0	0
21	22209234	.	C	G	1	2	3	0	0	3	0	0
21	22330177	.	A	C	3	6	9	0	0	9	0	0
21	22330494	.	C	T	4	4	8	0	0	8	0	0
21	22336365	.	C	T	12	8	20	0	1	21	0	0
21	22346512	.	G	T	3	4	7	0	0	8	1	0
21	22347182	.	T	C	3	4	7	0	0	7	0	0
21	22347380	.	C	A	1	1	2	0	1	3	0	0
21	22385617	.	C	T	1	2	3	0	0	3	0	0
21	22386399	.	T	C	2	2	4	0	0	4	0	0
21	22387556	.	G	T	1	3	4	0	0	4	0	0
21	22387825	.	G	A	1	1	2	0	0	2	0	0
21	22387834	.	T	C	1	2	3	0	0	3	0	0
21	22404800	.	G	C	0	9	9	0	11	20	0	0
21	22412304	.	T	C	18	11	29	0	1	30	0	0
21	22412343	.	C	T	17	15	32	0	0	32	0	0
21	22412376	.	T	G	15	0	15	0	22	37	0	0
21	22421853	.	T	C	17	7	24	1	0	25	0	0
21	22421867	.	T	G	5	15	20	1	0	21	0	0
21	22422052	.	A	G	14	18	32	0	3	35	0	0
21	22422149	.	T	C	15	17	32	0	1	33	0	0
21	22422243	.	G	A	13	10	23	0	0	23	0	0
21	22422407	.	T	G	16	14	30	0	1	31	0	0
21	22422565	.	C	G	11	7	18	0	0	18	0	0
21	22447991	.	T	C	2	2	4	0	0	4	0	0
21	22448132	.	T	C	4	4	8	0	0	8	0	0
21	22454360	.	G	A	2	2	4	0	0	4	0	0
21	22454381	.	T	C	2	2	4	0	0	4	0	0
21	22454715	.	G	A	1	2	3	0	0	3	0	0
21	22460206	.	C	T	1	2	3	0	0	3	0	0
21	22598734	.	T	G	1	2	3	0	0	3	0	0
21	22598794	.	A	C	1	3	4	0	0	4	0	0
21	22630712	.	T	A	1	2	3	0	0	3	0	0
21	22630819	.	T	A	4	2	6	0	0	6	0	0
21	22631163	.	T	C	24	23	47	0	0	47	0	0
21	22631172	.	A	T	19	21	40	0	3	43	0	0
21	22633430	.	C	T	16	16	32	0	0	32	0	0
21	22633773	.	T	C	10	12	22	0	0	22	0	0
21	22634136	.	C	G	9	10	19	0	0	19	0	0
21	22634205	.	G	T	7	15	22	0	1	23	0	0
21	22634243	.	G	A	10	14	24	0	1	25	0	0
21	22634289	.	C	T	14	11	25	0	1	26	0	0
21	22698809	.	C	T	7	4	11	0	1	12	0	0
21	22699645	.	C	T	8	7	15	0	0	15	0	0
21	22699654	.	A	G	4	6	10	0	2	12	0	0
21	22700003	.	T	G	4	7	11	0	0	11	0	0
21	22702551	.	A	C	8	4	12	0	2	14	0	0
21	22702804	.	C	T	8	11	19	0	1	20	0	0
21	22702816	.	T	C	10	6	16	0	3	19	0	0
21	22704853	.	T	C	14	9	23	0	0	23	0	0
21	22705087	.	C	T	1	6	7	0	1	8	0	0
21	22705165	.	G	T	3	4	7	0	0	7	0	0
21	22705177	.	G	T	3	4	7	0	0	7	0	0
21	22705203	.	C	T	4	3	7	0	0	7	0	0
21	22706822	.	A	C	1	4	5	0	0	5	0	0
21	22706834	.	A	G	1	3	4	0	0	4	0	0
21	22708855	.	T	G	3	5	8	0	0	8	0	0
21	22709160	.	C	T	3	2	5	0	1	6	0	0
21	22709197	.	T	A	2	2	4	0	0	4	0	0
21	22722594	.	T	C	1	2	3	0	0	3	0	0
21	22772230	.	T	C	6	2	8	0	0	8	0	0
21	22773736	.	G	A	0	4	4	0	1	5	0	0
21	22789131	.	G	A	3	10	13	0	3	16	0	0
21	22789353	.	C	T	2	3	5	0	0	5	0	0
21	22795324	.	C	T	6	7	13	0	1	14	0	0
21	22795358	.	T	G	4	2	6	0	1	7	0	0
21	22795392	.	A	T	4	3	7	0	0	7	0	0
21	22795593	.	C	G	5	6	11	0	1	12	0	0
21	22795662	.	T	A	3	4	7	0	0	7	0	0
21	22807907	.	G	A	1	2	3	0	0	3	0	0
21	22846910	.	G	A	9	12	21	0	1	22	0	0
21	22846948	.	G	A	12	12	24	0	0	24	0	0
21	22846973	.	C	T	11	13	24	0	2	26	0	0
21	22847059	.	G	C	18	19	37	0	0	37	0	0
21	22847069	.	A	G	18	22	40	0	0	40	0	0
21	22847128	.	G	C	14	14	28	0	1	29	0	0
21	22847136	.	C	T	15	13	28	0	0	28	0	0
21	22847284	.	A	G	21	0	21	0	15	36	0	0
21	22847750	.	C	T	20	25	45	0	4	49	0	0
21	22848011	.	G	A	24	21	45	0	0	45	0	0
21	22848173	.	C	T	10	18	28	0	0	28	0	0
21	22848293	.	C	T	13	12	25	0	1	26	0	0
21	22848403	.	T	C	16	11	27	0	2	29	0	0
21	22849817	.	A	C	21	25	46	1	1	48	0	0
21	22850242	.	G	A	25	23	48	0	1	49	0	0
21	22850422	.	G	A	24	24	48	0	2	50	0	0
21	22850949	.	G	A	16	15	31	0	1	32	0	0
21	22876194	.	C	A	1	2	3	0	0	3	0	0
21	22876273	.	C	A	2	2	4	0	0	4	0	0
21	22876289	.	G	C	2	2	4	0	0	4	0	0
21	22877279	.	T	A	2	3	5	0	0	5	0	0
21	22877313	.	C	T	1	2	3	0	0	3	0	0
21	22878880	.	C	A	18	8	26	0	1	27	0	0
21	22878994	.	T	C	14	9	23	0	1	24	0	0
21	22879338	.	C	A	9	8	17	1	0	18	0	0
21	22879458	.	A	G	9	0	9	0	12	21	0	0
21	22879559	.	A	C	14	14	28	0	0	28	0	0
21	22879733	.	G	C	1	9	10	0	6	16	0	0
21	22879824	.	A	C	10	10	20	0	1	21	0	0
21	22879909	.	C	A	6	7	13	0	0	13	0	0
21	22879925	.	T	A	9	8	17	0	0	17	0	0
21	22880016	.	A	T	15	11	26	0	2	28	0	0
21	22880079	.	C	T	9	13	22	0	0	22	0	0
21	22881408	.	A	G	15	6	21	0	2	23	0	0
21	22881477	.	G	C	15	5	20	0	0	20	0	0
21	22882354	.	G	T	10	7	17	0	1	18	0	0
21	22882386	.	T	G	7	0	7	0	11	18	0	0
21	22882587	.	A	C	9	12	21	0	1	22	0	0
21	22882761	.	C	T	9	11	20	0	0	20	0	0
21	22882801	.	G	T	9	11	20	0	1	21	0	0
21	22882866	.	T	C	11	8	19	0	0	19	0	0
21	22883182	.	C	T	16	6	22	0	0	22	0	0
21	22883363	.	T	C	12	4	16	0	0	16	0	0
21	22883854	.	A	T	22	9	31	0	0	31	0	0
21	22884361	.	T	C	15	11	26	0	0	26	0	0
21	22884412	.	C	T	14	15	29	0	0	29	0	0
21	22884556	.	G	A	1	9	10	0	17	27	0	0
21	22884661	.	T	C	16	13	29	0	1	30	0	0
21	22884769	.	C	T	18	15	33	0	1	34	0	0
21	22885083	.	G	T	16	10	26	0	0	26	0	0
21	22886365	.	G	A	13	15	28	0	0	28	0	0
21	22887883	.	C	T	10	7	17	0	1	18	0	0
21	22887951	.	A	G	11	9	20	0	4	24	0	0
21	22888352	.	C	T	5	7	12	0	0	12	0	0
21	22888355	.	T	A	5	6	11	0	1	12	0	0
21	22889238	.	A	C	7	6	13	0	0	13	0	0
21	22891872	.	C	A	1	3	4	0	0	4	0	0
21	22892027	.	C	T	0	2	2	0	1	3	0	0
21	22892936	.	C	T	2	2	4	0	0	4	0	0
21	22922488	.	C	T	1	2	3	0	1	4	0	0
21	22922490	.	A	G	2	2	4	0	0	4	0	0
21	22961233	.	A	T	6	8	14	0	0	14	0	0
21	22965838	.	G	A	2	7	9	0	0	9	0	0
21	22965844	.	G	A	3	8	11	0	0	11	0	0
21	22965891	.	C	A	9	3	12	0	0	12	0	0
21	22967106	.	A	G	2	15	17	0	1	18	0	0
21	22969687	.	C	G	2	5	7	0	0	7	0	0
21	23008720	.	C	T	3	2	5	0	0	5	0	0
21	23019589	.	T	G	10	10	20	0	0	20	0	0
21	23019679	.	C	A	23	15	38	0	3	41	0	0
21	23020440	.	A	T	16	17	33	1	2	36	0	0
21	23020523	.	T	C	18	0	18	1	23	42	0	0
21	23020558	.	C	T	2	22	24	1	17	42	0	0
21	23021145	.	C	A	15	16	31	0	1	32	0	0
21	23024996	.	A	G	16	15	31	0	1	32	0	0
21	23025197	.	T	A	6	16	22	0	1	23	0	0
21	23025233	.	G	A	7	16	23	0	0	23	0	0
21	23025364	.	T	A	14	9	23	0	2	25	0	0
21	23026978	.	C	T	3	15	18	0	15	33	0	0
21	23027017	.	C	T	17	13	30	0	1	31	0	0
21	23028399	.	C	T	3	19	22	0	14	36	0	0
21	23028432	.	G	A	21	18	39	0	2	41	0	0
21	23029206	.	A	G	12	11	23	0	1	24	0	0
21	23029476	.	T	A	8	19	27	0	1	28	0	0
21	23034852	.	A	G	11	14	25	0	1	26	0	0
21	23037906	.	T	C	10	10	20	0	0	20	0	0
21	23040517	.	A	G	5	5	10	0	1	11	0	0
21	23040577	.	A	G	4	8	12	0	1	13	0	0
21	23040993	.	T	G	8	4	12	0	0	12	0	0
21	23043192	.	G	T	4	2	6	0	0	6	0	0
21	23043953	.	T	C	6	4	10	0	1	11	0	0
21	23043978	.	A	G	5	3	8	0	0	8	0	0
21	23046424	.	C	T	0	5	5	0	5	10	0	0
21	23160558	.	T	G	7	8	15	0	1	16	0	0
21	23161061	.	G	A	16	13	29	0	0	29	0	0
21	23161651	.	C	A	6	3	9	1	0	10	0	0
21	23162127	.	A	T	12	8	20	0	0	20	0	0
21	23162618	.	C	A	9	8	17	0	2	19	0	0
21	23163694	.	G	A	10	7	17	0	1	18	0	0
21	23164090	.	C	T	3	3	6	0	0	6	0	0
21	23169835	.	G	A	13	9	22	0	1	23	0	0
21	23304314	.	G	A	2	5	7	0	0	7	0	0
21	23304539	.	T	A	6	5	11	0	1	12	0	0
21	23305121	.	A	C	1	5	6	0	0	6	0	0
21	23338168	.	A	G	5	11	16	0	2	18	0	0
21	23349569	.	C	T	9	5	14	0	1	15	0	0
21	23350204	.	G	A	11	12	23	0	2	25	0	0
21	23350240	.	A	G	12	12	24	0	2	26	0	0
21	23352791	.	A	C	6	0	6	0	4	10	0	0
21	23467074	.	A	G	9	9	18	0	1	19	0	0
21	23473213	.	G	A	6	12	18	0	0	18	0	0
21	23746912	.	G	T	1	3	4	0	1	5	0	0
21	24287537	.	C	T	15	17	32	0	1	33	0	0
21	24411429	.	C	G	17	22	39	0	2	41	0	0
21	24532288	.	G	A	5	6	11	0	0	11	0	0
21	24532321	.	T	C	4	3	7	0	0	7	0	0
21	24536365	.	G	T	3	3	6	0	0	6	0	0
21	24536809	.	G	A	12	16	28	0	1	29	0	0
21	24536943	.	T	C	6	4	10	0	0	10	0	0
21	24537014	.	T	A	2	3	5	0	0	5	0	0
21	24539908	.	T	A	5	4	9	0	0	9	0	0
21	24539983	.	A	G	4	8	12	0	1	13	0	0
21	24540379	.	C	A	1	7	8	0	19	27	0	0
21	24540684	.	A	G	14	6	20	0	0	20	0	0
21	24540990	.	G	C	7	5	12	0	1	13	0	0
21	24541141	.	C	T	8	11	19	0	0	19	0	0
21	24541279	.	A	G	13	6	19	0	0	19	0	0
21	24541606	.	T	A	9	9	18	0	0	18	0	0
21	24572181	.	G	A	1	4	5	0	0	5	0	0
21	24572193	.	G	T	1	3	4	0	0	4	0	0
21	24573783	.	A	G	4	2	6	0	1	7	0	0
21	24612536	.	G	A	3	4	7	0	0	7	0	0
21	24729766	.	G	A	1	2	3	0	0	3	0	0
21	24865403	.	C	A	3	3	6	0	0	6	0	0
21	25036957	.	C	T	4	3	7	1	0	8	0	0
21	25037404	.	A	C	4	4	8	0	0	8	0	0
21	25037431	.	G	T	0	3	3	0	4	7	0	0
21	25037521	.	G	A	0	2	2	0	6	8	0	0
21	25037572	.	T	C	6	5	11	0	0	11	0	0
21	25043681	.	C	T	5	8	13	0	0	13	0	0
21	25044375	.	G	A	3	3	6	0	0	6	0	0
21	25044532	.	C	A	10	5	15	0	0	15	0	0
21	25044885	.	G	C	6	6	12	0	1	13	0	0
21	25045347	.	A	G	8	3	11	0	0	11	0	0
21	25045470	.	C	A	1	3	4	0	0	4	0	0
21	25045517	.	C	T	3	4	7	0	0	7	0	0
21	25045521	.	T	C	3	4	7	0	0	7	0	0
21	25046734	.	C	T	4	5	9	0	1	10	0	0
21	25057140	.	G	A	2	3	5	0	5	10	0	0
21	25059752	.	G	A	1	4	5	0	3	8	0	0
21	25059941	.	G	A	7	3	10	0	0	10	0	0
21	25082995	.	G	A	2	3	5	0	1	6	0	0
21	25083307	.	C	T	1	2	3	0	0	3	0	0
21	25083308	.	A	C	1	1	2	0	1	3	0	0
21	25083391	.	A	T	2	2	4	0	0	4	0	0
21	25085598	.	C	T	1	2	3	0	1	4	0	0
21	25092333	.	T	G	7	8	15	0	0	15	0	0
21	25092667	.	C	T	4	11	15	0	0	15	0	0
21	25103396	.	C	A	13	10	23	0	0	23	0	0
21	25103676	.	T	A	19	7	26	0	1	27	0	0
21	25109986	.	A	G	17	8	25	0	0	25	0	0
21	25110372	.	G	A	14	12	26	0	0	26	0	0
21	25115692	.	G	T	16	16	32	0	0	32	0	0
21	25117588	.	A	G	10	9	19	0	0	19	0	0
21	25117626	.	A	G	11	1	12	0	7	20	1	0
21	25117777	.	T	G	8	12	20	0	0	20	0	0
21	25117887	.	G	T	7	7	14	0	0	14	0	0
21	25117926	.	T	C	9	15	24	0	0	24	0	0
21	25117974	.	A	C	11	8	19	0	1	20	0	0
21	25118122	.	G	A	6	5	11	0	0	11	0	0
21	25118141	.	A	G	9	0	9	0	4	13	0	0
21	25118560	.	G	A	0	4	4	0	4	8	0	0
21	25120740	.	A	G	4	2	6	0	0	6	0	0
21	25121405	.	G	A	4	3	7	0	0	7	0	0
21	25123236	.	A	G	7	5	12	0	1	13	0	0
21	25135789	.	C	T	4	2	6	0	1	7	0	0
21	25135922	.	T	G	4	7	11	0	0	11	0	0
21	25136093	.	T	C	9	4	13	0	1	14	0	0
21	25140596	.	A	G	5	3	8	0	1	9	0	0
21	25142635	.	A	G	10	8	18	0	1	19	0	0
21	25156486	.	C	A	5	4	9	0	0	9	0	0
21	25156487	.	C	A	5	5	10	0	0	10	0	0
21	25171632	.	C	T	5	8	13	0	1	14	0	0
21	25171692	.	T	C	2	3	5	0	0	5	0	0
21	25181082	.	A	G	4	4	8	0	0	8	0	0
21	25181089	.	G	T	5	4	9	0	0	9	0	0
21	25181299	.	A	G	2	4	6	0	0	6	0	0
21	25181366	.	A	G	5	8	13	0	1	14	0	0
21	25181643	.	T	A	19	13	32	0	1	34	1	0
21	25182086	.	G	A	15	10	25	0	2	27	0	0
21	25182552	.	A	T	14	11	25	0	0	25	0	0
21	25182595	.	T	C	8	13	21	0	0	21	0	0
21	25182598	.	G	A	8	12	20	0	1	21	0	0
21	25182721	.	T	C	2	11	13	0	0	13	0	0
21	25182735	.	T	G	2	0	2	0	11	13	0	0
21	25182858	.	A	C	11	9	20	0	0	20	0	0
21	25183176	.	C	A	6	12	18	0	1	19	0	0
21	25183177	.	T	C	7	12	19	0	0	19	0	0
21	25183224	.	T	A	6	12	18	0	0	18	0	0
21	25183225	.	A	G	6	11	17	0	1	18	0	0
21	25183292	.	T	A	2	3	5	0	0	5	0	0
21	25183322	.	C	A	2	2	4	0	0	4	0	0
21	25195376	.	G	A	4	3	7	0	0	7	0	0
21	25207925	.	A	G	7	5	12	0	0	12	0	0
21	25207931	.	A	G	5	5	10	0	1	11	0	0
21	25209223	.	G	A	3	4	7	0	1	8	0	0
21	25210921	.	A	G	2	7	9	0	0	9	0	0
21	25210936	.	T	C	2	0	2	0	8	10	0	0
21	25231265	.	T	A	12	10	22	0	4	26	0	0
21	25231269	.	T	G	12	0	12	0	13	25	0	0
21	25247433	.	C	A	1	10	11	0	9	20	0	0
21	25247533	.	T	C	4	0	4	0	13	17	0	0
21	25250524	.	G	A	9	3	12	0	0	12	0	0
21	25250632	.	G	C	3	0	3	0	2	5	0	0
21	25250749	.	C	T	1	5	6	0	2	8	0	0
21	25250836	.	G	A	1	4	5	0	2	7	0	0
21	25250983	.	G	A	6	6	12	0	1	13	0	0
21	25250986	.	G	A	6	6	12	0	1	13	0	0
21	25271503	.	C	T	3	2	5	0	0	5	0	0
21	25271522	.	T	A	2	2	4	0	0	4	0	0
21	25391290	.	C	A	27	19	46	0	6	52	0	0
21	25399339	.	T	G	7	15	22	0	1	23	0	0
21	25399873	.	A	G	22	17	39	0	4	43	0	0
21	25399909	.	T	G	20	20	40	0	2	42	0	0
21	25407031	.	G	C	21	2	23	0	19	42	0	0
21	25425528	.	C	A	7	9	16	0	2	18	0	0
21	25440088	.	C	T	27	24	51	0	3	54	0	0
21	25533875	.	T	G	3	8	11	0	0	11	0	0
21	25542391	.	T	C	4	4	8	0	0	9	1	0
21	25542711	.	T	C	14	8	22	0	0	22	0	0
21	25561388	.	C	A	2	5	7	0	0	7	0	0
21	25561586	.	G	A	18	7	25	0	1	26	0	0
21	25570275	.	G	C	16	10	26	0	3	29	0	0
21	25570323	.	G	A	13	13	26	0	3	29	0	0
21	25570416	.	C	G	1	13	14	0	10	24	0	0
21	25570434	.	G	A	10	16	26	0	0	26	0	0
21	25571133	.	C	A	5	2	7	0	0	7	0	0
21	25571377	.	A	G	8	5	13	0	0	13	0	0
21	25571446	.	G	A	12	6	18	0	2	20	0	0
21	25571488	.	T	A	4	10	14	0	0	14	0	0
21	25572156	.	C	T	0	4	4	0	4	8	0	0
21	25572930	.	C	T	1	5	6	0	3	10	1	0
21	25573031	.	A	C	6	6	12	0	1	13	0	0
21	25589318	.	T	C	11	13	24	0	0	24	0	0
21	25589724	.	A	G	4	2	6	0	0	6	0	0
21	25601254	.	G	A	8	15	23	0	3	26	0	0
21	25605515	.	T	A	5	2	7	0	1	8	0	0
21	25774329	.	C	G	2	2	4	0	0	4	0	0
21	25811263	.	C	T	3	3	6	0	0	6	0	0
21	25818509	.	T	C	1	6	7	0	1	8	0	0
21	25819439	.	G	A	2	3	5	0	0	5	0	0
21	25968253	.	C	T	8	8	16	0	0	16	0	0
21	26021822	.	T	C	1	0	1	0	2	3	0	0
21	26021834	.	A	C	2	2	4	0	0	5	1	0
21	26022173	.	A	T	5	6	11	0	0	11	0	0
21	26022992	.	C	T	1	2	3	0	5	8	0	0
21	26023209	.	G	A	2	11	13	0	1	14	0	0
21	26044146	.	G	T	4	8	12	0	0	12	0	0
21	26053710	.	T	G	18	0	18	0	12	30	0	0
21	26058204	.	G	A	17	10	27	0	2	29	0	0
21	26073115	.	A	T	32	26	58	0	2	60	0	0
21	26080402	.	A	G	4	8	12	0	0	12	0	0
21	26080547	.	A	G	12	9	21	0	0	21	0	0
21	26080633	.	G	C	6	5	11	0	0	11	0	0
21	26089689	.	G	A	7	4	11	0	0	11	0	0
21	26152862	.	C	T	3	8	11	0	2	13	0	0
21	26153049	.	C	T	13	8	21	0	0	21	0	0
21	26153123	.	G	A	21	10	31	0	3	34	0	0
21	26184258	.	T	A	6	10	16	0	0	16	0	0
21	26184259	.	G	T	5	9	14	0	1	15	0	0
21	26391964	.	T	A	5	3	8	1	0	9	0	0
21	26408340	.	A	C	13	1	14	0	15	29	0	0
21	26524932	.	G	T	9	11	20	0	0	20	0	0
21	26525311	.	C	T	8	5	13	0	1	14	0	0
21	26527808	.	A	G	16	6	22	0	1	23	0	0
21	26528092	.	T	A	8	6	14	0	0	14	0	0
21	26530723	.	G	T	9	9	18	0	1	19	0	0
21	26530758	.	T	C	8	13	21	0	0	21	0	0
21	26531102	.	A	G	12	8	20	0	1	21	0	0
21	26531299	.	T	A	3	6	9	0	2	11	0	0
21	26545622	.	T	A	7	2	9	0	0	9	0	0
21	26545632	.	T	C	6	2	8	0	0	8	0	0
21	26549764	.	A	G	8	7	15	0	2	17	0	0
21	26553406	.	C	T	6	6	12	0	0	12	0	0
21	26553425	.	T	C	7	7	14	0	0	14	0	0
21	26553466	.	A	G	4	6	10	0	1	11	0	0
21	26553554	.	A	C	9	6	15	0	1	16	0	0
21	26553577	.	A	T	5	9	14	0	1	15	0	0
21	26553794	.	C	T	12	4	16	0	1	17	0	0
21	26553857	.	T	A	7	4	11	0	0	11	0	0
21	26553879	.	G	T	6	3	9	0	0	9	0	0
21	26553971	.	A	T	3	5	8	0	1	9	0	0
21	26554116	.	T	C	3	5	8	0	0	8	0	0
21	26554139	.	C	T	2	5	7	0	0	7	0	0
21	26620914	.	T	C	6	5	11	0	1	12	0	0
21	26621139	.	G	A	1	7	8	0	2	10	0	0
21	26657476	.	C	T	27	32	59	0	2	61	0	0
21	26657484	.	C	A	32	26	58	0	2	60	0	0
21	26660055	.	G	A	3	28	31	0	26	57	0	0
21	26663161	.	G	C	37	28	65	0	0	65	0	0
21	26664625	.	C	T	36	30	66	3	1	70	0	0
21	26664770	.	C	T	13	19	32	0	10	42	0	0
21	26664824	.	G	A	4	9	13	0	1	14	0	0
21	26665171	.	T	A	12	8	20	0	0	20	0	0
21	26665364	.	T	A	4	10	14	0	0	14	0	0
21	26665661	.	A	G	14	17	31	0	0	31	0	0
21	26665745	.	C	A	2	12	14	0	17	31	0	0
21	26665784	.	C	T	0	19	19	0	15	34	0	0
21	26665986	.	C	A	16	17	33	0	0	33	0	0
21	26668766	.	T	A	9	9	18	0	0	18	0	0
21	26668826	.	T	G	6	8	14	0	0	14	0	0
21	26669075	.	C	A	4	3	7	0	0	7	0	0
21	26669077	.	T	A	3	3	6	0	0	6	0	0
21	26669926	.	G	T	3	2	5	0	1	6	0	0
21	26670265	.	T	A	7	9	16	0	0	16	0	0
21	26670306	.	T	A	11	8	19	0	0	19	0	0
21	26670409	.	A	T	5	6	11	0	0	11	0	0
21	26670418	.	C	T	4	5	9	0	0	9	0	0
21	26670860	.	C	A	6	2	8	0	0	8	0	0
21	26671390	.	G	A	1	1	2	0	5	7	0	0
21	26671715	.	A	T	8	2	10	0	0	10	0	0
21	26671993	.	A	G	8	8	16	0	0	16	0	0
21	26672293	.	A	G	7	7	14	0	0	14	0	0
21	26672319	.	C	G	7	7	14	0	0	14	0	0
21	26672409	.	C	T	3	4	7	0	0	7	0	0
21	26673408	.	A	G	5	5	10	0	2	12	0	0
21	26673777	.	G	A	3	5	8	0	0	8	0	0
21	26675240	.	C	T	0	6	6	0	5	11	0	0
21	26678611	.	T	A	2	2	4	0	0	4	0	0
21	26678649	.	C	T	3	7	10	0	0	10	0	0
21	26678650	.	C	T	3	7	10	0	0	10	0	0
21	26678838	.	C	A	7	8	15	0	0	15	0	0
21	26678906	.	G	A	13	7	20	0	1	21	0	0
21	26684350	.	T	A	11	8	19	0	4	23	0	0
21	26685383	.	C	T	4	3	7	0	2	9	0	0
21	26689440	.	G	A	6	8	14	0	0	14	0	0
21	26689934	.	A	T	8	16	24	0	1	25	0	0
21	26690151	.	T	A	8	13	21	0	0	21	0	0
21	26691926	.	A	T	8	7	15	0	2	17	0	0
21	26706404	.	T	G	34	33	67	0	2	69	0	0
21	26706408	.	G	A	5	36	41	0	31	72	0	0
21	26706481	.	C	T	32	28	60	0	2	62	0	0
21	26706482	.	C	T	31	28	59	0	3	62	0	0
21	26706646	.	C	G	27	24	51	0	0	51	0	0
21	26706662	.	T	A	30	22	52	0	2	54	0	0
21	26706805	.	C	T	26	27	53	0	1	54	0	0
21	26710514	.	A	G	33	27	60	0	0	60	0	0
21	26721403	.	A	T	9	10	19	0	2	21	0	0
21	26722212	.	G	C	23	10	33	0	0	33	0	0
21	26724649	.	A	G	19	16	35	0	2	37	0	0
21	26724723	.	G	A	24	15	39	0	3	42	0	0
21	26725247	.	C	T	21	15	36	0	0	36	0	0
21	26725403	.	T	C	22	19	41	0	3	44	0	0
21	26726997	.	C	A	36	34	70	0	3	73	0	0
21	26731236	.	C	A	32	38	70	0	2	72	0	0
21	26731344	.	G	A	36	26	62	0	6	68	0	0
21	26731364	.	T	A	36	31	67	2	1	70	0	0
21	26731765	.	C	T	36	37	73	0	4	77	0	0
21	26733416	.	C	T	6	11	17	0	1	18	0	0
21	26733489	.	G	A	5	3	8	0	1	9	0	0
21	26733639	.	A	G	3	0	3	0	5	8	0	0
21	26748227	.	T	C	8	7	15	0	0	15	0	0
21	26753714	.	G	A	6	7	13	0	0	13	0	0
21	26760016	.	G	A	7	3	10	0	1	11	0	0
21	26787786	.	T	C	7	6	13	0	0	13	0	0
21	26787885	.	A	T	12	4	16	0	0	16	0	0
21	26908810	.	G	A	12	18	30	0	0	30	0	0
21	26909176	.	G	A	9	16	25	0	0	25	0	0
21	26909197	.	G	A	11	16	27	0	0	27	0	0
21	26909361	.	G	A	17	8	25	0	0	25	0	0
21	26909425	.	C	G	17	9	26	0	1	27	0	0
21	26915316	.	T	G	9	9	18	0	0	18	0	0
21	26915956	.	A	T	7	4	11	0	1	12	0	0
21	26917948	.	C	T	7	5	12	0	1	13	0	0
21	26917958	.	C	T	0	6	6	0	7	13	0	0
21	26918023	.	G	A	2	3	5	0	0	5	0	0
21	26918601	.	C	T	6	5	11	0	0	11	0	0
21	26918703	.	A	G	4	4	8	0	0	8	0	0
21	26918726	.	G	A	3	4	7	0	2	9	0	0
21	26918762	.	C	A	7	5	12	0	1	13	0	0
21	26918767	.	G	A	9	6	15	0	0	15	0	0
21	26927255	.	T	C	12	10	22	0	0	22	0	0
21	26934419	.	G	A	11	9	20	0	1	21	0	0
21	26934888	.	C	T	10	10	20	0	1	21	0	0
21	26954405	.	G	A	14	6	20	0	0	20	0	0
21	26954430	.	T	C	12	6	18	0	0	18	0	0
21	26961015	.	A	T	14	10	24	0	2	26	0	0
21	26961084	.	A	G	17	14	31	0	2	33	0	0
21	26961177	.	C	T	11	17	28	0	1	29	0	0
21	26961515	.	C	T	7	16	23	0	1	24	0	0
21	26961548	.	C	A	11	18	29	0	1	30	0	0
21	26965636	.	C	T	12	16	28	0	1	29	0	0
21	26966025	.	T	C	10	13	23	0	1	24	0	0
21	26966047	.	A	T	13	17	30	0	0	30	0	0
21	26966079	.	A	G	14	0	14	0	11	25	0	0
21	26966088	.	A	T	9	8	17	0	4	21	0	0
21	26966193	.	A	T	15	18	33	0	0	33	0	0
21	26966681	.	A	G	14	0	14	0	7	21	0	0
21	26966918	.	C	T	9	7	16	0	2	18	0	0
21	26967426	.	G	A	18	20	38	0	1	39	0	0
21	26967551	.	A	T	15	14	29	0	4	33	0	0
21	26967899	.	A	C	27	19	46	0	1	47	0	0
21	26967906	.	T	G	29	18	47	0	1	48	0	0
21	26968127	.	G	T	18	19	37	0	3	40	0	0
21	26968264	.	G	A	23	18	41	0	2	43	0	0
21	26968478	.	G	A	12	12	24	0	1	25	0	0
21	26968499	.	T	G	20	10	30	0	1	31	0	0
21	26968556	.	G	A	13	3	16	0	0	17	1	0
21	26996005	.	A	G	8	16	24	0	0	24	0	0
21	27010406	.	T	A	19	11	30	0	5	35	0	0
21	27048320	.	C	A	11	13	24	0	1	25	0	0
21	27048374	.	A	G	10	7	17	0	0	17	0	0
21	27048388	.	G	A	9	7	16	0	1	17	0	0
21	27048423	.	G	T	6	7	13	0	1	14	0	0
21	27048534	.	G	A	17	9	26	0	2	28	0	0
21	27053061	.	G	A	5	8	13	0	0	13	0	0
21	27053121	.	A	G	9	7	16	0	0	16	0	0
21	27055995	.	G	A	15	8	23	0	0	23	0	0
21	27055998	.	G	T	9	16	25	0	0	25	0	0
21	27058274	.	C	G	13	10	23	0	0	23	0	0
21	27061115	.	C	T	1	10	11	0	9	20	0	0
21	27061178	.	C	T	20	6	26	0	1	27	0	0
21	27119465	.	C	T	9	21	30	0	4	34	0	0
21	27119723	.	G	A	13	14	27	0	0	27	0	0
21	27119786	.	G	A	11	10	21	0	0	21	0	0
21	27119945	.	A	T	12	9	21	0	0	21	0	0
21	27122362	.	G	A	14	14	28	0	0	28	0	0
21	27122533	.	G	A	6	7	13	0	0	13	0	0
21	27122560	.	G	A	9	4	13	0	0	13	0	0
21	27122725	.	G	A	5	7	12	0	0	12	0	0
21	27122908	.	C	G	0	13	13	0	6	19	0	0
21	27122920	.	G	A	6	11	17	0	1	18	0	0
21	27123024	.	T	C	5	0	5	0	9	14	0	0
21	27185479	.	T	G	14	9	23	0	1	24	0	0
21	27185545	.	A	G	5	10	15	0	2	17	0	0
21	27189570	.	C	A	9	7	16	0	0	16	0	0
21	27189802	.	G	A	0	19	19	0	10	29	0	0
21	27190033	.	G	A	1	8	9	0	8	17	0	0
21	27190038	.	G	C	9	8	17	0	0	17	0	0
21	27198018	.	T	G	9	9	18	0	0	18	0	0
21	27198159	.	C	T	2	14	16	1	19	36	0	0
21	27198227	.	G	T	16	26	42	1	0	43	0	0
21	27198967	.	A	G	5	2	7	0	1	8	0	0
21	27204648	.	C	T	11	9	20	0	0	20	0	0
21	27204669	.	T	C	9	1	10	0	12	22	0	0
21	27204713	.	T	A	15	15	30	0	1	31	0	0
21	27204747	.	C	T	20	19	39	0	0	39	0	0
21	27204942	.	G	A	16	9	25	0	1	26	0	0
21	27204957	.	G	A	6	12	18	0	1	19	0	0
21	27213101	.	G	A	17	14	31	0	2	33	0	0
21	27213209	.	A	T	17	10	27	0	2	30	1	0
21	27213212	.	A	G	11	15	26	0	1	27	0	0
21	27213287	.	T	A	16	16	32	1	0	33	0	0
21	27221206	.	G	A	10	11	21	0	1	22	0	0
21	27233048	.	C	T	9	3	12	0	0	12	0	0
21	27272878	.	C	T	0	5	5	0	2	7	0	0
21	27272920	.	A	G	2	4	6	0	0	6	0	0
21	27283720	.	G	A	6	7	13	0	0	13	0	0
21	27283782	.	G	A	8	7	15	0	1	16	0	0
21	27286876	.	A	T	5	6	11	0	0	11	0	0
21	27286888	.	A	G	5	5	10	0	0	10	0	0
21	27302868	.	A	G	20	0	20	0	13	33	0	0
21	27302943	.	C	A	18	18	36	0	0	36	0	0
21	27305794	.	C	T	24	16	40	0	1	41	0	0
21	27305972	.	A	G	18	0	18	0	20	38	0	0
21	27306203	.	C	T	24	14	38	0	1	39	0	0
21	27308671	.	C	T	19	19	38	0	1	39	0	0
21	27311230	.	C	T	19	12	31	0	2	33	0	0
21	27311450	.	C	T	16	18	34	0	1	35	0	0
21	27312644	.	A	G	19	14	33	0	0	33	0	0
21	27312950	.	C	T	16	22	38	0	1	39	0	0
21	27328969	.	G	A	2	2	4	0	0	4	0	0
21	27341444	.	C	T	2	6	8	0	0	8	0	0
21	27343637	.	T	C	3	8	11	0	0	11	0	0
21	27344032	.	C	T	6	3	9	0	0	9	0	0
21	27344125	.	T	C	2	5	7	0	0	7	0	0
21	27346260	.	T	C	1	5	6	0	0	6	0	0
21	27347994	.	C	T	3	8	11	0	1	12	0	0
21	27348033	.	A	C	4	7	11	0	0	11	0	0
21	27351007	.	C	T	8	12	20	0	0	20	0	0
21	27353478	.	A	G	8	8	16	0	1	17	0	0
21	27354112	.	A	G	9	14	23	0	0	23	0	0
21	27356981	.	G	A	4	3	7	0	0	7	0	0
21	27357019	.	T	C	2	5	7	0	0	7	0	0
21	27357227	.	T	A	3	2	5	0	2	7	0	0
21	27374812	.	T	C	8	3	11	0	1	12	0	0
21	27375199	.	A	G	12	13	25	0	0	25	0	0
21	27402373	.	T	C	1	2	3	0	0	3	0	0
21	27472057	.	C	T	2	5	7	0	1	8	0	0
21	27476727	.	T	C	2	3	5	0	0	5	0	0
21	27480718	.	C	T	1	2	3	0	0	3	0	0
21	27480789	.	G	A	2	2	4	0	0	4	0	0
21	27482476	.	G	A	1	3	4	0	1	5	0	0
21	27482494	.	T	C	1	3	4	0	1	5	0	0
21	27523079	.	T	C	9	7	16	0	0	16	0	0
21	27526405	.	C	T	7	9	16	0	0	16	0	0
21	27526408	.	C	T	6	10	16	0	0	16	0	0
21	27536471	.	T	C	10	4	14	0	0	14	0	0
21	27543557	.	G	A	10	6	16	0	0	16	0	0
21	27549548	.	G	A	9	10	19	0	1	20	0	0
21	27549667	.	G	A	11	11	22	0	1	23	0	0
21	27549702	.	G	T	9	11	20	0	1	21	0	0
21	27552699	.	C	G	13	6	19	0	1	20	0	0
21	27553372	.	C	A	12	12	24	0	0	24	0	0
21	27554858	.	C	T	9	13	22	0	2	24	0	0
21	27554939	.	G	C	11	8	19	0	0	19	0	0
21	27555051	.	G	T	11	4	15	0	0	15	0	0
21	27555219	.	C	G	1	2	3	0	0	3	0	0
21	27555226	.	A	G	3	0	3	0	3	6	0	0
21	27555331	.	G	A	8	4	12	0	4	16	0	0
21	27578814	.	G	A	1	2	3	0	0	3	0	0
21	27583508	.	A	G	3	2	5	0	0	5	0	0
21	27587025	.	G	A	3	3	6	0	0	6	0	0
21	27587127	.	A	G	2	3	5	0	0	5	0	0
21	27587130	.	T	C	2	0	2	0	3	5	0	0
21	27602850	.	C	T	1	2	3	0	0	3	0	0
21	27602972	.	G	T	6	5	11	0	0	11	0	0
21	27602975	.	C	T	0	6	6	0	5	11	0	0
21	27603360	.	A	G	4	2	6	0	0	6	0	0
21	27606744	.	G	A	3	2	5	0	0	5	0	0
21	27606765	.	G	A	4	3	7	0	0	7	0	0
21	27609562	.	G	A	2	2	4	0	0	4	0	0
21	27611746	.	G	T	1	3	4	0	0	4	0	0
21	27615385	.	A	G	1	2	3	0	0	3	0	0
21	27636438	.	C	T	26	21	47	0	1	48	0	0
21	27636664	.	C	T	3	21	24	4	19	47	0	0
21	27636867	.	C	T	18	11	29	0	1	30	0	0
21	27637171	.	C	T	3	17	20	0	16	36	0	0
21	27637534	.	C	T	23	21	44	0	0	44	0	0
21	27637701	.	G	A	12	18	30	0	2	32	0	0
21	27637729	.	C	A	1	25	26	0	17	43	0	0
21	27669178	.	C	T	1	12	13	0	13	26	0	0
21	27881041	.	G	T	8	9	17	0	2	19	0	0
21	28051224	.	G	T	2	2	4	0	1	5	0	0
21	28076575	.	A	G	2	5	7	0	0	7	0	0
21	28076668	.	G	A	9	6	15	0	1	16	0	0
21	28076770	.	T	C	5	5	10	0	0	10	0	0
21	28089512	.	A	G	1	5	6	0	0	6	0	0
21	28089641	.	G	T	1	4	5	0	0	5	0	0
21	28235035	.	T	C	6	3	9	0	0	9	0	0
21	28235605	.	C	T	4	3	7	0	0	7	0	0
21	28496332	.	C	T	27	40	67	0	0	67	0	0
21	28500394	.	A	G	42	34	76	0	3	79	0	0
21	28502369	.	G	A	10	5	15	0	0	15	0	0
21	28510226	.	C	T	13	15	28	0	0	28	0	0
21	28510258	.	A	G	18	14	32	0	3	35	0	0
21	28512642	.	C	T	15	11	26	0	1	27	0	0
21	28512934	.	A	G	2	5	7	0	0	7	0	0
21	28555214	.	G	T	4	3	7	0	0	7	0	0
21	28555442	.	A	G	3	4	7	0	1	8	0	0
21	28555451	.	C	T	0	1	1	0	7	8	0	0
21	28724148	.	C	T	6	10	16	0	1	17	0	0
21	28793800	.	A	C	3	2	5	0	0	5	0	0
21	28863254	.	A	G	10	4	14	0	3	17	0	0
21	28863810	.	A	G	12	9	21	0	0	21	0	0
21	28863884	.	G	A	10	3	13	0	1	14	0	0
21	28864246	.	G	A	12	13	25	0	4	29	0	0
21	28864475	.	C	T	3	27	30	1	25	56	0	0
21	28901022	.	C	A	2	15	17	0	29	46	0	0
21	28901037	.	G	A	21	15	36	0	2	38	0	0
21	28901078	.	T	C	15	13	28	0	1	29	0	0
21	28920111	.	C	T	2	6	8	0	12	20	0	0
21	29039214	.	C	A	16	11	27	0	0	27	0	0
21	29059819	.	G	A	3	18	21	0	20	41	0	0
21	29062843	.	G	A	1	19	20	0	26	46	0	0
21	29064692	.	T	C	24	23	47	0	2	49	0	0
21	29074438	.	C	G	26	21	47	0	3	50	0	0
21	29074439	.	T	C	29	20	49	0	2	51	0	0
21	29074492	.	A	T	27	25	52	0	1	53	0	0
21	29075235	.	T	G	17	4	21	0	0	21	0	0
21	29075247	.	G	T	15	6	21	0	8	29	0	0
21	29075332	.	G	T	20	23	43	0	1	44	0	0
21	29090757	.	G	A	5	3	8	0	0	8	0	0
21	29090803	.	C	T	1	4	5	0	9	14	0	0
21	29090935	.	C	T	3	10	13	0	12	25	0	0
21	29090984	.	T	G	31	14	45	0	2	47	0	0
21	29091053	.	T	C	21	14	35	0	1	36	0	0
21	29091054	.	G	A	21	14	35	0	1	36	0	0
21	29091362	.	C	G	29	17	46	0	0	46	0	0
21	29092236	.	T	C	2	3	5	0	0	5	0	0
21	29094676	.	T	C	26	1	27	1	22	50	0	0
21	29096390	.	A	T	23	21	44	0	2	47	1	0
21	29096709	.	T	G	18	26	44	0	2	46	0	0
21	29102482	.	T	C	1	3	4	0	0	4	0	0
21	29102494	.	A	T	1	3	4	0	0	4	0	0
21	29106632	.	C	T	1	2	3	0	0	3	0	0
21	29110108	.	A	T	5	4	9	0	0	9	0	0
21	29247636	.	C	T	4	4	8	0	0	8	0	0
21	29975068	.	C	T	0	3	3	1	2	6	0	0
21	30010042	.	T	C	7	10	17	0	1	18	0	0
21	30010146	.	C	T	3	8	11	0	0	11	0	0
21	30010299	.	C	A	6	4	10	0	0	10	0	0
21	30010332	.	G	A	0	7	7	0	6	13	0	0
21	30010462	.	C	T	7	5	12	0	0	12	0	0
21	30014066	.	C	T	4	7	11	0	0	11	0	0
21	30014318	.	C	T	4	11	15	0	0	15	0	0
21	30018856	.	T	C	9	5	14	0	1	15	0	0
21	30019225	.	C	T	6	6	12	0	0	12	0	0
21	30019250	.	C	T	3	7	10	0	0	10	0	0
21	30019385	.	C	G	3	7	10	0	0	10	0	0
21	30019930	.	C	A	2	6	8	0	0	8	0	0
21	30019953	.	A	T	6	3	9	0	0	9	0	0
21	30019992	.	T	C	5	0	5	0	5	10	0	0
21	30020062	.	T	A	5	5	10	0	1	11	0	0
21	30020097	.	A	G	8	5	13	0	0	13	0	0
21	30020123	.	T	G	2	7	9	0	1	10	0	0
21	30025205	.	T	C	4	0	4	0	12	16	0	0
21	30025514	.	G	A	7	6	13	0	1	14	0	0
21	30026162	.	C	T	0	19	19	0	6	25	0	0
21	30031126	.	G	A	6	6	12	0	0	12	0	0
21	30031316	.	G	A	10	6	16	0	3	19	0	0
21	30032045	.	C	T	7	13	20	0	0	20	0	0
21	30032649	.	A	C	2	2	4	0	0	4	0	0
21	30116508	.	G	A	7	8	15	0	1	16	0	0
21	30169705	.	T	C	7	1	8	0	2	10	0	0
21	30181216	.	G	A	8	13	21	0	1	22	0	0
21	30181662	.	T	A	10	6	16	0	2	19	1	0
21	30195389	.	C	T	11	12	23	0	2	25	0	0
21	30201092	.	G	A	19	14	33	0	2	35	0	0
21	30201235	.	C	T	14	10	24	0	2	26	0	0
21	30206393	.	A	T	4	5	9	0	0	9	0	0
21	30208255	.	G	A	0	8	8	0	13	21	0	0
21	30232112	.	T	G	11	15	26	0	1	27	0	0
21	30232187	.	C	T	14	15	29	0	2	32	1	0
21	30232212	.	C	T	10	17	27	0	1	28	0	0
21	30232304	.	C	T	16	14	30	0	0	30	0	0
21	30232307	.	C	T	14	14	28	0	1	29	0	0
21	30236791	.	C	A	3	6	9	0	0	9	0	0
21	30239975	.	A	C	14	18	32	0	0	32	0	0
21	30240378	.	C	A	15	26	41	0	0	42	1	0
21	30240400	.	T	G	16	21	37	0	4	41	0	0
21	30244739	.	G	T	16	15	31	0	2	33	0	0
21	30246684	.	A	G	18	9	27	0	0	27	0	0
21	30253692	.	A	G	18	16	34	0	2	36	0	0
21	30253884	.	A	G	9	13	22	0	0	22	0	0
21	30253942	.	A	C	10	8	18	0	1	19	0	0
21	30253954	.	A	C	7	13	20	0	1	21	0	0
21	30253982	.	T	A	17	5	22	0	1	23	0	0
21	30260961	.	C	T	2	13	15	0	6	21	0	0
21	30273366	.	C	A	6	13	19	0	0	20	1	0
21	30299416	.	T	C	16	18	34	0	1	35	0	0
21	30299561	.	T	C	5	10	15	0	0	15	0	0
21	30299679	.	A	T	3	4	7	0	0	7	0	0
21	30299735	.	C	T	4	4	8	0	1	9	0	0
21	30692796	.	A	G	6	7	13	0	0	13	0	0
21	30692817	.	A	G	8	0	8	0	4	12	0	0
21	30974055	.	A	G	1	2	3	0	0	3	0	0
21	31150943	.	A	T	3	3	6	0	0	6	0	0
21	31151130	.	T	G	9	7	16	0	0	16	0	0
21	31151144	.	G	T	2	10	12	0	11	23	0	0
21	31151264	.	A	C	16	13	29	0	0	29	0	0
21	31160054	.	T	C	14	15	29	0	0	29	0	0
21	31167452	.	T	A	15	12	27	0	0	27	0	0
21	31167528	.	G	T	12	17	29	0	1	30	0	0
21	31176240	.	A	G	8	18	26	0	4	30	0	0
21	31183375	.	G	A	14	16	30	0	4	34	0	0
21	31183501	.	T	C	16	14	30	0	2	32	0	0
21	31183734	.	T	C	15	15	30	0	1	31	0	0
21	31183837	.	A	T	12	13	25	0	0	25	0	0
21	31233389	.	A	G	6	11	17	0	0	17	0	0
21	31233579	.	G	C	12	5	17	0	1	18	0	0
21	31233657	.	G	A	13	10	23	0	2	25	0	0
21	31237428	.	A	G	13	6	19	0	1	20	0	0
21	31237941	.	A	G	8	7	15	0	0	15	0	0
21	31241015	.	T	C	12	11	23	0	0	23	0	0
21	31241079	.	G	C	16	9	25	0	2	27	0	0
21	31253340	.	G	A	3	3	6	0	0	6	0	0
21	31271741	.	T	C	2	3	5	0	0	5	0	0
21	32281076	.	G	A	5	4	9	0	0	9	0	0
21	32281122	.	G	A	8	9	17	0	0	17	0	0
21	32281155	.	G	A	5	13	18	1	0	19	0	0
21	32281680	.	C	T	14	8	22	0	0	22	0	0
21	32283519	.	G	A	17	7	24	0	0	24	0	0
21	32284398	.	A	G	8	3	11	0	0	11	0	0
21	32285135	.	T	C	4	0	4	0	4	8	0	0
21	32285161	.	A	G	3	3	6	0	0	6	0	0
21	32342458	.	G	A	5	2	7	0	1	8	0	0
21	32343230	.	C	A	9	5	14	0	1	15	0	0
21	32343248	.	C	A	11	7	18	0	0	18	0	0
21	32343316	.	T	A	15	16	31	0	1	32	0	0
21	32343453	.	C	T	12	8	20	0	2	22	0	0
21	32343577	.	T	C	6	7	13	0	0	13	0	0
21	32343649	.	C	A	9	7	16	0	1	17	0	0
21	32343721	.	T	G	10	1	11	0	9	20	0	0
21	32344021	.	C	A	5	8	13	0	2	15	0	0
21	32345162	.	T	C	7	8	15	0	0	15	0	0
21	32345318	.	G	A	0	6	6	0	3	9	0	0
21	32345607	.	C	T	9	10	19	0	0	19	0	0
21	32345724	.	A	G	4	8	12	0	0	12	0	0
21	32345749	.	A	G	6	3	9	0	0	9	0	0
21	32345774	.	A	T	6	2	8	0	0	8	0	0
21	32346021	.	A	C	5	3	8	0	0	8	0	0
21	32346273	.	G	A	13	19	32	0	4	36	0	0
21	32346603	.	G	C	20	8	28	0	0	28	0	0
21	32346630	.	T	C	14	14	28	0	1	29	0	0
21	32346674	.	T	A	16	16	32	0	1	33	0	0
21	32346689	.	A	G	20	15	35	1	0	36	0	0
21	32346799	.	G	A	9	15	24	0	1	25	0	0
21	32346800	.	T	A	10	14	24	0	1	25	0	0
21	32346899	.	A	G	19	7	26	0	1	27	0	0
21	32346901	.	A	G	20	6	26	0	1	27	0	0
21	32347134	.	T	A	14	20	34	0	0	34	0	0
21	32347569	.	G	T	12	19	31	0	1	32	0	0
21	32347855	.	T	C	12	12	24	0	0	24	0	0
21	32347966	.	A	C	12	0	12	0	8	20	0	0
21	32348230	.	A	T	9	11	20	0	2	22	0	0
21	32348321	.	C	A	5	4	9	0	0	9	0	0
21	32348449	.	G	A	6	6	12	0	0	12	0	0
21	32348484	.	G	A	6	7	13	0	0	13	0	0
21	32348523	.	G	A	15	7	22	0	0	22	0	0
21	32348600	.	C	T	21	11	32	0	0	32	0	0
21	32348667	.	G	C	16	13	29	0	0	29	0	0
21	32348919	.	C	T	3	15	18	0	6	24	0	0
21	32349000	.	G	A	16	15	31	0	0	31	0	0
21	32349023	.	G	C	16	15	31	0	2	33	0	0
21	32349055	.	C	T	17	13	30	0	1	31	0	0
21	32352459	.	C	G	12	12	24	0	1	25	0	0
21	32353049	.	G	A	9	13	22	0	0	22	0	0
21	32354980	.	A	G	15	12	27	0	0	27	0	0
21	32374460	.	A	T	11	5	16	0	3	19	0	0
21	32457400	.	A	G	1	3	4	0	0	4	0	0
21	32457785	.	T	C	12	9	21	0	0	21	0	0
21	32457931	.	T	G	18	15	33	0	1	34	0	0
21	32457983	.	G	A	19	14	33	0	2	35	0	0
21	32458261	.	A	G	20	20	40	0	2	42	0	0
21	32458315	.	T	A	16	19	35	0	1	36	0	0
21	32460912	.	A	G	20	17	37	0	2	39	0	0
21	32466140	.	G	C	20	26	46	0	2	48	0	0
21	32467660	.	A	G	25	23	48	0	1	49	0	0
21	32467724	.	T	C	29	12	41	0	3	44	0	0
21	32476760	.	A	G	26	26	52	0	1	53	0	0
21	32477584	.	T	C	20	21	41	0	2	43	0	0
21	32477967	.	C	T	25	26	51	1	0	52	0	0
21	32477987	.	A	T	23	27	50	1	9	60	0	0
21	32478227	.	G	T	35	22	57	0	4	61	0	0
21	32482797	.	C	T	32	25	57	0	1	58	0	0
21	32482854	.	T	C	25	4	29	2	23	54	0	0
21	32486997	.	A	T	1	3	4	0	0	4	0	0
21	32680383	.	G	A	1	3	4	0	0	4	0	0
21	32684537	.	A	T	2	2	4	0	0	4	0	0
21	32684538	.	T	A	2	2	4	0	0	4	0	0
21	32757791	.	C	A	8	4	12	0	0	12	0	0
21	32758254	.	G	A	7	7	14	0	1	15	0	0
21	32758351	.	C	T	17	7	24	0	2	26	0	0
21	32758584	.	G	A	21	14	35	0	2	37	0	0
21	32759421	.	C	T	10	11	21	0	2	23	0	0
21	32766389	.	G	A	18	12	30	0	1	31	0	0
21	32772450	.	G	A	10	7	17	0	1	18	0	0
21	33058940	.	G	C	7	6	13	0	1	14	0	0
21	33066214	.	T	G	21	8	29	0	2	31	0	0
21	33069896	.	A	G	15	9	24	0	1	25	0	0
21	33211506	.	T	A	14	9	23	0	0	23	0	0
21	33211568	.	C	T	11	9	20	1	0	21	0	0
21	33211664	.	T	G	10	6	16	1	4	21	0	0
21	33211720	.	A	T	9	5	14	1	0	15	0	0
21	33211809	.	A	T	10	17	27	0	3	30	0	0
21	33213315	.	C	T	10	13	23	0	0	23	0	0
21	33213384	.	G	A	11	6	17	0	0	17	0	0
21	33218312	.	T	C	4	6	10	0	1	11	0	0
21	33218405	.	G	A	8	10	18	0	0	18	0	0
21	33249606	.	T	A	3	2	5	0	0	5	0	0
21	33447251	.	A	G	11	10	21	0	1	22	0	0
21	33463486	.	A	G	11	15	26	0	1	27	0	0
21	33637920	.	T	A	1	3	4	0	0	4	0	0
21	34001982	.	C	T	18	12	30	0	1	31	0	0
21	34002041	.	C	A	11	16	27	0	0	27	0	0
21	34002154	.	A	C	7	10	17	0	0	17	0	0
21	34002155	.	A	T	7	9	16	0	1	17	0	0
21	34002333	.	T	C	3	6	9	0	1	10	0	0
21	34002455	.	G	A	6	4	10	0	0	10	0	0
21	34002507	.	A	G	3	10	13	0	1	14	0	0
21	34031232	.	G	A	2	10	12	0	0	12	0	0
21	34057611	.	T	G	6	5	11	0	1	12	0	0
21	34074618	.	A	G	3	6	9	0	0	9	0	0
21	34074684	.	G	A	3	6	9	0	0	9	0	0
21	34074712	.	T	C	4	5	9	0	0	9	0	0
21	34074978	.	T	A	2	2	4	0	0	4	0	0
21	34075010	.	T	G	0	2	2	0	0	2	0	0
21	34088192	.	C	T	1	3	4	0	0	4	0	0
21	34098006	.	T	C	1	4	5	0	1	6	0	0
21	34098048	.	C	T	2	4	6	0	0	6	0	0
21	34103275	.	G	A	0	4	4	0	6	10	0	0
21	34114058	.	C	A	5	3	8	0	0	8	0	0
21	34128660	.	A	G	18	15	33	0	0	33	0	0
21	34129007	.	C	G	20	0	20	0	17	37	0	0
21	34129073	.	G	C	11	14	25	0	2	27	0	0
21	34129195	.	G	T	9	18	27	0	1	28	0	0
21	34129279	.	A	G	9	17	26	0	1	27	0	0
21	34129629	.	A	G	2	2	4	0	0	4	0	0
21	34195790	.	T	C	2	3	5	0	0	5	0	0
21	34199704	.	T	C	3	5	8	0	0	8	0	0
21	34211093	.	G	A	2	5	7	0	10	17	0	0
21	34364472	.	T	A	15	11	26	0	2	28	0	0
21	34364595	.	G	A	11	11	22	0	0	22	0	0
21	34365167	.	T	A	13	12	25	0	1	26	0	0
21	34391104	.	C	T	10	10	20	0	2	22	0	0
21	34391155	.	T	C	10	10	20	0	0	20	0	0
21	34392843	.	C	T	8	10	18	0	0	18	0	0
21	34424086	.	C	T	2	6	8	0	13	21	0	0
21	34424116	.	A	G	11	9	20	0	2	22	0	0
21	34428080	.	G	A	11	8	19	0	0	19	0	0
21	34430533	.	A	G	6	10	16	0	0	16	0	0
21	34430544	.	A	G	5	10	15	0	0	15	0	0
21	36425071	.	C	T	5	1	6	0	1	7	0	0
21	36515083	.	A	G	1	5	6	0	0	6	0	0
21	38013631	.	T	C	5	9	14	0	0	14	0	0
21	38013707	.	T	C	1	2	3	0	0	3	0	0
21	38587378	.	T	C	11	13	24	0	2	26	0	0
21	39569373	.	T	G	5	2	7	0	21	28	0	0
21	40354884	.	A	G	7	2	9	0	0	9	0	0
21	40354894	.	A	T	6	2	8	0	0	8	0	0
21	40355102	.	G	A	2	2	4	0	0	4	0	0
21	40355113	.	A	G	2	4	6	0	0	6	0	0
21	40355226	.	G	A	5	5	10	0	1	11	0	0
21	40355844	.	A	T	7	10	17	0	0	17	0	0
21	40355886	.	T	G	9	8	17	0	1	19	1	0
21	40355968	.	T	A	12	9	21	0	0	21	0	0
21	40356104	.	T	C	5	1	6	0	9	15	0	0
21	40364758	.	C	A	8	8	16	0	1	17	0	0
21	40365359	.	A	T	10	11	21	0	1	22	0	0
21	40365404	.	G	A	9	7	16	0	1	17	0	0
21	40369108	.	C	T	0	5	5	0	4	9	0	0
21	40373086	.	A	T	5	13	18	0	1	19	0	0
21	40373137	.	C	T	1	7	8	0	11	19	0	0
21	40373200	.	A	C	10	5	15	0	0	15	0	0
21	40373283	.	C	G	7	6	13	0	1	14	0	0
21	40373320	.	A	T	9	4	13	0	1	14	0	0
21	40376536	.	G	A	6	2	8	0	0	8	0	0
21	40377861	.	A	G	5	6	11	0	1	12	0	0
21	40377895	.	A	G	4	6	10	0	0	10	0	0
21	40377904	.	G	A	5	5	10	0	0	10	0	0
21	40381967	.	C	T	5	3	8	0	1	9	0	0
21	40382278	.	C	T	0	4	4	0	3	7	0	0
21	40384140	.	A	G	4	3	7	0	0	7	0	0
21	40386112	.	G	A	2	4	6	0	0	6	0	0
21	40386127	.	G	A	2	3	5	0	0	5	0	0
21	40402659	.	A	G	4	3	7	0	0	7	0	0
21	40403423	.	A	G	12	15	27	0	1	28	0	0
21	40403581	.	G	C	9	10	19	0	1	20	0	0
21	40406485	.	A	T	6	11	17	0	0	17	0	0
21	40406796	.	C	A	10	3	13	0	0	13	0	0
21	40410983	.	T	A	3	11	14	0	1	15	0	0
21	40411034	.	G	A	11	4	15	0	1	16	0	0
21	40411061	.	C	T	11	4	15	0	0	15	0	0
21	40452357	.	T	C	2	5	7	0	1	8	0	0
21	40466539	.	A	G	5	0	5	0	6	11	0	0
21	40466711	.	G	A	0	4	4	0	5	9	0	0
21	40466893	.	C	T	7	6	13	0	0	13	0	0
21	40467039	.	C	T	6	5	11	0	0	11	0	0
21	40467126	.	G	A	0	2	2	0	5	7	0	0
21	40474875	.	G	A	5	6	11	0	1	12	0	0
21	40475579	.	G	T	9	7	16	0	1	17	0	0
21	40475643	.	T	C	4	4	8	0	1	9	0	0
21	40530901	.	A	G	7	21	28	0	1	29	0	0
21	40531217	.	A	T	4	10	14	0	2	16	0	0
21	40531240	.	C	T	2	9	11	0	9	20	0	0
21	40531316	.	C	T	12	15	27	0	1	28	0	0
21	40531615	.	G	A	12	15	27	0	1	28	0	0
21	40531971	.	A	T	7	6	13	0	0	13	0	0
21	40531993	.	G	A	9	6	15	0	2	17	0	0
21	40532139	.	A	T	9	7	16	0	0	16	0	0
21	40532147	.	A	G	9	6	15	0	0	15	0	0
21	40532204	.	A	G	7	6	13	0	0	13	0	0
21	40532206	.	T	C	6	5	11	0	1	12	0	0
21	40532312	.	A	G	3	5	8	0	0	8	0	0
21	40532368	.	T	C	7	5	12	0	0	12	0	0
21	40532545	.	T	C	4	5	9	0	0	9	0	0
21	40532662	.	T	C	11	0	11	0	6	17	0	0
21	40532665	.	T	C	9	5	14	0	0	14	0	0
21	40532848	.	G	A	8	11	19	0	1	20	0	0
21	40532886	.	T	C	3	12	15	0	0	15	0	0
21	40532989	.	A	G	8	6	14	0	1	15	0	0
21	40532990	.	T	A	9	5	14	0	1	15	0	0
21	40533076	.	C	T	0	6	6	0	4	10	0	0
21	40533165	.	A	G	7	13	20	0	0	20	0	0
21	40533313	.	C	T	8	9	17	0	3	20	0	0
21	40533456	.	A	G	8	15	23	0	0	23	0	0
21	40537188	.	A	G	10	17	27	0	1	28	0	0
21	40546922	.	T	C	9	13	22	0	1	23	0	0
21	40547729	.	G	A	7	16	23	0	0	23	0	0
21	40553288	.	A	G	7	10	17	1	1	19	0	0
21	40553497	.	G	A	6	12	18	0	1	19	0	0
21	40553547	.	C	T	0	8	8	0	9	17	0	0
21	40562600	.	G	A	3	5	8	0	0	8	0	0
21	40579746	.	C	A	1	6	7	0	0	7	0	0
21	40671163	.	C	T	1	2	3	0	0	3	0	0
21	40671169	.	G	A	2	2	4	0	0	4	0	0
21	40673148	.	A	T	1	2	3	0	0	3	0	0
21	40673203	.	G	A	4	5	9	0	0	9	0	0
21	40675007	.	C	T	3	2	5	0	0	5	0	0
21	40685948	.	A	G	6	0	6	0	14	20	0	0
21	40685964	.	A	C	6	16	22	0	0	22	0	0
21	40685990	.	C	A	5	10	15	0	0	15	0	0
21	40686010	.	G	C	6	4	10	0	0	10	0	0
21	40686109	.	G	A	14	9	23	0	0	23	0	0
21	40686158	.	T	A	13	8	21	0	0	21	0	0
21	40686170	.	T	A	13	9	22	0	0	22	0	0
21	40691452	.	G	A	10	11	21	0	1	22	0	0
21	40691464	.	G	A	12	11	23	0	1	24	0	0
21	40703190	.	C	T	16	10	26	0	1	27	0	0
21	40703402	.	A	C	4	14	18	0	2	20	0	0
21	40703445	.	G	A	1	13	14	0	5	19	0	0
21	40708974	.	T	A	15	12	27	0	0	27	0	0
21	40708978	.	C	A	15	13	28	0	0	28	0	0
21	40717637	.	G	C	8	4	12	0	2	14	0	0
21	40731131	.	A	C	7	5	12	0	0	12	0	0
21	40808525	.	C	G	1	2	3	0	0	3	0	0
21	40820946	.	C	A	3	2	5	0	0	5	0	0
21	40930179	.	G	A	10	7	17	0	1	18	0	0
21	40930400	.	C	A	4	6	10	0	2	12	0	0
21	40930430	.	C	G	5	9	14	0	1	15	0	0
21	40930469	.	T	C	7	4	11	0	1	12	0	0
21	40930528	.	C	A	7	8	15	0	0	15	0	0
21	40930650	.	T	A	9	7	16	0	0	16	0	0
21	40930651	.	G	A	9	7	16	0	0	16	0	0
21	40931215	.	A	G	9	10	19	0	1	20	0	0
21	40931236	.	T	C	13	0	13	0	10	23	0	0
21	40932888	.	T	A	4	10	14	0	1	15	0	0
21	40934586	.	G	A	13	6	19	0	0	19	0	0
21	40934703	.	T	C	13	0	13	0	8	21	0	0
21	40936544	.	G	A	5	10	15	0	2	17	0	0
21	40936548	.	A	G	11	6	17	0	0	17	0	0
21	40944590	.	A	C	1	2	3	0	0	3	0	0
21	41029033	.	A	C	5	4	9	0	0	9	0	0
21	41029378	.	A	G	6	2	8	0	1	9	0	0
21	41034863	.	A	G	3	4	7	0	0	7	0	0
21	41046647	.	T	A	5	9	14	0	0	14	0	0
21	41046745	.	T	A	2	6	8	0	1	9	0	0
21	41046746	.	G	C	3	5	8	0	1	9	0	0
21	41049488	.	A	G	4	3	7	0	0	7	0	0
21	41060822	.	C	A	0	2	2	0	1	3	0	0
21	41060855	.	T	C	2	2	4	0	0	4	0	0
21	41256821	.	C	T	1	12	13	0	9	22	0	0
21	41257136	.	A	G	34	19	53	1	1	55	0	0
21	41257157	.	C	G	29	17	46	0	2	48	0	0
21	41257228	.	T	G	33	23	56	0	1	57	0	0
21	41257256	.	T	C	33	26	59	0	1	60	0	0
21	41257357	.	G	A	29	36	65	0	1	66	0	0
21	41257374	.	C	T	33	35	68	0	3	71	0	0
21	41257599	.	T	A	29	31	60	0	3	63	0	0
21	41293435	.	G	A	27	31	58	0	2	60	0	0
21	41305128	.	G	T	23	29	52	0	4	56	0	0
21	41305269	.	C	T	30	19	49	1	1	51	0	0
21	41305271	.	C	T	21	23	44	1	6	51	0	0
21	41311605	.	A	G	17	16	33	0	0	33	0	0
21	41311922	.	G	A	13	16	29	0	1	30	0	0
21	41312058	.	A	T	17	14	31	0	0	31	0	0
21	41312822	.	C	G	18	23	41	1	7	49	0	0
21	41313042	.	A	G	19	14	33	0	4	37	0	0
21	41313124	.	G	A	19	21	40	0	1	41	0	0
21	41313216	.	G	A	18	22	40	0	0	40	0	0
21	41313257	.	T	C	19	18	37	0	2	39	0	0
21	41316974	.	C	T	16	19	35	0	1	36	0	0
21	41323551	.	C	T	3	16	19	0	15	34	0	0
21	41598942	.	G	C	12	7	19	0	1	20	0	0
21	41598961	.	T	C	18	0	18	0	7	25	0	0
21	41599060	.	T	C	10	15	25	3	2	30	0	0
21	41599096	.	A	C	17	3	20	1	0	21	0	0
21	41599147	.	G	A	16	6	22	1	1	24	0	0
21	41600360	.	T	C	3	7	10	0	0	10	0	0
21	42046839	.	T	A	9	17	26	5	0	31	0	0
21	42046969	.	G	A	13	8	21	40	1	62	0	0
21	42198228	.	T	C	4	2	6	0	1	7	0	0
21	42778557	.	G	C	2	0	2	0	1	3	0	0
21	42779096	.	C	T	1	5	6	0	0	6	0	0
21	42971463	.	T	C	26	15	41	0	15	56	0	0
21	43032249	.	T	G	4	3	7	0	13	20	0	0
21	43032261	.	T	G	10	4	14	0	8	22	0	0
21	43420701	.	T	C	4	0	4	0	6	10	0	0
21	43461082	.	T	C	9	4	13	0	0	13	0	0
21	43476276	.	T	C	23	9	32	0	3	35	0	0
21	44037040	.	G	A	1	10	11	0	0	11	0	0
21	45117413	.	A	G	7	4	11	3	1	15	0	0
21	45117422	.	A	G	8	3	11	0	1	12	0	0
21	45352211	.	G	A	11	13	24	0	2	26	0	0
21	45352212	.	G	A	10	13	23	0	3	26	0	0
21	45374370	.	T	C	2	11	13	0	0	13	0	0
21	45374928	.	A	G	16	8	24	0	0	24	0	0
21	45716030	.	T	C	6	2	8	0	0	8	0	0
21	45768787	.	A	T	2	3	5	0	0	5	0	0
22	337121	.	A	C	6	2	8	0	21	29	0	0
22	337127	.	A	C	9	2	11	0	18	29	0	0
22	583118	.	A	G	10	4	14	0	0	14	0	0
22	724757	.	T	C	2	18	20	7	7	34	0	0
22	912563	.	T	C	1	2	3	0	0	3	0	0
22	1392902	.	G	C	1	2	3	0	0	3	0	0
22	1944993	.	G	C	2	2	4	0	0	4	0	0
22	1959918	.	G	A	1	4	5	1	0	6	0	0
22	1960440	.	T	C	2	4	6	1	0	7	0	0
22	1960491	.	G	T	2	2	4	2	0	6	0	0
22	2147047	.	C	G	2	4	6	0	0	6	0	0
22	2373984	.	C	T	7	2	9	2	0	11	0	0
22	2411925	.	G	A	1	2	3	0	0	3	0	0
22	2444441	.	A	G	3	4	7	0	2	9	0	0
22	2444477	.	A	G	2	2	4	0	0	4	0	0
22	4747456	.	C	A	3	5	8	0	0	8	0	0
22	4767534	.	C	T	1	10	11	0	0	11	0	0
22	4957729	.	C	T	1	2	3	0	0	3	0	0
22	4962472	.	T	A	1	7	8	0	0	8	0	0
22	4962559	.	G	A	10	10	20	0	3	23	0	0
22	4962610	.	A	T	15	10	25	0	1	26	0	0
22	4962635	.	A	G	11	13	24	0	1	25	0	0
22	4962878	.	G	A	15	21	36	0	0	36	0	0
22	4968955	.	A	G	16	20	36	3	0	40	1	0
22	4969051	.	G	A	14	16	30	0	0	30	0	0
22	4970773	.	T	C	13	0	13	0	18	31	0	0
22	4970797	.	G	C	13	17	30	0	1	31	0	0
22	4972848	.	T	G	11	11	22	0	3	25	0	0
22	4972980	.	C	T	1	13	14	0	19	33	0	0
22	4975236	.	T	A	11	15	26	0	5	31	0	0
22	4977106	.	G	A	10	8	18	0	2	20	0	0
22	4985831	.	G	C	8	5	13	0	0	13	0	0
22	4985888	.	T	C	8	1	9	0	3	12	0	0
22	5056425	.	G	T	11	5	16	0	1	17	0	0
22	5056760	.	T	G	15	12	27	0	0	27	0	0
22	5056978	.	A	T	9	11	20	0	0	20	0	0
22	5057443	.	T	C	5	0	5	0	11	16	0	0
22	5057489	.	T	A	9	3	12	0	1	13	0	0
22	5057504	.	T	A	8	2	10	0	1	11	0	0
22	5059916	.	A	G	12	12	24	0	1	25	0	0
22	5060087	.	T	G	8	8	16	0	1	17	0	0
22	5060162	.	T	A	11	8	19	0	1	20	0	0
22	5062457	.	G	A	3	7	10	0	0	10	0	0
22	5075291	.	T	C	9	5	14	1	0	15	0	0
22	5075390	.	A	G	10	6	16	0	1	17	0	0
22	5075673	.	A	G	5	5	10	0	1	11	0	0
22	5075732	.	T	C	9	8	17	0	0	17	0	0
22	5087451	.	G	A	9	4	13	1	0	14	0	0
22	5087488	.	G	A	13	8	21	0	1	22	0	0
22	5090115	.	C	A	2	10	12	0	11	23	0	0
22	5098433	.	G	T	9	16	25	0	1	26	0	0
22	5103769	.	G	A	4	2	6	0	1	7	0	0
22	5109554	.	G	A	26	26	52	0	2	54	0	0
22	5109560	.	T	A	28	24	52	0	2	54	0	0
22	5112644	.	G	T	27	21	48	0	2	50	0	0
22	5112749	.	T	C	23	21	44	0	2	46	0	0
22	5112864	.	G	A	21	22	43	0	1	44	0	0
22	5112915	.	A	C	26	24	50	0	0	50	0	0
22	5114380	.	G	C	4	32	36	0	24	60	0	0
22	5116267	.	A	C	16	12	28	0	4	32	0	0
22	5118373	.	A	G	1	0	1	0	2	3	0	0
22	5118378	.	G	A	2	3	5	0	1	6	0	0
22	5118437	.	C	T	3	10	13	0	0	13	0	0
22	5121464	.	C	T	7	8	15	0	1	16	0	0
22	5121471	.	C	T	7	7	14	0	0	14	0	0
22	5121623	.	A	G	11	0	11	0	8	19	0	0
22	5135241	.	T	A	7	5	12	0	0	12	0	0
22	5140122	.	A	G	3	5	8	0	1	9	0	0
22	5140750	.	G	A	5	3	8	0	0	8	0	0
22	5144566	.	G	C	7	8	15	0	0	15	0	0
22	5144645	.	C	T	11	11	22	0	0	22	0	0
22	5144750	.	T	A	5	3	8	0	1	9	0	0
22	5144981	.	T	C	8	8	16	0	1	17	0	0
22	5145109	.	C	A	2	7	9	0	0	9	0	0
22	5145199	.	C	G	5	2	7	0	0	7	0	0
22	5228744	.	G	A	3	7	10	7	10	27	0	0
22	5229048	.	G	A	3	6	9	1	0	10	0	0
22	5229151	.	A	G	2	4	6	0	1	7	0	0
22	5229377	.	G	A	1	4	5	2	1	8	0	0
22	5230339	.	A	G	13	7	20	5	1	26	0	0
22	5230977	.	A	C	10	4	14	2	2	18	0	0
22	5909268	.	T	C	1	3	4	0	0	4	0	0
22	5911801	.	A	T	1	2	3	0	0	3	0	0
22	5911804	.	G	A	1	1	2	0	0	2	0	0
22	5928433	.	T	C	1	0	1	0	2	3	0	0
22	6075115	.	T	C	4	3	7	0	0	7	0	0
22	6075315	.	T	C	6	2	8	0	0	8	0	0
22	6077657	.	T	C	2	0	2	0	8	10	0	0
22	6077906	.	C	G	9	3	12	0	0	12	0	0
22	6078213	.	C	T	9	5	14	0	0	14	0	0
22	6078223	.	C	A	5	9	14	0	0	14	0	0
22	6078255	.	T	C	7	3	10	0	0	10	0	0
22	6078260	.	G	C	8	3	11	0	0	11	0	0
22	6184087	.	T	A	1	2	3	0	0	3	0	0
22	6353420	.	C	T	2	2	4	1	0	5	0	0
22	6353425	.	G	A	2	3	5	1	0	6	0	0
22	6353494	.	G	T	0	4	4	0	0	4	0	0
22	6528059	.	A	T	7	7	14	0	1	15	0	0
22	6528151	.	T	C	5	4	9	0	0	9	0	0
22	6528177	.	C	T	0	3	3	0	5	8	0	0
22	6528313	.	T	C	8	0	8	0	4	12	0	0
22	6528586	.	C	T	3	3	6	0	0	6	0	0
22	6528746	.	A	G	8	3	11	0	1	12	0	0
22	6546796	.	G	A	1	3	4	0	1	5	0	0
22	6546800	.	T	C	2	2	4	0	0	4	0	0
22	6546937	.	T	A	3	2	5	0	0	5	0	0
22	6547014	.	G	A	3	3	6	0	0	6	0	0
22	6547309	.	C	T	6	4	10	0	0	10	0	0
22	6548057	.	G	A	2	4	6	0	0	6	0	0
22	6548072	.	G	A	4	4	8	0	0	8	0	0
22	6548408	.	C	T	4	5	9	0	0	9	0	0
22	6548425	.	A	G	4	3	7	0	0	7	0	0
22	6765599	.	G	A	2	2	4	0	0	4	0	0
22	6953850	.	T	A	1	2	3	0	0	3	0	0
22	6956643	.	C	T	1	2	3	0	0	3	0	0
22	6956664	.	G	A	2	2	4	0	0	4	0	0
22	6996116	.	T	C	7	0	7	0	4	11	0	0
22	6996343	.	G	A	12	13	25	0	0	25	0	0
22	6998904	.	A	G	20	14	34	0	0	34	0	0
22	6998949	.	G	T	11	14	25	0	0	25	0	0
22	6998988	.	T	C	15	17	32	0	0	32	0	0
22	6999006	.	A	G	18	15	33	0	1	34	0	0
22	6999060	.	G	C	17	0	17	0	7	24	0	0
22	6999148	.	T	A	11	6	17	0	4	21	0	0
22	7001474	.	G	T	12	11	23	0	0	23	0	0
22	7001528	.	C	T	10	5	15	0	1	16	0	0
22	7001827	.	G	A	8	9	17	0	0	17	0	0
22	7003603	.	A	G	7	4	11	0	0	11	0	0
22	7006913	.	T	C	2	0	2	0	4	6	0	0
22	7009333	.	A	T	14	11	25	0	2	27	0	0
22	7009393	.	A	G	11	9	20	2	2	24	0	0
22	7009833	.	C	T	10	9	19	0	1	20	0	0
22	7009835	.	T	G	11	9	20	0	0	20	0	0
22	7009911	.	A	G	11	8	19	0	0	19	0	0
22	7009915	.	C	T	2	9	11	0	11	22	0	0
22	7010011	.	A	C	27	17	44	0	2	46	0	0
22	7010100	.	T	C	24	0	24	0	19	43	0	0
22	7010151	.	T	C	16	20	36	0	1	37	0	0
22	7012898	.	C	T	2	14	16	0	15	31	0	0
22	7012931	.	C	G	19	14	33	0	1	34	0	0
22	7016655	.	A	G	15	15	30	0	2	32	0	0
22	7018223	.	G	A	13	8	21	0	1	22	0	0
22	7019397	.	C	A	2	15	17	0	17	34	0	0
22	7019701	.	T	A	19	8	27	0	2	29	0	0
22	7044634	.	C	G	9	4	13	0	0	13	0	0
22	7044667	.	T	G	8	7	15	0	0	15	0	0
22	7044681	.	T	C	6	4	10	0	3	13	0	0
22	7045031	.	G	A	14	9	23	0	0	23	0	0
22	7045041	.	C	A	13	7	20	0	0	20	0	0
22	7045070	.	C	T	10	3	13	0	0	13	0	0
22	7045215	.	A	G	10	10	20	0	1	21	0	0
22	7056645	.	C	T	7	16	23	0	3	26	0	0
22	7128829	.	C	T	0	2	2	0	2	4	0	0
22	7129007	.	A	G	1	3	4	0	0	4	0	0
22	7129212	.	G	C	6	3	9	0	0	9	0	0
22	7359844	.	T	C	2	8	10	0	1	11	0	0
22	7522830	.	C	T	3	2	5	0	0	5	0	0
22	7526865	.	G	A	3	3	6	0	0	6	0	0
22	7528153	.	C	T	0	5	5	0	3	8	0	0
22	7529580	.	T	C	1	2	3	0	0	3	0	0
22	7529586	.	A	G	1	2	3	0	0	3	0	0
22	7542756	.	A	T	3	3	6	0	0	6	0	0
22	7542777	.	T	A	4	3	7	0	0	7	0	0
22	7556580	.	A	G	2	4	6	0	0	6	0	0
22	7558367	.	G	T	4	2	6	0	0	6	0	0
22	7558375	.	C	T	0	2	2	0	5	7	0	0
22	7558417	.	C	T	6	2	8	0	1	9	0	0
22	7558430	.	T	A	5	2	7	0	0	7	0	0
22	7636988	.	T	A	2	2	4	0	0	4	0	0
22	7676984	.	G	T	2	5	7	3	0	10	0	0
22	7677717	.	A	G	4	2	6	0	0	6	0	0
22	7683668	.	A	T	11	5	16	2	1	19	0	0
22	7683828	.	T	G	2	7	9	0	1	10	0	0
22	7683921	.	T	C	7	5	12	1	0	13	0	0
22	7700005	.	T	G	4	3	7	0	0	7	0	0
22	7972113	.	T	G	1	2	3	0	0	3	0	0
22	7972792	.	A	G	3	5	8	3	0	11	0	0
22	7974164	.	C	A	2	8	10	1	0	11	0	0
22	7974302	.	C	G	2	2	4	1	1	6	0	0
22	8074068	.	G	T	6	3	9	1	1	11	0	0
22	8074093	.	T	A	7	5	12	1	0	13	0	0
22	8161183	.	A	C	11	9	20	0	0	20	0	0
22	8163863	.	T	C	3	0	3	0	9	12	0	0
22	8163993	.	G	T	7	10	17	0	1	18	0	0
22	8164035	.	C	T	2	9	11	0	2	13	0	0
22	8243579	.	C	T	1	3	4	0	3	7	0	0
22	8296588	.	T	G	10	4	14	0	0	14	0	0
22	8296594	.	A	C	10	4	14	0	0	14	0	0
22	8296714	.	C	T	5	4	9	0	1	10	0	0
22	8296763	.	G	T	6	5	11	0	0	11	0	0
22	8328718	.	T	C	1	3	4	2	0	6	0	0
22	8328719	.	G	A	1	3	4	2	0	6	0	0
22	8339943	.	T	G	1	2	3	0	0	3	0	0
22	8339944	.	T	A	1	2	3	0	0	3	0	0
22	8341740	.	T	C	4	2	6	0	0	6	0	0
22	8341919	.	T	A	9	3	12	0	2	14	0	0
22	8341943	.	C	T	8	6	14	0	1	15	0	0
22	8342408	.	C	T	6	3	9	0	0	9	0	0
22	8342409	.	A	G	6	3	9	0	0	9	0	0
22	8347393	.	C	T	1	5	6	0	0	6	0	0
22	8351152	.	T	C	1	0	1	0	7	8	0	0
22	8351214	.	T	C	2	4	6	0	0	6	0	0
22	8351215	.	G	A	2	4	6	0	0	6	0	0
22	8351272	.	C	T	0	3	3	0	5	8	0	0
22	8638075	.	A	G	1	3	4	0	1	5	0	0
22	8638089	.	C	T	1	2	3	0	0	3	0	0
22	8714436	.	C	T	1	3	4	0	0	4	0	0
22	8714656	.	A	G	1	3	4	0	1	5	0	0
22	8715470	.	A	T	3	2	5	0	0	5	0	0
22	8719170	.	T	C	1	2	3	2	0	5	0	0
22	8720236	.	A	G	1	3	4	0	0	4	0	0
22	8720240	.	T	C	1	3	4	0	0	4	0	0
22	8775160	.	C	G	1	0	1	0	3	4	0	0
22	8784059	.	T	C	4	2	6	0	0	6	0	0
22	8784305	.	G	T	3	3	6	1	0	7	0	0
22	8784446	.	A	T	1	3	4	0	0	4	0	0
22	8784521	.	T	A	3	4	7	0	0	7	0	0
22	8784522	.	G	T	3	4	7	0	0	7	0	0
22	8785016	.	T	C	2	3	5	0	0	5	0	0
22	8785223	.	G	A	2	4	6	1	0	7	0	0
22	8785647	.	T	C	2	4	6	0	0	6	0	0
22	8785832	.	G	T	6	5	11	0	0	11	0	0
22	8785853	.	C	T	3	2	5	0	1	6	0	0
22	8785914	.	C	T	4	2	6	0	1	7	0	0
22	8786056	.	T	G	3	5	8	0	0	8	0	0
22	8786060	.	C	T	3	6	9	0	0	9	0	0
22	8786177	.	A	G	2	4	6	0	0	6	0	0
22	8786178	.	G	T	2	4	6	0	0	6	0	0
22	8787001	.	A	T	1	5	6	0	0	6	0	0
22	8787194	.	T	A	3	3	6	0	1	7	0	0
22	8787335	.	G	C	1	4	5	0	3	8	0	0
22	8787382	.	T	G	3	3	6	1	0	7	0	0
22	8787384	.	C	T	3	3	6	1	0	7	0	0
22	8787704	.	A	C	5	3	8	0	1	9	0	0
22	8787891	.	G	A	2	1	3	0	1	4	0	0
22	8787898	.	T	C	1	2	3	0	1	4	0	0
22	8788036	.	G	A	1	2	3	0	0	3	0	0
22	8995847	.	A	C	17	4	21	0	1	22	0	0
22	8995871	.	G	A	17	5	22	0	0	22	0	0
22	9006104	.	T	C	1	2	3	0	0	3	0	0
22	9034743	.	C	G	3	14	17	1	1	19	0	0
22	9034756	.	A	G	3	13	16	1	0	17	0	0
22	9043624	.	T	C	2	2	4	0	0	4	0	0
22	9043651	.	C	A	1	2	3	0	0	3	0	0
22	9065238	.	T	C	3	3	6	0	0	6	0	0
22	9065259	.	C	G	1	0	1	0	3	4	0	0
22	9065277	.	A	C	2	3	5	0	0	5	0	0
22	9164747	.	G	A	1	4	5	0	0	5	0	0
22	9472870	.	T	C	2	3	5	0	0	5	0	0
22	9472873	.	T	C	3	3	6	0	0	6	0	0
22	9483293	.	C	T	9	10	19	0	1	20	0	0
22	9484355	.	T	C	6	11	17	0	2	19	0	0
22	9489885	.	A	G	6	7	13	1	2	16	0	0
22	9490730	.	C	T	8	13	21	0	0	21	0	0
22	9494144	.	A	G	13	10	23	0	1	24	0	0
22	9496453	.	C	T	5	12	17	0	1	18	0	0
22	9496608	.	A	G	9	10	19	0	0	19	0	0
22	9496766	.	T	C	7	9	16	0	0	16	0	0
22	9496781	.	C	A	8	10	18	0	0	18	0	0
22	9496933	.	T	A	10	10	20	0	1	21	0	0
22	9496954	.	G	A	0	8	8	0	14	22	0	0
22	9499564	.	C	T	14	11	25	0	1	26	0	0
22	9499579	.	C	G	13	0	13	0	10	23	0	0
22	9499762	.	T	C	9	10	19	0	1	20	0	0
22	9508704	.	T	G	13	21	34	0	2	36	0	0
22	9509637	.	G	A	1	15	16	0	12	28	0	0
22	9512565	.	A	C	20	23	43	0	1	44	0	0
22	9512628	.	T	C	22	18	40	0	1	41	0	0
22	9512630	.	T	C	24	18	42	0	0	42	0	0
22	9512670	.	C	T	17	17	34	0	2	36	0	0
22	9512717	.	C	T	10	13	23	3	0	26	0	0
22	9512731	.	T	A	11	10	21	3	0	24	0	0
22	9512829	.	A	G	2	12	14	0	0	14	0	0
22	9512885	.	T	G	7	3	10	0	1	11	0	0
22	9513039	.	C	T	12	9	21	0	1	22	0	0
22	9513048	.	T	C	13	10	23	0	1	24	0	0
22	9523557	.	A	T	4	7	11	0	1	12	0	0
22	9523618	.	A	G	5	11	16	0	0	16	0	0
22	9525415	.	C	T	3	8	11	0	2	13	0	0
22	9526254	.	T	G	3	6	9	0	1	10	0	0
22	9526389	.	C	T	8	9	17	0	0	17	0	0
22	9527373	.	T	C	4	9	13	0	0	13	0	0
22	9527409	.	T	C	7	12	19	0	1	20	0	0
22	9527439	.	G	T	5	13	18	0	1	19	0	0
22	9527450	.	C	G	6	13	19	0	0	19	0	0
22	9527983	.	A	G	4	10	14	0	0	14	0	0
22	9530328	.	T	C	6	9	15	0	1	16	0	0
22	9530388	.	C	T	11	6	17	0	0	17	0	0
22	9530418	.	A	G	9	0	9	0	10	19	0	0
22	9530571	.	T	C	8	6	14	0	1	15	0	0
22	9530598	.	G	A	8	10	18	0	0	18	0	0
22	9532339	.	C	T	8	5	13	0	0	13	0	0
22	9532431	.	G	A	11	11	22	0	1	23	0	0
22	9532455	.	T	C	9	11	20	0	0	20	0	0
22	9534066	.	C	T	12	13	25	0	0	25	0	0
22	9534138	.	C	T	15	13	28	0	0	28	0	0
22	9535191	.	T	C	14	14	28	0	0	28	0	0
22	9535290	.	C	T	6	11	17	0	1	18	0	0
22	9535890	.	T	C	7	11	18	0	0	18	0	0
22	9535914	.	G	A	11	11	22	0	0	22	0	0
22	9536134	.	G	A	1	17	18	0	8	26	0	0
22	9536984	.	C	T	11	10	21	0	2	23	0	0
22	9537165	.	A	G	9	17	26	0	1	27	0	0
22	9537186	.	T	C	9	15	24	0	1	25	0	0
22	9537267	.	T	C	11	16	27	0	0	27	0	0
22	9537339	.	C	T	8	19	27	0	1	28	0	0
22	9537637	.	T	C	9	24	33	0	1	34	0	0
22	9537640	.	T	C	7	24	31	0	1	32	0	0
22	9537779	.	A	G	12	0	12	0	8	20	0	0
22	9537859	.	C	T	7	8	15	0	2	17	0	0
22	9537918	.	A	T	7	0	7	0	1	8	0	0
22	9537920	.	T	A	9	0	9	0	0	9	0	0
22	9824674	.	T	G	2	3	5	0	1	6	0	0
22	9824788	.	A	G	1	2	3	0	0	3	0	0
22	9826434	.	G	A	1	2	3	0	0	3	0	0
22	9828560	.	A	T	1	1	2	0	1	3	0	0
22	9828598	.	C	G	1	3	4	0	0	4	0	0
22	9828607	.	G	T	1	3	4	0	0	4	0	0
22	9835039	.	C	T	2	4	6	0	1	7	0	0
22	9835189	.	T	C	3	3	6	0	2	8	0	0
22	9835894	.	A	C	2	0	2	0	3	5	0	0
22	9835951	.	A	G	1	3	4	0	0	4	0	0
22	9836274	.	T	A	3	3	6	0	0	6	0	0
22	9836301	.	G	C	3	4	7	0	0	7	0	0
22	9836312	.	C	A	1	4	5	0	2	7	0	0
22	9858748	.	G	T	1	4	5	1	0	6	0	0
22	9862962	.	T	C	1	3	4	0	0	4	0	0
22	9863145	.	C	T	3	2	5	0	0	5	0	0
22	9877621	.	A	C	14	3	17	0	0	17	0	0
22	9877637	.	A	T	13	3	16	0	0	16	0	0
22	9877900	.	G	T	15	3	18	0	1	19	0	0
22	9877902	.	C	T	13	3	16	0	1	17	0	0
22	9888366	.	G	A	1	3	4	1	0	5	0	0
22	9888379	.	C	T	0	5	5	1	2	8	0	0
22	9893357	.	A	T	4	6	10	1	0	11	0	0
22	9893360	.	T	C	3	7	10	1	0	11	0	0
22	9893688	.	G	A	1	7	8	0	0	8	0	0
22	9893706	.	T	C	1	4	5	0	0	5	0	0
22	9893729	.	T	G	1	2	3	4	0	7	0	0
22	9894327	.	G	T	2	3	5	0	0	5	0	0
22	9894340	.	T	G	1	3	4	0	0	4	0	0
22	9898031	.	A	G	1	8	9	0	0	9	0	0
22	9898052	.	A	G	2	7	9	0	0	9	0	0
22	9898190	.	A	C	3	5	8	1	0	9	0	0
22	9898259	.	C	A	3	6	9	0	0	9	0	0
22	9898277	.	C	T	0	5	5	1	2	8	0	0
22	9898355	.	C	T	2	3	5	0	0	5	0	0
22	9898445	.	G	A	3	3	6	1	0	7	0	0
22	9899279	.	A	G	3	2	5	2	0	7	0	0
22	9899453	.	T	C	3	3	6	1	0	7	0	0
22	9899717	.	T	C	2	2	4	3	0	7	0	0
22	9904646	.	A	G	6	2	8	1	0	9	0	0
22	9904652	.	C	G	4	3	7	1	0	8	0	0
22	9926204	.	A	G	1	3	4	0	0	4	0	0
22	9926449	.	T	C	3	5	8	0	0	8	0	0
22	9926475	.	A	G	6	2	8	0	0	8	0	0
22	9926532	.	C	G	5	2	7	0	0	7	0	0
22	9930064	.	G	T	1	3	4	7	0	11	0	0
22	9932947	.	C	G	5	3	8	0	0	8	0	0
22	9933972	.	C	T	2	4	6	0	0	6	0	0
22	9952898	.	C	A	1	2	3	0	0	3	0	0
22	10019568	.	C	T	1	5	6	0	0	6	0	0
22	10019712	.	A	G	3	4	7	0	1	8	0	0
22	10019742	.	T	C	1	0	1	0	4	5	0	0
22	10038686	.	A	G	2	2	4	0	0	4	0	0
22	10038690	.	G	A	2	2	4	0	0	4	0	0
22	10039417	.	G	A	2	3	5	0	0	5	0	0
22	10039678	.	G	A	2	4	6	0	0	6	0	0
22	10039889	.	G	T	3	2	5	0	0	5	0	0
22	10039901	.	A	G	0	2	2	0	0	2	0	0
22	10040000	.	G	A	2	2	4	0	0	4	0	0
22	10040015	.	C	T	0	2	2	0	2	4	0	0
22	10040135	.	T	C	1	4	5	0	0	5	0	0
22	10040273	.	T	C	1	3	4	0	0	4	0	0
22	10048389	.	G	T	1	2	3	0	0	3	0	0
22	10049217	.	C	T	1	2	3	0	0	3	0	0
22	10049504	.	G	A	1	2	3	0	0	3	0	0
22	10071117	.	G	A	2	4	6	0	1	7	0	0
22	10123910	.	G	C	7	10	17	0	0	17	0	0
22	10123962	.	T	C	8	0	8	0	9	17	0	0
22	10123998	.	C	T	1	7	8	0	17	25	0	0
22	10129878	.	A	G	9	8	17	0	0	17	0	0
22	10159001	.	C	T	7	4	11	0	0	11	0	0
22	10159339	.	C	T	5	14	19	0	2	21	0	0
22	10162958	.	A	T	12	7	19	0	0	19	0	0
22	10168219	.	T	C	4	7	11	0	0	11	0	0
22	10184031	.	G	T	6	7	13	0	0	13	0	0
22	10188095	.	C	T	6	10	16	0	0	16	0	0
22	10196297	.	A	T	15	10	25	0	1	26	0	0
22	10196330	.	C	T	12	7	19	1	0	20	0	0
22	10196394	.	G	A	0	10	10	0	18	28	0	0
22	10196468	.	A	T	7	9	16	0	0	16	0	0
22	10196483	.	A	G	7	8	15	0	0	15	0	0
22	10196621	.	C	A	14	8	22	0	1	23	0	0
22	10196634	.	C	T	12	8	20	0	3	23	0	0
22	10196864	.	G	A	16	12	28	2	2	32	0	0
22	10196951	.	C	A	8	22	30	0	1	31	0	0
22	10197061	.	C	T	5	13	18	0	2	20	0	0
22	10197100	.	T	G	14	4	18	0	0	18	0	0
22	10197146	.	C	T	11	16	27	0	1	28	0	0
22	10197246	.	G	A	1	17	18	1	14	33	0	0
22	10197796	.	G	C	3	10	13	0	11	24	0	0
22	10198075	.	T	G	13	0	13	0	6	19	0	0
22	10198120	.	A	T	9	5	14	0	1	15	0	0
22	10198167	.	G	A	14	5	19	0	2	21	0	0
22	10198178	.	A	T	14	5	19	0	1	20	0	0
22	10198211	.	T	C	15	6	21	0	0	21	0	0
22	10198232	.	T	A	13	5	18	0	0	18	0	0
22	10198283	.	T	C	12	8	20	0	0	20	0	0
22	10198335	.	A	C	18	13	31	0	1	32	0	0
22	10198399	.	T	A	18	15	33	0	1	34	0	0
22	10198737	.	G	A	12	13	25	0	0	25	0	0
22	10198779	.	G	C	7	4	11	0	1	12	0	0
22	10201858	.	G	C	1	6	7	0	7	14	0	0
22	10201888	.	G	A	19	19	38	0	3	41	0	0
22	10201906	.	G	A	0	25	25	0	27	52	0	0
22	10205736	.	C	T	15	22	37	0	2	39	0	0
22	10207978	.	A	T	22	27	49	0	0	49	0	0
22	10208011	.	T	C	20	25	45	0	0	45	0	0
22	10208032	.	A	C	17	18	35	0	1	36	0	0
22	10208089	.	C	T	23	16	39	0	1	40	0	0
22	10208101	.	T	G	18	26	44	0	1	45	0	0
22	10208134	.	G	A	18	27	45	0	2	47	0	0
22	10208182	.	C	T	21	26	47	0	1	48	0	0
22	10208404	.	C	T	19	22	41	0	0	41	0	0
22	10210467	.	T	C	18	15	33	0	2	35	0	0
22	10211754	.	C	T	23	22	45	0	2	47	0	0
22	10212089	.	C	T	26	22	48	0	0	48	0	0
22	10212161	.	A	C	30	27	57	0	2	59	0	0
22	10212230	.	C	G	24	22	46	0	1	47	0	0
22	10212417	.	T	A	10	11	21	0	0	21	0	0
22	10215007	.	T	C	4	2	6	0	0	6	0	0
22	10215008	.	G	A	4	2	6	0	0	6	0	0
22	10220257	.	C	T	7	4	11	0	0	11	0	0
22	10220259	.	T	C	6	4	10	0	1	11	0	0
22	10220298	.	A	T	11	4	15	0	0	15	0	0
22	10220444	.	G	T	2	17	19	0	8	27	0	0
22	10220451	.	C	T	18	10	28	0	0	28	0	0
22	10260078	.	A	G	6	9	15	0	1	16	0	0
22	10260468	.	A	G	7	0	7	0	7	14	0	0
22	10260774	.	C	T	11	12	23	0	0	23	0	0
22	10260828	.	C	T	5	7	12	0	1	13	0	0
22	10261037	.	C	T	5	4	9	0	1	10	0	0
22	10261792	.	T	A	8	6	14	0	0	14	0	0
22	10261840	.	T	C	10	7	17	0	0	17	0	0
22	10261888	.	C	T	8	8	16	0	0	16	0	0
22	10261945	.	A	C	12	15	27	0	0	27	0	0
22	10262216	.	A	T	3	15	18	0	0	18	0	0
22	10361324	.	T	C	4	5	9	0	1	10	0	0
22	10361385	.	C	G	5	3	8	0	1	9	0	0
22	10361391	.	T	C	5	5	10	0	1	11	0	0
22	10361577	.	G	C	9	0	9	0	11	20	0	0
22	10361787	.	C	G	8	8	16	0	0	16	0	0
22	10361889	.	A	G	8	10	18	0	0	18	0	0
22	10361892	.	A	G	9	9	18	0	1	19	0	0
22	10361937	.	C	T	2	8	10	0	7	17	0	0
22	10361964	.	T	C	8	0	8	0	9	17	0	0
22	10362003	.	T	G	10	11	21	0	0	21	0	0
22	10362174	.	C	T	2	10	12	0	12	24	0	0
22	10364681	.	A	G	9	3	12	0	0	12	0	0
22	10372847	.	C	T	1	16	17	0	8	25	0	0
22	10372950	.	A	C	8	0	8	0	8	16	0	0
22	10373081	.	T	C	6	0	6	0	8	14	0	0
22	10373118	.	A	T	4	6	10	0	1	11	0	0
22	10373263	.	G	T	12	4	16	0	0	16	0	0
22	10373795	.	A	T	5	4	9	0	0	9	0	0
22	10373849	.	G	A	7	4	11	0	0	11	0	0
22	10373879	.	C	A	5	3	8	0	0	8	0	0
22	10373915	.	T	C	4	2	6	0	2	8	0	0
22	10373931	.	T	A	4	5	9	0	0	9	0	0
22	10383159	.	A	G	4	5	9	0	1	10	0	0
22	10390824	.	G	C	2	2	4	0	0	4	0	0
22	10391347	.	C	T	5	5	10	0	1	11	0	0
22	10393045	.	C	T	2	6	8	0	0	8	0	0
22	10396692	.	G	A	2	5	7	0	0	7	0	0
22	10397610	.	G	T	4	8	12	0	0	12	0	0
22	10430183	.	C	A	1	3	4	0	4	8	0	0
22	10430189	.	A	G	3	3	6	0	0	6	0	0
22	10430252	.	A	G	5	3	8	0	0	8	0	0
22	10430572	.	G	A	1	5	6	0	0	6	0	0
22	10430709	.	T	C	3	2	5	0	0	5	0	0
22	10434709	.	T	A	2	4	6	0	0	6	0	0
22	10434738	.	C	A	3	3	6	0	0	6	0	0
22	10435101	.	T	C	2	0	2	0	3	5	0	0
22	10435233	.	A	T	3	2	5	0	0	5	0	0
22	10435236	.	T	G	2	3	5	0	0	5	0	0
22	10435268	.	C	T	3	2	5	0	0	5	0	0
22	10437205	.	T	C	1	0	1	0	3	4	0	0
22	10514154	.	T	A	3	6	9	0	0	9	0	0
22	10514288	.	G	T	6	5	11	0	0	11	0	0
22	10514303	.	G	C	3	0	3	0	5	8	0	0
22	10516864	.	T	A	3	3	6	0	0	6	0	0
22	10517499	.	T	C	1	0	1	0	2	3	0	0
22	10517505	.	A	C	1	0	1	0	2	3	0	0
22	10545227	.	T	C	5	2	7	0	0	7	0	0
22	10545308	.	A	G	3	0	3	0	2	5	0	0
22	11144573	.	T	C	4	2	6	0	0	6	0	0
22	11154693	.	C	T	2	2	4	0	0	4	0	0
22	13047020	.	T	C	5	2	7	0	0	7	0	0
22	13977910	.	T	G	4	4	8	0	0	8	0	0
22	13978228	.	T	C	8	8	16	0	0	16	0	0
22	13978465	.	A	G	10	0	10	0	10	20	0	0
22	13978480	.	T	C	10	9	19	0	0	19	0	0
22	13978849	.	C	T	6	8	14	0	0	14	0	0
22	13979314	.	A	C	6	2	8	1	0	9	0	0
22	14061054	.	C	T	3	2	5	0	0	5	0	0
22	14061069	.	G	T	2	2	4	0	0	4	0	0
22	14068658	.	G	A	0	2	2	0	4	6	0	0
22	14068766	.	G	C	0	3	3	0	4	7	0	0
22	14069234	.	T	G	4	0	4	0	3	7	0	0
22	14072862	.	C	T	1	4	5	0	0	5	0	0
22	14076954	.	G	A	10	9	19	0	0	19	0	0
22	14077017	.	A	G	5	3	8	0	0	8	0	0
22	14077029	.	T	C	3	2	5	0	0	5	0	0
22	14078027	.	C	T	9	6	15	0	2	17	0	0
22	14083209	.	T	C	9	8	17	0	1	18	0	0
22	14083218	.	A	G	11	0	11	0	8	19	0	0
22	14083532	.	T	C	6	10	16	0	2	18	0	0
22	14083823	.	T	C	3	2	5	0	0	5	0	0
22	14124381	.	C	T	16	28	44	0	1	46	1	0
22	14124465	.	G	A	13	17	30	0	1	31	0	0
22	14124655	.	C	T	14	21	35	0	0	35	0	0
22	14125440	.	T	A	7	8	15	0	0	15	0	0
22	14366222	.	G	A	6	6	12	0	0	12	0	0
22	14380352	.	G	A	3	3	6	0	0	6	0	0
22	14381780	.	A	T	4	4	8	0	0	8	0	0
22	14381812	.	G	T	1	5	6	0	0	6	0	0
22	14390142	.	C	T	4	3	7	0	0	7	0	0
22	14398645	.	G	A	8	5	13	0	0	13	0	0
22	14402487	.	T	A	3	2	5	0	0	5	0	0
22	14402488	.	G	A	3	2	5	0	0	5	0	0
22	14404788	.	C	A	3	2	5	0	0	5	0	0
22	14416459	.	T	C	3	3	6	0	0	6	0	0
22	14422533	.	A	T	5	6	11	0	0	11	0	0
22	14427749	.	G	A	2	6	8	0	0	8	0	0
22	14445860	.	G	C	2	0	2	0	4	6	0	0
22	14458857	.	T	A	4	2	6	0	0	6	0	0
22	14459518	.	A	G	1	2	3	0	0	3	0	0
22	14495905	.	G	A	2	3	5	0	0	5	0	0
22	14495941	.	C	T	1	2	3	0	0	3	0	0
22	14507952	.	A	G	3	2	5	0	0	5	0	0
22	14557666	.	T	C	4	2	6	0	1	7	0	0
22	14850790	.	T	A	4	3	7	0	0	7	0	0
22	15009192	.	C	T	1	2	3	0	0	3	0	0
22	15010604	.	C	A	5	4	9	0	0	9	0	0
22	15257085	.	G	C	2	1	3	0	0	3	0	0
22	15257137	.	A	T	1	2	3	0	0	3	0	0
22	15345339	.	T	A	7	5	12	0	0	12	0	0
22	15384695	.	T	C	10	0	10	0	9	19	0	0
22	15384759	.	A	T	4	7	11	0	0	11	0	0
22	15385143	.	T	A	1	5	6	0	0	6	0	0
22	15385422	.	A	G	3	3	6	0	1	7	0	0
22	15464100	.	C	T	2	2	4	0	0	4	0	0
22	15501248	.	T	C	1	4	5	0	0	5	0	0
22	15541277	.	C	T	3	4	7	0	1	8	0	0
22	15543490	.	C	T	10	3	13	0	0	13	0	0
22	15545930	.	T	A	10	8	18	0	1	19	0	0
22	15548150	.	C	T	4	14	18	0	1	19	0	0
22	15593456	.	C	G	2	4	6	1	0	7	0	0
22	15593466	.	A	T	3	2	5	1	0	6	0	0
22	15628710	.	G	A	5	3	8	0	0	8	0	0
22	15628909	.	C	A	5	2	7	0	1	8	0	0
22	15629043	.	G	A	1	3	4	0	0	4	0	0
22	15629667	.	G	A	1	4	5	0	0	5	0	0
22	15629686	.	T	C	1	8	9	0	0	9	0	0
22	15629923	.	C	T	5	3	8	0	0	8	0	0
22	15630115	.	T	G	3	0	3	0	5	8	0	0
22	15696007	.	A	G	20	21	41	0	3	44	0	0
22	15696026	.	A	G	28	21	49	0	2	51	0	0
22	15696191	.	T	G	32	22	54	0	1	55	0	0
22	15700157	.	C	T	0	20	20	0	11	31	0	0
22	15701561	.	G	A	23	15	38	0	0	38	0	0
22	15701636	.	A	G	21	25	46	0	0	47	1	0
22	15704622	.	C	T	19	20	39	0	2	41	0	0
22	15719625	.	T	A	14	14	28	0	1	29	0	0
22	15719672	.	G	T	19	10	29	0	1	30	0	0
22	15719682	.	G	A	19	9	28	0	2	30	0	0
22	15719891	.	T	C	11	15	26	0	2	28	0	0
22	15720199	.	A	G	11	10	21	0	0	21	0	0
22	15720200	.	C	A	2	9	11	0	10	22	1	0
22	15720250	.	T	G	14	15	29	0	1	30	0	0
22	15720583	.	C	T	2	6	8	0	0	8	0	0
22	15721436	.	C	T	20	14	34	0	1	35	0	0
22	15721443	.	C	T	14	16	30	0	0	30	0	0
22	15721558	.	C	G	4	7	11	0	1	13	1	0
22	15900745	.	T	C	6	4	10	0	0	10	0	0
22	15900812	.	T	C	5	3	8	0	1	9	0	0
22	15912259	.	A	G	7	10	17	0	1	18	0	0
22	15912298	.	C	T	7	10	17	0	2	19	0	0
22	15912346	.	C	T	1	10	11	0	12	23	0	0
22	15915908	.	G	A	1	2	3	0	0	3	0	0
22	15917855	.	G	A	11	10	21	0	3	24	0	0
22	15929136	.	A	G	12	15	27	0	1	28	0	0
22	15932428	.	C	A	10	8	18	0	1	19	0	0
22	15943833	.	G	A	8	10	18	0	1	19	0	0
22	15950504	.	A	G	3	5	8	0	0	8	0	0
22	15979490	.	T	G	2	3	5	0	0	5	0	0
22	15979650	.	G	A	0	3	3	0	5	8	0	0
22	15979776	.	A	G	1	4	5	0	0	5	0	0
22	15979827	.	C	T	2	3	5	0	0	5	0	0
22	15987966	.	A	T	1	4	5	0	0	5	0	0
22	15996502	.	T	C	3	4	7	0	1	8	0	0
22	15996726	.	G	A	4	4	8	0	0	8	0	0
22	16000383	.	C	T	2	2	4	0	1	5	0	0
22	16002106	.	C	T	4	7	11	0	2	13	0	0
22	16002121	.	C	G	8	0	8	0	4	12	0	0
22	16002161	.	T	C	7	5	12	0	0	12	0	0
22	16002397	.	C	T	4	4	8	0	0	8	0	0
22	16003382	.	G	A	7	4	11	0	0	11	0	0
22	16027778	.	T	C	5	2	7	0	0	7	0	0
22	16027809	.	T	C	1	2	3	0	0	3	0	0
22	16032205	.	G	A	5	2	7	0	0	7	0	0
22	16032550	.	T	G	7	5	12	0	0	12	0	0
22	16033259	.	T	C	3	8	11	0	0	11	0	0
22	16033622	.	G	T	4	8	12	0	1	13	0	0
22	16038660	.	G	A	9	10	19	0	0	19	0	0
22	16038749	.	A	G	17	9	26	0	0	26	0	0
22	16038858	.	T	G	11	10	21	0	0	21	0	0
22	16039194	.	C	A	16	17	33	0	0	33	0	0
22	16039398	.	A	C	11	12	23	0	1	24	0	0
22	16039806	.	T	C	5	0	5	0	16	21	0	0
22	16040007	.	T	C	5	16	21	0	0	21	0	0
22	16097243	.	G	A	6	5	11	0	0	11	0	0
22	16097261	.	T	G	8	4	12	0	1	13	0	0
22	16097286	.	T	C	9	2	11	0	0	11	0	0
22	16097296	.	T	G	5	0	5	0	2	7	0	0
22	16112012	.	T	A	4	2	6	0	1	7	0	0
22	16112039	.	G	A	0	3	3	0	5	8	0	0
22	16120828	.	A	G	3	2	5	0	0	5	0	0
22	16121035	.	T	A	6	4	10	0	0	10	0	0
22	16121157	.	C	A	4	6	10	0	0	10	0	0
22	16121281	.	C	A	4	4	8	0	0	8	0	0
22	16123437	.	T	G	11	9	20	0	1	21	0	0
22	16123931	.	A	G	5	5	10	0	0	10	0	0
22	16144846	.	G	T	4	4	8	0	2	10	0	0
22	16171544	.	C	A	1	2	3	0	0	3	0	0
22	16171715	.	A	C	4	2	6	0	1	7	0	0
22	16171869	.	G	A	9	5	14	0	3	17	0	0
22	16171871	.	A	G	11	6	17	0	0	17	0	0
22	16173329	.	A	G	6	12	18	0	0	18	0	0
22	16173380	.	T	G	2	7	9	0	1	10	0	0
22	16173921	.	A	G	3	9	12	0	0	12	0	0
22	16174191	.	A	G	6	2	8	0	1	9	0	0
22	16174400	.	T	A	5	2	7	0	2	9	0	0
22	16175977	.	C	T	6	4	10	0	0	10	0	0
22	16176220	.	T	C	1	2	3	0	0	3	0	0
22	16176229	.	T	G	1	2	3	0	0	3	0	0
22	16176975	.	G	T	2	2	4	0	0	4	0	0
22	16177026	.	C	T	2	3	5	0	0	5	0	0
22	16177033	.	G	T	1	3	4	0	0	4	0	0
22	16177174	.	G	C	4	3	7	0	0	7	0	0
22	16177749	.	C	T	4	2	6	0	0	6	0	0
22	16177938	.	T	C	4	0	4	0	4	8	0	0
22	16179913	.	C	T	1	4	5	0	0	5	0	0
22	16191841	.	T	C	4	0	4	0	7	11	0	0
22	16191845	.	T	G	7	6	13	0	0	13	0	0
22	16191912	.	C	A	2	3	5	0	7	12	0	0
22	16191920	.	T	A	9	3	12	0	0	12	0	0
22	16192903	.	G	A	3	3	6	0	0	6	0	0
22	16192905	.	C	T	0	3	3	0	3	6	0	0
22	16193024	.	T	C	2	0	2	0	5	7	0	0
22	16193420	.	T	A	2	3	5	0	1	6	0	0
22	16193673	.	G	T	1	2	3	0	0	3	0	0
22	16201599	.	C	T	1	2	3	0	1	4	0	0
22	16201632	.	G	A	3	2	5	0	0	5	0	0
22	16217912	.	C	T	0	2	2	0	5	7	0	0
22	16219762	.	G	A	1	2	3	0	0	3	0	0
22	16270437	.	G	A	3	2	5	0	0	5	0	0
22	16270441	.	T	A	3	2	5	0	0	5	0	0
22	16282323	.	A	T	1	4	5	0	0	5	0	0
22	16282335	.	A	G	1	6	7	0	0	7	0	0
22	16282571	.	T	A	11	5	16	0	0	16	0	0
22	16282636	.	T	G	10	10	20	0	0	20	0	0
22	16282757	.	C	G	0	12	12	0	5	17	0	0
22	16285578	.	G	A	11	3	14	0	0	14	0	0
22	16287499	.	T	G	4	4	8	0	0	8	0	0
22	16287608	.	T	G	7	6	13	0	0	13	0	0
22	16287659	.	C	T	0	4	4	0	5	9	0	0
22	16290698	.	G	A	4	6	10	0	0	10	0	0
22	16290869	.	T	A	2	5	7	0	0	7	0	0
22	16290906	.	G	A	3	6	9	0	0	9	0	0
22	16298535	.	G	T	0	4	4	0	6	10	0	0
22	16298666	.	T	C	6	6	12	0	0	12	0	0
22	16298720	.	A	C	8	10	18	0	0	18	0	0
22	16298756	.	C	T	7	13	20	0	0	20	0	0
22	16302465	.	C	T	3	5	8	0	0	8	0	0
22	16302468	.	C	T	3	6	9	0	0	9	0	0
22	16302877	.	A	T	7	4	11	0	2	13	0	0
22	16302922	.	A	G	8	4	12	0	0	12	0	0
22	16305098	.	C	A	8	3	11	0	0	11	0	0
22	16305164	.	A	C	10	7	17	0	0	17	0	0
22	16305673	.	G	A	3	3	6	0	0	6	0	0
22	16310925	.	T	C	1	2	3	0	0	3	0	0
22	16312222	.	T	G	3	3	6	0	0	6	0	0
22	16312228	.	A	G	3	3	6	0	1	7	0	0
22	16312278	.	C	T	3	5	8	0	1	9	0	0
22	16312399	.	A	G	5	4	9	0	0	9	0	0
22	16312755	.	T	C	1	3	4	0	0	4	0	0
22	16312783	.	C	T	0	5	5	0	2	7	0	0
22	16313005	.	T	A	3	3	6	0	0	6	0	0
22	16313559	.	G	A	3	2	5	0	1	6	0	0
22	16333111	.	G	T	2	2	4	0	0	4	0	0
22	16333126	.	C	T	2	2	4	0	0	4	0	0
22	16345485	.	A	G	3	4	7	0	0	7	0	0
22	16345630	.	C	T	4	2	6	0	0	6	0	0
22	16345668	.	C	A	2	3	5	0	0	5	0	0
22	16350811	.	T	G	18	22	40	0	1	41	0	0
22	16351199	.	C	G	20	15	35	0	3	38	0	0
22	16351204	.	C	T	0	13	13	0	20	33	0	0
22	16351317	.	G	A	4	6	10	0	1	11	0	0
22	16351353	.	G	A	6	3	9	0	0	9	0	0
22	16351404	.	C	T	7	3	10	0	1	11	0	0
22	16351490	.	T	G	10	11	21	0	0	21	0	0
22	16351552	.	A	T	4	5	9	0	1	10	0	0
22	16352146	.	G	T	1	2	3	0	0	3	0	0
22	16352154	.	C	G	2	3	5	0	0	5	0	0
22	16352215	.	A	G	11	5	16	0	0	16	0	0
22	16352349	.	A	G	17	11	28	0	1	29	0	0
22	16352463	.	C	A	2	13	15	0	17	32	0	0
22	16352469	.	A	G	19	12	31	0	1	32	0	0
22	16352528	.	G	A	14	10	24	0	0	24	0	0
22	16352668	.	T	C	13	0	13	0	17	30	0	0
22	16352739	.	C	T	3	16	19	0	16	35	0	0
22	16355013	.	A	C	25	11	36	0	0	36	0	0
22	16355042	.	C	A	21	10	31	0	1	32	0	0
22	16355555	.	A	G	11	12	23	0	0	23	0	0
22	16357818	.	A	G	15	11	26	0	1	27	0	0
22	16357831	.	A	G	16	12	28	0	1	29	0	0
22	16357867	.	G	A	17	13	30	0	1	31	0	0
22	16367007	.	T	C	7	0	7	0	10	17	0	0
22	16367055	.	A	G	9	9	18	0	0	18	0	0
22	16368886	.	G	A	13	11	24	0	0	24	0	0
22	16377364	.	A	G	11	15	26	0	1	27	0	0
22	16377863	.	C	T	1	3	4	0	4	8	0	0
22	16410600	.	A	G	3	2	5	0	0	5	0	0
22	16412514	.	C	T	0	2	2	0	2	4	0	0
22	16422166	.	A	G	13	0	13	0	8	21	0	0
22	16424576	.	T	C	12	8	20	0	0	20	0	0
22	16430672	.	C	T	14	5	19	0	0	19	0	0
22	16432627	.	C	T	14	22	36	0	0	36	0	0
22	16432628	.	A	T	13	21	34	0	1	35	0	0
22	16433078	.	G	A	11	15	26	0	1	27	0	0
22	16433096	.	A	G	9	20	29	0	0	29	0	0
22	16433131	.	T	G	15	19	34	0	1	35	0	0
22	16433250	.	G	A	8	9	17	0	1	18	0	0
22	16433394	.	G	A	7	11	18	0	2	20	0	0
22	16433422	.	A	G	7	10	17	0	0	17	0	0
22	16433912	.	T	A	11	8	19	0	1	20	0	0
22	16433940	.	C	T	11	13	24	0	1	25	0	0
22	16434056	.	G	A	20	14	34	0	1	35	0	0
22	16438112	.	A	C	20	21	41	0	4	45	0	0
22	16440086	.	T	C	15	1	16	0	20	36	0	0
22	16464063	.	G	C	2	2	4	0	0	4	0	0
22	16484621	.	G	A	10	11	21	0	2	23	0	0
22	16484877	.	A	T	7	14	21	0	2	23	0	0
22	16484938	.	A	G	7	17	24	0	1	25	0	0
22	16484944	.	T	C	8	18	26	0	0	26	0	0
22	16485035	.	A	G	8	8	16	0	1	18	1	0
22	16485538	.	T	C	14	0	14	0	9	23	0	0
22	16485563	.	A	T	11	5	16	0	1	17	0	0
22	16485625	.	A	G	3	2	5	0	0	5	0	0
22	16485688	.	G	A	6	4	10	0	1	11	0	0
22	16485920	.	G	A	13	4	17	0	0	17	0	0
22	16485954	.	C	T	10	8	18	0	1	19	0	0
22	16485962	.	C	G	9	4	13	0	3	16	0	0
22	16485994	.	C	A	3	10	13	0	0	13	0	0
22	16486004	.	C	A	1	11	12	0	2	14	0	0
22	16486112	.	T	C	10	18	28	0	0	28	0	0
22	16491693	.	G	A	21	14	35	0	0	35	0	0
22	16491720	.	T	C	19	0	19	0	14	33	0	0
22	16491942	.	G	A	16	18	34	0	0	34	0	0
22	16492000	.	T	A	12	15	27	0	0	27	0	0
22	16497953	.	G	A	17	11	28	0	0	28	0	0
22	16498155	.	G	C	1	12	13	0	17	30	0	0
22	16498317	.	A	G	12	17	29	0	1	30	0	0
22	16498661	.	A	G	15	0	15	0	13	28	0	0
22	16537701	.	C	T	2	3	5	0	1	6	0	0
22	16543627	.	C	T	13	17	30	0	0	30	0	0
22	16543714	.	T	C	15	10	25	0	0	25	0	0
22	16544186	.	A	G	6	5	11	0	0	11	0	0
22	16544243	.	C	T	5	6	11	0	0	11	0	0
22	16544260	.	C	T	7	5	12	1	0	13	0	0
22	16544319	.	A	G	6	4	10	4	0	14	0	0
22	16544384	.	G	A	8	7	15	0	1	16	0	0
22	16544400	.	T	G	8	8	16	0	0	16	0	0
22	16544599	.	A	G	19	0	19	0	14	33	0	0
22	16544674	.	T	G	22	18	40	0	0	40	0	0
22	16544780	.	A	T	10	11	21	0	0	21	0	0
22	16544800	.	G	A	10	7	17	0	2	19	0	0
22	16569862	.	C	T	12	9	21	0	1	22	0	0
22	16584241	.	C	G	14	19	33	0	1	34	0	0
22	16592011	.	A	G	16	9	25	0	1	26	0	0
22	16592029	.	C	G	1	13	14	0	15	29	0	0
22	16594870	.	T	A	7	10	17	0	1	18	0	0
22	16595022	.	A	G	14	6	20	0	0	20	0	0
22	16601400	.	C	T	13	5	18	0	0	18	0	0
22	16609449	.	T	C	13	14	27	0	5	32	0	0
22	16609494	.	G	A	17	10	27	0	1	28	0	0
22	16614011	.	C	T	7	5	12	0	1	13	0	0
22	16759111	.	G	A	11	4	15	0	0	15	0	0
22	16775306	.	C	T	14	11	25	0	0	25	0	0
22	16840292	.	T	C	6	4	10	0	0	10	0	0
22	18966298	.	T	C	2	3	5	0	0	5	0	0
22	18966421	.	G	A	2	5	7	0	0	7	0	0
22	18971667	.	T	C	2	4	6	0	1	7	0	0
22	18971697	.	T	C	3	5	8	0	0	8	0	0
22	18971725	.	T	C	6	2	8	0	1	9	0	0
22	19006676	.	A	G	3	12	15	0	0	15	0	0
22	19006763	.	T	C	8	9	17	0	0	17	0	0
22	19006994	.	T	C	14	8	22	0	1	23	0	0
22	19007574	.	A	G	11	10	21	0	0	21	0	0
22	19007677	.	C	A	15	7	22	1	1	24	0	0
22	19007764	.	A	G	8	3	11	0	1	12	0	0
22	19074484	.	T	A	1	3	4	0	0	4	0	0
22	19099044	.	T	C	2	0	2	0	3	5	0	0
22	19547501	.	A	T	11	8	19	0	0	19	0	0
22	19547573	.	C	G	1	16	17	0	13	30	0	0
22	19547575	.	A	C	12	0	12	0	17	29	0	0
22	19547796	.	C	T	15	11	26	0	3	29	0	0
22	19552745	.	C	T	10	13	23	0	1	24	0	0
22	19642960	.	T	A	2	4	6	0	0	6	0	0
22	19645155	.	G	A	3	7	10	0	0	10	0	0
22	19645170	.	G	A	3	6	9	0	0	9	0	0
22	19645233	.	T	C	6	4	10	0	0	10	0	0
22	19645464	.	A	G	4	0	4	0	8	12	0	0
22	19645673	.	C	G	2	0	2	0	5	7	0	0
22	19645802	.	G	A	7	3	10	0	0	10	0	0
22	19665618	.	C	T	16	9	25	0	1	26	0	0
22	19671776	.	A	G	20	10	30	0	0	30	0	0
22	20011558	.	T	C	3	3	6	0	0	6	0	0
22	20105123	.	C	G	6	2	8	0	0	8	0	0
22	20105242	.	A	G	3	3	6	0	0	6	0	0
22	20105500	.	G	A	6	4	10	0	0	10	0	0
22	20139410	.	C	T	1	4	5	0	1	6	0	0
22	20139777	.	C	A	0	2	2	0	1	3	0	0
22	20141195	.	G	A	1	2	3	0	0	3	0	0
22	20141539	.	C	G	2	3	5	0	0	5	0	0
22	20141551	.	C	A	2	2	4	0	0	4	0	0
22	20141632	.	T	C	4	2	6	0	0	6	0	0
22	20141635	.	C	A	4	1	5	0	0	5	0	0
22	20142160	.	T	C	3	7	10	0	0	10	0	0
22	20142178	.	A	T	2	5	7	0	0	7	0	0
22	20142226	.	C	G	3	4	7	0	0	7	0	0
22	20142261	.	A	G	4	3	7	0	0	7	0	0
22	20142321	.	G	A	4	2	6	0	1	7	0	0
22	20142373	.	A	T	7	3	10	0	0	10	0	0
22	20142378	.	T	A	6	3	9	0	0	9	0	0
22	20142713	.	C	T	2	7	9	0	1	10	0	0
22	20142723	.	A	T	4	9	13	0	0	13	0	0
22	20142753	.	T	A	5	4	9	0	0	9	0	0
22	20142772	.	T	G	7	2	9	0	0	9	0	0
22	20143002	.	G	T	2	6	8	0	0	8	0	0
22	20143138	.	A	G	3	2	5	0	0	5	0	0
22	20143143	.	G	T	3	2	5	0	0	5	0	0
22	20159200	.	A	C	15	10	25	0	1	26	0	0
22	20159576	.	A	T	19	19	38	0	3	41	0	0
22	20159771	.	C	A	17	18	35	0	0	35	0	0
22	20164449	.	T	C	12	17	29	0	6	35	0	0
22	20169411	.	A	C	5	13	18	0	0	18	0	0
22	20169429	.	G	A	8	18	26	0	1	27	0	0
22	20172105	.	A	G	11	0	11	0	12	23	0	0
22	20172642	.	A	G	7	11	18	1	0	19	0	0
22	20175295	.	G	A	11	10	21	0	0	21	0	0
22	20177970	.	G	A	0	4	4	0	7	11	0	0
22	20177981	.	G	A	7	4	11	0	0	11	0	0
22	20178045	.	C	T	4	7	11	0	1	12	0	0
22	20178065	.	T	C	4	7	11	0	1	12	0	0
22	20178377	.	A	G	1	2	3	0	0	3	0	0
22	20202641	.	G	A	4	9	13	0	1	14	0	0
22	20211187	.	T	C	2	7	9	0	2	11	0	0
22	20211289	.	G	T	1	5	6	0	6	12	0	0
22	20212794	.	G	T	2	11	13	0	15	28	0	0
22	20214649	.	G	A	1	14	15	0	12	27	0	0
22	20215089	.	T	A	21	15	36	0	1	37	0	0
22	20215351	.	C	T	12	12	24	0	0	24	0	0
22	20220161	.	A	G	6	0	6	0	11	17	0	0
22	20220197	.	C	T	11	13	24	0	0	24	0	0
22	20222950	.	G	C	12	10	22	0	0	22	0	0
22	20230044	.	T	C	11	14	25	0	2	27	0	0
22	20240483	.	T	C	21	18	39	0	1	40	0	0
22	20240835	.	A	G	15	20	35	0	0	35	0	0
22	20261028	.	T	C	1	2	3	0	0	3	0	0
22	20292595	.	A	T	8	10	18	0	0	18	0	0
22	20292789	.	T	C	16	17	33	0	3	36	0	0
22	20293049	.	T	A	4	5	9	0	1	10	0	0
22	20293440	.	G	A	9	10	19	0	3	22	0	0
22	20296615	.	A	T	15	21	36	0	1	37	0	0
22	20296669	.	T	C	22	19	41	1	3	45	0	0
22	20299280	.	A	G	29	15	44	0	5	49	0	0
22	20299283	.	G	A	30	17	47	0	2	49	0	0
22	20299349	.	T	C	23	21	44	0	3	47	0	0
22	20303406	.	A	G	22	23	45	0	1	46	0	0
22	20303412	.	G	T	17	23	40	0	3	43	0	0
22	20303487	.	A	G	28	38	66	0	0	66	0	0
22	20305443	.	G	T	29	40	69	0	1	70	0	0
22	20313791	.	A	G	16	15	31	0	1	32	0	0
22	20313887	.	C	G	17	13	30	0	1	31	0	0
22	20313926	.	C	A	1	16	17	0	19	36	0	0
22	20315851	.	T	C	16	0	16	0	11	27	0	0
22	20315883	.	C	T	10	16	26	0	2	28	0	0
22	20315896	.	G	A	15	14	29	0	3	32	0	0
22	20316020	.	G	A	23	18	41	0	1	42	0	0
22	20318937	.	C	T	2	9	11	0	17	28	0	0
22	20319149	.	A	G	18	14	32	0	4	36	0	0
22	20372675	.	T	A	6	3	9	0	0	9	0	0
22	20388853	.	G	A	12	10	22	0	0	22	0	0
22	20389198	.	C	A	9	16	25	0	3	28	0	0
22	20389286	.	A	G	7	8	15	0	1	16	0	0
22	20389392	.	A	G	10	10	20	0	0	20	0	0
22	20389538	.	A	T	17	13	30	0	2	32	0	0
22	20389545	.	G	A	19	13	32	0	1	33	0	0
22	20389580	.	T	G	16	12	28	0	1	29	0	0
22	20389620	.	T	A	18	9	27	0	0	27	0	0
22	20390002	.	C	A	12	11	23	0	2	25	0	0
22	20390041	.	C	T	17	18	35	0	2	37	0	0
22	20402889	.	T	C	16	8	24	0	0	24	0	0
22	20408865	.	T	C	7	0	7	0	13	20	0	0
22	20409099	.	C	T	8	5	13	0	0	13	0	0
22	20478503	.	T	C	4	2	6	0	0	6	0	0
22	20574066	.	T	C	14	8	22	0	1	23	0	0
22	20574402	.	A	G	12	12	24	0	2	26	0	0
22	20574585	.	A	G	7	16	23	0	0	23	0	0
22	20575634	.	G	A	3	7	10	0	0	10	0	0
22	20783269	.	T	A	4	2	6	0	0	6	0	0
22	20788656	.	C	T	6	4	10	0	0	10	0	0
22	20791016	.	T	C	5	2	7	0	0	7	0	0
22	20794383	.	A	G	4	3	7	0	0	7	0	0
22	20797091	.	C	T	4	2	6	0	1	7	0	0
22	20797280	.	G	A	6	6	12	0	0	12	0	0
22	20797490	.	C	T	1	5	6	0	3	9	0	0
22	20797511	.	A	G	2	4	6	0	0	6	0	0
22	20797556	.	G	A	3	2	5	0	0	5	0	0
22	20806394	.	G	A	3	3	6	0	0	6	0	0
22	20848297	.	G	A	2	6	8	0	0	8	0	0
22	20848326	.	C	T	1	4	5	0	0	5	0	0
22	20848488	.	G	A	9	5	14	0	1	15	0	0
22	20848501	.	A	G	9	3	12	0	0	12	0	0
22	20849615	.	T	C	3	0	3	0	8	11	0	0
22	20877036	.	T	C	8	0	8	0	10	18	0	0
22	20926412	.	C	T	4	4	8	0	0	8	0	0
22	20926511	.	G	A	14	11	25	0	0	25	0	0
22	20940039	.	C	T	1	8	9	0	11	20	0	0
22	20940048	.	G	A	12	7	19	0	1	20	0	0
22	20944679	.	A	G	10	7	17	0	0	17	0	0
22	20951387	.	T	C	10	1	11	0	6	17	0	0
22	20951514	.	C	T	1	15	16	0	14	30	0	0
22	20951788	.	G	A	16	12	28	0	2	30	0	0
22	20951861	.	C	T	16	11	27	0	1	28	0	0
22	20951866	.	G	T	13	12	25	0	2	27	0	0
22	20952257	.	A	G	20	19	39	0	3	42	0	0
22	20952292	.	A	T	17	15	32	0	2	34	0	0
22	20952534	.	T	C	7	4	11	0	0	11	0	0
22	20953053	.	T	A	9	5	14	0	1	15	0	0
22	20953127	.	A	T	9	6	15	0	0	15	0	0
22	20953141	.	C	A	10	5	15	0	0	15	0	0
22	20953418	.	G	A	13	8	21	0	0	21	0	0
22	20953555	.	C	A	18	9	27	0	1	28	0	0
22	20953578	.	A	G	20	7	27	0	1	28	0	0
22	20954386	.	C	T	8	4	12	0	0	12	0	0
22	20954391	.	C	T	7	4	11	0	0	11	0	0
22	20954557	.	T	A	6	13	19	0	0	19	0	0
22	20954717	.	A	T	12	17	29	0	3	32	0	0
22	20954810	.	C	T	0	21	21	0	15	36	0	0
22	20954953	.	C	T	13	19	32	0	2	34	0	0
22	20955428	.	G	A	15	2	17	0	1	18	0	0
22	20955469	.	C	T	0	8	8	0	8	16	0	0
22	21032184	.	A	G	10	16	26	0	0	26	0	0
22	21128200	.	A	G	19	27	46	3	1	50	0	0
22	21129075	.	G	A	27	34	61	0	3	64	0	0
22	21129101	.	G	A	29	33	62	0	6	68	0	0
22	21129407	.	A	G	31	33	64	0	2	66	0	0
22	21129558	.	T	G	34	27	61	0	5	66	0	0
22	21129575	.	T	C	33	27	60	0	4	64	0	0
22	21342179	.	T	C	1	2	3	0	0	3	0	0
22	21359239	.	A	C	2	0	2	0	3	5	0	0
22	21359247	.	G	A	3	1	4	0	1	5	0	0
22	21361753	.	T	C	3	4	7	0	0	7	0	0
22	21365143	.	C	T	0	3	3	0	1	4	0	0
22	21366552	.	T	C	1	0	1	0	3	4	0	0
22	21367155	.	G	C	3	2	5	0	0	5	0	0
22	21372027	.	T	G	2	1	3	0	3	6	0	0
22	21398568	.	C	G	2	2	4	0	0	4	0	0
22	21399836	.	A	G	2	0	2	0	2	4	0	0
22	21407312	.	T	C	4	2	6	0	0	6	0	0
22	21446480	.	A	G	1	3	4	0	0	4	0	0
22	21454448	.	A	G	4	0	4	0	3	7	0	0
22	21465156	.	T	C	1	2	3	0	1	4	0	0
22	21465232	.	T	C	2	5	7	0	2	9	0	0
22	21465263	.	T	C	2	2	4	0	0	4	0	0
22	21465461	.	G	A	1	4	5	0	1	6	0	0
22	21541437	.	A	G	1	2	3	0	1	4	0	0
22	21544232	.	G	A	4	2	6	0	0	6	0	0
22	21584038	.	G	A	4	2	6	0	0	6	0	0
22	21618495	.	A	G	7	0	7	0	7	14	0	0
22	21618633	.	G	A	2	10	12	0	0	12	0	0
22	21624764	.	G	C	10	6	16	1	0	17	0	0
22	21657871	.	C	T	8	7	15	0	1	16	0	0
22	21661258	.	T	A	14	8	22	0	0	22	0	0
22	21661611	.	A	G	2	0	2	0	3	5	0	0
22	21661819	.	T	C	8	11	19	0	2	21	0	0
22	21662138	.	G	A	1	5	6	1	6	13	0	0
22	21676215	.	A	G	7	3	10	9	0	19	0	0
22	21676233	.	G	A	10	4	14	8	0	22	0	0
22	21676296	.	G	A	9	7	16	0	0	16	0	0
22	21680179	.	T	C	1	0	1	0	4	7	2	0
22	21697826	.	T	C	6	3	9	1	0	10	0	0
22	21737900	.	C	T	2	3	5	0	0	5	0	0
22	21737948	.	T	C	3	0	3	0	5	8	0	0
22	21852158	.	C	T	18	14	32	0	3	35	0	0
22	21852269	.	A	G	14	17	31	0	0	31	0	0
22	21852281	.	T	C	8	0	8	0	20	28	0	0
22	22129883	.	T	C	8	6	14	0	0	14	0	0
22	22130015	.	T	A	9	3	12	0	1	13	0	0
22	22130085	.	C	T	5	7	12	0	1	13	0	0
22	22130255	.	G	A	9	9	18	0	0	18	0	0
22	22130414	.	A	C	7	0	7	0	6	13	0	0
22	22130468	.	T	C	2	0	2	0	7	9	0	0
22	22130528	.	G	A	5	5	10	0	0	10	0	0
22	22130549	.	T	C	8	5	13	0	0	13	0	0
22	22141175	.	C	T	0	2	2	0	4	6	0	0
22	22141788	.	C	T	4	3	7	0	0	7	0	0
22	22142302	.	A	G	5	2	7	1	0	8	0	0
22	22164223	.	T	G	3	2	5	0	0	5	0	0
22	22175516	.	C	T	0	15	15	0	8	23	0	0
22	22179825	.	C	T	6	9	15	0	3	18	0	0
22	22188682	.	T	C	9	10	19	0	3	22	0	0
22	22196339	.	G	A	9	11	20	0	0	20	0	0
22	22199227	.	G	A	12	7	19	0	0	19	0	0
22	22204002	.	C	T	10	11	21	0	2	23	0	0
22	22204098	.	C	T	13	11	24	0	0	24	0	0
22	22204395	.	G	A	8	16	24	0	1	25	0	0
22	22204440	.	G	A	16	8	24	0	0	24	0	0
22	22214852	.	T	C	7	10	17	0	1	18	0	0
22	22215458	.	G	T	10	7	17	0	1	18	0	0
22	22231662	.	C	T	8	6	14	0	1	15	0	0
22	22231717	.	A	T	9	12	21	0	1	22	0	0
22	22234418	.	C	T	1	8	9	2	10	21	0	0
22	22240918	.	G	A	11	18	29	1	0	30	0	0
22	22241772	.	A	T	12	16	28	0	2	30	0	0
22	22245400	.	T	C	10	10	20	0	1	21	0	0
22	22245781	.	G	T	15	11	26	0	1	27	0	0
22	22251493	.	A	C	10	0	10	1	12	23	0	0
22	22259155	.	G	A	11	4	15	0	1	16	0	0
22	22260456	.	G	A	7	9	16	0	1	17	0	0
22	22266519	.	T	C	3	6	9	0	0	9	0	0
22	22267524	.	G	C	0	4	4	0	5	9	0	0
22	22273388	.	C	T	10	7	17	0	0	17	0	0
22	22273736	.	G	A	1	6	7	0	14	21	0	0
22	22273871	.	A	C	10	5	15	0	0	15	0	0
22	22274000	.	A	T	6	7	13	0	0	13	0	0
22	22274137	.	C	T	5	3	8	0	0	8	0	0
22	22274157	.	G	T	3	4	7	0	0	7	0	0
22	22274249	.	T	G	3	2	5	0	0	5	0	0
22	22276958	.	T	C	1	0	1	0	3	4	0	0
22	22311283	.	T	C	3	5	8	0	0	8	0	0
22	22312463	.	G	A	7	4	11	0	1	12	0	0
22	22312496	.	C	A	3	9	12	0	0	12	0	0
22	22312548	.	C	A	3	4	7	0	1	8	0	0
22	22312672	.	A	G	1	5	6	0	1	7	0	0
22	22313260	.	A	T	3	4	7	0	0	7	0	0
22	22313376	.	T	C	7	6	13	0	0	13	0	0
22	22313395	.	G	A	1	5	6	0	7	13	0	0
22	22313574	.	A	G	1	0	1	0	3	4	0	0
22	22313601	.	C	T	1	3	4	0	0	4	0	0
22	22313639	.	A	C	2	6	8	0	0	8	0	0
22	22313927	.	G	C	8	6	14	0	0	14	0	0
22	22313953	.	T	A	4	9	13	0	0	13	0	0
22	22314547	.	T	A	6	5	11	0	2	13	0	0
22	22314564	.	C	A	8	7	15	0	1	16	0	0
22	22314721	.	A	G	9	14	23	0	1	24	0	0
22	22314861	.	C	G	2	3	5	0	1	6	0	0
22	22315211	.	A	G	3	2	5	0	1	6	0	0
22	22345136	.	C	T	1	11	12	0	11	23	0	0
22	22345179	.	A	C	12	13	25	0	0	25	0	0
22	22345255	.	G	A	11	20	31	0	1	32	0	0
22	22345367	.	C	T	3	13	16	0	17	33	0	0
22	22345403	.	G	A	19	15	34	0	0	34	0	0
22	22345418	.	G	A	19	16	35	0	1	36	0	0
22	22351103	.	A	T	12	20	32	0	0	32	0	0
22	22351180	.	A	T	24	12	36	0	1	37	0	0
22	22352611	.	A	C	12	12	24	0	2	26	0	0
22	22352693	.	T	A	15	9	24	0	1	25	0	0
22	22353222	.	G	A	12	6	18	0	1	19	0	0
22	22353416	.	A	G	6	5	11	0	0	11	0	0
22	22353779	.	G	A	6	4	10	0	0	10	0	0
22	22353887	.	G	A	9	5	14	0	0	14	0	0
22	22354145	.	G	A	6	6	12	0	0	12	0	0
22	22354217	.	G	A	6	7	13	0	1	14	0	0
22	22354698	.	C	T	0	7	7	0	6	13	0	0
22	22376081	.	G	C	6	1	7	0	6	13	0	0
22	22376174	.	C	T	2	7	9	0	13	22	0	0
22	22397336	.	G	A	8	4	12	0	1	13	0	0
22	22397402	.	A	C	7	0	7	0	5	12	0	0
22	22418224	.	C	T	1	1	2	0	0	2	0	0
22	22418245	.	G	T	1	4	5	0	0	5	0	0
22	22418465	.	A	T	4	5	9	0	0	9	0	0
22	22420420	.	A	G	7	8	15	0	0	15	0	0
22	22420646	.	G	T	0	6	6	0	3	9	0	0
22	22420664	.	A	G	2	6	8	0	0	8	0	0
22	22420746	.	G	T	3	8	11	0	0	11	0	0
22	22422123	.	A	T	6	2	8	0	1	9	0	0
22	22422264	.	C	T	4	5	9	0	0	9	0	0
22	22422270	.	G	T	4	5	9	0	0	9	0	0
22	22424034	.	G	A	4	3	7	0	0	7	0	0
22	22424058	.	C	T	5	6	11	0	1	12	0	0
22	22425439	.	T	C	6	5	11	0	0	11	0	0
22	22427442	.	T	C	5	10	15	0	0	15	0	0
22	22427612	.	C	T	11	10	21	0	0	21	0	0
22	22427694	.	C	T	4	13	17	0	1	18	0	0
22	22427880	.	C	T	2	3	5	0	0	5	0	0
22	22634168	.	A	G	1	5	6	0	0	6	0	0
22	22635879	.	G	C	1	3	4	0	0	4	0	0
22	23360503	.	G	A	1	4	5	0	0	5	0	0
22	23452957	.	C	T	3	2	5	0	0	5	0	0
22	23478541	.	A	G	2	4	6	0	1	7	0	0
22	23479096	.	G	T	2	3	5	0	0	5	0	0
22	23493268	.	C	A	1	3	4	0	1	5	0	0
22	23509256	.	G	A	1	2	3	0	0	3	0	0
22	23512582	.	G	C	2	2	4	0	0	4	0	0
22	23580297	.	A	G	1	2	3	0	0	3	0	0
22	24157961	.	G	C	9	13	22	0	1	23	0	0
22	24158037	.	T	A	7	8	15	0	2	17	0	0
22	24158146	.	A	C	10	13	23	0	0	23	0	0
22	24158190	.	C	T	15	13	28	0	0	28	0	0
22	24158242	.	C	A	20	14	34	0	1	35	0	0
22	24158275	.	G	C	15	16	31	0	1	32	0	0
22	24166896	.	G	A	1	12	13	0	25	38	0	0
22	24166919	.	A	G	19	17	36	0	2	38	0	0
22	24167633	.	C	T	11	21	32	0	0	32	0	0
22	24168125	.	T	C	14	16	30	0	2	32	0	0
22	24168573	.	T	C	20	13	33	0	1	34	0	0
22	24168610	.	T	A	19	19	38	0	2	40	0	0
22	24218631	.	A	G	3	0	3	0	3	6	0	0
22	24218656	.	T	A	4	6	10	0	0	10	0	0
22	24220962	.	A	G	10	14	24	0	0	24	0	0
22	24220996	.	G	A	19	12	31	0	1	32	0	0
22	24221009	.	C	T	14	16	30	0	0	30	0	0
22	24224676	.	A	T	11	14	25	0	1	26	0	0
22	24225409	.	T	C	13	15	28	0	0	28	0	0
22	24229293	.	C	T	17	13	30	0	3	33	0	0
22	24229513	.	T	C	19	16	35	0	4	39	0	0
22	24229890	.	T	C	18	14	32	0	0	32	0	0
22	24230005	.	G	A	0	17	17	0	20	37	0	0
22	24230020	.	G	A	20	22	42	0	1	43	0	0
22	24233536	.	G	T	21	14	35	0	1	36	0	0
22	24246495	.	A	C	2	2	4	0	0	4	0	0
22	24247826	.	T	C	1	2	3	0	0	3	0	0
22	24359990	.	G	T	2	3	5	0	0	5	0	0
22	24621873	.	A	G	3	3	6	0	0	6	0	0
22	24715404	.	A	G	12	0	12	0	23	35	0	0
22	24716636	.	T	A	18	21	39	0	0	39	0	0
22	24717105	.	G	A	17	26	43	0	1	44	0	0
22	24718973	.	T	C	16	28	44	0	1	45	0	0
22	24724279	.	T	C	6	3	9	8	0	17	0	0
22	24724459	.	A	G	7	6	13	3	0	16	0	0
22	24975613	.	C	T	6	4	10	0	0	10	0	0
22	24984053	.	A	C	5	4	9	0	0	9	0	0
22	25025208	.	G	A	24	17	41	0	1	42	0	0
22	25028424	.	G	A	24	21	45	0	4	49	0	0
22	25028660	.	G	A	12	21	33	0	2	35	0	0
22	25028694	.	G	A	19	14	33	0	0	33	0	0
22	25032266	.	C	T	18	17	35	0	0	35	0	0
22	25032344	.	C	T	5	18	23	0	12	35	0	0
22	25032532	.	C	G	17	11	28	0	3	31	0	0
22	25032572	.	G	A	19	9	28	0	3	31	0	0
22	25032620	.	A	C	22	1	23	0	7	30	0	0
22	25032857	.	G	A	6	13	19	0	0	19	0	0
22	25032863	.	A	G	7	14	21	0	0	21	0	0
22	25032921	.	A	T	5	8	13	0	1	14	0	0
22	25042952	.	G	A	1	2	3	0	0	3	0	0
22	25053744	.	A	G	1	3	4	0	0	4	0	0
22	25054496	.	C	G	1	2	3	0	0	3	0	0
22	25055645	.	G	T	5	2	7	0	0	7	0	0
22	25058509	.	C	G	2	0	2	0	1	3	0	0
22	25058518	.	T	G	2	2	4	0	0	4	0	0
22	25063474	.	C	T	3	8	11	0	2	13	0	0
22	25063696	.	A	G	7	0	7	0	5	12	0	0
22	25063745	.	C	A	3	6	9	0	1	10	0	0
22	25063767	.	C	A	3	5	8	0	0	8	0	0
22	25066410	.	T	C	10	8	18	0	1	19	0	0
22	25066585	.	G	A	7	5	12	0	0	12	0	0
22	25066939	.	C	T	5	3	8	0	0	8	0	0
22	25067274	.	A	G	4	3	7	0	0	7	0	0
22	25067596	.	C	T	9	6	15	0	0	15	0	0
22	25069856	.	G	A	3	4	7	0	0	7	0	0
22	25069884	.	C	A	1	6	7	0	0	7	0	0
22	25072073	.	G	A	2	3	5	0	0	5	0	0
22	25072474	.	C	G	7	6	13	0	0	13	0	0
22	25076701	.	G	A	3	4	7	0	1	8	0	0
22	25076727	.	A	G	5	2	7	0	0	7	0	0
22	25078630	.	A	C	5	15	20	0	0	20	0	0
22	25096460	.	T	C	2	3	5	0	0	5	0	0
22	25105205	.	A	G	1	2	3	0	0	3	0	0
22	25109796	.	G	C	2	2	4	0	0	4	0	0
22	25136437	.	G	A	2	2	4	0	0	4	0	0
22	25554258	.	T	C	3	2	5	0	0	5	0	0
22	25554380	.	G	T	1	2	3	0	0	3	0	0
22	25554391	.	T	C	1	2	3	0	0	3	0	0
22	25558939	.	G	A	0	3	3	0	2	5	0	0
22	25566539	.	C	T	5	2	7	0	0	7	0	0
22	25566572	.	A	T	3	2	5	0	0	5	0	0
22	25573161	.	C	T	4	2	6	0	1	7	0	0
22	25573197	.	G	T	5	4	9	0	0	10	1	0
22	25576797	.	A	G	1	0	1	0	2	3	0	0
22	25577248	.	C	T	6	3	9	0	0	9	0	0
22	25577265	.	A	G	4	3	7	0	0	7	0	0
22	25582764	.	T	C	3	6	9	0	0	9	0	0
22	25586906	.	T	A	4	3	7	0	1	8	0	0
22	25586963	.	C	T	2	5	7	0	0	7	0	0
22	25815053	.	G	T	1	2	3	0	0	3	0	0
22	25931976	.	A	G	2	0	2	0	3	5	0	0
22	25935627	.	G	A	0	6	6	0	9	15	0	0
22	25937001	.	G	A	1	5	6	0	6	12	0	0
22	25937037	.	T	A	4	4	8	0	1	9	0	0
22	25937052	.	T	C	3	3	6	0	0	6	0	0
22	25938882	.	T	C	3	3	6	0	1	7	0	0
22	25938915	.	C	T	3	4	7	0	0	7	0	0
22	25939060	.	C	T	6	6	12	0	0	12	0	0
22	25942660	.	A	G	2	7	9	0	0	9	0	0
22	25942728	.	A	G	1	0	1	0	6	7	0	0
22	25942822	.	A	G	5	4	9	0	0	9	0	0
22	25942934	.	T	G	3	4	7	0	0	7	0	0
22	25942940	.	A	G	5	3	8	0	0	8	0	0
22	26180751	.	T	C	3	2	5	0	0	5	0	0
22	26182650	.	T	C	6	3	9	0	0	9	0	0
22	26184439	.	A	G	6	2	8	0	0	8	0	0
22	26239602	.	T	C	3	5	8	0	0	8	0	0
22	26239654	.	A	T	7	7	14	0	0	14	0	0
22	26239681	.	C	T	2	7	9	0	8	17	0	0
22	26239752	.	G	A	5	4	9	0	0	9	0	0
22	26239774	.	T	A	3	5	8	0	0	8	0	0
22	26239798	.	C	A	0	6	6	0	5	11	0	0
22	26239873	.	T	A	7	7	14	0	0	14	0	0
22	26239879	.	G	A	7	6	13	0	0	13	0	0
22	26243236	.	A	C	2	0	2	0	6	8	0	0
22	26243242	.	C	T	1	7	8	0	0	8	0	0
22	26244755	.	C	T	6	2	8	0	4	12	0	0
22	26245743	.	A	G	6	4	10	0	2	12	0	0
22	26245881	.	T	C	5	1	6	0	4	10	0	0
22	26265498	.	A	T	3	4	7	0	0	7	0	0
22	26266807	.	T	A	7	5	12	0	0	12	0	0
22	26274099	.	G	A	7	5	12	0	1	13	0	0
22	26274106	.	A	T	7	6	13	0	0	13	0	0
22	26277695	.	T	C	14	7	21	0	3	24	0	0
22	26277735	.	A	C	13	11	24	0	0	24	0	0
22	26277773	.	G	A	7	12	19	0	1	20	0	0
22	26277820	.	T	C	7	9	16	0	0	16	0	0
22	26277871	.	C	A	8	5	13	0	0	13	0	0
22	26277939	.	T	C	10	0	10	0	6	16	0	0
22	26278042	.	T	C	9	3	12	0	0	12	0	0
22	26278081	.	C	T	13	4	17	0	1	18	0	0
22	26278273	.	G	A	8	11	19	0	1	20	0	0
22	26281043	.	A	G	7	12	19	0	0	19	0	0
22	26289397	.	A	C	5	5	10	0	1	11	0	0
22	26289430	.	G	A	7	7	14	0	0	14	0	0
22	26289501	.	A	T	5	3	8	0	1	9	0	0
22	26290508	.	C	T	14	18	32	0	1	33	0	0
22	26290762	.	A	G	4	2	6	0	0	6	0	0
22	26290797	.	T	G	3	0	3	0	4	7	0	0
22	26304186	.	T	C	10	4	14	0	0	14	0	0
22	26307620	.	T	G	2	9	11	0	0	11	0	0
22	26307671	.	A	G	2	5	7	0	0	7	0	0
22	26307728	.	A	G	2	3	5	0	0	5	0	0
22	26307743	.	T	C	3	0	3	0	6	9	0	0
22	26323726	.	T	A	2	2	4	0	0	4	0	0
22	26323861	.	G	A	2	3	5	0	0	5	0	0
22	26524896	.	G	A	4	4	8	0	0	8	0	0
22	26525535	.	C	T	3	2	5	0	0	5	0	0
22	26525646	.	A	T	3	6	9	0	0	9	0	0
22	26525935	.	T	G	1	2	3	0	0	3	0	0
22	26525960	.	A	G	2	4	6	0	0	6	0	0
22	26525979	.	C	T	2	4	6	0	0	6	0	0
22	26526004	.	A	T	1	5	6	0	1	7	0	0
22	26526057	.	C	T	0	3	3	0	7	10	0	0
22	26526249	.	A	T	2	3	5	0	0	5	0	0
22	26526471	.	A	G	4	2	6	0	1	7	0	0
22	26526564	.	T	C	3	4	7	0	0	7	0	0
22	26526611	.	G	C	4	0	4	0	3	7	0	0
22	26526710	.	G	A	1	8	9	0	0	9	0	0
22	26526722	.	A	G	2	10	12	0	0	12	0	0
22	26526864	.	C	A	9	4	13	0	0	13	0	0
22	26527864	.	C	T	1	4	5	0	0	5	0	0
22	26529438	.	C	A	0	4	4	0	5	9	0	0
22	26529471	.	G	T	4	3	7	0	3	10	0	0
22	26529500	.	T	G	2	6	8	0	3	11	0	0
22	26532302	.	C	T	0	3	3	0	9	12	0	0
22	26536435	.	C	A	3	2	5	0	0	5	0	0
22	26536443	.	T	A	4	2	6	0	0	6	0	0
22	26687479	.	A	G	1	2	3	0	0	3	0	0
22	26696672	.	A	T	1	2	3	0	0	3	0	0
22	26696747	.	T	C	1	3	4	0	0	4	0	0
22	26696783	.	T	C	1	5	6	0	0	6	0	0
22	26703503	.	C	T	7	4	11	0	0	11	0	0
22	26738889	.	A	C	5	10	15	0	1	16	0	0
22	26739000	.	C	T	5	4	9	0	0	9	0	0
22	26739087	.	A	G	6	0	6	0	3	9	0	0
22	26739094	.	G	A	5	2	7	0	0	7	0	0
22	26739273	.	T	C	4	3	7	0	2	9	0	0
22	26739297	.	G	C	3	4	7	0	0	7	0	0
22	26739441	.	G	T	0	3	3	0	2	5	0	0
22	26739480	.	C	T	6	5	11	0	0	11	0	0
22	26751297	.	C	T	4	6	10	0	0	10	0	0
22	26768020	.	C	G	10	8	18	0	1	19	0	0
22	26768023	.	T	C	9	8	17	0	0	17	0	0
22	26768400	.	A	G	6	0	6	0	5	11	0	0
22	26771067	.	G	T	17	11	28	0	1	29	0	0
22	26771494	.	G	A	1	2	3	0	6	9	0	0
22	26774079	.	G	A	0	12	12	0	8	20	0	0
22	26774660	.	C	T	5	13	18	0	2	20	0	0
22	26776678	.	C	T	11	8	19	0	2	21	0	0
22	26776681	.	G	A	14	8	22	0	1	23	0	0
22	26785290	.	C	T	8	6	14	0	0	14	0	0
22	26786013	.	A	G	11	11	22	1	0	23	0	0
22	26786559	.	C	A	6	7	13	0	1	14	0	0
22	26787710	.	G	T	9	9	18	0	1	19	0	0
22	26787911	.	C	T	18	14	32	0	2	34	0	0
22	26788340	.	G	A	15	8	23	0	2	25	0	0
22	26788449	.	T	C	21	20	41	0	2	43	0	0
22	26788565	.	T	C	25	25	50	0	1	51	0	0
22	26788885	.	C	A	20	13	33	0	5	38	0	0
22	26789228	.	G	A	4	18	22	0	24	46	0	0
22	26789465	.	A	G	12	1	13	0	18	31	0	0
22	26789667	.	C	G	8	2	10	0	8	18	0	0
22	26789742	.	G	A	5	3	8	0	0	8	0	0
22	26789813	.	A	T	17	10	27	0	2	29	0	0
22	26790074	.	C	T	14	9	23	0	0	23	0	0
22	26790436	.	A	T	13	15	28	0	2	30	0	0
22	26799058	.	C	T	1	3	4	0	0	4	0	0
22	26799927	.	G	A	0	4	4	0	3	7	0	0
22	26799960	.	A	G	1	5	6	0	0	6	0	0
22	26812016	.	A	G	5	4	9	0	0	9	0	0
22	26812031	.	G	A	5	5	10	0	0	10	0	0
22	26812058	.	G	A	6	4	10	0	0	10	0	0
22	26812336	.	A	G	7	0	7	0	3	10	0	0
22	26812825	.	G	A	2	3	5	0	0	5	0	0
22	26813028	.	T	A	7	5	12	0	1	13	0	0
22	26813046	.	G	A	0	6	6	0	5	11	0	0
22	26813179	.	G	A	2	6	8	0	0	8	0	0
22	26813185	.	C	T	2	6	8	0	0	8	0	0
22	26813412	.	C	T	3	4	7	0	0	7	0	0
22	26813801	.	A	C	2	6	8	0	0	8	0	0
22	26813851	.	T	G	4	6	10	0	0	10	0	0
22	26813963	.	A	G	4	3	7	0	1	8	0	0
22	26813970	.	T	C	4	4	8	0	1	9	0	0
22	26814309	.	A	G	6	1	7	0	4	11	0	0
22	26814320	.	C	T	8	5	13	0	1	14	0	0
22	26818086	.	G	A	0	7	7	0	9	16	0	0
22	26818851	.	T	A	9	8	17	0	1	18	0	0
22	26818898	.	G	A	9	4	13	0	0	13	0	0
22	26818907	.	A	G	7	0	7	0	6	13	0	0
22	26819222	.	A	C	3	2	5	0	0	5	0	0
22	26819225	.	G	A	3	2	5	0	0	5	0	0
22	26832125	.	G	A	10	3	13	0	1	14	0	0
22	26839502	.	T	A	3	3	6	0	1	7	0	0
22	26839505	.	G	A	4	3	7	0	0	7	0	0
22	26839538	.	T	G	2	5	7	0	0	7	0	0
22	26844345	.	A	C	11	10	21	0	1	22	0	0
22	26851904	.	A	C	6	0	6	0	8	14	0	0
22	26851963	.	T	C	2	7	9	0	2	11	0	0
22	26852163	.	A	C	2	4	6	0	1	7	0	0
22	26854626	.	C	A	2	6	8	0	2	10	0	0
22	26854815	.	A	C	1	3	4	0	0	4	0	0
22	26854965	.	A	G	5	3	8	0	0	8	0	0
22	26855037	.	C	G	1	3	4	0	0	4	0	0
22	26855172	.	A	G	1	1	2	0	1	3	0	0
22	26855694	.	C	T	2	2	4	0	0	4	0	0
22	26856023	.	A	G	4	6	10	0	0	10	0	0
22	26856059	.	A	T	5	3	8	0	0	8	0	0
22	26857762	.	A	G	0	3	3	0	2	5	0	0
22	26858002	.	A	G	10	5	15	0	0	15	0	0
22	26858161	.	T	C	3	5	8	0	0	8	0	0
22	26858216	.	T	C	10	3	13	1	0	14	0	0
22	26860639	.	C	T	2	27	29	0	16	45	0	0
22	26860753	.	T	C	18	8	26	0	0	26	0	0
22	26861264	.	T	C	10	0	10	0	9	19	0	0
22	26929826	.	C	A	17	19	36	2	0	38	0	0
22	26929931	.	A	T	20	25	45	0	1	46	0	0
22	26929969	.	A	G	27	21	48	0	1	49	0	0
22	26930076	.	A	G	23	17	40	0	4	44	0	0
22	26930079	.	G	T	25	18	43	0	1	44	0	0
22	26930133	.	G	C	30	12	42	0	3	45	0	0
22	26930313	.	C	T	21	21	42	0	0	42	0	0
22	26930335	.	A	T	20	24	44	0	1	45	0	0
22	26930390	.	C	T	18	20	38	0	0	38	0	0
22	26930489	.	C	G	21	20	41	0	0	41	0	0
22	26930527	.	T	A	17	18	35	0	0	35	0	0
22	26930601	.	T	C	19	12	31	0	1	32	0	0
22	26930735	.	G	C	17	0	17	0	16	33	0	0
22	26930894	.	C	T	2	27	29	0	17	46	0	0
22	26931467	.	C	T	8	5	13	0	0	13	0	0
22	26931509	.	G	T	7	2	9	0	2	11	0	0
22	26931544	.	G	A	7	4	11	0	2	13	0	0
22	26931567	.	C	A	8	4	12	0	0	12	0	0
22	26931661	.	A	G	4	9	13	0	0	13	0	0
22	26931699	.	A	T	5	5	10	0	1	11	0	0
22	26931723	.	T	C	7	6	13	0	0	13	0	0
22	26931906	.	C	T	18	15	33	1	1	35	0	0
22	26931967	.	G	A	17	23	40	0	3	43	0	0
22	26940409	.	G	A	8	15	23	0	0	23	0	0
22	27091989	.	C	T	8	4	12	0	0	12	0	0
22	27092147	.	G	A	6	3	9	0	0	9	0	0
22	27092155	.	T	C	6	4	10	0	0	10	0	0
22	27092183	.	A	C	4	3	7	0	0	7	0	0
22	27098736	.	G	A	6	9	15	0	0	15	0	0
22	27098899	.	T	C	9	8	17	0	1	18	0	0
22	27102556	.	C	T	6	10	16	0	0	16	0	0
22	27104159	.	C	G	5	5	10	0	1	11	0	0
22	28236839	.	A	T	3	6	9	0	1	10	0	0
22	28240544	.	A	G	3	7	10	0	0	10	0	0
22	28240555	.	T	A	4	7	11	0	0	11	0	0
22	28241719	.	A	T	3	3	6	0	0	6	0	0
22	28241831	.	T	A	2	8	10	0	2	12	0	0
22	28244972	.	A	G	4	6	10	0	0	10	0	0
22	28255399	.	G	T	2	5	7	0	0	7	0	0
22	28255495	.	T	C	3	5	8	0	0	8	0	0
22	28255514	.	C	G	3	0	3	0	3	6	0	0
22	28265596	.	T	G	2	5	7	0	0	7	0	0
22	28265621	.	T	C	2	7	9	0	0	9	0	0
22	28265636	.	G	T	2	7	9	0	0	9	0	0
22	28284646	.	A	C	2	6	8	0	1	9	0	0
22	28284659	.	C	T	5	7	12	0	0	12	0	0
22	28287669	.	T	C	5	11	16	0	1	17	0	0
22	28290817	.	C	T	3	9	12	0	1	13	0	0
22	28303025	.	C	T	9	9	18	0	1	19	0	0
22	28303091	.	C	A	10	9	19	0	2	21	0	0
22	28461603	.	T	C	1	4	5	0	0	5	0	0
22	28481742	.	C	T	1	3	4	0	0	4	0	0
22	28481953	.	G	A	1	2	3	0	0	3	0	0
22	28642555	.	G	A	4	3	7	0	0	7	0	0
22	28642695	.	A	C	2	4	6	0	0	6	0	0
22	28642715	.	C	A	0	3	3	0	4	7	0	0
22	28642777	.	G	A	4	3	7	0	0	7	0	0
22	28642818	.	C	A	4	5	9	0	1	10	0	0
22	28642997	.	C	A	5	2	7	1	0	8	0	0
22	28769149	.	G	A	3	2	5	0	0	5	0	0
22	28769319	.	T	C	1	0	1	0	2	3	0	0
22	28769339	.	T	G	1	3	4	0	0	4	0	0
22	28804013	.	G	A	0	6	6	0	4	10	0	0
22	28832823	.	G	C	7	10	17	0	1	18	0	0
22	28836202	.	C	T	11	6	17	0	3	20	0	0
22	28836631	.	A	G	17	13	30	0	0	30	0	0
22	28837231	.	A	G	14	13	27	0	0	27	0	0
22	28839917	.	A	C	9	9	18	0	0	18	0	0
22	28840101	.	C	A	17	7	24	0	1	25	0	0
22	28840154	.	A	G	16	10	26	0	0	26	0	0
22	28847988	.	G	A	5	8	13	0	0	13	0	0
22	28848724	.	A	T	14	8	22	1	1	24	0	0
22	28848735	.	T	C	14	11	25	1	0	26	0	0
22	28848920	.	A	G	5	2	7	0	0	7	0	0
22	28858314	.	A	G	21	9	30	0	1	31	0	0
22	28859346	.	G	A	24	19	43	0	0	43	0	0
22	28859409	.	A	G	24	10	34	0	1	35	0	0
22	28859618	.	A	G	23	13	36	0	2	38	0	0
22	28859683	.	G	T	20	9	29	1	2	32	0	0
22	28862336	.	C	T	12	13	25	0	1	26	0	0
22	28862534	.	A	G	12	7	19	0	1	20	0	0
22	28863137	.	G	A	16	9	25	0	0	25	0	0
22	28863140	.	G	A	15	9	24	0	0	24	0	0
22	28865752	.	G	A	15	9	24	0	2	26	0	0
22	28865970	.	A	G	17	6	23	0	0	23	0	0
22	28868174	.	A	G	16	12	28	0	1	29	0	0
22	28868183	.	T	C	13	11	24	0	4	28	0	0
22	28871698	.	G	C	17	0	17	0	14	31	0	0
22	29075278	.	C	T	4	5	9	0	0	9	0	0
22	29076058	.	T	G	4	4	8	0	0	8	0	0
22	29076126	.	A	G	7	7	14	0	0	14	0	0
22	29076172	.	G	A	8	8	16	0	0	16	0	0
22	29076236	.	T	C	10	12	22	0	0	22	0	0
22	29076381	.	G	C	6	9	15	0	0	15	0	0
22	29076389	.	A	G	6	10	16	0	0	16	0	0
22	29076444	.	G	C	4	9	13	0	0	13	0	0
22	29076616	.	T	A	1	2	3	0	0	3	0	0
22	29076755	.	G	A	2	5	7	0	1	8	0	0
22	29077023	.	T	A	7	7	14	0	1	15	0	0
22	29077380	.	G	A	5	6	11	0	0	11	0	0
22	29077432	.	A	G	8	5	13	0	0	13	0	0
22	29077515	.	G	A	4	3	7	0	0	7	0	0
22	29077665	.	T	A	2	3	5	0	0	5	0	0
22	29078255	.	T	A	3	6	9	0	1	10	0	0
22	29078715	.	C	T	5	6	11	0	0	11	0	0
22	29079722	.	G	T	7	6	13	0	0	13	0	0
22	29079761	.	T	C	6	2	8	0	0	8	0	0
22	29080205	.	G	A	12	8	20	0	0	20	0	0
22	29080233	.	G	A	12	7	19	0	1	20	0	0
22	29080427	.	G	A	8	13	21	0	0	21	0	0
22	29080477	.	T	G	6	8	14	0	0	14	0	0
22	29080864	.	C	T	7	3	10	0	1	11	0	0
22	29091732	.	G	C	4	7	11	0	0	11	0	0
22	29092222	.	C	A	4	3	7	0	1	8	0	0
22	29096361	.	G	A	3	2	5	0	0	5	0	0
22	29097228	.	C	T	9	8	17	0	0	17	0	0
22	29097303	.	A	G	7	0	7	0	6	13	0	0
22	29097327	.	T	C	5	4	9	0	1	10	0	0
22	29097354	.	T	A	6	2	8	0	1	9	0	0
22	29103453	.	A	G	6	5	11	0	1	12	0	0
22	29113803	.	G	A	0	6	6	0	9	15	0	0
22	29113882	.	A	G	5	5	10	0	0	10	0	0
22	29114351	.	G	A	9	7	16	0	1	17	0	0
22	29118736	.	G	A	1	5	6	0	10	16	0	0
22	29119270	.	T	C	2	5	7	0	1	8	0	0
22	29119326	.	T	A	2	8	10	0	0	10	0	0
22	29121740	.	G	A	0	9	9	0	2	11	0	0
22	29121765	.	C	T	5	7	12	0	0	12	0	0
22	29121789	.	G	A	0	8	8	0	7	15	0	0
22	29125660	.	C	T	12	4	16	0	0	16	0	0
22	29125699	.	T	A	8	4	12	0	0	12	0	0
22	29125791	.	T	A	5	8	13	0	1	14	0	0
22	29126556	.	G	C	2	2	4	0	0	4	0	0
22	29126682	.	A	G	2	5	7	0	0	7	0	0
22	29168879	.	G	A	24	30	54	0	4	58	0	0
22	29168940	.	T	A	27	29	56	0	3	59	0	0
22	29242280	.	A	G	19	13	32	0	0	32	0	0
22	29242296	.	G	C	15	14	29	0	0	29	0	0
22	29242317	.	G	A	10	10	20	0	2	22	0	0
22	29251441	.	G	A	2	2	4	0	0	4	0	0
22	29251655	.	T	C	1	3	4	0	0	4	0	0
22	29312274	.	G	C	1	0	1	0	3	4	0	0
22	29312513	.	C	T	1	2	3	0	0	3	0	0
22	29312851	.	A	C	3	6	9	0	0	9	0	0
22	29316013	.	T	C	4	6	10	0	0	10	0	0
22	29316091	.	T	A	4	5	9	0	3	12	0	0
22	29316139	.	A	T	2	4	6	0	1	7	0	0
22	29316153	.	A	C	1	0	1	0	3	4	0	0
22	29316479	.	A	T	2	3	5	0	0	5	0	0
22	29318758	.	T	C	1	0	1	0	3	4	0	0
22	29336257	.	T	C	1	2	3	0	0	3	0	0
22	29585304	.	T	C	3	2	5	0	0	5	0	0
22	29612096	.	A	G	4	2	6	0	1	7	0	0
22	29615056	.	A	G	5	6	11	0	0	11	0	0
22	29617050	.	G	A	6	7	13	0	0	13	0	0
22	29620306	.	A	G	9	5	14	0	0	14	0	0
22	29620488	.	T	G	6	6	12	0	0	12	0	0
22	29651938	.	C	T	17	15	32	0	0	32	0	0
22	29652161	.	T	A	13	15	28	0	2	30	0	0
22	29652201	.	A	G	11	0	11	0	14	25	0	0
22	29659031	.	T	A	9	4	13	1	1	15	0	0
22	29659637	.	G	A	31	24	55	0	0	55	0	0
22	29666501	.	G	A	20	19	39	0	2	41	0	0
22	29666505	.	C	T	1	21	22	0	20	42	0	0
22	29666746	.	G	A	10	15	25	0	0	25	0	0
22	29668796	.	C	T	13	19	32	0	0	32	0	0
22	29668799	.	C	T	19	12	31	0	1	32	0	0
22	29670324	.	G	A	19	17	36	1	4	41	0	0
22	29671553	.	A	G	16	14	30	1	1	32	0	0
22	29689458	.	T	C	18	20	38	0	1	40	1	0
22	29858936	.	T	C	9	12	21	1	0	22	0	0
22	31364253	.	A	G	2	0	2	0	1	3	0	0
22	31404427	.	T	A	5	5	10	0	0	10	0	0
22	31406548	.	G	A	0	2	2	0	5	7	0	0
22	31431740	.	G	A	1	4	5	0	1	6	0	0
22	31440674	.	C	T	3	3	6	0	0	6	0	0
22	31445113	.	A	G	3	3	6	0	0	6	0	0
22	31456026	.	A	T	1	3	4	0	1	5	0	0
22	31466141	.	G	A	8	2	10	0	0	10	0	0
22	31504546	.	C	A	2	4	6	0	1	7	0	0
22	31513575	.	C	T	0	2	2	0	4	6	0	0
22	31517163	.	A	G	4	2	6	0	0	6	0	0
22	31668049	.	T	C	9	0	9	0	15	24	0	0
22	31671957	.	T	A	20	28	48	0	1	49	0	0
22	31821990	.	G	C	4	2	6	0	0	6	0	0
22	31933332	.	G	A	0	3	3	0	6	9	0	0
22	31933335	.	T	G	3	6	9	0	1	10	0	0
22	31992224	.	G	A	0	5	5	0	2	7	0	0
22	32103392	.	T	C	2	6	8	0	1	9	0	0
22	32291834	.	T	C	13	1	14	0	14	28	0	0
22	33592309	.	T	C	18	13	31	0	0	31	0	0
22	33592530	.	G	T	9	16	25	0	0	25	0	0
22	33639388	.	G	A	12	14	26	0	1	27	0	0
22	33791076	.	G	T	6	11	17	1	0	18	0	0
22	33791208	.	G	A	19	12	31	0	0	31	0	0
22	33791235	.	G	A	13	11	24	0	1	25	0	0
22	33915629	.	G	A	11	10	21	0	0	21	0	0
22	33916599	.	A	G	6	12	18	0	1	19	0	0
22	35931992	.	A	G	2	0	2	0	5	7	0	0
22	35944604	.	A	T	0	2	2	0	2	4	0	0
22	35945668	.	G	A	0	5	5	0	1	6	0	0
22	36592878	.	T	C	6	4	10	0	0	10	0	0
22	36594827	.	A	G	4	4	8	0	0	8	0	0
22	36596763	.	T	C	5	3	8	0	0	8	0	0
22	36598444	.	C	T	2	5	7	0	0	7	0	0
22	36598459	.	G	C	3	5	8	0	0	8	0	0
22	36601758	.	A	G	8	0	8	0	3	11	0	0
22	36601761	.	A	C	8	2	10	0	0	10	0	0
22	36634127	.	T	C	2	3	5	0	0	5	0	0
22	36661102	.	A	T	1	3	4	0	0	4	0	0
22	36674186	.	G	A	43	14	57	0	0	57	0	0
22	36674598	.	G	T	1	2	3	0	0	3	0	0
22	36674646	.	A	G	7	9	16	0	3	19	0	0
22	36674658	.	G	A	11	18	29	0	1	30	0	0
22	36679390	.	G	A	28	21	49	0	1	50	0	0
22	36681357	.	T	G	24	23	47	0	3	50	0	0
22	36681359	.	A	G	27	23	50	0	1	51	0	0
22	36684170	.	A	G	23	16	39	4	2	45	0	0
22	36685729	.	C	T	23	24	47	2	3	52	0	0
22	36685768	.	T	C	25	0	25	0	28	53	0	0
22	36686828	.	G	A	22	22	44	0	1	45	0	0
22	36686867	.	G	A	34	11	45	0	2	47	0	0
22	36686870	.	A	G	31	11	42	0	4	46	0	0
22	36687418	.	C	T	2	17	19	0	33	52	0	0
22	36687541	.	T	C	21	20	41	0	0	41	0	0
22	36690668	.	T	A	12	23	35	1	5	41	0	0
22	36746417	.	C	A	1	2	3	0	0	3	0	0
22	36746420	.	A	C	1	2	3	0	0	3	0	0
22	36755641	.	C	T	3	3	6	0	0	6	0	0
22	36755732	.	G	T	3	3	6	1	0	7	0	0
22	36755831	.	G	A	1	5	6	0	0	6	0	0
22	36755973	.	T	G	3	4	7	0	0	7	0	0
22	36756005	.	T	C	4	3	7	0	0	7	0	0
22	36756154	.	A	T	3	3	6	0	0	6	0	0
22	36756333	.	T	C	7	0	7	0	5	12	0	0
22	36758365	.	A	T	7	6	13	1	0	14	0	0
22	36768060	.	C	T	0	4	4	2	8	14	0	0
22	36795279	.	C	T	10	5	15	0	0	15	0	0
22	36795755	.	G	C	12	9	21	0	0	21	0	0
22	36795803	.	T	C	14	0	14	0	10	24	0	0
22	36795845	.	G	T	5	10	15	0	0	15	0	0
22	36798416	.	G	A	6	6	12	0	0	12	0	0
22	36800480	.	C	G	1	6	7	0	5	12	0	0
22	36800685	.	T	A	6	4	10	0	0	10	0	0
22	36800981	.	G	C	9	10	19	0	1	20	0	0
22	36801283	.	A	T	6	4	10	0	0	10	0	0
22	36801429	.	C	T	3	8	11	0	0	11	0	0
22	36801551	.	A	T	5	4	9	0	0	9	0	0
22	36801611	.	C	T	0	4	4	0	4	8	0	0
22	36801734	.	T	C	2	3	5	0	0	5	0	0
22	36801929	.	T	A	5	2	7	0	1	8	0	0
22	36802034	.	A	T	1	2	3	0	1	4	0	0
22	36802898	.	G	A	3	3	6	0	0	6	0	0
22	36802928	.	C	T	0	4	4	0	3	7	0	0
22	36803327	.	A	C	2	2	4	0	0	4	0	0
22	36803329	.	G	T	2	2	4	0	0	4	0	0
22	36820464	.	C	T	0	3	3	0	6	9	0	0
22	36820470	.	A	G	5	3	8	0	0	8	0	0
22	36836043	.	T	A	2	3	5	0	0	5	0	0
22	36841751	.	T	A	1	4	5	0	0	5	0	0
22	36875533	.	T	C	3	4	7	0	0	7	0	0
22	36875601	.	A	G	4	0	4	0	6	10	0	0
22	36877344	.	T	C	9	9	18	0	0	18	0	0
22	36877484	.	G	T	8	5	13	0	0	13	0	0
22	36877963	.	G	A	8	7	15	0	0	15	0	0
22	36879468	.	G	T	12	5	17	0	0	17	0	0
22	36879483	.	C	T	11	6	17	0	0	17	0	0
22	36882150	.	G	A	7	10	17	0	2	19	0	0
22	36882168	.	G	A	1	8	9	0	7	16	0	0
22	36882189	.	G	A	2	9	11	0	7	18	0	0
22	36887954	.	C	T	11	5	16	0	0	16	0	0
22	36891142	.	G	A	8	7	15	1	0	16	0	0
22	36893330	.	T	C	4	9	13	1	0	14	0	0
22	36893411	.	A	C	16	7	23	0	1	24	0	0
22	36894316	.	T	A	12	7	19	0	0	19	0	0
22	36898727	.	T	C	6	11	17	0	3	20	0	0
22	36899149	.	G	A	2	18	20	0	10	30	0	0
22	36899483	.	G	A	0	4	4	0	5	9	0	0
22	36899574	.	A	G	7	4	11	0	0	11	0	0
22	36899611	.	C	A	4	6	10	0	0	10	0	0
22	36947797	.	G	T	6	8	14	0	0	14	0	0
22	36947836	.	C	A	4	7	11	0	0	11	0	0
22	36947841	.	A	G	3	6	9	0	0	9	0	0
22	36947963	.	T	C	10	1	11	0	13	24	0	0
22	36947997	.	A	G	5	11	16	0	0	16	0	0
22	36948052	.	T	G	4	5	9	0	1	10	0	0
22	36948131	.	G	T	6	6	12	0	1	13	0	0
22	36948177	.	C	A	4	8	12	0	0	12	0	0
22	36948202	.	C	A	5	10	15	0	0	15	0	0
22	36948237	.	A	T	5	9	14	0	0	14	0	0
22	36948242	.	A	G	5	9	14	0	0	14	0	0
22	36948395	.	T	C	4	1	5	0	8	13	0	0
22	36948410	.	G	A	9	9	18	0	0	18	0	0
22	36948530	.	A	G	8	6	14	0	0	14	0	0
22	36970952	.	G	C	2	4	6	0	0	6	0	0
22	36978378	.	C	T	1	2	3	0	1	4	0	0
22	36988248	.	C	T	2	2	4	0	0	4	0	0
22	36999627	.	G	T	2	4	6	0	0	6	0	0
22	37002533	.	G	A	1	2	3	0	0	3	0	0
22	37007339	.	C	A	0	3	3	0	2	5	0	0
22	37007342	.	C	T	0	4	4	0	0	4	0	0
22	37276451	.	G	A	4	4	8	0	1	9	0	0
22	37276606	.	C	A	10	8	18	0	0	18	0	0
22	37276635	.	T	C	8	0	8	0	8	16	0	0
22	37276717	.	A	G	13	12	25	0	0	25	0	0
22	37276790	.	G	A	10	12	22	0	0	22	0	0
22	37278260	.	G	T	3	3	6	0	0	6	0	0
22	37278283	.	A	T	1	4	5	0	0	5	0	0
22	37278385	.	G	A	10	5	15	0	0	15	0	0
22	37278479	.	T	C	6	1	7	0	12	19	0	0
22	37278634	.	C	T	19	17	36	0	2	38	0	0
22	37278638	.	C	G	21	20	41	0	2	43	0	0
22	37348345	.	C	T	11	5	16	0	0	16	0	0
22	37352700	.	C	G	19	12	31	0	4	35	0	0
22	37543457	.	A	G	18	8	26	0	0	26	0	0
22	37543656	.	A	G	13	12	25	0	0	25	0	0
22	37550984	.	A	G	13	9	22	0	1	23	0	0
22	37551029	.	A	G	11	13	24	0	0	24	0	0
22	37551369	.	G	T	6	8	14	0	2	16	0	0
22	37551496	.	T	C	8	0	8	0	8	16	0	0
22	37552717	.	G	A	10	12	22	0	1	23	0	0
22	37555120	.	T	C	6	3	9	0	0	9	0	0
22	37555126	.	A	G	7	3	10	0	0	10	0	0
22	37557308	.	A	C	12	7	19	0	0	19	0	0
22	37561609	.	G	A	7	7	14	0	1	15	0	0
22	37588819	.	A	T	14	19	33	0	2	35	0	0
22	37588926	.	G	T	8	14	22	0	1	23	0	0
22	37589002	.	T	G	18	15	33	0	2	35	0	0
22	37589131	.	A	G	19	12	31	0	0	31	0	0
22	37589178	.	T	C	14	0	14	0	19	33	0	0
22	37589273	.	T	A	16	13	29	1	2	32	0	0
22	37589275	.	A	C	17	13	30	1	2	33	0	0
22	37589430	.	T	C	12	5	17	0	2	19	0	0
22	37589634	.	C	T	16	4	20	0	0	20	0	0
22	37589848	.	T	A	10	4	14	0	1	15	0	0
22	37590037	.	C	A	3	8	11	0	0	11	0	0
22	37590339	.	A	T	6	8	14	0	4	18	0	0
22	37590470	.	A	T	12	7	19	0	0	19	0	0
22	37590486	.	C	T	10	11	21	0	1	22	0	0
22	37590535	.	C	T	7	8	15	0	0	15	0	0
22	37591073	.	G	A	8	6	14	0	0	14	0	0
22	37591074	.	T	G	6	6	12	0	1	13	0	0
22	37591444	.	T	C	8	0	8	0	7	15	0	0
22	37591455	.	T	C	8	5	13	0	0	13	0	0
22	37591491	.	A	T	7	6	13	0	1	14	0	0
22	37596823	.	A	G	4	2	6	0	0	6	0	0
22	37596906	.	C	T	5	8	13	0	0	13	0	0
22	37599058	.	G	A	7	4	11	0	0	11	0	0
22	37611298	.	T	G	3	3	6	0	1	7	0	0
22	37611312	.	C	G	5	1	6	0	0	6	0	0
22	37611359	.	A	G	2	2	4	0	0	4	0	0
22	37611394	.	A	G	2	2	4	0	0	4	0	0
22	37611513	.	A	G	3	2	5	0	0	5	0	0
22	37639311	.	C	T	10	9	19	0	0	19	0	0
22	37641741	.	G	A	2	7	9	0	2	11	0	0
22	37644048	.	A	G	11	11	22	0	4	26	0	0
22	37645990	.	T	C	12	8	20	1	0	21	0	0
22	37646226	.	T	A	27	10	37	0	1	38	0	0
22	37650246	.	C	T	8	5	13	0	1	14	0	0
22	37652850	.	C	T	14	15	29	0	1	30	0	0
22	37652925	.	C	T	9	8	17	0	1	18	0	0
22	37655702	.	C	T	8	11	19	0	0	19	0	0
22	37691852	.	C	T	15	4	19	2	1	22	0	0
22	37699569	.	T	C	11	14	25	0	1	26	0	0
22	37710178	.	G	T	20	27	47	0	0	47	0	0
22	37710223	.	A	G	13	20	33	0	1	34	0	0
22	37710241	.	A	G	14	8	22	0	4	26	0	0
22	37712558	.	A	G	16	19	35	0	2	37	0	0
22	37712570	.	A	G	18	0	18	0	20	38	0	0
22	37716493	.	G	C	9	7	16	0	0	17	1	0
22	37737696	.	A	G	3	2	5	0	0	5	0	0
22	37738162	.	C	T	0	2	2	0	7	9	0	0
22	37770061	.	A	G	2	2	4	0	0	4	0	0
22	37823332	.	C	A	3	16	19	0	15	34	0	0
22	37834045	.	G	T	21	10	31	0	1	32	0	0
22	37834111	.	G	T	11	15	26	0	0	26	0	0
22	37834164	.	G	C	7	8	15	0	1	16	0	0
22	37834215	.	T	C	13	8	21	0	1	22	0	0
22	37834218	.	G	A	12	8	20	0	1	21	0	0
22	37875454	.	C	G	2	3	5	0	1	6	0	0
22	37875482	.	T	G	1	3	4	0	0	4	0	0
22	37881023	.	G	A	2	11	13	0	0	13	0	0
22	37881433	.	G	T	3	9	12	0	0	12	0	0
22	37995397	.	T	A	2	4	6	0	0	6	0	0
22	37995868	.	G	T	0	2	2	0	1	3	0	0
22	38019898	.	T	C	5	2	7	0	0	7	0	0
22	38028903	.	A	G	4	2	6	0	0	6	0	0
22	38029013	.	T	C	1	3	4	0	0	4	0	0
22	38030646	.	T	C	3	3	6	0	0	6	0	0
22	38030803	.	C	T	1	3	4	0	0	4	0	0
22	38034880	.	T	A	2	2	4	0	0	4	0	0
22	38034883	.	C	T	2	2	4	0	0	4	0	0
22	38037578	.	A	T	11	5	16	0	0	16	0	0
22	38037591	.	G	T	5	6	11	0	1	12	0	0
22	38037613	.	G	T	5	6	11	0	1	12	0	0
22	38041860	.	T	A	9	7	16	0	0	16	0	0
22	38041893	.	C	T	13	9	22	0	1	23	0	0
22	38041959	.	C	T	12	13	25	0	0	25	0	0
22	38045009	.	T	A	8	8	16	0	4	20	0	0
22	38168449	.	T	C	2	2	4	0	0	4	0	0
22	38168461	.	A	G	2	0	2	0	1	3	0	0
22	38176538	.	C	T	3	2	5	0	0	5	0	0
22	38178703	.	G	A	0	2	2	0	5	7	0	0
22	38178736	.	T	C	2	5	7	0	0	7	0	0
22	38181037	.	G	A	2	3	5	0	0	5	0	0
22	38186385	.	C	A	3	4	7	0	0	7	0	0
22	38186409	.	A	G	5	6	11	0	0	11	0	0
22	38191029	.	C	G	6	5	11	0	1	12	0	0
22	38191181	.	G	A	2	3	5	0	1	6	0	0
22	38191715	.	A	G	8	8	16	0	1	17	0	0
22	38191778	.	T	G	9	10	19	0	0	19	0	0
22	38194124	.	T	G	9	17	26	0	2	28	0	0
22	38195229	.	C	T	15	16	31	0	1	32	0	0
22	38197777	.	C	T	26	34	60	0	1	61	0	0
22	38197783	.	G	C	27	35	62	0	1	63	0	0
22	38197900	.	C	T	25	35	60	0	6	66	0	0
22	38199702	.	A	C	14	19	33	0	1	34	0	0
22	38199716	.	C	T	14	15	29	0	0	29	0	0
22	38205072	.	A	G	11	3	14	0	0	14	0	0
22	38209685	.	C	G	0	2	2	0	6	8	0	0
22	38221415	.	C	T	3	3	6	0	0	6	0	0
22	38224077	.	G	T	1	1	2	0	1	3	0	0
22	38224197	.	A	T	1	4	5	0	0	5	0	0
22	38276083	.	T	A	1	5	6	0	0	6	0	0
22	38278216	.	G	C	0	2	2	0	3	5	0	0
22	38280834	.	T	G	3	0	3	0	3	6	0	0
22	38284020	.	A	C	8	6	14	0	0	14	0	0
22	38284047	.	G	A	8	3	11	0	0	11	0	0
22	38286875	.	G	A	0	7	7	0	2	9	0	0
22	38286993	.	C	A	3	7	10	0	0	10	0	0
22	38289964	.	T	C	3	6	9	0	0	9	0	0
22	38293746	.	G	A	0	3	3	0	9	12	0	0
22	38293785	.	C	G	9	0	9	0	8	17	0	0
22	38293791	.	C	G	9	0	9	0	11	20	0	0
22	38293890	.	C	T	7	10	17	0	1	18	0	0
22	38322188	.	T	C	2	2	4	0	0	4	0	0
22	38343217	.	C	T	0	8	8	0	7	15	0	0
22	38343265	.	G	T	3	7	10	0	1	11	0	0
22	38346314	.	C	T	7	2	9	0	2	11	0	0
22	38400939	.	T	C	3	2	5	0	0	5	0	0
22	38429054	.	T	G	1	2	3	0	0	3	0	0
22	38468595	.	C	T	29	15	44	0	2	46	0	0
22	38468644	.	C	T	25	18	43	0	1	44	0	0
22	38469856	.	G	A	32	17	49	0	3	52	0	0
22	38469884	.	G	A	18	30	48	1	2	51	0	0
22	38469926	.	G	A	17	27	44	1	1	46	0	0
22	38471854	.	T	A	28	12	40	0	2	42	0	0
22	38474186	.	G	A	14	23	37	0	1	38	0	0
22	38475506	.	C	A	14	21	35	0	0	35	0	0
22	38475664	.	A	T	22	34	56	0	1	57	0	0
22	38499700	.	C	T	16	14	30	2	0	32	0	0
22	38501788	.	A	G	16	14	30	0	2	32	0	0
22	38505727	.	C	T	25	9	34	8	1	44	1	0
22	38505736	.	G	T	11	20	31	10	3	44	0	0
22	38506387	.	T	C	8	13	21	0	0	21	0	0
22	38507937	.	C	T	15	9	24	0	2	26	0	0
22	38516893	.	C	T	8	9	17	0	0	17	0	0
22	38520867	.	A	T	13	11	24	0	1	25	0	0
22	38521095	.	T	C	15	15	30	0	4	34	0	0
22	38521154	.	G	C	17	15	32	0	0	32	0	0
22	38521353	.	G	C	17	13	30	0	2	32	0	0
22	38521630	.	A	G	13	16	29	0	0	29	0	0
22	38521743	.	C	T	5	6	11	0	0	11	0	0
22	38521949	.	T	A	20	8	28	0	0	28	0	0
22	38522254	.	G	T	11	6	17	0	2	19	0	0
22	38522265	.	T	A	16	4	20	0	1	21	0	0
22	38522291	.	T	A	10	10	20	0	0	20	0	0
22	38522431	.	T	A	10	8	18	0	0	18	0	0
22	38522436	.	T	C	9	0	9	0	10	19	0	0
22	38522471	.	T	A	4	5	9	0	1	10	0	0
22	38523376	.	A	C	3	1	4	0	12	16	0	0
22	38523540	.	T	A	8	16	24	0	0	25	1	0
22	38523616	.	C	G	12	14	26	0	0	26	0	0
22	38523658	.	A	T	15	12	27	0	2	29	0	0
22	38524099	.	C	T	5	8	13	0	0	13	0	0
22	38524465	.	G	T	5	3	8	0	1	9	0	0
22	38524494	.	C	T	0	8	8	0	6	14	0	0
22	38524616	.	A	T	9	9	18	0	0	18	0	0
22	38524701	.	T	G	8	6	14	0	2	16	0	0
22	38524740	.	A	C	10	4	14	0	1	15	0	0
22	38524771	.	G	A	10	8	18	0	2	20	0	0
22	38525082	.	G	A	6	3	9	0	1	10	0	0
22	38525146	.	A	G	5	4	9	0	0	9	0	0
22	38525155	.	A	T	6	4	10	0	0	10	0	0
22	38525789	.	A	C	10	10	20	0	1	21	0	0
22	38526033	.	A	G	6	4	10	0	1	11	0	0
22	38530277	.	T	C	7	8	15	0	0	15	0	0
22	38541489	.	C	T	0	14	14	0	11	25	0	0
22	38543597	.	C	G	5	15	20	1	2	23	0	0
22	38545882	.	A	C	7	0	7	0	12	19	0	0
22	38545921	.	C	T	0	9	9	0	11	20	0	0
22	38566147	.	T	C	13	7	20	0	0	20	0	0
22	38567431	.	G	A	10	6	16	0	1	17	0	0
22	38615186	.	T	A	2	2	4	1	0	5	0	0
22	38615295	.	T	C	13	0	13	0	8	21	0	0
22	38617884	.	G	A	5	3	8	0	2	10	0	0
22	38621256	.	A	T	7	5	12	0	0	12	0	0
22	38796656	.	T	A	2	5	7	0	2	9	0	0
22	38799616	.	A	G	2	4	6	1	0	7	0	0
22	38800183	.	T	C	8	0	8	0	9	17	0	0
22	38899717	.	A	G	2	0	2	0	3	5	0	0
22	38906700	.	A	G	1	0	1	0	3	4	0	0
22	38911481	.	G	A	0	2	2	0	3	5	0	0
22	38911888	.	T	G	3	3	6	0	0	6	0	0
22	38911927	.	C	T	2	2	4	0	0	4	0	0
22	38911946	.	G	A	1	2	3	0	0	3	0	0
22	38912384	.	T	G	2	0	2	0	3	5	0	0
22	38912426	.	C	T	1	2	3	0	1	4	0	0
22	38912493	.	C	T	1	3	4	0	0	4	0	0
22	38912542	.	T	C	3	3	6	0	0	6	0	0
22	38912723	.	G	A	2	3	5	0	0	5	0	0
22	38912747	.	A	G	2	2	4	0	0	4	0	0
22	38912828	.	A	G	1	2	3	0	0	3	0	0
22	38915071	.	T	A	8	7	15	0	0	15	0	0
22	38915088	.	C	T	7	3	10	0	2	12	0	0
22	38918628	.	T	C	5	2	7	0	0	7	0	0
22	38918636	.	T	G	6	1	7	0	0	7	0	0
22	38919290	.	A	C	4	5	9	0	0	9	0	0
22	38919325	.	G	T	0	4	4	0	2	6	0	0
22	38919354	.	G	C	3	2	5	0	0	5	0	0
22	38928450	.	A	T	2	3	5	1	0	6	0	0
22	38928475	.	C	T	6	3	9	1	0	10	0	0
22	38928517	.	T	A	4	3	7	1	0	8	0	0
22	38928577	.	A	T	6	3	9	0	1	10	0	0
22	38928738	.	G	A	1	3	4	0	0	4	0	0
22	38928764	.	A	G	3	2	5	0	0	5	0	0
22	38928940	.	C	A	2	6	8	0	0	9	1	0
22	38928979	.	T	G	6	6	12	0	0	12	0	0
22	38929002	.	T	C	5	5	10	0	0	10	0	0
22	38929112	.	T	C	5	3	8	0	0	8	0	0
22	38929165	.	G	A	4	3	7	0	0	7	0	0
22	38932327	.	G	A	10	8	18	0	0	18	0	0
22	38934759	.	T	C	7	0	7	0	7	14	0	0
22	38935074	.	A	G	6	3	9	0	0	9	0	0
22	38935083	.	C	T	7	6	13	0	0	13	0	0
22	38942975	.	T	C	3	4	7	0	0	7	0	0
22	38943160	.	G	A	0	2	2	0	5	7	0	0
22	38945641	.	G	T	2	2	4	0	0	4	0	0
22	38946287	.	A	G	5	6	11	0	0	11	0	0
22	38946553	.	T	C	6	6	12	0	1	13	0	0
22	38946576	.	T	C	7	10	17	0	0	17	0	0
22	38946608	.	A	C	8	12	20	0	0	20	0	0
22	38946770	.	G	C	19	7	26	0	1	28	1	0
22	38946775	.	T	A	22	7	29	0	1	30	0	0
22	38946833	.	T	C	26	7	33	0	1	34	0	0
22	38951130	.	A	T	12	10	22	0	0	22	0	0
22	38951137	.	C	A	12	10	22	0	0	22	0	0
22	38951186	.	G	T	5	3	8	0	0	8	0	0
22	39014518	.	A	G	2	7	9	0	0	9	0	0
22	39014557	.	A	G	3	5	8	0	0	8	0	0
22	39014569	.	G	A	0	4	4	0	4	8	0	0
22	39014735	.	T	C	3	3	6	0	0	6	0	0
22	39015190	.	T	C	5	4	9	0	0	9	0	0
22	39015567	.	A	G	5	5	10	0	0	10	0	0
22	39023318	.	G	C	0	6	6	0	3	9	0	0
22	39023330	.	A	G	3	0	3	0	6	9	0	0
22	39023501	.	T	C	4	5	9	0	0	9	0	0
22	39023646	.	A	G	7	0	7	0	4	11	0	0
22	39023804	.	T	G	7	1	8	0	6	14	0	0
22	39023861	.	G	A	8	4	12	0	2	14	0	0
22	39023863	.	G	C	0	4	4	0	9	13	0	0
22	39027520	.	A	C	6	3	9	0	0	9	0	0
22	39028712	.	C	T	7	5	12	0	2	14	0	0
22	39028725	.	A	G	7	5	12	0	0	12	0	0
22	39032738	.	C	A	5	5	10	0	0	10	0	0
22	39032915	.	C	T	11	4	15	0	0	15	0	0
22	39032925	.	A	G	10	4	14	0	2	16	0	0
22	39033036	.	C	G	5	6	11	0	0	11	0	0
22	39033053	.	C	T	6	6	12	0	0	12	0	0
22	39033134	.	C	T	9	3	12	0	0	12	0	0
22	39033332	.	A	G	10	0	10	0	8	18	0	0
22	39033637	.	C	G	6	5	11	0	0	11	0	0
22	39033878	.	T	G	5	0	5	0	4	9	0	0
22	39033883	.	T	C	5	4	9	0	0	9	0	0
22	39054209	.	A	G	5	5	10	0	0	10	0	0
22	39054260	.	A	C	4	6	10	0	0	10	0	0
22	39054270	.	G	A	2	3	5	0	0	5	0	0
22	39054436	.	G	T	4	2	6	0	1	7	0	0
22	39054510	.	G	A	4	2	6	0	1	7	0	0
22	39054683	.	T	C	5	6	11	0	0	11	0	0
22	39068386	.	A	G	12	1	13	0	10	23	0	0
22	39076602	.	C	T	9	8	17	0	1	18	0	0
22	39077407	.	C	G	4	0	4	0	9	13	0	0
22	39079356	.	A	C	12	9	21	0	3	24	0	0
22	39079379	.	C	A	11	9	20	0	1	21	0	0
22	39079470	.	G	A	1	6	7	1	7	15	0	0
22	39079864	.	A	T	2	2	4	0	0	4	0	0
22	39079997	.	A	G	19	8	27	0	1	28	0	0
22	39080035	.	C	G	17	12	29	0	0	29	0	0
22	39080043	.	G	C	14	11	25	0	0	25	0	0
22	39080300	.	A	T	10	9	19	0	0	19	0	0
22	39080774	.	C	G	16	12	28	0	1	29	0	0
22	39081169	.	A	G	4	0	4	0	13	17	0	0
22	39081177	.	C	T	10	10	20	0	0	20	0	0
22	39081259	.	T	A	13	14	27	0	1	28	0	0
22	39084943	.	G	A	6	13	19	0	1	20	0	0
22	39084966	.	A	T	6	11	17	0	1	18	0	0
22	39087327	.	C	T	8	6	14	0	0	14	0	0
22	39090558	.	A	G	6	0	6	0	3	9	0	0
22	39093984	.	T	C	3	5	8	0	0	8	0	0
22	39095966	.	T	C	6	4	10	0	1	11	0	0
22	39096080	.	C	A	4	3	7	0	0	7	0	0
22	39096090	.	C	A	4	3	7	0	0	7	0	0
22	39096117	.	A	C	2	4	6	0	0	6	0	0
22	39100979	.	G	A	0	4	4	0	2	6	0	0
22	39103941	.	T	C	3	3	6	0	0	6	0	0
23	252305	.	T	C	4	3	7	0	0	7	0	0
23	320667	.	C	T	0	2	2	0	1	3	0	0
23	458254	.	T	C	9	6	15	0	0	15	0	0
23	458297	.	C	T	4	5	9	0	0	9	0	0
23	585657	.	A	G	12	0	12	0	6	18	0	0
23	586624	.	A	G	10	3	13	0	0	13	0	0
23	863574	.	T	C	3	3	6	0	0	6	0	0
23	863712	.	T	A	7	3	10	0	0	10	0	0
23	863715	.	G	A	7	3	10	0	0	10	0	0
23	864363	.	T	C	1	5	6	0	0	6	0	0
23	864470	.	T	C	1	6	7	0	0	7	0	0
23	1249602	.	A	G	1	2	3	0	0	3	0	0
23	1269234	.	G	T	2	2	4	0	0	4	0	0
23	1270105	.	A	T	1	2	3	0	0	3	0	0
23	1565211	.	T	A	1	2	3	0	0	3	0	0
23	1565694	.	G	A	2	2	4	0	0	4	0	0
23	1565755	.	C	T	1	3	4	0	0	4	0	0
23	1571639	.	G	A	2	3	5	0	0	5	0	0
23	1667175	.	C	A	4	2	6	0	2	8	0	0
23	1673125	.	C	T	2	2	4	0	0	4	0	0
23	1673410	.	G	A	1	2	3	0	0	3	0	0
23	1682200	.	T	C	4	3	7	0	1	8	0	0
23	1691708	.	G	A	0	4	4	0	3	7	0	0
23	1693920	.	A	C	13	4	17	0	0	17	0	0
23	1697238	.	T	G	13	0	13	0	7	20	0	0
23	1697242	.	C	T	11	7	18	0	1	19	0	0
23	1697434	.	C	T	8	4	12	0	0	12	0	0
23	1697469	.	G	A	0	3	3	0	7	10	0	0
23	1697513	.	G	A	4	2	6	0	0	6	0	0
23	1697517	.	T	C	4	2	6	0	0	6	0	0
23	1697860	.	C	T	5	4	9	0	0	9	0	0
23	1698202	.	C	T	9	7	16	0	1	17	0	0
23	1698229	.	G	T	5	5	10	0	0	10	0	0
23	1698256	.	G	A	5	5	10	0	0	10	0	0
23	1698358	.	G	T	1	5	6	0	5	11	0	0
23	1702648	.	C	T	9	8	17	0	0	17	0	0
23	2878837	.	G	A	4	2	6	0	0	6	0	0
23	2879569	.	T	G	1	4	5	0	0	5	0	0
23	4900277	.	A	G	2	2	4	2	0	6	0	0
23	5565897	.	A	G	5	4	9	0	0	9	0	0
23	5585483	.	T	C	5	6	11	0	0	11	0	0
23	5585528	.	G	T	4	6	10	0	1	11	0	0
23	5585555	.	T	C	2	6	8	0	0	8	0	0
23	5587625	.	T	C	6	5	11	0	0	11	0	0
23	5587626	.	C	A	6	5	11	0	0	11	0	0
23	5587860	.	G	A	4	4	8	0	0	8	0	0
23	5756781	.	G	T	3	3	6	0	0	6	0	0
23	5756847	.	C	T	10	5	15	0	0	15	0	0
23	5757010	.	G	A	9	3	12	0	0	12	0	0
23	5757047	.	A	T	5	4	9	0	0	9	0	0
23	5757193	.	G	T	5	3	8	0	0	8	0	0
23	5759014	.	A	T	1	4	5	0	0	5	0	0
23	5759124	.	A	G	1	4	5	0	0	5	0	0
23	5767365	.	T	A	1	2	3	0	0	3	0	0
23	5873124	.	C	T	3	2	5	0	0	5	0	0
23	5919146	.	C	T	3	3	6	0	0	6	0	0
23	5919147	.	G	A	0	3	3	0	3	6	0	0
23	5919188	.	C	T	3	2	5	0	0	5	0	0
23	5919239	.	G	A	0	4	4	0	1	5	0	0
23	6006968	.	G	A	0	3	3	0	1	4	0	0
23	6011958	.	A	G	3	7	10	0	0	10	0	0
23	6027379	.	G	A	7	4	11	0	0	11	0	0
23	6027415	.	T	G	4	6	10	0	1	11	0	0
23	6027439	.	G	A	6	5	11	0	0	11	0	0
23	6027578	.	C	T	2	4	6	0	1	7	0	0
23	6027694	.	C	T	3	3	6	0	0	6	0	0
23	6027781	.	T	C	2	3	5	0	2	7	0	0
23	6028015	.	C	T	7	3	10	0	0	10	0	0
23	6028029	.	C	T	4	5	9	0	1	10	0	0
23	6028051	.	G	A	4	4	8	0	0	8	0	0
23	6028093	.	G	A	5	4	9	0	3	12	0	0
23	6030946	.	T	C	9	8	17	0	0	17	0	0
23	6031126	.	C	T	5	7	12	0	0	12	0	0
23	6035912	.	C	G	9	6	15	0	0	15	0	0
23	6046850	.	T	C	3	3	6	0	0	6	0	0
23	6046867	.	T	C	4	4	8	0	0	8	0	0
23	6053512	.	G	A	4	7	11	0	0	11	0	0
23	6056016	.	T	C	1	3	4	0	1	5	0	0
23	6058704	.	C	T	2	10	12	0	0	12	0	0
23	6059847	.	G	A	0	3	3	0	4	7	0	0
23	6062654	.	C	T	3	2	5	0	0	5	0	0
23	6064579	.	T	C	15	4	19	0	3	22	0	0
23	6272793	.	C	T	11	14	25	0	0	25	0	0
23	6313752	.	T	A	20	12	32	0	1	33	0	0
23	6313801	.	T	G	26	9	35	0	2	37	0	0
23	6353605	.	C	T	0	4	4	0	4	8	0	0
23	6421776	.	T	C	3	2	5	2	1	8	0	0
23	6421788	.	G	A	3	5	8	2	1	11	0	0
23	6421921	.	T	G	3	3	6	0	0	6	0	0
23	6951037	.	T	G	2	3	5	0	0	5	0	0
23	6951157	.	C	T	0	5	5	1	2	8	0	0
23	6952261	.	T	C	3	0	3	0	8	11	0	0
23	6958256	.	A	G	3	2	5	0	0	5	0	0
23	6961424	.	G	A	4	4	8	0	1	9	0	0
23	7000229	.	C	T	3	2	5	0	0	5	0	0
23	7003572	.	G	T	17	15	32	0	0	32	0	0
23	7003744	.	C	T	11	9	20	0	1	21	0	0
23	7007879	.	C	T	7	8	15	0	1	16	0	0
23	7017443	.	A	G	7	15	22	0	0	22	0	0
23	7024631	.	T	C	11	11	22	0	1	23	0	0
23	7029600	.	G	A	10	5	15	0	0	15	0	0
23	7029741	.	G	A	5	8	13	0	0	13	0	0
23	7029916	.	A	T	11	8	19	0	1	20	0	0
23	7040258	.	G	A	2	3	5	0	2	7	0	0
23	7040725	.	G	A	9	10	19	0	1	20	0	0
23	7046813	.	G	A	12	8	20	0	0	20	0	0
23	7046816	.	G	C	12	0	12	0	9	21	0	0
23	7047072	.	T	C	16	0	16	0	8	24	0	0
23	7067236	.	T	G	6	4	10	0	2	12	0	0
23	7068334	.	A	T	5	6	11	0	1	12	0	0
23	7070404	.	G	T	1	3	4	0	0	4	0	0
23	7089569	.	A	C	4	3	7	0	0	7	0	0
23	7125366	.	A	T	1	3	4	0	0	4	0	0
23	7557081	.	C	T	3	7	10	0	1	11	0	0
23	7557382	.	C	T	6	9	15	0	0	15	0	0
23	7557383	.	G	A	9	6	15	0	0	15	0	0
23	7567105	.	A	G	6	5	11	0	0	11	0	0
23	7572445	.	A	G	7	0	7	0	8	15	0	0
23	7573845	.	T	C	4	3	7	0	0	7	0	0
23	7578710	.	T	C	10	13	23	0	1	24	0	0
23	7593012	.	A	G	1	2	3	0	0	3	0	0
23	7702068	.	G	A	1	3	4	0	2	6	0	0
23	7702128	.	A	G	1	2	3	0	0	3	0	0
23	7702169	.	G	A	1	2	3	0	0	3	0	0
23	7708637	.	T	C	1	4	5	0	0	5	0	0
23	7708803	.	T	A	2	3	5	0	0	5	0	0
23	7710831	.	G	A	3	4	7	0	0	7	0	0
23	7715101	.	C	T	3	2	5	0	0	5	0	0
23	7715195	.	G	A	0	2	2	0	2	4	0	0
23	7715477	.	T	C	3	2	5	0	0	5	0	0
23	7715747	.	A	G	5	7	12	0	0	12	0	0
23	7715873	.	G	A	5	3	8	0	0	8	0	0
23	7715909	.	T	C	4	7	11	0	0	11	0	0
23	7716281	.	T	C	3	7	10	0	0	10	0	0
23	7718359	.	C	T	8	7	15	0	0	15	0	0
23	7718972	.	G	A	0	4	4	0	5	9	0	0
23	7725252	.	T	C	5	5	10	0	0	10	0	0
23	7728594	.	T	C	4	8	12	0	0	12	0	0
23	7728606	.	C	T	4	8	12	0	0	12	0	0
23	7732649	.	C	T	9	4	13	0	0	13	0	0
23	7732651	.	T	C	8	4	12	0	1	13	0	0
23	7732761	.	C	T	2	5	7	0	0	7	0	0
23	7732866	.	C	G	3	6	9	0	1	10	0	0
23	7732874	.	C	G	3	6	9	0	1	10	0	0
23	7732918	.	G	A	5	2	7	0	0	7	0	0
23	7733043	.	C	T	4	11	15	0	4	19	0	0
23	7733047	.	G	A	12	7	19	0	1	20	0	0
23	7733081	.	A	G	9	3	12	0	8	20	0	0
23	7733118	.	A	G	5	4	9	0	7	16	0	0
23	7733269	.	C	G	1	2	3	0	2	5	0	0
23	7733732	.	T	C	5	2	7	0	0	7	0	0
23	7735163	.	C	T	0	3	3	0	1	4	0	0
23	7735360	.	T	G	3	0	3	0	3	6	0	0
23	7735384	.	C	T	3	5	8	0	0	8	0	0
23	7735464	.	T	C	5	5	10	0	0	10	0	0
23	7735497	.	T	C	4	10	14	0	0	14	0	0
23	7735695	.	C	T	5	5	10	0	0	10	0	0
23	7735798	.	G	T	2	4	6	0	1	7	0	0
23	7736145	.	T	A	4	7	11	0	0	11	0	0
23	7736257	.	G	A	1	5	6	0	1	7	0	0
23	7736377	.	C	A	3	3	6	0	0	6	0	0
23	7743748	.	G	T	12	11	23	0	1	24	0	0
23	7743871	.	C	T	1	13	14	0	7	21	0	0
23	7746618	.	T	C	7	1	8	0	4	12	0	0
23	7750495	.	A	G	2	4	6	0	0	6	0	0
23	7750552	.	G	A	5	7	12	0	1	13	0	0
23	7755088	.	T	C	3	0	3	0	8	11	0	0
23	7755112	.	A	C	3	8	11	0	0	11	0	0
23	7755165	.	G	A	7	5	12	0	2	14	0	0
23	7755215	.	T	C	2	2	4	0	0	4	0	0
23	7765955	.	G	A	7	6	13	0	0	13	0	0
23	7768578	.	C	T	10	12	22	0	0	22	0	0
23	7771378	.	A	T	7	9	16	0	0	16	0	0
23	7771440	.	G	A	7	6	13	0	1	14	0	0
23	7783606	.	C	T	10	12	22	0	2	24	0	0
23	7792567	.	A	G	7	8	15	0	1	16	0	0
23	7808944	.	C	T	6	7	13	0	0	13	0	0
23	8282601	.	T	C	1	2	3	0	0	3	0	0
23	8283878	.	C	G	1	2	3	0	0	3	0	0
23	8284903	.	C	T	5	4	9	0	0	9	0	0
23	8284991	.	G	T	4	7	11	0	0	11	0	0
23	8285220	.	G	A	7	9	16	0	0	16	0	0
23	8285236	.	G	T	8	14	22	0	0	22	0	0
23	8285332	.	C	T	15	15	30	0	1	31	0	0
23	8285365	.	G	A	11	18	29	0	1	30	0	0
23	8286192	.	T	C	10	0	10	0	9	19	0	0
23	8286261	.	C	T	1	16	17	0	11	28	0	0
23	8286333	.	G	T	9	6	15	0	0	15	0	0
23	8303897	.	C	T	3	4	7	0	1	8	0	0
23	8373535	.	T	G	7	10	17	0	1	18	0	0
23	8373641	.	A	G	10	10	20	0	5	25	0	0
23	8699593	.	C	A	4	3	7	0	0	7	0	0
23	8699811	.	C	T	2	2	4	0	0	4	0	0
23	9131416	.	A	G	2	0	2	0	5	7	0	0
23	9131458	.	T	C	3	4	7	0	0	7	0	0
23	9131467	.	C	T	3	4	7	0	1	8	0	0
23	9132108	.	C	T	2	2	4	0	0	4	0	0
23	9137288	.	T	C	3	3	6	0	0	6	0	0
23	9137333	.	G	A	0	5	5	0	4	9	0	0
23	9268466	.	T	C	1	3	4	0	1	5	0	0
23	9272674	.	C	T	3	3	6	0	0	6	0	0
23	9272984	.	T	C	4	9	13	0	0	13	0	0
23	9402734	.	A	G	3	6	9	0	0	9	0	0
23	9402758	.	G	A	5	5	10	0	0	10	0	0
23	9402915	.	G	C	3	4	7	0	1	8	0	0
23	9403272	.	T	C	5	3	8	0	1	9	0	0
23	9403284	.	C	A	5	3	8	0	0	8	0	0
23	9403348	.	T	G	1	2	3	0	0	3	0	0
23	9405572	.	C	G	0	6	6	0	2	8	0	0
23	9405633	.	C	A	0	5	5	0	1	6	0	0
23	9405689	.	A	C	2	5	7	0	0	7	0	0
23	9405713	.	G	T	2	4	6	0	3	9	0	0
23	9422123	.	T	C	1	0	1	0	2	3	0	0
23	9422133	.	A	G	1	2	3	0	0	3	0	0
23	9422783	.	G	C	2	3	5	0	0	5	0	0
23	9486643	.	T	C	1	0	1	0	4	5	0	0
23	9491115	.	G	T	2	3	5	0	0	5	0	0
23	9491498	.	C	T	0	2	2	0	2	4	0	0
23	9491972	.	T	G	2	3	5	0	0	5	0	0
23	9533222	.	T	C	2	2	4	0	0	4	0	0
23	9535312	.	C	T	5	4	9	0	1	10	0	0
23	9535327	.	C	T	4	5	9	0	0	9	0	0
23	9535351	.	G	A	1	5	6	0	4	10	0	0
23	9538742	.	A	G	5	3	8	0	0	8	0	0
23	9542588	.	T	C	7	11	18	0	0	18	0	0
23	9561099	.	C	A	16	9	25	0	1	26	0	0
23	9561695	.	G	A	6	11	17	0	2	19	0	0
23	9564268	.	T	C	13	10	23	0	0	23	0	0
23	9564283	.	C	A	10	11	21	0	1	22	0	0
23	9565948	.	T	C	21	17	38	0	2	40	0	0
23	9566027	.	A	C	3	6	9	0	6	15	0	0
23	9566030	.	A	C	3	3	6	0	6	12	0	0
23	9566370	.	T	C	12	8	20	0	2	22	0	0
23	9566375	.	G	A	1	13	14	0	11	25	0	0
23	9566471	.	T	G	18	0	18	0	15	33	0	0
23	9567071	.	C	T	14	9	23	0	3	26	0	0
23	9567122	.	C	T	11	11	22	0	2	24	0	0
23	9572424	.	A	G	2	4	6	0	3	9	0	0
23	9574611	.	T	C	3	4	7	0	0	7	0	0
23	9574728	.	C	T	0	2	2	0	2	4	0	0
23	9579392	.	T	C	2	4	6	0	0	6	0	0
23	9584289	.	C	T	0	2	2	0	1	3	0	0
23	9598156	.	G	A	2	2	4	0	0	4	0	0
23	9604718	.	T	C	2	2	4	0	0	4	0	0
23	9794733	.	T	C	6	5	11	4	0	15	0	0
23	9794868	.	T	G	13	17	30	0	1	31	0	0
23	9794959	.	T	A	17	15	32	0	0	32	0	0
23	9795057	.	A	G	21	18	39	0	2	41	0	0
23	9795434	.	C	T	0	9	9	0	13	22	0	0
23	9795663	.	A	C	14	21	35	0	0	35	0	0
23	9800761	.	T	G	10	14	24	0	1	25	0	0
23	9800872	.	T	C	13	16	29	0	0	29	0	0
23	9805838	.	A	G	13	7	20	1	0	21	0	0
23	9809863	.	A	G	12	12	24	0	0	24	0	0
23	9818057	.	A	G	11	19	30	0	1	31	0	0
23	9823221	.	T	C	11	10	21	0	1	22	0	0
23	9828634	.	C	A	0	15	15	0	12	27	0	0
23	9828762	.	G	A	10	10	20	0	3	23	0	0
23	9828765	.	C	G	1	10	11	0	11	22	0	0
23	9828802	.	T	C	9	0	9	0	10	19	0	0
23	9828838	.	T	C	8	1	9	0	9	18	0	0
23	9828925	.	G	A	7	10	17	0	0	17	0	0
23	9829028	.	T	C	6	2	8	0	1	9	0	0
23	9836778	.	G	A	10	12	22	0	0	22	0	0
23	9843221	.	T	C	6	5	11	0	1	12	0	0
23	9845905	.	T	G	3	2	5	0	0	5	0	0
23	9845906	.	T	C	3	2	5	0	0	5	0	0
23	9851839	.	C	T	14	4	18	0	0	18	0	0
23	9938315	.	A	C	2	0	2	0	2	4	0	0
23	9938497	.	G	A	1	3	4	0	0	4	0	0
23	9938693	.	T	A	8	3	11	0	0	11	0	0
23	9938812	.	A	T	2	5	7	0	0	7	0	0
23	9938824	.	T	C	3	0	3	0	5	8	0	0
23	9938869	.	C	T	5	4	9	0	0	9	0	0
23	9938905	.	T	C	6	0	6	0	7	13	0	0
23	9939602	.	T	C	10	5	15	0	0	15	0	0
23	9939817	.	A	G	8	11	19	0	5	24	0	0
23	9950087	.	A	C	9	5	14	0	0	14	0	0
23	9952460	.	C	T	4	8	12	0	1	13	0	0
23	9952532	.	C	G	0	3	3	0	5	8	0	0
23	9959766	.	A	G	6	3	9	0	1	10	0	0
23	9959772	.	G	A	5	3	8	0	0	8	0	0
23	9962955	.	T	C	3	6	9	0	1	10	0	0
23	9963048	.	T	C	4	3	7	0	0	7	0	0
23	9963087	.	T	C	4	2	6	0	1	7	0	0
23	9963108	.	C	T	4	2	6	0	0	6	0	0
23	9965037	.	A	G	8	5	13	0	0	13	0	0
23	9967419	.	T	G	1	6	7	1	0	9	1	0
23	9967563	.	A	G	3	3	6	0	0	6	0	0
23	9967565	.	C	A	2	3	5	0	0	5	0	0
23	9973557	.	G	A	6	2	8	0	1	9	0	0
23	9985619	.	A	G	3	2	5	0	0	5	0	0
23	10032410	.	C	T	0	3	3	0	1	4	0	0
23	10045892	.	A	G	1	2	3	0	0	3	0	0
23	10045928	.	C	T	2	2	4	0	0	4	0	0
23	10174773	.	G	A	6	3	9	0	2	11	0	0
23	10174904	.	C	T	5	6	11	0	0	11	0	0
23	10174961	.	A	G	5	4	9	0	0	9	0	0
23	10250357	.	G	A	16	20	36	0	2	38	0	0
23	10251076	.	A	G	18	16	34	0	1	35	0	0
23	10251750	.	T	C	8	12	20	0	2	22	0	0
23	10252499	.	A	G	17	8	25	0	0	25	0	0
23	10252526	.	G	A	19	9	28	0	0	28	0	0
23	10252625	.	T	A	15	21	36	0	1	37	0	0
23	10254018	.	A	G	10	16	26	0	1	27	0	0
23	10254075	.	G	A	15	9	24	0	0	24	0	0
23	10254081	.	A	G	14	8	22	0	1	23	0	0
23	10348206	.	C	T	4	3	7	0	1	8	0	0
23	10350105	.	T	C	5	2	7	0	0	7	0	0
23	10351405	.	T	A	11	8	19	0	1	20	0	0
23	10405703	.	G	A	16	12	28	1	1	30	0	0
23	10417484	.	T	G	5	10	15	0	0	15	0	0
23	10417502	.	C	T	6	9	15	2	0	17	0	0
23	10423909	.	C	G	18	13	31	0	0	31	0	0
23	10423948	.	C	T	14	16	30	0	0	30	0	0
23	10426291	.	C	T	13	8	21	0	0	21	0	0
23	10448606	.	G	T	1	15	16	1	20	37	0	0
23	10448642	.	G	A	15	20	35	1	3	39	0	0
23	10449405	.	A	T	6	6	12	0	0	12	0	0
23	10638386	.	A	G	4	2	6	0	0	6	0	0
23	10638702	.	C	A	1	2	3	0	2	5	0	0
23	10638774	.	A	T	3	2	5	0	0	5	0	0
23	10638775	.	T	A	3	2	5	0	0	5	0	0
23	10639037	.	A	G	4	5	9	0	1	10	0	0
23	10642720	.	T	C	3	3	6	0	0	6	0	0
23	10642729	.	A	G	3	3	6	0	0	6	0	0
23	10644873	.	G	C	4	2	6	0	1	7	0	0
23	10644879	.	T	C	4	2	6	0	0	6	0	0
23	10645201	.	G	A	5	4	9	0	0	9	0	0
23	10669371	.	A	G	1	2	3	0	0	3	0	0
23	10696523	.	A	G	3	3	6	0	0	6	0	0
23	10724336	.	A	G	8	15	23	0	0	23	0	0
23	10725012	.	T	C	12	7	19	0	0	19	0	0
23	10725013	.	G	A	13	6	19	0	1	20	0	0
23	10725491	.	T	G	16	8	24	0	1	25	0	0
23	10725753	.	A	C	11	8	19	0	1	20	0	0
23	10745058	.	G	T	13	8	21	0	0	21	0	0
23	10745139	.	T	G	9	8	17	0	0	17	0	0
23	10762922	.	G	A	8	10	18	0	1	19	0	0
23	10763070	.	G	A	7	6	13	0	0	13	0	0
23	10763182	.	G	C	12	6	18	0	0	18	0	0
23	10763301	.	T	C	6	4	10	0	2	12	0	0
23	10763303	.	T	C	7	5	12	0	0	12	0	0
23	10771991	.	C	A	2	14	16	0	14	30	0	0
23	10805275	.	A	G	6	3	9	0	0	9	0	0
23	10805322	.	A	G	5	4	9	0	0	9	0	0
23	10817292	.	T	G	4	2	6	0	0	6	0	0
23	10825541	.	T	A	7	15	22	0	0	23	1	0
23	10825569	.	A	G	7	0	7	0	7	14	0	0
23	10825591	.	C	T	4	8	12	0	1	13	0	0
23	10825996	.	G	A	6	6	12	0	1	13	0	0
23	10826120	.	C	T	7	3	10	0	0	10	0	0
23	10826194	.	C	A	5	11	16	0	2	18	0	0
23	10826618	.	T	C	15	5	20	0	0	20	0	0
23	10826856	.	A	T	3	4	7	0	0	7	0	0
23	10828929	.	T	C	4	4	8	0	0	8	0	0
23	10829138	.	A	G	6	3	9	0	0	9	0	0
23	10829164	.	A	G	4	2	6	0	0	6	0	0
23	10913958	.	G	A	1	3	4	0	0	4	0	0
23	11669513	.	G	A	1	2	3	0	0	3	0	0
23	11669538	.	T	A	2	2	4	0	0	4	0	0
23	11764269	.	C	T	4	3	7	0	0	7	0	0
23	11772230	.	A	C	6	2	8	0	0	8	0	0
23	11772310	.	C	T	1	2	3	0	0	3	0	0
23	11843358	.	C	T	3	3	6	0	0	6	0	0
23	11848645	.	C	T	8	3	11	0	0	11	0	0
23	11851459	.	C	A	4	5	9	0	2	11	0	0
23	11851467	.	C	T	5	4	9	0	0	9	0	0
23	11851545	.	T	C	6	8	14	0	0	14	0	0
23	11861321	.	T	C	6	4	10	0	0	10	0	0
23	11861367	.	C	T	6	6	12	0	0	12	0	0
23	11861378	.	G	C	7	5	12	0	0	12	0	0
23	11864948	.	T	C	24	19	43	0	2	45	0	0
23	11865055	.	T	A	11	11	22	0	0	22	0	0
23	11865274	.	A	C	11	14	25	0	0	25	0	0
23	11865510	.	T	C	21	16	37	0	4	41	0	0
23	11865545	.	A	G	25	21	46	0	0	46	0	0
23	11866086	.	G	A	16	23	39	0	2	41	0	0
23	11866259	.	T	C	25	23	48	0	2	50	0	0
23	11870063	.	T	C	22	0	22	0	13	35	0	0
23	11871807	.	G	A	9	18	27	0	1	28	0	0
23	11872533	.	A	G	18	15	33	0	2	35	0	0
23	11878173	.	A	G	15	16	31	0	2	33	0	0
23	11920705	.	G	A	3	7	10	0	2	12	0	0
23	12014796	.	C	T	15	18	33	0	1	34	0	0
23	12014872	.	T	C	19	2	21	0	11	32	0	0
23	12150658	.	G	A	5	4	9	0	0	9	0	0
23	12155166	.	G	A	8	12	20	0	0	20	0	0
23	12155298	.	G	A	13	8	21	0	3	24	0	0
23	12155319	.	G	A	20	8	28	0	2	30	0	0
23	12155364	.	A	G	18	5	23	0	0	23	0	0
23	12158399	.	G	A	9	3	12	0	1	13	0	0
23	12161145	.	T	A	1	2	3	0	0	3	0	0
23	12161851	.	T	A	3	4	7	0	0	7	0	0
23	12232873	.	G	A	11	4	15	0	0	15	0	0
23	12233117	.	G	A	13	12	25	0	1	26	0	0
23	12260903	.	T	C	12	12	24	0	0	24	0	0
23	12278655	.	A	C	10	10	20	0	0	20	0	0
23	12429291	.	C	T	1	2	3	0	0	3	0	0
23	12487331	.	C	T	2	3	5	0	0	5	0	0
23	12612350	.	A	G	4	4	8	0	0	8	0	0
23	12612427	.	A	G	2	0	2	0	2	4	0	0
23	13558711	.	C	T	4	3	7	0	0	7	0	0
23	13567257	.	G	T	2	6	8	0	0	8	0	0
23	13589383	.	A	G	4	3	7	0	0	7	0	0
23	13598632	.	T	C	6	5	11	0	2	13	0	0
23	13598679	.	C	T	6	7	13	0	0	13	0	0
23	13598766	.	A	C	7	7	14	0	0	14	0	0
23	13722254	.	G	A	1	6	7	0	5	12	0	0
23	13722335	.	T	G	8	0	8	0	11	19	0	0
23	13722416	.	C	A	10	7	17	0	0	17	0	0
23	13806444	.	T	C	15	19	34	0	0	34	0	0
23	13832393	.	A	G	3	2	5	0	0	5	0	0
23	13832412	.	T	C	4	5	9	0	0	9	0	0
23	13833376	.	T	A	14	14	28	0	1	29	0	0
23	13835932	.	C	A	10	10	20	0	1	21	0	0
23	13839846	.	A	G	12	10	22	0	1	23	0	0
23	13840362	.	C	T	0	8	8	0	13	21	0	0
23	13845114	.	A	C	5	11	16	0	0	16	0	0
23	13845149	.	T	G	7	10	17	0	1	18	0	0
23	13845201	.	A	G	6	6	12	0	0	12	0	0
23	13845247	.	G	T	7	4	11	0	1	12	0	0
23	13845447	.	T	C	13	4	17	0	0	17	0	0
23	13845480	.	T	A	13	5	18	0	0	18	0	0
23	13845493	.	T	C	11	0	11	0	3	14	0	0
23	13845544	.	C	T	8	8	16	0	0	16	0	0
23	13845558	.	C	T	1	8	9	0	5	14	0	0
23	13845764	.	A	G	5	3	8	0	0	8	0	0
23	13846207	.	A	T	4	2	6	0	0	6	0	0
23	13846482	.	G	T	6	2	8	0	0	8	0	0
23	13846540	.	C	A	4	2	6	0	0	6	0	0
23	13846664	.	T	C	3	2	5	0	0	5	0	0
23	13846854	.	C	T	1	4	5	0	0	5	0	0
23	13846885	.	A	G	2	4	6	0	0	6	0	0
23	13846917	.	T	G	2	6	8	0	0	8	0	0
23	13847093	.	T	A	2	3	5	0	0	5	0	0
23	13847220	.	T	C	5	4	9	0	0	9	0	0
23	13848537	.	G	A	4	6	10	0	0	10	0	0
23	13850343	.	A	G	3	9	12	0	0	12	0	0
23	13851386	.	A	C	3	4	7	0	0	7	0	0
23	13851392	.	A	G	5	6	11	0	0	11	0	0
23	13851458	.	T	C	8	9	17	0	0	17	0	0
23	13941275	.	C	T	8	6	14	0	0	14	0	0
23	13944394	.	A	G	8	6	14	0	1	15	0	0
23	13948990	.	A	G	9	12	21	0	0	21	0	0
23	13948993	.	G	A	9	11	20	0	1	21	0	0
23	13949074	.	T	C	13	8	21	0	1	22	0	0
23	13949089	.	T	C	11	7	18	0	1	19	0	0
23	13949110	.	C	T	1	4	5	0	14	19	0	0
23	13963821	.	A	T	1	5	6	0	0	6	0	0
23	13986276	.	G	A	5	5	10	0	0	10	0	0
23	14006105	.	G	A	6	6	12	0	1	13	0	0
23	14056595	.	A	G	5	7	12	0	0	12	0	0
23	14056679	.	G	A	4	3	7	0	0	7	0	0
23	14059036	.	A	G	4	4	8	1	1	10	0	0
23	14059063	.	G	A	2	6	8	1	0	9	0	0
23	14145826	.	A	G	4	0	4	0	4	8	0	0
23	14159182	.	A	G	2	4	6	0	0	6	0	0
23	14179725	.	T	G	1	4	5	0	0	5	0	0
23	14193640	.	T	C	6	6	12	0	1	13	0	0
23	14193649	.	G	T	5	6	11	1	2	14	0	0
23	14193777	.	C	T	9	6	15	0	1	16	0	0
23	14193851	.	A	G	15	13	28	0	1	29	0	0
23	14194101	.	T	A	13	8	21	0	2	23	0	0
23	14194125	.	A	G	12	11	23	0	1	24	0	0
23	14198137	.	G	A	14	10	24	0	1	25	0	0
23	14201512	.	T	C	8	10	18	0	0	18	0	0
23	14201521	.	T	C	7	10	17	0	1	18	0	0
23	14203829	.	T	G	10	10	20	0	0	20	0	0
23	14208718	.	A	G	6	15	21	0	0	21	0	0
23	14208817	.	A	T	14	13	27	0	1	28	0	0
23	14209024	.	T	G	16	9	25	0	1	26	0	0
23	14211707	.	C	T	21	11	32	0	1	33	0	0
23	14217769	.	G	A	0	4	4	0	6	10	0	0
23	14217799	.	G	A	5	2	7	0	1	8	0	0
23	14222913	.	A	G	5	5	10	0	0	10	0	0
23	14230410	.	A	T	6	2	8	0	0	8	0	0
23	14265152	.	A	G	4	7	11	0	2	13	0	0
23	14265182	.	C	T	7	4	11	1	1	13	0	0
23	14265220	.	A	T	7	7	14	1	1	16	0	0
23	14320390	.	T	C	3	8	11	0	0	11	0	0
23	14432386	.	C	A	3	3	6	0	0	6	0	0
23	14432447	.	T	C	7	5	12	0	0	12	0	0
23	14590894	.	T	C	2	2	4	0	0	4	0	0
23	14720159	.	G	A	3	4	7	0	0	7	0	0
23	14720234	.	G	A	1	6	7	0	2	9	0	0
23	14743092	.	A	G	6	2	8	0	0	8	0	0
23	14743099	.	G	A	6	2	8	0	0	8	0	0
23	14743154	.	G	A	1	2	3	0	0	3	0	0
23	14743404	.	C	A	1	3	4	0	1	5	0	0
23	14743419	.	G	A	1	2	3	0	1	4	0	0
23	14743447	.	G	A	5	3	8	0	0	8	0	0
23	14743497	.	A	G	3	3	6	0	0	6	0	0
23	14757409	.	T	C	2	3	5	0	0	5	0	0
23	14769407	.	G	A	5	3	8	0	0	8	0	0
23	14772079	.	G	A	3	3	6	0	1	7	0	0
23	14777039	.	A	C	5	6	11	0	0	11	0	0
23	14780393	.	C	A	5	4	9	0	0	9	0	0
23	14780650	.	A	C	4	5	9	0	0	9	0	0
23	14782566	.	A	G	2	5	7	0	0	7	0	0
23	14782599	.	C	T	3	3	6	0	0	6	0	0
23	14782617	.	G	T	5	3	8	0	0	8	0	0
23	14784198	.	T	A	6	4	10	0	0	10	0	0
23	14786347	.	T	C	5	4	9	0	0	9	0	0
23	14786429	.	A	T	4	5	9	0	3	12	0	0
23	14787372	.	T	C	9	3	12	0	0	12	0	0
23	14787378	.	A	G	8	0	8	0	4	12	0	0
23	14787409	.	G	A	0	6	6	0	6	12	0	0
23	14787426	.	G	A	9	9	18	0	0	18	0	0
23	14790429	.	G	A	9	3	12	0	1	13	0	0
23	14790659	.	T	C	7	4	11	0	1	12	0	0
23	14790795	.	A	G	5	3	8	0	0	8	0	0
23	14790827	.	G	A	7	6	13	0	0	13	0	0
23	14790881	.	A	T	5	9	14	0	0	14	0	0
23	14799653	.	T	C	6	8	14	0	0	14	0	0
23	14808335	.	C	T	2	2	4	0	0	4	0	0
23	14808399	.	G	A	2	3	5	0	0	5	0	0
23	14808537	.	G	T	3	4	7	0	2	9	0	0
23	14809613	.	C	A	5	3	8	0	1	9	0	0
23	14825487	.	G	C	2	3	5	0	0	5	0	0
23	14825527	.	T	A	1	2	3	0	0	3	0	0
23	14832585	.	T	G	7	11	18	0	5	23	0	0
23	14832733	.	G	A	15	32	47	0	1	48	0	0
23	14832740	.	A	C	18	29	47	0	2	49	0	0
23	14832866	.	C	T	19	36	55	0	2	57	0	0
23	14832941	.	C	A	5	29	34	0	25	59	0	0
23	14833142	.	A	T	19	36	55	0	1	56	0	0
23	14833143	.	A	T	19	30	49	0	7	56	0	0
23	14833389	.	A	C	37	15	52	0	0	52	0	0
23	14861741	.	A	G	20	31	51	0	3	54	0	0
23	14990819	.	G	T	13	13	26	0	5	31	0	0
23	14993089	.	G	A	16	13	29	0	1	30	0	0
23	14993302	.	A	C	15	11	26	0	0	26	0	0
23	14993393	.	C	A	12	7	19	0	0	19	0	0
23	14993421	.	G	A	8	6	14	0	0	14	0	0
23	14993438	.	A	G	8	7	15	0	2	18	1	0
23	14993493	.	A	T	8	14	22	0	0	22	0	0
23	14993525	.	A	T	10	8	18	0	0	18	0	0
23	14993563	.	C	G	12	6	18	0	2	20	0	0
23	14997341	.	A	G	14	15	29	0	0	29	0	0
23	14999053	.	C	T	12	15	27	0	1	28	0	0
23	14999095	.	C	T	3	14	17	0	13	30	0	0
23	15003551	.	T	C	11	0	11	0	14	25	0	0
23	15022206	.	T	C	10	0	10	0	16	26	0	0
23	15022511	.	C	T	11	7	18	0	0	18	0	0
23	15022526	.	C	T	10	7	17	0	1	18	0	0
23	15025084	.	G	C	9	0	9	0	4	13	0	0
23	15036698	.	G	A	9	8	17	0	1	18	0	0
23	15046644	.	T	C	2	0	2	0	4	6	0	0
23	15046819	.	G	A	4	4	8	0	0	8	0	0
23	15047157	.	C	T	2	3	5	0	0	5	0	0
23	15047322	.	T	C	3	7	10	0	0	10	0	0
23	15047674	.	A	G	4	4	8	0	0	8	0	0
23	15047745	.	C	T	0	3	3	0	4	7	0	0
23	15047979	.	A	G	2	2	4	0	0	4	0	0
23	15048070	.	A	G	1	2	3	0	0	3	0	0
23	15050912	.	T	C	1	4	5	0	0	5	0	0
23	15053319	.	T	C	4	0	4	0	5	9	0	0
23	15053433	.	A	G	3	3	6	0	0	6	0	0
23	15076070	.	T	C	2	4	6	0	1	7	0	0
23	15087289	.	G	A	2	4	6	0	0	6	0	0
23	15087550	.	T	C	3	2	5	0	0	5	0	0
23	15087562	.	T	C	3	2	5	0	0	5	0	0
23	15204028	.	C	T	24	15	39	0	0	39	0	0
23	15204038	.	T	G	24	12	36	0	1	37	0	0
23	15204222	.	C	T	0	15	15	0	19	34	0	0
23	15204321	.	T	A	20	10	30	0	0	30	0	0
23	15204324	.	T	A	21	11	32	0	1	33	0	0
23	15204417	.	A	G	21	16	37	0	1	38	0	0
23	15204926	.	C	A	13	12	25	0	1	26	0	0
23	15204936	.	G	T	13	10	23	0	5	28	0	0
23	15205100	.	T	G	19	12	31	0	3	34	0	0
23	15205428	.	A	T	23	16	39	0	0	39	0	0
23	15205487	.	C	G	16	24	40	0	1	41	0	0
23	15211253	.	G	C	24	17	41	0	1	42	0	0
23	15215709	.	G	A	23	22	45	0	1	46	0	0
23	15216664	.	G	T	17	15	32	0	1	33	0	0
23	15222509	.	G	A	19	22	41	0	2	43	0	0
23	15222521	.	C	T	21	20	41	0	0	41	0	0
23	15259821	.	G	A	10	16	26	0	3	29	0	0
23	15284602	.	G	T	15	14	29	0	0	29	0	0
23	15284668	.	A	G	11	9	20	0	0	20	0	0
23	15284671	.	G	A	11	9	20	0	0	20	0	0
23	15851064	.	A	G	9	11	20	0	0	20	0	0
23	15851506	.	C	G	18	20	38	0	0	38	0	0
23	15854004	.	T	C	15	19	34	0	1	35	0	0
23	15854102	.	A	C	24	15	39	0	1	40	0	0
23	15861092	.	C	T	1	16	17	0	13	30	0	0
23	15861536	.	T	C	11	13	24	0	1	25	0	0
23	15872605	.	T	A	16	12	28	0	9	37	0	0
23	15900255	.	C	T	10	7	17	0	0	17	0	0
23	15900330	.	G	A	18	12	30	0	0	30	0	0
23	15900387	.	G	A	16	15	31	0	0	31	0	0
23	15916232	.	A	T	11	17	28	0	0	28	0	0
23	16430779	.	G	A	0	2	2	0	1	3	0	0
23	16640852	.	A	G	18	0	18	0	11	29	0	0
23	16640925	.	A	G	12	17	29	0	1	30	0	0
23	16641017	.	A	G	16	12	28	0	3	31	0	0
23	16648643	.	A	G	3	3	6	0	1	7	0	0
23	16649021	.	C	G	9	0	9	2	2	18	5	0
23	16660094	.	G	T	8	17	25	0	2	27	0	0
23	16748903	.	A	T	7	5	12	0	0	12	0	0
23	16748915	.	T	A	7	6	13	0	0	13	0	0
23	16753735	.	T	C	3	11	14	0	1	15	0	0
23	16757414	.	T	G	14	0	14	0	7	21	0	0
23	16761407	.	A	G	1	8	9	0	0	9	0	0
23	16762022	.	A	T	3	8	11	0	1	12	0	0
23	16762698	.	A	G	1	0	1	0	4	5	0	0
23	16769255	.	T	C	2	8	10	0	0	10	0	0
23	16769700	.	A	G	3	3	6	1	0	7	0	0
23	16769949	.	T	C	2	3	5	0	0	5	0	0
23	16769991	.	T	G	2	0	2	0	7	9	0	0
23	16770091	.	A	G	2	0	2	1	4	7	0	0
23	16770121	.	G	A	0	2	2	1	5	8	0	0
23	16810343	.	A	G	1	7	8	0	1	9	0	0
23	16821940	.	T	C	2	6	8	0	1	9	0	0
23	16831230	.	A	T	2	3	5	0	0	5	0	0
23	16831386	.	G	A	2	7	9	0	1	10	0	0
23	16831507	.	A	T	4	2	6	0	0	6	0	0
23	16831822	.	G	A	0	4	4	0	1	5	0	0
23	16849383	.	A	G	2	5	7	0	0	7	0	0
23	16881359	.	T	C	2	2	4	0	0	4	0	0
23	16881471	.	G	A	1	2	3	0	0	3	0	0
23	16883250	.	G	A	1	2	3	1	0	4	0	0
23	16883689	.	A	T	3	3	6	0	0	6	0	0
23	16961626	.	T	C	3	2	5	0	0	5	0	0
23	16964140	.	G	A	6	5	11	0	0	11	0	0
23	16966370	.	G	A	4	2	6	0	0	6	0	0
23	16971941	.	A	T	2	2	4	0	0	4	0	0
23	16971989	.	G	A	2	3	5	0	0	5	0	0
23	16977316	.	C	A	0	3	3	0	1	4	0	0
23	16977322	.	C	T	1	3	4	0	0	4	0	0
23	17012548	.	G	A	2	2	4	0	0	4	0	0
23	17018886	.	G	A	2	2	4	0	0	4	0	0
23	17113842	.	A	G	4	4	8	0	0	8	0	0
23	17221056	.	G	A	3	3	6	0	0	6	0	0
23	17339044	.	C	T	6	7	13	0	0	13	0	0
23	17340346	.	G	A	1	3	4	0	7	11	0	0
23	17346121	.	T	C	3	2	5	0	0	5	0	0
23	17355498	.	G	T	4	2	6	0	1	7	0	0
23	17385136	.	A	G	5	3	8	0	2	10	0	0
23	17447240	.	A	G	17	9	26	0	0	26	0	0
23	17450650	.	G	T	13	17	30	0	1	31	0	0
23	17450660	.	T	A	16	14	30	0	0	30	0	0
23	17473187	.	C	T	10	8	18	0	0	18	0	0
23	17473278	.	C	G	12	7	19	0	2	21	0	0
23	17473309	.	G	A	10	11	21	0	0	21	0	0
23	17473649	.	T	A	12	6	18	0	0	18	0	0
23	17473779	.	G	A	20	21	41	0	0	41	0	0
23	17473857	.	A	G	14	23	37	0	1	38	0	0
23	17474206	.	A	T	6	3	9	0	1	10	0	0
23	17474438	.	T	A	2	3	5	0	0	5	0	0
23	17474577	.	A	T	10	10	20	0	0	20	0	0
23	17474592	.	G	A	13	15	28	0	0	28	0	0
23	17474801	.	T	G	11	12	23	0	2	25	0	0
23	17476145	.	T	A	8	6	14	0	0	14	0	0
23	17476164	.	C	T	12	3	15	0	0	15	0	0
23	17476792	.	A	T	4	6	10	0	0	10	0	0
23	17476947	.	T	C	3	3	6	0	1	8	1	0
23	17477252	.	C	T	9	15	24	0	0	24	0	0
23	17477384	.	A	C	16	25	41	0	0	41	0	0
23	17484395	.	C	T	22	12	34	0	1	35	0	0
23	17484492	.	T	A	4	4	8	0	0	8	0	0
23	17509537	.	A	G	13	16	29	0	0	29	0	0
23	17516759	.	A	G	22	16	38	0	0	38	0	0
23	17516889	.	C	T	13	13	26	0	3	29	0	0
23	17516897	.	C	T	14	15	29	0	0	29	0	0
23	17516945	.	G	A	14	15	29	0	2	31	0	0
23	17520086	.	A	T	19	16	35	0	0	35	0	0
23	17520632	.	A	T	3	5	8	0	1	9	0	0
23	17520870	.	T	C	1	8	9	0	0	9	0	0
23	17656044	.	A	G	7	10	17	0	0	17	0	0
23	17656477	.	G	A	20	8	28	0	2	30	0	0
23	17656654	.	G	A	14	7	21	0	0	21	0	0
23	17657130	.	T	G	9	7	16	1	0	18	1	0
23	17657325	.	A	G	11	7	18	0	0	18	0	0
23	17812711	.	C	T	29	18	47	0	2	49	0	0
23	17812720	.	T	A	19	30	49	0	1	50	0	0
23	17812755	.	G	T	18	26	44	0	0	44	0	0
23	17813057	.	G	A	23	14	37	1	0	38	0	0
23	17813161	.	T	A	17	24	41	2	0	43	0	0
23	17813717	.	G	A	29	21	50	0	0	50	0	0
23	17813952	.	G	T	9	9	18	0	0	18	0	0
23	17814056	.	G	A	20	23	43	0	0	43	0	0
23	17814223	.	C	T	19	15	34	0	8	42	0	0
23	17814281	.	G	T	21	19	40	0	2	43	1	0
23	17814299	.	A	C	26	14	40	0	2	42	0	0
23	17814408	.	A	C	18	7	25	0	2	27	0	0
23	17842285	.	G	A	3	2	5	0	0	5	0	0
23	17848981	.	A	G	5	2	7	0	0	7	0	0
23	17849044	.	T	A	2	3	5	0	0	5	0	0
23	17849275	.	T	G	11	10	21	0	0	21	0	0
23	17849296	.	C	G	1	13	14	0	13	27	0	0
23	17849627	.	C	T	5	12	17	0	2	19	0	0
23	17851768	.	C	T	1	6	7	0	6	13	0	0
23	17853145	.	T	G	5	5	10	0	1	11	0	0
23	17855427	.	C	A	4	5	9	0	0	9	0	0
23	17857831	.	G	A	7	5	12	0	0	12	0	0
23	17870234	.	C	T	1	3	4	0	0	4	0	0
23	17871143	.	C	G	1	3	4	0	0	4	0	0
23	17871220	.	A	G	1	0	1	1	2	4	0	0
23	17873750	.	C	A	42	36	78	0	3	81	0	0
23	17874583	.	G	C	1	5	6	0	0	6	0	0
23	17879107	.	C	T	3	4	7	0	0	7	0	0
23	17879152	.	A	T	2	5	7	0	1	8	0	0
23	17879153	.	A	C	5	2	7	0	1	8	0	0
23	17880800	.	C	T	4	7	11	0	1	12	0	0
23	17901655	.	A	G	1	0	1	0	4	5	0	0
23	17903519	.	G	A	0	4	4	0	6	10	0	0
23	17903574	.	C	T	2	2	4	0	2	6	0	0
23	17907323	.	A	C	2	3	5	0	0	5	0	0
23	17994101	.	T	A	5	2	7	0	1	8	0	0
23	17994148	.	A	T	7	3	10	0	1	11	0	0
23	17994274	.	C	G	8	3	11	0	1	12	0	0
23	17994354	.	T	C	2	16	18	0	1	19	0	0
23	17994359	.	C	T	16	3	19	0	0	19	0	0
23	17994615	.	T	C	3	2	5	0	0	5	0	0
23	17995169	.	A	T	1	1	2	0	2	4	0	0
23	17995469	.	G	T	11	3	14	0	0	14	0	0
23	17995548	.	A	C	3	5	8	0	0	8	0	0
23	17997033	.	A	G	2	5	7	0	0	7	0	0
23	17997043	.	T	C	1	1	2	0	6	8	0	0
23	18001836	.	A	C	4	6	10	0	1	11	0	0
23	18004297	.	A	G	2	9	11	0	0	11	0	0
23	18032772	.	G	A	3	2	5	0	0	5	0	0
23	18057311	.	G	A	2	3	5	0	1	6	0	0
23	18118653	.	A	T	4	2	6	0	1	7	0	0
23	18118922	.	G	A	15	25	40	0	1	41	0	0
23	18119166	.	C	T	20	20	40	0	1	41	0	0
23	18119192	.	T	C	17	0	17	0	20	37	0	0
23	18119399	.	A	G	14	15	29	0	3	32	0	0
23	18286781	.	G	A	5	5	10	0	1	11	0	0
23	18286782	.	C	T	5	6	11	0	0	11	0	0
23	18372124	.	A	T	4	4	8	0	0	8	0	0
23	18372135	.	C	T	5	4	9	0	0	9	0	0
23	18375847	.	G	A	13	18	31	0	1	32	0	0
23	18375853	.	T	C	18	2	20	0	15	35	0	0
23	18387709	.	T	A	27	24	51	0	3	54	0	0
23	18388004	.	G	A	15	24	39	0	3	42	0	0
23	18388166	.	T	A	16	10	26	0	2	28	0	0
23	18388476	.	G	A	12	10	22	0	1	23	0	0
23	18388555	.	A	G	14	18	32	0	1	33	0	0
23	18388620	.	A	C	9	12	21	0	1	22	0	0
23	18388685	.	G	A	15	11	26	0	1	27	0	0
23	18388764	.	G	A	15	9	24	0	1	25	0	0
23	18388858	.	T	G	7	10	17	4	0	21	0	0
23	18388954	.	G	A	15	7	22	0	0	22	0	0
23	18389594	.	G	T	19	13	32	0	0	32	0	0
23	18390402	.	G	A	11	13	24	0	0	24	0	0
23	18390635	.	G	A	12	8	20	0	1	21	0	0
23	18390758	.	T	C	10	0	10	0	17	27	0	0
23	18390780	.	C	T	17	6	23	0	0	23	0	0
23	18391490	.	G	A	9	8	17	0	0	17	0	0
23	18394401	.	T	G	17	8	25	0	2	27	0	0
23	18405812	.	C	T	6	13	19	0	0	19	0	0
23	18405862	.	A	G	10	5	15	0	0	15	0	0
23	18406479	.	G	A	8	7	15	0	0	15	0	0
23	18406573	.	C	A	9	11	20	0	1	21	0	0
23	18409242	.	C	T	11	12	23	0	2	25	0	0
23	18415329	.	G	C	8	5	13	0	2	16	1	0
23	18415427	.	T	A	11	11	22	0	0	22	0	0
23	18415493	.	C	A	1	9	10	0	6	16	0	0
23	18537386	.	C	T	2	4	6	0	0	6	0	0
23	18561051	.	T	C	6	3	9	0	2	11	0	0
23	18561289	.	T	A	18	16	34	0	1	35	0	0
23	18561434	.	C	T	1	10	11	0	16	27	0	0
23	18562299	.	A	T	2	3	5	0	2	7	0	0
23	18562358	.	T	G	3	8	11	0	1	12	0	0
23	18562427	.	C	T	6	4	10	0	0	10	0	0
23	18562484	.	G	A	9	5	14	0	1	15	0	0
23	18562522	.	A	C	12	9	21	1	0	22	0	0
23	18562623	.	C	T	13	12	25	0	0	25	0	0
23	18562911	.	C	A	2	14	16	0	16	32	0	0
23	18563951	.	G	T	12	8	20	0	1	21	0	0
23	18563952	.	T	C	11	0	11	0	9	20	0	0
23	18568144	.	G	A	9	10	19	0	0	19	0	0
23	18568206	.	G	A	7	8	15	0	0	15	0	0
23	18569380	.	T	A	5	5	10	0	0	10	0	0
23	18569455	.	T	G	7	10	17	0	3	20	0	0
23	18569462	.	T	A	12	11	23	0	0	23	0	0
23	18569543	.	T	C	19	6	25	0	5	30	0	0
23	18569625	.	A	G	16	17	33	0	3	36	0	0
23	18570887	.	C	T	13	13	26	0	0	26	0	0
23	18572547	.	T	A	16	15	31	1	1	33	0	0
23	18572605	.	T	A	6	8	14	0	2	16	0	0
23	18572618	.	G	A	7	5	12	0	1	13	0	0
23	18574353	.	G	A	11	7	18	0	0	18	0	0
23	18574720	.	T	C	15	14	29	0	3	32	0	0
23	18574800	.	C	T	2	16	18	0	10	28	0	0
23	18580933	.	C	A	14	19	33	0	0	33	0	0
23	18580939	.	C	A	1	10	11	0	19	30	0	0
23	18581065	.	A	G	18	14	32	0	1	33	0	0
23	18581835	.	G	A	17	21	38	0	0	38	0	0
23	18581933	.	T	G	13	25	38	0	2	40	0	0
23	18584225	.	G	A	20	11	31	0	1	32	0	0
23	18586793	.	C	T	4	9	13	1	13	27	0	0
23	18588969	.	C	T	13	10	23	0	1	24	0	0
23	18597667	.	G	A	7	16	23	0	1	24	0	0
23	18616517	.	A	T	8	6	14	0	1	15	0	0
23	18616880	.	T	A	13	11	24	0	1	25	0	0
23	18616980	.	C	G	5	4	9	0	0	9	0	0
23	18617300	.	G	A	9	10	19	0	2	21	0	0
23	18619766	.	C	T	11	11	22	0	2	24	0	0
23	18622541	.	T	G	12	8	20	0	0	20	0	0
23	18628460	.	T	G	21	10	31	0	0	31	0	0
23	18628746	.	C	T	7	10	17	0	4	21	0	0
23	18629024	.	T	C	8	8	16	0	0	16	0	0
23	18651789	.	G	A	9	8	17	0	1	18	0	0
23	18651918	.	C	A	10	9	19	0	2	21	0	0
23	18668440	.	T	C	9	11	20	0	1	21	0	0
23	18702862	.	A	G	1	6	7	0	0	7	0	0
23	18702863	.	G	A	1	6	7	0	0	7	0	0
23	18759802	.	C	A	7	3	10	0	0	10	0	0
23	18759827	.	T	C	4	7	11	0	0	11	0	0
23	18759973	.	T	G	10	3	13	1	0	14	0	0
23	18760004	.	G	C	6	0	6	0	5	11	0	0
23	18760049	.	T	A	8	6	14	0	0	14	0	0
23	18760223	.	T	A	4	2	6	0	0	6	0	0
23	18760519	.	T	A	8	12	20	0	1	21	0	0
23	18764770	.	A	C	7	4	11	0	0	11	0	0
23	18774122	.	T	C	5	2	7	1	0	8	0	0
23	18777816	.	C	T	10	8	18	0	0	18	0	0
23	18795055	.	T	C	4	7	11	0	1	12	0	0
23	18795620	.	A	G	16	19	35	0	0	35	0	0
23	18795721	.	C	T	17	19	36	0	1	37	0	0
23	18801275	.	G	A	21	16	37	0	1	38	0	0
23	18870235	.	A	T	9	3	12	0	0	12	0	0
23	18870245	.	T	C	5	1	6	0	8	14	0	0
23	18870716	.	G	T	4	8	12	0	1	13	0	0
23	18944489	.	A	G	8	14	22	0	0	22	0	0
23	18944543	.	G	A	1	19	20	0	16	36	0	0
23	18947344	.	C	A	15	21	36	0	0	36	0	0
23	18947385	.	G	C	16	22	38	0	2	40	0	0
23	18950968	.	T	C	19	11	30	0	0	30	0	0
23	18950970	.	T	A	19	11	30	0	0	30	0	0
23	18951010	.	G	A	15	10	25	0	0	25	0	0
23	18954023	.	A	G	4	10	14	0	2	16	0	0
23	18954100	.	A	G	7	8	15	0	1	16	0	0
23	18954151	.	G	A	4	9	13	0	0	13	0	0
23	18954759	.	T	G	17	17	34	0	0	34	0	0
23	18979342	.	C	T	26	14	40	0	0	40	0	0
23	18979561	.	G	A	14	17	31	0	1	32	0	0
23	18979756	.	T	C	15	10	25	0	1	26	0	0
23	18982375	.	G	A	13	10	23	0	2	25	0	0
23	18986338	.	G	A	11	7	18	0	1	19	0	0
23	18986344	.	G	A	6	13	19	0	1	20	0	0
23	18990914	.	C	T	1	6	7	0	11	18	0	0
23	18993525	.	T	C	22	12	34	0	0	34	0	0
23	18993827	.	C	T	1	4	5	0	9	14	0	0
23	18996030	.	C	T	3	13	16	0	1	17	0	0
23	19003263	.	A	G	8	7	15	1	0	16	0	0
23	19005426	.	G	T	8	6	14	1	1	16	0	0
23	19005486	.	T	C	10	9	19	0	0	19	0	0
23	19005758	.	C	T	6	14	20	0	1	21	0	0
23	19005761	.	C	G	5	13	18	0	1	19	0	0
23	19007389	.	G	T	5	8	13	0	1	14	0	0
23	19008149	.	C	T	5	3	8	0	0	8	0	0
23	19012845	.	C	G	8	3	11	0	0	11	0	0
23	19017421	.	C	A	8	7	15	0	1	16	0	0
23	19022254	.	A	G	10	7	17	0	1	18	0	0
23	19022534	.	G	A	5	3	8	0	1	9	0	0
23	19027408	.	G	A	4	2	6	0	1	7	0	0
23	19027510	.	A	C	6	0	6	0	4	10	0	0
23	19036052	.	C	G	5	8	13	0	0	13	0	0
23	19051737	.	C	T	6	4	10	0	1	11	0	0
23	19051739	.	G	A	5	4	9	0	2	11	0	0
23	19051831	.	C	T	11	6	17	0	0	17	0	0
23	19106781	.	G	A	2	3	5	0	0	5	0	0
23	19118372	.	G	T	9	3	12	0	0	12	0	0
23	19153221	.	A	T	3	4	7	0	0	7	0	0
23	19198348	.	A	T	10	12	22	0	0	22	0	0
23	19198588	.	A	T	9	13	22	0	0	22	0	0
23	19200168	.	G	A	9	9	18	0	0	18	0	0
23	19201103	.	C	A	10	13	23	0	0	23	0	0
23	19201148	.	G	T	5	4	9	0	0	9	0	0
23	19203952	.	C	T	1	7	8	0	0	8	0	0
23	19204126	.	C	T	2	6	8	0	0	8	0	0
23	19204130	.	T	C	3	6	9	0	0	9	0	0
23	19204597	.	G	A	2	4	6	0	0	6	0	0
23	19204738	.	C	T	4	2	6	0	0	6	0	0
23	19205844	.	A	C	2	3	5	0	0	5	0	0
23	19206052	.	C	T	1	3	4	0	0	4	0	0
23	19206388	.	G	T	1	5	6	0	0	6	0	0
23	19220388	.	G	C	1	2	3	0	0	3	0	0
23	19222299	.	G	T	2	2	4	0	1	5	0	0
23	19474823	.	G	T	14	11	25	0	0	25	0	0
23	19483010	.	C	T	2	8	10	0	7	17	0	0
23	19483260	.	A	G	5	2	7	1	0	8	0	0
23	19483497	.	A	C	5	0	5	0	7	12	0	0
23	19484162	.	C	T	3	3	6	0	0	6	0	0
23	19575044	.	G	A	1	8	9	0	12	21	0	0
23	19575134	.	C	T	10	13	23	0	0	23	0	0
23	19577464	.	G	A	3	26	29	0	11	40	0	0
23	19582481	.	T	C	12	20	32	0	1	33	0	0
23	19582559	.	G	T	13	10	23	0	0	23	0	0
23	19582668	.	T	C	13	20	33	0	1	34	0	0
23	19582678	.	C	T	16	17	33	0	0	33	0	0
23	19583208	.	G	A	1	16	17	0	9	26	0	0
23	19583252	.	C	T	9	14	23	0	2	25	0	0
23	19603630	.	T	C	27	28	55	0	3	58	0	0
23	19603753	.	T	C	34	19	53	0	3	56	0	0
23	19603803	.	T	C	16	20	36	0	1	37	0	0
23	19603880	.	A	T	21	25	46	0	6	52	0	0
23	19603994	.	G	A	21	19	40	0	1	41	0	0
23	19604263	.	A	G	13	0	13	0	19	32	0	0
23	19604351	.	G	T	8	11	19	0	2	21	0	0
23	19670139	.	G	C	3	7	10	0	0	10	0	0
23	19670185	.	A	T	6	8	14	0	3	17	0	0
23	19672720	.	T	C	7	7	14	0	0	14	0	0
23	19673170	.	C	T	14	8	22	0	1	23	0	0
23	19673376	.	C	T	11	5	16	0	1	17	0	0
23	19712898	.	G	A	34	34	68	0	1	69	0	0
23	19713291	.	A	G	39	35	74	0	0	74	0	0
23	19713324	.	A	G	36	25	61	0	10	71	0	0
23	19787241	.	G	A	2	3	5	0	0	5	0	0
23	19787795	.	A	G	1	0	1	0	2	3	0	0
23	19788562	.	A	T	4	3	7	0	0	7	0	0
23	19790452	.	G	A	0	5	5	0	4	9	0	0
23	19790712	.	C	T	1	2	3	0	0	3	0	0
23	19792704	.	G	A	2	4	6	0	1	7	0	0
23	19792737	.	C	T	4	4	8	0	1	9	0	0
23	19792821	.	T	C	2	4	6	0	0	6	0	0
23	19796643	.	A	T	5	2	7	0	1	8	0	0
23	19796651	.	G	A	5	3	8	0	1	9	0	0
23	19798216	.	T	C	3	3	6	0	0	6	0	0
23	19800228	.	T	C	1	3	4	0	0	4	0	0
23	19804543	.	C	A	1	4	5	0	0	5	0	0
23	19804743	.	A	C	3	4	7	0	0	7	0	0
23	19804744	.	T	C	3	4	7	0	0	7	0	0
23	19804878	.	T	C	5	4	9	0	1	10	0	0
23	19805577	.	A	T	6	5	11	0	4	15	0	0
23	19808022	.	C	T	4	7	11	0	1	12	0	0
23	19808078	.	T	C	9	6	15	0	0	15	0	0
23	19808691	.	G	A	1	19	20	0	10	30	0	0
23	19808895	.	A	G	2	0	2	0	4	6	0	0
23	19815467	.	G	A	12	5	17	0	1	18	0	0
23	19816699	.	A	T	11	9	20	0	0	20	0	0
23	19821136	.	A	G	5	0	5	0	17	22	0	0
23	19821150	.	C	T	4	11	15	0	3	18	0	0
23	19821277	.	A	C	11	8	19	0	0	19	0	0
23	19821408	.	C	T	8	10	18	0	0	18	0	0
23	19821447	.	G	C	8	3	11	0	0	11	0	0
23	19821470	.	G	A	0	1	1	0	6	7	0	0
23	19821489	.	A	T	5	4	9	0	1	10	0	0
23	19821549	.	C	A	3	4	7	0	0	7	0	0
23	19822100	.	G	T	1	5	6	0	0	6	0	0
23	19827641	.	A	C	2	0	2	0	2	4	0	0
23	19836260	.	C	T	28	30	58	0	1	59	0	0
23	19837080	.	T	C	32	23	55	0	2	57	0	0
23	19837503	.	G	A	23	26	49	0	0	49	0	0
23	19837939	.	A	G	17	16	33	0	1	34	0	0
23	19837974	.	G	A	15	14	29	0	1	30	0	0
23	19838100	.	C	A	27	28	55	0	0	55	0	0
23	19838295	.	T	G	4	10	14	0	1	15	0	0
23	19838312	.	A	T	8	9	17	0	0	17	0	0
23	19838387	.	A	T	9	14	23	0	2	25	0	0
23	19838388	.	T	A	8	15	23	0	2	25	0	0
23	19838458	.	A	T	14	15	29	0	2	31	0	0
23	19838459	.	A	C	15	15	30	0	1	31	0	0
23	19869132	.	G	A	14	20	34	0	2	36	0	0
23	19871615	.	A	G	22	29	51	0	1	52	0	0
23	19879576	.	C	T	2	16	18	0	27	45	0	0
23	19883318	.	T	C	15	15	30	0	1	31	0	0
23	19893409	.	A	T	20	27	47	0	3	50	0	0
23	19933542	.	A	G	18	12	30	0	0	30	0	0
23	19933578	.	G	A	18	12	30	0	1	31	0	0
23	19933742	.	G	A	14	11	25	0	2	27	0	0
23	19933850	.	A	G	14	11	25	0	0	25	0	0
23	19933896	.	A	G	15	18	33	0	3	36	0	0
23	19933952	.	A	G	18	10	28	0	2	30	0	0
23	19952743	.	C	T	3	21	24	0	15	39	0	0
23	19952869	.	T	A	9	18	27	1	2	30	0	0
23	19969136	.	C	A	1	3	4	0	0	4	0	0
23	19969420	.	A	T	3	5	8	0	0	8	0	0
23	19969710	.	G	A	9	3	12	0	0	12	0	0
23	19974092	.	G	A	2	5	7	0	0	7	0	0
23	19976882	.	G	C	2	3	5	0	0	5	0	0
23	19978571	.	C	T	1	2	3	0	0	3	0	0
23	19980707	.	A	T	5	2	7	0	1	8	0	0
23	19981191	.	A	T	1	2	3	0	0	3	0	0
23	19981510	.	G	T	7	4	11	0	1	14	2	0
23	19981554	.	T	C	4	6	10	0	1	11	0	0
23	19981608	.	A	T	7	8	15	0	0	15	0	0
23	19985054	.	A	G	10	4	14	0	0	14	0	0
23	19985201	.	A	G	6	2	8	0	0	8	0	0
23	19985210	.	G	T	4	5	9	0	2	11	0	0
23	19985307	.	G	T	2	5	7	0	0	7	0	0
23	19985403	.	T	C	11	6	17	0	0	17	0	0
23	20000716	.	A	G	2	9	11	0	9	20	0	0
23	20002339	.	G	C	4	8	12	0	0	12	0	0
23	20002373	.	T	A	5	4	9	0	1	10	0	0
23	20002439	.	G	C	2	0	2	0	7	9	0	0
23	20002524	.	A	G	5	2	7	0	0	7	0	0
23	20010481	.	A	C	6	0	6	0	3	9	0	0
23	20014069	.	A	C	1	2	3	0	0	3	0	0
23	20014070	.	T	A	1	2	3	0	0	3	0	0
23	20014285	.	A	T	4	3	7	0	0	7	0	0
23	20014390	.	C	T	1	2	3	0	5	8	0	0
23	20014995	.	T	G	2	2	4	0	0	4	0	0
23	20014996	.	C	T	2	2	4	0	0	4	0	0
23	20015159	.	C	T	2	3	5	0	0	5	0	0
23	20015161	.	C	T	2	2	4	0	1	5	0	0
23	20051215	.	A	C	2	0	2	0	2	4	0	0
23	20051217	.	A	G	2	2	4	0	0	4	0	0
23	20113599	.	T	C	15	10	25	0	2	27	0	0
23	20113848	.	G	T	21	17	38	0	2	40	0	0
23	20114327	.	C	A	30	19	49	0	1	50	0	0
23	20117625	.	C	G	0	17	17	0	21	38	0	0
23	20117830	.	A	G	19	20	39	0	0	40	1	0
23	20117938	.	A	C	13	2	15	0	25	41	1	0
23	20118597	.	T	G	11	21	32	0	1	33	0	0
23	20118730	.	T	A	20	12	32	0	0	32	0	0
23	20120646	.	T	C	20	0	20	0	14	34	0	0
23	20121265	.	T	A	23	18	41	0	3	45	1	0
23	20121270	.	G	T	24	19	43	0	2	45	0	0
23	20121326	.	G	A	24	17	41	0	1	42	0	0
23	20122190	.	A	G	17	14	31	0	1	32	0	0
23	20123375	.	G	A	20	10	30	0	1	31	0	0
23	20123386	.	G	T	18	10	28	0	4	32	0	0
23	20123575	.	C	A	9	22	31	0	1	32	0	0
23	20123576	.	C	T	10	21	31	0	1	32	0	0
23	20123629	.	A	G	14	17	31	0	3	34	0	0
23	20137931	.	C	T	2	2	4	0	0	4	0	0
23	20139248	.	T	C	3	5	8	0	0	8	0	0
23	20141748	.	C	A	1	2	3	0	0	3	0	0
23	20141925	.	C	T	2	2	4	0	0	4	0	0
23	20143177	.	G	A	2	2	4	0	0	4	0	0
23	20145420	.	T	A	11	14	25	0	2	27	0	0
23	20145823	.	T	C	7	8	15	0	0	15	0	0
23	20146080	.	A	G	8	7	15	0	0	15	0	0
23	20152477	.	T	C	10	10	20	0	0	20	0	0
23	20152640	.	G	A	11	13	24	0	0	24	0	0
23	20154486	.	A	G	4	2	6	0	1	7	0	0
23	20157790	.	G	A	6	9	15	0	2	17	0	0
23	20157923	.	G	C	7	0	7	0	8	15	0	0
23	20157930	.	T	C	8	0	8	0	7	15	0	0
23	20162522	.	C	T	0	6	6	0	5	11	0	0
23	20167944	.	T	C	6	8	14	0	0	14	0	0
23	20167966	.	G	A	5	8	13	0	1	14	0	0
23	20168111	.	T	A	7	11	18	0	1	19	0	0
23	20168127	.	C	T	0	11	11	0	7	18	0	0
23	20168404	.	C	G	6	6	12	0	1	13	0	0
23	20168568	.	T	C	9	3	12	0	0	12	0	0
23	20168573	.	A	G	9	3	12	0	0	12	0	0
23	20168739	.	T	C	8	8	16	0	1	17	0	0
23	20169105	.	C	G	0	5	5	0	5	10	0	0
23	20170945	.	T	A	4	2	6	0	1	7	0	0
23	20183551	.	A	G	2	3	5	0	0	5	0	0
23	20189590	.	T	G	1	3	4	0	0	4	0	0
23	20261923	.	C	T	0	2	2	0	1	3	0	0
23	20262546	.	G	T	1	6	7	0	0	7	0	0
23	20262814	.	A	C	1	3	4	0	0	4	0	0
23	20264440	.	C	T	2	3	5	0	0	5	0	0
23	20264937	.	T	C	1	4	5	0	0	5	0	0
23	20267328	.	A	G	2	2	4	0	0	4	0	0
23	20278509	.	A	G	1	2	3	0	0	3	0	0
23	20902390	.	T	A	12	10	22	0	1	24	1	0
23	20931095	.	C	A	9	10	19	0	0	19	0	0
23	20931119	.	C	T	6	6	12	0	2	14	0	0
23	20936226	.	G	A	1	10	11	0	4	15	0	0
23	20936395	.	T	A	14	5	19	0	1	20	0	0
23	20936467	.	T	C	2	7	9	0	0	9	0	0
23	21087740	.	C	T	4	2	6	0	0	6	0	0
23	21089840	.	C	A	6	8	14	0	0	14	0	0
23	21106219	.	A	T	3	7	10	0	0	10	0	0
23	21108312	.	T	C	4	8	12	0	0	12	0	0
23	21111170	.	A	G	8	0	8	0	6	14	0	0
23	21113750	.	T	C	7	5	12	0	2	14	0	0
23	21113770	.	C	T	8	1	9	0	1	10	0	0
23	21114732	.	A	C	6	3	9	0	1	10	0	0
23	21264226	.	A	G	5	4	9	0	1	10	0	0
23	21265446	.	C	T	11	5	16	0	0	16	0	0
23	21266896	.	C	T	6	4	10	0	0	10	0	0
23	21268808	.	T	C	4	2	6	0	0	6	0	0
23	21269494	.	A	G	3	4	7	0	0	7	0	0
23	21269620	.	A	G	5	4	9	0	0	9	0	0
23	21269626	.	T	G	6	4	10	0	0	10	0	0
23	21269792	.	T	G	2	5	7	0	0	7	0	0
23	21272845	.	G	T	0	7	7	0	7	14	0	0
23	21272851	.	T	A	0	1	1	0	1	2	0	0
23	21276362	.	T	C	9	5	14	0	0	14	0	0
23	21277208	.	G	A	10	3	13	0	2	15	0	0
23	21277247	.	T	A	8	7	15	0	2	17	0	0
23	21295506	.	T	C	3	2	5	0	0	5	0	0
23	21305907	.	C	T	4	2	6	0	0	6	0	0
23	21306051	.	A	T	4	6	10	0	1	11	0	0
23	21306061	.	G	T	0	8	8	0	4	12	0	0
23	21309136	.	G	A	2	3	5	0	1	6	0	0
23	21313858	.	G	T	3	2	5	0	0	5	0	0
23	21314021	.	T	C	4	4	8	0	2	10	0	0
23	21314094	.	C	T	3	2	5	0	0	5	0	0
23	21316361	.	C	T	9	4	13	0	0	13	0	0
23	21317619	.	T	C	2	2	4	0	0	4	0	0
23	21317724	.	G	C	4	4	8	0	1	9	0	0
23	21325926	.	A	C	4	2	6	0	0	6	0	0
23	21325956	.	C	A	5	3	8	0	0	8	0	0
23	21326441	.	A	G	1	2	3	0	0	3	0	0
23	21328482	.	C	T	3	2	5	0	1	6	0	0
23	21330786	.	T	C	9	5	14	0	0	14	0	0
23	21330864	.	T	C	6	7	13	0	0	13	0	0
23	21331172	.	C	A	2	5	7	0	0	7	0	0
23	21331603	.	T	A	3	3	6	0	0	6	0	0
23	21338789	.	A	G	5	6	11	0	0	11	0	0
23	21338834	.	C	T	2	5	7	0	0	7	0	0
23	21338846	.	G	A	3	6	9	0	0	9	0	0
23	21338888	.	C	T	6	4	10	0	0	10	0	0
23	21339130	.	G	C	0	6	6	0	3	9	0	0
23	21339136	.	C	T	2	8	10	0	0	10	0	0
23	21341304	.	G	A	2	7	9	0	1	10	0	0
23	21343661	.	A	G	5	6	11	0	0	11	0	0
23	21343718	.	T	C	7	3	10	0	1	11	0	0
23	21343903	.	T	C	4	8	12	0	1	13	0	0
23	21349972	.	T	C	3	6	9	0	0	9	0	0
23	21350008	.	T	C	4	2	6	0	0	6	0	0
23	21352523	.	G	A	5	6	11	0	1	12	0	0
23	21353604	.	C	A	4	5	9	0	0	9	0	0
23	21353643	.	A	T	7	3	10	0	0	10	0	0
23	21353837	.	C	T	6	7	13	0	0	13	0	0
23	21356056	.	C	T	5	8	13	0	0	13	0	0
23	21361347	.	T	C	7	8	15	0	0	15	0	0
23	21361570	.	G	A	9	10	19	0	0	19	0	0
23	21362178	.	G	A	1	12	13	0	2	15	0	0
23	21362217	.	G	T	3	11	14	0	2	16	0	0
23	21362735	.	G	A	9	14	23	0	2	25	0	0
23	21362822	.	C	T	3	8	11	0	0	11	0	0
23	21363039	.	C	A	8	11	19	0	1	20	0	0
23	21364431	.	G	A	10	9	19	0	2	21	0	0
23	21364449	.	G	A	1	10	11	0	16	27	0	0
23	21364632	.	T	C	10	14	24	0	2	26	0	0
23	21364725	.	C	T	15	13	28	0	1	29	0	0
23	21366588	.	C	T	7	16	23	0	0	23	0	0
23	21366743	.	A	C	10	14	24	0	1	25	0	0
23	21366764	.	C	T	5	19	24	0	1	25	0	0
23	21367861	.	A	G	18	16	34	0	3	37	0	0
23	21367994	.	A	T	17	15	32	0	1	33	0	0
23	21368078	.	C	T	15	7	22	0	1	23	0	0
23	21368090	.	G	A	17	9	26	0	1	27	0	0
23	21368156	.	A	G	9	15	24	0	2	26	0	0
23	21368183	.	G	A	7	13	20	0	1	21	0	0
23	21369126	.	G	C	0	24	24	0	14	38	0	0
23	21369678	.	T	C	13	17	30	0	1	31	0	0
23	21369703	.	C	A	12	20	32	0	0	32	0	0
23	21369750	.	C	T	13	22	35	0	1	36	0	0
23	21376413	.	T	A	18	16	34	0	2	36	0	0
23	21376570	.	C	T	19	12	31	0	4	35	0	0
23	21376617	.	A	G	17	0	17	3	11	31	0	0
23	21376678	.	G	T	11	8	19	1	1	21	0	0
23	21376689	.	C	T	12	10	22	1	0	23	0	0
23	21376787	.	C	G	9	11	20	0	1	21	0	0
23	21380480	.	G	A	1	1	2	0	1	3	0	0
23	21452700	.	C	T	6	6	12	0	0	12	0	0
23	21452750	.	A	G	2	6	8	0	0	8	0	0
23	21452814	.	G	T	11	4	15	0	0	15	0	0
23	21455709	.	C	T	2	2	4	4	1	9	0	0
23	21455786	.	A	C	2	2	4	1	0	5	0	0
23	21455788	.	A	G	0	2	2	1	1	4	0	0
23	21456791	.	T	A	1	4	5	0	1	6	0	0
23	21456869	.	G	A	0	3	3	0	4	7	0	0
23	21483656	.	C	T	4	6	10	0	0	10	0	0
23	21483803	.	G	A	7	5	12	0	0	12	0	0
23	21484652	.	G	C	2	2	4	0	0	4	0	0
23	21488054	.	T	C	4	9	13	0	0	13	0	0
23	21488630	.	A	C	3	2	5	0	0	5	0	0
23	21488726	.	T	C	1	3	4	0	0	4	0	0
23	21488872	.	G	A	10	9	19	0	0	19	0	0
23	21489121	.	C	T	8	3	11	0	1	12	0	0
23	21489233	.	T	C	6	6	12	0	0	12	0	0
23	21489567	.	T	C	5	6	11	0	0	11	0	0
23	21489929	.	A	G	5	2	7	0	0	7	0	0
23	21490211	.	G	A	1	3	4	0	1	5	0	0
23	21492314	.	A	T	2	3	5	0	1	6	0	0
23	21492756	.	A	T	6	3	9	0	0	9	0	0
23	21492777	.	C	T	4	3	7	0	0	7	0	0
23	21498165	.	T	C	3	2	5	0	0	5	0	0
23	21498291	.	T	C	2	5	7	0	1	8	0	0
23	21498326	.	C	T	4	3	7	0	2	9	0	0
23	21498449	.	T	C	8	4	12	0	0	12	0	0
23	21498478	.	T	C	7	5	12	0	0	12	0	0
23	21569490	.	G	A	6	5	11	0	2	13	0	0
23	21618055	.	C	T	15	5	20	0	0	20	0	0
23	21626211	.	C	T	12	7	19	0	0	19	0	0
23	21630363	.	T	G	11	10	21	0	0	21	0	0
23	21630393	.	G	A	13	8	21	0	1	22	0	0
23	21630676	.	G	A	11	6	17	0	0	17	0	0
23	21630973	.	C	T	9	19	28	0	0	28	0	0
23	21638300	.	C	T	7	5	12	0	0	12	0	0
23	21647187	.	C	T	7	10	17	0	1	18	0	0
23	21647196	.	G	A	1	8	9	0	10	19	0	0
23	21661227	.	C	T	6	10	16	0	2	18	0	0
23	21661483	.	G	A	0	7	7	0	6	13	0	0
23	21674163	.	G	T	4	2	6	0	0	6	0	0
23	21674167	.	G	T	4	2	6	0	0	6	0	0
23	21721667	.	C	T	7	11	18	0	0	18	0	0
23	21721868	.	G	A	7	7	14	0	1	15	0	0
23	21734738	.	A	G	2	6	8	0	0	8	0	0
23	21741133	.	C	T	8	2	10	0	0	10	0	0
23	21744521	.	T	A	2	5	7	0	0	7	0	0
23	21744522	.	C	T	2	5	7	0	0	7	0	0
23	21744789	.	A	G	3	3	6	0	1	7	0	0
23	21744819	.	G	A	2	3	5	0	0	5	0	0
23	21744988	.	A	G	1	5	6	0	0	6	0	0
23	21748436	.	G	A	1	3	4	0	0	4	0	0
23	21753024	.	C	A	2	4	6	0	0	6	0	0
23	21754894	.	A	G	1	2	3	0	0	3	0	0
23	21796976	.	G	A	2	2	4	0	0	4	0	0
23	21797387	.	G	A	11	4	15	0	0	15	0	0
23	21803685	.	G	A	1	4	5	0	0	5	0	0
23	21803801	.	T	C	1	6	7	0	0	7	0	0
23	21803918	.	A	C	0	3	3	0	0	3	0	0
23	21803925	.	T	A	3	1	4	0	0	4	0	0
23	21804394	.	T	A	3	2	5	0	0	5	0	0
23	21805236	.	C	T	1	2	3	0	3	6	0	0
23	21805289	.	T	A	3	4	7	0	0	7	0	0
23	21805621	.	C	A	3	2	5	0	0	5	0	0
23	21805710	.	C	T	1	2	3	0	0	3	0	0
23	21806130	.	C	T	5	4	9	0	0	9	0	0
23	21806273	.	C	A	3	6	9	0	0	9	0	0
23	21806281	.	G	A	3	6	9	0	0	9	0	0
23	21807113	.	T	C	3	3	6	0	1	7	0	0
23	21810048	.	A	G	2	3	5	0	0	5	0	0
23	21817988	.	C	A	2	2	4	0	0	4	0	0
23	21978616	.	T	A	3	4	7	0	0	7	0	0
23	21978739	.	C	A	4	2	6	0	0	6	0	0
23	21978923	.	T	C	5	5	10	0	0	10	0	0
23	21978933	.	C	A	3	4	7	0	0	7	0	0
23	22018738	.	G	T	3	9	12	0	0	12	0	0
23	22029866	.	C	T	9	6	15	0	0	15	0	0
23	22030235	.	T	C	8	7	15	0	0	15	0	0
23	22030791	.	C	T	4	3	7	0	0	7	0	0
23	22034461	.	C	T	4	8	12	0	1	13	0	0
23	22034473	.	G	A	0	9	9	0	5	14	0	0
23	22051041	.	G	A	6	4	10	0	1	11	0	0
23	22051380	.	C	T	9	5	14	0	0	14	0	0
23	22054542	.	C	A	7	6	13	0	1	14	0	0
23	22064493	.	A	G	7	8	15	0	1	16	0	0
23	22067865	.	G	T	7	9	16	0	0	17	1	0
23	22072641	.	T	G	4	4	8	0	0	8	0	0
23	22084512	.	T	G	3	3	6	0	2	8	0	0
23	22084627	.	A	G	5	3	8	0	0	8	0	0
23	22084696	.	G	A	4	2	6	0	0	6	0	0
23	22207247	.	C	T	2	4	6	0	0	6	0	0
23	22208920	.	A	G	3	3	6	0	0	6	0	0
23	22209186	.	C	T	4	10	14	0	1	15	0	0
23	22209196	.	C	T	10	4	14	0	1	15	0	0
23	22311611	.	G	A	1	5	6	0	0	6	0	0
23	22379008	.	T	C	4	6	10	0	1	11	0	0
23	22384473	.	C	T	4	8	12	0	0	12	0	0
23	22384741	.	C	T	9	6	15	0	1	16	0	0
23	22394219	.	G	A	7	9	16	1	0	17	0	0
23	22394475	.	C	T	13	7	20	0	0	20	0	0
23	22424506	.	T	A	9	12	21	0	0	21	0	0
23	22424524	.	C	T	9	11	20	0	0	20	0	0
23	22424562	.	A	G	10	5	15	0	0	15	0	0
23	22424574	.	G	A	0	3	3	0	10	13	0	0
23	22424764	.	C	T	7	6	13	0	0	13	0	0
23	22425126	.	G	C	3	7	10	0	1	11	0	0
23	22496589	.	A	G	12	8	20	0	1	21	0	0
23	22496785	.	A	G	6	5	11	0	0	11	0	0
23	22497049	.	A	T	12	5	17	0	0	17	0	0
23	22497550	.	A	G	13	6	19	0	1	20	0	0
23	22508141	.	A	T	6	4	10	0	0	10	0	0
23	22635284	.	G	A	11	6	17	0	0	17	0	0
23	22635720	.	T	A	4	2	6	0	1	7	0	0
23	22635732	.	C	A	1	2	3	0	6	9	0	0
23	22638688	.	T	G	1	2	3	0	0	3	0	0
23	22643542	.	G	A	2	2	4	0	0	4	0	0
23	22667247	.	C	T	30	21	51	0	1	52	0	0
23	22674704	.	C	T	27	36	63	0	2	65	0	0
23	22677394	.	A	C	38	42	80	0	0	80	0	0
23	22677496	.	C	T	31	31	62	0	6	68	0	0
23	22677638	.	C	T	33	26	59	0	4	63	0	0
23	22874433	.	T	A	4	7	11	0	0	11	0	0
23	22886149	.	C	T	10	6	16	0	1	17	0	0
23	22895465	.	G	A	11	7	18	0	0	18	0	0
23	22922775	.	A	C	17	14	31	0	3	34	0	0
23	22922795	.	G	T	17	17	34	0	0	35	1	0
23	22923021	.	A	C	19	22	41	0	0	41	0	0
23	22923033	.	C	T	20	20	40	0	2	42	0	0
23	22923198	.	C	T	10	19	29	0	2	31	0	0
23	22923339	.	C	T	23	18	41	0	0	41	0	0
23	22923537	.	C	T	25	9	34	0	1	35	0	0
23	22923603	.	T	C	19	17	36	0	3	39	0	0
23	22925490	.	C	A	16	12	28	0	0	28	0	0
23	23096495	.	A	G	3	0	3	0	7	10	0	0
23	23118653	.	A	T	3	2	5	0	1	6	0	0
23	23122381	.	C	T	11	9	20	0	2	22	0	0
23	23123146	.	G	T	10	3	13	0	0	13	0	0
23	23123715	.	C	T	3	4	7	0	0	7	0	0
23	23126589	.	A	C	5	5	10	0	0	10	0	0
23	23126621	.	T	C	6	2	8	0	0	8	0	0
23	23136745	.	G	A	6	7	13	0	1	14	0	0
23	23170963	.	T	G	3	2	5	0	0	5	0	0
23	23171172	.	C	T	3	5	8	0	0	8	0	0
23	23190151	.	T	A	10	5	15	0	0	15	0	0
23	23192478	.	G	A	11	12	23	0	0	23	0	0
23	23192514	.	A	T	11	13	24	0	0	24	0	0
23	23194228	.	C	T	10	9	19	2	0	21	0	0
23	23205469	.	A	G	13	0	13	2	14	29	0	0
23	23205511	.	T	C	12	13	25	2	1	28	0	0
23	23210288	.	A	G	24	16	40	0	1	41	0	0
23	23210303	.	A	G	22	14	36	0	1	37	0	0
23	23210339	.	C	T	11	19	30	0	1	31	0	0
23	23212257	.	C	T	13	20	33	1	3	37	0	0
23	23212567	.	C	T	13	12	25	0	1	26	0	0
23	23213219	.	T	C	16	13	29	0	0	29	0	0
23	23213437	.	G	A	3	13	16	1	19	36	0	0
23	23213582	.	C	A	10	16	26	0	1	27	0	0
23	23213613	.	T	A	17	14	31	0	1	32	0	0
23	23213657	.	G	A	22	14	36	0	1	37	0	0
23	23213757	.	G	A	19	24	43	0	1	44	0	0
23	23213800	.	G	A	2	15	17	0	12	29	0	0
23	23213917	.	T	A	8	16	24	0	0	24	0	0
23	23213939	.	T	A	5	18	23	0	1	24	0	0
23	23214070	.	C	T	7	8	15	0	0	15	0	0
23	23214531	.	G	A	2	4	6	0	1	7	0	0
23	23399987	.	T	C	11	4	15	0	0	15	0	0
23	23400332	.	G	C	6	4	10	0	2	12	0	0
23	23658600	.	A	G	7	7	14	0	1	15	0	0
23	23667591	.	T	A	10	3	13	0	1	15	1	0
23	23741687	.	G	A	0	2	2	0	5	7	0	0
23	23754415	.	C	T	12	8	20	0	0	20	0	0
23	23816509	.	A	C	12	9	21	0	0	21	0	0
23	23830985	.	C	G	7	9	16	0	0	16	0	0
23	23860113	.	T	A	12	10	22	0	0	22	0	0
23	23860117	.	G	A	13	11	24	0	1	25	0	0
23	23877088	.	A	G	20	0	20	0	11	31	0	0
23	23888136	.	G	A	2	19	21	0	15	36	0	0
23	23891551	.	G	A	5	13	18	0	20	38	0	0
23	23903278	.	G	A	2	16	18	0	22	40	0	0
23	23903432	.	C	T	11	17	28	0	0	28	0	0
23	23912720	.	G	T	18	16	34	1	0	35	0	0
23	23912723	.	C	A	17	17	34	1	1	36	0	0
23	23912900	.	C	G	16	9	25	0	0	25	0	0
23	23913240	.	G	T	19	18	37	0	2	39	0	0
23	23913818	.	A	T	13	18	31	1	3	35	0	0
23	23913858	.	A	C	18	19	37	1	3	41	0	0
23	23914017	.	G	A	2	14	16	0	18	34	0	0
23	23914176	.	A	T	15	18	33	0	1	34	0	0
23	23973724	.	T	A	6	4	10	0	0	10	0	0
23	23983662	.	A	T	7	11	18	0	0	18	0	0
23	23983677	.	C	T	5	11	16	0	0	16	0	0
23	23987646	.	A	G	10	8	18	0	1	19	0	0
23	23987652	.	G	A	9	7	16	0	0	16	0	0
23	23994537	.	T	C	9	4	13	0	0	13	0	0
23	23994595	.	C	T	9	6	15	0	1	16	0	0
23	23995111	.	G	T	3	3	6	0	0	6	0	0
23	24143464	.	T	A	2	4	6	0	1	7	0	0
23	24143471	.	G	A	5	2	7	0	0	7	0	0
23	24144860	.	A	G	4	4	8	0	0	8	0	0
23	24144872	.	T	C	3	2	5	0	0	5	0	0
23	24145904	.	A	T	2	3	5	0	0	5	0	0
23	24148183	.	T	C	4	3	7	0	0	7	0	0
23	24167254	.	T	A	3	2	5	0	0	5	0	0
23	24170870	.	G	A	9	8	17	0	0	17	0	0
23	24195469	.	C	T	11	8	19	0	1	21	1	0
23	24195611	.	T	C	5	0	5	6	5	16	0	0
23	24202602	.	C	T	7	2	9	0	1	10	0	0
23	24202658	.	G	A	1	4	5	0	1	6	0	0
23	24202760	.	C	T	5	3	8	0	0	8	0	0
23	24202858	.	C	T	3	7	10	0	0	10	0	0
23	24202985	.	T	C	2	3	5	0	1	6	0	0
23	24208176	.	G	A	6	8	14	0	0	14	0	0
23	24208208	.	G	C	6	7	13	0	0	13	0	0
23	24209760	.	C	T	3	2	5	0	1	6	0	0
23	24209873	.	C	T	0	2	2	0	4	6	0	0
23	24214226	.	C	T	5	3	8	0	1	9	0	0
23	24214414	.	C	T	4	9	13	0	0	13	0	0
23	24216192	.	G	A	5	4	9	0	0	9	0	0
23	24216339	.	A	C	7	0	7	0	6	13	0	0
23	24226487	.	C	T	6	4	10	0	1	11	0	0
23	24227380	.	A	G	2	7	9	0	1	10	0	0
23	24227458	.	T	C	8	13	21	0	0	21	0	0
23	24227673	.	C	A	15	25	40	1	1	42	0	0
23	24228767	.	G	A	20	12	32	0	0	32	0	0
23	24229110	.	G	A	19	13	32	0	1	33	0	0
23	24231222	.	A	G	13	13	26	0	0	26	0	0
23	24233458	.	A	G	13	15	28	0	0	28	0	0
23	24233831	.	A	G	7	9	16	0	5	21	0	0
23	24238551	.	G	A	3	2	5	0	0	5	0	0
23	24238659	.	C	T	1	6	7	0	2	9	0	0
23	24238676	.	A	T	1	6	7	0	0	7	0	0
23	24240979	.	G	T	13	11	24	0	0	24	0	0
23	24243168	.	G	A	7	9	16	0	0	16	0	0
23	24244694	.	C	T	1	3	4	0	9	13	0	0
23	24247719	.	A	T	2	5	7	0	0	7	0	0
23	24251628	.	C	A	0	5	5	0	7	12	0	0
23	24251829	.	T	A	7	3	10	0	1	11	0	0
23	24300861	.	T	G	2	2	4	0	0	4	0	0
23	24304648	.	T	C	5	3	8	0	1	9	0	0
23	24308568	.	G	A	2	4	6	0	0	6	0	0
23	24439480	.	G	T	18	14	32	0	0	32	0	0
23	24439780	.	G	A	15	10	25	0	1	26	0	0
23	24440397	.	C	T	13	6	19	1	7	27	0	0
23	24442787	.	T	G	21	14	35	0	0	35	0	0
23	24443161	.	G	T	13	10	23	0	0	23	0	0
23	24443576	.	A	G	16	15	31	0	0	31	0	0
23	24443609	.	C	T	1	12	13	0	12	25	0	0
23	24444291	.	A	G	18	17	35	0	2	37	0	0
23	24444344	.	C	G	14	13	27	0	1	28	0	0
23	24444543	.	C	T	1	9	10	0	12	22	0	0
23	24444803	.	T	G	13	10	23	0	2	25	0	0
23	24444861	.	G	A	13	10	23	0	2	25	0	0
23	24445112	.	G	T	12	18	30	0	0	30	0	0
23	24445338	.	A	G	15	7	22	0	2	24	0	0
23	24445584	.	A	G	6	17	23	0	0	23	0	0
23	24445876	.	A	G	14	11	25	0	1	26	0	0
23	24445906	.	G	C	18	9	27	0	0	27	0	0
23	24446411	.	C	T	11	12	23	0	1	24	0	0
23	24447113	.	C	T	9	12	21	0	0	21	0	0
23	24447297	.	C	T	5	6	11	0	0	11	0	0
23	24447794	.	G	A	8	9	17	0	0	17	0	0
23	24448071	.	T	A	11	5	16	0	2	18	0	0
23	24448146	.	T	C	5	5	10	0	0	10	0	0
23	24448273	.	G	C	13	4	17	0	2	19	0	0
23	24448621	.	G	C	8	4	12	0	0	12	0	0
23	24448630	.	G	T	7	4	11	0	0	11	0	0
23	24449429	.	G	A	3	6	9	0	0	9	0	0
23	24450327	.	T	C	5	4	9	0	2	11	0	0
23	24450353	.	C	T	7	3	10	0	1	11	0	0
23	24451083	.	A	G	7	13	20	0	0	20	0	0
23	24451283	.	A	G	8	6	14	0	0	14	0	0
23	24451512	.	T	C	10	5	15	0	1	16	0	0
23	24451791	.	T	C	5	2	7	0	0	7	0	0
23	24452496	.	C	T	2	2	4	0	0	4	0	0
23	24452508	.	G	A	1	2	3	0	1	4	0	0
23	24475726	.	T	C	4	6	10	0	0	10	0	0
23	24475749	.	G	T	9	3	12	0	0	12	0	0
23	24492872	.	G	A	4	2	6	0	0	6	0	0
23	24504389	.	A	G	18	0	18	0	10	28	0	0
23	24540675	.	T	C	2	0	2	0	2	4	0	0
23	24590317	.	G	A	1	2	3	0	0	3	0	0
23	24590813	.	T	C	0	2	2	0	1	3	0	0
23	24590974	.	G	A	0	5	5	0	1	6	0	0
23	24591399	.	G	A	2	2	4	0	0	4	0	0
23	24591764	.	G	A	3	5	8	0	0	8	0	0
23	24591799	.	G	A	2	2	4	0	1	5	0	0
23	24591808	.	G	A	2	3	5	0	1	6	0	0
23	24592340	.	T	C	2	3	5	0	0	5	0	0
23	24595748	.	T	C	3	3	6	0	0	6	0	0
23	24600513	.	C	T	9	12	21	0	0	21	0	0
23	24600947	.	T	C	11	10	21	0	0	21	0	0
23	24604042	.	C	T	9	12	21	0	0	21	0	0
23	24604323	.	C	T	11	10	21	0	1	22	0	0
23	24604461	.	A	G	8	0	8	0	12	20	0	0
23	24605243	.	T	A	10	8	18	0	1	19	0	0
23	24608805	.	G	A	13	8	21	0	1	22	0	0
23	24608847	.	G	A	0	12	12	0	12	24	0	0
23	24611786	.	G	A	0	4	4	0	4	8	0	0
23	24652909	.	G	A	1	5	6	0	2	8	0	0
23	24652929	.	G	A	0	4	4	0	4	8	0	0
23	24654287	.	G	T	3	5	8	0	0	8	0	0
23	24654391	.	A	T	2	2	4	0	1	5	0	0
23	24654528	.	G	T	3	4	7	0	0	7	0	0
23	24655227	.	T	C	5	2	7	0	0	7	0	0
23	24655478	.	C	T	3	3	6	0	0	6	0	0
23	24655761	.	T	G	9	0	9	0	10	19	0	0
23	24655833	.	A	G	4	7	11	0	2	13	0	0
23	24659777	.	C	T	3	7	10	0	1	11	0	0
23	24661851	.	C	T	11	4	15	0	0	15	0	0
23	24669381	.	C	T	2	7	9	0	11	20	0	0
23	24669633	.	T	C	10	0	10	0	14	24	0	0
23	24672365	.	C	T	2	7	9	0	0	9	0	0
23	24676192	.	G	C	9	5	14	0	2	16	0	0
23	24694242	.	C	A	16	13	29	0	0	29	0	0
23	24694756	.	C	T	19	19	38	0	3	41	0	0
23	24694763	.	T	A	19	18	37	0	3	40	0	0
23	24697036	.	G	A	15	18	33	0	1	34	0	0
23	24699281	.	T	A	20	26	46	0	1	47	0	0
23	24747961	.	G	A	1	2	3	0	1	4	0	0
23	24749292	.	A	G	1	3	4	0	0	4	0	0
23	24749415	.	G	T	1	2	3	0	0	3	0	0
23	24749848	.	A	T	4	2	6	0	0	6	0	0
23	24750010	.	C	T	3	2	5	0	0	5	0	0
23	24750339	.	C	A	1	2	3	0	0	3	0	0
23	24803130	.	C	T	24	9	33	0	2	35	0	0
23	24803221	.	T	C	16	0	16	0	17	33	0	0
23	24819831	.	C	G	12	13	25	0	0	25	0	0
23	24823899	.	T	C	11	8	19	0	1	20	0	0
23	24855864	.	G	T	10	9	19	0	2	21	0	0
23	24926470	.	G	A	9	12	21	0	0	21	0	0
23	24932493	.	G	T	7	4	11	0	1	12	0	0
23	24932979	.	G	A	10	7	17	0	1	18	0	0
23	24933121	.	C	T	10	8	18	0	1	19	0	0
23	24934567	.	T	C	17	11	28	0	1	29	0	0
23	24934597	.	C	G	11	10	21	0	2	23	0	0
23	24938290	.	T	A	6	5	11	0	1	12	0	0
23	24956985	.	A	T	3	3	6	0	0	6	0	0
23	24957061	.	T	G	4	3	7	0	0	7	0	0
23	24957161	.	G	C	4	5	9	0	0	9	0	0
23	24957184	.	A	G	4	0	4	0	5	9	0	0
23	24959374	.	G	C	5	3	8	0	0	8	0	0
23	24960393	.	T	A	1	4	5	0	3	8	0	0
23	24960740	.	T	G	5	3	8	0	0	8	0	0
23	24960741	.	G	T	5	3	8	0	0	8	0	0
23	24962414	.	A	T	3	6	9	0	0	9	0	0
23	24962560	.	G	A	0	6	6	0	3	9	0	0
23	24965393	.	C	T	9	4	13	0	3	16	0	0
23	24965396	.	G	A	11	6	17	0	0	17	0	0
23	24965432	.	G	T	9	4	13	0	1	14	0	0
23	24965767	.	C	G	9	5	14	0	0	14	0	0
23	24968676	.	C	A	5	3	8	0	1	9	0	0
23	24970331	.	A	G	3	0	3	0	5	8	0	0
23	24970372	.	G	A	8	2	10	0	0	10	0	0
23	24970451	.	T	C	5	3	8	0	0	8	0	0
23	24970589	.	A	G	1	2	3	0	0	3	0	0
23	24970593	.	G	A	1	2	3	0	0	3	0	0
23	24970732	.	C	T	1	3	4	0	0	4	0	0
23	24973871	.	T	C	6	4	10	0	0	10	0	0
23	24973928	.	A	G	3	4	7	0	0	7	0	0
23	24973931	.	A	G	3	0	3	0	4	7	0	0
23	24977048	.	G	T	2	5	7	0	0	7	0	0
23	24977060	.	C	T	4	4	8	0	0	8	0	0
23	24979922	.	G	A	4	2	6	0	1	7	0	0
23	24980093	.	A	G	3	0	3	0	2	5	0	0
23	24980349	.	T	A	3	5	8	0	1	9	0	0
23	24983572	.	C	T	3	5	8	0	0	8	0	0
23	24984969	.	A	C	5	3	8	0	0	8	0	0
23	25533607	.	T	C	2	2	4	0	0	4	0	0
23	25533609	.	A	G	1	2	3	0	1	4	0	0
23	25533685	.	C	T	0	3	3	0	2	5	0	0
23	25539868	.	A	G	2	2	4	0	0	4	0	0
23	25550894	.	A	G	1	6	7	0	0	7	0	0
23	25551282	.	G	A	3	4	7	0	0	7	0	0
23	25554502	.	A	T	5	3	8	0	0	8	0	0
23	25557150	.	T	C	4	0	4	0	3	7	0	0
23	25564701	.	T	C	1	3	4	0	0	4	0	0
23	25564734	.	G	T	2	2	4	0	0	4	0	0
23	25592209	.	G	A	3	2	5	0	0	5	0	0
23	25756641	.	A	G	4	2	6	0	0	6	0	0
23	25757012	.	G	A	2	3	5	0	0	5	0	0
23	25757378	.	G	A	0	7	7	2	6	15	0	0
23	25767757	.	G	A	0	6	6	0	4	10	0	0
23	25768384	.	C	T	2	2	4	0	0	4	0	0
23	25770414	.	G	A	2	4	6	0	1	7	0	0
23	25772369	.	A	G	7	13	20	0	0	20	0	0
23	25772799	.	G	A	2	6	8	0	0	8	0	0
23	25773460	.	G	A	6	2	8	0	0	8	0	0
23	25773469	.	G	A	2	4	6	0	1	7	0	0
23	25773505	.	G	T	3	2	5	0	0	5	0	0
23	25776824	.	C	T	5	11	16	0	0	16	0	0
23	25776879	.	A	G	5	4	9	0	0	9	0	0
23	25777286	.	A	G	8	6	14	0	0	14	0	0
23	25796410	.	T	A	11	8	19	0	1	20	0	0
23	25796484	.	G	C	6	0	6	0	3	9	0	0
23	25796563	.	C	A	1	6	7	0	0	7	0	0
23	25796670	.	T	G	8	3	11	0	0	11	0	0
23	25796691	.	T	C	5	0	5	0	3	8	0	0
23	25797011	.	T	A	1	9	10	0	1	11	0	0
23	25797022	.	T	A	9	3	12	0	1	13	0	0
23	25797143	.	G	C	7	3	10	0	1	11	0	0
23	25797216	.	G	A	4	6	10	0	0	10	0	0
23	25861407	.	T	C	1	0	1	0	4	5	0	0
23	25869424	.	A	G	16	0	16	0	11	27	0	0
23	25869571	.	G	A	7	5	12	0	1	13	0	0
23	25869596	.	C	A	5	6	11	0	1	12	0	0
23	25869658	.	C	T	13	4	17	0	0	17	0	0
23	25869706	.	A	G	11	5	16	0	0	16	0	0
23	25871764	.	C	A	10	10	20	0	0	20	0	0
23	25872703	.	G	A	0	10	10	0	16	26	0	0
23	25873362	.	G	T	5	5	10	0	1	11	0	0
23	25873365	.	T	A	6	5	11	0	0	11	0	0
23	25873444	.	C	A	8	10	18	0	0	18	0	0
23	25873522	.	T	G	4	5	9	0	1	10	0	0
23	25873570	.	G	A	6	7	13	0	1	14	0	0
23	25873708	.	C	T	6	2	8	0	0	8	0	0
23	25873966	.	T	A	6	1	7	0	0	7	0	0
23	25874249	.	A	G	13	0	13	0	11	24	0	0
23	25874261	.	T	A	13	11	24	0	1	25	0	0
23	25874334	.	C	G	7	6	13	0	1	14	0	0
23	25874355	.	A	T	6	6	12	0	2	14	0	0
23	25874459	.	A	T	10	10	20	0	1	21	0	0
23	25874498	.	G	A	7	8	15	0	1	16	0	0
23	25874615	.	G	A	2	6	8	0	2	10	0	0
23	25879786	.	A	G	8	10	18	0	0	18	0	0
23	25879930	.	A	C	6	14	20	1	2	23	0	0
23	25930689	.	C	T	18	10	28	0	5	33	0	0
23	25942399	.	T	G	10	0	10	0	11	21	0	0
23	25942559	.	T	A	10	5	15	0	0	15	0	0
23	25942708	.	G	A	1	3	4	0	9	13	0	0
23	25946732	.	A	G	3	3	6	0	0	6	0	0
23	25947155	.	A	T	3	4	7	0	0	7	0	0
23	25947169	.	T	C	4	0	4	0	4	8	0	0
23	25947416	.	T	G	3	3	6	0	0	6	0	0
23	25947599	.	T	C	6	0	6	0	3	9	0	0
23	26063560	.	A	T	27	22	49	0	5	54	0	0
23	26063614	.	A	C	28	26	54	0	1	55	0	0
23	26063734	.	G	A	21	28	49	0	5	54	0	0
23	26063843	.	G	A	26	32	58	0	3	61	0	0
23	26063985	.	A	T	31	25	56	0	2	58	0	0
23	26064050	.	T	A	31	26	57	0	1	58	0	0
23	26064122	.	T	A	11	26	37	0	2	40	1	0
23	26064124	.	T	A	32	8	40	0	1	41	0	0
23	26064266	.	T	A	21	18	39	0	0	39	0	0
23	26064923	.	T	C	39	0	39	0	27	66	0	0
23	26064948	.	T	G	36	24	60	0	2	62	0	0
23	26064989	.	A	G	37	27	64	0	2	66	0	0
23	26065079	.	T	C	38	32	70	0	1	71	0	0
23	26066629	.	C	T	25	16	41	0	1	42	0	0
23	26074123	.	G	A	20	20	40	0	2	42	0	0
23	26074252	.	T	A	13	17	30	0	3	33	0	0
23	26083822	.	A	C	2	4	6	0	0	6	0	0
23	26085897	.	A	C	3	3	6	0	0	6	0	0
23	26086052	.	T	G	3	2	5	0	1	6	0	0
23	26088791	.	G	C	5	7	12	0	0	12	0	0
23	26088845	.	A	G	4	5	9	0	0	9	0	0
23	26093095	.	C	T	8	8	16	0	1	17	0	0
23	26093597	.	A	G	6	3	9	0	0	9	0	0
23	26093868	.	T	C	4	3	7	0	0	7	0	0
23	26093933	.	A	T	6	4	10	0	0	10	0	0
23	26094063	.	A	G	5	4	9	0	1	10	0	0
23	26094533	.	A	G	8	6	14	0	0	14	0	0
23	26094589	.	G	C	12	18	30	0	0	30	0	0
23	26094617	.	T	C	11	20	31	0	1	32	0	0
23	26094626	.	T	C	11	0	11	0	21	33	1	0
23	26094694	.	A	C	10	10	20	0	1	21	0	0
23	26094877	.	A	G	13	8	21	0	1	22	0	0
23	26094932	.	G	A	12	9	21	0	0	21	0	0
23	26094938	.	C	A	11	6	17	0	2	19	0	0
23	26095081	.	G	A	17	14	31	0	0	31	0	0
23	26095096	.	C	T	16	14	30	0	0	30	0	0
23	26095153	.	G	A	13	10	23	0	0	23	0	0
23	26095285	.	T	A	13	15	28	0	3	31	0	0
23	26095400	.	C	T	27	30	57	0	1	58	0	0
23	26095416	.	T	G	20	31	51	0	4	55	0	0
23	26110735	.	G	A	17	16	33	1	1	35	0	0
23	26120198	.	C	A	1	11	12	0	9	21	0	0
23	26126392	.	T	C	1	9	10	3	0	13	0	0
23	26126478	.	G	A	4	6	10	3	0	13	0	0
23	26169157	.	T	A	0	2	2	0	1	3	0	0
23	26187603	.	C	A	0	5	5	0	2	7	0	0
23	26187735	.	C	T	5	7	12	0	1	13	0	0
23	26225907	.	A	T	6	8	14	0	0	14	0	0
23	26226066	.	G	T	5	5	10	0	0	10	0	0
23	26227697	.	C	T	0	10	10	0	11	21	0	0
23	26232509	.	C	A	10	6	16	0	1	17	0	0
23	26240860	.	G	A	5	15	20	0	2	22	0	0
23	26249884	.	G	A	13	6	19	0	1	20	0	0
23	26251940	.	G	A	7	7	14	0	1	15	0	0
23	26251946	.	A	G	7	8	15	0	0	15	0	0
23	26258065	.	C	T	1	4	5	0	6	11	0	0
23	26299011	.	T	C	4	0	4	0	4	8	0	0
23	26330387	.	C	T	4	7	11	0	0	11	0	0
23	26503884	.	T	C	23	3	26	0	29	55	0	0
23	26504151	.	A	C	34	2	36	1	20	57	0	0
23	26504202	.	A	T	42	21	63	2	0	65	0	0
23	26504254	.	G	A	34	15	49	1	2	52	0	0
23	26504264	.	C	T	29	17	46	1	2	49	0	0
23	26507741	.	G	A	21	28	49	0	3	52	0	0
23	26509764	.	G	A	25	28	53	0	2	55	0	0
23	26517183	.	G	A	17	30	47	0	2	49	0	0
23	26522647	.	A	G	12	15	27	0	2	29	0	0
23	26522892	.	G	A	13	13	26	0	3	29	0	0
23	26523020	.	A	G	8	4	12	0	0	12	0	0
23	26560135	.	C	A	1	2	3	0	0	3	0	0
23	26562183	.	A	G	2	2	4	0	0	4	0	0
23	26577480	.	G	T	2	2	4	0	0	4	0	0
23	26763798	.	A	T	9	6	15	0	1	16	0	0
23	26763994	.	C	A	5	7	12	0	0	12	0	0
23	26764351	.	A	C	6	8	14	0	0	14	0	0
23	26766668	.	A	G	5	10	15	0	0	15	0	0
23	26770180	.	C	T	3	9	12	0	0	12	0	0
23	26774334	.	G	A	2	3	5	0	0	5	0	0
23	26797108	.	T	A	3	3	6	0	0	6	0	0
23	26801696	.	C	T	5	4	9	0	0	9	0	0
23	26801807	.	C	T	2	1	3	0	1	4	0	0
23	26813850	.	C	T	1	4	5	0	0	5	0	0
23	26824607	.	G	A	1	3	4	0	0	4	0	0
23	26828236	.	C	T	1	2	3	0	1	4	0	0
23	26828760	.	G	A	1	3	4	0	0	4	0	0
23	26946805	.	A	G	5	4	9	0	0	9	0	0
23	26950928	.	G	A	1	4	5	0	2	7	0	0
23	26951926	.	G	A	6	2	8	0	0	8	0	0
23	26955383	.	C	T	9	4	13	0	0	13	0	0
23	26955401	.	A	G	11	5	16	0	1	17	0	0
23	26955425	.	G	T	8	4	12	0	0	12	0	0
23	26958483	.	A	G	4	8	12	0	1	13	0	0
23	26979223	.	C	A	15	13	28	0	0	28	0	0
23	27000605	.	T	C	18	22	40	1	2	43	0	0
23	27003630	.	T	A	24	25	49	2	1	52	0	0
23	27003720	.	G	A	26	24	50	0	1	51	0	0
23	27003801	.	T	C	18	28	46	0	3	49	0	0
23	27004310	.	C	T	18	16	34	0	1	35	0	0
23	27004339	.	C	T	19	19	38	0	1	39	0	0
23	27004347	.	G	A	19	19	38	0	2	40	0	0
23	27004383	.	C	T	20	19	39	0	2	41	0	0
23	27004397	.	T	C	20	15	35	0	4	39	0	0
23	27004665	.	T	C	20	15	35	0	1	36	0	0
23	27005195	.	G	A	22	18	40	0	5	45	0	0
23	27005514	.	A	G	16	0	16	0	8	24	0	0
23	27005920	.	T	C	6	1	7	0	0	7	0	0
23	27005925	.	A	T	5	2	7	0	0	7	0	0
23	27005973	.	G	T	1	2	3	0	0	3	0	0
23	27041461	.	A	T	2	4	6	0	0	6	0	0
23	27041503	.	C	G	4	4	8	0	0	8	0	0
23	27041778	.	A	T	5	10	15	0	1	16	0	0
23	27041786	.	A	C	11	4	15	0	0	15	0	0
23	27042132	.	A	G	12	9	21	0	0	21	0	0
23	27042454	.	T	C	4	7	11	0	0	11	0	0
23	27042533	.	C	T	1	3	4	0	0	4	0	0
23	27044241	.	C	T	5	6	11	0	0	11	0	0
23	27044526	.	A	G	6	4	10	0	1	11	0	0
23	27044638	.	T	A	10	6	16	0	0	16	0	0
23	27044946	.	C	G	4	5	9	0	0	9	0	0
23	27044947	.	T	C	3	0	3	0	6	9	0	0
23	27052123	.	C	A	19	17	36	0	0	36	0	0
23	27052125	.	C	T	19	16	35	0	2	38	1	0
23	27054361	.	C	T	15	11	26	0	0	26	0	0
23	27059120	.	G	A	3	17	20	0	15	35	0	0
23	27059376	.	T	A	14	19	33	0	0	33	0	0
23	27059422	.	C	T	13	23	36	0	0	36	0	0
23	27059459	.	A	G	11	0	11	0	25	36	0	0
23	27059526	.	G	A	1	19	20	0	18	38	0	0
23	27135178	.	A	T	2	2	4	0	0	4	0	0
23	27136385	.	T	G	3	4	7	0	0	7	0	0
23	27251789	.	G	C	24	12	36	0	2	38	0	0
23	27251859	.	G	A	30	26	56	0	1	57	0	0
23	27251872	.	C	T	3	26	29	0	24	53	0	0
23	27252425	.	G	A	20	25	45	0	1	46	0	0
23	27252587	.	A	G	18	17	35	0	2	38	1	0
23	27252833	.	A	G	23	17	40	0	1	41	0	0
23	27254226	.	T	C	11	16	27	0	0	27	0	0
23	27254586	.	C	T	2	23	25	0	18	43	0	0
23	27274110	.	G	A	8	13	21	0	1	22	0	0
23	27274266	.	G	A	17	17	34	0	1	35	0	0
23	27279281	.	A	G	14	16	30	0	1	31	0	0
23	27279320	.	A	G	20	14	34	0	1	35	0	0
23	27279476	.	G	A	19	14	33	0	1	34	0	0
23	27279533	.	C	T	13	11	24	0	0	24	0	0
23	27294611	.	G	A	9	15	24	0	1	25	0	0
23	27296964	.	G	C	9	0	9	0	16	25	0	0
23	27305186	.	C	T	18	12	30	0	1	31	0	0
23	27305195	.	G	A	16	11	27	0	2	29	0	0
23	27336193	.	G	A	7	7	14	0	1	15	0	0
23	27358990	.	A	T	7	15	22	0	0	22	0	0
23	27359203	.	A	G	12	9	21	0	1	22	0	0
23	27359526	.	T	C	13	8	21	0	0	21	0	0
23	27359755	.	C	T	0	9	9	0	6	15	0	0
23	27359825	.	C	A	14	6	20	0	2	22	0	0
23	27359867	.	A	C	9	11	20	0	0	20	0	0
23	27360007	.	G	A	3	10	13	0	1	14	0	0
23	27361210	.	A	T	7	7	14	0	1	15	0	0
23	27361216	.	G	A	8	9	17	0	0	17	0	0
23	27364018	.	C	T	6	4	10	0	1	11	0	0
23	27366669	.	C	T	7	7	14	0	1	15	0	0
23	27367052	.	C	T	1	2	3	0	5	8	0	0
23	27373181	.	C	T	2	7	9	0	6	15	0	0
23	27373186	.	G	T	7	7	14	0	1	15	0	0
23	27380430	.	A	C	3	0	3	0	2	5	0	0
23	27383533	.	G	C	4	5	9	0	1	10	0	0
23	27383888	.	G	A	1	5	6	0	0	6	0	0
23	27448169	.	T	C	1	2	3	0	0	3	0	0
23	27452814	.	A	G	1	2	3	0	0	3	0	0
23	27497960	.	A	T	17	6	23	0	0	23	0	0
23	27498027	.	A	T	11	6	17	0	0	18	1	0
23	27498040	.	C	G	8	10	18	0	1	19	0	0
23	27498195	.	A	T	9	17	26	0	2	28	0	0
23	27498564	.	T	A	3	3	6	0	0	6	0	0
23	27498798	.	C	T	1	12	13	0	10	23	0	0
23	27499096	.	G	A	18	8	26	0	0	26	0	0
23	27499195	.	A	T	14	12	26	0	2	28	0	0
23	27499246	.	G	A	14	14	28	0	0	28	0	0
23	27499306	.	C	T	15	12	27	0	1	28	0	0
23	27501872	.	A	G	13	10	23	0	0	23	0	0
23	27513819	.	G	A	4	3	7	0	1	8	0	0
23	27513890	.	T	G	3	0	3	0	14	17	0	0
23	27513952	.	A	G	17	12	29	0	0	29	0	0
23	27515931	.	G	A	18	10	28	0	0	28	0	0
23	27516268	.	T	C	5	0	5	0	8	13	0	0
23	27518434	.	G	A	11	7	18	0	4	22	0	0
23	27521608	.	A	T	4	5	9	0	0	9	0	0
23	27521815	.	G	A	9	6	15	0	0	15	0	0
23	27521863	.	A	G	8	12	20	0	0	20	0	0
23	27547467	.	C	T	0	4	4	0	6	10	0	0
23	27547568	.	G	A	5	4	9	0	1	10	0	0
23	27547650	.	A	T	4	4	8	0	0	8	0	0
23	27547850	.	C	T	1	3	4	0	3	7	0	0
23	27591834	.	C	T	11	6	17	0	0	17	0	0
23	27591859	.	C	T	8	7	15	0	2	17	0	0
23	27591939	.	A	G	5	6	11	0	0	11	0	0
23	27592615	.	T	C	1	5	6	0	0	6	0	0
23	27592796	.	T	C	11	2	13	0	7	20	0	0
23	27593230	.	C	T	14	9	23	0	0	23	0	0
23	27597141	.	C	A	2	9	11	0	9	20	0	0
23	27597808	.	G	A	11	11	22	0	0	22	0	0
23	27597980	.	G	A	6	5	11	0	0	11	0	0
23	27597981	.	C	A	6	5	11	0	0	11	0	0
23	27599365	.	G	A	12	7	19	0	0	19	0	0
23	27601803	.	C	T	3	3	6	0	0	6	0	0
23	27603302	.	G	A	6	3	9	0	0	9	0	0
23	27608131	.	G	A	3	4	7	0	0	7	0	0
23	27622036	.	T	A	19	20	39	0	2	41	0	0
23	27622212	.	C	A	13	12	25	0	2	27	0	0
23	27622258	.	T	C	14	14	28	0	1	29	0	0
23	27622324	.	T	C	11	12	23	0	1	24	0	0
23	27622386	.	T	G	7	8	15	0	3	18	0	0
23	27629923	.	A	T	19	18	37	0	0	37	0	0
23	27641530	.	G	A	2	2	4	0	0	4	0	0
23	27641607	.	C	T	2	2	4	0	1	5	0	0
23	27677263	.	G	A	32	15	47	0	6	53	0	0
23	27677278	.	G	A	19	30	49	0	6	55	0	0
23	27683248	.	C	A	0	4	4	0	1	5	0	0
23	27683371	.	C	T	0	3	3	0	7	10	0	0
23	27683497	.	C	T	3	9	12	0	1	13	0	0
23	27683629	.	C	T	1	4	5	0	5	10	0	0
23	27683710	.	G	A	4	8	12	0	0	12	0	0
23	27684618	.	T	C	3	0	3	0	3	6	0	0
23	27727163	.	T	C	1	2	3	0	0	3	0	0
23	27780905	.	A	G	1	6	7	0	0	7	0	0
23	27781082	.	T	C	2	3	5	0	1	6	0	0
23	27781618	.	T	C	1	2	3	0	0	3	0	0
23	27784281	.	A	T	5	3	8	0	1	9	0	0
23	27784392	.	G	A	4	2	6	0	1	7	0	0
23	27784466	.	G	A	6	2	8	0	0	8	0	0
23	27785026	.	A	C	3	8	11	0	0	11	0	0
23	27785413	.	G	A	4	2	6	0	0	6	0	0
23	27785460	.	A	T	7	3	10	0	1	11	0	0
23	27787598	.	T	C	6	7	13	0	2	15	0	0
23	27787851	.	T	C	5	5	10	0	0	10	0	0
23	27788133	.	G	A	5	8	13	0	1	14	0	0
23	27788665	.	C	T	14	15	29	0	0	29	0	0
23	27788768	.	G	A	14	8	22	0	0	22	0	0
23	27789577	.	T	C	5	4	9	0	1	10	0	0
23	27793510	.	T	C	11	9	20	0	0	20	0	0
23	27800681	.	G	T	3	9	12	0	4	16	0	0
23	27800954	.	A	C	10	7	17	0	1	18	0	0
23	27800977	.	C	T	16	7	23	0	0	23	0	0
23	27801074	.	T	C	17	5	22	0	1	23	0	0
23	27801237	.	T	C	16	5	21	0	0	21	0	0
23	27801268	.	C	A	13	9	22	0	0	22	0	0
23	27801629	.	C	T	7	7	14	0	0	14	0	0
23	27801849	.	G	A	8	6	14	0	0	14	0	0
23	27801880	.	G	T	8	6	14	0	2	16	0	0
23	27805414	.	A	G	10	5	15	0	0	15	0	0
23	27807294	.	A	G	4	9	13	0	1	14	0	0
23	27807523	.	A	G	3	6	9	0	0	9	0	0
23	27835898	.	G	A	5	3	8	0	1	9	0	0
23	27836003	.	C	G	5	4	9	0	0	9	0	0
23	27836235	.	C	T	0	5	5	0	6	11	0	0
23	27836245	.	G	A	6	5	11	0	0	11	0	0
23	27839682	.	A	G	2	6	8	0	1	9	0	0
23	27912116	.	C	A	3	1	4	0	1	5	0	0
23	27912136	.	T	C	3	5	8	0	1	9	0	0
23	27966981	.	G	A	3	5	8	0	0	8	0	0
23	27967014	.	T	G	7	6	13	0	2	15	0	0
23	27988988	.	A	G	6	9	15	0	0	15	0	0
23	28005087	.	C	T	9	4	13	0	0	13	0	0
23	28005338	.	A	G	10	6	16	0	1	17	0	0
23	28023784	.	T	C	11	8	19	0	1	20	0	0
23	28025586	.	G	A	11	5	16	0	1	17	0	0
23	28025664	.	A	G	5	8	13	0	0	13	0	0
23	28089460	.	T	C	4	5	9	0	0	9	0	0
23	28089478	.	C	T	3	4	7	0	0	7	0	0
23	28125796	.	C	T	4	5	9	0	0	9	0	0
23	28125932	.	T	A	6	6	12	0	0	12	0	0
23	28128445	.	T	C	8	3	11	0	1	12	0	0
23	28130983	.	G	A	3	5	8	0	0	8	0	0
23	28130999	.	A	G	5	5	10	0	0	10	0	0
23	28131047	.	T	C	9	4	13	0	1	14	0	0
23	28131083	.	A	G	5	4	9	0	1	10	0	0
23	28131248	.	C	T	8	3	11	0	1	12	0	0
23	28131251	.	C	T	8	3	11	0	1	12	0	0
23	28131285	.	C	T	11	5	16	0	0	16	0	0
23	28131320	.	G	A	10	8	18	0	0	18	0	0
23	28136167	.	G	T	6	8	14	0	1	15	0	0
23	28136471	.	T	G	4	4	8	0	0	8	0	0
23	28136498	.	A	G	3	4	7	0	0	7	0	0
23	28136615	.	C	G	1	2	3	0	1	4	0	0
23	28139515	.	C	T	5	9	14	0	1	15	0	0
23	28139564	.	A	G	9	6	15	0	1	16	0	0
23	28139633	.	T	C	19	11	30	0	0	30	0	0
23	28139812	.	A	G	14	13	27	0	0	27	0	0
23	28141324	.	G	C	5	8	13	0	1	14	0	0
23	28186060	.	T	A	13	13	26	0	5	31	0	0
23	28186688	.	T	G	15	16	31	0	1	32	0	0
23	28186995	.	T	C	4	1	5	0	7	12	0	0
23	28190648	.	A	G	12	19	31	0	2	33	0	0
23	28200967	.	A	G	14	10	24	0	0	24	0	0
23	28231248	.	G	A	4	9	13	1	1	15	0	0
23	28294259	.	T	A	4	7	11	0	1	12	0	0
23	28294709	.	A	G	2	6	8	0	0	8	0	0
23	28374722	.	C	T	18	14	32	0	2	34	0	0
23	28374756	.	A	G	16	11	27	0	1	28	0	0
23	28378254	.	G	A	16	11	27	0	0	27	0	0
23	28383548	.	T	C	3	7	10	0	0	10	0	0
23	28421241	.	G	T	3	4	7	0	0	7	0	0
23	28486050	.	C	A	1	2	3	0	0	3	0	0
23	28486843	.	T	C	4	0	4	0	5	9	0	0
23	28494838	.	C	T	3	2	5	0	1	6	0	0
23	28497962	.	C	T	2	4	6	0	0	6	0	0
23	28510075	.	C	T	4	2	6	0	0	6	0	0
23	28510337	.	G	A	3	3	6	0	1	7	0	0
23	28510736	.	T	A	4	3	7	0	0	7	0	0
23	28514820	.	G	A	3	3	6	0	0	6	0	0
23	28525831	.	A	G	5	6	11	0	0	11	0	0
23	28527739	.	A	C	5	2	7	0	1	8	0	0
23	28538590	.	T	A	5	5	10	0	1	11	0	0
23	28539108	.	T	C	5	5	10	0	0	10	0	0
23	28539279	.	G	A	0	8	8	0	6	14	0	0
23	28539626	.	G	A	12	7	19	0	0	19	0	0
23	28541593	.	T	C	3	10	13	0	0	13	0	0
23	28541638	.	C	T	7	11	18	0	1	19	0	0
23	28546798	.	T	C	10	11	21	0	1	22	0	0
23	28546870	.	G	A	0	8	8	0	7	15	0	0
23	28547207	.	C	G	13	9	22	0	1	23	0	0
23	28547242	.	A	G	9	0	9	0	10	19	0	0
23	28547261	.	A	G	9	13	22	0	1	23	0	0
23	28548883	.	A	G	12	1	13	0	7	20	0	0
23	28551306	.	A	T	9	16	25	0	0	25	0	0
23	28551671	.	A	G	12	0	12	0	13	25	0	0
23	28551770	.	G	A	6	13	19	0	0	19	0	0
23	28552149	.	A	C	3	2	5	0	19	24	0	0
23	28554784	.	A	T	11	18	29	0	1	30	0	0
23	28557337	.	T	C	15	11	26	0	2	28	0	0
23	28561248	.	T	C	17	16	33	0	0	33	0	0
23	28561836	.	C	T	14	14	28	0	1	29	0	0
23	28659252	.	A	T	7	6	13	0	1	14	0	0
23	28661490	.	C	T	2	7	9	0	0	9	0	0
23	28662989	.	T	C	2	9	11	0	0	11	0	0
23	28663197	.	T	C	16	11	27	0	0	27	0	0
23	28663227	.	T	C	9	7	16	0	0	16	0	0
23	28667217	.	T	C	7	8	15	0	0	15	0	0
23	28667294	.	T	C	10	6	16	0	1	17	0	0
23	28667300	.	C	A	11	8	19	0	0	19	0	0
23	28669550	.	C	T	10	12	22	0	0	22	0	0
23	28672155	.	G	A	4	10	14	0	11	25	0	0
23	28674634	.	T	A	13	12	25	0	2	27	0	0
23	28681558	.	G	C	27	25	52	0	3	55	0	0
23	28681559	.	C	A	25	26	51	0	3	54	0	0
23	28681723	.	T	A	32	20	52	0	2	54	0	0
23	28687446	.	C	T	3	2	5	0	0	5	0	0
23	28687448	.	C	G	3	2	5	0	0	5	0	0
23	28687591	.	T	C	4	6	10	0	0	10	0	0
23	28687656	.	G	A	9	3	12	0	0	12	0	0
23	28695772	.	A	G	8	9	17	0	0	17	0	0
23	28695820	.	T	C	8	7	15	0	0	15	0	0
23	28698340	.	T	C	9	11	20	0	1	21	0	0
23	28704611	.	G	A	15	13	28	0	2	30	0	0
23	28704635	.	C	T	11	9	20	0	1	21	0	0
23	28704683	.	G	A	7	11	18	0	0	18	0	0
23	28707051	.	C	T	7	10	17	0	0	17	0	0
23	28710429	.	T	C	17	7	24	0	1	25	0	0
23	28712193	.	T	G	11	11	22	0	0	22	0	0
23	28713648	.	C	T	12	11	23	0	1	24	0	0
23	28725425	.	C	T	5	5	10	0	0	10	0	0
23	28725899	.	T	A	4	4	8	0	0	8	0	0
23	28725916	.	A	C	3	4	7	0	0	7	0	0
23	28725991	.	T	C	4	2	6	0	0	6	0	0
23	28725994	.	G	A	4	2	6	0	0	6	0	0
23	28726053	.	A	T	4	3	7	0	0	7	0	0
23	28726060	.	G	A	4	3	7	0	0	7	0	0
23	28726100	.	G	T	2	3	5	0	0	5	0	0
23	28726143	.	A	T	2	2	4	0	0	4	0	0
23	28726486	.	A	T	4	7	11	0	0	11	0	0
23	28726738	.	A	G	8	9	17	0	3	20	0	0
23	28726852	.	T	C	6	4	10	0	1	11	0	0
23	28726937	.	C	A	1	3	4	0	0	4	0	0
23	28731489	.	A	C	27	23	50	0	1	51	0	0
23	28731834	.	C	T	34	29	63	0	0	63	0	0
23	28731914	.	T	C	37	24	61	0	5	66	0	0
23	28732305	.	A	T	1	3	4	0	1	5	0	0
23	28803167	.	A	G	1	2	3	0	0	3	0	0
23	28803305	.	C	T	1	7	8	0	0	8	0	0
23	28803597	.	G	A	1	2	3	0	0	3	0	0
23	28806171	.	A	G	2	5	7	0	0	7	0	0
23	28806278	.	A	G	3	3	6	0	0	6	0	0
23	28882508	.	T	C	1	5	6	0	0	6	0	0
23	28882538	.	T	C	4	6	10	0	0	10	0	0
23	28882550	.	C	T	3	6	9	0	1	10	0	0
23	28922024	.	A	G	2	6	8	0	0	8	0	0
23	28922165	.	C	A	1	6	7	0	1	8	0	0
23	28922716	.	C	T	1	4	5	0	0	6	1	0
23	28922778	.	T	A	3	3	6	0	0	6	0	0
23	28922854	.	A	C	3	3	6	0	1	7	0	0
23	28922920	.	T	A	3	3	6	0	0	6	0	0
23	28923151	.	C	T	1	2	3	0	0	3	0	0
23	28923571	.	T	A	2	11	13	0	0	13	0	0
23	28923660	.	A	T	5	3	8	0	0	8	0	0
23	28923797	.	G	A	3	7	10	0	0	11	1	0
23	28923959	.	T	A	8	5	13	0	0	13	0	0
23	28924079	.	A	C	3	5	8	0	0	8	0	0
23	28924117	.	G	C	3	7	10	0	0	10	0	0
23	28924399	.	C	G	3	13	16	1	0	17	0	0
23	28924672	.	C	T	3	8	11	0	0	11	0	0
23	28924687	.	G	A	2	7	9	0	1	10	0	0
23	28924806	.	A	G	1	4	5	0	0	5	0	0
23	28925156	.	A	T	4	5	9	0	0	9	0	0
23	28925159	.	G	A	0	5	5	0	4	9	0	0
23	28925270	.	T	G	7	5	12	1	0	13	0	0
23	28925272	.	A	G	8	2	10	1	2	13	0	0
23	28925354	.	T	C	4	7	11	0	0	11	0	0
23	28925589	.	G	A	0	4	4	0	3	7	0	0
23	28967458	.	T	A	3	2	5	0	0	5	0	0
23	28969691	.	A	G	3	6	9	0	1	10	0	0
23	28970042	.	A	G	2	3	5	0	0	5	0	0
23	28970057	.	G	T	2	4	6	0	0	6	0	0
23	28979414	.	A	G	3	4	7	0	0	7	0	0
23	28993935	.	T	C	2	2	4	0	0	4	0	0
23	29359664	.	T	A	16	22	38	0	0	39	1	0
23	29360044	.	T	C	15	26	41	0	1	42	0	0
23	29360407	.	G	T	1	12	13	0	14	27	0	0
23	29376111	.	T	C	13	11	24	0	1	25	0	0
23	29376410	.	C	T	10	16	26	0	2	28	0	0
23	29381612	.	C	A	6	6	12	0	0	12	0	0
23	29381816	.	G	A	9	17	26	0	2	28	0	0
23	29381819	.	T	G	10	16	26	0	1	27	0	0
23	29381855	.	T	G	12	22	34	0	1	35	0	0
23	29383693	.	C	A	13	11	24	1	1	26	0	0
23	29386973	.	G	T	7	5	12	0	0	12	0	0
23	29392421	.	G	A	8	8	16	0	1	17	0	0
23	29393414	.	C	T	2	9	11	0	8	19	0	0
23	29393628	.	G	A	9	5	14	0	0	14	0	0
23	29393643	.	A	T	6	7	13	0	1	14	0	0
23	29393787	.	A	G	2	3	5	0	1	6	0	0
23	29394039	.	T	C	3	4	7	0	0	7	0	0
23	29396482	.	C	T	33	23	56	0	3	59	0	0
23	29396588	.	T	C	29	2	31	1	25	57	0	0
23	29397116	.	C	G	22	19	41	0	2	43	0	0
23	29397451	.	T	G	28	17	45	0	0	45	0	0
23	29397476	.	T	C	33	11	44	1	1	46	0	0
23	29397509	.	T	C	37	12	49	1	0	50	0	0
23	29397537	.	G	A	30	18	48	0	0	48	0	0
23	29397584	.	C	A	22	17	39	0	0	39	0	0
23	29397590	.	C	G	21	15	36	0	1	37	0	0
23	29397665	.	T	G	20	12	32	0	0	32	0	0
23	29398015	.	C	A	3	33	36	0	27	63	0	0
23	29398025	.	G	A	29	30	59	0	2	61	0	0
23	29398065	.	T	C	30	22	52	0	1	53	0	0
23	29398288	.	T	G	35	10	45	0	1	46	0	0
23	29398310	.	C	T	31	17	48	0	0	48	0	0
23	29398343	.	A	G	27	28	55	0	0	55	0	0
23	29398390	.	C	T	20	30	50	1	1	52	0	0
23	29398718	.	A	T	18	29	47	0	3	50	0	0
23	29399085	.	T	C	36	1	37	1	24	62	0	0
23	29402103	.	A	G	26	27	53	0	2	55	0	0
23	29403243	.	G	A	33	22	55	0	1	56	0	0
23	29403297	.	G	A	29	25	54	0	2	56	0	0
23	29403437	.	G	A	33	28	61	0	2	63	0	0
23	29403491	.	C	A	38	23	61	0	3	64	0	0
23	29403515	.	A	C	39	24	63	0	1	64	0	0
23	29405829	.	A	G	31	21	52	0	3	55	0	0
23	29408773	.	A	G	35	23	58	1	6	65	0	0
23	29412411	.	A	G	32	25	57	0	5	62	0	0
23	29415484	.	A	G	19	22	41	1	3	45	0	0
23	29422007	.	G	C	27	0	27	0	27	54	0	0
23	29423410	.	G	A	31	23	54	0	1	55	0	0
23	29431995	.	T	C	22	22	44	0	1	45	0	0
23	29432040	.	A	G	16	27	43	0	1	44	0	0
23	29432055	.	G	A	19	24	43	0	1	44	0	0
23	29432867	.	T	G	24	21	45	0	0	45	0	0
23	29433670	.	G	A	16	20	36	0	4	40	0	0
23	29435044	.	T	C	18	20	38	0	2	40	0	0
23	29435330	.	C	T	17	18	35	0	0	35	0	0
23	29435381	.	G	A	21	21	42	0	2	44	0	0
23	29457909	.	G	A	22	18	40	0	0	40	0	0
23	29457942	.	T	C	13	0	13	0	21	34	0	0
23	29463158	.	A	G	13	15	28	1	3	32	0	0
23	29468650	.	T	C	21	12	33	0	0	33	0	0
23	29468653	.	G	A	19	11	30	0	1	31	0	0
23	29468959	.	A	G	20	16	36	0	3	39	0	0
23	29468980	.	G	A	21	17	38	0	0	38	0	0
23	29469261	.	A	G	11	18	29	0	0	29	0	0
23	29502227	.	C	T	0	16	16	0	19	35	0	0
23	29502302	.	C	T	2	18	20	0	17	37	0	0
23	29502311	.	C	T	14	16	30	0	2	32	0	0
23	29505482	.	C	T	2	6	8	0	14	22	0	0
23	29507723	.	A	T	20	12	32	0	1	33	0	0
23	29507825	.	T	C	10	0	10	0	10	20	0	0
23	29507859	.	T	G	6	10	16	0	0	16	0	0
23	29507883	.	G	A	8	12	20	0	0	20	0	0
23	29508247	.	G	C	17	0	17	0	10	27	0	0
23	29516726	.	T	C	12	10	22	0	0	22	0	0
23	29519565	.	G	A	8	4	12	1	1	14	0	0
23	29519769	.	G	C	8	12	20	0	0	21	1	0
23	29520070	.	A	C	12	4	16	0	0	16	0	0
23	29523602	.	G	A	8	10	18	0	0	18	0	0
23	29541251	.	C	T	8	3	11	0	0	11	0	0
23	29541317	.	G	A	7	4	11	0	0	11	0	0
23	29567633	.	T	A	1	2	3	0	0	3	0	0
23	29570627	.	C	G	10	9	19	0	0	19	0	0
23	29574311	.	C	G	4	2	6	0	0	7	1	0
23	29574430	.	G	C	2	3	5	0	0	5	0	0
23	29574435	.	C	T	2	2	4	0	0	4	0	0
23	29582416	.	T	C	21	41	62	0	1	63	0	0
23	29582420	.	T	C	18	45	63	0	1	64	0	0
23	29582476	.	T	C	5	52	57	0	4	61	0	0
23	29582496	.	T	C	33	24	57	0	2	59	0	0
23	29582634	.	C	A	45	22	67	0	3	70	0	0
23	29582673	.	A	G	44	24	68	0	0	68	0	0
23	29583417	.	T	A	25	38	63	0	1	64	0	0
23	29583708	.	G	A	38	26	64	0	2	66	0	0
23	29583814	.	T	A	48	35	83	0	2	85	0	0
23	29583882	.	A	G	44	33	77	3	0	80	0	0
23	29583960	.	G	A	37	35	72	0	11	83	0	0
23	29586380	.	G	A	40	32	72	0	4	76	0	0
23	29592588	.	T	C	37	3	40	1	31	72	0	0
23	29592708	.	G	A	37	25	62	0	3	65	0	0
23	29592741	.	C	T	35	23	58	0	4	62	0	0
23	29592927	.	T	C	35	1	36	0	27	63	0	0
23	29594441	.	A	G	28	26	54	1	1	56	0	0
23	29601269	.	C	T	30	19	49	0	3	52	0	0
23	29603174	.	T	C	28	26	54	0	3	57	0	0
23	29607011	.	A	G	23	24	47	0	2	49	0	0
23	29607029	.	A	G	18	28	46	0	0	46	0	0
23	29608769	.	A	G	27	16	43	0	5	48	0	0
23	29617571	.	A	C	33	2	35	1	13	49	0	0
23	29667473	.	A	C	34	16	50	0	1	51	0	0
23	29667480	.	G	A	35	14	49	0	2	51	0	0
23	29667614	.	C	G	19	22	41	0	1	42	0	0
23	29667784	.	G	A	2	4	6	0	0	6	0	0
23	29711788	.	G	A	9	15	24	0	1	25	0	0
23	29711911	.	C	T	10	17	27	0	0	27	0	0
23	29711998	.	G	A	17	11	28	0	1	29	0	0
23	29712140	.	G	A	9	11	20	0	0	20	0	0
23	29712465	.	G	A	9	14	23	0	0	23	0	0
23	29712493	.	C	T	2	12	14	0	8	22	0	0
23	29712922	.	C	A	13	10	23	0	1	24	0	0
23	29756865	.	A	T	6	10	16	0	2	18	0	0
23	29756977	.	T	C	1	6	7	0	0	7	0	0
23	29757099	.	A	T	7	6	13	0	0	13	0	0
23	29757980	.	T	C	11	1	12	0	11	23	0	0
23	29758030	.	C	T	2	14	16	0	8	24	0	0
23	29758088	.	A	G	8	19	27	0	1	28	0	0
23	29764120	.	T	C	8	9	17	0	1	18	0	0
23	29781868	.	G	A	4	8	12	0	2	14	0	0
23	29810779	.	G	A	4	4	8	0	0	8	0	0
23	29812663	.	A	T	6	5	11	0	0	11	0	0
23	29827748	.	G	A	4	4	8	0	1	9	0	0
23	29829115	.	A	G	3	4	7	0	0	7	0	0
23	29829160	.	A	T	4	6	10	0	0	10	0	0
23	29829186	.	A	C	5	5	10	0	0	10	0	0
23	29840171	.	T	C	4	0	4	0	7	11	0	0
23	29840274	.	C	A	11	6	17	0	0	17	0	0
23	29841374	.	T	C	3	4	7	0	0	7	0	0
23	29842966	.	C	T	6	3	9	0	0	9	0	0
23	29842967	.	T	G	6	3	9	0	0	9	0	0
23	29843104	.	T	C	3	2	5	0	0	5	0	0
23	29843566	.	A	C	2	5	7	0	0	7	0	0
23	29844310	.	C	A	1	3	4	0	5	9	0	0
23	29849025	.	A	G	4	5	9	0	1	10	0	0
23	29854359	.	G	A	10	6	16	0	0	16	0	0
23	29854362	.	C	T	3	5	8	0	9	17	0	0
23	29854443	.	G	A	6	6	12	0	0	12	0	0
23	29854491	.	C	T	4	3	7	0	0	7	0	0
23	29857967	.	T	A	6	3	9	0	0	9	0	0
23	29861645	.	A	T	12	4	16	0	1	17	0	0
23	29861973	.	A	G	16	18	34	0	0	34	0	0
23	29861976	.	T	C	15	0	15	0	18	33	0	0
23	29867576	.	G	A	7	10	17	0	1	18	0	0
23	29872254	.	A	G	5	10	15	0	2	17	0	0
23	29886897	.	G	C	15	19	34	0	1	35	0	0
23	29886937	.	T	A	18	15	33	0	3	36	0	0
23	29938120	.	A	G	2	0	2	0	2	4	0	0
23	29938154	.	C	T	2	1	3	0	1	4	0	0
23	29978089	.	T	C	4	2	6	0	0	6	0	0
23	29979467	.	T	C	3	3	6	0	0	6	0	0
23	29992023	.	G	C	5	4	9	0	0	9	0	0
23	30009227	.	T	A	3	3	6	0	0	6	0	0
23	30009230	.	C	A	2	3	5	0	0	5	0	0
23	30009382	.	C	T	1	3	4	0	0	4	0	0
23	30013921	.	A	C	1	2	3	0	0	3	0	0
23	30014160	.	T	A	1	2	3	0	0	3	0	0
23	30014162	.	C	A	0	2	2	0	1	3	0	0
23	30016857	.	T	A	5	3	8	0	0	8	0	0
23	30045528	.	A	T	1	2	3	0	0	3	0	0
23	30061605	.	A	C	20	10	30	0	2	32	0	0
23	30061763	.	C	T	1	23	24	0	22	46	0	0
23	30061804	.	A	C	18	18	36	0	2	38	0	0
23	30061960	.	T	C	21	0	21	0	23	44	0	0
23	30062364	.	T	A	18	12	30	0	3	33	0	0
23	30062792	.	C	T	13	16	29	0	1	30	0	0
23	30062888	.	C	T	0	19	19	1	16	36	0	0
23	30063216	.	T	C	13	0	13	0	16	29	0	0
23	30063217	.	T	G	13	16	29	0	0	29	0	0
23	30063527	.	G	A	16	6	22	0	1	23	0	0
23	30063578	.	A	G	12	13	25	0	1	26	0	0
23	30063643	.	C	T	12	8	20	0	1	21	0	0
23	30063722	.	G	A	7	5	12	0	2	14	0	0
23	30064289	.	T	C	7	11	18	0	7	25	0	0
23	30064579	.	A	G	19	13	32	0	0	32	0	0
23	30064743	.	C	A	8	16	24	0	2	26	0	0
23	30064804	.	A	G	8	12	20	0	0	20	0	0
23	30064853	.	A	G	13	9	22	0	1	23	0	0
23	30065144	.	G	A	6	13	19	1	1	21	0	0
23	30065641	.	T	G	11	2	13	0	1	14	0	0
23	30071637	.	G	A	10	13	23	0	1	24	0	0
23	30074633	.	A	G	10	16	26	0	0	26	0	0
23	30074651	.	G	T	8	16	24	0	0	24	0	0
23	30075201	.	G	A	13	8	21	0	0	21	0	0
23	30075367	.	A	T	11	18	29	0	0	29	0	0
23	30077023	.	T	C	12	1	13	1	17	31	0	0
23	30085812	.	A	T	4	5	9	1	0	10	0	0
23	30124048	.	A	C	8	0	8	0	13	21	0	0
23	30124303	.	C	T	0	11	11	0	12	23	0	0
23	30124430	.	C	G	5	3	8	0	2	10	0	0
23	30124651	.	A	G	15	13	28	0	2	30	0	0
23	30124818	.	C	T	9	6	15	0	0	15	0	0
23	30124960	.	G	A	6	6	12	0	1	13	0	0
23	30124998	.	T	C	4	8	12	0	2	14	0	0
23	30125004	.	G	A	4	6	10	0	0	10	0	0
23	30125206	.	A	G	10	8	18	0	0	18	0	0
23	30125443	.	G	A	8	5	13	0	0	13	0	0
23	30125599	.	G	A	10	6	16	0	1	17	0	0
23	30125698	.	A	G	5	3	8	0	1	9	0	0
23	30128788	.	G	A	4	3	7	0	1	8	0	0
23	30210267	.	A	G	5	3	8	0	0	8	0	0
23	30715328	.	T	C	7	6	13	0	1	14	0	0
23	30715397	.	G	A	2	4	6	0	4	10	0	0
23	30715991	.	A	G	8	0	8	0	3	11	0	0
23	30716096	.	C	T	6	2	8	0	0	8	0	0
23	30718514	.	T	A	8	6	14	0	0	14	0	0
23	30718554	.	A	G	5	0	5	0	6	11	0	0
23	30724698	.	T	A	5	3	8	0	2	10	0	0
23	30724828	.	G	C	2	4	6	0	0	6	0	0
23	30726880	.	G	A	2	2	4	0	0	4	0	0
23	30726898	.	T	G	2	4	6	0	0	6	0	0
23	30730194	.	C	T	7	2	9	0	0	9	0	0
23	30730351	.	C	T	1	4	5	0	0	5	0	0
23	30750183	.	G	A	1	15	16	0	9	25	0	0
23	30750402	.	C	A	10	9	19	0	2	21	0	0
23	30752095	.	C	A	9	12	21	0	0	21	0	0
23	30752233	.	T	G	5	6	11	0	1	12	0	0
23	30752352	.	A	T	3	5	8	0	0	8	0	0
23	30761144	.	G	A	8	7	15	0	2	17	0	0
23	30764212	.	T	C	17	10	27	0	0	27	0	0
23	30770193	.	A	G	14	16	30	0	0	30	0	0
23	30772902	.	C	T	7	12	19	0	1	20	0	0
23	30775273	.	T	C	16	15	31	0	1	32	0	0
23	30778358	.	T	C	4	5	9	0	0	9	0	0
23	30778499	.	G	A	13	6	19	0	0	19	0	0
23	30828279	.	A	C	1	3	4	0	1	5	0	0
23	30845760	.	C	G	1	2	3	0	1	4	0	0
23	30859543	.	C	A	2	3	5	0	1	6	0	0
23	30890018	.	G	T	1	1	2	0	1	3	0	0
23	30890191	.	T	G	7	3	10	0	0	10	0	0
23	30898132	.	C	T	2	7	9	0	0	9	0	0
23	30898150	.	T	C	1	5	6	0	0	6	0	0
23	30898297	.	T	C	4	4	8	0	0	8	0	0
23	30898355	.	A	C	8	6	14	0	0	14	0	0
23	30898387	.	C	T	9	3	12	0	0	12	0	0
23	30898467	.	G	C	0	5	5	0	3	8	0	0
23	30898503	.	A	T	3	4	7	0	0	7	0	0
23	30918919	.	A	G	3	3	6	0	0	6	0	0
23	30919027	.	T	G	5	3	8	0	0	8	0	0
23	30940412	.	A	T	2	2	4	0	1	5	0	0
23	30951633	.	A	G	3	2	5	0	0	5	0	0
23	30992939	.	C	A	2	2	4	0	1	5	0	0
23	30992952	.	G	A	2	3	5	0	0	5	0	0
23	31245593	.	A	T	3	6	9	0	0	9	0	0
23	31248605	.	A	T	2	5	7	0	0	7	0	0
23	31276396	.	T	A	7	5	12	0	0	12	0	0
23	31276453	.	G	A	10	8	18	0	0	18	0	0
23	31276509	.	C	T	6	6	12	0	2	14	0	0
23	31276657	.	T	C	10	8	18	0	1	19	0	0
23	31278183	.	G	T	11	5	16	0	0	16	0	0
23	31278322	.	A	G	7	8	15	0	0	15	0	0
23	31278375	.	A	G	10	10	20	0	1	21	0	0
23	31278417	.	G	T	7	10	17	0	0	17	0	0
23	31278450	.	T	A	3	6	9	0	3	12	0	0
23	31278732	.	C	T	4	9	13	0	0	13	0	0
23	31278792	.	G	T	4	5	9	0	0	9	0	0
23	31279122	.	G	T	8	4	12	0	0	12	0	0
23	31280198	.	G	A	4	3	7	0	0	7	0	0
23	31280892	.	T	A	7	3	10	0	0	10	0	0
23	31281768	.	T	G	2	2	4	0	0	4	0	0
23	31306794	.	T	C	3	3	6	0	1	7	0	0
23	31309710	.	T	C	3	3	6	0	0	6	0	0
23	31341052	.	A	G	3	3	6	0	0	6	0	0
23	31358342	.	A	T	33	18	51	0	0	51	0	0
23	31358344	.	A	T	26	18	44	0	1	45	0	0
23	31358489	.	T	G	21	23	44	0	2	46	0	0
23	31358631	.	G	A	26	32	58	0	1	59	0	0
23	31380641	.	A	G	2	2	4	0	1	5	0	0
23	31380643	.	G	A	2	3	5	0	0	5	0	0
23	31381425	.	C	T	3	3	6	0	0	6	0	0
23	31388310	.	G	A	1	2	3	0	0	3	0	0
23	31396169	.	C	T	3	3	6	0	0	6	0	0
23	31405519	.	C	T	6	7	13	0	1	14	0	0
23	31405570	.	A	C	11	10	21	0	2	23	0	0
23	31419172	.	A	T	6	2	8	0	1	9	0	0
23	31422369	.	A	T	6	2	8	0	0	8	0	0
23	31422429	.	C	T	5	4	9	0	0	9	0	0
23	31422600	.	C	T	5	5	10	0	1	11	0	0
23	31422768	.	A	G	5	4	9	1	0	10	0	0
23	31423091	.	T	C	8	5	13	0	0	13	0	0
23	31423145	.	G	A	2	11	13	0	4	17	0	0
23	31423392	.	C	A	16	10	26	0	0	27	1	0
23	31423427	.	A	G	12	1	13	0	7	20	0	0
23	31423432	.	C	A	13	6	19	0	2	21	0	0
23	31432102	.	A	G	8	0	8	0	14	22	0	0
23	31440119	.	T	A	5	2	7	0	0	7	0	0
23	31596584	.	T	G	4	0	4	0	5	9	0	0
23	31597571	.	T	C	7	7	14	0	0	14	0	0
23	31604900	.	C	T	3	4	7	0	0	7	0	0
23	31641153	.	C	A	20	26	46	0	2	48	0	0
23	31641197	.	A	G	25	22	47	0	3	50	0	0
23	31641270	.	G	A	28	15	43	0	3	46	0	0
23	31643818	.	A	G	20	13	33	0	1	34	0	0
23	31644368	.	A	G	8	24	32	0	0	32	0	0
23	31644419	.	A	G	9	16	25	0	1	26	0	0
23	31644602	.	T	G	11	12	23	0	2	25	0	0
23	31684244	.	A	G	14	8	22	0	1	23	0	0
23	31684352	.	G	A	18	16	34	0	1	35	0	0
23	31768596	.	T	C	5	8	13	0	1	14	0	0
23	31771282	.	T	C	9	9	18	0	1	19	0	0
23	31774194	.	G	A	13	11	24	0	0	24	0	0
23	31778174	.	A	G	7	7	14	0	0	14	0	0
23	31778183	.	C	T	7	6	13	0	0	13	0	0
23	31782969	.	T	C	11	0	11	0	7	19	1	0
23	31785175	.	G	A	8	4	12	0	1	13	0	0
23	31785183	.	T	G	7	4	11	0	3	14	0	0
23	31787127	.	C	G	7	9	16	0	0	16	0	0
23	31804162	.	A	G	4	6	10	0	0	10	0	0
23	31914316	.	C	T	1	2	3	0	1	4	0	0
23	31933739	.	T	G	5	5	10	0	0	10	0	0
23	31940681	.	C	A	5	4	9	0	0	9	0	0
23	31953228	.	A	T	1	3	4	0	1	5	0	0
23	31962971	.	T	C	8	6	14	0	0	14	0	0
23	31963226	.	C	T	4	9	13	0	1	14	0	0
23	31963360	.	A	G	5	4	9	0	0	9	0	0
23	31964680	.	C	T	10	8	18	0	2	20	0	0
23	31982041	.	T	C	2	4	6	0	0	6	0	0
23	31982042	.	C	T	2	4	6	0	0	6	0	0
23	31984871	.	C	T	3	3	6	0	0	6	0	0
23	31986705	.	T	G	1	0	1	0	7	8	0	0
23	31992375	.	T	C	4	5	9	0	0	9	0	0
23	31992522	.	T	C	4	6	10	0	0	10	0	0
23	31992537	.	C	T	4	5	9	0	1	10	0	0
23	31992690	.	C	T	3	4	7	0	0	7	0	0
23	31993590	.	C	T	2	3	5	0	0	5	0	0
23	31997582	.	G	A	7	5	12	0	0	12	0	0
23	31997953	.	C	T	4	7	11	0	0	11	0	0
23	31998162	.	T	C	9	3	12	0	0	12	0	0
23	31998741	.	A	G	3	1	4	0	8	12	0	0
23	32000336	.	G	C	4	5	9	0	0	9	0	0
23	32001190	.	C	T	5	4	9	0	0	9	0	0
23	32003354	.	T	A	9	10	19	0	0	19	0	0
23	32003808	.	T	C	2	9	11	0	0	11	0	0
23	32007376	.	T	G	9	5	14	0	2	16	0	0
23	32007445	.	T	A	6	11	17	0	2	19	0	0
23	32007520	.	T	C	10	3	13	0	0	13	0	0
23	32007526	.	C	G	7	3	10	0	1	11	0	0
23	32019847	.	A	G	1	2	3	0	1	4	0	0
23	32019855	.	A	C	1	2	3	0	0	3	0	0
23	32026927	.	T	C	13	10	23	0	2	25	0	0
23	32026978	.	C	T	11	5	16	0	0	16	0	0
23	32026996	.	G	A	1	2	3	0	7	11	1	0
23	32081708	.	C	T	15	13	28	0	2	30	0	0
23	32081717	.	T	C	16	14	30	0	1	31	0	0
23	32085908	.	G	T	1	4	5	0	0	5	0	0
23	32096873	.	C	T	0	4	4	0	5	9	0	0
23	32128848	.	A	T	2	2	4	0	0	4	0	0
23	32129476	.	G	T	3	3	6	0	0	6	0	0
23	32129514	.	G	T	1	3	4	0	0	4	0	0
23	32151669	.	A	C	7	15	22	0	2	24	0	0
23	32152022	.	C	T	8	8	16	0	0	16	0	0
23	32154021	.	G	T	5	7	12	0	0	12	0	0
23	32155325	.	A	G	6	9	15	0	0	15	0	0
23	32155719	.	C	T	12	5	17	0	1	18	0	0
23	32155720	.	C	T	1	6	7	0	10	17	0	0
23	32155864	.	A	C	5	0	5	0	4	9	0	0
23	32155975	.	C	T	2	3	5	0	1	6	0	0
23	32157787	.	G	T	4	7	11	0	0	11	0	0
23	32200004	.	A	G	4	3	7	0	0	7	0	0
23	32200410	.	A	G	5	3	8	0	0	8	0	0
23	32200482	.	T	C	3	5	8	0	0	8	0	0
23	32200517	.	C	A	1	2	3	0	1	4	0	0
23	32200583	.	C	T	0	2	2	0	3	5	0	0
23	32200689	.	G	A	2	2	4	0	0	4	0	0
23	32200979	.	A	G	8	6	14	0	1	15	0	0
23	32201087	.	G	T	6	4	10	0	0	10	0	0
23	32235977	.	C	A	2	2	4	0	0	4	0	0
23	32239474	.	A	G	1	3	4	0	0	4	0	0
23	32239513	.	T	G	3	4	7	0	0	7	0	0
23	32239688	.	C	A	11	3	14	0	0	14	0	0
23	32239708	.	G	A	13	6	19	0	0	19	0	0
23	32239824	.	G	A	6	14	20	0	0	20	0	0
23	32240258	.	C	T	6	4	10	0	0	10	0	0
23	32240290	.	A	G	8	7	15	0	0	15	0	0
23	32242086	.	C	A	9	10	19	0	1	20	0	0
23	32242251	.	T	C	16	8	24	0	0	24	0	0
23	32246169	.	A	G	11	8	19	0	0	19	0	0
23	32246190	.	A	G	9	7	16	0	1	17	0	0
23	32248595	.	C	G	7	6	13	0	0	13	0	0
23	32250286	.	C	T	8	4	12	0	0	12	0	0
23	32251473	.	T	G	7	3	10	0	1	11	0	0
23	32262708	.	G	A	3	3	6	0	0	6	0	0
23	32304535	.	T	G	2	2	4	0	1	5	0	0
23	32304585	.	C	T	7	2	9	0	0	9	0	0
23	32309187	.	T	C	15	10	25	0	1	26	0	0
23	32309193	.	G	A	16	10	26	0	1	28	1	0
23	32309323	.	G	A	15	13	28	0	0	28	0	0
23	32309533	.	A	G	13	10	23	0	0	23	0	0
23	32309659	.	C	A	2	6	8	0	5	13	0	0
23	32309709	.	G	A	10	6	16	0	1	17	0	0
23	32309787	.	A	C	12	11	23	0	0	23	0	0
23	32309846	.	T	A	4	5	9	0	0	9	0	0
23	32309943	.	A	G	8	4	12	0	1	13	0	0
23	32310254	.	T	A	9	4	13	0	0	13	0	0
23	32310864	.	G	A	10	3	13	0	0	13	0	0
23	32311418	.	T	C	7	6	13	0	1	14	0	0
23	32311555	.	G	C	17	19	36	0	0	36	0	0
23	32311612	.	G	A	19	11	30	0	0	30	0	0
23	32318047	.	A	G	17	17	34	0	0	34	0	0
23	32326532	.	A	G	12	5	17	0	1	18	0	0
23	32362317	.	A	G	8	8	16	0	0	16	0	0
23	32531948	.	T	C	3	2	5	0	0	5	0	0
23	32532018	.	T	G	2	2	4	0	0	4	0	0
23	32589398	.	C	T	4	5	9	0	0	9	0	0
23	32592331	.	A	G	6	8	14	0	0	14	0	0
23	32592518	.	A	G	9	4	13	0	2	15	0	0
23	32599214	.	G	T	13	5	18	0	1	19	0	0
23	32636197	.	G	A	4	4	8	0	0	8	0	0
23	32641956	.	C	T	0	3	3	0	9	12	0	0
23	32641959	.	G	A	7	5	12	0	0	12	0	0
23	32645443	.	G	A	4	11	15	0	1	16	0	0
23	32668999	.	A	G	7	6	13	0	0	13	0	0
23	32702864	.	C	T	1	2	3	0	4	7	0	0
23	32702903	.	C	T	4	2	6	0	0	6	0	0
23	32702945	.	A	G	1	3	4	0	0	4	0	0
23	32702993	.	C	T	1	3	4	0	0	4	0	0
23	32891503	.	A	T	2	3	5	0	0	5	0	0
23	32892620	.	A	G	2	4	6	0	0	6	0	0
23	33357856	.	A	C	6	6	12	0	0	12	0	0
23	33357953	.	T	A	7	6	13	0	0	13	0	0
23	33361256	.	C	T	0	8	8	0	10	18	0	0
23	33437440	.	T	A	2	3	5	0	1	6	0	0
23	33448483	.	A	G	2	2	4	0	0	4	0	0
23	33633592	.	T	C	3	5	8	0	0	8	0	0
23	33654535	.	G	A	0	3	3	0	1	4	0	0
23	33657431	.	T	A	13	9	22	0	0	22	0	0
23	33657460	.	C	T	7	14	21	0	3	24	0	0
23	33657467	.	T	A	10	16	26	0	0	26	0	0
23	33657714	.	T	G	9	11	20	0	1	21	0	0
23	33682045	.	A	T	3	4	7	0	0	7	0	0
23	33682306	.	T	C	6	5	11	1	0	12	0	0
23	33682313	.	A	G	5	5	10	1	1	12	0	0
23	33682369	.	T	A	2	7	9	1	0	10	0	0
23	33682370	.	T	A	2	7	9	1	0	10	0	0
23	33682416	.	T	A	4	2	6	0	0	6	0	0
23	33682463	.	T	G	0	3	3	0	0	3	0	0
23	33682736	.	A	G	2	5	7	1	0	8	0	0
23	33682740	.	A	T	3	5	8	1	0	9	0	0
23	33682780	.	C	T	4	4	8	0	0	8	0	0
23	33683092	.	T	G	2	10	12	0	1	13	0	0
23	33683518	.	A	G	5	5	10	0	0	10	0	0
23	33688013	.	T	C	4	0	4	0	7	11	0	0
23	33693482	.	G	A	6	8	14	0	1	15	0	0
23	33693572	.	T	C	4	3	7	0	0	7	0	0
23	33694328	.	A	C	8	1	9	0	3	12	0	0
23	33696929	.	T	G	4	3	7	0	0	7	0	0
23	33696938	.	C	G	4	3	7	0	0	7	0	0
23	33698929	.	G	A	3	3	6	0	0	6	0	0
23	33702812	.	G	A	3	2	5	0	0	5	0	0
23	33709937	.	G	A	2	2	4	0	0	4	0	0
23	33718699	.	T	C	22	24	46	0	0	46	0	0
23	33724825	.	G	A	4	15	19	0	28	47	0	0
23	33727916	.	C	T	26	21	47	0	3	50	0	0
23	33728398	.	A	T	15	29	44	0	0	44	0	0
23	33728518	.	T	C	18	17	35	0	0	35	0	0
23	33728609	.	A	T	21	23	44	0	3	47	0	0
23	33728877	.	T	A	23	29	52	0	2	55	1	0
23	33728994	.	T	A	16	8	24	0	0	24	0	0
23	33729231	.	T	A	16	7	23	0	1	24	0	0
23	33729510	.	A	G	18	23	41	0	2	43	0	0
23	33822891	.	T	C	2	7	9	0	0	9	0	0
23	33837975	.	C	T	4	7	11	0	1	12	0	0
23	33837983	.	A	G	4	0	4	0	8	12	0	0
23	33873137	.	T	A	12	4	16	0	3	19	0	0
23	33873187	.	C	G	11	7	18	0	0	18	0	0
23	33887839	.	C	T	7	10	17	0	0	17	0	0
23	33892021	.	C	T	10	10	20	0	0	20	0	0
23	33901239	.	C	T	13	6	19	1	0	20	0	0
23	33901271	.	C	T	6	7	13	1	2	16	0	0
23	33907969	.	C	A	17	13	30	0	2	32	0	0
23	33907990	.	A	G	18	0	18	0	14	32	0	0
23	33918162	.	C	T	21	13	34	0	1	35	0	0
23	33920287	.	G	A	17	23	40	0	1	41	0	0
23	33920311	.	A	G	17	23	40	0	1	41	0	0
23	33920344	.	C	T	15	16	31	0	1	32	0	0
23	33920431	.	C	T	12	16	28	0	2	30	0	0
23	33923716	.	A	G	15	1	16	0	19	35	0	0
23	33926555	.	C	A	24	17	41	0	3	44	0	0
23	33926663	.	C	T	28	20	48	0	0	48	0	0
23	33927045	.	C	T	24	23	47	0	2	49	0	0
23	33927244	.	G	A	3	16	19	0	21	40	0	0
23	33927500	.	T	A	19	10	29	0	0	29	0	0
23	33927897	.	T	G	26	19	45	1	3	50	1	0
23	33927941	.	C	T	28	20	48	0	4	52	0	0
23	33935471	.	C	G	6	11	17	0	0	17	0	0
23	33935549	.	C	T	11	7	18	0	1	19	0	0
23	33944059	.	G	A	9	7	16	0	0	16	0	0
23	33944188	.	C	T	8	7	15	0	2	17	0	0
23	33944295	.	T	G	3	5	8	0	0	8	0	0
23	33944336	.	A	T	9	4	13	0	1	14	0	0
23	33944337	.	G	A	9	5	14	0	0	14	0	0
23	33944421	.	C	A	2	3	5	0	0	5	0	0
23	33961885	.	C	G	3	0	3	0	9	12	0	0
23	33974392	.	T	C	13	15	28	0	1	29	0	0
23	33974659	.	C	A	15	18	33	0	1	34	0	0
23	33974662	.	A	T	15	17	32	0	0	32	0	0
23	33974827	.	A	T	12	13	25	0	2	27	0	0
23	33974904	.	T	A	8	10	18	0	1	19	0	0
23	33975854	.	T	A	25	11	36	0	0	36	0	0
23	33975994	.	G	A	7	5	12	0	0	12	0	0
23	33978028	.	T	G	8	3	11	0	1	12	0	0
23	33978125	.	A	C	3	5	8	0	0	8	0	0
23	33978462	.	T	A	14	11	25	0	1	26	0	0
23	33978469	.	C	T	11	12	23	0	2	25	0	0
23	33978577	.	C	T	3	12	15	0	0	15	0	0
23	33978639	.	G	T	6	13	19	0	2	21	0	0
23	33983333	.	G	C	12	19	31	0	2	33	0	0
23	33984364	.	G	A	13	14	27	0	3	30	0	0
23	33987467	.	T	G	7	10	17	0	0	17	0	0
23	33987637	.	C	T	9	9	18	0	0	18	0	0
23	33991132	.	G	A	6	13	19	0	1	20	0	0
23	33991145	.	T	A	0	3	3	0	0	3	0	0
23	33993191	.	T	C	9	12	21	0	0	21	0	0
23	34005089	.	G	T	4	8	12	0	0	12	0	0
23	34005095	.	T	C	4	7	11	0	1	12	0	0
23	34035241	.	G	T	12	10	22	0	1	23	0	0
23	34035295	.	G	A	10	12	22	0	0	22	0	0
23	34035364	.	C	T	10	18	28	0	1	29	0	0
23	34036432	.	A	G	19	11	30	0	0	30	0	0
23	34038436	.	C	T	23	14	37	0	1	38	0	0
23	34042998	.	C	T	15	18	33	0	2	35	0	0
23	34043308	.	G	T	18	20	38	0	0	38	0	0
23	34043335	.	G	A	1	15	16	0	22	38	0	0
23	34043423	.	G	A	16	14	30	0	2	32	0	0
23	34043536	.	T	C	16	7	23	0	2	25	0	0
23	34043596	.	T	C	6	7	13	0	1	14	0	0
23	34047440	.	G	A	0	5	5	0	14	19	0	0
23	34110634	.	C	T	19	16	35	0	0	35	0	0
23	34136467	.	C	T	13	13	26	0	2	28	0	0
23	34184982	.	G	C	2	3	5	0	0	5	0	0
23	34384939	.	C	T	2	2	4	0	1	5	0	0
23	34385597	.	G	A	3	5	8	0	2	10	0	0
23	34385720	.	G	A	8	3	11	0	1	12	0	0
23	34386119	.	T	C	3	4	7	0	0	7	0	0
23	34559897	.	C	T	3	5	8	1	3	12	0	0
23	34559971	.	C	T	3	4	7	0	1	8	0	0
23	34641484	.	C	T	3	4	7	0	0	7	0	0
23	34641505	.	G	A	0	4	4	0	3	7	0	0
23	34655172	.	G	A	0	5	5	0	4	9	0	0
23	34659533	.	C	T	3	10	13	0	0	13	0	0
23	34678957	.	G	T	7	7	14	0	1	15	0	0
23	34679008	.	A	G	7	5	12	0	0	12	0	0
23	34696631	.	C	T	4	7	11	0	0	11	0	0
23	34710333	.	C	T	5	11	16	0	0	16	0	0
23	34726384	.	A	G	8	0	8	0	12	20	0	0
23	34726387	.	A	G	8	13	21	0	1	22	0	0
23	34726438	.	T	C	12	11	23	0	0	23	0	0
23	34726444	.	G	T	12	12	24	0	0	24	0	0
23	34732871	.	A	G	8	1	9	0	9	18	0	0
23	34748833	.	G	A	2	12	14	0	6	20	0	0
23	34753803	.	A	G	9	13	22	0	3	25	0	0
23	35027189	.	T	C	3	2	5	0	0	5	0	0
23	35027386	.	T	G	6	3	9	0	1	10	0	0
23	35027480	.	T	G	5	3	8	0	0	8	0	0
23	35027518	.	T	A	5	3	8	0	2	10	0	0
23	35027541	.	A	G	6	3	9	0	0	9	0	0
23	35027736	.	C	G	5	12	17	0	0	17	0	0
23	35039803	.	C	T	4	4	8	0	3	11	0	0
23	35052494	.	G	A	5	3	8	0	0	8	0	0
23	35188562	.	G	A	3	1	4	0	2	6	0	0
23	35192619	.	A	G	3	2	5	0	0	5	0	0
23	35192697	.	G	T	1	2	3	0	0	3	0	0
23	35256186	.	G	A	3	3	6	0	0	6	0	0
23	35310779	.	G	A	4	3	7	0	2	9	0	0
23	35362951	.	C	T	7	9	16	0	0	16	0	0
23	35362973	.	G	T	8	7	15	0	0	15	0	0
23	35363024	.	A	T	5	4	9	0	0	9	0	0
23	35363054	.	T	G	3	1	4	0	7	11	0	0
23	35363067	.	A	T	7	5	12	0	2	15	1	0
23	35363106	.	G	A	15	13	28	0	0	28	0	0
23	35363111	.	C	G	17	15	32	0	1	33	0	0
23	35363226	.	T	C	16	0	16	0	15	31	0	0
23	35363341	.	A	G	14	10	24	0	0	24	0	0
23	35369733	.	G	A	4	6	10	0	0	10	0	0
23	35376893	.	A	G	3	3	6	0	0	6	0	0
23	35383037	.	C	T	3	3	6	0	0	6	0	0
23	35389118	.	C	T	3	2	5	0	1	6	0	0
23	35393459	.	A	G	7	10	17	0	0	17	0	0
23	35393473	.	G	T	8	9	17	0	1	18	0	0
23	35394053	.	G	C	6	5	11	0	0	11	0	0
23	35396735	.	C	A	9	6	15	0	0	15	0	0
23	35396791	.	C	A	9	6	15	0	0	15	0	0
23	35469135	.	T	C	2	3	5	0	1	6	0	0
23	35469136	.	G	A	3	2	5	0	1	6	0	0
23	35469479	.	A	G	6	10	16	0	0	16	0	0
23	35469668	.	G	T	8	10	18	0	0	18	0	0
23	35473640	.	A	G	9	4	13	0	1	14	0	0
23	35479283	.	A	C	5	1	6	0	1	7	0	0
23	35479987	.	G	A	5	3	8	0	0	8	0	0
23	35537390	.	C	T	17	4	21	0	0	21	0	0
23	35537599	.	G	A	11	4	15	0	1	16	0	0
23	35537617	.	G	A	8	6	14	0	0	14	0	0
23	35537693	.	A	C	2	2	4	0	0	4	0	0
23	35547370	.	G	A	2	2	4	0	0	4	0	0
23	35642327	.	T	G	8	6	14	0	0	14	0	0
23	35644234	.	C	T	4	6	10	0	0	10	0	0
23	35651790	.	T	C	4	5	9	0	0	9	0	0
23	35661380	.	C	T	3	8	11	0	0	11	0	0
23	35661530	.	T	C	6	13	19	0	0	19	0	0
23	35661549	.	A	C	5	11	16	0	0	16	0	0
23	35661572	.	A	C	3	8	11	0	1	12	0	0
23	35661660	.	T	G	7	1	8	0	5	13	0	0
23	35661692	.	C	A	6	8	14	1	0	15	0	0
23	35661723	.	A	C	9	5	14	1	0	15	0	0
23	35663421	.	T	G	6	5	11	0	1	12	0	0
23	35664298	.	A	G	2	4	6	0	2	8	0	0
23	35691968	.	T	G	12	10	22	5	0	27	0	0
23	35691989	.	G	A	2	2	4	1	0	5	0	0
23	35710179	.	A	C	35	20	55	7	1	63	0	0
23	37467073	.	A	G	10	7	17	0	0	17	0	0
23	37467109	.	A	G	12	0	12	0	12	24	0	0
23	37467115	.	A	G	17	0	17	0	9	26	0	0
23	39413261	.	A	C	6	0	6	0	16	22	0	0
23	39450021	.	G	A	7	4	11	0	0	11	0	0
23	39737157	.	T	C	1	1	2	0	0	2	0	0
23	39756775	.	T	G	2	17	19	0	1	20	0	0
23	39758548	.	T	C	4	2	6	0	2	8	0	0
23	39809185	.	G	A	25	3	28	15	3	46	0	0
23	40285717	.	A	G	2	4	6	0	0	6	0	0
23	40285727	.	A	G	5	2	7	0	0	7	0	0
23	40452660	.	A	T	11	10	21	0	1	22	0	0
23	40452667	.	T	C	12	9	21	0	1	22	0	0
23	40452735	.	G	T	12	6	18	0	0	18	0	0
23	40452739	.	G	C	2	7	9	0	11	20	0	0
23	40452793	.	A	G	7	8	15	0	1	16	0	0
23	40460860	.	G	C	8	11	19	0	0	19	0	0
23	40462004	.	A	G	4	10	14	0	0	14	0	0
23	40462538	.	G	A	14	8	22	0	0	22	0	0
23	40466320	.	C	T	6	8	14	0	1	15	0	0
23	40466623	.	C	G	5	6	11	0	0	11	0	0
23	40466714	.	T	A	6	6	12	0	1	13	0	0
23	40471963	.	G	A	2	13	15	0	13	28	0	0
23	40472068	.	A	G	7	0	7	0	11	18	0	0
23	40480255	.	C	A	13	9	22	0	1	23	0	0
23	40480263	.	C	T	15	9	24	0	1	25	0	0
23	40526549	.	T	C	5	2	7	0	0	7	0	0
23	40526556	.	T	C	2	4	6	0	0	6	0	0
23	40526883	.	T	G	8	5	13	0	0	13	0	0
23	40527219	.	T	C	4	0	4	3	5	12	0	0
23	40527246	.	T	C	5	3	8	10	0	18	0	0
23	40527359	.	T	C	5	0	5	0	7	12	0	0
23	40527425	.	C	T	0	2	2	0	6	8	0	0
23	40527427	.	A	C	6	0	6	0	2	8	0	0
23	40527632	.	G	A	6	4	10	4	0	14	0	0
23	40527653	.	T	G	4	4	8	2	0	10	0	0
23	40527852	.	A	T	6	0	6	1	3	10	0	0
23	40527993	.	A	C	7	2	9	0	0	9	0	0
23	40528151	.	T	A	10	3	13	1	1	15	0	0
23	40528182	.	T	C	5	0	5	0	8	13	0	0
23	40528397	.	A	G	4	3	7	0	0	7	0	0
23	40528669	.	C	T	0	6	6	0	12	18	0	0
23	40528727	.	G	A	14	9	23	0	2	25	0	0
23	40528886	.	T	A	12	14	26	0	2	29	1	0
23	40528998	.	G	A	10	12	22	0	0	22	0	0
23	40529137	.	T	C	4	8	12	0	1	13	0	0
23	40529288	.	T	C	8	5	13	0	0	13	0	0
23	40529318	.	A	G	12	6	18	0	0	18	0	0
23	40529693	.	T	C	6	10	16	0	0	16	0	0
23	40529708	.	T	C	6	12	18	0	0	18	0	0
23	40529747	.	G	A	6	8	14	0	1	15	0	0
23	40605107	.	C	T	4	4	8	0	0	8	0	0
23	40605139	.	G	C	3	2	5	0	0	5	0	0
23	40605155	.	T	C	2	2	4	0	0	4	0	0
23	40605193	.	A	T	1	3	4	0	0	4	0	0
23	40605356	.	C	T	2	5	7	0	0	7	0	0
23	40655395	.	T	G	2	2	4	0	0	4	0	0
23	40655425	.	A	G	3	4	7	0	0	7	0	0
23	40709924	.	A	G	2	0	2	0	6	8	0	0
23	40709943	.	A	G	1	0	1	0	5	6	0	0
23	40731757	.	A	G	6	2	8	0	0	8	0	0
23	40738428	.	T	C	5	2	7	0	1	8	0	0
23	40738508	.	A	G	2	5	7	0	1	8	0	0
23	40741765	.	C	T	2	5	7	0	0	7	0	0
23	40742133	.	G	C	9	4	13	0	0	13	0	0
23	40742234	.	C	A	3	10	13	0	1	14	0	0
23	40761073	.	T	A	11	7	18	0	0	18	0	0
23	40761326	.	T	A	5	7	12	0	2	14	0	0
23	40766436	.	A	G	8	6	14	0	0	14	0	0
23	40873218	.	T	A	1	2	3	0	0	3	0	0
23	40873232	.	A	T	1	2	3	0	0	3	0	0
23	40873364	.	T	A	1	7	8	0	1	9	0	0
23	40873473	.	G	A	2	2	4	0	0	4	0	0
23	40873613	.	T	G	0	2	2	0	1	3	0	0
23	40876907	.	G	T	1	3	4	0	0	4	0	0
23	40937532	.	T	C	4	1	5	0	1	6	0	0
23	40972208	.	C	T	5	5	10	0	0	10	0	0
23	41198801	.	C	T	1	3	4	0	1	5	0	0
23	41225159	.	C	A	2	3	5	0	0	5	0	0
23	41225162	.	T	C	2	2	4	0	1	5	0	0
23	41225825	.	C	G	5	0	5	0	4	9	0	0
23	41226359	.	A	C	2	3	5	0	1	6	0	0
23	41227092	.	T	C	1	4	5	0	1	6	0	0
23	41227146	.	C	G	3	0	3	0	5	8	0	0
23	41228858	.	C	A	4	2	6	0	1	7	0	0
23	41228903	.	T	G	4	4	8	0	0	8	0	0
23	41229119	.	C	T	1	4	5	0	1	6	0	0
23	41320957	.	G	A	4	4	8	0	0	8	0	0
23	41739874	.	C	A	1	3	4	0	0	4	0	0
23	41739952	.	G	A	3	4	7	0	0	7	0	0
23	41754587	.	A	G	6	5	11	0	0	11	0	0
23	41799849	.	C	A	9	6	15	0	0	15	0	0
23	41801492	.	C	T	15	7	22	0	3	25	0	0
23	41801555	.	G	A	18	12	30	0	1	31	0	0
23	41801940	.	G	T	13	18	31	0	2	33	0	0
23	41802130	.	T	G	14	11	25	0	1	26	0	0
23	41802827	.	T	C	1	0	1	0	3	4	0	0
23	41802856	.	G	A	2	3	5	0	0	5	0	0
23	41803124	.	G	T	6	8	14	0	1	15	0	0
23	41803160	.	C	T	4	14	18	1	0	19	0	0
23	41803217	.	T	C	4	0	4	0	11	15	0	0
23	41803447	.	G	A	5	7	12	0	0	12	0	0
23	41803473	.	A	G	8	5	13	0	0	13	0	0
23	41803643	.	G	C	4	9	13	0	1	14	0	0
23	41803672	.	C	T	4	5	9	0	0	9	0	0
23	41803740	.	A	G	10	6	16	0	1	17	0	0
23	41804039	.	A	G	4	5	9	0	0	9	0	0
23	41804070	.	C	T	0	2	2	0	1	3	0	0
23	41804202	.	T	A	4	4	8	0	0	8	0	0
23	41804287	.	C	A	1	5	6	0	0	6	0	0
23	41804326	.	C	A	1	2	3	0	0	3	0	0
23	41804340	.	A	T	1	2	3	0	0	3	0	0
23	41804600	.	T	A	6	9	15	0	0	15	0	0
23	41804776	.	G	C	2	4	6	0	0	6	0	0
23	41804779	.	A	T	1	4	5	0	1	6	0	0
23	41804934	.	A	C	2	0	2	0	7	9	0	0
23	41805158	.	C	T	8	4	12	0	1	13	0	0
23	41805348	.	G	A	8	9	17	0	0	17	0	0
23	41808038	.	G	A	2	9	11	0	0	11	0	0
23	41821117	.	G	C	3	4	7	0	1	8	0	0
23	41831305	.	T	A	16	8	24	0	1	25	0	0
23	41831306	.	C	T	13	9	22	0	2	24	0	0
23	41839373	.	G	A	0	11	11	0	14	25	0	0
23	41853782	.	T	C	10	8	18	0	2	20	0	0
23	41853876	.	T	C	11	6	17	0	0	17	0	0
23	41853892	.	A	T	7	6	13	0	1	14	0	0
23	41853989	.	T	C	17	3	20	0	0	20	0	0
23	41853994	.	G	T	18	3	21	0	0	21	0	0
23	41854025	.	C	A	15	7	22	0	1	23	0	0
23	41854030	.	C	A	13	8	21	0	0	21	0	0
23	41854068	.	G	T	12	11	23	0	2	25	0	0
23	41949602	.	T	G	2	2	4	0	0	4	0	0
23	41949703	.	G	A	3	2	5	0	1	6	0	0
23	41949748	.	T	G	4	4	8	0	0	8	0	0
23	41949751	.	A	G	5	4	9	0	0	9	0	0
23	41964709	.	G	A	5	4	9	0	0	9	0	0
23	42000700	.	C	T	1	2	3	0	1	4	0	0
23	42641681	.	A	G	3	0	3	0	3	6	0	0
23	42641787	.	A	G	4	6	10	0	0	10	0	0
23	42642211	.	A	C	5	2	7	0	11	18	0	0
23	42642215	.	A	C	4	1	5	0	12	17	0	0
23	42856791	.	C	G	5	0	5	1	5	11	0	0
23	43508198	.	A	G	1	0	1	0	3	4	0	0
23	43508261	.	G	A	0	2	2	0	1	3	0	0
23	43508528	.	A	G	4	0	4	0	3	7	0	0
23	43513159	.	T	G	5	0	5	0	8	13	0	0
23	43517458	.	A	G	2	6	8	0	0	8	0	0
23	43519354	.	C	G	1	2	3	0	0	3	0	0
23	43519414	.	G	A	3	4	7	0	0	7	0	0
23	43519699	.	C	G	2	2	4	0	0	4	0	0
23	43530699	.	A	G	1	2	3	0	0	3	0	0
23	43530703	.	T	C	1	3	4	0	0	4	0	0
23	43536268	.	T	C	1	0	1	0	4	5	0	0
23	43539296	.	G	T	3	5	8	0	0	8	0	0
23	43543158	.	A	G	5	2	7	0	0	7	0	0
23	43543197	.	A	G	4	3	7	0	0	7	0	0
23	43543860	.	G	T	4	2	6	0	2	8	0	0
23	43544974	.	A	G	2	2	4	0	0	4	0	0
23	43649431	.	T	C	4	3	7	0	0	7	0	0
23	43652306	.	G	C	8	6	14	0	0	14	0	0
23	43652590	.	T	C	4	3	7	0	0	7	0	0
23	43652831	.	G	C	4	3	7	0	1	8	0	0
23	43652901	.	C	G	2	5	7	0	0	7	0	0
23	43688291	.	T	C	4	7	11	0	0	11	0	0
23	43688361	.	A	T	1	7	8	0	1	9	0	0
23	43688364	.	A	T	1	6	7	0	2	9	0	0
23	43688409	.	A	T	2	6	8	0	0	8	0	0
23	43688805	.	C	T	3	5	8	0	0	8	0	0
23	43688810	.	T	C	3	5	8	0	0	8	0	0
23	43688852	.	C	G	6	6	12	0	0	12	0	0
23	43688959	.	C	G	4	6	10	0	0	10	0	0
23	43689174	.	T	C	5	2	7	0	3	10	0	0
23	43689621	.	C	G	4	1	5	0	2	7	0	0
23	43689675	.	T	C	2	2	4	0	1	5	0	0
23	43689729	.	G	A	2	5	7	0	0	7	0	0
23	43690144	.	T	C	4	6	10	0	0	10	0	0
23	43690394	.	A	G	1	3	4	0	0	4	0	0
23	43690490	.	A	G	5	5	10	0	1	11	0	0
23	43690622	.	G	C	3	9	12	0	0	12	0	0
23	43690625	.	T	G	3	10	13	0	0	13	0	0
23	43690715	.	T	C	5	4	9	0	0	9	0	0
23	43690762	.	C	A	3	3	6	0	1	7	0	0
23	43690808	.	A	T	3	2	5	0	0	5	0	0
23	43690838	.	A	G	3	3	6	0	0	6	0	0
23	43690913	.	T	G	3	3	6	0	0	6	0	0
23	43691515	.	C	T	2	8	10	0	0	10	0	0
23	43691528	.	C	T	3	6	9	0	0	9	0	0
23	43691636	.	G	T	2	4	6	0	0	6	0	0
23	43691716	.	A	T	2	5	7	0	0	7	0	0
23	43691770	.	T	C	1	4	5	0	0	5	0	0
23	43691810	.	A	T	3	2	5	0	0	5	0	0
23	43695927	.	C	A	1	5	6	1	7	14	0	0
23	43695956	.	C	T	0	7	7	1	9	17	0	0
23	43696355	.	G	A	18	18	36	0	2	38	0	0
23	43699846	.	A	G	23	24	47	0	1	48	0	0
23	43700064	.	T	C	11	0	11	0	21	32	0	0
23	43700082	.	C	G	10	15	25	0	0	25	0	0
23	43700114	.	G	A	10	16	26	0	0	26	0	0
23	43700121	.	G	A	10	15	25	0	2	27	0	0
23	43705961	.	G	T	19	26	45	0	1	46	0	0
23	43706003	.	A	G	13	25	38	0	1	39	0	0
23	43706102	.	T	G	18	18	36	0	1	37	0	0
23	43707165	.	C	T	15	11	26	0	0	26	0	0
23	43718042	.	C	A	6	6	12	0	1	13	0	0
23	43718947	.	A	G	8	4	12	0	0	12	0	0
23	43723615	.	G	A	11	9	20	0	3	23	0	0
23	43770583	.	C	A	8	13	21	0	1	22	0	0
23	43770667	.	A	G	5	0	5	0	13	18	0	0
23	43770682	.	T	C	10	9	19	0	0	19	0	0
23	43770715	.	C	T	11	6	17	0	0	17	0	0
23	43770832	.	T	C	13	9	22	0	0	22	0	0
23	43778396	.	T	G	10	10	20	0	1	21	0	0
23	43780214	.	C	T	7	9	16	0	0	16	0	0
23	43781781	.	C	T	6	13	19	0	0	19	0	0
23	43784587	.	T	C	9	4	13	1	4	18	0	0
23	43784985	.	C	T	8	9	17	0	1	18	0	0
23	43799463	.	T	C	4	2	6	0	0	6	0	0
23	43799542	.	G	C	1	3	4	0	1	5	0	0
23	43799598	.	G	C	0	5	5	0	2	7	0	0
23	43799798	.	A	C	4	3	7	0	0	7	0	0
23	43800270	.	T	A	3	3	6	0	0	6	0	0
23	43800280	.	A	T	3	3	6	0	0	6	0	0
23	43800684	.	G	A	1	7	8	0	4	12	0	0
23	43800701	.	T	C	4	7	11	0	0	11	0	0
23	43800723	.	G	A	1	8	9	0	2	11	0	0
23	43800747	.	A	C	1	5	6	0	0	6	0	0
23	43801018	.	A	G	3	0	3	0	3	6	0	0
23	43801284	.	C	G	3	3	6	0	0	6	0	0
23	43802158	.	A	T	3	3	6	0	1	7	0	0
23	43802301	.	A	C	2	2	4	0	0	4	0	0
23	43830137	.	T	A	1	4	5	0	0	5	0	0
23	43830185	.	T	C	4	4	8	0	1	9	0	0
23	43830324	.	A	G	2	2	4	0	1	5	0	0
23	43876103	.	C	A	4	6	10	0	0	10	0	0
23	43876109	.	T	A	3	6	9	0	1	10	0	0
23	43889641	.	T	C	4	4	8	0	0	8	0	0
23	43898097	.	A	C	8	3	11	0	0	11	0	0
23	43928824	.	A	G	6	2	8	0	0	8	0	0
23	43928880	.	T	G	1	5	6	1	0	7	0	0
23	43971368	.	G	A	3	2	5	0	0	5	0	0
23	43986740	.	C	T	1	2	3	0	0	3	0	0
23	44090326	.	T	A	15	11	26	0	0	26	0	0
23	44092839	.	T	A	20	23	43	0	4	47	0	0
23	44096060	.	A	G	12	0	12	0	12	24	0	0
23	44098511	.	A	G	25	11	36	0	0	36	0	0
23	44098517	.	C	T	21	9	30	0	1	31	0	0
23	44102199	.	G	T	22	15	37	0	2	39	0	0
23	44106540	.	C	T	19	27	46	0	0	46	0	0
23	44106591	.	G	C	28	22	50	0	3	53	0	0
23	44106860	.	G	A	5	2	7	1	13	21	0	0
23	44107138	.	C	T	8	12	20	0	2	22	0	0
23	44136886	.	A	C	1	2	3	0	0	3	0	0
23	44180513	.	C	A	1	3	4	0	0	4	0	0
23	44236361	.	G	T	9	8	17	0	0	17	0	0
23	44236388	.	A	T	7	3	10	0	1	11	0	0
23	44236561	.	G	A	4	5	9	0	0	9	0	0
23	44236673	.	C	T	6	11	17	0	3	20	0	0
23	44236750	.	T	A	6	4	10	0	0	10	0	0
23	44236939	.	G	A	0	5	5	0	6	11	0	0
23	44236946	.	C	T	6	4	10	0	0	10	0	0
23	44237029	.	T	C	8	3	11	0	0	11	0	0
23	44237030	.	A	G	6	0	6	0	5	11	0	0
23	44237065	.	A	C	2	5	7	0	0	7	0	0
23	44237068	.	A	G	1	6	7	0	0	7	0	0
23	44237158	.	A	C	11	7	18	0	0	18	0	0
23	44237416	.	T	C	7	6	13	0	0	13	0	0
23	44237531	.	G	T	12	7	19	0	2	21	0	0
23	44237611	.	G	C	2	20	22	0	17	40	1	0
23	44237701	.	C	A	13	17	30	0	2	32	0	0
23	44238125	.	G	T	9	7	16	0	2	18	0	0
23	44238186	.	C	T	7	3	10	0	0	10	0	0
23	44242535	.	A	C	11	13	24	0	1	25	0	0
23	44242608	.	T	C	10	13	23	0	0	23	0	0
23	44250638	.	A	G	7	1	8	0	9	17	0	0
23	44250702	.	C	A	7	3	10	0	0	10	0	0
23	44250736	.	C	T	7	5	12	0	0	12	0	0
23	44308088	.	G	A	10	11	21	0	2	23	0	0
23	44312611	.	G	A	1	12	13	0	8	21	0	0
23	44313190	.	G	C	15	13	28	0	1	29	0	0
23	44328488	.	G	A	18	21	39	1	1	41	0	0
23	44328557	.	C	T	20	21	41	0	0	41	0	0
23	44332614	.	C	T	17	17	34	0	2	36	0	0
23	44332617	.	C	T	20	16	36	0	2	38	0	0
23	44332675	.	C	T	20	13	33	1	1	35	0	0
23	44396964	.	A	G	1	0	1	0	3	4	0	0
23	44397619	.	C	G	2	3	5	0	0	5	0	0
23	44428067	.	A	C	13	16	29	0	2	31	0	0
23	44430544	.	C	T	16	17	33	0	0	33	0	0
23	44432608	.	C	T	21	14	35	0	2	37	0	0
23	44440421	.	G	A	4	6	10	0	1	11	0	0
23	44440489	.	C	T	5	8	13	0	3	16	0	0
23	44478131	.	A	G	11	13	24	0	0	24	0	0
23	44487465	.	C	G	11	10	21	0	3	24	0	0
23	44487521	.	A	G	13	6	19	0	0	19	0	0
23	44489428	.	A	C	3	1	4	0	10	14	0	0
23	44500533	.	C	A	2	4	6	0	1	7	0	0
23	44515717	.	C	T	1	3	4	0	0	4	0	0
23	44515822	.	C	T	2	2	4	0	0	4	0	0
23	44517725	.	A	G	3	1	4	0	0	4	0	0
23	44517792	.	C	A	3	3	6	0	0	6	0	0
23	44518479	.	G	A	2	3	5	0	1	6	0	0
23	44518550	.	G	A	3	2	5	0	0	5	0	0
23	44518668	.	A	T	3	4	7	0	0	7	0	0
23	44518812	.	C	T	3	1	4	0	0	4	0	0
23	44518833	.	C	A	2	3	5	0	0	5	0	0
23	44519149	.	A	T	7	3	10	0	0	10	0	0
23	44519381	.	T	G	2	0	2	0	5	7	0	0
23	44521330	.	A	G	9	11	20	0	0	20	0	0
23	44521495	.	G	A	7	8	15	0	0	15	0	0
23	44521516	.	A	C	7	8	15	0	1	16	0	0
23	44550446	.	G	A	12	9	21	0	0	21	0	0
23	44603710	.	T	C	23	31	54	0	3	57	0	0
23	44603912	.	G	A	15	15	30	0	0	30	0	0
23	44603990	.	C	G	10	10	20	0	3	23	0	0
23	44617600	.	T	C	6	4	10	0	0	10	0	0
23	44620750	.	C	T	4	14	18	0	0	18	0	0
23	44620911	.	C	T	10	6	16	0	0	16	0	0
23	44621684	.	C	A	17	10	27	0	0	27	0	0
23	44621690	.	C	A	16	11	27	0	0	27	0	0
23	44622736	.	T	C	14	16	30	0	2	32	0	0
23	44641343	.	A	G	1	2	3	0	0	3	0	0
23	44652877	.	A	G	3	3	6	0	0	6	0	0
23	44653259	.	A	T	7	4	11	0	0	11	0	0
23	44653489	.	G	A	0	8	8	0	5	13	0	0
23	44653490	.	C	T	2	11	13	0	0	13	0	0
23	44653647	.	A	G	1	0	1	0	8	9	0	0
23	44732976	.	G	A	25	28	53	0	8	61	0	0
23	44755296	.	T	C	32	35	67	0	5	72	0	0
23	44761680	.	G	C	20	20	40	0	5	45	0	0
23	44762190	.	T	C	30	34	64	0	2	66	0	0
23	44850211	.	A	T	1	4	5	0	1	6	0	0
23	44854679	.	G	A	3	3	6	0	0	6	0	0
23	44857894	.	G	A	1	3	4	0	0	4	0	0
23	44858352	.	T	G	1	3	4	0	0	4	0	0
23	44858903	.	G	A	2	4	6	0	0	6	0	0
23	44861891	.	T	A	2	5	7	0	0	7	0	0
23	44861899	.	A	G	2	6	8	0	0	8	0	0
23	44863907	.	C	T	0	3	3	0	2	5	0	0
23	44871969	.	G	A	1	2	3	0	0	3	0	0
23	44973321	.	G	T	1	2	3	0	0	3	0	0
23	44975073	.	G	A	8	4	12	0	0	12	0	0
23	44975079	.	G	T	9	5	14	0	0	14	0	0
23	44979814	.	G	A	3	3	6	0	0	6	0	0
23	44979861	.	C	T	5	3	8	0	0	8	0	0
23	44979987	.	C	T	5	3	8	0	0	8	0	0
23	44980002	.	G	T	4	2	6	0	0	6	0	0
23	44995892	.	C	G	2	3	5	0	0	5	0	0
23	44999663	.	A	C	5	2	7	0	1	8	0	0
23	45012640	.	C	G	2	4	6	0	0	6	0	0
23	45017166	.	T	A	2	2	4	0	0	4	0	0
23	45018630	.	G	A	3	5	8	0	0	8	0	0
23	45018662	.	G	A	1	5	6	0	0	6	0	0
23	45025952	.	A	G	17	13	30	3	0	33	0	0
23	45027911	.	C	T	27	19	46	0	2	48	0	0
23	45028191	.	T	C	32	22	54	0	1	55	0	0
23	45028248	.	C	T	29	24	53	0	3	56	0	0
23	45043654	.	G	A	5	2	7	0	0	7	0	0
23	45175603	.	T	A	1	1	2	2	1	5	0	0
24	20671	.	T	C	3	2	5	0	0	5	0	0
24	24470	.	T	C	4	7	11	0	0	11	0	0
24	24473	.	C	T	4	7	11	0	0	11	0	0
24	26103	.	C	T	8	10	18	0	0	18	0	0
24	44306	.	C	T	18	11	29	0	3	32	0	0
24	83308	.	C	T	3	3	6	0	0	6	0	0
24	83933	.	A	G	4	0	4	0	3	7	0	0
24	86722	.	G	C	1	3	4	0	0	4	0	0
24	86768	.	T	C	4	3	7	0	0	7	0	0
24	91430	.	A	G	3	0	3	0	4	7	0	0
24	139014	.	A	G	1	0	1	0	2	3	0	0
24	145739	.	C	T	3	2	5	0	0	5	0	0
24	166969	.	T	G	10	7	17	0	1	18	0	0
24	167149	.	A	T	13	18	31	0	0	31	0	0
24	167177	.	A	G	11	23	34	0	0	34	0	0
24	174353	.	A	G	13	0	13	0	13	26	0	0
24	178693	.	G	A	10	13	23	0	1	24	0	0
24	184800	.	A	G	19	0	19	0	24	43	0	0
24	184818	.	C	T	26	16	42	0	1	43	0	0
24	187371	.	T	A	14	17	31	0	0	31	0	0
24	187414	.	T	A	11	13	24	0	2	26	0	0
24	187497	.	G	T	9	5	14	0	1	15	0	0
24	187516	.	T	C	9	5	14	0	1	15	0	0
24	187686	.	T	A	11	6	17	0	3	20	0	0
24	187787	.	C	T	9	19	28	0	1	29	0	0
24	187811	.	A	T	9	14	23	0	0	23	0	0
24	188013	.	A	G	3	2	5	0	1	6	0	0
24	188015	.	A	G	0	4	4	0	1	5	0	0
24	188071	.	A	G	8	3	11	0	0	11	0	0
24	188155	.	C	G	10	5	15	0	0	15	0	0
24	188191	.	T	A	10	8	18	0	1	19	0	0
24	188363	.	G	A	15	13	28	0	3	31	0	0
24	188382	.	G	A	4	18	22	0	12	34	0	0
24	188423	.	T	C	16	18	34	0	0	34	0	0
24	188425	.	A	T	15	18	33	0	1	34	0	0
24	188464	.	T	C	12	24	36	0	2	38	0	0
24	196679	.	G	A	4	17	21	0	0	21	0	0
24	197062	.	C	T	14	6	20	0	1	21	0	0
24	197072	.	C	T	0	5	5	0	15	20	0	0
24	786646	.	A	G	2	4	6	0	0	6	0	0
24	786737	.	A	G	1	2	3	0	0	3	0	0
24	923829	.	G	A	0	3	3	0	1	4	0	0
24	941222	.	C	T	1	3	4	0	0	4	0	0
24	945706	.	T	C	14	12	26	0	0	26	0	0
24	947503	.	G	C	7	3	10	0	0	10	0	0
24	947518	.	C	T	2	3	5	1	4	10	0	0
24	947611	.	C	T	3	10	13	0	6	19	0	0
24	947680	.	T	C	9	7	16	0	12	28	0	0
24	947957	.	C	A	9	9	18	0	4	22	0	0
24	947984	.	G	C	9	9	18	0	3	21	0	0
24	948080	.	A	G	9	3	12	0	0	12	0	0
24	948201	.	T	A	11	3	14	0	0	14	0	0
24	948225	.	T	G	14	2	16	0	0	16	0	0
24	948360	.	A	G	4	7	11	0	3	14	0	0
24	948438	.	T	C	12	3	15	0	7	22	0	0
24	948466	.	C	G	4	6	10	0	9	19	0	0
24	948503	.	C	T	6	10	16	0	5	21	0	0
24	948565	.	T	C	10	6	16	0	14	30	0	0
24	948571	.	G	A	11	13	24	0	0	24	0	0
24	948806	.	G	A	12	10	22	0	0	22	0	0
24	948848	.	C	T	1	1	2	0	8	10	0	0
24	948868	.	T	C	7	4	11	0	0	11	0	0
24	977655	.	G	A	2	5	7	0	0	7	0	0
24	985094	.	A	T	9	6	15	0	2	17	0	0
24	985266	.	G	T	16	6	22	1	2	25	0	0
24	985740	.	C	G	9	8	17	0	1	18	0	0
24	988373	.	A	C	4	0	4	0	8	12	0	0
24	994885	.	T	C	3	0	3	1	14	18	0	0
24	1000112	.	G	A	8	10	18	0	1	19	0	0
24	1002664	.	T	C	4	13	17	0	0	17	0	0
24	1002757	.	T	C	8	10	18	0	0	18	0	0
24	1003494	.	C	T	1	12	13	0	8	21	0	0
24	1003551	.	C	A	1	9	10	0	5	15	0	0
24	1009078	.	A	G	5	12	17	0	0	17	0	0
24	1009381	.	C	A	0	4	4	0	5	9	0	0
24	1009978	.	A	C	10	0	10	0	6	16	0	0
24	1011355	.	A	T	1	3	4	0	0	4	0	0
24	1011372	.	G	A	2	4	6	0	0	6	0	0
24	1011897	.	T	A	2	2	4	0	0	4	0	0
24	1013057	.	A	T	5	2	7	0	0	7	0	0
24	1013059	.	A	T	5	2	7	0	0	7	0	0
24	1013105	.	T	G	4	3	7	0	0	7	0	0
24	1013106	.	G	T	4	3	7	0	0	7	0	0
24	1013290	.	G	C	5	4	9	0	0	9	0	0
24	1013303	.	G	A	5	4	9	0	0	9	0	0
24	1013359	.	G	C	3	4	7	0	1	8	0	0
24	1013375	.	A	T	3	5	8	0	0	8	0	0
24	1014681	.	T	A	2	3	5	0	0	5	0	0
24	1014745	.	A	T	1	3	4	0	2	6	0	0
24	1015292	.	T	C	13	1	14	0	14	28	0	0
24	1018672	.	T	C	22	1	23	0	22	45	0	0
24	1021216	.	T	G	11	11	22	1	1	24	0	0
24	1021222	.	A	G	10	7	17	1	1	19	0	0
24	1110150	.	T	C	7	7	14	0	0	14	0	0
24	1110152	.	T	A	8	7	15	0	0	15	0	0
24	1110227	.	G	A	7	5	12	0	0	12	0	0
24	1110325	.	C	A	8	7	15	0	1	16	0	0
24	1110595	.	G	C	5	4	9	0	0	9	0	0
24	1110601	.	G	A	6	4	10	0	0	10	0	0
24	1111076	.	G	A	2	3	5	0	0	5	0	0
24	1111102	.	G	T	4	5	9	0	0	9	0	0
24	1111146	.	T	C	11	2	13	0	0	13	0	0
24	1111453	.	T	A	5	5	10	0	0	10	0	0
24	1111469	.	C	T	0	6	6	0	6	12	0	0
24	1111571	.	T	A	3	6	9	0	0	9	0	0
24	1111572	.	G	T	3	6	9	0	0	9	0	0
24	1111628	.	A	C	5	3	8	0	0	8	0	0
24	1111712	.	A	G	4	3	7	0	1	8	0	0
24	1111717	.	T	C	5	3	8	0	0	8	0	0
24	1111791	.	A	C	4	3	7	0	0	7	0	0
24	1111818	.	G	A	4	2	6	0	0	6	0	0
24	1111857	.	C	T	3	2	5	0	0	5	0	0
24	1111905	.	C	A	3	3	6	0	1	7	0	0
24	1111910	.	T	C	4	3	7	0	0	7	0	0
24	1112337	.	A	G	3	2	5	0	1	6	0	0
24	1112365	.	T	C	4	0	4	0	3	7	0	0
24	1112547	.	C	G	0	3	3	0	6	9	0	0
24	1112678	.	A	C	1	2	3	0	0	3	0	0
24	1112950	.	G	T	1	4	5	0	0	5	0	0
24	1112972	.	T	G	1	4	5	0	0	5	0	0
24	1119052	.	G	A	2	4	6	0	0	6	0	0
24	1126902	.	T	A	1	2	3	0	0	3	0	0
24	1128057	.	A	G	3	2	5	0	1	6	0	0
24	1128762	.	G	A	1	2	3	0	0	3	0	0
24	1128831	.	G	A	1	2	3	0	0	3	0	0
24	1131751	.	T	C	2	0	2	0	2	4	0	0
24	1163061	.	G	A	20	13	33	0	0	33	0	0
24	1165052	.	A	G	16	19	35	0	0	35	0	0
24	1166957	.	G	A	11	16	27	0	0	27	0	0
24	1166975	.	T	C	13	14	27	0	0	27	0	0
24	1167496	.	G	A	15	17	32	1	2	35	0	0
24	1167506	.	G	A	17	20	37	1	0	38	0	0
24	1169291	.	C	T	3	16	19	1	21	41	0	0
24	1177074	.	T	A	15	19	34	1	1	36	0	0
24	1185142	.	G	A	10	11	21	0	0	21	0	0
24	1185271	.	G	A	16	7	23	0	0	23	0	0
24	1203471	.	A	T	11	9	20	0	2	22	0	0
24	1203573	.	A	G	14	10	24	1	2	27	0	0
24	1221280	.	C	T	1	12	13	0	14	27	0	0
24	1229646	.	G	C	12	0	12	0	16	28	0	0
24	1229683	.	G	C	16	11	27	0	2	29	0	0
24	1236358	.	A	G	21	8	29	0	0	29	0	0
24	1301258	.	C	T	14	10	24	0	0	24	0	0
24	1303892	.	A	G	9	9	18	0	1	19	0	0
24	2284456	.	A	T	13	14	27	0	3	30	0	0
24	2284526	.	T	C	14	0	14	0	16	30	0	0
24	2284647	.	C	T	0	20	20	0	10	30	0	0
24	2290232	.	T	C	11	0	11	0	5	16	0	0
24	2297093	.	T	A	11	10	21	0	0	21	0	0
24	2297117	.	A	G	12	10	22	0	0	22	0	0
24	2303715	.	T	G	6	8	14	1	0	15	0	0
24	2303784	.	C	T	11	8	19	0	2	21	0	0
24	2307342	.	C	T	9	11	20	0	1	21	0	0
24	2308075	.	A	G	5	5	10	0	0	10	0	0
24	2308122	.	T	G	7	5	12	0	0	12	0	0
24	2319969	.	A	G	2	3	5	0	0	5	0	0
24	2322219	.	C	T	3	5	8	0	0	8	0	0
24	2322273	.	T	C	1	4	5	0	0	5	0	0
24	2322351	.	T	C	3	3	6	0	0	6	0	0
24	2324534	.	T	C	5	2	7	0	0	7	0	0
24	2327295	.	T	C	1	2	3	0	0	3	0	0
24	2327815	.	G	A	0	4	4	0	3	7	0	0
24	2327832	.	C	T	3	5	8	0	0	8	0	0
24	2327866	.	C	G	4	2	6	0	0	6	0	0
24	2327935	.	T	C	4	2	6	0	0	6	0	0
24	2330491	.	T	C	4	2	6	0	0	6	0	0
24	2331156	.	A	G	1	0	1	0	4	5	0	0
24	2331198	.	G	A	3	3	6	0	0	6	0	0
24	2333811	.	C	T	2	3	5	0	0	5	0	0
24	2334066	.	G	A	4	2	6	0	0	6	0	0
24	2334069	.	C	G	5	2	7	0	1	8	0	0
24	2340671	.	A	T	4	2	6	0	0	6	0	0
24	2346976	.	A	G	4	2	6	0	0	6	0	0
24	2346989	.	G	T	4	3	7	0	0	7	0	0
24	3470169	.	T	C	9	6	15	0	4	19	0	0
24	3470405	.	T	C	7	3	10	0	0	10	0	0
24	3470608	.	T	C	4	3	7	0	0	7	0	0
24	3471342	.	T	C	7	5	12	0	0	12	0	0
24	5653468	.	C	T	4	2	6	0	1	7	0	0
24	6011063	.	G	T	3	2	5	0	0	5	0	0
24	6011741	.	A	G	6	2	8	0	0	8	0	0
24	7522530	.	G	A	1	3	4	0	1	5	0	0
24	8861412	.	C	T	4	3	7	0	0	7	0	0
24	8861521	.	G	C	4	2	6	0	0	6	0	0
24	8861555	.	T	C	4	3	7	0	0	7	0	0
24	8861821	.	A	G	3	3	6	0	0	6	0	0
24	8861853	.	C	G	0	3	3	0	2	5	0	0
24	8861884	.	C	A	2	2	4	0	0	4	0	0
24	8862323	.	A	C	4	3	7	1	0	8	0	0
24	8862342	.	T	C	5	2	7	1	0	8	0	0
24	8862434	.	C	T	0	3	3	1	7	11	0	0
24	8862438	.	C	A	7	3	10	1	0	11	0	0
24	8862744	.	T	C	1	3	4	0	0	4	0	0
24	8862747	.	A	G	2	2	4	0	0	4	0	0
24	8863029	.	G	A	4	3	7	0	0	7	0	0
24	8863082	.	A	G	6	2	8	0	0	8	0	0
24	8865645	.	T	G	2	4	6	0	0	6	0	0
24	8968808	.	G	A	2	5	7	0	7	14	0	0
24	8979615	.	C	G	2	3	5	0	0	5	0	0
24	8979618	.	G	A	2	3	5	0	0	5	0	0
24	8979708	.	C	T	0	4	4	0	8	12	0	0
24	8979917	.	G	A	10	8	18	0	0	18	0	0
24	8979937	.	G	A	7	7	14	0	0	14	0	0
24	8980026	.	T	A	5	2	7	0	0	7	0	0
24	8980027	.	A	T	5	2	7	0	0	7	0	0
24	8980122	.	G	A	1	4	5	0	2	7	0	0
24	8988945	.	G	C	11	1	12	0	10	22	0	0
24	8999699	.	T	A	3	6	9	0	0	9	0	0
24	9162766	.	G	A	4	2	6	0	0	6	0	0
24	9163150	.	T	C	5	4	9	0	0	9	0	0
24	9250241	.	T	C	4	3	7	2	2	11	0	0
24	9250601	.	C	T	5	3	8	0	0	8	0	0
24	9260452	.	A	C	6	4	10	0	0	10	0	0
24	9260530	.	A	G	3	0	3	0	5	8	0	0
24	9267871	.	G	A	0	6	6	0	2	8	0	0
24	9267967	.	A	T	4	2	6	0	1	7	0	0
24	9288889	.	G	T	14	15	29	0	3	32	0	0
24	9293831	.	A	G	13	9	22	0	0	22	0	0
24	9298312	.	G	A	2	3	5	0	0	5	0	0
24	9298592	.	G	A	0	2	2	0	2	4	0	0
24	9299325	.	T	C	1	2	3	0	0	3	0	0
24	9518522	.	T	C	3	3	6	0	0	6	0	0
24	9525632	.	C	T	6	2	8	1	0	9	0	0
24	9543120	.	A	G	1	0	1	0	1	2	0	0
24	9543304	.	A	C	4	3	7	0	0	7	0	0
24	9566928	.	A	G	2	4	6	0	0	6	0	0
24	9572907	.	A	G	5	4	9	0	1	10	0	0
24	9573201	.	T	C	3	2	5	0	0	5	0	0
24	9573220	.	G	A	3	2	5	0	0	5	0	0
24	9594999	.	T	C	6	6	12	0	3	15	0	0
24	9596093	.	A	C	2	3	5	0	0	5	0	0
24	9596241	.	C	T	4	3	7	0	1	8	0	0
24	9596350	.	G	A	4	5	9	0	0	9	0	0
24	9596366	.	T	A	4	2	6	0	2	8	0	0
24	9676147	.	T	A	14	13	27	0	1	28	0	0
24	9676204	.	C	A	14	20	34	0	1	35	0	0
24	9678514	.	A	T	13	18	31	0	3	34	0	0
24	9683072	.	G	A	8	5	13	0	1	14	0	0
24	9689613	.	G	T	6	3	9	0	1	10	0	0
24	9689709	.	G	T	14	5	19	0	0	19	0	0
24	9689758	.	T	C	9	0	9	0	4	13	0	0
24	9706939	.	T	C	2	3	5	0	0	5	0	0
24	9706946	.	C	T	2	3	5	0	0	5	0	0
24	9707007	.	G	C	2	4	6	0	0	6	0	0
24	9708555	.	G	A	1	3	4	0	3	7	0	0
24	9708580	.	C	T	1	3	4	0	0	4	0	0
24	9711494	.	A	G	2	2	4	0	0	4	0	0
24	9714294	.	T	C	4	4	8	0	0	8	0	0
24	9714423	.	T	C	2	2	4	0	0	4	0	0
24	9714585	.	G	A	0	2	2	0	2	4	0	0
24	9717589	.	T	C	2	4	6	0	0	6	0	0
24	9723677	.	G	C	1	4	5	0	0	5	0	0
24	9724925	.	A	G	2	4	6	0	0	6	0	0
24	9725084	.	C	G	3	3	6	0	0	6	0	0
24	9726828	.	C	G	4	2	6	0	1	7	0	0
24	9729966	.	A	T	4	5	9	0	0	9	0	0
24	9730134	.	G	A	2	3	5	0	0	5	0	0
24	9732183	.	A	T	2	2	4	0	0	4	0	0
24	9746370	.	T	A	3	2	5	0	0	5	0	0
24	9865836	.	G	A	1	10	11	0	8	19	0	0
24	9866270	.	G	A	10	4	14	0	0	14	0	0
24	9866721	.	C	T	4	10	14	0	2	16	0	0
24	9867105	.	T	A	13	6	19	0	0	19	0	0
24	10237360	.	C	T	3	3	6	0	0	6	0	0
24	10270447	.	T	C	1	2	3	0	1	4	0	0
24	10303168	.	C	T	5	4	9	0	0	9	0	0
24	10309119	.	G	C	0	3	3	0	11	14	0	0
24	10309244	.	G	A	5	3	8	0	0	8	0	0
24	10309774	.	T	A	3	2	5	0	0	5	0	0
24	10309775	.	A	T	2	2	4	0	1	5	0	0
24	10314437	.	T	A	3	4	7	0	1	8	0	0
24	10319106	.	C	T	1	2	3	0	0	3	0	0
24	10319400	.	T	C	1	4	5	0	1	6	0	0
24	10319567	.	A	G	1	2	3	0	0	3	0	0
24	10319598	.	G	T	2	2	4	0	0	4	0	0
24	10338272	.	C	T	1	3	4	0	1	5	0	0
24	10344333	.	C	G	3	6	9	0	0	9	0	0
24	10349671	.	C	T	1	3	4	0	0	4	0	0
24	10349865	.	T	G	3	6	9	0	1	10	0	0
24	10349898	.	T	C	3	7	10	0	0	10	0	0
24	10350089	.	T	A	2	2	4	0	0	4	0	0
24	10356563	.	G	A	4	4	8	0	0	8	0	0
24	10356592	.	T	C	3	6	9	0	0	9	0	0
24	10356617	.	G	A	2	7	9	0	0	9	0	0
24	10368855	.	G	A	5	4	9	0	0	9	0	0
24	10376840	.	G	A	3	3	6	0	0	6	0	0
24	10376984	.	G	A	1	4	5	0	0	5	0	0
24	10376990	.	T	C	1	3	4	0	0	4	0	0
24	10393951	.	C	G	3	3	6	0	0	6	0	0
24	10393979	.	G	T	4	4	8	0	1	9	0	0
24	10393995	.	A	C	3	3	6	0	1	7	0	0
24	10413706	.	T	C	5	6	11	0	0	11	0	0
24	10414439	.	G	T	1	6	7	0	5	12	0	0
24	10415193	.	A	G	7	9	16	0	0	16	0	0
24	10415424	.	A	C	6	11	17	0	0	17	0	0
24	10415487	.	G	A	2	8	10	0	8	18	0	0
24	10415827	.	T	G	1	4	5	0	1	6	0	0
24	10464188	.	C	A	3	7	10	0	0	10	0	0
24	10464195	.	A	G	3	8	11	0	0	11	0	0
24	10828512	.	A	G	10	14	24	0	2	26	0	0
24	10897254	.	G	A	9	15	24	0	0	24	0	0
24	10897340	.	C	A	5	5	10	0	1	11	0	0
24	10901467	.	A	C	3	6	9	0	0	9	0	0
24	10901696	.	C	G	22	24	46	0	2	48	0	0
24	10901759	.	G	T	24	14	38	1	0	39	0	0
24	10901946	.	C	T	20	6	26	0	2	28	0	0
24	10902065	.	T	G	11	14	25	0	1	26	0	0
24	10902268	.	G	A	6	12	18	0	0	18	0	0
24	10902688	.	G	A	24	17	41	0	2	43	0	0
24	10907000	.	T	C	20	14	34	0	0	34	0	0
24	10907473	.	C	T	20	16	36	0	3	39	0	0
24	10907587	.	G	T	17	16	33	0	3	36	0	0
24	10915813	.	A	G	21	18	39	0	0	39	0	0
24	10917040	.	C	T	17	19	36	0	2	38	0	0
24	10917046	.	C	T	1	17	18	0	19	37	0	0
24	10917238	.	C	T	9	15	24	0	0	24	0	0
24	10919519	.	A	G	7	11	18	0	0	18	0	0
24	10919563	.	G	T	5	8	13	0	0	13	0	0
24	10924880	.	C	T	17	10	27	0	0	27	0	0
24	10924912	.	C	T	13	11	24	0	0	24	0	0
24	10924930	.	T	A	6	10	16	0	0	16	0	0
24	10944579	.	T	A	15	9	24	0	2	26	0	0
24	10961510	.	T	C	12	7	19	0	0	19	0	0
24	10971127	.	C	T	4	5	9	0	1	10	0	0
24	10971160	.	G	A	4	6	10	0	2	12	0	0
24	11049421	.	G	A	3	9	12	0	1	13	0	0
24	11049627	.	T	G	3	6	9	0	2	11	0	0
24	11049670	.	C	T	2	7	9	0	0	9	0	0
24	11049678	.	C	T	4	6	10	0	0	10	0	0
24	11049902	.	G	C	3	4	7	0	0	7	0	0
24	11059944	.	T	A	1	4	5	0	0	5	0	0
24	11083475	.	G	A	5	5	10	0	0	10	0	0
24	11083860	.	C	T	6	6	12	0	0	12	0	0
24	11084035	.	G	A	5	3	8	0	0	8	0	0
24	11086437	.	G	T	2	3	5	0	0	5	0	0
24	11086465	.	T	A	4	2	6	0	0	6	0	0
24	11113110	.	C	T	14	7	21	0	1	22	0	0
24	11113493	.	T	C	5	0	5	0	4	9	0	0
24	11114040	.	A	C	4	6	10	0	1	11	0	0
24	11114048	.	C	A	4	6	10	0	0	10	0	0
24	11114094	.	T	C	2	5	7	0	0	7	0	0
24	11114236	.	A	T	11	7	18	0	0	18	0	0
24	11114288	.	T	C	9	6	15	0	0	15	0	0
24	11114290	.	A	G	8	6	14	0	0	14	0	0
24	11114356	.	C	T	4	2	6	0	1	7	0	0
24	11114385	.	T	C	6	3	9	0	0	9	0	0
24	11114393	.	C	A	4	2	6	0	2	8	0	0
24	11114560	.	T	C	6	0	6	0	8	14	0	0
24	11114583	.	A	T	7	7	14	0	5	19	0	0
24	11114670	.	C	T	1	5	6	0	8	14	0	0
24	11114688	.	T	G	6	7	13	0	0	13	0	0
24	11114709	.	T	A	8	9	17	0	1	18	0	0
24	11114953	.	A	T	1	5	6	0	0	6	0	0
24	11115114	.	G	A	3	6	9	1	0	10	0	0
24	11115269	.	C	A	9	5	14	0	1	15	0	0
24	11115280	.	C	G	7	11	18	0	0	18	0	0
24	11115338	.	A	T	9	5	14	0	1	15	0	0
24	11115339	.	C	T	2	5	7	0	8	15	0	0
24	11115719	.	T	A	3	3	6	0	0	6	0	0
24	11115720	.	A	G	2	3	5	0	1	6	0	0
24	11115806	.	A	G	6	7	13	0	0	13	0	0
24	11115894	.	A	G	6	2	8	0	0	8	0	0
24	11116025	.	G	C	8	0	8	0	5	13	0	0
24	11116032	.	C	T	5	6	11	0	1	12	0	0
24	11124199	.	C	T	5	2	7	0	1	8	0	0
24	11127483	.	G	A	6	5	11	0	0	11	0	0
24	11141253	.	A	C	10	7	17	0	1	18	0	0
24	11141654	.	A	G	5	7	12	0	1	13	0	0
24	11141757	.	T	C	9	13	22	0	0	22	0	0
24	11141849	.	G	A	12	10	22	0	0	22	0	0
24	11145148	.	C	T	7	7	14	0	1	15	0	0
24	11145232	.	G	A	5	9	14	0	0	14	0	0
24	11145445	.	G	A	6	9	15	0	0	15	0	0
24	11145460	.	A	G	8	7	15	0	0	15	0	0
24	11150790	.	G	A	5	7	12	0	0	12	0	0
24	11150791	.	A	T	6	7	13	0	0	13	0	0
24	11156140	.	T	C	4	5	9	0	1	10	0	0
24	11346038	.	C	A	1	2	3	0	0	3	0	0
24	11346046	.	C	T	1	2	3	0	0	3	0	0
24	11346616	.	C	G	1	3	4	0	0	4	0	0
24	11350825	.	A	G	4	2	6	0	0	6	0	0
24	11388406	.	T	A	2	3	5	0	0	5	0	0
24	11388508	.	C	T	2	4	6	0	0	6	0	0
24	11388615	.	C	T	3	2	5	0	0	5	0	0
24	11388628	.	A	C	2	3	5	0	0	5	0	0
24	11388678	.	A	T	4	4	8	0	0	8	0	0
24	11388701	.	T	C	4	3	7	0	0	7	0	0
24	11389554	.	A	G	0	6	6	0	0	6	0	0
24	11389572	.	A	G	1	5	6	0	0	6	0	0
24	11389596	.	A	G	1	0	1	0	4	5	0	0
24	11452849	.	T	A	1	3	4	0	0	4	0	0
24	11467289	.	G	C	1	2	3	0	0	3	0	0
24	11473788	.	T	A	2	6	8	0	0	8	0	0
24	11473857	.	C	A	3	2	5	0	0	5	0	0
24	11473891	.	G	A	4	3	7	0	0	7	0	0
24	11474103	.	C	G	10	9	19	0	1	20	0	0
24	11474110	.	G	A	8	9	17	0	1	18	0	0
24	11474167	.	T	C	9	9	18	0	2	20	0	0
24	11474730	.	A	G	7	8	15	0	0	15	0	0
24	11483833	.	C	T	7	7	14	0	2	16	0	0
24	11487067	.	G	C	9	8	17	0	0	17	0	0
24	11490280	.	A	C	5	3	8	0	0	8	0	0
24	11496640	.	T	A	5	3	8	0	0	8	0	0
24	11497201	.	T	A	9	5	14	0	2	16	0	0
24	11528490	.	A	G	3	3	6	0	0	6	0	0
24	11528804	.	A	G	1	2	3	0	2	5	0	0
24	11530083	.	T	C	1	2	3	0	0	3	0	0
24	11530137	.	G	T	1	2	3	0	0	3	0	0
24	11530850	.	G	T	2	2	4	0	0	4	0	0
24	11531088	.	T	A	1	2	3	0	1	4	0	0
24	11531132	.	G	A	3	3	6	0	0	6	0	0
24	11531307	.	A	G	2	2	4	0	0	4	0	0
24	11531639	.	C	A	0	2	2	0	2	4	0	0
24	11532686	.	T	C	4	2	6	0	0	6	0	0
24	11608929	.	G	T	2	3	5	0	0	5	0	0
24	11888694	.	G	A	4	3	7	0	2	9	0	0
24	11888788	.	G	A	14	7	21	0	0	21	0	0
24	11888799	.	T	C	13	7	20	0	2	22	0	0
24	11888854	.	T	C	11	6	17	0	1	18	0	0
24	11889070	.	T	C	13	4	17	0	0	17	0	0
24	11889155	.	T	C	4	0	4	0	4	8	0	0
24	11889579	.	T	C	7	5	12	0	1	13	0	0
24	11889617	.	T	C	4	2	6	0	0	6	0	0
24	11893428	.	G	A	8	3	11	0	0	11	0	0
24	11894968	.	C	T	0	4	4	0	5	9	0	0
24	11896033	.	A	G	2	3	5	0	0	5	0	0
24	11900166	.	G	A	2	2	4	0	0	4	0	0
24	11900230	.	A	C	4	4	8	0	1	9	0	0
24	11905534	.	G	A	4	2	6	0	0	6	0	0
24	11909441	.	T	G	6	4	10	0	0	10	0	0
24	11918846	.	G	A	9	7	16	0	1	17	0	0
24	11919170	.	A	G	2	4	6	0	1	7	0	0
24	12133963	.	C	A	13	9	22	0	1	23	0	0
24	12133998	.	A	C	8	4	12	0	2	14	0	0
24	12252675	.	G	T	11	8	19	1	0	20	0	0
24	12253067	.	G	A	9	6	15	0	0	15	0	0
24	12253154	.	T	G	10	7	17	0	1	18	0	0
24	12630352	.	A	G	10	13	23	0	0	23	0	0
24	12634439	.	C	T	11	7	18	0	0	18	0	0
24	12638007	.	C	T	2	7	9	0	24	33	0	0
24	12686316	.	A	T	13	11	24	0	0	24	0	0
24	12744159	.	T	C	5	2	7	0	0	7	0	0
24	12744603	.	C	T	5	4	9	0	0	9	0	0
24	12744606	.	G	A	4	4	8	0	0	8	0	0
24	12746597	.	A	G	3	4	7	0	1	8	0	0
24	12748468	.	A	G	2	4	6	0	0	6	0	0
24	12749046	.	G	A	8	12	20	0	1	21	0	0
24	12764550	.	A	T	5	4	9	0	0	9	0	0
24	12768339	.	G	A	6	3	9	0	0	9	0	0
24	12799196	.	C	T	1	3	4	0	4	8	0	0
24	12963161	.	T	A	7	3	10	0	0	10	0	0
24	12966730	.	C	T	19	20	39	0	1	40	0	0
24	12966981	.	G	A	7	12	19	0	1	20	0	0
24	12967041	.	C	T	12	11	23	0	0	23	0	0
24	12967214	.	T	C	10	1	11	0	15	26	0	0
24	12970814	.	A	T	9	9	18	0	1	19	0	0
24	12975210	.	A	G	14	8	22	0	3	25	0	0
24	12977735	.	A	T	5	5	10	0	1	11	0	0
24	12983478	.	A	T	7	10	17	0	0	17	0	0
24	12988794	.	C	T	2	2	4	0	0	4	0	0
24	12998907	.	G	A	0	4	4	0	4	8	0	0
24	13009351	.	T	A	5	6	11	0	0	11	0	0
24	13014280	.	C	T	8	4	12	0	0	12	0	0
24	13014423	.	A	T	5	2	7	0	0	7	0	0
24	13015293	.	A	T	4	3	7	0	0	7	0	0
24	13023054	.	C	T	45	14	59	0	2	61	0	0
24	13026060	.	G	A	33	12	45	1	5	51	0	0
24	13026449	.	T	C	29	18	47	0	0	47	0	0
24	13101128	.	A	G	34	29	63	0	2	65	0	0
24	13101143	.	C	A	35	29	64	0	1	65	0	0
24	13101185	.	A	G	39	0	39	0	28	67	0	0
24	13138165	.	T	C	41	24	65	1	3	69	0	0
24	13239124	.	T	A	28	9	37	0	4	42	1	0
24	13239248	.	A	G	20	15	35	0	13	48	0	0
24	13239985	.	G	C	16	21	37	0	1	38	0	0
24	13251801	.	A	C	11	10	21	0	1	22	0	0
24	13252065	.	G	A	9	8	17	0	0	17	0	0
24	13252122	.	A	C	5	1	6	0	9	15	0	0
24	13252448	.	A	G	10	10	20	0	0	20	0	0
24	13255400	.	C	T	12	6	18	1	0	19	0	0
24	13262409	.	G	C	4	0	4	0	7	11	0	0
24	13271566	.	T	C	3	3	6	0	0	6	0	0
24	13271628	.	A	G	3	3	6	0	1	7	0	0
24	13362353	.	G	T	1	2	3	0	1	4	0	0
24	13966477	.	T	C	2	2	4	0	0	4	0	0
24	14015267	.	G	A	0	3	3	0	2	5	0	0
24	14015287	.	T	G	3	3	6	0	0	6	0	0
24	14214952	.	C	T	1	2	3	0	1	4	0	0
24	14218683	.	C	T	3	2	5	0	0	5	0	0
24	14233716	.	C	A	3	3	6	0	0	6	0	0
24	14233798	.	G	C	3	3	6	0	1	7	0	0
24	14233840	.	T	G	2	4	6	0	0	6	0	0
24	14233841	.	G	A	2	4	6	0	0	6	0	0
24	14234355	.	A	G	4	5	9	0	0	9	0	0
24	14234412	.	T	G	1	3	4	0	1	5	0	0
24	14385405	.	G	A	0	7	7	0	6	13	0	0
24	14385520	.	A	G	8	4	12	0	0	12	0	0
24	14385526	.	C	A	8	3	11	0	1	12	0	0
24	14385630	.	C	G	7	15	22	0	0	22	0	0
24	14385882	.	T	G	10	0	10	0	12	22	0	0
24	14385969	.	C	T	6	7	13	0	0	13	0	0
24	14385999	.	T	C	10	8	18	0	0	18	0	0
24	14386024	.	C	T	9	7	16	0	2	18	0	0
24	14386050	.	C	T	8	5	13	0	0	13	0	0
24	14415965	.	G	A	9	12	21	0	0	21	0	0
24	14416018	.	G	C	0	6	6	0	4	10	0	0
24	14420990	.	T	G	3	0	3	0	5	8	0	0
24	14426642	.	T	G	1	0	1	0	6	7	0	0
24	14426646	.	A	C	0	1	1	0	6	7	0	0
24	14432194	.	T	C	9	9	18	0	0	18	0	0
24	14442861	.	G	A	3	5	8	0	1	9	0	0
24	14443291	.	C	T	7	8	15	0	1	16	0	0
24	14443578	.	A	G	8	3	11	0	0	11	0	0
24	14542501	.	A	G	3	4	7	0	0	7	0	0
24	14549344	.	T	A	5	3	8	0	1	9	0	0
24	14550545	.	C	T	13	8	21	0	0	21	0	0
24	14550554	.	G	A	9	9	18	0	2	20	0	0
24	14550596	.	T	C	5	11	16	0	1	17	0	0
24	14559391	.	A	G	17	9	26	0	0	26	0	0
24	14559778	.	A	T	46	28	74	0	2	76	0	0
24	14559828	.	T	A	34	35	69	0	3	72	0	0
24	14567336	.	G	A	2	2	4	0	0	4	0	0
24	14567341	.	C	T	2	1	3	0	0	3	0	0
24	14568300	.	G	T	41	24	65	1	4	70	0	0
24	14575607	.	G	A	30	26	56	0	3	59	0	0
24	14576693	.	A	G	23	16	39	0	1	40	0	0
24	14576782	.	A	G	10	5	15	0	0	15	0	0
24	14624012	.	T	C	3	3	6	0	0	6	0	0
24	14636463	.	C	T	3	5	8	0	0	8	0	0
24	14636495	.	T	C	3	0	3	0	7	10	0	0
24	14636523	.	G	T	2	2	4	0	0	4	0	0
24	14706845	.	A	G	5	3	8	0	0	8	0	0
24	14706851	.	A	G	5	3	8	0	0	8	0	0
24	14711696	.	A	G	1	2	3	0	0	3	0	0
24	14711715	.	G	A	3	2	5	0	0	5	0	0
24	14711743	.	A	T	4	1	5	0	1	6	0	0
24	14711793	.	A	G	2	3	5	0	0	5	0	0
24	14713927	.	T	C	16	14	30	0	2	32	0	0
24	14718163	.	T	C	27	27	54	0	0	54	0	0
24	14725164	.	A	G	29	18	47	0	0	47	0	0
24	14725417	.	G	A	11	28	39	0	0	39	0	0
24	14725551	.	G	A	12	10	22	0	1	23	0	0
24	14937209	.	T	G	1	2	3	0	0	3	0	0
24	15061397	.	T	C	3	3	6	0	1	7	0	0
24	15061434	.	T	C	4	7	11	0	1	12	0	0
24	15061758	.	C	T	3	8	11	0	0	11	0	0
24	15061866	.	G	A	5	8	13	0	3	16	0	0
24	15124785	.	A	T	5	5	10	0	1	11	0	0
24	15124880	.	T	C	11	0	11	0	5	16	0	0
24	15124890	.	A	G	11	4	15	0	0	15	0	0
24	15127487	.	A	T	9	4	13	0	2	15	0	0
24	15127639	.	T	C	6	3	9	0	1	10	0	0
24	15167040	.	G	A	1	2	3	0	0	3	0	0
24	15169316	.	C	T	1	2	3	0	0	3	0	0
24	15277264	.	G	T	1	4	5	0	0	5	0	0
24	15277338	.	G	C	2	4	6	0	0	6	0	0
24	15277347	.	T	C	2	4	6	0	0	6	0	0
24	15277512	.	C	T	5	3	8	0	0	8	0	0
24	15277923	.	T	C	4	2	6	0	1	7	0	0
24	15278403	.	A	G	1	0	1	0	4	5	0	0
24	15645617	.	G	T	6	9	15	0	15	30	0	0
24	15645669	.	G	T	15	13	28	0	0	28	0	0
24	15648158	.	A	G	7	18	25	0	0	25	0	0
24	15648504	.	T	C	6	6	12	0	0	12	0	0
24	15648713	.	G	C	1	3	4	0	0	4	0	0
24	15898196	.	T	G	6	3	9	0	0	9	0	0
24	16111914	.	T	C	7	3	10	0	0	10	0	0
24	16121362	.	G	A	1	6	7	0	7	14	0	0
24	16121462	.	G	A	3	10	13	0	1	14	0	0
24	16162185	.	T	G	2	2	4	0	1	5	0	0
24	16162344	.	A	T	7	7	14	0	0	14	0	0
24	16162422	.	A	T	6	7	13	0	0	13	0	0
24	16471603	.	C	A	8	4	12	0	3	15	0	0
24	16572266	.	G	A	12	10	22	0	1	23	0	0
24	16574732	.	A	G	10	4	14	0	0	14	0	0
24	16596414	.	A	G	13	0	13	0	5	18	0	0
24	16693526	.	T	C	13	9	22	0	4	26	0	0
24	16696713	.	G	C	29	18	47	0	0	47	0	0
24	16702886	.	G	T	1	11	12	0	20	32	0	0
24	16705878	.	C	T	14	13	27	0	1	28	0	0
24	16705948	.	C	T	16	18	34	0	0	34	0	0
24	16705949	.	A	G	14	18	32	0	2	34	0	0
24	16706108	.	A	G	22	10	32	0	1	33	0	0
24	16706709	.	A	C	3	3	6	0	0	6	0	0
24	16706834	.	A	G	3	5	8	0	0	8	0	0
24	16852167	.	A	C	1	2	3	0	0	3	0	0
24	16852174	.	T	C	1	0	1	0	1	2	0	0
24	16855489	.	G	A	1	2	3	0	1	4	0	0
24	16855491	.	A	C	1	2	3	0	1	4	0	0
24	16908827	.	G	A	19	21	40	0	0	40	0	0
24	16908908	.	C	T	21	17	38	0	1	39	0	0
24	16909052	.	T	C	25	19	44	0	1	45	0	0
24	16911600	.	A	C	17	24	41	0	1	42	0	0
24	16911898	.	C	T	20	23	43	0	1	44	0	0
24	16912191	.	G	A	19	31	50	0	0	50	0	0
24	16964353	.	C	A	5	7	12	0	0	12	0	0
24	16964753	.	C	T	4	3	7	0	1	8	0	0
24	16964787	.	T	A	4	2	6	0	1	7	0	0
24	16964881	.	G	C	3	6	9	0	0	9	0	0
24	16964889	.	A	G	2	7	9	0	1	10	0	0
24	16964943	.	A	T	9	2	11	0	1	12	0	0
24	16965020	.	C	T	8	4	12	0	0	12	0	0
24	16965032	.	G	A	7	6	13	0	0	13	0	0
24	16965545	.	C	A	6	6	12	0	0	12	0	0
24	16965648	.	C	G	7	3	10	0	2	12	0	0
24	16965729	.	A	C	5	3	8	0	0	8	0	0
24	16965765	.	T	C	6	4	10	0	2	12	0	0
24	16965770	.	T	C	7	7	14	0	0	14	0	0
24	16965900	.	A	C	4	0	4	0	4	8	0	0
24	16965972	.	A	G	6	2	8	0	0	8	0	0
24	16966176	.	G	A	9	10	19	0	0	19	0	0
24	16966185	.	T	C	10	1	11	0	8	19	0	0
24	16966389	.	A	G	3	8	11	0	0	11	0	0
24	16979653	.	C	A	1	6	7	0	3	10	0	0
24	16979678	.	A	T	2	5	7	0	0	7	0	0
24	16985547	.	C	T	18	16	34	0	0	34	0	0
24	16992605	.	G	A	0	14	14	0	21	35	0	0
24	16992915	.	C	T	22	20	42	0	2	44	0	0
24	16998976	.	A	T	37	20	57	0	1	58	0	0
24	17002611	.	C	T	23	28	51	0	1	52	0	0
24	17002666	.	A	T	22	27	49	1	2	52	0	0
24	17007501	.	C	G	5	5	10	0	0	10	0	0
24	17010932	.	G	T	5	5	10	0	0	10	0	0
24	17011082	.	C	A	2	6	8	0	0	8	0	0
24	17016658	.	T	C	6	3	9	0	0	9	0	0
24	17017060	.	T	C	6	10	16	0	1	17	0	0
24	17019252	.	A	G	13	0	13	1	11	25	0	0
24	17019483	.	T	G	5	0	5	0	3	8	0	0
24	17019504	.	G	A	6	5	11	0	0	11	0	0
24	17019669	.	A	G	7	4	11	0	0	11	0	0
24	17019843	.	A	G	6	0	6	0	4	10	0	0
24	17021848	.	G	A	28	21	49	0	1	50	0	0
24	17021894	.	T	C	35	4	39	0	17	56	0	0
24	17022028	.	A	G	34	6	40	6	2	48	0	0
24	17022029	.	T	A	31	7	38	6	3	47	0	0
24	17023063	.	G	A	21	23	44	0	0	44	0	0
24	17028690	.	T	A	17	15	32	0	0	32	0	0
24	17040627	.	C	T	5	4	9	0	1	10	0	0
24	17040803	.	A	T	3	3	6	0	2	8	0	0
24	17041159	.	G	C	6	4	10	0	0	10	0	0
24	17041208	.	T	G	10	4	14	0	0	14	0	0
24	17041354	.	A	G	8	3	11	0	0	11	0	0
24	17042420	.	G	A	3	2	5	0	0	5	0	0
24	17042598	.	C	A	3	2	5	0	1	6	0	0
24	17042763	.	C	T	16	9	25	0	1	26	0	0
24	17062297	.	A	G	0	2	2	0	1	3	0	0
24	17068942	.	C	T	11	9	20	0	0	20	0	0
24	17068949	.	A	G	11	0	11	0	9	20	0	0
24	17069249	.	C	A	7	5	12	0	1	13	0	0
24	17069297	.	A	G	11	6	17	0	0	17	0	0
24	17069358	.	T	A	4	3	7	0	0	7	0	0
24	17069360	.	G	A	4	2	6	0	1	7	0	0
24	17124124	.	C	T	9	17	26	0	2	28	0	0
24	17124476	.	G	A	1	9	10	0	14	24	0	0
24	17124567	.	T	C	22	13	35	0	2	37	0	0
24	17124591	.	T	A	15	18	33	0	1	34	0	0
24	17126069	.	G	A	14	18	32	0	1	33	0	0
24	17126341	.	C	T	20	11	31	0	0	31	0	0
24	17137566	.	G	T	2	2	4	0	0	4	0	0
24	17177262	.	G	A	0	8	8	0	9	17	0	0
24	17181217	.	C	A	5	3	8	0	0	8	0	0
24	17189815	.	T	A	5	5	10	1	0	11	0	0
24	17211821	.	C	A	15	12	27	0	3	30	0	0
24	17214493	.	A	T	8	13	21	0	3	24	0	0
24	17214629	.	T	C	21	7	28	0	3	31	0	0
24	17214746	.	C	T	8	3	11	0	0	11	0	0
24	17215186	.	T	C	9	5	14	0	1	15	0	0
24	17215855	.	C	T	2	4	6	0	4	10	0	0
24	17215894	.	A	G	3	4	7	0	3	10	0	0
24	17257693	.	C	A	13	9	22	0	4	26	0	0
24	17257866	.	T	C	11	8	19	0	0	19	0	0
24	17258426	.	G	A	12	14	26	0	2	28	0	0
24	17258451	.	G	T	14	12	26	0	2	28	0	0
24	17259535	.	G	T	7	6	13	0	1	14	0	0
24	17260568	.	C	A	6	4	10	0	0	10	0	0
24	17266382	.	G	A	6	6	12	0	2	14	0	0
24	17266564	.	G	T	5	4	9	0	0	9	0	0
24	17266886	.	T	A	14	4	18	0	1	19	0	0
24	17266909	.	T	A	10	4	14	0	1	15	0	0
24	17345618	.	C	A	4	4	8	0	0	8	0	0
24	17345634	.	T	C	2	4	6	0	0	6	0	0
24	17349859	.	G	A	1	2	3	0	0	3	0	0
24	17360174	.	T	C	4	2	6	0	0	6	0	0
24	17363523	.	C	T	1	5	6	0	1	7	0	0
24	17363740	.	A	G	1	4	5	0	0	5	0	0
24	17363745	.	T	G	1	5	6	0	0	6	0	0
24	17364010	.	G	A	0	3	3	0	2	5	0	0
24	17364985	.	G	A	13	17	30	0	2	32	0	0
24	17365081	.	A	G	12	11	23	0	0	23	0	0
24	17366374	.	G	A	15	19	34	0	1	35	0	0
24	17367882	.	G	A	12	10	22	0	0	22	0	0
24	17368343	.	T	A	12	7	19	0	0	19	0	0
24	17368816	.	G	A	5	12	17	0	0	17	0	0
24	17372074	.	G	A	10	7	17	0	1	18	0	0
24	17374611	.	T	C	8	5	13	0	0	13	0	0
24	17377871	.	G	A	8	8	16	0	1	17	0	0
24	17377874	.	G	A	8	7	15	0	2	17	0	0
24	17378123	.	T	C	4	0	4	0	8	12	0	0
24	17378475	.	A	G	6	5	11	0	0	11	0	0
24	17404219	.	G	A	4	8	12	0	0	12	0	0
24	17409892	.	T	G	3	4	7	0	1	8	0	0
24	17417535	.	T	G	6	16	22	0	3	25	0	0
24	17417855	.	G	C	15	12	27	0	0	27	0	0
24	17417899	.	G	C	13	9	22	0	0	22	0	0
24	17417947	.	A	G	10	15	25	0	1	26	0	0
24	17418024	.	C	A	12	12	24	0	0	24	0	0
24	17418180	.	G	T	11	9	20	0	2	22	0	0
24	17418752	.	T	A	10	7	17	0	0	17	0	0
24	17419118	.	T	G	4	10	14	0	0	14	0	0
24	17419140	.	A	G	2	9	11	0	0	11	0	0
24	17419185	.	C	T	2	6	8	0	0	8	0	0
24	17419563	.	A	T	8	5	13	0	0	13	0	0
24	17419604	.	C	A	8	14	22	0	0	22	0	0
24	17419607	.	A	T	8	13	21	0	0	22	1	0
24	17420516	.	G	A	15	11	26	0	1	27	0	0
24	17420519	.	T	C	17	0	17	0	10	27	0	0
24	17420595	.	T	A	9	7	16	0	2	18	0	0
24	17420761	.	G	T	11	6	17	0	0	17	0	0
24	17421216	.	G	T	19	11	30	0	1	31	0	0
24	17421270	.	C	T	2	11	13	0	16	29	0	0
24	17421311	.	G	C	13	9	22	0	3	25	0	0
24	17421338	.	A	T	17	13	30	0	1	31	0	0
24	17421396	.	C	A	22	18	40	0	0	40	0	0
24	17421655	.	G	A	10	11	21	0	1	22	0	0
24	17465715	.	C	T	10	16	26	0	0	26	0	0
24	17465722	.	A	T	10	13	23	0	1	24	0	0
24	17505209	.	G	A	8	5	13	0	0	13	0	0
24	17521679	.	C	G	8	7	15	0	0	15	0	0
24	17611267	.	A	G	5	7	12	0	0	12	0	0
24	17611316	.	G	C	3	6	9	0	1	10	0	0
24	17611349	.	G	A	4	6	10	0	0	10	0	0
24	17618929	.	T	G	2	7	9	0	0	9	0	0
24	17731754	.	T	A	10	5	15	0	1	16	0	0
24	17733684	.	G	A	9	4	13	0	0	13	0	0
24	17733702	.	A	G	6	9	15	0	0	15	0	0
24	17754557	.	G	A	7	8	15	0	1	16	0	0
24	17835812	.	A	G	3	6	9	0	0	9	0	0
24	17871763	.	T	C	4	2	6	0	0	6	0	0
24	18376840	.	G	A	0	5	5	0	4	9	0	0
24	18376848	.	A	C	5	4	9	0	0	9	0	0
24	18444097	.	A	T	7	7	14	0	1	15	0	0
24	18444153	.	G	C	8	5	13	0	1	14	0	0
24	18444267	.	T	C	25	5	30	0	23	53	0	0
24	18444334	.	G	T	31	36	67	0	1	68	0	0
24	18444373	.	C	T	3	3	6	0	0	6	0	0
24	18445784	.	A	G	26	33	59	0	2	61	0	0
24	18446545	.	G	A	20	18	38	0	0	38	0	0
24	18448348	.	G	A	5	4	9	0	0	9	0	0
24	18453298	.	T	C	6	0	6	0	6	12	0	0
24	18465403	.	C	T	3	3	6	0	1	7	0	0
24	18485959	.	T	A	3	3	6	0	0	6	0	0
24	18486030	.	A	G	6	5	11	0	0	11	0	0
24	18486345	.	T	C	1	4	5	0	1	6	0	0
24	18486870	.	T	A	2	2	4	0	0	4	0	0
24	18487385	.	C	T	4	3	7	0	0	7	0	0
24	18492081	.	G	A	5	2	7	0	1	8	0	0
24	18521384	.	T	A	5	3	8	0	1	9	0	0
24	18521467	.	C	A	3	8	11	0	2	13	0	0
24	18549400	.	G	A	7	7	14	0	0	14	0	0
24	18553898	.	C	T	6	9	15	0	1	16	0	0
24	18563695	.	G	A	6	11	17	0	1	18	0	0
24	18563714	.	A	G	6	11	17	0	1	18	0	0
24	18565564	.	A	G	8	6	14	0	0	14	0	0
24	18565591	.	C	T	8	4	12	0	2	14	0	0
24	18598654	.	C	T	3	4	7	0	0	7	0	0
24	18618371	.	A	G	6	4	10	0	0	10	0	0
24	18618372	.	G	T	5	3	8	0	1	10	1	0
24	18625641	.	C	G	3	4	7	0	1	8	0	0
24	18625971	.	C	T	3	4	7	0	0	7	0	0
24	18691811	.	A	T	1	2	3	0	0	3	0	0
24	18710872	.	C	T	1	2	3	0	0	3	0	0
24	18731867	.	T	C	3	5	8	0	0	8	0	0
24	18732018	.	T	A	1	2	3	0	0	3	0	0
24	18732188	.	T	C	2	2	4	0	0	4	0	0
24	18732216	.	A	T	2	4	6	0	0	6	0	0
24	18737472	.	G	T	5	12	17	0	0	17	0	0
24	18737876	.	C	T	9	6	15	0	0	15	0	0
24	18746161	.	C	T	14	6	20	0	3	23	0	0
24	18749985	.	A	G	24	8	32	0	1	33	0	0
24	18750012	.	G	C	15	17	32	0	0	32	0	0
24	18751734	.	T	A	15	7	22	0	2	24	0	0
24	18751740	.	C	T	2	6	8	0	17	25	0	0
24	18751833	.	A	G	12	14	26	0	1	27	0	0
24	18754752	.	G	A	6	6	12	0	0	12	0	0
24	18769652	.	A	G	7	5	12	0	1	13	0	0
24	18783090	.	A	G	8	13	21	0	0	21	0	0
24	18783404	.	C	T	0	11	11	0	5	16	0	0
24	18783638	.	G	A	6	7	13	0	0	13	0	0
24	18783713	.	T	G	5	4	9	0	0	9	0	0
24	18784259	.	C	T	0	1	1	0	9	10	0	0
24	18784288	.	G	A	5	5	10	1	0	11	0	0
24	18794371	.	G	A	6	2	8	0	1	9	0	0
24	18797129	.	G	T	7	6	13	0	0	13	0	0
24	18797142	.	G	A	6	4	10	0	0	10	0	0
24	18827372	.	A	G	1	9	10	0	1	11	0	0
24	19095175	.	C	T	2	3	5	0	0	5	0	0
24	19115072	.	C	A	3	3	6	0	0	6	0	0
24	19190953	.	G	A	0	4	4	0	6	10	0	0
24	19206388	.	A	T	3	2	5	1	0	6	0	0
24	19206561	.	G	T	1	2	3	0	0	3	0	0
24	19206585	.	C	A	2	3	5	0	0	5	0	0
24	19258854	.	A	T	2	3	5	0	0	5	0	0
24	19260876	.	G	A	0	2	2	0	4	6	0	0
24	19342704	.	C	G	5	2	7	0	0	7	0	0
24	19342705	.	A	T	4	2	6	0	1	7	0	0
24	19402231	.	G	A	0	2	2	0	3	5	0	0
24	19586074	.	C	A	1	2	3	0	0	3	0	0
24	19586439	.	G	C	0	5	5	0	6	11	0	0
24	19692059	.	G	A	0	3	3	0	2	5	0	0
24	19692822	.	C	A	2	4	6	0	0	6	0	0
24	19695904	.	C	T	2	3	5	0	0	5	0	0
24	19696060	.	T	C	11	6	17	0	1	18	0	0
24	19696090	.	C	T	4	5	9	0	1	10	0	0
24	19696728	.	G	A	2	3	5	0	4	9	0	0
24	19697211	.	G	A	2	2	4	0	1	5	0	0
24	19697387	.	A	G	5	3	8	0	0	8	0	0
24	19708085	.	A	G	20	24	44	0	2	46	0	0
24	19708448	.	G	T	19	21	40	0	0	40	0	0
24	19708846	.	T	C	10	12	22	0	2	24	0	0
24	19711576	.	G	T	20	15	35	0	2	37	0	0
24	19719132	.	C	A	1	16	17	0	10	27	0	0
24	20064128	.	C	T	5	6	11	0	0	11	0	0
24	20064130	.	G	T	4	5	9	0	1	10	0	0
24	20064232	.	G	A	10	6	16	0	1	17	0	0
24	20064844	.	A	G	5	6	11	1	0	12	0	0
24	20064924	.	A	G	9	4	13	0	1	14	0	0
24	20064988	.	A	C	2	4	6	0	0	6	0	0
24	20065115	.	C	T	2	6	8	0	2	10	0	0
24	20065236	.	T	C	1	4	5	0	1	6	0	0
24	20065366	.	T	G	4	4	8	0	0	8	0	0
24	20065375	.	T	A	4	5	9	0	0	9	0	0
24	20065592	.	G	C	2	2	4	0	1	5	0	0
24	20065733	.	T	C	7	4	11	0	0	11	0	0
24	20066116	.	T	C	5	2	7	0	1	8	0	0
24	20066122	.	A	G	2	2	4	0	3	7	0	0
24	20066317	.	C	T	2	4	6	0	0	6	0	0
24	20082836	.	C	T	1	3	4	0	4	8	0	0
24	20082881	.	T	C	6	5	11	0	0	11	0	0
24	20087709	.	T	C	6	3	9	0	0	9	0	0
24	20189278	.	G	A	1	3	4	0	0	4	0	0
24	20192418	.	A	G	1	2	3	0	0	3	0	0
24	20192539	.	T	G	1	2	3	0	0	3	0	0
24	20194475	.	A	G	3	3	6	0	1	7	0	0
24	20196172	.	A	G	10	3	13	0	0	13	0	0
24	20197755	.	C	A	5	5	10	0	0	10	0	0
24	20199122	.	A	C	3	7	10	0	0	10	0	0
24	20202041	.	C	T	2	1	3	0	1	4	0	0
24	20207173	.	T	G	3	5	8	0	0	8	0	0
24	20208353	.	A	G	5	6	11	0	0	11	0	0
24	20214463	.	G	T	2	3	5	0	0	5	0	0
24	20214496	.	T	C	3	3	6	0	1	7	0	0
24	20216163	.	A	T	1	3	4	0	0	4	0	0
24	20325589	.	G	A	2	4	6	0	0	6	0	0
24	20325754	.	G	A	1	1	2	0	2	4	0	0
24	20328349	.	A	G	6	4	10	0	0	10	0	0
24	20328370	.	G	T	1	5	6	0	4	10	0	0
24	20328567	.	G	C	5	13	18	0	1	19	0	0
24	20328609	.	G	A	5	8	13	0	1	14	0	0
24	20328999	.	T	A	4	4	8	0	0	8	0	0
24	20329493	.	G	A	6	13	19	0	2	21	0	0
24	20329589	.	G	C	8	10	18	0	1	19	0	0
24	20332145	.	A	G	5	3	8	0	0	8	0	0
24	20332187	.	A	T	3	2	5	0	0	5	0	0
24	20336686	.	T	C	4	2	6	0	0	6	0	0
24	20336694	.	A	G	3	0	3	0	1	4	0	0
24	20450191	.	A	G	7	9	16	0	1	17	0	0
24	20450424	.	A	T	7	8	15	0	1	16	0	0
24	20450475	.	G	A	8	5	13	0	0	13	0	0
24	20450536	.	C	T	7	9	16	0	1	17	0	0
24	20450672	.	C	G	9	13	22	0	0	22	0	0
24	20450766	.	G	A	11	19	30	0	1	31	0	0
24	20470788	.	A	G	11	8	19	0	0	19	0	0
24	20501116	.	A	G	9	6	15	0	1	16	0	0
24	20536110	.	G	C	10	5	15	0	0	15	0	0
24	20536188	.	C	A	12	10	22	0	2	24	0	0
24	20536235	.	G	A	0	13	13	0	9	22	0	0
24	20536292	.	A	G	7	13	20	0	0	20	0	0
24	20537515	.	A	T	11	7	18	0	0	18	0	0
24	20539454	.	G	A	13	7	20	0	0	20	0	0
24	20552578	.	A	C	26	14	40	0	0	40	0	0
24	20554732	.	A	G	14	16	30	0	0	30	0	0
24	20554812	.	T	A	3	12	15	0	0	15	0	0
24	20591775	.	G	A	9	7	16	0	0	16	0	0
24	20596717	.	A	G	3	3	6	0	1	7	0	0
24	20600431	.	T	C	4	3	7	0	0	7	0	0
24	20600444	.	G	C	3	2	5	0	1	6	0	0
24	20600712	.	C	T	2	6	8	0	0	8	0	0
24	20600788	.	A	T	4	4	8	0	0	8	0	0
24	20600794	.	G	A	4	4	8	0	0	8	0	0
24	20644548	.	A	G	20	20	40	0	0	40	0	0
24	20645101	.	T	C	16	20	36	0	0	36	0	0
24	20645273	.	T	C	17	17	34	0	0	34	0	0
24	20645858	.	A	T	13	12	25	0	2	27	0	0
24	20646289	.	T	A	11	7	18	0	1	19	0	0
24	20646694	.	G	A	6	11	17	0	1	18	0	0
24	20648945	.	T	C	14	18	32	0	2	34	0	0
24	20649013	.	T	C	14	11	25	0	0	25	0	0
24	20649039	.	T	G	14	11	25	0	2	27	0	0
24	20664650	.	C	G	2	0	2	0	3	5	0	0
24	20708288	.	C	T	4	2	6	0	0	6	0	0
24	20708388	.	A	G	1	4	5	0	0	5	0	0
24	20717280	.	A	G	2	4	6	0	0	6	0	0
24	20807990	.	G	A	3	3	6	0	0	6	0	0
24	20897954	.	G	A	4	4	8	0	0	8	0	0
24	20898218	.	A	T	0	3	3	0	1	4	0	0
24	20898363	.	A	G	2	2	4	0	0	4	0	0
24	20898392	.	A	G	2	3	5	1	0	6	0	0
24	20898402	.	A	G	2	3	5	1	0	6	0	0
24	20898485	.	G	A	3	5	8	0	0	8	0	0
24	20899896	.	T	A	4	3	7	0	0	7	0	0
24	20899929	.	A	T	2	2	4	0	0	4	0	0
24	20899947	.	C	A	2	2	4	0	0	4	0	0
24	20899964	.	A	T	3	2	5	0	0	5	0	0
24	20900032	.	G	T	3	4	7	0	1	8	0	0
24	20902184	.	C	T	5	5	10	0	0	10	0	0
24	20902188	.	C	T	0	5	5	0	6	11	0	0
24	20908035	.	A	C	2	0	2	0	4	6	0	0
24	20908042	.	A	T	1	4	5	0	1	6	0	0
24	20913315	.	G	A	1	6	7	0	0	7	0	0
24	20913316	.	G	A	1	6	7	0	0	7	0	0
24	20916841	.	C	A	3	12	15	1	0	16	0	0
24	20916874	.	A	T	4	4	8	2	1	11	0	0
24	20917017	.	T	C	7	4	11	0	0	11	0	0
24	20917029	.	T	C	5	5	10	3	0	13	0	0
24	20917080	.	T	C	2	2	4	0	0	4	0	0
24	20920648	.	G	C	2	15	17	0	19	36	0	0
24	20920910	.	C	G	15	6	21	5	0	26	0	0
24	20921431	.	C	T	14	8	22	20	0	42	0	0
24	20921530	.	A	G	7	9	16	0	1	17	0	0
24	20921537	.	G	T	8	9	17	0	0	17	0	0
24	20921565	.	C	A	7	6	13	0	1	14	0	0
24	20921594	.	C	T	8	5	13	0	1	14	0	0
24	20921615	.	A	G	4	7	11	0	0	11	0	0
24	20921645	.	A	G	2	2	4	0	2	6	0	0
24	20922708	.	T	G	6	2	8	0	1	9	0	0
24	20922721	.	G	A	8	4	12	0	0	12	0	0
24	20922783	.	G	A	5	3	8	0	0	8	0	0
24	20924996	.	C	T	1	5	6	0	0	6	0	0
24	20931626	.	G	A	17	12	29	0	2	31	0	0
24	20934223	.	C	T	15	17	32	0	1	33	0	0
24	20934528	.	G	A	12	7	19	0	1	20	0	0
24	20941540	.	G	A	9	7	16	0	0	16	0	0
24	20946263	.	G	A	18	11	29	0	1	30	0	0
24	20948122	.	C	T	19	18	37	0	1	38	0	0
24	20949494	.	A	G	17	9	26	0	1	27	0	0
24	20952215	.	T	A	6	8	14	0	1	15	0	0
24	20952306	.	C	T	1	7	8	0	4	12	0	0
24	20953415	.	C	T	9	13	22	0	0	22	0	0
24	20954109	.	G	A	13	5	18	1	0	19	0	0
24	20954151	.	C	A	16	10	26	1	0	27	0	0
24	20954154	.	T	C	17	11	28	1	0	29	0	0
24	20968424	.	A	C	4	2	6	0	0	6	0	0
24	20969449	.	C	T	3	2	5	0	0	5	0	0
24	20987798	.	T	C	2	2	4	0	0	4	0	0
24	21005908	.	A	T	7	8	15	0	0	15	0	0
24	21006082	.	G	A	5	5	10	0	2	12	0	0
24	21060229	.	T	C	1	3	4	0	0	4	0	0
24	21060332	.	A	G	2	2	4	0	0	4	0	0
24	21154165	.	G	A	9	6	15	0	1	16	0	0
24	21154203	.	C	T	14	10	24	0	0	24	0	0
24	21154421	.	A	T	12	23	35	0	1	36	0	0
24	21154496	.	C	A	6	17	23	0	17	40	0	0
24	21154707	.	A	G	36	24	60	0	2	62	0	0
24	21157712	.	G	A	20	26	46	0	1	47	0	0
24	21159814	.	A	G	18	24	42	0	0	42	0	0
24	21161459	.	C	T	1	20	21	0	14	36	1	0
24	21177180	.	T	C	4	8	12	0	0	12	0	0
24	21182156	.	A	G	6	3	9	0	0	9	0	0
24	21182444	.	A	G	5	6	11	0	1	12	0	0
24	21182783	.	C	T	9	14	23	0	3	26	0	0
24	21182834	.	G	A	0	11	11	0	16	27	0	0
24	21182911	.	G	A	2	11	13	0	8	21	0	0
24	21183181	.	C	T	13	9	22	0	0	22	0	0
24	21183228	.	C	G	16	11	27	0	4	31	0	0
24	21183467	.	T	C	4	4	8	0	1	9	0	0
24	21196166	.	T	C	3	3	6	0	0	6	0	0
24	21196410	.	A	G	2	5	7	0	1	8	0	0
24	21196446	.	T	G	1	4	5	0	0	5	0	0
24	21196637	.	T	A	1	2	3	0	0	3	0	0
24	21202203	.	A	G	3	5	8	0	0	8	0	0
24	21202225	.	C	T	4	3	7	0	0	7	0	0
24	21206347	.	T	A	3	4	7	0	0	7	0	0
24	21206352	.	G	T	3	4	7	0	1	8	0	0
24	21206401	.	T	C	1	5	6	0	1	7	0	0
24	21210704	.	A	G	1	3	4	0	0	4	0	0
24	21210728	.	G	T	1	4	5	0	1	6	0	0
24	21212594	.	A	C	1	0	1	0	4	5	0	0
24	21212663	.	A	G	1	2	3	0	0	3	0	0
24	21212684	.	G	A	1	3	4	0	0	4	0	0
24	21214898	.	G	A	3	9	12	0	0	12	0	0
24	21222697	.	C	T	0	2	2	0	1	3	0	0
24	21230992	.	G	A	2	2	4	0	0	4	0	0
24	21371282	.	A	C	2	4	6	0	0	6	0	0
24	21371801	.	T	G	13	29	42	0	4	46	0	0
24	21371919	.	G	A	16	16	32	2	3	37	0	0
24	21372389	.	T	A	22	20	42	0	5	47	0	0
24	21372417	.	A	G	22	20	42	0	0	42	0	0
24	21392168	.	T	C	25	14	39	0	1	40	0	0
24	21392258	.	T	C	17	12	29	0	0	29	0	0
24	21438113	.	A	G	12	13	25	0	1	26	0	0
24	21442815	.	A	G	16	14	30	0	2	32	0	0
24	21447610	.	T	G	13	15	28	0	2	30	0	0
24	21447668	.	C	T	0	16	16	0	9	25	0	0
24	21450383	.	G	A	12	9	21	0	0	21	0	0
24	21462810	.	A	G	14	12	26	0	0	26	0	0
24	21469067	.	T	G	7	10	17	0	1	18	0	0
24	21469157	.	T	C	14	0	14	0	19	33	0	0
24	21470795	.	G	C	6	0	6	0	4	10	0	0
24	21470933	.	C	A	3	2	5	0	1	6	0	0
24	21470934	.	C	A	3	2	5	0	1	6	0	0
24	21502007	.	A	G	4	3	7	0	1	8	0	0
24	21502069	.	G	A	4	13	17	0	0	17	0	0
24	21502133	.	T	C	7	0	7	0	10	17	0	0
24	21502305	.	A	G	7	15	22	0	1	23	0	0
24	21502762	.	T	A	4	2	6	0	1	7	0	0
24	21502817	.	C	A	3	7	10	0	0	10	0	0
24	21502999	.	G	A	11	5	16	0	2	18	0	0
24	21503438	.	G	A	3	5	8	0	0	8	0	0
24	21504169	.	T	G	1	3	4	0	0	4	0	0
24	21504467	.	A	G	9	6	15	0	0	15	0	0
24	21504725	.	C	T	1	9	10	0	12	22	0	0
24	21504785	.	A	G	10	4	14	0	1	15	0	0
24	21504860	.	G	T	6	6	12	0	1	13	0	0
24	21505255	.	T	G	5	7	12	0	0	12	0	0
24	21505895	.	A	G	2	3	5	0	1	6	0	0
24	21538430	.	C	T	7	11	18	0	2	20	0	0
24	21538441	.	T	G	7	0	7	0	10	17	0	0
24	21538568	.	A	C	6	12	18	0	2	20	0	0
24	21538628	.	C	T	4	9	13	0	0	13	0	0
24	21561074	.	C	T	6	10	16	0	1	17	0	0
24	21575273	.	T	A	16	23	39	0	0	39	0	0
24	21575311	.	G	C	18	22	40	0	0	40	0	0
24	21577239	.	G	A	11	10	21	0	0	21	0	0
24	21577488	.	T	C	7	10	17	0	0	17	0	0
24	21577620	.	T	G	9	7	16	0	0	16	0	0
24	21577898	.	C	A	4	4	8	0	0	8	0	0
24	21584115	.	T	C	10	7	17	0	0	17	0	0
24	21584116	.	A	C	9	7	16	0	0	16	0	0
24	21584189	.	G	A	6	4	10	0	0	10	0	0
24	21584323	.	A	T	4	5	9	0	0	9	0	0
24	21584355	.	C	T	4	5	9	0	0	9	0	0
24	21584367	.	C	G	4	4	8	0	0	8	0	0
24	21584731	.	G	A	6	3	9	0	0	9	0	0
24	21584756	.	A	C	6	3	9	0	0	9	0	0
24	21584794	.	G	A	4	3	7	0	0	7	0	0
24	21584904	.	T	C	4	3	7	0	0	7	0	0
24	21585042	.	A	C	6	6	12	0	0	12	0	0
24	21585043	.	A	C	6	6	12	0	0	12	0	0
24	21585148	.	T	C	3	0	3	0	3	6	0	0
24	21585719	.	C	T	0	2	2	0	5	7	0	0
24	21586135	.	T	A	4	4	8	0	0	9	1	0
24	21586190	.	C	G	7	3	10	0	0	10	0	0
24	21587309	.	T	G	5	5	10	0	0	10	0	0
24	21600984	.	C	A	9	26	35	0	0	35	0	0
24	21606035	.	G	A	17	10	27	0	1	28	0	0
24	21606325	.	C	T	1	18	19	0	10	29	0	0
24	21610064	.	G	A	13	19	32	0	0	32	0	0
24	21621684	.	C	T	1	4	5	0	0	5	0	0
24	21621694	.	T	C	1	4	5	0	0	5	0	0
24	21621730	.	G	T	12	15	27	0	2	29	0	0
24	21646375	.	G	A	6	4	10	0	2	12	0	0
24	21646704	.	G	T	18	18	36	0	3	39	0	0
24	21646847	.	A	C	17	18	35	0	0	35	0	0
24	21650034	.	T	A	27	14	41	0	2	43	0	0
24	21657567	.	C	G	17	13	30	0	1	31	0	0
24	21657606	.	T	C	8	20	28	0	0	28	0	0
24	21657639	.	G	A	12	18	30	0	1	31	0	0
24	21657642	.	G	A	13	19	32	0	1	33	0	0
24	21657738	.	T	C	19	0	19	0	12	31	0	0
24	21659864	.	A	T	16	15	31	0	2	33	0	0
24	21659873	.	A	G	18	15	33	0	0	33	0	0
24	21662298	.	T	G	19	5	24	0	0	24	0	0
24	21671114	.	G	A	20	22	42	0	1	43	0	0
24	21679971	.	G	A	10	5	15	0	1	16	0	0
24	21680010	.	G	A	0	12	12	0	10	22	0	0
24	21680143	.	T	C	10	8	18	0	0	18	0	0
24	21680252	.	G	A	3	3	6	0	0	6	0	0
24	21680610	.	G	T	2	4	6	0	0	6	0	0
24	21680612	.	C	T	2	4	6	0	0	6	0	0
24	21680646	.	G	T	5	5	10	0	0	10	0	0
24	21680661	.	T	G	7	6	13	0	0	13	0	0
24	21680747	.	C	G	6	3	9	0	0	9	0	0
24	21680811	.	C	G	5	6	11	0	1	12	0	0
24	21681074	.	G	T	6	6	12	0	1	13	0	0
24	21681112	.	T	A	5	6	11	0	0	11	0	0
24	21681162	.	C	T	4	2	6	0	0	6	0	0
24	21681305	.	A	G	3	4	7	0	0	7	0	0
24	21744266	.	A	G	9	6	15	0	0	15	0	0
24	21748175	.	A	G	6	11	17	0	1	18	0	0
24	21748249	.	T	C	11	15	26	0	0	26	0	0
24	21748279	.	C	T	8	15	23	0	3	26	0	0
24	21748514	.	G	C	0	6	6	0	5	11	0	0
24	21750867	.	A	G	1	2	3	0	0	3	0	0
24	21750874	.	C	T	1	2	3	0	0	3	0	0
24	21750987	.	C	A	2	3	5	0	2	7	0	0
24	21781146	.	A	G	2	3	5	0	0	5	0	0
24	21781451	.	T	G	8	9	17	0	0	17	0	0
24	21781452	.	T	A	9	7	16	0	2	18	0	0
24	21788640	.	C	T	4	3	7	0	1	8	0	0
24	21917518	.	G	A	5	5	10	0	0	10	0	0
24	21917654	.	C	G	0	4	4	0	3	7	0	0
24	21917745	.	T	G	10	9	19	0	1	20	0	0
24	21917777	.	C	A	9	7	16	0	1	17	0	0
24	21917863	.	T	C	4	2	6	0	0	6	0	0
24	21917955	.	G	A	5	3	8	0	0	8	0	0
24	21927438	.	G	A	1	4	5	0	0	5	0	0
24	21927456	.	C	T	1	3	4	0	1	5	0	0
24	21927506	.	A	G	6	3	9	0	0	9	0	0
24	21929107	.	T	C	1	0	1	0	4	5	0	0
24	21934112	.	A	G	2	4	6	0	0	6	0	0
24	22740563	.	C	T	3	2	5	0	0	5	0	0
24	22740589	.	T	C	8	6	14	0	0	14	0	0
24	22740897	.	A	T	10	13	23	0	1	24	0	0
24	22740949	.	A	G	8	18	26	0	0	26	0	0
24	22740996	.	C	T	6	14	20	0	0	20	0	0
24	22741051	.	G	A	11	7	18	0	2	20	0	0
24	22741088	.	C	T	8	16	24	0	0	24	0	0
24	22741403	.	T	A	16	11	27	0	3	30	0	0
24	22741453	.	C	T	11	8	19	0	3	22	0	0
24	22744502	.	A	G	6	18	24	0	0	24	0	0
24	22746843	.	T	G	16	14	30	0	2	32	0	0
24	22748633	.	C	T	10	9	19	0	4	23	0	0
24	22769225	.	A	T	11	13	24	0	3	27	0	0
24	22769333	.	A	G	3	0	3	0	6	9	0	0
24	22769447	.	G	A	11	6	17	0	0	17	0	0
24	22769484	.	C	T	13	4	17	0	0	17	0	0
24	22769593	.	C	A	12	5	17	0	0	17	0	0
24	22769595	.	T	A	5	10	15	0	0	15	0	0
24	23213411	.	C	A	2	5	7	0	0	7	0	0
24	23213419	.	A	C	5	3	8	0	0	8	0	0
24	23213684	.	C	T	2	2	4	0	0	4	0	0
24	23213738	.	C	T	3	3	6	0	0	6	0	0
24	23213886	.	G	A	0	2	2	0	2	4	0	0
24	23243257	.	A	G	0	5	5	0	1	6	0	0
24	23250116	.	T	A	7	5	12	0	1	13	0	0
24	23300755	.	A	G	4	4	8	0	0	8	0	0
24	23302371	.	A	G	5	4	9	0	0	9	0	0
24	23302441	.	A	G	1	4	5	0	0	5	0	0
24	23302707	.	T	G	2	3	5	0	0	5	0	0
24	23302897	.	G	C	2	2	4	0	0	4	0	0
24	23303003	.	G	A	1	2	3	0	0	3	0	0
24	23716987	.	T	A	6	5	11	0	0	11	0	0
24	23716991	.	A	G	6	5	11	0	0	11	0	0
24	23717079	.	T	G	7	7	14	0	2	16	0	0
24	23747297	.	G	A	6	3	9	0	0	9	0	0
24	23747302	.	T	C	5	3	8	0	1	9	0	0
24	23759258	.	C	T	2	2	4	0	0	4	0	0
24	23759505	.	A	G	5	8	13	0	0	13	0	0
24	23759787	.	T	G	8	6	14	0	0	14	0	0
24	23760291	.	A	G	5	6	11	0	1	12	0	0
24	23838823	.	C	T	5	2	7	0	2	9	0	0
24	23839024	.	T	C	7	3	10	0	1	11	0	0
24	23839303	.	A	G	2	5	7	0	0	7	0	0
24	23851341	.	A	C	1	2	3	0	0	3	0	0
24	23884522	.	G	A	1	2	3	0	3	6	0	0
24	23941618	.	G	T	7	9	16	0	0	16	0	0
24	24017837	.	C	T	11	4	15	0	0	15	0	0
24	24020314	.	C	T	10	14	24	0	0	24	0	0
24	24027914	.	T	A	6	12	18	0	0	18	0	0
24	24027939	.	A	G	11	10	21	0	1	22	0	0
24	24028016	.	C	T	9	4	13	0	0	13	0	0
24	24028032	.	G	C	9	3	12	0	0	12	0	0
24	24028059	.	T	A	7	11	18	0	1	19	0	0
24	24102091	.	T	C	11	1	12	0	20	32	0	0
24	24110789	.	A	T	21	20	41	0	1	42	0	0
24	24110935	.	C	T	18	17	35	0	1	36	0	0
24	24111470	.	G	A	8	7	15	0	1	16	0	0
24	24114272	.	G	C	23	16	39	0	0	39	0	0
24	24114321	.	C	T	18	13	31	0	1	32	0	0
24	24114417	.	C	T	11	11	22	0	0	22	0	0
24	24114744	.	G	A	12	15	27	0	0	27	0	0
24	24114810	.	A	C	13	9	22	0	0	22	0	0
24	24118213	.	A	C	3	11	14	0	1	15	0	0
24	24118272	.	A	G	10	9	19	0	1	20	0	0
24	24118362	.	C	T	7	6	13	0	2	15	0	0
24	24118366	.	A	T	8	5	13	0	1	14	0	0
24	24121130	.	C	T	23	23	46	0	0	46	0	0
24	24121282	.	C	G	2	14	16	0	27	43	0	0
24	24121366	.	A	G	25	24	49	0	3	52	0	0
24	24121375	.	G	C	23	0	23	0	26	49	0	0
24	24121502	.	T	A	9	6	15	0	1	16	0	0
24	24121826	.	G	T	25	19	44	1	4	49	0	0
24	24121851	.	A	T	28	21	49	2	1	52	0	0
24	24124517	.	G	A	29	23	52	1	0	53	0	0
24	24127078	.	A	T	22	29	51	0	2	53	0	0
24	24130794	.	A	G	29	29	58	0	3	61	0	0
24	24130824	.	T	C	32	25	57	0	2	59	0	0
24	24135906	.	G	A	28	19	47	0	2	49	0	0
24	24136047	.	T	G	35	17	52	0	2	54	0	0
24	24146669	.	T	C	35	0	35	0	29	64	0	0
24	24155586	.	T	C	16	18	34	0	3	37	0	0
24	24155607	.	G	A	17	16	33	0	3	36	0	0
24	24155655	.	A	G	24	14	38	0	2	40	0	0
24	24155664	.	C	A	24	16	40	0	1	41	0	0
24	24155718	.	A	T	20	15	35	0	3	38	0	0
24	24163114	.	C	T	12	9	21	0	1	22	0	0
24	24164812	.	A	T	16	14	30	0	1	31	0	0
24	24164935	.	A	C	11	16	27	0	0	27	0	0
24	24168359	.	G	C	31	28	59	0	1	60	0	0
24	24171017	.	G	A	2	4	6	0	0	6	0	0
24	24177010	.	G	A	6	1	7	0	0	7	0	0
24	24177024	.	T	C	8	3	11	0	0	11	0	0
24	24177137	.	A	G	7	6	13	0	0	13	0	0
24	24177213	.	G	C	8	5	13	0	0	13	0	0
24	24184394	.	T	C	3	0	3	0	7	10	0	0
24	24184677	.	T	A	11	5	16	0	1	17	0	0
24	24187454	.	T	G	11	4	15	0	0	15	0	0
24	24189345	.	T	A	14	5	19	0	0	19	0	0
24	24189357	.	A	G	13	6	19	0	0	19	0	0
24	24189516	.	C	T	1	4	5	0	5	10	0	0
24	24189543	.	T	C	10	3	13	0	0	13	0	0
24	24189591	.	C	T	11	2	13	0	2	15	0	0
24	24210479	.	C	T	3	5	8	0	0	8	0	0
24	24210485	.	G	A	3	4	7	0	0	7	0	0
24	24214816	.	A	T	6	4	10	0	0	10	0	0
24	24274069	.	A	T	1	3	4	0	0	4	0	0
24	24299597	.	T	C	1	8	9	0	0	9	0	0
24	24461710	.	T	A	15	10	25	0	0	25	0	0
24	24462021	.	C	T	8	12	20	0	0	20	0	0
24	24463030	.	T	A	16	12	28	0	0	28	0	0
24	24463060	.	A	G	14	12	26	0	3	29	0	0
24	24701885	.	C	G	14	11	25	0	0	25	0	0
24	24701938	.	T	C	8	9	17	0	3	20	0	0
24	24702119	.	A	C	5	0	5	0	9	14	0	0
24	24702674	.	C	T	14	14	28	0	2	30	0	0
24	24702930	.	C	T	1	7	8	0	9	17	0	0
24	24702936	.	T	C	8	7	15	0	0	15	0	0
24	24720991	.	G	A	7	14	21	0	1	22	0	0
24	24731064	.	T	A	1	2	3	0	2	5	0	0
24	24732383	.	T	G	2	0	2	0	2	4	0	0
24	24745966	.	T	C	8	0	8	0	5	13	0	0
24	24796567	.	C	G	0	3	3	0	2	5	0	0
24	24796811	.	T	C	2	0	2	0	4	6	0	0
24	24796901	.	T	C	4	4	8	0	0	8	0	0
24	24797416	.	C	T	2	3	5	0	0	5	0	0
24	24848118	.	C	T	5	16	21	0	15	36	0	0
24	24931465	.	T	C	12	8	20	0	1	21	0	0
24	24934347	.	T	C	10	9	19	0	1	20	0	0
24	24935527	.	G	A	10	8	18	0	2	20	0	0
24	24935560	.	A	G	8	0	8	0	9	17	0	0
24	24935791	.	G	C	5	2	7	0	1	8	0	0
24	24935810	.	T	C	6	6	12	0	0	12	0	0
24	24944387	.	A	C	10	10	20	0	0	20	0	0
24	24948089	.	T	A	14	12	26	0	1	27	0	0
24	24948101	.	T	A	19	10	29	0	0	29	0	0
24	24950569	.	T	C	10	9	19	0	1	20	0	0
24	24954478	.	T	C	10	5	15	0	0	15	0	0
24	24989293	.	T	G	3	10	13	0	1	14	0	0
24	24989368	.	C	T	1	10	11	0	11	22	0	0
24	24992522	.	G	A	8	9	17	0	1	18	0	0
24	24992832	.	A	G	3	4	7	0	0	7	0	0
24	25001181	.	G	A	5	4	9	0	1	10	0	0
24	25008378	.	G	C	1	0	1	0	4	5	0	0
24	25008884	.	G	A	3	14	17	0	2	19	0	0
24	25008887	.	G	A	3	16	19	0	0	19	0	0
24	25020054	.	T	G	8	6	14	0	0	14	0	0
24	25026278	.	G	A	2	3	5	0	2	7	0	0
24	25026344	.	C	T	0	6	6	0	7	13	0	0
24	25029860	.	T	A	10	10	20	0	0	20	0	0
24	25030071	.	G	A	5	3	8	0	0	8	0	0
24	25032485	.	G	A	8	4	12	0	0	12	0	0
24	25041054	.	T	C	3	4	7	0	1	8	0	0
24	25047572	.	C	G	8	0	8	0	11	19	0	0
24	25049209	.	C	T	10	13	23	0	0	23	0	0
24	25049436	.	T	C	6	8	14	0	0	14	0	0
24	25049484	.	T	G	7	6	13	0	0	13	0	0
24	25049658	.	T	C	6	5	11	0	0	11	0	0
24	25052078	.	C	T	9	5	14	0	0	14	0	0
24	25052723	.	T	A	9	8	17	0	2	19	0	0
24	25052774	.	C	T	9	7	16	0	0	16	0	0
24	25053032	.	C	A	12	14	26	0	0	26	0	0
24	25059127	.	C	T	5	4	9	0	0	9	0	0
24	25059129	.	T	C	5	4	9	0	0	9	0	0
24	25069670	.	G	A	10	9	19	0	0	19	0	0
24	25069926	.	A	G	15	0	15	0	8	23	0	0
24	25069928	.	T	A	7	15	22	0	0	22	0	0
24	25070289	.	C	T	6	8	14	0	1	15	0	0
24	25070515	.	C	T	6	4	10	0	1	11	0	0
24	25070745	.	G	A	3	8	11	0	8	19	0	0
24	25070921	.	C	T	12	9	21	0	1	22	0	0
24	25070922	.	T	G	13	8	21	0	1	22	0	0
24	25071270	.	T	A	12	14	26	0	1	27	0	0
24	25071474	.	T	C	19	16	35	0	0	35	0	0
24	25071486	.	A	T	13	18	31	0	0	31	0	0
24	25071726	.	G	A	7	6	13	0	0	13	0	0
24	25071742	.	T	C	8	6	14	0	0	14	0	0
24	25071939	.	G	A	4	3	7	0	0	7	0	0
24	25072088	.	T	C	12	12	24	0	0	24	0	0
24	25072102	.	T	C	14	10	24	0	0	24	0	0
24	25072311	.	C	T	6	10	16	0	0	16	0	0
24	25072358	.	C	A	7	6	13	0	2	15	0	0
24	25072487	.	A	G	11	14	25	0	2	27	0	0
24	25072511	.	T	G	10	11	21	0	2	23	0	0
24	25072711	.	G	A	12	14	26	0	2	28	0	0
24	25094289	.	G	C	2	0	2	0	2	4	0	0
24	25230048	.	G	A	6	3	9	0	0	9	0	0
24	25347794	.	G	T	9	3	12	0	0	12	0	0
24	25348187	.	C	A	5	2	7	0	0	7	0	0
24	25348354	.	C	T	4	5	9	0	1	10	0	0
24	25350710	.	G	A	5	4	9	0	0	9	0	0
24	25350712	.	G	A	5	4	9	0	0	9	0	0
24	25351091	.	A	G	3	2	5	0	0	5	0	0
24	25351121	.	T	C	1	5	6	0	0	6	0	0
24	25351172	.	A	T	1	3	4	0	0	4	0	0
24	25351368	.	A	T	4	4	8	0	1	9	0	0
24	25351563	.	T	C	3	2	5	0	0	5	0	0
24	25351588	.	T	G	4	2	6	0	0	6	0	0
24	25351693	.	A	G	3	2	5	0	0	5	0	0
24	25351911	.	C	T	1	3	4	0	3	7	0	0
24	25351955	.	C	T	1	2	3	0	0	3	0	0
24	25359629	.	G	A	2	2	4	0	0	4	0	0
24	25363324	.	C	G	2	3	5	0	0	5	0	0
24	25448155	.	G	A	4	6	10	0	0	10	0	0
24	25448185	.	C	A	0	8	8	0	3	11	0	0
24	25448733	.	G	T	6	3	9	0	1	11	1	0
24	25448741	.	T	C	3	7	10	0	1	11	0	0
24	25448791	.	T	C	4	3	7	0	1	8	0	0
24	25448792	.	T	C	5	2	7	0	1	8	0	0
24	25449182	.	G	A	2	4	6	0	0	6	0	0
24	25449319	.	G	A	3	7	10	0	0	10	0	0
24	25454912	.	G	A	5	4	9	0	0	9	0	0
24	25455160	.	T	C	2	6	8	0	0	8	0	0
24	25458768	.	A	G	2	2	4	0	0	4	0	0
24	25461117	.	C	A	1	5	6	0	0	6	0	0
24	25496194	.	A	C	7	5	12	0	0	12	0	0
24	25496215	.	T	G	7	7	14	0	0	14	0	0
24	25496271	.	C	T	2	4	6	0	1	7	0	0
24	25496318	.	A	G	6	0	6	0	3	9	0	0
24	25496590	.	T	C	4	8	12	0	0	12	0	0
24	25496789	.	T	C	9	3	12	0	0	12	0	0
24	25497273	.	A	T	9	7	16	0	1	17	0	0
24	25497327	.	T	C	6	5	11	0	0	11	0	0
24	25497353	.	G	A	1	4	5	0	2	7	0	0
24	25497412	.	C	A	8	3	11	0	1	13	1	0
24	25497414	.	A	T	9	3	12	0	1	13	0	0
24	25497677	.	G	A	4	4	8	0	0	8	0	0
24	25497704	.	A	G	2	2	4	0	1	6	1	0
24	25497979	.	T	A	1	3	4	0	0	4	0	0
24	25526192	.	C	A	12	14	26	0	1	27	0	0
24	25565407	.	T	C	7	0	7	0	7	14	0	0
24	25565556	.	T	C	5	4	9	0	0	9	0	0
24	25575049	.	A	G	11	8	19	0	1	20	0	0
24	25582229	.	A	G	10	8	18	0	0	18	0	0
24	25587684	.	T	C	3	2	5	0	1	6	0	0
24	25602136	.	G	T	4	4	8	0	0	8	0	0
24	25635801	.	C	T	6	4	10	0	1	11	0	0
24	25635933	.	G	A	6	2	8	0	0	8	0	0
24	25693003	.	G	A	24	22	46	0	1	47	0	0
24	25693026	.	C	T	24	26	50	0	3	53	0	0
24	25693948	.	A	G	23	26	49	1	0	50	0	0
24	25693992	.	T	A	20	17	37	0	6	43	0	0
24	25694537	.	A	C	17	17	34	0	3	37	0	0
24	25761637	.	T	C	2	4	6	0	0	6	0	0
24	25761784	.	C	A	2	2	4	0	0	4	0	0
24	25761788	.	A	T	2	2	4	0	0	4	0	0
24	25762272	.	G	A	2	5	7	1	0	8	0	0
24	25762491	.	A	G	3	5	8	0	0	8	0	0
24	25762506	.	C	T	4	4	8	0	0	8	0	0
24	25762600	.	T	C	1	3	4	0	0	4	0	0
24	25762884	.	C	T	6	6	12	0	1	13	0	0
24	25763513	.	A	G	2	2	4	0	0	4	0	0
24	25764207	.	A	T	1	2	3	0	0	3	0	0
24	25764281	.	A	G	1	2	3	0	0	3	0	0
24	25764365	.	A	C	2	0	2	0	3	5	0	0
24	25764375	.	A	C	3	0	3	0	2	5	0	0
24	25764729	.	T	C	2	0	2	0	2	4	0	0
24	25764892	.	A	T	1	2	3	0	0	3	0	0
24	25765159	.	C	T	2	2	4	0	0	4	0	0
24	25779059	.	G	A	1	2	3	0	0	3	0	0
24	25786579	.	G	A	1	2	3	0	0	3	0	0
24	25794522	.	C	A	11	3	14	0	0	14	0	0
24	25794530	.	G	A	11	1	12	0	0	12	0	0
24	25872390	.	C	T	14	5	19	0	0	19	0	0
24	25988133	.	C	A	1	2	3	3	0	6	0	0
24	25988309	.	A	T	2	5	7	0	0	7	0	0
24	26017133	.	T	C	3	3	6	0	0	6	0	0
24	26017175	.	T	A	7	6	13	0	0	13	0	0
24	26017188	.	A	G	5	5	10	0	3	13	0	0
24	26020254	.	A	T	2	5	7	0	0	7	0	0
24	26020514	.	T	G	4	3	7	0	0	7	0	0
24	26021810	.	T	C	4	2	6	0	0	6	0	0
24	26021871	.	G	A	4	4	8	0	0	8	0	0
24	26025151	.	T	C	2	4	6	0	0	6	0	0
24	26025384	.	T	A	5	2	7	0	1	8	0	0
24	26026179	.	A	T	6	8	14	0	0	14	0	0
24	26030340	.	T	G	13	6	19	0	2	21	0	0
24	26030571	.	C	T	16	14	30	0	1	31	0	0
24	26030663	.	T	C	12	9	21	0	0	21	0	0
24	26030827	.	A	C	11	16	27	0	1	28	0	0
24	26030849	.	T	A	10	16	26	0	1	27	0	0
24	26030893	.	G	A	12	12	24	0	4	28	0	0
24	26030985	.	A	T	5	10	15	0	0	15	0	0
24	26036427	.	C	A	3	3	6	0	2	8	0	0
24	26039798	.	A	G	5	2	7	1	0	8	0	0
24	26040719	.	A	G	1	3	4	0	0	4	0	0
24	26041227	.	T	C	3	2	5	0	0	5	0	0
24	26045132	.	C	T	4	2	6	0	0	6	0	0
24	26046588	.	A	G	5	0	5	0	11	16	0	0
24	26046618	.	G	A	8	11	19	0	0	19	0	0
24	26046820	.	A	G	4	0	4	0	5	9	0	0
24	26046822	.	T	C	5	4	9	0	0	9	0	0
24	26048017	.	G	A	8	8	16	0	0	16	0	0
24	26049166	.	G	T	4	10	14	0	0	14	0	0
24	26049825	.	T	C	7	5	12	0	0	12	0	0
24	26050066	.	A	T	2	5	7	0	1	8	0	0
24	26052082	.	T	C	6	7	13	0	0	13	0	0
24	26142635	.	G	A	1	3	4	0	0	4	0	0
24	26196594	.	A	G	4	3	7	0	0	7	0	0
24	26196676	.	A	G	1	1	2	0	0	2	0	0
24	26196693	.	A	G	2	2	4	0	0	4	0	0
24	26197291	.	A	G	3	3	6	0	0	6	0	0
24	26280058	.	G	A	5	4	9	0	1	10	0	0
24	26280163	.	A	G	5	7	12	0	0	12	0	0
24	26280505	.	G	A	1	2	3	0	2	5	0	0
24	26280668	.	A	C	4	3	7	0	0	7	0	0
24	26280756	.	G	A	7	5	12	0	0	12	0	0
24	26284612	.	G	T	9	13	22	0	1	23	0	0
24	26331279	.	G	A	1	4	5	0	2	8	1	0
24	26331307	.	C	T	3	5	8	0	0	8	0	0
24	26333084	.	T	C	4	3	7	0	0	7	0	0
24	26333597	.	C	T	5	3	8	0	0	8	0	0
24	26333801	.	C	T	4	3	7	0	0	7	0	0
24	26334257	.	G	A	4	7	11	0	0	11	0	0
24	26334299	.	A	G	4	0	4	0	9	13	0	0
24	26373354	.	G	A	6	3	9	0	0	9	0	0
24	26373473	.	G	A	6	9	15	0	0	15	0	0
24	26373498	.	G	A	9	3	12	0	0	12	0	0
24	26376380	.	A	G	15	9	24	0	0	24	0	0
24	26383253	.	C	T	5	3	8	0	0	8	0	0
24	26383430	.	A	G	12	9	21	0	0	21	0	0
24	26383604	.	T	A	3	3	6	0	0	6	0	0
24	26383670	.	A	G	3	7	10	0	1	11	0	0
24	26383700	.	C	T	3	2	5	0	6	11	0	0
24	26383829	.	C	T	0	10	10	0	9	19	0	0
24	26383840	.	C	T	12	8	20	0	1	21	0	0
24	26383907	.	T	C	10	8	18	0	1	19	0	0
24	26383971	.	A	C	9	0	9	0	6	15	0	0
24	26384030	.	G	C	11	1	12	0	5	17	0	0
24	26406895	.	C	A	5	5	10	0	4	14	0	0
24	26406898	.	A	G	6	0	6	0	8	14	0	0
24	26406967	.	G	T	3	7	10	0	0	10	0	0
24	26415190	.	T	C	18	11	29	0	0	29	0	0
24	26420141	.	T	C	14	10	24	0	1	25	0	0
24	26475434	.	C	T	16	9	25	0	2	27	0	0
24	26478889	.	C	T	4	17	21	0	25	46	0	0
24	26482337	.	T	C	33	35	68	0	3	71	0	0
24	26492062	.	T	A	10	6	16	0	1	17	0	0
24	26492113	.	C	T	2	14	16	0	12	28	0	0
24	26492505	.	G	T	6	8	14	1	2	18	1	0
24	26492905	.	G	T	4	8	12	0	0	12	0	0
24	26493029	.	T	G	7	2	9	0	0	9	0	0
24	26493158	.	A	C	12	0	12	0	6	18	0	0
24	26493542	.	C	A	15	11	26	0	0	26	0	0
24	26493691	.	T	A	8	12	20	0	1	21	0	0
24	26494077	.	C	A	7	12	19	0	0	19	0	0
24	26494477	.	C	T	0	9	9	0	6	15	0	0
24	26508886	.	C	T	1	10	11	0	5	16	0	0
24	26511001	.	C	T	8	6	14	0	0	14	0	0
24	26513205	.	T	C	4	7	11	0	1	12	0	0
24	26518811	.	A	G	6	5	11	0	1	12	0	0
24	26527472	.	G	A	11	9	20	0	0	20	0	0
24	26530814	.	T	A	4	11	15	0	0	15	0	0
24	26558029	.	A	G	15	8	23	0	1	24	0	0
24	26574127	.	C	T	1	3	4	0	1	5	0	0
24	26662895	.	A	G	4	2	6	0	0	6	0	0
24	26663944	.	A	G	5	2	7	0	1	8	0	0
24	26666778	.	G	A	4	3	7	0	1	8	0	0
24	26687731	.	G	A	3	4	7	0	0	7	0	0
24	26688607	.	C	T	2	2	4	0	1	5	0	0
24	26692216	.	A	G	4	4	8	0	0	8	0	0
24	26692261	.	G	A	3	2	5	0	1	6	0	0
24	26701534	.	C	T	3	3	6	0	1	7	0	0
24	26701540	.	C	T	2	3	5	0	0	5	0	0
24	26887490	.	C	A	2	3	5	0	0	5	0	0
24	26888938	.	A	C	1	3	4	0	0	4	0	0
24	26889347	.	C	T	3	4	7	0	0	7	0	0
24	26889359	.	G	A	3	4	7	0	0	7	0	0
24	26895836	.	T	G	3	2	5	0	1	6	0	0
24	26901727	.	G	A	0	2	2	0	2	4	0	0
24	26936794	.	G	A	1	5	6	0	0	6	0	0
24	26941713	.	C	T	10	6	16	0	0	16	0	0
24	26941996	.	A	G	9	8	17	0	0	17	0	0
24	26942242	.	C	G	8	16	24	0	0	24	0	0
24	26942711	.	T	C	9	15	24	0	2	26	0	0
24	26942880	.	A	T	9	12	21	0	1	22	0	0
24	26942989	.	G	A	3	3	6	0	1	7	0	0
24	26943103	.	C	G	14	9	23	0	1	24	0	0
24	26943148	.	C	T	7	9	16	0	1	17	0	0
24	26945274	.	T	A	10	7	17	0	1	18	0	0
24	26948933	.	A	T	3	3	6	0	1	7	0	0
24	26949426	.	A	C	4	9	13	0	0	13	0	0
24	26949555	.	T	G	7	4	11	0	1	12	0	0
24	26959891	.	T	C	3	1	4	0	10	14	0	0
24	26962107	.	G	A	5	5	10	0	0	10	0	0
24	26962277	.	C	T	11	5	16	0	0	16	0	0
24	26964935	.	A	C	2	2	4	0	0	4	0	0
24	26967521	.	C	T	7	4	11	0	0	11	0	0
24	26968308	.	G	A	6	7	13	0	1	14	0	0
24	26970323	.	A	T	4	3	7	0	0	7	0	0
24	26970404	.	G	A	3	5	8	0	0	8	0	0
24	26970407	.	C	T	3	5	8	0	0	8	0	0
24	26970936	.	T	C	5	0	5	0	4	9	0	0
24	26971515	.	C	T	1	5	6	0	0	6	0	0
24	26980842	.	A	G	6	4	10	0	0	10	0	0
24	26997920	.	G	A	4	3	7	0	2	9	0	0
24	27009231	.	C	A	7	6	13	0	1	14	0	0
24	27011189	.	T	A	7	6	13	0	1	14	0	0
24	27023403	.	C	T	7	5	12	0	0	12	0	0
24	27151634	.	T	C	1	7	8	0	0	8	0	0
24	27153245	.	C	T	11	4	15	0	0	15	0	0
24	27168681	.	T	C	6	7	13	0	0	13	0	0
24	27168939	.	C	T	7	3	10	0	0	10	0	0
24	27185574	.	A	G	20	10	30	0	0	30	0	0
24	27203410	.	C	T	9	6	15	2	0	17	0	0
24	27207238	.	G	T	16	10	26	0	1	27	0	0
24	27216987	.	G	A	1	5	6	0	6	12	0	0
24	27222574	.	G	A	18	9	27	0	2	29	0	0
24	27222662	.	C	T	11	10	21	0	6	27	0	0
24	27222731	.	A	G	12	0	12	0	15	27	0	0
24	27222937	.	G	A	3	12	15	0	14	29	0	0
24	27223018	.	C	T	8	10	18	0	0	18	0	0
24	27224064	.	T	A	20	19	39	0	1	40	0	0
24	27224598	.	G	A	6	6	12	0	0	12	0	0
24	27224863	.	C	A	13	8	21	0	1	22	0	0
24	27225096	.	T	C	16	15	31	0	2	33	0	0
24	27225423	.	C	A	17	8	25	0	0	25	0	0
24	27226057	.	C	T	6	8	14	0	1	15	0	0
24	27238808	.	C	T	1	18	19	0	11	30	0	0
24	27238826	.	G	A	21	9	30	0	0	30	0	0
24	27244609	.	T	C	3	1	4	0	2	6	0	0
24	27244691	.	C	A	1	4	5	0	4	9	0	0
24	27244900	.	T	C	2	0	2	0	4	6	0	0
24	27244927	.	T	G	1	2	3	0	2	5	0	0
24	27245465	.	G	A	1	2	3	0	0	3	0	0
24	27245481	.	T	A	2	2	4	0	0	4	0	0
24	27251249	.	C	T	10	13	23	0	2	25	0	0
24	27399969	.	T	C	6	13	19	0	1	20	0	0
24	28137270	.	G	T	2	2	4	0	0	4	0	0
24	28137355	.	G	A	4	4	8	0	1	9	0	0
24	28137429	.	G	A	2	6	8	0	1	9	0	0
24	28137679	.	C	T	0	3	3	0	1	4	0	0
24	28228495	.	G	A	4	4	8	0	0	8	0	0
24	28228572	.	G	A	7	5	12	0	0	12	0	0
24	28228587	.	T	C	6	3	9	0	0	9	0	0
24	28228993	.	A	T	4	2	6	0	1	7	0	0
24	28252608	.	C	T	7	3	10	0	0	10	0	0
24	28252699	.	G	A	7	6	13	0	0	13	0	0
24	28252898	.	C	A	11	12	23	0	1	24	0	0
24	28253740	.	A	T	20	8	28	0	1	29	0	0
24	28253802	.	T	C	21	0	21	2	12	35	0	0
24	28259134	.	T	C	12	13	25	0	1	26	0	0
24	28263856	.	G	C	10	12	22	1	0	23	0	0
24	28263964	.	G	A	14	9	23	0	2	25	0	0
24	28276193	.	C	T	0	6	6	0	11	17	0	0
24	28306413	.	A	C	3	0	3	0	6	9	0	0
24	28354675	.	T	G	12	8	20	0	0	20	0	0
24	28365152	.	G	A	9	5	14	0	0	14	0	0
24	28381103	.	C	T	3	2	5	0	1	6	0	0
24	28381130	.	T	C	6	4	10	0	0	10	0	0
24	28392367	.	A	G	3	0	3	0	4	7	0	0
24	28392421	.	T	C	7	3	10	0	1	11	0	0
24	28394482	.	C	T	5	7	12	0	0	12	0	0
24	28397232	.	G	T	0	8	8	0	5	13	0	0
24	28397569	.	G	A	1	2	3	0	0	3	0	0
24	28426082	.	T	A	23	4	27	0	1	28	0	0
24	28426244	.	G	C	6	15	21	1	0	22	0	0
24	28426597	.	G	A	32	20	52	1	0	53	0	0
24	28432465	.	C	T	26	13	39	0	0	39	0	0
24	28437375	.	A	G	18	19	37	0	0	37	0	0
24	28437562	.	G	C	8	8	16	0	0	16	0	0
24	28556150	.	C	T	1	2	3	0	0	3	0	0
24	28687424	.	C	T	2	7	9	0	9	18	0	0
24	28687576	.	A	G	11	12	23	0	0	23	0	0
24	28688104	.	G	A	10	9	19	0	0	19	0	0
24	28688137	.	G	A	11	6	17	0	0	17	0	0
24	28688416	.	G	A	6	8	14	0	0	14	0	0
24	28691389	.	C	T	6	8	14	0	1	15	0	0
24	28691457	.	C	T	0	12	12	0	5	17	0	0
24	28710825	.	A	G	9	6	15	0	0	15	0	0
24	28764251	.	A	C	3	2	5	0	0	5	0	0
24	28935232	.	A	G	7	3	10	0	0	10	0	0
24	28936771	.	C	T	11	12	23	0	0	23	0	0
24	28936801	.	A	T	10	16	26	0	0	26	0	0
24	28953040	.	C	A	10	11	21	0	0	21	0	0
24	28960786	.	T	G	12	13	25	0	0	25	0	0
24	28960808	.	A	C	10	18	28	0	0	28	0	0
24	28964652	.	G	A	3	2	5	0	0	5	0	0
24	28964747	.	T	A	1	2	3	0	0	3	0	0
24	28964976	.	A	C	2	3	5	0	0	5	0	0
24	28965616	.	C	T	1	3	4	0	1	5	0	0
24	28966034	.	C	G	1	4	5	0	0	5	0	0
24	28966873	.	C	A	2	2	4	0	0	4	0	0
24	28966892	.	T	C	4	2	6	0	0	6	0	0
24	28967704	.	G	A	2	2	4	0	0	4	0	0
24	28967982	.	T	C	1	4	5	0	0	5	0	0
24	28968098	.	C	T	2	2	4	0	0	4	0	0
24	29352703	.	T	C	1	2	3	0	0	3	0	0
24	29353048	.	C	T	4	3	7	0	1	8	0	0
24	29353340	.	T	A	1	4	5	0	0	5	0	0
24	29382153	.	T	A	10	7	17	0	0	17	0	0
24	29449847	.	C	T	6	5	11	0	1	12	0	0
24	29450222	.	C	T	8	12	20	0	0	20	0	0
24	29525169	.	T	A	14	12	26	0	4	30	0	0
24	29525262	.	T	C	12	9	21	0	1	22	0	0
24	29961798	.	C	T	1	2	3	0	3	6	0	0
24	29961833	.	A	T	4	2	6	0	1	7	0	0
24	29961857	.	C	T	4	2	6	0	1	7	0	0
24	29961883	.	G	A	3	2	5	0	0	5	0	0
24	30053987	.	C	T	0	7	7	0	9	16	0	0
24	30054257	.	A	G	13	5	18	1	1	20	0	0
24	30054404	.	G	A	5	5	10	0	0	10	0	0
24	30054812	.	G	C	6	7	13	0	1	14	0	0
24	30054835	.	A	T	5	8	13	0	3	16	0	0
24	30054857	.	A	G	8	8	16	0	1	17	0	0
24	30054898	.	G	A	12	10	22	0	0	22	0	0
24	30054947	.	C	T	16	12	28	0	1	29	0	0
24	30054980	.	T	G	12	8	20	0	0	20	0	0
24	30056786	.	C	T	5	3	8	0	2	10	0	0
24	30067126	.	C	T	9	5	14	1	1	16	0	0
24	30082868	.	A	G	8	5	13	0	1	14	0	0
24	30082884	.	A	G	7	5	12	0	0	12	0	0
24	30082929	.	A	G	4	6	10	0	0	10	0	0
24	30182343	.	T	G	3	0	3	0	4	7	0	0
24	30258239	.	G	A	1	2	3	0	0	3	0	0
24	30350077	.	T	G	6	6	12	0	0	12	0	0
24	30352234	.	C	T	10	6	16	0	0	16	0	0
24	30352276	.	T	C	11	6	17	0	0	17	0	0
24	30352907	.	T	C	16	15	31	0	1	32	0	0
24	30352940	.	T	A	21	14	35	0	2	37	0	0
24	30353036	.	T	A	22	11	33	0	1	34	0	0
24	30353065	.	G	A	17	15	32	0	1	33	0	0
24	30353083	.	G	A	16	16	32	0	1	33	0	0
24	30353298	.	A	G	9	15	24	0	0	24	0	0
24	30353447	.	T	C	14	9	23	0	0	23	0	0
24	30353683	.	A	G	13	9	22	0	0	22	0	0
24	30353825	.	A	G	8	0	8	0	11	19	0	0
24	30353893	.	C	A	16	8	24	0	0	24	0	0
24	30353918	.	C	T	12	5	17	0	0	17	0	0
24	30736883	.	G	A	2	2	4	0	0	4	0	0
24	30768908	.	A	C	2	2	4	0	0	4	0	0
24	30768909	.	G	C	2	2	4	0	0	4	0	0
24	30835934	.	T	C	9	4	13	0	1	14	0	0
24	30835936	.	A	G	9	4	13	0	1	14	0	0
24	30835992	.	G	T	9	8	17	0	2	19	0	0
24	30836132	.	A	G	8	4	12	0	0	12	0	0
24	30837512	.	A	G	6	13	19	0	1	20	0	0
24	30837682	.	G	C	10	10	20	0	1	21	0	0
24	30845845	.	G	A	4	4	8	0	1	9	0	0
24	30845875	.	G	C	2	0	2	0	2	4	0	0
24	30855344	.	C	T	0	2	2	0	4	6	0	0
24	30855507	.	A	G	5	2	7	0	0	7	0	0
24	30862080	.	A	T	1	4	5	0	0	5	0	0
24	31082078	.	A	G	3	7	10	0	0	10	0	0
24	31082432	.	G	T	10	10	20	0	1	21	0	0
24	31082758	.	A	T	3	8	11	0	0	11	0	0
24	31082774	.	C	A	3	7	10	0	0	10	0	0
24	31092530	.	T	G	8	14	22	0	0	22	0	0
24	31098564	.	A	C	10	8	18	1	0	19	0	0
24	31098655	.	C	A	16	12	28	0	1	29	0	0
24	31098820	.	A	G	11	7	18	0	0	18	0	0
24	31116765	.	T	C	5	2	7	0	0	7	0	0
24	31170701	.	C	T	1	7	8	0	5	13	0	0
24	31170921	.	A	G	3	6	9	0	1	10	0	0
24	31176087	.	A	G	2	6	8	0	0	8	0	0
24	31290487	.	A	C	2	2	4	0	0	4	0	0
24	31311080	.	A	C	14	12	26	0	1	27	0	0
24	31311323	.	C	G	0	6	6	0	7	13	0	0
24	31311334	.	G	C	7	5	12	0	0	12	0	0
24	31313234	.	G	A	12	6	18	0	3	21	0	0
24	31319592	.	C	T	2	2	4	0	8	12	0	0
24	31320049	.	G	A	3	7	10	0	0	10	0	0
24	31322911	.	G	C	6	0	6	0	7	13	0	0
24	31322950	.	T	G	3	6	9	0	1	10	0	0
24	31323142	.	C	T	4	8	12	0	1	13	0	0
24	31325202	.	T	C	4	3	7	0	0	7	0	0
24	31329983	.	C	G	0	9	9	0	4	13	0	0
24	31334313	.	A	G	20	17	37	0	3	40	0	0
24	31340673	.	T	C	31	34	65	0	1	66	0	0
24	31340819	.	A	T	29	24	53	0	4	57	0	0
24	31342846	.	G	C	2	3	5	0	0	5	0	0
24	31342855	.	G	A	1	2	3	0	0	3	0	0
24	31346647	.	G	T	23	14	37	0	0	37	0	0
24	31364567	.	G	A	6	4	10	0	0	10	0	0
24	31367491	.	A	G	7	4	11	0	1	12	0	0
24	31367851	.	G	A	7	2	9	0	0	9	0	0
24	31367891	.	C	T	2	5	7	0	0	7	0	0
24	31367999	.	A	G	6	8	14	0	0	14	0	0
24	31368370	.	A	T	1	4	5	0	0	5	0	0
24	31368390	.	T	A	2	5	7	0	0	7	0	0
24	31374494	.	T	C	3	3	6	0	0	6	0	0
24	31379444	.	A	C	3	5	8	0	0	8	0	0
24	31390756	.	G	A	0	3	3	0	5	8	0	0
24	31393945	.	T	C	5	5	10	0	0	10	0	0
24	31393957	.	A	T	5	3	8	0	1	9	0	0
24	31397840	.	G	A	5	6	11	0	0	11	0	0
24	31402318	.	A	G	1	2	3	0	0	3	0	0
24	31832549	.	G	A	10	13	23	0	0	23	0	0
24	31832615	.	T	G	12	3	15	0	0	16	1	0
24	31832657	.	G	A	9	10	19	0	1	20	0	0
24	31832833	.	T	G	5	2	7	0	0	7	0	0
24	31832970	.	C	T	7	2	9	0	1	10	0	0
24	31833114	.	A	T	6	12	18	0	1	19	0	0
24	31833991	.	G	A	6	12	18	1	2	21	0	0
24	31834286	.	A	G	6	10	16	0	1	17	0	0
24	31834396	.	G	A	7	7	14	0	0	14	0	0
24	31834681	.	A	T	10	7	17	0	0	17	0	0
24	31836483	.	A	T	13	9	22	0	2	24	0	0
24	31838995	.	C	A	6	6	12	0	3	15	0	0
24	31839067	.	G	A	4	4	8	0	0	8	0	0
24	31842739	.	C	T	6	8	14	0	0	14	0	0
24	31846257	.	C	T	3	8	11	0	0	11	0	0
24	31853381	.	C	T	2	2	4	0	0	4	0	0
24	31853438	.	C	T	1	3	4	0	0	4	0	0
24	31942105	.	T	G	5	3	8	2	1	11	0	0
24	32152821	.	C	A	2	1	3	0	1	4	0	0
24	32152862	.	A	G	2	2	4	0	2	6	0	0
24	32163890	.	C	T	4	2	6	0	2	8	0	0
24	32163896	.	C	A	0	4	4	0	4	8	0	0
24	32173200	.	A	T	3	4	7	0	0	7	0	0
24	32173251	.	A	G	1	7	8	0	0	8	0	0
24	32173646	.	A	G	2	6	8	0	0	8	0	0
24	32176448	.	C	T	13	19	32	0	0	32	0	0
24	32176716	.	G	C	23	20	43	0	2	45	0	0
24	32184363	.	C	T	20	17	37	0	1	38	0	0
24	32184379	.	C	A	26	14	40	0	4	45	1	0
24	32187534	.	G	A	33	17	50	0	4	54	0	0
24	32192622	.	T	C	19	7	26	0	0	26	0	0
24	32406971	.	C	T	6	3	9	0	0	9	0	0
24	32418818	.	G	A	1	4	5	0	0	5	0	0
24	32472919	.	T	C	6	4	10	0	0	10	0	0
24	32473291	.	C	T	9	12	21	0	0	21	0	0
24	32473326	.	C	G	9	0	9	0	12	21	0	0
24	32473386	.	C	T	21	5	26	0	2	28	0	0
24	32473464	.	T	C	5	9	14	0	0	14	0	0
24	32473597	.	G	A	0	8	8	0	8	16	0	0
24	32473829	.	A	G	4	11	15	0	0	15	0	0
24	32474070	.	G	C	2	3	5	0	0	5	0	0
24	32474198	.	T	G	5	8	13	0	1	14	0	0
24	32474229	.	T	A	4	6	10	0	0	10	0	0
24	32474360	.	A	G	6	7	13	0	1	14	0	0
24	32474439	.	A	T	5	6	11	0	0	11	0	0
24	32474442	.	A	T	5	8	13	0	0	13	0	0
24	32474546	.	A	C	9	7	16	0	2	18	0	0
24	32517984	.	G	A	12	10	22	0	0	22	0	0
24	32519471	.	G	A	20	30	50	0	2	52	0	0
24	32519528	.	C	T	1	27	28	0	19	47	0	0
24	32522462	.	T	A	28	19	47	0	2	49	0	0
24	32522577	.	A	T	8	8	16	0	1	17	0	0
24	32530539	.	A	G	2	5	7	0	0	7	0	0
24	32533395	.	T	A	2	3	5	0	0	5	0	0
24	32534789	.	C	T	1	2	3	0	0	3	0	0
24	32534867	.	C	T	7	3	10	0	1	11	0	0
24	32547959	.	A	T	5	2	7	0	0	7	0	0
24	32650263	.	T	G	11	8	19	0	1	20	0	0
24	32658577	.	C	T	14	14	28	0	0	28	0	0
24	32664790	.	A	T	8	10	18	0	2	20	0	0
24	32664823	.	T	G	7	13	20	0	2	22	0	0
24	32668834	.	G	A	7	8	15	0	0	15	0	0
24	32668880	.	T	A	10	12	22	0	0	22	0	0
24	32674708	.	C	T	6	11	17	0	0	17	0	0
24	32674960	.	T	A	1	4	5	0	0	5	0	0
24	33228611	.	A	G	11	10	21	0	0	21	0	0
24	33228620	.	C	T	10	9	19	0	1	20	0	0
24	33234934	.	T	C	6	2	8	0	8	16	0	0
24	33280061	.	C	T	7	4	11	0	0	11	0	0
24	33283197	.	G	A	13	5	18	0	0	18	0	0
24	33284689	.	G	A	11	6	17	0	1	18	0	0
24	33284915	.	A	G	3	2	5	0	0	5	0	0
24	33289036	.	A	C	3	3	6	0	0	6	0	0
24	33289043	.	C	T	3	2	5	0	0	5	0	0
24	33290278	.	G	A	6	2	8	0	0	8	0	0
24	33290618	.	T	G	9	3	12	0	0	12	0	0
24	33291656	.	C	G	10	3	13	0	0	13	0	0
24	33291690	.	C	A	0	2	2	0	6	8	0	0
24	33400863	.	C	T	2	3	5	0	0	5	0	0
24	33401158	.	C	T	8	6	14	0	0	14	0	0
24	33402901	.	G	A	3	5	8	0	1	9	0	0
24	33403196	.	A	G	4	0	4	0	5	9	0	0
24	33403328	.	G	A	0	2	2	0	2	4	0	0
24	33410992	.	G	A	4	3	7	0	0	7	0	0
24	33411157	.	A	C	5	4	9	0	1	10	0	0
24	33836696	.	A	G	3	3	6	0	0	6	0	0
24	33837790	.	A	G	6	9	15	0	0	15	0	0
24	33837914	.	A	G	3	5	8	0	0	8	0	0
24	33837916	.	A	G	4	4	8	0	0	8	0	0
24	33838023	.	A	G	7	2	9	0	0	9	0	0
24	33838549	.	A	G	11	3	14	0	0	14	0	0
24	34607240	.	C	T	7	8	15	0	1	16	0	0
24	34607282	.	C	G	7	10	17	0	1	18	0	0
24	34607366	.	C	A	8	3	11	0	0	11	0	0
24	34608653	.	C	T	14	7	21	0	1	22	0	0
24	34608844	.	C	T	6	12	18	0	0	18	0	0
24	34610158	.	A	G	11	0	11	0	17	28	0	0
24	34610215	.	G	T	2	11	13	0	10	23	0	0
24	34610515	.	G	A	16	11	27	0	1	28	0	0
24	34610655	.	G	A	1	11	12	0	9	21	0	0
24	34610874	.	A	G	16	12	28	0	0	28	0	0
24	34610920	.	A	T	9	15	24	0	2	27	1	0
24	34611151	.	T	C	19	12	31	0	0	31	0	0
24	34611211	.	G	A	19	14	33	0	3	36	0	0
24	34611236	.	G	A	3	14	17	0	18	35	0	0
24	34611378	.	G	T	22	18	40	0	1	41	0	0
24	34611407	.	G	C	20	16	36	0	2	38	0	0
24	34611445	.	A	G	13	17	30	0	1	31	0	0
24	34611536	.	G	A	11	15	26	0	0	26	0	0
24	34611623	.	A	G	13	14	27	0	0	27	0	0
24	34611681	.	C	T	10	19	29	0	0	29	0	0
24	34611757	.	T	G	10	7	17	1	3	21	0	0
24	34611915	.	A	G	10	0	10	0	13	23	0	0
24	34612187	.	C	A	14	8	22	0	1	23	0	0
24	34612317	.	G	A	17	23	40	0	1	41	0	0
24	34612327	.	A	T	21	18	39	0	0	39	0	0
24	34973991	.	C	T	9	4	13	0	1	14	0	0
24	34974022	.	C	A	6	9	15	0	0	15	0	0
24	34974105	.	C	T	9	8	17	0	0	17	0	0
24	34976187	.	A	G	6	0	6	0	6	12	0	0
24	34976349	.	T	C	4	6	10	0	0	10	0	0
24	34976465	.	G	A	6	4	10	0	0	10	0	0
24	34979444	.	T	C	7	8	15	0	0	15	0	0
24	34991185	.	A	G	7	14	21	0	0	21	0	0
24	34993400	.	A	G	19	14	33	0	0	33	0	0
24	34993406	.	T	C	19	13	32	0	0	32	0	0
24	34996173	.	C	T	12	9	21	0	0	21	0	0
24	35000961	.	G	T	0	13	13	0	23	36	0	0
24	35002871	.	G	A	13	7	20	0	2	22	0	0
24	35196166	.	C	T	10	15	25	1	2	28	0	0
24	35196205	.	C	G	7	11	18	1	2	21	0	0
24	35213755	.	T	C	20	16	36	0	0	36	0	0
24	35213764	.	G	A	5	17	22	0	16	38	0	0
24	35216439	.	A	T	24	17	41	0	6	47	0	0
24	35216541	.	C	T	28	20	48	0	1	49	0	0
24	35216835	.	A	G	16	11	27	1	2	30	0	0
24	35217255	.	G	A	15	10	25	0	0	25	0	0
24	35217258	.	C	G	15	9	24	0	1	25	0	0
24	35217302	.	T	G	8	11	19	1	0	20	0	0
24	35218228	.	G	A	2	2	4	0	2	6	0	0
24	35269876	.	T	C	3	2	5	0	1	6	0	0
24	35272469	.	G	A	3	4	7	0	1	8	0	0
24	35393162	.	C	T	5	3	8	0	0	8	0	0
24	35393178	.	A	C	2	3	5	0	0	5	0	0
24	35536833	.	T	C	2	1	3	0	0	3	0	0
24	35720364	.	G	A	4	4	8	0	0	8	0	0
24	35726377	.	A	G	3	5	8	0	0	8	0	0
24	35767462	.	C	T	2	3	5	0	1	6	0	0
24	36364292	.	A	G	4	1	5	0	2	7	0	0
24	37604311	.	G	T	3	4	7	0	0	7	0	0
24	37623247	.	A	C	5	3	8	0	0	8	0	0
24	37631842	.	G	A	3	4	7	1	1	9	0	0
24	37636887	.	G	A	1	2	3	0	0	3	0	0
24	37649768	.	C	G	3	4	7	0	0	7	0	0
24	37649810	.	T	C	4	3	7	0	0	7	0	0
24	37650077	.	C	T	1	3	4	0	0	4	0	0
24	37664505	.	G	A	4	2	6	0	0	6	0	0
24	37664506	.	T	C	5	2	7	0	0	7	0	0
24	37668208	.	T	C	1	2	3	0	0	3	0	0
24	37681556	.	G	T	5	4	9	0	0	9	0	0
24	37685925	.	C	T	5	8	13	0	0	13	0	0
24	37685942	.	C	T	0	4	4	0	8	12	0	0
24	37686132	.	C	T	4	3	7	0	0	7	0	0
24	37689919	.	T	C	27	32	59	0	3	62	0	0
24	37692529	.	G	A	34	27	61	0	1	62	0	0
24	37695870	.	C	T	0	2	2	0	4	6	0	0
24	37696274	.	A	G	3	2	5	0	0	5	0	0
24	37696508	.	T	C	5	6	11	0	0	11	0	0
24	37704287	.	G	C	6	6	12	0	0	12	0	0
24	37708017	.	T	C	3	8	11	0	0	11	0	0
24	37708207	.	T	A	3	5	8	0	0	8	0	0
24	37708288	.	A	C	2	4	6	0	0	6	0	0
24	37718892	.	C	T	1	2	3	0	0	3	0	0
24	37721298	.	T	G	5	2	7	0	1	8	0	0
24	37722245	.	T	C	2	2	4	0	0	4	0	0
24	37723056	.	G	A	5	2	7	0	0	7	0	0
24	37723096	.	G	A	2	5	7	0	0	7	0	0
24	37723133	.	G	A	4	2	6	0	1	7	0	0
24	37723173	.	A	T	3	3	6	0	0	6	0	0
24	37723950	.	C	A	3	4	7	0	0	7	0	0
24	37724045	.	A	T	3	7	10	0	0	10	0	0
24	37724175	.	A	G	5	4	9	0	0	9	0	0
24	37724206	.	T	C	3	4	7	0	0	7	0	0
24	37724700	.	A	C	2	3	5	0	1	6	0	0
24	37725117	.	T	C	4	6	10	0	0	10	0	0
24	37725179	.	T	A	4	3	7	0	0	7	0	0
24	37725817	.	G	A	5	3	8	1	0	9	0	0
24	37725860	.	T	G	6	3	9	1	0	10	0	0
24	37726004	.	G	A	2	5	7	0	0	7	0	0
24	37726188	.	C	A	10	3	13	0	3	16	0	0
24	37726198	.	T	C	7	9	16	0	1	17	0	0
24	37726377	.	A	G	3	5	8	0	0	8	0	0
24	37726649	.	G	A	0	3	3	0	7	10	0	0
24	37726867	.	C	G	3	3	6	0	2	8	0	0
24	37726991	.	C	T	12	4	16	0	0	16	0	0
24	37726997	.	G	A	3	11	14	0	0	14	0	0
24	37746094	.	G	A	2	11	13	0	8	21	0	0
24	37752430	.	C	T	8	8	16	0	0	16	0	0
24	37767074	.	G	C	3	6	9	0	0	9	0	0
24	37774244	.	C	T	7	5	12	0	0	12	0	0
24	37781428	.	G	A	8	7	15	0	0	15	0	0
24	37781446	.	C	T	9	8	17	0	1	18	0	0
24	37791099	.	C	T	6	10	16	0	2	18	0	0
24	37793276	.	C	A	6	7	13	0	3	16	0	0
24	37793282	.	C	T	6	10	16	0	0	16	0	0
24	37793315	.	C	T	6	14	20	0	0	20	0	0
24	37793725	.	C	T	6	6	12	0	0	12	0	0
24	37800433	.	C	T	6	4	10	0	0	10	0	0
24	37802119	.	T	G	2	0	2	0	4	6	0	0
24	37816405	.	C	T	4	2	6	0	0	6	0	0
24	37823329	.	T	C	2	4	6	0	0	6	0	0
24	37833539	.	G	T	0	2	2	0	2	4	0	0
24	37836280	.	C	G	1	5	6	0	0	6	0	0
24	37888518	.	C	T	1	2	3	0	1	4	0	0
24	37893391	.	A	T	2	2	4	0	1	5	0	0
24	37896875	.	C	T	3	4	7	0	0	7	0	0
24	37897208	.	G	C	13	4	17	0	0	17	0	0
24	37899479	.	A	T	3	4	7	0	0	7	0	0
24	37900945	.	G	A	1	2	3	0	5	8	0	0
24	37901148	.	A	G	2	2	4	0	0	4	0	0
24	37901178	.	C	T	4	2	6	0	1	7	0	0
24	37919753	.	T	G	2	3	5	0	0	5	0	0
24	37920923	.	G	A	1	2	3	0	0	3	0	0
24	37941922	.	A	C	15	5	20	1	1	22	0	0
24	37942032	.	C	T	9	10	19	0	2	21	0	0
24	37942183	.	A	T	12	4	16	1	0	17	0	0
24	37942423	.	G	A	6	2	8	0	0	8	0	0
24	37942559	.	C	T	2	12	14	0	0	14	0	0
24	37942664	.	T	C	5	4	9	0	1	10	0	0
24	37942726	.	C	A	1	4	5	0	0	5	0	0
24	37943052	.	A	G	5	3	8	0	0	8	0	0
24	37943664	.	G	C	5	2	7	0	0	7	0	0
24	37943666	.	T	C	6	2	8	0	0	8	0	0
24	37943725	.	A	C	5	5	10	0	0	10	0	0
24	37952667	.	C	T	4	2	6	0	0	6	0	0
24	37952719	.	T	C	2	0	2	0	2	4	0	0
24	37955965	.	C	T	0	4	4	0	3	7	0	0
24	38073247	.	A	G	23	14	37	0	3	40	0	0
24	38073271	.	G	A	20	22	42	0	3	45	0	0
24	38073625	.	A	G	14	16	30	0	4	34	0	0
24	38073712	.	C	T	19	22	41	0	1	42	0	0
24	38073754	.	A	C	22	24	46	0	1	47	0	0
24	38159480	.	A	T	1	1	2	0	1	3	0	0
24	38171235	.	C	A	1	2	3	0	0	3	0	0
24	38174887	.	T	A	1	3	4	0	0	4	0	0
24	38179968	.	G	A	2	3	5	0	1	6	0	0
24	38180047	.	A	G	2	0	2	0	2	4	0	0
24	38180086	.	T	G	1	0	1	0	2	3	0	0
24	38189702	.	A	C	4	5	9	0	0	9	0	0
24	38190121	.	A	G	2	2	4	0	0	4	0	0
24	38190199	.	A	G	2	3	5	0	1	6	0	0
24	38190201	.	C	T	3	3	6	0	0	6	0	0
24	38190387	.	T	C	4	1	5	0	0	5	0	0
24	38190396	.	A	C	5	3	8	0	0	8	0	0
24	38190594	.	G	T	0	4	4	0	5	9	0	0
24	38190606	.	A	T	3	4	7	0	1	8	0	0
24	38190768	.	G	A	2	3	5	0	0	5	0	0
24	38190868	.	A	G	2	3	5	0	0	5	0	0
24	38190894	.	G	A	2	4	6	0	0	6	0	0
24	38190968	.	A	T	6	5	11	0	1	12	0	0
24	38191015	.	T	C	5	4	9	0	0	9	0	0
24	38191042	.	C	T	4	3	7	0	0	7	0	0
24	38191227	.	A	T	2	2	4	0	0	4	0	0
24	38191537	.	C	T	6	2	8	0	1	9	0	0
24	38191590	.	T	C	2	2	4	0	0	4	0	0
24	38191643	.	A	G	2	4	6	0	0	6	0	0
24	38191652	.	A	T	4	3	7	0	0	7	0	0
24	38369559	.	T	A	14	19	33	0	2	35	0	0
24	38369873	.	G	A	24	20	44	0	1	45	0	0
24	38370188	.	A	G	20	11	31	0	1	32	0	0
24	38370245	.	C	G	0	15	15	0	21	36	0	0
24	38370443	.	C	T	2	8	10	0	16	26	0	0
24	38370998	.	A	G	13	16	29	0	1	30	0	0
24	38371178	.	A	G	12	10	22	0	1	23	0	0
24	38384245	.	A	T	5	11	16	0	1	17	0	0
24	38565405	.	G	A	1	2	3	0	0	3	0	0
24	38618980	.	G	A	2	2	4	0	0	4	0	0
24	38618992	.	G	C	3	0	3	0	2	5	0	0
24	38619275	.	T	C	2	0	2	0	2	4	0	0
24	38628464	.	T	A	2	2	4	0	0	4	0	0
24	38628465	.	C	A	0	2	2	0	2	4	0	0
24	38756179	.	C	T	0	2	2	0	2	4	0	0
24	38815524	.	G	A	6	4	10	0	1	11	0	0
24	38816010	.	G	T	7	8	15	0	0	15	0	0
24	38816340	.	T	G	4	7	11	0	1	12	0	0
24	39051126	.	C	T	4	8	12	0	2	14	0	0
24	39051210	.	C	T	3	2	5	0	2	7	0	0
24	39051803	.	A	C	4	8	12	0	0	12	0	0
24	39051981	.	G	A	1	4	5	0	10	15	0	0
24	39052200	.	C	T	9	9	18	0	1	19	0	0
24	39052236	.	G	T	1	9	10	0	5	15	0	0
24	39052302	.	G	A	8	7	15	0	1	16	0	0
24	39052311	.	C	T	8	8	16	0	1	17	0	0
24	39052410	.	C	T	2	6	8	0	0	8	0	0
24	39073885	.	G	A	0	7	7	0	7	14	0	0
24	39075534	.	T	C	4	4	8	0	0	8	0	0
24	39078597	.	A	G	7	0	7	0	5	12	0	0
24	39081150	.	C	T	4	4	8	0	0	8	0	0
24	39137015	.	C	T	10	13	23	0	0	23	0	0
24	39137027	.	G	C	7	10	17	0	0	17	0	0
24	39137777	.	G	A	0	7	7	0	11	18	0	0
24	39137785	.	G	T	10	7	17	0	0	17	0	0
24	39151989	.	A	G	19	13	32	0	1	33	0	0
24	39152001	.	A	G	14	15	29	0	2	31	0	0
24	39152523	.	A	G	3	1	4	0	1	5	0	0
24	39152798	.	A	G	13	6	19	0	3	22	0	0
24	39153010	.	C	G	14	6	20	0	1	21	0	0
24	39215207	.	G	A	4	3	7	0	1	8	0	0
24	39215213	.	T	C	4	3	7	0	0	7	0	0
24	39268891	.	A	G	13	10	23	0	1	24	0	0
24	39272041	.	A	G	4	9	13	0	4	17	0	0
24	39274821	.	A	G	9	10	19	0	3	22	0	0
24	39277575	.	C	G	7	9	16	0	0	16	0	0
24	39287210	.	A	G	10	14	24	0	4	28	0	0
24	39295664	.	T	C	9	16	25	0	2	27	0	0
24	39298214	.	C	T	13	15	28	0	0	28	0	0
24	39309684	.	A	G	14	0	14	0	23	37	0	0
24	39309889	.	A	T	16	21	37	0	3	40	0	0
24	39310129	.	G	A	12	12	24	0	0	24	0	0
24	39310163	.	G	T	14	13	27	0	0	27	0	0
24	39310253	.	C	T	15	8	23	0	0	23	0	0
24	39321017	.	T	C	25	14	39	0	1	40	0	0
24	39322945	.	G	T	2	19	21	0	24	45	0	0
24	39323791	.	C	T	22	29	51	0	1	52	0	0
24	39333916	.	C	T	17	27	44	1	2	47	0	0
24	39334153	.	T	G	15	21	36	0	1	37	0	0
24	39334388	.	A	G	22	17	39	0	3	42	0	0
24	39334681	.	G	T	11	41	52	0	1	53	0	0
24	39334796	.	G	A	0	7	7	0	19	26	0	0
24	39354752	.	G	A	1	2	3	0	0	3	0	0
24	39510791	.	T	C	0	1	1	0	3	4	0	0
24	39510812	.	T	G	1	4	5	0	1	6	0	0
24	39510891	.	T	C	6	2	8	0	1	9	0	0
24	39511016	.	T	C	5	2	7	0	0	7	0	0
24	39511157	.	G	A	8	3	11	0	0	11	0	0
24	39511298	.	A	C	2	3	5	0	1	6	0	0
24	39511477	.	C	T	1	4	5	0	0	5	0	0
24	39511509	.	A	G	4	3	7	0	0	7	0	0
24	39514075	.	A	C	5	11	16	0	2	19	1	0
24	39514296	.	C	G	4	8	12	0	2	14	0	0
24	39518554	.	C	G	1	9	10	0	8	18	0	0
24	39530034	.	G	A	1	7	8	0	7	15	0	0
24	39533337	.	A	G	6	6	12	0	0	12	0	0
24	39533987	.	T	A	6	8	14	0	0	14	0	0
24	39537605	.	C	T	3	7	10	0	0	10	0	0
24	39544398	.	G	A	1	4	5	0	0	5	0	0
24	39549379	.	C	T	4	5	9	0	1	10	0	0
24	39549427	.	A	G	5	0	5	0	5	10	0	0
24	39556276	.	G	T	0	5	5	0	3	8	0	0
24	39556324	.	G	A	4	2	6	0	1	7	0	0
24	39556716	.	C	G	4	2	6	0	0	6	0	0
24	39559345	.	A	G	6	0	6	0	4	10	0	0
24	39559356	.	C	T	7	4	11	0	1	12	0	0
24	39559386	.	G	A	5	7	12	0	1	13	0	0
24	39576071	.	A	T	4	4	8	0	1	9	0	0
24	39576166	.	G	A	0	2	2	0	4	6	0	0
24	39576247	.	C	T	2	4	6	0	0	6	0	0
24	39576414	.	C	T	10	6	16	0	0	16	0	0
24	39579443	.	C	T	6	4	10	0	1	11	0	0
24	39579569	.	G	A	6	3	9	0	0	9	0	0
24	39579730	.	A	G	4	5	9	0	0	9	0	0
24	39579989	.	G	A	1	11	12	0	7	19	0	0
24	39586778	.	A	T	5	8	13	0	1	14	0	0
24	39593009	.	T	C	3	6	9	0	0	9	0	0
24	39593038	.	G	A	0	4	4	0	5	9	0	0
24	39595866	.	A	C	5	5	10	0	0	10	0	0
24	39606237	.	G	A	18	18	36	2	2	40	0	0
24	39610535	.	G	T	17	10	27	0	1	28	0	0
24	39614915	.	A	G	1	3	4	0	0	4	0	0
24	39614940	.	T	G	1	3	4	0	0	4	0	0
24	39614963	.	G	A	0	5	5	0	0	5	0	0
24	39616007	.	T	A	2	2	4	0	2	6	0	0
24	39616348	.	A	T	2	2	4	0	0	4	0	0
24	39625539	.	T	C	4	2	6	0	0	6	0	0
24	39628474	.	G	A	1	4	5	0	0	5	0	0
24	39628788	.	C	T	0	3	3	0	1	4	0	0
24	39638642	.	G	A	20	21	41	0	2	43	0	0
24	39642072	.	A	T	10	9	19	1	1	21	0	0
24	39642220	.	A	G	14	4	18	0	1	19	0	0
24	39642229	.	A	G	14	7	21	0	0	21	0	0
24	39642336	.	C	A	11	8	19	0	0	19	0	0
24	39642361	.	G	T	13	11	24	0	0	24	0	0
24	39644259	.	T	C	20	13	33	0	3	36	0	0
24	39646762	.	C	T	18	20	38	0	1	39	0	0
24	39647021	.	C	T	34	15	49	0	2	51	0	0
24	39647042	.	G	C	16	29	45	0	1	46	0	0
24	39648806	.	C	T	24	25	49	0	0	49	0	0
24	39651567	.	T	G	21	30	51	0	4	55	0	0
24	39651612	.	A	T	22	29	51	0	1	52	0	0
24	39653626	.	G	A	26	15	41	18	7	66	0	0
24	39660219	.	C	T	18	12	30	0	0	30	0	0
24	39661890	.	T	A	8	17	25	0	2	27	0	0
24	39661905	.	C	T	11	12	23	0	1	24	0	0
24	39662074	.	T	C	16	13	29	0	1	30	0	0
24	39663197	.	A	G	12	16	28	0	1	29	0	0
24	39667154	.	A	T	14	16	30	1	2	33	0	0
24	39667348	.	T	C	12	9	21	3	0	24	0	0
24	39742273	.	G	A	4	7	11	0	0	11	0	0
24	39742336	.	G	A	6	5	11	0	0	11	0	0
24	39742396	.	G	A	3	7	10	0	0	10	0	0
24	39742786	.	T	A	12	10	22	0	0	22	0	0
24	39742869	.	G	T	10	7	17	0	0	17	0	0
24	39771659	.	G	T	8	5	13	0	2	15	0	0
24	39771864	.	T	C	2	2	4	0	0	4	0	0
24	39771976	.	G	A	4	6	10	0	0	10	0	0
24	39771983	.	A	G	4	7	11	0	1	12	0	0
24	39779020	.	C	T	1	2	3	0	1	4	0	0
24	39779108	.	G	T	4	2	6	0	1	7	0	0
24	39781817	.	T	C	2	4	6	0	0	6	0	0
24	39787653	.	G	C	5	0	5	0	3	8	0	0
24	40498708	.	G	A	7	3	10	0	0	10	0	0
24	40498712	.	C	A	6	3	9	0	1	10	0	0
24	40500264	.	A	G	3	0	3	0	5	8	0	0
24	40608954	.	C	T	13	12	25	0	0	25	0	0
24	40608962	.	G	T	12	11	23	0	1	24	0	0
24	40609001	.	A	G	8	15	23	0	3	26	0	0
24	40624408	.	T	C	19	14	33	0	5	38	0	0
24	40633168	.	T	C	5	7	12	5	1	18	0	0
24	40648270	.	C	T	21	17	38	1	0	39	0	0
24	40648284	.	T	A	20	18	38	1	0	39	0	0
24	40876839	.	G	A	1	2	3	5	0	8	0	0
24	40876873	.	G	T	2	2	4	0	0	4	0	0
24	40881213	.	T	C	4	0	4	2	4	10	0	0
24	40881240	.	T	A	5	6	11	1	1	13	0	0
24	40892759	.	C	T	0	3	3	1	4	8	0	0
24	41246800	.	G	A	4	4	8	0	0	8	0	0
24	41259381	.	C	G	0	3	3	0	3	6	0	0
24	41273330	.	A	G	3	1	4	0	6	10	0	0
24	41281276	.	T	G	3	1	4	1	7	12	0	0
24	41281297	.	T	C	2	7	9	1	0	10	0	0
24	41290602	.	G	A	0	2	2	0	10	12	0	0
24	41290604	.	G	A	10	2	12	0	0	12	0	0
24	41290712	.	C	T	3	11	14	0	0	14	0	0
24	41293409	.	G	A	9	7	16	1	0	17	0	0
24	41317090	.	A	T	20	9	29	0	5	34	0	0
24	41317132	.	G	A	13	12	25	1	0	26	0	0
24	41317350	.	G	C	8	3	11	0	19	30	0	0
24	41473576	.	T	C	16	0	16	0	5	21	0	0
24	41478831	.	C	T	12	12	24	0	0	24	0	0
24	41560116	.	G	C	6	5	11	0	0	11	0	0
24	41560146	.	G	A	6	5	11	0	1	12	0	0
24	41747414	.	C	T	3	3	6	0	0	6	0	0
24	41756978	.	C	T	1	2	3	0	0	3	0	0
24	41757941	.	C	A	2	3	5	0	0	5	0	0
24	41764121	.	G	A	0	4	4	0	3	7	0	0
24	41764572	.	A	G	2	3	5	0	2	7	0	0
24	41770645	.	A	G	1	0	1	0	2	3	0	0
24	41773216	.	G	C	0	4	4	0	5	9	0	0
24	41773287	.	A	T	3	3	6	0	0	6	0	0
24	41773318	.	C	T	8	3	11	0	0	11	0	0
24	41781968	.	C	T	4	7	11	0	0	11	0	0
24	41783906	.	G	A	1	4	5	0	6	11	0	0
24	41783999	.	C	T	5	7	12	0	1	13	0	0
24	41786304	.	G	A	3	4	7	0	0	7	0	0
24	41791707	.	A	G	1	3	4	0	0	4	0	0
24	41796777	.	G	A	5	4	9	0	0	9	0	0
24	41797346	.	G	A	3	3	6	0	0	6	0	0
24	41916447	.	G	T	4	9	13	0	1	14	0	0
24	41916584	.	G	A	9	10	19	0	0	19	0	0
24	41916677	.	A	G	9	0	9	0	7	16	0	0
24	41916887	.	G	A	13	9	22	0	1	23	0	0
24	41917543	.	T	C	4	9	13	0	0	13	0	0
24	41953649	.	T	G	26	26	52	0	0	52	0	0
24	41954745	.	A	G	9	1	10	0	14	24	0	0
24	41954764	.	A	C	11	11	22	0	2	24	0	0
24	41954781	.	C	T	11	11	22	0	0	22	0	0
24	41964613	.	A	C	22	14	36	0	1	37	0	0
24	41965111	.	G	A	20	13	33	0	0	33	0	0
24	41965147	.	T	C	12	11	23	0	3	26	0	0
24	41969781	.	C	A	15	19	34	0	6	40	0	0
24	41972519	.	A	G	25	14	39	0	1	40	0	0
24	41972633	.	C	G	13	2	15	0	25	40	0	0
24	41972638	.	A	T	14	23	37	0	2	39	0	0
24	41974769	.	C	T	18	20	38	0	0	38	0	0
24	41981865	.	A	G	22	21	43	0	2	45	0	0
24	41986626	.	G	C	1	14	15	0	13	28	0	0
24	41986704	.	C	T	18	18	36	0	0	36	0	0
24	41989196	.	A	C	3	3	6	0	1	7	0	0
24	41989416	.	C	G	4	5	9	0	0	9	0	0
24	41989455	.	C	T	3	5	8	0	0	8	0	0
24	41990626	.	A	T	9	10	19	0	0	19	0	0
24	41990821	.	G	A	0	8	8	0	11	19	0	0
24	41994096	.	G	A	5	10	15	0	2	17	0	0
24	41994147	.	G	T	8	10	18	0	0	18	0	0
24	42007885	.	C	T	2	4	6	0	0	6	0	0
24	42007900	.	G	A	0	2	2	0	3	5	0	0
24	42008582	.	G	A	0	4	4	0	2	6	0	0
24	42061423	.	G	T	4	11	15	0	1	16	0	0
24	42061426	.	G	A	4	11	15	0	1	16	0	0
24	42061460	.	A	G	4	7	11	0	0	11	0	0
24	42083876	.	A	G	19	13	32	0	0	32	0	0
24	42133270	.	G	A	3	18	21	1	5	27	0	0
24	42133646	.	C	T	11	12	23	6	0	29	0	0
24	42138533	.	A	G	24	1	25	0	14	39	0	0
24	42141605	.	G	A	14	15	29	0	0	29	0	0
24	42141770	.	T	C	15	6	21	0	0	21	0	0
24	42153241	.	A	G	16	6	22	0	2	24	0	0
24	42155187	.	T	C	15	12	27	0	2	29	0	0
25	13978	.	C	T	9	13	22	0	1	23	0	0
25	14101	.	C	T	6	10	16	0	2	18	0	0
25	15467	.	C	T	11	20	31	0	0	31	0	0
25	15524	.	C	T	15	7	22	0	0	22	0	0
25	15542	.	T	C	16	7	23	0	1	24	0	0
25	15704	.	C	T	16	21	37	0	0	37	0	0
25	15764	.	A	G	12	0	12	0	17	29	0	0
25	127683	.	T	G	8	0	8	0	7	15	0	0
25	127734	.	A	G	6	4	10	0	0	10	0	0
25	127786	.	A	G	4	0	4	0	10	14	0	0
25	136857	.	C	T	25	14	39	0	0	39	0	0
25	136986	.	C	T	17	15	32	0	4	36	0	0
25	146198	.	C	T	17	27	44	0	2	46	0	0
25	146237	.	G	A	22	15	37	0	2	39	0	0
25	146282	.	C	T	19	18	37	0	1	38	0	0
25	146778	.	C	T	22	26	48	0	2	50	0	0
25	146918	.	G	A	18	27	45	0	3	48	0	0
25	154392	.	T	C	12	14	26	0	0	26	0	0
25	156522	.	C	T	9	6	15	0	0	15	0	0
25	156608	.	C	T	5	9	14	0	0	14	0	0
25	157151	.	T	C	9	7	16	0	0	16	0	0
25	157389	.	T	C	10	7	17	0	0	17	0	0
25	157404	.	C	A	7	10	17	0	0	17	0	0
25	157996	.	C	A	11	12	23	0	1	24	0	0
25	158641	.	T	C	12	11	23	0	2	25	0	0
25	158770	.	C	T	13	16	29	0	0	29	0	0
25	158958	.	C	T	14	6	20	0	2	22	0	0
25	159543	.	T	C	13	17	30	0	0	30	0	0
25	160490	.	C	T	10	18	28	0	3	31	0	0
25	187121	.	G	A	0	8	8	0	6	14	0	0
25	187241	.	T	G	4	5	9	0	0	9	0	0
25	236835	.	G	A	7	5	12	0	0	12	0	0
25	241694	.	C	T	6	5	11	0	0	11	0	0
25	241695	.	A	G	5	5	10	0	1	11	0	0
25	244115	.	C	T	5	10	15	0	1	16	0	0
25	244305	.	G	C	2	3	5	0	0	5	0	0
25	265570	.	A	G	2	2	4	0	0	4	0	0
25	267138	.	T	C	2	0	2	0	3	5	0	0
25	267153	.	G	A	2	4	6	0	0	6	0	0
25	267219	.	G	A	2	3	5	0	0	5	0	0
25	267224	.	A	C	2	0	2	0	2	4	0	0
25	269108	.	C	G	2	3	5	0	0	5	0	0
25	269134	.	A	C	1	0	1	0	3	4	0	0
25	314758	.	T	A	2	4	6	0	0	6	0	0
25	314781	.	A	T	3	3	6	0	0	6	0	0
25	315124	.	G	C	1	5	6	0	0	6	0	0
25	315157	.	C	T	1	3	4	0	1	5	0	0
25	315364	.	A	G	2	2	4	0	0	4	0	0
25	315373	.	G	T	2	2	4	0	0	4	0	0
25	315401	.	C	G	3	3	6	0	1	7	0	0
25	317160	.	T	C	1	2	3	0	0	3	0	0
25	317567	.	T	C	2	0	2	0	2	4	0	0
25	325130	.	G	T	1	2	3	0	0	3	0	0
25	388320	.	C	A	3	2	5	0	1	6	0	0
25	398433	.	T	C	4	8	12	0	0	12	0	0
25	399735	.	C	T	8	7	15	0	0	15	0	0
25	401810	.	T	C	5	5	10	0	1	11	0	0
25	402152	.	T	C	12	5	17	0	1	18	0	0
25	402186	.	C	A	5	13	18	0	0	18	0	0
25	402224	.	A	T	10	5	15	0	0	15	0	0
25	402348	.	G	A	1	8	9	0	4	13	0	0
25	402359	.	T	G	5	0	5	0	8	13	0	0
25	403935	.	T	G	7	6	13	0	1	14	0	0
25	450354	.	C	T	7	10	17	1	3	21	0	0
25	469932	.	G	T	36	29	65	0	3	68	0	0
25	469983	.	C	T	26	31	57	0	3	60	0	0
25	472843	.	A	T	35	25	60	0	4	64	0	0
25	474766	.	G	C	26	32	58	0	2	60	0	0
25	474938	.	T	A	20	22	42	0	2	44	0	0
25	474981	.	A	C	30	21	51	0	1	52	0	0
25	474983	.	A	C	23	28	51	0	0	51	0	0
25	485653	.	A	G	22	16	38	0	4	42	0	0
25	485772	.	C	A	15	10	25	0	2	27	0	0
25	485802	.	T	C	19	12	31	0	0	31	0	0
25	485863	.	A	T	17	13	30	0	3	33	0	0
25	486276	.	A	T	15	6	21	0	0	21	0	0
25	486284	.	G	A	15	6	21	0	1	22	0	0
25	486363	.	T	G	11	10	21	0	2	23	0	0
25	487045	.	C	T	17	11	28	0	2	30	0	0
25	487360	.	C	T	1	17	18	1	8	27	0	0
25	488701	.	G	C	8	1	9	0	12	21	0	0
25	488817	.	G	T	13	16	29	0	2	31	0	0
25	489557	.	C	G	0	9	9	0	9	18	0	0
25	489904	.	G	T	15	11	26	0	1	27	0	0
25	494685	.	A	G	15	12	27	0	1	28	0	0
25	495366	.	G	A	16	12	28	0	0	28	0	0
25	498814	.	T	C	14	6	20	0	1	21	0	0
25	502593	.	C	G	3	10	13	0	8	21	0	0
25	502608	.	G	A	10	9	19	0	0	19	0	0
25	504816	.	C	T	4	8	12	0	1	13	0	0
25	504837	.	G	A	6	8	14	0	1	15	0	0
25	505214	.	C	T	11	10	21	0	0	21	0	0
25	509625	.	G	A	10	4	14	0	0	14	0	0
25	509899	.	C	T	8	10	18	0	1	19	0	0
25	510468	.	C	T	0	11	11	0	11	22	0	0
25	510505	.	T	C	12	2	14	0	7	21	0	0
25	510645	.	G	A	10	8	18	0	1	19	0	0
25	513362	.	C	T	5	3	8	0	0	8	0	0
25	518436	.	G	A	7	6	13	0	2	15	0	0
25	525220	.	T	C	5	6	11	0	1	12	0	0
25	527694	.	A	G	10	6	16	0	0	16	0	0
25	527721	.	G	A	10	6	16	0	0	16	0	0
25	535003	.	A	T	5	3	8	0	0	8	0	0
25	538788	.	G	A	6	6	12	0	1	13	0	0
25	552548	.	G	A	4	5	9	0	0	9	0	0
25	552677	.	T	G	4	5	9	0	0	9	0	0
25	552743	.	A	C	4	1	5	0	2	7	0	0
25	552761	.	C	T	0	3	3	0	4	7	0	0
25	552779	.	G	A	4	4	8	0	0	8	0	0
25	552872	.	G	A	7	6	13	0	0	13	0	0
25	582432	.	G	T	17	10	27	0	0	27	0	0
25	582437	.	T	C	16	12	28	0	0	28	0	0
25	582484	.	C	A	19	16	35	0	0	35	0	0
25	615178	.	G	A	13	15	28	0	1	29	0	0
25	617774	.	C	T	21	15	36	0	0	36	0	0
25	617859	.	T	C	17	17	34	0	0	34	0	0
25	626817	.	C	T	22	14	36	0	1	37	0	0
25	640440	.	G	A	1	13	14	0	16	30	0	0
25	663178	.	C	T	20	24	44	0	0	44	0	0
25	663214	.	C	T	27	18	45	0	2	47	0	0
25	663284	.	G	A	1	21	22	0	22	44	0	0
25	757080	.	A	C	5	0	5	0	0	5	0	0
25	763197	.	C	T	7	11	18	0	0	18	0	0
25	763774	.	T	C	10	16	26	0	1	27	0	0
25	764745	.	G	A	21	15	36	0	0	36	0	0
25	769201	.	C	T	1	4	5	0	0	5	0	0
25	769484	.	A	G	5	2	7	0	0	7	0	0
25	771070	.	A	G	3	2	5	0	1	6	0	0
25	771140	.	T	G	2	3	5	0	0	5	0	0
25	771557	.	T	G	1	2	3	0	0	3	0	0
25	771649	.	T	G	4	5	9	0	0	9	0	0
25	773164	.	T	G	1	3	4	0	0	4	0	0
25	824750	.	C	T	0	7	7	0	9	16	0	0
25	824774	.	C	T	10	7	17	0	0	17	0	0
25	825323	.	A	G	3	7	10	0	0	10	0	0
25	825335	.	C	G	3	6	9	0	0	9	0	0
25	825656	.	G	A	4	6	10	1	0	11	0	0
25	825695	.	T	C	6	3	9	0	1	10	0	0
25	825704	.	A	C	5	0	5	0	4	9	0	0
25	825746	.	T	C	4	0	4	0	4	8	0	0
25	825805	.	G	T	5	5	10	0	1	11	0	0
25	825827	.	C	T	1	6	7	0	6	13	0	0
25	825842	.	T	A	4	7	11	0	1	12	0	0
25	825866	.	G	A	6	6	12	0	0	12	0	0
25	825902	.	G	T	7	4	11	0	0	11	0	0
25	825968	.	A	C	7	7	14	0	1	15	0	0
25	826108	.	A	G	4	5	9	0	0	9	0	0
25	826405	.	C	A	6	2	8	0	0	8	0	0
25	826722	.	C	T	5	2	7	0	0	7	0	0
25	826790	.	C	T	1	3	4	0	0	4	0	0
25	827036	.	G	A	3	2	5	0	0	5	0	0
25	827408	.	T	C	5	0	5	0	7	12	0	0
25	827459	.	C	A	5	4	9	0	0	9	0	0
25	836168	.	C	T	0	2	2	0	3	5	0	0
25	867342	.	C	T	0	2	2	0	5	7	0	0
25	997618	.	C	T	1	2	3	0	0	3	0	0
25	1048814	.	T	C	2	3	5	0	0	5	0	0
25	1049179	.	G	C	2	2	4	0	0	4	0	0
25	1049194	.	T	C	5	2	7	0	0	7	0	0
25	1049544	.	T	C	2	3	5	0	1	6	0	0
25	1049686	.	G	C	5	6	11	0	1	12	0	0
25	1049967	.	G	A	4	4	8	0	2	10	0	0
25	1060999	.	A	G	3	2	5	0	0	5	0	0
25	1088800	.	A	G	1	3	4	0	1	5	0	0
25	1088887	.	T	C	5	8	13	0	1	14	0	0
25	1091760	.	A	G	12	6	18	0	0	18	0	0
25	1091806	.	G	A	10	5	15	0	0	15	0	0
25	1092442	.	C	A	0	6	6	0	6	12	0	0
25	1093526	.	A	G	4	11	15	0	0	15	0	0
25	1094460	.	T	G	13	11	24	0	0	24	0	0
25	1101431	.	A	G	2	3	5	0	0	5	0	0
25	1101659	.	A	G	4	4	8	0	1	9	0	0
25	1101704	.	C	G	4	5	9	0	0	9	0	0
25	1101707	.	G	A	4	4	8	0	0	8	0	0
25	1101860	.	A	G	2	3	5	0	0	5	0	0
25	1103369	.	G	T	4	6	10	0	0	10	0	0
25	1103486	.	C	T	7	3	10	0	2	12	0	0
25	1103980	.	G	A	7	2	9	0	0	9	0	0
25	1105884	.	A	C	5	6	11	0	0	11	0	0
25	1106247	.	C	G	7	5	12	0	0	12	0	0
25	1107992	.	G	A	3	7	10	0	1	11	0	0
25	1108210	.	G	A	4	4	8	0	0	8	0	0
25	1112164	.	G	T	4	4	8	0	1	9	0	0
25	1116480	.	C	T	3	3	6	0	0	6	0	0
25	1118564	.	A	G	1	4	5	0	0	5	0	0
25	1118714	.	C	T	4	2	6	0	1	7	0	0
25	1118764	.	T	C	1	0	1	0	3	4	0	0
25	1118855	.	T	C	2	0	2	0	3	5	0	0
25	1124062	.	G	A	3	3	6	0	0	6	0	0
25	1124405	.	C	T	0	7	7	0	6	13	0	0
25	1124488	.	C	G	4	7	11	0	0	11	0	0
25	1124732	.	A	T	2	3	5	0	0	5	0	0
25	1124753	.	C	T	0	2	2	0	2	4	0	0
25	1132496	.	C	G	11	9	20	1	0	21	0	0
25	1132611	.	A	T	10	5	15	0	0	15	0	0
25	1133793	.	G	A	1	13	14	0	8	22	0	0
25	1133797	.	T	G	14	7	21	0	2	23	0	0
25	1220400	.	G	T	8	11	19	0	0	19	0	0
25	1235287	.	G	A	4	2	6	0	1	7	0	0
25	1235362	.	C	T	3	2	5	4	0	9	0	0
25	1305338	.	T	G	7	5	12	0	1	13	0	0
25	1335681	.	G	A	5	7	12	1	0	13	0	0
25	1338263	.	C	T	1	4	5	0	0	5	0	0
25	1338272	.	G	T	1	3	4	0	1	5	0	0
25	1338689	.	T	C	5	5	10	0	1	11	0	0
25	1338860	.	T	A	4	4	8	0	0	8	0	0
25	1339403	.	C	T	7	4	11	0	1	12	0	0
25	1339601	.	G	T	1	2	3	0	4	7	0	0
25	1339760	.	C	T	2	3	5	0	0	5	0	0
25	1340021	.	A	G	1	0	1	0	2	3	0	0
25	1340042	.	C	T	1	3	4	0	1	5	0	0
25	1340088	.	T	C	3	3	6	0	1	7	0	0
25	1340215	.	G	A	7	4	11	0	0	11	0	0
25	1592111	.	G	A	15	20	35	0	4	39	0	0
25	1603727	.	G	A	1	6	7	0	11	18	0	0
25	1603772	.	C	A	10	7	17	0	0	17	0	0
25	1603787	.	G	T	8	8	16	0	0	16	0	0
25	1604543	.	T	G	10	2	12	0	11	23	0	0
25	1605150	.	T	C	9	9	18	0	0	18	0	0
25	1608836	.	C	G	11	9	20	0	0	20	0	0
25	1608857	.	C	G	10	12	22	0	1	23	0	0
25	1624547	.	C	A	17	11	28	0	0	29	1	0
25	1624777	.	G	A	23	15	38	0	1	39	0	0
25	1635419	.	G	A	15	5	20	0	0	20	0	0
25	1635714	.	C	G	20	7	27	0	1	28	0	0
25	1635783	.	G	A	16	14	30	0	2	32	0	0
25	1635786	.	C	T	0	13	13	0	19	32	0	0
25	1635879	.	G	A	21	12	33	0	1	34	0	0
25	1639932	.	G	T	15	9	24	0	2	26	0	0
25	1642066	.	C	T	8	11	19	0	0	19	0	0
25	1642319	.	C	A	11	13	24	0	0	24	0	0
25	1644857	.	C	T	8	10	18	0	0	18	0	0
25	1652138	.	C	T	0	9	9	0	9	18	0	0
25	1652294	.	G	A	10	6	16	0	1	17	0	0
25	1652450	.	A	G	6	8	14	0	0	14	0	0
25	1652513	.	G	A	7	10	17	0	1	18	0	0
25	1652543	.	C	T	1	6	7	0	8	15	0	0
25	1652591	.	A	G	6	7	13	0	0	13	0	0
25	1652766	.	C	A	11	8	19	0	2	21	0	0
25	1652793	.	C	T	1	6	7	0	11	18	0	0
25	1652916	.	G	A	8	6	14	0	1	15	0	0
25	1654432	.	G	T	13	5	18	0	1	19	0	0
25	1655408	.	G	A	5	10	15	0	2	17	0	0
25	1655502	.	G	A	9	10	19	0	1	20	0	0
25	1655535	.	G	C	10	4	14	0	3	17	0	0
25	1655537	.	G	A	13	4	17	0	0	17	0	0
25	1660233	.	G	A	6	4	10	1	1	12	0	0
25	1660255	.	G	T	7	4	11	1	0	12	0	0
25	1670422	.	G	T	8	3	11	0	1	12	0	0
25	1670785	.	T	C	9	6	15	0	0	15	0	0
25	1670850	.	C	T	5	9	14	0	0	14	0	0
25	1670878	.	T	C	7	6	13	0	0	13	0	0
25	1672306	.	A	G	8	5	13	0	0	13	0	0
25	1672911	.	C	T	8	4	12	0	1	13	0	0
25	1672920	.	G	T	3	7	10	0	0	10	0	0
25	1680477	.	G	A	5	2	7	0	0	7	0	0
25	1681344	.	A	C	4	6	10	0	0	10	0	0
25	2044654	.	A	T	1	1	2	0	1	3	0	0
25	2253135	.	T	C	3	3	6	0	0	6	0	0
25	2264091	.	C	A	4	5	9	0	1	11	1	0
25	2264112	.	T	C	4	4	8	0	0	8	0	0
25	2264788	.	A	G	2	2	4	0	0	4	0	0
25	2264824	.	A	C	2	2	4	0	0	4	0	0
25	2264830	.	A	G	3	2	5	0	0	5	0	0
25	2264875	.	C	A	3	2	5	0	1	6	0	0
25	2273945	.	C	T	1	7	8	0	2	10	0	0
25	2276704	.	C	T	3	3	6	0	8	14	0	0
25	2276770	.	T	C	7	4	11	0	3	14	0	0
25	2276781	.	A	G	5	8	13	0	0	13	0	0
25	2276828	.	T	A	3	5	8	0	0	8	0	0
25	2276869	.	C	T	1	4	5	0	1	6	0	0
25	2282566	.	A	G	12	4	16	0	10	26	0	0
25	2282846	.	A	C	16	17	33	0	1	34	0	0
25	2286066	.	C	T	14	23	37	0	3	40	0	0
25	2286120	.	G	A	11	9	20	0	1	21	0	0
25	2286376	.	T	C	6	9	15	1	0	16	0	0
25	2286502	.	T	C	16	12	28	0	1	29	0	0
25	2286600	.	A	T	9	15	24	0	0	24	0	0
25	2286762	.	A	C	9	4	13	0	2	15	0	0
25	2286798	.	A	C	13	8	21	0	1	22	0	0
25	2286837	.	C	T	13	15	28	0	0	28	0	0
25	2286841	.	C	A	13	14	27	0	2	29	0	0
25	2702712	.	A	G	5	9	14	0	1	15	0	0
25	2702718	.	A	G	9	0	9	0	9	18	0	0
25	3245895	.	A	G	8	8	16	0	1	17	0	0
25	3246593	.	A	G	14	4	18	1	1	20	0	0
25	3451196	.	T	A	7	11	18	0	0	18	0	0
25	3451250	.	A	C	20	11	31	0	0	31	0	0
25	3451760	.	A	C	10	10	20	0	1	21	0	0
25	3451779	.	A	G	10	6	16	0	0	16	0	0
25	3453651	.	G	A	11	9	20	0	0	20	0	0
25	3454644	.	G	A	13	12	25	0	0	25	0	0
25	3454719	.	G	A	14	11	25	0	1	26	0	0
25	3457756	.	G	A	6	3	9	0	0	9	0	0
25	3461097	.	C	G	1	8	9	0	9	18	0	0
25	3465854	.	G	A	6	6	12	0	1	13	0	0
25	3465905	.	C	G	0	5	5	0	7	12	0	0
25	3465911	.	A	G	5	7	12	0	1	13	0	0
25	3469502	.	G	A	2	5	7	0	0	7	0	0
25	3478467	.	G	T	14	13	27	0	0	27	0	0
25	3478617	.	C	T	15	10	25	0	1	26	0	0
25	3481088	.	G	T	12	12	24	0	0	24	0	0
25	3483727	.	G	A	12	12	24	1	1	26	0	0
25	3511278	.	A	G	6	2	8	1	0	9	0	0
25	3513274	.	G	A	6	2	8	0	0	8	0	0
25	3528738	.	T	C	6	3	9	0	0	9	0	0
25	3529701	.	G	A	0	4	4	0	5	9	0	0
25	3529758	.	C	T	5	4	9	0	0	9	0	0
25	3529781	.	T	C	5	1	6	0	0	6	0	0
25	3529806	.	A	G	4	2	6	0	0	6	0	0
25	3536269	.	G	A	5	2	7	0	0	7	0	0
25	3536279	.	G	T	6	2	8	0	0	8	0	0
25	3536470	.	G	T	5	3	8	0	1	9	0	0
25	3536512	.	A	T	5	3	8	0	0	8	0	0
25	3539530	.	C	T	0	2	2	0	3	5	0	0
25	3542072	.	G	T	3	3	6	0	0	6	0	0
25	3544210	.	G	A	3	4	7	0	0	7	0	0
25	3544217	.	G	C	3	0	3	0	3	6	0	0
25	3546464	.	G	A	7	2	9	0	0	9	0	0
25	3546488	.	A	C	3	2	5	0	1	6	0	0
25	3546506	.	A	G	5	2	7	0	2	9	0	0
25	3546602	.	C	A	2	3	5	0	0	5	0	0
25	3550991	.	C	T	1	4	5	0	0	5	0	0
25	3555037	.	G	C	1	3	4	0	0	4	0	0
25	3557470	.	G	A	1	5	6	0	4	10	0	0
25	3560066	.	G	A	0	4	4	0	2	6	0	0
25	3562517	.	A	C	1	8	9	0	0	9	0	0
25	3573350	.	G	A	7	3	10	0	0	10	0	0
25	3573447	.	T	C	6	0	6	0	3	9	0	0
25	3573624	.	G	C	3	1	4	0	1	5	0	0
25	3573635	.	A	T	6	3	9	0	0	9	0	0
25	3573796	.	C	A	0	4	4	0	9	13	0	0
25	3573815	.	G	A	7	8	15	0	0	15	0	0
25	3579429	.	A	C	4	7	11	0	0	11	0	0
25	3579459	.	C	A	2	7	9	0	1	10	0	0
25	3582443	.	A	G	6	6	12	0	0	12	0	0
25	3583975	.	C	T	6	7	13	0	1	14	0	0
25	3583983	.	G	T	6	7	13	0	1	14	0	0
25	3584053	.	G	A	7	4	11	0	1	12	0	0
25	3584156	.	T	C	3	0	3	0	10	13	0	0
25	3594911	.	T	C	5	4	9	0	0	9	0	0
25	3595118	.	G	A	7	2	9	0	0	9	0	0
25	3595120	.	C	T	1	2	3	0	6	9	0	0
25	3596319	.	C	T	4	2	6	0	0	6	0	0
25	3596361	.	T	G	4	3	7	0	1	8	0	0
25	3599390	.	A	G	4	2	6	0	0	6	0	0
25	3603228	.	C	T	3	4	7	0	1	8	0	0
25	3603252	.	T	C	2	0	2	0	4	6	0	0
25	3606940	.	G	A	4	5	9	0	0	9	0	0
25	3606970	.	C	T	4	3	7	0	0	7	0	0
25	3607015	.	A	G	2	3	5	0	0	5	0	0
25	3607033	.	G	C	1	0	1	0	4	5	0	0
25	3623403	.	T	C	4	4	8	0	1	9	0	0
25	3623573	.	T	G	2	4	6	0	2	8	0	0
25	3638484	.	T	G	4	5	9	0	0	9	0	0
25	3641123	.	C	T	0	2	2	0	2	4	0	0
25	3641160	.	G	A	3	4	7	0	1	8	0	0
25	3644458	.	C	T	2	4	6	0	0	6	0	0
25	3677703	.	G	A	4	18	22	0	19	41	0	0
25	3682253	.	C	T	21	19	40	0	1	41	0	0
25	3682610	.	G	A	2	17	19	0	13	32	0	0
25	3682789	.	G	A	27	22	49	0	1	50	0	0
25	3682795	.	A	C	27	24	51	0	0	51	0	0
25	3683247	.	G	A	30	26	56	0	0	56	0	0
25	3683297	.	C	T	33	31	64	0	0	64	0	0
25	3683386	.	C	T	24	23	47	0	1	48	0	0
25	3683527	.	G	A	5	25	30	0	16	46	0	0
25	3683796	.	A	T	20	15	35	0	1	36	0	0
25	3683887	.	C	T	28	9	37	0	1	38	0	0
25	3684141	.	C	A	26	30	56	0	3	59	0	0
25	3684148	.	A	G	28	31	59	0	3	62	0	0
25	3684195	.	G	A	4	18	22	11	21	54	0	0
25	3684409	.	G	T	2	20	22	2	37	61	0	0
25	3684741	.	A	G	22	26	48	0	1	49	0	0
25	3708429	.	G	T	5	3	8	0	0	8	0	0
25	3713652	.	T	C	11	0	11	0	14	25	0	0
25	3713724	.	T	C	9	9	18	0	1	19	0	0
25	3719888	.	G	T	16	8	24	0	2	26	0	0
25	3721726	.	G	C	12	0	12	0	12	24	0	0
25	3724275	.	T	C	5	0	5	0	7	12	0	0
25	3724598	.	G	A	3	5	8	0	1	9	0	0
25	3725000	.	G	A	8	8	16	0	1	17	0	0
25	3739815	.	T	G	2	3	5	0	0	5	0	0
25	3750079	.	C	T	6	4	10	0	1	11	0	0
25	3750168	.	T	C	4	0	4	0	3	7	0	0
25	3750466	.	A	T	1	2	3	0	0	3	0	0
25	3750509	.	T	A	5	5	10	0	3	13	0	0
25	3750545	.	A	T	12	13	25	0	0	25	0	0
25	3750559	.	T	C	14	12	26	0	1	27	0	0
25	3750655	.	C	T	17	9	26	0	1	27	0	0
25	3754606	.	G	A	10	10	20	0	2	22	0	0
25	3755271	.	G	A	8	13	21	0	3	24	0	0
25	3755303	.	A	G	18	12	30	0	0	30	0	0
25	3757584	.	G	A	6	9	15	0	1	16	0	0
25	3757606	.	G	A	7	7	14	0	0	14	0	0
25	3757670	.	C	T	14	7	21	0	3	24	0	0
25	3758022	.	T	C	6	8	14	0	0	14	0	0
25	3761443	.	G	A	2	6	8	0	0	8	0	0
25	3761475	.	C	T	1	2	3	0	1	4	0	0
25	3765659	.	G	A	0	3	3	0	4	7	0	0
25	3772165	.	T	C	4	4	8	0	0	8	0	0
25	3774637	.	A	C	5	3	8	0	0	8	0	0
25	3774681	.	G	A	3	3	6	0	0	6	0	0
25	3774705	.	A	T	5	3	8	0	0	8	0	0
25	3777774	.	A	G	4	0	4	0	7	11	0	0
25	3777795	.	G	C	1	3	4	0	6	10	0	0
25	3779091	.	T	C	6	4	10	0	1	11	0	0
25	3782576	.	T	C	6	4	10	0	0	10	0	0
25	3784679	.	C	T	4	7	11	0	0	11	0	0
25	3788564	.	T	C	7	9	16	0	0	16	0	0
25	3789004	.	G	A	3	9	12	0	14	26	0	0
25	3790279	.	G	A	1	6	7	0	9	16	0	0
25	3792945	.	A	G	17	9	26	0	0	26	0	0
25	3793096	.	T	C	16	7	23	0	0	23	0	0
25	3793141	.	T	A	11	5	16	0	1	17	0	0
25	3794975	.	A	G	19	0	19	0	11	30	0	0
25	3800590	.	C	T	10	6	16	0	1	17	0	0
25	3801310	.	C	T	4	2	6	0	0	6	0	0
25	3801505	.	T	G	6	3	9	0	0	9	0	0
25	3801726	.	A	G	15	10	25	0	1	26	0	0
25	3801737	.	T	C	18	12	30	0	0	30	0	0
25	3804410	.	A	G	24	12	36	0	0	36	0	0
25	3807526	.	C	T	2	10	12	0	14	26	0	0
25	3808572	.	T	A	18	10	28	0	0	28	0	0
25	3881331	.	A	G	2	3	5	0	0	5	0	0
25	3887287	.	C	T	1	3	4	0	1	5	0	0
25	3891940	.	A	T	26	26	52	0	2	54	0	0
25	3898332	.	A	G	7	16	23	0	0	23	0	0
25	3898449	.	T	C	17	0	17	0	8	25	0	0
25	3898483	.	C	T	17	13	30	0	0	30	0	0
25	3898566	.	G	T	15	11	26	0	1	27	0	0
25	3898572	.	C	A	0	11	11	0	15	26	0	0
25	3898937	.	T	A	11	7	18	2	0	20	0	0
25	3898976	.	C	T	1	9	10	0	11	21	0	0
25	3899039	.	A	C	7	12	19	0	1	20	0	0
25	3899169	.	C	T	11	8	19	0	0	19	0	0
25	3903316	.	A	T	15	10	25	0	2	27	0	0
25	3903317	.	C	G	17	10	27	0	1	28	0	0
25	3906840	.	A	C	10	0	10	0	14	24	0	0
25	3907063	.	A	G	15	21	36	0	0	36	0	0
25	3910957	.	A	G	7	7	14	0	0	14	0	0
25	3913568	.	G	A	7	16	23	0	0	23	0	0
25	4097440	.	C	G	3	3	6	2	0	8	0	0
25	4097514	.	T	C	1	5	6	0	0	6	0	0
25	4112013	.	C	T	5	3	8	0	0	8	0	0
25	4113930	.	T	C	4	4	8	1	0	9	0	0
25	4117899	.	C	T	5	4	9	0	0	9	0	0
25	4126771	.	G	A	5	7	12	0	0	12	0	0
25	4129075	.	G	T	3	6	9	0	0	9	0	0
25	4129093	.	T	A	2	3	5	0	0	5	0	0
25	4129131	.	C	A	4	7	11	0	0	11	0	0
25	4129165	.	C	A	9	6	15	0	2	17	0	0
25	4133498	.	T	C	15	15	30	0	0	30	0	0
25	4133647	.	C	A	24	17	41	0	1	42	0	0
25	4133648	.	T	C	24	2	26	0	17	43	0	0
25	4133708	.	T	G	31	16	47	0	1	48	0	0
25	4133720	.	C	A	28	16	44	0	1	45	0	0
25	4136001	.	C	A	22	22	44	0	0	44	0	0
25	4136292	.	A	G	27	18	45	1	0	46	0	0
25	4141629	.	G	A	17	9	26	0	0	26	0	0
25	4143837	.	T	C	9	1	10	0	4	14	0	0
25	4460165	.	T	C	20	6	26	0	0	26	0	0
25	4460441	.	G	A	22	15	37	0	0	37	0	0
25	4475705	.	A	G	11	10	21	0	0	21	0	0
25	4479442	.	A	G	15	12	27	0	0	27	0	0
25	4479613	.	G	C	14	7	21	0	0	21	0	0
25	4581599	.	T	C	2	5	7	0	0	7	0	0
25	4660873	.	T	C	3	2	5	0	0	5	0	0
25	4668799	.	C	T	2	3	5	0	0	5	0	0
25	4677100	.	A	C	2	4	6	0	2	8	0	0
25	4686548	.	T	C	6	2	8	0	1	9	0	0
25	4686575	.	T	C	5	4	9	0	0	9	0	0
25	4689362	.	A	G	4	2	6	0	0	6	0	0
25	4689573	.	A	G	5	2	7	0	1	8	0	0
25	4689578	.	A	G	4	3	7	0	0	7	0	0
25	4717246	.	C	T	1	12	13	0	3	17	1	0
25	4723885	.	A	G	1	8	9	0	0	9	0	0
25	4733021	.	A	G	4	5	9	0	0	9	0	0
25	4837937	.	G	C	16	10	26	0	2	28	0	0
25	4838118	.	A	G	24	18	42	0	1	43	0	0
25	4841406	.	T	C	12	13	25	0	2	27	0	0
25	4843398	.	A	G	17	16	33	0	1	34	0	0
25	4843685	.	A	C	23	23	46	0	1	47	0	0
25	4846836	.	T	C	26	23	49	0	1	50	0	0
25	4848808	.	C	T	20	19	39	0	5	44	0	0
25	4849326	.	A	G	21	0	21	0	19	40	0	0
25	4849422	.	T	A	27	9	36	0	4	40	0	0
25	4849453	.	C	T	22	15	37	0	5	42	0	0
25	4850969	.	C	G	13	1	14	0	14	28	0	0
25	4850989	.	G	A	16	12	28	0	3	31	0	0
25	4855790	.	A	G	3	2	5	0	0	5	0	0
25	4867859	.	T	A	2	3	5	0	0	5	0	0
25	4871568	.	T	C	6	2	8	0	0	8	0	0
25	4871597	.	G	A	1	3	4	0	7	11	0	0
25	4873878	.	C	A	5	2	7	0	0	7	0	0
25	4873904	.	G	A	4	2	6	0	0	6	0	0
25	4874057	.	C	A	3	2	5	0	0	5	0	0
25	4877685	.	A	G	7	7	14	0	1	15	0	0
25	4877781	.	C	A	5	4	9	0	0	9	0	0
25	4879937	.	T	A	8	9	17	0	0	17	0	0
25	4879964	.	C	T	9	12	21	0	0	21	0	0
25	4879973	.	A	C	7	10	17	0	1	18	0	0
25	4880138	.	A	C	4	6	10	0	0	10	0	0
25	4880144	.	A	G	3	1	4	0	7	11	0	0
25	4880363	.	C	T	4	2	6	0	0	6	0	0
25	4880372	.	T	A	4	2	6	0	0	6	0	0
25	4883338	.	A	G	6	0	6	0	3	9	0	0
25	4891272	.	G	A	43	27	70	0	1	71	0	0
25	4891286	.	A	T	36	30	66	0	6	73	1	0
25	4891350	.	C	T	22	47	69	0	2	71	0	0
25	4891538	.	A	G	21	39	60	1	3	64	0	0
25	4891597	.	G	A	23	42	65	0	2	67	0	0
25	4891762	.	C	G	20	29	49	0	2	51	0	0
25	4891867	.	T	C	13	0	13	0	15	28	0	0
25	4891882	.	C	T	14	12	26	0	1	27	0	0
25	4892010	.	A	C	16	31	47	0	1	48	0	0
25	4892172	.	G	T	32	35	67	0	1	68	0	0
25	4892203	.	T	A	26	35	61	0	2	63	0	0
25	4892291	.	T	C	20	30	50	0	3	53	0	0
25	4892348	.	A	G	36	19	55	0	4	59	0	0
25	4892356	.	G	A	38	15	53	0	1	54	0	0
25	4892537	.	A	G	20	26	46	0	1	47	0	0
25	4892830	.	C	T	23	29	52	0	2	54	0	0
25	4892982	.	T	C	14	25	39	0	0	39	0	0
25	4892985	.	T	C	13	23	36	0	2	38	0	0
25	4893024	.	A	C	20	13	33	0	0	33	0	0
25	4893049	.	T	C	19	9	28	2	0	30	0	0
25	4893059	.	G	A	18	4	22	2	3	27	0	0
25	4893176	.	C	T	3	13	16	0	12	28	0	0
25	4893193	.	A	C	14	22	36	0	0	36	0	0
25	4893214	.	T	G	9	34	43	0	0	43	0	0
25	4893238	.	A	G	6	34	40	0	4	44	0	0
25	4893304	.	G	T	12	32	44	0	2	46	0	0
25	4893398	.	T	C	22	41	63	0	1	64	0	0
25	4893435	.	C	T	29	43	72	0	3	75	0	0
25	4896182	.	A	G	15	36	51	0	6	57	0	0
25	4896281	.	A	C	23	2	25	0	20	45	0	0
25	4896290	.	A	G	27	17	44	0	4	48	0	0
25	4897187	.	T	A	19	29	48	0	0	48	0	0
25	4899071	.	G	A	19	31	50	0	1	51	0	0
25	4902538	.	A	T	20	20	40	0	3	43	0	0
25	4902586	.	T	C	18	1	19	0	24	43	0	0
25	4904387	.	A	G	14	12	26	0	0	26	0	0
25	5020225	.	C	T	4	2	6	0	0	6	0	0
25	5020270	.	C	T	4	2	6	0	0	6	0	0
25	5022275	.	C	T	1	2	3	0	1	4	0	0
25	5024565	.	T	C	1	3	4	0	0	4	0	0
25	5024859	.	T	G	4	0	4	0	2	6	0	0
25	5027167	.	A	C	1	2	3	0	2	5	0	0
25	5189406	.	C	T	0	4	4	0	2	6	0	0
25	5189445	.	T	C	3	0	3	5	5	13	0	0
25	5604947	.	T	C	1	2	3	0	0	3	0	0
25	5605165	.	C	A	7	2	9	0	0	9	0	0
25	5605168	.	T	C	7	1	8	0	1	9	0	0
25	5627518	.	G	A	1	3	4	0	2	6	0	0
25	5634058	.	C	T	4	4	8	0	0	8	0	0
25	5636152	.	G	A	4	2	6	0	0	6	0	0
25	5636158	.	C	T	4	2	6	0	0	6	0	0
25	5636188	.	C	T	2	2	4	0	0	4	0	0
25	5652409	.	G	A	6	5	11	0	0	11	0	0
25	5654679	.	G	T	0	5	5	1	6	12	0	0
25	5664609	.	C	T	2	5	7	0	0	7	0	0
25	5666904	.	C	T	7	3	10	0	0	10	0	0
25	5666925	.	A	G	6	6	12	0	0	12	0	0
25	5667039	.	T	C	6	9	15	0	0	15	0	0
25	5676227	.	C	T	11	4	15	2	1	18	0	0
25	5676235	.	C	T	12	2	14	2	1	17	0	0
25	5679314	.	A	T	5	8	13	0	1	14	0	0
25	5679356	.	T	G	5	4	9	0	0	9	0	0
25	5702160	.	G	T	17	14	31	0	0	31	0	0
25	5709328	.	T	G	19	15	34	0	1	35	0	0
25	5709381	.	C	T	2	9	11	0	14	25	0	0
25	5710949	.	C	G	18	17	35	0	2	37	0	0
25	5713704	.	G	C	11	1	12	0	24	36	0	0
25	5722072	.	A	G	10	16	26	0	0	26	0	0
25	5724887	.	C	T	2	8	10	0	11	21	0	0
25	5724905	.	G	A	8	7	15	0	1	16	0	0
25	5730936	.	A	T	8	10	18	0	0	18	0	0
25	5733681	.	G	A	11	4	15	0	0	15	0	0
25	5733684	.	G	A	12	4	16	0	0	16	0	0
25	5734392	.	C	T	0	10	10	0	8	18	0	0
25	5736673	.	C	T	1	9	10	0	8	18	0	0
25	5774925	.	C	T	7	5	12	0	0	12	0	0
25	5774984	.	C	G	10	4	14	0	0	14	0	0
25	5774990	.	T	A	10	4	14	0	1	15	0	0
25	5775124	.	C	T	5	8	13	0	0	13	0	0
25	5775139	.	T	A	8	4	12	0	3	15	0	0
25	5775423	.	G	A	0	3	3	0	6	9	0	0
25	5775497	.	T	C	5	6	11	0	0	11	0	0
25	5775498	.	C	T	5	6	11	0	0	11	0	0
25	5775536	.	T	A	5	5	10	0	0	10	0	0
25	5775552	.	C	T	5	5	10	0	0	10	0	0
25	5775605	.	G	C	2	6	8	0	0	8	0	0
25	5775638	.	G	C	4	2	6	0	0	6	0	0
25	5775697	.	G	A	5	3	8	0	0	8	0	0
25	5776138	.	G	A	1	3	4	0	7	11	0	0
25	5776822	.	G	A	1	7	8	0	4	12	0	0
25	5776920	.	T	A	5	4	9	0	0	9	0	0
25	5776966	.	G	C	6	6	12	0	0	12	0	0
25	5777032	.	T	A	6	6	12	0	1	13	0	0
25	5777674	.	G	A	7	9	16	0	1	17	0	0
25	5778842	.	C	G	8	4	12	0	0	12	0	0
25	5778851	.	T	C	9	4	13	0	0	13	0	0
25	5779557	.	G	A	8	10	18	0	0	18	0	0
25	5780633	.	T	C	11	7	18	0	1	19	0	0
25	5783309	.	T	C	11	13	24	0	0	24	0	0
25	5783523	.	C	T	6	11	17	0	0	17	0	0
25	5783598	.	T	A	5	7	12	0	2	15	1	0
25	5786668	.	T	C	1	5	6	0	0	6	0	0
25	5787684	.	C	T	11	11	22	0	1	23	0	0
25	5787966	.	C	A	12	8	20	0	0	20	0	0
25	5788212	.	A	G	1	2	3	0	1	4	0	0
25	5788310	.	T	C	7	6	13	0	0	13	0	0
25	5788321	.	C	T	9	8	17	0	1	18	0	0
25	5788384	.	C	T	10	12	22	0	0	22	0	0
25	5788432	.	A	G	10	13	23	0	2	25	0	0
25	5788519	.	G	T	8	14	22	0	1	23	0	0
25	5788670	.	C	T	1	12	13	0	17	30	0	0
25	5788783	.	G	C	20	18	38	0	0	38	0	0
25	5788838	.	A	G	12	7	19	0	0	19	0	0
25	5788842	.	C	T	1	7	8	0	9	17	0	0
25	5788968	.	C	T	1	3	4	0	6	10	0	0
25	5789625	.	T	A	8	7	15	0	2	17	0	0
25	5789626	.	T	C	9	0	9	0	8	17	0	0
25	5789660	.	A	T	12	5	17	1	2	20	0	0
25	5789721	.	G	A	15	6	21	0	1	22	0	0
25	5789734	.	G	C	16	6	22	0	0	22	0	0
25	5789937	.	A	C	8	10	18	0	1	19	0	0
25	5790050	.	T	G	10	14	24	0	0	24	0	0
25	5790341	.	C	G	9	8	17	0	1	18	0	0
25	5790414	.	A	T	4	6	10	0	2	12	0	0
25	5790742	.	G	A	8	11	19	0	1	20	0	0
25	5796606	.	A	G	15	9	24	0	0	24	0	0
25	5796675	.	A	C	7	0	7	0	13	20	0	0
25	5803529	.	A	G	7	6	13	0	0	13	0	0
25	5805328	.	G	A	10	11	21	0	1	22	0	0
25	5805346	.	G	T	11	9	20	0	1	21	0	0
25	5805382	.	G	A	9	8	17	0	1	18	0	0
25	5815822	.	G	A	3	3	6	0	0	6	0	0
25	5835390	.	T	G	19	0	19	0	10	29	0	0
25	5835564	.	T	C	11	12	23	0	0	23	0	0
25	5936080	.	C	T	5	5	10	0	0	10	0	0
25	5936556	.	A	T	8	9	17	0	1	18	0	0
25	5936725	.	T	A	13	21	34	0	1	35	0	0
25	5936764	.	C	A	10	19	29	0	1	31	1	0
25	5936886	.	C	T	0	7	7	0	7	14	0	0
25	5937012	.	C	T	10	12	22	0	1	23	0	0
25	5937424	.	T	G	8	8	16	0	0	16	0	0
25	5937516	.	C	T	1	16	17	0	21	38	0	0
25	5937686	.	G	C	15	0	15	0	25	40	0	0
25	5938065	.	A	T	8	10	18	0	0	18	0	0
25	5938694	.	G	A	5	4	9	0	0	9	0	0
25	5938858	.	A	C	13	4	17	0	0	17	0	0
25	5938881	.	G	T	4	10	14	0	1	15	0	0
25	5938895	.	C	T	4	6	10	0	0	10	0	0
25	5939484	.	C	T	10	8	18	0	2	20	0	0
25	5939569	.	T	C	8	8	16	0	1	17	0	0
25	5940272	.	T	C	5	2	7	0	0	7	0	0
25	5944304	.	G	A	2	4	6	0	0	6	0	0
25	5947539	.	G	A	9	7	16	0	0	16	0	0
25	5962763	.	C	T	0	7	7	0	3	10	0	0
25	5963021	.	T	A	5	2	7	0	0	7	0	0
25	5963435	.	T	A	3	3	6	0	0	6	0	0
25	5983468	.	T	A	1	2	3	0	0	3	0	0
25	5986994	.	A	G	44	3	47	0	23	70	0	0
25	5990107	.	A	C	18	16	34	0	0	34	0	0
25	6016708	.	G	A	5	3	8	0	0	8	0	0
25	6016752	.	T	C	7	2	9	0	8	17	0	0
25	6016829	.	C	T	9	9	18	0	1	19	0	0
25	6017382	.	A	T	10	13	23	0	2	25	0	0
25	6017623	.	C	T	0	19	19	0	14	33	0	0
25	6025278	.	C	A	9	6	15	0	1	16	0	0
25	6025326	.	G	T	12	8	20	0	0	20	0	0
25	6026106	.	G	A	9	6	15	0	0	15	0	0
25	6028947	.	G	A	9	7	16	0	0	16	0	0
25	6042871	.	G	A	11	8	19	0	1	20	0	0
25	6049177	.	G	A	13	10	23	0	4	27	0	0
25	6051785	.	G	T	0	2	2	0	1	3	0	0
25	6067712	.	A	C	6	0	6	0	3	9	0	0
25	6069190	.	G	A	1	2	3	0	0	3	0	0
25	6069635	.	T	G	3	3	6	0	0	6	0	0
25	6069639	.	A	T	3	3	6	0	0	6	0	0
25	6076542	.	C	T	1	2	3	0	0	3	0	0
25	6079096	.	C	A	2	2	4	0	0	4	0	0
25	6151813	.	T	A	4	3	7	0	0	7	0	0
25	6152324	.	G	A	2	6	8	0	0	8	0	0
25	6152347	.	T	A	3	7	10	0	0	10	0	0
25	6152363	.	A	C	4	3	7	0	1	8	0	0
25	6152383	.	T	A	3	2	5	0	1	6	0	0
25	6152501	.	A	G	2	0	2	0	3	5	0	0
25	6186933	.	A	G	9	13	22	0	1	23	0	0
25	6202870	.	T	A	9	4	13	0	2	15	0	0
25	6203292	.	A	G	5	11	16	0	2	18	0	0
25	6204825	.	A	G	13	5	18	0	0	18	0	0
25	6205703	.	C	T	11	16	27	0	0	27	0	0
25	6216349	.	A	C	17	17	34	0	1	35	0	0
25	6222555	.	G	A	8	15	23	0	2	25	0	0
25	6222600	.	C	A	0	14	14	0	12	26	0	0
25	6228616	.	G	A	9	11	20	0	0	20	0	0
25	6228651	.	A	G	10	10	20	0	0	20	0	0
25	6230616	.	G	A	11	11	22	0	2	24	0	0
25	6230721	.	T	C	16	9	25	0	2	27	0	0
25	6230736	.	T	G	15	10	25	0	1	26	0	0
25	6230935	.	T	C	11	4	15	0	1	16	0	0
25	6233485	.	C	T	14	10	24	0	1	25	0	0
25	6237656	.	G	A	7	5	12	0	0	12	0	0
25	6237674	.	T	C	6	0	6	0	6	12	0	0
25	6237993	.	A	G	5	4	9	0	1	10	0	0
25	6239911	.	T	C	7	6	13	0	0	13	0	0
25	6240154	.	G	A	6	2	8	0	1	9	0	0
25	6242742	.	C	T	8	5	13	0	1	14	0	0
25	6245099	.	A	G	9	6	15	0	1	16	0	0
25	6246357	.	A	T	5	5	10	0	1	11	0	0
25	6268373	.	G	T	0	2	2	0	2	4	0	0
25	6268616	.	C	A	1	2	3	0	0	3	0	0
25	6274879	.	A	G	1	6	7	0	0	7	0	0
25	6275032	.	T	G	1	2	3	0	0	3	0	0
25	6288353	.	G	C	5	9	14	0	0	14	0	0
25	6292370	.	A	G	9	5	14	0	0	14	0	0
25	6292381	.	T	A	8	5	13	0	0	13	0	0
25	6292449	.	A	G	13	3	16	0	0	16	0	0
25	6292481	.	C	T	3	4	7	0	7	14	0	0
25	6307064	.	T	C	26	29	55	0	1	56	0	0
25	6312955	.	A	C	28	35	63	0	3	66	0	0
25	6313069	.	G	A	3	27	30	0	26	56	0	0
25	6313075	.	T	C	28	25	53	0	3	56	0	0
25	6337111	.	G	A	4	30	34	2	23	59	0	0
25	6337136	.	C	T	20	28	48	2	4	54	0	0
25	6337253	.	A	T	15	12	27	0	1	28	0	0
25	6337271	.	C	A	18	11	29	0	2	31	0	0
25	6351282	.	A	G	9	13	22	1	0	23	0	0
25	6351283	.	C	G	9	13	22	1	0	23	0	0
25	6357227	.	C	T	10	4	14	0	1	15	0	0
25	6357245	.	C	T	2	4	6	0	8	14	0	0
25	6357451	.	T	C	7	6	13	0	0	13	0	0
25	6357503	.	G	A	8	5	13	0	0	13	0	0
25	6359728	.	G	C	10	8	18	0	0	18	0	0
25	6360049	.	T	A	5	12	17	0	1	18	0	0
25	6360225	.	T	C	9	13	22	0	3	25	0	0
25	6365322	.	T	C	8	5	13	0	2	15	0	0
25	6365361	.	C	A	5	7	12	0	3	15	0	0
25	6365394	.	G	T	5	11	16	0	0	16	0	0
25	6365415	.	T	C	5	10	15	0	1	16	0	0
25	6366800	.	T	G	7	5	12	0	0	12	0	0
25	6366888	.	G	A	7	5	12	0	0	12	0	0
25	6370171	.	C	T	2	3	5	0	5	10	0	0
25	6377724	.	T	C	9	1	10	0	2	12	0	0
25	6383376	.	T	C	5	0	5	0	4	9	0	0
25	6403986	.	A	T	4	3	7	0	0	7	0	0
25	6404230	.	G	T	3	2	5	0	0	5	0	0
25	6404599	.	C	T	0	3	3	0	7	10	0	0
25	6407526	.	T	C	6	0	6	0	11	17	0	0
25	6407562	.	T	C	3	0	3	0	6	9	0	0
25	6411731	.	T	A	3	2	5	0	2	7	0	0
25	6417123	.	C	T	1	4	5	0	0	5	0	0
25	6420717	.	T	C	3	5	8	0	0	8	0	0
25	6431914	.	C	A	3	5	8	0	1	9	0	0
25	6431985	.	A	C	2	2	4	0	0	4	0	0
25	6435955	.	A	G	6	3	9	0	0	9	0	0
25	6436199	.	G	C	9	13	22	0	1	23	0	0
25	6437716	.	A	G	7	13	20	0	0	20	0	0
25	6437735	.	A	G	10	8	18	0	2	20	0	0
25	6507377	.	A	G	2	3	5	0	0	5	0	0
25	6507821	.	G	T	2	2	4	0	0	4	0	0
25	6507833	.	T	C	2	2	4	0	0	4	0	0
25	6507914	.	G	A	2	2	4	0	0	4	0	0
25	7229255	.	T	A	7	10	17	0	1	18	0	0
25	7230239	.	T	C	8	11	19	0	0	19	0	0
25	7241452	.	G	A	2	3	5	0	0	5	0	0
25	7324580	.	C	T	16	9	25	1	0	26	0	0
25	7327718	.	C	T	17	17	34	0	0	34	0	0
25	7333751	.	G	A	12	17	29	0	1	30	0	0
25	7333841	.	C	T	21	15	36	0	3	39	0	0
25	7334900	.	A	G	20	1	21	0	16	37	0	0
25	7334951	.	T	C	18	18	36	0	0	36	0	0
25	7334987	.	G	C	20	15	35	0	2	37	0	0
25	7336096	.	T	A	12	9	21	0	2	23	0	0
25	7398773	.	C	T	2	4	6	0	0	6	0	0
25	7398977	.	C	A	4	5	9	0	0	9	0	0
25	7399297	.	G	A	0	3	3	0	4	7	0	0
25	7401054	.	C	T	3	6	9	0	0	9	0	0
25	7401539	.	C	T	4	5	9	0	0	9	0	0
25	7401580	.	A	G	5	3	8	0	1	9	0	0
25	7410399	.	A	G	5	7	12	0	0	12	0	0
25	7410558	.	C	A	6	4	10	0	0	10	0	0
25	7410645	.	G	A	2	6	8	0	0	8	0	0
25	7410822	.	G	A	0	4	4	0	4	8	0	0
25	7412640	.	T	G	5	13	18	0	0	18	0	0
25	7412985	.	C	T	4	11	15	0	1	16	0	0
25	7413288	.	T	A	4	3	7	0	1	8	0	0
25	7413501	.	C	T	4	5	9	0	0	9	0	0
25	7413736	.	G	T	4	2	6	0	0	6	0	0
25	7413815	.	G	A	0	2	2	0	2	4	0	0
25	7428932	.	A	C	7	4	11	0	1	12	0	0
25	7428944	.	T	C	6	5	11	0	1	12	0	0
25	7428971	.	A	T	5	7	12	0	0	12	0	0
25	7429028	.	C	A	4	3	7	0	0	7	0	0
25	7431310	.	A	C	1	3	4	0	0	5	1	0
25	7431611	.	G	A	2	5	7	0	1	8	0	0
25	7431626	.	T	C	7	3	10	0	0	10	0	0
25	7439859	.	T	C	1	2	3	0	0	3	0	0
25	7454599	.	T	C	7	3	10	0	3	13	0	0
25	7456535	.	C	A	4	7	11	0	0	11	0	0
25	7456843	.	G	A	0	6	6	0	1	7	0	0
25	7477641	.	C	T	19	17	36	0	5	41	0	0
25	7487835	.	G	C	20	26	46	0	3	49	0	0
25	7488407	.	T	C	26	26	52	0	0	52	0	0
25	7488599	.	G	T	26	14	40	0	0	40	0	0
25	7488660	.	C	T	25	13	38	0	2	40	0	0
25	7488812	.	G	A	26	26	52	0	2	54	0	0
25	7488813	.	G	T	27	24	51	0	3	54	0	0
25	7489011	.	A	T	34	23	57	0	3	60	0	0
25	7489034	.	G	A	5	22	27	0	30	57	0	0
25	7489197	.	G	T	14	15	29	0	0	29	0	0
25	7492888	.	C	T	10	10	20	0	0	20	0	0
25	7492927	.	T	A	6	4	10	0	2	12	0	0
25	7494243	.	G	A	3	8	11	0	8	19	0	0
25	7496003	.	C	T	11	6	17	1	1	19	0	0
25	7496021	.	C	T	9	5	14	1	0	15	0	0
25	7496039	.	C	T	8	4	12	0	0	12	0	0
25	7496992	.	G	C	1	8	9	0	11	20	0	0
25	7500473	.	T	C	24	18	42	0	0	42	0	0
25	7501997	.	G	A	18	12	30	0	2	32	0	0
25	7502022	.	G	C	18	15	33	0	1	34	0	0
25	7502119	.	T	C	13	7	20	0	0	20	0	0
25	7502241	.	G	A	5	5	10	0	0	10	0	0
25	7502271	.	T	G	8	0	8	0	5	13	0	0
25	7533559	.	G	C	4	3	7	0	1	8	0	0
25	7549175	.	G	A	6	4	10	0	0	10	0	0
25	7678424	.	T	C	1	16	17	0	3	20	0	0
25	7891836	.	T	C	2	3	5	0	0	5	0	0
25	7892297	.	T	C	2	5	7	0	1	8	0	0
25	9040834	.	A	G	1	2	3	0	0	3	0	0
25	9678666	.	G	A	7	5	12	0	1	13	0	0
25	9679242	.	G	A	16	10	26	0	5	31	0	0
25	9679389	.	G	A	7	15	22	0	0	22	0	0
25	9679413	.	C	T	0	9	9	0	8	17	0	0
25	9679539	.	T	C	7	4	11	0	0	11	0	0
25	9680022	.	T	C	6	6	12	0	0	12	0	0
25	9680196	.	T	A	2	2	4	0	1	5	0	0
25	9680448	.	A	G	6	9	15	0	1	16	0	0
25	9805253	.	G	C	7	10	17	0	1	18	0	0
25	9805257	.	G	C	8	11	19	0	0	19	0	0
25	11035689	.	G	A	1	2	3	0	0	3	0	0
25	11704083	.	C	G	2	2	4	0	0	4	0	0
25	11796531	.	T	C	13	0	13	0	9	22	0	0
25	11796579	.	T	A	23	9	32	0	0	32	0	0
25	11796728	.	A	T	14	15	29	0	0	29	0	0
25	11796860	.	T	C	13	7	20	0	2	22	0	0
25	11796973	.	T	C	11	1	12	0	8	20	0	0
25	11796987	.	A	G	13	6	19	0	0	19	0	0
25	11797515	.	A	G	15	13	28	0	1	30	1	0
25	11797550	.	G	T	16	10	26	0	0	26	0	0
25	11797789	.	A	T	6	7	13	0	0	13	0	0
25	11797979	.	A	G	3	4	7	0	0	7	0	0
25	11797990	.	A	G	3	3	6	0	0	6	0	0
25	11798043	.	G	A	6	6	12	0	0	12	0	0
25	11798081	.	T	C	10	2	12	0	11	23	0	0
25	11798215	.	A	C	6	6	12	0	0	12	0	0
25	11798227	.	T	A	6	6	12	0	0	13	1	0
25	11798333	.	A	T	7	8	15	0	0	15	0	0
25	11798381	.	T	A	11	14	25	0	0	25	0	0
25	11798509	.	A	T	9	14	23	0	2	25	0	0
25	11798511	.	C	A	0	14	14	0	10	24	0	0
25	11798598	.	C	T	4	5	9	1	0	10	0	0
25	11798659	.	A	T	9	3	12	0	1	13	0	0
25	11798863	.	G	C	4	2	6	0	0	6	0	0
25	11798922	.	A	G	3	3	6	0	0	6	0	0
25	11799527	.	A	T	14	8	22	0	1	23	0	0
25	11799577	.	G	A	16	4	20	0	0	20	0	0
25	11799625	.	A	T	12	4	16	0	0	16	0	0
25	11799685	.	A	G	13	2	15	0	0	15	0	0
25	11800098	.	G	C	10	11	21	0	0	21	0	0
25	11800140	.	A	G	8	7	15	0	0	15	0	0
25	11800319	.	T	G	3	2	5	0	0	5	0	0
25	11800328	.	C	T	1	3	4	0	3	7	0	0
25	11800522	.	G	A	9	6	15	0	1	16	0	0
25	11800652	.	C	T	2	10	12	0	6	18	0	0
25	11801111	.	C	A	2	7	9	0	0	9	0	0
25	11801513	.	A	C	8	8	16	0	0	16	0	0
25	11801642	.	C	G	4	10	14	0	0	14	0	0
25	11801731	.	C	G	3	6	9	0	0	9	0	0
25	11801838	.	A	C	6	0	6	0	5	11	0	0
25	11801841	.	G	T	6	4	10	0	1	11	0	0
25	11802044	.	A	G	6	4	10	0	0	10	0	0
25	11802066	.	C	G	4	7	11	0	0	11	0	0
25	11802115	.	C	A	5	4	9	0	2	11	0	0
25	11802192	.	T	A	5	6	11	0	0	11	0	0
25	11802306	.	C	A	1	6	7	0	12	19	0	0
25	11802485	.	C	T	3	9	12	0	11	23	0	0
25	11803455	.	G	T	7	3	10	0	0	10	0	0
25	11803467	.	A	T	5	4	9	0	0	9	0	0
25	11803996	.	A	C	3	2	5	0	0	5	0	0
25	11804128	.	A	G	0	2	2	0	1	3	0	0
25	11804330	.	C	G	0	5	5	0	4	9	0	0
25	11804688	.	T	G	5	5	10	0	3	13	0	0
25	11805270	.	C	G	2	3	5	0	1	6	0	0
25	11805675	.	T	A	5	3	8	0	1	9	0	0
25	11833526	.	G	A	6	7	13	0	0	13	0	0
25	11844148	.	C	T	6	2	8	0	0	8	0	0
25	11894540	.	G	A	5	4	9	0	1	10	0	0
25	12008336	.	A	G	7	3	10	0	1	11	0	0
25	12853166	.	G	T	2	3	5	0	0	5	0	0
25	12853211	.	C	T	1	6	7	0	0	7	0	0
25	12853640	.	G	A	50	13	63	0	1	64	0	0
25	12853691	.	C	T	10	47	57	0	2	59	0	0
25	12853811	.	G	A	30	12	42	0	4	46	0	0
25	12853971	.	T	A	15	35	50	0	2	52	0	0
25	12854112	.	C	T	41	19	60	0	1	61	0	0
25	12854201	.	C	T	25	19	44	1	0	45	0	0
25	12854266	.	A	T	14	23	37	1	4	43	1	0
25	13104333	.	C	A	1	12	13	0	4	17	0	0
25	13180109	.	C	A	3	3	6	0	0	6	0	0
25	13332531	.	C	T	33	28	61	0	3	64	0	0
25	13332693	.	G	A	35	35	70	0	3	73	0	0
25	13332737	.	A	G	46	33	79	0	7	86	0	0
25	13333027	.	A	G	43	27	70	1	3	74	0	0
25	13333287	.	A	G	30	40	70	0	4	74	0	0
25	13333986	.	T	A	43	34	77	0	3	80	0	0
25	13333994	.	C	T	47	35	82	0	5	87	0	0
25	13334023	.	T	A	49	29	78	0	3	81	0	0
25	13334049	.	A	T	44	29	73	0	5	78	0	0
25	13334061	.	A	G	47	27	74	0	2	76	0	0
25	13334334	.	A	T	36	28	64	0	3	67	0	0
25	13334371	.	T	C	45	27	72	0	2	74	0	0
25	13334397	.	C	G	43	29	72	0	3	75	0	0
25	13334429	.	T	C	34	33	67	0	6	73	0	0
25	13334526	.	A	G	48	20	68	0	3	71	0	0
25	13334537	.	T	C	54	0	54	0	13	67	0	0
25	13334729	.	C	T	41	37	78	0	4	82	0	0
25	13335021	.	G	T	38	29	67	0	4	71	0	0
25	13335059	.	G	C	46	18	64	0	2	68	2	0
25	13335078	.	A	G	41	23	64	0	1	65	0	0
25	13335185	.	A	G	34	29	63	0	4	67	0	0
25	13335225	.	T	C	39	26	65	0	2	67	0	0
25	13335331	.	T	C	23	39	62	0	2	64	0	0
25	13335359	.	C	T	2	37	39	1	26	66	0	0
25	13335524	.	T	C	33	25	58	0	2	60	0	0
25	13335892	.	A	G	31	34	65	0	2	67	0	0
25	13335897	.	T	C	29	33	62	0	1	63	0	0
25	13336236	.	G	T	48	14	62	0	6	68	0	0
25	13336391	.	G	A	37	34	71	0	3	74	0	0
25	13336409	.	A	C	39	30	69	0	5	74	0	0
25	13336755	.	G	T	28	40	68	0	6	74	0	0
25	13336780	.	A	G	27	40	67	0	1	68	0	0
25	13336815	.	T	A	31	36	67	0	4	71	0	0
25	13336967	.	T	A	29	30	59	0	3	62	0	0
25	13337044	.	G	A	30	30	60	1	6	67	0	0
25	13337136	.	A	G	29	34	63	0	0	63	0	0
25	13340180	.	C	T	36	31	67	1	1	69	0	0
25	13346723	.	G	A	28	33	61	0	4	65	0	0
25	13346730	.	A	G	33	33	66	0	1	67	0	0
25	13350259	.	A	G	45	23	68	0	3	71	0	0
25	13351894	.	T	A	35	35	70	0	1	71	0	0
25	13352304	.	T	A	34	29	63	0	2	65	0	0
25	13352316	.	A	G	31	27	58	0	6	64	0	0
25	13353747	.	G	A	26	37	63	0	1	64	0	0
25	13469844	.	A	G	14	0	14	0	16	30	0	0
25	13469858	.	T	C	9	15	24	0	0	24	0	0
25	13470424	.	C	T	10	14	24	0	0	24	0	0
25	13470430	.	A	T	11	13	24	0	2	26	0	0
25	13470544	.	A	T	9	5	14	2	0	16	0	0
25	13471127	.	A	G	11	0	11	1	12	24	0	0
25	13474246	.	C	T	4	4	8	0	0	8	0	0
25	13474362	.	C	G	7	3	10	0	1	11	0	0
25	13474411	.	A	G	3	6	9	0	1	10	0	0
25	13479710	.	G	A	4	5	9	0	0	9	0	0
25	13509942	.	T	A	7	7	14	0	1	15	0	0
25	13510356	.	A	G	8	6	14	0	0	14	0	0
25	13525164	.	A	T	6	7	13	0	0	13	0	0
25	13525295	.	C	G	16	8	24	0	0	24	0	0
25	13525407	.	G	A	12	14	26	0	1	27	0	0
25	13525453	.	C	T	17	15	32	0	1	33	0	0
25	13525521	.	A	C	6	10	16	0	2	18	0	0
25	13525633	.	A	C	13	9	22	0	0	22	0	0
25	13525848	.	A	T	25	9	34	0	3	37	0	0
25	13525864	.	G	A	22	8	30	0	2	32	0	0
25	13525890	.	A	C	17	13	30	0	1	31	0	0
25	13526171	.	A	C	17	15	32	0	1	33	0	0
25	13529294	.	A	G	4	7	11	0	0	11	0	0
25	13536504	.	T	A	2	2	4	0	0	4	0	0
25	13559168	.	T	G	4	5	9	0	0	10	1	0
25	13559194	.	G	A	4	5	9	0	1	10	0	0
25	13559220	.	G	A	7	6	13	0	1	14	0	0
25	13559446	.	T	A	7	13	20	0	2	22	0	0
25	13559500	.	T	C	3	11	14	0	1	15	0	0
25	13559723	.	T	A	2	5	7	0	0	7	0	0
25	13559740	.	A	G	2	7	9	0	1	10	0	0
25	13559760	.	T	C	4	1	5	0	8	13	0	0
25	13559953	.	A	T	8	15	23	1	2	26	0	0
25	13560080	.	C	T	2	5	7	0	1	8	0	0
25	13560136	.	C	T	3	10	13	0	1	14	0	0
25	13560149	.	C	T	3	9	12	0	1	13	0	0
25	13560186	.	A	G	9	6	15	0	0	15	0	0
25	13560207	.	T	C	9	6	15	0	0	15	0	0
25	13560547	.	C	T	1	14	15	0	10	25	0	0
25	13560576	.	C	T	14	9	23	0	1	24	0	0
25	13560598	.	T	G	13	7	20	0	0	20	0	0
25	13560638	.	C	A	6	4	10	0	0	10	0	0
25	13561133	.	T	C	2	3	5	0	0	5	0	0
25	13561149	.	T	C	2	4	6	0	0	6	0	0
25	13561296	.	A	G	6	11	17	0	0	17	0	0
25	13561775	.	C	A	0	9	9	0	3	12	0	0
25	13561851	.	A	C	3	4	7	0	0	7	0	0
25	13562066	.	G	A	2	3	5	0	0	5	0	0
25	13562371	.	G	A	3	5	8	0	0	8	0	0
25	13562742	.	T	C	10	0	10	1	9	20	0	0
25	13614475	.	G	C	8	0	8	0	5	13	0	0
25	13614509	.	C	G	6	3	9	0	0	9	0	0
25	13614593	.	G	A	2	2	4	0	1	5	0	0
25	13614668	.	G	A	3	2	5	0	1	6	0	0
25	13645911	.	C	T	14	14	28	0	0	28	0	0
25	13646153	.	G	A	7	8	15	0	0	15	0	0
25	13649206	.	C	T	2	9	11	0	8	19	0	0
25	13651394	.	A	T	9	11	20	0	4	24	0	0
25	13658316	.	C	T	1	10	11	0	10	21	0	0
25	13658940	.	G	A	6	13	19	0	3	22	0	0
25	13658976	.	T	C	6	0	6	0	13	19	0	0
25	13659075	.	T	A	12	10	22	0	0	22	0	0
25	13672106	.	T	A	6	5	11	0	1	12	0	0
25	13672111	.	A	T	6	7	13	0	1	14	0	0
25	13672226	.	C	T	5	6	11	0	2	13	0	0
25	13672349	.	G	A	2	4	6	0	0	6	0	0
25	13672629	.	A	C	4	4	8	0	0	8	0	0
25	13673119	.	A	G	7	5	12	0	2	14	0	0
25	13673377	.	A	G	8	5	13	0	2	15	0	0
25	13674202	.	A	G	4	4	8	0	1	9	0	0
25	13674214	.	A	G	7	4	11	0	0	11	0	0
25	13674307	.	C	T	5	2	7	0	0	7	0	0
25	13676274	.	T	C	2	2	4	0	0	4	0	0
25	13677352	.	G	A	0	3	3	0	2	5	0	0
25	13677396	.	A	G	3	7	10	0	0	10	0	0
25	13677519	.	C	T	3	2	5	0	0	5	0	0
25	13680295	.	A	G	1	5	6	0	0	6	0	0
25	13685517	.	T	C	2	4	6	0	0	6	0	0
25	13689166	.	G	A	2	4	6	0	0	6	0	0
25	13689341	.	T	C	5	3	8	0	1	9	0	0
25	13689359	.	C	A	5	5	10	0	0	10	0	0
25	13689486	.	T	C	6	0	6	0	5	11	0	0
25	13689575	.	A	G	9	3	12	0	0	12	0	0
25	13689612	.	A	G	6	4	10	0	0	10	0	0
25	13689617	.	C	A	5	5	10	0	0	10	0	0
25	13689725	.	C	T	2	2	4	1	0	5	0	0
25	13689945	.	G	A	6	4	10	0	1	11	0	0
25	13695726	.	G	A	2	2	4	0	0	4	0	0
25	13698970	.	G	A	4	4	8	0	0	8	0	0
25	13744547	.	G	T	3	3	6	0	0	6	0	0
25	13744587	.	T	C	1	6	7	0	0	7	0	0
25	13745659	.	A	G	30	36	66	0	0	66	0	0
25	13745665	.	A	G	29	35	64	0	3	67	0	0
25	13745776	.	A	G	31	16	47	0	1	48	0	0
25	13745788	.	A	C	30	2	32	0	16	48	0	0
25	13747722	.	G	C	25	1	26	0	27	53	0	0
25	13747948	.	T	C	20	1	21	0	20	41	0	0
25	13750734	.	T	A	15	18	33	0	0	33	0	0
25	13754015	.	A	G	25	18	43	0	0	43	0	0
25	13754094	.	T	A	17	21	38	0	0	38	0	0
25	13754338	.	T	G	17	17	34	0	0	35	1	0
25	13754359	.	A	G	12	19	31	0	1	32	0	0
25	13759547	.	G	A	19	15	34	0	2	36	0	0
25	13762889	.	T	C	17	13	30	0	2	32	0	0
25	13763626	.	A	G	9	16	25	0	1	26	0	0
25	13763641	.	C	T	7	15	22	0	0	22	0	0
25	13767612	.	G	A	11	10	21	0	0	21	0	0
25	13767726	.	G	A	18	16	34	0	0	34	0	0
25	13768396	.	G	A	14	16	30	0	1	31	0	0
25	13768547	.	A	G	14	13	27	0	3	30	0	0
25	13774036	.	C	T	14	16	30	0	0	30	0	0
25	13774400	.	G	A	12	11	23	0	1	24	0	0
25	13775158	.	A	G	12	16	28	0	1	29	0	0
25	13776771	.	T	A	4	5	9	0	0	9	0	0
25	13777997	.	T	A	2	6	8	0	0	8	0	0
25	13780322	.	C	G	11	10	21	0	1	22	0	0
25	13782361	.	T	C	3	2	5	0	0	5	0	0
25	13782376	.	A	G	4	3	7	0	0	7	0	0
25	13782544	.	A	G	9	8	17	0	0	17	0	0
25	13787514	.	A	T	14	13	27	0	1	28	0	0
25	13791853	.	A	C	8	10	18	0	1	19	0	0
25	13795332	.	G	A	16	17	33	0	1	34	0	0
25	13795440	.	T	C	22	13	35	0	0	35	0	0
25	13795441	.	G	A	21	13	34	0	1	35	0	0
25	13795494	.	A	G	28	16	44	0	1	45	0	0
25	13796379	.	T	C	31	21	52	0	0	52	0	0
25	13799172	.	G	A	1	4	5	0	1	6	0	0
25	13799689	.	C	T	13	18	31	0	2	33	0	0
25	13801895	.	G	C	16	11	27	0	1	28	0	0
25	13801933	.	C	T	18	19	37	0	0	37	0	0
25	13802100	.	C	T	18	19	37	0	6	43	0	0
25	13802235	.	T	A	8	15	23	0	0	23	0	0
25	13802673	.	C	T	3	15	18	0	16	34	0	0
25	13802710	.	C	T	15	17	32	0	2	34	0	0
25	13802876	.	G	A	17	20	37	0	3	40	0	0
25	13802901	.	G	A	17	23	40	0	2	42	0	0
25	13802918	.	A	G	16	25	41	0	0	41	0	0
25	13802940	.	A	T	19	19	38	0	3	41	0	0
25	13803710	.	A	G	20	20	40	0	1	41	0	0
25	13803712	.	T	G	20	20	40	0	1	41	0	0
25	13803895	.	A	G	17	13	30	0	2	32	0	0
25	13803903	.	C	T	17	19	36	0	0	36	0	0
25	13804056	.	C	T	17	19	36	0	2	38	0	0
25	13804097	.	T	A	18	31	49	0	1	50	0	0
25	13804216	.	C	T	19	17	36	0	2	38	0	0
25	13813656	.	A	G	19	18	37	0	0	37	0	0
25	13813659	.	G	A	18	18	36	0	1	37	0	0
25	13815325	.	G	A	16	15	31	0	0	31	0	0
25	13815361	.	A	G	14	21	35	0	1	36	0	0
25	13816724	.	G	A	16	12	28	0	1	29	0	0
25	13816840	.	C	T	1	7	8	0	14	22	0	0
25	13817135	.	C	G	14	11	25	0	0	25	0	0
25	13817243	.	C	T	0	13	13	0	10	23	0	0
25	13821187	.	C	T	15	10	25	0	0	25	0	0
25	13846984	.	A	G	6	5	11	0	1	12	0	0
25	13847533	.	A	G	11	13	24	0	2	26	0	0
25	13848801	.	G	A	19	12	31	0	2	33	0	0
25	13848930	.	A	G	19	19	38	0	0	38	0	0
25	13850757	.	A	C	24	17	41	0	1	42	0	0
25	13854838	.	G	A	10	12	22	0	1	23	0	0
25	13855707	.	T	A	9	14	23	0	2	25	0	0
25	13856023	.	C	A	3	13	16	0	11	27	0	0
25	13871070	.	C	T	8	15	23	0	0	23	0	0
25	14017624	.	C	G	1	2	3	0	0	3	0	0
25	14017632	.	A	G	1	3	4	0	0	4	0	0
25	14018007	.	T	C	8	6	14	0	0	14	0	0
25	14018872	.	T	G	5	5	10	0	2	12	0	0
25	14019921	.	G	A	0	10	10	0	17	27	0	0
25	14020872	.	G	A	1	3	4	0	6	10	0	0
25	14020923	.	C	A	5	5	10	0	0	10	0	0
25	14020924	.	A	C	5	5	10	0	0	10	0	0
25	14020973	.	C	T	3	2	5	0	0	5	0	0
25	14021000	.	A	C	2	2	4	0	0	4	0	0
25	14033013	.	G	C	3	3	6	0	0	6	0	0
25	14033268	.	T	C	21	6	27	0	2	29	0	0
25	14033670	.	T	G	9	8	17	0	1	18	0	0
25	14033867	.	A	G	9	7	16	0	1	17	0	0
25	14033914	.	G	A	7	5	12	0	0	12	0	0
25	14033984	.	G	T	9	7	16	0	1	17	0	0
25	14034033	.	T	C	3	6	9	0	1	11	1	0
25	14034065	.	T	C	9	6	15	0	0	15	0	0
25	14034240	.	G	C	22	16	38	0	2	40	0	0
25	14034398	.	C	T	21	10	31	0	1	32	0	0
25	14034406	.	G	A	20	13	33	0	0	33	0	0
25	14034512	.	C	T	12	12	24	0	2	26	0	0
25	14034513	.	T	A	13	13	26	0	0	26	0	0
25	14034620	.	A	G	10	9	19	0	5	24	0	0
25	14034667	.	C	T	18	5	23	0	0	23	0	0
25	14034725	.	T	A	15	6	21	0	0	21	0	0
25	14034881	.	T	C	15	13	28	0	1	29	0	0
25	14034911	.	C	G	17	12	29	0	1	30	0	0
25	14035012	.	T	G	8	8	16	0	1	17	0	0
25	14035017	.	T	A	7	9	16	0	0	16	0	0
25	14035229	.	C	T	7	10	17	0	0	17	0	0
25	14035247	.	T	G	10	8	18	0	2	20	0	0
25	14035414	.	A	T	13	8	21	0	0	21	0	0
25	14035500	.	T	G	10	9	19	0	1	20	0	0
25	14035507	.	T	C	12	4	16	0	1	17	0	0
25	14035559	.	T	G	9	4	13	0	0	13	0	0
25	14035684	.	A	C	5	4	9	0	0	9	0	0
25	14035833	.	A	C	5	6	11	0	0	11	0	0
25	14035834	.	A	T	4	6	10	0	0	10	0	0
25	14035908	.	A	C	9	4	13	0	1	14	0	0
25	14035990	.	T	C	6	0	6	0	3	9	0	0
25	14351449	.	C	T	5	5	10	0	0	10	0	0
25	14351932	.	G	A	0	5	5	0	6	11	0	0
25	14361812	.	C	T	12	10	22	0	2	24	0	0
25	14363216	.	C	T	13	14	27	0	1	28	0	0
25	14363291	.	T	A	17	14	31	0	0	31	0	0
25	14363572	.	G	T	14	16	30	0	0	30	0	0
25	14365546	.	G	A	21	20	41	0	1	42	0	0
25	14365781	.	C	T	12	16	28	0	1	29	0	0
25	14365834	.	C	T	14	9	23	0	2	25	0	0
25	14366056	.	T	A	13	11	24	0	0	24	0	0
25	14369587	.	G	T	6	6	12	0	0	12	0	0
25	14369631	.	C	T	7	11	18	0	2	20	0	0
25	14369712	.	G	A	7	14	21	0	3	24	0	0
25	14369869	.	T	A	10	8	18	0	1	19	0	0
25	14369883	.	T	C	14	3	17	0	8	25	0	0
25	14374076	.	G	A	9	7	16	0	0	16	0	0
25	14381513	.	G	T	2	5	7	0	0	7	0	0
25	14381583	.	A	G	4	13	17	0	1	18	0	0
25	14381763	.	G	A	22	20	42	0	0	42	0	0
25	14384028	.	G	T	17	15	32	0	2	34	0	0
25	14387616	.	C	T	25	15	40	0	0	40	0	0
25	14388955	.	A	T	13	12	25	0	2	27	0	0
25	14392808	.	C	G	14	12	26	0	1	27	0	0
25	14393533	.	A	G	12	14	26	0	0	26	0	0
25	14398703	.	A	C	5	5	10	1	0	11	0	0
25	14398744	.	A	T	15	13	28	1	0	29	0	0
25	14401150	.	C	T	11	6	17	0	1	18	0	0
25	14401219	.	C	A	8	12	20	0	0	20	0	0
25	14401374	.	C	G	17	7	24	0	0	24	0	0
25	14403369	.	T	C	13	11	24	0	0	24	0	0
25	14403404	.	C	T	13	7	20	0	0	20	0	0
25	14406608	.	A	C	11	4	15	0	0	15	0	0
25	14406621	.	T	C	4	10	14	0	1	15	0	0
25	14406649	.	A	T	3	10	13	0	0	13	0	0
25	14409222	.	T	A	3	3	6	0	0	6	0	0
25	14409257	.	A	C	4	0	4	0	4	8	0	0
25	14409642	.	G	A	6	3	9	0	0	9	0	0
25	14409936	.	T	C	4	1	5	0	3	8	0	0
25	14426595	.	A	T	2	2	4	0	0	4	0	0
25	14511458	.	T	A	2	5	7	0	0	7	0	0
25	14511470	.	G	T	2	2	4	0	1	5	0	0
25	14511493	.	G	T	1	3	4	0	0	4	0	0
25	14511584	.	T	A	0	7	7	0	2	9	0	0
25	14517370	.	C	G	0	3	3	0	1	4	0	0
25	14518815	.	A	G	3	2	5	0	0	5	0	0
25	14694942	.	C	T	2	3	5	0	0	5	0	0
25	14694979	.	T	C	5	4	9	0	0	9	0	0
25	14695065	.	T	C	10	5	15	0	1	16	0	0
25	14695092	.	C	T	8	9	17	0	0	17	0	0
25	14695122	.	A	G	2	0	2	0	11	13	0	0
25	14702821	.	C	T	6	7	13	2	1	16	0	0
25	14733824	.	C	T	2	5	7	0	0	7	0	0
25	14734122	.	A	G	4	9	13	0	0	13	0	0
25	14738244	.	A	G	2	4	6	0	0	6	0	0
25	14738298	.	T	C	3	3	6	0	0	6	0	0
25	14738462	.	T	A	1	4	5	0	1	6	0	0
25	14738535	.	A	T	3	4	7	0	0	7	0	0
25	14738541	.	T	C	3	4	7	0	0	7	0	0
25	14870811	.	T	C	3	3	6	0	0	6	0	0
25	15029225	.	C	T	6	7	13	0	1	14	0	0
25	15031773	.	G	A	12	12	24	0	0	24	0	0
25	15031851	.	A	G	17	13	30	0	2	32	0	0
25	15032087	.	A	G	20	8	28	0	0	28	0	0
25	15034012	.	C	T	0	7	7	0	15	22	0	0
25	15045221	.	T	A	7	4	11	0	0	11	0	0
25	15273455	.	A	T	8	10	18	0	1	19	0	0
25	15275985	.	G	A	1	6	7	0	0	7	0	0
25	15276105	.	T	C	8	5	13	0	0	13	0	0
25	15281889	.	C	T	6	9	15	0	0	15	0	0
25	15281891	.	A	G	8	9	17	0	0	17	0	0
25	15284485	.	T	C	8	5	13	0	2	15	0	0
25	15284644	.	C	G	11	1	12	0	9	21	0	0
25	15284734	.	G	T	19	12	31	0	1	32	0	0
25	15284799	.	C	T	17	16	33	0	0	33	0	0
25	15284862	.	T	C	12	15	27	0	0	27	0	0
25	15284959	.	T	C	17	14	31	0	0	31	0	0
25	15285004	.	A	C	13	9	22	0	1	23	0	0
25	15285092	.	T	C	8	15	23	0	1	24	0	0
25	15285105	.	C	A	7	16	23	0	0	23	0	0
25	15285213	.	G	C	8	15	23	0	1	24	0	0
25	15285256	.	T	A	9	17	26	0	0	26	0	0
25	15285470	.	C	T	3	10	13	0	0	13	0	0
25	15285471	.	C	A	3	10	13	0	0	13	0	0
25	15292574	.	T	G	2	2	4	0	1	5	0	0
25	15292705	.	G	A	1	2	3	0	1	4	0	0
25	15342700	.	G	A	3	5	8	0	1	9	0	0
25	15345474	.	C	A	8	3	11	0	3	14	0	0
25	15347416	.	A	G	2	0	2	0	7	9	0	0
25	15347460	.	G	A	1	5	6	0	3	9	0	0
25	15347613	.	A	G	4	0	4	0	4	8	0	0
25	15347688	.	G	A	5	4	9	0	0	9	0	0
25	15348263	.	A	T	5	2	7	0	0	7	0	0
25	15350012	.	A	G	9	6	15	0	0	15	0	0
25	15350016	.	G	A	9	5	14	0	1	15	0	0
25	15350058	.	A	G	8	6	14	0	0	14	0	0
25	15350402	.	T	G	7	8	15	0	0	15	0	0
25	15350467	.	T	C	2	8	10	0	0	11	1	0
25	15351088	.	A	G	11	11	22	0	0	22	0	0
25	15354333	.	G	T	16	5	21	0	1	22	0	0
25	15354360	.	C	T	13	6	19	0	1	20	0	0
25	15404898	.	G	A	15	23	38	0	1	39	0	0
25	15408820	.	G	A	2	25	27	0	16	43	0	0
25	15409013	.	T	C	8	17	25	0	2	27	0	0
25	15430310	.	T	C	16	19	35	0	2	37	0	0
25	15430334	.	T	C	12	21	33	0	1	34	0	0
25	15432769	.	G	A	16	13	29	0	2	31	0	0
25	15434566	.	T	C	18	15	33	0	4	37	0	0
25	15434579	.	C	T	21	17	38	0	3	41	0	0
25	15438723	.	G	A	3	18	21	0	26	47	0	0
25	15438789	.	C	A	19	16	35	0	0	35	0	0
25	15450807	.	C	G	28	15	43	1	1	45	0	0
25	15465167	.	T	C	29	16	45	0	3	48	0	0
25	15472286	.	C	A	32	27	59	0	2	62	1	0
25	15477186	.	G	A	3	18	21	0	27	48	0	0
25	15478092	.	A	G	35	32	67	0	3	70	0	0
25	15480676	.	G	A	9	29	38	0	24	62	0	0
25	15480711	.	T	C	23	23	46	0	6	52	0	0
25	15481040	.	C	T	7	17	24	9	4	37	0	0
25	15481240	.	A	G	22	24	46	0	7	53	0	0
25	15481481	.	T	G	18	19	37	0	1	38	0	0
25	15481759	.	G	A	22	27	49	0	0	49	0	0
25	15482251	.	T	C	8	2	10	0	1	11	0	0
25	15482335	.	G	A	2	4	6	0	0	6	0	0
25	15648042	.	G	A	5	13	18	0	0	18	0	0
25	15648092	.	A	G	4	10	14	0	0	14	0	0
25	15648237	.	T	A	7	8	15	0	0	15	0	0
25	15648243	.	C	A	7	4	11	0	3	14	0	0
25	15648330	.	C	A	7	12	19	0	3	22	0	0
25	15648342	.	G	C	8	12	20	0	1	21	0	0
25	15649992	.	G	A	10	10	20	0	0	20	0	0
25	16963906	.	T	C	2	4	6	0	0	6	0	0
25	17418280	.	G	A	1	6	7	0	1	8	0	0
25	17479273	.	T	C	2	1	3	0	5	8	0	0
25	17479278	.	T	C	3	4	7	0	0	7	0	0
25	17479487	.	A	G	6	2	8	0	0	8	0	0
25	17892352	.	A	T	7	3	10	0	0	10	0	0
25	17959075	.	T	A	3	1	4	0	1	5	0	0
25	18907561	.	A	G	2	3	5	0	0	5	0	0
25	18908651	.	A	G	7	4	11	0	1	12	0	0
25	18961695	.	C	T	4	3	7	0	0	7	0	0
25	18977011	.	A	G	1	2	3	0	0	3	0	0
25	18977066	.	A	G	5	4	9	0	0	9	0	0
25	18977092	.	A	G	1	6	7	0	1	8	0	0
25	19189301	.	T	C	2	2	4	0	1	5	0	0
25	19932096	.	C	T	1	8	9	0	0	9	0	0
25	19933582	.	A	G	3	2	5	0	0	5	0	0
25	20998134	.	A	G	2	5	7	0	1	8	0	0
25	21518625	.	T	A	2	2	4	0	0	4	0	0
25	22079521	.	G	A	1	4	5	0	4	9	0	0
25	22079673	.	C	T	2	4	6	0	0	6	0	0
25	22079682	.	T	C	0	4	4	0	1	5	0	0
25	22085155	.	C	A	4	7	11	0	0	11	0	0
25	22095022	.	C	T	1	5	6	0	1	7	0	0
25	22095054	.	G	A	1	4	5	0	1	6	0	0
25	22095118	.	A	G	3	5	8	0	1	9	0	0
25	22095199	.	T	C	2	3	5	0	1	6	0	0
25	22095325	.	G	C	1	4	5	0	0	5	0	0
25	22095498	.	T	G	1	2	3	0	0	3	0	0
25	22095549	.	A	T	3	2	5	0	0	5	0	0
25	22225037	.	G	T	4	2	6	0	0	6	0	0
25	22228713	.	G	T	0	2	2	0	1	3	0	0
25	22232767	.	A	T	5	4	9	0	0	9	0	0
25	22232831	.	C	A	2	6	8	0	0	8	0	0
25	22232870	.	C	T	6	6	12	0	0	12	0	0
25	22281504	.	C	A	1	4	5	0	0	5	0	0
25	22291805	.	G	A	5	7	12	0	0	12	0	0
25	22292558	.	G	A	2	2	4	0	0	4	0	0
25	22634029	.	C	T	1	2	3	0	0	3	0	0
25	22635759	.	A	G	32	25	57	0	2	59	0	0
25	22635812	.	T	G	34	20	54	0	2	56	0	0
25	22636075	.	C	A	21	18	39	1	2	42	0	0
25	22636574	.	G	A	32	22	54	0	5	59	0	0
25	22636967	.	C	T	20	19	39	0	2	41	0	0
25	22637012	.	C	T	20	20	40	0	4	44	0	0
25	22637039	.	A	G	26	23	49	0	0	49	0	0
25	22637290	.	C	A	3	14	17	0	33	51	1	0
25	22637384	.	G	A	22	21	43	0	3	46	0	0
25	22637444	.	A	T	16	26	42	0	0	42	0	0
25	22637501	.	A	G	24	19	43	0	1	44	0	0
25	22637584	.	A	T	20	15	35	0	4	39	0	0
25	22637667	.	T	C	28	18	46	0	1	47	0	0
25	22637729	.	G	T	24	22	46	0	2	49	1	0
25	22637732	.	G	A	23	23	46	0	2	48	0	0
25	22637873	.	C	A	17	25	42	0	1	43	0	0
25	22638170	.	C	G	2	7	9	0	8	17	0	0
25	22639039	.	G	A	21	13	34	0	1	35	0	0
25	22730504	.	T	C	10	6	16	0	0	16	0	0
25	22730594	.	G	A	0	3	3	0	6	9	0	0
25	23555998	.	A	T	3	4	7	0	0	7	0	0
25	23556378	.	C	G	7	6	13	0	0	13	0	0
25	23556452	.	T	C	7	5	12	0	2	14	0	0
25	23562487	.	C	T	0	12	12	0	6	18	0	0
25	23571614	.	A	G	9	6	15	0	1	16	0	0
25	23571823	.	T	C	4	9	13	0	0	13	0	0
25	23583076	.	G	C	4	0	4	0	4	8	0	0
25	23609121	.	A	G	3	0	3	0	3	6	0	0
25	23625907	.	G	A	3	2	5	0	0	5	0	0
25	23630635	.	A	C	3	4	7	0	2	9	0	0
25	23630701	.	C	T	5	3	8	0	0	8	0	0
25	23631148	.	C	T	3	6	9	0	0	9	0	0
25	23636135	.	G	T	5	2	7	0	0	7	0	0
25	23636144	.	C	T	5	2	7	0	1	8	0	0
25	23636329	.	C	T	5	3	8	0	2	10	0	0
25	23643111	.	A	C	3	7	10	0	0	10	0	0
25	23643122	.	A	T	4	7	11	0	0	11	0	0
25	23643477	.	C	T	6	3	9	0	0	9	0	0
25	23777510	.	C	A	7	9	16	0	1	17	0	0
25	23777545	.	G	A	15	16	31	0	1	32	0	0
25	23815540	.	C	T	13	15	28	0	0	28	0	0
25	24039661	.	T	C	3	1	4	0	2	6	0	0
25	24040247	.	A	C	7	4	11	0	0	11	0	0
25	24040312	.	T	C	2	1	3	0	1	4	0	0
25	24041044	.	T	C	1	1	2	0	0	2	0	0
25	24055419	.	T	C	1	0	1	0	4	5	0	0
25	24059983	.	A	G	7	7	14	0	0	14	0	0
25	24059991	.	A	G	8	8	16	0	0	16	0	0
25	24060460	.	G	A	7	5	12	0	0	12	0	0
25	24179052	.	T	C	1	2	3	0	0	3	0	0
25	24179588	.	G	A	0	3	3	0	2	5	0	0
25	24188421	.	C	T	0	3	3	0	1	4	0	0
25	24237087	.	A	T	1	2	3	0	0	3	0	0
25	24237184	.	C	T	2	3	5	0	0	5	0	0
25	24237196	.	T	C	2	3	5	0	0	5	0	0
25	24237636	.	G	A	10	11	21	1	2	24	0	0
25	24238066	.	T	G	11	8	19	0	0	19	0	0
25	24238134	.	A	C	18	1	19	0	0	19	0	0
25	24238243	.	T	C	4	4	8	0	0	8	0	0
25	24240918	.	C	T	7	9	16	0	2	18	0	0
25	24241338	.	T	G	10	13	23	0	1	25	1	0
25	24241350	.	G	A	10	15	25	0	1	26	0	0
25	24242001	.	A	G	4	8	12	0	0	12	0	0
25	24242103	.	A	G	9	13	22	0	0	22	0	0
25	24242115	.	T	C	10	12	22	0	0	22	0	0
25	24247267	.	C	G	7	16	23	0	0	23	0	0
25	24247282	.	A	C	10	16	26	0	0	26	0	0
25	24247758	.	A	C	10	1	11	0	10	21	0	0
25	24247765	.	T	C	10	10	20	0	1	21	0	0
25	24247814	.	T	C	2	10	12	0	0	12	0	0
25	24247852	.	A	G	2	6	8	0	0	8	0	0
25	24247985	.	G	A	5	2	7	0	0	7	0	0
25	24250326	.	T	A	6	2	8	0	0	8	0	0
25	24264276	.	G	A	1	3	4	0	4	8	0	0
25	24291451	.	T	C	1	2	3	0	0	3	0	0
25	24291519	.	A	T	1	4	5	0	0	5	0	0
25	24292287	.	C	A	3	2	5	0	0	5	0	0
25	24292708	.	G	A	2	2	4	0	0	4	0	0
25	24388630	.	A	G	3	0	3	0	5	8	0	0
25	24555186	.	G	T	3	3	6	0	0	6	0	0
25	24593493	.	G	A	0	4	4	0	2	6	0	0
25	24593517	.	C	T	2	3	5	0	0	5	0	0
25	24593766	.	A	G	2	2	4	0	0	4	0	0
25	24593833	.	A	T	5	10	15	0	0	15	0	0
25	24594339	.	C	T	4	3	7	0	1	8	0	0
25	24594474	.	T	G	2	0	2	0	5	7	0	0
25	24596961	.	T	C	3	6	9	0	0	9	0	0
25	24596976	.	T	A	4	6	10	0	0	10	0	0
25	24598869	.	T	C	7	4	11	0	0	11	0	0
25	24605595	.	G	T	5	7	12	0	1	13	0	0
25	24605598	.	A	C	5	8	13	0	0	13	0	0
25	24607933	.	A	G	9	0	9	0	7	16	0	0
25	24609348	.	C	T	6	3	9	0	0	9	0	0
25	24609418	.	A	T	3	5	8	0	0	8	0	0
25	24609463	.	T	A	6	5	11	0	1	12	0	0
25	24609515	.	A	G	6	7	13	0	3	16	0	0
25	24610020	.	G	A	6	4	10	0	0	10	0	0
25	24610030	.	T	C	5	3	8	0	0	8	0	0
25	24610543	.	A	T	6	5	11	0	0	11	0	0
25	24610544	.	A	G	6	5	11	0	0	11	0	0
25	24617114	.	G	T	1	2	3	0	0	3	0	0
25	24686137	.	A	G	1	0	1	0	4	5	0	0
25	24714919	.	C	T	1	3	4	0	0	4	0	0
25	24714928	.	T	C	1	3	4	0	0	4	0	0
25	24716984	.	A	G	1	0	1	0	2	3	0	0
25	24716990	.	C	G	1	1	2	0	0	2	0	0
25	24720580	.	A	G	3	3	6	0	0	6	0	0
25	24736579	.	A	T	4	16	20	0	0	20	0	0
25	24736828	.	A	T	4	2	6	0	0	6	0	0
25	24736875	.	T	G	4	7	11	0	0	11	0	0
25	24736921	.	G	A	5	3	8	0	0	8	0	0
25	24737026	.	C	T	7	7	14	0	1	15	0	0
25	24737154	.	C	T	0	3	3	0	3	6	0	0
25	24737215	.	C	T	12	7	19	0	2	21	0	0
25	24737244	.	A	C	9	6	15	0	2	17	0	0
25	24737664	.	C	A	3	15	18	0	0	18	0	0
25	24737961	.	C	T	1	7	8	0	0	8	0	0
25	24738023	.	T	C	3	0	3	0	4	7	0	0
25	24738084	.	T	C	16	0	16	0	9	25	0	0
25	24738114	.	C	G	18	9	27	0	0	27	0	0
25	24738754	.	T	C	2	5	7	0	0	7	0	0
25	24738826	.	G	A	2	12	14	0	2	16	0	0
25	24739029	.	A	G	11	11	22	0	0	22	0	0
25	24752181	.	A	G	7	17	24	0	0	24	0	0
25	24760448	.	C	A	0	8	8	0	7	15	0	0
25	24763746	.	A	G	5	5	10	0	0	10	0	0
25	24763755	.	G	T	5	6	11	0	1	12	0	0
25	24770089	.	G	A	11	20	31	0	1	32	0	0
25	24792647	.	C	A	6	9	15	0	1	16	0	0
25	24805912	.	T	A	4	5	9	0	0	9	0	0
25	24826237	.	G	T	2	7	9	0	0	9	0	0
25	24826240	.	T	C	2	0	2	0	6	8	0	0
25	24826290	.	A	G	5	6	11	0	0	11	0	0
25	24847561	.	A	T	6	3	9	0	0	9	0	0
25	25058302	.	C	T	5	3	8	0	1	9	0	0
25	25058334	.	A	C	3	0	3	0	6	9	0	0
25	25058469	.	T	C	2	3	5	0	0	5	0	0
25	25123445	.	T	C	14	16	30	0	1	31	0	0
25	25124779	.	A	T	12	18	30	0	2	33	1	0
25	25127090	.	C	T	19	23	42	0	1	43	0	0
25	25127250	.	A	G	20	23	43	0	1	44	0	0
25	25130648	.	C	T	23	32	55	0	2	57	0	0
25	25130693	.	C	T	30	30	60	0	2	62	0	0
25	25130747	.	C	T	25	26	51	0	0	51	0	0
25	25130782	.	G	A	26	22	48	0	1	49	0	0
25	25130908	.	C	T	25	14	39	2	1	42	0	0
25	25130924	.	T	C	26	16	42	2	3	47	0	0
25	25130968	.	C	T	23	27	50	0	0	50	0	0
25	25131274	.	A	G	10	25	35	0	1	36	0	0
25	25131298	.	A	T	15	31	46	0	1	47	0	0
25	25131389	.	A	T	15	35	50	0	1	51	0	0
25	25131464	.	G	A	19	28	47	0	1	48	0	0
25	25131631	.	C	T	23	22	45	0	0	50	5	0
25	25131710	.	A	G	20	13	33	0	3	36	0	0
25	25132985	.	C	T	12	11	23	0	3	26	0	0
25	25133030	.	G	A	11	15	26	0	1	27	0	0
25	25133123	.	T	G	22	9	31	0	2	33	0	0
25	25133171	.	A	G	26	20	46	0	1	47	0	0
25	25133353	.	G	A	19	18	37	0	1	38	0	0
25	25133365	.	T	A	17	21	38	0	2	40	0	0
25	25133509	.	A	G	14	12	26	0	2	28	0	0
25	25142127	.	G	A	9	4	13	0	0	16	3	0
25	25142171	.	T	C	7	7	14	0	1	15	0	0
25	25396237	.	T	C	7	19	26	0	1	27	0	0
25	25396295	.	T	C	14	21	35	0	0	35	0	0
25	25488555	.	G	C	2	2	4	0	0	4	0	0
25	25488772	.	T	G	5	3	8	0	0	8	0	0
25	25490963	.	C	T	3	2	5	0	0	5	0	0
25	25535319	.	T	G	4	4	8	0	0	8	0	0
25	25536707	.	T	C	3	4	7	0	0	7	0	0
25	25538143	.	A	C	5	9	14	0	0	14	0	0
25	25538151	.	C	T	5	9	14	0	1	15	0	0
25	25538206	.	G	T	8	10	18	0	0	18	0	0
25	25538354	.	T	A	5	7	12	0	0	12	0	0
25	25538624	.	C	A	6	4	10	0	0	10	0	0
25	25538786	.	T	G	8	0	8	0	8	16	0	0
25	25538834	.	C	A	4	5	9	0	1	10	0	0
25	25539028	.	G	A	8	4	12	0	2	14	0	0
25	25539270	.	C	A	6	5	11	0	0	11	0	0
25	25539398	.	G	A	6	10	16	0	0	16	0	0
25	25539434	.	G	A	0	5	5	0	4	9	0	0
25	25539518	.	A	G	6	5	11	0	0	11	0	0
25	25539569	.	A	G	2	1	3	0	5	8	0	0
25	25539723	.	C	A	16	5	21	0	0	21	0	0
25	25539783	.	G	C	13	11	24	0	0	24	0	0
25	25539800	.	A	G	11	9	20	0	0	20	0	0
25	25539834	.	A	T	10	6	16	0	0	16	0	0
25	25539928	.	A	G	6	0	6	0	9	15	0	0
25	25540058	.	T	A	2	6	8	0	1	9	0	0
25	25540060	.	G	A	3	6	9	0	0	9	0	0
25	25540181	.	A	T	7	7	14	1	1	16	0	0
25	25540245	.	A	G	4	6	10	0	1	11	0	0
25	25540444	.	T	C	7	4	11	0	0	11	0	0
25	25540490	.	C	T	5	7	12	0	0	12	0	0
25	25540954	.	G	A	10	10	20	0	1	21	0	0
25	25545131	.	T	C	10	7	17	0	0	17	0	0
25	25545149	.	G	C	13	7	20	0	0	20	0	0
25	25545365	.	G	C	7	4	11	0	0	11	0	0
25	25545420	.	G	A	0	5	5	0	1	6	0	0
25	25545654	.	T	C	5	1	6	0	0	6	0	0
25	25545700	.	A	T	1	6	7	0	0	7	0	0
25	25545722	.	T	C	1	4	5	0	0	5	0	0
25	25545989	.	G	C	3	5	8	0	1	9	0	0
25	25546053	.	G	A	3	3	6	0	0	6	0	0
25	25546319	.	G	A	1	2	3	0	0	3	0	0
25	25547043	.	C	A	1	2	3	0	0	3	0	0
25	25547137	.	C	A	1	2	3	0	0	3	0	0
25	25547150	.	T	A	1	2	3	0	0	3	0	0
25	25548032	.	G	T	2	3	5	0	0	5	0	0
25	25592238	.	A	G	3	3	6	0	1	7	0	0
25	25592821	.	G	A	4	6	10	0	0	10	0	0
25	25646510	.	A	T	3	4	7	1	0	8	0	0
25	25646521	.	T	G	2	4	6	1	0	7	0	0
25	25646548	.	A	G	2	4	6	1	0	7	0	0
25	25646690	.	C	T	3	8	11	0	1	12	0	0
25	25736865	.	T	C	9	0	9	0	10	19	0	0
25	25737674	.	C	A	3	2	5	0	0	5	0	0
25	25737729	.	A	G	4	2	6	0	0	6	0	0
25	25738396	.	T	C	3	3	6	0	0	6	0	0
25	25740315	.	G	C	2	2	4	0	0	4	0	0
25	25740642	.	G	A	2	2	4	0	1	5	0	0
25	25806264	.	C	T	34	9	43	0	0	43	0	0
25	25823529	.	T	C	16	23	39	0	2	41	0	0
25	25829020	.	T	C	3	7	10	0	2	12	0	0
25	26673233	.	A	G	10	7	17	0	0	17	0	0
25	26739184	.	T	C	1	5	6	0	0	6	0	0
25	26744995	.	G	T	9	6	15	0	0	15	0	0
25	26813023	.	A	C	1	2	3	0	0	3	0	0
25	26821795	.	T	C	5	3	8	0	1	9	0	0
25	26821844	.	A	T	3	4	7	0	0	7	0	0
25	26823244	.	C	T	2	2	4	0	2	6	0	0
25	26823436	.	A	T	2	4	6	0	0	6	0	0
25	26823888	.	G	A	2	2	4	0	0	4	0	0
25	26824155	.	G	A	4	5	9	0	0	9	0	0
25	26824177	.	G	A	6	5	11	0	0	11	0	0
25	26829266	.	G	T	10	5	15	0	1	16	0	0
25	26832141	.	A	G	6	3	9	0	0	9	0	0
25	26840452	.	G	T	6	8	14	0	5	19	0	0
25	26840480	.	T	G	9	11	20	0	1	21	0	0
25	26840678	.	A	T	7	7	14	0	1	15	0	0
25	26840919	.	G	A	9	11	20	0	0	20	0	0
25	26842444	.	G	A	6	9	15	0	1	16	0	0
25	26853906	.	C	T	2	2	4	0	0	4	0	0
25	26853918	.	T	A	2	3	5	0	0	5	0	0
25	26854734	.	T	C	1	3	4	0	1	5	0	0
25	26866896	.	T	A	1	3	4	0	0	4	0	0
25	26867765	.	C	A	2	4	6	0	0	6	0	0
25	26867832	.	T	A	2	2	4	1	2	7	0	0
25	26877783	.	A	T	4	11	15	0	2	17	0	0
25	26877865	.	A	T	15	9	24	0	1	25	0	0
25	26879592	.	T	C	14	23	37	0	4	41	0	0
25	26884286	.	G	A	9	8	17	0	0	17	0	0
25	26884407	.	C	T	12	8	20	1	3	24	0	0
25	26888170	.	A	G	12	10	22	0	0	22	0	0
25	26890845	.	A	G	20	23	43	0	0	43	0	0
25	26908888	.	C	T	4	2	6	0	0	6	0	0
25	26909197	.	G	A	6	8	14	0	0	14	0	0
25	26909269	.	A	G	11	5	16	0	1	17	0	0
25	26909392	.	A	T	8	13	21	0	0	21	0	0
25	26909618	.	A	C	5	2	7	0	1	8	0	0
25	26911216	.	C	T	7	4	11	0	0	11	0	0
25	26911428	.	A	C	1	5	6	0	1	7	0	0
25	26911554	.	T	A	4	11	15	0	0	15	0	0
25	26911605	.	C	A	8	5	13	0	0	13	0	0
25	26911768	.	A	G	5	8	13	0	0	13	0	0
25	26911792	.	G	A	6	2	8	0	0	8	0	0
25	26912037	.	C	T	4	5	9	0	0	9	0	0
25	26912062	.	C	T	2	2	4	0	0	4	0	0
25	26923180	.	T	A	2	3	5	0	1	6	0	0
25	27173852	.	G	A	6	6	12	0	0	12	0	0
25	27173936	.	C	T	4	8	12	0	0	12	0	0
25	27173940	.	A	C	6	9	15	0	0	15	0	0
25	27174065	.	C	T	7	3	10	0	1	11	0	0
25	27210906	.	T	C	15	14	29	0	0	29	0	0
25	27237022	.	A	G	5	4	9	0	0	9	0	0
25	27493723	.	A	T	2	3	5	0	0	5	0	0
25	27494243	.	A	G	1	2	3	0	0	3	0	0
25	27494578	.	A	T	2	4	6	0	0	6	0	0
25	27499385	.	T	C	4	3	7	0	0	7	0	0
25	27499983	.	G	A	1	4	5	0	2	7	0	0
25	27499996	.	T	A	2	5	7	0	0	7	0	0
25	27500038	.	C	A	5	3	8	0	0	8	0	0
25	27500055	.	A	G	2	2	4	0	0	4	0	0
25	27542856	.	C	T	1	3	4	0	0	4	0	0
25	27543077	.	T	C	1	4	5	0	0	5	0	0
25	27543087	.	T	C	1	3	4	0	0	4	0	0
25	27543124	.	A	G	1	3	4	0	0	4	0	0
25	27544025	.	C	A	2	2	4	0	0	4	0	0
25	27544385	.	T	C	4	3	7	0	0	7	0	0
25	27549077	.	T	A	3	2	5	0	0	5	0	0
25	27550352	.	C	T	2	4	6	0	0	6	0	0
25	27550559	.	G	A	1	3	4	0	0	4	0	0
25	27636026	.	C	A	1	3	4	0	0	4	0	0
25	27636029	.	A	T	1	2	3	0	0	3	0	0
25	27744408	.	C	A	11	6	17	0	0	17	0	0
25	27759983	.	A	G	8	7	15	0	0	15	0	0
25	27788019	.	T	A	3	2	5	0	2	7	0	0
25	27795017	.	A	G	16	12	28	0	3	31	0	0
25	27795083	.	C	T	19	12	31	0	0	31	0	0
25	27801759	.	T	G	8	0	8	0	22	31	1	0
25	27801882	.	A	C	4	0	4	0	14	18	0	0
25	27802122	.	C	A	20	15	35	0	1	37	1	0
25	27802149	.	G	A	17	15	32	0	0	32	0	0
25	27811761	.	C	T	14	16	30	0	5	35	0	0
25	27937719	.	T	C	1	2	3	0	0	3	0	0
25	27995812	.	G	A	6	6	12	0	0	12	0	0
25	28070532	.	C	T	1	5	6	0	0	6	0	0
25	28070673	.	A	C	1	2	3	0	0	3	0	0
25	28122051	.	C	T	7	8	15	0	0	15	0	0
25	28138918	.	A	C	6	3	9	0	0	9	0	0
25	28640724	.	T	G	26	23	49	0	3	52	0	0
25	28640890	.	T	G	24	16	40	0	1	42	1	0
25	28641207	.	A	T	10	11	21	1	8	30	0	0
25	28641261	.	T	A	23	11	34	1	2	37	0	0
25	28641321	.	T	G	14	21	35	0	3	38	0	0
25	28648067	.	T	C	14	5	19	0	1	20	0	0
25	28648078	.	A	G	16	9	25	0	0	25	0	0
25	28650764	.	T	A	25	14	39	0	0	39	0	0
25	28655056	.	G	A	19	14	33	0	1	34	0	0
25	28661185	.	C	T	8	11	19	0	0	19	0	0
25	28661227	.	T	C	10	11	21	0	0	21	0	0
25	28661351	.	G	A	14	13	27	0	0	27	0	0
25	28661626	.	G	A	11	16	27	0	2	29	0	0
25	28665446	.	T	A	9	14	23	0	2	25	0	0
25	28665464	.	A	C	14	14	28	0	0	28	0	0
25	28668001	.	G	A	17	12	29	0	0	29	0	0
25	28668723	.	C	A	20	11	31	0	0	31	0	0
25	28714616	.	A	G	2	2	4	0	0	4	0	0
25	28716206	.	G	A	2	3	5	0	0	5	0	0
25	28719957	.	T	G	3	9	12	0	1	13	0	0
25	28720044	.	T	C	4	0	4	0	6	10	0	0
25	28726537	.	C	A	0	9	9	0	8	17	0	0
25	28726758	.	A	G	4	3	7	0	0	7	0	0
25	28736679	.	C	T	6	7	13	1	0	14	0	0
25	28736893	.	A	G	9	8	17	0	1	18	0	0
25	28737007	.	A	T	7	9	16	0	0	16	0	0
25	28739882	.	A	G	3	4	7	0	0	7	0	0
25	28739891	.	A	G	2	3	5	0	1	6	0	0
25	28740295	.	A	T	1	5	6	0	0	6	0	0
25	28740319	.	G	A	3	4	7	0	0	7	0	0
25	28740366	.	T	C	3	0	3	0	3	6	0	0
25	28745128	.	A	G	3	2	5	0	0	5	0	0
25	28745260	.	G	A	5	2	7	0	1	8	0	0
25	28745266	.	C	T	3	3	6	0	1	7	0	0
25	28752579	.	C	T	0	7	7	0	4	11	0	0
25	28763144	.	A	G	3	2	5	0	0	5	0	0
25	28768464	.	C	T	3	2	5	0	0	5	0	0
25	28825652	.	G	C	18	7	25	0	0	25	0	0
25	28826630	.	A	G	12	0	12	0	13	25	0	0
25	28827752	.	A	G	14	0	14	0	12	26	0	0
25	28846383	.	G	T	2	10	12	0	16	28	0	0
25	28893665	.	T	A	3	8	11	0	0	11	0	0
25	28893713	.	C	A	5	14	19	0	0	19	0	0
25	28893956	.	C	T	9	12	21	0	1	22	0	0
25	28903105	.	A	C	17	13	30	0	0	30	0	0
25	28903253	.	A	G	12	0	12	0	8	20	0	0
25	28907971	.	T	C	4	1	5	0	1	6	0	0
25	28907997	.	A	G	5	3	8	0	1	9	0	0
25	28926529	.	T	G	1	3	4	0	0	4	0	0
25	29076852	.	T	A	34	29	63	3	2	68	0	0
25	29080112	.	G	A	3	6	9	0	0	9	0	0
25	29083827	.	T	A	4	4	8	0	0	8	0	0
25	29084154	.	G	A	4	9	13	0	0	13	0	0
25	29087845	.	T	C	5	0	5	0	6	11	0	0
25	29109251	.	G	A	4	12	16	0	0	16	0	0
25	29110052	.	A	G	8	5	13	0	0	13	0	0
25	29114835	.	G	A	5	7	12	0	0	12	0	0
25	29117835	.	A	G	9	5	14	0	0	14	0	0
25	29128870	.	G	C	8	5	13	0	0	13	0	0
25	29212008	.	G	A	3	4	7	0	0	7	0	0
25	29212167	.	G	T	9	8	17	0	0	17	0	0
25	29212302	.	C	T	0	3	3	0	6	9	0	0
25	29212476	.	T	C	3	6	9	0	0	9	0	0
25	29212780	.	A	T	6	5	11	0	1	12	0	0
25	29212781	.	C	G	1	5	6	0	6	12	0	0
25	29212835	.	A	T	7	8	15	0	3	18	0	0
25	29212851	.	G	T	8	10	18	0	0	18	0	0
25	29212986	.	A	G	4	6	10	0	0	10	0	0
25	29213001	.	G	C	4	4	8	0	2	10	0	0
25	29319097	.	A	G	27	29	56	0	0	56	0	0
25	29319239	.	A	T	21	19	40	0	2	42	0	0
25	29319706	.	T	C	43	3	46	0	22	68	0	0
25	29319712	.	A	G	39	22	61	0	4	65	0	0
25	29329949	.	A	G	36	38	74	0	6	80	0	0
25	29427951	.	A	C	8	5	13	2	3	18	0	0
25	29427955	.	A	C	6	5	11	1	3	15	0	0
25	29428094	.	A	G	15	16	31	0	1	32	0	0
25	29428300	.	C	A	23	11	34	0	1	35	0	0
25	29428638	.	A	G	18	12	30	0	0	30	0	0
25	29428806	.	T	A	13	12	25	0	1	26	0	0
25	29428963	.	G	A	22	23	45	0	0	45	0	0
25	29429187	.	A	G	6	7	13	0	4	17	0	0
25	29429420	.	G	A	13	22	35	0	3	38	0	0
25	29429569	.	T	C	17	0	17	0	14	31	0	0
25	29429589	.	G	T	15	11	26	0	0	26	0	0
25	29429732	.	A	T	6	5	11	0	2	13	0	0
25	29429984	.	T	C	12	0	12	0	16	28	0	0
25	29444782	.	A	G	16	16	32	0	0	32	0	0
25	29662436	.	C	A	8	6	14	0	0	14	0	0
25	29662642	.	T	C	6	3	9	0	0	9	0	0
25	29662739	.	C	T	7	14	21	0	3	24	0	0
25	29663116	.	T	G	11	5	16	0	0	16	0	0
25	29664955	.	T	C	13	11	24	0	0	25	1	0
25	29665705	.	G	A	2	21	23	0	20	43	0	0
25	29666170	.	T	G	15	0	15	0	17	32	0	0
25	29666299	.	A	G	22	14	36	0	0	36	0	0
25	29666607	.	G	T	7	3	10	0	0	10	0	0
25	29666640	.	T	A	10	4	14	0	0	14	0	0
25	29666797	.	T	A	8	7	15	0	1	16	0	0
25	29688802	.	G	A	2	2	4	0	1	5	0	0
25	29694272	.	T	A	6	5	11	0	0	11	0	0
25	29694487	.	A	C	3	4	7	0	1	8	0	0
25	29694545	.	A	G	3	6	9	0	0	9	0	0
25	29694824	.	A	C	2	2	4	0	0	4	0	0
25	29695316	.	G	A	1	2	3	0	3	6	0	0
25	29696881	.	A	G	3	5	8	0	0	8	0	0
25	29696896	.	A	G	2	0	2	0	4	6	0	0
25	29697015	.	G	A	1	4	5	0	0	5	0	0
25	29697064	.	C	T	6	2	8	0	0	8	0	0
25	29697575	.	C	A	5	5	10	0	0	10	0	0
25	29697625	.	A	G	4	0	4	0	4	8	0	0
25	29698784	.	C	T	8	4	12	0	0	12	0	0
25	29699018	.	G	A	8	4	12	0	0	12	0	0
25	29699227	.	T	C	2	7	9	0	0	9	0	0
25	29699236	.	A	T	3	6	9	0	1	10	0	0
25	29701710	.	G	A	4	3	7	0	0	7	0	0
25	29711597	.	A	T	7	17	24	0	0	24	0	0
25	32216389	.	A	G	8	0	8	0	8	16	0	0
25	32886363	.	A	G	1	2	3	0	0	3	0	0
25	32886762	.	A	G	4	2	6	0	0	6	0	0
25	32886771	.	C	T	0	1	1	0	5	6	0	0
25	33006913	.	G	T	1	4	5	0	0	5	0	0
25	33016092	.	G	A	1	1	2	0	1	3	0	0
25	33038216	.	A	G	1	0	1	0	2	3	0	0
25	33050967	.	T	C	1	2	3	0	1	4	0	0
25	33052316	.	G	T	4	2	6	0	0	6	0	0
25	33052340	.	A	G	3	0	3	0	2	5	0	0
25	33052544	.	C	T	3	3	6	0	0	6	0	0
25	33065530	.	A	G	3	0	3	0	2	5	0	0
25	33065551	.	C	T	3	2	5	0	0	5	0	0
25	33078229	.	G	A	3	2	5	0	0	5	0	0
25	33078253	.	A	C	3	3	6	0	0	6	0	0
25	33081889	.	A	G	4	6	10	0	0	10	0	0
25	33084034	.	A	G	3	4	7	0	0	7	0	0
25	33091554	.	A	G	4	0	4	0	9	13	0	0
25	33093485	.	T	C	9	4	13	0	1	14	0	0
25	33104491	.	T	C	4	7	11	0	0	11	0	0
25	33104494	.	T	C	4	7	11	0	0	11	0	0
25	33121219	.	T	C	5	3	8	0	0	8	0	0
25	33121740	.	C	T	4	4	8	0	0	8	0	0
25	33121782	.	A	G	5	0	5	0	6	11	0	0
25	33125194	.	A	C	4	4	8	0	0	8	0	0
25	33145031	.	C	T	4	7	11	0	0	11	0	0
25	33151573	.	C	G	8	0	8	0	5	13	0	0
25	33192594	.	C	T	0	2	2	0	1	3	0	0
25	33194649	.	A	G	2	3	5	0	0	5	0	0
25	33194667	.	A	C	1	3	4	0	2	6	0	0
25	33225248	.	A	G	24	30	54	0	2	56	0	0
25	33225287	.	G	A	16	29	45	0	3	48	0	0
25	33226972	.	A	G	15	23	38	0	1	39	0	0
25	33226984	.	A	G	15	21	36	0	3	39	0	0
25	33239223	.	T	A	7	3	10	0	1	11	0	0
25	33239228	.	T	C	7	3	10	0	0	10	0	0
25	33239682	.	C	T	1	2	3	0	0	3	0	0
25	33242605	.	A	T	3	4	7	0	2	9	0	0
25	33242606	.	T	G	3	3	6	0	3	9	0	0
25	33249905	.	T	G	15	18	33	0	0	33	0	0
25	33250053	.	A	G	10	9	19	0	2	21	0	0
25	33256212	.	C	A	1	6	7	0	1	8	0	0
25	33256493	.	G	A	4	2	6	0	0	6	0	0
25	33258739	.	G	A	1	3	4	0	6	10	0	0
25	33258745	.	T	G	5	0	5	0	3	8	0	0
25	33258811	.	A	G	1	0	1	0	4	5	0	0
25	33258817	.	C	T	1	4	5	0	0	5	0	0
25	33259568	.	A	G	6	1	7	0	8	15	0	0
25	33259778	.	T	C	4	6	10	0	0	10	0	0
25	33262180	.	A	G	7	6	13	0	0	13	0	0
25	33265759	.	A	G	5	4	9	0	0	9	0	0
25	33265814	.	C	T	5	6	11	0	1	12	0	0
25	33265898	.	C	T	6	6	12	0	0	12	0	0
25	33266029	.	G	A	3	7	10	0	0	10	0	0
25	33266128	.	A	G	3	0	3	0	9	12	0	0
25	33266157	.	A	C	4	6	10	0	1	11	0	0
25	33962809	.	G	A	3	11	14	0	16	30	0	0
25	33963168	.	C	A	12	6	18	0	0	18	0	0
25	33963427	.	A	T	14	7	21	0	0	21	0	0
25	33964265	.	C	T	7	5	12	0	0	12	0	0
25	33964791	.	A	G	12	4	16	3	2	21	0	0
25	33964962	.	A	G	13	9	22	0	0	22	0	0
25	33964968	.	A	G	12	6	18	0	1	19	0	0
25	33965016	.	C	A	15	5	20	0	0	20	0	0
25	33965238	.	A	G	9	3	12	0	2	14	0	0
25	33965251	.	G	A	0	2	2	0	11	13	0	0
25	33965518	.	G	T	12	6	18	0	0	18	0	0
25	33965541	.	C	T	11	9	20	0	2	22	0	0
25	33965695	.	C	T	8	7	15	0	0	15	0	0
25	33965786	.	T	C	6	5	11	1	0	12	0	0
25	33965831	.	G	A	2	3	5	1	3	9	0	0
25	33965893	.	C	T	5	9	14	0	0	14	0	0
25	33965974	.	A	C	11	11	22	0	0	22	0	0
25	33966100	.	G	A	4	8	12	0	0	12	0	0
25	33966251	.	T	G	18	7	25	0	1	26	0	0
25	33966585	.	C	G	16	1	17	0	10	27	0	0
25	33966731	.	T	C	9	8	17	0	1	18	0	0
25	33966854	.	C	T	11	8	19	0	0	19	0	0
25	33966969	.	T	A	5	6	11	0	1	12	0	0
25	33967133	.	T	A	15	11	26	0	0	26	0	0
25	33967361	.	A	G	20	14	34	0	2	36	0	0
25	33967495	.	T	C	12	11	23	0	0	23	0	0
25	33967695	.	T	C	7	8	15	0	0	15	0	0
25	33967791	.	C	T	13	6	19	0	0	19	0	0
25	33967803	.	G	A	11	5	16	0	0	16	0	0
25	33968091	.	C	T	12	17	29	0	1	30	0	0
25	33968470	.	T	A	16	12	28	0	1	29	0	0
25	33968691	.	A	G	5	17	22	0	0	22	0	0
25	33968842	.	G	C	21	20	41	0	2	43	0	0
25	33968857	.	C	T	17	19	36	0	2	38	0	0
25	33968881	.	T	A	19	16	35	0	1	36	0	0
25	33983031	.	G	A	4	5	9	0	1	10	0	0
25	33983108	.	G	A	1	8	9	0	0	9	0	0
25	33983286	.	C	T	3	3	6	0	0	6	0	0
25	33983303	.	T	C	3	5	8	0	0	8	0	0
25	33987881	.	A	G	4	3	7	0	0	7	0	0
25	33988864	.	T	G	2	6	8	0	0	8	0	0
25	33988893	.	G	A	3	5	8	0	0	8	0	0
25	33988899	.	T	C	2	6	8	0	0	8	0	0
25	33988928	.	A	T	2	6	8	0	0	8	0	0
25	34002853	.	T	C	3	4	7	0	0	7	0	0
25	34014573	.	A	G	13	11	24	0	0	24	0	0
25	34017089	.	A	G	6	12	18	0	0	18	0	0
25	34018537	.	C	T	9	8	17	0	1	18	0	0
25	34020631	.	T	A	8	5	13	0	1	14	0	0
25	34022288	.	T	C	15	20	35	0	0	35	0	0
25	34022309	.	T	C	15	20	35	0	0	35	0	0
25	34027086	.	A	T	14	10	24	0	0	24	0	0
25	34027215	.	C	A	9	4	13	0	5	18	0	0
25	34027263	.	G	T	5	8	13	0	0	13	0	0
25	34154496	.	A	T	10	7	17	0	4	21	0	0
25	34154540	.	T	G	9	14	23	0	1	24	0	0
25	34154678	.	G	A	16	16	32	0	0	32	0	0
25	34246687	.	A	T	1	7	8	0	0	8	0	0
25	34247217	.	G	A	1	2	3	0	1	4	0	0
25	34257427	.	T	C	1	2	3	0	1	4	0	0
25	34257433	.	G	A	2	3	5	0	0	5	0	0
25	34267634	.	T	A	1	2	3	0	0	3	0	0
25	34267959	.	G	A	1	2	3	0	0	3	0	0
25	34268026	.	C	G	1	2	3	0	0	3	0	0
25	34268035	.	C	T	1	2	3	0	0	3	0	0
25	34268363	.	A	G	6	2	8	0	0	8	0	0
25	34911352	.	A	G	2	4	6	0	0	6	0	0
25	34973070	.	C	T	6	5	11	0	0	11	0	0
25	34973090	.	C	A	5	5	10	0	0	10	0	0
25	34976394	.	A	G	1	2	3	0	0	3	0	0
25	35002394	.	G	A	24	31	55	1	6	62	0	0
25	35005362	.	G	A	46	17	63	0	3	66	0	0
25	35006830	.	G	A	2	33	35	0	22	57	0	0
25	35006989	.	C	T	31	25	56	1	1	58	0	0
25	35270407	.	A	G	22	19	41	0	2	43	0	0
25	35680694	.	T	A	1	0	1	0	1	2	0	0
25	35713260	.	G	A	19	8	27	0	1	28	0	0
25	35713263	.	G	C	21	7	28	0	0	28	0	0
25	36040526	.	A	G	1	6	7	0	0	7	0	0
25	37137135	.	A	G	5	4	9	0	0	9	0	0
25	37333480	.	C	T	1	4	5	0	0	5	0	0
25	37336710	.	A	G	3	4	7	0	0	7	0	0
3	13624	.	T	A	1	2	3	1	0	4	0	0
3	13880	.	G	T	1	3	4	1	0	6	1	0
3	13937	.	C	T	5	3	8	12	0	20	0	0
3	13952	.	T	C	2	2	4	6	0	10	0	0
3	40869	.	G	C	4	2	6	1	0	7	0	0
3	197013	.	T	C	1	2	3	0	1	4	0	0
3	240680	.	G	A	1	7	8	0	1	9	0	0
3	240735	.	C	A	5	5	10	0	0	10	0	0
3	249334	.	T	A	5	3	8	2	0	10	0	0
3	249413	.	A	T	7	3	10	0	1	11	0	0
3	1134009	.	C	G	0	5	5	2	0	7	0	0
3	1134012	.	C	T	2	5	7	2	0	9	0	0
3	1323815	.	T	C	2	4	6	0	1	7	0	0
3	1324064	.	C	A	16	4	20	0	0	20	0	0
3	1324281	.	G	T	6	2	8	0	0	8	0	0
3	1324300	.	T	C	7	7	14	0	0	14	0	0
3	1324383	.	G	C	2	0	2	0	6	9	1	0
3	1324509	.	C	A	6	6	12	0	0	12	0	0
3	1324515	.	C	T	7	6	13	0	0	13	0	0
3	1324646	.	G	A	15	4	19	0	0	19	0	0
3	1324666	.	T	C	14	5	19	0	1	20	0	0
3	1324688	.	T	C	8	10	18	0	1	19	0	0
3	1337593	.	A	G	8	2	10	0	2	12	0	0
3	1337674	.	T	C	8	0	8	0	6	14	0	0
3	1339147	.	T	A	12	11	23	0	1	24	0	0
3	3610150	.	A	T	2	2	4	0	0	4	0	0
3	3610185	.	C	A	6	8	14	0	1	15	0	0
3	3610202	.	A	T	7	9	16	0	0	16	0	0
3	3610224	.	C	T	8	6	14	0	0	14	0	0
3	3617633	.	G	A	0	13	13	0	8	21	0	0
3	3630587	.	T	C	9	11	20	0	0	20	0	0
3	3631407	.	T	C	11	10	21	0	2	23	0	0
3	3634408	.	G	A	15	9	24	0	2	26	0	0
3	3668451	.	G	T	1	2	3	0	0	3	0	0
3	3813805	.	G	A	5	2	7	0	0	7	0	0
3	3813838	.	C	T	7	5	12	0	0	12	0	0
3	3820708	.	T	C	2	3	5	0	1	6	0	0
3	4460727	.	G	A	1	3	4	0	0	4	0	0
3	4463979	.	C	T	1	6	7	1	0	8	0	0
3	4466011	.	A	G	2	3	5	0	0	5	0	0
3	4466046	.	C	T	2	4	6	0	0	6	0	0
3	4469683	.	C	T	0	4	4	0	3	7	0	0
3	4471748	.	G	A	2	2	4	0	0	4	0	0
3	4475886	.	G	C	1	0	1	0	5	6	0	0
3	4487884	.	A	G	1	2	3	0	0	3	0	0
3	4502158	.	C	A	7	17	24	0	2	26	0	0
3	4506897	.	A	G	5	13	18	0	1	19	0	0
3	4506961	.	G	A	0	12	12	0	6	18	0	0
3	4507825	.	T	C	8	11	19	0	0	19	0	0
3	4508042	.	A	C	12	10	22	0	1	23	0	0
3	4508093	.	C	A	9	10	19	0	4	23	0	0
3	4508120	.	C	T	9	11	20	0	0	20	0	0
3	4511052	.	T	C	8	19	27	0	0	27	0	0
3	4511163	.	A	G	4	0	4	0	4	8	0	0
3	4514030	.	G	A	4	9	13	0	0	13	0	0
3	4516925	.	C	A	13	12	25	0	1	26	0	0
3	4530061	.	G	A	16	6	22	0	2	24	0	0
3	4530118	.	T	A	5	8	13	0	0	13	0	0
3	4997623	.	C	T	3	3	6	0	0	6	0	0
3	5009112	.	G	C	13	0	13	0	9	22	0	0
3	5012832	.	C	G	1	12	13	0	13	26	0	0
3	5021432	.	G	A	11	8	19	0	0	19	0	0
3	5021453	.	C	T	1	11	12	0	11	23	0	0
3	5040591	.	A	G	9	7	16	0	1	17	0	0
3	5040757	.	A	G	7	6	13	0	0	13	0	0
3	5040798	.	A	C	5	8	13	0	0	13	0	0
3	5052823	.	T	G	12	8	20	0	0	20	0	0
3	5052868	.	G	A	13	12	25	5	1	31	0	0
3	5053060	.	C	T	5	20	25	0	29	54	0	0
3	5053454	.	T	A	18	23	41	0	2	43	0	0
3	5053934	.	G	A	28	20	48	0	0	48	0	0
3	5053988	.	C	G	28	25	53	0	0	53	0	0
3	5056247	.	G	A	16	24	40	0	2	42	0	0
3	5056390	.	A	T	24	19	43	2	4	50	1	0
3	5062827	.	C	T	20	19	39	0	1	40	0	0
3	5063125	.	G	A	10	24	34	0	7	41	0	0
3	5063176	.	G	A	27	11	38	0	0	38	0	0
3	5067581	.	T	A	11	17	28	0	1	29	0	0
3	5130791	.	C	A	13	8	21	0	1	22	0	0
3	5130851	.	T	C	9	11	20	1	0	21	0	0
3	5134113	.	G	A	12	9	21	0	0	21	0	0
3	5134122	.	G	A	8	13	21	0	0	21	0	0
3	5134669	.	T	C	10	9	19	0	0	19	0	0
3	5136617	.	G	A	6	8	14	0	1	15	0	0
3	5140851	.	A	G	8	11	19	0	1	20	0	0
3	5141035	.	C	T	14	3	17	0	2	19	0	0
3	5141152	.	C	T	9	8	17	0	1	18	0	0
3	5143119	.	C	T	10	6	16	0	0	16	0	0
3	5143522	.	C	T	8	5	13	0	0	13	0	0
3	5145139	.	C	A	1	7	8	0	6	14	0	0
3	5145797	.	C	T	0	6	6	0	16	22	0	0
3	5145988	.	G	A	5	7	12	0	1	13	0	0
3	5145991	.	T	C	4	0	4	0	8	12	0	0
3	5147544	.	G	A	1	7	8	0	0	8	0	0
3	5147606	.	G	T	6	6	12	0	1	13	0	0
3	5150391	.	G	A	5	5	10	0	0	10	0	0
3	5152715	.	T	C	3	6	9	0	0	9	0	0
3	5159345	.	G	A	3	4	7	0	0	7	0	0
3	5163352	.	C	T	3	4	7	0	1	8	0	0
3	5163418	.	C	G	5	5	10	0	1	11	0	0
3	5163442	.	G	T	6	4	10	0	0	10	0	0
3	5163826	.	C	T	1	1	2	0	5	7	0	0
3	5171303	.	G	T	6	2	8	0	0	8	0	0
3	5228084	.	A	G	1	3	4	0	0	4	0	0
3	5267221	.	G	A	14	14	28	0	0	28	0	0
3	5267251	.	C	T	9	11	20	0	4	24	0	0
3	5270274	.	C	T	1	14	15	0	19	34	0	0
3	5403851	.	A	G	3	6	9	0	1	10	0	0
3	5609143	.	T	G	3	2	5	0	0	5	0	0
3	5624487	.	C	T	3	14	17	0	23	40	0	0
3	5633056	.	A	G	12	14	26	0	0	26	0	0
3	5633089	.	G	A	10	8	18	0	0	18	0	0
3	5633122	.	A	G	13	10	23	0	1	24	0	0
3	5634976	.	A	G	20	12	32	0	0	32	0	0
3	5637213	.	A	C	17	11	28	0	0	29	1	0
3	5637222	.	A	G	17	12	29	0	1	30	0	0
3	5648017	.	A	G	4	3	7	0	2	9	0	0
3	5652676	.	A	G	1	2	3	0	0	3	0	0
3	5719007	.	G	T	1	3	4	0	0	4	0	0
3	5723535	.	C	T	0	2	2	0	2	4	0	0
3	5723554	.	A	G	2	4	6	0	0	6	0	0
3	5723572	.	G	A	1	3	4	0	0	4	0	0
3	5725371	.	G	A	1	4	5	0	0	5	0	0
3	5778981	.	G	A	9	12	21	0	4	25	0	0
3	5779044	.	T	A	5	14	19	0	1	20	0	0
3	5779093	.	G	T	6	10	16	0	0	16	0	0
3	5782501	.	A	G	8	8	16	0	1	17	0	0
3	5782715	.	A	G	17	11	28	0	0	28	0	0
3	5792569	.	T	A	12	18	30	0	0	30	0	0
3	5812205	.	C	T	6	11	17	0	1	18	0	0
3	5812802	.	C	T	1	6	7	0	16	23	0	0
3	5812813	.	G	A	7	5	12	0	9	21	0	0
3	5814475	.	C	T	5	10	15	0	0	15	0	0
3	5814478	.	C	T	5	9	14	0	0	14	0	0
3	5823477	.	G	A	7	3	10	0	0	10	0	0
3	5823483	.	C	A	0	3	3	0	8	11	0	0
3	5824858	.	C	T	5	2	7	0	1	8	0	0
3	5824870	.	C	T	3	7	10	0	0	10	0	0
3	5829415	.	A	G	7	3	10	0	2	12	0	0
3	5882661	.	T	C	0	4	4	0	1	5	0	0
3	5882808	.	C	T	1	2	3	0	0	3	0	0
3	5882973	.	T	C	3	3	6	0	0	6	0	0
3	5886917	.	C	T	2	19	21	0	35	56	0	0
3	5887223	.	T	C	20	14	34	0	2	36	0	0
3	5887463	.	T	G	22	17	39	0	3	42	0	0
3	5887661	.	A	T	20	18	38	0	3	41	0	0
3	5887673	.	G	C	22	0	22	0	18	41	1	0
3	5887715	.	T	C	20	14	34	0	2	36	0	0
3	5887841	.	T	A	16	26	42	0	4	46	0	0
3	5887931	.	A	T	15	20	35	0	5	40	0	0
3	5888245	.	C	T	17	11	28	0	3	31	0	0
3	5888664	.	G	A	13	8	21	0	1	22	0	0
3	5888868	.	G	A	21	12	33	0	0	33	0	0
3	5889077	.	G	T	16	10	26	0	0	26	0	0
3	5889302	.	T	C	13	8	21	0	1	22	0	0
3	5889642	.	A	T	12	8	20	0	1	21	0	0
3	5889983	.	A	G	6	8	14	0	0	14	0	0
3	5890274	.	T	A	21	13	34	0	0	34	0	0
3	5890287	.	A	G	22	10	32	0	3	35	0	0
3	5890698	.	C	T	2	20	22	0	13	35	0	0
3	5890833	.	G	A	13	10	23	0	1	24	0	0
3	5908262	.	C	T	8	17	25	0	1	26	0	0
3	5908302	.	T	C	4	0	4	0	15	19	0	0
3	5908452	.	T	C	5	0	5	0	22	27	0	0
3	5908569	.	C	A	1	8	9	0	16	25	0	0
3	5964113	.	G	A	7	4	11	0	1	12	0	0
3	5991798	.	C	T	1	3	4	0	5	9	0	0
3	5991822	.	G	A	3	4	7	0	2	9	0	0
3	5994984	.	C	T	4	6	10	0	0	10	0	0
3	5995038	.	A	G	10	7	17	0	1	18	0	0
3	5995071	.	A	G	7	6	13	0	0	13	0	0
3	6015843	.	A	G	5	3	8	0	0	8	0	0
3	6018562	.	A	G	4	7	11	0	0	11	0	0
3	6380368	.	T	C	33	20	53	0	0	53	0	0
3	6417172	.	G	A	18	26	44	0	4	48	0	0
3	6455377	.	A	T	2	2	4	0	0	4	0	0
3	6457308	.	T	G	4	3	7	0	0	7	0	0
3	6460039	.	G	T	2	6	8	0	1	9	0	0
3	6477596	.	G	C	4	3	7	0	2	9	0	0
3	6490980	.	G	T	1	5	6	2	0	8	0	0
3	6490987	.	C	T	1	6	7	2	0	9	0	0
3	6491117	.	C	A	1	2	3	0	4	7	0	0
3	6491540	.	C	T	6	5	11	0	0	11	0	0
3	6491542	.	G	T	6	5	11	0	0	11	0	0
3	6491670	.	C	T	4	6	10	1	0	11	0	0
3	6491820	.	A	T	5	4	9	0	0	9	0	0
3	6491833	.	A	G	6	4	10	0	0	10	0	0
3	6491881	.	G	T	7	8	15	1	0	16	0	0
3	6491906	.	T	C	5	7	12	1	0	13	0	0
3	6498049	.	C	G	0	7	7	0	6	13	0	0
3	6499606	.	T	C	7	0	7	0	6	13	0	0
3	6499636	.	A	G	6	5	11	0	1	12	0	0
3	6502039	.	G	A	8	5	13	0	0	13	0	0
3	6504814	.	T	A	13	7	20	0	1	21	0	0
3	6505007	.	G	T	8	8	16	0	0	16	0	0
3	6505010	.	T	C	8	9	17	0	0	17	0	0
3	6515014	.	C	G	4	7	11	0	1	12	0	0
3	6515029	.	A	G	5	8	13	0	1	14	0	0
3	6516457	.	C	T	1	6	7	0	8	15	0	0
3	6608024	.	C	A	1	5	6	0	0	6	0	0
3	6608276	.	T	A	1	4	5	0	0	5	0	0
3	6608296	.	G	A	1	4	5	0	0	5	0	0
3	6659702	.	G	A	0	3	3	0	10	13	0	0
3	6663606	.	G	A	2	2	4	0	0	4	0	0
3	6663814	.	A	G	2	3	5	0	0	5	0	0
3	6664270	.	A	G	3	0	3	0	5	8	0	0
3	6664358	.	T	G	2	2	4	0	0	4	0	0
3	6664943	.	A	G	4	8	12	0	0	12	0	0
3	6665437	.	T	A	5	5	10	0	0	10	0	0
3	6665456	.	T	C	4	4	8	0	2	10	0	0
3	6665479	.	A	G	9	3	12	0	1	13	0	0
3	6665874	.	C	G	3	0	3	0	6	9	0	0
3	6665902	.	G	T	8	4	12	0	0	12	0	0
3	6665951	.	C	A	7	12	19	0	1	20	0	0
3	6665985	.	A	T	8	9	17	0	1	18	0	0
3	6666027	.	C	T	7	7	14	0	0	14	0	0
3	6666080	.	A	G	8	10	18	0	2	20	0	0
3	6666092	.	T	C	9	9	18	0	0	18	0	0
3	6666194	.	G	C	15	12	27	0	2	29	0	0
3	6666283	.	A	T	9	17	26	0	0	26	0	0
3	6666342	.	A	G	15	3	18	0	0	18	0	0
3	6666362	.	G	A	8	7	15	0	0	15	0	0
3	6666689	.	T	C	3	5	8	0	0	8	0	0
3	6666691	.	T	C	5	3	8	0	0	8	0	0
3	6666730	.	C	T	3	5	8	0	0	8	0	0
3	6667060	.	G	C	15	13	28	0	2	30	0	0
3	6667209	.	C	T	8	15	23	0	2	25	0	0
3	6667383	.	T	C	1	2	3	2	0	5	0	0
3	6667502	.	A	C	1	1	2	0	3	5	0	0
3	6667850	.	T	C	2	3	5	5	0	10	0	0
3	6667983	.	C	G	2	0	2	6	3	11	0	0
3	6668055	.	T	C	3	2	5	6	0	11	0	0
3	6668917	.	T	C	1	2	3	0	0	3	0	0
3	6721278	.	A	G	2	6	8	0	0	8	0	0
3	6721286	.	G	C	2	5	7	0	0	7	0	0
3	6721421	.	T	G	14	9	23	0	1	24	0	0
3	6721456	.	A	T	9	6	15	0	3	18	0	0
3	6721497	.	T	A	4	7	11	0	2	13	0	0
3	6721504	.	A	T	7	7	14	0	1	15	0	0
3	6721763	.	T	C	6	4	10	0	0	10	0	0
3	6721773	.	T	G	7	6	13	0	0	13	0	0
3	6721851	.	C	T	6	3	9	0	0	9	0	0
3	6722021	.	T	A	5	7	12	0	0	13	1	0
3	6722070	.	C	G	3	7	10	0	0	10	0	0
3	6722333	.	C	A	7	6	13	0	0	13	0	0
3	6722341	.	G	A	8	4	12	0	0	12	0	0
3	6722401	.	T	C	12	5	17	0	0	17	0	0
3	6722438	.	C	T	7	3	10	0	0	10	0	0
3	6725130	.	C	T	9	4	13	2	0	15	0	0
3	6725150	.	G	C	5	2	7	2	0	9	0	0
3	6725378	.	A	T	4	4	8	0	3	11	0	0
3	6725497	.	C	T	7	2	9	0	0	9	0	0
3	6725699	.	C	G	1	3	4	0	2	6	0	0
3	6725704	.	A	G	2	4	6	0	0	6	0	0
3	6725737	.	T	A	3	5	8	0	1	9	0	0
3	6725951	.	A	G	3	2	5	0	0	5	0	0
3	6726004	.	A	G	5	12	17	0	0	17	0	0
3	6726020	.	C	T	5	11	16	0	1	17	0	0
3	6726053	.	T	C	5	10	15	0	0	15	0	0
3	6726170	.	G	T	7	10	17	0	0	17	0	0
3	6726284	.	A	T	13	6	19	0	1	21	1	0
3	6726323	.	T	G	15	9	24	0	0	24	0	0
3	6726359	.	G	A	11	14	25	0	1	26	0	0
3	6727154	.	C	T	1	13	14	0	10	24	0	0
3	6731289	.	G	T	4	7	11	0	0	11	0	0
3	6732346	.	T	A	7	3	10	0	0	10	0	0
3	6732696	.	G	A	1	2	3	0	0	3	0	0
3	6732697	.	C	T	1	2	3	0	1	4	0	0
3	6737079	.	G	A	6	4	10	0	1	11	0	0
3	6737099	.	G	T	9	4	13	0	1	14	0	0
3	6744653	.	A	G	4	2	6	0	0	6	0	0
3	6749311	.	T	C	4	6	10	0	0	10	0	0
3	6749326	.	A	G	4	4	8	0	1	9	0	0
3	6895940	.	A	T	4	4	8	0	0	8	0	0
3	6896248	.	T	G	1	2	3	0	0	3	0	0
3	6993356	.	A	G	2	2	4	1	0	5	0	0
3	7007642	.	C	T	1	3	4	0	0	4	0	0
3	7007650	.	C	T	0	3	3	0	0	3	0	0
3	7008290	.	C	T	3	2	5	0	1	6	0	0
3	7008594	.	A	G	3	2	5	0	0	5	0	0
3	7008690	.	C	A	3	7	10	0	1	11	0	0
3	7056934	.	T	C	1	0	1	0	2	3	0	0
3	7081493	.	G	A	1	3	4	1	0	5	0	0
3	7081675	.	G	A	3	2	5	0	0	5	0	0
3	7081699	.	T	C	2	0	2	0	2	4	0	0
3	7094337	.	A	G	1	2	3	5	0	8	0	0
3	7099160	.	A	G	2	8	10	0	1	11	0	0
3	7099285	.	G	T	1	5	6	0	0	6	0	0
3	7099600	.	T	C	1	5	6	0	0	6	0	0
3	7099791	.	G	A	1	4	5	1	0	6	0	0
3	7100056	.	T	C	2	2	4	0	0	4	0	0
3	7100061	.	A	G	2	2	4	0	0	4	0	0
3	7112990	.	C	T	1	6	7	0	2	9	0	0
3	7113036	.	G	T	5	7	12	0	1	13	0	0
3	7113075	.	T	G	3	10	13	0	0	13	0	0
3	7113126	.	A	G	2	9	11	0	0	11	0	0
3	7113327	.	T	C	7	0	7	0	10	17	0	0
3	7113330	.	T	C	6	11	17	0	0	17	0	0
3	7113424	.	G	C	1	5	6	0	0	6	0	0
3	7113433	.	T	C	3	4	7	0	0	7	0	0
3	7113465	.	A	G	2	4	6	0	0	6	0	0
3	7113660	.	A	G	4	5	9	0	0	9	0	0
3	7113669	.	C	T	3	4	7	0	0	7	0	0
3	7113720	.	G	A	5	3	8	0	0	8	0	0
3	7124140	.	G	A	5	3	8	0	0	8	0	0
3	7124437	.	A	G	0	2	2	0	1	3	0	0
3	7124584	.	G	T	4	4	8	1	0	9	0	0
3	7124585	.	G	T	4	4	8	1	0	9	0	0
3	7124659	.	C	T	7	3	10	0	1	11	0	0
3	7124705	.	C	T	3	3	6	0	1	7	0	0
3	7133743	.	A	G	4	9	13	0	0	13	0	0
3	7133751	.	A	G	4	8	12	0	0	12	0	0
3	7133967	.	G	A	4	2	6	0	0	6	0	0
3	7141369	.	T	C	1	2	3	0	0	3	0	0
3	7141527	.	G	T	5	7	12	0	0	12	0	0
3	7141562	.	A	T	2	6	8	0	1	9	0	0
3	7141846	.	G	A	5	3	8	0	0	8	0	0
3	7141924	.	G	A	1	6	7	0	0	7	0	0
3	7141981	.	C	T	2	5	7	0	0	7	0	0
3	7142011	.	G	A	1	4	5	0	0	5	0	0
3	7142350	.	A	G	4	2	6	3	0	9	0	0
3	7142372	.	C	G	4	5	9	3	0	12	0	0
3	7155012	.	T	C	3	0	3	0	2	5	0	0
3	7155039	.	T	C	2	5	7	0	0	7	0	0
3	7155156	.	C	T	5	3	8	1	0	9	0	0
3	7155196	.	T	A	5	10	15	4	1	20	0	0
3	7155198	.	A	G	3	12	15	4	1	20	0	0
3	7155428	.	G	A	5	5	10	0	0	10	0	0
3	7156141	.	C	T	3	3	6	0	0	6	0	0
3	7546419	.	A	C	2	3	5	0	0	5	0	0
3	7546477	.	A	G	1	2	3	0	0	3	0	0
3	7638508	.	A	G	12	7	19	0	0	19	0	0
3	7638510	.	A	G	8	9	17	0	0	17	0	0
3	7819739	.	A	G	4	2	6	0	0	6	0	0
3	8334392	.	C	T	1	4	5	0	4	9	0	0
3	8348306	.	C	T	0	4	4	0	5	9	0	0
3	8399700	.	G	A	4	7	11	0	1	12	0	0
3	8399799	.	C	T	6	6	12	0	0	12	0	0
3	9380690	.	T	A	2	1	3	0	1	4	0	0
3	9417311	.	C	G	6	4	10	0	0	10	0	0
3	9417377	.	G	A	0	3	3	0	4	7	0	0
3	9417431	.	T	C	2	2	4	0	1	5	0	0
3	9417823	.	G	T	2	4	6	0	0	6	0	0
3	9417827	.	G	T	1	4	5	0	0	5	0	0
3	9418178	.	G	A	0	2	2	0	1	3	0	0
3	9418494	.	G	A	0	5	5	0	6	11	0	0
3	9418575	.	C	T	1	4	5	0	0	5	0	0
3	9418700	.	A	G	5	3	8	0	0	8	0	0
3	9419095	.	C	T	2	2	4	0	0	4	0	0
3	9419131	.	A	T	3	3	6	0	0	6	0	0
3	9419138	.	T	C	3	2	5	0	0	5	0	0
3	9419634	.	C	T	3	2	5	0	0	5	0	0
3	9419890	.	A	G	1	2	3	0	0	3	0	0
3	9419973	.	T	A	3	3	6	0	1	7	0	0
3	9420002	.	G	A	6	4	10	0	1	11	0	0
3	9420541	.	T	C	2	5	7	0	0	7	0	0
3	9420613	.	A	T	3	3	6	0	0	6	0	0
3	9420973	.	A	G	3	6	9	0	0	9	0	0
3	9421668	.	G	A	0	5	5	0	6	11	0	0
3	9421840	.	T	G	6	4	10	0	0	10	0	0
3	9421878	.	C	A	7	7	14	0	1	15	0	0
3	9422130	.	T	C	1	3	4	1	0	5	0	0
3	9422176	.	T	A	2	2	4	1	0	5	0	0
3	9422245	.	T	C	1	2	3	0	0	3	0	0
3	9593338	.	G	T	5	6	11	0	0	11	0	0
3	9593344	.	A	T	6	7	13	0	0	13	0	0
3	9596311	.	C	T	6	6	12	0	1	13	0	0
3	9596313	.	C	T	8	6	14	0	0	14	0	0
3	9599885	.	G	T	9	4	13	0	1	14	0	0
3	9609472	.	C	G	11	14	25	0	2	27	0	0
3	9609502	.	G	A	9	12	21	0	1	22	0	0
3	9611371	.	G	A	1	11	12	0	10	22	0	0
3	9615718	.	G	A	12	12	24	0	2	26	0	0
3	9616399	.	C	T	12	17	29	0	0	29	0	0
3	9624849	.	G	A	13	12	25	0	1	26	0	0
3	9624882	.	G	A	10	11	21	0	0	21	0	0
3	9625735	.	C	T	13	8	21	0	1	22	0	0
3	9626276	.	G	T	8	9	17	0	0	17	0	0
3	9626307	.	T	G	7	9	16	0	0	16	0	0
3	9626373	.	T	C	2	2	4	0	1	5	0	0
3	9639162	.	A	G	13	6	19	0	2	21	0	0
3	9640322	.	C	T	0	12	12	0	12	24	0	0
3	9640467	.	A	G	9	20	29	0	0	29	0	0
3	9640659	.	A	G	17	16	33	0	0	33	0	0
3	9641205	.	C	T	11	6	17	0	2	19	0	0
3	9641217	.	T	C	6	11	17	0	0	17	0	0
3	9641244	.	C	T	14	10	24	0	0	24	0	0
3	9641337	.	C	T	10	14	24	0	6	30	0	0
3	9641451	.	C	T	2	14	16	0	21	37	0	0
3	9641859	.	G	A	5	8	13	0	2	15	0	0
3	9644745	.	G	A	8	3	11	0	0	11	0	0
3	9644772	.	A	G	10	5	15	0	0	15	0	0
3	9646926	.	A	G	10	10	20	0	0	20	0	0
3	9650313	.	A	G	10	8	18	0	1	19	0	0
3	9650327	.	A	G	7	9	16	0	0	16	0	0
3	9650403	.	A	G	12	6	18	0	2	20	0	0
3	9650598	.	G	A	7	4	11	0	0	11	0	0
3	9650631	.	C	T	0	4	4	0	5	9	0	0
3	9650682	.	T	C	8	0	8	0	7	15	0	0
3	9650706	.	A	G	13	7	20	0	0	20	0	0
3	9654675	.	G	A	10	8	18	0	0	18	0	0
3	9656656	.	C	T	1	6	7	0	11	18	0	0
3	9658463	.	C	T	2	9	11	0	4	15	0	0
3	9658481	.	A	G	6	9	15	0	0	15	0	0
3	9663966	.	A	T	6	6	12	0	0	12	0	0
3	9664193	.	C	T	0	7	7	0	5	12	0	0
3	9665608	.	G	T	5	5	10	0	2	12	0	0
3	9665629	.	A	G	4	6	10	0	1	11	0	0
3	9686142	.	C	A	5	2	7	0	0	7	0	0
3	9706117	.	T	G	4	4	8	0	0	8	0	0
3	9706331	.	A	G	7	4	11	0	0	11	0	0
3	9706445	.	T	C	11	4	15	0	1	16	0	0
3	9706577	.	T	C	5	4	9	0	0	9	0	0
3	9749791	.	C	A	3	2	5	0	0	5	0	0
3	9749806	.	A	C	2	0	2	0	2	4	0	0
3	9761259	.	C	T	0	2	2	0	1	3	0	0
3	10412073	.	G	A	3	5	8	0	0	8	0	0
3	10536511	.	C	T	21	8	29	0	1	30	0	0
3	10536673	.	A	G	11	5	16	0	2	18	0	0
3	10551014	.	G	A	7	12	19	0	0	19	0	0
3	10551976	.	G	A	6	3	9	0	0	9	0	0
3	10552740	.	T	G	5	4	9	0	0	9	0	0
3	10559821	.	T	C	5	0	5	0	4	9	0	0
3	10559824	.	G	T	6	4	10	0	0	10	0	0
3	10574232	.	A	G	3	2	5	0	0	5	0	0
3	10575699	.	C	G	8	4	12	0	0	12	0	0
3	10575701	.	T	G	9	4	13	0	0	13	0	0
3	10612103	.	G	A	9	5	14	0	0	14	0	0
3	10634422	.	C	T	12	15	27	0	3	30	0	0
3	10634437	.	T	C	13	10	23	0	4	27	0	0
3	10638536	.	C	T	3	3	6	0	0	6	0	0
3	11073388	.	A	G	18	12	30	0	0	30	0	0
3	11073431	.	C	T	13	12	25	0	0	25	0	0
3	11073454	.	T	C	13	11	24	0	1	25	0	0
3	11073517	.	C	T	10	9	19	0	1	20	0	0
3	11074764	.	C	G	15	2	17	0	15	32	0	0
3	11075120	.	G	A	9	20	29	0	1	30	0	0
3	11075190	.	G	A	2	18	20	0	10	30	0	0
3	11075310	.	A	G	19	0	19	0	11	30	0	0
3	11564499	.	G	A	9	7	16	0	1	17	0	0
3	11564523	.	T	C	12	11	23	0	0	23	0	0
3	11564592	.	C	T	8	18	26	0	0	26	0	0
3	11575354	.	G	A	1	10	11	0	7	18	0	0
3	11575471	.	T	C	8	5	13	0	1	14	0	0
3	11575591	.	C	A	11	8	19	1	0	20	0	0
3	11575743	.	C	T	6	0	6	0	0	6	0	0
3	11575753	.	T	C	4	7	11	0	1	12	0	0
3	11575828	.	A	C	2	3	5	0	0	5	0	0
3	11585488	.	T	A	19	17	36	0	2	38	0	0
3	11585492	.	G	A	19	17	36	0	1	37	0	0
3	11585541	.	T	C	12	7	19	0	0	19	0	0
3	11585549	.	T	C	4	13	17	0	0	17	0	0
3	11585815	.	A	G	13	10	23	0	0	23	0	0
3	11585852	.	T	A	13	17	30	0	0	30	0	0
3	11585937	.	G	A	14	16	30	0	3	33	0	0
3	11586002	.	T	G	19	7	26	0	14	40	0	0
3	11586331	.	C	T	3	12	15	0	30	45	0	0
3	11586346	.	C	T	34	10	44	0	3	47	0	0
3	11586382	.	G	A	27	16	43	0	4	47	0	0
3	11586635	.	A	G	33	12	45	0	5	50	0	0
3	11586679	.	C	T	26	15	41	1	1	43	0	0
3	11586695	.	C	T	0	9	9	3	17	29	0	0
3	11590280	.	A	G	18	19	37	0	4	41	0	0
3	11614970	.	T	C	32	21	53	0	1	54	0	0
3	11615007	.	A	T	31	18	49	0	4	53	0	0
3	11615041	.	T	C	29	1	30	0	25	55	0	0
3	11615109	.	G	A	32	19	51	0	0	51	0	0
3	11615133	.	A	G	32	15	47	0	4	51	0	0
3	11615224	.	A	G	32	15	47	0	2	49	0	0
3	11624298	.	A	G	21	14	35	0	3	38	0	0
3	11781003	.	A	C	16	12	28	3	1	33	1	0
3	11781079	.	T	C	20	7	27	0	3	30	0	0
3	11781113	.	G	A	23	18	41	0	3	44	0	0
3	11784743	.	G	A	14	13	27	0	6	33	0	0
3	11797076	.	C	T	2	9	11	0	12	23	0	0
3	11867824	.	C	T	1	3	4	0	0	4	0	0
3	11867832	.	T	C	1	2	3	0	0	3	0	0
3	11922695	.	G	T	4	5	9	0	0	10	1	0
3	11934018	.	G	A	13	10	23	0	0	23	0	0
3	11934021	.	T	C	12	11	23	0	1	24	0	0
3	11934072	.	C	T	10	14	24	0	0	24	0	0
3	11937063	.	G	A	12	13	25	0	0	25	0	0
3	11937093	.	T	C	12	11	23	0	1	24	0	0
3	11937295	.	C	T	9	5	14	0	1	15	0	0
3	11937499	.	T	C	13	9	22	0	0	22	0	0
3	11941226	.	A	C	16	12	28	0	4	32	0	0
3	11947012	.	A	G	13	0	13	1	7	21	0	0
3	11947250	.	T	A	4	4	8	0	0	8	0	0
3	11947275	.	T	A	5	2	7	0	1	8	0	0
3	11947401	.	A	T	8	11	19	0	0	19	0	0
3	11958700	.	A	T	2	4	6	0	1	7	0	0
3	11966623	.	G	A	6	2	8	0	0	8	0	0
3	12203028	.	C	G	6	6	12	0	0	12	0	0
3	12226807	.	T	C	2	5	7	0	0	7	0	0
3	12226808	.	C	T	2	5	7	0	0	7	0	0
3	12335244	.	C	A	2	5	7	0	1	8	0	0
3	12335748	.	C	T	2	2	4	0	0	4	0	0
3	12335842	.	T	A	2	3	5	0	1	6	0	0
3	12345351	.	T	C	6	6	12	0	2	14	0	0
3	12345373	.	G	T	8	10	18	0	1	19	0	0
3	12349672	.	A	G	15	13	28	0	1	29	0	0
3	12372085	.	C	T	2	3	5	1	1	7	0	0
3	12372309	.	G	A	3	2	5	0	0	5	0	0
3	12376677	.	G	A	5	6	11	0	0	11	0	0
3	12376803	.	C	T	0	11	11	0	3	14	0	0
3	12486458	.	T	C	1	2	3	0	0	3	0	0
3	12486492	.	A	T	0	2	2	0	1	3	0	0
3	12585267	.	G	A	3	3	6	0	7	13	0	0
3	12602469	.	T	C	6	2	8	0	0	8	0	0
3	12630622	.	C	G	8	0	8	0	8	16	0	0
3	12634976	.	C	A	6	5	11	0	0	11	0	0
3	12647220	.	G	T	12	4	16	0	1	17	0	0
3	12647229	.	A	G	10	6	16	0	1	17	0	0
3	12647256	.	C	T	11	5	16	0	1	17	0	0
3	12647316	.	T	C	9	3	12	0	0	12	0	0
3	12652186	.	T	C	11	7	18	1	0	19	0	0
3	12652243	.	T	C	9	7	16	0	2	18	0	0
3	12658066	.	G	C	11	7	18	0	2	21	1	0
3	12658518	.	T	C	5	10	15	0	0	15	0	0
3	12658536	.	T	C	4	9	13	0	0	13	0	0
3	12658591	.	G	A	7	8	15	0	0	15	0	0
3	12660690	.	C	G	12	4	16	0	0	16	0	0
3	12672020	.	C	T	11	9	20	0	1	21	0	0
3	12672068	.	C	T	15	6	21	0	1	22	0	0
3	12672195	.	C	A	10	4	14	0	0	14	0	0
3	12678482	.	A	G	14	6	20	0	2	22	0	0
3	12678993	.	T	C	11	15	26	0	1	27	0	0
3	12679090	.	C	T	15	4	19	0	0	19	0	0
3	12681141	.	C	T	17	15	32	0	0	32	0	0
3	12681359	.	G	A	12	9	21	0	1	22	0	0
3	12689490	.	T	C	18	6	24	0	0	24	0	0
3	12689511	.	A	G	13	0	13	0	6	19	0	0
3	12691823	.	C	A	13	8	21	0	1	22	0	0
3	12692858	.	G	T	22	14	36	0	0	36	0	0
3	12692859	.	T	G	22	14	36	0	0	36	0	0
3	12698831	.	A	T	22	7	29	0	2	31	0	0
3	12698890	.	T	C	19	14	33	0	0	33	0	0
3	12698897	.	A	G	19	16	35	0	0	35	0	0
3	12698976	.	C	A	15	12	27	0	1	28	0	0
3	12699026	.	T	A	9	11	20	0	1	21	0	0
3	12699044	.	T	C	10	9	19	0	0	19	0	0
3	12699073	.	T	A	11	8	19	0	0	19	0	0
3	12699260	.	A	G	13	6	19	0	1	21	1	0
3	12699274	.	C	T	14	10	24	0	0	25	1	0
3	12699311	.	A	T	21	13	34	0	0	34	0	0
3	12699525	.	C	T	17	11	28	1	1	30	0	0
3	12699645	.	G	C	14	17	31	0	0	31	0	0
3	12699662	.	C	T	11	18	29	0	1	30	0	0
3	12831862	.	A	C	7	4	11	1	2	14	0	0
3	13424069	.	C	A	5	5	10	0	2	12	0	0
3	13424392	.	T	G	6	6	12	0	1	13	0	0
3	13424418	.	T	A	5	4	9	0	1	10	0	0
3	13424531	.	C	A	2	5	7	0	0	7	0	0
3	13424538	.	T	G	2	6	8	0	0	8	0	0
3	13424595	.	A	T	3	13	16	0	0	16	0	0
3	13424601	.	T	G	2	12	14	0	1	15	0	0
3	13424635	.	G	A	2	7	9	0	0	9	0	0
3	13424738	.	A	T	7	3	10	0	0	10	0	0
3	13424739	.	A	T	6	3	9	0	0	9	0	0
3	13424847	.	G	T	9	11	20	0	0	20	0	0
3	13424877	.	T	C	10	13	23	0	0	23	0	0
3	13424919	.	T	C	8	12	20	0	0	20	0	0
3	13424950	.	A	T	6	7	13	0	1	14	0	0
3	13424968	.	C	T	5	9	14	0	0	14	0	0
3	13424989	.	C	A	1	8	9	0	4	13	0	0
3	13426691	.	G	A	5	15	20	0	2	22	0	0
3	13426754	.	C	A	1	14	15	0	3	18	0	0
3	13430606	.	A	G	7	15	22	0	3	25	0	0
3	13431327	.	G	A	10	12	22	0	1	23	0	0
3	13432609	.	C	T	8	11	19	0	2	21	0	0
3	13434860	.	C	T	0	9	9	0	11	20	0	0
3	13434888	.	A	G	10	11	21	0	1	22	0	0
3	13434920	.	C	G	8	7	15	0	0	15	0	0
3	13434930	.	A	T	9	8	17	0	0	17	0	0
3	13435924	.	A	G	8	4	12	0	1	13	0	0
3	13435998	.	T	C	10	0	10	0	10	20	0	0
3	13437767	.	G	A	7	9	16	0	0	16	0	0
3	13441459	.	G	A	3	19	22	0	13	35	0	0
3	13445758	.	G	A	2	19	21	0	13	34	0	0
3	13445819	.	T	C	8	17	25	0	1	26	0	0
3	13445884	.	T	G	7	9	16	1	3	20	0	0
3	13446019	.	C	T	8	7	15	0	2	17	0	0
3	13447870	.	C	T	14	15	29	0	1	30	0	0
3	13453494	.	C	T	5	2	7	0	0	7	0	0
3	13453500	.	A	G	5	1	6	0	0	6	0	0
3	13455893	.	T	C	2	0	2	0	4	6	0	0
3	13456064	.	C	T	1	5	6	0	0	6	0	0
3	13456108	.	G	T	1	2	3	0	1	4	0	0
3	13456214	.	A	G	3	2	5	0	0	5	0	0
3	13456303	.	G	A	1	3	4	0	0	4	0	0
3	13456316	.	T	C	1	2	3	0	0	3	0	0
3	13456436	.	A	G	3	5	8	0	0	8	0	0
3	13456472	.	C	T	3	3	6	0	1	7	0	0
3	13456492	.	T	C	1	6	7	0	1	8	0	0
3	13458400	.	T	C	2	0	2	0	6	8	0	0
3	13458430	.	C	T	1	4	5	0	4	9	0	0
3	13458443	.	G	A	3	4	7	0	0	7	0	0
3	13459669	.	A	G	1	2	3	0	0	3	0	0
3	13459678	.	G	C	1	0	1	0	2	3	0	0
3	13461228	.	C	A	2	2	4	0	0	4	0	0
3	13461234	.	A	T	3	1	4	0	0	4	0	0
3	13487973	.	G	A	2	2	4	0	0	4	0	0
3	13488321	.	G	A	7	2	9	0	0	9	0	0
3	13488486	.	T	A	2	2	4	0	1	5	0	0
3	13488518	.	G	C	1	2	3	0	0	3	0	0
3	13516015	.	T	C	4	2	6	0	0	6	0	0
3	13525976	.	C	G	4	5	9	0	0	9	0	0
3	13526043	.	A	G	3	2	5	0	1	6	0	0
3	13534291	.	C	T	0	4	4	0	3	7	0	0
3	13534311	.	G	C	2	4	6	0	1	7	0	0
3	13534339	.	C	T	0	3	3	0	2	5	0	0
3	13541879	.	C	T	1	4	5	0	4	9	0	0
3	13542252	.	C	T	4	4	8	0	0	8	0	0
3	13582031	.	A	T	2	2	4	0	0	4	0	0
3	13582156	.	T	C	8	8	16	0	1	17	0	0
3	13582181	.	G	A	13	10	23	0	1	24	0	0
3	13582217	.	G	T	13	14	27	0	2	29	0	0
3	13582220	.	A	T	14	13	27	0	0	27	0	0
3	13582288	.	A	T	16	13	29	0	3	32	0	0
3	13582295	.	T	A	15	16	31	0	2	33	0	0
3	13582547	.	C	G	1	15	16	0	18	34	0	0
3	13589391	.	G	T	10	20	30	0	1	31	0	0
3	13589412	.	G	A	12	19	31	0	0	31	0	0
3	13589469	.	A	G	10	22	32	0	1	33	0	0
3	13590995	.	G	A	13	22	35	0	1	36	0	0
3	13593605	.	C	T	16	10	26	0	1	27	0	0
3	13595100	.	A	G	11	11	22	0	0	22	0	0
3	13595245	.	G	A	17	9	26	0	0	26	0	0
3	13595686	.	C	T	21	12	33	0	0	33	0	0
3	13599436	.	A	G	11	9	20	0	0	20	0	0
3	13603365	.	T	G	6	4	10	0	2	12	0	0
3	13607036	.	G	A	1	8	9	0	2	11	0	0
3	13607051	.	T	C	2	7	9	0	2	11	0	0
3	13608054	.	A	G	4	0	4	0	4	8	0	0
3	13608153	.	A	G	1	3	4	0	0	4	0	0
3	13617993	.	G	T	4	6	10	0	0	10	0	0
3	13618203	.	A	T	1	5	6	0	0	6	0	0
3	13684347	.	A	G	1	3	4	0	0	4	0	0
3	13684377	.	A	G	2	3	5	0	0	5	0	0
3	13860363	.	G	A	21	16	37	0	1	38	0	0
3	14496729	.	T	C	22	1	23	0	14	37	0	0
3	14507505	.	A	G	5	4	9	0	0	9	0	0
3	14507506	.	A	G	5	4	9	0	0	9	0	0
3	14507564	.	A	G	6	4	10	0	0	10	0	0
3	14507609	.	A	G	5	3	8	0	0	8	0	0
3	14580598	.	A	C	2	4	6	0	0	6	0	0
3	14580728	.	G	A	1	4	5	0	0	5	0	0
3	14580746	.	G	A	1	2	3	0	0	3	0	0
3	14605750	.	T	C	3	9	12	0	1	13	0	0
3	14606095	.	C	T	2	2	4	0	0	4	0	0
3	14631392	.	G	A	0	1	1	0	2	3	0	0
3	14682097	.	A	T	2	3	5	0	0	5	0	0
3	14692201	.	T	C	16	17	33	0	2	35	0	0
3	14692204	.	T	C	15	0	15	0	18	33	0	0
3	14694835	.	G	A	12	16	28	0	0	28	0	0
3	14793651	.	T	C	3	6	9	0	0	9	0	0
3	14860158	.	C	T	14	13	27	0	2	29	0	0
3	15020506	.	C	T	7	15	22	0	4	26	0	0
3	15020548	.	T	A	16	15	31	0	2	33	0	0
3	15020572	.	C	T	19	20	39	0	1	40	0	0
3	15041021	.	C	T	20	16	36	0	1	37	0	0
3	15041084	.	T	C	22	21	43	0	2	45	0	0
3	15057214	.	G	T	20	17	37	0	1	38	0	0
3	15057538	.	C	T	13	27	40	0	1	41	0	0
3	15057549	.	T	G	26	11	37	0	4	41	0	0
3	15057656	.	G	A	4	14	18	0	21	39	0	0
3	15057697	.	G	T	2	23	25	0	5	30	0	0
3	15058023	.	T	A	2	5	7	2	0	9	0	0
3	15058278	.	A	T	16	14	30	0	0	30	0	0
3	15058323	.	A	G	11	16	27	0	1	28	0	0
3	15085528	.	C	T	8	4	12	0	0	12	0	0
3	15085530	.	G	T	7	4	11	0	0	11	0	0
3	15085669	.	A	G	16	10	26	0	0	26	0	0
3	15085821	.	C	T	8	17	25	0	1	26	0	0
3	15091183	.	C	T	0	6	6	0	5	11	0	0
3	15091201	.	A	G	3	8	11	0	0	11	0	0
3	15095987	.	A	G	11	12	23	0	1	24	0	0
3	15104165	.	G	A	2	4	6	0	0	6	0	0
3	15110967	.	T	C	2	3	5	0	0	5	0	0
3	15113378	.	A	G	4	3	7	0	0	7	0	0
3	15113423	.	G	A	5	3	8	0	2	10	0	0
3	15114919	.	G	A	4	3	7	1	0	8	0	0
3	15114935	.	C	T	3	3	6	1	0	7	0	0
3	15115138	.	G	A	2	8	10	0	2	12	0	0
3	15130981	.	T	G	2	3	5	0	1	6	0	0
3	15130993	.	C	T	5	4	9	0	0	9	0	0
3	15131217	.	T	C	1	5	6	0	2	8	0	0
3	15134427	.	G	A	3	3	6	0	0	6	0	0
3	15134493	.	T	C	1	3	4	0	0	4	0	0
3	15134537	.	T	A	1	2	3	0	0	3	0	0
3	15134894	.	T	A	11	6	17	0	1	18	0	0
3	15137023	.	C	T	3	9	12	0	0	12	0	0
3	15137045	.	A	G	8	5	13	0	1	14	0	0
3	15193773	.	T	A	13	10	23	0	0	23	0	0
3	15198701	.	A	G	15	10	25	0	1	26	0	0
3	15203329	.	C	A	26	11	37	0	1	38	0	0
3	15203371	.	A	C	14	25	39	0	2	41	0	0
3	15203388	.	T	G	25	16	41	0	0	41	0	0
3	15203935	.	C	T	7	9	16	0	1	17	0	0
3	15203977	.	G	A	13	13	26	0	0	26	0	0
3	15207876	.	T	A	13	18	31	0	1	32	0	0
3	15214252	.	A	C	10	7	17	0	0	17	0	0
3	15214300	.	T	A	3	6	9	0	0	9	0	0
3	15214462	.	C	A	7	12	19	0	0	19	0	0
3	15214475	.	T	A	6	11	17	0	0	17	0	0
3	15214683	.	C	T	8	4	12	3	5	20	0	0
3	15215101	.	T	A	5	4	9	0	0	9	0	0
3	15215599	.	G	A	6	6	12	0	0	12	0	0
3	15215625	.	G	A	7	10	17	1	1	19	0	0
3	15217246	.	A	G	6	13	19	0	1	20	0	0
3	15217255	.	C	T	6	14	20	0	0	20	0	0
3	15223921	.	G	A	11	8	19	0	0	19	0	0
3	15232447	.	A	G	36	24	60	0	4	64	0	0
3	15232481	.	G	A	25	29	54	0	1	55	0	0
3	15232498	.	G	A	27	21	48	0	1	49	0	0
3	15242201	.	C	T	4	18	22	0	33	55	0	0
3	15245973	.	C	T	30	19	49	0	1	50	0	0
3	15246060	.	T	C	26	25	51	0	2	53	0	0
3	15246871	.	C	T	28	26	54	1	2	57	0	0
3	15247060	.	T	C	26	19	45	0	1	46	0	0
3	15255286	.	C	T	22	16	38	0	1	39	0	0
3	15255334	.	C	T	3	18	21	0	7	28	0	0
3	15258440	.	T	A	9	16	25	0	2	27	0	0
3	15258676	.	G	A	20	10	30	0	1	31	0	0
3	15259118	.	G	A	16	22	38	1	1	40	0	0
3	15272263	.	A	G	7	7	14	0	1	15	0	0
3	15273982	.	G	C	9	8	17	0	0	17	0	0
3	15274280	.	G	A	0	11	11	0	15	26	0	0
3	15274320	.	G	A	14	13	27	0	0	27	0	0
3	15274649	.	G	A	0	7	7	0	16	23	0	0
3	15274691	.	T	C	15	10	25	0	0	25	0	0
3	15278931	.	A	G	9	0	9	0	12	21	0	0
3	15279045	.	C	G	10	19	29	0	0	29	0	0
3	15282328	.	C	T	17	12	29	0	0	29	0	0
3	15284041	.	C	T	9	11	20	0	1	21	0	0
3	15284047	.	C	T	8	12	20	0	0	20	0	0
3	15284513	.	C	A	6	5	11	0	11	22	0	0
3	15284604	.	G	A	0	5	5	0	8	13	0	0
3	15302507	.	A	G	2	4	6	0	0	6	0	0
3	15317262	.	A	G	2	4	6	0	0	6	0	0
3	15332476	.	C	A	13	20	33	0	0	33	0	0
3	15332538	.	C	G	22	16	38	0	2	40	0	0
3	15332641	.	C	T	16	20	36	0	1	37	0	0
3	15550837	.	C	T	9	8	17	0	0	17	0	0
3	15551446	.	A	C	12	9	21	0	2	23	0	0
3	15562804	.	G	A	0	17	17	0	19	36	0	0
3	15562834	.	A	C	16	18	34	0	0	35	1	0
3	15591107	.	C	T	14	5	19	0	2	21	0	0
3	15599576	.	A	G	13	0	13	0	16	29	0	0
3	15607970	.	T	G	22	14	36	0	1	37	0	0
3	15608000	.	C	A	22	18	40	0	2	42	0	0
3	15622966	.	A	G	6	2	8	0	0	8	0	0
3	15623003	.	A	T	1	3	4	0	0	4	0	0
3	15623132	.	T	G	1	2	3	0	2	5	0	0
3	15625347	.	C	T	1	2	3	0	0	3	0	0
3	15627722	.	G	A	11	5	16	0	0	16	0	0
3	15627806	.	G	C	10	9	19	0	0	19	0	0
3	15628704	.	A	C	4	3	7	1	0	8	0	0
3	15635237	.	T	C	4	5	9	0	1	10	0	0
3	15635249	.	T	C	3	6	9	0	1	10	0	0
3	15635288	.	T	A	5	6	11	0	0	11	0	0
3	15642367	.	C	T	5	3	8	0	1	9	0	0
3	15642384	.	T	C	5	4	9	0	0	9	0	0
3	15642468	.	A	T	9	3	12	0	0	12	0	0
3	15642472	.	A	T	8	3	11	0	1	12	0	0
3	15642539	.	C	T	3	5	8	0	0	8	0	0
3	15642897	.	C	T	1	1	2	0	1	3	0	0
3	15646974	.	T	A	7	9	16	0	2	18	0	0
3	15648759	.	T	C	2	7	9	0	0	9	0	0
3	15648767	.	C	T	4	6	10	0	0	10	0	0
3	15648886	.	C	T	2	7	9	0	0	9	0	0
3	15649675	.	G	A	5	8	13	0	1	14	0	0
3	15667548	.	G	A	8	6	14	0	1	15	0	0
3	15671578	.	A	T	9	4	13	0	1	14	0	0
3	15671703	.	G	A	4	5	9	0	0	9	0	0
3	15671704	.	A	G	3	5	8	0	0	8	0	0
3	15679004	.	C	A	3	4	7	0	0	7	0	0
3	15697388	.	A	G	11	15	26	0	1	27	0	0
3	15697454	.	A	G	9	11	20	0	0	20	0	0
3	15697487	.	G	T	8	9	17	0	0	17	0	0
3	15697529	.	C	T	8	7	15	0	0	15	0	0
3	15706550	.	T	A	9	16	25	0	1	26	0	0
3	15706582	.	G	A	13	11	24	0	1	25	0	0
3	15715141	.	A	G	4	5	9	0	0	9	0	0
3	15715907	.	T	C	8	4	12	0	2	14	0	0
3	15717641	.	C	G	1	5	6	0	2	8	0	0
3	15741954	.	C	T	14	10	24	0	0	24	0	0
3	15744752	.	A	G	20	0	20	0	18	38	0	0
3	15744895	.	G	A	19	26	45	0	2	47	0	0
3	15746427	.	T	A	12	12	24	0	1	25	0	0
3	15746488	.	T	C	13	15	28	0	0	28	0	0
3	15746518	.	G	T	14	15	29	0	1	30	0	0
3	15746612	.	G	A	11	15	26	0	2	28	0	0
3	15746613	.	T	C	11	16	27	0	1	28	0	0
3	15746701	.	C	T	13	9	22	0	2	24	0	0
3	15746884	.	G	T	4	13	17	0	2	19	0	0
3	15746937	.	A	T	4	5	9	0	0	9	0	0
3	15746938	.	C	T	4	5	9	0	0	9	0	0
3	15774083	.	T	A	3	7	10	0	0	10	0	0
3	15775783	.	A	G	1	5	6	0	0	6	0	0
3	15775992	.	C	G	7	0	7	0	5	12	0	0
3	15776000	.	G	A	3	7	10	0	3	13	0	0
3	15776027	.	G	A	1	6	7	0	6	13	0	0
3	15776060	.	C	T	9	8	17	0	1	18	0	0
3	15776153	.	T	C	9	5	14	0	0	14	0	0
3	15776377	.	G	A	10	7	17	0	0	17	0	0
3	15776429	.	G	A	7	2	9	0	0	9	0	0
3	15776603	.	T	A	8	7	15	0	0	15	0	0
3	15776624	.	G	A	6	6	12	0	0	12	0	0
3	15776729	.	A	G	5	5	10	0	0	10	0	0
3	15794907	.	C	G	11	1	12	0	11	23	0	0
3	15795012	.	C	T	10	13	23	0	0	23	0	0
3	15795090	.	C	T	19	12	31	0	1	32	0	0
3	15795192	.	A	G	12	14	26	0	2	28	0	0
3	15795395	.	G	A	12	9	21	0	2	23	0	0
3	15809394	.	G	C	2	2	4	0	0	4	0	0
3	15809862	.	C	T	1	4	5	0	0	5	0	0
3	15809868	.	A	C	0	3	3	0	1	4	0	0
3	15809969	.	G	T	1	2	3	0	0	3	0	0
3	15818992	.	T	C	7	4	11	0	0	11	0	0
3	15821653	.	C	T	7	8	15	2	1	18	0	0
3	15821763	.	C	T	9	6	15	0	1	16	0	0
3	15821919	.	C	T	7	5	12	0	1	13	0	0
3	15822017	.	A	T	7	9	16	0	0	16	0	0
3	15822354	.	A	G	6	0	6	0	7	13	0	0
3	15822542	.	A	T	4	6	10	0	0	10	0	0
3	15822628	.	A	T	9	5	14	0	0	14	0	0
3	15822668	.	T	C	10	6	16	0	0	16	0	0
3	15822706	.	A	T	9	7	16	0	1	17	0	0
3	15822721	.	T	C	14	6	20	0	1	21	0	0
3	15823267	.	C	A	4	2	6	1	0	7	0	0
3	15823373	.	C	A	11	12	23	0	0	23	0	0
3	15823578	.	T	A	5	7	12	0	1	13	0	0
3	15823857	.	T	A	17	12	29	0	2	31	0	0
3	15823858	.	C	T	14	12	26	0	4	30	0	0
3	15835605	.	A	C	21	15	36	0	2	38	0	0
3	15835616	.	G	A	3	15	18	0	23	41	0	0
3	15835777	.	G	A	2	15	17	0	13	30	0	0
3	15852739	.	T	A	8	6	14	0	0	14	0	0
3	15856170	.	G	C	5	4	9	0	0	9	0	0
3	15856234	.	C	A	2	10	12	0	4	16	0	0
3	15862581	.	A	T	8	12	20	0	1	21	0	0
3	15862687	.	G	A	12	9	21	0	3	24	0	0
3	15862895	.	G	A	10	4	14	0	0	14	0	0
3	15863398	.	G	C	9	9	18	0	1	19	0	0
3	15867593	.	G	A	12	11	23	0	0	23	0	0
3	15868504	.	C	T	12	7	19	0	3	22	0	0
3	15868578	.	C	T	6	4	10	0	5	15	0	0
3	15873653	.	A	G	13	6	19	0	0	19	0	0
3	15876085	.	T	A	2	10	12	0	0	12	0	0
3	15878957	.	A	G	8	4	12	0	0	12	0	0
3	15879331	.	G	A	5	5	10	0	0	10	0	0
3	15882141	.	A	G	7	3	10	0	0	10	0	0
3	15882171	.	T	C	4	5	9	0	0	9	0	0
3	15882177	.	G	T	5	3	8	0	0	8	0	0
3	15886590	.	G	A	8	9	17	0	0	17	0	0
3	15887079	.	C	T	4	4	8	0	5	13	0	0
3	15900668	.	A	C	11	6	17	1	2	20	0	0
3	15900764	.	C	T	4	3	7	0	0	7	0	0
3	15900849	.	T	C	3	9	12	0	2	14	0	0
3	15900875	.	T	G	3	0	3	0	8	11	0	0
3	15900998	.	C	T	3	6	9	0	1	10	0	0
3	15901024	.	C	T	7	5	12	0	0	12	0	0
3	15901147	.	A	T	4	6	10	0	1	11	0	0
3	15901187	.	A	G	9	0	9	0	5	14	0	0
3	15901481	.	C	T	7	6	13	0	0	13	0	0
3	15902013	.	A	C	11	8	19	0	0	19	0	0
3	15907410	.	G	A	15	15	30	0	2	32	0	0
3	15907421	.	T	C	14	18	32	0	1	33	0	0
3	15907523	.	T	G	26	22	48	0	0	48	0	0
3	15907610	.	T	G	17	18	35	0	2	37	0	0
3	15907619	.	C	T	16	17	33	0	2	35	0	0
3	15921020	.	A	G	14	16	30	0	1	31	0	0
3	15921045	.	T	C	16	18	34	0	1	35	0	0
3	15921089	.	T	C	18	18	36	0	1	37	0	0
3	15922002	.	A	T	20	19	39	0	0	39	0	0
3	15957830	.	T	G	15	0	15	0	26	42	1	0
3	15957896	.	T	C	20	27	47	0	2	49	0	0
3	15957962	.	T	C	25	24	49	0	0	49	0	0
3	15969632	.	A	C	20	19	39	0	0	39	0	0
3	15974017	.	A	T	28	24	52	1	0	53	0	0
3	15986073	.	G	A	1	23	24	0	31	55	0	0
3	15988337	.	A	G	13	21	34	7	1	42	0	0
3	15990688	.	C	A	3	13	16	0	1	17	0	0
3	15990698	.	A	G	3	8	11	0	3	14	0	0
3	15990797	.	C	T	11	9	20	0	1	21	0	0
3	15990891	.	G	A	10	4	14	0	0	14	0	0
3	15990929	.	A	T	8	3	11	0	0	11	0	0
3	15991041	.	C	A	1	4	5	0	15	20	0	0
3	15991141	.	C	T	3	8	11	0	4	15	0	0
3	15994064	.	C	T	4	12	16	0	1	17	0	0
3	15996759	.	G	T	6	13	19	0	1	20	0	0
3	15996819	.	G	T	14	4	18	0	1	20	1	0
3	16003199	.	C	A	1	5	6	0	0	6	0	0
3	16003276	.	T	A	5	6	11	0	0	11	0	0
3	16003282	.	A	T	6	5	11	0	0	11	0	0
3	16003331	.	T	A	14	9	23	0	1	24	0	0
3	16004015	.	G	A	21	17	38	0	1	39	0	0
3	16004240	.	G	A	16	25	41	1	2	44	0	0
3	16018463	.	A	T	8	6	14	0	0	14	0	0
3	16019165	.	C	A	11	7	18	0	0	18	0	0
3	16019451	.	A	G	14	5	19	0	1	20	0	0
3	16019455	.	A	T	15	7	22	0	0	22	0	0
3	16020210	.	C	A	10	3	13	0	0	13	0	0
3	16021057	.	A	G	5	3	8	0	0	8	0	0
3	16021208	.	G	A	7	3	10	0	0	10	0	0
3	16021210	.	T	G	7	2	9	0	1	10	0	0
3	16021244	.	G	A	4	7	11	0	0	11	0	0
3	16021397	.	C	T	6	10	16	0	1	17	0	0
3	16021491	.	T	C	5	2	7	0	1	8	0	0
3	16021531	.	C	T	4	2	6	0	0	6	0	0
3	16021723	.	T	A	6	9	15	0	1	16	0	0
3	16021820	.	G	A	3	2	5	0	0	5	0	0
3	16021960	.	C	T	7	4	11	0	0	11	0	0
3	16022076	.	C	T	0	8	8	0	11	19	0	0
3	16024429	.	C	T	8	7	15	0	1	16	0	0
3	16024459	.	G	A	3	11	14	0	0	14	0	0
3	16035067	.	T	G	2	3	5	0	0	5	0	0
3	16039493	.	G	A	9	11	20	0	1	21	0	0
3	16045215	.	G	A	12	23	35	0	4	39	0	0
3	16045404	.	A	C	35	30	65	0	4	69	0	0
3	16045544	.	A	G	32	37	69	3	0	72	0	0
3	16045569	.	C	G	40	35	75	3	0	79	1	0
3	16045592	.	T	A	44	27	71	1	0	72	0	0
3	16068159	.	T	G	22	24	46	0	1	47	0	0
3	16073274	.	A	T	18	19	37	0	2	39	0	0
3	16073434	.	A	C	14	2	16	0	23	39	0	0
3	16073453	.	G	A	10	22	32	0	3	35	0	0
3	16073481	.	C	T	13	25	38	0	2	40	0	0
3	16073547	.	C	T	27	18	45	0	2	47	0	0
3	16073594	.	C	T	4	31	35	0	23	58	0	0
3	16073991	.	G	A	31	29	60	0	8	68	0	0
3	16074016	.	T	A	32	34	66	0	0	66	0	0
3	16074031	.	G	A	28	29	57	0	1	58	0	0
3	16074141	.	G	T	24	22	46	1	5	52	0	0
3	16074155	.	G	A	28	17	45	1	4	50	0	0
3	16074340	.	C	G	32	25	57	0	4	61	0	0
3	16074376	.	C	T	2	21	23	0	32	55	0	0
3	16109894	.	G	A	4	2	6	0	0	6	0	0
3	16134797	.	C	G	0	11	11	1	10	22	0	0
3	16134798	.	C	G	11	9	20	1	1	22	0	0
3	16138950	.	C	G	8	14	22	0	1	23	0	0
3	16141709	.	A	T	10	4	14	0	1	15	0	0
3	16141725	.	C	T	3	9	12	0	2	14	0	0
3	16141803	.	C	T	3	8	11	0	0	11	0	0
3	16141870	.	C	T	2	9	11	2	0	13	0	0
3	16157220	.	T	G	4	6	10	0	0	10	0	0
3	16157243	.	T	A	7	9	16	0	0	16	0	0
3	16157328	.	G	T	11	19	30	0	0	30	0	0
3	16161653	.	G	T	16	17	33	0	3	36	0	0
3	16165135	.	T	C	7	10	17	0	1	18	0	0
3	16171589	.	G	A	11	8	19	0	1	20	0	0
3	16191248	.	C	T	8	4	12	0	0	12	0	0
3	16227536	.	A	C	7	8	15	0	1	16	0	0
3	16241142	.	T	A	3	3	6	0	0	6	0	0
3	16241162	.	A	T	2	2	4	0	0	4	0	0
3	16241621	.	A	G	7	9	16	0	1	17	0	0
3	16241695	.	A	G	3	5	8	0	0	8	0	0
3	16241699	.	C	A	5	3	8	0	0	8	0	0
3	16245299	.	G	A	1	2	3	0	0	3	0	0
3	16245517	.	A	G	1	2	3	0	0	3	0	0
3	16275770	.	G	A	2	2	4	0	1	5	0	0
3	16275821	.	A	T	3	3	6	0	1	7	0	0
3	16281537	.	A	G	1	2	3	0	0	3	0	0
3	16281669	.	T	C	2	3	5	0	1	6	0	0
3	16282080	.	T	A	1	3	4	0	0	4	0	0
3	16282198	.	T	G	3	1	4	0	3	7	0	0
3	16282295	.	T	C	1	1	2	0	1	3	0	0
3	16282525	.	T	A	5	2	7	0	0	7	0	0
3	16282534	.	T	C	5	2	7	0	0	7	0	0
3	16282656	.	C	G	6	5	11	0	1	12	0	0
3	16283092	.	C	T	2	9	11	0	0	11	0	0
3	16283196	.	A	T	2	2	4	0	0	4	0	0
3	16283219	.	T	C	5	2	7	0	0	7	0	0
3	16283389	.	G	A	3	4	7	0	0	7	0	0
3	16283546	.	T	A	3	2	5	0	0	5	0	0
3	16283554	.	G	C	4	2	6	0	0	6	0	0
3	16283791	.	T	A	10	5	15	0	1	16	0	0
3	16283797	.	T	C	7	11	18	0	0	18	0	0
3	16283860	.	A	G	8	5	13	1	0	14	0	0
3	16283861	.	G	A	8	5	13	1	0	14	0	0
3	16283989	.	G	T	7	4	11	0	1	12	0	0
3	16284258	.	C	T	2	2	4	0	1	5	0	0
3	16284414	.	A	G	9	5	14	0	4	18	0	0
3	16285193	.	C	T	1	4	5	0	0	5	0	0
3	16389180	.	G	T	10	8	18	0	1	19	0	0
3	16389230	.	C	T	17	10	27	0	0	27	0	0
3	16389517	.	C	T	11	10	21	0	0	21	0	0
3	16391695	.	G	A	7	12	19	0	0	19	0	0
3	16391719	.	T	C	8	1	9	0	11	20	0	0
3	16394522	.	A	G	13	7	20	0	0	20	0	0
3	16395548	.	A	G	8	4	12	0	1	13	0	0
3	16397627	.	A	T	3	9	12	0	1	13	0	0
3	16404204	.	T	C	4	7	11	0	1	12	0	0
3	16404370	.	G	A	5	3	8	0	2	10	0	0
3	16404382	.	G	A	6	7	13	0	0	13	0	0
3	16404406	.	G	C	6	6	12	0	0	12	0	0
3	16408960	.	A	G	4	4	8	0	0	8	0	0
3	16409330	.	G	A	9	3	12	0	0	12	0	0
3	16409485	.	C	A	0	5	5	0	5	10	0	0
3	16409491	.	T	A	2	5	7	0	1	8	0	0
3	16409551	.	A	G	2	3	5	0	0	5	0	0
3	16411173	.	C	T	2	2	4	0	0	4	0	0
3	16449620	.	C	T	2	4	6	0	0	6	0	0
3	16455693	.	G	A	2	4	6	0	0	6	0	0
3	16455740	.	C	A	3	6	9	0	0	9	0	0
3	16456144	.	A	T	1	3	4	0	0	4	0	0
3	16456222	.	T	A	2	3	5	0	0	5	0	0
3	16456255	.	C	T	4	2	6	0	0	6	0	0
3	16457404	.	A	G	4	2	6	0	0	6	0	0
3	16457412	.	C	G	3	3	6	0	0	6	0	0
3	16457532	.	G	A	5	3	8	0	0	8	0	0
3	16457843	.	C	A	2	4	6	0	0	6	0	0
3	16457921	.	A	T	4	4	8	0	0	8	0	0
3	16457967	.	T	C	8	4	12	1	0	13	0	0
3	16457975	.	C	T	8	3	11	1	0	12	0	0
3	16483204	.	G	C	1	3	4	0	0	4	0	0
3	16483205	.	C	T	0	3	3	0	1	4	0	0
3	16523904	.	A	G	1	4	5	0	0	5	0	0
3	16637830	.	C	T	14	11	25	1	2	28	0	0
3	16637877	.	G	A	12	12	24	1	1	26	0	0
3	16638069	.	C	T	12	11	23	0	4	27	0	0
3	16643170	.	A	G	11	9	20	0	1	21	0	0
3	16644899	.	G	T	0	17	17	0	13	30	0	0
3	16645507	.	A	C	21	22	43	0	4	47	0	0
3	16646520	.	A	G	18	18	36	0	2	38	0	0
3	16646562	.	T	C	15	19	34	0	1	35	0	0
3	16664476	.	T	C	4	5	9	0	1	10	0	0
3	16664530	.	C	T	7	3	10	0	0	10	0	0
3	16668671	.	C	T	15	5	20	0	0	20	0	0
3	16670880	.	T	G	5	0	5	0	11	16	0	0
3	16671831	.	A	G	5	0	5	0	13	18	0	0
3	16671849	.	A	G	6	0	6	0	13	19	0	0
3	16678754	.	G	A	1	5	6	0	14	20	0	0
3	16678830	.	C	T	11	4	15	0	0	15	0	0
3	16679136	.	C	T	12	6	18	0	1	19	0	0
3	16679171	.	T	G	9	6	15	0	2	17	0	0
3	16679172	.	G	T	11	6	17	0	0	17	0	0
3	16679238	.	C	T	11	5	16	0	0	16	0	0
3	16679248	.	C	T	12	4	16	0	1	17	0	0
3	16679349	.	G	A	7	3	10	0	0	10	0	0
3	16679520	.	G	A	8	10	18	0	0	18	0	0
3	16679556	.	G	A	1	6	7	0	8	15	0	0
3	16679561	.	A	G	8	0	8	0	6	14	0	0
3	16691951	.	A	G	1	2	3	0	0	3	0	0
3	16692232	.	A	G	4	3	7	0	0	7	0	0
3	16696369	.	G	A	1	2	3	0	0	3	0	0
3	16699603	.	G	A	2	2	4	0	0	4	0	0
3	16731938	.	A	G	11	0	11	0	10	21	0	0
3	16746036	.	T	C	9	24	33	0	1	34	0	0
3	16746659	.	A	T	4	4	8	0	1	9	0	0
3	16746666	.	T	C	4	4	8	0	0	8	0	0
3	16746718	.	T	A	6	6	12	0	0	12	0	0
3	16746756	.	G	A	7	6	13	0	1	14	0	0
3	16746782	.	A	G	6	7	13	0	0	13	0	0
3	16746849	.	C	A	7	11	18	0	0	18	0	0
3	16746871	.	T	G	5	11	16	0	0	16	0	0
3	16747148	.	T	C	10	8	18	0	2	20	0	0
3	16871503	.	G	A	3	3	6	0	1	7	0	0
3	16871504	.	G	T	4	3	7	0	0	7	0	0
3	16871745	.	G	A	2	2	4	0	0	4	0	0
3	16871897	.	T	C	1	3	4	0	0	4	0	0
3	16872038	.	T	A	3	3	6	0	0	6	0	0
3	16872084	.	A	G	5	3	8	0	0	8	0	0
3	16872200	.	C	T	6	3	9	0	2	11	0	0
3	16872453	.	A	T	5	2	7	0	0	7	0	0
3	16872493	.	T	C	4	5	9	0	0	9	0	0
3	16872572	.	T	C	4	6	10	0	1	11	0	0
3	16872584	.	G	A	0	6	6	0	5	11	0	0
3	16872634	.	A	G	4	3	7	0	0	7	0	0
3	16972991	.	T	C	1	5	6	0	0	6	0	0
3	17030751	.	A	G	4	0	4	0	3	7	0	0
3	17090749	.	T	C	5	5	10	0	0	10	0	0
3	17090956	.	T	C	5	6	11	0	0	11	0	0
3	17104220	.	T	C	6	9	15	0	0	15	0	0
3	17107128	.	C	G	2	8	10	0	0	10	0	0
3	17107131	.	T	C	2	7	9	0	1	10	0	0
3	17107194	.	T	A	1	2	3	0	0	3	0	0
3	17321119	.	T	C	2	3	5	0	0	5	0	0
3	17457811	.	G	A	3	4	7	0	1	8	0	0
3	17457880	.	A	T	1	2	3	0	0	3	0	0
3	17458045	.	C	T	2	2	4	0	0	4	0	0
3	17458120	.	T	C	1	4	5	0	0	5	0	0
3	17458888	.	A	G	9	0	9	0	6	15	0	0
3	17481844	.	C	T	4	3	7	0	0	7	0	0
3	17481886	.	T	C	9	4	13	0	0	13	0	0
3	17481955	.	G	A	1	5	6	0	7	13	0	0
3	17522960	.	A	G	1	1	2	0	5	7	0	0
3	17541134	.	C	T	1	2	3	0	0	3	0	0
3	17564259	.	C	T	1	3	4	0	0	4	0	0
3	17564280	.	C	G	1	2	3	0	0	3	0	0
3	17566911	.	G	A	1	2	3	0	0	3	0	0
3	17584134	.	C	T	1	3	4	0	0	4	0	0
3	17591140	.	G	A	0	4	4	0	1	5	0	0
3	17591558	.	G	C	1	3	4	0	0	4	0	0
3	17593257	.	A	G	1	2	3	0	0	3	0	0
3	17593336	.	C	T	3	3	6	0	0	6	0	0
3	17593342	.	C	T	3	3	6	0	0	6	0	0
3	17600190	.	C	T	2	4	6	0	0	6	0	0
3	17600201	.	C	T	2	4	6	0	0	6	0	0
3	17600574	.	A	T	4	4	8	0	0	8	0	0
3	17602332	.	A	C	7	3	10	0	0	10	0	0
3	17603678	.	T	A	2	2	4	0	0	4	0	0
3	17603683	.	T	C	2	2	4	0	0	4	0	0
3	17603926	.	T	C	2	2	4	0	0	4	0	0
3	17615630	.	A	C	4	4	8	0	1	9	0	0
3	17634816	.	T	C	19	19	38	0	2	40	0	0
3	17640544	.	C	T	29	14	43	0	1	44	0	0
3	17647236	.	T	C	19	15	34	0	3	37	0	0
3	17650732	.	A	G	23	26	49	0	5	54	0	0
3	17650927	.	C	G	18	19	37	0	0	37	0	0
3	17651072	.	A	G	24	2	26	0	24	50	0	0
3	17651382	.	C	T	14	12	26	0	2	28	0	0
3	17651718	.	C	T	22	20	42	0	3	45	0	0
3	17651837	.	C	T	6	19	25	0	1	26	0	0
3	17654944	.	T	C	3	4	7	0	0	7	0	0
3	17660084	.	A	G	2	4	6	0	0	6	0	0
3	17669484	.	T	C	1	5	6	0	0	6	0	0
3	17671843	.	G	A	4	2	6	0	1	7	0	0
3	17671888	.	G	A	8	5	13	0	0	13	0	0
3	17671897	.	T	C	10	7	17	0	0	17	0	0
3	17673157	.	G	C	6	10	16	0	0	16	0	0
3	17673250	.	C	T	6	8	14	0	0	14	0	0
3	17673386	.	C	T	9	7	16	0	0	16	0	0
3	17677237	.	G	T	8	4	12	0	0	12	0	0
3	17678335	.	T	C	5	8	13	0	1	14	0	0
3	17806542	.	C	T	9	3	12	0	0	12	0	0
3	17813564	.	A	G	5	0	5	0	5	10	0	0
3	17847103	.	T	G	12	12	24	0	2	26	0	0
3	17853383	.	T	C	7	8	15	0	0	15	0	0
3	17853488	.	C	T	14	9	23	0	0	23	0	0
3	17867440	.	T	C	4	5	9	0	1	10	0	0
3	17867564	.	T	C	17	5	22	0	1	23	0	0
3	17867668	.	T	A	13	10	23	0	0	23	0	0
3	17867683	.	T	A	12	10	22	0	0	22	0	0
3	17867716	.	C	A	9	9	18	0	0	18	0	0
3	17868103	.	G	A	10	5	15	0	1	16	0	0
3	17868174	.	T	G	10	8	18	0	0	18	0	0
3	17868416	.	G	A	6	4	10	0	0	10	0	0
3	17868540	.	T	C	17	0	17	0	5	22	0	0
3	17868585	.	G	A	12	5	17	0	1	18	0	0
3	17868586	.	T	C	12	6	18	0	0	18	0	0
3	17868669	.	C	A	10	4	14	0	0	14	0	0
3	17868673	.	A	G	10	5	15	0	0	15	0	0
3	17869300	.	G	A	24	10	34	0	0	34	0	0
3	17886528	.	G	A	14	15	29	0	2	31	0	0
3	17886996	.	C	T	15	17	32	0	0	32	0	0
3	17894416	.	A	G	10	13	23	1	0	24	0	0
3	17896899	.	T	C	16	10	26	0	3	29	0	0
3	17896956	.	T	C	17	15	32	0	2	34	0	0
3	17897723	.	T	C	19	14	33	0	1	34	0	0
3	17899820	.	A	G	16	2	18	0	18	36	0	0
3	17902600	.	C	T	15	13	28	0	4	32	0	0
3	17907520	.	C	T	22	26	48	0	1	49	0	0
3	17907545	.	T	C	19	33	52	0	0	52	0	0
3	17907626	.	T	C	22	26	48	0	3	51	0	0
3	17907741	.	A	T	30	25	55	0	2	57	0	0
3	17907801	.	T	A	22	22	44	0	3	47	0	0
3	17907812	.	T	C	22	21	43	0	2	45	0	0
3	17907861	.	G	T	26	21	47	0	2	49	0	0
3	17907907	.	T	C	23	18	41	0	9	50	0	0
3	17907976	.	G	A	2	18	20	0	18	38	0	0
3	17908002	.	A	G	24	19	43	0	1	44	0	0
3	17908034	.	G	T	25	21	46	0	2	48	0	0
3	17908730	.	T	C	14	28	42	0	0	42	0	0
3	17939970	.	C	T	3	2	5	0	1	6	0	0
3	17940057	.	G	C	6	8	14	0	0	14	0	0
3	17940184	.	G	A	0	4	4	0	5	9	0	0
3	17940289	.	T	G	1	8	9	0	0	9	0	0
3	17942432	.	C	T	8	6	14	0	0	14	0	0
3	17942468	.	G	A	1	7	8	0	10	18	0	0
3	17942471	.	C	T	7	9	16	0	1	17	0	0
3	17942627	.	C	A	11	7	18	0	0	18	0	0
3	17942948	.	G	C	18	9	27	0	1	28	0	0
3	17943332	.	A	G	9	3	12	0	0	12	0	0
3	17943523	.	G	T	8	15	23	0	1	24	0	0
3	17943529	.	C	A	8	15	23	0	0	23	0	0
3	17943567	.	C	A	6	10	16	0	1	17	0	0
3	17943648	.	A	C	7	7	14	0	0	14	0	0
3	17943679	.	C	T	6	8	14	0	5	19	0	0
3	17943881	.	C	G	10	4	14	0	0	14	0	0
3	17943882	.	T	A	10	4	14	0	0	14	0	0
3	17943934	.	T	G	10	0	10	1	6	17	0	0
3	17944149	.	A	G	9	6	15	0	0	15	0	0
3	17967826	.	C	A	14	5	19	0	0	19	0	0
3	17967859	.	G	A	10	9	19	0	0	19	0	0
3	17967880	.	A	G	9	11	20	0	0	20	0	0
3	17967896	.	T	A	5	12	17	0	0	17	0	0
3	17984415	.	G	A	11	7	18	0	1	19	0	0
3	17986376	.	A	C	12	9	21	1	1	23	0	0
3	17988049	.	T	A	12	8	20	0	3	23	0	0
3	17991395	.	A	T	11	14	25	0	3	28	0	0
3	17991465	.	C	T	15	15	30	0	1	31	0	0
3	17991468	.	A	G	12	2	14	0	17	31	0	0
3	17993540	.	G	A	16	13	29	0	2	31	0	0
3	17993892	.	C	T	13	11	24	1	0	25	0	0
3	17995833	.	G	A	13	14	27	0	3	30	0	0
3	17995860	.	T	C	14	13	27	0	0	27	0	0
3	17996064	.	A	T	10	11	21	0	2	23	0	0
3	17996133	.	T	C	9	12	21	0	4	25	0	0
3	17999665	.	T	G	20	21	41	0	1	42	0	0
3	17999773	.	T	C	22	18	40	0	1	41	0	0
3	18002989	.	T	G	22	12	34	0	1	35	0	0
3	18004984	.	T	C	25	18	43	0	1	44	0	0
3	18004987	.	C	T	23	16	39	0	2	41	0	0
3	18006423	.	T	C	18	21	39	0	2	41	0	0
3	18007841	.	A	G	12	4	16	0	3	19	0	0
3	18007946	.	T	G	17	16	33	0	3	36	0	0
3	18008040	.	C	G	17	23	40	0	2	42	0	0
3	18008083	.	T	C	17	23	40	0	0	40	0	0
3	18008095	.	A	T	18	26	44	0	0	44	0	0
3	18008273	.	T	A	17	19	36	0	0	36	0	0
3	18008351	.	C	G	29	17	46	0	0	46	0	0
3	18008510	.	T	C	24	17	41	1	1	43	0	0
3	18008564	.	A	G	25	18	43	0	3	46	0	0
3	18008642	.	G	C	18	13	31	0	1	32	0	0
3	18008833	.	C	A	7	2	9	0	1	10	0	0
3	18008853	.	G	A	6	2	8	0	0	8	0	0
3	18056951	.	G	C	6	3	9	0	0	9	0	0
3	18059698	.	G	A	10	6	16	0	0	16	0	0
3	18060929	.	C	A	2	2	4	0	0	4	0	0
3	18061478	.	G	T	2	2	4	0	0	4	0	0
3	18061548	.	A	G	4	3	7	0	0	7	0	0
3	18063189	.	G	A	0	9	9	0	7	16	0	0
3	18066006	.	T	C	5	10	15	0	0	15	0	0
3	18069821	.	C	T	10	12	22	0	1	23	0	0
3	18070082	.	T	C	5	6	11	0	4	15	0	0
3	18079296	.	G	A	4	9	13	0	0	13	0	0
3	18079331	.	C	G	4	9	13	0	0	13	0	0
3	18079662	.	A	G	6	0	6	0	10	16	0	0
3	18079754	.	T	C	6	9	15	0	0	15	0	0
3	18079787	.	C	T	7	8	15	0	1	16	0	0
3	18080208	.	G	A	8	9	17	0	1	18	0	0
3	18080439	.	T	C	3	3	6	0	0	6	0	0
3	18186295	.	C	T	7	16	23	0	20	43	0	0
3	18189151	.	C	A	34	18	52	0	1	53	0	0
3	18189250	.	A	T	16	27	43	0	0	43	0	0
3	18303452	.	A	G	9	6	15	0	1	16	0	0
3	18303473	.	G	C	12	7	19	0	0	19	0	0
3	18303515	.	T	C	18	5	23	0	0	23	0	0
3	18303521	.	T	A	17	4	21	0	0	21	0	0
3	18322462	.	T	G	11	6	17	0	0	17	0	0
3	18322504	.	G	A	9	4	13	0	0	13	0	0
3	18325373	.	G	A	8	3	11	0	0	11	0	0
3	18333407	.	A	G	16	8	24	0	0	24	0	0
3	18333449	.	T	C	13	5	18	0	1	19	0	0
3	18339312	.	G	A	12	4	16	0	0	16	0	0
3	18339426	.	C	T	0	8	8	0	11	19	0	0
3	18349286	.	C	T	13	3	16	0	0	16	0	0
3	18376403	.	A	T	19	7	26	0	2	28	0	0
3	18376408	.	A	T	17	8	25	0	1	26	0	0
3	18376464	.	T	C	15	12	27	0	0	27	0	0
3	18377229	.	T	G	13	10	23	0	0	23	0	0
3	18377230	.	A	G	13	10	23	0	0	23	0	0
3	18377406	.	C	T	0	16	16	0	8	24	0	0
3	18377441	.	A	T	5	19	24	0	3	27	0	0
3	18377514	.	T	C	12	9	21	0	1	22	0	0
3	18377728	.	C	T	1	18	19	0	20	39	0	0
3	18379645	.	T	G	7	7	14	0	1	15	0	0
3	18383126	.	A	G	4	6	10	0	1	11	0	0
3	18383141	.	G	A	5	8	13	0	1	14	0	0
3	18384272	.	C	T	6	12	18	0	2	20	0	0
3	18384424	.	T	A	9	10	19	0	0	19	0	0
3	18384456	.	G	A	2	4	6	0	0	6	0	0
3	18399412	.	A	G	37	35	72	0	3	75	0	0
3	18399695	.	G	A	30	41	71	0	2	73	0	0
3	18400615	.	A	C	32	30	62	0	4	67	1	0
3	18400819	.	G	A	37	33	70	0	2	73	1	0
3	18405239	.	A	C	13	1	14	0	8	22	0	0
3	18407179	.	A	T	30	23	53	0	2	55	0	0
3	18407184	.	T	C	29	1	30	0	25	55	0	0
3	18409607	.	A	G	31	32	63	0	0	63	0	0
3	18409612	.	T	G	31	30	61	0	3	64	0	0
3	18410941	.	T	C	5	10	15	0	0	15	0	0
3	18429667	.	G	A	0	3	3	0	2	5	0	0
3	18447738	.	T	C	3	9	12	0	0	12	0	0
3	18448093	.	C	T	13	7	20	0	0	20	0	0
3	18448234	.	A	G	5	9	14	0	1	15	0	0
3	18448294	.	T	C	8	7	15	0	0	15	0	0
3	18468857	.	T	C	3	3	6	0	1	7	0	0
3	18469004	.	T	C	10	8	18	0	0	18	0	0
3	18473078	.	A	G	9	1	10	0	8	18	0	0
3	18487320	.	G	T	8	10	18	0	0	18	0	0
3	18498313	.	T	C	8	10	18	0	2	20	0	0
3	18498486	.	C	T	8	5	13	0	1	14	0	0
3	18498689	.	C	G	3	0	3	0	8	11	0	0
3	18561461	.	T	C	5	5	10	0	0	10	0	0
3	18562193	.	T	C	6	3	9	0	0	9	0	0
3	18562235	.	G	A	6	4	10	0	0	10	0	0
3	18562418	.	T	C	3	4	7	0	0	7	0	0
3	18562584	.	T	C	3	6	9	0	0	9	0	0
3	18563512	.	A	T	1	3	4	0	0	4	0	0
3	18563779	.	T	C	1	3	4	0	0	4	0	0
3	18568896	.	G	A	9	6	15	0	0	15	0	0
3	18569080	.	C	A	5	2	7	0	1	8	0	0
3	18569617	.	T	G	6	3	9	0	0	9	0	0
3	18569659	.	G	C	8	5	13	0	1	14	0	0
3	18569699	.	C	A	8	6	14	0	1	15	0	0
3	18570029	.	A	T	3	8	11	0	1	12	0	0
3	18570041	.	G	T	0	9	9	0	4	13	0	0
3	18570142	.	T	C	8	6	14	1	0	15	0	0
3	18570161	.	C	T	5	5	10	1	0	11	0	0
3	18570434	.	A	C	8	9	17	0	0	17	0	0
3	18570683	.	G	C	8	7	15	0	0	15	0	0
3	18570696	.	G	A	6	5	11	0	1	12	0	0
3	18570730	.	C	A	10	6	16	0	0	16	0	0
3	18570759	.	A	G	6	6	12	0	1	13	0	0
3	18570815	.	G	A	2	7	9	0	0	9	0	0
3	18570904	.	G	A	2	3	5	0	0	5	0	0
3	18570922	.	T	C	2	3	5	0	0	5	0	0
3	18571010	.	A	G	2	2	4	0	0	4	0	0
3	18650014	.	G	A	2	2	4	0	0	4	0	0
3	18650268	.	G	T	1	2	3	0	0	3	0	0
3	18650458	.	A	T	0	2	2	0	1	3	0	0
3	18676153	.	C	T	5	7	12	0	0	12	0	0
3	18676186	.	G	A	9	11	20	0	0	20	0	0
3	18676190	.	T	A	10	11	21	0	0	21	0	0
3	18676224	.	A	T	8	6	14	0	2	16	0	0
3	18676551	.	C	T	1	3	4	0	6	10	0	0
3	18676830	.	G	A	6	5	11	0	1	12	0	0
3	18676832	.	G	A	7	5	12	0	0	12	0	0
3	18677047	.	A	T	6	4	10	0	0	10	0	0
3	18677077	.	A	G	9	8	17	0	1	18	0	0
3	18677171	.	C	T	13	17	30	0	1	31	0	0
3	18677314	.	C	T	9	8	17	0	2	19	0	0
3	18677389	.	G	T	12	10	22	0	2	24	0	0
3	18680023	.	A	C	13	11	24	0	0	24	0	0
3	18685468	.	A	T	22	24	46	0	0	46	0	0
3	18685471	.	T	A	19	22	41	0	2	43	0	0
3	18685669	.	T	C	20	12	32	0	2	34	0	0
3	18685762	.	C	G	2	9	11	0	16	27	0	0
3	18685918	.	T	C	19	17	36	0	1	37	0	0
3	18686542	.	T	C	14	15	29	0	0	29	0	0
3	18686781	.	T	C	11	0	11	0	13	24	0	0
3	18687899	.	G	T	2	3	5	0	0	5	0	0
3	18688780	.	G	A	4	8	12	0	0	12	0	0
3	18688852	.	A	G	5	4	9	0	0	9	0	0
3	18689384	.	C	T	1	8	9	0	7	16	0	0
3	18692264	.	C	T	6	6	12	0	0	12	0	0
3	18694054	.	T	C	4	0	4	0	7	11	0	0
3	18702639	.	T	C	2	5	7	0	0	7	0	0
3	18702657	.	T	G	2	7	9	0	0	9	0	0
3	18704081	.	C	A	6	5	11	0	0	11	0	0
3	18704114	.	T	A	5	7	12	0	0	12	0	0
3	18704159	.	A	G	5	4	9	0	0	9	0	0
3	18704171	.	A	G	5	4	9	0	0	9	0	0
3	18710296	.	A	G	4	4	8	0	1	9	0	0
3	18710326	.	G	A	3	6	9	0	0	9	0	0
3	18720511	.	A	G	6	4	10	0	0	10	0	0
3	18720644	.	C	T	0	3	3	0	7	10	0	0
3	18720719	.	A	G	3	3	6	0	0	6	0	0
3	18720949	.	G	A	3	2	5	0	0	5	0	0
3	18723030	.	G	A	6	2	8	0	0	8	0	0
3	18723036	.	T	C	6	2	8	0	1	9	0	0
3	18723095	.	A	G	5	5	10	1	0	11	0	0
3	18732955	.	A	T	10	5	15	0	0	15	0	0
3	18732969	.	G	C	9	6	15	0	0	15	0	0
3	18758171	.	C	T	4	3	7	0	0	7	0	0
3	18760534	.	T	C	6	3	9	0	1	10	0	0
3	18760539	.	G	A	1	4	5	0	6	11	0	0
3	18765436	.	T	C	3	2	5	0	1	6	0	0
3	18769081	.	T	C	1	6	7	0	0	7	0	0
3	18769165	.	T	C	3	4	7	0	0	7	0	0
3	18769380	.	C	A	3	3	6	0	1	7	0	0
3	18769436	.	G	C	3	5	8	0	1	9	0	0
3	18769741	.	G	A	2	6	8	0	1	9	0	0
3	18775305	.	C	A	16	11	27	0	1	28	0	0
3	18777284	.	T	C	19	16	35	0	0	35	0	0
3	18778996	.	A	T	11	11	22	0	0	22	0	0
3	18787884	.	G	A	11	12	23	0	0	23	0	0
3	18795907	.	G	T	1	8	9	0	1	10	0	0
3	18795938	.	T	A	3	6	9	0	0	9	0	0
3	18796218	.	C	T	2	4	6	0	0	6	0	0
3	18799171	.	G	A	2	3	5	0	0	5	0	0
3	18799290	.	C	A	1	2	3	0	0	3	0	0
3	18799474	.	C	A	1	4	5	0	0	5	0	0
3	18807519	.	C	G	1	3	4	0	0	4	0	0
3	18817622	.	T	C	5	2	7	0	1	9	1	0
3	18818368	.	G	A	5	3	8	0	0	8	0	0
3	18818395	.	G	A	1	3	4	0	6	10	0	0
3	18818893	.	T	C	4	7	11	0	0	11	0	0
3	18818929	.	C	T	9	5	14	0	0	14	0	0
3	18818962	.	A	G	10	4	14	0	0	14	0	0
3	18819979	.	T	C	2	11	13	0	0	13	0	0
3	18821163	.	C	T	10	5	15	0	0	15	0	0
3	18823027	.	T	C	8	7	15	0	1	16	0	0
3	18823331	.	T	C	4	5	9	0	0	9	0	0
3	18827249	.	G	T	12	10	22	0	1	23	0	0
3	18827491	.	T	C	8	6	14	0	0	14	0	0
3	18827509	.	G	A	15	8	23	0	0	23	0	0
3	18833001	.	G	A	3	7	10	0	11	21	0	0
3	18833016	.	C	T	7	9	16	0	2	18	0	0
3	18835665	.	C	T	10	7	17	0	0	17	0	0
3	18835852	.	C	G	7	8	15	0	0	15	0	0
3	18836023	.	T	C	7	5	12	0	1	13	0	0
3	18836168	.	A	G	7	6	13	0	1	14	0	0
3	18836857	.	A	T	13	10	23	0	0	23	0	0
3	18836935	.	T	G	9	10	19	0	0	19	0	0
3	18836986	.	C	A	4	2	6	0	1	7	0	0
3	18836995	.	C	T	4	2	6	0	1	7	0	0
3	18837029	.	G	A	6	5	11	0	0	11	0	0
3	18837095	.	A	T	6	13	19	0	0	19	0	0
3	18837111	.	G	A	1	9	10	0	4	14	0	0
3	18837238	.	A	G	5	2	7	0	0	7	0	0
3	18837456	.	G	A	11	7	18	0	0	18	0	0
3	18837468	.	A	T	10	9	19	0	0	19	0	0
3	18837887	.	G	A	1	11	12	0	17	29	0	0
3	18837917	.	A	T	17	10	27	0	0	27	0	0
3	18837995	.	C	T	10	4	14	0	0	14	0	0
3	18838097	.	A	C	6	7	13	0	0	13	0	0
3	18838547	.	C	T	9	4	13	0	0	13	0	0
3	18838595	.	T	A	11	5	16	0	1	17	0	0
3	18838715	.	G	C	5	7	12	0	0	12	0	0
3	18838728	.	T	G	4	7	11	0	0	11	0	0
3	18838900	.	T	A	1	4	5	0	2	7	0	0
3	18838981	.	C	T	3	3	6	0	0	6	0	0
3	18921526	.	C	T	3	2	5	0	0	5	0	0
3	18922745	.	T	C	4	2	6	0	0	6	0	0
3	18922801	.	G	A	2	5	7	0	0	7	0	0
3	18922819	.	C	T	2	6	8	0	0	8	0	0
3	18922892	.	A	G	4	3	7	0	0	7	0	0
3	18923209	.	C	A	2	5	7	0	0	7	0	0
3	18923536	.	C	T	6	2	8	0	0	8	0	0
3	18923644	.	C	T	2	6	8	0	1	9	0	0
3	18923824	.	A	T	1	2	3	0	0	3	0	0
3	19006010	.	G	A	4	14	18	0	0	18	0	0
3	19006388	.	G	A	9	13	22	0	2	24	0	0
3	19019232	.	A	G	3	3	6	0	0	6	0	0
3	19042691	.	A	C	3	5	8	0	0	8	0	0
3	19068868	.	G	A	4	12	16	0	0	16	0	0
3	19090695	.	A	G	2	2	4	0	0	4	0	0
3	19090884	.	A	G	2	6	8	0	0	8	0	0
3	19162582	.	A	G	5	4	9	0	0	9	0	0
3	19162654	.	A	G	7	10	17	0	0	17	0	0
3	19162663	.	A	G	7	8	15	0	0	15	0	0
3	19162717	.	A	G	7	9	16	0	0	16	0	0
3	19172078	.	A	G	6	3	9	0	0	9	0	0
3	19172087	.	C	T	0	2	2	0	6	9	1	0
3	19172284	.	G	T	8	9	17	0	0	17	0	0
3	19180634	.	G	A	7	4	11	0	0	11	0	0
3	19180650	.	C	G	5	4	9	0	2	11	0	0
3	19180775	.	C	A	6	7	13	0	0	13	0	0
3	19180778	.	A	G	4	7	11	0	0	12	1	0
3	19180811	.	C	T	3	4	7	0	0	7	0	0
3	19194126	.	C	T	0	5	5	0	7	12	0	0
3	19194135	.	A	T	7	6	13	0	0	13	0	0
3	19200437	.	C	T	8	4	12	0	0	12	0	0
3	19207219	.	A	G	12	0	12	0	11	23	0	0
3	19210238	.	T	C	22	12	34	0	0	34	0	0
3	19210287	.	A	G	24	0	24	0	14	38	0	0
3	19210495	.	T	C	2	3	5	0	0	5	0	0
3	19264751	.	A	G	8	7	15	0	2	17	0	0
3	19264760	.	T	A	11	4	15	0	3	18	0	0
3	19264787	.	G	T	13	7	20	0	0	20	0	0
3	19264874	.	T	C	4	11	15	0	0	15	0	0
3	19267552	.	C	T	18	10	28	0	2	30	0	0
3	19267564	.	T	C	22	10	32	0	3	35	0	0
3	19267906	.	A	G	15	0	15	0	10	25	0	0
3	19267963	.	A	G	12	13	25	0	0	25	0	0
3	19270732	.	C	T	17	12	29	0	2	31	0	0
3	19271549	.	A	G	11	17	28	0	2	30	0	0
3	19273907	.	A	G	22	14	36	0	2	38	0	0
3	19274532	.	C	G	13	15	28	0	1	29	0	0
3	19274544	.	A	C	16	14	30	0	1	31	0	0
3	19274688	.	T	C	13	15	28	0	0	28	0	0
3	19277027	.	A	G	17	15	32	0	0	32	0	0
3	19277084	.	T	A	23	14	37	0	0	37	0	0
3	19278247	.	T	C	22	22	44	0	1	45	0	0
3	19278796	.	C	T	19	18	37	0	2	39	0	0
3	19281259	.	G	A	2	22	24	0	15	39	0	0
3	19281310	.	T	A	21	16	37	0	0	37	0	0
3	19336553	.	T	A	1	6	7	0	0	7	0	0
3	19338418	.	A	T	2	2	4	0	0	4	0	0
3	19338599	.	C	T	3	2	5	0	0	5	0	0
3	19338875	.	C	T	2	4	6	0	1	7	0	0
3	19339594	.	T	C	6	3	9	0	1	10	0	0
3	19339833	.	A	G	4	7	11	0	0	11	0	0
3	19346162	.	C	G	5	2	7	0	1	8	0	0
3	19346376	.	C	T	4	9	13	0	1	14	0	0
3	19346394	.	C	T	3	6	9	0	0	9	0	0
3	19354657	.	G	C	7	10	17	0	1	18	0	0
3	19354768	.	A	C	2	5	7	0	1	8	0	0
3	19354902	.	T	C	5	7	12	0	1	13	0	0
3	19609716	.	G	A	11	7	18	0	1	19	0	0
3	19609747	.	G	A	12	5	17	0	1	18	0	0
3	19609897	.	A	C	11	16	27	0	1	28	0	0
3	19610495	.	T	A	4	7	11	0	0	11	0	0
3	19610648	.	A	T	15	9	24	0	1	25	0	0
3	19610655	.	G	T	17	8	25	0	2	27	0	0
3	19610865	.	A	C	24	22	46	0	1	47	0	0
3	19610933	.	A	G	4	3	7	0	0	7	0	0
3	19665429	.	G	A	2	2	4	0	0	4	0	0
3	19673523	.	A	C	4	2	6	0	0	6	0	0
3	19674329	.	G	A	0	2	2	0	7	9	0	0
3	19674385	.	C	T	5	2	7	0	0	7	0	0
3	19678301	.	A	G	2	6	8	0	0	8	0	0
3	19678310	.	C	T	1	6	7	0	0	7	0	0
3	19685977	.	T	G	7	4	11	0	0	11	0	0
3	19686149	.	C	T	5	2	7	0	1	8	0	0
3	19686332	.	G	T	5	4	9	0	1	10	0	0
3	19687393	.	T	C	8	6	14	0	0	14	0	0
3	19702196	.	G	A	8	14	22	0	0	22	0	0
3	19702224	.	T	C	7	12	19	0	1	20	0	0
3	19702551	.	T	C	8	6	14	0	1	15	0	0
3	19706564	.	A	G	12	8	20	0	3	23	0	0
3	19707181	.	G	A	8	10	18	0	0	18	0	0
3	19710389	.	T	C	9	12	21	0	1	22	0	0
3	19716761	.	C	T	11	8	19	0	1	20	0	0
3	19717079	.	T	C	9	3	12	0	0	12	0	0
3	19717171	.	T	A	7	6	13	0	1	14	0	0
3	19717459	.	C	T	15	13	28	0	0	28	0	0
3	19717589	.	T	G	13	1	14	1	12	27	0	0
3	19717656	.	T	C	11	13	24	0	1	25	0	0
3	19717669	.	G	A	10	14	24	0	1	25	0	0
3	19807281	.	T	C	3	2	5	0	0	5	0	0
3	19814070	.	A	G	2	4	6	0	0	6	0	0
3	19814111	.	C	T	4	4	8	0	0	8	0	0
3	19851289	.	G	T	18	9	27	0	1	28	0	0
3	19851325	.	T	C	21	8	29	0	0	29	0	0
3	19914453	.	A	G	22	22	44	0	1	45	0	0
3	19914619	.	C	T	21	20	41	0	4	45	0	0
3	19914781	.	G	A	2	19	21	0	18	39	0	0
3	19969409	.	C	T	20	17	37	0	1	38	0	0
3	19969416	.	G	C	19	20	39	0	0	39	0	0
3	19969530	.	G	C	28	20	48	0	2	50	0	0
3	19969560	.	C	T	28	21	49	0	0	49	0	0
3	19969909	.	C	T	21	28	49	0	3	52	0	0
3	19970397	.	C	A	26	16	42	0	4	47	1	0
3	19970589	.	G	A	4	16	20	0	21	41	0	0
3	19970828	.	T	A	39	12	51	0	3	54	0	0
3	19971063	.	T	G	26	27	53	0	2	55	0	0
3	19971316	.	A	G	24	21	45	0	1	46	0	0
3	19971719	.	A	C	16	19	35	2	12	49	0	0
3	20015458	.	G	T	5	12	17	0	1	18	0	0
3	20015752	.	T	C	16	21	37	0	3	40	0	0
3	20015785	.	G	C	22	18	40	0	0	40	0	0
3	20021477	.	C	T	9	8	17	0	0	17	0	0
3	20021593	.	C	T	8	3	11	0	1	12	0	0
3	20026042	.	G	T	15	13	28	0	1	29	0	0
3	20026106	.	G	A	18	17	35	0	1	36	0	0
3	20026148	.	G	A	19	12	31	0	0	31	0	0
3	20035849	.	C	T	3	21	24	0	18	42	0	0
3	20036309	.	A	G	16	18	34	0	2	36	0	0
3	20040557	.	C	G	1	11	12	0	20	32	0	0
3	20042325	.	A	T	21	16	37	0	1	38	0	0
3	20042453	.	G	C	24	15	39	0	1	40	0	0
3	20042476	.	C	T	21	15	36	0	2	38	0	0
3	20042679	.	A	G	5	9	14	0	0	14	0	0
3	20042681	.	A	G	4	10	14	0	0	14	0	0
3	20042824	.	A	G	19	21	40	0	0	40	0	0
3	20042965	.	T	C	13	25	38	0	2	40	0	0
3	20043024	.	A	G	18	13	31	0	2	33	0	0
3	20043069	.	C	A	21	6	27	0	0	27	0	0
3	20043121	.	A	T	18	14	32	0	1	34	1	0
3	20043279	.	A	T	14	15	29	0	1	30	0	0
3	20045679	.	A	G	19	18	37	0	3	40	0	0
3	20049714	.	G	A	20	11	31	0	0	31	0	0
3	20051185	.	G	A	12	19	31	0	0	31	0	0
3	20051290	.	G	A	12	21	33	0	1	34	0	0
3	20062718	.	A	G	16	15	31	0	1	32	0	0
3	20063757	.	A	G	9	12	21	0	2	23	0	0
3	20063901	.	C	T	3	4	7	0	1	8	0	0
3	20063917	.	G	A	3	4	7	0	0	7	0	0
3	20064002	.	C	T	2	2	4	0	0	4	0	0
3	20064090	.	A	C	1	2	3	0	1	4	0	0
3	20108424	.	A	T	29	18	47	0	0	47	0	0
3	20108636	.	A	T	17	25	42	0	1	43	0	0
3	20108643	.	G	T	19	22	41	0	2	44	1	0
3	20108790	.	T	C	28	19	47	1	0	48	0	0
3	20109247	.	T	C	20	0	20	0	11	31	0	0
3	20109421	.	T	C	17	22	39	0	0	39	0	0
3	20109583	.	A	G	14	20	34	0	1	35	0	0
3	20109861	.	G	A	15	20	35	0	4	39	0	0
3	20109951	.	C	A	20	24	44	0	1	45	0	0
3	20110269	.	T	C	32	8	40	0	1	41	0	0
3	20110346	.	A	G	21	19	40	0	2	42	0	0
3	20110359	.	T	A	18	17	35	0	2	37	0	0
3	20110444	.	C	A	18	15	33	0	0	33	0	0
3	20110557	.	A	G	14	38	52	0	0	52	0	0
3	20118281	.	C	G	16	29	45	0	1	46	0	0
3	20170339	.	G	A	1	3	4	0	0	4	0	0
3	20192178	.	A	G	3	8	11	0	0	11	0	0
3	20208474	.	A	G	9	0	9	0	5	14	0	0
3	20224065	.	A	G	2	7	9	0	0	9	0	0
3	20224161	.	A	T	4	5	9	0	0	9	0	0
3	20224364	.	A	T	3	8	11	0	0	11	0	0
3	20224548	.	C	A	1	4	5	0	1	6	0	0
3	20224569	.	A	T	1	5	6	0	0	6	0	0
3	20224700	.	A	C	1	6	7	1	0	8	0	0
3	20224704	.	G	T	1	4	5	1	1	7	0	0
3	20224902	.	T	C	2	2	4	0	0	4	0	0
3	20226074	.	A	T	3	4	7	0	0	7	0	0
3	20226092	.	A	G	4	0	4	0	3	7	0	0
3	20226236	.	G	A	3	6	9	0	0	9	0	0
3	20226274	.	T	C	2	5	7	0	0	7	0	0
3	20226300	.	T	G	4	5	9	0	0	9	0	0
3	20226515	.	T	C	6	4	10	0	0	10	0	0
3	20226859	.	T	G	1	2	3	0	0	3	0	0
3	20226889	.	G	T	2	4	6	0	0	6	0	0
3	20226924	.	T	C	8	7	15	0	0	15	0	0
3	20226937	.	A	C	7	5	12	0	0	12	0	0
3	20227147	.	T	A	1	3	4	0	0	4	0	0
3	20227173	.	T	C	2	3	5	0	0	5	0	0
3	20227256	.	T	G	6	3	9	0	0	9	0	0
3	20227420	.	A	T	3	2	5	0	1	6	0	0
3	20227443	.	A	G	8	4	12	0	0	12	0	0
3	20227531	.	A	G	10	2	12	0	0	12	0	0
3	20227555	.	G	A	8	3	11	0	1	12	0	0
3	20227781	.	T	A	3	5	8	0	1	9	0	0
3	20227805	.	T	C	2	4	6	0	0	6	0	0
3	20227848	.	A	C	3	6	9	0	0	9	0	0
3	20228052	.	C	T	1	4	5	0	2	7	0	0
3	20228168	.	A	T	4	8	12	0	0	12	0	0
3	20228303	.	C	T	4	4	8	0	0	8	0	0
3	20228335	.	T	C	9	3	12	0	0	12	0	0
3	20228616	.	C	G	3	4	7	0	0	7	0	0
3	20228686	.	T	G	5	3	8	0	0	8	0	0
3	20228961	.	A	G	6	0	6	0	5	11	0	0
3	20229057	.	A	T	7	4	11	0	1	12	0	0
3	20229235	.	A	G	8	8	16	0	1	17	0	0
3	20229260	.	G	A	9	11	20	0	0	20	0	0
3	20229479	.	A	G	5	5	10	0	0	10	0	0
3	20229503	.	T	A	6	4	10	0	0	10	0	0
3	20230598	.	T	C	4	5	9	0	0	9	0	0
3	20230615	.	A	G	2	0	2	1	5	8	0	0
3	20231025	.	T	G	8	6	14	0	0	14	0	0
3	20231060	.	C	T	8	10	18	0	0	18	0	0
3	20231080	.	G	A	0	7	7	0	9	16	0	0
3	20231288	.	G	A	5	3	8	0	1	9	0	0
3	20231289	.	C	T	5	4	9	0	0	9	0	0
3	20231385	.	C	T	19	10	29	0	0	29	0	0
3	20231483	.	T	A	7	9	16	0	5	21	0	0
3	20231510	.	G	A	10	9	19	0	0	19	0	0
3	20231539	.	C	G	12	8	20	0	0	20	0	0
3	20404926	.	A	C	3	3	6	0	0	6	0	0
3	20461475	.	A	G	2	3	5	0	0	5	0	0
3	20658235	.	C	T	11	10	21	0	1	22	0	0
3	20658333	.	G	T	15	15	30	0	1	31	0	0
3	20658653	.	C	G	17	10	27	0	1	28	0	0
3	20658809	.	C	T	13	13	26	0	3	29	0	0
3	20658899	.	T	A	10	7	17	0	0	17	0	0
3	20659051	.	T	G	22	10	32	0	1	33	0	0
3	20666937	.	A	G	16	10	26	0	0	26	0	0
3	20666970	.	A	T	11	11	22	0	0	22	0	0
3	20677240	.	A	G	18	10	28	0	2	30	0	0
3	20677261	.	C	A	14	14	28	0	0	28	0	0
3	20720843	.	G	A	13	7	20	0	0	20	0	0
3	20721042	.	C	A	4	3	7	0	0	7	0	0
3	20752904	.	A	T	11	10	21	0	2	23	0	0
3	20752928	.	A	T	11	12	23	0	1	24	0	0
3	20793587	.	G	A	10	7	17	0	1	18	0	0
3	20950366	.	C	T	10	18	28	0	3	31	0	0
3	20950529	.	T	C	31	27	58	2	3	63	0	0
3	20956926	.	C	A	24	31	55	0	3	58	0	0
3	20956957	.	G	A	15	19	34	0	5	39	0	0
3	20973017	.	C	T	4	8	12	0	0	12	0	0
3	20982056	.	G	A	4	8	12	0	0	12	0	0
3	20982061	.	T	C	8	3	11	0	0	11	0	0
3	20982156	.	C	T	6	6	12	0	0	12	0	0
3	20982159	.	C	T	7	5	12	0	0	12	0	0
3	20982340	.	G	T	3	10	13	0	0	13	0	0
3	20984365	.	T	A	1	2	3	0	1	4	0	0
3	21020188	.	A	G	6	14	20	0	1	21	0	0
3	21022558	.	C	A	8	12	20	0	1	21	0	0
3	21022993	.	A	G	8	11	19	0	1	20	0	0
3	21022996	.	T	C	9	11	20	0	0	20	0	0
3	21025709	.	A	T	23	30	53	0	1	54	0	0
3	21025986	.	A	T	18	21	39	0	0	39	0	0
3	21026079	.	A	G	17	24	41	0	0	41	0	0
3	21026293	.	A	G	14	25	39	0	1	40	0	0
3	21026370	.	T	C	12	16	28	0	1	29	0	0
3	21026573	.	G	A	6	5	11	0	0	11	0	0
3	21026576	.	C	T	7	2	9	0	1	10	0	0
3	21026729	.	A	G	1	2	3	0	0	3	0	0
3	21026748	.	G	A	1	3	4	0	1	5	0	0
3	21026894	.	A	T	6	5	11	0	1	12	0	0
3	21027101	.	A	T	22	13	35	0	1	36	0	0
3	21027504	.	C	T	17	14	31	0	2	33	0	0
3	21027715	.	C	T	28	17	45	2	0	47	0	0
3	21029813	.	C	A	21	21	42	0	0	42	0	0
3	21029902	.	T	G	18	16	34	1	3	38	0	0
3	21030101	.	G	A	24	15	39	0	1	40	0	0
3	21030293	.	C	T	25	22	47	0	4	51	0	0
3	21030318	.	A	C	26	30	56	0	1	57	0	0
3	21030730	.	T	C	20	13	33	0	0	33	0	0
3	21037760	.	C	T	2	5	7	0	0	7	0	0
3	21037828	.	T	G	1	2	3	0	0	3	0	0
3	21044189	.	G	A	15	18	33	0	0	33	0	0
3	21066745	.	A	T	7	7	14	0	0	14	0	0
3	21067384	.	A	G	7	6	13	1	3	17	0	0
3	21067565	.	A	G	9	10	19	0	0	19	0	0
3	21067606	.	A	T	12	7	19	0	0	19	0	0
3	21067718	.	T	A	11	10	21	0	1	22	0	0
3	21067911	.	G	T	5	13	18	0	1	19	0	0
3	21068176	.	G	A	8	5	13	2	1	16	0	0
3	21068205	.	G	T	11	5	16	4	1	21	0	0
3	21068378	.	T	G	8	6	14	0	0	14	0	0
3	21074598	.	G	A	13	6	19	0	0	19	0	0
3	21074667	.	G	A	13	4	17	0	1	18	0	0
3	21086092	.	G	A	11	6	17	0	0	17	0	0
3	21087743	.	G	T	6	8	14	0	0	14	0	0
3	21094398	.	C	A	6	8	14	5	0	19	0	0
3	21094462	.	G	A	3	4	7	0	0	7	0	0
3	21096056	.	A	T	2	3	5	0	0	5	0	0
3	21096057	.	T	C	3	2	5	1	0	6	0	0
3	21096176	.	C	T	8	5	13	0	1	14	0	0
3	21096487	.	G	A	17	15	32	0	0	32	0	0
3	21096693	.	T	A	14	11	25	0	2	27	0	0
3	21104470	.	A	G	14	13	27	0	2	29	0	0
3	21111671	.	C	T	2	13	15	0	13	28	0	0
3	21111680	.	T	C	11	11	22	0	0	22	0	0
3	21111916	.	G	C	9	14	23	0	0	23	0	0
3	21111940	.	A	G	12	11	23	0	3	26	0	0
3	21113913	.	C	A	16	20	36	0	1	37	0	0
3	21125687	.	G	T	20	18	38	0	1	39	0	0
3	21126015	.	C	T	28	29	57	0	3	60	0	0
3	21139754	.	T	C	15	7	22	1	0	23	0	0
3	21140789	.	A	G	8	7	15	0	0	15	0	0
3	21141184	.	C	T	7	10	17	0	1	18	0	0
3	21142429	.	A	T	8	7	15	0	3	18	0	0
3	21240878	.	A	T	3	4	7	0	0	7	0	0
3	21240971	.	C	G	1	6	7	0	0	7	0	0
3	21241269	.	A	G	6	4	10	0	0	10	0	0
3	21241413	.	C	A	0	6	6	0	1	7	0	0
3	21241416	.	A	G	0	6	6	0	1	7	0	0
3	21241461	.	G	A	4	3	7	0	1	8	0	0
3	21242399	.	A	T	1	5	6	0	0	6	0	0
3	21242438	.	C	G	0	4	4	0	1	5	0	0
3	21251642	.	A	T	19	8	27	0	0	27	0	0
3	21251732	.	G	C	11	7	18	0	2	20	0	0
3	21251873	.	A	G	12	13	25	0	1	26	0	0
3	21251924	.	G	A	10	12	22	0	0	22	0	0
3	21252172	.	C	G	25	20	45	0	2	47	0	0
3	21281268	.	T	C	3	3	6	0	0	6	0	0
3	21281483	.	G	C	7	15	22	0	2	24	0	0
3	21281677	.	C	T	2	11	13	0	22	35	0	0
3	21281926	.	A	C	4	7	11	0	1	12	0	0
3	21281927	.	T	A	5	7	12	0	0	12	0	0
3	21282192	.	T	C	10	8	18	0	0	18	0	0
3	21282299	.	T	A	11	9	20	0	0	20	0	0
3	21282340	.	A	G	12	13	25	0	0	25	0	0
3	21282546	.	G	A	15	7	22	0	0	22	0	0
3	21282981	.	A	G	13	9	22	0	0	22	0	0
3	21283365	.	T	C	13	0	13	0	16	29	0	0
3	21283509	.	C	A	14	7	21	0	1	22	0	0
3	21283759	.	T	C	14	4	18	0	1	19	0	0
3	21283811	.	T	G	12	9	21	0	1	22	0	0
3	21284429	.	A	G	11	9	20	0	0	20	0	0
3	21284430	.	A	G	9	9	18	0	2	20	0	0
3	21284514	.	A	T	9	6	15	0	0	15	0	0
3	21284752	.	G	A	7	6	13	0	1	14	0	0
3	21284794	.	G	T	9	5	14	1	2	17	0	0
3	21287697	.	A	G	6	7	13	0	0	13	0	0
3	21287938	.	A	C	11	0	11	0	8	19	0	0
3	21287981	.	C	T	15	8	23	0	0	23	0	0
3	21288007	.	T	C	13	6	19	0	1	20	0	0
3	21288016	.	C	T	11	5	16	0	1	17	0	0
3	21348283	.	T	G	8	9	17	0	2	19	0	0
3	21669924	.	T	A	3	3	6	0	0	6	0	0
3	21670010	.	T	C	5	4	9	0	0	9	0	0
3	21670187	.	T	C	4	2	6	0	0	6	0	0
3	21740587	.	G	T	2	2	4	0	0	4	0	0
3	21868222	.	G	A	2	4	6	0	0	6	0	0
3	21868261	.	C	T	2	4	6	0	0	6	0	0
3	21882027	.	G	A	0	4	4	0	1	5	0	0
3	21882058	.	C	T	1	4	5	0	0	5	0	0
3	21882580	.	A	T	1	2	3	0	0	3	0	0
3	21882991	.	A	T	2	4	6	0	0	6	0	0
3	21884299	.	A	C	1	2	3	0	0	3	0	0
3	21884302	.	C	T	1	2	3	0	0	3	0	0
3	21885490	.	C	T	4	2	6	0	0	6	0	0
3	21885917	.	T	C	1	3	4	0	0	4	0	0
3	21885954	.	C	T	1	5	6	0	0	6	0	0
3	21886743	.	A	T	2	2	4	0	0	4	0	0
3	21887641	.	G	A	5	2	7	0	0	7	0	0
3	21888820	.	G	A	3	3	6	0	0	6	0	0
3	21888916	.	A	G	1	6	7	0	2	9	0	0
3	21888924	.	T	G	6	3	9	0	0	9	0	0
3	21889028	.	T	A	2	5	7	0	1	8	0	0
3	21889036	.	T	C	3	7	10	0	0	10	0	0
3	21889213	.	A	T	3	4	7	0	0	7	0	0
3	21889268	.	A	G	7	3	10	0	1	11	0	0
3	21889443	.	A	G	1	3	4	0	0	4	0	0
3	22039893	.	C	T	5	5	10	0	1	11	0	0
3	22050000	.	C	A	5	4	9	0	0	9	0	0
3	22050026	.	G	A	3	6	9	0	0	9	0	0
3	22050263	.	G	A	9	11	20	0	0	20	0	0
3	22054324	.	G	A	7	12	19	0	2	21	0	0
3	22054356	.	C	T	11	12	23	0	0	23	0	0
3	22054491	.	C	T	11	10	21	1	0	22	0	0
3	22054517	.	A	C	3	0	3	1	12	16	0	0
3	22054724	.	T	C	11	5	16	0	0	16	0	0
3	22054793	.	A	C	7	7	14	0	0	14	0	0
3	22055128	.	A	G	4	0	4	0	5	9	0	0
3	22055216	.	T	A	2	3	5	0	0	5	0	0
3	22059083	.	A	T	5	5	10	0	0	10	0	0
3	22079377	.	C	T	2	10	12	0	0	12	0	0
3	22079815	.	A	T	4	4	8	0	0	8	0	0
3	22080117	.	A	G	6	7	13	0	2	15	0	0
3	22127948	.	G	A	0	6	6	0	9	15	0	0
3	22130419	.	G	T	5	6	11	0	1	12	0	0
3	22146900	.	G	C	2	15	17	0	10	27	0	0
3	22146945	.	T	C	8	8	16	0	0	16	0	0
3	22146969	.	C	T	5	11	16	0	0	16	0	0
3	22152952	.	C	T	8	5	13	0	1	14	0	0
3	22153116	.	C	T	9	13	22	0	1	23	0	0
3	22153178	.	C	T	8	8	16	0	0	16	0	0
3	22153372	.	A	G	5	0	5	0	8	13	0	0
3	22153412	.	A	C	14	8	22	0	0	22	0	0
3	22153849	.	A	G	1	5	6	0	1	7	0	0
3	22153850	.	A	G	4	2	6	0	1	7	0	0
3	22153885	.	A	G	3	6	9	0	0	9	0	0
3	22153896	.	C	T	4	8	12	0	0	12	0	0
3	22154051	.	A	G	4	3	7	0	3	10	0	0
3	22154274	.	C	G	2	6	8	0	0	8	0	0
3	22154306	.	G	T	1	4	5	0	3	8	0	0
3	22154429	.	C	T	10	8	18	0	1	19	0	0
3	22154610	.	A	C	12	7	19	0	2	21	0	0
3	22154745	.	C	T	9	15	24	0	0	24	0	0
3	22158243	.	T	A	34	21	55	0	1	56	0	0
3	22158364	.	T	C	26	9	35	0	8	43	0	0
3	22158373	.	G	T	32	16	48	0	7	55	0	0
3	22158414	.	G	A	27	28	55	0	2	57	0	0
3	22158489	.	G	A	23	42	65	0	2	67	0	0
3	22158551	.	T	C	26	37	63	0	2	65	0	0
3	22158768	.	T	G	17	35	52	0	3	55	0	0
3	22159081	.	T	C	43	19	62	0	2	64	0	0
3	22159520	.	T	G	20	20	40	0	2	42	0	0
3	22159525	.	A	T	19	20	39	0	1	40	0	0
3	22159584	.	C	A	1	32	33	0	13	46	0	0
3	22159943	.	C	T	7	8	15	0	0	15	0	0
3	22160007	.	G	A	13	17	30	0	2	32	0	0
3	22160042	.	T	G	22	12	34	0	0	34	0	0
3	22160421	.	C	T	21	17	38	0	3	41	0	0
3	22161176	.	G	T	9	20	29	0	1	30	0	0
3	22172765	.	A	G	12	24	36	0	0	36	0	0
3	23020550	.	A	G	1	2	3	0	0	3	0	0
3	23248840	.	A	G	10	11	21	0	2	23	0	0
3	23250603	.	C	G	7	7	14	0	1	15	0	0
3	23250652	.	G	A	0	12	12	0	8	20	0	0
3	23251018	.	A	G	6	8	14	0	0	14	0	0
3	23251258	.	A	C	6	7	13	0	3	16	0	0
3	23251299	.	C	G	11	11	22	0	0	22	0	0
3	23251744	.	G	A	0	10	10	0	14	24	0	0
3	23251822	.	A	G	12	15	27	0	2	29	0	0
3	23302371	.	A	G	11	15	26	0	1	27	0	0
3	23307870	.	G	T	4	8	12	0	15	27	0	0
3	23309155	.	C	A	16	14	30	0	0	30	0	0
3	23309214	.	A	G	15	15	30	0	1	31	0	0
3	23318362	.	G	A	23	17	40	0	0	40	0	0
3	23318368	.	C	T	21	16	37	0	1	38	0	0
3	23323560	.	T	A	15	9	24	0	1	25	0	0
3	23323788	.	G	A	2	6	8	0	0	8	0	0
3	23323829	.	T	C	1	7	8	0	0	8	0	0
3	23324159	.	T	A	8	10	18	0	0	18	0	0
3	23324235	.	G	A	16	9	25	0	0	25	0	0
3	23324420	.	T	C	4	6	10	0	0	10	0	0
3	23324421	.	T	C	4	6	10	0	0	10	0	0
3	23324536	.	C	T	10	7	17	0	0	17	0	0
3	23324746	.	T	A	15	16	31	0	0	31	0	0
3	23324815	.	T	A	14	6	20	0	0	20	0	0
3	23324829	.	C	T	15	5	20	0	1	21	0	0
3	23325207	.	A	C	8	10	18	0	0	18	0	0
3	23325476	.	G	A	12	7	19	0	2	21	0	0
3	23325559	.	C	T	5	3	8	0	0	8	0	0
3	23326418	.	C	G	5	0	5	0	6	11	0	0
3	23326478	.	G	A	8	6	14	0	2	16	0	0
3	23326711	.	G	A	7	11	18	0	0	18	0	0
3	23327282	.	C	T	12	18	30	0	0	30	0	0
3	23334465	.	A	T	14	8	22	0	0	22	0	0
3	23335024	.	G	A	9	22	31	0	2	33	0	0
3	23348300	.	T	G	15	22	37	0	2	39	0	0
3	23348304	.	C	T	15	23	38	0	1	39	0	0
3	23351944	.	G	A	10	8	18	0	0	18	0	0
3	23363193	.	G	A	13	11	24	0	1	25	0	0
3	23406614	.	G	A	11	7	18	0	1	19	0	0
3	23406637	.	G	C	9	2	11	0	7	18	0	0
3	23406701	.	C	T	16	12	28	0	0	28	0	0
3	23407085	.	G	T	11	15	26	0	6	32	0	0
3	23429169	.	A	C	9	6	15	0	1	16	0	0
3	23429262	.	A	T	9	8	17	0	1	18	0	0
3	23429263	.	T	C	8	9	17	0	1	18	0	0
3	23429433	.	A	G	6	5	11	0	2	13	0	0
3	23429696	.	A	G	6	14	20	0	1	21	0	0
3	23429763	.	A	C	13	0	13	0	16	29	0	0
3	23430011	.	G	A	6	11	17	0	0	17	0	0
3	23430067	.	A	G	14	9	23	0	2	25	0	0
3	23430116	.	T	A	14	9	23	0	0	23	0	0
3	23430119	.	C	T	1	8	9	0	13	22	0	0
3	23436305	.	T	A	16	22	38	0	0	38	0	0
3	23442923	.	A	G	10	9	19	0	2	21	0	0
3	23443487	.	G	A	12	8	20	0	0	20	0	0
3	23444539	.	A	T	10	10	20	0	0	20	0	0
3	23444551	.	T	G	9	13	22	0	0	22	0	0
3	23456344	.	T	C	15	0	15	0	10	25	0	0
3	23464828	.	T	C	1	3	4	0	0	4	0	0
3	23464865	.	T	C	3	1	4	0	0	4	0	0
3	23464894	.	G	A	6	2	8	0	0	8	0	0
3	23464911	.	C	T	8	5	13	0	0	13	0	0
3	23465292	.	T	C	7	8	15	0	4	19	0	0
3	23466160	.	A	G	13	8	21	0	0	21	0	0
3	23469391	.	C	T	12	10	22	0	2	24	0	0
3	23469438	.	A	G	8	8	16	0	0	16	0	0
3	23469472	.	T	C	6	10	16	0	1	17	0	0
3	23469848	.	T	A	13	3	16	0	0	16	0	0
3	23470037	.	A	C	16	0	16	0	12	28	0	0
3	23470044	.	T	A	14	9	23	0	3	26	0	0
3	23470172	.	G	A	10	5	15	0	0	15	0	0
3	23470173	.	T	A	9	5	14	0	1	15	0	0
3	23488816	.	T	C	15	19	34	0	0	34	0	0
3	23492529	.	A	T	17	19	36	0	2	38	0	0
3	23493694	.	T	C	26	17	43	0	4	47	0	0
3	23493864	.	C	T	37	26	63	0	1	64	0	0
3	23494015	.	G	A	5	18	23	0	38	61	0	0
3	23494216	.	T	C	38	32	70	0	0	70	0	0
3	23494780	.	A	G	18	14	32	0	0	32	0	0
3	23494805	.	G	A	1	12	13	0	22	35	0	0
3	23495908	.	A	G	14	9	23	0	0	23	0	0
3	23504076	.	G	C	1	3	4	0	0	4	0	0
3	23584173	.	G	C	7	12	19	0	0	19	0	0
3	23584577	.	A	C	9	17	26	1	1	28	0	0
3	23584977	.	A	C	8	8	16	0	1	17	0	0
3	23585197	.	T	A	8	8	16	0	1	17	0	0
3	23585253	.	T	A	12	13	25	0	0	25	0	0
3	23585442	.	G	T	18	10	28	0	1	29	0	0
3	23591620	.	T	C	17	0	17	0	18	35	0	0
3	23591662	.	G	C	11	0	11	0	20	31	0	0
3	23592988	.	G	T	11	17	28	0	0	28	0	0
3	23596401	.	G	A	10	11	21	0	2	23	0	0
3	23596632	.	G	C	15	14	29	0	1	30	0	0
3	23596791	.	T	A	15	19	34	0	4	38	0	0
3	23599443	.	G	T	30	24	54	0	2	56	0	0
3	23599844	.	A	C	30	26	56	1	1	58	0	0
3	23689526	.	G	A	4	4	8	0	0	8	0	0
3	23695790	.	A	G	3	3	6	0	0	6	0	0
3	23708080	.	G	A	2	7	9	0	13	22	0	0
3	23710000	.	G	T	2	4	6	0	0	6	0	0
3	23748628	.	T	A	7	3	10	0	1	11	0	0
3	24065389	.	A	T	9	11	20	0	3	23	0	0
3	24065395	.	A	G	9	13	22	0	1	23	0	0
3	24065437	.	C	T	14	21	35	0	0	35	0	0
3	24067629	.	A	T	14	19	33	0	2	35	0	0
3	24070118	.	C	T	17	6	23	0	0	23	0	0
3	24070251	.	T	C	11	11	22	0	1	23	0	0
3	24070336	.	G	A	7	15	22	0	0	22	0	0
3	24070815	.	G	T	10	9	19	0	0	19	0	0
3	24071163	.	G	A	8	10	18	0	1	19	0	0
3	24071294	.	A	T	9	14	23	0	1	24	0	0
3	24072896	.	T	C	1	3	4	0	0	4	0	0
3	24096191	.	C	T	14	12	26	0	4	30	0	0
3	24100770	.	C	T	15	14	29	0	0	29	0	0
3	24109896	.	T	A	5	6	11	0	0	11	0	0
3	24109973	.	G	A	1	2	3	0	0	3	0	0
3	24110213	.	T	A	6	7	13	0	0	13	0	0
3	24110250	.	C	T	1	3	4	0	1	5	0	0
3	24111188	.	G	C	6	5	11	0	0	11	0	0
3	24111223	.	A	G	4	2	6	0	0	6	0	0
3	24134600	.	C	T	9	14	23	0	1	24	0	0
3	24143497	.	T	A	5	3	8	0	1	9	0	0
3	24143559	.	G	A	5	8	13	0	0	13	0	0
3	24198970	.	G	A	25	20	45	0	1	46	0	0
3	24199073	.	T	G	29	2	31	0	31	63	1	0
3	24199154	.	T	C	25	28	53	0	4	57	0	0
3	24199689	.	T	C	30	33	63	0	0	63	0	0
3	24200287	.	T	A	41	29	70	0	3	73	0	0
3	24200578	.	C	T	24	10	34	0	0	34	0	0
3	24200643	.	C	T	12	13	25	0	2	27	0	0
3	24200645	.	A	G	13	13	26	0	1	27	0	0
3	24200768	.	G	T	9	3	12	0	0	12	0	0
3	24203272	.	C	T	9	7	16	0	0	16	0	0
3	24203504	.	A	G	6	11	17	0	0	17	0	0
3	24203513	.	G	A	11	5	16	0	1	17	0	0
3	24203584	.	C	T	9	3	12	0	1	13	0	0
3	24203654	.	G	A	3	6	9	0	0	9	0	0
3	24203676	.	G	T	6	10	16	0	0	16	0	0
3	24203735	.	G	A	9	4	13	0	0	13	0	0
3	24207390	.	G	A	10	5	15	0	2	17	0	0
3	24207449	.	T	C	2	5	7	0	0	7	0	0
3	24209792	.	G	A	6	5	11	0	2	13	0	0
3	24212197	.	T	G	6	6	12	0	0	12	0	0
3	24214534	.	G	T	8	6	14	0	0	14	0	0
3	24218282	.	C	T	9	9	18	0	0	18	0	0
3	24287630	.	T	C	1	4	5	0	0	5	0	0
3	24290104	.	T	C	2	4	6	0	0	6	0	0
3	24292535	.	C	T	4	6	10	0	0	10	0	0
3	24292634	.	A	G	6	0	6	0	3	9	0	0
3	24295157	.	C	A	4	3	7	0	1	8	0	0
3	24295198	.	C	T	1	3	4	0	0	4	0	0
3	24295314	.	T	G	2	2	4	0	0	4	0	0
3	24295426	.	G	T	3	2	5	0	0	5	0	0
3	24295429	.	T	C	3	2	5	0	0	5	0	0
3	24295497	.	G	A	4	4	8	0	0	8	0	0
3	24295499	.	C	T	4	4	8	0	0	8	0	0
3	24361132	.	C	T	16	21	37	0	3	40	0	0
3	24361245	.	T	C	15	23	38	2	1	41	0	0
3	24433057	.	C	A	28	29	57	0	1	58	0	0
3	24434512	.	C	G	41	28	69	0	3	72	0	0
3	24434601	.	C	T	43	18	61	1	1	63	0	0
3	24434694	.	A	G	32	32	64	0	5	69	0	0
3	24434833	.	C	A	13	20	33	0	1	34	0	0
3	24463746	.	A	C	2	3	5	0	1	6	0	0
3	24463828	.	C	T	1	4	5	0	0	5	0	0
3	24483064	.	C	A	30	17	47	0	2	49	0	0
3	24483322	.	C	T	21	18	39	0	2	41	0	0
3	24489662	.	T	C	19	20	39	0	3	42	0	0
3	24501757	.	G	A	4	29	33	0	14	47	0	0
3	24501772	.	G	A	16	26	42	0	7	49	0	0
3	24512002	.	A	T	3	3	6	0	0	6	0	0
3	24512020	.	C	G	4	3	7	0	0	7	0	0
3	24514136	.	C	T	3	7	10	0	0	10	0	0
3	24516825	.	A	C	2	2	4	0	0	4	0	0
3	24516948	.	G	A	3	2	5	0	0	5	0	0
3	24517534	.	C	T	3	2	5	0	0	5	0	0
3	24518459	.	T	C	4	5	9	0	0	9	0	0
3	24518471	.	T	C	4	3	7	0	0	7	0	0
3	24554315	.	G	A	2	3	5	0	0	5	0	0
3	24554318	.	C	T	2	3	5	0	0	5	0	0
3	24554727	.	C	T	3	3	6	0	0	6	0	0
3	24641612	.	C	T	0	2	2	0	1	3	0	0
3	24682798	.	A	T	1	3	4	0	0	4	0	0
3	24690061	.	T	A	3	2	5	0	0	5	0	0
3	24690391	.	T	A	1	1	2	0	0	2	0	0
3	24690431	.	G	A	3	1	4	0	0	4	0	0
3	24690453	.	T	A	2	2	4	0	1	5	0	0
3	24690486	.	T	G	3	3	6	0	0	6	0	0
3	24690526	.	T	C	1	4	5	0	0	5	0	0
3	24691176	.	G	A	1	3	4	0	0	4	0	0
3	24691649	.	C	T	1	2	3	0	0	3	0	0
3	24692117	.	T	C	4	2	6	0	0	6	0	0
3	24692120	.	G	A	2	2	4	0	0	4	0	0
3	24750887	.	T	C	1	2	3	0	0	3	0	0
3	24750893	.	A	G	1	2	3	0	0	3	0	0
3	24754059	.	T	C	1	3	4	0	0	4	0	0
3	24764263	.	G	A	1	3	4	0	0	4	0	0
3	24764518	.	C	G	1	2	3	0	0	3	0	0
3	24764836	.	A	T	2	4	6	0	0	6	0	0
3	24764868	.	T	G	3	4	7	0	1	8	0	0
3	24764877	.	G	T	4	2	6	0	0	6	0	0
3	24764933	.	T	A	4	2	6	0	0	6	0	0
3	24764940	.	A	G	2	3	5	0	1	6	0	0
3	24793957	.	T	A	1	2	3	0	0	3	0	0
3	24793963	.	G	A	1	1	2	0	1	3	0	0
3	24903865	.	G	A	2	6	8	0	0	8	0	0
3	24904147	.	C	T	1	2	3	0	4	7	0	0
3	24904217	.	C	G	2	3	5	0	0	5	0	0
3	24909051	.	C	T	1	1	2	0	1	3	0	0
3	24973867	.	T	A	11	23	34	0	1	35	0	0
3	24973912	.	T	C	16	0	16	0	18	34	0	0
3	24974298	.	G	A	21	17	38	1	1	40	0	0
3	24990641	.	G	A	2	23	25	0	25	50	0	0
3	24993349	.	G	A	2	36	38	0	27	65	0	0
3	24993449	.	G	A	28	21	49	0	1	50	0	0
3	24993791	.	G	A	3	20	23	0	27	50	0	0
3	24997055	.	A	T	10	11	21	0	3	24	0	0
3	24998204	.	C	G	10	7	17	0	0	17	0	0
3	24998533	.	A	G	24	16	40	0	2	42	0	0
3	24998536	.	A	G	22	19	41	0	1	42	0	0
3	24998833	.	C	T	15	6	21	0	0	21	0	0
3	24998860	.	C	T	10	8	18	0	0	18	0	0
3	24998977	.	G	T	14	19	33	0	1	34	0	0
3	24999259	.	G	A	10	5	15	0	1	16	0	0
3	24999358	.	T	G	6	10	16	0	0	16	0	0
3	24999955	.	T	G	10	12	22	0	0	22	0	0
3	25000051	.	G	T	10	7	17	0	1	18	0	0
3	25000114	.	G	A	11	7	18	0	0	18	0	0
3	25002169	.	A	G	2	9	11	0	0	11	0	0
3	25024580	.	C	T	3	6	9	0	0	9	0	0
3	25027685	.	A	G	4	3	7	0	0	7	0	0
3	25027734	.	G	A	5	5	10	0	2	12	0	0
3	25030198	.	G	T	5	9	14	0	1	15	0	0
3	25030209	.	C	A	5	7	12	0	1	13	0	0
3	25030431	.	C	T	6	6	12	0	3	15	0	0
3	25030809	.	C	T	2	2	4	0	0	4	0	0
3	25031948	.	C	T	3	3	6	0	1	7	0	0
3	25033548	.	C	T	3	3	6	0	0	6	0	0
3	25033581	.	G	A	4	2	6	0	0	6	0	0
3	25033623	.	T	C	7	5	12	0	0	12	0	0
3	25036604	.	C	T	3	3	6	0	0	6	0	0
3	25039408	.	C	G	3	5	8	0	0	8	0	0
3	25039489	.	A	G	3	2	5	0	2	7	0	0
3	25039555	.	C	T	5	2	7	0	0	7	0	0
3	25046205	.	G	A	3	2	5	0	0	5	0	0
3	25054458	.	G	A	6	3	9	0	0	9	0	0
3	25055424	.	T	C	3	0	3	0	2	5	0	0
3	25059690	.	A	G	5	2	7	0	0	7	0	0
3	25066348	.	A	G	9	4	13	0	1	14	0	0
3	25075675	.	T	C	4	4	8	0	1	9	0	0
3	25080982	.	G	T	2	11	13	0	0	13	0	0
3	25085122	.	G	A	6	2	8	0	0	8	0	0
3	25086825	.	A	T	1	3	4	0	0	4	0	0
3	25094590	.	G	A	22	11	33	0	1	34	0	0
3	25097218	.	T	A	14	21	35	0	2	37	0	0
3	25097257	.	T	C	24	21	45	0	0	45	0	0
3	25099883	.	T	C	30	19	49	0	3	52	0	0
3	25100222	.	G	A	1	20	21	1	23	45	0	0
3	25100260	.	A	G	21	20	41	0	4	45	0	0
3	25100379	.	A	T	16	13	29	0	0	29	0	0
3	25102095	.	A	G	22	12	34	0	1	35	0	0
3	25102121	.	C	T	18	22	40	0	6	46	0	0
3	25105097	.	A	C	11	3	14	0	24	38	0	0
3	25132610	.	G	A	2	2	4	0	0	4	0	0
3	25132616	.	A	T	2	3	5	0	0	5	0	0
3	25136706	.	C	G	4	6	10	0	1	11	0	0
3	25138114	.	A	G	11	9	20	0	0	20	0	0
3	25138543	.	C	T	1	7	8	0	8	16	0	0
3	25138624	.	G	A	11	3	14	0	1	15	0	0
3	25138804	.	C	G	0	7	7	0	4	11	0	0
3	25142371	.	T	A	3	6	9	0	1	10	0	0
3	25144108	.	A	C	7	7	14	0	1	15	0	0
3	25147989	.	G	A	4	5	9	0	0	9	0	0
3	25167117	.	T	C	10	4	14	0	0	14	0	0
3	25167168	.	C	T	14	5	19	0	3	22	0	0
3	25168882	.	T	C	10	9	19	0	0	19	0	0
3	25169426	.	C	T	5	7	12	0	0	12	0	0
3	25169483	.	C	T	4	7	11	0	0	12	1	0
3	25169600	.	A	T	4	8	12	0	1	13	0	0
3	25169612	.	A	T	3	8	11	0	1	12	0	0
3	25269936	.	A	C	9	9	18	0	0	18	0	0
3	25269960	.	A	G	12	18	30	0	0	30	0	0
3	25270023	.	A	G	12	14	26	4	0	30	0	0
3	25270058	.	A	C	16	17	33	4	1	38	0	0
3	25270311	.	A	G	30	32	62	1	12	75	0	0
3	25270515	.	G	A	41	35	76	0	2	78	0	0
3	25270680	.	C	T	44	35	79	0	4	83	0	0
3	25270710	.	A	C	39	36	75	2	3	80	0	0
3	25270752	.	A	G	29	35	64	2	10	76	0	0
3	25271579	.	C	T	20	22	42	0	2	44	0	0
3	25272653	.	T	C	23	34	57	0	2	59	0	0
3	25273463	.	G	A	38	23	61	0	1	62	0	0
3	25282004	.	C	T	0	3	3	0	5	8	0	0
3	25282029	.	C	T	6	4	10	0	0	10	0	0
3	25282063	.	A	C	3	5	8	0	0	8	0	0
3	25282348	.	T	C	12	7	19	0	0	19	0	0
3	25282387	.	T	G	11	10	21	0	0	21	0	0
3	25282422	.	A	G	8	11	19	0	0	19	0	0
3	25282928	.	G	A	11	12	23	0	1	24	0	0
3	25282979	.	T	C	14	14	28	0	1	29	0	0
3	25312797	.	C	A	8	6	14	0	0	15	1	0
3	25322673	.	G	A	7	6	13	0	0	13	0	0
3	25333049	.	A	G	6	4	10	0	0	10	0	0
3	25379483	.	C	A	3	10	13	1	16	30	0	0
3	25379546	.	A	G	23	14	37	0	0	37	0	0
3	25391167	.	G	A	14	8	22	0	0	22	0	0
3	25393308	.	A	G	10	14	24	0	0	24	0	0
3	25393509	.	G	C	12	16	28	0	2	30	0	0
3	25393602	.	T	A	13	18	31	0	3	34	0	0
3	25393641	.	C	T	2	19	21	0	23	44	0	0
3	25393677	.	A	C	20	1	21	0	27	48	0	0
3	25393707	.	A	C	21	1	22	0	25	47	0	0
3	25393785	.	C	T	22	13	35	1	6	42	0	0
3	25396597	.	C	T	3	22	25	0	21	46	0	0
3	25396677	.	G	T	22	20	42	0	5	47	0	0
3	25396731	.	G	A	20	19	39	0	1	40	0	0
3	25397899	.	C	T	11	11	22	0	1	23	0	0
3	25400320	.	C	T	13	12	25	0	0	25	0	0
3	25400673	.	C	T	0	12	12	0	11	23	0	0
3	25403654	.	G	A	8	4	12	0	0	13	1	0
3	25403865	.	G	T	2	3	5	0	0	5	0	0
3	25404038	.	G	A	9	11	20	0	0	20	0	0
3	25409114	.	A	T	3	4	7	0	1	8	0	0
3	25409641	.	C	T	1	2	3	0	3	6	0	0
3	25409655	.	C	T	4	2	6	0	1	7	0	0
3	25414648	.	T	C	6	4	10	0	1	11	0	0
3	25416925	.	A	G	6	8	14	0	1	15	0	0
3	25416928	.	T	C	5	9	14	0	0	14	0	0
3	25417006	.	G	A	5	4	9	0	0	9	0	0
3	25417237	.	A	T	5	3	8	0	0	8	0	0
3	25417255	.	A	G	5	4	9	0	0	9	0	0
3	25417279	.	G	A	5	4	9	0	0	9	0	0
3	25417327	.	T	C	5	6	11	0	0	11	0	0
3	25417345	.	C	T	8	5	13	0	0	13	0	0
3	25417408	.	G	A	4	4	8	0	0	8	0	0
3	25420829	.	C	A	5	3	8	0	1	9	0	0
3	25436085	.	A	C	18	13	31	0	1	32	0	0
3	25436370	.	G	A	3	4	7	0	0	7	0	0
3	25436493	.	T	A	10	8	18	0	1	19	0	0
3	25436561	.	A	G	21	12	33	0	2	35	0	0
3	25437017	.	G	A	12	9	21	0	1	22	0	0
3	25437284	.	G	T	20	12	32	0	1	33	0	0
3	25437451	.	A	G	20	19	39	0	1	40	0	0
3	25437517	.	G	A	17	19	36	1	0	37	0	0
3	25492299	.	A	G	13	10	23	0	2	25	0	0
3	25508913	.	C	T	1	2	3	0	0	3	0	0
3	25509197	.	T	C	3	2	5	0	0	5	0	0
3	25509206	.	G	A	4	2	6	0	0	6	0	0
3	25510150	.	T	A	3	5	8	0	0	8	0	0
3	25510169	.	G	C	2	2	4	0	0	4	0	0
3	25510408	.	G	T	7	3	10	0	0	10	0	0
3	25510465	.	A	G	9	3	12	0	0	12	0	0
3	25510531	.	T	C	4	3	7	0	0	7	0	0
3	25510746	.	A	C	3	2	5	0	0	5	0	0
3	25510750	.	T	G	4	0	4	0	3	7	0	0
3	25510782	.	A	G	3	0	3	0	6	9	0	0
3	25510832	.	T	A	2	11	13	0	0	13	0	0
3	25510848	.	A	T	3	8	11	0	0	11	0	0
3	25510879	.	A	G	4	0	4	0	2	6	0	0
3	25510885	.	C	G	3	2	5	0	0	5	0	0
3	25510981	.	G	T	3	2	5	0	0	5	0	0
3	25511057	.	G	C	1	3	4	0	0	4	0	0
3	25511122	.	G	A	1	2	3	0	1	4	0	0
3	25511155	.	A	C	1	2	3	0	1	4	0	0
3	25511506	.	A	T	2	2	4	0	0	4	0	0
3	25511563	.	C	T	3	3	6	0	0	6	0	0
3	25511586	.	T	A	2	2	4	0	0	4	0	0
3	25546673	.	C	A	0	2	2	0	1	3	0	0
3	25546674	.	A	G	1	2	3	0	0	3	0	0
3	25548177	.	T	G	3	3	6	0	0	6	0	0
3	25645843	.	T	C	1	2	3	0	0	3	0	0
3	25708909	.	A	G	3	4	7	0	0	7	0	0
3	25709176	.	T	A	10	6	16	0	0	16	0	0
3	25709242	.	A	G	4	7	11	0	0	11	0	0
3	25709515	.	A	G	2	4	6	1	0	7	0	0
3	25709679	.	T	G	3	7	10	0	0	10	0	0
3	25709844	.	T	C	5	0	5	2	3	10	0	0
3	25709859	.	C	T	5	3	8	2	1	11	0	0
3	25709914	.	A	G	7	3	10	0	0	10	0	0
3	25710190	.	G	A	3	2	5	1	0	6	0	0
3	25710398	.	G	A	3	6	9	0	0	9	0	0
3	25710444	.	A	T	2	5	7	0	0	7	0	0
3	25710551	.	T	G	4	4	8	0	0	8	0	0
3	25710591	.	G	A	5	4	9	0	0	9	0	0
3	25710632	.	A	T	3	2	5	0	0	5	0	0
3	25710753	.	G	C	9	2	11	0	0	11	0	0
3	25710758	.	C	A	0	3	3	0	8	11	0	0
3	25710799	.	C	G	5	4	9	0	1	10	0	0
3	25710828	.	A	C	7	4	11	0	0	11	0	0
3	25710867	.	T	C	7	0	7	0	3	10	0	0
3	25710886	.	A	C	5	3	8	0	0	8	0	0
3	25710952	.	A	G	6	5	11	0	1	12	0	0
3	25711158	.	C	T	5	4	9	0	0	9	0	0
3	25711169	.	G	C	6	1	7	0	0	7	0	0
3	25711321	.	A	G	1	4	5	0	0	5	0	0
3	25711329	.	G	A	1	3	4	0	0	4	0	0
3	25711551	.	T	G	4	4	8	0	0	8	0	0
3	25739022	.	C	T	5	2	7	0	1	8	0	0
3	25739042	.	T	G	2	5	7	0	1	8	0	0
3	25739060	.	T	A	4	5	9	0	0	9	0	0
3	25756204	.	A	G	3	6	9	0	1	10	0	0
3	25812638	.	A	G	2	4	6	0	0	6	0	0
3	25813178	.	G	A	3	3	6	0	0	6	0	0
3	25813214	.	A	C	3	1	4	0	2	6	0	0
3	25813253	.	A	C	2	0	2	0	3	5	0	0
3	25813286	.	G	A	2	3	5	0	0	5	0	0
3	25914122	.	G	T	7	9	16	0	0	16	0	0
3	25914125	.	T	C	7	8	15	0	0	15	0	0
3	25914386	.	A	C	6	9	15	0	0	15	0	0
3	25914415	.	C	T	6	6	12	0	1	13	0	0
3	25917795	.	C	T	3	4	7	0	0	7	0	0
3	25917972	.	A	T	11	7	18	0	1	19	0	0
3	25918090	.	G	A	7	13	20	0	0	20	0	0
3	25938298	.	C	T	9	7	16	0	1	17	0	0
3	25938375	.	T	C	7	3	10	0	2	12	0	0
3	25938377	.	T	C	8	4	12	0	0	12	0	0
3	25938793	.	A	C	8	7	15	0	1	16	0	0
3	25938950	.	G	T	8	10	18	0	1	19	0	0
3	25939068	.	T	G	5	4	9	0	0	9	0	0
3	25990199	.	T	C	1	3	4	0	1	5	0	0
3	25992741	.	T	C	3	3	6	0	0	6	0	0
3	26007942	.	G	A	0	2	2	0	4	6	0	0
3	26009027	.	G	A	0	4	4	0	1	5	0	0
3	26009060	.	C	T	2	3	5	0	0	5	0	0
3	26157625	.	T	C	3	2	5	0	1	6	0	0
3	27695301	.	A	G	1	4	5	0	0	5	0	0
3	27695326	.	A	G	3	0	3	0	4	7	0	0
3	27695410	.	A	G	7	3	10	0	0	10	0	0
3	27695434	.	A	G	3	0	3	0	8	11	0	0
3	27695450	.	A	G	5	0	5	0	6	11	0	0
3	27767284	.	A	G	5	15	20	0	1	21	0	0
3	27767288	.	A	G	11	9	20	0	1	21	0	0
3	27831574	.	A	G	2	0	2	0	3	5	0	0
3	27831725	.	A	G	3	0	3	0	2	5	0	0
3	27833015	.	T	C	27	6	33	0	4	37	0	0
3	27833018	.	T	C	30	5	35	0	2	37	0	0
3	27833093	.	T	C	18	7	25	0	2	27	0	0
3	27834305	.	T	C	25	10	35	0	1	36	0	0
3	27834412	.	T	C	29	11	40	0	1	41	0	0
3	27834552	.	T	C	12	9	21	0	0	21	0	0
3	27836036	.	T	C	8	12	20	0	3	23	0	0
3	28581572	.	C	T	3	3	6	0	0	6	0	0
3	28594831	.	T	C	4	6	10	0	0	10	0	0
3	28621351	.	C	T	6	3	9	0	0	9	0	0
3	28626340	.	A	C	8	7	15	0	1	16	0	0
3	28627044	.	T	A	8	8	16	0	0	16	0	0
3	28627393	.	T	G	1	2	3	0	0	3	0	0
3	28634485	.	T	A	14	8	22	0	0	22	0	0
3	28634549	.	A	G	12	17	29	0	1	30	0	0
3	28634883	.	C	A	14	14	28	0	2	30	0	0
3	28634884	.	A	C	10	15	25	0	5	30	0	0
3	28635106	.	G	A	15	18	33	0	1	34	0	0
3	28640608	.	C	T	2	13	15	1	13	29	0	0
3	28640734	.	G	A	13	16	29	0	1	30	0	0
3	28650721	.	T	C	11	0	11	0	11	22	0	0
3	28665218	.	T	C	13	13	26	0	1	27	0	0
3	28665239	.	G	A	12	12	24	0	0	24	0	0
3	28719103	.	G	A	11	7	18	0	0	18	0	0
3	28719160	.	C	A	5	2	7	0	0	7	0	0
3	28719315	.	T	C	12	3	15	0	0	15	0	0
3	28719506	.	C	G	13	13	26	0	0	26	0	0
3	28719592	.	T	G	10	4	14	0	3	17	0	0
3	28719636	.	T	A	6	6	12	0	2	14	0	0
3	28719649	.	C	T	9	5	14	0	0	14	0	0
3	28719730	.	G	T	11	7	18	0	1	20	1	0
3	28719852	.	T	C	7	7	14	0	3	17	0	0
3	28719878	.	G	A	8	8	16	0	0	16	0	0
3	28719905	.	C	A	2	6	8	0	8	16	0	0
3	28719971	.	C	A	0	5	5	0	7	12	0	0
3	28720010	.	G	A	7	7	14	0	1	15	0	0
3	28750223	.	G	T	11	4	15	0	0	15	0	0
3	28750376	.	A	C	4	5	9	0	1	10	0	0
3	28750377	.	G	C	5	5	10	0	0	10	0	0
3	29950919	.	T	C	21	7	28	0	1	29	0	0
3	29950927	.	T	C	14	11	25	0	1	26	0	0
3	29951384	.	T	C	23	12	35	0	0	35	0	0
3	30749508	.	T	C	6	0	6	0	9	15	0	0
3	30749541	.	G	A	10	6	16	0	0	16	0	0
3	30801282	.	G	A	8	9	17	0	1	18	0	0
3	30801297	.	G	T	6	9	15	0	1	16	0	0
3	30801370	.	T	C	6	1	7	0	4	11	0	0
3	30860896	.	A	T	4	6	10	0	0	10	0	0
3	30868853	.	T	G	10	5	15	0	2	17	0	0
3	30868855	.	T	C	11	5	16	0	1	17	0	0
3	30869205	.	A	G	12	7	19	0	1	20	0	0
3	30869206	.	C	T	13	6	19	0	2	21	0	0
3	30869662	.	C	T	9	8	17	0	0	17	0	0
3	30869728	.	C	T	1	5	6	0	6	12	0	0
3	30870382	.	T	G	9	6	15	0	0	15	0	0
3	30870409	.	G	A	11	7	18	0	0	18	0	0
3	30870508	.	G	A	8	7	15	0	2	17	0	0
3	30870670	.	G	A	4	2	6	0	0	6	0	0
3	30870706	.	A	T	3	2	5	0	0	5	0	0
3	30870707	.	T	A	2	2	4	0	1	5	0	0
3	30870974	.	A	C	8	4	12	0	0	12	0	0
3	30871021	.	G	T	4	5	9	0	0	9	0	0
3	30871478	.	A	T	7	2	9	0	0	9	0	0
3	30871873	.	C	G	0	7	7	0	3	10	0	0
3	30872004	.	C	T	3	4	7	0	1	8	0	0
3	30872264	.	T	G	10	5	15	0	0	15	0	0
3	30872608	.	C	T	0	3	3	0	1	4	0	0
3	30873029	.	G	A	2	7	9	0	0	9	0	0
3	30873048	.	G	A	1	6	7	0	0	7	0	0
3	30873102	.	T	C	1	1	2	0	1	3	0	0
3	30873165	.	C	T	6	5	11	1	0	12	0	0
3	30873185	.	A	T	6	4	10	1	0	11	0	0
3	30873316	.	C	G	0	3	3	0	2	5	0	0
3	30873408	.	T	C	5	2	7	0	0	7	0	0
3	30877163	.	C	T	5	4	9	0	0	9	0	0
3	30890630	.	T	A	11	13	24	1	1	26	0	0
3	30890869	.	G	A	17	28	45	0	3	48	0	0
3	30891201	.	A	G	26	18	44	0	0	44	0	0
3	30894281	.	A	G	15	9	24	0	0	24	0	0
3	30926689	.	A	G	6	4	10	0	1	11	0	0
3	30926817	.	T	C	5	1	6	0	5	11	0	0
3	30932219	.	G	A	4	5	9	0	1	10	0	0
3	30948173	.	G	A	2	3	5	0	1	6	0	0
3	30948206	.	C	A	5	3	8	0	0	8	0	0
3	30962456	.	C	G	1	3	4	0	1	5	0	0
3	30962536	.	C	T	0	2	2	0	5	7	0	0
3	31043733	.	A	C	1	3	4	0	0	4	0	0
3	31043800	.	T	C	3	4	7	0	0	7	0	0
3	31044176	.	T	C	1	2	3	0	1	4	0	0
3	31044205	.	A	G	3	2	5	0	0	5	0	0
3	31044431	.	C	T	2	3	5	0	0	5	0	0
3	31044579	.	A	G	4	5	9	0	0	9	0	0
3	31044649	.	T	C	4	1	5	0	1	6	0	0
3	31044782	.	A	C	2	0	2	0	9	11	0	0
3	31044850	.	T	C	4	4	8	0	1	9	0	0
3	31044986	.	G	T	2	4	6	0	0	6	0	0
3	31045335	.	C	G	2	4	6	0	0	6	0	0
3	31050126	.	T	A	5	8	13	0	1	14	0	0
3	31050554	.	T	C	9	5	14	0	0	14	0	0
3	31052466	.	T	C	2	3	5	0	1	6	0	0
3	31052589	.	G	A	2	1	3	0	1	4	0	0
3	31060219	.	A	G	1	1	2	0	6	8	0	0
3	31060366	.	C	T	4	2	6	0	0	6	0	0
3	31063625	.	A	T	6	4	10	0	0	10	0	0
3	31066143	.	C	G	3	2	5	0	0	5	0	0
3	31066259	.	A	G	1	3	4	0	0	4	0	0
3	31066269	.	A	C	1	3	4	0	0	4	0	0
3	31069602	.	G	A	5	6	11	1	17	36	7	0
3	31070892	.	A	G	27	15	42	0	2	44	0	0
3	31080994	.	G	A	7	3	10	0	0	10	0	0
3	31081017	.	T	C	5	3	8	0	0	8	0	0
3	31087644	.	A	C	3	2	5	0	0	5	0	0
3	31089600	.	C	G	1	3	4	0	0	4	0	0
3	31089630	.	G	A	1	4	5	0	1	6	0	0
3	31090056	.	G	A	1	3	4	0	0	4	0	0
3	31090557	.	G	C	3	2	5	0	0	5	0	0
3	31103852	.	G	A	3	2	5	0	0	5	0	0
3	31103861	.	C	T	3	2	5	0	0	5	0	0
3	31104046	.	T	C	2	3	5	0	1	6	0	0
3	31104065	.	T	C	4	4	8	0	0	8	0	0
3	31104104	.	G	C	4	3	7	0	0	7	0	0
3	31104127	.	A	T	5	3	8	0	0	8	0	0
3	31104209	.	A	T	2	2	4	0	0	4	0	0
3	31104943	.	C	T	1	3	4	0	6	10	0	0
3	31105259	.	A	C	29	27	56	0	2	58	0	0
3	31120249	.	C	T	15	15	30	0	2	32	0	0
3	31122581	.	T	G	14	17	31	0	1	32	0	0
3	31135832	.	T	C	7	0	7	0	5	12	0	0
3	31138225	.	A	G	10	8	18	0	0	18	0	0
3	31138247	.	C	T	8	9	17	0	1	18	0	0
3	31140267	.	C	T	1	4	5	0	0	5	0	0
3	31143129	.	T	G	3	8	11	0	1	12	0	0
3	31144674	.	A	G	6	4	10	0	0	10	0	0
3	31146122	.	G	A	2	4	6	0	0	6	0	0
3	31146690	.	C	T	3	3	6	0	2	8	0	0
3	31146909	.	G	A	3	5	8	0	0	8	0	0
3	31149781	.	C	A	4	3	7	0	0	7	0	0
3	31150363	.	A	G	1	2	3	0	0	3	0	0
3	31150996	.	G	A	3	2	5	0	0	5	0	0
3	31152443	.	G	A	3	2	5	0	0	5	0	0
3	31155340	.	C	T	0	2	2	0	4	6	0	0
3	31179384	.	G	A	1	2	3	0	2	5	0	0
3	31184034	.	C	T	2	2	4	0	1	5	0	0
3	31187564	.	C	G	10	5	15	0	1	16	0	0
3	31187608	.	C	T	9	5	14	0	0	14	0	0
3	31187719	.	G	A	4	2	6	0	0	6	0	0
3	31187721	.	A	C	4	2	6	0	0	6	0	0
3	31201643	.	T	G	4	3	7	0	1	8	0	0
3	31214520	.	G	A	3	3	6	0	0	6	0	0
3	31217714	.	G	T	2	2	4	0	2	6	0	0
3	31217723	.	G	A	2	4	6	0	0	6	0	0
3	31218153	.	C	T	0	3	3	0	6	9	0	0
3	31218230	.	G	A	5	2	7	0	0	7	0	0
3	31218240	.	T	A	3	4	7	0	1	8	0	0
3	31396212	.	A	G	4	1	5	0	5	10	0	0
3	31396679	.	A	G	12	4	16	0	1	17	0	0
3	31396760	.	A	C	13	9	22	0	0	22	0	0
3	31396781	.	C	G	14	0	14	0	10	24	0	0
3	31396826	.	T	C	11	7	18	1	0	19	0	0
3	31430327	.	T	C	10	10	20	0	1	21	0	0
3	31600731	.	T	C	3	4	7	0	0	7	0	0
3	31603766	.	G	A	0	4	4	0	3	7	0	0
3	31603925	.	A	G	4	6	10	0	1	11	0	0
3	31603976	.	G	A	3	3	6	0	0	6	0	0
3	31604030	.	T	C	2	3	5	0	0	5	0	0
3	31604133	.	T	C	2	3	5	0	0	5	0	0
3	31604411	.	T	A	1	7	8	0	0	8	0	0
3	31604669	.	T	G	1	0	1	0	3	4	0	0
3	31604834	.	A	T	4	7	11	0	0	11	0	0
3	31605033	.	A	G	0	6	6	0	1	7	0	0
3	31605039	.	C	T	2	5	7	0	0	7	0	0
3	31622904	.	T	C	3	2	5	0	0	5	0	0
3	31623718	.	G	T	3	8	11	0	0	11	0	0
3	31706607	.	C	A	16	8	24	0	0	24	0	0
3	31706966	.	T	C	6	9	15	0	0	15	0	0
3	31709010	.	C	T	10	23	33	0	0	33	0	0
3	31709079	.	G	A	24	16	40	0	1	41	0	0
3	31711526	.	T	C	12	15	27	0	0	27	0	0
3	31712328	.	G	T	4	5	9	0	3	12	0	0
3	31717595	.	C	T	9	18	27	0	0	27	0	0
3	31722101	.	A	T	24	22	46	0	2	48	0	0
3	31722342	.	A	G	17	26	43	0	3	46	0	0
3	31725824	.	C	T	22	21	43	0	1	44	0	0
3	31726066	.	T	C	21	16	37	2	0	39	0	0
3	31726395	.	G	A	1	7	8	0	18	26	0	0
3	31726541	.	A	T	5	12	17	0	2	19	0	0
3	31726829	.	C	T	8	6	14	3	0	17	0	0
3	31729087	.	T	G	1	2	3	0	0	3	0	0
3	31729531	.	C	T	4	4	8	0	0	8	0	0
3	31729707	.	C	T	0	3	3	0	5	8	0	0
3	31734188	.	C	T	0	5	5	0	4	9	0	0
3	31792600	.	T	A	2	7	9	0	0	9	0	0
3	31792601	.	G	A	8	2	10	0	0	10	0	0
3	31792683	.	G	T	18	9	27	0	2	29	0	0
3	31792856	.	G	A	19	7	26	0	0	26	0	0
3	31793080	.	C	T	16	17	33	0	0	33	0	0
3	31793515	.	T	G	8	9	17	0	0	17	0	0
3	31793518	.	G	A	9	7	16	0	0	16	0	0
3	31793557	.	A	G	14	6	20	0	0	20	0	0
3	31793715	.	G	C	14	8	22	0	0	22	0	0
3	31793739	.	C	T	11	18	29	0	1	30	0	0
3	31797508	.	C	G	13	17	30	0	2	32	0	0
3	31797749	.	A	G	12	9	21	0	2	23	0	0
3	31799575	.	G	A	9	4	13	0	0	13	0	0
3	31815456	.	G	T	3	4	7	0	0	7	0	0
3	31874969	.	G	T	7	11	18	0	0	18	0	0
3	31879513	.	T	A	3	2	5	0	0	5	0	0
3	31879626	.	G	A	4	3	7	0	0	7	0	0
3	31879725	.	T	A	12	6	18	0	0	18	0	0
3	31879726	.	C	A	10	6	16	0	2	18	0	0
3	31879880	.	G	T	13	10	23	0	0	23	0	0
3	31879911	.	T	C	12	8	20	0	0	20	0	0
3	31880184	.	C	G	1	9	10	0	5	15	0	0
3	31880641	.	C	T	2	10	12	0	18	30	0	0
3	31881082	.	G	T	6	8	14	0	0	14	0	0
3	31884001	.	A	G	6	2	8	0	2	10	0	0
3	31884321	.	C	T	0	11	11	0	11	22	0	0
3	31884477	.	C	T	7	6	13	0	2	15	0	0
3	31886783	.	C	T	2	5	7	0	6	13	0	0
3	31890010	.	T	C	6	9	15	0	0	15	0	0
3	31892324	.	C	T	8	6	14	0	2	16	0	0
3	31897070	.	A	G	2	7	9	0	0	9	0	0
3	31914167	.	T	A	13	7	20	0	0	20	0	0
3	31916592	.	G	T	16	4	20	1	0	21	0	0
3	31916624	.	T	G	10	0	10	3	17	30	0	0
3	31916701	.	A	T	12	12	24	0	1	25	0	0
3	31916724	.	A	G	13	10	23	0	2	25	0	0
3	31916787	.	G	T	6	13	19	0	1	20	0	0
3	31916863	.	T	C	11	13	24	0	0	24	0	0
3	31917075	.	T	G	6	0	6	0	12	18	0	0
3	31917279	.	G	T	4	7	11	0	0	11	0	0
3	31922838	.	G	C	3	5	8	0	0	8	0	0
3	31926052	.	C	A	19	18	37	0	0	37	0	0
3	31939272	.	A	G	12	13	25	0	1	26	0	0
3	31939473	.	G	T	2	20	22	0	23	45	0	0
3	31939566	.	C	A	8	24	32	0	2	34	0	0
3	31941152	.	C	T	22	13	35	0	0	35	0	0
3	31944357	.	A	T	12	11	23	1	0	24	0	0
3	31951034	.	A	C	1	4	5	0	0	5	0	0
3	31961992	.	G	A	1	9	10	0	13	23	0	0
3	32021628	.	G	A	11	7	18	0	0	18	0	0
3	32049674	.	C	G	1	0	1	0	17	18	0	0
3	32049689	.	C	A	11	5	16	0	2	18	0	0
3	32049740	.	C	T	22	8	30	0	1	31	0	0
3	32078476	.	A	G	1	2	3	0	0	3	0	0
3	32078491	.	G	A	1	2	3	0	0	3	0	0
3	32083116	.	G	T	0	3	3	0	1	4	0	0
3	32085821	.	T	A	3	3	6	0	2	8	0	0
3	32085822	.	C	T	4	4	8	0	0	8	0	0
3	32087455	.	T	G	3	5	8	0	0	8	0	0
3	32092698	.	A	T	4	5	9	0	0	9	0	0
3	32098130	.	G	A	0	4	4	1	5	10	0	0
3	32098194	.	C	T	3	4	7	0	0	7	0	0
3	32098379	.	A	G	6	2	8	0	1	9	0	0
3	32099841	.	A	G	30	0	30	0	23	53	0	0
3	32100183	.	G	T	23	11	34	21	2	57	0	0
3	32100206	.	T	C	11	5	16	31	1	48	0	0
3	32100755	.	T	C	20	9	29	25	1	55	0	0
3	32105746	.	C	A	15	13	28	0	1	29	0	0
3	32139671	.	G	A	5	5	10	0	1	11	0	0
3	32139701	.	C	G	6	5	11	1	0	12	0	0
3	32169677	.	C	T	2	4	6	0	0	6	0	0
3	32172579	.	C	T	2	2	4	0	0	4	0	0
3	32175758	.	C	T	1	3	4	0	7	11	0	0
3	32175918	.	C	A	3	7	10	0	1	11	0	0
3	32175945	.	T	C	4	0	4	0	7	11	0	0
3	32195106	.	T	C	1	0	1	0	2	3	0	0
3	32195116	.	A	T	1	2	3	0	0	3	0	0
3	32228968	.	G	A	1	2	3	0	0	3	0	0
3	32294745	.	G	A	19	19	38	0	0	38	0	0
3	32294869	.	C	G	3	10	13	0	25	38	0	0
3	32295151	.	C	T	20	13	33	1	0	34	0	0
3	32295294	.	G	A	22	16	38	7	0	45	0	0
3	32295519	.	A	C	25	10	35	0	3	38	0	0
3	32295635	.	T	A	9	11	20	0	2	22	0	0
3	32295733	.	T	A	6	3	9	0	0	9	0	0
3	32295880	.	C	T	0	5	5	0	4	9	0	0
3	32295903	.	A	T	10	6	16	0	0	16	0	0
3	32295923	.	C	T	1	9	10	0	17	27	0	0
3	32296122	.	C	T	14	14	28	0	1	29	0	0
3	32296202	.	G	A	13	11	24	0	2	26	0	0
3	32296253	.	T	A	15	11	26	0	1	27	0	0
3	32296283	.	G	A	12	13	25	0	1	26	0	0
3	32296306	.	G	A	12	12	24	0	1	25	0	0
3	32296379	.	A	G	11	13	24	0	1	25	0	0
3	32296559	.	G	A	7	19	26	1	3	30	0	0
3	32296560	.	C	T	1	8	9	1	20	30	0	0
3	32296673	.	A	G	18	17	35	0	0	35	0	0
3	32296873	.	G	A	24	11	35	0	0	35	0	0
3	32303045	.	G	A	12	7	19	0	2	21	0	0
3	32303589	.	G	C	1	0	1	0	2	3	0	0
3	32303590	.	T	G	1	2	3	0	0	3	0	0
3	32303698	.	A	G	19	18	37	0	0	37	0	0
3	32314732	.	G	A	8	9	17	0	3	20	0	0
3	32325218	.	A	G	1	8	9	0	0	9	0	0
3	32329167	.	A	T	7	13	20	0	0	20	0	0
3	32357596	.	C	T	14	23	37	7	10	54	0	0
3	32357799	.	A	C	29	33	62	0	1	63	0	0
3	32360978	.	G	A	19	14	33	0	1	34	0	0
3	32361669	.	G	A	21	23	44	0	0	44	0	0
3	32361865	.	A	G	26	19	45	1	2	48	0	0
3	32366131	.	T	C	14	12	26	0	2	28	0	0
3	32366279	.	T	C	18	12	30	0	2	32	0	0
3	32366332	.	G	A	22	11	33	0	0	33	0	0
3	32366403	.	C	T	15	13	28	0	1	29	0	0
3	32400967	.	C	T	30	30	60	0	2	62	0	0
3	32401159	.	C	A	28	34	62	0	1	63	0	0
3	32401252	.	C	T	19	27	46	0	2	48	0	0
3	32403959	.	T	G	10	0	10	0	12	22	0	0
3	32405571	.	C	T	18	24	42	0	2	44	0	0
3	32405865	.	G	C	16	24	40	0	4	44	0	0
3	32405910	.	C	T	22	20	42	0	2	44	0	0
3	32406447	.	T	C	36	24	60	0	4	64	0	0
3	32406547	.	T	C	30	25	55	1	1	57	0	0
3	32406618	.	G	A	22	35	57	0	0	57	0	0
3	32406631	.	C	G	32	18	50	0	3	53	0	0
3	32414109	.	T	C	5	2	7	0	1	8	0	0
3	32414873	.	T	C	2	2	4	0	0	4	0	0
3	32414882	.	G	C	2	2	4	0	0	4	0	0
3	32415781	.	A	C	2	2	4	0	0	4	0	0
3	32433953	.	T	C	10	12	22	0	0	22	0	0
3	32434974	.	G	A	1	12	13	0	13	26	0	0
3	32435034	.	G	T	2	12	14	0	16	30	0	0
3	32435757	.	G	A	1	11	12	0	15	27	0	0
3	32435874	.	G	A	0	13	13	0	9	22	0	0
3	32436024	.	C	A	6	7	13	0	3	16	0	0
3	32436109	.	T	A	8	7	15	0	1	16	0	0
3	32436156	.	T	C	2	10	12	0	0	12	0	0
3	32436426	.	C	T	14	20	34	0	2	36	0	0
3	32436736	.	G	C	7	11	18	0	2	20	0	0
3	32436774	.	G	A	10	4	14	0	1	15	0	0
3	32438425	.	A	C	12	13	25	0	0	25	0	0
3	32440805	.	A	G	22	14	36	0	1	37	0	0
3	32441156	.	T	G	19	1	20	0	23	43	0	0
3	32441297	.	C	A	17	18	35	0	1	36	0	0
3	32441385	.	G	C	27	18	45	0	1	46	0	0
3	32441532	.	G	A	16	22	38	0	5	43	0	0
3	32441779	.	C	T	27	16	43	0	0	43	0	0
3	32447386	.	G	A	18	9	27	1	1	29	0	0
3	32447505	.	G	T	17	7	24	1	2	27	0	0
3	32447674	.	C	G	14	20	34	0	2	37	1	0
3	32447800	.	T	C	19	14	33	0	0	33	0	0
3	32450399	.	T	C	18	24	42	0	0	42	0	0
3	32453727	.	G	A	18	21	39	0	3	42	0	0
3	32457325	.	G	A	4	19	23	1	26	50	0	0
3	32457620	.	T	C	22	14	36	0	0	36	0	0
3	32457686	.	T	C	26	12	38	0	2	40	0	0
3	32458627	.	C	T	10	3	13	0	0	13	0	0
3	32477891	.	T	C	14	8	22	0	1	23	0	0
3	32477950	.	T	A	7	8	15	0	2	17	0	0
3	32479471	.	T	C	6	4	10	0	0	10	0	0
3	32482222	.	A	T	16	13	29	0	0	29	0	0
3	32482231	.	A	G	14	0	14	0	15	29	0	0
3	32482495	.	G	T	0	12	12	0	14	26	0	0
3	32482834	.	A	G	11	10	21	0	1	22	0	0
3	32483557	.	T	G	13	19	32	1	2	35	0	0
3	32483956	.	T	C	11	11	22	0	3	25	0	0
3	32484034	.	A	G	17	1	18	0	16	34	0	0
3	32484039	.	A	G	18	0	18	0	15	33	0	0
3	32484204	.	T	C	23	16	39	0	3	42	0	0
3	32484472	.	T	C	16	11	27	0	0	27	0	0
3	32484676	.	T	G	25	14	39	0	0	39	0	0
3	32484892	.	A	G	9	13	22	0	2	24	0	0
3	32485306	.	A	G	23	22	45	0	2	47	0	0
3	32485324	.	C	T	23	19	42	0	2	44	0	0
3	32485366	.	A	G	25	12	37	0	1	38	0	0
3	32485519	.	A	C	21	13	34	0	2	36	0	0
3	32485967	.	C	A	29	16	45	2	2	49	0	0
3	32486049	.	A	T	22	21	43	0	3	46	0	0
3	32486069	.	C	G	23	0	23	0	16	39	0	0
3	32489613	.	C	T	22	26	48	0	4	52	0	0
3	32490098	.	C	T	11	8	19	0	2	21	0	0
3	32490251	.	G	T	21	16	37	0	0	37	0	0
3	32490264	.	G	A	17	15	32	0	0	32	0	0
3	32490487	.	G	T	8	7	15	0	3	18	0	0
3	32532878	.	C	T	1	4	5	0	0	5	0	0
3	32534263	.	A	G	9	16	25	0	0	25	0	0
3	32534353	.	C	T	11	12	23	0	0	23	0	0
3	32534365	.	T	A	10	11	21	0	0	21	0	0
3	32587304	.	C	T	6	2	8	0	0	8	0	0
3	32589231	.	T	A	2	7	9	0	0	9	0	0
3	32589250	.	G	C	1	0	1	0	7	8	0	0
3	32596314	.	A	T	2	3	5	0	0	5	0	0
3	32608523	.	A	G	2	2	4	0	0	4	0	0
3	32637967	.	A	T	1	2	3	0	0	3	0	0
3	32637977	.	A	C	1	3	4	0	0	4	0	0
3	32641716	.	T	G	12	12	24	0	1	25	0	0
3	32643512	.	G	A	14	17	31	0	1	32	0	0
3	32647124	.	T	C	22	14	36	0	1	37	0	0
3	32647194	.	C	T	11	12	23	0	0	23	0	0
3	32647252	.	G	A	13	13	26	0	1	27	0	0
3	32647308	.	G	C	15	10	25	0	2	27	0	0
3	32647414	.	A	G	17	9	26	0	0	26	0	0
3	32647558	.	A	G	18	0	18	0	10	28	0	0
3	32649846	.	C	T	10	13	23	0	1	24	0	0
3	32649960	.	G	A	12	13	25	0	0	25	0	0
3	32650004	.	A	G	18	7	25	0	1	26	0	0
3	32650199	.	C	A	4	6	10	0	0	10	0	0
3	32657323	.	C	T	2	2	4	0	1	5	0	0
3	32662034	.	A	C	6	2	8	0	0	8	0	0
3	32663255	.	T	C	3	2	5	1	0	6	0	0
3	32663485	.	T	C	3	3	6	0	1	7	0	0
3	32663638	.	A	G	2	4	6	0	0	6	0	0
3	32663764	.	T	G	3	6	9	0	0	9	0	0
3	32665515	.	G	A	2	2	4	0	0	4	0	0
3	32667118	.	A	C	7	11	18	0	0	18	0	0
3	32668806	.	A	G	5	8	13	0	0	13	0	0
3	32668818	.	A	G	6	4	10	0	0	10	0	0
3	32669077	.	T	A	1	2	3	0	0	3	0	0
3	32672501	.	C	A	7	6	13	0	2	15	0	0
3	32675236	.	G	A	14	9	23	0	1	24	0	0
3	32679267	.	T	A	20	17	37	0	2	39	0	0
3	32679289	.	T	A	19	19	38	0	3	41	0	0
3	32679332	.	C	T	18	15	33	0	1	34	0	0
3	32679528	.	C	A	11	15	26	0	1	27	0	0
3	32685708	.	A	G	9	0	9	0	12	21	0	0
3	32686230	.	A	G	10	0	10	0	18	28	0	0
3	32686245	.	T	C	11	20	31	0	0	31	0	0
3	32686655	.	T	C	1	4	5	0	0	5	0	0
3	32698500	.	A	G	19	14	33	0	3	36	0	0
3	32700697	.	A	G	10	11	21	0	1	22	0	0
3	32700758	.	A	G	20	16	36	0	1	37	0	0
3	32700988	.	C	T	12	15	27	0	3	30	0	0
3	32701031	.	T	G	15	0	15	0	27	43	1	0
3	32702596	.	T	A	25	7	32	0	1	33	0	0
3	32707219	.	G	A	7	8	15	0	0	15	0	0
3	32707267	.	T	C	8	8	16	0	1	17	0	0
3	32707272	.	C	A	8	7	15	0	1	16	0	0
3	32707480	.	C	T	9	11	20	0	1	21	0	0
3	32707621	.	C	G	19	14	33	0	1	34	0	0
3	32707813	.	C	G	21	15	36	0	0	36	0	0
3	32708077	.	T	C	27	26	53	0	1	54	0	0
3	32710705	.	A	G	22	32	54	0	0	54	0	0
3	32710812	.	G	A	1	34	35	1	17	53	0	0
3	32710999	.	C	A	10	3	13	1	0	14	0	0
3	32711117	.	T	C	6	4	10	0	1	11	0	0
3	32711147	.	T	A	5	4	9	0	1	10	0	0
3	32715514	.	C	T	1	3	4	0	0	4	0	0
3	32718451	.	T	G	3	3	6	0	0	6	0	0
3	32718460	.	C	T	2	2	4	0	0	4	0	0
3	32718605	.	A	G	1	1	2	0	1	3	0	0
3	32718851	.	T	C	4	3	7	0	0	7	0	0
3	32718945	.	C	G	7	6	13	0	0	13	0	0
3	32719715	.	T	C	9	5	14	0	0	14	0	0
3	32720184	.	A	C	6	3	9	0	0	9	0	0
3	32720342	.	T	C	5	4	9	0	1	10	0	0
3	32722973	.	C	T	5	5	10	0	3	13	0	0
3	32723033	.	A	G	4	0	4	0	10	14	0	0
3	32723497	.	A	G	10	1	11	0	9	20	0	0
3	32723698	.	C	T	5	7	12	0	0	12	0	0
3	32724010	.	G	A	1	8	9	0	5	14	0	0
3	32724100	.	G	A	4	4	8	1	0	9	0	0
3	32726271	.	A	G	5	12	17	0	0	17	0	0
3	32726357	.	A	G	5	5	10	0	0	10	0	0
3	32728304	.	T	C	5	6	11	0	2	13	0	0
3	32729150	.	T	C	8	10	18	0	2	20	0	0
3	32729232	.	T	C	4	12	16	0	1	17	0	0
3	32729429	.	T	A	6	2	8	0	0	8	0	0
3	32729591	.	C	T	10	5	15	0	0	15	0	0
3	32729663	.	C	T	6	6	12	0	1	13	0	0
3	32729759	.	C	A	9	3	12	0	1	13	0	0
3	32729827	.	A	T	10	7	17	0	0	17	0	0
3	32729845	.	G	A	11	6	17	0	0	17	0	0
3	32730011	.	A	G	5	1	6	0	6	12	0	0
3	32730071	.	T	A	6	6	12	0	0	12	0	0
3	32730131	.	A	G	7	7	14	0	1	15	0	0
3	32731255	.	A	G	10	0	10	0	5	15	0	0
3	32731418	.	C	T	8	8	16	0	0	16	0	0
3	32731750	.	A	G	8	0	8	0	10	18	0	0
3	32731804	.	T	C	9	9	18	0	2	20	0	0
3	32731840	.	T	C	9	7	16	0	1	17	0	0
3	32731855	.	T	C	9	10	19	0	0	19	0	0
3	32731879	.	A	G	2	0	2	0	10	12	0	0
3	32734926	.	G	A	0	6	6	0	7	13	0	0
3	32737727	.	C	T	7	6	13	0	0	13	0	0
3	32741137	.	G	A	3	9	12	0	7	19	0	0
3	32741385	.	G	A	0	7	7	5	14	26	0	0
3	32741809	.	A	G	10	0	10	0	11	21	0	0
3	32777481	.	A	C	5	18	23	0	1	24	0	0
3	32777733	.	G	T	9	15	24	0	1	25	0	0
3	32789654	.	G	T	4	3	7	0	8	15	0	0
3	32789985	.	T	C	10	15	25	0	1	26	0	0
3	32794931	.	C	A	9	5	14	0	0	14	0	0
3	32795068	.	C	T	12	11	23	0	0	23	0	0
3	32795425	.	G	A	9	6	15	0	0	15	0	0
3	32795461	.	A	T	7	10	17	0	0	17	0	0
3	32795614	.	C	T	5	7	12	0	1	13	0	0
3	32807667	.	G	A	14	10	24	0	1	25	0	0
3	32808023	.	T	A	12	9	21	0	2	23	0	0
3	32808185	.	T	C	12	15	27	0	2	29	0	0
3	32808214	.	G	A	16	15	31	0	1	32	0	0
3	32808338	.	A	C	23	15	38	0	5	43	0	0
3	32808554	.	T	G	14	12	26	0	4	30	0	0
3	32808771	.	G	A	11	10	21	0	1	22	0	0
3	32808772	.	G	C	11	10	21	0	1	22	0	0
3	32808979	.	T	G	14	13	27	0	1	28	0	0
3	32809154	.	A	T	14	11	25	0	0	25	0	0
3	32809368	.	G	A	14	11	25	0	2	27	0	0
3	32809410	.	G	A	10	13	23	0	0	23	0	0
3	32809432	.	T	A	11	11	22	0	1	23	0	0
3	32809548	.	T	C	8	8	16	0	0	16	0	0
3	32809561	.	G	A	8	9	17	0	2	19	0	0
3	32809836	.	A	G	14	0	14	0	10	24	0	0
3	32809927	.	T	C	15	12	27	0	2	29	0	0
3	32810011	.	T	A	8	6	14	0	1	15	0	0
3	32810580	.	C	T	16	10	26	0	1	27	0	0
3	32810715	.	A	G	13	17	30	0	0	30	0	0
3	32811094	.	A	T	3	6	9	0	1	10	0	0
3	32824114	.	T	C	1	2	3	1	1	5	0	0
3	32824733	.	C	T	1	2	3	0	0	3	0	0
3	32825846	.	G	A	3	2	5	0	0	5	0	0
3	32831417	.	T	C	3	3	6	0	0	6	0	0
3	32837514	.	G	A	21	11	32	1	4	37	0	0
3	32837643	.	G	A	21	14	35	0	7	42	0	0
3	32837904	.	A	G	26	0	26	0	20	46	0	0
3	32838033	.	G	A	0	14	14	0	21	35	0	0
3	32838039	.	A	G	18	16	34	0	1	35	0	0
3	32842163	.	C	T	10	8	18	0	2	20	0	0
3	32842235	.	G	T	11	8	19	0	2	21	0	0
3	32842318	.	C	T	5	5	10	0	0	10	0	0
3	32847607	.	C	T	5	5	10	0	0	10	0	0
3	32847771	.	G	A	0	3	3	0	5	8	0	0
3	32847887	.	C	G	5	7	12	0	0	12	0	0
3	32847923	.	C	A	9	8	17	0	0	17	0	0
3	32847942	.	A	G	9	0	9	0	8	17	0	0
3	32848175	.	T	G	7	6	13	0	3	16	0	0
3	32848418	.	C	T	11	4	15	0	0	15	0	0
3	32848714	.	A	G	6	7	13	0	1	14	0	0
3	32849079	.	C	T	10	4	14	0	1	15	0	0
3	32849679	.	T	A	19	12	31	0	1	32	0	0
3	32850029	.	A	T	16	10	26	0	1	27	0	0
3	32850265	.	A	G	6	0	6	0	10	16	0	0
3	32850499	.	T	C	7	7	14	0	0	14	0	0
3	32854276	.	T	C	6	6	12	0	0	12	0	0
3	32854533	.	T	C	10	14	24	0	1	25	0	0
3	32854743	.	C	G	7	0	7	0	10	17	0	0
3	32854744	.	A	G	7	10	17	0	1	18	0	0
3	32855066	.	G	A	8	4	12	0	1	13	0	0
3	32862854	.	C	G	1	2	3	0	0	3	0	0
3	32862862	.	C	T	1	2	3	0	0	3	0	0
3	32863016	.	A	G	3	2	5	0	1	6	0	0
3	32863128	.	C	A	2	2	4	0	0	4	0	0
3	32864848	.	A	G	2	4	6	0	0	6	0	0
3	32864854	.	T	A	2	4	6	0	0	6	0	0
3	32865030	.	T	A	5	2	7	0	0	7	0	0
3	32866068	.	A	T	1	2	3	0	0	3	0	0
3	32867711	.	C	A	3	2	5	0	0	5	0	0
3	32867865	.	A	G	3	5	8	0	0	8	0	0
3	32868114	.	G	T	6	5	11	0	0	11	0	0
3	32868143	.	C	T	4	7	11	0	0	11	0	0
3	32868519	.	G	T	2	4	6	0	2	8	0	0
3	32868590	.	C	T	7	4	11	0	0	11	0	0
3	32868593	.	A	G	6	2	8	0	2	10	0	0
3	32869770	.	C	T	6	5	11	0	0	11	0	0
3	32869773	.	G	A	6	6	12	0	0	12	0	0
3	32869913	.	C	T	1	2	3	0	0	3	0	0
3	32869930	.	C	T	1	3	4	0	0	4	0	0
3	32870564	.	G	C	1	2	3	0	0	3	0	0
3	32870572	.	C	A	1	2	3	0	0	3	0	0
3	32870756	.	A	G	1	0	1	0	7	8	0	0
3	32870766	.	G	A	2	7	9	0	0	9	0	0
3	32870947	.	A	G	3	8	11	0	0	11	0	0
3	32871202	.	T	C	1	0	1	0	3	4	0	0
3	32871247	.	A	G	1	2	3	0	0	3	0	0
3	32871350	.	T	C	2	2	4	0	0	4	0	0
3	32889849	.	T	C	8	0	8	0	11	19	0	0
3	32890002	.	G	T	21	17	38	0	3	41	0	0
3	32890058	.	A	G	16	14	30	0	1	31	0	0
3	32892061	.	G	A	8	20	28	0	1	29	0	0
3	32892422	.	A	G	8	20	28	0	0	28	0	0
3	32900428	.	A	G	13	21	34	0	1	35	0	0
3	32924386	.	G	A	5	7	12	0	1	13	0	0
3	32924643	.	G	A	5	6	11	0	3	14	0	0
3	32924836	.	T	A	17	15	32	0	1	33	0	0
3	32924989	.	G	A	11	10	21	0	1	22	0	0
3	32925066	.	G	A	12	13	25	0	0	25	0	0
3	32925248	.	C	T	6	10	16	0	1	17	0	0
3	32925264	.	G	T	6	12	18	0	1	19	0	0
3	32925400	.	C	T	8	8	16	0	0	16	0	0
3	32926016	.	C	T	0	7	7	0	7	14	0	0
3	32926025	.	G	A	6	7	13	0	1	14	0	0
3	32926058	.	A	G	6	7	13	0	0	13	0	0
3	32926113	.	A	G	6	2	8	0	0	8	0	0
3	32926148	.	G	A	4	6	10	0	1	11	0	0
3	32926184	.	A	T	6	3	9	0	0	9	0	0
3	32933774	.	A	C	5	7	12	0	0	12	0	0
3	32933849	.	A	T	7	16	23	0	0	23	0	0
3	32935936	.	A	G	7	0	7	0	10	17	0	0
3	32937628	.	A	G	13	12	25	0	0	25	0	0
3	32941242	.	G	A	13	11	24	0	1	25	0	0
3	32941661	.	A	G	19	11	30	0	0	30	0	0
3	32944203	.	C	A	19	14	33	0	2	35	0	0
3	32944569	.	C	T	18	21	39	0	1	40	0	0
3	32944668	.	C	A	11	19	30	0	4	34	0	0
3	32944854	.	C	T	19	21	40	0	0	40	0	0
3	32947971	.	T	C	23	12	35	0	3	38	0	0
3	32950959	.	G	A	11	13	24	0	0	24	0	0
3	32950977	.	G	A	1	11	12	0	12	25	1	0
3	32951001	.	G	T	0	10	10	0	17	27	0	0
3	32951394	.	G	A	22	26	48	0	1	49	0	0
3	32951564	.	A	C	9	11	20	0	0	20	0	0
3	32951637	.	G	A	11	13	24	0	0	24	0	0
3	32951778	.	C	T	20	17	37	0	1	38	0	0
3	32951891	.	T	C	14	16	30	0	1	31	0	0
3	33065643	.	T	A	5	3	8	2	1	11	0	0
3	33065950	.	T	C	4	4	8	1	1	10	0	0
3	33065985	.	A	G	6	4	10	1	1	12	0	0
3	33066155	.	C	T	0	6	6	0	6	12	0	0
3	33066292	.	C	T	11	4	15	0	1	16	0	0
3	33066714	.	A	T	3	5	8	0	0	8	0	0
3	33066804	.	T	C	7	0	7	0	8	15	0	0
3	33066809	.	C	G	8	6	14	0	0	14	0	0
3	33066969	.	T	C	14	0	14	0	5	19	0	0
3	33066976	.	T	C	16	5	21	0	1	22	0	0
3	33067092	.	A	T	3	2	5	0	0	5	0	0
3	33067337	.	A	G	2	3	5	0	0	5	0	0
3	33067340	.	A	G	3	3	6	0	0	6	0	0
3	33067376	.	G	A	6	4	10	0	0	10	0	0
3	33067438	.	G	A	6	8	14	0	1	15	0	0
3	33069274	.	A	C	4	11	15	0	0	15	0	0
3	33069596	.	G	A	5	13	18	0	1	19	0	0
3	33075167	.	C	T	5	5	10	0	0	10	0	0
3	33259382	.	A	T	3	2	5	0	1	6	0	0
3	33259407	.	G	A	3	4	7	0	0	7	0	0
3	33341072	.	T	A	26	18	44	0	0	44	0	0
3	33344470	.	T	A	16	16	32	0	0	32	0	0
3	33345482	.	G	A	0	7	7	0	8	15	0	0
3	33360480	.	A	G	11	0	11	0	11	22	0	0
3	33368134	.	T	C	10	14	24	0	0	24	0	0
3	33372555	.	G	C	0	7	7	0	8	15	0	0
3	33373443	.	T	C	7	8	15	0	2	17	0	0
3	33373540	.	A	C	7	11	18	0	1	19	0	0
3	33375645	.	C	A	7	11	18	0	2	20	0	0
3	33379072	.	C	T	3	6	9	0	1	10	0	0
3	33420561	.	C	T	2	2	4	0	1	5	0	0
3	33420614	.	A	T	1	5	6	0	0	6	0	0
3	33424010	.	C	T	3	8	11	0	7	18	0	0
3	33424420	.	G	A	32	25	57	0	5	62	0	0
3	33426513	.	G	A	45	28	73	0	3	76	0	0
3	33432379	.	A	C	11	0	11	0	5	16	0	0
3	33432605	.	C	T	1	2	3	0	0	3	0	0
3	33433621	.	G	A	8	13	21	0	0	21	0	0
3	33437399	.	T	C	3	4	7	0	0	7	0	0
3	33440693	.	C	T	6	2	8	0	1	9	0	0
3	33445039	.	A	T	11	8	19	0	1	20	0	0
3	33445090	.	G	C	2	6	8	0	11	19	0	0
3	33449405	.	C	T	15	12	27	0	0	27	0	0
3	33449554	.	G	A	0	13	13	0	10	23	0	0
3	33452168	.	C	T	21	20	41	0	1	42	0	0
3	33455809	.	G	A	2	13	15	0	19	34	0	0
3	33458803	.	C	T	16	19	35	0	1	36	0	0
3	33458911	.	A	T	13	16	29	0	0	29	0	0
3	33459394	.	T	A	6	12	18	0	2	20	0	0
3	33459489	.	C	T	13	9	22	0	1	23	0	0
3	33459517	.	C	T	12	11	23	0	1	24	0	0
3	33459532	.	G	A	9	12	21	0	1	22	0	0
3	33461366	.	C	T	0	17	17	1	10	28	0	0
3	33461646	.	C	T	0	11	11	0	15	26	0	0
3	33461796	.	A	T	14	6	20	0	1	21	0	0
3	33469413	.	A	G	11	18	29	0	0	29	0	0
3	33469614	.	T	A	8	23	31	0	1	32	0	0
3	33473131	.	C	T	2	9	11	0	16	27	0	0
3	33476589	.	T	C	16	5	21	0	0	21	0	0
3	33478690	.	G	A	9	9	18	0	0	18	0	0
3	33494089	.	A	T	8	19	27	0	3	30	0	0
3	33494091	.	G	C	9	18	27	0	3	30	0	0
3	33571002	.	C	T	2	9	11	0	0	11	0	0
3	33571231	.	C	T	6	4	10	0	0	10	0	0
3	33571264	.	T	C	5	0	5	0	5	10	0	0
3	33571294	.	C	T	3	7	10	0	0	10	0	0
3	33572206	.	G	C	5	0	5	0	7	12	0	0
3	33572298	.	G	A	8	6	14	0	0	14	0	0
3	33572335	.	C	T	7	5	12	0	0	12	0	0
3	33572404	.	C	T	0	5	5	0	3	8	0	0
3	33572464	.	T	C	2	0	2	0	4	6	0	0
3	33572473	.	A	G	2	4	6	0	0	6	0	0
3	33573178	.	G	A	4	4	8	0	0	8	0	0
3	33747527	.	A	G	6	13	19	1	0	20	0	0
3	33747563	.	A	G	9	0	9	1	10	20	0	0
3	33761597	.	C	T	7	10	17	0	1	18	0	0
3	33761705	.	G	A	2	7	9	0	13	22	0	0
3	33761834	.	G	A	18	12	30	0	2	32	0	0
3	33761835	.	A	T	18	14	32	0	1	33	0	0
3	33762068	.	A	G	5	10	15	0	1	16	0	0
3	33762278	.	A	G	4	12	16	0	0	16	0	0
3	33762310	.	C	A	6	12	18	0	0	18	0	0
3	33762408	.	T	A	12	8	20	0	0	20	0	0
3	33762480	.	C	T	4	4	8	0	0	8	0	0
3	33773294	.	A	G	17	17	34	0	2	37	1	0
3	33777317	.	T	G	21	16	37	0	12	49	0	0
3	33777425	.	A	G	24	16	40	0	3	43	0	0
3	33777807	.	A	G	25	25	50	1	1	52	0	0
3	33820291	.	T	C	4	8	12	0	0	12	0	0
3	33820568	.	C	T	14	9	23	0	0	23	0	0
3	33820580	.	A	G	16	8	24	0	0	24	0	0
3	33821929	.	C	T	6	2	8	0	0	8	0	0
3	33834678	.	T	C	10	4	14	0	1	15	0	0
3	33842844	.	A	G	12	7	19	0	0	19	0	0
3	33844761	.	T	C	10	0	10	0	12	22	0	0
3	33847104	.	A	G	4	6	10	0	1	11	0	0
3	33847131	.	C	T	3	7	10	0	1	11	0	0
3	33847191	.	T	C	6	6	12	0	2	14	0	0
3	33847832	.	G	A	6	5	11	0	0	11	0	0
3	33854879	.	T	C	5	5	10	0	0	10	0	0
3	33854927	.	G	A	9	6	15	0	2	17	0	0
3	33854972	.	A	G	7	5	12	0	1	13	0	0
3	33918537	.	T	A	3	2	5	0	0	5	0	0
3	33918611	.	A	G	3	5	8	0	0	8	0	0
3	33918675	.	T	G	9	3	12	0	0	12	0	0
3	33918775	.	A	G	5	5	10	0	1	11	0	0
3	33921663	.	A	C	6	10	16	0	0	16	0	0
3	33922198	.	C	T	3	2	5	0	1	6	0	0
3	33922233	.	T	A	5	2	7	0	1	8	0	0
3	33922245	.	T	C	5	2	7	0	0	7	0	0
3	33922359	.	G	A	3	9	12	0	1	13	0	0
3	33922413	.	T	A	6	7	13	0	0	13	0	0
3	33922415	.	G	A	6	7	13	0	0	13	0	0
3	33922471	.	T	C	6	7	13	0	0	13	0	0
3	33932170	.	C	T	1	11	12	0	3	15	0	0
3	33932430	.	T	A	5	14	19	0	0	19	0	0
3	33932628	.	G	A	8	5	13	0	0	13	0	0
3	33934848	.	T	C	8	4	12	0	0	12	0	0
3	33934849	.	G	C	6	4	10	0	2	12	0	0
3	33936783	.	G	C	4	8	12	0	0	12	0	0
3	34123144	.	G	T	1	3	4	0	0	4	0	0
3	34129941	.	C	T	0	14	14	0	11	25	0	0
3	34135868	.	C	T	7	6	13	0	1	14	0	0
3	34144353	.	A	T	5	2	7	0	0	7	0	0
3	34144807	.	C	G	5	6	11	0	0	11	0	0
3	34144808	.	G	A	0	6	6	0	5	11	0	0
3	34146338	.	C	T	3	4	7	0	0	7	0	0
3	34146882	.	G	T	5	3	8	0	0	8	0	0
3	34146955	.	A	G	2	1	3	0	1	4	0	0
3	34166288	.	C	A	13	16	29	0	0	29	0	0
3	34170913	.	G	A	17	17	34	0	2	36	0	0
3	34171863	.	C	G	3	1	4	0	16	20	0	0
3	34180096	.	G	T	14	10	24	0	0	24	0	0
3	34180332	.	A	G	8	6	14	0	0	14	0	0
3	34180386	.	G	A	4	5	9	0	0	9	0	0
3	34182164	.	C	T	12	4	16	0	0	16	0	0
3	34182306	.	G	C	9	6	15	0	1	16	0	0
3	34182376	.	A	C	7	8	15	0	0	15	0	0
3	34182386	.	G	A	0	9	9	0	6	15	0	0
3	34220359	.	A	T	5	5	10	0	0	10	0	0
3	34244901	.	G	C	6	6	12	0	2	14	0	0
3	34258965	.	G	A	16	17	33	0	0	33	0	0
3	34259013	.	C	G	20	12	32	0	1	33	0	0
3	34259060	.	C	T	23	17	40	0	0	40	0	0
3	34260325	.	T	C	6	13	19	0	1	20	0	0
3	34260808	.	T	C	11	13	24	0	1	25	0	0
3	34261204	.	T	C	8	18	26	0	0	26	0	0
3	34261354	.	A	G	20	18	38	0	0	38	0	0
3	34261795	.	G	A	12	10	22	0	1	23	0	0
3	34262290	.	C	T	20	9	29	0	0	29	0	0
3	34262421	.	C	A	5	12	17	0	0	17	0	0
3	34262639	.	G	A	19	9	28	0	3	31	0	0
3	34262823	.	A	T	11	12	23	0	1	24	0	0
3	34263007	.	C	T	1	13	14	0	7	22	1	0
3	34263101	.	T	A	14	4	18	0	3	21	0	0
3	34263566	.	C	A	16	8	24	0	0	24	0	0
3	34264140	.	A	T	8	4	12	0	2	14	0	0
3	34264634	.	T	A	7	8	15	0	4	19	0	0
3	34264657	.	A	T	13	10	23	0	0	23	0	0
3	34270546	.	A	G	11	4	15	0	1	16	0	0
3	34323584	.	C	T	4	4	8	0	0	8	0	0
3	34327103	.	G	A	5	2	7	0	1	8	0	0
3	34337695	.	C	T	3	2	5	0	0	5	0	0
3	34455822	.	T	C	1	0	1	0	6	7	0	0
3	34455908	.	C	T	0	2	2	0	1	3	0	0
3	34456397	.	G	A	3	2	5	0	0	5	0	0
3	34456405	.	A	G	4	2	6	0	0	6	0	0
3	34456538	.	A	G	1	7	8	0	0	8	0	0
3	34461700	.	A	G	2	3	5	0	0	5	0	0
3	34470021	.	G	A	1	2	3	0	0	3	0	0
3	34588788	.	G	A	5	5	10	0	0	10	0	0
3	34589501	.	C	T	3	3	6	0	0	6	0	0
3	34590350	.	A	C	1	2	3	0	0	3	0	0
3	34599655	.	T	G	2	2	4	0	0	4	0	0
3	34604202	.	A	G	1	1	2	0	1	3	0	0
3	34697461	.	G	A	6	7	13	0	0	13	0	0
3	34697514	.	T	C	8	0	8	0	13	21	0	0
3	34703722	.	T	G	1	5	6	0	1	7	0	0
3	34703731	.	G	C	2	6	8	0	0	8	0	0
3	34706676	.	G	A	1	3	4	0	1	5	0	0
3	34724968	.	A	C	5	4	9	0	0	9	0	0
3	34767006	.	A	T	10	3	13	0	2	15	0	0
3	34767112	.	G	T	21	26	47	0	5	52	0	0
3	34767662	.	T	G	25	33	58	0	3	61	0	0
3	34767669	.	G	A	24	35	59	0	2	61	0	0
3	34772941	.	T	G	36	36	72	0	0	72	0	0
3	34775942	.	G	A	34	31	65	0	2	67	0	0
3	34776115	.	T	G	32	19	51	0	6	57	0	0
3	34776133	.	G	C	36	21	57	0	2	59	0	0
3	34776151	.	C	A	39	27	66	0	2	68	0	0
3	34781074	.	A	G	32	34	66	0	0	66	0	0
3	34781095	.	C	T	32	33	65	0	2	67	0	0
3	34781448	.	T	C	19	22	41	0	5	46	0	0
3	34781586	.	T	C	18	2	20	0	21	41	0	0
3	34783970	.	G	A	19	25	44	0	2	46	0	0
3	34783982	.	A	G	16	28	44	0	2	46	0	0
3	34801034	.	T	C	8	13	21	0	0	21	0	0
3	34804427	.	A	G	19	13	32	1	4	37	0	0
3	34814839	.	A	G	3	6	9	0	0	9	0	0
3	34822049	.	C	T	13	17	30	0	2	32	0	0
3	34822169	.	C	T	19	18	37	0	0	37	0	0
3	34822214	.	T	C	10	19	29	0	0	29	0	0
3	34919853	.	A	G	5	0	5	0	4	9	0	0
3	34919892	.	C	T	12	9	21	0	1	23	1	0
3	34977497	.	A	G	16	1	17	0	9	26	0	0
3	34977508	.	A	G	15	0	15	0	6	21	0	0
3	34981394	.	T	C	3	4	7	0	0	7	0	0
3	34994140	.	C	T	32	29	61	1	3	65	0	0
3	34994750	.	A	G	16	11	27	0	2	29	0	0
3	35170112	.	T	C	24	12	36	2	1	39	0	0
3	35225160	.	A	G	23	2	25	0	29	54	0	0
3	35225202	.	C	T	19	24	43	0	1	44	0	0
3	35248470	.	T	C	13	8	21	0	0	21	0	0
3	35248492	.	T	A	12	14	26	0	1	27	0	0
3	35249369	.	T	C	20	12	32	0	1	33	0	0
3	35249535	.	T	C	15	11	26	0	1	27	0	0
3	35250145	.	A	T	19	17	36	0	1	37	0	0
3	35250188	.	A	G	17	20	37	0	1	38	0	0
3	35264406	.	T	G	32	16	48	0	3	51	0	0
3	35264460	.	C	T	23	19	42	0	1	43	0	0
3	35264744	.	T	A	24	9	33	0	3	36	0	0
3	35264951	.	G	A	16	12	28	2	1	31	0	0
3	35265350	.	T	C	14	14	28	6	0	34	0	0
3	35265419	.	T	G	19	11	30	0	1	31	0	0
3	35265654	.	G	A	3	19	22	0	25	47	0	0
3	35298531	.	G	T	3	6	9	0	0	9	0	0
3	35298725	.	T	A	6	9	15	0	1	16	0	0
3	35374719	.	C	T	11	11	22	0	0	22	0	0
3	35375112	.	G	A	14	11	25	0	0	25	0	0
3	35375162	.	T	A	18	11	29	0	0	29	0	0
3	35375279	.	A	T	11	8	19	0	5	24	0	0
3	35375306	.	T	C	14	10	24	0	2	26	0	0
3	35375448	.	T	G	12	1	13	0	17	30	0	0
3	35375638	.	T	A	17	8	25	0	1	26	0	0
3	35406475	.	G	A	7	7	14	0	0	14	0	0
3	35406648	.	G	T	0	3	3	0	6	9	0	0
3	35408361	.	A	G	2	2	4	0	0	4	0	0
3	35418047	.	A	G	8	8	16	0	0	16	0	0
3	35419683	.	A	T	13	11	24	0	2	26	0	0
3	35420588	.	A	G	6	6	12	0	2	14	0	0
3	35420604	.	C	T	7	3	10	0	0	10	0	0
3	35513674	.	A	G	4	5	9	0	1	10	0	0
3	35514786	.	C	T	9	12	21	0	1	22	0	0
3	35514849	.	C	A	11	7	18	0	5	23	0	0
3	35515053	.	G	T	9	12	21	0	1	22	0	0
3	35515074	.	C	T	11	8	19	0	0	19	0	0
3	35515103	.	G	A	9	6	15	0	0	15	0	0
3	35515179	.	T	C	9	10	19	0	0	19	0	0
3	35515206	.	G	A	3	9	12	0	0	12	0	0
3	35515304	.	T	G	5	5	10	0	1	11	0	0
3	35515866	.	A	T	3	16	19	0	1	20	0	0
3	35517999	.	A	C	9	7	16	0	0	17	1	0
3	35518036	.	C	G	8	12	20	0	1	21	0	0
3	35518464	.	A	C	12	5	17	0	0	17	0	0
3	35518962	.	C	A	11	11	22	0	0	23	1	0
3	35523824	.	C	G	17	10	27	0	1	28	0	0
3	35527024	.	T	C	6	11	17	0	1	18	0	0
3	35529040	.	T	C	13	13	26	0	0	26	0	0
3	35530787	.	C	T	6	5	11	1	2	14	0	0
3	35531018	.	T	C	8	10	18	0	7	25	0	0
3	35531028	.	T	C	9	15	24	0	4	28	0	0
3	35531328	.	G	A	1	8	9	0	9	18	0	0
3	35531329	.	A	T	9	9	18	0	0	18	0	0
3	35531671	.	A	T	13	11	24	0	0	24	0	0
3	35531791	.	A	G	14	1	15	0	19	34	0	0
3	35531866	.	T	A	15	20	35	0	0	35	0	0
3	35531985	.	G	A	20	20	40	0	0	40	0	0
3	35532074	.	A	T	11	16	27	0	2	29	0	0
3	35532452	.	A	T	19	21	40	0	0	40	0	0
3	35532634	.	A	G	15	0	15	0	15	30	0	0
3	35532665	.	C	T	18	14	32	0	1	33	0	0
3	35532736	.	A	C	20	6	26	0	0	26	0	0
3	35535484	.	G	A	1	3	4	0	0	4	0	0
3	35535525	.	T	G	3	2	5	0	0	5	0	0
3	35535652	.	T	A	3	3	6	0	0	6	0	0
3	35535695	.	A	C	2	4	6	0	0	6	0	0
3	35535702	.	G	T	2	3	5	0	1	6	0	0
3	35535945	.	G	A	2	2	4	0	0	4	0	0
3	35536115	.	C	G	11	10	21	0	1	22	0	0
3	35536269	.	G	A	11	8	19	0	0	19	0	0
3	35541273	.	A	G	34	28	62	0	0	62	0	0
3	35548822	.	C	A	2	2	4	0	0	4	0	0
3	35548903	.	G	A	4	6	10	0	0	10	0	0
3	35549002	.	G	A	7	7	14	0	0	14	0	0
3	35549223	.	A	T	3	2	5	0	0	5	0	0
3	35551047	.	A	T	12	17	29	0	0	29	0	0
3	35551190	.	C	T	1	7	8	0	7	15	0	0
3	35589548	.	C	T	12	22	34	0	2	36	0	0
3	35589881	.	T	C	19	12	31	0	11	42	0	0
3	35589908	.	A	G	29	14	43	0	0	43	0	0
3	35589918	.	G	A	28	14	42	0	1	43	0	0
3	35590270	.	T	C	31	1	32	0	20	52	0	0
3	35602007	.	A	C	22	0	22	0	27	49	0	0
3	35602047	.	A	G	22	23	45	0	4	49	0	0
3	35602153	.	A	G	18	15	33	0	1	34	0	0
3	35602154	.	T	A	18	15	33	0	1	34	0	0
3	35608511	.	C	T	2	3	5	0	0	5	0	0
3	35617940	.	A	C	6	4	10	0	0	10	0	0
3	35617943	.	A	C	5	4	9	0	1	10	0	0
3	35621473	.	G	A	2	6	8	0	3	11	0	0
3	35621515	.	T	G	6	0	6	0	9	15	0	0
3	35623614	.	A	G	1	5	6	0	1	7	0	0
3	35634953	.	A	G	5	7	12	0	0	12	0	0
3	35635039	.	C	T	7	10	17	0	1	18	0	0
3	35635135	.	A	G	7	0	7	0	4	11	0	0
3	35635151	.	T	C	5	6	11	0	1	12	0	0
3	35636172	.	A	G	5	4	9	0	0	9	0	0
3	35636410	.	A	G	8	6	14	0	0	14	0	0
3	35637535	.	A	G	2	0	2	0	7	9	0	0
3	35638008	.	T	A	14	9	23	0	1	24	0	0
3	35638119	.	A	C	13	16	29	0	1	30	0	0
3	35638201	.	A	G	13	12	25	0	0	25	0	0
3	35638240	.	C	T	9	13	22	0	0	22	0	0
3	35638366	.	T	C	9	3	12	0	3	15	0	0
3	35638450	.	T	A	6	8	14	1	2	17	0	0
3	35638513	.	G	A	15	14	29	0	0	29	0	0
3	35638908	.	C	T	3	19	22	0	17	39	0	0
3	35638986	.	C	A	16	18	34	0	0	35	1	0
3	35639020	.	A	G	18	18	36	0	1	37	0	0
3	35639021	.	G	A	18	18	36	0	1	37	0	0
3	35639194	.	T	C	16	19	35	0	0	35	0	0
3	35639621	.	A	C	10	15	25	0	1	26	0	0
3	35639817	.	T	A	4	12	16	0	4	20	0	0
3	35639862	.	G	T	11	10	21	0	0	21	0	0
3	35639884	.	T	C	10	0	10	0	8	18	0	0
3	35639958	.	T	C	13	5	18	0	1	19	0	0
3	35640042	.	A	G	15	7	22	0	0	22	0	0
3	35640122	.	G	T	9	8	17	0	0	17	0	0
3	35640441	.	C	A	19	7	26	0	0	26	0	0
3	35640625	.	C	T	9	5	14	0	1	15	0	0
3	35640784	.	T	C	13	13	26	0	1	27	0	0
3	35640828	.	A	G	15	5	20	0	2	22	0	0
3	35641173	.	C	T	5	10	15	0	0	15	0	0
3	35641371	.	C	T	3	18	21	0	17	38	0	0
3	35641382	.	G	A	19	21	40	0	0	40	0	0
3	35641595	.	A	T	16	19	35	0	0	35	0	0
3	35641663	.	T	C	13	13	26	0	3	29	0	0
3	35641785	.	C	T	1	11	12	0	16	28	0	0
3	35642012	.	A	T	15	14	29	0	0	29	0	0
3	35642072	.	A	G	14	14	28	0	0	28	0	0
3	35642242	.	T	C	7	0	7	0	8	15	0	0
3	35642462	.	T	C	7	1	8	0	14	22	0	0
3	35643320	.	G	A	11	4	15	0	2	17	0	0
3	35643540	.	G	A	11	11	22	0	1	23	0	0
3	35643546	.	A	T	10	11	21	0	0	21	0	0
3	35645380	.	T	C	17	2	19	0	21	40	0	0
3	35645411	.	G	A	17	17	34	0	3	37	0	0
3	35645661	.	T	G	12	25	37	0	1	38	0	0
3	35646025	.	G	T	19	16	35	0	1	36	0	0
3	35646160	.	G	T	17	9	26	0	0	26	0	0
3	35646611	.	T	G	6	9	15	0	0	15	0	0
3	35647181	.	A	G	18	15	33	0	0	33	0	0
3	35647321	.	G	A	9	11	20	0	1	21	0	0
3	35647882	.	G	A	5	3	8	0	0	8	0	0
3	35647975	.	A	G	9	11	20	0	0	20	0	0
3	35800738	.	T	C	7	8	15	0	0	15	0	0
3	35800758	.	T	G	8	4	12	0	2	14	0	0
3	35801019	.	A	T	1	2	3	0	1	4	0	0
3	35831029	.	T	C	4	5	9	0	2	11	0	0
3	35831095	.	G	T	2	8	10	0	1	11	0	0
3	35837532	.	C	T	4	4	8	0	0	8	0	0
3	35840264	.	A	G	2	0	2	0	2	4	0	0
3	35840267	.	T	A	2	2	4	0	0	4	0	0
3	35845735	.	A	G	3	6	9	0	1	10	0	0
3	35845774	.	T	C	7	4	11	0	1	12	0	0
3	35845805	.	A	G	6	7	13	0	0	13	0	0
3	35846120	.	C	G	7	7	14	0	1	15	0	0
3	35846343	.	C	G	6	4	10	1	0	11	0	0
3	35846410	.	A	T	9	6	15	1	1	17	0	0
3	35846440	.	G	A	5	7	12	0	1	13	0	0
3	35846823	.	A	G	5	4	9	0	2	11	0	0
3	35850254	.	G	A	5	5	10	0	1	11	0	0
3	35850380	.	C	T	7	3	10	0	2	12	0	0
3	35864419	.	G	A	2	4	6	0	0	6	0	0
3	36023342	.	T	G	17	28	45	0	1	46	0	0
3	36023455	.	A	G	21	13	34	0	2	36	0	0
3	36023465	.	A	G	22	16	38	0	1	39	0	0
3	36026294	.	C	G	1	30	31	0	25	56	0	0
3	36032241	.	G	A	20	25	45	0	0	45	0	0
3	36038631	.	G	A	13	24	37	0	1	38	0	0
3	36040863	.	A	G	17	14	31	0	2	33	0	0
3	36041017	.	A	C	28	25	53	0	0	53	0	0
3	36123546	.	G	A	1	2	3	0	1	4	0	0
3	36125256	.	C	G	0	4	4	0	3	7	0	0
3	36127040	.	A	G	1	2	3	0	0	3	0	0
3	36131883	.	T	A	7	6	13	0	0	13	0	0
3	36132099	.	C	T	6	4	10	0	1	11	0	0
3	36132740	.	T	C	15	16	31	0	1	32	0	0
3	36135867	.	A	C	1	2	3	0	0	3	0	0
3	36136290	.	G	C	1	1	2	0	1	3	0	0
3	36136405	.	A	T	1	4	5	0	1	6	0	0
3	36136609	.	T	C	4	4	8	0	2	10	0	0
3	36143805	.	C	T	1	2	3	0	2	5	0	0
3	36143917	.	C	T	0	3	3	0	1	4	0	0
3	36167286	.	T	C	5	5	10	0	0	10	0	0
3	36173633	.	T	C	22	7	29	0	1	30	0	0
3	36174175	.	C	A	16	10	26	0	2	28	0	0
3	36174248	.	C	G	14	11	25	0	0	25	0	0
3	36174276	.	T	C	11	1	12	0	14	26	0	0
3	36184806	.	A	G	10	14	24	0	1	25	0	0
3	36188400	.	A	G	11	10	21	0	1	22	0	0
3	36210030	.	G	A	5	10	15	0	1	16	0	0
3	36210074	.	C	T	6	7	13	0	3	16	0	0
3	36224109	.	C	T	2	3	5	0	0	5	0	0
3	36228319	.	T	G	1	2	3	0	0	3	0	0
3	36229823	.	G	A	7	4	11	0	0	11	0	0
3	36229886	.	A	T	2	7	9	0	1	10	0	0
3	36232218	.	A	G	4	4	8	0	0	8	0	0
3	36232331	.	C	T	3	5	8	0	0	8	0	0
3	36232368	.	A	C	3	4	7	0	0	7	0	0
3	36241839	.	T	C	12	14	26	0	0	26	0	0
3	36241938	.	T	C	10	0	10	0	17	27	0	0
3	36242239	.	C	T	2	9	11	0	15	26	0	0
3	36248869	.	T	C	4	20	24	0	1	25	0	0
3	36249172	.	C	T	7	7	14	0	0	14	0	0
3	36249419	.	G	A	21	6	27	0	0	27	0	0
3	36249476	.	T	A	23	19	42	0	1	43	0	0
3	36249516	.	T	A	18	10	28	0	0	28	0	0
3	36249518	.	A	C	18	10	28	0	0	28	0	0
3	36253186	.	G	A	18	15	33	0	3	36	0	0
3	36255436	.	A	G	20	14	34	0	0	34	0	0
3	36259855	.	T	C	11	23	34	0	0	34	0	0
3	36262799	.	A	C	30	1	31	0	10	41	0	0
3	36263099	.	T	C	15	1	16	0	19	35	0	0
3	36263151	.	A	G	20	21	41	0	1	42	0	0
3	36263163	.	C	T	19	21	40	0	0	40	0	0
3	36263464	.	C	A	18	16	34	0	1	35	0	0
3	36263557	.	A	G	18	19	37	0	1	38	0	0
3	36263563	.	T	A	19	18	37	0	2	39	0	0
3	36263596	.	T	C	7	0	7	0	14	21	0	0
3	36263666	.	T	C	9	0	9	0	19	28	0	0
3	36263824	.	T	C	23	17	40	0	3	43	0	0
3	36263895	.	A	T	23	19	42	0	0	42	0	0
3	36264028	.	T	C	17	1	18	0	16	34	0	0
3	36264204	.	T	G	21	13	34	0	0	34	0	0
3	36264217	.	A	C	20	14	34	0	0	34	0	0
3	36264248	.	T	C	17	13	30	0	2	32	0	0
3	36264822	.	C	A	7	3	10	0	0	10	0	0
3	36265895	.	C	T	2	23	25	0	18	43	0	0
3	36266137	.	T	A	20	20	40	0	1	41	0	0
3	36266173	.	A	G	18	15	33	0	1	34	0	0
3	36268616	.	A	G	15	11	26	0	0	26	0	0
3	36285177	.	C	A	7	5	12	0	1	13	0	0
3	36291213	.	A	G	8	0	8	0	8	16	0	0
3	36292481	.	G	C	2	8	10	0	8	18	0	0
3	36292657	.	T	C	8	15	23	0	2	25	0	0
3	36293950	.	C	T	13	8	21	0	1	22	0	0
3	36293964	.	C	T	13	8	21	0	0	21	0	0
3	36305854	.	A	G	22	18	40	0	2	42	0	0
3	36305860	.	A	G	24	0	24	0	20	44	0	0
3	36305971	.	T	A	13	10	23	0	0	23	0	0
3	36319778	.	T	A	4	2	6	0	1	7	0	0
3	36323001	.	T	C	3	2	5	0	1	6	0	0
3	36325569	.	T	A	4	2	6	0	0	6	0	0
3	36325599	.	G	C	6	2	8	0	1	9	0	0
3	36325648	.	A	T	9	6	15	0	1	16	0	0
3	36325726	.	C	T	1	5	6	0	0	6	0	0
3	36325802	.	A	G	3	0	3	0	5	8	0	0
3	36326003	.	T	C	2	2	4	0	0	4	0	0
3	36326091	.	A	C	2	3	5	0	0	5	0	0
3	36326108	.	A	T	1	3	4	0	1	5	0	0
3	36326139	.	T	G	5	4	9	0	0	9	0	0
3	36326370	.	A	G	4	8	12	0	1	13	0	0
3	36326482	.	T	A	2	4	6	0	0	6	0	0
3	36326490	.	A	T	2	4	6	0	0	6	0	0
3	36326839	.	T	A	1	3	4	0	1	5	0	0
3	36327060	.	G	A	0	4	4	0	8	12	0	0
3	36327061	.	A	C	8	4	12	0	0	12	0	0
3	36327097	.	C	T	7	2	9	0	1	10	0	0
3	36327129	.	G	A	9	7	16	0	0	16	0	0
3	36327260	.	T	C	4	2	6	0	0	6	0	0
3	36327414	.	T	A	2	2	4	0	0	4	0	0
3	36327802	.	C	A	5	2	7	0	0	7	0	0
3	36327872	.	G	A	8	4	12	0	0	12	0	0
3	36327906	.	G	T	8	5	13	0	0	13	0	0
3	36327909	.	G	T	2	5	7	0	4	11	0	0
3	36328029	.	T	G	2	4	6	0	1	7	0	0
3	36328083	.	G	T	5	2	7	0	0	7	0	0
3	36328204	.	C	A	3	10	13	0	0	13	0	0
3	36328218	.	G	A	4	9	13	0	1	14	0	0
3	36328339	.	G	A	4	3	7	0	1	8	0	0
3	36328390	.	A	T	1	3	4	0	1	5	0	0
3	36328414	.	T	A	3	3	6	0	1	7	0	0
3	36401284	.	G	A	0	3	3	0	3	6	0	0
3	36402930	.	T	C	5	0	5	0	3	8	0	0
3	36407283	.	C	A	2	4	6	0	0	6	0	0
3	36407604	.	A	G	7	3	10	0	0	10	0	0
3	36408402	.	G	T	1	3	4	0	0	4	0	0
3	36409656	.	C	T	4	3	7	0	0	7	0	0
3	36409721	.	G	A	7	3	10	0	0	10	0	0
3	36409877	.	C	T	6	6	12	0	1	13	0	0
3	36409969	.	T	C	4	4	8	0	0	8	0	0
3	36410038	.	T	A	3	2	5	0	0	5	0	0
3	36419413	.	A	C	3	2	5	0	0	5	0	0
3	36428612	.	T	A	24	16	40	0	1	41	0	0
3	36428620	.	T	A	23	16	39	0	3	42	0	0
3	36431380	.	T	C	28	27	55	0	3	58	0	0
3	36441484	.	T	C	8	3	11	0	2	13	0	0
3	36442021	.	T	C	3	8	11	0	2	13	0	0
3	36442029	.	A	G	3	7	10	0	1	11	0	0
3	36442071	.	A	G	4	4	8	0	0	8	0	0
3	36442551	.	C	T	3	12	15	0	13	28	0	0
3	36442661	.	T	G	11	12	23	0	1	24	0	0
3	36442726	.	A	G	13	25	38	0	1	39	0	0
3	36443189	.	G	A	13	16	29	0	0	29	0	0
3	36446613	.	A	G	10	12	22	0	0	22	0	0
3	36859755	.	A	T	21	10	31	0	2	33	0	0
3	36859767	.	A	G	16	0	16	0	19	35	0	0
3	36859821	.	G	T	13	14	27	0	1	28	0	0
3	36862242	.	T	G	9	7	16	0	0	16	0	0
3	36868428	.	T	C	19	15	34	0	1	35	0	0
3	36871254	.	A	T	11	20	31	0	0	31	0	0
3	36871260	.	G	A	2	17	19	0	9	28	0	0
3	36871310	.	A	G	15	1	16	0	11	27	0	0
3	36871316	.	A	G	17	1	18	0	11	29	0	0
3	36877656	.	A	G	23	11	34	0	1	35	0	0
3	36880046	.	C	T	20	12	32	0	0	32	0	0
3	36883659	.	A	G	15	0	15	1	19	35	0	0
3	36888169	.	T	C	30	14	44	0	3	47	0	0
3	36888395	.	G	A	27	17	44	0	2	46	0	0
3	36889316	.	C	G	22	1	23	0	20	43	0	0
3	36889821	.	A	G	31	0	31	0	23	54	0	0
3	36892130	.	C	T	14	9	23	0	3	26	0	0
3	36892457	.	T	G	1	2	3	0	0	3	0	0
3	36892469	.	T	G	1	2	3	0	0	3	0	0
3	36892514	.	G	C	1	3	4	0	0	4	0	0
3	36895578	.	T	G	3	2	5	0	0	5	0	0
3	36907411	.	T	C	4	7	11	0	0	11	0	0
3	36909852	.	T	G	9	15	24	0	1	25	0	0
3	36910159	.	C	A	12	5	17	0	0	17	0	0
3	36910174	.	G	A	11	5	16	0	0	16	0	0
3	36917320	.	A	T	6	6	12	0	0	12	0	0
3	36917365	.	A	G	7	5	12	0	2	14	0	0
3	36918852	.	G	A	10	9	19	0	2	21	0	0
3	36918966	.	A	G	13	10	23	0	0	23	0	0
3	36923106	.	G	A	4	5	9	0	0	9	0	0
3	36923226	.	G	A	7	6	13	0	0	13	0	0
3	36923412	.	A	G	5	4	9	0	0	9	0	0
3	36923933	.	C	T	5	7	12	0	0	12	0	0
3	36926417	.	A	G	7	10	17	0	0	17	0	0
3	36926456	.	C	T	2	12	14	0	4	18	0	0
3	36926546	.	G	A	7	4	11	0	0	11	0	0
3	36926886	.	G	A	5	3	8	0	0	8	0	0
3	36929565	.	A	G	8	5	13	0	0	13	0	0
3	37104617	.	A	G	1	3	4	0	0	4	0	0
3	37104621	.	A	G	1	0	1	0	2	3	0	0
3	37107093	.	C	T	7	3	10	0	0	10	0	0
3	37559334	.	A	T	19	32	51	1	2	54	0	0
3	37559905	.	A	C	18	20	38	0	0	39	1	0
3	37564769	.	G	A	16	23	39	0	2	41	0	0
3	37649598	.	G	C	9	3	12	0	0	12	0	0
3	37660307	.	G	A	11	3	14	0	0	14	0	0
3	37664117	.	A	T	11	10	21	0	0	21	0	0
3	37664635	.	A	G	8	16	24	0	3	27	0	0
3	37665855	.	G	A	28	24	52	0	1	53	0	0
3	37666774	.	C	T	1	11	12	0	29	41	0	0
3	37667562	.	C	T	3	29	32	0	21	53	0	0
3	37667608	.	G	C	14	28	42	0	3	45	0	0
3	37667646	.	C	T	13	16	29	0	4	33	0	0
3	37667952	.	C	T	4	14	18	0	15	33	0	0
3	37668319	.	A	G	10	5	15	0	1	16	0	0
3	37668370	.	T	C	4	3	7	0	0	7	0	0
3	37668578	.	T	A	13	4	17	0	3	20	0	0
3	37668667	.	C	A	6	15	21	0	0	21	0	0
3	37670156	.	G	T	8	6	14	0	0	14	0	0
3	37673750	.	T	A	7	11	18	0	1	19	0	0
3	37725453	.	A	G	5	0	5	0	3	8	0	0
3	37726111	.	C	T	6	2	8	0	0	8	0	0
3	37727784	.	T	C	4	3	7	0	1	8	0	0
3	37737680	.	C	A	8	6	14	0	1	15	0	0
3	37737735	.	T	G	9	0	9	0	6	15	0	0
3	37737736	.	C	T	9	6	15	0	0	15	0	0
3	37737852	.	A	G	5	6	11	0	1	12	0	0
3	37738024	.	A	G	7	10	17	0	2	19	0	0
3	37738050	.	C	G	5	10	15	0	1	16	0	0
3	37738089	.	G	A	4	4	8	0	1	9	0	0
3	37742152	.	T	C	8	3	11	0	0	11	0	0
3	37742245	.	C	T	12	5	17	0	0	17	0	0
3	37742247	.	A	G	13	5	18	0	0	18	0	0
3	37742284	.	T	G	11	4	15	0	0	15	0	0
3	37742338	.	C	G	4	2	6	0	0	6	0	0
3	37742363	.	C	T	2	4	6	0	0	6	0	0
3	37776713	.	T	C	7	6	13	0	0	13	0	0
3	37777309	.	A	T	6	7	13	0	2	15	0	0
3	37777417	.	G	C	4	7	11	0	0	11	0	0
3	37777590	.	C	T	7	3	10	0	1	11	0	0
3	37777811	.	C	T	0	8	8	0	10	18	0	0
3	37781162	.	A	G	6	5	11	0	0	11	0	0
3	37788401	.	T	C	35	33	68	2	2	72	0	0
3	37789216	.	G	T	2	6	8	0	1	9	0	0
3	37827420	.	G	A	4	4	8	0	0	8	0	0
3	37827822	.	C	T	5	9	14	0	0	14	0	0
3	37827948	.	C	T	6	5	11	0	0	11	0	0
3	38505629	.	A	G	19	13	32	0	0	32	0	0
3	38614366	.	C	T	13	10	23	0	0	23	0	0
3	38614426	.	A	G	12	1	13	0	12	25	0	0
3	38614562	.	C	T	19	11	30	0	0	30	0	0
3	38624737	.	A	G	22	0	22	0	9	31	0	0
3	38624823	.	G	A	16	10	26	0	1	27	0	0
3	38625098	.	A	C	16	14	30	0	0	30	0	0
3	38625497	.	G	T	11	12	23	0	1	24	0	0
3	38625559	.	T	C	10	5	15	0	2	17	0	0
3	38625605	.	G	A	10	13	23	0	0	23	0	0
3	38625751	.	A	C	9	6	15	0	0	15	0	0
3	38625901	.	T	G	12	7	19	0	1	20	0	0
3	38649991	.	A	T	14	14	28	0	1	29	0	0
3	38650341	.	T	C	11	5	16	1	4	21	0	0
3	38650348	.	T	C	3	17	20	1	1	22	0	0
3	38650440	.	T	C	8	7	15	1	1	17	0	0
3	38650462	.	T	C	6	7	13	1	0	14	0	0
3	38763153	.	T	A	8	7	15	0	4	19	0	0
3	38763391	.	A	G	6	7	13	0	0	13	0	0
3	38763449	.	C	T	5	4	9	0	0	9	0	0
3	38763505	.	G	A	5	2	7	0	0	7	0	0
3	38763527	.	C	T	1	4	5	0	5	10	0	0
3	38763564	.	C	A	5	9	14	0	0	14	0	0
3	38763700	.	G	A	6	2	8	0	0	8	0	0
3	38764738	.	A	C	4	0	4	0	2	6	0	0
3	38764990	.	G	T	3	2	5	0	0	5	0	0
3	38765447	.	T	G	1	0	1	0	0	4	3	0
3	38766207	.	C	T	1	4	5	0	6	11	0	0
3	38766395	.	G	A	2	3	5	0	0	5	0	0
3	38766507	.	G	A	4	2	6	0	0	6	0	0
3	38766759	.	G	A	1	5	6	0	0	6	0	0
3	38766779	.	C	T	1	3	4	0	1	5	0	0
3	38766813	.	A	G	3	3	6	0	0	6	0	0
3	38767750	.	T	C	4	4	8	0	0	8	0	0
3	38793729	.	G	T	0	2	2	0	2	4	0	0
3	38793808	.	G	A	2	2	4	0	0	4	0	0
3	38794422	.	G	C	5	7	12	0	1	13	0	0
3	38858649	.	A	G	2	4	6	0	1	7	0	0
3	38858673	.	C	A	1	5	6	0	2	8	0	0
3	38858722	.	G	A	5	3	8	0	0	8	0	0
3	38858908	.	G	A	0	6	6	0	6	12	0	0
3	38858949	.	G	C	9	6	15	0	0	15	0	0
3	38859066	.	G	A	2	3	5	0	0	5	0	0
3	38859126	.	A	T	3	2	5	0	0	5	0	0
3	39181560	.	A	C	4	2	6	0	0	6	0	0
3	39181635	.	C	T	3	4	7	0	0	7	0	0
3	39181745	.	T	A	3	3	6	0	0	6	0	0
3	39181758	.	C	A	3	1	4	0	1	5	0	0
3	39181793	.	A	G	2	3	5	0	0	5	0	0
3	39181823	.	A	G	3	5	8	0	1	9	0	0
3	39181849	.	A	G	4	7	11	0	0	11	0	0
3	39184156	.	A	G	7	6	13	0	1	14	0	0
3	39184180	.	C	T	6	7	13	0	0	13	0	0
3	39186729	.	T	C	6	3	9	0	0	9	0	0
3	39189208	.	G	T	6	3	9	2	0	11	0	0
3	39189212	.	A	G	3	3	6	2	1	9	0	0
3	39238579	.	C	A	9	3	12	0	1	13	0	0
3	39238580	.	C	A	11	3	14	0	0	14	0	0
3	39239380	.	A	G	18	14	32	0	0	32	0	0
3	39241350	.	G	T	15	16	31	0	1	32	0	0
3	39248863	.	A	G	7	9	16	0	0	16	0	0
3	39251020	.	G	T	11	6	17	0	1	18	0	0
3	39251341	.	T	C	10	6	16	0	0	16	0	0
3	39259624	.	T	C	9	0	9	0	10	19	0	0
3	39260767	.	A	T	5	3	8	0	1	9	0	0
3	39260818	.	A	G	4	4	8	0	0	8	0	0
3	39260934	.	G	A	3	3	6	0	1	7	0	0
3	39261182	.	C	A	0	6	6	0	1	7	0	0
3	39261672	.	G	A	3	2	5	0	1	6	0	0
3	39261954	.	G	T	1	2	3	0	0	3	0	0
3	39261966	.	T	C	2	1	3	0	0	3	0	0
3	39262338	.	C	G	6	10	16	0	1	17	0	0
3	39262786	.	G	A	1	2	3	0	0	3	0	0
3	39262801	.	C	A	0	2	2	0	1	3	0	0
3	39262925	.	C	A	2	3	5	0	0	5	0	0
3	39263316	.	G	C	3	0	3	0	2	5	0	0
3	39263324	.	T	C	2	0	2	0	2	4	0	0
3	39269080	.	C	T	1	2	3	0	0	3	0	0
3	39269790	.	A	G	2	2	4	0	0	4	0	0
3	39313310	.	A	G	8	7	15	0	2	17	0	0
3	39313625	.	T	C	6	6	12	0	2	14	0	0
3	39314028	.	C	T	19	15	34	0	0	34	0	0
3	39314101	.	T	C	14	14	28	0	0	28	0	0
3	39314146	.	C	G	11	15	26	0	1	27	0	0
3	39314260	.	A	G	8	3	11	0	0	11	0	0
3	39314502	.	G	C	10	9	19	0	0	19	0	0
3	39314631	.	C	T	1	8	9	0	10	19	0	0
3	39314677	.	C	T	5	9	14	0	1	15	0	0
3	39314893	.	C	A	6	6	12	0	1	13	0	0
3	39314899	.	C	T	7	7	14	0	0	14	0	0
3	39315154	.	C	A	3	6	9	0	0	9	0	0
3	39315169	.	C	G	6	5	11	0	1	12	0	0
3	39315191	.	C	G	6	8	14	1	0	15	0	0
3	39315229	.	A	T	5	5	10	1	0	11	0	0
3	39315728	.	C	T	5	7	12	0	0	12	0	0
3	39315737	.	T	C	5	6	11	0	1	12	0	0
3	39315816	.	A	G	6	5	11	0	0	11	0	0
3	39315874	.	C	A	11	9	20	0	0	20	0	0
3	39315876	.	C	T	11	8	19	0	1	20	0	0
3	39315937	.	A	C	7	0	7	0	5	12	0	0
3	39316037	.	T	C	4	6	10	0	0	10	0	0
3	39316062	.	G	A	8	9	17	0	0	17	0	0
3	39316167	.	A	G	10	10	20	0	0	20	0	0
3	39316570	.	G	A	5	6	11	0	1	12	0	0
3	39316846	.	T	C	8	7	15	0	3	18	0	0
3	39316906	.	C	A	19	16	35	0	0	35	0	0
3	39316912	.	G	A	16	13	29	0	2	31	0	0
3	39316996	.	A	G	16	14	30	0	1	31	0	0
3	39317215	.	C	G	9	6	15	0	4	19	0	0
3	39317279	.	C	T	6	6	12	0	1	13	0	0
3	39317310	.	T	C	6	8	14	0	0	14	0	0
3	39317370	.	C	T	8	7	15	0	0	15	0	0
3	39322109	.	G	A	4	7	11	0	1	12	0	0
3	39328095	.	G	C	8	10	18	0	1	19	0	0
3	39330407	.	T	C	8	0	8	0	9	17	0	0
3	39348533	.	G	A	10	12	22	0	0	22	0	0
3	39348914	.	G	A	4	5	9	0	2	11	0	0
3	39454708	.	C	G	5	3	8	0	0	8	0	0
3	39568368	.	T	G	24	18	42	0	0	42	0	0
3	39568856	.	A	G	25	26	51	1	1	53	0	0
3	39574883	.	C	A	33	32	65	1	8	74	0	0
3	39574961	.	G	A	26	39	65	0	1	66	0	0
3	39576621	.	T	G	31	6	37	0	40	77	0	0
3	39576663	.	A	G	31	46	77	0	3	80	0	0
3	39576866	.	T	C	25	16	41	0	2	43	0	0
3	39579616	.	C	A	4	2	6	0	0	6	0	0
3	39579660	.	G	T	4	8	12	0	0	12	0	0
3	39580908	.	T	C	6	5	11	0	2	13	0	0
3	39586473	.	A	T	2	2	4	0	0	4	0	0
3	39592640	.	T	G	5	2	7	0	0	7	0	0
3	39592797	.	C	T	4	7	11	0	0	11	0	0
3	39592800	.	G	C	0	7	7	0	4	11	0	0
3	39606220	.	C	T	5	10	15	0	1	16	0	0
3	39612261	.	T	A	8	16	24	0	2	26	0	0
3	39612430	.	T	C	17	10	27	0	0	27	0	0
3	39612579	.	G	C	10	10	20	0	1	21	0	0
3	39612715	.	A	T	7	9	16	0	0	16	0	0
3	39613024	.	T	C	7	13	20	0	1	21	0	0
3	39631505	.	T	C	4	3	7	0	0	7	0	0
3	39663915	.	C	T	5	2	7	0	0	7	0	0
3	39663929	.	T	C	5	2	7	0	0	7	0	0
3	39683715	.	A	G	2	4	6	0	0	6	0	0
3	39686016	.	C	A	1	3	4	0	0	4	0	0
3	39686776	.	T	A	4	3	7	0	1	8	0	0
3	39686807	.	A	T	3	2	5	0	0	5	0	0
3	39686915	.	T	C	3	3	6	0	0	6	0	0
3	39687418	.	C	T	5	3	8	0	0	8	0	0
3	39688892	.	T	C	7	9	16	0	1	17	0	0
3	39688906	.	C	T	5	8	13	0	0	13	0	0
3	39689132	.	T	C	7	2	9	0	0	9	0	0
3	39689157	.	G	A	9	2	11	0	1	12	0	0
3	39689234	.	G	T	5	2	7	0	1	8	0	0
3	39689277	.	A	G	3	2	5	0	0	5	0	0
3	39691676	.	A	G	2	2	4	0	0	4	0	0
3	39691795	.	C	T	1	3	4	0	0	4	0	0
3	39691978	.	C	G	2	5	7	0	0	7	0	0
3	39692008	.	G	T	2	4	6	0	1	7	0	0
3	39692165	.	A	T	5	7	12	0	0	12	0	0
3	39692196	.	C	T	0	14	14	0	5	19	0	0
3	39692206	.	C	T	6	12	18	0	2	20	0	0
3	39692235	.	C	A	9	16	25	0	0	25	0	0
3	39692265	.	G	A	11	7	18	0	0	18	0	0
3	39692307	.	A	G	9	9	18	0	0	18	0	0
3	39695744	.	T	C	5	9	14	0	0	14	0	0
3	39878663	.	C	T	2	9	11	0	0	11	0	0
3	39878822	.	T	C	4	7	11	0	0	11	0	0
3	39884348	.	G	A	0	5	5	0	2	7	0	0
3	39919127	.	G	A	3	4	7	0	0	7	0	0
3	39923512	.	G	A	0	6	6	0	3	9	0	0
3	39925087	.	T	C	7	8	15	0	0	15	0	0
3	39940210	.	T	C	8	9	17	0	1	18	0	0
3	39945696	.	A	G	6	5	11	0	1	12	0	0
3	39949389	.	G	A	6	6	12	0	0	13	1	0
3	39949650	.	G	A	1	19	20	0	13	33	0	0
3	39950276	.	A	C	12	10	22	0	5	27	0	0
3	39950340	.	C	T	13	6	19	0	1	20	0	0
3	39950414	.	T	C	11	7	18	0	1	19	0	0
3	39950954	.	T	C	10	8	18	0	0	18	0	0
3	39951124	.	C	T	13	6	19	0	2	21	0	0
3	39951216	.	T	C	9	9	18	0	0	18	0	0
3	39951703	.	A	T	5	9	14	0	1	15	0	0
3	39952025	.	T	C	6	5	11	0	0	11	0	0
3	39952272	.	A	G	11	10	21	0	0	21	0	0
3	39952273	.	A	T	11	10	21	0	0	21	0	0
3	39958680	.	C	T	3	6	9	0	0	9	0	0
3	39958729	.	T	A	4	7	11	0	0	11	0	0
3	39959679	.	A	C	5	6	11	0	3	14	0	0
3	39960535	.	G	C	1	6	7	0	6	13	0	0
3	39962981	.	T	C	10	5	15	0	0	15	0	0
3	39963053	.	T	C	10	10	20	0	0	20	0	0
3	39963089	.	A	G	7	6	13	0	0	13	0	0
3	39963128	.	G	A	6	5	11	0	0	11	0	0
3	39963131	.	A	G	4	3	7	0	1	8	0	0
3	39970555	.	G	A	10	5	15	0	0	15	0	0
3	39970641	.	T	G	7	6	13	0	1	14	0	0
3	39971335	.	T	A	6	3	9	0	0	9	0	0
3	39971365	.	T	C	5	3	8	0	0	8	0	0
3	39971373	.	T	C	3	3	6	0	1	7	0	0
3	39971894	.	T	C	3	10	13	1	0	14	0	0
3	39971943	.	T	C	11	3	14	0	0	14	0	0
3	39972127	.	T	C	5	5	10	0	1	11	0	0
3	39975467	.	T	C	6	1	7	0	9	16	0	0
3	39982019	.	C	T	8	5	13	0	1	14	0	0
3	39982198	.	A	T	7	3	10	0	1	11	0	0
3	39982423	.	T	C	1	0	1	1	5	7	0	0
3	39984551	.	C	T	0	4	4	0	2	6	0	0
3	39984581	.	G	A	1	3	4	0	1	5	0	0
3	39987992	.	T	C	1	0	1	0	3	4	0	0
3	40154188	.	T	C	1	2	3	0	0	3	0	0
3	40154189	.	T	A	1	2	3	0	0	3	0	0
3	40154310	.	G	A	1	2	3	0	0	3	0	0
3	40154322	.	G	A	1	2	3	0	0	3	0	0
3	40154387	.	C	T	9	5	14	0	1	15	0	0
3	40158383	.	C	G	16	8	24	1	0	25	0	0
3	40160676	.	G	A	6	6	12	0	0	12	0	0
3	40161564	.	T	C	7	1	8	0	11	19	0	0
3	40162535	.	T	C	8	0	8	0	13	21	0	0
3	40162805	.	A	G	6	11	17	0	0	17	0	0
3	40164156	.	C	T	4	9	13	0	0	13	0	0
3	40164233	.	T	C	12	3	15	0	0	15	0	0
3	40164238	.	G	T	13	5	18	0	0	18	0	0
3	40165637	.	T	C	8	12	20	0	0	20	0	0
3	40165733	.	T	C	5	11	16	0	1	17	0	0
3	40168006	.	A	C	12	8	20	0	1	21	0	0
3	40168007	.	G	A	11	8	19	0	2	21	0	0
3	40168192	.	T	G	5	6	11	0	1	12	0	0
3	40168424	.	T	G	2	4	6	0	0	6	0	0
3	40172218	.	C	T	20	31	51	0	0	51	0	0
3	40178148	.	C	T	23	27	50	0	1	51	0	0
3	40178154	.	C	T	23	28	51	0	2	53	0	0
3	40178343	.	G	A	15	19	34	0	1	35	0	0
3	40178761	.	G	A	6	4	10	0	0	10	0	0
3	40178833	.	G	A	1	15	16	0	19	35	0	0
3	40178956	.	G	T	18	17	35	0	3	38	0	0
3	40179025	.	G	C	15	23	38	0	1	39	0	0
3	40179331	.	A	T	24	21	45	1	1	47	0	0
3	40179457	.	A	T	17	14	31	0	1	32	0	0
3	40179476	.	T	C	16	17	33	0	0	33	0	0
3	40179528	.	G	T	22	15	37	0	1	38	0	0
3	40179533	.	T	A	22	17	39	0	1	40	0	0
3	40179604	.	T	A	26	24	50	0	0	50	0	0
3	40179608	.	A	G	26	24	50	0	0	50	0	0
3	40179642	.	C	T	33	14	47	0	11	58	0	0
3	40179669	.	G	A	33	18	51	0	2	53	0	0
3	40179849	.	C	T	26	26	52	0	6	58	0	0
3	40179870	.	C	A	27	27	54	0	7	61	0	0
3	40180023	.	A	G	26	0	26	0	23	49	0	0
3	40180091	.	A	G	26	23	49	0	2	51	0	0
3	40180092	.	A	G	27	24	51	0	0	51	0	0
3	40180197	.	A	T	16	15	31	0	0	31	0	0
3	40186041	.	C	T	13	6	19	0	0	19	0	0
3	40188830	.	A	G	6	7	13	0	2	15	0	0
3	40189828	.	A	C	6	0	6	0	3	9	0	0
3	40190805	.	A	G	7	6	13	0	0	13	0	0
3	40190838	.	T	C	7	0	7	0	11	18	0	0
3	40190926	.	C	T	0	4	4	0	7	11	0	0
3	40191012	.	C	T	0	4	4	0	6	10	0	0
3	40191061	.	A	T	4	5	9	0	1	10	0	0
3	40191116	.	C	T	8	5	13	0	0	13	0	0
3	40193140	.	A	G	4	5	9	0	0	9	0	0
3	40193176	.	C	T	0	4	4	0	5	9	0	0
3	40193589	.	G	T	9	8	17	0	0	17	0	0
3	40193819	.	C	T	6	10	16	0	1	17	0	0
3	40206184	.	G	A	10	7	17	0	1	18	0	0
3	40206355	.	C	A	11	4	15	0	3	18	0	0
3	40206373	.	A	T	6	4	10	0	5	15	0	0
3	40206430	.	G	T	12	6	18	0	0	18	0	0
3	40206440	.	T	C	13	5	18	0	0	18	0	0
3	40206597	.	A	T	11	8	19	0	0	19	0	0
3	40206736	.	T	G	11	8	19	0	1	20	0	0
3	40206766	.	C	T	3	7	10	0	8	18	0	0
3	40207030	.	A	G	16	5	21	0	0	21	0	0
3	40207407	.	A	C	6	4	10	0	0	10	0	0
3	40207449	.	C	A	5	3	8	0	3	11	0	0
3	40212040	.	G	T	12	11	23	0	0	23	0	0
3	40216281	.	G	A	18	12	30	0	0	30	0	0
3	40218727	.	G	A	6	4	10	0	0	10	0	0
3	40219194	.	C	T	1	6	7	0	12	19	0	0
3	40220951	.	G	A	10	5	15	0	0	15	0	0
3	40220984	.	A	G	11	4	15	0	0	15	0	0
3	40229047	.	C	T	9	3	12	0	0	12	0	0
3	40237555	.	G	A	8	3	11	0	0	11	0	0
3	40237574	.	A	T	5	3	8	0	0	8	0	0
3	40241337	.	A	T	2	3	5	0	0	5	0	0
3	40255951	.	C	T	8	4	12	0	0	12	0	0
3	40256418	.	C	T	8	5	13	0	1	14	0	0
3	40256688	.	T	C	2	2	4	0	0	4	0	0
3	40256734	.	G	A	2	2	4	0	0	4	0	0
3	40256735	.	C	A	2	2	4	0	0	4	0	0
3	40256864	.	C	T	4	6	10	0	0	10	0	0
3	40257201	.	C	T	2	5	7	0	0	7	0	0
3	40257397	.	C	G	2	4	6	0	0	6	0	0
3	40261306	.	T	A	1	2	3	0	0	3	0	0
3	40280034	.	T	C	10	11	21	0	1	22	0	0
3	40284375	.	T	C	16	0	16	0	14	30	0	0
3	40284447	.	T	A	12	7	19	0	1	20	0	0
3	40284860	.	G	T	13	14	27	0	0	27	0	0
3	40287149	.	C	T	14	12	26	0	0	26	0	0
3	40287227	.	C	T	8	7	15	0	1	16	0	0
3	40287538	.	C	T	2	3	5	0	0	5	0	0
3	40287574	.	A	G	1	5	6	0	0	6	0	0
3	40290123	.	T	C	9	8	17	0	1	18	0	0
3	40294179	.	G	A	8	10	18	0	2	20	0	0
3	40294970	.	A	G	11	3	14	0	1	15	0	0
3	40299905	.	A	T	27	32	59	0	3	62	0	0
3	40318555	.	C	G	6	8	14	0	1	15	0	0
3	40318556	.	C	G	6	9	15	0	0	15	0	0
3	40318613	.	A	G	8	6	14	0	0	14	0	0
3	40333577	.	A	G	10	0	10	0	8	18	0	0
3	40333793	.	T	C	6	3	9	0	2	11	0	0
3	40346035	.	C	T	15	9	24	0	1	25	0	0
3	40348839	.	T	C	15	16	31	1	2	35	1	0
3	40349123	.	C	T	6	10	16	0	0	16	0	0
3	40349354	.	T	G	9	5	14	0	0	14	0	0
3	40349417	.	A	C	5	7	12	0	0	12	0	0
3	40349618	.	G	C	1	2	3	0	0	3	0	0
3	40349631	.	T	A	1	1	2	0	1	3	0	0
3	40404508	.	T	A	6	3	9	0	0	9	0	0
3	40404688	.	A	T	2	3	5	0	0	5	0	0
3	40430922	.	G	A	3	9	12	0	12	24	0	0
3	40443143	.	A	T	10	4	14	0	0	14	0	0
3	40444020	.	C	T	7	7	14	0	0	14	0	0
3	40444342	.	G	A	7	3	10	0	0	10	0	0
3	40444470	.	G	A	6	11	17	0	0	17	0	0
3	40448130	.	A	G	8	0	8	0	9	17	0	0
3	40448220	.	T	C	10	10	20	0	2	22	0	0
3	40467464	.	C	T	6	7	13	0	0	13	0	0
3	40467486	.	G	A	1	4	5	0	7	12	0	0
3	40467687	.	G	A	12	8	20	0	1	21	0	0
3	40467756	.	C	T	14	9	23	0	4	27	0	0
3	40468374	.	C	T	10	18	28	0	2	30	0	0
3	40479178	.	G	A	11	12	23	0	3	26	0	0
3	40479736	.	A	T	13	16	29	0	2	31	0	0
3	40480877	.	G	A	0	15	15	0	22	37	0	0
3	40480986	.	G	T	18	21	39	0	3	42	0	0
3	40484376	.	A	T	22	9	31	0	0	31	0	0
3	40484454	.	C	A	7	16	23	0	0	23	0	0
3	40485360	.	C	A	15	10	25	0	1	26	0	0
3	40485499	.	G	A	14	15	29	0	4	33	0	0
3	40485582	.	C	T	8	17	25	0	1	26	0	0
3	40485965	.	G	C	13	10	23	0	0	23	0	0
3	40486256	.	C	T	19	20	39	0	0	39	0	0
3	40486294	.	C	T	19	26	45	0	1	46	0	0
3	40487095	.	G	T	14	12	26	0	0	26	0	0
3	40487197	.	T	A	13	9	22	0	1	23	0	0
3	40487628	.	T	C	20	21	41	0	0	41	0	0
3	40487704	.	T	C	16	15	31	1	2	34	0	0
3	40487957	.	G	A	16	20	36	0	0	36	0	0
3	40488212	.	C	T	16	16	32	0	1	33	0	0
3	40488266	.	T	C	25	6	31	0	9	40	0	0
3	40488630	.	T	C	2	5	7	0	2	10	1	0
3	40488640	.	T	C	3	5	8	0	0	8	0	0
3	40527028	.	G	A	49	39	88	0	4	92	0	0
3	40527575	.	G	A	52	54	106	4	15	125	0	0
3	40528241	.	A	T	40	31	71	0	6	77	0	0
3	40576600	.	C	T	19	28	47	0	5	52	0	0
3	40576780	.	C	T	27	11	38	0	1	39	0	0
3	40577032	.	C	T	19	22	41	0	0	41	0	0
3	40581432	.	C	T	11	11	22	0	0	22	0	0
3	40587884	.	G	A	5	23	28	0	29	57	0	0
3	40587901	.	G	A	2	21	23	0	29	52	0	0
3	40588109	.	A	T	25	26	51	0	1	52	0	0
3	40588363	.	C	T	20	27	47	0	1	48	0	0
3	40588410	.	C	A	25	20	45	0	3	49	1	0
3	40588746	.	C	G	17	23	40	0	0	40	0	0
3	40589117	.	T	A	27	26	53	0	1	54	0	0
3	40589214	.	C	A	27	23	50	0	1	51	0	0
3	40589348	.	A	G	14	12	26	0	1	27	0	0
3	40589356	.	A	G	12	14	26	0	2	28	0	0
3	40605308	.	G	A	4	5	9	0	0	9	0	0
3	40615891	.	A	G	8	4	12	0	0	12	0	0
3	40615948	.	G	A	14	7	21	0	0	21	0	0
3	40647450	.	C	A	2	2	4	0	0	4	0	0
3	40649928	.	A	T	6	6	12	0	0	12	0	0
3	40656449	.	T	G	4	4	8	0	0	8	0	0
3	40656600	.	T	C	4	4	8	0	0	8	0	0
3	40690901	.	G	A	3	2	5	0	1	6	0	0
3	40691643	.	A	T	8	6	14	0	0	14	0	0
3	40691969	.	C	T	9	5	14	0	1	15	0	0
3	40692064	.	A	T	9	8	17	0	1	18	0	0
3	40692099	.	A	G	3	13	16	0	0	16	0	0
3	40698424	.	C	A	9	10	19	1	0	20	0	0
3	40698481	.	A	G	6	7	13	0	0	13	0	0
3	40712935	.	G	A	4	4	8	0	0	8	0	0
3	40716045	.	G	A	6	4	10	0	0	10	0	0
3	40804382	.	G	A	0	10	10	0	8	18	0	0
3	40809148	.	C	T	6	9	15	0	0	15	0	0
3	40814704	.	C	A	11	4	15	0	1	16	0	0
3	40817022	.	G	A	10	6	16	0	2	18	0	0
3	40817213	.	G	A	15	6	21	0	0	21	0	0
3	40817338	.	C	T	15	9	24	0	1	25	0	0
3	40817712	.	G	A	13	9	22	0	0	22	0	0
3	40819959	.	A	C	6	8	14	0	1	15	0	0
3	40820007	.	A	G	3	6	9	0	0	9	0	0
3	40821871	.	A	T	12	19	31	0	0	31	0	0
3	40826707	.	G	T	13	19	32	0	1	33	0	0
3	40833733	.	C	T	11	11	22	0	0	22	0	0
3	40833775	.	C	T	3	8	11	0	7	18	0	0
3	40870555	.	G	T	0	2	2	0	2	4	0	0
3	40870851	.	A	T	1	2	3	0	0	3	0	0
3	40870863	.	C	T	1	3	4	0	0	4	0	0
3	40880130	.	C	A	2	2	4	0	0	4	0	0
3	40882964	.	A	T	3	3	6	0	1	7	0	0
3	40902163	.	C	T	0	8	8	0	4	12	0	0
3	40902171	.	C	T	9	4	13	0	0	13	0	0
3	40913590	.	G	A	7	4	11	0	0	11	0	0
3	40913730	.	G	A	11	5	16	1	0	17	0	0
3	40927653	.	C	T	9	10	19	0	0	19	0	0
3	40927656	.	C	T	1	8	9	0	10	19	0	0
3	40932798	.	G	A	5	4	9	0	0	9	0	0
3	40948815	.	C	T	0	2	2	1	2	5	0	0
3	40969547	.	C	T	0	5	5	0	5	10	0	0
3	40973554	.	T	C	4	3	7	0	0	7	0	0
3	40973744	.	A	C	3	2	5	0	0	5	0	0
3	40974842	.	A	C	2	2	4	0	1	5	0	0
3	40979597	.	G	C	5	8	13	0	0	13	0	0
3	40979746	.	T	A	4	11	15	0	0	15	0	0
3	40979791	.	G	C	9	4	13	0	0	13	0	0
3	40980024	.	G	A	7	6	13	0	0	13	0	0
3	40980166	.	T	A	15	8	23	0	0	23	0	0
3	40980167	.	T	A	8	15	23	0	1	24	0	0
3	40980245	.	G	T	6	10	16	0	9	25	0	0
3	40983062	.	A	G	10	7	17	0	0	17	0	0
3	40990933	.	A	G	4	2	6	0	0	6	0	0
3	40995278	.	G	A	7	8	15	0	0	15	0	0
3	41003413	.	G	A	7	6	13	1	0	14	0	0
3	41023331	.	G	A	6	3	9	0	1	10	0	0
3	41030891	.	C	T	0	8	8	0	4	12	0	0
3	41030921	.	T	C	5	8	13	0	0	13	0	0
3	41030939	.	T	C	3	7	10	0	1	11	0	0
3	41037779	.	A	T	9	5	14	0	1	15	0	0
3	41047649	.	C	T	2	3	5	0	0	5	0	0
3	41086775	.	G	A	5	4	9	0	0	9	0	0
3	41092046	.	G	C	4	3	7	0	0	7	0	0
3	41092198	.	G	A	2	2	4	0	0	4	0	0
3	41103145	.	G	A	2	2	4	0	0	4	0	0
3	41107371	.	A	G	1	2	3	0	0	3	0	0
3	41150941	.	G	A	4	7	11	0	0	11	0	0
3	41156419	.	C	T	0	4	4	0	2	6	0	0
3	41219134	.	C	G	2	4	6	0	0	6	0	0
3	41282708	.	C	T	0	3	3	0	3	6	0	0
3	41282750	.	G	A	2	4	6	0	0	6	0	0
3	41282762	.	C	T	1	3	4	0	1	5	0	0
3	41704398	.	G	C	1	3	4	0	0	4	0	0
3	41704514	.	T	C	2	2	4	0	0	4	0	0
3	41704687	.	G	A	3	3	6	0	0	6	0	0
3	41704947	.	T	C	1	3	4	0	0	4	0	0
3	41705133	.	C	T	1	2	3	0	1	4	0	0
3	41705141	.	T	C	2	3	5	0	1	6	0	0
3	41705468	.	A	T	2	2	4	0	0	4	0	0
3	41705476	.	C	T	2	0	2	0	2	4	0	0
3	41705560	.	A	G	5	5	10	0	0	10	0	0
3	41705597	.	C	T	4	4	8	0	0	8	0	0
3	41715646	.	G	A	2	11	13	0	6	19	0	0
3	41716889	.	C	A	10	7	17	1	0	18	0	0
3	41719049	.	G	A	13	9	22	0	1	23	0	0
3	41719219	.	A	G	15	1	16	0	10	26	0	0
3	41721916	.	G	A	18	18	36	0	0	36	0	0
3	41723069	.	G	A	20	9	29	0	3	32	0	0
3	41723437	.	G	A	15	19	34	0	0	34	0	0
3	41724298	.	C	T	20	17	37	0	0	37	0	0
3	41724806	.	G	A	14	11	25	0	1	26	0	0
3	41731929	.	C	A	6	5	11	0	2	13	0	0
3	41731980	.	G	A	5	4	9	0	0	9	0	0
3	41732076	.	T	C	5	4	9	0	0	9	0	0
3	41732220	.	C	T	9	3	12	0	0	12	0	0
3	41732349	.	C	T	3	2	5	0	0	5	0	0
3	41732486	.	T	A	12	6	18	0	1	19	0	0
3	41732782	.	C	A	2	6	8	0	0	8	0	0
3	41917608	.	G	T	2	6	8	0	0	8	0	0
3	41917747	.	T	C	7	5	12	0	0	12	0	0
3	41917830	.	T	C	5	2	7	0	0	7	0	0
3	41922243	.	C	T	1	2	3	0	0	3	0	0
3	41922587	.	C	T	4	2	6	0	1	7	0	0
3	41922766	.	A	G	5	0	5	0	7	12	0	0
3	41922799	.	C	T	3	8	11	0	0	11	0	0
3	41923195	.	T	C	4	8	12	0	0	12	0	0
3	41923288	.	C	T	7	5	12	0	0	12	0	0
3	41925154	.	C	T	5	7	12	0	0	12	0	0
3	41925508	.	A	G	1	7	8	0	0	8	0	0
3	41925541	.	C	G	6	6	12	0	1	13	0	0
3	41925663	.	C	T	9	3	12	0	0	12	0	0
3	41925694	.	A	C	7	5	12	0	2	14	0	0
3	41925823	.	C	T	2	5	7	0	0	7	0	0
3	41925889	.	T	C	5	3	8	0	0	8	0	0
3	41926020	.	T	A	4	7	11	0	0	11	0	0
3	41926633	.	T	A	3	5	8	0	0	8	0	0
3	41926695	.	T	C	2	2	4	0	1	5	0	0
3	41955449	.	A	G	6	9	15	0	0	15	0	0
3	41955526	.	C	T	4	8	12	0	0	12	0	0
3	41955613	.	G	T	19	16	35	0	1	36	0	0
3	41955911	.	C	G	19	15	34	0	1	35	0	0
3	41956040	.	G	T	11	13	24	0	2	26	0	0
3	41956299	.	T	C	10	7	17	0	1	18	0	0
3	41956353	.	T	A	13	10	23	0	1	24	0	0
3	41956467	.	T	A	11	4	15	1	0	16	0	0
3	41956792	.	A	T	9	16	25	0	1	26	0	0
3	41956818	.	T	C	10	18	28	0	1	29	0	0
3	41956837	.	T	G	12	14	26	0	0	26	0	0
3	41956855	.	C	T	13	12	25	0	0	25	0	0
3	41956921	.	T	A	8	10	18	0	0	18	0	0
3	41956941	.	T	C	10	5	15	0	0	15	0	0
3	41956978	.	G	A	10	8	18	0	0	18	0	0
3	41957457	.	T	A	6	2	8	0	0	8	0	0
3	41957580	.	G	T	4	8	12	0	1	13	0	0
3	41957839	.	A	T	3	5	8	0	0	8	0	0
3	41957993	.	G	A	8	5	13	0	0	13	0	0
3	41958291	.	T	G	4	5	9	0	2	11	0	0
3	41958829	.	A	G	5	4	9	0	1	10	0	0
3	41958856	.	C	A	6	8	14	0	0	14	0	0
3	41958885	.	T	C	2	1	3	0	8	11	0	0
3	41959370	.	G	T	6	13	19	0	1	20	0	0
3	41959658	.	G	T	5	11	16	0	0	16	0	0
3	41959772	.	A	G	8	13	21	0	0	21	0	0
3	41959906	.	T	A	3	5	8	0	1	9	0	0
3	41959943	.	T	C	6	5	11	0	0	11	0	0
3	41959958	.	A	G	7	2	9	0	1	10	0	0
3	41960005	.	C	A	9	7	16	0	1	17	0	0
3	41960069	.	G	T	9	6	15	0	1	16	0	0
3	41960346	.	A	G	1	6	7	0	0	7	0	0
3	41960928	.	T	C	1	2	3	0	1	4	0	0
3	41961314	.	G	A	8	6	14	0	1	15	0	0
3	41961341	.	T	G	6	10	16	0	2	18	0	0
3	41961469	.	A	G	7	4	11	0	0	11	0	0
3	41961558	.	A	T	10	10	20	0	0	20	0	0
3	41961587	.	T	G	11	10	21	0	0	21	0	0
3	41961651	.	G	A	7	9	16	0	2	18	0	0
3	41961688	.	T	C	9	1	10	0	15	25	0	0
3	41961993	.	C	G	0	8	8	0	5	13	0	0
3	41962098	.	T	C	6	10	16	0	0	16	0	0
3	41962463	.	G	A	3	4	7	0	0	7	0	0
3	41985866	.	G	A	7	4	11	0	0	11	0	0
3	41985953	.	C	T	5	6	11	0	0	11	0	0
3	41985959	.	G	A	6	6	12	0	1	13	0	0
3	42016675	.	A	T	5	5	10	0	0	10	0	0
3	42016682	.	C	G	1	6	7	0	4	11	0	0
3	42121562	.	G	A	2	3	5	0	0	5	0	0
3	42126594	.	A	T	2	3	5	0	1	6	0	0
3	42126621	.	A	G	3	3	6	0	0	6	0	0
3	42126639	.	T	C	2	2	4	0	1	5	0	0
3	42918924	.	C	A	10	8	18	0	2	20	0	0
3	42919474	.	C	T	14	9	23	0	1	24	0	0
3	42919510	.	C	T	9	12	21	0	2	23	0	0
3	42919664	.	C	T	7	9	16	0	1	17	0	0
3	42919846	.	T	G	3	4	7	0	0	7	0	0
3	42919849	.	C	T	3	4	7	0	0	7	0	0
3	42919881	.	C	T	2	6	8	0	0	8	0	0
3	42919895	.	A	G	2	5	7	0	0	7	0	0
3	42919943	.	G	C	3	4	7	0	0	7	0	0
3	42919959	.	A	T	2	3	5	0	0	5	0	0
3	42956602	.	A	G	1	3	4	0	0	4	0	0
3	42956616	.	G	T	1	3	4	0	0	4	0	0
3	42957152	.	A	T	2	2	4	0	0	4	0	0
3	42964866	.	T	C	1	0	1	0	4	5	0	0
3	43000474	.	A	G	4	3	7	0	1	8	0	0
3	43000489	.	G	A	1	4	5	0	1	6	0	0
3	43000552	.	T	A	2	3	5	0	1	6	0	0
3	43000627	.	G	A	1	2	3	0	3	6	0	0
3	43003017	.	G	T	1	2	3	0	0	3	0	0
3	43005282	.	C	T	2	3	5	0	0	5	0	0
3	43009405	.	G	A	1	2	3	0	1	4	0	0
3	43014396	.	T	C	3	6	9	0	0	9	0	0
3	43017888	.	A	C	1	7	8	0	0	8	0	0
3	43017912	.	T	C	1	5	6	0	0	6	0	0
3	43024872	.	T	C	2	2	4	0	0	4	0	0
3	43029889	.	T	C	2	7	9	0	0	9	0	0
3	43036193	.	T	C	5	4	9	0	0	9	0	0
3	43038222	.	G	A	3	4	7	0	0	7	0	0
3	43039306	.	A	G	5	2	7	0	0	7	0	0
3	43039479	.	C	T	4	6	10	0	1	11	0	0
3	43040677	.	G	A	0	7	7	0	8	15	0	0
3	43052230	.	T	C	7	7	14	0	1	15	0	0
3	43059090	.	A	G	10	9	19	0	0	19	0	0
3	43059153	.	A	G	8	7	15	0	1	16	0	0
3	43060866	.	T	C	3	3	6	0	0	6	0	0
3	43380283	.	C	T	8	5	13	0	0	13	0	0
3	43392755	.	T	A	6	7	13	0	0	13	0	0
3	43392795	.	C	A	5	5	10	0	0	10	0	0
3	43474920	.	A	T	5	2	7	0	0	7	0	0
3	43475184	.	C	T	7	4	11	0	0	11	0	0
3	43475265	.	G	A	7	6	13	0	0	13	0	0
3	43475325	.	A	G	9	8	17	0	0	17	0	0
3	43475376	.	T	C	6	7	13	0	0	13	0	0
3	43475397	.	C	T	6	5	11	0	1	12	0	0
3	43475592	.	A	C	6	5	11	0	0	11	0	0
3	43475617	.	G	T	0	5	5	0	6	11	0	0
3	43475654	.	C	T	6	5	11	0	0	11	0	0
3	43475742	.	G	T	5	5	10	0	1	11	0	0
3	43475772	.	A	G	9	5	14	0	0	14	0	0
3	43476017	.	A	G	1	5	6	0	0	6	0	0
3	43476088	.	G	T	5	7	12	0	0	12	0	0
3	43476097	.	C	A	3	6	9	0	0	9	0	0
3	43476394	.	T	C	8	2	10	0	2	12	0	0
3	43476402	.	C	T	9	3	12	0	0	12	0	0
3	43476435	.	G	T	7	4	11	0	0	11	0	0
3	43476698	.	A	G	6	3	9	0	0	9	0	0
3	43476880	.	C	T	9	10	19	0	1	20	0	0
3	43476887	.	T	G	9	9	18	0	0	18	0	0
3	43477255	.	T	A	5	4	9	0	0	9	0	0
3	43477705	.	T	A	1	2	3	0	0	3	0	0
3	43477975	.	T	G	4	3	7	0	0	7	0	0
3	43478137	.	T	C	7	5	12	0	0	12	0	0
3	43478310	.	T	G	11	4	15	0	0	15	0	0
3	43478321	.	A	G	10	0	10	0	4	14	0	0
3	43478433	.	A	T	5	5	10	0	0	10	0	0
3	43478586	.	C	T	4	2	6	0	1	7	0	0
3	43579820	.	C	T	1	13	14	0	9	23	0	0
3	43580055	.	A	G	15	13	28	0	1	29	0	0
3	43580195	.	A	T	4	5	9	0	2	11	0	0
3	43580583	.	T	C	14	11	25	0	0	25	0	0
3	43581272	.	A	C	11	8	19	0	0	19	0	0
3	43584423	.	T	C	14	0	14	0	10	24	0	0
3	43584453	.	T	C	9	15	24	0	1	25	0	0
3	43594256	.	A	G	16	10	26	0	1	27	0	0
3	43594358	.	C	T	13	11	24	0	1	25	0	0
3	43594376	.	C	T	2	9	11	0	11	22	0	0
3	43594577	.	G	A	13	14	27	0	0	27	0	0
3	43594655	.	C	T	1	9	10	0	7	17	0	0
3	43594658	.	G	A	7	9	16	0	0	16	0	0
3	43594735	.	T	C	5	14	19	0	2	21	0	0
3	43600999	.	C	T	1	7	8	0	9	17	0	0
3	43645900	.	G	C	15	11	26	0	0	26	0	0
3	43646161	.	A	G	5	6	11	0	0	11	0	0
3	43646362	.	C	T	0	10	10	0	3	13	0	0
3	43774440	.	C	A	3	6	9	0	0	9	0	0
3	43791284	.	T	C	9	4	13	0	0	13	0	0
3	43791317	.	G	A	4	5	9	0	0	9	0	0
3	43793147	.	T	C	6	3	9	0	0	9	0	0
3	43793273	.	G	A	9	6	15	0	0	15	0	0
3	43793389	.	T	C	6	3	9	0	1	10	0	0
3	43796956	.	T	G	3	0	3	0	2	5	0	0
3	43797073	.	C	T	4	9	13	0	0	13	0	0
3	43801338	.	C	T	13	13	26	0	0	26	0	0
3	43807512	.	T	C	7	3	10	0	0	10	0	0
3	43807921	.	C	A	11	16	27	0	0	27	0	0
3	43807945	.	T	A	10	8	18	0	0	20	2	0
3	43814607	.	C	T	5	5	10	0	3	13	0	0
3	43821273	.	G	T	13	11	24	0	0	24	0	0
3	43821328	.	A	G	11	6	17	0	2	19	0	0
3	43825892	.	T	A	3	3	6	0	0	6	0	0
3	43825901	.	T	C	3	2	5	0	1	6	0	0
3	43828902	.	G	A	1	3	4	0	0	4	0	0
3	43829154	.	G	C	3	4	7	0	0	7	0	0
3	43829179	.	G	C	2	2	4	0	0	4	0	0
3	43829411	.	C	T	3	3	6	0	1	7	0	0
3	43829413	.	C	T	4	2	6	0	2	8	0	0
3	43829712	.	G	A	2	3	5	0	2	7	0	0
3	43944611	.	A	G	10	7	17	0	0	17	0	0
3	43953805	.	C	T	5	3	8	0	1	9	0	0
3	43953883	.	T	C	7	0	7	0	11	18	0	0
3	43981371	.	C	T	1	1	2	0	1	3	0	0
3	43985795	.	T	A	1	5	6	0	0	6	0	0
3	43985815	.	G	T	1	4	5	0	1	6	0	0
3	44077285	.	T	C	1	2	3	0	0	3	0	0
3	44077295	.	A	T	2	2	4	0	0	4	0	0
3	44077429	.	A	C	4	3	7	0	0	7	0	0
3	44077508	.	C	T	5	3	8	0	0	8	0	0
3	44081793	.	G	A	1	3	4	0	0	4	0	0
3	44082200	.	A	G	2	4	6	0	0	6	0	0
3	44082239	.	T	G	1	2	3	0	1	4	0	0
3	44089225	.	T	G	1	7	8	0	0	8	0	0
3	44089529	.	A	G	3	5	8	0	0	8	0	0
3	44089576	.	A	G	4	2	6	0	1	7	0	0
3	44093661	.	T	C	2	0	2	0	2	4	0	0
3	44541766	.	C	T	0	3	3	0	1	4	0	0
3	44541955	.	C	A	6	8	14	0	0	14	0	0
3	44752966	.	T	C	12	3	15	0	0	15	0	0
3	45284618	.	T	C	10	4	14	3	1	18	0	0
3	45284619	.	T	C	11	4	15	3	0	18	0	0
3	45714552	.	C	T	5	5	10	0	0	10	0	0
3	45714678	.	C	T	2	3	5	0	0	5	0	0
3	45714945	.	T	C	1	2	3	0	0	3	0	0
3	45715126	.	G	A	3	2	5	0	1	6	0	0
3	45715128	.	A	T	3	2	5	0	0	5	0	0
3	45715511	.	T	A	2	5	7	0	0	7	0	0
3	45715655	.	A	G	3	5	8	0	0	8	0	0
3	45715716	.	C	T	7	2	9	0	2	11	0	0
3	45715776	.	T	C	7	4	11	0	1	12	0	0
3	45716156	.	A	T	2	5	7	0	0	7	0	0
3	45716766	.	A	G	5	0	5	0	4	9	0	0
3	45717180	.	C	T	5	12	17	0	3	20	0	0
3	45769164	.	A	G	1	2	3	0	0	3	0	0
3	45776520	.	T	C	17	0	17	0	26	43	0	0
3	45776721	.	T	C	22	37	59	0	3	62	0	0
3	45778103	.	T	A	4	4	8	0	0	8	0	0
3	45790559	.	T	C	6	6	12	0	2	14	0	0
3	45805605	.	C	G	11	5	16	0	0	16	0	0
3	45814062	.	A	T	1	3	4	0	0	4	0	0
3	45814631	.	A	T	4	7	11	0	0	11	0	0
3	45815894	.	A	C	8	10	18	0	2	20	0	0
3	45815997	.	G	A	1	8	9	0	3	12	0	0
3	45816004	.	C	T	3	8	11	0	1	12	0	0
3	45816549	.	A	G	6	10	16	0	0	16	0	0
3	45816618	.	T	C	7	14	21	0	1	22	0	0
3	46043483	.	G	A	1	4	5	0	2	7	0	0
3	46043528	.	T	A	3	2	5	0	0	5	0	0
3	46043617	.	G	A	3	2	5	0	0	5	0	0
3	46043918	.	T	A	3	2	5	0	0	5	0	0
3	46044190	.	G	T	5	2	7	0	1	8	0	0
3	46114398	.	A	G	4	5	9	0	0	9	0	0
3	46795013	.	G	T	4	2	6	0	0	6	0	0
3	46795113	.	G	T	1	2	3	0	0	3	0	0
3	46795118	.	G	T	5	2	7	0	0	7	0	0
3	46802864	.	G	A	9	3	12	0	4	16	0	0
3	48212028	.	T	C	1	5	6	0	0	6	0	0
3	53047910	.	T	C	1	3	4	0	0	4	0	0
3	54602027	.	A	G	1	5	6	0	1	7	0	0
3	54748546	.	T	C	2	3	5	0	0	5	0	0
3	54835274	.	A	G	13	4	17	4	0	21	0	0
3	54836316	.	A	G	5	0	5	3	4	12	0	0
3	55098813	.	G	T	21	23	44	30	2	76	0	0
3	55099174	.	A	G	1	4	5	0	0	5	0	0
3	55100228	.	T	C	21	18	39	4	3	46	0	0
3	55100413	.	C	A	34	14	48	7	2	57	0	0
3	55100522	.	A	G	11	7	18	41	1	60	0	0
3	55104129	.	T	C	23	11	34	13	6	53	0	0
3	55104214	.	T	C	14	0	14	18	9	41	0	0
3	55104215	.	A	G	14	9	23	18	0	41	0	0
3	56389953	.	T	C	0	4	4	0	1	5	0	0
3	56389959	.	C	T	1	4	5	0	0	5	0	0
3	56393872	.	A	G	3	2	5	0	0	5	0	0
3	56783559	.	T	C	1	3	4	0	0	4	0	0
3	56799806	.	G	C	1	7	8	0	0	8	0	0
3	57124935	.	T	C	2	2	4	0	0	4	0	0
3	57125761	.	C	T	1	3	4	0	0	4	0	0
3	57125949	.	C	T	3	2	5	0	0	5	0	0
3	57127078	.	G	A	1	3	4	0	3	7	0	0
3	57127204	.	C	G	1	2	3	0	0	3	0	0
3	57131468	.	A	G	2	0	2	0	4	6	0	0
3	57131477	.	C	G	2	0	2	0	4	6	0	0
3	57133824	.	C	A	1	2	3	0	0	3	0	0
3	57150015	.	G	A	1	2	3	0	4	7	0	0
3	57158314	.	G	C	2	2	4	0	1	5	0	0
3	57170701	.	G	A	0	2	2	0	1	3	0	0
3	57173711	.	T	C	3	7	10	0	0	10	0	0
3	57423485	.	A	C	13	5	18	0	0	18	0	0
3	57423489	.	C	T	10	5	15	0	1	16	0	0
3	57423533	.	A	G	7	6	13	0	1	14	0	0
3	57423847	.	G	A	7	4	11	0	0	11	0	0
3	57423952	.	T	G	9	3	12	0	1	13	0	0
3	57424244	.	C	T	9	11	20	0	1	21	0	0
3	57424311	.	G	A	7	6	13	0	1	14	0	0
3	57424327	.	T	C	7	7	14	0	1	15	0	0
3	57424743	.	A	G	9	10	19	0	0	19	0	0
3	57425892	.	G	C	3	0	3	0	4	7	0	0
3	57462285	.	G	A	4	4	8	0	1	9	0	0
3	57462301	.	A	C	4	7	11	0	0	11	0	0
3	57462490	.	G	T	14	13	27	0	0	27	0	0
3	57462548	.	C	T	0	9	9	0	20	29	0	0
3	57462584	.	C	T	9	16	25	1	0	26	0	0
3	57462598	.	A	G	7	9	16	1	1	18	0	0
3	57462643	.	A	C	10	4	14	1	0	15	0	0
3	57462673	.	G	T	11	4	15	0	0	15	0	0
3	57462751	.	G	C	8	3	11	2	1	14	0	0
3	57462953	.	T	C	4	4	8	0	6	14	0	0
3	57462962	.	T	C	5	4	9	0	2	11	0	0
3	57463446	.	A	T	11	15	26	0	1	27	0	0
3	57463698	.	C	T	2	15	17	9	13	39	0	0
3	57463817	.	C	G	13	9	22	5	0	27	0	0
3	57464484	.	G	A	6	13	19	0	0	19	0	0
3	57464706	.	C	A	11	16	27	1	1	29	0	0
3	57464735	.	T	A	12	16	28	0	0	28	0	0
3	57464746	.	C	T	1	9	10	0	13	23	0	0
3	57464793	.	T	A	8	5	13	0	0	13	0	0
3	57464884	.	T	A	2	6	8	0	0	8	0	0
3	57464986	.	A	C	5	5	10	0	0	10	0	0
3	57465090	.	G	C	6	18	24	0	2	26	0	0
3	57465176	.	G	C	13	10	23	0	1	24	0	0
3	57465308	.	T	C	10	1	11	0	10	21	0	0
3	57465544	.	A	T	9	9	18	0	0	18	0	0
3	57465550	.	A	G	9	9	18	0	0	18	0	0
3	57465965	.	G	T	7	6	13	0	0	13	0	0
3	57492140	.	C	T	5	10	15	0	0	15	0	0
3	57494405	.	G	A	6	4	10	0	0	10	0	0
3	57498111	.	T	G	5	4	9	0	0	9	0	0
3	57583954	.	C	T	7	10	17	0	1	18	0	0
3	57584599	.	A	T	10	14	24	0	0	24	0	0
3	57584606	.	A	G	10	12	22	0	0	22	0	0
3	57584656	.	A	C	7	9	16	0	0	16	0	0
3	57584783	.	T	C	7	0	7	0	8	15	0	0
3	57585015	.	C	T	0	6	6	1	11	18	0	0
3	57585033	.	C	T	8	13	21	1	1	24	1	0
3	57585150	.	C	T	1	15	16	0	8	24	0	0
3	57593524	.	C	T	7	11	18	1	3	22	0	0
3	57593977	.	G	A	8	10	18	0	1	19	0	0
3	57593978	.	G	A	9	10	19	0	0	19	0	0
3	57594016	.	G	A	9	11	20	0	1	21	0	0
3	57599177	.	C	T	9	4	13	0	1	14	0	0
3	57603737	.	C	T	2	4	6	0	0	6	0	0
3	57608735	.	G	A	8	8	16	0	1	17	0	0
3	57608900	.	A	T	5	7	12	0	0	12	0	0
3	57608951	.	G	A	4	11	15	0	0	15	0	0
3	57630700	.	C	T	0	7	7	0	6	13	0	0
3	57634139	.	G	T	4	5	9	0	0	9	0	0
3	57634380	.	A	G	5	2	7	0	0	7	0	0
3	57634480	.	G	A	8	5	13	0	0	13	0	0
3	57646269	.	A	G	6	7	13	0	2	15	0	0
3	57646437	.	C	T	0	4	4	0	3	7	0	0
3	57649281	.	G	T	6	8	14	0	0	14	0	0
3	57654123	.	A	G	4	5	9	0	0	9	0	0
3	57666296	.	A	G	6	2	8	0	0	8	0	0
3	57666435	.	C	A	7	4	11	0	0	11	0	0
3	57742154	.	G	A	6	2	8	0	0	8	0	0
3	57742220	.	G	A	12	20	32	1	1	34	0	0
3	57742262	.	C	G	12	26	38	0	2	40	0	0
3	57742532	.	T	G	6	17	23	0	0	23	0	0
3	57742805	.	G	A	3	11	14	0	0	14	0	0
3	57743177	.	A	G	5	2	7	0	0	7	0	0
3	57743912	.	T	C	2	2	4	0	0	4	0	0
3	57743984	.	C	T	1	2	3	0	0	3	0	0
3	57744027	.	G	A	4	4	8	0	0	8	0	0
3	57744225	.	A	G	1	4	5	0	0	5	0	0
3	57747826	.	T	A	2	1	3	0	1	4	0	0
3	57748026	.	G	A	7	7	14	0	1	15	0	0
3	57748044	.	A	G	11	2	13	0	0	13	0	0
3	57748246	.	C	T	3	4	7	0	0	7	0	0
3	57748342	.	T	A	16	7	23	0	0	23	0	0
3	57748437	.	A	G	7	6	13	0	0	13	0	0
3	57748449	.	G	A	7	4	11	0	0	11	0	0
3	57748494	.	T	C	6	5	11	0	1	12	0	0
3	57748581	.	C	G	4	6	10	0	9	19	0	0
3	57751835	.	G	A	17	8	25	0	0	25	0	0
3	57754460	.	C	T	13	8	21	0	0	21	0	0
3	57767106	.	A	C	5	5	10	0	0	10	0	0
3	57768914	.	C	T	1	2	3	0	0	3	0	0
3	57769453	.	A	G	1	2	3	0	0	3	0	0
3	57769474	.	G	A	3	2	5	0	0	5	0	0
3	57829926	.	T	A	1	2	3	0	0	3	0	0
3	57998332	.	T	C	2	3	5	0	0	5	0	0
3	58001423	.	T	C	3	4	7	0	0	7	0	0
3	58001814	.	G	A	1	2	3	0	1	4	0	0
3	58004532	.	C	T	4	5	9	0	1	10	0	0
3	58137540	.	C	T	6	2	8	0	0	8	0	0
3	58139655	.	C	T	2	7	9	0	0	9	0	0
3	58139796	.	G	A	0	6	6	0	5	11	0	0
3	58140344	.	G	A	6	2	8	0	0	8	0	0
3	58147315	.	C	G	4	6	10	0	0	10	0	0
3	58147467	.	T	C	6	3	9	0	0	9	0	0
3	58147479	.	C	A	6	4	10	0	0	10	0	0
3	58148643	.	G	A	7	3	10	0	0	10	0	0
3	58149114	.	C	A	2	9	11	0	0	11	0	0
3	58149192	.	T	C	2	9	11	0	0	11	0	0
3	58149204	.	G	A	2	6	8	0	0	8	0	0
3	58153632	.	C	T	4	7	11	0	0	11	0	0
3	58153889	.	T	A	8	6	14	0	1	15	0	0
3	58153994	.	A	G	3	0	3	0	11	14	0	0
3	58154073	.	G	A	0	4	4	0	4	8	0	0
3	58158826	.	T	C	3	4	7	0	1	8	0	0
3	58171761	.	C	T	8	16	24	0	1	25	0	0
3	58172028	.	T	C	15	14	29	0	1	30	0	0
3	58174380	.	C	T	10	13	23	0	0	23	0	0
3	58175761	.	G	C	17	6	23	0	0	23	0	0
3	58178032	.	G	A	1	18	19	0	21	40	0	0
3	58180664	.	G	A	14	12	26	0	0	26	0	0
3	58180695	.	C	T	18	13	31	0	1	32	0	0
3	58197600	.	A	G	2	4	6	12	0	18	0	0
3	58197648	.	C	T	13	5	18	8	1	27	0	0
3	58211317	.	T	C	3	3	6	0	2	8	0	0
3	58211877	.	A	T	5	3	8	2	0	10	0	0
3	58577228	.	C	G	1	2	3	9	0	12	0	0
3	58608335	.	G	A	4	8	12	12	0	24	0	0
3	58610859	.	C	T	3	2	5	13	2	20	0	0
3	58615428	.	T	G	4	11	15	2	0	17	0	0
3	58615543	.	G	C	4	4	8	2	0	10	0	0
3	58704640	.	T	C	1	6	7	0	0	7	0	0
3	58704655	.	C	A	1	3	4	0	0	4	0	0
3	58705144	.	A	G	3	2	5	16	0	21	0	0
3	58705145	.	A	T	3	2	5	16	0	21	0	0
3	60055408	.	G	A	3	2	5	0	1	6	0	0
3	60074274	.	C	G	2	2	4	4	0	8	0	0
3	60219093	.	T	C	2	2	4	0	0	4	0	0
3	60222551	.	T	C	1	4	5	0	0	5	0	0
3	60222583	.	G	C	3	4	7	0	0	7	0	0
3	60222625	.	A	G	2	3	5	0	0	5	0	0
3	60223583	.	A	G	1	2	3	0	0	3	0	0
3	60294079	.	A	G	3	4	7	4	0	11	0	0
3	60294089	.	C	G	1	4	5	5	1	11	0	0
3	60342876	.	T	G	1	3	4	1	0	5	0	0
3	60594801	.	A	C	2	2	4	0	0	4	0	0
3	60596046	.	A	G	5	0	5	0	3	8	0	0
3	61221250	.	A	T	7	4	11	0	0	11	0	0
3	61244015	.	C	T	6	9	15	0	2	17	0	0
3	61272235	.	C	T	3	8	11	0	0	11	0	0
3	61272250	.	C	T	3	7	10	0	0	10	0	0
3	61276907	.	C	T	5	4	9	0	0	9	0	0
3	61277028	.	C	G	8	8	16	0	1	17	0	0
3	61278677	.	A	G	3	4	7	0	0	7	0	0
3	61278692	.	C	T	5	3	8	0	1	9	0	0
3	61278992	.	C	T	7	6	13	0	0	13	0	0
3	61279308	.	T	G	2	4	6	0	1	7	0	0
3	61279427	.	A	C	9	8	17	0	0	17	0	0
3	61279585	.	G	A	1	5	6	0	14	20	0	0
3	61279643	.	T	C	11	15	26	0	0	26	0	0
3	61280055	.	G	A	9	6	15	0	0	15	0	0
3	61280117	.	T	C	7	6	13	0	1	14	0	0
3	61280343	.	G	C	10	10	20	0	1	21	0	0
3	61280350	.	C	G	12	8	20	0	1	21	0	0
3	61280381	.	T	A	6	12	18	0	2	20	0	0
3	61280579	.	T	G	13	1	14	0	7	21	0	0
3	61281051	.	A	G	9	7	16	0	2	18	0	0
3	61281681	.	G	A	1	8	9	0	15	24	0	0
3	61285787	.	C	T	7	8	15	0	0	15	0	0
3	61286009	.	A	C	4	8	12	0	0	12	0	0
3	61286062	.	T	A	4	9	13	0	0	13	0	0
3	61286081	.	C	A	9	5	14	0	0	14	0	0
3	61286468	.	C	T	4	2	6	1	0	7	0	0
3	61286528	.	A	T	2	5	7	1	1	9	0	0
3	61286687	.	T	A	8	7	15	0	1	16	0	0
3	61286889	.	T	C	13	9	22	0	0	22	0	0
3	61287282	.	T	G	10	1	11	0	9	20	0	0
3	61287491	.	T	A	6	22	28	0	1	29	0	0
3	61287590	.	G	T	16	19	35	0	0	35	0	0
3	61287627	.	C	G	8	17	25	0	0	25	0	0
3	61287893	.	T	G	12	0	12	0	18	30	0	0
3	61288028	.	T	C	13	17	30	0	1	31	0	0
3	61288105	.	C	A	12	14	26	0	0	26	0	0
3	61288238	.	A	C	16	15	31	0	1	32	0	0
3	61288469	.	T	G	15	0	15	0	22	37	0	0
3	61292963	.	C	A	3	8	11	0	0	11	0	0
3	61293028	.	A	G	2	3	5	0	0	5	0	0
3	61297154	.	C	T	2	4	6	0	0	6	0	0
3	61306165	.	A	G	2	3	5	0	0	5	0	0
3	61308972	.	A	G	2	3	5	0	0	5	0	0
3	61316869	.	C	T	1	2	3	0	3	6	0	0
3	61328575	.	A	G	2	2	4	0	0	4	0	0
3	61336744	.	T	C	2	2	4	0	0	4	0	0
3	61342368	.	T	C	7	11	18	1	2	21	0	0
3	61342387	.	G	A	10	11	21	0	0	21	0	0
3	61342408	.	G	A	15	6	21	0	1	22	0	0
3	61342423	.	G	C	8	14	22	0	0	22	0	0
3	61342708	.	T	A	6	4	10	0	3	13	0	0
3	61342747	.	C	T	2	8	10	0	7	17	0	0
3	61342770	.	G	A	10	7	17	0	1	18	0	0
3	61342891	.	A	G	5	6	11	0	1	12	0	0
3	61342942	.	T	C	1	2	3	0	1	4	0	0
3	61343076	.	C	T	7	6	13	0	0	13	0	0
3	61343224	.	C	T	4	7	11	0	1	12	0	0
3	61343390	.	A	C	2	0	2	0	4	6	0	0
3	61343509	.	C	T	0	4	4	0	3	7	0	0
3	61343589	.	T	C	1	2	3	0	0	3	0	0
3	61349602	.	G	A	6	4	10	0	0	10	0	0
3	61349654	.	C	T	7	8	15	0	0	15	0	0
3	61349887	.	A	T	5	5	10	0	0	10	0	0
3	61349931	.	G	T	3	7	10	0	0	10	0	0
3	61350036	.	C	T	1	2	3	0	0	3	0	0
3	61350156	.	A	G	1	4	5	0	0	5	0	0
3	61350238	.	A	G	2	3	5	0	0	5	0	0
3	61350259	.	T	A	2	3	5	0	0	5	0	0
3	61350529	.	T	A	5	4	9	0	0	9	0	0
3	61350600	.	T	C	4	6	10	0	0	10	0	0
3	61350648	.	G	A	5	5	10	0	1	11	0	0
3	61350673	.	T	G	4	5	9	0	0	9	0	0
3	61350700	.	C	T	5	7	12	0	3	15	0	0
3	61350787	.	A	T	5	5	10	0	0	10	0	0
3	61350788	.	T	G	5	5	10	0	0	10	0	0
3	61351691	.	C	G	4	2	6	0	0	6	0	0
3	61351702	.	C	T	2	2	4	0	0	4	0	0
3	61351733	.	C	T	3	2	5	0	0	5	0	0
3	61351905	.	C	T	0	4	4	0	2	6	0	0
3	61351910	.	T	A	3	3	6	0	1	7	0	0
3	61352058	.	C	T	1	3	4	0	0	4	0	0
3	61354072	.	A	T	2	4	6	0	0	6	0	0
3	61354108	.	C	A	5	3	8	0	0	8	0	0
3	61359027	.	A	T	4	2	6	0	0	6	0	0
3	61359266	.	G	T	5	2	7	2	0	9	0	0
3	61360125	.	T	C	5	2	7	0	0	7	0	0
3	61361306	.	T	C	3	2	5	0	0	5	0	0
3	61361409	.	G	A	7	7	14	7	0	21	0	0
3	61365135	.	G	A	4	2	6	4	0	10	0	0
3	61372060	.	T	G	5	10	15	0	0	15	0	0
3	61382870	.	A	C	2	2	4	0	0	4	0	0
3	61383062	.	A	T	0	1	1	3	3	7	0	0
3	61383072	.	C	T	0	4	4	3	1	8	0	0
3	61383835	.	C	T	1	3	4	0	1	5	0	0
3	61383841	.	G	T	1	4	5	0	1	6	0	0
3	61383875	.	A	G	1	4	5	0	0	5	0	0
3	61385043	.	A	G	1	2	3	1	0	4	0	0
3	61391953	.	C	A	12	5	17	0	0	17	0	0
3	61392048	.	A	G	3	1	4	0	11	15	0	0
3	61395181	.	C	T	11	4	15	0	1	16	0	0
3	61395211	.	G	A	0	6	6	0	5	11	0	0
3	61396868	.	A	T	4	4	8	0	0	9	1	0
3	61396891	.	C	A	6	3	9	0	0	9	0	0
3	61396911	.	C	T	6	4	10	0	0	10	0	0
3	61397037	.	T	A	10	5	15	0	0	15	0	0
3	61397141	.	G	T	4	6	10	0	0	10	0	0
3	61397231	.	C	A	7	8	15	0	0	15	0	0
3	61397248	.	A	G	7	0	7	0	10	17	0	0
3	61398272	.	A	T	3	8	11	0	1	12	0	0
3	61398563	.	A	G	17	4	21	0	0	21	0	0
3	61398728	.	A	G	9	8	17	0	1	18	0	0
3	61398835	.	G	A	2	4	6	0	0	6	0	0
3	61398839	.	T	C	2	3	5	0	0	5	0	0
3	61401583	.	A	C	1	3	4	0	0	4	0	0
3	61540764	.	C	T	3	3	6	0	0	6	0	0
3	61542854	.	G	T	4	4	8	0	0	8	0	0
3	61542889	.	C	A	4	3	7	0	0	7	0	0
3	61542910	.	C	T	4	4	8	0	0	8	0	0
3	61542973	.	T	C	1	2	3	0	0	3	0	0
3	61543009	.	T	G	1	0	1	0	4	5	0	0
3	61543130	.	G	A	1	3	4	0	0	4	0	0
3	61566559	.	G	A	3	3	6	0	0	6	0	0
3	61592888	.	T	C	2	2	4	0	0	4	0	0
3	61961782	.	A	C	1	2	3	0	0	3	0	0
3	62035030	.	G	A	0	9	9	0	7	16	0	0
3	62035861	.	C	T	4	3	7	0	0	7	0	0
3	62035952	.	A	G	3	0	3	0	4	7	0	0
3	62036047	.	G	A	0	5	5	0	7	12	0	0
3	62036320	.	A	G	7	4	11	0	0	11	0	0
3	62036323	.	A	G	7	5	12	0	0	12	0	0
3	62036426	.	G	A	4	4	8	0	0	8	0	0
3	62036570	.	G	A	14	6	20	0	1	21	0	0
3	62037105	.	T	C	8	5	13	0	0	13	0	0
3	62037343	.	G	C	1	5	6	0	0	6	0	0
3	62037430	.	A	G	8	0	8	0	6	14	0	0
3	62037716	.	G	A	9	5	14	0	0	14	0	0
3	62038526	.	T	C	11	7	18	0	1	19	0	0
3	62038739	.	G	C	9	12	21	0	0	21	0	0
3	62038993	.	G	A	3	11	14	0	16	30	0	0
3	62039278	.	A	G	9	1	10	0	14	24	0	0
3	62039524	.	A	G	2	9	11	0	2	13	0	0
3	62039534	.	C	T	8	4	12	0	1	13	0	0
3	62039657	.	G	A	3	7	10	0	11	21	0	0
3	62039689	.	C	A	13	6	19	0	0	19	0	0
3	62039718	.	G	A	7	12	19	0	0	19	0	0
3	62039813	.	T	A	12	15	27	0	1	28	0	0
3	62040555	.	G	A	15	20	35	0	0	35	0	0
3	62051395	.	A	G	14	10	24	0	0	24	0	0
3	62051660	.	T	A	9	15	24	0	0	24	0	0
3	62051934	.	A	G	11	1	12	1	3	16	0	0
3	62068866	.	A	G	9	3	12	0	0	12	0	0
3	62068871	.	A	G	8	3	11	0	0	11	0	0
3	62068902	.	C	T	0	4	4	0	6	10	0	0
3	62069739	.	G	T	6	9	15	0	1	16	0	0
3	62069815	.	G	A	8	9	17	0	0	17	0	0
3	62069821	.	G	A	8	11	19	0	0	19	0	0
3	62070762	.	T	C	5	8	13	0	1	14	0	0
3	62070890	.	G	A	6	8	14	0	0	14	0	0
3	62073967	.	T	A	17	10	27	0	0	27	0	0
3	62074030	.	T	C	9	6	15	0	0	15	0	0
3	62080117	.	G	C	11	10	21	0	0	21	0	0
3	62080172	.	G	A	8	8	16	0	4	20	0	0
3	62080183	.	G	A	8	8	16	0	3	19	0	0
3	62091398	.	A	G	4	6	10	0	0	10	0	0
3	62091632	.	T	A	8	7	15	0	1	16	0	0
3	62091660	.	T	A	11	6	17	0	2	19	0	0
3	62091880	.	C	T	12	11	23	0	1	24	0	0
3	62091975	.	C	A	13	13	26	0	0	26	0	0
3	62091995	.	G	T	14	15	29	0	0	29	0	0
3	62092025	.	C	T	1	13	14	0	11	25	0	0
3	62092262	.	T	A	11	6	17	0	0	17	0	0
3	62092279	.	A	T	8	6	14	0	0	14	0	0
3	62092666	.	G	A	10	6	16	0	0	16	0	0
3	62092715	.	A	C	10	12	22	0	0	22	0	0
3	62092749	.	G	C	7	13	20	0	1	21	0	0
3	62092801	.	C	T	11	9	20	0	0	20	0	0
3	62092902	.	A	T	8	6	14	0	1	15	0	0
3	62093241	.	T	A	9	6	15	0	2	17	0	0
3	62093567	.	A	C	1	4	5	0	0	5	0	0
3	62094006	.	A	C	1	3	4	0	0	4	0	0
3	62094190	.	A	C	3	2	5	0	0	5	0	0
3	62094327	.	C	T	8	9	17	0	0	17	0	0
3	62094645	.	A	G	4	7	11	0	0	11	0	0
3	62094686	.	C	A	2	3	5	0	7	12	0	0
3	62094849	.	A	G	10	11	21	0	0	21	0	0
3	62095051	.	G	A	12	4	16	0	0	16	0	0
3	62095644	.	G	C	1	4	5	0	0	5	0	0
3	62095646	.	T	A	1	4	5	0	0	5	0	0
3	62095734	.	G	A	3	4	7	0	0	7	0	0
3	62095887	.	T	C	6	0	6	0	4	10	0	0
3	62095940	.	G	C	2	4	6	0	0	6	0	0
3	62095980	.	A	C	4	4	8	0	0	8	0	0
3	62096288	.	A	T	5	2	7	0	0	7	0	0
3	62096937	.	C	T	2	2	4	0	0	4	0	0
3	62097272	.	T	C	1	3	4	0	0	4	0	0
3	62097300	.	A	T	2	2	4	0	0	4	0	0
3	62097490	.	A	T	9	4	13	0	3	16	0	0
3	62097548	.	A	T	11	9	20	0	0	20	0	0
3	62114615	.	C	T	1	3	4	0	5	9	0	0
3	62114663	.	C	T	6	7	13	0	2	15	0	0
3	62117154	.	C	T	1	5	6	0	8	14	0	0
3	62117187	.	C	T	7	5	12	0	1	13	0	0
3	62129751	.	T	C	6	2	8	0	0	8	0	0
3	62129754	.	G	A	5	2	7	0	0	7	0	0
3	62137708	.	C	T	11	6	17	0	0	17	0	0
3	62138746	.	A	G	7	4	11	0	0	11	0	0
3	62147737	.	G	A	5	5	10	1	1	12	0	0
3	62149774	.	C	T	5	6	11	0	1	12	0	0
3	62167910	.	T	A	1	2	3	0	0	3	0	0
3	62173443	.	A	T	5	3	8	0	0	8	0	0
3	62173503	.	G	T	4	9	13	0	1	14	0	0
3	62173546	.	C	T	7	10	17	0	1	18	0	0
3	62173593	.	T	C	7	5	12	0	2	14	0	0
3	62173628	.	T	C	8	8	16	0	1	17	0	0
3	62180638	.	G	A	2	5	7	0	1	8	0	0
3	62180788	.	G	A	3	3	6	0	0	6	0	0
3	62196977	.	C	T	7	10	17	0	1	18	0	0
3	62203509	.	G	A	8	6	14	0	0	14	0	0
3	62203653	.	T	A	4	5	9	0	0	9	0	0
3	62205906	.	C	A	3	7	10	0	0	10	0	0
3	62208678	.	C	T	1	3	4	0	0	4	0	0
3	62209024	.	A	G	3	5	8	0	1	9	0	0
3	62209033	.	A	G	5	2	7	0	0	7	0	0
3	62209183	.	A	G	2	0	2	0	4	6	0	0
3	62209216	.	A	G	4	3	7	0	0	7	0	0
3	62238692	.	G	A	2	3	5	4	0	9	0	0
3	62238721	.	C	T	4	4	8	0	0	8	0	0
3	62238997	.	T	G	3	0	3	1	4	8	0	0
3	62240421	.	A	T	2	3	5	0	0	5	0	0
3	62275507	.	T	A	3	4	7	0	1	8	0	0
3	62275598	.	G	A	4	3	7	0	0	7	0	0
3	62275667	.	A	G	4	0	4	5	3	12	0	0
3	62275743	.	T	C	2	3	5	1	0	6	0	0
3	62276009	.	A	T	2	3	5	0	0	5	0	0
3	62276101	.	G	A	1	4	5	0	0	5	0	0
3	62276104	.	A	G	1	4	5	0	0	5	0	0
3	62296761	.	G	T	1	3	4	3	0	7	0	0
3	62297353	.	A	C	2	2	4	0	0	4	0	0
3	62297360	.	G	A	1	3	4	0	0	4	0	0
3	62323087	.	T	C	1	5	6	0	0	6	0	0
3	62323384	.	G	A	6	3	9	1	0	10	0	0
3	62323564	.	C	T	4	9	13	0	2	15	0	0
3	62324030	.	C	T	5	2	7	0	0	7	0	0
3	62324063	.	A	T	3	5	8	0	1	9	0	0
3	62324109	.	G	A	0	2	2	0	7	9	0	0
3	62324118	.	G	A	2	8	10	0	1	11	0	0
3	62324312	.	T	C	2	2	4	2	0	6	0	0
3	62324426	.	A	G	2	4	6	0	0	6	0	0
3	62328846	.	G	C	4	5	9	4	0	13	0	0
3	62329097	.	G	C	5	3	8	0	1	9	0	0
3	62329199	.	A	G	7	0	7	2	3	12	0	0
3	62329545	.	G	T	4	2	6	0	0	6	0	0
3	62329682	.	G	T	6	3	9	0	0	9	0	0
3	62329699	.	C	A	3	6	9	0	0	9	0	0
3	62345471	.	A	T	1	4	5	1	1	7	0	0
3	62345588	.	T	A	3	4	7	0	0	7	0	0
3	62345686	.	T	A	7	4	11	0	1	12	0	0
3	62345708	.	G	A	6	5	11	0	0	11	0	0
3	62345770	.	A	T	3	4	7	0	0	7	0	0
3	62353679	.	G	T	3	3	6	0	0	6	0	0
3	62353952	.	G	A	7	5	12	0	0	12	0	0
3	62359440	.	G	T	12	15	27	0	0	27	0	0
3	62360484	.	C	T	13	11	24	0	1	25	0	0
3	62360686	.	G	A	2	3	5	0	1	6	0	0
3	62360736	.	C	A	2	2	4	0	1	5	0	0
3	62369864	.	G	A	14	14	28	0	1	29	0	0
3	62370068	.	A	G	10	9	19	0	0	19	0	0
3	62370381	.	A	G	11	15	26	0	1	27	0	0
3	62370476	.	G	A	11	9	20	0	2	22	0	0
3	62379739	.	C	T	16	7	23	0	0	23	0	0
3	62382863	.	A	G	39	27	66	0	2	68	0	0
3	62383314	.	T	G	59	10	69	0	2	71	0	0
3	62383315	.	G	T	57	11	68	0	3	71	0	0
3	62383438	.	G	A	29	31	60	0	0	60	0	0
3	62383439	.	A	G	30	31	61	0	0	61	0	0
3	62383565	.	T	A	24	22	46	0	2	49	1	0
3	62383589	.	A	C	24	22	46	1	1	48	0	0
3	62383610	.	G	C	20	3	23	1	24	48	0	0
3	62383706	.	C	T	40	19	59	1	1	61	0	0
3	62383992	.	C	G	9	16	25	2	0	27	0	0
3	62384055	.	G	A	12	17	29	6	3	38	0	0
3	62384112	.	T	A	4	7	11	4	0	15	0	0
3	62384208	.	C	T	1	44	45	0	21	66	0	0
3	62384219	.	G	A	48	12	60	0	5	65	0	0
3	62384428	.	T	A	46	20	66	0	3	69	0	0
3	62384565	.	C	G	32	26	58	1	7	66	0	0
3	62386420	.	T	C	34	1	35	0	22	57	0	0
3	62386955	.	G	T	32	26	58	0	1	59	0	0
3	62387141	.	C	T	3	18	21	1	26	48	0	0
3	62387144	.	C	T	21	23	44	1	2	47	0	0
3	62389677	.	A	C	2	2	4	0	0	4	0	0
3	62389681	.	A	C	2	2	4	0	0	4	0	0
3	62390349	.	A	G	29	30	59	0	1	60	0	0
3	62393321	.	G	A	26	11	37	0	0	37	0	0
3	62393337	.	C	T	30	13	43	0	1	44	0	0
3	62399310	.	T	C	2	2	4	0	0	4	0	0
3	62399314	.	A	C	2	2	4	0	0	4	0	0
3	62399368	.	A	G	2	2	4	0	0	4	0	0
3	62403255	.	T	C	1	2	3	2	0	5	0	0
3	62403494	.	A	G	1	3	4	0	0	4	0	0
3	62433064	.	C	T	10	9	19	0	0	19	0	0
3	62433138	.	T	G	8	7	15	1	0	16	0	0
3	62521263	.	T	A	10	8	18	0	0	18	0	0
3	62521956	.	G	A	7	6	13	0	0	13	0	0
3	62522063	.	A	T	13	9	22	0	0	22	0	0
3	62522065	.	G	T	9	8	17	0	5	22	0	0
3	62522238	.	A	G	6	8	14	0	1	15	0	0
3	62522742	.	C	A	8	4	12	0	0	12	0	0
3	62522750	.	G	C	4	7	11	0	2	13	0	0
3	62522804	.	C	T	0	2	2	0	7	9	0	0
3	62522808	.	C	T	3	6	9	0	1	10	0	0
3	62522899	.	C	G	17	7	24	0	1	25	0	0
3	62523031	.	A	G	3	14	17	0	2	19	0	0
3	62523032	.	A	T	16	3	19	0	0	19	0	0
3	62523325	.	G	T	5	11	16	0	0	16	0	0
3	62523502	.	G	A	7	4	11	0	1	12	0	0
3	62523550	.	C	T	5	3	8	0	0	8	0	0
3	62527379	.	G	T	2	2	4	0	0	4	0	0
3	62527397	.	G	T	2	2	4	0	0	4	0	0
4	316946	.	A	T	13	27	40	0	0	40	0	0
4	317091	.	A	G	12	22	34	0	1	35	0	0
4	317217	.	T	A	13	10	23	0	1	24	0	0
4	317275	.	G	T	9	13	22	0	1	23	0	0
4	317938	.	G	A	1	4	5	0	0	5	0	0
4	325073	.	C	T	3	5	8	0	0	8	0	0
4	325126	.	G	A	4	6	10	0	0	10	0	0
4	325136	.	G	A	6	7	13	0	1	14	0	0
4	325161	.	A	C	11	0	11	0	7	18	0	0
4	329743	.	G	A	12	16	28	0	3	31	0	0
4	329746	.	A	G	14	16	30	0	0	30	0	0
4	332491	.	G	T	0	4	4	0	2	6	0	0
4	344264	.	T	G	2	2	4	0	0	4	0	0
4	344662	.	G	A	2	3	5	0	0	5	0	0
4	344878	.	C	G	4	6	10	0	0	10	0	0
4	348201	.	G	A	1	5	6	0	6	12	0	0
4	348216	.	C	T	7	4	11	0	0	11	0	0
4	348297	.	T	C	5	7	12	0	1	13	0	0
4	349298	.	T	C	1	7	8	0	2	10	0	0
4	349304	.	A	G	3	10	13	0	0	13	0	0
4	349490	.	A	C	3	10	13	0	0	13	0	0
4	349514	.	T	C	4	6	10	0	2	12	0	0
4	349886	.	T	C	5	3	8	0	0	8	0	0
4	350652	.	C	T	3	3	6	0	1	7	0	0
4	350832	.	G	A	4	4	8	0	1	9	0	0
4	351654	.	T	A	1	4	5	0	0	5	0	0
4	352031	.	C	G	5	3	8	0	1	9	0	0
4	352284	.	A	G	7	0	7	0	15	22	0	0
4	352289	.	T	C	10	11	21	0	1	22	0	0
4	352504	.	T	C	12	8	20	0	1	21	0	0
4	353049	.	A	T	6	6	12	0	0	12	0	0
4	353064	.	C	G	7	5	12	0	1	13	0	0
4	353238	.	T	G	7	1	8	0	10	18	0	0
4	353247	.	T	C	9	11	20	0	0	20	0	0
4	353379	.	A	T	13	12	25	0	3	28	0	0
4	353481	.	A	G	4	0	4	0	8	12	0	0
4	353638	.	C	T	9	4	13	1	0	14	0	0
4	353778	.	T	A	7	2	9	0	2	11	0	0
4	357887	.	T	G	10	8	18	0	0	18	0	0
4	357954	.	G	A	7	4	11	0	0	11	0	0
4	358080	.	T	C	5	5	10	0	0	10	0	0
4	362282	.	C	T	9	3	12	0	1	13	0	0
4	367532	.	T	G	7	0	7	0	6	13	0	0
4	385092	.	C	T	11	15	26	0	8	34	0	0
4	385710	.	T	C	13	10	23	0	0	23	0	0
4	386014	.	A	C	20	5	25	0	6	31	0	0
4	386037	.	T	G	27	6	33	0	1	34	0	0
4	386124	.	C	A	5	3	8	0	8	16	0	0
4	386537	.	T	A	25	14	39	1	4	44	0	0
4	386538	.	T	A	30	13	43	1	4	48	0	0
4	386717	.	G	C	25	0	25	0	4	29	0	0
4	386839	.	A	G	26	0	26	0	5	31	0	0
4	386961	.	G	A	31	15	46	2	4	52	0	0
4	394020	.	T	C	28	45	73	0	4	77	0	0
4	647752	.	G	T	10	10	20	0	0	20	0	0
4	659276	.	C	T	8	5	13	0	0	13	0	0
4	659345	.	T	C	12	4	16	0	0	16	0	0
4	660571	.	G	A	8	14	22	0	2	24	0	0
4	660649	.	T	A	10	13	23	0	1	24	0	0
4	660655	.	G	A	2	12	14	0	12	26	0	0
4	660715	.	T	C	12	14	26	0	1	27	0	0
4	667358	.	T	C	12	11	23	0	1	24	0	0
4	667382	.	A	G	14	0	14	0	12	26	0	0
4	674838	.	T	C	15	11	26	0	4	30	0	0
4	675080	.	T	C	7	10	17	0	0	17	0	0
4	676885	.	A	G	6	9	15	1	0	16	0	0
4	676942	.	A	G	11	5	16	0	0	16	0	0
4	678853	.	C	T	8	10	18	0	0	18	0	0
4	679441	.	C	G	0	11	11	0	14	25	0	0
4	680314	.	G	T	10	9	19	0	0	19	0	0
4	680320	.	C	T	11	8	19	0	0	19	0	0
4	680359	.	C	T	14	8	22	0	0	22	0	0
4	680395	.	T	C	13	1	14	0	8	22	0	0
4	680404	.	G	A	12	9	21	0	0	21	0	0
4	681595	.	G	A	9	7	16	0	0	16	0	0
4	686987	.	G	A	1	5	6	0	3	9	0	0
4	686999	.	C	G	4	7	11	0	0	11	0	0
4	687083	.	A	G	6	0	6	0	7	13	0	0
4	694254	.	T	C	5	9	14	0	0	14	0	0
4	694299	.	T	C	2	7	9	0	1	10	0	0
4	694300	.	G	A	2	8	10	0	0	10	0	0
4	694680	.	A	C	8	6	14	0	1	15	0	0
4	694718	.	G	A	9	13	22	0	0	22	0	0
4	694741	.	T	G	8	13	21	0	0	21	0	0
4	694757	.	A	T	8	14	22	0	0	22	0	0
4	695367	.	C	T	10	7	17	0	0	17	0	0
4	700281	.	A	C	3	10	13	0	2	15	0	0
4	700284	.	G	T	0	8	8	0	6	15	1	0
4	700563	.	G	T	2	7	9	0	1	10	0	0
4	700569	.	G	A	0	6	6	0	2	8	0	0
4	700598	.	A	T	2	4	6	0	0	6	0	0
4	700606	.	T	C	1	2	3	0	0	3	0	0
4	700665	.	G	T	2	2	4	0	0	4	0	0
4	702061	.	C	G	4	11	15	0	1	16	0	0
4	736442	.	A	G	12	13	25	0	2	27	0	0
4	737636	.	A	T	8	6	14	0	0	14	0	0
4	737811	.	A	G	7	5	12	0	0	12	0	0
4	737927	.	T	G	9	6	15	0	0	15	0	0
4	740435	.	A	T	12	9	21	0	0	21	0	0
4	740921	.	T	C	11	6	17	0	0	17	0	0
4	740965	.	T	G	16	5	21	1	1	23	0	0
4	749803	.	G	A	12	21	33	0	0	33	0	0
4	749989	.	G	T	7	6	13	0	2	15	0	0
4	750016	.	T	C	7	1	8	0	8	16	0	0
4	750526	.	C	G	9	10	19	0	1	20	0	0
4	750531	.	C	T	9	10	19	0	4	23	0	0
4	750661	.	C	T	0	14	14	0	14	28	0	0
4	751275	.	A	G	8	11	19	0	0	19	0	0
4	751546	.	G	A	12	5	17	0	1	18	0	0
4	751553	.	C	T	13	4	17	0	0	17	0	0
4	751640	.	T	G	13	8	21	0	0	21	0	0
4	753723	.	T	C	8	0	8	0	7	15	0	0
4	755539	.	C	T	7	11	18	0	1	19	0	0
4	757405	.	C	T	4	6	10	0	1	11	0	0
4	760555	.	G	T	4	3	7	0	0	7	0	0
4	765112	.	A	G	11	13	24	0	0	24	0	0
4	766575	.	G	A	8	9	17	0	0	17	0	0
4	766588	.	G	A	6	11	17	0	0	17	0	0
4	766613	.	A	C	6	8	14	0	0	14	0	0
4	769533	.	A	T	8	5	13	0	0	13	0	0
4	769726	.	G	A	7	12	19	1	0	20	0	0
4	772363	.	C	T	15	10	25	0	1	26	0	0
4	776550	.	G	T	9	4	13	0	0	13	0	0
4	777976	.	A	G	7	7	14	0	2	16	0	0
4	778111	.	G	A	14	11	25	0	2	27	0	0
4	779310	.	G	A	10	12	22	0	1	23	0	0
4	779363	.	T	C	7	0	7	0	9	16	0	0
4	779429	.	A	G	16	14	30	0	0	31	1	0
4	779442	.	G	A	16	14	30	0	1	31	0	0
4	779523	.	T	C	2	5	7	0	0	7	0	0
4	783816	.	G	T	23	14	37	0	2	39	0	0
4	783835	.	A	G	29	11	40	0	1	41	0	0
4	784002	.	T	A	27	18	45	1	4	50	0	0
4	784177	.	T	C	29	20	49	0	2	51	0	0
4	784325	.	A	T	18	14	32	0	1	33	0	0
4	784373	.	T	A	7	10	17	0	0	17	0	0
4	784435	.	G	T	7	2	9	0	0	9	0	0
4	784642	.	G	A	20	5	25	0	0	25	0	0
4	784854	.	C	A	13	4	17	0	2	19	0	0
4	784990	.	T	A	19	14	33	0	1	34	0	0
4	785011	.	T	C	16	7	23	0	5	28	0	0
4	785060	.	T	A	13	10	23	0	1	24	0	0
4	785132	.	G	A	31	16	47	0	1	48	0	0
4	788970	.	G	C	22	0	22	0	17	39	0	0
4	789589	.	A	G	16	12	28	0	3	31	0	0
4	798743	.	G	C	2	5	7	0	0	7	0	0
4	798804	.	G	A	8	14	22	0	1	23	0	0
4	798850	.	A	C	12	15	27	0	0	27	0	0
4	798861	.	G	T	16	16	32	0	0	32	0	0
4	799006	.	G	T	20	16	36	0	1	37	0	0
4	799090	.	T	C	21	10	31	0	1	32	0	0
4	799127	.	T	G	14	9	23	0	1	25	1	0
4	799245	.	G	A	14	12	26	0	0	26	0	0
4	799475	.	A	G	26	10	36	0	0	36	0	0
4	799513	.	G	A	17	13	30	0	3	33	0	0
4	799620	.	C	T	19	11	30	0	1	31	0	0
4	799643	.	T	A	21	14	35	0	1	36	0	0
4	799933	.	C	T	25	18	43	0	1	44	0	0
4	800027	.	C	T	19	9	28	0	0	28	0	0
4	800094	.	A	G	18	18	36	0	0	36	0	0
4	800113	.	A	G	22	14	36	0	1	37	0	0
4	800363	.	C	T	1	18	19	0	23	42	0	0
4	800520	.	T	C	30	21	51	0	4	55	0	0
4	802909	.	T	A	17	30	47	0	4	51	0	0
4	803862	.	T	C	13	0	13	0	21	34	0	0
4	806319	.	G	A	20	16	36	0	0	36	0	0
4	806322	.	T	C	17	15	32	0	3	35	0	0
4	807895	.	C	G	12	20	32	0	3	35	0	0
4	807898	.	A	G	9	19	28	0	4	32	0	0
4	808421	.	A	G	23	12	35	0	0	35	0	0
4	809456	.	A	G	18	21	39	0	1	40	0	0
4	809512	.	T	C	14	0	14	0	20	34	0	0
4	809549	.	A	G	11	17	28	0	0	28	0	0
4	813157	.	G	A	9	17	26	0	0	26	0	0
4	813226	.	A	G	16	17	33	0	1	34	0	0
4	823659	.	G	A	1	3	4	0	0	4	0	0
4	823755	.	C	A	0	2	2	0	2	4	0	0
4	831691	.	G	A	2	3	5	0	0	5	0	0
4	862009	.	A	G	7	4	11	0	0	11	0	0
4	864324	.	T	A	5	8	13	0	1	14	0	0
4	867601	.	G	C	5	3	8	0	0	8	0	0
4	867692	.	A	C	4	3	7	0	0	7	0	0
4	870833	.	C	T	0	2	2	0	3	5	0	0
4	870876	.	C	T	5	3	8	0	0	8	0	0
4	873763	.	C	G	4	5	9	0	0	9	0	0
4	874241	.	G	T	5	6	11	0	0	11	0	0
4	874323	.	C	T	4	7	11	0	0	11	0	0
4	880033	.	A	G	3	3	6	0	0	6	0	0
4	880275	.	A	G	6	5	11	0	0	11	0	0
4	880286	.	C	T	5	5	10	0	1	11	0	0
4	880318	.	G	T	5	5	10	0	0	10	0	0
4	880323	.	C	G	5	4	9	0	1	10	0	0
4	880692	.	T	G	5	4	9	0	0	9	0	0
4	880693	.	G	T	5	4	9	0	0	9	0	0
4	880918	.	T	C	3	2	5	0	1	6	0	0
4	880934	.	A	C	2	0	2	0	2	4	0	0
4	881030	.	T	A	7	3	10	1	0	11	0	0
4	881051	.	A	G	4	4	8	0	1	9	0	0
4	881180	.	G	A	2	5	7	0	0	7	0	0
4	881758	.	G	T	3	2	5	0	0	5	0	0
4	881784	.	G	A	5	3	8	0	0	8	0	0
4	881980	.	T	A	4	6	10	0	0	10	0	0
4	881997	.	A	C	2	5	7	0	0	7	0	0
4	882099	.	G	A	3	2	5	0	0	5	0	0
4	883485	.	G	A	3	3	6	0	1	7	0	0
4	883581	.	G	T	1	3	4	0	0	4	0	0
4	883854	.	G	A	1	4	5	0	0	5	0	0
4	884270	.	T	C	1	2	3	0	0	3	0	0
4	905612	.	G	A	2	2	4	0	1	5	0	0
4	905657	.	A	G	1	2	3	0	0	3	0	0
4	905713	.	C	G	1	2	3	0	0	3	0	0
4	908796	.	T	C	2	0	2	0	4	6	0	0
4	959015	.	T	C	4	3	7	0	0	7	0	0
4	961542	.	G	A	2	4	6	0	0	6	0	0
4	963452	.	A	G	6	2	8	0	0	8	0	0
4	965124	.	C	G	0	2	2	0	2	4	0	0
4	967974	.	C	T	12	7	19	0	1	20	0	0
4	968001	.	G	A	0	6	6	0	7	13	0	0
4	968121	.	T	C	3	14	17	0	1	18	0	0
4	969475	.	A	T	3	10	13	0	0	13	0	0
4	969486	.	T	G	4	0	4	0	12	16	0	0
4	970689	.	A	G	4	0	4	0	7	11	0	0
4	971765	.	A	G	7	6	13	0	0	13	0	0
4	971842	.	G	C	0	7	7	0	5	12	0	0
4	974482	.	C	T	7	7	14	0	1	15	0	0
4	975735	.	G	C	1	11	12	0	14	26	0	0
4	975758	.	C	T	11	14	25	0	0	25	0	0
4	975792	.	G	C	0	11	11	0	13	24	0	0
4	975938	.	T	C	8	13	21	0	0	21	0	0
4	982892	.	G	A	3	10	13	0	1	14	0	0
4	982893	.	T	C	11	3	14	0	0	14	0	0
4	982938	.	C	G	4	7	11	0	0	11	0	0
4	982958	.	A	G	5	3	8	0	0	8	0	0
4	986133	.	A	G	2	2	4	0	0	4	0	0
4	986350	.	C	A	0	2	2	0	4	6	0	0
4	1014713	.	G	A	2	2	4	0	0	4	0	0
4	1054775	.	G	A	18	15	33	0	2	35	0	0
4	1054866	.	G	T	34	7	41	2	4	47	0	0
4	1054868	.	G	A	35	7	42	2	2	46	0	0
4	1055081	.	C	T	35	17	52	0	3	55	0	0
4	1055095	.	T	A	32	17	49	0	2	51	0	0
4	1055149	.	A	G	16	12	28	0	1	29	0	0
4	1055200	.	A	G	13	7	20	0	1	21	0	0
4	1055724	.	C	T	29	17	46	0	2	48	0	0
4	1055770	.	A	G	28	16	44	0	0	44	0	0
4	1146384	.	T	C	4	6	10	0	1	11	0	0
4	1146466	.	G	C	2	4	6	0	2	8	0	0
4	1283605	.	A	G	1	0	1	0	4	5	0	0
4	1283626	.	T	C	3	3	6	0	0	6	0	0
4	1283707	.	C	T	4	2	6	0	0	6	0	0
4	1284013	.	C	A	2	2	4	0	0	4	0	0
4	1284608	.	T	A	3	3	6	0	0	6	0	0
4	1301455	.	G	T	1	3	4	0	1	5	0	0
4	1301582	.	G	A	12	16	28	0	0	28	0	0
4	1301785	.	G	T	2	4	6	1	1	8	0	0
4	1301848	.	G	A	5	10	15	0	0	15	0	0
4	1301866	.	A	T	7	9	16	0	1	17	0	0
4	1301921	.	T	C	7	1	8	0	10	18	0	0
4	1301954	.	C	T	7	5	12	0	2	14	0	0
4	1302059	.	T	C	13	0	13	2	14	29	0	0
4	1302155	.	A	G	15	10	25	0	0	25	0	0
4	1302198	.	G	A	12	3	15	2	3	20	0	0
4	1302219	.	G	T	11	4	15	0	4	19	0	0
4	1302385	.	G	A	7	13	20	0	0	20	0	0
4	1302401	.	G	A	6	12	18	0	0	18	0	0
4	1302437	.	A	G	13	9	22	0	0	22	0	0
4	1302485	.	T	C	17	1	18	0	10	28	0	0
4	1302488	.	T	C	16	0	16	0	12	28	0	0
4	1302584	.	A	G	11	5	16	2	1	19	0	0
4	1302609	.	A	G	13	8	21	2	1	24	0	0
4	1302624	.	A	G	13	10	23	2	1	26	0	0
4	1302702	.	C	A	10	10	20	0	2	22	0	0
4	1302785	.	C	T	3	14	17	0	14	31	0	0
4	1303044	.	C	T	5	8	13	0	0	13	0	0
4	1303097	.	A	G	2	7	9	0	0	9	0	0
4	1303196	.	G	A	10	5	15	0	0	15	0	0
4	1303206	.	T	C	9	0	9	0	1	10	0	0
4	1360469	.	A	G	1	3	4	0	0	4	0	0
4	1389106	.	C	T	8	19	27	0	0	27	0	0
4	1392957	.	G	A	8	7	15	0	1	16	0	0
4	1393032	.	T	A	12	6	18	0	1	19	0	0
4	1393062	.	A	G	11	6	17	0	0	17	0	0
4	1396176	.	C	T	4	7	11	0	0	11	0	0
4	1398375	.	C	T	0	8	8	0	0	8	0	0
4	1398382	.	G	A	4	5	9	0	0	9	0	0
4	1469788	.	T	C	11	4	15	0	0	15	0	0
4	1470000	.	C	T	8	2	10	0	0	10	0	0
4	1470380	.	C	A	20	12	32	0	0	32	0	0
4	1471113	.	T	A	3	2	5	0	0	5	0	0
4	1477538	.	A	G	14	8	22	0	1	23	0	0
4	1479855	.	C	A	9	4	13	1	0	14	0	0
4	1497159	.	G	A	11	5	16	0	0	16	0	0
4	1547304	.	G	C	2	4	6	0	0	6	0	0
4	1563938	.	T	A	1	1	2	0	1	3	0	0
4	1564041	.	T	C	1	4	5	0	0	5	0	0
4	1565405	.	C	A	9	3	12	0	0	12	0	0
4	1565587	.	G	A	8	4	12	1	4	17	0	0
4	1565789	.	A	G	6	3	9	0	0	9	0	0
4	1565832	.	G	A	3	3	6	0	0	6	0	0
4	1565901	.	G	A	3	2	5	0	1	6	0	0
4	1566501	.	T	C	3	4	7	0	0	7	0	0
4	1566502	.	T	G	2	0	2	0	5	7	0	0
4	1648035	.	G	T	9	2	11	0	0	11	0	0
4	1834169	.	C	G	3	7	10	0	0	10	0	0
4	1834190	.	G	A	6	3	9	0	0	9	0	0
4	1835801	.	C	T	2	2	4	0	0	4	0	0
4	1835950	.	G	T	2	3	5	0	0	5	0	0
4	1835982	.	T	C	3	4	7	0	0	7	0	0
4	1837647	.	A	T	4	4	8	0	1	10	1	0
4	1839142	.	T	C	2	4	6	0	2	8	0	0
4	1988778	.	T	A	6	4	10	1	1	12	0	0
4	1988856	.	T	C	4	0	4	0	10	14	0	0
4	1988988	.	A	C	3	0	3	0	5	8	0	0
4	1989071	.	G	A	2	5	7	0	0	7	0	0
4	1989101	.	T	C	4	0	4	0	6	10	0	0
4	1994261	.	C	A	9	7	16	0	0	16	0	0
4	1994560	.	A	T	4	7	11	0	1	12	0	0
4	1997528	.	C	T	0	4	4	0	3	7	0	0
4	1997549	.	G	A	4	3	7	0	0	7	0	0
4	1999461	.	A	T	4	2	6	0	0	6	0	0
4	1999473	.	A	G	3	2	5	0	1	6	0	0
4	2014198	.	T	C	2	7	9	0	0	9	0	0
4	2044213	.	A	G	7	13	20	0	0	20	0	0
4	2044222	.	T	C	13	1	14	0	6	20	0	0
4	2044359	.	A	C	18	17	35	0	2	37	0	0
4	2044379	.	T	A	15	24	39	0	1	40	0	0
4	2044409	.	A	G	25	17	42	1	1	44	0	0
4	2044517	.	A	G	16	20	36	0	1	37	0	0
4	2044541	.	T	C	19	0	19	0	17	36	0	0
4	2044944	.	T	A	4	4	8	0	2	10	0	0
4	2045000	.	T	A	2	6	8	0	1	9	0	0
4	2051223	.	C	G	0	3	3	0	2	5	0	0
4	2051355	.	G	A	6	2	8	0	1	9	0	0
4	2051929	.	T	G	27	26	53	0	2	55	0	0
4	2055019	.	G	A	20	14	34	0	4	38	0	0
4	2055318	.	G	A	18	21	39	1	4	44	0	0
4	2056055	.	A	C	18	0	18	0	14	32	0	0
4	2056607	.	G	A	17	16	33	0	1	34	0	0
4	2059765	.	C	A	8	8	16	0	0	16	0	0
4	2060125	.	T	C	11	13	24	0	0	24	0	0
4	2060134	.	C	T	14	9	23	0	1	24	0	0
4	2061214	.	G	A	12	13	25	0	1	26	0	0
4	2061217	.	G	A	14	11	25	0	2	27	0	0
4	2062085	.	A	G	11	12	23	0	2	25	0	0
4	2062088	.	G	A	12	15	27	0	1	28	0	0
4	2099425	.	T	C	1	2	3	0	0	3	0	0
4	2151664	.	T	A	13	8	21	0	0	21	0	0
4	2151743	.	G	A	10	5	15	0	1	16	0	0
4	2160995	.	G	A	7	12	19	0	0	19	0	0
4	2162639	.	G	A	4	10	14	0	0	14	0	0
4	2162726	.	C	G	0	10	10	0	10	20	0	0
4	2162798	.	G	A	7	10	17	0	0	17	0	0
4	2162804	.	A	G	6	10	16	0	1	17	0	0
4	2163383	.	T	C	11	0	11	0	6	17	0	0
4	2210437	.	T	G	15	11	26	0	1	27	0	0
4	2210459	.	C	T	15	15	30	0	0	30	0	0
4	2210499	.	T	C	11	2	13	0	14	27	0	0
4	2210517	.	C	T	14	10	24	0	0	24	0	0
4	2210553	.	A	G	13	9	22	0	1	23	0	0
4	2210583	.	A	G	15	5	20	0	0	20	0	0
4	2259067	.	G	A	3	4	7	0	0	7	0	0
4	2259071	.	T	C	4	0	4	0	3	7	0	0
4	2259851	.	G	T	3	7	10	0	1	11	0	0
4	2260515	.	T	C	7	0	7	0	8	15	0	0
4	2261176	.	A	G	3	5	8	0	0	8	0	0
4	2265201	.	G	A	6	2	8	0	0	8	0	0
4	2349386	.	G	A	5	11	16	0	0	16	0	0
4	2349391	.	C	T	5	10	15	0	0	15	0	0
4	2349527	.	A	G	9	10	19	0	1	20	0	0
4	2349542	.	A	T	9	7	16	0	0	16	0	0
4	2349576	.	A	C	7	4	11	0	1	12	0	0
4	2349583	.	G	A	6	3	9	0	0	9	0	0
4	2349798	.	G	A	8	11	19	0	1	20	0	0
4	2349805	.	G	T	6	11	17	0	1	18	0	0
4	2361733	.	G	A	27	15	42	0	3	45	0	0
4	2361835	.	T	C	24	0	24	0	23	47	0	0
4	2362945	.	C	A	0	27	27	0	26	53	0	0
4	2396616	.	C	T	5	7	12	0	0	12	0	0
4	2402861	.	G	A	7	4	11	0	0	11	0	0
4	2408432	.	G	A	2	4	6	0	0	6	0	0
4	2408474	.	T	C	4	0	4	0	3	7	0	0
4	2412025	.	A	G	6	7	13	0	0	13	0	0
4	2412359	.	G	T	1	3	4	0	0	4	0	0
4	2497044	.	T	C	8	9	17	0	0	17	0	0
4	2665826	.	A	G	9	3	12	0	1	13	0	0
4	3338195	.	A	G	4	2	6	0	0	6	0	0
4	3474718	.	A	G	7	4	11	0	0	11	0	0
4	3474744	.	A	G	2	4	6	0	0	6	0	0
4	4079716	.	T	C	3	2	5	0	1	6	0	0
4	4090438	.	C	T	4	4	8	0	0	8	0	0
4	4098479	.	T	A	11	12	23	0	0	23	0	0
4	4104264	.	A	G	6	0	6	0	18	25	1	0
4	4106546	.	T	G	12	6	18	0	1	19	0	0
4	4111070	.	A	G	4	9	13	0	2	15	0	0
4	4111180	.	C	T	4	5	9	0	0	9	0	0
4	4111229	.	A	T	13	6	19	0	0	19	0	0
4	4111396	.	T	C	9	10	19	0	0	19	0	0
4	4111673	.	G	A	5	2	7	0	0	7	0	0
4	4117174	.	A	C	1	3	4	0	0	4	0	0
4	4117480	.	T	C	2	3	5	0	0	5	0	0
4	4117730	.	T	C	2	0	2	0	3	5	0	0
4	4117876	.	G	A	1	7	8	0	0	8	0	0
4	4119065	.	C	T	1	2	3	0	1	4	0	0
4	4120825	.	C	T	1	3	4	0	0	4	0	0
4	4120854	.	C	T	1	2	3	0	0	3	0	0
4	4120872	.	A	G	2	4	6	0	0	6	0	0
4	4122652	.	C	T	2	5	7	0	0	7	0	0
4	4122769	.	T	A	1	4	5	0	0	5	0	0
4	4122781	.	G	A	1	4	5	0	0	5	0	0
4	4125111	.	G	A	3	3	6	0	0	6	0	0
4	4125114	.	A	T	4	3	7	0	0	7	0	0
4	4126432	.	C	T	1	3	4	0	0	4	0	0
4	4228518	.	C	A	3	4	7	6	0	13	0	0
4	4232705	.	A	T	1	4	5	0	0	5	0	0
4	4232886	.	C	G	3	0	3	0	3	6	0	0
4	4232994	.	T	C	3	3	6	0	0	6	0	0
4	4233088	.	T	C	2	2	4	0	0	4	0	0
4	4235162	.	A	G	25	21	46	0	3	49	0	0
4	4238175	.	C	T	2	18	20	0	17	37	0	0
4	4240177	.	T	C	16	23	39	0	1	40	0	0
4	4243084	.	G	A	14	31	45	0	1	46	0	0
4	4249690	.	G	A	17	14	31	0	2	33	0	0
4	4258884	.	A	G	17	11	28	0	2	30	0	0
4	4258927	.	T	C	19	15	34	0	0	34	0	0
4	4258951	.	C	T	17	20	37	0	1	38	0	0
4	4290728	.	C	G	6	0	6	0	3	9	0	0
4	4291289	.	A	C	5	4	9	0	0	9	0	0
4	4327793	.	C	T	2	3	5	0	0	5	0	0
4	4331151	.	C	T	4	3	7	0	0	7	0	0
4	4348785	.	C	T	10	5	15	0	1	16	0	0
4	4348902	.	A	G	5	0	5	1	5	11	0	0
4	4355714	.	C	T	5	4	9	0	0	9	0	0
4	4355791	.	G	T	1	12	13	0	7	20	0	0
4	4356757	.	T	G	1	4	5	0	1	6	0	0
4	4357073	.	A	G	10	7	17	0	0	17	0	0
4	4357173	.	C	T	11	6	17	0	1	18	0	0
4	4357175	.	G	A	11	7	18	0	0	18	0	0
4	4358201	.	G	A	1	2	3	5	0	8	0	0
4	4358411	.	T	A	3	14	17	1	0	18	0	0
4	4358471	.	C	T	9	12	21	0	1	22	0	0
4	4358536	.	A	G	10	4	14	0	1	15	0	0
4	4358610	.	C	A	8	9	17	0	0	17	0	0
4	4484788	.	A	G	17	11	28	0	0	28	0	0
4	4484914	.	T	A	19	11	30	0	3	33	0	0
4	4485186	.	A	T	17	25	42	1	4	47	0	0
4	4485247	.	A	T	18	18	36	0	3	39	0	0
4	4485306	.	T	C	14	17	31	0	4	39	4	0
4	4485534	.	C	A	17	19	36	0	0	36	0	0
4	4485650	.	A	T	9	10	19	0	0	19	0	0
4	4485736	.	T	G	23	11	34	0	0	34	0	0
4	4485793	.	C	G	18	10	28	0	0	28	0	0
4	4488137	.	A	G	13	12	25	0	0	25	0	0
4	4488207	.	G	A	9	18	27	0	1	28	0	0
4	4491740	.	T	C	8	0	8	0	9	17	0	0
4	4491782	.	T	C	11	1	12	0	11	23	0	0
4	4492003	.	C	T	11	16	27	0	0	27	0	0
4	4492336	.	A	G	12	13	25	0	1	26	0	0
4	4492369	.	C	A	2	9	11	0	11	22	0	0
4	4492444	.	A	G	12	6	18	0	3	21	0	0
4	4492456	.	T	C	14	0	14	0	8	22	0	0
4	4494733	.	C	A	8	12	20	0	0	20	0	0
4	4495334	.	G	A	11	6	17	0	1	18	0	0
4	4510097	.	A	G	8	0	8	0	6	14	0	0
4	4514215	.	A	G	7	0	7	0	16	23	0	0
4	4516310	.	G	C	1	7	8	0	19	27	0	0
4	4516313	.	A	G	17	0	17	0	10	27	0	0
4	4516346	.	C	T	17	12	29	0	1	30	0	0
4	4519688	.	G	A	12	19	31	0	0	31	0	0
4	4519697	.	T	C	11	18	29	0	0	29	0	0
4	4523403	.	C	G	18	30	48	0	1	49	0	0
4	4523579	.	T	C	22	29	51	0	1	52	0	0
4	4523885	.	A	C	18	16	34	0	0	34	0	0
4	4524215	.	T	A	9	8	17	0	1	18	0	0
4	4526251	.	G	A	5	2	7	0	0	7	0	0
4	4527045	.	A	G	1	3	4	0	0	4	0	0
4	4527870	.	C	T	1	2	3	0	1	4	0	0
4	4528554	.	A	G	1	4	5	0	0	5	0	0
4	4635691	.	C	G	22	17	39	0	0	39	0	0
4	4638701	.	G	C	12	0	12	0	11	23	0	0
4	4640605	.	G	A	19	12	31	0	0	31	0	0
4	4640614	.	G	A	18	12	30	0	0	30	0	0
4	4647977	.	A	G	20	9	29	0	0	29	0	0
4	4653380	.	A	C	17	0	17	0	19	36	0	0
4	4657961	.	G	A	20	11	31	0	1	32	0	0
4	4706687	.	G	T	16	10	26	0	1	27	0	0
4	4706819	.	C	T	3	13	16	0	11	27	0	0
4	4706825	.	C	G	13	13	26	0	0	26	0	0
4	4712951	.	G	A	4	2	6	0	0	6	0	0
4	4713042	.	T	G	1	3	4	0	0	4	0	0
4	4713967	.	T	G	6	3	9	0	0	9	0	0
4	4713982	.	C	G	3	7	10	0	1	11	0	0
4	4751738	.	T	C	3	4	7	0	0	7	0	0
4	4753372	.	T	A	6	6	12	0	1	13	0	0
4	4754474	.	A	G	10	12	22	0	0	22	0	0
4	4755605	.	G	T	5	5	10	1	1	12	0	0
4	4755627	.	G	T	5	7	12	1	0	13	0	0
4	4758089	.	G	A	3	2	5	0	0	5	0	0
4	4758452	.	T	C	2	0	2	0	3	5	0	0
4	4758458	.	A	G	2	2	4	0	0	4	0	0
4	4760581	.	C	T	6	4	10	0	0	10	0	0
4	4762804	.	T	A	6	2	8	0	0	8	0	0
4	4768014	.	G	T	3	2	5	0	1	6	0	0
4	4780448	.	C	T	2	5	7	0	0	7	0	0
4	4782880	.	C	G	1	2	3	0	0	3	0	0
4	4783059	.	A	T	7	6	13	0	3	16	0	0
4	4783067	.	C	T	11	8	19	0	1	20	0	0
4	4784802	.	G	A	6	8	14	0	0	14	0	0
4	4786350	.	A	G	8	4	12	0	0	12	0	0
4	4786383	.	G	A	5	3	8	0	0	8	0	0
4	4786443	.	A	C	2	0	2	0	4	6	0	0
4	4816591	.	C	T	1	2	3	0	0	3	0	0
4	4831630	.	T	G	8	6	14	0	1	15	0	0
4	4831660	.	G	A	8	4	12	0	1	13	0	0
4	4831885	.	A	C	5	6	11	0	2	13	0	0
4	4831898	.	T	C	10	7	17	0	0	17	0	0
4	4831968	.	A	C	6	5	11	0	1	12	0	0
4	4832241	.	A	G	9	9	18	0	1	19	0	0
4	4834125	.	G	A	12	11	23	0	1	24	0	0
4	4834497	.	A	G	18	10	28	0	2	30	0	0
4	4834526	.	T	C	11	8	19	0	2	21	0	0
4	4894486	.	C	A	4	7	11	0	1	12	0	0
4	4901602	.	C	T	8	11	19	0	2	21	0	0
4	4901611	.	T	G	14	1	15	0	7	23	1	0
4	4902137	.	A	C	6	11	17	0	2	19	0	0
4	4902425	.	G	C	13	14	27	0	1	28	0	0
4	4908409	.	C	T	6	8	14	0	2	16	0	0
4	4911071	.	C	T	7	12	19	1	2	22	0	0
4	4911247	.	A	G	13	11	24	0	0	24	0	0
4	4913422	.	C	T	11	9	20	0	0	20	0	0
4	4914832	.	A	G	19	14	33	0	0	33	0	0
4	4921733	.	T	C	16	17	33	0	1	34	0	0
4	4921773	.	G	A	2	20	22	0	17	39	0	0
4	4923290	.	A	T	12	13	25	0	0	25	0	0
4	4923323	.	C	T	17	16	33	0	3	36	0	0
4	4923755	.	T	G	21	13	34	0	0	34	0	0
4	4925611	.	C	T	14	17	31	0	1	32	0	0
4	4926035	.	G	A	8	5	13	0	0	13	0	0
4	4926037	.	G	T	5	6	11	0	3	14	0	0
4	4938966	.	A	T	4	5	9	4	1	14	0	0
4	4938969	.	T	G	4	5	9	4	1	14	0	0
4	4971354	.	C	A	8	5	13	0	0	13	0	0
4	4971707	.	T	C	4	2	6	0	0	6	0	0
4	4971836	.	T	C	5	3	8	0	1	9	0	0
4	4971847	.	T	A	4	3	7	0	2	9	0	0
4	4971911	.	G	T	10	10	20	0	0	20	0	0
4	4971947	.	A	G	12	7	19	0	0	19	0	0
4	4972056	.	C	T	8	7	15	0	0	15	0	0
4	4972533	.	G	A	7	10	17	0	0	17	0	0
4	4972555	.	G	C	4	7	11	0	1	12	0	0
4	4973053	.	G	A	11	8	19	0	0	19	0	0
4	4975329	.	C	G	6	9	15	0	0	15	0	0
4	4975597	.	G	A	3	2	5	0	0	5	0	0
4	4980443	.	G	A	8	5	13	0	0	13	0	0
4	4980458	.	C	T	1	6	7	0	9	16	0	0
4	4983209	.	T	C	3	4	7	0	0	7	0	0
4	4983339	.	T	C	3	2	5	0	0	5	0	0
4	4984298	.	G	A	7	3	10	0	0	10	0	0
4	4985789	.	G	A	5	9	14	0	0	14	0	0
4	4992114	.	A	C	3	2	5	0	0	5	0	0
4	5006535	.	T	C	3	3	6	0	1	7	0	0
4	5006562	.	G	T	2	6	8	0	0	8	0	0
4	5025964	.	G	C	16	11	27	2	2	31	0	0
4	5026355	.	T	C	15	15	30	0	1	31	0	0
4	5042689	.	T	A	25	14	39	0	1	40	0	0
4	5042755	.	C	T	18	16	34	0	3	37	0	0
4	5048903	.	C	T	14	13	27	0	2	29	0	0
4	5094237	.	C	T	3	3	6	0	0	6	0	0
4	5097421	.	C	T	0	7	7	0	2	9	0	0
4	5098152	.	G	A	5	9	14	0	0	14	0	0
4	5098507	.	A	G	4	2	6	0	0	6	0	0
4	5102316	.	A	C	5	0	5	0	6	11	0	0
4	5104859	.	G	A	2	3	5	0	0	5	0	0
4	5149638	.	A	G	1	2	3	0	0	3	0	0
4	5158749	.	C	T	13	10	23	0	1	24	0	0
4	5161241	.	G	T	4	12	16	0	1	17	0	0
4	5161256	.	A	C	2	12	14	0	1	15	0	0
4	5181042	.	C	T	1	4	5	0	0	5	0	0
4	5240203	.	A	C	21	2	23	0	22	46	1	0
4	5240265	.	C	T	26	16	42	3	2	47	0	0
4	5240472	.	T	A	26	30	56	1	1	58	0	0
4	5240505	.	A	G	31	21	52	1	1	54	0	0
4	5242055	.	T	G	17	28	45	0	2	47	0	0
4	5242300	.	C	G	45	22	67	0	0	67	0	0
4	5243657	.	C	A	23	43	66	0	3	69	0	0
4	5244568	.	C	A	25	30	55	0	4	59	0	0
4	5244789	.	G	A	30	29	59	0	0	59	0	0
4	5247107	.	G	A	26	22	48	0	3	51	0	0
4	5247127	.	G	C	27	22	49	0	1	50	0	0
4	5247145	.	C	T	2	27	29	0	26	55	0	0
4	5255128	.	C	A	16	11	27	1	0	29	1	0
4	5255148	.	C	T	13	17	30	1	2	33	0	0
4	5255180	.	T	C	18	16	34	0	4	38	0	0
4	5256482	.	A	G	19	12	31	0	0	31	0	0
4	5256659	.	A	G	7	0	7	0	10	17	0	0
4	5256674	.	G	T	12	5	17	0	0	17	0	0
4	5256737	.	A	G	4	4	8	0	1	9	0	0
4	5269608	.	G	A	27	26	53	0	3	56	0	0
4	5269660	.	C	G	37	30	67	0	0	67	0	0
4	5290944	.	G	A	23	20	43	0	1	44	0	0
4	5290947	.	C	T	21	20	41	0	0	41	0	0
4	5291755	.	T	C	23	24	47	0	1	48	0	0
4	5291794	.	T	C	22	23	45	0	1	46	0	0
4	5302127	.	C	T	3	20	23	0	17	40	0	0
4	5302195	.	A	G	23	17	40	0	1	41	0	0
4	5302327	.	G	A	21	18	39	0	0	39	0	0
4	5302689	.	G	A	9	13	22	0	2	24	0	0
4	5318995	.	G	A	15	9	24	0	4	28	0	0
4	5324871	.	G	T	9	15	24	0	0	24	0	0
4	5325105	.	C	T	13	9	22	0	0	22	0	0
4	5329849	.	G	A	6	11	17	0	0	17	0	0
4	5329850	.	G	A	11	6	17	0	0	17	0	0
4	5330192	.	C	A	7	10	17	0	0	17	0	0
4	5330341	.	C	T	8	7	15	0	1	16	0	0
4	5331720	.	G	A	6	9	15	0	1	16	0	0
4	5334029	.	G	C	4	9	13	0	0	13	0	0
4	5334061	.	G	A	11	11	22	0	1	23	0	0
4	5338909	.	T	A	7	6	13	2	3	22	4	0
4	5338950	.	G	T	9	10	19	0	2	21	0	0
4	5339053	.	T	A	12	12	24	0	1	25	0	0
4	5349894	.	C	T	1	6	7	0	1	8	0	0
4	5360934	.	G	A	0	2	2	0	4	6	0	0
4	5360970	.	A	G	4	2	6	0	0	6	0	0
4	5363600	.	G	C	2	4	6	0	0	6	0	0
4	5363697	.	T	G	1	2	3	0	0	3	0	0
4	5363744	.	A	C	2	2	4	0	0	4	0	0
4	5363760	.	A	T	4	2	6	0	0	6	0	0
4	5363836	.	G	A	2	4	6	0	0	6	0	0
4	5364430	.	A	T	3	2	5	0	0	5	0	0
4	5364433	.	A	G	3	3	6	0	0	6	0	0
4	5365399	.	G	A	3	3	6	0	0	6	0	0
4	5366080	.	A	G	3	3	6	1	0	7	0	0
4	5366462	.	C	G	3	3	6	0	0	6	0	0
4	5367558	.	A	T	1	2	3	0	0	3	0	0
4	5370090	.	C	T	2	2	4	0	0	4	0	0
4	5370156	.	A	T	1	3	4	0	0	4	0	0
4	5398370	.	A	G	1	0	1	0	2	3	0	0
4	5421883	.	A	C	2	1	3	0	2	5	0	0
4	5421895	.	T	G	1	2	3	0	0	3	0	0
4	5424148	.	G	C	1	2	3	0	0	3	0	0
4	5515160	.	T	G	2	2	4	0	0	4	0	0
4	5515184	.	G	A	0	5	5	0	2	7	0	0
4	5521510	.	C	T	10	16	26	0	2	28	0	0
4	5521996	.	G	T	25	12	37	0	0	37	0	0
4	5522154	.	G	T	23	10	33	0	0	33	0	0
4	5522161	.	C	T	9	23	32	0	1	33	0	0
4	5522298	.	C	A	4	5	9	0	0	9	0	0
4	5524020	.	T	C	2	3	5	0	0	5	0	0
4	5529131	.	T	C	3	2	5	0	0	5	0	0
4	5595171	.	C	T	3	3	6	0	0	6	0	0
4	5597772	.	T	C	5	2	7	0	0	7	0	0
4	5643321	.	G	A	15	12	27	0	0	27	0	0
4	5644808	.	G	A	17	18	35	0	1	36	0	0
4	5644974	.	G	A	9	6	15	0	0	15	0	0
4	5645097	.	C	T	3	3	6	0	0	6	0	0
4	5645116	.	T	G	2	2	4	0	0	4	0	0
4	5645340	.	C	T	1	2	3	0	0	3	0	0
4	5665612	.	T	C	3	0	3	0	10	13	0	0
4	5665912	.	T	C	3	0	3	0	5	8	0	0
4	5672765	.	G	A	2	2	4	0	0	4	0	0
4	5683456	.	G	T	1	3	4	0	0	4	0	0
4	5742551	.	G	A	13	16	29	0	0	29	0	0
4	5742831	.	A	C	14	19	33	0	2	35	0	0
4	5742846	.	C	T	22	13	35	0	0	35	0	0
4	5742936	.	G	A	1	16	17	0	24	41	0	0
4	5742962	.	A	T	21	13	34	0	0	34	0	0
4	5743027	.	A	G	11	10	21	0	1	22	0	0
4	5750854	.	G	A	17	9	26	0	0	26	0	0
4	5750884	.	T	A	13	12	25	0	1	26	0	0
4	5750924	.	A	G	15	7	22	0	0	22	0	0
4	5751381	.	A	C	16	14	30	0	1	31	0	0
4	5751382	.	C	T	1	14	15	0	16	31	0	0
4	5751551	.	G	A	10	8	18	0	2	20	0	0
4	5755018	.	C	T	3	18	21	0	8	29	0	0
4	5755027	.	C	T	2	11	13	0	15	28	0	0
4	5757253	.	C	T	12	11	23	1	2	26	0	0
4	5759617	.	T	G	14	11	25	0	1	26	0	0
4	5763975	.	G	A	21	14	35	0	0	35	0	0
4	5764128	.	T	A	14	18	32	1	3	36	0	0
4	5765183	.	C	T	1	5	6	0	0	6	0	0
4	5765247	.	A	G	2	2	4	0	0	4	0	0
4	5765529	.	T	G	2	2	4	0	0	4	0	0
4	5765985	.	C	A	4	4	8	0	0	8	0	0
4	5766156	.	C	T	0	6	6	0	3	9	0	0
4	5766200	.	T	A	5	8	13	0	0	13	0	0
4	5766315	.	G	A	8	4	12	2	0	14	0	0
4	5769036	.	T	C	4	7	11	0	0	11	0	0
4	5785957	.	G	T	1	2	3	0	0	3	0	0
4	5786267	.	G	T	3	2	5	0	1	6	0	0
4	5790438	.	C	A	2	2	4	0	0	4	0	0
4	5794344	.	C	T	3	4	7	0	0	7	0	0
4	5806252	.	T	A	2	2	4	0	0	4	0	0
4	5806312	.	C	A	1	4	5	0	0	5	0	0
4	5807072	.	A	T	1	2	3	0	0	3	0	0
4	5834198	.	G	A	2	2	4	0	0	4	0	0
4	5835612	.	C	T	4	5	9	0	3	12	0	0
4	5835635	.	G	A	6	5	11	0	1	12	0	0
4	5835688	.	T	G	3	4	7	0	1	8	0	0
4	5835733	.	G	A	5	2	7	0	0	7	0	0
4	5838505	.	G	A	4	5	9	0	0	9	0	0
4	5849003	.	C	A	13	13	26	0	1	27	0	0
4	5849180	.	A	G	8	0	8	0	6	14	0	0
4	5849225	.	G	A	10	7	17	0	0	17	0	0
4	5849368	.	A	G	4	4	8	0	2	10	0	0
4	5849373	.	C	T	6	5	11	0	0	11	0	0
4	5849408	.	A	G	4	2	6	0	0	6	0	0
4	5849659	.	C	A	0	4	4	1	0	5	0	0
4	5849676	.	A	C	4	3	7	1	1	9	0	0
4	5850061	.	A	T	4	2	6	0	0	6	0	0
4	5850169	.	T	C	10	4	14	0	0	14	0	0
4	5850281	.	T	C	9	12	21	0	1	22	0	0
4	5850297	.	A	G	8	13	21	0	2	23	0	0
4	5850800	.	C	T	2	2	4	0	0	4	0	0
4	5851019	.	G	A	3	3	6	0	1	7	0	0
4	5895687	.	G	A	1	2	3	0	0	3	0	0
4	5905677	.	C	T	1	2	3	0	0	3	0	0
4	5907100	.	C	T	3	3	6	0	0	6	0	0
4	5907465	.	G	T	0	3	3	0	4	7	0	0
4	5908763	.	T	C	7	3	10	0	1	11	0	0
4	5908764	.	C	T	7	4	11	0	0	11	0	0
4	5910302	.	C	T	3	7	10	0	0	10	0	0
4	5910492	.	A	G	12	5	17	1	13	31	0	0
4	5910644	.	G	A	20	22	42	0	1	43	0	0
4	5912445	.	C	T	19	13	32	0	3	35	0	0
4	5912475	.	G	A	19	11	30	0	2	32	0	0
4	5912707	.	A	G	22	18	40	0	0	40	0	0
4	6341420	.	G	C	1	2	3	0	0	3	0	0
4	6432112	.	G	A	9	19	28	0	1	29	0	0
4	6449366	.	G	A	9	10	19	0	0	19	0	0
4	6455849	.	G	A	11	6	17	0	1	18	0	0
4	6508382	.	G	C	5	3	8	0	0	8	0	0
4	6567410	.	A	C	1	3	4	0	0	4	0	0
4	6578358	.	G	A	1	1	2	0	0	2	0	0
4	6579308	.	G	A	0	2	2	0	1	3	0	0
4	6579654	.	G	C	2	2	4	0	0	4	0	0
4	6639440	.	A	G	20	6	26	0	2	28	0	0
4	6639665	.	G	A	15	21	36	0	2	38	0	0
4	6639786	.	C	T	14	12	26	0	0	26	0	0
4	6640145	.	G	C	14	11	25	0	1	26	0	0
4	6640156	.	T	C	13	12	25	0	1	26	0	0
4	6640342	.	C	A	1	3	4	0	0	4	0	0
4	6645994	.	C	T	9	9	18	0	2	20	0	0
4	6646283	.	A	C	9	13	22	0	1	23	0	0
4	6646851	.	G	A	15	10	25	0	0	25	0	0
4	6737471	.	C	T	2	2	4	0	0	4	0	0
4	6749054	.	T	C	7	4	11	0	0	11	0	0
4	6749060	.	C	G	5	4	9	0	0	9	0	0
4	6799942	.	A	G	22	22	44	0	3	47	0	0
4	6800153	.	T	C	18	25	43	0	0	43	0	0
4	6800162	.	C	T	17	24	41	0	0	41	0	0
4	6800393	.	G	A	28	23	51	0	2	53	0	0
4	6802173	.	T	G	24	19	43	0	1	44	0	0
4	6802506	.	A	C	26	17	43	0	0	43	0	0
4	6802518	.	C	G	2	17	19	0	23	42	0	0
4	6877975	.	T	C	2	4	6	0	0	6	0	0
4	6880306	.	C	T	2	2	4	0	0	4	0	0
4	6884753	.	C	T	1	6	7	0	0	7	0	0
4	6909858	.	G	A	1	6	7	0	0	7	0	0
4	6925881	.	C	A	3	2	5	0	0	5	0	0
4	6940374	.	C	T	8	4	12	0	0	12	0	0
4	6946608	.	C	T	7	6	13	0	0	13	0	0
4	6946831	.	G	A	13	8	21	0	1	22	0	0
4	6960365	.	G	A	2	4	6	0	8	14	0	0
4	6960377	.	C	T	9	5	14	0	1	15	0	0
4	6990096	.	C	T	17	8	25	0	0	25	0	0
4	6990392	.	G	T	3	2	5	0	1	6	0	0
4	6990421	.	T	C	4	2	6	0	0	6	0	0
4	6990682	.	G	A	5	8	13	0	0	13	0	0
4	6990882	.	C	T	11	13	24	0	0	24	0	0
4	6990886	.	C	A	13	8	21	0	2	23	0	0
4	6991220	.	T	A	6	7	13	0	0	13	0	0
4	6991272	.	G	A	8	5	13	0	1	14	0	0
4	6991764	.	G	T	7	8	15	0	3	18	0	0
4	6992264	.	G	T	10	16	26	0	1	27	0	0
4	6992744	.	C	T	15	9	24	0	0	24	0	0
4	6992918	.	G	C	9	9	18	0	0	18	0	0
4	7211013	.	G	A	21	16	37	0	2	39	0	0
4	7211097	.	C	T	18	19	37	0	0	37	0	0
4	7211264	.	A	G	19	19	38	0	2	40	0	0
4	7211364	.	C	T	2	15	17	0	13	30	0	0
4	7212228	.	G	A	11	9	20	0	0	20	0	0
4	7212236	.	G	A	10	8	18	0	0	18	0	0
4	7212342	.	G	A	5	13	18	0	0	18	0	0
4	7212461	.	G	A	15	8	23	0	0	23	0	0
4	7212606	.	A	G	17	11	28	0	1	29	0	0
4	7212624	.	G	A	12	15	27	0	1	28	0	0
4	7222118	.	G	T	4	6	10	0	0	10	0	0
4	7465914	.	T	C	4	3	7	0	1	8	0	0
4	7471682	.	A	T	3	5	8	0	0	8	0	0
4	7476736	.	C	T	5	7	12	0	0	12	0	0
4	7480023	.	A	T	1	2	3	0	0	3	0	0
4	7546046	.	T	A	8	10	18	0	1	19	0	0
4	7549361	.	G	A	0	5	5	0	1	6	0	0
4	7653887	.	C	T	7	3	10	0	0	10	0	0
4	7659049	.	C	T	6	6	12	0	0	12	0	0
4	7659924	.	G	A	1	5	6	0	0	6	0	0
4	7664811	.	G	A	3	4	7	0	0	7	0	0
4	7665110	.	T	A	4	4	8	0	0	8	0	0
4	7666604	.	A	C	2	0	2	0	5	7	0	0
4	7668432	.	G	A	3	5	8	0	0	8	0	0
4	7668510	.	A	G	4	3	7	0	0	7	0	0
4	7668516	.	G	A	4	3	7	0	0	7	0	0
4	7698971	.	G	A	4	4	8	0	1	9	0	0
4	7713041	.	A	G	6	1	7	0	5	12	0	0
4	7713070	.	T	C	4	4	8	0	0	8	0	0
4	7713127	.	C	T	2	3	5	1	0	6	0	0
4	7713176	.	C	T	4	8	12	0	1	13	0	0
4	7713360	.	C	A	2	2	4	0	1	5	0	0
4	7713513	.	G	A	2	3	5	0	1	6	0	0
4	7713538	.	G	T	1	3	4	0	0	4	0	0
4	7713549	.	C	T	1	2	3	0	0	3	0	0
4	7718868	.	C	T	16	15	31	0	2	33	0	0
4	7726665	.	G	A	7	9	16	0	0	16	0	0
4	7726752	.	T	C	6	9	15	0	0	15	0	0
4	7729807	.	G	A	10	9	19	0	0	19	0	0
4	7737468	.	G	T	11	6	17	0	0	17	0	0
4	7743092	.	C	T	1	6	7	0	8	15	0	0
4	7836176	.	A	G	23	8	31	0	0	31	0	0
4	7870444	.	A	T	3	4	7	0	0	7	0	0
4	7870599	.	T	C	5	2	7	0	0	7	0	0
4	7870913	.	T	G	7	7	14	0	1	15	0	0
4	7870952	.	C	T	1	7	8	0	7	15	0	0
4	7870983	.	C	T	5	5	10	0	1	11	0	0
4	7871084	.	A	C	11	9	20	0	0	20	0	0
4	7872229	.	A	G	13	5	18	0	1	19	0	0
4	7872637	.	G	A	8	6	14	0	0	14	0	0
4	7875702	.	A	T	3	9	12	0	0	12	0	0
4	7876796	.	C	A	2	5	7	0	1	8	0	0
4	7879522	.	A	G	1	1	2	0	11	13	0	0
4	7881534	.	C	G	8	0	8	0	13	21	0	0
4	7883462	.	A	C	8	6	14	0	0	14	0	0
4	7883466	.	G	A	8	5	13	0	0	13	0	0
4	7888181	.	A	C	6	4	10	0	1	11	0	0
4	7943958	.	C	T	3	5	8	0	0	8	0	0
4	7959162	.	T	C	4	3	7	0	0	7	0	0
4	7981870	.	A	C	0	0	0	0	5	5	0	0
4	7981872	.	A	C	0	1	1	0	3	4	0	0
4	8609609	.	T	A	5	1	6	0	2	8	0	0
4	8609620	.	A	T	7	5	12	0	0	12	0	0
4	8609648	.	G	A	5	7	12	0	1	13	0	0
4	8609799	.	T	C	19	9	28	0	1	29	0	0
4	8662255	.	C	T	1	2	3	0	0	3	0	0
4	8680965	.	C	T	7	17	24	0	1	25	0	0
4	8681039	.	C	T	8	7	15	0	0	15	0	0
4	8697245	.	C	T	6	6	12	0	0	13	1	0
4	8697269	.	A	G	4	4	8	0	1	9	0	0
4	8702687	.	G	A	8	8	16	0	0	16	0	0
4	8702729	.	C	A	14	7	21	0	0	21	0	0
4	8702765	.	C	T	8	13	21	0	0	21	0	0
4	8704655	.	C	T	2	9	11	0	1	12	0	0
4	8706385	.	G	A	12	7	19	0	0	19	0	0
4	8706412	.	G	T	9	8	17	0	1	18	0	0
4	8706716	.	A	G	10	10	20	0	1	21	0	0
4	8706855	.	A	T	4	7	11	0	1	12	0	0
4	8707154	.	C	T	9	8	17	0	0	17	0	0
4	8707182	.	T	C	13	6	19	0	1	20	0	0
4	8707381	.	A	G	3	5	8	0	0	8	0	0
4	8755661	.	G	C	5	4	9	0	0	9	0	0
4	8781919	.	T	A	1	3	4	0	0	4	0	0
4	8797201	.	T	A	30	23	53	0	1	54	0	0
4	8797234	.	T	A	30	20	50	0	1	51	0	0
4	8797315	.	T	C	24	22	46	0	3	49	0	0
4	8803071	.	C	T	19	21	40	0	2	42	0	0
4	8805792	.	T	C	30	28	58	0	2	60	0	0
4	8808775	.	C	T	38	37	75	0	7	82	0	0
4	8808823	.	C	T	40	24	64	0	4	68	0	0
4	8808974	.	C	T	31	16	47	0	1	48	0	0
4	8809268	.	T	G	33	14	47	0	0	47	0	0
4	8809431	.	T	G	7	14	21	0	2	23	0	0
4	8809444	.	T	G	16	9	25	0	0	25	0	0
4	8809506	.	A	T	18	14	32	0	3	35	0	0
4	8809544	.	C	G	20	2	22	0	25	47	0	0
4	8809690	.	G	T	0	17	17	0	1	18	0	0
4	8809695	.	C	T	0	23	23	0	1	24	0	0
4	8809879	.	T	G	12	7	19	0	2	21	0	0
4	8809985	.	G	T	23	7	30	0	0	30	0	0
4	8810200	.	G	T	20	14	34	0	1	35	0	0
4	8810367	.	A	C	32	15	47	0	1	49	1	0
4	8810474	.	A	T	27	18	45	0	0	45	0	0
4	8810597	.	A	T	23	9	32	0	3	35	0	0
4	8810607	.	C	T	18	8	26	0	1	28	1	0
4	8850984	.	A	G	9	1	10	1	1	12	0	0
4	8851503	.	T	A	13	11	24	1	0	25	0	0
4	8851547	.	A	G	11	17	28	0	2	30	0	0
4	8851740	.	G	A	14	9	23	0	1	24	0	0
4	8851864	.	G	A	10	7	17	0	1	18	0	0
4	8851999	.	C	T	12	13	25	0	0	25	0	0
4	8852085	.	G	T	8	12	20	0	1	21	0	0
4	8854403	.	G	T	21	14	35	0	1	36	0	0
4	8857562	.	T	G	9	13	22	0	1	24	1	0
4	8882297	.	G	T	13	12	25	0	1	26	0	0
4	8898917	.	C	T	1	13	14	0	13	27	0	0
4	8898939	.	G	A	13	9	22	0	1	23	0	0
4	8903051	.	T	A	14	7	21	0	0	21	0	0
4	8909871	.	A	C	2	0	2	0	3	5	0	0
4	8912701	.	T	C	2	0	2	0	2	4	0	0
4	9012215	.	T	G	13	1	14	0	11	25	0	0
4	9012218	.	T	C	12	11	23	0	0	23	0	0
4	9012258	.	A	T	7	8	15	0	1	16	0	0
4	9017996	.	C	T	7	7	14	0	1	15	0	0
4	9021166	.	T	G	9	9	18	0	1	19	0	0
4	9021369	.	T	C	14	6	20	0	1	21	0	0
4	9024665	.	T	G	16	9	25	0	0	25	0	0
4	9024671	.	A	G	16	9	25	0	0	25	0	0
4	9024720	.	A	C	15	9	24	0	0	24	0	0
4	9024784	.	A	G	12	15	27	0	2	29	0	0
4	9024807	.	A	G	10	13	23	0	3	26	0	0
4	9028868	.	T	C	2	2	4	0	0	4	0	0
4	9045012	.	T	C	5	3	8	0	0	8	0	0
4	9045979	.	C	T	6	5	11	0	0	11	0	0
4	9047365	.	C	T	3	2	5	0	0	5	0	0
4	9048957	.	G	T	3	3	6	0	0	6	0	0
4	9052184	.	A	G	6	1	7	0	0	7	0	0
4	9052192	.	T	A	6	2	8	0	0	8	0	0
4	9052228	.	C	G	0	5	5	0	4	9	0	0
4	9070929	.	T	G	3	5	8	0	0	8	0	0
4	9085337	.	A	G	7	0	7	0	7	14	0	0
4	9094270	.	G	T	4	7	11	0	1	12	0	0
4	9094347	.	G	A	3	5	8	0	0	8	0	0
4	9094666	.	T	G	6	3	9	0	0	9	0	0
4	9094668	.	T	A	6	3	9	0	0	9	0	0
4	9104173	.	G	C	5	3	8	0	1	9	0	0
4	9104510	.	T	C	9	0	9	0	8	17	0	0
4	9105199	.	T	C	5	0	5	0	8	13	0	0
4	9128095	.	T	C	8	0	8	1	7	16	0	0
4	9173425	.	A	G	5	7	12	0	0	12	0	0
4	9173514	.	T	C	3	6	9	0	0	9	0	0
4	9180680	.	G	A	10	13	23	0	1	24	0	0
4	9180746	.	T	C	13	17	30	0	1	31	0	0
4	9183115	.	T	A	20	11	31	0	0	31	0	0
4	9192444	.	G	A	5	3	8	0	0	8	0	0
4	9195006	.	A	G	7	3	10	0	0	10	0	0
4	9196128	.	C	G	0	2	2	0	1	3	0	0
4	9208383	.	A	G	3	3	6	0	0	6	0	0
4	9208978	.	G	A	1	2	3	0	0	3	0	0
4	9209561	.	T	G	3	3	6	0	0	6	0	0
4	9209562	.	G	T	3	3	6	0	0	6	0	0
4	9209966	.	G	A	1	2	3	0	0	3	0	0
4	9209973	.	C	G	0	2	2	0	1	3	0	0
4	9210013	.	C	G	2	2	4	0	0	4	0	0
4	9280030	.	C	T	2	4	6	0	0	6	0	0
4	9280059	.	T	A	2	3	5	0	0	5	0	0
4	9308224	.	C	T	1	6	7	0	0	7	0	0
4	9308332	.	C	T	4	2	6	0	1	7	0	0
4	9308344	.	G	A	4	2	6	0	1	7	0	0
4	9317959	.	T	C	1	5	6	0	0	6	0	0
4	9329819	.	T	A	6	11	17	0	1	18	0	0
4	9329912	.	C	A	7	6	13	0	0	13	0	0
4	9331330	.	G	A	2	7	9	0	9	18	0	0
4	9331495	.	T	G	12	1	13	0	9	22	0	0
4	9333448	.	C	T	6	10	16	1	1	18	0	0
4	9333565	.	G	A	0	7	7	0	20	27	0	0
4	9333739	.	A	C	10	16	26	0	4	30	0	0
4	9334180	.	G	C	2	9	11	0	7	18	0	0
4	9334196	.	A	G	7	7	14	0	1	15	0	0
4	9334735	.	A	G	11	0	11	0	10	21	0	0
4	9339140	.	G	A	4	6	10	0	0	10	0	0
4	9339202	.	G	A	7	3	10	0	0	10	0	0
4	9339274	.	C	T	3	4	7	0	0	7	0	0
4	9339316	.	C	T	1	6	7	0	2	9	0	0
4	9339637	.	C	T	0	5	5	0	3	8	0	0
4	9339964	.	T	C	5	0	5	0	4	9	0	0
4	9364314	.	A	G	0	0	0	0	5	5	0	0
4	9364317	.	C	T	2	4	6	0	0	6	0	0
4	9366498	.	C	T	2	2	4	0	0	4	0	0
4	9376859	.	A	G	3	0	3	0	8	11	0	0
4	9385390	.	A	G	12	0	12	0	12	24	0	0
4	9386108	.	C	T	9	6	15	0	0	15	0	0
4	9388890	.	C	T	8	5	13	0	0	13	0	0
4	9389003	.	A	C	5	2	7	0	1	8	0	0
4	9389112	.	G	A	3	4	7	0	0	7	0	0
4	9429583	.	A	T	4	2	6	0	0	6	0	0
4	9429769	.	G	A	5	4	9	0	0	9	0	0
4	9446126	.	C	G	4	7	11	0	0	11	0	0
4	9447758	.	C	T	5	4	9	0	0	9	0	0
4	9448634	.	G	A	1	4	5	0	0	5	0	0
4	9448643	.	G	T	3	3	6	0	1	7	0	0
4	9460213	.	A	G	11	0	11	0	8	19	0	0
4	9460603	.	A	C	6	4	10	0	1	11	0	0
4	9461286	.	T	C	5	2	7	0	0	7	0	0
4	9461625	.	T	A	1	2	3	0	0	3	0	0
4	9461739	.	G	C	4	2	6	0	1	7	0	0
4	9461782	.	T	G	2	2	4	0	0	4	0	0
4	9461822	.	C	A	5	2	7	0	0	7	0	0
4	9461839	.	C	A	6	2	8	0	1	9	0	0
4	9461946	.	T	A	7	6	13	0	0	13	0	0
4	9462039	.	T	G	4	5	9	0	0	9	0	0
4	9462897	.	A	G	5	0	5	0	5	10	0	0
4	9463604	.	C	A	1	3	4	0	0	4	0	0
4	9463634	.	T	G	4	2	6	0	0	6	0	0
4	9463840	.	C	G	6	6	12	0	0	12	0	0
4	9463855	.	T	A	8	6	14	0	0	14	0	0
4	9464143	.	T	G	6	3	9	0	1	10	0	0
4	9464224	.	T	C	2	2	4	0	1	5	0	0
4	9465637	.	A	G	4	3	7	0	0	7	0	0
4	9465832	.	G	T	6	12	18	0	0	18	0	0
4	9465899	.	C	A	9	11	20	0	0	20	0	0
4	9465900	.	C	A	7	11	18	0	1	19	0	0
4	9466075	.	G	T	7	10	17	0	1	18	0	0
4	9466192	.	C	A	3	3	6	0	0	6	0	0
4	9495749	.	C	G	4	7	11	0	0	11	0	0
4	9496926	.	C	T	7	5	12	0	0	12	0	0
4	9496934	.	G	A	7	5	12	0	0	12	0	0
4	9496969	.	A	T	2	4	6	0	0	6	0	0
4	9496976	.	C	G	2	4	6	0	0	6	0	0
4	9498803	.	C	A	1	3	4	0	0	4	0	0
4	9498886	.	G	C	3	8	11	0	0	11	0	0
4	9499404	.	G	A	7	2	9	0	0	9	0	0
4	9500311	.	A	T	6	2	8	0	0	8	0	0
4	9500312	.	G	T	5	2	7	0	0	7	0	0
4	9500370	.	G	A	10	5	15	0	0	15	0	0
4	9502243	.	G	T	12	6	18	0	1	19	0	0
4	9502312	.	T	A	11	5	16	0	0	16	0	0
4	9502347	.	C	G	4	1	5	0	9	14	0	0
4	9502388	.	T	C	7	6	13	0	0	13	0	0
4	9502422	.	G	A	7	6	13	0	2	15	0	0
4	9502440	.	A	G	9	0	9	0	9	18	0	0
4	9502608	.	T	G	7	0	7	0	7	14	0	0
4	9537015	.	A	G	11	15	26	0	1	27	0	0
4	9537025	.	C	T	9	19	28	0	2	30	0	0
4	9549369	.	C	T	1	3	4	0	0	4	0	0
4	9560129	.	C	T	2	7	9	0	0	9	0	0
4	9562957	.	G	T	7	6	13	0	1	14	0	0
4	9565450	.	C	T	0	3	3	0	4	7	0	0
4	9573368	.	G	A	2	5	7	0	0	7	0	0
4	9579297	.	C	G	3	5	8	0	2	10	0	0
4	9592782	.	A	T	8	6	14	0	1	15	0	0
4	9593832	.	C	A	2	2	4	0	1	5	0	0
4	9596614	.	A	G	9	7	16	0	1	17	0	0
4	9597837	.	G	A	3	6	9	0	2	11	0	0
4	9597862	.	G	A	3	8	11	0	0	11	0	0
4	9598642	.	C	T	6	5	11	0	0	11	0	0
4	9598690	.	C	T	9	7	16	0	3	19	0	0
4	9599566	.	G	A	13	9	22	0	3	25	0	0
4	9601158	.	C	T	10	8	18	0	0	18	0	0
4	9601174	.	T	C	9	8	17	0	0	17	0	0
4	9601256	.	A	C	4	8	12	0	0	12	0	0
4	9601401	.	A	T	9	10	19	0	1	20	0	0
4	9601628	.	G	T	4	6	10	0	0	10	0	0
4	9603559	.	G	A	3	2	5	0	0	5	0	0
4	9603589	.	G	A	2	3	5	0	0	5	0	0
4	9603791	.	G	A	9	7	16	0	1	17	0	0
4	9603803	.	G	A	7	7	14	0	0	14	0	0
4	9604134	.	G	A	5	11	16	0	0	16	0	0
4	9604294	.	C	T	1	5	6	0	9	15	0	0
4	9604336	.	T	C	6	1	7	0	9	16	0	0
4	9604384	.	A	G	11	6	17	0	0	17	0	0
4	9605221	.	C	T	0	6	6	0	3	9	0	0
4	9605397	.	A	G	15	6	21	0	1	22	0	0
4	9607259	.	A	G	2	4	6	0	1	7	0	0
4	9616190	.	A	G	6	9	15	0	0	15	0	0
4	9618432	.	A	G	6	12	18	0	1	19	0	0
4	9618867	.	A	C	9	5	14	0	1	15	0	0
4	9632179	.	A	G	5	0	5	2	2	9	0	0
4	9632188	.	C	A	4	2	6	1	0	7	0	0
4	9653570	.	A	G	4	5	9	0	0	9	0	0
4	9653574	.	C	A	0	5	5	0	4	9	0	0
4	9653626	.	G	A	4	2	6	0	1	7	0	0
4	9653925	.	T	G	5	5	10	0	0	10	0	0
4	9654020	.	T	A	5	6	11	0	2	13	0	0
4	9654071	.	T	C	10	5	15	0	0	15	0	0
4	9654103	.	A	G	11	9	20	0	0	20	0	0
4	9654114	.	C	T	1	8	9	0	12	21	0	0
4	9654149	.	C	G	14	10	24	0	1	25	0	0
4	9655534	.	T	C	7	0	7	0	7	14	0	0
4	9655807	.	G	A	12	6	18	0	0	18	0	0
4	9659858	.	G	A	6	4	10	0	0	10	0	0
4	9661253	.	A	T	8	4	12	0	2	14	0	0
4	9661625	.	T	A	5	4	9	0	1	10	0	0
4	9664900	.	G	A	6	3	9	0	0	9	0	0
4	9669846	.	A	T	13	4	17	0	0	17	0	0
4	9669869	.	C	T	14	5	19	0	1	20	0	0
4	9674206	.	G	A	6	7	13	0	0	13	0	0
4	9675420	.	G	A	0	5	5	0	10	15	0	0
4	9677280	.	G	C	8	11	19	0	0	19	0	0
4	9677319	.	T	C	14	11	25	0	1	26	0	0
4	9686153	.	A	G	12	0	12	0	14	26	0	0
4	9688093	.	T	C	14	14	28	0	2	30	0	0
4	9688570	.	C	T	19	16	35	0	4	39	0	0
4	9688636	.	G	A	15	16	31	0	0	31	0	0
4	9689825	.	G	A	1	19	20	0	28	48	0	0
4	9697599	.	C	A	9	10	19	0	0	19	0	0
4	9697763	.	A	C	6	7	13	0	0	13	0	0
4	9697813	.	C	T	4	5	9	0	0	9	0	0
4	9698023	.	C	T	11	15	26	0	0	26	0	0
4	9724441	.	A	G	6	6	12	0	1	13	0	0
4	9724635	.	T	A	12	14	26	0	2	28	0	0
4	9724644	.	C	T	10	12	22	0	2	24	0	0
4	9724718	.	C	A	6	16	22	0	0	22	0	0
4	9724898	.	A	G	20	10	30	0	0	30	0	0
4	9736186	.	A	G	17	12	29	0	0	29	0	0
4	9736211	.	C	T	10	6	16	0	1	17	0	0
4	9737157	.	G	T	12	8	20	0	0	20	0	0
4	9737314	.	A	C	10	0	10	0	16	26	0	0
4	9739228	.	C	A	1	4	5	0	1	6	0	0
4	9740769	.	G	A	15	12	27	1	0	28	0	0
4	9743762	.	T	G	5	7	12	0	0	12	0	0
4	9743774	.	C	T	3	9	12	0	0	12	0	0
4	9744561	.	A	T	3	4	7	0	0	7	0	0
4	9746515	.	A	G	8	7	15	0	0	15	0	0
4	9746547	.	C	T	10	4	14	0	1	15	0	0
4	9746559	.	C	A	10	6	16	0	2	18	0	0
4	9746604	.	G	A	6	6	12	0	0	12	0	0
4	9747209	.	C	G	2	6	8	0	6	14	0	0
4	9747647	.	C	T	6	4	10	0	0	10	0	0
4	9750109	.	G	T	9	9	18	0	0	18	0	0
4	9750154	.	T	G	10	4	14	0	0	14	0	0
4	9751050	.	A	G	7	4	11	0	1	12	0	0
4	9751310	.	T	G	2	8	10	0	1	11	0	0
4	9753200	.	A	G	8	6	14	0	0	14	0	0
4	9755341	.	G	A	8	7	15	0	0	15	0	0
4	9755350	.	G	A	8	5	13	0	1	14	0	0
4	9756488	.	G	T	4	5	9	0	1	10	0	0
4	9758862	.	C	A	0	6	6	0	6	12	0	0
4	9764703	.	G	A	5	2	7	0	1	8	0	0
4	9784331	.	T	A	8	9	17	0	0	17	0	0
4	9784444	.	C	T	8	5	13	0	1	14	0	0
4	9784669	.	G	A	14	5	19	0	0	19	0	0
4	9784678	.	C	T	0	3	3	0	16	19	0	0
4	9784740	.	A	G	10	6	16	0	0	16	0	0
4	9784747	.	T	A	8	6	14	0	1	15	0	0
4	9785900	.	T	A	9	7	16	0	1	17	0	0
4	9786203	.	A	G	8	16	24	0	0	24	0	0
4	9786338	.	T	A	12	8	20	0	0	20	0	0
4	9786466	.	C	G	0	5	5	0	10	15	0	0
4	9786514	.	C	T	4	6	10	0	0	10	0	0
4	9786574	.	T	A	5	4	9	0	0	9	0	0
4	9786617	.	C	A	11	6	17	0	0	17	0	0
4	9786670	.	C	A	9	6	15	0	0	15	0	0
4	9786705	.	A	C	5	2	7	0	0	7	0	0
4	9786855	.	T	C	6	5	11	0	1	12	0	0
4	9786925	.	T	C	1	0	1	0	2	3	0	0
4	9786976	.	G	A	2	3	5	0	0	5	0	0
4	9787025	.	T	G	2	3	5	0	0	5	0	0
4	9787130	.	A	G	4	8	12	0	1	13	0	0
4	9787156	.	A	T	4	7	11	0	1	12	0	0
4	9787250	.	A	G	6	5	11	0	3	14	0	0
4	9787415	.	G	A	13	4	17	0	1	18	0	0
4	9787516	.	C	T	7	12	19	0	3	22	0	0
4	9787600	.	G	T	11	8	19	0	0	19	0	0
4	9787761	.	A	G	11	9	20	0	0	20	0	0
4	9789478	.	A	G	8	11	19	0	0	19	0	0
4	9791466	.	A	T	11	11	22	0	0	22	0	0
4	9791493	.	T	C	9	0	9	0	11	20	0	0
4	9792102	.	T	G	4	11	15	0	0	15	0	0
4	9792229	.	G	T	10	7	17	0	0	17	0	0
4	9792726	.	T	G	7	3	10	0	0	10	0	0
4	9792798	.	A	G	4	5	9	0	1	10	0	0
4	9794644	.	C	A	0	4	4	0	9	13	0	0
4	9795288	.	C	T	4	13	17	0	0	17	0	0
4	9795309	.	C	T	5	10	15	0	0	15	0	0
4	9795417	.	T	A	8	6	14	0	0	14	0	0
4	9797312	.	C	T	1	4	5	0	4	9	0	0
4	9797376	.	G	A	4	3	7	0	0	7	0	0
4	9797390	.	G	C	4	1	5	0	4	9	0	0
4	9797411	.	C	T	2	4	6	0	0	6	0	0
4	9798825	.	C	A	1	4	5	0	9	14	0	0
4	9801626	.	G	A	6	4	10	0	1	11	0	0
4	9801662	.	A	G	2	7	9	1	1	11	0	0
4	9801730	.	A	T	6	12	18	0	1	19	0	0
4	9801747	.	G	A	10	11	21	0	0	21	0	0
4	9801935	.	A	G	8	9	17	0	0	17	0	0
4	9802472	.	A	T	3	3	6	0	0	6	0	0
4	9802487	.	C	T	0	4	4	0	2	6	0	0
4	9809733	.	T	G	2	6	8	0	0	8	0	0
4	9809829	.	T	C	3	0	3	0	2	5	0	0
4	9813844	.	T	A	7	2	9	0	0	9	0	0
4	9813902	.	C	A	4	2	6	0	0	6	0	0
4	9814044	.	C	G	8	4	12	0	0	12	0	0
4	9817327	.	C	T	5	6	11	0	0	11	0	0
4	9819858	.	A	T	4	4	8	0	0	8	0	0
4	9819944	.	T	C	1	4	5	0	3	8	0	0
4	9836583	.	T	A	9	7	16	0	2	19	1	0
4	9837992	.	A	G	5	5	10	0	0	10	0	0
4	9838875	.	T	C	13	7	20	0	3	23	0	0
4	9838932	.	C	T	9	9	18	0	0	18	0	0
4	9838974	.	T	C	6	6	12	0	0	12	0	0
4	9840136	.	T	C	8	12	20	0	1	21	0	0
4	9840242	.	T	C	7	12	19	0	0	19	0	0
4	9840338	.	T	C	9	8	17	0	0	17	0	0
4	9841657	.	G	A	13	19	32	0	3	35	0	0
4	9854313	.	T	C	5	5	10	0	1	11	0	0
4	9854467	.	C	T	4	2	6	0	1	7	0	0
4	9855482	.	G	A	3	6	9	0	0	9	0	0
4	9858023	.	A	G	8	9	17	0	0	17	0	0
4	9858050	.	C	T	7	5	12	0	0	12	0	0
4	9860188	.	T	G	2	3	5	0	0	5	0	0
4	9863363	.	G	A	2	4	6	0	0	6	0	0
4	9863795	.	A	G	4	2	6	0	0	6	0	0
4	9864001	.	C	T	2	4	6	0	0	6	0	0
4	9865503	.	T	C	3	4	7	0	0	7	0	0
4	9866926	.	T	C	1	4	5	0	1	6	0	0
4	9867387	.	A	G	1	3	4	0	1	5	0	0
4	9955338	.	A	G	4	0	4	0	9	13	0	0
4	9955350	.	C	T	5	10	15	0	1	16	0	0
4	9957319	.	T	C	4	9	13	0	0	13	0	0
4	9957331	.	C	T	7	9	16	0	0	16	0	0
4	9957367	.	T	C	4	5	9	0	1	10	0	0
4	9961823	.	T	A	6	3	9	0	1	10	0	0
4	9962466	.	C	T	6	4	10	0	0	10	0	0
4	9964153	.	T	C	13	4	17	0	0	17	0	0
4	9964161	.	C	G	13	2	15	0	1	16	0	0
4	9964813	.	C	T	5	3	8	0	0	8	0	0
4	9964876	.	G	A	2	4	6	0	0	6	0	0
4	9966229	.	C	T	6	5	11	0	0	11	0	0
4	9969261	.	C	T	9	8	17	0	1	18	0	0
4	9969306	.	G	T	9	8	17	0	3	20	0	0
4	9969447	.	T	C	10	6	16	0	0	16	0	0
4	9974720	.	C	T	3	3	6	0	0	6	0	0
4	9979792	.	T	C	5	3	8	0	1	9	0	0
4	9980400	.	G	A	1	3	4	0	6	11	1	0
4	9981763	.	C	T	4	5	9	0	2	11	0	0
4	9981838	.	G	A	9	6	15	0	0	15	0	0
4	9982775	.	G	T	10	13	23	0	1	24	0	0
4	9982872	.	A	T	10	11	21	0	3	24	0	0
4	9982883	.	A	G	10	14	24	0	1	25	0	0
4	9983251	.	G	A	7	13	20	0	4	24	0	0
4	9983269	.	C	G	7	15	22	0	0	22	0	0
4	9983347	.	G	T	4	11	15	0	1	16	0	0
4	9983940	.	C	T	12	9	21	0	1	22	0	0
4	9983943	.	T	C	10	10	20	0	1	21	0	0
4	9985320	.	G	C	9	6	15	0	0	15	0	0
4	9986279	.	G	A	13	10	23	0	2	25	0	0
4	9988867	.	C	T	13	7	20	0	1	21	0	0
4	9990796	.	G	A	12	9	21	0	1	22	0	0
4	9993789	.	C	T	14	19	33	0	0	33	0	0
4	9996182	.	T	C	17	14	31	1	0	32	0	0
4	9998553	.	G	A	2	10	12	0	17	29	0	0
4	9998566	.	A	C	15	13	28	0	3	31	0	0
4	9998677	.	A	G	15	12	27	0	0	27	0	0
4	9998986	.	A	T	10	9	19	0	1	21	1	0
4	9998988	.	T	C	10	10	20	0	0	20	0	0
4	9999240	.	C	T	16	13	29	0	0	29	0	0
4	9999367	.	A	G	17	20	37	0	0	37	0	0
4	9999830	.	T	C	15	5	20	0	5	25	0	0
4	9999877	.	A	T	14	2	16	0	1	19	2	0
4	9999909	.	A	T	9	6	15	0	0	15	0	0
4	10008809	.	G	A	0	2	2	0	3	5	0	0
4	10011770	.	A	C	6	3	9	0	0	9	0	0
4	10017468	.	A	G	23	21	44	0	0	44	0	0
4	10038009	.	T	C	17	29	46	0	0	47	1	0
4	10040249	.	G	A	2	19	21	0	26	47	0	0
4	10040285	.	A	G	31	0	31	0	22	53	0	0
4	10040297	.	C	T	30	22	52	0	2	55	1	0
4	10124153	.	A	C	3	4	7	0	0	7	0	0
4	10126486	.	T	A	2	2	4	0	0	4	0	0
4	10127591	.	C	A	3	3	6	0	0	6	0	0
4	10128809	.	C	T	2	2	4	0	1	5	0	0
4	10128828	.	A	C	2	1	3	0	2	5	0	0
4	10128875	.	T	C	5	3	8	0	0	8	0	0
4	10130199	.	G	A	2	2	4	0	0	4	0	0
4	10366710	.	G	A	7	6	13	0	2	15	0	0
4	10367028	.	A	G	5	8	13	0	0	13	0	0
4	10367412	.	A	C	7	6	13	0	0	13	0	0
4	10367562	.	C	T	7	3	10	0	0	10	0	0
4	10367610	.	C	T	5	4	9	0	0	9	0	0
4	10367619	.	C	T	5	5	10	0	0	10	0	0
4	10553528	.	G	A	6	5	11	0	3	14	0	0
4	10558370	.	C	T	10	6	16	0	0	16	0	0
4	10558600	.	A	T	5	1	6	1	3	10	0	0
4	10559042	.	A	T	6	8	14	0	0	14	0	0
4	10559213	.	C	G	4	4	8	0	0	8	0	0
4	10559621	.	C	A	6	8	14	0	2	16	0	0
4	10559755	.	T	C	0	1	1	0	0	1	0	0
4	10559768	.	T	C	1	2	3	0	0	3	0	0
4	10559992	.	C	T	1	6	7	0	0	7	0	0
4	10560246	.	G	A	11	10	21	0	0	21	0	0
4	10560253	.	A	T	10	10	20	0	1	21	0	0
4	10560284	.	C	T	15	13	28	0	0	28	0	0
4	10560404	.	A	T	17	10	27	0	1	28	0	0
4	10560607	.	A	G	11	6	17	0	1	18	0	0
4	10560916	.	C	T	9	7	16	0	1	17	0	0
4	10561598	.	T	C	13	9	22	0	0	22	0	0
4	10561603	.	G	A	12	7	19	0	3	22	0	0
4	10574958	.	T	A	1	2	3	0	0	3	0	0
4	10605409	.	T	C	11	5	16	0	0	16	0	0
4	10608878	.	G	T	11	8	19	0	1	20	0	0
4	10611014	.	T	A	12	20	32	0	1	33	0	0
4	10615123	.	A	T	11	9	20	0	0	20	0	0
4	10615127	.	G	T	11	10	21	0	1	22	0	0
4	10615175	.	A	G	10	0	10	0	11	21	0	0
4	10690370	.	A	C	1	4	5	0	0	5	0	0
4	10761803	.	C	G	2	0	2	0	4	6	0	0
4	10762335	.	T	A	3	4	7	0	0	7	0	0
4	10783836	.	C	T	0	3	3	3	1	7	0	0
4	10812042	.	C	G	0	3	3	1	2	6	0	0
4	10813741	.	C	T	1	2	3	0	0	3	0	0
4	10813929	.	T	C	1	0	1	0	2	3	0	0
4	10826346	.	C	T	2	2	4	0	0	4	0	0
4	10888842	.	G	C	1	5	6	0	5	11	0	0
4	10888890	.	T	A	5	4	9	0	1	10	0	0
4	10888935	.	C	A	5	3	8	0	0	8	0	0
4	10890516	.	G	T	7	3	10	1	0	11	0	0
4	10890822	.	G	A	7	3	10	0	1	11	0	0
4	10896354	.	G	C	6	5	11	0	0	11	0	0
4	10896570	.	G	A	8	8	16	0	0	16	0	0
4	10896582	.	G	T	6	6	12	0	2	14	0	0
4	10896618	.	C	T	4	4	8	0	1	9	0	0
4	10896620	.	A	T	3	5	8	0	0	8	0	0
4	10904784	.	C	T	8	8	16	0	1	17	0	0
4	10905246	.	C	T	7	13	20	0	0	20	0	0
4	10906254	.	C	T	5	4	9	0	1	10	0	0
4	10908001	.	C	T	19	10	29	0	0	29	0	0
4	10908182	.	T	C	11	7	18	0	0	18	0	0
4	10908294	.	C	T	5	5	10	0	1	11	0	0
4	10908726	.	T	C	12	6	18	0	1	19	0	0
4	10974650	.	C	T	2	6	8	0	0	8	0	0
4	10974722	.	G	A	4	2	6	0	1	7	0	0
4	10976944	.	G	A	6	5	11	0	0	11	0	0
4	10982291	.	C	T	9	4	13	0	0	13	0	0
4	10982339	.	T	G	3	3	6	0	0	6	0	0
4	10982390	.	C	A	0	5	5	0	5	10	0	0
4	10987895	.	T	A	7	5	12	0	0	12	0	0
4	10988147	.	A	G	2	2	4	0	0	4	0	0
4	10988546	.	G	C	8	4	12	0	0	12	0	0
4	10988581	.	C	T	1	5	6	0	8	14	0	0
4	10994841	.	G	A	2	5	7	0	0	7	0	0
4	10994967	.	A	G	2	2	4	0	0	4	0	0
4	10995138	.	G	A	3	2	5	0	0	5	0	0
4	11024616	.	C	T	0	3	3	0	6	9	0	0
4	11051793	.	C	T	1	3	4	0	0	4	0	0
4	11051839	.	C	T	1	3	4	0	0	4	0	0
4	11053851	.	G	A	0	5	5	0	9	14	0	0
4	11054484	.	A	C	5	9	14	0	2	16	0	0
4	11054509	.	G	C	6	7	13	0	0	13	0	0
4	11180049	.	C	T	3	2	5	0	0	5	0	0
4	11186762	.	G	A	0	4	4	0	2	6	0	0
4	11311383	.	G	A	3	8	11	0	1	12	0	0
4	11311408	.	C	T	7	5	12	0	1	13	0	0
4	11311632	.	T	A	3	2	5	0	0	5	0	0
4	11344964	.	G	A	5	3	8	0	0	8	0	0
4	11356555	.	A	G	9	8	17	0	0	17	0	0
4	11356618	.	T	C	4	5	9	0	1	10	0	0
4	11358626	.	C	T	8	7	15	0	1	16	0	0
4	11366360	.	T	C	6	10	16	0	0	16	0	0
4	11366481	.	G	A	10	8	18	0	6	24	0	0
4	11367668	.	T	A	11	11	22	1	0	23	0	0
4	11367952	.	T	C	9	10	19	0	0	19	0	0
4	11368056	.	A	T	18	21	39	0	3	42	0	0
4	11368076	.	G	T	23	22	45	0	2	47	0	0
4	11368171	.	G	A	2	17	19	0	17	36	0	0
4	11386687	.	G	A	2	1	3	1	3	7	0	0
4	11387131	.	G	T	5	7	12	0	3	15	0	0
4	11387698	.	A	T	9	6	15	0	0	15	0	0
4	11389372	.	G	C	0	6	6	0	3	9	0	0
4	11414424	.	A	T	3	2	5	0	0	5	0	0
4	11414567	.	A	T	4	4	8	0	0	8	0	0
4	11414937	.	A	G	4	6	10	0	0	10	0	0
4	11415471	.	G	A	7	11	18	0	0	18	0	0
4	11415483	.	G	A	6	11	17	0	0	17	0	0
4	11416701	.	C	T	8	12	20	0	4	24	0	0
4	11416758	.	T	A	14	6	20	0	1	21	0	0
4	11416854	.	G	A	13	5	18	0	1	19	0	0
4	11417753	.	G	T	9	6	15	0	0	15	0	0
4	11417829	.	C	A	6	6	12	0	2	14	0	0
4	11418969	.	C	T	9	10	19	0	1	20	0	0
4	11419062	.	G	A	6	4	10	0	0	10	0	0
4	11419163	.	C	G	6	8	14	0	0	14	0	0
4	11419510	.	C	T	11	9	20	0	0	20	0	0
4	11419656	.	C	T	6	9	15	0	2	17	0	0
4	11419836	.	A	T	10	7	17	0	2	19	0	0
4	11419869	.	T	C	12	6	18	0	1	19	0	0
4	11420005	.	A	T	15	10	25	0	3	28	0	0
4	11421575	.	C	T	17	11	28	0	1	29	0	0
4	11422121	.	C	T	18	14	32	0	0	32	0	0
4	11425839	.	G	T	19	14	33	0	0	33	0	0
4	11439544	.	C	A	5	10	15	0	1	16	0	0
4	11444080	.	C	T	20	19	39	0	0	39	0	0
4	11446078	.	A	G	24	15	39	0	1	41	1	0
4	11446365	.	A	T	20	27	47	0	1	48	0	0
4	11446943	.	A	G	15	6	21	0	2	23	0	0
4	11447135	.	T	C	27	15	42	0	0	42	0	0
4	11447144	.	G	A	11	24	35	0	2	37	0	0
4	11447226	.	T	G	12	1	13	0	23	36	0	0
4	11447251	.	T	C	12	23	35	0	0	35	0	0
4	11447719	.	T	G	17	21	38	0	3	41	0	0
4	11448296	.	A	T	14	26	40	0	0	40	0	0
4	11448403	.	G	A	3	23	26	0	22	48	0	0
4	11458318	.	T	G	10	5	15	0	0	15	0	0
4	11461181	.	C	G	1	5	6	0	0	6	0	0
4	11461914	.	A	G	7	6	13	0	0	13	0	0
4	11464390	.	A	G	23	23	46	0	2	48	0	0
4	11470854	.	A	G	16	15	31	0	3	34	0	0
4	11471203	.	T	C	24	17	41	0	1	42	0	0
4	11472674	.	T	C	22	23	45	0	0	45	0	0
4	11476472	.	G	A	5	26	31	0	26	57	0	0
4	11476487	.	C	T	23	29	52	0	5	57	0	0
4	11476740	.	C	T	37	18	55	1	4	60	0	0
4	11476868	.	C	G	24	31	55	0	3	58	0	0
4	11476945	.	C	T	27	32	59	0	4	63	0	0
4	11477047	.	T	A	25	31	56	0	3	59	0	0
4	11480649	.	T	C	8	4	12	0	3	15	0	0
4	11480824	.	C	A	11	6	17	0	1	18	0	0
4	11480866	.	C	T	8	8	16	0	0	16	0	0
4	11482235	.	G	A	2	5	7	0	8	15	0	0
4	11482259	.	G	A	10	7	17	0	1	18	0	0
4	11482358	.	T	G	9	7	16	0	3	19	0	0
4	11482367	.	C	G	9	8	17	0	0	17	0	0
4	11482668	.	T	A	12	11	23	0	1	24	0	0
4	11482830	.	C	T	4	2	6	0	0	6	0	0
4	11484854	.	A	G	2	4	6	0	0	6	0	0
4	11485626	.	G	T	1	1	2	0	1	3	0	0
4	11485671	.	C	T	1	3	4	0	0	4	0	0
4	11489736	.	C	T	5	2	7	0	0	7	0	0
4	11489758	.	G	A	0	1	1	0	3	4	0	0
4	11573837	.	C	T	0	4	4	0	1	5	0	0
4	11712653	.	C	T	5	6	11	0	1	12	0	0
4	11712704	.	G	T	0	6	6	0	6	12	0	0
4	11712794	.	T	C	4	3	7	0	0	7	0	0
4	11713065	.	C	T	3	3	6	0	0	6	0	0
4	11721731	.	C	T	7	4	11	0	0	11	0	0
4	11721782	.	C	T	7	2	9	0	0	9	0	0
4	11726366	.	T	A	1	7	8	0	2	10	0	0
4	11728959	.	G	A	2	9	11	0	13	24	0	0
4	11729719	.	G	A	9	5	14	0	1	15	0	0
4	11730159	.	G	C	7	8	15	0	0	15	0	0
4	11730515	.	C	A	8	10	18	0	1	19	0	0
4	11732213	.	G	A	3	3	6	0	0	6	0	0
4	11732222	.	G	A	3	3	6	0	0	6	0	0
4	11732456	.	G	A	7	4	11	0	0	11	0	0
4	11732589	.	T	C	9	12	21	0	1	22	0	0
4	11732590	.	T	C	11	12	23	0	0	23	0	0
4	11732956	.	A	G	7	5	12	0	0	12	0	0
4	11732975	.	G	A	3	6	9	0	0	9	0	0
4	11733061	.	A	C	5	3	8	0	0	8	0	0
4	11733114	.	A	C	3	0	3	0	3	6	0	0
4	11733201	.	T	A	5	1	6	0	0	6	0	0
4	11733222	.	C	T	5	2	7	0	0	7	0	0
4	11733357	.	C	A	3	5	8	0	0	8	0	0
4	11733545	.	T	C	13	1	14	1	11	26	0	0
4	11733573	.	G	A	9	13	22	0	0	22	0	0
4	11733726	.	A	C	6	9	15	0	1	16	0	0
4	11733778	.	C	A	1	5	6	0	7	13	0	0
4	11734001	.	A	T	6	5	11	0	0	11	0	0
4	11734071	.	T	C	4	3	7	0	1	8	0	0
4	11734072	.	A	C	4	4	8	0	0	8	0	0
4	11734150	.	A	G	1	3	4	0	0	4	0	0
4	11734196	.	A	T	5	3	8	0	0	8	0	0
4	11734423	.	G	A	1	2	3	0	2	5	0	0
4	11734696	.	C	G	4	9	13	0	0	13	0	0
4	11736989	.	G	A	2	2	4	0	0	4	0	0
4	11780629	.	T	C	5	3	8	4	0	12	0	0
4	11804825	.	C	G	3	2	5	0	0	5	0	0
4	11804940	.	G	A	5	7	12	0	0	12	0	0
4	11805396	.	G	T	7	2	9	0	2	11	0	0
4	11805423	.	T	C	6	4	10	0	0	10	0	0
4	11806934	.	G	A	7	12	19	0	0	19	0	0
4	11806965	.	G	C	10	8	18	0	0	18	0	0
4	11810123	.	T	G	5	2	7	0	0	7	0	0
4	11810129	.	A	G	4	2	6	0	0	6	0	0
4	11814022	.	A	G	24	11	35	0	2	37	0	0
4	11814055	.	C	T	1	24	25	0	16	41	0	0
4	11814074	.	T	A	18	27	45	0	0	45	0	0
4	11814429	.	A	T	11	6	17	0	1	18	0	0
4	11814456	.	A	G	5	7	12	0	2	14	0	0
4	11814471	.	G	A	9	6	15	0	1	16	0	0
4	11814494	.	C	T	9	8	17	0	2	19	0	0
4	11814565	.	A	T	16	8	24	0	2	26	0	0
4	11814684	.	C	T	13	9	22	0	3	25	0	0
4	11814723	.	A	C	10	15	25	0	2	27	0	0
4	11815137	.	G	T	13	15	28	0	1	29	0	0
4	11815143	.	C	G	11	15	26	0	0	27	1	0
4	11815324	.	A	C	18	8	26	0	4	31	1	0
4	11816535	.	T	C	7	0	7	0	5	12	0	0
4	11818347	.	G	A	13	8	21	0	1	22	0	0
4	11818353	.	A	G	11	8	19	0	2	21	0	0
4	11827171	.	C	T	11	14	25	1	0	26	0	0
4	11841949	.	T	A	8	6	14	0	1	15	0	0
4	12006542	.	G	A	14	7	21	0	0	21	0	0
4	12006761	.	C	T	1	4	5	0	12	17	0	0
4	12007149	.	T	A	3	5	8	0	0	8	0	0
4	12013470	.	T	G	9	12	21	0	2	23	0	0
4	12013513	.	A	T	12	7	19	0	1	20	0	0
4	12020936	.	C	T	7	10	17	0	1	18	0	0
4	12021120	.	C	T	18	9	27	0	2	29	0	0
4	12021703	.	C	T	14	20	34	0	0	34	0	0
4	12021748	.	G	T	0	27	27	0	15	42	0	0
4	12022108	.	A	G	26	1	27	0	14	41	0	0
4	12022444	.	T	C	28	20	48	0	0	48	0	0
4	12023445	.	A	C	26	24	50	0	1	51	0	0
4	12025771	.	G	A	35	13	48	3	1	52	0	0
4	12026098	.	G	A	8	5	13	0	2	15	0	0
4	12026286	.	A	T	14	13	27	0	2	29	0	0
4	12026305	.	T	C	20	8	28	0	1	29	0	0
4	12026369	.	G	T	17	9	26	0	1	27	0	0
4	12026429	.	C	A	13	9	22	0	0	22	0	0
4	12026488	.	T	C	4	6	10	0	0	10	0	0
4	12036357	.	G	A	3	3	6	0	0	6	0	0
4	12036384	.	G	T	1	2	3	0	0	3	0	0
4	12037883	.	G	A	1	2	3	0	0	3	0	0
4	12078423	.	T	C	5	0	5	0	10	15	0	0
4	12080673	.	C	T	5	10	15	0	1	16	0	0
4	12080911	.	T	G	9	14	23	0	2	25	0	0
4	12087262	.	G	C	7	0	7	0	6	13	0	0
4	12091037	.	T	C	9	0	9	1	13	23	0	0
4	12091104	.	G	T	12	10	22	0	0	22	0	0
4	12103619	.	T	C	2	0	2	1	6	9	0	0
4	12103911	.	A	T	2	7	9	0	1	10	0	0
4	12103964	.	T	A	4	12	16	0	1	17	0	0
4	12106000	.	G	C	2	0	2	0	7	9	0	0
4	12111399	.	G	A	6	5	11	0	0	11	0	0
4	12113128	.	C	T	2	5	7	0	0	7	0	0
4	12230029	.	C	T	12	6	18	0	1	19	0	0
4	12230509	.	C	A	10	7	17	0	2	19	0	0
4	12230510	.	T	C	12	6	18	0	1	19	0	0
4	12230608	.	T	C	5	9	14	0	0	14	0	0
4	12230665	.	C	T	5	8	13	0	1	14	0	0
4	12230698	.	C	T	9	4	13	0	0	13	0	0
4	12230713	.	T	C	11	5	16	0	0	16	0	0
4	12230833	.	G	T	4	3	7	0	0	7	0	0
4	12230851	.	T	C	5	2	7	0	1	8	0	0
4	12230890	.	T	A	9	4	13	0	0	13	0	0
4	12230909	.	G	A	8	8	16	0	1	17	0	0
4	12231008	.	G	A	1	10	11	1	3	15	0	0
4	12231131	.	A	C	5	4	9	0	0	9	0	0
4	12231328	.	A	T	6	9	15	0	2	17	0	0
4	12231751	.	A	C	6	11	17	0	3	20	0	0
4	12231789	.	C	A	9	11	20	0	0	20	0	0
4	12232164	.	C	G	12	4	16	0	0	16	0	0
4	12232253	.	G	T	13	2	15	0	1	16	0	0
4	12232254	.	C	T	14	2	16	0	0	16	0	0
4	12232323	.	A	T	13	5	18	0	2	20	0	0
4	12232328	.	A	T	12	6	18	0	0	18	0	0
4	12232415	.	G	T	3	2	5	0	1	6	0	0
4	12232509	.	C	T	6	3	9	0	0	9	0	0
4	12232614	.	A	C	6	7	13	0	1	14	0	0
4	12232644	.	A	T	10	10	20	0	0	20	0	0
4	12232737	.	G	A	5	3	8	0	0	8	0	0
4	12232746	.	T	C	4	3	7	0	0	7	0	0
4	12232958	.	T	C	7	7	14	0	0	14	0	0
4	12232985	.	G	T	9	7	16	0	0	16	0	0
4	12233004	.	A	G	11	0	11	0	8	19	0	0
4	12233125	.	T	A	8	10	18	0	1	19	0	0
4	12233220	.	C	T	9	14	23	0	0	23	0	0
4	12233252	.	A	T	10	10	20	0	0	20	0	0
4	12233402	.	G	T	4	5	9	0	1	10	0	0
4	12233431	.	C	A	4	4	8	0	0	8	0	0
4	12233450	.	C	A	4	7	11	0	0	11	0	0
4	12233651	.	A	T	11	3	14	3	1	18	0	0
4	12233728	.	G	T	5	4	9	0	0	9	0	0
4	12233908	.	A	C	16	11	27	1	1	29	0	0
4	12233967	.	C	T	4	3	7	1	0	8	0	0
4	12234267	.	G	C	1	4	5	1	1	7	0	0
4	12234269	.	T	A	1	5	6	1	0	7	0	0
4	12234398	.	T	G	6	7	13	1	0	14	0	0
4	12234458	.	C	T	8	5	13	0	0	13	0	0
4	12234670	.	A	G	11	0	11	0	13	24	0	0
4	12234755	.	C	A	8	12	20	0	1	21	0	0
4	12234792	.	A	G	18	8	26	0	2	28	0	0
4	12234828	.	C	T	8	12	20	0	2	22	0	0
4	12234955	.	C	T	17	11	28	0	2	30	0	0
4	12235677	.	T	C	5	9	14	0	0	14	0	0
4	12235722	.	A	G	5	3	8	0	0	8	0	0
4	12235770	.	T	C	6	12	18	0	1	19	0	0
4	12236171	.	G	A	16	10	26	0	2	28	0	0
4	12236178	.	T	G	15	7	22	0	3	25	0	0
4	12236429	.	T	A	11	11	22	0	0	22	0	0
4	12236495	.	A	G	10	0	10	0	15	25	0	0
4	12236519	.	A	G	17	11	28	0	0	28	0	0
4	12236584	.	C	T	13	9	22	0	0	22	0	0
4	12236592	.	T	A	12	1	13	0	0	13	0	0
4	12236641	.	A	G	14	8	22	0	0	22	0	0
4	12236667	.	C	A	13	6	19	0	1	20	0	0
4	12237337	.	T	C	9	4	13	0	0	13	0	0
4	12237340	.	G	A	11	4	15	0	0	15	0	0
4	12237490	.	C	A	15	12	27	0	1	28	0	0
4	12237689	.	C	A	11	14	25	0	1	26	0	0
4	12237849	.	C	T	15	17	32	0	2	34	0	0
4	12238161	.	C	T	7	22	29	0	4	33	0	0
4	12238418	.	C	T	18	22	40	0	1	41	0	0
4	12238711	.	G	A	14	14	28	0	0	28	0	0
4	12238904	.	G	A	7	8	15	0	0	15	0	0
4	12238956	.	G	A	19	15	34	0	8	42	0	0
4	12243881	.	T	G	9	5	14	0	2	16	0	0
4	12244071	.	T	C	14	11	25	0	0	25	0	0
4	12244099	.	T	C	16	18	34	0	0	34	0	0
4	12244153	.	T	A	17	12	29	0	0	29	0	0
4	12244258	.	T	C	9	10	19	0	2	21	0	0
4	12244322	.	C	T	12	13	25	0	0	25	0	0
4	12244607	.	C	T	1	8	9	0	4	13	0	0
4	12245058	.	G	A	10	7	17	0	0	17	0	0
4	12245555	.	T	G	6	0	6	0	13	19	0	0
4	12245584	.	A	G	17	7	24	0	0	24	0	0
4	12265268	.	T	A	6	8	14	0	0	14	0	0
4	12265337	.	T	C	10	0	10	0	4	14	0	0
4	12270202	.	A	T	5	3	8	0	0	8	0	0
4	12275400	.	T	C	1	3	4	0	0	4	0	0
4	12286040	.	C	T	3	2	5	0	0	5	0	0
4	12311776	.	C	T	2	3	5	0	0	5	0	0
4	12312370	.	T	C	2	2	4	0	0	4	0	0
4	12312712	.	C	T	1	2	3	0	1	4	0	0
4	12312717	.	T	G	1	3	4	0	1	5	0	0
4	12312865	.	T	C	3	6	9	0	0	9	0	0
4	12317636	.	T	G	3	4	7	0	2	9	0	0
4	12317674	.	A	T	2	3	5	0	1	6	0	0
4	12381900	.	T	C	11	6	17	0	1	18	0	0
4	12381930	.	G	A	10	4	14	0	1	15	0	0
4	12382076	.	A	G	19	18	37	0	1	38	0	0
4	12382234	.	C	T	11	6	17	0	2	19	0	0
4	12382336	.	T	G	18	16	34	0	0	34	0	0
4	12382433	.	G	C	18	10	28	0	3	31	0	0
4	12382673	.	A	T	16	6	22	0	0	22	0	0
4	12382871	.	G	A	17	14	31	0	1	32	0	0
4	12382889	.	T	G	14	14	28	0	8	36	0	0
4	12382943	.	T	G	26	17	43	0	2	45	0	0
4	12383030	.	C	T	27	17	44	0	1	45	0	0
4	12383081	.	C	T	27	16	43	0	1	44	0	0
4	12384831	.	A	G	13	13	26	0	1	27	0	0
4	12384840	.	G	A	15	15	30	0	1	31	0	0
4	12384873	.	C	G	2	17	19	0	16	36	1	0
4	12388419	.	T	C	16	10	26	0	1	27	0	0
4	13755907	.	A	G	23	6	29	0	2	31	0	0
4	13756335	.	A	G	21	5	26	0	0	26	0	0
4	13756536	.	G	T	6	3	9	0	0	9	0	0
4	14469763	.	A	G	4	2	6	0	0	6	0	0
4	14843970	.	A	G	8	2	10	0	0	10	0	0
4	16315830	.	A	G	3	2	5	0	0	5	0	0
4	16318963	.	G	A	0	2	2	0	4	6	0	0
4	16319377	.	C	T	4	2	6	0	1	7	0	0
4	16320221	.	G	A	1	3	4	0	1	5	0	0
4	16368805	.	T	C	15	2	17	0	17	34	0	0
4	16368977	.	G	A	11	17	28	0	3	31	0	0
4	16369033	.	T	A	15	12	27	0	0	27	0	0
4	16369335	.	T	C	8	0	8	0	16	24	0	0
4	16369375	.	G	C	9	15	24	0	0	24	0	0
4	16369384	.	T	C	10	15	25	0	1	26	0	0
4	16369440	.	C	T	11	14	25	0	0	25	0	0
4	16369486	.	T	C	6	9	15	0	0	15	0	0
4	16380491	.	G	C	12	1	13	0	4	17	0	0
4	16382917	.	A	G	8	7	15	0	1	16	0	0
4	16536946	.	C	A	22	15	37	0	0	37	0	0
4	16537045	.	T	C	18	19	37	0	2	39	0	0
4	16537099	.	A	T	29	22	51	0	1	52	0	0
4	16537575	.	T	G	18	29	47	0	1	48	0	0
4	16537770	.	G	A	34	24	58	0	2	60	0	0
4	16538055	.	T	A	18	14	32	0	2	34	0	0
4	16539253	.	A	G	25	26	51	0	0	51	0	0
4	16632415	.	G	A	7	6	13	0	1	14	0	0
4	16632650	.	A	T	11	6	17	0	0	17	0	0
4	16632762	.	A	T	12	9	21	0	0	21	0	0
4	16632907	.	T	A	7	4	11	0	0	11	0	0
4	16633208	.	C	T	9	8	17	0	1	18	0	0
4	16634916	.	A	G	15	10	25	0	0	25	0	0
4	16634929	.	A	T	10	12	22	0	0	22	0	0
4	16635162	.	G	A	9	8	17	0	0	17	0	0
4	16635208	.	G	A	13	7	20	0	0	20	0	0
4	16635326	.	T	C	13	0	13	0	5	18	0	0
4	16635460	.	T	A	6	3	9	0	1	10	0	0
4	16635710	.	T	C	10	11	21	0	0	21	0	0
4	16638015	.	T	C	7	7	14	0	0	14	0	0
4	16638021	.	T	G	8	6	14	0	0	14	0	0
4	16641677	.	T	C	8	6	14	0	1	15	0	0
4	16649730	.	T	A	17	4	21	0	1	22	0	0
4	16650102	.	T	C	7	10	17	0	0	17	0	0
4	16650142	.	A	T	11	8	19	0	0	19	0	0
4	16650433	.	A	C	17	15	32	0	0	32	0	0
4	16650482	.	T	C	16	11	27	0	0	27	0	0
4	16650611	.	T	G	10	15	25	0	0	25	0	0
4	16650618	.	A	G	10	14	24	0	0	24	0	0
4	16651046	.	G	C	16	5	21	0	0	21	0	0
4	16651121	.	A	G	19	7	26	0	1	27	0	0
4	16651414	.	G	A	12	15	27	0	1	28	0	0
4	16652890	.	A	G	14	9	23	0	0	23	0	0
4	16654337	.	G	C	21	15	36	0	0	36	0	0
4	16654349	.	C	T	1	11	12	0	24	36	0	0
4	16659679	.	G	A	10	13	23	0	0	23	0	0
4	16666267	.	C	T	11	6	17	0	0	17	0	0
4	16671133	.	T	C	11	9	20	0	0	20	0	0
4	16671232	.	C	T	1	8	9	0	11	20	0	0
4	16672481	.	G	T	7	8	15	0	0	15	0	0
4	16672771	.	C	T	16	7	23	0	2	25	0	0
4	16677348	.	T	C	13	4	17	0	0	17	0	0
4	16677354	.	C	G	12	6	18	0	0	18	0	0
4	16680671	.	T	G	8	6	14	0	1	15	0	0
4	16680674	.	T	G	8	8	16	0	0	16	0	0
4	16706865	.	T	C	7	9	16	0	1	17	0	0
4	16706889	.	A	T	8	8	16	0	0	16	0	0
4	16733585	.	G	A	6	4	10	0	0	10	0	0
4	16733984	.	C	T	10	3	13	0	2	15	0	0
4	16736812	.	C	G	10	0	10	0	4	14	0	0
4	16736833	.	A	G	8	0	8	0	7	15	0	0
4	16739122	.	G	A	0	6	6	0	5	11	0	0
4	16741979	.	T	G	11	10	21	0	1	22	0	0
4	16742444	.	G	C	12	12	24	0	1	25	0	0
4	16768990	.	C	T	1	5	6	9	0	15	0	0
4	16784712	.	A	T	5	4	9	0	0	9	0	0
4	16784840	.	G	T	23	22	45	0	2	47	0	0
4	16784876	.	C	T	24	19	43	0	1	44	0	0
4	16785393	.	A	G	23	19	42	0	0	42	0	0
4	16785766	.	T	C	2	8	10	0	0	10	0	0
4	16786002	.	C	A	2	8	10	0	2	12	0	0
4	16786018	.	A	T	2	7	9	0	0	9	0	0
4	16786059	.	T	C	2	5	7	0	0	7	0	0
4	16786077	.	G	A	1	5	6	0	0	6	0	0
4	16788485	.	C	T	4	2	6	0	0	6	0	0
4	16788500	.	G	A	0	3	3	0	4	7	0	0
4	16791616	.	G	A	8	15	23	0	0	23	0	0
4	16791673	.	C	A	11	3	14	0	2	16	0	0
4	16791780	.	A	G	10	0	10	0	10	20	0	0
4	16791781	.	G	C	10	10	20	0	0	20	0	0
4	16791883	.	T	A	2	3	5	0	0	5	0	0
4	16829355	.	T	C	33	30	63	0	1	64	0	0
4	16829387	.	T	G	31	28	59	0	1	60	0	0
4	16829651	.	G	A	26	45	71	0	3	74	0	0
4	16831399	.	A	T	32	29	61	0	1	62	0	0
4	16832124	.	C	A	2	31	33	0	23	56	0	0
4	16832894	.	G	A	27	36	63	0	2	65	0	0
4	16858074	.	A	T	3	2	5	0	0	5	0	0
4	16858075	.	A	G	3	2	5	0	0	5	0	0
4	16858289	.	G	C	4	0	4	0	8	12	0	0
4	16858414	.	A	T	2	2	4	0	1	5	0	0
4	16876881	.	A	T	4	2	6	0	0	6	0	0
4	16877387	.	C	T	2	19	21	0	6	27	0	0
4	16879505	.	T	C	17	0	17	0	20	37	0	0
4	16881865	.	T	G	17	16	33	0	2	35	0	0
4	16885898	.	A	T	8	19	27	0	2	29	0	0
4	16889709	.	C	T	12	12	24	0	0	24	0	0
4	16889745	.	G	A	15	6	21	0	0	21	0	0
4	16893050	.	A	G	11	13	24	0	0	24	0	0
4	16893062	.	T	C	13	13	26	0	0	26	0	0
4	16898904	.	A	T	14	6	20	0	1	22	1	0
4	16899273	.	T	C	14	21	35	0	1	36	0	0
4	16904521	.	C	G	22	20	42	0	2	44	0	0
4	16904527	.	A	G	22	0	22	0	22	45	1	0
4	16905090	.	T	C	18	17	35	0	0	35	0	0
4	16905119	.	T	C	21	16	37	0	0	37	0	0
4	16905184	.	T	C	19	16	35	0	2	37	0	0
4	16905224	.	A	G	21	16	37	0	3	40	0	0
4	16905318	.	G	A	19	9	28	2	3	33	0	0
4	16905370	.	G	A	15	6	21	1	1	23	0	0
4	16905410	.	C	A	8	6	14	0	1	15	0	0
4	16905511	.	C	T	7	7	14	0	0	14	0	0
4	16905684	.	T	G	13	16	29	0	1	30	0	0
4	16905708	.	T	A	14	17	31	0	0	31	0	0
4	16905723	.	C	A	11	16	27	0	1	28	0	0
4	16905853	.	T	A	18	15	33	0	1	34	0	0
4	16906173	.	C	A	26	18	44	0	3	47	0	0
4	16906198	.	C	A	21	17	38	0	4	42	0	0
4	16906244	.	A	T	20	25	45	0	0	45	0	0
4	16906562	.	G	A	19	25	44	0	1	45	0	0
4	16982269	.	G	A	17	10	27	0	1	28	0	0
4	16982682	.	C	A	11	9	20	0	3	23	0	0
4	16982870	.	C	A	0	2	2	0	8	10	0	0
4	16982871	.	G	A	8	2	10	0	0	10	0	0
4	16983131	.	A	G	11	8	19	0	0	19	0	0
4	16983183	.	G	A	10	4	14	0	0	14	0	0
4	16983434	.	T	C	26	0	26	0	16	42	0	0
4	16984252	.	C	G	6	12	18	0	0	18	0	0
4	16984542	.	A	G	8	7	15	3	2	20	0	0
4	16985045	.	C	T	5	10	15	0	2	17	0	0
4	16988139	.	A	G	16	16	32	0	1	33	0	0
4	17008995	.	A	G	6	7	13	0	0	13	0	0
4	17251495	.	A	T	1	2	3	0	0	3	0	0
4	17251503	.	A	G	1	2	3	0	0	3	0	0
4	17253737	.	A	G	5	5	10	0	1	11	0	0
4	17253758	.	C	T	5	6	11	0	0	11	0	0
4	17253813	.	A	C	7	5	12	0	0	12	0	0
4	17253818	.	A	G	7	4	11	0	0	11	0	0
4	17253925	.	T	A	13	7	20	0	2	22	0	0
4	17253927	.	T	A	14	7	21	0	1	22	0	0
4	17254046	.	A	G	14	12	26	0	0	26	0	0
4	17256855	.	C	T	11	7	18	0	2	20	0	0
4	17257386	.	G	A	11	9	20	0	0	20	0	0
4	17257458	.	C	T	6	9	15	0	0	15	0	0
4	17260535	.	G	A	4	7	11	0	2	13	0	0
4	17287446	.	T	G	12	12	24	0	1	25	0	0
4	17288964	.	T	C	15	17	32	0	1	33	0	0
4	17291024	.	A	G	10	23	33	0	0	33	0	0
4	17292575	.	C	A	18	18	36	0	1	37	0	0
4	17292770	.	G	A	29	19	48	0	1	49	0	0
4	17292789	.	A	C	26	18	44	0	3	48	1	0
4	17292837	.	A	G	28	16	44	0	2	46	0	0
4	17294947	.	T	C	12	23	35	0	2	37	0	0
4	17296974	.	A	G	8	10	18	0	2	20	0	0
4	17297086	.	C	A	14	22	36	0	1	37	0	0
4	17297338	.	T	G	8	7	15	0	2	17	0	0
4	17326234	.	C	T	2	3	5	0	1	6	0	0
4	17326506	.	T	C	2	2	4	0	0	4	0	0
4	17336624	.	C	T	14	7	21	0	0	21	0	0
4	17336693	.	G	A	9	7	16	0	1	17	0	0
4	17337593	.	A	T	10	4	14	0	0	14	0	0
4	17353770	.	G	C	3	2	5	0	0	5	0	0
4	17353776	.	A	C	3	2	5	0	0	5	0	0
4	17354747	.	G	C	4	4	8	0	0	8	0	0
4	17369451	.	T	C	6	5	11	0	0	11	0	0
4	17380828	.	C	A	2	4	6	0	0	6	0	0
4	17382830	.	T	C	2	3	5	0	1	6	0	0
4	17382833	.	A	G	3	3	6	0	0	6	0	0
4	17384624	.	A	T	1	3	4	0	1	5	0	0
4	17388620	.	G	A	2	3	5	0	0	5	0	0
4	17417668	.	T	G	1	1	2	0	1	3	0	0
4	17417692	.	C	T	1	3	4	0	0	4	0	0
4	17524485	.	T	C	1	2	3	0	0	3	0	0
4	17524604	.	T	A	5	3	8	0	0	8	0	0
4	17528599	.	G	A	4	3	7	0	1	8	0	0
4	17530763	.	C	T	3	3	6	0	0	6	0	0
4	17534198	.	A	G	3	0	3	0	5	8	0	0
4	17534234	.	C	T	2	2	4	0	0	4	0	0
4	17536140	.	T	G	4	2	6	0	0	6	0	0
4	17537639	.	A	G	5	8	13	0	3	16	0	0
4	17537939	.	G	T	1	6	7	0	9	16	0	0
4	17539261	.	T	G	4	2	6	0	1	7	0	0
4	17541666	.	A	G	4	3	7	0	0	7	0	0
4	17541730	.	G	A	4	4	8	0	0	8	0	0
4	17545083	.	A	G	13	0	13	0	6	19	0	0
4	17572583	.	C	T	20	17	37	0	0	37	0	0
4	17572589	.	C	A	15	18	33	0	0	34	1	0
4	17572898	.	T	C	18	14	32	1	3	36	0	0
4	17572901	.	A	C	18	14	32	1	2	35	0	0
4	17573071	.	A	T	11	15	26	0	0	26	0	0
4	17573081	.	G	C	9	15	24	0	0	24	0	0
4	17573464	.	A	G	12	5	17	0	0	17	0	0
4	17573465	.	A	G	12	5	17	0	0	17	0	0
4	17573594	.	T	A	12	6	18	0	1	19	0	0
4	17573616	.	A	G	10	5	15	0	1	16	0	0
4	17573802	.	T	C	18	7	25	0	1	26	0	0
4	17573841	.	A	G	21	14	35	0	0	35	0	0
4	17573865	.	T	A	13	15	28	0	4	32	0	0
4	17573959	.	T	A	12	12	24	0	3	27	0	0
4	17573982	.	A	T	11	9	20	0	2	22	0	0
4	17574093	.	A	G	12	12	24	0	1	25	0	0
4	17574175	.	G	C	12	8	20	0	1	21	0	0
4	17574390	.	C	T	15	14	29	0	3	32	0	0
4	17574608	.	A	C	15	13	28	0	0	28	0	0
4	17574706	.	T	C	11	5	16	0	0	16	0	0
4	17577307	.	C	A	11	17	28	0	0	28	0	0
4	17580468	.	A	T	12	13	25	0	0	25	0	0
4	17596433	.	T	C	11	0	11	0	23	34	0	0
4	17596490	.	T	C	13	15	28	0	1	29	0	0
4	17629138	.	C	T	2	18	20	0	14	34	0	0
4	17629266	.	C	A	5	13	18	0	1	19	0	0
4	17634841	.	G	T	1	2	3	0	1	4	0	0
4	17635322	.	A	G	1	2	3	0	0	3	0	0
4	17636416	.	C	T	2	2	4	0	0	4	0	0
4	17642772	.	C	T	1	3	4	0	0	4	0	0
4	17642813	.	G	T	0	3	3	0	1	4	0	0
4	17643252	.	A	G	4	5	9	0	0	9	0	0
4	17644600	.	T	C	7	3	10	0	0	10	0	0
4	17644913	.	A	G	9	3	12	0	0	12	0	0
4	17644964	.	G	A	4	5	9	0	0	9	0	0
4	17645408	.	T	C	10	6	16	0	0	16	0	0
4	17645890	.	A	C	7	5	12	0	1	13	0	0
4	17645962	.	C	T	6	7	13	0	0	13	0	0
4	17657549	.	A	G	16	1	17	0	5	22	0	0
4	17660723	.	C	T	10	3	13	0	0	13	0	0
4	17660732	.	A	G	10	3	13	0	0	13	0	0
4	17660859	.	G	A	2	9	11	0	1	12	0	0
4	17660871	.	A	G	5	4	9	0	0	9	0	0
4	17661191	.	T	C	12	2	14	0	0	14	0	0
4	17661200	.	C	T	10	3	13	0	1	14	0	0
4	17661265	.	A	G	5	3	8	0	0	8	0	0
4	17661349	.	C	T	5	3	8	0	0	8	0	0
4	17661354	.	T	G	5	3	8	0	0	8	0	0
4	17684505	.	C	T	1	4	5	0	0	5	0	0
4	17684535	.	A	T	2	2	4	0	0	4	0	0
4	17686515	.	G	C	3	2	5	0	0	5	0	0
4	17688726	.	G	A	4	4	8	0	0	8	0	0
4	17688795	.	T	C	7	5	12	0	0	12	0	0
4	17688849	.	T	C	5	11	16	0	0	16	0	0
4	17688874	.	T	C	5	10	15	0	1	16	0	0
4	17688897	.	C	T	8	7	15	0	0	15	0	0
4	17689128	.	C	T	3	2	5	0	0	5	0	0
4	17689133	.	A	T	3	2	5	0	0	5	0	0
4	17689377	.	A	G	2	4	6	0	1	7	0	0
4	17689395	.	C	T	2	3	5	0	0	5	0	0
4	17689464	.	C	A	2	4	6	0	0	6	0	0
4	17689551	.	G	A	5	5	10	0	0	10	0	0
4	17689561	.	T	C	4	7	11	0	0	11	0	0
4	17693223	.	C	T	2	8	10	0	0	10	0	0
4	17693232	.	C	T	2	8	10	0	0	10	0	0
4	17693286	.	T	C	4	7	11	0	0	11	0	0
4	17693400	.	A	G	10	11	21	1	0	22	0	0
4	17695054	.	A	G	7	3	10	0	0	10	0	0
4	17696254	.	G	A	5	7	12	0	0	12	0	0
4	17696341	.	A	G	5	0	5	0	7	12	0	0
4	17704067	.	G	A	4	5	9	0	0	9	0	0
4	17704123	.	T	C	3	6	9	0	0	9	0	0
4	17704279	.	T	A	2	4	6	0	2	8	0	0
4	17704345	.	C	T	5	5	10	0	0	10	0	0
4	17704393	.	A	T	4	3	7	0	0	7	0	0
4	17704560	.	A	G	2	10	12	0	0	12	0	0
4	17704842	.	A	G	6	6	12	0	0	12	0	0
4	17704885	.	T	C	2	5	7	0	0	7	0	0
4	17704915	.	A	T	4	4	8	0	0	8	0	0
4	17704928	.	T	A	5	4	9	0	0	9	0	0
4	17707849	.	A	C	5	4	9	0	0	9	0	0
4	17708230	.	T	C	10	4	14	0	0	14	0	0
4	17708346	.	G	A	2	9	11	0	0	11	0	0
4	17821696	.	A	G	1	3	4	0	0	4	0	0
4	17822279	.	G	A	2	3	5	0	1	6	0	0
4	17837886	.	G	A	1	2	3	0	0	3	0	0
4	17849578	.	T	C	3	3	6	0	0	6	0	0
4	17851366	.	T	C	3	4	7	0	0	7	0	0
4	17853738	.	T	C	2	3	5	0	0	5	0	0
4	17873351	.	A	G	10	3	13	0	1	14	0	0
4	17873530	.	T	G	8	8	16	0	1	17	0	0
4	17873711	.	A	T	3	5	8	0	0	8	0	0
4	17873743	.	C	T	2	5	7	0	0	7	0	0
4	17873787	.	G	A	0	4	4	0	2	6	0	0
4	17873808	.	G	C	4	2	6	0	0	6	0	0
4	17886974	.	G	A	8	25	33	0	0	33	0	0
4	17887059	.	T	C	25	12	37	1	2	40	0	0
4	17887388	.	A	T	18	22	40	0	3	43	0	0
4	17887826	.	C	T	22	29	51	0	0	51	0	0
4	17887885	.	A	C	17	23	40	0	9	49	0	0
4	17902098	.	A	G	24	12	36	0	1	37	0	0
4	17904325	.	A	C	20	0	20	0	20	40	0	0
4	17915070	.	G	A	25	22	47	0	4	51	0	0
4	17949261	.	C	T	14	13	27	0	1	28	0	0
4	17999156	.	G	A	4	4	8	0	0	8	0	0
4	17999310	.	C	A	6	6	12	0	0	12	0	0
4	17999412	.	G	T	3	3	6	0	1	7	0	0
4	18067311	.	C	T	5	6	11	0	0	11	0	0
4	18067324	.	G	T	5	4	9	0	0	9	0	0
4	18119557	.	G	C	2	5	7	0	0	7	0	0
4	18208005	.	A	G	6	3	9	0	0	9	0	0
4	18208044	.	A	G	8	3	11	0	4	15	0	0
4	18208068	.	A	G	10	10	20	0	0	20	0	0
4	18208347	.	C	G	8	3	11	0	7	18	0	0
4	18208557	.	C	A	1	6	7	0	0	7	0	0
4	18208569	.	T	C	2	7	9	0	0	9	0	0
4	18208635	.	T	A	5	4	9	0	0	9	0	0
4	18208939	.	C	T	5	6	11	0	0	11	0	0
4	18209107	.	G	C	10	6	16	0	0	16	0	0
4	18209185	.	A	T	12	2	14	0	1	15	0	0
4	18213267	.	C	T	6	9	15	0	1	16	0	0
4	18216182	.	A	G	11	8	19	0	0	19	0	0
4	18216251	.	T	C	12	8	20	0	0	20	0	0
4	18216332	.	A	G	8	15	23	0	1	24	0	0
4	18235106	.	T	C	6	3	9	0	0	9	0	0
4	18235397	.	A	T	4	2	6	0	0	6	0	0
4	18237355	.	A	G	5	4	9	0	0	9	0	0
4	18240356	.	A	G	3	2	5	0	0	5	0	0
4	18240451	.	G	A	2	4	6	0	0	6	0	0
4	18240536	.	G	T	4	5	9	0	0	9	0	0
4	18240546	.	C	T	1	5	6	0	2	8	0	0
4	18240658	.	T	C	2	1	3	0	2	5	0	0
4	18240690	.	A	T	2	5	7	0	0	7	0	0
4	18241255	.	C	G	5	9	14	0	0	14	0	0
4	18241297	.	C	T	3	5	8	0	0	8	0	0
4	18242936	.	G	T	4	3	7	0	0	7	0	0
4	18244632	.	T	A	4	4	8	0	0	8	0	0
4	18248692	.	C	T	1	6	7	0	7	14	0	0
4	18249120	.	G	C	5	3	8	0	0	8	0	0
4	18249414	.	T	C	7	6	13	0	2	15	0	0
4	18249423	.	G	T	7	6	13	0	3	16	0	0
4	18250996	.	G	A	5	6	11	0	0	11	0	0
4	18251171	.	T	G	1	4	5	0	0	5	0	0
4	18283111	.	A	G	6	4	10	0	0	10	0	0
4	18283222	.	A	G	2	5	7	0	0	7	0	0
4	18287263	.	T	C	7	6	13	0	0	13	0	0
4	18287410	.	T	C	2	0	2	0	4	6	0	0
4	18287449	.	T	G	6	4	10	0	1	11	0	0
4	18287739	.	T	G	3	4	7	0	0	7	0	0
4	18287744	.	A	G	3	4	7	0	0	7	0	0
4	18289359	.	G	T	1	3	4	0	0	4	0	0
4	18301353	.	T	C	2	3	5	0	0	5	0	0
4	18304336	.	C	T	2	2	4	0	0	4	0	0
4	18416371	.	C	G	2	4	6	0	0	6	0	0
4	18432317	.	T	C	4	2	6	0	0	6	0	0
4	18432363	.	G	T	3	3	6	0	0	6	0	0
4	18436549	.	G	A	1	3	4	0	0	4	0	0
4	18447326	.	A	C	2	2	4	0	0	4	0	0
4	18454352	.	A	G	7	11	18	0	0	18	0	0
4	18454363	.	T	A	7	11	18	0	0	18	0	0
4	18454400	.	C	T	0	4	4	0	3	7	0	0
4	18454423	.	G	A	4	3	7	0	0	7	0	0
4	18502437	.	A	G	8	4	12	0	1	13	0	0
4	18504433	.	C	G	0	2	2	0	2	4	0	0
4	18505935	.	G	C	2	2	4	0	0	4	0	0
4	18507196	.	G	A	2	2	4	0	0	4	0	0
4	18512471	.	A	T	2	2	4	0	1	5	0	0
4	18592863	.	A	C	5	4	9	0	0	9	0	0
4	18593839	.	G	A	12	8	20	0	2	22	0	0
4	18594045	.	T	C	10	6	16	0	1	17	0	0
4	18594125	.	T	A	12	9	21	0	2	23	0	0
4	18594871	.	T	C	9	11	20	0	1	21	0	0
4	18594920	.	G	A	6	12	18	0	0	18	0	0
4	18597841	.	C	G	7	23	30	0	2	32	0	0
4	18599126	.	T	A	1	2	3	0	0	3	0	0
4	18606501	.	G	T	20	28	48	0	1	49	0	0
4	18606512	.	C	T	16	25	41	0	3	44	0	0
4	18609613	.	T	G	6	5	11	0	1	12	0	0
4	18609759	.	C	G	3	9	12	0	0	12	0	0
4	18609769	.	A	G	5	8	13	0	0	13	0	0
4	18609812	.	A	C	8	5	13	0	0	13	0	0
4	18609855	.	G	C	8	4	12	0	0	12	0	0
4	18614034	.	A	G	8	9	17	0	0	17	0	0
4	18614232	.	A	G	3	2	5	0	0	5	0	0
4	18614367	.	A	G	1	5	6	0	0	6	0	0
4	18614484	.	G	A	6	2	8	0	0	8	0	0
4	18623708	.	A	G	3	2	5	0	0	5	0	0
4	18709714	.	T	C	1	0	1	0	2	3	0	0
4	18720871	.	C	T	3	6	9	0	1	10	0	0
4	18737966	.	T	G	2	2	4	0	0	4	0	0
4	18738057	.	A	G	2	2	4	0	0	4	0	0
4	18738072	.	T	C	1	2	3	0	0	3	0	0
4	18738328	.	T	C	3	3	6	0	0	6	0	0
4	18741886	.	T	C	2	4	6	0	0	6	0	0
4	18741940	.	C	G	2	2	4	0	0	4	0	0
4	18837166	.	T	G	4	0	4	0	9	13	0	0
4	18837175	.	T	G	4	0	4	0	10	14	0	0
4	18837898	.	A	T	7	9	16	0	3	19	0	0
4	18848977	.	A	C	1	3	4	0	0	4	0	0
4	18853153	.	C	T	2	6	8	0	0	8	0	0
4	18853972	.	C	G	12	18	30	0	4	34	0	0
4	18854250	.	A	C	19	0	19	0	15	34	0	0
4	18963897	.	G	A	3	5	8	0	11	19	0	0
4	18963908	.	C	A	11	5	16	0	0	16	0	0
4	18963960	.	G	C	12	9	21	0	0	21	0	0
4	18976182	.	A	G	5	6	11	0	1	12	0	0
4	18976574	.	C	T	14	6	20	0	1	21	0	0
4	18979820	.	T	A	20	15	35	0	0	35	0	0
4	18985807	.	T	A	11	18	29	0	0	29	0	0
4	18985846	.	A	G	15	13	28	0	3	31	0	0
4	18985995	.	G	A	15	12	27	0	2	29	0	0
4	18986107	.	C	T	4	6	10	0	0	10	0	0
4	18986413	.	G	A	8	10	18	0	1	19	0	0
4	18986497	.	C	T	3	16	19	0	11	30	0	0
4	18986771	.	A	T	3	10	13	0	0	13	0	0
4	18986805	.	G	T	4	9	13	0	1	14	0	0
4	18986893	.	C	G	10	6	16	0	0	16	0	0
4	18986897	.	T	A	9	6	15	0	0	15	0	0
4	18987202	.	C	A	10	3	13	0	2	15	0	0
4	18987275	.	A	G	16	5	21	0	0	21	0	0
4	18987391	.	G	A	9	12	21	0	0	21	0	0
4	18987523	.	T	C	10	12	22	0	1	23	0	0
4	18987835	.	G	C	12	0	12	0	16	28	0	0
4	18988068	.	T	C	10	0	10	0	7	17	0	0
4	18988084	.	G	A	12	8	20	0	0	20	0	0
4	18988150	.	T	G	10	12	22	0	0	22	0	0
4	18988222	.	A	G	13	7	20	0	0	20	0	0
4	18988270	.	T	A	4	11	15	0	0	15	0	0
4	18988426	.	G	C	2	7	9	0	0	9	0	0
4	18988912	.	G	A	7	5	12	0	0	12	0	0
4	18989185	.	T	C	4	0	4	0	5	9	0	0
4	18999680	.	C	T	1	8	9	0	5	14	0	0
4	19007158	.	C	T	0	6	6	0	6	12	0	0
4	19007377	.	T	A	6	7	13	0	0	13	0	0
4	19007486	.	A	C	9	14	23	0	0	23	0	0
4	19007601	.	A	T	7	8	15	0	1	16	0	0
4	19007711	.	T	C	10	2	12	0	9	21	0	0
4	19007811	.	T	C	8	10	18	0	1	19	0	0
4	19007823	.	A	G	8	7	15	0	1	16	0	0
4	19008090	.	C	T	1	7	8	0	2	10	0	0
4	19397641	.	A	T	22	7	29	0	1	30	0	0
4	19414905	.	G	A	4	14	18	0	0	18	0	0
4	19421890	.	G	A	13	7	20	0	2	22	0	0
4	19493773	.	G	T	12	7	19	0	1	20	0	0
4	19493808	.	G	A	13	10	23	0	1	24	0	0
4	19535841	.	T	G	19	15	34	0	1	35	0	0
4	19536422	.	T	C	10	15	25	0	2	27	0	0
4	19536917	.	C	T	16	29	45	0	0	45	0	0
4	19537703	.	A	G	25	26	51	0	0	51	0	0
4	19537937	.	A	G	25	1	26	0	35	61	0	0
4	19539017	.	C	T	12	7	19	0	0	19	0	0
4	19567605	.	A	G	10	14	24	0	1	25	0	0
4	19611694	.	G	A	8	11	19	0	0	19	0	0
4	19611739	.	T	G	7	14	21	0	0	21	0	0
4	19630280	.	A	G	7	13	20	0	0	20	0	0
4	19651917	.	G	A	9	8	17	0	0	17	0	0
4	19686284	.	A	G	7	6	13	0	0	13	0	0
4	19690484	.	C	A	0	5	5	0	5	10	0	0
4	19777932	.	G	A	1	2	3	0	0	3	0	0
4	19855565	.	G	A	1	2	3	0	0	3	0	0
4	19948131	.	G	A	2	3	5	0	2	7	0	0
4	19948312	.	A	G	2	3	5	0	0	5	0	0
4	19948313	.	A	G	2	3	5	0	0	5	0	0
4	19948602	.	C	A	2	2	4	0	0	4	0	0
4	19948746	.	T	C	5	5	10	0	0	10	0	0
4	19949148	.	T	C	6	7	13	0	0	13	0	0
4	19949178	.	A	T	3	9	12	0	1	13	0	0
4	19949260	.	A	G	3	4	7	0	0	7	0	0
4	19949730	.	T	C	5	2	7	0	0	7	0	0
4	19949900	.	T	C	12	5	17	0	0	17	0	0
4	19949985	.	T	C	4	5	9	0	0	9	0	0
4	19950024	.	T	A	3	5	8	0	0	8	0	0
4	19950032	.	T	A	3	2	5	0	0	5	0	0
4	19950412	.	A	G	1	3	4	0	0	4	0	0
4	19950657	.	A	C	1	2	3	0	0	3	0	0
4	19955237	.	A	G	2	3	5	0	0	5	0	0
4	19955276	.	A	G	3	2	5	0	0	5	0	0
4	19962707	.	C	T	1	2	3	0	0	3	0	0
4	19962725	.	T	C	2	0	2	0	2	4	0	0
4	19981777	.	C	T	1	2	3	0	0	3	0	0
4	20049543	.	C	T	26	26	52	0	4	56	0	0
4	20051021	.	A	G	27	25	52	0	1	53	0	0
4	20051092	.	C	T	1	14	15	0	21	36	0	0
4	20053199	.	T	C	23	16	39	0	5	44	0	0
4	20053211	.	A	G	26	17	43	0	1	44	0	0
4	20053901	.	C	T	20	14	34	0	0	34	0	0
4	20054036	.	C	T	15	13	28	0	2	30	0	0
4	20054135	.	A	G	10	4	14	0	0	14	0	0
4	20054190	.	T	G	9	5	14	0	0	14	0	0
4	20054243	.	A	G	6	6	12	0	1	13	0	0
4	20054516	.	C	T	3	2	5	0	1	6	0	0
4	20060589	.	A	G	1	0	1	0	2	3	0	0
4	20065233	.	C	T	5	2	7	0	0	7	0	0
4	20066194	.	T	G	4	4	8	0	1	9	0	0
4	20066208	.	G	A	6	2	8	0	0	8	0	0
4	20066263	.	T	C	4	6	10	0	0	10	0	0
4	20068149	.	T	G	9	5	14	0	0	14	0	0
4	20068185	.	A	G	9	3	12	0	0	12	0	0
4	20068266	.	A	G	12	7	19	0	0	19	0	0
4	20068446	.	G	A	14	14	28	0	0	28	0	0
4	20068470	.	C	G	13	16	29	0	0	29	0	0
4	20068717	.	G	A	6	8	14	0	0	14	0	0
4	20068890	.	G	A	9	2	11	0	1	12	0	0
4	20068903	.	T	C	10	4	14	0	0	14	0	0
4	20069343	.	C	A	6	15	21	0	0	21	0	0
4	20071344	.	A	T	6	5	11	0	2	13	0	0
4	20071401	.	G	T	5	7	12	0	0	12	0	0
4	20071877	.	C	T	0	2	2	0	2	4	0	0
4	20072394	.	C	G	13	9	22	0	1	23	0	0
4	20072429	.	T	G	12	10	22	0	0	22	0	0
4	20073790	.	T	C	8	12	20	0	1	21	0	0
4	20075455	.	T	C	5	8	13	0	0	13	0	0
4	20075473	.	G	A	7	8	15	0	0	15	0	0
4	20078569	.	G	A	4	3	7	0	1	8	0	0
4	20080778	.	T	A	4	4	8	0	0	8	0	0
4	20081451	.	A	G	4	2	6	0	0	6	0	0
4	20081520	.	C	A	1	3	4	0	5	9	0	0
4	20089075	.	C	A	5	2	7	0	1	8	0	0
4	20091055	.	G	C	2	7	9	0	7	16	0	0
4	20098793	.	C	G	4	3	7	0	0	7	0	0
4	20099022	.	G	A	4	4	8	0	0	8	0	0
4	20099261	.	C	T	6	6	12	0	2	14	0	0
4	20099516	.	G	A	0	2	2	0	8	10	0	0
4	20099564	.	C	T	1	3	4	0	1	5	0	0
4	20101105	.	G	T	5	4	9	0	0	9	0	0
4	20102901	.	C	A	5	2	7	0	0	7	0	0
4	20103813	.	T	A	6	4	10	0	0	10	0	0
4	20103864	.	G	A	6	4	10	0	0	10	0	0
4	20103873	.	T	C	8	4	12	0	0	12	0	0
4	20105455	.	T	A	1	6	7	0	1	8	0	0
4	20125767	.	A	G	3	5	8	0	0	8	0	0
4	20127909	.	C	T	1	4	5	0	0	5	0	0
4	20130015	.	G	T	3	4	7	0	0	7	0	0
4	20130216	.	T	C	3	3	6	0	0	6	0	0
4	20135088	.	A	C	2	0	2	0	4	6	0	0
4	20145979	.	G	A	2	2	4	0	0	4	0	0
4	20226916	.	A	C	9	9	18	0	1	19	0	0
4	20229626	.	C	T	9	9	18	0	1	19	0	0
4	20229920	.	C	A	0	11	11	0	12	23	0	0
4	20230213	.	G	A	11	5	16	0	0	16	0	0
4	20232838	.	A	G	9	9	18	0	1	19	0	0
4	20235766	.	G	A	11	11	22	0	0	22	0	0
4	20265275	.	A	T	7	18	25	0	0	25	0	0
4	20265309	.	C	T	8	13	21	0	1	22	0	0
4	20303423	.	T	C	6	2	8	0	0	8	0	0
4	20303545	.	T	C	3	3	6	0	0	6	0	0
4	20303604	.	T	C	1	2	3	0	0	3	0	0
4	20305520	.	G	T	3	2	5	0	0	5	0	0
4	20305777	.	T	G	2	5	7	0	1	8	0	0
4	20306278	.	T	C	1	4	5	0	0	5	0	0
4	20306333	.	G	A	2	3	5	0	0	5	0	0
4	20306436	.	C	T	3	3	6	0	0	6	0	0
4	20306447	.	T	C	1	0	1	0	3	4	0	0
4	20447754	.	A	G	5	7	12	0	1	13	0	0
4	20453583	.	A	C	7	11	18	0	2	20	0	0
4	20453824	.	A	G	7	8	15	1	0	16	0	0
4	20464937	.	C	T	13	4	17	0	1	18	0	0
4	20465711	.	T	C	6	4	10	0	0	10	0	0
4	20465899	.	C	T	10	7	17	0	1	18	0	0
4	20467610	.	T	C	9	14	23	0	0	23	0	0
4	20470061	.	G	A	15	14	29	0	0	29	0	0
4	20470205	.	C	T	11	14	25	0	1	26	0	0
4	20470316	.	C	T	16	10	26	0	1	27	0	0
4	20473032	.	G	A	18	9	27	0	1	28	0	0
4	20473127	.	G	A	0	16	16	0	10	26	0	0
4	20473142	.	C	T	14	15	29	0	0	29	0	0
4	20473175	.	C	T	18	11	29	0	0	29	0	0
4	20474363	.	A	T	15	12	27	1	1	29	0	0
4	20474728	.	A	T	13	8	21	0	0	21	0	0
4	20474969	.	A	G	10	0	10	0	12	22	0	0
4	20480734	.	G	A	7	7	14	0	0	14	0	0
4	20482150	.	T	C	7	7	14	0	0	14	0	0
4	20482425	.	A	G	11	6	17	0	1	18	0	0
4	20482506	.	C	T	5	7	12	0	0	12	0	0
4	20482615	.	G	T	5	6	11	0	1	12	0	0
4	20482726	.	A	G	8	3	11	0	1	12	0	0
4	20483785	.	G	A	1	4	5	0	2	7	0	0
4	20483846	.	T	G	4	4	8	0	0	8	0	0
4	20483881	.	C	T	6	5	11	0	0	11	0	0
4	20483901	.	G	A	5	6	11	0	1	12	0	0
4	20483918	.	A	G	7	7	14	0	0	14	0	0
4	20486087	.	T	A	2	2	4	0	0	4	0	0
4	20486173	.	T	C	4	3	7	0	0	7	0	0
4	20486260	.	A	T	1	3	4	0	0	4	0	0
4	20488741	.	T	C	3	2	5	0	0	5	0	0
4	20490031	.	C	T	5	2	7	0	0	7	0	0
4	20490043	.	T	C	5	2	7	0	0	7	0	0
4	20494332	.	C	T	10	6	16	0	1	17	0	0
4	20498240	.	A	G	7	7	14	0	1	15	0	0
4	20499421	.	G	C	8	6	14	0	0	14	0	0
4	20499440	.	A	G	9	5	14	0	1	15	0	0
4	20499493	.	T	G	3	3	6	0	1	7	0	0
4	20499516	.	G	T	3	2	5	0	0	5	0	0
4	20499557	.	G	A	2	2	4	0	0	4	0	0
4	20507121	.	T	A	7	12	19	0	3	22	0	0
4	20507155	.	A	C	8	10	18	0	4	22	0	0
4	20507473	.	T	A	8	7	15	0	1	16	0	0
4	20507546	.	T	A	9	10	19	0	1	20	0	0
4	20508691	.	G	A	6	5	11	0	1	12	0	0
4	20508913	.	A	G	6	12	18	0	0	18	0	0
4	20508928	.	A	G	6	12	18	0	1	19	0	0
4	20508992	.	C	T	11	16	27	0	2	29	0	0
4	20930170	.	C	T	2	2	4	0	1	5	0	0
4	20949623	.	G	C	6	3	9	0	0	9	0	0
4	20950073	.	C	T	2	5	7	0	0	7	0	0
4	20950816	.	T	C	4	4	8	0	1	9	0	0
4	20950990	.	A	C	2	2	4	0	0	4	0	0
4	20951111	.	G	A	2	4	6	0	0	6	0	0
4	20951390	.	C	T	8	7	15	0	1	16	0	0
4	20952889	.	C	T	4	7	11	0	0	11	0	0
4	20952934	.	A	G	1	0	1	0	6	7	0	0
4	20953265	.	C	A	9	3	12	0	0	12	0	0
4	20955052	.	T	C	8	6	14	0	1	15	0	0
4	20959176	.	T	C	4	2	6	0	1	7	0	0
4	20965426	.	A	T	5	3	8	0	0	8	0	0
4	20965483	.	T	C	8	6	14	0	0	14	0	0
4	20971490	.	C	T	11	8	19	0	0	19	0	0
4	20974250	.	C	T	7	8	15	0	0	15	0	0
4	20974343	.	C	A	5	9	14	0	0	14	0	0
4	20976062	.	A	T	5	11	16	0	1	17	0	0
4	20976085	.	G	A	6	12	18	0	0	18	0	0
4	20976252	.	G	A	4	6	10	0	0	10	0	0
4	20976371	.	C	T	6	3	9	0	0	9	0	0
4	20979435	.	C	A	11	6	17	0	1	18	0	0
4	20980971	.	A	G	8	13	21	0	0	21	0	0
4	20981198	.	G	A	1	8	9	0	12	21	0	0
4	20981273	.	A	C	6	8	14	0	0	14	0	0
4	21290798	.	G	A	31	25	56	0	3	59	0	0
4	21295949	.	T	C	28	21	49	0	6	55	0	0
4	21297417	.	A	C	30	25	55	0	1	56	0	0
4	21312642	.	T	C	33	19	52	0	2	54	0	0
4	21312981	.	C	T	33	20	53	0	7	60	0	0
4	21313120	.	A	G	20	3	23	0	42	65	0	0
4	21313136	.	T	C	26	35	61	0	5	66	0	0
4	21313779	.	T	G	38	25	63	0	2	65	0	0
4	21313805	.	G	A	4	26	30	0	43	73	0	0
4	21314120	.	T	C	24	33	57	2	1	60	0	0
4	21314204	.	G	T	24	23	47	1	1	49	0	0
4	21314338	.	G	T	34	32	66	0	1	67	0	0
4	21314583	.	T	C	25	23	48	0	2	50	0	0
4	21323076	.	G	C	1	2	3	0	0	3	0	0
4	21323083	.	A	C	1	2	3	0	0	3	0	0
4	21323215	.	T	C	1	0	1	0	2	3	0	0
4	21323216	.	T	G	1	2	3	0	0	3	0	0
4	21323363	.	G	C	2	4	6	0	2	8	0	0
4	21323454	.	A	G	4	4	8	0	1	9	0	0
4	21323467	.	G	C	5	6	11	0	0	11	0	0
4	21323532	.	C	T	1	5	6	0	4	10	0	0
4	21323536	.	T	C	5	4	9	0	1	10	0	0
4	21369434	.	G	A	2	5	7	0	0	7	0	0
4	21489392	.	C	A	15	12	27	1	4	32	0	0
4	21489397	.	C	A	15	12	27	1	5	33	0	0
4	21489551	.	A	G	14	1	15	0	4	19	0	0
4	21489629	.	G	T	13	9	22	0	0	22	0	0
4	21490320	.	T	C	23	11	34	0	0	34	0	0
4	21490344	.	A	G	23	13	36	0	1	37	0	0
4	21499521	.	G	A	9	17	26	0	1	27	0	0
4	21507026	.	G	A	8	10	18	0	1	19	0	0
4	21508353	.	C	T	18	11	29	0	1	30	0	0
4	21512191	.	C	T	11	17	28	2	3	33	0	0
4	21517970	.	A	G	11	9	20	0	0	20	0	0
4	21523541	.	A	T	15	7	22	1	2	25	0	0
4	21523789	.	T	G	10	6	16	0	0	16	0	0
4	21525430	.	G	T	4	12	16	0	0	16	0	0
4	21526300	.	A	G	9	10	19	0	0	19	0	0
4	21649505	.	G	A	34	43	77	0	7	84	0	0
4	21651486	.	G	A	36	32	68	0	1	69	0	0
4	21652609	.	A	T	13	7	20	0	0	20	0	0
4	21752284	.	G	A	10	7	17	0	0	17	0	0
4	21752291	.	C	T	8	8	16	0	0	16	0	0
4	21752372	.	T	A	7	10	17	0	0	17	0	0
4	21752493	.	T	C	4	6	10	0	0	10	0	0
4	21752495	.	C	G	4	6	10	0	0	10	0	0
4	21752688	.	G	C	14	1	15	0	13	29	1	0
4	21752736	.	T	C	10	12	22	0	1	23	0	0
4	21752941	.	T	A	13	8	21	0	1	22	0	0
4	21752969	.	C	T	13	8	21	0	0	21	0	0
4	21752984	.	C	A	12	8	20	0	0	20	0	0
4	21753139	.	C	T	9	15	24	0	1	25	0	0
4	21753185	.	T	C	16	18	34	0	2	36	0	0
4	21753316	.	T	C	12	13	25	0	4	29	0	0
4	21753344	.	G	A	10	14	24	0	1	25	0	0
4	21761688	.	A	T	18	16	34	0	2	36	0	0
4	22756239	.	T	C	20	13	33	0	0	33	0	0
4	23775435	.	T	G	4	0	4	0	20	24	0	0
4	25739717	.	G	C	1	4	5	0	0	5	0	0
4	25739775	.	T	C	1	2	3	0	0	3	0	0
4	25746452	.	A	G	2	0	2	0	4	6	0	0
4	25747948	.	C	T	4	5	9	0	0	9	0	0
4	25747994	.	C	T	4	2	6	0	0	6	0	0
4	25750850	.	G	A	2	4	6	0	0	6	0	0
4	25751003	.	A	G	1	0	1	0	7	8	0	0
4	25755269	.	C	T	13	11	24	0	0	24	0	0
4	25755341	.	T	A	10	4	14	0	0	14	0	0
4	25755359	.	G	T	6	5	11	0	0	11	0	0
4	25756387	.	T	G	7	2	9	0	0	9	0	0
4	25756432	.	A	G	8	3	11	0	0	11	0	0
4	25756453	.	G	T	7	3	10	0	0	10	0	0
4	25759088	.	T	A	7	6	13	0	0	13	0	0
4	25759183	.	T	C	5	6	11	0	0	11	0	0
4	25759327	.	G	A	6	8	14	0	0	14	0	0
4	25759518	.	C	A	3	3	6	0	7	13	0	0
4	25759549	.	T	C	9	4	13	0	0	13	0	0
4	25759690	.	A	G	14	6	20	0	0	20	0	0
4	25759816	.	T	C	5	6	11	0	0	11	0	0
4	25796742	.	T	C	8	1	9	0	7	16	0	0
4	25796765	.	G	A	7	7	14	0	0	14	0	0
4	25796784	.	C	T	1	5	6	0	5	11	0	0
4	25829939	.	G	A	14	7	21	0	1	22	0	0
4	25833146	.	A	G	21	28	49	0	1	50	0	0
4	25833221	.	G	A	34	21	55	0	0	55	0	0
4	25839737	.	G	A	3	2	5	0	2	7	0	0
4	25839832	.	A	G	7	5	12	0	1	13	0	0
4	25842788	.	C	T	3	4	7	0	0	7	0	0
4	25843659	.	A	G	4	4	8	0	0	8	0	0
4	25853058	.	C	T	2	4	6	0	0	6	0	0
4	25860509	.	T	C	2	3	5	0	1	6	0	0
4	25860634	.	C	T	2	4	6	0	0	6	0	0
4	25861313	.	T	C	1	0	1	0	4	5	0	0
4	25861883	.	T	A	1	2	3	0	0	3	0	0
4	25862009	.	A	G	4	6	10	0	1	11	0	0
4	25862231	.	A	G	4	6	10	0	0	10	0	0
4	25862270	.	A	G	4	4	8	0	0	8	0	0
4	25862284	.	G	A	3	5	8	0	0	8	0	0
4	25862309	.	G	A	1	4	5	0	0	5	0	0
4	25864326	.	T	C	3	4	7	0	0	7	0	0
4	25864355	.	G	T	4	3	7	0	1	8	0	0
4	25881181	.	C	T	1	2	3	0	0	3	0	0
4	25906925	.	A	G	4	4	8	0	0	8	0	0
4	25907688	.	A	G	3	3	6	0	0	6	0	0
4	25907717	.	G	A	3	3	6	0	0	6	0	0
4	25907905	.	T	C	1	2	3	0	0	3	0	0
4	25908114	.	G	A	2	2	4	0	0	4	0	0
4	25908593	.	C	T	0	2	2	0	1	3	0	0
4	25932628	.	A	G	4	0	4	0	6	10	0	0
4	25932664	.	A	T	3	3	6	0	2	8	0	0
4	25934667	.	G	A	4	8	12	0	0	12	0	0
4	25934722	.	T	C	5	10	15	0	0	15	0	0
4	25936437	.	A	G	9	7	16	0	1	17	0	0
4	25936491	.	A	G	6	5	11	0	0	11	0	0
4	25939158	.	A	G	4	3	7	0	0	7	0	0
4	26012322	.	C	T	5	2	7	0	0	7	0	0
4	26015476	.	C	T	3	5	8	0	0	8	0	0
4	26016340	.	A	C	2	3	5	0	2	7	0	0
4	26021876	.	G	A	1	2	3	0	1	4	0	0
4	26021910	.	A	G	5	2	7	0	0	7	0	0
4	26022076	.	T	C	4	0	4	0	5	9	0	0
4	26022351	.	C	G	3	5	8	0	0	8	0	0
4	26022447	.	T	C	4	0	4	0	5	9	0	0
4	26022637	.	T	C	5	5	10	0	0	10	0	0
4	26022640	.	C	T	0	6	6	0	5	11	0	0
4	26026444	.	T	C	12	5	17	0	1	18	0	0
4	26027022	.	A	G	5	6	11	0	0	11	0	0
4	26028813	.	C	T	4	2	6	0	0	6	0	0
4	26028873	.	C	T	2	4	6	0	0	6	0	0
4	26028947	.	C	T	1	4	5	0	3	8	0	0
4	26029119	.	A	G	3	5	8	0	0	8	0	0
4	26029362	.	T	A	4	4	8	0	0	8	0	0
4	26029413	.	T	C	3	0	3	0	2	5	0	0
4	26056542	.	A	G	3	6	9	0	0	9	0	0
4	26056580	.	C	T	8	9	17	0	0	17	0	0
4	26056589	.	A	G	8	8	16	0	1	17	0	0
4	26056643	.	C	T	5	5	10	0	0	10	0	0
4	26067359	.	C	A	2	2	4	0	1	5	0	0
4	26068170	.	T	C	7	9	16	0	0	16	0	0
4	26072844	.	G	A	8	7	15	0	0	15	0	0
4	26075640	.	G	C	6	3	9	0	0	9	0	0
4	26075856	.	G	A	7	4	11	0	2	13	0	0
4	26075882	.	A	G	7	0	7	0	7	14	0	0
4	26077483	.	T	C	8	6	14	0	1	15	0	0
4	26077671	.	A	T	9	15	24	0	2	26	0	0
4	26078008	.	T	C	5	5	10	0	0	10	0	0
4	26078134	.	A	G	3	4	7	0	0	7	0	0
4	26078174	.	C	A	8	0	8	0	4	13	1	0
4	26078205	.	G	A	0	6	6	0	8	14	0	0
4	26078675	.	A	T	3	2	5	0	0	5	0	0
4	26078847	.	A	G	8	3	11	0	0	11	0	0
4	26079096	.	A	C	8	12	20	0	1	21	0	0
4	26079116	.	T	C	4	8	12	0	3	15	0	0
4	26079174	.	A	C	3	3	6	0	0	6	0	0
4	26079267	.	T	G	4	0	4	0	8	12	0	0
4	26079721	.	T	A	0	2	2	0	1	3	0	0
4	26079838	.	A	G	2	3	5	0	0	5	0	0
4	26079844	.	A	G	1	3	4	0	1	5	0	0
4	26080071	.	T	C	6	3	9	0	0	9	0	0
4	26080387	.	T	A	13	6	19	0	1	20	0	0
4	26080441	.	C	T	10	7	17	0	0	17	0	0
4	26304240	.	T	G	9	16	25	0	2	27	0	0
4	26304451	.	T	C	18	9	27	0	3	30	0	0
4	26304730	.	G	T	7	5	12	0	2	14	0	0
4	26305191	.	T	C	13	4	17	0	0	17	0	0
4	26305286	.	C	A	9	6	15	0	0	15	0	0
4	26305309	.	T	A	9	10	19	0	0	19	0	0
4	26305324	.	C	T	6	9	15	0	0	15	0	0
4	26305413	.	A	C	16	12	28	0	0	28	0	0
4	26305468	.	A	T	13	9	22	0	0	22	0	0
4	26305516	.	A	T	11	9	20	0	0	20	0	0
4	26305578	.	A	T	9	8	17	0	0	17	0	0
4	26306209	.	A	G	13	9	22	0	0	22	0	0
4	26321216	.	A	G	9	7	16	0	0	16	0	0
4	26322655	.	C	A	0	16	16	0	12	28	0	0
4	26322721	.	C	T	2	9	11	0	14	25	0	0
4	26496683	.	G	A	10	10	20	0	2	22	0	0
4	26496730	.	G	A	7	10	17	0	1	18	0	0
4	26762518	.	G	T	1	4	5	0	0	5	0	0
4	26764217	.	C	T	9	4	13	0	0	14	1	0
4	26765056	.	T	C	3	3	6	0	0	6	0	0
4	26765057	.	A	T	3	3	6	0	0	6	0	0
4	26765359	.	A	T	3	3	6	0	0	6	0	0
4	27082166	.	T	C	5	2	7	0	1	8	0	0
4	27104963	.	C	T	4	2	6	0	0	6	0	0
4	27105026	.	A	C	2	2	4	0	0	4	0	0
4	27113093	.	A	G	2	4	6	0	1	7	0	0
4	27113479	.	G	A	4	6	10	0	0	11	1	0
4	27113986	.	G	A	4	4	8	1	0	9	0	0
4	27114157	.	T	C	5	2	7	0	1	8	0	0
4	27114894	.	A	G	7	4	11	0	0	11	0	0
4	27115765	.	A	G	6	4	10	0	0	10	0	0
4	27116335	.	A	G	2	2	4	0	0	4	0	0
4	27116905	.	C	A	2	2	4	0	0	4	0	0
4	27117215	.	T	C	6	3	9	0	0	9	0	0
4	27132114	.	A	G	4	2	6	0	0	6	0	0
4	27132314	.	A	C	3	2	5	0	0	5	0	0
4	27133405	.	T	A	2	4	6	0	1	7	0	0
4	27133498	.	G	A	2	4	6	0	0	6	0	0
4	27137874	.	G	A	4	5	9	0	0	9	0	0
4	27137991	.	T	G	5	8	13	0	1	14	0	0
4	27139739	.	T	C	3	7	10	0	0	10	0	0
4	27139955	.	T	A	4	2	6	0	0	6	0	0
4	27140031	.	G	A	0	4	4	0	2	6	0	0
4	27140644	.	C	T	2	6	8	0	1	9	0	0
4	27140658	.	A	G	2	7	9	0	0	9	0	0
4	27145549	.	T	C	6	3	9	0	0	9	0	0
4	27147440	.	T	G	5	5	10	0	0	10	0	0
4	27147510	.	T	C	4	3	7	0	0	7	0	0
4	27147712	.	C	T	8	10	18	0	1	19	0	0
4	27147752	.	A	G	9	7	16	0	0	16	0	0
4	27148291	.	G	T	7	3	10	0	0	10	0	0
4	27148417	.	T	C	4	10	14	1	0	15	0	0
4	27148425	.	A	T	6	8	14	1	0	15	0	0
4	27148545	.	A	C	5	6	11	0	0	11	0	0
4	27148943	.	A	C	6	6	12	0	0	12	0	0
4	27149017	.	G	A	0	7	7	0	2	9	0	0
4	27149676	.	G	T	1	4	5	0	2	7	0	0
4	27149680	.	G	T	2	5	7	0	1	8	0	0
4	27252027	.	T	C	10	5	15	0	0	15	0	0
4	27252096	.	C	T	10	3	13	0	0	13	0	0
4	27252178	.	C	T	2	9	11	0	9	20	0	0
4	27252581	.	G	A	11	10	21	0	0	21	0	0
4	27350432	.	G	T	11	3	14	0	0	14	0	0
4	27350666	.	G	A	5	9	14	0	0	14	0	0
4	27350674	.	C	G	0	9	9	0	5	14	0	0
4	27627569	.	C	T	2	2	4	0	0	4	0	0
4	27628373	.	G	A	1	2	3	0	0	3	0	0
4	27628686	.	C	A	0	2	2	0	3	5	0	0
4	27628697	.	A	C	3	2	5	0	0	5	0	0
4	27628788	.	T	A	5	2	7	0	1	8	0	0
4	27713785	.	A	T	1	4	5	0	0	5	0	0
4	27869698	.	C	T	1	3	4	0	1	5	0	0
4	27890564	.	A	G	1	3	4	0	0	4	0	0
4	27898949	.	C	T	3	6	9	0	0	9	0	0
4	27921925	.	A	G	6	10	16	0	0	16	0	0
4	27921962	.	G	C	1	6	7	0	11	18	0	0
4	27945941	.	T	C	8	5	13	0	0	13	0	0
4	28062562	.	G	C	1	7	8	0	0	8	0	0
4	28062581	.	A	G	2	7	9	0	1	10	0	0
4	28062603	.	G	A	5	6	11	0	0	11	0	0
4	28062846	.	T	A	3	5	8	0	0	8	0	0
4	28062920	.	T	C	7	0	7	0	3	10	0	0
4	28063086	.	G	A	6	8	14	0	1	15	0	0
4	28063385	.	G	A	3	3	6	0	0	6	0	0
4	28063469	.	T	C	5	0	5	0	4	9	0	0
4	28063635	.	A	G	6	8	14	0	0	14	0	0
4	28063653	.	G	T	5	10	15	0	0	16	1	0
4	28063715	.	A	G	2	12	14	0	0	14	0	0
4	28063873	.	T	C	5	6	11	0	0	11	0	0
4	28063876	.	T	C	6	6	12	0	0	12	0	0
4	28063911	.	C	G	1	5	6	0	7	13	0	0
4	28064028	.	T	C	4	6	10	0	1	11	0	0
4	28066394	.	G	A	9	6	15	0	2	17	0	0
4	28066425	.	C	T	8	8	16	0	1	17	0	0
4	28068908	.	G	A	4	10	14	0	0	14	0	0
4	28084993	.	A	G	7	6	13	0	0	13	0	0
4	28093323	.	A	G	7	7	14	0	0	14	0	0
4	28191712	.	G	A	2	2	4	0	1	5	0	0
4	28191752	.	C	T	0	3	3	0	3	6	0	0
4	28194299	.	C	T	2	2	4	0	0	4	0	0
4	28194359	.	G	A	3	3	6	0	0	6	0	0
4	28195380	.	A	C	5	3	8	0	1	9	0	0
4	28195396	.	T	C	7	3	10	0	0	10	0	0
4	28197964	.	T	G	3	4	7	0	0	7	0	0
4	28198271	.	A	G	3	4	7	0	0	7	0	0
4	28198292	.	T	A	2	6	8	0	0	8	0	0
4	28200250	.	T	C	2	0	2	0	2	4	0	0
4	28202709	.	G	T	2	3	5	0	0	5	0	0
4	28211121	.	C	A	2	4	6	0	0	6	0	0
4	28215241	.	G	A	2	4	6	0	0	6	0	0
4	28215277	.	T	C	2	0	2	0	3	5	0	0
4	28221120	.	A	G	1	2	3	0	0	3	0	0
4	28339246	.	C	G	3	2	5	0	0	5	0	0
4	28343794	.	A	G	5	3	8	0	0	8	0	0
4	28343976	.	A	G	2	2	4	0	0	4	0	0
4	28344009	.	G	A	2	2	4	0	0	4	0	0
4	28344012	.	A	G	2	2	4	0	0	4	0	0
4	28373691	.	A	G	9	4	13	0	1	14	0	0
4	28373791	.	T	G	9	7	16	0	0	16	0	0
4	28374731	.	C	G	1	2	3	0	0	3	0	0
4	28379240	.	G	T	1	4	5	0	0	5	0	0
4	28379266	.	G	T	1	3	4	0	0	4	0	0
4	28379899	.	A	T	2	4	6	0	0	6	0	0
4	28419637	.	G	A	2	2	4	0	0	4	0	0
4	28422589	.	T	A	1	3	4	0	1	5	0	0
4	28423483	.	T	C	2	2	4	0	0	4	0	0
4	28423499	.	A	T	2	3	5	0	1	6	0	0
4	28423528	.	C	G	3	0	3	0	2	5	0	0
4	28423547	.	C	T	3	2	5	0	0	5	0	0
4	28423735	.	C	T	4	5	9	0	0	9	0	0
4	28423886	.	A	C	1	4	5	0	0	5	0	0
4	28423952	.	G	C	1	3	4	0	1	5	0	0
4	28821416	.	G	A	0	2	2	2	2	6	0	0
4	28821417	.	A	T	1	2	3	2	1	6	0	0
4	28975083	.	C	T	1	2	3	1	0	4	0	0
4	28975577	.	T	C	1	2	3	0	0	3	0	0
4	28975587	.	A	C	1	2	3	0	0	3	0	0
4	28975943	.	G	A	2	2	4	0	0	4	0	0
4	29040165	.	A	G	1	2	3	0	0	3	0	0
4	29040548	.	A	G	3	2	5	0	0	5	0	0
4	29040677	.	G	A	1	4	5	0	0	5	0	0
4	29040980	.	C	A	1	3	4	0	0	4	0	0
4	29041638	.	T	A	2	3	5	0	0	5	0	0
4	29050168	.	T	A	2	3	5	0	0	5	0	0
4	29287642	.	G	A	0	2	2	0	2	4	0	0
4	29854432	.	T	C	1	2	3	0	0	3	0	0
4	35893649	.	A	T	1	2	3	1	0	4	0	0
4	37246082	.	C	T	2	2	4	0	0	4	0	0
4	40959639	.	T	G	1	3	4	0	0	4	0	0
4	42038973	.	G	A	5	4	9	0	0	9	0	0
4	44572949	.	A	G	1	2	3	2	0	5	0	0
4	46914925	.	C	T	1	7	8	2	0	10	0	0
4	50755435	.	G	A	1	2	3	1	0	4	0	0
4	50756006	.	C	T	1	2	3	1	0	4	0	0
4	50756495	.	G	A	2	3	5	0	0	5	0	0
4	51172528	.	A	C	3	3	6	0	0	6	0	0
4	55587518	.	T	C	2	2	4	0	0	4	0	0
4	55873259	.	C	G	0	2	2	2	1	5	0	0
4	56772511	.	C	A	1	2	3	0	0	3	0	0
4	65727802	.	C	T	3	3	6	1	0	7	0	0
4	65727822	.	G	A	3	3	6	1	1	8	0	0
4	68497199	.	G	A	5	4	9	1	0	10	0	0
4	69126719	.	C	A	6	2	8	7	0	15	0	0
4	70843223	.	T	C	3	2	5	0	0	5	0	0
4	70843237	.	T	G	3	2	5	0	1	6	0	0
4	70843283	.	G	A	4	5	9	0	0	9	0	0
4	70843302	.	G	T	4	4	8	0	0	8	0	0
4	70850712	.	T	C	1	2	3	0	0	3	0	0
4	70851069	.	G	A	8	4	12	6	0	18	0	0
4	70851105	.	A	G	9	4	13	3	1	17	0	0
4	70855931	.	T	C	4	2	6	0	3	9	0	0
4	70860034	.	A	C	6	0	6	2	9	17	0	0
4	70860166	.	A	G	15	7	22	0	0	22	0	0
4	70864466	.	G	A	3	5	8	0	0	8	0	0
4	70866411	.	G	A	5	3	8	2	0	10	0	0
4	70866787	.	A	T	12	4	16	0	0	16	0	0
4	70866791	.	A	T	12	5	17	0	0	17	0	0
4	70867005	.	G	C	5	3	8	1	0	9	0	0
4	72217285	.	T	C	1	7	8	0	0	8	0	0
4	72217438	.	A	C	1	4	5	0	0	5	0	0
4	72217647	.	T	C	1	2	3	0	0	3	0	0
4	72217779	.	A	G	4	0	4	0	4	8	0	0
4	72217813	.	T	C	5	5	10	0	0	10	0	0
4	72217847	.	G	A	0	3	3	0	4	7	0	0
4	72235663	.	A	G	1	3	4	0	0	4	0	0
4	72235685	.	C	G	0	4	4	0	0	4	0	0
4	72272239	.	G	A	7	2	9	0	0	9	0	0
4	72272461	.	C	T	3	2	5	0	0	5	0	0
4	72272617	.	G	A	2	4	6	0	0	6	0	0
4	72275250	.	G	A	3	4	7	0	0	7	0	0
4	72275308	.	C	T	3	4	7	0	0	7	0	0
4	72296413	.	C	G	2	3	5	0	0	5	0	0
4	72296433	.	C	G	3	4	7	0	0	7	0	0
4	72309499	.	T	C	3	2	5	0	0	5	0	0
4	72314968	.	G	A	2	2	4	0	1	5	0	0
4	72349041	.	G	A	3	4	7	0	1	8	0	0
4	72349343	.	C	T	1	2	3	0	0	3	0	0
4	72573242	.	A	C	4	4	8	0	0	8	0	0
4	72573245	.	T	C	4	0	4	0	4	8	0	0
4	72573302	.	T	G	2	2	4	0	0	4	0	0
4	72603483	.	C	A	3	4	7	0	0	7	0	0
4	72603620	.	G	A	1	3	4	0	0	4	0	0
4	72603653	.	G	A	2	3	5	0	0	5	0	0
4	72603725	.	A	G	2	2	4	0	0	4	0	0
4	72629131	.	T	C	3	0	3	0	2	5	0	0
4	72629138	.	C	T	1	2	3	0	2	5	0	0
4	72629622	.	G	A	3	2	5	0	0	5	0	0
4	72630231	.	G	A	6	5	11	0	0	11	0	0
4	72630316	.	G	A	2	4	6	0	0	6	0	0
4	72630351	.	C	A	4	4	8	0	0	8	0	0
4	72630360	.	C	G	5	4	9	0	0	9	0	0
4	72678551	.	C	T	1	2	3	0	0	3	0	0
4	72678592	.	G	C	1	2	3	0	0	3	0	0
4	72723910	.	T	A	7	3	10	7	1	18	0	0
4	72754244	.	C	T	18	23	41	1	0	42	0	0
4	72772769	.	T	C	16	11	27	0	0	27	0	0
4	72775687	.	C	A	17	16	33	0	0	33	0	0
4	72781277	.	A	G	22	18	40	0	2	42	0	0
4	72784800	.	T	C	9	11	20	0	3	23	0	0
4	72785055	.	T	C	1	3	4	0	0	4	0	0
4	72785056	.	T	C	1	3	4	0	0	4	0	0
4	72785129	.	C	G	1	3	4	0	0	4	0	0
4	72785147	.	T	C	1	3	4	0	0	4	0	0
4	72785238	.	T	A	4	3	7	0	0	7	0	0
4	72785245	.	C	T	3	4	7	0	0	7	0	0
4	72785303	.	T	G	3	0	3	0	2	5	0	0
4	72785306	.	G	A	0	2	2	0	3	5	0	0
4	73059149	.	C	T	6	5	11	0	0	11	0	0
4	73059245	.	C	T	2	7	9	0	1	10	0	0
4	73059299	.	T	A	1	6	7	0	0	7	0	0
4	73059408	.	T	C	3	5	8	0	0	8	0	0
4	73063082	.	A	G	5	1	6	0	8	14	0	0
4	73063417	.	T	G	6	4	10	0	0	10	0	0
4	73063427	.	A	C	4	2	6	0	0	6	0	0
4	73063511	.	C	T	2	2	4	0	0	4	0	0
4	73063534	.	C	A	1	2	3	0	0	3	0	0
4	73064381	.	A	G	3	0	3	0	4	7	0	0
4	73064409	.	A	G	4	4	8	0	0	8	0	0
4	73064991	.	T	C	1	5	6	0	1	7	0	0
4	73186242	.	A	C	1	2	3	0	0	3	0	0
4	73186320	.	G	A	2	2	4	0	1	5	0	0
4	73186351	.	G	A	1	4	5	0	0	5	0	0
4	73186390	.	G	A	1	2	3	0	1	4	0	0
4	73188539	.	G	A	1	2	3	0	0	3	0	0
4	73205755	.	A	C	1	2	3	0	0	3	0	0
4	73274151	.	T	C	2	3	5	0	0	5	0	0
4	73277237	.	G	A	1	2	3	0	0	3	0	0
4	73277245	.	T	G	1	2	3	0	0	3	0	0
4	73335956	.	G	A	4	4	8	0	0	8	0	0
4	73335990	.	T	A	3	5	8	0	0	8	0	0
4	73336441	.	C	T	2	3	5	0	0	5	0	0
4	73336618	.	C	T	2	4	6	0	0	6	0	0
4	73336629	.	C	T	2	4	6	0	0	6	0	0
4	73336748	.	C	T	0	2	2	0	1	3	0	0
4	73336863	.	A	C	4	2	6	0	0	6	0	0
4	73336869	.	G	C	3	2	5	0	0	5	0	0
4	73337244	.	A	G	1	7	8	0	0	8	0	0
4	73337248	.	G	A	3	7	10	0	0	10	0	0
4	73337565	.	T	A	3	3	6	0	0	6	0	0
4	73337601	.	G	A	2	3	5	0	1	6	0	0
4	73337911	.	T	A	3	2	5	0	0	5	0	0
4	73338060	.	C	A	3	5	8	1	3	12	0	0
4	73338062	.	T	C	5	5	10	1	1	12	0	0
4	73338166	.	G	A	1	4	5	1	0	6	0	0
4	73342807	.	A	G	1	4	5	0	0	5	0	0
4	73347263	.	G	C	1	3	4	0	0	4	0	0
4	73383853	.	C	T	7	2	9	0	0	9	0	0
4	73393951	.	T	C	3	3	6	0	0	6	0	0
4	73399255	.	T	G	4	3	7	1	0	8	0	0
4	73399278	.	A	G	3	3	6	1	0	7	0	0
4	73418647	.	G	A	1	2	3	0	0	3	0	0
4	73418744	.	A	T	2	3	5	0	0	5	0	0
4	73418823	.	T	C	4	5	9	0	0	9	0	0
4	73418974	.	T	C	3	0	3	0	3	6	0	0
4	73419010	.	G	A	2	5	7	0	0	7	0	0
4	73419026	.	C	T	3	6	9	0	0	9	0	0
4	73419160	.	C	T	3	6	9	1	0	10	0	0
4	73419209	.	G	T	1	7	8	0	0	8	0	0
4	73419217	.	G	A	2	8	10	0	0	10	0	0
4	73419550	.	G	A	5	6	11	0	0	11	0	0
4	73419754	.	A	C	3	4	7	0	0	7	0	0
4	73419799	.	G	A	2	6	8	0	0	8	0	0
4	73420143	.	T	C	1	2	3	0	0	3	0	0
4	73447030	.	T	C	1	2	3	0	0	3	0	0
4	73447096	.	C	T	1	6	7	0	1	8	0	0
4	73471021	.	G	A	2	2	4	2	0	6	0	0
4	73471048	.	A	G	2	2	4	2	0	6	0	0
4	73472873	.	A	T	1	2	3	0	0	3	0	0
4	73473128	.	T	C	1	2	3	0	0	3	0	0
4	73473154	.	T	C	1	2	3	0	0	3	0	0
4	73499736	.	T	A	4	2	6	0	0	6	0	0
4	73499862	.	A	G	2	2	4	0	0	4	0	0
4	73501310	.	T	C	3	3	6	0	0	6	0	0
4	73501311	.	G	A	3	3	6	0	0	6	0	0
4	73501606	.	A	T	1	2	3	1	0	4	0	0
4	73501858	.	C	T	2	3	5	0	0	5	0	0
4	73501963	.	G	A	3	3	6	0	0	6	0	0
4	73502274	.	A	C	1	3	4	0	0	4	0	0
4	73502446	.	C	A	1	2	3	0	1	4	0	0
4	73519301	.	T	A	3	5	8	0	1	9	0	0
4	73519433	.	A	G	4	4	8	0	0	8	0	0
4	73520344	.	A	G	4	3	7	0	0	7	0	0
4	73520362	.	C	T	2	2	4	0	1	5	0	0
4	73520443	.	C	T	1	3	4	0	0	4	0	0
4	73542536	.	G	A	2	4	6	0	0	6	0	0
4	73542582	.	A	G	4	3	7	0	0	7	0	0
4	73542633	.	G	A	6	2	8	0	0	8	0	0
4	73542707	.	T	G	1	2	3	0	1	4	0	0
4	73542757	.	C	A	2	4	6	0	0	6	0	0
4	73542775	.	C	T	0	2	2	0	2	4	0	0
4	73542830	.	C	T	1	2	3	0	0	3	0	0
4	73542845	.	G	A	1	1	2	0	1	3	0	0
4	73550570	.	A	T	2	2	4	0	0	4	0	0
4	73551208	.	G	C	1	0	1	0	3	4	0	0
4	73563458	.	T	G	2	2	4	0	0	4	0	0
4	73563467	.	A	T	2	2	4	0	0	4	0	0
4	73563494	.	C	T	2	2	4	0	0	4	0	0
4	73565026	.	A	G	1	2	3	0	1	4	0	0
4	73573799	.	T	A	3	4	7	0	0	7	0	0
4	73573870	.	T	G	6	5	11	0	1	12	0	0
4	73573887	.	A	C	8	2	10	0	3	13	0	0
4	73574235	.	A	G	3	4	7	0	0	7	0	0
4	73574374	.	G	A	5	7	12	0	0	12	0	0
4	73574386	.	T	A	8	7	15	0	0	15	0	0
4	73574579	.	A	G	4	2	6	0	0	6	0	0
4	73574583	.	C	G	3	2	5	0	0	5	0	0
4	73575094	.	T	C	2	2	4	0	0	4	0	0
4	73575171	.	A	G	3	4	7	0	0	7	0	0
4	73575192	.	T	A	4	3	7	0	0	7	0	0
4	73575576	.	G	T	5	6	11	0	0	11	0	0
4	73575807	.	A	T	1	2	3	0	0	3	0	0
4	73575958	.	C	T	1	2	3	0	0	3	0	0
4	73575967	.	C	T	3	2	5	0	0	5	0	0
4	73638857	.	G	A	1	5	6	0	0	6	0	0
4	73657799	.	T	G	1	2	3	0	0	3	0	0
4	73690525	.	A	T	2	2	4	0	0	4	0	0
4	73690547	.	A	G	3	0	3	0	2	5	0	0
4	73690572	.	G	T	2	2	4	0	0	4	0	0
4	73701997	.	G	A	1	3	4	0	0	4	0	0
4	73702353	.	C	T	1	3	4	0	0	4	0	0
4	73702393	.	G	A	1	2	3	0	0	3	0	0
4	73702473	.	G	A	1	2	3	0	0	3	0	0
4	73702490	.	T	G	1	2	3	0	0	3	0	0
4	73711740	.	G	C	1	2	3	1	0	4	0	0
4	73711828	.	T	G	1	2	3	2	0	5	0	0
4	73713173	.	C	T	1	4	5	0	0	5	0	0
4	73713587	.	A	T	2	2	4	0	0	4	0	0
4	73713602	.	A	G	1	3	4	0	0	4	0	0
4	73713850	.	G	T	3	6	9	0	1	10	0	0
4	73718242	.	G	T	1	2	3	0	0	3	0	0
4	73729780	.	C	A	4	2	6	0	0	6	0	0
4	73730341	.	G	A	3	3	6	0	0	6	0	0
4	73731331	.	T	C	2	2	4	0	0	4	0	0
4	73740301	.	G	A	7	3	10	0	0	10	0	0
4	73740391	.	C	G	3	3	6	0	0	6	0	0
4	73740409	.	C	A	3	2	5	0	0	5	0	0
4	73740487	.	C	G	2	5	7	0	0	7	0	0
4	73740517	.	A	G	3	2	5	0	0	5	0	0
4	73740651	.	G	C	3	2	5	0	1	6	0	0
4	73740691	.	T	A	3	2	5	0	0	5	0	0
4	73740879	.	A	C	5	2	7	0	0	7	0	0
4	73741749	.	G	T	2	2	4	2	0	6	0	0
4	73741764	.	G	A	0	4	4	2	0	6	0	0
4	73756578	.	A	T	3	2	5	0	0	5	0	0
4	73780856	.	C	T	1	2	3	0	0	3	0	0
4	73796397	.	G	A	2	3	5	0	0	5	0	0
4	73796424	.	C	T	3	3	6	0	0	6	0	0
4	73796484	.	A	G	3	4	7	0	0	7	0	0
4	73797199	.	A	T	1	2	3	0	0	3	0	0
4	73797208	.	C	G	1	2	3	0	0	3	0	0
4	73815178	.	C	T	2	3	5	0	1	6	0	0
4	73816163	.	T	C	1	0	1	0	4	5	0	0
4	73816175	.	T	C	1	0	1	0	2	3	0	0
4	73816589	.	T	C	0	2	2	0	1	3	0	0
4	73816590	.	T	C	0	0	0	0	3	3	0	0
4	73817044	.	C	T	1	3	4	0	0	4	0	0
4	73848994	.	T	A	1	2	3	0	0	3	0	0
4	73897683	.	G	A	6	4	10	0	0	10	0	0
4	73897713	.	T	C	4	3	7	0	0	7	0	0
4	73897725	.	C	T	4	3	7	0	0	7	0	0
4	73897923	.	T	C	2	6	8	0	0	8	0	0
4	73898168	.	G	T	3	1	4	0	1	5	0	0
4	73898170	.	C	T	3	2	5	0	0	5	0	0
4	73899078	.	T	A	2	5	7	0	0	7	0	0
4	73899370	.	G	A	3	3	6	0	0	6	0	0
4	73899511	.	A	G	3	0	3	0	3	6	0	0
4	73942096	.	A	G	1	0	1	0	2	3	0	0
4	73945901	.	C	T	2	3	5	0	0	5	0	0
4	73945925	.	T	A	3	2	5	0	0	5	0	0
4	73946198	.	A	G	1	3	4	0	0	4	0	0
4	73980836	.	C	A	3	3	6	0	0	6	0	0
4	73980884	.	G	A	4	2	6	0	0	6	0	0
4	73980890	.	A	C	6	2	8	0	0	8	0	0
4	73981397	.	C	T	4	2	6	0	0	6	0	0
4	73981513	.	A	G	2	2	4	0	0	4	0	0
4	74006572	.	C	T	1	3	4	0	1	5	0	0
4	74008326	.	C	G	2	0	2	0	2	4	0	0
4	74008362	.	A	G	2	4	6	0	0	6	0	0
4	74008378	.	T	A	2	7	9	0	0	9	0	0
4	74087781	.	G	A	14	12	26	0	0	26	0	0
4	74087785	.	G	C	13	13	26	0	1	27	0	0
4	74088060	.	T	G	19	19	38	0	1	39	0	0
4	74109763	.	A	T	9	11	20	0	2	22	0	0
4	74131583	.	T	G	8	0	8	0	13	21	0	0
4	74131652	.	T	C	14	8	22	0	0	22	0	0
4	74131717	.	G	A	1	12	13	0	11	24	0	0
4	74135244	.	G	T	10	9	19	0	0	19	0	0
4	74135295	.	A	G	12	9	21	0	0	21	0	0
4	74135415	.	C	T	12	13	25	0	0	25	0	0
4	74141580	.	C	A	6	6	12	0	0	12	0	0
4	74174078	.	C	T	4	4	8	0	0	8	0	0
4	74176550	.	G	A	4	3	7	0	0	7	0	0
4	74180716	.	G	A	1	4	5	0	15	20	0	0
4	74180788	.	T	C	10	6	16	0	1	17	0	0
4	74182382	.	G	C	16	5	21	0	1	22	0	0
4	74182389	.	G	T	17	4	21	0	1	22	0	0
4	74193480	.	C	G	9	6	15	0	0	15	0	0
4	74196686	.	T	C	8	3	11	0	1	12	0	0
4	74196704	.	T	C	8	4	12	0	1	13	0	0
4	74196764	.	G	T	11	6	17	0	0	17	0	0
4	74200391	.	C	T	11	9	20	0	1	21	0	0
4	74204177	.	T	C	7	7	14	0	0	14	0	0
4	74204236	.	G	T	0	10	10	0	10	20	0	0
4	74204387	.	G	T	3	7	10	0	0	10	0	0
4	74204494	.	A	T	1	5	6	0	2	8	0	0
4	74204643	.	A	G	2	6	8	0	1	9	0	0
4	74204687	.	A	G	6	4	10	0	0	10	0	0
4	74204842	.	A	G	3	5	8	0	0	8	0	0
4	74205295	.	T	C	3	3	6	0	0	6	0	0
4	74267225	.	A	G	6	8	14	0	2	16	0	0
4	74267348	.	C	T	7	8	15	0	0	15	0	0
4	74267519	.	A	G	22	8	30	0	0	30	0	0
4	74267540	.	G	A	0	15	15	0	10	25	0	0
4	74267582	.	T	G	9	10	19	0	1	20	0	0
4	74267639	.	T	A	14	7	21	0	0	21	0	0
4	74267733	.	A	T	11	17	28	0	0	28	0	0
4	74267748	.	C	T	19	10	29	0	2	31	0	0
4	74267865	.	A	C	9	9	18	0	1	19	0	0
4	74268175	.	A	G	10	9	19	0	0	19	0	0
4	74268182	.	C	T	9	10	19	0	1	20	0	0
4	74271251	.	G	A	3	5	8	0	0	8	0	0
4	74278079	.	T	G	8	6	14	0	0	14	0	0
4	74278093	.	C	T	0	5	5	0	5	10	0	0
4	74282709	.	C	T	6	3	9	0	1	10	0	0
4	74282917	.	G	A	6	8	14	0	2	16	0	0
4	74284790	.	A	C	4	11	15	0	1	16	0	0
4	74287776	.	T	A	7	7	14	2	1	17	0	0
4	74301564	.	C	T	1	2	3	0	1	4	0	0
4	74303174	.	T	C	2	0	2	0	3	5	0	0
4	74303216	.	G	A	1	2	3	0	0	3	0	0
4	74315331	.	C	T	1	1	2	0	1	3	0	0
4	74828261	.	C	A	2	3	5	0	2	7	0	0
4	74888566	.	C	T	2	2	4	0	1	5	0	0
4	74891617	.	A	T	2	3	5	0	0	5	0	0
4	74891619	.	C	G	1	3	4	0	1	5	0	0
4	74943202	.	A	T	13	14	27	0	1	29	1	0
4	74952477	.	G	A	13	17	30	0	1	31	0	0
4	74952525	.	A	G	13	1	14	0	17	31	0	0
4	74952660	.	G	T	1	17	18	0	14	32	0	0
4	74960826	.	C	T	15	18	33	0	1	34	0	0
4	74961011	.	C	T	13	11	24	1	5	30	0	0
4	74961075	.	G	A	10	19	29	0	0	29	0	0
4	74961520	.	T	A	2	6	8	0	0	8	0	0
4	76317041	.	T	C	4	3	7	0	0	7	0	0
4	76322771	.	T	C	2	5	7	0	0	7	0	0
4	76336468	.	T	A	3	6	9	0	0	9	0	0
4	76336471	.	A	C	5	2	7	0	1	8	0	0
4	76343850	.	A	G	2	3	5	1	1	7	0	0
4	76345660	.	A	G	4	2	6	1	0	7	0	0
4	76345923	.	A	G	5	0	5	1	4	10	0	0
4	76345974	.	A	G	4	7	11	2	0	13	0	0
4	76346004	.	T	C	4	3	7	2	1	10	0	0
4	76346011	.	T	C	4	2	6	2	1	9	0	0
4	76346188	.	T	A	3	3	6	0	1	7	0	0
4	76346238	.	C	A	2	6	8	2	2	12	0	0
4	76346564	.	C	T	3	5	8	0	2	10	0	0
4	76347126	.	T	C	2	2	4	0	0	4	0	0
4	76347163	.	A	G	5	3	8	0	0	8	0	0
4	76347508	.	T	G	4	2	6	0	0	6	0	0
4	76347977	.	A	T	5	2	7	0	0	7	0	0
4	76350043	.	A	G	1	2	3	0	0	3	0	0
4	76353485	.	C	G	2	2	4	0	1	5	0	0
4	76359850	.	G	A	0	3	3	0	3	6	0	0
4	76360500	.	T	A	1	3	4	0	0	4	0	0
4	76361212	.	C	A	2	3	5	0	0	5	0	0
4	76361229	.	T	C	2	3	5	0	0	5	0	0
4	76363060	.	A	C	2	4	6	1	2	9	0	0
4	76363195	.	C	T	1	3	4	0	5	9	0	0
4	76363204	.	A	C	5	4	9	0	0	9	0	0
4	76378159	.	C	A	1	2	3	0	0	3	0	0
4	76378186	.	G	A	2	3	5	0	1	6	0	0
4	76378209	.	T	C	3	0	3	0	2	5	0	0
4	76378365	.	A	G	1	2	3	0	0	3	0	0
4	76378374	.	T	C	0	2	2	0	0	2	0	0
4	76404224	.	A	G	1	2	3	0	0	3	0	0
4	76408988	.	G	A	2	4	6	0	0	6	0	0
4	76409461	.	A	G	1	0	1	0	2	3	0	0
4	76409494	.	A	C	1	5	6	0	0	6	0	0
4	76410071	.	C	T	1	3	4	0	0	4	0	0
4	76411308	.	C	G	6	2	8	0	1	9	0	0
4	76411346	.	T	C	2	3	5	0	1	6	0	0
4	76411558	.	C	T	2	5	7	0	0	7	0	0
4	76411559	.	A	C	5	2	7	0	0	7	0	0
4	76412570	.	G	A	5	2	7	0	0	7	0	0
4	76412751	.	A	T	1	5	6	1	0	7	0	0
4	76416857	.	G	T	2	2	4	0	0	4	0	0
4	76420751	.	T	C	3	2	5	0	0	5	0	0
4	76420800	.	A	G	1	3	4	0	0	4	0	0
4	76420809	.	A	G	1	3	4	0	0	4	0	0
4	76421602	.	A	C	2	2	4	0	0	4	0	0
4	76421958	.	C	T	1	3	4	0	0	4	0	0
4	76422084	.	A	G	1	3	4	0	0	4	0	0
4	76422231	.	G	A	0	4	4	0	4	8	0	0
4	76422357	.	T	C	2	4	6	0	0	6	0	0
4	76422500	.	T	C	2	3	5	0	0	5	0	0
4	76423234	.	G	A	4	4	8	0	0	8	0	0
4	76427137	.	G	C	1	3	4	0	0	4	0	0
4	76427145	.	A	G	1	4	5	0	0	5	0	0
4	76429102	.	A	G	2	4	6	0	1	7	0	0
4	76429202	.	A	C	1	4	5	1	0	6	0	0
4	76429234	.	A	C	7	2	9	0	0	9	0	0
4	76429237	.	G	C	5	2	7	0	1	8	0	0
4	76429270	.	C	T	7	3	10	0	0	10	0	0
4	76429545	.	C	A	1	3	4	0	0	4	0	0
4	76429584	.	A	G	1	4	5	0	0	5	0	0
4	76429719	.	G	T	1	4	5	0	0	5	0	0
4	76429878	.	G	T	1	2	3	0	0	3	0	0
4	76429944	.	G	C	6	2	8	0	0	8	0	0
4	76429969	.	G	A	3	8	11	0	0	11	0	0
4	76438019	.	A	T	2	4	6	0	0	6	0	0
4	76438073	.	A	G	2	4	6	0	0	6	0	0
4	76439450	.	C	T	2	3	5	0	0	5	0	0
4	76450189	.	T	A	4	0	4	0	0	4	0	0
4	76463780	.	G	C	2	4	6	0	0	6	0	0
4	76464859	.	G	C	2	2	4	0	0	4	0	0
4	76464961	.	G	A	5	3	8	0	0	8	0	0
4	76465087	.	C	T	3	7	10	0	0	10	0	0
4	76465329	.	T	C	6	6	12	0	0	12	0	0
4	76465346	.	C	T	6	3	9	0	0	9	0	0
4	76473500	.	T	C	1	2	3	0	2	5	0	0
4	76473527	.	A	G	1	3	4	0	0	4	0	0
4	76473553	.	G	C	2	2	4	0	0	4	0	0
4	76473613	.	C	A	1	3	4	0	1	5	0	0
4	76473716	.	G	A	1	2	3	0	0	3	0	0
4	76474078	.	G	A	2	4	6	0	0	6	0	0
4	76474339	.	G	C	4	4	8	0	0	8	0	0
4	76480943	.	C	A	0	3	3	0	1	4	0	0
4	76480996	.	C	T	0	3	3	2	1	6	0	0
4	76481177	.	T	C	7	0	7	0	2	9	0	0
4	76481216	.	G	C	6	0	6	1	6	13	0	0
4	76481403	.	T	A	3	11	14	0	3	17	0	0
4	76481572	.	G	A	7	5	12	0	1	13	0	0
4	76481665	.	A	T	6	2	8	0	0	8	0	0
4	76482075	.	G	T	1	2	3	0	1	4	0	0
4	76482207	.	A	G	8	3	11	0	0	11	0	0
4	76482249	.	C	T	4	5	9	0	0	9	0	0
4	76482487	.	G	T	2	3	5	0	0	5	0	0
4	76482673	.	T	C	4	5	9	0	1	10	0	0
4	76484343	.	G	A	7	2	9	0	0	9	0	0
4	76484424	.	T	C	3	4	7	0	0	7	0	0
4	76484531	.	T	C	5	3	8	0	0	8	0	0
4	76488299	.	C	A	0	5	5	0	2	7	0	0
4	76488514	.	T	A	4	9	13	0	0	13	0	0
4	76488617	.	G	A	6	4	10	0	0	10	0	0
4	76488624	.	A	G	6	4	10	0	0	10	0	0
4	76488742	.	G	C	3	3	6	0	0	6	0	0
4	76503193	.	T	C	1	3	4	0	0	4	0	0
4	76504227	.	T	A	1	3	4	0	0	4	0	0
4	76866993	.	A	G	15	6	21	0	0	21	0	0
4	76918845	.	G	C	1	3	4	0	0	4	0	0
4	76961053	.	G	T	4	4	8	4	2	14	0	0
4	77148401	.	A	G	1	3	4	0	0	4	0	0
4	77148402	.	A	G	1	3	4	0	0	4	0	0
4	77148561	.	A	G	2	0	2	0	3	5	0	0
4	77358274	.	C	T	1	2	3	0	0	3	0	0
4	77358323	.	G	A	1	2	3	0	0	3	0	0
4	77389832	.	G	C	4	6	10	0	0	10	0	0
4	77390628	.	A	T	6	6	12	0	1	13	0	0
4	77402711	.	G	A	1	5	6	0	0	6	0	0
5	32110	.	C	T	2	3	5	0	0	5	0	0
5	43375	.	G	T	1	3	4	0	0	4	0	0
5	97212	.	T	C	1	0	1	0	4	5	0	0
5	318077	.	G	A	11	13	24	0	1	25	0	0
5	318125	.	C	T	10	12	22	0	2	24	0	0
5	320383	.	T	C	8	1	9	0	6	15	0	0
5	894613	.	C	T	8	4	12	0	0	12	0	0
5	895581	.	T	C	16	6	22	0	0	22	0	0
5	896908	.	C	A	10	5	15	1	0	16	0	0
5	899952	.	C	T	9	12	21	0	0	21	0	0
5	905263	.	C	A	15	6	21	0	1	22	0	0
5	917336	.	C	T	16	12	28	0	2	30	0	0
5	1055103	.	C	T	22	18	40	0	0	40	0	0
5	1059697	.	T	C	22	20	42	0	0	42	0	0
5	1064013	.	A	G	19	24	43	0	1	44	0	0
5	1068116	.	T	A	23	14	37	0	1	38	0	0
5	1079480	.	C	T	16	8	24	0	2	26	0	0
5	1079558	.	G	T	13	7	20	0	0	20	0	0
5	1083073	.	A	G	5	0	5	0	5	10	0	0
5	1083203	.	G	C	6	4	10	0	0	10	0	0
5	1083237	.	T	A	2	3	5	0	0	5	0	0
5	1083242	.	T	C	2	3	5	0	0	5	0	0
5	1083679	.	G	A	0	4	4	3	4	11	0	0
5	1083894	.	T	G	9	0	9	0	5	14	0	0
5	1091487	.	G	T	2	2	4	0	3	7	0	0
5	1109177	.	G	A	1	2	3	0	0	3	0	0
5	1109244	.	C	T	2	2	4	0	0	4	0	0
5	1120788	.	C	T	1	2	3	0	0	3	0	0
5	1138161	.	C	T	1	2	3	0	0	3	0	0
5	1149757	.	C	G	1	2	3	0	0	3	0	0
5	1152013	.	G	C	2	3	5	0	0	5	0	0
5	1152132	.	C	A	3	3	6	0	0	6	0	0
5	1159612	.	G	A	0	5	5	0	2	7	0	0
5	1187950	.	G	A	8	5	13	0	3	16	0	0
5	1207835	.	C	T	4	4	8	1	0	9	0	0
5	1216494	.	A	G	7	6	13	0	0	13	0	0
5	1216536	.	C	T	0	8	8	0	8	16	0	0
5	1219263	.	C	T	21	12	33	0	0	33	0	0
5	1219381	.	G	A	22	12	34	0	1	35	0	0
5	1223368	.	A	T	11	7	18	0	1	19	0	0
5	1223369	.	C	T	12	8	20	0	0	20	0	0
5	1223460	.	G	A	16	9	25	0	0	25	0	0
5	1223487	.	G	T	12	6	18	0	2	20	0	0
5	1240403	.	C	A	0	2	2	0	7	9	0	0
5	1240517	.	T	C	1	4	5	1	1	7	0	0
5	1240534	.	G	A	2	2	4	1	1	6	0	0
5	1240589	.	C	T	0	5	5	0	1	6	0	0
5	1245017	.	T	C	1	2	3	0	0	3	0	0
5	1264403	.	G	A	2	2	4	0	1	5	0	0
5	1270554	.	T	C	1	0	1	0	3	4	0	0
5	1271483	.	C	G	2	6	8	0	0	8	0	0
5	1299350	.	C	G	13	0	13	0	11	24	0	0
5	1311041	.	G	A	15	23	38	0	1	39	0	0
5	1317871	.	T	C	13	16	29	0	4	33	0	0
5	1317883	.	G	A	18	18	36	0	1	37	0	0
5	1346838	.	T	C	17	28	45	0	1	46	0	0
5	1420729	.	A	G	21	6	27	0	0	27	0	0
5	1420741	.	A	G	20	6	26	0	0	26	0	0
5	1421052	.	T	A	4	8	12	0	0	12	0	0
5	1438628	.	G	A	12	10	22	0	1	23	0	0
5	1445964	.	G	A	8	7	15	0	0	15	0	0
5	1451568	.	G	A	5	6	11	0	0	11	0	0
5	1454760	.	A	G	11	8	19	0	0	20	1	0
5	1456393	.	G	A	5	5	10	0	1	11	0	0
5	1456411	.	T	C	2	7	9	0	0	9	0	0
5	1461953	.	C	T	9	3	12	0	3	15	0	0
5	1464617	.	G	T	8	8	16	0	0	16	0	0
5	1468472	.	T	C	4	0	4	2	7	13	0	0
5	1519571	.	G	C	9	16	25	0	1	27	1	0
5	1519574	.	T	A	9	11	20	0	6	26	0	0
5	2067180	.	T	C	4	2	6	0	0	6	0	0
5	2069080	.	G	A	4	5	9	1	0	10	0	0
5	2069082	.	C	G	5	2	7	1	0	8	0	0
5	2242447	.	A	G	0	2	2	0	0	2	0	0
5	2242456	.	A	T	2	2	4	0	1	5	0	0
5	2242599	.	G	A	5	3	8	0	0	8	0	0
5	2242602	.	G	T	5	2	7	0	1	8	0	0
5	2242708	.	A	G	4	3	7	0	0	7	0	0
5	2251629	.	C	T	1	6	7	0	0	7	0	0
5	2251669	.	A	G	1	8	9	0	0	9	0	0
5	2251670	.	T	A	0	7	7	0	2	9	0	0
5	2251704	.	T	C	3	0	3	0	5	8	0	0
5	2254721	.	G	T	6	5	11	0	0	11	0	0
5	2658348	.	G	A	9	8	17	0	1	18	0	0
5	2681146	.	G	T	2	5	7	0	1	8	0	0
5	2686225	.	G	C	3	8	11	0	0	11	0	0
5	2693660	.	G	A	1	5	6	0	0	6	0	0
5	2696450	.	A	C	1	3	4	0	1	5	0	0
5	2709533	.	A	G	2	2	4	0	0	4	0	0
5	2713967	.	A	G	24	17	41	0	1	42	0	0
5	2714042	.	C	T	27	24	51	1	1	53	0	0
5	2714135	.	C	T	23	20	43	0	4	47	0	0
5	2714237	.	G	A	31	16	47	0	4	51	0	0
5	2714495	.	G	A	29	23	52	0	1	53	0	0
5	2714507	.	A	G	26	26	52	0	1	53	0	0
5	2714531	.	T	C	21	1	22	0	26	48	0	0
5	2716930	.	G	A	20	6	26	2	1	29	0	0
5	2716963	.	G	A	19	6	25	0	0	25	0	0
5	2717014	.	G	A	10	17	27	0	0	27	0	0
5	2717022	.	G	A	10	16	26	0	0	26	0	0
5	2717260	.	T	C	16	11	27	0	0	27	0	0
5	2717350	.	G	C	5	1	6	0	17	23	0	0
5	2717611	.	C	T	10	12	22	0	0	22	0	0
5	2717623	.	A	G	8	13	21	0	0	21	0	0
5	2717960	.	A	G	11	9	20	0	1	21	0	0
5	2718696	.	A	G	5	10	15	0	1	16	0	0
5	2718834	.	G	A	10	10	20	0	2	22	0	0
5	2720119	.	A	G	8	14	22	0	0	22	0	0
5	2721588	.	C	T	19	9	28	0	2	30	0	0
5	2742784	.	A	G	16	5	21	0	0	21	0	0
5	2744938	.	C	T	2	7	9	0	0	9	0	0
5	2744962	.	C	G	6	8	14	0	0	14	0	0
5	2744998	.	C	T	4	8	12	0	1	13	0	0
5	2745220	.	G	T	13	8	21	0	1	22	0	0
5	2750087	.	G	A	9	7	16	0	0	16	0	0
5	2750127	.	G	A	11	14	25	0	0	25	0	0
5	2750244	.	G	A	7	11	18	0	0	18	0	0
5	2750256	.	G	A	11	6	17	0	2	19	0	0
5	2751319	.	G	A	9	8	17	0	1	18	0	0
5	2751511	.	G	A	9	10	19	0	1	20	0	0
5	2772390	.	T	C	2	0	2	0	3	5	0	0
5	3185164	.	C	G	0	2	2	0	2	4	0	0
5	3185195	.	A	T	4	2	6	0	1	7	0	0
5	3362996	.	G	A	0	4	4	0	0	4	0	0
5	3363014	.	C	T	1	3	4	0	0	4	0	0
5	3363050	.	C	T	1	5	6	0	0	6	0	0
5	3502001	.	A	G	21	14	35	0	5	40	0	0
5	3544098	.	C	T	30	28	58	0	4	62	0	0
5	3544380	.	C	T	28	28	56	0	5	61	0	0
5	3544955	.	T	C	25	23	48	0	1	49	0	0
5	3545011	.	T	A	26	15	41	0	4	45	0	0
5	3545205	.	A	T	29	0	29	0	1	30	0	0
5	3568313	.	C	T	3	2	5	2	0	7	0	0
5	3568494	.	C	T	11	20	31	0	0	31	0	0
5	3568518	.	G	T	6	16	22	0	2	24	0	0
5	3568530	.	C	T	16	9	25	0	0	25	0	0
5	3573946	.	A	C	5	9	14	0	1	15	0	0
5	3612011	.	A	T	2	3	5	0	0	5	0	0
5	3612025	.	C	A	2	4	6	0	0	6	0	0
5	3612075	.	A	T	8	4	12	0	1	13	0	0
5	3612185	.	A	T	6	3	9	0	0	9	0	0
5	3612254	.	A	G	3	6	9	0	0	9	0	0
5	3612415	.	G	T	2	4	6	0	0	6	0	0
5	3612442	.	G	T	6	2	8	0	1	9	0	0
5	3618064	.	G	A	6	9	15	0	1	16	0	0
5	3670231	.	G	A	5	4	9	0	1	10	0	0
5	3891603	.	C	T	4	4	8	0	0	8	0	0
5	3901564	.	A	C	4	7	11	0	0	11	0	0
5	3914638	.	T	G	10	16	26	0	1	27	0	0
5	3925732	.	A	C	21	2	23	0	15	38	0	0
5	3925769	.	T	C	8	25	33	0	4	37	0	0
5	3927524	.	G	A	18	15	33	0	0	33	0	0
5	3928017	.	T	C	2	2	4	0	0	4	0	0
5	3928112	.	T	C	3	3	6	0	0	6	0	0
5	3930283	.	G	C	3	4	7	0	0	7	0	0
5	4010507	.	G	C	2	4	6	0	0	6	0	0
5	4010515	.	G	A	2	3	5	0	1	6	0	0
5	4010639	.	G	C	1	3	4	0	0	4	0	0
5	4010937	.	G	T	2	2	4	0	0	4	0	0
5	4024746	.	A	G	6	0	6	0	5	11	0	0
5	4024797	.	G	T	5	7	12	0	0	12	0	0
5	4024857	.	G	A	0	3	3	0	9	12	0	0
5	4024863	.	T	C	3	7	10	0	0	10	0	0
5	4052191	.	G	A	3	7	10	0	0	10	0	0
5	4137043	.	A	G	2	5	7	0	0	7	0	0
5	4142284	.	T	G	4	2	6	0	0	6	0	0
5	4142487	.	G	A	4	4	8	0	1	9	0	0
5	4142581	.	T	A	2	5	7	0	1	8	0	0
5	4142582	.	T	G	2	5	7	0	1	8	0	0
5	4254061	.	C	T	1	8	9	0	9	18	0	0
5	4265417	.	T	C	8	11	19	0	0	19	0	0
5	4270791	.	C	A	2	10	12	0	7	19	0	0
5	4273144	.	T	C	12	6	18	0	0	18	0	0
5	4273159	.	T	C	13	7	20	0	0	20	0	0
5	4275481	.	C	T	1	13	14	0	12	26	0	0
5	4281626	.	A	G	12	7	19	0	2	21	0	0
5	4281634	.	A	G	13	9	22	0	1	23	0	0
5	4292545	.	A	T	5	2	7	0	0	7	0	0
5	4292578	.	A	G	9	5	14	0	0	14	0	0
5	4293975	.	T	C	13	10	23	0	1	24	0	0
5	4293978	.	C	A	14	10	24	0	1	25	0	0
5	4296556	.	C	G	16	12	28	0	0	28	0	0
5	4298902	.	G	C	16	14	30	0	0	30	0	0
5	4299588	.	A	G	12	0	12	0	12	24	0	0
5	4338885	.	A	T	1	2	3	0	0	3	0	0
5	4373684	.	C	T	11	8	19	0	1	20	0	0
5	4373701	.	G	T	0	8	8	0	7	15	0	0
5	4374245	.	A	G	1	3	4	0	0	4	0	0
5	4374247	.	A	T	1	3	4	0	0	4	0	0
5	4382543	.	A	G	9	5	14	0	1	15	0	0
5	4384706	.	G	A	5	6	11	0	0	11	0	0
5	4397741	.	A	G	5	7	12	0	0	12	0	0
5	4397901	.	T	C	5	7	12	0	0	12	0	0
5	4414178	.	C	T	10	5	15	0	1	16	0	0
5	4436449	.	G	C	0	2	2	0	5	7	0	0
5	4444829	.	G	A	7	6	13	0	0	13	0	0
5	4445039	.	T	C	6	5	11	0	1	12	0	0
5	4448249	.	G	A	2	3	5	0	4	9	0	0
5	4448306	.	T	C	3	6	9	0	0	9	0	0
5	4733927	.	C	T	0	2	2	0	6	8	0	0
5	4825336	.	A	G	1	2	3	0	0	3	0	0
5	4922266	.	G	A	1	2	3	0	0	3	0	0
5	4922491	.	G	A	1	2	3	0	0	3	0	0
5	5171358	.	T	A	2	2	4	0	0	4	0	0
5	5171750	.	G	A	6	2	8	0	0	8	0	0
5	5171770	.	G	A	5	4	9	0	1	10	0	0
5	5185955	.	G	C	9	11	20	0	0	20	0	0
5	5195882	.	A	G	6	3	9	0	0	9	0	0
5	5217028	.	G	A	5	4	9	0	0	9	0	0
5	5308502	.	A	G	10	3	13	0	0	13	0	0
5	5321191	.	C	T	2	2	4	0	0	4	0	0
5	5394327	.	A	C	1	2	3	0	0	3	0	0
5	5394341	.	A	C	2	0	2	0	2	4	0	0
5	5406529	.	T	C	1	3	4	0	0	4	0	0
5	5486039	.	T	C	6	2	8	0	0	8	0	0
5	5628973	.	G	A	2	2	4	0	0	4	0	0
5	5629053	.	A	G	2	3	5	0	1	6	0	0
5	5632422	.	C	T	0	2	2	0	2	4	0	0
5	5642756	.	C	A	0	2	2	0	4	6	0	0
5	5666936	.	C	T	3	4	7	0	0	7	0	0
5	5689542	.	C	T	1	2	3	0	0	3	0	0
5	5689889	.	A	G	2	4	6	0	1	7	0	0
5	5691879	.	A	G	1	2	3	0	0	3	0	0
5	5708595	.	C	G	5	4	9	0	1	10	0	0
5	5731919	.	C	T	3	4	7	0	0	7	0	0
5	5733101	.	T	C	3	5	8	0	0	8	0	0
5	5733130	.	C	T	3	3	6	0	0	6	0	0
5	5733227	.	C	G	2	5	7	0	0	7	0	0
5	5780248	.	A	T	1	2	3	0	1	4	0	0
5	5783092	.	T	A	2	3	5	0	1	6	0	0
5	5783122	.	G	C	4	4	8	0	0	8	0	0
5	5796908	.	A	T	1	4	5	0	0	5	0	0
5	5798255	.	G	A	3	2	5	0	0	5	0	0
5	5798621	.	C	T	2	2	4	0	0	4	0	0
5	5803625	.	A	T	1	2	3	0	0	3	0	0
5	6489400	.	A	T	2	2	4	0	0	4	0	0
5	6617454	.	T	C	4	7	11	0	0	11	0	0
5	6672965	.	G	T	3	3	6	0	0	6	0	0
5	6717505	.	C	T	2	2	4	0	0	4	0	0
5	6717757	.	C	A	1	5	6	0	0	6	0	0
5	6717804	.	T	C	1	2	3	0	1	4	0	0
5	6717809	.	G	A	1	2	3	0	1	4	0	0
5	6726416	.	T	C	5	3	8	0	0	8	0	0
5	6727099	.	C	A	3	2	5	0	0	5	0	0
5	6735293	.	A	G	3	2	5	0	0	5	0	0
5	6796383	.	G	A	2	3	5	0	3	8	0	0
5	6807812	.	G	A	0	4	4	0	8	12	0	0
5	6827651	.	G	A	4	6	10	0	1	11	0	0
5	6827669	.	G	C	9	5	14	0	0	14	0	0
5	6828589	.	A	T	6	3	9	0	0	9	0	0
5	6828721	.	G	A	11	6	17	0	0	17	0	0
5	6832646	.	C	T	2	7	9	0	1	10	0	0
5	6839136	.	A	C	6	6	12	0	0	12	0	0
5	6844179	.	C	T	4	5	9	0	0	9	0	0
5	6858380	.	C	A	6	11	17	0	0	17	0	0
5	6858389	.	T	A	7	10	17	0	1	18	0	0
5	6858540	.	T	A	13	6	19	0	0	19	0	0
5	6858779	.	G	T	1	11	12	0	5	17	0	0
5	6863577	.	C	T	14	5	19	0	0	19	0	0
5	6863647	.	C	T	12	7	19	0	1	20	0	0
5	6863768	.	G	C	9	10	19	0	0	19	0	0
5	6863793	.	G	A	3	18	21	0	1	22	0	0
5	6863855	.	G	A	5	7	12	0	2	14	0	0
5	6864010	.	C	T	3	4	7	0	0	7	0	0
5	6864061	.	A	G	4	2	6	0	0	6	0	0
5	6864067	.	G	A	0	3	3	0	1	4	0	0
5	6881679	.	C	T	6	4	10	0	0	10	0	0
5	6892251	.	G	A	0	2	2	0	1	3	0	0
5	6892290	.	C	T	4	2	6	0	1	7	0	0
5	6921397	.	T	C	1	3	4	0	0	4	0	0
5	6956547	.	C	G	3	4	7	0	0	7	0	0
5	6958910	.	T	C	8	4	12	0	0	12	0	0
5	6958965	.	G	C	2	3	5	0	0	5	0	0
5	6959148	.	C	A	6	5	11	0	0	11	0	0
5	6959834	.	T	A	2	5	7	0	0	7	0	0
5	6959839	.	C	T	3	4	7	0	0	7	0	0
5	7443939	.	G	A	1	1	2	0	1	3	0	0
5	7455629	.	G	A	0	3	3	0	1	4	0	0
5	7498844	.	C	A	3	2	5	0	0	5	0	0
5	7499034	.	G	A	2	2	4	0	2	6	0	0
5	7504448	.	C	T	3	2	5	0	0	5	0	0
5	7642690	.	G	C	2	2	4	0	0	4	0	0
5	8006206	.	A	G	3	6	9	0	0	9	0	0
5	8006474	.	A	G	8	3	11	0	6	17	0	0
5	8006503	.	A	G	12	7	19	0	0	19	0	0
5	8006977	.	A	G	13	16	29	0	2	31	0	0
5	8015099	.	C	T	0	7	7	0	5	12	0	0
5	8015165	.	G	A	7	4	11	0	1	12	0	0
5	8015192	.	C	T	1	4	5	0	8	13	0	0
5	8015252	.	C	T	3	7	10	0	0	10	0	0
5	8015361	.	G	T	7	7	14	1	0	15	0	0
5	8019962	.	A	G	10	9	19	0	0	19	0	0
5	8020001	.	C	T	7	9	16	0	0	16	0	0
5	8033036	.	A	G	10	8	18	0	0	18	0	0
5	8038472	.	C	T	6	2	8	0	0	8	0	0
5	8041956	.	A	T	1	2	3	0	0	3	0	0
5	8042113	.	G	A	1	5	6	0	1	7	0	0
5	8043891	.	C	T	6	4	10	0	0	10	0	0
5	8537820	.	T	C	3	5	8	0	0	8	0	0
5	9677857	.	G	A	3	3	6	0	0	6	0	0
5	10002132	.	T	G	1	2	3	0	0	3	0	0
5	10002156	.	G	T	1	2	3	0	0	3	0	0
5	10051017	.	G	A	0	2	2	0	1	3	0	0
5	10053867	.	C	T	4	2	6	0	0	6	0	0
5	10056181	.	T	G	1	0	1	0	2	3	0	0
5	10084310	.	C	T	3	3	6	0	0	6	0	0
5	10766286	.	G	A	6	2	8	0	0	8	0	0
5	10766505	.	A	G	11	15	26	1	2	29	0	0
5	10766529	.	G	A	16	11	27	3	3	33	0	0
5	10766879	.	A	G	16	14	30	0	0	30	0	0
5	10767113	.	C	T	10	6	16	0	3	19	0	0
5	10767259	.	A	G	18	18	36	0	1	37	0	0
5	10767588	.	C	T	5	3	8	0	1	9	0	0
5	10768089	.	G	A	9	13	22	0	0	22	0	0
5	10768182	.	G	A	10	5	15	0	2	17	0	0
5	10768215	.	T	C	10	0	10	0	6	16	0	0
5	10946038	.	G	A	7	8	15	0	1	16	0	0
5	10946085	.	G	T	8	9	17	0	0	17	0	0
5	11244625	.	T	C	5	4	9	0	0	9	0	0
5	11244675	.	A	G	6	2	8	0	0	8	0	0
5	11270877	.	A	G	1	3	4	0	0	4	0	0
5	11504372	.	A	G	9	14	23	0	1	24	0	0
5	11507602	.	A	G	4	13	17	0	0	17	0	0
5	11573461	.	C	T	9	4	13	0	0	13	0	0
5	11812278	.	C	T	9	6	15	0	0	15	0	0
5	11816439	.	C	T	1	1	2	0	1	3	0	0
5	11816599	.	G	A	5	9	14	0	0	14	0	0
5	11824059	.	G	A	0	8	8	0	4	12	0	0
5	11824188	.	T	C	6	3	9	0	1	10	0	0
5	11826347	.	T	C	7	11	18	0	1	19	0	0
5	11836437	.	T	C	19	10	29	0	1	30	0	0
5	11864593	.	A	G	4	3	7	0	0	7	0	0
5	11864774	.	T	G	8	10	18	0	1	19	0	0
5	11869576	.	C	A	1	4	5	0	6	11	0	0
5	11900230	.	T	C	10	0	10	0	8	18	0	0
5	11905038	.	G	A	3	3	6	0	0	6	0	0
5	11905044	.	A	C	3	3	6	0	0	6	0	0
5	11905086	.	A	T	4	4	8	0	0	8	0	0
5	11905661	.	T	C	2	0	2	0	5	7	0	0
5	11905725	.	C	T	4	4	8	0	0	8	0	0
5	11905890	.	A	G	7	10	17	0	0	18	1	0
5	11905903	.	T	G	6	7	13	0	0	13	0	0
5	11917125	.	C	T	5	2	7	0	0	7	0	0
5	11917405	.	G	A	10	4	14	0	0	14	0	0
5	11917436	.	G	A	3	9	12	0	0	12	0	0
5	11917485	.	G	A	11	6	17	0	0	17	0	0
5	11917596	.	C	A	0	10	10	0	11	21	0	0
5	11933155	.	A	G	6	9	15	1	0	16	0	0
5	11935444	.	G	A	11	4	15	0	0	15	0	0
5	11937486	.	G	A	6	6	12	0	0	12	0	0
5	11937564	.	A	T	4	3	7	0	2	9	0	0
5	11941903	.	T	C	8	0	8	0	6	14	0	0
5	11943662	.	A	C	3	13	16	0	0	16	0	0
5	11943868	.	G	A	13	6	19	0	0	19	0	0
5	11943934	.	C	A	7	10	17	0	1	18	0	0
5	11943948	.	T	A	7	11	18	0	0	18	0	0
5	11943989	.	G	A	6	6	12	0	0	12	0	0
5	11944060	.	T	G	6	6	12	0	1	13	0	0
5	11949244	.	G	T	9	9	18	0	0	18	0	0
5	11959776	.	G	T	1	19	20	0	11	31	0	0
5	11959777	.	C	T	18	11	29	0	2	31	0	0
5	11959818	.	C	T	14	20	34	0	0	34	0	0
5	11959966	.	C	G	18	9	27	0	2	30	1	0
5	11959988	.	G	A	1	13	14	0	12	26	0	0
5	11983395	.	T	A	6	8	14	1	1	16	0	0
5	11983548	.	C	G	4	9	13	0	0	13	0	0
5	11984086	.	T	C	4	3	7	0	0	7	0	0
5	11984133	.	C	T	3	4	7	0	0	7	0	0
5	11984141	.	T	A	2	5	7	0	0	7	0	0
5	11984808	.	C	T	4	4	8	0	0	8	0	0
5	11984850	.	A	T	2	5	7	0	0	7	0	0
5	11985133	.	A	T	1	5	6	3	0	9	0	0
5	11985672	.	A	T	3	2	5	0	0	5	0	0
5	11986476	.	C	A	1	2	3	0	0	3	0	0
5	11997476	.	A	G	2	2	4	0	0	4	0	0
5	12011302	.	C	T	1	3	4	0	3	7	0	0
5	12100335	.	G	A	4	6	10	0	0	10	0	0
5	12144035	.	T	C	2	4	6	0	0	6	0	0
5	12146026	.	A	G	3	2	5	0	1	6	0	0
5	12170258	.	G	A	1	5	6	0	0	6	0	0
5	12284075	.	C	T	15	13	28	0	1	29	0	0
5	12285172	.	T	C	16	0	16	0	11	27	0	0
5	12285381	.	C	A	5	2	7	1	0	8	0	0
5	12285601	.	C	G	5	5	10	0	0	10	0	0
5	12288511	.	T	C	7	8	15	0	4	19	0	0
5	12288541	.	A	G	8	11	19	0	1	20	0	0
5	12297084	.	C	T	9	12	21	0	1	22	0	0
5	12322321	.	G	A	9	7	16	0	0	16	0	0
5	12357538	.	G	A	11	10	21	0	0	21	0	0
5	12357554	.	C	T	9	7	16	0	0	16	0	0
5	12454563	.	T	C	10	0	10	0	10	20	0	0
5	12503554	.	G	A	3	7	10	0	0	10	0	0
5	12524938	.	A	G	14	6	20	1	0	21	0	0
5	12530423	.	G	T	7	5	12	0	0	12	0	0
5	12530425	.	C	A	7	5	12	0	0	12	0	0
5	12533197	.	C	T	5	6	11	0	0	11	0	0
5	12535785	.	A	T	7	7	14	0	0	14	0	0
5	12549258	.	C	T	10	11	21	0	0	21	0	0
5	12549326	.	C	T	9	4	13	0	1	14	0	0
5	12549561	.	T	C	9	4	13	0	1	14	0	0
5	12549642	.	C	A	2	2	4	0	0	4	0	0
5	12549776	.	G	T	3	5	8	0	0	8	0	0
5	12549807	.	A	G	4	4	8	0	0	8	0	0
5	12549981	.	G	T	3	6	9	0	0	9	0	0
5	12553935	.	C	T	0	3	3	0	10	13	0	0
5	12554073	.	G	A	1	5	6	0	0	6	0	0
5	12554119	.	A	G	2	6	8	0	0	8	0	0
5	12558090	.	C	T	4	5	9	0	0	9	0	0
5	12618524	.	G	A	1	2	3	0	2	5	0	0
5	12648074	.	G	A	4	3	7	0	0	7	0	0
5	12664330	.	T	C	1	2	3	0	0	3	0	0
5	12701122	.	A	G	3	4	7	0	0	7	0	0
5	12701139	.	C	T	3	3	6	0	0	6	0	0
5	12701226	.	C	T	1	2	3	0	0	3	0	0
5	12724121	.	C	T	10	9	19	0	1	20	0	0
5	12724224	.	G	A	16	7	23	0	1	24	0	0
5	12724249	.	A	C	4	7	11	0	0	11	0	0
5	12724292	.	C	A	7	2	9	0	2	11	0	0
5	12724307	.	A	G	6	8	14	0	0	14	0	0
5	12724412	.	A	G	4	3	7	0	0	7	0	0
5	12724450	.	C	T	0	7	7	0	5	12	0	0
5	12724505	.	C	A	12	18	30	0	1	31	0	0
5	12724518	.	G	C	9	0	9	0	19	28	0	0
5	12724567	.	A	G	11	11	22	0	4	26	0	0
5	12724694	.	C	T	2	9	11	0	11	22	0	0
5	12725930	.	G	A	18	33	51	0	1	52	0	0
5	12726842	.	A	G	28	12	40	0	2	42	0	0
5	12729397	.	C	T	9	10	19	0	1	20	0	0
5	12732247	.	C	T	10	5	15	0	0	15	0	0
5	12734883	.	G	T	9	15	24	0	2	26	0	0
5	12734910	.	T	C	8	17	25	0	1	26	0	0
5	12743011	.	C	A	4	6	10	0	0	10	0	0
5	12743088	.	T	A	2	2	4	0	0	4	0	0
5	12743159	.	A	T	4	3	7	0	1	8	0	0
5	12837064	.	G	A	8	4	12	0	0	12	0	0
5	12859258	.	T	C	18	11	29	0	1	30	0	0
5	12903862	.	G	C	2	2	4	0	0	4	0	0
5	12905911	.	A	C	4	2	6	0	0	6	0	0
5	12906014	.	C	T	2	2	4	0	0	4	0	0
5	12906273	.	C	T	1	4	5	0	0	6	1	0
5	12908828	.	C	A	2	9	11	0	0	11	0	0
5	12926507	.	C	A	5	7	12	0	0	12	0	0
5	12935223	.	A	G	3	4	7	0	0	7	0	0
5	12956918	.	T	C	6	5	11	0	0	11	0	0
5	12956960	.	C	T	3	5	8	0	1	9	0	0
5	12975297	.	G	A	1	8	9	0	9	18	0	0
5	12975532	.	C	T	11	5	16	0	1	17	0	0
5	13037199	.	C	T	2	10	12	0	6	18	0	0
5	13037203	.	C	T	2	6	8	0	10	18	0	0
5	13037939	.	T	G	13	8	21	0	4	25	0	0
5	13037967	.	G	A	16	11	27	0	1	28	0	0
5	13037998	.	A	G	18	10	28	0	0	28	0	0
5	13105020	.	C	T	26	17	43	1	2	46	0	0
5	13105070	.	C	A	5	21	26	0	26	52	0	0
5	13112979	.	G	A	16	21	37	0	2	39	0	0
5	13167048	.	A	T	17	9	26	0	1	27	0	0
5	13181401	.	G	A	1	3	4	0	0	4	0	0
5	13181425	.	C	T	0	3	3	0	2	5	0	0
5	13193475	.	T	A	1	2	3	0	0	3	0	0
5	13214637	.	C	G	4	8	12	0	0	12	0	0
5	13214802	.	C	G	6	4	10	0	0	10	0	0
5	13223062	.	G	A	3	2	5	0	1	6	0	0
5	13229846	.	G	T	3	5	8	0	0	8	0	0
5	13235157	.	G	C	1	4	5	0	0	5	0	0
5	13237809	.	G	A	1	3	4	0	0	4	0	0
5	13239172	.	A	G	5	4	9	0	0	9	0	0
5	13239412	.	A	G	2	5	7	0	0	7	0	0
5	13251737	.	C	A	0	2	2	0	6	8	0	0
5	13308778	.	A	C	1	4	5	0	0	5	0	0
5	13308959	.	G	A	5	5	10	0	0	10	0	0
5	13308985	.	T	C	5	6	11	0	0	11	0	0
5	13308997	.	G	T	3	6	9	0	0	9	0	0
5	13309174	.	T	C	16	0	16	0	10	26	0	0
5	13309215	.	C	T	9	10	19	0	1	20	0	0
5	13309273	.	C	T	10	16	26	0	1	27	0	0
5	13309309	.	G	A	10	16	26	0	2	28	0	0
5	13309402	.	A	G	14	12	26	0	1	27	0	0
5	13309435	.	A	T	11	17	28	0	0	28	0	0
5	13309522	.	G	A	12	15	27	1	0	28	0	0
5	13312671	.	A	T	16	13	29	0	3	32	0	0
5	13312746	.	G	A	15	15	30	0	1	31	0	0
5	13315490	.	G	C	11	21	32	0	0	32	0	0
5	13315526	.	T	C	9	15	24	0	0	24	0	0
5	13315603	.	A	C	11	11	22	0	0	22	0	0
5	13326920	.	G	A	2	3	5	0	0	5	0	0
5	13329785	.	G	C	2	4	6	0	0	6	0	0
5	13332930	.	A	G	5	3	8	0	0	8	0	0
5	13335291	.	C	T	3	3	6	0	0	6	0	0
5	13335333	.	G	A	7	6	13	0	0	13	0	0
5	13335373	.	G	T	2	5	7	0	4	11	0	0
5	13335423	.	C	T	4	6	10	0	0	10	0	0
5	13337803	.	C	T	9	10	19	0	0	19	0	0
5	13337883	.	T	A	14	12	26	0	3	29	0	0
5	13338441	.	C	T	2	15	17	0	17	34	0	0
5	13338762	.	A	T	12	8	20	0	1	22	1	0
5	13339038	.	G	C	19	15	34	2	11	47	0	0
5	13385888	.	A	G	4	0	4	0	6	10	0	0
5	13385916	.	T	A	6	6	12	0	0	12	0	0
5	13394714	.	A	G	3	4	7	0	0	7	0	0
5	13410745	.	G	A	1	2	3	0	2	5	0	0
5	13415128	.	A	T	1	4	5	0	0	5	0	0
5	13415131	.	A	G	1	0	1	0	4	5	0	0
5	13419418	.	T	C	1	4	5	0	0	5	0	0
5	13443925	.	C	T	3	2	5	0	0	5	0	0
5	13445433	.	C	T	2	3	5	0	1	6	0	0
5	13445511	.	A	G	2	6	8	0	0	8	0	0
5	13465095	.	T	C	2	4	6	0	0	6	0	0
5	13468172	.	C	T	3	4	7	0	1	8	0	0
5	13468440	.	T	A	4	5	9	0	0	9	0	0
5	13468574	.	G	A	6	2	8	0	0	8	0	0
5	13468655	.	G	A	3	6	9	0	0	9	0	0
5	13468656	.	A	T	3	6	9	0	0	9	0	0
5	13469105	.	T	A	1	2	3	0	0	3	0	0
5	13472279	.	C	T	3	9	12	0	0	13	1	0
5	13472295	.	G	T	11	4	15	0	0	15	0	0
5	13472743	.	A	T	5	3	8	0	0	8	0	0
5	13472887	.	G	A	2	1	3	0	1	4	0	0
5	13473094	.	T	G	1	2	3	0	0	3	0	0
5	13473334	.	G	A	0	7	7	0	6	13	0	0
5	13501228	.	T	C	1	2	3	0	0	3	0	0
5	13539403	.	A	G	2	0	2	0	8	10	0	0
5	13539493	.	A	G	4	0	4	0	3	7	0	0
5	13540689	.	C	T	10	5	15	0	0	15	0	0
5	13540846	.	T	A	4	6	10	0	1	11	0	0
5	13553343	.	A	G	1	0	1	0	2	3	0	0
5	13554109	.	T	C	0	2	2	0	1	3	0	0
5	13554146	.	A	G	2	3	5	0	0	5	0	0
5	13557614	.	T	C	3	2	5	0	0	5	0	0
5	13643325	.	G	A	15	16	31	0	0	31	0	0
5	13643411	.	C	T	3	25	28	0	17	45	0	0
5	13643824	.	G	A	14	13	27	0	1	28	0	0
5	13644126	.	A	T	20	26	46	0	0	46	0	0
5	13644185	.	T	G	16	16	32	0	0	33	1	0
5	13644189	.	T	G	18	14	32	0	1	33	0	0
5	13644227	.	A	G	13	14	27	2	0	29	0	0
5	13644256	.	A	T	16	9	25	7	1	33	0	0
5	13644581	.	T	G	19	19	38	0	6	44	0	0
5	13644602	.	T	A	23	23	46	0	0	48	2	0
5	13644781	.	C	T	14	6	20	0	1	21	0	0
5	13644797	.	A	G	5	14	19	0	0	19	0	0
5	13645047	.	C	G	15	9	24	0	3	27	0	0
5	13645746	.	A	G	22	17	39	0	1	40	0	0
5	13645885	.	T	C	9	13	22	0	0	22	0	0
5	13649518	.	C	T	20	14	34	0	1	35	0	0
5	13652410	.	T	C	12	21	33	0	1	34	0	0
5	13671624	.	G	T	12	7	19	0	0	19	0	0
5	13671631	.	A	C	7	10	17	0	1	18	0	0
5	13671899	.	C	G	19	13	32	0	1	33	0	0
5	13672004	.	C	T	3	21	24	0	16	40	0	0
5	13672211	.	C	T	17	22	39	0	1	40	0	0
5	13672232	.	C	T	22	15	37	0	2	39	0	0
5	13673016	.	C	G	2	17	19	4	13	36	0	0
5	13684132	.	A	G	19	16	35	0	0	35	0	0
5	13684502	.	C	A	9	13	22	0	23	45	0	0
5	13684983	.	G	T	4	3	7	0	0	7	0	0
5	13766188	.	A	T	9	9	18	0	1	19	0	0
5	13766276	.	A	G	6	9	15	0	0	15	0	0
5	13767883	.	A	T	4	2	6	0	0	6	0	0
5	13772666	.	T	C	20	21	41	1	2	44	0	0
5	13778659	.	G	T	29	20	49	0	2	51	0	0
5	13778663	.	C	T	31	19	50	0	1	51	0	0
5	13782325	.	T	C	27	14	41	1	1	43	0	0
5	13782786	.	C	A	9	7	16	0	0	16	0	0
5	13783350	.	C	A	4	10	14	0	0	14	0	0
5	13783377	.	A	G	5	11	16	0	0	16	0	0
5	13783391	.	G	A	11	5	16	0	0	16	0	0
5	13783516	.	A	C	9	15	24	0	2	26	0	0
5	13784111	.	G	T	5	4	9	0	0	9	0	0
5	13784243	.	T	A	15	9	24	0	0	24	0	0
5	13784486	.	G	T	12	12	24	0	1	25	0	0
5	13784559	.	T	A	4	13	17	4	2	23	0	0
5	13784629	.	A	G	0	0	0	1	3	9	5	0
5	13784914	.	G	T	8	5	13	0	0	13	0	0
5	13784916	.	C	T	8	4	12	0	1	13	0	0
5	13785289	.	T	C	8	0	8	0	8	16	0	0
5	13785304	.	A	G	6	8	14	0	1	15	0	0
5	13785326	.	A	G	5	11	16	0	0	16	0	0
5	13785441	.	A	G	14	4	18	0	1	19	0	0
5	13785485	.	T	C	12	0	12	1	7	20	0	0
5	13785490	.	G	A	10	8	18	1	0	19	0	0
5	13785522	.	T	C	8	10	18	0	0	18	0	0
5	13785677	.	T	C	11	0	11	0	7	18	0	0
5	13785735	.	C	T	14	8	22	0	0	22	0	0
5	13791984	.	G	A	18	10	28	0	1	29	0	0
5	13793333	.	T	C	15	10	25	0	2	27	0	0
5	13799613	.	G	A	12	11	23	0	0	23	0	0
5	13799635	.	C	T	13	10	23	0	0	23	0	0
5	13799704	.	G	A	11	8	19	0	0	19	0	0
5	13800062	.	C	T	9	6	15	0	0	15	0	0
5	13800170	.	C	A	8	6	14	1	2	17	0	0
5	13803918	.	C	A	2	7	9	0	9	18	0	0
5	13803960	.	C	T	9	7	16	0	0	16	0	0
5	13820304	.	C	T	10	6	16	0	1	17	0	0
5	13820457	.	G	A	8	12	20	0	0	20	0	0
5	13835462	.	T	G	3	3	6	0	0	6	0	0
5	14003976	.	T	C	1	5	6	0	0	6	0	0
5	14004030	.	A	T	1	3	4	0	0	4	0	0
5	14306793	.	G	T	18	17	35	0	1	36	0	0
5	14307459	.	G	A	13	11	24	0	1	25	0	0
5	14307720	.	C	T	10	15	25	0	0	25	0	0
5	14308394	.	A	C	17	0	17	0	0	17	0	0
5	14308710	.	A	G	14	15	29	0	2	31	0	0
5	14308773	.	G	A	10	11	21	0	1	22	0	0
5	14308792	.	C	A	11	11	22	0	2	24	0	0
5	14309073	.	T	C	7	5	12	0	1	13	0	0
5	14309334	.	C	T	1	8	9	0	11	20	0	0
5	14309661	.	C	T	4	4	8	0	0	8	0	0
5	14310874	.	T	A	18	19	37	0	4	41	0	0
5	14312030	.	C	T	2	13	15	0	12	27	0	0
5	14312091	.	G	A	12	5	17	0	2	19	0	0
5	14321243	.	G	A	5	4	9	0	0	9	0	0
5	14321336	.	G	A	12	7	19	0	0	19	0	0
5	14321393	.	C	T	8	10	18	0	0	18	0	0
5	14321438	.	A	G	6	8	14	0	1	15	0	0
5	14321488	.	G	A	5	10	15	0	0	15	0	0
5	14322022	.	C	T	9	6	15	0	2	17	0	0
5	14322037	.	C	T	7	7	14	0	3	17	0	0
5	14322212	.	C	T	18	9	27	0	1	28	0	0
5	14322269	.	T	C	8	6	14	0	1	15	0	0
5	14322433	.	A	T	9	9	18	0	1	19	0	0
5	14322647	.	C	T	9	8	17	0	1	18	0	0
5	14322898	.	T	G	5	12	17	0	1	18	0	0
5	14323082	.	A	T	5	16	21	0	0	21	0	0
5	14323934	.	T	C	7	6	13	0	0	13	0	0
5	14375330	.	T	A	3	3	6	0	1	7	0	0
5	14375529	.	A	G	13	11	24	0	1	25	0	0
5	14375598	.	A	G	16	15	31	0	1	32	0	0
5	14375623	.	A	G	15	15	30	0	4	34	0	0
5	14375881	.	T	C	12	5	17	1	2	20	0	0
5	14376155	.	A	G	18	16	34	0	1	35	0	0
5	14380632	.	C	T	10	13	23	0	4	27	0	0
5	14382534	.	C	G	9	12	21	0	4	25	0	0
5	14383193	.	G	A	15	11	26	0	0	26	0	0
5	14386045	.	T	A	11	13	24	0	2	26	0	0
5	14386277	.	A	G	9	12	21	0	2	23	0	0
5	14387338	.	G	A	9	7	16	0	0	16	0	0
5	14394466	.	A	G	20	20	40	0	2	42	0	0
5	14394515	.	G	A	22	16	38	0	2	40	0	0
5	14394872	.	T	A	14	19	33	0	0	33	0	0
5	14395430	.	G	A	20	10	30	0	0	30	0	0
5	14395664	.	G	A	19	17	36	0	1	37	0	0
5	14395697	.	G	A	20	13	33	0	2	35	0	0
5	14396030	.	C	T	10	7	17	0	0	17	0	0
5	14396438	.	C	G	2	17	19	0	25	44	0	0
5	14396609	.	T	C	8	7	15	0	0	15	0	0
5	14396783	.	C	T	12	13	25	0	0	25	0	0
5	14396876	.	C	T	10	14	24	0	1	25	0	0
5	14396893	.	G	T	12	12	24	0	0	24	0	0
5	14397231	.	T	A	8	9	17	0	1	18	0	0
5	14397232	.	G	T	8	9	17	0	0	17	0	0
5	14398364	.	C	T	8	9	17	0	0	17	0	0
5	14398876	.	A	T	5	6	11	0	0	11	0	0
5	14399766	.	G	C	3	7	10	0	0	10	0	0
5	14402108	.	C	T	5	5	10	0	0	10	0	0
5	14402144	.	C	T	0	4	4	0	6	10	0	0
5	14402848	.	C	T	2	7	9	0	0	9	0	0
5	14442388	.	C	T	0	4	4	0	5	9	0	0
5	14529221	.	C	T	2	13	15	0	17	32	0	0
5	14529450	.	C	T	15	12	27	0	1	28	0	0
5	14530091	.	T	G	10	18	28	0	0	28	0	0
5	14530346	.	C	T	13	9	22	0	1	23	0	0
5	14530457	.	G	A	4	10	14	0	0	14	0	0
5	14530511	.	T	C	4	7	11	0	2	13	0	0
5	14530571	.	A	G	8	8	16	0	0	16	0	0
5	14530595	.	C	T	8	7	15	0	1	16	0	0
5	14533937	.	C	T	2	13	15	0	15	30	0	0
5	14534025	.	G	A	13	14	27	0	0	27	0	0
5	14543331	.	G	A	12	11	23	0	0	23	0	0
5	14545814	.	C	T	1	11	12	0	10	22	0	0
5	14560993	.	G	A	5	9	14	0	1	15	0	0
5	14564831	.	G	A	11	6	17	0	0	17	0	0
5	14584305	.	G	A	10	9	19	0	1	20	0	0
5	14647979	.	T	C	6	5	11	0	2	13	0	0
5	15222330	.	A	C	1	3	4	0	0	4	0	0
5	15263332	.	A	G	1	2	3	0	0	3	0	0
5	15357116	.	A	G	20	11	31	0	0	31	0	0
5	15357117	.	A	G	19	10	29	0	3	32	0	0
5	15394285	.	G	T	14	8	22	0	0	22	0	0
5	15394354	.	G	A	15	11	26	0	0	26	0	0
5	15394357	.	A	G	15	11	26	0	0	26	0	0
5	15394396	.	C	T	2	4	6	0	9	15	0	0
5	15416836	.	T	A	5	6	11	0	2	13	0	0
5	15808741	.	A	G	8	3	11	0	0	11	0	0
5	15809671	.	G	T	1	4	5	0	0	5	0	0
5	15809708	.	C	A	5	4	9	0	0	9	0	0
5	15809754	.	C	T	2	5	7	0	0	7	0	0
5	15809903	.	C	T	3	7	10	0	0	10	0	0
5	15810361	.	A	G	5	2	7	0	2	9	0	0
5	16126203	.	C	T	5	3	8	0	0	8	0	0
5	16126392	.	G	A	4	3	7	0	0	7	0	0
5	16126440	.	T	C	4	2	6	0	0	6	0	0
5	16126762	.	C	A	3	5	8	0	0	8	0	0
5	16128798	.	C	T	5	9	14	0	2	16	0	0
5	16134766	.	C	T	0	7	7	0	3	10	0	0
5	16138840	.	G	C	5	3	8	0	2	10	0	0
5	16139401	.	G	A	4	8	12	0	0	12	0	0
5	16139451	.	A	G	6	7	13	0	0	13	0	0
5	16161112	.	A	G	1	3	4	0	0	4	0	0
5	16331902	.	G	C	4	3	7	0	0	7	0	0
5	16360785	.	G	A	1	3	4	0	0	4	0	0
5	16718993	.	G	C	6	7	13	0	0	13	0	0
5	16720830	.	G	A	13	11	24	0	2	26	0	0
5	16800437	.	A	G	12	7	19	0	0	19	0	0
5	16800710	.	T	C	18	0	18	0	14	32	0	0
5	16800955	.	C	T	2	12	14	0	13	27	0	0
5	16815222	.	C	G	12	15	27	0	0	27	0	0
5	16818828	.	G	A	13	17	30	0	3	33	0	0
5	16818858	.	T	G	11	16	27	0	0	27	0	0
5	16833631	.	A	G	14	8	22	0	1	23	0	0
5	16916446	.	T	C	9	9	18	0	0	18	0	0
5	16916476	.	G	A	7	10	17	0	0	17	0	0
5	16916575	.	T	C	12	15	27	0	1	28	0	0
5	16956501	.	G	A	13	8	21	0	0	21	0	0
5	16956615	.	C	T	7	12	19	0	0	19	0	0
5	16982624	.	G	A	14	9	23	0	0	23	0	0
5	16983206	.	C	T	7	9	16	0	0	16	0	0
5	17624588	.	C	T	4	2	6	0	0	6	0	0
5	17624669	.	G	A	5	5	10	0	0	10	0	0
5	17625003	.	A	G	2	3	5	0	0	5	0	0
5	17727421	.	A	C	12	12	24	0	2	26	0	0
5	17738720	.	G	A	1	8	9	0	10	19	0	0
5	17751894	.	A	T	9	16	25	0	3	29	1	0
5	17751939	.	A	G	9	21	30	0	0	30	0	0
5	17752545	.	A	G	15	22	37	0	2	39	0	0
5	17752778	.	A	T	8	8	16	0	0	16	0	0
5	17753214	.	G	A	3	10	13	0	1	14	0	0
5	17753216	.	G	A	3	10	13	0	1	14	0	0
5	17753584	.	C	G	13	1	14	0	8	22	0	0
5	17780571	.	A	T	3	4	7	0	1	8	0	0
5	17809748	.	T	A	4	3	7	0	0	7	0	0
5	17812618	.	G	A	2	2	4	0	1	5	0	0
5	17812921	.	A	C	1	2	3	0	0	3	0	0
5	17813007	.	G	A	1	2	3	0	5	8	0	0
5	17813008	.	G	T	6	2	8	0	0	8	0	0
5	17813051	.	T	G	2	4	6	0	0	6	0	0
5	17813181	.	C	T	3	2	5	0	0	5	0	0
5	17848805	.	C	T	1	2	3	0	0	3	0	0
5	17848811	.	G	A	1	2	3	0	0	3	0	0
5	17881763	.	C	T	3	3	6	0	0	6	0	0
5	17881793	.	T	G	3	3	6	0	0	6	0	0
5	17881851	.	A	T	1	2	3	0	0	3	0	0
5	17882282	.	T	A	9	6	15	0	0	15	0	0
5	17882291	.	C	T	6	3	9	0	2	11	0	0
5	17882438	.	G	A	4	8	12	0	0	12	0	0
5	17882454	.	G	A	5	8	13	0	0	13	0	0
5	17885194	.	T	C	3	0	3	0	6	9	0	0
5	17885287	.	A	C	4	7	11	0	0	11	0	0
5	17885863	.	G	A	6	2	8	0	2	10	0	0
5	17885902	.	G	A	4	6	10	0	0	10	0	0
5	17885920	.	C	T	3	4	7	0	0	7	0	0
5	17885995	.	A	G	8	7	15	0	0	15	0	0
5	17886028	.	T	G	10	6	16	0	0	16	0	0
5	17886039	.	G	T	8	4	12	0	3	15	0	0
5	17891709	.	G	A	9	3	12	0	0	12	0	0
5	17908986	.	C	T	1	2	3	0	1	4	0	0
5	18827368	.	T	C	5	6	11	0	0	11	0	0
5	18827683	.	C	T	3	4	7	0	0	7	0	0
5	18828352	.	A	G	7	5	12	0	0	12	0	0
5	18843931	.	C	T	0	6	6	0	5	11	0	0
5	18843983	.	G	A	4	5	9	1	1	11	0	0
5	18850867	.	C	T	7	4	11	0	1	12	0	0
5	18850885	.	C	T	0	6	6	0	4	10	0	0
5	18862517	.	T	C	4	4	8	0	1	9	0	0
5	18869002	.	T	C	2	2	4	0	0	4	0	0
5	18897313	.	T	C	3	4	7	0	1	8	0	0
5	18897321	.	C	A	0	4	4	0	4	8	0	0
5	18897450	.	A	G	3	2	5	0	0	5	0	0
5	18905088	.	T	A	14	11	25	0	0	25	0	0
5	18905648	.	G	T	12	14	26	0	0	26	0	0
5	18913313	.	G	C	7	6	13	0	0	13	0	0
5	18913435	.	G	C	6	5	11	0	0	12	1	0
5	18913480	.	C	A	1	6	7	0	5	12	0	0
5	18913587	.	T	G	2	7	9	0	0	9	0	0
5	18913772	.	T	A	10	7	17	0	0	17	0	0
5	18913792	.	T	A	6	8	14	0	3	17	0	0
5	18914639	.	G	T	7	5	12	0	3	15	0	0
5	18914661	.	T	C	7	6	13	0	1	14	0	0
5	18914801	.	G	A	3	4	7	0	0	7	0	0
5	18917589	.	T	A	2	2	4	0	1	6	1	0
5	18917746	.	A	G	3	5	8	0	0	8	0	0
5	18924714	.	G	A	2	4	6	0	0	6	0	0
5	18924732	.	A	C	1	5	6	0	0	6	0	0
5	18924753	.	T	C	1	5	6	0	0	6	0	0
5	18925680	.	G	A	0	12	12	0	15	27	0	0
5	18934879	.	C	T	14	11	25	0	0	25	0	0
5	18935327	.	G	A	13	7	20	0	0	20	0	0
5	18935437	.	G	T	10	7	17	0	1	18	0	0
5	18935553	.	A	T	6	13	19	0	2	21	0	0
5	18935629	.	A	G	2	2	4	0	1	5	0	0
5	18935661	.	A	T	2	4	6	0	0	6	0	0
5	18935752	.	C	T	9	5	14	0	0	14	0	0
5	18935832	.	G	A	1	9	10	0	8	18	0	0
5	18936192	.	G	T	3	2	5	0	0	5	0	0
5	18943102	.	G	A	1	5	6	0	0	6	0	0
5	18946776	.	G	A	3	4	7	0	0	7	0	0
5	18946980	.	G	C	5	4	9	0	0	9	0	0
5	18946983	.	T	C	4	3	7	0	0	7	0	0
5	18947824	.	T	G	2	6	8	0	0	8	0	0
5	18948119	.	A	T	4	6	10	0	0	10	0	0
5	18956409	.	C	T	0	2	2	0	2	4	0	0
5	18965845	.	G	A	7	8	15	0	0	15	0	0
5	18966343	.	C	T	0	9	9	0	5	14	0	0
5	18966410	.	A	G	5	6	11	0	0	11	0	0
5	18966474	.	A	G	9	8	17	0	1	18	0	0
5	18966553	.	G	A	10	10	20	0	3	23	0	0
5	18966611	.	C	T	10	8	18	0	0	18	0	0
5	18966695	.	C	T	12	11	23	0	0	23	0	0
5	18968390	.	C	T	4	6	10	0	0	10	0	0
5	18970922	.	C	G	9	10	19	0	1	20	0	0
5	18970923	.	G	A	10	7	17	0	2	19	0	0
5	18970983	.	G	A	8	7	15	0	1	16	0	0
5	18974517	.	G	A	8	9	17	0	0	17	0	0
5	18979769	.	T	A	7	11	18	0	0	18	0	0
5	18979776	.	A	G	12	8	20	0	0	20	0	0
5	18980271	.	G	T	7	2	9	0	1	10	0	0
5	18985625	.	G	A	8	4	12	0	1	13	0	0
5	18985806	.	G	A	6	12	18	0	0	18	0	0
5	18987399	.	C	A	10	9	19	0	0	19	0	0
5	18987797	.	C	T	1	6	7	0	6	13	0	0
5	18988571	.	C	T	0	4	4	0	9	13	0	0
5	18992415	.	C	T	1	5	6	0	2	8	0	0
5	18992883	.	A	T	3	6	9	0	0	9	0	0
5	18993038	.	C	T	4	3	7	0	0	7	0	0
5	18993393	.	C	T	3	5	8	0	0	8	0	0
5	18997473	.	A	G	3	2	5	0	0	5	0	0
5	18997614	.	G	A	3	9	12	0	0	12	0	0
5	18997636	.	G	A	2	8	10	0	0	10	0	0
5	19003863	.	A	T	3	3	6	0	0	6	0	0
5	19003998	.	A	G	5	3	8	0	1	9	0	0
5	19006884	.	A	T	1	2	3	0	0	3	0	0
5	19006907	.	A	T	3	2	5	0	0	5	0	0
5	19006931	.	A	C	1	4	5	0	0	5	0	0
5	19007201	.	G	A	5	8	13	0	0	13	0	0
5	19007282	.	C	T	6	3	9	0	0	9	0	0
5	19007306	.	A	G	4	4	8	0	1	9	0	0
5	19007355	.	C	T	7	7	14	0	0	14	0	0
5	19007374	.	T	A	7	5	12	0	0	12	0	0
5	19007392	.	G	A	5	6	11	0	0	11	0	0
5	19007452	.	T	A	9	6	15	0	0	15	0	0
5	19007498	.	C	T	7	13	20	0	1	21	0	0
5	19007606	.	G	A	7	14	21	0	1	22	0	0
5	19007686	.	C	T	3	16	19	0	0	19	0	0
5	19007760	.	G	A	15	16	31	0	0	31	0	0
5	19008334	.	A	G	29	3	32	4	7	43	0	0
5	19008335	.	A	G	25	7	32	4	7	43	0	0
5	19008379	.	G	A	22	24	46	0	0	46	0	0
5	19022146	.	T	C	12	8	20	0	1	21	0	0
5	19022250	.	C	T	15	13	28	0	2	30	0	0
5	19031187	.	G	C	13	8	21	0	1	22	0	0
5	19035241	.	T	C	5	0	5	0	7	12	0	0
5	19035299	.	T	C	5	3	8	0	2	10	0	0
5	19035328	.	C	A	9	4	13	0	1	14	0	0
5	19035580	.	G	A	9	6	15	0	1	16	0	0
5	19040491	.	G	A	8	5	13	0	1	14	0	0
5	19172186	.	C	T	1	2	3	0	0	3	0	0
5	19174266	.	T	C	2	2	4	0	0	4	0	0
5	19175154	.	C	T	1	3	4	0	0	4	0	0
5	19175199	.	T	C	1	2	3	0	0	3	0	0
5	19179405	.	T	G	7	2	9	0	0	9	0	0
5	19191559	.	T	C	4	4	8	0	0	8	0	0
5	19193288	.	G	A	4	2	6	0	0	6	0	0
5	19225580	.	C	T	2	6	8	0	0	8	0	0
5	19237466	.	G	A	3	6	9	0	0	9	0	0
5	19310688	.	G	A	1	5	6	0	0	6	0	0
5	19311116	.	C	T	7	10	17	0	2	19	0	0
5	19311622	.	T	C	9	11	20	0	1	21	0	0
5	19311835	.	G	C	8	5	13	0	2	15	0	0
5	19311863	.	G	A	9	7	16	0	2	18	0	0
5	19311914	.	G	A	9	10	19	0	1	20	0	0
5	19312925	.	C	T	15	7	22	0	0	22	0	0
5	19312927	.	T	A	15	7	22	0	0	22	0	0
5	19313010	.	T	C	8	7	15	0	0	15	0	0
5	19313082	.	C	T	12	14	26	0	1	27	0	0
5	19313169	.	T	C	16	16	32	0	3	35	0	0
5	19313211	.	G	A	15	16	31	0	1	33	1	0
5	19313268	.	T	C	16	14	30	0	0	30	0	0
5	19313317	.	G	A	14	16	30	0	2	32	0	0
5	19313338	.	C	A	19	14	33	0	0	33	0	0
5	19315455	.	T	A	14	18	32	0	0	32	0	0
5	19315501	.	G	A	19	19	38	0	1	39	0	0
5	19315519	.	G	T	1	18	19	0	19	38	0	0
5	19325641	.	G	T	26	21	47	0	0	47	0	0
5	19326549	.	G	C	16	14	30	0	1	31	0	0
5	19327072	.	G	C	23	28	51	0	0	51	0	0
5	19327221	.	G	A	24	17	41	0	0	41	0	0
5	19327700	.	A	T	15	15	30	0	0	30	0	0
5	19327815	.	T	A	13	10	23	0	0	23	0	0
5	19327979	.	G	T	12	7	19	0	2	21	0	0
5	19328135	.	G	A	20	18	38	0	4	42	0	0
5	19328216	.	A	G	21	13	34	0	0	34	0	0
5	19383074	.	A	G	2	3	5	0	0	5	0	0
5	19383077	.	G	A	1	2	3	0	1	4	0	0
5	19383211	.	T	C	3	2	5	0	0	5	0	0
5	19383242	.	A	G	2	2	4	0	0	4	0	0
5	19385849	.	A	T	1	6	7	0	0	7	0	0
5	19436667	.	T	C	3	1	4	0	6	10	0	0
5	19436677	.	G	A	4	6	10	0	0	10	0	0
5	19436704	.	C	G	6	5	11	0	1	12	0	0
5	19437002	.	C	G	9	3	12	0	1	13	0	0
5	19437213	.	G	A	7	11	18	0	0	18	0	0
5	19437253	.	G	A	7	6	13	0	1	14	0	0
5	19437424	.	T	C	7	0	7	0	6	13	0	0
5	19437454	.	G	A	5	6	11	0	0	11	0	0
5	19437467	.	T	G	4	5	9	0	0	9	0	0
5	19437678	.	T	A	11	2	13	0	0	13	0	0
5	19437684	.	C	T	11	0	11	0	1	12	0	0
5	19437952	.	A	C	10	3	13	0	0	13	0	0
5	19437968	.	T	C	8	3	11	0	1	12	0	0
5	19438084	.	C	T	1	4	5	0	6	11	0	0
5	19438097	.	G	A	4	3	7	0	1	8	0	0
5	19438356	.	A	T	3	2	5	0	1	6	0	0
5	19438357	.	T	G	3	3	6	0	0	6	0	0
5	19438458	.	G	T	4	5	9	0	1	10	0	0
5	19438572	.	A	G	4	3	7	0	1	8	0	0
5	19438744	.	T	C	5	5	10	0	0	10	0	0
5	19438865	.	T	A	3	5	8	0	0	8	0	0
5	19438954	.	A	T	6	6	12	0	0	12	0	0
5	19439052	.	C	T	7	3	10	0	0	10	0	0
5	19439201	.	T	C	4	4	8	0	2	10	0	0
5	19439468	.	C	T	7	4	11	0	1	12	0	0
5	19443348	.	C	T	9	4	13	0	0	13	0	0
5	19443375	.	G	A	6	4	10	0	0	10	0	0
5	19448114	.	C	T	2	2	4	0	1	5	0	0
5	19453365	.	C	T	3	2	5	0	0	5	0	0
5	19461887	.	C	T	2	5	7	0	0	7	0	0
5	19463858	.	C	A	3	2	5	0	0	5	0	0
5	19464065	.	G	T	1	3	4	0	0	4	0	0
5	19464086	.	C	T	3	3	6	0	0	6	0	0
5	19465354	.	C	A	2	2	4	0	0	4	0	0
5	19465450	.	C	A	2	3	5	0	1	6	0	0
5	19465459	.	C	T	4	3	7	0	0	7	0	0
5	19468585	.	C	A	4	5	9	0	1	10	0	0
5	19487762	.	A	G	1	3	4	0	0	4	0	0
5	19489764	.	T	G	5	4	9	0	0	9	0	0
5	19489821	.	C	A	6	8	14	0	0	14	0	0
5	19489964	.	C	G	11	6	17	0	0	17	0	0
5	19492344	.	G	A	5	6	11	0	0	11	0	0
5	19492395	.	T	C	8	0	8	0	4	12	0	0
5	19493896	.	C	A	7	8	15	0	0	15	0	0
5	19494465	.	G	A	1	4	5	0	1	6	0	0
5	19952815	.	T	C	5	4	9	0	0	9	0	0
5	19962079	.	A	T	2	2	4	0	0	4	0	0
5	19962284	.	A	T	7	8	15	0	0	15	0	0
5	19962349	.	A	T	4	8	12	0	1	13	0	0
5	19962395	.	C	T	2	4	6	0	0	6	0	0
5	19962431	.	A	T	1	3	4	0	0	4	0	0
5	19962527	.	G	T	11	8	19	0	0	19	0	0
5	19962590	.	C	A	11	10	21	0	2	23	0	0
5	19962721	.	T	A	7	14	21	0	0	21	0	0
5	19962880	.	T	C	3	0	3	0	11	14	0	0
5	19962891	.	G	A	4	9	13	0	0	13	0	0
5	19962959	.	G	T	9	12	21	0	0	21	0	0
5	19963023	.	A	G	11	16	27	0	0	27	0	0
5	19963065	.	A	T	11	17	28	0	1	29	0	0
5	20064856	.	G	T	1	2	3	0	0	3	0	0
5	20086305	.	T	A	3	3	6	0	0	6	0	0
5	20086473	.	C	T	4	2	6	0	0	6	0	0
5	20086564	.	G	A	2	2	4	0	0	4	0	0
5	20086669	.	A	T	1	2	3	0	0	3	0	0
5	20103255	.	C	A	11	5	16	0	0	16	0	0
5	20103314	.	G	T	12	10	22	0	2	24	0	0
5	20103315	.	C	T	12	10	22	0	2	24	0	0
5	20103410	.	G	A	9	10	19	0	0	19	0	0
5	20103416	.	T	A	9	9	18	0	2	20	0	0
5	20108008	.	C	G	4	6	10	0	1	11	0	0
5	20112356	.	G	C	0	3	3	0	2	5	0	0
5	20112374	.	T	G	1	2	3	0	2	5	0	0
5	20125995	.	C	A	4	4	8	0	0	8	0	0
5	20126133	.	A	G	3	3	6	0	0	6	0	0
5	20126699	.	T	C	6	0	6	0	8	14	0	0
5	20129618	.	C	T	5	4	9	0	0	9	0	0
5	20148761	.	A	G	3	5	8	0	0	8	0	0
5	20151106	.	A	G	10	7	17	0	1	18	0	0
5	20159547	.	C	A	9	12	21	0	0	21	0	0
5	20163124	.	G	A	0	10	10	0	15	25	0	0
5	20165544	.	C	T	14	14	28	0	0	28	0	0
5	20165673	.	C	T	11	7	18	0	1	19	0	0
5	20170985	.	T	C	10	7	17	0	0	17	0	0
5	20173896	.	C	T	1	2	3	0	0	3	0	0
5	20286278	.	G	A	1	4	5	0	0	5	0	0
5	20416565	.	G	C	1	4	5	0	7	12	0	0
5	20416618	.	A	T	4	3	7	0	0	7	0	0
5	20416958	.	T	C	10	4	14	0	0	14	0	0
5	20417099	.	T	C	6	4	10	0	1	11	0	0
5	20417180	.	G	A	1	6	7	0	10	17	0	0
5	20417399	.	G	C	4	3	7	0	1	8	0	0
5	20417405	.	C	G	5	2	7	0	0	8	1	0
5	20417631	.	T	G	5	0	5	0	7	12	0	0
5	20418680	.	A	C	2	2	4	0	0	4	0	0
5	20418958	.	A	T	6	6	12	0	1	13	0	0
5	20419008	.	A	T	10	8	18	0	1	19	0	0
5	20419613	.	G	A	13	4	17	0	1	18	0	0
5	20443918	.	T	A	1	2	3	0	1	4	0	0
5	20443949	.	A	G	4	4	8	0	1	9	0	0
5	20444017	.	G	T	18	15	33	0	3	36	0	0
5	20444216	.	G	C	20	25	45	0	3	48	0	0
5	20445065	.	G	A	13	19	32	0	1	33	0	0
5	20445985	.	A	T	23	22	45	0	3	48	0	0
5	20446021	.	T	A	14	15	29	0	0	29	0	0
5	20457291	.	T	C	5	6	11	0	1	12	0	0
5	20457390	.	C	T	10	8	18	0	3	21	0	0
5	20467641	.	A	G	6	14	20	0	0	20	0	0
5	20471875	.	G	C	11	12	23	0	1	24	0	0
5	20473812	.	A	G	9	0	9	0	14	23	0	0
5	20473818	.	G	A	1	11	12	0	9	21	0	0
5	20474076	.	A	G	7	11	18	0	1	19	0	0
5	20475730	.	A	G	9	16	25	0	0	25	0	0
5	20477419	.	T	C	9	22	31	0	1	32	0	0
5	20479921	.	C	A	5	3	8	0	0	8	0	0
5	20479990	.	A	G	5	16	21	0	0	21	0	0
5	20480036	.	A	T	2	9	11	0	0	11	0	0
5	20480369	.	T	C	4	7	11	0	1	12	0	0
5	20480401	.	G	A	7	10	17	0	0	17	0	0
5	20480758	.	T	A	12	14	26	1	0	27	0	0
5	20480867	.	C	T	9	12	21	0	1	22	0	0
5	20481132	.	G	A	13	8	21	0	3	24	0	0
5	20485754	.	G	A	1	3	4	0	0	4	0	0
5	20485769	.	T	C	1	4	5	0	0	5	0	0
5	20486485	.	G	A	7	2	9	0	0	9	0	0
5	20486727	.	G	T	5	9	14	0	0	14	0	0
5	20486746	.	A	G	5	7	12	0	0	12	0	0
5	20486866	.	T	C	10	4	14	0	0	14	0	0
5	20487175	.	A	G	6	5	11	0	1	12	0	0
5	20487328	.	G	A	7	4	11	0	0	11	0	0
5	20487379	.	G	A	4	4	8	0	1	9	0	0
5	20487433	.	C	T	7	3	10	0	1	11	0	0
5	20487490	.	A	G	2	3	5	0	0	5	0	0
5	20589797	.	C	T	3	3	6	0	0	6	0	0
5	20590064	.	C	T	5	4	9	0	0	9	0	0
5	20590247	.	G	A	5	2	7	0	0	7	0	0
5	20590725	.	C	T	7	4	11	0	0	11	0	0
5	20590730	.	T	C	7	4	11	0	0	11	0	0
5	20627301	.	G	A	3	4	7	0	0	7	0	0
5	20627337	.	G	A	3	2	5	0	0	5	0	0
5	20627609	.	G	A	6	2	8	0	0	8	0	0
5	20627917	.	T	G	2	4	6	0	0	6	0	0
5	20628036	.	G	A	2	7	9	0	0	9	0	0
5	20638976	.	A	T	6	4	10	0	0	10	0	0
5	20639285	.	C	G	0	3	3	0	2	5	0	0
5	20647434	.	A	G	1	3	4	0	0	4	0	0
5	20678070	.	T	C	1	4	5	0	0	5	0	0
5	20787273	.	T	C	3	4	7	0	0	7	0	0
5	20862014	.	G	T	0	4	4	0	0	4	0	0
5	20933321	.	C	A	7	36	43	0	1	44	0	0
5	20933332	.	T	C	10	0	10	7	36	53	0	0
5	22012459	.	T	C	6	6	12	0	0	12	0	0
5	22172569	.	C	T	4	2	6	0	3	9	0	0
5	23397221	.	T	C	22	10	32	0	0	32	0	0
5	23574916	.	T	C	2	5	7	1	1	9	0	0
5	23575646	.	T	C	3	11	14	0	0	14	0	0
5	23575661	.	T	C	4	5	9	0	0	9	0	0
5	24135195	.	C	T	15	4	19	0	1	20	0	0
5	24163099	.	A	G	2	3	5	0	0	5	0	0
5	24163289	.	A	G	3	6	9	0	0	9	0	0
5	24885617	.	G	A	0	6	6	0	1	7	0	0
5	26062582	.	A	G	14	5	19	0	1	20	0	0
5	26109349	.	A	G	1	7	8	0	0	8	0	0
5	26926492	.	A	G	2	2	4	0	0	4	0	0
5	28529378	.	A	G	1	3	4	0	2	6	0	0
5	28789611	.	C	T	5	3	8	0	0	8	0	0
5	29492123	.	A	G	6	2	8	0	0	8	0	0
5	29598984	.	T	C	36	0	36	0	19	55	0	0
5	31432387	.	A	G	3	5	8	0	0	8	0	0
5	32796788	.	T	C	2	4	6	0	0	6	0	0
5	33329786	.	A	G	6	6	12	0	1	13	0	0
5	35123821	.	T	A	1	2	3	0	0	3	0	0
5	35124435	.	T	C	10	0	10	0	7	17	0	0
5	35124479	.	C	T	0	8	8	0	7	15	0	0
5	35124859	.	C	T	6	3	9	0	0	9	0	0
5	35125414	.	C	T	0	8	8	0	6	14	0	0
5	35125423	.	C	T	7	9	16	0	0	16	0	0
5	35125882	.	G	A	7	6	13	0	0	13	0	0
5	35125883	.	A	T	7	6	13	0	0	13	0	0
5	35129861	.	C	A	4	5	9	0	0	10	1	0
5	35135687	.	G	A	5	7	12	0	0	12	0	0
5	35137384	.	A	G	3	4	7	0	1	8	0	0
5	35137621	.	C	T	0	10	10	0	10	20	0	0
5	35202876	.	A	T	4	8	12	0	0	12	0	0
5	35202958	.	G	A	8	6	14	0	0	17	3	0
5	35202959	.	A	T	12	5	17	0	1	18	0	0
5	35203092	.	G	A	7	10	17	0	0	17	0	0
5	35203486	.	C	A	9	9	18	0	2	20	0	0
5	35203629	.	C	T	1	18	19	0	7	26	0	0
5	35204077	.	T	G	6	8	14	0	2	16	0	0
5	35204159	.	C	T	5	5	10	0	1	11	0	0
5	35204280	.	A	T	11	8	19	0	1	20	0	0
5	35204322	.	A	G	10	7	17	0	0	17	0	0
5	35204353	.	C	T	6	6	12	0	0	12	0	0
5	35204390	.	G	A	7	7	14	0	1	15	0	0
5	35204681	.	A	C	2	6	8	0	1	9	0	0
5	35204689	.	A	C	3	0	3	0	5	8	0	0
5	35204754	.	C	T	9	8	17	0	3	20	0	0
5	35205005	.	G	A	10	8	18	0	1	19	0	0
5	35207914	.	T	G	4	10	14	0	1	15	0	0
5	35220402	.	T	A	6	6	12	0	0	12	0	0
5	35271001	.	C	T	28	10	38	0	3	41	0	0
5	35271154	.	A	T	15	23	38	0	1	39	0	0
5	35271181	.	A	G	19	17	36	0	5	41	0	0
5	35271194	.	G	A	18	22	40	0	4	44	0	0
5	35271309	.	T	A	29	29	58	0	1	59	0	0
5	35271465	.	T	C	26	22	48	0	2	50	0	0
5	35271824	.	C	A	18	18	36	0	0	36	0	0
5	35272032	.	G	A	21	18	39	0	0	39	0	0
5	35272438	.	C	T	4	19	23	0	24	47	0	0
5	35272497	.	G	A	16	16	32	0	1	33	0	0
5	35272560	.	T	G	24	12	36	0	3	39	0	0
5	35273062	.	G	A	27	20	47	0	1	48	0	0
5	35273225	.	T	C	14	19	33	0	1	34	0	0
5	35273447	.	A	G	19	9	28	0	0	28	0	0
5	35273509	.	A	T	19	15	34	0	0	35	1	0
5	35273546	.	A	T	18	9	27	0	2	29	0	0
5	35273564	.	G	A	13	10	23	0	0	23	0	0
5	35273708	.	T	C	11	12	23	0	1	24	0	0
5	35273793	.	A	T	15	14	29	0	0	29	0	0
5	35273838	.	A	C	17	18	35	0	1	36	0	0
5	35273992	.	A	G	12	18	30	1	1	32	0	0
5	35274398	.	G	A	11	15	26	0	1	27	0	0
5	35275103	.	C	T	19	18	37	0	2	39	0	0
5	35275859	.	G	T	9	13	22	0	0	22	0	0
5	35276154	.	A	G	19	14	33	0	0	33	0	0
5	35276303	.	G	C	17	17	34	0	3	37	0	0
5	35276386	.	G	A	17	12	29	0	1	30	0	0
5	35276580	.	A	G	12	14	26	0	1	27	0	0
5	35276811	.	C	G	17	13	30	0	0	30	0	0
5	35276911	.	C	T	2	10	12	0	12	24	0	0
5	35277184	.	T	A	11	10	21	0	0	21	0	0
5	35277256	.	T	A	8	15	23	0	0	23	0	0
5	35277280	.	T	C	12	12	24	0	0	24	0	0
5	35277459	.	T	C	18	9	27	0	2	29	0	0
5	35277509	.	A	T	22	8	30	0	1	31	0	0
5	35278237	.	A	T	7	5	12	0	0	12	0	0
5	35278597	.	C	T	12	11	23	0	0	23	0	0
5	35278863	.	C	T	8	9	17	0	2	19	0	0
5	35278933	.	T	C	10	0	10	0	8	18	0	0
5	35278977	.	T	G	5	6	11	0	0	11	0	0
5	35279007	.	C	T	0	12	12	0	4	16	0	0
5	35279065	.	A	G	7	7	14	1	0	15	0	0
5	35279230	.	T	G	7	7	14	0	0	14	0	0
5	35279275	.	T	G	10	6	16	0	0	16	0	0
5	35279831	.	C	T	4	4	8	0	1	9	0	0
5	35279884	.	G	A	7	7	14	0	0	14	0	0
5	35301563	.	A	G	11	5	16	0	0	16	0	0
5	35422324	.	T	C	7	7	14	0	0	14	0	0
5	35422530	.	C	T	8	2	10	0	0	10	0	0
5	35431641	.	A	G	8	8	16	0	2	18	0	0
5	35431703	.	T	G	8	10	18	0	0	18	0	0
5	35454464	.	C	T	10	14	24	0	1	25	0	0
5	35473544	.	T	C	7	2	9	0	1	10	0	0
5	35475907	.	A	T	7	5	12	0	0	12	0	0
5	35478593	.	G	C	0	5	5	0	3	8	0	0
5	35486822	.	C	T	3	2	5	0	1	6	0	0
5	35486827	.	G	A	3	3	6	0	0	6	0	0
5	35486917	.	C	A	1	5	6	0	0	6	0	0
5	35486955	.	T	C	1	4	5	0	1	6	0	0
5	35487030	.	A	G	5	3	8	0	0	8	0	0
5	35487332	.	T	A	5	2	7	0	0	7	0	0
5	35487407	.	A	T	3	3	6	0	1	7	0	0
5	35487416	.	G	C	3	4	7	0	0	7	0	0
5	35487459	.	A	T	4	3	7	0	0	7	0	0
5	35678570	.	G	A	0	4	4	0	6	10	0	0
5	35678844	.	C	T	3	3	6	0	0	6	0	0
5	35683116	.	G	A	1	2	3	0	0	3	0	0
5	35683134	.	C	A	2	2	4	0	0	4	0	0
5	35683225	.	C	A	3	2	5	0	0	5	0	0
5	35683861	.	A	G	2	1	3	0	1	4	0	0
5	35683950	.	T	A	1	1	2	0	0	2	0	0
5	35683991	.	A	G	2	3	5	0	0	5	0	0
5	35684014	.	C	T	4	3	7	0	0	7	0	0
5	35748938	.	T	C	9	15	24	0	0	24	0	0
5	35749470	.	A	G	6	12	18	0	0	18	0	0
5	35751883	.	G	T	11	10	21	0	0	21	0	0
5	35751977	.	A	G	11	12	23	0	2	25	0	0
5	35754284	.	A	G	13	1	14	0	17	31	0	0
5	35754424	.	T	C	8	16	24	0	3	27	0	0
5	35754431	.	A	G	10	1	11	0	15	26	0	0
5	35754503	.	A	C	19	7	26	0	1	27	0	0
5	35754599	.	T	A	18	16	34	0	1	35	0	0
5	35754663	.	A	G	14	6	20	0	1	21	0	0
5	35898689	.	T	C	1	5	6	0	0	6	0	0
5	35955514	.	T	C	10	15	25	1	0	26	0	0
5	35967234	.	C	T	8	7	15	0	2	17	0	0
5	35967270	.	T	A	4	4	8	0	0	8	0	0
5	35967438	.	A	T	1	8	9	0	0	9	0	0
5	36271160	.	T	G	5	6	11	0	0	11	0	0
5	36296066	.	G	A	6	4	10	0	0	10	0	0
5	36296114	.	T	C	3	5	8	0	0	8	0	0
5	36416204	.	A	G	13	11	24	0	0	24	0	0
5	36416307	.	C	G	13	0	13	0	8	21	0	0
5	36416367	.	G	A	1	6	7	0	15	22	0	0
5	36416478	.	G	T	15	10	25	0	1	26	0	0
5	36416583	.	C	T	18	18	36	0	1	37	0	0
5	36421991	.	G	A	2	8	10	0	5	15	0	0
5	36530959	.	A	T	13	7	20	0	0	20	0	0
5	36536665	.	T	C	11	9	20	0	3	23	0	0
5	36536742	.	C	T	14	11	25	0	1	26	0	0
5	36536859	.	A	G	4	0	4	0	6	10	0	0
5	36536910	.	G	A	7	5	12	0	0	12	0	0
5	36537020	.	A	G	6	8	14	0	1	15	0	0
5	36537021	.	T	A	6	9	15	0	0	15	0	0
5	36537057	.	G	A	8	13	21	0	0	21	0	0
5	36537073	.	A	C	12	10	22	0	0	22	0	0
5	36537124	.	A	G	15	4	19	0	0	19	0	0
5	36537126	.	G	A	13	5	18	0	1	19	0	0
5	36537231	.	A	T	14	8	22	0	2	24	0	0
5	36537246	.	A	G	15	2	17	0	7	24	0	0
5	36537334	.	A	T	11	8	19	0	0	19	0	0
5	36537352	.	G	A	7	7	14	0	2	16	0	0
5	36537611	.	C	A	5	7	12	0	0	12	0	0
5	36537672	.	C	A	8	2	10	0	1	11	0	0
5	36537927	.	T	C	2	6	8	0	0	8	0	0
5	36558059	.	G	A	19	18	37	0	1	38	0	0
5	36558348	.	A	G	13	11	24	0	2	26	0	0
5	36558369	.	G	A	11	12	23	0	2	25	0	0
5	36558441	.	C	T	16	20	36	0	0	36	0	0
5	36563257	.	T	C	13	12	25	0	1	26	0	0
5	36564205	.	A	G	10	6	16	0	0	16	0	0
5	36564206	.	A	T	10	6	16	0	0	16	0	0
5	36567750	.	C	A	1	6	7	0	12	19	0	0
5	36570280	.	G	A	9	11	20	0	2	22	0	0
5	36583271	.	A	G	8	4	12	0	0	12	0	0
5	36583575	.	C	T	0	9	9	0	5	14	0	0
5	36584779	.	G	T	6	8	14	0	0	14	0	0
5	36584985	.	C	T	5	8	13	0	0	13	0	0
5	36585054	.	C	T	8	6	14	0	0	14	0	0
5	36585662	.	G	A	7	7	14	0	1	15	0	0
5	36585933	.	C	T	5	5	10	0	0	10	0	0
5	36586190	.	G	A	10	6	16	0	0	16	0	0
5	36586192	.	C	G	11	6	17	0	0	17	0	0
5	36586867	.	A	G	3	3	6	0	0	6	0	0
5	36586906	.	C	G	0	4	4	0	11	15	0	0
5	36592135	.	G	A	6	4	10	0	0	10	0	0
5	36595912	.	G	A	9	8	17	0	0	17	0	0
5	36596106	.	A	G	2	10	12	0	0	12	0	0
5	36596278	.	G	A	5	4	9	0	0	9	0	0
5	36596294	.	G	A	6	6	12	0	0	12	0	0
5	36596378	.	G	A	5	4	9	0	1	10	0	0
5	36596397	.	T	A	6	3	9	0	0	9	0	0
5	36596517	.	C	A	0	9	9	0	3	12	0	0
5	36597547	.	C	A	1	2	3	0	0	3	0	0
5	36609286	.	G	A	3	2	5	0	0	5	0	0
5	36609442	.	G	A	0	2	2	0	1	3	0	0
5	36609469	.	T	C	1	5	6	0	0	6	0	0
5	36624620	.	G	A	2	14	16	0	9	25	0	0
5	36650153	.	C	A	5	3	8	0	0	8	0	0
5	36650289	.	T	G	2	4	6	0	1	7	0	0
5	36653522	.	G	A	8	8	16	0	0	16	0	0
5	36653876	.	T	G	2	0	2	0	8	10	0	0
5	36654147	.	G	A	1	8	9	0	7	16	0	0
5	36654344	.	G	A	1	2	3	0	0	3	0	0
5	36665351	.	C	T	9	13	22	0	1	23	0	0
5	36668321	.	C	T	5	5	10	0	1	11	0	0
5	36673347	.	C	T	3	9	12	0	0	12	0	0
5	36673470	.	C	A	5	3	8	0	1	9	0	0
5	36673609	.	A	G	4	3	7	0	0	7	0	0
5	36673687	.	A	T	4	2	6	0	0	6	0	0
5	36674005	.	A	T	8	3	11	0	0	11	0	0
5	36674796	.	G	C	3	7	10	0	0	10	0	0
5	36674831	.	C	T	4	9	13	0	0	13	0	0
5	36732199	.	G	C	18	16	34	0	4	38	0	0
5	36732217	.	A	G	23	15	38	0	3	41	0	0
5	36739134	.	T	C	17	17	34	0	0	34	0	0
5	36739310	.	T	A	11	15	26	0	0	26	0	0
5	36739316	.	T	C	10	16	26	0	0	26	0	0
5	36739352	.	T	A	14	10	24	0	2	26	0	0
5	36739361	.	T	C	12	9	21	0	1	22	0	0
5	36786641	.	G	A	2	9	11	0	8	19	0	0
5	36802395	.	A	C	5	7	12	0	1	13	0	0
5	36802407	.	T	C	5	8	13	0	0	13	0	0
5	36851191	.	C	T	14	5	19	0	0	19	0	0
5	36852564	.	A	G	9	0	9	0	9	18	0	0
5	36852848	.	G	A	1	3	4	0	8	12	0	0
5	36853849	.	C	G	13	15	28	0	0	28	0	0
5	36854390	.	G	C	16	6	22	0	0	22	0	0
5	36895627	.	G	A	4	4	8	0	0	8	0	0
5	36897749	.	C	A	1	2	3	0	1	4	0	0
5	36898476	.	C	T	22	24	46	1	1	48	0	0
5	36898668	.	A	G	32	0	32	0	31	63	0	0
5	36901003	.	T	G	12	13	25	0	2	27	0	0
5	36902610	.	A	G	16	1	17	0	19	36	0	0
5	36902628	.	T	C	17	17	34	0	1	35	0	0
5	36907182	.	G	T	5	3	8	0	0	8	0	0
5	36908034	.	T	C	25	21	46	0	0	46	0	0
5	36913570	.	A	G	3	2	5	0	0	5	0	0
5	36914002	.	C	T	6	5	11	0	0	11	0	0
5	36914018	.	A	C	6	0	6	0	5	11	0	0
5	36916370	.	A	T	4	6	10	0	0	10	0	0
5	36922399	.	A	G	4	2	6	0	0	6	0	0
5	36924122	.	G	C	2	4	6	0	0	6	0	0
5	36945378	.	T	A	18	16	34	8	2	44	0	0
5	36945383	.	A	T	17	15	32	8	3	44	1	0
5	36945463	.	T	A	37	18	55	0	1	56	0	0
5	36945518	.	T	G	34	16	50	0	3	53	0	0
5	36945719	.	G	T	31	26	57	4	11	72	0	0
5	36945747	.	T	A	25	27	52	4	11	67	0	0
5	36945927	.	A	C	29	34	63	0	0	63	0	0
5	36945937	.	C	T	28	31	59	0	0	59	0	0
5	36946244	.	A	G	42	26	68	0	6	74	0	0
5	36946261	.	T	C	45	5	50	0	25	75	0	0
5	36946341	.	C	T	9	29	38	0	31	69	0	0
5	36996458	.	A	G	16	8	24	0	1	25	0	0
5	36996638	.	A	G	22	0	22	0	16	38	0	0
5	36997133	.	A	G	19	7	26	0	1	27	0	0
5	37032095	.	A	G	13	17	30	0	0	30	0	0
5	37032191	.	T	C	13	17	30	0	1	31	0	0
5	37032280	.	C	G	14	16	30	0	1	31	0	0
5	37032339	.	A	G	11	0	11	0	15	26	0	0
5	37032611	.	T	C	8	14	22	0	1	23	0	0
5	37032782	.	G	A	10	21	31	0	0	31	0	0
5	37032799	.	A	T	11	18	29	0	0	29	0	0
5	37032959	.	A	G	15	15	30	0	2	32	0	0
5	37034111	.	T	C	11	19	30	0	0	30	0	0
5	37036404	.	T	C	9	11	20	0	0	20	0	0
5	37036648	.	A	G	12	0	12	0	5	17	0	0
5	37036662	.	T	A	9	4	13	0	1	14	0	0
5	37036856	.	T	C	11	10	21	0	0	21	0	0
5	37036975	.	A	T	7	12	19	0	0	20	1	0
5	37037079	.	C	T	19	13	32	0	0	32	0	0
5	37037152	.	T	C	16	20	36	0	1	37	0	0
5	37037308	.	C	A	6	5	11	0	0	11	0	0
5	37037436	.	G	T	1	8	9	0	6	15	0	0
5	37037583	.	T	C	17	12	29	0	1	30	0	0
5	37037617	.	A	T	17	15	32	0	2	35	1	0
5	37037669	.	T	G	16	15	31	1	3	35	0	0
5	37037742	.	A	T	15	17	32	0	0	32	0	0
5	37038017	.	T	C	6	7	13	0	0	13	0	0
5	37056839	.	A	G	2	0	2	0	2	4	0	0
5	37061485	.	G	A	33	18	51	0	0	51	0	0
5	37061487	.	C	T	31	17	48	0	1	49	0	0
5	37065416	.	T	C	25	20	45	0	2	47	0	0
5	37065729	.	C	T	22	8	30	0	0	35	5	0
5	37277534	.	A	G	2	2	4	0	0	4	0	0
5	37280125	.	A	G	2	3	5	0	0	5	0	0
5	37280343	.	T	G	2	2	4	0	0	4	0	0
5	37286325	.	A	G	3	0	3	0	6	9	0	0
5	37286590	.	G	A	1	5	6	0	1	7	0	0
5	37293768	.	G	A	6	6	12	0	2	14	0	0
5	37293815	.	T	C	9	8	17	0	0	17	0	0
5	37293841	.	G	A	12	8	20	0	0	20	0	0
5	37294077	.	G	A	4	5	9	0	0	9	0	0
5	37295646	.	C	T	8	9	17	0	0	17	0	0
5	37296298	.	C	T	7	8	15	0	0	15	0	0
5	37301236	.	G	A	11	9	20	0	0	20	0	0
5	37301249	.	C	T	11	6	17	0	0	17	0	0
5	37301282	.	C	T	9	6	15	0	3	18	0	0
5	37301783	.	A	G	8	13	21	0	1	22	0	0
5	37304028	.	T	C	9	5	14	0	1	15	0	0
5	37304070	.	G	T	11	5	16	0	0	16	0	0
5	37307921	.	C	G	19	14	33	0	1	34	0	0
5	37309734	.	A	G	16	16	32	0	1	33	0	0
5	37309881	.	C	T	24	10	34	0	3	37	0	0
5	37331854	.	C	T	7	6	13	0	1	14	0	0
5	37333870	.	G	A	16	14	30	0	0	30	0	0
5	37334264	.	T	A	5	6	11	0	0	11	0	0
5	37380533	.	T	C	8	9	17	0	2	19	0	0
5	37413762	.	G	A	10	4	14	0	1	15	0	0
5	37422999	.	A	T	11	4	15	0	1	16	0	0
5	37423193	.	G	A	8	5	13	0	1	14	0	0
5	37439388	.	C	T	12	12	24	0	0	24	0	0
5	37439418	.	C	T	12	13	25	0	3	28	0	0
5	37439505	.	T	C	6	18	24	0	2	26	0	0
5	37439517	.	A	C	7	15	22	0	2	24	0	0
5	37439891	.	T	C	15	11	26	0	1	27	0	0
5	37504340	.	T	A	4	3	7	0	0	7	0	0
5	37504966	.	G	A	2	2	4	0	0	4	0	0
5	37505245	.	G	A	9	9	18	0	0	18	0	0
5	37507823	.	T	C	9	5	14	0	0	14	0	0
5	37507901	.	C	T	6	8	14	0	1	15	0	0
5	37508828	.	C	T	3	7	10	0	0	10	0	0
5	37508832	.	T	G	2	7	9	0	0	9	0	0
5	37508979	.	A	C	1	4	5	0	0	5	0	0
5	37509102	.	T	C	2	2	4	0	1	5	0	0
5	37509156	.	G	A	2	5	7	0	0	7	0	0
5	37509296	.	G	C	7	8	15	0	0	15	0	0
5	37509428	.	T	G	6	4	10	0	0	10	0	0
5	37509703	.	C	T	12	17	29	0	0	29	0	0
5	37509766	.	G	A	0	12	12	0	9	21	0	0
5	37509857	.	A	G	3	9	12	0	1	13	0	0
5	37509916	.	A	G	4	10	14	0	0	14	0	0
5	37510292	.	C	T	3	6	9	0	0	9	0	0
5	37510293	.	T	C	3	6	9	0	0	9	0	0
5	37510574	.	C	G	10	4	14	0	0	14	0	0
5	37561297	.	T	C	1	2	3	0	0	3	0	0
5	37573388	.	C	T	1	3	4	0	0	4	0	0
5	37677229	.	C	T	7	10	17	0	0	17	0	0
5	37678256	.	T	C	8	8	16	0	0	16	0	0
5	37680403	.	G	A	1	10	11	0	11	22	0	0
5	37686590	.	C	T	10	13	23	0	2	25	0	0
5	37688077	.	C	T	8	9	17	0	1	18	0	0
5	37688422	.	A	G	8	6	14	0	0	14	0	0
5	37688878	.	A	C	20	20	40	0	0	40	0	0
5	37691223	.	A	G	15	9	24	0	2	26	0	0
5	37692171	.	A	G	19	18	37	0	0	37	0	0
5	37692620	.	T	C	9	10	19	0	0	19	0	0
5	37694283	.	G	A	13	21	34	0	2	36	0	0
5	37694568	.	A	C	16	17	33	0	1	34	0	0
5	37695528	.	A	G	11	6	17	0	1	18	0	0
5	37696582	.	G	A	14	5	19	0	0	19	0	0
5	37697134	.	C	T	19	16	35	0	1	36	0	0
5	37699115	.	A	G	19	20	39	0	0	39	0	0
5	37700687	.	C	A	12	14	26	0	2	28	0	0
5	37700908	.	T	C	17	15	32	0	2	34	0	0
5	37701262	.	T	A	13	21	34	0	2	36	0	0
5	37702934	.	C	T	14	16	30	0	5	35	0	0
5	37703176	.	G	A	2	16	18	0	16	34	0	0
5	37706798	.	C	T	27	24	51	1	0	52	0	0
5	37707190	.	G	A	25	19	44	0	0	44	0	0
5	37708995	.	A	T	24	20	44	0	5	49	0	0
5	37709057	.	T	A	17	30	47	0	0	47	0	0
5	37757505	.	C	T	2	5	7	0	0	7	0	0
5	37757677	.	C	T	10	6	16	0	0	16	0	0
5	37757690	.	T	C	10	5	15	0	1	16	0	0
5	37785214	.	A	G	2	2	4	0	0	4	0	0
5	37807825	.	T	C	1	2	3	0	0	3	0	0
5	37807834	.	A	G	1	2	3	0	1	4	0	0
5	37812150	.	A	G	2	2	4	0	0	4	0	0
5	37813990	.	G	T	1	1	2	0	1	3	0	0
5	37838415	.	T	C	41	35	76	0	9	85	0	0
5	37839029	.	G	T	47	62	109	0	2	111	0	0
5	37851201	.	C	T	6	2	8	0	0	8	0	0
5	37851528	.	T	C	3	4	7	0	1	8	0	0
5	37851542	.	G	A	3	4	7	0	0	7	0	0
5	37851742	.	G	A	1	3	4	0	0	4	0	0
5	37851830	.	C	A	4	3	7	0	0	7	0	0
5	37851876	.	C	T	5	6	11	0	0	11	0	0
5	37851923	.	G	A	4	4	8	0	0	8	0	0
5	37864845	.	A	G	8	11	19	0	0	19	0	0
5	37865142	.	C	T	11	5	16	0	0	16	0	0
5	37865628	.	T	C	5	5	10	0	0	10	0	0
5	37865744	.	C	G	6	6	12	0	0	12	0	0
5	37866310	.	C	T	8	6	14	0	0	14	0	0
5	37867491	.	C	T	10	9	19	0	1	20	0	0
5	37875576	.	A	G	2	2	4	0	0	4	0	0
5	37880681	.	C	A	4	4	8	0	0	8	0	0
5	37880796	.	A	T	3	2	5	0	0	5	0	0
5	37880896	.	C	T	0	3	3	0	1	4	0	0
5	37880922	.	G	A	3	3	6	0	0	6	0	0
5	37912292	.	T	A	19	10	29	0	1	30	0	0
5	37912442	.	A	G	10	11	21	0	1	22	0	0
5	37912489	.	T	A	11	13	24	0	1	25	0	0
5	37912748	.	A	T	17	5	22	0	0	22	0	0
5	37912859	.	A	C	13	10	23	0	1	24	0	0
5	37912970	.	A	C	11	11	22	0	2	24	0	0
5	37913041	.	C	G	12	10	22	0	0	22	0	0
5	37913064	.	T	C	12	13	25	0	1	26	0	0
5	37918855	.	G	A	7	5	12	0	0	12	0	0
5	37918994	.	C	T	7	5	12	0	0	12	0	0
5	37926323	.	T	A	5	5	10	0	0	10	0	0
5	37933914	.	A	G	4	5	9	0	0	9	0	0
5	37933930	.	C	G	0	5	5	0	3	8	0	0
5	37934005	.	C	T	8	5	13	0	0	13	0	0
5	37934206	.	T	C	1	4	5	0	0	5	0	0
5	37963259	.	C	T	8	15	23	0	0	23	0	0
5	37963262	.	G	T	14	8	22	0	2	24	0	0
5	37963316	.	C	A	13	8	21	0	6	27	0	0
5	37963326	.	C	A	17	7	24	0	0	24	0	0
5	37968879	.	G	T	15	12	27	0	0	27	0	0
5	37968912	.	T	G	15	13	28	0	0	28	0	0
5	37968951	.	G	A	6	14	20	0	1	21	0	0
5	37968966	.	T	C	4	15	19	0	1	20	0	0
5	37970764	.	C	T	15	9	24	0	3	27	0	0
5	37970773	.	A	T	14	9	23	0	0	23	0	0
5	37970818	.	T	G	13	1	14	0	6	20	0	0
5	37981972	.	C	T	1	2	3	0	1	4	0	0
5	37982156	.	G	C	6	0	6	0	6	12	0	0
5	37987325	.	C	T	0	4	4	0	10	14	0	0
5	37987369	.	G	A	12	4	16	0	0	16	0	0
5	37989090	.	G	A	14	7	21	0	0	21	0	0
5	37989135	.	A	G	3	14	17	0	0	17	0	0
5	37989325	.	G	A	9	5	14	0	1	15	0	0
5	37989379	.	G	T	8	12	20	0	1	21	0	0
5	37989443	.	A	C	8	7	15	0	0	15	0	0
5	37989447	.	A	G	10	6	16	0	0	16	0	0
5	37991350	.	T	A	10	4	14	0	0	14	0	0
5	37991566	.	C	A	0	5	5	0	1	6	0	0
5	37991756	.	C	T	4	3	7	0	1	8	0	0
5	37991757	.	C	T	4	4	8	0	0	8	0	0
5	37993446	.	G	T	3	6	9	0	0	9	0	0
5	38089247	.	G	T	8	5	13	0	1	14	0	0
5	38089309	.	G	A	6	2	8	0	0	8	0	0
5	38089537	.	T	C	1	6	7	0	0	7	0	0
5	38089578	.	T	G	8	9	17	0	0	17	0	0
5	38089651	.	G	A	8	12	20	0	0	20	0	0
5	38089733	.	G	C	5	0	5	0	5	10	0	0
5	38089834	.	A	G	2	7	9	0	1	10	0	0
5	38089930	.	G	T	6	6	12	0	0	12	0	0
5	38090070	.	A	G	3	6	9	0	0	9	0	0
5	38090179	.	A	G	8	3	11	0	0	11	0	0
5	38090230	.	A	C	9	5	14	0	1	15	0	0
5	38090542	.	G	A	3	3	6	0	1	7	0	0
5	38090659	.	G	C	2	1	3	0	3	6	0	0
5	38090677	.	A	G	3	6	9	0	0	9	0	0
5	38090707	.	G	A	3	8	11	0	0	11	0	0
5	38090734	.	G	T	5	5	10	0	0	10	0	0
5	38091247	.	A	G	5	3	8	0	0	8	0	0
5	38091547	.	A	G	4	3	7	0	0	7	0	0
5	38091573	.	G	A	2	2	4	0	1	5	0	0
5	38097406	.	C	G	1	4	5	0	0	5	0	0
5	38097408	.	T	A	1	4	5	0	0	5	0	0
5	38100745	.	G	T	1	2	3	0	0	3	0	0
5	38100756	.	G	A	1	2	3	0	0	3	0	0
5	38100992	.	T	C	5	3	8	0	0	8	0	0
5	38101135	.	T	C	1	1	2	0	1	3	0	0
5	38101142	.	C	T	2	2	4	0	0	4	0	0
5	38101548	.	G	A	1	2	3	0	0	3	0	0
5	38101549	.	C	A	1	2	3	0	0	3	0	0
5	38101745	.	T	G	1	0	1	0	2	3	0	0
5	38104953	.	C	T	2	3	5	0	0	5	0	0
5	38104971	.	G	T	0	3	3	0	2	5	0	0
5	38106815	.	C	T	2	2	4	0	0	4	0	0
5	38110449	.	T	G	2	2	4	0	1	5	0	0
5	38110826	.	G	T	12	5	17	0	1	18	0	0
5	38110908	.	A	T	18	8	26	0	2	28	0	0
5	38111060	.	T	C	10	0	10	0	12	22	0	0
5	38115349	.	T	C	11	12	23	0	0	23	0	0
5	38115361	.	T	C	8	10	18	0	0	19	1	0
5	38115395	.	A	G	8	10	18	0	0	18	0	0
5	38115502	.	C	T	9	7	16	0	0	16	0	0
5	38115582	.	C	T	10	6	16	0	0	16	0	0
5	38115685	.	A	T	10	7	17	0	2	19	0	0
5	38115940	.	T	C	3	0	3	0	4	7	0	0
5	38120116	.	A	G	7	2	9	0	0	9	0	0
5	38120117	.	C	A	7	2	9	0	0	9	0	0
5	38120162	.	T	C	6	4	10	0	0	10	0	0
5	38121914	.	T	A	12	7	19	0	0	19	0	0
5	38121942	.	A	G	9	4	13	0	0	13	0	0
5	38121991	.	A	T	8	4	12	0	0	12	0	0
5	38121993	.	T	C	9	4	13	0	0	13	0	0
5	38122100	.	C	A	15	3	18	0	2	20	0	0
5	38122112	.	T	A	12	4	16	0	1	17	0	0
5	38206476	.	C	T	1	2	3	0	0	3	0	0
5	38206485	.	G	T	0	2	2	0	1	3	0	0
5	38214258	.	A	G	3	3	6	0	0	6	0	0
5	38216344	.	G	A	4	3	7	0	0	7	0	0
5	38216469	.	C	A	3	3	6	0	1	7	0	0
5	38216471	.	C	T	0	4	4	0	2	6	0	0
5	38216661	.	G	A	1	3	4	0	0	4	0	0
5	38217224	.	G	A	5	2	7	0	0	7	0	0
5	38217376	.	T	C	5	2	7	0	0	7	0	0
5	38217422	.	G	T	3	5	8	0	0	8	0	0
5	38218105	.	A	T	3	2	5	0	0	5	0	0
5	38241345	.	A	G	4	2	6	0	0	6	0	0
5	38251506	.	C	T	0	5	5	0	6	11	0	0
5	38251968	.	T	G	6	7	13	0	1	14	0	0
5	38252113	.	G	C	1	3	4	0	0	4	0	0
5	38254734	.	A	G	1	8	9	0	0	9	0	0
5	38254919	.	A	G	1	6	7	0	1	8	0	0
5	38254958	.	C	T	0	4	4	0	2	6	0	0
5	38255108	.	G	T	3	9	12	0	0	12	0	0
5	38255132	.	G	A	3	8	11	0	0	11	0	0
5	38255219	.	A	C	9	0	9	0	3	12	0	0
5	38263384	.	G	A	13	21	34	0	0	34	0	0
5	38263611	.	G	A	21	15	36	0	0	36	0	0
5	38263870	.	C	T	18	20	38	0	0	38	0	0
5	38281540	.	G	C	1	27	28	0	9	37	0	0
5	38287103	.	C	T	21	18	39	0	1	40	0	0
5	38288313	.	T	A	15	15	30	0	0	30	0	0
5	38288346	.	T	A	14	22	36	0	0	36	0	0
5	38289358	.	A	C	14	19	33	0	3	36	0	0
5	38296192	.	C	T	22	26	48	0	1	49	0	0
5	38296193	.	A	G	23	26	49	0	1	50	0	0
5	38296475	.	G	A	16	20	36	0	5	41	0	0
5	38296765	.	A	C	14	17	31	0	2	33	0	0
5	38296799	.	A	C	17	24	41	0	3	44	0	0
5	38297305	.	A	G	25	1	26	0	23	49	0	0
5	38301916	.	C	T	0	2	2	0	1	3	0	0
5	38302085	.	G	A	11	11	22	0	2	24	0	0
5	38302158	.	C	A	15	13	28	0	2	30	0	0
5	38302159	.	A	C	21	6	27	0	3	30	0	0
5	38302490	.	A	G	18	23	41	0	2	43	0	0
5	38302589	.	T	A	28	23	51	0	0	51	0	0
5	38302753	.	G	T	24	24	48	0	4	52	0	0
5	38302859	.	C	T	27	19	46	0	0	46	0	0
5	38302911	.	A	T	20	9	29	0	3	32	0	0
5	38303028	.	G	T	16	27	43	0	1	44	0	0
5	38303301	.	T	C	12	0	12	2	18	32	0	0
5	38303895	.	A	T	21	23	44	0	0	44	0	0
5	38303896	.	G	A	21	23	44	0	0	44	0	0
5	38304578	.	C	T	20	21	41	0	3	44	0	0
5	38304633	.	T	G	22	17	39	0	0	39	0	0
5	38304768	.	G	A	18	26	44	1	5	50	0	0
5	38305068	.	G	A	24	23	47	0	0	47	0	0
5	38305127	.	T	C	19	16	35	0	2	40	3	0
5	38305493	.	C	T	6	14	20	0	2	22	0	0
5	38305698	.	G	A	21	7	28	0	2	30	0	0
5	38308378	.	C	A	19	19	38	0	2	40	0	0
5	38314069	.	C	T	14	9	23	0	2	25	0	0
5	38320825	.	A	G	12	19	31	0	1	32	0	0
5	38324453	.	C	T	12	15	27	0	1	28	0	0
5	38349956	.	A	G	13	10	23	0	0	23	0	0
5	38363132	.	T	C	11	1	12	0	10	22	0	0
5	38369850	.	C	T	9	5	14	0	1	15	0	0
5	38388741	.	C	A	5	4	9	0	0	9	0	0
5	38388875	.	C	G	1	5	6	0	0	6	0	0
5	38389087	.	C	G	9	4	13	0	0	13	0	0
5	38389089	.	G	A	8	4	12	0	0	12	0	0
5	38389147	.	T	C	7	3	10	0	1	11	0	0
5	38389165	.	G	T	8	5	13	0	0	13	0	0
5	38389441	.	A	T	1	4	5	0	0	5	0	0
5	38389538	.	G	A	7	3	10	0	0	10	0	0
5	38389641	.	G	A	2	4	6	0	0	6	0	0
5	38389642	.	G	T	2	4	6	0	0	6	0	0
5	38389811	.	C	T	1	3	4	0	0	4	0	0
5	38390114	.	A	T	1	1	2	0	1	3	0	0
5	38390158	.	T	C	2	5	7	0	0	7	0	0
5	38390162	.	C	T	0	5	5	0	2	7	0	0
5	38390323	.	C	A	2	2	4	0	1	5	0	0
5	38390352	.	A	G	3	3	6	0	0	6	0	0
5	38390635	.	T	C	5	0	5	0	4	9	0	0
5	38390640	.	T	C	3	5	8	0	0	8	0	0
5	38390672	.	C	T	6	5	11	0	2	13	0	0
5	38390728	.	C	T	4	2	6	0	1	7	0	0
5	38390959	.	G	A	3	3	6	0	0	6	0	0
5	38391622	.	T	G	2	4	6	0	0	6	0	0
5	38401395	.	A	G	4	2	6	0	0	6	0	0
5	38475953	.	C	G	4	9	13	0	1	14	0	0
5	38476185	.	C	T	3	5	8	0	0	8	0	0
5	38476750	.	C	A	7	11	18	0	0	18	0	0
5	38506785	.	T	G	2	4	6	4	0	10	0	0
5	38531848	.	T	A	9	3	12	0	0	12	0	0
5	38532216	.	A	T	6	5	11	0	0	11	0	0
5	38532462	.	T	C	13	0	13	0	12	25	0	0
5	38532535	.	A	G	14	9	23	0	0	23	0	0
5	38533170	.	A	G	10	8	18	0	0	18	0	0
5	38533248	.	G	A	6	6	12	0	2	14	0	0
5	38533296	.	T	G	9	10	19	0	0	19	0	0
5	38533392	.	G	T	13	8	21	0	2	23	0	0
5	38533404	.	C	T	0	10	10	0	13	23	0	0
5	38533464	.	A	G	13	8	21	0	0	21	0	0
5	38533551	.	A	G	4	9	13	0	0	13	0	0
5	38604964	.	T	A	1	5	6	0	0	6	0	0
5	38605058	.	C	A	4	3	7	0	0	7	0	0
5	38605094	.	C	T	10	6	16	0	0	16	0	0
5	38605164	.	C	T	7	4	11	0	0	11	0	0
5	38605201	.	A	C	6	4	10	0	0	10	0	0
5	38605291	.	G	C	17	4	21	1	2	24	0	0
5	38611096	.	G	T	18	9	27	0	0	27	0	0
5	38611108	.	T	C	18	0	18	0	7	25	0	0
5	38726961	.	A	T	2	2	4	0	0	4	0	0
5	38745925	.	C	T	1	4	5	0	0	5	0	0
5	38745962	.	A	T	1	2	3	0	1	4	0	0
5	38747264	.	A	G	1	3	4	0	0	4	0	0
5	38749767	.	C	T	5	4	9	0	0	9	0	0
5	38749814	.	G	A	4	4	8	0	0	8	0	0
5	38749939	.	C	A	1	4	5	0	0	5	0	0
5	38750125	.	A	G	2	0	2	0	2	4	0	0
5	38750127	.	T	A	2	2	4	0	0	4	0	0
5	38750354	.	T	G	2	2	4	0	0	4	0	0
5	38750408	.	T	C	3	2	5	0	0	5	0	0
5	38750410	.	G	A	0	2	2	0	3	5	0	0
5	38786720	.	T	C	2	0	2	0	4	6	0	0
5	38786808	.	C	T	5	2	7	0	1	8	0	0
5	38786823	.	G	A	5	2	7	0	1	8	0	0
5	38786922	.	T	C	6	6	12	0	1	13	0	0
5	38787107	.	G	T	2	1	3	0	1	4	0	0
5	38803214	.	G	A	2	2	4	0	0	4	0	0
5	38824361	.	A	G	3	4	7	0	0	7	0	0
5	38827340	.	T	A	3	5	8	0	0	8	0	0
5	38831573	.	A	G	7	5	12	0	2	14	0	0
5	39055104	.	T	C	1	2	3	0	0	3	0	0
5	39061917	.	T	C	6	2	8	0	0	8	0	0
5	39061992	.	C	T	1	2	3	0	0	3	0	0
5	39067289	.	T	C	4	3	7	0	0	7	0	0
5	39081359	.	C	G	7	0	7	0	5	12	0	0
5	39082734	.	T	A	2	2	4	0	0	4	0	0
5	39082830	.	T	C	1	1	2	0	1	3	0	0
5	39082833	.	C	T	1	2	3	0	0	3	0	0
5	39083116	.	T	C	3	2	5	0	0	5	0	0
5	39083125	.	G	A	3	3	6	0	0	6	0	0
5	39084712	.	T	G	1	2	3	0	0	3	0	0
5	39085302	.	T	A	1	2	3	0	0	3	0	0
5	39085328	.	C	T	1	3	4	0	0	4	0	0
5	39085976	.	C	T	4	7	11	0	0	11	0	0
5	39086295	.	T	A	4	3	7	0	0	7	0	0
5	39124314	.	C	T	8	7	15	0	0	15	0	0
5	39136032	.	G	A	7	12	19	0	0	19	0	0
5	39142657	.	A	G	13	0	13	0	8	21	0	0
5	39142677	.	A	T	12	6	18	0	0	18	0	0
5	39143310	.	C	T	5	7	12	0	1	13	0	0
5	39143447	.	C	T	5	4	9	0	1	10	0	0
5	39150608	.	C	A	3	2	5	0	1	6	0	0
5	39150623	.	C	T	2	2	4	0	0	4	0	0
5	39150701	.	G	A	0	3	3	0	3	6	0	0
5	39150758	.	C	A	3	4	7	0	1	8	0	0
5	39150803	.	T	C	4	2	6	0	0	6	0	0
5	39151045	.	A	T	3	6	9	0	1	10	0	0
5	39151493	.	G	A	0	4	4	0	1	5	0	0
5	39151637	.	C	G	2	0	2	0	5	7	0	0
5	39152411	.	C	T	3	6	9	0	1	10	0	0
5	39152582	.	A	G	2	6	8	0	4	12	0	0
5	39152613	.	T	A	1	6	7	0	0	7	0	0
5	39154714	.	A	C	9	0	9	0	3	12	0	0
5	39154819	.	C	G	7	7	14	0	1	15	0	0
5	39154829	.	G	T	6	12	18	0	2	20	0	0
5	39154919	.	A	G	12	10	22	0	0	22	0	0
5	39154958	.	C	G	8	11	19	0	0	19	0	0
5	39154979	.	C	T	1	13	14	0	5	19	0	0
5	39155006	.	T	A	5	7	12	0	1	13	0	0
5	39155044	.	A	G	3	9	12	0	0	12	0	0
5	39155146	.	T	A	4	1	5	0	0	5	0	0
5	39155419	.	C	T	5	4	9	0	0	9	0	0
5	39155511	.	A	G	5	5	10	0	0	10	0	0
5	39160584	.	G	A	11	5	16	0	0	16	0	0
5	39169387	.	T	C	3	0	3	0	4	7	0	0
5	39388407	.	A	T	2	3	5	0	0	5	0	0
5	39504271	.	G	C	5	5	10	0	1	11	0	0
5	39504307	.	C	A	7	7	14	0	3	17	0	0
5	39508009	.	C	T	20	19	39	0	0	39	0	0
5	39508059	.	T	A	18	15	33	0	0	33	0	0
5	39508540	.	G	A	0	8	8	1	8	17	0	0
5	39670239	.	A	G	2	0	2	0	4	6	0	0
5	39707758	.	A	C	5	8	13	0	2	15	0	0
5	39707825	.	G	A	6	5	11	0	0	11	0	0
5	39708046	.	A	G	10	10	20	0	1	21	0	0
5	39712557	.	T	C	13	15	28	0	1	29	0	0
5	39714917	.	T	C	14	12	26	0	0	26	0	0
5	39715249	.	G	A	14	14	28	0	2	30	0	0
5	39730511	.	A	G	8	13	21	0	0	21	0	0
5	39730575	.	C	T	9	6	15	0	0	15	0	0
5	39730713	.	T	C	10	6	16	0	0	16	0	0
5	39730785	.	A	G	11	7	18	0	0	18	0	0
5	39731805	.	T	C	11	10	21	0	0	21	0	0
5	39736279	.	C	T	3	12	15	0	0	15	0	0
5	39805398	.	T	C	1	0	1	0	3	4	0	0
5	40003053	.	G	A	0	5	5	0	4	9	0	0
5	40003650	.	C	T	5	5	10	0	2	12	0	0
5	40012989	.	G	A	4	4	8	0	2	10	0	0
5	40024831	.	C	T	1	5	6	0	8	14	0	0
5	40052933	.	A	G	7	28	35	0	0	35	0	0
5	40054407	.	C	G	15	20	35	0	2	37	0	0
5	40059722	.	C	G	27	21	48	0	1	49	0	0
5	40059761	.	T	C	27	19	46	0	0	46	0	0
5	40062351	.	A	G	12	16	28	0	1	29	0	0
5	40062390	.	G	A	20	12	32	0	0	32	0	0
5	40071745	.	C	T	15	6	21	0	0	21	0	0
5	40077300	.	G	A	9	8	17	0	1	18	0	0
5	40078717	.	C	A	17	9	26	0	0	26	0	0
5	40080885	.	G	A	10	9	19	0	1	20	0	0
5	40093858	.	G	A	6	4	10	0	0	10	0	0
5	40095602	.	C	T	1	8	9	0	5	14	0	0
5	40097502	.	A	G	8	5	13	0	0	13	0	0
5	40097505	.	A	G	9	5	14	0	0	14	0	0
5	40097831	.	A	G	8	5	13	0	0	13	0	0
5	40111613	.	G	T	7	3	10	0	0	10	0	0
5	40203540	.	G	A	11	7	18	0	0	18	0	0
5	40206117	.	G	A	9	9	18	0	0	18	0	0
5	40206358	.	A	C	4	10	14	0	0	14	0	0
5	40210379	.	A	C	4	6	10	0	0	10	0	0
5	40273166	.	C	A	5	4	9	0	0	9	0	0
5	40273606	.	C	T	0	6	6	0	4	10	0	0
5	40273727	.	T	A	9	5	14	0	0	14	0	0
5	40273864	.	G	A	3	5	8	0	1	9	0	0
5	40505124	.	C	T	3	3	6	0	0	6	0	0
5	40506837	.	A	G	2	2	4	0	1	5	0	0
5	40507577	.	C	A	3	6	9	0	0	9	0	0
5	40508436	.	T	C	4	0	4	0	3	7	0	0
5	40510347	.	T	G	2	3	5	0	1	6	0	0
5	40728852	.	A	G	2	5	7	0	0	7	0	0
5	40729081	.	A	C	4	5	9	0	2	11	0	0
5	40729147	.	T	C	2	4	6	0	0	6	0	0
5	40729408	.	G	A	13	7	20	0	0	20	0	0
5	40729618	.	A	G	10	4	14	0	1	15	0	0
5	40732293	.	A	G	7	4	11	0	0	11	0	0
5	40732341	.	T	A	6	4	10	0	0	10	0	0
5	40845312	.	A	G	8	9	17	0	0	17	0	0
5	40845344	.	G	C	7	4	11	0	0	11	0	0
5	40845387	.	A	G	5	9	14	0	0	14	0	0
5	40845389	.	A	T	5	8	13	0	1	14	0	0
5	40845433	.	A	G	3	6	9	0	0	9	0	0
5	40845434	.	G	A	3	6	9	0	0	9	0	0
5	40845505	.	G	C	5	0	5	0	10	15	0	0
5	40845556	.	C	A	8	11	19	0	1	20	0	0
5	40845893	.	A	G	8	5	13	0	0	13	0	0
5	40846122	.	G	A	11	10	21	0	0	21	0	0
5	40856738	.	T	G	2	5	7	0	0	7	0	0
5	40857564	.	C	T	3	6	9	0	0	9	0	0
5	40865309	.	C	T	0	3	3	0	4	7	0	0
5	40877058	.	T	C	3	7	10	0	0	10	0	0
5	40910613	.	A	T	7	3	10	0	0	10	0	0
5	40910770	.	A	G	1	4	5	0	1	6	0	0
5	40910833	.	T	A	1	6	7	0	0	7	0	0
5	40935003	.	C	T	2	3	5	0	0	5	0	0
5	40951489	.	C	T	2	2	4	0	0	4	0	0
5	40952550	.	A	T	2	3	5	0	0	5	0	0
5	40952563	.	G	T	1	3	4	0	0	4	0	0
5	40953178	.	G	T	2	2	4	0	0	4	0	0
5	40953232	.	G	C	2	4	6	0	0	6	0	0
5	41082921	.	C	G	12	8	20	0	0	20	0	0
5	41082951	.	A	C	8	0	8	0	10	18	0	0
5	41083000	.	C	A	10	11	21	0	0	21	0	0
5	41083001	.	T	C	8	0	8	0	12	20	0	0
5	41083118	.	C	T	0	3	3	0	9	12	0	0
5	41083227	.	A	G	6	9	15	0	0	15	0	0
5	41083763	.	A	G	8	10	18	0	1	19	0	0
5	41084063	.	G	C	12	7	19	0	0	19	0	0
5	41084274	.	A	G	16	13	29	0	2	31	0	0
5	41084367	.	C	A	0	13	13	0	8	21	0	0
5	41085118	.	A	G	8	5	13	0	0	13	0	0
5	41085414	.	T	A	5	6	11	0	1	12	0	0
5	41085511	.	C	T	0	6	6	0	2	8	0	0
5	41085571	.	T	C	4	0	4	0	6	10	0	0
5	41085582	.	C	T	4	5	9	0	2	11	0	0
5	41086082	.	T	G	6	5	11	0	2	13	0	0
5	41086195	.	A	T	7	5	12	0	0	12	0	0
5	41103286	.	T	C	7	9	16	0	4	20	0	0
5	41103462	.	A	G	13	8	21	0	1	22	0	0
5	41103469	.	G	A	13	12	25	0	0	25	0	0
5	41105709	.	T	C	5	2	7	0	0	7	0	0
5	41105714	.	T	C	3	3	6	0	1	7	0	0
5	41106535	.	G	A	3	2	5	0	0	5	0	0
5	41106540	.	A	G	4	2	6	0	0	6	0	0
5	41106602	.	C	T	3	2	5	0	0	5	0	0
5	41125097	.	C	T	7	2	9	0	0	9	0	0
5	41125229	.	G	T	11	6	17	0	0	17	0	0
5	41125310	.	A	C	21	22	43	0	0	44	1	0
5	41125311	.	A	C	21	21	42	0	2	44	0	0
5	41125354	.	C	A	23	19	42	0	1	43	0	0
5	41125996	.	T	C	28	19	47	0	1	48	0	0
5	41126059	.	G	A	24	22	46	0	0	46	0	0
5	41127078	.	A	G	19	19	38	0	3	41	0	0
5	41127111	.	T	C	19	24	43	0	1	44	0	0
5	41127132	.	C	T	20	20	40	0	1	41	0	0
5	41128808	.	T	G	20	23	43	0	0	43	0	0
5	41133401	.	A	T	24	16	40	0	2	42	0	0
5	41134921	.	A	T	10	17	27	0	0	27	0	0
5	41134942	.	A	G	13	15	28	0	0	28	0	0
5	41135002	.	A	G	18	24	42	0	1	43	0	0
5	41137311	.	G	A	24	14	38	0	6	44	0	0
5	41137341	.	G	A	30	9	39	0	3	42	0	0
5	41138377	.	C	T	32	12	44	0	6	50	0	0
5	41138720	.	T	C	21	20	41	0	0	41	0	0
5	41138738	.	A	G	21	14	35	0	1	36	0	0
5	41138756	.	C	A	17	21	38	0	1	39	0	0
5	41138807	.	T	C	18	0	18	0	23	41	0	0
5	41146801	.	G	A	30	22	52	0	0	52	0	0
5	41150615	.	C	T	19	20	39	1	0	40	0	0
5	41150898	.	T	A	24	18	42	0	2	44	0	0
5	41150979	.	A	C	19	23	42	0	0	42	0	0
5	41151265	.	G	A	8	7	15	0	2	17	0	0
5	41260717	.	G	T	3	4	7	0	1	8	0	0
5	41260937	.	C	T	12	6	18	0	0	18	0	0
5	41261032	.	A	G	6	6	12	0	0	12	0	0
5	41261680	.	A	G	3	6	9	0	0	9	0	0
5	41261684	.	G	A	2	6	8	0	1	9	0	0
5	41261901	.	G	C	2	5	7	0	0	7	0	0
5	41261907	.	G	A	1	5	6	0	0	6	0	0
5	41271673	.	A	G	1	3	4	0	0	4	0	0
5	41286949	.	G	A	1	4	5	0	0	5	0	0
5	41286973	.	G	T	2	4	6	0	0	6	0	0
5	41307456	.	C	T	2	2	4	0	0	4	0	0
5	41307487	.	A	G	3	4	7	0	0	7	0	0
5	41478237	.	G	A	4	3	7	0	2	9	0	0
5	41478264	.	A	G	4	0	4	0	5	9	0	0
5	41478349	.	C	T	3	3	6	0	0	6	0	0
5	41478382	.	T	C	5	6	11	0	0	11	0	0
5	41481405	.	A	G	10	11	21	0	1	22	0	0
5	41481991	.	C	T	3	4	7	0	0	7	0	0
5	41481996	.	C	T	4	3	7	0	1	8	0	0
5	41482098	.	T	C	4	3	7	0	1	8	0	0
5	41484391	.	A	C	12	10	22	0	0	22	0	0
5	41484460	.	T	C	14	10	24	0	0	24	0	0
5	41484496	.	T	C	12	7	19	0	1	20	0	0
5	41484680	.	C	T	10	3	13	0	0	13	0	0
5	41484797	.	C	A	7	10	17	0	1	18	0	0
5	41485363	.	C	G	9	16	25	0	6	31	0	0
5	41485365	.	A	G	10	19	29	0	2	31	0	0
5	41485497	.	C	G	15	17	32	0	1	33	0	0
5	41485533	.	C	T	5	21	26	0	21	47	0	0
5	41485709	.	A	T	28	29	57	0	4	61	0	0
5	41485814	.	A	T	31	31	62	0	0	62	0	0
5	41486025	.	A	G	31	25	56	0	5	61	0	0
5	41486031	.	T	G	35	24	59	0	2	61	0	0
5	41486803	.	G	A	26	31	57	0	1	58	0	0
5	41486890	.	C	T	32	28	60	0	2	62	0	0
5	41488903	.	A	G	28	25	53	0	1	54	0	0
5	41489487	.	G	T	30	28	58	0	4	62	0	0
5	41489493	.	C	T	30	28	58	0	6	64	0	0
5	41489748	.	T	C	24	30	54	0	0	54	0	0
5	41492135	.	C	T	19	25	44	0	1	45	0	0
5	41492183	.	C	T	4	21	25	0	21	46	0	0
5	41492234	.	G	A	22	17	39	0	4	43	0	0
5	41492279	.	G	A	37	16	53	0	1	54	0	0
5	41492901	.	G	A	24	26	50	0	1	51	0	0
5	41492934	.	A	G	25	23	48	0	0	48	0	0
5	41496647	.	A	T	1	2	3	0	0	3	0	0
5	41500553	.	A	T	1	2	3	0	0	3	0	0
5	41501561	.	T	C	2	2	4	0	0	4	0	0
5	41503549	.	C	T	2	2	4	0	0	4	0	0
5	41508900	.	C	G	2	3	5	0	0	5	0	0
5	41509073	.	T	G	1	2	3	0	0	3	0	0
5	41509101	.	C	T	1	2	3	0	0	3	0	0
5	41513013	.	T	C	11	16	27	0	3	30	0	0
5	41514127	.	A	G	12	13	25	0	0	25	0	0
5	41516322	.	A	C	14	19	33	0	1	34	0	0
5	41516521	.	G	A	11	16	27	0	1	28	0	0
5	41518836	.	T	C	20	23	43	0	1	44	0	0
5	41519423	.	A	C	28	24	52	1	2	55	0	0
5	41519459	.	T	C	22	25	47	1	2	50	0	0
5	41520822	.	A	T	17	16	33	0	3	36	0	0
5	41520823	.	T	C	17	16	33	0	3	36	0	0
5	41520886	.	G	A	10	4	14	0	0	14	0	0
5	41523272	.	G	C	2	2	4	0	0	4	0	0
5	41582736	.	G	A	7	2	9	0	0	9	0	0
5	41585126	.	C	T	11	4	15	0	0	15	0	0
5	41585186	.	G	A	4	4	8	0	1	9	0	0
5	41594919	.	G	T	5	2	7	0	0	7	0	0
5	41595242	.	C	T	4	3	7	0	0	7	0	0
5	41595243	.	T	C	3	3	6	0	0	6	0	0
5	41597384	.	C	T	1	2	3	0	1	4	0	0
5	41597659	.	G	T	1	3	4	0	1	5	0	0
5	41597740	.	A	G	4	3	7	0	0	7	0	0
5	41600769	.	G	T	2	3	5	0	0	5	0	0
5	41617159	.	C	T	1	2	3	0	0	3	0	0
5	41617163	.	G	A	0	2	2	0	0	2	0	0
5	41622364	.	G	A	1	4	5	0	0	5	0	0
5	41633085	.	C	A	1	2	3	0	0	3	0	0
5	41633093	.	A	C	1	2	3	0	0	3	0	0
5	41633418	.	C	T	1	2	3	0	0	3	0	0
5	41634467	.	T	C	4	4	8	0	0	8	0	0
5	41637701	.	G	C	3	0	3	0	2	5	0	0
5	41639787	.	A	T	5	2	7	0	0	7	0	0
5	41639814	.	A	G	6	4	10	0	0	10	0	0
5	41639874	.	G	T	7	2	9	0	0	9	0	0
5	41641750	.	G	A	12	8	20	0	1	21	0	0
5	41641835	.	G	C	13	8	21	0	0	21	0	0
5	41641887	.	A	G	12	9	21	0	1	22	0	0
5	41642167	.	A	G	4	6	10	0	0	10	0	0
5	41642348	.	G	A	5	6	11	0	0	11	0	0
5	41643084	.	A	G	4	5	9	0	0	9	0	0
5	41643095	.	A	G	2	4	6	0	0	6	0	0
5	41643359	.	G	A	2	4	6	0	0	6	0	0
5	41645652	.	A	G	12	19	31	0	0	31	0	0
5	41645982	.	A	G	25	10	35	0	3	38	0	0
5	41650451	.	T	C	18	2	20	0	11	31	0	0
5	41655134	.	G	A	15	12	27	0	0	27	0	0
5	41655155	.	T	A	14	12	26	0	0	26	0	0
5	41670193	.	G	A	4	4	8	0	0	8	0	0
5	41675669	.	T	C	4	3	7	0	0	7	0	0
5	41676855	.	T	C	7	4	11	0	0	11	0	0
5	41684870	.	A	G	3	6	9	0	0	9	0	0
5	41684885	.	A	T	4	5	9	0	0	9	0	0
5	41689439	.	T	G	4	5	9	0	0	9	0	0
5	41691606	.	A	G	9	6	15	0	0	15	0	0
5	41705757	.	A	G	4	3	7	0	0	7	0	0
5	41878612	.	A	C	10	3	13	0	2	15	0	0
5	41878711	.	C	T	0	9	9	0	15	24	0	0
5	41878965	.	G	C	4	7	11	0	2	13	0	0
5	41879465	.	C	G	12	10	22	0	0	22	0	0
5	41879497	.	T	C	6	7	13	0	1	14	0	0
5	41879848	.	C	A	9	3	12	0	0	12	0	0
5	41880240	.	T	C	16	0	16	0	13	29	0	0
5	41880243	.	T	C	15	0	15	0	14	29	0	0
5	41880280	.	C	G	16	20	36	0	1	37	0	0
5	41880288	.	G	A	16	20	36	0	0	36	0	0
5	41882364	.	T	C	8	13	21	0	6	27	0	0
5	41888132	.	T	C	14	0	14	0	15	29	0	0
5	41890054	.	G	A	14	15	29	0	1	30	0	0
5	41890092	.	A	G	12	14	26	0	0	26	0	0
5	41890277	.	T	G	2	3	5	0	1	6	0	0
5	41891324	.	T	C	2	0	2	0	8	10	0	0
5	41898424	.	A	G	11	15	26	0	1	27	0	0
5	41899006	.	C	G	0	7	7	0	5	12	0	0
5	41899015	.	C	T	1	6	7	0	5	12	0	0
5	41900012	.	A	C	8	3	11	0	0	11	0	0
5	41900020	.	A	G	8	3	11	0	0	11	0	0
5	41900126	.	G	T	4	9	13	0	0	13	0	0
5	41900153	.	T	C	2	1	3	0	12	15	0	0
5	41900604	.	C	T	3	6	9	0	0	9	0	0
5	41901020	.	A	G	2	9	11	0	0	11	0	0
5	41901093	.	T	C	5	7	12	0	0	12	0	0
5	41914620	.	C	T	2	6	8	0	0	8	0	0
5	41914784	.	A	G	2	5	7	0	1	8	0	0
5	41915295	.	G	T	2	3	5	0	0	5	0	0
5	41917306	.	A	G	4	5	9	0	0	9	0	0
5	41917426	.	C	T	9	8	17	0	0	17	0	0
5	41917501	.	G	A	6	9	15	0	0	15	0	0
5	41917544	.	C	T	4	7	11	0	1	12	0	0
5	41917615	.	G	A	2	4	6	0	0	6	0	0
5	41917631	.	C	A	3	5	8	0	0	8	0	0
5	41917678	.	T	A	3	4	7	0	1	8	0	0
5	41932185	.	C	T	0	6	6	0	1	7	0	0
5	41960208	.	A	G	3	6	9	0	0	9	0	0
5	41974556	.	C	A	0	9	9	0	3	12	0	0
5	41975971	.	T	A	5	4	9	0	0	9	0	0
5	41984305	.	A	G	5	7	12	0	0	12	0	0
5	41996202	.	C	A	6	2	8	1	0	9	0	0
5	41997098	.	T	C	3	5	8	0	0	8	0	0
5	41997144	.	G	A	2	4	6	0	0	6	0	0
5	41997146	.	A	T	2	4	6	0	0	6	0	0
5	41997446	.	C	A	5	3	8	0	1	9	0	0
5	42028963	.	C	A	10	3	13	0	0	13	0	0
5	42028974	.	C	T	6	4	10	0	1	11	0	0
5	42053465	.	G	C	8	5	13	0	0	13	0	0
5	42053985	.	C	A	4	4	8	0	0	8	0	0
5	42064204	.	T	G	7	8	15	0	0	15	0	0
5	42066958	.	C	T	17	17	34	7	1	42	0	0
5	42067486	.	T	C	14	9	23	8	3	34	0	0
5	42094464	.	C	A	1	5	6	0	0	6	0	0
5	42122907	.	C	T	11	8	19	0	2	21	0	0
5	42122914	.	C	T	13	8	21	0	1	22	0	0
5	42123023	.	C	T	22	8	30	0	0	30	0	0
5	42123125	.	C	T	22	15	37	0	5	42	0	0
5	42123375	.	C	A	15	11	26	0	3	29	0	0
5	42123664	.	A	G	19	14	33	0	0	33	0	0
5	42123697	.	G	C	21	15	36	0	2	39	1	0
5	42123766	.	G	T	12	9	21	0	2	23	0	0
5	43872573	.	C	T	2	2	4	0	0	4	0	0
5	44795297	.	A	G	10	0	10	0	10	20	0	0
5	44795308	.	A	G	10	8	18	1	3	22	0	0
5	45141069	.	C	T	6	2	8	0	1	9	0	0
5	45141075	.	T	A	4	2	6	0	2	8	0	0
5	45183345	.	C	T	3	2	5	0	0	5	0	0
5	45183470	.	G	A	8	6	14	0	0	14	0	0
5	45204118	.	C	T	6	8	14	0	0	14	0	0
5	45204971	.	A	G	6	6	12	0	0	12	0	0
5	45224048	.	C	T	11	13	24	0	1	25	0	0
5	45224396	.	A	G	8	8	16	0	0	16	0	0
5	45230659	.	C	A	9	4	13	0	0	13	0	0
5	45261926	.	C	T	17	8	25	0	1	26	0	0
5	45269380	.	A	G	11	11	22	0	1	23	0	0
5	45269386	.	A	G	14	13	27	0	1	28	0	0
5	45272009	.	A	G	15	0	15	0	25	40	0	0
5	45272056	.	C	T	22	21	43	0	0	43	0	0
5	45272068	.	G	A	22	16	38	0	1	39	0	0
5	45274486	.	C	T	18	11	29	0	2	31	0	0
5	45282910	.	G	A	4	10	14	1	0	15	0	0
5	45283046	.	G	T	4	4	8	0	0	8	0	0
5	45283117	.	A	C	4	8	12	0	0	12	0	0
5	45283165	.	C	T	4	8	12	0	0	12	0	0
5	45283274	.	T	C	12	11	23	0	1	24	0	0
5	45283284	.	T	C	12	13	25	0	0	25	0	0
5	45283365	.	G	A	9	9	18	0	0	18	0	0
5	45283645	.	C	T	13	8	21	0	0	21	0	0
5	45613282	.	A	G	5	4	9	0	0	9	0	0
5	45613465	.	G	T	3	3	6	0	0	6	0	0
5	45747118	.	G	T	2	6	8	0	0	8	0	0
5	45747455	.	C	T	17	16	33	0	0	33	0	0
5	45747475	.	C	T	3	12	15	0	10	25	0	0
5	45747647	.	A	G	15	13	28	0	2	30	0	0
5	45747845	.	C	A	8	6	14	0	0	14	0	0
5	45747924	.	A	T	13	12	25	0	0	25	0	0
5	45748172	.	T	A	5	3	8	1	1	10	0	0
5	45748339	.	T	G	24	15	39	0	1	40	0	0
5	45748726	.	A	C	13	0	13	0	15	28	0	0
5	45751208	.	C	T	2	15	17	0	17	34	0	0
5	45754818	.	C	T	9	15	24	0	0	24	0	0
5	45754851	.	A	G	7	20	27	0	0	27	0	0
5	45754899	.	G	A	11	15	26	0	1	27	0	0
5	45757617	.	A	G	10	11	21	0	1	22	0	0
5	45757731	.	A	G	6	15	21	0	1	22	0	0
5	45762709	.	A	G	12	15	27	0	2	29	0	0
5	45762892	.	A	G	5	10	15	0	0	15	0	0
5	45769800	.	C	G	2	2	4	0	0	4	0	0
5	45771930	.	G	A	3	9	12	0	0	12	0	0
5	45772014	.	T	C	5	5	10	0	0	10	0	0
5	45781837	.	G	A	11	4	15	0	0	15	0	0
5	45890036	.	A	T	8	8	16	0	0	16	0	0
5	45890086	.	A	T	8	8	16	0	0	16	0	0
5	45890087	.	A	T	8	8	16	0	0	16	0	0
5	45890159	.	A	G	2	8	10	0	0	10	0	0
5	45890195	.	A	G	6	10	16	0	1	17	0	0
5	45890219	.	A	T	9	9	18	0	1	19	0	0
5	45890625	.	C	T	19	8	27	0	1	28	0	0
5	45890908	.	C	T	2	9	11	0	10	21	0	0
5	45890915	.	C	T	11	9	20	0	0	20	0	0
5	45891074	.	A	G	8	4	12	0	0	12	0	0
5	45891090	.	A	G	11	4	15	0	0	15	0	0
5	45891147	.	T	A	11	5	16	0	0	16	0	0
5	45891226	.	T	A	18	8	26	0	0	26	0	0
5	45891327	.	G	T	14	13	27	0	1	28	0	0
5	45892671	.	C	A	10	14	24	0	0	24	0	0
5	45894699	.	C	T	15	10	25	0	3	28	0	0
5	45894720	.	T	C	17	14	31	0	0	31	0	0
5	45894737	.	T	C	16	15	31	0	1	32	0	0
5	45908225	.	T	C	1	5	6	0	0	6	0	0
5	45908261	.	A	G	2	2	4	0	0	4	0	0
5	45910370	.	A	G	3	0	3	0	7	10	0	0
5	45941003	.	G	A	1	1	2	0	0	2	0	0
5	45941013	.	A	C	0	2	2	0	1	3	0	0
5	45990216	.	C	T	5	2	7	0	0	7	0	0
5	45990252	.	C	T	4	4	8	0	1	9	0	0
5	45990372	.	G	A	5	6	11	0	0	11	0	0
5	45990426	.	C	T	1	5	6	0	0	6	0	0
5	46056557	.	T	C	1	1	2	0	1	3	0	0
5	46064330	.	G	T	3	2	5	0	0	5	0	0
5	46209051	.	G	T	3	7	10	0	2	12	0	0
5	46242156	.	C	T	5	4	9	0	1	10	0	0
5	46327798	.	G	T	8	8	16	0	1	17	0	0
5	46328476	.	T	C	9	0	9	0	8	17	0	0
5	46328611	.	C	T	7	6	13	0	2	15	0	0
5	46329750	.	C	G	1	8	9	0	8	17	0	0
5	46490958	.	T	A	1	3	4	0	0	4	0	0
5	46491059	.	C	G	3	4	7	0	0	7	0	0
5	46491074	.	G	A	5	3	8	0	0	8	0	0
5	46491329	.	T	C	1	2	3	0	0	3	0	0
5	46492347	.	G	C	2	2	4	0	0	4	0	0
5	46492354	.	C	T	0	2	2	0	1	3	0	0
5	46659285	.	T	G	24	11	35	1	1	37	0	0
5	46659401	.	A	G	14	26	40	0	0	40	0	0
5	46659666	.	T	A	34	17	51	0	1	52	0	0
5	46659707	.	C	A	24	28	52	0	3	55	0	0
5	46659861	.	G	A	13	22	35	0	7	42	0	0
5	46659950	.	C	T	17	26	43	0	2	45	0	0
5	46659985	.	A	G	33	16	49	0	2	51	0	0
5	46660068	.	C	T	22	17	39	0	2	41	0	0
5	46660116	.	C	T	20	21	41	0	0	41	0	0
5	46660120	.	A	G	21	16	37	0	3	40	0	0
5	46660162	.	C	G	21	21	42	0	3	45	0	0
5	46660600	.	T	A	28	9	37	2	0	39	0	0
5	46660672	.	G	A	28	13	41	1	0	42	0	0
5	46660940	.	G	A	24	23	47	1	2	50	0	0
5	46660941	.	A	T	23	24	47	1	2	50	0	0
5	46661073	.	G	A	14	18	32	0	0	32	0	0
5	46661168	.	T	A	11	10	21	0	1	22	0	0
5	46661213	.	A	G	10	11	21	0	3	24	0	0
5	46661240	.	A	G	10	14	24	0	1	25	0	0
5	46661423	.	T	C	25	0	25	0	24	49	0	0
5	46661519	.	C	T	17	23	40	0	1	41	0	0
5	46661678	.	T	A	13	7	20	0	1	21	0	0
5	46662184	.	G	T	4	2	6	0	1	7	0	0
5	46662271	.	A	G	11	11	22	0	1	23	0	0
5	46662316	.	A	G	15	10	25	0	2	27	0	0
5	46685872	.	A	G	16	16	32	0	1	33	0	0
5	46724854	.	G	A	22	14	36	0	1	37	0	0
5	46724893	.	G	T	19	16	35	1	1	37	0	0
5	47727760	.	C	T	1	13	14	0	28	42	0	0
5	47862923	.	C	T	2	2	4	0	0	4	0	0
5	47862988	.	C	T	3	2	5	0	1	6	0	0
5	47863190	.	G	C	3	3	6	0	0	6	0	0
5	47932096	.	T	C	3	2	5	0	0	5	0	0
5	47949989	.	A	G	4	0	4	0	7	11	0	0
5	47949992	.	G	A	8	5	13	0	0	13	0	0
5	47950082	.	A	C	2	8	10	0	0	10	0	0
5	47950862	.	C	T	3	5	8	0	0	8	0	0
5	47953562	.	G	A	4	2	6	0	0	6	0	0
5	47953721	.	A	G	3	0	3	0	2	5	0	0
5	47955833	.	C	A	6	3	9	0	0	9	0	0
5	47959994	.	C	A	1	4	5	0	0	5	0	0
5	47960283	.	T	A	1	2	3	0	0	3	0	0
5	47960284	.	G	A	1	2	3	0	0	3	0	0
5	47968970	.	C	T	4	11	15	0	2	17	0	0
5	47970622	.	A	G	2	2	4	0	0	4	0	0
5	47972770	.	T	C	2	0	2	0	2	4	0	0
5	47975285	.	A	T	3	2	5	0	0	5	0	0
5	47976525	.	C	T	1	5	6	0	1	7	0	0
5	47976728	.	C	G	4	7	11	0	1	12	0	0
5	47976747	.	C	A	5	9	14	0	0	14	0	0
5	47976827	.	A	G	4	4	8	0	1	9	0	0
5	48022757	.	T	C	3	4	7	0	1	8	0	0
5	48022826	.	G	A	0	2	2	0	3	5	0	0
5	48023044	.	C	T	4	3	7	0	0	7	0	0
5	48023209	.	C	T	3	2	5	0	0	5	0	0
5	48023263	.	A	G	2	2	4	0	0	4	0	0
5	48023264	.	A	G	2	2	4	0	0	4	0	0
5	48028338	.	C	A	8	3	11	0	0	11	0	0
5	48028406	.	A	C	9	11	20	0	0	20	0	0
5	48028435	.	G	T	8	11	19	0	0	19	0	0
5	48028508	.	T	C	12	6	18	0	0	18	0	0
5	48029633	.	C	A	3	7	10	0	0	10	0	0
5	48029667	.	G	A	4	4	8	0	0	8	0	0
5	48029720	.	T	G	4	3	7	0	0	8	1	0
5	48029732	.	C	T	0	6	6	0	3	9	0	0
5	48029793	.	C	T	10	6	16	0	1	17	0	0
5	48029805	.	A	C	9	6	15	0	0	15	0	0
5	48029828	.	A	T	8	3	11	0	0	11	0	0
5	48033995	.	T	C	3	3	6	0	1	7	0	0
5	48036243	.	C	T	4	3	7	0	0	7	0	0
5	48036246	.	G	C	4	3	7	0	0	7	0	0
5	48050510	.	C	A	2	4	6	0	0	6	0	0
5	48110331	.	G	A	4	8	12	0	0	12	0	0
5	48154436	.	G	A	19	20	39	0	1	40	0	0
5	48154456	.	T	A	21	17	38	0	2	40	0	0
5	48172446	.	C	A	2	7	9	1	9	19	0	0
5	48175482	.	T	G	2	1	3	0	1	4	0	0
5	48182087	.	A	G	7	2	9	0	1	10	0	0
5	48182550	.	A	T	4	6	10	0	1	11	0	0
5	48182725	.	T	C	10	10	20	0	0	20	0	0
5	48183577	.	C	T	3	10	13	0	19	32	0	0
5	48183579	.	A	G	18	12	30	0	2	32	0	0
5	48183628	.	T	C	15	1	16	0	17	33	0	0
5	48208539	.	G	A	14	5	19	0	1	20	0	0
5	48208572	.	G	A	5	9	14	0	1	15	0	0
5	48242529	.	T	G	5	7	12	0	2	14	0	0
5	48242610	.	G	A	12	9	21	0	0	21	0	0
5	48285619	.	C	T	6	7	13	0	0	13	0	0
5	48659834	.	G	A	1	2	3	0	0	3	0	0
5	48664229	.	T	C	4	5	9	0	0	9	0	0
5	48672925	.	A	T	3	2	5	0	0	5	0	0
5	48672970	.	G	A	7	2	9	0	0	9	0	0
5	48673501	.	A	G	8	11	19	0	1	20	0	0
5	48673639	.	C	A	1	4	5	0	6	11	0	0
5	48673720	.	A	G	4	5	9	0	0	9	0	0
5	48679320	.	A	G	7	4	11	0	0	11	0	0
5	48827974	.	G	A	2	1	3	0	0	3	0	0
5	48833078	.	C	T	2	2	4	0	0	4	0	0
5	48833105	.	C	T	1	3	4	0	0	4	0	0
5	48833303	.	G	A	3	2	5	0	0	5	0	0
5	48893880	.	G	A	2	4	6	0	0	6	0	0
5	48935915	.	C	T	5	4	9	0	0	9	0	0
5	48935981	.	C	T	4	4	8	0	0	8	0	0
5	48986109	.	G	A	9	10	19	0	1	20	0	0
5	48986405	.	T	A	14	11	25	2	3	30	0	0
5	48986410	.	G	T	19	12	31	2	0	33	0	0
5	48986565	.	A	G	16	17	33	0	2	35	0	0
5	48986626	.	A	T	12	21	33	0	1	34	0	0
5	48986939	.	C	T	24	11	35	1	0	36	0	0
5	48987007	.	A	T	21	12	33	0	2	35	0	0
5	48987199	.	C	T	16	7	23	0	5	28	0	0
5	48987356	.	G	T	11	20	31	0	1	32	0	0
5	48987920	.	T	C	18	12	30	0	2	32	0	0
5	48988051	.	C	T	1	18	19	0	18	37	0	0
5	48992401	.	T	C	16	1	17	0	10	27	0	0
5	48992972	.	C	T	1	6	7	0	17	24	0	0
5	48993345	.	T	C	10	12	22	0	2	24	0	0
5	48995559	.	A	T	14	11	25	0	1	26	0	0
5	48995613	.	A	G	16	9	25	0	2	27	0	0
5	48995637	.	A	T	21	13	34	0	0	34	0	0
5	48995860	.	A	G	16	4	20	0	0	20	0	0
5	48995884	.	G	A	22	8	30	0	0	30	0	0
5	48995945	.	G	A	12	8	20	0	0	20	0	0
5	49019451	.	G	A	2	5	7	0	0	7	0	0
5	49019456	.	G	A	2	5	7	0	0	7	0	0
5	49019528	.	T	C	3	5	8	0	0	8	0	0
5	49019744	.	A	T	2	4	6	1	0	7	0	0
5	49019746	.	C	A	1	4	5	1	1	7	0	0
5	49019821	.	T	A	3	3	6	0	0	6	0	0
5	49019935	.	T	C	1	2	3	0	0	3	0	0
5	49028707	.	G	T	2	3	5	0	0	5	0	0
5	49734581	.	C	T	6	10	16	0	0	16	0	0
5	49735022	.	G	T	4	5	9	0	1	10	0	0
5	49735135	.	C	A	4	4	8	0	1	9	0	0
5	49735169	.	A	T	5	4	9	0	0	9	0	0
5	49735453	.	T	C	4	4	8	0	0	8	0	0
5	49735942	.	T	G	8	8	16	0	2	18	0	0
5	49743020	.	A	T	7	8	15	0	0	15	0	0
5	49745130	.	T	A	5	6	11	0	0	11	0	0
5	49747271	.	G	T	2	12	14	0	21	35	0	0
5	49750765	.	C	T	20	13	33	0	2	35	0	0
5	49750796	.	A	C	12	13	25	0	0	26	1	0
5	49768324	.	G	T	6	3	9	0	0	9	0	0
5	49768341	.	T	C	3	3	6	0	0	6	0	0
5	49768429	.	A	T	3	5	8	0	0	8	0	0
5	49768885	.	T	C	5	2	7	0	0	7	0	0
5	49769277	.	G	T	4	4	8	0	0	8	0	0
5	49769711	.	C	G	4	6	10	0	0	10	0	0
5	49769812	.	A	T	5	4	9	0	0	9	0	0
5	49919762	.	G	A	5	4	9	0	0	9	0	0
5	49919774	.	T	A	5	5	10	0	0	10	0	0
5	49919798	.	A	G	1	7	8	0	0	8	0	0
5	50035819	.	A	C	5	0	5	0	6	11	0	0
5	50038692	.	G	T	8	3	11	0	1	12	0	0
5	50038725	.	C	T	7	6	13	0	0	13	0	0
5	50081761	.	T	C	7	0	7	0	6	13	0	0
5	50253750	.	G	A	1	3	4	0	0	4	0	0
5	50253792	.	C	T	1	3	4	0	0	4	0	0
5	50256327	.	T	G	1	3	4	0	0	4	0	0
5	50344361	.	G	A	2	2	4	0	0	4	0	0
5	50344366	.	G	A	2	2	4	0	0	4	0	0
5	50344556	.	C	T	2	2	4	0	0	4	0	0
5	50435897	.	G	A	1	2	3	0	0	3	0	0
5	50436028	.	C	T	3	4	7	0	0	7	0	0
5	50436069	.	C	T	3	2	5	0	0	5	0	0
5	50436127	.	C	T	3	6	9	0	0	9	0	0
5	50436175	.	C	G	3	0	3	0	2	5	0	0
5	50443077	.	T	C	16	16	32	0	4	36	0	0
5	50443184	.	A	G	14	10	24	0	1	25	0	0
5	50443211	.	C	A	11	11	22	0	2	24	0	0
5	50443399	.	G	C	14	17	31	0	3	34	0	0
5	50443418	.	T	A	26	12	38	0	0	38	0	0
5	50443466	.	A	G	14	19	33	0	2	35	0	0
5	50443837	.	G	A	7	8	15	0	0	15	0	0
5	50443868	.	T	G	9	4	13	0	1	14	0	0
5	50465188	.	C	T	2	10	12	0	9	21	0	0
5	50465649	.	G	A	5	14	19	0	1	20	0	0
5	50520009	.	G	A	6	11	17	0	1	18	0	0
5	50544227	.	G	A	6	4	10	0	1	11	0	0
5	50544281	.	T	C	4	5	9	0	0	9	0	0
5	50576699	.	G	A	2	12	14	0	0	14	0	0
5	50582271	.	G	A	5	7	12	0	0	12	0	0
5	50582482	.	T	G	5	5	10	0	1	11	0	0
5	50594268	.	C	T	0	8	8	0	6	14	0	0
5	50594298	.	G	C	3	0	3	0	8	11	0	0
5	50636003	.	G	A	4	3	7	0	0	7	0	0
5	50636066	.	C	T	0	6	6	0	4	10	0	0
5	50781108	.	G	A	4	6	10	0	1	11	0	0
5	50781246	.	G	A	3	2	5	0	0	5	0	0
5	50817403	.	C	T	4	5	9	0	2	11	0	0
5	50817414	.	C	T	3	7	10	0	0	10	0	0
5	50819775	.	C	T	4	5	9	0	0	9	0	0
5	50819811	.	G	A	5	4	9	0	1	10	0	0
5	50820988	.	A	G	4	3	7	0	0	7	0	0
5	50828304	.	G	T	1	6	7	0	0	7	0	0
5	50831444	.	T	A	5	2	7	0	0	7	0	0
5	50839022	.	T	C	1	0	1	0	4	5	0	0
5	50843374	.	G	T	2	3	5	0	1	6	0	0
5	50843399	.	C	T	0	2	2	0	3	5	0	0
5	50843442	.	G	A	3	2	5	0	0	5	0	0
5	50844377	.	A	G	2	2	4	0	0	4	0	0
5	50846049	.	G	A	1	2	3	0	0	3	0	0
5	50848691	.	A	T	2	2	4	0	0	4	0	0
5	50848985	.	G	C	2	3	5	0	0	5	0	0
5	50859169	.	G	A	2	2	4	0	0	4	0	0
5	50862118	.	C	G	0	2	2	0	2	4	0	0
5	50862243	.	G	A	2	3	5	0	0	5	0	0
5	50867810	.	C	T	0	3	3	0	1	4	0	0
5	50869192	.	A	G	2	3	5	0	0	5	0	0
5	50869213	.	T	C	4	2	6	0	0	6	0	0
5	50869246	.	T	A	2	2	4	0	0	4	0	0
5	50869828	.	G	A	0	2	2	0	2	4	0	0
5	50869840	.	C	G	3	2	5	0	0	5	0	0
5	50872448	.	C	A	1	3	4	0	0	4	0	0
5	50872471	.	G	A	1	3	4	0	0	4	0	0
5	50874881	.	G	T	2	4	6	0	0	6	0	0
5	50879505	.	C	T	1	2	3	0	0	3	0	0
5	50881136	.	T	C	1	4	5	0	1	6	0	0
5	50886309	.	C	T	6	5	11	0	0	11	0	0
5	50889675	.	T	G	4	6	10	0	0	10	0	0
5	50889714	.	G	A	6	4	10	0	1	11	0	0
5	50892968	.	T	A	4	3	7	0	0	7	0	0
5	50893082	.	A	G	9	0	9	0	12	21	0	0
5	50895330	.	A	C	4	7	11	0	1	12	0	0
5	50895544	.	C	T	2	6	8	0	0	8	0	0
5	50895606	.	C	T	3	3	6	0	1	7	0	0
5	50897465	.	G	T	1	4	5	0	4	9	0	0
5	50897528	.	C	A	2	2	4	0	0	4	0	0
5	50897630	.	A	G	1	2	3	0	0	3	0	0
5	50897719	.	G	A	2	4	6	0	0	6	0	0
5	50958575	.	C	T	7	2	9	0	0	9	0	0
5	50958602	.	C	T	2	3	5	0	0	5	0	0
5	50960402	.	C	A	1	3	4	0	0	4	0	0
5	50960453	.	T	C	1	2	3	0	0	3	0	0
5	50964422	.	C	G	7	0	7	0	8	15	0	0
5	50969288	.	C	T	2	3	5	0	0	5	0	0
5	50973014	.	C	T	0	6	6	0	0	6	0	0
5	50973039	.	C	T	4	7	11	0	0	11	0	0
5	50973357	.	T	A	3	4	7	0	0	7	0	0
5	50973471	.	C	G	5	2	7	0	0	7	0	0
5	50973518	.	A	C	5	9	14	0	1	15	0	0
5	50973625	.	A	T	5	4	9	1	0	10	0	0
5	50973669	.	C	T	0	6	6	0	3	9	0	0
5	50973748	.	C	T	6	3	9	0	0	9	0	0
5	50978920	.	G	C	5	2	7	0	0	8	1	0
5	50981198	.	G	A	4	2	6	0	0	6	0	0
5	50981201	.	C	T	3	3	6	0	0	6	0	0
5	50983097	.	G	T	2	2	4	0	1	5	0	0
5	50983137	.	C	A	3	2	5	0	0	5	0	0
5	50988069	.	C	T	3	2	5	0	0	5	0	0
5	51089939	.	A	C	2	5	7	0	0	7	0	0
5	51096280	.	A	G	1	2	3	0	0	3	0	0
5	51096285	.	G	C	1	2	3	0	0	3	0	0
5	51096377	.	T	A	3	2	5	0	0	5	0	0
5	51102602	.	T	G	4	5	9	0	0	9	0	0
5	51102641	.	T	C	3	5	8	0	0	8	0	0
5	51102947	.	C	A	3	4	7	0	0	7	0	0
5	51103006	.	T	C	6	5	11	0	0	11	0	0
5	51103007	.	T	C	4	4	8	0	2	10	0	0
5	51103043	.	T	C	5	5	10	0	2	12	0	0
5	51103411	.	G	A	4	3	7	0	0	7	0	0
5	51103550	.	G	A	6	6	12	0	0	12	0	0
5	51103689	.	A	C	2	3	5	0	1	6	0	0
5	51103744	.	C	A	3	2	5	0	0	5	0	0
5	51103745	.	A	C	3	2	5	0	0	5	0	0
5	51103944	.	A	T	6	4	10	0	0	10	0	0
5	51104010	.	G	A	2	2	4	0	0	4	0	0
5	51104151	.	G	A	3	2	5	0	0	5	0	0
5	51104458	.	G	T	3	3	6	0	0	6	0	0
5	51113867	.	G	T	2	2	4	0	0	4	0	0
5	51121295	.	G	A	6	6	12	0	0	12	0	0
5	51124758	.	C	T	9	3	12	0	0	12	0	0
5	51124803	.	A	G	2	9	11	0	1	12	0	0
5	51127291	.	C	T	4	2	6	0	1	7	0	0
5	51127396	.	C	G	1	8	9	2	0	11	0	0
5	51169167	.	T	G	1	6	7	0	0	7	0	0
5	51169354	.	A	T	2	2	4	0	0	4	0	0
5	51169376	.	T	C	2	0	2	0	2	4	0	0
5	51169545	.	C	T	2	5	7	0	1	8	0	0
5	51169732	.	G	A	1	5	6	0	0	6	0	0
5	51169749	.	C	T	1	4	5	0	0	5	0	0
5	51170113	.	G	A	1	4	5	0	0	5	0	0
5	51170171	.	T	C	5	3	8	0	0	8	0	0
5	51170264	.	A	G	6	3	9	0	0	9	0	0
5	51170375	.	C	T	3	2	5	0	0	5	0	0
5	51170577	.	G	A	1	3	4	0	0	4	0	0
5	51170694	.	G	A	1	3	4	0	0	4	0	0
5	51171003	.	A	G	2	5	7	0	0	7	0	0
5	51200506	.	A	G	4	4	8	0	0	8	0	0
5	51200697	.	G	A	4	4	8	0	0	8	0	0
5	51202374	.	T	A	2	5	7	0	0	7	0	0
5	51202938	.	G	A	8	4	12	0	0	12	0	0
5	51203146	.	C	T	8	2	10	0	0	10	0	0
5	51205593	.	G	A	5	4	9	0	0	9	0	0
5	51227011	.	T	A	3	9	12	0	2	14	0	0
5	51227197	.	C	T	6	6	12	0	0	12	0	0
5	51228935	.	G	A	7	3	10	1	1	12	0	0
5	51230665	.	C	G	3	5	8	1	0	9	0	0
5	51230901	.	T	C	1	4	5	0	0	5	0	0
5	51236457	.	C	A	3	6	9	0	1	10	0	0
5	51236528	.	A	G	8	4	12	0	1	13	0	0
5	51240353	.	T	G	3	0	3	0	3	6	0	0
5	51240414	.	G	C	2	5	7	0	0	7	0	0
5	51240588	.	T	C	10	5	15	0	0	15	0	0
5	51240679	.	A	G	7	4	11	0	0	11	0	0
5	51240830	.	T	C	8	4	12	0	0	12	0	0
5	51241023	.	A	G	3	7	10	0	0	10	0	0
5	51241095	.	C	T	3	8	11	0	0	11	0	0
5	51241817	.	C	A	1	2	3	0	1	4	0	0
5	51242020	.	C	T	4	3	7	0	0	7	0	0
5	51242684	.	A	G	3	2	5	0	0	5	0	0
5	51242882	.	A	G	10	4	14	0	0	14	0	0
5	51243006	.	T	A	10	4	14	0	1	15	0	0
5	51243068	.	A	G	10	11	21	0	2	23	0	0
5	51243085	.	C	A	11	7	18	0	1	19	0	0
5	51243157	.	T	A	10	7	17	0	1	18	0	0
5	51243243	.	C	T	8	3	11	0	2	13	0	0
5	51243287	.	G	A	6	5	11	0	1	12	0	0
5	51243341	.	G	A	5	8	13	0	1	14	0	0
5	51243635	.	C	T	11	10	21	0	1	22	0	0
5	51243645	.	A	T	10	11	21	0	1	22	0	0
5	51243680	.	T	G	13	11	24	0	0	24	0	0
5	51243706	.	C	T	13	9	22	0	1	23	0	0
5	51334616	.	C	T	1	2	3	0	0	3	0	0
5	51438782	.	T	C	1	3	4	0	0	4	0	0
5	51440059	.	T	C	1	2	3	0	0	3	0	0
5	51443310	.	T	A	2	6	8	0	0	8	0	0
5	51515847	.	T	C	1	2	3	0	1	4	0	0
5	51521887	.	G	A	2	2	4	0	0	4	0	0
5	51525739	.	C	T	2	2	4	0	0	4	0	0
5	51535143	.	C	T	2	2	4	0	1	5	0	0
5	51546497	.	T	C	5	5	10	0	0	10	0	0
5	51546541	.	C	T	5	2	7	0	0	7	0	0
5	51548092	.	C	T	6	8	14	0	0	14	0	0
5	51548107	.	A	G	10	1	11	0	6	17	0	0
5	51559010	.	C	G	4	0	4	0	3	7	0	0
5	51575756	.	C	T	5	4	9	0	0	9	0	0
5	51578289	.	A	G	3	0	3	0	8	11	0	0
5	51578328	.	G	A	4	4	8	0	0	8	0	0
5	51579025	.	G	A	0	3	3	0	4	7	0	0
5	51579076	.	C	T	3	3	6	0	0	6	0	0
5	51616580	.	A	T	7	5	12	0	0	12	0	0
5	51616704	.	C	G	7	6	13	0	2	15	0	0
5	51616959	.	G	A	10	3	13	0	3	16	0	0
5	51747378	.	C	T	1	2	3	0	0	3	0	0
5	51775190	.	C	T	9	6	15	0	0	15	0	0
5	51775291	.	A	T	13	11	24	0	0	24	0	0
5	51775364	.	A	T	14	13	27	0	1	28	0	0
5	51775458	.	A	C	17	15	32	0	1	33	0	0
5	51775501	.	T	G	17	15	32	0	4	36	0	0
5	51775642	.	T	A	15	12	27	0	1	28	0	0
5	51775962	.	G	T	16	18	34	0	0	34	0	0
5	51776150	.	C	A	9	14	23	0	1	24	0	0
5	51779513	.	C	T	24	14	38	0	0	38	0	0
5	51789176	.	G	A	8	1	9	0	1	10	0	0
5	51789180	.	C	T	2	3	5	0	5	10	0	0
5	51792974	.	G	A	12	17	29	0	1	30	0	0
5	51834217	.	C	A	4	4	8	0	2	10	0	0
5	51835634	.	C	T	3	2	5	0	1	6	0	0
5	51836004	.	A	G	1	0	1	0	9	10	0	0
5	51836211	.	T	A	4	2	6	0	0	6	0	0
5	51840420	.	C	T	9	3	12	0	0	12	0	0
5	51840942	.	C	T	8	3	11	0	0	11	0	0
5	51846285	.	C	A	14	6	20	0	1	21	0	0
5	51847429	.	T	C	3	5	8	0	0	8	0	0
5	51847675	.	C	G	4	3	7	0	1	8	0	0
5	51886188	.	A	C	16	7	23	0	0	23	0	0
5	51894040	.	T	C	13	6	19	0	1	20	0	0
5	51898796	.	C	T	2	5	7	0	5	12	0	0
5	51898933	.	C	G	7	3	10	0	1	11	0	0
5	51902067	.	T	G	3	6	9	0	0	9	0	0
5	51902253	.	A	G	5	2	7	0	1	8	0	0
5	51947370	.	G	T	11	7	18	0	2	20	0	0
5	51947398	.	C	T	0	15	15	0	10	25	0	0
5	51947497	.	C	T	14	8	22	0	1	23	0	0
5	51947650	.	T	C	9	6	15	0	0	15	0	0
5	51947696	.	A	T	11	4	15	0	2	17	0	0
5	51947852	.	A	T	7	8	15	0	1	16	0	0
5	51947927	.	T	C	3	0	3	0	3	6	0	0
5	51947976	.	C	G	6	3	9	0	0	9	0	0
5	51948017	.	G	T	8	4	12	0	0	12	0	0
5	51948146	.	G	A	10	7	17	0	0	17	0	0
5	51948207	.	T	C	10	5	15	0	0	15	0	0
5	51948436	.	G	T	0	12	12	0	1	13	0	0
5	51948671	.	C	A	2	4	6	0	0	6	0	0
5	51948708	.	A	T	5	7	12	0	0	12	0	0
5	51948737	.	C	T	0	8	8	0	3	11	0	0
5	51948755	.	C	A	5	7	12	0	0	12	0	0
5	51948825	.	T	C	7	14	21	0	1	22	0	0
5	51948827	.	C	G	13	7	20	0	2	22	0	0
5	51948870	.	A	G	10	4	14	0	0	14	0	0
5	51949069	.	T	A	13	12	25	0	0	25	0	0
5	51949115	.	G	T	9	9	18	0	0	18	0	0
5	51949769	.	C	T	13	0	13	0	2	15	0	0
5	51950032	.	G	C	7	11	18	0	4	22	0	0
5	51950357	.	C	T	2	4	6	0	9	15	0	0
5	51960989	.	G	A	11	4	15	0	0	15	0	0
5	51961039	.	C	T	7	7	14	0	0	14	0	0
5	51968073	.	A	G	2	5	7	0	0	7	0	0
5	52002660	.	T	G	4	7	11	0	0	11	0	0
5	52002708	.	T	C	5	9	14	0	2	16	0	0
5	52002743	.	T	G	7	3	10	0	1	11	0	0
5	52005851	.	G	T	9	8	17	0	0	17	0	0
5	52005893	.	C	T	4	8	12	0	0	12	0	0
5	52010134	.	C	T	0	3	3	0	1	4	0	0
5	52039349	.	T	C	3	3	6	0	0	6	0	0
5	52039496	.	A	T	2	2	4	0	2	6	0	0
5	52068001	.	T	C	5	3	8	0	0	8	0	0
5	52068332	.	G	A	4	2	6	0	0	6	0	0
5	52121557	.	T	C	9	4	13	0	0	13	0	0
5	52121629	.	G	A	3	4	7	0	1	8	0	0
5	52121680	.	G	T	7	6	13	0	1	14	0	0
5	52121801	.	G	C	5	3	8	0	0	8	0	0
5	52122057	.	C	G	6	0	6	0	5	11	0	0
5	52122189	.	C	G	5	3	8	0	0	8	0	0
5	52122711	.	C	T	4	2	6	0	2	8	0	0
5	52122779	.	C	G	3	5	8	0	0	8	0	0
5	52123640	.	G	T	10	10	20	0	0	20	0	0
5	52124734	.	A	G	10	10	20	0	0	20	0	0
5	52132468	.	G	A	10	9	19	0	2	21	0	0
5	52132498	.	A	T	9	9	18	0	0	18	0	0
5	52132561	.	C	T	7	8	15	0	1	16	0	0
5	52132966	.	A	G	9	10	19	0	0	19	0	0
5	52190969	.	A	G	2	2	4	0	0	4	0	0
5	52191039	.	C	T	0	2	2	0	1	3	0	0
5	52191593	.	C	T	7	5	12	0	0	12	0	0
5	52191630	.	T	C	6	6	12	0	0	12	0	0
5	52192545	.	T	A	3	7	10	0	0	10	0	0
5	52192557	.	C	T	6	4	10	0	1	11	0	0
5	52192625	.	C	A	3	2	5	0	0	5	0	0
5	52193066	.	C	T	5	9	14	0	1	15	0	0
5	52193249	.	T	G	4	3	7	0	0	7	0	0
5	52193817	.	A	G	9	9	18	0	2	20	0	0
5	52197793	.	C	T	6	3	9	0	1	10	0	0
5	52198066	.	G	A	4	5	9	0	1	10	0	0
5	52199622	.	C	T	6	4	10	0	0	10	0	0
5	52201458	.	T	C	3	0	3	0	9	12	0	0
5	52211755	.	G	A	2	6	8	0	0	8	0	0
5	52215311	.	A	G	1	2	3	0	0	3	0	0
5	52215356	.	A	C	1	3	4	0	0	4	0	0
5	52215405	.	T	A	1	2	3	0	0	3	0	0
5	52226964	.	T	C	3	0	3	0	5	8	0	0
5	52227090	.	T	A	2	5	7	0	1	8	0	0
5	52227190	.	T	A	13	7	20	0	1	21	0	0
5	52227393	.	T	C	6	4	10	0	0	10	0	0
5	52227404	.	T	C	4	0	4	0	6	10	0	0
5	52227570	.	C	T	6	2	8	0	0	8	0	0
5	52234708	.	A	G	1	5	6	0	0	6	0	0
5	52235385	.	C	T	4	3	7	0	0	7	0	0
5	52236775	.	G	T	4	5	9	0	0	9	0	0
5	52237039	.	G	A	1	2	3	0	0	3	0	0
5	52237263	.	T	C	7	0	7	0	5	12	0	0
5	52237449	.	G	C	1	0	1	0	5	6	0	0
5	52240005	.	C	T	0	2	2	0	1	3	0	0
5	52240449	.	C	A	1	2	3	0	0	3	0	0
5	52242924	.	C	G	0	3	3	0	5	8	0	0
5	52257106	.	A	C	10	1	11	1	5	17	0	0
5	52257299	.	G	A	5	7	12	0	1	13	0	0
5	52257976	.	G	T	8	9	17	0	0	17	0	0
5	52258036	.	G	A	8	8	16	0	1	17	0	0
5	52258234	.	G	A	10	16	26	1	0	27	0	0
5	52258268	.	C	G	14	11	25	0	0	25	0	0
5	52258518	.	C	T	11	11	22	0	3	25	0	0
5	52258614	.	C	A	5	6	11	0	1	12	0	0
5	52258721	.	C	G	4	7	11	0	0	11	0	0
5	52258921	.	T	G	7	6	13	0	1	14	0	0
5	52259221	.	T	A	7	11	18	0	0	18	0	0
5	52259542	.	G	C	11	0	11	0	9	20	0	0
5	52259579	.	A	T	8	8	16	0	0	16	0	0
5	52259825	.	C	A	13	9	22	0	1	23	0	0
5	52264354	.	C	T	0	5	5	0	12	17	0	0
5	52264456	.	C	G	0	6	6	0	13	19	0	0
5	52264512	.	G	A	9	5	14	0	1	15	0	0
5	52264549	.	C	T	13	10	23	0	1	24	0	0
5	52264654	.	C	G	1	9	10	0	12	22	0	0
5	52264663	.	G	A	8	14	22	0	0	22	0	0
5	52277282	.	G	A	7	10	17	0	0	17	0	0
5	52277390	.	G	A	11	8	19	0	0	19	0	0
5	52277448	.	A	T	7	9	16	0	1	17	0	0
5	52277487	.	T	A	7	8	15	0	0	15	0	0
5	52277574	.	G	A	12	5	17	0	0	17	0	0
5	52512768	.	A	G	2	3	5	0	0	5	0	0
5	52598546	.	A	T	2	7	9	0	0	9	0	0
5	52598563	.	G	A	4	6	10	0	0	10	0	0
5	52608696	.	G	A	3	7	10	0	0	10	0	0
5	52617922	.	A	G	10	5	15	0	2	17	0	0
5	52696865	.	T	A	11	4	15	0	0	15	0	0
5	52697519	.	A	C	7	10	17	0	3	20	0	0
5	52698067	.	G	A	9	12	21	0	0	21	0	0
5	52710951	.	A	G	6	4	10	0	0	10	0	0
5	52710957	.	G	A	7	4	11	0	0	11	0	0
5	52725675	.	C	T	9	10	19	0	0	19	0	0
5	52730540	.	C	T	11	4	15	0	1	16	0	0
5	52730645	.	C	T	8	7	15	0	0	15	0	0
5	52730704	.	C	T	8	2	10	0	1	11	0	0
5	52730742	.	G	C	6	4	10	0	1	11	0	0
5	52730793	.	G	A	3	6	9	0	1	10	0	0
5	52730846	.	C	A	8	4	12	0	1	13	0	0
5	52731515	.	C	A	12	14	26	0	0	26	0	0
5	52731550	.	C	T	11	10	21	0	1	22	0	0
5	52731647	.	G	A	0	8	8	0	11	19	0	0
5	52731678	.	A	T	11	3	14	0	1	15	0	0
5	52731758	.	G	C	7	12	19	0	1	20	0	0
5	52731787	.	G	A	6	9	15	0	0	15	0	0
5	52731919	.	C	A	7	3	10	0	2	12	0	0
5	52732146	.	C	T	6	4	10	0	3	13	0	0
5	52732147	.	G	A	5	6	11	0	2	13	0	0
5	52732383	.	C	T	11	13	24	0	2	26	0	0
5	52732727	.	G	A	14	17	31	0	0	31	0	0
5	52732931	.	C	T	8	15	23	0	0	23	0	0
5	52732991	.	A	G	7	0	7	0	16	23	0	0
5	52733022	.	G	T	13	9	22	0	1	24	1	0
5	52733230	.	G	A	18	9	27	0	1	28	0	0
5	52733259	.	T	G	22	7	29	0	1	30	0	0
5	52733266	.	T	G	22	7	29	0	0	29	0	0
5	52733370	.	A	T	22	9	31	0	0	31	0	0
5	52733411	.	G	A	16	7	23	0	0	23	0	0
5	52745571	.	T	G	4	7	11	0	0	11	0	0
5	52748724	.	T	C	3	5	8	0	0	8	0	0
5	52751568	.	C	T	1	3	4	0	5	9	0	0
5	52751586	.	C	T	6	4	10	0	1	11	0	0
5	52752441	.	T	A	4	4	8	0	1	9	0	0
5	52752479	.	A	G	4	5	9	0	1	10	0	0
5	52783725	.	G	C	2	3	5	0	0	5	0	0
5	52783758	.	C	T	3	5	8	0	0	8	0	0
5	52845638	.	C	T	3	2	5	0	0	5	0	0
5	52855974	.	A	T	3	7	10	0	0	10	0	0
5	52858847	.	C	T	8	5	13	0	1	14	0	0
5	52858898	.	A	G	3	0	3	0	6	9	0	0
5	52859422	.	T	G	6	4	10	0	0	10	0	0
5	52859510	.	C	T	4	6	10	0	0	10	0	0
5	52859624	.	A	G	5	0	5	0	4	9	0	0
5	52859751	.	G	T	6	6	12	0	0	12	0	0
5	52860243	.	T	A	3	2	5	0	0	5	0	0
5	52860310	.	T	A	9	3	12	0	0	12	0	0
5	52860413	.	G	A	1	10	11	0	0	11	0	0
5	52860503	.	A	T	6	15	21	0	0	21	0	0
5	52860718	.	G	C	9	5	14	0	0	14	0	0
5	52860863	.	G	T	4	12	16	0	1	17	0	0
5	52860957	.	T	C	3	2	5	0	1	6	0	0
5	52861213	.	T	C	4	7	11	0	2	13	0	0
5	52861239	.	G	T	0	7	7	0	10	17	0	0
5	52861266	.	A	C	6	6	12	0	0	12	0	0
5	52861818	.	G	A	8	8	16	0	1	17	0	0
5	52937798	.	A	G	8	5	13	0	0	13	0	0
5	52937956	.	A	T	9	5	14	0	2	16	0	0
5	52937988	.	T	A	7	14	21	0	0	21	0	0
5	52938528	.	A	G	4	2	6	0	0	6	0	0
5	52938532	.	T	C	4	2	6	0	0	6	0	0
5	52938742	.	C	T	7	5	12	0	0	12	0	0
5	52938787	.	C	A	7	6	13	0	1	14	0	0
5	52962667	.	T	C	4	0	4	0	11	15	0	0
5	52971471	.	T	A	2	2	4	0	0	4	0	0
5	52971478	.	C	T	3	2	5	0	0	5	0	0
5	52972260	.	A	G	6	6	12	0	0	12	0	0
5	52972323	.	C	A	7	8	15	0	0	15	0	0
5	52988108	.	C	T	8	8	16	0	1	17	0	0
5	52988147	.	C	T	6	11	17	0	1	18	0	0
5	53003463	.	C	G	0	5	5	0	5	10	0	0
5	53003640	.	C	G	3	10	13	0	0	13	0	0
5	53003896	.	G	A	7	6	13	0	1	14	0	0
5	53003988	.	A	C	7	0	7	0	6	13	0	0
5	53009239	.	T	A	14	6	20	0	2	22	0	0
5	53041702	.	T	C	4	10	14	0	0	14	0	0
5	53734556	.	C	T	5	5	10	0	0	10	0	0
5	53748244	.	C	T	4	2	6	0	0	6	0	0
5	53748304	.	T	G	5	3	8	0	0	8	0	0
5	53759491	.	A	T	8	9	17	0	2	19	0	0
5	53763009	.	A	T	2	3	5	0	0	5	0	0
5	53876236	.	A	T	12	16	28	0	0	28	0	0
5	53876244	.	G	A	14	19	33	0	1	34	0	0
5	53899585	.	G	T	9	10	19	0	2	21	0	0
5	53908613	.	T	A	5	4	9	0	0	9	0	0
5	53908722	.	G	T	5	3	8	0	0	8	0	0
5	53908892	.	A	G	2	6	8	0	1	9	0	0
5	53908893	.	G	A	3	6	9	0	0	9	0	0
5	53908957	.	A	T	5	8	13	0	0	13	0	0
5	53909509	.	G	A	0	2	2	0	3	5	0	0
5	53910004	.	G	A	5	2	7	0	0	7	0	0
5	53913085	.	A	G	2	2	4	0	0	4	0	0
5	54280198	.	A	T	7	4	11	0	0	11	0	0
5	54280223	.	C	T	6	5	11	0	0	11	0	0
5	54280350	.	C	G	3	2	5	0	0	5	0	0
5	54280436	.	A	T	5	5	10	0	0	10	0	0
5	54280495	.	T	G	2	2	4	0	0	4	0	0
5	54280678	.	T	C	3	7	10	0	0	10	0	0
5	54280801	.	G	A	5	4	9	0	0	9	0	0
5	54280889	.	G	A	8	4	12	0	1	13	0	0
5	54290289	.	C	A	7	7	14	0	1	15	0	0
5	54293907	.	A	T	3	2	5	0	0	5	0	0
5	54297376	.	T	A	4	5	9	0	0	9	0	0
5	54297377	.	C	T	3	5	8	0	0	8	0	0
5	54297461	.	T	G	5	2	7	0	0	7	0	0
5	54297668	.	C	T	2	5	7	0	1	8	0	0
5	54304731	.	T	A	8	4	12	0	0	12	0	0
5	54304736	.	G	T	9	5	14	0	0	14	0	0
5	54305209	.	G	A	5	7	12	0	2	14	0	0
5	54309452	.	G	T	6	10	16	0	0	16	0	0
5	54337575	.	G	A	9	4	13	0	0	13	0	0
5	54337831	.	T	A	11	4	15	0	0	15	0	0
5	54337880	.	T	C	10	1	11	0	5	16	0	0
5	54337902	.	C	T	7	7	14	0	2	16	0	0
5	54337934	.	C	A	10	6	16	0	1	17	0	0
5	54339740	.	C	T	10	5	15	0	0	15	0	0
5	54340047	.	G	A	9	3	12	0	0	12	0	0
5	54342135	.	C	T	3	5	8	0	0	8	0	0
5	54395339	.	T	A	6	6	12	0	0	12	0	0
5	54416527	.	C	G	4	2	6	0	0	6	0	0
5	54416709	.	C	T	5	3	8	0	0	8	0	0
5	54416743	.	A	T	3	4	7	0	1	8	0	0
5	54416810	.	C	T	7	9	16	0	0	16	0	0
5	54416820	.	A	G	6	9	15	0	0	15	0	0
5	54445997	.	T	G	2	3	5	0	0	5	0	0
5	54458053	.	A	C	8	5	13	0	0	13	0	0
5	54458326	.	G	A	6	8	14	0	0	14	0	0
5	54458345	.	T	A	8	6	14	0	1	15	0	0
5	54458437	.	C	T	11	11	22	0	0	22	0	0
5	54458668	.	C	A	9	8	17	0	2	19	0	0
5	54458791	.	C	G	0	7	7	0	9	16	0	0
5	54458974	.	C	G	7	6	13	0	0	13	0	0
5	54459334	.	T	C	5	9	14	0	0	14	0	0
5	54459337	.	T	C	8	8	16	0	0	16	0	0
5	54459467	.	T	C	3	2	5	0	7	12	0	0
5	54459628	.	G	T	8	5	13	0	0	13	0	0
5	54459647	.	A	C	8	10	18	0	1	19	0	0
5	54459682	.	C	T	3	6	9	0	2	11	0	0
5	54459700	.	T	C	5	0	5	0	5	10	0	0
5	54459772	.	T	C	3	6	9	0	1	10	0	0
5	54460218	.	A	C	6	3	9	0	0	9	0	0
5	54460237	.	T	A	6	4	10	0	0	10	0	0
5	54460259	.	G	A	7	4	11	0	0	11	0	0
5	54460322	.	T	A	11	5	16	0	1	17	0	0
5	54460371	.	T	A	7	8	15	0	0	15	0	0
5	54460460	.	A	G	7	7	14	0	1	15	0	0
5	54460481	.	C	T	1	7	8	0	10	18	0	0
5	54460555	.	G	A	18	7	25	0	7	32	0	0
5	54460558	.	A	T	16	7	23	0	7	30	0	0
5	54467999	.	G	T	7	4	11	0	0	11	0	0
5	54470845	.	C	G	0	10	10	0	7	17	0	0
5	54471091	.	T	C	5	5	10	0	0	10	0	0
5	54473134	.	G	A	7	4	11	0	1	12	0	0
5	54482550	.	G	A	5	4	9	0	0	9	0	0
5	54482561	.	A	C	4	5	9	0	0	9	0	0
5	54482795	.	C	A	2	4	6	0	1	7	0	0
5	54482806	.	C	T	2	4	6	0	0	6	0	0
5	54482997	.	T	G	4	4	8	0	0	8	0	0
5	54492797	.	C	T	0	2	2	0	3	5	0	0
5	54492839	.	C	T	1	4	5	0	1	6	0	0
5	54495561	.	G	A	2	2	4	0	0	4	0	0
5	54497019	.	G	A	2	5	7	0	0	7	0	0
5	54497628	.	C	T	11	3	14	0	0	14	0	0
5	54498226	.	G	C	6	5	11	0	1	12	0	0
5	54498255	.	A	C	9	6	15	0	1	16	0	0
5	54498272	.	G	A	6	7	13	0	0	13	0	0
5	54498292	.	C	T	7	6	13	0	1	14	0	0
5	54498363	.	C	T	6	11	17	0	0	17	0	0
5	54498452	.	C	T	5	12	17	0	1	18	0	0
5	54501179	.	C	T	7	4	11	0	1	12	0	0
5	54501485	.	C	T	7	7	14	0	1	15	0	0
5	54501993	.	A	G	3	0	3	0	8	11	0	0
5	54502264	.	G	A	8	3	11	0	6	17	0	0
5	54502307	.	G	A	3	9	12	0	10	22	0	0
5	54502414	.	G	C	10	18	28	0	0	28	0	0
5	54502697	.	A	G	7	1	8	0	3	11	0	0
5	54541975	.	C	A	5	7	12	0	0	12	0	0
5	54557025	.	G	A	6	2	8	0	0	8	0	0
5	54558663	.	T	C	4	5	9	0	0	9	0	0
5	54558684	.	G	A	1	7	8	0	3	11	0	0
5	54558738	.	A	C	3	4	7	0	0	7	0	0
5	54558787	.	G	A	0	3	3	0	5	8	0	0
5	54564538	.	A	G	2	0	2	0	2	4	0	0
5	54564544	.	G	C	3	3	6	0	0	6	0	0
5	54564835	.	C	T	1	5	6	0	0	6	0	0
5	54565379	.	A	C	4	3	7	0	0	7	0	0
5	54572808	.	C	T	3	2	5	0	0	5	0	0
5	54572859	.	T	A	1	5	6	0	0	6	0	0
5	54576127	.	C	T	5	3	8	0	0	8	0	0
5	54576142	.	C	T	4	4	8	0	0	8	0	0
5	54576238	.	G	A	2	8	10	0	0	10	0	0
5	54579900	.	A	C	5	4	9	0	1	10	0	0
5	54579955	.	C	T	7	5	12	0	0	12	0	0
5	54580125	.	G	A	8	5	13	0	0	13	0	0
5	54586098	.	T	C	4	3	7	0	1	8	0	0
5	54602360	.	C	A	2	2	4	0	0	4	0	0
5	54608836	.	G	A	1	2	3	0	1	4	0	0
5	54610737	.	G	A	0	2	2	0	3	5	0	0
5	54618404	.	G	A	4	2	6	0	1	7	0	0
5	54628542	.	C	T	1	3	4	0	0	4	0	0
5	54628851	.	C	T	1	3	4	0	0	4	0	0
5	54652941	.	T	A	7	9	16	0	0	16	0	0
5	54652947	.	C	A	9	8	17	0	0	17	0	0
5	54656543	.	T	A	0	2	2	0	0	2	0	0
5	54656548	.	T	C	1	2	3	0	0	3	0	0
5	54656583	.	A	G	9	0	9	0	5	14	0	0
5	54656613	.	T	C	5	2	7	0	2	9	0	0
5	54685371	.	A	T	6	14	20	0	1	21	0	0
5	54685445	.	C	A	6	10	16	0	3	20	1	0
5	54719503	.	A	G	3	4	7	0	0	7	0	0
5	54719844	.	G	A	13	11	24	0	0	24	0	0
5	54720249	.	C	T	4	3	7	0	1	8	0	0
5	54724444	.	A	T	3	2	5	0	0	5	0	0
5	54724738	.	T	A	1	3	4	0	1	5	0	0
5	54726445	.	A	T	1	7	8	0	0	8	0	0
5	54767361	.	C	A	15	12	27	0	2	29	0	0
5	54767688	.	C	T	15	21	36	0	2	38	0	0
5	54767734	.	T	A	22	11	33	0	2	35	0	0
5	54768993	.	G	T	25	18	43	0	0	43	0	0
5	54769091	.	A	G	15	10	25	0	2	27	0	0
5	54769133	.	A	G	15	7	22	3	0	25	0	0
5	54769896	.	A	G	21	21	42	0	1	43	0	0
5	54769914	.	C	T	21	20	41	0	2	43	0	0
5	54770121	.	T	C	19	25	44	0	0	44	0	0
5	54770370	.	G	A	21	24	45	0	2	47	0	0
5	54770889	.	C	T	18	23	41	0	1	42	0	0
5	54772818	.	G	A	4	7	11	0	0	11	0	0
5	54772955	.	T	C	8	10	18	0	0	18	0	0
5	54773182	.	C	A	0	7	7	0	12	19	0	0
5	54776408	.	T	C	12	13	25	0	0	25	0	0
5	54776413	.	G	C	13	11	24	0	0	24	0	0
5	54778115	.	G	C	9	8	17	0	2	19	0	0
5	54778236	.	G	C	6	7	13	0	1	14	0	0
5	54790426	.	A	C	9	6	15	0	0	15	0	0
5	54790513	.	T	C	4	7	11	0	0	11	0	0
5	54790751	.	A	C	11	13	24	0	0	24	0	0
5	54790769	.	T	C	10	13	23	0	0	23	0	0
5	54790808	.	T	G	5	8	13	0	0	13	0	0
5	54792072	.	G	C	7	7	14	0	0	14	0	0
5	54958580	.	G	A	14	10	24	0	0	24	0	0
5	54961109	.	A	G	13	8	21	0	0	21	0	0
5	54964633	.	G	A	11	7	18	0	1	19	0	0
5	54965991	.	G	A	5	4	9	0	2	11	0	0
5	54966114	.	C	A	7	7	14	0	0	14	0	0
5	54967094	.	C	T	12	5	17	0	0	17	0	0
5	54971774	.	G	C	8	6	14	0	0	14	0	0
5	54974350	.	A	G	9	5	14	0	1	15	0	0
5	54977130	.	A	G	6	5	11	0	0	11	0	0
5	55160685	.	C	T	2	14	16	0	2	18	0	0
5	55165175	.	A	T	13	16	29	0	1	30	0	0
5	55168177	.	G	T	15	19	34	1	2	37	0	0
5	55371908	.	C	T	13	9	22	0	0	22	0	0
5	55372218	.	A	G	23	7	30	0	0	30	0	0
5	55372425	.	A	C	13	13	26	0	0	26	0	0
5	55372761	.	G	T	16	11	27	0	1	28	0	0
5	55372773	.	A	T	14	13	27	0	1	28	0	0
5	55373299	.	G	A	16	17	33	0	2	35	0	0
5	55373869	.	G	T	8	12	20	0	1	21	0	0
5	55374343	.	T	A	13	8	21	0	0	21	0	0
5	55374560	.	T	C	5	10	15	0	1	16	0	0
5	55588458	.	T	C	5	11	16	0	1	17	0	0
5	55588562	.	T	C	6	6	12	0	1	13	0	0
5	55599950	.	G	C	5	7	12	0	0	12	0	0
5	55600108	.	A	C	10	5	15	0	0	15	0	0
5	55600149	.	T	C	7	6	13	0	1	14	0	0
5	55600154	.	A	G	9	7	16	0	0	16	0	0
5	55604037	.	G	C	11	6	17	0	0	17	0	0
5	55604162	.	G	C	12	19	31	1	4	36	0	0
5	55604211	.	A	T	27	5	32	2	0	34	0	0
5	55604228	.	G	T	15	7	22	2	3	27	0	0
5	55604302	.	A	T	34	1	35	1	2	38	0	0
5	55604438	.	A	G	19	12	31	2	2	35	0	0
5	55609426	.	T	G	25	18	43	0	5	48	0	0
5	55613789	.	G	A	23	11	34	0	0	34	0	0
5	55613813	.	A	C	21	12	33	0	3	36	0	0
5	55613864	.	A	G	19	12	31	0	1	32	0	0
5	55613999	.	G	A	15	17	32	0	2	34	0	0
5	55626700	.	T	A	6	6	12	0	0	12	0	0
5	55648510	.	G	C	6	4	10	0	0	10	0	0
5	55669528	.	C	T	6	7	13	0	0	13	0	0
5	55686574	.	T	C	11	3	14	0	0	14	0	0
5	55689628	.	C	T	10	6	16	0	0	16	0	0
5	55720486	.	C	T	0	7	7	0	11	18	0	0
5	55723534	.	A	G	16	5	21	0	0	21	0	0
5	55763649	.	A	G	28	26	54	0	1	55	0	0
5	55763752	.	G	T	20	18	38	0	0	38	0	0
5	55763884	.	G	A	24	19	43	0	1	44	0	0
5	55764173	.	T	C	13	0	13	0	25	38	0	0
5	55764509	.	G	A	17	27	44	0	0	44	0	0
5	55773856	.	A	G	20	19	39	0	1	40	0	0
5	55873688	.	G	T	4	6	10	0	0	10	0	0
5	55873712	.	C	A	4	4	8	0	0	8	0	0
5	55876311	.	C	G	4	6	10	0	0	10	0	0
5	55876508	.	C	G	7	7	14	0	0	14	0	0
5	55876698	.	T	A	1	3	4	0	0	4	0	0
5	55895902	.	A	G	2	2	4	0	1	5	0	0
5	55921076	.	A	T	6	10	16	0	2	18	0	0
5	55921335	.	G	A	15	17	32	0	0	32	0	0
5	55921931	.	A	G	6	11	17	0	0	17	0	0
5	55928367	.	A	G	4	4	8	1	1	10	0	0
5	55933055	.	G	A	6	15	21	0	1	22	0	0
5	55933243	.	T	C	4	3	7	0	1	8	0	0
5	55936430	.	C	A	4	7	11	0	0	11	0	0
5	55951471	.	T	G	5	16	21	0	1	22	0	0
5	55951639	.	A	T	3	10	13	0	0	13	0	0
5	55951810	.	G	T	4	2	6	0	0	6	0	0
5	56100260	.	T	A	9	3	12	0	0	12	0	0
5	56110137	.	C	T	2	2	4	0	0	4	0	0
5	56111059	.	A	G	3	2	5	0	0	5	0	0
5	56113870	.	C	T	7	2	9	0	0	9	0	0
5	56113978	.	C	T	1	5	6	0	0	6	0	0
5	56271365	.	T	C	4	4	8	0	1	9	0	0
5	56271503	.	C	T	2	3	5	0	0	5	0	0
5	56271521	.	A	G	2	2	4	0	1	5	0	0
5	56272381	.	A	G	3	0	3	0	3	6	0	0
5	56273737	.	C	T	1	3	4	0	1	5	0	0
5	56274002	.	A	G	2	3	5	0	0	5	0	0
5	56277966	.	C	A	3	4	7	0	1	8	0	0
5	56277975	.	C	T	3	4	7	0	0	7	0	0
5	56280092	.	G	A	2	2	4	0	0	4	0	0
5	56308816	.	C	T	1	5	6	0	15	21	0	0
5	56309013	.	G	C	16	4	20	3	0	23	0	0
5	56309109	.	C	T	1	21	22	1	13	36	0	0
5	56309115	.	A	T	14	20	34	1	1	36	0	0
5	56309244	.	A	G	8	2	10	0	2	12	0	0
5	56309246	.	A	C	9	3	12	0	1	13	0	0
5	56309454	.	A	G	19	9	28	0	0	28	0	0
5	56309517	.	T	C	7	16	23	0	1	24	0	0
5	56309672	.	C	A	2	13	15	0	9	24	0	0
5	56309677	.	C	A	11	12	23	0	2	25	0	0
5	56309761	.	G	C	13	13	26	0	1	27	0	0
5	56309844	.	G	A	20	16	36	0	3	39	0	0
5	56313189	.	A	G	29	16	45	0	1	46	0	0
5	56313207	.	G	A	26	16	42	0	0	42	0	0
5	56317153	.	T	A	22	15	37	0	2	39	0	0
5	56317170	.	C	T	23	15	38	0	1	39	0	0
5	56317377	.	G	A	20	14	34	0	1	35	0	0
5	56322148	.	A	G	11	17	28	0	1	29	0	0
5	56322205	.	C	T	10	10	20	0	2	22	0	0
5	56322404	.	A	G	9	14	23	0	0	23	0	0
5	56322449	.	T	C	9	11	20	0	1	21	0	0
5	56322467	.	G	A	8	8	16	0	1	17	0	0
5	56322680	.	A	G	8	7	15	0	1	16	0	0
5	56326387	.	A	G	12	4	16	0	0	16	0	0
5	56340613	.	A	G	11	7	18	0	1	19	0	0
5	56343032	.	C	T	1	11	12	0	11	23	0	0
5	56343095	.	C	T	3	7	10	1	0	11	0	0
5	56345091	.	A	G	8	12	20	0	0	20	0	0
5	56345109	.	A	G	8	10	18	0	1	19	0	0
5	56345138	.	T	G	8	9	17	0	0	17	0	0
5	56345653	.	T	C	6	4	10	0	1	11	0	0
5	56355401	.	A	G	10	6	16	0	0	16	0	0
5	56362376	.	C	T	7	9	16	0	0	16	0	0
5	56364862	.	A	G	8	12	20	0	1	21	0	0
5	56364946	.	G	A	9	7	16	0	1	17	0	0
5	56364979	.	A	G	13	6	19	0	0	19	0	0
5	56364982	.	G	T	13	6	19	0	0	19	0	0
5	56375274	.	C	T	6	8	14	0	0	14	0	0
5	56375289	.	G	T	8	6	14	0	1	15	0	0
5	56376741	.	T	G	3	9	12	0	0	12	0	0
5	56378072	.	C	A	7	6	13	0	1	14	0	0
5	56383131	.	C	G	2	4	6	4	0	10	0	0
5	56390352	.	G	A	4	2	6	0	0	6	0	0
5	56405927	.	T	C	1	2	3	4	0	7	0	0
5	56412197	.	G	A	6	2	8	0	0	8	0	0
5	56412236	.	C	T	6	4	10	0	1	11	0	0
5	56416052	.	G	A	2	3	5	0	0	5	0	0
5	56915023	.	G	A	4	6	10	0	0	10	0	0
5	56918932	.	G	A	12	9	21	0	0	21	0	0
5	56918974	.	A	G	9	9	18	0	2	20	0	0
5	56920385	.	A	T	4	5	9	0	1	10	0	0
5	56921765	.	T	C	6	1	7	0	6	13	0	0
5	56924447	.	G	T	9	4	13	0	0	13	0	0
5	56924460	.	T	C	5	6	11	0	0	11	0	0
5	56927749	.	G	T	2	2	4	0	1	5	0	0
5	56927772	.	C	T	2	2	4	0	1	5	0	0
5	56927784	.	G	A	2	2	4	0	0	4	0	0
5	56934960	.	A	G	3	3	6	0	0	6	0	0
5	56935031	.	G	T	4	3	7	0	1	8	0	0
5	56939054	.	C	T	2	8	10	0	0	10	0	0
5	56939414	.	G	A	4	2	6	0	0	6	0	0
5	56939449	.	C	T	0	2	2	0	3	5	0	0
5	56942904	.	C	T	3	2	5	0	1	6	0	0
5	56943570	.	C	T	2	2	4	0	0	4	0	0
5	56947756	.	C	T	3	2	5	0	0	5	0	0
5	56951015	.	A	C	12	0	12	0	14	26	0	0
5	56951081	.	T	C	13	10	23	0	1	24	0	0
5	56951144	.	A	T	10	9	19	0	3	22	0	0
5	56951156	.	C	T	14	10	24	0	1	25	0	0
5	56951220	.	C	T	20	13	33	0	1	34	0	0
5	56951258	.	A	C	8	12	20	0	2	22	0	0
5	56958513	.	C	T	10	15	25	0	1	26	0	0
5	56964475	.	G	A	7	6	13	0	0	13	0	0
5	56992465	.	T	C	1	2	3	0	0	3	0	0
5	57210284	.	G	A	0	1	1	0	4	5	0	0
5	57210293	.	T	C	7	3	10	0	0	10	0	0
5	57217249	.	G	A	1	8	9	1	10	20	0	0
5	57217343	.	T	G	8	6	14	0	2	16	0	0
5	57217391	.	C	G	10	7	17	0	0	17	0	0
5	57219429	.	T	C	9	4	13	0	1	14	0	0
5	57219430	.	T	A	10	3	13	0	1	14	0	0
5	57219496	.	G	A	4	4	8	0	0	8	0	0
5	57219736	.	T	C	4	7	11	0	1	12	0	0
5	57219789	.	C	T	12	8	20	0	0	20	0	0
5	57219938	.	G	C	0	11	11	0	7	18	0	0
5	57219990	.	C	A	9	5	14	0	0	14	0	0
5	57220108	.	G	A	2	10	12	0	6	18	0	0
5	57220262	.	A	T	2	11	13	0	2	15	0	0
5	57225332	.	C	T	7	4	11	0	0	11	0	0
5	57225343	.	C	T	7	6	13	0	0	13	0	0
5	57225496	.	C	G	7	0	7	0	10	17	0	0
5	57226522	.	T	C	11	6	17	0	0	17	0	0
5	57320235	.	C	T	30	32	62	0	1	63	0	0
5	57320274	.	G	A	34	28	62	0	3	65	0	0
5	57325158	.	T	G	37	27	64	0	1	65	0	0
5	57325204	.	T	G	32	0	32	0	29	62	1	0
5	57325210	.	G	A	36	30	66	0	0	66	0	0
5	57325359	.	G	A	34	20	54	0	4	58	0	0
5	57340478	.	T	A	2	3	5	0	0	5	0	0
5	57350958	.	C	T	1	2	3	0	0	3	0	0
5	57351382	.	C	A	4	3	7	0	0	7	0	0
5	57351403	.	G	A	4	3	7	0	0	7	0	0
5	57353886	.	C	T	5	4	9	0	1	10	0	0
5	57353959	.	C	A	7	8	15	0	2	17	0	0
5	57353981	.	C	T	8	10	18	0	1	20	1	0
5	57354046	.	G	A	7	8	15	0	2	17	0	0
5	57354061	.	G	A	1	8	9	0	6	15	0	0
5	57354096	.	A	G	10	7	17	0	0	17	0	0
5	57354302	.	A	G	11	3	14	0	0	14	0	0
5	57354311	.	G	A	14	3	17	0	1	18	0	0
5	57354552	.	C	T	4	8	12	0	1	13	0	0
5	57354656	.	A	G	8	6	14	0	0	14	0	0
5	57354680	.	G	A	2	13	15	0	8	23	0	0
5	57354786	.	G	T	2	9	11	0	1	12	0	0
5	57354839	.	A	G	1	0	1	0	5	6	0	0
5	57359740	.	G	A	5	5	10	0	3	13	0	0
5	57359811	.	A	G	9	8	17	0	0	17	0	0
5	57361015	.	G	T	22	16	38	1	1	40	0	0
5	57442382	.	G	A	1	5	6	0	3	9	0	0
5	57442389	.	T	G	2	6	8	0	1	9	0	0
5	57446925	.	G	A	5	9	14	0	0	14	0	0
5	57448788	.	T	C	5	3	8	0	2	10	0	0
5	57449035	.	C	A	1	7	8	0	0	8	0	0
5	57450862	.	C	T	5	6	11	0	0	11	0	0
5	57450868	.	C	A	5	4	9	0	0	9	0	0
5	57450973	.	A	G	7	0	7	0	3	10	0	0
5	57453587	.	T	C	1	3	4	0	1	5	0	0
5	57453635	.	T	C	2	2	4	0	1	5	0	0
5	57483544	.	G	C	1	2	3	0	1	4	0	0
5	57489821	.	G	A	16	11	27	0	1	28	0	0
5	57499990	.	T	C	21	0	21	0	12	33	0	0
5	57500086	.	T	C	10	15	25	0	0	25	0	0
5	57505050	.	C	T	14	12	26	0	0	26	0	0
5	57506568	.	A	C	11	16	27	0	0	27	0	0
5	57514332	.	G	A	18	11	29	0	0	29	0	0
5	57514428	.	G	A	23	7	30	3	0	33	0	0
5	57641711	.	A	T	7	7	14	0	0	14	0	0
5	57641751	.	C	T	5	6	11	0	1	12	0	0
5	57641808	.	T	C	6	13	19	0	1	20	0	0
5	57641811	.	T	C	14	7	21	0	1	22	0	0
5	57641895	.	T	C	7	9	16	0	3	19	0	0
5	57643949	.	T	C	13	12	25	0	0	25	0	0
5	57644184	.	T	G	11	14	25	0	0	25	0	0
5	57644256	.	G	A	7	18	25	0	2	27	0	0
5	57644280	.	G	A	15	6	21	0	2	23	0	0
5	57644495	.	A	T	3	2	5	0	0	5	0	0
5	57644519	.	A	T	4	2	6	0	0	6	0	0
5	57644790	.	C	T	4	2	6	0	0	6	0	0
5	57645280	.	C	A	2	2	4	0	0	4	0	0
5	57645311	.	A	T	2	1	3	0	0	3	0	0
5	57645325	.	T	C	3	3	6	0	0	6	0	0
5	57645466	.	G	A	3	2	5	1	0	6	0	0
5	57650037	.	A	C	12	7	19	0	0	19	0	0
5	57650695	.	C	T	9	8	17	0	1	18	0	0
5	57650699	.	C	A	11	7	18	0	1	19	0	0
5	57650830	.	G	A	3	2	5	0	1	6	0	0
5	57693556	.	A	G	1	4	5	0	1	6	0	0
5	57693577	.	G	A	1	5	6	0	0	6	0	0
5	57693607	.	T	G	4	4	8	0	0	8	0	0
5	57693625	.	C	A	3	3	6	0	0	6	0	0
5	57693709	.	T	C	1	4	5	0	0	5	0	0
5	57693872	.	T	G	4	3	7	0	0	7	0	0
5	57693880	.	T	A	5	4	9	0	0	9	0	0
5	57693926	.	T	C	5	2	7	0	0	7	0	0
5	57699903	.	C	G	2	6	8	0	2	10	0	0
5	57699936	.	C	T	4	2	6	0	1	7	0	0
5	57704982	.	C	T	0	4	4	0	1	5	0	0
5	57711761	.	G	A	1	2	3	0	0	3	0	0
5	57715904	.	T	C	14	17	31	0	0	31	0	0
5	57716169	.	T	C	13	16	29	0	0	29	0	0
5	57718478	.	G	T	11	9	20	0	1	21	0	0
5	57718551	.	A	C	3	4	7	1	2	10	0	0
5	57718614	.	C	A	1	5	6	0	0	6	0	0
5	57718649	.	A	G	9	0	9	0	0	9	0	0
5	57718659	.	C	T	5	10	15	0	2	17	0	0
5	57726573	.	T	A	6	3	9	0	0	9	0	0
5	57734348	.	C	T	2	4	6	0	0	6	0	0
5	57734692	.	A	T	7	3	10	0	0	10	0	0
5	57737337	.	A	G	5	4	9	0	1	10	0	0
5	57737427	.	G	A	1	6	7	0	3	10	0	0
5	57737460	.	C	T	6	6	12	0	0	12	0	0
5	57737504	.	C	A	6	5	11	0	0	11	0	0
5	57737587	.	G	A	4	5	9	0	1	10	0	0
5	57737637	.	A	G	6	0	6	0	9	15	0	0
5	57737727	.	A	T	1	6	7	0	0	7	0	0
5	57737862	.	T	A	3	7	10	0	0	10	0	0
5	57737863	.	A	C	3	6	9	0	1	10	0	0
5	57738078	.	C	T	3	9	12	0	0	12	0	0
5	57738233	.	C	T	3	3	6	0	1	7	0	0
5	57738321	.	G	A	4	2	6	0	0	6	0	0
5	57743868	.	G	A	9	9	18	0	0	18	0	0
5	57743907	.	A	G	4	9	13	0	3	16	0	0
5	57744681	.	C	T	4	10	14	0	0	14	0	0
5	57744731	.	T	C	4	10	14	0	0	14	0	0
5	57747691	.	A	G	4	7	11	0	0	11	0	0
5	57750299	.	C	T	10	3	13	0	2	15	0	0
5	57750341	.	T	G	6	11	17	0	1	18	0	0
5	57751676	.	T	A	7	15	22	0	0	22	0	0
5	57753821	.	C	T	8	7	15	0	1	16	0	0
5	57753827	.	A	G	9	0	9	0	9	18	0	0
5	57762390	.	A	G	26	17	43	1	1	46	1	0
5	57762468	.	G	T	16	20	36	0	3	39	0	0
5	57762479	.	A	T	13	24	37	0	2	39	0	0
5	57762529	.	C	T	26	13	39	0	2	41	0	0
5	57762656	.	T	G	14	18	32	0	0	32	0	0
5	57762849	.	A	T	7	13	20	0	0	20	0	0
5	57762868	.	A	G	8	11	19	0	0	19	0	0
5	57762900	.	T	C	10	11	21	0	1	22	0	0
5	57762938	.	A	T	20	11	31	0	0	32	1	0
5	57762986	.	C	G	19	8	27	0	1	28	0	0
5	57777906	.	C	G	20	0	20	0	13	33	0	0
5	57787630	.	C	T	30	26	56	0	6	62	0	0
5	57790313	.	G	A	32	23	55	0	1	56	0	0
5	57790583	.	G	A	28	29	57	0	2	59	0	0
5	57797085	.	A	C	18	34	52	0	6	59	1	0
5	57797770	.	T	C	38	25	63	0	2	65	0	0
5	57797774	.	T	C	42	26	68	0	0	68	0	0
5	57797844	.	C	T	20	34	54	2	12	68	0	0
5	57797887	.	A	T	15	32	47	0	3	50	0	0
5	57797914	.	A	G	13	0	13	0	26	39	0	0
5	57797954	.	T	C	15	19	34	0	0	34	0	0
5	57814454	.	C	A	7	2	9	0	0	9	0	0
5	57814627	.	G	A	11	9	20	0	0	20	0	0
5	57814630	.	T	C	8	0	8	0	11	19	0	0
5	57815018	.	G	A	8	7	15	1	0	16	0	0
5	57818963	.	G	T	8	7	15	0	0	15	0	0
5	57819009	.	C	T	1	11	12	0	4	16	0	0
5	57820641	.	C	A	5	3	8	0	2	10	0	0
5	57820683	.	A	G	8	3	11	0	0	11	0	0
5	57820731	.	T	A	4	9	13	0	0	13	0	0
5	57820743	.	G	C	6	4	10	0	1	11	0	0
5	57838329	.	G	A	1	4	5	0	0	5	0	0
5	57842175	.	A	C	2	4	6	0	1	7	0	0
5	57842181	.	C	T	1	4	5	0	0	5	0	0
5	57902067	.	T	C	2	2	4	0	0	4	0	0
5	57919823	.	T	A	5	6	11	0	0	11	0	0
5	58075599	.	C	T	5	2	7	0	0	7	0	0
5	58075686	.	A	G	3	3	6	0	1	7	0	0
5	58075815	.	T	G	3	3	6	0	2	8	0	0
5	58081110	.	C	T	4	4	8	0	1	9	0	0
5	58081173	.	T	A	3	4	7	0	0	7	0	0
5	58081179	.	C	T	4	3	7	0	0	7	0	0
5	58086215	.	G	C	1	0	1	0	5	6	0	0
5	58111797	.	C	T	0	4	4	0	2	6	0	0
5	58111830	.	C	T	1	2	3	0	0	3	0	0
5	58173388	.	C	T	1	2	3	0	0	3	0	0
5	58173545	.	C	A	3	2	5	0	0	5	0	0
5	58173573	.	T	A	2	3	5	0	1	6	0	0
5	58372268	.	T	C	30	25	55	0	2	57	0	0
5	58372286	.	G	A	29	28	57	0	2	60	1	0
5	58382159	.	A	G	30	4	34	0	34	68	0	0
5	58382358	.	C	T	24	34	58	0	1	59	0	0
5	58382440	.	T	A	11	16	27	0	2	45	16	0
5	58382457	.	C	G	26	7	33	0	10	43	0	0
5	58405010	.	G	A	0	2	2	0	3	5	0	0
5	58409519	.	C	T	3	5	8	0	0	9	1	0
5	58412403	.	T	C	6	6	12	0	0	12	0	0
5	58412439	.	C	T	7	5	12	0	0	12	0	0
5	58421697	.	C	G	2	0	2	0	3	5	0	0
5	58439018	.	C	T	7	2	9	0	0	9	0	0
5	58440528	.	A	T	6	3	9	0	0	9	0	0
5	58440541	.	A	G	5	0	5	0	6	11	0	0
5	58444059	.	G	A	2	2	4	0	0	4	0	0
5	58459476	.	A	C	12	4	16	0	1	17	0	0
5	58462891	.	A	G	14	0	14	0	10	24	0	0
5	58478188	.	C	T	15	12	27	0	1	28	0	0
5	58490636	.	A	T	4	2	6	0	0	6	0	0
5	58500411	.	C	T	1	4	5	0	0	5	0	0
5	58500489	.	G	A	2	2	4	0	0	4	0	0
5	58504183	.	C	T	8	7	15	0	1	16	0	0
5	58504447	.	G	T	4	5	9	0	3	12	0	0
5	58504562	.	G	T	5	5	10	0	0	10	0	0
5	58511523	.	C	G	2	6	8	0	1	9	0	0
5	58511553	.	T	C	1	6	7	0	0	7	0	0
5	58511705	.	G	A	1	5	6	0	0	6	0	0
5	58687569	.	A	C	1	3	4	0	0	4	0	0
5	58687623	.	A	T	11	8	19	0	0	19	0	0
5	58687649	.	C	A	12	11	23	0	0	23	0	0
5	58687673	.	T	C	7	8	15	0	0	15	0	0
5	58687739	.	G	A	0	2	2	0	5	7	0	0
5	58688749	.	A	G	14	10	24	0	0	24	0	0
5	58695764	.	G	A	1	8	9	0	3	12	0	0
5	58695783	.	A	C	2	7	9	0	0	9	0	0
5	58696412	.	A	C	5	14	19	0	0	19	0	0
5	58696905	.	C	G	7	6	13	0	0	13	0	0
5	58699888	.	C	T	6	5	11	0	1	12	0	0
5	58704272	.	C	T	12	7	19	0	0	19	0	0
5	58711159	.	G	T	9	7	16	0	1	17	0	0
5	58713213	.	C	T	0	4	4	0	4	8	0	0
5	58713579	.	C	T	4	6	10	0	0	10	0	0
5	58717412	.	C	T	8	9	17	1	0	18	0	0
5	58717618	.	A	T	4	9	13	0	1	14	0	0
5	58719797	.	C	T	8	7	15	0	0	15	0	0
5	58721406	.	C	T	0	10	10	0	9	19	0	0
5	58722507	.	T	C	6	4	10	0	1	11	0	0
5	58726558	.	C	T	4	4	8	0	0	8	0	0
5	58726575	.	C	T	3	4	7	0	0	7	0	0
5	58730739	.	G	A	3	3	6	0	0	6	0	0
5	58736043	.	C	A	4	4	8	0	0	8	0	0
5	58736111	.	T	G	2	4	6	0	2	8	0	0
5	58736144	.	C	T	4	3	7	0	1	8	0	0
5	58742862	.	C	T	2	5	7	0	0	7	0	0
5	58745861	.	G	A	3	3	6	0	0	6	0	0
5	58776499	.	G	A	2	5	7	0	0	7	0	0
5	58831533	.	C	T	3	2	5	0	0	5	0	0
5	58831781	.	A	G	1	2	3	0	0	3	0	0
5	58850871	.	G	T	14	22	36	0	1	37	0	0
5	58850923	.	A	C	16	19	35	3	0	38	0	0
5	58851297	.	T	A	12	9	21	0	0	21	0	0
5	58851789	.	A	C	23	0	23	0	21	44	0	0
5	58851865	.	T	C	19	0	19	0	15	34	0	0
5	58851925	.	G	A	25	18	43	0	1	44	0	0
5	58851938	.	C	T	26	12	38	0	5	43	0	0
5	58852042	.	T	C	16	0	16	0	15	31	0	0
5	58852164	.	T	C	15	9	24	0	2	26	0	0
5	58852223	.	A	T	12	19	31	0	1	32	0	0
5	58852515	.	A	G	1	3	4	5	0	9	0	0
5	58852758	.	C	A	13	11	24	0	2	26	0	0
5	58852825	.	A	C	22	10	32	0	1	33	0	0
5	58852864	.	T	G	8	15	23	0	0	23	0	0
5	58852971	.	C	T	1	10	11	0	2	13	0	0
5	58853177	.	T	A	3	2	5	0	1	6	0	0
5	58853407	.	C	T	8	5	13	0	0	13	0	0
5	58853711	.	T	A	11	11	22	0	0	22	0	0
5	58866495	.	C	T	9	19	28	0	0	28	0	0
5	58868891	.	A	G	8	13	21	0	1	22	0	0
5	58875086	.	A	G	10	9	19	0	0	19	0	0
5	58875113	.	T	C	10	9	19	0	1	20	0	0
5	58875140	.	C	G	0	11	11	0	12	23	0	0
5	58876301	.	C	T	1	8	9	0	10	19	0	0
5	58876498	.	T	C	5	0	5	0	5	10	0	0
5	58878863	.	G	C	4	3	7	0	0	7	0	0
5	58939388	.	C	A	0	10	10	0	13	23	0	0
5	58993040	.	G	A	1	2	3	0	0	3	0	0
5	58993333	.	T	G	1	2	3	0	0	3	0	0
5	58993390	.	G	A	3	2	5	0	0	5	0	0
5	58993405	.	A	G	4	2	6	0	0	6	0	0
5	59030172	.	T	C	2	3	5	0	0	5	0	0
5	59041862	.	T	C	7	4	11	0	0	11	0	0
5	59046275	.	G	A	1	6	7	0	5	12	0	0
5	59046296	.	T	C	7	5	12	0	0	12	0	0
5	59050313	.	C	T	3	8	11	0	0	11	0	0
5	59060620	.	C	T	4	7	11	0	0	11	0	0
5	59060855	.	C	T	6	7	13	0	2	15	0	0
5	59067763	.	T	A	8	8	16	0	0	16	0	0
5	59079919	.	G	A	1	5	6	1	10	17	0	0
5	59079932	.	C	T	6	10	16	0	0	16	0	0
5	59080452	.	G	T	1	14	15	0	10	25	0	0
5	59080526	.	T	A	5	7	12	0	1	13	0	0
5	59080874	.	A	G	4	4	8	0	0	8	0	0
5	59081830	.	A	G	3	5	8	0	0	8	0	0
5	59081870	.	C	T	2	2	4	0	0	4	0	0
5	59082395	.	C	T	6	4	10	0	0	10	0	0
5	59082409	.	G	T	5	11	16	0	1	17	0	0
5	59082495	.	C	A	15	9	24	0	0	24	0	0
5	59082540	.	C	T	4	11	15	0	0	15	0	0
5	59082581	.	T	A	11	5	16	0	0	16	0	0
5	59082882	.	C	T	5	16	21	0	1	22	0	0
5	59083136	.	T	G	6	13	19	0	1	20	0	0
5	59083201	.	T	A	2	7	9	0	0	9	0	0
5	59092513	.	A	G	14	5	19	0	0	19	0	0
5	59092644	.	G	A	13	7	20	0	1	21	0	0
5	59100577	.	G	A	7	3	10	0	0	10	0	0
5	59101813	.	G	A	5	4	9	0	0	9	0	0
5	59101933	.	G	A	6	3	9	0	0	9	0	0
5	59199272	.	A	T	1	4	5	0	0	5	0	0
5	59199316	.	A	T	4	4	8	0	0	8	0	0
5	59199332	.	A	C	4	2	6	0	0	6	0	0
5	59199517	.	C	T	4	3	7	0	0	7	0	0
5	59199538	.	C	T	3	3	6	0	0	6	0	0
5	59199734	.	C	T	7	3	10	0	0	10	0	0
5	59199738	.	G	A	1	3	4	0	6	10	0	0
5	59200130	.	A	G	4	4	8	0	0	8	0	0
5	59200153	.	T	G	5	4	9	0	0	9	0	0
5	59200211	.	C	T	2	8	10	0	0	10	0	0
5	59200270	.	T	A	7	4	11	0	0	11	0	0
5	59200435	.	T	G	2	4	6	0	0	6	0	0
5	59200444	.	G	A	2	3	5	0	0	5	0	0
5	59201308	.	G	A	0	7	7	0	3	10	0	0
5	59201690	.	T	C	4	2	6	0	0	6	0	0
5	59201785	.	T	G	2	7	9	0	0	9	0	0
5	59201825	.	G	A	7	8	15	0	0	15	0	0
5	59201883	.	T	G	6	4	10	0	0	10	0	0
5	59201947	.	A	G	6	7	13	0	1	14	0	0
5	59202206	.	C	T	1	2	3	0	1	4	0	0
5	59234451	.	G	T	6	3	9	0	0	9	0	0
5	59239773	.	C	G	4	13	17	0	0	17	0	0
5	59239851	.	G	A	8	8	16	0	0	16	0	0
5	59247894	.	A	G	17	9	26	0	1	27	0	0
5	59248038	.	C	G	8	3	11	1	0	12	0	0
5	59248156	.	A	G	4	0	4	0	5	9	0	0
5	59248162	.	T	C	3	4	7	0	0	7	0	0
5	59278455	.	C	T	3	7	10	0	0	10	0	0
5	59278463	.	T	C	9	4	13	0	0	13	0	0
5	59278569	.	G	A	9	3	12	0	0	12	0	0
5	59303988	.	C	T	4	6	10	0	1	11	0	0
5	59380488	.	C	T	9	6	15	0	1	16	0	0
5	59381774	.	C	T	10	6	16	0	1	17	0	0
5	59386337	.	G	T	0	8	8	0	10	18	0	0
5	59386416	.	A	G	5	11	16	0	1	17	0	0
5	59386504	.	T	G	5	1	6	0	12	18	0	0
5	59386512	.	C	G	9	8	17	0	2	19	0	0
5	59387075	.	A	C	4	4	8	0	1	9	0	0
5	59387094	.	A	T	5	3	8	0	0	8	0	0
5	59387120	.	C	T	1	4	5	0	0	5	0	0
5	59387476	.	C	A	7	7	14	0	0	14	0	0
5	59387478	.	C	A	7	7	14	0	0	14	0	0
5	59387566	.	G	T	8	5	13	0	1	14	0	0
5	59388479	.	G	A	11	6	17	0	0	17	0	0
5	59388660	.	A	G	7	13	20	0	1	21	0	0
5	59388686	.	C	T	4	8	12	0	0	12	0	0
5	59389014	.	G	A	11	6	17	0	1	18	0	0
5	59389101	.	G	A	6	6	12	0	0	12	0	0
5	59389107	.	G	A	6	5	11	0	0	11	0	0
5	59389688	.	G	A	9	9	18	0	0	18	0	0
5	59397579	.	C	A	3	2	5	0	1	6	0	0
5	59397604	.	G	C	2	2	4	0	1	5	0	0
5	59397689	.	A	C	4	4	8	0	0	8	0	0
5	59419954	.	C	T	6	3	9	0	0	9	0	0
5	59420030	.	C	T	6	6	12	0	0	12	0	0
5	59420096	.	T	C	5	6	11	0	1	12	0	0
5	59420111	.	G	A	3	5	8	0	0	8	0	0
5	59420138	.	G	A	0	5	5	0	3	8	0	0
5	59420249	.	A	G	4	0	4	0	10	14	0	0
5	59420321	.	A	C	9	4	13	0	0	13	0	0
5	59420414	.	G	T	0	3	3	0	11	14	0	0
5	59444562	.	C	A	8	3	11	0	2	13	0	0
5	59449717	.	T	C	6	7	13	0	0	13	0	0
5	59449729	.	C	T	2	7	9	0	1	10	0	0
5	59449767	.	C	T	7	7	14	0	1	15	0	0
5	59462457	.	G	A	8	8	16	0	1	17	0	0
5	59462595	.	C	T	3	8	11	0	1	12	0	0
5	59462663	.	C	T	9	6	15	0	0	15	0	0
5	59462679	.	C	T	5	9	14	1	1	16	0	0
5	59462881	.	G	A	7	6	13	0	0	13	0	0
5	59462994	.	A	T	7	11	18	0	0	18	0	0
5	59463183	.	G	T	3	9	12	0	0	12	0	0
5	59463213	.	T	C	12	6	18	0	0	18	0	0
5	59463261	.	C	A	5	14	19	0	0	19	0	0
5	59473885	.	A	C	12	10	22	0	0	22	0	0
5	59479541	.	C	A	5	12	17	0	1	19	1	0
5	59479818	.	C	G	9	5	14	0	1	16	1	0
5	59479973	.	C	T	9	8	17	0	0	17	0	0
5	59515629	.	G	C	2	4	6	0	0	6	0	0
5	59536913	.	G	C	3	4	7	0	0	7	0	0
5	59536958	.	C	T	4	2	6	0	1	7	0	0
5	59538508	.	T	G	4	0	4	1	4	9	0	0
5	59544327	.	C	T	6	3	9	0	1	10	0	0
5	59544717	.	A	G	2	0	2	0	7	9	0	0
5	59548944	.	T	A	3	3	6	1	0	7	0	0
5	59549182	.	G	A	8	2	10	0	0	10	0	0
5	59549382	.	A	G	3	5	8	0	0	8	0	0
5	59549389	.	G	A	2	5	7	0	0	7	0	0
5	59550260	.	A	T	5	5	10	0	0	10	0	0
5	59550529	.	T	G	6	3	9	0	0	9	0	0
5	59550733	.	T	A	1	2	3	0	0	3	0	0
5	59550762	.	A	C	2	4	6	1	3	10	0	0
5	59559881	.	C	T	9	7	16	0	0	16	0	0
5	59559905	.	T	C	10	5	15	0	1	16	0	0
5	59560110	.	T	C	12	14	26	0	0	26	0	0
5	59560131	.	A	G	13	0	13	0	12	25	0	0
5	59584626	.	C	T	7	11	18	0	0	18	0	0
5	59589199	.	G	A	0	8	8	0	9	17	0	0
5	59593297	.	G	C	1	7	8	0	10	18	0	0
5	59593363	.	C	T	5	9	14	0	1	15	0	0
5	59593441	.	G	A	12	4	16	0	1	17	0	0
5	59593471	.	G	A	1	7	8	0	8	16	0	0
5	59593523	.	C	T	4	5	9	0	0	9	0	0
5	59593623	.	C	T	8	5	13	0	0	13	0	0
5	59593822	.	G	T	2	8	10	0	0	10	0	0
5	59593884	.	T	G	1	8	9	0	0	9	0	0
5	59594126	.	G	T	4	3	7	0	0	7	0	0
5	59594155	.	G	A	5	4	9	0	0	9	0	0
5	59594328	.	T	C	10	8	18	0	2	20	0	0
5	59594507	.	A	C	15	6	21	0	0	21	0	0
5	59594648	.	A	T	7	9	16	0	0	16	0	0
5	59594762	.	G	A	3	8	11	0	0	11	0	0
5	59594825	.	A	T	6	12	18	0	0	18	0	0
5	59595127	.	T	C	2	7	9	0	3	12	0	0
5	59595193	.	G	A	7	4	11	0	0	11	0	0
5	59595307	.	C	A	11	9	20	0	0	20	0	0
5	59595339	.	G	A	12	6	18	0	0	18	0	0
5	59595359	.	A	G	10	2	12	0	1	13	0	0
5	59595407	.	G	A	6	11	17	0	0	17	0	0
5	60605673	.	T	C	2	2	4	0	1	5	0	0
5	60665225	.	A	C	5	5	10	0	1	11	0	0
5	60665315	.	G	A	0	4	4	0	2	6	0	0
5	60665324	.	A	C	2	4	6	0	0	6	0	0
5	60673572	.	C	G	8	4	12	0	1	13	0	0
5	60683909	.	C	T	5	10	15	0	0	15	0	0
5	60683998	.	C	A	2	7	9	0	0	10	1	0
5	60684257	.	C	T	3	5	8	0	0	8	0	0
5	60684434	.	C	T	5	6	11	0	1	12	0	0
5	60685481	.	G	A	8	15	23	0	2	25	0	0
5	60685513	.	A	G	11	8	19	0	0	19	0	0
5	60685758	.	T	C	7	6	13	0	1	14	0	0
5	60685822	.	C	T	8	9	17	0	1	18	0	0
5	60685851	.	G	A	10	5	15	0	2	17	0	0
5	60685952	.	A	C	7	5	12	0	3	15	0	0
5	60686374	.	A	T	11	6	17	0	0	17	0	0
5	60686380	.	C	A	11	9	20	0	0	20	0	0
5	60686409	.	G	A	8	9	17	0	1	18	0	0
5	60686686	.	C	G	9	7	16	0	2	18	0	0
5	60686784	.	G	T	7	3	10	0	0	10	0	0
5	60687344	.	A	T	7	4	11	0	1	12	0	0
5	60850638	.	T	C	4	3	7	0	0	7	0	0
5	60863132	.	C	T	3	2	5	0	0	5	0	0
5	60867936	.	A	G	8	4	12	0	0	12	0	0
5	60868009	.	A	G	3	0	3	0	5	8	0	0
5	60868173	.	G	A	0	4	4	0	6	10	0	0
5	60868216	.	G	A	7	8	15	0	1	16	0	0
5	60871999	.	A	T	8	9	17	0	0	17	0	0
5	60872258	.	C	T	2	5	7	0	0	7	0	0
5	60872299	.	T	G	4	4	8	0	0	8	0	0
5	60872349	.	T	G	5	0	5	0	6	11	0	0
5	60872639	.	G	A	3	4	7	0	5	12	0	0
5	60872708	.	T	C	4	5	9	0	2	11	0	0
5	60886282	.	C	T	4	4	8	0	0	8	0	0
5	60894675	.	G	A	10	4	14	0	0	14	0	0
5	60894807	.	A	G	4	0	4	0	5	9	0	0
5	60906002	.	C	T	13	3	16	0	1	17	0	0
5	60906313	.	G	A	1	6	7	0	5	12	0	0
5	61270901	.	G	A	13	9	22	0	1	23	0	0
5	61270905	.	C	T	14	7	21	0	2	23	0	0
5	61316248	.	T	C	12	5	17	0	0	17	0	0
5	61325345	.	A	T	9	9	18	0	0	18	0	0
5	61329486	.	G	A	12	4	16	0	1	17	0	0
5	61329508	.	G	C	9	6	15	0	1	16	0	0
5	61351851	.	C	T	4	9	13	0	0	13	0	0
5	61352582	.	T	C	7	7	14	0	2	16	0	0
5	61353901	.	G	A	1	6	7	0	0	7	0	0
5	61354097	.	A	C	2	9	11	0	2	13	0	0
5	61354264	.	A	G	1	5	6	0	0	6	0	0
5	61380091	.	A	G	14	0	14	0	12	26	0	0
5	61380103	.	T	A	12	15	27	0	1	28	0	0
5	61380130	.	C	T	15	16	31	0	0	31	0	0
5	61389725	.	T	C	21	23	44	0	1	45	0	0
5	61396054	.	G	A	16	16	32	0	1	33	0	0
5	61401915	.	C	T	12	15	27	0	1	28	0	0
5	61402030	.	G	A	14	10	24	0	1	25	0	0
5	61402366	.	G	C	12	13	25	0	2	27	0	0
5	61402440	.	T	C	12	18	30	0	1	31	0	0
5	61402479	.	G	A	16	19	35	0	1	36	0	0
5	61402532	.	C	T	22	16	38	0	0	38	0	0
5	61402534	.	T	A	22	15	37	0	1	38	0	0
5	61402570	.	T	C	16	17	33	0	0	33	0	0
5	61403005	.	A	T	14	11	25	0	3	28	0	0
5	61404702	.	A	T	6	4	10	0	1	11	0	0
5	61405885	.	A	G	10	9	19	0	0	19	0	0
5	61414618	.	A	T	9	9	18	0	3	21	0	0
5	61420653	.	C	T	11	4	15	0	0	15	0	0
5	61429013	.	C	A	14	5	19	0	0	19	0	0
5	61431675	.	G	A	1	4	5	0	0	5	0	0
5	61432996	.	T	C	2	3	5	0	0	5	0	0
5	61433181	.	T	G	2	3	5	0	0	5	0	0
5	61433293	.	G	A	3	9	12	0	0	12	0	0
5	61433329	.	A	G	6	3	9	0	0	9	0	0
5	61433369	.	A	T	5	5	10	0	0	10	0	0
5	61433476	.	C	T	0	5	5	0	2	7	0	0
5	61437994	.	C	T	1	2	3	0	3	6	0	0
5	61459502	.	T	C	8	16	24	0	0	24	0	0
5	61464874	.	G	T	9	8	17	0	0	18	1	0
5	61464975	.	T	G	2	4	6	0	1	7	0	0
5	61467646	.	T	A	2	4	6	0	0	6	0	0
5	61467748	.	G	T	5	3	8	0	0	8	0	0
5	61467754	.	T	A	5	1	6	0	2	8	0	0
5	61472457	.	C	T	5	4	9	0	1	10	0	0
5	61552554	.	T	C	17	20	37	0	1	38	0	0
5	61552591	.	A	T	19	19	38	0	1	39	0	0
5	61552620	.	G	C	16	16	32	0	0	32	0	0
5	61552724	.	G	T	18	13	31	0	0	31	0	0
5	61552808	.	T	A	13	8	21	0	0	21	0	0
5	61552836	.	T	A	13	10	23	0	0	23	0	0
5	61553119	.	A	G	7	3	10	0	0	10	0	0
5	61553207	.	C	T	12	8	20	0	1	21	0	0
5	61553252	.	G	T	9	14	23	0	1	24	0	0
5	61553309	.	A	G	6	0	6	0	9	15	0	0
5	61553418	.	G	A	9	10	19	0	0	19	0	0
5	61553517	.	G	T	14	15	29	0	0	29	0	0
5	61553556	.	A	T	9	13	22	1	0	23	0	0
5	61553611	.	T	G	14	6	20	1	0	21	0	0
5	61553614	.	C	T	16	6	22	1	0	23	0	0
5	61553702	.	A	T	16	12	28	0	1	29	0	0
5	61553852	.	A	T	13	9	22	0	0	22	0	0
5	61566678	.	G	C	7	6	13	0	0	13	0	0
5	61570931	.	C	T	5	7	12	0	0	12	0	0
5	61571203	.	C	T	6	4	10	0	0	10	0	0
5	61571441	.	A	G	5	0	5	0	3	8	0	0
5	61584008	.	A	T	4	7	11	0	1	12	0	0
5	61584010	.	A	T	4	4	8	0	4	12	0	0
5	61584047	.	T	C	2	0	2	0	7	9	0	0
5	61584144	.	G	C	7	4	11	0	0	11	0	0
5	61584178	.	T	C	6	3	9	0	1	10	0	0
5	61657805	.	C	T	21	15	36	0	1	37	0	0
5	61665215	.	G	A	18	16	34	0	1	35	0	0
5	61668302	.	G	A	2	17	19	0	12	31	0	0
5	61676676	.	T	G	16	1	17	0	8	25	0	0
5	61676700	.	T	G	17	9	26	0	2	28	0	0
5	61676739	.	A	C	20	13	33	0	0	33	0	0
5	61682577	.	C	T	22	20	42	0	3	45	0	0
5	61682715	.	A	C	25	15	40	0	1	41	0	0
5	61682721	.	C	T	27	15	42	0	3	45	0	0
5	61698770	.	C	T	20	25	45	0	1	46	0	0
5	61712754	.	C	T	30	32	62	0	3	65	0	0
5	61723061	.	G	A	25	26	51	0	4	55	0	0
5	61723180	.	T	C	32	25	57	0	3	60	0	0
5	61723366	.	A	G	36	25	61	1	1	63	0	0
5	61723538	.	A	G	23	1	24	0	23	47	0	0
5	61723637	.	A	G	18	22	40	0	0	40	0	0
5	61723694	.	T	G	24	22	46	0	1	47	0	0
5	61723914	.	T	C	24	26	50	0	1	51	0	0
5	61723979	.	C	T	17	13	30	0	1	31	0	0
5	61723981	.	G	A	18	12	30	0	2	32	0	0
5	61790220	.	G	A	1	2	3	0	0	3	0	0
5	61790460	.	G	T	3	2	5	0	0	5	0	0
5	61791376	.	G	A	2	4	6	0	0	6	0	0
5	61793019	.	T	A	5	2	7	0	0	7	0	0
5	61793978	.	C	T	1	4	5	0	0	5	0	0
5	61794625	.	G	A	5	4	9	0	1	10	0	0
5	61799766	.	G	A	22	20	42	0	2	44	0	0
5	61801070	.	G	A	14	18	32	0	0	32	0	0
5	61804538	.	C	T	16	15	31	0	1	32	0	0
5	61806498	.	T	C	16	18	34	0	1	35	0	0
5	61817051	.	A	T	25	25	50	0	0	50	0	0
5	61864528	.	G	T	1	3	4	0	5	9	0	0
5	61866749	.	G	A	0	3	3	0	5	8	0	0
5	61868691	.	C	T	5	2	7	0	0	7	0	0
5	61870677	.	G	T	4	4	8	0	0	8	0	0
5	61871360	.	T	C	1	6	7	0	0	7	0	0
5	61874068	.	G	A	4	3	7	0	0	7	0	0
5	61877517	.	G	A	4	5	9	0	0	9	0	0
5	61881101	.	C	T	6	3	9	0	0	9	0	0
5	61884167	.	G	A	14	4	18	0	0	18	0	0
5	61884460	.	C	T	13	12	25	0	0	25	0	0
5	61884478	.	C	T	17	10	27	0	0	27	0	0
5	61884514	.	C	T	17	9	26	0	1	27	0	0
5	61886601	.	C	T	13	16	29	0	3	32	0	0
5	61886622	.	G	A	18	8	26	1	4	31	0	0
5	61889421	.	A	G	13	1	14	0	14	28	0	0
5	61889572	.	C	G	13	12	25	0	1	26	0	0
5	61890223	.	G	A	1	11	12	0	3	15	0	0
5	61890336	.	A	T	6	3	9	0	1	10	0	0
5	61921824	.	C	T	2	5	7	0	1	8	0	0
5	61923199	.	A	G	0	3	3	0	0	3	0	0
5	61930715	.	A	T	10	7	17	0	1	18	0	0
5	61931392	.	A	G	15	18	33	0	1	34	0	0
5	61931409	.	C	T	19	12	31	0	2	33	0	0
5	61931795	.	T	C	6	7	13	0	0	13	0	0
5	61932177	.	G	A	4	8	12	1	0	13	0	0
5	61932319	.	C	T	9	8	17	0	0	17	0	0
5	61932332	.	C	T	8	8	16	0	1	17	0	0
5	61932361	.	A	T	10	7	17	0	0	18	1	0
5	61932383	.	G	A	9	8	17	0	0	17	0	0
5	61932568	.	T	C	19	8	27	0	2	29	0	0
5	61932604	.	C	T	8	16	24	0	0	24	0	0
5	61932706	.	C	G	7	12	19	0	0	19	0	0
5	61932707	.	T	G	8	12	20	0	0	20	0	0
5	61932754	.	G	C	14	9	23	0	2	25	0	0
5	61934579	.	C	T	5	13	18	0	2	20	0	0
5	61941680	.	C	T	4	2	6	0	0	6	0	0
5	61941867	.	C	G	1	2	3	0	0	3	0	0
5	61947326	.	C	T	5	3	8	0	0	8	0	0
5	61947395	.	C	T	1	3	4	0	0	4	0	0
5	61947586	.	G	C	1	5	6	0	0	6	0	0
5	61947734	.	C	T	5	3	8	0	0	8	0	0
5	61947848	.	G	C	4	4	8	0	0	8	0	0
5	61947914	.	A	T	4	2	6	0	0	6	0	0
5	61947962	.	G	A	4	2	6	0	1	7	0	0
5	61947983	.	G	A	2	2	4	0	0	4	0	0
5	61948214	.	C	T	5	3	8	0	0	8	0	0
5	61948809	.	G	A	1	3	4	0	1	5	0	0
5	61949198	.	G	T	2	2	4	0	0	4	0	0
5	61949549	.	T	G	7	10	17	0	0	17	0	0
5	61949624	.	C	T	8	8	16	0	0	16	0	0
5	61949757	.	C	G	5	4	9	0	0	9	0	0
5	61950200	.	G	T	1	2	3	0	0	3	0	0
5	61950249	.	G	A	0	3	3	0	2	5	0	0
5	61950345	.	T	G	3	1	4	0	2	6	0	0
5	61950389	.	T	A	7	0	7	0	0	7	0	0
5	61950573	.	A	G	6	3	9	0	0	9	0	0
5	61950639	.	G	T	4	4	8	0	0	8	0	0
5	61950809	.	A	G	4	2	6	0	2	8	0	0
5	61950834	.	A	T	3	5	8	0	0	8	0	0
5	61951032	.	T	C	5	5	10	0	0	10	0	0
5	61998644	.	C	T	16	11	27	0	2	29	0	0
5	62004552	.	C	T	33	11	44	0	2	46	0	0
5	62004561	.	A	G	14	28	42	0	1	43	0	0
5	62004999	.	A	G	12	10	22	0	2	24	0	0
5	62005005	.	G	T	13	7	20	0	3	23	0	0
5	62005054	.	C	T	3	2	5	0	0	5	0	0
5	62018920	.	G	A	1	6	7	0	6	13	0	0
5	62025541	.	C	T	4	6	10	0	1	11	0	0
5	62025736	.	G	A	1	5	6	0	9	15	0	0
5	62025829	.	C	A	2	6	8	0	1	9	0	0
5	62025924	.	T	C	9	6	15	0	0	15	0	0
5	62025991	.	A	G	5	0	5	0	7	12	0	0
5	62026018	.	C	A	4	7	11	0	0	11	0	0
5	62029820	.	C	T	4	5	9	0	1	10	0	0
5	62033817	.	G	A	5	3	8	0	0	8	0	0
5	62038700	.	C	A	6	6	12	0	1	13	0	0
5	62042450	.	A	G	15	13	28	0	1	29	0	0
5	62052685	.	T	G	2	4	6	0	0	6	0	0
5	62052860	.	T	G	4	4	8	0	0	8	0	0
5	62053043	.	G	A	7	4	11	0	0	11	0	0
5	62288882	.	T	C	4	9	13	0	0	13	0	0
5	62288960	.	C	T	9	19	28	0	0	28	0	0
5	62289032	.	A	T	3	8	11	0	1	12	0	0
5	62289363	.	C	A	2	2	4	0	0	4	0	0
5	62289365	.	A	G	2	2	4	0	0	4	0	0
5	62289478	.	A	G	2	9	11	0	0	11	0	0
5	62289822	.	A	G	5	0	5	0	9	14	0	0
5	62290430	.	G	T	5	3	8	0	1	9	0	0
5	62290448	.	A	T	8	3	11	0	0	11	0	0
5	62290516	.	G	T	0	2	2	0	4	6	0	0
5	62290539	.	A	G	6	0	6	0	3	9	0	0
5	62290568	.	A	T	7	4	11	0	0	11	0	0
5	62290605	.	T	C	8	7	15	0	0	15	0	0
5	62290844	.	G	A	3	8	11	0	0	11	0	0
5	62290869	.	A	T	4	7	11	0	0	11	0	0
5	62290904	.	T	C	5	6	11	0	1	12	0	0
5	62290931	.	T	C	6	6	12	0	0	12	0	0
5	62290956	.	T	C	10	3	13	0	0	13	0	0
5	62311639	.	C	A	3	3	6	0	0	6	0	0
5	62319386	.	C	T	1	2	3	0	0	3	0	0
5	62321310	.	C	T	2	3	5	0	0	5	0	0
5	62324553	.	A	G	1	0	1	0	3	4	0	0
5	62328145	.	T	C	3	2	5	0	0	5	0	0
5	62328207	.	C	G	2	2	4	0	0	4	0	0
5	62328605	.	G	T	0	4	4	0	3	7	0	0
5	62328795	.	G	T	0	5	5	0	2	7	0	0
5	62328824	.	G	T	3	4	7	0	0	7	0	0
5	62329288	.	A	G	2	7	9	0	1	10	0	0
5	62329437	.	G	A	4	3	7	0	0	7	0	0
5	62329486	.	A	C	5	6	11	0	0	11	0	0
5	62329517	.	T	C	4	3	7	0	0	7	0	0
5	62329522	.	T	C	5	2	7	0	0	7	0	0
5	62329689	.	G	A	2	3	5	0	0	5	0	0
5	62329773	.	G	T	3	4	7	0	1	8	0	0
5	62330030	.	C	T	2	4	6	0	1	7	0	0
5	62330124	.	C	T	1	5	6	0	0	6	0	0
5	62330232	.	G	T	2	2	4	0	1	5	0	0
5	62330313	.	A	G	2	5	7	0	0	7	0	0
5	62330541	.	G	C	2	2	4	0	0	4	0	0
5	62330661	.	G	A	3	5	8	0	2	10	0	0
5	62330737	.	C	G	8	3	11	0	0	11	0	0
5	62330879	.	G	A	1	5	6	0	4	10	0	0
5	62330913	.	A	G	2	0	2	0	4	6	0	0
5	62331120	.	T	C	5	3	8	0	0	8	0	0
5	62331123	.	A	T	4	3	7	0	1	8	0	0
5	62331193	.	G	T	1	2	3	0	2	5	0	0
5	62331255	.	T	C	4	5	9	0	0	9	0	0
5	62331427	.	A	T	5	3	8	0	0	8	0	0
5	62331478	.	C	A	4	8	12	0	1	14	1	0
5	62331516	.	A	T	4	8	12	0	2	14	0	0
5	62331519	.	A	G	5	8	13	0	0	13	0	0
5	62331675	.	G	A	4	9	13	0	0	13	0	0
5	62331802	.	C	A	7	3	10	0	0	10	0	0
5	62331835	.	G	A	5	3	8	0	0	8	0	0
5	62331897	.	C	T	3	7	10	0	0	10	0	0
5	62331932	.	T	G	4	8	12	0	0	12	0	0
5	62332231	.	A	C	3	5	8	0	0	8	0	0
5	62332491	.	G	A	11	5	16	0	0	16	0	0
5	62332508	.	G	A	9	4	13	0	0	13	0	0
5	62332735	.	C	T	4	3	7	0	0	7	0	0
5	62332756	.	A	T	2	3	5	0	0	5	0	0
5	62333198	.	C	A	3	6	9	0	0	9	0	0
5	62333534	.	A	C	8	6	14	0	1	15	0	0
5	62333740	.	T	G	3	3	6	0	0	6	0	0
5	62333981	.	A	G	8	0	8	0	4	12	0	0
5	62334164	.	G	A	7	4	11	0	0	11	0	0
5	62334610	.	C	T	8	6	14	0	0	14	0	0
5	62334694	.	A	T	9	4	13	0	1	14	0	0
5	62334738	.	A	C	8	6	14	0	1	15	0	0
5	62334754	.	G	A	6	6	12	1	1	14	0	0
5	62334843	.	G	T	5	6	11	0	0	11	0	0
5	62334980	.	G	A	9	1	10	0	2	12	0	0
5	62335079	.	A	G	4	0	4	0	6	10	0	0
5	62335089	.	A	G	5	0	5	0	7	12	0	0
5	62335297	.	C	A	11	7	18	0	1	19	0	0
5	62335337	.	A	T	11	6	17	0	0	17	0	0
5	62335523	.	A	G	9	0	9	0	6	15	0	0
5	62335641	.	T	A	5	4	9	0	0	9	0	0
5	62335655	.	G	T	4	4	8	0	0	8	0	0
5	62341098	.	A	G	2	2	4	0	0	4	0	0
5	62639596	.	G	A	21	21	42	0	4	46	0	0
5	62782068	.	T	G	1	2	3	0	0	3	0	0
5	62806599	.	T	A	9	3	12	0	1	13	0	0
5	62806675	.	A	G	4	8	12	0	0	12	0	0
5	62806701	.	A	G	3	7	10	0	0	10	0	0
5	62806786	.	C	A	3	3	6	0	0	6	0	0
5	62806867	.	C	T	0	7	7	0	7	14	0	0
5	62806951	.	A	G	2	6	8	0	0	8	0	0
5	62807044	.	T	A	3	3	6	0	0	6	0	0
5	62807056	.	T	C	2	2	4	0	0	4	0	0
5	62807294	.	G	A	2	8	10	0	0	10	0	0
5	62807357	.	G	A	2	4	6	0	1	7	0	0
5	62807516	.	G	A	10	7	17	0	1	18	0	0
5	62807519	.	G	A	7	9	16	0	0	16	0	0
5	62860901	.	A	G	5	7	12	0	0	12	0	0
5	62860902	.	G	T	5	6	11	0	1	12	0	0
5	62860943	.	T	C	9	5	14	0	1	15	0	0
5	62865289	.	G	A	3	10	13	0	0	13	0	0
5	62884052	.	T	C	6	7	13	0	0	13	0	0
5	62889651	.	C	T	11	10	21	0	0	21	0	0
5	62889957	.	G	A	8	6	14	0	0	14	0	0
5	62889966	.	C	G	6	3	9	0	1	10	0	0
5	62890011	.	T	G	3	7	10	0	0	10	0	0
5	62890026	.	G	A	3	7	10	0	1	11	0	0
5	62890161	.	A	G	3	5	8	0	0	8	0	0
5	62890405	.	C	T	3	6	9	0	0	9	0	0
5	62890642	.	G	A	7	9	16	0	0	16	0	0
5	62890846	.	A	G	6	4	10	0	1	11	0	0
5	62924464	.	G	A	2	2	4	0	0	4	0	0
5	62937329	.	C	T	7	4	11	0	1	12	0	0
5	62937377	.	T	G	4	5	9	0	0	9	0	0
5	62937410	.	C	A	5	5	10	0	0	10	0	0
5	62937428	.	C	T	0	5	5	0	8	13	0	0
5	62989260	.	C	T	8	12	20	0	2	22	0	0
5	63026448	.	C	T	7	4	11	0	1	12	0	0
5	63026458	.	T	C	6	0	6	0	5	11	0	0
5	63026570	.	T	C	1	3	4	0	0	4	0	0
5	63065739	.	G	A	4	3	7	0	0	7	0	0
5	63065768	.	A	C	5	0	5	0	4	9	0	0
5	63089582	.	T	G	6	4	10	0	0	10	0	0
5	63092339	.	A	G	2	5	7	0	0	7	0	0
5	63198185	.	A	G	1	2	3	0	0	3	0	0
5	63206286	.	A	G	1	2	3	0	0	3	0	0
5	63248320	.	G	T	6	7	13	0	0	13	0	0
5	63248335	.	A	G	3	5	8	0	2	10	0	0
5	63248368	.	T	C	2	3	5	0	0	5	0	0
5	63248433	.	G	A	3	2	5	0	0	5	0	0
5	63248665	.	A	C	8	7	15	0	1	16	0	0
5	63248668	.	T	C	9	7	16	0	0	16	0	0
5	63267269	.	A	G	1	5	6	0	0	6	0	0
5	63268917	.	G	A	3	4	7	0	0	7	0	0
5	63273840	.	T	G	3	3	6	0	0	6	0	0
5	63276533	.	A	G	3	3	6	0	0	6	0	0
5	63285995	.	T	G	3	9	12	0	0	12	0	0
5	63289113	.	T	G	1	3	4	0	0	4	0	0
5	63289312	.	C	A	1	2	3	0	0	3	0	0
5	63322568	.	A	T	3	3	6	2	0	8	0	0
5	63322584	.	G	T	2	3	5	1	0	6	0	0
5	63329526	.	G	A	3	4	7	0	0	7	0	0
5	63331691	.	A	G	1	7	8	0	0	8	0	0
5	63335216	.	C	A	4	4	8	5	0	13	0	0
5	63338518	.	A	T	4	4	8	0	0	8	0	0
5	63338557	.	C	T	7	3	10	0	0	10	0	0
5	63338563	.	A	G	8	3	11	0	0	11	0	0
5	63359675	.	T	C	1	2	3	0	0	3	0	0
5	63359680	.	T	C	1	2	3	0	0	3	0	0
5	63360311	.	A	G	1	3	4	0	0	4	0	0
5	63362964	.	A	G	2	0	2	0	3	5	0	0
5	63363010	.	G	A	1	3	4	0	1	5	0	0
5	63373650	.	G	A	3	2	5	0	0	5	0	0
5	63373660	.	A	G	2	0	2	0	2	4	0	0
5	63375511	.	C	G	1	2	3	0	0	3	0	0
5	63375553	.	G	A	2	3	5	0	0	5	0	0
5	63375809	.	G	C	1	2	3	0	1	4	0	0
5	63375818	.	A	G	2	0	2	0	2	4	0	0
5	63375980	.	C	T	2	3	5	0	0	5	0	0
5	63378650	.	C	T	3	3	6	0	0	6	0	0
5	63378665	.	A	G	3	0	3	0	3	6	0	0
5	63382081	.	G	A	4	2	6	0	0	6	0	0
5	63394174	.	C	A	30	13	43	0	0	43	0	0
5	63395057	.	A	T	23	26	49	0	0	49	0	0
5	63398847	.	T	C	8	23	31	0	0	31	0	0
5	63398973	.	G	A	20	12	32	1	9	42	0	0
5	63399066	.	G	C	16	28	44	0	2	46	0	0
5	63399111	.	T	A	23	28	51	0	2	53	0	0
5	63399683	.	T	A	19	14	33	0	2	35	0	0
5	63400476	.	G	A	5	2	7	0	0	7	0	0
5	63400524	.	T	G	4	3	7	0	0	7	0	0
5	63400685	.	G	A	1	3	4	0	0	4	0	0
5	63412535	.	G	C	1	2	3	0	0	3	0	0
5	63416896	.	T	G	4	5	9	0	0	9	0	0
5	63417980	.	C	T	0	2	2	0	1	3	0	0
5	63425133	.	C	G	2	3	5	0	0	5	0	0
5	63425166	.	C	G	1	2	3	0	1	4	0	0
5	63425407	.	G	A	1	2	3	0	0	3	0	0
5	63435513	.	C	A	1	2	3	0	0	3	0	0
5	63510908	.	G	T	10	6	16	0	1	17	0	0
5	63511045	.	A	G	6	3	9	0	0	9	0	0
5	63511110	.	T	C	8	0	8	0	6	14	0	0
5	63511264	.	A	G	2	4	6	0	0	6	0	0
5	63511315	.	A	G	2	4	6	0	0	6	0	0
5	63511788	.	A	T	9	7	16	0	0	16	0	0
5	63511791	.	A	G	8	6	14	0	1	15	0	0
5	63514810	.	T	C	1	0	1	0	4	5	0	0
5	63629121	.	C	A	9	4	13	0	0	13	0	0
5	63629136	.	G	A	9	6	15	0	0	15	0	0
5	63629299	.	A	T	7	8	15	0	0	15	0	0
5	63644850	.	G	A	3	4	7	0	0	7	0	0
5	63648811	.	A	G	2	2	4	0	0	4	0	0
5	63655829	.	T	C	3	3	6	0	0	6	0	0
5	63658134	.	C	T	2	2	4	0	0	4	0	0
5	63680655	.	A	G	13	0	13	0	12	25	0	0
5	63680661	.	C	G	10	11	21	0	0	21	0	0
5	63680709	.	T	G	5	16	21	0	0	21	0	0
5	63680718	.	A	G	7	0	7	0	16	23	0	0
5	63681123	.	A	G	7	9	16	0	0	16	0	0
5	63681300	.	A	G	6	13	19	0	1	20	0	0
5	63695760	.	C	T	14	15	29	0	0	29	0	0
5	63698549	.	T	C	14	17	31	0	1	32	0	0
5	63699468	.	T	C	24	13	37	0	0	37	0	0
5	63720639	.	A	G	17	19	36	0	1	37	0	0
5	63723807	.	G	A	2	15	17	0	16	33	0	0
5	63730115	.	G	A	2	20	22	0	30	52	0	0
5	63739868	.	A	G	3	1	4	1	24	29	0	0
5	63739869	.	A	G	2	26	28	1	0	29	0	0
5	63739912	.	A	G	14	17	31	1	2	34	0	0
5	63740093	.	C	T	12	20	32	0	0	32	0	0
5	63740097	.	T	A	12	17	29	0	3	32	0	0
5	63740305	.	A	G	18	6	24	0	3	27	0	0
5	63740423	.	A	G	26	10	36	0	0	36	0	0
5	63740431	.	A	G	21	9	30	0	2	32	0	0
5	63740465	.	C	A	10	13	23	0	3	28	2	0
5	63740815	.	A	C	23	14	37	0	0	38	1	0
5	63740874	.	A	C	30	11	41	0	1	42	0	0
5	63740895	.	A	C	25	11	36	0	1	38	1	0
5	63740910	.	A	G	21	15	36	0	1	37	0	0
5	63741023	.	T	A	12	11	23	0	1	24	0	0
5	63741077	.	A	T	10	6	16	0	2	18	0	0
5	63848261	.	T	C	5	10	15	0	1	16	0	0
5	63848593	.	T	C	2	2	4	0	0	4	0	0
5	63848662	.	C	T	3	7	10	0	1	11	0	0
5	63848668	.	G	T	4	8	12	0	0	12	0	0
5	63858951	.	C	A	4	4	8	0	0	8	0	0
5	63860936	.	A	G	4	3	7	0	0	7	0	0
5	63860943	.	A	G	4	1	5	0	2	7	0	0
5	63861355	.	G	A	0	2	2	0	2	4	0	0
5	63863018	.	G	A	1	3	4	0	4	8	0	0
5	63863651	.	C	G	5	0	5	0	3	8	0	0
5	63863656	.	G	A	4	3	7	0	0	7	0	0
5	63863945	.	G	C	4	4	8	0	1	9	0	0
5	63864117	.	C	T	7	6	13	0	1	14	0	0
5	63864150	.	T	C	4	2	6	0	3	9	0	0
5	64204867	.	T	C	10	3	13	0	0	13	0	0
5	64205273	.	T	C	7	0	7	0	3	10	0	0
5	64205459	.	T	C	5	3	8	0	0	8	0	0
5	64207009	.	T	C	4	3	7	0	0	7	0	0
5	64207040	.	T	C	5	2	7	0	0	7	0	0
5	64207370	.	T	C	8	10	18	0	0	18	0	0
5	64850066	.	A	T	5	2	7	0	0	7	0	0
5	65112769	.	T	A	2	2	4	0	0	4	0	0
5	66250917	.	C	T	6	3	9	0	0	9	0	0
5	66252054	.	G	A	1	5	6	0	5	11	0	0
5	66252127	.	A	T	5	2	7	0	0	7	0	0
5	66263544	.	A	T	5	4	9	0	0	9	0	0
5	66266997	.	A	G	4	7	11	0	0	11	0	0
5	66268964	.	A	G	6	0	6	0	8	14	0	0
5	66271189	.	G	A	1	2	3	0	0	3	0	0
5	66271446	.	A	T	3	3	6	0	0	6	0	0
5	66388196	.	G	A	8	8	16	0	0	16	0	0
5	66389652	.	C	T	7	8	15	0	3	18	0	0
5	66389676	.	C	T	10	7	17	0	0	17	0	0
5	66397643	.	C	A	3	6	9	0	0	9	0	0
5	66404663	.	T	C	3	0	3	0	3	6	0	0
5	66498617	.	C	T	1	2	3	0	1	4	0	0
5	66676766	.	C	G	9	17	26	1	1	28	0	0
5	66676768	.	G	A	9	15	24	1	3	28	0	0
5	66699135	.	G	T	11	9	20	0	1	21	0	0
5	66699138	.	C	G	12	9	21	0	1	22	0	0
5	66699564	.	G	T	13	8	21	0	0	21	0	0
5	66700388	.	C	T	5	4	9	0	1	10	0	0
5	66700602	.	T	A	4	5	9	0	0	10	1	0
5	66700608	.	T	C	3	6	9	0	0	9	0	0
5	66700734	.	C	A	0	8	8	0	5	13	0	0
5	66700833	.	T	C	8	0	8	0	9	17	0	0
5	66700974	.	T	A	3	6	9	0	0	9	0	0
5	66701266	.	T	C	2	7	9	0	1	10	0	0
5	66701493	.	T	C	10	10	20	0	1	21	0	0
5	66702411	.	G	A	6	2	8	0	0	8	0	0
5	66733482	.	C	G	3	5	8	0	0	8	0	0
5	66733572	.	C	T	0	4	4	0	7	11	0	0
5	66733682	.	T	C	11	11	22	0	1	23	0	0
5	66733694	.	T	C	12	0	12	0	13	25	0	0
5	66733891	.	G	C	13	8	21	0	1	22	0	0
5	66736211	.	T	C	7	9	16	0	3	19	0	0
5	66736280	.	A	G	1	6	7	0	1	8	0	0
5	66740183	.	A	T	10	11	21	0	0	21	0	0
5	66740239	.	T	G	6	7	13	0	0	13	0	0
5	66740273	.	A	T	4	3	7	0	2	9	0	0
5	66807482	.	C	T	7	18	25	0	0	25	0	0
5	66807543	.	C	T	2	21	23	0	15	38	0	0
5	66807735	.	A	G	4	14	18	0	1	19	0	0
5	66807771	.	T	G	8	11	19	0	1	20	0	0
5	66807788	.	C	T	2	13	15	0	10	25	0	0
5	66807830	.	G	A	11	10	21	3	1	25	0	0
5	66807831	.	A	G	12	10	22	3	0	25	0	0
5	66807881	.	A	G	16	17	33	1	1	35	0	0
5	66807916	.	T	C	19	16	35	0	1	36	0	0
5	66813647	.	T	C	11	0	11	0	12	23	0	0
5	66813674	.	G	A	15	8	23	0	1	24	0	0
5	66813722	.	A	G	15	13	28	1	1	30	0	0
5	66814504	.	T	C	10	15	25	1	0	26	0	0
5	66814522	.	A	G	11	12	23	1	1	25	0	0
5	66818699	.	C	T	10	18	28	0	5	33	0	0
5	66819515	.	T	C	13	17	30	0	0	30	0	0
5	66820859	.	A	T	8	8	16	0	1	17	0	0
5	67273308	.	A	G	3	5	8	0	0	8	0	0
5	68767201	.	C	T	12	3	15	0	0	15	0	0
5	68767355	.	T	C	3	4	7	0	1	8	0	0
5	68891694	.	C	T	1	9	10	3	0	13	0	0
5	68891782	.	A	G	0	2	2	0	0	2	0	0
5	68891791	.	G	T	3	3	6	0	0	6	0	0
5	68892515	.	A	C	24	17	41	6	0	47	0	0
5	68892550	.	C	T	24	9	33	1	0	34	0	0
5	68892872	.	T	C	8	28	36	0	0	36	0	0
5	68892875	.	T	C	18	15	33	0	3	36	0	0
5	69014276	.	T	C	6	6	12	0	0	12	0	0
5	69581937	.	G	A	1	6	7	3	1	11	0	0
5	69588720	.	A	T	5	13	18	1	0	19	0	0
5	69595361	.	G	A	7	16	23	1	0	24	0	0
5	69599798	.	G	T	5	16	21	2	0	23	0	0
5	69608211	.	G	A	2	13	15	3	0	18	0	0
5	69608223	.	G	A	2	13	15	3	0	18	0	0
5	69616625	.	A	T	3	4	7	5	0	12	0	0
5	69686414	.	T	C	2	4	6	0	0	6	0	0
5	69699689	.	G	C	1	2	3	0	4	7	0	0
5	69699700	.	T	C	4	4	8	1	0	9	0	0
5	69875648	.	C	T	1	4	5	0	0	5	0	0
5	69907555	.	T	C	2	9	11	0	0	11	0	0
5	70182082	.	A	G	27	33	60	0	0	60	0	0
5	70182599	.	T	G	25	0	25	0	29	54	0	0
5	70183091	.	T	C	24	12	36	1	1	38	0	0
5	70271882	.	C	T	6	3	9	0	0	9	0	0
5	70301379	.	C	T	1	6	7	0	0	7	0	0
5	70301392	.	C	A	1	5	6	0	0	6	0	0
5	70315679	.	G	A	0	2	2	0	9	11	0	0
5	70317090	.	T	A	1	5	6	0	0	6	0	0
5	70317960	.	G	A	2	5	7	0	1	8	0	0
5	70318311	.	T	C	7	7	14	0	0	14	0	0
5	70318320	.	G	A	5	7	12	0	0	12	0	0
5	70318665	.	A	T	2	4	6	0	0	6	0	0
5	70318671	.	C	T	3	5	8	0	0	8	0	0
5	70318898	.	T	A	2	5	7	0	0	7	0	0
5	70318950	.	A	G	4	4	8	0	0	8	0	0
5	70319066	.	G	A	1	5	6	0	8	14	0	0
5	70319330	.	G	C	3	4	7	0	0	7	0	0
5	70319533	.	C	T	5	6	11	0	1	12	0	0
5	70319984	.	T	A	1	6	7	0	1	8	0	0
5	71748357	.	T	C	7	5	12	0	1	13	0	0
5	71765768	.	C	T	16	9	25	0	2	28	1	0
5	71924996	.	G	A	1	3	4	0	0	4	0	0
5	71931193	.	C	T	3	3	6	0	0	6	0	0
5	71934657	.	A	G	0	0	0	0	3	3	0	0
5	71934680	.	A	C	4	3	7	0	0	7	0	0
5	71934706	.	T	G	2	0	2	0	9	11	0	0
5	71934762	.	T	C	3	3	6	0	1	7	0	0
5	71941870	.	T	C	6	5	11	0	0	11	0	0
5	71944137	.	G	A	0	2	2	0	6	8	0	0
5	71944140	.	G	A	6	2	8	0	0	8	0	0
5	71946050	.	G	A	2	6	8	0	0	8	0	0
5	71946405	.	G	A	4	2	6	0	0	6	0	0
5	71946540	.	A	G	6	4	10	0	0	10	0	0
5	72000295	.	C	T	1	2	3	0	0	3	0	0
5	72002655	.	A	C	3	2	5	0	0	5	0	0
5	72002712	.	G	A	2	2	4	0	0	4	0	0
5	72002790	.	G	T	6	2	8	0	1	9	0	0
5	72002796	.	G	A	7	3	10	0	0	10	0	0
5	72002917	.	C	T	4	3	7	0	0	7	0	0
5	72023857	.	C	T	21	25	46	0	9	55	0	0
5	72024336	.	C	T	0	26	26	0	23	49	0	0
5	72027464	.	C	T	1	18	19	0	27	46	0	0
5	72028042	.	G	C	18	1	19	0	17	37	1	0
5	72031809	.	G	A	25	20	45	0	0	45	0	0
5	72031846	.	A	G	22	15	37	0	1	38	0	0
5	72033527	.	C	T	0	9	9	0	20	29	0	0
5	72034108	.	C	T	0	23	23	0	14	37	0	0
5	72034177	.	A	G	15	14	29	0	1	30	0	0
5	72038586	.	C	T	15	22	37	0	1	38	0	0
5	72038727	.	G	A	14	17	31	0	1	32	0	0
5	72038909	.	C	T	0	14	14	0	9	23	0	0
5	72039105	.	G	A	15	12	27	0	2	29	0	0
5	72043751	.	A	G	15	13	28	1	2	31	0	0
5	72043778	.	G	A	15	12	27	0	1	28	0	0
5	72043791	.	G	T	14	18	32	0	0	32	0	0
5	72044324	.	G	A	6	5	11	0	1	12	0	0
5	72044342	.	A	G	7	12	19	0	0	19	0	0
5	72045010	.	C	T	1	8	9	0	11	20	0	0
5	72046888	.	C	T	12	12	24	0	2	26	0	0
5	72047047	.	C	G	1	10	11	0	15	26	0	0
5	72047127	.	T	A	17	12	29	0	0	29	0	0
5	72047136	.	T	C	14	0	14	0	13	27	0	0
5	72049688	.	C	A	2	11	13	0	16	29	0	0
5	72050192	.	A	G	16	13	29	0	5	34	0	0
5	72050257	.	C	T	1	13	14	0	17	31	0	0
5	72050314	.	T	C	5	1	6	0	25	31	0	0
5	72053139	.	C	T	1	4	5	0	9	14	0	0
5	72058489	.	T	C	10	16	26	0	1	27	0	0
5	72066904	.	C	T	4	6	10	0	0	10	0	0
5	72066993	.	G	A	4	6	10	0	0	10	0	0
5	72067803	.	A	G	2	7	9	0	0	9	0	0
5	72068820	.	C	T	0	5	5	0	1	6	0	0
5	72069271	.	T	C	3	1	4	0	0	4	0	0
5	72069295	.	C	A	3	3	6	0	0	6	0	0
5	72071914	.	A	G	2	6	8	0	0	8	0	0
5	72075193	.	T	C	1	0	1	0	4	5	0	0
5	72075379	.	G	A	3	2	5	0	0	5	0	0
5	72075434	.	G	A	2	3	5	0	0	5	0	0
5	72092483	.	C	T	44	20	64	0	4	68	0	0
5	72092958	.	G	A	1	46	47	0	31	78	0	0
5	72095464	.	G	A	7	2	9	0	0	9	0	0
5	72095796	.	G	A	1	4	5	0	0	5	0	0
5	72104168	.	G	A	3	3	6	0	0	6	0	0
5	72104177	.	C	A	3	4	7	0	0	7	0	0
5	72130139	.	C	A	6	7	13	0	0	14	1	0
5	72130561	.	A	T	5	3	8	0	0	8	0	0
5	72131154	.	G	A	3	4	7	0	0	7	0	0
5	72131482	.	C	T	0	6	6	0	1	7	0	0
5	72131531	.	C	T	3	6	9	0	0	9	0	0
5	72131618	.	C	T	3	5	8	0	0	8	0	0
5	72134329	.	A	G	1	4	5	0	0	5	0	0
5	72136544	.	G	A	2	2	4	0	0	4	0	0
5	72142077	.	T	C	2	6	8	0	0	8	0	0
5	72155379	.	C	T	2	5	7	0	1	8	0	0
5	72155508	.	A	C	1	5	6	0	0	6	0	0
5	72157900	.	A	G	3	2	5	0	0	5	0	0
5	72166708	.	A	G	4	3	7	0	0	7	0	0
5	72167073	.	A	G	3	0	3	0	5	8	0	0
5	72167239	.	C	T	3	3	6	0	0	6	0	0
5	72167277	.	G	A	6	2	8	0	0	8	0	0
5	72167289	.	A	G	6	2	8	0	0	8	0	0
5	72167379	.	C	T	2	6	8	0	0	8	0	0
5	72168237	.	T	C	3	2	5	0	0	5	0	0
5	72168297	.	T	G	2	0	2	0	3	5	0	0
5	72168552	.	C	T	4	6	10	0	0	10	0	0
5	72172350	.	T	A	31	24	55	0	0	55	0	0
5	72172446	.	G	T	19	18	37	0	1	38	0	0
5	72172456	.	G	T	19	22	41	0	1	42	0	0
5	72172752	.	G	A	23	27	50	0	1	51	0	0
5	72173169	.	C	A	13	9	22	0	2	24	0	0
5	72173476	.	T	C	13	17	30	0	2	32	0	0
5	72173483	.	T	G	15	16	31	0	0	31	0	0
5	72173894	.	G	A	9	15	24	0	0	24	0	0
5	72173943	.	C	T	17	8	25	0	1	26	0	0
5	72196949	.	G	A	4	4	8	0	0	8	0	0
5	72199763	.	C	T	2	7	9	0	0	9	0	0
5	72202402	.	G	A	0	5	5	0	7	12	0	0
5	72202467	.	G	A	3	7	10	0	3	13	0	0
5	72205483	.	A	C	5	10	15	0	0	15	0	0
5	72205583	.	T	G	10	0	10	0	8	18	0	0
5	72205867	.	T	G	5	3	8	0	0	8	0	0
5	72205905	.	T	C	6	5	11	0	0	11	0	0
5	72206009	.	T	C	6	3	9	0	0	9	0	0
5	72206090	.	T	C	4	9	13	0	2	15	0	0
5	72206155	.	G	T	7	7	14	0	2	16	0	0
5	72206235	.	T	G	9	0	9	0	4	13	0	0
5	72317622	.	C	T	1	2	3	0	0	3	0	0
5	72317643	.	A	G	2	3	5	0	0	5	0	0
5	72318163	.	G	A	2	2	4	0	0	4	0	0
5	72318172	.	C	T	0	3	3	0	2	5	0	0
5	72318307	.	G	A	1	2	3	0	0	3	0	0
5	72376119	.	C	G	15	29	44	0	0	44	0	0
5	72376227	.	A	G	14	19	33	0	0	33	0	0
5	72376959	.	A	G	8	16	24	0	1	25	0	0
5	72382995	.	C	T	15	16	31	0	0	31	0	0
5	72383263	.	C	T	15	19	34	0	2	36	0	0
5	72384426	.	A	C	7	9	16	2	4	22	0	0
5	72384544	.	A	G	17	5	22	1	2	25	0	0
5	72384546	.	A	G	12	8	20	1	2	23	0	0
5	72384642	.	T	C	3	6	9	0	0	9	0	0
5	72384679	.	A	G	5	3	8	0	0	8	0	0
5	72384807	.	T	C	11	0	11	0	12	23	0	0
5	72384978	.	G	A	9	9	18	0	4	22	0	0
5	72386870	.	T	C	18	14	32	0	0	32	0	0
5	72389156	.	C	A	1	15	16	0	18	34	0	0
5	72390189	.	G	A	18	9	27	0	0	27	0	0
6	28313	.	G	A	7	5	12	0	0	12	0	0
6	29439	.	T	C	14	10	24	0	1	25	0	0
6	31812	.	G	C	0	2	2	0	4	6	0	0
6	31854	.	C	T	1	3	4	0	0	4	0	0
6	32147	.	A	G	6	1	7	0	3	10	0	0
6	32192	.	C	T	5	4	9	0	0	9	0	0
6	32673	.	C	T	2	2	4	0	0	4	0	0
6	35464	.	G	C	3	5	8	0	3	11	0	0
6	36084	.	A	G	3	0	3	0	6	9	0	0
6	37050	.	C	T	5	7	12	0	0	12	0	0
6	37919	.	C	T	9	11	20	0	0	20	0	0
6	38168	.	C	T	6	12	18	0	1	19	0	0
6	38264	.	C	G	12	7	19	0	1	20	0	0
6	41065	.	A	T	10	10	20	0	0	20	0	0
6	41164	.	A	G	3	0	3	0	6	9	0	0
6	48863	.	G	T	0	2	2	0	1	3	0	0
6	58559	.	G	A	0	9	9	0	4	13	0	0
6	59048	.	C	T	6	10	16	0	0	16	0	0
6	59171	.	G	A	10	8	18	0	3	21	0	0
6	59459	.	T	C	6	5	11	0	0	11	0	0
6	59465	.	G	A	6	5	11	0	0	11	0	0
6	59732	.	T	C	9	7	16	0	1	17	0	0
6	68277	.	A	T	6	3	9	0	0	9	0	0
6	85645	.	G	A	6	5	11	0	3	14	0	0
6	92359	.	T	G	12	16	28	0	0	28	0	0
6	92383	.	A	G	7	17	24	0	3	27	0	0
6	93840	.	T	C	16	15	31	0	0	31	0	0
6	93966	.	A	G	22	16	38	0	0	38	0	0
6	104111	.	G	A	0	3	3	0	7	10	0	0
6	121239	.	C	T	1	6	7	0	1	8	0	0
6	125585	.	G	A	1	1	2	0	1	3	0	0
6	125868	.	C	T	3	2	5	0	0	5	0	0
6	126494	.	C	A	1	2	3	0	0	3	0	0
6	127077	.	T	C	2	0	2	0	2	4	0	0
6	132157	.	G	C	10	7	17	0	0	17	0	0
6	132867	.	C	T	13	4	17	0	1	18	0	0
6	132868	.	A	G	15	4	19	0	0	19	0	0
6	134267	.	C	G	4	10	14	0	1	15	0	0
6	134270	.	C	T	1	10	11	0	3	14	0	0
6	136816	.	G	A	4	3	7	0	0	7	0	0
6	136988	.	A	T	6	4	10	0	0	10	0	0
6	152306	.	A	G	18	0	18	0	17	35	0	0
6	152680	.	T	A	9	8	17	0	2	19	0	0
6	169944	.	G	A	0	3	3	0	3	6	0	0
6	169959	.	A	C	3	4	7	0	0	7	0	0
6	170194	.	A	G	0	0	0	0	3	3	0	0
6	170776	.	A	C	1	3	4	0	0	4	0	0
6	184361	.	C	T	14	14	28	0	1	29	0	0
6	184382	.	A	G	12	0	12	0	15	27	0	0
6	202561	.	T	C	6	6	12	0	0	12	0	0
6	202699	.	C	A	11	14	25	0	0	25	0	0
6	203950	.	A	T	11	10	21	0	0	21	0	0
6	204004	.	C	T	7	9	16	0	0	16	0	0
6	204014	.	A	C	4	9	13	0	2	15	0	0
6	204106	.	G	A	2	6	8	0	10	18	0	0
6	204354	.	T	C	5	7	12	0	1	13	0	0
6	204385	.	C	T	3	5	8	0	1	9	0	0
6	204952	.	T	C	6	10	16	0	0	16	0	0
6	205090	.	T	C	6	9	15	0	0	15	0	0
6	205102	.	G	A	8	7	15	0	3	18	0	0
6	205159	.	T	C	10	9	19	0	0	19	0	0
6	205258	.	G	A	0	7	7	0	5	12	0	0
6	265188	.	G	T	19	8	27	0	0	27	0	0
6	265191	.	A	T	18	8	26	0	1	27	0	0
6	265837	.	G	A	17	14	31	0	0	31	0	0
6	267412	.	C	T	8	7	15	0	1	16	0	0
6	267417	.	C	G	9	7	16	0	0	16	0	0
6	267451	.	G	A	2	4	6	0	10	16	0	0
6	267645	.	C	T	11	5	16	0	1	17	0	0
6	267669	.	C	T	5	6	11	0	1	12	0	0
6	267817	.	G	A	4	12	16	0	0	16	0	0
6	267884	.	T	C	5	4	9	0	2	11	0	0
6	267886	.	T	C	7	4	11	0	1	12	0	0
6	268308	.	T	C	1	4	5	0	0	5	0	0
6	271793	.	C	A	26	21	47	0	5	52	0	0
6	272041	.	C	T	29	21	50	0	3	53	0	0
6	272056	.	A	G	30	17	47	0	2	49	0	0
6	272194	.	A	G	42	1	43	0	13	56	0	0
6	272298	.	G	A	3	20	23	0	28	51	0	0
6	272503	.	T	C	5	7	12	0	2	14	0	0
6	322371	.	C	T	26	8	34	0	2	36	0	0
6	331909	.	T	A	14	16	30	0	6	36	0	0
6	331912	.	C	T	17	18	35	0	0	35	0	0
6	340480	.	A	C	31	10	41	0	0	41	0	0
6	340488	.	T	C	16	12	28	0	3	31	0	0
6	340670	.	A	G	16	26	42	0	0	42	0	0
6	340800	.	T	G	13	10	23	0	1	24	0	0
6	340839	.	A	G	14	8	22	0	0	22	0	0
6	341882	.	G	A	17	21	38	0	1	39	0	0
6	341933	.	G	A	20	21	41	0	1	42	0	0
6	341953	.	C	T	20	27	47	0	2	49	0	0
6	342017	.	T	A	14	11	25	0	1	26	0	0
6	342123	.	C	T	14	11	25	1	0	26	0	0
6	374956	.	T	A	8	5	13	0	0	13	0	0
6	374988	.	G	T	9	4	13	0	0	13	0	0
6	375007	.	A	C	8	5	13	0	0	13	0	0
6	375051	.	T	C	1	4	5	0	1	6	0	0
6	428833	.	C	G	4	2	6	0	1	7	0	0
6	499351	.	A	G	2	2	4	0	0	4	0	0
6	521758	.	C	T	1	3	4	0	0	4	0	0
6	537168	.	A	G	4	2	6	0	0	6	0	0
6	543216	.	G	A	4	4	8	0	0	8	0	0
6	543429	.	C	T	2	4	6	0	0	6	0	0
6	543474	.	A	G	1	0	1	0	2	3	0	0
6	840724	.	T	G	8	4	12	0	3	15	0	0
6	840792	.	C	G	11	11	22	0	0	22	0	0
6	841511	.	T	C	13	14	27	0	1	28	0	0
6	841557	.	A	G	8	13	21	0	3	24	0	0
6	841851	.	T	C	7	21	28	0	1	29	0	0
6	841941	.	G	A	8	16	24	1	2	27	0	0
6	842009	.	G	A	17	13	30	0	2	32	0	0
6	842010	.	C	T	2	14	16	0	17	33	0	0
6	842149	.	A	T	18	4	22	0	0	22	0	0
6	842192	.	T	C	13	0	13	0	8	21	0	0
6	842461	.	C	T	7	6	13	0	1	14	0	0
6	842739	.	C	T	1	11	12	0	19	31	0	0
6	842791	.	C	A	18	14	32	0	2	34	0	0
6	842816	.	A	C	11	13	24	0	0	24	0	0
6	843745	.	C	A	5	5	10	1	1	12	0	0
6	843836	.	G	A	6	5	11	2	1	14	0	0
6	844146	.	G	T	4	5	9	0	0	9	0	0
6	844164	.	C	T	6	4	10	0	0	10	0	0
6	844209	.	G	A	7	2	9	0	0	9	0	0
6	844337	.	A	G	1	9	10	0	0	10	0	0
6	844388	.	A	G	16	5	21	0	1	22	0	0
6	858026	.	C	T	3	10	13	0	15	28	0	0
6	858128	.	C	T	2	10	12	0	22	34	0	0
6	858713	.	A	G	14	11	25	0	3	28	0	0
6	859364	.	C	T	10	8	18	0	0	18	0	0
6	859907	.	A	G	4	8	12	0	1	13	0	0
6	859910	.	C	T	4	7	11	0	2	13	0	0
6	866742	.	G	T	9	5	14	0	0	14	0	0
6	869374	.	T	C	5	9	14	0	2	16	0	0
6	1351820	.	C	T	2	3	5	0	0	5	0	0
6	1352177	.	G	A	5	4	9	0	0	9	0	0
6	1421140	.	A	G	2	2	4	0	0	4	0	0
6	1431028	.	G	A	2	3	5	0	1	6	0	0
6	1431901	.	T	G	1	2	3	0	0	3	0	0
6	1431988	.	A	C	4	3	7	0	0	7	0	0
6	1511685	.	A	G	20	21	41	0	2	44	1	0
6	1535603	.	G	T	2	5	7	0	0	7	0	0
6	1538150	.	G	A	10	6	16	0	1	17	0	0
6	1539074	.	G	A	8	7	15	0	0	15	0	0
6	1541215	.	C	G	0	5	5	0	5	10	0	0
6	1541393	.	A	G	6	4	10	0	0	10	0	0
6	1544724	.	G	A	5	5	10	0	0	10	0	0
6	1549727	.	G	A	6	5	11	0	0	11	0	0
6	1554299	.	T	G	4	3	7	0	0	7	0	0
6	1554922	.	A	T	8	5	13	0	1	14	0	0
6	1561807	.	C	G	0	2	2	0	2	4	0	0
6	1562026	.	A	C	4	3	7	0	0	7	0	0
6	1582095	.	C	T	1	3	4	0	0	4	0	0
6	1582600	.	C	T	1	1	2	0	2	4	0	0
6	1582648	.	C	T	0	3	3	0	1	4	0	0
6	1584792	.	T	C	1	0	1	0	2	3	0	0
6	1780069	.	T	C	7	17	24	0	0	24	0	0
6	1794944	.	T	C	1	4	5	0	0	5	0	0
6	1797352	.	A	C	1	8	9	0	0	9	0	0
6	1797509	.	A	C	0	6	6	0	0	6	0	0
6	1797567	.	G	T	1	6	7	0	0	7	0	0
6	1797619	.	T	A	1	6	7	1	0	8	0	0
6	1797624	.	A	T	1	8	9	1	0	10	0	0
6	1797802	.	C	A	15	5	20	4	0	24	0	0
6	1799112	.	A	T	3	7	10	2	0	12	0	0
6	1833542	.	C	T	6	2	8	0	0	8	0	0
6	1838527	.	C	T	6	13	19	0	1	20	0	0
6	1843300	.	G	C	7	0	7	0	9	16	0	0
6	1843315	.	C	T	0	4	4	0	8	12	0	0
6	1843423	.	C	G	1	4	5	0	5	10	0	0
6	1843468	.	G	A	6	6	12	0	0	12	0	0
6	1872047	.	G	A	2	5	7	0	0	7	0	0
6	1874305	.	A	G	3	2	5	0	0	5	0	0
6	1874539	.	T	C	5	4	9	0	1	10	0	0
6	1874554	.	C	T	0	6	6	0	7	13	0	0
6	1874606	.	T	G	11	6	17	0	0	17	0	0
6	1874656	.	C	A	6	5	11	0	0	11	0	0
6	2068241	.	G	T	0	2	2	0	2	4	0	0
6	2068268	.	T	C	2	3	5	0	0	5	0	0
6	2073824	.	C	G	3	2	5	0	0	5	0	0
6	2079272	.	A	G	1	2	3	0	0	3	0	0
6	2079288	.	G	A	1	4	5	0	1	6	0	0
6	2089239	.	A	G	2	0	2	0	3	5	0	0
6	2091200	.	G	A	3	3	6	0	0	6	0	0
6	2091268	.	T	C	2	3	5	0	0	5	0	0
6	2091278	.	G	A	2	3	5	0	0	5	0	0
6	2117557	.	G	A	1	4	5	0	0	5	0	0
6	2125032	.	T	C	1	2	3	0	0	3	0	0
6	2125033	.	G	T	0	2	2	0	1	3	0	0
6	2126037	.	C	A	4	2	6	0	0	6	0	0
6	2126043	.	G	A	3	2	5	0	1	6	0	0
6	2126512	.	C	T	2	4	6	0	0	6	0	0
6	2133641	.	T	A	2	3	5	0	0	5	0	0
6	2133644	.	C	A	0	1	1	0	4	5	0	0
6	2165703	.	T	G	3	5	8	0	0	8	0	0
6	2165735	.	A	T	2	2	4	0	0	4	0	0
6	2165955	.	A	G	3	5	8	0	1	9	0	0
6	2165982	.	A	T	7	5	12	0	1	13	0	0
6	2166074	.	G	A	2	4	6	0	0	6	0	0
6	2166111	.	A	T	7	2	9	0	0	9	0	0
6	2166157	.	G	A	3	8	11	0	0	11	0	0
6	2166240	.	T	C	9	0	9	0	4	13	0	0
6	2166287	.	A	T	8	4	12	0	0	12	0	0
6	2166397	.	A	G	3	4	7	1	0	8	0	0
6	2166531	.	A	T	5	3	8	0	1	9	0	0
6	2170215	.	A	C	2	3	5	0	0	5	0	0
6	2171341	.	A	G	4	7	11	0	0	11	0	0
6	2190325	.	T	A	2	4	6	0	0	6	0	0
6	2190857	.	C	T	4	8	12	0	0	12	0	0
6	2194178	.	A	G	6	6	12	0	0	12	0	0
6	2198105	.	G	C	18	9	27	0	0	27	0	0
6	2198659	.	A	G	1	4	5	0	0	5	0	0
6	2206704	.	G	T	2	4	6	0	0	6	0	0
6	2206884	.	G	A	3	3	6	0	0	6	0	0
6	2208117	.	G	A	4	2	6	0	0	6	0	0
6	2208261	.	A	T	5	5	10	0	0	10	0	0
6	2208479	.	T	G	5	6	11	0	1	12	0	0
6	2208522	.	T	C	5	7	12	0	0	12	0	0
6	2208562	.	C	T	7	4	11	0	0	11	0	0
6	2208609	.	C	T	4	9	13	0	1	14	0	0
6	2208655	.	A	G	6	6	12	0	0	12	0	0
6	2210120	.	A	G	7	7	14	0	1	15	0	0
6	2215208	.	T	A	6	5	11	0	1	12	0	0
6	2216896	.	G	T	4	3	7	0	0	7	0	0
6	2217689	.	C	T	0	3	3	0	6	9	0	0
6	2271637	.	A	C	1	4	5	0	0	5	0	0
6	2372043	.	A	T	5	5	10	0	0	10	0	0
6	2384828	.	C	T	6	4	10	0	1	11	0	0
6	2391475	.	G	A	1	9	10	0	10	20	0	0
6	2453730	.	T	C	8	4	12	0	1	13	0	0
6	2453751	.	A	C	11	6	17	0	0	17	0	0
6	2505585	.	C	G	2	3	5	0	0	5	0	0
6	2526720	.	C	G	2	0	2	0	2	4	0	0
6	2533345	.	T	G	2	3	5	0	0	5	0	0
6	2558381	.	T	A	4	2	6	0	0	6	0	0
6	2558446	.	C	T	7	3	10	0	0	10	0	0
6	2560464	.	C	T	4	5	9	0	1	10	0	0
6	2562615	.	G	A	0	3	3	0	4	7	0	0
6	2586154	.	G	A	1	4	5	0	1	6	0	0
6	2620078	.	C	G	8	6	14	0	0	14	0	0
6	2621637	.	C	G	1	5	6	0	10	16	0	0
6	2621656	.	G	A	5	9	14	0	0	14	0	0
6	2621677	.	C	T	6	5	11	0	2	13	0	0
6	2621719	.	T	A	7	5	12	0	0	12	0	0
6	2623378	.	G	C	6	4	10	0	0	10	0	0
6	2624527	.	G	C	3	2	5	0	0	5	0	0
6	3005115	.	C	A	4	4	8	0	1	9	0	0
6	3005179	.	G	T	5	5	10	0	0	10	0	0
6	3005215	.	T	C	3	7	10	0	0	10	0	0
6	3040443	.	C	T	3	5	8	0	1	9	0	0
6	3040572	.	G	A	7	6	13	0	1	14	0	0
6	3142968	.	T	C	1	4	5	0	1	6	0	0
6	3143019	.	C	T	5	7	12	0	0	12	0	0
6	3143292	.	T	A	6	4	10	0	0	10	0	0
6	3145256	.	C	A	6	8	14	0	0	14	0	0
6	3197028	.	C	T	11	11	22	0	3	25	0	0
6	3205538	.	T	C	11	10	21	0	0	21	0	0
6	3223245	.	C	T	7	8	15	0	0	15	0	0
6	3223341	.	C	G	9	6	15	0	0	15	0	0
6	3268327	.	T	C	11	19	30	0	0	30	0	0
6	3270011	.	G	A	20	18	38	0	1	39	0	0
6	3273341	.	T	A	10	8	18	0	1	19	0	0
6	3273379	.	A	G	7	9	16	0	0	16	0	0
6	3273588	.	A	T	15	8	23	0	0	23	0	0
6	3273826	.	A	T	16	11	27	0	1	28	0	0
6	3273965	.	C	T	21	16	37	0	1	38	0	0
6	3273986	.	T	C	19	12	31	0	1	32	0	0
6	3274114	.	G	C	4	16	20	0	20	40	0	0
6	3274289	.	C	T	17	11	28	0	2	30	0	0
6	3293193	.	G	A	1	6	7	0	3	10	0	0
6	3293428	.	T	A	6	5	11	0	0	11	0	0
6	3293441	.	C	G	7	3	10	0	0	10	0	0
6	3295998	.	C	A	6	9	15	0	3	18	0	0
6	3296303	.	G	A	3	6	9	0	1	10	0	0
6	3298797	.	C	T	2	3	5	0	0	5	0	0
6	3302599	.	C	T	4	5	9	0	0	9	0	0
6	3302644	.	T	C	5	4	9	0	0	9	0	0
6	3302645	.	A	G	5	0	5	0	4	9	0	0
6	3302734	.	T	C	4	2	6	0	0	6	0	0
6	3309358	.	C	T	6	10	16	0	0	16	0	0
6	3312627	.	C	T	3	2	5	0	0	5	0	0
6	3312750	.	A	T	5	3	8	0	0	8	0	0
6	3318673	.	T	C	6	8	14	0	0	14	0	0
6	3319047	.	A	G	2	2	4	0	0	4	0	0
6	3319140	.	A	G	2	0	2	0	2	4	0	0
6	3334494	.	A	G	3	0	3	0	3	6	0	0
6	3334502	.	T	C	3	3	6	0	0	6	0	0
6	3343800	.	T	C	3	2	5	0	1	6	0	0
6	3395649	.	C	T	4	4	8	0	0	8	0	0
6	3398876	.	A	G	1	0	1	0	7	8	0	0
6	3398906	.	A	G	2	8	10	0	0	10	0	0
6	3404956	.	G	A	0	7	7	0	3	10	0	0
6	3405060	.	G	A	0	4	4	0	4	8	0	0
6	3405143	.	T	C	5	11	16	0	1	17	0	0
6	3405191	.	G	C	7	7	14	0	1	15	0	0
6	3405244	.	A	G	8	6	14	0	3	17	0	0
6	3405245	.	C	A	12	6	18	0	0	18	0	0
6	3509041	.	T	G	4	2	6	0	0	6	0	0
6	3514481	.	A	C	35	26	61	3	2	66	0	0
6	3516965	.	A	G	1	2	3	0	0	3	0	0
6	3516968	.	G	A	0	2	2	0	1	3	0	0
6	3517024	.	T	C	1	2	3	0	0	3	0	0
6	3517025	.	T	G	1	0	1	0	2	3	0	0
6	3537472	.	G	A	1	2	3	0	0	3	0	0
6	3563926	.	C	T	1	3	4	0	0	4	0	0
6	3563927	.	T	C	1	3	4	0	0	4	0	0
6	3564059	.	A	C	4	0	4	0	3	7	0	0
6	3564344	.	A	G	1	2	3	0	0	3	0	0
6	3564404	.	A	G	2	3	5	0	0	5	0	0
6	3566502	.	T	C	1	0	1	0	4	5	0	0
6	3566532	.	G	T	2	3	5	0	0	5	0	0
6	3704391	.	G	A	2	9	11	0	9	20	0	0
6	3707095	.	A	G	10	9	19	0	0	19	0	0
6	3707116	.	G	A	9	7	16	0	2	18	0	0
6	3707371	.	G	A	1	16	17	0	7	24	0	0
6	3707372	.	A	G	7	16	23	0	1	24	0	0
6	3707407	.	T	C	9	8	17	0	1	18	0	0
6	3708061	.	A	G	5	12	17	0	0	17	0	0
6	3708149	.	T	C	7	5	12	0	0	12	0	0
6	3711200	.	T	A	3	8	11	0	0	11	0	0
6	3711221	.	A	G	3	12	15	0	0	15	0	0
6	3711282	.	T	G	9	0	9	0	17	26	0	0
6	3711338	.	A	G	9	9	18	0	0	18	0	0
6	3711386	.	T	C	10	6	16	0	1	17	0	0
6	3711419	.	A	G	8	2	10	0	0	10	0	0
6	3711448	.	C	A	4	2	6	0	1	7	0	0
6	3711616	.	G	A	5	3	8	0	0	8	0	0
6	3711665	.	A	T	2	2	4	0	1	5	0	0
6	3711971	.	G	A	7	6	13	0	0	13	0	0
6	3712045	.	T	A	8	5	13	0	0	13	0	0
6	3712069	.	A	T	9	6	15	0	0	15	0	0
6	3712136	.	G	A	6	7	13	0	2	15	0	0
6	3712198	.	G	T	9	5	14	0	0	14	0	0
6	3712199	.	A	C	8	5	13	0	1	14	0	0
6	3712264	.	A	C	3	4	7	0	1	8	0	0
6	3712335	.	T	G	6	0	6	0	6	12	0	0
6	3712389	.	C	T	10	5	15	0	0	15	0	0
6	3712433	.	A	T	4	2	6	0	1	7	0	0
6	3712713	.	C	G	11	7	18	0	1	19	0	0
6	3712907	.	A	G	1	3	4	0	0	4	0	0
6	3713014	.	C	A	1	3	4	0	0	4	0	0
6	3717060	.	T	A	3	2	5	0	0	5	0	0
6	3717110	.	A	T	8	9	17	0	1	18	0	0
6	3717843	.	C	T	10	8	18	0	0	18	0	0
6	3724870	.	A	C	4	12	16	0	3	19	0	0
6	3725767	.	C	A	15	15	30	0	1	31	0	0
6	3727891	.	C	T	12	13	25	0	2	27	0	0
6	3728295	.	A	T	5	7	12	0	0	12	0	0
6	3728559	.	G	C	4	5	9	0	0	9	0	0
6	3821463	.	G	A	2	3	5	0	0	5	0	0
6	3821481	.	T	C	2	3	5	0	0	5	0	0
6	3821520	.	T	G	2	0	2	0	3	5	0	0
6	3821586	.	G	A	1	3	4	0	0	4	0	0
6	3827894	.	C	A	21	23	44	0	0	44	0	0
6	3834630	.	G	C	30	25	55	0	2	57	0	0
6	3853120	.	T	G	22	1	23	0	40	63	0	0
6	3853165	.	T	C	37	31	68	0	2	70	0	0
6	3862018	.	A	G	10	18	28	0	4	32	0	0
6	3867542	.	A	T	10	12	22	0	0	22	0	0
6	3869454	.	G	A	2	12	14	0	21	35	0	0
6	3869891	.	C	T	23	21	44	0	0	44	0	0
6	3871982	.	T	A	21	23	44	0	2	46	0	0
6	3874504	.	G	A	3	27	30	0	21	51	0	0
6	3874533	.	C	T	15	25	40	0	1	41	0	0
6	3874686	.	A	G	10	13	23	0	1	24	0	0
6	3878513	.	T	A	9	7	16	0	0	16	0	0
6	3878593	.	A	G	9	8	17	0	0	17	0	0
6	3878831	.	G	C	2	6	8	0	0	8	0	0
6	3878983	.	A	T	12	7	19	0	9	28	0	0
6	3879158	.	A	G	12	9	21	0	0	21	0	0
6	3879247	.	C	A	2	13	15	0	6	21	0	0
6	3879314	.	C	G	0	15	15	0	10	25	0	0
6	3879335	.	C	T	10	15	25	0	1	26	0	0
6	3879367	.	G	A	11	11	22	0	0	22	0	0
6	3881078	.	G	A	11	7	18	0	1	19	0	0
6	3885451	.	C	T	12	9	21	0	2	23	0	0
6	3895442	.	A	T	7	4	11	0	1	12	0	0
6	3895460	.	C	T	0	8	8	0	11	19	0	0
6	3901120	.	C	T	0	8	8	0	9	17	0	0
6	3906051	.	C	T	1	18	19	0	15	34	0	0
6	3907796	.	A	T	5	6	11	0	0	11	0	0
6	3944518	.	G	T	4	3	7	0	1	8	0	0
6	3945773	.	C	A	8	3	11	0	2	13	0	0
6	3945792	.	C	A	8	5	13	0	0	13	0	0
6	3950267	.	C	T	5	5	10	0	1	11	0	0
6	3950270	.	C	T	5	5	10	0	0	10	0	0
6	3950309	.	C	T	4	3	7	0	0	7	0	0
6	3953280	.	T	C	9	5	14	0	1	15	0	0
6	3953302	.	A	C	9	4	13	0	0	13	0	0
6	3961387	.	G	A	4	3	7	0	0	7	0	0
6	3962132	.	G	A	24	24	48	0	3	51	0	0
6	3962192	.	A	T	26	16	42	0	1	43	0	0
6	3964619	.	G	A	11	9	20	0	0	20	0	0
6	3965389	.	G	T	12	13	25	0	0	25	0	0
6	3965461	.	A	G	7	15	22	0	1	23	0	0
6	3973572	.	G	A	6	12	18	0	0	18	0	0
6	3973638	.	T	G	10	13	23	0	0	23	0	0
6	3974047	.	G	A	11	6	17	0	1	18	0	0
6	3984909	.	T	A	3	5	8	0	0	8	0	0
6	3985083	.	G	A	5	10	15	0	0	15	0	0
6	3985137	.	G	A	9	12	21	0	0	21	0	0
6	3987131	.	A	G	5	5	10	0	0	10	0	0
6	3987145	.	T	C	6	5	11	0	0	11	0	0
6	4144415	.	C	T	6	6	12	0	0	12	0	0
6	4144448	.	C	T	3	5	8	0	1	9	0	0
6	4145917	.	C	G	3	3	6	0	0	6	0	0
6	4185678	.	G	A	14	22	36	0	4	40	0	0
6	4191449	.	C	T	8	7	15	0	1	16	0	0
6	4191554	.	A	T	12	8	20	0	0	20	0	0
6	4192025	.	G	A	9	8	17	0	0	17	0	0
6	4192031	.	A	G	8	9	17	0	0	17	0	0
6	4192171	.	G	A	8	5	13	0	0	13	0	0
6	4199494	.	T	C	3	4	7	0	0	7	0	0
6	4200799	.	C	T	3	3	6	0	1	7	0	0
6	4204072	.	G	T	4	4	8	0	0	8	0	0
6	4204117	.	G	T	5	3	8	0	0	8	0	0
6	4206411	.	G	A	4	3	7	0	0	7	0	0
6	4206435	.	G	A	5	5	10	0	0	10	0	0
6	4219856	.	G	A	9	9	18	0	0	18	0	0
6	4229789	.	T	C	4	3	7	0	1	8	0	0
6	4229790	.	T	C	5	3	8	0	0	8	0	0
6	4229830	.	C	T	5	3	8	0	0	8	0	0
6	4229854	.	A	G	5	5	10	0	0	10	0	0
6	4241945	.	C	T	1	5	6	0	0	6	0	0
6	4241954	.	A	G	1	6	7	0	0	7	0	0
6	4245276	.	C	T	8	8	16	0	0	16	0	0
6	4246466	.	T	C	5	2	7	0	1	8	0	0
6	4246496	.	G	A	1	7	8	0	5	13	0	0
6	4247099	.	A	T	0	7	7	0	0	7	0	0
6	4247928	.	C	T	1	5	6	1	1	8	0	0
6	4248307	.	G	A	1	2	3	0	4	7	0	0
6	4248399	.	A	T	3	2	5	0	0	5	0	0
6	4248412	.	T	A	2	3	5	0	1	6	0	0
6	4249420	.	C	T	3	4	7	0	0	7	0	0
6	4249437	.	A	G	2	3	5	0	0	5	0	0
6	4249684	.	A	G	7	3	10	0	0	10	0	0
6	4249821	.	G	A	2	1	3	0	1	4	0	0
6	4303233	.	A	G	1	0	1	0	4	5	0	0
6	4311662	.	T	A	1	2	3	0	0	3	0	0
6	4314415	.	A	T	2	2	4	0	0	4	0	0
6	4314446	.	C	T	1	5	6	0	0	6	0	0
6	4314593	.	C	A	2	2	4	0	0	4	0	0
6	4319379	.	G	A	1	3	4	0	1	5	0	0
6	4319805	.	C	A	2	2	4	0	0	4	0	0
6	4322404	.	G	A	1	2	3	0	3	6	0	0
6	4329801	.	C	T	3	2	5	0	0	5	0	0
6	4332730	.	G	A	0	3	3	0	4	7	0	0
6	4334616	.	T	G	3	0	3	0	4	7	0	0
6	4337436	.	C	T	3	2	5	0	0	5	0	0
6	4337442	.	C	T	3	3	6	0	0	6	0	0
6	4341944	.	G	A	4	6	10	0	1	11	0	0
6	4349060	.	A	G	6	5	11	0	0	11	0	0
6	4352140	.	G	T	5	6	11	0	2	13	0	0
6	4357277	.	C	T	3	2	5	0	0	5	0	0
6	4357299	.	G	A	2	4	6	0	0	6	0	0
6	4359773	.	G	A	5	4	9	0	0	9	0	0
6	4359857	.	C	G	4	7	11	0	1	12	0	0
6	4360110	.	C	T	1	5	6	0	1	7	0	0
6	4365163	.	C	T	3	6	9	0	1	10	0	0
6	4365295	.	G	C	9	13	22	0	2	24	0	0
6	4376831	.	T	C	11	6	17	0	0	17	0	0
6	4376849	.	G	A	0	9	9	0	7	16	0	0
6	4376894	.	G	A	6	9	15	0	0	15	0	0
6	4377182	.	A	G	4	5	9	0	0	9	0	0
6	4379559	.	G	C	10	7	17	0	0	17	0	0
6	4379760	.	G	A	1	9	10	0	6	16	0	0
6	4386999	.	C	T	4	6	10	0	0	10	0	0
6	4389434	.	G	A	10	15	25	0	0	25	0	0
6	4389436	.	T	C	16	10	26	0	0	26	0	0
6	4392639	.	C	T	5	5	10	0	0	10	0	0
6	4397173	.	G	A	8	10	18	0	0	18	0	0
6	4397181	.	C	A	9	9	18	0	1	19	0	0
6	4397262	.	C	T	11	14	25	0	0	25	0	0
6	4398906	.	C	T	12	6	18	0	0	18	0	0
6	4398939	.	A	C	11	6	17	0	0	17	0	0
6	4400803	.	T	A	13	5	18	0	0	18	0	0
6	4400999	.	C	T	4	7	11	0	1	12	0	0
6	4416859	.	G	A	5	4	9	0	0	9	0	0
6	4531158	.	T	C	4	2	6	0	1	7	0	0
6	4540422	.	A	G	6	3	9	0	0	9	0	0
6	4541178	.	T	C	8	3	11	0	1	12	0	0
6	4542492	.	A	G	1	0	1	0	5	6	0	0
6	4542573	.	A	C	5	7	12	0	0	12	0	0
6	4873119	.	G	A	1	3	4	0	1	5	0	0
6	4873321	.	C	G	5	2	7	0	0	7	0	0
6	4874434	.	T	C	5	5	10	0	0	10	0	0
6	4874563	.	C	T	4	4	8	0	1	9	0	0
6	4874821	.	G	C	3	5	8	0	0	8	0	0
6	4875031	.	G	A	1	8	9	0	5	14	0	0
6	4875292	.	C	T	7	3	10	0	0	10	0	0
6	4876522	.	G	C	1	6	7	0	10	17	0	0
6	4876738	.	G	A	14	9	23	0	2	25	0	0
6	4876946	.	C	A	3	8	11	0	2	13	0	0
6	4877023	.	C	T	6	5	11	0	0	11	0	0
6	6231117	.	T	C	3	2	5	0	0	5	0	0
6	6231244	.	T	C	5	3	8	0	0	8	0	0
6	6231262	.	T	C	2	4	6	0	0	6	0	0
6	6231321	.	C	A	3	4	7	0	0	7	0	0
6	6231337	.	A	C	3	5	8	0	0	8	0	0
6	6232301	.	A	C	25	29	54	0	0	54	0	0
6	6232315	.	T	C	23	0	23	0	30	53	0	0
6	6234779	.	A	G	23	23	46	0	4	50	0	0
6	6235307	.	G	A	30	17	47	0	2	49	0	0
6	6248833	.	G	A	2	2	4	0	0	4	0	0
6	6258045	.	G	C	5	0	5	0	16	21	0	0
6	6258130	.	C	T	12	9	21	0	0	21	0	0
6	6258240	.	A	G	2	11	13	0	0	13	0	0
6	6270811	.	C	G	1	3	4	0	0	4	0	0
6	6270833	.	T	G	1	2	3	0	0	3	0	0
6	6270882	.	G	C	18	29	47	0	3	51	1	0
6	6273345	.	C	T	29	38	67	0	2	69	0	0
6	6273396	.	C	T	28	30	58	0	1	59	0	0
6	6275599	.	A	G	4	4	8	0	1	9	0	0
6	6275667	.	C	T	3	6	9	0	0	9	0	0
6	6275668	.	A	G	3	6	9	0	0	9	0	0
6	6284114	.	A	G	5	10	15	0	0	15	0	0
6	6293926	.	T	C	4	0	4	0	4	8	0	0
6	6317168	.	G	A	2	4	6	0	0	6	0	0
6	6317189	.	C	T	3	2	5	0	0	5	0	0
6	6319737	.	C	T	2	4	6	0	0	6	0	0
6	6331764	.	A	G	3	2	5	0	0	5	0	0
6	6395035	.	T	G	4	5	9	0	0	9	0	0
6	6395096	.	C	T	1	6	7	0	3	10	0	0
6	6395099	.	C	T	6	4	10	0	0	10	0	0
6	6395211	.	T	A	9	4	13	0	0	13	0	0
6	6395222	.	T	A	8	5	13	0	1	14	0	0
6	6395367	.	C	T	0	8	8	0	4	12	0	0
6	6423827	.	C	T	0	3	3	0	6	9	0	0
6	6459235	.	T	C	6	7	13	0	1	14	0	0
6	6459315	.	G	A	7	5	12	0	1	13	0	0
6	6466502	.	C	T	5	6	11	0	1	12	0	0
6	6467931	.	C	T	1	5	6	0	9	15	0	0
6	6470529	.	G	A	8	5	13	0	1	14	0	0
6	6471174	.	C	G	5	4	9	0	1	10	0	0
6	6471486	.	G	A	5	3	8	0	0	8	0	0
6	6471726	.	T	C	4	2	6	0	0	6	0	0
6	6471843	.	T	G	8	4	12	0	1	13	0	0
6	6471875	.	C	G	4	6	10	0	0	10	0	0
6	6472040	.	T	G	10	4	14	0	0	14	0	0
6	6472059	.	T	A	8	4	12	0	0	12	0	0
6	6472177	.	T	C	4	5	9	0	1	10	0	0
6	6475515	.	C	T	0	5	5	0	2	7	0	0
6	6475576	.	G	T	8	4	12	0	0	12	0	0
6	6475578	.	G	T	4	8	12	0	0	12	0	0
6	6475712	.	C	T	5	4	9	0	0	9	0	0
6	6475740	.	T	A	6	4	10	0	0	10	0	0
6	6477578	.	C	A	0	2	2	0	3	5	0	0
6	6480100	.	T	A	1	7	8	0	0	8	0	0
6	6480405	.	G	A	3	2	5	0	0	5	0	0
6	6480417	.	G	A	4	2	6	0	0	6	0	0
6	6480583	.	A	G	6	4	10	0	0	10	0	0
6	6482512	.	C	T	4	6	10	0	0	10	0	0
6	6498842	.	C	T	1	1	2	0	1	3	0	0
6	6539842	.	T	G	1	0	1	0	5	6	0	0
6	6539848	.	T	A	1	5	6	0	0	6	0	0
6	6540903	.	A	G	2	4	6	0	0	6	0	0
6	6540964	.	T	A	1	3	4	0	0	4	0	0
6	6541039	.	C	T	2	5	7	0	0	7	0	0
6	6541128	.	G	A	1	1	2	0	1	3	0	0
6	6541360	.	T	C	3	4	7	0	0	7	0	0
6	6541369	.	A	G	2	0	2	0	3	5	0	0
6	6666313	.	T	C	0	3	3	0	1	4	0	0
6	6666322	.	T	A	1	2	3	0	1	4	0	0
6	6669743	.	G	A	4	3	7	0	0	7	0	0
6	6671545	.	G	C	8	7	15	0	0	15	0	0
6	6671769	.	T	A	5	4	9	0	1	10	0	0
6	6673527	.	C	A	5	5	10	0	1	11	0	0
6	6737391	.	C	T	13	12	25	0	0	25	0	0
6	6737401	.	G	T	14	11	25	0	1	26	0	0
6	6737982	.	T	A	15	20	35	0	0	35	0	0
6	6737998	.	C	T	2	20	22	0	20	42	0	0
6	6769345	.	T	A	11	7	18	0	1	19	0	0
6	6769716	.	C	T	11	15	26	0	0	26	0	0
6	6769719	.	T	C	11	17	28	0	0	28	0	0
6	6769782	.	A	G	13	8	21	0	0	21	0	0
6	6775689	.	G	T	11	5	16	0	2	18	0	0
6	6784095	.	G	A	4	6	10	0	0	10	0	0
6	6784239	.	G	C	8	10	18	0	1	19	0	0
6	6785788	.	G	A	7	9	16	0	0	16	0	0
6	6793164	.	C	T	13	9	22	0	0	22	0	0
6	6793224	.	G	A	1	9	10	0	5	15	0	0
6	6795520	.	T	A	3	5	8	0	0	8	0	0
6	6795526	.	C	T	4	3	7	0	1	8	0	0
6	6795664	.	T	C	7	4	11	0	0	11	0	0
6	6796229	.	G	A	1	2	3	0	1	4	0	0
6	6797583	.	A	G	6	6	12	0	0	12	0	0
6	6797598	.	T	C	8	8	16	0	0	16	0	0
6	6797694	.	T	A	9	6	15	0	0	15	0	0
6	6803726	.	T	A	17	10	27	0	0	27	0	0
6	6805245	.	C	T	8	12	20	0	0	20	0	0
6	6805275	.	G	A	10	11	21	0	0	21	0	0
6	6805572	.	G	T	13	13	26	0	0	27	1	0
6	6807004	.	C	T	3	2	5	0	0	5	0	0
6	6808431	.	C	G	1	5	6	0	0	6	0	0
6	6900767	.	T	C	6	4	10	0	1	11	0	0
6	6903468	.	C	T	8	7	15	0	1	16	0	0
6	6905848	.	G	A	0	5	5	0	3	8	0	0
6	6908955	.	A	G	1	3	4	0	1	5	0	0
6	6909792	.	G	A	6	4	10	0	1	11	0	0
6	6916417	.	A	G	7	0	7	0	12	19	0	0
6	6919866	.	G	T	0	14	14	0	4	18	0	0
6	6920171	.	C	T	2	2	4	0	0	4	0	0
6	6920938	.	G	A	4	3	7	0	0	7	0	0
6	6921577	.	C	T	7	7	14	0	1	15	0	0
6	6921581	.	T	C	8	7	15	0	0	15	0	0
6	6921802	.	G	A	18	19	37	1	2	40	0	0
6	6921889	.	T	A	15	7	22	0	4	26	0	0
6	6922072	.	G	T	10	9	19	0	0	19	0	0
6	6922187	.	T	C	12	7	19	0	1	20	0	0
6	6967024	.	C	T	4	2	6	0	0	6	0	0
6	6973009	.	A	T	11	6	17	0	0	17	0	0
6	6973383	.	G	T	5	9	14	20	2	36	0	0
6	7089952	.	C	G	4	8	12	0	0	12	0	0
6	7105400	.	C	T	2	6	8	0	0	8	0	0
6	7107034	.	A	G	2	6	8	0	0	8	0	0
6	7110148	.	C	T	9	6	15	0	0	15	0	0
6	7110434	.	C	T	10	13	23	0	1	24	0	0
6	7110435	.	T	G	11	13	24	0	0	24	0	0
6	7110551	.	C	T	21	19	40	0	0	40	0	0
6	7113001	.	T	G	12	10	22	0	3	25	0	0
6	7114482	.	C	T	14	12	26	0	1	27	0	0
6	7114937	.	A	G	10	17	27	0	2	29	0	0
6	7115967	.	T	C	21	9	30	0	2	32	0	0
6	7118398	.	A	C	11	9	20	0	1	21	0	0
6	7133402	.	C	T	0	4	4	0	2	6	0	0
6	7133424	.	A	C	3	3	6	0	0	6	0	0
6	7133449	.	A	T	2	4	6	0	0	6	0	0
6	7157570	.	G	A	9	7	16	0	1	17	0	0
6	7157615	.	C	T	11	5	16	0	1	17	0	0
6	7157771	.	G	A	4	4	8	0	0	8	0	0
6	7207934	.	G	A	1	6	7	0	0	7	0	0
6	7251362	.	A	T	3	4	7	0	0	7	0	0
6	7251426	.	A	G	4	3	7	0	0	7	0	0
6	7251564	.	G	A	8	5	13	0	0	13	0	0
6	7251627	.	A	G	10	8	18	0	0	18	0	0
6	7251694	.	G	A	4	6	10	0	1	11	0	0
6	7265179	.	G	A	4	3	7	0	1	8	0	0
6	7270355	.	T	C	6	6	12	0	0	12	0	0
6	7273005	.	A	G	4	0	4	0	6	10	0	0
6	7273021	.	C	T	6	8	14	0	0	14	0	0
6	7273512	.	T	A	2	3	5	0	2	7	0	0
6	7273518	.	G	A	0	5	5	0	2	7	0	0
6	7276139	.	T	C	4	2	6	0	0	6	0	0
6	7276178	.	T	A	8	8	16	0	0	17	1	0
6	7276212	.	C	T	11	10	21	0	1	23	1	0
6	7276263	.	G	A	1	6	7	0	12	19	0	0
6	7276776	.	A	C	5	3	8	0	0	8	0	0
6	7380404	.	T	C	2	2	4	0	0	4	0	0
6	7390418	.	C	T	2	2	4	0	0	4	0	0
6	7390419	.	A	G	2	2	4	0	0	4	0	0
6	7435565	.	C	T	5	8	13	0	0	13	0	0
6	7438474	.	C	T	5	6	11	0	0	11	0	0
6	7444930	.	T	C	17	10	27	0	0	27	0	0
6	7451563	.	T	G	19	14	33	0	0	33	0	0
6	7452519	.	T	C	14	17	31	0	1	32	0	0
6	7453379	.	T	G	20	0	20	2	19	41	0	0
6	7453567	.	G	T	18	9	27	1	0	28	0	0
6	7453649	.	C	G	18	10	28	0	1	29	0	0
6	7453660	.	C	T	16	11	27	0	2	29	0	0
6	7529925	.	T	C	2	3	5	0	0	5	0	0
6	7530494	.	T	A	1	1	2	0	1	3	0	0
6	7530577	.	A	G	4	4	8	0	0	8	0	0
6	7530712	.	C	T	1	2	3	0	0	3	0	0
6	7531043	.	T	C	1	1	2	0	1	3	0	0
6	7531396	.	T	C	1	2	3	0	0	3	0	0
6	7542491	.	G	T	1	13	14	0	12	26	0	0
6	7545794	.	C	T	11	14	25	0	2	27	0	0
6	7545824	.	T	C	12	14	26	0	0	26	0	0
6	7547451	.	C	T	9	9	18	0	0	18	0	0
6	7549967	.	G	A	20	23	43	0	2	45	0	0
6	7550040	.	A	C	3	1	4	0	15	19	0	0
6	7550046	.	A	C	7	4	11	0	11	22	0	0
6	7550210	.	A	C	12	9	21	0	1	22	0	0
6	7550405	.	C	T	20	7	27	0	1	28	0	0
6	7551087	.	C	A	3	2	5	0	0	5	0	0
6	7555618	.	C	T	6	8	14	0	0	14	0	0
6	7555634	.	G	T	8	6	14	0	1	15	0	0
6	7555871	.	G	A	6	6	12	0	0	12	0	0
6	7591018	.	G	A	4	4	8	0	0	8	0	0
6	7624322	.	C	T	6	6	12	0	0	12	0	0
6	7624725	.	T	C	7	8	15	0	0	15	0	0
6	7626457	.	C	T	8	6	14	0	0	14	0	0
6	7633452	.	G	C	2	8	10	0	11	21	0	0
6	7636811	.	A	T	9	12	21	0	3	24	0	0
6	7637195	.	C	T	19	15	34	0	0	34	0	0
6	7638717	.	G	A	15	13	28	0	3	31	0	0
6	7645319	.	T	C	20	14	34	0	0	34	0	0
6	7646039	.	A	G	19	16	35	0	1	36	0	0
6	7646102	.	G	A	16	20	36	0	0	36	0	0
6	7646111	.	G	C	15	19	34	0	1	35	0	0
6	7648224	.	A	G	15	1	16	2	11	29	0	0
6	7652458	.	C	T	17	20	37	0	3	40	0	0
6	7652470	.	A	C	20	19	39	0	0	39	0	0
6	7652896	.	G	A	3	18	21	0	20	41	0	0
6	7652959	.	C	T	30	13	43	0	4	47	0	0
6	7656920	.	A	G	15	3	18	1	31	50	0	0
6	7656932	.	A	G	14	34	48	1	2	51	0	0
6	7657177	.	C	T	13	10	23	0	0	23	0	0
6	7657793	.	A	C	21	9	30	0	0	30	0	0
6	7657886	.	T	A	20	16	36	0	2	38	0	0
6	7657887	.	G	T	20	16	36	0	2	38	0	0
6	7657972	.	T	G	12	13	25	0	1	26	0	0
6	7658076	.	G	A	14	10	24	0	1	25	0	0
6	7659915	.	G	A	1	4	5	0	0	5	0	0
6	7660119	.	A	G	8	10	18	0	1	19	0	0
6	7660300	.	T	C	4	1	5	0	3	8	0	0
6	7660369	.	T	C	1	3	4	0	1	5	0	0
6	7660458	.	A	C	5	2	7	0	9	16	0	0
6	7660659	.	C	A	0	5	5	0	2	7	0	0
6	7660707	.	C	T	0	4	4	0	5	9	0	0
6	7679455	.	G	A	3	3	6	0	0	6	0	0
6	7682793	.	C	A	0	2	2	0	3	5	0	0
6	7686080	.	G	A	2	2	4	0	0	4	0	0
6	7688598	.	C	T	0	2	2	0	4	6	0	0
6	7688757	.	A	C	2	0	2	0	4	6	0	0
6	7697573	.	G	A	7	4	11	0	0	11	0	0
6	7699948	.	C	T	4	4	8	1	0	9	0	0
6	7702770	.	G	T	8	4	12	0	0	12	0	0
6	7705984	.	G	A	7	5	12	0	0	12	0	0
6	7711166	.	T	C	1	2	3	0	0	3	0	0
6	7711239	.	G	A	2	2	4	0	0	4	0	0
6	7713433	.	G	A	27	23	50	0	4	54	0	0
6	7721530	.	T	A	8	9	17	1	0	18	0	0
6	7721860	.	G	A	6	7	13	0	2	15	0	0
6	7721906	.	G	A	7	16	23	0	1	24	0	0
6	7721958	.	C	A	14	17	31	0	1	32	0	0
6	7722143	.	G	T	16	15	31	0	1	32	0	0
6	7722159	.	A	T	15	12	27	0	6	33	0	0
6	7722195	.	G	T	18	9	27	0	1	28	0	0
6	7722205	.	G	A	17	8	25	0	2	27	0	0
6	7722333	.	G	A	9	7	16	0	0	16	0	0
6	7722387	.	T	C	9	6	15	1	4	20	0	0
6	7722402	.	T	C	11	9	20	1	0	21	0	0
6	7722467	.	T	A	17	6	23	1	2	26	0	0
6	7722577	.	C	T	1	11	12	0	11	23	0	0
6	7722921	.	A	T	2	1	3	0	1	4	0	0
6	7723008	.	G	T	7	10	17	0	0	17	0	0
6	7723155	.	A	C	10	8	18	0	0	18	0	0
6	7723850	.	C	T	1	5	6	1	9	16	0	0
6	7723961	.	G	A	6	12	18	0	0	18	0	0
6	7726824	.	G	A	8	16	24	0	0	24	0	0
6	7734250	.	A	C	3	4	7	0	0	7	0	0
6	7734271	.	C	A	2	6	8	0	0	8	0	0
6	7795698	.	C	T	21	11	32	0	8	40	0	0
6	7842013	.	C	T	2	8	10	0	14	24	0	0
6	7842034	.	C	A	14	7	21	0	1	22	0	0
6	8140859	.	C	T	1	2	3	0	0	3	0	0
6	8154656	.	T	C	2	2	4	0	0	4	0	0
6	8176101	.	A	G	7	6	13	0	1	14	0	0
6	8176575	.	C	T	6	8	14	0	0	14	0	0
6	8177030	.	T	C	12	12	24	0	0	24	0	0
6	8177399	.	T	C	16	9	25	0	0	25	0	0
6	8177600	.	T	C	13	13	26	0	1	27	0	0
6	8177678	.	C	T	14	9	23	0	0	23	0	0
6	8178002	.	T	C	25	10	35	0	1	36	0	0
6	8178053	.	G	A	1	19	20	0	10	30	0	0
6	8178113	.	T	C	11	11	22	0	4	26	0	0
6	8178351	.	G	A	11	11	22	0	0	22	0	0
6	8179022	.	G	T	3	13	16	0	25	41	0	0
6	8179205	.	A	T	14	17	31	0	3	34	0	0
6	8179373	.	G	A	20	12	32	0	2	34	0	0
6	8179683	.	A	T	5	4	9	0	2	11	0	0
6	8210404	.	C	T	2	4	6	0	0	6	0	0
6	8210902	.	C	G	3	2	5	0	0	5	0	0
6	8211075	.	C	T	4	7	11	0	2	13	0	0
6	8211106	.	T	C	1	5	6	0	0	6	0	0
6	8211143	.	A	T	4	3	7	0	0	7	0	0
6	8211154	.	T	C	3	2	5	0	0	5	0	0
6	8211253	.	G	A	5	7	12	0	0	12	0	0
6	8212174	.	G	A	2	4	6	0	0	6	0	0
6	8214118	.	T	C	6	2	8	0	1	9	0	0
6	8214947	.	T	C	5	0	5	0	3	8	0	0
6	8217870	.	G	A	1	3	4	0	0	4	0	0
6	8224881	.	A	G	1	3	4	0	0	4	0	0
6	8262499	.	A	C	1	2	3	0	0	3	0	0
6	8265214	.	G	A	4	5	9	0	0	9	0	0
6	8265282	.	G	A	3	7	10	0	0	10	0	0
6	8267111	.	C	T	16	17	33	0	1	34	0	0
6	8267266	.	A	G	17	19	36	0	1	37	0	0
6	8267284	.	G	A	14	17	31	0	2	33	0	0
6	8267307	.	G	C	12	15	27	0	1	28	0	0
6	8267352	.	A	T	17	15	32	0	2	35	1	0
6	8267519	.	G	A	20	15	35	0	5	40	0	0
6	8267563	.	G	T	29	15	44	0	0	44	0	0
6	8267635	.	T	C	18	26	44	0	2	46	0	0
6	8267795	.	T	A	9	11	20	0	0	20	0	0
6	8267880	.	G	A	15	10	25	0	0	25	0	0
6	8268529	.	A	G	18	9	27	0	1	28	0	0
6	8273066	.	G	A	8	12	20	0	1	21	0	0
6	8277141	.	C	A	7	10	17	0	1	18	0	0
6	8282275	.	A	G	3	7	10	0	2	12	0	0
6	8283360	.	A	G	3	4	7	0	0	7	0	0
6	8289112	.	G	A	6	3	9	0	1	10	0	0
6	8291791	.	A	G	2	3	5	1	0	6	0	0
6	8310840	.	C	T	4	2	6	0	0	6	0	0
6	8315076	.	A	G	11	19	30	0	3	33	0	0
6	8315078	.	A	G	13	19	32	0	1	33	0	0
6	8316947	.	A	G	5	9	14	0	1	15	0	0
6	8318001	.	T	C	7	11	18	0	2	20	0	0
6	8318037	.	G	A	0	13	13	0	8	21	0	0
6	8328181	.	G	T	13	13	26	0	0	26	0	0
6	8328434	.	A	G	1	2	3	0	0	3	0	0
6	8366006	.	A	T	5	11	16	0	2	18	0	0
6	8366167	.	C	T	18	13	31	0	0	31	0	0
6	8370489	.	T	C	11	10	21	0	3	24	0	0
6	8374716	.	G	A	2	6	8	0	0	8	0	0
6	8375089	.	C	T	18	8	26	0	1	27	0	0
6	8380345	.	G	A	3	3	6	0	0	6	0	0
6	8380433	.	G	C	5	5	10	0	0	10	0	0
6	8391629	.	C	T	1	6	7	0	15	22	0	0
6	8392005	.	G	A	7	11	18	0	2	20	0	0
6	8453747	.	C	T	1	4	5	0	0	5	0	0
6	8455483	.	T	C	1	0	1	0	4	5	0	0
6	8457125	.	T	C	3	4	7	0	0	7	0	0
6	8460400	.	A	T	4	2	6	0	0	6	0	0
6	8460435	.	G	T	3	2	5	0	0	5	0	0
6	8460493	.	G	T	1	3	4	0	1	5	0	0
6	8460603	.	T	G	2	2	4	0	1	5	0	0
6	8460622	.	T	C	4	0	4	0	3	7	0	0
6	8463698	.	A	G	1	2	3	0	0	3	0	0
6	8465662	.	A	G	3	3	6	0	0	6	0	0
6	8501017	.	A	G	1	2	3	0	0	3	0	0
6	8512263	.	A	G	1	2	3	0	0	3	0	0
6	8518746	.	T	C	1	3	4	0	0	4	0	0
6	8518776	.	C	G	3	4	7	0	0	7	0	0
6	8518808	.	G	A	3	4	7	0	0	7	0	0
6	9969372	.	A	G	5	2	7	0	0	7	0	0
6	10008329	.	G	A	2	20	22	0	14	36	0	0
6	10008398	.	A	G	29	13	42	0	4	46	0	0
6	10008407	.	C	T	28	13	41	0	3	44	0	0
6	10009850	.	C	T	28	21	49	0	0	49	0	0
6	10009903	.	A	T	15	24	39	0	2	41	0	0
6	10015551	.	T	C	7	6	13	0	1	14	0	0
6	10015602	.	T	C	32	16	48	0	3	51	0	0
6	10015794	.	A	T	18	24	42	1	9	52	0	0
6	10015902	.	A	T	36	19	55	0	3	59	1	0
6	10015952	.	C	A	32	29	61	0	1	62	0	0
6	10015992	.	A	C	34	33	67	0	0	67	0	0
6	10015993	.	G	A	33	31	64	0	3	67	0	0
6	10016114	.	C	T	28	39	67	0	2	69	0	0
6	10016116	.	C	A	28	36	64	0	5	69	0	0
6	10016174	.	T	G	37	22	59	3	12	74	0	0
6	10016363	.	T	G	28	29	57	2	3	62	0	0
6	10020055	.	G	A	33	31	64	0	4	68	0	0
6	10026677	.	C	T	28	33	61	0	2	63	0	0
6	10026818	.	G	A	9	6	15	0	0	15	0	0
6	10028949	.	C	T	1	3	4	0	1	5	0	0
6	10029332	.	G	A	4	2	6	0	0	6	0	0
6	10032925	.	T	G	6	4	10	0	0	10	0	0
6	10032932	.	C	T	6	4	10	0	0	10	0	0
6	10037073	.	T	C	3	2	5	0	0	5	0	0
6	10037111	.	T	C	2	2	4	0	0	4	0	0
6	10045449	.	G	T	18	12	30	0	0	30	0	0
6	10047204	.	T	C	15	10	25	0	1	26	0	0
6	10047805	.	G	A	15	17	32	0	3	35	0	0
6	10047814	.	T	C	11	21	32	0	1	33	0	0
6	10050050	.	G	A	23	18	41	0	0	41	0	0
6	10056466	.	G	T	19	19	38	0	1	39	0	0
6	10085418	.	C	T	1	2	3	0	1	4	0	0
6	10085495	.	A	G	2	3	5	0	0	5	0	0
6	10087986	.	A	C	4	5	9	0	0	9	0	0
6	10087995	.	G	A	4	3	7	0	0	7	0	0
6	10088076	.	T	C	3	2	5	0	0	5	0	0
6	10248476	.	T	A	22	11	33	0	2	35	0	0
6	10248530	.	A	G	17	18	35	0	2	37	0	0
6	10248546	.	T	C	13	0	13	0	18	31	0	0
6	10248596	.	T	C	15	19	34	0	2	36	0	0
6	10248980	.	A	G	10	9	19	0	0	19	0	0
6	10249451	.	A	G	11	9	20	0	1	21	0	0
6	10251188	.	C	A	13	9	22	0	2	24	0	0
6	10257886	.	A	G	7	4	11	0	0	11	0	0
6	10264656	.	T	C	9	1	10	0	6	16	0	0
6	10283118	.	T	A	6	2	8	0	0	8	0	0
6	10283462	.	A	G	6	7	13	0	1	14	0	0
6	10288771	.	G	A	2	2	4	0	1	5	0	0
6	10301763	.	G	A	2	6	8	0	0	8	0	0
6	10305813	.	T	G	2	2	4	0	0	5	1	0
6	10305821	.	A	G	3	2	5	0	0	5	0	0
6	10305922	.	G	A	5	4	9	0	0	9	0	0
6	10320418	.	A	G	7	4	11	0	0	11	0	0
6	10354469	.	T	C	4	4	8	0	0	8	0	0
6	10354530	.	T	C	1	5	6	0	1	7	0	0
6	10512858	.	C	T	6	7	13	0	2	15	0	0
6	10512903	.	C	G	10	3	13	0	1	14	0	0
6	10513182	.	C	G	5	7	12	0	0	12	0	0
6	10522332	.	C	T	7	8	15	0	0	15	0	0
6	10540300	.	A	T	2	7	9	0	1	10	0	0
6	10547409	.	C	T	2	5	7	0	0	7	0	0
6	10547502	.	T	G	4	0	4	0	7	11	0	0
6	10547556	.	T	C	3	7	10	0	0	10	0	0
6	10564408	.	C	T	6	4	10	0	1	11	0	0
6	10564426	.	T	C	7	6	13	0	0	13	0	0
6	10567861	.	C	T	5	7	12	0	0	12	0	0
6	10570843	.	C	T	9	6	15	0	0	15	0	0
6	10576573	.	A	G	3	0	3	0	7	10	0	0
6	10701627	.	C	T	6	5	11	0	0	11	0	0
6	10701642	.	C	A	0	8	8	0	5	13	0	0
6	10702203	.	T	C	3	0	3	0	5	8	0	0
6	10702244	.	T	C	2	0	2	0	6	8	0	0
6	10702269	.	T	A	7	2	9	0	0	9	0	0
6	10713784	.	G	A	2	5	7	0	0	7	0	0
6	10713810	.	G	T	6	2	8	0	0	8	0	0
6	10721767	.	C	T	17	0	17	0	0	17	0	0
6	10721971	.	T	G	4	11	15	1	2	18	0	0
6	10722541	.	G	A	12	15	27	0	0	27	0	0
6	10724275	.	G	A	7	10	17	0	0	17	0	0
6	10724336	.	C	T	1	8	9	0	12	21	0	0
6	10724591	.	G	T	11	17	28	0	0	28	0	0
6	10724645	.	A	T	14	6	20	0	2	22	0	0
6	10724665	.	G	A	12	13	25	0	0	25	0	0
6	10724765	.	G	A	7	6	13	0	3	16	0	0
6	10725365	.	T	C	6	0	6	0	5	11	0	0
6	10725506	.	T	C	3	6	9	0	0	9	0	0
6	10736615	.	T	C	5	5	10	0	0	10	0	0
6	10736746	.	C	T	2	6	8	0	5	13	0	0
6	10736760	.	A	C	4	7	11	0	0	11	0	0
6	10736798	.	T	A	5	3	8	0	0	8	0	0
6	10737000	.	C	A	1	4	5	1	4	10	0	0
6	10740119	.	T	G	3	3	6	0	2	8	0	0
6	10741483	.	T	C	2	2	4	0	0	4	0	0
6	10741616	.	A	G	0	2	2	0	1	3	0	0
6	10741636	.	C	G	2	0	2	0	1	3	0	0
6	10741916	.	G	C	7	9	16	0	1	17	0	0
6	10742120	.	T	C	28	24	52	0	0	52	0	0
6	10742121	.	G	A	28	23	51	0	1	52	0	0
6	10742306	.	A	G	31	29	60	0	1	61	0	0
6	10742318	.	G	A	28	30	58	0	0	58	0	0
6	10742497	.	T	C	24	0	24	0	26	50	0	0
6	10751216	.	G	A	10	15	25	2	3	30	0	0
6	10758459	.	A	C	2	0	2	0	3	5	0	0
6	10758866	.	A	T	5	6	11	0	0	11	0	0
6	10758890	.	A	C	8	0	8	0	3	11	0	0
6	10758927	.	A	G	10	2	12	0	0	12	0	0
6	10758946	.	G	A	0	5	5	0	0	5	0	0
6	10761181	.	C	G	2	3	5	0	0	5	0	0
6	10763977	.	A	G	5	5	10	0	0	10	0	0
6	10764001	.	A	G	6	5	11	0	0	11	0	0
6	10776227	.	A	T	3	3	6	0	0	6	0	0
6	10780694	.	A	G	2	7	9	0	0	9	0	0
6	10782416	.	T	G	2	3	5	0	0	5	0	0
6	10782960	.	C	G	1	2	3	0	0	3	0	0
6	10787844	.	T	C	2	0	2	0	3	5	0	0
6	10787853	.	T	A	3	1	4	0	0	4	0	0
6	10787952	.	G	A	3	2	5	0	0	5	0	0
6	10831093	.	G	A	28	33	61	1	3	65	0	0
6	10833078	.	T	C	25	0	25	0	26	51	0	0
6	10834821	.	G	C	36	31	67	0	3	70	0	0
6	10835676	.	G	A	2	5	7	0	0	7	0	0
6	10835700	.	T	A	2	5	7	0	0	7	0	0
6	10835721	.	A	G	4	5	9	0	0	9	0	0
6	10835788	.	G	A	4	3	7	0	0	7	0	0
6	10838690	.	C	T	0	2	2	0	3	5	0	0
6	10838716	.	A	C	4	4	8	0	0	8	0	0
6	10838741	.	G	A	4	3	7	0	1	8	0	0
6	10838753	.	T	C	4	4	8	0	1	9	0	0
6	10839332	.	A	G	1	7	8	0	1	9	0	0
6	10839370	.	A	C	2	4	6	0	0	6	0	0
6	10839885	.	C	A	2	12	14	0	13	27	0	0
6	10846001	.	G	A	12	12	24	0	0	24	0	0
6	10859011	.	G	A	6	3	9	0	0	9	0	0
6	10872687	.	T	C	11	11	22	0	0	22	0	0
6	10877269	.	A	G	18	19	37	0	0	37	0	0
6	10879525	.	T	C	22	15	37	0	0	37	0	0
6	10879633	.	T	C	21	21	42	0	0	42	0	0
6	10879679	.	G	A	12	20	32	0	0	32	0	0
6	10879816	.	A	T	10	12	22	0	0	22	0	0
6	10879833	.	A	G	10	1	11	0	12	23	0	0
6	10910627	.	G	A	2	2	4	0	0	4	0	0
6	10910684	.	G	A	2	8	10	0	2	12	0	0
6	10910784	.	C	A	22	18	40	0	0	40	0	0
6	10911066	.	T	C	17	35	52	0	2	56	2	0
6	10911198	.	A	G	28	44	72	0	0	72	0	0
6	10912341	.	G	A	26	20	46	0	2	48	0	0
6	10982984	.	G	T	1	5	6	0	0	6	0	0
6	10983337	.	T	A	4	2	6	0	0	6	0	0
6	10983433	.	A	C	2	5	7	0	0	7	0	0
6	11067142	.	T	A	1	3	4	0	0	4	0	0
6	11067144	.	C	G	0	3	3	0	1	4	0	0
6	11067436	.	A	C	1	4	5	0	0	5	0	0
6	11067480	.	A	G	1	3	4	0	1	5	0	0
6	11071222	.	A	G	21	33	54	1	2	57	0	0
6	11101781	.	T	C	5	9	14	0	1	15	0	0
6	11101790	.	C	T	0	10	10	0	6	16	0	0
6	11101852	.	G	A	9	12	21	0	0	21	0	0
6	11106924	.	C	G	4	6	10	0	0	10	0	0
6	11107167	.	G	C	11	0	11	0	8	19	0	0
6	11107233	.	C	A	3	5	8	0	1	9	0	0
6	11107326	.	T	C	4	0	4	0	4	8	0	0
6	11113091	.	A	G	1	7	8	0	0	8	0	0
6	11120420	.	G	A	7	2	9	0	0	9	0	0
6	11122579	.	A	G	8	4	12	0	0	12	0	0
6	11122682	.	T	C	6	0	6	0	3	9	0	0
6	11122754	.	G	A	2	7	9	0	0	9	0	0
6	11125254	.	A	G	1	3	4	0	0	4	0	0
6	11129033	.	G	A	4	5	9	0	0	9	0	0
6	11129105	.	C	T	1	3	4	0	0	4	0	0
6	11129203	.	A	G	4	3	7	0	1	8	0	0
6	11129282	.	C	T	0	2	2	0	2	4	0	0
6	11129357	.	T	C	3	2	5	0	0	5	0	0
6	11129447	.	A	T	5	6	11	0	0	11	0	0
6	11141282	.	T	C	4	2	6	0	1	7	0	0
6	11250427	.	A	T	7	6	13	0	1	14	0	0
6	11250462	.	C	T	17	9	26	0	0	26	0	0
6	11250973	.	T	C	2	9	11	0	1	12	0	0
6	11252838	.	C	A	9	12	21	0	1	22	0	0
6	11252883	.	A	G	14	7	21	0	0	21	0	0
6	11253881	.	T	C	11	11	22	0	1	23	0	0
6	11253890	.	C	T	10	11	21	0	1	22	0	0
6	11254142	.	T	G	6	0	6	0	6	12	0	0
6	11254358	.	A	G	9	0	9	0	9	18	0	0
6	11254526	.	C	T	6	11	17	0	0	17	0	0
6	11257827	.	G	A	0	20	20	0	16	36	0	0
6	11257866	.	G	C	3	11	14	0	15	29	0	0
6	11257917	.	T	A	12	17	29	0	0	29	0	0
6	11259970	.	C	A	18	15	33	0	2	35	0	0
6	11265612	.	G	T	1	8	9	0	19	28	0	0
6	11265681	.	T	A	23	12	35	0	2	37	0	0
6	11265717	.	T	C	23	8	31	0	2	33	0	0
6	11266255	.	C	T	11	17	28	0	1	29	0	0
6	11266490	.	A	T	11	5	16	0	0	16	0	0
6	11266496	.	T	C	10	6	16	0	0	16	0	0
6	11276827	.	T	A	6	3	9	0	0	9	0	0
6	11276912	.	A	G	3	5	8	0	0	8	0	0
6	11279804	.	T	C	4	4	8	0	0	8	0	0
6	11279815	.	T	C	4	5	9	0	1	10	0	0
6	11281923	.	A	G	3	7	10	0	0	10	0	0
6	11285310	.	C	T	6	5	11	0	0	11	0	0
6	11285362	.	T	C	8	0	8	0	4	12	0	0
6	11285374	.	C	T	7	3	10	0	0	10	0	0
6	11285453	.	T	C	8	5	13	0	0	13	0	0
6	11285583	.	C	T	14	5	19	0	1	20	0	0
6	11285662	.	C	T	0	3	3	0	4	7	0	0
6	11285772	.	C	T	2	8	10	0	1	11	0	0
6	11287918	.	C	G	1	4	5	0	0	5	0	0
6	11288179	.	T	A	4	3	7	0	1	8	0	0
6	11288460	.	G	T	5	7	12	0	0	12	0	0
6	11288467	.	C	T	0	8	8	0	0	8	0	0
6	11288558	.	T	C	2	0	2	0	6	8	0	0
6	11295376	.	G	C	4	0	4	0	3	7	0	0
6	11295408	.	T	G	6	4	10	0	0	10	0	0
6	11295430	.	G	T	7	4	11	0	1	12	0	0
6	11295484	.	G	A	8	4	12	0	0	12	0	0
6	11295616	.	T	G	1	5	6	0	0	6	0	0
6	11298557	.	G	A	5	7	12	0	0	12	0	0
6	11299394	.	T	C	5	5	10	0	0	10	0	0
6	11299909	.	C	T	1	4	5	0	0	5	0	0
6	11320584	.	C	T	0	4	4	0	4	8	0	0
6	11322792	.	T	C	3	5	8	0	0	8	0	0
6	11322821	.	T	A	3	3	6	0	0	6	0	0
6	11326973	.	G	A	1	2	3	0	0	3	0	0
6	11330918	.	T	A	0	3	3	0	1	4	0	0
6	11330927	.	C	T	0	4	4	0	1	5	0	0
6	11331254	.	A	G	2	2	4	0	0	4	0	0
6	11334929	.	G	A	1	1	2	0	2	4	0	0
6	11340037	.	T	C	1	3	4	0	1	5	0	0
6	11397818	.	G	C	0	3	3	0	3	6	0	0
6	11398324	.	G	T	2	3	5	0	0	5	0	0
6	11403359	.	C	A	11	13	24	0	1	25	0	0
6	11407918	.	G	A	6	8	14	0	0	14	0	0
6	11407944	.	A	G	7	9	16	0	0	16	0	0
6	11407954	.	A	G	8	7	15	0	2	17	0	0
6	11410523	.	C	T	9	5	14	0	1	15	0	0
6	11413532	.	A	T	9	9	18	0	1	19	0	0
6	11414715	.	C	T	8	6	14	0	1	15	0	0
6	11414748	.	G	A	5	3	8	0	2	10	0	0
6	11414777	.	A	T	6	8	14	0	0	14	0	0
6	11414822	.	T	G	6	0	6	0	12	18	0	0
6	11415220	.	A	C	14	18	32	0	2	34	0	0
6	11415460	.	G	A	1	10	11	0	4	15	0	0
6	11486819	.	C	T	1	2	3	0	0	3	0	0
6	11504470	.	G	A	2	5	7	0	0	7	0	0
6	11540362	.	T	C	4	9	13	0	1	14	0	0
6	11765506	.	A	G	33	24	57	0	2	59	0	0
6	11766190	.	T	A	21	19	40	0	1	41	0	0
6	11766267	.	G	A	20	23	43	0	1	44	0	0
6	11766276	.	A	G	20	22	42	0	0	42	0	0
6	11766765	.	T	C	20	22	42	0	0	42	0	0
6	12503989	.	T	G	6	4	10	0	0	10	0	0
6	12504230	.	T	C	5	5	10	0	0	10	0	0
6	12504362	.	C	T	5	2	7	1	0	8	0	0
6	12529163	.	C	T	3	10	13	0	0	13	0	0
6	12529247	.	C	T	15	7	22	0	1	23	0	0
6	12550437	.	G	A	13	14	27	0	2	29	0	0
6	12550764	.	G	A	7	7	14	0	2	16	0	0
6	12550934	.	C	T	15	17	32	0	0	32	0	0
6	12620093	.	T	A	9	7	16	0	0	16	0	0
6	12627321	.	T	A	2	3	5	0	0	5	0	0
6	12629345	.	T	C	1	2	3	0	1	4	0	0
6	12633166	.	C	T	0	7	7	0	3	10	0	0
6	12670979	.	C	T	0	2	2	0	2	4	0	0
6	12680643	.	C	T	2	2	4	0	0	4	0	0
6	12681048	.	G	A	1	2	3	0	0	3	0	0
6	12684618	.	A	T	3	2	5	0	0	5	0	0
6	12684627	.	T	C	2	3	5	0	0	5	0	0
6	12701412	.	G	A	3	2	5	0	0	5	0	0
6	12701453	.	G	A	3	3	6	0	0	6	0	0
6	12797677	.	C	T	9	3	12	0	1	13	0	0
6	12797755	.	G	A	12	8	20	0	1	21	0	0
6	12797815	.	A	G	12	8	20	0	2	22	0	0
6	12798083	.	G	T	8	4	12	1	0	13	0	0
6	12798124	.	T	C	5	2	7	0	0	7	0	0
6	12803257	.	C	A	11	6	17	0	0	17	0	0
6	12803325	.	A	G	2	2	4	0	2	6	0	0
6	12803568	.	A	G	4	11	15	0	0	15	0	0
6	12803598	.	T	C	5	10	15	0	0	15	0	0
6	12803664	.	G	A	9	7	16	0	0	16	0	0
6	12803790	.	A	G	10	6	16	0	0	16	0	0
6	12803919	.	C	G	8	4	12	0	1	13	0	0
6	12804024	.	A	T	6	10	16	0	0	16	0	0
6	12804132	.	G	A	12	5	17	0	0	17	0	0
6	12810249	.	C	G	1	3	4	0	8	12	0	0
6	13506931	.	G	C	3	3	6	0	0	6	0	0
6	13507066	.	A	T	3	2	5	0	0	5	0	0
6	13509296	.	C	T	4	3	7	0	0	7	0	0
6	13510307	.	A	G	2	3	5	0	0	5	0	0
6	13510493	.	G	A	2	2	4	0	0	4	0	0
6	13510565	.	T	C	6	3	9	0	0	9	0	0
6	13513936	.	C	T	6	3	9	0	0	9	0	0
6	13513962	.	A	G	2	3	5	0	1	6	0	0
6	13699488	.	G	A	2	2	4	0	0	4	0	0
6	13699642	.	A	G	1	2	3	0	0	3	0	0
6	13700485	.	G	A	1	3	4	0	0	4	0	0
6	13709142	.	G	A	4	2	6	0	0	6	0	0
6	13709172	.	C	T	0	2	2	0	1	3	0	0
6	13709179	.	G	A	1	2	3	0	0	3	0	0
6	13730697	.	G	A	2	4	6	0	0	6	0	0
6	13734439	.	C	T	2	6	8	0	1	9	0	0
6	13734474	.	C	T	2	4	6	0	0	6	0	0
6	13743317	.	G	A	20	31	51	0	0	51	0	0
6	13743753	.	T	C	27	25	52	0	2	54	0	0
6	13743923	.	C	T	38	29	67	0	4	71	0	0
6	13744099	.	C	T	42	27	69	2	2	73	0	0
6	13744676	.	T	C	1	2	3	0	0	3	0	0
6	13806522	.	C	T	12	11	23	0	0	23	0	0
6	13862171	.	C	T	10	8	18	0	1	19	0	0
6	13862576	.	A	C	23	19	42	0	0	42	0	0
6	13866551	.	G	A	29	18	47	0	2	49	0	0
6	13868823	.	A	G	16	19	35	0	2	37	0	0
6	13868850	.	A	T	14	21	35	0	2	39	2	0
6	13869343	.	A	C	12	4	16	0	1	17	0	0
6	13869540	.	C	A	31	7	38	0	0	38	0	0
6	13869608	.	C	T	18	11	29	0	2	31	0	0
6	13871773	.	A	G	2	3	5	0	0	5	0	0
6	13871906	.	G	T	1	3	4	0	0	4	0	0
6	13871941	.	T	G	3	2	5	0	0	5	0	0
6	13900918	.	C	G	7	1	8	0	2	10	0	0
6	13901213	.	G	A	4	6	10	0	0	10	0	0
6	13901255	.	A	T	5	4	9	0	1	10	0	0
6	13901312	.	C	T	3	9	12	0	0	12	0	0
6	13901496	.	C	T	4	5	9	0	1	10	0	0
6	13901604	.	T	C	5	5	10	0	0	10	0	0
6	13907856	.	T	A	2	4	6	0	0	6	0	0
6	13908633	.	G	A	0	5	5	0	14	19	0	0
6	13914821	.	T	C	6	12	18	0	0	18	0	0
6	13914824	.	G	A	6	10	16	0	2	18	0	0
6	13920194	.	A	G	5	3	8	0	0	8	0	0
6	13920275	.	T	G	1	4	5	0	0	5	0	0
6	13920549	.	C	T	8	5	13	0	0	13	0	0
6	13941729	.	C	A	17	16	33	0	3	36	0	0
6	13967038	.	A	T	17	19	36	0	1	37	0	0
6	13967328	.	G	A	19	16	35	0	2	37	0	0
6	13967512	.	C	A	24	18	42	1	2	49	4	0
6	13977080	.	T	A	21	19	40	0	3	43	0	0
6	13977567	.	G	T	14	29	43	0	2	45	0	0
6	13977588	.	C	T	13	33	46	0	2	48	0	0
6	13977648	.	G	A	18	24	42	0	1	43	0	0
6	13987287	.	G	C	22	9	31	0	0	31	0	0
6	13987299	.	A	T	20	19	39	1	2	42	0	0
6	13987346	.	C	T	11	21	32	0	1	33	0	0
6	13987560	.	T	C	22	14	36	0	1	37	0	0
6	13987631	.	G	A	27	16	43	0	2	45	0	0
6	13987663	.	T	A	21	21	42	0	1	43	0	0
6	13987710	.	G	A	16	9	25	0	1	26	0	0
6	13987713	.	T	G	15	8	23	0	1	24	0	0
6	13993783	.	A	T	6	5	11	0	0	11	0	0
6	14010445	.	G	A	11	4	15	1	2	18	0	0
6	14032693	.	T	C	34	10	44	0	3	47	0	0
6	14032698	.	T	A	39	7	46	0	0	46	0	0
6	14032739	.	G	A	23	12	35	0	0	35	0	0
6	14033030	.	G	T	10	19	29	0	0	29	0	0
6	14033167	.	G	A	21	21	42	0	0	42	0	0
6	14033556	.	T	A	17	12	29	0	0	29	0	0
6	14033836	.	G	C	13	12	25	0	1	26	0	0
6	14034887	.	G	C	13	15	28	0	1	29	0	0
6	14034907	.	C	T	2	11	13	0	20	33	0	0
6	14034949	.	G	A	20	12	32	0	1	33	0	0
6	14038306	.	C	T	13	11	24	0	0	24	0	0
6	14038506	.	T	A	13	5	18	0	1	19	0	0
6	14086810	.	T	C	25	22	47	0	3	50	0	0
6	14086901	.	G	T	24	27	51	0	0	51	0	0
6	14086942	.	G	C	28	30	58	0	0	58	0	0
6	14087182	.	C	A	27	28	55	0	1	56	0	0
6	14087220	.	T	A	29	23	52	0	2	54	0	0
6	14087569	.	T	G	23	30	53	0	0	53	0	0
6	14087641	.	A	C	27	26	53	0	2	55	0	0
6	14087883	.	T	C	16	18	34	0	3	37	0	0
6	14088095	.	C	T	31	11	42	0	6	48	0	0
6	14092942	.	T	A	23	23	46	0	4	50	0	0
6	14096684	.	C	T	1	26	27	0	24	51	0	0
6	14098760	.	C	T	2	25	27	0	23	50	0	0
6	14105071	.	G	T	21	21	42	0	2	44	0	0
6	14172926	.	A	T	6	4	10	0	1	11	0	0
6	14173159	.	C	A	11	4	15	0	0	15	0	0
6	14173599	.	A	G	3	2	5	0	0	5	0	0
6	14173641	.	G	A	5	6	11	0	1	12	0	0
6	14191637	.	A	G	7	6	13	0	0	13	0	0
6	14191676	.	G	A	6	4	10	0	1	11	0	0
6	14191709	.	T	C	7	1	8	0	5	13	0	0
6	14209151	.	C	T	11	6	17	0	1	18	0	0
6	14209674	.	A	G	6	6	12	0	0	12	0	0
6	14209764	.	A	G	3	5	8	0	2	10	0	0
6	14212352	.	G	A	3	3	6	0	0	6	0	0
6	14212370	.	G	A	3	5	8	0	0	8	0	0
6	14212430	.	T	G	5	6	11	0	1	12	0	0
6	14220145	.	G	T	3	3	6	0	1	7	0	0
6	14240226	.	C	T	2	6	8	0	0	8	0	0
6	14950538	.	T	A	9	4	13	0	0	13	0	0
6	14950567	.	T	C	7	7	14	0	2	16	0	0
6	14950759	.	T	C	10	6	16	0	0	16	0	0
6	14951854	.	C	T	17	16	33	0	1	34	0	0
6	14952579	.	T	C	11	15	26	0	0	26	0	0
6	14981102	.	G	T	0	2	2	0	1	3	0	0
6	14988559	.	G	T	8	9	17	0	0	17	0	0
6	15000149	.	C	T	9	12	21	0	0	21	0	0
6	15023688	.	G	A	10	11	21	0	1	22	0	0
6	15023713	.	A	G	7	9	16	0	0	16	0	0
6	15037025	.	A	G	4	4	8	0	0	8	0	0
6	15037258	.	A	G	7	8	15	0	0	15	0	0
6	15043859	.	T	C	2	2	4	0	0	4	0	0
6	15043886	.	A	T	3	2	5	0	0	5	0	0
6	15051753	.	G	A	2	3	5	0	0	5	0	0
6	15051782	.	T	C	1	3	4	0	1	5	0	0
6	15062015	.	A	G	1	4	5	0	0	5	0	0
6	15062132	.	C	T	3	3	6	0	0	6	0	0
6	15062153	.	T	A	5	3	8	0	0	8	0	0
6	15062264	.	T	C	2	4	6	0	0	6	0	0
6	15062492	.	G	A	1	3	4	0	0	4	0	0
6	15127591	.	G	A	1	6	7	0	4	11	0	0
6	15127666	.	T	G	2	0	2	0	3	5	0	0
6	15130982	.	G	A	1	2	3	0	3	6	0	0
6	15131047	.	G	A	1	4	5	0	0	5	0	0
6	15210156	.	C	T	4	4	8	0	0	8	0	0
6	15235960	.	A	C	4	2	6	0	0	6	0	0
6	15236344	.	G	A	3	6	9	0	0	9	0	0
6	15242287	.	A	T	9	4	13	0	0	13	0	0
6	15242641	.	C	T	6	5	11	0	1	12	0	0
6	15242659	.	C	G	4	0	4	0	5	9	0	0
6	15242680	.	C	T	4	2	6	0	0	6	0	0
6	15243129	.	T	C	3	6	9	0	0	9	0	0
6	15243137	.	A	C	3	4	7	0	1	8	0	0
6	15434544	.	T	A	5	17	22	0	0	22	0	0
6	15437352	.	G	T	1	3	4	0	0	4	0	0
6	15446948	.	G	A	3	2	5	0	0	5	0	0
6	15455804	.	C	A	0	8	8	0	2	10	0	0
6	15459617	.	C	T	0	4	4	0	3	7	0	0
6	15470261	.	A	G	1	4	5	0	0	5	0	0
6	15470271	.	T	A	1	3	4	0	1	5	0	0
6	15470505	.	A	G	1	5	6	0	0	6	0	0
6	15470544	.	A	G	1	5	6	0	0	6	0	0
6	15491568	.	A	G	1	2	3	0	0	3	0	0
6	15527107	.	A	G	6	5	11	0	1	12	0	0
6	15527202	.	T	C	5	2	7	0	1	8	0	0
6	15527356	.	T	C	8	8	16	0	1	17	0	0
6	15527385	.	G	A	8	8	16	0	0	16	0	0
6	15531697	.	G	A	9	8	17	1	0	18	0	0
6	15541015	.	G	A	9	7	16	0	0	16	0	0
6	15541077	.	T	C	8	9	17	0	0	17	0	0
6	15543451	.	C	T	9	5	14	0	3	17	0	0
6	15548966	.	A	G	15	8	23	0	0	23	0	0
6	15604071	.	G	A	2	8	10	0	1	11	0	0
6	15604133	.	C	T	6	4	10	0	1	11	0	0
6	15604178	.	G	T	1	2	3	0	0	3	0	0
6	15653165	.	G	A	1	2	3	0	0	3	0	0
6	15752348	.	A	G	11	3	14	0	0	14	0	0
6	15752602	.	A	G	3	2	5	0	0	5	0	0
6	15752681	.	A	C	3	8	11	0	0	11	0	0
6	15753256	.	A	G	3	5	8	0	0	8	0	0
6	15753508	.	A	C	1	1	2	0	1	3	0	0
6	15789877	.	C	A	1	3	4	0	0	4	0	0
6	15790083	.	C	T	4	2	6	0	0	6	0	0
6	15834635	.	A	G	1	2	3	0	0	3	0	0
6	15834641	.	C	T	2	3	5	0	0	5	0	0
6	16031714	.	C	T	2	6	8	0	1	9	0	0
6	16033239	.	A	G	5	4	9	0	0	9	0	0
6	16043950	.	C	T	1	13	14	0	13	27	0	0
6	16043980	.	A	G	17	14	31	0	0	31	0	0
6	16044019	.	T	C	20	0	20	0	16	36	0	0
6	16044597	.	C	T	14	8	22	0	0	22	0	0
6	16044664	.	T	C	16	16	32	0	1	33	0	0
6	16045413	.	T	C	8	8	16	0	0	16	0	0
6	16045463	.	G	C	9	0	9	0	16	25	0	0
6	16045511	.	G	A	11	13	24	0	0	24	0	0
6	16045650	.	G	A	8	8	16	0	1	17	0	0
6	16045712	.	C	T	11	10	21	0	0	21	0	0
6	16045768	.	C	G	10	7	17	0	0	17	0	0
6	16045798	.	T	C	13	3	16	1	2	19	0	0
6	16045946	.	A	C	12	9	21	1	4	26	0	0
6	16045947	.	A	T	14	8	22	1	3	26	0	0
6	16046025	.	T	A	17	9	26	2	2	30	0	0
6	16046049	.	G	T	10	17	27	0	0	28	1	0
6	16046110	.	T	C	11	11	22	0	1	23	0	0
6	16046115	.	T	C	11	11	22	0	1	23	0	0
6	16046272	.	G	T	9	7	16	0	0	16	0	0
6	16046365	.	G	A	4	6	10	0	1	11	0	0
6	16046371	.	A	T	4	5	9	0	1	10	0	0
6	16046440	.	T	C	9	0	9	0	5	14	0	0
6	16046664	.	A	G	13	7	20	0	0	20	0	0
6	16046676	.	G	A	8	14	22	0	0	22	0	0
6	16046850	.	G	A	11	11	22	0	1	23	0	0
6	16047197	.	C	T	3	14	17	0	14	32	1	0
6	16084168	.	T	C	7	8	15	0	0	15	0	0
6	16104448	.	G	T	10	8	18	0	1	19	0	0
6	16129824	.	G	T	12	8	20	0	0	20	0	0
6	16135963	.	C	T	4	4	8	0	0	8	0	0
6	16135966	.	C	T	3	4	7	0	0	7	0	0
6	16162994	.	G	A	8	9	17	0	0	17	0	0
6	16169641	.	G	A	7	7	14	0	0	14	0	0
6	16196326	.	G	A	10	7	17	0	0	17	0	0
6	16393459	.	G	T	5	3	8	0	3	11	0	0
6	16393518	.	G	A	10	4	14	0	0	14	0	0
6	16393570	.	G	T	8	8	16	0	0	16	0	0
6	16393792	.	G	C	3	4	7	0	0	7	0	0
6	16393816	.	G	C	4	4	8	0	0	8	0	0
6	16393890	.	C	G	2	10	12	0	0	12	0	0
6	16446373	.	A	G	2	2	4	0	0	4	0	0
6	16474853	.	T	C	7	4	11	0	0	11	0	0
6	16474948	.	T	C	14	6	20	0	0	20	0	0
6	16475047	.	T	A	9	8	17	0	1	18	0	0
6	16475395	.	A	C	7	3	10	0	1	11	0	0
6	16475499	.	G	A	11	7	18	0	0	18	0	0
6	16475502	.	G	T	10	6	16	0	1	17	0	0
6	16475559	.	T	A	5	4	9	0	0	9	0	0
6	16475582	.	G	T	4	5	9	0	0	9	0	0
6	16475728	.	G	A	1	8	9	0	7	16	0	0
6	16478198	.	C	A	1	6	7	0	8	16	1	0
6	16478200	.	T	G	9	7	16	0	1	17	0	0
6	16485073	.	A	T	19	18	37	0	1	38	0	0
6	16493381	.	A	T	24	10	34	0	1	36	1	0
6	16499206	.	G	A	6	6	12	0	0	12	0	0
6	16499312	.	A	G	7	1	8	0	6	14	0	0
6	16499422	.	A	G	4	7	11	0	0	11	0	0
6	16521166	.	C	A	11	4	15	0	1	16	0	0
6	16523647	.	A	G	3	4	7	0	0	7	0	0
6	16523662	.	C	T	0	3	3	0	6	9	0	0
6	16523704	.	A	G	7	2	9	0	0	9	0	0
6	16523788	.	G	A	4	4	8	0	0	8	0	0
6	16524019	.	G	A	5	6	11	0	1	12	0	0
6	16524618	.	C	G	2	10	12	0	1	13	0	0
6	16524653	.	G	A	4	8	12	0	0	12	0	0
6	16524663	.	T	C	4	8	12	0	0	12	0	0
6	16526864	.	C	T	0	2	2	0	9	11	0	0
6	16526875	.	C	T	8	6	14	0	0	14	0	0
6	16535731	.	G	C	4	4	8	0	0	8	0	0
6	16544879	.	G	A	4	6	10	0	0	10	0	0
6	16545661	.	A	G	4	6	10	0	1	11	0	0
6	16545847	.	A	G	2	3	5	0	0	5	0	0
6	16545904	.	C	T	2	2	4	0	0	4	0	0
6	16545916	.	A	G	1	2	3	0	1	4	0	0
6	16552235	.	T	G	5	4	9	0	0	9	0	0
6	16558508	.	A	T	4	5	9	0	1	10	0	0
6	16558556	.	T	G	2	2	4	0	0	4	0	0
6	16561379	.	C	T	4	3	7	0	0	7	0	0
6	16561490	.	T	G	4	3	7	0	0	7	0	0
6	16571935	.	G	A	5	2	7	0	1	8	0	0
6	16571947	.	G	T	4	2	6	0	0	6	0	0
6	16574765	.	G	C	3	5	8	0	0	8	0	0
6	16574794	.	T	A	3	9	12	0	0	12	0	0
6	16574821	.	G	C	5	9	14	0	0	14	0	0
6	16574890	.	C	G	3	5	8	0	1	9	0	0
6	16577142	.	A	G	1	2	3	0	0	3	0	0
6	16577229	.	C	T	1	4	5	0	3	8	0	0
6	16585984	.	G	A	2	2	4	0	0	4	0	0
6	16586104	.	T	C	3	5	8	0	0	8	0	0
6	16586221	.	C	T	0	3	3	0	3	6	0	0
6	16589347	.	C	T	7	4	11	0	0	11	0	0
6	16589452	.	T	G	2	3	5	0	0	5	0	0
6	16656833	.	C	T	2	2	4	0	1	5	0	0
6	16661736	.	T	A	2	4	6	0	0	6	0	0
6	16674296	.	A	G	13	9	22	0	2	24	0	0
6	16674344	.	T	A	14	10	24	1	5	30	0	0
6	16674371	.	T	C	10	9	19	1	4	24	0	0
6	16674435	.	A	C	13	14	27	1	0	28	0	0
6	16674618	.	G	A	15	15	30	0	2	32	0	0
6	16674808	.	T	C	12	16	28	0	1	29	0	0
6	16683385	.	T	C	14	16	30	0	0	30	0	0
6	16683421	.	A	G	15	11	26	0	0	26	0	0
6	16684004	.	A	G	7	8	15	0	2	17	0	0
6	16687429	.	C	A	16	15	31	0	1	32	0	0
6	16687432	.	T	A	14	13	27	0	1	29	1	0
6	16688900	.	T	C	10	4	14	0	1	15	0	0
6	16688921	.	A	G	5	8	13	0	0	13	0	0
6	16689416	.	T	A	2	6	8	0	1	9	0	0
6	16695771	.	C	T	4	2	6	0	0	6	0	0
6	16695994	.	A	C	2	2	4	0	0	4	0	0
6	16696083	.	C	T	2	2	4	0	1	5	0	0
6	16699626	.	C	G	5	6	11	0	0	11	0	0
6	16717795	.	A	C	4	8	12	0	0	12	0	0
6	16717807	.	C	A	0	8	8	0	3	11	0	0
6	17726542	.	A	C	1	2	3	0	0	3	0	0
6	17980479	.	A	T	3	2	5	0	1	6	0	0
6	18078439	.	G	A	4	9	13	0	0	13	0	0
6	18203842	.	G	A	29	11	40	0	0	40	0	0
6	18220141	.	G	A	6	7	13	0	0	13	0	0
6	18228324	.	G	A	7	9	16	0	1	17	0	0
6	18245385	.	G	A	19	21	40	0	1	41	0	0
6	18267829	.	G	C	1	3	4	0	0	4	0	0
6	18270731	.	G	A	2	2	4	0	0	4	0	0
6	18272540	.	T	C	6	2	8	0	0	8	0	0
6	18274351	.	T	A	3	5	8	0	1	9	0	0
6	18290937	.	G	A	0	4	4	0	3	7	0	0
6	18359389	.	G	A	8	8	16	0	1	17	0	0
6	18361359	.	A	T	9	10	19	0	2	21	0	0
6	18361609	.	T	C	12	10	22	0	1	23	0	0
6	18362043	.	T	G	6	0	6	0	5	11	0	0
6	18364051	.	A	T	3	3	6	0	0	6	0	0
6	18364081	.	G	A	0	4	4	0	5	9	0	0
6	18367670	.	C	A	4	2	6	0	0	6	0	0
6	18375692	.	A	C	4	3	7	0	1	8	0	0
6	18375693	.	T	C	3	3	6	0	1	7	0	0
6	18388387	.	T	G	4	10	14	0	1	15	0	0
6	18389220	.	G	A	5	5	10	0	0	10	0	0
6	18389541	.	C	T	4	8	12	0	0	12	0	0
6	18389655	.	G	A	11	5	16	0	2	18	0	0
6	18390031	.	T	A	12	8	20	0	0	20	0	0
6	18390141	.	C	T	2	1	3	0	1	4	0	0
6	18393826	.	A	T	3	9	12	0	2	14	0	0
6	18418714	.	T	G	3	3	6	0	1	7	0	0
6	18418760	.	G	A	3	3	6	0	0	6	0	0
6	18431143	.	G	A	2	4	6	0	0	6	0	0
6	18437514	.	T	G	9	0	9	0	12	21	0	0
6	18438459	.	A	G	4	7	11	0	2	13	0	0
6	18439256	.	C	A	6	12	18	0	1	19	0	0
6	18439481	.	A	T	5	8	13	0	1	14	0	0
6	18439576	.	A	G	5	7	12	0	1	13	0	0
6	18439723	.	G	A	7	11	18	0	0	18	0	0
6	18439774	.	G	A	0	7	7	0	6	13	0	0
6	18520930	.	T	A	23	15	38	0	1	39	0	0
6	18523549	.	C	A	14	13	27	0	1	28	0	0
6	18523770	.	A	T	10	11	21	0	1	22	0	0
6	18523772	.	C	G	11	9	20	0	2	22	0	0
6	18523817	.	T	A	13	11	24	0	1	25	0	0
6	18523895	.	C	G	2	6	8	0	0	8	0	0
6	18524550	.	A	G	4	6	10	0	1	11	0	0
6	18524579	.	A	G	6	10	16	0	0	16	0	0
6	18526432	.	A	G	5	2	7	0	3	10	0	0
6	18529148	.	G	T	1	6	7	0	0	7	0	0
6	18529457	.	G	A	4	3	7	0	0	7	0	0
6	18529589	.	G	A	5	3	8	0	0	8	0	0
6	18529593	.	T	G	5	2	7	0	0	7	0	0
6	18531296	.	T	G	3	7	10	0	0	10	0	0
6	18532445	.	A	T	3	5	8	0	1	9	0	0
6	18533201	.	T	C	5	2	7	0	0	7	0	0
6	18536748	.	C	T	10	6	16	0	1	17	0	0
6	18540815	.	G	T	13	15	28	0	0	28	0	0
6	18541077	.	A	G	2	4	6	0	0	6	0	0
6	18541083	.	A	G	2	3	5	0	0	5	0	0
6	18542735	.	T	C	3	4	7	0	1	8	0	0
6	18542741	.	G	A	3	5	8	0	0	8	0	0
6	18542836	.	C	A	2	4	6	0	0	6	0	0
6	18542933	.	T	C	4	5	9	0	0	9	0	0
6	18543385	.	C	T	11	12	23	0	1	24	0	0
6	18543400	.	A	G	6	12	18	0	2	20	0	0
6	18543735	.	A	G	6	8	14	0	0	14	0	0
6	18543950	.	G	T	12	11	23	0	1	24	0	0
6	18554177	.	T	G	6	4	10	0	0	10	0	0
6	18554431	.	G	A	1	3	4	0	1	5	0	0
6	18554702	.	C	G	4	5	9	0	0	9	0	0
6	18554719	.	T	C	4	0	4	0	3	7	0	0
6	18555651	.	A	T	5	4	9	0	0	9	0	0
6	18555657	.	G	A	5	4	9	0	0	9	0	0
6	18558098	.	A	G	2	2	4	0	0	4	0	0
6	18558110	.	C	G	2	2	4	0	0	4	0	0
6	18558137	.	G	A	2	2	4	0	0	4	0	0
6	18584793	.	T	A	5	2	7	0	1	8	0	0
6	18587728	.	G	A	7	4	11	0	0	11	0	0
6	18589235	.	T	C	6	3	9	0	2	11	0	0
6	18592209	.	G	A	7	5	12	0	0	12	0	0
6	18595391	.	C	A	4	3	7	0	0	7	0	0
6	18600213	.	A	G	2	7	9	0	0	9	0	0
6	18600234	.	T	G	3	5	8	0	1	9	0	0
6	18600288	.	C	T	0	3	3	0	4	7	0	0
6	18606063	.	T	C	8	5	13	0	0	13	0	0
6	18606135	.	T	G	13	8	21	0	0	21	0	0
6	18607590	.	G	A	14	18	32	0	3	35	0	0
6	18623673	.	C	G	1	2	3	0	0	3	0	0
6	18624805	.	C	T	0	3	3	0	4	7	0	0
6	18663450	.	C	A	4	3	7	0	0	7	0	0
6	18714358	.	A	G	3	4	7	0	0	7	0	0
6	18714592	.	T	G	6	4	10	0	0	10	0	0
6	18714845	.	A	C	7	4	11	0	0	11	0	0
6	18714890	.	T	A	6	5	11	0	0	11	0	0
6	18714910	.	T	C	7	3	10	0	0	10	0	0
6	18714937	.	A	G	7	7	14	0	1	15	0	0
6	18715090	.	A	G	18	5	23	0	0	23	0	0
6	18715309	.	T	C	3	0	3	0	4	7	0	0
6	18715372	.	A	G	3	7	10	0	0	10	0	0
6	18715540	.	A	G	7	6	13	0	0	13	0	0
6	18715544	.	C	T	6	7	13	0	0	13	0	0
6	18715879	.	A	C	5	3	8	0	2	10	0	0
6	18716054	.	G	A	7	6	13	0	0	13	0	0
6	18716085	.	C	T	8	6	14	0	0	14	0	0
6	18716242	.	G	A	7	4	11	0	0	11	0	0
6	18716269	.	A	G	5	6	11	0	0	11	0	0
6	18716330	.	C	T	4	9	13	0	0	13	0	0
6	18716539	.	C	T	0	7	7	0	6	13	0	0
6	18717238	.	T	A	6	3	9	0	1	10	0	0
6	18717315	.	T	C	7	4	11	0	1	13	1	0
6	18717319	.	A	T	8	6	14	0	0	14	0	0
6	18717449	.	C	A	0	6	6	0	5	11	0	0
6	18717610	.	T	A	3	2	5	0	0	5	0	0
6	18717886	.	T	C	1	2	3	0	0	3	0	0
6	18717934	.	T	C	3	3	6	0	1	7	0	0
6	18718126	.	G	A	4	2	6	0	1	7	0	0
6	18718205	.	A	C	4	2	6	0	0	6	0	0
6	18718397	.	G	A	3	3	6	0	0	6	0	0
6	18718438	.	T	G	2	4	6	0	0	6	0	0
6	18718485	.	C	T	1	3	4	0	1	5	0	0
6	18718662	.	G	A	4	5	9	0	0	9	0	0
6	18718663	.	C	T	5	5	10	0	0	10	0	0
6	18718846	.	A	T	5	4	9	0	1	10	0	0
6	18718964	.	A	G	4	8	12	0	0	12	0	0
6	18721021	.	A	G	6	4	10	0	1	11	0	0
6	18721099	.	T	C	10	5	15	0	1	16	0	0
6	18724415	.	T	A	7	4	11	0	1	12	0	0
6	18725196	.	C	T	2	3	5	0	1	6	0	0
6	18728766	.	A	G	4	3	7	0	0	7	0	0
6	18728793	.	T	C	3	0	3	0	4	7	0	0
6	18736460	.	A	G	2	4	6	0	0	7	1	0
6	18737442	.	A	G	2	5	7	0	1	8	0	0
6	18738593	.	T	A	1	9	10	0	0	10	0	0
6	18739319	.	C	T	1	3	4	0	0	4	0	0
6	18751146	.	C	T	0	5	5	0	1	6	0	0
6	18937493	.	T	C	5	2	7	0	0	7	0	0
6	18953406	.	G	C	5	5	10	0	3	13	0	0
6	18992723	.	G	A	2	2	4	0	0	4	0	0
6	19263882	.	T	A	5	3	8	0	0	8	0	0
6	19263902	.	G	A	4	3	7	0	0	7	0	0
6	19265802	.	C	A	1	2	3	0	0	3	0	0
6	19295015	.	T	A	18	12	30	0	0	30	0	0
6	19295044	.	A	T	20	9	29	0	0	29	0	0
6	19295469	.	T	C	24	0	24	0	17	41	0	0
6	19295609	.	A	T	16	7	23	0	1	24	0	0
6	19295644	.	C	T	1	16	17	0	13	30	0	0
6	19320696	.	C	T	0	5	5	0	7	12	0	0
6	19327236	.	T	C	0	0	0	0	3	3	0	0
6	19327239	.	C	T	0	3	3	0	1	4	0	0
6	19327320	.	T	G	2	4	6	0	1	7	0	0
6	19328873	.	G	T	4	2	6	0	0	6	0	0
6	19330232	.	T	C	3	2	5	0	0	5	0	0
6	19334643	.	T	C	1	6	7	0	0	7	0	0
6	19334948	.	A	T	2	2	4	0	0	4	0	0
6	19334949	.	C	A	2	2	4	0	0	4	0	0
6	19335232	.	A	G	5	2	7	0	0	7	0	0
6	19339426	.	C	T	4	9	13	0	0	13	0	0
6	19344846	.	C	T	4	12	16	0	0	16	0	0
6	19344930	.	G	C	10	7	17	0	0	17	0	0
6	19344950	.	C	T	10	6	16	0	1	17	0	0
6	19345191	.	G	A	5	11	16	2	2	20	0	0
6	19347426	.	C	T	0	6	6	0	5	11	0	0
6	19381679	.	C	G	5	2	7	0	0	7	0	0
6	19676807	.	C	T	1	3	4	0	0	4	0	0
6	19682168	.	A	G	1	2	3	0	0	3	0	0
6	19715507	.	A	C	5	8	13	0	2	15	0	0
6	19802042	.	T	C	9	6	15	0	0	15	0	0
6	19802242	.	C	T	8	11	19	0	1	20	0	0
6	19802330	.	G	A	3	8	11	0	0	11	0	0
6	19802354	.	G	A	2	7	9	0	2	11	0	0
6	19802414	.	C	G	3	1	4	0	1	5	0	0
6	19802415	.	G	A	3	3	6	0	0	6	0	0
6	19804702	.	A	C	3	3	6	0	0	6	0	0
6	19804743	.	A	T	4	5	9	0	0	9	0	0
6	19807095	.	A	T	2	4	6	0	0	6	0	0
6	19807640	.	T	C	3	0	3	0	3	6	0	0
6	19808670	.	C	T	2	4	6	0	1	7	0	0
6	19808818	.	G	A	1	6	7	0	0	7	0	0
6	19925856	.	A	G	2	3	5	0	0	5	0	0
6	20766136	.	C	T	5	3	8	0	1	9	0	0
6	20766307	.	A	G	16	9	25	0	1	26	0	0
6	20766500	.	G	T	11	9	20	0	2	22	0	0
6	20767015	.	T	A	16	17	33	0	2	35	0	0
6	20767537	.	A	G	21	13	34	0	1	35	0	0
6	20767830	.	T	G	9	3	12	0	1	13	0	0
6	20767898	.	A	T	5	5	10	0	0	10	0	0
6	20767958	.	T	G	5	4	9	0	1	10	0	0
6	20767994	.	T	C	7	9	16	0	1	17	0	0
6	20768061	.	A	G	8	10	18	0	1	19	0	0
6	20768076	.	C	A	6	12	18	0	0	18	0	0
6	20768107	.	A	T	8	13	21	0	1	22	0	0
6	20768239	.	A	G	13	6	19	2	0	21	0	0
6	20768338	.	G	A	14	14	28	0	1	29	0	0
6	20768346	.	T	G	16	12	28	0	0	28	0	0
6	20768558	.	C	G	13	10	23	0	1	24	0	0
6	20773961	.	G	A	15	16	31	0	0	31	0	0
6	20774048	.	A	C	17	15	32	0	2	34	0	0
6	20774701	.	G	A	14	8	22	0	4	26	0	0
6	20774768	.	C	T	20	15	35	0	3	38	0	0
6	20785089	.	A	G	11	8	19	0	1	20	0	0
6	20785105	.	C	T	2	7	9	0	10	19	0	0
6	20785144	.	G	A	13	15	28	0	1	29	0	0
6	20789072	.	A	G	12	14	26	0	0	26	0	0
6	20789162	.	G	A	14	11	25	0	0	25	0	0
6	20789195	.	C	T	11	8	19	0	0	19	0	0
6	20789351	.	T	C	9	13	22	0	2	24	0	0
6	20789369	.	T	A	8	14	22	0	1	23	0	0
6	20789489	.	T	C	9	8	17	0	0	17	0	0
6	20814418	.	A	G	4	4	8	0	0	8	0	0
6	20815058	.	A	T	9	5	14	0	0	14	0	0
6	20822000	.	A	G	1	5	6	0	0	6	0	0
6	20822108	.	T	C	8	3	11	0	2	13	0	0
6	20910627	.	A	C	4	5	9	0	0	9	0	0
6	20910713	.	G	T	3	5	8	0	0	8	0	0
6	20910759	.	A	T	5	3	8	0	0	8	0	0
6	20910830	.	T	C	5	7	12	0	0	12	0	0
6	20910880	.	G	A	8	7	15	0	0	15	0	0
6	20917730	.	A	T	6	5	11	0	0	11	0	0
6	20917780	.	T	A	6	5	11	0	0	11	0	0
6	20917921	.	G	A	3	8	11	0	1	12	0	0
6	20917922	.	A	C	2	9	11	0	1	12	0	0
6	20917991	.	A	T	9	5	14	0	0	14	0	0
6	20917994	.	C	T	10	3	13	0	0	13	0	0
6	20918132	.	A	G	6	7	13	0	0	13	0	0
6	20918456	.	C	A	8	12	20	0	0	20	0	0
6	20918613	.	G	T	10	13	23	0	1	24	0	0
6	20918673	.	T	C	8	9	17	0	1	18	0	0
6	20921859	.	G	A	10	8	18	0	0	18	0	0
6	20921888	.	T	C	6	9	15	0	1	16	0	0
6	20922057	.	A	T	14	7	21	0	0	21	0	0
6	20922316	.	G	C	5	0	5	0	7	12	0	0
6	20922330	.	G	A	7	6	13	0	0	13	0	0
6	20922396	.	G	A	11	6	17	0	1	18	0	0
6	20922468	.	G	A	11	6	17	0	0	17	0	0
6	20952104	.	A	C	2	2	4	0	0	4	0	0
6	20956869	.	C	T	2	2	4	0	0	4	0	0
6	20961760	.	T	A	2	2	4	0	0	4	0	0
6	20961775	.	C	T	1	2	3	0	0	3	0	0
6	20961799	.	T	C	1	3	4	0	1	5	0	0
6	20961820	.	G	A	1	2	3	0	1	4	0	0
6	20965710	.	G	A	0	5	5	0	3	8	0	0
6	20965745	.	T	A	2	3	5	0	1	6	0	0
6	20965873	.	T	A	4	6	10	0	0	10	0	0
6	20970989	.	T	A	2	5	7	0	0	7	0	0
6	20977715	.	T	C	4	4	8	0	1	9	0	0
6	20978972	.	C	T	4	6	10	0	0	10	0	0
6	20995800	.	A	G	6	3	9	0	0	9	0	0
6	20996640	.	C	T	7	4	11	0	0	11	0	0
6	20997031	.	A	T	4	9	13	0	0	13	0	0
6	21009258	.	A	G	4	1	5	0	0	5	0	0
6	21009283	.	G	C	0	2	2	0	1	3	0	0
6	21009526	.	T	C	2	3	5	0	0	5	0	0
6	21009740	.	A	T	1	3	4	0	0	4	0	0
6	21116134	.	C	G	4	7	11	0	0	11	0	0
6	21118608	.	G	A	7	6	13	0	0	13	0	0
6	21119598	.	C	T	4	6	10	0	0	10	0	0
6	21119779	.	G	A	2	3	5	0	0	5	0	0
6	21119842	.	G	A	0	4	4	0	7	11	0	0
6	21119847	.	G	A	7	5	12	0	0	12	0	0
6	21119953	.	C	A	7	3	10	0	0	10	0	0
6	21120080	.	A	G	5	5	10	0	1	11	0	0
6	21120146	.	G	C	8	6	14	0	0	14	0	0
6	21120193	.	T	C	4	10	14	0	0	14	0	0
6	21120201	.	T	C	4	11	15	0	0	15	0	0
6	21120261	.	C	T	7	11	18	0	0	18	0	0
6	21120341	.	A	C	10	11	21	0	1	22	0	0
6	21120387	.	T	C	7	14	21	0	0	21	0	0
6	21121977	.	T	C	1	4	5	0	1	6	0	0
6	21121986	.	G	C	1	4	5	0	0	5	0	0
6	21130593	.	G	A	1	6	7	0	0	7	0	0
6	21130623	.	C	T	4	4	8	0	0	8	0	0
6	21130668	.	A	C	6	6	12	0	0	12	0	0
6	21130850	.	T	G	4	5	9	0	0	9	0	0
6	21131142	.	A	T	6	6	12	0	0	12	0	0
6	21131414	.	C	A	6	11	17	0	0	17	0	0
6	21138869	.	C	T	2	5	7	0	1	8	0	0
6	21138870	.	T	G	1	5	6	0	2	8	0	0
6	21140553	.	G	T	2	4	6	0	0	6	0	0
6	21143033	.	T	C	6	11	17	0	0	17	0	0
6	21143685	.	C	T	6	6	12	0	0	12	0	0
6	21143995	.	G	A	3	7	10	0	0	10	0	0
6	21144020	.	T	G	3	5	8	0	0	8	0	0
6	21147218	.	G	A	0	8	8	1	8	17	0	0
6	21147240	.	A	G	8	6	14	1	1	16	0	0
6	21147291	.	C	A	8	5	13	0	0	13	0	0
6	21147332	.	T	A	6	7	13	0	1	14	0	0
6	21147334	.	T	A	7	7	14	0	0	14	0	0
6	21147368	.	G	A	0	10	10	0	4	14	0	0
6	21147818	.	T	C	7	12	19	0	1	20	0	0
6	21147837	.	A	G	7	11	18	0	0	18	0	0
6	21147920	.	A	C	6	11	17	0	0	17	0	0
6	21148166	.	A	T	8	6	14	1	1	16	0	0
6	21148167	.	T	C	8	7	15	1	0	16	0	0
6	21148736	.	T	A	5	7	12	0	0	12	0	0
6	21148737	.	A	T	5	7	12	0	0	12	0	0
6	21148972	.	G	C	7	10	17	0	1	18	0	0
6	21149337	.	G	A	10	9	19	0	1	20	0	0
6	21150661	.	T	C	11	20	31	0	4	35	0	0
6	21150672	.	G	A	13	18	31	0	1	32	0	0
6	21150712	.	A	T	13	18	31	0	2	33	0	0
6	21150872	.	C	T	20	21	41	0	3	44	0	0
6	21150958	.	A	G	17	17	34	0	1	35	0	0
6	21151027	.	A	G	9	13	22	0	1	23	0	0
6	21151078	.	T	C	11	12	23	0	2	25	0	0
6	21151312	.	T	C	12	8	20	0	0	20	0	0
6	21151379	.	A	C	8	14	22	0	0	22	0	0
6	21151415	.	T	C	7	9	16	0	1	17	0	0
6	21151459	.	T	C	9	6	15	0	2	17	0	0
6	21153285	.	G	A	2	19	21	1	8	30	0	0
6	21154996	.	T	A	8	19	27	0	0	27	0	0
6	21363258	.	A	G	2	2	4	1	0	5	0	0
6	21390316	.	G	A	1	10	11	0	6	17	0	0
6	21391439	.	G	A	4	10	14	0	0	14	0	0
6	21391444	.	C	T	6	8	14	0	0	14	0	0
6	21391499	.	T	A	5	6	11	0	1	12	0	0
6	21391675	.	A	G	3	6	9	0	1	10	0	0
6	21392126	.	A	G	4	5	9	0	1	10	0	0
6	21392472	.	G	A	2	2	4	0	0	4	0	0
6	21392584	.	C	A	4	3	7	0	1	8	0	0
6	21392722	.	T	C	3	8	11	0	1	12	0	0
6	21393635	.	G	A	0	5	5	1	7	13	0	0
6	21395153	.	T	G	2	4	6	0	0	6	0	0
6	21395164	.	C	T	2	3	5	0	0	5	0	0
6	21454984	.	C	A	7	5	12	0	1	13	0	0
6	21513778	.	A	G	1	4	5	0	0	5	0	0
6	21513826	.	C	A	1	3	4	0	0	4	0	0
6	21514529	.	C	T	2	4	6	0	0	6	0	0
6	21515176	.	T	A	1	4	5	0	0	5	0	0
6	21515212	.	T	C	1	2	3	0	0	3	0	0
6	21516593	.	A	G	4	2	6	0	0	6	0	0
6	21525887	.	C	A	9	4	13	0	0	13	0	0
6	21525916	.	A	G	10	7	17	0	1	18	0	0
6	21525943	.	T	A	13	9	22	0	0	22	0	0
6	21526047	.	C	A	13	4	17	1	0	18	0	0
6	21526069	.	T	C	11	0	11	1	12	24	0	0
6	21526109	.	A	G	10	17	27	0	2	29	0	0
6	21526322	.	A	G	12	12	24	0	0	24	0	0
6	21526357	.	C	T	0	14	14	0	13	27	0	0
6	21526620	.	T	C	15	12	27	0	0	27	0	0
6	21529229	.	A	G	16	10	26	0	1	27	0	0
6	21529253	.	C	A	19	11	30	0	2	33	1	0
6	21529379	.	A	T	15	25	40	0	0	40	0	0
6	21543374	.	G	A	0	2	2	0	1	3	0	0
6	21547932	.	T	A	1	3	4	0	0	4	0	0
6	21570236	.	G	A	5	2	7	0	0	7	0	0
6	21576216	.	T	G	3	4	7	0	0	8	1	0
6	21577839	.	G	A	2	4	6	0	1	7	0	0
6	21578760	.	C	T	4	2	6	0	1	7	0	0
6	21581699	.	G	A	5	2	7	0	0	7	0	0
6	21588594	.	C	A	1	9	10	0	8	18	0	0
6	21588597	.	T	G	9	9	18	0	0	18	0	0
6	21588727	.	T	A	10	8	18	0	0	18	0	0
6	21588970	.	A	G	3	2	5	0	1	6	0	0
6	21598085	.	C	T	13	10	23	0	1	24	0	0
6	21602514	.	C	T	20	20	40	0	2	42	0	0
6	21602679	.	T	G	12	13	25	0	0	25	0	0
6	21602849	.	C	A	6	11	17	0	0	17	0	0
6	21615529	.	C	T	5	9	14	0	0	14	0	0
6	21693910	.	A	G	4	10	14	0	0	14	0	0
6	21694306	.	G	A	14	5	19	0	0	19	0	0
6	21694369	.	T	A	5	8	13	0	1	14	0	0
6	21694486	.	C	A	9	2	11	0	2	13	0	0
6	21694544	.	A	G	6	7	13	0	2	15	0	0
6	21694591	.	C	A	7	7	14	0	0	14	0	0
6	21694652	.	T	A	9	4	13	0	1	14	0	0
6	21694917	.	C	A	4	8	12	0	3	15	0	0
6	21695033	.	C	A	3	6	9	0	0	9	0	0
6	21695034	.	C	T	3	6	9	0	0	9	0	0
6	21726584	.	C	T	7	6	13	0	0	13	0	0
6	21809771	.	T	A	5	3	8	0	0	8	0	0
6	21809936	.	T	A	6	6	12	0	0	12	0	0
6	21811551	.	G	A	3	7	10	0	0	10	0	0
6	21815301	.	C	A	0	2	2	0	3	5	0	0
6	21830392	.	G	A	4	3	7	0	0	7	0	0
6	21861324	.	G	T	15	16	31	0	3	34	0	0
6	21861490	.	C	A	3	20	23	0	25	48	0	0
6	21861590	.	G	T	21	13	34	0	0	34	0	0
6	21861725	.	A	T	15	8	23	0	1	24	0	0
6	21861736	.	T	G	13	11	24	0	0	24	0	0
6	21862054	.	C	A	14	18	32	0	2	34	0	0
6	21862158	.	G	C	18	14	32	0	2	34	0	0
6	21862486	.	G	A	22	14	36	0	2	38	0	0
6	21875429	.	A	C	3	6	9	0	0	9	0	0
6	21875511	.	T	C	3	4	7	0	0	7	0	0
6	21875691	.	T	C	13	0	13	0	7	20	0	0
6	21875960	.	A	G	3	2	5	0	0	5	0	0
6	21876060	.	G	A	6	3	9	0	0	9	0	0
6	21876131	.	T	A	5	11	16	0	0	16	0	0
6	21877981	.	G	A	3	5	8	0	0	8	0	0
6	21878294	.	T	C	3	2	5	0	0	5	0	0
6	21891917	.	T	A	4	3	7	0	0	7	0	0
6	21996194	.	A	C	3	4	7	0	0	7	0	0
6	21996281	.	C	A	7	2	9	0	0	9	0	0
6	21996320	.	A	G	1	7	8	0	0	8	0	0
6	21996452	.	C	A	2	5	7	0	0	7	0	0
6	21999860	.	A	T	3	5	8	0	0	8	0	0
6	22001456	.	G	A	3	3	6	0	0	6	0	0
6	22007420	.	G	A	9	7	16	0	0	16	0	0
6	22026088	.	A	G	6	0	6	0	3	9	0	0
6	22026339	.	T	A	7	5	12	0	0	12	0	0
6	22026431	.	G	C	8	4	12	0	1	13	0	0
6	22026440	.	G	A	9	4	13	0	0	13	0	0
6	22026636	.	A	G	6	4	10	0	1	11	0	0
6	22026645	.	A	C	6	4	10	0	0	10	0	0
6	22027263	.	A	G	5	0	5	0	10	15	0	0
6	22028009	.	A	T	2	7	9	0	0	9	0	0
6	22034802	.	A	G	10	11	21	0	2	23	0	0
6	22034961	.	A	C	7	10	17	0	0	17	0	0
6	22035222	.	G	A	0	16	16	0	13	29	0	0
6	22035426	.	A	G	9	7	16	0	1	17	0	0
6	22035519	.	G	A	6	12	18	0	3	21	0	0
6	22037517	.	A	G	12	0	12	0	14	26	0	0
6	22037553	.	G	A	11	13	24	0	2	26	0	0
6	22037565	.	A	G	13	1	14	0	13	27	0	0
6	22037625	.	C	T	6	8	14	0	1	15	0	0
6	22048636	.	A	G	7	4	11	0	0	11	0	0
6	22053067	.	C	T	2	3	5	0	0	5	0	0
6	22055545	.	A	G	4	7	11	0	1	12	0	0
6	22058288	.	G	A	2	2	4	0	0	4	0	0
6	22058321	.	G	C	2	2	4	0	0	4	0	0
6	22062888	.	C	T	4	2	6	0	0	6	0	0
6	22064042	.	A	T	4	5	9	0	0	9	0	0
6	22078860	.	G	A	1	4	5	0	1	6	0	0
6	22082074	.	G	A	5	2	7	0	0	7	0	0
6	22088129	.	G	A	6	1	7	0	0	7	0	0
6	22088135	.	G	A	7	2	9	0	0	9	0	0
6	22090275	.	T	C	12	3	15	0	2	17	0	0
6	22093674	.	T	A	1	7	8	0	0	8	0	0
6	22093707	.	A	G	2	9	11	0	0	11	0	0
6	22093722	.	A	G	2	11	13	0	0	13	0	0
6	22099448	.	C	T	3	7	10	0	1	11	0	0
6	22102095	.	C	T	2	8	10	0	0	10	0	0
6	22102116	.	A	G	1	8	9	0	0	9	0	0
6	22102195	.	C	T	3	3	6	0	0	6	0	0
6	22105061	.	G	C	10	11	21	0	0	21	0	0
6	22105118	.	A	T	5	5	10	0	1	11	0	0
6	22105135	.	C	A	0	4	4	0	0	4	0	0
6	22105289	.	T	G	5	14	19	0	1	20	0	0
6	22107277	.	C	T	12	13	25	0	0	25	0	0
6	22107813	.	T	G	9	1	10	0	16	27	1	0
6	22107858	.	C	T	10	16	26	0	0	26	0	0
6	22108004	.	C	G	15	10	25	0	3	28	0	0
6	22108307	.	C	A	17	10	27	0	1	28	0	0
6	22109552	.	T	G	13	0	13	0	9	22	0	0
6	22109678	.	A	T	22	8	30	0	2	32	0	0
6	22111594	.	A	G	14	15	29	0	2	31	0	0
6	22112416	.	C	T	25	13	38	0	3	41	0	0
6	22118497	.	G	C	17	43	60	0	1	61	0	0
6	22118630	.	G	A	31	16	47	3	4	54	0	0
6	22118681	.	C	T	22	15	37	1	1	39	0	0
6	22119201	.	T	A	12	17	29	0	2	31	0	0
6	22119241	.	A	T	10	13	23	0	3	26	0	0
6	22119376	.	A	C	21	16	37	0	5	42	0	0
6	22119516	.	T	C	14	27	41	0	0	41	0	0
6	22119582	.	T	C	18	14	32	0	1	33	0	0
6	22119668	.	T	C	1	4	5	0	0	5	0	0
6	22119836	.	T	A	2	2	4	0	0	4	0	0
6	22119977	.	T	A	19	13	32	0	0	32	0	0
6	22120445	.	A	G	16	11	27	0	0	27	0	0
6	22120793	.	A	G	6	7	13	0	1	14	0	0
6	22127270	.	C	T	3	7	10	0	3	13	0	0
6	22328821	.	A	G	14	0	14	0	14	28	0	0
6	22333884	.	A	T	4	8	12	0	1	13	0	0
6	22344452	.	C	T	23	19	42	0	0	42	0	0
6	22351692	.	T	C	29	22	51	0	2	53	0	0
6	22351727	.	T	C	28	22	50	0	2	52	0	0
6	22351770	.	A	C	27	21	48	0	2	50	0	0
6	22351780	.	T	A	21	22	43	0	5	48	0	0
6	22352229	.	T	C	14	9	23	0	0	23	0	0
6	22352370	.	C	T	13	10	23	0	1	24	0	0
6	22352539	.	C	T	9	18	27	0	3	30	0	0
6	22354759	.	A	G	4	9	13	0	0	13	0	0
6	22463151	.	A	G	5	3	8	0	0	8	0	0
6	22463274	.	A	C	1	4	5	0	0	5	0	0
6	22463346	.	C	T	3	3	6	0	0	6	0	0
6	22464834	.	A	G	1	0	1	0	8	9	0	0
6	22464835	.	C	A	2	4	6	0	3	9	0	0
6	22519217	.	T	C	1	2	3	0	0	3	0	0
6	22537165	.	A	G	1	2	3	0	0	3	0	0
6	22597503	.	G	A	18	17	35	0	0	35	0	0
6	22615546	.	G	A	13	17	30	1	0	31	0	0
6	22628073	.	T	G	14	12	26	0	1	27	0	0
6	22628112	.	A	G	16	12	28	0	1	29	0	0
6	22628483	.	G	A	1	7	8	0	30	38	0	0
6	22628779	.	T	C	13	18	31	0	0	31	0	0
6	22628997	.	T	G	4	0	4	0	6	10	0	0
6	22629099	.	A	T	12	4	16	0	0	16	0	0
6	22629182	.	A	G	9	9	18	0	0	18	0	0
6	22966966	.	C	A	4	5	9	0	0	9	0	0
6	23001363	.	G	A	5	8	13	0	1	14	0	0
6	23010431	.	T	C	2	2	4	0	0	4	0	0
6	23010558	.	T	C	2	2	4	0	0	4	0	0
6	23010648	.	C	T	0	3	3	0	0	3	0	0
6	23010673	.	G	A	4	2	6	0	0	6	0	0
6	23010894	.	G	T	2	1	3	0	0	3	0	0
6	23010903	.	A	C	2	2	4	0	0	4	0	0
6	23010957	.	G	A	1	3	4	0	0	4	0	0
6	23010975	.	A	C	1	2	3	0	0	3	0	0
6	23018861	.	G	A	2	6	8	0	0	8	0	0
6	23053129	.	C	T	9	5	14	0	0	14	0	0
6	23053296	.	A	G	4	8	12	0	0	12	0	0
6	23053374	.	G	A	0	14	14	0	7	21	0	0
6	23053482	.	G	C	9	4	13	0	0	13	0	0
6	23053761	.	A	G	9	9	18	0	3	21	0	0
6	23053980	.	A	T	8	12	20	0	1	21	0	0
6	23054266	.	C	T	13	18	31	1	0	32	0	0
6	23054267	.	A	G	18	7	25	1	5	31	0	0
6	23054403	.	A	G	9	11	20	0	1	21	0	0
6	23054569	.	C	T	5	11	16	0	3	19	0	0
6	23054705	.	A	G	4	0	4	0	7	11	0	0
6	23137335	.	T	A	11	9	20	0	0	20	0	0
6	23617815	.	C	T	1	2	3	0	0	3	0	0
6	23752615	.	G	A	0	4	4	0	2	6	0	0
6	23781267	.	C	T	4	2	6	0	0	6	0	0
6	23781314	.	C	T	7	8	15	0	0	15	0	0
6	23810518	.	T	C	13	8	21	0	0	21	0	0
6	23810922	.	G	C	18	15	33	0	1	34	0	0
6	23811154	.	C	T	22	12	34	0	0	34	0	0
6	23812768	.	T	A	19	26	45	0	1	46	0	0
6	23812771	.	C	G	19	27	46	0	0	46	0	0
6	23812885	.	T	C	19	12	31	0	0	31	0	0
6	23813437	.	G	C	20	21	41	0	1	42	0	0
6	23813554	.	C	A	15	17	32	0	4	36	0	0
6	23813767	.	C	A	13	23	36	0	0	36	0	0
6	23903880	.	T	C	2	2	4	0	0	4	0	0
6	23938676	.	A	C	7	8	15	0	0	15	0	0
6	23938738	.	A	G	7	9	16	0	0	16	0	0
6	24055743	.	T	A	3	6	9	0	1	10	0	0
6	24055784	.	G	A	2	10	12	0	0	12	0	0
6	24055866	.	G	T	3	8	11	0	2	13	0	0
6	24056103	.	C	T	0	8	8	0	8	16	0	0
6	24065975	.	C	G	1	8	9	0	10	19	0	0
6	24066253	.	T	C	8	0	8	0	12	20	0	0
6	24066345	.	A	G	2	7	9	0	1	10	0	0
6	24066382	.	T	A	10	11	21	0	0	21	0	0
6	24066547	.	C	T	1	3	4	0	6	10	0	0
6	24066575	.	T	C	7	6	13	0	3	16	0	0
6	24066662	.	A	T	5	5	10	0	1	11	0	0
6	24094588	.	A	G	1	2	3	0	1	4	0	0
6	24094610	.	C	T	6	2	8	0	0	8	0	0
6	24153159	.	C	T	23	11	34	0	1	35	0	0
6	24155442	.	A	T	20	14	34	0	3	37	0	0
6	24155744	.	T	C	16	19	35	0	1	36	0	0
6	24155766	.	T	C	18	15	33	0	1	34	0	0
6	24155886	.	A	C	14	0	14	0	14	28	0	0
6	24155898	.	C	T	13	9	22	1	2	25	0	0
6	24156027	.	T	C	21	23	44	0	2	46	0	0
6	24156344	.	T	G	17	8	25	0	2	27	0	0
6	24156399	.	C	G	18	14	32	0	0	32	0	0
6	24156428	.	A	T	18	14	32	0	0	32	0	0
6	24156476	.	T	G	14	12	26	0	1	27	0	0
6	24156486	.	A	C	14	11	25	0	1	26	0	0
6	24156567	.	T	C	11	0	11	0	12	23	0	0
6	24157177	.	C	T	6	10	16	0	1	17	0	0
6	24158601	.	T	C	10	0	10	0	16	26	0	0
6	24160303	.	T	C	13	11	24	0	0	24	0	0
6	24161409	.	G	A	9	10	19	0	1	20	0	0
6	24163448	.	C	T	2	3	5	0	0	5	0	0
6	24163505	.	C	T	1	5	6	0	0	6	0	0
6	24176062	.	C	T	2	3	5	0	0	5	0	0
6	24202458	.	C	T	3	1	4	0	2	6	0	0
6	24203928	.	C	T	2	3	5	0	1	6	0	0
6	24338496	.	T	A	10	19	29	0	2	31	0	0
6	24338526	.	G	A	17	9	26	0	0	26	0	0
6	24358326	.	G	A	8	10	18	0	2	20	0	0
6	24358596	.	G	A	9	7	16	0	0	16	0	0
6	24358608	.	T	A	7	7	14	0	0	14	0	0
6	24364750	.	C	T	1	2	3	0	0	3	0	0
6	24365205	.	T	A	4	6	10	0	2	12	0	0
6	24365482	.	C	A	9	5	14	0	0	14	0	0
6	24370637	.	C	T	4	9	13	0	0	13	0	0
6	24370646	.	T	C	9	4	13	0	0	13	0	0
6	24379745	.	T	C	16	11	27	0	2	29	0	0
6	24379760	.	T	C	14	11	25	0	3	28	0	0
6	24379802	.	T	G	2	3	5	0	4	9	0	0
6	24379865	.	G	A	16	12	28	0	2	30	0	0
6	24380335	.	C	A	18	13	31	0	0	31	0	0
6	24382063	.	A	T	13	8	21	0	2	23	0	0
6	24384613	.	T	C	4	9	13	0	3	16	0	0
6	24389518	.	A	T	3	7	10	0	1	11	0	0
6	24392318	.	C	T	8	7	15	0	1	16	0	0
6	24392674	.	G	T	6	8	14	0	0	14	0	0
6	24392732	.	T	C	6	3	9	0	0	9	0	0
6	24392837	.	T	C	2	4	6	0	1	7	0	0
6	24681529	.	C	T	5	7	12	0	0	12	0	0
6	24681812	.	T	A	5	4	9	0	0	9	0	0
6	24682165	.	G	C	10	6	16	0	0	16	0	0
6	24682721	.	C	T	17	6	23	0	0	23	0	0
6	24682925	.	T	C	12	7	19	0	0	19	0	0
6	24683354	.	C	T	9	9	18	0	0	18	0	0
6	24683723	.	A	T	8	5	13	0	0	13	0	0
6	24683854	.	A	G	10	0	10	0	5	15	0	0
6	24691718	.	A	T	5	2	7	0	0	7	0	0
6	24691791	.	A	T	9	5	14	0	0	14	0	0
6	24697940	.	G	C	4	9	13	0	0	13	0	0
6	24698036	.	A	G	3	0	3	0	3	6	0	0
6	24818240	.	C	A	7	12	19	0	2	21	0	0
6	24818312	.	C	G	16	10	26	0	0	26	0	0
6	25162387	.	G	A	1	2	3	0	0	3	0	0
6	25168647	.	G	C	6	3	9	1	0	10	0	0
6	25169241	.	A	T	8	3	11	0	1	12	0	0
6	25169277	.	C	T	0	6	6	0	3	9	0	0
6	25169385	.	T	A	1	2	3	0	0	3	0	0
6	25170438	.	T	C	9	5	14	0	0	14	0	0
6	25170743	.	G	A	5	3	8	0	0	8	0	0
6	25171078	.	T	A	4	4	8	0	0	8	0	0
6	25171100	.	A	G	5	4	9	0	0	9	0	0
6	25171285	.	A	G	4	6	10	0	0	10	0	0
6	25171940	.	A	G	4	4	8	0	0	8	0	0
6	25172176	.	A	T	2	4	6	0	0	6	0	0
6	25173005	.	G	A	3	4	7	0	0	7	0	0
6	25173026	.	A	G	3	6	9	0	0	9	0	0
6	25314577	.	T	A	4	2	6	0	0	6	0	0
6	25933917	.	T	C	19	0	19	0	16	35	0	0
6	25934214	.	A	G	24	11	35	1	0	40	4	0
6	25934313	.	A	T	16	17	33	0	0	33	0	0
6	26065499	.	A	C	6	8	14	0	0	14	0	0
6	26065508	.	C	A	0	8	8	0	7	15	0	0
6	26066097	.	A	T	7	7	14	0	1	15	0	0
6	26080187	.	A	G	7	7	14	0	0	14	0	0
6	26080352	.	C	T	8	9	17	0	1	18	0	0
6	26225456	.	G	A	6	7	13	0	1	14	0	0
6	26225479	.	T	G	7	9	16	0	0	16	0	0
6	26225575	.	A	C	8	0	8	0	4	12	0	0
6	26225657	.	G	C	8	7	15	0	0	15	0	0
6	26558837	.	C	T	3	15	18	0	15	33	0	0
6	26558927	.	C	T	0	15	15	0	17	32	0	0
6	26559179	.	T	C	13	0	13	0	34	47	0	0
6	26559780	.	A	G	10	13	23	0	1	24	0	0
6	26559807	.	A	G	11	17	28	0	1	29	0	0
6	26875804	.	C	A	8	13	21	0	0	21	0	0
6	26875944	.	T	A	17	24	41	0	1	43	1	0
6	26878802	.	G	A	11	13	24	0	1	25	0	0
6	26879486	.	G	T	12	8	20	0	0	20	0	0
6	26879510	.	T	C	11	8	19	0	1	20	0	0
6	26883895	.	T	G	12	10	22	0	1	23	0	0
6	26891891	.	A	G	9	10	19	0	1	20	0	0
6	27038012	.	T	G	1	3	4	0	0	4	0	0
6	27038125	.	T	C	2	3	5	0	0	5	0	0
6	27038157	.	G	A	1	4	5	0	1	6	0	0
6	27038198	.	G	A	2	3	5	0	0	5	0	0
6	27038507	.	A	T	2	4	6	0	0	6	0	0
6	27041723	.	C	G	1	4	5	0	0	5	0	0
6	27041886	.	T	C	4	7	11	2	0	13	0	0
6	27041988	.	C	T	5	7	12	0	2	14	0	0
6	27045205	.	G	A	11	5	16	0	0	16	0	0
6	27045238	.	A	G	14	4	18	0	2	20	0	0
6	27045424	.	T	C	10	1	11	0	5	16	0	0
6	27048800	.	T	A	11	12	23	0	2	25	0	0
6	27048976	.	A	G	11	12	23	0	3	26	0	0
6	27051710	.	G	A	12	17	29	0	0	29	0	0
6	27051749	.	C	T	8	21	29	0	1	30	0	0
6	27051836	.	G	A	9	11	20	0	2	22	0	0
6	27055569	.	T	C	6	10	16	0	2	18	0	0
6	27057438	.	A	G	8	9	17	0	0	17	0	0
6	27057561	.	A	G	12	8	20	0	0	20	0	0
6	27057586	.	T	C	12	5	17	0	0	17	0	0
6	27057598	.	A	T	12	5	17	0	0	17	0	0
6	27087515	.	T	A	4	7	11	0	0	11	0	0
6	27087827	.	A	T	5	3	8	0	0	8	0	0
6	27087843	.	A	G	4	3	7	0	0	7	0	0
6	27087875	.	G	A	3	4	7	0	0	7	0	0
6	27087884	.	C	T	4	3	7	0	0	7	0	0
6	27088076	.	G	C	10	3	13	0	0	13	0	0
6	27088260	.	A	G	9	8	17	0	0	17	0	0
6	27088416	.	C	T	2	2	4	0	0	4	0	0
6	27092237	.	A	T	3	7	10	0	0	10	0	0
6	27092370	.	G	A	0	5	5	0	4	9	0	0
6	27099004	.	T	C	4	6	10	0	2	12	0	0
6	27099061	.	G	A	8	4	12	0	1	13	0	0
6	27101393	.	A	G	7	0	7	0	5	12	0	0
6	27104458	.	G	C	10	5	15	0	0	15	0	0
6	27104584	.	T	C	7	12	19	0	1	20	0	0
6	27104752	.	A	G	6	2	8	0	0	8	0	0
6	27106554	.	G	A	3	2	5	0	0	5	0	0
6	27108673	.	C	A	1	2	3	0	0	3	0	0
6	27108716	.	T	A	7	3	10	0	0	10	0	0
6	27146872	.	C	T	18	12	30	0	0	30	0	0
6	27146902	.	C	T	12	17	29	0	1	30	0	0
6	27146933	.	C	T	14	2	16	0	0	16	0	0
6	27146992	.	T	C	7	4	11	0	0	11	0	0
6	27216458	.	T	A	10	15	25	0	2	27	0	0
6	27220245	.	C	T	16	17	33	0	1	34	0	0
6	27231706	.	G	A	1	20	21	0	16	37	0	0
6	27233775	.	G	A	1	16	17	0	23	40	0	0
6	27234032	.	T	G	20	13	33	0	3	36	0	0
6	27234250	.	C	T	20	19	39	0	0	39	0	0
6	27234414	.	A	G	17	23	40	0	4	44	0	0
6	27259107	.	T	A	15	23	38	0	0	38	0	0
6	27265434	.	C	T	22	13	35	0	2	37	0	0
6	27269862	.	G	A	2	22	24	0	13	37	0	0
6	27269873	.	C	T	21	17	38	0	0	38	0	0
6	27269902	.	T	A	21	21	42	0	0	42	0	0
6	27270389	.	C	A	8	15	23	0	0	23	0	0
6	27270548	.	G	A	18	19	37	0	3	40	0	0
6	27270738	.	A	G	24	1	25	0	11	36	0	0
6	27270959	.	C	A	18	15	33	0	3	36	0	0
6	27271208	.	A	G	30	2	32	0	26	58	0	0
6	27271215	.	A	G	41	13	54	0	2	56	0	0
6	27271390	.	T	A	17	21	38	0	0	40	2	0
6	27271409	.	G	A	36	9	45	0	0	45	0	0
6	27271498	.	C	T	15	27	42	0	2	44	0	0
6	27271543	.	C	T	20	19	39	1	6	46	0	0
6	27271610	.	A	T	21	22	43	0	1	44	0	0
6	27271617	.	G	A	25	20	45	0	1	46	0	0
6	27271803	.	A	G	41	13	54	0	3	57	0	0
6	27271813	.	A	G	45	10	55	0	0	55	0	0
6	27272205	.	G	C	21	19	40	0	0	40	0	0
6	27272440	.	C	T	26	20	46	0	2	48	0	0
6	27272487	.	A	T	22	16	38	0	0	38	0	0
6	27272488	.	T	C	23	15	38	0	1	39	0	0
6	27272623	.	A	G	25	32	57	0	2	59	0	0
6	27272660	.	C	G	25	29	54	0	0	54	0	0
6	27272835	.	G	T	16	26	42	0	0	42	0	0
6	27276750	.	G	A	4	2	6	0	1	7	0	0
6	27278025	.	A	G	2	0	2	0	3	5	0	0
6	27279447	.	C	T	4	4	8	0	1	9	0	0
6	27284093	.	C	T	2	3	5	0	0	5	0	0
6	27288831	.	C	A	4	5	9	0	0	9	0	0
6	27449472	.	T	G	2	4	6	0	0	6	0	0
6	27449502	.	C	T	3	2	5	0	0	5	0	0
6	27450462	.	T	A	2	4	6	0	0	6	0	0
6	27510024	.	T	C	2	2	4	0	1	5	0	0
6	27574439	.	C	G	7	4	11	0	1	12	0	0
6	27574472	.	G	A	8	5	13	0	0	13	0	0
6	27613633	.	C	T	3	5	8	0	0	8	0	0
6	27614989	.	A	T	2	5	7	0	0	7	0	0
6	27614993	.	T	C	2	5	7	0	0	7	0	0
6	27615210	.	G	A	1	2	3	0	2	5	0	0
6	27615242	.	A	C	1	2	3	0	0	3	0	0
6	27667415	.	A	C	31	20	51	0	4	55	0	0
6	27775416	.	T	A	25	24	49	0	0	49	0	0
6	27874674	.	T	C	18	14	32	0	1	33	0	0
6	27874680	.	C	G	17	17	34	0	0	34	0	0
6	27874730	.	A	G	13	0	13	0	19	32	0	0
6	27874753	.	G	C	1	19	20	0	11	31	0	0
6	27874769	.	T	A	11	18	29	0	0	29	0	0
6	27874896	.	T	A	17	15	32	0	1	33	0	0
6	27875309	.	T	C	28	25	53	0	1	54	0	0
6	27875383	.	G	T	29	27	56	0	1	57	0	0
6	27875519	.	G	T	31	27	58	1	1	60	0	0
6	27875598	.	T	C	0	47	47	0	3	50	0	0
6	27875600	.	A	C	63	0	63	1	0	64	0	0
6	27875873	.	A	G	18	34	52	0	2	54	0	0
6	27876060	.	T	A	24	30	54	0	5	59	0	0
6	27876134	.	C	T	21	25	46	0	2	48	0	0
6	27889080	.	A	T	2	2	4	0	0	4	0	0
6	27925037	.	C	T	2	2	4	0	0	4	0	0
6	27993266	.	G	A	1	5	6	0	1	7	0	0
6	27993450	.	A	T	4	4	8	0	0	8	0	0
6	27993569	.	T	C	3	6	9	0	0	9	0	0
6	27993744	.	C	T	7	4	11	0	0	11	0	0
6	27997333	.	C	T	3	4	7	0	1	8	0	0
6	27997510	.	A	G	2	0	2	0	4	6	0	0
6	27997528	.	A	G	3	3	6	0	1	7	0	0
6	27998329	.	C	A	5	5	10	0	0	10	0	0
6	27999396	.	G	C	2	3	5	0	0	5	0	0
6	27999645	.	C	T	1	4	5	0	0	5	0	0
6	27999744	.	A	C	5	8	13	0	0	13	0	0
6	28000242	.	T	A	7	5	12	0	0	12	0	0
6	28000316	.	G	A	1	10	11	0	5	16	0	0
6	28000597	.	A	C	2	2	4	0	0	4	0	0
6	28000768	.	G	T	7	6	13	0	0	13	0	0
6	28020082	.	T	C	4	4	8	0	0	8	0	0
6	28031468	.	G	A	7	8	15	0	1	16	0	0
6	28031474	.	T	C	6	9	15	0	1	16	0	0
6	28033221	.	T	A	11	9	20	0	0	20	0	0
6	28036311	.	C	T	3	10	13	0	1	14	0	0
6	28039034	.	C	T	12	7	19	0	0	19	0	0
6	28039175	.	T	A	6	7	13	0	1	14	0	0
6	28041161	.	G	A	1	5	6	0	6	12	0	0
6	28044401	.	A	G	8	11	19	0	0	19	0	0
6	28048870	.	C	T	5	2	7	0	0	7	0	0
6	28048923	.	C	A	2	3	5	0	1	6	0	0
6	28124936	.	C	T	3	2	5	0	0	5	0	0
6	28125286	.	A	C	4	6	10	0	0	10	0	0
6	28186000	.	T	A	2	7	9	0	0	9	0	0
6	28206124	.	T	C	11	18	29	0	1	30	0	0
6	28206442	.	G	A	11	14	25	0	1	26	0	0
6	28207340	.	C	T	10	15	25	0	0	25	0	0
6	28207418	.	C	G	11	13	24	0	1	25	0	0
6	28207532	.	C	A	7	2	9	0	0	9	0	0
6	28207534	.	A	G	7	2	9	0	0	9	0	0
6	28207593	.	A	G	7	3	10	0	2	12	0	0
6	28209163	.	A	T	2	2	4	0	0	4	0	0
6	28209525	.	T	A	1	3	4	0	0	4	0	0
6	28217596	.	C	T	3	6	9	0	4	13	0	0
6	28218159	.	G	T	4	14	18	0	2	20	0	0
6	28218555	.	T	G	8	9	17	0	2	19	0	0
6	28223683	.	G	C	2	2	4	0	0	4	0	0
6	28689103	.	T	C	1	3	4	0	0	4	0	0
6	28689130	.	A	C	2	2	4	0	0	4	0	0
6	28914331	.	A	G	5	10	15	0	0	15	0	0
6	28914336	.	C	T	9	4	13	0	0	13	0	0
6	28914418	.	A	G	15	5	20	0	0	20	0	0
6	28914523	.	G	A	17	11	28	1	1	30	0	0
6	28914571	.	T	A	18	10	28	1	1	30	0	0
6	28914886	.	G	A	11	5	16	1	0	17	0	0
6	28914975	.	T	A	11	9	20	0	1	21	0	0
6	28923667	.	G	A	6	4	10	0	1	11	0	0
6	28926540	.	C	T	13	6	19	0	0	19	0	0
6	28926567	.	T	A	10	8	18	0	0	18	0	0
6	28931184	.	C	T	7	7	14	0	0	14	0	0
6	28932634	.	G	A	7	11	18	0	0	18	0	0
6	28946199	.	T	G	14	20	34	0	1	35	0	0
6	28956323	.	A	G	25	18	43	0	2	45	0	0
6	28957089	.	G	A	16	13	29	0	0	29	0	0
6	28957814	.	C	G	13	11	24	0	1	25	0	0
6	28961407	.	A	G	21	15	36	0	1	37	0	0
6	29011988	.	C	T	13	8	21	0	0	21	0	0
6	29012037	.	A	T	7	8	15	0	1	16	0	0
6	29034576	.	G	C	13	11	24	0	0	24	0	0
6	29040789	.	C	T	2	3	5	0	12	17	0	0
6	29040885	.	C	T	3	12	15	0	11	26	0	0
6	29043162	.	T	G	9	8	17	0	0	17	0	0
6	29044465	.	A	G	6	4	10	0	0	10	0	0
6	29044900	.	G	A	4	2	6	0	0	6	0	0
6	29044933	.	A	G	2	4	6	0	0	6	0	0
6	29085397	.	A	T	4	2	6	0	1	7	0	0
6	29087164	.	T	G	32	31	63	0	0	63	0	0
6	29096659	.	A	C	29	35	64	0	6	70	0	0
6	29097297	.	G	A	30	13	43	0	1	44	0	0
6	29097344	.	T	C	10	7	17	0	4	21	0	0
6	29103005	.	G	A	4	4	8	0	0	8	0	0
6	29103419	.	G	A	4	4	8	0	0	8	0	0
6	29105698	.	C	T	5	5	10	0	0	10	0	0
6	29143365	.	A	T	5	3	8	0	0	8	0	0
6	29144951	.	T	A	7	2	9	0	1	10	0	0
6	29144952	.	A	T	8	2	10	0	0	10	0	0
6	29145433	.	C	A	1	4	5	0	15	20	0	0
6	29145742	.	T	A	13	6	19	0	0	19	0	0
6	29152208	.	C	T	9	8	17	0	2	19	0	0
6	29152618	.	A	G	8	4	12	0	1	13	0	0
6	29152769	.	G	A	6	3	9	0	1	10	0	0
6	29152819	.	C	T	6	4	10	0	1	11	0	0
6	29154280	.	T	A	10	7	17	0	0	17	0	0
6	29154295	.	T	C	7	0	7	0	8	15	0	0
6	29154520	.	C	T	5	2	7	0	1	8	0	0
6	29154889	.	C	A	7	3	10	0	0	10	0	0
6	29155039	.	G	A	5	4	9	0	1	10	0	0
6	29156423	.	A	T	2	3	5	0	0	5	0	0
6	29159751	.	A	C	2	3	5	0	0	5	0	0
6	29159768	.	A	G	3	3	6	0	0	6	0	0
6	29159851	.	G	A	3	6	9	0	3	12	0	0
6	29221040	.	C	T	10	4	14	0	2	16	0	0
6	29222796	.	A	C	15	11	26	1	0	27	0	0
6	29223651	.	T	C	13	10	23	0	0	23	0	0
6	29226126	.	G	A	0	12	12	0	17	29	0	0
6	29226186	.	A	G	13	17	30	0	2	32	0	0
6	29226189	.	C	T	19	13	32	0	1	33	0	0
6	29226767	.	A	T	13	16	29	0	2	31	0	0
6	29226790	.	G	A	13	14	27	0	3	30	0	0
6	29226823	.	A	C	15	16	31	0	0	31	0	0
6	29273690	.	C	T	7	5	12	0	0	12	0	0
6	29273855	.	G	A	7	2	9	0	1	10	0	0
6	29278868	.	T	G	4	4	8	0	1	9	0	0
6	29278874	.	G	A	5	8	13	0	0	13	0	0
6	29287954	.	G	A	7	2	9	0	1	10	0	0
6	29288360	.	A	C	1	4	5	0	0	5	0	0
6	29288372	.	A	G	1	0	1	0	2	3	0	0
6	29289386	.	G	A	0	4	4	0	1	5	0	0
6	29289625	.	G	A	4	2	6	0	0	6	0	0
6	29289844	.	A	T	4	6	10	0	0	10	0	0
6	29289883	.	C	T	4	5	9	0	0	9	0	0
6	29291666	.	G	A	7	3	10	0	2	12	0	0
6	29292610	.	A	C	6	6	12	0	0	12	0	0
6	29292651	.	A	G	7	7	14	0	0	14	0	0
6	29292728	.	C	T	4	6	10	0	0	10	0	0
6	29292780	.	G	A	5	5	10	0	2	12	0	0
6	29292804	.	G	A	4	6	10	0	0	10	0	0
6	29292849	.	G	T	6	7	13	0	0	13	0	0
6	29295492	.	T	A	10	12	22	0	1	23	0	0
6	29295517	.	G	C	10	13	23	0	0	23	0	0
6	29295535	.	T	A	10	12	22	0	3	25	0	0
6	29295713	.	C	A	12	7	19	0	1	20	0	0
6	29295714	.	G	A	6	11	17	0	2	19	0	0
6	29295851	.	G	A	14	14	28	0	0	28	0	0
6	29295860	.	C	T	15	12	27	0	1	28	0	0
6	29303573	.	C	T	13	7	20	0	0	20	0	0
6	29303625	.	G	A	14	9	23	0	0	23	0	0
6	29303630	.	G	A	10	10	20	0	1	21	0	0
6	29303778	.	C	T	2	18	20	0	13	33	0	0
6	29303925	.	C	T	13	17	30	0	1	31	0	0
6	29303958	.	C	T	0	9	9	0	16	25	0	0
6	29305073	.	G	A	12	7	19	0	1	20	0	0
6	29322547	.	G	A	10	5	15	0	1	16	0	0
6	29328308	.	G	A	8	6	14	0	1	15	0	0
6	29328524	.	A	G	16	7	23	0	0	23	0	0
6	29328866	.	G	A	4	10	14	0	0	14	0	0
6	29330676	.	G	A	6	5	11	0	2	13	0	0
6	29330727	.	A	G	8	4	12	0	1	13	0	0
6	29332546	.	A	T	4	6	10	0	1	11	0	0
6	29336100	.	T	C	3	7	10	0	0	10	0	0
6	29337926	.	A	G	7	4	11	0	0	11	0	0
6	29347875	.	T	C	3	0	3	0	6	9	0	0
6	29348152	.	T	A	3	3	6	0	0	6	0	0
6	29393714	.	C	T	9	9	18	0	1	19	0	0
6	29394244	.	A	T	6	12	18	0	0	18	0	0
6	29395424	.	G	A	7	12	19	0	0	19	0	0
6	29395497	.	T	A	8	4	12	0	1	13	0	0
6	29397697	.	G	A	4	3	7	0	0	7	0	0
6	29401837	.	T	C	6	12	18	0	1	19	0	0
6	29402451	.	C	A	0	9	9	0	8	17	0	0
6	29403052	.	G	T	0	19	19	0	10	29	0	0
6	29403076	.	C	T	22	16	38	0	0	38	0	0
6	29414769	.	A	T	1	3	4	0	0	4	0	0
6	29414775	.	T	A	2	3	5	0	0	5	0	0
6	29434711	.	G	A	1	4	5	0	0	5	0	0
6	29458942	.	T	C	2	6	8	0	0	8	0	0
6	29466897	.	A	C	3	2	5	0	0	5	0	0
6	29466980	.	A	G	1	2	3	0	0	3	0	0
6	29466993	.	T	A	2	2	4	0	0	4	0	0
6	29467475	.	A	G	1	2	3	0	0	3	0	0
6	29468320	.	C	T	7	4	11	0	1	12	0	0
6	29468331	.	A	T	7	6	13	0	0	13	0	0
6	29468551	.	A	T	3	4	7	0	0	7	0	0
6	29468556	.	T	G	3	4	7	0	0	7	0	0
6	29468671	.	A	G	6	3	9	0	0	9	0	0
6	29476983	.	C	A	4	3	7	1	0	8	0	0
6	29477526	.	C	T	2	4	6	0	0	6	0	0
6	29477739	.	C	T	5	2	7	0	0	7	0	0
6	29477962	.	C	T	3	3	6	0	0	6	0	0
6	29488641	.	C	T	3	4	7	0	0	7	0	0
6	29612067	.	G	A	1	3	4	0	0	4	0	0
6	29705343	.	C	T	13	9	22	0	1	23	0	0
6	29705561	.	A	T	9	8	17	0	2	19	0	0
6	29705614	.	G	A	3	5	8	0	5	13	0	0
6	29708100	.	C	T	4	8	12	0	0	12	0	0
6	29710252	.	T	C	11	8	19	0	2	21	0	0
6	29713920	.	G	T	3	5	8	0	0	8	0	0
6	29713926	.	T	C	3	11	14	0	0	14	0	0
6	29714017	.	A	G	6	4	10	0	0	10	0	0
6	29714139	.	C	T	1	2	3	0	1	4	0	0
6	29714171	.	A	G	0	3	3	0	1	4	0	0
6	29754191	.	T	G	3	2	5	0	0	5	0	0
6	29793814	.	C	T	32	43	75	0	6	81	0	0
6	29794003	.	T	G	36	42	78	0	1	79	0	0
6	29794042	.	G	A	39	35	74	0	3	77	0	0
6	29794695	.	T	C	29	30	59	0	2	61	0	0
6	30027896	.	C	A	19	12	31	0	1	32	0	0
6	30032574	.	A	G	14	1	15	1	14	30	0	0
6	30048285	.	A	G	6	0	6	0	5	11	0	0
6	30052061	.	C	A	34	15	49	0	2	51	0	0
6	30052085	.	A	G	32	19	51	0	0	51	0	0
6	30060296	.	C	T	20	28	48	0	2	50	0	0
6	30081420	.	C	T	24	14	38	0	3	41	0	0
6	30081421	.	T	C	26	13	39	0	2	41	0	0
6	30081503	.	A	G	26	20	46	0	1	47	0	0
6	30081725	.	C	T	20	23	43	0	2	45	0	0
6	30082838	.	G	T	12	13	25	0	2	27	0	0
6	30124575	.	C	T	18	15	33	0	0	33	0	0
6	30133958	.	G	T	20	13	33	0	4	37	0	0
6	30147249	.	T	C	14	1	15	0	15	30	0	0
6	30148182	.	G	A	9	8	17	0	1	18	0	0
6	30148422	.	C	T	16	15	31	0	1	32	0	0
6	30148863	.	T	C	16	21	37	1	1	39	0	0
6	30151519	.	G	A	17	15	32	0	2	34	0	0
6	30151537	.	G	A	16	13	29	0	2	31	0	0
6	30160956	.	C	T	12	14	26	0	1	27	0	0
6	30177635	.	G	A	8	3	11	0	0	11	0	0
6	30177724	.	G	A	9	5	14	0	0	14	0	0
6	30177742	.	T	C	6	8	14	0	1	15	0	0
6	30432533	.	T	G	3	3	6	0	1	7	0	0
6	30432887	.	C	A	1	2	3	0	0	3	0	0
6	30432995	.	G	T	2	2	4	0	0	4	0	0
6	30433029	.	T	C	2	3	5	0	0	5	0	0
6	30433053	.	C	T	1	3	4	0	0	4	0	0
6	30433069	.	G	A	2	2	4	0	0	4	0	0
6	30433125	.	C	T	1	2	3	0	0	3	0	0
6	30433337	.	T	A	3	2	5	0	0	5	0	0
6	30433389	.	C	G	2	4	6	0	0	6	0	0
6	30433415	.	T	A	3	2	5	0	0	5	0	0
6	30440099	.	A	C	8	5	13	0	0	13	0	0
6	30441536	.	G	A	3	4	7	0	0	7	0	0
6	30441589	.	C	G	5	3	8	0	0	8	0	0
6	30441762	.	G	A	3	7	10	0	0	10	0	0
6	30450458	.	T	C	5	5	10	0	0	10	0	0
6	30452669	.	A	T	5	2	7	0	0	7	0	0
6	30452811	.	C	T	1	4	5	0	0	5	0	0
6	30452843	.	G	T	4	3	7	0	0	7	0	0
6	30452932	.	G	C	4	3	7	0	1	8	0	0
6	30538648	.	C	T	1	2	3	0	0	3	0	0
6	30538681	.	A	G	1	2	3	0	0	3	0	0
6	30579371	.	A	T	4	4	8	0	1	9	0	0
6	30583746	.	A	G	3	0	3	0	3	6	0	0
6	30583815	.	A	G	4	3	7	0	0	7	0	0
6	30587201	.	T	A	3	11	14	0	0	14	0	0
6	30588283	.	C	T	3	5	8	0	0	8	0	0
6	30592556	.	T	C	3	2	5	0	0	5	0	0
6	30592558	.	A	T	3	2	5	0	0	5	0	0
6	30592624	.	C	G	1	2	3	0	0	3	0	0
6	30626630	.	T	G	5	7	12	0	0	12	0	0
6	30626908	.	G	A	12	8	20	0	3	23	0	0
6	30626931	.	T	C	11	4	15	0	0	15	0	0
6	30627182	.	T	A	10	15	25	0	1	26	0	0
6	30627228	.	A	C	19	22	41	0	0	41	0	0
6	30627549	.	G	A	14	9	23	0	1	24	0	0
6	30627674	.	G	T	11	11	22	0	4	26	0	0
6	30627764	.	G	T	15	11	26	0	1	27	0	0
6	30627807	.	G	T	6	11	17	0	2	19	0	0
6	30627811	.	T	C	12	6	18	0	3	21	0	0
6	30628066	.	T	C	8	12	20	0	2	22	0	0
6	30628097	.	C	T	12	12	24	0	1	25	0	0
6	30628185	.	G	A	6	13	19	0	0	19	0	0
6	30628447	.	G	A	12	10	22	0	0	22	0	0
6	30628459	.	A	G	11	11	22	0	0	22	0	0
6	30628540	.	T	C	9	1	10	0	8	18	0	0
6	30628651	.	G	A	5	5	10	0	0	10	0	0
6	30628684	.	C	A	8	4	12	0	0	12	0	0
6	30628848	.	C	T	11	7	18	0	2	20	0	0
6	30628976	.	T	A	9	8	17	0	1	18	0	0
6	30628978	.	C	T	8	9	17	0	0	17	0	0
6	30629142	.	G	A	9	8	17	0	1	18	0	0
6	30629229	.	T	A	5	7	12	0	0	12	0	0
6	30629373	.	A	T	9	4	13	0	0	13	0	0
6	30629384	.	T	C	4	0	4	0	9	13	0	0
6	30629553	.	C	T	0	5	5	0	8	13	0	0
6	30629734	.	A	G	5	3	8	0	0	8	0	0
6	30629827	.	C	A	5	6	11	0	1	12	0	0
6	30629988	.	C	A	2	2	4	0	0	4	0	0
6	30630017	.	C	T	0	3	3	0	5	8	0	0
6	30630057	.	G	A	5	2	7	0	0	7	0	0
6	30630454	.	T	G	3	8	11	0	0	11	0	0
6	30630811	.	T	C	13	7	20	0	0	20	0	0
6	30630904	.	A	G	9	6	15	0	1	16	0	0
6	30658102	.	T	C	9	5	14	0	0	14	0	0
6	30658524	.	T	C	6	4	10	0	0	10	0	0
6	30658545	.	G	A	8	3	11	0	1	12	0	0
6	30658728	.	A	C	5	4	9	0	0	9	0	0
6	30677445	.	G	C	6	2	8	0	0	8	0	0
6	30677475	.	A	G	4	4	8	1	1	10	0	0
6	30677582	.	T	C	8	5	13	0	0	13	0	0
6	30677602	.	A	T	7	4	11	0	0	11	0	0
6	30677646	.	A	G	3	4	7	0	0	7	0	0
6	30677701	.	C	T	0	4	4	0	2	6	0	0
6	30677734	.	A	C	1	0	1	0	8	9	0	0
6	30678133	.	A	T	1	3	4	0	0	4	0	0
6	30678396	.	T	C	2	4	6	0	0	6	0	0
6	30678406	.	C	A	4	2	6	0	0	6	0	0
6	30681208	.	C	T	6	3	9	0	0	9	0	0
6	30681291	.	C	A	2	8	10	0	0	10	0	0
6	30683571	.	T	A	4	2	6	0	0	6	0	0
6	30683578	.	T	C	4	2	6	0	0	6	0	0
6	30685027	.	T	C	3	2	5	0	0	5	0	0
6	30685353	.	T	C	2	2	4	0	0	4	0	0
6	30685354	.	G	A	2	2	4	0	0	4	0	0
6	30688021	.	A	G	2	4	6	0	1	7	0	0
6	30710313	.	C	A	23	20	43	1	1	45	0	0
6	30711447	.	C	T	9	8	17	0	1	18	0	0
6	30711485	.	A	T	8	18	26	0	1	27	0	0
6	30711511	.	C	T	10	18	28	0	2	30	0	0
6	30711554	.	C	T	4	13	17	1	14	32	0	0
6	30711586	.	A	C	19	3	22	1	15	38	0	0
6	30711612	.	G	A	18	21	39	1	1	41	0	0
6	30711777	.	C	T	8	25	33	1	0	34	0	0
6	30712121	.	G	T	22	14	36	1	1	38	0	0
6	30712458	.	A	G	16	8	24	1	0	25	0	0
6	30712508	.	G	A	19	17	36	1	1	38	0	0
6	30712616	.	C	T	0	8	8	0	14	22	0	0
6	30712622	.	A	G	15	7	22	1	2	25	0	0
6	30712917	.	G	A	22	9	31	0	1	32	0	0
6	30713184	.	T	A	15	10	25	1	0	26	0	0
6	30713334	.	G	C	13	9	22	1	0	23	0	0
6	30713341	.	G	A	9	12	21	1	1	23	0	0
6	30713647	.	C	T	7	9	16	0	3	19	0	0
6	30713910	.	C	T	22	19	41	0	1	42	0	0
6	30713929	.	C	G	27	17	44	0	0	44	0	0
6	30714177	.	T	A	15	12	27	0	2	29	0	0
6	30714218	.	T	A	10	20	30	0	0	30	0	0
6	30714240	.	T	C	11	12	23	0	2	25	0	0
6	30715647	.	A	T	8	15	23	0	1	24	0	0
6	30715865	.	A	T	13	17	30	0	2	32	0	0
6	30719348	.	G	C	13	14	27	0	2	29	0	0
6	30719391	.	A	T	17	9	26	0	1	27	0	0
6	30719935	.	C	T	10	11	21	0	0	21	0	0
6	30721397	.	G	A	12	14	26	0	3	29	0	0
6	30740160	.	C	A	1	3	4	0	7	11	0	0
6	30851611	.	A	T	10	7	17	0	1	18	0	0
6	30853053	.	T	A	45	26	71	0	2	73	0	0
6	30855423	.	G	A	24	16	40	0	0	40	0	0
6	30859381	.	T	A	19	22	41	0	1	42	0	0
6	30931362	.	C	T	0	6	6	0	6	12	0	0
6	30931476	.	A	T	4	7	11	0	0	12	1	0
6	30931479	.	T	C	6	0	6	0	6	12	0	0
6	31069622	.	T	A	4	4	8	0	1	9	0	0
6	31146723	.	G	A	5	6	11	0	0	11	0	0
6	31146776	.	T	A	5	7	12	0	0	12	0	0
6	31146868	.	A	C	3	0	3	0	2	5	0	0
6	31146993	.	T	C	4	0	4	0	3	7	0	0
6	31147002	.	A	G	3	2	5	0	0	5	0	0
6	31184532	.	T	C	2	4	6	0	0	6	0	0
6	31184600	.	T	G	3	4	7	1	0	8	0	0
6	31185133	.	G	A	8	5	13	0	0	13	0	0
6	31185247	.	C	G	7	4	11	0	0	11	0	0
6	31185292	.	A	C	4	8	12	0	0	12	0	0
6	31185760	.	T	A	3	5	8	0	0	8	0	0
6	31185825	.	A	T	3	4	7	0	0	7	0	0
6	31186563	.	T	A	8	1	9	0	0	9	0	0
6	31186981	.	G	A	6	4	10	0	0	10	0	0
6	31198291	.	C	T	6	4	10	0	0	10	0	0
6	31214355	.	C	T	2	2	4	0	0	4	0	0
6	31214368	.	G	A	1	2	3	0	0	3	0	0
6	31279834	.	G	A	12	11	23	0	2	25	0	0
6	31280141	.	G	A	25	12	37	0	0	37	0	0
6	31280185	.	T	A	19	21	40	0	1	41	0	0
6	31280495	.	C	T	8	20	28	0	2	30	0	0
6	31280586	.	A	G	12	13	25	0	4	29	0	0
6	31280646	.	A	C	9	17	26	0	0	26	0	0
6	31280681	.	C	A	12	8	20	0	2	22	0	0
6	31280936	.	A	T	10	14	24	0	1	25	0	0
6	31281006	.	C	T	1	13	14	0	7	21	0	0
6	31281130	.	A	G	21	19	40	0	2	42	0	0
6	31281304	.	C	A	21	19	40	1	1	42	0	0
6	31281481	.	A	G	7	7	14	0	0	14	0	0
6	31281533	.	T	A	6	11	17	0	0	17	0	0
6	31281537	.	A	G	6	12	18	0	0	18	0	0
6	31281594	.	A	T	16	9	25	0	2	27	0	0
6	31281694	.	C	T	6	10	16	0	0	16	0	0
6	31281994	.	T	A	12	8	20	0	1	21	0	0
6	31282028	.	T	G	11	5	16	1	0	17	0	0
6	31282170	.	T	C	8	0	8	0	9	17	0	0
6	31282205	.	C	T	16	9	25	0	0	25	0	0
6	31283049	.	C	A	10	7	17	0	0	17	0	0
6	31283055	.	G	A	8	10	18	0	1	19	0	0
6	31283245	.	A	G	15	10	25	0	0	25	0	0
6	31283280	.	T	A	14	8	22	0	0	22	0	0
6	31309823	.	C	T	0	12	12	0	9	21	0	0
6	31336156	.	G	A	12	11	23	0	1	24	0	0
6	31352298	.	T	A	7	9	16	0	5	21	0	0
6	31352406	.	C	A	14	17	31	0	2	33	0	0
6	31352635	.	T	G	3	4	7	0	0	7	0	0
6	31352664	.	C	T	5	4	9	0	0	9	0	0
6	31352956	.	A	C	11	9	20	0	1	21	0	0
6	31353022	.	G	C	7	12	19	0	1	20	0	0
6	31353345	.	T	A	8	12	20	0	2	22	0	0
6	31353451	.	A	T	5	14	19	0	3	22	0	0
6	31355787	.	C	T	14	10	24	0	1	25	0	0
6	31358525	.	C	T	1	13	14	0	15	30	1	0
6	31368096	.	C	T	2	2	4	0	0	4	0	0
6	31394453	.	A	C	5	5	10	0	0	10	0	0
6	31394508	.	T	C	3	5	8	0	0	8	0	0
6	31395724	.	T	C	4	2	6	0	0	6	0	0
6	31395746	.	C	T	4	3	7	0	0	7	0	0
6	31395943	.	C	T	4	2	6	0	0	6	0	0
6	31396249	.	A	T	2	7	9	0	0	9	0	0
6	31405898	.	G	A	0	6	6	0	7	13	0	0
6	31405923	.	C	T	5	4	9	0	1	10	0	0
6	31411751	.	C	T	4	4	8	0	0	8	0	0
6	31414061	.	A	C	7	6	13	0	0	13	0	0
6	31416100	.	A	G	1	0	1	0	8	9	0	0
6	31417667	.	C	T	7	5	12	0	0	12	0	0
6	31419749	.	T	C	7	7	14	0	0	14	0	0
6	31426246	.	A	G	12	1	13	0	6	19	0	0
6	31426727	.	C	G	8	12	20	0	0	20	0	0
6	31426881	.	C	T	15	7	22	0	2	24	0	0
6	31426886	.	C	T	6	15	21	0	2	23	0	0
6	31427226	.	C	T	4	5	9	0	0	9	0	0
6	31427261	.	T	C	4	5	9	0	1	10	0	0
6	31427468	.	A	G	5	6	11	0	0	11	0	0
6	31427538	.	A	G	2	8	10	0	1	11	0	0
6	31428283	.	C	A	16	12	28	1	0	29	0	0
6	31428448	.	T	A	5	3	8	0	1	9	0	0
6	31428565	.	T	G	7	4	11	0	0	11	0	0
6	31428566	.	A	G	6	4	10	0	1	11	0	0
6	31428705	.	C	T	19	6	25	0	1	26	0	0
6	31428954	.	C	T	4	4	8	1	0	9	0	0
6	31428980	.	C	G	2	0	2	1	4	7	0	0
6	31430900	.	T	C	0	4	4	0	1	5	0	0
6	31431145	.	T	G	9	4	13	0	1	14	0	0
6	31431355	.	G	A	12	15	27	0	0	27	0	0
6	31431520	.	A	G	20	12	32	0	1	33	0	0
6	31431775	.	T	C	19	12	31	0	2	33	0	0
6	31431870	.	G	A	19	9	28	0	2	30	0	0
6	31431926	.	A	T	25	19	44	0	2	46	0	0
6	31432302	.	G	A	5	7	12	0	0	12	0	0
6	31432431	.	A	G	3	2	5	0	0	5	0	0
6	31432554	.	A	T	2	7	9	0	0	9	0	0
6	31432617	.	T	G	6	4	10	0	1	11	0	0
6	31432679	.	T	A	9	3	12	0	0	12	0	0
6	31432684	.	T	C	3	7	10	0	0	10	0	0
6	31432950	.	G	A	3	8	11	2	0	13	0	0
6	31432955	.	T	C	3	6	9	2	0	11	0	0
6	31433412	.	A	G	2	5	7	0	2	9	0	0
6	31433572	.	T	A	6	4	10	0	2	12	0	0
6	31433692	.	A	T	3	3	6	0	3	9	0	0
6	31433846	.	G	A	2	8	10	0	2	12	0	0
6	31434050	.	C	A	2	7	9	0	0	9	0	0
6	31434245	.	A	T	7	7	14	0	0	14	0	0
6	31434830	.	A	G	8	7	15	0	0	15	0	0
6	31434923	.	C	T	1	4	5	0	13	18	0	0
6	31435017	.	C	T	0	8	8	0	7	15	0	0
6	31441574	.	A	T	14	8	22	0	3	25	0	0
6	31462606	.	G	A	6	8	14	0	0	14	0	0
6	31463147	.	A	T	8	2	10	0	0	10	0	0
6	31470029	.	G	C	6	0	6	0	11	17	0	0
6	31470041	.	T	C	6	9	15	0	2	17	0	0
6	31591116	.	C	T	4	5	9	0	2	11	0	0
6	31591452	.	C	T	9	9	18	0	1	19	0	0
6	31591838	.	T	G	9	17	26	0	5	31	0	0
6	31591841	.	G	A	18	8	26	0	5	31	0	0
6	31591997	.	A	C	19	0	19	0	22	41	0	0
6	31598783	.	C	T	13	5	18	0	1	19	0	0
6	31624107	.	T	C	8	6	14	0	1	15	0	0
6	31627223	.	G	A	4	9	13	0	0	13	0	0
6	31631366	.	A	G	8	7	15	0	0	15	0	0
6	31632508	.	T	C	11	6	17	0	0	17	0	0
6	31632519	.	G	A	13	6	19	0	0	19	0	0
6	31632550	.	G	C	4	0	4	0	5	9	0	0
6	31638814	.	A	G	1	3	4	0	0	4	0	0
6	32010341	.	C	T	2	15	17	0	14	31	0	0
6	32010475	.	A	G	27	20	47	0	2	49	0	0
6	32014771	.	T	G	20	24	44	0	1	45	0	0
6	32016492	.	T	C	22	21	43	0	3	46	0	0
6	32020326	.	G	A	13	8	21	0	1	22	0	0
6	32020327	.	T	A	13	9	22	0	0	22	0	0
6	32024960	.	C	T	13	8	21	0	1	22	0	0
6	32025005	.	C	T	0	6	6	0	10	16	0	0
6	32025109	.	C	A	16	11	27	0	0	27	0	0
6	32029267	.	A	T	3	5	8	0	0	8	0	0
6	32029269	.	A	T	3	5	8	0	0	8	0	0
6	32032371	.	A	C	7	11	18	0	0	18	0	0
6	32032479	.	C	T	9	11	20	0	0	20	0	0
6	32034354	.	G	A	1	2	3	0	0	3	0	0
6	32035921	.	G	A	1	5	6	0	0	6	0	0
6	32040581	.	G	A	4	8	12	0	0	12	0	0
6	32040620	.	G	A	5	1	6	0	1	7	0	0
6	32042325	.	C	T	3	3	6	0	0	6	0	0
6	32042381	.	G	A	4	3	7	0	0	7	0	0
6	32043513	.	G	C	5	4	9	0	0	9	0	0
6	32043514	.	G	T	5	4	9	0	0	9	0	0
6	32065310	.	C	T	4	3	7	0	0	7	0	0
6	32068390	.	C	T	1	2	3	0	3	6	0	0
6	32068411	.	G	C	3	3	6	0	1	7	0	0
6	32068488	.	G	A	3	2	5	0	0	5	0	0
6	32092853	.	G	A	2	2	4	0	0	4	0	0
6	32300717	.	G	A	4	4	8	0	1	9	0	0
6	32301040	.	G	C	2	5	7	0	0	7	0	0
6	32301137	.	A	T	6	5	11	0	0	11	0	0
6	32301161	.	C	T	11	4	15	0	0	15	0	0
6	32301214	.	A	T	8	3	11	0	0	11	0	0
6	32301265	.	A	T	11	7	18	0	0	18	0	0
6	32301462	.	C	T	8	3	11	0	0	11	0	0
6	32301487	.	G	C	4	2	6	0	0	7	1	0
6	32301900	.	C	G	0	9	9	0	4	13	0	0
6	32301969	.	T	G	12	5	17	0	2	19	0	0
6	32302236	.	C	T	0	8	8	0	3	11	0	0
6	32336532	.	C	T	8	4	12	0	0	12	0	0
6	32339831	.	C	A	7	5	12	0	0	12	0	0
6	32340005	.	C	T	6	5	11	0	0	11	0	0
6	32345010	.	A	T	2	2	4	0	0	4	0	0
6	32345039	.	G	A	2	2	4	0	0	4	0	0
6	32346790	.	G	A	6	3	9	0	0	9	0	0
6	32346802	.	C	T	3	6	9	0	1	10	0	0
6	32347346	.	C	T	0	2	2	0	3	5	0	0
6	32359264	.	C	T	3	3	6	0	1	7	0	0
6	32359371	.	A	G	3	4	7	0	0	7	0	0
6	32359470	.	G	A	2	3	5	0	0	5	0	0
6	32364439	.	C	T	6	7	13	0	0	13	0	0
6	32368952	.	C	T	3	2	5	0	0	5	0	0
6	32368970	.	A	T	1	2	3	0	1	4	0	0
6	32371466	.	A	T	2	6	8	0	0	8	0	0
6	32375838	.	T	C	8	9	17	0	0	17	0	0
6	32382629	.	C	T	13	9	22	0	0	22	0	0
6	32397588	.	C	T	18	24	42	0	0	42	0	0
6	32398844	.	G	A	12	16	28	0	1	29	0	0
6	32403028	.	G	A	15	11	26	0	1	27	0	0
6	32403052	.	T	C	15	11	26	0	0	26	0	0
6	32404206	.	C	G	9	14	23	0	1	24	0	0
6	32404863	.	C	T	0	5	5	0	7	12	0	0
6	32405020	.	G	A	11	11	22	0	1	23	0	0
6	32405266	.	G	A	4	4	8	0	0	8	0	0
6	32405478	.	A	T	4	6	10	0	0	10	0	0
6	32405741	.	A	T	10	5	15	0	1	16	0	0
6	32405784	.	A	G	8	12	20	0	0	20	0	0
6	32405952	.	C	T	8	3	11	0	0	11	0	0
6	32406216	.	G	A	10	5	15	0	1	16	0	0
6	32408437	.	C	T	2	3	5	0	4	9	0	0
6	32408742	.	A	T	3	2	5	0	1	6	0	0
6	32409490	.	T	A	5	5	10	0	0	10	0	0
6	32409931	.	A	G	3	8	11	0	0	11	0	0
6	32481835	.	G	A	9	5	14	0	0	14	0	0
6	32481868	.	G	A	6	3	9	0	1	10	0	0
6	32481998	.	T	C	1	7	8	0	1	9	0	0
6	32482213	.	A	G	5	2	7	0	0	7	0	0
6	32482376	.	G	A	3	6	9	0	1	10	0	0
6	32482727	.	G	A	2	3	5	0	0	5	0	0
6	32482984	.	C	T	5	4	9	0	0	9	0	0
6	32483265	.	A	G	6	4	10	0	0	10	0	0
6	32483443	.	C	G	2	3	5	0	0	5	0	0
6	32483750	.	T	C	9	4	13	0	0	13	0	0
6	32483869	.	C	T	1	2	3	0	0	3	0	0
6	32493039	.	C	A	2	6	8	0	0	8	0	0
6	32493103	.	C	T	1	3	4	0	0	4	0	0
6	32497690	.	A	G	9	4	13	0	1	14	0	0
6	32504356	.	C	T	11	5	16	0	0	16	0	0
6	32506349	.	T	A	7	8	15	0	2	17	0	0
6	32506386	.	C	T	9	8	17	0	1	18	0	0
6	32506473	.	G	A	0	6	6	0	9	15	0	0
6	32506526	.	A	G	2	4	6	0	0	6	0	0
6	32507270	.	C	T	1	3	4	0	0	4	0	0
6	32699666	.	G	A	5	4	9	0	1	10	0	0
6	32699682	.	T	A	5	5	10	0	1	11	0	0
6	32699775	.	A	C	5	0	5	0	5	10	0	0
6	32700108	.	T	C	2	3	5	0	0	5	0	0
6	32700530	.	T	C	4	2	6	0	0	6	0	0
6	32700607	.	T	G	3	3	6	0	1	7	0	0
6	32702198	.	C	T	6	4	10	0	1	11	0	0
6	32703298	.	T	A	3	2	5	0	0	5	0	0
6	32722640	.	C	T	0	4	4	0	9	13	0	0
6	32722680	.	A	T	6	6	12	0	0	12	0	0
6	32739226	.	A	G	2	3	5	0	0	5	0	0
6	32744121	.	G	A	2	3	5	0	0	5	0	0
6	32830082	.	T	C	2	4	6	0	0	6	0	0
6	32830083	.	A	G	4	2	6	0	0	6	0	0
6	32831529	.	C	T	0	3	3	0	4	7	0	0
6	32831584	.	A	G	2	3	5	0	0	5	0	0
6	32831927	.	G	A	4	3	7	0	1	8	0	0
6	32832003	.	A	G	1	5	6	0	0	6	0	0
6	32832061	.	C	T	0	5	5	0	2	7	0	0
6	32832113	.	G	A	2	2	4	0	0	4	0	0
6	32832166	.	T	C	4	0	4	0	3	7	0	0
6	32832409	.	G	T	5	4	9	0	0	9	0	0
6	32832662	.	A	G	5	6	11	0	0	11	0	0
6	32832747	.	A	C	3	4	7	0	0	7	0	0
6	32966915	.	G	C	12	11	23	0	0	23	0	0
6	32967065	.	C	T	6	11	17	0	1	18	0	0
6	32967080	.	T	C	7	11	18	0	1	19	0	0
6	32967174	.	G	A	13	13	26	0	0	26	0	0
6	32967182	.	A	T	12	11	23	0	0	23	0	0
6	32967357	.	G	A	15	8	23	0	0	23	0	0
6	32970032	.	G	A	11	8	19	0	1	20	0	0
6	32970178	.	T	C	10	8	18	0	0	18	0	0
6	32976281	.	G	A	4	7	11	0	4	15	0	0
6	32979285	.	A	C	5	7	12	0	1	13	0	0
6	32999747	.	A	C	5	0	5	0	7	12	0	0
6	33023389	.	T	A	6	8	14	0	2	16	0	0
6	33023439	.	G	A	7	9	16	0	1	17	0	0
6	33023545	.	T	C	7	0	7	0	12	19	0	0
6	33023601	.	A	G	6	8	14	0	1	15	0	0
6	33023625	.	G	C	5	6	11	0	0	11	0	0
6	33085555	.	G	T	5	6	11	0	0	11	0	0
6	33085558	.	G	T	6	5	11	0	0	11	0	0
6	33089139	.	G	A	0	3	3	0	9	12	0	0
6	33089475	.	G	A	2	5	7	0	1	8	0	0
6	33089493	.	G	A	1	5	6	0	1	7	0	0
6	33091561	.	C	T	2	2	4	0	0	4	0	0
6	33091567	.	T	C	2	2	4	0	0	4	0	0
6	33092969	.	A	C	3	2	5	0	1	6	0	0
6	33094767	.	A	C	5	4	9	0	0	9	0	0
6	33095174	.	G	A	2	2	4	0	0	4	0	0
6	33095499	.	T	C	6	6	12	0	1	13	0	0
6	33548919	.	A	G	7	9	16	1	0	17	0	0
6	33549187	.	T	G	6	1	7	0	12	19	0	0
6	33552793	.	A	G	1	8	9	0	1	10	0	0
6	33553084	.	G	A	4	8	12	0	1	13	0	0
6	33553406	.	T	C	7	8	15	0	0	15	0	0
6	33554433	.	A	T	12	7	19	0	0	19	0	0
6	33554435	.	C	T	10	7	17	0	0	17	0	0
6	33555159	.	G	A	1	3	4	0	4	8	0	0
6	33555168	.	C	T	7	4	11	0	1	12	0	0
6	33555351	.	A	G	15	8	23	0	2	25	0	0
6	33555374	.	G	A	2	4	6	0	18	24	0	0
6	33555397	.	A	G	20	2	22	0	0	22	0	0
6	33555570	.	G	A	9	7	16	0	0	16	0	0
6	33555594	.	T	C	6	8	14	0	0	14	0	0
6	33555691	.	T	G	4	0	4	0	7	11	0	0
6	33555736	.	G	T	4	8	12	0	2	14	0	0
6	33555952	.	T	A	12	17	29	0	0	29	0	0
6	33556036	.	T	A	12	14	26	0	1	27	0	0
6	33556316	.	C	T	8	13	21	0	1	22	0	0
6	33556424	.	A	G	8	9	17	0	3	20	0	0
6	33556441	.	G	A	12	11	23	0	2	25	0	0
6	33556493	.	A	T	0	21	21	0	0	21	0	0
6	33556497	.	A	T	9	16	25	0	1	26	0	0
6	33556706	.	G	C	11	14	25	0	1	26	0	0
6	33556877	.	G	A	4	10	14	0	25	39	0	0
6	33556968	.	G	C	12	11	23	0	1	24	0	0
6	33557077	.	G	A	2	6	8	0	12	20	0	0
6	33557438	.	T	A	9	9	18	0	1	19	0	0
6	33557625	.	C	T	23	22	45	0	2	47	0	0
6	33558437	.	G	A	13	22	35	0	2	37	0	0
6	33558711	.	G	C	18	14	32	0	1	33	0	0
6	33558837	.	C	T	7	6	13	0	0	13	0	0
6	33663701	.	T	C	12	7	19	0	1	21	1	0
6	33663839	.	C	T	1	10	11	0	15	26	0	0
6	33664182	.	A	G	12	10	22	0	0	22	0	0
6	33664460	.	A	G	6	8	14	0	0	14	0	0
6	33664556	.	C	T	5	3	8	0	0	8	0	0
6	33664801	.	A	G	11	7	18	0	2	20	0	0
6	33664899	.	G	A	5	11	16	0	0	16	0	0
6	33664917	.	C	T	1	3	4	0	7	11	0	0
6	33665123	.	T	G	9	10	19	0	3	22	0	0
6	33665320	.	G	A	5	6	11	0	0	11	0	0
6	33665327	.	C	T	6	4	10	0	0	10	0	0
6	33665513	.	C	T	1	8	9	0	6	15	0	0
6	33665734	.	C	T	15	12	27	0	2	29	0	0
6	33665867	.	G	T	12	12	24	0	0	24	0	0
6	33665968	.	C	T	17	14	31	0	0	31	0	0
6	33666166	.	G	A	11	13	24	0	0	24	0	0
6	33666250	.	C	A	1	7	8	0	11	20	1	0
6	33666302	.	C	A	7	16	23	0	0	23	0	0
6	33666308	.	G	A	6	16	22	0	1	23	0	0
6	33666472	.	G	T	12	18	30	0	0	30	0	0
6	33666578	.	G	T	19	19	38	1	0	39	0	0
6	33666631	.	C	T	22	15	37	0	0	37	0	0
6	33666715	.	C	A	15	14	29	0	0	29	0	0
6	33666733	.	A	G	20	11	31	0	0	31	0	0
6	33666871	.	A	T	9	10	19	0	0	19	0	0
6	33666910	.	G	T	12	9	21	0	1	22	0	0
6	33667006	.	C	T	11	4	15	0	0	15	0	0
6	33667056	.	T	C	10	0	10	0	5	15	0	0
6	33667180	.	C	T	0	5	5	0	8	13	0	0
6	33667234	.	T	A	9	8	17	0	1	18	0	0
6	33667345	.	G	C	9	12	21	0	0	21	0	0
6	33667369	.	G	A	18	10	28	0	2	30	0	0
6	33667492	.	G	T	15	9	24	0	14	38	0	0
6	33668228	.	A	T	7	12	19	0	0	19	0	0
6	33668729	.	A	T	8	7	15	0	0	15	0	0
6	33669168	.	G	C	6	0	6	0	9	15	0	0
6	33669460	.	A	C	10	6	16	0	1	17	0	0
6	33672116	.	C	A	4	4	8	0	0	8	0	0
6	33673964	.	A	G	4	3	7	0	0	7	0	0
6	33674305	.	T	C	7	4	11	0	0	11	0	0
6	33675666	.	C	T	0	3	3	0	6	9	0	0
6	33683816	.	A	G	3	4	7	0	0	7	0	0
6	33683837	.	G	A	4	4	8	0	0	8	0	0
6	33683882	.	A	G	4	3	7	0	1	8	0	0
6	33683885	.	T	A	4	4	8	0	0	8	0	0
6	33694269	.	G	A	8	3	11	0	1	12	0	0
6	33813404	.	A	T	1	2	3	0	1	4	0	0
6	33870048	.	A	T	1	2	3	0	0	3	0	0
6	33875833	.	G	A	2	3	5	0	0	5	0	0
6	33875839	.	G	A	1	3	4	0	0	4	0	0
6	33875902	.	C	T	0	3	3	0	2	5	0	0
6	33883580	.	C	T	7	3	10	0	0	10	0	0
6	33896399	.	T	A	30	13	43	0	1	44	0	0
6	33896457	.	A	G	11	30	41	0	2	43	0	0
6	33896538	.	T	C	24	19	43	0	3	46	0	0
6	33896562	.	A	G	24	19	43	0	1	44	0	0
6	33896615	.	G	A	2	11	13	0	27	40	0	0
6	33896620	.	C	T	14	21	35	0	1	36	0	0
6	33897505	.	G	A	11	11	22	0	0	22	0	0
6	33900410	.	T	C	1	2	3	0	0	3	0	0
6	33902836	.	G	A	1	2	3	0	2	5	0	0
6	33902855	.	G	A	2	2	4	0	0	4	0	0
6	33912228	.	G	T	6	7	13	0	0	13	0	0
6	33912708	.	A	C	5	0	5	0	6	11	0	0
6	33913345	.	A	T	6	6	12	0	0	12	0	0
6	33916648	.	T	C	10	0	10	0	5	15	0	0
6	33921298	.	C	T	8	5	13	0	1	14	0	0
6	33921511	.	G	A	11	6	17	0	0	17	0	0
6	33921631	.	A	G	9	6	15	0	0	15	0	0
6	33923900	.	C	T	9	8	17	0	0	17	0	0
6	33924622	.	A	T	9	3	12	0	0	12	0	0
6	33924693	.	A	G	12	13	25	0	0	25	0	0
6	33926972	.	C	A	1	2	3	0	0	3	0	0
6	33927040	.	A	T	3	10	13	0	3	16	0	0
6	33927271	.	G	T	9	10	19	0	0	19	0	0
6	33931582	.	T	C	11	13	24	0	0	24	0	0
6	33982409	.	T	A	4	2	6	0	0	6	0	0
6	33982412	.	G	A	2	4	6	0	0	6	0	0
6	33982683	.	C	T	0	2	2	0	1	3	0	0
6	33982777	.	G	C	1	2	3	1	0	4	0	0
6	33982779	.	T	G	1	2	3	1	0	4	0	0
6	33983143	.	A	C	1	2	3	0	0	3	0	0
6	33983303	.	G	T	2	4	6	0	0	6	0	0
6	33983316	.	A	T	2	4	6	0	0	6	0	0
6	33983405	.	G	T	3	4	7	0	0	7	0	0
6	33984216	.	T	A	3	4	7	0	0	7	0	0
6	34064132	.	T	C	1	2	3	0	0	3	0	0
6	34072285	.	C	A	2	4	6	0	0	6	0	0
6	34512342	.	T	A	1	3	4	0	0	4	0	0
6	34512487	.	G	A	1	3	4	0	0	4	0	0
6	34710709	.	T	G	1	1	2	0	3	5	0	0
6	34767154	.	T	C	2	5	7	0	0	7	0	0
6	34767157	.	T	A	2	4	6	0	1	7	0	0
6	34767193	.	T	C	0	3	3	0	0	3	0	0
6	34767202	.	C	T	2	3	5	0	0	5	0	0
6	34769061	.	G	T	2	2	4	0	0	4	0	0
6	34805913	.	C	A	4	2	6	0	0	6	0	0
6	34806307	.	T	C	8	5	13	0	0	13	0	0
6	34806893	.	A	T	6	5	11	0	0	11	0	0
6	34807374	.	T	A	3	4	7	0	0	7	0	0
6	34807534	.	C	A	6	8	14	0	0	14	0	0
6	34807605	.	C	G	5	4	9	0	0	9	0	0
6	34807640	.	A	C	8	4	12	0	0	12	0	0
6	34807682	.	C	T	7	3	10	0	0	10	0	0
6	34807927	.	T	A	4	3	7	0	0	7	0	0
6	34807933	.	G	T	5	5	10	0	0	10	0	0
6	34807999	.	G	T	8	6	14	0	0	14	0	0
6	34808517	.	A	G	2	4	6	0	0	6	0	0
6	34808591	.	G	A	10	6	16	0	2	18	0	0
6	34808754	.	C	T	8	6	14	0	0	14	0	0
6	34808821	.	G	A	6	7	13	0	0	13	0	0
6	34809697	.	C	G	11	0	11	0	12	23	0	0
6	34810495	.	G	A	2	8	10	0	16	26	0	0
6	34810748	.	A	C	7	7	14	0	0	14	0	0
6	34810763	.	T	A	7	8	15	0	1	16	0	0
6	34810896	.	G	A	8	8	16	0	1	17	0	0
6	34810908	.	T	C	9	9	18	0	3	21	0	0
6	34811130	.	A	T	8	3	11	0	0	11	0	0
6	34811175	.	T	C	7	7	14	0	2	16	0	0
6	34825949	.	C	T	4	4	8	0	0	8	0	0
6	34825955	.	C	T	1	3	4	0	3	7	0	0
6	34826151	.	C	T	0	2	2	0	2	4	0	0
6	34826214	.	G	A	4	4	8	0	0	8	0	0
6	34826598	.	G	A	4	7	11	1	0	12	0	0
6	34826870	.	G	A	14	7	21	0	2	23	0	0
6	34826882	.	T	G	13	6	19	0	2	21	0	0
6	34828893	.	A	T	8	8	16	0	0	16	0	0
6	34831124	.	A	C	7	0	7	0	8	15	0	0
6	34848447	.	C	A	4	5	9	0	0	9	0	0
6	34931646	.	G	A	11	17	28	0	1	29	0	0
6	34931911	.	C	T	29	23	52	0	2	54	0	0
6	34931912	.	C	T	30	22	52	0	2	54	0	0
6	34933574	.	C	T	31	25	56	0	0	56	0	0
6	34934903	.	G	T	37	27	64	0	0	64	0	0
6	34943714	.	G	A	4	6	10	0	0	10	0	0
6	34943760	.	A	G	2	2	4	0	1	5	0	0
6	34943824	.	A	T	4	3	7	1	0	8	0	0
6	34943938	.	T	C	1	4	5	0	0	5	0	0
6	34944056	.	T	C	3	4	7	0	0	7	0	0
6	34944523	.	G	A	3	2	5	0	0	5	0	0
6	34947195	.	T	A	6	3	9	0	2	11	0	0
6	34947415	.	G	A	4	2	6	0	0	6	0	0
6	34951839	.	C	G	5	2	7	0	0	7	0	0
6	34960950	.	A	T	3	2	5	0	0	5	0	0
6	35036459	.	A	T	6	6	12	0	3	15	0	0
6	35036463	.	T	C	8	0	8	0	6	14	0	0
6	35036755	.	T	A	7	3	10	0	1	11	0	0
6	35039912	.	G	T	9	5	14	0	1	15	0	0
6	35039966	.	C	T	8	6	14	0	0	14	0	0
6	35042201	.	A	G	5	3	8	0	0	8	0	0
6	35046783	.	G	A	3	3	6	0	0	6	0	0
6	35046852	.	T	C	7	5	12	0	0	12	0	0
6	35046894	.	A	G	3	5	8	0	0	8	0	0
6	35051403	.	T	G	4	4	8	0	0	8	0	0
6	35052942	.	T	C	5	2	7	0	0	7	0	0
6	35053090	.	T	G	2	2	4	0	0	4	0	0
6	35053243	.	G	A	6	5	11	0	0	11	0	0
6	35053250	.	A	G	4	5	9	0	1	10	0	0
6	35054938	.	A	T	4	6	10	0	0	10	0	0
6	35054984	.	T	G	5	5	10	0	0	10	0	0
6	35055004	.	A	T	6	2	8	0	1	9	0	0
6	35056519	.	C	A	5	2	7	0	0	7	0	0
6	35056547	.	C	T	5	2	7	0	1	8	0	0
6	35056787	.	A	G	6	7	13	0	0	13	0	0
6	35058456	.	C	T	5	9	14	0	0	14	0	0
6	35058696	.	A	G	8	4	12	0	0	12	0	0
6	35058850	.	A	G	10	3	13	0	0	13	0	0
6	35061001	.	A	T	2	2	4	0	0	4	0	0
6	35061019	.	G	A	2	2	4	0	0	4	0	0
6	35061226	.	C	T	4	5	9	0	0	9	0	0
6	35061237	.	C	T	2	3	5	0	0	5	0	0
6	35061298	.	T	C	3	4	7	0	0	7	0	0
6	35100084	.	G	A	2	6	8	0	0	8	0	0
6	35100230	.	T	A	7	3	10	0	0	10	0	0
6	35100484	.	C	T	1	2	3	0	3	6	0	0
6	35100528	.	A	G	5	4	9	0	0	9	0	0
6	35100795	.	C	G	0	7	7	0	6	13	0	0
6	35100801	.	T	G	6	6	12	0	1	13	0	0
6	35100857	.	A	G	5	7	12	0	0	12	0	0
6	35100868	.	T	A	6	6	12	0	0	12	0	0
6	35100894	.	C	T	0	2	2	0	4	6	0	0
6	35100933	.	A	G	3	5	8	0	0	8	0	0
6	35100956	.	G	C	3	4	7	0	0	7	0	0
6	35101016	.	G	A	2	4	6	0	0	6	0	0
6	35101184	.	A	T	4	3	7	0	0	7	0	0
6	35101749	.	T	C	1	2	3	0	0	3	0	0
6	35102174	.	G	T	4	1	5	0	0	5	0	0
6	35102178	.	A	C	4	2	6	0	0	6	0	0
6	35102555	.	G	C	2	2	4	0	0	4	0	0
6	35106162	.	T	C	1	2	3	0	0	3	0	0
6	35136451	.	T	C	7	3	10	0	0	10	0	0
6	35136471	.	C	T	0	7	7	0	7	14	0	0
6	35136505	.	T	A	5	10	15	0	1	16	0	0
6	35136558	.	G	A	8	5	13	0	0	13	0	0
6	35136693	.	A	T	4	2	6	0	1	7	0	0
6	35136781	.	C	T	1	2	3	0	1	4	0	0
6	35136983	.	A	G	6	3	9	0	0	9	0	0
6	35137320	.	A	G	9	5	14	0	0	14	0	0
6	35137587	.	A	G	2	5	7	0	0	7	0	0
6	35139248	.	T	C	7	7	14	0	1	15	0	0
6	35194786	.	G	A	8	3	11	0	0	11	0	0
6	35309798	.	T	G	4	5	9	0	0	9	0	0
6	35309823	.	A	T	7	4	11	0	0	11	0	0
6	35309876	.	T	A	7	2	9	0	0	9	0	0
6	35309901	.	T	G	6	2	8	0	1	9	0	0
6	35363247	.	A	G	7	7	14	0	1	15	0	0
6	35364869	.	G	A	6	7	13	0	1	14	0	0
6	35365098	.	A	T	3	4	7	0	3	10	0	0
6	35365234	.	C	T	2	4	6	0	0	6	0	0
6	35365441	.	C	A	5	4	9	0	0	9	0	0
6	35365462	.	T	A	5	6	11	0	0	11	0	0
6	35365492	.	A	G	4	4	8	0	0	8	0	0
6	35365872	.	C	T	16	6	22	0	0	22	0	0
6	35365877	.	C	T	14	6	20	0	1	21	0	0
6	35366140	.	G	T	1	7	8	0	7	15	0	0
6	35366141	.	A	G	8	7	15	0	0	15	0	0
6	35366640	.	C	G	10	5	15	0	0	15	0	0
6	35389384	.	T	A	7	8	15	0	0	15	0	0
6	35389517	.	C	G	1	7	8	0	3	11	0	0
6	35461790	.	T	A	5	2	7	0	1	8	0	0
6	35461812	.	A	T	5	1	6	0	0	6	0	0
6	35461859	.	A	G	3	3	6	0	0	6	0	0
6	35462087	.	G	A	21	7	28	0	1	29	0	0
6	35462088	.	A	G	20	7	27	0	1	28	0	0
6	35462134	.	G	A	16	10	26	5	2	33	0	0
6	35462186	.	A	G	21	13	34	0	1	35	0	0
6	35462470	.	G	A	19	21	40	0	0	40	0	0
6	35472834	.	C	T	18	19	37	0	0	37	0	0
6	35472858	.	G	T	13	18	31	0	2	33	0	0
6	35487433	.	C	T	0	2	2	0	1	3	0	0
6	35676784	.	A	G	10	13	23	0	1	24	0	0
6	35676799	.	C	T	14	12	26	0	1	27	0	0
6	35688231	.	G	A	7	7	14	0	0	14	0	0
6	35693656	.	C	T	4	13	17	0	0	17	0	0
6	35713078	.	T	A	3	7	10	1	2	13	0	0
6	35718058	.	T	C	13	5	18	0	1	19	0	0
6	35737276	.	G	T	2	6	8	0	1	9	0	0
6	35737289	.	A	G	4	7	11	0	0	11	0	0
6	35737387	.	C	G	6	3	9	0	0	9	0	0
6	36128976	.	C	T	2	3	5	0	0	5	0	0
6	36129066	.	A	G	1	3	4	0	0	4	0	0
6	36129115	.	C	G	2	2	4	0	1	5	0	0
6	36129135	.	T	A	1	4	5	0	0	5	0	0
6	36129779	.	C	T	2	4	6	0	1	7	0	0
6	36129800	.	G	A	3	2	5	0	1	6	0	0
6	36129946	.	T	G	11	3	14	0	1	15	0	0
6	36130245	.	G	A	3	5	8	0	0	8	0	0
6	36130727	.	T	G	1	2	3	0	0	3	0	0
6	36131055	.	A	G	4	4	8	0	1	9	0	0
6	36131097	.	A	T	4	3	7	0	1	8	0	0
6	36131376	.	A	G	6	10	16	0	0	16	0	0
6	36131670	.	A	G	8	2	10	0	0	10	0	0
6	36131876	.	G	A	4	4	8	0	0	8	0	0
6	36132072	.	C	T	0	7	7	0	2	9	0	0
6	36141601	.	G	A	8	6	14	0	0	14	0	0
6	36141631	.	G	A	7	5	12	0	0	12	0	0
6	36141739	.	T	G	2	5	7	0	1	8	0	0
6	36141741	.	A	G	3	5	8	0	0	8	0	0
6	36178531	.	A	G	1	8	9	0	0	9	0	0
6	36197470	.	A	T	4	2	6	0	0	6	0	0
6	36462395	.	G	C	0	2	2	0	1	3	0	0
6	36462422	.	G	C	1	2	3	0	0	3	0	0
6	36758758	.	A	G	19	21	40	0	1	41	0	0
6	36760065	.	A	C	16	1	17	0	12	29	0	0
6	36760080	.	T	A	12	12	24	0	1	25	0	0
6	36760140	.	C	T	15	14	29	0	0	29	0	0
6	36762535	.	A	G	8	21	29	0	2	31	0	0
6	36770666	.	C	T	11	9	20	0	0	20	0	0
6	36783178	.	T	C	10	8	18	0	0	18	0	0
6	36783187	.	T	A	10	8	18	0	1	19	0	0
6	36789072	.	A	G	10	15	25	0	1	26	0	0
6	36792028	.	A	C	8	6	14	0	0	14	0	0
6	36792112	.	A	G	6	10	16	0	1	17	0	0
6	36792130	.	A	T	7	10	17	0	2	19	0	0
6	36792163	.	C	G	8	10	18	0	2	20	0	0
6	36792294	.	A	G	12	21	33	0	1	34	0	0
6	36813910	.	G	A	3	5	8	0	0	8	0	0
6	36818779	.	T	A	3	4	7	0	0	7	0	0
6	36818784	.	C	T	4	2	6	0	1	7	0	0
6	36818840	.	C	T	7	2	9	0	0	9	0	0
6	36854168	.	C	T	1	2	3	0	0	3	0	0
6	36854171	.	A	G	1	2	3	0	0	3	0	0
6	36865756	.	C	T	4	2	6	0	0	6	0	0
6	36876939	.	A	G	5	3	8	0	0	8	0	0
6	36877037	.	G	C	5	4	9	0	0	9	0	0
6	36877053	.	A	G	3	2	5	0	1	6	0	0
6	36877078	.	G	A	4	2	6	0	1	7	0	0
6	36877264	.	A	G	6	2	8	0	0	8	0	0
6	36877293	.	A	C	6	7	13	0	0	13	0	0
6	36897355	.	A	T	1	6	7	0	0	7	0	0
6	37071353	.	G	A	17	14	31	0	0	31	0	0
6	37071374	.	A	G	18	18	36	0	1	37	0	0
6	37163366	.	A	T	15	14	29	0	1	30	0	0
6	37163449	.	G	A	4	10	14	0	35	49	0	0
6	37163488	.	G	A	30	19	49	0	0	50	1	0
6	37163588	.	G	T	5	22	27	0	20	47	0	0
6	37163932	.	T	C	19	20	39	0	2	41	0	0
6	37163943	.	C	T	13	20	33	0	0	33	0	0
6	37164060	.	T	C	20	20	40	0	4	44	0	0
6	37164173	.	T	G	18	18	36	0	0	36	0	0
6	37301438	.	G	T	10	23	33	0	0	33	0	0
6	37301458	.	A	G	10	25	35	0	0	35	0	0
6	37301479	.	A	T	13	24	37	0	0	37	0	0
6	37305142	.	A	C	15	17	32	0	1	33	0	0
6	37305368	.	A	G	5	0	5	0	7	12	0	0
6	37305383	.	A	G	8	7	15	0	0	15	0	0
6	37305470	.	G	A	7	5	12	0	0	12	0	0
6	37305532	.	G	T	9	6	15	0	1	16	0	0
6	37305539	.	G	T	11	6	17	0	0	17	0	0
6	37306620	.	A	T	13	14	27	0	1	28	0	0
6	37306827	.	C	T	13	10	23	0	0	23	0	0
6	37307034	.	C	T	3	9	12	4	3	19	0	0
6	37409738	.	C	T	12	15	27	0	1	28	0	0
6	37409986	.	C	T	5	4	9	0	0	9	0	0
6	37410029	.	A	G	8	6	14	0	1	15	0	0
6	37410047	.	C	T	12	7	19	0	1	20	0	0
6	37410119	.	C	T	11	6	17	0	1	18	0	0
6	37417345	.	T	A	8	8	16	0	0	16	0	0
6	37419449	.	G	A	14	4	18	0	0	18	0	0
6	37419479	.	G	A	9	4	13	0	0	13	0	0
6	37419491	.	A	T	4	4	8	0	1	9	0	0
6	37420172	.	A	C	8	4	12	0	0	12	0	0
6	37421038	.	C	A	1	3	4	0	5	9	0	0
6	37422787	.	A	G	5	9	14	0	0	14	0	0
6	37431386	.	A	T	1	2	3	0	0	3	0	0
6	37431476	.	T	G	4	5	9	0	0	9	0	0
6	37431532	.	G	C	2	5	7	0	0	7	0	0
6	37431649	.	T	C	6	9	15	0	0	15	0	0
6	37438497	.	T	A	2	3	5	0	1	6	0	0
6	37440068	.	G	A	5	4	9	0	0	9	0	0
6	37440515	.	G	T	2	4	6	0	0	6	0	0
6	37440547	.	T	A	2	6	8	0	0	8	0	0
6	37441474	.	T	C	4	7	11	0	1	12	0	0
6	37441492	.	G	A	2	6	8	0	0	8	0	0
6	37442218	.	A	C	2	2	4	0	1	5	0	0
6	37442314	.	A	T	1	3	4	0	0	4	0	0
6	37442821	.	G	A	2	4	6	0	0	6	0	0
6	37443945	.	T	C	2	5	7	0	0	7	0	0
6	37444475	.	C	T	1	3	4	0	1	5	0	0
6	37445258	.	T	A	3	2	5	0	1	6	0	0
6	37445357	.	T	C	4	6	10	0	0	10	0	0
6	37461072	.	C	T	2	2	4	0	0	4	0	0
6	37469571	.	C	A	0	3	3	0	1	4	0	0
6	37469637	.	C	A	3	2	5	0	0	5	0	0
6	37478859	.	G	A	4	5	9	0	0	9	0	0
6	37479506	.	G	A	7	6	13	0	0	13	0	0
6	37479779	.	A	C	9	7	16	0	0	16	0	0
6	37479785	.	A	C	8	8	16	0	0	16	0	0
6	37479910	.	T	G	8	8	16	0	0	16	0	0
6	37479932	.	G	A	7	9	16	0	0	16	0	0
6	37479998	.	A	G	6	3	9	0	1	10	0	0
6	37480028	.	A	G	7	3	10	0	1	11	0	0
6	37480100	.	T	A	8	5	13	0	0	13	0	0
6	37489092	.	C	G	3	5	8	0	0	8	0	0
6	37495117	.	G	A	5	5	10	0	0	10	0	0
6	37495147	.	G	A	4	5	9	0	0	9	0	0
6	37498477	.	A	G	2	5	7	0	3	10	0	0
6	37499562	.	A	C	3	4	7	0	2	9	0	0
6	37514749	.	T	C	2	3	5	0	0	5	0	0
6	37515100	.	A	T	2	6	8	0	0	8	0	0
6	37515270	.	A	G	5	2	7	0	0	7	0	0
6	37515300	.	C	T	10	6	16	0	0	16	0	0
6	37515353	.	T	A	6	4	10	0	0	10	0	0
6	37521529	.	A	T	8	8	16	0	0	16	0	0
6	37521594	.	C	A	9	4	13	0	1	14	0	0
6	37525748	.	G	A	11	6	17	0	0	17	0	0
6	37529504	.	C	A	20	16	36	0	2	38	0	0
6	37548605	.	T	C	9	11	20	0	0	20	0	0
6	37548897	.	C	T	19	9	28	0	0	28	0	0
6	37551165	.	G	A	0	19	19	0	6	25	0	0
6	37551548	.	T	C	18	16	34	0	1	35	0	0
6	37552621	.	C	T	19	12	31	0	1	32	0	0
6	37554293	.	C	T	16	12	28	0	1	29	0	0
6	37598966	.	C	T	10	26	36	0	0	36	0	0
6	37599293	.	C	T	10	10	20	0	1	21	0	0
6	37599406	.	G	A	14	14	28	0	0	28	0	0
6	37599499	.	G	T	13	14	27	0	0	27	0	0
6	37599687	.	A	T	18	15	33	3	0	37	1	0
6	37599937	.	T	G	18	10	28	0	1	29	0	0
6	37599954	.	C	T	20	5	25	0	1	26	0	0
6	37600173	.	A	G	18	1	19	0	18	37	0	0
6	37600210	.	G	A	2	18	20	0	21	41	0	0
6	37600233	.	G	A	23	18	41	0	1	42	0	0
6	37604311	.	C	A	2	2	4	0	1	5	0	0
6	37604410	.	T	A	7	3	10	0	1	11	0	0
6	37604547	.	A	G	5	8	13	0	0	13	0	0
6	37604724	.	G	A	7	5	12	0	1	13	0	0
6	37604866	.	A	C	10	8	18	0	0	18	0	0
6	37621150	.	T	C	2	5	7	0	0	7	0	0
6	37621204	.	A	G	3	4	7	0	0	7	0	0
6	37621213	.	A	G	3	3	6	0	0	6	0	0
6	37621918	.	A	G	7	9	16	0	0	16	0	0
6	37622089	.	C	T	1	5	6	0	7	13	0	0
6	37623826	.	A	G	3	2	5	0	0	5	0	0
6	37623836	.	A	T	3	2	5	0	1	6	0	0
6	37626084	.	T	A	3	6	9	0	0	9	0	0
6	37627004	.	A	G	5	6	11	0	0	11	0	0
6	37627114	.	G	A	6	5	11	0	0	11	0	0
6	37627141	.	C	A	6	3	9	0	0	9	0	0
6	37628973	.	G	A	7	8	15	0	1	16	0	0
6	37628991	.	C	T	4	8	12	0	1	13	0	0
6	37629402	.	A	G	9	0	9	0	5	14	0	0
6	37631456	.	A	G	5	6	11	0	0	11	0	0
6	37632921	.	G	A	7	7	14	0	0	14	0	0
6	37632963	.	A	G	4	0	4	0	10	14	0	0
6	37632966	.	C	T	4	11	15	0	0	15	0	0
6	37633005	.	C	A	5	7	12	0	0	12	0	0
6	37633549	.	G	A	0	8	8	0	6	14	0	0
6	37635589	.	G	A	2	6	8	0	1	9	0	0
6	37635595	.	C	A	2	8	10	0	0	10	0	0
6	37635649	.	T	C	7	8	15	0	0	15	0	0
6	37637987	.	G	A	3	9	12	0	1	13	0	0
6	37651619	.	T	C	11	7	18	0	0	18	0	0
6	37703947	.	C	T	1	2	3	0	0	3	0	0
6	37716969	.	C	T	3	3	6	0	0	6	0	0
6	37728484	.	T	C	1	5	6	0	1	7	0	0
6	37728496	.	T	C	1	5	6	0	0	6	0	0
6	37730423	.	G	T	10	2	12	0	1	13	0	0
6	37730520	.	C	T	9	6	15	0	2	17	0	0
6	37730527	.	C	T	7	9	16	0	1	17	0	0
6	37733992	.	G	A	10	4	14	0	0	14	0	0
6	37737188	.	C	A	7	3	10	0	0	10	0	0
6	37743373	.	C	G	2	3	5	0	1	6	0	0
6	37743456	.	T	C	3	0	3	0	4	7	0	0
6	37744304	.	C	A	8	4	12	0	0	12	0	0
6	37745914	.	A	T	0	4	4	0	1	5	0	0
6	37746085	.	C	T	3	3	6	0	0	6	0	0
6	37746099	.	G	A	4	3	7	0	0	7	0	0
6	37752838	.	A	G	2	3	5	0	0	5	0	0
6	37771609	.	T	C	3	3	6	0	0	6	0	0
6	37772400	.	C	T	4	3	7	0	0	7	0	0
6	37772406	.	A	G	3	2	5	0	1	6	0	0
6	37775562	.	G	A	0	2	2	0	3	5	0	0
6	37784031	.	A	G	3	0	3	0	4	7	0	0
6	37801954	.	A	G	4	0	4	0	7	11	0	0
6	37808238	.	G	A	1	4	5	0	7	12	0	0
6	37808262	.	G	C	0	4	4	0	6	10	0	0
6	37808349	.	G	A	5	3	8	0	0	8	0	0
6	37809918	.	C	T	5	6	11	0	0	11	0	0
6	37810256	.	C	T	4	7	11	0	0	11	0	0
6	37812199	.	A	G	4	3	7	0	0	7	0	0
6	37812271	.	G	A	0	4	4	0	2	6	0	0
6	37815348	.	C	G	6	3	9	0	0	9	0	0
6	37815525	.	T	C	10	3	13	0	0	13	0	0
6	37815621	.	T	G	7	4	11	0	0	11	0	0
6	37815799	.	C	T	4	5	9	0	0	9	0	0
6	37818324	.	A	C	7	7	14	0	1	15	0	0
6	37818327	.	G	A	6	7	13	0	1	14	0	0
6	37820306	.	C	T	8	8	16	0	0	16	0	0
6	37820960	.	T	C	5	7	12	0	0	12	0	0
6	37821169	.	G	T	0	7	7	0	4	11	0	0
6	37824355	.	G	T	6	5	11	0	2	13	0	0
6	37824645	.	T	C	9	8	17	0	1	18	0	0
6	37825508	.	T	G	6	1	7	0	7	14	0	0
6	37829585	.	G	A	5	6	11	0	0	11	0	0
6	37829613	.	T	C	4	7	11	0	1	12	0	0
6	37830742	.	A	T	11	11	22	0	1	23	0	0
6	37830784	.	C	T	10	13	23	0	1	24	0	0
6	37830811	.	C	T	14	13	27	0	2	29	0	0
6	37832947	.	C	T	16	17	33	0	2	35	0	0
6	37832953	.	G	A	17	16	33	0	1	34	0	0
6	37833493	.	T	C	12	10	22	0	1	23	0	0
6	37835767	.	T	C	21	16	37	0	0	37	0	0
6	37835797	.	C	T	20	16	36	0	1	37	0	0
6	37836387	.	G	A	11	16	27	0	1	28	0	0
6	37841100	.	C	T	12	11	23	0	1	24	0	0
6	37846026	.	C	T	29	18	47	0	1	48	0	0
6	38357666	.	T	A	3	2	5	0	0	5	0	0
6	38367062	.	G	C	16	0	16	0	16	32	0	0
6	38367107	.	T	C	11	17	28	0	0	28	0	0
6	38375020	.	G	A	8	17	25	0	2	27	0	0
6	38381094	.	G	A	7	8	15	0	0	15	0	0
6	38415315	.	G	A	12	6	18	0	2	20	0	0
6	38415385	.	A	G	15	13	28	0	0	28	0	0
6	38427427	.	G	A	3	5	8	0	0	8	0	0
6	38477019	.	G	T	10	11	21	0	1	22	0	0
6	38503673	.	C	T	13	14	27	0	0	27	0	0
6	38511604	.	G	A	13	16	29	0	1	30	0	0
6	38511739	.	C	T	10	14	24	0	0	24	0	0
6	38511921	.	T	C	16	9	25	0	2	27	0	0
6	38511967	.	A	T	10	12	22	0	1	23	0	0
6	38512160	.	T	C	13	14	27	0	0	27	0	0
6	38512178	.	G	A	18	13	31	0	0	31	0	0
6	38512236	.	C	T	11	14	25	0	2	27	0	0
6	38512629	.	C	T	12	22	34	0	1	35	0	0
6	38513231	.	C	T	16	10	26	1	0	27	0	0
6	38778327	.	T	C	1	3	4	0	1	5	0	0
6	38782025	.	C	T	7	13	20	0	0	20	0	0
6	38782439	.	C	A	5	6	11	0	0	11	0	0
6	38782442	.	C	T	4	6	10	0	1	11	0	0
6	38782511	.	A	G	8	8	16	0	2	18	0	0
6	38782712	.	T	C	7	7	14	0	0	14	0	0
6	38782794	.	C	T	8	7	15	0	0	15	0	0
6	38782799	.	T	A	8	7	15	0	0	15	0	0
6	38783002	.	T	A	2	5	7	0	0	7	0	0
6	38786301	.	G	A	1	5	6	0	9	15	0	0
6	38786622	.	C	A	6	10	16	0	1	17	0	0
6	38789065	.	C	A	11	12	23	0	0	23	0	0
6	38789292	.	C	T	10	10	20	0	3	23	0	0
6	38789317	.	C	T	11	14	25	0	2	27	0	0
6	38789507	.	A	T	8	11	19	0	1	20	0	0
6	38789583	.	G	C	15	11	26	0	1	27	0	0
6	38789733	.	A	G	16	10	26	0	5	31	0	0
6	38789832	.	A	G	10	14	24	0	1	25	0	0
6	38789853	.	T	A	15	15	30	0	0	30	0	0
6	38845797	.	G	A	5	8	13	0	0	13	0	0
6	38845817	.	T	C	3	5	8	0	0	8	0	0
6	38845865	.	G	A	5	11	16	0	0	16	0	0
6	38845943	.	C	G	6	10	16	0	0	16	0	0
6	38845964	.	A	G	3	6	9	0	1	10	0	0
6	38845986	.	A	G	5	1	6	0	5	11	0	0
6	38846240	.	A	G	3	4	7	0	1	8	0	0
6	38858036	.	G	T	1	10	11	0	4	15	0	0
6	38858558	.	T	A	6	3	9	0	0	9	0	0
6	38858784	.	T	G	15	8	23	0	0	24	1	0
6	38858832	.	T	G	11	5	16	0	0	16	0	0
6	38858902	.	T	A	4	4	8	0	0	8	0	0
6	38859796	.	T	A	6	4	10	0	0	10	0	0
6	38859938	.	A	G	17	5	22	1	1	24	0	0
6	38860293	.	C	G	7	5	12	0	2	14	0	0
6	38860362	.	T	A	6	3	9	0	1	10	0	0
6	38860421	.	C	T	3	3	6	0	0	6	0	0
6	38860815	.	A	G	4	13	17	0	0	17	0	0
6	38860823	.	C	T	4	14	18	0	0	18	0	0
6	38860898	.	T	C	7	16	23	0	4	27	0	0
6	38860905	.	C	T	6	19	25	0	0	25	0	0
6	38860981	.	T	C	7	10	17	0	0	17	0	0
6	38860985	.	T	G	7	11	18	0	0	18	0	0
6	38861020	.	G	A	5	12	17	0	2	19	0	0
6	38861035	.	C	A	8	9	17	0	1	18	0	0
6	38890691	.	C	T	1	3	4	0	0	4	0	0
6	38896523	.	T	C	10	6	16	0	0	16	0	0
6	38901991	.	T	C	11	10	21	0	0	21	0	0
6	38902291	.	T	A	5	7	12	0	1	13	0	0
6	39023682	.	A	G	1	2	3	0	0	3	0	0
6	39068424	.	A	G	19	10	29	0	3	32	0	0
6	39075254	.	A	C	14	15	29	0	0	30	1	0
6	39075513	.	G	A	11	14	25	0	0	25	0	0
6	39077308	.	G	C	16	11	27	0	2	29	0	0
6	39077364	.	C	T	8	10	18	0	0	18	0	0
6	39123712	.	A	T	1	3	4	0	0	4	0	0
6	39123923	.	C	A	7	7	14	0	1	15	0	0
6	39124288	.	C	A	3	6	9	0	0	9	0	0
6	39124304	.	A	C	3	8	11	0	0	11	0	0
6	39124389	.	G	A	4	3	7	0	2	9	0	0
6	39124688	.	C	T	1	4	5	0	7	12	0	0
6	39125228	.	G	A	4	8	12	0	0	12	0	0
6	39125296	.	C	T	3	3	6	0	1	7	0	0
6	39125390	.	T	A	1	4	5	0	0	5	0	0
6	39125392	.	C	A	1	4	5	0	0	5	0	0
6	39125609	.	A	C	3	7	10	0	0	10	0	0
6	39125626	.	G	A	3	4	7	0	1	8	0	0
6	39125653	.	G	A	3	3	6	0	0	6	0	0
6	39125746	.	A	C	4	2	6	0	0	6	0	0
6	39125783	.	T	C	0	4	4	0	1	5	0	0
6	39125784	.	T	C	2	0	2	0	3	5	0	0
6	39126503	.	G	A	3	2	5	0	0	5	0	0
6	39126528	.	G	C	2	2	4	0	1	5	0	0
6	39126884	.	C	T	6	7	13	0	0	13	0	0
6	39127005	.	A	T	8	9	17	0	0	17	0	0
6	39127012	.	A	T	6	8	14	0	0	15	1	0
6	39127340	.	G	A	1	5	6	0	1	7	0	0
6	39136487	.	A	G	1	2	3	0	0	3	0	0
6	39141303	.	C	T	5	2	7	0	0	7	0	0
6	39160327	.	C	T	6	3	9	0	0	9	0	0
6	39160328	.	A	G	6	3	9	0	0	9	0	0
6	39162382	.	A	T	1	3	4	0	0	4	0	0
6	39162488	.	C	A	4	8	12	0	0	12	0	0
6	39162491	.	C	G	4	7	11	0	0	11	0	0
6	39162607	.	C	T	12	13	25	0	1	26	0	0
6	39162718	.	A	T	9	12	21	0	0	21	0	0
6	39162756	.	T	A	9	8	17	0	1	18	0	0
6	39162855	.	C	T	6	10	16	0	0	16	0	0
6	39162896	.	G	A	13	8	21	0	2	23	0	0
6	39163058	.	T	A	6	5	11	2	0	13	0	0
6	39163286	.	G	A	5	8	13	0	1	14	0	0
6	39163363	.	A	T	7	8	15	1	0	16	0	0
6	39163657	.	T	G	8	7	15	0	0	15	0	0
6	39163876	.	A	G	8	6	14	0	0	14	0	0
6	39164046	.	T	G	6	5	11	0	0	11	0	0
6	39882119	.	C	T	1	3	4	0	0	4	0	0
6	40761936	.	T	C	4	2	6	0	0	6	0	0
6	40761940	.	T	C	3	3	6	0	0	6	0	0
6	41435866	.	A	G	26	21	47	0	1	48	0	0
6	41453070	.	C	T	1	4	5	0	0	5	0	0
6	41460563	.	A	T	2	9	11	0	0	11	0	0
6	42345083	.	C	A	5	3	8	0	0	8	0	0
6	42620190	.	G	C	1	2	3	1	0	4	0	0
6	44009350	.	G	C	5	0	5	0	11	18	2	0
6	44586711	.	C	T	6	2	8	0	0	8	0	0
6	44922563	.	A	C	4	2	6	0	0	6	0	0
6	44924866	.	A	C	3	4	7	0	0	7	0	0
6	44931081	.	T	G	7	3	10	0	0	10	0	0
6	44939209	.	A	G	3	7	10	0	0	10	0	0
6	44942314	.	G	A	0	4	4	0	1	5	0	0
6	44945233	.	A	G	5	4	9	0	1	10	0	0
6	44945279	.	C	A	10	3	13	0	0	13	0	0
6	44945301	.	C	T	12	5	17	0	0	17	0	0
6	44945320	.	T	C	12	5	17	0	0	17	0	0
6	44945585	.	C	T	6	10	16	0	1	17	0	0
6	44950364	.	C	T	7	6	13	0	0	13	0	0
6	44950644	.	C	T	8	6	14	0	1	15	0	0
6	44950701	.	T	G	7	6	13	0	0	13	0	0
6	44961519	.	A	G	12	8	20	0	1	21	0	0
6	44970154	.	A	G	4	0	4	0	6	10	0	0
6	44977406	.	G	A	21	14	35	0	1	36	0	0
6	46343180	.	T	C	4	3	7	0	0	7	0	0
6	46357708	.	C	A	0	15	15	0	5	20	0	0
6	46414595	.	G	A	8	4	12	0	0	12	0	0
6	46416267	.	C	T	5	3	8	0	0	8	0	0
6	46419928	.	A	T	5	2	7	0	0	7	0	0
6	46422955	.	G	A	9	8	17	1	0	18	0	0
6	46423470	.	C	A	8	4	12	0	0	12	0	0
6	46423593	.	G	T	6	8	14	0	1	15	0	0
6	46425620	.	A	G	6	7	13	0	0	13	0	0
6	46428718	.	A	C	10	6	16	0	1	17	0	0
6	46431950	.	A	G	33	22	55	0	4	59	0	0
6	46432016	.	G	A	27	31	58	0	2	60	0	0
6	46450487	.	C	G	34	21	55	0	5	60	0	0
6	46450547	.	T	C	26	23	49	0	0	49	0	0
6	46450804	.	C	T	34	23	57	0	4	61	0	0
6	46452997	.	C	T	26	29	55	0	1	56	0	0
6	46454103	.	C	A	24	11	35	0	0	35	0	0
6	46454148	.	G	A	31	9	40	0	2	42	0	0
6	46454173	.	T	G	31	16	47	0	0	47	0	0
6	46454396	.	T	A	24	30	54	0	0	54	0	0
6	46507612	.	A	G	3	3	6	0	0	6	0	0
6	46507773	.	C	T	3	2	5	0	1	6	0	0
6	46508072	.	G	T	4	5	9	0	0	9	0	0
6	46509415	.	A	G	1	2	3	0	1	4	0	0
6	46559848	.	C	T	2	7	9	0	0	9	0	0
6	46559932	.	G	A	3	3	6	1	0	7	0	0
6	46697930	.	T	C	12	5	17	0	0	17	0	0
6	46701953	.	C	T	6	5	11	0	1	12	0	0
6	46715399	.	A	G	5	6	11	0	1	12	0	0
6	46715454	.	T	A	5	6	11	0	0	11	0	0
6	46716897	.	T	C	11	10	21	0	0	21	0	0
6	46716915	.	C	T	12	11	23	0	0	23	0	0
6	46716954	.	T	C	12	4	16	0	0	16	0	0
6	46717535	.	T	C	10	10	20	0	1	21	0	0
6	46717731	.	A	G	8	0	8	0	3	11	0	0
6	46717772	.	T	C	9	5	14	0	0	14	0	0
6	46718103	.	T	G	15	7	22	1	1	24	0	0
6	46718193	.	G	T	10	14	24	0	0	24	0	0
6	46718237	.	G	A	9	10	19	1	0	20	0	0
6	46718243	.	G	A	8	11	19	1	0	20	0	0
6	46721369	.	C	T	13	8	21	0	2	23	0	0
6	46722670	.	G	A	11	9	20	0	1	21	0	0
6	46722671	.	G	T	11	10	21	0	0	21	0	0
6	46722783	.	G	T	0	6	6	0	10	17	1	0
6	46722786	.	C	G	10	7	17	0	1	18	0	0
6	46722883	.	T	G	9	6	15	0	1	16	0	0
6	46725949	.	T	C	3	2	5	0	0	5	0	0
6	46725966	.	T	A	4	3	7	0	1	8	0	0
6	46726234	.	T	G	6	5	11	0	0	11	0	0
6	46726901	.	C	T	7	7	14	0	0	14	0	0
6	47006599	.	G	A	16	13	29	0	0	29	0	0
6	47006611	.	A	G	16	14	30	0	0	30	0	0
6	47032679	.	C	T	11	9	20	0	0	20	0	0
6	47032772	.	A	G	7	6	13	0	1	14	0	0
6	47054448	.	A	G	12	4	16	0	0	16	0	0
6	47246513	.	C	T	12	6	18	0	5	23	0	0
6	47460099	.	A	T	1	4	5	0	0	5	0	0
6	47530011	.	A	G	4	4	8	0	0	8	0	0
6	47530049	.	A	G	3	2	5	0	1	6	0	0
6	47530112	.	C	G	4	7	11	0	0	11	0	0
6	47530428	.	T	C	5	7	12	0	0	12	0	0
6	47530562	.	G	T	7	8	15	0	1	16	0	0
6	47530563	.	T	A	6	9	15	0	0	16	1	0
6	47530828	.	C	T	1	9	10	0	4	14	0	0
6	47531110	.	C	A	9	4	13	0	1	14	0	0
6	47531176	.	G	C	7	0	7	0	7	14	0	0
6	47536856	.	G	A	4	3	7	0	0	7	0	0
6	47538035	.	C	A	7	2	9	0	0	9	0	0
6	47540060	.	C	T	0	5	5	0	2	7	0	0
6	47540093	.	C	T	5	3	8	0	0	8	0	0
6	47540279	.	C	T	4	4	8	0	0	8	0	0
6	47540405	.	A	T	1	2	3	0	0	3	0	0
6	47558374	.	C	T	1	5	6	0	5	11	0	0
6	47571152	.	C	T	2	5	7	0	0	7	0	0
6	47574248	.	C	T	0	8	8	0	3	11	0	0
6	47796167	.	A	G	1	2	3	0	0	3	0	0
6	47809905	.	T	G	3	4	7	0	0	7	0	0
6	47810323	.	A	G	6	8	14	0	0	14	0	0
6	47810671	.	T	A	11	13	24	0	0	24	0	0
6	47810688	.	T	C	10	0	10	0	11	21	0	0
6	47810804	.	A	T	6	10	16	0	0	16	0	0
6	47810810	.	T	A	11	4	15	0	0	15	0	0
6	47810941	.	C	T	0	7	7	0	4	11	0	0
6	47811024	.	G	A	7	8	15	0	0	15	0	0
6	47811463	.	G	A	8	2	10	0	0	10	0	0
6	47811473	.	G	A	6	3	9	0	0	9	0	0
6	47811687	.	T	C	2	0	2	0	6	8	0	0
6	47811829	.	G	C	5	6	11	0	0	11	0	0
6	47811875	.	A	C	4	5	9	0	0	9	0	0
6	47811890	.	G	A	4	4	8	0	1	9	0	0
6	47811940	.	G	A	4	4	8	0	0	8	0	0
6	47812193	.	C	A	1	2	3	0	0	3	0	0
6	47812280	.	G	C	8	0	8	0	7	15	0	0
6	47812843	.	C	T	0	5	5	0	5	10	0	0
6	47812880	.	C	G	5	3	8	0	0	8	0	0
6	47813100	.	T	G	6	9	15	0	0	15	0	0
6	47813366	.	G	A	2	7	9	0	0	9	0	0
6	47813407	.	T	A	4	3	7	0	0	7	0	0
6	47813499	.	G	A	6	3	9	0	0	9	0	0
6	47813548	.	T	C	4	6	10	0	0	10	0	0
6	47813877	.	G	A	6	9	15	0	0	15	0	0
6	47816406	.	G	C	4	6	10	0	0	10	0	0
6	47816512	.	G	A	4	2	6	0	0	6	0	0
6	47816711	.	A	G	3	4	7	0	0	7	0	0
6	47816730	.	T	C	3	0	3	0	3	6	0	0
6	47820011	.	C	A	2	2	4	0	6	10	0	0
6	47820092	.	G	A	5	2	7	0	0	7	0	0
6	47825288	.	G	A	5	4	9	0	1	10	0	0
6	47825364	.	T	A	2	4	6	0	1	7	0	0
6	47825404	.	C	A	2	6	8	0	0	9	1	0
6	47825488	.	G	A	3	7	10	0	0	10	0	0
6	47825537	.	G	A	4	5	9	0	0	9	0	0
6	47833110	.	T	A	1	2	3	0	0	3	0	0
6	47835187	.	G	A	1	2	3	0	1	4	0	0
6	47838392	.	T	C	4	0	4	0	3	7	0	0
6	47838635	.	C	T	2	3	5	0	0	5	0	0
6	47846543	.	A	G	3	3	6	0	0	6	0	0
6	47865287	.	C	A	6	6	12	0	0	12	0	0
6	47865322	.	C	T	6	9	15	0	0	15	0	0
6	47865391	.	C	T	7	11	18	0	0	18	0	0
6	47865588	.	T	C	3	9	12	0	1	13	0	0
6	47865626	.	G	T	3	6	9	0	3	12	0	0
6	47865661	.	A	T	3	7	10	0	1	11	0	0
6	47865770	.	A	C	5	4	9	0	0	9	0	0
6	47865780	.	C	G	3	4	7	0	0	7	0	0
6	47869454	.	C	T	5	3	8	0	3	11	0	0
6	47869500	.	C	T	4	4	8	0	0	8	0	0
6	47869510	.	C	G	4	4	8	0	1	9	0	0
6	47869555	.	T	C	3	1	4	0	1	5	0	0
6	47869802	.	C	A	2	3	5	0	1	6	0	0
6	47869982	.	G	A	6	4	10	0	0	10	0	0
6	47870185	.	T	C	11	0	11	0	4	15	0	0
6	47870463	.	G	A	5	8	13	0	1	14	0	0
6	47872510	.	G	A	5	11	16	0	0	16	0	0
6	47879230	.	C	T	3	6	9	0	1	10	0	0
6	47894170	.	A	G	3	4	7	0	0	7	0	0
6	47896501	.	A	G	7	2	9	0	0	9	0	0
6	47896507	.	A	G	6	1	7	0	1	8	0	0
6	47899387	.	A	T	4	2	6	0	0	6	0	0
6	48045699	.	C	A	3	2	5	0	0	5	0	0
6	48047026	.	G	A	1	6	7	0	2	9	0	0
6	48051766	.	G	A	5	4	9	0	0	9	0	0
6	48051920	.	T	C	6	5	11	0	0	11	0	0
6	48052127	.	G	A	3	5	8	0	0	8	0	0
6	48052310	.	C	T	2	12	14	0	0	14	0	0
6	48054766	.	C	T	8	10	18	0	1	19	0	0
6	48057928	.	C	T	11	13	24	0	0	24	0	0
6	48058088	.	T	A	5	2	7	0	0	8	1	0
6	48058160	.	T	G	4	5	9	0	0	9	0	0
6	48058628	.	A	G	10	10	20	0	0	20	0	0
6	48383793	.	T	C	4	0	4	0	4	8	0	0
6	49108157	.	T	C	22	9	31	0	3	34	0	0
6	49577503	.	A	G	7	4	11	0	0	11	0	0
6	49737914	.	A	G	11	4	15	0	1	16	0	0
6	49738006	.	A	G	14	4	18	0	3	21	0	0
6	49738159	.	A	G	11	4	15	0	0	15	0	0
6	49738171	.	A	G	5	0	5	0	12	17	0	0
6	49738348	.	A	G	10	0	10	0	7	17	0	0
6	49738353	.	A	G	8	0	8	0	8	16	0	0
6	49738823	.	A	G	6	10	16	0	0	16	0	0
6	49782543	.	A	T	5	2	7	0	0	7	0	0
6	52223936	.	A	G	37	18	55	0	4	59	0	0
6	52224090	.	A	G	31	17	48	0	1	49	0	0
6	52224406	.	A	G	42	21	63	0	3	66	0	0
6	54806566	.	T	C	7	3	10	0	0	10	0	0
6	55218047	.	A	G	4	11	15	0	0	15	0	0
6	57401535	.	T	C	5	2	7	0	0	7	0	0
6	57401553	.	G	C	2	2	4	0	0	4	0	0
6	57401939	.	T	C	2	2	4	0	0	4	0	0
6	57436358	.	G	T	3	4	7	0	0	7	0	0
6	57436359	.	G	T	3	4	7	0	1	8	0	0
6	57439021	.	T	C	3	8	11	0	0	11	0	0
6	57439429	.	C	T	11	6	17	0	0	17	0	0
6	57455557	.	T	C	11	6	17	0	1	18	0	0
6	57459817	.	C	T	3	6	9	0	2	11	0	0
6	57459823	.	T	G	4	7	11	0	0	11	0	0
6	57478900	.	C	T	4	19	23	0	24	47	0	0
6	57481377	.	A	G	29	17	46	1	0	47	0	0
6	57492086	.	G	A	6	12	18	0	2	20	0	0
6	57492208	.	G	A	9	7	16	0	0	16	0	0
6	57492209	.	A	G	9	7	16	0	0	16	0	0
6	57498040	.	G	A	7	6	13	0	1	14	0	0
6	57498088	.	T	C	10	6	16	0	0	16	0	0
6	57498253	.	A	G	11	7	18	0	2	20	0	0
6	57498255	.	A	T	13	6	19	0	2	21	0	0
6	57500563	.	G	A	7	5	12	0	1	13	0	0
6	57500608	.	C	T	8	7	15	0	0	15	0	0
6	57500617	.	G	C	9	0	9	0	6	15	0	0
6	57504571	.	G	T	2	3	5	0	0	5	0	0
6	57504592	.	C	T	1	2	3	0	0	3	0	0
6	57508317	.	G	A	4	6	10	0	1	11	0	0
6	57510245	.	T	A	3	3	6	0	0	6	0	0
6	57510254	.	T	A	4	3	7	0	0	7	0	0
6	57516039	.	A	C	3	7	10	0	0	10	0	0
6	57519053	.	T	C	6	0	6	0	7	13	0	0
6	57519597	.	G	C	6	4	10	0	1	11	0	0
6	57523315	.	T	G	4	2	6	0	0	6	0	0
6	57523330	.	T	A	6	2	8	0	0	8	0	0
6	57531941	.	C	T	5	1	6	0	0	6	0	0
6	57531947	.	C	A	5	2	7	0	0	7	0	0
6	57538896	.	G	C	5	8	13	0	2	15	0	0
6	57541942	.	T	A	23	13	36	0	2	38	0	0
6	57583996	.	T	C	14	17	31	0	2	33	0	0
6	57595160	.	T	C	12	20	32	0	0	32	0	0
6	57595196	.	T	C	12	15	27	0	0	27	0	0
6	57618934	.	C	T	22	24	46	0	0	46	0	0
6	57620177	.	T	C	23	17	40	0	3	43	0	0
6	57620315	.	A	C	21	19	40	0	0	40	0	0
6	57630819	.	A	G	6	9	15	0	0	15	0	0
6	57630879	.	C	A	4	7	11	0	0	11	0	0
6	57630989	.	T	C	16	6	22	0	2	24	0	0
6	57634880	.	T	G	11	14	25	0	2	27	0	0
6	57634922	.	G	A	14	12	26	0	1	27	0	0
6	57634949	.	G	A	15	7	22	0	0	22	0	0
6	57638474	.	T	G	8	6	14	0	2	16	0	0
6	57644311	.	A	G	7	5	12	0	7	19	0	0
6	57644779	.	C	T	9	15	24	0	1	25	0	0
6	57651978	.	C	A	8	9	17	0	0	17	0	0
6	57652041	.	T	C	2	0	2	0	9	11	0	0
6	57900462	.	C	T	2	5	7	0	0	7	0	0
6	57901172	.	C	T	9	13	22	0	0	22	0	0
6	57930338	.	C	T	4	5	9	0	5	14	0	0
6	57984173	.	T	C	12	0	12	0	14	26	0	0
6	58038322	.	T	C	2	4	6	0	0	6	0	0
6	58300429	.	C	T	6	4	10	0	0	10	0	0
6	58304148	.	C	T	4	6	10	0	0	10	0	0
6	58307588	.	C	T	3	2	5	0	0	5	0	0
6	58315258	.	T	A	7	3	10	0	0	10	0	0
6	58315270	.	G	C	0	4	4	0	5	9	0	0
6	58315333	.	T	C	5	10	15	0	0	15	0	0
6	58334566	.	A	C	5	4	9	0	2	11	0	0
6	58359511	.	G	A	6	4	10	0	0	10	0	0
6	58364435	.	C	T	5	3	8	0	0	8	0	0
6	58364534	.	A	T	6	3	9	0	0	9	0	0
6	58367679	.	C	T	1	5	6	0	0	6	0	0
6	58370763	.	T	A	5	6	11	0	1	12	0	0
6	58370814	.	A	G	8	0	8	0	3	11	0	0
6	58370817	.	C	T	7	3	10	0	0	10	0	0
6	58373985	.	T	A	6	4	10	0	1	11	0	0
6	58374023	.	C	T	3	6	9	0	1	10	0	0
6	58374026	.	C	A	3	9	12	0	0	12	0	0
6	58381417	.	T	C	4	6	10	0	1	11	0	0
6	58382915	.	T	G	5	3	8	0	1	9	0	0
6	58382939	.	C	T	4	5	9	0	0	9	0	0
6	58382954	.	C	T	7	5	12	0	0	12	0	0
6	58384020	.	T	C	8	5	13	0	1	14	0	0
6	58384067	.	A	G	6	0	6	0	4	10	0	0
6	58384122	.	C	T	6	5	11	0	0	11	0	0
6	58389115	.	A	C	13	5	18	0	1	19	0	0
6	58389151	.	G	T	12	7	19	0	1	20	0	0
6	58393919	.	A	T	7	5	12	0	0	12	0	0
6	58395444	.	G	A	1	10	11	0	16	27	0	0
6	58460596	.	C	T	9	4	13	0	0	13	0	0
6	58463718	.	C	T	7	6	13	0	1	14	0	0
6	58463787	.	C	T	6	3	9	0	1	10	0	0
6	58495301	.	G	A	4	9	13	0	1	14	0	0
6	58495436	.	C	T	5	5	10	0	1	11	0	0
6	58495573	.	G	T	8	6	14	0	0	14	0	0
6	58495634	.	G	A	1	4	5	0	6	11	0	0
6	58496633	.	T	C	3	2	5	0	0	5	0	0
6	58496698	.	A	G	5	6	11	0	0	11	0	0
6	58496761	.	T	C	5	5	10	0	0	10	0	0
6	58496801	.	G	T	4	4	8	0	0	8	0	0
6	58497002	.	T	C	1	3	4	0	0	4	0	0
6	58497703	.	A	C	3	2	5	0	1	6	0	0
6	58497750	.	A	G	1	5	6	0	0	6	0	0
6	58497757	.	C	T	5	2	7	0	0	7	0	0
6	58497864	.	A	T	6	7	13	0	0	13	0	0
6	58497993	.	C	T	6	3	9	4	0	13	0	0
6	58498021	.	C	T	3	6	9	0	0	9	0	0
6	58498040	.	T	A	5	2	7	0	0	7	0	0
6	58498424	.	C	A	2	4	6	0	1	7	0	0
6	58498439	.	A	T	4	7	11	0	0	11	0	0
6	58498474	.	G	C	2	5	7	0	0	7	0	0
6	58498645	.	A	C	2	3	5	0	0	5	0	0
6	58499657	.	T	C	14	9	23	0	0	23	0	0
6	58522689	.	C	G	11	0	11	0	11	22	0	0
6	58522695	.	A	G	11	11	22	0	1	23	0	0
6	58528602	.	A	G	5	6	11	0	0	11	0	0
6	58528617	.	A	G	6	6	12	0	1	13	0	0
6	58549100	.	A	G	24	0	24	1	34	59	0	0
6	58560682	.	G	A	27	22	49	0	5	54	0	0
6	58560718	.	G	A	31	23	54	0	2	56	0	0
6	58560795	.	C	T	23	24	47	4	1	52	0	0
6	58561003	.	C	T	16	17	33	0	2	35	0	0
6	58561186	.	A	C	11	11	22	0	0	22	0	0
6	58561365	.	G	T	16	3	19	5	1	25	0	0
6	58561494	.	G	T	31	4	35	6	3	44	0	0
6	58562393	.	G	T	22	6	28	2	3	34	1	0
6	58562407	.	T	A	14	17	31	9	6	46	0	0
6	58562436	.	T	A	20	8	28	16	2	46	0	0
6	58563302	.	A	T	12	20	32	0	0	32	0	0
6	58563305	.	G	A	2	19	21	0	11	32	0	0
6	58563527	.	G	A	3	2	5	0	0	5	0	0
6	58698737	.	C	T	7	6	13	0	0	13	0	0
6	58698910	.	T	G	8	1	9	0	9	18	0	0
6	58712268	.	C	T	12	8	20	0	0	20	0	0
6	58712458	.	G	C	10	17	27	0	0	27	0	0
6	58712477	.	C	G	14	13	27	0	0	27	0	0
6	58712540	.	G	A	0	9	9	0	8	17	0	0
6	58712564	.	A	T	11	5	16	0	0	16	0	0
6	58726066	.	G	A	2	16	18	0	15	33	0	0
6	58726154	.	A	G	11	14	25	0	1	26	0	0
6	58728670	.	G	A	1	14	15	0	21	36	0	0
6	58728706	.	G	A	2	15	17	0	18	35	0	0
6	58728825	.	A	G	7	5	12	1	1	14	0	0
6	58728858	.	G	A	1	7	8	1	7	16	0	0
6	58728907	.	C	T	14	6	20	0	0	20	0	0
6	58728915	.	G	T	15	8	23	0	0	23	0	0
6	58729100	.	C	G	9	0	9	0	3	12	0	0
6	58729120	.	T	C	7	7	14	0	1	15	0	0
6	58730421	.	T	A	4	3	7	0	1	8	0	0
6	58732475	.	C	G	18	19	37	0	1	38	0	0
6	58772271	.	T	A	16	9	25	0	2	27	0	0
6	58772272	.	G	A	16	8	24	0	3	27	0	0
6	58778755	.	T	C	9	0	9	0	13	22	0	0
6	58778896	.	G	C	9	0	9	0	9	18	0	0
6	58780420	.	C	T	2	7	9	0	17	26	0	0
6	58780811	.	C	T	10	3	13	0	3	16	0	0
6	58781017	.	G	A	12	7	19	0	1	20	0	0
6	58781083	.	A	G	6	8	14	0	1	15	0	0
6	58781128	.	C	T	6	16	22	0	2	24	0	0
6	58784777	.	C	T	0	8	8	0	13	21	0	0
6	58786939	.	C	T	11	9	20	0	1	21	0	0
6	58808298	.	G	A	7	11	18	0	3	21	0	0
6	58808328	.	C	T	12	8	20	0	2	22	0	0
6	58828322	.	A	T	7	11	18	1	1	20	0	0
6	58832202	.	C	T	4	3	7	0	0	7	0	0
6	58852853	.	G	A	18	13	31	0	5	36	0	0
6	58855648	.	C	T	14	18	32	0	3	35	0	0
6	58856151	.	C	T	20	13	33	0	2	35	0	0
6	58857940	.	A	G	27	21	48	0	1	49	0	0
6	58857964	.	A	G	19	1	20	0	26	46	0	0
6	58859737	.	G	A	4	13	17	0	28	45	0	0
6	58861707	.	A	G	28	17	45	1	1	47	0	0
6	58862328	.	A	G	21	1	22	0	25	47	0	0
6	58862341	.	G	A	2	24	26	0	24	50	0	0
6	58863294	.	T	C	23	24	47	0	3	50	0	0
6	58867048	.	A	G	20	1	21	0	27	49	1	0
6	58867090	.	A	T	23	14	37	0	2	40	1	0
6	58867093	.	C	T	22	13	35	0	4	39	0	0
6	58867206	.	A	G	16	0	16	0	10	26	0	0
6	58867240	.	A	G	13	13	26	0	1	27	0	0
6	58867282	.	G	A	14	12	26	0	0	26	0	0
6	58867329	.	G	C	15	5	20	0	2	22	0	0
6	58867372	.	A	T	14	14	28	0	4	32	0	0
6	58875650	.	C	T	0	5	5	1	1	7	0	0
6	58878032	.	A	C	4	9	13	0	0	13	0	0
6	58886169	.	G	A	4	7	11	0	0	11	0	0
6	58886232	.	A	C	0	7	7	0	0	7	0	0
6	58886247	.	C	T	0	4	4	0	2	6	0	0
6	58889093	.	T	G	2	7	9	0	0	9	0	0
6	58889258	.	T	G	4	3	7	0	0	7	0	0
6	58889690	.	A	G	3	3	6	0	0	6	0	0
6	58891765	.	T	A	4	3	7	0	2	9	0	0
6	58892027	.	A	G	4	7	11	0	1	12	0	0
6	58892365	.	C	T	1	4	5	0	5	10	0	0
6	58892828	.	T	C	2	0	2	0	2	4	0	0
6	58892935	.	G	A	2	4	6	0	0	6	0	0
6	58904939	.	C	A	3	4	7	0	0	7	0	0
6	58921434	.	C	A	6	4	10	0	0	10	0	0
6	58921506	.	G	T	9	10	19	0	0	19	0	0
6	58931376	.	G	A	3	4	7	0	1	8	0	0
6	58939303	.	G	T	3	5	8	0	1	9	0	0
6	58948931	.	C	T	7	16	23	0	1	24	0	0
6	58949325	.	C	T	0	2	2	0	1	3	0	0
6	58949337	.	G	A	1	3	4	0	0	4	0	0
6	58949364	.	C	A	2	4	6	0	1	7	0	0
6	58950079	.	C	G	6	3	9	0	0	9	0	0
6	58962056	.	C	A	4	2	6	0	0	6	0	0
6	58974749	.	C	A	2	2	4	0	0	4	0	0
6	58974791	.	C	T	2	3	5	0	0	5	0	0
6	59031604	.	C	T	2	2	4	0	0	4	0	0
6	59427210	.	C	T	0	2	2	0	2	4	0	0
6	59432046	.	G	A	1	2	3	0	1	4	0	0
6	59813578	.	G	A	2	13	15	0	22	37	0	0
6	59813608	.	A	G	20	16	36	0	1	37	0	0
6	59813857	.	G	A	4	17	21	0	17	38	0	0
6	59813905	.	A	G	22	1	23	0	18	41	0	0
6	59819362	.	C	T	21	14	35	0	2	37	0	0
6	59824482	.	C	T	32	10	42	0	2	44	0	0
6	59824496	.	C	T	30	9	39	0	2	41	0	0
6	59824672	.	C	T	24	16	40	2	8	50	0	0
6	59824736	.	C	T	14	21	35	0	4	39	0	0
6	59832922	.	T	C	16	12	28	0	3	31	0	0
6	59833006	.	T	A	10	12	22	0	1	23	0	0
6	59833007	.	A	G	10	11	21	0	2	23	0	0
6	59837587	.	C	G	12	12	24	0	2	26	0	0
6	59837710	.	A	G	26	29	55	0	1	56	0	0
6	59837747	.	G	A	3	24	27	0	19	46	0	0
6	59839033	.	G	A	1	17	18	0	18	36	0	0
6	59839048	.	G	A	15	17	32	0	1	33	0	0
6	59841394	.	G	A	0	11	11	0	16	27	0	0
6	59847692	.	C	T	1	1	2	0	1	3	0	0
6	59848119	.	C	T	33	22	55	0	1	56	0	0
6	59848345	.	T	C	30	19	49	0	1	50	0	0
6	59848894	.	T	C	18	26	44	0	0	44	0	0
6	59850253	.	C	T	23	15	38	0	0	38	0	0
6	59850308	.	T	C	21	17	38	0	3	41	0	0
6	59874147	.	G	A	0	4	4	0	9	13	0	0
6	59882680	.	T	C	19	9	28	0	1	29	0	0
6	59882704	.	T	C	19	8	27	0	0	27	0	0
6	59883154	.	G	A	10	10	20	0	0	20	0	0
6	59883372	.	A	C	8	2	10	0	19	29	0	0
6	59889640	.	G	T	1	8	9	0	18	27	0	0
6	59889964	.	A	G	10	1	11	0	12	23	0	0
6	59889978	.	C	T	8	5	13	0	2	15	0	0
6	59890125	.	C	T	12	7	19	0	1	20	0	0
6	59891289	.	T	C	12	19	31	0	0	31	0	0
6	59892864	.	C	T	15	11	26	0	2	28	0	0
6	59894548	.	T	C	18	12	30	0	0	30	0	0
6	59894580	.	T	A	23	9	32	0	1	33	0	0
6	59894719	.	T	C	14	6	20	0	1	21	0	0
6	59915599	.	T	C	9	8	17	0	1	18	0	0
6	59915608	.	T	C	8	11	19	0	1	20	0	0
6	59917077	.	T	C	8	11	19	0	0	19	0	0
6	59921661	.	T	G	10	17	27	0	0	27	0	0
6	59921685	.	T	C	12	15	27	0	2	29	0	0
6	59921788	.	A	C	6	9	15	0	1	16	0	0
6	59939277	.	G	A	14	18	32	0	0	32	0	0
6	59944501	.	C	T	1	2	3	0	0	3	0	0
6	59945088	.	A	G	3	4	7	1	1	9	0	0
6	59947097	.	C	A	5	4	9	0	0	9	0	0
6	59949374	.	C	A	6	6	12	1	1	14	0	0
6	59949585	.	A	G	2	3	5	0	0	5	0	0
6	59951483	.	C	G	2	3	5	0	0	5	0	0
6	59968016	.	T	C	3	6	9	3	0	12	0	0
6	59968039	.	T	C	0	7	7	1	1	9	0	0
6	59971416	.	C	T	26	14	40	0	2	42	0	0
6	59971597	.	A	G	38	13	51	0	2	53	0	0
6	59971711	.	G	A	27	13	40	4	0	44	0	0
6	59971718	.	C	A	27	12	39	4	2	45	0	0
6	59971897	.	G	A	2	6	8	2	0	10	0	0
6	59971964	.	G	A	11	4	15	0	0	15	0	0
6	59971968	.	A	G	6	6	12	0	0	12	0	0
6	59972055	.	G	A	1	11	12	0	0	12	0	0
6	59972259	.	T	A	13	15	28	0	1	29	0	0
6	59985833	.	C	T	8	3	11	0	0	11	0	0
6	59987311	.	C	T	6	6	12	0	0	12	0	0
6	59999765	.	C	T	1	5	6	0	1	7	0	0
6	60031520	.	G	A	7	12	19	0	0	19	0	0
6	60043297	.	T	A	2	3	5	0	0	5	0	0
6	60043413	.	G	A	8	7	15	0	1	16	0	0
6	60043529	.	A	G	0	4	4	0	1	5	0	0
6	60043580	.	G	C	2	6	8	0	0	8	0	0
6	60044319	.	T	A	4	3	7	0	0	7	0	0
6	60044320	.	A	T	4	3	7	0	0	7	0	0
7	742828	.	T	C	9	16	25	0	2	27	0	0
7	838170	.	A	C	4	4	8	0	0	8	0	0
7	846579	.	C	T	6	9	15	0	0	15	0	0
7	846972	.	T	C	10	11	21	0	0	21	0	0
7	847189	.	A	T	7	8	15	0	0	15	0	0
7	860914	.	A	G	1	4	5	0	4	9	0	0
7	861057	.	G	C	5	4	9	1	0	10	0	0
7	1417308	.	C	G	2	3	5	1	0	6	0	0
7	1417573	.	G	A	2	2	4	7	0	11	0	0
7	1418207	.	T	A	2	2	4	1	1	7	1	0
7	1418631	.	T	C	4	2	6	0	0	6	0	0
7	1526589	.	G	T	20	5	25	5	10	40	0	0
7	1618769	.	G	A	1	3	4	1	8	13	0	0
7	1618771	.	G	A	0	9	9	1	3	13	0	0
7	3931029	.	A	G	37	19	56	0	3	59	0	0
7	3931264	.	C	T	17	33	50	0	1	51	0	0
7	3931396	.	A	T	30	32	62	1	1	64	0	0
7	3931543	.	A	T	29	22	51	0	2	53	0	0
7	3931598	.	G	T	22	25	47	0	2	49	0	0
7	3931644	.	T	C	25	1	26	0	14	40	0	0
7	3932044	.	T	C	16	6	22	1	0	23	0	0
7	3932209	.	A	T	10	23	33	0	2	35	0	0
7	3932402	.	T	C	9	21	30	0	1	31	0	0
7	3932405	.	A	T	9	21	30	0	1	31	0	0
7	3932463	.	T	G	12	11	23	0	3	26	0	0
7	3932546	.	C	A	2	4	6	0	0	6	0	0
7	3932694	.	G	A	34	8	42	0	1	43	0	0
7	3932698	.	T	C	38	8	46	0	1	47	0	0
7	3932731	.	C	A	40	12	52	0	1	53	0	0
7	3932935	.	C	A	19	13	32	0	0	32	0	0
7	3933121	.	G	A	27	25	52	0	1	53	0	0
7	3933243	.	C	A	27	8	35	0	0	35	0	0
7	3933271	.	C	T	23	8	31	0	4	35	0	0
7	3933383	.	A	C	14	1	15	0	19	34	0	0
7	3933481	.	T	C	24	0	24	0	16	40	0	0
7	3933483	.	C	T	4	13	17	0	23	40	0	0
7	3933998	.	C	T	22	12	34	0	1	35	0	0
7	3934038	.	A	T	11	14	25	0	1	26	0	0
7	3934242	.	T	C	19	1	20	0	5	25	0	0
7	3934387	.	C	T	24	17	41	0	1	42	0	0
7	3934428	.	G	T	24	17	41	0	2	43	0	0
7	3934551	.	A	T	13	8	21	0	1	22	0	0
7	3934645	.	A	C	8	10	18	0	1	19	0	0
7	3934818	.	G	A	15	7	22	0	2	24	0	0
7	3934970	.	A	G	10	9	19	0	4	23	0	0
7	3935055	.	T	C	13	14	27	0	2	29	0	0
7	3935123	.	A	G	9	20	29	0	2	31	0	0
7	3935171	.	G	C	20	8	28	0	0	28	0	0
7	3935283	.	G	A	11	19	30	0	1	31	0	0
7	3935737	.	C	T	2	12	14	0	19	33	0	0
7	3935788	.	C	A	6	10	16	1	2	19	0	0
7	3936127	.	C	T	4	18	22	1	16	39	0	0
7	3936702	.	A	G	4	3	7	0	0	7	0	0
7	3936764	.	G	A	7	8	15	0	1	16	0	0
7	3936946	.	C	T	3	7	10	0	13	24	1	0
7	3951010	.	C	T	0	12	12	0	15	27	0	0
7	3951115	.	G	A	20	11	31	0	0	31	0	0
7	3952993	.	A	G	14	15	29	0	1	30	0	0
7	3955628	.	G	A	7	16	23	0	0	23	0	0
7	4088334	.	C	T	19	16	35	0	1	36	0	0
7	4088545	.	C	T	1	11	12	0	12	24	0	0
7	4088680	.	G	A	9	15	24	0	0	24	0	0
7	4088727	.	A	T	19	18	37	0	0	37	0	0
7	4088832	.	A	G	14	27	41	0	2	43	0	0
7	4089042	.	A	G	20	14	34	0	2	36	0	0
7	4089090	.	G	A	20	10	30	0	0	30	0	0
7	4095265	.	C	T	4	23	27	0	20	47	0	0
7	4100931	.	C	T	17	21	38	0	1	39	0	0
7	4100967	.	G	A	18	21	39	0	2	41	0	0
7	4110441	.	T	C	9	0	9	0	13	22	0	0
7	4174962	.	G	A	0	7	7	0	2	9	0	0
7	4175054	.	G	A	5	4	9	0	1	10	0	0
7	4175078	.	G	A	4	3	7	0	1	8	0	0
7	4178753	.	T	G	1	2	3	0	0	3	0	0
7	4179747	.	A	G	1	0	1	0	3	4	0	0
7	4179962	.	A	G	3	3	6	0	0	6	0	0
7	4179968	.	G	A	3	3	6	0	0	6	0	0
7	4180410	.	C	T	2	3	5	0	0	5	0	0
7	4180653	.	A	G	2	2	4	1	0	5	0	0
7	4183317	.	G	A	3	4	7	0	0	7	0	0
7	4183345	.	C	T	2	3	5	0	0	5	0	0
7	4183602	.	T	G	1	3	4	0	0	4	0	0
7	4183604	.	C	A	1	3	4	0	0	4	0	0
7	4183926	.	C	G	2	2	4	1	1	6	0	0
7	4184141	.	A	G	2	4	6	0	0	6	0	0
7	4184203	.	G	C	3	3	6	0	0	6	0	0
7	4184897	.	G	T	6	5	11	0	0	11	0	0
7	4185160	.	A	T	11	10	21	0	0	21	0	0
7	4185556	.	A	G	2	2	4	0	0	4	0	0
7	4185569	.	A	G	3	3	6	0	1	7	0	0
7	4186499	.	A	G	6	3	9	1	0	10	0	0
7	5324903	.	T	C	9	3	12	0	0	12	0	0
7	5519374	.	A	G	0	1	1	0	1	2	0	0
7	5937407	.	G	A	2	2	4	0	0	4	0	0
7	7039320	.	A	G	8	2	10	1	0	11	0	0
7	7248193	.	C	T	12	5	17	1	4	22	0	0
7	7248212	.	A	T	11	2	13	1	7	21	0	0
7	7372222	.	C	T	2	7	9	0	1	10	0	0
7	7372404	.	A	G	11	7	18	3	2	23	0	0
7	7478533	.	T	C	8	12	20	0	4	24	0	0
7	7478546	.	T	C	10	16	26	0	2	28	0	0
7	7552113	.	G	A	15	17	32	0	1	33	0	0
7	7608920	.	G	A	2	5	7	0	14	21	0	0
7	7608944	.	T	G	13	1	14	0	9	23	0	0
7	7608965	.	C	T	13	8	21	0	0	21	0	0
7	7611758	.	C	T	20	18	38	0	0	38	0	0
7	7611803	.	C	A	13	8	21	0	13	34	0	0
7	7611866	.	T	C	21	10	31	0	3	34	0	0
7	7617855	.	T	C	24	21	45	0	0	45	0	0
7	7617963	.	C	G	14	18	32	0	1	33	0	0
7	7624082	.	A	G	28	22	50	0	2	52	0	0
7	7624090	.	T	C	30	17	47	0	4	51	0	0
7	7641230	.	A	T	25	21	46	0	0	46	0	0
7	7641351	.	G	A	25	21	46	0	1	47	0	0
7	7641353	.	G	A	27	21	48	0	0	48	0	0
7	7641559	.	C	T	20	11	31	0	2	33	0	0
7	7641567	.	C	T	18	13	31	0	0	31	0	0
7	7641608	.	A	G	20	17	37	0	0	37	0	0
7	7641678	.	T	A	19	8	27	0	2	29	0	0
7	7641976	.	T	C	16	11	27	0	0	27	0	0
7	7641984	.	G	T	16	8	24	0	0	24	0	0
7	7642730	.	C	T	21	17	38	0	0	38	0	0
7	7642819	.	G	A	28	9	37	0	1	38	0	0
7	7642840	.	T	A	24	10	34	0	1	35	0	0
7	7642856	.	C	T	19	13	32	0	1	33	0	0
7	7642991	.	T	A	4	3	7	0	1	8	0	0
7	7643184	.	A	G	16	0	16	0	15	31	0	0
7	7643348	.	G	A	28	18	46	0	0	46	0	0
7	7643362	.	T	A	25	18	43	0	2	45	0	0
7	7643488	.	A	G	21	20	41	0	4	45	0	0
7	7643629	.	A	G	32	28	60	1	2	63	0	0
7	7662467	.	C	G	4	8	12	0	1	13	0	0
7	7662475	.	T	C	4	0	4	0	10	14	0	0
7	7662527	.	A	C	8	9	17	0	1	18	0	0
7	7662580	.	G	A	10	15	25	0	0	25	0	0
7	7662872	.	A	C	13	11	24	0	0	24	0	0
7	7662978	.	A	C	5	19	24	0	0	24	0	0
7	7663017	.	T	A	10	18	28	0	0	28	0	0
7	7663048	.	A	G	13	22	35	0	1	36	0	0
7	7663132	.	A	G	9	16	25	0	0	25	0	0
7	7663152	.	A	T	5	9	14	0	0	14	0	0
7	7663320	.	C	G	14	10	24	0	2	26	0	0
7	7663449	.	A	C	24	0	24	0	7	31	0	0
7	7663453	.	A	T	22	7	29	0	0	29	0	0
7	7663682	.	C	T	5	5	10	0	11	21	0	0
7	7663902	.	G	T	10	12	22	1	0	23	0	0
7	7664011	.	A	G	12	5	17	0	0	17	0	0
7	7664026	.	G	A	7	8	15	0	2	17	0	0
7	7664083	.	G	A	7	6	13	0	1	14	0	0
7	7664558	.	G	T	7	6	13	4	2	19	0	0
7	7664838	.	G	T	12	8	20	0	0	20	0	0
7	7664870	.	G	T	9	4	13	0	0	13	0	0
7	7664882	.	G	C	9	4	13	0	0	13	0	0
7	7664912	.	A	C	6	3	9	0	0	9	0	0
7	7665338	.	G	T	14	9	23	0	0	23	0	0
7	7665353	.	T	A	14	9	23	0	0	23	0	0
7	7665480	.	A	C	10	9	19	0	0	19	0	0
7	7665877	.	T	C	1	2	3	0	0	3	0	0
7	7665878	.	C	T	1	2	3	0	0	3	0	0
7	7665952	.	T	A	5	2	7	0	0	7	0	0
7	7666388	.	G	A	12	14	26	0	0	26	0	0
7	7666625	.	G	A	12	13	25	0	2	27	0	0
7	7674378	.	T	C	13	0	13	0	16	29	0	0
7	7674462	.	C	G	11	12	23	0	1	24	0	0
7	7674474	.	T	A	6	13	19	0	0	19	0	0
7	7676086	.	C	T	9	6	15	0	0	15	0	0
7	7676112	.	C	T	9	6	15	0	0	15	0	0
7	7676185	.	C	T	2	3	5	0	0	5	0	0
7	7680073	.	C	T	1	4	5	1	0	6	0	0
7	7681415	.	T	G	6	2	8	0	0	8	0	0
7	7681419	.	C	G	0	2	2	0	6	8	0	0
7	7683342	.	G	A	2	2	4	0	1	5	0	0
7	7683537	.	G	A	1	3	4	0	0	4	0	0
7	7683545	.	C	T	0	3	3	0	2	5	0	0
7	7684895	.	T	A	1	2	3	0	1	4	0	0
7	7696726	.	G	C	9	9	18	0	1	19	0	0
7	7696742	.	A	G	13	12	25	0	0	25	0	0
7	7696785	.	T	A	7	12	19	0	0	19	0	0
7	7696794	.	G	T	0	12	12	0	9	21	0	0
7	7700867	.	G	A	0	10	10	1	7	18	0	0
7	7700965	.	T	G	7	0	7	0	13	20	0	0
7	7700987	.	T	C	8	11	19	0	1	20	0	0
7	7701016	.	G	C	7	10	17	0	0	17	0	0
7	7701293	.	T	C	2	10	12	0	1	13	0	0
7	7705993	.	C	G	10	0	10	0	7	18	1	0
7	7706005	.	C	T	9	5	14	0	1	15	0	0
7	7706869	.	A	G	5	5	10	0	1	11	0	0
7	7706997	.	C	A	7	5	12	0	1	13	0	0
7	7707029	.	T	G	4	4	8	0	1	9	0	0
7	7708714	.	T	C	7	5	12	0	0	12	0	0
7	7708826	.	T	G	4	6	10	0	1	11	0	0
7	7708840	.	C	A	4	3	7	0	1	8	0	0
7	7710930	.	A	G	3	3	6	2	0	8	0	0
7	7720139	.	A	G	1	1	2	0	1	3	0	0
7	7756542	.	G	T	1	3	4	0	0	4	0	0
7	7785550	.	T	C	3	2	5	0	1	6	0	0
7	7795237	.	C	G	2	2	4	0	0	4	0	0
7	7796019	.	T	C	4	2	6	0	0	6	0	0
7	7797598	.	T	C	3	3	6	0	0	6	0	0
7	7797616	.	C	A	3	3	6	0	0	6	0	0
7	8694893	.	A	C	0	12	12	0	0	12	0	0
7	8694999	.	T	A	2	4	6	0	0	6	0	0
7	8695001	.	C	A	2	4	6	0	0	6	0	0
7	8695191	.	C	T	0	3	3	0	11	14	0	0
7	8702121	.	C	T	2	2	4	0	0	4	0	0
7	8728524	.	C	T	1	2	3	0	0	3	0	0
7	8890495	.	C	T	1	8	9	0	8	17	0	0
7	8890515	.	G	C	8	0	8	0	16	24	0	0
7	8891675	.	T	A	10	4	14	0	0	14	0	0
7	8891710	.	A	G	4	16	20	0	0	20	0	0
7	8891717	.	A	G	5	15	20	0	0	20	0	0
7	8891755	.	T	G	5	13	18	5	0	23	0	0
7	8909438	.	C	T	6	5	11	0	0	11	0	0
7	9212234	.	A	G	5	6	11	0	0	11	0	0
7	9224366	.	G	A	2	4	6	0	3	9	0	0
7	9229327	.	A	C	11	5	16	0	1	17	0	0
7	9232531	.	T	C	3	3	6	0	0	6	0	0
7	9232615	.	C	T	1	7	8	0	0	8	0	0
7	9232621	.	C	G	1	7	8	0	0	8	0	0
7	9238631	.	A	G	3	0	3	0	5	8	0	0
7	9261589	.	T	C	4	7	11	0	0	11	0	0
7	9290962	.	A	G	2	1	3	0	1	4	0	0
7	9291049	.	C	A	21	8	29	0	1	30	0	0
7	9299776	.	T	A	7	7	14	0	0	14	0	0
7	9302654	.	G	A	0	3	3	0	7	10	0	0
7	9302664	.	T	C	7	3	10	0	0	10	0	0
7	9302736	.	C	A	10	3	13	0	0	13	0	0
7	9302841	.	A	G	13	6	19	0	0	19	0	0
7	9302990	.	T	A	20	8	28	0	0	28	0	0
7	9303000	.	T	A	18	5	23	0	4	27	0	0
7	9304692	.	T	C	19	15	34	0	1	35	0	0
7	9305501	.	G	A	1	2	3	0	0	3	0	0
7	9308683	.	A	G	22	15	37	0	0	37	0	0
7	9308715	.	C	T	26	8	34	0	0	34	0	0
7	9308817	.	A	G	22	15	37	0	1	38	0	0
7	9312770	.	G	A	1	23	24	0	22	46	0	0
7	9317990	.	G	A	17	18	35	0	2	37	0	0
7	9319626	.	T	C	19	24	43	0	1	44	0	0
7	9319774	.	A	C	6	4	10	0	0	10	0	0
7	9320431	.	A	T	17	10	27	0	0	27	0	0
7	9320489	.	A	G	16	8	24	0	2	26	0	0
7	9321124	.	G	A	3	7	10	0	8	18	0	0
7	9321188	.	G	A	13	10	23	0	0	23	0	0
7	9321528	.	A	C	4	2	6	0	0	6	0	0
7	9321529	.	C	G	4	0	4	0	2	6	0	0
7	9321800	.	G	A	1	10	11	0	17	28	0	0
7	9321981	.	G	T	16	17	33	0	1	34	0	0
7	9322176	.	C	A	23	4	27	0	0	29	2	0
7	9322178	.	T	C	24	4	28	0	2	30	0	0
7	9322271	.	G	C	13	12	25	0	0	26	1	0
7	9322441	.	C	T	6	10	16	0	0	16	0	0
7	9509567	.	G	T	0	2	2	0	1	3	0	0
7	9509583	.	A	C	4	3	7	0	0	7	0	0
7	9599105	.	T	C	2	2	4	0	0	4	0	0
7	9844342	.	T	C	1	0	1	0	8	9	0	0
7	10875101	.	A	G	15	16	31	1	3	35	0	0
7	10875386	.	A	G	15	8	23	0	1	24	0	0
7	10875552	.	A	G	11	5	16	0	1	17	0	0
7	10875751	.	A	G	22	11	33	0	0	33	0	0
7	10875761	.	A	G	22	10	32	0	1	33	0	0
7	11005603	.	G	A	1	5	6	0	2	8	0	0
7	11340654	.	A	G	9	7	16	0	2	18	0	0
7	11340658	.	A	G	9	0	9	0	10	19	0	0
7	11341012	.	A	G	5	0	5	1	4	10	0	0
7	12843432	.	T	G	1	7	8	0	0	8	0	0
7	12843987	.	T	C	1	6	7	0	0	7	0	0
7	12844513	.	T	C	4	7	11	0	0	11	0	0
7	12844549	.	T	C	10	0	10	0	4	14	0	0
7	13242876	.	A	G	1	0	1	0	3	4	0	0
7	13336485	.	A	T	2	2	4	0	0	4	0	0
7	13512132	.	G	T	0	10	10	0	1	11	0	0
7	13569969	.	C	G	5	2	7	4	0	11	0	0
7	13616825	.	G	C	1	7	8	0	0	8	0	0
7	13617354	.	A	G	2	0	2	0	2	4	0	0
7	13617705	.	T	C	1	1	2	0	0	2	0	0
7	13824251	.	G	A	2	2	4	0	0	4	0	0
7	13858902	.	T	A	2	1	3	0	1	4	0	0
7	13858905	.	C	T	0	3	3	0	0	3	0	0
7	13897615	.	C	T	1	3	4	0	0	4	0	0
7	13897711	.	T	C	3	4	7	0	0	7	0	0
7	13897765	.	A	C	9	5	14	0	0	14	0	0
7	13897768	.	A	C	8	0	8	0	5	14	1	0
7	13897822	.	G	A	5	4	9	0	0	9	0	0
7	13897878	.	G	A	2	2	4	0	0	4	0	0
7	13897897	.	T	C	4	2	6	0	0	6	0	0
7	13900964	.	A	G	3	3	6	0	0	6	0	0
7	13900967	.	G	A	3	3	6	0	0	6	0	0
7	14005289	.	C	A	3	4	7	0	0	7	0	0
7	14171276	.	A	G	1	3	4	0	0	4	0	0
7	14202790	.	C	T	1	2	3	0	0	3	0	0
7	14203690	.	A	G	2	4	6	0	1	7	0	0
7	14203711	.	A	G	5	2	7	0	0	7	0	0
7	14203761	.	A	G	3	3	6	0	0	6	0	0
7	14204447	.	T	A	1	3	4	0	0	4	0	0
7	14205132	.	A	G	2	3	5	0	1	6	0	0
7	14205503	.	G	A	5	9	14	0	1	15	0	0
7	14205527	.	G	C	3	9	12	0	1	13	0	0
7	14205559	.	T	C	4	4	8	0	0	8	0	0
7	14205857	.	C	A	1	4	5	0	1	6	0	0
7	14205881	.	A	G	4	4	8	0	0	8	0	0
7	14206383	.	C	T	3	3	6	0	0	6	0	0
7	14206499	.	T	A	2	8	10	1	1	12	0	0
7	14206790	.	T	G	5	3	8	0	0	8	0	0
7	14206847	.	C	A	6	3	9	0	0	9	0	0
7	14262108	.	A	T	4	6	10	0	1	11	0	0
7	14262111	.	G	T	0	6	6	0	6	12	0	0
7	14354038	.	T	C	5	12	17	0	2	19	0	0
7	14381282	.	C	G	3	4	7	0	0	7	0	0
7	14393317	.	G	A	1	2	3	0	1	4	0	0
7	14393956	.	A	T	1	4	5	0	1	6	0	0
7	14394824	.	G	T	3	6	9	0	1	10	0	0
7	14394839	.	G	C	4	6	10	0	0	10	0	0
7	14394860	.	A	C	4	9	13	0	0	13	0	0
7	14394891	.	G	A	4	8	12	0	0	12	0	0
7	14394925	.	A	G	5	8	13	0	0	13	0	0
7	14394991	.	G	A	3	6	9	0	0	9	0	0
7	14395029	.	A	G	5	7	12	0	0	12	0	0
7	14397735	.	A	G	6	4	10	0	0	10	0	0
7	14400446	.	G	A	4	3	7	0	0	7	0	0
7	14417122	.	C	T	1	6	7	0	0	7	0	0
7	14417212	.	G	A	3	3	6	0	0	6	0	0
7	14417239	.	C	A	3	4	7	0	1	8	0	0
7	14423183	.	C	T	2	3	5	0	0	5	0	0
7	14424209	.	T	C	2	3	5	0	1	6	0	0
7	14424246	.	C	A	2	2	4	0	0	4	0	0
7	14424254	.	C	T	2	2	4	0	0	4	0	0
7	14431063	.	A	C	2	2	4	0	0	4	0	0
7	14512064	.	G	A	2	4	6	0	0	6	0	0
7	14512081	.	A	C	3	4	7	0	0	7	0	0
7	14512099	.	C	G	5	5	10	0	0	10	0	0
7	14532066	.	T	C	9	16	25	0	0	25	0	0
7	14534326	.	T	C	18	1	19	0	12	31	0	0
7	14534789	.	T	C	12	17	29	0	2	31	0	0
7	14535719	.	T	C	13	11	24	0	0	24	0	0
7	14535749	.	T	A	15	13	28	0	0	28	0	0
7	14535782	.	G	T	15	15	30	0	0	30	0	0
7	14535834	.	A	C	4	2	6	0	0	6	0	0
7	14536163	.	A	G	9	4	13	0	0	13	0	0
7	14539470	.	T	C	7	6	13	0	0	13	0	0
7	14542854	.	C	T	4	6	10	0	0	10	0	0
7	14543002	.	T	C	7	7	14	0	2	16	0	0
7	14543031	.	G	A	7	4	11	0	1	12	0	0
7	14543128	.	A	T	1	2	3	0	0	3	0	0
7	14543156	.	T	G	1	3	4	0	0	4	0	0
7	14543391	.	A	G	1	3	4	0	1	5	0	0
7	14543454	.	G	T	2	6	8	0	1	9	0	0
7	14543463	.	T	C	2	4	6	0	1	7	0	0
7	14632664	.	G	A	2	2	4	0	0	4	0	0
7	14774086	.	C	A	5	6	11	0	1	12	0	0
7	14789964	.	G	A	1	11	12	0	5	17	0	0
7	14860521	.	C	T	6	12	18	0	0	18	0	0
7	14860524	.	A	C	6	10	16	0	1	17	0	0
7	14900869	.	G	A	13	3	16	0	4	20	0	0
7	14905516	.	G	C	6	7	13	0	0	13	0	0
7	14938134	.	C	T	9	4	13	0	0	13	0	0
7	14938404	.	C	T	5	3	8	0	0	8	0	0
7	15087543	.	A	C	4	0	4	0	3	7	0	0
7	15087831	.	A	T	3	3	6	0	0	6	0	0
7	15087833	.	G	A	2	3	5	0	1	6	0	0
7	15087995	.	A	T	1	2	3	0	1	4	0	0
7	15088130	.	A	G	3	2	5	0	0	5	0	0
7	15088184	.	G	A	3	2	5	0	0	5	0	0
7	15088906	.	T	C	1	2	3	1	1	5	0	0
7	15088988	.	G	T	1	2	3	0	0	3	0	0
7	15459009	.	A	C	1	2	3	0	0	3	0	0
7	15543788	.	C	T	1	5	6	0	0	6	0	0
7	15543860	.	G	A	0	3	3	0	3	6	0	0
7	15543920	.	T	C	3	2	5	0	0	5	0	0
7	15572650	.	G	C	1	2	3	0	0	3	0	0
7	15572797	.	A	G	1	2	3	0	0	3	0	0
7	15602760	.	T	G	1	0	1	0	2	3	0	0
7	15603667	.	A	T	1	2	3	0	0	3	0	0
7	15605058	.	G	T	4	6	10	0	1	11	0	0
7	15605180	.	A	T	6	4	10	0	0	10	0	0
7	15605844	.	C	T	6	4	10	0	1	11	0	0
7	15605846	.	T	C	6	5	11	0	0	11	0	0
7	15605950	.	T	C	6	3	9	0	1	10	0	0
7	15605968	.	T	A	4	7	11	0	0	11	0	0
7	15606146	.	T	G	1	3	4	0	1	5	0	0
7	15606167	.	C	A	0	1	1	0	1	2	0	0
7	15607650	.	C	T	9	10	19	0	1	20	0	0
7	15607757	.	G	A	0	9	9	0	5	14	0	0
7	15607809	.	A	G	2	3	5	0	2	7	0	0
7	15607867	.	C	T	4	4	8	0	0	8	0	0
7	15608108	.	A	C	3	6	9	0	1	10	0	0
7	15608113	.	T	C	4	5	9	0	0	9	0	0
7	15608471	.	C	T	7	5	12	0	0	12	0	0
7	15608520	.	G	A	2	7	9	0	1	10	0	0
7	15608620	.	G	A	1	4	5	0	0	5	0	0
7	15608707	.	T	G	1	3	4	0	0	4	0	0
7	15608730	.	A	C	2	3	5	0	0	5	0	0
7	15608767	.	T	A	4	5	9	0	0	9	0	0
7	15608774	.	C	G	3	4	7	0	1	8	0	0
7	15609137	.	A	C	6	10	16	0	0	16	0	0
7	15609156	.	G	A	6	7	13	0	1	14	0	0
7	15609387	.	T	A	9	5	14	0	0	14	0	0
7	15609469	.	C	T	9	11	20	0	0	20	0	0
7	15609520	.	G	A	7	3	10	1	1	12	0	0
7	15609826	.	C	T	5	7	12	0	1	13	0	0
7	15609961	.	C	T	10	7	17	0	0	17	0	0
7	15618216	.	T	C	3	4	7	0	0	7	0	0
7	15618227	.	C	T	2	2	4	0	1	5	0	0
7	15620071	.	A	G	5	5	10	0	1	11	0	0
7	15623727	.	A	C	4	5	9	0	0	9	0	0
7	15648755	.	C	T	3	6	9	0	0	9	0	0
7	15653514	.	G	A	4	8	12	0	1	13	0	0
7	15819692	.	C	T	7	7	14	0	0	14	0	0
7	15825888	.	T	C	5	1	6	0	3	9	0	0
7	15825932	.	T	C	6	0	6	0	7	13	0	0
7	15826026	.	G	A	7	3	10	0	0	10	0	0
7	15830007	.	T	C	4	3	7	0	0	7	0	0
7	15830026	.	A	G	2	3	5	0	1	6	0	0
7	15830095	.	C	T	2	4	6	0	0	6	0	0
7	15891623	.	C	A	8	5	13	0	1	14	0	0
7	15896959	.	G	C	3	5	8	0	1	9	0	0
7	15896998	.	G	A	0	4	4	0	6	10	0	0
7	15897024	.	G	A	5	3	8	0	0	8	0	0
7	15897076	.	G	A	3	3	6	0	0	6	0	0
7	15897615	.	G	T	3	6	9	0	0	9	0	0
7	15897671	.	G	T	3	4	7	0	0	7	0	0
7	15897676	.	T	C	4	4	8	0	0	8	0	0
7	15897755	.	A	G	3	7	10	0	0	10	0	0
7	15898112	.	G	T	2	4	6	0	0	6	0	0
7	15898280	.	T	C	2	7	9	0	2	11	0	0
7	15898400	.	T	C	5	4	9	0	2	11	0	0
7	15898712	.	C	A	1	7	8	0	0	8	0	0
7	15899189	.	T	C	4	4	8	0	0	8	0	0
7	15899191	.	A	G	4	4	8	0	0	8	0	0
7	15899286	.	A	G	3	5	8	0	2	10	0	0
7	15899468	.	A	T	4	8	12	0	0	12	0	0
7	15899532	.	T	A	8	10	18	0	3	22	1	0
7	15899711	.	G	T	1	4	5	0	0	5	0	0
7	15900102	.	G	A	1	3	4	0	0	4	0	0
7	15959883	.	G	T	5	2	7	0	0	7	0	0
7	16051387	.	T	G	1	3	4	0	0	4	0	0
7	16348898	.	A	G	10	14	24	0	4	28	0	0
7	16388262	.	C	T	14	18	32	0	1	33	0	0
7	16388307	.	C	T	16	15	31	0	0	31	0	0
7	16388310	.	G	C	15	15	30	0	0	30	0	0
7	16388358	.	T	C	12	10	22	0	4	26	0	0
7	16456854	.	C	T	13	19	32	0	1	33	0	0
7	16460093	.	C	T	6	14	20	0	3	23	0	0
7	16460252	.	G	A	12	7	19	1	0	20	0	0
7	16460448	.	T	C	1	4	5	0	0	5	0	0
7	16460466	.	C	T	1	1	2	0	2	4	0	0
7	16514226	.	G	A	1	6	7	0	0	7	0	0
7	16514265	.	C	T	5	2	7	0	0	7	0	0
7	16516650	.	C	T	1	2	3	0	0	3	0	0
7	16529521	.	C	T	3	2	5	0	0	5	0	0
7	16538203	.	T	C	4	4	8	0	0	8	0	0
7	16545638	.	C	T	8	7	15	0	0	15	0	0
7	16545725	.	G	A	4	9	13	1	0	14	0	0
7	16545777	.	T	A	6	8	14	0	0	14	0	0
7	16545790	.	A	G	4	7	11	0	1	12	0	0
7	16545847	.	G	A	0	2	2	0	6	8	0	0
7	16545860	.	G	T	4	2	6	0	0	6	0	0
7	16546048	.	T	A	5	3	8	0	1	9	0	0
7	16546052	.	G	C	0	4	4	0	5	9	0	0
7	16922248	.	G	A	4	4	8	0	1	9	0	0
7	16922258	.	C	T	5	5	10	0	0	10	0	0
7	16955692	.	T	C	3	2	5	0	0	5	0	0
7	16958050	.	C	T	6	2	8	0	0	8	0	0
7	16963409	.	C	T	5	4	9	0	0	9	0	0
7	16963444	.	C	A	4	4	8	0	0	8	0	0
7	16994639	.	G	A	0	5	5	0	1	6	0	0
7	16996078	.	C	T	3	5	8	0	0	8	0	0
7	17000956	.	G	A	1	3	4	0	2	6	0	0
7	17003499	.	A	T	4	2	6	0	0	6	0	0
7	17003562	.	A	G	4	0	4	0	4	8	0	0
7	17003632	.	A	T	4	3	7	0	1	8	0	0
7	17004383	.	C	T	4	3	7	0	0	7	0	0
7	17006574	.	G	A	1	3	4	0	2	6	0	0
7	17008188	.	G	T	2	3	5	0	0	5	0	0
7	17008217	.	C	A	3	5	8	0	0	8	0	0
7	17008230	.	T	C	4	5	9	0	0	9	0	0
7	17008305	.	C	T	6	4	10	0	0	10	0	0
7	17009538	.	C	T	3	4	7	0	0	7	0	0
7	17010015	.	T	C	4	4	8	0	0	8	0	0
7	17011427	.	T	C	2	8	10	0	0	10	0	0
7	17012073	.	G	C	2	3	5	0	0	5	0	0
7	17012233	.	T	G	4	2	6	0	1	7	0	0
7	17012299	.	T	A	2	2	4	0	0	4	0	0
7	17012573	.	G	C	2	3	5	0	0	5	0	0
7	17012682	.	C	T	1	3	4	0	0	4	0	0
7	17012967	.	C	A	1	5	6	0	0	6	0	0
7	17013000	.	G	A	0	5	5	0	3	8	0	0
7	17014017	.	G	C	2	4	6	0	0	6	0	0
7	17014338	.	T	G	1	0	1	1	6	8	0	0
7	17014453	.	A	C	2	6	8	0	1	9	0	0
7	17014531	.	C	A	8	8	16	0	0	16	0	0
7	17014548	.	G	T	8	8	16	0	0	16	0	0
7	17014621	.	T	A	7	14	21	0	1	22	0	0
7	17014653	.	C	T	7	8	15	0	0	15	0	0
7	17014748	.	T	C	6	2	8	0	0	8	0	0
7	17014809	.	A	C	3	3	6	0	0	6	0	0
7	17014815	.	T	C	3	4	7	0	0	7	0	0
7	17014914	.	A	G	1	3	4	0	0	4	0	0
7	17096318	.	G	A	1	2	3	0	2	5	0	0
7	17097176	.	G	A	8	7	15	0	0	15	0	0
7	17097191	.	C	T	9	8	17	0	0	17	0	0
7	17100076	.	T	C	8	11	19	0	0	19	0	0
7	17100259	.	T	C	9	7	16	0	0	16	0	0
7	17100271	.	G	A	11	6	17	0	0	17	0	0
7	17104445	.	C	A	1	2	3	0	0	3	0	0
7	17106599	.	C	T	3	2	5	0	0	5	0	0
7	17173458	.	A	G	2	0	2	0	3	5	0	0
7	17246018	.	G	A	0	3	3	0	5	8	0	0
7	17246036	.	C	T	6	3	9	0	0	9	0	0
7	17247785	.	T	A	2	10	12	0	0	12	0	0
7	17247804	.	G	C	6	2	8	0	1	9	0	0
7	17248373	.	T	G	7	1	8	0	4	12	0	0
7	17248433	.	G	A	8	4	12	0	0	12	0	0
7	17248436	.	G	A	0	1	1	0	8	10	1	0
7	17248476	.	G	T	4	3	7	0	0	7	0	0
7	17248484	.	A	C	2	2	4	0	0	4	0	0
7	17248579	.	T	C	1	6	7	0	0	7	0	0
7	17248865	.	T	A	4	7	11	0	0	11	0	0
7	17249121	.	C	T	7	2	9	0	0	9	0	0
7	17249293	.	A	T	5	9	14	0	0	14	0	0
7	17249439	.	T	A	2	10	12	0	0	12	0	0
7	17249463	.	C	A	8	2	10	0	1	11	0	0
7	17249500	.	G	C	1	5	6	0	0	6	0	0
7	17249642	.	C	T	3	12	15	0	0	15	0	0
7	17249829	.	A	T	3	9	12	0	0	12	0	0
7	17249885	.	G	A	3	5	8	4	0	12	0	0
7	17249941	.	A	T	9	8	17	1	1	19	0	0
7	17249945	.	A	C	6	9	15	0	3	18	0	0
7	17250069	.	C	T	6	9	15	0	0	15	0	0
7	17250073	.	C	A	9	2	11	0	1	12	0	0
7	17250191	.	C	T	8	22	30	0	0	30	0	0
7	17250249	.	G	A	1	10	11	0	9	20	0	0
7	17250298	.	C	T	1	4	5	0	1	6	0	0
7	17250422	.	G	T	2	10	12	1	0	13	0	0
7	17251098	.	C	A	23	8	31	1	1	33	0	0
7	17251222	.	G	A	1	13	14	0	22	36	0	0
7	17251234	.	A	G	22	13	35	0	2	37	0	0
7	17650751	.	G	C	3	2	5	0	0	5	0	0
7	17654734	.	C	G	1	5	6	0	0	6	0	0
7	17690892	.	A	T	1	2	3	0	1	4	0	0
7	17692797	.	G	A	4	5	9	0	0	9	0	0
7	17692857	.	T	C	2	6	8	0	0	8	0	0
7	17695039	.	C	T	6	10	16	0	0	16	0	0
7	17695051	.	A	G	8	5	13	0	0	13	0	0
7	17695425	.	A	G	3	3	6	0	1	7	0	0
7	17702671	.	G	A	2	4	6	0	0	6	0	0
7	17708643	.	C	T	0	3	3	0	3	6	0	0
7	17708968	.	G	A	3	6	9	0	0	9	0	0
7	17754299	.	G	A	21	20	41	4	1	46	0	0
7	17754811	.	T	A	3	11	14	0	2	16	0	0
7	17757019	.	A	G	26	25	51	0	7	58	0	0
7	17757024	.	C	T	28	28	56	0	2	58	0	0
7	17757078	.	A	G	31	29	60	0	1	61	0	0
7	17757243	.	T	G	30	16	46	3	2	51	0	0
7	17757371	.	T	C	26	34	60	1	1	62	0	0
7	17757408	.	G	A	33	26	59	1	0	60	0	0
7	17761063	.	A	C	4	2	6	0	1	7	0	0
7	17762455	.	C	G	0	3	3	0	2	5	0	0
7	17762480	.	G	C	2	2	4	0	0	4	0	0
7	17763741	.	T	C	2	2	4	0	0	4	0	0
7	17767011	.	G	T	2	4	6	0	0	6	0	0
7	17770871	.	G	A	3	4	7	0	0	7	0	0
7	17779572	.	A	G	1	2	3	0	0	3	0	0
7	17787167	.	A	G	1	2	3	0	0	3	0	0
7	17800748	.	C	T	3	2	5	0	0	5	0	0
7	17800956	.	A	G	4	2	6	0	0	6	0	0
7	17800993	.	C	T	2	3	5	0	0	5	0	0
7	17801385	.	A	G	1	4	5	0	0	5	0	0
7	17801435	.	T	A	2	4	6	0	0	6	0	0
7	17801442	.	G	A	0	2	2	0	2	4	0	0
7	17801775	.	T	C	4	4	8	0	0	8	0	0
7	17801778	.	C	T	3	4	7	0	1	8	0	0
7	17801841	.	C	T	3	6	9	0	1	10	0	0
7	17801857	.	C	A	2	5	7	0	0	7	0	0
7	17801896	.	T	G	5	3	8	0	0	8	0	0
7	17801900	.	A	G	4	0	4	0	3	7	0	0
7	17801938	.	A	G	6	0	6	2	6	14	0	0
7	17802747	.	T	G	1	3	4	0	0	4	0	0
7	17802755	.	T	G	1	2	3	0	0	4	1	0
7	17803410	.	T	A	2	3	5	0	0	5	0	0
7	17803424	.	C	A	1	4	5	0	0	5	0	0
7	17805586	.	G	C	3	0	3	0	3	6	0	0
7	17805595	.	T	A	5	3	8	0	0	8	0	0
7	17805706	.	C	G	3	8	11	0	1	12	0	0
7	17809860	.	C	T	7	4	11	0	0	11	0	0
7	17810581	.	C	T	7	3	10	0	1	11	0	0
7	17810611	.	G	A	8	4	12	0	0	12	0	0
7	17811052	.	T	C	7	1	8	0	6	14	0	0
7	17812892	.	T	A	8	7	15	0	2	17	0	0
7	17813283	.	A	G	6	4	10	0	0	10	0	0
7	17813987	.	T	C	3	0	3	0	2	5	0	0
7	17933314	.	C	G	7	4	11	0	2	13	0	0
7	17933323	.	C	T	8	3	11	0	0	11	0	0
7	17933350	.	G	A	0	9	9	0	12	21	0	0
7	17933362	.	A	G	10	1	11	0	8	20	1	0
7	17933413	.	T	A	11	10	21	0	1	22	0	0
7	17933777	.	G	A	1	12	13	0	15	28	0	0
7	17936753	.	C	G	16	22	38	0	2	40	0	0
7	17936795	.	G	A	2	24	26	0	18	44	0	0
7	17938069	.	C	A	18	13	31	0	0	31	0	0
7	17941936	.	C	T	9	11	20	0	4	24	0	0
7	17942370	.	G	A	6	6	12	0	1	13	0	0
7	17942451	.	A	C	5	3	8	0	0	8	0	0
7	17942482	.	A	G	2	2	4	0	0	4	0	0
7	17942883	.	T	G	16	11	27	0	0	27	0	0
7	17943078	.	A	G	10	15	25	0	1	26	0	0
7	17943133	.	C	T	19	12	31	0	0	31	0	0
7	17943170	.	G	A	1	22	23	0	18	42	1	0
7	17943376	.	C	G	12	17	29	0	1	30	0	0
7	17943509	.	A	G	19	0	19	0	22	41	0	0
7	17943851	.	G	C	4	3	7	0	0	7	0	0
7	17953986	.	G	A	2	2	4	0	0	4	0	0
7	17957514	.	C	A	3	2	5	0	0	5	0	0
7	17963800	.	C	G	4	4	8	0	0	8	0	0
7	17963815	.	C	T	4	5	9	0	0	9	0	0
7	17965749	.	G	A	4	5	9	0	0	9	0	0
7	17969145	.	C	T	12	7	19	0	1	20	0	0
7	17969461	.	T	A	4	4	8	0	0	8	0	0
7	17969679	.	A	G	2	2	4	0	0	4	0	0
7	17969720	.	C	T	1	3	4	0	0	4	0	0
7	17969851	.	A	G	5	1	6	0	1	7	0	0
7	17970006	.	A	G	2	1	3	0	0	6	3	0
7	17970016	.	C	T	4	3	7	0	1	8	0	0
7	17970124	.	T	A	3	4	7	0	0	7	0	0
7	17970654	.	G	A	4	3	7	0	0	7	0	0
7	18072762	.	C	A	3	2	5	0	2	7	0	0
7	18072797	.	T	G	4	3	7	0	1	8	0	0
7	18072800	.	C	T	3	4	7	0	1	8	0	0
7	18073336	.	G	T	1	1	2	0	1	3	0	0
7	18114316	.	G	A	10	19	29	0	42	71	0	0
7	18114495	.	C	T	18	16	34	0	7	41	0	0
7	18114518	.	A	T	11	7	18	0	10	28	0	0
7	18115220	.	T	A	20	20	40	0	3	43	0	0
7	18115261	.	G	T	18	22	40	0	3	43	0	0
7	18115302	.	G	A	2	26	28	0	14	42	0	0
7	18115470	.	C	T	28	15	43	0	0	43	0	0
7	18115584	.	T	G	13	17	30	1	4	35	0	0
7	18115721	.	G	A	2	21	23	0	22	45	0	0
7	18116037	.	C	T	14	14	28	0	1	29	0	0
7	18116204	.	G	A	24	23	47	0	3	50	0	0
7	18122445	.	C	G	10	8	18	0	0	18	0	0
7	18122541	.	G	C	16	0	16	0	20	36	0	0
7	18124218	.	C	T	18	18	36	0	1	37	0	0
7	18124314	.	C	T	17	20	37	0	1	38	0	0
7	18124329	.	T	A	17	17	34	0	1	35	0	0
7	18137325	.	C	T	1	22	23	0	21	44	0	0
7	18146699	.	T	G	7	10	17	0	0	17	0	0
7	18168253	.	T	A	24	14	38	0	1	39	0	0
7	18168419	.	A	T	2	2	4	0	0	4	0	0
7	18365306	.	C	T	1	2	3	0	0	3	0	0
7	18365336	.	C	T	1	2	3	0	0	3	0	0
7	18366718	.	C	T	2	5	7	0	0	7	0	0
7	18366865	.	T	A	4	2	6	0	0	6	0	0
7	18366932	.	T	C	1	4	5	0	0	5	0	0
7	18366936	.	A	T	1	4	5	0	0	5	0	0
7	18367052	.	C	T	2	1	3	0	1	4	0	0
7	18367075	.	A	C	4	3	7	0	0	7	0	0
7	18412779	.	A	G	2	3	5	0	0	5	0	0
7	18413054	.	G	T	3	2	5	0	0	5	0	0
7	18413086	.	G	T	4	2	6	0	1	7	0	0
7	18413585	.	A	C	2	5	7	0	0	7	0	0
7	18413745	.	G	A	5	2	7	1	0	8	0	0
7	18413798	.	G	A	2	2	4	0	0	4	0	0
7	18414120	.	C	T	0	4	4	0	0	4	0	0
7	18414124	.	C	T	2	3	5	0	0	5	0	0
7	18414504	.	T	C	2	0	2	0	1	3	0	0
7	18415009	.	A	T	4	5	9	0	0	9	0	0
7	18415530	.	C	T	1	2	3	0	0	3	0	0
7	18415653	.	G	A	3	2	5	0	0	5	0	0
7	18415905	.	C	T	4	2	6	0	1	7	0	0
7	18416769	.	C	T	0	3	3	0	4	7	0	0
7	18416779	.	A	T	5	3	8	0	0	8	0	0
7	18416804	.	C	A	3	4	7	0	0	7	0	0
7	18416830	.	G	A	3	3	6	0	0	6	0	0
7	18462466	.	T	C	2	1	3	0	1	4	0	0
7	18462473	.	A	G	3	2	5	0	1	6	0	0
7	18462543	.	C	G	2	2	4	0	0	4	0	0
7	18462733	.	G	A	9	3	12	0	0	12	0	0
7	18463132	.	T	A	7	4	11	0	0	11	0	0
7	18463259	.	T	C	3	2	5	0	0	5	0	0
7	18463488	.	A	T	7	7	14	0	0	14	0	0
7	18463589	.	A	T	4	4	8	0	0	8	0	0
7	18464308	.	G	T	3	4	7	0	0	7	0	0
7	18464352	.	G	A	1	4	5	0	0	5	0	0
7	18464593	.	A	T	5	2	7	0	0	7	0	0
7	18464618	.	C	G	0	2	2	0	4	6	0	0
7	18464919	.	C	T	2	7	9	0	0	9	0	0
7	18465000	.	G	A	11	5	16	0	0	16	0	0
7	18465096	.	A	G	8	5	13	0	0	13	0	0
7	18465435	.	T	G	8	8	16	0	0	16	0	0
7	18470277	.	G	A	4	3	7	0	0	7	0	0
7	18470294	.	G	T	3	4	7	0	2	9	0	0
7	18470314	.	C	T	6	4	10	0	0	10	0	0
7	18470573	.	C	A	8	3	11	0	0	11	0	0
7	18470813	.	C	A	10	7	17	0	0	17	0	0
7	18474994	.	C	T	3	2	5	0	0	5	0	0
7	18475150	.	C	G	3	3	6	0	0	6	0	0
7	18500580	.	A	T	1	2	3	0	0	3	0	0
7	18550499	.	C	T	2	2	4	0	1	5	0	0
7	18550622	.	G	A	1	3	4	0	0	4	0	0
7	18558504	.	C	T	9	5	14	0	2	16	0	0
7	18558586	.	T	C	1	0	1	0	3	4	0	0
7	18558806	.	A	T	10	17	27	0	0	27	0	0
7	18558871	.	G	A	11	11	22	0	0	22	0	0
7	18558906	.	T	G	8	12	20	0	1	21	0	0
7	18559197	.	G	T	5	7	12	0	0	12	0	0
7	18559212	.	C	A	6	8	14	0	0	14	0	0
7	18559258	.	A	G	7	11	18	0	1	19	0	0
7	18559402	.	G	T	2	5	7	0	3	10	0	0
7	18559416	.	T	C	7	2	9	0	2	11	0	0
7	18560013	.	C	A	4	11	15	0	3	18	0	0
7	18560047	.	G	A	5	9	14	0	0	14	0	0
7	18560397	.	C	T	1	5	6	0	8	14	0	0
7	18560474	.	C	T	0	5	5	0	9	14	0	0
7	18560478	.	T	A	9	8	17	0	1	18	0	0
7	18560952	.	C	T	0	11	11	0	10	21	0	0
7	18564318	.	G	A	9	5	14	0	0	14	0	0
7	18594368	.	T	G	6	3	9	0	15	24	0	0
7	18594557	.	T	C	9	0	9	0	9	18	0	0
7	18598610	.	C	T	5	8	13	0	3	16	0	0
7	18607620	.	A	T	2	2	4	0	1	5	0	0
7	18607732	.	C	T	1	5	6	0	0	6	0	0
7	18607790	.	A	G	4	5	9	0	0	9	0	0
7	18607852	.	T	A	2	6	8	0	2	10	0	0
7	18607928	.	A	T	3	9	12	0	0	12	0	0
7	18607932	.	A	G	3	8	11	0	1	12	0	0
7	18608190	.	A	G	2	8	10	0	0	10	0	0
7	18608221	.	C	G	2	6	8	0	0	8	0	0
7	18609192	.	C	T	2	3	5	0	1	6	0	0
7	18609253	.	G	T	2	2	4	0	0	4	0	0
7	18609411	.	T	C	5	2	7	0	0	7	0	0
7	18618113	.	T	A	9	6	15	1	0	16	0	0
7	18618608	.	T	A	2	4	6	0	0	6	0	0
7	18618776	.	T	C	7	7	14	0	1	15	0	0
7	18618859	.	A	G	7	2	9	0	0	9	0	0
7	18618860	.	T	C	6	0	6	0	6	12	0	0
7	18618927	.	T	C	14	9	23	0	0	23	0	0
7	18619067	.	A	G	4	2	6	0	1	7	0	0
7	18619661	.	G	A	8	8	16	0	1	17	0	0
7	18620049	.	A	C	4	5	9	0	1	10	0	0
7	18620223	.	C	T	1	9	10	0	11	21	0	0
7	18620273	.	T	C	6	8	14	0	0	14	0	0
7	18620481	.	C	A	6	3	9	0	0	9	0	0
7	18645360	.	G	A	3	5	8	0	2	10	0	0
7	18650823	.	C	G	1	5	6	0	0	6	0	0
7	18655772	.	A	C	1	4	5	0	0	5	0	0
7	18655798	.	T	G	1	6	7	0	0	7	0	0
7	18655921	.	G	A	4	3	7	0	0	7	0	0
7	18655949	.	T	G	6	2	8	0	1	9	0	0
7	18656025	.	G	A	2	6	8	0	0	8	0	0
7	18705665	.	G	A	2	4	6	0	0	6	0	0
7	18711374	.	G	C	5	3	8	0	0	8	0	0
7	18711378	.	G	C	6	3	9	0	0	9	0	0
7	18780119	.	A	G	3	5	8	0	0	8	0	0
7	18780196	.	A	G	4	3	7	0	0	7	0	0
7	18810675	.	A	G	6	6	12	0	0	12	0	0
7	18810692	.	T	C	6	5	11	0	1	12	0	0
7	18810710	.	C	T	8	5	13	0	0	13	0	0
7	18810768	.	C	A	2	2	4	0	4	8	0	0
7	18810926	.	T	C	3	5	8	0	0	8	0	0
7	18810971	.	C	T	0	4	4	0	4	8	0	0
7	18810990	.	C	A	3	5	8	0	0	8	0	0
7	18811128	.	A	G	8	8	16	0	0	16	0	0
7	18876417	.	A	C	6	2	8	0	0	8	0	0
7	18876519	.	G	A	8	5	13	0	1	14	0	0
7	18960057	.	G	C	3	2	5	0	0	5	0	0
7	18970714	.	A	G	2	4	6	0	0	6	0	0
7	18971066	.	G	T	2	1	3	0	1	4	0	0
7	18971068	.	C	A	2	2	4	0	0	4	0	0
7	18980787	.	G	T	1	2	3	0	0	3	0	0
7	18980857	.	T	C	1	2	3	0	0	3	0	0
7	18983230	.	G	A	1	2	3	0	3	6	0	0
7	19028850	.	G	A	9	8	17	0	2	19	0	0
7	19028857	.	A	T	10	8	18	0	1	19	0	0
7	19033969	.	A	G	1	2	3	0	0	3	0	0
7	19043366	.	C	A	2	5	7	0	0	7	0	0
7	19055605	.	C	T	11	21	32	0	0	32	0	0
7	19065861	.	A	G	17	15	32	0	1	33	0	0
7	19070994	.	C	T	0	13	13	0	19	32	0	0
7	19071420	.	T	C	10	0	10	0	12	22	0	0
7	19071639	.	C	A	12	6	18	0	3	21	0	0
7	19072665	.	T	C	13	4	17	0	1	18	0	0
7	19072767	.	T	A	3	7	10	0	0	10	0	0
7	19072853	.	G	A	3	7	10	0	0	10	0	0
7	19073105	.	T	C	4	7	11	0	0	11	0	0
7	19073202	.	T	C	4	0	4	0	3	7	0	0
7	19073481	.	T	C	8	16	24	0	1	25	0	0
7	19073495	.	G	A	6	17	23	0	0	23	0	0
7	19073576	.	T	A	13	4	17	0	0	17	0	0
7	19073788	.	T	C	4	10	14	0	1	15	0	0
7	19073818	.	T	C	1	8	9	0	1	10	0	0
7	19073833	.	G	A	4	2	6	0	4	10	0	0
7	19073918	.	G	A	8	5	13	0	0	13	0	0
7	19073984	.	G	A	1	2	3	0	0	3	0	0
7	19073985	.	C	T	1	2	3	0	0	3	0	0
7	19074041	.	G	A	8	1	9	0	1	10	0	0
7	19074056	.	T	C	9	3	12	0	4	16	0	0
7	19074173	.	C	T	8	17	25	0	3	28	0	0
7	19074194	.	A	T	10	13	23	0	2	25	0	0
7	19074270	.	G	A	12	9	21	0	0	21	0	0
7	19074363	.	T	C	10	8	18	0	0	18	0	0
7	19074666	.	C	G	1	2	3	0	0	3	0	0
7	19075025	.	C	T	1	4	5	0	11	16	0	0
7	19075058	.	T	C	13	1	14	0	5	19	0	0
7	19075591	.	T	C	5	5	10	0	0	10	0	0
7	19075605	.	A	C	5	6	11	0	1	12	0	0
7	19075760	.	A	G	3	3	6	0	1	7	0	0
7	19075849	.	G	A	3	2	5	0	0	5	0	0
7	19076154	.	A	G	3	9	12	0	1	13	0	0
7	19076219	.	C	T	5	5	10	0	0	10	0	0
7	19076536	.	A	G	7	2	9	0	1	10	0	0
7	19076759	.	C	A	6	6	12	0	1	13	0	0
7	19077092	.	G	A	6	7	13	0	1	14	0	0
7	19083600	.	G	A	12	3	15	0	0	15	0	0
7	19095988	.	C	A	0	5	5	0	6	11	0	0
7	19099986	.	G	A	4	4	8	0	0	8	0	0
7	19101929	.	C	T	0	3	3	0	3	6	0	0
7	19179977	.	C	T	0	3	3	0	1	4	0	0
7	19180152	.	T	A	4	2	6	0	0	6	0	0
7	19180589	.	C	T	3	6	9	0	1	10	0	0
7	19753008	.	C	A	9	9	18	0	1	19	0	0
7	19753702	.	C	T	8	8	16	0	2	18	0	0
7	19759079	.	G	T	11	10	21	0	0	21	0	0
7	19759194	.	C	A	12	11	23	0	1	24	0	0
7	19759209	.	G	A	0	12	12	0	11	23	0	0
7	19759263	.	T	A	13	5	18	0	1	19	0	0
7	19759296	.	C	T	12	5	17	0	0	17	0	0
7	19759299	.	A	T	9	5	14	0	1	15	0	0
7	19759550	.	C	T	9	7	16	0	0	16	0	0
7	19759895	.	C	T	5	4	9	0	0	9	0	0
7	19759962	.	C	T	4	4	8	0	0	8	0	0
7	19759968	.	A	T	4	4	8	0	0	8	0	0
7	19857890	.	G	C	2	1	3	0	0	3	0	0
7	19857910	.	C	T	0	4	4	0	0	4	0	0
7	19860967	.	T	C	4	3	7	0	0	7	0	0
7	19891283	.	A	G	1	3	4	0	1	5	0	0
7	19891365	.	A	G	2	0	2	0	5	7	0	0
7	19891779	.	G	C	4	4	8	0	0	8	0	0
7	19892265	.	C	T	5	2	7	0	1	8	0	0
7	19892592	.	A	G	6	0	6	0	6	12	0	0
7	19892880	.	G	A	0	8	8	0	5	13	0	0
7	19893023	.	A	G	2	4	6	0	1	7	0	0
7	19893149	.	T	G	9	6	15	0	0	15	0	0
7	19893463	.	A	G	5	2	7	0	1	8	0	0
7	19893573	.	T	A	5	4	9	0	1	10	0	0
7	19893623	.	A	C	1	1	2	0	0	2	0	0
7	19893627	.	G	A	0	2	2	0	0	2	0	0
7	19893705	.	A	T	4	7	11	0	0	11	0	0
7	19894016	.	A	G	4	2	6	0	0	6	0	0
7	19894099	.	A	G	5	0	5	0	4	9	0	0
7	19894114	.	G	A	0	4	4	0	4	8	0	0
7	19894322	.	T	G	4	2	6	0	0	6	0	0
7	19894406	.	T	C	1	2	3	0	0	3	0	0
7	19895088	.	G	A	1	5	6	0	8	14	0	0
7	19895447	.	G	A	2	3	5	0	1	6	0	0
7	19895506	.	G	A	1	4	5	0	1	6	0	0
7	19895683	.	C	T	3	5	8	0	1	9	0	0
7	19895919	.	C	G	4	3	7	0	0	7	0	0
7	19896060	.	A	G	9	5	14	0	0	14	0	0
7	19896187	.	A	G	2	5	7	0	0	7	0	0
7	19896221	.	G	C	2	5	7	0	0	7	0	0
7	19896400	.	A	C	5	4	9	0	0	9	0	0
7	19897309	.	C	T	11	10	21	0	0	21	0	0
7	19897959	.	T	C	7	9	16	0	0	16	0	0
7	19899331	.	A	G	5	0	5	0	6	11	0	0
7	19909988	.	C	T	3	2	5	0	1	6	0	0
7	19909995	.	C	T	3	2	5	0	1	6	0	0
7	19910438	.	A	T	4	5	9	0	0	9	0	0
7	19910628	.	G	T	2	2	4	0	0	4	0	0
7	19910629	.	G	T	2	2	4	0	0	4	0	0
7	19910931	.	G	A	1	3	4	0	0	4	0	0
7	19965281	.	G	A	3	4	7	0	2	9	0	0
7	19965721	.	T	A	6	4	10	0	0	10	0	0
7	19966252	.	G	A	6	4	10	0	0	10	0	0
7	19966273	.	T	G	8	5	13	0	0	13	0	0
7	19978616	.	G	A	2	4	6	0	0	6	0	0
7	19978847	.	G	A	3	2	5	0	0	5	0	0
7	19978875	.	T	A	1	2	3	0	0	3	0	0
7	19979028	.	C	T	6	3	9	0	0	9	0	0
7	19979133	.	C	T	5	5	10	0	0	10	0	0
7	19979200	.	A	G	5	8	13	0	0	13	0	0
7	19979561	.	C	T	0	4	4	0	3	7	0	0
7	19979575	.	G	T	4	3	7	0	0	7	0	0
7	19979669	.	G	A	2	4	6	0	0	6	0	0
7	19979876	.	A	C	3	0	3	0	6	9	0	0
7	19979943	.	A	T	7	3	10	0	0	10	0	0
7	19979968	.	C	A	2	3	5	0	7	12	0	0
7	19984249	.	A	G	6	2	8	0	0	8	0	0
7	19986080	.	A	T	2	2	4	0	0	4	0	0
7	19988581	.	G	A	12	10	22	0	2	24	0	0
7	19991770	.	T	C	4	1	5	0	5	10	0	0
7	19991783	.	G	T	5	6	11	0	0	11	0	0
7	19998621	.	A	G	7	5	12	0	0	12	0	0
7	20024319	.	G	A	1	5	6	0	0	6	0	0
7	20027595	.	A	T	2	4	6	0	0	6	0	0
7	20027717	.	G	A	5	6	11	0	0	11	0	0
7	20027943	.	T	C	0	2	2	0	1	3	0	0
7	20028007	.	T	C	3	2	5	0	0	5	0	0
7	20028011	.	G	A	2	3	5	0	0	5	0	0
7	20046081	.	C	T	2	2	4	0	0	4	0	0
7	20046096	.	C	T	1	2	3	0	1	4	0	0
7	20052769	.	C	T	0	2	2	0	1	3	0	0
7	20054381	.	C	T	2	3	5	0	0	5	0	0
7	20069772	.	T	G	2	4	6	0	0	6	0	0
7	20069806	.	G	A	1	3	4	0	0	4	0	0
7	20118228	.	C	G	13	12	25	0	0	25	0	0
7	20118330	.	T	C	12	15	27	0	1	28	0	0
7	20141697	.	T	C	14	15	29	0	1	30	0	0
7	20141823	.	A	G	8	10	18	1	1	20	0	0
7	20141916	.	T	C	10	10	20	0	1	21	0	0
7	20142253	.	A	T	1	2	3	0	0	3	0	0
7	20142360	.	A	G	1	3	4	0	0	4	0	0
7	20142361	.	A	T	1	3	4	0	0	4	0	0
7	20142497	.	T	A	6	5	11	0	0	11	0	0
7	20142523	.	T	C	2	3	5	0	1	6	0	0
7	20176444	.	A	T	5	5	10	0	0	10	0	0
7	20222385	.	A	G	5	6	11	0	0	11	0	0
7	20222702	.	A	C	1	2	3	0	0	3	0	0
7	20222861	.	C	G	1	2	3	0	0	3	0	0
7	20222949	.	A	C	1	6	7	0	0	7	0	0
7	20222993	.	A	T	2	3	5	0	0	5	0	0
7	20223074	.	G	A	7	3	10	0	0	10	0	0
7	20223079	.	A	G	8	2	10	0	1	11	0	0
7	20223110	.	G	A	7	3	10	0	0	10	0	0
7	20223208	.	G	C	2	4	6	0	0	6	0	0
7	20223384	.	A	C	7	3	10	0	2	12	0	0
7	20223385	.	C	T	9	3	12	0	0	12	0	0
7	20223478	.	T	A	10	8	18	0	0	18	0	0
7	20223568	.	C	T	6	9	15	0	0	15	0	0
7	20223632	.	C	T	6	3	9	0	1	10	0	0
7	20240392	.	T	C	1	2	3	0	0	3	0	0
7	20292791	.	C	T	3	2	5	0	0	5	0	0
7	20293994	.	T	C	1	3	4	0	0	4	0	0
7	20294433	.	C	T	3	3	6	0	0	6	0	0
7	20294466	.	A	G	1	2	3	0	0	3	0	0
7	20294471	.	T	C	2	2	4	0	0	4	0	0
7	20298563	.	A	T	2	5	7	0	0	7	0	0
7	20298577	.	A	G	1	4	5	0	1	6	0	0
7	20298598	.	A	T	3	4	7	0	0	7	0	0
7	20298670	.	T	C	6	2	8	0	0	8	0	0
7	20298789	.	C	G	5	11	16	0	1	17	0	0
7	20301839	.	C	T	8	12	20	0	0	20	0	0
7	20302952	.	A	G	13	8	21	0	1	22	0	0
7	20305694	.	C	T	6	10	16	0	0	16	0	0
7	20305697	.	C	T	6	10	16	0	0	16	0	0
7	20310893	.	T	C	16	11	27	0	0	27	0	0
7	20310929	.	T	C	11	8	19	0	1	20	0	0
7	20315913	.	G	A	14	10	24	0	1	25	0	0
7	20325995	.	C	T	14	6	20	0	1	21	0	0
7	20326405	.	T	C	7	8	15	0	0	15	0	0
7	20332513	.	T	C	13	10	23	0	2	25	0	0
7	20332775	.	A	T	12	8	20	0	0	20	0	0
7	20332784	.	G	A	14	9	23	0	0	23	0	0
7	20332959	.	G	A	16	11	27	0	0	27	0	0
7	20332963	.	G	A	15	12	27	0	0	27	0	0
7	20333061	.	A	G	13	0	13	0	9	22	0	0
7	20333076	.	C	A	11	8	19	0	0	19	0	0
7	20333120	.	A	C	6	10	16	0	0	16	0	0
7	20333276	.	T	G	3	10	13	0	0	13	0	0
7	20334603	.	T	C	7	5	12	0	1	13	0	0
7	20335283	.	T	C	1	1	2	0	1	3	0	0
7	20335323	.	G	A	1	2	3	0	2	5	0	0
7	20335331	.	A	G	4	2	6	0	0	6	0	0
7	20529043	.	A	C	8	6	14	0	0	14	0	0
7	20529155	.	A	G	6	9	15	0	0	15	0	0
7	20529578	.	A	C	5	6	11	0	0	11	0	0
7	20529725	.	C	T	18	8	26	0	4	30	0	0
7	20529728	.	G	A	20	9	29	0	0	29	0	0
7	20529760	.	C	T	15	13	28	0	2	30	0	0
7	20529773	.	T	C	14	12	26	0	0	26	0	0
7	20530284	.	A	T	10	5	15	0	1	16	0	0
7	20530314	.	G	A	5	8	13	0	0	13	0	0
7	20530338	.	C	T	5	4	9	0	1	10	0	0
7	20530373	.	T	A	6	3	9	0	1	10	0	0
7	20537117	.	A	G	2	2	4	0	0	4	0	0
7	20537118	.	T	C	2	2	4	0	0	4	0	0
7	20542251	.	G	A	11	5	16	0	3	19	0	0
7	20542262	.	C	A	9	6	15	0	1	16	0	0
7	20587681	.	G	T	8	7	15	2	0	17	0	0
7	20587685	.	T	G	9	8	17	2	0	19	0	0
7	20587812	.	T	C	6	9	15	0	3	18	0	0
7	20588229	.	G	A	6	8	14	0	2	16	0	0
7	20588280	.	C	G	6	10	16	0	2	19	1	0
7	20593682	.	G	A	0	7	7	0	8	15	0	0
7	20593809	.	G	A	13	5	18	0	5	23	0	0
7	20597033	.	G	A	6	9	15	0	0	15	0	0
7	20597132	.	C	T	9	4	13	0	1	14	0	0
7	20600211	.	T	A	7	7	14	0	0	14	0	0
7	20600398	.	C	T	12	3	15	0	0	15	0	0
7	20600447	.	A	G	6	0	6	0	6	12	0	0
7	20601052	.	G	A	5	12	17	0	0	17	0	0
7	20601072	.	T	C	5	10	15	0	0	15	0	0
7	20601192	.	C	T	8	6	14	0	1	15	0	0
7	20601250	.	A	G	9	8	17	0	0	17	0	0
7	20601325	.	A	G	10	10	20	0	0	20	0	0
7	20601410	.	T	A	3	8	11	0	0	11	0	0
7	20601524	.	G	A	7	4	11	0	0	11	0	0
7	20601539	.	T	C	9	6	15	0	1	16	0	0
7	20601578	.	T	C	7	6	13	0	0	13	0	0
7	20601583	.	T	C	8	6	14	0	0	14	0	0
7	20601713	.	A	T	8	7	15	0	0	15	0	0
7	20601835	.	G	T	10	9	19	0	0	19	0	0
7	20601907	.	A	T	7	12	19	0	0	19	0	0
7	20601925	.	T	C	9	10	19	0	1	20	0	0
7	20602053	.	T	C	7	7	14	0	2	16	0	0
7	20602205	.	A	G	1	5	6	0	1	7	0	0
7	20605661	.	A	G	7	7	14	0	0	14	0	0
7	20629684	.	T	C	2	7	9	0	0	9	0	0
7	20629792	.	G	A	3	11	14	0	1	15	0	0
7	20629801	.	A	G	4	11	15	0	0	16	1	0
7	20633683	.	A	C	4	7	11	0	0	11	0	0
7	20633686	.	T	A	3	7	10	0	0	10	0	0
7	20634045	.	A	G	4	0	4	4	6	14	0	0
7	20634202	.	C	G	4	7	11	0	0	11	0	0
7	20634444	.	A	T	5	7	12	0	1	13	0	0
7	20634498	.	T	A	9	19	28	0	0	28	0	0
7	20634577	.	T	G	10	20	30	0	1	31	0	0
7	20635475	.	A	G	6	19	25	0	2	27	0	0
7	20635495	.	T	A	7	11	18	0	0	18	0	0
7	20635519	.	A	G	10	7	17	0	0	17	0	0
7	20635616	.	T	C	4	10	14	0	1	15	0	0
7	20635760	.	A	G	2	8	10	0	0	10	0	0
7	20635864	.	G	T	1	4	5	0	0	5	0	0
7	20636168	.	C	A	3	2	5	0	0	5	0	0
7	20636344	.	A	G	6	13	19	0	2	21	0	0
7	20636379	.	A	T	8	13	21	0	4	25	0	0
7	20636410	.	C	T	9	13	22	0	0	22	0	0
7	20636414	.	T	G	10	14	24	0	1	25	0	0
7	20636464	.	G	A	10	13	23	0	0	23	0	0
7	20636465	.	A	G	10	12	22	0	1	23	0	0
7	20636802	.	T	G	4	11	15	0	0	15	0	0
7	20636833	.	A	G	5	12	17	0	0	17	0	0
7	20636844	.	T	A	6	14	20	0	2	22	0	0
7	20657314	.	T	C	2	4	6	0	0	6	0	0
7	20664794	.	T	C	6	3	9	0	1	10	0	0
7	20693673	.	G	T	19	23	42	0	2	44	0	0
7	20695949	.	G	T	24	19	43	0	1	44	0	0
7	20698208	.	T	A	17	15	32	0	0	32	0	0
7	20712555	.	C	T	15	7	22	0	2	24	0	0
7	20715178	.	G	A	18	13	31	0	2	33	0	0
7	20715434	.	C	T	15	6	21	0	0	21	0	0
7	20715485	.	A	G	11	6	17	0	0	17	0	0
7	20731052	.	C	T	11	15	26	0	0	26	0	0
7	20731166	.	A	G	8	14	22	0	1	23	0	0
7	20735155	.	G	A	5	5	10	0	1	11	0	0
7	20738148	.	A	G	14	9	23	0	1	24	0	0
7	20743583	.	G	A	9	6	15	0	0	15	0	0
7	20743984	.	C	T	0	7	7	0	12	19	0	0
7	20748622	.	A	G	6	7	13	0	2	15	0	0
7	20754669	.	G	A	10	7	17	0	0	17	0	0
7	20780285	.	G	A	6	3	9	0	1	10	0	0
7	20780317	.	C	T	7	4	11	0	0	11	0	0
7	20780337	.	A	C	5	5	10	0	0	10	0	0
7	20780356	.	A	G	5	4	9	0	1	10	0	0
7	20780424	.	A	T	6	10	16	0	0	16	0	0
7	20780453	.	C	A	5	9	14	0	0	14	0	0
7	20780500	.	A	C	4	0	4	0	3	7	0	0
7	20780732	.	A	C	6	6	12	0	1	13	0	0
7	20780758	.	T	C	10	6	16	0	0	16	0	0
7	20780797	.	T	C	14	5	19	0	0	19	0	0
7	20780918	.	C	T	0	10	10	0	13	23	0	0
7	20780987	.	G	A	8	8	16	0	0	16	0	0
7	20781110	.	C	T	4	13	17	0	0	17	0	0
7	20781253	.	T	C	12	5	17	0	0	17	0	0
7	20781327	.	A	G	5	5	10	0	1	11	0	0
7	20781549	.	C	G	5	6	11	0	1	12	0	0
7	20781592	.	T	C	4	3	7	0	0	7	0	0
7	20781593	.	T	C	2	4	6	0	1	7	0	0
7	20784496	.	C	T	8	6	14	0	0	14	0	0
7	20787233	.	C	T	5	6	11	0	0	11	0	0
7	20789958	.	T	C	3	6	9	0	0	9	0	0
7	20790042	.	G	A	1	4	5	0	0	5	0	0
7	20790796	.	A	G	6	6	12	0	0	12	0	0
7	20796929	.	T	C	8	6	14	0	0	14	0	0
7	20859843	.	T	G	6	3	9	0	0	9	0	0
7	20859975	.	G	A	11	7	18	0	0	18	0	0
7	20860011	.	T	C	18	9	27	0	0	27	0	0
7	20864097	.	A	G	8	14	22	0	0	22	0	0
7	20864256	.	T	C	9	8	17	0	4	21	0	0
7	20889840	.	C	A	4	8	12	0	0	13	1	0
7	20890420	.	T	C	7	7	14	0	0	14	0	0
7	20890435	.	C	T	8	7	15	0	0	15	0	0
7	20890715	.	G	A	5	2	7	0	0	7	0	0
7	20890718	.	G	A	6	2	8	0	0	8	0	0
7	20892307	.	A	T	6	7	13	0	2	15	0	0
7	20894701	.	G	A	0	6	6	0	6	12	0	0
7	20897911	.	G	A	7	5	12	0	2	14	0	0
7	20905507	.	C	T	1	3	4	0	0	4	0	0
7	20923330	.	A	G	3	2	5	0	0	5	0	0
7	20924115	.	C	T	2	5	7	0	0	7	0	0
7	20935058	.	T	C	1	4	5	0	1	6	0	0
7	20935547	.	G	A	4	5	9	0	0	9	0	0
7	20935684	.	C	T	2	7	9	0	0	9	0	0
7	20935737	.	T	A	2	7	9	0	0	9	0	0
7	20935765	.	A	G	6	3	9	0	1	10	0	0
7	20938812	.	C	T	1	3	4	0	2	6	0	0
7	20938928	.	C	T	2	5	7	0	0	7	0	0
7	20966203	.	A	C	4	3	7	0	1	8	0	0
7	20966369	.	G	A	6	2	8	0	0	8	0	0
7	20966508	.	G	T	0	2	2	0	3	5	0	0
7	21752348	.	C	A	5	3	8	0	0	8	0	0
7	21752758	.	A	G	4	2	6	0	0	6	0	0
7	21765244	.	G	A	5	6	11	0	0	11	0	0
7	21765562	.	C	A	11	7	18	0	1	19	0	0
7	21765702	.	T	A	8	10	18	0	4	22	0	0
7	21766917	.	G	A	10	14	24	0	1	25	0	0
7	21766937	.	C	A	10	15	25	0	0	25	0	0
7	21767423	.	A	G	15	16	31	0	2	33	0	0
7	21768002	.	T	C	15	10	25	0	1	26	0	0
7	21768060	.	A	G	9	9	18	0	0	18	0	0
7	21768270	.	G	A	6	13	19	0	1	20	0	0
7	21768334	.	C	A	16	10	26	0	0	26	0	0
7	21768540	.	T	A	11	7	18	0	1	19	0	0
7	21769286	.	T	G	6	10	16	0	0	16	0	0
7	21769318	.	A	G	7	7	14	0	0	14	0	0
7	21769733	.	G	A	10	7	17	0	1	18	0	0
7	21770141	.	A	G	8	0	8	0	4	12	0	0
7	21770567	.	C	T	11	12	23	0	0	23	0	0
7	21770819	.	G	T	0	5	5	0	12	17	0	0
7	21772869	.	A	T	12	9	21	0	2	23	0	0
7	21773542	.	C	T	17	10	27	0	0	27	0	0
7	21773626	.	C	T	14	11	25	0	1	26	0	0
7	21774127	.	G	A	17	10	27	0	1	28	0	0
7	21776426	.	C	T	20	9	29	0	5	34	0	0
7	21776683	.	G	A	17	9	26	0	0	26	0	0
7	21776693	.	T	C	16	6	22	0	1	23	0	0
7	21777110	.	G	A	16	12	28	0	1	29	0	0
7	21777111	.	C	T	15	12	27	0	2	29	0	0
7	21777203	.	G	T	12	10	22	0	0	22	0	0
7	21777720	.	G	A	21	13	34	0	1	35	0	0
7	21777978	.	T	G	12	16	28	0	3	31	0	0
7	21778055	.	G	A	9	11	20	0	1	21	0	0
7	21778070	.	T	C	9	11	20	0	0	20	0	0
7	21778131	.	T	A	3	5	8	0	0	9	1	0
7	21859402	.	C	T	4	3	7	0	0	7	0	0
7	21859485	.	A	T	1	3	4	0	0	4	0	0
7	21872185	.	G	T	7	7	14	0	0	14	0	0
7	21872364	.	G	A	0	4	4	0	3	7	0	0
7	21872759	.	T	A	3	6	9	0	1	10	0	0
7	21872969	.	G	C	5	3	8	0	0	8	0	0
7	21873246	.	C	G	6	5	11	0	2	13	0	0
7	21873266	.	G	A	1	3	4	0	6	10	0	0
7	21873342	.	A	C	4	2	6	0	0	6	0	0
7	21873350	.	G	A	2	4	6	0	0	6	0	0
7	21873388	.	T	A	2	1	3	0	1	4	0	0
7	21873878	.	T	G	3	1	4	0	1	5	0	0
7	21873885	.	T	A	3	2	5	0	0	5	0	0
7	21874075	.	T	C	2	7	9	0	0	9	0	0
7	21874092	.	A	G	2	0	2	0	8	10	0	0
7	21874117	.	G	A	3	6	9	0	1	10	0	0
7	21878507	.	G	A	5	2	7	0	0	7	0	0
7	21879728	.	A	G	2	5	7	0	0	7	0	0
7	21884138	.	C	A	0	3	3	0	2	5	0	0
7	21884493	.	G	A	3	2	5	0	1	6	0	0
7	21884570	.	A	C	1	0	1	0	8	9	0	0
7	21887797	.	A	T	24	17	41	0	0	41	0	0
7	21887967	.	C	T	22	19	41	0	0	41	0	0
7	21888084	.	T	A	19	16	35	0	4	39	0	0
7	21888274	.	T	A	11	12	23	0	1	24	0	0
7	21890998	.	C	T	8	3	11	0	0	11	0	0
7	21891208	.	C	T	6	12	18	0	0	18	0	0
7	21917927	.	C	A	4	4	8	0	0	8	0	0
7	21918235	.	G	A	2	2	4	0	0	4	0	0
7	21940965	.	T	G	9	11	20	0	2	22	0	0
7	21940992	.	A	G	11	13	24	0	1	25	0	0
7	21941016	.	T	G	20	17	37	0	0	37	0	0
7	21941460	.	G	A	11	9	20	0	0	20	0	0
7	21941477	.	C	A	9	10	19	0	1	20	0	0
7	21941568	.	C	T	10	11	21	0	1	22	0	0
7	21941579	.	A	C	11	9	20	0	0	20	0	0
7	21942513	.	A	T	11	10	21	0	0	21	0	0
7	21942644	.	T	A	15	17	32	0	1	33	0	0
7	21942672	.	C	T	12	17	29	0	2	31	0	0
7	21943553	.	A	G	10	17	27	0	1	28	0	0
7	21943625	.	G	A	14	9	23	0	0	23	0	0
7	21943716	.	T	G	10	13	23	0	0	23	0	0
7	21943772	.	T	C	14	7	21	0	1	22	0	0
7	21943886	.	C	A	3	5	8	0	1	9	0	0
7	21944495	.	T	C	12	10	22	0	0	22	0	0
7	21944753	.	G	A	9	14	23	0	2	25	0	0
7	21945257	.	C	T	0	14	14	0	9	23	0	0
7	21945347	.	C	T	0	13	13	0	21	34	0	0
7	21947228	.	G	A	7	10	17	0	1	18	0	0
7	21947237	.	C	T	9	6	15	0	3	18	0	0
7	21951353	.	G	A	10	12	22	0	0	22	0	0
7	21956571	.	A	G	4	9	13	0	0	13	0	0
7	22131815	.	C	T	1	11	12	0	7	19	0	0
7	22132134	.	A	G	5	11	16	0	1	17	0	0
7	23752701	.	G	A	5	2	7	0	2	9	0	0
7	23907703	.	T	G	1	0	1	0	3	4	0	0
7	23907784	.	G	T	21	31	52	0	0	52	0	0
7	23909369	.	A	C	21	30	51	0	2	53	0	0
7	23909456	.	T	G	25	24	49	0	3	52	0	0
7	23915104	.	G	A	4	22	26	2	38	66	0	0
7	23915296	.	C	T	27	34	61	0	7	68	0	0
7	23915359	.	G	A	4	30	34	0	25	59	0	0
7	23915379	.	T	A	35	22	57	0	3	61	1	0
7	23915700	.	G	T	20	18	38	0	1	39	0	0
7	23915731	.	G	T	19	23	42	0	0	42	0	0
7	23915926	.	C	T	29	30	59	0	3	62	0	0
7	23915963	.	A	G	34	0	34	0	22	56	0	0
7	23915964	.	A	T	34	21	55	0	0	55	0	0
7	23967515	.	A	C	9	1	10	0	10	21	1	0
7	23967522	.	G	A	8	11	19	0	0	19	0	0
7	23967591	.	G	A	3	11	14	0	1	15	0	0
7	23967596	.	G	A	3	11	14	0	1	15	0	0
7	23967705	.	G	A	5	8	13	0	1	14	0	0
7	23967772	.	A	G	10	14	24	0	1	25	0	0
7	23967861	.	C	T	4	24	28	0	17	45	0	0
7	23967878	.	G	A	23	17	40	0	0	40	0	0
7	23967930	.	A	G	23	13	36	0	0	36	0	0
7	23968009	.	T	C	16	0	16	0	20	36	0	0
7	23968174	.	A	C	9	11	20	1	0	21	0	0
7	23968267	.	A	C	6	7	13	0	0	13	0	0
7	23968292	.	T	G	8	8	16	0	0	16	0	0
7	23968414	.	A	C	3	3	6	0	0	6	0	0
7	23969226	.	G	A	3	4	7	0	0	7	0	0
7	23969446	.	C	T	11	6	17	0	2	19	0	0
7	23969593	.	G	A	9	10	19	2	0	21	0	0
7	23969819	.	A	G	2	4	6	5	0	11	0	0
7	23970196	.	A	G	7	11	18	0	3	21	0	0
7	23970236	.	T	A	8	14	22	0	3	25	0	0
7	23970320	.	G	T	16	13	29	0	0	29	0	0
7	23970331	.	G	A	16	10	26	0	2	28	0	0
7	23970428	.	T	C	7	16	23	0	2	25	0	0
7	23970674	.	T	A	7	4	11	0	0	11	0	0
7	23970695	.	T	C	8	5	13	0	3	16	0	0
7	23971181	.	G	C	3	5	8	0	0	8	0	0
7	23971312	.	A	G	8	4	12	0	0	12	0	0
7	23971682	.	T	A	12	3	15	0	1	16	0	0
7	23971714	.	G	C	8	7	15	0	0	15	0	0
7	23971728	.	T	A	7	9	16	0	0	16	0	0
7	23977711	.	T	C	6	6	12	0	0	12	0	0
7	23977905	.	A	C	3	4	7	0	1	8	0	0
7	23984264	.	C	T	6	4	10	0	0	10	0	0
7	24006992	.	A	T	1	2	3	0	0	3	0	0
7	24007222	.	T	C	2	3	5	0	1	6	0	0
7	24007347	.	G	A	0	2	2	0	3	5	0	0
7	24007373	.	A	G	4	2	6	0	0	6	0	0
7	24011474	.	C	A	5	4	9	0	0	9	0	0
7	24011926	.	T	C	10	9	19	0	0	19	0	0
7	24012794	.	T	C	12	6	18	0	0	18	0	0
7	24013269	.	G	A	3	4	7	0	0	7	0	0
7	24013489	.	G	A	0	5	5	0	6	11	0	0
7	24030398	.	G	C	6	2	8	0	0	8	0	0
7	24036340	.	G	A	3	4	7	0	0	7	0	0
7	24041627	.	T	C	1	0	1	0	6	7	0	0
7	24043250	.	C	T	11	5	16	0	0	16	0	0
7	24053314	.	G	A	3	4	7	0	0	7	0	0
7	24053451	.	G	A	3	5	8	0	0	8	0	0
7	24053553	.	A	G	4	3	7	0	0	7	0	0
7	24053575	.	A	G	3	0	3	0	5	8	0	0
7	24053673	.	A	G	1	2	3	0	0	3	0	0
7	24054196	.	C	G	3	4	7	0	0	7	0	0
7	24059449	.	T	A	4	3	7	0	1	8	0	0
7	24059570	.	C	T	7	8	15	0	1	16	0	0
7	24059705	.	G	A	7	5	12	0	1	13	0	0
7	24059861	.	C	G	5	3	8	0	0	8	0	0
7	24059873	.	C	T	6	3	9	0	0	9	0	0
7	24060071	.	A	C	6	6	12	0	0	12	0	0
7	24060107	.	G	T	3	3	6	0	0	6	0	0
7	24066825	.	C	T	1	3	4	0	0	4	0	0
7	24067056	.	G	T	4	3	7	0	0	7	0	0
7	24068078	.	T	G	7	4	11	0	0	12	1	0
7	24068224	.	A	T	6	3	9	0	0	9	0	0
7	24068669	.	T	G	4	4	8	0	0	8	0	0
7	24068761	.	G	T	3	2	5	0	0	5	0	0
7	24068868	.	G	A	0	2	2	0	2	4	0	0
7	24069484	.	T	C	8	3	11	0	1	12	0	0
7	24069592	.	A	G	4	5	9	0	0	9	0	0
7	24069598	.	G	A	4	4	8	0	0	8	0	0
7	24072217	.	C	T	4	5	9	0	0	9	0	0
7	24075155	.	C	G	4	7	11	0	1	12	0	0
7	24075776	.	C	T	8	10	18	0	0	18	0	0
7	24075842	.	A	C	9	3	12	0	3	15	0	0
7	24075911	.	G	A	12	4	16	0	1	17	0	0
7	24076009	.	A	T	2	4	6	0	0	6	0	0
7	24076044	.	A	C	3	4	7	0	2	9	0	0
7	24076086	.	C	A	4	8	12	0	0	12	0	0
7	24076088	.	A	G	3	7	10	0	2	12	0	0
7	24076192	.	C	T	0	18	18	0	0	18	0	0
7	24076198	.	C	T	16	5	21	0	0	21	0	0
7	24076269	.	C	T	12	9	21	0	0	21	0	0
7	24076329	.	C	T	10	15	25	0	0	25	0	0
7	24076373	.	C	T	11	13	24	0	0	24	0	0
7	24084879	.	C	T	18	10	28	1	0	29	0	0
7	24087362	.	A	T	6	7	13	0	1	14	0	0
7	24087365	.	T	C	6	6	12	0	3	15	0	0
7	24087724	.	C	A	5	9	14	0	0	14	0	0
7	24090182	.	G	A	16	12	28	0	1	29	0	0
7	24091054	.	G	A	16	16	32	0	1	33	0	0
7	24091269	.	G	A	1	11	12	0	15	27	0	0
7	24092626	.	C	T	11	11	22	0	1	23	0	0
7	24093165	.	C	G	16	18	34	0	1	35	0	0
7	24093300	.	C	T	16	12	28	1	1	30	0	0
7	24093301	.	A	C	16	13	29	1	0	30	0	0
7	24093372	.	A	G	18	17	35	0	2	37	0	0
7	24095515	.	C	G	25	17	42	0	0	42	0	0
7	24095717	.	G	A	3	18	21	0	18	39	0	0
7	24095776	.	G	A	17	20	37	0	2	39	0	0
7	24095788	.	A	G	12	24	36	0	2	38	0	0
7	24095836	.	C	T	21	13	34	0	0	34	0	0
7	24095848	.	G	A	22	14	36	0	1	37	0	0
7	24095883	.	T	A	15	24	39	0	0	39	0	0
7	24095926	.	A	C	15	16	31	0	2	33	0	0
7	24095978	.	T	A	21	14	35	0	3	38	0	0
7	24096399	.	C	A	18	11	29	0	1	30	0	0
7	24096505	.	G	A	4	13	17	0	21	38	0	0
7	24096541	.	C	T	21	9	30	0	1	31	0	0
7	24096767	.	A	C	17	12	29	0	1	30	0	0
7	24100511	.	G	A	2	4	6	0	0	6	0	0
7	24100743	.	A	C	5	0	5	0	2	7	0	0
7	24100761	.	C	T	4	2	6	0	0	6	0	0
7	24106127	.	G	A	1	2	3	0	0	3	0	0
7	24106228	.	A	G	6	2	8	0	0	8	0	0
7	24110278	.	G	A	4	3	7	0	0	7	0	0
7	24111181	.	A	G	1	4	5	0	0	5	0	0
7	24115186	.	G	A	14	15	29	0	0	29	0	0
7	24153839	.	T	C	3	2	5	0	0	5	0	0
7	24153885	.	G	A	2	4	6	0	0	6	0	0
7	24156373	.	A	G	2	7	9	0	0	9	0	0
7	24156994	.	G	A	0	4	4	0	3	7	0	0
7	24158843	.	A	G	10	0	10	0	7	17	0	0
7	24158918	.	G	A	0	5	5	0	7	12	0	0
7	24159155	.	G	T	4	3	7	0	1	8	0	0
7	24159248	.	C	A	6	5	11	0	0	11	0	0
7	24159284	.	G	A	6	4	10	0	0	10	0	0
7	24161591	.	C	A	12	14	26	0	3	29	0	0
7	24161648	.	G	A	0	12	12	0	11	23	0	0
7	24162019	.	G	A	3	6	9	0	1	10	0	0
7	24162034	.	C	T	3	7	10	0	0	10	0	0
7	24162368	.	A	T	9	10	19	0	0	19	0	0
7	24162369	.	A	C	9	9	18	0	1	19	0	0
7	24162485	.	C	T	12	10	22	0	0	22	0	0
7	24162567	.	T	C	8	4	12	0	1	13	0	0
7	24162761	.	G	T	3	4	7	0	3	10	0	0
7	24197574	.	C	A	6	6	12	0	0	12	0	0
7	24197607	.	A	T	5	4	9	0	0	9	0	0
7	24197814	.	G	A	6	2	8	0	0	8	0	0
7	24197841	.	G	A	3	4	7	0	0	7	0	0
7	24197867	.	T	A	2	3	5	0	0	5	0	0
7	24198334	.	C	T	9	6	15	0	1	16	0	0
7	24198335	.	C	T	2	2	4	0	12	16	0	0
7	24200052	.	C	T	1	9	10	0	7	17	0	0
7	24207520	.	A	C	25	18	43	0	1	44	0	0
7	24207552	.	A	G	18	0	18	0	26	44	0	0
7	24207590	.	A	T	19	17	36	0	2	38	0	0
7	24207632	.	G	C	11	17	28	0	0	28	0	0
7	24210121	.	T	C	5	2	7	0	0	7	0	0
7	24210323	.	C	A	0	11	11	0	16	27	0	0
7	24210422	.	T	C	9	12	21	0	3	24	0	0
7	24210629	.	T	A	13	22	35	1	0	36	0	0
7	24210659	.	A	G	18	22	40	1	1	42	0	0
7	24210676	.	A	G	25	17	42	0	2	44	0	0
7	24211015	.	A	T	16	13	29	0	1	30	0	0
7	24211054	.	G	A	16	13	29	0	0	29	0	0
7	24211081	.	T	A	25	11	36	0	0	36	0	0
7	24211342	.	C	T	0	15	15	0	18	33	0	0
7	24211443	.	C	T	2	7	9	1	16	26	0	0
7	24211542	.	G	T	11	5	16	0	3	19	0	0
7	24211560	.	A	T	5	11	16	0	1	17	0	0
7	24211646	.	C	T	0	8	8	0	9	17	0	0
7	24211900	.	A	C	1	0	1	0	3	4	0	0
7	24211978	.	G	A	11	12	23	3	0	26	0	0
7	24212093	.	C	G	10	11	21	0	1	22	0	0
7	24212122	.	T	C	9	10	19	0	0	19	0	0
7	24212159	.	G	C	7	1	8	0	13	21	0	0
7	24212383	.	G	A	14	17	31	0	0	31	0	0
7	24214655	.	C	T	8	9	17	0	0	17	0	0
7	24214673	.	C	A	11	6	17	0	1	18	0	0
7	24219052	.	A	G	2	7	9	0	0	9	0	0
7	24227149	.	T	G	6	8	14	0	0	14	0	0
7	24235806	.	G	A	4	6	10	0	0	10	0	0
7	24236035	.	A	G	5	3	8	0	0	8	0	0
7	24236177	.	C	G	12	12	24	0	0	24	0	0
7	24343589	.	G	T	3	2	5	0	1	6	0	0
7	24343649	.	C	G	1	3	4	0	0	4	0	0
7	24343653	.	A	G	1	0	1	0	3	4	0	0
7	24457691	.	C	A	35	20	55	0	2	57	0	0
7	24457788	.	C	A	32	16	48	0	2	50	0	0
7	24457803	.	A	C	30	12	42	0	2	44	0	0
7	24457845	.	T	C	33	7	40	0	6	46	0	0
7	24458103	.	C	A	30	20	50	0	0	50	0	0
7	24458128	.	G	C	29	19	48	0	0	48	0	0
7	24458205	.	G	A	35	23	58	0	1	59	0	0
7	24458282	.	C	T	25	11	36	0	2	38	0	0
7	24458339	.	A	G	33	14	47	0	2	49	0	0
7	24458866	.	T	C	26	16	42	0	3	45	0	0
7	24458894	.	T	A	25	16	41	0	4	45	0	0
7	24459452	.	G	A	24	12	36	0	0	36	0	0
7	24459847	.	A	G	25	19	44	0	0	44	0	0
7	24459932	.	T	C	20	21	41	0	1	42	0	0
7	24460025	.	G	A	19	19	38	0	0	38	0	0
7	24460026	.	C	T	18	19	37	0	0	37	0	0
7	24460189	.	T	C	18	18	36	0	5	41	0	0
7	24460443	.	G	A	16	13	29	0	4	33	0	0
7	24460461	.	G	A	18	10	28	0	2	30	0	0
7	24461115	.	A	C	15	22	37	0	1	38	0	0
7	24461298	.	G	A	12	13	25	0	0	25	0	0
7	24461601	.	A	G	22	10	32	0	1	33	0	0
7	24462394	.	A	G	18	14	32	2	0	34	0	0
7	24470812	.	A	G	19	20	39	0	3	42	0	0
7	24485180	.	C	T	1	1	2	0	0	2	0	0
7	24485201	.	A	G	1	2	3	0	0	3	0	0
7	24485232	.	T	C	2	2	4	0	1	5	0	0
7	24485285	.	T	C	1	2	3	0	0	3	0	0
7	24485291	.	T	A	1	2	3	0	0	3	0	0
7	24486345	.	A	G	24	17	41	0	0	43	2	0
7	24486515	.	A	C	39	25	64	0	3	67	0	0
7	24486546	.	G	C	36	26	62	0	1	66	3	0
7	24486721	.	G	A	31	33	64	0	4	68	0	0
7	24486822	.	G	A	36	23	59	0	1	60	0	0
7	24489888	.	A	G	26	33	59	0	2	61	0	0
7	24498912	.	C	T	10	9	19	0	0	19	0	0
7	24501156	.	T	C	9	5	14	0	4	18	0	0
7	24504508	.	C	T	11	9	20	0	0	20	0	0
7	24504875	.	C	T	7	4	11	0	0	11	0	0
7	24505063	.	A	G	2	3	5	0	0	5	0	0
7	24528917	.	T	A	9	3	12	0	1	13	0	0
7	24551057	.	G	C	5	2	7	0	0	7	0	0
7	24569961	.	T	C	8	8	16	0	2	18	0	0
7	24569990	.	T	G	10	13	23	0	1	24	0	0
7	24570012	.	A	T	14	7	21	0	3	24	0	0
7	24570714	.	G	A	3	7	10	0	9	19	0	0
7	24570973	.	G	A	1	2	3	0	1	4	0	0
7	24581855	.	A	T	3	2	5	0	0	5	0	0
7	24593439	.	T	C	8	10	18	0	1	19	0	0
7	24593452	.	T	A	10	11	21	0	0	21	0	0
7	24594860	.	T	A	10	8	18	0	0	18	0	0
7	24598728	.	G	T	12	11	23	0	0	23	0	0
7	24603028	.	G	T	11	8	19	0	0	19	0	0
7	24603231	.	C	T	1	6	7	0	6	13	0	0
7	24612524	.	G	A	5	7	12	0	0	12	0	0
7	24612623	.	C	T	4	3	7	0	0	7	0	0
7	24616240	.	G	A	7	3	10	0	0	10	0	0
7	24621385	.	C	T	4	8	12	0	0	12	0	0
7	24621480	.	T	C	1	3	4	0	0	4	0	0
7	24632080	.	C	T	1	12	13	0	3	16	0	0
7	24635159	.	G	A	5	6	11	0	2	13	0	0
7	24637765	.	C	A	7	3	10	0	1	11	0	0
7	24637934	.	T	C	2	3	5	0	1	6	0	0
7	24638015	.	C	A	2	3	5	0	11	16	0	0
7	24643742	.	C	T	4	2	6	0	2	8	0	0
7	24644446	.	A	C	11	5	16	0	0	16	0	0
7	24645292	.	A	G	2	2	4	0	0	4	0	0
7	24645402	.	G	A	6	4	10	0	1	11	0	0
7	24646602	.	T	C	1	3	4	1	1	6	0	0
7	24649610	.	G	C	2	5	7	0	0	7	0	0
7	24649694	.	T	C	2	4	6	0	0	6	0	0
7	24651636	.	C	T	3	5	8	0	0	8	0	0
7	24651645	.	G	A	3	4	7	0	1	8	0	0
7	24652951	.	A	G	2	0	2	0	5	7	0	0
7	24653020	.	G	A	2	6	8	0	0	8	0	0
7	24653068	.	C	T	3	5	8	0	0	8	0	0
7	24653079	.	G	A	4	6	10	0	0	10	0	0
7	24653121	.	G	A	6	7	13	0	1	14	0	0
7	24655086	.	T	A	9	6	15	0	0	15	0	0
7	24655094	.	T	C	8	6	14	0	0	14	0	0
7	24655261	.	A	G	7	6	13	0	0	13	0	0
7	24658938	.	G	A	0	3	3	0	4	7	0	0
7	24662235	.	G	A	8	4	12	0	0	12	0	0
7	24663995	.	T	C	5	5	10	0	0	10	0	0
7	24672147	.	A	G	16	0	16	0	13	29	0	0
7	24672257	.	G	C	12	16	28	0	1	29	0	0
7	24681673	.	A	G	22	23	45	0	3	48	0	0
7	24681731	.	T	C	26	27	53	0	3	56	0	0
7	24681755	.	A	G	28	27	55	0	4	59	0	0
7	24681806	.	A	G	23	25	48	0	3	51	0	0
7	24697400	.	T	C	4	14	18	0	0	18	0	0
7	24699881	.	G	T	11	11	22	0	0	22	0	0
7	24715143	.	G	A	2	2	4	0	0	4	0	0
7	24715168	.	A	C	2	2	4	0	0	4	0	0
7	24715870	.	C	T	0	4	4	0	1	5	0	0
7	24715879	.	C	T	2	3	5	0	0	5	0	0
7	24716258	.	C	T	2	2	4	0	1	5	0	0
7	24716373	.	G	A	1	4	5	0	0	5	0	0
7	24716393	.	G	T	2	4	6	0	0	6	0	0
7	24716697	.	T	C	1	2	3	0	0	3	0	0
7	24717322	.	T	G	3	2	5	0	0	5	0	0
7	24717327	.	T	G	3	2	5	0	0	5	0	0
7	24796095	.	A	C	1	2	3	0	0	3	0	0
7	24796137	.	G	A	0	2	2	0	3	5	0	0
7	24801445	.	C	T	1	2	3	0	0	3	0	0
7	24801448	.	C	T	1	2	3	0	0	3	0	0
7	24801593	.	G	A	0	5	5	0	1	6	0	0
7	24801886	.	G	A	2	6	8	0	0	8	0	0
7	24801920	.	G	T	0	6	6	0	4	10	0	0
7	24801937	.	T	A	5	6	11	0	1	12	0	0
7	24801961	.	T	A	6	4	10	0	0	10	0	0
7	24804343	.	T	G	1	4	5	0	0	5	0	0
7	24807919	.	A	G	3	2	5	0	0	5	0	0
7	24807931	.	C	T	3	3	6	0	0	6	0	0
7	24812267	.	C	T	1	3	4	0	0	4	0	0
7	24812538	.	G	C	6	3	9	0	0	9	0	0
7	24812587	.	C	T	14	5	19	0	0	19	0	0
7	24812662	.	G	T	5	4	9	0	0	9	0	0
7	24812783	.	A	G	1	0	1	0	4	5	0	0
7	24812829	.	A	G	1	2	3	0	1	4	0	0
7	24815992	.	C	T	7	7	14	0	1	15	0	0
7	24819788	.	G	A	27	20	47	0	0	47	0	0
7	24819812	.	G	A	24	17	41	0	1	42	0	0
7	24822914	.	G	A	23	14	37	0	2	39	0	0
7	24830546	.	C	T	2	2	4	0	0	4	0	0
7	24830818	.	A	T	2	2	4	0	0	4	0	0
7	24830832	.	C	T	3	2	5	0	0	5	0	0
7	24887998	.	C	A	1	2	3	0	0	3	0	0
7	24888986	.	T	C	8	5	13	0	1	14	0	0
7	24889051	.	G	C	0	6	6	0	2	8	0	0
7	24889617	.	T	G	5	0	5	0	6	11	0	0
7	24889758	.	T	C	1	7	8	0	0	8	0	0
7	24889808	.	C	G	3	7	10	0	0	10	0	0
7	24944724	.	C	T	7	4	11	0	0	11	0	0
7	24946895	.	C	T	8	7	15	0	1	16	0	0
7	24946913	.	T	C	5	9	14	0	0	14	0	0
7	24947440	.	T	C	11	8	19	0	0	19	0	0
7	24974916	.	T	C	13	10	23	1	0	24	0	0
7	24974937	.	T	C	5	12	17	1	1	19	0	0
7	24975264	.	T	C	16	17	33	0	0	33	0	0
7	24975646	.	C	T	15	18	33	0	0	33	0	0
7	24975678	.	G	A	14	16	30	0	0	30	0	0
7	24976539	.	T	C	8	19	27	0	2	29	0	0
7	24979979	.	A	G	5	3	8	0	0	8	0	0
7	24980185	.	T	G	5	3	8	0	0	8	0	0
7	24980469	.	C	T	5	8	13	1	0	14	0	0
7	24983304	.	C	T	9	5	14	0	0	14	0	0
7	24983328	.	C	T	1	5	6	0	5	11	0	0
7	24984869	.	G	T	8	7	15	0	0	15	0	0
7	24985318	.	C	G	1	2	3	0	5	8	0	0
7	25010745	.	C	T	30	17	47	0	0	48	1	0
7	25011238	.	A	G	15	11	26	0	2	28	0	0
7	25011375	.	T	C	2	2	4	0	0	4	0	0
7	25011585	.	T	G	6	6	12	0	0	12	0	0
7	25015154	.	C	T	5	6	11	0	1	12	0	0
7	25015239	.	C	T	7	7	14	0	1	15	0	0
7	25015419	.	T	C	6	6	12	2	0	14	0	0
7	25015424	.	G	A	7	6	13	2	0	15	0	0
7	25017967	.	G	C	6	5	11	0	0	11	0	0
7	25018043	.	G	T	8	10	18	0	1	19	0	0
7	25021647	.	T	G	8	11	19	0	0	19	0	0
7	25021697	.	T	C	8	12	20	0	0	20	0	0
7	25021718	.	C	T	7	14	21	0	1	22	0	0
7	25024266	.	T	C	9	13	22	0	2	24	0	0
7	25024277	.	A	T	6	16	22	0	1	23	0	0
7	25024346	.	G	C	0	11	11	2	10	23	0	0
7	25026873	.	C	T	8	7	15	0	0	15	0	0
7	25026960	.	C	T	8	10	18	0	0	18	0	0
7	25027022	.	T	C	11	9	20	0	1	21	0	0
7	25027034	.	A	G	10	8	18	0	0	18	0	0
7	25027208	.	G	A	5	7	12	0	3	15	0	0
7	25027211	.	G	T	2	9	11	0	5	16	0	0
7	25027266	.	T	C	5	2	7	0	1	8	0	0
7	25027466	.	C	A	3	3	6	0	0	6	0	0
7	25027561	.	C	T	9	6	15	0	1	16	0	0
7	25027571	.	A	G	9	7	16	0	1	17	0	0
7	25027756	.	T	C	11	3	14	0	0	14	0	0
7	25028034	.	C	T	7	8	15	0	0	15	0	0
7	25028081	.	A	G	7	10	17	0	1	18	0	0
7	25028085	.	G	C	7	10	17	0	1	18	0	0
7	25028205	.	T	A	11	10	21	1	0	22	0	0
7	25028440	.	A	T	4	2	6	0	1	7	0	0
7	25028627	.	T	A	6	2	8	1	1	10	0	0
7	25029003	.	T	C	10	4	14	0	0	14	0	0
7	25029129	.	C	T	3	2	5	0	0	5	0	0
7	25029140	.	T	A	3	3	6	0	0	6	0	0
7	25029169	.	G	A	5	3	8	0	0	8	0	0
7	25029191	.	G	A	0	2	2	0	4	6	0	0
7	25042942	.	A	C	6	11	17	0	4	21	0	0
7	25045337	.	T	A	5	8	13	0	1	14	0	0
7	25045777	.	A	G	11	11	22	0	0	22	0	0
7	25047228	.	A	C	3	4	7	0	0	7	0	0
7	25047307	.	G	C	4	4	8	0	1	9	0	0
7	25047318	.	A	C	5	4	9	0	1	10	0	0
7	25047441	.	T	G	13	15	28	0	0	28	0	0
7	25047604	.	T	A	9	9	18	0	0	18	0	0
7	25047954	.	G	A	17	13	30	0	0	30	0	0
7	25049262	.	A	G	11	19	30	0	1	31	0	0
7	25059856	.	C	T	23	13	36	0	0	36	0	0
7	25096889	.	T	C	23	7	30	1	1	32	0	0
7	25098910	.	G	A	35	23	58	0	2	60	0	0
7	25099133	.	A	G	20	4	24	2	23	49	0	0
7	25099302	.	T	C	9	8	17	0	0	17	0	0
7	25099594	.	T	G	15	16	31	0	0	31	0	0
7	25099704	.	T	C	16	22	38	0	1	39	0	0
7	25129868	.	T	C	3	2	5	0	0	5	0	0
7	25129889	.	A	G	2	2	4	0	1	5	0	0
7	25171709	.	A	G	3	0	3	0	2	5	0	0
7	25292455	.	T	C	10	5	15	0	0	15	0	0
7	25292660	.	T	C	4	2	6	0	0	6	0	0
7	25292719	.	T	A	3	2	5	0	0	5	0	0
7	25292978	.	G	A	0	10	10	0	8	18	0	0
7	25293123	.	C	A	5	3	8	0	0	8	0	0
7	25293131	.	G	T	4	3	7	0	1	8	0	0
7	25293261	.	T	C	7	4	11	0	0	11	0	0
7	25339860	.	A	C	6	7	13	0	1	14	0	0
7	25339872	.	A	T	6	8	14	0	0	14	0	0
7	25341280	.	G	A	0	9	9	0	11	20	0	0
7	25346765	.	T	C	13	8	21	0	0	21	0	0
7	25346924	.	G	C	4	12	16	0	10	26	0	0
7	25347024	.	C	T	15	11	26	0	0	26	0	0
7	25347459	.	T	G	19	23	42	0	2	44	0	0
7	25347679	.	A	T	9	9	18	0	0	18	0	0
7	25348031	.	C	T	5	6	11	0	0	11	0	0
7	25558952	.	C	A	1	5	6	0	5	11	0	0
7	25559010	.	T	C	3	6	9	0	1	10	0	0
7	25559093	.	A	G	4	4	8	0	0	8	0	0
7	25559763	.	A	T	1	4	5	0	0	5	0	0
7	25561039	.	T	G	3	4	7	0	0	7	0	0
7	25561094	.	A	T	3	4	7	0	0	7	0	0
7	25843643	.	A	G	2	0	2	0	4	6	0	0
7	25846430	.	G	A	1	4	5	0	0	5	0	0
7	25846562	.	C	T	3	2	5	0	0	5	0	0
7	25852549	.	A	G	3	0	3	0	3	6	0	0
7	25854239	.	T	C	6	9	15	0	0	15	0	0
7	25854245	.	C	G	5	9	14	0	0	14	0	0
7	25858611	.	C	A	5	11	16	0	2	18	0	0
7	25863708	.	C	T	11	13	24	0	0	24	0	0
7	25867412	.	C	T	7	10	17	0	0	17	0	0
7	25869617	.	C	T	9	20	29	0	3	32	0	0
7	25872580	.	C	T	12	11	23	0	2	25	0	0
7	25872691	.	G	A	0	7	7	0	7	14	0	0
7	25873009	.	C	T	12	10	22	0	1	23	0	0
7	25873601	.	A	T	18	14	32	0	1	33	0	0
7	25873728	.	T	G	21	1	22	0	13	35	0	0
7	25873743	.	C	A	23	16	39	0	0	39	0	0
7	25873857	.	T	C	14	14	28	0	0	28	0	0
7	25876947	.	A	C	8	8	16	0	1	18	1	0
7	25877033	.	A	T	15	12	27	0	0	27	0	0
7	25877038	.	G	A	16	12	28	0	1	29	0	0
7	25877420	.	T	C	24	15	39	0	0	39	0	0
7	25877445	.	G	C	18	12	30	0	0	30	0	0
7	25877615	.	A	G	5	0	5	0	3	8	0	0
7	25877622	.	C	T	3	3	6	0	0	6	0	0
7	25877984	.	A	C	3	4	7	0	0	7	0	0
7	25878417	.	T	G	14	5	19	0	0	19	0	0
7	25878642	.	G	T	14	13	27	0	3	30	0	0
7	25878723	.	A	C	22	22	44	0	1	45	0	0
7	25878786	.	C	T	4	24	28	0	24	52	0	0
7	25878849	.	T	C	26	12	38	0	5	43	0	0
7	25878977	.	A	G	28	15	43	0	1	44	0	0
7	25879116	.	T	G	25	17	42	0	3	45	0	0
7	25879130	.	G	C	23	18	41	0	6	47	0	0
7	25879514	.	T	A	19	23	42	0	1	43	0	0
7	25879905	.	G	A	17	20	37	0	0	37	0	0
7	25879920	.	G	T	23	16	39	0	0	39	0	0
7	25880033	.	A	T	16	13	29	0	2	31	0	0
7	25880046	.	C	A	17	13	30	0	0	30	0	0
7	25880207	.	T	A	11	13	24	0	0	24	0	0
7	25880226	.	G	A	18	9	27	0	0	27	0	0
7	25880313	.	T	A	21	17	38	0	2	41	1	0
7	25880340	.	C	T	2	23	25	0	20	45	0	0
7	25880754	.	C	T	1	18	19	0	15	34	0	0
7	25880843	.	G	A	10	22	32	0	0	32	0	0
7	25881215	.	C	T	15	14	29	0	2	31	0	0
7	25881583	.	G	A	19	6	25	5	6	36	0	0
7	25881605	.	A	C	15	19	34	5	3	42	0	0
7	25884007	.	G	T	25	13	38	0	2	40	0	0
7	25884148	.	A	G	18	24	42	0	2	44	0	0
7	25917046	.	A	G	34	38	72	0	4	76	0	0
7	25917473	.	G	A	3	29	32	3	30	65	0	0
7	25917634	.	A	T	40	30	70	0	2	72	0	0
7	25918056	.	C	T	28	37	65	3	6	74	0	0
7	25918101	.	T	G	29	4	33	0	30	63	0	0
7	25920966	.	A	G	17	1	18	0	17	35	0	0
7	25979203	.	T	C	17	15	32	0	0	32	0	0
7	25979417	.	C	T	18	19	37	0	2	39	0	0
7	25979468	.	C	T	21	10	31	0	2	33	0	0
7	25986069	.	G	T	2	19	21	0	20	41	0	0
7	25986099	.	C	T	24	22	46	0	1	47	0	0
7	25988324	.	C	A	17	20	37	0	3	40	0	0
7	26002674	.	C	T	16	19	35	0	2	37	0	0
7	26002915	.	T	A	21	15	36	0	2	38	0	0
7	26003853	.	C	T	4	6	10	0	0	10	0	0
7	26004014	.	G	T	4	8	12	0	1	13	0	0
7	26004616	.	A	G	9	7	16	0	1	17	0	0
7	26004876	.	T	A	18	5	23	0	1	24	0	0
7	26004907	.	A	G	16	0	16	0	5	21	0	0
7	26004922	.	C	T	17	2	19	0	0	19	0	0
7	26004951	.	A	G	12	4	16	0	0	16	0	0
7	26005033	.	A	G	5	5	10	0	0	10	0	0
7	26005574	.	A	T	2	3	5	0	0	5	0	0
7	26007291	.	G	A	3	3	6	0	0	6	0	0
7	26008444	.	A	G	3	2	5	0	0	5	0	0
7	26013041	.	C	G	5	2	7	0	0	7	0	0
7	26015376	.	C	T	8	6	14	0	0	14	0	0
7	26015378	.	A	G	8	6	14	0	0	14	0	0
7	26015544	.	G	T	14	10	24	0	1	25	0	0
7	26015595	.	C	A	12	9	21	0	0	21	0	0
7	26015628	.	T	C	7	13	20	0	1	21	0	0
7	26015663	.	T	C	12	19	31	0	0	31	0	0
7	26015693	.	C	A	19	12	31	0	1	32	0	0
7	26020078	.	T	C	17	12	29	0	1	30	0	0
7	26020192	.	C	T	10	5	15	0	0	15	0	0
7	26020273	.	G	A	3	11	14	0	12	26	0	0
7	26020370	.	T	C	8	8	16	0	0	16	0	0
7	26020408	.	A	C	7	10	17	0	0	17	0	0
7	26020659	.	C	T	9	8	17	0	1	18	0	0
7	26020779	.	C	T	14	12	26	0	0	26	0	0
7	26020927	.	A	T	5	6	11	0	0	11	0	0
7	26021146	.	A	G	19	18	37	0	1	38	0	0
7	26026114	.	A	G	16	1	17	0	12	29	0	0
7	26026176	.	C	T	14	10	24	0	1	25	0	0
7	26026188	.	C	A	14	13	27	0	0	27	0	0
7	26026241	.	G	A	9	10	19	0	0	19	0	0
7	26026264	.	C	G	8	5	13	1	0	14	0	0
7	26026298	.	T	G	7	0	7	1	8	16	0	0
7	26026330	.	A	T	11	6	17	1	2	20	0	0
7	26026491	.	T	G	4	4	8	0	0	8	0	0
7	26048144	.	G	C	2	3	5	0	1	6	0	0
7	26048402	.	T	C	1	2	3	0	1	4	0	0
7	26048403	.	T	C	2	2	4	0	0	4	0	0
7	26048541	.	G	A	6	2	8	0	0	8	0	0
7	26074160	.	C	A	8	14	22	0	0	22	0	0
7	26076368	.	A	G	10	4	14	0	0	15	1	0
7	26076458	.	A	T	6	7	13	0	0	13	0	0
7	26076531	.	G	C	4	4	8	0	0	8	0	0
7	26077845	.	G	T	19	24	43	0	3	46	0	0
7	26077947	.	T	A	20	36	56	0	1	57	0	0
7	26077949	.	C	T	21	34	55	0	2	57	0	0
7	26078061	.	T	C	22	13	35	3	1	39	0	0
7	26078243	.	A	C	23	17	40	0	1	41	0	0
7	26078284	.	C	T	22	22	44	0	3	47	0	0
7	26078345	.	T	A	19	24	43	0	1	44	0	0
7	26078435	.	G	T	21	11	32	0	2	34	0	0
7	26078897	.	G	A	33	21	54	0	0	54	0	0
7	26078947	.	G	A	32	14	46	0	0	46	0	0
7	26079370	.	T	G	25	28	53	0	2	55	0	0
7	26079667	.	C	G	3	22	25	0	26	52	1	0
7	26081171	.	C	T	20	18	38	0	0	38	0	0
7	26081252	.	A	G	23	19	42	0	2	44	0	0
7	26081744	.	T	C	25	22	47	0	2	49	0	0
7	26082281	.	G	A	13	13	26	0	0	26	0	0
7	26082311	.	A	G	11	10	21	0	2	23	0	0
7	26107353	.	T	C	1	3	4	0	0	4	0	0
7	26107354	.	G	A	1	3	4	0	0	4	0	0
7	26108254	.	G	A	1	1	2	0	1	3	0	0
7	26116876	.	A	G	1	2	3	0	0	3	0	0
7	26118930	.	T	G	4	2	6	0	0	6	0	0
7	26132724	.	C	T	22	18	40	0	0	40	0	0
7	26132743	.	C	T	25	18	43	0	0	43	0	0
7	26140767	.	A	G	30	22	52	0	1	53	0	0
7	26141394	.	G	C	19	13	32	0	0	32	0	0
7	26141519	.	T	A	22	25	47	0	0	47	0	0
7	26141568	.	T	A	28	21	49	0	0	50	1	0
7	26142339	.	T	C	11	10	21	0	3	24	0	0
7	26142525	.	T	G	20	2	22	1	23	46	0	0
7	26142702	.	A	G	19	31	50	0	2	52	0	0
7	26142736	.	A	T	22	25	47	0	1	48	0	0
7	26143343	.	A	G	16	16	32	0	1	33	0	0
7	26143501	.	T	C	27	22	49	0	0	49	0	0
7	26143760	.	G	A	26	19	45	0	0	45	0	0
7	26144551	.	T	A	3	6	9	0	1	10	0	0
7	26144628	.	C	T	7	12	19	0	1	20	0	0
7	26145605	.	T	C	34	24	58	0	0	58	0	0
7	26145816	.	C	T	6	4	10	0	2	12	0	0
7	26145873	.	C	T	8	12	20	0	1	21	0	0
7	26145910	.	T	C	18	7	25	0	1	26	0	0
7	26146176	.	A	C	29	30	59	0	4	63	0	0
7	26146188	.	T	C	25	31	56	0	4	60	0	0
7	26146796	.	A	G	28	2	30	0	27	57	0	0
7	26146993	.	C	T	32	34	66	0	2	68	0	0
7	26148181	.	A	C	32	31	63	0	1	64	0	0
7	26148312	.	T	G	29	17	46	1	0	47	0	0
7	26148773	.	G	A	8	6	14	0	0	14	0	0
7	26149252	.	G	A	29	31	60	0	0	60	0	0
7	26149690	.	C	T	30	34	64	0	4	68	0	0
7	26150096	.	T	A	23	19	42	0	1	43	0	0
7	26224320	.	A	G	24	18	42	0	4	46	0	0
7	26224365	.	A	T	18	18	36	0	0	36	0	0
7	26226772	.	G	C	12	22	34	0	2	36	0	0
7	26227119	.	C	T	18	20	38	0	2	40	0	0
7	26227149	.	C	T	14	17	31	0	3	34	0	0
7	26227527	.	T	C	17	20	37	0	1	38	0	0
7	26227539	.	T	C	20	17	37	0	1	38	0	0
7	26228290	.	C	T	27	23	50	0	0	50	0	0
7	26228639	.	T	C	22	22	44	0	1	45	0	0
7	26229449	.	G	A	18	13	31	0	0	31	0	0
7	26229529	.	C	T	19	24	43	0	1	44	0	0
7	26229551	.	T	A	21	28	49	0	0	49	0	0
7	26229640	.	T	C	25	27	52	0	2	54	0	0
7	26229935	.	C	T	19	15	34	0	0	34	0	0
7	26229979	.	A	G	8	9	17	0	3	20	0	0
7	26245668	.	T	C	14	12	26	0	1	27	0	0
7	26245714	.	A	T	13	8	21	0	2	23	0	0
7	26263153	.	C	T	15	6	21	0	0	21	0	0
7	26263174	.	T	C	7	0	7	0	6	13	0	0
7	26265832	.	C	A	0	3	3	0	2	5	0	0
7	26265961	.	G	A	2	4	6	0	0	6	0	0
7	26266069	.	G	C	6	7	13	0	0	13	0	0
7	26300184	.	A	G	5	2	7	0	0	7	0	0
7	26300263	.	A	G	6	4	10	0	0	10	0	0
7	26300359	.	A	G	7	11	18	0	0	18	0	0
7	26300955	.	T	C	5	0	5	0	4	9	0	0
7	26366620	.	T	C	10	5	15	0	1	16	0	0
7	26366684	.	C	T	11	9	20	0	0	20	0	0
7	26366778	.	G	A	8	10	18	0	0	18	0	0
7	26366919	.	G	A	9	10	19	0	1	20	0	0
7	26367056	.	T	C	6	0	6	0	10	16	0	0
7	26367280	.	C	T	1	8	9	0	11	20	0	0
7	26367470	.	C	G	3	2	5	0	0	5	0	0
7	26367486	.	A	C	5	5	10	0	0	10	0	0
7	26367525	.	A	G	11	7	18	0	0	18	0	0
7	26367628	.	A	G	6	3	9	0	1	10	0	0
7	26367797	.	T	C	3	6	9	0	1	10	0	0
7	26367944	.	G	A	7	3	10	0	0	10	0	0
7	26368240	.	C	A	2	5	7	0	2	9	0	0
7	26368291	.	A	C	3	9	12	0	0	12	0	0
7	26368333	.	A	T	2	7	9	0	1	10	0	0
7	26368483	.	T	A	3	8	11	0	0	11	0	0
7	26368719	.	C	A	3	4	7	0	1	8	0	0
7	26368748	.	A	T	7	4	11	0	0	11	0	0
7	26368836	.	A	T	3	7	10	0	1	11	0	0
7	26368955	.	G	T	6	6	12	0	2	14	0	0
7	26369030	.	C	T	7	5	12	0	0	12	0	0
7	26369034	.	G	C	6	4	10	0	0	10	0	0
7	26369227	.	G	A	5	8	13	0	0	13	0	0
7	26369269	.	C	T	0	3	3	0	2	5	0	0
7	26369583	.	A	C	8	1	9	0	11	20	0	0
7	26378224	.	G	A	9	5	14	0	0	14	0	0
7	26380290	.	T	C	6	7	13	0	2	15	0	0
7	26389261	.	C	T	1	2	3	0	0	3	0	0
7	26389351	.	C	T	6	3	9	0	0	9	0	0
7	26389369	.	G	A	4	4	8	0	2	10	0	0
7	26389429	.	C	T	3	11	14	0	0	14	0	0
7	26389486	.	G	A	6	6	12	0	0	12	0	0
7	26389805	.	A	G	8	4	12	0	0	12	0	0
7	26393903	.	T	C	3	0	3	0	2	5	0	0
7	26394208	.	A	T	16	16	32	0	0	32	0	0
7	26394285	.	A	T	15	15	30	0	1	31	0	0
7	26394382	.	C	T	1	19	20	0	12	32	0	0
7	26394476	.	G	A	22	18	40	0	0	40	0	0
7	26394791	.	A	G	15	23	38	0	1	39	0	0
7	26394848	.	G	A	16	18	34	0	1	35	0	0
7	26394951	.	T	A	9	11	20	0	0	20	0	0
7	26395538	.	T	C	13	13	26	0	1	27	0	0
7	26395625	.	T	A	10	12	22	0	0	22	0	0
7	26395778	.	T	G	9	8	17	0	0	17	0	0
7	26396170	.	G	A	7	12	19	0	0	19	0	0
7	26396560	.	C	G	10	8	18	0	1	19	0	0
7	26396768	.	G	A	19	17	36	0	0	36	0	0
7	26396915	.	A	C	8	13	21	0	1	22	0	0
7	26396975	.	A	G	13	11	24	0	0	24	0	0
7	26397003	.	T	G	13	8	21	0	0	21	0	0
7	26397096	.	T	C	11	0	11	0	10	21	0	0
7	26397243	.	G	A	8	11	19	0	0	19	0	0
7	26397475	.	T	A	7	6	13	0	0	13	0	0
7	26397541	.	G	A	17	10	27	0	1	28	0	0
7	26397760	.	C	T	11	10	21	0	1	22	0	0
7	26398159	.	A	T	12	7	19	0	1	20	0	0
7	26398351	.	A	G	12	13	25	0	0	25	0	0
7	26398867	.	G	A	20	19	39	0	0	39	0	0
7	26402680	.	C	A	6	9	15	0	0	15	0	0
7	26402788	.	T	G	8	8	16	0	1	17	0	0
7	26408340	.	C	T	10	7	17	0	1	18	0	0
7	26408466	.	C	A	0	3	3	0	6	9	0	0
7	26432105	.	G	A	6	3	9	0	1	10	0	0
7	26432306	.	T	C	5	6	11	0	1	12	0	0
7	26432464	.	A	T	6	5	11	0	5	16	0	0
7	26432733	.	A	G	2	2	4	0	0	4	0	0
7	26469820	.	G	A	0	4	4	0	7	11	0	0
7	26472340	.	A	C	5	10	15	0	0	15	0	0
7	26472346	.	A	T	4	11	15	0	1	16	0	0
7	26472398	.	C	T	6	6	12	0	1	13	0	0
7	26472413	.	A	G	5	6	11	0	0	11	0	0
7	26472971	.	C	G	3	5	8	0	1	9	0	0
7	26473040	.	A	G	6	0	6	0	4	10	0	0
7	26473163	.	G	A	6	3	9	0	1	10	0	0
7	26511439	.	A	T	15	22	37	0	4	41	0	0
7	26511691	.	G	A	15	21	36	0	1	37	0	0
7	26511760	.	A	G	24	20	44	0	0	44	0	0
7	26511801	.	T	G	22	17	39	0	1	40	0	0
7	26519052	.	A	G	3	5	8	0	0	8	0	0
7	26519150	.	A	T	14	9	23	0	1	24	0	0
7	26522358	.	T	C	12	10	22	0	0	22	0	0
7	26522364	.	C	T	12	12	24	0	1	25	0	0
7	26523169	.	A	G	9	6	15	0	0	15	0	0
7	26525463	.	C	T	4	7	11	0	1	12	0	0
7	26561539	.	A	G	2	0	2	0	2	4	0	0
7	27179302	.	C	A	1	1	2	0	0	2	0	0
7	27452761	.	T	G	4	2	6	1	0	7	0	0
7	27681025	.	G	T	9	8	17	0	3	20	0	0
7	27681071	.	A	T	11	11	22	0	1	23	0	0
7	27682919	.	C	T	10	12	22	0	2	24	0	0
7	27700517	.	G	A	13	7	20	0	0	20	0	0
7	27700777	.	C	T	0	9	9	0	14	23	0	0
7	27701155	.	C	G	0	7	7	0	8	15	0	0
7	27701231	.	T	A	10	4	14	0	1	15	0	0
7	27701431	.	T	A	8	4	12	0	0	12	0	0
7	27701561	.	A	T	8	8	16	0	0	16	0	0
7	27701623	.	C	A	7	5	12	0	1	13	0	0
7	27701634	.	A	G	6	4	10	0	0	10	0	0
7	27702003	.	A	C	4	3	7	0	1	8	0	0
7	27702571	.	T	G	5	6	11	0	0	11	0	0
7	27702934	.	G	A	10	7	17	0	0	17	0	0
7	27702998	.	T	A	5	8	13	0	0	13	0	0
7	27703102	.	T	C	7	9	16	0	1	17	0	0
7	27705837	.	G	A	8	9	17	0	0	17	0	0
7	27712933	.	C	T	0	5	5	0	2	7	0	0
7	27718258	.	C	G	1	13	14	0	9	23	0	0
7	27720520	.	A	G	5	5	10	0	0	10	0	0
7	27722513	.	A	G	7	3	10	0	1	11	0	0
7	27722534	.	A	G	11	8	19	0	1	20	0	0
7	27724908	.	T	C	4	6	10	0	1	11	0	0
7	27724920	.	T	G	5	9	14	0	1	15	0	0
7	27797760	.	A	G	1	2	3	0	0	3	0	0
7	27797834	.	A	C	5	3	8	0	0	8	0	0
7	27798561	.	A	C	4	9	13	0	0	13	0	0
7	27805487	.	A	G	7	6	13	0	0	13	0	0
7	27805547	.	C	T	6	8	14	0	0	14	0	0
7	27806074	.	G	A	0	11	11	0	12	23	0	0
7	27811770	.	C	T	14	15	29	0	0	29	0	0
7	27813749	.	C	T	11	13	24	0	1	25	0	0
7	27813942	.	G	A	11	9	20	0	0	20	0	0
7	27813978	.	A	G	9	0	9	0	13	22	0	0
7	27814326	.	C	T	11	13	24	0	0	24	0	0
7	27816668	.	T	C	14	14	28	0	0	28	0	0
7	27816875	.	C	T	10	15	25	0	0	25	0	0
7	27817229	.	C	A	19	8	27	0	3	30	0	0
7	27817283	.	A	G	16	0	16	0	17	33	0	0
7	27817755	.	G	C	12	20	32	0	1	33	0	0
7	27820177	.	G	A	2	11	13	0	0	13	0	0
7	27820496	.	T	A	1	3	4	0	0	4	0	0
7	27834170	.	A	G	7	3	10	0	3	13	0	0
7	27884185	.	A	G	8	12	20	0	0	20	0	0
7	27884211	.	A	G	6	11	17	0	0	17	0	0
7	27884611	.	T	G	6	3	9	0	0	9	0	0
7	27884618	.	C	T	5	4	9	0	0	9	0	0
7	27884979	.	G	T	2	2	4	0	1	5	0	0
7	27885000	.	T	C	2	3	5	0	0	5	0	0
7	27885043	.	C	T	2	5	7	0	0	7	0	0
7	27885118	.	T	C	11	4	15	1	0	16	0	0
7	27885160	.	A	G	7	7	14	0	0	14	0	0
7	27885259	.	A	G	4	3	7	0	0	7	0	0
7	27885364	.	A	T	2	2	4	0	0	4	0	0
7	27885365	.	A	C	2	2	4	0	0	4	0	0
7	27885703	.	A	T	8	9	17	0	0	17	0	0
7	27885706	.	C	T	7	10	17	0	0	17	0	0
7	27885941	.	G	A	7	10	17	0	1	18	0	0
7	27886502	.	A	T	5	5	10	0	0	10	0	0
7	27886508	.	A	T	3	4	7	0	0	7	0	0
7	27886602	.	C	A	5	7	12	0	0	12	0	0
7	27886923	.	A	G	7	7	14	0	1	15	0	0
7	27886924	.	A	G	7	7	14	0	0	14	0	0
7	27887044	.	T	A	14	5	19	0	2	21	0	0
7	27887284	.	A	C	1	6	7	0	0	7	0	0
7	27976894	.	C	T	6	5	11	0	1	12	0	0
7	27977061	.	C	T	10	5	15	0	1	16	0	0
7	27977083	.	G	A	2	4	6	0	11	17	0	0
7	28033649	.	G	A	1	10	11	0	11	22	0	0
7	28039990	.	G	A	0	12	12	0	6	18	0	0
7	28040014	.	G	T	0	12	12	0	8	20	0	0
7	28040083	.	T	C	7	7	14	0	0	14	0	0
7	28040885	.	T	C	11	7	18	0	0	18	0	0
7	28041147	.	G	A	0	5	5	0	8	13	0	0
7	28041246	.	T	G	6	0	6	0	8	14	0	0
7	28041336	.	T	A	2	3	5	0	0	5	0	0
7	28041496	.	T	C	8	7	15	0	0	15	0	0
7	28041538	.	T	C	6	8	14	0	0	14	0	0
7	28041570	.	G	T	7	3	10	0	0	10	0	0
7	28041615	.	C	T	6	3	9	0	0	9	0	0
7	28041842	.	T	C	5	3	8	0	0	8	0	0
7	28042027	.	G	A	13	9	22	0	0	22	0	0
7	28042060	.	G	A	3	9	12	1	1	14	0	0
7	28042070	.	A	C	7	7	14	1	0	15	0	0
7	28042611	.	A	T	12	4	16	0	0	16	0	0
7	28042732	.	G	A	5	4	9	0	0	9	0	0
7	28042740	.	G	A	5	3	8	0	2	10	0	0
7	28043040	.	C	A	5	5	10	0	0	10	0	0
7	28043173	.	T	G	6	2	8	0	0	8	0	0
7	28043184	.	A	G	5	0	5	0	6	11	0	0
7	28043284	.	A	G	6	6	12	0	0	12	0	0
7	28043416	.	A	G	5	11	16	0	0	16	0	0
7	28043837	.	T	G	10	0	10	0	12	22	0	0
7	28043852	.	G	A	9	13	22	0	0	22	0	0
7	28044193	.	A	G	9	9	18	0	0	18	0	0
7	28044303	.	A	G	10	4	14	0	0	14	0	0
7	28044323	.	A	G	12	4	16	0	2	18	0	0
7	28044339	.	A	G	5	7	12	0	2	14	0	0
7	28045160	.	G	A	0	6	6	4	5	15	0	0
7	28045263	.	C	G	13	5	18	1	0	19	0	0
7	28045404	.	A	C	17	5	22	1	0	23	0	0
7	28045444	.	T	A	18	13	31	1	0	32	0	0
7	28045600	.	C	T	16	11	27	1	1	29	0	0
7	28045685	.	C	T	8	3	11	0	1	12	0	0
7	28046436	.	T	C	15	4	19	2	0	21	0	0
7	28046530	.	A	G	14	12	26	0	2	28	0	0
7	28046572	.	T	C	21	9	30	0	0	30	0	0
7	28046580	.	A	G	9	19	28	0	0	28	0	0
7	28046619	.	A	G	18	0	18	3	10	31	0	0
7	28046918	.	A	C	2	6	8	1	0	9	0	0
7	28047072	.	C	T	7	12	19	0	0	19	0	0
7	28147806	.	T	A	23	16	39	0	0	39	0	0
7	28406477	.	G	A	3	5	8	0	0	8	0	0
7	28406514	.	G	A	1	7	8	0	0	8	0	0
7	28406725	.	A	G	1	4	5	0	0	5	0	0
7	28406732	.	T	A	1	4	5	0	0	5	0	0
7	28407151	.	G	T	1	2	3	1	0	4	0	0
7	28407152	.	T	G	1	2	3	1	0	4	0	0
7	28407339	.	A	G	1	3	4	0	0	4	0	0
7	28408177	.	G	A	1	3	4	0	0	4	0	0
7	28424095	.	G	A	3	4	7	0	0	7	0	0
7	28424237	.	C	G	15	8	23	0	0	23	0	0
7	28424381	.	A	T	4	6	10	0	1	11	0	0
7	28430010	.	G	A	11	6	17	0	2	19	0	0
7	28430127	.	C	A	7	6	13	0	1	14	0	0
7	28430430	.	C	T	7	7	14	0	1	15	0	0
7	28430454	.	C	A	5	9	14	0	0	14	0	0
7	28430503	.	G	A	5	6	11	0	1	12	0	0
7	28430528	.	G	T	6	4	10	0	0	10	0	0
7	28434034	.	A	T	18	7	25	3	2	30	0	0
7	28436486	.	G	C	19	7	26	0	0	26	0	0
7	28442009	.	G	C	13	8	21	0	1	22	0	0
7	28448588	.	C	T	8	8	16	0	0	16	0	0
7	28454686	.	A	G	4	2	6	0	0	6	0	0
7	28463034	.	T	A	4	4	8	0	0	8	0	0
7	28465338	.	G	A	6	11	17	0	0	17	0	0
7	28465399	.	A	T	8	3	11	0	2	13	0	0
7	28467182	.	A	G	9	13	22	0	0	22	0	0
7	28485206	.	G	A	3	4	7	0	1	8	0	0
7	28485287	.	T	A	1	4	5	0	1	6	0	0
7	28499926	.	G	A	3	7	10	0	1	11	0	0
7	28513074	.	G	A	3	3	6	0	0	6	0	0
7	28515998	.	T	C	3	0	3	0	5	8	0	0
7	28516154	.	A	G	5	6	11	0	1	12	0	0
7	28516231	.	A	G	2	4	6	0	0	6	0	0
7	28516250	.	G	A	3	3	6	0	0	6	0	0
7	28517010	.	A	C	3	3	6	0	0	6	0	0
7	28559907	.	G	A	17	11	28	0	1	29	0	0
7	28559969	.	G	T	20	5	25	0	0	25	0	0
7	28560250	.	G	C	13	17	30	0	1	31	0	0
7	28560256	.	G	A	10	21	31	0	1	32	0	0
7	28560467	.	C	G	18	16	34	0	1	35	0	0
7	28562196	.	A	G	24	17	41	0	3	44	0	0
7	28570209	.	T	C	3	3	6	0	1	7	0	0
7	28580690	.	C	T	1	3	4	0	0	4	0	0
7	28580691	.	T	C	1	3	4	0	0	4	0	0
7	28599977	.	G	T	2	2	4	0	0	4	0	0
7	28612726	.	T	C	16	17	33	0	2	35	0	0
7	28612899	.	G	A	4	10	14	0	15	29	0	0
7	28612929	.	A	G	20	14	34	0	0	34	0	0
7	28612962	.	G	A	11	19	30	0	1	31	0	0
7	28615709	.	T	C	13	17	30	1	0	31	0	0
7	28615850	.	G	A	15	17	32	0	4	36	0	0
7	28615922	.	A	G	11	1	12	0	12	24	0	0
7	28618813	.	C	T	34	13	47	3	2	52	0	0
7	28622856	.	G	A	17	15	32	0	5	37	0	0
7	28622970	.	T	C	25	22	47	0	1	48	0	0
7	28623506	.	T	A	4	8	12	0	0	12	0	0
7	28623533	.	A	T	4	2	6	0	0	6	0	0
7	28623823	.	G	T	2	4	6	0	1	7	0	0
7	28623860	.	A	G	6	5	11	0	0	11	0	0
7	28623863	.	A	G	6	5	11	0	0	11	0	0
7	28624106	.	A	T	5	6	11	1	0	12	0	0
7	28624157	.	C	G	2	3	5	1	1	7	0	0
7	28624490	.	T	G	4	3	7	0	0	7	0	0
7	28624688	.	A	T	6	6	12	0	1	13	0	0
7	28624692	.	T	C	6	7	13	0	0	13	0	0
7	28625080	.	G	T	4	5	9	0	0	9	0	0
7	28625145	.	A	T	2	5	7	0	0	7	0	0
7	28625174	.	G	C	1	5	6	0	0	6	0	0
7	28626037	.	G	C	5	2	7	0	0	7	0	0
7	28626098	.	G	A	4	2	6	0	1	7	0	0
7	28636305	.	G	A	2	2	4	0	0	4	0	0
7	29161359	.	G	A	0	6	6	0	1	7	0	0
7	29234155	.	C	T	0	3	3	0	1	4	0	0
7	29969031	.	A	G	3	0	3	0	2	5	0	0
7	30770041	.	A	G	1	8	9	0	1	10	0	0
7	31497837	.	T	C	3	2	5	0	0	5	0	0
7	31500402	.	T	C	1	2	3	0	0	3	0	0
7	32743001	.	A	G	10	0	10	0	5	15	0	0
7	32745052	.	A	G	15	5	20	0	1	21	0	0
7	32746213	.	A	G	27	10	37	0	1	38	0	0
7	32747956	.	A	G	11	0	11	0	13	24	0	0
7	32747973	.	A	G	8	15	23	0	4	27	0	0
7	32748046	.	A	G	25	10	35	0	0	35	0	0
7	32748077	.	A	G	24	0	24	0	11	35	0	0
7	32748203	.	A	G	20	8	28	0	2	30	0	0
7	32815268	.	T	C	8	0	8	0	10	18	0	0
7	34314826	.	A	G	3	2	5	0	0	5	0	0
7	34417537	.	T	A	0	6	6	0	1	7	0	0
7	34774010	.	T	C	1	7	8	0	0	8	0	0
7	35241706	.	T	C	1	3	4	0	1	5	0	0
7	35283238	.	T	A	6	2	8	0	0	8	0	0
7	35283780	.	T	C	4	0	4	0	3	7	0	0
7	35422783	.	G	A	2	2	4	0	0	4	0	0
7	36551682	.	C	T	1	6	7	0	0	7	0	0
7	37585016	.	T	A	4	2	6	0	0	6	0	0
7	38308551	.	G	T	4	3	7	0	0	7	0	0
7	38340539	.	T	C	2	0	2	0	4	6	0	0
7	38379379	.	T	C	1	2	3	0	0	3	0	0
7	38392031	.	C	T	5	5	10	0	1	11	0	0
7	38392422	.	A	C	4	4	8	0	2	10	0	0
7	38392424	.	C	T	5	4	9	0	1	10	0	0
7	38456516	.	C	A	4	3	7	0	0	7	0	0
7	38456517	.	C	T	4	3	7	0	0	7	0	0
7	38456578	.	T	C	4	4	8	0	0	8	0	0
7	38456592	.	A	T	4	5	9	0	0	9	0	0
7	38476911	.	T	A	5	8	13	0	0	13	0	0
7	38476976	.	C	T	6	4	10	0	0	10	0	0
7	38477026	.	C	T	6	10	16	0	7	23	0	0
7	38477075	.	G	A	3	10	13	0	0	13	0	0
7	38477196	.	C	T	4	5	9	0	0	9	0	0
7	38500104	.	T	C	2	4	6	0	1	7	0	0
7	38529272	.	G	T	3	3	6	0	0	6	0	0
7	38529290	.	C	T	3	2	5	0	0	5	0	0
7	38529350	.	C	T	1	3	4	0	0	4	0	0
7	38529374	.	A	G	1	0	1	0	3	4	0	0
7	38529503	.	C	T	1	2	3	0	0	3	0	0
7	38529617	.	G	T	0	2	2	0	1	3	0	0
7	38529623	.	C	T	0	2	2	0	0	2	0	0
7	38529680	.	G	A	4	3	7	0	0	7	0	0
7	38529689	.	C	G	2	0	2	0	6	8	0	0
7	38529867	.	A	T	4	4	8	0	0	8	0	0
7	38529899	.	C	T	4	2	6	0	0	6	0	0
7	38529950	.	G	T	5	2	7	0	0	7	0	0
7	38531729	.	G	A	1	3	4	0	0	4	0	0
7	38533013	.	T	C	4	5	9	0	1	10	0	0
7	38533048	.	C	A	3	3	6	0	0	6	0	0
7	38533225	.	G	T	5	5	10	0	0	10	0	0
7	38533250	.	C	G	5	3	8	0	0	8	0	0
7	38533683	.	A	T	5	6	11	0	0	11	0	0
7	38536370	.	C	T	20	15	35	0	1	36	0	0
7	38536416	.	C	T	23	15	38	0	0	38	0	0
7	38536697	.	A	G	18	6	24	0	1	25	0	0
7	38536703	.	A	T	18	7	25	0	0	25	0	0
7	38536889	.	G	T	15	14	29	0	1	30	0	0
7	38537085	.	T	A	16	10	26	0	0	26	0	0
7	38537345	.	C	T	12	14	26	0	2	28	0	0
7	38537657	.	C	T	15	10	25	0	0	25	0	0
7	38539320	.	T	A	3	6	9	0	1	10	0	0
7	38539554	.	A	G	11	8	19	0	1	20	0	0
7	38539577	.	A	G	8	6	14	0	1	15	0	0
7	38539643	.	C	A	8	7	15	0	0	15	0	0
7	38539730	.	G	A	9	5	14	0	0	14	0	0
7	38539768	.	T	A	11	9	20	0	1	21	0	0
7	38539992	.	G	A	13	7	20	0	2	22	0	0
7	38540134	.	G	A	10	14	24	0	0	24	0	0
7	38544706	.	A	G	8	10	18	0	0	18	0	0
7	38552294	.	T	C	8	6	14	0	1	15	0	0
7	38570789	.	C	T	9	5	14	0	1	15	0	0
7	38578128	.	T	C	6	10	16	0	0	16	0	0
7	38578140	.	T	C	6	9	15	0	0	15	0	0
7	38588890	.	T	G	4	12	16	0	0	16	0	0
7	38594474	.	A	C	15	14	29	0	0	29	0	0
7	38594510	.	G	C	15	11	26	0	1	27	0	0
7	38600226	.	A	G	19	12	31	0	1	32	0	0
7	38600265	.	T	C	29	15	44	0	0	44	0	0
7	38600483	.	A	G	25	14	39	0	0	39	0	0
7	38600585	.	C	T	3	18	21	1	32	54	0	0
7	38600892	.	G	A	23	24	47	0	1	48	0	0
7	38600982	.	G	A	42	25	67	0	2	69	0	0
7	38601025	.	G	T	46	20	66	0	3	69	0	0
7	38601067	.	G	T	48	15	63	0	2	65	0	0
7	38601156	.	G	T	29	15	44	0	3	47	0	0
7	38601374	.	C	T	33	36	69	0	2	71	0	0
7	38601391	.	T	A	25	43	68	0	3	71	0	0
7	38601417	.	A	C	26	42	68	1	0	69	0	0
7	38601625	.	C	A	44	13	57	0	0	57	0	0
7	38601646	.	G	A	35	25	60	0	1	61	0	0
7	38601751	.	T	C	41	19	60	0	1	61	0	0
7	38601759	.	C	G	45	17	62	0	3	65	0	0
7	38601823	.	C	A	4	14	18	3	38	59	0	0
7	38601909	.	C	T	3	16	19	0	44	63	0	0
7	38602123	.	C	T	38	21	59	0	2	61	0	0
7	38602160	.	A	T	31	21	52	0	0	52	0	0
7	38602623	.	T	C	40	28	68	0	4	72	0	0
7	38602656	.	G	A	36	28	64	0	3	67	0	0
7	38602917	.	A	T	42	25	67	0	1	68	0	0
7	38612100	.	A	G	32	22	54	0	0	54	0	0
7	38612109	.	G	A	29	25	54	0	0	54	0	0
7	38671516	.	A	G	11	13	24	0	0	24	0	0
7	38671782	.	T	C	21	6	27	0	0	27	0	0
7	38673259	.	G	A	1	12	13	0	15	28	0	0
7	38674189	.	T	C	13	14	27	0	1	28	0	0
7	38677497	.	T	C	21	14	35	0	1	36	0	0
7	38677880	.	G	T	13	14	27	0	1	28	0	0
7	38677999	.	A	T	12	11	23	0	0	23	0	0
7	38680066	.	G	T	7	4	11	0	0	11	0	0
7	38681322	.	C	T	14	5	19	0	2	21	0	0
7	38683503	.	C	A	13	16	29	0	0	29	0	0
7	38683834	.	T	C	15	19	34	0	2	36	0	0
7	38684830	.	C	T	24	16	40	0	0	40	0	0
7	38684970	.	C	T	19	13	32	0	0	32	0	0
7	38686194	.	C	T	1	3	4	0	0	4	0	0
7	38687535	.	G	A	2	2	4	0	0	4	0	0
7	38689701	.	G	A	0	1	1	0	3	4	0	0
7	38696163	.	A	G	32	37	69	0	3	72	0	0
7	38703434	.	T	A	4	3	7	0	0	7	0	0
7	38703509	.	C	T	0	3	3	0	4	7	0	0
7	38703598	.	C	T	8	7	15	0	1	16	0	0
7	38704006	.	G	A	5	7	12	0	0	12	0	0
7	38704009	.	G	A	5	7	12	0	0	12	0	0
7	38704063	.	T	C	3	16	19	0	0	19	0	0
7	38704622	.	C	A	6	4	10	0	2	12	0	0
7	38704623	.	T	C	6	0	6	0	5	11	0	0
7	38704754	.	C	T	3	5	8	0	2	10	0	0
7	38704832	.	G	A	5	4	9	0	0	9	0	0
7	38704834	.	A	G	5	3	8	0	1	9	0	0
7	38705012	.	A	T	6	10	16	0	0	16	0	0
7	38705097	.	A	C	5	1	6	0	6	12	0	0
7	38705367	.	C	G	0	9	9	0	2	11	0	0
7	38709326	.	G	T	10	9	19	0	2	21	0	0
7	38709701	.	G	A	4	5	9	0	0	9	0	0
7	38717795	.	G	A	0	11	11	0	7	18	0	0
7	38717819	.	A	C	8	12	20	0	2	22	0	0
7	38726646	.	A	G	9	17	26	0	1	27	0	0
7	38734152	.	G	A	0	10	10	0	7	17	0	0
7	38734276	.	T	G	8	12	20	0	0	20	0	0
7	38734431	.	C	A	19	8	27	0	0	27	0	0
7	38734475	.	A	C	16	10	26	0	0	26	0	0
7	38734527	.	T	C	13	13	26	0	2	28	0	0
7	38734573	.	A	G	17	18	35	0	0	35	0	0
7	38734626	.	G	T	19	24	43	0	2	45	0	0
7	38735363	.	A	G	20	18	38	0	2	40	0	0
7	38735406	.	C	T	18	16	34	0	0	34	0	0
7	38735460	.	G	T	26	15	41	0	0	41	0	0
7	38735465	.	A	C	24	15	39	0	1	40	0	0
7	38735501	.	T	C	29	8	37	0	1	38	0	0
7	38735711	.	G	A	15	10	25	0	0	25	0	0
7	38735727	.	A	T	12	9	21	0	2	23	0	0
7	38735827	.	A	C	13	7	20	0	3	23	0	0
7	38736320	.	G	C	22	22	44	0	4	48	0	0
7	38736526	.	C	T	6	15	21	0	0	21	0	0
7	38736616	.	T	A	3	4	7	0	0	7	0	0
7	38736818	.	C	A	1	7	8	0	0	8	0	0
7	38736819	.	A	G	1	6	7	0	1	8	0	0
7	38736912	.	T	C	6	9	15	0	0	15	0	0
7	38737020	.	T	C	17	8	25	0	0	25	0	0
7	38737224	.	C	T	14	9	23	0	2	25	0	0
7	38737286	.	C	T	15	9	24	0	2	26	0	0
7	38762091	.	A	C	8	4	12	0	0	12	0	0
7	38762127	.	A	G	15	0	15	0	16	31	0	0
7	38773039	.	C	T	19	13	32	0	2	34	0	0
7	38775075	.	A	G	18	17	35	0	1	36	0	0
7	38775078	.	C	T	16	16	32	0	3	35	0	0
7	38777082	.	C	T	15	16	31	1	5	37	0	0
7	38779759	.	A	G	19	2	21	1	21	43	0	0
7	38783439	.	C	T	16	19	35	0	2	37	0	0
7	38783644	.	A	G	14	18	32	0	1	33	0	0
7	38783742	.	G	A	20	16	36	0	2	38	0	0
7	38783972	.	T	C	13	13	26	2	0	28	0	0
7	38784439	.	A	G	13	17	30	0	1	31	0	0
7	38784648	.	A	G	41	16	57	0	2	59	0	0
7	38784766	.	C	A	18	26	44	0	0	44	0	0
7	38784786	.	T	A	27	22	49	0	1	50	0	0
7	38784818	.	G	A	33	23	56	0	1	57	0	0
7	38784976	.	T	A	13	28	41	1	1	43	0	0
7	38785069	.	C	T	16	22	38	0	0	38	0	0
7	38785182	.	G	C	2	20	22	0	20	42	0	0
7	38785224	.	G	A	1	16	17	0	23	40	0	0
7	38794090	.	T	G	18	8	26	0	1	27	0	0
7	38794235	.	C	T	21	9	30	0	1	31	0	0
7	38798630	.	A	G	15	19	34	0	3	37	0	0
7	38805508	.	T	G	11	13	24	0	1	25	0	0
7	38805781	.	T	A	10	8	18	2	2	22	0	0
7	38807677	.	T	G	14	8	22	0	0	22	0	0
7	38807714	.	G	A	13	15	28	0	0	28	0	0
7	38807723	.	A	T	15	15	30	0	1	31	0	0
7	38807797	.	G	A	7	4	11	0	2	13	0	0
7	38809865	.	G	T	0	6	6	0	1	7	0	0
7	38810084	.	A	C	9	4	13	0	3	16	0	0
7	38822327	.	C	T	3	9	12	0	3	15	0	0
7	38822523	.	G	A	6	5	11	0	1	12	0	0
7	38822528	.	C	A	0	6	6	0	5	12	1	0
7	38822559	.	C	T	0	5	5	0	7	12	0	0
7	38822825	.	T	C	4	3	7	0	0	7	0	0
7	38824259	.	G	A	5	6	11	0	1	12	0	0
7	38824387	.	C	G	2	6	8	0	0	8	0	0
7	38824972	.	G	A	9	8	17	0	0	17	0	0
7	38827635	.	T	A	7	10	17	2	1	20	0	0
7	38836062	.	G	A	6	3	9	0	0	9	0	0
7	38842502	.	C	T	0	4	4	0	6	10	0	0
7	38929578	.	A	T	2	3	5	0	0	5	0	0
7	38929595	.	C	T	3	2	5	0	0	5	0	0
7	38938905	.	A	G	5	2	7	0	0	7	0	0
7	38950644	.	G	A	0	4	4	0	4	8	0	0
7	38953464	.	G	C	4	2	6	0	0	6	0	0
7	38954102	.	T	C	7	5	12	0	1	13	0	0
7	38954158	.	T	A	4	3	7	0	1	8	0	0
7	38962294	.	C	A	3	2	5	0	0	5	0	0
7	38962584	.	T	C	3	3	6	0	0	6	0	0
7	39100137	.	C	A	6	3	9	0	0	9	0	0
7	39123095	.	G	A	1	10	11	0	8	19	0	0
7	39145653	.	C	T	9	9	18	0	0	18	0	0
7	39153769	.	C	A	6	9	15	0	0	15	0	0
7	39153849	.	G	A	0	9	9	1	11	21	0	0
7	39153975	.	G	A	5	4	9	0	0	9	0	0
7	39154119	.	C	T	9	6	15	0	0	15	0	0
7	39154181	.	A	T	4	10	14	0	1	15	0	0
7	39154272	.	A	T	9	6	15	0	0	15	0	0
7	39154844	.	A	G	3	3	6	0	0	6	0	0
7	39154971	.	C	T	10	9	19	0	1	20	0	0
7	39155099	.	C	T	8	10	18	0	0	18	0	0
7	39155115	.	T	C	8	9	17	0	0	17	0	0
7	39155344	.	G	A	8	8	16	0	0	16	0	0
7	39155758	.	T	G	3	4	7	0	0	7	0	0
7	39155940	.	T	A	7	5	12	0	0	12	0	0
7	39156140	.	T	C	9	10	19	0	0	19	0	0
7	39156161	.	C	T	10	7	17	0	1	18	0	0
7	39156207	.	T	C	9	10	19	0	0	19	0	0
7	39156474	.	T	C	13	7	20	0	0	20	0	0
7	39156553	.	C	A	12	11	23	0	1	24	0	0
7	39156673	.	A	T	7	5	12	0	0	12	0	0
7	39156736	.	A	G	14	5	19	0	0	19	0	0
7	39156760	.	A	G	13	8	21	0	1	22	0	0
7	39157175	.	A	T	13	6	19	0	0	19	0	0
7	39157219	.	G	A	1	10	11	0	3	14	0	0
7	39157239	.	C	A	9	3	12	0	0	12	0	0
7	39174052	.	T	C	28	23	51	0	0	51	0	0
7	39174452	.	G	A	2	26	28	0	32	60	0	0
7	39176261	.	G	A	3	18	21	2	34	57	0	0
7	39176444	.	G	A	2	25	27	0	26	53	0	0
7	39176447	.	A	C	26	26	52	0	1	53	0	0
7	39176739	.	A	T	30	7	37	0	0	37	0	0
7	39176863	.	G	A	13	31	44	0	2	46	0	0
7	39176881	.	G	A	32	10	42	0	3	45	0	0
7	39177067	.	A	G	1	5	6	0	1	7	0	0
7	39177729	.	A	G	9	8	17	0	0	17	0	0
7	39177871	.	C	A	8	13	21	0	0	21	0	0
7	39178123	.	A	G	1	3	4	0	1	5	0	0
7	39181275	.	A	G	18	8	26	0	0	26	0	0
7	39181318	.	C	T	19	11	30	0	0	30	0	0
7	39181597	.	C	A	18	14	32	0	0	32	0	0
7	39181853	.	C	A	9	14	23	0	0	23	0	0
7	39182265	.	T	C	15	15	30	0	2	32	0	0
7	39182433	.	T	C	10	20	30	0	1	31	0	0
7	39182910	.	G	A	5	16	21	0	0	21	0	0
7	39183045	.	A	G	8	13	21	0	0	21	0	0
7	39256023	.	C	T	1	3	4	0	0	4	0	0
7	39256029	.	T	C	1	0	1	0	3	4	0	0
7	39280721	.	A	T	6	4	10	0	0	10	0	0
7	39474551	.	A	G	1	6	7	0	0	7	0	0
7	39482671	.	C	G	0	4	4	0	1	5	0	0
7	39482674	.	G	C	2	0	2	0	4	6	0	0
7	39537983	.	C	G	5	7	12	0	0	12	0	0
7	39538001	.	T	C	8	4	12	0	1	13	0	0
7	39538153	.	T	C	4	2	6	0	0	6	0	0
7	39541293	.	T	G	5	12	17	0	0	17	0	0
7	39541452	.	A	C	5	6	11	0	1	12	0	0
7	39551880	.	C	T	0	2	2	0	6	8	0	0
7	39552198	.	G	A	7	6	13	0	0	13	0	0
7	39552270	.	G	T	5	4	9	0	0	9	0	0
7	39642671	.	G	A	2	10	12	0	10	22	0	0
7	39643001	.	G	A	10	9	19	0	1	20	0	0
7	39643046	.	A	G	8	6	14	0	1	15	0	0
7	39648980	.	A	G	7	5	12	0	1	13	0	0
7	39649070	.	C	T	6	5	11	0	0	11	0	0
7	39654722	.	C	T	7	9	16	0	1	17	0	0
7	39655392	.	T	G	4	11	15	0	1	16	0	0
7	39655524	.	T	A	8	3	11	0	0	11	0	0
7	39655586	.	C	G	5	4	9	0	0	9	0	0
7	39656372	.	C	T	6	4	10	0	0	10	0	0
7	39656394	.	T	A	9	3	12	0	2	14	0	0
7	39656620	.	G	A	10	6	16	0	1	17	0	0
7	39656916	.	C	T	2	11	13	1	0	14	0	0
7	39656950	.	G	T	4	5	9	2	1	12	0	0
7	39657301	.	C	T	6	2	8	0	0	8	0	0
7	39657693	.	G	T	7	3	10	0	0	10	0	0
7	39658224	.	A	C	8	13	21	0	1	22	0	0
7	39658293	.	C	A	7	13	20	0	0	20	0	0
7	39658356	.	T	C	9	7	16	0	0	16	0	0
7	39658445	.	C	A	11	9	20	0	0	20	0	0
7	39658730	.	G	T	3	13	16	0	20	36	0	0
7	39658831	.	T	G	10	20	30	0	2	32	0	0
7	39659275	.	A	C	7	8	15	0	0	15	0	0
7	39659400	.	T	A	3	3	6	2	0	8	0	0
7	39659711	.	A	C	5	4	9	2	0	11	0	0
7	39659758	.	C	A	4	2	6	3	1	10	0	0
7	39659806	.	G	A	6	14	20	0	0	20	0	0
7	39660054	.	A	C	12	6	18	0	2	20	0	0
7	39660201	.	G	A	14	11	25	0	4	29	0	0
7	39660249	.	A	C	21	20	41	0	0	41	0	0
7	39670892	.	G	C	12	16	28	0	1	29	0	0
7	39671118	.	T	A	6	9	15	0	2	17	0	0
7	39671281	.	G	A	9	21	30	0	0	30	0	0
7	39671647	.	C	T	10	11	21	0	0	21	0	0
7	39671715	.	A	C	6	8	14	0	0	14	0	0
7	39672054	.	A	T	9	11	20	0	0	20	0	0
7	39672165	.	G	A	10	8	18	0	2	20	0	0
7	39673095	.	A	G	9	1	10	0	9	19	0	0
7	39673773	.	G	C	0	9	9	0	12	21	0	0
7	39675838	.	A	G	6	7	13	0	1	14	0	0
7	39675961	.	T	A	4	2	6	0	1	7	0	0
7	39676183	.	T	A	10	8	18	0	0	19	1	0
7	39676364	.	T	G	6	11	17	0	1	18	0	0
7	39676365	.	C	T	6	11	17	0	1	18	0	0
7	39676446	.	A	T	10	8	18	0	0	18	0	0
7	39676518	.	A	G	6	12	18	0	0	18	0	0
7	39676833	.	T	C	10	15	25	0	0	25	0	0
7	39676947	.	T	G	6	4	10	0	6	16	0	0
7	39676948	.	T	G	9	4	13	0	3	16	0	0
7	39677347	.	G	A	11	19	30	0	0	30	0	0
7	39677948	.	G	T	12	15	27	1	1	29	0	0
7	39691119	.	G	A	2	7	9	0	5	14	0	0
7	39691357	.	G	A	5	5	10	0	1	11	0	0
7	39693686	.	T	C	10	6	16	0	0	16	0	0
7	39701913	.	A	C	7	9	16	0	1	17	0	0
7	39702396	.	A	T	7	3	10	0	1	11	0	0
7	39702413	.	T	C	6	3	9	0	0	9	0	0
7	39702537	.	C	A	1	2	3	0	0	3	0	0
7	39702827	.	C	T	1	3	4	0	1	5	0	0
7	39703139	.	G	A	0	2	2	0	4	6	0	0
7	39704063	.	T	A	8	5	13	0	0	13	0	0
7	39704085	.	A	G	5	7	12	0	1	13	0	0
7	39704166	.	A	T	8	6	14	0	0	14	0	0
7	39704267	.	C	A	7	3	10	0	0	10	0	0
7	39705601	.	A	G	9	4	13	0	1	14	0	0
7	39730787	.	C	T	2	2	4	0	0	4	0	0
7	39731292	.	G	T	1	2	3	0	1	4	0	0
7	39731320	.	A	G	3	3	6	0	0	6	0	0
7	39740885	.	G	C	4	1	5	0	0	5	0	0
7	39740893	.	C	T	4	2	6	0	0	6	0	0
7	39741626	.	C	T	1	3	4	0	0	4	0	0
7	39742820	.	T	G	6	5	11	1	1	13	0	0
7	39742841	.	A	T	9	6	15	1	1	17	0	0
7	39742941	.	G	T	2	3	5	0	0	5	0	0
7	39742946	.	G	T	2	3	5	0	0	5	0	0
7	39743014	.	A	G	2	0	2	0	5	7	0	0
7	39743126	.	G	A	3	3	6	0	0	6	0	0
7	39743163	.	T	A	1	3	4	0	0	4	0	0
7	39743181	.	T	C	1	3	4	0	0	4	0	0
7	39744543	.	G	A	5	6	11	0	0	11	0	0
7	39748847	.	T	C	11	12	23	0	0	23	0	0
7	39748934	.	A	C	16	10	26	0	2	28	0	0
7	39758749	.	G	A	1	4	5	0	0	5	0	0
7	40043273	.	C	T	2	5	7	0	0	7	0	0
7	40043336	.	T	C	2	2	4	0	1	5	0	0
7	40046715	.	G	A	3	3	6	0	2	8	0	0
7	40046734	.	T	C	3	6	9	0	0	9	0	0
7	40050962	.	C	T	4	9	13	0	0	13	0	0
7	40050986	.	G	C	0	10	10	0	3	13	0	0
7	40053306	.	G	A	7	7	14	0	0	14	0	0
7	40053490	.	T	C	7	12	19	0	3	22	0	0
7	40053537	.	C	T	9	13	22	0	0	22	0	0
7	40053717	.	T	A	7	8	15	0	0	15	0	0
7	40053720	.	G	A	8	6	14	0	1	15	0	0
7	40053978	.	C	T	10	5	15	0	0	15	0	0
7	40054234	.	G	A	3	7	10	0	1	11	0	0
7	40054464	.	A	C	4	9	13	0	0	13	0	0
7	40054814	.	C	T	2	5	7	0	0	7	0	0
7	40054901	.	G	T	7	7	14	0	0	14	0	0
7	40054925	.	G	T	0	4	4	0	8	12	0	0
7	40055080	.	T	C	13	11	24	0	1	25	0	0
7	40055099	.	C	T	13	10	23	0	1	24	0	0
7	40055117	.	T	A	13	5	18	0	0	18	0	0
7	40055178	.	C	G	3	15	18	1	3	22	0	0
7	40055219	.	A	T	11	5	16	1	1	18	0	0
7	40055612	.	C	T	5	5	10	0	0	10	0	0
7	40055628	.	G	A	8	6	14	0	0	14	0	0
7	40055672	.	G	A	8	7	15	0	0	15	0	0
7	40055711	.	A	T	5	3	8	0	2	10	0	0
7	40055844	.	C	T	11	12	23	0	0	23	0	0
7	40055928	.	T	C	2	3	5	0	0	5	0	0
7	40055945	.	C	T	4	3	7	0	0	7	0	0
7	40056060	.	C	T	11	9	20	0	1	21	0	0
7	40056243	.	C	A	17	4	21	1	1	23	0	0
7	40056307	.	C	T	12	9	21	0	1	22	0	0
7	40056353	.	G	A	7	8	15	0	0	15	0	0
7	40056417	.	C	A	11	7	18	0	0	18	0	0
7	40056542	.	A	T	7	10	17	0	1	18	0	0
7	40056587	.	C	T	9	8	17	0	1	18	0	0
7	40056589	.	T	C	8	8	16	0	1	17	0	0
7	40056729	.	A	T	7	8	15	0	3	18	0	0
7	40056851	.	T	C	3	7	10	0	0	10	0	0
7	40056854	.	C	T	8	3	11	0	0	11	0	0
7	40056982	.	C	T	3	3	6	0	0	6	0	0
7	40057140	.	G	A	9	8	17	0	0	17	0	0
7	40057393	.	C	T	13	7	20	0	1	21	0	0
7	40057581	.	T	G	9	5	14	0	0	14	0	0
7	40057674	.	A	G	2	4	6	0	1	7	0	0
7	40059207	.	G	A	3	6	9	0	0	9	0	0
7	40059248	.	T	C	9	10	19	0	0	19	0	0
7	40059673	.	G	A	7	3	10	0	1	11	0	0
7	40059986	.	T	C	5	0	5	0	0	5	0	0
7	40060347	.	T	A	2	3	5	0	0	5	0	0
7	40060543	.	A	T	3	2	5	0	0	5	0	0
7	40063669	.	G	T	4	5	9	0	0	9	0	0
7	40070301	.	G	A	5	4	9	0	0	9	0	0
7	40070531	.	C	G	4	2	6	0	0	6	0	0
7	40071267	.	A	T	2	3	5	0	0	5	0	0
7	40071308	.	C	T	2	2	4	0	1	5	0	0
7	40071776	.	G	A	1	2	3	0	0	3	0	0
7	40072371	.	T	G	10	9	19	0	0	19	0	0
7	40074825	.	A	G	9	13	22	0	0	22	0	0
7	40076634	.	T	C	8	0	8	0	14	22	0	0
7	40076782	.	A	G	6	6	12	0	0	12	0	0
7	40079824	.	A	C	2	0	2	0	4	6	0	0
7	40080166	.	C	T	4	7	11	0	2	13	0	0
7	40081813	.	C	T	2	3	5	0	5	10	0	0
7	40083683	.	T	A	6	14	20	0	0	20	0	0
7	40083762	.	C	G	5	8	13	0	0	13	0	0
7	40083786	.	A	T	3	6	9	0	2	11	0	0
7	40083815	.	T	A	2	4	6	0	1	7	0	0
7	40090547	.	T	A	18	17	35	0	1	36	0	0
7	40090602	.	T	C	28	14	42	0	1	43	0	0
7	40091261	.	A	T	4	2	6	0	0	6	0	0
7	40091332	.	C	A	5	7	12	0	1	13	0	0
7	40091396	.	T	A	6	4	10	0	0	10	0	0
7	40091401	.	T	A	3	5	8	0	0	8	0	0
7	40091460	.	C	T	5	6	11	0	0	11	0	0
7	40091510	.	G	T	2	4	6	0	0	6	0	0
7	40091543	.	T	C	2	3	5	0	0	5	0	0
7	40091552	.	A	T	4	3	7	0	0	7	0	0
7	40091622	.	C	G	11	9	20	0	2	22	0	0
7	40091718	.	G	A	15	9	24	0	1	25	0	0
7	40091749	.	T	C	16	8	24	0	2	26	0	0
7	40091818	.	T	G	16	8	24	0	0	24	0	0
7	40091951	.	A	T	4	6	10	0	0	10	0	0
7	40091985	.	A	G	1	2	3	0	0	3	0	0
7	40092003	.	T	G	1	3	4	0	0	4	0	0
7	40094359	.	C	A	4	4	8	0	1	9	0	0
7	40097105	.	A	C	2	8	10	0	1	11	0	0
7	40097304	.	C	A	6	2	8	0	1	9	0	0
7	40097313	.	G	C	6	3	9	0	0	9	0	0
7	40097345	.	A	G	4	4	8	0	0	8	0	0
7	40097602	.	A	G	5	0	5	0	6	11	0	0
7	40097681	.	T	A	3	6	9	0	0	9	0	0
7	40100168	.	A	C	4	7	11	0	0	11	0	0
7	40104296	.	T	C	2	2	4	0	0	4	0	0
7	40123342	.	T	C	2	2	4	0	0	4	0	0
7	40123350	.	A	T	2	2	4	0	0	4	0	0
7	40123989	.	T	C	1	0	1	0	5	6	0	0
7	40126615	.	T	C	1	2	3	0	0	3	0	0
7	40127153	.	A	G	1	3	4	0	0	4	0	0
7	40138226	.	A	G	1	2	3	0	0	3	0	0
7	40138250	.	G	C	1	2	3	0	0	3	0	0
7	40138268	.	C	T	1	2	3	0	0	3	0	0
7	40140399	.	T	C	5	6	11	0	0	11	0	0
7	40144195	.	C	T	3	4	7	0	0	7	0	0
7	40144329	.	T	A	2	2	4	0	0	4	0	0
7	40144339	.	C	T	2	3	5	0	0	5	0	0
7	40144428	.	T	A	4	2	6	0	0	6	0	0
7	40145032	.	A	T	5	4	9	0	0	9	0	0
7	40183152	.	A	G	2	2	4	0	0	4	0	0
7	40183822	.	T	A	6	4	10	0	0	10	0	0
7	40183825	.	G	A	6	3	9	0	0	9	0	0
7	40185017	.	G	C	3	3	6	0	0	6	0	0
7	40188991	.	C	T	5	4	9	0	0	9	0	0
7	40197623	.	C	A	11	3	14	0	0	14	0	0
7	40200740	.	G	A	5	6	11	0	0	11	0	0
7	40201016	.	C	T	5	8	13	0	1	14	0	0
7	40201108	.	G	T	7	9	16	0	0	16	0	0
7	40201975	.	A	G	9	3	12	0	1	13	0	0
7	40228499	.	A	T	23	24	47	0	2	49	0	0
7	40292834	.	T	C	24	16	40	0	1	41	0	0
7	40318309	.	T	A	19	10	29	1	4	34	0	0
7	40318486	.	A	G	29	1	30	0	13	43	0	0
7	40318580	.	G	T	14	12	26	0	0	26	0	0
7	40318593	.	G	A	16	12	28	0	0	28	0	0
7	40320956	.	A	C	12	16	28	0	0	28	0	0
7	40321174	.	C	T	15	21	36	0	2	38	0	0
7	40321224	.	A	G	16	21	37	0	2	39	0	0
7	40321273	.	G	T	17	27	44	0	0	44	0	0
7	40321443	.	C	T	18	17	35	0	2	37	0	0
7	40460256	.	T	C	28	26	54	0	2	56	0	0
7	40460371	.	C	T	17	24	41	0	1	42	0	0
7	40466026	.	A	G	26	34	60	0	0	60	0	0
7	40471301	.	A	G	29	24	53	0	1	54	0	0
7	40492740	.	T	A	37	25	62	0	4	66	0	0
7	40492764	.	G	C	4	32	36	0	36	72	0	0
7	40492789	.	T	C	42	22	64	0	2	66	0	0
7	40492800	.	G	T	41	19	60	0	2	63	1	0
7	40498598	.	G	A	21	27	48	0	2	50	0	0
7	40498934	.	C	A	21	25	46	0	1	47	0	0
7	40499177	.	A	C	10	15	25	0	2	27	0	0
7	40499182	.	A	G	9	14	23	0	0	23	0	0
7	40560398	.	C	T	2	3	5	0	1	6	0	0
7	40560934	.	G	A	13	10	23	0	1	24	0	0
7	40561366	.	G	A	2	4	6	1	0	7	0	0
7	40562662	.	C	T	0	5	5	0	4	9	0	0
7	40562743	.	G	A	5	3	8	0	0	8	0	0
7	40562757	.	T	G	4	2	6	0	1	7	0	0
7	40567075	.	T	C	13	5	18	0	0	18	0	0
7	40569966	.	G	A	8	6	14	0	0	14	0	0
7	40578658	.	C	G	8	10	18	0	0	18	0	0
7	40584065	.	A	C	7	6	13	0	3	16	0	0
7	40584121	.	A	C	16	14	30	0	0	30	0	0
7	40584148	.	T	C	14	0	14	0	14	28	0	0
7	40584321	.	T	A	12	3	15	0	0	15	0	0
7	40584337	.	C	G	9	5	14	0	0	14	0	0
7	40584395	.	G	C	10	16	26	0	0	26	0	0
7	40584415	.	G	C	12	14	26	0	0	26	0	0
7	40584469	.	C	T	9	8	17	0	1	18	0	0
7	40584988	.	A	C	4	10	14	0	0	14	0	0
7	40585112	.	A	G	3	5	8	0	0	8	0	0
7	40585138	.	T	A	3	0	3	0	6	9	0	0
7	40585217	.	T	C	7	6	13	0	0	13	0	0
7	40585546	.	A	T	2	8	10	0	1	11	0	0
7	40602439	.	G	A	11	3	14	0	0	14	0	0
7	40605299	.	T	A	7	3	10	0	0	10	0	0
7	40607911	.	T	A	11	3	14	0	3	17	0	0
7	40608459	.	T	C	4	0	4	0	4	8	0	0
7	40615603	.	T	C	3	2	5	0	0	5	0	0
7	40615648	.	T	C	2	0	2	0	4	6	0	0
7	40617137	.	G	C	1	3	4	0	0	4	0	0
7	40617139	.	G	A	1	3	4	0	0	4	0	0
7	40624281	.	A	T	4	3	7	0	0	7	0	0
7	40626449	.	C	T	2	5	7	0	0	7	0	0
7	40630634	.	A	C	3	0	3	0	2	5	0	0
7	40640033	.	A	G	1	0	1	0	2	3	0	0
7	40645217	.	A	G	8	5	13	0	0	13	0	0
7	40649674	.	G	A	2	2	4	0	1	5	0	0
7	40707966	.	G	A	1	4	5	0	2	7	0	0
7	40708059	.	A	G	6	3	9	0	0	9	0	0
7	40884570	.	T	C	3	4	7	0	0	7	0	0
7	40890678	.	G	A	3	9	12	0	2	14	0	0
7	40900772	.	G	A	7	7	14	1	0	15	0	0
7	40900785	.	C	A	2	7	9	1	10	20	0	0
7	40901322	.	C	T	5	2	7	0	0	7	0	0
7	40901425	.	T	A	4	4	8	0	0	8	0	0
7	40901436	.	G	A	4	5	9	0	1	10	0	0
7	40901584	.	A	C	3	6	9	0	0	9	0	0
7	40901621	.	T	G	0	8	8	0	0	8	0	0
7	40901628	.	A	G	2	7	9	0	0	9	0	0
7	40901659	.	A	G	4	3	7	0	0	7	0	0
7	40901704	.	C	T	0	5	5	0	2	7	0	0
7	40901779	.	C	G	7	5	12	0	1	13	0	0
7	40901945	.	T	C	12	9	21	0	0	21	0	0
7	40903292	.	G	A	1	9	10	0	1	11	0	0
7	40903491	.	T	A	9	9	18	0	0	18	0	0
7	40903915	.	C	A	0	2	2	0	2	4	0	0
7	40904099	.	A	G	5	6	11	0	0	11	0	0
7	40904129	.	T	A	4	6	10	0	0	10	0	0
7	40904167	.	A	G	3	2	5	0	0	5	0	0
7	40904277	.	C	T	1	2	3	0	0	3	0	0
7	40904446	.	C	T	3	3	6	3	0	9	0	0
7	40904709	.	A	C	2	3	5	0	0	5	0	0
7	40904949	.	G	T	5	3	8	0	0	8	0	0
7	40905103	.	C	T	4	3	7	0	0	7	0	0
7	40905695	.	A	T	11	9	20	0	1	21	0	0
7	40905774	.	C	T	0	9	9	0	22	31	0	0
7	40906286	.	T	C	10	9	19	0	0	19	0	0
7	40906516	.	C	A	0	3	3	0	9	12	0	0
7	40935308	.	C	T	7	10	17	0	1	18	0	0
7	40942588	.	G	C	5	9	14	0	0	14	0	0
7	40951391	.	G	A	5	6	11	0	1	12	0	0
7	40989156	.	A	G	5	5	10	0	0	10	0	0
7	40990473	.	G	C	7	4	11	0	0	11	0	0
7	40990589	.	T	A	7	3	10	0	0	10	0	0
7	40993298	.	G	A	10	7	17	0	0	17	0	0
7	40993422	.	G	A	13	10	23	0	1	24	0	0
7	40993442	.	T	G	11	7	18	0	1	19	0	0
7	41008618	.	T	C	12	9	21	0	0	21	0	0
7	41008856	.	C	T	0	11	11	0	10	21	0	0
7	41009217	.	C	T	0	16	16	0	15	31	0	0
7	41009797	.	T	A	20	13	33	1	1	35	0	0
7	41012081	.	A	T	7	13	20	0	2	22	0	0
7	41012505	.	C	T	0	10	10	0	11	21	0	0
7	41082391	.	T	G	3	3	6	0	0	6	0	0
7	41082686	.	A	T	5	2	7	0	0	7	0	0
7	41082802	.	G	A	1	3	4	0	0	4	0	0
7	41082931	.	C	T	2	2	4	0	1	5	0	0
7	41147792	.	A	G	15	0	15	0	14	29	0	0
7	41153792	.	A	G	30	1	31	0	10	41	0	0
7	41157531	.	G	C	14	16	30	0	1	31	0	0
7	41157735	.	T	C	20	17	37	0	1	38	0	0
7	41157805	.	C	A	21	16	37	0	3	40	0	0
7	41157997	.	G	A	16	12	28	1	1	30	0	0
7	41158057	.	C	T	13	13	26	1	0	27	0	0
7	41223561	.	C	T	4	2	6	0	1	7	0	0
7	41229427	.	T	C	7	8	15	0	0	15	0	0
7	41238313	.	C	T	6	10	16	0	0	16	0	0
7	41238671	.	T	C	1	7	8	0	0	8	0	0
7	41244570	.	C	G	7	0	7	0	13	20	0	0
7	41249282	.	A	G	2	6	8	0	1	9	0	0
7	41249387	.	T	C	2	6	8	0	0	8	0	0
7	41249526	.	C	T	1	3	4	0	1	5	0	0
7	41249613	.	A	G	8	0	8	0	5	13	0	0
7	41250813	.	T	C	4	9	13	0	0	13	0	0
7	41255443	.	A	T	12	14	26	0	3	29	0	0
7	41257549	.	G	T	4	5	9	0	0	9	0	0
7	41258015	.	T	C	5	14	19	0	1	20	0	0
7	41261343	.	C	A	13	16	29	0	0	30	1	0
7	41262058	.	T	G	9	14	23	0	0	23	0	0
7	41262277	.	A	G	7	15	22	0	0	22	0	0
7	41262361	.	G	A	7	12	19	0	1	20	0	0
7	41263277	.	G	A	1	9	10	0	14	24	0	0
7	41267424	.	C	T	10	14	24	0	1	25	0	0
7	41269653	.	C	G	15	18	33	0	1	34	0	0
7	41273527	.	T	C	9	12	21	0	0	21	0	0
7	41273889	.	T	C	11	6	17	0	1	18	0	0
7	41274080	.	T	G	10	12	22	0	0	22	0	0
7	41274258	.	T	C	11	13	24	0	0	24	0	0
7	41274261	.	A	G	11	1	12	0	12	24	0	0
7	41274802	.	C	A	12	7	19	0	3	22	0	0
7	41274896	.	A	C	13	10	23	0	4	27	0	0
7	41274916	.	A	C	15	13	28	0	1	29	0	0
7	41274943	.	T	A	16	15	31	0	0	31	0	0
7	41313645	.	G	A	2	4	6	0	0	6	0	0
7	41313853	.	C	A	3	9	12	0	0	12	0	0
7	41313894	.	G	C	4	6	10	0	0	10	0	0
7	41313920	.	C	A	5	4	9	0	0	9	0	0
7	41314900	.	G	T	4	11	15	0	1	16	0	0
7	41316722	.	T	G	6	6	12	0	1	13	0	0
7	41322440	.	G	A	1	3	4	0	0	4	0	0
7	41326482	.	A	G	1	2	3	0	0	3	0	0
7	41329674	.	T	G	2	2	4	0	0	4	0	0
7	41329683	.	A	G	1	2	3	0	0	3	0	0
7	41329736	.	C	T	2	4	6	0	1	7	0	0
7	41329778	.	A	G	3	0	3	0	4	7	0	0
7	41329840	.	G	A	3	2	5	0	0	5	0	0
7	41329885	.	C	G	5	2	7	0	0	7	0	0
7	41330106	.	A	T	2	2	4	0	0	4	0	0
7	41331258	.	G	A	3	2	5	0	0	5	0	0
7	41336553	.	C	T	0	2	2	0	4	6	0	0
7	41340562	.	C	T	1	3	4	0	0	4	0	0
7	41340641	.	T	C	2	6	8	0	0	8	0	0
7	41340840	.	C	A	3	4	7	0	0	7	0	0
7	41345059	.	G	A	3	2	5	0	0	5	0	0
7	41345105	.	C	T	1	3	4	0	0	4	0	0
7	41345123	.	C	T	1	3	4	0	0	4	0	0
7	41345282	.	A	C	7	4	11	0	0	11	0	0
7	41345375	.	T	C	5	2	7	0	1	8	0	0
7	41345393	.	A	T	2	3	5	0	0	5	0	0
7	41345463	.	T	G	6	3	9	0	0	9	0	0
7	41345720	.	G	A	3	5	8	0	0	8	0	0
7	41345723	.	T	C	3	5	8	0	0	8	0	0
7	41345828	.	G	T	10	9	19	0	1	20	0	0
7	41347123	.	A	G	4	0	4	0	4	8	0	0
7	41347138	.	C	T	5	4	9	0	0	9	0	0
7	41347642	.	T	C	3	4	7	0	1	8	0	0
7	41347813	.	C	T	2	2	4	0	0	4	0	0
7	41347897	.	C	T	1	5	6	0	0	6	0	0
7	41348023	.	C	T	1	3	4	0	0	4	0	0
7	41348026	.	T	C	1	3	4	0	0	4	0	0
7	41349128	.	C	T	1	5	6	0	8	14	0	0
7	41349454	.	G	T	6	4	10	0	0	10	0	0
7	41350424	.	A	G	3	5	8	0	0	8	0	0
7	41352145	.	T	A	6	4	10	0	1	11	0	0
7	41353258	.	G	A	6	6	12	0	0	12	0	0
7	41355308	.	T	C	2	8	10	0	0	10	0	0
7	41356140	.	T	C	2	4	6	0	1	7	0	0
7	41356188	.	A	G	3	4	7	0	0	8	1	0
7	41356547	.	C	T	3	6	9	0	0	9	0	0
7	41357331	.	C	T	6	1	7	0	4	11	0	0
7	41357602	.	G	A	2	6	8	0	1	9	0	0
7	41357623	.	G	C	2	3	5	0	1	6	0	0
7	41358645	.	A	G	7	6	13	0	1	14	0	0
7	41359972	.	C	T	4	3	7	0	0	7	0	0
7	41359987	.	A	T	3	4	7	0	0	7	0	0
7	41361864	.	A	G	4	4	8	0	0	8	0	0
7	41362029	.	G	A	1	2	3	0	0	3	0	0
7	41362945	.	A	G	5	3	8	0	0	8	0	0
7	41363510	.	C	T	2	4	6	0	0	6	0	0
7	41364202	.	C	T	2	4	6	0	0	6	0	0
7	41364641	.	A	G	1	4	5	0	0	5	0	0
7	41364668	.	C	T	2	5	7	0	0	7	0	0
7	41367337	.	G	A	2	5	7	0	0	7	0	0
7	41367380	.	A	T	2	4	6	0	0	6	0	0
7	41374157	.	A	G	1	2	3	0	0	3	0	0
7	41374297	.	C	T	1	2	3	0	0	3	0	0
7	41377188	.	A	G	2	3	5	0	0	5	0	0
7	41401851	.	C	T	3	7	10	0	0	10	0	0
7	41401881	.	T	C	4	3	7	0	0	7	0	0
7	41402079	.	C	T	0	2	2	0	4	6	0	0
7	41402943	.	C	G	1	4	5	0	0	5	0	0
7	41403991	.	A	T	6	2	8	0	0	8	0	0
7	41404081	.	C	T	16	5	21	0	0	21	0	0
7	41404090	.	T	C	13	5	18	0	2	20	0	0
7	41404242	.	A	G	8	4	12	0	1	13	0	0
7	41404552	.	G	A	9	6	15	0	0	15	0	0
7	41404564	.	A	G	8	5	13	0	1	14	0	0
7	41404679	.	T	G	7	2	9	0	0	9	0	0
7	41413760	.	C	T	4	4	8	0	0	8	0	0
7	41413781	.	A	T	4	3	7	0	0	7	0	0
7	41419036	.	A	C	6	5	11	0	0	11	0	0
7	41419132	.	G	A	10	6	16	0	0	16	0	0
7	41419183	.	G	T	7	7	14	0	1	16	1	0
7	41422030	.	T	A	4	3	7	0	0	7	0	0
7	41427737	.	G	T	6	4	10	0	1	11	0	0
7	41430417	.	T	C	5	10	15	0	0	15	0	0
7	41431901	.	A	T	8	9	17	0	1	18	0	0
7	41431916	.	T	C	9	5	14	0	0	14	0	0
7	41432039	.	T	C	5	6	11	0	0	11	0	0
7	41432220	.	G	A	1	9	10	0	11	21	0	0
7	41432324	.	T	A	4	6	10	0	1	11	0	0
7	41432676	.	T	C	7	13	20	0	1	21	0	0
7	41432732	.	A	T	9	11	20	0	0	20	0	0
7	41432906	.	T	C	10	7	17	0	0	17	0	0
7	41433390	.	T	A	4	4	8	0	0	8	0	0
7	41436575	.	T	C	7	0	7	0	3	10	0	0
7	41436811	.	T	A	5	5	10	0	0	10	0	0
7	41436845	.	G	A	6	4	10	0	0	10	0	0
7	41436902	.	A	G	5	4	9	0	0	9	0	0
7	41436907	.	G	A	5	5	10	0	0	10	0	0
7	41437342	.	A	C	13	10	23	0	0	23	0	0
7	41437363	.	A	G	12	11	23	0	0	23	0	0
7	41437623	.	C	A	15	7	22	0	1	23	0	0
7	41437715	.	T	G	10	7	17	0	1	18	0	0
7	41437827	.	C	A	1	8	9	0	14	23	0	0
7	41437948	.	G	A	9	8	17	0	0	17	0	0
7	41438036	.	A	C	8	11	19	0	1	20	0	0
7	41438417	.	T	A	6	7	13	0	0	13	0	0
7	41438502	.	C	T	2	4	6	0	5	11	0	0
7	41438676	.	G	T	10	6	16	0	1	17	0	0
7	41438677	.	T	C	9	6	15	0	1	16	0	0
7	41438826	.	C	T	0	13	13	0	9	22	0	0
7	41438871	.	C	T	1	7	8	0	3	11	0	0
7	41438896	.	C	T	1	5	6	0	2	8	0	0
7	41438970	.	G	A	10	6	16	0	0	16	0	0
7	41439411	.	C	T	0	13	13	0	14	27	0	0
7	41443125	.	G	A	6	5	11	1	0	12	0	0
7	41443186	.	C	T	0	11	11	1	3	15	0	0
7	41452225	.	T	C	8	1	9	0	6	15	0	0
7	41491701	.	A	T	10	3	13	0	0	13	0	0
7	41491785	.	A	G	11	4	15	0	0	15	0	0
7	41491841	.	T	C	5	5	10	0	1	11	0	0
7	41496791	.	G	A	7	8	15	0	0	15	0	0
7	41498075	.	T	C	13	5	18	0	0	18	0	0
7	41500538	.	A	G	12	7	19	0	0	19	0	0
7	41500676	.	G	A	4	8	12	0	0	12	0	0
7	41501061	.	A	G	3	9	12	0	1	13	0	0
7	41501124	.	A	G	6	9	15	0	0	15	0	0
7	41503775	.	G	A	5	3	8	0	0	8	0	0
7	41506677	.	A	G	2	5	7	0	0	7	0	0
7	41506683	.	T	C	1	4	5	0	1	6	0	0
7	41511558	.	T	C	5	4	9	0	0	9	0	0
7	41511626	.	C	T	2	6	8	0	0	8	0	0
7	41511804	.	T	C	5	4	9	0	2	11	0	0
7	41511939	.	A	C	7	4	11	0	0	11	0	0
7	41512833	.	T	A	3	3	6	0	0	6	0	0
7	41517442	.	C	G	8	6	14	0	0	14	0	0
7	41517467	.	A	G	5	7	12	0	0	12	0	0
7	41517777	.	T	A	5	4	9	0	0	9	0	0
7	41517796	.	T	C	4	4	8	0	1	9	0	0
7	41517909	.	T	A	7	5	12	0	0	12	0	0
7	41517978	.	A	G	4	8	12	0	0	12	0	0
7	41518033	.	G	A	6	7	13	0	0	13	0	0
7	41518109	.	C	A	5	13	18	0	1	19	0	0
7	41518146	.	G	A	7	3	10	0	0	10	0	0
7	41518147	.	C	G	6	3	9	0	1	10	0	0
7	41518217	.	C	A	0	8	8	0	6	14	0	0
7	41518328	.	T	G	7	9	16	0	0	16	0	0
7	41518420	.	G	C	8	6	14	0	1	15	0	0
7	41518663	.	A	G	11	5	16	0	0	16	0	0
7	41518721	.	G	T	9	8	17	0	0	17	0	0
7	41518727	.	C	T	11	6	17	0	2	19	0	0
7	41518871	.	T	G	6	5	11	0	0	11	0	0
7	41518875	.	G	A	5	3	8	0	0	8	0	0
7	41519283	.	A	C	1	2	3	0	0	3	0	0
7	41519284	.	G	A	1	1	2	0	1	3	0	0
7	41550790	.	T	A	1	6	7	0	0	7	0	0
7	41574673	.	C	G	4	7	11	0	0	11	0	0
7	41627738	.	C	T	0	5	5	0	3	8	0	0
7	41627745	.	C	T	1	5	6	0	1	7	0	0
7	41627849	.	G	C	4	2	6	0	0	6	0	0
7	41635183	.	A	T	1	2	3	0	0	3	0	0
7	41645970	.	T	C	2	0	2	0	2	4	0	0
7	41713997	.	G	A	4	2	6	0	0	6	0	0
7	41714059	.	C	T	1	5	6	0	6	12	0	0
7	41714076	.	A	T	7	4	11	0	1	12	0	0
7	41714140	.	C	T	1	4	5	0	8	13	0	0
7	41714196	.	T	A	4	5	9	1	0	11	1	0
7	41714205	.	C	T	4	5	9	1	1	11	0	0
7	41714244	.	A	G	2	4	6	0	0	6	0	0
7	41714377	.	T	G	5	4	9	0	0	9	0	0
7	41714453	.	T	C	12	9	21	0	0	21	0	0
7	41714481	.	C	T	7	11	18	0	1	19	0	0
7	41714923	.	G	A	6	9	15	0	1	16	0	0
7	41715156	.	A	T	1	4	5	0	0	5	0	0
7	41715288	.	C	T	0	2	2	0	3	5	0	0
7	41715446	.	G	A	11	6	17	0	1	18	0	0
7	41715594	.	T	A	10	6	16	0	1	17	0	0
7	41715721	.	T	A	9	8	17	0	0	17	0	0
7	41715794	.	C	T	1	6	7	0	7	14	0	0
7	41726280	.	A	C	4	0	4	0	6	10	0	0
7	41726339	.	C	T	2	4	6	0	12	18	0	0
7	41726355	.	G	T	11	6	17	0	1	18	0	0
7	41726580	.	A	C	12	5	17	0	0	17	0	0
7	41748916	.	G	T	8	7	15	0	1	16	0	0
7	41749093	.	A	T	6	5	11	0	1	12	0	0
7	41749150	.	A	G	9	7	16	0	0	16	0	0
7	41749382	.	C	T	12	9	21	0	1	22	0	0
7	41751146	.	C	T	13	9	22	0	1	23	0	0
7	41751510	.	T	C	12	6	18	0	0	18	0	0
7	41751671	.	C	T	11	8	19	0	1	20	0	0
7	41752422	.	G	T	18	5	23	2	2	27	0	0
7	41752440	.	A	C	23	9	32	2	0	34	0	0
7	41752463	.	A	G	24	0	24	2	11	37	0	0
7	41752497	.	C	A	20	6	26	6	2	34	0	0
7	41752507	.	C	G	17	5	22	7	1	30	0	0
7	41752590	.	T	C	14	4	18	2	1	21	0	0
7	41752631	.	A	G	14	8	22	0	2	25	1	0
7	41752662	.	G	A	19	10	29	0	2	31	0	0
7	41752892	.	T	A	11	7	18	0	2	20	0	0
7	41752974	.	T	G	7	0	7	0	11	19	1	0
7	41753195	.	A	T	7	8	15	0	1	16	0	0
7	41757730	.	G	A	24	19	43	0	1	44	0	0
7	41773951	.	T	G	19	20	39	0	0	39	0	0
7	41774020	.	A	G	14	18	32	0	2	34	0	0
7	41774035	.	G	A	13	26	39	0	1	40	0	0
7	41774125	.	A	G	16	21	37	0	2	39	0	0
7	41780925	.	A	T	15	18	33	0	5	38	0	0
7	41791391	.	A	G	9	4	13	0	0	13	0	0
7	41791469	.	T	C	22	16	38	0	0	38	0	0
7	41791538	.	G	A	20	19	39	0	1	40	0	0
7	41791857	.	C	T	27	14	41	0	1	42	0	0
7	41791920	.	C	T	21	13	34	0	1	35	0	0
7	41805215	.	G	T	8	18	26	0	0	26	0	0
7	41805518	.	C	T	4	9	13	0	0	13	0	0
7	41805881	.	G	A	9	14	23	0	1	24	0	0
7	41873256	.	C	T	19	5	24	0	0	24	0	0
7	41873257	.	T	G	19	5	24	0	0	24	0	0
7	41873368	.	T	A	15	7	22	0	0	22	0	0
7	41873426	.	T	C	13	13	26	0	0	26	0	0
7	41873503	.	A	G	10	13	23	0	1	24	0	0
7	41873554	.	A	T	14	20	34	0	1	35	0	0
7	41873691	.	T	C	16	17	33	0	1	34	0	0
7	41875951	.	T	C	16	17	33	0	1	34	0	0
7	41887496	.	T	G	1	2	3	0	0	3	0	0
7	41887690	.	C	A	7	4	11	0	0	11	0	0
7	41891612	.	C	G	5	2	7	0	0	7	0	0
7	41896315	.	A	C	2	8	10	0	0	10	0	0
7	41896385	.	A	G	5	2	7	0	0	7	0	0
7	41899051	.	A	C	7	8	15	0	3	18	0	0
7	41899096	.	G	A	2	3	5	0	0	5	0	0
7	41899097	.	C	T	1	3	4	0	0	4	0	0
7	41899187	.	C	T	2	4	6	0	0	6	0	0
7	41899352	.	C	T	2	7	9	0	0	9	0	0
7	41899426	.	C	A	6	4	10	0	0	10	0	0
7	41899674	.	T	C	5	7	12	0	1	13	0	0
7	41900215	.	T	C	2	6	8	0	2	10	0	0
7	41900402	.	G	C	3	6	9	0	1	10	0	0
7	41900937	.	A	G	3	3	6	0	0	6	0	0
7	41901217	.	A	G	6	4	10	0	0	10	0	0
7	41901355	.	A	G	6	8	14	0	0	14	0	0
7	41903633	.	T	A	13	14	27	1	1	29	0	0
7	41903681	.	C	T	16	24	40	0	0	40	0	0
7	41903907	.	A	G	4	10	14	0	1	15	0	0
7	41904152	.	A	G	22	23	45	1	3	49	0	0
7	41904520	.	G	A	34	27	61	0	4	65	0	0
7	41911604	.	C	T	1	25	26	0	21	47	0	0
7	41957814	.	G	A	11	9	20	0	0	20	0	0
7	41995046	.	T	C	8	14	22	0	3	25	0	0
7	42068201	.	C	T	11	7	18	1	0	19	0	0
7	42096376	.	C	A	8	11	19	0	0	19	0	0
7	42096378	.	A	G	8	11	19	0	0	19	0	0
7	42096413	.	C	T	0	7	7	0	12	19	0	0
7	42125466	.	G	A	8	7	15	0	0	15	0	0
7	42125480	.	C	G	8	6	14	0	0	14	0	0
7	42161814	.	G	A	5	7	12	0	0	12	0	0
7	42203869	.	T	C	5	4	9	0	1	10	0	0
7	42229877	.	C	T	4	6	10	1	0	11	0	0
7	42255966	.	C	T	7	4	11	0	2	13	0	0
7	42267249	.	C	T	4	7	11	0	0	11	0	0
7	42267339	.	T	C	11	6	17	0	0	17	0	0
7	42323699	.	G	C	0	13	13	0	7	20	0	0
7	42338816	.	A	G	17	12	29	5	2	36	0	0
7	42345361	.	G	T	10	13	23	0	0	23	0	0
7	42345681	.	T	A	17	12	29	0	2	31	0	0
7	42345782	.	G	A	6	6	12	0	1	13	0	0
7	42545468	.	G	A	3	4	7	0	0	7	0	0
7	42545498	.	C	G	2	0	2	0	3	5	0	0
7	43174642	.	G	A	13	5	18	0	2	20	0	0
7	43309851	.	T	G	9	12	21	0	3	24	0	0
7	43760755	.	T	C	11	4	15	0	5	21	1	0
7	43760757	.	T	C	6	1	7	0	13	21	1	0
7	43760822	.	G	A	14	13	27	0	0	27	0	0
7	43760875	.	T	A	15	12	27	0	0	27	0	0
7	43760881	.	G	A	10	15	25	0	2	28	1	0
7	43761810	.	T	A	13	11	24	0	1	25	0	0
7	43765189	.	A	G	13	8	21	0	0	21	0	0
7	43765197	.	A	G	15	8	23	0	0	23	0	0
7	43765348	.	G	A	11	17	28	0	1	29	0	0
7	43775054	.	G	A	18	13	31	0	1	32	0	0
7	43778690	.	C	G	16	10	26	0	2	28	0	0
7	43781554	.	G	T	13	12	25	0	0	25	0	0
7	43787480	.	C	G	10	4	14	0	0	14	0	0
7	43840624	.	C	T	8	5	13	0	0	13	0	0
7	43840669	.	G	C	7	6	13	0	0	13	0	0
7	44460124	.	T	G	1	2	3	0	0	3	0	0
7	45400754	.	A	T	2	3	5	0	0	5	0	0
7	45400790	.	C	T	10	13	23	0	0	23	0	0
7	45402452	.	C	T	22	24	46	0	1	47	0	0
7	45402887	.	C	A	24	17	41	0	2	43	0	0
7	45402989	.	C	T	18	26	44	0	1	45	0	0
7	45403244	.	C	T	14	19	33	0	1	34	0	0
7	45403292	.	G	A	14	15	29	0	2	31	0	0
7	45403294	.	A	T	12	17	29	0	1	31	1	0
7	45403360	.	T	G	7	20	27	0	1	28	0	0
7	45403370	.	A	T	8	20	28	0	1	29	0	0
7	45403416	.	C	T	18	13	31	0	3	34	0	0
7	45403831	.	A	C	3	6	9	0	1	10	0	0
7	45403844	.	A	T	4	1	5	0	1	9	3	0
7	45403868	.	C	T	5	4	9	0	0	9	0	0
7	45404063	.	T	G	4	4	8	0	0	8	0	0
7	45404079	.	C	A	4	5	9	0	0	9	0	0
7	45404098	.	T	A	4	3	7	0	0	7	0	0
7	45404490	.	C	T	9	6	15	0	1	16	0	0
7	45405163	.	C	T	11	10	21	0	2	23	0	0
7	45405179	.	G	T	10	8	18	0	1	19	0	0
7	45405236	.	T	G	6	0	6	0	3	9	0	0
7	45405244	.	T	C	4	4	8	0	0	8	0	0
7	45405839	.	G	T	6	5	11	0	1	12	0	0
7	45405871	.	A	C	6	4	10	0	1	11	0	0
7	45405992	.	C	T	5	5	10	0	0	10	0	0
7	45966120	.	C	T	4	3	7	0	0	7	0	0
7	45971454	.	A	T	4	4	8	0	0	8	0	0
7	46004948	.	T	G	8	11	19	0	1	20	0	0
7	46004971	.	C	G	11	14	25	0	1	26	0	0
7	46004991	.	C	G	13	0	13	0	13	26	0	0
7	46373295	.	A	G	6	6	12	0	0	12	0	0
7	46373463	.	T	C	2	4	6	0	0	6	0	0
7	46374272	.	T	A	11	7	18	0	2	20	0	0
7	46374390	.	A	G	8	4	12	0	1	13	0	0
7	46430098	.	C	T	7	7	14	0	0	14	0	0
7	46430530	.	G	A	8	9	17	0	0	17	0	0
7	46430696	.	T	A	11	6	17	0	1	18	0	0
7	46430847	.	C	G	10	8	18	0	0	18	0	0
7	46431108	.	T	A	9	14	23	0	1	24	0	0
7	46431256	.	C	A	13	12	25	0	1	26	0	0
7	46431273	.	C	G	10	13	23	0	1	24	0	0
7	46431319	.	A	G	8	10	18	0	0	18	0	0
7	46431577	.	G	A	23	12	35	0	0	35	0	0
7	46486048	.	C	T	5	10	15	0	0	15	0	0
7	46486244	.	A	C	9	10	19	1	2	22	0	0
7	46486629	.	G	A	1	13	14	0	14	28	0	0
7	46486719	.	G	T	19	7	26	0	0	26	0	0
7	46487322	.	C	T	10	13	23	0	0	23	0	0
7	46487652	.	G	A	0	6	6	0	0	6	0	0
7	46487662	.	C	A	3	4	7	0	0	7	0	0
7	46728687	.	G	A	3	9	12	0	1	13	0	0
7	46728721	.	A	C	3	0	3	0	13	16	0	0
7	46728791	.	A	C	11	7	18	2	0	20	0	0
7	46728964	.	A	C	2	3	5	0	0	5	0	0
7	46729545	.	C	T	0	4	4	0	10	14	0	0
7	46730076	.	A	G	10	6	16	0	0	16	0	0
7	46730178	.	A	T	9	9	18	0	2	20	0	0
7	46730199	.	A	C	12	0	12	0	8	20	0	0
7	46730469	.	C	T	15	13	28	0	0	28	0	0
7	46730705	.	C	T	10	8	18	0	1	19	0	0
7	46730754	.	G	A	7	7	14	0	1	15	0	0
7	46730820	.	T	C	4	0	4	0	13	17	0	0
7	46731141	.	C	T	13	8	21	0	0	21	0	0
7	46731669	.	T	C	6	7	13	0	1	14	0	0
7	46732134	.	G	A	3	8	11	0	0	11	0	0
7	46732680	.	G	A	3	3	6	0	1	7	0	0
7	47258637	.	A	T	1	2	3	0	0	3	0	0
7	47265569	.	A	G	4	0	4	0	8	12	0	0
7	47265729	.	T	C	8	7	15	0	0	15	0	0
7	47265859	.	A	T	3	7	10	0	3	13	0	0
7	47265898	.	G	A	2	2	4	0	1	5	0	0
7	47288309	.	C	T	2	4	6	0	0	6	0	0
7	47317344	.	G	A	0	4	4	0	3	7	0	0
7	47323685	.	C	T	5	4	9	0	2	11	0	0
7	47410829	.	C	T	3	9	12	0	1	13	0	0
7	47411071	.	G	A	0	8	8	0	3	11	0	0
7	47411358	.	C	A	3	6	9	0	0	9	0	0
7	47411434	.	C	T	5	7	12	0	0	12	0	0
7	47411791	.	C	G	6	4	10	0	0	10	0	0
7	47411837	.	T	G	10	0	10	0	10	20	0	0
7	47411838	.	G	A	10	10	20	0	0	20	0	0
7	47411962	.	C	A	14	6	20	0	0	20	0	0
7	47412000	.	T	A	13	4	17	0	4	21	0	0
7	47412040	.	C	T	16	7	23	0	1	24	0	0
7	47412173	.	T	C	10	3	13	0	1	14	0	0
7	47412203	.	A	C	11	5	16	0	3	19	0	0
7	47412215	.	C	T	14	5	19	0	0	19	0	0
7	47412366	.	C	T	7	4	11	3	0	14	0	0
7	47412418	.	C	T	4	5	9	0	0	9	0	0
7	47412447	.	T	A	4	5	9	0	0	9	0	0
7	47412495	.	A	G	7	1	8	0	3	11	0	0
7	47412600	.	G	A	2	5	7	0	0	7	0	0
7	47413091	.	A	C	1	4	5	0	1	6	0	0
7	47413408	.	C	A	8	5	13	0	0	13	0	0
7	47413411	.	G	A	7	5	12	0	1	13	0	0
7	47413517	.	C	A	10	4	14	0	0	14	0	0
7	47413691	.	A	T	5	6	11	0	0	11	0	0
7	47413948	.	A	T	7	10	17	0	0	17	0	0
7	47414174	.	C	T	4	8	12	0	2	14	0	0
7	47414233	.	T	A	1	8	9	1	0	10	0	0
7	47414348	.	C	T	14	13	27	0	1	28	0	0
7	47416473	.	G	A	8	8	16	1	0	17	0	0
7	47416496	.	T	A	6	8	14	1	1	16	0	0
7	47416790	.	T	A	5	5	10	0	2	12	0	0
7	47416807	.	A	T	6	7	13	0	0	13	0	0
7	47416825	.	A	G	10	0	10	0	8	18	0	0
7	47416904	.	T	A	6	3	9	1	1	11	0	0
7	47417002	.	C	A	9	7	16	0	0	16	0	0
7	47417080	.	T	C	15	3	18	0	1	19	0	0
7	47417810	.	C	T	3	6	9	0	2	11	0	0
7	47417934	.	T	A	14	4	18	0	2	20	0	0
7	47418575	.	G	T	9	10	19	0	0	19	0	0
7	47418697	.	C	A	13	15	28	0	1	29	0	0
7	47418847	.	T	A	9	6	15	0	0	15	0	0
7	47419114	.	A	C	7	16	23	0	2	25	0	0
7	47419177	.	A	C	12	1	13	0	12	25	0	0
7	47419250	.	T	G	11	8	19	0	0	19	0	0
7	47419653	.	G	A	9	13	22	0	1	23	0	0
7	47419842	.	G	A	17	12	29	0	0	29	0	0
7	47420019	.	A	G	17	12	29	0	0	29	0	0
7	47421313	.	C	T	9	12	21	0	1	22	0	0
7	47448218	.	G	A	6	8	14	0	0	14	0	0
7	47462909	.	G	A	4	11	15	0	0	15	0	0
7	47488246	.	C	T	5	13	18	0	1	19	0	0
7	47488312	.	G	A	14	8	22	0	0	22	0	0
7	47507136	.	G	A	8	13	21	0	2	23	0	0
7	47563359	.	C	T	0	9	9	0	6	15	0	0
7	47563853	.	G	A	4	3	7	0	0	7	0	0
7	47584257	.	C	T	5	4	9	0	0	9	0	0
7	47596554	.	G	A	3	2	5	0	0	5	0	0
7	47596641	.	G	A	3	7	10	0	1	11	0	0
7	47596707	.	T	A	6	4	10	0	1	11	0	0
7	47614319	.	G	A	3	4	7	0	0	7	0	0
7	47614349	.	A	G	3	4	7	0	1	8	0	0
7	47641808	.	T	A	3	2	5	0	0	5	0	0
7	47691435	.	A	G	4	5	9	0	0	9	0	0
7	47691483	.	A	G	4	2	6	0	0	6	0	0
7	47691531	.	T	C	2	4	6	0	0	6	0	0
7	48041940	.	G	A	8	4	12	0	0	12	0	0
7	48041967	.	G	A	11	6	17	0	1	18	0	0
7	48042195	.	G	A	3	6	9	0	0	9	0	0
7	48042456	.	A	G	6	6	12	0	0	12	0	0
7	48042483	.	G	T	5	7	12	0	0	12	0	0
7	48054942	.	T	A	5	10	15	0	0	15	0	0
7	48054990	.	G	A	9	8	17	0	2	19	0	0
7	48063519	.	A	G	9	10	19	1	1	21	0	0
7	48063546	.	A	G	2	2	4	1	2	7	0	0
7	48071605	.	T	C	5	6	11	0	0	11	0	0
7	48172753	.	A	G	4	3	7	0	1	8	0	0
7	48241475	.	G	A	1	2	3	0	0	3	0	0
7	48247055	.	T	C	1	2	3	0	2	5	0	0
7	48263490	.	G	A	3	2	5	0	0	5	0	0
7	48288848	.	A	G	13	21	34	0	1	35	0	0
7	48291844	.	A	G	11	22	33	0	2	35	0	0
7	48291864	.	G	A	14	21	35	0	1	36	0	0
7	48295902	.	G	T	8	15	23	0	2	25	0	0
7	48295910	.	C	T	9	17	26	0	0	26	0	0
7	48296075	.	A	G	9	9	18	0	0	18	0	0
7	48300621	.	T	C	2	7	9	0	1	10	0	0
7	48300648	.	G	C	2	8	10	0	0	10	0	0
7	48300795	.	C	T	6	5	11	0	0	11	0	0
7	48302925	.	A	G	7	7	14	0	0	14	0	0
7	48303198	.	T	A	6	3	9	0	0	9	0	0
7	48303216	.	G	A	8	2	10	0	0	10	0	0
7	48303497	.	A	G	2	3	5	0	2	7	0	0
7	48304240	.	A	G	3	0	3	0	2	5	0	0
7	48304348	.	C	T	2	3	5	0	0	5	0	0
7	48304350	.	A	T	2	3	5	0	0	5	0	0
7	48327801	.	A	G	2	7	9	0	0	9	0	0
7	48327867	.	C	A	5	9	14	0	0	14	0	0
7	48327906	.	T	C	12	9	21	0	0	21	0	0
7	48327912	.	C	T	12	8	20	0	0	20	0	0
7	48342519	.	A	T	3	6	9	0	0	9	0	0
7	48342526	.	T	C	3	5	8	0	0	8	0	0
7	48347478	.	T	G	13	12	25	0	0	25	0	0
7	48347680	.	A	C	11	7	18	0	0	18	0	0
7	48348003	.	G	A	8	9	17	0	0	17	0	0
7	48348006	.	A	G	8	8	16	0	1	17	0	0
7	48348062	.	C	T	9	7	16	0	2	18	0	0
7	48348485	.	A	G	13	6	19	0	2	21	0	0
7	48348519	.	C	T	9	5	14	0	2	16	0	0
7	48348554	.	G	A	8	7	15	0	0	15	0	0
7	48353844	.	G	A	9	4	13	0	1	14	0	0
7	48358792	.	A	T	6	9	15	0	0	15	0	0
7	48369043	.	C	G	0	8	8	0	11	19	0	0
7	48369306	.	G	A	3	4	7	0	1	8	0	0
7	48369999	.	C	T	4	5	9	0	0	9	0	0
7	48370014	.	T	G	4	5	9	0	0	9	0	0
7	48383527	.	A	G	3	3	6	0	0	6	0	0
7	48391532	.	C	T	4	3	7	0	2	9	0	0
7	48460315	.	C	T	14	19	33	0	1	34	0	0
7	48482286	.	C	A	13	6	19	0	2	21	0	0
7	48482370	.	C	T	13	7	20	0	1	21	0	0
7	48482616	.	T	C	3	4	7	0	0	7	0	0
7	48483513	.	T	A	17	22	39	0	0	39	0	0
7	48484269	.	T	C	11	19	30	0	1	31	0	0
7	48484307	.	G	A	0	13	13	0	6	19	0	0
7	48484416	.	G	A	11	6	17	0	1	18	0	0
7	48484621	.	C	T	11	13	24	0	0	24	0	0
7	48664032	.	A	G	5	3	8	0	0	8	0	0
7	48664862	.	C	T	2	3	5	0	0	5	0	0
7	48720633	.	A	G	1	3	4	0	0	4	0	0
7	48720759	.	T	C	1	3	4	0	0	4	0	0
7	48720768	.	A	G	4	3	7	0	0	7	0	0
7	48720887	.	A	G	1	3	4	0	0	4	0	0
7	48720977	.	G	T	1	2	3	0	1	4	0	0
7	48721603	.	T	A	3	3	6	0	0	6	0	0
7	48721692	.	C	T	0	2	2	0	4	6	0	0
7	48721832	.	A	C	4	3	7	0	0	7	0	0
7	48723668	.	A	G	1	2	3	0	0	3	0	0
7	48787121	.	A	C	1	2	3	0	0	3	0	0
7	48788204	.	A	C	1	2	3	0	0	3	0	0
7	48788256	.	G	A	4	6	10	0	0	10	0	0
7	48788265	.	A	T	5	6	11	0	0	11	0	0
7	48788369	.	T	C	9	18	27	0	0	27	0	0
7	48788389	.	G	C	9	0	9	0	16	25	0	0
7	48788622	.	G	A	5	9	14	0	0	14	0	0
7	48788790	.	A	T	7	11	18	0	1	19	0	0
7	48788791	.	T	A	8	10	18	0	1	19	0	0
7	48788910	.	C	T	8	11	19	0	2	21	0	0
7	48788966	.	C	T	9	10	19	0	2	21	0	0
7	48790641	.	G	A	8	6	14	0	1	15	0	0
7	48790794	.	A	C	4	5	9	0	2	11	0	0
7	48790824	.	A	G	5	3	8	0	1	9	0	0
7	48800943	.	T	C	1	2	3	0	0	3	0	0
7	48805629	.	C	T	8	13	21	0	0	21	0	0
7	48805874	.	G	A	1	3	4	0	0	4	0	0
7	48806542	.	G	A	8	2	10	0	0	10	0	0
7	48806554	.	A	G	7	4	11	0	0	11	0	0
7	48806809	.	T	C	11	4	15	0	0	15	0	0
7	48809031	.	T	C	6	2	8	0	0	8	0	0
7	48811446	.	C	T	12	8	20	0	1	21	0	0
7	48818563	.	T	C	17	19	36	0	0	36	0	0
7	48819684	.	A	G	20	7	27	0	0	27	0	0
7	48820740	.	T	A	10	4	14	0	0	14	0	0
7	48820773	.	C	T	11	13	24	0	0	24	0	0
7	48821065	.	T	C	11	9	20	0	0	20	0	0
7	48821331	.	T	C	17	7	24	4	0	28	0	0
7	48821362	.	C	T	9	11	20	4	1	25	0	0
7	48823809	.	A	T	14	20	34	0	2	36	0	0
7	48829569	.	G	C	13	19	32	0	0	32	0	0
7	48829728	.	A	G	11	10	21	0	0	21	0	0
7	48829926	.	A	T	10	5	15	0	2	17	0	0
7	48875023	.	C	T	1	2	3	0	0	3	0	0
7	48875953	.	G	A	1	5	6	0	0	6	0	0
7	49020658	.	G	A	7	10	17	0	1	18	0	0
7	49033267	.	G	A	1	8	9	0	4	13	0	0
7	49046764	.	C	T	2	9	11	0	1	12	0	0
7	49051870	.	G	A	6	4	10	0	1	11	0	0
7	49051922	.	G	A	6	4	10	0	0	10	0	0
7	49051927	.	G	A	6	3	9	0	2	11	0	0
7	49052044	.	T	A	15	7	22	0	1	23	0	0
7	49052112	.	C	T	13	11	24	0	2	26	0	0
7	49052138	.	G	A	18	13	31	0	1	32	0	0
7	49052359	.	A	G	7	7	14	0	1	15	0	0
7	49052377	.	A	T	8	6	14	0	0	14	0	0
7	49052413	.	C	T	3	12	15	0	1	16	0	0
7	49052476	.	G	A	8	2	10	0	0	10	0	0
7	49052575	.	G	A	5	6	11	0	0	11	0	0
7	49052625	.	C	T	5	14	19	0	0	19	0	0
7	49052777	.	C	T	12	8	20	0	1	21	0	0
7	49052957	.	C	G	7	7	14	0	0	14	0	0
7	49053260	.	C	T	7	12	19	0	0	19	0	0
7	49053531	.	C	T	8	10	18	0	1	19	0	0
7	49053566	.	G	A	0	12	12	0	4	16	0	0
7	49053627	.	C	T	9	14	23	0	0	23	0	0
7	49053677	.	G	A	1	13	14	0	9	23	0	0
7	49053977	.	C	T	3	5	8	0	1	9	0	0
7	49054076	.	T	G	8	0	8	0	8	16	0	0
7	49054243	.	G	A	0	2	2	1	5	8	0	0
7	49054268	.	T	C	8	3	11	1	1	13	0	0
7	49054382	.	T	A	10	8	18	0	1	19	0	0
7	49054394	.	G	A	13	4	17	0	1	18	0	0
7	49054885	.	C	T	3	11	14	0	1	15	0	0
7	49054985	.	T	C	5	4	9	0	1	10	0	0
7	49055197	.	C	T	10	10	20	0	0	20	0	0
7	49055371	.	A	C	22	11	33	0	0	33	0	0
7	49055411	.	T	C	19	14	33	0	1	34	0	0
7	49055812	.	T	G	3	0	3	0	4	7	0	0
7	49055880	.	C	T	4	3	7	0	0	7	0	0
7	49055930	.	A	C	3	4	7	0	0	7	0	0
7	49079102	.	C	T	2	2	4	0	0	4	0	0
7	49079167	.	T	C	1	2	3	0	0	3	0	0
7	49079278	.	T	C	1	4	5	0	1	6	0	0
7	49147462	.	G	C	2	3	5	0	0	5	0	0
7	49169991	.	C	T	1	5	6	0	0	6	0	0
7	49170028	.	G	A	0	3	3	0	4	7	0	0
7	49170029	.	G	T	3	3	6	0	1	7	0	0
7	49179547	.	G	C	4	3	7	0	0	7	0	0
7	49251540	.	A	G	3	2	5	0	1	6	0	0
7	49257220	.	C	T	8	8	16	0	0	16	0	0
7	49257333	.	T	C	7	8	15	0	0	15	0	0
7	49257841	.	C	T	10	10	20	0	3	23	0	0
7	49257979	.	A	G	5	11	16	0	0	16	0	0
7	49258012	.	G	A	4	8	12	0	1	13	0	0
7	49266497	.	G	A	8	8	16	0	0	16	0	0
7	49271067	.	C	A	8	10	18	0	1	19	0	0
7	49271069	.	C	T	10	8	18	0	0	18	0	0
7	49271208	.	C	T	8	8	16	0	1	17	0	0
7	49271363	.	A	G	2	0	2	0	2	4	0	0
7	49309592	.	T	C	1	2	3	0	0	3	0	0
7	49309643	.	A	T	2	2	4	0	0	4	0	0
7	49313925	.	T	A	1	3	4	0	0	4	0	0
7	49313966	.	A	C	1	3	4	0	1	5	0	0
7	49319909	.	A	G	1	2	3	0	0	3	0	0
7	49320253	.	G	A	5	7	12	0	0	12	0	0
7	49320342	.	A	T	5	4	9	0	0	9	0	0
7	49320778	.	C	A	6	2	8	0	1	9	0	0
7	49320779	.	A	C	6	2	8	0	1	9	0	0
7	49320841	.	A	G	3	3	6	0	0	6	0	0
7	49325125	.	G	A	14	7	21	1	0	22	0	0
7	49338309	.	G	A	16	9	25	0	2	27	0	0
7	49342391	.	G	A	15	20	35	0	2	37	0	0
7	49357357	.	G	A	12	13	25	0	2	27	0	0
7	49594967	.	C	T	10	8	18	0	0	18	0	0
7	50650697	.	C	T	1	4	5	0	0	5	0	0
7	50877064	.	T	C	5	4	9	0	0	9	0	0
7	50921147	.	C	T	1	4	5	0	0	5	0	0
7	51193657	.	T	G	2	3	5	0	1	6	0	0
7	51220278	.	T	C	9	7	16	0	0	16	0	0
7	51220557	.	G	A	9	8	17	0	1	18	0	0
7	51249441	.	G	T	6	9	15	0	0	15	0	0
7	51314945	.	G	A	2	3	5	0	0	5	0	0
7	51315934	.	G	A	1	2	3	0	0	3	0	0
7	51331947	.	C	T	4	5	9	0	1	10	0	0
7	51352721	.	A	T	7	6	13	0	0	13	0	0
7	51352806	.	T	C	6	3	9	0	0	9	0	0
7	51352871	.	T	C	5	4	9	0	0	9	0	0
7	51353191	.	G	A	5	6	11	0	0	11	0	0
7	51353421	.	C	T	2	4	6	0	0	6	0	0
7	51353447	.	G	T	3	4	7	0	0	7	0	0
7	51353854	.	T	A	4	3	7	0	1	8	0	0
7	51353935	.	G	A	6	3	9	0	0	9	0	0
7	51354162	.	A	G	4	7	11	0	0	11	0	0
7	51354442	.	C	A	4	2	6	0	0	6	0	0
7	51354672	.	T	A	5	3	8	0	1	9	0	0
7	51354696	.	C	T	6	5	11	0	0	11	0	0
7	51354756	.	T	C	14	6	20	0	0	20	0	0
7	51355592	.	G	A	0	5	5	0	4	9	0	0
7	51355936	.	G	T	4	4	8	0	1	10	1	0
7	51355972	.	T	A	5	2	7	0	0	7	0	0
7	51355993	.	T	A	3	1	4	0	2	6	0	0
7	51356100	.	A	T	5	4	9	0	0	9	0	0
7	51356542	.	C	G	6	16	22	0	1	23	0	0
7	51368654	.	T	G	3	6	9	0	0	9	0	0
7	51395580	.	T	A	2	2	4	0	0	4	0	0
7	51423426	.	G	A	2	2	4	0	0	4	0	0
7	51468042	.	C	T	0	12	12	0	11	23	0	0
7	51468199	.	C	T	22	15	37	0	1	38	0	0
7	51468389	.	C	T	2	12	14	0	11	25	0	0
7	51468411	.	A	T	12	13	25	0	1	26	0	0
7	51468556	.	G	C	18	15	33	0	3	36	0	0
7	51468577	.	C	A	15	17	32	0	1	33	0	0
7	51468928	.	G	A	16	5	21	1	2	24	0	0
7	51469048	.	T	G	13	17	30	0	1	31	0	0
7	51469166	.	A	T	18	10	28	0	2	30	0	0
7	51469340	.	G	A	9	11	20	0	0	20	0	0
7	51469361	.	A	G	8	10	18	0	2	20	0	0
7	51469578	.	T	G	11	6	17	0	1	18	0	0
7	51469897	.	A	G	9	6	15	0	0	15	0	0
7	51469952	.	A	T	10	19	29	0	0	29	0	0
7	51469956	.	C	T	1	17	18	0	11	29	0	0
7	51470070	.	T	C	5	0	5	0	11	16	0	0
7	51470569	.	G	T	4	10	14	0	1	15	0	0
7	51470868	.	C	A	8	6	14	0	2	16	0	0
7	51471107	.	G	A	8	8	16	0	1	18	1	0
7	51471117	.	A	G	11	8	19	0	0	19	0	0
7	51471365	.	T	C	15	0	15	0	0	15	0	0
7	51471554	.	T	C	2	0	2	0	12	14	0	0
7	51471690	.	T	C	8	0	8	0	7	15	0	0
7	51471714	.	A	G	6	6	12	0	1	13	0	0
7	51471775	.	G	A	3	12	15	0	0	15	0	0
7	51472175	.	A	C	3	2	5	0	0	5	0	0
7	51472179	.	C	A	0	4	4	0	0	4	0	0
7	51472456	.	C	T	3	8	11	0	0	11	0	0
7	51472693	.	C	T	1	4	5	0	10	15	0	0
7	51472702	.	A	G	12	4	16	0	0	16	0	0
7	51472793	.	A	C	6	0	6	0	8	14	0	0
7	51473000	.	C	T	3	4	7	0	0	7	0	0
7	51473021	.	C	T	5	4	9	0	1	10	0	0
7	51473585	.	T	C	6	1	7	0	4	11	0	0
7	51473673	.	G	A	9	13	22	0	0	22	0	0
7	51473814	.	C	T	13	9	22	0	3	25	0	0
7	51474238	.	G	A	4	5	9	0	1	10	0	0
7	51474279	.	C	A	11	6	17	0	1	18	0	0
7	51474300	.	G	T	11	8	19	0	0	19	0	0
7	51474468	.	C	T	1	12	13	0	12	25	0	0
7	51475111	.	G	A	9	4	13	0	1	14	0	0
7	51475199	.	G	C	5	7	12	0	0	12	0	0
7	51475288	.	G	A	4	8	12	0	1	13	0	0
7	51475795	.	T	A	4	2	6	0	0	6	0	0
7	51476108	.	G	A	3	6	9	0	1	10	0	0
7	51493063	.	C	T	1	5	6	0	1	7	0	0
7	51634231	.	A	G	34	24	58	0	6	64	0	0
7	51634285	.	C	T	29	34	63	0	1	64	0	0
7	51634480	.	G	A	36	35	71	0	2	73	0	0
7	51643163	.	A	G	4	6	10	0	0	10	0	0
7	51643363	.	G	A	5	2	7	0	0	7	0	0
7	51643366	.	G	A	3	4	7	0	0	7	0	0
7	51643722	.	A	G	2	4	6	0	0	6	0	0
7	51698403	.	T	A	3	3	6	0	0	6	0	0
7	51709472	.	G	A	6	5	11	0	1	12	0	0
7	51712777	.	T	C	2	4	6	0	0	6	0	0
7	51713852	.	G	A	5	2	7	0	0	7	0	0
7	51713857	.	T	G	2	5	7	0	0	7	0	0
7	51716203	.	T	G	3	2	5	0	0	5	0	0
7	51716278	.	C	T	1	3	4	0	1	5	0	0
7	51779552	.	G	A	4	17	21	0	21	42	0	0
7	51779636	.	T	C	21	20	41	0	2	43	0	0
7	51786442	.	T	G	21	1	22	0	24	46	0	0
7	51788729	.	C	T	13	22	35	2	0	37	0	0
7	51788756	.	A	C	18	20	38	2	2	42	0	0
7	51793623	.	C	T	15	16	31	0	1	32	0	0
7	51793747	.	C	T	17	10	27	0	0	27	0	0
7	51793813	.	G	C	11	13	24	0	1	25	0	0
7	51795827	.	C	T	9	6	15	0	1	16	0	0
7	51795835	.	C	T	4	6	10	0	1	11	0	0
7	51805642	.	A	T	3	2	5	0	0	5	0	0
7	51806570	.	T	C	4	6	10	0	0	10	0	0
7	51808384	.	G	C	0	5	5	0	2	7	0	0
7	51808585	.	C	T	5	2	7	0	0	7	0	0
7	51808615	.	A	T	2	2	4	0	0	4	0	0
7	51813764	.	G	A	1	5	6	0	0	6	0	0
7	51814287	.	C	G	6	7	13	0	0	13	0	0
7	51814385	.	G	C	11	5	16	0	0	16	0	0
7	51814416	.	T	A	7	3	10	0	0	10	0	0
7	51814512	.	C	T	3	8	11	0	1	12	0	0
7	51816405	.	T	C	3	2	5	0	0	5	0	0
7	51824687	.	C	A	5	5	10	0	0	10	0	0
7	51824772	.	T	G	3	2	5	0	0	5	0	0
7	52150715	.	T	C	2	0	2	0	2	4	0	0
7	52152053	.	A	T	1	4	5	0	0	5	0	0
7	52152063	.	C	T	0	3	3	0	1	4	0	0
7	52153001	.	G	A	1	3	4	0	0	4	0	0
7	52153006	.	C	T	1	3	4	0	0	4	0	0
7	52156113	.	G	A	0	5	5	0	4	9	0	0
7	52156137	.	T	A	6	6	12	0	0	12	0	0
7	52157531	.	T	G	8	5	13	0	0	13	0	0
7	52157782	.	T	C	10	6	16	0	0	16	0	0
7	52157814	.	G	T	12	8	20	0	2	22	0	0
7	52157994	.	A	G	1	0	1	0	5	6	0	0
7	52158210	.	G	T	4	7	11	0	0	11	0	0
7	52158304	.	G	A	9	3	12	0	1	13	0	0
7	52158339	.	G	C	9	6	15	0	0	15	0	0
7	52158362	.	T	A	12	4	16	0	0	16	0	0
7	52158916	.	C	G	3	2	5	0	0	5	0	0
7	52161646	.	G	T	2	6	8	0	0	8	0	0
7	52164592	.	T	C	1	4	5	0	0	5	0	0
7	52165016	.	T	A	4	4	8	0	0	8	0	0
7	52166143	.	G	A	13	13	26	0	0	26	0	0
7	52173195	.	C	A	6	5	11	0	0	11	0	0
7	52175362	.	T	C	5	5	10	0	2	12	0	0
7	52282674	.	G	T	8	7	15	0	4	19	0	0
7	52285113	.	C	G	6	8	14	0	0	14	0	0
7	52294403	.	G	A	17	12	29	0	2	31	0	0
7	52294540	.	A	T	14	9	23	0	2	25	0	0
7	52294746	.	C	T	2	5	7	0	12	19	0	0
7	52295795	.	C	T	3	11	14	0	7	21	0	0
7	52296018	.	T	C	23	8	31	0	1	32	0	0
7	52296281	.	T	C	14	4	18	0	2	20	0	0
7	52296320	.	G	A	9	6	15	0	1	16	0	0
7	52296352	.	G	T	9	6	15	0	1	16	0	0
7	52296400	.	C	A	6	10	16	0	1	17	0	0
7	52309924	.	G	A	8	13	21	0	1	22	0	0
7	52315434	.	C	G	0	6	6	0	5	11	0	0
7	52328463	.	A	G	9	5	14	0	0	14	0	0
7	52328569	.	C	T	9	8	17	0	1	18	0	0
7	52372072	.	T	A	1	2	3	0	0	3	0	0
7	52431954	.	C	T	2	2	4	0	2	6	0	0
7	52432459	.	G	A	4	5	9	0	0	9	0	0
7	52492776	.	C	A	0	2	2	0	1	3	0	0
7	52517561	.	C	G	4	7	11	0	0	11	0	0
7	52518134	.	G	C	14	0	14	0	9	23	0	0
7	52518271	.	A	T	11	7	18	0	2	20	0	0
7	52518813	.	C	T	10	5	15	0	1	16	0	0
7	52519134	.	G	A	16	12	28	0	2	30	0	0
7	52521352	.	G	A	15	6	21	0	1	22	0	0
7	52533621	.	C	T	6	6	12	1	0	13	0	0
7	52533649	.	C	T	3	8	11	1	2	14	0	0
7	52551570	.	A	T	10	7	17	0	0	17	0	0
7	52574213	.	A	C	8	0	8	0	6	14	0	0
7	52574225	.	G	A	9	6	15	0	0	15	0	0
7	52589092	.	G	A	5	3	8	0	1	9	0	0
7	52589094	.	A	C	5	0	5	0	3	8	0	0
7	52709772	.	T	A	4	9	13	0	0	13	0	0
7	52716777	.	T	A	6	7	13	0	1	14	0	0
7	52716792	.	A	T	6	7	13	0	0	13	0	0
7	52716875	.	C	A	9	5	14	0	0	14	0	0
7	52717095	.	T	C	13	6	19	0	0	19	0	0
7	52728713	.	G	A	3	7	10	0	2	12	0	0
7	52729079	.	T	G	2	0	2	0	5	7	0	0
7	52744228	.	T	C	6	6	12	0	0	12	0	0
7	52750565	.	C	T	13	11	24	0	0	24	0	0
7	52750847	.	C	T	11	7	18	0	2	20	0	0
7	52751306	.	T	C	3	4	7	0	0	7	0	0
7	52751341	.	T	A	4	2	6	0	0	6	0	0
7	52751357	.	T	C	5	2	7	0	0	7	0	0
7	52753098	.	C	G	2	2	4	0	0	4	0	0
7	52753577	.	G	T	0	4	4	0	1	5	0	0
7	52766053	.	T	G	1	3	4	0	0	4	0	0
7	52766063	.	C	T	1	4	5	0	0	5	0	0
7	52820060	.	T	A	9	6	15	0	1	16	0	0
7	52820320	.	C	T	8	13	21	0	1	22	0	0
7	52821156	.	T	G	1	2	3	0	0	3	0	0
7	52821244	.	T	C	1	4	5	1	0	6	0	0
7	52821701	.	G	A	5	3	8	0	0	8	0	0
7	52822708	.	C	T	6	13	19	0	0	19	0	0
7	52822791	.	T	A	9	5	14	0	0	14	0	0
7	52822793	.	A	G	9	5	14	0	0	14	0	0
7	52823429	.	A	T	8	5	13	0	4	17	0	0
7	52830423	.	G	T	2	4	6	0	0	6	0	0
7	52830601	.	T	G	16	11	27	0	1	29	1	0
7	52831053	.	G	T	26	22	48	0	4	52	0	0
7	52831413	.	C	T	12	16	28	0	2	30	0	0
7	52831622	.	T	C	23	8	31	0	0	31	0	0
7	52832127	.	C	T	22	8	30	0	0	30	0	0
7	52832129	.	C	T	21	7	28	0	1	29	0	0
7	52833126	.	C	G	7	11	18	0	0	18	0	0
7	52833248	.	A	T	16	16	32	0	2	34	0	0
7	52833606	.	G	A	22	16	38	0	0	38	0	0
7	52833792	.	G	A	14	19	33	0	1	34	0	0
7	52837804	.	T	G	20	18	38	0	1	39	0	0
7	52837908	.	G	A	15	17	32	0	2	34	0	0
7	52838681	.	G	A	16	16	32	0	1	33	0	0
7	52839062	.	C	T	11	9	20	0	3	23	0	0
7	52841648	.	G	A	3	11	14	0	0	14	0	0
7	52876507	.	G	C	5	2	7	0	0	7	0	0
7	52876544	.	A	G	8	4	12	0	1	13	0	0
7	52900928	.	A	C	18	13	31	0	2	33	0	0
7	52901531	.	C	T	10	14	24	0	1	25	0	0
7	52902160	.	G	A	19	11	30	0	2	32	0	0
7	52929182	.	G	A	23	25	48	0	0	48	0	0
7	52933191	.	C	T	7	4	11	0	0	11	0	0
7	52937334	.	G	A	11	6	17	0	0	17	0	0
7	52942312	.	G	T	7	8	15	0	1	16	0	0
7	52942472	.	C	T	6	7	13	0	0	13	0	0
7	52944199	.	G	A	7	7	14	0	2	16	0	0
7	52958716	.	A	T	3	3	6	0	0	6	0	0
7	52958995	.	T	C	3	4	7	0	0	7	0	0
7	52962765	.	T	C	4	1	5	0	6	11	0	0
7	53162425	.	T	C	1	2	3	0	1	4	0	0
7	54039463	.	G	A	0	2	2	0	3	5	0	0
7	54039538	.	T	C	1	3	4	0	0	4	0	0
7	54039544	.	G	A	1	4	5	0	0	5	0	0
7	54058312	.	C	T	5	5	10	0	0	10	0	0
7	54058390	.	C	T	4	3	7	0	0	7	0	0
7	54070097	.	G	A	1	5	6	0	3	9	0	0
7	54070841	.	T	G	6	0	6	0	5	11	0	0
7	54071109	.	G	A	2	6	8	0	0	8	0	0
7	54071118	.	T	C	3	6	9	0	0	9	0	0
7	54088230	.	C	T	7	4	11	0	1	12	0	0
7	54088520	.	G	A	7	8	15	0	1	16	0	0
7	54088578	.	T	C	8	6	14	0	0	14	0	0
7	54088988	.	G	A	8	9	17	0	1	18	0	0
7	54089192	.	A	T	3	2	5	0	0	5	0	0
7	54092602	.	A	T	16	14	30	0	1	31	0	0
7	54102515	.	C	T	8	4	12	0	0	12	0	0
7	54102764	.	C	A	3	4	7	0	0	7	0	0
7	54102884	.	T	A	4	7	11	0	1	12	0	0
7	54103168	.	C	T	0	4	4	0	6	10	0	0
7	54103566	.	A	T	2	4	6	0	1	7	0	0
7	54103590	.	G	A	4	8	12	0	0	12	0	0
7	54103841	.	G	A	2	2	4	0	0	4	0	0
7	54103980	.	C	T	2	3	5	1	2	8	0	0
7	54104127	.	C	A	0	7	7	0	7	14	0	0
7	54104153	.	C	T	3	5	8	0	0	8	0	0
7	54104318	.	A	G	6	5	11	0	2	13	0	0
7	54104395	.	T	C	4	5	9	0	0	9	0	0
7	54105150	.	G	A	1	6	7	0	0	7	0	0
7	54105266	.	C	T	0	4	4	0	3	7	0	0
7	54105412	.	C	T	0	4	4	0	6	10	0	0
7	54137202	.	G	A	4	3	7	0	0	7	0	0
7	54274047	.	C	T	2	3	5	0	0	5	0	0
7	54307309	.	T	A	4	4	8	0	0	8	0	0
7	54324019	.	C	T	11	12	23	0	0	23	0	0
7	54324133	.	C	A	11	13	24	0	2	26	0	0
7	54327110	.	G	A	9	6	15	0	1	16	0	0
7	54327402	.	T	C	7	12	19	0	0	19	0	0
7	54331379	.	G	C	10	8	18	0	0	18	0	0
7	54356092	.	A	T	4	4	8	0	0	8	0	0
7	54361300	.	C	T	0	4	4	0	5	9	0	0
7	54361303	.	A	G	5	4	9	0	0	9	0	0
7	54407828	.	T	C	3	3	6	0	0	6	0	0
7	54475284	.	G	A	4	2	6	0	0	6	0	0
7	54480159	.	C	T	1	4	5	0	0	5	0	0
7	54498267	.	G	A	1	4	5	0	0	5	0	0
7	54606263	.	T	C	1	2	3	0	0	3	0	0
7	54655172	.	T	A	2	3	5	0	0	5	0	0
7	54655219	.	A	T	4	3	7	0	1	8	0	0
7	54655229	.	C	T	5	4	9	0	0	9	0	0
7	54670384	.	C	T	3	5	8	0	0	8	0	0
7	54670905	.	A	G	6	2	8	0	0	8	0	0
7	54671038	.	C	T	0	4	4	0	2	6	0	0
7	54672826	.	A	T	1	2	3	0	0	3	0	0
7	55300266	.	C	T	2	3	5	0	0	5	0	0
7	55300360	.	T	C	1	3	4	0	0	4	0	0
7	55314253	.	A	G	2	3	5	0	0	5	0	0
7	55315983	.	C	G	1	5	6	0	0	6	0	0
7	55530488	.	C	G	1	3	4	0	0	4	0	0
7	55530498	.	T	A	1	2	3	0	0	3	0	0
7	55530571	.	G	T	5	2	7	0	0	7	0	0
7	55530590	.	C	T	5	2	7	0	0	7	0	0
7	55531105	.	A	G	9	8	17	1	0	18	0	0
7	55531112	.	G	A	10	8	18	1	0	19	0	0
7	55531224	.	G	A	8	3	11	0	5	16	0	0
7	55531240	.	G	A	11	2	13	0	1	14	0	0
7	55531295	.	C	T	1	5	6	0	16	22	0	0
7	55532125	.	G	A	4	5	9	0	0	9	0	0
7	55532131	.	G	A	4	5	9	2	0	11	0	0
7	55532316	.	A	G	2	5	7	0	0	7	0	0
7	55532327	.	C	A	1	6	7	0	1	8	0	0
7	55532380	.	T	C	4	0	4	0	9	13	0	0
7	55532424	.	C	A	6	9	15	0	0	15	0	0
7	55532429	.	T	C	8	9	17	0	0	17	0	0
7	55532524	.	A	G	1	4	5	0	0	5	0	0
7	55535754	.	T	A	8	10	18	0	0	18	0	0
7	55536419	.	C	G	5	4	9	0	2	11	0	0
7	55536451	.	G	A	6	3	9	0	0	9	0	0
7	55536487	.	G	A	5	4	9	0	0	9	0	0
7	55593120	.	A	C	4	2	6	0	2	8	0	0
7	55607313	.	G	C	2	2	4	0	0	4	0	0
7	55616188	.	T	G	1	3	4	0	0	4	0	0
7	55622831	.	T	C	2	3	5	0	0	5	0	0
7	55622848	.	C	T	0	3	3	0	2	5	0	0
7	55635202	.	T	C	6	15	21	0	0	21	0	0
7	55635355	.	G	A	0	5	5	0	4	9	0	0
7	55635521	.	T	G	1	2	3	0	0	3	0	0
7	55637122	.	C	A	8	9	17	0	1	18	0	0
7	55660269	.	G	A	13	17	30	0	1	31	0	0
7	55955842	.	G	T	3	2	5	0	0	5	0	0
7	55955890	.	G	A	2	3	5	0	0	5	0	0
7	56152363	.	C	A	7	5	12	0	2	14	0	0
7	56152436	.	G	A	3	7	10	0	2	12	0	0
7	56152437	.	G	A	4	7	11	0	0	11	0	0
7	56152660	.	T	C	9	10	19	0	0	19	0	0
7	56152740	.	G	A	12	11	23	0	1	24	0	0
7	56152759	.	C	G	2	14	16	0	15	31	0	0
7	56158197	.	G	A	10	19	29	0	1	30	0	0
7	56164219	.	T	G	6	9	15	0	2	17	0	0
7	56164267	.	G	A	11	10	21	0	0	21	0	0
7	56167349	.	C	A	17	8	25	0	0	25	0	0
7	56177177	.	C	T	0	7	7	0	7	14	0	0
7	56177188	.	T	G	6	6	12	0	0	12	0	0
7	56180417	.	A	C	2	3	5	0	0	5	0	0
7	56180482	.	G	A	2	3	5	0	0	5	0	0
7	56180589	.	C	A	0	4	4	0	4	8	0	0
7	56253928	.	T	A	5	7	12	0	0	12	0	0
7	56394928	.	A	G	1	3	4	0	0	4	0	0
7	56394991	.	T	C	2	5	7	0	0	7	0	0
7	56395283	.	A	G	5	8	13	0	2	15	0	0
7	56395681	.	A	G	4	0	4	0	5	9	0	0
7	56395764	.	G	A	3	4	7	0	0	7	0	0
7	56395822	.	T	C	7	4	11	0	0	11	0	0
7	56396599	.	G	A	0	5	5	0	11	16	0	0
7	56397859	.	G	A	6	9	15	0	0	15	0	0
7	56401049	.	A	G	11	8	19	0	0	19	0	0
7	56473558	.	T	A	8	4	12	0	1	13	0	0
7	56483101	.	G	T	3	2	5	0	0	5	0	0
7	56483772	.	T	G	17	7	24	0	1	25	0	0
7	56483928	.	C	T	13	9	22	0	1	23	0	0
7	56484288	.	G	C	10	12	22	0	1	23	0	0
7	56523233	.	A	G	6	9	15	0	0	15	0	0
7	56528530	.	T	C	6	5	11	0	0	11	0	0
7	56743837	.	G	C	1	2	3	0	0	3	0	0
7	56743879	.	A	G	2	4	6	0	0	6	0	0
7	56746224	.	T	C	2	5	7	0	0	7	0	0
7	56746311	.	C	T	2	12	14	0	0	14	0	0
7	56761482	.	G	T	8	5	13	0	1	14	0	0
7	56762118	.	G	C	14	5	19	0	0	19	0	0
7	56764603	.	G	A	7	5	12	0	0	12	0	0
7	56766691	.	G	A	1	6	7	0	0	7	0	0
7	56778235	.	T	A	20	21	41	0	2	43	0	0
7	56778251	.	T	C	21	22	43	0	0	43	0	0
7	56778282	.	C	T	2	19	21	0	15	36	0	0
7	56778605	.	A	T	22	23	45	0	1	46	0	0
7	56778817	.	G	A	12	8	20	0	2	22	0	0
7	56778822	.	A	T	13	9	22	0	1	23	0	0
7	56784046	.	C	T	17	12	29	0	2	31	0	0
7	56784070	.	A	T	20	12	32	0	1	33	0	0
7	56785006	.	T	C	12	12	24	0	1	25	0	0
7	56785093	.	A	C	12	16	28	0	0	28	0	0
7	56785315	.	G	A	20	11	31	0	1	32	0	0
7	56787414	.	A	T	12	15	27	0	1	28	0	0
7	56787483	.	T	A	17	14	31	0	0	31	0	0
7	56787527	.	C	T	14	13	27	0	0	27	0	0
7	56787671	.	T	A	7	4	11	0	0	11	0	0
7	56793377	.	A	C	9	1	10	0	6	16	0	0
7	56793647	.	C	A	2	10	12	0	6	18	0	0
7	56831424	.	C	T	0	2	2	0	2	4	0	0
7	56831469	.	T	G	3	3	6	0	0	6	0	0
7	56831574	.	T	C	4	0	4	0	3	7	0	0
7	56981010	.	T	C	3	2	5	0	0	5	0	0
7	56998868	.	A	G	1	6	7	0	0	7	0	0
7	56998877	.	C	T	1	6	7	0	0	7	0	0
7	57036334	.	T	G	1	3	4	0	0	4	0	0
7	57048677	.	T	C	3	1	4	0	0	4	0	0
7	57048682	.	C	A	4	2	6	0	0	6	0	0
7	57048885	.	T	A	2	3	5	0	0	5	0	0
7	57048945	.	A	T	5	2	7	0	0	7	0	0
7	57049638	.	A	G	5	5	10	0	0	10	0	0
7	57049715	.	T	C	4	7	11	0	1	12	0	0
7	57049980	.	T	G	2	2	4	0	0	4	0	0
7	57057285	.	C	T	4	3	7	0	1	8	0	0
7	57059463	.	T	A	3	4	7	0	0	7	0	0
7	57065184	.	T	C	6	6	12	0	1	13	0	0
7	57081143	.	C	T	3	3	6	0	0	6	0	0
7	57081146	.	T	C	2	3	5	0	1	6	0	0
7	57083043	.	C	T	4	6	10	0	0	10	0	0
7	57083088	.	G	A	5	4	9	0	0	9	0	0
7	57083094	.	A	G	5	0	5	0	4	9	0	0
7	57086216	.	G	A	0	7	7	0	10	17	0	0
7	57086277	.	G	A	1	7	8	0	7	15	0	0
7	57086383	.	C	A	8	9	17	0	1	18	0	0
7	57123438	.	A	G	0	3	3	0	1	4	0	0
7	57123513	.	T	G	2	0	2	0	2	4	0	0
7	57129474	.	A	G	1	6	7	0	2	9	0	0
7	57129518	.	C	T	4	5	9	1	0	10	0	0
7	57129520	.	A	T	4	5	9	1	0	10	0	0
7	57129553	.	C	A	4	7	11	1	0	12	0	0
7	57129656	.	G	A	5	3	8	0	0	8	0	0
7	57129729	.	G	T	4	6	10	0	0	10	0	0
7	57129766	.	A	T	3	4	7	0	0	7	0	0
7	57342345	.	A	G	3	4	7	0	0	7	0	0
7	57342407	.	T	C	2	1	3	0	2	5	0	0
7	57342737	.	C	G	1	0	1	0	5	6	0	0
7	57469876	.	C	T	2	2	4	0	1	5	0	0
7	57485461	.	T	C	7	4	11	0	0	11	0	0
7	57485811	.	C	A	6	8	14	0	1	15	0	0
7	57485847	.	G	A	11	10	21	0	1	22	0	0
7	57494184	.	C	T	1	12	13	0	11	24	0	0
7	57497353	.	T	C	10	6	16	0	0	16	0	0
7	57497455	.	C	G	5	7	12	0	0	12	0	0
7	57497456	.	T	C	5	0	5	0	7	12	0	0
7	57504671	.	A	G	17	11	28	0	0	28	0	0
7	57509353	.	C	T	2	4	6	0	0	6	0	0
7	57623974	.	T	A	2	3	5	0	0	5	0	0
7	57800754	.	C	T	3	7	10	0	1	11	0	0
7	58143272	.	T	A	1	2	3	0	0	3	0	0
7	59041531	.	A	G	1	1	2	0	8	10	0	0
7	60245033	.	G	A	1	4	5	0	0	5	0	0
7	61169484	.	G	A	1	4	5	0	0	5	0	0
7	61767441	.	A	C	2	3	5	0	0	5	0	0
7	61769957	.	G	A	1	2	3	0	0	3	0	0
7	61772930	.	G	T	4	3	7	0	1	8	0	0
7	61799933	.	C	T	3	2	5	0	1	6	0	0
7	61804797	.	T	C	3	3	6	0	0	6	0	0
7	61804880	.	A	T	5	5	10	0	1	11	0	0
7	61804909	.	C	A	1	5	6	0	0	6	0	0
7	61805102	.	G	A	8	4	12	0	1	13	0	0
7	61805104	.	T	A	8	4	12	0	0	13	1	0
7	61844258	.	G	C	2	2	4	0	0	4	0	0
7	61844263	.	A	G	1	2	3	0	0	3	0	0
7	61921320	.	G	A	8	5	13	0	1	14	0	0
7	61921387	.	T	A	5	3	8	0	0	8	0	0
7	61921463	.	C	T	8	8	16	0	0	16	0	0
7	61921465	.	T	A	8	8	16	0	0	16	0	0
7	61931851	.	A	C	3	3	6	0	0	6	0	0
7	61934189	.	T	A	11	6	17	0	1	18	0	0
7	61934278	.	C	T	3	5	8	0	1	9	0	0
7	61934306	.	A	G	3	0	3	0	4	7	0	0
7	61934330	.	A	G	4	0	4	0	5	9	0	0
7	61945030	.	A	G	3	2	5	0	0	5	0	0
7	61950074	.	C	T	2	4	6	0	0	6	0	0
7	61953293	.	C	T	3	5	8	0	0	8	0	0
7	61953344	.	G	C	9	11	20	0	0	20	0	0
7	61954500	.	G	T	4	8	12	0	0	12	0	0
7	61962238	.	G	T	0	6	6	0	5	11	0	0
7	61977229	.	C	T	5	5	10	0	0	10	0	0
7	61977256	.	A	T	4	6	10	0	1	11	0	0
7	61977499	.	T	C	9	10	19	0	0	19	0	0
7	61977514	.	G	A	6	13	19	0	1	20	0	0
7	61981518	.	A	G	3	3	6	0	0	6	0	0
7	61981934	.	G	C	5	2	7	0	0	7	0	0
7	61982188	.	A	G	5	3	8	0	0	8	0	0
7	61987819	.	A	G	2	4	6	0	1	7	0	0
7	61989033	.	A	C	1	3	4	0	0	4	0	0
7	61995417	.	G	A	3	5	8	0	0	8	0	0
7	62000765	.	G	A	2	5	7	0	1	8	0	0
7	62000825	.	G	A	3	3	6	0	1	7	0	0
7	62009652	.	G	A	1	11	12	0	8	20	0	0
7	62009677	.	G	A	0	11	11	0	11	22	0	0
7	62009701	.	C	T	9	10	19	0	0	19	0	0
7	62203426	.	G	A	3	3	6	0	0	6	0	0
7	62205268	.	A	G	1	0	1	0	2	3	0	0
7	62205292	.	G	A	0	2	2	0	1	3	0	0
7	62205313	.	C	T	1	2	3	0	0	3	0	0
7	62205714	.	T	C	1	3	4	0	0	4	0	0
7	62206044	.	T	C	1	3	4	0	0	4	0	0
7	62206389	.	A	T	4	2	6	0	0	6	0	0
7	62206419	.	C	T	3	2	5	0	0	5	0	0
7	62206564	.	T	C	1	2	3	0	0	3	0	0
7	62206565	.	T	C	1	2	3	0	0	3	0	0
7	62248635	.	C	T	4	5	9	0	1	10	0	0
7	62248651	.	T	G	4	4	8	0	0	8	0	0
7	62248670	.	T	A	1	2	3	0	0	3	0	0
7	62258058	.	A	T	3	3	6	0	0	6	0	0
7	62268259	.	C	T	3	3	6	0	0	6	0	0
7	63325317	.	A	G	5	12	17	0	0	17	0	0
7	63325484	.	T	C	6	4	10	0	0	10	0	0
7	63325567	.	C	G	10	7	17	0	0	17	0	0
7	63326010	.	A	C	7	6	13	0	0	13	0	0
7	63326184	.	A	G	8	5	13	0	0	13	0	0
7	63326928	.	G	A	2	8	10	0	8	18	0	0
7	63327063	.	C	T	5	6	11	0	0	11	0	0
7	63327468	.	C	T	7	8	15	0	0	15	0	0
7	63327757	.	C	T	7	5	12	0	0	12	0	0
7	63327912	.	G	C	2	15	17	0	6	23	0	0
7	63328125	.	A	T	9	5	14	0	0	14	0	0
7	63328305	.	T	C	9	12	21	0	1	22	0	0
7	63328320	.	T	C	13	11	24	0	0	24	0	0
7	63328446	.	T	A	15	11	26	0	3	29	0	0
7	63328485	.	C	T	10	15	25	0	0	25	0	0
7	63328599	.	A	G	13	0	13	0	14	27	0	0
7	63328632	.	C	A	14	17	31	0	1	32	0	0
7	63328746	.	G	T	19	16	35	0	2	37	0	0
7	63328764	.	G	A	0	16	16	0	21	37	0	0
7	64988122	.	C	T	14	12	26	0	1	27	0	0
7	64991495	.	T	C	13	9	22	0	1	23	0	0
7	64991501	.	A	G	12	8	20	0	3	23	0	0
7	64996666	.	A	G	5	6	11	0	2	13	0	0
7	65011498	.	A	G	8	10	18	0	0	18	0	0
7	65011513	.	C	T	9	6	15	0	0	15	0	0
7	65019746	.	T	C	10	15	25	0	0	25	0	0
7	65024002	.	G	A	6	12	18	0	2	20	0	0
7	65026828	.	C	T	2	2	4	0	3	7	0	0
7	65035509	.	G	A	9	13	22	0	1	23	0	0
7	65039374	.	T	A	11	13	24	0	1	25	0	0
7	65050030	.	G	A	14	15	29	0	2	31	0	0
7	65092935	.	G	A	2	3	5	0	3	8	0	0
7	65104042	.	A	T	1	3	4	0	0	4	0	0
7	65104792	.	C	T	2	3	5	0	0	5	0	0
7	65104964	.	C	A	0	3	3	0	4	7	0	0
7	65107075	.	T	G	2	2	4	0	0	4	0	0
7	65113970	.	C	A	3	4	7	0	0	7	0	0
7	65121982	.	C	T	8	8	16	0	0	16	0	0
7	65132821	.	T	C	5	6	11	0	0	11	0	0
7	65138868	.	A	G	8	12	20	0	2	22	0	0
7	65140577	.	T	C	12	3	15	0	0	15	0	0
7	65140738	.	T	A	5	4	9	0	2	11	0	0
7	65148056	.	C	T	8	13	21	0	0	21	0	0
7	65157397	.	A	C	15	10	25	0	0	25	0	0
7	65162339	.	G	A	0	12	12	0	13	25	0	0
7	65169335	.	G	A	2	24	26	0	18	44	0	0
7	65169795	.	G	A	2	15	17	0	18	35	0	0
7	65173534	.	C	T	4	6	10	1	1	12	0	0
7	65173829	.	A	T	1	3	4	0	0	4	0	0
7	65173918	.	G	A	2	2	4	0	0	4	0	0
7	65178135	.	C	T	3	4	7	0	1	8	0	0
7	65178270	.	C	T	3	5	8	0	0	8	0	0
7	65297313	.	G	T	7	6	13	0	0	13	0	0
7	65306067	.	T	C	9	10	19	0	1	20	0	0
7	65306085	.	C	T	7	8	15	0	2	17	0	0
7	65306255	.	A	G	5	7	12	0	0	12	0	0
7	65306355	.	G	A	0	0	0	0	5	5	0	0
7	65333876	.	C	T	1	4	5	0	0	5	0	0
7	65371899	.	C	T	4	5	9	0	0	9	0	0
7	65434513	.	G	A	0	4	4	0	6	10	0	0
7	65440308	.	T	A	5	6	11	0	0	11	0	0
7	65440493	.	C	T	6	3	9	0	1	10	0	0
7	65445483	.	G	A	8	9	17	0	1	18	0	0
7	65451324	.	T	A	7	11	18	0	0	18	0	0
7	65453159	.	C	A	6	9	15	0	1	16	0	0
7	65457079	.	G	A	7	8	15	0	0	15	0	0
7	65461040	.	G	A	0	14	14	0	5	19	0	0
7	65461201	.	A	G	8	5	13	0	0	13	0	0
7	65461211	.	T	C	7	6	13	0	1	14	0	0
7	65463169	.	G	A	7	10	17	0	1	18	0	0
7	65463511	.	G	A	3	11	14	0	23	37	0	0
7	65463586	.	C	T	10	8	18	0	0	18	0	0
7	65463906	.	T	C	8	7	15	0	1	16	0	0
7	65464010	.	C	T	11	6	17	1	0	18	0	0
7	65464120	.	T	G	10	5	15	1	0	16	0	0
7	65464288	.	G	T	4	4	8	0	0	9	1	0
7	65473421	.	G	C	30	19	49	0	0	49	0	0
7	65473700	.	G	C	26	27	53	0	1	54	0	0
7	65473814	.	T	C	22	14	36	1	5	42	0	0
7	65473901	.	C	T	14	17	31	0	0	31	0	0
7	65473902	.	T	C	21	10	31	0	1	32	0	0
7	65474100	.	C	T	27	18	45	0	1	46	0	0
7	65474103	.	A	G	27	18	45	0	1	46	0	0
7	65475422	.	T	G	21	21	42	0	6	48	0	0
7	65475669	.	C	T	16	16	32	0	0	32	0	0
7	65488586	.	G	A	10	19	29	0	1	30	0	0
7	65491835	.	G	A	25	25	50	0	2	52	0	0
7	65491855	.	A	T	21	23	44	0	3	47	0	0
7	65491910	.	T	A	4	4	8	1	2	11	0	0
7	65899329	.	A	C	1	3	4	0	0	4	0	0
7	65917615	.	G	T	2	3	5	0	0	5	0	0
7	65918793	.	T	G	4	5	9	0	0	9	0	0
7	65918984	.	T	G	4	4	8	0	0	8	0	0
7	65919103	.	T	C	1	2	3	0	0	3	0	0
7	65919326	.	C	A	4	4	8	0	0	8	0	0
7	65919360	.	C	G	2	2	4	0	0	4	0	0
7	65919373	.	A	C	1	3	4	0	0	4	0	0
7	65919744	.	C	G	1	1	2	0	0	2	0	0
7	65919754	.	A	G	2	2	4	0	0	4	0	0
7	65919806	.	A	G	2	2	4	0	1	5	0	0
7	65919903	.	C	A	2	3	5	0	0	5	0	0
7	65919940	.	T	G	2	0	2	0	4	6	0	0
7	65919942	.	T	A	2	4	6	0	0	6	0	0
7	65920010	.	G	A	4	2	6	0	0	6	0	0
7	65920024	.	A	G	5	1	6	0	1	7	0	0
7	65920194	.	C	T	2	5	7	0	0	7	0	0
7	65920214	.	A	G	3	0	3	0	6	9	0	0
7	65920347	.	A	G	1	3	4	0	0	4	0	0
7	65920618	.	G	A	2	2	4	0	1	5	0	0
7	65920720	.	A	G	10	0	10	0	4	14	0	0
7	65921037	.	G	A	0	3	3	0	1	4	0	0
7	65921467	.	G	C	5	6	11	0	2	13	0	0
7	65921645	.	T	A	3	2	5	0	0	5	0	0
7	65922489	.	A	G	2	0	2	0	3	5	0	0
7	65922495	.	A	G	1	0	1	0	4	5	0	0
7	65922732	.	G	C	7	3	10	0	0	10	0	0
7	65923179	.	C	T	4	3	7	0	0	7	0	0
7	65923238	.	C	T	4	3	7	0	1	8	0	0
7	65923321	.	A	C	8	3	11	0	0	12	1	0
7	65923777	.	T	A	3	3	6	0	0	6	0	0
7	65923921	.	T	C	5	6	11	0	1	12	0	0
7	65923944	.	T	G	6	3	9	0	0	9	0	0
7	65924277	.	T	C	4	4	8	0	1	9	0	0
7	65924554	.	A	G	3	5	8	0	0	8	0	0
7	65924558	.	C	T	2	6	8	0	1	9	0	0
7	65924621	.	T	C	4	5	9	0	0	9	0	0
7	65924634	.	A	G	3	2	5	0	0	5	0	0
7	65939949	.	C	T	2	2	4	0	0	4	0	0
7	66112556	.	G	A	1	5	6	0	0	6	0	0
7	66452390	.	C	T	4	3	7	0	0	7	0	0
7	66452543	.	T	C	3	5	8	0	1	9	0	0
7	66634326	.	T	C	10	11	21	1	0	22	0	0
7	66639333	.	T	C	7	7	14	0	1	15	0	0
7	66642286	.	T	A	16	17	33	0	1	34	0	0
7	66646655	.	T	C	17	11	28	0	2	30	0	0
7	66652907	.	G	C	14	17	31	0	1	33	1	0
7	66652919	.	C	G	16	18	34	0	1	35	0	0
7	66653019	.	G	A	18	16	34	0	1	35	0	0
7	66653335	.	G	C	16	15	31	0	1	32	0	0
7	66653442	.	G	T	1	20	21	0	21	42	0	0
7	66653469	.	T	G	20	18	38	0	3	41	0	0
7	66653529	.	T	C	18	10	28	0	0	28	0	0
7	66653785	.	G	A	1	8	9	0	15	24	0	0
7	66653840	.	T	A	17	13	30	1	3	34	0	0
7	66653929	.	T	C	17	13	30	0	2	32	0	0
7	66653950	.	C	T	17	17	34	0	0	35	1	0
7	66655930	.	G	T	4	9	13	0	2	15	0	0
7	66655938	.	A	T	5	10	15	0	0	15	0	0
7	66656242	.	C	T	2	11	13	0	11	24	0	0
7	66660481	.	T	C	15	0	15	0	12	27	0	0
7	66664405	.	C	T	14	9	23	0	0	23	0	0
7	66670802	.	A	G	5	6	11	0	1	12	0	0
7	66670865	.	T	C	7	4	11	0	0	11	0	0
7	66683490	.	T	C	3	0	3	0	4	7	0	0
7	66685648	.	T	G	5	3	8	0	1	9	0	0
7	66875278	.	T	C	2	1	3	0	0	3	0	0
7	66875298	.	G	T	1	2	3	0	0	3	0	0
7	66884620	.	G	A	3	3	6	0	0	6	0	0
7	66988127	.	A	C	1	2	3	0	0	3	0	0
7	67017349	.	T	G	2	0	2	0	3	5	0	0
7	67017368	.	T	C	2	3	5	0	0	5	0	0
7	67081821	.	C	A	2	4	6	0	0	6	0	0
7	67095218	.	T	C	2	2	4	0	0	4	0	0
7	67152142	.	C	T	5	9	14	0	0	14	0	0
7	67157950	.	T	C	6	8	14	0	0	14	0	0
7	67161491	.	A	G	7	10	17	0	2	19	0	0
7	67165438	.	G	A	0	5	5	0	5	10	0	0
7	67171186	.	G	T	0	3	3	0	6	9	0	0
7	67220614	.	C	T	4	4	8	0	1	9	0	0
7	67227885	.	T	G	2	13	15	0	2	17	0	0
7	67239098	.	A	G	3	10	13	0	0	13	0	0
7	67241045	.	T	C	6	3	9	0	0	9	0	0
7	67247101	.	A	C	1	0	1	0	5	7	1	0
7	67248773	.	A	G	2	3	5	0	0	5	0	0
7	67252044	.	A	C	6	10	16	0	1	17	0	0
7	67310028	.	G	T	5	5	10	0	0	10	0	0
7	67310030	.	T	A	5	5	10	0	0	10	0	0
7	67310144	.	G	T	12	9	21	0	0	21	0	0
7	67310147	.	T	C	12	0	12	0	9	21	0	0
7	67310200	.	T	G	11	13	24	0	0	24	0	0
7	67310269	.	G	A	16	17	33	0	0	33	0	0
7	67310429	.	A	T	13	13	26	0	1	27	0	0
7	67310507	.	T	C	23	22	45	0	2	47	0	0
7	67310690	.	A	G	20	11	31	0	4	35	0	0
7	67314142	.	A	G	9	8	17	0	0	17	0	0
7	67315481	.	G	T	12	8	20	0	2	23	1	0
7	67418757	.	G	T	1	2	3	0	0	3	0	0
7	67432668	.	A	G	5	5	10	0	0	10	0	0
7	67434693	.	A	C	18	15	33	0	0	33	0	0
7	67434807	.	T	C	15	10	25	0	2	27	0	0
7	67439496	.	T	A	8	16	24	0	0	24	0	0
7	67439520	.	T	A	7	16	23	0	0	23	0	0
7	67439742	.	T	C	13	16	29	0	1	30	0	0
7	67439743	.	C	T	10	15	25	0	3	28	0	0
7	67439781	.	T	C	13	16	29	0	1	30	0	0
7	67443766	.	T	C	20	18	38	0	0	38	0	0
7	67471561	.	C	T	27	41	68	0	5	73	0	0
7	67476376	.	T	C	26	31	57	0	3	60	0	0
7	67493909	.	C	T	1	3	4	0	1	5	0	0
7	67493955	.	C	T	1	2	3	0	0	3	0	0
7	67524394	.	G	A	4	3	7	0	0	7	0	0
7	67545636	.	C	T	3	2	5	0	0	5	0	0
7	67555434	.	G	A	0	3	3	0	2	5	0	0
7	67584796	.	C	T	6	4	10	0	1	11	0	0
7	67591043	.	C	T	2	5	7	0	1	8	0	0
7	67594006	.	T	G	15	0	15	0	8	23	0	0
7	67594122	.	C	T	4	7	11	0	0	11	0	0
7	67594248	.	C	T	2	4	6	0	2	8	0	0
7	67594292	.	A	T	3	4	7	0	0	7	0	0
7	67594506	.	G	A	0	6	6	0	9	15	0	0
7	67743901	.	A	G	6	5	11	0	0	11	0	0
7	67744341	.	A	G	13	6	19	0	0	19	0	0
7	67794302	.	G	C	0	7	7	0	1	8	0	0
7	67794314	.	C	T	5	2	7	0	1	8	0	0
7	68218940	.	T	C	3	3	6	0	0	6	0	0
7	68219066	.	C	A	7	3	10	0	4	14	0	0
7	68219332	.	A	G	5	6	11	0	0	11	0	0
7	68219340	.	A	T	5	7	12	0	0	12	0	0
7	68219412	.	T	A	7	11	18	0	0	18	0	0
7	68220824	.	A	C	9	7	16	0	1	17	0	0
7	68224841	.	G	A	3	10	13	0	0	13	0	0
7	68329037	.	C	T	4	2	6	0	0	6	0	0
7	68370843	.	A	G	1	5	6	0	0	6	0	0
7	68541467	.	A	C	2	3	5	0	0	5	0	0
7	68542050	.	A	G	1	0	1	0	3	4	0	0
7	68542095	.	A	T	2	3	5	0	0	5	0	0
7	69144037	.	T	C	2	10	12	0	0	12	0	0
7	69144969	.	T	C	8	2	10	0	0	10	0	0
7	69144984	.	T	C	6	4	10	0	1	11	0	0
7	69145033	.	T	C	1	5	6	0	0	6	0	0
7	69145041	.	T	C	3	0	3	0	2	5	0	0
7	69145836	.	T	C	4	4	8	0	0	8	0	0
7	69146323	.	T	C	3	3	6	0	0	6	0	0
7	69146362	.	T	C	1	6	7	0	1	8	0	0
7	69147328	.	T	C	12	0	12	0	3	15	0	0
7	69313357	.	T	G	6	3	9	0	17	26	0	0
7	69615015	.	G	A	14	11	25	0	0	25	0	0
7	69615021	.	G	A	13	9	22	0	1	23	0	0
7	69617937	.	C	A	9	4	13	0	0	13	0	0
7	69636439	.	G	A	9	5	14	0	0	14	0	0
7	69636454	.	T	C	4	3	7	0	2	9	0	0
7	69643973	.	C	T	1	3	4	0	0	4	0	0
7	69913607	.	G	C	0	2	2	0	3	5	0	0
7	69917639	.	C	A	1	1	2	0	1	3	0	0
7	69934781	.	A	C	3	5	8	0	1	9	0	0
7	69943002	.	C	T	4	4	8	0	0	8	0	0
7	69943491	.	A	G	2	2	4	0	0	4	0	0
7	69946805	.	C	T	4	3	7	0	0	7	0	0
7	69950644	.	G	T	5	3	8	0	0	8	0	0
7	69950666	.	T	C	4	3	7	0	0	7	0	0
7	69950785	.	G	C	0	2	2	0	4	6	0	0
7	69959980	.	G	A	4	7	11	0	1	12	0	0
7	69962366	.	C	T	8	4	12	0	0	12	0	0
7	70267233	.	T	C	6	0	6	0	4	10	0	0
7	70267390	.	A	G	2	2	4	0	0	4	0	0
7	70267426	.	T	C	2	2	4	0	1	5	0	0
7	70267622	.	G	T	2	3	5	0	2	7	0	0
7	70267680	.	T	C	5	2	7	0	0	7	0	0
7	70601377	.	C	T	6	5	11	0	1	12	0	0
7	70611159	.	C	T	7	4	11	0	0	11	0	0
7	70611371	.	T	G	4	4	8	0	1	9	0	0
7	70611606	.	G	A	2	4	6	0	1	7	0	0
7	70611741	.	C	T	0	6	6	0	5	11	0	0
7	70619207	.	C	A	1	3	4	0	4	8	0	0
7	70619253	.	G	A	7	4	11	0	0	11	0	0
7	72018290	.	G	T	0	22	22	0	12	34	0	0
7	72024034	.	T	G	9	12	21	0	1	22	0	0
7	72024081	.	G	T	11	11	22	0	1	23	0	0
7	72024117	.	C	G	12	13	25	0	1	26	0	0
7	72024239	.	T	A	5	19	24	0	1	25	0	0
7	72024350	.	T	C	11	10	21	0	1	22	0	0
7	72024446	.	C	G	12	10	22	0	0	22	0	0
7	72024467	.	G	A	12	10	22	0	0	22	0	0
7	72024491	.	A	T	11	8	19	0	0	19	0	0
7	72024733	.	A	G	10	7	17	0	0	17	0	0
7	72025428	.	T	A	10	14	24	0	0	24	0	0
7	72025430	.	G	A	1	14	15	0	10	25	0	0
7	72025548	.	A	T	10	9	19	0	1	21	1	0
7	72025688	.	A	G	12	0	12	0	17	29	0	0
7	72025689	.	C	G	12	14	26	0	3	29	0	0
7	72025748	.	G	A	13	11	24	0	0	24	0	0
7	72025774	.	T	C	12	10	22	0	2	24	0	0
7	72025966	.	A	G	3	10	13	0	1	14	0	0
7	72027982	.	C	T	28	14	42	0	0	42	0	0
7	72028015	.	C	T	21	21	42	0	0	42	0	0
7	72028386	.	T	A	18	19	37	0	1	38	0	0
7	72028442	.	G	T	17	19	36	1	0	37	0	0
7	72028458	.	T	C	18	14	32	1	1	34	0	0
7	72028742	.	A	G	16	8	24	0	1	25	0	0
7	72028841	.	A	G	20	19	39	0	4	43	0	0
7	72028893	.	G	T	2	6	8	0	15	23	0	0
7	72028976	.	A	T	23	10	33	0	0	33	0	0
7	72029011	.	C	T	17	15	32	0	1	33	0	0
7	72029083	.	T	C	14	19	33	0	1	35	1	0
7	72029127	.	G	T	26	16	42	0	3	45	0	0
7	72029383	.	G	C	10	29	39	0	3	42	0	0
7	72029424	.	G	A	15	21	36	0	3	39	0	0
7	72029429	.	T	G	14	0	14	0	23	37	0	0
7	72032982	.	A	T	16	16	32	0	2	34	0	0
7	72033024	.	G	C	21	13	34	0	1	35	0	0
7	72033053	.	A	C	14	17	31	0	0	31	0	0
7	72033186	.	A	C	12	26	38	0	2	40	0	0
7	72033264	.	G	A	15	18	33	0	0	33	0	0
7	72033286	.	C	T	18	22	40	0	2	42	0	0
7	72033312	.	G	A	19	19	38	0	1	39	0	0
7	72033370	.	A	C	19	11	30	0	3	33	0	0
7	72033384	.	A	C	17	10	27	0	1	28	0	0
7	72034012	.	T	C	12	12	24	0	0	24	0	0
7	72034024	.	C	T	12	10	22	0	1	23	0	0
7	72034151	.	T	C	9	12	21	0	0	21	0	0
7	72034304	.	G	A	19	5	24	0	1	25	0	0
7	72034339	.	C	A	30	8	38	0	1	39	0	0
7	72034521	.	T	C	14	5	19	2	0	21	0	0
7	72034720	.	A	C	6	2	8	0	0	8	0	0
7	72034776	.	C	T	2	10	12	0	0	12	0	0
7	72034805	.	T	C	2	0	2	0	12	14	0	0
7	72034856	.	A	G	8	10	18	1	1	20	0	0
7	72034874	.	T	C	11	10	21	2	0	23	0	0
7	72035075	.	G	A	6	17	23	0	0	23	0	0
7	72035258	.	G	T	4	6	10	0	0	10	0	0
7	72035321	.	A	T	7	15	22	0	1	24	1	0
7	72035339	.	T	G	6	17	23	0	1	24	0	0
7	72035422	.	C	A	11	4	15	1	0	16	0	0
7	72035475	.	C	T	1	9	10	0	5	15	0	0
7	72040996	.	G	C	13	7	20	0	3	23	0	0
7	72045451	.	A	C	11	0	11	0	5	16	0	0
7	72051864	.	C	T	4	4	8	0	1	9	0	0
7	72410082	.	A	G	10	15	25	0	0	25	0	0
7	72411694	.	A	T	7	12	19	0	0	19	0	0
7	72415298	.	A	T	7	11	18	0	0	18	0	0
7	72416996	.	T	G	9	7	16	0	0	16	0	0
7	72417089	.	G	A	7	10	17	0	0	17	0	0
7	72417095	.	C	T	1	7	8	0	10	18	0	0
7	72417322	.	G	A	7	7	14	1	2	17	0	0
7	72417355	.	T	A	7	13	20	0	4	24	0	0
7	72419933	.	G	A	8	10	18	0	0	18	0	0
7	72421715	.	T	C	4	7	11	0	0	11	0	0
7	72421754	.	T	A	5	11	16	0	0	16	0	0
7	72434962	.	T	C	3	0	3	0	11	14	0	0
7	72434978	.	A	T	1	8	9	0	0	9	0	0
7	72469750	.	C	A	1	2	3	0	0	3	0	0
7	72492354	.	A	C	2	2	4	0	0	4	0	0
7	72517569	.	G	A	1	2	3	0	0	3	0	0
7	72524625	.	A	G	2	0	2	0	4	6	0	0
7	72541307	.	T	C	4	4	8	0	0	8	0	0
7	72541310	.	G	A	4	4	8	0	0	8	0	0
7	72541394	.	G	C	0	5	5	2	2	9	0	0
7	72545962	.	C	T	3	2	5	0	1	6	0	0
7	72546664	.	T	A	4	2	6	0	0	6	0	0
7	72549193	.	A	G	7	5	12	0	0	12	0	0
7	72558361	.	T	C	2	3	5	0	0	5	0	0
7	72562004	.	T	G	6	3	9	0	0	9	0	0
7	72567016	.	G	A	6	6	12	0	0	12	0	0
7	72567240	.	A	G	8	6	14	0	0	14	0	0
7	72569230	.	C	G	7	0	7	0	6	13	0	0
7	72570359	.	A	G	11	9	20	0	0	20	0	0
7	72578005	.	C	G	7	7	14	0	0	14	0	0
7	72704231	.	G	C	1	2	3	0	0	3	0	0
7	72723524	.	C	T	1	2	3	0	0	3	0	0
7	72882696	.	T	C	3	3	6	0	0	6	0	0
7	72981115	.	C	T	5	2	7	0	0	7	0	0
7	72981295	.	C	T	3	2	5	0	1	6	0	0
7	72981532	.	C	T	1	5	6	0	0	6	0	0
7	72981574	.	G	A	1	2	3	0	0	3	0	0
7	73012582	.	C	T	5	4	9	0	0	9	0	0
7	73012597	.	G	A	5	3	8	0	0	8	0	0
7	73013741	.	T	C	1	3	4	0	0	4	0	0
7	73013765	.	T	C	1	2	3	0	0	3	0	0
7	73029277	.	G	A	4	3	7	0	2	9	0	0
7	73035395	.	C	T	5	5	10	0	0	10	0	0
7	73035452	.	G	A	0	4	4	0	5	9	0	0
7	73048746	.	C	G	1	4	5	0	0	5	0	0
7	73070506	.	G	A	0	2	2	0	9	11	0	0
7	73084736	.	G	A	0	12	12	0	13	25	0	0
7	73084738	.	C	G	10	1	11	0	14	25	0	0
7	73084873	.	T	G	10	0	10	0	4	14	0	0
7	73084948	.	T	C	9	11	20	0	0	20	0	0
7	73085083	.	G	A	9	7	16	0	3	19	0	0
7	73085188	.	A	T	10	6	16	2	0	18	0	0
7	73085190	.	A	C	10	5	15	2	1	18	0	0
7	73085695	.	A	G	1	2	3	0	0	3	0	0
7	73085730	.	C	T	3	7	10	0	0	10	0	0
7	73085777	.	T	C	3	7	10	0	0	10	0	0
7	73085818	.	G	T	2	3	5	0	0	5	0	0
7	73085837	.	T	C	4	3	7	0	0	7	0	0
7	73085868	.	A	G	4	4	8	0	0	8	0	0
7	73085889	.	T	C	4	6	10	0	0	10	0	0
7	73085914	.	A	G	3	6	9	0	0	9	0	0
7	73085967	.	C	T	2	5	7	0	0	7	0	0
7	73085981	.	T	C	7	4	11	0	0	11	0	0
7	73086051	.	T	G	14	8	22	0	0	22	0	0
7	73086061	.	A	T	13	10	23	0	0	23	0	0
7	73086217	.	A	G	3	9	12	0	0	12	0	0
7	73086326	.	T	C	7	9	16	0	0	16	0	0
7	73087208	.	A	G	9	9	18	0	2	20	0	0
7	73087209	.	T	C	11	8	19	0	2	21	0	0
7	73087250	.	A	C	17	10	27	0	0	27	0	0
7	73087266	.	G	A	16	11	27	0	1	28	0	0
7	73087329	.	T	G	10	11	21	0	1	22	0	0
7	73087344	.	T	C	10	11	21	0	0	21	0	0
7	73087374	.	A	T	11	13	24	0	2	26	0	0
7	73087479	.	A	C	7	7	14	0	0	14	0	0
7	73087491	.	G	A	4	3	7	0	3	10	0	0
7	73087528	.	T	C	9	2	11	0	0	11	0	0
7	73087600	.	A	G	9	0	9	0	4	13	0	0
7	73087702	.	A	G	9	0	9	0	8	17	0	0
7	73087741	.	G	C	4	8	12	0	8	20	0	0
7	73087895	.	A	C	16	17	33	0	0	33	0	0
7	73088489	.	C	T	7	15	22	0	2	24	0	0
7	73297746	.	C	G	2	1	3	0	1	4	0	0
7	73332657	.	A	G	4	0	4	2	3	9	0	0
7	73337684	.	G	A	2	7	9	0	0	9	0	0
7	73338005	.	G	A	2	5	7	0	7	14	0	0
7	73338051	.	C	G	13	6	19	0	1	20	0	0
7	73397528	.	G	A	1	5	6	0	9	15	0	0
7	73397531	.	C	T	8	6	14	0	1	15	0	0
7	73397568	.	T	C	8	8	16	0	0	16	0	0
7	73401946	.	C	T	24	13	37	0	0	37	0	0
7	73612053	.	T	C	3	4	7	0	0	7	0	0
7	73612138	.	T	A	7	3	10	0	0	10	0	0
7	73612356	.	C	G	1	9	10	0	1	11	0	0
7	73612510	.	C	G	8	1	9	0	3	12	0	0
7	73612683	.	G	A	7	5	12	0	0	12	0	0
7	73612806	.	G	A	6	4	10	0	0	10	0	0
7	73613025	.	C	T	9	5	14	0	1	15	0	0
7	73613230	.	G	A	5	6	11	0	0	11	0	0
7	73613362	.	C	A	7	8	15	0	0	15	0	0
7	73613478	.	G	A	4	10	14	0	0	14	0	0
7	73613555	.	G	T	4	7	11	0	0	11	0	0
7	73615097	.	C	T	3	3	6	0	0	6	0	0
7	73615798	.	C	T	9	5	14	0	1	15	0	0
7	73615889	.	G	A	8	7	15	0	0	15	0	0
7	73616027	.	A	G	5	9	14	0	0	14	0	0
7	73616547	.	T	A	10	10	20	0	0	20	0	0
7	73616711	.	T	C	6	6	12	0	1	14	1	0
7	73617583	.	A	G	4	4	8	0	0	8	0	0
7	73617589	.	A	G	3	4	7	0	1	8	0	0
7	73617637	.	T	C	11	8	19	0	3	22	0	0
7	73617654	.	A	T	12	10	22	0	3	25	0	0
7	73617759	.	G	A	1	6	7	0	10	17	0	0
7	73617792	.	A	G	6	5	11	0	2	13	0	0
7	73617817	.	A	G	10	3	13	0	2	15	0	0
7	73618004	.	G	A	11	14	25	0	1	26	0	0
7	73618437	.	A	G	9	6	15	0	6	21	0	0
7	73618456	.	A	G	9	1	10	0	10	20	0	0
7	73618474	.	A	G	6	12	18	0	0	18	0	0
7	73618519	.	A	G	12	3	15	0	1	16	0	0
7	73618522	.	A	G	12	4	16	0	0	16	0	0
7	73618866	.	A	G	7	0	7	0	4	11	0	0
7	73619587	.	A	C	12	9	21	0	1	22	0	0
7	73620129	.	C	T	9	12	21	0	0	21	0	0
7	73630951	.	G	C	29	32	61	0	1	62	0	0
7	73630955	.	G	A	3	33	36	0	28	64	0	0
7	73651959	.	C	A	37	16	53	0	4	57	0	0
7	73652321	.	T	A	33	20	53	0	1	54	0	0
7	73652715	.	A	T	24	24	48	0	2	50	0	0
7	73652819	.	C	T	17	23	40	0	1	41	0	0
7	73652873	.	G	T	16	16	32	0	2	34	0	0
7	73652892	.	A	G	16	1	17	0	17	34	0	0
7	73653241	.	T	C	36	18	54	0	1	55	0	0
7	73653373	.	C	A	23	25	48	0	2	51	1	0
7	73653994	.	G	A	18	18	36	0	2	38	0	0
7	73654065	.	T	C	15	13	28	0	2	30	0	0
7	73654505	.	C	T	22	24	46	0	0	46	0	0
7	73654647	.	C	G	27	3	30	0	39	69	0	0
7	73654652	.	G	A	38	24	62	0	5	67	0	0
7	73654693	.	A	C	39	27	66	0	1	67	0	0
7	73654742	.	C	A	29	35	64	0	2	66	0	0
7	73654827	.	A	G	36	24	60	0	1	61	0	0
7	73654878	.	C	T	35	26	61	0	1	62	0	0
7	73654896	.	G	A	28	31	59	0	2	61	0	0
7	73655474	.	T	G	43	21	64	0	1	65	0	0
7	73655580	.	G	A	29	21	50	0	8	58	0	0
7	73655698	.	A	G	19	19	38	0	1	39	0	0
7	73655775	.	T	C	7	15	22	0	2	24	0	0
7	73655997	.	C	T	33	33	66	0	3	69	0	0
7	73655998	.	T	C	36	31	67	0	2	69	0	0
7	73656075	.	T	C	43	32	75	0	1	76	0	0
7	73656136	.	G	A	31	25	56	0	2	58	0	0
7	73656361	.	G	A	5	3	8	0	2	10	0	0
7	74056606	.	G	T	15	18	33	0	1	34	0	0
7	74085487	.	C	T	0	5	5	0	4	9	0	0
7	74086382	.	T	C	1	0	1	0	6	7	0	0
7	74134988	.	T	C	20	11	31	0	4	35	0	0
7	74135136	.	G	A	3	16	19	0	30	49	0	0
7	74135375	.	C	T	15	24	39	0	6	45	0	0
7	74135462	.	A	G	21	16	37	0	1	38	0	0
7	74135773	.	G	T	7	3	10	0	3	13	0	0
7	74143628	.	C	T	3	5	8	0	0	8	0	0
7	74144167	.	A	G	5	0	5	0	10	15	0	0
7	74154066	.	C	T	35	20	55	1	2	58	0	0
8	5733	.	T	C	23	24	47	0	1	48	0	0
8	6265	.	C	T	32	26	58	0	2	60	0	0
8	6366	.	T	C	37	11	48	0	3	51	0	0
8	6372	.	T	A	24	16	40	0	8	48	0	0
8	7184	.	T	C	10	12	22	0	0	22	0	0
8	7276	.	G	A	9	12	21	0	3	24	0	0
8	7346	.	G	T	9	15	24	0	0	24	0	0
8	387692	.	G	A	4	4	8	0	1	9	0	0
8	387926	.	G	A	4	3	7	0	2	9	0	0
8	388020	.	G	C	11	7	18	0	0	18	0	0
8	388949	.	G	A	15	9	24	0	2	26	0	0
8	388971	.	T	C	14	14	28	1	0	29	0	0
8	389114	.	T	A	10	15	25	0	3	28	0	0
8	391988	.	C	A	9	7	16	0	0	16	0	0
8	392389	.	T	C	9	0	9	0	11	20	0	0
8	395428	.	G	A	11	8	19	1	2	22	0	0
8	397233	.	G	A	11	7	18	0	1	19	0	0
8	397338	.	T	C	15	11	26	0	0	26	0	0
8	400185	.	C	G	6	11	17	0	0	17	0	0
8	406330	.	T	G	9	3	12	0	0	12	0	0
8	412296	.	T	C	19	0	19	0	11	30	0	0
8	412345	.	A	G	21	4	25	0	1	26	0	0
8	412355	.	A	G	19	3	22	0	0	22	0	0
8	417849	.	A	G	5	4	9	0	1	10	0	0
8	423533	.	T	C	4	5	9	0	0	9	0	0
8	423815	.	C	A	15	13	28	0	0	28	0	0
8	423897	.	A	G	7	8	15	2	1	18	0	0
8	424123	.	G	A	9	10	19	0	0	19	0	0
8	927105	.	T	C	1	3	4	0	0	4	0	0
8	1852056	.	A	G	3	3	6	0	0	6	0	0
8	1852078	.	A	G	4	3	7	0	0	7	0	0
8	1852599	.	A	G	4	8	12	0	0	12	0	0
8	1853005	.	A	G	5	4	9	0	1	10	0	0
8	1853406	.	A	G	7	4	11	0	2	13	0	0
8	1853474	.	A	G	2	6	8	0	0	8	0	0
8	1855245	.	A	G	9	3	12	0	0	12	0	0
8	1855312	.	A	G	13	4	17	0	1	18	0	0
8	1856254	.	A	G	13	14	27	0	1	28	0	0
8	1856265	.	A	G	9	15	24	0	2	26	0	0
8	2412800	.	C	T	36	5	41	1	1	43	0	0
8	2412911	.	G	A	29	24	53	0	1	54	0	0
8	2413133	.	T	G	32	31	63	0	6	69	0	0
8	2413160	.	G	C	36	1	37	0	29	66	0	0
8	2416886	.	G	A	26	18	44	0	6	50	0	0
8	2416931	.	C	T	2	25	27	0	22	49	0	0
8	2417891	.	T	C	21	30	51	0	1	52	0	0
8	2421318	.	T	C	27	13	40	0	1	41	0	0
8	2421342	.	C	A	23	18	41	0	2	43	0	0
8	2426500	.	A	G	24	18	42	0	0	42	0	0
8	2438671	.	T	C	2	6	8	0	0	8	0	0
8	2446957	.	C	T	2	4	6	0	0	6	0	0
8	2456933	.	C	T	4	5	9	0	1	10	0	0
8	2456953	.	C	G	5	6	11	0	0	11	0	0
8	2457571	.	T	C	9	5	14	0	0	14	0	0
8	2467230	.	A	G	11	0	11	0	6	17	0	0
8	2467233	.	A	G	9	5	14	0	2	16	0	0
8	2469292	.	G	A	14	6	20	0	0	20	0	0
8	2469377	.	G	C	6	3	9	0	0	9	0	0
8	2469401	.	C	T	3	4	7	0	0	7	0	0
8	2469528	.	G	T	4	2	6	0	0	6	0	0
8	2469559	.	C	T	6	2	8	0	0	8	0	0
8	2487329	.	T	C	30	23	53	0	1	54	0	0
8	2490968	.	C	T	26	21	47	0	0	47	0	0
8	2491338	.	G	A	10	8	18	0	0	18	0	0
8	2502037	.	G	A	38	37	75	0	2	77	0	0
8	2502067	.	C	T	44	28	72	0	4	76	0	0
8	2502088	.	A	G	47	23	70	0	3	73	0	0
8	2502112	.	A	G	49	25	74	0	2	76	0	0
8	2516019	.	C	T	2	4	6	0	6	12	0	0
8	2525435	.	A	G	5	6	11	0	0	11	0	0
8	2525450	.	T	C	5	5	10	0	1	11	0	0
8	2525492	.	A	T	6	5	11	0	0	11	0	0
8	2529817	.	T	A	4	9	13	0	0	13	0	0
8	2529852	.	A	G	1	3	4	0	0	4	0	0
8	2530118	.	G	A	10	8	18	0	0	18	0	0
8	2535588	.	T	A	9	12	21	0	6	27	0	0
8	2535642	.	T	C	9	5	14	0	0	14	0	0
8	2536673	.	A	G	3	3	6	0	0	6	0	0
8	2536761	.	G	C	3	2	5	0	0	5	0	0
8	2549579	.	T	C	3	5	8	0	2	10	0	0
8	2549582	.	A	G	4	7	11	0	0	11	0	0
8	2555046	.	C	G	5	5	10	0	0	10	0	0
8	2560680	.	T	G	8	0	8	0	5	13	0	0
8	2560848	.	A	G	7	8	15	0	0	15	0	0
8	2566882	.	G	T	3	2	5	0	0	5	0	0
8	2567788	.	T	C	5	4	9	0	1	10	0	0
8	2567818	.	C	T	5	5	10	0	0	10	0	0
8	2571478	.	T	C	5	4	9	0	0	9	0	0
8	2574463	.	A	G	5	0	5	0	2	7	0	0
8	2574470	.	T	G	4	3	7	0	1	8	0	0
8	2574514	.	A	C	8	6	14	0	1	15	0	0
8	2574524	.	A	C	7	6	13	0	3	16	0	0
8	2585280	.	A	T	2	3	5	0	0	5	0	0
8	2585329	.	G	C	4	10	14	1	0	15	0	0
8	2585681	.	C	A	22	10	32	0	1	34	1	0
8	2588348	.	A	G	30	24	54	0	4	58	0	0
8	2588354	.	C	A	3	23	26	0	34	60	0	0
8	2591624	.	A	C	14	0	14	0	7	21	0	0
8	2606354	.	T	C	2	6	8	0	0	8	0	0
8	2606435	.	A	T	3	2	5	0	0	5	0	0
8	3085466	.	C	A	1	3	4	0	0	4	0	0
8	3085565	.	A	G	4	4	8	0	1	9	0	0
8	3085841	.	T	A	6	3	9	0	1	10	0	0
8	3085863	.	A	G	5	4	9	0	0	9	0	0
8	3099585	.	G	A	1	4	5	0	13	18	0	0
8	3099890	.	A	T	1	3	4	0	0	4	0	0
8	3100184	.	G	C	3	3	6	0	0	6	0	0
8	3100425	.	C	A	1	4	5	0	0	5	0	0
8	3100442	.	A	G	1	3	4	0	0	4	0	0
8	3101241	.	G	T	7	7	14	0	0	14	0	0
8	3101277	.	T	C	6	5	11	0	1	12	0	0
8	3426825	.	T	C	1	2	3	0	0	3	0	0
8	3426986	.	G	A	1	2	3	0	0	3	0	0
8	3427273	.	T	C	1	3	4	0	0	4	0	0
8	3431825	.	C	T	2	3	5	0	0	5	0	0
8	3434368	.	G	A	2	2	4	0	0	4	0	0
8	3439164	.	G	A	1	2	3	0	0	3	0	0
8	3439283	.	G	C	3	3	6	0	0	6	0	0
8	3439309	.	C	T	3	3	6	0	0	6	0	0
8	3537152	.	G	A	1	2	3	0	6	9	0	0
8	3539482	.	C	T	1	5	6	0	0	6	0	0
8	3557831	.	T	C	1	4	5	0	0	5	0	0
8	3561501	.	T	C	5	7	12	0	0	12	0	0
8	3561515	.	G	A	4	6	10	0	1	11	0	0
8	3566853	.	G	A	2	2	4	0	1	5	0	0
8	3568004	.	C	T	3	4	7	0	0	7	0	0
8	3568037	.	C	T	4	3	7	0	0	7	0	0
8	3569907	.	C	T	6	6	12	0	0	12	0	0
8	3571727	.	T	A	4	3	7	0	0	7	0	0
8	3586385	.	C	T	3	4	7	0	0	7	0	0
8	3589375	.	T	G	6	4	10	0	0	10	0	0
8	3591154	.	T	C	8	3	11	0	1	12	0	0
8	3591211	.	C	A	8	6	14	0	0	14	0	0
8	3594308	.	A	G	6	0	6	0	3	9	0	0
8	3595161	.	G	A	2	4	6	0	5	11	0	0
8	3595359	.	C	T	11	6	17	0	0	17	0	0
8	3597233	.	T	C	4	8	12	0	0	12	0	0
8	3602715	.	T	A	3	3	6	0	0	6	0	0
8	3605050	.	A	G	4	0	4	0	4	8	0	0
8	3612263	.	T	A	6	9	15	0	0	15	0	0
8	3612308	.	A	T	7	9	16	0	0	16	0	0
8	3624208	.	G	C	14	9	23	0	1	24	0	0
8	3628683	.	C	T	11	13	24	0	1	25	0	0
8	3628747	.	C	A	8	11	19	0	1	20	0	0
8	3628758	.	T	A	5	15	20	0	3	23	0	0
8	3628782	.	G	A	1	12	13	0	10	23	0	0
8	3631371	.	T	C	13	9	22	0	2	24	0	0
8	3631932	.	C	T	26	14	40	0	1	41	0	0
8	3641218	.	G	C	17	20	37	0	1	38	0	0
8	3643299	.	T	C	21	27	48	1	1	50	0	0
8	3659979	.	T	C	9	5	14	0	0	14	0	0
8	3660034	.	C	T	9	9	18	0	0	18	0	0
8	3674510	.	C	T	5	3	8	0	0	8	0	0
8	3674701	.	T	C	4	3	7	0	0	7	0	0
8	3756287	.	C	A	0	3	3	0	3	6	0	0
8	3859383	.	T	A	7	7	14	0	1	15	0	0
8	3865233	.	T	C	7	10	17	0	0	17	0	0
8	3883831	.	C	G	11	6	17	0	1	18	0	0
8	3886220	.	T	C	11	12	23	0	1	24	0	0
8	3889662	.	G	A	1	14	15	0	8	23	0	0
8	3890837	.	T	C	13	9	22	0	1	23	0	0
8	3904963	.	C	T	3	14	17	0	1	18	0	0
8	3915909	.	G	A	18	10	28	0	0	28	0	0
8	3923371	.	C	T	13	9	22	0	1	23	0	0
8	3932889	.	A	T	6	3	9	0	3	12	0	0
8	3932974	.	A	G	6	6	12	1	1	14	0	0
8	3932990	.	A	G	5	8	13	1	0	14	0	0
8	3933498	.	T	A	16	16	32	0	2	34	0	0
8	3949558	.	G	T	3	7	10	0	1	11	0	0
8	3950039	.	C	G	7	5	12	0	3	15	0	0
8	3950317	.	G	A	5	3	8	0	0	8	0	0
8	3950341	.	A	G	1	3	4	0	0	4	0	0
8	3950554	.	C	T	2	1	3	0	1	4	0	0
8	3950655	.	C	T	5	4	9	0	1	10	0	0
8	3952495	.	G	T	2	3	5	0	0	5	0	0
8	3960992	.	G	A	9	7	16	0	1	17	0	0
8	3974903	.	G	A	6	4	10	0	0	10	0	0
8	4044846	.	G	A	4	6	10	0	1	11	0	0
8	4045163	.	G	A	2	2	4	0	0	4	0	0
8	4048709	.	A	T	1	1	2	0	1	3	0	0
8	4059000	.	G	A	1	3	4	0	0	4	0	0
8	4059039	.	C	T	2	2	4	0	0	4	0	0
8	4059838	.	G	A	1	2	3	0	1	4	0	0
8	4074424	.	G	A	3	3	6	0	0	6	0	0
8	4368714	.	C	G	5	5	10	0	0	10	0	0
8	4368847	.	T	A	3	3	6	0	3	9	0	0
8	4368848	.	C	G	4	5	9	0	0	9	0	0
8	4369021	.	A	C	7	10	17	0	0	17	0	0
8	4381510	.	A	G	4	0	4	0	11	15	0	0
8	4381624	.	G	A	6	7	13	0	0	13	0	0
8	4386198	.	A	G	4	3	7	0	0	7	0	0
8	4393910	.	C	G	8	7	15	0	1	16	0	0
8	4398425	.	A	T	6	5	11	0	0	11	0	0
8	4398531	.	T	C	8	4	12	0	2	14	0	0
8	4398737	.	C	T	11	14	25	0	0	25	0	0
8	4398762	.	A	G	16	16	32	0	0	32	0	0
8	4398981	.	G	A	2	7	9	0	7	16	0	0
8	4400242	.	A	G	2	2	4	1	1	6	0	0
8	4400253	.	T	C	2	4	6	0	0	6	0	0
8	4400337	.	A	G	3	5	8	0	1	9	0	0
8	4400357	.	T	G	3	3	6	0	0	6	0	0
8	4400699	.	C	A	6	11	17	0	0	17	0	0
8	4400861	.	T	C	12	5	17	0	3	20	0	0
8	4400872	.	G	A	2	3	5	0	15	20	0	0
8	4401053	.	T	G	5	7	12	0	0	12	0	0
8	4401068	.	C	T	6	6	12	0	1	13	0	0
8	4401374	.	G	A	1	8	9	0	6	15	0	0
8	4401514	.	A	T	7	9	16	0	0	16	0	0
8	4401687	.	G	A	16	14	30	0	2	32	0	0
8	4401708	.	C	T	17	16	33	0	2	35	0	0
8	4401813	.	G	T	17	22	39	0	2	41	0	0
8	4401913	.	T	G	9	6	15	0	0	15	0	0
8	4401931	.	T	C	4	12	16	0	0	16	0	0
8	4436840	.	A	T	1	2	3	0	0	3	0	0
8	4440705	.	A	C	2	3	5	0	0	5	0	0
8	4440720	.	T	C	2	5	7	0	0	7	0	0
8	4442655	.	G	A	0	4	4	0	1	5	0	0
8	4443129	.	G	A	0	2	2	0	4	6	0	0
8	4443130	.	T	C	3	3	6	0	0	6	0	0
8	4444201	.	A	G	2	5	7	0	0	7	0	0
8	4446247	.	A	C	4	0	4	0	4	8	0	0
8	4446266	.	C	T	1	3	4	0	4	8	0	0
8	4446303	.	T	C	4	2	6	0	0	6	0	0
8	4446389	.	C	T	3	4	7	0	0	7	0	0
8	4446407	.	T	C	1	0	1	0	5	6	0	0
8	4516962	.	G	A	3	2	5	0	0	5	0	0
8	4519116	.	C	T	0	5	5	0	1	6	0	0
8	4522035	.	T	A	2	2	4	0	0	4	0	0
8	4525126	.	C	T	1	2	3	0	0	3	0	0
8	4525174	.	A	G	3	4	7	0	0	7	0	0
8	4529598	.	A	G	2	2	4	0	0	4	0	0
8	4530635	.	C	A	5	2	7	0	1	8	0	0
8	4530647	.	G	A	4	3	7	0	1	8	0	0
8	4531903	.	C	A	2	5	7	0	0	7	0	0
8	4541242	.	C	G	1	2	3	0	0	3	0	0
8	4556863	.	A	T	3	2	5	0	1	6	0	0
8	4576244	.	A	C	1	3	4	0	0	4	0	0
8	4577907	.	A	G	4	4	8	0	0	8	0	0
8	4589148	.	A	G	30	17	47	0	2	49	0	0
8	4589169	.	T	G	29	22	51	0	1	52	0	0
8	4589216	.	A	T	32	18	50	0	2	52	0	0
8	4589402	.	C	T	29	26	55	0	2	57	0	0
8	4596649	.	T	A	30	21	51	0	0	51	0	0
8	4609822	.	T	C	26	0	26	0	27	53	0	0
8	4618536	.	G	A	30	19	49	1	1	51	0	0
8	4618562	.	C	T	2	14	16	1	15	32	0	0
8	4621454	.	A	G	3	4	7	0	0	7	0	0
8	4621614	.	A	T	1	5	6	0	0	6	0	0
8	4621742	.	A	G	5	2	7	0	0	7	0	0
8	4621744	.	C	T	6	2	8	0	0	8	0	0
8	4621817	.	G	T	6	6	12	0	0	12	0	0
8	4668899	.	G	A	2	2	4	0	0	4	0	0
8	4697808	.	A	C	4	2	6	0	0	6	0	0
8	4697849	.	G	C	3	2	5	0	1	6	0	0
8	4698161	.	G	A	2	2	4	1	0	5	0	0
8	4699317	.	A	T	2	4	6	0	0	6	0	0
8	4776243	.	A	T	17	18	35	0	1	36	0	0
8	4780127	.	A	T	4	4	8	0	0	8	0	0
8	4780368	.	T	A	5	4	9	0	0	9	0	0
8	4780552	.	C	T	2	5	7	0	14	21	0	0
8	4780637	.	G	T	10	9	19	0	1	20	0	0
8	4782879	.	C	T	0	7	7	0	12	19	0	0
8	4788942	.	T	C	8	0	8	0	8	16	0	0
8	4799273	.	A	G	1	0	1	5	3	9	0	0
8	4799942	.	T	C	2	2	4	7	0	11	0	0
8	4799945	.	T	C	2	1	3	7	1	11	0	0
8	4800185	.	C	T	4	2	6	3	1	10	0	0
8	4803950	.	C	T	17	10	27	0	0	27	0	0
8	4803956	.	C	T	16	11	27	0	1	28	0	0
8	4806795	.	T	C	7	8	15	0	0	15	0	0
8	4806865	.	C	T	3	6	9	0	1	10	0	0
8	4807033	.	G	C	0	4	4	0	7	11	0	0
8	4807084	.	C	T	2	4	6	0	1	7	0	0
8	4809221	.	C	T	3	7	10	0	1	11	0	0
8	4809230	.	C	T	3	6	9	0	1	10	0	0
8	4813479	.	A	C	8	4	12	0	0	12	0	0
8	4813493	.	T	C	8	4	12	0	0	12	0	0
8	4813592	.	C	T	8	5	13	0	0	13	0	0
8	4813635	.	G	A	6	5	11	0	1	12	0	0
8	4848815	.	A	G	1	4	5	0	0	5	0	0
8	4848818	.	G	T	0	4	4	0	1	5	0	0
8	4868877	.	T	C	1	2	3	0	0	3	0	0
8	4964228	.	A	G	1	4	5	0	1	6	0	0
8	4964236	.	T	C	3	5	8	0	1	9	0	0
8	5119396	.	A	G	12	16	28	0	1	29	0	0
8	5122568	.	G	A	12	9	21	0	1	22	0	0
8	5141521	.	G	A	20	10	30	0	1	31	0	0
8	5142508	.	G	C	12	11	23	0	0	23	0	0
8	5144347	.	T	G	12	8	20	0	0	20	0	0
8	5148911	.	A	G	7	9	16	0	3	19	0	0
8	5149030	.	G	T	4	15	19	0	1	20	0	0
8	7119123	.	A	G	6	6	12	0	1	13	0	0
8	7119128	.	A	G	9	6	15	0	0	15	0	0
8	7909314	.	A	G	4	5	9	0	0	9	0	0
8	7909351	.	A	G	5	3	8	0	1	9	0	0
8	7909374	.	A	G	2	4	6	0	0	6	0	0
8	7909663	.	A	G	1	3	4	0	1	5	0	0
8	7910145	.	A	G	2	0	2	0	3	5	0	0
8	7912647	.	A	T	3	2	5	0	0	5	0	0
8	8686398	.	T	C	2	0	2	0	2	4	0	0
8	8686875	.	T	C	3	2	5	0	0	5	0	0
8	11201986	.	G	T	2	2	4	0	0	4	0	0
8	11202058	.	C	T	1	5	6	0	0	6	0	0
8	11204321	.	A	G	3	3	6	0	0	6	0	0
8	11204365	.	C	A	1	4	5	0	0	5	0	0
8	11234333	.	A	C	2	0	2	0	4	6	0	0
8	11234334	.	T	G	2	4	6	0	0	6	0	0
8	11234489	.	T	C	3	0	3	0	7	10	0	0
8	11234573	.	A	G	9	8	17	0	1	18	0	0
8	11236914	.	T	C	7	4	11	0	0	11	0	0
8	11245918	.	C	T	6	5	11	0	0	11	0	0
8	11268717	.	A	T	7	2	9	0	0	9	0	0
8	11278615	.	G	A	6	4	10	0	0	10	0	0
8	11288949	.	C	T	2	4	6	0	0	6	0	0
8	11289267	.	G	C	4	4	8	0	0	8	0	0
8	11289274	.	C	A	5	4	9	0	0	9	0	0
8	11327947	.	C	G	3	5	8	0	1	9	0	0
8	11337395	.	C	T	3	3	6	0	0	6	0	0
8	11337703	.	A	C	1	2	3	0	0	3	0	0
8	11338731	.	A	G	3	3	6	0	0	6	0	0
8	11338934	.	A	T	4	5	9	0	1	10	0	0
8	11338941	.	G	A	0	7	7	0	3	10	0	0
8	11339307	.	T	C	5	6	11	0	0	11	0	0
8	11339379	.	A	T	4	4	8	0	0	8	0	0
8	11339528	.	G	T	2	2	4	0	0	4	0	0
8	11477573	.	C	T	5	9	14	0	1	15	0	0
8	11483097	.	G	A	3	11	14	0	15	29	0	0
8	11483163	.	C	T	16	11	27	0	0	27	0	0
8	11488414	.	C	T	15	13	28	0	0	28	0	0
8	11491308	.	A	G	9	10	19	1	2	22	0	0
8	11491332	.	C	T	9	15	24	1	0	25	0	0
8	11491347	.	G	C	0	12	12	1	8	21	0	0
8	11503000	.	A	C	6	11	17	0	1	18	0	0
8	11503006	.	T	C	4	12	16	0	2	18	0	0
8	11504174	.	T	A	6	6	12	0	0	12	0	0
8	11520599	.	C	T	11	4	15	0	1	16	0	0
8	11521110	.	A	T	6	13	19	0	1	20	0	0
8	11521145	.	G	A	8	8	16	0	0	16	0	0
8	11521229	.	C	T	11	6	17	0	0	17	0	0
8	11521244	.	A	G	11	8	19	0	0	19	0	0
8	11535261	.	A	G	10	11	21	0	3	24	0	0
8	11540815	.	G	T	13	13	26	0	1	27	0	0
8	11541829	.	A	G	8	16	24	0	0	24	0	0
8	11541844	.	C	A	11	13	24	0	0	24	0	0
8	11541880	.	T	C	11	9	20	0	0	20	0	0
8	11543023	.	G	T	1	2	3	0	0	3	0	0
8	11543050	.	G	A	2	2	4	0	0	4	0	0
8	11548214	.	T	G	2	4	6	0	0	6	0	0
8	11548311	.	G	T	1	5	6	0	0	6	0	0
8	11578414	.	G	T	9	6	15	0	0	15	0	0
8	11584163	.	T	C	5	4	9	0	0	9	0	0
8	11590898	.	G	A	5	5	10	0	1	11	0	0
8	11590903	.	G	A	6	4	10	0	0	10	0	0
8	11603914	.	G	A	7	6	13	0	0	13	0	0
8	11646509	.	G	T	1	3	4	0	0	4	0	0
8	11648725	.	C	T	2	2	4	0	0	4	0	0
8	11648767	.	G	A	2	2	4	0	0	4	0	0
8	11648815	.	T	G	5	3	8	0	1	9	0	0
8	11661816	.	A	C	2	4	6	0	0	6	0	0
8	11715504	.	C	T	4	4	8	0	0	8	0	0
8	11715528	.	T	C	1	3	4	0	0	4	0	0
8	11728191	.	C	T	3	2	5	0	1	6	0	0
8	11728655	.	C	A	3	3	6	0	0	6	0	0
8	11734317	.	C	T	4	7	11	0	1	12	0	0
8	11734353	.	C	A	7	7	14	0	2	16	0	0
8	11736671	.	T	A	7	8	15	0	1	16	0	0
8	11737826	.	T	C	7	3	10	0	1	11	0	0
8	11740220	.	T	C	11	11	22	0	1	23	0	0
8	11740370	.	G	A	15	13	28	0	1	29	0	0
8	11740461	.	A	C	5	6	11	0	0	12	1	0
8	11746684	.	A	G	4	7	11	0	0	11	0	0
8	11746701	.	G	T	5	7	12	0	0	12	0	0
8	11746741	.	G	A	7	15	22	0	1	23	0	0
8	11752669	.	C	T	1	5	6	0	4	10	0	0
8	11752672	.	T	A	4	6	10	0	0	10	0	0
8	11756602	.	A	G	3	5	8	0	0	8	0	0
8	11757139	.	T	C	1	2	3	0	0	3	0	0
8	11761820	.	C	T	0	8	8	0	6	14	0	0
8	11761862	.	T	C	5	0	5	0	5	10	0	0
8	11770027	.	A	G	2	6	8	0	0	8	0	0
8	11770033	.	T	A	2	5	7	0	0	7	0	0
8	11779630	.	C	A	0	2	2	0	3	5	0	0
8	11788795	.	C	T	6	4	10	0	0	10	0	0
8	11789554	.	T	C	3	3	6	0	1	7	0	0
8	11789587	.	G	A	4	3	7	0	0	7	0	0
8	11792633	.	A	G	3	2	5	0	0	5	0	0
8	11803515	.	T	C	3	5	8	0	0	8	0	0
8	11823195	.	C	G	0	2	2	0	3	5	0	0
8	11831881	.	A	G	2	6	8	0	1	9	0	0
8	11884789	.	A	T	2	5	7	0	0	7	0	0
8	11885082	.	T	C	7	2	9	0	0	9	0	0
8	11987931	.	C	T	4	3	7	0	0	7	0	0
8	12016451	.	T	C	10	8	18	0	1	19	0	0
8	12111198	.	C	T	12	15	27	0	1	28	0	0
8	12135190	.	G	A	6	11	17	0	0	17	0	0
8	12135193	.	A	G	5	11	16	0	0	16	0	0
8	12135256	.	G	A	7	12	19	0	0	19	0	0
8	12136448	.	A	G	4	13	17	0	0	17	0	0
8	12142180	.	T	A	6	8	14	0	0	14	0	0
8	12149994	.	G	A	4	3	7	0	0	7	0	0
8	12150108	.	A	G	6	5	11	0	0	11	0	0
8	12150480	.	A	G	4	3	7	0	1	8	0	0
8	12150516	.	G	C	3	0	3	0	4	7	0	0
8	12156204	.	C	T	3	4	7	0	0	7	0	0
8	12182923	.	G	A	1	5	6	0	1	7	0	0
8	12183187	.	T	C	1	0	1	0	4	5	0	0
8	12189722	.	G	A	4	7	11	0	0	11	0	0
8	12209354	.	C	G	2	2	4	0	0	4	0	0
8	12452284	.	C	T	1	5	6	1	17	24	0	0
8	12521420	.	A	G	8	4	12	0	0	12	0	0
8	12574533	.	A	G	8	6	14	1	0	15	0	0
8	12601513	.	G	A	14	5	19	1	0	20	0	0
8	12668578	.	G	T	5	10	15	0	0	15	0	0
8	12668714	.	C	T	4	5	9	0	0	9	0	0
8	12925505	.	T	C	10	8	18	0	0	18	0	0
8	12930227	.	T	C	11	3	14	0	0	14	0	0
8	12932734	.	G	A	7	9	16	0	1	17	0	0
8	12935793	.	A	G	7	0	7	0	5	12	0	0
8	12935799	.	T	C	5	5	10	0	0	10	0	0
8	12935844	.	C	T	3	5	8	0	0	8	0	0
8	12936041	.	A	G	2	0	2	0	4	6	0	0
8	12936857	.	A	C	8	21	29	0	0	29	0	0
8	12937147	.	T	C	7	5	12	0	0	12	0	0
8	12951260	.	C	G	1	2	3	0	0	3	0	0
8	12962712	.	T	C	2	2	4	0	0	4	0	0
8	12969111	.	A	G	3	0	3	0	3	6	0	0
8	12969220	.	G	A	0	2	2	0	6	8	0	0
8	12989640	.	T	A	3	2	5	0	0	5	0	0
8	12991628	.	C	T	2	4	6	0	0	6	0	0
8	12994619	.	C	T	6	2	8	0	0	8	0	0
8	12998146	.	T	C	3	3	6	0	0	6	0	0
8	12998155	.	T	C	3	4	7	0	0	7	0	0
8	13003708	.	G	A	1	2	3	0	0	3	0	0
8	13068237	.	A	T	12	12	24	0	2	26	0	0
8	13068315	.	C	T	12	16	28	0	3	31	0	0
8	13093662	.	G	A	13	13	26	0	1	27	0	0
8	13093677	.	C	T	14	10	24	0	0	24	0	0
8	13094216	.	A	G	10	12	22	0	0	22	0	0
8	13094340	.	C	T	10	14	24	0	2	26	0	0
8	13097535	.	C	T	5	4	9	0	7	16	0	0
8	13097538	.	C	A	5	11	16	0	1	17	0	0
8	13098033	.	A	G	3	7	10	0	1	11	0	0
8	13136913	.	C	T	3	3	6	0	0	6	0	0
8	13157427	.	A	T	7	2	9	0	0	9	0	0
8	13157443	.	T	A	3	2	5	0	3	8	0	0
8	13157470	.	C	T	1	2	3	0	1	4	0	0
8	13157718	.	C	T	3	5	8	1	0	9	0	0
8	13157719	.	A	C	3	5	8	1	0	9	0	0
8	13157978	.	T	A	2	4	6	0	0	6	0	0
8	13157980	.	A	T	2	4	6	0	0	6	0	0
8	13159280	.	T	A	2	2	4	0	0	4	0	0
8	13161999	.	A	G	7	7	14	0	1	15	0	0
8	13162008	.	T	C	6	7	13	0	0	13	0	0
8	13192061	.	T	C	7	7	14	0	0	14	0	0
8	13194912	.	C	T	1	8	9	0	11	20	0	0
8	13207577	.	G	A	6	2	8	0	0	8	0	0
8	13211273	.	C	T	7	6	13	0	0	13	0	0
8	13244683	.	T	C	2	8	10	0	0	10	0	0
8	13286530	.	A	G	1	5	6	0	1	7	0	0
8	13352100	.	C	A	3	22	25	0	11	36	0	0
8	13352103	.	T	A	14	22	36	0	0	36	0	0
8	13352166	.	T	C	17	18	35	0	0	35	0	0
8	13352318	.	G	A	17	17	34	0	0	34	0	0
8	13352428	.	A	G	18	29	47	0	2	49	0	0
8	13355949	.	C	T	20	20	40	0	3	43	0	0
8	13362699	.	T	C	24	24	48	0	1	49	0	0
8	13364868	.	T	C	7	6	13	0	1	14	0	0
8	13382316	.	C	A	1	3	4	0	0	4	0	0
8	13630504	.	T	C	2	2	4	0	0	4	0	0
8	13643800	.	G	A	1	3	4	0	0	4	0	0
8	13643862	.	G	C	1	5	6	0	0	6	0	0
8	13643998	.	A	T	1	2	3	0	0	3	0	0
8	13644084	.	G	A	1	6	7	0	0	7	0	0
8	13647654	.	A	G	1	2	3	0	0	3	0	0
8	13779556	.	C	T	8	10	18	0	1	19	0	0
8	13779604	.	T	C	6	14	20	0	2	22	0	0
8	13782862	.	C	G	15	11	26	0	0	26	0	0
8	13782902	.	C	A	17	10	27	0	0	27	0	0
8	13784177	.	A	G	18	9	27	0	0	27	0	0
8	13784180	.	G	A	16	8	24	0	4	28	0	0
8	13784219	.	C	T	16	17	33	0	3	36	0	0
8	13784231	.	A	G	22	15	37	0	4	41	0	0
8	13784288	.	A	T	27	12	39	0	2	41	0	0
8	13786944	.	G	C	16	15	31	0	0	31	0	0
8	13787093	.	G	A	1	6	7	0	11	18	0	0
8	13787132	.	G	A	12	8	20	0	1	21	0	0
8	13787150	.	A	T	11	7	18	0	1	19	0	0
8	13787345	.	G	A	7	4	11	1	1	13	0	0
8	13787528	.	G	A	7	10	17	0	0	17	0	0
8	13852774	.	C	T	21	22	43	0	0	43	0	0
8	13852795	.	T	C	20	22	42	0	4	46	0	0
8	13852864	.	T	C	21	19	40	0	2	42	0	0
8	13852930	.	G	A	19	14	33	0	4	37	0	0
8	13853026	.	C	T	12	14	26	0	3	29	0	0
8	13910234	.	C	A	14	14	28	1	0	29	0	0
8	13944193	.	T	C	19	19	38	1	0	40	1	0
8	13991378	.	A	G	2	2	4	0	0	4	0	0
8	13991828	.	G	A	4	4	8	0	0	8	0	0
8	13991875	.	C	A	3	2	5	0	2	7	0	0
8	13993704	.	A	G	5	3	8	0	0	8	0	0
8	13998316	.	A	G	5	9	14	0	0	14	0	0
8	13998361	.	A	C	4	0	4	0	7	11	0	0
8	13998483	.	A	C	5	2	7	0	0	7	0	0
8	13998502	.	C	A	6	2	8	0	0	8	0	0
8	13998549	.	G	A	5	2	7	0	0	7	0	0
8	14003374	.	G	A	25	24	49	0	2	51	0	0
8	14012346	.	C	T	2	25	27	0	23	50	0	0
8	14018790	.	C	T	26	28	54	0	2	56	0	0
8	14020571	.	A	G	21	28	49	0	3	52	0	0
8	14027241	.	A	C	21	17	38	0	0	38	0	0
8	14041319	.	A	G	21	21	42	0	5	47	0	0
8	14043810	.	A	G	20	27	47	0	2	49	0	0
8	14049333	.	A	C	15	13	28	0	3	31	0	0
8	14049447	.	G	A	21	23	44	0	2	46	0	0
8	14049462	.	A	G	25	20	45	0	2	47	0	0
8	14049641	.	G	A	26	21	47	0	2	49	0	0
8	14049702	.	T	C	29	22	51	0	2	53	0	0
8	14059902	.	C	A	1	3	4	0	0	4	0	0
8	14061174	.	C	T	1	2	3	0	0	3	0	0
8	14061992	.	G	A	0	1	1	0	2	3	0	0
8	14062237	.	T	A	3	4	7	0	0	7	0	0
8	14063418	.	T	A	14	9	23	0	0	23	0	0
8	14064253	.	T	A	6	2	8	0	0	8	0	0
8	14064374	.	G	A	5	5	10	0	1	11	0	0
8	14064441	.	C	A	2	8	10	0	0	10	0	0
8	14065313	.	G	A	15	15	30	0	0	30	0	0
8	14070490	.	T	C	14	16	30	0	2	32	0	0
8	14075809	.	C	T	13	15	28	0	1	29	0	0
8	14076247	.	G	A	6	10	16	0	0	16	0	0
8	14076340	.	T	G	7	15	22	0	0	22	0	0
8	14130264	.	G	A	4	3	7	0	0	7	0	0
8	14130435	.	T	C	8	1	9	0	6	15	0	0
8	14141184	.	C	T	1	2	3	1	0	4	0	0
8	14144196	.	C	A	1	2	3	0	0	3	0	0
8	14148775	.	T	G	2	2	4	0	0	4	0	0
8	14163845	.	A	G	7	11	18	0	1	19	0	0
8	14170428	.	C	A	3	7	10	0	2	12	0	0
8	14170546	.	A	T	1	2	3	0	1	4	0	0
8	14170712	.	C	T	14	12	26	0	5	31	0	0
8	14170789	.	A	T	19	11	30	2	0	32	0	0
8	14171076	.	A	T	23	27	50	1	1	52	0	0
8	14171346	.	T	C	16	28	44	0	2	46	0	0
8	14171414	.	G	A	18	14	32	0	2	34	0	0
8	14171660	.	T	C	25	26	51	0	2	53	0	0
8	14171825	.	C	T	4	12	16	0	22	38	0	0
8	14171875	.	G	T	25	20	45	0	1	46	0	0
8	14171955	.	T	C	27	15	42	0	1	43	0	0
8	14172113	.	A	T	17	25	42	0	2	44	0	0
8	14174231	.	G	A	33	25	58	0	1	59	0	0
8	14176574	.	T	C	21	25	46	0	1	47	0	0
8	14176592	.	A	G	22	27	49	0	1	50	0	0
8	14184198	.	C	T	2	8	10	0	32	42	0	0
8	14184246	.	A	G	19	22	41	0	1	42	0	0
8	14211960	.	A	G	2	2	4	0	0	4	0	0
8	14212264	.	T	G	7	4	11	0	1	12	0	0
8	14212384	.	T	C	4	0	4	0	8	12	0	0
8	14212545	.	T	C	9	0	9	0	12	21	0	0
8	14212676	.	A	G	10	6	16	0	1	17	0	0
8	14213303	.	T	C	3	7	10	0	1	11	0	0
8	14217986	.	T	C	6	7	13	0	1	14	0	0
8	14225269	.	G	A	7	10	17	0	0	17	0	0
8	14228320	.	G	A	1	4	5	0	0	5	0	0
8	14229557	.	A	G	2	4	6	0	2	8	0	0
8	14244494	.	A	G	20	25	45	0	1	46	0	0
8	14246405	.	G	A	21	24	45	0	1	46	0	0
8	14246411	.	A	G	20	22	42	0	2	44	0	0
8	14247431	.	A	G	14	13	27	0	0	27	0	0
8	14250036	.	C	T	12	21	33	0	0	33	0	0
8	14272806	.	A	G	21	16	37	0	0	37	0	0
8	14275609	.	G	A	5	10	15	0	2	17	0	0
8	14278444	.	G	A	16	9	25	0	2	27	0	0
8	14375543	.	A	T	11	10	21	0	0	21	0	0
8	14375718	.	T	A	12	9	21	0	1	22	0	0
8	14375742	.	C	A	10	11	21	0	0	21	0	0
8	14375841	.	T	C	14	8	22	0	1	23	0	0
8	14375873	.	T	C	3	4	7	0	0	7	0	0
8	14384377	.	A	G	11	10	21	0	0	21	0	0
8	14388428	.	A	G	7	5	12	0	1	13	0	0
8	14388482	.	G	A	6	6	12	0	1	13	0	0
8	14439556	.	T	G	7	10	17	0	1	18	0	0
8	14440277	.	A	G	3	14	17	0	1	18	0	0
8	14440278	.	A	C	2	14	16	0	1	18	1	0
8	14440447	.	A	C	11	6	17	0	0	17	0	0
8	14440564	.	A	G	5	4	9	0	0	9	0	0
8	14440580	.	C	A	4	6	10	0	0	10	0	0
8	14440754	.	C	A	2	5	7	0	0	7	0	0
8	14441344	.	C	T	9	5	14	0	0	14	0	0
8	14441416	.	C	A	7	10	17	0	1	18	0	0
8	14441524	.	A	G	6	15	21	0	0	21	0	0
8	14441656	.	A	C	7	11	18	0	0	18	0	0
8	14441657	.	C	A	6	11	17	0	0	17	0	0
8	14454383	.	T	C	4	2	6	0	0	6	0	0
8	14559476	.	A	G	3	2	5	0	0	5	0	0
8	14559709	.	T	A	6	7	13	0	0	13	0	0
8	14560242	.	A	C	6	3	9	0	1	10	0	0
8	14560252	.	A	G	9	4	13	0	0	13	0	0
8	14560612	.	G	A	3	6	9	0	0	9	0	0
8	14560888	.	A	T	2	3	5	0	0	5	0	0
8	14561114	.	G	T	8	2	10	0	0	10	0	0
8	14564126	.	C	T	0	5	5	0	5	10	0	0
8	14564717	.	T	A	4	6	10	0	0	10	0	0
8	14564813	.	G	T	6	2	8	0	0	8	0	0
8	14565180	.	T	C	3	6	9	0	0	9	0	0
8	14565303	.	T	A	6	5	11	0	0	11	0	0
8	14565350	.	G	A	7	6	13	0	0	13	0	0
8	14565376	.	T	C	7	10	17	0	0	17	0	0
8	14565457	.	T	C	3	5	8	0	1	9	0	0
8	14565843	.	C	T	0	1	1	0	1	2	0	0
8	14565850	.	A	G	1	2	3	0	0	3	0	0
8	14566295	.	G	T	3	2	5	0	0	5	0	0
8	14566360	.	C	A	3	3	6	0	0	6	0	0
8	14566380	.	A	C	3	0	3	0	4	7	0	0
8	14568457	.	T	C	5	0	5	0	6	11	0	0
8	14568760	.	G	A	2	4	6	0	0	6	0	0
8	14571008	.	C	T	6	3	9	0	0	9	0	0
8	14571053	.	A	G	4	4	8	0	0	8	0	0
8	14578369	.	A	G	4	3	7	0	0	7	0	0
8	14578765	.	G	A	4	3	7	0	0	7	0	0
8	14580484	.	A	G	1	3	4	0	0	4	0	0
8	14581114	.	A	G	8	2	10	0	0	10	0	0
8	14581138	.	A	T	5	4	9	0	0	9	0	0
8	14581171	.	C	A	0	5	5	0	7	12	0	0
8	14581650	.	T	C	3	3	6	0	1	7	0	0
8	14591731	.	A	G	4	3	7	0	0	7	0	0
8	14591771	.	C	T	0	2	2	0	2	4	0	0
8	14591985	.	T	A	1	2	3	0	0	3	0	0
8	14601733	.	A	G	1	3	4	0	0	4	0	0
8	14782073	.	C	T	3	4	7	0	0	7	0	0
8	14790282	.	T	C	5	11	16	0	0	16	0	0
8	14790559	.	A	G	2	4	6	0	2	8	0	0
8	14790733	.	C	T	10	7	17	0	0	17	0	0
8	14792860	.	A	G	3	15	18	0	0	18	0	0
8	14796863	.	C	A	7	5	12	0	1	13	0	0
8	14801544	.	G	A	5	2	7	0	1	8	0	0
8	14802951	.	T	C	6	7	13	0	0	13	0	0
8	14805109	.	C	T	3	5	8	0	0	8	0	0
8	14810160	.	A	G	4	6	10	0	0	10	0	0
8	14810527	.	A	G	8	6	14	0	1	15	0	0
8	14915387	.	A	C	3	4	7	0	0	7	0	0
8	14915478	.	T	C	1	2	3	0	1	4	0	0
8	14961331	.	T	C	5	3	8	0	0	8	0	0
8	14972782	.	T	A	5	4	9	0	0	9	0	0
8	14978906	.	T	C	6	8	14	1	0	15	0	0
8	14979893	.	A	C	8	10	18	0	0	18	0	0
8	14981059	.	A	T	6	7	13	0	0	13	0	0
8	14981124	.	A	T	4	5	9	0	1	10	0	0
8	14981189	.	T	A	2	6	8	0	0	8	0	0
8	14981235	.	C	T	6	4	10	0	0	10	0	0
8	14981991	.	C	T	3	4	7	0	0	7	0	0
8	14982022	.	A	G	6	8	14	0	0	14	0	0
8	14982477	.	A	C	5	5	10	0	0	10	0	0
8	14983176	.	A	G	5	5	10	0	1	11	0	0
8	14983191	.	A	G	2	4	6	0	0	6	0	0
8	14983211	.	A	G	1	3	4	0	0	4	0	0
8	14983309	.	T	C	2	1	3	0	2	5	0	0
8	14983320	.	A	G	3	2	5	0	0	5	0	0
8	14983866	.	C	T	11	6	17	0	2	19	0	0
8	15056624	.	C	G	10	10	20	0	1	21	0	0
8	15072236	.	A	C	7	6	13	0	0	13	0	0
8	15080551	.	G	A	11	12	23	0	0	23	0	0
8	15080566	.	A	G	9	11	20	0	0	20	0	0
8	15084458	.	G	A	3	6	9	0	0	9	0	0
8	15088972	.	T	C	7	0	7	0	4	11	0	0
8	15088981	.	T	C	5	0	5	0	6	11	0	0
8	15090910	.	A	G	4	2	6	0	0	6	0	0
8	15091708	.	C	T	9	9	18	0	0	18	0	0
8	15091727	.	T	A	8	9	17	0	0	17	0	0
8	15094241	.	T	C	7	6	13	0	1	14	0	0
8	15094262	.	C	T	8	4	12	0	1	13	0	0
8	15094525	.	A	G	9	6	15	0	0	15	0	0
8	15094588	.	G	C	5	4	9	0	0	9	0	0
8	15094599	.	C	A	3	5	8	0	3	11	0	0
8	15094803	.	C	G	0	11	11	0	7	18	0	0
8	15094809	.	G	A	7	11	18	0	1	19	0	0
8	15100461	.	A	G	6	2	8	0	0	8	0	0
8	15100653	.	T	C	6	0	6	0	11	17	0	0
8	15100731	.	A	G	8	7	15	0	0	15	0	0
8	15129356	.	G	A	4	3	7	0	0	7	0	0
8	15129362	.	T	C	4	3	7	0	0	7	0	0
8	15150031	.	G	A	1	2	3	0	1	4	0	0
8	15244781	.	C	G	1	2	3	0	0	3	0	0
8	15248558	.	T	G	2	0	2	0	2	4	0	0
8	15248561	.	T	C	2	2	4	0	0	4	0	0
8	15249886	.	A	T	3	3	6	0	0	6	0	0
8	15252141	.	A	G	21	9	30	0	0	30	0	0
8	15252250	.	C	G	14	14	28	0	1	29	0	0
8	15252306	.	G	A	9	11	20	0	1	21	0	0
8	15253365	.	C	A	10	9	19	0	2	21	0	0
8	15253384	.	T	C	12	7	19	0	2	21	0	0
8	15253496	.	G	A	10	6	16	0	1	17	0	0
8	15272931	.	C	T	5	5	10	0	0	10	0	0
8	15275665	.	T	C	10	9	19	0	0	19	0	0
8	15275704	.	G	A	13	11	24	0	0	24	0	0
8	15276587	.	T	A	9	15	24	0	1	25	0	0
8	15276588	.	C	G	8	15	23	0	1	24	0	0
8	15276678	.	G	A	4	8	12	0	0	12	0	0
8	15276684	.	G	A	2	6	8	0	3	11	0	0
8	15276944	.	T	G	7	8	15	0	0	15	0	0
8	15277957	.	T	C	3	7	10	0	0	10	0	0
8	15277965	.	T	C	3	7	10	0	0	10	0	0
8	15281446	.	A	T	4	4	8	0	0	8	0	0
8	15289348	.	G	T	1	3	4	0	0	4	0	0
8	15312985	.	A	G	10	7	17	0	0	17	0	0
8	15506831	.	G	A	2	2	4	0	0	4	0	0
8	15951146	.	C	T	2	3	5	0	7	12	0	0
8	15951185	.	A	G	6	3	9	0	1	10	0	0
8	16054374	.	C	T	23	24	47	0	3	50	0	0
8	16054389	.	T	C	21	26	47	0	4	51	0	0
8	16112107	.	G	A	1	26	27	0	30	57	0	0
8	16112212	.	C	T	35	22	57	0	6	63	0	0
8	16113850	.	C	A	20	20	40	0	3	43	0	0
8	16115682	.	C	T	14	10	24	1	8	36	3	0
8	16257435	.	C	T	3	5	8	0	0	8	0	0
8	16257444	.	G	T	5	3	8	0	0	8	0	0
8	16275011	.	G	C	2	3	5	1	4	10	0	0
8	16294511	.	G	A	12	9	21	0	0	21	0	0
8	16406283	.	C	A	5	3	8	0	0	8	0	0
8	16408914	.	T	A	3	3	6	0	0	6	0	0
8	16425038	.	C	T	15	10	25	0	0	25	0	0
8	16425079	.	C	T	1	13	14	0	12	26	0	0
8	16425383	.	T	C	13	10	23	0	0	23	0	0
8	16439114	.	G	T	10	6	16	0	0	16	0	0
8	16464296	.	T	A	5	5	10	0	1	11	0	0
8	16464306	.	T	G	6	4	10	0	1	11	0	0
8	16470556	.	G	A	3	4	7	0	0	7	0	0
8	16517553	.	G	A	6	4	10	0	1	11	0	0
8	16517558	.	T	C	6	4	10	0	1	11	0	0
8	16517649	.	C	T	0	2	2	0	1	3	0	0
8	16519102	.	T	G	10	14	24	0	0	24	0	0
8	16519560	.	A	G	4	10	14	0	0	14	0	0
8	16519692	.	G	A	7	6	13	0	0	13	0	0
8	16519695	.	G	C	7	4	11	0	0	11	0	0
8	16519782	.	C	T	9	10	19	0	0	19	0	0
8	16524401	.	G	C	11	0	11	0	9	20	0	0
8	16525234	.	G	T	5	6	11	0	1	12	0	0
8	16525250	.	G	T	7	5	12	0	1	13	0	0
8	16525366	.	T	A	5	5	10	0	0	10	0	0
8	16525417	.	A	G	3	6	9	0	0	9	0	0
8	16525504	.	T	A	8	4	12	0	0	12	0	0
8	16525519	.	A	G	8	4	12	0	1	13	0	0
8	16528223	.	A	G	3	4	7	0	1	8	0	0
8	16528390	.	T	G	2	4	6	0	3	9	0	0
8	16528454	.	C	T	0	6	6	0	5	11	0	0
8	16528475	.	C	T	0	7	7	0	3	10	0	0
8	16531802	.	C	T	7	5	12	0	1	13	0	0
8	16582470	.	T	A	20	11	31	0	1	32	0	0
8	16582608	.	G	A	21	14	35	0	0	35	0	0
8	16582762	.	A	G	5	18	23	1	0	24	0	0
8	16583043	.	G	A	11	5	16	11	0	27	0	0
8	16583127	.	C	T	4	23	27	8	2	37	0	0
8	16583142	.	A	C	25	7	32	4	1	37	0	0
8	16583174	.	C	A	24	11	35	0	1	36	0	0
8	16583447	.	C	T	23	16	39	0	3	42	0	0
8	16583528	.	C	T	26	9	35	3	2	44	4	0
8	16583534	.	G	A	21	9	30	3	1	43	9	0
8	16583591	.	C	T	20	18	38	3	1	42	0	0
8	16583851	.	C	T	2	5	7	22	0	29	0	0
8	16587510	.	T	A	18	25	43	0	5	48	0	0
8	16588157	.	A	G	12	14	26	0	0	26	0	0
8	16588421	.	C	T	20	14	34	0	1	35	0	0
8	16592465	.	G	C	19	20	39	0	0	39	0	0
8	16597215	.	C	T	4	8	12	0	0	12	0	0
8	16597238	.	G	A	10	9	19	0	0	19	0	0
8	16597252	.	G	A	9	7	16	0	1	17	0	0
8	16597632	.	C	T	5	2	7	0	0	7	0	0
8	16597649	.	G	T	5	2	7	0	0	7	0	0
8	16597889	.	G	A	6	7	13	0	0	13	0	0
8	16598148	.	C	T	1	9	10	0	6	16	0	0
8	16600671	.	T	C	5	3	8	0	0	8	0	0
8	16602571	.	G	A	9	3	12	0	0	12	0	0
8	16605597	.	A	G	8	4	12	0	1	13	0	0
8	16605615	.	G	A	4	6	10	0	1	11	0	0
8	16608287	.	G	A	5	3	8	0	0	8	0	0
8	16608875	.	G	A	4	4	8	0	1	9	0	0
8	16608898	.	C	T	1	2	3	0	5	8	0	0
8	16608988	.	A	T	5	2	7	0	0	7	0	0
8	16610387	.	G	A	14	4	18	0	0	18	0	0
8	16611005	.	A	C	2	20	22	0	0	22	0	0
8	16615802	.	T	C	7	6	13	0	0	13	0	0
8	16615866	.	T	C	7	8	15	0	0	15	0	0
8	16615867	.	A	G	8	7	15	0	0	15	0	0
8	16615929	.	A	T	16	7	23	0	2	25	0	0
8	16616190	.	C	A	10	12	22	0	0	22	0	0
8	16616899	.	G	A	8	16	24	0	1	25	0	0
8	16625575	.	C	A	14	12	26	0	0	26	0	0
8	16632794	.	G	A	7	7	14	0	3	17	0	0
8	16653843	.	A	G	4	6	10	0	1	11	0	0
8	16680296	.	T	C	1	3	4	0	0	4	0	0
8	16680399	.	C	T	1	2	3	0	0	3	0	0
8	16680424	.	C	A	0	2	2	0	0	3	1	0
8	16682943	.	G	A	2	2	4	0	0	4	0	0
8	16685439	.	C	T	4	5	9	0	0	9	0	0
8	16702218	.	T	C	6	0	6	0	4	10	0	0
8	16702267	.	C	T	4	5	9	0	0	9	0	0
8	16702396	.	A	T	3	3	6	0	0	6	0	0
8	16702423	.	T	C	2	2	4	0	0	4	0	0
8	16702658	.	G	A	4	2	6	0	0	6	0	0
8	16703900	.	T	C	3	2	5	0	0	5	0	0
8	16704305	.	T	C	2	2	4	0	0	4	0	0
8	16706195	.	G	A	2	2	4	0	0	4	0	0
8	16729938	.	A	G	17	13	30	0	1	31	0	0
8	16729941	.	G	A	17	14	31	0	0	31	0	0
8	16734037	.	A	T	8	4	12	0	0	12	0	0
8	16734074	.	C	G	3	8	11	0	0	11	0	0
8	16734247	.	C	A	11	9	20	0	1	22	1	0
8	16736489	.	A	T	13	15	28	0	0	28	0	0
8	16738054	.	G	A	14	14	28	0	1	29	0	0
8	16738149	.	G	T	14	9	23	0	0	23	0	0
8	16740792	.	A	G	6	6	12	0	0	12	0	0
8	16740977	.	C	T	2	3	5	0	0	5	0	0
8	16748538	.	T	C	7	6	13	0	0	13	0	0
8	16755381	.	G	A	12	10	22	0	0	22	0	0
8	16756847	.	G	C	4	4	8	0	0	8	0	0
8	16768992	.	A	G	11	0	11	0	6	17	0	0
8	16769126	.	C	T	8	9	17	0	0	17	0	0
8	16769641	.	G	A	1	3	4	0	0	4	0	0
8	17039140	.	G	A	2	3	5	0	0	5	0	0
8	17044255	.	G	A	0	4	4	0	4	8	0	0
8	17055751	.	C	T	16	20	36	0	17	53	0	0
8	17055802	.	C	T	3	26	29	0	28	57	0	0
8	17067268	.	A	T	22	18	40	0	1	41	0	0
8	17079902	.	C	T	10	14	24	0	0	24	0	0
8	17081758	.	C	T	20	13	33	1	2	36	0	0
8	17081782	.	C	T	21	16	37	1	2	40	0	0
8	17081863	.	G	A	22	15	37	0	0	37	0	0
8	17081976	.	C	T	13	22	35	0	1	36	0	0
8	17082927	.	G	A	1	10	11	0	15	26	0	0
8	17084733	.	C	G	22	20	42	0	1	43	0	0
8	17086002	.	C	T	12	14	26	0	0	26	0	0
8	17086043	.	C	T	7	4	11	0	2	13	0	0
8	17145317	.	A	G	4	3	7	0	0	7	0	0
8	17145332	.	A	G	5	5	10	0	0	10	0	0
8	17146887	.	T	C	10	8	18	0	1	19	0	0
8	17149312	.	G	A	4	3	7	0	0	7	0	0
8	17151997	.	A	G	10	4	14	0	3	17	0	0
8	17152057	.	C	A	7	3	10	0	0	10	0	0
8	17154080	.	A	C	7	5	12	0	0	12	0	0
8	17154110	.	C	T	10	4	14	0	0	14	0	0
8	17154406	.	T	C	5	7	12	0	0	12	0	0
8	17163611	.	A	G	7	10	17	0	1	18	0	0
8	17164208	.	G	A	21	16	37	0	0	37	0	0
8	17164302	.	A	G	25	23	48	0	1	49	0	0
8	17166577	.	C	T	11	14	25	0	1	26	0	0
8	17175037	.	T	C	3	1	4	0	1	5	0	0
8	17175215	.	C	A	3	4	7	0	0	7	0	0
8	17178794	.	A	G	1	2	3	0	0	3	0	0
8	17186987	.	C	T	4	4	8	0	0	8	0	0
8	17190128	.	C	T	3	2	5	0	0	5	0	0
8	17191921	.	A	G	2	5	7	0	0	7	0	0
8	17192129	.	A	G	2	2	4	0	0	4	0	0
8	17396056	.	G	T	8	12	20	0	4	24	0	0
8	17396186	.	T	G	24	19	43	0	0	43	0	0
8	17396303	.	G	A	20	18	38	0	0	38	0	0
8	17396447	.	A	C	7	6	13	0	0	13	0	0
8	17396566	.	T	C	5	5	10	0	0	10	0	0
8	17396567	.	C	T	0	5	5	0	5	10	0	0
8	17396814	.	T	A	14	4	18	0	1	19	0	0
8	17396815	.	T	A	14	6	20	0	0	20	0	0
8	17397995	.	A	T	15	9	24	0	0	24	0	0
8	17398113	.	C	T	2	9	11	0	4	15	0	0
8	17398229	.	A	T	3	12	15	0	0	15	0	0
8	17398712	.	G	A	13	8	21	0	0	21	0	0
8	17398775	.	G	A	17	9	26	0	1	27	0	0
8	17399586	.	T	A	18	19	37	0	0	37	0	0
8	17404605	.	C	A	3	12	15	0	5	20	0	0
8	17515848	.	G	A	12	4	16	0	1	17	0	0
8	17516304	.	C	T	0	9	9	0	9	18	0	0
8	17516363	.	G	A	6	2	8	0	0	8	0	0
8	17534858	.	G	T	3	5	8	0	1	9	0	0
8	17534887	.	C	T	4	4	8	0	1	9	0	0
8	17534908	.	T	G	5	0	5	0	3	8	0	0
8	17583923	.	T	G	10	20	30	0	0	30	0	0
8	17609003	.	C	T	10	11	21	0	1	22	0	0
8	17781076	.	G	A	0	6	6	0	12	18	0	0
8	17781096	.	C	A	10	6	16	0	0	16	0	0
8	17781416	.	A	T	5	2	7	0	0	7	0	0
8	17781468	.	C	G	4	10	14	0	0	14	0	0
8	17781537	.	T	C	7	6	13	0	1	14	0	0
8	17781555	.	C	T	5	8	13	0	1	14	0	0
8	17781576	.	T	C	5	3	8	0	1	10	1	0
8	17783674	.	A	G	2	2	4	0	0	4	0	0
8	17783703	.	G	T	4	3	7	0	0	7	0	0
8	17783735	.	G	A	8	7	15	0	0	15	0	0
8	17783775	.	C	T	9	13	22	0	0	22	0	0
8	17784308	.	A	G	6	8	14	1	0	15	0	0
8	17784426	.	T	G	3	6	9	0	2	11	0	0
8	17787833	.	A	T	5	5	10	0	0	10	0	0
8	17788008	.	T	G	2	3	5	0	0	5	0	0
8	17788049	.	C	T	0	6	6	0	1	7	0	0
8	17800823	.	A	T	2	3	5	0	0	5	0	0
8	17800833	.	A	G	2	2	4	0	0	4	0	0
8	17801060	.	C	T	4	3	7	0	0	7	0	0
8	17801078	.	T	A	0	3	3	0	0	3	0	0
8	17808331	.	A	G	4	2	6	0	0	6	0	0
8	17822149	.	C	G	6	3	9	0	1	10	0	0
8	17904618	.	A	G	3	4	7	0	0	7	0	0
8	17906181	.	C	A	4	5	9	0	0	9	0	0
8	17911215	.	C	T	2	4	6	0	0	6	0	0
8	17917200	.	C	T	1	2	3	0	0	3	0	0
8	17937069	.	A	G	0	2	2	0	1	3	0	0
8	17937075	.	G	C	1	2	3	0	0	3	0	0
8	17983772	.	C	A	5	2	7	0	0	7	0	0
8	17983773	.	C	A	4	2	6	0	1	7	0	0
8	17984761	.	A	G	2	4	6	0	0	6	0	0
8	17984922	.	G	A	2	2	4	0	0	4	0	0
8	17987497	.	C	A	1	4	5	0	0	5	0	0
8	17994298	.	C	T	0	4	4	0	2	6	0	0
8	18033113	.	T	C	13	10	23	0	0	23	0	0
8	18035129	.	A	T	20	16	36	0	1	37	0	0
8	18035231	.	T	A	16	12	28	0	2	30	0	0
8	18035290	.	T	C	10	10	20	0	2	22	0	0
8	18035303	.	T	A	13	13	26	0	0	26	0	0
8	18035371	.	T	C	21	10	31	1	1	33	0	0
8	18035428	.	G	A	22	14	36	0	1	37	0	0
8	18035946	.	T	A	11	13	24	0	1	25	0	0
8	18035963	.	T	C	12	14	26	0	0	26	0	0
8	18036592	.	G	A	7	4	11	0	0	11	0	0
8	18036610	.	C	T	4	2	6	0	1	7	0	0
8	18039741	.	A	G	5	2	7	0	1	8	0	0
8	18040011	.	T	A	1	3	4	0	1	5	0	0
8	18041793	.	C	T	8	2	10	0	0	10	0	0
8	18196462	.	A	G	25	21	46	0	3	49	0	0
8	18204369	.	T	C	1	2	3	0	0	3	0	0
8	18204443	.	T	C	1	2	3	0	0	3	0	0
8	18206394	.	A	G	1	5	6	0	0	6	0	0
8	18207056	.	T	G	8	5	13	0	0	13	0	0
8	18207202	.	T	A	1	3	4	0	0	4	0	0
8	18207245	.	C	A	2	4	6	0	0	6	0	0
8	18207465	.	C	T	5	4	9	0	0	9	0	0
8	18242977	.	C	A	5	2	7	0	0	7	0	0
8	18242978	.	A	C	5	2	7	0	0	7	0	0
8	18243633	.	C	T	3	2	5	0	0	5	0	0
8	18244003	.	G	A	2	3	5	0	0	5	0	0
8	18244007	.	T	A	1	3	4	0	0	4	0	0
8	18256255	.	A	G	1	3	4	0	0	4	0	0
8	18256270	.	G	A	1	2	3	0	0	3	0	0
8	18262136	.	T	C	3	2	5	0	0	5	0	0
8	18262262	.	A	G	1	2	3	0	0	3	0	0
8	18358694	.	T	G	4	3	7	0	1	8	0	0
8	18364066	.	G	A	12	4	16	0	0	16	0	0
8	18365134	.	G	A	3	7	10	0	0	10	0	0
8	18365788	.	C	T	3	5	8	0	0	8	0	0
8	18506177	.	G	T	1	2	3	0	0	3	0	0
8	18506178	.	A	T	1	2	3	0	0	3	0	0
8	18509756	.	A	G	4	6	10	0	0	10	0	0
8	18510560	.	A	G	2	4	6	0	0	6	0	0
8	18512195	.	G	A	3	3	6	0	0	6	0	0
8	18514407	.	C	T	1	3	4	0	0	4	0	0
8	18514466	.	C	T	5	3	8	0	0	8	0	0
8	18514476	.	A	G	5	4	9	0	0	9	0	0
8	18514518	.	C	A	0	4	4	0	4	8	0	0
8	18514568	.	A	G	2	4	6	0	0	6	0	0
8	18514571	.	C	G	2	3	5	0	0	5	0	0
8	18514855	.	A	T	5	4	9	0	0	9	0	0
8	18515092	.	G	T	2	6	8	0	0	8	0	0
8	18515137	.	G	A	4	3	7	0	0	7	0	0
8	18515138	.	G	A	4	3	7	0	0	7	0	0
8	18517772	.	A	G	1	2	3	0	0	3	0	0
8	18517971	.	A	G	1	2	3	0	0	3	0	0
8	18518714	.	C	T	1	3	4	0	0	4	0	0
8	18519593	.	T	C	3	4	7	0	1	8	0	0
8	18519633	.	A	C	4	7	11	0	1	12	0	0
8	18519687	.	C	A	4	4	8	0	0	8	0	0
8	18550469	.	T	A	11	6	17	0	0	17	0	0
8	18554651	.	T	C	8	8	16	0	0	16	0	0
8	18554720	.	G	T	9	8	17	0	1	18	0	0
8	18554731	.	T	A	9	9	18	0	0	18	0	0
8	18554825	.	T	C	11	10	21	0	0	21	0	0
8	18554826	.	G	A	11	9	20	0	1	21	0	0
8	18555104	.	A	G	12	0	12	0	11	23	0	0
8	18562153	.	A	G	23	9	32	0	1	33	0	0
8	18562283	.	G	A	2	9	11	0	16	27	0	0
8	18562317	.	C	T	16	5	21	0	1	22	0	0
8	18562570	.	C	T	12	5	17	0	1	18	0	0
8	18562576	.	G	A	12	4	16	0	1	17	0	0
8	18566970	.	C	A	15	10	25	0	1	26	0	0
8	18567020	.	G	A	16	15	31	0	1	32	0	0
8	18567260	.	A	G	16	11	27	1	4	32	0	0
8	18567342	.	G	A	18	10	28	0	2	30	0	0
8	18567577	.	G	T	27	11	38	0	0	38	0	0
8	18568022	.	G	C	13	8	21	0	0	21	0	0
8	18568121	.	C	T	16	11	27	0	1	28	0	0
8	18568167	.	G	T	14	9	23	0	0	23	0	0
8	18568189	.	C	A	15	9	24	0	1	25	0	0
8	18568264	.	T	A	11	7	18	0	0	18	0	0
8	18568350	.	C	G	7	8	15	0	0	15	0	0
8	18568468	.	A	T	8	7	15	1	0	16	0	0
8	18568473	.	T	G	8	6	14	1	2	17	0	0
8	18568527	.	C	T	8	12	20	0	2	22	0	0
8	18568571	.	T	G	13	12	25	0	0	25	0	0
8	18568677	.	C	T	2	11	13	0	21	34	0	0
8	18568687	.	A	G	20	12	32	0	1	33	0	0
8	18568739	.	T	A	15	13	28	0	0	28	0	0
8	18568740	.	C	A	1	13	14	0	14	28	0	0
8	18568800	.	A	G	12	5	17	1	1	19	0	0
8	18569126	.	T	C	16	3	19	0	0	19	0	0
8	18569129	.	A	G	17	3	20	0	0	20	0	0
8	18569189	.	T	C	6	5	11	0	5	16	0	0
8	18569605	.	A	T	12	5	17	0	1	18	0	0
8	18569763	.	C	G	2	9	11	0	5	16	0	0
8	18569767	.	A	T	7	8	15	0	0	15	0	0
8	18569856	.	T	C	10	5	15	0	2	17	0	0
8	18569871	.	G	A	11	6	17	0	1	18	0	0
8	18570116	.	A	T	9	6	15	0	1	16	0	0
8	18570239	.	A	G	15	9	24	0	2	26	0	0
8	18582554	.	C	T	12	8	20	0	0	20	0	0
8	18582626	.	G	A	9	11	20	0	0	20	0	0
8	18582710	.	C	A	9	8	17	0	0	17	0	0
8	18582789	.	C	G	10	3	13	0	0	13	0	0
8	18582857	.	T	C	11	10	21	0	0	21	0	0
8	18589215	.	T	C	3	9	12	0	1	13	0	0
8	18589779	.	C	T	2	2	4	0	0	4	0	0
8	18593094	.	C	T	4	5	9	0	0	9	0	0
8	18593245	.	G	A	4	3	7	0	0	7	0	0
8	18593288	.	T	A	1	3	4	0	1	5	0	0
8	18593388	.	T	C	2	4	6	0	1	7	0	0
8	18593405	.	G	A	3	5	8	0	0	8	0	0
8	18598351	.	A	T	10	12	22	0	2	24	0	0
8	18598391	.	T	A	16	14	30	0	2	32	0	0
8	18598533	.	G	A	9	8	17	0	0	17	0	0
8	18598544	.	T	C	10	6	16	2	1	19	0	0
8	18598590	.	T	G	13	0	13	2	4	19	0	0
8	18598593	.	C	G	13	4	17	2	0	19	0	0
8	18598782	.	T	C	11	10	21	0	0	21	0	0
8	18598915	.	A	G	9	11	20	0	1	21	0	0
8	18598920	.	G	C	12	10	22	0	0	22	0	0
8	18598997	.	G	T	15	6	21	0	0	21	0	0
8	18599014	.	G	T	0	8	8	0	14	22	0	0
8	18599088	.	C	A	15	11	26	0	0	26	0	0
8	18599123	.	T	C	13	8	21	0	1	22	0	0
8	18599147	.	A	G	9	11	20	0	1	21	0	0
8	18601787	.	C	T	1	4	5	0	0	5	0	0
8	18601873	.	T	C	1	1	2	0	3	5	0	0
8	18611625	.	T	C	3	0	3	1	5	9	0	0
8	18613661	.	A	T	8	7	15	0	0	15	0	0
8	18620697	.	G	A	2	3	5	0	0	5	0	0
8	18620700	.	G	A	2	3	5	0	0	5	0	0
8	18621799	.	A	G	1	3	4	0	0	4	0	0
8	18622922	.	G	A	0	3	3	0	2	5	0	0
8	18633221	.	C	T	7	6	13	0	0	13	0	0
8	18635266	.	G	A	7	6	13	0	1	14	0	0
8	18635278	.	T	C	8	4	12	0	0	12	0	0
8	18640339	.	T	C	6	4	10	0	1	11	0	0
8	18640342	.	T	C	6	6	12	0	0	12	0	0
8	18641712	.	T	C	10	11	21	0	0	21	0	0
8	18646867	.	T	G	11	12	23	0	2	25	0	0
8	18646894	.	C	T	15	13	28	0	1	29	0	0
8	18647252	.	A	G	9	6	15	0	1	16	0	0
8	18647348	.	T	G	4	6	10	0	1	11	0	0
8	18836881	.	T	C	4	2	6	0	0	6	0	0
8	18837494	.	C	A	9	10	19	0	1	20	0	0
8	18837533	.	A	G	4	11	15	0	1	16	0	0
8	18840295	.	A	G	3	0	3	0	6	9	0	0
8	18840561	.	T	A	3	4	7	0	0	7	0	0
8	18842586	.	T	C	2	4	6	0	0	6	0	0
8	18842587	.	A	T	2	4	6	0	0	6	0	0
8	18853540	.	T	C	4	3	7	0	0	7	0	0
8	18885207	.	G	A	9	4	13	0	0	13	0	0
8	18885507	.	G	A	7	5	12	0	0	12	0	0
8	18888742	.	G	A	4	5	9	0	0	9	0	0
8	18888748	.	G	A	3	6	9	0	0	9	0	0
8	18890966	.	A	G	12	5	17	0	1	18	0	0
8	18893166	.	G	T	8	8	16	0	0	16	0	0
8	18936643	.	A	C	6	7	13	0	0	13	0	0
8	18936665	.	C	T	3	8	11	0	1	12	0	0
8	18965152	.	A	C	5	6	11	0	0	11	0	0
8	18971535	.	C	T	2	5	7	0	6	13	0	0
8	18977632	.	C	T	10	11	21	0	1	22	0	0
8	18977684	.	A	C	10	0	10	0	6	16	0	0
8	18977710	.	T	G	7	3	10	0	1	11	0	0
8	18982386	.	A	C	3	0	3	0	5	8	0	0
8	19003298	.	T	G	5	6	11	0	0	11	0	0
8	19232258	.	A	C	4	5	9	0	1	10	0	0
8	19232588	.	C	A	2	7	9	0	0	9	0	0
8	19232618	.	A	G	2	6	8	0	0	8	0	0
8	19253718	.	G	A	7	8	15	0	0	15	0	0
8	19258719	.	C	T	1	5	6	0	12	18	0	0
8	19258761	.	G	A	12	5	17	0	2	19	0	0
8	19275572	.	A	G	1	3	4	0	0	4	0	0
8	19283759	.	G	A	4	4	8	0	0	8	0	0
8	19285193	.	C	T	1	3	4	0	0	4	0	0
8	19401508	.	C	T	2	21	23	0	21	45	1	0
8	19472131	.	C	G	9	11	20	0	0	20	0	0
8	19476613	.	C	T	8	6	14	0	0	14	0	0
8	19477798	.	C	T	0	10	10	0	7	17	0	0
8	19481987	.	G	A	3	3	6	0	1	7	0	0
8	19499851	.	C	G	5	5	10	0	0	10	0	0
8	19504059	.	A	G	6	5	11	0	0	11	0	0
8	19504081	.	T	A	11	6	17	0	0	17	0	0
8	19506793	.	C	T	9	10	19	5	3	27	0	0
8	19511480	.	G	A	0	17	17	0	7	24	0	0
8	19511673	.	C	G	8	15	23	0	2	25	0	0
8	19511674	.	C	A	8	16	24	0	1	25	0	0
8	19511770	.	A	C	13	16	29	0	1	30	0	0
8	19512186	.	A	G	7	0	7	0	8	15	0	0
8	19512187	.	C	A	8	7	15	0	1	16	0	0
8	19621852	.	G	A	3	2	5	0	0	5	0	0
8	19642555	.	A	T	3	3	6	0	0	6	0	0
8	19642570	.	C	A	3	3	6	0	1	7	0	0
8	19642764	.	A	C	2	0	2	0	5	7	0	0
8	19675481	.	C	A	2	4	6	0	0	6	0	0
8	19990460	.	A	G	1	2	3	0	0	3	0	0
8	19990774	.	A	G	1	4	5	0	0	5	0	0
8	19997914	.	G	A	1	2	3	0	1	4	0	0
8	19997918	.	A	G	1	3	4	0	0	4	0	0
8	19997949	.	C	T	2	5	7	0	0	7	0	0
8	19998025	.	C	T	1	3	4	0	0	4	0	0
8	19998192	.	G	A	6	3	9	1	0	10	0	0
8	20048330	.	G	A	2	2	4	0	0	4	0	0
8	20053600	.	G	A	1	3	4	0	0	4	0	0
8	20059302	.	A	C	10	3	13	0	0	13	0	0
8	20059401	.	C	T	5	7	12	0	0	12	0	0
8	20059563	.	C	A	6	2	8	0	0	8	0	0
8	20059860	.	T	A	5	6	11	0	0	11	0	0
8	20062344	.	C	T	4	11	15	0	1	16	0	0
8	20065519	.	T	G	4	0	4	0	7	11	0	0
8	20068125	.	T	C	2	7	9	0	0	9	0	0
8	20068366	.	T	C	2	6	8	0	1	9	0	0
8	20073213	.	T	C	4	5	9	0	0	9	0	0
8	20073257	.	C	T	2	4	6	0	0	6	0	0
8	20082877	.	A	G	2	5	7	0	0	7	0	0
8	20157840	.	A	G	7	7	14	0	2	16	0	0
8	20170561	.	C	T	10	10	20	0	1	21	0	0
8	20170672	.	T	C	11	8	19	0	1	20	0	0
8	20170795	.	T	C	7	12	19	0	1	20	0	0
8	20175907	.	A	C	15	12	27	0	0	27	0	0
8	20177126	.	C	G	10	1	11	0	8	19	0	0
8	20183420	.	T	C	17	7	24	0	1	25	0	0
8	20184545	.	A	G	18	17	35	0	2	37	0	0
8	20184698	.	T	C	17	11	28	0	0	28	0	0
8	20185652	.	A	G	16	1	17	0	13	30	0	0
8	20185664	.	A	G	15	0	15	0	14	29	0	0
8	20185694	.	C	T	21	13	34	0	0	34	0	0
8	20185718	.	G	T	20	17	37	0	2	39	0	0
8	20185793	.	G	A	1	17	18	0	9	27	0	0
8	20185796	.	G	C	10	16	26	0	1	27	0	0
8	20187793	.	T	C	10	13	23	0	1	24	0	0
8	20187829	.	A	T	17	14	31	0	1	32	0	0
8	20187835	.	A	G	16	1	17	0	16	33	0	0
8	20190489	.	A	G	12	14	26	0	2	28	0	0
8	20190764	.	G	C	9	11	20	0	0	20	0	0
8	20190790	.	T	C	12	15	27	0	0	27	0	0
8	20190809	.	G	C	11	23	34	0	2	36	0	0
8	20190876	.	A	G	10	21	31	5	1	37	0	0
8	20190967	.	G	A	2	8	10	0	19	29	0	0
8	20191067	.	T	C	17	8	25	0	0	25	0	0
8	20191286	.	A	G	21	2	23	0	20	43	0	0
8	20191301	.	C	A	19	12	31	0	8	39	0	0
8	20191354	.	A	G	19	13	32	1	2	35	0	0
8	20191561	.	A	G	19	25	44	0	1	45	0	0
8	20191651	.	T	C	18	17	35	0	1	36	0	0
8	20191965	.	T	A	19	18	37	0	1	38	0	0
8	20191999	.	C	T	15	9	24	0	0	24	0	0
8	20192046	.	A	G	9	0	9	0	9	18	0	0
8	20192049	.	G	A	9	11	20	0	0	20	0	0
8	20194236	.	C	T	1	1	2	0	0	2	0	0
8	20194246	.	C	T	2	2	4	0	0	4	0	0
8	20194583	.	C	T	9	9	18	0	0	18	0	0
8	20194647	.	T	C	10	13	23	0	0	23	0	0
8	20194787	.	T	C	5	5	10	0	0	10	0	0
8	20194801	.	T	C	5	0	5	1	5	11	0	0
8	20195228	.	A	G	5	2	7	0	0	7	0	0
8	20195470	.	C	T	2	2	4	0	0	4	0	0
8	20195482	.	T	C	2	2	4	0	0	4	0	0
8	20196748	.	A	T	5	4	9	0	0	9	0	0
8	20207031	.	T	C	1	2	3	0	0	3	0	0
8	20207046	.	A	G	1	2	3	0	0	3	0	0
8	20250802	.	A	G	1	3	4	0	0	4	0	0
8	20298639	.	G	A	5	2	7	0	0	7	0	0
8	20440330	.	C	A	13	17	30	0	1	31	0	0
8	20440699	.	G	A	19	14	33	0	1	34	0	0
8	20443562	.	C	T	10	10	20	0	1	21	0	0
8	20448181	.	G	A	11	13	24	0	0	24	0	0
8	20448687	.	T	C	16	13	29	0	2	31	0	0
8	20449016	.	G	A	0	10	10	0	11	21	0	0
8	20449478	.	G	A	2	14	16	0	19	35	0	0
8	20449559	.	A	T	18	5	23	1	0	24	0	0
8	20449590	.	G	A	12	13	25	1	0	26	0	0
8	20449614	.	A	G	12	18	30	0	0	30	0	0
8	20449847	.	A	G	6	14	20	0	0	20	0	0
8	20449851	.	T	A	6	13	19	0	1	20	0	0
8	20450168	.	C	T	12	20	32	0	3	35	0	0
8	20450249	.	T	A	16	14	30	0	1	31	0	0
8	20450289	.	G	A	17	10	27	0	0	27	0	0
8	20457247	.	G	C	3	3	6	0	0	6	0	0
8	20457791	.	G	A	0	4	4	0	2	6	0	0
8	20457933	.	G	A	3	3	6	0	1	7	0	0
8	20458303	.	C	G	3	4	7	0	0	7	0	0
8	20458640	.	A	G	2	4	6	0	1	7	0	0
8	20460509	.	A	G	6	0	6	0	3	9	0	0
8	20460633	.	C	A	2	4	6	0	0	6	0	0
8	20460726	.	G	T	1	4	5	0	2	7	0	0
8	20467283	.	C	T	1	4	5	0	0	5	0	0
8	20471387	.	G	A	3	6	9	0	0	9	0	0
8	20471480	.	C	T	8	6	14	0	0	14	0	0
8	20496037	.	T	C	8	10	18	0	2	20	0	0
8	20503838	.	G	A	5	7	12	0	0	12	0	0
8	20559103	.	T	C	11	19	30	0	1	31	0	0
8	20559169	.	A	G	10	0	10	1	23	34	0	0
8	20559202	.	A	G	13	0	13	0	23	36	0	0
8	20559211	.	T	A	13	24	37	0	1	38	0	0
8	20559270	.	A	G	19	28	47	0	0	47	0	0
8	20559373	.	G	A	16	12	28	0	0	28	0	0
8	20559682	.	G	A	8	33	41	0	3	44	0	0
8	20559683	.	A	G	6	34	40	0	4	44	0	0
8	20755224	.	C	A	2	2	4	0	0	4	0	0
8	20782390	.	G	T	0	3	3	0	5	8	0	0
8	20853149	.	A	G	8	14	22	0	0	22	0	0
8	20853314	.	A	G	12	9	21	0	0	21	0	0
8	20853803	.	G	A	5	9	14	0	0	14	0	0
8	20853900	.	G	A	7	10	17	0	0	17	0	0
8	20853951	.	G	C	5	8	13	0	3	16	0	0
8	20853987	.	C	G	4	10	14	0	2	16	0	0
8	20856365	.	T	G	15	16	31	0	0	31	0	0
8	20856383	.	G	A	18	13	31	0	0	31	0	0
8	20856505	.	A	G	9	11	20	0	1	21	0	0
8	20856646	.	C	A	12	16	28	0	1	29	0	0
8	20861672	.	T	C	1	5	6	0	1	7	0	0
8	20862385	.	C	A	3	5	8	1	0	9	0	0
8	20863117	.	A	G	7	6	13	0	0	13	0	0
8	20865545	.	A	C	9	7	16	0	4	20	0	0
8	20868122	.	G	A	4	14	18	0	0	18	0	0
8	20870301	.	G	A	6	9	15	0	0	15	0	0
8	20870439	.	A	T	7	9	16	0	1	17	0	0
8	20870639	.	G	C	1	9	10	0	7	17	0	0
8	20871596	.	A	G	3	6	9	0	0	9	0	0
8	20873011	.	G	A	2	4	6	0	10	16	0	0
8	20873113	.	C	T	10	15	25	0	3	28	0	0
8	20873116	.	T	C	16	11	27	0	1	28	0	0
8	20873183	.	C	T	8	9	17	0	0	17	0	0
8	20876466	.	C	T	11	5	16	0	3	19	0	0
8	21052270	.	T	C	2	4	6	0	0	6	0	0
8	21071433	.	G	A	11	9	20	0	0	20	0	0
8	21071672	.	T	C	4	0	4	0	7	11	0	0
8	21071724	.	C	T	5	6	11	0	0	11	0	0
8	21095506	.	G	A	8	11	19	0	2	21	0	0
8	21100075	.	G	A	10	7	17	1	0	18	0	0
8	21100278	.	T	A	10	6	16	0	1	17	0	0
8	21100290	.	G	A	9	6	15	0	0	15	0	0
8	21101847	.	G	A	11	6	17	1	1	19	0	0
8	21104767	.	A	G	2	2	4	0	1	5	0	0
8	21104837	.	G	A	1	8	9	0	0	9	0	0
8	21105045	.	G	A	6	8	14	0	0	14	0	0
8	21105504	.	G	A	13	13	26	0	2	28	0	0
8	21123525	.	A	T	7	3	10	0	2	12	0	0
8	21130028	.	A	G	11	9	20	0	2	22	0	0
8	21130049	.	C	T	10	10	20	0	2	22	0	0
8	21130581	.	T	C	1	2	3	0	0	3	0	0
8	21130746	.	T	C	4	7	11	0	0	11	0	0
8	21130849	.	G	A	3	4	7	0	0	7	0	0
8	21130910	.	C	T	3	3	6	0	1	7	0	0
8	21131089	.	A	T	5	2	7	0	0	7	0	0
8	21131310	.	C	T	4	3	7	0	1	8	0	0
8	21131373	.	C	A	4	3	7	0	1	8	0	0
8	21131532	.	T	C	11	4	15	0	1	16	0	0
8	21131926	.	A	G	2	4	6	0	0	6	0	0
8	21131996	.	A	G	6	0	6	0	3	9	0	0
8	21132038	.	A	T	3	2	5	0	0	5	0	0
8	21132300	.	C	T	14	11	25	0	1	26	0	0
8	21132318	.	G	A	12	13	25	1	3	29	0	0
8	21132445	.	A	C	14	8	22	0	0	22	0	0
8	21132538	.	C	G	11	12	23	0	5	28	0	0
8	21132696	.	C	T	11	12	23	0	2	25	0	0
8	21132956	.	G	A	6	5	11	0	0	11	0	0
8	21132979	.	T	A	4	2	6	0	1	7	0	0
8	21134088	.	G	T	13	21	34	0	3	37	0	0
8	21137675	.	G	A	1	2	3	0	1	4	0	0
8	21139989	.	G	A	2	10	12	0	0	12	0	0
8	21140121	.	G	C	8	2	10	0	3	13	0	0
8	21140175	.	G	T	7	2	9	0	0	9	0	0
8	21140181	.	G	T	7	2	9	0	0	9	0	0
8	21140313	.	A	C	9	0	9	0	4	13	0	0
8	21140369	.	A	G	3	2	5	0	1	6	0	0
8	21140679	.	T	C	3	3	6	0	0	6	0	0
8	21141088	.	G	A	4	6	10	0	0	10	0	0
8	21141479	.	G	T	4	4	8	0	0	8	0	0
8	21146302	.	G	T	2	3	5	0	0	5	0	0
8	21146324	.	C	T	2	2	4	0	1	5	0	0
8	21146789	.	C	T	4	4	8	0	0	8	0	0
8	21146840	.	T	G	3	5	8	0	1	9	0	0
8	21151760	.	C	T	6	4	10	0	1	11	0	0
8	21152728	.	C	G	5	5	10	0	0	10	0	0
8	21152737	.	C	A	2	5	7	0	0	7	0	0
8	21155392	.	T	G	1	4	5	0	0	5	0	0
8	21155871	.	T	C	9	5	14	0	1	15	0	0
8	21155937	.	T	G	3	9	12	0	1	13	0	0
8	21159168	.	G	T	1	2	3	0	2	5	0	0
8	21159196	.	A	G	9	5	14	0	0	14	0	0
8	21159288	.	A	G	14	10	24	0	2	26	0	0
8	21162191	.	C	T	10	14	24	0	0	24	0	0
8	21162209	.	T	C	19	9	28	0	0	28	0	0
8	21162593	.	A	G	4	0	4	0	9	13	0	0
8	21225172	.	A	G	9	12	21	0	4	25	0	0
8	21229867	.	T	C	19	21	40	0	0	40	0	0
8	21239835	.	A	C	18	15	33	0	1	34	0	0
8	21240124	.	T	C	14	15	29	0	2	31	0	0
8	21241111	.	T	G	14	0	14	0	24	38	0	0
8	21241122	.	T	C	13	22	35	0	1	36	0	0
8	21247280	.	G	A	23	20	43	0	3	46	0	0
8	21250183	.	T	A	23	16	39	0	0	39	0	0
8	21250485	.	C	A	10	10	20	0	1	21	0	0
8	21250694	.	A	G	23	2	25	0	18	43	0	0
8	21250709	.	C	A	18	21	39	0	1	40	0	0
8	21250897	.	G	A	3	12	15	0	13	28	0	0
8	21250982	.	G	A	20	10	30	0	1	31	0	0
8	21250988	.	C	T	17	13	30	0	0	30	0	0
8	21251171	.	C	G	23	32	55	0	0	55	0	0
8	21251172	.	C	T	22	30	52	0	2	54	0	0
8	21251241	.	G	A	29	17	46	0	1	47	0	0
8	21251325	.	C	A	13	23	36	0	1	37	0	0
8	21251732	.	C	T	22	15	37	0	4	41	0	0
8	21251820	.	A	T	20	15	35	0	1	36	0	0
8	21251856	.	G	A	21	14	35	0	2	37	0	0
8	21251993	.	A	C	11	16	27	0	0	27	0	0
8	21252042	.	G	T	17	15	32	0	0	32	0	0
8	21252163	.	A	G	33	21	54	0	1	55	0	0
8	21252472	.	C	G	18	19	37	0	0	37	0	0
8	21265272	.	G	A	8	7	15	0	1	16	0	0
8	21265688	.	G	T	3	2	5	0	0	5	0	0
8	21265728	.	C	G	3	3	6	0	0	6	0	0
8	21265892	.	C	A	3	2	5	0	0	5	0	0
8	21352414	.	A	G	1	2	3	0	0	3	0	0
8	21352639	.	T	C	1	2	3	0	0	3	0	0
8	21352643	.	T	A	1	2	3	0	0	3	0	0
8	21360211	.	C	T	1	2	3	0	0	3	0	0
8	21361307	.	G	A	1	2	3	0	0	3	0	0
8	21361321	.	C	T	1	2	3	0	0	3	0	0
8	21365130	.	A	C	4	6	10	0	1	11	0	0
8	21368033	.	A	T	3	7	10	0	0	10	0	0
8	21413092	.	G	A	2	4	6	0	0	6	0	0
8	21629800	.	T	G	9	0	9	0	19	28	0	0
8	21664443	.	C	T	3	11	14	0	0	14	0	0
8	21664464	.	C	T	12	3	15	0	1	16	0	0
8	21671568	.	G	A	1	8	9	0	11	20	0	0
8	21671593	.	A	T	10	4	14	0	0	14	0	0
8	21671769	.	G	A	7	6	13	0	0	13	0	0
8	21672329	.	T	A	6	6	12	0	0	12	0	0
8	21672526	.	C	A	5	5	10	0	0	10	0	0
8	21672637	.	A	T	7	2	9	0	0	9	0	0
8	21673091	.	T	C	14	6	20	0	1	21	0	0
8	21673629	.	T	G	2	13	15	0	0	15	0	0
8	21673650	.	G	T	2	14	16	0	0	16	0	0
8	21673765	.	C	T	7	6	13	0	1	14	0	0
8	21673813	.	C	T	13	10	23	0	0	23	0	0
8	21673880	.	A	C	7	5	12	0	1	13	0	0
8	21673886	.	A	G	8	1	9	0	4	13	0	0
8	21674359	.	A	T	5	10	15	0	1	16	0	0
8	21674449	.	T	A	5	8	13	0	0	13	0	0
8	21674499	.	T	C	1	5	6	0	0	6	0	0
8	21674509	.	T	A	2	6	8	0	0	8	0	0
8	21674546	.	A	T	2	5	7	0	1	8	0	0
8	21674662	.	T	C	1	5	6	0	0	6	0	0
8	21674841	.	A	G	3	0	3	0	19	22	0	0
8	21675000	.	G	A	4	9	13	0	4	17	0	0
8	21675004	.	G	A	9	5	14	0	2	16	0	0
8	21675043	.	G	C	5	10	15	0	3	18	0	0
8	21675054	.	A	G	18	0	18	0	0	18	0	0
8	21675208	.	T	C	3	14	17	0	0	17	0	0
8	21675551	.	A	G	6	24	30	0	2	32	0	0
8	21675575	.	T	C	20	9	29	0	0	29	0	0
8	21675608	.	G	C	13	8	21	0	0	21	0	0
8	21675695	.	G	T	0	11	11	0	5	16	0	0
8	21675698	.	G	A	0	11	11	0	5	16	0	0
8	21675787	.	T	A	6	13	19	0	1	20	0	0
8	21675882	.	A	G	2	15	17	0	1	18	0	0
8	21978302	.	A	C	5	2	7	0	0	7	0	0
8	21978306	.	G	A	5	2	7	0	0	7	0	0
8	21978455	.	A	G	1	2	3	0	0	3	0	0
8	21978475	.	A	G	2	2	4	0	0	4	0	0
8	22010925	.	A	T	2	3	5	0	1	6	0	0
8	22054581	.	T	C	1	0	1	0	1	2	0	0
8	22054593	.	T	C	1	2	3	0	0	3	0	0
8	22277221	.	A	C	1	2	3	0	0	3	0	0
8	22277274	.	A	T	2	3	5	0	0	5	0	0
8	22277560	.	A	T	5	2	7	0	0	7	0	0
8	22282637	.	T	C	4	3	7	0	1	8	0	0
8	22283782	.	G	A	3	4	7	1	0	8	0	0
8	22284029	.	T	A	2	3	5	0	0	5	0	0
8	22284192	.	G	T	8	6	14	0	0	14	0	0
8	22284206	.	G	T	9	7	16	0	0	16	0	0
8	22284262	.	C	T	8	5	13	0	0	13	0	0
8	22284266	.	C	T	5	7	12	0	0	12	0	0
8	22284306	.	C	T	6	7	13	0	0	13	0	0
8	22284316	.	C	T	8	6	14	0	0	14	0	0
8	22284379	.	T	G	5	7	12	0	1	13	0	0
8	22284425	.	G	A	8	5	13	0	0	13	0	0
8	22284509	.	T	C	10	10	20	0	0	20	0	0
8	22284570	.	T	G	8	6	14	0	1	16	1	0
8	22287163	.	A	G	4	6	10	0	0	10	0	0
8	22289490	.	A	T	2	3	5	0	0	5	0	0
8	22289764	.	A	C	1	2	3	0	0	3	0	0
8	22289769	.	A	C	1	2	3	0	0	3	0	0
8	22290025	.	A	G	1	3	4	0	0	4	0	0
8	22290358	.	G	A	1	1	2	0	1	3	0	0
8	22298241	.	A	C	6	8	14	0	0	14	0	0
8	22298242	.	G	T	6	8	14	0	0	14	0	0
8	22301156	.	T	C	4	3	7	0	0	7	0	0
8	22303820	.	G	A	6	4	10	0	0	10	0	0
8	22303922	.	A	T	3	3	6	0	0	6	0	0
8	22307003	.	C	T	2	8	10	0	1	11	0	0
8	22317465	.	T	C	2	4	6	0	1	7	0	0
8	22319231	.	G	T	1	3	4	0	0	4	0	0
8	22319260	.	A	C	3	0	3	0	5	8	0	0
8	22319303	.	A	G	5	4	9	0	0	9	0	0
8	22320748	.	A	G	7	7	14	0	0	14	0	0
8	22320850	.	C	T	2	5	7	0	0	7	0	0
8	22321160	.	T	C	3	2	5	0	0	5	0	0
8	22321163	.	T	C	2	2	4	0	0	4	0	0
8	22321242	.	G	A	1	2	3	0	0	3	0	0
8	22324449	.	T	C	4	2	6	0	0	6	0	0
8	22324992	.	G	A	3	2	5	0	0	5	0	0
8	22325928	.	G	A	3	2	5	0	0	5	0	0
8	22327353	.	G	A	6	6	12	0	0	12	0	0
8	22329411	.	C	A	5	7	12	0	1	13	0	0
8	22329434	.	A	G	7	4	11	0	1	12	0	0
8	22337301	.	T	C	4	5	9	0	0	9	0	0
8	22337337	.	G	A	1	9	10	0	4	14	0	0
8	22337436	.	T	C	4	6	10	0	0	10	0	0
8	22337674	.	A	T	1	2	3	0	0	3	0	0
8	22345458	.	T	A	2	2	4	0	0	4	0	0
8	22345517	.	G	A	1	5	6	0	6	12	0	0
8	22345520	.	G	A	6	5	11	0	0	11	0	0
8	22346502	.	C	T	5	7	12	0	2	14	0	0
8	22346638	.	C	T	4	2	6	0	2	8	0	0
8	22394324	.	C	A	16	13	29	0	0	29	0	0
8	22394626	.	T	C	9	6	15	0	1	16	0	0
8	22453603	.	A	G	1	5	6	0	0	6	0	0
8	22472601	.	A	C	1	5	6	0	0	6	0	0
8	22472607	.	A	G	1	5	6	0	0	6	0	0
8	22500293	.	C	T	8	4	12	0	0	12	0	0
8	22500307	.	A	C	4	0	4	0	3	7	0	0
8	22500406	.	A	T	3	8	11	0	0	11	0	0
8	22500543	.	T	C	6	0	6	0	11	17	0	0
8	22500739	.	G	A	6	12	18	0	1	19	0	0
8	22502731	.	C	T	6	9	15	0	1	16	0	0
8	22503725	.	T	G	7	4	11	0	0	11	0	0
8	22503748	.	C	T	7	4	11	0	1	12	0	0
8	22503782	.	C	T	3	3	6	0	6	12	0	0
8	22504424	.	T	A	4	4	8	0	0	8	0	0
8	22504463	.	T	A	6	4	10	0	0	10	0	0
8	22511092	.	A	C	2	5	7	0	0	7	0	0
8	22511387	.	G	A	3	5	8	0	0	8	0	0
8	22511518	.	C	T	0	6	6	0	5	11	0	0
8	22511551	.	C	A	4	6	10	0	0	10	0	0
8	22511654	.	C	T	0	6	6	0	6	12	0	0
8	22511718	.	G	A	2	3	5	0	0	5	0	0
8	22511936	.	G	A	7	2	9	0	0	9	0	0
8	22512537	.	T	G	1	2	3	0	0	3	0	0
8	22512567	.	C	T	0	2	2	0	1	3	0	0
8	22522035	.	G	A	17	24	41	1	8	50	0	0
8	22522385	.	T	C	8	1	9	0	13	22	0	0
8	22522688	.	G	A	18	13	31	0	3	34	0	0
8	22522699	.	C	G	0	10	10	0	21	34	3	0
8	22522744	.	A	G	20	17	37	0	1	38	0	0
8	22522913	.	T	A	15	20	35	0	1	36	0	0
8	22523010	.	A	T	15	14	29	0	2	31	0	0
8	22524820	.	C	T	25	18	43	0	3	46	0	0
8	22525228	.	G	A	24	17	41	0	0	41	0	0
8	22525336	.	G	A	22	21	43	0	3	46	0	0
8	22525773	.	C	T	3	9	12	0	20	32	0	0
8	22525978	.	C	T	24	15	39	0	2	41	0	0
8	22526355	.	T	G	14	9	23	0	3	26	0	0
8	22530480	.	G	A	10	18	28	0	1	29	0	0
8	22530633	.	A	G	19	12	31	0	1	32	0	0
8	22531978	.	G	A	16	14	30	0	0	30	0	0
8	22533535	.	C	T	9	12	21	0	1	22	0	0
8	22536031	.	C	T	10	8	18	0	1	19	0	0
8	22544636	.	G	A	2	5	7	0	0	7	0	0
8	22544985	.	G	A	4	4	8	0	0	8	0	0
8	22554321	.	C	G	3	4	7	0	2	9	0	0
8	22556565	.	C	G	2	2	4	0	0	4	0	0
8	22603951	.	C	T	5	7	12	0	0	12	0	0
8	22604170	.	A	T	12	6	18	0	0	18	0	0
8	22604181	.	T	C	12	5	17	0	1	18	0	0
8	22607125	.	T	C	11	7	18	0	0	18	0	0
8	22611837	.	C	T	14	9	23	0	0	23	0	0
8	22612158	.	A	C	8	12	20	0	0	20	0	0
8	22612328	.	A	G	6	6	12	0	4	16	0	0
8	22612329	.	C	T	10	7	17	0	0	17	0	0
8	22612638	.	T	C	6	9	15	0	3	18	0	0
8	22612917	.	T	G	6	5	11	0	0	11	0	0
8	22612950	.	C	T	7	7	14	0	0	14	0	0
8	22613136	.	C	T	6	4	10	0	1	11	0	0
8	22613346	.	G	T	6	5	11	0	3	14	0	0
8	22613404	.	T	C	5	2	7	0	2	9	0	0
8	22613419	.	C	A	4	2	6	0	5	11	0	0
8	22613493	.	G	A	1	6	7	0	2	9	0	0
8	22613553	.	A	G	6	5	11	0	1	12	0	0
8	22618864	.	A	G	26	8	34	0	14	48	0	0
8	22619110	.	G	A	28	21	49	0	1	50	0	0
8	22619212	.	T	A	17	24	41	0	2	43	0	0
8	22619669	.	G	A	4	16	20	0	7	27	0	0
8	22622632	.	G	C	6	10	16	0	0	16	0	0
8	22622674	.	A	T	9	16	25	0	0	25	0	0
8	22622712	.	C	T	1	16	17	0	14	31	0	0
8	22622733	.	A	T	12	18	30	0	0	30	0	0
8	22624324	.	C	A	1	12	13	0	14	27	0	0
8	22627917	.	A	C	15	14	29	0	0	29	0	0
8	22630366	.	A	G	8	13	21	0	1	22	0	0
8	22631760	.	T	A	10	11	21	0	1	22	0	0
8	22631865	.	A	G	8	12	20	0	1	21	0	0
8	22631898	.	C	A	0	16	16	0	15	31	0	0
8	22632185	.	G	A	22	19	41	0	3	44	0	0
8	22632213	.	A	G	20	13	33	0	3	36	0	0
8	22632249	.	A	G	11	16	27	0	1	28	0	0
8	22632687	.	T	A	10	8	18	0	1	19	0	0
8	22635426	.	T	C	10	1	11	3	10	24	0	0
8	22637699	.	T	G	12	14	26	0	1	27	0	0
8	22761882	.	C	G	5	3	8	0	1	9	0	0
8	22762019	.	G	A	5	7	12	0	1	13	0	0
8	22762173	.	C	T	9	11	20	0	0	20	0	0
8	22762194	.	A	C	9	7	16	0	0	16	0	0
8	22762442	.	A	G	9	8	17	0	0	17	0	0
8	22766529	.	A	C	5	5	10	0	0	10	0	0
8	22766857	.	A	G	8	6	14	0	0	14	0	0
8	22787579	.	T	A	3	4	7	0	0	7	0	0
8	22787968	.	C	A	5	6	11	0	1	12	0	0
8	22788116	.	G	A	8	8	16	0	1	17	0	0
8	22788511	.	A	G	8	2	10	0	1	11	0	0
8	22788541	.	T	G	7	7	14	0	0	14	0	0
8	22788583	.	T	G	6	6	12	0	0	12	0	0
8	22788956	.	A	G	4	5	9	0	1	10	0	0
8	22789112	.	A	G	5	6	11	0	0	11	0	0
8	22837646	.	G	A	1	2	3	0	0	3	0	0
8	22837651	.	C	T	1	1	2	0	0	2	0	0
8	22916188	.	G	A	2	2	4	0	0	4	0	0
8	22926258	.	A	C	1	3	4	0	0	4	0	0
8	22945179	.	G	T	25	29	54	0	5	59	0	0
8	22945605	.	T	C	27	27	54	0	5	59	0	0
8	22946780	.	T	C	24	24	48	0	2	50	0	0
8	22946987	.	G	C	40	26	66	0	1	67	0	0
8	22951203	.	A	T	37	26	63	0	5	68	0	0
8	22951406	.	T	A	19	23	42	1	9	52	0	0
8	22951691	.	A	T	28	19	47	0	2	49	0	0
8	22951730	.	G	A	33	18	51	0	4	55	0	0
8	22951880	.	A	G	26	25	51	0	1	52	0	0
8	22951979	.	T	G	30	36	66	0	0	66	0	0
8	22952243	.	T	A	41	31	72	0	1	73	0	0
8	22953595	.	T	A	1	3	4	0	0	4	0	0
8	22977306	.	A	G	4	2	6	0	0	6	0	0
8	23025510	.	A	C	2	3	5	0	0	5	0	0
8	23040887	.	A	G	14	8	22	0	1	23	0	0
8	23040913	.	G	C	11	11	22	0	0	22	0	0
8	23044478	.	G	T	16	7	23	0	0	23	0	0
8	23044554	.	T	C	11	0	11	0	12	23	0	0
8	23044620	.	G	A	19	7	26	0	1	27	0	0
8	23044752	.	A	G	15	9	24	0	1	25	0	0
8	23056164	.	T	A	14	7	21	0	1	22	0	0
8	23081314	.	T	C	8	0	8	0	7	15	0	0
8	23105304	.	T	A	10	10	20	0	1	21	0	0
8	23105429	.	A	G	12	6	18	0	0	18	0	0
8	23109308	.	C	T	14	7	21	0	0	21	0	0
8	23109554	.	C	A	12	16	28	0	1	29	0	0
8	23109803	.	A	C	6	6	12	0	3	15	0	0
8	23109890	.	T	C	11	15	26	0	1	27	0	0
8	23110301	.	T	A	13	15	28	0	2	30	0	0
8	23110475	.	A	G	8	10	18	0	0	18	0	0
8	23118396	.	A	G	9	10	19	0	1	20	0	0
8	23118830	.	T	C	10	7	17	0	1	18	0	0
8	23119524	.	C	A	18	17	35	0	1	36	0	0
8	23122210	.	T	G	3	6	9	0	0	9	0	0
8	23122265	.	T	C	4	5	9	0	1	10	0	0
8	23122348	.	A	G	4	13	17	0	0	17	0	0
8	23142985	.	G	A	1	2	3	0	0	3	0	0
8	23143137	.	G	A	2	3	5	0	0	5	0	0
8	23143144	.	G	A	2	2	4	0	1	5	0	0
8	23147528	.	C	T	5	3	8	0	0	8	0	0
8	23147536	.	G	A	5	4	9	0	0	9	0	0
8	23149815	.	C	G	9	16	25	0	1	26	0	0
8	23149956	.	G	A	3	10	13	0	17	30	0	0
8	23151375	.	C	T	6	9	15	0	0	15	0	0
8	23151697	.	C	T	8	4	12	0	2	14	0	0
8	23165835	.	G	T	3	20	23	0	23	46	0	0
8	23175234	.	C	T	21	27	48	0	0	48	0	0
8	23179659	.	G	T	28	25	53	0	2	55	0	0
8	23179702	.	T	G	27	24	51	0	0	51	0	0
8	23194322	.	A	T	10	5	15	0	1	16	0	0
8	23202757	.	C	T	5	7	12	0	0	12	0	0
8	23206666	.	T	A	1	1	2	0	1	3	0	0
8	23206667	.	T	C	1	2	3	0	0	3	0	0
8	23210432	.	C	T	14	15	29	0	0	29	0	0
8	23210441	.	T	C	15	15	30	0	0	30	0	0
8	23210492	.	T	C	18	7	25	0	1	26	0	0
8	23210579	.	G	A	9	11	20	0	1	21	0	0
8	23210652	.	G	A	14	8	22	0	2	24	0	0
8	23210832	.	A	T	3	8	11	0	0	11	0	0
8	23210857	.	A	G	6	7	13	0	1	15	1	0
8	23210944	.	T	C	12	9	21	0	0	21	0	0
8	23211047	.	A	C	12	3	15	0	0	15	0	0
8	23211054	.	C	T	11	6	17	0	0	17	0	0
8	23211109	.	G	T	12	6	18	0	1	19	0	0
8	23211120	.	C	T	16	8	24	0	1	25	0	0
8	23211233	.	G	T	12	11	23	0	0	23	0	0
8	23211402	.	T	C	11	8	19	0	0	19	0	0
8	23211424	.	C	A	11	8	19	0	0	19	0	0
8	23211446	.	A	C	13	5	18	0	0	18	0	0
8	23215631	.	C	T	9	8	17	0	0	17	0	0
8	23215643	.	C	T	8	8	16	0	2	18	0	0
8	23215762	.	T	C	12	10	22	0	0	22	0	0
8	23253118	.	T	C	3	6	9	0	0	9	0	0
8	23253169	.	T	C	3	6	9	0	0	9	0	0
8	23253200	.	A	G	4	6	10	0	0	10	0	0
8	23253242	.	C	T	3	6	9	0	0	9	0	0
8	23253274	.	A	T	2	2	4	0	0	4	0	0
8	23253640	.	A	T	2	3	5	0	0	5	0	0
8	23253656	.	C	T	0	4	4	0	2	6	0	0
8	23253843	.	A	G	2	6	8	0	0	8	0	0
8	23256509	.	A	G	7	13	20	0	1	21	0	0
8	23256521	.	A	G	5	11	16	0	1	17	0	0
8	23271275	.	G	A	3	6	9	0	0	9	0	0
8	23271281	.	G	A	4	8	12	0	0	12	0	0
8	23286153	.	G	A	3	10	13	0	0	13	0	0
8	23296377	.	A	G	1	4	5	0	0	5	0	0
8	23360901	.	G	A	2	2	4	0	0	4	0	0
8	23375392	.	G	A	1	2	3	0	0	3	0	0
8	23380007	.	G	A	1	2	3	0	0	3	0	0
8	23380532	.	G	A	1	2	3	0	0	3	0	0
8	23380604	.	C	A	2	2	4	0	0	4	0	0
8	23384003	.	G	A	2	4	6	0	0	6	0	0
8	23389692	.	A	C	2	5	7	0	0	7	0	0
8	23389736	.	G	A	2	3	5	0	1	6	0	0
8	23390113	.	T	C	1	2	3	0	2	5	0	0
8	23390197	.	T	A	1	2	3	0	0	3	0	0
8	23415651	.	C	T	8	3	11	0	1	12	0	0
8	23415693	.	G	A	10	7	17	0	0	17	0	0
8	23544205	.	G	T	3	3	6	1	0	7	0	0
8	23553648	.	C	T	2	2	4	0	1	5	0	0
8	23553749	.	A	T	2	4	6	0	0	6	0	0
8	23567670	.	T	C	7	6	13	0	2	15	0	0
8	23580927	.	C	T	3	3	6	0	0	6	0	0
8	23617372	.	C	T	7	7	14	0	0	14	0	0
8	23620494	.	G	A	9	15	24	0	2	26	0	0
8	23625823	.	T	G	11	5	16	0	0	16	0	0
8	23627371	.	T	C	3	2	5	0	0	5	0	0
8	23627494	.	T	C	6	4	10	0	2	12	0	0
8	23631692	.	C	T	10	8	18	0	0	18	0	0
8	23636779	.	A	C	8	8	16	0	1	17	0	0
8	23636901	.	C	A	8	8	16	0	0	16	0	0
8	23636973	.	T	G	6	2	8	0	0	8	0	0
8	23637680	.	C	T	3	3	6	0	0	6	0	0
8	23639214	.	T	G	7	6	13	0	2	15	0	0
8	23639301	.	T	C	7	14	21	0	0	21	0	0
8	23639472	.	T	C	3	4	7	0	0	7	0	0
8	23640048	.	A	G	6	0	6	0	4	10	0	0
8	23642117	.	T	C	6	5	11	0	0	11	0	0
8	23644351	.	C	A	3	7	10	0	1	11	0	0
8	23644363	.	T	A	4	8	12	0	1	13	0	0
8	23647323	.	G	C	4	7	11	0	0	11	0	0
8	23648753	.	T	C	8	10	18	0	1	19	0	0
8	23656058	.	G	A	9	9	18	0	0	18	0	0
8	23656151	.	C	T	10	21	31	0	0	31	0	0
8	23667549	.	T	C	3	4	7	0	0	7	0	0
8	23667561	.	C	T	2	4	6	0	0	6	0	0
8	23667739	.	C	T	7	4	11	0	2	13	0	0
8	23667810	.	T	C	6	7	13	0	0	13	0	0
8	23667902	.	C	A	7	5	12	0	0	12	0	0
8	23667909	.	G	T	7	4	11	0	0	11	0	0
8	23667966	.	G	A	11	4	15	0	1	16	0	0
8	23668050	.	G	A	6	7	13	0	0	13	0	0
8	23668060	.	C	T	3	7	10	0	1	11	0	0
8	23668371	.	A	T	4	5	9	0	0	9	0	0
8	23668623	.	G	A	5	12	17	0	0	17	0	0
8	23669276	.	C	T	6	6	12	0	0	12	0	0
8	23669307	.	T	C	3	3	6	0	0	6	0	0
8	23669423	.	T	C	2	4	6	0	0	6	0	0
8	23669451	.	A	G	3	4	7	0	0	7	0	0
8	23669642	.	C	T	5	5	10	0	2	12	0	0
8	23669736	.	A	T	9	7	16	0	0	16	0	0
8	23669802	.	C	A	5	10	15	0	1	16	0	0
8	23669821	.	G	A	0	9	9	0	5	14	0	0
8	23669933	.	C	A	3	14	17	0	1	18	0	0
8	23669968	.	C	T	2	10	12	0	0	12	0	0
8	23669983	.	T	C	4	6	10	0	0	10	0	0
8	23670202	.	A	G	6	3	9	0	0	9	0	0
8	23672388	.	A	C	1	2	3	0	0	3	0	0
8	23672505	.	C	T	8	6	14	0	0	14	0	0
8	23672740	.	G	C	7	7	14	0	1	15	0	0
8	23672802	.	A	G	3	10	13	0	0	14	1	0
8	23672812	.	G	A	3	11	14	0	0	14	0	0
8	23672888	.	T	A	2	4	6	0	2	8	0	0
8	23673051	.	A	G	5	2	7	0	0	7	0	0
8	23673096	.	T	C	3	6	9	0	1	10	0	0
8	23673133	.	G	T	1	6	7	0	0	7	0	0
8	23673205	.	T	A	9	4	13	0	0	13	0	0
8	23673285	.	G	T	3	2	5	0	0	5	0	0
8	23673339	.	T	C	2	2	4	0	0	4	0	0
8	23673368	.	G	A	1	3	4	0	0	4	0	0
8	23673982	.	A	G	1	2	3	0	1	4	0	0
8	23674036	.	C	T	2	3	5	0	0	5	0	0
8	23674046	.	C	T	0	3	3	0	2	5	0	0
8	23674125	.	A	G	1	3	4	0	1	5	0	0
8	23674355	.	T	G	1	3	4	0	0	5	1	0
8	23674563	.	A	T	3	2	5	0	0	5	0	0
8	23674664	.	A	G	3	3	6	2	0	8	0	0
8	23675228	.	G	A	1	3	4	0	0	4	0	0
8	23691287	.	T	C	6	0	6	0	2	8	0	0
8	23691297	.	C	G	5	2	7	1	0	8	0	0
8	23703739	.	C	T	6	3	9	0	0	9	0	0
8	23703754	.	C	T	5	5	10	0	0	10	0	0
8	23703775	.	T	A	6	3	9	0	1	10	0	0
8	23703819	.	C	A	2	4	6	0	0	6	0	0
8	23703827	.	T	A	2	3	5	0	0	5	0	0
8	23709336	.	A	G	2	2	4	0	0	4	0	0
8	23711985	.	G	A	4	5	9	0	1	10	0	0
8	23713465	.	G	A	5	3	8	0	2	10	0	0
8	23713466	.	T	C	4	4	8	0	2	10	0	0
8	23716979	.	G	T	4	5	9	0	0	9	0	0
8	23717117	.	C	A	1	3	4	0	0	4	0	0
8	23720518	.	A	G	4	4	8	0	0	8	0	0
8	23723497	.	C	A	3	2	5	0	0	5	0	0
8	23723503	.	G	A	2	1	3	0	0	3	0	0
8	23723723	.	G	A	1	4	5	0	1	6	0	0
8	23724045	.	A	C	9	7	16	0	0	16	0	0
8	23724620	.	G	A	0	5	5	0	5	10	0	0
8	23733414	.	G	A	4	6	10	0	0	10	0	0
8	23733495	.	G	C	3	4	7	0	0	7	0	0
8	23733545	.	A	G	4	4	8	0	0	8	0	0
8	23733548	.	G	A	4	6	10	0	0	10	0	0
8	23734596	.	C	T	1	5	6	0	0	6	0	0
8	23734632	.	A	G	1	4	5	0	1	6	0	0
8	23735725	.	G	A	3	4	7	0	0	7	0	0
8	23735856	.	C	T	3	4	7	0	0	7	0	0
8	23738160	.	C	G	10	16	26	0	1	27	0	0
8	23740519	.	G	A	33	32	65	0	3	68	0	0
8	23742978	.	G	A	1	6	7	0	1	8	0	0
8	23753566	.	T	A	7	5	12	0	0	12	0	0
8	23753793	.	C	T	1	3	4	0	4	8	0	0
8	23753834	.	C	G	0	4	4	0	1	5	0	0
8	23756089	.	A	T	5	5	10	0	2	12	0	0
8	23756536	.	C	G	1	10	11	0	9	20	0	0
8	23756749	.	G	C	7	4	11	0	1	12	0	0
8	23760288	.	C	T	1	6	7	0	6	13	0	0
8	23762559	.	A	G	1	2	3	0	0	3	0	0
8	23763809	.	T	C	6	3	9	0	0	9	0	0
8	23765199	.	T	C	4	4	8	0	0	8	0	0
8	23783259	.	C	T	1	1	2	0	1	3	0	0
8	23827665	.	A	G	4	1	5	0	6	11	0	0
8	23833257	.	G	A	3	10	13	1	0	14	0	0
8	23857845	.	T	C	18	14	32	0	1	33	0	0
8	23857997	.	G	A	8	8	16	0	0	16	0	0
8	23860200	.	G	A	3	5	8	0	1	9	0	0
8	23865837	.	A	G	6	5	11	0	0	11	0	0
8	23867417	.	A	G	11	7	18	0	0	18	0	0
8	23869978	.	C	T	9	6	15	0	1	16	0	0
8	23871978	.	T	C	11	5	16	0	1	17	0	0
8	23878905	.	T	A	5	7	12	0	0	12	0	0
8	23879044	.	T	A	7	9	16	0	0	16	0	0
8	23879238	.	T	A	14	9	23	0	0	23	0	0
8	23879365	.	G	A	6	13	19	1	1	21	0	0
8	24108887	.	A	G	7	6	13	0	0	13	0	0
8	24108899	.	T	C	5	5	10	0	0	10	0	0
8	24109317	.	T	A	8	4	12	0	0	13	1	0
8	24109860	.	G	A	7	7	14	0	1	15	0	0
8	24110817	.	A	G	7	9	16	0	0	16	0	0
8	24111073	.	A	G	8	8	16	0	0	16	0	0
8	24111082	.	T	C	7	9	16	0	0	16	0	0
8	24113044	.	C	A	13	7	20	0	0	20	0	0
8	24113075	.	A	G	7	9	16	0	0	16	0	0
8	24113420	.	A	G	10	6	16	0	0	16	0	0
8	24113519	.	G	C	6	4	10	0	0	10	0	0
8	24120176	.	T	A	9	8	17	1	0	18	0	0
8	24120187	.	A	T	11	9	20	1	0	21	0	0
8	24122960	.	C	A	2	6	8	0	4	12	0	0
8	24123072	.	C	T	6	2	8	0	0	8	0	0
8	24135019	.	C	T	8	3	11	0	0	11	0	0
8	24135022	.	G	A	6	3	9	0	2	11	0	0
8	24303878	.	T	C	5	3	8	0	0	8	0	0
8	24303896	.	T	A	4	4	8	0	0	8	0	0
8	24304440	.	G	A	0	2	2	0	1	3	0	0
8	24313399	.	T	C	5	5	10	0	0	10	0	0
8	24315553	.	T	C	5	4	9	0	0	9	0	0
8	24316484	.	A	G	1	0	1	0	3	4	0	0
8	24316499	.	G	A	2	5	7	0	0	7	0	0
8	24322446	.	C	T	3	5	8	0	0	8	0	0
8	24322455	.	T	A	4	5	9	0	0	9	0	0
8	24323336	.	T	C	4	2	6	0	0	6	0	0
8	24325363	.	A	G	6	4	10	0	0	10	0	0
8	24740168	.	C	A	14	13	27	0	1	28	0	0
8	24741031	.	A	T	6	10	16	0	0	16	0	0
8	24743676	.	A	T	6	7	13	0	0	13	0	0
8	24743874	.	G	A	1	5	6	0	7	13	0	0
8	24788514	.	C	T	8	4	12	0	0	12	0	0
8	24790139	.	A	G	4	10	14	0	1	15	0	0
8	24790194	.	A	G	6	7	13	0	0	13	0	0
8	24854637	.	G	A	7	8	15	0	0	15	0	0
8	24861530	.	T	C	13	9	22	0	0	22	0	0
8	24875117	.	C	G	7	0	7	0	13	20	0	0
8	24880220	.	G	A	9	9	18	0	0	18	0	0
8	24881058	.	T	C	14	12	26	0	0	26	0	0
8	24883433	.	G	A	2	16	18	0	21	39	0	0
8	24883487	.	T	C	12	15	27	0	0	27	0	0
8	24883577	.	C	T	6	11	17	0	1	18	0	0
8	24883963	.	C	A	7	8	15	0	2	17	0	0
8	24883975	.	A	G	10	9	19	0	0	19	0	0
8	24886194	.	T	C	7	11	18	0	3	21	0	0
8	24886251	.	A	G	8	9	17	0	0	17	0	0
8	24886626	.	T	G	7	18	25	0	2	27	0	0
8	24889403	.	C	T	12	22	34	0	5	39	0	0
8	24889482	.	A	T	11	16	27	0	5	32	0	0
8	24889586	.	C	T	10	21	31	0	1	32	0	0
8	24889629	.	A	G	9	26	35	0	0	35	0	0
8	24889638	.	T	A	11	27	38	0	1	39	0	0
8	24889796	.	G	A	17	22	39	0	0	39	0	0
8	24890084	.	T	A	15	21	36	0	0	36	0	0
8	24890238	.	T	A	16	16	32	0	4	36	0	0
8	24890798	.	C	T	15	16	31	0	2	33	0	0
8	24890913	.	T	G	14	21	35	0	3	38	0	0
8	24940006	.	C	T	3	3	6	0	1	7	0	0
8	24940282	.	G	A	3	2	5	0	0	5	0	0
8	24940303	.	G	A	3	2	5	0	0	5	0	0
8	24964775	.	G	A	1	3	4	0	0	4	0	0
8	24972006	.	T	C	16	12	28	0	4	32	0	0
8	24972137	.	G	T	7	16	23	0	13	36	0	0
8	24972413	.	A	C	12	10	22	0	0	22	0	0
8	24972594	.	T	C	20	21	41	0	0	41	0	0
8	24972595	.	T	A	20	21	41	0	0	41	0	0
8	24972746	.	T	A	10	20	30	0	2	32	0	0
8	24973088	.	G	C	10	11	21	0	0	21	0	0
8	24973239	.	T	A	16	15	31	0	0	31	0	0
8	24973276	.	A	G	15	13	28	0	0	28	0	0
8	24973462	.	A	G	10	8	18	1	0	19	0	0
8	24985735	.	T	C	12	12	24	1	0	25	0	0
8	24985741	.	G	C	11	13	24	1	0	25	0	0
8	24986965	.	G	A	15	17	32	0	0	32	0	0
8	24991082	.	G	T	14	13	27	0	1	28	0	0
8	24991127	.	G	A	11	10	21	0	0	21	0	0
8	24991169	.	G	A	7	14	21	0	0	21	0	0
8	25010904	.	C	A	0	15	15	0	10	25	0	0
8	25022506	.	C	T	1	6	7	0	6	13	0	0
8	25022808	.	C	T	5	3	8	0	1	9	0	0
8	25036520	.	T	C	7	4	11	0	0	11	0	0
8	25036523	.	A	G	6	0	6	0	3	9	0	0
8	25036694	.	C	G	9	6	15	1	1	17	0	0
8	25039704	.	T	C	12	8	20	0	1	21	0	0
8	25039967	.	C	A	6	6	12	0	0	12	0	0
8	25040295	.	A	G	5	6	11	0	1	12	0	0
8	25040349	.	A	G	3	4	7	0	0	7	0	0
8	25040479	.	T	C	1	4	5	0	0	5	0	0
8	25042269	.	T	C	12	6	18	0	1	19	0	0
8	25042275	.	T	C	13	6	19	0	0	19	0	0
8	25042328	.	A	G	11	11	22	0	0	22	0	0
8	25042352	.	G	A	10	9	19	0	1	20	0	0
8	25042474	.	T	C	14	2	16	0	12	28	0	0
8	25042578	.	A	G	12	15	27	0	0	27	0	0
8	25043125	.	A	G	11	12	23	0	0	23	0	0
8	25043167	.	A	T	13	15	28	0	0	28	0	0
8	25045766	.	T	C	11	14	25	0	0	25	0	0
8	25055972	.	G	T	12	7	19	0	0	19	0	0
8	25056041	.	T	C	9	0	9	0	10	19	0	0
8	25056207	.	A	G	9	12	21	0	1	22	0	0
8	25065675	.	T	A	5	9	14	0	2	16	0	0
8	25065762	.	A	G	4	10	14	0	1	15	0	0
8	25066100	.	C	T	7	8	15	0	1	16	0	0
8	25070634	.	T	C	3	0	3	0	6	9	0	0
8	25074042	.	A	C	8	11	19	0	1	20	0	0
8	25091546	.	G	T	4	9	13	0	1	14	0	0
8	25094117	.	A	G	8	0	8	0	3	11	0	0
8	25094489	.	C	G	4	3	7	0	1	8	0	0
8	25097431	.	G	A	2	3	5	0	0	5	0	0
8	25101351	.	A	G	5	0	5	0	4	9	0	0
8	25101435	.	G	A	4	5	9	0	2	11	0	0
8	25103407	.	C	T	9	7	16	0	1	17	0	0
8	25103581	.	C	T	2	7	9	0	1	10	0	0
8	25103719	.	T	C	7	8	15	0	0	15	0	0
8	25103731	.	T	C	9	5	14	0	0	14	0	0
8	25103801	.	A	G	2	0	2	0	8	10	0	0
8	25117654	.	T	C	8	13	21	0	0	21	0	0
8	25117759	.	A	G	13	6	19	0	0	19	0	0
8	25118164	.	C	A	18	8	26	0	0	26	0	0
8	25118587	.	A	G	6	11	17	0	0	17	0	0
8	25176197	.	C	T	7	9	16	0	0	16	0	0
8	25176250	.	T	C	8	9	17	0	1	18	0	0
8	25176257	.	T	C	9	7	16	0	1	17	0	0
8	25176303	.	A	G	10	8	18	0	3	21	0	0
8	25176677	.	T	C	5	9	14	0	0	14	0	0
8	25176957	.	C	G	3	6	9	0	0	9	0	0
8	25177285	.	A	G	4	5	9	0	0	9	0	0
8	25190350	.	A	T	1	2	3	0	0	3	0	0
8	25190352	.	T	C	1	2	3	0	0	3	0	0
8	25217721	.	C	T	2	4	6	0	1	7	0	0
8	25247262	.	A	C	2	2	4	0	0	4	0	0
8	25247355	.	A	G	6	0	6	0	6	12	0	0
8	25267833	.	T	C	10	8	18	0	1	19	0	0
8	25271544	.	T	C	5	6	11	0	1	12	0	0
8	25272507	.	C	T	12	12	24	0	0	24	0	0
8	25280530	.	T	C	10	17	27	0	1	28	0	0
8	25280849	.	C	T	8	7	15	0	0	15	0	0
8	25281877	.	A	G	9	0	9	0	8	17	0	0
8	25283346	.	T	G	15	0	15	0	8	23	0	0
8	25283768	.	A	G	11	10	21	0	0	21	0	0
8	25283771	.	T	C	11	9	20	0	2	22	0	0
8	25289156	.	A	G	13	0	13	0	16	29	0	0
8	25289180	.	C	T	9	22	31	0	0	31	0	0
8	25291478	.	A	T	10	6	16	0	1	17	0	0
8	25291573	.	C	A	10	9	19	0	0	19	0	0
8	25291651	.	A	G	6	9	15	0	1	16	0	0
8	25291662	.	A	G	8	8	16	0	1	17	0	0
8	25291742	.	A	C	10	14	24	0	2	26	0	0
8	25291912	.	A	T	12	18	30	0	0	30	0	0
8	25292188	.	C	T	8	11	19	0	0	19	0	0
8	25292370	.	A	G	5	20	25	0	1	26	0	0
8	25292407	.	G	T	8	22	30	0	1	31	0	0
8	25292482	.	T	C	18	7	25	0	1	26	0	0
8	25292492	.	A	T	19	9	28	0	0	28	0	0
8	25292608	.	T	C	21	17	38	0	2	40	0	0
8	25292865	.	G	C	15	17	32	0	0	32	0	0
8	25293008	.	A	G	17	17	34	0	0	34	0	0
8	25293064	.	C	T	11	23	34	0	2	36	0	0
8	25293111	.	G	T	13	14	27	0	1	29	1	0
8	25293184	.	C	T	15	26	41	0	0	41	0	0
8	25293225	.	T	A	9	18	27	0	0	27	0	0
8	25293275	.	A	G	21	1	22	0	10	32	0	0
8	25293346	.	C	T	18	8	26	0	0	26	0	0
8	25293445	.	T	C	3	5	8	0	1	9	0	0
8	25293459	.	T	C	2	4	6	0	0	6	0	0
8	25295219	.	A	T	5	5	10	0	0	10	0	0
8	25297326	.	A	G	12	0	12	0	32	44	0	0
8	25297371	.	T	C	13	29	42	8	4	54	0	0
8	25297523	.	A	G	19	0	19	6	25	50	0	0
8	25297617	.	G	C	17	23	40	0	1	41	0	0
8	25297741	.	C	T	10	28	38	0	0	38	0	0
8	25297842	.	T	A	18	15	33	0	1	34	0	0
8	25297864	.	A	G	12	7	19	0	2	21	0	0
8	25299819	.	A	G	8	6	14	0	3	17	0	0
8	25300511	.	C	T	6	6	12	0	1	13	0	0
8	25300749	.	T	C	14	12	26	1	1	28	0	0
8	25301185	.	T	C	11	6	17	0	3	20	0	0
8	25301280	.	A	G	10	15	25	0	0	25	0	0
8	25301350	.	A	G	10	8	18	0	3	21	0	0
8	25301389	.	G	A	1	8	9	1	7	17	0	0
8	25301450	.	T	C	8	5	13	0	0	13	0	0
8	25301512	.	G	T	7	11	18	0	0	18	0	0
8	25301524	.	A	G	6	11	17	0	2	19	0	0
8	25301547	.	G	A	11	8	19	0	0	19	0	0
8	25301583	.	C	A	10	8	18	0	1	19	0	0
8	25301590	.	A	C	7	9	16	0	3	19	0	0
8	25329565	.	T	C	5	3	8	0	0	8	0	0
8	25329583	.	A	T	7	2	9	0	0	9	0	0
8	25329981	.	A	T	13	3	16	0	2	18	0	0
8	25330065	.	T	A	9	15	24	0	0	24	0	0
8	25330181	.	C	T	12	7	19	0	1	20	0	0
8	25330293	.	C	T	20	7	27	0	1	28	0	0
8	25330295	.	T	A	18	8	26	0	2	28	0	0
8	25330390	.	A	G	24	6	30	0	0	30	0	0
8	25330498	.	G	A	27	19	46	0	0	46	0	0
8	25332708	.	C	T	35	33	68	0	4	72	0	0
8	25332900	.	A	G	32	33	65	0	1	66	0	0
8	25332945	.	G	A	28	36	64	0	2	67	1	0
8	25335063	.	G	A	22	28	50	0	0	50	0	0
8	25336097	.	T	A	30	26	56	0	1	58	1	0
8	25336102	.	T	G	27	26	53	0	2	55	0	0
8	25367091	.	C	T	3	7	10	0	0	10	0	0
8	25368374	.	A	G	3	4	7	0	0	7	0	0
8	25368421	.	A	G	4	6	10	0	1	11	0	0
8	25368451	.	A	G	3	4	7	0	0	7	0	0
8	25370776	.	T	C	7	5	12	1	0	13	0	0
8	25398679	.	T	C	1	0	1	0	3	4	0	0
8	25422063	.	G	T	2	3	5	0	0	5	0	0
8	25422072	.	A	C	2	0	2	0	3	5	0	0
8	25424272	.	C	T	8	5	13	0	1	14	0	0
8	25424375	.	C	A	14	16	30	0	0	30	0	0
8	25424411	.	T	A	9	7	16	0	1	17	0	0
8	25424658	.	G	A	3	6	9	0	1	10	0	0
8	25424721	.	A	G	2	6	8	0	0	8	0	0
8	25424734	.	T	A	1	6	7	0	0	7	0	0
8	25424865	.	T	A	11	12	23	0	0	23	0	0
8	25425395	.	G	A	5	4	9	0	0	9	0	0
8	25425453	.	G	A	7	3	10	0	0	10	0	0
8	25426563	.	T	G	6	3	9	0	0	9	0	0
8	25431560	.	A	G	3	3	6	0	0	6	0	0
8	25445451	.	A	G	6	3	9	0	0	9	0	0
8	25445553	.	A	G	7	4	11	0	0	11	0	0
8	25450326	.	A	G	1	6	7	0	0	7	0	0
8	25452089	.	G	A	2	4	6	0	0	6	0	0
8	25452117	.	T	C	1	4	5	0	0	5	0	0
8	25455917	.	C	A	1	6	7	0	1	8	0	0
8	25497591	.	T	C	3	0	3	0	2	5	0	0
8	25497594	.	A	G	4	2	6	0	0	6	0	0
8	25650512	.	T	C	3	2	5	0	0	5	0	0
8	25650518	.	T	C	5	0	5	0	2	7	0	0
8	25708263	.	A	G	4	3	7	0	1	8	0	0
8	25708998	.	C	T	7	8	15	0	2	17	0	0
8	25709426	.	G	T	12	5	17	0	0	17	0	0
8	25709521	.	T	A	9	7	16	0	1	17	0	0
8	25709522	.	A	C	10	8	18	0	0	18	0	0
8	25709694	.	T	G	11	8	19	0	1	20	0	0
8	25709725	.	C	A	15	4	19	0	0	19	0	0
8	25712660	.	G	T	22	9	31	0	1	32	0	0
8	25713053	.	G	A	18	15	33	0	1	34	0	0
8	25713365	.	A	G	5	8	13	0	0	13	0	0
8	25714884	.	G	A	12	6	18	0	0	18	0	0
8	25715028	.	T	A	9	14	23	0	1	24	0	0
8	25715118	.	A	C	10	3	13	0	11	24	0	0
8	25715181	.	C	T	8	8	16	0	0	16	0	0
8	25715325	.	G	C	9	4	13	0	6	19	0	0
8	25715950	.	C	A	5	11	16	0	0	16	0	0
8	25716000	.	C	A	9	11	20	0	0	20	0	0
8	25733949	.	T	A	11	5	16	0	2	18	0	0
8	25745724	.	C	T	11	8	19	0	1	20	0	0
8	25745840	.	C	T	9	8	17	0	0	17	0	0
8	25745915	.	A	T	12	6	18	0	0	18	0	0
8	25746888	.	A	T	6	4	10	0	0	10	0	0
8	25746899	.	G	A	7	3	10	0	0	10	0	0
8	25747425	.	A	T	11	6	17	0	2	19	0	0
8	25747502	.	T	C	6	6	12	0	0	12	0	0
8	25747518	.	T	C	5	7	12	0	0	12	0	0
8	25747677	.	G	A	14	11	25	0	1	26	0	0
8	25747705	.	A	G	8	0	8	0	10	18	0	0
8	25748147	.	C	T	9	8	17	0	1	18	0	0
8	25751167	.	A	G	12	0	12	0	10	22	0	0
8	25753663	.	G	A	1	3	4	0	0	4	0	0
8	25761657	.	A	G	1	0	1	0	3	4	0	0
8	25761791	.	A	T	3	6	9	0	0	9	0	0
8	25761792	.	C	A	3	6	9	0	0	9	0	0
8	25761886	.	T	C	9	11	20	0	0	20	0	0
8	25764192	.	T	C	30	25	55	0	3	58	0	0
8	25765647	.	G	A	2	11	13	0	12	25	0	0
8	25765788	.	G	A	1	11	12	0	24	36	0	0
8	25765794	.	G	A	23	11	34	0	1	35	0	0
8	25766098	.	G	A	26	7	33	0	0	33	0	0
8	25766131	.	T	C	22	9	31	0	3	34	0	0
8	25766188	.	A	C	16	13	29	0	2	31	0	0
8	25766249	.	A	G	4	11	15	0	1	16	0	0
8	25812075	.	T	C	11	13	24	0	1	25	0	0
8	25812327	.	G	A	16	23	39	0	0	39	0	0
8	25813740	.	A	G	22	18	40	0	1	41	0	0
8	25813979	.	G	A	22	14	36	0	2	38	0	0
8	25814003	.	C	T	3	16	19	0	18	37	0	0
8	25816811	.	T	A	13	23	36	0	7	43	0	0
8	25816849	.	G	A	18	20	38	0	3	41	0	0
8	25816863	.	G	A	17	17	34	0	2	36	0	0
8	25816889	.	T	C	13	14	27	0	2	29	0	0
8	25816904	.	T	G	18	9	27	0	2	29	0	0
8	25816959	.	G	T	14	23	37	0	1	38	0	0
8	25818670	.	T	G	1	4	5	0	1	6	0	0
8	25818836	.	C	T	1	14	15	3	19	37	0	0
8	25819057	.	T	A	12	17	29	0	1	30	0	0
8	25819090	.	G	T	11	10	21	0	0	21	0	0
8	25819095	.	A	T	9	10	19	0	2	21	0	0
8	25819128	.	A	G	9	8	17	0	1	18	0	0
8	25819137	.	T	C	8	8	16	0	0	16	0	0
8	25819172	.	T	A	8	2	10	0	0	10	0	0
8	25819196	.	G	A	5	3	8	0	0	8	0	0
8	25819349	.	A	G	11	15	26	0	0	26	0	0
8	25819430	.	A	T	11	8	19	0	2	21	0	0
8	25819434	.	C	G	11	11	22	0	0	22	0	0
8	25819548	.	C	G	17	18	35	0	0	35	0	0
8	25820917	.	G	T	10	9	19	0	0	19	0	0
8	25821088	.	T	G	15	11	26	0	0	26	0	0
8	25821426	.	T	C	17	23	40	0	2	42	0	0
8	25845885	.	G	C	27	12	39	0	1	40	0	0
8	25869415	.	T	G	1	2	3	0	0	3	0	0
8	25892732	.	C	G	7	0	7	0	5	12	0	0
8	25893610	.	C	G	4	4	8	0	0	8	0	0
8	25893655	.	T	C	2	4	6	0	0	6	0	0
8	25893676	.	T	C	3	4	7	0	0	7	0	0
8	25894080	.	C	G	4	10	14	0	0	14	0	0
8	25894108	.	C	T	9	6	15	0	1	16	0	0
8	25897046	.	A	T	16	3	19	1	5	25	0	0
8	25897373	.	G	A	1	3	4	0	6	10	0	0
8	25897378	.	C	T	6	4	10	0	0	10	0	0
8	25897861	.	G	A	7	3	10	0	0	10	0	0
8	25902955	.	T	C	31	27	58	1	1	60	0	0
8	25905686	.	T	A	16	18	34	0	2	36	0	0
8	25905919	.	T	C	2	9	11	0	1	12	0	0
8	25925483	.	G	A	1	6	7	2	6	15	0	0
8	25927455	.	C	T	5	3	8	0	2	10	0	0
8	25944419	.	A	G	8	0	8	0	11	19	0	0
8	25948519	.	A	C	8	5	13	0	1	14	0	0
8	25950704	.	G	C	16	4	20	0	1	21	0	0
8	25950772	.	G	A	12	8	20	0	0	20	0	0
8	25950880	.	G	T	13	12	25	0	0	25	0	0
8	25951090	.	A	G	18	12	30	0	2	32	0	0
8	25951162	.	G	A	0	6	6	0	9	15	0	0
8	25951187	.	T	A	13	2	15	0	0	15	0	0
8	25951197	.	G	A	12	2	14	0	1	15	0	0
8	25951265	.	A	T	15	8	23	0	0	23	0	0
8	25951293	.	A	T	17	6	23	0	2	25	0	0
8	25951310	.	A	C	14	2	16	0	1	17	0	0
8	25951378	.	C	G	14	9	23	0	1	24	0	0
8	25951411	.	C	T	12	14	26	0	0	26	0	0
8	25951575	.	A	T	12	4	16	0	0	16	0	0
8	25951626	.	T	C	13	3	16	0	0	16	0	0
8	25951660	.	G	T	12	3	15	0	1	16	0	0
8	25951665	.	T	A	14	3	17	0	0	17	0	0
8	25951762	.	C	T	8	7	15	0	0	15	0	0
8	25963150	.	A	G	10	11	21	0	1	22	0	0
8	25963151	.	C	A	11	11	22	0	0	22	0	0
8	25964468	.	A	G	12	0	12	0	9	21	0	0
8	25964489	.	A	G	10	0	10	0	13	23	0	0
8	25964669	.	A	G	3	4	7	0	0	7	0	0
8	25969188	.	C	T	11	9	20	0	0	20	0	0
8	25969466	.	C	T	10	13	23	0	2	25	0	0
8	25969498	.	A	G	8	14	22	0	2	24	0	0
8	25969506	.	G	A	0	13	13	0	8	21	0	0
8	25969778	.	T	A	13	6	19	0	1	20	0	0
8	25969840	.	A	G	8	7	15	0	1	16	0	0
8	25970647	.	A	T	4	4	8	0	0	8	0	0
8	25970719	.	A	T	5	6	11	0	0	11	0	0
8	25970816	.	G	T	11	7	18	0	0	18	0	0
8	25970932	.	G	A	6	14	20	0	0	20	0	0
8	25971143	.	C	A	4	5	9	0	2	11	0	0
8	25971306	.	T	A	14	13	27	0	1	28	0	0
8	25971367	.	C	T	12	9	21	0	0	21	0	0
8	25971397	.	G	A	11	4	15	0	1	16	0	0
8	26008088	.	G	A	0	2	2	0	3	5	0	0
8	26008246	.	G	C	1	5	6	0	0	6	0	0
8	26009290	.	C	T	2	5	7	0	0	7	0	0
8	26012153	.	T	C	1	3	4	0	0	4	0	0
8	26019711	.	A	G	2	3	5	0	2	7	0	0
8	26034654	.	A	G	10	10	20	0	0	20	0	0
8	26034676	.	C	T	12	13	25	0	1	26	0	0
8	26056801	.	G	A	21	16	37	0	1	38	0	0
8	26056891	.	T	G	23	24	47	2	4	53	0	0
8	26056935	.	T	C	20	25	45	1	4	50	0	0
8	26056970	.	T	C	18	20	38	0	4	42	0	0
8	26056990	.	T	C	22	19	41	0	0	41	0	0
8	26057014	.	T	C	23	18	41	0	3	44	0	0
8	26059867	.	T	A	5	4	9	0	0	9	0	0
8	26059897	.	A	T	6	5	11	0	0	11	0	0
8	26078551	.	C	T	14	11	25	0	1	26	0	0
8	26078825	.	A	G	8	4	12	0	0	12	0	0
8	26078826	.	A	G	7	4	11	0	0	11	0	0
8	26078879	.	T	G	4	4	8	0	0	8	0	0
8	26091767	.	C	T	3	6	9	0	1	10	0	0
8	26091845	.	A	G	7	0	7	0	13	20	0	0
8	26092050	.	A	G	12	13	25	0	1	26	0	0
8	26092176	.	T	A	9	7	16	0	0	16	0	0
8	26095683	.	G	A	15	10	25	0	0	25	0	0
8	26097399	.	T	C	27	22	49	0	1	50	0	0
8	26097749	.	C	T	4	7	11	0	0	11	0	0
8	26097895	.	C	A	6	7	13	0	0	13	0	0
8	26125896	.	T	C	1	2	3	0	0	3	0	0
8	26126279	.	G	T	4	3	7	0	0	7	0	0
8	26126765	.	C	A	3	5	8	0	0	8	0	0
8	26127179	.	C	A	1	1	2	0	1	3	0	0
8	26151750	.	G	T	4	4	8	0	0	8	0	0
8	26176125	.	T	C	5	5	10	0	1	11	0	0
8	26185498	.	G	C	5	6	11	0	0	11	0	0
8	26189447	.	T	G	4	6	10	0	1	11	0	0
8	26189449	.	G	A	0	6	6	0	5	11	0	0
8	26190452	.	G	A	3	3	6	0	0	6	0	0
8	26192936	.	C	T	9	4	13	0	0	13	0	0
8	26199999	.	G	A	0	6	6	0	10	16	0	0
8	26200014	.	G	T	9	6	15	0	1	16	0	0
8	26203373	.	C	T	4	6	10	0	0	10	0	0
8	26203553	.	A	G	3	0	3	0	6	9	0	0
8	26208387	.	T	C	10	8	18	0	1	19	0	0
8	26210178	.	G	A	8	4	12	0	0	12	0	0
8	26210523	.	A	T	3	3	6	0	0	6	0	0
8	26210718	.	G	A	9	4	13	0	3	16	0	0
8	26210781	.	C	T	4	8	12	0	1	13	0	0
8	26220795	.	G	A	1	2	3	0	0	3	0	0
8	26220803	.	A	G	0	1	1	0	0	1	0	0
8	26233424	.	T	C	2	2	4	0	1	5	0	0
8	26233430	.	G	A	0	2	2	0	3	5	0	0
8	26234027	.	A	G	6	4	10	0	1	11	0	0
8	26234044	.	G	A	6	4	10	0	0	10	0	0
8	26234114	.	G	T	0	4	4	0	4	8	0	0
8	26234123	.	T	A	3	5	8	0	0	9	1	0
8	26234563	.	G	A	6	4	10	0	1	11	0	0
8	26234599	.	A	T	4	4	8	0	0	8	0	0
8	26235117	.	A	C	6	2	8	0	0	8	0	0
8	26239871	.	T	G	7	0	7	0	7	14	0	0
8	26239916	.	G	A	1	7	8	0	9	17	0	0
8	26239919	.	T	A	10	7	17	0	1	18	0	0
8	26240007	.	C	T	11	4	15	0	0	15	0	0
8	26240047	.	T	G	7	4	11	0	0	11	0	0
8	26240196	.	C	T	5	6	11	0	3	14	0	0
8	26240249	.	A	G	3	0	3	0	5	8	0	0
8	26240346	.	G	A	1	2	3	0	2	5	0	0
8	26240348	.	A	T	3	2	5	0	0	5	0	0
8	26292594	.	G	T	5	11	16	0	0	16	0	0
8	26293930	.	C	T	16	8	24	0	1	25	0	0
8	26323893	.	A	T	7	9	16	0	0	16	0	0
8	26324620	.	C	T	12	9	21	0	0	21	0	0
8	26324647	.	A	T	15	13	28	0	1	29	0	0
8	26324683	.	C	T	15	12	27	0	1	28	0	0
8	26324709	.	T	C	19	11	30	0	0	30	0	0
8	26324773	.	T	C	10	18	28	0	3	31	0	0
8	26324905	.	A	G	14	17	31	0	0	31	0	0
8	26325332	.	T	A	23	22	45	0	1	46	0	0
8	26325333	.	A	T	22	23	45	0	1	46	0	0
8	26325519	.	A	T	21	11	32	0	3	35	0	0
8	26325600	.	T	C	18	18	36	0	1	37	0	0
8	26325679	.	C	T	25	14	39	0	2	41	0	0
8	26326046	.	G	A	15	24	39	0	4	43	0	0
8	26326152	.	T	C	20	28	48	0	1	49	0	0
8	26330006	.	G	A	14	15	29	0	0	29	0	0
8	26330047	.	A	C	13	16	29	0	1	30	0	0
8	26330134	.	A	T	9	9	18	0	2	20	0	0
8	26330190	.	T	C	6	14	20	0	1	21	0	0
8	26357826	.	A	G	15	18	33	0	1	34	0	0
8	26367891	.	T	G	28	20	48	0	2	50	0	0
8	26368025	.	C	T	26	17	43	4	0	47	0	0
8	26368150	.	C	T	35	18	53	0	1	54	0	0
8	26368171	.	T	C	27	24	51	0	1	52	0	0
8	26368446	.	A	T	7	12	19	0	0	19	0	0
8	26383055	.	T	C	1	2	3	0	0	3	0	0
8	26383057	.	C	T	0	2	2	0	1	3	0	0
8	26386342	.	T	G	3	3	6	0	0	6	0	0
8	26386346	.	C	T	3	3	6	0	0	6	0	0
8	26410472	.	G	C	7	5	12	0	0	12	0	0
8	26424873	.	A	G	8	6	14	0	0	14	0	0
8	26426163	.	T	C	8	9	17	0	1	18	0	0
8	26426596	.	T	G	8	10	18	0	0	18	0	0
8	26426621	.	C	T	8	5	13	0	0	13	0	0
8	26426771	.	C	T	4	8	12	0	0	12	0	0
8	26426978	.	A	C	7	3	10	0	1	11	0	0
8	26427081	.	C	T	11	6	17	0	0	17	0	0
8	26427125	.	C	T	5	4	9	0	0	9	0	0
8	26427132	.	C	A	5	4	9	0	1	10	0	0
8	26433541	.	T	C	2	3	5	0	1	6	0	0
8	26436030	.	A	G	5	7	12	0	1	13	0	0
8	26438912	.	A	G	6	5	11	0	0	11	0	0
8	26439041	.	A	C	2	8	10	0	0	10	0	0
8	26439046	.	A	G	2	8	10	0	0	10	0	0
8	26439101	.	G	T	3	3	6	0	0	6	0	0
8	26444701	.	T	C	6	2	8	0	0	8	0	0
8	26444741	.	T	C	2	6	8	0	1	9	0	0
8	26444759	.	A	T	1	6	7	0	0	7	0	0
8	26445075	.	T	C	4	6	10	0	0	10	0	0
8	26445100	.	G	T	3	7	10	0	0	10	0	0
8	26445119	.	A	G	3	4	7	0	1	8	0	0
8	26445157	.	A	C	3	2	5	0	1	6	0	0
8	26445184	.	A	T	5	3	8	0	0	8	0	0
8	26447468	.	G	A	3	5	8	0	0	8	0	0
8	26449383	.	G	A	2	2	4	0	0	4	0	0
8	26565293	.	A	C	2	2	4	0	1	5	0	0
8	26565503	.	C	A	1	3	4	0	0	4	0	0
8	26571179	.	C	G	3	2	5	0	1	6	0	0
8	26571193	.	G	T	4	2	6	0	0	6	0	0
8	26572943	.	T	C	2	3	5	0	0	5	0	0
8	26573009	.	T	C	8	4	12	0	0	12	0	0
8	26573030	.	G	A	2	5	7	0	5	12	0	0
8	26573066	.	T	A	5	4	9	0	0	9	0	0
8	26573075	.	A	C	6	3	9	0	0	9	0	0
8	26573243	.	T	C	2	4	6	0	0	6	0	0
8	26573365	.	T	C	5	2	7	0	0	7	0	0
8	26573454	.	G	A	0	3	3	0	3	6	0	0
8	26573519	.	T	C	1	4	5	0	0	5	0	0
8	26573622	.	G	A	3	3	6	0	0	6	0	0
8	26573837	.	A	C	4	3	7	0	0	7	0	0
8	26573839	.	T	C	4	3	7	0	0	7	0	0
8	26586558	.	G	A	13	10	23	0	1	24	0	0
8	26586634	.	A	C	12	10	22	0	0	22	0	0
8	26586900	.	G	T	14	10	24	0	0	25	1	0
8	26587137	.	C	G	8	6	14	0	0	14	0	0
8	26587164	.	G	A	7	3	10	0	0	10	0	0
8	26587323	.	G	A	13	5	18	0	0	18	0	0
8	26587380	.	G	A	10	11	21	0	0	21	0	0
8	26587447	.	C	T	1	8	9	0	8	17	0	0
8	26591336	.	G	A	3	3	6	0	0	6	0	0
8	26594082	.	A	G	4	3	7	0	0	7	0	0
8	26607064	.	A	C	5	0	5	0	4	9	0	0
8	26609170	.	C	G	1	2	3	0	0	3	0	0
8	26701774	.	A	T	1	2	3	0	0	3	0	0
8	26709844	.	T	C	4	5	9	0	0	9	0	0
8	26709876	.	A	T	4	8	12	0	0	12	0	0
8	26714641	.	G	T	3	2	5	0	0	5	0	0
8	26716404	.	C	T	6	2	8	0	0	8	0	0
8	26731764	.	A	C	10	5	15	0	0	15	0	0
8	26731866	.	T	G	10	5	15	0	0	15	0	0
8	26746173	.	C	T	14	7	21	0	1	22	0	0
8	26792738	.	T	A	9	4	13	0	0	13	0	0
8	26792849	.	A	G	11	10	21	0	3	24	0	0
8	26830994	.	T	A	2	5	7	0	0	7	0	0
8	26838036	.	A	G	1	3	4	0	0	4	0	0
8	26838547	.	C	T	3	9	12	0	0	12	0	0
8	26860307	.	A	G	5	3	8	0	0	8	0	0
8	26860359	.	G	T	6	7	13	0	1	14	0	0
8	26860430	.	C	T	5	6	11	0	0	11	0	0
8	26860493	.	A	C	5	5	10	0	0	10	0	0
8	26860511	.	T	C	6	5	11	0	0	11	0	0
8	26860600	.	G	T	3	4	7	0	1	8	0	0
8	26860778	.	T	C	3	5	8	0	2	10	0	0
8	26860779	.	G	A	4	5	9	0	1	10	0	0
8	26860909	.	T	C	4	4	8	0	1	9	0	0
8	26861145	.	A	G	11	12	23	0	2	25	0	0
8	26861248	.	G	T	10	10	20	0	3	23	0	0
8	26861434	.	G	A	5	8	13	0	0	13	0	0
8	26861653	.	T	C	8	4	12	0	0	12	0	0
8	26861760	.	C	A	3	9	12	0	0	12	0	0
8	26862002	.	A	C	17	6	23	0	1	24	0	0
8	26862526	.	C	A	11	6	17	0	0	17	0	0
8	26863804	.	C	A	9	9	18	0	2	20	0	0
8	26864121	.	A	G	17	8	25	0	1	26	0	0
8	26864150	.	G	C	19	8	27	0	0	27	0	0
8	26864195	.	G	C	14	15	29	0	0	29	0	0
8	26868418	.	T	C	17	23	40	0	0	40	0	0
8	26881205	.	T	G	28	0	28	0	23	51	0	0
8	26884298	.	T	C	21	19	40	0	2	42	0	0
8	26884313	.	A	G	22	21	43	0	1	44	0	0
8	26884619	.	C	T	33	25	58	0	2	60	0	0
8	26884767	.	C	T	25	25	50	0	2	52	0	0
8	26884903	.	T	A	20	21	41	0	0	41	0	0
8	26885382	.	C	A	21	19	40	0	3	43	0	0
8	26886025	.	C	T	23	16	39	0	2	41	0	0
8	26886177	.	T	C	27	12	39	0	2	41	0	0
8	26886259	.	A	G	13	23	36	0	2	38	0	0
8	26886399	.	C	G	29	24	53	0	2	55	0	0
8	26886667	.	T	A	28	28	56	0	2	60	2	0
8	26886766	.	T	C	30	21	51	0	1	52	0	0
8	26886972	.	A	T	17	23	40	0	4	44	0	0
8	26887013	.	T	C	21	16	37	0	0	37	0	0
8	26887122	.	A	C	13	13	26	0	1	27	0	0
8	26887240	.	G	A	1	8	9	0	5	14	0	0
8	27361846	.	G	A	9	4	13	0	0	13	0	0
8	27362288	.	C	G	9	5	14	0	1	15	0	0
8	27515239	.	T	C	7	7	14	0	3	17	0	0
8	27623973	.	A	G	22	2	24	0	12	36	0	0
8	27624026	.	T	A	25	17	42	0	1	43	0	0
8	27624027	.	T	C	24	17	41	0	1	42	0	0
8	27624222	.	T	C	4	4	8	0	0	8	0	0
8	27624255	.	A	T	1	3	4	0	0	4	0	0
8	27813611	.	C	A	12	14	26	0	3	29	0	0
8	27816560	.	C	A	29	20	49	0	6	55	0	0
8	27816680	.	C	T	16	21	37	0	2	39	0	0
8	27823634	.	A	G	1	4	5	0	0	5	0	0
8	27858407	.	C	T	1	2	3	0	0	3	0	0
8	28399129	.	G	A	7	7	14	0	0	14	0	0
8	28868245	.	T	C	6	3	9	0	0	9	0	0
8	28868416	.	G	A	2	6	8	0	6	14	0	0
8	28868425	.	G	A	9	6	15	0	0	15	0	0
8	28901165	.	C	T	3	6	9	0	0	9	0	0
8	28901170	.	C	A	6	2	8	0	0	8	0	0
8	28982606	.	G	A	10	5	15	0	0	15	0	0
8	29285574	.	T	C	5	10	15	0	0	15	0	0
8	29285661	.	C	T	13	9	22	0	1	23	0	0
8	29336828	.	C	T	7	8	15	0	2	17	0	0
8	29427894	.	C	T	13	8	21	0	1	22	0	0
8	29427954	.	T	C	7	8	15	0	2	18	1	0
8	29428042	.	C	A	7	11	18	0	1	19	0	0
8	29428071	.	G	A	2	6	8	1	11	20	0	0
8	29428110	.	C	T	9	10	19	1	2	22	0	0
8	29476190	.	T	C	6	12	18	0	0	18	0	0
8	29574985	.	C	A	15	13	28	0	4	32	0	0
8	29587262	.	C	A	19	15	34	0	1	35	0	0
8	29587431	.	A	C	3	1	4	0	14	18	0	0
8	29587500	.	C	A	16	9	25	0	2	27	0	0
8	29587651	.	C	T	12	10	22	0	1	23	0	0
8	29636210	.	A	G	1	0	1	0	2	3	0	0
8	29636980	.	C	T	3	5	8	0	0	8	0	0
8	29644195	.	G	A	4	2	6	0	2	8	0	0
8	29644791	.	G	A	3	2	5	0	0	5	0	0
8	29644838	.	T	A	2	3	5	0	0	5	0	0
8	29644845	.	C	T	4	2	6	0	0	6	0	0
8	29645127	.	G	A	2	7	9	0	0	9	0	0
8	29647473	.	G	T	5	3	8	0	0	8	0	0
8	29647488	.	A	T	4	4	8	0	0	8	0	0
8	29647748	.	T	C	1	5	6	0	0	6	0	0
8	29651670	.	G	A	8	3	11	0	0	11	0	0
8	29651951	.	A	G	6	9	15	0	1	16	0	0
8	29652100	.	A	G	9	1	10	0	3	13	0	0
8	29652143	.	A	G	4	5	9	0	0	9	0	0
8	29652174	.	G	A	4	5	9	0	0	9	0	0
8	29710502	.	T	C	2	2	4	0	0	4	0	0
8	29710509	.	T	C	3	2	5	0	0	5	0	0
8	29710752	.	C	T	4	3	7	0	0	7	0	0
8	29710888	.	A	G	4	3	7	0	0	7	0	0
8	29710891	.	C	T	4	3	7	0	0	7	0	0
8	29710966	.	A	C	1	3	4	0	0	4	0	0
8	29719073	.	G	T	1	3	4	0	0	4	0	0
8	29719149	.	A	G	3	6	9	0	0	9	0	0
8	29719306	.	C	T	4	5	9	0	0	9	0	0
8	29742498	.	A	G	1	4	5	0	0	5	0	0
8	29749112	.	T	G	4	6	10	0	0	10	0	0
8	29749346	.	C	T	2	2	4	0	0	4	0	0
8	29759726	.	A	C	2	4	6	0	0	6	0	0
8	29763480	.	C	T	9	8	17	0	0	17	0	0
8	29763812	.	G	C	7	5	12	0	0	12	0	0
8	29763822	.	A	G	6	0	6	0	5	11	0	0
8	29764138	.	C	T	5	4	9	0	0	9	0	0
8	29764150	.	A	T	6	3	9	0	0	9	0	0
8	29764585	.	G	A	3	2	5	0	0	5	0	0
8	29764968	.	T	C	4	4	8	0	1	9	0	0
8	29765045	.	C	T	1	3	4	0	0	4	0	0
8	29765178	.	C	T	2	4	6	0	0	6	0	0
8	29765379	.	T	A	4	2	6	0	0	6	0	0
8	29765414	.	A	G	3	2	5	0	0	5	0	0
8	29765429	.	C	A	1	2	3	0	1	4	0	0
8	29765824	.	T	C	1	3	4	0	0	4	0	0
8	29766167	.	T	G	2	5	7	0	0	7	0	0
8	29766516	.	T	C	1	2	3	0	1	4	0	0
8	29770371	.	T	A	29	34	63	0	2	65	0	0
8	29773127	.	T	A	7	12	19	0	1	20	0	0
8	29774042	.	C	G	1	18	19	0	15	34	0	0
8	29774428	.	T	A	6	12	18	0	2	20	0	0
8	29793782	.	A	G	9	9	18	0	1	19	0	0
8	29799168	.	C	T	5	12	17	0	18	35	0	0
8	29799360	.	G	A	11	5	16	0	4	20	0	0
8	29799627	.	G	A	20	13	33	0	4	37	0	0
8	29801150	.	C	G	20	16	36	0	0	36	0	0
8	29801291	.	C	T	7	7	14	0	1	15	0	0
8	29806615	.	G	A	7	12	19	0	2	21	0	0
8	29819317	.	G	A	8	10	18	0	0	18	0	0
8	29819419	.	T	C	6	0	6	0	5	11	0	0
8	29819431	.	G	A	8	3	11	0	0	11	0	0
8	29819604	.	C	T	0	6	6	0	3	9	0	0
8	29819610	.	C	T	3	5	8	0	1	9	0	0
8	29851592	.	T	G	9	5	14	0	0	14	0	0
8	29864654	.	A	G	3	2	5	0	0	5	0	0
8	29871800	.	T	C	3	2	5	0	0	5	0	0
8	29898834	.	T	C	2	0	2	0	5	7	0	0
8	29899087	.	G	C	3	0	3	0	3	6	0	0
8	29899209	.	T	C	7	4	11	0	1	12	0	0
8	29899248	.	T	C	5	4	9	0	0	9	0	0
8	29899302	.	C	T	0	4	4	0	6	10	0	0
8	29899318	.	T	C	4	3	7	0	0	7	0	0
8	29902904	.	T	C	3	4	7	0	0	7	0	0
8	29904855	.	T	C	3	4	7	0	0	7	0	0
8	29904949	.	G	T	4	2	6	0	1	7	0	0
8	29907311	.	C	G	5	2	7	0	0	7	0	0
8	29907414	.	C	A	4	5	9	0	0	9	0	0
8	29907494	.	A	G	1	3	4	0	0	4	0	0
8	29907560	.	C	G	3	3	6	0	0	6	0	0
8	29907621	.	G	A	4	2	6	0	0	6	0	0
8	29963111	.	C	T	1	3	4	0	0	4	0	0
8	30016948	.	C	T	2	3	5	0	0	5	0	0
8	30021383	.	C	T	3	3	6	0	0	6	0	0
8	30021416	.	A	G	4	0	4	0	4	8	0	0
8	30022126	.	G	C	3	2	5	0	0	5	0	0
8	30022393	.	G	T	2	2	4	0	0	4	0	0
8	30025143	.	T	A	4	3	7	0	0	7	0	0
8	30025145	.	G	A	0	3	3	0	4	7	0	0
8	30038883	.	G	A	1	5	6	0	0	6	0	0
8	30062679	.	A	G	4	4	8	0	0	8	0	0
8	30063320	.	T	C	4	6	10	0	0	10	0	0
8	30155860	.	C	T	1	2	3	0	0	3	0	0
8	30326228	.	G	A	8	7	15	1	0	17	1	0
8	30330694	.	A	T	4	5	9	0	0	9	0	0
8	30338875	.	C	G	4	6	10	0	0	10	0	0
8	30338887	.	G	A	7	5	12	0	0	12	0	0
8	30338926	.	C	T	6	9	15	0	0	15	0	0
8	30356647	.	G	A	4	3	7	0	1	8	0	0
8	30358354	.	G	A	3	5	8	0	1	9	0	0
8	30358397	.	T	G	2	3	5	0	0	5	0	0
8	30359873	.	C	A	5	7	12	0	0	12	0	0
8	30359887	.	G	T	5	7	12	0	0	12	0	0
8	30359978	.	C	T	0	4	4	0	3	7	0	0
8	30374425	.	A	G	1	4	5	0	0	5	0	0
8	30378051	.	G	C	2	4	6	0	1	7	0	0
8	30395862	.	T	C	1	0	1	0	2	3	0	0
8	30425782	.	G	C	8	13	21	0	1	22	0	0
8	30437538	.	T	C	11	7	18	0	0	18	0	0
8	30501214	.	C	T	2	2	4	0	0	4	0	0
8	30501850	.	T	C	3	2	5	0	0	5	0	0
8	30502189	.	G	A	0	2	2	0	2	4	0	0
8	30502482	.	G	C	3	4	7	0	0	7	0	0
8	30502483	.	T	A	2	4	6	0	1	7	0	0
8	30560867	.	C	T	6	6	12	0	0	12	0	0
8	30570193	.	G	T	1	4	5	0	0	5	0	0
8	30570483	.	T	C	9	4	13	0	0	13	0	0
8	30575832	.	C	T	5	3	8	0	0	8	0	0
8	30576118	.	G	A	7	3	10	0	0	10	0	0
8	30590805	.	A	G	3	4	7	0	0	7	0	0
8	30593567	.	G	A	9	4	13	0	0	13	0	0
8	30619922	.	G	A	2	4	6	0	1	7	0	0
8	30620073	.	C	T	4	3	7	0	1	8	0	0
8	30621203	.	A	T	2	5	7	0	0	7	0	0
8	30623994	.	C	T	6	4	10	0	0	10	0	0
8	30631057	.	C	T	7	7	14	0	0	14	0	0
8	30661270	.	C	T	8	9	17	0	1	18	0	0
8	30661565	.	A	G	16	0	16	0	9	25	0	0
8	30661645	.	G	A	7	11	18	0	1	19	0	0
8	30662366	.	A	T	5	3	8	0	1	9	0	0
8	30662481	.	T	C	11	11	22	0	0	22	0	0
8	30662505	.	A	T	9	8	17	0	0	17	0	0
8	30662713	.	C	T	5	4	9	0	0	9	0	0
8	30731187	.	A	G	5	5	10	0	0	10	0	0
8	30731492	.	C	T	1	3	4	0	0	4	0	0
8	30731535	.	A	T	1	2	3	0	1	4	0	0
8	30731791	.	T	A	6	3	9	0	0	9	0	0
8	30735082	.	T	A	7	9	16	0	0	16	0	0
8	30742022	.	C	A	2	3	5	0	6	11	0	0
8	30742130	.	C	T	1	7	8	0	3	11	0	0
8	30743321	.	T	C	4	6	10	0	1	11	0	0
8	30743345	.	A	G	8	6	14	0	0	14	0	0
8	30744468	.	G	A	0	9	9	0	7	16	0	0
8	30744528	.	C	T	10	6	16	0	0	16	0	0
8	30745437	.	A	G	2	6	8	0	0	8	0	0
8	30778415	.	C	A	5	4	9	1	0	10	0	0
8	30778455	.	G	A	1	2	3	2	0	5	0	0
8	30979363	.	T	C	1	7	8	0	0	8	0	0
8	31119730	.	A	G	14	5	19	0	0	19	0	0
8	31119865	.	T	C	13	11	24	0	0	24	0	0
8	31119909	.	T	G	8	1	9	0	15	24	0	0
8	31123029	.	T	C	16	19	35	0	0	35	0	0
8	31131079	.	G	A	11	25	36	0	3	39	0	0
8	31131277	.	A	G	19	24	43	0	0	44	1	0
8	31131394	.	A	C	22	9	31	0	2	33	0	0
8	31142074	.	G	A	28	19	47	0	9	56	0	0
8	31146748	.	G	A	25	18	43	0	1	44	0	0
8	31146913	.	G	A	21	20	41	0	1	42	0	0
8	31147380	.	T	G	22	20	42	0	0	42	0	0
8	31147526	.	G	A	25	19	44	0	0	44	0	0
8	31249605	.	A	G	14	12	26	0	0	26	0	0
8	31249881	.	T	A	15	8	23	0	0	23	0	0
8	31249941	.	T	A	15	4	19	1	2	22	0	0
8	31250183	.	C	A	16	17	33	0	3	36	0	0
8	31250357	.	A	G	13	2	15	0	10	25	0	0
8	31250384	.	T	G	16	10	26	0	0	26	0	0
8	31251091	.	A	G	21	10	31	0	1	32	0	0
8	31251129	.	G	A	16	16	32	0	2	34	0	0
8	31251222	.	T	C	17	20	37	0	0	37	0	0
8	31251354	.	T	C	17	14	31	0	2	33	0	0
8	31251426	.	T	C	18	18	36	0	1	37	0	0
8	31251510	.	C	A	16	22	38	0	1	39	0	0
8	31251555	.	G	A	1	26	27	0	16	43	0	0
8	31251792	.	G	C	0	19	19	0	24	43	0	0
8	31253722	.	T	C	9	15	24	0	0	24	0	0
8	31254046	.	C	A	16	12	28	5	1	34	0	0
8	31254176	.	A	T	23	21	44	0	0	45	1	0
8	31254219	.	T	C	18	14	32	0	1	33	0	0
8	31367747	.	T	C	2	6	8	0	0	8	0	0
8	31368010	.	G	A	22	28	50	0	0	50	0	0
8	31368279	.	T	G	8	12	20	0	0	20	0	0
8	31368524	.	C	T	22	7	29	0	1	30	0	0
8	31368557	.	A	G	15	11	26	0	0	26	0	0
8	31368611	.	T	C	12	8	20	0	0	20	0	0
8	31368889	.	C	T	13	11	24	0	0	24	0	0
8	31369071	.	G	C	12	13	25	0	0	25	0	0
8	31375338	.	T	C	6	5	11	0	0	11	0	0
8	31375400	.	C	T	5	9	14	0	1	15	0	0
8	31375405	.	T	C	5	8	13	0	0	13	0	0
8	31375529	.	T	C	14	16	30	0	1	31	0	0
8	31375549	.	C	T	15	11	26	1	2	29	0	0
8	31375670	.	T	G	7	26	33	0	1	34	0	0
8	31375928	.	A	G	9	8	17	0	1	18	0	0
8	31375988	.	A	G	3	3	6	0	0	6	0	0
8	31379542	.	C	T	3	10	13	0	12	25	0	0
8	31387695	.	A	G	7	5	12	0	0	12	0	0
8	31387728	.	T	G	7	4	11	0	0	11	0	0
8	31390061	.	T	C	10	8	18	0	0	18	0	0
8	31393235	.	G	A	4	3	7	0	0	7	0	0
8	31393376	.	G	A	5	6	11	0	0	11	0	0
8	31395397	.	C	T	3	2	5	0	0	5	0	0
8	31395400	.	C	T	0	2	2	0	3	5	0	0
8	31395471	.	A	G	2	3	5	0	1	6	0	0
8	31395632	.	A	C	3	6	9	0	0	9	0	0
8	31400775	.	A	G	3	4	7	0	0	7	0	0
8	31406847	.	G	C	8	0	8	0	7	15	0	0
8	31407126	.	A	T	11	9	20	0	0	20	0	0
8	31407153	.	C	T	16	6	22	0	0	22	0	0
8	31407294	.	A	G	8	15	23	0	0	23	0	0
8	31411089	.	C	T	0	8	8	0	8	16	0	0
8	31411578	.	G	A	15	6	21	0	0	21	0	0
8	31411646	.	T	A	11	7	18	0	0	18	0	0
8	31437497	.	G	C	29	25	54	0	0	54	0	0
8	31437611	.	C	T	19	37	56	0	2	58	0	0
8	31437768	.	C	G	35	26	61	0	4	65	0	0
8	31441698	.	C	A	30	27	57	0	1	58	0	0
8	31441724	.	G	T	33	30	63	0	1	64	0	0
8	31441733	.	C	A	34	31	65	0	1	66	0	0
8	31441850	.	T	C	43	22	65	0	3	68	0	0
8	31442000	.	G	A	33	26	59	0	5	64	0	0
8	31442595	.	G	A	27	23	50	0	2	52	0	0
8	31442886	.	T	C	40	20	60	0	0	60	0	0
8	31443023	.	A	C	30	31	61	1	4	66	0	0
8	31705267	.	G	A	21	23	44	0	2	46	0	0
8	31710941	.	G	A	15	12	27	0	1	28	0	0
8	31711411	.	T	C	13	0	13	0	14	27	0	0
8	31730813	.	A	C	12	16	28	0	1	29	0	0
8	31756640	.	A	G	17	16	33	0	1	34	0	0
8	31760785	.	C	T	17	18	35	0	0	35	0	0
8	31764858	.	G	A	11	17	28	0	2	30	0	0
8	31817931	.	A	C	13	19	32	0	1	34	1	0
8	31818018	.	T	C	19	15	34	0	0	34	0	0
8	31818022	.	G	A	1	16	17	0	20	37	0	0
8	31818083	.	A	T	19	15	34	0	1	35	0	0
8	31818196	.	G	A	29	19	48	0	1	49	0	0
8	31818267	.	T	G	9	24	33	0	0	33	0	0
8	31818273	.	T	A	9	21	30	0	1	31	0	0
8	31818335	.	G	A	13	7	20	0	3	23	0	0
8	31818349	.	A	C	13	8	21	0	2	23	0	0
8	31818549	.	C	T	4	7	11	0	0	11	0	0
8	31818748	.	T	C	9	12	21	0	0	21	0	0
8	31818800	.	G	A	9	7	16	0	0	16	0	0
8	31818835	.	T	G	12	9	21	0	0	21	0	0
8	31850955	.	A	T	22	16	38	0	0	38	0	0
8	31850976	.	G	T	19	14	33	0	2	35	0	0
8	31851150	.	A	C	14	8	22	0	1	23	0	0
8	31851270	.	G	A	11	9	20	0	0	20	0	0
8	31851333	.	G	T	11	15	26	0	1	27	0	0
8	31851336	.	A	G	13	17	30	0	0	30	0	0
8	31851582	.	A	G	14	21	35	0	2	37	0	0
8	31851594	.	T	C	16	22	38	0	1	39	0	0
8	31861425	.	A	G	15	18	33	0	1	34	0	0
8	31861580	.	G	A	20	16	36	0	1	37	0	0
8	31861616	.	T	A	15	15	30	0	2	32	0	0
8	31861746	.	C	T	21	10	31	0	1	32	0	0
8	31862063	.	T	C	21	21	42	0	0	42	0	0
8	31862179	.	A	G	21	22	43	0	1	44	0	0
8	31862312	.	G	A	5	20	25	0	25	50	0	0
8	31862584	.	G	T	15	15	30	0	0	30	0	0
8	31862846	.	T	A	8	2	10	1	0	11	0	0
8	31862848	.	C	A	7	2	9	1	0	10	0	0
8	31893747	.	T	C	1	2	3	0	0	3	0	0
8	31901757	.	T	C	9	4	13	0	1	14	0	0
8	31901760	.	C	T	10	4	14	0	0	14	0	0
8	31901925	.	G	A	6	16	22	0	1	23	0	0
8	31906886	.	G	A	15	10	25	0	3	28	0	0
8	31906910	.	C	A	20	12	32	0	0	32	0	0
8	31906927	.	G	A	19	14	33	0	0	33	0	0
8	31919110	.	A	C	13	0	13	0	11	24	0	0
8	31919526	.	C	A	10	10	20	0	1	21	0	0
8	31919558	.	A	C	12	18	30	1	0	31	0	0
8	31941679	.	C	T	3	4	7	0	0	7	0	0
8	31941746	.	C	A	7	7	14	0	1	15	0	0
8	31941853	.	C	T	8	5	13	0	1	14	0	0
8	31941904	.	T	A	5	3	8	0	1	9	0	0
8	31942771	.	C	T	5	9	14	0	0	14	0	0
8	31943276	.	G	A	4	5	9	0	1	10	0	0
8	31943301	.	T	G	6	3	9	0	0	9	0	0
8	32028856	.	G	T	5	3	8	0	0	8	0	0
8	32028921	.	T	A	3	2	5	0	2	7	0	0
8	32029044	.	T	G	7	7	14	0	0	14	0	0
8	32029258	.	T	C	9	6	15	0	1	16	0	0
8	32029481	.	A	G	3	2	5	0	0	5	0	0
8	32029692	.	T	C	4	2	6	0	0	6	0	0
8	32029810	.	G	C	5	2	7	0	0	7	0	0
8	32029843	.	T	C	4	4	8	0	0	8	0	0
8	32029881	.	G	T	1	3	4	0	0	4	0	0
8	32029882	.	A	T	1	3	4	0	0	4	0	0
8	32030087	.	G	A	5	3	8	0	1	9	0	0
8	32030107	.	G	A	4	6	10	0	0	10	0	0
8	32030147	.	T	C	2	3	5	0	0	5	0	0
8	32030341	.	A	G	9	7	16	0	0	16	0	0
8	32030538	.	G	A	2	4	6	0	0	6	0	0
8	32030771	.	T	G	3	9	12	0	0	12	0	0
8	32191744	.	G	A	6	4	10	0	0	10	0	0
8	32247811	.	T	C	1	4	5	0	0	5	0	0
8	32270345	.	T	C	4	0	4	0	3	7	0	0
8	32278309	.	G	C	4	3	7	0	0	7	0	0
8	32377563	.	C	T	2	2	4	0	0	4	0	0
8	32483905	.	G	C	14	21	35	0	1	36	0	0
8	32486956	.	C	T	2	16	18	0	11	29	0	0
8	32497755	.	T	C	6	4	10	0	3	13	0	0
8	32501429	.	T	G	3	4	7	0	0	7	0	0
8	32501541	.	A	G	3	7	10	0	0	10	0	0
8	32502932	.	C	T	5	6	11	0	0	11	0	0
8	32506134	.	T	C	6	4	10	0	0	10	0	0
8	32506175	.	G	T	4	3	7	0	3	10	0	0
8	32506215	.	T	C	7	0	7	0	7	14	0	0
8	32516296	.	A	G	12	8	20	0	0	20	0	0
8	32577794	.	G	A	8	7	15	0	0	15	0	0
8	32588542	.	G	T	0	2	2	0	5	7	0	0
8	32598954	.	A	G	8	13	21	1	0	22	0	0
8	32598963	.	C	G	7	0	7	1	15	23	0	0
8	32599147	.	G	A	13	6	19	0	1	20	0	0
8	32599288	.	T	C	4	5	9	0	1	10	0	0
8	32599295	.	A	G	5	4	9	0	0	9	0	0
8	32599413	.	T	C	9	7	16	0	0	16	0	0
8	32599586	.	C	T	3	11	14	0	2	16	0	0
8	32599795	.	G	A	3	3	6	0	0	6	0	0
8	32914931	.	T	C	8	3	11	0	2	13	0	0
8	32949287	.	C	T	1	10	11	0	12	23	0	0
8	33114094	.	T	A	5	14	19	0	0	19	0	0
8	33133616	.	G	A	3	4	7	0	0	7	0	0
8	33261014	.	T	A	2	3	5	0	1	6	0	0
8	33261068	.	G	T	3	2	5	0	0	5	0	0
8	33896450	.	A	G	10	8	18	0	3	21	0	0
8	33896524	.	G	T	16	15	31	0	0	31	0	0
8	33896585	.	C	T	27	19	46	0	1	47	0	0
8	33896698	.	A	G	18	22	40	0	2	42	0	0
8	33896902	.	G	A	23	22	45	0	1	46	0	0
8	33896964	.	T	G	24	16	40	0	1	41	0	0
8	33897266	.	T	C	17	0	17	0	29	46	0	0
8	33910017	.	G	A	34	26	60	3	5	68	0	0
8	33918520	.	C	T	19	21	40	0	2	42	0	0
8	33924284	.	A	G	14	27	41	0	3	44	0	0
8	33924333	.	G	T	24	20	44	0	1	45	0	0
8	34051619	.	G	T	23	14	37	0	0	37	0	0
8	34051719	.	G	A	17	19	36	0	0	36	0	0
8	34051850	.	G	A	16	16	32	0	1	33	0	0
8	34342146	.	G	A	19	10	29	0	0	29	0	0
8	34342214	.	A	T	14	13	27	0	0	27	0	0
8	34342462	.	A	G	13	6	19	3	2	24	0	0
8	34345285	.	G	A	17	12	29	0	3	32	0	0
8	34345372	.	T	C	14	10	24	0	1	25	0	0
8	34345390	.	A	G	13	14	27	0	0	27	0	0
8	34345583	.	A	G	9	10	19	0	1	20	0	0
8	34347281	.	T	C	10	19	29	0	4	33	0	0
8	34348958	.	A	C	2	5	7	0	0	7	0	0
8	34376264	.	G	A	4	3	7	0	0	7	0	0
8	34376728	.	G	A	7	6	13	0	0	13	0	0
8	34390998	.	C	T	0	5	5	0	4	9	0	0
8	34394570	.	G	A	5	6	11	0	0	11	0	0
8	34397046	.	C	T	3	6	9	0	4	13	0	0
8	35357789	.	G	A	1	2	3	0	0	3	0	0
8	35580986	.	C	T	1	4	5	0	1	6	0	0
8	35703841	.	C	A	1	3	4	0	1	5	0	0
8	35759213	.	G	C	5	5	10	0	0	10	0	0
8	35759363	.	T	G	3	4	7	0	0	7	0	0
8	35759402	.	C	T	4	2	6	0	0	6	0	0
8	35759444	.	C	T	1	2	3	0	0	3	0	0
8	35759999	.	C	T	6	4	10	0	0	10	0	0
8	35760218	.	C	T	5	5	10	0	1	11	0	0
8	35809374	.	C	T	1	2	3	1	0	4	0	0
8	35809375	.	A	G	1	2	3	1	0	4	0	0
8	35810115	.	T	C	1	0	1	0	4	5	0	0
8	35950512	.	C	T	2	2	4	0	0	4	0	0
8	35950515	.	G	A	2	2	4	0	0	4	0	0
8	35964671	.	C	T	3	4	7	0	0	7	0	0
8	35970250	.	C	T	2	2	4	0	0	4	0	0
8	36058873	.	T	A	7	3	10	0	0	10	0	0
8	36058882	.	A	C	7	2	9	0	1	10	0	0
8	36061619	.	G	A	2	4	6	0	0	6	0	0
8	36062618	.	G	C	0	2	2	0	1	3	0	0
8	36062629	.	C	T	2	2	4	0	0	4	0	0
8	36468769	.	A	T	8	3	11	0	1	12	0	0
8	36473141	.	G	T	17	6	23	0	2	25	0	0
8	36473144	.	A	G	18	7	25	0	1	26	0	0
8	36473361	.	A	T	4	17	21	0	1	22	0	0
8	36474411	.	A	G	11	18	29	0	0	29	0	0
8	36504059	.	A	G	1	0	1	0	4	5	0	0
8	36504089	.	T	C	2	4	6	0	0	6	0	0
8	36504185	.	T	C	3	2	5	0	0	5	0	0
8	36504620	.	A	G	3	5	8	0	0	8	0	0
8	36507344	.	C	T	5	6	11	0	0	11	0	0
8	36507449	.	T	C	1	7	8	0	0	8	0	0
8	36507470	.	C	T	4	5	9	0	0	9	0	0
8	36512804	.	G	A	1	3	4	0	2	6	0	0
8	36512981	.	A	C	2	6	8	0	0	8	0	0
8	36512982	.	T	C	2	5	7	0	1	8	0	0
8	36515779	.	G	A	1	4	5	0	7	12	0	0
8	36547029	.	T	A	2	3	5	0	0	5	0	0
8	36560180	.	C	T	23	9	32	0	2	34	0	0
8	36561942	.	A	T	16	5	21	0	4	27	2	0
8	36562262	.	T	C	25	9	34	0	0	34	0	0
8	36562293	.	C	T	23	12	35	0	1	36	0	0
8	36564005	.	A	G	20	8	28	0	2	30	0	0
8	36564746	.	C	T	4	7	11	1	5	17	0	0
8	36564760	.	T	C	3	1	4	1	8	13	0	0
8	36566125	.	C	T	30	9	39	0	1	40	0	0
8	36566167	.	G	A	30	10	40	0	0	40	0	0
8	36566182	.	T	C	30	9	39	0	0	39	0	0
8	36566353	.	T	C	17	14	31	0	1	32	0	0
8	36567283	.	C	T	26	13	39	0	4	43	0	0
8	36568561	.	A	G	13	15	28	0	0	28	0	0
8	36568755	.	T	C	16	13	29	0	0	29	0	0
8	36569810	.	T	C	18	7	25	0	1	26	0	0
8	36569924	.	C	A	12	4	16	0	2	18	0	0
8	36569925	.	T	A	11	6	17	0	1	18	0	0
8	36569968	.	A	C	12	6	18	0	1	19	0	0
8	36569990	.	A	G	14	7	21	0	0	21	0	0
8	36571018	.	A	C	2	4	6	0	0	6	0	0
8	36571161	.	A	G	3	3	6	0	0	6	0	0
8	36571187	.	A	G	2	4	6	0	0	6	0	0
8	36571231	.	T	G	1	7	8	0	1	9	0	0
8	36573472	.	T	C	5	3	8	0	0	8	0	0
8	36573727	.	T	C	5	3	8	0	1	9	0	0
8	36573742	.	C	T	7	4	11	0	0	11	0	0
8	36573796	.	C	T	4	4	8	0	0	8	0	0
8	36575325	.	T	C	4	3	7	0	2	9	0	0
8	36577083	.	T	C	2	5	7	0	0	7	0	0
8	36577143	.	C	T	1	4	5	0	0	5	0	0
8	36577158	.	T	C	0	4	4	0	1	5	0	0
8	36577368	.	T	A	4	4	8	0	0	8	0	0
8	36577404	.	T	A	7	4	11	0	0	11	0	0
8	36583834	.	T	C	6	8	14	0	2	16	0	0
8	36587934	.	A	G	13	11	24	0	1	25	0	0
8	36587936	.	A	G	12	0	12	0	11	23	0	0
8	36587970	.	C	A	10	12	22	0	0	22	0	0
8	36587981	.	G	T	8	12	20	0	1	21	0	0
8	36588124	.	G	A	12	11	23	0	1	24	0	0
8	36589197	.	C	T	3	8	11	0	1	12	0	0
8	36589260	.	T	A	5	7	12	0	0	12	0	0
8	36591868	.	A	C	4	5	9	0	0	9	0	0
8	36591985	.	C	T	8	6	14	0	0	14	0	0
8	36592018	.	A	G	7	7	14	0	0	14	0	0
8	36592021	.	C	A	0	8	8	0	7	15	0	0
8	36592159	.	A	G	2	7	9	0	1	10	0	0
8	36592160	.	A	G	3	7	10	0	0	10	0	0
8	36592297	.	G	A	9	9	18	0	0	18	0	0
8	36592374	.	A	G	15	8	23	1	1	25	0	0
8	36594354	.	T	C	10	0	10	0	11	21	0	0
8	36594481	.	T	G	13	10	23	0	1	24	0	0
8	36594509	.	G	A	13	10	23	0	2	25	0	0
8	36598244	.	T	C	4	0	4	0	9	14	1	0
8	36598441	.	C	T	1	7	8	0	14	22	0	0
8	36600867	.	C	T	12	10	22	0	1	23	0	0
8	36600879	.	G	A	12	9	21	0	1	22	0	0
8	36602459	.	C	T	8	5	13	0	2	15	0	0
8	36617635	.	C	G	4	6	10	0	0	10	0	0
8	36617669	.	A	G	5	6	11	0	0	11	0	0
8	36617728	.	G	A	11	8	19	0	2	21	0	0
8	36617954	.	C	T	6	6	12	0	1	13	0	0
8	36621943	.	T	C	2	2	4	0	0	4	0	0
8	36743518	.	G	A	0	1	1	0	2	3	0	0
8	36747132	.	G	A	2	2	4	0	0	4	0	0
8	36750162	.	C	T	3	3	6	0	0	6	0	0
8	36750165	.	T	C	3	3	6	0	0	6	0	0
8	36750282	.	A	C	4	2	6	0	0	6	0	0
8	36750336	.	A	G	1	0	1	0	3	4	0	0
8	36781593	.	G	A	0	4	4	0	8	12	0	0
8	36781596	.	A	G	5	0	5	0	7	12	0	0
8	36783396	.	C	T	9	5	14	1	0	15	0	0
8	36785572	.	A	C	6	7	13	0	1	14	0	0
8	36785599	.	T	C	5	7	12	0	0	12	0	0
8	36803687	.	G	A	9	13	22	0	1	23	0	0
8	36803717	.	G	A	0	16	16	0	8	24	0	0
8	36803850	.	T	C	14	9	23	0	1	24	0	0
8	36951346	.	C	T	20	17	37	0	0	37	0	0
8	36951481	.	C	T	19	9	28	0	1	29	0	0
8	36951610	.	T	C	10	13	23	0	0	23	0	0
8	36952015	.	A	G	23	1	24	0	27	51	0	0
8	36953884	.	A	G	13	18	31	0	0	31	0	0
8	36953947	.	C	T	9	16	25	0	2	27	0	0
8	36953950	.	G	C	9	16	25	0	2	27	0	0
8	36956254	.	C	T	18	16	34	0	1	35	0	0
8	36956269	.	T	C	17	18	35	0	1	36	0	0
8	36959694	.	C	T	10	18	28	0	1	29	0	0
8	36959915	.	T	A	9	17	26	0	1	27	0	0
8	36961895	.	C	A	5	23	28	0	0	28	0	0
8	36964126	.	G	A	18	15	33	0	1	34	0	0
8	36969205	.	T	C	15	17	32	0	0	32	0	0
8	36974328	.	C	T	29	23	52	0	2	54	0	0
8	36974514	.	C	T	26	34	60	0	2	62	0	0
8	36975826	.	A	G	15	14	29	0	0	29	0	0
8	36975928	.	T	C	12	12	24	0	1	25	0	0
8	36976089	.	T	C	15	14	29	0	0	29	0	0
8	36976247	.	A	C	6	2	8	0	1	9	0	0
8	36976255	.	T	G	6	3	9	0	0	9	0	0
8	36976319	.	T	A	6	7	13	0	0	13	0	0
8	36976352	.	G	T	1	8	9	0	9	18	0	0
8	36976388	.	A	T	12	11	23	0	2	25	0	0
8	36976432	.	T	A	16	14	30	0	1	31	0	0
8	36976557	.	G	A	16	12	28	0	2	30	0	0
8	36976836	.	C	A	22	15	37	0	2	39	0	0
8	36977178	.	A	G	19	24	43	0	0	43	0	0
8	36977199	.	C	A	15	21	36	0	2	38	0	0
8	36977520	.	G	A	25	20	45	0	0	45	0	0
8	36977848	.	T	C	11	13	24	0	0	24	0	0
8	36983676	.	A	T	10	9	19	0	0	19	0	0
8	37007868	.	A	G	8	4	12	0	0	12	0	0
8	37009605	.	C	T	11	3	14	0	0	14	0	0
8	37009674	.	C	G	5	0	5	0	4	9	0	0
8	37010662	.	T	C	7	12	19	0	0	19	0	0
8	37012762	.	T	A	13	5	18	0	0	18	0	0
8	37012825	.	C	T	12	3	15	0	0	15	0	0
8	37012872	.	C	G	10	6	16	0	0	16	0	0
8	37013093	.	A	G	7	10	17	0	2	19	0	0
8	37013255	.	T	C	7	5	12	0	0	12	0	0
8	37013282	.	T	C	8	7	15	0	0	15	0	0
8	37014582	.	T	C	14	11	25	0	0	25	0	0
8	37016584	.	G	T	0	20	20	0	13	33	0	0
8	37016616	.	C	T	9	16	25	0	4	29	0	0
8	37016638	.	A	G	11	11	22	0	1	23	0	0
8	37016784	.	G	A	2	15	17	0	13	30	0	0
8	37016790	.	T	C	14	17	31	0	1	32	0	0
8	37017149	.	G	A	16	10	26	0	1	27	0	0
8	37017159	.	C	T	18	11	29	0	2	31	0	0
8	37018904	.	A	G	25	0	25	0	9	34	0	0
8	37019048	.	G	A	19	11	30	0	1	31	0	0
8	37019062	.	C	A	19	14	33	0	2	35	0	0
8	37025576	.	A	T	17	16	33	0	1	34	0	0
8	37025614	.	T	A	17	15	32	0	3	35	0	0
8	37025633	.	A	G	15	0	15	0	21	36	0	0
8	37025896	.	T	C	6	11	17	0	4	21	0	0
8	37026130	.	G	A	9	8	17	0	0	17	0	0
8	37033173	.	T	G	3	2	5	0	0	5	0	0
8	37035640	.	T	C	2	0	2	0	2	4	0	0
8	37038912	.	T	C	2	4	6	0	0	6	0	0
8	37038921	.	G	A	3	4	7	0	0	7	0	0
8	37041346	.	C	T	1	2	3	0	0	3	0	0
8	37059976	.	A	G	3	3	6	0	1	7	0	0
8	37060595	.	A	C	14	8	22	0	2	24	0	0
8	37060640	.	A	G	5	9	14	0	2	16	0	0
8	37068600	.	T	G	3	3	6	0	0	6	0	0
8	37075172	.	A	G	2	3	5	0	1	6	0	0
8	37075179	.	A	G	2	3	5	0	0	5	0	0
8	37075209	.	A	T	1	2	3	0	0	3	0	0
8	37075536	.	A	G	4	4	8	0	0	8	0	0
8	37082711	.	A	G	3	2	5	0	0	5	0	0
8	37082927	.	A	G	1	3	4	0	0	4	0	0
8	37086959	.	C	T	2	2	4	0	0	4	0	0
8	37101346	.	T	C	3	8	11	0	0	11	0	0
8	37101370	.	G	C	1	6	7	0	0	7	0	0
8	37232122	.	C	T	1	5	6	0	3	10	1	0
8	37232189	.	A	C	12	0	12	0	9	21	0	0
8	37232442	.	A	C	17	0	17	0	14	31	0	0
8	37232487	.	A	C	14	25	39	0	0	39	0	0
8	37239141	.	C	T	1	7	8	1	5	14	0	0
8	37241078	.	A	G	5	12	17	0	0	17	0	0
8	37242367	.	T	G	6	5	11	0	0	11	0	0
8	37242374	.	A	T	3	4	7	0	2	9	0	0
8	37242428	.	T	C	6	3	9	0	0	9	0	0
8	37242438	.	T	C	4	3	7	0	0	7	0	0
8	37248654	.	G	C	1	0	1	0	2	3	0	0
8	37249727	.	C	T	3	7	10	0	7	17	0	0
8	37249732	.	A	T	10	7	17	0	0	17	0	0
8	37280726	.	C	T	8	10	18	0	0	18	0	0
8	37280858	.	C	T	14	6	20	0	1	21	0	0
8	37281109	.	T	C	10	26	36	0	1	37	0	0
8	37282486	.	A	C	15	22	37	0	0	37	0	0
8	37282487	.	G	T	14	21	35	0	1	37	1	0
8	37282610	.	G	A	21	15	36	0	1	37	0	0
8	37282752	.	C	T	29	16	45	0	1	46	0	0
8	37282866	.	T	G	22	16	38	0	0	38	0	0
8	37282950	.	T	G	10	18	28	0	0	28	0	0
8	37282976	.	G	A	11	16	27	0	0	27	0	0
8	37283177	.	T	A	3	3	6	0	0	6	0	0
8	37283487	.	A	C	6	8	14	0	1	15	0	0
8	37283536	.	G	A	11	12	23	0	1	24	0	0
8	37283986	.	A	G	4	2	6	0	0	6	0	0
8	37284018	.	A	T	3	5	8	0	0	8	0	0
8	37284046	.	T	C	3	0	3	0	11	14	0	0
8	37294918	.	C	T	2	15	17	0	14	31	0	0
8	37294923	.	G	A	12	15	27	0	5	32	0	0
8	37297524	.	C	T	17	22	39	0	4	43	0	0
8	37303891	.	G	A	3	13	16	0	0	16	0	0
8	37305515	.	G	C	6	9	15	0	0	15	0	0
8	37306114	.	A	G	13	13	26	0	3	29	0	0
8	37311888	.	T	A	9	8	17	0	0	17	0	0
8	37316284	.	G	A	9	8	17	0	2	19	0	0
8	37317224	.	G	A	11	4	15	0	2	17	0	0
8	37317248	.	G	A	8	6	14	0	2	16	0	0
8	37317290	.	G	T	7	9	16	0	6	22	0	0
8	37320810	.	A	T	5	11	16	0	0	16	0	0
8	37453403	.	A	G	5	12	17	0	1	18	0	0
8	37453683	.	G	A	9	8	17	0	0	17	0	0
8	37456522	.	A	T	3	3	6	0	0	6	0	0
8	37456826	.	C	A	6	5	11	0	0	11	0	0
8	37460743	.	T	C	3	0	3	0	6	9	0	0
8	37460746	.	C	T	0	6	6	0	3	9	0	0
8	37460919	.	G	A	1	6	7	0	1	8	0	0
8	37460985	.	T	C	5	3	8	0	1	9	0	0
8	37461060	.	C	T	1	5	6	0	1	7	0	0
8	39816893	.	G	A	2	2	4	0	0	4	0	0
8	39819518	.	T	A	5	4	9	0	1	10	0	0
8	39822845	.	A	G	2	3	5	0	0	5	0	0
8	39848745	.	G	C	7	6	13	0	0	13	0	0
8	39848967	.	A	T	9	5	14	0	0	14	0	0
8	39849354	.	C	T	5	7	12	0	0	12	0	0
8	39849373	.	A	T	2	6	8	0	1	9	0	0
8	39849394	.	C	G	5	4	9	0	0	9	0	0
8	39849422	.	T	G	3	3	6	0	0	6	0	0
8	39849524	.	C	T	11	4	15	0	1	16	0	0
8	39849617	.	A	G	13	4	17	0	0	17	0	0
8	39849686	.	C	G	7	4	11	0	0	11	0	0
8	39849688	.	T	C	6	4	10	0	1	11	0	0
8	39849728	.	A	T	8	4	12	0	0	12	0	0
8	39849767	.	A	T	5	5	10	0	2	12	0	0
8	39849791	.	A	G	2	4	6	0	0	6	0	0
8	39850031	.	C	A	9	5	14	0	1	15	0	0
8	39850149	.	C	T	6	3	9	0	0	9	0	0
8	39850157	.	A	G	5	3	8	0	1	9	0	0
8	39850455	.	G	A	11	4	15	0	0	15	0	0
8	39850625	.	T	A	7	3	10	0	0	10	0	0
8	39850759	.	C	T	8	5	13	0	0	13	0	0
8	39850776	.	A	T	6	4	10	0	0	10	0	0
8	39851386	.	A	G	10	5	15	0	1	16	0	0
8	39851514	.	A	G	5	2	7	0	0	7	0	0
8	39851699	.	T	G	2	3	5	0	0	5	0	0
8	39851709	.	G	T	2	2	4	0	1	5	0	0
8	39851966	.	T	G	2	6	8	0	0	8	0	0
8	39852036	.	G	T	5	2	7	0	0	7	0	0
8	39852514	.	C	T	3	2	5	0	1	6	0	0
8	39858164	.	T	C	4	0	4	0	3	7	0	0
8	39859520	.	T	C	4	2	6	0	4	10	0	0
8	39870752	.	G	T	2	4	6	0	0	6	0	0
8	39870765	.	C	T	0	4	4	0	2	6	0	0
8	39870975	.	C	T	5	3	8	0	1	9	0	0
8	39876339	.	G	A	3	5	8	0	0	8	0	0
8	39901781	.	A	G	2	11	13	0	1	14	0	0
8	40028680	.	A	G	1	3	4	0	0	4	0	0
8	40081408	.	G	C	14	8	22	0	1	23	0	0
8	40081462	.	T	G	14	10	24	0	1	25	0	0
8	40081718	.	T	C	13	13	26	0	2	28	0	0
8	40218288	.	C	T	6	2	8	0	0	8	0	0
8	40218290	.	C	T	6	1	7	0	1	8	0	0
8	40234640	.	C	T	7	5	12	0	0	12	0	0
8	40234830	.	A	G	5	6	11	0	0	11	0	0
8	40234831	.	T	A	5	6	11	0	0	11	0	0
8	40235244	.	C	T	6	3	9	0	0	9	0	0
8	40235281	.	G	A	8	3	11	0	0	11	0	0
8	40235348	.	G	C	4	7	11	0	2	13	0	0
8	40235419	.	T	A	3	3	6	0	0	6	0	0
8	40235450	.	C	A	2	2	4	0	1	5	0	0
8	40236448	.	C	A	5	3	8	0	0	8	0	0
8	40236453	.	A	T	5	3	8	0	0	8	0	0
8	40237725	.	A	G	0	2	2	0	1	3	0	0
8	40237770	.	G	A	2	2	4	0	0	4	0	0
8	40240922	.	C	G	6	11	17	0	1	18	0	0
8	40241441	.	A	G	27	12	39	5	1	45	0	0
8	40241446	.	A	G	26	14	40	5	0	45	0	0
8	40241640	.	A	T	26	13	39	3	0	42	0	0
8	40241681	.	A	G	21	14	35	0	1	36	0	0
8	40241695	.	T	A	19	7	26	0	2	28	0	0
8	40242103	.	G	A	15	27	42	1	0	43	0	0
8	40242453	.	G	A	10	18	28	0	0	28	0	0
8	40242613	.	T	A	12	8	20	0	3	23	0	0
8	40242653	.	C	T	13	9	22	0	0	22	0	0
8	40243052	.	G	C	13	24	37	0	0	37	0	0
8	40243148	.	T	C	14	12	26	0	1	27	0	0
8	40248373	.	T	G	14	9	23	0	3	26	0	0
8	40248673	.	T	C	12	19	31	0	1	32	0	0
8	40248976	.	G	T	10	17	27	0	0	27	0	0
8	40251444	.	T	G	10	17	27	0	1	28	0	0
8	40251834	.	C	A	11	10	21	0	3	24	0	0
8	40252508	.	C	T	1	14	15	0	18	33	0	0
8	40254366	.	A	G	14	20	34	0	1	35	0	0
8	40254375	.	T	G	14	20	34	0	3	37	0	0
8	40270856	.	G	A	8	21	29	0	2	31	0	0
8	40325709	.	G	T	12	9	21	0	0	21	0	0
8	40326039	.	A	G	13	16	29	0	3	32	0	0
8	40326128	.	C	T	10	12	22	0	1	23	0	0
8	40326736	.	A	G	7	5	12	0	1	13	0	0
8	40427547	.	T	C	9	3	12	0	0	12	0	0
8	40427548	.	T	C	9	2	11	0	1	12	0	0
8	40427737	.	T	A	2	6	8	0	0	8	0	0
8	40427834	.	T	C	6	2	8	0	0	8	0	0
8	40427912	.	T	C	4	2	6	0	0	6	0	0
8	40427932	.	T	C	5	3	8	0	0	8	0	0
8	40428224	.	G	C	2	2	4	0	0	4	0	0
8	40428226	.	A	G	2	2	4	0	0	4	0	0
8	40428287	.	C	A	4	3	7	0	0	7	0	0
8	40429207	.	T	C	1	0	1	0	4	5	0	0
8	40429846	.	G	A	2	3	5	0	0	5	0	0
8	40430038	.	C	A	6	4	10	0	0	10	0	0
8	40430293	.	C	T	0	8	8	0	3	11	0	0
8	40430322	.	A	G	4	5	9	0	1	10	0	0
8	40430664	.	G	A	3	2	5	0	0	5	0	0
8	40430771	.	A	G	2	10	12	0	0	12	0	0
8	40430799	.	G	T	3	8	11	0	1	12	0	0
8	40430902	.	T	A	5	8	13	0	1	14	0	0
8	40430934	.	A	G	7	7	14	0	0	14	0	0
8	40631823	.	C	T	9	10	19	0	0	19	0	0
8	40631862	.	C	T	14	4	18	0	0	18	0	0
8	40632014	.	T	C	12	8	20	0	0	20	0	0
8	40632065	.	T	C	8	6	14	0	0	14	0	0
8	40632411	.	A	T	11	5	16	0	0	16	0	0
8	40632534	.	G	A	9	10	19	0	0	19	0	0
8	40633172	.	G	C	5	7	12	0	1	13	0	0
8	40644876	.	T	G	6	12	18	0	0	18	0	0
8	40645165	.	C	T	8	5	13	0	0	14	1	0
8	40645269	.	C	T	5	4	9	0	0	9	0	0
8	40646154	.	C	T	10	13	23	0	2	25	0	0
8	42075668	.	A	T	8	6	14	0	1	15	0	0
8	42075701	.	A	G	12	5	17	0	0	17	0	0
8	42138863	.	C	T	12	8	20	0	0	20	0	0
8	42138878	.	G	A	11	6	17	0	3	20	0	0
8	42139010	.	G	A	8	5	13	0	2	15	0	0
8	42238507	.	A	G	2	2	4	0	0	4	0	0
8	42238508	.	C	A	2	2	4	0	0	4	0	0
8	42610518	.	C	T	4	3	7	0	0	7	0	0
8	42642058	.	A	T	6	5	11	0	1	12	0	0
8	42642120	.	C	A	0	4	4	0	4	8	0	0
8	42642139	.	T	C	10	4	14	0	0	14	0	0
8	42642235	.	A	G	15	13	28	0	0	28	0	0
8	42642683	.	G	A	6	2	8	0	0	8	0	0
8	42642879	.	G	A	3	5	8	0	1	9	0	0
8	42655774	.	G	T	13	5	18	0	0	18	0	0
8	42676804	.	A	C	4	0	4	0	3	7	0	0
8	42688884	.	C	G	2	5	7	0	0	7	0	0
8	42689252	.	G	A	6	3	9	0	1	10	0	0
8	42689483	.	A	T	5	2	7	0	1	8	0	0
8	42689492	.	G	A	5	2	7	0	0	7	0	0
8	42689764	.	G	T	4	4	8	0	0	8	0	0
8	42689805	.	T	C	4	7	11	0	0	11	0	0
8	42689992	.	G	T	1	4	5	0	0	5	0	0
8	42690067	.	T	A	4	2	6	0	1	7	0	0
8	42690390	.	T	A	2	2	4	0	0	4	0	0
8	42690749	.	G	A	2	4	6	0	0	6	0	0
8	42691529	.	G	C	2	3	5	0	0	5	0	0
8	42691632	.	C	T	2	2	4	0	0	4	0	0
8	42691634	.	G	A	3	1	4	0	1	5	0	0
8	42695557	.	G	A	3	2	5	0	0	5	0	0
8	43379779	.	T	C	20	15	35	0	0	35	0	0
8	43380067	.	G	A	16	16	32	0	0	32	0	0
8	43380290	.	A	T	11	11	22	0	0	22	0	0
8	43380543	.	T	G	11	8	19	0	1	20	0	0
8	43380781	.	C	T	1	13	14	0	9	23	0	0
8	43380905	.	A	T	13	14	27	1	0	28	0	0
8	43380923	.	C	T	2	17	19	0	12	31	0	0
8	43381239	.	A	T	17	11	28	0	2	30	0	0
8	43381306	.	A	T	18	15	33	0	1	34	0	0
8	43381417	.	T	G	7	13	20	0	0	21	1	0
8	43381500	.	A	G	6	19	25	0	0	25	0	0
8	43381664	.	A	T	7	15	22	0	0	22	0	0
8	43382046	.	A	T	19	20	39	0	7	46	0	0
8	43386194	.	G	A	18	16	34	0	5	39	0	0
8	43386677	.	T	A	18	12	30	0	2	32	0	0
8	43393575	.	C	A	2	14	16	0	15	31	0	0
8	43400484	.	A	G	10	8	18	0	0	18	0	0
8	43400820	.	G	A	8	14	22	0	0	22	0	0
8	43400880	.	G	A	6	13	19	0	1	20	0	0
8	43401134	.	A	G	7	12	19	0	0	19	0	0
8	43401161	.	T	C	7	0	7	0	9	16	0	0
8	43401423	.	G	A	7	9	16	0	1	17	0	0
8	43413787	.	C	T	2	12	14	1	11	26	0	0
8	43419175	.	C	T	1	6	7	0	6	13	0	0
8	43419763	.	A	C	6	5	11	0	0	11	0	0
8	43423931	.	C	T	7	3	10	0	0	10	0	0
8	43424006	.	C	T	9	4	13	0	0	13	0	0
8	43424205	.	C	T	8	4	12	0	1	13	0	0
8	43455875	.	G	A	2	4	6	0	1	7	0	0
8	43486712	.	T	C	10	4	14	0	1	15	0	0
8	43501983	.	T	G	4	6	10	0	0	10	0	0
8	43574555	.	A	T	3	6	9	0	0	9	0	0
8	43668521	.	A	G	13	9	22	0	2	24	0	0
8	43668716	.	T	G	13	19	32	0	3	35	0	0
8	43671871	.	C	T	11	14	25	0	2	27	0	0
8	43675370	.	G	A	16	7	23	0	0	23	0	0
8	43675698	.	T	A	8	5	13	0	1	14	0	0
8	43677718	.	T	C	10	11	21	0	1	22	0	0
8	43677736	.	A	C	9	11	20	0	1	21	0	0
8	43680438	.	A	G	6	7	13	0	0	13	0	0
8	43680469	.	T	G	4	6	10	0	2	12	0	0
8	43680500	.	T	C	7	5	12	0	1	13	0	0
8	43680510	.	A	G	9	8	17	0	0	17	0	0
8	43682544	.	A	G	10	7	17	0	2	19	0	0
8	43683133	.	G	A	9	8	17	0	3	20	0	0
8	43688536	.	A	G	8	8	16	0	1	17	0	0
8	43688847	.	G	A	3	6	9	0	1	10	0	0
8	43691854	.	G	T	4	7	11	0	0	11	0	0
8	43693140	.	A	C	8	3	11	0	1	12	0	0
8	43693392	.	A	G	10	3	13	1	0	14	0	0
8	43701731	.	A	G	9	4	13	0	0	13	0	0
8	43703589	.	T	G	4	2	6	0	1	7	0	0
8	43706201	.	A	G	1	4	5	0	1	6	0	0
8	43708257	.	A	C	4	2	6	0	0	6	0	0
8	43708440	.	C	T	0	5	5	0	3	8	0	0
8	43708637	.	A	G	2	3	5	0	0	5	0	0
8	43709160	.	T	C	4	0	4	0	4	8	0	0
8	43711819	.	G	T	4	2	6	0	1	7	0	0
8	43712309	.	A	C	8	6	14	0	3	17	0	0
8	43717174	.	A	T	2	2	4	0	0	4	0	0
8	43717198	.	T	A	1	2	3	0	0	3	0	0
8	43720121	.	C	T	2	2	4	0	0	4	0	0
8	43720325	.	T	C	1	3	4	0	0	4	0	0
8	43720343	.	T	C	1	1	2	0	0	2	0	0
8	43720778	.	A	T	2	4	6	0	0	6	0	0
8	43720811	.	A	G	2	2	4	0	0	4	0	0
8	43736314	.	C	T	0	3	3	0	1	4	0	0
8	43736354	.	G	T	2	2	4	0	0	4	0	0
8	43816389	.	A	T	2	1	3	0	1	4	0	0
8	43816393	.	A	C	2	2	4	0	0	4	0	0
8	43934966	.	G	A	8	10	18	0	1	19	0	0
8	43935120	.	A	G	20	12	32	0	5	37	0	0
8	43935351	.	A	T	7	7	14	0	0	14	0	0
8	43935481	.	C	T	7	12	19	0	1	20	0	0
8	43935552	.	A	G	7	14	21	0	0	21	0	0
8	43935679	.	A	T	8	3	11	0	0	11	0	0
8	43935680	.	A	C	8	3	11	0	0	11	0	0
8	43935731	.	C	T	6	8	14	0	0	14	0	0
8	43935879	.	C	G	5	7	12	0	0	12	0	0
8	43940148	.	C	A	3	3	6	0	0	6	0	0
8	43944366	.	C	T	5	3	8	0	2	10	0	0
8	43960570	.	T	C	11	7	18	0	1	19	0	0
8	43967218	.	A	G	7	6	13	0	0	13	0	0
8	43974538	.	T	A	3	11	14	0	1	15	0	0
8	44003950	.	A	G	6	4	10	0	0	10	0	0
8	44004004	.	A	C	5	3	8	0	0	8	0	0
8	44211831	.	G	A	1	3	4	0	0	4	0	0
8	44213470	.	T	G	2	3	5	0	0	5	0	0
8	44213729	.	C	T	2	3	5	0	0	5	0	0
8	44296292	.	C	T	0	3	3	0	4	7	0	0
8	44296595	.	A	C	3	1	4	0	7	11	0	0
8	44296672	.	G	A	9	6	15	0	0	15	0	0
8	44296985	.	G	A	7	3	10	0	1	11	0	0
8	44297555	.	A	G	3	3	6	0	1	7	0	0
8	44297609	.	G	A	4	4	8	0	0	8	0	0
8	44297822	.	T	C	3	2	5	0	0	5	0	0
8	44446256	.	G	A	5	2	7	0	0	7	0	0
8	44448140	.	A	T	2	2	4	0	0	4	0	0
8	44448181	.	T	A	2	3	5	0	1	6	0	0
8	44448358	.	T	G	3	3	6	1	0	7	0	0
8	44599938	.	C	T	5	4	9	0	0	9	0	0
8	44602132	.	G	A	15	5	20	0	0	20	0	0
8	44602264	.	A	G	10	4	14	0	0	14	0	0
8	44602353	.	G	C	4	0	4	0	9	13	0	0
8	44602357	.	T	C	6	6	12	0	1	13	0	0
8	44604588	.	C	T	0	5	5	0	6	11	0	0
8	44617902	.	G	A	3	7	10	0	0	10	0	0
8	44617903	.	A	T	2	7	9	0	1	10	0	0
8	44618024	.	C	T	3	3	6	0	0	6	0	0
8	44671767	.	T	C	7	6	13	0	0	13	0	0
8	44677544	.	C	T	3	10	13	0	0	13	0	0
8	44677613	.	T	C	9	8	17	0	1	18	0	0
8	44694956	.	G	A	0	7	7	0	10	17	0	0
8	44695043	.	A	C	7	16	23	0	0	23	0	0
8	44695140	.	A	C	7	10	17	0	0	17	0	0
8	44695230	.	A	T	10	14	24	0	0	24	0	0
8	44714384	.	C	T	17	8	25	0	0	25	0	0
8	44726070	.	C	A	3	5	8	0	1	9	0	0
8	44730536	.	G	A	3	4	7	0	3	10	0	0
8	44737646	.	C	A	4	4	8	0	0	8	0	0
8	44894337	.	G	T	7	5	12	0	0	12	0	0
8	44894604	.	C	T	7	7	14	0	1	15	0	0
8	44894631	.	G	C	7	7	14	0	0	14	0	0
8	44897853	.	C	A	2	12	14	0	6	20	0	0
8	44921346	.	G	A	2	2	4	0	0	4	0	0
8	44923501	.	T	G	5	4	9	0	0	9	0	0
8	44923622	.	T	G	5	3	8	0	0	8	0	0
8	44923700	.	T	C	4	0	4	0	4	8	0	0
8	44959583	.	C	T	1	4	5	0	0	5	0	0
8	44959589	.	A	G	1	3	4	0	1	5	0	0
8	45293782	.	A	G	5	0	5	0	7	12	0	0
8	45298603	.	G	A	9	11	20	0	0	20	0	0
8	45298943	.	G	C	7	10	17	1	3	21	0	0
8	45304210	.	T	C	5	10	15	0	1	16	0	0
8	45308963	.	A	C	18	10	28	0	0	28	0	0
8	45311761	.	T	G	14	12	26	0	1	27	0	0
8	45312231	.	G	C	1	9	10	0	14	24	0	0
8	45312285	.	C	A	9	7	16	0	5	21	0	0
8	45313023	.	A	C	12	9	21	0	0	21	0	0
8	45315444	.	T	C	9	18	27	0	4	31	0	0
8	45317898	.	A	T	17	18	35	0	5	40	0	0
8	45317976	.	G	A	4	14	18	0	19	37	0	0
8	45318124	.	C	T	14	18	32	0	3	35	0	0
8	45319659	.	A	G	18	1	19	0	26	45	0	0
8	45325269	.	G	C	16	19	35	0	2	37	0	0
8	45328278	.	T	A	12	13	25	0	0	25	0	0
8	45361816	.	A	G	13	13	26	0	2	28	0	0
8	45365789	.	T	C	10	15	25	0	1	26	0	0
8	45374151	.	A	T	9	10	19	0	3	23	1	0
8	45374477	.	A	G	8	8	16	0	0	16	0	0
8	45374665	.	T	A	24	18	42	0	1	43	0	0
8	45374884	.	T	G	12	13	25	0	0	25	0	0
8	45374966	.	G	T	6	8	14	0	1	15	0	0
8	45374970	.	A	G	7	6	13	0	2	15	0	0
8	45381427	.	T	A	2	3	5	0	0	5	0	0
8	45381480	.	A	T	4	2	6	0	0	6	0	0
8	45381488	.	C	A	7	3	10	0	0	10	0	0
8	45381555	.	T	C	7	5	12	0	0	12	0	0
8	45381570	.	C	T	6	6	12	0	0	12	0	0
8	45381596	.	G	T	2	3	5	0	5	10	0	0
8	45381919	.	G	A	0	2	2	0	5	7	0	0
8	45384426	.	C	T	3	2	5	0	0	5	0	0
8	45384444	.	G	A	3	3	6	0	1	7	0	0
8	45385546	.	T	A	2	2	4	0	0	4	0	0
8	45385586	.	A	G	1	0	1	0	2	3	0	0
8	45394968	.	A	T	1	2	3	0	0	3	0	0
8	45395114	.	T	A	7	4	11	0	0	11	0	0
8	45395127	.	C	T	7	4	11	0	0	11	0	0
8	45395357	.	C	T	1	4	5	0	1	6	0	0
8	45395452	.	T	G	1	4	5	0	0	5	0	0
8	45395463	.	A	C	1	2	3	0	0	3	0	0
8	45396028	.	T	C	9	1	10	0	6	16	0	0
8	45427189	.	C	A	24	17	41	0	3	44	0	0
8	45428039	.	C	T	20	15	35	0	1	36	0	0
8	45430757	.	G	A	28	21	49	0	1	50	0	0
8	45755040	.	T	C	2	3	5	0	0	5	0	0
8	45755078	.	A	G	5	6	11	0	1	12	0	0
8	45755263	.	T	C	3	3	6	0	2	8	0	0
8	45755732	.	C	T	29	24	53	0	4	57	0	0
8	45755973	.	C	G	28	42	70	0	6	77	1	0
8	45759960	.	C	T	42	20	62	0	0	62	0	0
8	45760071	.	A	C	10	0	10	0	9	19	0	0
8	45763350	.	C	T	1	4	5	0	0	5	0	0
8	45763511	.	T	G	6	4	10	0	0	10	0	0
8	45763537	.	A	T	6	11	17	0	1	18	0	0
8	45763562	.	G	A	10	17	27	0	1	28	0	0
8	45763670	.	C	T	26	13	39	0	3	42	0	0
8	45763872	.	T	A	21	11	32	1	4	37	0	0
8	45763991	.	A	G	12	23	35	0	0	35	0	0
8	45764006	.	G	C	24	11	35	0	3	38	0	0
8	45764665	.	G	C	17	0	17	0	10	27	0	0
8	45764800	.	G	A	16	6	22	0	0	22	0	0
8	45764820	.	A	T	13	4	17	0	0	17	0	0
8	45764884	.	G	A	6	14	20	0	0	20	0	0
8	45765170	.	C	T	3	22	25	0	37	62	0	0
8	45765188	.	A	T	31	25	56	0	2	58	0	0
8	45765326	.	G	A	29	22	51	0	2	53	0	0
8	45772961	.	G	C	20	13	33	0	1	34	0	0
8	45774471	.	C	T	1	18	19	0	12	31	0	0
8	45775089	.	C	T	12	8	20	0	3	23	0	0
8	45779729	.	A	C	11	15	26	0	0	26	0	0
8	45786186	.	C	T	2	9	11	0	11	22	0	0
8	45786612	.	G	T	8	8	16	0	0	16	0	0
8	45786615	.	A	G	8	9	17	0	0	17	0	0
8	45787137	.	A	G	20	15	35	0	1	36	0	0
8	45788941	.	T	G	9	7	16	0	2	18	0	0
8	45789130	.	T	C	15	6	21	0	0	21	0	0
8	45793550	.	A	C	13	11	24	0	0	24	0	0
8	45797305	.	G	A	3	13	16	0	2	18	0	0
8	45834940	.	G	A	5	7	12	0	0	12	0	0
8	45838228	.	C	T	6	3	9	0	0	9	0	0
8	45852874	.	C	A	5	3	8	0	0	8	0	0
8	45853465	.	C	A	1	4	5	0	8	13	0	0
8	45853475	.	G	A	4	6	10	0	1	11	0	0
8	45853533	.	T	C	4	2	6	0	2	8	0	0
8	45853574	.	A	G	3	4	7	0	0	7	0	0
8	45853626	.	G	A	6	6	12	0	1	13	0	0
8	45859500	.	A	G	6	15	21	0	2	23	0	0
8	45862402	.	A	G	7	18	25	0	1	26	0	0
8	45864652	.	G	C	11	14	25	0	0	25	0	0
8	45875593	.	T	C	1	9	10	0	0	10	0	0
8	45879493	.	T	C	6	0	6	0	5	11	0	0
8	45880074	.	T	A	8	6	14	0	0	14	0	0
8	45880125	.	G	A	6	2	8	0	0	8	0	0
8	45883767	.	C	T	0	3	3	0	10	13	0	0
8	45883836	.	A	G	4	3	7	0	0	7	0	0
8	45896997	.	T	C	2	0	2	0	4	6	0	0
8	45898077	.	A	G	5	2	7	0	0	7	0	0
8	45907117	.	C	T	3	4	7	0	1	8	0	0
8	45911899	.	C	T	3	3	6	0	0	6	0	0
8	45939385	.	G	A	3	2	5	0	2	7	0	0
8	45939398	.	A	G	3	2	5	0	1	6	0	0
8	45939648	.	C	G	7	3	10	1	0	12	1	0
8	45944896	.	T	A	14	11	25	0	1	26	0	0
8	45944983	.	G	A	8	5	13	0	0	13	0	0
8	45948718	.	G	A	10	8	18	0	0	18	0	0
8	45952072	.	C	G	7	5	12	0	0	12	0	0
8	45952152	.	A	T	6	4	10	0	0	10	0	0
8	45952231	.	T	C	6	3	9	0	0	9	0	0
8	45952352	.	G	C	3	7	10	0	0	10	0	0
8	45952423	.	A	G	9	3	12	0	1	13	0	0
8	45952500	.	A	G	7	0	7	0	3	10	0	0
8	45961976	.	T	A	1	4	5	0	1	6	0	0
8	45961998	.	C	A	3	0	3	0	0	3	0	0
8	45965528	.	G	T	1	4	5	0	0	5	0	0
8	45965749	.	G	A	1	6	7	0	0	7	0	0
8	45968648	.	G	A	1	2	3	0	0	3	0	0
8	45986867	.	T	G	1	2	3	0	0	3	0	0
8	46011055	.	T	A	1	3	4	0	0	4	0	0
8	46014147	.	T	C	1	6	7	0	0	7	0	0
8	46025145	.	G	A	1	4	5	0	0	5	0	0
8	46077675	.	A	G	4	4	8	0	0	8	0	0
8	46077757	.	C	T	11	4	15	0	1	16	0	0
8	46077819	.	G	A	16	4	20	0	1	21	0	0
8	46078264	.	A	T	13	5	18	0	0	18	0	0
8	46078287	.	A	G	14	4	18	0	0	18	0	0
8	46078342	.	C	G	12	4	16	0	0	16	0	0
8	46085480	.	A	T	15	8	23	0	0	23	0	0
8	46089037	.	G	T	11	21	32	0	0	32	0	0
8	46089052	.	T	C	13	17	30	0	1	31	0	0
8	46089432	.	A	C	13	0	13	0	12	25	0	0
8	46089634	.	C	T	18	11	29	0	2	31	0	0
8	46094790	.	G	A	8	9	17	0	2	19	0	0
8	46125509	.	G	A	3	4	7	0	2	9	0	0
8	46132662	.	G	C	5	0	5	0	7	12	0	0
8	46160980	.	C	T	0	5	5	0	8	13	0	0
8	46188003	.	A	G	9	7	16	0	0	16	0	0
8	46188018	.	A	G	9	8	17	0	0	17	0	0
8	46218233	.	C	A	1	3	4	0	0	4	0	0
8	46220826	.	C	T	1	9	10	0	0	10	0	0
8	46220848	.	A	C	1	10	11	0	0	11	0	0
8	46228719	.	C	T	1	5	6	0	4	10	0	0
8	46231128	.	A	G	7	5	12	1	1	14	0	0
8	46247717	.	T	C	4	5	9	0	1	10	0	0
8	46258216	.	A	G	7	4	11	0	0	11	0	0
8	46286443	.	G	A	7	2	9	0	0	9	0	0
8	46296796	.	G	A	3	6	9	0	0	9	0	0
8	46296830	.	A	G	4	4	8	0	0	8	0	0
8	46296851	.	T	C	5	5	10	0	0	10	0	0
8	46310717	.	G	A	3	3	6	0	0	6	0	0
8	46310897	.	A	G	5	2	7	0	0	7	0	0
8	46337310	.	A	G	6	3	9	0	0	9	0	0
8	46348083	.	A	T	1	6	7	0	0	7	0	0
8	46348121	.	G	A	0	4	4	0	3	7	0	0
8	46348391	.	T	A	2	4	6	0	0	6	0	0
8	46356282	.	G	A	6	4	10	0	1	11	0	0
8	46362082	.	G	A	5	6	11	0	0	11	0	0
8	46362083	.	G	T	5	6	11	0	0	11	0	0
8	47232850	.	G	A	1	4	5	0	0	5	0	0
8	47947391	.	A	G	12	6	18	0	7	25	0	0
8	47947445	.	A	G	8	17	25	0	2	27	0	0
8	47947460	.	A	G	14	11	25	0	5	30	0	0
8	49310925	.	T	C	4	3	7	0	1	8	0	0
8	49310928	.	T	C	3	5	8	0	1	9	0	0
8	49404195	.	C	A	20	15	35	2	12	49	0	0
8	49405661	.	T	C	1	0	1	0	2	3	0	0
8	49406014	.	G	A	1	2	3	0	0	3	0	0
8	49406035	.	G	A	1	2	3	0	1	4	0	0
8	49447326	.	A	G	4	2	6	0	1	7	0	0
8	49447428	.	A	G	1	3	4	0	0	4	0	0
8	49447433	.	A	G	3	2	5	0	0	5	0	0
8	49710686	.	G	A	5	11	16	0	2	18	0	0
8	49722313	.	T	C	2	10	12	0	0	12	0	0
8	49728659	.	T	A	10	10	20	0	1	21	0	0
8	49732151	.	T	C	3	0	3	0	2	5	0	0
8	49735647	.	C	G	1	2	3	0	0	3	0	0
8	49745727	.	T	G	3	2	5	0	3	8	0	0
8	49746224	.	T	C	12	13	25	0	0	25	0	0
8	49746256	.	G	A	15	15	30	0	0	30	0	0
8	49746440	.	T	C	19	25	44	0	2	46	0	0
8	49746456	.	T	G	15	25	40	1	1	42	0	0
8	49755801	.	A	C	25	16	41	0	1	42	0	0
8	49755867	.	A	T	18	21	39	0	1	40	0	0
8	49756121	.	A	T	18	18	36	0	0	36	0	0
8	49759453	.	A	G	19	14	33	0	2	35	0	0
8	49768183	.	C	G	2	2	4	0	0	4	0	0
8	49768413	.	G	A	0	3	3	0	3	6	0	0
8	49768420	.	C	T	4	3	7	0	0	7	0	0
8	49768925	.	G	A	2	4	6	0	1	7	0	0
8	49769213	.	T	A	1	2	3	0	0	3	0	0
8	49769237	.	G	A	1	3	4	0	0	4	0	0
8	49769496	.	G	A	4	3	7	0	0	7	0	0
8	49778672	.	T	G	9	10	19	0	1	20	0	0
8	49845392	.	A	G	13	12	25	0	0	25	0	0
8	49850230	.	C	T	6	6	12	0	0	12	0	0
8	49851155	.	C	G	9	9	18	0	0	18	0	0
8	49860718	.	C	T	11	7	18	0	0	18	0	0
8	49864103	.	T	C	13	12	25	0	1	26	0	0
8	49864124	.	G	A	12	15	27	0	2	29	0	0
8	49864212	.	C	T	14	13	27	0	2	29	0	0
8	49864232	.	G	A	12	13	25	0	1	26	0	0
8	49864402	.	C	T	8	9	17	0	3	20	0	0
8	49864655	.	G	T	10	16	26	0	1	27	0	0
8	49865070	.	G	A	11	4	15	0	0	15	0	0
8	49865099	.	T	G	10	3	13	0	0	13	0	0
8	49865124	.	C	T	9	5	14	0	0	14	0	0
8	49865212	.	G	C	5	6	11	0	15	26	0	0
8	49899474	.	G	A	3	7	10	0	2	12	0	0
8	49899528	.	G	A	11	10	21	0	0	21	0	0
8	49899621	.	G	A	9	3	12	0	0	12	0	0
8	49908585	.	C	T	0	6	6	0	1	7	0	0
8	49908719	.	C	T	0	6	6	0	5	11	0	0
8	49908841	.	C	T	7	5	12	0	0	12	0	0
8	49911143	.	G	A	6	8	14	0	1	15	0	0
8	49912557	.	G	A	3	6	9	0	1	10	0	0
8	49912682	.	G	A	6	9	15	0	1	16	0	0
8	49925662	.	G	T	3	2	5	0	1	6	0	0
8	49925719	.	C	T	4	4	8	0	0	8	0	0
8	49941098	.	A	T	4	2	6	0	0	6	0	0
8	49947483	.	C	T	15	8	23	0	0	23	0	0
8	49949798	.	C	T	3	8	11	0	0	11	0	0
8	49952260	.	C	T	5	7	12	0	0	12	0	0
8	49969037	.	C	T	3	5	8	0	0	8	0	0
8	49989214	.	A	C	4	3	7	0	0	7	0	0
8	49991438	.	A	G	4	6	10	0	1	11	0	0
8	49993381	.	A	C	2	3	5	0	1	6	0	0
8	49996176	.	T	C	6	8	14	0	0	14	0	0
8	50000859	.	C	A	5	2	7	0	2	9	0	0
8	50012607	.	G	A	3	4	7	0	0	7	0	0
8	50151789	.	G	A	6	4	10	0	1	11	0	0
8	50151797	.	C	T	4	6	10	0	0	10	0	0
8	50156805	.	G	A	6	4	10	0	1	11	0	0
8	50159305	.	C	T	2	6	8	0	0	8	0	0
8	50159515	.	A	G	5	8	13	0	2	15	0	0
8	50163398	.	A	G	8	0	8	0	10	18	0	0
8	50170889	.	T	C	5	5	10	0	2	12	0	0
8	50179868	.	T	A	3	4	7	0	1	8	0	0
8	50501318	.	C	G	3	0	3	0	3	6	0	0
8	50501360	.	A	G	2	4	6	0	0	6	0	0
8	50501462	.	C	T	2	6	8	0	0	8	0	0
8	50522089	.	A	G	5	2	7	0	0	7	0	0
8	50522118	.	C	T	1	3	4	0	3	7	0	0
8	50522613	.	A	G	3	4	7	0	0	7	0	0
8	50812321	.	G	A	10	6	16	0	0	16	0	0
8	50818102	.	G	T	6	10	16	0	0	16	0	0
8	50818180	.	C	T	4	9	13	0	0	13	0	0
8	50835236	.	T	A	2	5	7	0	0	7	0	0
8	50835253	.	A	G	3	3	6	0	1	7	0	0
8	50837390	.	T	C	1	2	3	0	0	3	0	0
8	50837603	.	C	T	3	3	6	0	2	8	0	0
8	50837684	.	G	C	3	5	8	0	1	9	0	0
8	50837731	.	A	G	3	6	9	0	0	9	0	0
8	50838854	.	G	A	4	3	7	0	0	7	0	0
8	50845104	.	T	C	10	11	21	0	2	23	0	0
8	50849973	.	C	T	7	9	16	0	0	16	0	0
8	50863149	.	G	A	1	2	3	0	0	3	0	0
8	50890422	.	A	T	7	10	17	0	1	18	0	0
8	50898126	.	C	T	1	4	5	0	8	13	0	0
8	50947386	.	G	C	42	26	68	0	1	69	0	0
8	50947648	.	T	A	19	20	39	0	2	41	0	0
8	50949040	.	T	A	18	25	43	1	1	45	0	0
8	50949128	.	T	C	16	17	33	1	2	36	0	0
8	50949160	.	A	T	23	14	37	0	1	38	0	0
8	50949188	.	C	T	23	18	41	0	1	42	0	0
8	50949430	.	T	A	27	17	44	0	2	46	0	0
8	50949479	.	A	G	19	32	51	1	2	54	0	0
8	50949501	.	A	T	40	16	56	1	0	57	0	0
8	50949570	.	G	A	28	27	55	2	0	57	0	0
8	50949573	.	G	A	28	25	53	2	3	58	0	0
8	50949639	.	C	T	28	23	51	6	5	62	0	0
8	50949766	.	C	T	15	8	23	0	0	23	0	0
8	50949903	.	A	G	35	0	35	0	12	47	0	0
8	50960443	.	C	A	14	9	23	1	2	26	0	0
8	50960542	.	T	C	15	12	27	0	2	29	0	0
8	50962536	.	T	C	20	25	45	0	2	47	0	0
8	50962623	.	T	G	19	0	19	0	20	39	0	0
8	50966854	.	G	T	2	6	8	0	0	8	0	0
8	50967774	.	C	G	6	3	9	0	2	11	0	0
8	50967890	.	C	T	7	6	13	0	1	14	0	0
8	50969141	.	T	C	6	7	13	0	0	13	0	0
8	50969150	.	A	G	4	9	13	0	1	14	0	0
8	50969367	.	G	A	6	2	8	0	2	10	0	0
8	50969493	.	T	A	11	11	22	0	0	22	0	0
8	50971524	.	G	A	10	12	22	1	0	23	0	0
8	50972267	.	C	T	12	15	27	0	1	28	0	0
8	50981034	.	A	G	8	3	11	0	0	11	0	0
8	50993300	.	G	A	6	3	9	0	0	9	0	0
8	50995581	.	A	G	4	4	8	0	0	8	0	0
8	51008419	.	T	C	3	5	8	0	0	8	0	0
8	51008524	.	T	G	6	6	12	0	1	13	0	0
8	51027845	.	G	C	4	3	7	0	0	7	0	0
8	51105900	.	A	T	1	2	3	0	0	3	0	0
8	51109346	.	T	G	2	0	2	0	2	4	0	0
8	51126705	.	A	G	4	2	6	0	0	6	0	0
8	51133164	.	G	A	1	2	3	0	0	3	0	0
8	51134917	.	A	T	5	2	7	0	1	8	0	0
8	51144662	.	T	C	1	2	3	0	1	4	0	0
8	51147570	.	A	G	5	3	8	0	0	8	0	0
8	51165572	.	T	C	8	7	15	0	2	17	0	0
8	51165786	.	C	A	0	13	13	0	10	23	0	0
8	51173843	.	A	G	6	6	12	0	1	13	0	0
8	51175677	.	G	A	1	2	3	0	0	3	0	0
8	51189364	.	C	T	0	3	3	0	1	4	0	0
8	51189373	.	G	C	1	3	4	0	0	4	0	0
8	51189463	.	A	G	3	5	8	0	0	8	0	0
8	51195100	.	G	A	2	3	5	0	0	5	0	0
8	51247891	.	G	C	3	3	6	0	0	6	0	0
8	51309145	.	T	G	14	21	35	0	0	35	0	0
8	51309311	.	A	G	14	14	28	0	1	29	0	0
8	51314087	.	G	A	16	22	38	0	1	39	0	0
8	51320547	.	C	T	8	12	20	0	5	25	0	0
8	51320652	.	C	T	10	7	17	1	2	20	0	0
8	51325510	.	T	G	16	11	27	0	1	28	0	0
8	51330776	.	T	C	9	12	21	0	1	22	0	0
8	51330836	.	A	T	10	9	19	0	0	19	0	0
8	51351155	.	T	A	11	5	16	0	0	16	0	0
8	51351200	.	A	T	10	11	21	0	1	22	0	0
8	51352480	.	A	G	11	15	26	0	1	27	0	0
8	51352525	.	A	T	14	14	28	0	1	29	0	0
8	51358769	.	G	A	19	17	36	0	1	37	0	0
8	51364515	.	T	C	13	10	23	0	0	23	0	0
8	51364644	.	C	A	0	9	9	0	16	25	0	0
8	51364665	.	T	C	16	7	23	0	1	24	0	0
8	51364696	.	C	G	10	7	17	0	1	18	0	0
8	51364713	.	C	A	0	8	8	0	8	16	0	0
8	51367178	.	A	T	8	9	17	0	0	17	0	0
8	51367206	.	C	T	13	6	19	0	0	19	0	0
8	51367217	.	C	T	16	9	25	0	1	26	0	0
8	51367267	.	A	T	13	8	21	0	0	21	0	0
8	51375405	.	T	G	12	11	23	0	2	25	0	0
8	51379609	.	G	A	9	7	16	0	0	16	0	0
8	51379699	.	G	A	8	9	17	0	1	18	0	0
8	51379741	.	A	T	9	6	15	0	1	16	0	0
8	51379747	.	G	A	9	6	15	0	1	16	0	0
8	51383765	.	C	T	6	6	12	0	1	13	0	0
8	51431396	.	C	T	1	5	6	0	9	15	0	0
8	51431684	.	T	C	3	3	6	0	0	6	0	0
8	51431879	.	C	T	2	3	5	0	0	5	0	0
8	51432359	.	T	C	3	2	5	0	0	5	0	0
8	51432765	.	T	C	1	2	3	0	0	3	0	0
8	51432919	.	A	G	2	3	5	0	0	5	0	0
8	51432930	.	T	C	2	3	5	0	0	5	0	0
8	51433141	.	G	T	5	2	7	0	1	8	0	0
8	51433238	.	A	G	2	2	4	0	0	4	0	0
8	51433511	.	T	G	5	6	11	0	0	11	0	0
8	51433512	.	G	T	4	7	11	0	0	11	0	0
8	51433680	.	G	A	1	7	8	0	0	8	0	0
8	51433843	.	T	C	5	5	10	0	0	10	0	0
8	51434384	.	C	T	2	3	5	0	3	8	0	0
8	51434455	.	G	A	3	5	8	0	0	8	0	0
8	51437284	.	G	A	4	5	9	0	0	9	0	0
8	51439541	.	T	C	2	0	2	0	6	8	0	0
8	51443601	.	A	C	1	4	5	4	0	9	0	0
8	51573166	.	G	A	2	2	4	0	0	4	0	0
8	51573167	.	C	T	2	2	4	0	0	4	0	0
8	51576997	.	T	G	1	7	8	0	0	8	0	0
8	51591902	.	G	A	1	3	4	0	0	4	0	0
8	51634935	.	T	C	2	1	3	0	6	9	0	0
8	51635673	.	A	C	1	0	1	0	2	3	0	0
8	51635691	.	T	G	1	4	5	0	0	5	0	0
8	51723206	.	G	A	1	2	3	0	6	9	0	0
8	51779797	.	C	T	0	2	2	0	7	9	0	0
8	51782044	.	A	G	16	7	23	0	1	24	0	0
8	51826625	.	C	T	1	8	9	0	1	10	0	0
8	51827243	.	C	T	7	4	11	0	0	11	0	0
8	51867952	.	T	G	6	2	8	0	0	8	0	0
8	51900760	.	C	T	0	3	3	0	1	4	0	0
8	51900814	.	G	A	1	2	3	0	0	3	0	0
8	51921953	.	T	A	1	2	3	0	1	4	0	0
8	51941362	.	T	A	1	2	3	0	0	3	0	0
8	51947040	.	C	A	1	3	4	0	0	4	0	0
8	51951879	.	T	C	2	0	2	0	3	5	0	0
8	51992393	.	C	A	2	2	4	0	0	4	0	0
8	51992501	.	G	T	5	4	9	0	1	10	0	0
8	51996707	.	A	G	12	9	21	0	1	22	0	0
8	51996727	.	A	G	13	12	25	0	0	25	0	0
8	52001776	.	C	T	2	12	14	0	17	31	0	0
8	52001785	.	A	G	16	12	28	0	0	28	0	0
8	52002903	.	C	T	2	7	9	0	15	24	0	0
8	52002945	.	T	A	22	14	36	0	4	40	0	0
8	52005582	.	A	C	11	6	17	0	1	18	0	0
8	52006139	.	C	T	0	6	6	0	10	16	0	0
8	52010799	.	T	C	6	9	15	0	0	15	0	0
8	52012737	.	T	A	4	5	9	0	0	9	0	0
8	52015712	.	G	T	11	6	17	0	1	18	0	0
8	52016041	.	G	A	12	9	21	0	1	22	0	0
8	52016101	.	T	C	8	8	16	0	0	16	0	0
8	52016128	.	G	A	11	5	16	0	0	16	0	0
8	52026501	.	G	A	5	6	11	0	0	11	0	0
8	52026702	.	C	A	6	6	12	0	1	13	0	0
8	52029849	.	T	C	2	7	9	0	1	10	0	0
8	52029852	.	G	A	3	7	10	0	0	10	0	0
8	52029978	.	C	T	1	5	6	0	5	11	0	0
8	52030185	.	G	A	10	5	15	0	0	15	0	0
8	52031962	.	A	G	9	7	16	0	1	17	0	0
8	52031965	.	A	G	11	7	18	0	0	18	0	0
8	52032016	.	T	A	6	3	9	0	0	9	0	0
8	52034609	.	G	A	3	4	7	0	0	7	0	0
8	52036359	.	A	G	3	2	5	0	0	5	0	0
8	52036392	.	A	G	2	3	5	0	0	5	0	0
8	52037800	.	A	G	4	7	11	0	0	11	0	0
8	52037830	.	C	A	4	6	10	0	0	10	0	0
8	52039233	.	A	G	2	3	5	0	0	5	0	0
8	52042175	.	T	C	4	0	4	0	5	9	0	0
8	52042206	.	G	A	1	4	5	0	1	6	0	0
8	52042293	.	C	G	0	4	4	0	4	8	0	0
8	52042891	.	T	C	6	3	9	0	0	9	0	0
8	52042893	.	G	A	6	3	9	0	0	9	0	0
8	52043119	.	T	A	2	4	6	0	0	6	0	0
8	52045585	.	C	T	3	4	7	0	0	7	0	0
8	52050643	.	T	A	5	4	9	0	0	9	0	0
8	52065100	.	A	C	4	0	4	0	3	7	0	0
8	52068159	.	A	T	2	2	4	0	1	5	0	0
8	52070944	.	G	T	1	3	4	0	0	4	0	0
8	52077323	.	T	G	1	5	6	1	0	7	0	0
8	52079212	.	C	T	2	2	4	0	0	4	0	0
8	52079217	.	G	A	2	3	5	0	0	5	0	0
8	52086057	.	G	A	1	4	5	0	2	7	0	0
8	52107898	.	T	G	3	3	6	0	0	6	0	0
8	52108329	.	T	C	1	2	3	0	2	5	0	0
8	52108611	.	T	G	1	5	6	0	1	7	0	0
8	52108621	.	C	A	3	4	7	0	0	7	0	0
8	52108970	.	G	A	4	4	8	0	0	8	0	0
8	52109686	.	T	G	5	7	12	1	0	13	0	0
8	52109730	.	T	G	5	7	12	0	1	13	0	0
8	52226378	.	A	C	2	2	4	0	0	4	0	0
8	52229959	.	A	T	2	3	5	0	0	5	0	0
8	52229962	.	G	A	2	3	5	0	1	6	0	0
8	52292515	.	T	C	11	7	18	0	0	18	0	0
8	52296833	.	T	G	5	4	9	0	0	9	0	0
8	52296834	.	T	G	5	4	9	0	0	9	0	0
8	52297140	.	G	A	0	3	3	0	2	5	0	0
8	52297790	.	T	A	8	3	11	0	1	12	0	0
8	52314637	.	G	T	1	5	6	0	7	13	0	0
8	52322189	.	C	G	4	0	4	0	4	8	0	0
8	52324918	.	A	G	4	8	12	0	1	13	0	0
8	52325721	.	A	G	6	0	6	0	11	17	0	0
8	52336870	.	T	C	7	7	14	0	2	16	0	0
8	52342586	.	A	C	11	8	19	1	1	21	0	0
8	52345733	.	T	C	11	9	20	0	1	21	0	0
8	52345751	.	T	C	11	11	22	0	0	22	0	0
8	52345915	.	T	C	6	7	13	0	0	13	0	0
8	52346035	.	T	C	3	6	9	0	0	9	0	0
8	52346072	.	A	T	4	3	7	0	0	7	0	0
8	52346111	.	A	C	4	5	9	0	0	9	0	0
8	52346225	.	A	T	5	4	9	0	1	10	0	0
8	52347460	.	C	T	6	13	19	0	1	20	0	0
8	52348619	.	A	G	4	7	11	0	0	11	0	0
8	52348648	.	A	G	10	3	13	0	1	14	0	0
8	52348685	.	T	C	7	6	13	0	0	13	0	0
8	52349080	.	T	G	9	6	15	0	0	15	0	0
8	52350101	.	A	G	10	0	10	0	12	24	2	0
8	52350146	.	A	G	15	0	15	0	13	28	0	0
8	52350251	.	A	G	11	11	22	0	1	23	0	0
8	52350322	.	T	G	6	3	9	0	1	10	0	0
8	52408619	.	G	A	27	23	50	0	2	52	0	0
8	52411451	.	T	C	22	21	43	0	1	44	0	0
8	52412982	.	A	G	17	24	41	1	0	42	0	0
8	52412985	.	C	G	17	23	40	1	0	41	0	0
8	52453432	.	A	C	5	6	11	0	0	11	0	0
8	52453862	.	T	A	6	6	12	0	2	14	0	0
8	52455588	.	A	G	4	5	9	0	1	10	0	0
8	52455610	.	A	G	4	7	11	0	0	11	0	0
8	52455638	.	C	G	3	4	7	0	0	7	0	0
8	52463828	.	T	A	5	3	8	0	1	9	0	0
8	52463855	.	C	T	1	5	6	0	4	10	0	0
8	52472930	.	C	G	6	7	13	1	0	14	0	0
8	52472955	.	C	T	0	2	2	1	7	10	0	0
8	52491586	.	G	A	5	7	12	0	0	12	0	0
8	52509559	.	C	A	7	4	11	0	2	13	0	0
8	52509568	.	C	A	8	4	12	0	0	12	0	0
8	52509624	.	G	A	6	4	10	0	0	10	0	0
8	52509762	.	A	T	6	3	9	0	0	9	0	0
8	52510088	.	C	T	4	6	10	0	0	10	0	0
8	52521261	.	T	C	2	3	5	0	0	5	0	0
8	52521280	.	T	G	2	3	5	0	0	5	0	0
8	52524436	.	A	T	7	10	17	0	2	19	0	0
8	52528665	.	A	G	13	5	18	0	0	18	0	0
8	52528717	.	A	G	12	5	17	0	0	17	0	0
8	52528856	.	C	G	6	6	12	0	0	12	0	0
8	52529123	.	C	T	6	3	9	0	0	9	0	0
8	52529206	.	T	C	9	8	17	0	2	19	0	0
8	52529235	.	G	A	11	8	19	0	1	20	0	0
8	52529397	.	A	G	13	11	24	0	0	24	0	0
8	52534158	.	A	G	2	5	7	0	0	7	0	0
8	52538056	.	G	A	0	5	5	0	5	11	1	0
8	52538062	.	G	A	0	4	4	0	7	11	0	0
8	52547038	.	T	G	10	7	17	0	0	17	0	0
8	52547356	.	A	G	7	7	14	0	1	15	0	0
8	52547519	.	C	G	3	0	3	0	7	10	0	0
8	52547569	.	T	A	3	8	11	0	0	11	0	0
8	52547787	.	T	A	5	2	7	0	1	8	0	0
8	52547829	.	T	G	2	3	5	0	0	5	0	0
8	52550361	.	C	T	6	6	12	0	1	13	0	0
8	52550373	.	T	C	7	0	7	0	6	13	0	0
8	52550462	.	A	G	5	6	11	0	0	11	0	0
8	52553162	.	G	A	5	9	14	0	0	14	0	0
8	52553193	.	A	T	7	2	9	0	3	12	0	0
8	52553197	.	A	G	7	5	12	0	1	13	0	0
8	52554799	.	T	A	6	6	12	0	0	12	0	0
8	52554874	.	G	T	10	2	12	0	1	13	0	0
8	52554875	.	T	C	9	3	12	0	1	13	0	0
8	52555050	.	G	A	7	12	19	0	1	20	0	0
8	52555077	.	C	G	12	11	23	0	0	23	0	0
8	52555137	.	G	A	15	4	19	0	0	19	0	0
8	52557454	.	G	T	2	6	8	0	0	8	0	0
8	52559996	.	G	T	3	11	14	0	0	14	0	0
8	52560034	.	T	C	3	11	14	0	1	15	0	0
8	52560058	.	T	C	8	7	15	0	0	15	0	0
8	52561397	.	C	T	8	10	18	0	0	18	0	0
8	52561421	.	C	A	8	11	19	0	1	20	0	0
8	52561477	.	C	A	6	4	10	0	1	11	0	0
8	52563316	.	T	G	9	2	11	0	2	13	0	0
8	52563364	.	C	T	7	7	14	0	1	15	0	0
8	52563427	.	C	T	3	5	8	0	8	16	0	0
8	52565222	.	C	A	4	5	9	0	0	9	0	0
8	52565319	.	T	C	3	4	7	0	0	7	0	0
8	52571198	.	T	C	2	9	11	0	0	11	0	0
8	52580094	.	A	G	6	4	10	0	0	10	0	0
8	52580169	.	A	G	5	4	9	0	0	9	0	0
8	52584246	.	T	A	2	3	5	0	0	5	0	0
8	52584249	.	A	T	2	3	5	0	0	5	0	0
8	52591539	.	G	A	1	3	4	0	0	4	0	0
8	52630327	.	G	A	2	2	4	0	0	4	0	0
8	52630332	.	G	A	2	2	4	0	0	4	0	0
8	52711583	.	A	T	1	3	4	0	0	4	0	0
8	52712503	.	A	C	1	2	3	0	0	3	0	0
8	52712513	.	G	T	2	2	4	0	0	4	0	0
8	52713677	.	T	G	49	28	77	0	1	78	0	0
8	52713776	.	G	A	38	23	61	0	8	69	0	0
8	52713932	.	G	A	34	37	71	0	4	75	0	0
8	52713974	.	A	G	35	27	62	0	6	68	0	0
8	52713989	.	G	A	40	29	69	0	0	69	0	0
8	52714343	.	T	G	44	22	66	0	1	67	0	0
8	52715821	.	C	T	33	16	49	0	0	49	0	0
8	52815581	.	C	G	2	0	2	0	2	4	0	0
8	52815584	.	C	T	1	2	3	0	0	3	0	0
8	52824680	.	T	C	2	3	5	0	0	5	0	0
8	53148976	.	T	C	6	7	13	0	0	13	0	0
8	53149259	.	T	C	3	5	8	0	1	9	0	0
8	53150736	.	T	C	6	2	8	0	0	8	0	0
8	53398653	.	A	G	3	3	6	0	1	7	0	0
8	53398654	.	A	G	2	5	7	0	0	7	0	0
8	53399003	.	A	G	9	6	15	0	0	15	0	0
8	53399188	.	A	G	3	7	10	0	0	10	0	0
8	53665057	.	G	A	3	2	5	0	2	7	0	0
8	53765038	.	A	G	1	8	9	0	0	9	0	0
8	53918281	.	T	G	3	2	5	0	0	5	0	0
8	53918323	.	A	T	3	4	7	0	0	7	0	0
8	53918472	.	T	C	11	9	20	0	1	21	0	0
8	53918664	.	C	T	8	10	18	0	0	18	0	0
8	53918730	.	T	C	9	10	19	0	1	20	0	0
8	53918790	.	G	T	8	11	19	0	1	20	0	0
8	53918899	.	C	T	3	2	5	0	0	5	0	0
8	53919124	.	C	A	6	3	9	0	0	9	0	0
8	53921722	.	A	G	7	11	18	0	0	18	0	0
8	53921779	.	G	A	13	10	23	0	0	23	0	0
8	53921797	.	A	G	10	12	22	0	0	22	0	0
8	53921815	.	A	G	10	12	22	0	1	23	0	0
8	53922034	.	A	G	9	4	13	0	1	14	0	0
8	53940977	.	T	C	1	4	5	0	0	5	0	0
8	53942440	.	T	C	2	5	7	0	1	8	0	0
8	53948412	.	C	T	8	7	15	0	0	15	0	0
8	53948434	.	G	A	8	7	15	0	2	17	0	0
8	53948501	.	T	C	13	8	21	0	0	21	0	0
8	53949706	.	G	A	19	14	33	0	0	33	0	0
8	53950181	.	T	C	11	0	11	0	8	19	0	0
8	53953420	.	C	G	10	10	20	0	0	20	0	0
8	53954966	.	T	G	11	6	17	0	1	18	0	0
8	53956476	.	T	G	12	12	24	0	0	24	0	0
8	53956530	.	T	G	15	9	24	0	1	25	0	0
8	53959378	.	T	C	12	10	22	0	1	23	0	0
8	53984570	.	C	T	1	2	3	0	1	4	0	0
8	54013347	.	A	T	11	8	19	0	2	21	0	0
8	54013556	.	T	A	19	6	25	1	3	29	0	0
8	54013594	.	G	T	8	12	20	1	2	23	0	0
8	54023714	.	A	G	11	0	11	0	8	19	0	0
8	54128964	.	A	G	21	0	21	0	8	29	0	0
8	54129735	.	G	A	0	27	27	0	11	38	0	0
8	54129767	.	G	A	13	20	33	0	0	33	0	0
8	54129774	.	T	C	12	20	32	0	1	34	1	0
8	54129867	.	A	C	16	14	30	0	1	31	0	0
8	54130103	.	T	G	7	6	13	0	0	13	0	0
8	54130203	.	T	G	7	6	13	0	0	13	0	0
8	54130346	.	A	G	1	0	1	0	3	8	4	0
8	54131660	.	G	T	6	7	13	0	0	13	0	0
8	54131669	.	A	G	5	6	11	0	0	11	0	0
8	54131889	.	T	G	9	11	20	0	0	20	0	0
8	54132024	.	C	G	8	9	17	0	2	19	0	0
8	54132044	.	C	T	6	16	22	0	0	22	0	0
8	54132084	.	C	G	5	12	17	0	1	18	0	0
8	54132248	.	T	A	8	4	12	1	0	13	0	0
8	54132477	.	G	T	2	3	5	0	1	6	0	0
8	54132773	.	C	T	1	2	3	0	2	5	0	0
8	54133376	.	A	G	18	13	31	0	0	31	0	0
8	54133403	.	A	T	16	13	29	0	0	29	0	0
8	54133450	.	G	A	16	11	27	0	0	27	0	0
8	54133522	.	G	A	14	9	23	0	1	24	0	0
8	54135717	.	T	C	5	4	9	0	0	9	0	0
8	54137658	.	T	C	1	3	4	0	0	4	0	0
8	54142752	.	C	T	6	8	14	0	0	14	0	0
8	54145198	.	A	G	2	2	4	0	0	4	0	0
8	54147056	.	T	C	6	6	12	0	0	12	0	0
8	54151403	.	C	T	4	3	7	0	1	8	0	0
8	54155012	.	C	A	8	6	14	0	1	15	0	0
8	54202655	.	C	T	15	12	27	0	0	27	0	0
8	54203198	.	A	G	8	14	22	0	0	22	0	0
8	54208231	.	A	G	14	11	25	0	2	27	0	0
8	54208282	.	C	T	17	15	32	0	1	33	0	0
8	54208572	.	C	T	20	15	35	0	1	36	0	0
8	54210066	.	G	A	14	14	28	0	2	30	0	0
8	54210081	.	C	T	16	15	31	0	1	32	0	0
8	54211989	.	G	A	1	3	4	0	0	4	0	0
8	54211991	.	G	A	1	3	4	0	1	5	0	0
8	54213461	.	A	G	7	4	11	0	0	11	0	0
8	54213462	.	C	T	7	4	11	0	0	11	0	0
8	54220876	.	T	A	26	15	41	0	0	41	0	0
8	54220949	.	T	C	37	10	47	0	2	49	0	0
8	54221065	.	A	T	20	22	42	1	1	46	2	0
8	54221067	.	T	C	28	13	41	1	3	45	0	0
8	54221243	.	T	C	17	0	17	0	25	42	0	0
8	54221390	.	T	C	24	8	32	0	3	35	0	0
8	54221573	.	T	C	19	1	20	0	21	41	0	0
8	54221812	.	G	C	21	23	44	0	0	44	0	0
8	54221927	.	C	T	16	30	46	0	3	49	0	0
8	54221966	.	G	A	18	25	43	0	0	43	0	0
8	54303407	.	A	G	1	5	6	0	0	6	0	0
9	11776	.	G	A	1	4	5	0	0	5	0	0
9	11863	.	C	A	3	6	9	0	0	9	0	0
9	12837	.	A	G	6	5	11	0	0	11	0	0
9	24528	.	C	T	19	11	30	0	1	31	0	0
9	37058	.	G	A	17	20	37	0	5	42	0	0
9	37199	.	G	A	18	15	33	0	2	35	0	0
9	37830	.	C	T	0	10	10	0	18	28	0	0
9	52064	.	G	C	6	6	12	3	0	15	0	0
9	54479	.	C	T	10	21	31	0	2	33	0	0
9	62205	.	C	G	18	0	18	1	4	26	3	0
9	62336	.	T	C	24	14	38	0	2	40	0	0
9	62351	.	A	G	24	14	38	0	3	41	0	0
9	62528	.	T	G	21	18	39	0	0	39	0	0
9	63313	.	G	A	13	19	32	0	3	35	0	0
9	63418	.	G	A	13	7	20	0	2	22	0	0
9	63532	.	G	A	12	10	22	0	2	24	0	0
9	63604	.	G	A	12	7	19	0	1	20	0	0
9	64739	.	C	A	1	8	9	0	10	19	0	0
9	70215	.	G	T	4	2	6	0	0	6	0	0
9	71641	.	A	G	5	0	5	0	5	10	0	0
9	74903	.	T	G	1	2	3	0	0	3	0	0
9	77975	.	A	G	1	3	4	0	0	4	0	0
9	78365	.	A	G	1	2	3	0	0	3	0	0
9	80243	.	G	A	2	3	5	0	0	5	0	0
9	80263	.	T	C	2	3	5	0	0	5	0	0
9	80628	.	A	G	3	0	3	0	3	6	0	0
9	82627	.	G	A	2	5	7	0	0	7	0	0
9	82903	.	C	G	1	1	2	0	4	6	0	0
9	83092	.	C	T	5	3	8	0	0	8	0	0
9	83116	.	A	G	4	4	8	0	0	8	0	0
9	83133	.	G	C	3	4	7	0	0	7	0	0
9	83347	.	A	G	2	8	10	0	0	10	0	0
9	83365	.	A	C	2	10	12	0	0	12	0	0
9	83629	.	G	A	0	2	2	0	2	4	0	0
9	83785	.	T	C	7	4	11	0	1	12	0	0
9	84216	.	G	A	3	5	8	0	1	9	0	0
9	84247	.	A	G	1	0	1	0	5	6	0	0
9	84293	.	A	G	2	5	7	0	0	7	0	0
9	84487	.	A	G	4	3	7	0	1	8	0	0
9	84515	.	G	A	0	4	4	0	7	11	0	0
9	84617	.	A	T	4	3	7	0	0	7	0	0
9	84814	.	A	G	2	1	3	0	6	9	0	0
9	85318	.	T	C	5	4	9	0	0	9	0	0
9	85846	.	A	G	4	5	9	0	0	9	0	0
9	86089	.	A	G	1	8	9	0	0	9	0	0
9	86107	.	C	G	2	5	7	0	0	7	0	0
9	86439	.	T	C	3	13	16	0	0	16	0	0
9	86462	.	G	T	4	13	17	0	0	17	0	0
9	86719	.	T	C	7	6	13	0	0	13	0	0
9	86767	.	T	C	10	5	15	0	0	15	0	0
9	86830	.	T	C	6	6	12	1	0	13	0	0
9	89121	.	C	A	6	5	11	0	0	11	0	0
9	89407	.	C	T	12	12	24	0	1	25	0	0
9	90189	.	A	G	7	6	13	0	3	16	0	0
9	90507	.	G	C	1	7	8	0	8	16	0	0
9	94276	.	T	C	15	14	29	0	2	31	0	0
9	97312	.	G	A	2	3	5	0	0	5	0	0
9	97348	.	G	A	2	4	6	0	0	6	0	0
9	103432	.	T	C	15	10	25	0	0	25	0	0
9	104840	.	G	A	14	7	21	0	0	21	0	0
9	104862	.	T	G	8	6	14	0	1	15	0	0
9	105091	.	C	T	0	9	9	0	5	14	0	0
9	134835	.	C	T	0	5	5	0	1	6	0	0
9	135612	.	T	C	1	0	1	0	2	3	0	0
9	145209	.	A	G	2	3	5	0	0	5	0	0
9	145214	.	C	T	2	4	6	0	0	6	0	0
9	145913	.	G	A	6	7	13	0	0	13	0	0
9	148333	.	G	A	1	9	10	0	5	15	0	0
9	148339	.	A	G	5	9	14	0	0	14	0	0
9	149078	.	G	A	2	9	11	0	3	14	0	0
9	149215	.	C	A	14	7	21	0	2	23	0	0
9	149251	.	A	T	11	11	22	0	2	24	0	0
9	153001	.	C	T	16	9	25	0	0	25	0	0
9	168918	.	A	G	11	3	14	0	0	14	0	0
9	168974	.	T	C	4	5	9	0	3	12	0	0
9	168975	.	T	C	7	4	11	0	1	12	0	0
9	169072	.	T	A	6	6	12	0	0	12	0	0
9	169806	.	G	C	16	1	17	0	19	36	0	0
9	170845	.	G	T	16	12	28	0	0	28	0	0
9	170945	.	G	A	15	8	23	1	3	27	0	0
9	172661	.	C	T	17	12	29	0	0	29	0	0
9	180245	.	G	A	13	11	24	0	1	25	0	0
9	197122	.	T	C	1	0	1	0	4	5	0	0
9	208799	.	C	T	2	3	5	0	5	10	0	0
9	209444	.	T	A	3	2	5	0	0	5	0	0
9	225220	.	T	A	12	12	24	0	1	25	0	0
9	225257	.	C	T	10	12	22	0	0	22	0	0
9	225362	.	T	C	11	13	24	0	0	24	0	0
9	225371	.	T	C	9	9	18	0	1	19	0	0
9	225599	.	C	T	2	11	13	0	0	13	0	0
9	225656	.	C	T	6	5	11	0	0	11	0	0
9	226168	.	C	T	11	6	17	0	0	17	0	0
9	227072	.	C	T	10	8	18	0	0	18	0	0
9	233295	.	A	G	14	0	14	0	8	22	0	0
9	233922	.	C	T	6	11	17	0	2	19	0	0
9	234328	.	G	A	7	11	18	0	1	19	0	0
9	235262	.	G	T	2	11	13	0	10	23	0	0
9	235365	.	T	A	12	9	21	0	1	22	0	0
9	235567	.	C	G	8	7	15	0	0	15	0	0
9	253264	.	T	C	17	1	18	0	18	36	0	0
9	254484	.	A	G	33	26	59	0	3	62	0	0
9	257890	.	A	T	30	21	51	2	6	59	0	0
9	257926	.	G	C	25	3	28	5	25	58	0	0
9	262487	.	A	G	28	30	58	0	2	60	0	0
9	262511	.	C	T	4	24	28	0	30	58	0	0
9	266053	.	T	C	12	11	23	0	0	23	0	0
9	266227	.	T	C	31	24	55	0	0	55	0	0
9	266255	.	C	T	34	29	63	0	0	63	0	0
9	266445	.	G	C	24	28	52	0	1	53	0	0
9	266572	.	T	C	33	0	33	0	27	60	0	0
9	266721	.	A	G	23	19	42	0	0	42	0	0
9	266802	.	A	C	15	20	35	0	3	38	0	0
9	266910	.	G	A	26	20	46	0	0	46	0	0
9	267081	.	A	G	26	36	62	0	2	64	0	0
9	267290	.	G	A	29	37	66	0	2	68	0	0
9	275474	.	G	A	27	27	54	0	3	57	0	0
9	276059	.	A	G	29	24	53	1	1	55	0	0
9	278150	.	A	G	29	23	52	0	1	53	0	0
9	278174	.	G	A	33	21	54	0	0	54	0	0
9	282686	.	C	T	26	19	45	0	3	48	0	0
9	282737	.	T	C	22	1	23	0	13	36	0	0
9	296052	.	G	A	27	26	53	0	1	54	0	0
9	296177	.	T	A	24	32	56	0	3	59	0	0
9	296181	.	T	C	26	3	29	0	31	60	0	0
9	298715	.	C	T	0	2	2	0	1	3	0	0
9	298930	.	A	G	3	3	6	0	0	6	0	0
9	298970	.	A	G	4	2	6	0	2	8	0	0
9	299247	.	C	T	4	6	10	1	0	11	0	0
9	301535	.	A	T	9	5	14	0	0	14	0	0
9	302720	.	T	C	6	5	11	0	0	11	0	0
9	303032	.	C	G	7	6	13	0	1	14	0	0
9	303061	.	T	C	5	0	5	0	10	15	0	0
9	303070	.	T	C	8	7	15	0	1	16	0	0
9	303288	.	C	T	0	4	4	0	4	8	0	0
9	323588	.	A	G	5	6	11	0	0	11	0	0
9	323762	.	T	C	5	6	11	0	1	12	0	0
9	323893	.	C	T	4	6	10	0	0	10	0	0
9	323904	.	G	T	3	6	9	0	0	9	0	0
9	324119	.	G	A	3	3	6	0	0	6	0	0
9	326140	.	C	T	4	4	8	0	0	8	0	0
9	331672	.	C	T	3	4	7	0	0	7	0	0
9	331771	.	G	T	6	2	8	0	0	8	0	0
9	332710	.	T	C	5	3	8	0	0	8	0	0
9	335985	.	A	G	3	1	4	0	3	7	0	0
9	336102	.	C	G	1	2	3	0	0	3	0	0
9	336776	.	G	T	1	3	4	0	0	4	0	0
9	336852	.	A	T	7	3	10	0	1	11	0	0
9	336863	.	A	G	7	1	8	0	2	10	0	0
9	339332	.	T	C	8	9	17	0	1	18	0	0
9	340075	.	T	C	10	3	13	0	1	14	0	0
9	340076	.	A	T	11	3	14	0	0	14	0	0
9	355324	.	A	G	7	4	11	0	0	11	0	0
9	355348	.	G	A	8	2	10	0	0	10	0	0
9	355397	.	C	A	9	0	9	0	1	10	0	0
9	355411	.	A	C	8	4	12	0	0	12	0	0
9	360846	.	G	A	4	6	10	0	0	10	0	0
9	360894	.	A	G	4	5	9	0	0	9	0	0
9	362906	.	G	T	4	3	7	0	0	7	0	0
9	427848	.	A	G	4	0	4	0	5	9	0	0
9	427925	.	T	C	4	2	6	0	0	6	0	0
9	429277	.	A	T	3	7	10	0	1	11	0	0
9	430071	.	T	C	9	14	23	0	1	24	0	0
9	430125	.	G	T	0	5	5	0	9	14	0	0
9	431089	.	C	T	4	8	12	0	1	13	0	0
9	431137	.	C	T	5	5	10	0	0	10	0	0
9	432146	.	A	T	2	2	4	0	0	4	0	0
9	432202	.	A	T	1	2	3	0	0	3	0	0
9	432680	.	G	C	1	2	3	0	0	3	0	0
9	433821	.	A	T	2	4	6	0	0	6	0	0
9	448596	.	G	A	1	2	3	0	0	3	0	0
9	453409	.	C	T	0	4	4	0	3	7	0	0
9	453459	.	G	T	3	2	5	0	0	5	0	0
9	458995	.	T	A	10	8	18	0	1	19	0	0
9	459042	.	A	T	11	6	17	0	0	17	0	0
9	459754	.	C	T	10	12	22	0	0	22	0	0
9	459755	.	T	C	10	0	10	0	12	22	0	0
9	463005	.	A	C	7	11	18	0	0	18	0	0
9	463010	.	T	C	7	0	7	0	10	17	0	0
9	504375	.	G	A	0	2	2	0	1	3	0	0
9	510854	.	A	G	1	0	1	0	2	3	0	0
9	510855	.	A	T	0	1	1	0	2	3	0	0
9	510956	.	C	G	5	4	9	0	0	9	0	0
9	511884	.	C	T	4	3	7	0	0	7	0	0
9	511935	.	C	A	7	3	10	0	0	10	0	0
9	511947	.	C	T	3	8	11	0	0	11	0	0
9	525826	.	C	T	2	6	8	0	0	8	0	0
9	527777	.	T	C	3	2	5	0	1	6	0	0
9	527867	.	A	T	4	6	10	0	0	10	0	0
9	527969	.	G	A	0	5	5	0	10	15	0	0
9	528021	.	A	G	3	3	6	0	1	7	0	0
9	528540	.	A	T	2	5	7	0	0	7	0	0
9	528545	.	G	A	0	5	5	0	2	7	0	0
9	529147	.	C	T	2	4	6	0	0	6	0	0
9	529930	.	G	A	2	2	4	0	0	4	0	0
9	581466	.	G	A	1	2	3	0	0	3	0	0
9	585887	.	A	G	11	8	19	0	0	19	0	0
9	588454	.	A	G	9	11	20	0	1	21	0	0
9	588456	.	C	T	10	11	21	0	1	22	0	0
9	596596	.	G	A	4	5	9	0	1	10	0	0
9	597342	.	C	T	3	6	9	0	0	9	0	0
9	598720	.	A	G	8	10	18	0	0	18	0	0
9	598795	.	A	G	7	14	21	0	0	21	0	0
9	598819	.	G	A	9	11	20	0	0	20	0	0
9	600609	.	G	A	6	5	11	0	0	11	0	0
9	606784	.	T	A	4	4	8	0	0	8	0	0
9	606838	.	A	G	3	4	7	0	1	8	0	0
9	607208	.	G	A	4	2	6	0	0	6	0	0
9	608623	.	C	T	3	2	5	0	0	5	0	0
9	612636	.	G	A	4	6	10	0	0	10	0	0
9	619328	.	G	A	2	2	4	0	0	4	0	0
9	627648	.	C	A	0	3	3	0	5	8	0	0
9	701575	.	A	T	13	4	17	0	0	17	0	0
9	707172	.	A	G	1	3	4	0	0	4	0	0
9	707178	.	G	A	1	3	4	0	0	4	0	0
9	707599	.	C	G	5	2	7	0	0	7	0	0
9	707601	.	C	G	5	2	7	0	0	7	0	0
9	707741	.	G	A	0	2	2	0	1	3	0	0
9	707742	.	T	C	1	2	3	0	0	3	0	0
9	707996	.	C	T	4	14	18	0	26	44	0	0
9	717840	.	G	A	20	5	25	0	0	25	0	0
9	717849	.	T	C	18	6	24	0	2	26	0	0
9	719729	.	G	A	11	7	18	0	0	18	0	0
9	721472	.	C	T	0	6	6	0	20	26	0	0
9	721822	.	T	A	10	5	15	0	1	16	0	0
9	721829	.	A	G	11	6	17	0	1	18	0	0
9	722965	.	A	G	5	5	10	0	0	10	0	0
9	723004	.	G	A	9	6	15	0	1	16	0	0
9	723044	.	C	T	11	6	17	0	0	17	0	0
9	724592	.	G	A	8	7	15	0	1	16	0	0
9	724616	.	G	A	13	6	19	0	2	21	0	0
9	726870	.	A	G	9	5	14	0	0	14	0	0
9	728531	.	C	A	1	2	3	0	4	7	0	0
9	729672	.	A	G	4	2	6	0	1	7	0	0
9	730539	.	C	A	5	2	7	0	0	7	0	0
9	731356	.	G	A	8	3	11	0	0	11	0	0
9	732191	.	C	T	1	5	6	0	10	16	0	0
9	732218	.	G	A	12	4	16	0	2	18	0	0
9	734643	.	T	G	13	5	18	1	0	19	0	0
9	735860	.	A	G	5	3	8	0	0	8	0	0
9	737461	.	C	A	0	3	3	0	3	6	0	0
9	737462	.	G	T	3	3	6	0	0	6	0	0
9	740907	.	C	T	6	2	8	0	0	8	0	0
9	746006	.	A	G	3	7	10	0	1	11	0	0
9	746071	.	T	C	7	9	16	0	0	16	0	0
9	748018	.	T	C	5	9	14	0	0	14	0	0
9	781983	.	G	C	2	5	7	0	0	8	1	0
9	784574	.	C	T	1	2	3	0	0	3	0	0
9	1188237	.	G	T	2	2	4	0	0	4	0	0
9	1235841	.	A	G	6	5	11	0	0	11	0	0
9	1235943	.	G	T	4	4	8	0	0	8	0	0
9	1236252	.	C	T	2	4	6	0	0	6	0	0
9	1236273	.	G	T	3	3	6	0	0	6	0	0
9	1236396	.	A	G	1	3	4	0	1	5	0	0
9	1251672	.	T	G	4	2	6	0	0	6	0	0
9	1251753	.	T	C	4	4	8	0	0	8	0	0
9	1251795	.	T	C	2	2	4	0	0	4	0	0
9	1282509	.	C	T	5	2	7	0	0	7	0	0
9	1285758	.	A	G	2	0	2	0	2	4	0	0
9	1293974	.	C	T	2	2	4	0	0	4	0	0
9	1296985	.	T	C	3	3	6	0	0	6	0	0
9	1297000	.	G	A	3	4	7	0	1	8	0	0
9	1297027	.	T	C	2	5	7	0	1	8	0	0
9	1371021	.	A	G	7	3	10	0	0	10	0	0
9	1371363	.	A	G	3	7	10	0	0	10	0	0
9	1576417	.	A	G	4	3	7	0	0	7	0	0
9	1576924	.	T	A	1	10	11	0	0	11	0	0
9	1577542	.	C	A	8	8	16	0	1	17	0	0
9	1589727	.	T	A	0	2	2	0	1	3	0	0
9	2340957	.	T	A	11	29	40	0	0	40	0	0
9	2340964	.	G	A	20	11	31	0	4	36	1	0
9	2557538	.	A	G	4	2	6	0	0	6	0	0
9	2559875	.	T	C	12	4	16	0	0	16	0	0
9	2586484	.	A	G	5	4	9	0	0	9	0	0
9	2896592	.	C	T	0	1	1	0	3	4	0	0
9	2896614	.	A	G	2	2	4	0	0	4	0	0
9	3231991	.	A	G	6	3	9	0	0	9	0	0
9	3667949	.	G	A	4	3	7	0	3	10	0	0
9	4506242	.	T	C	4	4	8	0	1	9	0	0
9	4511264	.	T	G	2	3	5	0	0	5	0	0
9	6208020	.	G	T	1	2	3	0	0	3	0	0
9	6256165	.	C	T	7	7	14	0	0	14	0	0
9	6256184	.	C	T	6	6	12	0	0	12	0	0
9	6256349	.	A	T	3	2	5	0	3	8	0	0
9	6256541	.	G	A	1	12	13	0	4	17	0	0
9	6362976	.	G	A	9	10	19	0	1	20	0	0
9	6395679	.	C	G	13	13	26	0	1	28	1	0
9	6395713	.	G	A	9	16	25	0	1	26	0	0
9	6395792	.	T	A	16	7	23	0	0	23	0	0
9	6395859	.	G	A	7	3	10	0	0	10	0	0
9	6396181	.	G	A	6	11	17	0	1	18	0	0
9	6396235	.	A	G	6	10	16	0	0	16	0	0
9	6396242	.	G	A	6	10	16	0	0	16	0	0
9	6396354	.	A	G	5	5	10	1	0	11	0	0
9	6396477	.	A	G	7	10	17	0	0	17	0	0
9	6399592	.	C	T	2	6	8	0	4	12	0	0
9	6399610	.	A	G	5	8	13	0	0	13	0	0
9	6399721	.	T	C	12	0	12	0	7	19	0	0
9	6399762	.	C	T	11	5	16	0	0	16	0	0
9	6399784	.	A	G	8	6	14	0	2	16	0	0
9	6399949	.	A	G	3	11	14	0	0	14	0	0
9	6400005	.	A	C	4	2	6	0	0	6	0	0
9	6400191	.	G	A	3	5	8	0	0	8	0	0
9	6400240	.	C	T	1	4	5	0	6	11	0	0
9	6400251	.	G	A	7	5	12	0	0	12	0	0
9	6415385	.	G	A	8	3	11	0	0	11	0	0
9	6660314	.	G	A	8	12	20	0	1	21	0	0
9	6660611	.	G	A	17	14	31	0	0	31	0	0
9	6660953	.	C	T	1	9	10	0	10	20	0	0
9	6661361	.	A	T	5	4	9	0	3	12	0	0
9	7030092	.	A	G	7	3	10	0	0	11	1	0
9	7031683	.	C	T	14	8	22	1	1	24	0	0
9	7032231	.	C	A	6	8	14	0	1	15	0	0
9	7039659	.	C	T	9	11	20	0	0	20	0	0
9	7039689	.	T	C	11	9	20	0	1	21	0	0
9	7042639	.	C	T	12	4	16	0	1	17	0	0
9	7042659	.	G	A	9	9	18	0	0	18	0	0
9	7042674	.	A	G	10	0	10	0	9	19	0	0
9	7046383	.	A	G	11	9	20	0	1	21	0	0
9	7049484	.	C	G	4	11	15	0	0	15	0	0
9	7056563	.	T	C	9	21	30	0	0	30	0	0
9	7056713	.	A	C	7	10	17	0	0	17	0	0
9	7056968	.	C	T	13	8	21	0	0	21	0	0
9	7092424	.	T	C	14	5	19	0	0	19	0	0
9	7092457	.	T	C	12	5	17	0	1	18	0	0
9	7094141	.	T	C	14	8	22	0	0	22	0	0
9	7094898	.	T	C	15	10	25	0	0	25	0	0
9	7213050	.	A	G	5	11	16	0	0	16	0	0
9	7213565	.	C	T	2	2	4	0	0	4	0	0
9	7213607	.	T	C	9	6	15	0	2	17	0	0
9	7228087	.	A	C	1	2	3	0	0	3	0	0
9	7228272	.	C	T	17	13	30	0	0	30	0	0
9	7228348	.	C	A	13	18	31	0	1	32	0	0
9	7228805	.	T	A	16	2	18	0	0	18	0	0
9	7229226	.	T	A	23	16	39	0	2	42	1	0
9	7229262	.	C	G	25	17	42	0	0	42	0	0
9	7229288	.	G	T	25	12	37	0	0	37	0	0
9	7229317	.	G	A	17	16	33	0	0	33	0	0
9	7229355	.	G	A	13	12	25	1	2	28	0	0
9	7234590	.	G	A	9	7	16	0	2	18	0	0
9	7234681	.	A	C	10	13	23	0	4	27	0	0
9	7241855	.	C	T	5	5	10	0	0	10	0	0
9	7241922	.	T	C	5	3	8	1	0	9	0	0
9	7242047	.	T	C	4	2	6	0	1	7	0	0
9	7242076	.	A	G	5	4	9	0	0	9	0	0
9	7242158	.	G	A	3	8	11	0	0	11	0	0
9	7242214	.	G	A	4	4	8	0	2	10	0	0
9	7244659	.	T	C	3	4	7	0	0	7	0	0
9	7244985	.	C	T	3	4	7	0	0	7	0	0
9	7245023	.	T	C	2	4	6	0	0	6	0	0
9	7245075	.	T	G	3	6	9	0	1	10	0	0
9	7245130	.	G	A	4	5	9	0	0	9	0	0
9	7245309	.	A	C	6	3	9	0	0	9	0	0
9	7245445	.	C	A	4	3	7	0	0	7	0	0
9	7245852	.	C	T	0	4	4	0	2	6	0	0
9	7248800	.	G	A	2	5	7	0	0	7	0	0
9	7249016	.	C	T	5	3	8	0	0	8	0	0
9	7249156	.	G	A	3	3	6	0	0	6	0	0
9	7249241	.	T	G	7	4	11	0	0	11	0	0
9	7249273	.	T	C	6	7	13	0	0	13	0	0
9	7249432	.	T	C	8	3	11	0	2	13	0	0
9	7252960	.	C	T	1	2	3	0	0	3	0	0
9	7252982	.	T	C	2	2	4	0	0	4	0	0
9	7253232	.	C	T	1	3	4	0	1	5	0	0
9	7253515	.	A	G	2	2	4	0	0	4	0	0
9	7253567	.	A	G	2	2	4	0	0	4	0	0
9	7253736	.	T	C	1	0	1	0	3	4	0	0
9	7255449	.	T	C	3	2	5	0	0	5	0	0
9	7282910	.	A	G	4	2	6	0	0	6	0	0
9	7283046	.	A	C	2	1	3	0	2	5	0	0
9	7287131	.	T	A	2	1	3	0	0	3	0	0
9	7410825	.	G	A	8	10	18	0	0	18	0	0
9	7410831	.	G	T	11	8	19	0	2	21	0	0
9	7410995	.	G	A	7	8	15	0	1	16	0	0
9	7415424	.	C	T	0	6	6	0	8	14	0	0
9	7415453	.	A	G	9	7	16	0	0	16	0	0
9	7433080	.	A	T	6	3	9	0	1	10	0	0
9	7456380	.	T	C	5	3	8	0	2	10	0	0
9	7488486	.	C	T	4	4	8	0	0	8	0	0
9	7488576	.	T	C	4	6	10	0	0	10	0	0
9	7488844	.	C	T	4	6	10	0	0	10	0	0
9	7499322	.	G	A	1	12	13	0	5	18	0	0
9	7909543	.	G	A	7	3	10	0	1	11	0	0
9	7909621	.	C	A	7	3	10	0	1	11	0	0
9	7976555	.	G	A	1	2	3	0	6	9	0	0
9	7981498	.	C	G	10	0	10	0	6	16	0	0
9	7995812	.	G	A	1	6	7	0	0	7	0	0
9	8011580	.	G	A	5	4	9	0	1	10	0	0
9	8064308	.	C	T	5	8	13	0	0	13	0	0
9	8090089	.	G	T	9	9	18	0	1	19	0	0
9	8090240	.	C	T	7	11	18	1	2	21	0	0
9	8114209	.	A	G	6	7	13	0	0	13	0	0
9	8121026	.	A	C	11	5	16	0	2	18	0	0
9	8121093	.	A	G	15	9	24	0	0	24	0	0
9	8121113	.	A	G	14	9	23	0	1	24	0	0
9	8121128	.	C	T	14	9	23	0	0	23	0	0
9	8121855	.	G	T	14	8	22	0	0	22	0	0
9	8121939	.	G	T	6	9	15	0	2	17	0	0
9	8122095	.	A	T	10	15	25	0	1	26	0	0
9	8122429	.	C	T	12	13	25	0	2	27	0	0
9	8128576	.	G	A	10	16	26	0	0	26	0	0
9	8429782	.	T	C	17	24	41	1	2	44	0	0
9	8430162	.	A	G	23	14	37	0	1	38	0	0
9	8430527	.	T	C	16	0	16	0	14	30	0	0
9	8430558	.	A	C	17	7	24	0	1	25	0	0
9	8430739	.	T	C	5	7	12	0	1	13	0	0
9	8430755	.	T	A	10	5	15	0	2	17	0	0
9	8430787	.	A	G	9	13	22	0	0	22	0	0
9	8430831	.	C	T	2	12	14	0	6	20	0	0
9	8430881	.	C	T	21	9	30	0	0	30	0	0
9	8430962	.	T	C	10	17	27	0	1	28	0	0
9	8431214	.	C	T	3	22	25	0	16	41	0	0
9	8432802	.	T	C	10	0	10	0	19	29	0	0
9	8432996	.	G	A	20	13	33	0	0	33	0	0
9	8433189	.	C	T	19	13	32	0	1	33	0	0
9	8433205	.	G	A	11	21	32	0	0	32	0	0
9	8451265	.	G	A	8	6	14	0	1	15	0	0
9	8451312	.	A	G	10	9	19	0	0	19	0	0
9	8451386	.	C	T	0	7	7	0	12	19	0	0
9	8451633	.	G	A	12	17	29	0	2	31	0	0
9	8452099	.	T	C	11	0	11	0	10	21	0	0
9	8452339	.	C	T	9	12	21	0	1	22	0	0
9	8452405	.	T	C	12	0	12	0	14	26	0	0
9	8452465	.	G	A	13	9	22	0	0	22	0	0
9	8452546	.	A	G	11	12	23	0	1	24	0	0
9	8452627	.	G	A	12	6	18	0	1	19	0	0
9	8453035	.	G	A	8	8	16	0	0	16	0	0
9	8888379	.	C	T	4	3	7	0	0	7	0	0
9	8898196	.	G	A	0	4	4	0	4	8	0	0
9	8898403	.	T	C	1	3	4	0	0	4	0	0
9	8898903	.	C	A	6	3	9	0	0	9	0	0
9	8898906	.	G	A	3	5	8	0	2	10	0	0
9	8899948	.	G	A	1	8	9	0	7	16	0	0
9	8899974	.	A	G	10	11	21	0	0	21	0	0
9	8903523	.	G	C	8	11	19	0	0	19	0	0
9	8904032	.	C	T	13	11	24	0	0	24	0	0
9	8910116	.	A	T	5	13	18	0	0	18	0	0
9	8923188	.	A	T	3	12	15	0	0	16	1	0
9	8929848	.	G	T	9	8	17	0	0	17	0	0
9	8929905	.	G	A	1	13	14	0	7	21	0	0
9	8964925	.	G	T	18	12	30	0	1	31	0	0
9	8964997	.	C	T	3	3	6	0	0	6	0	0
9	8965027	.	A	G	6	5	11	0	0	11	0	0
9	8967442	.	G	A	11	18	29	0	2	31	0	0
9	8969067	.	C	T	14	12	26	0	0	26	0	0
9	8969571	.	T	C	15	14	29	0	1	30	0	0
9	8971713	.	G	A	17	24	41	0	1	42	0	0
9	8971984	.	T	G	19	0	19	0	16	35	0	0
9	8972340	.	C	G	21	16	37	1	0	38	0	0
9	8972429	.	T	A	17	12	29	0	0	29	0	0
9	8972468	.	A	G	11	12	23	0	4	27	0	0
9	8972601	.	G	A	13	12	25	0	2	27	0	0
9	8973335	.	T	G	7	8	15	0	0	15	0	0
9	8973581	.	G	A	3	2	5	0	0	5	0	0
9	8973627	.	C	A	3	2	5	0	1	6	0	0
9	8973629	.	G	A	3	2	5	0	0	5	0	0
9	8974152	.	G	A	6	5	11	0	2	13	0	0
9	8974221	.	T	C	11	4	15	0	0	15	0	0
9	8974509	.	G	A	10	4	14	0	1	15	0	0
9	8978881	.	T	A	4	7	11	0	0	11	0	0
9	9113008	.	A	G	6	3	9	0	0	9	0	0
9	9116101	.	C	T	4	15	19	0	0	19	0	0
9	9116845	.	C	A	5	6	11	0	1	12	0	0
9	9117542	.	T	C	11	9	20	0	1	21	0	0
9	9118701	.	A	G	5	3	8	0	1	9	0	0
9	9119417	.	C	T	15	7	22	0	2	24	0	0
9	9119546	.	A	G	1	4	5	0	0	5	0	0
9	9119671	.	G	C	7	11	18	0	0	18	0	0
9	9119755	.	G	T	11	4	15	0	0	15	0	0
9	9119771	.	T	A	6	6	12	0	1	13	0	0
9	9119830	.	A	T	6	3	9	0	0	9	0	0
9	9119877	.	G	A	7	6	13	0	1	14	0	0
9	9119937	.	G	A	4	4	8	0	0	8	0	0
9	9120185	.	A	G	7	8	15	0	2	17	0	0
9	9121917	.	A	T	13	7	20	0	1	21	0	0
9	9183768	.	C	A	8	13	21	0	0	21	0	0
9	9183784	.	A	T	13	8	21	0	1	22	0	0
9	9183848	.	C	A	0	15	15	0	10	25	0	0
9	9183874	.	C	T	9	11	20	0	0	20	0	0
9	9184092	.	G	A	14	18	32	0	1	33	0	0
9	9184177	.	G	A	19	23	42	0	1	43	0	0
9	9184397	.	G	A	11	19	30	0	0	30	0	0
9	9184536	.	T	C	10	13	23	0	0	23	0	0
9	9184566	.	G	A	9	15	24	0	1	25	0	0
9	9195964	.	C	T	19	17	36	2	4	42	0	0
9	9198139	.	A	G	18	18	36	0	1	37	0	0
9	9198208	.	G	A	11	16	27	0	2	29	0	0
9	9202668	.	T	C	14	11	25	0	2	27	0	0
9	9205089	.	G	A	13	13	26	0	0	26	0	0
9	9208714	.	C	A	9	16	25	0	2	27	0	0
9	9208786	.	G	A	19	9	28	0	0	28	0	0
9	9235825	.	G	C	20	1	21	0	18	39	0	0
9	9235849	.	T	C	19	2	21	0	29	50	0	0
9	9241683	.	A	G	22	20	42	0	2	44	0	0
9	9322544	.	T	G	2	2	4	0	0	4	0	0
9	9322661	.	C	A	8	11	19	0	1	20	0	0
9	9322664	.	A	G	8	11	19	0	1	20	0	0
9	9322782	.	C	G	0	11	11	0	10	21	0	0
9	9322795	.	A	G	11	14	25	0	1	26	0	0
9	9323489	.	G	T	11	12	23	0	0	23	0	0
9	9327588	.	G	A	6	7	13	0	0	13	0	0
9	9327705	.	C	T	8	4	12	0	0	12	0	0
9	9345329	.	A	G	6	11	17	0	0	17	0	0
9	9345478	.	A	G	4	5	9	0	1	10	0	0
9	9345748	.	G	T	8	10	18	0	0	18	0	0
9	9542914	.	G	A	1	3	4	0	0	4	0	0
9	9542938	.	T	G	3	3	6	0	0	6	0	0
9	9545016	.	C	T	1	4	5	0	0	5	0	0
9	9545023	.	C	T	2	4	6	0	0	6	0	0
9	9555267	.	G	C	2	4	6	0	0	6	0	0
9	9562158	.	T	A	1	4	5	0	1	6	0	0
9	9578598	.	G	T	19	20	39	0	2	41	0	0
9	9578829	.	T	A	18	18	36	0	2	38	0	0
9	9578880	.	G	A	24	17	41	0	0	41	0	0
9	9579027	.	C	A	22	23	45	0	2	47	0	0
9	9579033	.	T	C	19	2	21	0	24	45	0	0
9	9579076	.	G	C	19	16	35	0	0	35	0	0
9	9579078	.	A	T	20	15	35	0	1	36	0	0
9	9579297	.	G	C	19	13	32	0	1	33	0	0
9	9579653	.	G	A	13	12	25	0	0	25	0	0
9	9580103	.	G	A	21	16	37	0	0	37	0	0
9	9592761	.	G	A	17	12	29	0	2	31	0	0
9	9592779	.	C	A	18	12	30	0	2	32	0	0
9	9599452	.	A	G	12	4	16	1	1	18	0	0
9	9670925	.	G	C	6	8	14	0	0	14	0	0
9	9671134	.	G	T	7	7	14	0	0	14	0	0
9	9676583	.	C	T	1	3	4	0	0	4	0	0
9	9676584	.	T	G	1	3	4	0	0	4	0	0
9	9679897	.	A	G	1	2	3	0	0	3	0	0
9	9679910	.	A	T	1	2	3	0	0	3	0	0
9	9719264	.	A	G	3	3	6	0	0	6	0	0
9	9719349	.	G	A	1	2	3	0	0	3	0	0
9	9719685	.	A	G	2	3	5	0	1	6	0	0
9	9731796	.	A	C	3	0	3	0	2	5	0	0
9	9731811	.	A	G	3	3	6	0	0	6	0	0
9	9732015	.	C	T	1	2	3	0	0	3	0	0
9	9735639	.	T	A	1	2	3	0	0	3	0	0
9	9736317	.	G	T	9	12	21	0	1	22	0	0
9	9736406	.	C	A	13	9	22	0	0	22	0	0
9	9736436	.	G	T	16	7	23	0	2	25	0	0
9	9736653	.	C	G	10	2	12	0	0	12	0	0
9	9736684	.	C	T	0	4	4	0	6	10	0	0
9	9736689	.	A	C	5	5	10	0	0	10	0	0
9	9736727	.	A	G	1	8	9	0	0	9	0	0
9	9736815	.	T	A	5	10	15	0	0	15	0	0
9	9736870	.	T	G	2	11	13	0	1	14	0	0
9	9736918	.	G	C	5	12	17	0	1	18	0	0
9	9737060	.	T	G	6	5	11	0	0	11	0	0
9	9737219	.	C	G	9	9	18	0	0	18	0	0
9	9737248	.	G	A	8	10	18	0	0	18	0	0
9	9737432	.	A	T	8	8	16	0	1	17	0	0
9	9737437	.	T	C	8	0	8	0	8	16	0	0
9	9737592	.	T	A	7	8	15	0	2	17	0	0
9	9738021	.	A	T	3	3	6	0	0	6	0	0
9	9738078	.	G	C	10	4	14	0	0	14	0	0
9	9738137	.	T	A	13	2	15	0	0	15	0	0
9	9738158	.	T	G	11	3	14	0	0	14	0	0
9	9738174	.	G	A	8	4	12	0	0	12	0	0
9	9738304	.	C	T	0	4	4	0	6	10	0	0
9	9738325	.	A	T	8	7	15	0	1	16	0	0
9	9738357	.	T	C	12	0	12	0	7	19	0	0
9	9738449	.	C	T	3	7	10	0	0	11	1	0
9	9738450	.	T	A	4	7	11	0	0	11	0	0
9	9738629	.	C	T	1	7	8	0	2	10	0	0
9	9738671	.	C	A	3	5	8	0	0	8	0	0
9	9738707	.	G	A	7	3	10	0	0	10	0	0
9	9738739	.	A	G	6	8	14	0	0	14	0	0
9	9738758	.	T	A	3	7	10	0	0	10	0	0
9	9738857	.	A	C	4	3	7	0	0	7	0	0
9	9743579	.	T	A	7	7	14	0	0	14	0	0
9	9751476	.	A	T	6	6	12	0	0	12	0	0
9	10153234	.	A	T	2	2	4	0	0	4	0	0
9	10239519	.	G	A	5	2	7	0	0	7	0	0
9	13783810	.	A	C	2	0	2	0	15	17	0	0
9	13783816	.	A	C	3	2	5	0	6	11	0	0
9	14411627	.	G	A	7	2	9	0	0	9	0	0
9	16853232	.	T	C	5	0	5	0	4	9	0	0
9	16867634	.	C	T	8	7	15	0	0	15	0	0
9	16867646	.	G	A	6	6	12	0	2	14	0	0
9	16867806	.	A	G	12	5	17	0	1	18	0	0
9	16867909	.	A	G	22	12	34	0	1	35	0	0
9	16868233	.	A	G	22	10	32	0	0	32	0	0
9	16868242	.	G	A	21	10	31	0	0	31	0	0
9	16868326	.	T	C	16	0	16	0	12	28	0	0
9	16872592	.	G	A	6	6	12	0	2	14	0	0
9	16872764	.	T	C	16	6	22	0	0	22	0	0
9	16872767	.	T	C	16	5	21	0	1	22	0	0
9	16877287	.	C	T	9	7	16	0	3	19	0	0
9	16877408	.	G	A	14	12	26	0	2	28	0	0
9	16877518	.	A	G	6	3	9	0	0	9	0	0
9	17046020	.	T	C	17	20	37	0	2	39	0	0
9	17046736	.	A	G	21	13	34	0	1	35	0	0
9	17047014	.	A	G	22	13	35	2	3	40	0	0
9	17057365	.	T	C	13	20	33	0	4	37	0	0
9	17060311	.	G	A	15	14	29	0	0	29	0	0
9	17067934	.	C	T	12	21	33	0	2	35	0	0
9	17068057	.	T	G	22	14	36	0	1	37	0	0
9	17073498	.	T	C	17	13	30	0	2	32	0	0
9	17074714	.	T	C	16	9	25	0	0	25	0	0
9	17074720	.	T	C	14	8	22	0	0	22	0	0
9	17074792	.	G	A	17	15	32	0	0	32	0	0
9	17077376	.	A	G	11	16	27	0	1	28	0	0
9	17077430	.	C	T	0	16	16	0	10	26	0	0
9	17077439	.	A	G	12	18	30	0	1	31	0	0
9	17080224	.	G	T	19	14	33	0	2	35	0	0
9	17080517	.	G	A	7	15	22	0	1	23	0	0
9	17080970	.	A	G	11	7	18	0	1	19	0	0
9	17082273	.	A	T	19	14	33	0	1	34	0	0
9	17082926	.	G	T	12	8	20	0	0	20	0	0
9	17083053	.	G	A	11	8	19	0	1	20	0	0
9	17083221	.	T	C	10	9	19	0	1	20	0	0
9	17083278	.	G	A	16	12	28	0	1	29	0	0
9	17083296	.	T	A	14	16	30	0	0	30	0	0
9	17083434	.	C	T	13	11	24	0	2	26	0	0
9	17083581	.	G	T	10	7	17	0	0	17	0	0
9	17083908	.	T	C	11	0	11	0	17	29	1	0
9	17083989	.	G	A	9	11	20	0	0	20	0	0
9	17084127	.	T	C	8	0	8	0	7	15	0	0
9	17084229	.	T	C	13	1	14	0	9	23	0	0
9	17084253	.	G	A	14	7	21	0	3	24	0	0
9	17094362	.	A	T	11	5	16	0	0	16	0	0
9	17119143	.	G	A	6	7	13	0	0	13	0	0
9	17119789	.	G	A	6	6	12	0	1	13	0	0
9	17119982	.	A	G	8	3	11	0	1	12	0	0
9	17127011	.	G	T	7	5	12	0	0	12	0	0
9	17127025	.	C	T	8	6	14	0	1	15	0	0
9	17129876	.	A	G	3	4	7	0	0	7	0	0
9	17130282	.	G	A	7	3	10	0	0	10	0	0
9	17139140	.	A	C	5	2	7	0	0	7	0	0
9	17139350	.	A	T	2	5	7	0	0	8	1	0
9	17139378	.	T	C	4	0	4	0	6	10	0	0
9	17145472	.	T	C	8	5	13	0	0	13	0	0
9	17145508	.	T	C	11	5	16	0	0	16	0	0
9	17148204	.	G	A	4	6	10	0	1	11	0	0
9	17163711	.	A	C	3	0	3	0	6	9	0	0
9	17167397	.	A	T	1	3	4	0	1	5	0	0
9	17169110	.	C	T	6	6	12	0	0	12	0	0
9	17169406	.	G	C	5	1	6	0	6	12	0	0
9	17169430	.	A	C	4	5	9	0	0	9	0	0
9	17169681	.	G	A	8	7	15	0	0	15	0	0
9	17169741	.	G	C	5	3	8	0	0	8	0	0
9	17182513	.	C	T	4	8	12	0	0	12	0	0
9	17193186	.	A	G	7	5	12	0	0	12	0	0
9	17219850	.	A	G	1	3	4	0	1	5	0	0
9	17221884	.	T	C	3	2	5	0	1	6	0	0
9	17248228	.	A	G	5	5	10	0	0	10	0	0
9	17248464	.	G	T	4	4	8	0	0	8	0	0
9	17315397	.	T	C	1	2	3	0	0	3	0	0
9	17349073	.	T	C	3	5	8	0	3	11	0	0
9	17349103	.	G	T	0	3	3	0	8	11	0	0
9	17349125	.	G	A	2	5	7	0	6	13	0	0
9	17349272	.	C	T	5	8	13	0	0	13	0	0
9	17364337	.	C	G	12	8	20	0	0	20	0	0
9	17365117	.	C	T	9	4	13	0	1	14	0	0
9	17365231	.	G	A	6	8	14	0	0	14	0	0
9	17368889	.	A	C	15	14	29	0	0	29	0	0
9	17368904	.	C	T	14	11	25	0	0	25	0	0
9	17369071	.	G	A	8	14	22	0	2	24	0	0
9	17378203	.	A	G	14	11	25	0	0	25	0	0
9	17379954	.	C	T	15	16	31	0	1	32	0	0
9	17386152	.	C	A	4	3	7	0	2	9	0	0
9	17386154	.	C	T	4	4	8	0	1	9	0	0
9	17386338	.	A	G	5	0	5	0	6	11	0	0
9	17386341	.	G	T	4	6	10	0	0	10	0	0
9	17423947	.	C	T	1	3	4	0	1	5	0	0
9	17424198	.	T	C	1	2	3	0	0	3	0	0
9	17424639	.	T	G	1	2	3	0	1	4	0	0
9	17425308	.	T	C	3	2	5	0	0	5	0	0
9	17431499	.	T	C	2	4	6	0	0	6	0	0
9	17431798	.	A	G	3	8	11	0	0	11	0	0
9	17431818	.	C	T	3	9	12	0	0	12	0	0
9	17431925	.	A	T	2	4	6	0	1	7	0	0
9	17431938	.	A	G	2	3	5	0	0	5	0	0
9	17432023	.	T	C	3	4	7	0	0	7	0	0
9	17432068	.	A	C	2	6	8	0	1	9	0	0
9	17432155	.	C	T	2	5	7	0	0	7	0	0
9	17432170	.	T	C	2	3	5	0	0	5	0	0
9	17432297	.	G	T	3	2	5	0	1	6	0	0
9	17432484	.	C	A	2	3	5	0	0	5	0	0
9	17432962	.	A	C	3	4	7	0	0	7	0	0
9	17433794	.	G	C	1	5	6	0	0	6	0	0
9	17433983	.	T	G	3	4	7	0	1	8	0	0
9	17445217	.	A	G	7	17	24	0	0	24	0	0
9	17445268	.	T	C	9	20	29	0	1	30	0	0
9	17540619	.	A	G	3	2	5	0	0	5	0	0
9	17540692	.	A	C	4	3	7	0	0	7	0	0
9	17540701	.	T	C	2	3	5	0	0	5	0	0
9	17548502	.	T	C	8	2	10	1	1	12	0	0
9	17560343	.	A	G	6	4	10	0	0	10	0	0
9	17563067	.	C	T	3	4	7	0	0	7	0	0
9	17583192	.	G	A	5	8	13	0	1	14	0	0
9	17646993	.	G	T	5	4	9	0	0	9	0	0
9	17668432	.	T	C	1	3	4	0	2	6	0	0
9	17668443	.	T	C	3	3	6	0	2	8	0	0
9	17747795	.	T	C	3	0	3	0	3	6	0	0
9	17770972	.	A	G	1	3	4	0	0	4	0	0
9	17899179	.	G	A	1	9	10	0	10	20	0	0
9	17907587	.	A	T	8	6	14	0	1	15	0	0
9	17907768	.	G	A	5	4	9	0	1	10	0	0
9	17908898	.	A	G	10	3	13	0	0	13	0	0
9	17908958	.	A	C	14	10	24	0	0	24	0	0
9	17912372	.	C	G	9	7	16	0	1	17	0	0
9	17918428	.	A	G	8	6	14	0	1	15	0	0
9	17918485	.	A	G	7	8	15	0	0	15	0	0
9	17918681	.	G	A	3	7	10	1	0	11	0	0
9	17922172	.	T	A	13	15	28	0	1	29	0	0
9	17922191	.	G	C	13	12	25	0	1	26	0	0
9	17934202	.	T	G	8	12	20	0	0	20	0	0
9	17979350	.	A	C	11	14	25	0	0	25	0	0
9	17979389	.	G	A	13	6	19	0	2	21	0	0
9	17984914	.	G	T	3	5	8	0	0	8	0	0
9	17987998	.	A	G	12	17	29	0	1	30	0	0
9	17988011	.	C	A	11	16	27	0	1	28	0	0
9	17988072	.	A	C	11	12	23	0	3	26	0	0
9	17988091	.	A	G	16	9	25	0	2	27	0	0
9	18001161	.	T	G	20	20	40	0	1	41	0	0
9	18001200	.	A	C	23	22	45	0	0	45	0	0
9	18003664	.	T	C	21	23	44	0	0	44	0	0
9	18003684	.	C	G	17	20	37	0	2	39	0	0
9	18003807	.	C	T	14	23	37	0	2	40	1	0
9	18003856	.	T	G	24	0	24	0	20	44	0	0
9	18004476	.	A	C	18	19	37	0	3	41	1	0
9	18005023	.	C	T	17	16	33	0	1	34	0	0
9	18005065	.	C	T	16	23	39	0	0	39	0	0
9	18005217	.	A	T	10	19	29	0	1	30	0	0
9	18005245	.	T	C	14	18	32	0	0	32	0	0
9	18005507	.	C	T	14	17	31	0	2	33	0	0
9	18005806	.	A	G	23	9	32	0	0	32	0	0
9	18005864	.	G	A	13	23	36	0	0	36	0	0
9	18005879	.	T	A	14	18	32	0	4	36	0	0
9	18005977	.	T	C	21	18	39	0	1	40	0	0
9	18006144	.	T	A	24	16	40	0	3	44	1	0
9	18006282	.	C	T	23	37	60	0	1	61	0	0
9	18229592	.	A	G	12	1	13	0	13	26	0	0
9	18235383	.	A	G	13	17	30	0	1	31	0	0
9	18278110	.	C	T	5	7	12	0	1	13	0	0
9	18310309	.	G	A	12	8	20	0	1	21	0	0
9	18320009	.	G	A	15	7	22	0	0	22	0	0
9	18333107	.	A	G	17	13	30	0	1	31	0	0
9	18390631	.	T	C	3	4	7	0	0	7	0	0
9	18392777	.	T	G	6	4	10	0	1	11	0	0
9	18392903	.	C	A	5	5	10	0	0	10	0	0
9	18392924	.	G	A	4	4	8	0	0	8	0	0
9	18424739	.	A	T	6	3	9	0	0	9	0	0
9	18568860	.	C	T	0	12	12	0	8	20	0	0
9	18732878	.	C	T	2	26	28	0	26	54	0	0
9	18732899	.	G	A	22	31	53	0	1	54	0	0
9	18733592	.	T	C	32	1	33	0	35	68	0	0
9	18735081	.	A	G	24	24	48	0	1	49	0	0
9	18812765	.	A	G	7	6	13	0	3	16	0	0
9	18812960	.	A	G	12	10	22	0	4	26	0	0
9	18813462	.	G	A	13	11	24	0	2	26	0	0
9	18813467	.	A	G	14	10	24	0	1	25	0	0
9	18813624	.	G	A	5	7	12	0	1	13	0	0
9	18813650	.	T	C	4	8	12	0	0	12	0	0
9	18813755	.	T	C	7	5	12	0	0	12	0	0
9	18814056	.	C	T	4	5	9	0	0	9	0	0
9	18814328	.	A	G	5	8	13	0	0	13	0	0
9	18814379	.	A	G	3	8	11	0	0	11	0	0
9	18814598	.	T	C	11	4	15	0	3	18	0	0
9	18876332	.	A	T	17	12	29	0	2	31	0	0
9	18876545	.	G	T	22	15	37	0	0	37	0	0
9	18876937	.	C	G	1	21	22	0	18	40	0	0
9	18877051	.	G	A	17	20	37	0	1	38	0	0
9	18877078	.	G	A	15	19	34	0	2	36	0	0
9	18877485	.	T	C	10	0	10	0	25	35	0	0
9	18909235	.	A	T	8	3	11	0	1	12	0	0
9	18909242	.	A	T	9	3	12	0	0	12	0	0
9	18909748	.	A	C	5	5	10	0	1	11	0	0
9	18911575	.	G	A	3	3	6	0	0	6	0	0
9	19027536	.	T	A	4	3	7	0	0	7	0	0
9	19027560	.	G	C	5	2	7	0	0	7	0	0
9	19027582	.	A	T	3	2	5	0	0	5	0	0
9	19027630	.	T	A	3	3	6	0	1	7	0	0
9	19027637	.	G	T	4	3	7	0	0	7	0	0
9	19027748	.	T	C	6	4	10	0	0	10	0	0
9	19057840	.	A	G	2	0	2	0	3	5	0	0
9	19074628	.	T	C	4	5	9	0	1	10	0	0
9	19074642	.	G	T	5	3	8	0	0	8	0	0
9	19074687	.	G	A	2	4	6	0	0	6	0	0
9	19074800	.	A	G	5	2	7	0	0	7	0	0
9	19075144	.	A	T	3	6	9	0	0	9	0	0
9	19080384	.	G	A	2	3	5	0	0	5	0	0
9	19101750	.	G	C	1	2	3	0	0	3	0	0
9	19101759	.	A	G	1	2	3	0	0	3	0	0
9	19109043	.	C	T	5	1	6	0	1	7	0	0
9	19114304	.	C	T	2	3	5	0	0	5	0	0
9	19118853	.	T	C	5	6	11	0	0	11	0	0
9	19118903	.	T	G	4	1	5	0	7	12	0	0
9	19118929	.	G	A	3	6	9	0	3	12	0	0
9	19118990	.	G	A	4	8	12	0	0	12	0	0
9	19119000	.	G	A	5	8	13	0	0	13	0	0
9	19119185	.	T	C	5	4	9	0	0	9	0	0
9	19119214	.	A	G	2	5	7	0	0	7	0	0
9	19119285	.	T	C	6	7	13	0	0	13	0	0
9	19308066	.	T	G	1	3	4	0	0	4	0	0
9	19364025	.	G	A	3	3	6	0	0	6	0	0
9	19366353	.	A	T	1	3	4	0	0	4	0	0
9	19368235	.	T	C	2	3	5	0	0	5	0	0
9	19368270	.	A	T	1	2	3	0	1	4	0	0
9	19368286	.	A	G	2	0	2	0	2	4	0	0
9	19401830	.	C	T	1	3	4	5	0	9	0	0
9	19405943	.	A	G	1	0	1	3	3	7	0	0
9	19405989	.	C	G	4	0	4	0	3	7	0	0
9	19406425	.	T	A	7	3	10	0	1	11	0	0
9	19407614	.	G	T	3	2	5	0	0	5	0	0
9	19408248	.	A	G	2	2	4	0	0	4	0	0
9	19408327	.	C	G	6	5	11	0	0	11	0	0
9	19408345	.	G	A	6	5	11	0	0	11	0	0
9	19421855	.	T	C	5	2	7	0	1	8	0	0
9	19442787	.	T	C	3	5	8	0	1	9	0	0
9	19442817	.	A	C	3	7	10	0	1	11	0	0
9	19469175	.	C	T	1	4	5	0	0	5	0	0
9	19471377	.	A	G	9	8	17	0	1	18	0	0
9	19477979	.	A	G	2	3	5	0	0	5	0	0
9	19480893	.	T	C	2	2	4	0	0	4	0	0
9	19490058	.	G	C	20	10	30	0	1	31	0	0
9	19504678	.	C	T	24	12	36	0	0	36	0	0
9	19510730	.	T	G	12	11	23	0	1	24	0	0
9	19510773	.	A	G	11	17	28	0	1	29	0	0
9	19518690	.	A	T	4	2	6	0	0	6	0	0
9	19527883	.	T	C	13	16	29	0	1	30	0	0
9	19534822	.	A	T	10	6	16	0	0	16	0	0
9	19534824	.	A	G	10	1	11	0	5	16	0	0
9	19539222	.	C	T	10	3	13	0	0	13	0	0
9	19539770	.	C	A	9	11	20	0	0	20	0	0
9	19539800	.	T	C	5	11	16	2	2	20	0	0
9	19539840	.	T	C	3	9	12	2	1	15	0	0
9	19545511	.	T	G	8	5	13	0	0	13	0	0
9	19545529	.	T	C	7	5	12	0	0	12	0	0
9	19545550	.	T	C	8	4	12	0	1	13	0	0
9	19549346	.	A	G	9	0	9	0	5	14	0	0
9	19549349	.	G	C	9	5	14	0	0	14	0	0
9	19549790	.	G	T	0	4	4	0	8	12	0	0
9	19549958	.	C	A	6	5	11	0	0	11	0	0
9	19549989	.	G	A	4	5	9	0	0	9	0	0
9	19623699	.	A	G	1	5	6	0	1	7	0	0
9	19623931	.	T	C	5	5	10	0	1	11	0	0
9	19636514	.	G	A	1	8	9	0	4	13	0	0
9	19639402	.	A	G	3	7	10	0	1	11	0	0
9	19639420	.	T	G	4	5	9	0	1	10	0	0
9	19640924	.	G	A	1	3	4	0	2	6	0	0
9	19640933	.	T	A	2	3	5	0	1	6	0	0
9	19642724	.	T	C	3	10	13	0	0	13	0	0
9	19653115	.	G	A	7	3	10	0	0	10	0	0
9	19653130	.	T	A	8	4	12	0	0	12	0	0
9	19696586	.	G	A	2	4	6	0	0	6	0	0
9	19696593	.	G	A	2	5	7	0	0	7	0	0
9	19696698	.	T	C	1	0	1	0	2	3	0	0
9	20076691	.	G	C	12	12	24	0	1	25	0	0
9	20076799	.	A	G	7	12	19	0	0	19	0	0
9	20076847	.	A	G	9	15	24	0	0	24	0	0
9	20076850	.	A	G	10	15	25	0	0	25	0	0
9	20076913	.	T	C	9	1	10	0	27	37	0	0
9	20078034	.	G	A	18	12	30	0	2	32	0	0
9	20095725	.	C	G	9	12	21	0	1	22	0	0
9	20160291	.	T	A	12	11	23	0	0	23	0	0
9	20160387	.	C	T	12	8	20	0	1	21	0	0
9	20174733	.	G	C	5	6	11	0	0	11	0	0
9	20191222	.	A	T	3	3	6	0	1	7	0	0
9	20191377	.	T	C	2	0	2	0	6	8	0	0
9	20191488	.	C	A	10	3	13	0	0	13	0	0
9	20315458	.	G	C	6	6	12	0	1	13	0	0
9	20315497	.	A	G	8	4	12	0	0	12	0	0
9	20315614	.	A	G	8	6	14	0	2	16	0	0
9	20372940	.	C	T	3	3	6	0	0	6	0	0
9	20498630	.	A	T	2	3	5	0	0	5	0	0
9	20498644	.	T	G	3	2	5	0	0	5	0	0
9	20498690	.	A	G	5	3	8	0	0	8	0	0
9	20498985	.	A	C	1	2	3	0	0	3	0	0
9	20499502	.	T	A	2	3	5	0	0	5	0	0
9	20499727	.	T	C	4	3	7	0	0	7	0	0
9	20499758	.	G	A	7	4	11	0	0	11	0	0
9	20499897	.	C	T	5	2	7	0	0	7	0	0
9	20499918	.	C	T	3	1	4	0	0	4	0	0
9	20500337	.	A	C	5	1	6	0	0	6	0	0
9	20500347	.	G	A	4	2	6	0	0	6	0	0
9	20623998	.	G	A	12	8	20	0	2	22	0	0
9	20700073	.	T	C	5	7	12	0	0	12	0	0
9	20700130	.	T	C	8	3	11	0	0	11	0	0
9	20731284	.	G	A	2	10	12	1	7	20	0	0
9	20731311	.	A	G	6	11	17	0	0	17	0	0
9	20763517	.	C	T	14	20	34	0	6	40	0	0
9	20763564	.	C	T	15	26	41	0	0	41	0	0
9	20763585	.	C	T	18	21	39	0	0	39	0	0
9	20763877	.	C	T	9	10	19	0	1	20	0	0
9	20763907	.	A	T	14	12	26	0	1	27	0	0
9	20764019	.	T	A	15	14	29	0	1	30	0	0
9	20764276	.	A	G	20	0	20	0	16	36	0	0
9	20764685	.	C	T	12	8	20	0	1	21	0	0
9	20764795	.	T	A	6	8	14	0	2	16	0	0
9	20764877	.	T	C	22	6	28	0	0	28	0	0
9	20765065	.	T	A	12	1	13	0	2	15	0	0
9	20765104	.	A	G	11	5	16	1	1	18	0	0
9	20765131	.	C	A	8	4	12	0	0	12	0	0
9	20765193	.	A	G	9	14	23	0	0	23	0	0
9	20806460	.	T	C	2	0	2	0	3	5	0	0
9	20806648	.	A	T	10	5	15	0	0	15	0	0
9	20806657	.	A	G	10	8	18	0	0	18	0	0
9	20806925	.	C	T	6	7	13	0	0	13	0	0
9	20806942	.	C	T	5	7	12	0	0	12	0	0
9	20807171	.	C	T	7	2	9	0	1	10	0	0
9	20807216	.	T	C	8	0	8	0	6	14	0	0
9	20826146	.	T	C	3	0	3	0	8	11	0	0
9	20831162	.	T	G	9	6	15	0	0	15	0	0
9	20831177	.	A	G	7	5	12	0	1	13	0	0
9	20846506	.	A	G	4	4	8	0	0	8	0	0
9	20846566	.	C	T	2	3	5	0	0	5	0	0
9	20849415	.	G	A	3	4	7	0	0	7	0	0
9	20850584	.	A	G	3	7	10	0	0	10	0	0
9	20850693	.	G	A	1	2	3	0	0	3	0	0
9	20859226	.	A	T	1	2	3	0	1	4	0	0
9	20859690	.	A	G	1	2	3	0	0	3	0	0
9	20860161	.	G	C	6	3	9	0	0	9	0	0
9	20863342	.	T	C	2	6	8	0	0	8	0	0
9	20868978	.	T	A	5	7	12	0	0	12	0	0
9	20869156	.	G	T	1	3	4	0	0	4	0	0
9	20870520	.	T	C	1	2	3	0	0	3	0	0
9	20870521	.	T	C	1	2	3	0	0	3	0	0
9	20870779	.	T	C	5	9	14	1	0	15	0	0
9	20872390	.	G	A	2	2	4	0	1	5	0	0
9	20872435	.	A	G	1	2	3	0	0	3	0	0
9	21072922	.	T	C	4	6	10	0	0	10	0	0
9	21084858	.	A	C	2	4	6	0	0	6	0	0
9	21084894	.	G	C	2	3	5	0	0	5	0	0
9	21203845	.	T	A	1	2	3	0	0	3	0	0
9	21203969	.	G	A	4	2	6	0	1	7	0	0
9	21204063	.	T	G	2	2	4	0	0	4	0	0
9	21204244	.	T	G	7	11	18	0	0	18	0	0
9	21205138	.	A	G	6	7	13	0	0	13	0	0
9	21216897	.	T	C	9	13	22	0	1	23	0	0
9	21216898	.	T	C	9	13	22	0	1	23	0	0
9	21217438	.	A	G	4	9	13	0	0	13	0	0
9	21221874	.	G	A	11	12	23	0	0	23	0	0
9	21221932	.	T	A	8	18	26	0	1	27	0	0
9	21222749	.	G	A	2	23	25	0	7	32	0	0
9	21222750	.	T	A	6	25	31	0	0	31	0	0
9	21222807	.	G	A	1	21	22	0	3	25	0	0
9	21224505	.	A	G	6	0	6	0	8	14	0	0
9	21224671	.	A	C	5	9	14	0	0	14	0	0
9	21224703	.	T	C	9	11	20	0	0	20	0	0
9	21224753	.	G	A	5	15	20	0	0	20	0	0
9	21224768	.	T	G	6	15	21	0	1	22	0	0
9	21224963	.	T	C	6	12	18	0	0	18	0	0
9	21225011	.	C	A	3	13	16	0	1	17	0	0
9	21225461	.	C	A	2	6	8	0	1	9	0	0
9	21225503	.	G	T	0	3	3	0	1	4	0	0
9	21225550	.	G	A	2	4	6	0	0	6	0	0
9	21225761	.	T	A	2	3	5	0	0	5	0	0
9	21225987	.	C	A	2	6	8	0	0	8	0	0
9	21235770	.	A	T	5	9	14	0	1	15	0	0
9	21266854	.	A	G	14	13	27	0	0	27	0	0
9	21266878	.	C	T	2	12	14	0	13	27	0	0
9	21267097	.	T	A	24	26	50	0	2	52	0	0
9	21267133	.	C	T	17	26	43	0	2	45	0	0
9	21271539	.	G	T	2	2	4	0	0	4	0	0
9	21271573	.	C	G	4	4	8	0	0	8	0	0
9	21271647	.	C	T	1	5	6	0	0	6	0	0
9	21272448	.	C	T	1	2	3	1	0	4	0	0
9	21272496	.	A	C	1	2	3	1	0	4	0	0
9	21272498	.	A	T	1	2	3	0	0	3	0	0
9	21273105	.	C	A	2	3	5	0	0	5	0	0
9	21273348	.	C	A	1	2	3	0	0	3	0	0
9	21297887	.	T	C	1	3	4	0	0	4	0	0
9	21339110	.	C	T	1	2	3	0	0	3	0	0
9	21341312	.	C	T	1	3	4	0	0	4	0	0
9	21342427	.	T	G	6	3	9	0	0	9	0	0
9	21345506	.	A	G	3	3	6	0	0	6	0	0
9	21347189	.	G	T	4	4	8	0	0	8	0	0
9	21347234	.	G	A	2	2	4	0	0	4	0	0
9	21349540	.	C	T	4	2	6	0	0	6	0	0
9	21351552	.	C	T	5	3	8	0	0	8	0	0
9	21356621	.	G	A	0	3	3	0	4	7	0	0
9	21357526	.	A	C	1	3	4	0	1	5	0	0
9	21358995	.	C	T	3	2	5	2	2	9	0	0
9	21361507	.	C	T	3	4	7	0	0	7	0	0
9	21361564	.	A	C	2	4	6	0	0	7	1	0
9	21362858	.	A	G	2	4	6	0	0	6	0	0
9	21363323	.	T	C	3	2	5	0	1	6	0	0
9	21366340	.	G	A	12	15	27	0	2	29	0	0
9	21366346	.	A	G	13	15	28	1	1	30	0	0
9	21369378	.	T	C	8	12	20	1	1	22	0	0
9	21374039	.	G	A	10	9	19	1	0	20	0	0
9	21374336	.	G	A	16	14	30	0	1	31	0	0
9	21374354	.	A	C	13	13	26	0	0	26	0	0
9	21375928	.	G	A	7	4	11	0	2	13	0	0
9	21375997	.	G	A	7	3	10	0	0	10	0	0
9	21376217	.	C	T	7	7	14	0	0	14	0	0
9	21376279	.	G	A	4	3	7	0	1	8	0	0
9	21376280	.	A	G	5	3	8	0	0	8	0	0
9	21377476	.	A	G	4	7	11	0	1	12	0	0
9	21379041	.	C	T	5	6	11	0	0	11	0	0
9	21383725	.	G	A	4	4	8	0	0	8	0	0
9	21383758	.	G	A	6	5	11	0	0	11	0	0
9	21384297	.	T	C	3	2	5	0	1	6	0	0
9	21385937	.	C	T	5	6	11	0	0	11	0	0
9	21385956	.	A	G	4	1	5	0	7	12	0	0
9	21388976	.	A	G	5	3	8	0	1	9	0	0
9	21391949	.	C	T	5	6	11	0	1	12	0	0
9	21399284	.	A	C	8	4	12	0	0	12	0	0
9	21399392	.	T	G	3	2	5	0	0	5	0	0
9	21399508	.	T	C	3	2	5	0	0	5	0	0
9	21430647	.	C	T	5	2	7	0	1	8	0	0
9	21430889	.	T	C	10	8	18	0	1	19	0	0
9	21437038	.	C	T	2	6	8	0	2	10	0	0
9	21437060	.	G	A	3	7	10	0	0	10	0	0
9	21437094	.	A	G	3	7	10	0	1	11	0	0
9	21437349	.	G	A	6	8	14	0	0	14	0	0
9	21440071	.	A	G	8	7	15	0	0	15	0	0
9	21443744	.	G	A	8	5	13	0	0	13	0	0
9	21448023	.	T	G	5	3	8	0	1	9	0	0
9	21449792	.	G	C	1	0	1	0	4	5	0	0
9	21449914	.	A	T	2	3	5	0	0	5	0	0
9	21453954	.	G	A	1	3	4	0	0	4	0	0
9	21453986	.	G	A	6	3	9	0	0	9	0	0
9	21462651	.	T	C	5	7	12	0	1	13	0	0
9	21462692	.	C	T	0	7	7	0	6	13	0	0
9	21463152	.	C	T	1	11	12	1	20	33	0	0
9	21463333	.	T	A	6	12	18	0	1	19	0	0
9	21470362	.	A	G	11	10	21	0	1	22	0	0
9	21470446	.	T	C	13	12	25	0	0	25	0	0
9	21471685	.	T	C	6	9	15	0	1	16	0	0
9	21472758	.	G	T	7	4	11	0	0	11	0	0
9	21476284	.	T	C	10	5	15	0	0	15	0	0
9	21476307	.	T	G	12	7	19	0	0	19	0	0
9	21478881	.	C	T	1	5	6	0	16	22	0	0
9	21478935	.	T	C	7	11	18	0	0	18	0	0
9	21479115	.	C	T	1	13	14	0	10	24	0	0
9	21479295	.	G	A	10	7	17	0	1	18	0	0
9	21495866	.	T	G	3	7	10	0	0	10	0	0
9	21496505	.	T	A	2	4	6	0	0	6	0	0
9	21496662	.	T	C	2	3	5	0	0	5	0	0
9	21497001	.	T	C	5	0	5	0	6	11	0	0
9	21497956	.	C	T	1	3	4	0	1	5	0	0
9	21504569	.	G	T	2	2	4	0	0	4	0	0
9	21535963	.	A	G	13	0	13	0	11	24	0	0
9	21540992	.	C	T	1	3	4	0	0	4	0	0
9	21550306	.	T	C	10	13	23	0	1	24	0	0
9	21554226	.	A	G	13	6	19	0	0	19	0	0
9	21558019	.	G	A	16	8	24	0	1	25	0	0
9	21558276	.	T	C	13	10	23	0	0	23	0	0
9	21558279	.	A	G	12	1	13	0	9	22	0	0
9	21560580	.	G	A	9	16	25	0	1	26	0	0
9	21560749	.	T	C	22	24	46	0	1	48	1	0
9	21561709	.	A	T	11	17	28	0	3	31	0	0
9	21563194	.	T	C	8	13	21	0	1	22	0	0
9	21722951	.	T	C	15	7	22	0	1	23	0	0
9	21723202	.	C	A	12	9	21	0	0	21	0	0
9	21724003	.	G	A	2	8	10	0	15	25	0	0
9	21802933	.	A	T	5	4	9	0	0	9	0	0
9	21802978	.	T	C	3	4	7	0	0	7	0	0
9	21802981	.	C	T	2	4	6	0	1	7	0	0
9	21803062	.	A	T	5	3	8	0	0	8	0	0
9	21808049	.	T	C	3	5	8	0	1	9	0	0
9	21808345	.	A	T	4	2	6	0	0	6	0	0
9	21810866	.	C	T	1	2	3	0	2	5	0	0
9	21810899	.	G	A	2	3	5	0	0	5	0	0
9	21811157	.	A	G	7	4	11	0	0	11	0	0
9	21811211	.	C	G	1	5	6	0	0	6	0	0
9	21811829	.	T	C	13	11	24	0	0	24	0	0
9	21811872	.	T	G	17	11	28	0	0	28	0	0
9	21812480	.	C	T	13	8	21	0	2	23	0	0
9	21816596	.	A	G	1	5	6	0	0	6	0	0
9	21821061	.	T	C	16	16	32	0	0	32	0	0
9	21821362	.	A	G	21	0	21	0	20	41	0	0
9	21821437	.	C	T	15	17	32	0	3	35	0	0
9	21824069	.	C	G	16	0	16	0	12	28	0	0
9	21824124	.	G	A	3	16	19	0	9	28	0	0
9	21824510	.	T	C	11	19	30	0	0	30	0	0
9	21824564	.	A	C	9	9	18	0	0	18	0	0
9	21824588	.	G	T	4	2	6	0	0	6	0	0
9	21824788	.	G	A	8	8	16	0	0	16	0	0
9	21824847	.	T	C	21	14	35	0	1	36	0	0
9	21825345	.	C	T	22	19	41	0	2	43	0	0
9	21825632	.	G	A	20	13	33	0	0	33	0	0
9	21825819	.	C	A	21	12	33	0	0	33	0	0
9	21825844	.	A	G	14	7	21	0	0	21	0	0
9	21826752	.	T	A	1	4	5	0	0	5	0	0
9	21826817	.	C	T	5	12	17	1	0	18	0	0
9	21826893	.	G	A	7	5	12	0	1	13	0	0
9	21829505	.	C	T	6	13	19	1	0	20	0	0
9	21831293	.	T	A	10	6	16	0	1	17	0	0
9	21834021	.	T	C	1	2	3	0	1	4	0	0
9	21834167	.	G	A	1	2	3	0	0	3	0	0
9	21843991	.	C	T	17	16	33	0	0	33	0	0
9	21844190	.	C	A	7	12	19	0	1	20	0	0
9	21844438	.	T	A	11	15	26	0	0	26	0	0
9	21844702	.	A	G	9	9	18	0	0	18	0	0
9	21844944	.	T	C	15	12	27	0	1	28	0	0
9	21845038	.	C	A	13	9	22	0	0	22	0	0
9	21845142	.	G	A	8	15	23	0	0	23	0	0
9	21845208	.	G	A	11	11	22	0	1	23	0	0
9	21845365	.	G	C	14	9	23	0	4	27	0	0
9	21845366	.	G	A	15	10	25	0	2	27	0	0
9	21845541	.	T	C	9	7	16	0	0	16	0	0
9	21893856	.	A	G	6	5	11	0	0	11	0	0
9	21893862	.	G	A	7	5	12	0	2	14	0	0
9	21894057	.	T	G	10	7	17	0	1	18	0	0
9	21899687	.	T	C	14	6	20	0	5	25	0	0
9	21899795	.	T	C	13	0	13	0	9	22	0	0
9	21899973	.	G	A	11	14	25	0	1	26	0	0
9	21900123	.	C	A	13	6	19	0	0	19	0	0
9	21900141	.	T	C	15	0	15	0	7	22	0	0
9	21904770	.	C	T	10	5	15	0	0	15	0	0
9	21904973	.	G	A	16	11	27	0	1	28	0	0
9	21906892	.	T	C	13	5	18	0	0	18	0	0
9	21908363	.	A	T	14	9	23	0	1	24	0	0
9	21914170	.	A	G	4	7	11	0	1	12	0	0
9	21914184	.	C	G	0	7	7	0	3	10	0	0
9	21919162	.	G	C	11	7	18	0	1	19	0	0
9	21919360	.	G	T	6	9	15	0	2	17	0	0
9	21919908	.	G	T	7	3	10	0	0	10	0	0
9	21927072	.	C	T	6	3	9	0	0	9	0	0
9	21927241	.	T	C	8	0	8	0	6	14	0	0
9	21927288	.	C	T	6	5	11	0	0	11	0	0
9	21930120	.	G	T	5	5	10	0	0	10	0	0
9	21931796	.	C	G	2	4	6	0	0	6	0	0
9	21969976	.	T	G	2	1	3	0	2	5	0	0
9	21971511	.	G	T	5	5	10	0	0	10	0	0
9	21974246	.	T	C	12	18	30	0	1	31	0	0
9	21974252	.	A	C	14	19	33	0	0	33	0	0
9	21976540	.	T	C	6	10	16	0	0	16	0	0
9	22447527	.	C	A	2	3	5	0	0	5	0	0
9	22483715	.	G	C	5	7	12	0	0	12	0	0
9	22483724	.	G	A	0	6	6	0	4	10	0	0
9	22483856	.	G	A	2	2	4	0	4	8	0	0
9	22483862	.	C	T	5	3	8	0	0	8	0	0
9	22485458	.	A	G	5	3	8	0	0	8	0	0
9	22488933	.	C	A	1	6	7	0	1	8	0	0
9	22489092	.	A	C	2	7	9	0	0	9	0	0
9	22613315	.	C	T	4	4	8	0	0	8	0	0
9	22613357	.	A	G	3	2	5	0	0	5	0	0
9	22613379	.	C	T	1	2	3	0	0	3	0	0
9	22634324	.	T	C	15	18	33	0	0	33	0	0
9	22636747	.	C	T	20	40	60	0	3	63	0	0
9	22636988	.	C	T	23	22	45	0	3	48	0	0
9	22637031	.	C	G	24	27	51	0	2	53	0	0
9	22637082	.	A	T	24	26	50	1	2	53	0	0
9	22638738	.	C	G	21	29	50	0	2	52	0	0
9	22647331	.	T	C	26	24	50	0	3	53	0	0
9	22647373	.	A	G	24	0	24	0	32	56	0	0
9	22647391	.	C	T	29	24	53	0	3	56	0	0
9	22647607	.	A	T	22	26	48	0	1	49	0	0
9	22647754	.	A	T	15	27	42	0	2	44	0	0
9	22647755	.	A	T	18	26	44	0	1	45	0	0
9	22648004	.	A	G	11	1	12	0	28	40	0	0
9	22648010	.	G	A	0	28	28	0	13	41	0	0
9	22648051	.	T	C	17	25	42	0	1	43	0	0
9	22648355	.	A	T	18	28	46	0	5	51	0	0
9	22648747	.	T	G	23	32	55	0	2	57	0	0
9	22649019	.	T	A	2	2	4	0	1	5	0	0
9	22677597	.	T	G	3	5	8	0	0	8	0	0
9	22707105	.	T	C	4	3	7	0	2	9	0	0
9	22707438	.	A	C	5	5	10	0	0	10	0	0
9	22707477	.	C	T	5	7	12	0	0	12	0	0
9	22707493	.	C	A	6	6	12	0	1	13	0	0
9	22747557	.	A	G	12	5	17	0	1	18	0	0
9	22747644	.	G	A	3	9	12	0	9	21	0	0
9	22747811	.	G	T	1	9	10	0	0	10	0	0
9	22788756	.	C	T	7	3	10	0	2	12	0	0
9	22796244	.	C	A	2	2	4	0	0	4	0	0
9	22796255	.	C	A	2	3	5	0	0	5	0	0
9	22797500	.	G	A	4	4	8	0	1	9	0	0
9	22797816	.	C	A	5	8	13	0	1	14	0	0
9	22797962	.	A	C	9	8	17	0	0	17	0	0
9	22798087	.	C	T	4	4	8	0	0	8	0	0
9	22798715	.	A	G	5	5	10	0	1	11	0	0
9	22798736	.	G	T	6	5	11	0	0	11	0	0
9	22798765	.	A	G	11	5	16	0	1	17	0	0
9	22798789	.	C	T	9	7	16	0	0	16	0	0
9	22799115	.	T	A	8	3	11	0	1	12	0	0
9	22799157	.	G	A	7	8	15	0	0	15	0	0
9	22799456	.	G	C	0	6	6	0	3	9	0	0
9	22799508	.	T	C	6	6	12	0	0	12	0	0
9	22799810	.	A	G	14	7	21	0	0	21	0	0
9	22799883	.	C	T	7	5	12	0	0	12	0	0
9	22800271	.	T	C	4	3	7	0	1	8	0	0
9	22801205	.	C	T	8	9	17	0	1	18	0	0
9	22801527	.	C	T	10	7	17	0	1	18	0	0
9	22801860	.	C	A	2	4	6	0	0	6	0	0
9	22802045	.	A	G	1	0	1	0	2	3	0	0
9	22802066	.	G	A	1	3	4	0	1	5	0	0
9	22902938	.	A	T	3	4	7	0	1	8	0	0
9	22902997	.	G	A	5	5	10	0	0	10	0	0
9	22903012	.	T	G	5	4	9	0	1	10	0	0
9	22903166	.	C	T	1	6	7	0	16	23	0	0
9	22903270	.	A	T	9	11	20	0	1	21	0	0
9	22906425	.	C	T	7	7	14	0	0	14	0	0
9	22932366	.	T	G	8	10	18	0	0	18	0	0
9	22937852	.	G	A	6	8	14	0	1	15	0	0
9	22938719	.	A	T	11	9	20	0	0	20	0	0
9	22938828	.	T	G	9	6	15	0	1	16	0	0
9	22938932	.	T	G	12	0	12	0	11	23	0	0
9	22938967	.	T	G	12	11	23	0	0	23	0	0
9	22939068	.	A	G	7	13	20	0	2	22	0	0
9	22939201	.	C	G	5	6	11	0	1	12	0	0
9	22941166	.	C	A	6	6	12	0	0	12	0	0
9	22941285	.	G	T	6	7	13	0	0	13	0	0
9	22946494	.	G	A	5	3	8	0	0	8	0	0
9	22949353	.	C	T	6	4	10	0	2	12	0	0
9	22953228	.	G	A	5	3	8	0	1	9	0	0
9	22962612	.	A	G	2	3	5	0	0	5	0	0
9	22963427	.	C	T	0	2	2	0	2	4	0	0
9	23004411	.	C	A	3	2	5	0	0	5	0	0
9	23006546	.	C	T	3	1	4	0	0	4	0	0
9	23006561	.	T	C	3	2	5	0	0	5	0	0
9	23006862	.	T	C	2	2	4	0	0	4	0	0
9	23016422	.	T	C	1	2	3	0	0	3	0	0
9	23016482	.	T	A	3	2	5	0	0	5	0	0
9	23016709	.	G	A	2	3	5	0	0	5	0	0
9	23018709	.	C	A	4	5	9	0	0	9	0	0
9	23022763	.	A	T	6	4	10	0	0	10	0	0
9	23023047	.	A	T	5	5	10	0	0	10	0	0
9	23023064	.	C	T	7	7	14	0	0	14	0	0
9	23023103	.	G	C	4	1	5	0	5	10	0	0
9	23023254	.	G	A	0	2	2	0	2	4	0	0
9	23026337	.	C	T	0	3	3	0	1	4	0	0
9	23026412	.	A	T	4	4	8	0	0	8	0	0
9	23026901	.	C	T	20	6	26	0	0	26	0	0
9	23033771	.	T	C	7	0	7	0	7	14	0	0
9	23049577	.	A	G	3	0	3	0	13	16	0	0
9	23051913	.	G	T	0	6	6	0	1	7	0	0
9	23055635	.	C	T	9	14	23	0	1	24	0	0
9	23055644	.	A	G	10	12	22	0	0	22	0	0
9	23055674	.	G	C	9	15	24	0	2	26	0	0
9	23055986	.	A	C	1	6	7	0	0	7	0	0
9	23056098	.	A	T	7	2	9	0	0	9	0	0
9	23056104	.	G	C	6	2	8	0	0	8	0	0
9	23056148	.	A	T	4	2	6	0	0	6	0	0
9	23071272	.	A	G	2	2	4	0	0	4	0	0
9	23071353	.	C	G	3	2	5	0	0	5	0	0
9	23071830	.	T	A	3	2	5	0	3	8	0	0
9	23185674	.	A	G	17	13	30	0	2	32	0	0
9	23185786	.	A	C	23	21	44	0	0	44	0	0
9	23185801	.	T	A	20	22	42	0	5	47	0	0
9	23186163	.	A	C	10	14	24	0	1	25	0	0
9	23187985	.	T	C	5	8	13	0	1	14	0	0
9	23188003	.	C	T	4	7	11	0	0	11	0	0
9	23194587	.	G	A	9	16	25	0	0	25	0	0
9	23194608	.	A	T	12	14	26	0	2	28	0	0
9	23198166	.	C	T	13	6	19	0	1	20	0	0
9	23202123	.	C	T	4	5	9	0	0	9	0	0
9	23202433	.	A	T	8	4	12	0	1	13	0	0
9	23202743	.	G	A	5	4	9	0	0	9	0	0
9	23217093	.	C	T	4	8	12	0	1	13	0	0
9	23234567	.	T	C	10	0	10	0	13	23	0	0
9	23236339	.	T	C	16	11	27	0	1	28	0	0
9	23236465	.	G	C	12	14	26	0	0	26	0	0
9	23236515	.	G	A	18	17	35	0	0	35	0	0
9	23236531	.	C	T	1	16	17	0	17	34	0	0
9	23357063	.	T	A	2	2	4	0	0	4	0	0
9	23357134	.	A	G	7	5	12	0	0	12	0	0
9	23357142	.	G	C	6	0	6	0	5	11	0	0
9	23357194	.	C	T	5	4	9	0	1	10	0	0
9	23357200	.	T	C	4	4	8	0	0	8	0	0
9	23357234	.	C	G	3	7	10	0	1	11	0	0
9	23357317	.	T	C	8	0	8	0	6	14	0	0
9	23357528	.	C	T	9	7	16	0	0	16	0	0
9	23372041	.	C	T	3	3	6	0	0	6	0	0
9	23555976	.	G	A	5	4	9	0	0	9	0	0
9	23558562	.	C	T	2	2	4	0	0	4	0	0
9	23589297	.	A	T	4	3	7	0	0	7	0	0
9	23590549	.	G	T	5	3	8	0	0	8	0	0
9	23590551	.	A	G	5	3	8	0	0	8	0	0
9	23590600	.	C	T	1	2	3	0	0	3	0	0
9	23597979	.	A	C	2	3	5	0	0	5	0	0
9	23607087	.	G	A	0	2	2	0	5	7	0	0
9	23670839	.	T	C	2	2	4	0	0	4	0	0
9	23670880	.	A	G	1	2	3	0	0	3	0	0
9	23718577	.	T	A	2	2	4	0	0	4	0	0
9	23740555	.	G	C	5	4	9	0	0	9	0	0
9	23740676	.	A	G	16	13	29	0	0	29	0	0
9	23745176	.	C	T	2	13	15	0	22	37	0	0
9	23745201	.	T	A	18	15	33	0	1	34	0	0
9	23745471	.	C	A	14	8	22	0	0	22	0	0
9	23745504	.	A	G	15	7	22	0	0	22	0	0
9	23745531	.	C	T	22	7	29	0	0	30	1	0
9	23745558	.	T	C	21	0	21	0	10	31	0	0
9	23745570	.	G	A	19	9	28	0	2	30	0	0
9	23746628	.	A	G	21	11	32	0	0	32	0	0
9	23746676	.	G	A	23	8	31	0	1	32	0	0
9	23747111	.	T	C	17	15	32	0	0	32	0	0
9	23747118	.	G	A	18	15	33	0	0	33	0	0
9	23747226	.	A	C	10	10	20	0	0	20	0	0
9	23748417	.	C	G	11	7	18	0	2	20	0	0
9	23748421	.	A	G	9	8	17	0	3	20	0	0
9	23748993	.	G	C	4	6	10	0	1	11	0	0
9	23750634	.	T	C	15	13	28	0	0	28	0	0
9	23750643	.	C	T	15	13	28	0	0	28	0	0
9	23754905	.	T	C	14	11	25	0	2	27	0	0
9	23754989	.	C	A	10	7	17	0	0	17	0	0
9	23755024	.	A	T	5	12	17	0	1	18	0	0
9	23755083	.	C	G	3	9	12	0	1	13	0	0
9	23755774	.	G	A	2	7	9	0	0	9	0	0
9	23755883	.	C	T	5	2	7	0	0	7	0	0
9	23755897	.	G	C	6	3	9	0	0	9	0	0
9	23756108	.	G	C	9	9	18	0	0	18	0	0
9	23756268	.	G	A	4	7	11	0	3	14	0	0
9	23756298	.	A	G	4	0	4	0	5	9	0	0
9	23756332	.	T	A	5	6	11	0	0	11	0	0
9	23756377	.	G	A	6	2	8	0	0	8	0	0
9	23756519	.	C	T	9	9	18	0	1	19	0	0
9	23756552	.	C	T	10	9	19	0	2	21	0	0
9	23756584	.	T	C	8	7	15	0	0	15	0	0
9	23756636	.	T	A	8	7	15	0	0	15	0	0
9	23756640	.	C	G	6	7	13	0	1	14	0	0
9	23757196	.	G	C	4	2	6	0	0	6	0	0
9	23757197	.	G	A	4	2	6	0	0	6	0	0
9	23808573	.	T	C	1	2	3	0	1	4	0	0
9	23810426	.	A	G	5	7	12	0	0	12	0	0
9	23814104	.	G	C	22	16	38	0	0	38	0	0
9	23823895	.	A	G	15	15	30	0	2	32	0	0
9	23826525	.	A	G	2	2	4	0	0	4	0	0
9	23826534	.	G	A	2	2	4	0	0	4	0	0
9	23831339	.	T	C	1	4	5	0	0	5	0	0
9	23832650	.	C	A	3	3	6	0	0	6	0	0
9	23832689	.	C	T	2	6	8	0	0	8	0	0
9	23836415	.	T	C	8	3	11	0	0	11	0	0
9	23838898	.	C	T	4	5	9	0	0	9	0	0
9	23840554	.	G	A	4	5	9	0	0	9	0	0
9	23840775	.	G	C	8	3	11	0	0	11	0	0
9	23840824	.	C	T	8	4	12	0	0	12	0	0
9	23841000	.	A	G	2	0	2	0	7	9	0	0
9	23841037	.	T	G	1	5	6	0	0	6	0	0
9	23841088	.	G	A	1	6	7	0	0	7	0	0
9	23841139	.	T	C	3	3	6	0	0	6	0	0
9	23846100	.	C	T	0	2	2	0	1	3	0	0
9	23905834	.	A	C	8	5	13	0	0	13	0	0
9	23905848	.	G	T	8	6	14	0	0	14	0	0
9	23906101	.	C	T	3	2	5	0	0	5	0	0
9	23914386	.	C	G	1	3	4	0	0	4	0	0
9	23914387	.	C	T	2	3	5	0	0	5	0	0
9	23914555	.	T	C	4	3	7	0	1	8	0	0
9	23914684	.	C	G	4	3	7	0	2	9	0	0
9	23914696	.	G	C	6	2	8	0	0	8	0	0
9	24025849	.	A	T	7	3	10	0	0	10	0	0
9	24025859	.	T	C	7	4	11	0	1	12	0	0
9	24026116	.	C	A	4	3	7	0	0	7	0	0
9	24026205	.	C	A	5	2	7	0	0	7	0	0
9	24026332	.	G	T	6	3	9	0	0	9	0	0
9	24026397	.	G	A	9	4	13	0	0	13	0	0
9	24026400	.	G	A	8	4	12	0	1	13	0	0
9	24044395	.	G	A	1	4	5	0	0	5	0	0
9	24044706	.	A	T	5	2	7	0	0	7	0	0
9	24044738	.	C	T	5	3	8	0	0	8	0	0
9	24044847	.	T	C	1	5	6	0	0	6	0	0
9	24045070	.	A	C	1	0	1	0	2	3	0	0
9	24107215	.	G	A	8	5	13	0	0	13	0	0
9	24107251	.	C	A	5	11	16	0	1	17	0	0
9	24110322	.	G	A	1	2	3	0	0	3	0	0
9	24114126	.	C	T	3	2	5	0	0	5	0	0
9	24114826	.	C	T	4	8	12	0	0	12	0	0
9	24114867	.	T	G	2	5	7	0	0	7	0	0
9	24114994	.	G	A	3	4	7	0	0	7	0	0
9	24115004	.	C	T	3	3	6	0	0	6	0	0
9	24116512	.	T	C	1	0	1	1	4	6	0	0
9	24116915	.	C	A	7	5	12	0	0	12	0	0
9	24117048	.	C	A	0	8	8	0	2	10	0	0
9	24122676	.	C	T	8	6	14	0	0	14	0	0
9	24122715	.	G	T	0	6	6	0	5	11	0	0
9	24143567	.	A	C	7	2	9	0	0	9	0	0
9	24159317	.	T	G	1	2	3	0	0	3	0	0
9	24159634	.	G	A	1	2	3	0	5	8	0	0
9	24159805	.	C	A	1	3	4	0	0	4	0	0
9	24162994	.	A	G	3	5	8	0	1	9	0	0
9	24165519	.	C	T	8	5	13	0	0	13	0	0
9	24165555	.	C	T	5	8	13	0	0	13	0	0
9	24166575	.	T	C	7	4	11	0	0	11	0	0
9	24166729	.	T	C	3	4	7	0	0	7	0	0
9	24166825	.	T	C	5	9	14	0	0	14	0	0
9	24166846	.	C	T	6	5	11	0	1	12	0	0
9	24178660	.	G	A	13	3	16	0	1	17	0	0
9	24183438	.	T	C	3	7	10	0	0	10	0	0
9	24183603	.	C	T	6	6	12	0	0	12	0	0
9	24186269	.	G	A	7	6	13	0	0	13	0	0
9	24187510	.	C	A	12	5	17	0	0	17	0	0
9	24187675	.	T	G	5	4	9	0	0	9	0	0
9	24187805	.	C	G	5	9	14	0	0	14	0	0
9	24187967	.	A	G	10	0	10	0	8	18	0	0
9	24188100	.	A	T	4	6	10	0	0	10	0	0
9	24188110	.	A	T	6	7	13	0	0	13	0	0
9	24188729	.	C	G	2	5	7	0	0	7	0	0
9	24188969	.	T	G	9	9	18	0	0	18	0	0
9	24189179	.	T	G	8	4	12	0	0	12	0	0
9	24189198	.	A	G	4	5	9	0	0	9	0	0
9	24189283	.	G	A	8	7	15	0	2	17	0	0
9	24189407	.	A	G	18	15	33	0	1	34	0	0
9	24189757	.	C	A	13	13	26	0	1	27	0	0
9	24189825	.	T	A	10	8	18	0	0	18	0	0
9	24189946	.	C	T	8	9	17	0	0	17	0	0
9	24189977	.	A	G	11	6	17	0	1	18	0	0
9	24190010	.	G	A	11	9	20	0	1	21	0	0
9	24190020	.	G	A	12	7	19	0	2	21	0	0
9	24190048	.	T	C	14	13	27	0	0	27	0	0
9	24190139	.	A	G	7	11	18	0	1	19	0	0
9	24190295	.	T	C	10	10	20	0	1	21	0	0
9	24190302	.	A	G	10	11	21	0	0	21	0	0
9	24190419	.	G	A	12	13	25	0	1	26	0	0
9	24190466	.	G	T	11	10	21	0	1	23	1	0
9	24190489	.	C	G	8	9	17	0	2	19	0	0
9	24190547	.	C	A	9	7	16	0	0	16	0	0
9	24190630	.	G	C	9	3	12	0	0	12	0	0
9	24190642	.	T	A	7	5	12	0	0	12	0	0
9	24190748	.	G	T	14	9	23	1	2	26	0	0
9	24190767	.	A	G	17	0	17	1	12	30	0	0
9	24190792	.	A	G	13	10	23	0	1	25	1	0
9	24191053	.	T	A	14	12	26	0	0	26	0	0
9	24191462	.	G	A	10	9	19	0	1	20	0	0
9	24192423	.	T	C	1	5	6	0	0	6	0	0
9	24192618	.	A	G	2	3	5	0	2	7	0	0
9	24197435	.	G	A	0	5	5	1	3	9	0	0
9	24197447	.	T	C	5	4	9	1	0	10	0	0
9	24198574	.	G	T	3	5	8	0	0	8	0	0
9	24200608	.	C	T	9	3	12	0	1	13	0	0
9	24204661	.	T	A	8	6	14	0	0	14	0	0
9	24204723	.	T	A	7	10	17	0	0	17	0	0
9	24204749	.	T	A	6	9	15	0	0	15	0	0
9	24204762	.	A	G	7	10	17	0	1	18	0	0
9	24204806	.	T	C	7	0	7	0	11	18	0	0
9	24204905	.	T	A	6	14	20	0	0	20	0	0
9	24204913	.	G	C	14	5	19	0	1	20	0	0
9	24204947	.	A	C	5	11	16	0	0	16	0	0
9	24205136	.	G	A	5	8	13	0	0	13	0	0
9	24205242	.	C	G	8	9	17	0	0	17	0	0
9	24205260	.	C	T	8	6	14	0	0	14	0	0
9	24205292	.	C	T	7	6	13	0	0	13	0	0
9	24205318	.	A	G	5	5	10	0	1	11	0	0
9	24205391	.	T	C	7	6	13	0	0	13	0	0
9	24205484	.	A	G	5	5	10	0	1	11	0	0
9	24205596	.	C	T	7	11	18	0	0	18	0	0
9	24205681	.	G	T	10	8	18	0	0	18	0	0
9	24205818	.	G	T	4	7	11	0	2	13	0	0
9	24205916	.	G	A	9	7	16	0	1	18	1	0
9	24208774	.	T	C	10	7	17	0	0	17	0	0
9	24208779	.	T	A	10	7	17	0	0	17	0	0
9	24208825	.	T	C	6	1	7	0	6	13	0	0
9	24209052	.	G	A	8	3	11	0	1	12	0	0
9	24209663	.	C	T	1	3	4	0	1	5	0	0
9	24209941	.	A	G	1	3	4	0	0	4	0	0
9	24210083	.	A	G	4	1	5	0	1	6	0	0
9	24210244	.	T	C	1	3	4	0	0	4	0	0
9	24211081	.	T	C	1	3	4	0	0	4	0	0
9	24211172	.	A	G	2	2	4	0	1	5	0	0
9	24212230	.	T	G	4	2	6	0	2	8	0	0
9	24212277	.	C	T	3	6	9	0	0	9	0	0
9	24212299	.	G	A	4	6	10	0	0	10	0	0
9	24212552	.	G	A	1	2	3	0	2	5	0	0
9	24212585	.	A	C	2	3	5	0	0	5	0	0
9	24212629	.	T	A	4	4	8	0	0	8	0	0
9	24212654	.	T	A	4	5	9	0	0	9	0	0
9	24212748	.	T	C	5	2	7	0	0	7	0	0
9	24214709	.	C	A	0	5	5	0	8	13	0	0
9	24214792	.	C	T	6	9	15	0	0	15	0	0
9	24216417	.	C	T	7	6	13	0	0	13	0	0
9	24217459	.	G	A	7	6	13	0	0	13	0	0
9	24217829	.	T	G	2	2	4	0	2	6	0	0
9	24217894	.	T	A	2	4	6	2	0	8	0	0
9	24217910	.	T	C	4	2	6	0	0	6	0	0
9	24223493	.	G	T	2	4	6	0	0	6	0	0
9	24223499	.	G	A	4	4	8	0	0	8	0	0
9	24223903	.	G	A	2	2	4	0	0	4	0	0
9	24224015	.	T	C	3	0	3	0	3	6	0	0
9	24224254	.	C	A	2	2	4	0	1	5	0	0
9	24249396	.	T	G	14	25	39	0	2	41	0	0
9	24249414	.	T	C	15	0	15	0	26	41	0	0
9	24252457	.	C	T	0	24	24	0	16	40	0	0
9	24252490	.	T	C	17	0	17	1	19	37	0	0
9	24255690	.	G	T	16	18	34	0	1	35	0	0
9	24366142	.	G	A	15	23	38	0	0	38	0	0
9	24412781	.	A	G	16	13	29	0	0	29	0	0
9	24412790	.	A	G	16	13	29	0	2	31	0	0
9	24949237	.	C	T	1	2	3	0	0	3	0	0
9	25123436	.	A	C	7	8	15	0	0	15	0	0
9	25132516	.	C	T	7	5	12	0	0	12	0	0
9	25139179	.	A	C	5	3	8	0	2	10	0	0
9	25140796	.	T	C	4	3	7	1	0	8	0	0
9	25148540	.	C	A	13	5	18	0	1	19	0	0
9	25154390	.	T	G	9	10	19	0	2	21	0	0
9	25154910	.	T	A	10	8	18	0	3	21	0	0
9	25167271	.	C	T	5	2	7	0	0	7	0	0
9	25167404	.	T	A	4	4	8	0	0	8	0	0
9	25167588	.	T	C	7	4	11	0	0	11	0	0
9	25167759	.	T	A	2	2	4	0	0	4	0	0
9	25168500	.	A	T	3	4	7	0	0	7	0	0
9	25168569	.	A	C	3	3	6	0	1	7	0	0
9	25169176	.	G	A	4	3	7	0	0	7	0	0
9	25169258	.	A	T	5	5	10	0	0	10	0	0
9	25169295	.	T	A	4	5	9	0	1	10	0	0
9	25169380	.	A	G	10	7	17	0	0	17	0	0
9	25169399	.	T	A	15	4	19	0	1	20	0	0
9	25169444	.	T	G	14	6	20	0	0	20	0	0
9	25169609	.	T	C	5	3	8	0	0	8	0	0
9	25169738	.	G	A	6	5	11	0	0	11	0	0
9	25177600	.	A	G	9	5	14	0	0	14	0	0
9	25177642	.	A	G	5	7	12	0	1	13	0	0
9	25180196	.	G	A	8	7	15	0	0	15	0	0
9	25181203	.	C	T	3	6	9	0	0	9	0	0
9	25181215	.	C	T	3	5	8	0	0	8	0	0
9	25181285	.	A	T	2	4	6	0	0	6	0	0
9	25181286	.	A	T	2	4	6	0	0	6	0	0
9	25198560	.	T	C	4	2	6	0	0	6	0	0
9	25210606	.	C	T	3	1	4	0	1	5	0	0
9	25210612	.	T	A	2	3	5	0	1	6	0	0
9	25210753	.	A	T	1	3	4	0	1	5	0	0
9	25320799	.	C	T	5	3	8	0	0	8	0	0
9	25320914	.	T	A	6	6	12	0	0	12	0	0
9	25320980	.	A	T	4	10	14	0	1	15	0	0
9	25321538	.	G	A	12	4	16	0	0	16	0	0
9	25323773	.	C	T	9	3	12	0	0	12	0	0
9	25326386	.	G	A	4	4	8	0	0	8	0	0
9	25326482	.	C	T	0	9	9	0	6	15	0	0
9	25331051	.	C	T	2	3	5	0	0	5	0	0
9	25331065	.	T	C	1	3	4	0	0	4	0	0
9	25337403	.	C	T	4	5	9	0	0	9	0	0
9	25337468	.	C	T	6	4	10	0	0	10	0	0
9	25337499	.	G	A	3	3	6	0	0	6	0	0
9	25345948	.	A	G	7	6	13	0	0	13	0	0
9	25345974	.	A	G	5	4	9	0	0	9	0	0
9	25346001	.	G	T	0	7	7	0	9	16	0	0
9	25346088	.	T	G	1	2	3	0	0	3	0	0
9	25349838	.	G	A	12	8	20	0	2	22	0	0
9	25353387	.	C	T	1	9	10	0	12	22	0	0
9	25356838	.	A	G	10	7	17	0	2	19	0	0
9	25381021	.	A	G	21	10	31	0	1	32	0	0
9	25381150	.	A	G	13	15	28	0	1	29	0	0
9	25382028	.	T	C	10	0	10	0	10	20	0	0
9	25382097	.	T	C	7	7	14	0	0	14	0	0
9	25382322	.	C	G	9	7	16	0	1	17	0	0
9	25382478	.	C	A	10	8	18	0	0	18	0	0
9	25383046	.	C	A	7	14	21	0	0	22	1	0
9	25383124	.	T	C	7	1	8	0	15	23	0	0
9	25383421	.	G	A	9	12	21	1	2	24	0	0
9	25383780	.	A	C	10	8	18	0	1	19	0	0
9	25384091	.	G	A	13	8	21	0	1	22	0	0
9	25388150	.	T	C	8	0	8	0	13	21	0	0
9	25389823	.	G	A	10	8	18	0	0	18	0	0
9	25389931	.	G	A	15	9	24	0	1	25	0	0
9	25392985	.	C	T	9	11	20	0	1	21	0	0
9	25393036	.	T	C	5	7	12	0	0	12	0	0
9	25419211	.	C	G	13	7	20	0	0	20	0	0
9	25443163	.	T	A	9	5	14	0	0	14	0	0
9	25443330	.	A	T	6	5	11	0	0	11	0	0
9	25443352	.	A	T	5	6	11	0	0	11	0	0
9	25443419	.	G	T	3	3	6	0	0	6	0	0
9	25443575	.	A	T	4	4	8	0	0	8	0	0
9	25443650	.	C	T	6	2	8	0	0	8	0	0
9	25443702	.	T	C	5	3	8	0	0	8	0	0
9	25443874	.	T	A	2	3	5	1	0	6	0	0
9	25443957	.	G	A	3	4	7	0	0	7	0	0
9	25444055	.	T	G	3	2	5	0	0	5	0	0
9	25837206	.	A	T	1	3	4	0	0	4	0	0
9	25837213	.	A	T	3	3	6	0	3	9	0	0
9	25837592	.	G	T	5	2	7	0	0	7	0	0
9	27381934	.	A	C	1	2	3	0	0	3	0	0
9	27381941	.	A	G	1	1	2	0	0	2	0	0
9	27692005	.	C	A	4	2	6	0	1	7	0	0
9	27692017	.	T	C	2	4	6	0	0	6	0	0
9	27692075	.	G	T	3	2	5	0	0	5	0	0
9	27692121	.	C	A	0	3	3	0	3	6	0	0
9	27692325	.	A	G	13	4	17	0	1	18	0	0
9	27692329	.	G	T	12	5	17	0	1	18	0	0
9	27692389	.	A	G	4	5	9	0	3	12	0	0
9	27692402	.	G	T	6	6	12	0	0	12	0	0
9	27692471	.	C	T	1	8	9	0	3	12	0	0
9	27692699	.	C	G	2	10	12	0	6	18	0	0
9	27694630	.	T	C	5	4	9	0	0	9	0	0
9	27716762	.	A	G	1	6	7	0	0	7	0	0
9	27716974	.	A	G	7	5	12	0	0	12	0	0
9	27717219	.	A	G	1	6	7	0	0	7	0	0
9	27720032	.	G	A	4	1	5	0	1	6	0	0
9	27744579	.	G	A	1	2	3	0	0	3	0	0
9	27757831	.	C	T	22	11	33	0	0	33	0	0
9	27757893	.	A	G	22	0	22	0	22	44	0	0
9	27860734	.	C	T	1	5	6	0	5	11	0	0
9	27861186	.	G	T	6	3	9	0	2	11	0	0
9	27861293	.	C	G	0	9	9	0	7	16	0	0
9	27863828	.	G	T	5	8	13	0	0	13	0	0
9	27876169	.	T	C	2	2	4	0	0	4	0	0
9	27884383	.	G	T	7	4	11	0	0	11	0	0
9	27887795	.	G	T	4	4	8	0	0	8	0	0
9	27887864	.	C	T	3	5	8	0	0	8	0	0
9	27894444	.	G	T	6	4	10	0	1	11	0	0
9	27894656	.	T	C	5	5	10	0	0	10	0	0
9	27897012	.	T	C	3	2	5	0	1	6	0	0
9	27909933	.	C	T	10	3	13	0	1	14	0	0
9	27912962	.	G	A	4	4	8	0	0	8	0	0
9	27912995	.	A	G	4	5	9	0	0	9	0	0
9	27966379	.	T	C	2	6	8	0	1	9	0	0
9	27966424	.	T	A	1	4	5	0	0	5	0	0
9	27966442	.	G	A	1	3	4	0	0	4	0	0
9	27975589	.	G	A	3	3	6	0	0	6	0	0
9	27982905	.	G	A	4	2	6	0	0	6	0	0
9	28115886	.	A	G	4	0	4	0	9	13	0	0
9	28115901	.	A	G	4	9	13	0	1	14	0	0
9	28116064	.	T	C	13	8	21	0	0	21	0	0
9	28124661	.	G	A	6	4	10	0	0	10	0	0
9	28124775	.	A	G	9	0	9	0	11	20	0	0
9	28127334	.	A	G	15	0	15	0	11	26	0	0
9	28127471	.	A	G	13	10	23	0	3	26	0	0
9	28127513	.	A	C	11	10	21	0	0	21	0	0
9	28127532	.	A	C	9	11	20	0	0	20	0	0
9	28127573	.	A	G	11	11	22	0	0	22	0	0
9	28127706	.	C	G	14	9	23	0	0	23	0	0
9	28150855	.	G	C	3	3	6	0	0	6	0	0
9	28150896	.	C	T	2	2	4	0	0	4	0	0
9	28204026	.	C	T	4	3	7	0	0	7	0	0
9	28204036	.	C	A	4	3	7	0	0	7	0	0
9	28204412	.	C	T	5	6	11	0	0	11	0	0
9	28204464	.	C	A	3	4	7	0	0	7	0	0
9	28204594	.	C	T	3	2	5	0	0	5	0	0
9	28204698	.	C	T	1	2	3	0	0	3	0	0
9	28204700	.	A	G	1	1	2	0	1	3	0	0
9	28204872	.	T	A	3	3	6	0	0	6	0	0
9	28205703	.	T	C	3	3	6	0	0	6	0	0
9	28206186	.	G	A	4	2	6	0	1	7	0	0
9	28206190	.	C	T	3	2	5	0	0	5	0	0
9	28207033	.	C	T	1	1	2	0	1	3	0	0
9	28207339	.	T	A	6	5	11	0	0	11	0	0
9	28207392	.	T	A	8	3	11	0	0	11	0	0
9	28207480	.	G	C	0	3	3	0	1	4	0	0
9	28207647	.	C	T	1	2	3	0	0	3	0	0
9	28234415	.	C	T	1	2	3	0	0	3	0	0
9	28238302	.	C	T	19	11	30	0	1	31	0	0
9	28238305	.	C	T	0	14	14	0	17	31	0	0
9	28243879	.	C	A	1	2	3	0	0	3	0	0
9	28245874	.	G	A	22	9	31	0	0	31	0	0
9	28254633	.	C	T	20	13	33	0	3	36	0	0
9	28254783	.	C	T	0	11	11	0	13	24	0	0
9	28254810	.	G	A	10	11	21	0	0	21	0	0
9	28254909	.	G	A	5	3	8	0	0	8	0	0
9	28263971	.	C	T	15	13	28	0	0	28	0	0
9	28264469	.	T	C	8	0	8	0	17	25	0	0
9	28267158	.	G	A	15	17	32	0	1	33	0	0
9	28268543	.	G	A	10	15	25	0	2	27	0	0
9	28270529	.	A	C	8	1	9	0	5	14	0	0
9	28271181	.	T	C	7	9	16	0	2	18	0	0
9	28341330	.	C	A	0	6	6	0	4	10	0	0
9	28341382	.	G	A	6	8	14	0	0	14	0	0
9	28341591	.	C	A	14	15	29	0	4	33	0	0
9	28341593	.	T	A	24	10	34	0	3	37	0	0
9	28342963	.	G	A	12	7	19	0	0	19	0	0
9	28343054	.	G	A	13	12	25	0	1	26	0	0
9	28343100	.	A	G	14	13	27	0	1	28	0	0
9	28343121	.	T	G	10	15	25	0	2	27	0	0
9	28343549	.	C	T	8	9	17	0	0	17	0	0
9	28343590	.	G	A	16	5	21	0	1	22	0	0
9	28343629	.	C	T	7	10	17	0	3	20	0	0
9	28344026	.	T	C	13	3	16	0	0	16	0	0
9	28344126	.	A	C	5	13	18	0	0	18	0	0
9	28344320	.	T	G	5	11	16	2	1	19	0	0
9	28345531	.	T	C	7	8	15	0	2	17	0	0
9	28363208	.	G	A	13	4	17	0	2	19	0	0
9	28398942	.	G	C	3	11	14	0	0	14	0	0
9	28688667	.	T	G	7	0	7	0	6	13	0	0
9	28688956	.	C	G	10	0	10	0	4	14	0	0
9	28688965	.	A	G	10	3	13	0	1	14	0	0
9	28689032	.	G	A	16	6	22	0	1	23	0	0
9	28689033	.	C	A	17	6	23	0	1	24	0	0
9	28691645	.	T	C	6	10	16	0	1	17	0	0
9	28693928	.	G	C	2	4	6	0	0	6	0	0
9	28696610	.	A	C	7	6	13	0	0	13	0	0
9	28696643	.	A	G	9	6	15	0	0	15	0	0
9	28696911	.	T	A	1	2	3	0	0	3	0	0
9	28818163	.	T	G	2	4	6	0	0	6	0	0
9	28818176	.	C	T	1	4	5	0	0	5	0	0
9	28818327	.	A	G	3	3	6	0	0	6	0	0
9	28818498	.	A	T	12	3	15	1	1	17	0	0
9	28839811	.	T	C	8	4	12	0	1	13	0	0
9	28839859	.	G	A	10	7	17	0	1	18	0	0
9	28839879	.	T	A	9	6	15	0	0	15	0	0
9	28867390	.	T	C	8	0	8	0	6	14	0	0
9	28867421	.	A	C	7	7	14	0	0	14	0	0
9	28867426	.	A	C	6	5	11	0	1	12	0	0
9	28867459	.	C	T	4	5	9	0	0	9	0	0
9	28867555	.	G	A	5	5	10	0	0	10	0	0
9	28871367	.	A	T	7	6	13	0	0	13	0	0
9	28872083	.	A	G	0	2	2	0	1	3	0	0
9	28872253	.	T	G	5	6	11	0	1	12	0	0
9	28872341	.	G	A	3	4	7	1	0	8	0	0
9	28879348	.	C	T	2	5	7	0	0	7	0	0
9	28890020	.	A	C	2	4	6	0	0	6	0	0
9	28940998	.	G	A	14	8	22	0	0	22	0	0
9	28941003	.	T	C	12	0	12	0	9	21	0	0
9	28941061	.	A	C	15	12	27	0	0	27	0	0
9	28941179	.	A	G	8	5	13	0	0	13	0	0
9	28941189	.	G	A	10	7	17	0	0	17	0	0
9	28941234	.	C	T	11	5	16	0	1	17	0	0
9	28941414	.	A	G	11	15	26	0	0	26	0	0
9	28941446	.	A	G	10	14	24	0	0	24	0	0
9	28941488	.	T	A	13	10	23	0	1	24	0	0
9	28941498	.	C	G	12	15	27	0	0	27	0	0
9	28941629	.	G	A	4	6	10	0	0	10	0	0
9	28941630	.	G	A	4	5	9	0	1	10	0	0
9	28941709	.	G	C	4	6	10	0	0	10	0	0
9	28941723	.	A	G	5	2	7	0	1	8	0	0
9	28941795	.	C	T	3	5	8	0	1	9	0	0
9	28941832	.	A	G	4	8	12	0	0	12	0	0
9	28941879	.	A	T	3	8	11	0	2	13	0	0
9	28941897	.	T	G	5	9	14	0	0	14	0	0
9	28942018	.	G	A	9	8	17	0	0	17	0	0
9	28942111	.	A	G	3	4	7	0	0	7	0	0
9	28942542	.	T	A	12	10	22	0	3	25	0	0
9	28942553	.	T	A	13	11	24	0	1	25	0	0
9	28946132	.	A	T	11	9	20	0	1	21	0	0
9	28952959	.	G	A	6	9	15	0	0	15	0	0
9	28955543	.	A	G	13	7	20	0	0	20	0	0
9	28964849	.	C	A	10	10	20	0	2	22	0	0
9	28967048	.	A	G	6	9	15	0	0	15	0	0
9	28972347	.	A	C	7	6	13	0	0	13	0	0
9	28983790	.	C	A	1	6	7	0	5	12	0	0
9	28989543	.	C	T	4	5	9	0	1	10	0	0
9	28989549	.	G	A	4	4	8	0	0	8	0	0
9	29034834	.	T	C	5	2	7	0	0	7	0	0
9	29034857	.	T	C	5	4	9	0	0	9	0	0
9	29035075	.	T	C	3	2	5	0	1	6	0	0
9	29035086	.	A	C	4	2	6	0	0	6	0	0
9	29035183	.	C	T	1	2	3	0	0	3	0	0
9	29035776	.	T	C	1	3	4	0	0	4	0	0
9	29035839	.	C	A	1	3	4	0	0	4	0	0
9	29035884	.	T	C	4	3	7	0	0	7	0	0
9	29035977	.	A	G	2	2	4	0	0	4	0	0
9	29036245	.	A	G	3	4	7	0	0	7	0	0
9	29040544	.	G	A	1	2	3	0	0	3	0	0
9	29049901	.	T	C	3	2	5	0	0	5	0	0
9	29122231	.	T	G	2	4	6	0	1	7	0	0
9	29122536	.	T	A	1	3	4	0	2	6	0	0
9	29122725	.	C	T	7	7	14	0	0	14	0	0
9	29122849	.	A	G	3	6	9	0	0	9	0	0
9	29167096	.	T	C	3	0	3	0	6	9	0	0
9	29195268	.	A	G	4	5	9	0	0	9	0	0
9	29225281	.	G	A	4	6	10	0	0	10	0	0
9	29230754	.	A	G	3	6	9	0	0	9	0	0
9	29339133	.	G	C	5	6	11	0	0	11	0	0
9	29339139	.	A	T	4	6	10	0	0	10	0	0
9	29433519	.	G	A	2	4	6	0	0	6	0	0
9	29436007	.	C	A	1	2	3	0	0	3	0	0
9	29443840	.	T	C	3	3	6	0	0	6	0	0
9	29448320	.	A	G	2	3	5	0	0	5	0	0
9	29448372	.	T	G	3	4	7	0	0	7	0	0
9	29448703	.	T	G	4	0	4	0	3	7	0	0
9	29448727	.	C	A	4	5	9	0	0	9	0	0
9	29455415	.	T	C	2	4	6	0	0	6	0	0
9	29458550	.	A	C	2	2	4	0	0	4	0	0
9	29458562	.	T	C	0	2	2	0	1	3	0	0
9	29465051	.	C	T	3	3	6	0	1	7	0	0
9	29470325	.	G	A	1	6	7	0	0	7	0	0
9	29470326	.	G	A	1	6	7	0	0	7	0	0
9	29473879	.	T	A	3	9	12	0	0	12	0	0
9	29477021	.	G	C	8	6	14	1	0	15	0	0
9	29481518	.	T	C	10	10	20	0	0	20	0	0
9	29481708	.	A	G	5	4	9	1	1	11	0	0
9	29481732	.	A	G	8	4	12	0	0	12	0	0
9	29481747	.	G	A	1	6	7	0	5	12	0	0
9	29481795	.	T	C	6	8	14	0	0	14	0	0
9	29489797	.	A	G	6	6	12	0	0	12	0	0
9	29497181	.	C	T	0	4	4	0	3	7	0	0
9	29497200	.	A	T	3	3	6	0	0	6	0	0
9	29520819	.	A	G	14	19	33	0	2	35	0	0
9	29523552	.	T	G	13	0	13	0	15	28	0	0
9	29535291	.	T	C	1	2	3	0	0	3	0	0
9	29542822	.	T	C	1	4	5	0	1	6	0	0
9	29542990	.	G	T	1	3	4	0	0	4	0	0
9	29602959	.	T	C	9	4	13	0	2	15	0	0
9	29607543	.	C	T	14	12	26	0	0	26	0	0
9	29615087	.	C	G	21	23	44	0	3	47	0	0
9	29615238	.	T	A	19	10	29	1	4	34	0	0
9	29615575	.	C	T	16	13	29	0	1	30	0	0
9	29630650	.	C	T	2	3	5	0	0	5	0	0
9	29630668	.	T	C	1	3	4	0	0	4	0	0
9	29647469	.	G	A	26	20	46	0	1	47	0	0
9	29647470	.	C	T	23	19	42	0	5	47	0	0
9	29649571	.	C	A	25	17	42	1	4	47	0	0
9	29649809	.	G	T	2	2	4	0	0	4	0	0
9	29654693	.	T	C	1	4	5	0	0	5	0	0
9	29731041	.	T	C	15	8	23	0	0	23	0	0
9	29992145	.	A	G	5	0	5	0	13	18	0	0
9	29992332	.	G	A	7	2	9	0	0	9	0	0
9	30004003	.	C	T	1	2	3	0	0	3	0	0
9	30022468	.	G	T	5	6	11	0	1	12	0	0
9	30028016	.	C	T	0	6	6	0	2	8	0	0
9	30028056	.	T	C	4	0	4	0	3	7	0	0
9	30048300	.	G	C	1	3	4	0	0	4	0	0
9	30105956	.	G	A	2	5	7	0	0	7	0	0
9	30106009	.	G	A	4	7	11	0	1	12	0	0
9	30107428	.	C	T	1	2	3	2	0	5	0	0
9	30107439	.	T	A	2	5	7	2	0	9	0	0
9	30108779	.	T	C	7	3	10	0	0	10	0	0
9	30110026	.	T	C	8	12	20	0	0	20	0	0
9	30110217	.	T	C	11	7	18	0	0	18	0	0
9	30112544	.	A	G	11	0	11	0	13	24	0	0
9	30114853	.	A	G	16	11	27	0	2	29	0	0
9	30121155	.	C	A	19	20	39	0	3	42	0	0
9	30121167	.	C	T	16	21	37	0	3	40	0	0
9	30126136	.	A	G	25	0	25	0	29	54	0	0
9	30128084	.	C	G	25	25	50	0	0	50	0	0
9	30128085	.	C	T	24	22	46	0	3	49	0	0
9	30218140	.	C	T	4	6	10	0	0	10	0	0
9	30218310	.	G	A	5	4	9	0	0	9	0	0
9	30218323	.	A	G	3	4	7	0	0	7	0	0
9	30220931	.	C	T	3	6	9	0	0	9	0	0
9	30220968	.	T	A	7	4	11	0	0	11	0	0
9	30220975	.	C	T	7	3	10	0	0	10	0	0
9	30226160	.	T	C	5	0	5	0	11	16	0	0
9	30231360	.	A	C	2	0	2	0	3	5	0	0
9	30231586	.	A	G	1	3	4	0	0	4	0	0
9	30231616	.	T	C	2	0	2	0	2	4	0	0
9	30231659	.	A	T	2	3	5	0	0	5	0	0
9	30231664	.	C	T	1	2	3	0	2	5	0	0
9	30233169	.	A	T	2	5	7	0	0	7	0	0
9	30233386	.	T	C	2	2	4	0	0	4	0	0
9	30236090	.	A	C	0	2	2	0	1	3	0	0
9	30236303	.	A	G	4	4	8	0	0	8	0	0
9	30236417	.	C	A	1	3	4	0	3	7	0	0
9	30240979	.	A	G	3	5	8	0	0	8	0	0
9	30243319	.	T	C	2	2	4	0	1	5	0	0
9	30243324	.	C	T	1	3	4	0	0	4	0	0
9	30246172	.	C	G	19	5	24	0	1	25	0	0
9	30248931	.	C	T	1	2	3	0	0	3	0	0
9	30249039	.	C	T	2	8	10	0	4	14	0	0
9	30251977	.	A	G	2	5	7	0	1	8	0	0
9	30255146	.	C	G	3	4	7	0	0	7	0	0
9	30326347	.	G	A	4	7	11	0	0	11	0	0
9	30326377	.	A	G	4	8	12	0	0	12	0	0
9	30330206	.	C	T	0	2	2	0	5	7	0	0
9	30340154	.	A	G	4	5	9	0	0	9	0	0
9	30344279	.	A	G	4	5	9	0	1	10	0	0
9	30346237	.	T	C	1	3	4	0	0	4	0	0
9	30346243	.	T	G	1	4	5	0	0	5	0	0
9	30375082	.	T	A	2	2	4	0	0	4	0	0
9	30375117	.	A	C	1	3	4	0	0	4	0	0
9	30375261	.	A	G	2	4	6	0	0	6	0	0
9	30375346	.	A	G	1	2	3	0	0	3	0	0
9	30375391	.	T	C	5	2	7	0	0	7	0	0
9	30377562	.	C	T	0	3	3	0	3	6	0	0
9	30377582	.	G	T	2	2	4	0	0	4	0	0
9	30484621	.	C	A	3	3	6	0	0	6	0	0
9	30487596	.	C	A	5	4	9	0	0	9	0	0
9	30487599	.	T	C	3	4	7	0	0	7	0	0
9	30489813	.	A	G	3	6	9	0	1	10	0	0
9	30490106	.	G	A	2	4	6	0	0	6	0	0
9	30490949	.	G	T	6	7	13	0	2	15	0	0
9	30491053	.	T	C	8	6	14	0	0	14	0	0
9	30491197	.	G	A	1	6	7	0	0	7	0	0
9	30491560	.	C	T	3	9	12	0	9	21	0	0
9	30494225	.	T	C	9	7	16	0	0	16	0	0
9	30494498	.	C	G	0	5	5	0	11	16	0	0
9	30494839	.	A	G	7	5	12	0	0	12	0	0
9	30494854	.	T	A	7	4	11	0	0	11	0	0
9	30495139	.	C	T	1	6	7	0	12	19	0	0
9	30496325	.	C	T	4	6	10	0	0	10	0	0
9	30496377	.	A	G	2	6	8	0	0	8	0	0
9	30496436	.	A	G	5	2	7	0	0	7	0	0
9	30496446	.	G	T	4	1	5	0	0	5	0	0
9	30496952	.	A	G	3	6	9	0	0	9	0	0
9	30562659	.	A	G	4	3	7	0	0	7	0	0
9	30562689	.	A	T	1	3	4	0	0	4	0	0
9	30563541	.	T	C	6	0	6	0	3	9	0	0
9	30563568	.	T	C	6	0	6	0	3	9	0	0
9	30565867	.	G	A	4	4	8	0	0	8	0	0
9	30566872	.	T	C	5	3	8	1	1	10	0	0
9	30566878	.	G	T	5	4	9	1	0	10	0	0
9	30571117	.	G	C	3	3	6	0	0	6	0	0
9	30578018	.	A	G	3	8	11	0	0	11	0	0
9	30581779	.	G	C	6	8	14	0	2	16	0	0
9	30581942	.	C	T	4	8	12	0	0	12	0	0
9	30603877	.	C	A	1	2	3	0	0	3	0	0
9	30630552	.	A	G	2	2	4	0	0	4	0	0
9	30636682	.	A	G	1	2	3	0	0	3	0	0
9	30636727	.	T	C	1	2	3	0	0	3	0	0
9	30638865	.	A	G	1	2	3	0	0	3	0	0
9	30638922	.	A	G	1	4	5	0	1	6	0	0
9	30638970	.	A	G	3	3	6	0	1	7	0	0
9	30639047	.	A	T	1	2	3	0	0	3	0	0
9	30639079	.	T	C	5	2	7	0	1	8	0	0
9	30639148	.	C	T	3	3	6	0	0	6	0	0
9	30639149	.	T	C	3	3	6	0	0	6	0	0
9	30639290	.	C	T	2	2	4	0	0	4	0	0
9	30720128	.	C	G	1	2	3	0	0	3	0	0
9	30720132	.	C	G	2	2	4	0	0	4	0	0
9	30764489	.	A	T	5	4	9	0	1	10	0	0
9	30780786	.	G	A	1	3	4	0	0	4	0	0
9	30780813	.	A	G	1	5	6	0	0	6	0	0
9	30783316	.	T	C	6	2	8	0	0	8	0	0
9	30783321	.	A	T	7	2	9	0	0	9	0	0
9	30783676	.	C	T	2	4	6	0	0	6	0	0
9	30783828	.	A	T	5	3	8	0	0	8	0	0
9	30783844	.	T	A	4	2	6	0	0	6	0	0
9	30783874	.	T	A	5	3	8	0	0	8	0	0
9	30783887	.	A	C	6	3	9	0	0	9	0	0
9	30806492	.	A	G	5	8	13	0	1	14	0	0
9	30806642	.	G	T	13	4	17	0	0	17	0	0
9	30806662	.	T	G	9	3	12	0	0	12	0	0
9	30807902	.	T	C	3	3	6	0	0	6	0	0
9	30807944	.	C	T	3	7	10	0	0	10	0	0
9	30990731	.	T	C	8	6	14	1	1	16	0	0
9	30990845	.	A	G	10	11	21	0	0	21	0	0
9	31042584	.	T	C	25	29	54	0	2	56	0	0
9	31062518	.	T	A	21	19	40	0	2	42	0	0
9	31062588	.	G	A	19	17	36	0	2	38	0	0
9	31062589	.	G	A	19	19	38	0	1	39	0	0
9	31167733	.	C	T	1	2	3	0	0	3	0	0
9	31214307	.	T	G	2	7	9	0	0	9	0	0
9	31214442	.	A	C	5	6	11	0	1	12	0	0
9	31239258	.	A	G	10	0	10	0	7	17	0	0
9	31248923	.	C	T	11	9	20	0	1	21	0	0
9	31258832	.	G	A	7	8	15	0	0	15	0	0
9	31267491	.	T	A	1	4	5	0	0	5	0	0
9	31268856	.	G	T	3	7	10	0	1	11	0	0
9	31274993	.	T	C	14	0	14	3	9	26	0	0
9	31276912	.	C	T	29	20	49	0	0	49	0	0
9	31510724	.	T	A	9	4	13	0	1	14	0	0
9	31518804	.	C	T	4	2	6	0	0	6	0	0
9	31524405	.	G	A	5	2	7	0	0	7	0	0
9	31524406	.	T	C	5	2	7	0	0	7	0	0
9	31576987	.	T	C	1	3	4	1	0	5	0	0
9	31586434	.	G	A	1	3	4	0	0	4	0	0
9	31595634	.	C	T	20	18	38	0	2	40	0	0
9	31604943	.	G	A	10	16	26	0	0	26	0	0
9	31605235	.	A	G	8	3	11	0	2	13	0	0
9	31605260	.	T	C	8	0	8	0	8	16	0	0
9	31605281	.	C	A	1	10	11	0	5	16	0	0
9	31606333	.	C	T	9	6	15	0	0	15	0	0
9	31612184	.	C	T	9	9	18	0	0	18	0	0
9	31617687	.	A	G	5	12	17	0	0	17	0	0
9	31619998	.	A	G	6	8	14	0	0	14	0	0
9	31639107	.	C	T	1	3	4	0	11	15	0	0
9	31715887	.	A	G	5	4	9	0	1	10	0	0
9	31716932	.	G	A	6	6	12	0	2	14	0	0
9	31735673	.	A	G	8	7	15	0	0	15	0	0
9	31735676	.	A	C	8	8	16	0	0	16	0	0
9	31736102	.	G	A	3	9	12	0	1	13	0	0
9	32169182	.	A	G	23	32	55	0	1	56	0	0
9	32169287	.	G	A	25	28	53	0	2	55	0	0
9	32181865	.	A	G	3	2	5	0	0	5	0	0
9	32187866	.	A	T	2	6	8	0	0	8	0	0
9	32286804	.	C	G	3	5	8	0	3	11	0	0
9	32286858	.	C	T	6	7	13	0	1	14	0	0
9	32287162	.	A	G	12	11	23	0	1	24	0	0
9	32287208	.	A	C	17	13	30	0	1	31	0	0
9	32287418	.	A	G	15	14	29	0	1	30	0	0
9	32287419	.	A	G	12	14	26	0	4	30	0	0
9	32287481	.	T	C	16	23	39	0	1	40	0	0
9	32287688	.	A	G	18	22	40	0	1	41	0	0
9	32289064	.	C	A	0	16	16	0	16	32	0	0
9	32289281	.	G	A	19	13	32	0	0	32	0	0
9	32290957	.	G	A	16	11	27	0	0	27	0	0
9	32297376	.	G	A	10	6	16	0	0	16	0	0
9	32297472	.	T	C	9	9	18	0	0	18	0	0
9	32297487	.	C	T	9	10	19	0	0	19	0	0
9	32304476	.	G	A	11	8	19	0	1	20	0	0
9	32304643	.	C	T	1	1	2	0	0	3	1	0
9	32304655	.	A	G	1	3	4	0	0	4	0	0
9	32307717	.	T	C	22	19	41	0	1	42	0	0
9	32308523	.	A	C	15	10	25	0	2	27	0	0
9	32312472	.	C	T	30	21	51	0	0	51	0	0
9	32312600	.	A	G	25	2	27	0	19	46	0	0
9	32312683	.	C	A	13	19	32	0	3	35	0	0
9	32313260	.	T	C	10	3	13	0	1	14	0	0
9	32313318	.	T	C	10	4	14	0	1	15	0	0
9	32313626	.	C	T	8	6	14	0	0	14	0	0
9	32313689	.	A	G	5	2	7	0	0	7	0	0
9	32313875	.	G	T	14	7	21	0	2	23	0	0
9	32313964	.	G	A	8	12	20	0	1	21	0	0
9	32316114	.	C	T	8	4	12	0	1	13	0	0
9	32316348	.	C	G	12	6	18	0	0	18	0	0
9	32343547	.	T	A	0	3	3	0	1	4	0	0
9	32432640	.	A	G	1	2	3	0	0	3	0	0
9	32433925	.	C	T	4	3	7	0	0	7	0	0
9	32433957	.	A	T	0	5	5	0	1	6	0	0
9	32434098	.	T	G	3	4	7	0	0	7	0	0
9	32435052	.	G	A	9	4	13	0	0	13	0	0
9	32435121	.	T	A	10	4	14	0	0	14	0	0
9	32435127	.	T	A	7	5	12	0	0	12	0	0
9	32435256	.	T	G	3	5	8	0	0	8	0	0
9	32441761	.	A	G	10	0	10	0	7	17	0	0
9	32441800	.	T	C	12	9	21	0	0	21	0	0
9	32457192	.	C	T	13	13	26	0	0	26	0	0
9	32641053	.	A	T	2	2	4	0	0	4	0	0
9	32641131	.	T	A	4	3	7	0	0	7	0	0
9	32641175	.	T	G	8	8	16	0	1	17	0	0
9	32641278	.	A	T	7	13	20	0	1	21	0	0
9	32641294	.	G	T	10	12	22	0	0	22	0	0
9	32641424	.	G	A	10	3	13	0	0	13	0	0
9	32641442	.	G	C	9	3	12	0	0	12	0	0
9	32641600	.	A	G	4	11	15	0	0	15	0	0
9	32641682	.	A	G	11	10	21	0	0	21	0	0
9	32641731	.	C	A	8	14	22	0	3	25	0	0
9	32641737	.	A	G	11	14	25	0	3	28	0	0
9	32641802	.	T	C	9	10	19	0	2	21	0	0
9	32641805	.	A	G	11	8	19	0	1	20	0	0
9	32642342	.	A	G	4	13	17	0	3	20	0	0
9	32643643	.	G	A	9	8	17	0	2	19	0	0
9	32645615	.	G	C	7	21	28	0	3	31	0	0
9	32645939	.	T	C	8	10	18	0	1	19	0	0
9	32649147	.	C	T	9	6	15	0	0	15	0	0
9	32649662	.	T	C	3	2	5	0	0	5	0	0
9	32651241	.	A	T	2	9	11	0	0	11	0	0
9	32651277	.	A	G	3	0	3	0	4	7	0	0
9	32651334	.	C	T	6	7	13	0	1	14	0	0
9	32651527	.	C	A	3	8	11	0	0	11	0	0
9	32651648	.	A	G	2	4	6	0	0	6	0	0
9	32651665	.	T	C	3	6	9	0	1	10	0	0
9	32651826	.	T	C	3	3	6	0	0	6	0	0
9	32652059	.	A	G	6	0	6	0	3	9	0	0
9	32652072	.	T	C	4	5	9	0	0	9	0	0
9	32652129	.	C	T	3	2	5	0	0	5	0	0
9	32671163	.	G	T	1	2	3	0	0	3	0	0
9	32681804	.	A	T	2	2	4	0	0	4	0	0
9	32681877	.	A	C	5	6	11	0	0	11	0	0
9	32681880	.	A	C	6	5	11	0	0	11	0	0
9	32728896	.	G	C	8	9	17	0	1	18	0	0
9	32728969	.	A	G	8	18	26	0	0	26	0	0
9	32728984	.	C	A	9	14	23	0	0	23	0	0
9	32729022	.	T	C	5	10	15	0	2	17	0	0
9	32729183	.	T	G	3	3	6	0	0	6	0	0
9	32729908	.	C	A	2	10	12	0	0	12	0	0
9	32751579	.	A	G	1	7	8	0	1	9	0	0
9	32751640	.	A	G	12	17	29	0	0	29	0	0
9	32751812	.	A	G	7	15	22	0	2	24	0	0
9	32751825	.	C	T	7	13	20	0	0	20	0	0
9	32752272	.	C	T	17	17	34	0	1	35	0	0
9	32752555	.	C	T	16	13	29	0	1	30	0	0
9	32752794	.	A	C	13	1	14	0	16	30	0	0
9	32752824	.	G	T	16	13	29	0	0	29	0	0
9	32752864	.	G	T	16	15	31	0	2	33	0	0
9	32752995	.	T	C	6	11	17	0	4	21	0	0
9	32753016	.	C	G	10	19	29	0	0	29	0	0
9	32804802	.	C	T	9	5	14	0	0	14	0	0
9	32804898	.	C	A	1	3	4	0	8	12	0	0
9	32860395	.	A	C	4	3	7	0	0	7	0	0
9	32860396	.	A	C	3	3	6	0	1	7	0	0
9	32863357	.	G	A	2	3	5	0	1	6	0	0
9	32863381	.	T	C	2	6	8	0	0	8	0	0
9	32870757	.	G	A	4	3	7	0	1	8	0	0
9	32870793	.	A	G	3	4	7	0	0	7	0	0
9	32870886	.	T	C	2	2	4	0	0	4	0	0
9	32870922	.	T	C	1	3	4	0	0	4	0	0
9	32871509	.	A	G	6	4	10	0	1	11	0	0
9	32871514	.	T	C	8	4	12	0	0	12	0	0
9	32871562	.	G	A	8	3	11	0	1	12	0	0
9	32872881	.	G	A	5	2	7	0	1	8	0	0
9	32872932	.	T	C	5	4	9	0	0	9	0	0
9	32873025	.	G	A	7	3	10	0	0	10	0	0
9	32873040	.	C	T	8	3	11	0	1	12	0	0
9	32873127	.	G	T	6	3	9	0	0	9	0	0
9	32873151	.	G	A	0	3	3	0	7	10	0	0
9	32873544	.	G	T	1	8	9	0	12	21	0	0
9	32873788	.	C	A	14	4	18	0	0	18	0	0
9	32873792	.	C	A	13	4	17	0	0	17	0	0
9	32873834	.	A	T	13	5	18	0	0	18	0	0
9	32873940	.	G	A	7	3	10	0	0	10	0	0
9	32874222	.	T	G	6	6	12	0	2	14	0	0
9	32874603	.	G	A	1	5	6	0	13	19	0	0
9	32895294	.	A	T	12	3	15	0	0	15	0	0
9	32895297	.	T	C	11	0	11	0	3	14	0	0
9	32897304	.	C	T	9	9	18	0	0	18	0	0
9	32899796	.	C	T	7	6	13	0	1	14	0	0
9	32900000	.	T	C	4	0	4	0	7	11	0	0
9	32900267	.	C	T	0	11	11	0	12	23	0	0
9	32900453	.	A	G	7	10	17	0	0	17	0	0
9	32900768	.	A	G	6	9	15	0	0	15	0	0
9	32900849	.	G	A	8	12	20	0	1	21	0	0
9	32901173	.	A	G	10	9	19	0	0	19	0	0
9	32901176	.	T	A	9	9	18	0	0	18	0	0
9	32901275	.	G	A	2	8	10	0	1	11	0	0
9	32909683	.	A	G	3	4	7	0	1	8	0	0
9	32912464	.	A	G	5	3	8	0	0	8	0	0
9	32980561	.	T	A	4	5	9	0	0	9	0	0
9	32981252	.	C	T	2	6	8	0	0	8	0	0
9	32981302	.	C	T	4	4	8	0	0	8	0	0
9	32981317	.	T	C	4	3	7	0	1	8	0	0
9	33411227	.	C	A	11	12	23	0	0	23	0	0
9	33411228	.	A	G	10	12	22	0	0	22	0	0
9	33661021	.	T	C	2	1	3	0	5	8	0	0
9	33661399	.	A	G	26	10	36	0	1	37	0	0
9	33661424	.	G	A	18	13	31	0	2	33	0	0
9	33661645	.	A	T	13	4	17	0	2	19	0	0
9	33661691	.	A	T	10	7	17	0	1	18	0	0
9	33661714	.	G	A	9	5	14	0	2	16	0	0
9	33661765	.	C	T	9	9	18	0	0	18	0	0
9	33661773	.	A	C	10	10	20	0	0	20	0	0
9	33661939	.	T	A	14	8	22	0	1	23	0	0
9	33662043	.	A	G	8	5	13	0	0	13	0	0
9	33662134	.	C	T	20	6	26	0	2	28	0	0
9	33662158	.	A	G	20	10	30	0	0	30	0	0
9	33662175	.	T	G	22	10	32	0	0	32	0	0
9	33662223	.	A	T	12	9	21	0	1	22	0	0
9	33662250	.	A	T	7	8	15	0	0	15	0	0
9	33662273	.	A	C	5	8	13	0	2	15	0	0
9	33663176	.	T	A	7	6	13	0	0	13	0	0
9	33663300	.	G	A	8	10	18	0	0	18	0	0
9	33663331	.	A	G	12	13	25	0	1	26	0	0
9	33663455	.	A	G	5	13	18	0	1	19	0	0
9	33663816	.	T	C	6	0	6	0	6	12	0	0
9	33669020	.	C	A	3	4	7	0	0	7	0	0
9	33678095	.	G	A	6	3	9	0	1	10	0	0
9	33678124	.	A	G	3	6	9	0	4	13	0	0
9	33678164	.	T	G	4	5	9	0	0	9	0	0
9	33735177	.	G	T	1	2	3	0	0	3	0	0
9	33741597	.	G	C	5	3	8	0	0	8	0	0
9	33783800	.	A	T	12	12	24	0	1	26	1	0
9	33783822	.	T	A	20	16	36	0	1	37	0	0
9	33783956	.	T	C	31	23	54	0	1	55	0	0
9	33784689	.	T	G	33	30	63	0	2	65	0	0
9	33797118	.	A	G	5	3	8	0	1	9	0	0
9	33816267	.	C	T	4	6	10	0	0	10	0	0
9	33816289	.	C	T	2	4	6	0	1	7	0	0
9	33853510	.	A	G	16	0	16	0	11	27	0	0
9	33857776	.	C	T	12	8	20	0	0	20	0	0
9	33858088	.	G	A	11	8	19	0	1	20	0	0
9	33858111	.	T	C	11	10	21	0	0	21	0	0
9	34090223	.	G	C	4	4	8	0	0	8	0	0
9	34090618	.	A	G	2	3	5	0	0	5	0	0
9	34090715	.	T	A	2	2	4	0	0	4	0	0
9	34102362	.	A	G	3	1	4	0	4	8	0	0
9	34112981	.	T	C	3	4	7	0	0	7	0	0
9	34113008	.	A	T	6	4	10	0	0	10	0	0
9	34113140	.	G	A	2	3	5	0	0	5	0	0
9	34116933	.	A	G	5	7	12	0	0	12	0	0
9	34117293	.	A	C	12	4	16	0	0	16	0	0
9	34117578	.	C	G	2	7	9	0	2	11	0	0
9	34120207	.	T	A	1	3	4	0	0	4	0	0
9	34120732	.	C	T	1	5	6	0	2	8	0	0
9	34120826	.	G	A	6	5	11	0	0	11	0	0
9	34120863	.	C	A	4	6	10	0	0	10	0	0
9	34155005	.	T	G	6	2	8	0	0	8	0	0
9	34170057	.	G	A	10	8	18	0	1	19	0	0
9	34174561	.	C	T	4	6	10	0	1	11	0	0
9	34174682	.	G	A	8	6	14	0	0	14	0	0
9	34191597	.	G	A	5	9	14	0	0	14	0	0
9	34200253	.	T	A	6	5	11	0	0	11	0	0
9	34201156	.	G	A	6	3	9	0	0	9	0	0
9	34205537	.	A	G	5	3	8	0	0	8	0	0
9	34218953	.	A	G	4	8	12	0	0	12	0	0
9	34219058	.	G	T	2	6	8	0	0	8	0	0
9	34222113	.	C	T	21	14	35	0	1	36	0	0
9	34225055	.	A	G	17	19	36	0	1	37	0	0
9	34225316	.	G	C	27	16	43	0	2	45	0	0
9	34226884	.	G	A	22	28	50	0	4	54	0	0
9	34226888	.	G	A	4	29	33	1	21	55	0	0
9	34226960	.	A	C	19	17	36	0	1	37	0	0
9	34227016	.	A	T	11	16	27	0	3	30	0	0
9	34227020	.	C	G	13	15	28	0	0	28	0	0
9	34227054	.	C	T	11	14	25	0	1	26	0	0
9	34227074	.	C	A	9	11	20	0	1	21	0	0
9	34227365	.	G	T	1	2	3	0	0	3	0	0
9	34232612	.	G	T	2	4	6	0	0	6	0	0
9	34232672	.	T	C	4	6	10	0	0	10	0	0
9	34232718	.	G	T	3	5	8	0	0	8	0	0
9	34236709	.	G	A	1	3	4	0	1	5	0	0
9	34238849	.	C	T	5	2	7	0	0	7	0	0
9	34238858	.	C	A	5	2	7	0	0	7	0	0
9	34238915	.	T	C	9	7	16	0	0	16	0	0
9	34243122	.	G	C	9	7	16	0	0	16	0	0
9	34243567	.	G	T	12	8	20	0	0	20	0	0
9	34246473	.	G	A	6	6	12	0	0	12	0	0
9	34246524	.	G	A	7	6	13	0	0	13	0	0
9	34246555	.	T	G	5	6	11	0	0	11	0	0
9	34246628	.	G	A	4	4	8	0	1	9	0	0
9	34246710	.	G	A	9	9	18	0	1	19	0	0
9	34246932	.	A	G	11	13	24	0	3	27	0	0
9	34247086	.	G	T	24	5	29	1	2	32	0	0
9	34247087	.	C	T	25	5	30	1	1	32	0	0
9	34247356	.	G	A	12	11	23	0	2	25	0	0
9	34251632	.	G	A	11	16	27	0	2	29	0	0
9	34251707	.	C	G	16	20	36	0	0	36	0	0
9	34251752	.	G	A	13	10	23	0	0	23	0	0
9	34251764	.	G	A	13	10	23	0	0	23	0	0
9	34251963	.	A	G	15	13	28	0	0	28	0	0
9	34254851	.	A	G	9	6	15	0	0	15	0	0
9	34254896	.	G	A	8	12	20	0	0	20	0	0
9	34256016	.	A	C	10	6	16	0	0	16	0	0
9	34258384	.	A	G	5	5	10	0	0	10	0	0
9	34258580	.	C	T	0	7	7	0	4	11	0	0
9	34259406	.	T	A	8	4	12	0	0	12	0	0
9	34259418	.	T	A	9	3	12	0	0	12	0	0
9	34260164	.	C	T	2	11	13	0	0	13	0	0
9	34277840	.	G	A	1	2	3	0	0	3	0	0
9	34334173	.	T	G	11	0	11	0	12	23	0	0
9	34349379	.	T	C	7	11	18	0	1	19	0	0
9	34352271	.	G	A	3	5	8	0	0	8	0	0
9	34380503	.	T	A	6	22	28	0	1	29	0	0
9	34380525	.	T	A	8	26	34	0	2	36	0	0
9	34382946	.	A	T	13	21	34	0	0	34	0	0
9	34385183	.	A	G	9	10	19	0	0	19	0	0
9	34385396	.	A	G	16	1	17	0	24	41	0	0
9	34388882	.	G	A	13	11	24	0	2	26	0	0
9	34389077	.	T	C	12	13	25	0	0	25	0	0
9	34389101	.	C	G	10	10	20	0	2	22	0	0
9	34389288	.	T	G	15	11	26	0	0	26	0	0
9	34389299	.	T	G	16	0	16	0	12	28	0	0
9	34389427	.	C	T	17	17	34	0	2	36	0	0
9	34389602	.	A	G	21	0	21	0	14	35	0	0
9	34389666	.	A	G	19	15	34	0	3	37	0	0
9	34389701	.	A	T	21	14	35	0	2	37	0	0
9	34389704	.	G	C	23	15	38	0	0	38	0	0
9	34389743	.	G	T	12	15	27	0	1	28	0	0
9	34389748	.	A	C	13	16	29	0	0	29	0	0
9	34389791	.	A	G	5	6	11	0	1	12	0	0
9	34397996	.	G	A	1	6	7	0	2	9	0	0
9	34399884	.	A	C	4	2	6	0	0	6	0	0
9	34401847	.	G	T	1	2	3	0	1	4	0	0
9	34404827	.	C	T	3	6	9	0	0	9	0	0
9	34404830	.	T	G	3	5	8	0	1	9	0	0
9	34405078	.	A	T	3	2	5	0	1	6	0	0
9	34405155	.	A	G	4	3	7	0	0	7	0	0
9	34408044	.	A	G	4	4	8	0	0	8	0	0
9	34408154	.	C	T	2	2	4	0	0	4	0	0
9	34409576	.	C	T	8	3	11	0	1	12	0	0
9	34409578	.	G	A	9	3	12	0	0	12	0	0
9	34410156	.	G	A	1	5	6	0	0	6	0	0
9	34410237	.	T	C	6	3	9	0	0	9	0	0
9	34415308	.	T	C	11	4	15	0	0	15	0	0
9	34416575	.	A	T	5	8	13	0	1	14	0	0
9	34423397	.	C	A	5	10	15	1	4	20	0	0
9	34423415	.	T	A	6	13	19	0	1	20	0	0
9	34423468	.	T	A	4	7	11	0	1	12	0	0
9	34423474	.	A	G	5	0	5	0	7	12	0	0
9	34423794	.	T	C	5	3	8	0	0	8	0	0
9	34423822	.	T	A	5	2	7	0	0	7	0	0
9	34425920	.	C	T	3	10	13	0	2	15	0	0
9	34491034	.	C	A	4	3	7	0	1	8	0	0
9	34647415	.	A	G	13	1	14	0	18	32	0	0
9	34647427	.	A	C	12	16	28	0	3	31	0	0
9	34866579	.	T	G	19	7	26	0	1	27	0	0
9	34866684	.	T	A	5	6	11	0	0	12	1	0
9	34866888	.	C	T	12	25	37	0	1	38	0	0
9	34867007	.	C	A	3	11	14	0	16	30	0	0
9	34867015	.	T	C	13	0	13	0	15	28	0	0
9	34869699	.	A	G	16	14	30	0	1	31	0	0
9	34869813	.	G	A	13	13	26	0	0	26	0	0
9	34869945	.	G	A	16	13	29	0	1	30	0	0
9	34871796	.	G	C	16	16	32	0	0	32	0	0
9	34877024	.	G	A	3	3	6	0	0	6	0	0
9	34877042	.	G	A	5	6	11	0	0	11	0	0
9	34877074	.	C	T	3	4	7	0	0	7	0	0
9	34877285	.	G	A	4	2	6	0	0	6	0	0
9	34877315	.	G	A	6	5	11	0	0	11	0	0
9	34878338	.	T	A	2	2	4	0	0	4	0	0
9	34880471	.	T	C	3	5	8	0	1	9	0	0
9	34880623	.	C	T	0	4	4	0	3	7	0	0
9	34880634	.	G	A	2	2	4	0	0	4	0	0
9	34903218	.	T	G	31	19	50	0	2	52	0	0
9	34906337	.	C	G	24	30	54	0	3	57	0	0
9	34912626	.	A	T	23	21	44	0	2	46	0	0
9	34912695	.	T	C	22	2	24	0	23	47	0	0
9	34912895	.	T	A	17	19	36	0	5	42	1	0
9	34920395	.	G	A	8	6	14	0	1	15	0	0
9	34922670	.	C	T	1	8	9	0	5	14	0	0
9	34922898	.	A	G	2	7	9	0	0	9	0	0
9	34938795	.	C	T	12	7	19	0	0	19	0	0
9	34939336	.	A	G	14	10	24	0	3	27	0	0
9	34939800	.	T	C	4	13	17	0	1	18	0	0
9	34967647	.	C	T	5	4	9	0	0	9	0	0
9	34967649	.	C	T	4	4	8	0	0	8	0	0
9	34967733	.	A	G	8	7	15	0	0	15	0	0
9	34967743	.	A	C	10	6	16	0	0	16	0	0
9	34968005	.	A	G	6	9	15	0	0	15	0	0
9	35014847	.	C	G	4	2	6	0	0	6	0	0
9	35016453	.	G	T	1	2	3	0	0	3	0	0
9	35022050	.	A	G	1	5	6	0	0	6	0	0
9	35024459	.	G	C	0	10	10	0	8	18	0	0
9	35025183	.	C	T	10	5	15	0	0	15	0	0
9	35025243	.	A	T	3	4	7	0	1	8	0	0
9	35026736	.	T	A	28	26	54	0	3	57	0	0
9	35026941	.	T	C	32	29	61	0	1	62	0	0
9	35027262	.	A	G	42	23	65	0	2	67	0	0
9	35027309	.	T	C	39	1	40	0	27	67	0	0
9	35027333	.	A	G	32	29	61	0	2	63	0	0
9	35027365	.	G	T	31	29	60	0	4	64	0	0
9	35027371	.	G	T	33	32	65	0	2	68	1	0
9	35027402	.	G	A	33	35	68	0	0	68	0	0
9	35027549	.	T	G	37	24	61	0	2	63	0	0
9	35027705	.	G	A	19	1	20	0	2	34	12	0
9	35028086	.	T	C	42	4	46	0	33	79	0	0
9	35028282	.	T	C	39	3	42	0	37	79	0	0
9	35030977	.	G	A	30	28	58	1	3	62	0	0
9	35032640	.	A	G	29	29	58	0	2	60	0	0
9	35032643	.	A	G	29	28	57	0	3	60	0	0
9	35033347	.	C	T	29	20	49	0	8	57	0	0
9	35039175	.	T	C	28	27	55	1	1	57	0	0
9	35048839	.	G	C	31	30	61	0	2	63	0	0
9	35048840	.	A	C	32	30	62	0	2	64	0	0
9	35170671	.	G	A	6	13	19	0	0	19	0	0
9	35176030	.	A	G	27	13	40	0	0	40	0	0
9	35228165	.	G	A	10	11	21	0	0	21	0	0
9	35230740	.	G	A	15	5	20	0	1	21	0	0
9	35233382	.	A	T	7	2	9	0	0	9	0	0
9	35254679	.	G	A	7	13	20	0	0	20	0	0
9	35266330	.	C	T	0	10	10	0	8	18	0	0
9	35296835	.	C	T	11	5	16	0	1	17	0	0
9	35836674	.	T	G	4	6	10	0	0	10	0	0
9	35836721	.	T	A	6	3	9	0	0	9	0	0
9	35837194	.	C	G	6	0	6	0	7	13	0	0
9	35837404	.	C	A	6	7	13	0	0	13	0	0
9	35838477	.	T	A	11	14	25	0	0	25	0	0
9	35840713	.	G	A	2	15	17	0	0	17	0	0
9	35840782	.	T	C	9	5	14	0	1	15	0	0
9	35841115	.	T	G	1	6	7	0	0	7	0	0
9	35841279	.	G	T	4	4	8	0	0	8	0	0
9	35841282	.	A	G	5	4	9	0	0	9	0	0
9	35841663	.	G	T	7	6	13	0	0	13	0	0
9	35841879	.	T	A	12	8	20	0	1	21	0	0
9	35841994	.	A	G	11	5	16	0	2	18	0	0
9	35842164	.	T	A	7	6	13	0	0	13	0	0
9	35842209	.	G	T	6	5	11	0	1	12	0	0
9	35860982	.	G	A	7	8	15	0	0	15	0	0
9	35860983	.	A	T	7	8	15	0	0	15	0	0
9	35862184	.	A	T	15	17	32	0	0	32	0	0
9	35862299	.	G	A	17	17	34	0	1	35	0	0
9	35863132	.	C	T	20	18	38	0	2	40	0	0
9	35863555	.	T	C	16	21	37	0	1	38	0	0
9	35863603	.	T	C	23	13	36	0	2	38	0	0
9	35863798	.	C	T	21	14	35	0	1	36	0	0
9	35863968	.	A	T	16	8	24	0	3	27	0	0
9	35864155	.	A	T	10	15	25	0	0	25	0	0
9	35864210	.	C	T	5	10	15	0	0	15	0	0
9	35864266	.	C	A	6	8	14	0	0	14	0	0
9	35864277	.	C	T	7	7	14	0	1	15	0	0
9	35864356	.	A	G	1	6	7	0	1	8	0	0
9	35864416	.	A	C	2	4	6	0	1	7	0	0
9	35864486	.	C	T	5	7	12	0	0	12	0	0
9	35864565	.	A	G	7	14	21	0	0	21	0	0
9	35864598	.	C	T	9	13	22	0	0	22	0	0
9	35865073	.	C	T	20	20	40	0	2	42	0	0
9	35865162	.	G	T	11	16	27	1	1	29	0	0
9	35865270	.	C	G	6	11	17	0	3	20	0	0
9	35872993	.	A	T	5	3	8	0	0	8	0	0
9	35885084	.	G	A	1	2	3	0	0	3	0	0
9	35901573	.	C	G	1	3	4	0	0	4	0	0
9	35901598	.	G	C	4	7	11	0	0	11	0	0
9	35901654	.	T	A	8	12	20	0	1	21	0	0
9	35906533	.	C	A	3	2	5	0	1	6	0	0
9	35907553	.	C	T	6	15	21	0	0	21	0	0
9	35909794	.	T	C	5	5	10	0	0	10	0	0
9	35909842	.	A	G	3	6	9	0	1	10	0	0
9	35910390	.	C	G	11	21	32	0	0	32	0	0
9	35910672	.	T	C	4	6	10	0	1	11	0	0
9	35912447	.	A	T	4	5	9	0	2	11	0	0
9	35912459	.	G	A	7	8	15	0	1	16	0	0
9	35915327	.	C	A	6	19	25	0	1	26	0	0
9	35915548	.	C	T	10	23	33	0	1	34	0	0
9	35915557	.	G	A	1	27	28	0	9	37	0	0
9	35916518	.	T	G	12	23	35	0	1	36	0	0
9	35916786	.	G	A	17	16	33	0	4	38	1	0
9	35922046	.	T	G	18	23	41	2	0	43	0	0
9	35922115	.	T	C	10	14	24	0	3	27	0	0
9	36375155	.	G	A	3	2	5	0	0	5	0	0
9	36426844	.	G	C	1	2	3	0	0	3	0	0
9	36540309	.	C	T	4	2	6	0	0	6	0	0
9	36577315	.	T	C	2	3	5	0	0	5	0	0
9	36580205	.	A	G	3	3	6	0	1	7	0	0
9	36585992	.	G	A	0	2	2	0	5	7	0	0
9	36595536	.	G	A	1	5	6	0	0	6	0	0
9	36610139	.	C	T	4	2	6	0	0	6	0	0
9	36610163	.	T	C	3	2	5	0	0	5	0	0
9	36656011	.	A	G	2	4	6	0	0	6	0	0
9	36659702	.	T	G	9	6	15	0	1	16	0	0
9	36896761	.	C	A	1	5	6	0	5	11	0	0
9	36896791	.	C	T	5	4	9	0	0	9	0	0
9	36898724	.	C	T	8	7	15	0	1	16	0	0
9	36899065	.	C	T	1	5	6	0	11	17	0	0
9	36973147	.	T	C	1	2	3	0	0	3	0	0
9	36973751	.	T	C	2	5	7	0	1	8	0	0
9	36973841	.	C	G	3	5	8	0	0	8	0	0
9	36974170	.	G	T	7	3	10	0	0	10	0	0
9	36974191	.	T	C	6	2	8	0	1	9	0	0
9	37294635	.	T	C	1	1	2	0	0	2	0	0
9	37294641	.	A	C	1	2	3	0	0	3	0	0
9	37294745	.	A	T	1	2	3	0	0	3	0	0
9	37294755	.	C	T	0	2	2	0	0	2	0	0
9	37296124	.	A	G	1	2	3	0	1	4	0	0
9	37296192	.	G	A	2	3	5	1	0	6	0	0
9	37296235	.	G	T	1	2	3	0	0	3	0	0
9	37348530	.	A	G	2	3	5	0	0	5	0	0
9	37354220	.	A	G	3	5	8	0	0	8	0	0
9	37371515	.	A	T	4	9	13	0	0	13	0	0
9	37387230	.	T	C	5	3	8	0	1	9	0	0
9	37387233	.	T	C	5	5	10	0	0	10	0	0
9	37390314	.	C	T	6	4	10	0	0	10	0	0
9	37416605	.	C	T	7	3	10	0	1	11	0	0
9	37416617	.	C	T	8	6	14	0	0	14	0	0
9	37431935	.	G	A	0	3	3	0	6	9	0	0
9	37451609	.	T	G	12	5	17	0	0	17	0	0
9	37452012	.	A	T	5	11	16	0	0	16	0	0
9	37452223	.	C	T	7	10	17	0	1	18	0	0
9	37452432	.	G	A	6	10	16	0	2	18	0	0
9	37452499	.	T	G	18	5	23	0	4	27	0	0
9	37452515	.	G	T	16	9	25	0	1	26	0	0
9	37452616	.	T	G	23	10	33	0	0	33	0	0
9	37452819	.	G	C	10	6	16	0	1	17	0	0
9	37452862	.	T	C	13	5	18	0	0	18	0	0
9	37452924	.	C	G	12	8	20	0	1	21	0	0
9	37492798	.	G	A	6	3	9	0	2	11	0	0
9	37492807	.	A	G	7	4	11	0	1	12	0	0
9	37497510	.	C	T	0	2	2	0	6	8	0	0
9	37508255	.	T	C	4	3	7	0	0	7	0	0
9	37563478	.	T	C	1	2	3	0	0	3	0	0
9	37573890	.	C	G	2	3	5	0	0	5	0	0
9	37771849	.	A	G	3	3	6	0	0	6	0	0
9	37840024	.	G	T	2	3	5	0	2	7	0	0
9	37850479	.	G	C	3	5	8	0	0	8	0	0
9	37850559	.	T	A	7	6	13	0	0	13	0	0
9	37850574	.	A	G	5	0	5	0	5	11	1	0
9	37853970	.	A	C	4	8	12	0	0	12	0	0
9	37856541	.	C	T	11	7	18	0	0	18	0	0
9	37856895	.	T	A	6	8	14	0	0	14	0	0
9	37859807	.	G	T	13	10	23	0	0	23	0	0
9	37859881	.	T	G	9	15	24	0	0	24	0	0
9	37860116	.	T	C	10	6	16	0	1	17	0	0
9	37860504	.	G	A	1	2	3	0	0	3	0	0
9	37860508	.	G	A	1	2	3	0	0	3	0	0
9	37861307	.	G	A	0	4	4	0	2	6	0	0
9	37861560	.	A	G	2	0	2	0	3	5	0	0
9	37861844	.	G	A	2	5	7	0	1	8	0	0
9	37862154	.	C	T	6	2	8	0	0	8	0	0
9	37862193	.	G	A	3	3	6	0	0	6	0	0
9	37862376	.	T	C	1	3	4	0	0	4	0	0
9	37941602	.	C	T	9	5	14	0	0	14	0	0
9	38021226	.	T	C	2	0	2	0	4	6	0	0
9	38030131	.	A	T	18	9	27	0	0	28	1	0
9	38030366	.	A	T	5	8	13	0	0	13	0	0
9	38030485	.	A	T	7	11	18	0	2	20	0	0
9	38030503	.	C	T	0	12	12	0	11	23	0	0
9	38030574	.	G	A	16	10	26	0	0	26	0	0
9	38033363	.	T	C	17	1	18	0	13	31	0	0
9	38033578	.	A	G	17	13	30	0	0	30	0	0
9	38042752	.	G	A	8	6	14	0	0	14	0	0
9	38057075	.	A	G	6	2	8	0	0	8	0	0
9	38058608	.	T	C	6	7	13	1	0	14	0	0
9	38059042	.	C	T	7	3	10	0	0	10	0	0
9	38061311	.	G	A	6	8	14	0	0	14	0	0
9	38061525	.	G	T	0	13	13	0	6	19	0	0
9	38061699	.	T	C	6	7	13	0	0	13	0	0
9	38061788	.	T	C	15	11	26	0	1	27	0	0
9	38063688	.	C	A	9	13	22	1	1	24	0	0
9	38063689	.	C	A	10	13	23	1	0	24	0	0
9	38064165	.	A	T	6	6	12	0	0	12	0	0
9	38064268	.	T	C	6	6	12	0	0	12	0	0
9	38064420	.	T	G	11	4	15	0	0	15	0	0
9	38064421	.	C	A	11	4	15	0	0	15	0	0
9	38064672	.	A	C	4	6	10	0	0	10	0	0
9	38074140	.	A	T	3	5	8	0	1	9	0	0
9	38129312	.	C	G	10	5	15	0	1	16	0	0
9	38129632	.	A	G	3	0	3	0	5	8	0	0
9	38129902	.	C	T	3	2	5	0	0	5	0	0
9	38130025	.	A	T	1	2	3	0	1	4	0	0
9	38140963	.	C	A	0	2	2	0	1	3	0	0
9	38142493	.	A	G	1	1	2	0	1	3	0	0
9	38144499	.	T	A	7	2	9	0	0	9	0	0
9	38161177	.	A	G	1	0	1	0	5	6	0	0
9	38161842	.	C	T	2	4	6	0	0	6	0	0
9	38161905	.	G	A	1	2	3	0	0	3	0	0
9	38161975	.	T	G	2	2	4	0	1	5	0	0
9	38167747	.	T	G	4	4	8	0	0	8	0	0
9	38167761	.	G	A	3	3	6	0	0	6	0	0
9	38167875	.	T	C	2	2	4	0	1	5	0	0
9	38205480	.	G	T	1	3	4	0	4	8	0	0
9	38207504	.	C	T	3	5	8	0	0	8	0	0
9	38207964	.	G	A	8	7	15	0	1	16	0	0
9	38238917	.	G	A	1	5	6	0	8	14	0	0
9	38251409	.	T	C	9	4	13	0	0	13	0	0
9	38269630	.	A	G	6	5	11	0	0	11	0	0
9	38273171	.	G	A	24	16	40	0	0	40	0	0
9	38273264	.	T	A	14	14	28	0	0	28	0	0
9	38276558	.	T	G	4	0	4	0	8	12	0	0
9	38277513	.	A	G	12	9	21	0	0	21	0	0
9	38278121	.	A	G	16	11	27	0	0	27	0	0
9	38278289	.	C	T	13	12	25	0	0	25	0	0
9	38278301	.	T	C	15	13	28	0	0	28	0	0
9	38278337	.	T	C	17	6	23	0	1	24	0	0
9	38283647	.	G	A	16	14	30	0	0	30	0	0
9	38283659	.	C	T	15	14	29	0	0	29	0	0
9	38284317	.	A	G	17	0	17	0	14	31	0	0
9	38285598	.	A	G	21	15	36	0	1	37	0	0
9	38286823	.	G	A	17	9	26	0	2	28	0	0
9	38290165	.	C	T	9	13	22	0	2	24	0	0
9	38290210	.	A	G	5	11	16	0	5	21	0	0
9	38290220	.	T	G	9	0	9	0	11	20	0	0
9	38290245	.	C	T	10	12	22	0	1	23	0	0
9	38290414	.	A	G	15	11	26	0	1	27	0	0
9	38290517	.	A	C	11	10	21	0	1	22	0	0
9	38290530	.	A	T	16	9	25	0	0	25	0	0
9	38290561	.	C	T	13	6	19	1	0	20	0	0
9	38290777	.	G	T	3	16	19	0	20	39	0	0
9	38290959	.	A	C	25	16	41	0	0	41	0	0
9	38291439	.	G	T	21	11	32	0	0	32	0	0
9	38291616	.	C	T	15	6	21	0	0	21	0	0
9	38291737	.	C	A	8	6	14	0	1	15	0	0
9	38315128	.	T	G	8	4	12	0	0	12	0	0
9	38351016	.	T	C	4	8	12	0	0	12	0	0
9	38353794	.	T	C	17	8	25	0	0	25	0	0
9	38354000	.	T	C	15	9	24	0	0	24	0	0
9	38354224	.	A	G	16	7	23	0	0	23	0	0
9	38354689	.	G	A	10	9	19	0	1	20	0	0
9	38359027	.	A	C	8	0	8	0	9	17	0	0
9	38359737	.	G	A	10	4	14	0	1	15	0	0
9	38360102	.	C	T	1	4	5	0	10	15	0	0
9	38362354	.	G	A	14	8	22	0	1	23	0	0
9	38362380	.	C	T	12	11	23	0	0	23	0	0
9	38368055	.	A	G	4	4	8	0	0	8	0	0
9	38372264	.	C	T	7	3	10	0	0	10	0	0
9	38375890	.	T	G	5	5	10	0	0	10	0	0
9	38376129	.	A	T	1	3	4	0	0	4	0	0
9	38376231	.	T	C	7	5	12	0	0	12	0	0
9	38376248	.	A	T	6	3	9	0	1	10	0	0
9	38377858	.	G	A	5	7	12	0	0	12	0	0
9	38385734	.	G	A	4	6	10	0	0	10	0	0
9	38386066	.	A	G	4	0	4	0	5	9	0	0
9	38386205	.	C	T	2	9	11	0	0	11	0	0
9	38386615	.	C	A	3	3	6	0	0	6	0	0
9	38388492	.	C	T	10	6	16	0	0	16	0	0
9	38388493	.	C	T	2	6	8	0	8	16	0	0
9	38388703	.	T	C	13	7	20	0	0	20	0	0
9	38389026	.	T	A	2	7	9	0	0	9	0	0
9	38389194	.	C	T	4	7	11	0	0	11	0	0
9	38389263	.	T	A	4	8	12	0	0	12	0	0
9	38389426	.	G	A	11	12	23	0	0	23	0	0
9	38389603	.	A	G	5	1	6	0	6	12	0	0
9	38389616	.	C	T	4	10	14	0	0	14	0	0
9	38389644	.	A	T	5	17	22	0	1	23	0	0
9	38389722	.	G	T	6	6	12	0	0	12	0	0
9	38389746	.	T	C	5	9	14	1	1	16	0	0
9	38389800	.	T	C	4	0	4	2	3	9	0	0
9	38389886	.	C	T	6	10	16	0	0	16	0	0
9	38391549	.	C	T	4	8	12	0	0	12	0	0
9	38392097	.	T	C	3	3	6	0	0	6	0	0
9	38393070	.	T	A	3	2	5	0	0	5	0	0
9	38393080	.	G	C	3	3	6	0	0	6	0	0
9	38396338	.	C	T	1	2	3	0	0	3	0	0
9	38396343	.	T	G	1	2	3	0	0	3	0	0
9	38396592	.	T	C	1	3	4	0	0	4	0	0
9	38396699	.	G	C	1	2	3	0	0	3	0	0
9	38397263	.	A	G	3	2	5	0	0	5	0	0
9	38405238	.	A	G	5	2	7	0	1	8	0	0
9	38405271	.	G	C	4	2	6	0	1	7	0	0
9	38413298	.	C	T	5	7	12	0	1	13	0	0
9	38418623	.	C	T	1	6	7	0	0	7	0	0
9	38418864	.	T	C	6	6	12	0	0	12	0	0
9	38429624	.	G	T	11	3	14	0	0	14	0	0
9	38429707	.	T	C	11	3	14	0	0	14	0	0
9	38429716	.	A	C	10	3	13	0	1	14	0	0
9	38429894	.	A	T	5	2	7	3	0	10	0	0
9	38456091	.	A	C	1	4	5	0	0	5	0	0
9	38456111	.	T	C	2	3	5	0	0	5	0	0
9	38458204	.	A	C	5	2	7	0	0	7	0	0
9	38458220	.	T	A	6	3	9	0	0	9	0	0
9	38458262	.	T	G	2	0	2	0	2	4	0	0
9	38458269	.	T	C	2	2	4	0	0	4	0	0
9	38458825	.	C	T	3	2	5	0	0	5	0	0
9	38458999	.	T	A	2	3	5	0	0	5	0	0
9	38464295	.	A	G	2	4	6	0	0	6	0	0
9	38466332	.	T	G	2	2	4	0	0	4	0	0
9	38470376	.	C	T	7	5	12	0	0	12	0	0
9	38473937	.	T	C	4	2	6	0	0	6	0	0
9	38473973	.	C	T	5	2	7	0	0	7	0	0
9	38475598	.	T	C	2	5	7	0	0	7	0	0
9	38476780	.	G	C	1	4	5	0	0	5	0	0
9	38476810	.	T	G	1	5	6	0	0	6	0	0
9	38476842	.	G	T	1	6	7	0	2	9	0	0
9	38478252	.	A	G	4	2	6	0	0	6	0	0
9	38478424	.	T	C	5	4	9	0	0	9	0	0
9	38478477	.	G	A	0	6	6	0	1	7	0	0
9	38478643	.	A	T	3	5	8	0	0	8	0	0
9	38479579	.	A	G	5	0	5	0	5	10	0	0
9	38502640	.	A	G	3	3	6	0	2	8	0	0
9	38507790	.	C	T	1	2	3	0	0	3	0	0
9	38525107	.	A	C	3	2	5	0	0	5	0	0
9	38525125	.	T	C	2	2	4	0	0	4	0	0
9	38550889	.	T	C	3	2	5	0	0	5	0	0
9	38550910	.	T	C	3	2	5	0	0	5	0	0
9	38600006	.	G	A	2	5	7	0	5	12	0	0
9	38603338	.	A	T	14	13	27	0	1	28	0	0
9	38603742	.	T	C	20	6	26	0	3	29	0	0
9	38620058	.	C	T	13	10	23	0	0	23	0	0
9	38620308	.	C	A	7	4	11	0	0	11	0	0
9	38620673	.	A	G	24	15	39	0	3	42	0	0
9	38629997	.	T	A	1	5	6	0	0	6	0	0
9	38634508	.	A	G	2	2	4	0	0	4	0	0
9	38636152	.	A	G	1	0	1	0	5	6	0	0
9	38636170	.	A	G	2	4	6	0	0	6	0	0
9	38636413	.	G	T	1	8	9	0	6	15	0	0
9	38636722	.	T	C	3	3	6	0	0	6	0	0
9	38636797	.	T	C	8	6	14	0	0	14	0	0
9	38637072	.	G	T	1	3	4	0	1	5	0	0
9	38637872	.	T	C	2	7	9	0	0	9	0	0
9	38637879	.	A	C	1	5	6	0	0	6	0	0
9	38638197	.	C	T	4	2	6	0	1	7	0	0
9	38638452	.	A	T	2	9	11	0	0	11	0	0
9	38638461	.	C	G	2	7	9	0	1	10	0	0
9	38638492	.	A	G	7	0	7	0	4	11	0	0
9	38638518	.	T	C	9	4	13	0	1	14	0	0
9	38638743	.	T	C	9	8	17	0	0	17	0	0
9	38638862	.	C	T	3	2	5	0	0	5	0	0
9	38638863	.	C	A	4	1	5	0	1	6	0	0
9	38638970	.	G	A	4	2	6	0	1	7	0	0
9	38639799	.	T	C	3	1	4	0	1	5	0	0
9	38639846	.	C	T	5	7	12	0	0	12	0	0
9	38639907	.	A	C	5	5	10	0	1	11	0	0
9	38640114	.	T	A	5	9	14	0	0	14	0	0
9	38640186	.	T	C	3	6	9	0	0	9	0	0
9	38640193	.	T	C	4	3	7	0	1	8	0	0
9	38640598	.	A	G	4	0	4	0	6	10	0	0
9	38641111	.	C	T	6	4	10	0	0	10	0	0
9	38641196	.	C	G	1	3	4	0	0	4	0	0
9	38706615	.	C	A	2	2	4	0	0	4	0	0
9	38706621	.	C	G	1	2	3	0	1	4	0	0
9	38706894	.	T	A	2	6	8	0	0	8	0	0
9	38707108	.	T	A	0	1	1	0	1	3	1	0
9	38707187	.	C	T	5	2	7	0	0	7	0	0
9	38743960	.	T	G	2	0	2	0	3	5	0	0
9	38761700	.	G	A	1	2	3	0	1	4	0	0
9	38761708	.	A	G	2	2	4	0	1	5	0	0
9	38888025	.	A	T	7	8	15	0	1	16	0	0
9	40928199	.	T	C	4	4	8	0	0	8	0	0
9	40928245	.	T	C	11	3	14	0	1	15	0	0
9	40928284	.	T	C	4	0	4	0	8	12	0	0
9	40928706	.	T	C	2	4	6	0	0	6	0	0
9	40928717	.	T	C	5	2	7	0	0	7	0	0
9	40930319	.	T	C	6	3	9	0	1	10	0	0
9	40930354	.	T	C	5	4	9	0	0	9	0	0
9	41479871	.	A	G	2	3	5	0	0	5	0	0
9	41479883	.	A	G	4	1	5	0	1	6	0	0
9	41479980	.	A	G	2	3	5	0	0	5	0	0
9	41481147	.	A	G	5	4	9	0	0	9	0	0
9	42360743	.	C	G	7	10	17	0	0	17	0	0
9	42360893	.	C	T	1	8	9	0	8	17	0	0
9	42360899	.	G	A	7	8	15	0	0	15	0	0
9	42372354	.	T	A	2	5	7	0	0	7	0	0
9	42418425	.	T	C	4	2	6	0	0	6	0	0
9	42418463	.	C	A	2	2	4	0	0	4	0	0
9	42421027	.	G	A	4	3	7	0	0	7	0	0
9	42421044	.	G	T	6	3	9	0	0	9	0	0
9	42421232	.	T	A	8	5	13	0	0	13	0	0
9	42644892	.	A	G	14	0	14	0	9	23	0	0
9	42649583	.	A	G	4	6	10	0	0	10	0	0
9	42649636	.	T	A	2	5	7	0	0	7	0	0
9	42649653	.	T	C	4	5	9	0	0	9	0	0
9	42649739	.	C	T	8	6	14	0	0	14	0	0
9	42649743	.	A	G	7	7	14	0	1	15	0	0
9	42649923	.	A	G	5	4	9	0	1	10	0	0
9	42653737	.	T	C	2	3	5	0	0	5	0	0
9	42658401	.	G	C	1	2	3	0	1	4	0	0
9	42658788	.	A	G	4	6	10	0	0	10	0	0
9	42658818	.	T	C	2	0	2	0	7	9	0	0
9	42660036	.	T	C	1	4	5	0	2	7	0	0
9	42660732	.	G	A	1	2	3	0	0	3	0	0
9	42662977	.	A	T	3	4	7	0	0	7	0	0
9	42730451	.	A	C	1	2	3	0	0	3	0	0
9	43082373	.	A	T	5	3	8	0	0	8	0	0
9	43082398	.	A	G	6	4	10	0	0	10	0	0
9	43082519	.	C	A	1	2	3	0	3	6	0	0
9	43082541	.	A	C	3	1	4	0	1	5	0	0
9	43082717	.	T	G	1	2	3	0	0	3	0	0
9	43085369	.	G	T	3	4	7	0	0	7	0	0
9	43085471	.	G	C	7	3	10	0	0	10	0	0
9	43085527	.	A	T	1	3	4	0	1	5	0	0
9	43085728	.	A	C	10	4	14	0	0	14	0	0
9	43085879	.	C	T	4	3	7	0	0	7	0	0
9	43085949	.	A	C	5	2	7	0	1	8	0	0
9	43088841	.	C	A	2	5	7	0	0	7	0	0
9	43088870	.	T	A	1	2	3	0	3	6	0	0
9	43088884	.	G	A	5	2	7	0	0	7	0	0
9	43088984	.	A	G	3	3	6	0	0	6	0	0
9	43116349	.	C	T	1	1	2	0	1	3	0	0
9	43116358	.	G	C	1	2	3	0	0	3	0	0
9	43116589	.	C	A	3	2	5	0	0	5	0	0
9	43150018	.	T	A	6	12	18	0	3	21	0	0
9	43150278	.	T	G	8	13	21	0	0	21	0	0
9	43150604	.	A	G	14	14	28	4	2	34	0	0
9	43150817	.	C	T	0	24	24	0	9	33	0	0
9	43153287	.	C	T	13	13	26	1	2	29	0	0
9	43154841	.	C	T	11	16	27	0	1	28	0	0
9	43175527	.	C	T	0	11	11	0	15	26	0	0
9	43202097	.	T	C	16	0	16	0	12	28	0	0
9	43207727	.	G	A	16	8	24	0	0	24	0	0
9	43261951	.	T	A	7	9	16	0	2	18	0	0
9	43287748	.	G	A	13	4	17	0	2	19	0	0
9	43375122	.	G	A	3	9	12	0	1	13	0	0
9	43552604	.	C	A	1	5	6	0	0	6	0	0
9	43553036	.	G	T	11	8	19	0	0	19	0	0
9	43612482	.	T	G	6	3	9	0	0	9	0	0
9	43617899	.	A	G	5	9	14	0	1	15	0	0
9	43617962	.	A	G	7	5	12	0	1	13	0	0
9	44097854	.	C	T	1	4	5	0	4	9	0	0
9	44109260	.	A	G	3	2	5	0	0	5	0	0
9	44109589	.	T	C	5	0	5	0	3	8	0	0
9	44109595	.	T	C	4	0	4	0	5	9	0	0
9	44192300	.	G	A	3	3	6	0	0	6	0	0
9	44249852	.	T	C	2	2	4	0	0	4	0	0
9	44292285	.	A	C	31	0	31	0	26	57	0	0
9	44292737	.	T	C	29	23	52	0	0	52	0	0
9	44292909	.	C	T	3	29	32	0	30	62	0	0
9	44293488	.	C	T	38	23	61	0	2	63	0	0
9	44294792	.	A	G	22	9	31	0	1	32	0	0
9	44391277	.	T	C	2	2	4	0	1	5	0	0
9	44391309	.	T	C	2	3	5	0	0	5	0	0
9	44391339	.	T	G	1	3	4	0	0	4	0	0
9	44391395	.	G	A	1	5	6	0	0	6	0	0
9	44391507	.	G	C	2	3	5	0	0	5	0	0
9	44391664	.	T	C	3	1	4	0	1	5	0	0
9	44391666	.	G	A	2	2	4	0	0	4	0	0
9	44391780	.	G	A	0	5	5	0	7	12	0	0
9	44391831	.	A	G	7	4	11	0	1	12	0	0
9	44399446	.	C	A	3	5	8	0	0	8	0	0
9	44399472	.	A	G	3	0	3	0	3	6	0	0
9	44399521	.	C	T	5	2	7	0	0	7	0	0
9	44400091	.	T	G	5	4	9	0	1	10	0	0
9	44400119	.	G	A	4	8	12	0	1	13	0	0
9	44400580	.	G	A	16	16	32	0	1	33	0	0
9	44400706	.	C	A	8	11	19	0	0	19	0	0
9	44411647	.	A	G	9	16	25	0	1	26	0	0
9	44411652	.	C	A	11	16	27	0	2	29	0	0
9	44411828	.	A	C	15	11	26	0	0	26	0	0
9	44419652	.	T	A	14	5	19	0	2	21	0	0
9	44419793	.	C	A	13	9	22	0	2	24	0	0
9	44431117	.	G	A	11	5	16	0	1	17	0	0
9	44443998	.	T	C	23	14	37	0	0	37	0	0
9	44469318	.	A	G	23	0	23	0	15	38	0	0
9	44488578	.	T	A	8	9	17	0	0	17	0	0
9	44488620	.	G	A	4	12	16	0	1	17	0	0
9	44489843	.	G	A	1	7	8	0	6	14	0	0
9	44489844	.	T	A	7	7	14	0	0	14	0	0
9	44498332	.	T	C	6	16	22	0	0	22	0	0
9	44509181	.	G	A	4	11	15	0	0	15	0	0
9	44511218	.	C	T	7	9	16	0	1	17	0	0
9	44515937	.	G	A	5	13	18	1	0	19	0	0
9	44526546	.	G	A	3	10	13	0	1	14	0	0
9	44641974	.	A	T	5	7	12	0	2	14	0	0
9	44642017	.	G	A	6	11	17	0	0	17	0	0
9	44642057	.	T	C	7	0	7	0	18	25	0	0
9	44961166	.	A	G	8	4	12	0	0	12	0	0
9	44961473	.	A	G	5	3	8	1	0	9	0	0
9	44962552	.	C	G	1	3	4	0	1	5	0	0
9	44964501	.	T	G	2	2	4	0	0	4	0	0
9	44967138	.	A	G	2	2	4	0	0	4	0	0
9	45428086	.	C	T	1	2	3	0	0	3	0	0
9	45504199	.	C	T	5	3	8	0	0	8	0	0
9	45504357	.	A	C	4	4	8	0	0	8	0	0
9	45504485	.	A	G	8	3	11	0	3	14	0	0
9	45504819	.	A	G	8	0	8	0	8	16	0	0
9	45504888	.	G	A	0	3	3	0	10	13	0	0
9	45523190	.	G	A	5	9	14	0	0	14	0	0
9	45536096	.	A	G	6	4	10	0	1	11	0	0
9	45541036	.	C	A	4	4	8	0	1	9	0	0
9	45541069	.	T	C	3	7	10	0	0	10	0	0
9	45541239	.	G	A	2	4	6	0	0	6	0	0
9	45551273	.	T	C	15	13	28	1	3	32	0	0
9	45552338	.	T	G	9	9	18	0	0	18	0	0
9	45552364	.	G	A	1	8	9	0	13	22	0	0
9	45552386	.	C	G	16	10	26	0	0	26	0	0
9	45552567	.	G	A	1	10	11	0	18	29	0	0
9	45552715	.	C	T	14	19	33	0	4	37	0	0
9	45552806	.	G	A	2	16	18	0	15	33	0	0
9	45552881	.	T	C	17	13	30	0	1	31	0	0
9	45552924	.	C	A	13	10	23	0	2	26	1	0
9	45552957	.	C	T	12	12	24	0	1	25	0	0
9	45605525	.	T	C	1	5	6	0	0	6	0	0
9	45617551	.	T	C	2	2	4	0	1	5	0	0
9	45623346	.	C	T	2	7	9	0	1	10	0	0
9	45623446	.	A	G	4	3	7	0	0	7	0	0
9	45637090	.	G	A	5	1	6	1	1	8	0	0
9	45666600	.	G	A	6	6	12	0	0	12	0	0
9	45667103	.	C	T	2	3	5	0	0	5	0	0
9	45884409	.	C	T	5	3	8	0	0	8	0	0
9	45884711	.	G	A	5	5	10	0	0	10	0	0
9	45884768	.	T	G	5	9	14	0	0	14	0	0
9	45934065	.	A	G	3	3	6	0	1	7	0	0
9	45945935	.	A	C	7	6	13	0	1	14	0	0
9	45968318	.	A	G	2	8	10	0	0	10	0	0
9	45969254	.	C	T	1	5	6	0	6	12	0	0
9	45975846	.	C	T	2	8	10	0	8	18	0	0
9	45997103	.	G	A	10	5	15	0	1	16	0	0
9	46029269	.	G	T	6	4	10	0	1	11	0	0
9	46029344	.	G	A	3	5	8	0	0	8	0	0
9	46409427	.	C	T	0	4	4	0	3	7	0	0
9	46409442	.	A	G	1	3	4	0	2	6	0	0
9	46409589	.	T	A	1	3	4	0	0	4	0	0
9	46525673	.	A	G	9	7	16	1	0	17	0	0
9	46598134	.	T	C	5	4	9	0	0	9	0	0
9	46603999	.	A	G	2	1	3	0	5	8	0	0
9	46604056	.	T	C	3	3	6	0	1	7	0	0
9	46604068	.	A	G	4	0	4	0	5	9	0	0
9	46650764	.	T	C	4	4	8	0	0	8	0	0
9	46656990	.	G	C	0	4	4	0	2	6	0	0
9	46657120	.	T	C	8	2	10	0	0	10	0	0
9	46657128	.	T	C	4	5	9	0	1	10	0	0
9	46667831	.	A	T	2	7	9	0	0	9	0	0
9	46671108	.	G	A	2	3	5	0	4	9	0	0
9	46671174	.	C	T	7	3	10	0	1	11	0	0
9	46676385	.	C	T	2	2	4	0	0	4	0	0
9	46676393	.	C	G	2	2	4	0	0	4	0	0
9	46678159	.	A	C	6	6	12	0	0	12	0	0
9	46678196	.	C	T	4	7	11	0	0	11	0	0
9	46678255	.	T	C	3	7	10	0	0	10	0	0
9	46678279	.	A	T	6	6	12	0	0	12	0	0
9	46683861	.	A	C	6	11	17	0	0	17	0	0
9	46684000	.	A	C	2	6	8	0	0	8	0	0
9	46684356	.	A	C	3	5	8	0	0	8	0	0
9	46692261	.	T	G	21	21	42	0	0	42	0	0
9	46799102	.	T	C	3	8	11	0	0	11	0	0
9	46821464	.	C	T	12	14	26	0	2	28	0	0
9	46821685	.	A	G	8	6	14	0	1	15	0	0
9	46821853	.	G	A	3	5	8	0	0	8	0	0
9	46821855	.	G	T	4	5	9	0	0	9	0	0
9	46821905	.	A	G	8	5	13	0	0	13	0	0
9	46821916	.	A	T	8	5	13	0	1	14	0	0
9	46822002	.	T	C	5	5	10	8	1	19	0	0
9	46822079	.	C	T	16	6	22	0	1	23	0	0
9	46822120	.	C	T	0	8	8	0	10	18	0	0
9	46822144	.	T	C	8	8	16	0	0	16	0	0
9	46822417	.	C	T	0	9	9	0	9	18	0	0
9	46823198	.	C	T	18	11	29	0	0	29	0	0
9	46823325	.	G	A	14	8	22	0	0	22	0	0
9	46823366	.	T	C	9	13	22	0	3	25	0	0
9	46823524	.	A	G	13	13	26	0	2	28	0	0
9	46824110	.	A	G	9	13	22	0	0	22	0	0
9	46824160	.	T	A	11	8	19	0	0	19	0	0
9	46825039	.	C	T	7	3	10	0	0	10	0	0
9	46825094	.	A	T	8	7	15	0	1	16	0	0
9	46841787	.	C	G	4	4	8	0	0	8	0	0
9	47463251	.	A	T	6	5	11	0	1	12	0	0
9	47464728	.	A	G	3	4	7	0	0	7	0	0
9	47464731	.	C	T	1	3	4	0	3	7	0	0
9	47465478	.	G	A	5	4	9	0	0	9	0	0
9	47485067	.	C	T	3	2	5	0	1	6	0	0
9	47485109	.	G	A	4	3	7	0	0	7	0	0
9	47502293	.	A	T	3	3	6	0	0	6	0	0
9	47502415	.	G	A	4	2	6	0	1	7	0	0
9	47502512	.	C	A	1	3	4	0	0	4	0	0
9	47502964	.	A	G	1	3	4	0	0	4	0	0
9	48054753	.	G	A	25	24	49	0	3	52	0	0
9	48060592	.	G	C	26	18	44	0	5	49	0	0
9	48076973	.	C	T	16	24	40	0	3	43	0	0
9	48123109	.	C	G	1	3	4	0	0	4	0	0
9	48123142	.	G	A	5	6	11	0	0	11	0	0
9	48123222	.	G	C	8	4	12	0	0	12	0	0
9	48127200	.	G	A	3	6	9	0	1	10	0	0
9	48128027	.	G	T	1	6	7	0	4	11	0	0
9	48131637	.	T	A	2	3	5	0	0	5	0	0
9	48131814	.	A	T	1	5	6	0	2	8	0	0
9	48131920	.	A	C	1	3	4	1	0	5	0	0
9	48131956	.	G	A	2	6	8	1	1	10	0	0
9	48131997	.	C	T	0	7	7	0	4	11	0	0
9	48132029	.	T	C	7	1	8	0	6	14	0	0
9	48132037	.	T	A	7	8	15	0	0	15	0	0
9	48132095	.	A	C	5	10	15	0	0	15	0	0
9	48132156	.	A	C	6	7	13	0	0	13	0	0
9	48132176	.	C	T	3	6	9	0	1	10	0	0
9	48132194	.	G	T	2	5	7	0	1	8	0	0
9	48132309	.	G	T	8	3	11	0	1	12	0	0
9	48132336	.	C	T	3	4	7	0	6	13	0	0
9	48132439	.	G	A	4	4	8	0	0	8	0	0
9	48132441	.	A	G	4	4	8	0	0	8	0	0
9	48132531	.	G	A	5	2	7	0	0	7	0	0
9	48132592	.	G	T	7	3	10	0	0	10	0	0
9	48133013	.	T	C	2	0	2	0	3	5	0	0
9	48133105	.	G	T	4	3	7	0	0	7	0	0
9	48133541	.	T	C	6	9	15	0	1	16	0	0
9	48133687	.	A	G	1	5	6	0	0	6	0	0
9	48133900	.	G	T	7	5	12	0	0	12	0	0
9	48134201	.	A	T	4	2	6	0	0	6	0	0
9	48134351	.	G	A	6	2	8	0	1	9	0	0
9	48134568	.	G	A	6	6	12	0	6	18	0	0
9	48134678	.	A	T	5	7	12	0	0	12	0	0
9	48179081	.	T	C	4	3	7	0	0	7	0	0
9	48186325	.	G	T	2	2	4	0	0	4	0	0
9	48189403	.	C	G	0	3	3	0	6	9	0	0
9	48189411	.	T	C	4	3	7	0	0	7	0	0
9	48195432	.	C	T	4	3	7	0	0	7	0	0
9	48203875	.	G	A	1	4	5	0	0	5	0	0
9	48203896	.	A	G	3	3	6	0	0	6	0	0
9	48203947	.	C	G	0	3	3	0	3	6	0	0
9	48214157	.	T	A	3	3	6	0	0	6	0	0
9	48219255	.	G	A	3	2	5	0	0	5	0	0
9	48219274	.	C	T	2	2	4	0	0	4	0	0
9	48219649	.	T	G	3	0	3	0	5	8	0	0
9	48219700	.	A	G	1	5	6	0	0	6	0	0
9	48227847	.	T	A	2	5	7	0	0	7	0	0
9	48227885	.	T	G	3	6	9	0	0	9	0	0
9	48228950	.	T	C	3	2	5	0	0	5	0	0
9	48229039	.	C	G	2	6	8	0	0	8	0	0
9	48229074	.	T	C	3	8	11	0	0	11	0	0
9	48230669	.	C	T	4	3	7	0	0	7	0	0
9	48239744	.	G	A	0	2	2	0	2	4	0	0
9	48239757	.	C	A	2	2	4	0	0	4	0	0
9	48243390	.	C	T	4	3	7	0	0	7	0	0
9	48252167	.	C	T	3	2	5	0	0	5	0	0
9	48252171	.	G	C	0	2	2	0	4	6	0	0
9	48252433	.	C	T	1	2	3	0	0	3	0	0
9	48255357	.	G	A	0	3	3	0	1	4	0	0
9	48264034	.	C	T	2	3	5	0	0	5	0	0
9	48266553	.	C	A	3	2	5	0	0	5	0	0
9	48266676	.	G	C	1	2	3	0	0	3	0	0
9	48284901	.	T	C	10	4	14	0	0	14	0	0
9	48284917	.	C	A	2	6	8	0	9	17	0	0
9	48284972	.	T	C	9	8	17	0	0	17	0	0
9	48285019	.	G	A	8	8	16	0	0	16	0	0
9	48286702	.	G	A	3	7	10	0	0	10	0	0
9	48287441	.	G	A	6	6	12	0	1	13	0	0
9	48289758	.	G	A	6	7	13	0	0	13	0	0
9	48289797	.	A	T	6	9	15	0	0	15	0	0
9	48289961	.	A	G	5	7	12	0	0	12	0	0
9	48289991	.	T	C	2	6	8	0	0	8	0	0
9	48295210	.	G	A	8	3	11	0	0	11	0	0
9	48295211	.	T	G	6	3	9	0	1	10	0	0
9	48296346	.	C	T	0	7	7	0	8	15	0	0
9	48386932	.	A	G	1	3	4	0	0	4	0	0
9	48390858	.	G	T	2	4	6	0	0	6	0	0
9	48397350	.	T	C	2	0	2	0	4	6	0	0
9	48407342	.	C	T	3	4	7	0	1	8	0	0
9	48603509	.	G	A	1	2	3	0	0	3	0	0
9	48609109	.	G	T	3	2	5	0	0	5	0	0
9	48609172	.	A	G	1	1	2	0	2	4	0	0
9	48613366	.	C	T	1	2	3	0	0	3	0	0
9	48653759	.	T	C	3	3	6	0	0	6	0	0
9	48665419	.	A	T	2	4	6	0	1	7	0	0
9	48665654	.	G	A	9	4	13	0	1	14	0	0
9	48666890	.	A	G	4	2	6	0	0	6	0	0
9	48670113	.	G	A	0	2	2	0	2	4	0	0
9	48670316	.	C	T	2	3	5	0	2	7	0	0
9	48670395	.	A	C	3	5	8	0	0	8	0	0
9	48670454	.	T	G	3	6	9	0	0	9	0	0
9	48670525	.	T	C	4	2	6	0	0	6	0	0
9	48670660	.	G	A	0	5	5	0	3	8	0	0
9	48670747	.	T	G	3	0	3	0	8	11	0	0
9	48670748	.	T	C	4	5	9	0	2	11	0	0
9	48671167	.	A	C	1	6	7	0	0	7	0	0
9	48671520	.	G	A	0	2	2	0	1	3	0	0
9	48718225	.	C	A	0	5	5	0	2	7	0	0
9	48718229	.	C	G	2	4	6	0	0	6	0	0
9	48721088	.	C	T	3	4	7	0	0	7	0	0
9	48721107	.	C	T	5	4	9	0	0	9	0	0
9	48870578	.	T	C	11	1	12	0	9	21	0	0
9	48870593	.	A	T	12	10	22	0	0	22	0	0
9	48870627	.	T	A	12	9	21	0	0	21	0	0
9	48870680	.	A	G	10	4	14	0	1	15	0	0
9	48870886	.	C	T	7	7	14	0	0	14	0	0
9	48871080	.	G	C	7	4	11	0	1	12	0	0
9	48871966	.	T	G	9	7	16	3	0	19	0	0
9	48871973	.	A	C	11	3	14	8	0	22	0	0
9	48872615	.	A	G	8	3	11	0	0	11	0	0
9	48872620	.	C	T	8	1	9	0	0	9	0	0
9	48872890	.	C	A	4	10	14	0	0	14	0	0
9	48872924	.	A	G	6	10	16	0	0	16	0	0
9	48872926	.	C	T	0	8	8	0	6	14	0	0
9	48873144	.	A	G	1	7	8	0	0	8	0	0
9	48873371	.	A	G	7	5	12	0	0	12	0	0
9	48873522	.	C	G	5	5	10	0	1	11	0	0
9	48873853	.	G	A	1	2	3	0	1	4	0	0
9	48874562	.	G	A	6	6	12	0	0	12	0	0
9	48874577	.	G	A	7	7	14	0	1	15	0	0
9	48874728	.	T	C	7	3	10	1	0	11	0	0
9	48875094	.	C	A	8	4	12	0	0	12	0	0
9	48875171	.	C	T	1	2	3	0	0	3	0	0
9	48875208	.	C	G	2	2	4	0	0	4	0	0
9	48875218	.	G	T	3	2	5	0	0	5	0	0
9	48875510	.	T	C	2	4	6	0	0	6	0	0
9	48875516	.	G	A	3	2	5	0	1	6	0	0
9	48875595	.	A	C	4	6	10	0	0	10	0	0
9	48875598	.	T	A	5	4	9	0	1	10	0	0
9	48875674	.	A	G	5	2	7	0	1	8	0	0
9	48876199	.	T	C	3	4	7	0	0	7	0	0
9	48876587	.	A	G	7	7	14	0	0	14	0	0
9	48876798	.	C	T	0	5	5	0	3	8	0	0
9	48877129	.	T	C	1	0	1	0	4	5	0	0
9	48877348	.	A	G	3	5	8	0	0	8	0	0
9	49713606	.	G	T	3	3	6	0	2	9	1	0
9	50189241	.	A	G	1	0	1	0	1	2	0	0
9	50189250	.	C	T	0	2	2	0	0	2	0	0
9	50195588	.	A	G	2	2	4	0	0	4	0	0
9	50196064	.	C	T	1	3	4	0	1	5	0	0
9	50755016	.	A	T	4	2	6	0	0	6	0	0
9	51302422	.	A	G	26	15	41	0	0	41	0	0
9	51307387	.	G	T	12	15	27	0	0	27	0	0
9	51345386	.	C	A	6	5	11	0	0	11	0	0
9	51430737	.	C	T	1	3	4	0	1	5	0	0
9	51430767	.	T	A	2	3	5	0	0	5	0	0
9	51430826	.	A	T	3	3	6	0	0	6	0	0
9	51430847	.	T	G	3	0	3	0	1	4	0	0
9	51431179	.	C	G	12	10	22	0	0	22	0	0
9	51431642	.	A	C	6	1	7	0	5	12	0	0
9	51431791	.	G	A	1	5	6	0	0	6	0	0
9	51431831	.	G	A	2	4	6	0	1	7	0	0
9	51431843	.	C	G	2	7	9	0	1	10	0	0
9	51432279	.	T	G	4	4	8	0	1	9	0	0
9	51432381	.	C	T	0	3	3	0	6	9	0	0
9	51433816	.	C	T	0	8	8	0	6	14	0	0
9	51433944	.	G	A	7	5	12	0	0	12	0	0
9	51521620	.	G	A	2	2	4	0	0	4	0	0
9	51791393	.	G	A	0	3	3	0	2	5	0	0
9	51804777	.	C	T	7	2	9	0	0	9	0	0
9	51996246	.	C	T	0	4	4	0	4	8	0	0
9	51996280	.	T	A	7	4	11	0	0	11	0	0
9	51996281	.	G	A	7	4	11	0	0	11	0	0
9	51996444	.	T	G	2	16	18	0	2	20	0	0
9	51996469	.	C	T	1	6	7	0	14	21	0	0
9	51997231	.	T	A	4	3	7	0	0	7	0	0
9	51997232	.	C	A	0	3	3	0	4	7	0	0
9	51998330	.	T	C	2	3	5	0	0	5	0	0
9	51998379	.	C	A	2	2	4	0	0	4	0	0
9	51998648	.	C	T	5	3	8	0	0	8	0	0
9	51998761	.	C	G	7	5	12	0	1	13	0	0
9	51998784	.	T	G	3	7	10	0	3	13	0	0
9	51998841	.	G	T	2	3	5	0	1	6	0	0
9	51998887	.	T	G	3	7	10	0	0	10	0	0
9	51999842	.	C	G	8	4	12	1	0	13	0	0
9	51999855	.	T	G	10	3	13	1	0	14	0	0
9	51999991	.	A	G	3	3	6	0	0	6	0	0
9	52000032	.	C	T	0	3	3	0	4	7	0	0
9	52000088	.	G	A	5	5	10	0	0	10	0	0
9	52000127	.	C	G	5	3	8	0	0	8	0	0
9	52000248	.	T	A	3	3	6	0	0	6	0	0
9	52000335	.	A	T	10	6	16	0	0	16	0	0
9	52000665	.	A	G	3	4	7	0	0	7	0	0
9	52000773	.	C	T	2	3	5	0	3	8	0	0
9	52000869	.	G	C	2	0	2	0	2	4	0	0
9	52001016	.	C	T	1	7	8	0	5	13	0	0
9	52001241	.	C	T	0	6	6	0	1	7	0	0
9	52003427	.	T	C	2	0	2	0	4	6	0	0
9	52057356	.	T	C	3	0	3	0	4	7	0	0
9	52057378	.	C	A	1	3	4	0	4	8	0	0
9	52057708	.	C	T	4	4	8	0	1	9	0	0
9	52100697	.	A	G	1	3	4	0	0	4	0	0
9	52378682	.	C	T	19	7	26	0	3	29	0	0
9	52378697	.	A	G	15	17	32	0	1	33	0	0
9	52378832	.	T	A	29	18	47	1	3	51	0	0
9	52431349	.	G	A	0	3	3	0	5	8	0	0
9	52433132	.	T	C	2	3	5	0	0	5	0	0
9	52435058	.	G	C	5	3	8	0	0	8	0	0
9	52435100	.	G	A	5	3	8	0	1	9	0	0
9	52435112	.	C	T	4	5	9	0	0	9	0	0
9	52439166	.	G	A	2	2	4	0	0	4	0	0
9	52439171	.	C	A	1	5	6	0	0	6	0	0
9	52479199	.	T	C	1	3	4	0	1	5	0	0
9	52479815	.	C	T	0	5	5	0	2	7	0	0
9	52479822	.	C	G	0	6	6	0	2	8	0	0
9	52479901	.	C	T	3	3	6	0	0	6	0	0
9	52487535	.	T	C	2	0	2	0	6	8	0	0
9	52489838	.	C	A	2	4	6	0	0	6	0	0
9	52489899	.	T	C	2	0	2	0	3	5	0	0
9	52490015	.	A	G	2	2	4	0	0	4	0	0
9	52490121	.	A	T	1	2	3	0	0	3	0	0
9	52490127	.	A	G	1	2	3	0	0	3	0	0
9	52492641	.	A	C	8	6	14	0	0	14	0	0
9	52492688	.	C	G	20	0	20	0	11	31	0	0
9	52492705	.	A	G	9	23	32	0	1	33	0	0
9	52493059	.	A	T	16	6	22	0	3	25	0	0
9	52493231	.	A	T	5	20	25	0	2	27	0	0
9	52493406	.	C	T	20	6	26	0	0	26	0	0
9	52539290	.	G	A	3	10	13	0	18	31	0	0
9	52539453	.	C	T	12	21	33	0	1	34	0	0
9	52539629	.	C	T	22	13	35	0	1	36	0	0
9	52558268	.	C	T	1	2	3	0	0	3	0	0
9	52564578	.	T	C	6	0	6	0	4	10	0	0
9	52564622	.	T	C	4	3	7	0	0	7	0	0
9	52572555	.	C	T	7	2	9	0	0	9	0	0
9	52572573	.	G	A	6	3	9	0	0	9	0	0
9	52574737	.	C	G	6	8	14	0	0	14	0	0
9	52577701	.	A	G	4	2	6	0	0	6	0	0
9	52580080	.	G	A	4	4	8	0	0	8	0	0
9	52581925	.	C	T	3	3	6	0	0	6	0	0
9	52583872	.	G	A	4	2	6	0	0	6	0	0
9	52594558	.	G	C	4	3	7	0	0	7	0	0
9	52594594	.	C	T	3	1	4	0	1	5	0	0
9	52594600	.	G	A	4	2	6	0	0	6	0	0
9	52609094	.	G	A	1	2	3	0	0	3	0	0
9	52629113	.	C	T	7	16	23	0	1	24	0	0
9	52629119	.	C	T	17	6	23	0	0	23	0	0
9	52629155	.	T	C	8	13	21	0	1	22	0	0
9	52631620	.	G	A	13	6	19	0	0	19	0	0
9	52633151	.	C	T	8	3	11	0	0	11	0	0
9	52633184	.	C	G	9	5	14	0	1	15	0	0
9	52635271	.	C	A	14	5	19	0	1	20	0	0
9	52635520	.	G	A	7	3	10	0	0	10	0	0
9	52645687	.	C	T	0	6	6	0	6	12	0	0
9	52649740	.	C	A	0	5	5	0	5	10	0	0
9	52649758	.	T	A	5	4	9	0	0	9	0	0
9	52649794	.	A	G	5	3	8	0	0	9	1	0
9	52649941	.	G	A	4	3	7	0	0	7	0	0
9	52651985	.	T	C	5	5	10	0	2	12	0	0
9	52652015	.	A	G	7	3	10	0	0	10	0	0
9	53276550	.	A	C	7	6	13	0	0	13	0	0
9	53276681	.	G	A	0	8	8	0	9	17	0	0
9	53276976	.	C	T	5	10	15	0	1	16	0	0
9	53276978	.	A	G	11	4	15	0	0	15	0	0
9	53277068	.	C	G	9	0	9	1	6	16	0	0
9	53277131	.	A	T	12	8	20	0	0	20	0	0
9	53277453	.	G	A	2	8	10	0	13	23	0	0
9	53277493	.	A	T	10	6	16	0	0	16	0	0
9	54230898	.	G	A	2	3	5	0	0	5	0	0
9	54239528	.	T	C	3	4	7	0	0	7	0	0
9	54245010	.	T	A	5	4	9	0	0	9	0	0
9	54247334	.	A	G	3	8	11	0	2	13	0	0
9	54247336	.	T	C	6	7	13	0	0	13	0	0
9	54255362	.	C	G	5	9	14	0	1	15	0	0
9	54256221	.	C	G	7	3	10	0	0	10	0	0
9	54256286	.	C	A	3	7	10	0	0	10	0	0
9	54260901	.	C	T	3	6	9	0	0	9	0	0
9	54263996	.	C	T	5	5	10	0	2	12	0	0
9	54264236	.	T	C	3	8	11	0	3	14	0	0
9	54264245	.	T	C	3	10	13	0	1	14	0	0
9	54264272	.	C	T	3	5	8	0	0	8	0	0
9	54264299	.	C	A	3	5	8	0	1	9	0	0
9	54267524	.	A	T	2	6	8	0	1	9	0	0
9	54270324	.	C	T	3	5	8	0	3	11	0	0
9	54270348	.	T	A	2	9	11	0	0	11	0	0
9	54273514	.	G	T	2	5	7	0	1	8	0	0
9	54273797	.	C	T	10	5	15	0	0	15	0	0
9	54329537	.	T	C	3	3	6	0	0	6	0	0
9	54329593	.	C	A	0	3	3	0	2	5	0	0
9	54329644	.	T	C	1	2	3	0	0	3	0	0
9	54331768	.	G	A	1	5	6	0	0	6	0	0
9	54335139	.	A	G	2	3	5	0	0	5	0	0
9	54351499	.	T	C	1	2	3	0	1	4	0	0
9	54417949	.	A	T	5	2	7	0	0	7	0	0
9	54418577	.	G	T	0	4	4	0	4	8	0	0
9	54418687	.	T	C	2	5	7	0	0	7	0	0
9	54419201	.	A	G	2	2	4	0	0	4	0	0
9	54711496	.	C	A	4	8	12	2	1	15	0	0
9	54711802	.	A	G	5	2	7	6	0	13	0	0
9	54712645	.	T	C	16	7	23	0	0	23	0	0
9	54712650	.	T	C	4	15	19	0	0	19	0	0
9	55749767	.	T	C	1	3	4	0	0	4	0	0
9	56225580	.	A	G	11	1	12	0	3	15	0	0
9	56225617	.	A	G	8	5	13	0	1	14	0	0
