contig	position	variantID	refAllele	altAllele	refCount	altCount	totalCount	lowMAPQDepth	lowBaseQDepth	rawDepth	otherBases	improperPairs
1	6698	.	G	A	12	25	37	0	5	42	0	0
1	6746	.	T	C	28	6	34	0	32	66	0	0
1	10093	.	C	T	46	25	71	0	2	73	0	0
1	14083	.	G	A	0	8	8	0	8	16	0	0
1	15050	.	G	A	1	7	8	0	13	21	0	0
1	15772	.	G	A	0	9	9	0	15	24	0	0
1	15828	.	G	A	3	8	11	0	10	21	0	0
1	16072	.	C	T	7	4	11	0	2	13	0	0
1	32450	.	T	C	12	14	26	0	1	27	0	0
1	33036	.	C	T	16	6	22	0	2	24	0	0
1	38106	.	C	T	18	12	30	0	0	30	0	0
1	38814	.	G	A	5	21	26	0	15	41	0	0
1	39620	.	C	A	1	7	8	0	10	18	0	0
1	39621	.	G	C	9	7	16	0	2	18	0	0
1	39717	.	T	G	8	11	19	0	1	20	0	0
1	40409	.	T	C	4	6	10	0	0	10	0	0
1	41287	.	C	T	1	5	6	0	7	13	0	0
1	41560	.	G	A	5	4	9	0	0	9	0	0
1	46097	.	G	A	1	2	3	0	0	3	0	0
1	62838	.	C	T	5	2	7	0	0	7	0	0
1	118680	.	C	T	1	2	3	0	0	3	0	0
1	118773	.	G	A	1	3	4	0	0	4	0	0
1	141333	.	C	T	6	3	9	0	0	9	0	0
1	157915	.	T	A	2	3	5	0	0	5	0	0
1	176642	.	C	T	7	7	14	0	0	14	0	0
1	176774	.	C	T	10	3	13	0	2	15	0	0
1	181717	.	T	C	13	17	30	0	0	30	0	0
1	181754	.	C	T	12	14	26	0	1	27	0	0
1	181763	.	A	G	11	13	24	0	6	30	0	0
1	185010	.	A	G	3	2	5	0	1	6	0	0
1	185057	.	G	A	5	3	8	0	0	8	0	0
1	185126	.	G	A	3	4	7	0	0	7	0	0
1	185191	.	C	T	2	3	5	0	1	6	0	0
1	186389	.	C	T	2	4	6	0	1	7	0	0
1	186392	.	A	G	0	4	4	0	1	5	0	0
1	208408	.	T	A	15	23	38	0	0	38	0	0
1	208564	.	T	C	9	9	18	2	0	20	0	0
1	208570	.	T	C	8	8	16	2	2	20	0	0
1	212162	.	G	A	2	7	9	0	1	10	0	0
1	213203	.	G	C	14	0	14	0	14	28	0	0
1	218775	.	G	A	2	3	5	0	0	5	0	0
1	221004	.	A	G	2	3	5	0	0	5	0	0
1	223511	.	T	C	1	4	5	0	0	5	0	0
1	225044	.	G	A	0	11	11	0	8	19	0	0
1	225083	.	C	T	6	7	13	0	0	13	0	0
1	442456	.	T	C	6	5	11	1	1	13	0	0
1	442527	.	A	T	5	3	8	1	1	10	0	0
1	474195	.	A	G	2	2	4	0	0	4	0	0
1	474273	.	C	G	4	3	7	0	1	8	0	0
1	474286	.	T	A	7	2	9	0	1	10	0	0
1	474321	.	A	G	5	7	12	0	0	12	0	0
1	474465	.	C	T	11	4	15	0	4	19	0	0
1	474473	.	A	G	11	8	19	0	2	21	0	0
1	476034	.	G	A	7	6	13	0	3	16	0	0
1	477001	.	C	T	0	6	6	0	14	20	0	0
1	477013	.	G	T	11	5	16	0	1	17	0	0
1	477070	.	C	T	2	2	4	0	6	10	0	0
1	477817	.	C	T	8	2	10	0	0	10	0	0
1	477823	.	G	C	7	4	11	0	0	11	0	0
1	477951	.	C	T	8	5	13	0	0	13	0	0
1	479986	.	A	G	2	7	9	1	2	12	0	0
1	483820	.	T	A	2	5	7	0	0	7	0	0
1	483821	.	C	T	2	5	7	0	0	7	0	0
1	483862	.	A	T	5	8	13	0	0	13	0	0
1	483873	.	C	T	6	9	15	0	0	15	0	0
1	484094	.	G	A	4	6	10	0	1	11	0	0
1	484237	.	G	A	1	4	5	0	0	5	0	0
1	484434	.	C	T	3	9	12	0	1	13	0	0
1	484590	.	C	T	6	5	11	0	0	11	0	0
1	486475	.	G	C	2	5	7	0	0	7	0	0
1	486775	.	T	C	3	10	13	0	0	13	0	0
1	492141	.	T	C	1	3	4	0	0	4	0	0
1	492222	.	C	T	0	2	2	0	6	8	0	0
1	492231	.	C	A	3	6	9	0	0	9	0	0
1	496303	.	A	G	5	4	9	0	0	9	0	0
1	496305	.	A	C	4	4	8	0	1	9	0	0
1	496760	.	A	G	3	0	3	0	3	6	0	0
1	499220	.	A	G	1	3	4	0	0	4	0	0
1	501303	.	G	A	0	7	7	0	5	12	0	0
1	501381	.	T	A	7	7	14	0	1	15	0	0
1	502079	.	C	A	6	6	12	0	2	14	0	0
1	503900	.	C	T	9	13	22	0	0	22	0	0
1	504073	.	A	G	8	0	8	0	13	21	0	0
1	504457	.	G	A	3	2	5	0	0	5	0	0
1	504527	.	G	A	1	2	3	0	6	9	0	0
1	504535	.	A	G	7	2	9	0	1	10	0	0
1	504663	.	C	G	9	5	14	1	2	17	0	0
1	504912	.	C	A	4	2	6	0	0	6	0	0
1	505013	.	A	G	5	5	10	0	0	10	0	0
1	505178	.	G	A	6	8	14	0	1	15	0	0
1	505260	.	A	G	8	0	8	0	10	18	0	0
1	505298	.	C	T	12	8	20	0	1	21	0	0
1	505403	.	G	A	16	5	21	0	0	21	0	0
1	505499	.	C	G	1	6	7	0	0	7	0	0
1	509222	.	T	G	2	6	8	0	1	10	1	0
1	509718	.	T	A	3	4	7	0	0	7	0	0
1	509769	.	G	T	4	5	9	0	0	9	0	0
1	511525	.	G	A	8	6	14	0	0	14	0	0
1	511544	.	C	T	6	6	12	0	2	14	0	0
1	511968	.	A	T	2	2	4	0	0	4	0	0
1	512127	.	C	T	2	3	5	0	0	5	0	0
1	513613	.	A	G	2	4	6	0	1	7	0	0
1	513615	.	T	A	2	4	6	0	1	7	0	0
1	513655	.	C	T	1	3	4	0	1	5	0	0
1	514114	.	G	A	0	4	4	0	7	11	0	0
1	514202	.	C	T	4	2	6	0	1	7	0	0
1	515549	.	G	A	7	4	11	0	0	11	0	0
1	515575	.	G	C	4	7	11	0	0	11	0	0
1	517515	.	C	T	10	7	17	0	1	18	0	0
1	517697	.	T	C	1	5	6	0	1	7	0	0
1	517699	.	A	G	1	0	1	0	6	7	0	0
1	524806	.	G	A	12	6	18	0	3	21	0	0
1	524828	.	C	T	13	8	21	0	1	22	0	0
1	528522	.	G	A	2	15	17	0	19	36	0	0
1	528552	.	A	C	11	23	34	0	3	37	0	0
1	530497	.	T	A	8	8	16	0	1	17	0	0
1	586161	.	G	A	1	4	5	0	5	10	0	0
1	586165	.	C	T	4	6	10	0	0	10	0	0
1	586765	.	C	T	8	6	14	0	1	15	0	0
1	587200	.	G	T	9	8	17	0	1	18	0	0
1	589044	.	A	T	18	14	32	0	2	34	0	0
1	589056	.	C	T	21	14	35	0	1	36	0	0
1	589115	.	G	A	3	12	15	0	19	34	0	0
1	601882	.	G	A	4	2	6	0	0	6	0	0
1	601954	.	C	T	2	3	5	0	0	5	0	0
1	603292	.	A	G	3	3	6	0	0	6	0	0
1	610507	.	T	C	1	0	1	0	6	7	0	0
1	610606	.	C	T	2	12	14	0	0	14	0	0
1	610722	.	T	C	16	11	27	0	5	32	0	0
1	611267	.	T	C	39	21	60	0	2	62	0	0
1	614568	.	C	G	1	16	17	0	12	29	0	0
1	617950	.	C	T	6	29	35	0	26	61	0	0
1	618190	.	A	C	35	3	38	0	24	62	0	0
1	618210	.	G	A	29	28	57	0	5	62	0	0
1	618277	.	A	G	31	26	57	0	2	59	0	0
1	618434	.	C	T	29	33	62	0	8	70	0	0
1	618760	.	C	T	0	9	9	0	13	22	0	0
1	618776	.	C	A	15	13	28	0	0	28	0	0
1	618826	.	C	T	21	13	34	0	1	35	0	0
1	618918	.	A	T	17	34	51	4	5	60	0	0
1	618932	.	A	G	20	37	57	4	2	63	0	0
1	619679	.	T	A	9	15	24	0	2	26	0	0
1	619703	.	C	T	1	10	11	0	19	30	0	0
1	620244	.	A	T	35	20	55	0	5	60	0	0
1	620314	.	G	A	37	21	58	0	1	59	0	0
1	620516	.	A	T	22	36	58	0	0	58	0	0
1	620517	.	T	G	21	36	57	0	1	58	0	0
1	621027	.	C	T	4	17	21	0	18	39	0	0
1	621063	.	T	A	19	11	30	0	2	32	0	0
1	621069	.	G	A	17	11	28	0	2	30	0	0
1	621102	.	A	T	16	14	30	0	2	32	0	0
1	621141	.	T	A	12	18	30	0	0	30	0	0
1	621283	.	C	T	2	13	15	0	22	37	0	0
1	621336	.	G	A	23	13	36	0	7	43	0	0
1	621389	.	C	T	19	16	35	0	1	36	0	0
1	621440	.	C	T	19	23	42	0	4	46	0	0
1	626601	.	G	A	19	19	38	0	0	38	0	0
1	629610	.	G	A	11	15	26	0	0	26	0	0
1	629619	.	A	G	8	14	22	0	2	24	0	0
1	634933	.	T	C	12	4	16	0	1	18	1	0
1	638431	.	C	T	2	8	10	0	8	18	0	0
1	658722	.	C	A	0	2	2	0	4	6	0	0
1	658850	.	A	G	2	2	4	0	0	4	0	0
1	658877	.	A	G	1	2	3	0	0	3	0	0
1	659130	.	G	A	1	2	3	0	0	3	0	0
1	961662	.	G	A	1	2	3	0	0	3	0	0
1	970339	.	A	G	2	0	2	0	7	9	0	0
1	970637	.	C	T	3	10	13	0	0	13	0	0
1	970638	.	G	T	0	10	10	0	3	13	0	0
1	970803	.	C	A	7	4	11	0	0	11	0	0
1	973476	.	C	T	5	3	8	0	0	8	0	0
1	2299051	.	C	G	2	29	31	2	1	34	0	0
1	5357083	.	T	C	10	4	14	11	0	25	0	0
1	5357405	.	T	C	9	19	28	0	0	28	0	0
1	6210567	.	C	T	2	6	8	0	0	8	0	0
1	6234077	.	A	G	2	3	5	0	0	5	0	0
1	6234090	.	C	T	2	5	7	0	0	7	0	0
1	6238639	.	C	T	7	3	10	0	0	10	0	0
1	6241379	.	G	T	1	5	6	0	7	13	0	0
1	6241427	.	T	G	9	6	15	0	0	15	0	0
1	6243549	.	A	G	5	0	5	0	9	14	0	0
1	6243620	.	T	C	6	3	9	0	0	9	0	0
1	6243626	.	A	C	5	3	8	0	0	8	0	0
1	6243962	.	C	T	2	2	4	0	0	4	0	0
1	6243975	.	T	G	2	2	4	0	0	4	0	0
1	6247104	.	C	T	0	2	2	0	1	3	0	0
1	6247156	.	G	T	2	3	5	0	0	5	0	0
1	6247235	.	C	T	2	2	4	0	0	4	0	0
1	6262918	.	C	T	2	3	5	0	0	5	0	0
1	6264973	.	C	A	3	2	5	0	0	5	0	0
1	6266294	.	C	T	3	5	8	0	1	9	0	0
1	6359952	.	G	A	6	5	11	0	0	11	0	0
1	6365673	.	A	G	4	6	10	0	0	10	0	0
1	6365711	.	T	G	8	5	13	0	1	14	0	0
1	6365793	.	A	C	1	3	4	0	1	5	0	0
1	6366000	.	T	A	3	2	5	0	0	5	0	0
1	6366024	.	A	C	2	3	5	0	0	5	0	0
1	6404659	.	G	A	5	2	7	0	0	7	0	0
1	6924858	.	G	C	2	2	4	0	0	4	0	0
1	7518644	.	C	T	13	5	18	0	1	19	0	0
1	7523258	.	A	C	10	1	11	0	1	12	0	0
1	7523264	.	C	T	10	2	12	0	0	12	0	0
1	7526839	.	G	A	6	10	16	0	1	17	0	0
1	7528289	.	G	C	1	13	14	0	22	36	0	0
1	7530123	.	C	T	25	22	47	0	0	47	0	0
1	7538822	.	C	T	19	27	46	0	1	47	0	0
1	7538971	.	T	C	19	23	42	0	3	45	0	0
1	7539000	.	C	A	14	15	29	0	9	38	0	0
1	7539053	.	G	C	19	24	43	0	2	45	0	0
1	7539074	.	A	C	13	24	37	0	2	39	0	0
1	7554068	.	T	C	5	1	6	0	3	9	0	0
1	7557132	.	C	T	4	4	8	0	0	8	0	0
1	7560705	.	T	A	19	16	35	1	2	38	0	0
1	7561118	.	T	G	3	2	5	1	0	6	0	0
1	7632221	.	C	T	3	4	7	0	0	7	0	0
1	7634807	.	G	A	1	2	3	0	1	4	0	0
1	7662275	.	T	C	20	21	41	0	0	41	0	0
1	7662628	.	G	A	24	20	44	0	3	47	0	0
1	7662880	.	A	T	20	25	45	0	0	45	0	0
1	7662949	.	C	T	30	18	48	0	1	49	0	0
1	7668211	.	A	G	20	17	37	0	0	37	0	0
1	7668298	.	C	T	12	16	28	0	3	31	0	0
1	7673070	.	C	T	13	17	30	0	2	32	0	0
1	7673129	.	C	A	11	9	20	0	2	22	0	0
1	7682912	.	A	C	11	6	17	0	1	18	0	0
1	7682923	.	A	G	9	7	16	0	1	17	0	0
1	7682949	.	G	A	7	6	13	0	0	13	0	0
1	7853375	.	T	G	4	4	8	0	2	10	0	0
1	7853399	.	G	A	6	4	10	0	1	11	0	0
1	8022503	.	T	A	15	13	28	0	0	28	0	0
1	8022505	.	T	C	15	11	26	0	2	28	0	0
1	8022817	.	T	A	17	14	31	0	3	34	0	0
1	8023471	.	A	T	11	11	22	0	2	24	0	0
1	8023490	.	A	C	11	9	20	0	2	22	0	0
1	8023559	.	A	T	18	12	30	0	0	30	0	0
1	8023587	.	A	G	12	22	34	0	0	34	0	0
1	8023639	.	C	A	20	15	35	1	1	37	0	0
1	8023658	.	A	T	18	16	34	1	1	36	0	0
1	8023730	.	C	T	11	17	28	0	3	31	0	0
1	8026148	.	T	G	9	13	22	0	1	23	0	0
1	8026404	.	T	A	19	8	27	0	0	28	1	0
1	8026415	.	C	T	0	19	19	0	7	26	0	0
1	8026478	.	T	C	18	0	18	0	9	27	0	0
1	8026975	.	T	C	7	4	11	0	0	11	0	0
1	8028177	.	T	A	2	8	10	0	0	11	1	0
1	8028626	.	T	G	2	11	13	0	0	13	0	0
1	8028652	.	G	A	4	13	17	0	0	17	0	0
1	8028696	.	G	T	6	14	20	0	0	20	0	0
1	8028912	.	G	C	6	6	12	0	0	12	0	0
1	8028925	.	C	A	6	5	11	0	0	11	0	0
1	8029002	.	T	A	1	5	6	0	1	7	0	0
1	8032956	.	G	C	6	5	11	0	0	11	0	0
1	8032986	.	A	G	5	4	9	0	0	9	0	0
1	8051513	.	G	A	2	2	4	0	0	4	0	0
1	8055927	.	T	C	2	0	2	0	3	5	0	0
1	8130147	.	T	C	1	2	3	0	0	3	0	0
1	8165609	.	C	T	7	13	20	0	0	20	0	0
1	8165667	.	T	C	2	6	8	0	0	8	0	0
1	8165769	.	T	A	1	4	5	0	3	8	0	0
1	8165802	.	C	T	4	5	9	0	1	10	0	0
1	8165937	.	G	A	2	7	9	0	3	12	0	0
1	8165947	.	C	T	3	7	10	0	0	10	0	0
1	8166788	.	A	T	6	9	15	0	1	16	0	0
1	8166992	.	A	G	4	11	15	0	0	15	0	0
1	8167319	.	A	G	8	5	13	0	0	13	0	0
1	8167383	.	G	A	6	10	16	0	0	16	0	0
1	8167526	.	C	T	12	5	17	0	2	19	0	0
1	8167668	.	G	A	8	9	17	0	2	19	0	0
1	8169262	.	C	T	6	6	12	0	0	12	0	0
1	8169268	.	C	T	5	2	7	0	4	11	0	0
1	8403438	.	A	C	1	2	3	0	0	3	0	0
1	8417896	.	T	C	17	24	41	0	0	41	0	0
1	8418058	.	T	A	5	13	18	0	0	18	0	0
1	8422521	.	A	G	22	21	43	0	0	43	0	0
1	8424735	.	G	A	15	12	27	0	2	29	0	0
1	8530928	.	C	T	2	3	5	0	0	5	0	0
1	8530943	.	G	A	0	3	3	0	3	6	0	0
1	8531343	.	G	A	1	3	4	0	1	5	0	0
1	8531505	.	T	C	2	10	12	0	0	12	0	0
1	8531645	.	T	C	1	5	6	0	0	6	0	0
1	8531927	.	G	A	1	2	3	0	0	3	0	0
1	8531943	.	C	T	1	2	3	0	0	3	0	0
1	8544483	.	G	A	2	2	4	0	1	5	0	0
1	8544495	.	G	C	1	0	1	0	2	3	0	0
1	8555456	.	A	G	1	2	3	0	0	3	0	0
1	8557075	.	G	A	6	8	14	0	1	15	0	0
1	8557159	.	T	A	4	6	10	0	0	10	0	0
1	8560072	.	A	G	3	3	6	0	0	6	0	0
1	8560237	.	C	T	3	5	8	0	0	8	0	0
1	8560266	.	C	T	5	4	9	0	0	9	0	0
1	8560289	.	C	T	6	4	10	0	0	10	0	0
1	8563792	.	G	A	2	2	4	0	0	4	0	0
1	8566485	.	T	C	2	2	4	0	0	4	0	0
1	8601971	.	A	T	4	4	8	0	0	9	1	0
1	8601990	.	A	T	6	5	11	0	0	11	0	0
1	8606561	.	C	T	3	5	8	0	0	8	0	0
1	8606632	.	C	T	2	5	7	0	0	7	0	0
1	8608300	.	C	T	4	6	10	0	0	10	0	0
1	8610548	.	C	A	3	2	5	0	2	7	0	0
1	8639877	.	G	A	4	4	8	0	0	8	0	0
1	8639883	.	G	A	4	4	8	0	0	8	0	0
1	8642800	.	C	T	6	3	9	0	2	11	0	0
1	8642824	.	A	T	6	7	13	0	2	15	0	0
1	8642938	.	A	G	6	4	10	0	0	10	0	0
1	8642953	.	C	T	5	3	8	0	1	9	0	0
1	8643112	.	G	C	3	2	5	0	0	5	0	0
1	8649726	.	A	G	36	43	79	3	1	83	0	0
1	8649865	.	C	T	35	43	78	2	1	81	0	0
1	8649988	.	A	G	46	28	74	0	1	75	0	0
1	8649994	.	A	T	41	30	71	0	2	74	1	0
1	8650317	.	G	A	30	28	58	0	2	60	0	0
1	8650371	.	C	T	36	22	58	0	2	60	0	0
1	8651036	.	G	A	26	26	52	1	3	56	0	0
1	8651060	.	T	C	29	20	49	1	3	53	0	0
1	8651576	.	G	A	26	34	60	2	2	64	0	0
1	8662553	.	G	A	9	20	29	0	0	29	0	0
1	8663048	.	G	A	2	11	13	0	6	19	0	0
1	8663195	.	T	G	16	10	26	0	0	26	0	0
1	8663295	.	T	C	9	18	27	0	1	28	0	0
1	8667377	.	G	A	17	9	26	0	2	28	0	0
1	8667606	.	C	T	16	14	30	0	0	30	0	0
1	8668166	.	T	C	20	28	48	0	1	49	0	0
1	8668238	.	G	T	31	18	49	0	3	52	0	0
1	8668886	.	T	C	5	2	7	1	0	9	1	0
1	8668930	.	A	T	6	3	9	1	0	10	0	0
1	8669543	.	A	G	11	5	16	0	3	19	0	0
1	8669673	.	A	G	15	7	22	0	1	23	0	0
1	8669717	.	T	G	17	16	33	0	1	35	1	0
1	8669718	.	T	C	17	16	33	0	2	35	0	0
1	8669753	.	T	A	26	14	40	1	0	41	0	0
1	8669847	.	G	T	29	21	50	0	1	51	0	0
1	8670031	.	T	C	24	33	57	0	7	64	0	0
1	8670032	.	G	T	5	24	29	0	36	65	0	0
1	8670402	.	G	A	21	18	39	0	2	41	0	0
1	8694404	.	G	A	16	10	26	0	1	27	0	0
1	8698765	.	T	C	21	19	40	0	0	40	0	0
1	8698799	.	C	T	23	15	38	0	0	38	0	0
1	8698834	.	T	A	26	17	43	0	0	43	0	0
1	8701548	.	A	G	21	3	24	0	27	51	0	0
1	8701623	.	C	T	26	18	44	0	2	46	0	0
1	8701747	.	G	A	22	18	40	3	3	46	0	0
1	8702158	.	G	A	22	10	32	3	4	39	0	0
1	8702325	.	G	T	22	14	36	0	2	38	0	0
1	8763824	.	A	G	7	9	16	0	1	17	0	0
1	8763832	.	A	C	8	1	9	0	11	20	0	0
1	8764123	.	C	T	9	10	19	0	1	20	0	0
1	8764612	.	T	C	12	0	12	0	14	26	0	0
1	8764661	.	T	A	17	12	29	0	3	32	0	0
1	8764729	.	C	T	11	11	22	0	0	22	0	0
1	8764760	.	G	A	13	10	23	0	0	23	0	0
1	8764811	.	C	T	0	5	5	0	8	13	0	0
1	8764812	.	G	A	8	5	13	0	0	13	0	0
1	8765315	.	A	G	14	20	34	0	1	35	0	0
1	8765422	.	G	A	16	13	29	0	1	30	0	0
1	8765713	.	A	C	14	21	35	0	4	39	0	0
1	8765724	.	A	G	16	21	37	0	3	40	0	0
1	8766267	.	T	C	11	0	11	0	14	25	0	0
1	8766453	.	C	T	23	11	34	0	2	36	0	0
1	8766471	.	C	T	1	11	12	0	19	31	0	0
1	8766501	.	C	T	17	10	27	0	1	28	0	0
1	8766693	.	G	A	9	5	14	0	1	15	0	0
1	8767002	.	C	T	5	6	11	0	0	11	0	0
1	8767080	.	G	A	5	12	17	0	1	18	0	0
1	8767155	.	C	T	9	11	20	0	1	21	0	0
1	8767185	.	T	C	6	10	16	0	2	18	0	0
1	8767260	.	T	C	7	6	13	0	3	16	0	0
1	8767395	.	A	G	7	7	14	0	0	14	0	0
1	8767536	.	T	C	5	0	5	0	7	12	0	0
1	8767629	.	G	A	7	5	12	0	1	13	0	0
1	8767725	.	T	C	6	7	13	0	1	14	0	0
1	8768307	.	A	G	5	4	9	0	0	9	0	0
1	8770773	.	G	A	1	3	4	0	0	4	0	0
1	8771020	.	T	G	2	5	7	0	0	7	0	0
1	8773269	.	T	C	1	3	4	0	0	4	0	0
1	8773320	.	G	A	2	7	9	0	0	9	0	0
1	8773383	.	A	G	1	3	4	0	0	4	0	0
1	8776497	.	A	G	1	3	4	0	0	4	0	0
1	8917623	.	C	T	2	2	4	0	0	4	0	0
1	8974620	.	A	G	2	6	8	0	0	8	0	0
1	8974695	.	A	T	1	6	7	0	0	7	0	0
1	8975415	.	T	C	1	9	10	0	0	10	0	0
1	8977721	.	T	G	2	9	11	0	0	11	0	0
1	9044745	.	C	T	7	5	12	0	0	12	0	0
1	9051092	.	T	C	7	6	13	0	0	13	0	0
1	9056045	.	T	G	8	10	18	0	0	18	0	0
1	9056886	.	T	C	10	18	28	0	0	28	0	0
1	9064611	.	T	C	4	8	12	0	0	12	0	0
1	9064791	.	C	A	1	3	4	0	1	6	1	0
1	9064864	.	T	C	2	3	5	0	0	5	0	0
1	9064885	.	C	A	2	2	4	0	0	4	0	0
1	9074440	.	T	C	17	13	30	0	2	32	0	0
1	9118497	.	T	A	16	27	43	1	0	44	0	0
1	9123262	.	A	G	21	15	36	3	0	39	0	0
1	9145260	.	C	T	2	2	4	0	0	4	0	0
1	9145541	.	T	C	1	5	6	0	0	6	0	0
1	9262077	.	A	G	10	9	19	0	1	20	0	0
1	9262080	.	A	G	9	9	18	0	1	19	0	0
1	9265578	.	T	C	8	12	20	0	2	22	0	0
1	9270198	.	T	C	3	6	9	0	1	10	0	0
1	9270885	.	G	A	3	7	10	0	1	11	0	0
1	9273347	.	A	G	2	5	7	0	1	8	0	0
1	9273947	.	G	C	2	6	8	0	0	8	0	0
1	9276360	.	T	C	14	0	14	0	7	21	0	0
1	9276420	.	C	T	3	6	9	0	1	10	0	0
1	9277858	.	T	C	7	9	16	0	1	17	0	0
1	9278150	.	G	A	3	3	6	0	0	6	0	0
1	9290500	.	G	T	4	3	7	0	0	7	0	0
1	9293041	.	C	T	9	8	17	0	0	17	0	0
1	9293117	.	G	A	0	10	10	0	14	24	0	0
1	9293156	.	G	A	9	14	23	0	4	27	0	0
1	9293185	.	T	C	11	14	25	0	1	26	0	0
1	9293215	.	G	A	12	14	26	0	2	28	0	0
1	9293495	.	A	G	18	7	25	0	5	30	0	0
1	9293580	.	C	T	12	17	29	0	0	29	0	0
1	9293740	.	T	C	10	10	20	0	0	20	0	0
1	9293889	.	C	A	4	3	7	0	0	7	0	0
1	9499764	.	C	T	14	6	20	0	3	23	0	0
1	9500502	.	G	T	3	3	6	0	0	6	0	0
1	9500508	.	C	A	4	2	6	0	1	7	0	0
1	9500801	.	T	C	7	2	9	0	1	10	0	0
1	9500835	.	A	G	8	6	14	0	1	15	0	0
1	9500947	.	G	T	3	8	11	0	2	13	0	0
1	9501031	.	C	T	1	4	5	0	3	8	0	0
1	9501229	.	C	T	10	16	26	0	0	26	0	0
1	9501231	.	G	A	17	9	26	0	0	26	0	0
1	9501365	.	T	C	7	1	8	0	11	19	0	0
1	9501394	.	T	A	14	8	22	0	0	22	0	0
1	9508752	.	T	A	7	5	12	0	0	12	0	0
1	9510571	.	A	G	4	2	6	0	0	6	0	0
1	9510574	.	G	A	4	2	6	0	0	6	0	0
1	9517102	.	G	A	2	2	4	0	0	4	0	0
1	9636708	.	C	A	0	2	2	0	1	3	0	0
1	9710759	.	C	T	4	2	6	0	0	6	0	0
1	9710853	.	T	C	1	4	5	0	0	5	0	0
1	9711956	.	A	G	3	2	5	0	2	7	0	0
1	9712253	.	T	A	6	1	7	0	1	8	0	0
1	9712266	.	G	T	3	1	4	0	2	6	0	0
1	9740989	.	T	A	2	5	7	0	1	8	0	0
1	9741123	.	G	A	2	6	8	0	0	8	0	0
1	9793219	.	C	T	1	3	4	0	0	4	0	0
1	9793220	.	T	C	1	2	3	0	1	4	0	0
1	9793286	.	C	T	1	3	4	0	2	6	0	0
1	9808324	.	A	G	1	4	5	0	0	5	0	0
1	9808365	.	C	T	1	4	5	0	1	6	0	0
1	9808691	.	A	T	4	2	6	0	0	6	0	0
1	9873485	.	G	A	5	8	13	0	1	14	0	0
1	9873509	.	G	A	5	8	13	0	1	14	0	0
1	9873538	.	G	A	5	5	10	0	1	11	0	0
1	9873607	.	A	T	10	4	14	0	1	15	0	0
1	9873616	.	T	C	8	0	8	0	8	16	0	0
1	9873787	.	G	A	6	7	13	0	1	14	0	0
1	9880387	.	A	G	4	3	7	0	0	7	0	0
1	9893762	.	T	A	2	2	4	0	0	4	0	0
1	9914164	.	C	T	5	5	10	0	0	10	0	0
1	10033032	.	A	T	10	3	13	0	1	14	0	0
1	10645529	.	C	T	2	2	4	1	0	5	0	0
1	10673161	.	G	A	3	2	5	0	1	6	0	0
1	10673163	.	A	C	4	2	6	0	0	6	0	0
1	10675585	.	A	T	4	2	6	0	0	6	0	0
1	10675629	.	A	T	4	3	7	0	2	9	0	0
1	10680513	.	A	G	3	3	6	0	0	6	0	0
1	10680518	.	C	T	0	3	3	0	2	5	0	0
1	10683868	.	A	T	10	8	18	0	1	19	0	0
1	10683955	.	A	G	14	14	28	0	0	28	0	0
1	10684037	.	A	G	13	0	13	0	12	25	0	0
1	10684105	.	G	A	3	8	11	0	11	22	0	0
1	10688731	.	T	G	10	0	10	0	7	17	0	0
1	10692078	.	T	C	16	9	25	1	2	28	0	0
1	10692090	.	G	A	14	11	25	0	2	27	0	0
1	10736181	.	G	A	25	20	45	0	3	48	0	0
1	10738177	.	A	G	15	11	26	0	0	26	0	0
1	10738509	.	T	C	34	25	59	0	1	60	0	0
1	10738535	.	G	A	33	28	61	0	3	64	0	0
1	10738568	.	A	G	34	1	35	0	25	60	0	0
1	10738863	.	C	A	36	27	63	0	7	70	0	0
1	10841254	.	T	C	11	10	21	0	0	21	0	0
1	10841275	.	T	C	10	13	23	0	0	23	0	0
1	10841356	.	G	A	6	6	12	1	0	13	0	0
1	10885173	.	A	C	1	2	3	0	0	3	0	0
1	10885266	.	T	A	6	6	12	0	1	13	0	0
1	10901325	.	G	A	1	3	4	0	0	4	0	0
1	10912132	.	C	T	2	2	4	0	1	5	0	0
1	11125149	.	C	T	0	4	4	0	2	6	0	0
1	11125177	.	C	T	3	3	6	0	0	6	0	0
1	11125195	.	C	T	2	1	3	0	1	4	0	0
1	11125237	.	G	A	3	3	6	0	0	6	0	0
1	11125249	.	A	C	3	3	6	0	0	6	0	0
1	11127938	.	G	A	6	3	9	0	0	9	0	0
1	11150984	.	G	A	1	4	5	0	0	5	0	0
1	11670963	.	T	C	4	3	7	0	0	7	0	0
1	11671042	.	T	C	4	3	7	0	1	8	0	0
1	11671059	.	A	G	10	3	13	0	0	13	0	0
1	11671355	.	C	A	4	6	10	0	0	10	0	0
1	11671527	.	G	A	4	7	11	0	0	11	0	0
1	11671580	.	C	T	6	7	13	0	0	13	0	0
1	11671651	.	A	C	6	5	11	0	0	11	0	0
1	11783388	.	T	C	15	26	41	0	1	42	0	0
1	11783410	.	T	C	18	15	33	0	1	34	0	0
1	11783504	.	T	C	21	12	33	0	0	33	0	0
1	11783650	.	T	C	31	11	42	0	1	43	0	0
1	11784609	.	T	C	20	11	31	0	2	33	0	0
1	11904553	.	T	A	5	2	7	0	0	7	0	0
1	12333960	.	A	T	7	2	9	0	0	9	0	0
1	14163857	.	G	A	18	2	20	0	13	33	0	0
1	15254249	.	A	G	13	0	13	0	7	20	0	0
1	17523030	.	A	G	18	0	18	0	14	32	0	0
1	17535766	.	A	G	3	5	8	0	2	10	0	0
1	19759915	.	A	G	4	0	4	0	2	6	0	0
1	19760680	.	A	T	4	2	6	0	0	6	0	0
1	19762901	.	C	T	6	3	9	0	1	10	0	0
1	19862011	.	G	A	1	3	4	0	0	4	0	0
1	19862012	.	C	A	1	3	4	0	0	4	0	0
1	19869748	.	G	A	3	2	5	0	0	5	0	0
1	19869750	.	A	C	3	2	5	0	0	5	0	0
1	19872148	.	C	T	1	2	3	0	0	3	0	0
1	19874550	.	G	A	3	3	6	0	0	6	0	0
1	19879890	.	A	T	2	2	4	0	0	4	0	0
1	19882538	.	C	A	2	5	7	0	1	8	0	0
1	19882923	.	C	T	2	2	4	0	0	4	0	0
1	19886159	.	A	C	3	4	7	0	0	7	0	0
1	19886292	.	T	A	7	4	11	0	0	11	0	0
1	19937090	.	A	G	3	0	3	0	3	6	0	0
1	19950478	.	A	T	2	5	7	0	0	7	0	0
1	19955634	.	A	G	2	2	4	0	0	4	0	0
1	19984448	.	C	T	7	5	12	0	0	12	0	0
1	19988952	.	C	G	6	3	9	0	3	12	0	0
1	19989008	.	T	G	9	6	15	0	2	17	0	0
1	19989023	.	G	A	1	7	8	0	8	16	0	0
1	19989404	.	G	A	1	7	8	0	0	8	0	0
1	20063611	.	T	C	1	2	3	0	0	3	0	0
1	20063614	.	C	T	1	2	3	0	0	3	0	0
1	20063843	.	C	A	0	2	2	0	7	9	0	0
1	20065156	.	A	G	2	4	6	0	0	6	0	0
1	20094234	.	G	A	2	2	4	0	0	4	0	0
1	20094327	.	G	T	3	2	5	0	0	5	0	0
1	20112454	.	C	T	1	3	4	2	0	6	0	0
1	20112574	.	C	T	1	2	3	7	0	10	0	0
1	20112598	.	A	G	1	2	3	2	0	5	0	0
1	20117629	.	T	C	3	3	6	0	0	6	0	0
1	20129562	.	C	T	3	2	5	0	0	5	0	0
1	20129652	.	T	C	3	6	9	0	1	10	0	0
1	20139488	.	T	C	2	4	6	0	0	6	0	0
1	20139551	.	G	A	5	3	8	1	0	9	0	0
1	20139566	.	A	G	6	3	9	1	0	10	0	0
1	20139636	.	A	C	6	1	7	0	0	7	0	0
1	20139658	.	T	A	9	3	12	0	0	12	0	0
1	20139815	.	T	C	5	3	8	0	0	8	0	0
1	20139858	.	T	C	5	2	7	0	1	8	0	0
1	20139962	.	A	T	9	9	18	0	1	19	0	0
1	20140042	.	G	T	0	5	5	0	8	13	0	0
1	20140048	.	A	T	8	5	13	0	0	13	0	0
1	20140120	.	C	T	3	4	7	0	1	8	0	0
1	20140133	.	T	C	6	4	10	0	0	10	0	0
1	20140200	.	C	T	13	3	16	0	0	16	0	0
1	20140363	.	T	G	14	4	18	0	0	18	0	0
1	20140419	.	G	A	5	2	7	0	3	10	0	0
1	20140951	.	G	A	5	11	16	0	16	32	0	0
1	20140952	.	G	A	20	10	30	0	2	32	0	0
1	20141070	.	C	A	11	16	27	0	1	28	0	0
1	20141106	.	A	G	14	11	25	0	3	28	0	0
1	20141218	.	T	G	10	5	15	0	1	16	0	0
1	20141232	.	T	A	11	8	19	0	0	19	0	0
1	20141253	.	G	A	16	11	27	0	3	30	0	0
1	20141310	.	G	A	17	15	32	0	4	36	0	0
1	20141378	.	C	G	16	1	17	0	16	33	0	0
1	20141411	.	A	T	21	15	36	0	1	37	0	0
1	20141572	.	G	A	1	8	9	3	8	20	0	0
1	20141611	.	T	C	9	8	17	0	1	18	0	0
1	20141661	.	A	C	3	20	23	0	0	23	0	0
1	20141834	.	G	C	5	5	10	0	0	10	0	0
1	20147248	.	T	A	13	10	23	0	1	24	0	0
1	20160882	.	T	A	14	16	30	0	2	32	0	0
1	20166536	.	C	A	11	13	24	0	2	26	0	0
1	20166600	.	A	G	16	8	24	0	0	24	0	0
1	20173954	.	A	G	12	8	20	0	0	20	0	0
1	20194118	.	C	T	5	6	11	0	1	12	0	0
1	20212239	.	G	A	6	4	10	0	0	10	0	0
1	20212284	.	C	T	6	3	9	0	0	9	0	0
1	20212362	.	G	A	6	4	10	0	0	10	0	0
1	20221498	.	G	A	4	3	7	0	0	7	0	0
1	20270080	.	G	A	1	2	3	0	1	4	0	0
1	20557447	.	G	A	12	13	25	0	2	27	0	0
1	20557625	.	A	C	10	0	10	0	7	17	0	0
1	20557650	.	C	T	8	6	14	0	0	14	0	0
1	20557938	.	C	T	1	2	3	0	0	3	0	0
1	20558143	.	T	C	7	3	10	0	2	12	0	0
1	20558594	.	C	A	0	2	2	0	2	4	0	0
1	20558888	.	C	A	3	4	7	0	0	7	0	0
1	20559321	.	T	C	7	0	7	0	5	12	0	0
1	20559324	.	T	A	7	4	11	0	0	11	0	0
1	20559538	.	G	A	6	3	9	0	0	9	0	0
1	20559830	.	G	A	2	2	4	0	0	4	0	0
1	20678674	.	G	C	11	13	24	0	4	28	0	0
1	20694916	.	G	A	1	12	13	0	24	37	0	0
1	20694955	.	A	G	21	13	34	0	2	36	0	0
1	20695073	.	G	A	0	23	23	0	22	45	0	0
1	20700473	.	T	C	31	33	64	0	1	65	0	0
1	20700524	.	G	A	6	35	41	0	30	71	0	0
1	20704896	.	T	C	16	24	40	0	7	47	0	0
1	20705237	.	C	T	20	21	41	0	5	46	0	0
1	20705863	.	A	G	29	27	56	0	0	56	0	0
1	20866886	.	C	T	15	12	27	0	5	32	0	0
1	20866996	.	T	G	33	38	71	0	1	72	0	0
1	20867057	.	A	T	29	33	62	0	3	65	0	0
1	20867092	.	C	T	28	29	57	0	5	62	0	0
1	20867185	.	A	T	33	22	55	0	3	58	0	0
1	20867186	.	G	T	29	23	52	0	2	55	1	0
1	20867321	.	C	T	8	14	22	0	34	56	0	0
1	20867345	.	C	T	44	13	57	0	3	60	0	0
1	20867359	.	C	T	44	15	59	0	4	63	0	0
1	20867623	.	T	C	33	36	69	0	4	73	0	0
1	20867968	.	T	G	38	32	70	0	5	75	0	0
1	20868165	.	C	G	32	38	70	0	2	72	0	0
1	20868242	.	T	A	21	43	64	0	4	68	0	0
1	20868258	.	T	A	39	23	62	0	3	65	0	0
1	20868301	.	A	G	38	31	69	0	1	70	0	0
1	20868309	.	C	G	32	30	62	0	8	70	0	0
1	20868338	.	G	T	34	31	65	0	6	71	0	0
1	20868504	.	T	C	34	33	67	0	1	68	0	0
1	20868530	.	C	T	24	39	63	0	6	69	0	0
1	20868546	.	G	A	36	14	50	0	6	56	0	0
1	20868684	.	A	T	32	35	67	2	2	71	0	0
1	20868802	.	T	G	47	8	55	5	0	61	1	0
1	20868825	.	G	A	40	20	60	0	0	60	0	0
1	20868850	.	G	A	34	24	58	0	3	61	0	0
1	20868927	.	A	G	28	32	60	0	2	62	0	0
1	20868953	.	C	T	4	30	34	0	28	62	0	0
1	20869064	.	T	A	11	7	18	0	0	18	0	0
1	20870387	.	T	C	24	12	36	1	2	39	0	0
1	20870632	.	T	C	28	18	46	7	3	56	0	0
1	20870846	.	C	T	19	31	50	1	4	55	0	0
1	20871144	.	C	G	23	32	55	0	5	60	0	0
1	20886924	.	G	A	21	26	47	0	2	49	0	0
1	20886936	.	G	A	23	24	47	0	1	48	0	0
1	20910967	.	A	G	22	16	38	0	3	41	0	0
1	20911171	.	G	T	15	16	31	0	3	34	0	0
1	20916780	.	A	T	2	2	4	0	0	4	0	0
1	20916898	.	G	A	6	3	9	0	0	9	0	0
1	20916928	.	T	A	6	7	13	0	0	13	0	0
1	20932137	.	T	A	6	8	14	0	1	15	0	0
1	20932138	.	C	T	7	8	15	0	0	15	0	0
1	20941573	.	G	A	2	3	5	0	0	5	0	0
1	20946897	.	A	G	5	6	11	0	0	11	0	0
1	20956239	.	G	A	2	4	6	0	1	7	0	0
1	20959028	.	T	C	2	4	6	1	0	7	0	0
1	20970109	.	G	T	4	2	6	0	0	6	0	0
1	21138623	.	T	C	5	5	10	0	1	11	0	0
1	21139142	.	G	A	12	6	18	0	0	18	0	0
1	21139367	.	G	A	7	3	10	0	0	10	0	0
1	21139456	.	G	C	9	7	16	0	0	16	0	0
1	21141701	.	A	G	8	6	14	0	0	14	0	0
1	21141894	.	C	T	2	4	6	0	3	9	0	0
1	21141930	.	T	G	4	5	9	0	0	9	0	0
1	21146729	.	C	G	0	4	4	0	5	9	0	0
1	21151784	.	A	G	2	5	7	0	0	7	0	0
1	21309461	.	A	T	7	2	9	0	0	9	0	0
1	21312067	.	A	G	7	10	17	0	1	18	0	0
1	21312112	.	C	T	8	17	25	0	2	27	0	0
1	21312393	.	C	T	5	2	7	0	0	7	0	0
1	21312398	.	A	G	5	2	7	0	0	7	0	0
1	21313861	.	T	A	1	5	6	0	0	6	0	0
1	21333205	.	C	G	1	14	15	0	31	46	0	0
1	21333223	.	A	T	14	27	41	0	1	42	0	0
1	21333337	.	G	C	20	18	38	0	1	39	0	0
1	21344500	.	G	A	15	20	35	0	1	36	0	0
1	21344518	.	C	G	2	22	24	0	13	37	0	0
1	21346015	.	T	C	10	14	24	0	1	25	0	0
1	21368014	.	C	A	15	9	24	0	2	26	0	0
1	21368074	.	C	A	8	9	17	0	2	19	0	0
1	21368206	.	G	T	11	8	19	0	0	19	0	0
1	21423093	.	A	T	10	4	14	0	1	15	0	0
1	21423307	.	C	T	8	10	18	0	0	18	0	0
1	21423756	.	A	G	17	9	26	0	1	27	0	0
1	21423765	.	C	A	9	15	24	0	1	25	0	0
1	21449804	.	A	G	6	3	9	0	0	9	0	0
1	21500451	.	G	T	5	15	20	0	0	20	0	0
1	21513826	.	G	A	5	4	9	0	1	10	0	0
1	21514069	.	G	A	4	5	9	0	0	9	0	0
1	21515903	.	G	T	5	4	9	0	0	9	0	0
1	21516249	.	C	G	4	4	8	0	0	8	0	0
1	21518503	.	G	A	1	3	4	0	0	4	0	0
1	21527348	.	C	A	2	3	5	0	0	5	0	0
1	21576919	.	G	A	4	2	6	0	0	6	0	0
1	21581680	.	T	C	3	0	3	0	4	7	0	0
1	21593731	.	C	T	2	2	4	0	1	5	0	0
1	21610651	.	A	G	4	4	8	0	0	8	0	0
1	21611274	.	T	C	1	2	3	0	0	3	0	0
1	21612127	.	C	T	4	4	8	0	0	8	0	0
1	21612153	.	T	G	3	6	9	0	1	10	0	0
1	21612400	.	G	A	7	8	15	0	0	15	0	0
1	21612418	.	G	C	4	6	10	0	0	10	0	0
1	21648917	.	T	A	2	3	5	0	1	6	0	0
1	21944599	.	C	G	1	2	3	0	0	3	0	0
1	22236735	.	T	G	7	2	9	0	0	9	0	0
1	22236990	.	G	A	5	2	7	0	0	7	0	0
1	22242492	.	A	G	5	2	7	0	0	7	0	0
1	22245639	.	G	A	1	2	3	0	0	3	0	0
1	22388955	.	C	T	2	3	5	0	0	5	0	0
1	22389122	.	C	T	6	8	14	0	1	15	0	0
1	22389246	.	C	T	0	4	4	0	7	11	0	0
1	22389264	.	T	A	7	7	14	0	0	14	0	0
1	22389395	.	T	C	20	12	32	0	2	34	0	0
1	22412005	.	G	A	3	5	8	0	1	9	0	0
1	22484544	.	C	A	2	5	7	0	1	8	0	0
1	22542770	.	C	A	3	4	7	0	1	8	0	0
1	22542771	.	T	C	3	0	3	0	5	8	0	0
1	22543902	.	G	A	1	2	3	0	0	3	0	0
1	22546729	.	G	A	1	2	3	0	0	3	0	0
1	22648037	.	T	A	27	31	58	1	1	60	0	0
1	22648038	.	A	C	27	30	57	1	2	60	0	0
1	22651348	.	C	A	1	16	17	0	20	37	0	0
1	22651934	.	T	A	30	11	41	0	1	42	0	0
1	22713000	.	A	T	2	2	4	0	0	4	0	0
1	22713010	.	A	T	3	1	4	0	0	4	0	0
1	22713058	.	C	T	0	3	3	0	2	5	0	0
1	22713095	.	A	C	1	0	1	0	4	5	0	0
1	22713141	.	A	G	1	2	3	0	1	4	0	0
1	22713401	.	G	A	3	4	7	0	0	7	0	0
1	22713418	.	T	C	3	0	3	0	4	7	0	0
1	22713595	.	G	C	1	3	4	0	1	5	0	0
1	22713674	.	C	T	3	2	5	0	1	6	0	0
1	22713974	.	G	A	2	5	7	0	0	7	0	0
1	22770608	.	A	T	16	19	35	0	0	35	0	0
1	22770723	.	C	T	11	9	20	0	2	22	0	0
1	22770810	.	C	T	10	13	23	0	2	25	0	0
1	22771305	.	T	G	20	9	29	0	0	29	0	0
1	22771437	.	G	A	10	12	22	0	1	23	0	0
1	22771677	.	C	T	0	7	7	0	8	15	0	0
1	22771911	.	A	T	14	5	19	0	0	19	0	0
1	22771936	.	C	T	12	6	18	0	0	18	0	0
1	22771952	.	A	T	7	9	16	0	0	16	0	0
1	22772213	.	C	A	10	14	24	0	0	24	0	0
1	22772308	.	C	T	11	5	16	1	0	17	0	0
1	22772545	.	A	T	8	9	17	0	0	17	0	0
1	22772711	.	G	A	11	5	16	0	0	16	0	0
1	22777201	.	G	A	7	2	9	0	0	9	0	0
1	22777862	.	A	C	3	2	5	0	2	7	0	0
1	22803051	.	C	T	4	5	9	1	0	10	0	0
1	22805615	.	C	T	14	15	29	0	3	32	0	0
1	22805630	.	G	C	11	14	25	0	1	26	0	0
1	22805750	.	T	A	7	8	15	0	1	16	0	0
1	22805766	.	C	T	7	5	12	0	1	13	0	0
1	22805880	.	G	T	9	6	15	0	0	15	0	0
1	22805906	.	A	C	9	13	22	0	0	22	0	0
1	22805927	.	C	A	10	9	19	0	0	19	0	0
1	22806089	.	C	T	23	14	37	0	3	40	0	0
1	22806108	.	A	G	18	19	37	0	3	40	0	0
1	22806156	.	T	A	13	0	13	0	4	23	6	0
1	22806166	.	G	A	11	7	18	0	1	19	0	0
1	22806643	.	C	A	16	20	36	0	1	37	0	0
1	22806825	.	C	T	2	8	10	0	15	25	0	0
1	22806845	.	C	A	14	6	20	0	0	20	0	0
1	22806917	.	C	A	7	7	14	0	0	14	0	0
1	22806936	.	C	T	1	7	8	0	9	17	0	0
1	22806980	.	G	A	11	6	17	0	0	17	0	0
1	22807043	.	G	A	13	3	16	0	0	16	0	0
1	22807169	.	A	G	9	8	17	0	1	18	0	0
1	22807238	.	G	A	13	6	19	0	0	19	0	0
1	22807275	.	C	G	17	9	26	0	0	26	0	0
1	22807304	.	C	G	23	9	32	0	0	32	0	0
1	22807321	.	G	A	22	12	34	0	0	34	0	0
1	22807632	.	C	T	6	11	17	0	1	18	0	0
1	22807639	.	G	A	7	10	17	0	1	18	0	0
1	22807744	.	G	T	8	4	12	0	1	14	1	0
1	22808009	.	G	T	5	2	7	0	2	9	0	0
1	22808149	.	T	A	7	9	16	0	0	16	0	0
1	22808181	.	T	C	6	0	6	0	7	13	0	0
1	22808264	.	T	G	8	8	16	0	1	17	0	0
1	22808296	.	A	T	5	3	8	0	1	13	4	0
1	22808301	.	C	G	1	4	5	0	4	9	0	0
1	22808384	.	C	T	0	6	6	0	6	12	0	0
1	22808444	.	G	A	4	7	11	0	0	11	0	0
1	22808479	.	G	T	4	3	7	0	1	8	0	0
1	22808514	.	A	T	6	2	8	0	2	10	0	0
1	22808665	.	C	T	9	6	15	0	0	15	0	0
1	22814910	.	A	G	10	9	19	0	0	19	0	0
1	22829325	.	G	A	2	3	5	0	2	7	0	0
1	22845919	.	A	G	11	4	15	1	0	16	0	0
1	22851065	.	G	T	10	5	15	0	1	16	0	0
1	22851828	.	A	T	11	4	15	0	1	16	0	0
1	22856087	.	C	T	5	4	9	0	0	9	0	0
1	22857979	.	C	T	11	12	23	0	1	24	0	0
1	22857995	.	A	G	12	10	22	0	1	23	0	0
1	22858194	.	G	A	20	17	37	0	2	39	0	0
1	22858275	.	T	C	30	17	47	0	4	51	0	0
1	22858397	.	G	A	26	20	46	0	1	47	0	0
1	22858478	.	G	A	21	22	43	0	6	49	0	0
1	22861267	.	G	A	21	16	37	0	1	38	0	0
1	22864011	.	C	T	6	7	13	0	0	13	0	0
1	22943748	.	G	A	11	10	21	0	0	21	0	0
1	22944056	.	C	T	2	28	30	1	19	50	0	0
1	22944068	.	C	T	33	19	52	1	0	53	0	0
1	22944386	.	A	C	18	31	49	0	2	51	0	0
1	22945054	.	T	C	36	11	47	0	2	49	0	0
1	22945173	.	T	G	20	20	40	0	0	40	0	0
1	22945190	.	G	T	17	20	37	0	0	37	0	0
1	22945444	.	G	A	16	18	34	0	0	34	0	0
1	22945519	.	C	T	21	18	39	0	1	40	0	0
1	22945888	.	G	C	20	1	21	0	11	32	0	0
1	22945903	.	T	C	20	8	28	0	6	34	0	0
1	22946108	.	C	T	14	13	27	0	3	30	0	0
1	22956429	.	C	T	2	5	7	1	9	17	0	0
1	22966877	.	C	A	7	8	15	0	1	16	0	0
1	22987960	.	A	G	6	6	12	0	0	12	0	0
1	22992058	.	G	A	5	3	8	0	0	8	0	0
1	22996606	.	G	A	7	2	9	0	0	9	0	0
1	23072224	.	G	A	3	5	8	0	0	8	0	0
1	23072278	.	G	A	5	3	8	0	1	9	0	0
1	23072304	.	G	T	4	3	7	0	0	7	0	0
1	23072461	.	G	A	2	6	8	0	0	8	0	0
1	23072683	.	T	C	7	0	7	0	6	13	0	0
1	23072746	.	T	A	5	5	10	0	0	10	0	0
1	23094677	.	G	A	8	3	11	0	0	11	0	0
1	23110816	.	T	C	2	11	13	0	2	15	0	0
1	23243179	.	C	T	0	4	4	0	7	11	0	0
1	23243230	.	A	G	4	5	9	0	0	9	0	0
1	23243733	.	C	T	2	7	9	0	0	9	0	0
1	23251104	.	C	T	2	2	4	0	0	4	0	0
1	23254504	.	G	A	2	2	4	0	0	4	0	0
1	23254712	.	G	A	4	3	7	0	0	7	0	0
1	23271345	.	G	A	29	36	65	0	7	72	0	0
1	23271500	.	G	A	35	35	70	0	6	76	0	0
1	23271608	.	G	A	33	37	70	0	3	73	0	0
1	23271612	.	T	A	0	4	4	0	0	4	0	0
1	23271770	.	T	G	23	35	58	0	3	62	1	0
1	23274820	.	G	A	5	7	12	0	2	14	0	0
1	23275228	.	C	G	4	8	12	2	0	14	0	0
1	23277619	.	A	G	9	0	9	0	5	14	0	0
1	23283717	.	G	A	1	2	3	0	0	3	0	0
1	23283790	.	A	G	2	1	3	0	0	3	0	0
1	23284094	.	T	A	1	3	4	0	1	5	0	0
1	23287163	.	T	C	5	2	7	0	0	7	0	0
1	23291117	.	C	A	0	3	3	0	1	4	0	0
1	23297750	.	A	G	3	4	7	0	0	7	0	0
1	23298642	.	A	T	4	6	10	0	0	10	0	0
1	23298892	.	A	G	9	3	12	0	0	12	0	0
1	23301873	.	G	T	2	3	5	0	0	5	0	0
1	23388325	.	C	T	4	3	7	0	0	7	0	0
1	23393122	.	A	T	2	3	5	0	0	5	0	0
1	23506660	.	C	A	6	17	23	0	3	26	0	0
1	23506711	.	A	T	9	9	18	0	8	26	0	0
1	23506787	.	A	T	26	21	47	0	0	47	0	0
1	23506865	.	C	A	21	20	41	0	0	41	0	0
1	23508009	.	G	T	27	14	41	0	3	44	0	0
1	23526644	.	T	C	12	7	19	1	3	23	0	0
1	23528066	.	C	T	13	7	20	0	2	22	0	0
1	23530438	.	C	T	6	10	16	0	2	18	0	0
1	23535880	.	C	T	2	11	13	0	9	22	0	0
1	23536012	.	T	C	9	7	16	0	2	18	0	0
1	23536222	.	T	A	8	5	13	0	3	16	0	0
1	23573460	.	T	C	1	3	4	0	1	5	0	0
1	23573582	.	C	T	10	8	18	6	0	24	0	0
1	23573823	.	A	T	12	7	19	0	0	19	0	0
1	23574931	.	C	T	2	2	4	0	0	4	0	0
1	23578157	.	C	T	5	3	8	0	0	8	0	0
1	23578478	.	C	T	3	2	5	0	0	5	0	0
1	23578490	.	G	A	3	3	6	0	0	6	0	0
1	23578514	.	C	T	2	3	5	0	0	5	0	0
1	23580196	.	G	A	1	2	3	0	0	3	0	0
1	23586133	.	A	G	2	5	7	0	0	7	0	0
1	23586581	.	G	A	4	2	6	0	0	6	0	0
1	23589162	.	T	C	2	0	2	0	2	4	0	0
1	23908939	.	T	G	9	6	15	0	0	15	0	0
1	23908940	.	T	G	9	6	15	0	0	15	0	0
1	23909090	.	A	G	15	13	28	0	1	29	0	0
1	23909522	.	A	C	3	6	9	0	0	9	0	0
1	23909748	.	A	T	9	11	20	0	0	20	0	0
1	23920983	.	C	T	0	12	12	0	7	19	0	0
1	23921071	.	A	T	10	14	24	0	2	26	0	0
1	23921284	.	T	C	8	10	18	0	0	18	0	0
1	23921302	.	C	A	6	7	13	0	0	13	0	0
1	23921427	.	T	C	2	0	2	0	4	6	0	0
1	23921793	.	A	C	9	5	14	0	0	14	0	0
1	23936154	.	C	T	3	3	6	0	0	6	0	0
1	23943609	.	A	T	8	3	11	0	0	11	0	0
1	23943726	.	G	A	6	3	9	0	1	10	0	0
1	23945132	.	T	A	3	2	5	0	0	5	0	0
1	23947881	.	T	A	4	5	9	0	0	9	0	0
1	24045920	.	G	T	1	3	4	0	0	4	0	0
1	24076890	.	A	G	4	7	11	0	2	13	0	0
1	24077274	.	A	G	5	0	5	0	11	16	0	0
1	24077791	.	G	A	2	30	32	0	13	45	0	0
1	24077902	.	A	G	7	12	19	0	0	19	0	0
1	24079262	.	A	T	2	2	4	0	0	4	0	0
1	24357931	.	C	T	32	43	75	0	2	77	0	0
1	24520679	.	T	C	5	3	8	0	0	8	0	0
1	24520759	.	T	C	3	4	7	0	0	7	0	0
1	24520823	.	T	C	5	2	7	0	0	7	0	0
1	24520863	.	A	T	3	2	5	0	0	5	0	0
1	24523415	.	T	C	1	3	4	0	0	4	0	0
1	24540785	.	A	G	2	3	5	0	0	5	0	0
1	24540959	.	A	G	2	4	6	0	0	6	0	0
1	24557100	.	A	G	2	3	5	0	0	5	0	0
1	24557510	.	G	A	5	7	12	0	0	12	0	0
1	24558336	.	C	G	2	3	5	0	0	5	0	0
1	24871075	.	A	G	3	12	15	0	0	15	0	0
1	24871079	.	A	G	3	14	17	0	0	17	0	0
1	24879994	.	C	T	7	9	16	0	0	16	0	0
1	24902745	.	T	C	8	1	9	0	3	12	0	0
1	24908001	.	T	C	7	0	7	0	10	17	0	0
1	25216208	.	C	T	2	1	3	0	1	4	0	0
1	25296797	.	C	T	3	6	9	0	0	9	0	0
1	25296831	.	C	T	5	6	11	0	0	11	0	0
1	25305446	.	T	G	7	0	7	0	6	13	0	0
1	25310899	.	C	A	11	9	20	0	0	20	0	0
1	25310912	.	T	A	6	10	16	0	1	17	0	0
1	25313056	.	C	T	14	9	23	0	1	24	0	0
1	25313261	.	T	C	18	14	32	0	1	33	0	0
1	25313300	.	G	A	1	17	18	0	19	37	0	0
1	25340311	.	G	A	1	2	3	0	0	3	0	0
1	25399574	.	G	A	2	4	6	0	0	6	0	0
1	25400247	.	C	T	4	3	7	0	1	8	0	0
1	25400814	.	T	A	4	4	8	0	0	8	0	0
1	25400842	.	A	T	1	3	4	0	0	4	0	0
1	25401181	.	G	A	2	3	5	0	0	5	0	0
1	25401290	.	T	A	4	3	7	0	0	7	0	0
1	25401362	.	T	C	1	0	1	0	2	3	0	0
1	25402203	.	C	T	0	2	2	0	4	6	0	0
1	25654976	.	C	T	2	3	5	0	0	5	0	0
1	25660719	.	C	T	0	6	6	0	1	7	0	0
1	25741901	.	A	G	3	2	5	0	0	5	0	0
1	25798863	.	G	C	14	8	22	0	0	22	0	0
1	25798983	.	A	C	5	3	8	0	1	9	0	0
1	25811411	.	T	C	1	5	6	0	2	8	0	0
1	25812658	.	C	T	3	3	6	0	0	6	0	0
1	25863511	.	G	A	7	6	13	0	0	13	0	0
1	25863638	.	A	T	5	7	12	0	0	12	0	0
1	25918405	.	C	T	5	2	7	0	0	7	0	0
1	26012748	.	G	T	2	4	6	0	0	6	0	0
1	26012755	.	G	A	2	4	6	0	0	6	0	0
1	26044934	.	G	T	1	1	2	0	1	3	0	0
1	26046323	.	A	G	13	9	22	0	1	23	0	0
1	26046950	.	T	A	6	11	17	0	2	19	0	0
1	26046996	.	A	T	12	9	21	0	2	23	0	0
1	26063007	.	G	T	5	6	11	0	0	11	0	0
1	26063030	.	G	A	3	5	8	0	1	9	0	0
1	26096055	.	T	A	4	2	6	0	1	7	0	0
1	26096124	.	A	T	6	2	8	0	1	9	0	0
1	26096270	.	C	T	5	4	9	0	0	9	0	0
1	26096522	.	G	T	12	17	29	0	0	29	0	0
1	26108389	.	G	A	2	2	4	0	0	4	0	0
1	26109464	.	T	C	3	3	6	0	0	6	0	0
1	26109479	.	T	C	4	3	7	0	1	8	0	0
1	26127339	.	A	G	11	15	26	0	1	27	0	0
1	26127856	.	A	T	16	10	26	0	0	26	0	0
1	26251906	.	T	G	2	2	4	0	0	4	0	0
1	26252033	.	C	T	0	8	8	0	3	11	0	0
1	26252215	.	T	C	5	3	8	0	0	8	0	0
1	26252308	.	G	C	1	5	6	0	0	6	0	0
1	26252323	.	A	T	6	2	8	0	0	8	0	0
1	26252688	.	A	G	4	2	6	0	0	6	0	0
1	26252814	.	C	T	5	5	10	0	0	10	0	0
1	26252877	.	G	A	5	4	9	0	0	9	0	0
1	26252931	.	A	T	5	3	8	0	0	8	0	0
1	26375218	.	C	T	1	5	6	0	0	6	0	0
1	26375404	.	C	A	2	3	5	0	0	5	0	0
1	26376176	.	G	A	3	4	7	0	0	7	0	0
1	26376816	.	A	T	1	6	7	0	1	8	0	0
1	26377593	.	G	A	1	3	4	0	1	5	0	0
1	26382809	.	A	T	8	8	16	0	0	17	1	0
1	26383281	.	G	T	0	9	9	0	8	17	0	0
1	26383466	.	G	A	8	8	16	0	0	16	0	0
1	26384682	.	G	A	4	4	8	0	0	8	0	0
1	26384721	.	A	G	3	6	9	0	0	9	0	0
1	26384774	.	C	T	5	3	8	0	0	8	0	0
1	26384779	.	C	A	4	3	7	0	0	7	0	0
1	26385222	.	C	G	10	4	14	0	0	14	0	0
1	26385939	.	A	G	9	11	20	0	0	20	0	0
1	26391649	.	C	T	1	4	5	0	4	9	0	0
1	26391698	.	A	G	5	3	8	0	0	8	0	0
1	26391720	.	A	G	3	4	7	0	1	8	0	0
1	26392422	.	G	A	4	6	10	0	0	10	0	0
1	26394436	.	A	C	3	0	3	0	3	6	0	0
1	26454080	.	T	A	1	3	4	0	0	4	0	0
1	26463488	.	T	G	2	0	2	0	3	5	0	0
1	26463671	.	T	A	6	3	9	0	1	10	0	0
1	26463692	.	C	T	4	6	10	0	1	11	0	0
1	26463779	.	T	A	2	7	9	0	0	9	0	0
1	26463878	.	C	A	7	10	17	0	1	18	0	0
1	26463931	.	A	T	9	4	13	1	0	14	0	0
1	26464175	.	G	A	4	4	8	0	1	9	0	0
1	26464353	.	A	G	10	10	20	0	1	21	0	0
1	26464446	.	G	A	15	8	23	0	0	23	0	0
1	26464758	.	T	A	19	7	26	0	0	26	0	0
1	26465041	.	G	T	14	5	19	0	0	20	1	0
1	26465047	.	A	C	6	12	18	0	1	19	0	0
1	26465224	.	T	A	16	11	27	0	0	28	1	0
1	26465368	.	G	A	1	2	3	0	3	6	0	0
1	26467243	.	G	A	1	3	4	0	0	4	0	0
1	26489854	.	G	A	7	7	14	0	1	15	0	0
1	26498400	.	C	T	16	9	25	0	0	25	0	0
1	26498657	.	G	A	1	12	13	0	13	26	0	0
1	26504998	.	G	A	14	9	23	0	0	23	0	0
1	26505282	.	T	C	14	10	24	0	1	25	0	0
1	26505291	.	C	T	15	11	26	0	2	28	0	0
1	26507356	.	G	A	12	8	20	0	0	20	0	0
1	26507392	.	T	A	6	4	10	0	0	10	0	0
1	26507582	.	G	A	19	11	30	0	2	32	0	0
1	26507764	.	A	G	11	0	11	0	9	20	0	0
1	26638053	.	G	C	2	2	4	0	1	5	0	0
1	26827238	.	A	G	1	2	3	0	0	3	0	0
1	26827449	.	T	C	1	2	3	0	1	4	0	0
1	26827519	.	G	A	11	8	19	0	2	21	0	0
1	26881374	.	A	G	2	2	4	0	0	4	0	0
1	27207986	.	A	G	9	0	9	0	6	15	0	0
1	27208703	.	A	T	5	2	7	0	1	8	0	0
1	27209904	.	T	G	7	14	21	0	0	21	0	0
1	27210057	.	T	C	8	4	12	0	1	13	0	0
1	27210073	.	T	C	5	5	10	0	0	10	0	0
1	27210231	.	C	T	8	4	12	0	0	12	0	0
1	27210578	.	G	A	4	8	12	0	0	12	0	0
1	27210929	.	C	T	18	9	27	0	1	28	0	0
1	27809162	.	T	C	5	5	10	0	0	10	0	0
1	27826090	.	C	A	8	9	17	0	1	18	0	0
1	27826198	.	C	T	6	10	16	0	0	16	0	0
1	27826651	.	T	C	17	12	29	0	1	30	0	0
1	27842373	.	G	A	1	19	20	0	11	31	0	0
1	27860743	.	T	A	9	4	13	0	3	16	0	0
1	27893097	.	T	C	7	10	17	0	0	17	0	0
1	27893285	.	A	T	3	1	4	0	1	5	0	0
1	27893550	.	T	A	6	2	8	0	1	9	0	0
1	27893920	.	A	T	1	3	4	0	0	4	0	0
1	27993191	.	A	G	5	0	5	0	7	12	0	0
1	28018821	.	C	T	17	13	30	0	1	31	0	0
1	28018988	.	T	A	8	12	20	0	0	20	0	0
1	28035719	.	G	A	5	3	8	0	0	8	0	0
1	28035786	.	C	T	7	6	13	0	0	13	0	0
1	28036159	.	A	C	7	4	11	0	0	11	0	0
1	28046218	.	T	C	15	11	26	0	3	29	0	0
1	28046224	.	A	G	16	3	19	0	13	32	0	0
1	28067976	.	T	A	3	8	11	0	0	11	0	0
1	28391882	.	C	G	14	7	21	0	0	21	0	0
1	28391914	.	C	T	1	3	4	0	7	11	0	0
1	28422569	.	C	T	9	9	18	0	1	19	0	0
1	28724010	.	G	T	4	3	7	0	0	7	0	0
1	28788272	.	G	A	4	4	8	0	0	8	0	0
1	28809127	.	A	C	4	0	4	0	2	6	0	0
1	28833228	.	A	G	3	4	7	0	0	7	0	0
1	28834592	.	A	G	1	3	4	0	0	4	0	0
1	28834898	.	C	A	1	2	3	0	0	3	0	0
1	28835669	.	T	C	2	8	10	0	0	10	0	0
1	28847677	.	C	T	1	8	9	0	16	25	0	0
1	28874819	.	C	T	1	5	6	0	0	6	0	0
1	28899350	.	G	A	5	7	12	0	0	12	0	0
1	28899483	.	G	A	1	5	6	0	0	6	0	0
1	28899530	.	T	C	1	6	7	0	0	7	0	0
1	28900661	.	A	G	4	5	9	0	0	9	0	0
1	28965095	.	G	A	14	11	25	0	0	25	0	0
1	28979080	.	A	C	11	0	11	0	5	16	0	0
1	28979161	.	G	C	14	0	14	0	8	22	0	0
1	28986486	.	C	T	11	6	17	0	1	18	0	0
1	29045226	.	G	A	7	10	17	0	0	17	0	0
1	29058596	.	C	T	3	2	5	0	0	5	0	0
1	29060639	.	C	T	1	2	3	0	0	3	0	0
1	29201933	.	G	C	10	10	20	0	1	21	0	0
1	29202110	.	T	C	6	7	13	0	0	13	0	0
1	29202368	.	G	A	5	2	7	0	0	7	0	0
1	29212165	.	T	C	4	2	6	0	0	6	0	0
1	29227642	.	T	A	2	4	6	0	0	6	0	0
1	29227770	.	C	T	3	3	6	0	0	6	0	0
1	29227880	.	G	T	5	7	12	0	0	12	0	0
1	29228261	.	A	G	4	0	4	0	5	9	0	0
1	29228390	.	A	T	6	8	14	0	0	14	0	0
1	29270942	.	C	T	3	2	5	0	0	5	0	0
1	29281770	.	C	T	1	2	3	0	0	3	0	0
1	29282145	.	C	T	2	2	4	0	1	5	0	0
1	29389987	.	C	T	2	4	6	0	1	7	0	0
1	29751529	.	T	G	1	4	5	0	1	6	0	0
1	29751819	.	C	A	5	3	8	0	1	9	0	0
1	29752319	.	T	C	8	10	18	0	0	18	0	0
1	29752421	.	A	G	3	2	5	0	1	6	0	0
1	29758042	.	G	A	2	2	4	0	0	4	0	0
1	29770360	.	T	A	1	6	7	0	0	7	0	0
1	29772391	.	A	G	2	8	10	0	0	10	0	0
1	29772615	.	T	C	8	2	10	0	1	11	0	0
1	29772741	.	C	T	8	5	13	0	0	13	0	0
1	29775664	.	C	A	3	7	10	0	0	10	0	0
1	29779402	.	G	A	0	3	3	0	7	10	0	0
1	29781462	.	G	A	11	4	15	0	0	15	0	0
1	29781597	.	A	T	6	10	16	0	3	19	0	0
1	29786570	.	G	A	8	8	16	0	3	19	0	0
1	29786659	.	T	G	8	0	8	0	7	15	0	0
1	29786704	.	A	G	10	7	17	0	0	17	0	0
1	29787397	.	G	A	16	9	25	0	1	26	0	0
1	29789889	.	C	T	9	6	15	1	1	17	0	0
1	29790030	.	A	T	11	9	20	0	1	21	0	0
1	29795692	.	G	A	6	15	21	0	1	22	0	0
1	29797191	.	T	C	14	13	27	0	2	29	0	0
1	29797344	.	G	T	15	9	24	0	2	26	0	0
1	29797345	.	A	T	14	11	25	0	1	26	0	0
1	29797387	.	A	C	13	11	24	0	0	24	0	0
1	29797699	.	T	G	6	4	10	0	2	12	0	0
1	29806547	.	C	T	2	2	4	0	1	5	0	0
1	29813246	.	C	A	6	8	14	0	0	14	0	0
1	29813276	.	C	T	4	11	15	0	0	15	0	0
1	29817451	.	C	A	10	10	20	0	3	23	0	0
1	29820831	.	C	T	19	24	43	0	1	44	0	0
1	29823603	.	T	C	15	9	24	0	4	28	0	0
1	29823690	.	T	A	29	14	43	0	1	44	0	0
1	29823701	.	A	G	23	14	37	0	5	42	0	0
1	29858127	.	G	T	3	3	6	0	1	7	0	0
1	29860326	.	T	A	6	8	14	0	0	14	0	0
1	29860506	.	A	G	7	4	11	0	0	11	0	0
1	29900692	.	G	A	3	2	5	0	0	5	0	0
1	29908013	.	A	G	5	3	8	0	0	8	0	0
1	29909502	.	C	T	1	2	3	0	0	3	0	0
1	29916178	.	G	A	7	3	10	0	1	11	0	0
1	29952918	.	A	T	7	6	13	0	0	13	0	0
1	29953069	.	G	A	11	3	14	0	1	15	0	0
1	29953239	.	G	T	1	7	8	0	10	18	0	0
1	29953253	.	A	G	10	0	10	0	10	20	0	0
1	29953433	.	A	T	9	5	14	0	0	14	0	0
1	29953616	.	A	T	2	4	6	0	0	6	0	0
1	29954795	.	A	C	7	3	10	0	0	10	0	0
1	29954844	.	T	C	8	3	11	0	1	12	0	0
1	29954972	.	C	T	10	12	22	0	0	22	0	0
1	29955006	.	G	A	13	8	21	0	2	24	1	0
1	29955171	.	G	A	13	16	29	0	0	29	0	0
1	29955179	.	A	G	11	14	25	0	2	27	0	0
1	29955228	.	C	T	10	8	18	0	2	20	0	0
1	29955249	.	A	G	8	7	15	0	0	15	0	0
1	30039302	.	T	A	2	2	4	0	0	4	0	0
1	30178635	.	C	A	3	3	6	0	0	6	0	0
1	30180924	.	G	A	4	1	5	0	2	7	0	0
1	30180929	.	T	A	4	2	6	0	1	7	0	0
1	30183309	.	C	G	3	2	5	0	0	5	0	0
1	30212461	.	G	A	7	7	14	0	1	15	0	0
1	30212793	.	G	A	4	5	9	0	1	10	0	0
1	30250557	.	T	C	8	10	18	0	2	20	0	0
1	30255365	.	G	A	10	11	21	0	1	22	0	0
1	30255458	.	A	C	9	12	21	0	2	23	0	0
1	30270683	.	T	C	6	12	18	2	1	21	0	0
1	30282841	.	G	T	4	9	13	0	0	13	0	0
1	30343967	.	T	G	12	18	30	0	1	31	0	0
1	30344842	.	A	G	7	5	12	0	1	13	0	0
1	30345026	.	T	C	2	13	15	0	2	17	0	0
1	30345029	.	C	T	3	12	15	0	1	16	0	0
1	30345075	.	G	T	6	11	17	0	1	18	0	0
1	30345131	.	C	T	0	4	4	0	8	12	0	0
1	30345239	.	G	C	8	3	11	0	0	11	0	0
1	30345243	.	T	C	7	2	9	0	0	9	0	0
1	30345531	.	A	G	4	2	6	0	0	6	0	0
1	30345635	.	T	G	3	5	8	0	2	10	0	0
1	30345669	.	T	G	10	4	14	0	0	14	0	0
1	30345925	.	G	A	6	5	11	0	1	12	0	0
1	30345948	.	C	T	0	7	7	0	8	15	0	0
1	30346042	.	G	A	10	6	16	0	1	17	0	0
1	30346112	.	T	C	5	3	8	0	0	8	0	0
1	30346124	.	T	A	5	2	7	0	0	8	1	0
1	30346233	.	G	A	8	7	15	0	0	15	0	0
1	30346377	.	G	A	11	4	15	0	0	15	0	0
1	30346385	.	G	A	5	11	16	0	0	16	0	0
1	30346432	.	T	G	8	5	13	0	0	13	0	0
1	30346456	.	G	A	7	7	14	0	0	14	0	0
1	30346624	.	G	T	4	3	7	0	0	7	0	0
1	30346845	.	G	T	3	2	5	0	0	6	1	0
1	30346906	.	C	A	8	3	11	0	1	12	0	0
1	30346977	.	C	A	7	9	16	0	1	17	0	0
1	30347027	.	C	A	15	9	24	0	0	24	0	0
1	30347043	.	T	C	14	0	14	0	8	22	0	0
1	30347586	.	C	T	5	3	8	0	0	8	0	0
1	30540535	.	C	T	3	4	7	0	0	7	0	0
1	30589258	.	C	A	6	4	10	0	0	10	0	0
1	30641002	.	G	A	2	2	4	1	0	5	0	0
1	30641038	.	T	C	3	2	5	0	0	5	0	0
1	30641077	.	C	A	1	3	4	0	3	7	0	0
1	30688802	.	G	A	2	6	8	0	0	8	0	0
1	30688924	.	G	T	2	4	6	0	0	6	0	0
1	30718394	.	T	C	4	0	4	0	6	10	0	0
1	30718463	.	T	A	5	4	9	0	1	10	0	0
1	30718538	.	C	G	12	10	22	0	2	24	0	0
1	30718567	.	A	C	14	0	14	0	11	25	0	0
1	30736716	.	G	T	2	3	5	0	0	5	0	0
1	30736725	.	C	G	2	4	6	0	0	6	0	0
1	30747216	.	C	T	0	2	2	0	4	6	0	0
1	30955972	.	C	A	3	3	6	0	0	6	0	0
1	31063836	.	T	C	3	3	6	0	0	6	0	0
1	31063923	.	T	C	4	4	8	0	1	9	0	0
1	31063928	.	G	A	5	4	9	0	0	9	0	0
1	31063975	.	G	A	0	5	5	0	3	8	0	0
1	31063982	.	G	A	0	5	5	0	3	8	0	0
1	31064519	.	G	A	2	5	7	0	0	7	0	0
1	31072098	.	T	C	5	2	7	0	0	7	0	0
1	31072589	.	C	T	2	5	7	0	0	7	0	0
1	31072604	.	A	C	5	2	7	0	0	7	0	0
1	31072843	.	C	T	3	3	6	0	1	7	0	0
1	31072863	.	A	G	8	3	11	0	0	11	0	0
1	31075158	.	C	T	1	3	4	0	5	9	0	0
1	31083271	.	G	A	3	4	7	0	0	7	0	0
1	31085882	.	C	T	2	3	5	0	0	5	0	0
1	31091473	.	C	T	3	5	8	0	0	8	0	0
1	31112466	.	G	C	0	2	2	0	1	3	0	0
1	31112468	.	G	A	1	2	3	0	0	3	0	0
1	31117686	.	G	A	19	9	28	0	2	30	0	0
1	31117695	.	T	C	22	9	31	0	2	33	0	0
1	31119296	.	C	T	22	20	42	0	1	43	0	0
1	31122596	.	G	A	21	23	44	0	4	48	0	0
1	31130005	.	T	C	22	23	45	0	0	45	0	0
1	31130028	.	T	C	16	29	45	0	0	45	0	0
1	31130094	.	G	A	2	17	19	0	16	35	0	0
1	31130176	.	T	C	8	6	14	0	0	14	0	0
1	31136018	.	G	A	6	4	10	0	0	10	0	0
1	31136477	.	A	G	5	10	15	0	0	15	0	0
1	31146286	.	G	A	1	3	4	0	0	4	0	0
1	31374780	.	A	T	12	6	18	0	3	21	0	0
1	31386255	.	T	C	8	4	12	0	0	12	0	0
1	31423014	.	C	T	2	7	9	0	9	18	0	0
1	31423099	.	G	T	5	4	9	0	1	10	0	0
1	31428150	.	G	A	4	6	10	0	0	10	0	0
1	31445874	.	T	A	1	1	2	0	1	3	0	0
1	31446226	.	C	T	0	2	2	0	2	4	0	0
1	31472033	.	A	G	5	4	9	0	0	9	0	0
1	31657604	.	T	C	5	4	9	0	1	10	0	0
1	31661165	.	T	C	2	2	4	0	0	4	0	0
1	31664892	.	C	T	5	2	7	0	0	7	0	0
1	31667491	.	C	T	4	3	7	0	1	8	0	0
1	31671721	.	C	T	4	3	7	0	0	7	0	0
1	31671746	.	C	A	5	2	7	0	2	9	0	0
1	31671958	.	G	A	0	8	8	0	6	14	0	0
1	31793920	.	A	G	1	0	1	0	6	7	0	0
1	31793998	.	A	G	2	6	8	1	1	10	0	0
1	31797386	.	A	G	3	4	7	0	1	8	0	0
1	31797459	.	G	A	3	3	6	0	1	7	0	0
1	31797488	.	C	T	2	3	5	0	0	5	0	0
1	31797503	.	G	A	0	1	1	0	6	7	0	0
1	31797533	.	C	T	3	2	5	0	0	5	0	0
1	31797597	.	G	A	1	6	7	0	1	8	0	0
1	31798794	.	T	C	2	5	7	0	1	8	0	0
1	31798821	.	C	T	1	3	4	0	3	7	0	0
1	31798980	.	C	T	2	5	7	0	1	8	0	0
1	31799112	.	C	A	3	8	11	0	0	11	0	0
1	31799185	.	T	A	1	4	5	0	0	5	0	0
1	31809332	.	G	A	7	3	10	0	1	11	0	0
1	31809496	.	G	A	12	3	15	0	0	15	0	0
1	31813229	.	A	G	10	9	19	0	1	20	0	0
1	31813283	.	A	G	6	6	12	0	2	14	0	0
1	31813355	.	T	C	7	5	12	0	0	12	0	0
1	31818237	.	G	A	6	7	13	0	0	13	0	0
1	31856632	.	A	G	1	3	4	1	0	5	0	0
1	31865172	.	G	A	2	7	9	0	2	11	0	0
1	31865387	.	G	A	7	4	11	0	0	11	0	0
1	31866684	.	G	A	10	10	20	0	0	20	0	0
1	31867264	.	T	A	9	10	19	0	4	23	0	0
1	31867314	.	C	T	12	11	23	0	0	24	1	0
1	31867449	.	C	T	13	7	20	0	1	21	0	0
1	32385476	.	A	G	2	0	2	0	2	4	0	0
1	33355834	.	T	G	3	4	7	0	0	7	0	0
1	33355989	.	C	T	4	3	7	0	0	7	0	0
1	33356004	.	C	T	3	2	5	0	2	7	0	0
1	33356259	.	A	T	7	1	8	0	1	9	0	0
1	33356268	.	G	A	2	2	4	0	3	7	0	0
1	33356398	.	T	C	2	3	5	0	0	5	0	0
1	33384062	.	G	A	8	6	14	0	1	15	0	0
1	33449334	.	C	A	10	4	14	0	3	17	0	0
1	33457733	.	C	T	8	7	15	0	1	16	0	0
1	33484129	.	C	G	9	8	17	0	0	17	0	0
1	33484288	.	T	C	14	9	23	0	1	24	0	0
1	33484293	.	C	A	12	9	21	0	0	21	0	0
1	33484404	.	C	T	11	8	19	0	1	20	0	0
1	33484652	.	T	C	16	11	27	0	2	29	0	0
1	33485692	.	A	G	10	1	11	0	19	30	0	0
1	33556056	.	G	A	2	5	7	0	1	8	0	0
1	33561520	.	A	G	9	0	9	0	10	19	0	0
1	33561544	.	C	T	11	8	19	0	0	19	0	0
1	33568153	.	A	T	5	20	25	0	1	26	0	0
1	33568211	.	A	G	4	0	4	0	16	20	0	0
1	33568303	.	G	A	1	5	6	0	7	13	0	0
1	33568454	.	G	T	6	7	13	0	0	13	0	0
1	33568520	.	G	A	8	13	21	0	2	23	0	0
1	33568836	.	T	G	0	20	20	1	1	22	0	0
1	33568976	.	G	T	0	13	13	0	11	24	0	0
1	33656317	.	A	T	1	4	5	0	0	5	0	0
1	33657793	.	A	G	5	3	8	0	0	8	0	0
1	33657904	.	G	A	1	3	4	0	7	11	0	0
1	33658030	.	G	A	0	4	4	0	4	8	0	0
1	33658065	.	T	G	4	3	7	0	0	7	0	0
1	33658669	.	A	G	4	1	5	0	1	6	0	0
1	33658852	.	C	A	6	4	10	0	0	10	0	0
1	33658945	.	C	T	10	5	15	0	0	15	0	0
1	33658971	.	C	T	6	9	15	0	0	15	0	0
1	33659374	.	C	T	6	8	14	0	1	15	0	0
1	33686477	.	G	A	8	6	14	0	1	15	0	0
1	33686513	.	G	T	9	11	20	0	0	20	0	0
1	33687177	.	A	T	13	6	19	0	0	19	0	0
1	33693919	.	C	A	6	2	8	0	0	8	0	0
1	33694165	.	A	T	6	3	9	0	1	10	0	0
1	33694198	.	T	A	3	5	8	0	1	9	0	0
1	33694327	.	C	T	10	11	21	0	0	21	0	0
1	33694357	.	T	A	10	13	23	0	0	23	0	0
1	33694517	.	T	A	5	5	10	0	1	11	0	0
1	33694573	.	T	C	5	5	10	0	0	10	0	0
1	33701368	.	C	T	1	6	7	0	0	7	0	0
1	33701445	.	C	T	3	3	6	0	0	6	0	0
1	34043394	.	T	C	3	3	6	0	1	8	1	0
1	34134691	.	G	A	1	2	3	0	4	7	0	0
1	34137711	.	T	C	4	3	7	0	2	9	0	0
1	34137741	.	T	C	3	4	7	0	0	7	0	0
1	34137768	.	A	C	3	3	6	0	2	8	0	0
1	34176504	.	C	T	1	4	5	0	0	5	0	0
1	34176808	.	A	T	7	3	10	0	0	10	0	0
1	34182333	.	C	T	9	7	16	0	2	19	1	0
1	34199906	.	G	T	27	15	42	0	0	42	0	0
1	34199913	.	C	T	26	18	44	0	2	46	0	0
1	34232514	.	G	A	3	3	6	0	0	6	0	0
1	34232551	.	A	C	9	4	13	0	0	13	0	0
1	34232744	.	T	A	10	15	25	0	0	25	0	0
1	34232761	.	A	G	12	13	25	0	1	26	0	0
1	34232879	.	T	C	13	6	19	0	1	20	0	0
1	34232929	.	C	T	14	9	23	0	0	23	0	0
1	34232931	.	G	A	13	8	21	0	2	23	0	0
1	34233096	.	C	A	15	8	23	0	2	25	0	0
1	34233145	.	G	T	9	13	22	0	0	22	0	0
1	34233198	.	C	A	8	10	18	0	0	18	0	0
1	34233238	.	A	G	10	7	17	0	0	17	0	0
1	34233301	.	A	G	9	0	9	0	8	17	0	0
1	34233312	.	A	G	11	7	18	0	3	21	0	0
1	34233548	.	T	G	5	7	12	0	1	13	0	0
1	34258077	.	C	A	1	2	3	0	0	3	0	0
1	34258971	.	C	T	5	5	10	0	0	10	0	0
1	34259098	.	C	A	3	5	8	0	0	8	0	0
1	34259411	.	A	T	2	3	5	0	0	5	0	0
1	34259452	.	T	A	6	5	11	0	0	11	0	0
1	34259863	.	T	G	5	3	8	0	0	8	0	0
1	34260583	.	G	T	1	3	4	0	0	4	0	0
1	34260599	.	T	A	2	2	4	0	1	5	0	0
1	34260887	.	A	T	6	8	14	0	2	17	1	0
1	34260914	.	C	T	9	8	17	1	0	18	0	0
1	34261230	.	A	T	14	11	25	0	2	27	0	0
1	34261358	.	A	G	12	0	12	0	20	32	0	0
1	34261393	.	G	A	1	13	14	1	11	26	0	0
1	34261654	.	T	C	11	5	16	0	1	17	0	0
1	34296606	.	A	T	14	9	23	0	0	23	0	0
1	34297112	.	C	A	11	11	22	0	3	25	0	0
1	34297135	.	C	T	17	6	23	0	1	24	0	0
1	34297336	.	T	A	3	6	9	0	0	9	0	0
1	34540552	.	C	G	3	0	3	0	5	8	0	0
1	34540564	.	G	A	0	4	4	0	2	6	0	0
1	34555559	.	C	T	9	4	13	0	0	13	0	0
1	34556148	.	T	A	3	3	6	0	0	6	0	0
1	34556241	.	A	C	5	4	9	0	0	9	0	0
1	34556298	.	G	A	0	6	6	0	6	12	0	0
1	34556301	.	G	T	1	7	8	0	6	14	0	0
1	34607543	.	C	T	1	2	3	0	0	3	0	0
1	34679431	.	A	G	4	2	6	0	0	6	0	0
1	34683302	.	C	T	1	3	4	0	0	4	0	0
1	34685529	.	C	G	5	2	7	0	0	7	0	0
1	34685603	.	A	G	9	4	13	0	0	13	0	0
1	34695423	.	G	A	7	9	16	0	0	16	0	0
1	34695476	.	G	A	11	8	19	0	0	19	0	0
1	34696017	.	G	A	11	5	16	0	0	16	0	0
1	34703048	.	T	A	13	11	24	0	0	24	0	0
1	34703272	.	A	G	22	12	34	0	0	34	0	0
1	34706526	.	G	A	12	9	21	0	1	22	0	0
1	34707958	.	T	C	11	10	21	0	4	25	0	0
1	34708145	.	C	T	5	24	29	0	29	58	0	0
1	34712097	.	A	G	25	32	57	1	9	67	0	0
1	34713763	.	T	A	1	2	3	0	0	3	0	0
1	34806975	.	A	T	5	2	7	2	0	9	0	0
1	35212086	.	A	G	1	3	4	1	0	5	0	0
1	35232521	.	A	C	4	9	13	0	0	13	0	0
1	35232834	.	C	A	3	1	4	0	1	5	0	0
1	35481768	.	T	C	3	5	8	0	0	8	0	0
1	35481777	.	G	A	2	4	6	0	1	7	0	0
1	35484358	.	C	T	4	4	8	0	0	8	0	0
1	35485056	.	G	A	5	3	8	0	2	10	0	0
1	35485105	.	G	A	0	4	4	0	6	10	0	0
1	35485263	.	C	A	1	3	4	0	0	4	0	0
1	35485289	.	C	T	2	2	4	0	1	5	0	0
1	35485378	.	C	T	4	9	13	0	0	13	0	0
1	35488211	.	A	T	10	11	21	0	0	21	0	0
1	35488332	.	G	A	4	5	9	0	0	9	0	0
1	35488632	.	A	C	4	2	6	0	0	6	0	0
1	35597542	.	A	G	2	1	3	0	1	4	0	0
1	35607830	.	G	A	2	3	5	0	0	5	0	0
1	35608041	.	G	A	0	6	6	0	5	11	0	0
1	35608308	.	C	T	2	3	5	0	0	5	0	0
1	35608405	.	G	A	1	2	3	0	1	4	0	0
1	35608619	.	T	C	5	3	8	0	1	9	0	0
1	35608941	.	A	C	4	4	8	0	0	8	0	0
1	35609192	.	A	G	5	6	11	0	0	11	0	0
1	35609431	.	T	C	8	6	14	0	1	15	0	0
1	35609474	.	G	A	6	3	9	0	0	9	0	0
1	35811779	.	C	A	2	1	3	0	1	4	0	0
1	35812128	.	T	C	3	3	6	0	1	7	0	0
1	35812155	.	T	C	3	5	8	0	1	9	0	0
1	35815706	.	A	C	1	2	3	0	1	4	0	0
1	35834307	.	T	A	4	4	8	0	0	8	0	0
1	35834554	.	G	T	2	6	8	0	0	8	0	0
1	35835125	.	T	G	3	1	4	0	8	12	0	0
1	35835237	.	G	A	0	11	11	0	8	19	0	0
1	35835371	.	A	C	13	12	25	0	0	25	0	0
1	35835502	.	C	T	8	12	20	0	0	20	0	0
1	35898075	.	G	A	2	2	4	0	0	4	0	0
1	35949969	.	C	A	5	4	9	0	0	9	0	0
1	35950082	.	T	G	4	6	10	0	0	10	0	0
1	35950100	.	T	G	5	6	11	0	2	13	0	0
1	35950145	.	A	C	4	4	8	0	1	9	0	0
1	35956508	.	C	G	3	3	6	0	0	6	0	0
1	35956549	.	C	T	5	2	7	0	2	9	0	0
1	35959826	.	T	C	11	4	15	0	1	16	0	0
1	35962990	.	C	T	7	8	15	0	0	15	0	0
1	35963306	.	G	A	0	11	11	0	11	22	0	0
1	35969716	.	G	A	20	7	27	0	0	27	0	0
1	35969836	.	G	C	9	15	24	0	1	25	0	0
1	35969878	.	C	T	17	13	30	0	1	31	0	0
1	36018610	.	T	A	9	10	19	0	1	20	0	0
1	36018817	.	T	C	9	0	9	0	14	23	0	0
1	36019227	.	C	T	11	13	24	0	0	24	0	0
1	36019361	.	T	C	13	2	15	0	20	35	0	0
1	36019416	.	G	T	20	9	29	0	1	30	0	0
1	36020092	.	A	T	3	3	6	0	2	8	0	0
1	36020154	.	T	C	3	9	12	0	0	12	0	0
1	36020492	.	T	G	7	5	12	0	2	14	0	0
1	36020642	.	T	A	12	7	19	0	1	20	0	0
1	36021110	.	G	A	5	5	10	0	2	12	0	0
1	36021158	.	C	G	7	4	11	0	1	12	0	0
1	36021399	.	A	G	18	11	29	0	3	32	0	0
1	36036829	.	G	A	3	3	6	0	0	6	0	0
1	36057147	.	G	A	1	6	7	0	0	7	0	0
1	36057303	.	A	G	2	3	5	0	1	6	0	0
1	36057306	.	C	T	3	3	6	0	0	6	0	0
1	36105117	.	C	T	0	4	4	0	3	7	0	0
1	36194799	.	G	T	2	10	12	0	14	27	1	0
1	36200014	.	C	T	15	10	25	1	2	28	0	0
1	36438671	.	T	A	15	15	30	0	3	33	0	0
1	36438882	.	T	A	13	15	28	0	0	29	1	0
1	36439186	.	T	A	19	18	37	0	1	38	0	0
1	36439204	.	G	T	18	15	33	0	1	34	0	0
1	36439248	.	G	A	15	14	29	0	1	30	0	0
1	36439380	.	G	T	18	19	37	1	1	39	0	0
1	36701999	.	C	T	7	8	15	0	2	17	0	0
1	36735144	.	G	A	0	2	2	0	1	3	0	0
1	36738356	.	C	T	3	3	6	0	0	6	0	0
1	36738459	.	G	A	0	4	4	0	1	5	0	0
1	36738574	.	C	A	1	2	3	0	0	3	0	0
1	36738595	.	A	T	1	3	4	0	1	5	0	0
1	36738747	.	T	A	1	3	4	0	0	4	0	0
1	36738810	.	C	T	2	4	6	0	0	6	0	0
1	36739086	.	A	T	2	2	4	0	0	4	0	0
1	36739104	.	C	T	3	2	5	0	0	5	0	0
1	36739124	.	G	A	0	2	2	0	5	7	0	0
1	36740324	.	G	C	1	2	3	0	0	3	0	0
1	36740359	.	C	A	4	3	7	0	0	7	0	0
1	36740365	.	T	G	4	3	7	0	0	7	0	0
1	36740468	.	T	A	1	3	4	0	0	4	0	0
1	36740764	.	C	A	5	4	9	0	0	9	0	0
1	36740961	.	G	T	0	8	8	0	4	12	0	0
1	36740995	.	G	C	6	3	9	0	1	10	0	0
1	36741087	.	T	A	9	9	18	0	1	19	0	0
1	36741110	.	G	T	6	14	20	0	0	20	0	0
1	36741396	.	T	G	8	3	11	0	1	12	0	0
1	36741493	.	A	G	8	3	11	0	0	11	0	0
1	36741499	.	T	A	8	3	11	0	1	12	0	0
1	36741537	.	A	C	9	5	14	0	0	14	0	0
1	36741581	.	C	T	9	9	18	1	0	19	0	0
1	36741602	.	A	C	10	5	15	1	0	16	0	0
1	36741642	.	T	C	8	6	14	1	0	15	0	0
1	36741761	.	A	T	7	3	10	0	2	12	0	0
1	36741796	.	T	G	9	6	15	0	1	16	0	0
1	36741863	.	A	C	9	4	13	0	0	14	1	0
1	36742074	.	G	C	4	1	5	0	1	6	0	0
1	36742075	.	G	A	4	2	6	0	0	6	0	0
1	36746225	.	A	T	5	2	7	0	0	7	0	0
1	36755165	.	G	T	4	4	8	0	0	8	0	0
1	36763718	.	T	G	2	3	5	0	0	5	0	0
1	36769270	.	G	A	2	1	3	0	0	3	0	0
1	36769288	.	C	T	0	2	2	0	2	4	0	0
1	36887811	.	C	A	3	2	5	0	0	5	0	0
1	36887880	.	C	A	6	7	13	0	0	13	0	0
1	36903175	.	T	A	4	4	8	0	0	8	0	0
1	36911491	.	A	C	4	3	7	0	0	7	0	0
1	36911647	.	A	T	0	1	1	0	2	3	0	0
1	36911788	.	G	A	0	4	4	0	2	6	0	0
1	36911932	.	C	G	4	7	11	0	0	11	0	0
1	36912176	.	G	A	5	8	13	0	0	13	0	0
1	36938228	.	T	G	2	2	4	0	0	4	0	0
1	36963429	.	T	A	2	6	8	0	1	9	0	0
1	37087725	.	G	C	1	2	3	0	0	3	0	0
1	37284382	.	C	T	1	8	9	0	0	9	0	0
1	37291884	.	A	C	8	5	13	0	0	13	0	0
1	37304354	.	C	A	15	10	25	0	0	25	0	0
1	37304439	.	C	T	6	8	14	0	0	14	0	0
1	37304870	.	T	A	10	2	12	0	1	13	0	0
1	37305148	.	C	T	6	6	12	0	1	13	0	0
1	37306726	.	G	T	1	15	16	0	14	30	0	0
1	37306913	.	T	A	16	17	33	0	0	33	0	0
1	37306942	.	A	C	19	17	36	0	0	36	0	0
1	37353355	.	C	T	6	3	9	0	0	9	0	0
1	37355591	.	G	A	3	3	6	0	1	7	0	0
1	37355606	.	C	T	3	2	5	0	0	5	0	0
1	37359071	.	C	T	8	4	12	0	0	12	0	0
1	37359221	.	G	C	3	8	11	0	0	11	0	0
1	37359352	.	A	G	3	8	11	0	2	13	0	0
1	37361554	.	A	G	12	6	18	0	0	18	0	0
1	37361759	.	C	T	9	8	17	0	0	18	1	0
1	37361879	.	T	A	7	4	11	0	1	12	0	0
1	37361919	.	T	C	3	6	9	0	1	10	0	0
1	37361960	.	C	T	2	5	7	0	0	7	0	0
1	37752392	.	A	G	4	0	4	0	3	7	0	0
1	38125431	.	C	A	7	16	23	0	2	25	0	0
1	38125684	.	T	C	13	13	26	0	0	26	0	0
1	38131058	.	C	T	17	12	29	0	0	29	0	0
1	38131073	.	T	C	12	16	28	0	0	28	0	0
1	38131094	.	G	A	15	12	27	0	2	29	0	0
1	38131288	.	G	A	21	12	33	0	1	34	0	0
1	38131360	.	G	A	25	24	49	0	2	51	0	0
1	38131486	.	G	A	19	13	32	0	6	38	0	0
1	38132103	.	T	A	1	1	2	0	2	4	0	0
1	38132105	.	G	A	2	2	4	0	0	4	0	0
1	38146192	.	G	T	5	2	7	0	0	7	0	0
1	38163017	.	C	T	13	10	23	0	3	26	0	0
1	38163132	.	G	A	21	8	29	0	1	30	0	0
1	38166009	.	G	C	14	9	23	0	0	23	0	0
1	38166268	.	A	C	9	20	29	0	2	31	0	0
1	38166429	.	T	C	16	19	35	0	4	39	0	0
1	38166431	.	T	G	18	18	36	0	2	38	0	0
1	38166520	.	A	G	21	21	42	0	0	42	0	0
1	38169771	.	T	A	25	8	33	0	2	35	0	0
1	38169972	.	T	G	15	14	29	0	2	31	0	0
1	38170553	.	G	A	18	17	35	0	1	36	0	0
1	38346162	.	C	T	0	5	5	2	10	17	0	0
1	38346475	.	C	T	1	3	4	0	1	5	0	0
1	38346578	.	G	T	5	7	12	0	1	13	0	0
1	38346739	.	G	A	5	6	11	0	0	11	0	0
1	38354049	.	G	A	3	3	6	0	1	7	0	0
1	38374317	.	G	A	4	6	10	0	1	11	0	0
1	38416352	.	G	C	4	4	8	0	0	8	0	0
1	38416477	.	G	A	7	5	12	0	0	12	0	0
1	38416536	.	A	G	8	3	11	0	0	11	0	0
1	38417116	.	A	T	1	3	4	0	0	4	0	0
1	38417229	.	G	A	2	3	5	0	2	7	0	0
1	38417268	.	A	T	5	7	12	0	1	13	0	0
1	38417332	.	A	G	6	7	13	0	0	13	0	0
1	38417370	.	G	A	8	6	14	0	0	14	0	0
1	38417531	.	G	T	7	9	16	0	0	16	0	0
1	38417571	.	G	T	5	8	13	0	0	13	0	0
1	38417588	.	T	G	7	4	11	0	0	11	0	0
1	38417757	.	G	A	2	2	4	0	0	4	0	0
1	38417758	.	T	C	2	2	4	0	0	4	0	0
1	38418087	.	C	T	3	5	8	0	1	9	0	0
1	38418243	.	A	G	3	5	8	0	0	8	0	0
1	38418294	.	G	T	4	5	9	0	0	9	0	0
1	38466714	.	G	A	3	2	5	0	0	5	0	0
1	38649340	.	A	G	36	31	67	0	3	70	0	0
1	38649947	.	G	A	35	36	71	0	3	74	0	0
1	38650132	.	G	T	30	31	61	0	5	67	1	0
1	38650298	.	G	A	26	27	53	0	2	55	0	0
1	38650382	.	G	C	29	31	60	0	5	66	1	0
1	38650467	.	A	G	22	39	61	0	7	68	0	0
1	38650510	.	G	C	31	35	66	0	2	68	0	0
1	38650516	.	T	C	33	37	70	0	1	71	0	0
1	38650545	.	T	C	40	30	70	0	2	72	0	0
1	38651063	.	G	T	40	25	65	0	1	66	0	0
1	38651065	.	T	A	37	25	62	0	6	68	0	0
1	38651361	.	C	T	13	13	26	0	1	27	0	0
1	38651370	.	G	A	12	13	25	0	3	28	0	0
1	38651469	.	C	A	16	17	33	0	5	38	0	0
1	38655522	.	C	T	2	22	24	1	32	57	0	0
1	38657689	.	G	A	30	19	49	0	2	51	0	0
1	38660240	.	T	C	27	0	27	0	13	40	0	0
1	38660252	.	A	G	29	13	42	0	3	45	0	0
1	38660369	.	G	A	19	13	32	0	3	35	0	0
1	38709480	.	G	A	4	2	6	0	1	7	0	0
1	38709535	.	T	A	6	2	8	0	1	9	0	0
1	38787039	.	C	T	4	2	6	0	0	6	0	0
1	38791569	.	C	T	6	8	14	0	1	15	0	0
1	38797663	.	A	C	10	7	17	0	1	18	0	0
1	38799513	.	G	A	7	11	18	0	2	20	0	0
1	38799585	.	A	G	14	8	22	0	0	22	0	0
1	38799588	.	T	A	8	14	22	0	0	22	0	0
1	38802537	.	G	A	8	8	16	0	1	17	0	0
1	38802703	.	A	G	15	8	23	0	1	24	0	0
1	38802718	.	G	A	12	16	28	0	1	29	0	0
1	38802747	.	A	G	11	0	11	0	12	23	0	0
1	38802855	.	C	A	7	12	19	0	0	19	0	0
1	38803033	.	T	C	9	3	12	0	1	13	0	0
1	38803042	.	A	C	8	3	11	0	1	12	0	0
1	38803092	.	C	T	3	4	7	0	1	8	0	0
1	38803127	.	C	T	5	11	16	0	1	17	0	0
1	38803154	.	T	A	9	10	19	0	2	21	0	0
1	38803205	.	A	T	11	10	21	0	1	22	0	0
1	38803404	.	A	G	8	13	21	0	0	21	0	0
1	38805128	.	G	T	6	8	14	0	2	16	0	0
1	38805135	.	C	T	7	8	15	0	2	17	0	0
1	38805439	.	G	A	13	18	31	0	2	33	0	0
1	38805450	.	A	G	15	15	30	0	1	31	0	0
1	38805506	.	G	A	14	10	24	0	3	27	0	0
1	38807255	.	G	C	10	7	17	1	1	19	0	0
1	38808259	.	C	A	6	6	12	0	0	12	0	0
1	38808379	.	C	T	0	9	9	0	12	21	0	0
1	38808723	.	T	A	9	5	14	0	1	15	0	0
1	38820219	.	G	A	0	10	10	0	10	20	0	0
1	38822092	.	A	T	8	4	12	0	0	12	0	0
1	38851111	.	C	T	0	5	5	0	4	9	0	0
1	38851225	.	C	T	4	4	8	0	1	9	0	0
1	39639723	.	C	T	1	2	3	0	0	3	0	0
1	39724761	.	G	A	2	2	4	0	0	4	0	0
1	39732544	.	C	T	4	2	6	0	1	7	0	0
1	39735491	.	T	C	2	4	6	0	0	6	0	0
1	39771429	.	T	A	5	7	12	0	0	12	0	0
1	39772010	.	T	C	9	5	14	0	1	15	0	0
1	39772042	.	A	G	8	4	12	0	0	12	0	0
1	39772135	.	C	A	9	7	16	0	2	18	0	0
1	39772225	.	C	T	10	6	16	0	1	17	0	0
1	39774096	.	C	T	5	8	13	0	0	13	0	0
1	39774225	.	C	T	7	5	12	0	0	12	0	0
1	39774363	.	G	A	5	8	13	0	2	15	0	0
1	39774618	.	A	G	6	4	10	0	3	13	0	0
1	39774690	.	A	G	9	8	17	0	1	18	0	0
1	39774727	.	C	A	4	12	16	0	1	17	0	0
1	39774891	.	C	T	10	12	22	0	0	22	0	0
1	39774915	.	G	A	15	10	25	0	0	25	0	0
1	39775089	.	C	T	10	12	22	0	4	26	0	0
1	39775131	.	C	T	14	13	27	0	1	28	0	0
1	39775227	.	C	T	10	14	24	0	1	25	0	0
1	39776356	.	A	C	20	16	36	0	1	37	0	0
1	39777089	.	G	A	13	18	31	0	2	33	0	0
1	39777836	.	G	A	1	13	14	0	15	29	0	0
1	39777975	.	A	T	20	11	31	0	1	32	0	0
1	39778047	.	A	G	13	0	13	0	12	25	0	0
1	39778075	.	T	G	12	12	24	0	0	24	0	0
1	39778332	.	G	C	24	27	51	0	1	52	0	0
1	39778661	.	G	A	15	12	27	0	0	27	0	0
1	39778663	.	G	A	14	12	26	0	1	27	0	0
1	39778949	.	G	C	25	17	42	0	1	43	0	0
1	39779225	.	G	C	12	14	26	0	1	27	0	0
1	39779468	.	A	T	7	8	15	0	0	15	0	0
1	39779518	.	T	G	9	5	14	0	1	15	0	0
1	39869860	.	T	A	4	5	9	0	1	10	0	0
1	39869917	.	T	A	4	4	8	0	1	9	0	0
1	39869974	.	G	A	2	2	4	0	0	4	0	0
1	39870008	.	T	C	4	3	7	0	1	8	0	0
1	39882764	.	A	T	3	4	7	0	0	8	1	0
1	39882906	.	T	A	2	10	12	0	1	13	0	0
1	39899477	.	G	C	21	20	41	0	4	45	0	0
1	39899494	.	A	G	26	23	49	0	2	51	0	0
1	39899663	.	G	A	27	19	46	0	1	47	0	0
1	39900056	.	G	A	32	19	51	0	2	53	0	0
1	39900129	.	G	A	19	25	44	0	1	45	0	0
1	39900137	.	G	T	23	21	44	0	1	45	0	0
1	39900360	.	G	A	11	9	20	0	0	20	0	0
1	39900432	.	C	T	2	16	18	0	9	27	0	0
1	39900750	.	C	T	1	11	12	0	12	24	0	0
1	39901269	.	G	A	8	3	11	0	1	12	0	0
1	39901378	.	T	A	11	6	17	0	1	18	0	0
1	39901500	.	T	C	12	6	18	0	0	18	0	0
1	39901501	.	G	A	11	6	17	0	1	18	0	0
1	39901729	.	T	C	16	1	17	0	11	28	0	0
1	39907291	.	A	C	4	5	9	0	0	9	0	0
1	39907492	.	T	C	15	0	15	0	8	23	0	0
1	39907611	.	C	T	1	3	4	0	3	7	0	0
1	39908047	.	G	A	10	7	17	0	1	18	0	0
1	39908680	.	C	T	5	7	12	0	0	12	0	0
1	39908854	.	A	G	8	10	18	0	1	19	0	0
1	39908881	.	C	T	9	7	16	0	2	18	0	0
1	39909003	.	A	T	6	9	15	0	0	15	0	0
1	39909247	.	A	T	6	8	14	0	2	16	0	0
1	39909274	.	A	T	6	9	15	0	0	15	0	0
1	39981794	.	A	G	7	2	9	0	0	9	0	0
1	39995100	.	C	T	5	4	9	0	1	10	0	0
1	39998875	.	G	A	8	4	12	0	0	12	0	0
1	40001853	.	A	T	10	7	17	0	1	18	0	0
1	40001873	.	C	A	7	7	14	0	1	15	0	0
1	40002113	.	G	A	11	8	19	0	0	19	0	0
1	40002148	.	C	G	14	4	18	0	0	18	0	0
1	40008905	.	T	C	21	18	39	0	1	40	0	0
1	40008906	.	G	A	21	18	39	0	0	40	1	0
1	40009227	.	T	A	14	18	32	0	0	32	0	0
1	40009258	.	C	T	16	8	24	0	4	28	0	0
1	40009291	.	A	G	21	6	27	0	0	27	0	0
1	40009382	.	G	A	17	17	34	0	0	34	0	0
1	40009526	.	T	C	7	10	17	0	0	17	0	0
1	40009625	.	T	C	3	6	9	0	2	11	0	0
1	40009671	.	C	A	13	8	21	0	1	22	0	0
1	40009697	.	C	T	8	10	18	0	1	19	0	0
1	40015189	.	A	G	6	10	16	0	0	16	0	0
1	40015219	.	C	T	10	8	18	0	0	18	0	0
1	40015265	.	C	T	0	8	8	0	11	19	0	0
1	40015553	.	A	G	4	9	13	0	1	14	0	0
1	40015697	.	A	G	5	7	12	0	0	12	0	0
1	40027564	.	C	A	1	3	4	0	0	4	0	0
1	40028568	.	G	T	3	2	5	0	0	5	0	0
1	40028613	.	G	A	2	2	4	0	1	5	0	0
1	40028637	.	C	T	4	3	7	0	0	7	0	0
1	40028680	.	G	A	4	2	6	0	1	7	0	0
1	40041528	.	C	T	3	6	9	0	2	11	0	0
1	40042241	.	G	A	3	2	5	0	2	7	0	0
1	40044175	.	G	C	1	7	8	0	0	8	0	0
1	40044562	.	G	A	7	2	9	0	0	9	0	0
1	40044578	.	C	T	4	5	9	0	1	10	0	0
1	40046859	.	G	A	6	3	9	0	1	10	0	0
1	40047070	.	T	A	5	10	15	0	2	17	0	0
1	40051918	.	T	C	6	6	12	0	2	14	0	0
1	40051923	.	G	C	4	8	12	0	3	15	0	0
1	40051988	.	G	C	0	13	13	0	7	20	0	0
1	40052033	.	A	G	10	8	18	0	2	20	0	0
1	40052066	.	G	C	12	8	20	0	0	20	0	0
1	40052083	.	G	A	12	10	22	0	2	24	0	0
1	40052481	.	A	C	9	10	19	0	0	19	0	0
1	40052550	.	A	C	6	10	16	0	1	17	0	0
1	40052562	.	A	G	5	8	13	0	0	13	0	0
1	40052965	.	T	A	4	6	10	0	1	11	0	0
1	40057604	.	A	G	5	4	9	0	0	9	0	0
1	40057655	.	C	T	7	5	12	0	0	12	0	0
1	40057805	.	C	T	2	10	12	0	1	13	0	0
1	40060836	.	T	A	3	4	7	0	0	7	0	0
1	40060860	.	T	C	2	5	7	0	0	7	0	0
1	40060968	.	A	C	2	4	6	0	0	6	0	0
1	40060992	.	C	T	0	4	4	0	3	7	0	0
1	40061061	.	C	T	1	5	6	0	2	8	0	0
1	40061169	.	G	A	2	7	9	0	3	12	0	0
1	40061285	.	C	T	11	5	16	0	0	16	0	0
1	40062593	.	T	G	1	2	3	0	0	3	0	0
1	40107961	.	C	T	3	4	7	0	0	8	1	0
1	40111679	.	C	G	9	14	23	0	4	27	0	0
1	40111702	.	T	G	13	15	28	0	1	29	0	0
1	40111737	.	A	C	12	16	28	0	1	29	0	0
1	40111738	.	G	A	12	15	27	0	2	29	0	0
1	40111776	.	C	T	15	6	21	0	3	24	0	0
1	40111918	.	C	T	17	17	34	0	1	35	0	0
1	40112206	.	T	C	9	3	12	0	6	18	0	0
1	40112347	.	C	T	6	9	15	0	0	15	0	0
1	40112410	.	C	T	9	7	16	0	6	22	0	0
1	40112510	.	T	C	8	6	14	0	0	14	0	0
1	40112760	.	T	A	8	13	21	0	0	21	0	0
1	40112822	.	A	T	16	13	29	2	0	31	0	0
1	40112837	.	C	T	13	11	24	2	3	29	0	0
1	40112869	.	C	T	16	13	29	1	1	31	0	0
1	40112879	.	A	G	14	12	26	1	2	29	0	0
1	40112938	.	G	C	9	13	22	0	1	23	0	0
1	40113008	.	A	T	1	6	7	0	0	7	0	0
1	40113272	.	G	C	4	4	8	0	1	9	0	0
1	40113314	.	A	G	3	0	3	0	4	7	0	0
1	40113374	.	T	A	6	4	10	0	0	10	0	0
1	40113486	.	A	G	2	2	4	0	0	4	0	0
1	40113833	.	T	C	1	2	3	0	0	3	0	0
1	40114155	.	T	A	5	4	9	0	0	9	0	0
1	40114326	.	C	T	3	3	6	0	0	6	0	0
1	40114527	.	T	A	2	2	4	0	0	4	0	0
1	40115018	.	A	T	3	7	10	0	0	10	0	0
1	40115065	.	T	C	2	8	10	0	0	10	0	0
1	40116747	.	G	A	6	5	11	0	1	12	0	0
1	40116823	.	C	T	1	3	4	0	4	8	0	0
1	40116889	.	G	A	0	2	2	0	1	3	0	0
1	40116946	.	C	T	3	4	7	0	10	17	0	0
1	40117345	.	G	A	10	13	23	0	0	23	0	0
1	40123964	.	C	T	0	7	7	0	3	10	0	0
1	40126279	.	T	C	4	2	6	0	1	7	0	0
1	40126281	.	T	G	5	2	7	0	0	7	0	0
1	40210865	.	G	T	7	22	29	0	3	32	0	0
1	40211048	.	C	T	0	4	4	0	8	12	0	0
1	40211065	.	T	C	5	3	8	0	0	8	0	0
1	40211217	.	A	C	5	5	10	0	1	11	0	0
1	40211465	.	T	C	6	0	6	0	7	13	0	0
1	40211645	.	C	G	1	5	6	0	11	17	0	0
1	40212065	.	C	T	10	6	16	0	1	17	0	0
1	40212084	.	C	A	1	8	9	0	8	17	0	0
1	40212305	.	C	T	8	10	18	0	4	22	0	0
1	40221359	.	A	G	1	5	6	0	1	7	0	0
1	40221458	.	A	T	1	5	6	0	0	6	0	0
1	40226289	.	G	A	2	2	4	0	0	4	0	0
1	40226292	.	G	C	2	2	4	0	0	4	0	0
1	40227029	.	T	G	5	4	9	0	0	9	0	0
1	40242922	.	C	A	2	2	4	0	0	4	0	0
1	40248383	.	C	T	4	5	9	0	0	9	0	0
1	40252219	.	T	A	10	13	23	0	0	23	0	0
1	40257577	.	A	G	12	9	21	0	1	22	0	0
1	40257631	.	C	T	12	10	22	0	2	24	0	0
1	40257751	.	C	T	11	7	18	0	2	20	0	0
1	40257834	.	T	G	12	0	12	0	10	22	0	0
1	40258340	.	G	T	3	3	6	0	0	6	0	0
1	40263675	.	C	A	3	7	10	0	0	10	0	0
1	40266618	.	C	T	30	27	57	0	1	58	0	0
1	40270054	.	C	T	27	34	61	0	8	69	0	0
1	40270094	.	G	A	4	21	25	0	34	59	0	0
1	40270095	.	G	A	38	21	59	0	1	60	0	0
1	40336234	.	C	G	3	4	7	0	1	8	0	0
1	40337314	.	C	T	6	6	12	0	1	13	0	0
1	40337464	.	C	A	1	4	5	0	5	10	0	0
1	40340571	.	C	T	7	5	12	0	3	15	0	0
1	40340598	.	C	T	8	5	13	0	0	13	0	0
1	40410608	.	C	T	1	3	4	0	5	9	0	0
1	40410839	.	A	T	6	6	12	0	0	12	0	0
1	40410908	.	C	T	4	2	6	0	0	6	0	0
1	40567094	.	G	A	4	4	8	0	1	9	0	0
1	40568601	.	G	A	9	12	21	0	1	22	0	0
1	40568707	.	A	G	11	0	11	0	6	17	0	0
1	40568883	.	G	A	2	9	11	0	21	32	0	0
1	40568990	.	A	G	16	15	31	0	2	33	0	0
1	40569153	.	C	T	5	10	15	0	0	15	0	0
1	40569168	.	C	T	8	10	18	0	1	19	0	0
1	40569231	.	G	A	14	5	19	0	1	20	0	0
1	40569295	.	A	T	11	12	23	0	1	24	0	0
1	40569386	.	T	A	15	9	24	2	2	28	0	0
1	40569466	.	A	T	16	18	34	0	1	35	0	0
1	40569538	.	G	A	18	9	27	0	2	29	0	0
1	40569548	.	T	C	15	9	24	0	0	24	0	0
1	40573703	.	G	T	13	18	31	0	3	34	0	0
1	40590967	.	T	G	20	23	43	0	0	43	0	0
1	40591262	.	T	C	13	22	35	0	3	38	0	0
1	40591272	.	T	C	14	22	36	0	2	38	0	0
1	40594373	.	C	T	12	14	26	0	0	26	0	0
1	40594415	.	C	T	1	11	12	0	8	20	0	0
1	40594517	.	T	C	10	0	10	1	16	27	0	0
1	40594526	.	G	A	11	16	27	1	0	28	0	0
1	40597332	.	A	C	15	0	15	0	16	31	0	0
1	40600992	.	A	T	4	4	8	0	0	8	0	0
1	40601547	.	G	A	8	6	14	0	1	15	0	0
1	40601595	.	G	C	2	0	2	0	4	6	0	0
1	40618861	.	C	T	6	3	9	0	0	9	0	0
1	40638246	.	A	T	8	9	17	0	0	17	0	0
1	40796779	.	G	T	4	2	6	0	0	6	0	0
1	40796791	.	G	A	1	3	4	0	1	5	0	0
1	40796977	.	C	T	2	2	4	0	1	5	0	0
1	40796985	.	A	T	2	3	5	0	0	5	0	0
1	40992716	.	T	A	7	7	14	0	0	14	0	0
1	40992823	.	A	G	5	9	14	0	0	14	0	0
1	40992878	.	C	G	6	6	12	0	0	12	0	0
1	40993195	.	C	T	9	3	12	0	1	13	0	0
1	40993349	.	C	T	0	7	7	0	9	16	0	0
1	40993714	.	G	A	2	3	5	0	0	5	0	0
1	41131608	.	C	T	7	8	15	1	0	16	0	0
1	41133944	.	G	A	6	4	10	0	1	11	0	0
1	41136245	.	T	C	13	8	21	0	0	21	0	0
1	41138638	.	A	G	10	11	21	0	2	23	0	0
1	41138641	.	C	T	12	10	22	0	2	24	0	0
1	41140465	.	T	C	13	17	30	0	1	31	0	0
1	41140640	.	C	T	17	14	31	0	1	32	0	0
1	41215289	.	T	A	10	8	18	0	2	20	0	0
1	41215312	.	T	G	13	14	27	0	1	28	0	0
1	41215547	.	G	A	13	10	23	0	0	23	0	0
1	41215746	.	T	A	10	11	21	0	1	22	0	0
1	41215868	.	T	G	13	6	19	0	1	20	0	0
1	41215869	.	G	T	6	13	19	0	1	20	0	0
1	41215998	.	T	C	5	6	11	0	1	12	0	0
1	41222341	.	T	C	3	3	6	0	0	6	0	0
1	41230927	.	C	T	2	4	6	0	0	6	0	0
1	41294719	.	A	G	15	10	25	0	1	26	0	0
1	41294760	.	T	C	16	6	22	0	3	25	0	0
1	41294790	.	G	T	14	7	21	0	0	21	0	0
1	41297453	.	C	T	0	10	10	0	10	20	0	0
1	41297495	.	G	A	14	7	21	0	0	21	0	0
1	41297561	.	C	T	9	4	13	0	4	18	1	0
1	41297564	.	A	T	6	10	16	0	2	18	0	0
1	41300133	.	C	T	6	3	9	0	0	9	0	0
1	41309208	.	C	G	2	7	9	0	1	10	0	0
1	41310074	.	A	G	3	4	7	0	2	9	0	0
1	41331692	.	G	A	1	2	3	0	0	3	0	0
1	41470524	.	T	C	20	25	45	0	4	49	0	0
1	41471529	.	T	C	26	20	46	0	5	51	0	0
1	41487459	.	C	A	5	2	7	0	1	8	0	0
1	41487474	.	C	T	2	4	6	0	0	6	0	0
1	41487811	.	C	T	4	5	9	0	0	9	0	0
1	41487960	.	A	T	4	3	7	0	1	8	0	0
1	41487973	.	T	C	5	2	7	0	0	7	0	0
1	41488643	.	A	C	2	3	5	0	0	5	0	0
1	41489068	.	C	T	3	4	7	0	0	7	0	0
1	41489274	.	G	C	3	2	5	0	1	6	0	0
1	41492367	.	A	T	1	4	5	0	0	5	0	0
1	41596291	.	C	T	2	2	4	0	1	5	0	0
1	41600339	.	T	C	4	6	10	0	1	11	0	0
1	41600533	.	A	G	2	3	5	0	0	5	0	0
1	41604931	.	C	G	5	0	5	0	5	10	0	0
1	41604934	.	C	G	5	0	5	0	6	11	0	0
1	41604985	.	G	A	0	9	9	0	6	15	0	0
1	41605011	.	T	C	7	7	14	0	0	14	0	0
1	41605065	.	C	A	5	6	11	0	0	11	0	0
1	41605149	.	T	C	2	5	7	0	0	7	0	0
1	41605203	.	C	T	9	5	14	0	0	14	0	0
1	41605675	.	G	A	2	5	7	0	0	7	0	0
1	41615874	.	C	T	3	2	5	0	0	5	0	0
1	41615904	.	T	C	4	2	6	0	0	6	0	0
1	41615949	.	T	C	7	6	13	0	0	13	0	0
1	41616081	.	T	G	5	6	11	0	0	11	0	0
1	41616186	.	A	C	2	2	4	0	1	5	0	0
1	41730609	.	C	T	5	7	12	0	1	13	0	0
1	41730669	.	G	A	7	5	12	0	0	12	0	0
1	41744103	.	C	T	1	3	4	0	0	4	0	0
1	41755157	.	C	T	11	8	19	0	0	19	0	0
1	41755158	.	A	T	11	8	19	0	0	19	0	0
1	41755195	.	C	T	9	7	16	1	0	17	0	0
1	41770847	.	T	A	10	6	16	0	1	17	0	0
1	41770872	.	T	C	8	7	15	0	0	15	0	0
1	41770959	.	T	C	2	3	5	0	0	5	0	0
1	41849293	.	A	G	9	2	11	0	0	11	0	0
1	41849310	.	A	G	10	6	16	0	1	17	0	0
1	41865471	.	C	T	34	26	60	1	4	65	0	0
1	41949875	.	A	G	1	3	4	0	0	4	0	0
1	41958356	.	C	T	5	3	8	0	0	8	0	0
1	42375005	.	C	A	6	6	12	0	0	12	0	0
1	42375071	.	C	T	1	5	6	0	1	7	0	0
1	42776652	.	T	C	19	19	38	0	5	43	0	0
1	42776787	.	C	T	4	18	22	0	22	44	0	0
1	42776806	.	A	T	27	19	46	0	2	48	0	0
1	42776853	.	T	C	26	16	42	0	1	43	0	0
1	42776906	.	A	G	23	15	38	0	2	40	0	0
1	42777116	.	G	A	21	9	30	0	0	30	0	0
1	42777146	.	C	G	1	7	8	0	20	28	0	0
1	42777383	.	A	G	16	13	29	0	1	30	0	0
1	42777593	.	T	G	16	9	25	0	2	27	0	0
1	42777674	.	G	A	8	6	14	0	0	14	0	0
1	42882955	.	C	T	7	4	11	0	0	11	0	0
1	43023630	.	G	A	9	10	19	0	2	21	0	0
1	43034947	.	C	T	17	16	33	0	1	34	0	0
1	43035178	.	T	C	21	15	36	0	5	41	0	0
1	43035546	.	T	A	10	12	22	0	2	24	0	0
1	43037004	.	G	A	1	2	3	0	0	3	0	0
1	43037016	.	G	A	1	2	3	0	0	3	0	0
1	44228705	.	C	T	12	3	15	0	1	16	0	0
1	44958961	.	G	A	0	2	2	0	4	6	0	0
1	44961107	.	G	C	0	4	4	3	1	8	0	0
1	45015637	.	C	G	1	0	1	0	17	18	0	0
1	45015643	.	A	T	3	1	4	0	14	18	0	0
1	45039566	.	A	G	1	4	5	0	0	5	0	0
1	45094867	.	C	T	1	5	6	0	3	9	0	0
1	45095019	.	T	C	5	5	10	3	0	13	0	0
1	45570224	.	T	A	3	25	28	3	7	38	0	0
1	45699895	.	T	G	5	1	6	0	1	7	0	0
1	45743268	.	A	G	5	0	5	0	3	8	0	0
1	45833542	.	A	G	5	3	8	0	0	8	0	0
1	45868178	.	C	T	15	15	30	38	2	70	0	0
1	47120514	.	A	T	1	4	5	1	1	7	0	0
1	47120622	.	G	C	3	4	7	0	0	7	0	0
1	47120627	.	C	T	3	5	8	0	0	8	0	0
1	47134498	.	G	T	2	7	9	9	0	18	0	0
1	47144971	.	G	T	1	2	3	2	0	5	0	0
1	47159503	.	T	C	8	1	9	0	4	13	0	0
1	47682775	.	T	C	1	2	3	0	0	3	0	0
1	48583000	.	T	C	8	3	11	0	0	11	0	0
1	48583115	.	T	C	2	1	3	0	2	5	0	0
1	49222797	.	T	C	1	1	2	0	3	5	0	0
1	49271317	.	G	A	17	26	43	0	0	43	0	0
1	49289729	.	C	G	33	1	34	0	28	62	0	0
1	49293808	.	T	C	10	23	33	0	2	35	0	0
1	49293954	.	C	T	27	15	42	0	1	43	0	0
1	49294032	.	A	T	16	18	34	0	1	35	0	0
1	49294686	.	A	G	6	16	22	0	3	25	0	0
1	49418122	.	T	C	3	3	6	0	0	6	0	0
1	49418156	.	T	C	2	4	6	0	0	6	0	0
1	49483231	.	T	C	7	4	11	0	0	11	0	0
1	49483555	.	T	C	11	8	19	2	0	21	0	0
1	49814674	.	T	C	7	8	15	0	2	17	0	0
1	49814732	.	C	T	4	6	10	0	0	10	0	0
1	49814844	.	C	T	6	8	14	0	0	14	0	0
1	49869672	.	G	A	16	13	29	0	2	31	0	0
1	49912665	.	C	T	5	10	15	0	2	17	0	0
1	49912841	.	C	A	1	9	10	0	7	17	0	0
1	49912866	.	C	T	1	8	9	0	5	14	0	0
1	49913071	.	G	A	7	13	20	0	3	24	1	0
1	49915231	.	C	T	5	9	14	0	1	15	0	0
1	49915278	.	G	C	10	8	18	0	1	19	0	0
1	49915598	.	C	T	6	7	13	0	1	14	0	0
1	49929693	.	T	C	1	2	3	0	0	3	0	0
1	49960571	.	G	A	2	2	4	0	0	4	0	0
1	49960657	.	A	T	1	2	3	0	0	3	0	0
1	49960756	.	T	C	1	3	4	0	0	4	0	0
1	49980651	.	G	A	2	2	4	1	0	5	0	0
1	50051814	.	C	A	4	3	7	0	0	7	0	0
1	50061614	.	C	A	2	2	4	0	0	4	0	0
1	50171219	.	T	C	2	3	5	0	0	5	0	0
1	50172815	.	A	G	4	3	7	0	0	7	0	0
1	50178612	.	T	C	4	6	10	0	0	10	0	0
1	50178643	.	A	G	3	0	3	0	9	12	0	0
1	50178829	.	C	A	5	2	7	0	0	7	0	0
1	50187511	.	C	T	12	7	19	0	2	21	0	0
1	50187733	.	A	T	1	4	5	0	0	5	0	0
1	50187866	.	A	G	2	0	2	0	3	5	0	0
1	50198815	.	C	T	2	6	8	0	12	20	0	0
1	50199365	.	A	T	8	7	15	0	1	16	0	0
1	50199368	.	G	A	10	5	15	0	0	15	0	0
1	50199416	.	G	A	6	12	18	0	1	19	0	0
1	50221045	.	G	A	5	2	7	0	1	8	0	0
1	50245894	.	G	C	3	2	5	0	0	5	0	0
1	50257749	.	T	C	3	1	4	0	4	8	0	0
1	50301833	.	A	G	4	11	15	0	0	15	0	0
1	50303960	.	C	T	5	12	17	0	0	17	0	0
1	50303989	.	G	A	0	9	9	0	11	21	1	0
1	50317687	.	G	A	2	16	18	0	4	22	0	0
1	50317723	.	A	C	8	16	24	0	3	27	0	0
1	50319584	.	A	G	6	4	10	1	2	13	0	0
1	50487762	.	G	C	7	0	7	0	7	14	0	0
1	50487837	.	C	A	6	8	14	0	2	16	0	0
1	50487844	.	G	A	4	9	13	0	1	14	0	0
1	50488002	.	A	G	5	12	17	0	0	17	0	0
1	50496598	.	A	G	6	5	11	0	1	12	0	0
1	50502852	.	C	T	0	4	4	0	3	8	1	0
1	50503237	.	G	A	6	3	9	0	0	9	0	0
1	50521871	.	G	T	2	3	5	0	0	5	0	0
1	50524745	.	G	A	1	2	3	0	0	3	0	0
1	50594239	.	T	A	13	22	35	0	4	39	0	0
1	50594573	.	T	A	2	2	4	0	0	4	0	0
1	50594647	.	G	A	13	5	18	0	0	18	0	0
1	50594670	.	A	T	14	7	21	0	1	22	0	0
1	50594771	.	C	A	17	9	26	0	1	27	0	0
1	50594777	.	C	T	15	9	24	0	0	24	0	0
1	50594986	.	T	C	9	0	9	0	15	24	0	0
1	50595289	.	G	A	17	15	32	0	0	32	0	0
1	50595387	.	C	T	15	10	25	0	0	25	0	0
1	50595476	.	G	A	8	13	21	1	0	22	0	0
1	50595530	.	A	G	14	6	20	1	1	22	0	0
1	50595608	.	G	C	7	11	18	0	1	19	0	0
1	50595748	.	T	C	21	8	29	0	2	31	0	0
1	50595805	.	G	A	12	12	24	1	2	27	0	0
1	50596748	.	G	T	10	16	26	0	0	26	0	0
1	50598793	.	C	T	1	9	10	0	12	22	0	0
1	50598848	.	G	A	9	10	19	0	0	19	0	0
1	50608505	.	T	C	3	3	6	0	1	7	0	0
1	50608584	.	G	A	5	9	14	0	0	14	0	0
1	50668798	.	G	A	0	2	2	0	1	3	0	0
1	50673749	.	G	A	0	4	4	0	3	7	0	0
1	50691194	.	G	C	0	2	2	0	2	4	0	0
1	50694993	.	T	C	12	18	30	0	0	30	0	0
1	50694994	.	G	T	11	18	29	0	1	30	0	0
1	50698089	.	G	A	6	5	11	0	0	11	0	0
1	50700256	.	G	A	10	8	18	0	1	19	0	0
1	50847905	.	T	C	5	3	8	0	1	9	0	0
1	50848206	.	A	C	10	15	25	0	1	26	0	0
1	50848484	.	C	T	22	7	29	0	2	31	0	0
1	50848555	.	A	G	17	11	28	0	1	29	0	0
1	50849078	.	A	T	23	13	36	0	2	38	0	0
1	50849938	.	T	A	10	9	19	0	0	19	0	0
1	50849942	.	G	A	9	9	18	0	1	19	0	0
1	50850041	.	T	A	4	10	14	0	2	16	0	0
1	50969209	.	G	A	9	9	18	0	0	18	0	0
1	50977072	.	C	A	3	7	10	0	0	10	0	0
1	50977089	.	C	T	13	7	20	0	0	20	0	0
1	50977669	.	G	A	5	2	7	0	0	7	0	0
1	50977707	.	G	A	1	41	42	0	44	86	0	0
1	50983906	.	T	C	25	26	51	0	3	54	0	0
1	50985169	.	C	T	29	34	63	0	0	63	0	0
1	50987742	.	C	A	34	41	75	0	2	77	0	0
1	50990605	.	G	A	29	28	57	0	2	59	0	0
1	50990698	.	A	T	33	26	59	4	2	65	0	0
1	50990709	.	T	C	23	26	49	5	2	64	8	0
1	50990815	.	G	A	29	21	50	0	0	50	0	0
1	51021529	.	C	A	8	7	15	0	1	16	0	0
1	51021591	.	C	A	5	7	12	0	0	12	0	0
1	51040428	.	T	C	20	28	48	0	0	48	0	0
1	51041363	.	G	A	2	12	14	0	10	24	0	0
1	51042230	.	G	C	14	10	24	0	3	27	0	0
1	51052276	.	C	T	3	5	8	0	0	8	0	0
1	51052279	.	T	C	3	5	8	0	0	8	0	0
1	51105411	.	T	A	6	6	12	0	0	12	0	0
1	51105448	.	T	C	2	0	2	0	4	6	0	0
1	51105513	.	G	A	2	2	4	0	1	5	0	0
1	51107451	.	C	T	0	2	2	0	2	4	0	0
1	51107574	.	G	A	1	2	3	0	0	3	0	0
1	51192069	.	C	T	1	3	4	0	0	4	0	0
1	51196161	.	C	T	1	3	4	0	0	4	0	0
1	51196203	.	T	C	1	2	3	0	1	4	0	0
1	51196863	.	G	A	1	4	5	0	0	5	0	0
1	51197316	.	A	G	3	2	5	0	0	5	0	0
1	51207210	.	A	C	8	10	18	0	0	18	0	0
1	51210562	.	T	C	6	9	15	0	0	15	0	0
1	51211052	.	A	G	6	7	13	0	0	13	0	0
1	51211139	.	C	A	0	5	5	0	4	9	0	0
1	51215290	.	G	A	1	5	6	0	0	6	0	0
1	51217048	.	C	A	1	5	6	0	1	7	0	0
1	51217063	.	C	A	0	5	5	0	3	8	0	0
1	51217888	.	A	C	2	3	5	0	0	5	0	0
1	51221347	.	A	G	7	0	7	0	6	13	0	0
1	51221349	.	A	T	8	6	14	0	0	14	0	0
1	51229355	.	C	T	7	7	14	0	1	15	0	0
1	51229464	.	C	G	6	6	12	0	1	13	0	0
1	51229471	.	C	T	2	5	7	0	5	12	0	0
1	51230244	.	T	C	15	4	19	0	0	19	0	0
1	51230277	.	C	G	5	7	12	0	0	13	1	0
1	51230324	.	G	A	5	8	13	0	1	14	0	0
1	51230328	.	C	A	5	9	14	0	1	15	0	0
1	51230404	.	A	G	5	7	12	0	0	12	0	0
1	51230427	.	A	G	2	5	7	0	1	8	0	0
1	51230467	.	T	C	1	6	7	0	0	7	0	0
1	51230487	.	A	T	3	4	7	0	1	8	0	0
1	51230564	.	C	T	1	2	3	0	0	3	0	0
1	51230957	.	C	A	1	7	8	0	4	12	0	0
1	51231225	.	A	T	2	5	7	0	0	7	0	0
1	51231228	.	G	T	2	5	7	0	0	7	0	0
1	51244814	.	C	T	3	3	6	0	0	6	0	0
1	51246693	.	T	C	2	1	3	0	1	4	0	0
1	51263352	.	C	T	1	1	2	0	1	3	0	0
1	51374844	.	C	T	2	3	5	0	0	5	0	0
1	51375170	.	A	T	2	2	4	0	0	4	0	0
1	51377558	.	T	C	2	3	5	0	0	5	0	0
1	51377757	.	C	T	6	5	11	0	2	13	0	0
1	51377798	.	G	A	1	4	5	0	8	13	0	0
1	51398024	.	C	T	4	4	8	0	2	10	0	0
1	51403088	.	C	T	5	3	8	0	2	10	0	0
1	51403499	.	C	A	6	5	11	0	0	11	0	0
1	51403544	.	G	C	5	6	11	0	0	11	0	0
1	51403562	.	C	T	5	6	11	0	1	12	0	0
1	51403763	.	C	A	1	5	6	0	0	6	0	0
1	51403872	.	T	C	2	3	5	0	1	6	0	0
1	51405119	.	C	A	4	3	7	1	2	10	0	0
1	51405323	.	C	A	5	7	12	0	1	13	0	0
1	51405499	.	G	A	2	3	5	0	0	5	0	0
1	51405636	.	A	C	5	2	7	0	0	7	0	0
1	51405684	.	G	A	0	3	3	0	5	8	0	0
1	51405721	.	G	A	3	3	6	0	0	6	0	0
1	51406142	.	G	A	14	5	19	0	0	19	0	0
1	51406288	.	C	T	13	12	25	0	0	25	0	0
1	51413315	.	T	C	2	4	6	0	0	6	0	0
1	51416963	.	C	T	5	7	12	0	0	12	0	0
1	51417125	.	C	G	2	0	2	0	6	8	0	0
1	51424779	.	A	T	4	8	12	0	3	15	0	0
1	51424813	.	G	A	0	6	6	0	9	15	0	0
1	51424937	.	T	A	8	4	12	1	0	14	1	0
1	51425221	.	G	T	1	4	5	0	3	8	0	0
1	51425296	.	G	A	6	7	13	0	0	13	0	0
1	51426986	.	G	A	5	2	7	1	2	10	0	0
1	51427152	.	G	T	14	9	23	0	1	24	0	0
1	51427153	.	G	T	15	9	24	0	0	24	0	0
1	51427671	.	G	T	8	15	23	0	1	24	0	0
1	51427779	.	T	C	17	11	28	0	2	30	0	0
1	51427837	.	A	C	12	18	30	0	0	30	0	0
1	51445450	.	A	T	15	8	23	0	0	23	0	0
1	51445732	.	A	G	12	14	26	0	0	26	0	0
1	51446004	.	G	A	1	7	8	0	0	8	0	0
1	51446230	.	T	A	4	3	7	0	2	9	0	0
1	51446451	.	C	T	3	5	8	0	0	8	0	0
1	51446511	.	G	A	7	4	11	0	0	11	0	0
1	51446597	.	A	T	4	3	7	0	1	8	0	0
1	51446671	.	A	T	1	3	4	0	0	4	0	0
1	51447543	.	T	G	5	2	7	0	0	7	0	0
1	51447914	.	G	T	1	3	4	0	0	4	0	0
1	51447919	.	T	C	1	0	1	0	3	4	0	0
1	51448249	.	C	A	5	3	8	0	0	8	0	0
1	51448485	.	C	T	9	6	15	0	0	15	0	0
1	51448517	.	C	T	6	8	14	0	0	14	0	0
1	51448781	.	A	G	2	3	5	0	1	6	0	0
1	51449298	.	T	C	4	6	10	0	0	10	0	0
1	51449720	.	G	A	5	2	7	0	0	7	0	0
1	51450018	.	C	T	0	1	1	0	5	6	0	0
1	51450180	.	C	T	0	3	3	0	2	5	0	0
1	51450713	.	G	A	4	3	7	0	0	7	0	0
1	51450752	.	G	A	2	4	6	0	0	6	0	0
1	51557903	.	C	T	2	27	29	0	18	47	0	0
1	51558133	.	G	T	21	12	33	0	2	35	0	0
1	51558150	.	A	T	18	10	28	0	1	29	0	0
1	51558354	.	T	A	15	13	28	3	5	36	0	0
1	51558463	.	G	A	34	21	55	0	0	55	0	0
1	51558730	.	G	T	28	16	44	0	8	52	0	0
1	51558897	.	T	A	20	23	43	0	2	45	0	0
1	51558903	.	A	C	23	18	41	0	2	43	0	0
1	51559269	.	G	C	12	24	36	0	1	37	0	0
1	51559815	.	C	T	19	18	37	0	2	39	0	0
1	51562803	.	T	C	15	14	29	0	3	32	0	0
1	51591427	.	G	A	1	2	3	0	1	4	0	0
1	51593925	.	A	C	3	11	14	0	1	15	0	0
1	51593926	.	C	T	0	12	12	0	3	15	0	0
1	51594068	.	A	C	13	7	20	0	1	21	0	0
1	51594453	.	A	G	25	17	42	0	4	46	0	0
1	51594690	.	C	G	2	18	20	0	28	48	0	0
1	51594701	.	C	T	3	21	24	0	24	48	0	0
1	51594883	.	C	T	2	16	18	0	20	38	0	0
1	51606302	.	C	G	26	22	48	0	2	50	0	0
1	51612371	.	G	T	16	22	38	0	1	39	0	0
1	51612408	.	C	G	22	14	36	0	2	38	0	0
1	51615110	.	T	C	17	0	17	0	17	34	0	0
1	51673610	.	C	T	1	2	3	0	0	3	0	0
1	51702266	.	T	C	2	3	5	0	0	5	0	0
1	51703824	.	C	T	1	4	5	0	1	6	0	0
1	51710007	.	C	T	10	5	15	0	2	17	0	0
1	51712960	.	G	A	4	1	5	0	0	5	0	0
1	51712983	.	A	G	5	3	8	0	1	9	0	0
1	51713077	.	G	A	8	6	14	0	0	14	0	0
1	51713468	.	C	T	6	3	9	0	1	10	0	0
1	51718980	.	A	G	4	3	7	0	0	7	0	0
1	51719005	.	G	A	6	3	9	0	0	9	0	0
1	51721923	.	T	G	10	7	17	0	0	17	0	0
1	51723093	.	T	G	11	0	11	0	10	21	0	0
1	51726524	.	C	T	18	26	44	0	0	44	0	0
1	51727432	.	C	A	26	26	52	0	3	55	0	0
1	51729605	.	G	A	14	16	30	1	1	32	0	0
1	51729608	.	G	T	14	13	27	0	4	31	0	0
1	51729645	.	A	C	20	12	32	2	0	34	0	0
1	51729687	.	C	T	15	15	30	1	2	33	0	0
1	51729697	.	C	A	16	16	32	0	3	35	0	0
1	51729735	.	C	A	15	14	29	0	4	33	0	0
1	51729798	.	A	C	12	8	20	0	0	20	0	0
1	51729825	.	C	T	2	4	6	0	0	6	0	0
1	51733129	.	T	A	7	12	19	0	0	19	0	0
1	51733284	.	T	A	13	12	25	0	2	27	0	0
1	51869072	.	T	C	1	3	4	0	0	4	0	0
1	52073807	.	C	G	6	7	13	0	0	13	0	0
1	52113225	.	T	C	4	0	4	0	7	11	0	0
1	52115862	.	C	T	1	10	11	0	5	16	0	0
1	52115880	.	G	C	6	9	15	0	0	15	0	0
1	52117007	.	T	C	5	0	5	0	8	13	0	0
1	52124240	.	C	T	0	2	2	0	2	4	0	0
1	52130268	.	G	A	0	8	8	0	6	14	0	0
1	52130328	.	T	C	9	3	12	0	4	16	0	0
1	52130339	.	A	G	8	5	13	0	1	14	0	0
1	52130431	.	G	A	12	9	21	0	2	23	0	0
1	52134992	.	G	A	8	8	16	0	0	16	0	0
1	52135254	.	T	C	13	15	28	0	0	28	0	0
1	52135303	.	T	C	14	8	22	0	1	23	0	0
1	52135513	.	G	A	4	5	9	0	0	9	0	0
1	52135840	.	C	A	12	6	18	0	1	19	0	0
1	52135972	.	A	T	14	10	24	0	0	24	0	0
1	52136027	.	T	C	9	8	17	0	2	19	0	0
1	52136117	.	A	C	11	14	25	0	0	25	0	0
1	52136294	.	T	C	9	3	12	0	1	13	0	0
1	52136454	.	A	C	12	7	19	0	1	20	0	0
1	52136641	.	A	G	6	7	13	0	0	13	0	0
1	52136759	.	A	T	19	13	32	0	1	33	0	0
1	52136762	.	A	C	21	13	34	0	0	34	0	0
1	52136868	.	A	G	15	9	24	0	3	27	0	0
1	52136894	.	T	C	21	11	32	0	0	32	0	0
1	52136917	.	A	C	14	11	25	0	1	26	0	0
1	52137013	.	T	A	12	9	21	0	1	22	0	0
1	52137580	.	T	C	2	3	5	0	0	5	0	0
1	52137591	.	T	C	2	5	7	0	0	7	0	0
1	52137639	.	A	G	4	9	13	0	2	15	0	0
1	52146021	.	A	T	6	8	14	0	0	14	0	0
1	52149554	.	A	T	19	15	34	0	3	37	0	0
1	52149794	.	A	G	7	6	13	0	0	13	0	0
1	52149952	.	A	G	10	1	11	0	10	21	0	0
1	52149977	.	T	A	12	6	18	0	1	19	0	0
1	52150029	.	T	C	15	9	24	0	0	24	0	0
1	52150152	.	G	A	17	7	24	0	0	24	0	0
1	52150182	.	G	T	4	13	17	0	15	32	0	0
1	52150231	.	C	T	20	15	35	0	1	36	0	0
1	52150400	.	A	G	7	8	15	0	1	16	0	0
1	52150900	.	G	T	9	3	12	0	1	13	0	0
1	52150974	.	A	G	12	7	19	0	0	19	0	0
1	52151387	.	A	G	3	2	5	0	0	5	0	0
1	52151865	.	T	C	18	5	23	3	1	27	0	0
1	52152043	.	A	G	8	7	15	0	0	15	0	0
1	52152188	.	G	A	2	9	11	0	13	24	0	0
1	52152202	.	A	G	14	8	22	0	2	24	0	0
1	52152300	.	A	T	8	13	21	0	2	23	0	0
1	52152363	.	A	G	21	7	28	0	1	29	0	0
1	52152365	.	A	G	20	7	27	0	2	29	0	0
1	52152398	.	T	C	11	21	32	0	0	32	0	0
1	52152406	.	A	C	12	18	30	0	3	33	0	0
1	52152488	.	A	G	16	15	31	0	1	32	0	0
1	52179066	.	C	T	1	9	10	0	6	16	0	0
1	52198293	.	T	G	1	3	4	0	0	4	0	0
1	52452275	.	G	T	8	9	17	0	1	18	0	0
1	52452332	.	C	T	7	9	16	0	0	16	0	0
1	52455908	.	G	A	9	8	17	0	1	18	0	0
1	52455960	.	C	T	13	12	25	0	1	26	0	0
1	52456002	.	G	A	12	11	23	0	0	23	0	0
1	52460737	.	C	T	10	4	14	0	1	15	0	0
1	52460739	.	T	C	11	4	15	0	0	15	0	0
1	52460906	.	T	C	5	7	12	0	0	12	0	0
1	52460944	.	G	T	5	7	12	0	0	12	0	0
1	52478381	.	C	T	1	2	3	0	0	3	0	0
1	52478600	.	A	T	0	6	6	0	1	8	1	0
1	52486209	.	A	G	2	3	5	0	2	7	0	0
1	52486701	.	A	C	1	2	3	0	1	4	0	0
1	52489974	.	G	A	1	4	5	0	10	15	0	0
1	52495004	.	T	A	2	2	4	1	0	5	0	0
1	52501213	.	A	C	3	1	4	0	8	12	0	0
1	52501794	.	T	C	5	2	7	0	0	7	0	0
1	52501800	.	G	A	4	3	7	0	0	7	0	0
1	52535607	.	A	T	2	1	3	0	0	3	0	0
1	52536561	.	A	G	3	2	5	0	0	5	0	0
1	52536660	.	A	G	0	0	0	0	3	3	0	0
1	52536674	.	A	G	1	2	3	0	0	3	0	0
1	52609392	.	C	T	2	4	6	0	0	6	0	0
1	52614253	.	C	T	6	3	9	0	1	10	0	0
1	52614377	.	C	T	2	2	4	0	1	5	0	0
1	52614401	.	T	C	5	2	7	0	0	7	0	0
1	52615031	.	C	T	4	4	8	0	0	8	0	0
1	52615824	.	C	T	3	5	8	0	0	8	0	0
1	52615831	.	C	T	3	2	5	0	0	5	0	0
1	52618405	.	C	T	6	5	11	0	0	11	0	0
1	52621542	.	C	T	5	11	16	0	1	17	0	0
1	52621545	.	C	T	5	10	15	0	3	18	0	0
1	52623591	.	G	A	10	10	20	0	1	21	0	0
1	52625747	.	C	G	6	0	6	0	8	14	0	0
1	52627572	.	G	A	2	19	21	0	18	39	0	0
1	52627678	.	A	T	19	12	31	0	3	35	1	0
1	52627679	.	C	T	17	16	33	0	0	33	0	0
1	52627794	.	G	A	17	10	27	0	1	28	0	0
1	52627984	.	T	C	13	10	23	0	2	25	0	0
1	52628253	.	G	T	10	11	21	0	0	21	0	0
1	52628322	.	A	T	8	5	13	0	2	15	0	0
1	52652155	.	C	A	1	2	3	0	1	4	0	0
1	52655415	.	C	T	0	2	2	0	6	8	0	0
1	52655421	.	G	A	7	2	9	0	0	9	0	0
1	52659459	.	T	C	1	5	6	0	0	6	0	0
1	52679345	.	A	G	3	2	5	0	0	5	0	0
1	52681185	.	G	A	2	3	5	0	1	6	0	0
1	52681212	.	T	C	2	2	4	0	0	4	0	0
1	52681296	.	C	A	2	2	4	0	0	4	0	0
1	52685145	.	A	C	2	4	6	0	0	6	0	0
1	52688355	.	C	T	2	4	6	0	0	6	0	0
1	52698944	.	G	T	5	3	8	0	0	8	0	0
1	52698955	.	C	T	3	3	6	0	1	7	0	0
1	52764824	.	A	T	6	9	15	0	0	15	0	0
1	52773239	.	G	A	14	14	28	0	2	30	0	0
1	52773311	.	A	G	12	7	19	0	2	21	0	0
1	52775649	.	A	G	7	17	24	0	2	26	0	0
1	52779785	.	G	A	10	7	17	0	1	18	0	0
1	52782161	.	G	A	10	8	18	0	1	20	1	0
1	52782220	.	G	T	6	11	17	0	1	18	0	0
1	52784483	.	C	A	4	5	9	0	0	9	0	0
1	52784527	.	C	T	0	2	2	0	4	6	0	0
1	52784679	.	G	C	4	3	7	0	0	7	0	0
1	52784702	.	G	A	5	5	10	0	0	10	0	0
1	52792476	.	C	A	3	5	8	0	1	9	0	0
1	52796148	.	A	G	5	2	7	0	0	7	0	0
1	52796844	.	T	G	3	3	6	0	1	7	0	0
1	52796850	.	C	T	3	3	6	0	1	7	0	0
1	52796964	.	T	C	3	3	6	0	0	6	0	0
1	52797128	.	C	T	2	2	4	0	0	4	0	0
1	52797152	.	T	C	2	3	5	0	0	5	0	0
1	52799789	.	C	T	4	2	6	0	1	7	0	0
1	52812219	.	C	G	17	6	23	0	2	25	0	0
1	52813633	.	A	T	17	6	23	0	3	26	0	0
1	52817949	.	C	G	21	12	33	0	1	35	1	0
1	53007935	.	A	G	7	4	11	0	1	12	0	0
1	53025666	.	C	T	8	4	12	0	0	12	0	0
1	53025708	.	C	G	11	5	16	0	2	18	0	0
1	53025711	.	C	T	11	4	15	0	1	16	0	0
1	53132860	.	T	C	8	4	12	0	0	12	0	0
1	53156324	.	A	G	1	9	10	0	0	10	0	0
1	53156413	.	C	T	9	12	21	0	0	21	0	0
1	53166094	.	A	G	17	13	30	0	1	31	0	0
1	53168227	.	A	G	17	0	17	0	12	29	0	0
1	53185877	.	A	C	22	10	32	0	1	33	0	0
1	53185906	.	T	C	15	15	30	0	1	31	0	0
1	53185945	.	T	C	11	13	24	0	1	25	0	0
1	53235021	.	G	A	6	3	9	0	0	9	0	0
1	53238395	.	G	A	4	3	7	0	1	8	0	0
1	53238404	.	G	T	4	5	9	0	0	9	0	0
1	53238434	.	A	G	3	7	10	0	0	10	0	0
1	53266867	.	A	C	5	4	9	0	0	9	0	0
1	53267026	.	A	C	9	0	9	0	6	15	0	0
1	53267349	.	A	G	15	7	22	0	0	22	0	0
1	53269670	.	A	C	13	10	23	0	1	24	0	0
1	53269694	.	A	G	10	6	16	0	0	16	0	0
1	53277043	.	T	C	4	1	5	0	6	11	0	0
1	53277064	.	C	T	6	5	11	0	0	11	0	0
1	53298561	.	C	T	2	4	6	0	0	6	0	0
1	53298665	.	G	A	0	2	2	0	1	3	0	0
1	53298950	.	A	C	2	2	4	0	1	5	0	0
1	53338551	.	T	C	1	2	3	0	0	3	0	0
1	53340349	.	T	G	2	2	4	0	0	4	0	0
1	53348920	.	A	G	6	4	10	0	0	10	0	0
1	53352481	.	T	C	3	2	5	0	0	5	0	0
1	53359867	.	T	G	5	5	10	0	0	10	0	0
1	53360153	.	T	C	7	7	14	0	0	14	0	0
1	53360308	.	G	A	3	4	7	0	1	8	0	0
1	53360342	.	C	T	4	4	8	0	0	8	0	0
1	53360369	.	C	T	5	2	7	0	2	9	0	0
1	53360459	.	C	T	14	5	19	0	1	20	0	0
1	53360549	.	T	C	10	7	17	0	0	17	0	0
1	53360871	.	G	A	3	5	8	0	0	8	0	0
1	53385017	.	G	A	0	6	6	0	5	11	0	0
1	53385087	.	A	G	4	0	4	0	7	11	0	0
1	53387431	.	T	A	8	7	15	0	0	15	0	0
1	53387521	.	T	C	2	5	7	0	0	7	0	0
1	53387573	.	T	C	3	4	7	0	1	8	0	0
1	53387633	.	T	A	2	1	3	0	1	4	0	0
1	53387722	.	G	A	6	12	18	0	0	18	0	0
1	53387779	.	T	G	4	10	14	0	0	14	0	0
1	53387786	.	C	T	6	13	19	0	1	20	0	0
1	53387829	.	C	T	10	10	20	0	2	22	0	0
1	53387954	.	A	G	13	7	20	0	0	20	0	0
1	53387990	.	T	C	12	8	20	1	1	22	0	0
1	53388005	.	T	C	11	11	22	1	0	23	0	0
1	53388135	.	A	C	17	15	32	0	1	33	0	0
1	53388309	.	G	C	19	14	33	0	2	35	0	0
1	53388476	.	A	C	10	13	23	0	1	24	0	0
1	53388540	.	T	A	10	16	26	0	0	26	0	0
1	53388590	.	T	G	14	16	30	0	0	30	0	0
1	53388861	.	A	G	5	9	14	0	3	17	0	0
1	53391669	.	A	C	23	12	35	0	2	38	1	0
1	53391729	.	T	C	17	0	17	1	12	30	0	0
1	53391860	.	G	T	12	5	17	0	1	18	0	0
1	53391916	.	C	T	7	4	11	0	1	12	0	0
1	53392002	.	A	T	12	4	16	0	3	19	0	0
1	53392064	.	T	C	24	0	24	0	10	34	0	0
1	53392161	.	T	C	11	10	21	0	2	23	0	0
1	53392220	.	C	A	0	6	6	1	10	17	0	0
1	53392227	.	A	T	12	4	16	1	0	17	0	0
1	53394847	.	T	C	4	2	6	0	0	6	0	0
1	53395165	.	T	C	1	0	1	0	2	3	0	0
1	53395169	.	G	T	1	2	3	0	0	3	0	0
1	53395627	.	T	C	2	3	5	0	0	5	0	0
1	53395688	.	G	A	7	3	10	0	0	10	0	0
1	53395710	.	G	C	6	3	9	0	0	9	0	0
1	53395828	.	G	A	10	5	15	0	2	17	0	0
1	53491565	.	A	G	4	8	12	0	5	17	0	0
1	53491937	.	A	G	8	3	11	0	1	12	0	0
1	53491964	.	T	A	8	5	13	1	3	17	0	0
1	53492000	.	C	A	12	7	19	0	0	19	0	0
1	53669651	.	A	G	5	2	7	0	0	7	0	0
1	53670917	.	G	T	5	4	9	0	0	9	0	0
1	53673609	.	C	T	0	2	2	0	3	5	0	0
1	53674825	.	G	A	2	2	4	0	1	5	0	0
1	53688769	.	T	A	1	3	4	0	0	4	0	0
1	53701875	.	A	G	12	12	24	0	1	25	0	0
1	53701905	.	T	G	20	17	37	0	3	40	0	0
1	53703149	.	G	A	22	14	36	1	6	43	0	0
1	53703194	.	G	T	29	20	49	1	5	55	0	0
1	53704485	.	C	A	25	31	56	0	2	58	0	0
1	53705191	.	G	A	21	23	44	0	3	47	0	0
1	53705203	.	G	A	18	29	47	0	1	48	0	0
1	53705266	.	A	G	26	21	47	0	2	49	0	0
1	53709732	.	C	A	3	15	18	0	12	30	0	0
1	53709762	.	C	T	10	14	24	0	1	25	0	0
1	53713449	.	G	T	9	8	17	0	1	18	0	0
1	53714586	.	A	G	4	13	17	0	1	18	0	0
1	53714592	.	T	G	6	14	20	0	0	20	0	0
1	53714790	.	T	A	11	19	30	0	2	32	0	0
1	53714974	.	T	A	2	2	4	0	1	5	0	0
1	53714977	.	T	G	2	0	2	0	4	6	0	0
1	53715069	.	T	G	1	0	1	0	2	3	0	0
1	53715083	.	G	A	1	2	3	0	0	3	0	0
1	53718266	.	A	G	2	4	6	0	0	6	0	0
1	53718294	.	A	T	2	2	4	0	0	4	0	0
1	53719831	.	T	C	2	3	5	0	2	7	0	0
1	53720360	.	T	G	3	3	6	0	0	6	0	0
1	53722489	.	A	T	7	5	12	0	0	12	0	0
1	53724724	.	T	A	3	3	6	0	1	7	0	0
1	53726457	.	G	A	4	5	9	0	2	11	0	0
1	53726662	.	G	A	5	8	13	0	1	14	0	0
1	53727755	.	C	T	6	7	13	0	2	15	0	0
1	53729934	.	G	A	6	5	11	0	0	11	0	0
1	53729997	.	C	T	4	3	7	0	0	7	0	0
1	53730412	.	A	G	3	5	8	0	0	8	0	0
1	53735245	.	C	T	12	6	18	0	1	19	0	0
1	53735249	.	C	T	11	8	19	1	2	22	0	0
1	53735648	.	A	G	9	15	24	0	1	25	0	0
1	53735702	.	T	G	13	5	18	0	0	18	0	0
1	53735712	.	G	A	12	6	18	0	1	19	0	0
1	53739397	.	G	A	10	6	16	0	2	18	0	0
1	53756723	.	C	T	1	6	7	0	9	16	0	0
1	53866223	.	A	T	4	10	14	0	0	14	0	0
1	53871326	.	T	A	3	9	12	1	0	13	0	0
1	53871338	.	C	A	8	4	12	1	1	14	0	0
1	53871383	.	A	G	2	8	10	0	0	10	0	0
1	53879731	.	T	C	2	0	2	0	4	6	0	0
1	53879767	.	G	A	2	2	4	0	1	5	0	0
1	53911983	.	G	A	3	2	5	0	0	5	0	0
1	53912019	.	G	A	5	4	9	0	0	9	0	0
1	53912307	.	A	G	1	3	4	0	0	4	0	0
1	53912418	.	G	T	5	5	10	0	0	10	0	0
1	53912637	.	A	G	3	2	5	0	0	5	0	0
1	53926940	.	G	T	6	4	10	0	0	10	0	0
1	53929218	.	G	A	3	1	4	0	1	5	0	0
1	53929219	.	C	A	2	2	4	0	0	4	0	0
1	53932271	.	A	G	6	3	9	0	0	9	0	0
1	53935236	.	G	A	2	2	4	0	0	4	0	0
1	53935248	.	G	T	1	2	3	0	1	4	0	0
1	53935287	.	A	G	6	0	6	0	4	10	0	0
1	53935314	.	T	C	8	5	13	0	0	13	0	0
1	53935335	.	C	T	6	5	11	0	1	12	0	0
1	53937423	.	C	T	5	3	8	0	0	8	0	0
1	53939430	.	A	G	7	4	11	0	1	12	0	0
1	53939604	.	C	T	6	9	15	0	0	15	0	0
1	53953276	.	G	T	1	1	2	0	1	3	0	0
1	53954314	.	G	A	1	4	5	0	6	11	0	0
1	53954361	.	C	A	4	6	10	0	1	11	0	0
1	53954385	.	A	C	4	7	11	0	0	11	0	0
1	53955055	.	G	A	8	5	13	0	0	13	0	0
1	53958136	.	G	A	2	6	8	0	8	16	0	0
1	53958263	.	C	T	6	11	17	0	0	17	0	0
1	53962227	.	A	T	9	10	19	0	1	20	0	0
1	53962264	.	T	C	10	9	19	0	0	19	0	0
1	53962490	.	T	G	10	6	16	0	1	17	0	0
1	53962606	.	T	A	8	4	12	0	0	12	0	0
1	53962900	.	T	A	11	7	18	1	0	19	0	0
1	53962961	.	C	T	2	3	5	0	0	5	0	0
1	53963108	.	C	A	10	6	16	0	2	18	0	0
1	53963159	.	C	T	13	11	24	0	0	24	0	0
1	53963782	.	A	G	9	4	13	0	0	13	0	0
1	53982990	.	C	T	1	2	3	0	0	3	0	0
1	54022797	.	A	G	2	0	2	0	2	4	0	0
1	54025424	.	C	T	2	2	4	0	0	4	0	0
1	54025468	.	T	A	2	4	6	0	0	6	0	0
1	54025491	.	T	A	3	3	6	0	0	6	0	0
1	54025576	.	A	G	2	0	2	0	3	5	0	0
1	54048616	.	C	T	3	2	5	0	0	5	0	0
1	54048674	.	A	G	1	0	1	0	3	4	0	0
1	54048689	.	C	T	1	3	4	0	0	4	0	0
1	54048786	.	G	A	2	3	5	0	0	5	0	0
1	54061812	.	C	T	4	2	6	0	0	6	0	0
1	54061824	.	C	T	3	3	6	0	0	6	0	0
1	54062551	.	T	A	1	4	5	0	0	5	0	0
1	54062754	.	G	A	15	22	37	1	4	42	0	0
1	54062858	.	A	G	19	13	32	0	1	33	0	0
1	54069513	.	G	T	1	2	3	0	0	3	0	0
1	54069515	.	C	A	1	2	3	0	0	3	0	0
1	54077472	.	T	C	3	2	5	0	0	5	0	0
1	54080067	.	A	T	2	3	5	0	0	5	0	0
1	54080098	.	T	C	2	2	4	0	0	4	0	0
1	54080189	.	T	G	4	0	4	0	7	11	0	0
1	54080361	.	T	G	4	6	10	0	2	12	0	0
1	54080550	.	T	G	1	0	1	0	5	6	0	0
1	54084613	.	G	A	0	2	2	0	3	5	0	0
1	54084616	.	C	T	4	2	6	0	0	6	0	0
1	54137238	.	A	G	2	2	4	0	1	5	0	0
1	54140472	.	A	T	7	3	10	0	0	10	0	0
1	54142097	.	T	C	10	5	15	0	1	16	0	0
1	54142130	.	G	T	0	10	10	0	13	23	0	0
1	54144024	.	T	G	4	6	10	0	2	12	0	0
1	54146383	.	C	T	10	9	19	0	1	20	0	0
1	54146416	.	T	C	10	10	20	0	1	21	0	0
1	54154371	.	T	C	4	0	4	0	4	8	0	0
1	54154383	.	T	G	3	4	7	0	0	7	0	0
1	54158479	.	A	G	1	4	5	0	0	5	0	0
1	54161774	.	A	G	3	3	6	0	0	6	0	0
1	54178755	.	G	C	9	8	17	0	0	17	0	0
1	54184468	.	C	T	6	2	8	0	1	9	0	0
1	54189017	.	T	C	2	0	2	0	3	5	0	0
1	54189094	.	T	C	2	2	4	0	0	4	0	0
1	54190522	.	C	A	5	2	7	0	0	7	0	0
1	54190661	.	A	G	2	3	5	0	0	5	0	0
1	54190672	.	T	G	2	2	4	0	0	4	0	0
1	54221930	.	T	C	1	3	4	1	0	5	0	0
1	54221936	.	T	C	1	3	4	1	0	5	0	0
1	54244041	.	T	C	3	4	7	0	0	7	0	0
1	54244432	.	T	C	3	3	6	0	0	6	0	0
1	54248366	.	A	C	4	8	12	0	0	12	0	0
1	54253768	.	G	A	0	7	7	0	8	15	0	0
1	54255651	.	C	T	3	5	8	0	0	8	0	0
1	54683743	.	C	T	7	9	16	0	1	17	0	0
1	54685559	.	C	G	6	6	12	0	1	13	0	0
1	54685590	.	A	G	5	7	12	0	0	12	0	0
1	54685610	.	T	C	6	8	14	0	0	14	0	0
1	54685799	.	G	A	2	2	4	0	1	5	0	0
1	54687580	.	C	T	2	9	11	0	0	11	0	0
1	54687649	.	G	T	4	4	8	0	2	10	0	0
1	54687715	.	C	A	3	6	9	1	1	11	0	0
1	54687928	.	G	T	5	4	9	0	0	9	0	0
1	54687981	.	A	G	6	8	14	0	0	14	0	0
1	54689329	.	T	C	9	7	16	0	1	17	0	0
1	54693953	.	C	A	2	4	6	0	0	6	0	0
1	54701201	.	C	G	1	4	5	1	8	14	0	0
1	54701231	.	G	A	6	6	12	0	2	14	0	0
1	54703469	.	C	T	1	4	5	0	7	12	0	0
1	54707977	.	G	A	30	31	61	0	3	64	0	0
1	54708098	.	G	T	31	29	60	0	2	62	0	0
1	54708191	.	C	A	36	20	56	0	4	60	0	0
1	54708253	.	G	A	31	36	67	0	4	71	0	0
1	54708281	.	A	T	33	35	68	0	3	71	0	0
1	54708301	.	A	C	34	36	70	0	2	72	0	0
1	54708317	.	C	T	34	30	64	0	7	71	0	0
1	54708359	.	C	T	36	22	58	0	2	60	0	0
1	54708781	.	A	G	12	16	28	0	4	32	0	0
1	54708946	.	T	C	10	15	25	0	0	25	0	0
1	54709000	.	T	C	3	16	19	0	0	19	0	0
1	54709334	.	G	A	29	25	54	0	1	55	0	0
1	54747720	.	T	C	1	2	3	0	0	3	0	0
1	54747729	.	A	G	1	0	1	0	1	2	0	0
1	54753095	.	T	G	10	0	10	0	4	14	0	0
1	54753101	.	T	C	9	3	12	0	0	12	0	0
1	54753615	.	G	A	2	3	5	0	0	5	0	0
1	54753623	.	T	G	2	3	5	0	0	5	0	0
1	54753982	.	G	T	6	3	9	2	2	13	0	0
1	54754356	.	C	T	10	5	15	0	1	16	0	0
1	54754482	.	T	G	9	6	15	0	0	15	0	0
1	54754503	.	G	A	11	8	19	0	0	19	0	0
1	54754550	.	C	A	8	5	13	0	0	13	0	0
1	54754565	.	C	T	6	4	10	0	0	10	0	0
1	54754623	.	A	T	8	7	15	0	0	15	0	0
1	54754626	.	T	A	9	7	16	0	0	16	0	0
1	54754744	.	C	T	4	8	12	0	3	15	0	0
1	54754754	.	T	C	6	12	18	0	1	19	0	0
1	54754834	.	C	T	14	10	24	0	4	28	0	0
1	54754839	.	C	T	16	12	28	0	0	28	0	0
1	54754912	.	G	A	5	6	11	0	1	12	0	0
1	54755054	.	C	T	8	4	12	0	3	15	0	0
1	54755335	.	T	A	3	3	6	0	0	6	0	0
1	54758624	.	A	T	6	4	10	0	1	11	0	0
1	54758725	.	C	T	4	9	13	0	11	24	0	0
1	54758810	.	C	T	13	14	27	0	0	27	0	0
1	54758975	.	T	C	11	15	26	0	1	27	0	0
1	54759065	.	G	A	8	18	26	0	1	27	0	0
1	54762947	.	G	A	13	15	28	0	2	30	0	0
1	54762997	.	G	T	12	18	30	0	0	30	0	0
1	54763022	.	G	C	7	17	24	0	2	26	0	0
1	54763070	.	C	G	1	10	11	0	5	16	0	0
1	54763106	.	A	G	2	6	8	0	1	9	0	0
1	54763133	.	T	C	6	5	11	1	0	12	0	0
1	54763182	.	A	G	7	6	13	1	2	16	0	0
1	54763187	.	G	A	8	9	17	1	0	18	0	0
1	54763298	.	G	A	12	9	21	0	1	22	0	0
1	54765216	.	A	C	16	1	17	0	12	29	0	0
1	54765218	.	C	T	1	11	12	0	17	29	0	0
1	54893126	.	C	G	1	2	3	0	0	3	0	0
1	54893140	.	G	A	0	2	2	0	1	3	0	0
1	54906069	.	T	C	6	3	9	0	0	9	0	0
1	54906162	.	G	A	1	2	3	0	6	9	0	0
1	54906192	.	T	C	8	3	11	0	0	11	0	0
1	54906476	.	G	C	0	6	6	0	4	10	0	0
1	54906619	.	T	A	4	4	8	0	0	8	0	0
1	54907021	.	G	A	8	4	12	0	1	13	0	0
1	54907074	.	G	A	10	4	14	0	0	14	0	0
1	54907077	.	T	A	10	4	14	0	0	14	0	0
1	54907367	.	T	G	3	7	10	0	2	12	0	0
1	54907549	.	T	C	8	10	18	0	0	18	0	0
1	54907585	.	G	C	16	6	22	0	3	25	0	0
1	54907622	.	T	C	19	5	24	0	0	24	0	0
1	54907698	.	G	T	10	4	14	0	1	15	0	0
1	54907707	.	C	T	8	4	12	0	3	15	0	0
1	54927198	.	T	C	10	7	17	0	0	17	0	0
1	54929168	.	G	A	13	11	24	2	0	26	0	0
1	54929281	.	G	A	2	8	10	0	6	16	0	0
1	54929293	.	C	T	7	6	13	0	3	16	0	0
1	54929373	.	C	G	3	7	10	0	0	10	0	0
1	54930428	.	T	A	3	6	9	0	0	9	0	0
1	54930486	.	G	A	5	8	13	0	1	14	0	0
1	54930598	.	A	G	8	10	18	0	1	19	0	0
1	54930626	.	A	C	8	10	18	0	0	18	0	0
1	54930693	.	T	C	12	10	22	0	1	23	0	0
1	54930711	.	G	A	6	10	16	0	2	18	0	0
1	54930776	.	A	G	4	9	13	0	2	15	0	0
1	54930868	.	C	A	17	6	23	0	0	23	0	0
1	54931111	.	T	C	6	10	16	0	1	17	0	0
1	54931122	.	G	A	0	10	10	0	5	15	0	0
1	54931211	.	A	T	6	15	21	0	1	22	0	0
1	54931230	.	T	A	8	12	20	0	2	22	0	0
1	54931791	.	G	C	0	10	10	0	10	20	0	0
1	54934658	.	T	G	1	7	8	0	0	8	0	0
1	54934690	.	T	C	2	5	7	0	1	8	0	0
1	54934694	.	G	T	2	4	6	0	1	7	0	0
1	54936235	.	G	T	23	14	37	0	0	37	0	0
1	54936471	.	T	C	21	0	21	0	20	41	0	0
1	54938274	.	T	C	13	5	18	1	0	19	0	0
1	54939536	.	A	T	12	8	20	0	2	22	0	0
1	54941036	.	G	A	7	10	17	0	1	18	0	0
1	54943139	.	G	A	5	4	9	0	0	9	0	0
1	54943160	.	A	G	5	4	9	0	0	9	0	0
1	54943178	.	G	A	3	7	10	0	1	11	0	0
1	54946977	.	A	C	1	0	1	0	3	4	0	0
1	54950534	.	T	C	10	13	23	0	0	23	0	0
1	54950572	.	G	A	13	8	21	0	3	24	0	0
1	54950661	.	G	A	9	7	16	0	2	18	0	0
1	54950745	.	G	T	14	6	20	0	0	20	0	0
1	54955207	.	G	A	13	9	22	0	1	23	0	0
1	54955234	.	A	G	13	9	22	0	1	23	0	0
1	54960328	.	A	G	10	8	18	0	4	22	0	0
1	54960368	.	T	G	23	14	37	0	0	37	0	0
1	54960416	.	A	C	24	16	40	0	1	41	0	0
1	54960563	.	T	A	16	20	36	1	8	45	0	0
1	54960620	.	G	C	5	7	12	0	0	12	0	0
1	54960639	.	C	T	1	9	10	0	6	16	0	0
1	54960881	.	A	G	21	16	37	0	7	44	0	0
1	54962466	.	A	G	20	14	34	0	1	35	0	0
1	54963314	.	A	G	14	16	30	0	1	31	0	0
1	54964724	.	A	G	11	15	26	0	1	27	0	0
1	54974321	.	C	T	4	4	8	0	0	8	0	0
1	54974437	.	C	A	6	9	15	0	0	15	0	0
1	54974438	.	A	G	6	9	15	0	0	15	0	0
1	54974477	.	G	A	8	5	13	0	2	15	0	0
1	54974500	.	T	A	12	5	17	0	0	17	0	0
1	54974538	.	A	G	7	6	13	0	1	14	0	0
1	54974660	.	T	C	10	4	14	0	3	17	0	0
1	54974774	.	G	A	6	7	13	0	1	14	0	0
1	54974810	.	G	T	4	13	17	0	2	19	0	0
1	54975484	.	G	T	20	8	28	0	1	29	0	0
1	54975519	.	C	T	17	12	29	0	1	30	0	0
1	54975636	.	C	T	10	10	20	0	0	20	0	0
1	54975658	.	A	G	13	5	18	0	1	19	0	0
1	54975762	.	A	T	8	4	12	0	1	13	0	0
1	54975884	.	A	G	4	8	12	1	2	15	0	0
1	54975911	.	G	A	6	6	12	0	0	12	0	0
1	54976026	.	T	A	4	9	13	0	0	13	0	0
1	54976035	.	T	A	6	7	13	0	0	13	0	0
1	54976104	.	G	A	3	12	15	0	1	16	0	0
1	54976731	.	C	T	5	3	8	0	0	8	0	0
1	54976732	.	A	G	5	3	8	0	0	8	0	0
1	54976784	.	T	A	3	3	6	0	2	8	0	0
1	54976798	.	C	A	5	6	11	0	0	11	0	0
1	54976827	.	T	C	4	4	8	0	0	8	0	0
1	54976835	.	C	T	5	3	8	0	0	8	0	0
1	54977572	.	G	A	3	4	7	0	0	7	0	0
1	54977618	.	G	A	6	6	12	0	1	13	0	0
1	54977697	.	G	A	2	3	5	0	0	5	0	0
1	54977719	.	T	A	2	3	5	0	0	5	0	0
1	54977767	.	A	T	4	4	8	0	0	8	0	0
1	54977781	.	A	G	4	3	7	0	0	7	0	0
1	54978022	.	T	G	5	4	9	0	1	10	0	0
1	54978023	.	C	T	0	4	4	0	6	10	0	0
1	54981628	.	G	A	4	3	7	0	0	7	0	0
1	54981706	.	C	T	2	4	6	0	0	6	0	0
1	54984172	.	A	G	2	4	6	0	0	6	0	0
1	54985320	.	C	T	4	5	9	0	0	9	0	0
1	54987539	.	A	G	2	2	4	0	0	4	0	0
1	54988190	.	T	G	1	2	3	0	0	3	0	0
1	54988259	.	G	A	3	3	6	0	1	7	0	0
1	55008322	.	A	G	10	11	21	0	1	22	0	0
1	55008382	.	C	T	20	6	26	0	1	27	0	0
1	55008405	.	G	A	22	7	29	0	0	29	0	0
1	55008594	.	A	T	13	5	18	0	1	19	0	0
1	55008772	.	T	C	13	15	28	0	2	30	0	0
1	55010914	.	A	C	6	4	10	0	0	10	0	0
1	55011101	.	T	A	5	4	9	0	0	9	0	0
1	55011117	.	T	C	6	4	10	0	0	10	0	0
1	55011353	.	G	C	3	2	5	0	0	5	0	0
1	55011514	.	C	T	13	4	17	0	0	17	0	0
1	55011539	.	A	T	10	3	13	0	0	13	0	0
1	55011550	.	G	A	7	3	10	0	4	14	0	0
1	55011692	.	C	T	1	6	7	0	8	15	0	0
1	55021952	.	G	A	3	2	5	0	0	5	0	0
1	55022075	.	T	C	4	0	4	0	5	9	0	0
1	55022162	.	T	A	2	3	5	0	0	5	0	0
1	55032657	.	A	G	2	4	6	0	0	6	0	0
1	55038249	.	A	G	2	2	4	0	0	4	0	0
1	55046026	.	A	T	1	3	4	0	0	4	0	0
1	55046494	.	G	A	4	5	9	0	1	10	0	0
1	55046509	.	G	A	3	6	9	0	1	10	0	0
1	55046541	.	A	G	3	5	8	0	0	8	0	0
1	55046560	.	A	C	2	4	6	0	1	7	0	0
1	55046591	.	G	A	1	3	4	0	0	4	0	0
1	55046697	.	C	G	1	3	4	0	1	5	0	0
1	55047614	.	G	A	2	2	4	0	0	4	0	0
1	55049427	.	C	A	1	2	3	0	2	5	0	0
1	55049456	.	T	C	3	0	3	0	2	5	0	0
1	55084673	.	A	G	2	2	4	0	0	4	0	0
1	55085830	.	A	T	1	4	5	0	0	5	0	0
1	55087742	.	T	C	1	4	5	0	0	5	0	0
1	55087823	.	G	C	1	4	5	0	0	5	0	0
1	55087949	.	A	C	1	2	3	0	0	3	0	0
1	55088467	.	T	A	2	3	5	0	0	5	0	0
1	55088871	.	A	G	3	0	3	0	3	6	0	0
1	55089078	.	T	A	1	4	5	0	0	5	0	0
1	55089316	.	G	A	0	5	5	0	3	8	0	0
1	55089328	.	G	A	3	5	8	0	0	8	0	0
1	55089396	.	C	T	5	12	17	0	2	19	0	0
1	55089449	.	G	A	2	1	3	0	1	4	0	0
1	55099316	.	T	C	5	9	14	0	1	15	0	0
1	55099411	.	G	A	7	6	13	0	0	13	0	0
1	55099880	.	C	G	8	5	13	0	0	13	0	0
1	55100378	.	G	A	1	12	13	0	15	28	0	0
1	55100397	.	G	C	15	13	28	0	1	29	0	0
1	55100422	.	T	A	10	14	24	0	0	24	0	0
1	55101439	.	C	A	13	9	22	0	3	25	0	0
1	55103163	.	A	C	10	8	18	0	0	18	0	0
1	55105688	.	T	G	8	0	8	0	14	22	0	0
1	55109717	.	A	T	5	10	15	0	0	15	0	0
1	55113389	.	G	C	3	1	4	0	3	7	0	0
1	55113410	.	G	A	1	3	4	0	3	7	0	0
1	55126626	.	A	C	3	0	3	0	4	7	0	0
1	55126635	.	G	A	3	4	7	0	0	7	0	0
1	55127910	.	C	T	3	2	5	0	1	6	0	0
1	55131337	.	A	T	10	6	16	0	0	16	0	0
1	55131359	.	A	T	7	3	10	0	2	12	0	0
1	55141789	.	T	C	0	2	2	0	1	3	0	0
1	55161252	.	T	C	2	0	2	0	4	6	0	0
1	55169244	.	G	C	7	4	11	0	1	12	0	0
1	55169260	.	G	A	2	10	12	0	0	12	0	0
1	55169349	.	G	C	12	8	20	0	0	20	0	0
1	55169658	.	T	A	16	9	25	0	2	27	0	0
1	55170051	.	T	A	12	11	23	0	0	23	0	0
1	55170161	.	C	A	7	6	13	0	1	14	0	0
1	55170328	.	C	A	13	4	17	5	1	23	0	0
1	55170366	.	C	T	11	8	19	4	1	24	0	0
1	55170384	.	G	A	11	14	25	1	1	27	0	0
1	55170804	.	T	C	5	12	17	0	0	17	0	0
1	55170856	.	T	C	9	0	9	0	5	14	0	0
1	55170920	.	C	T	5	3	8	0	1	9	0	0
1	55171249	.	G	A	6	14	20	0	0	20	0	0
1	55179434	.	C	T	3	7	10	0	0	10	0	0
1	55179470	.	C	T	4	4	8	0	0	8	0	0
1	55182808	.	C	T	3	2	5	0	0	5	0	0
1	55183074	.	G	A	3	5	8	0	0	8	0	0
1	55191256	.	A	T	1	2	3	0	0	3	0	0
1	55191471	.	T	C	7	0	7	0	7	14	0	0
1	55191675	.	A	G	4	3	7	0	0	7	0	0
1	55195384	.	G	T	8	3	11	0	0	11	0	0
1	55223001	.	A	C	0	0	0	0	5	5	0	0
1	55228562	.	C	G	0	2	2	0	1	3	0	0
1	55228575	.	C	T	2	2	4	0	0	4	0	0
1	55229531	.	T	A	1	3	4	0	0	4	0	0
1	55234020	.	A	G	1	2	3	0	0	3	0	0
1	55745821	.	T	C	2	0	2	0	3	5	0	0
1	55745917	.	C	A	3	2	5	0	0	5	0	0
1	55776909	.	A	C	13	10	23	0	4	28	1	0
1	55785527	.	C	A	2	35	37	0	28	65	0	0
1	55785654	.	C	T	20	23	43	0	0	43	0	0
1	55787507	.	A	G	3	4	7	0	0	7	0	0
1	55789456	.	C	T	4	3	7	0	0	7	0	0
1	55789504	.	A	C	5	0	5	0	4	9	0	0
1	55817658	.	T	C	5	0	5	0	5	10	0	0
1	55817661	.	A	T	6	4	10	0	0	10	0	0
1	55817728	.	C	T	6	4	10	0	0	10	0	0
1	55818073	.	T	C	1	2	3	0	0	3	0	0
1	55818218	.	A	T	4	3	7	0	0	7	0	0
1	55818319	.	T	C	3	2	5	0	1	6	0	0
1	55833185	.	G	A	3	5	8	0	0	8	0	0
1	55839282	.	A	C	2	2	4	0	1	5	0	0
1	55843902	.	C	T	22	22	44	0	3	47	0	0
1	55843968	.	G	A	21	30	51	0	0	51	0	0
1	55844044	.	T	A	18	22	40	0	0	40	0	0
1	55844401	.	A	G	22	25	47	0	0	47	0	0
1	55849463	.	T	C	19	0	19	1	8	28	0	0
1	55853320	.	G	A	7	8	15	0	0	15	0	0
1	55872892	.	C	G	9	4	13	0	0	13	0	0
1	55873073	.	C	T	9	6	15	0	0	15	0	0
1	55878243	.	C	T	0	5	5	0	7	12	0	0
1	55878257	.	T	A	3	9	12	0	1	13	0	0
1	55878400	.	C	T	0	8	8	0	6	14	0	0
1	55878496	.	T	C	3	1	4	0	9	13	0	0
1	55878624	.	T	A	2	7	9	0	1	10	0	0
1	55878626	.	A	C	2	7	9	0	1	10	0	0
1	55885148	.	C	T	2	5	7	0	16	23	0	0
1	55888583	.	C	A	5	5	10	0	0	10	0	0
1	55888632	.	T	C	4	0	4	0	5	9	0	0
1	55888654	.	C	T	3	3	6	0	0	6	0	0
1	55888690	.	A	G	2	3	5	0	0	5	0	0
1	55888693	.	T	A	0	3	3	0	1	4	0	0
1	56217450	.	G	T	15	4	19	0	0	19	0	0
1	56217510	.	A	G	31	20	51	0	3	54	0	0
1	56217925	.	G	A	29	34	63	0	3	66	0	0
1	56218141	.	A	G	36	28	64	0	11	75	0	0
1	56218189	.	C	T	3	30	33	0	36	69	0	0
1	56218360	.	G	C	30	0	30	0	31	61	0	0
1	56423678	.	T	A	2	4	6	0	0	6	0	0
1	56424791	.	C	T	1	4	5	0	7	12	0	0
1	56424794	.	T	C	7	0	7	0	3	10	0	0
1	56425843	.	T	C	7	1	8	0	2	10	0	0
1	56428320	.	G	A	4	10	14	0	1	15	0	0
1	57278282	.	T	G	6	3	9	0	1	10	0	0
1	57278610	.	T	G	1	5	6	0	0	6	0	0
1	57278690	.	G	A	6	3	9	0	0	9	0	0
1	57278714	.	C	T	0	2	2	0	7	9	0	0
1	57280184	.	G	T	3	3	6	0	1	7	0	0
1	57280292	.	T	C	4	2	6	0	0	6	0	0
1	57280400	.	G	A	4	3	7	0	1	8	0	0
1	57280502	.	T	C	1	7	8	0	0	8	0	0
1	57311941	.	C	A	5	3	8	0	0	8	0	0
1	57311952	.	A	G	4	0	4	0	3	7	0	0
1	57317706	.	C	T	1	2	3	0	1	4	0	0
1	57332657	.	G	A	0	2	2	0	1	3	0	0
1	57338268	.	G	A	0	4	4	0	3	7	0	0
1	57364666	.	G	A	2	2	4	0	0	4	0	0
1	57381708	.	C	A	1	2	3	0	0	3	0	0
1	58545499	.	A	G	3	6	9	0	0	9	0	0
1	58545547	.	T	G	7	4	11	0	0	11	0	0
1	58545580	.	G	C	4	2	6	0	0	6	0	0
1	58545734	.	C	G	8	9	17	0	1	18	0	0
1	58547783	.	T	C	8	6	14	0	1	15	0	0
1	58548428	.	T	C	5	5	10	0	1	11	0	0
1	58548491	.	T	C	4	9	13	0	0	13	0	0
1	58550545	.	A	G	4	3	7	0	0	7	0	0
1	58559454	.	C	T	0	2	2	0	1	3	0	0
1	58593418	.	G	A	1	2	3	0	0	3	0	0
1	58593490	.	C	G	4	3	7	0	0	7	0	0
1	58593494	.	T	A	4	3	7	0	0	7	0	0
1	58593542	.	G	A	6	2	8	0	0	8	0	0
1	58593547	.	A	T	6	2	8	0	0	8	0	0
1	58593768	.	T	G	5	3	8	0	1	9	0	0
1	58593833	.	C	A	8	9	17	0	1	18	0	0
1	58593835	.	T	C	8	10	18	0	0	18	0	0
1	58593912	.	C	T	5	4	9	0	0	9	0	0
1	58594007	.	C	T	5	3	8	0	1	9	0	0
1	58594066	.	T	C	3	1	4	0	6	10	0	0
1	58594143	.	A	C	6	4	10	0	0	10	0	0
1	58594144	.	G	A	6	4	10	0	0	10	0	0
1	58594470	.	T	C	5	10	15	0	1	16	0	0
1	58594491	.	G	A	4	6	10	0	2	12	0	0
1	58594611	.	T	G	4	7	11	0	0	11	0	0
1	58595018	.	C	T	5	9	14	0	1	15	0	0
1	58595198	.	A	G	4	7	11	0	0	11	0	0
1	58595386	.	G	A	3	5	8	0	0	8	0	0
1	58595455	.	G	A	4	4	8	0	0	8	0	0
1	58595545	.	T	C	5	4	9	0	0	9	0	0
1	58601615	.	G	A	3	4	7	0	0	7	0	0
1	58601620	.	T	C	2	4	6	0	0	6	0	0
1	58605840	.	A	G	7	3	10	0	0	10	0	0
1	58605969	.	C	G	5	3	8	1	0	9	0	0
1	58605997	.	A	G	4	4	8	2	0	10	0	0
1	58606206	.	G	A	2	2	4	2	4	10	0	0
1	58612519	.	T	C	1	3	4	0	0	4	0	0
1	58612762	.	A	G	5	5	10	0	0	10	0	0
1	58612899	.	G	A	0	2	2	1	4	7	0	0
1	58613027	.	A	G	2	3	5	0	0	5	0	0
1	58613091	.	A	C	2	1	3	0	0	3	0	0
1	58615380	.	G	T	4	2	6	0	1	7	0	0
1	58615393	.	T	G	3	3	6	0	0	6	0	0
1	58617410	.	T	C	1	4	5	0	0	5	0	0
1	58617987	.	T	C	5	2	7	0	0	7	0	0
1	58618014	.	C	T	4	2	6	0	0	6	0	0
1	58618035	.	C	T	2	3	5	0	0	5	0	0
1	58631374	.	A	G	4	3	7	0	1	8	0	0
1	58631609	.	C	T	1	5	6	0	1	7	0	0
1	58631695	.	A	T	2	3	5	0	0	5	0	0
1	58631713	.	A	G	2	0	2	0	2	4	0	0
1	58677839	.	T	C	2	10	12	1	0	13	0	0
1	58677856	.	C	T	2	10	12	0	0	12	0	0
1	58677900	.	A	C	2	3	5	0	0	5	0	0
1	58677901	.	T	G	1	1	2	0	3	5	0	0
1	58680432	.	T	A	7	7	14	0	2	16	0	0
1	58680499	.	C	A	9	10	19	0	1	20	0	0
1	58680708	.	T	C	10	8	18	0	0	18	0	0
1	58680718	.	C	G	9	9	18	0	0	18	0	0
1	58680792	.	T	C	12	9	21	0	1	22	0	0
1	58680913	.	T	C	11	9	20	0	0	20	0	0
1	58681068	.	C	T	13	6	19	0	1	20	0	0
1	58681419	.	A	T	10	12	22	0	2	28	4	0
1	58681491	.	T	C	10	5	15	0	0	15	0	0
1	58762985	.	T	G	3	5	8	0	0	8	0	0
1	58846938	.	A	G	3	5	8	0	0	8	0	0
1	58850562	.	C	T	6	3	9	0	0	9	0	0
1	58850622	.	T	C	3	4	7	0	0	7	0	0
1	58978436	.	A	C	4	2	6	0	0	6	0	0
1	58978454	.	C	T	5	2	7	0	1	8	0	0
1	58982147	.	G	A	0	7	7	0	5	12	0	0
1	58982195	.	C	G	6	5	11	0	1	12	0	0
1	58984239	.	G	T	4	3	7	0	0	7	0	0
1	58984368	.	G	A	0	7	7	0	4	11	0	0
1	58984478	.	T	C	5	4	9	0	0	9	0	0
1	58984640	.	C	T	4	3	7	0	1	8	0	0
1	58985530	.	G	A	13	11	24	0	2	26	0	0
1	58985579	.	T	G	10	13	23	0	0	23	0	0
1	58985730	.	C	A	4	5	9	0	0	9	0	0
1	58991269	.	C	A	1	2	3	0	0	3	0	0
1	58991278	.	T	C	1	2	3	0	0	3	0	0
1	59009732	.	A	G	20	0	20	0	16	36	0	0
1	59010618	.	G	A	21	21	42	0	1	43	0	0
1	59018886	.	C	T	1	5	6	0	8	14	0	0
1	59019006	.	C	G	8	6	14	0	0	14	0	0
1	59019084	.	T	A	3	7	10	0	1	11	0	0
1	59019093	.	A	G	4	7	11	0	0	11	0	0
1	59062665	.	T	C	20	29	49	0	1	50	0	0
1	59065047	.	G	A	1	4	5	0	0	5	0	0
1	59065049	.	C	T	1	4	5	0	0	5	0	0
1	59065889	.	G	A	3	13	16	0	24	40	0	0
1	59141116	.	T	A	5	2	7	2	1	10	0	0
1	59141397	.	T	C	3	1	4	1	3	8	0	0
1	59141429	.	G	T	4	3	7	0	0	7	0	0
1	59146790	.	A	G	2	6	8	0	2	10	0	0
1	59147468	.	C	G	3	0	3	0	11	14	0	0
1	59148341	.	T	C	3	8	11	0	0	11	0	0
1	59149117	.	C	T	12	11	23	0	1	24	0	0
1	59149968	.	T	C	7	15	22	0	0	22	0	0
1	59150450	.	A	G	10	8	18	0	2	20	0	0
1	59150482	.	G	T	15	5	20	0	2	22	0	0
1	59150518	.	T	C	9	10	19	0	1	20	0	0
1	59150559	.	T	G	10	19	29	0	1	30	0	0
1	59150583	.	T	A	9	17	26	0	2	28	0	0
1	59150683	.	T	C	7	11	18	0	0	18	0	0
1	59150737	.	T	C	13	18	31	0	1	32	0	0
1	59150762	.	G	T	17	16	33	0	1	34	0	0
1	59150781	.	T	C	19	15	34	0	0	34	0	0
1	59151051	.	A	C	1	2	3	0	0	3	0	0
1	59156827	.	T	G	1	4	5	0	0	5	0	0
1	59157536	.	T	C	4	6	10	0	0	10	0	0
1	59157856	.	T	A	11	4	15	0	0	15	0	0
1	59157888	.	T	C	9	12	21	0	1	22	0	0
1	59157977	.	A	C	3	11	14	1	1	17	1	0
1	59158035	.	C	A	7	6	13	0	2	15	0	0
1	59158062	.	A	T	8	6	14	0	0	14	0	0
1	59158070	.	G	A	7	7	14	0	0	14	0	0
1	59172876	.	A	G	16	12	28	0	0	28	0	0
1	59172900	.	A	G	12	11	23	0	4	27	0	0
1	59172969	.	G	A	20	11	31	0	0	31	0	0
1	59173563	.	C	T	15	13	28	0	1	29	0	0
1	59173701	.	G	T	15	14	29	0	0	29	0	0
1	59173758	.	A	G	7	8	15	0	0	15	0	0
1	59173866	.	T	G	10	7	17	0	1	18	0	0
1	59173896	.	T	C	12	0	12	0	8	20	0	0
1	59174387	.	A	G	5	9	14	0	0	14	0	0
1	59174408	.	G	A	3	11	14	0	1	15	0	0
1	59174492	.	T	G	5	9	14	0	0	14	0	0
1	59174525	.	A	C	7	7	14	0	1	15	0	0
1	59174645	.	G	A	5	9	14	0	2	16	0	0
1	59174797	.	A	C	7	8	15	1	0	16	0	0
1	59174962	.	T	C	11	5	16	0	3	19	0	0
1	59175511	.	T	C	3	5	8	0	1	9	0	0
1	59175572	.	A	G	2	4	6	0	1	7	0	0
1	59175626	.	G	A	5	3	8	0	0	8	0	0
1	59175635	.	G	A	5	4	9	0	0	9	0	0
1	59175740	.	G	T	3	5	8	0	1	9	0	0
1	59176636	.	C	T	4	5	9	0	0	9	0	0
1	59176887	.	G	T	7	8	15	0	0	15	0	0
1	59176935	.	A	C	3	0	3	0	5	8	0	0
1	59218477	.	C	G	0	3	3	1	6	10	0	0
1	59218594	.	A	G	10	12	22	0	2	24	0	0
1	59226049	.	T	C	23	24	47	0	8	55	0	0
1	59226052	.	A	G	25	27	52	0	4	56	0	0
1	59226374	.	A	G	39	14	53	0	1	54	0	0
1	59228311	.	G	A	36	26	62	0	1	63	0	0
1	59228322	.	C	T	35	31	66	0	0	66	0	0
1	59228569	.	A	C	20	1	21	0	27	48	0	0
1	59229211	.	G	A	6	6	12	1	1	14	0	0
1	59232206	.	A	G	7	16	23	0	0	23	0	0
1	59232509	.	G	A	11	13	24	0	1	25	0	0
1	59235016	.	T	G	13	17	30	0	1	31	0	0
1	59244312	.	A	G	11	8	19	0	2	21	0	0
1	59244635	.	A	T	14	22	36	0	0	36	0	0
1	59244916	.	T	A	41	7	48	1	2	51	0	0
1	59244928	.	C	T	38	10	48	1	2	51	0	0
1	59245142	.	C	G	32	24	56	0	4	60	0	0
1	59245658	.	G	A	21	10	31	0	2	33	0	0
1	59245873	.	T	C	18	10	28	0	2	30	0	0
1	59245900	.	C	T	21	9	30	0	1	31	0	0
1	59246189	.	T	C	10	0	10	0	10	20	0	0
1	59246318	.	A	G	2	2	4	0	1	5	0	0
1	59246320	.	G	A	2	3	5	0	0	5	0	0
1	59247893	.	T	G	12	9	21	0	1	22	0	0
1	59247944	.	C	T	13	9	22	0	2	24	0	0
1	59248138	.	T	A	9	5	14	0	1	15	0	0
1	59251658	.	C	G	14	7	21	0	1	22	0	0
1	59297464	.	T	G	1	3	4	0	0	4	0	0
1	59298261	.	T	G	2	3	5	0	0	5	0	0
1	59302210	.	G	A	1	4	5	0	10	15	0	0
1	59302276	.	C	T	5	8	13	0	0	13	0	0
1	59302372	.	T	G	1	6	7	1	1	9	0	0
1	59302813	.	C	A	2	3	5	0	1	6	0	0
1	59303024	.	C	A	6	4	10	0	0	10	0	0
1	59303294	.	C	G	1	0	1	0	2	3	0	0
1	59303334	.	A	G	3	3	6	0	0	6	0	0
1	59304427	.	T	C	1	4	5	0	0	5	0	0
1	59305116	.	T	C	13	1	14	0	11	25	0	0
1	59305200	.	T	C	15	4	19	0	0	19	0	0
1	59318769	.	A	G	6	8	14	0	0	14	0	0
1	59318771	.	C	A	6	8	14	0	0	14	0	0
1	59320111	.	C	T	7	11	18	0	0	18	0	0
1	59321447	.	A	G	8	0	8	0	14	22	0	0
1	59324067	.	T	C	19	22	41	0	5	46	0	0
1	59328110	.	T	G	5	0	5	0	6	11	0	0
1	59328287	.	C	T	6	7	13	0	0	13	0	0
1	59328486	.	C	T	4	6	10	0	2	12	0	0
1	59329950	.	A	G	3	7	10	0	0	10	0	0
1	59329957	.	T	C	1	7	8	0	0	8	0	0
1	59409266	.	G	A	2	8	10	0	0	10	0	0
1	59409321	.	C	G	2	12	14	0	0	14	0	0
1	59409455	.	A	G	3	12	15	0	2	17	0	0
1	59411110	.	A	G	2	9	11	0	0	11	0	0
1	59415710	.	A	G	1	4	5	0	0	5	0	0
1	59542739	.	A	T	1	8	9	0	0	9	0	0
1	59562375	.	A	G	1	2	3	0	0	3	0	0
1	59565350	.	G	A	1	4	5	0	0	5	0	0
10	18509	.	A	G	5	6	11	0	0	11	0	0
10	18533	.	T	C	6	10	16	0	0	16	0	0
10	19217	.	G	A	4	6	10	0	2	12	0	0
10	22333	.	C	G	11	3	14	0	1	15	0	0
10	22434	.	G	T	1	6	7	0	6	13	0	0
10	22435	.	G	T	6	6	12	0	1	13	0	0
10	22507	.	A	G	8	13	21	0	1	22	0	0
10	24014	.	G	A	2	3	5	0	0	5	0	0
10	24733	.	G	A	6	3	9	0	1	10	0	0
10	27021	.	C	T	4	6	10	0	0	10	0	0
10	27787	.	G	T	2	3	5	0	5	10	0	0
10	32978	.	T	C	3	0	3	0	6	9	0	0
10	32998	.	G	T	3	4	7	0	1	8	0	0
10	33237	.	T	C	7	5	12	0	0	12	0	0
10	33287	.	G	C	9	4	13	0	0	13	0	0
10	33441	.	A	G	8	7	15	0	0	15	0	0
10	33630	.	A	G	6	8	14	0	0	14	0	0
10	33634	.	G	T	6	6	12	0	1	13	0	0
10	33665	.	T	C	5	5	10	0	0	10	0	0
10	33986	.	G	T	5	5	10	0	0	10	0	0
10	34028	.	C	T	4	5	9	0	0	9	0	0
10	34206	.	A	C	3	4	7	0	0	7	0	0
10	34233	.	G	A	2	2	4	0	0	4	0	0
10	34302	.	G	T	1	4	5	0	0	5	0	0
10	34325	.	C	T	0	4	4	0	1	5	0	0
10	34725	.	G	A	5	3	8	0	1	9	0	0
10	34727	.	A	T	5	4	9	0	0	9	0	0
10	34839	.	G	C	5	8	13	0	1	14	0	0
10	38922	.	A	G	2	2	4	0	0	4	0	0
10	38924	.	A	G	2	2	4	0	0	4	0	0
10	53930	.	T	G	9	4	13	0	1	14	0	0
10	55594	.	G	A	11	6	17	0	0	17	0	0
10	62459	.	A	C	18	1	19	0	19	38	0	0
10	62468	.	C	G	19	17	36	0	1	37	0	0
10	63587	.	A	G	16	9	25	0	4	29	0	0
10	64855	.	G	A	12	4	16	0	0	16	0	0
10	65086	.	A	G	10	3	13	0	0	13	0	0
10	67063	.	T	C	2	7	9	0	0	9	0	0
10	72381	.	A	G	5	3	8	0	1	9	0	0
10	78461	.	G	C	2	12	14	0	16	30	0	0
10	81285	.	C	T	26	18	44	1	0	45	0	0
10	81348	.	C	T	19	14	33	0	2	35	0	0
10	81508	.	A	G	14	2	16	0	11	27	0	0
10	82336	.	A	G	25	8	33	0	2	35	0	0
10	83401	.	G	A	7	7	14	0	0	14	0	0
10	85353	.	A	G	12	6	18	0	0	18	0	0
10	85404	.	G	A	9	10	19	0	3	22	0	0
10	85419	.	C	T	2	9	11	0	10	21	0	0
10	85571	.	G	C	10	13	23	0	2	25	0	0
10	85585	.	C	T	13	12	25	0	1	26	0	0
10	85927	.	A	G	16	10	26	0	0	26	0	0
10	85948	.	G	C	17	9	26	0	2	28	0	0
10	87353	.	G	A	7	3	10	0	2	12	0	0
10	87417	.	G	A	4	5	9	0	2	11	0	0
10	87426	.	T	C	5	5	10	0	0	10	0	0
10	87606	.	G	A	4	7	11	0	1	12	0	0
10	89893	.	T	C	2	0	2	0	4	6	0	0
10	110895	.	G	A	3	4	7	0	0	7	0	0
10	115088	.	G	A	5	12	17	0	2	19	0	0
10	115136	.	T	C	6	15	21	2	2	25	0	0
10	115578	.	T	C	4	9	13	0	0	13	0	0
10	115773	.	A	G	6	10	16	0	2	18	0	0
10	115820	.	T	C	7	14	21	0	0	21	0	0
10	115967	.	A	G	1	0	1	0	6	7	0	0
10	116619	.	G	C	2	3	5	0	0	5	0	0
10	116831	.	C	T	2	2	4	1	0	5	0	0
10	134809	.	G	A	11	10	21	0	1	22	0	0
10	193726	.	A	G	3	10	13	0	0	13	0	0
10	193853	.	G	A	12	10	22	0	4	26	0	0
10	194316	.	A	G	9	9	18	0	1	19	0	0
10	195321	.	T	C	15	7	22	0	1	23	0	0
10	195327	.	T	C	14	8	22	0	1	23	0	0
10	196054	.	C	T	13	9	22	1	2	25	0	0
10	196307	.	C	T	12	8	20	0	1	21	0	0
10	196342	.	C	G	14	8	22	0	0	22	0	0
10	196670	.	G	A	17	20	37	0	3	40	0	0
10	196693	.	T	A	18	21	39	0	0	39	0	0
10	196773	.	T	C	5	4	9	0	1	10	0	0
10	196782	.	C	A	2	1	3	0	3	6	0	0
10	207258	.	C	T	13	13	26	0	2	28	0	0
10	207259	.	C	A	1	15	16	0	11	27	0	0
10	210568	.	A	G	8	7	15	0	0	15	0	0
10	210598	.	T	C	9	6	15	0	0	15	0	0
10	286788	.	T	C	9	0	9	0	8	17	0	0
10	292655	.	C	T	0	7	7	0	4	11	0	0
10	292667	.	A	G	3	7	10	0	0	10	0	0
10	294113	.	G	A	3	6	9	0	0	9	0	0
10	296617	.	C	T	0	4	4	0	5	9	0	0
10	307976	.	G	T	6	9	15	0	3	18	0	0
10	307985	.	T	C	7	0	7	0	7	14	0	0
10	308288	.	T	C	7	5	12	0	0	12	0	0
10	311901	.	A	G	8	5	13	0	0	13	0	0
10	313332	.	T	C	3	4	7	0	0	7	0	0
10	320142	.	C	A	1	3	4	0	0	4	0	0
10	323781	.	C	T	1	2	3	0	0	3	0	0
10	323803	.	A	C	1	2	3	0	0	3	0	0
10	431607	.	T	A	1	2	3	0	0	3	0	0
10	431608	.	T	C	1	1	2	0	1	3	0	0
10	474834	.	T	C	5	8	13	0	0	13	0	0
10	474896	.	T	C	10	7	17	0	2	19	0	0
10	478304	.	T	G	6	14	20	0	0	21	1	0
10	478388	.	G	A	3	9	12	0	12	24	0	0
10	478508	.	T	C	11	16	27	0	1	28	0	0
10	478661	.	C	T	14	11	25	0	2	27	0	0
10	478724	.	G	A	16	13	29	0	2	31	0	0
10	478742	.	C	T	13	12	25	0	0	25	0	0
10	479063	.	A	G	7	14	21	0	2	23	0	0
10	482335	.	G	A	13	11	24	0	3	27	0	0
10	482371	.	T	G	15	17	32	0	0	32	0	0
10	486146	.	G	A	20	10	30	0	2	32	0	0
10	486153	.	T	C	19	10	29	0	2	31	0	0
10	500114	.	A	G	17	2	19	0	16	35	0	0
10	500168	.	G	A	6	19	25	0	20	45	0	0
10	500423	.	A	G	21	0	21	0	17	38	0	0
10	500473	.	T	C	13	19	32	0	4	36	0	0
10	501833	.	C	T	13	26	39	0	2	41	0	0
10	501899	.	G	C	25	23	48	0	2	50	0	0
10	505282	.	A	G	11	20	31	0	3	34	0	0
10	505316	.	G	A	2	29	31	0	13	44	0	0
10	577791	.	G	C	3	4	7	0	0	7	0	0
10	579989	.	A	G	7	0	7	0	8	15	0	0
10	580088	.	G	T	1	9	10	0	12	22	0	0
10	580092	.	G	A	12	9	21	0	3	24	0	0
10	586563	.	C	A	2	7	9	0	1	10	0	0
10	589487	.	G	A	7	7	14	1	0	15	0	0
10	589655	.	T	C	1	6	7	0	0	7	0	0
10	589789	.	G	A	1	4	5	0	5	10	0	0
10	589810	.	A	T	6	5	11	0	0	11	0	0
10	589875	.	T	C	3	5	8	0	0	8	0	0
10	590067	.	A	C	3	4	7	0	0	7	0	0
10	590273	.	A	C	10	4	14	0	2	16	0	0
10	591017	.	T	C	13	9	22	1	0	23	0	0
10	591219	.	T	G	7	0	7	0	8	15	0	0
10	591220	.	C	T	6	8	14	0	1	15	0	0
10	591386	.	G	T	0	2	2	0	1	3	0	0
10	591434	.	G	A	6	8	14	0	0	14	0	0
10	591461	.	A	G	14	4	18	0	1	19	0	0
10	591476	.	A	G	7	0	7	0	11	18	0	0
10	591567	.	T	A	10	8	18	0	1	19	0	0
10	591634	.	T	G	7	5	12	0	2	14	0	0
10	591716	.	C	G	8	2	10	0	1	11	0	0
10	591720	.	G	A	0	2	2	0	7	9	0	0
10	591820	.	A	G	14	0	14	0	6	20	0	0
10	600448	.	T	C	2	6	8	0	1	9	0	0
10	600450	.	T	C	2	7	9	0	0	9	0	0
10	600584	.	G	A	3	7	10	0	0	10	0	0
10	617784	.	G	A	2	1	3	0	1	4	0	0
10	1056227	.	A	G	2	6	8	0	0	8	0	0
10	1056409	.	A	G	2	1	3	0	1	4	0	0
10	1056460	.	T	C	1	3	4	0	0	4	0	0
10	1076251	.	T	C	5	5	10	0	0	10	0	0
10	1082985	.	T	G	6	5	11	0	0	11	0	0
10	1083030	.	T	A	4	6	10	0	0	10	0	0
10	1091694	.	A	G	3	2	5	0	0	5	0	0
10	1105953	.	C	T	19	10	29	0	0	29	0	0
10	1107460	.	C	T	16	12	28	1	0	29	0	0
10	1150511	.	T	A	1	2	3	0	0	3	0	0
10	1150520	.	G	C	1	2	3	0	0	3	0	0
10	1226809	.	T	C	2	4	6	0	0	6	0	0
10	1436596	.	C	G	0	6	6	0	7	13	0	0
10	1450286	.	G	A	6	4	10	0	1	11	0	0
10	1541411	.	G	A	4	17	21	0	0	21	0	0
10	1541492	.	C	T	8	16	24	0	2	26	0	0
10	1543805	.	C	G	1	11	12	0	3	15	0	0
10	1549013	.	C	A	2	10	12	0	4	16	0	0
10	1549088	.	C	T	1	5	6	0	3	9	0	0
10	1549494	.	G	A	2	8	10	0	3	13	0	0
10	1552657	.	T	C	4	2	6	0	0	6	0	0
10	1597332	.	A	G	3	5	8	0	0	8	0	0
10	1597396	.	G	A	7	10	17	0	1	18	0	0
10	1599468	.	C	T	3	5	8	0	2	10	0	0
10	1603967	.	T	C	2	2	4	0	0	4	0	0
10	1658184	.	T	C	1	2	3	0	0	3	0	0
10	1666500	.	A	G	2	0	2	0	3	5	0	0
10	1666525	.	G	A	0	2	2	0	1	3	0	0
10	1668159	.	C	T	11	5	16	0	0	16	0	0
10	1671442	.	A	T	8	5	13	0	0	13	0	0
10	1674291	.	C	T	13	10	23	0	2	25	0	0
10	1681712	.	A	T	7	7	14	0	1	15	0	0
10	1684563	.	T	G	9	13	22	1	1	24	0	0
10	1684742	.	A	G	1	3	4	0	0	4	0	0
10	1687094	.	C	T	12	4	16	0	0	16	0	0
10	1687547	.	C	T	22	19	41	0	4	45	0	0
10	1694456	.	T	A	18	10	28	0	0	28	0	0
10	1708197	.	T	A	27	16	43	0	1	45	1	0
10	1708230	.	T	C	24	20	44	0	2	46	0	0
10	1708239	.	A	T	21	23	44	0	1	45	0	0
10	1708412	.	A	T	32	21	53	0	3	56	0	0
10	1709165	.	T	A	33	21	54	0	1	56	1	0
10	1709331	.	T	G	30	31	61	0	1	63	1	0
10	1709731	.	G	A	31	30	61	0	2	63	0	0
10	1709783	.	G	A	26	32	58	0	2	60	0	0
10	1709836	.	T	G	32	19	51	0	0	51	0	0
10	1709855	.	C	T	24	22	46	0	6	52	0	0
10	1709871	.	G	A	28	19	47	0	1	48	0	0
10	1710270	.	A	G	31	18	49	1	0	50	0	0
10	1710358	.	C	T	19	13	32	0	0	32	0	0
10	1711061	.	T	C	16	1	17	0	18	35	0	0
10	1711136	.	T	C	18	22	40	0	1	41	0	0
10	1711188	.	T	A	23	19	42	0	3	45	0	0
10	1711211	.	C	T	22	15	37	0	1	38	0	0
10	1711711	.	G	A	12	16	28	0	0	28	0	0
10	1711780	.	C	T	2	13	15	0	6	21	0	0
10	1711854	.	G	T	3	13	16	0	21	37	0	0
10	1712091	.	G	A	8	7	15	0	3	18	0	0
10	1712100	.	T	A	9	5	14	0	3	17	0	0
10	1712306	.	G	A	9	21	30	0	3	33	0	0
10	1712316	.	C	T	6	22	28	0	3	31	0	0
10	1712496	.	C	T	18	4	22	3	0	25	0	0
10	1712499	.	G	A	19	3	22	3	0	25	0	0
10	1712658	.	G	A	17	13	30	0	2	32	0	0
10	1712757	.	A	G	16	10	26	0	2	28	0	0
10	1712899	.	A	T	22	14	36	0	5	41	0	0
10	1712964	.	T	G	36	1	37	1	0	38	0	0
10	1713418	.	T	C	15	7	22	0	4	26	0	0
10	1718294	.	C	A	16	19	35	0	3	38	0	0
10	1745541	.	A	T	1	2	3	0	1	4	0	0
10	1745738	.	T	A	10	7	17	0	0	17	0	0
10	1752113	.	T	A	3	5	8	0	2	10	0	0
10	1782968	.	C	G	1	2	3	0	0	3	0	0
10	1869328	.	C	T	1	3	4	0	0	4	0	0
10	1880470	.	A	G	5	3	8	0	0	8	0	0
10	1880734	.	C	T	1	3	4	0	0	4	0	0
10	1886265	.	C	G	2	4	6	0	0	6	0	0
10	1886587	.	T	C	3	4	7	0	0	7	0	0
10	1886590	.	T	A	4	4	8	0	1	9	0	0
10	1886764	.	T	C	4	3	7	0	0	7	0	0
10	1887238	.	C	T	6	3	9	0	0	9	0	0
10	1887364	.	C	T	2	3	5	0	0	5	0	0
10	1887496	.	A	G	7	0	7	0	6	13	0	0
10	1887811	.	A	G	6	4	10	0	0	10	0	0
10	1888135	.	G	C	3	4	7	0	0	7	0	0
10	1888222	.	C	T	6	8	14	0	0	14	0	0
10	1888225	.	G	A	5	7	12	0	1	13	0	0
10	1888303	.	C	T	5	7	12	0	0	12	0	0
10	1888414	.	T	C	10	7	17	0	0	17	0	0
10	1888438	.	C	T	12	7	19	0	0	19	0	0
10	1888487	.	T	C	10	8	18	0	0	18	0	0
10	1888515	.	C	T	8	10	18	0	0	18	0	0
10	1888824	.	C	T	5	7	12	0	0	12	0	0
10	1888893	.	C	T	8	8	16	0	1	17	0	0
10	1889171	.	G	T	9	14	23	0	0	23	0	0
10	1889179	.	A	G	6	1	7	0	13	20	0	0
10	1889255	.	C	T	7	9	16	0	0	16	0	0
10	1889296	.	C	T	10	6	16	0	0	16	0	0
10	1889882	.	A	C	12	8	20	0	1	21	0	0
10	1890313	.	A	G	16	12	28	0	0	28	0	0
10	1890481	.	T	G	10	0	10	0	29	39	0	0
10	1890949	.	T	C	16	14	30	0	2	32	0	0
10	1890961	.	G	A	17	15	32	0	0	32	0	0
10	1891018	.	G	A	3	15	18	0	15	33	0	0
10	1891660	.	G	C	16	16	32	0	1	33	0	0
10	1891724	.	G	C	25	22	47	0	3	50	0	0
10	1892516	.	G	A	17	16	33	0	2	35	0	0
10	1893073	.	T	A	0	2	2	0	1	3	0	0
10	2261897	.	A	T	1	2	3	0	0	3	0	0
10	2288974	.	A	G	2	3	5	0	0	5	0	0
10	2294325	.	G	A	6	3	9	0	0	9	0	0
10	2339274	.	C	T	4	2	6	2	0	8	0	0
10	2354973	.	C	A	4	2	6	0	0	6	0	0
10	2367762	.	C	T	5	5	10	0	0	10	0	0
10	2393715	.	G	A	25	14	39	0	1	40	0	0
10	2393763	.	G	C	16	23	39	0	3	42	0	0
10	2504174	.	G	T	9	7	16	0	2	18	0	0
10	2504210	.	C	T	1	12	13	0	12	25	0	0
10	2506081	.	G	A	15	11	26	0	1	27	0	0
10	2508347	.	T	C	7	1	8	0	6	14	0	0
10	2510397	.	C	G	0	6	6	0	9	15	0	0
10	2515351	.	T	G	4	3	7	0	0	7	0	0
10	2515447	.	T	C	3	0	3	0	5	8	0	0
10	2526413	.	A	G	1	3	4	0	0	4	0	0
10	2542000	.	C	T	2	2	4	0	0	4	0	0
10	2575369	.	T	C	7	6	13	0	0	13	0	0
10	2661542	.	C	G	1	2	3	0	1	4	0	0
10	2663002	.	C	T	1	2	3	0	0	3	0	0
10	2666480	.	A	G	2	2	4	0	1	5	0	0
10	2681622	.	C	T	6	3	9	0	0	9	0	0
10	2681771	.	G	A	6	4	10	0	0	10	0	0
10	2681800	.	C	T	2	5	7	0	9	16	0	0
10	2697434	.	A	G	2	1	3	0	1	4	0	0
10	2697449	.	C	T	0	2	2	0	3	5	0	0
10	2700572	.	G	A	1	4	5	0	0	5	0	0
10	2704752	.	G	T	3	2	5	0	0	5	0	0
10	2759276	.	G	A	14	10	24	0	2	26	0	0
10	2759329	.	T	G	13	14	27	0	2	29	0	0
10	2759381	.	G	C	14	26	40	0	2	42	0	0
10	2759391	.	A	T	14	25	39	0	1	41	1	0
10	2772036	.	G	A	5	5	10	0	2	12	0	0
10	2772057	.	G	A	7	4	11	0	1	12	0	0
10	2778444	.	G	A	7	2	9	0	1	10	0	0
10	2782761	.	G	A	2	3	5	0	0	5	0	0
10	2784391	.	A	G	4	4	8	0	0	8	0	0
10	2788649	.	A	T	4	7	11	0	0	11	0	0
10	2836689	.	A	G	3	2	5	0	0	5	0	0
10	2850675	.	A	G	4	0	4	0	5	9	0	0
10	2888166	.	C	A	5	6	11	0	0	11	0	0
10	2891905	.	G	A	5	6	11	0	0	11	0	0
10	2894148	.	G	C	5	7	12	0	1	13	0	0
10	2894193	.	T	G	8	0	8	0	10	18	0	0
10	2894545	.	C	T	12	9	21	0	0	21	0	0
10	2897110	.	A	C	10	8	18	0	1	19	0	0
10	2897720	.	T	A	9	19	28	0	1	29	0	0
10	2897817	.	T	G	14	2	16	0	10	26	0	0
10	2897897	.	A	G	4	5	9	0	2	11	0	0
10	2897911	.	G	T	3	7	10	0	1	11	0	0
10	2898087	.	T	C	3	4	7	0	0	7	0	0
10	2898260	.	T	G	9	7	16	1	1	18	0	0
10	2898269	.	C	T	4	9	13	0	3	16	0	0
10	2898346	.	T	A	8	8	16	0	0	16	0	0
10	2898390	.	A	T	4	6	10	0	0	10	0	0
10	2915399	.	G	A	1	4	5	0	0	5	0	0
10	2915412	.	A	G	1	3	4	0	0	4	0	0
10	2916931	.	A	T	1	2	3	0	2	5	0	0
10	2920032	.	C	T	3	4	7	0	0	7	0	0
10	2921236	.	T	C	2	8	10	3	1	14	0	0
10	2984557	.	T	C	2	4	6	0	0	6	0	0
10	3007051	.	A	C	2	5	7	0	0	7	0	0
10	3024637	.	C	G	3	5	8	0	0	8	0	0
10	3026264	.	A	C	4	4	8	0	0	8	0	0
10	3026376	.	A	G	5	2	7	0	0	7	0	0
10	3031670	.	T	C	4	0	4	0	4	8	0	0
10	3031760	.	A	G	7	6	13	0	2	15	0	0
10	3032353	.	T	A	0	4	4	0	1	5	0	0
10	3308482	.	G	A	1	4	5	0	4	9	0	0
10	3311737	.	T	G	4	6	10	0	0	10	0	0
10	3314596	.	T	C	5	8	13	0	0	13	0	0
10	3317976	.	G	A	3	3	6	0	6	12	0	0
10	3318005	.	G	C	2	6	8	0	5	13	0	0
10	3318060	.	G	A	4	5	9	0	0	9	0	0
10	3319873	.	A	G	10	0	10	0	8	18	0	0
10	3319890	.	G	T	0	9	9	0	13	22	0	0
10	3319938	.	C	T	11	6	17	0	0	17	0	0
10	3320007	.	C	G	9	8	17	0	3	20	0	0
10	3320015	.	T	C	13	7	20	0	1	21	0	0
10	3320151	.	A	G	16	15	31	0	1	32	0	0
10	3320194	.	G	A	16	11	27	0	1	28	0	0
10	3320229	.	G	A	11	13	24	0	1	25	0	0
10	3320465	.	C	G	9	11	20	0	2	22	0	0
10	3320495	.	A	T	17	15	32	0	1	33	0	0
10	3320506	.	C	T	15	17	32	0	1	33	0	0
10	3320705	.	G	A	16	13	29	0	1	30	0	0
10	3320776	.	C	T	14	22	36	0	1	37	0	0
10	3320850	.	C	T	15	13	28	0	1	29	0	0
10	3320887	.	G	A	15	9	24	0	1	25	0	0
10	3321262	.	A	G	12	27	39	0	5	44	0	0
10	3321416	.	T	G	14	13	27	0	1	28	0	0
10	3336838	.	C	T	2	1	3	0	0	3	0	0
10	3336846	.	T	A	2	2	4	0	0	4	0	0
10	3341412	.	C	T	2	4	6	0	0	6	0	0
10	3353607	.	C	T	6	5	11	0	0	11	0	0
10	3353622	.	A	G	8	6	14	0	0	14	0	0
10	3354048	.	A	G	7	9	16	0	2	18	0	0
10	3358897	.	A	T	17	9	26	0	1	27	0	0
10	3364772	.	A	T	5	12	17	0	0	17	0	0
10	3365063	.	C	T	2	10	12	0	15	27	0	0
10	3365312	.	T	C	9	7	16	0	0	16	0	0
10	3365726	.	A	C	23	0	23	1	2	26	0	0
10	3365834	.	A	T	8	12	20	0	1	21	0	0
10	3366095	.	C	T	0	12	12	0	11	23	0	0
10	3366199	.	C	T	1	7	8	0	9	17	0	0
10	3370680	.	G	A	3	2	5	0	0	5	0	0
10	3371866	.	G	A	5	4	9	0	1	10	0	0
10	3371921	.	A	G	4	2	6	0	1	7	0	0
10	3379107	.	T	C	1	0	1	0	2	3	0	0
10	3398215	.	G	T	2	4	6	0	0	6	0	0
10	3400093	.	T	C	7	4	11	0	0	11	0	0
10	3400126	.	A	T	3	6	9	0	0	9	0	0
10	3400216	.	C	T	6	5	11	0	0	11	0	0
10	3400225	.	T	C	6	4	10	0	1	11	0	0
10	3403764	.	C	T	0	5	5	0	6	11	0	0
10	3408009	.	G	A	2	3	5	0	0	5	0	0
10	3420097	.	A	T	24	18	42	0	1	43	0	0
10	3426363	.	G	A	18	14	32	0	2	34	0	0
10	3430894	.	C	G	1	3	4	0	0	4	0	0
10	3434883	.	C	T	2	2	4	0	0	4	0	0
10	3436370	.	C	T	4	4	8	0	1	9	0	0
10	3438991	.	T	C	1	3	4	0	1	5	0	0
10	3439018	.	A	G	3	3	6	0	0	6	0	0
10	3441973	.	T	C	4	3	7	0	0	7	0	0
10	3442030	.	T	C	2	4	6	0	0	6	0	0
10	3445818	.	C	T	7	5	12	0	0	12	0	0
10	3450861	.	A	G	5	4	9	0	1	10	0	0
10	3451091	.	G	A	4	4	8	0	0	8	0	0
10	3451429	.	G	A	2	11	13	0	9	22	0	0
10	3451672	.	A	G	6	5	11	0	2	13	0	0
10	3451688	.	C	T	6	6	12	0	0	12	0	0
10	3451848	.	G	A	0	6	6	0	3	9	0	0
10	3451864	.	C	T	6	2	8	0	1	9	0	0
10	3452045	.	G	A	8	2	10	0	0	10	0	0
10	3452073	.	A	G	10	6	16	0	0	16	0	0
10	3452124	.	A	G	7	11	18	0	0	18	0	0
10	3452183	.	G	A	12	5	17	0	1	18	0	0
10	3452185	.	T	A	12	5	17	0	1	18	0	0
10	3969887	.	C	T	3	2	5	0	0	5	0	0
10	3979870	.	G	A	2	3	5	0	1	6	0	0
10	3979876	.	C	A	2	3	5	0	1	6	0	0
10	4010300	.	A	G	1	2	3	0	0	3	0	0
10	4016017	.	G	A	2	2	4	0	0	4	0	0
10	4029507	.	T	C	2	2	4	0	1	5	0	0
10	4030211	.	A	T	4	2	6	0	0	6	0	0
10	4037287	.	G	A	5	4	9	0	0	9	0	0
10	4038772	.	G	A	7	10	17	0	0	17	0	0
10	4038898	.	A	G	10	5	15	0	2	17	0	0
10	4039123	.	C	T	12	16	28	0	2	30	0	0
10	4039129	.	C	T	11	13	24	0	5	29	0	0
10	4240887	.	T	C	12	10	22	0	0	22	0	0
10	4240899	.	C	T	12	10	22	0	1	23	0	0
10	4279623	.	C	A	1	4	5	0	0	5	0	0
10	4279695	.	T	C	4	2	6	0	2	8	0	0
10	4279800	.	A	G	2	4	6	0	0	6	0	0
10	4284081	.	A	G	4	2	6	0	0	6	0	0
10	4501609	.	C	T	5	5	10	0	0	10	0	0
10	4501733	.	G	A	5	6	11	0	0	11	0	0
10	4501817	.	A	G	7	4	11	0	0	11	0	0
10	4503291	.	G	T	13	3	16	0	3	19	0	0
10	4503736	.	C	T	13	8	21	0	0	21	0	0
10	4503901	.	C	G	11	9	20	0	1	21	0	0
10	4505886	.	T	A	17	11	28	0	1	29	0	0
10	4505887	.	T	A	16	11	27	0	2	29	0	0
10	4508492	.	T	A	18	10	28	0	0	28	0	0
10	4508518	.	G	T	2	13	15	0	14	29	0	0
10	4896742	.	G	A	4	2	6	0	0	6	0	0
10	4896766	.	G	A	4	3	7	0	0	7	0	0
10	4941342	.	G	C	6	10	16	0	2	18	0	0
10	4941421	.	T	G	9	8	17	0	0	17	0	0
10	4950824	.	G	T	3	8	11	0	0	11	0	0
10	4956906	.	C	T	5	4	9	0	1	10	0	0
10	4956966	.	G	A	3	8	11	0	1	12	0	0
10	4968900	.	G	C	11	17	28	0	1	29	0	0
10	4969014	.	T	A	9	11	20	0	1	21	0	0
10	4969036	.	T	G	5	1	6	0	11	17	0	0
10	4969069	.	C	A	3	11	14	0	0	14	0	0
10	5000719	.	C	T	2	15	17	3	14	34	0	0
10	5000753	.	C	T	0	13	13	0	25	38	0	0
10	5004215	.	C	T	11	7	18	0	0	18	0	0
10	5010287	.	G	A	15	22	37	0	5	42	0	0
10	5010344	.	T	G	20	20	40	0	3	43	0	0
10	5010407	.	G	A	14	22	36	0	2	38	0	0
10	5016797	.	G	A	19	27	46	0	4	50	0	0
10	5016917	.	C	G	24	27	51	0	0	51	0	0
10	5016922	.	A	G	22	26	48	0	3	51	0	0
10	5020320	.	G	A	30	34	64	0	2	66	0	0
10	5020326	.	T	C	36	26	62	0	3	65	0	0
10	5024410	.	C	T	22	27	49	0	0	49	0	0
10	5025848	.	C	A	7	9	16	0	0	16	0	0
10	5026058	.	C	T	11	10	21	0	1	22	0	0
10	5028877	.	A	G	8	11	19	0	1	20	0	0
10	5031869	.	T	C	7	7	14	0	3	17	0	0
10	5036521	.	G	A	0	14	14	0	11	25	0	0
10	5036522	.	A	G	11	14	25	0	0	25	0	0
10	5036729	.	C	T	10	6	16	0	1	17	0	0
10	5036881	.	A	G	3	1	4	0	3	7	0	0
10	5037119	.	T	A	11	7	18	0	0	18	0	0
10	5037147	.	C	T	8	9	17	0	1	18	0	0
10	5037181	.	T	G	12	9	21	0	0	21	0	0
10	5037354	.	C	A	13	2	15	0	5	20	0	0
10	5037372	.	A	T	13	5	18	0	4	22	0	0
10	5042113	.	C	T	4	3	7	0	0	7	0	0
10	5042217	.	A	G	6	3	9	0	0	9	0	0
10	5042469	.	G	A	5	3	8	0	3	11	0	0
10	5047452	.	A	G	3	5	8	0	1	9	0	0
10	5053518	.	C	G	2	2	4	0	1	5	0	0
10	5053556	.	T	C	3	3	6	0	0	6	0	0
10	5092764	.	T	C	7	7	14	4	1	19	0	0
10	5092772	.	A	G	6	6	12	6	1	19	0	0
10	5093121	.	C	G	0	7	7	8	2	17	0	0
10	5093157	.	T	C	5	16	21	1	1	23	0	0
10	5093222	.	A	G	14	10	24	0	0	24	0	0
10	5093240	.	C	A	9	7	16	0	1	17	0	0
10	5093274	.	A	G	4	5	9	2	1	12	0	0
10	5094649	.	C	A	5	6	11	0	1	12	0	0
10	5094778	.	G	T	6	4	10	0	1	11	0	0
10	5097478	.	G	A	3	3	6	0	0	6	0	0
10	5097520	.	A	G	2	9	11	0	0	11	0	0
10	5147061	.	A	G	1	3	4	0	0	4	0	0
10	5203569	.	G	A	2	5	7	0	0	7	0	0
10	5216204	.	T	C	3	5	8	0	1	9	0	0
10	5216249	.	A	G	5	9	14	0	1	15	0	0
10	5220608	.	C	T	7	10	17	0	0	17	0	0
10	5220835	.	G	A	2	5	7	1	2	10	0	0
10	5220992	.	C	T	4	7	11	0	0	11	0	0
10	5220997	.	C	A	7	4	11	0	0	11	0	0
10	5221039	.	G	A	6	6	12	0	0	12	0	0
10	5221199	.	T	A	2	3	5	0	0	5	0	0
10	5221238	.	C	A	2	7	9	0	0	9	0	0
10	5221292	.	C	A	9	6	15	0	1	16	0	0
10	5221297	.	T	G	7	8	15	0	0	15	0	0
10	5221336	.	G	C	7	6	13	0	0	13	0	0
10	5248247	.	T	C	2	4	6	0	0	6	0	0
10	5257980	.	C	T	4	4	8	0	0	8	0	0
10	5258914	.	T	A	7	4	11	0	2	13	0	0
10	5264280	.	A	G	10	8	18	0	1	19	0	0
10	5264310	.	G	A	5	7	12	0	3	15	0	0
10	5264458	.	G	A	5	7	12	0	0	12	0	0
10	5264534	.	C	A	6	4	10	0	0	10	0	0
10	5264809	.	T	A	2	3	5	0	0	5	0	0
10	5264828	.	A	C	2	2	4	0	0	4	0	0
10	5265047	.	T	A	2	2	4	0	0	4	0	0
10	5410607	.	T	G	1	4	5	0	1	6	0	0
10	5414339	.	C	T	2	5	7	0	0	7	0	0
10	5417669	.	T	A	6	4	10	0	1	11	0	0
10	5417841	.	A	C	3	2	5	0	0	5	0	0
10	5418509	.	A	G	9	6	15	0	2	17	0	0
10	5418569	.	C	T	9	6	15	0	1	16	0	0
10	5429905	.	G	A	1	2	3	0	4	7	0	0
10	5432576	.	T	C	2	3	5	0	0	5	0	0
10	5461988	.	C	A	1	6	7	0	1	9	1	0
10	5475206	.	G	C	6	10	16	0	0	16	0	0
10	5475214	.	T	G	6	9	15	0	1	16	0	0
10	5475406	.	A	T	3	2	5	0	1	6	0	0
10	5475436	.	A	G	4	4	8	0	1	9	0	0
10	5475526	.	T	C	11	7	18	0	1	19	0	0
10	5534179	.	T	A	12	4	16	0	1	17	0	0
10	5534183	.	T	C	11	1	12	0	3	15	0	0
10	5534369	.	T	A	3	4	7	0	0	7	0	0
10	5534527	.	G	T	7	4	11	0	0	11	0	0
10	5534539	.	G	A	6	4	10	0	0	10	0	0
10	5534611	.	C	T	5	6	11	0	0	11	0	0
10	5534612	.	A	G	5	6	11	0	0	11	0	0
10	5534646	.	A	G	5	9	14	0	0	14	0	0
10	5534878	.	C	T	11	12	23	0	1	24	0	0
10	5534946	.	A	G	11	10	21	0	0	21	0	0
10	5534950	.	A	T	11	10	21	0	1	22	0	0
10	5535359	.	A	T	9	8	17	0	0	17	0	0
10	5535368	.	T	A	11	7	18	0	0	18	0	0
10	5535436	.	C	T	6	7	13	0	1	14	0	0
10	5535445	.	T	C	5	8	13	0	1	14	0	0
10	5535483	.	A	T	9	9	18	0	2	20	0	0
10	5535540	.	T	G	12	6	18	0	3	21	0	0
10	5535561	.	T	A	10	8	18	0	0	18	0	0
10	5536240	.	T	C	2	3	5	0	0	5	0	0
10	5536534	.	T	A	3	4	7	0	0	7	0	0
10	5537048	.	G	T	6	7	13	0	0	13	0	0
10	5538302	.	T	G	4	5	9	0	0	9	0	0
10	5542152	.	T	C	5	2	7	0	0	7	0	0
10	5545438	.	C	T	6	4	10	0	0	10	0	0
10	5545465	.	T	C	5	6	11	0	0	11	0	0
10	5568128	.	G	T	1	2	3	0	0	3	0	0
10	5568212	.	G	A	4	3	7	0	0	7	0	0
10	5667467	.	T	A	6	2	8	0	0	8	0	0
10	5667605	.	C	T	4	2	6	0	0	6	0	0
10	5667792	.	G	A	3	3	6	0	1	7	0	0
10	5667906	.	C	A	2	2	4	0	1	5	0	0
10	5668103	.	C	T	3	4	7	0	0	7	0	0
10	5668135	.	G	A	3	6	9	0	1	10	0	0
10	5668218	.	G	C	8	8	16	0	0	16	0	0
10	5724020	.	T	C	2	4	6	0	0	6	0	0
10	5724095	.	T	C	1	7	8	0	0	8	0	0
10	5745015	.	C	A	10	11	21	0	1	22	0	0
10	5745290	.	T	C	10	9	19	0	2	21	0	0
10	5745299	.	C	T	10	10	20	0	1	21	0	0
10	5760455	.	T	C	13	9	22	0	1	23	0	0
10	5760461	.	A	G	10	8	18	0	3	21	0	0
10	5766958	.	A	G	16	14	30	0	0	30	0	0
10	5769541	.	G	T	17	7	24	0	2	26	0	0
10	5772568	.	A	G	17	24	41	0	7	48	0	0
10	5782337	.	C	T	31	32	63	0	0	63	0	0
10	5788755	.	A	C	7	5	12	0	3	15	0	0
10	5788806	.	G	A	10	5	15	0	2	17	0	0
10	5788877	.	G	A	5	7	12	0	0	12	0	0
10	5789059	.	A	G	9	8	17	0	0	17	0	0
10	5789155	.	G	T	9	3	12	0	0	12	0	0
10	5789241	.	T	C	8	3	11	0	2	13	0	0
10	5789415	.	A	G	4	5	9	0	0	9	0	0
10	5789417	.	G	C	4	5	9	0	0	9	0	0
10	5789758	.	G	T	2	6	8	0	2	10	0	0
10	5789806	.	C	T	7	7	14	0	0	14	0	0
10	5789995	.	C	T	4	3	7	0	1	8	0	0
10	5790080	.	A	G	7	10	17	1	0	18	0	0
10	5790097	.	G	A	6	6	12	1	0	13	0	0
10	5790210	.	C	T	8	8	16	0	5	21	0	0
10	5790278	.	G	T	9	4	13	1	0	14	0	0
10	5790570	.	A	C	6	5	11	0	0	11	0	0
10	5790640	.	T	G	2	5	7	0	0	7	0	0
10	5790866	.	A	C	6	10	16	0	0	16	0	0
10	5790913	.	A	C	4	6	10	0	0	10	0	0
10	5790922	.	C	A	5	5	10	0	0	10	0	0
10	5790956	.	C	G	0	6	6	0	6	12	0	0
10	5791030	.	A	G	6	11	17	0	0	17	0	0
10	5791044	.	C	T	1	9	10	0	7	17	0	0
10	5791184	.	G	A	3	8	11	0	2	13	0	0
10	5791224	.	C	G	3	5	8	0	2	10	0	0
10	5791238	.	A	G	3	6	9	0	0	9	0	0
10	5791377	.	A	T	7	4	11	0	1	12	0	0
10	5791387	.	G	A	8	3	11	0	0	11	0	0
10	5791417	.	C	T	0	6	6	0	5	11	0	0
10	5792512	.	A	T	5	9	14	0	0	14	0	0
10	5792533	.	A	T	5	6	11	0	1	12	0	0
10	5792573	.	G	A	4	3	7	0	1	8	0	0
10	5792584	.	A	G	5	3	8	0	0	8	0	0
10	5792615	.	A	G	3	3	6	0	0	6	0	0
10	5792667	.	G	A	1	7	8	0	0	8	0	0
10	5792722	.	T	C	2	0	2	0	5	7	0	0
10	5792757	.	A	G	2	3	5	0	1	6	0	0
10	5793376	.	G	A	1	3	4	0	0	4	0	0
10	5793425	.	C	A	1	2	3	0	1	4	0	0
10	5793568	.	T	A	2	2	4	0	0	4	0	0
10	5796929	.	C	T	0	2	2	0	1	3	0	0
10	5828645	.	A	G	6	7	13	0	2	15	0	0
10	5828660	.	A	G	8	10	18	0	0	18	0	0
10	5828704	.	C	A	1	8	9	0	7	16	0	0
10	5828840	.	A	G	2	4	6	0	0	6	0	0
10	5828945	.	A	G	3	6	9	0	2	11	0	0
10	5834171	.	C	T	7	8	15	0	0	15	0	0
10	5834242	.	G	A	4	3	7	0	0	7	0	0
10	5837337	.	G	A	2	2	4	0	0	4	0	0
10	5844718	.	G	A	2	2	4	0	1	5	0	0
10	6023946	.	T	C	2	3	5	0	0	5	0	0
10	6023958	.	G	A	4	3	7	0	0	7	0	0
10	6032880	.	A	G	6	0	6	0	8	14	0	0
10	6032886	.	G	A	5	7	12	0	2	14	0	0
10	6033452	.	T	C	3	4	7	0	0	7	0	0
10	6033469	.	A	C	3	6	9	0	0	9	0	0
10	6033612	.	G	A	1	12	13	0	6	19	0	0
10	6033627	.	A	T	6	10	16	0	0	16	0	0
10	6034194	.	A	T	11	9	20	0	1	21	0	0
10	6034362	.	G	A	3	3	6	0	0	6	0	0
10	6034376	.	G	A	2	3	5	0	0	5	0	0
10	6278202	.	A	G	3	3	6	0	0	6	0	0
10	6280939	.	G	A	0	2	2	0	3	5	0	0
10	6280948	.	G	A	0	2	2	0	2	4	0	0
10	6301828	.	C	T	3	4	7	0	0	7	0	0
10	6301930	.	C	T	13	8	21	0	1	22	0	0
10	6312954	.	A	T	3	8	11	0	0	11	0	0
10	6313465	.	A	G	3	0	3	0	4	7	0	0
10	6313643	.	C	T	2	5	7	0	2	9	0	0
10	6348571	.	C	A	4	4	8	1	0	9	0	0
10	6372501	.	C	T	10	3	13	0	0	13	0	0
10	6372915	.	G	A	9	7	16	0	0	16	0	0
10	6372964	.	T	C	8	4	12	0	2	14	0	0
10	6373003	.	T	C	5	2	7	0	0	7	0	0
10	6373079	.	C	G	3	4	7	0	0	7	0	0
10	6373332	.	A	T	5	4	9	0	0	9	0	0
10	6373336	.	C	G	6	4	10	0	0	10	0	0
10	6373472	.	T	A	5	4	9	0	0	9	0	0
10	6373522	.	A	G	4	4	8	0	1	12	3	0
10	6373524	.	A	G	5	5	10	0	1	11	0	0
10	6373758	.	A	C	15	10	25	0	0	25	0	0
10	6374017	.	A	G	10	8	18	0	2	20	0	0
10	6374041	.	A	T	7	12	19	0	2	21	0	0
10	6374068	.	G	T	9	8	17	0	3	20	0	0
10	6374235	.	T	C	14	15	29	0	2	31	0	0
10	6374279	.	G	A	2	20	22	0	16	38	0	0
10	6374352	.	C	T	20	16	36	0	0	36	0	0
10	6374372	.	A	G	14	24	38	0	1	39	0	0
10	6374388	.	C	T	20	12	32	0	2	34	0	0
10	6374415	.	C	T	15	13	28	0	0	28	0	0
10	6374501	.	A	G	6	12	18	0	2	20	0	0
10	6402213	.	T	A	2	3	5	0	0	5	0	0
10	6402742	.	C	G	4	2	6	0	0	6	0	0
10	6404764	.	G	C	1	2	3	0	0	3	0	0
10	6406142	.	T	A	1	3	4	0	0	4	0	0
10	6406246	.	T	A	2	2	4	0	0	4	0	0
10	6406254	.	G	T	2	2	4	0	0	4	0	0
10	6406298	.	G	A	1	3	4	0	0	4	0	0
10	6406601	.	T	G	2	4	6	0	1	7	0	0
10	6406635	.	C	T	4	3	7	0	0	7	0	0
10	6407449	.	C	T	5	2	7	0	0	7	0	0
10	6407475	.	G	A	0	4	4	0	1	5	0	0
10	6407559	.	A	T	4	3	7	0	0	7	0	0
10	6407605	.	C	A	3	3	6	0	1	7	0	0
10	6407744	.	A	G	3	3	6	0	0	8	2	0
10	6407764	.	C	A	4	5	9	0	0	9	0	0
10	6407833	.	T	C	6	3	9	0	0	9	0	0
10	6408955	.	T	G	10	0	10	0	6	17	1	0
10	6408986	.	A	G	8	6	14	0	2	16	0	0
10	6409095	.	G	A	0	4	4	0	15	19	0	0
10	6409120	.	G	A	11	6	17	0	0	17	0	0
10	6409145	.	G	C	12	4	16	0	1	17	0	0
10	6409267	.	C	A	3	9	12	0	0	12	0	0
10	6409379	.	A	G	5	10	15	0	2	17	0	0
10	6409448	.	C	T	7	6	13	0	0	13	0	0
10	6409455	.	T	A	6	8	14	0	0	14	0	0
10	6409506	.	A	G	10	8	18	0	0	18	0	0
10	6409583	.	C	T	7	5	12	0	1	13	0	0
10	6409695	.	C	A	1	2	3	0	1	4	0	0
10	6473544	.	T	C	13	10	23	0	3	26	0	0
10	6473685	.	T	C	7	16	23	0	2	25	0	0
10	6473704	.	C	G	12	15	27	0	0	27	0	0
10	6473851	.	A	G	19	16	35	0	0	35	0	0
10	6473862	.	C	T	3	14	17	0	17	34	0	0
10	6473908	.	A	G	9	14	23	0	0	23	0	0
10	6473996	.	T	C	12	7	19	0	0	19	0	0
10	6474057	.	T	A	6	18	24	0	3	27	0	0
10	6479444	.	T	C	10	1	11	0	13	24	0	0
10	6479471	.	C	T	1	12	13	0	10	23	0	0
10	6510756	.	T	C	20	24	44	0	2	46	0	0
10	6510786	.	T	G	18	21	39	0	4	43	0	0
10	6510825	.	T	C	17	24	41	0	4	45	0	0
10	6517593	.	T	A	31	26	57	0	0	57	0	0
10	6517663	.	A	G	27	2	29	0	19	48	0	0
10	6517726	.	C	T	22	16	38	0	5	43	0	0
10	6517959	.	A	G	19	16	35	0	2	37	0	0
10	6522267	.	A	T	7	7	14	0	0	14	0	0
10	6528005	.	A	G	6	5	11	0	1	12	0	0
10	6531002	.	A	G	7	6	13	0	3	16	0	0
10	6531297	.	T	C	6	6	12	0	0	12	0	0
10	6533850	.	T	A	2	5	7	0	1	8	0	0
10	6546851	.	A	G	1	3	4	0	0	4	0	0
10	6549360	.	C	T	3	2	5	0	0	5	0	0
10	6781239	.	G	A	5	7	12	1	0	13	0	0
10	6781278	.	T	A	8	10	18	0	1	19	0	0
10	6781286	.	G	T	10	9	19	0	0	19	0	0
10	6781362	.	G	A	11	21	32	0	0	32	0	0
10	6781372	.	T	A	13	21	34	0	3	37	0	0
10	6781450	.	T	C	17	14	31	0	5	36	0	0
10	6781506	.	A	T	12	16	28	0	0	28	0	0
10	6781664	.	A	T	16	12	28	0	1	29	0	0
10	6781742	.	G	T	7	17	24	0	1	25	0	0
10	6781786	.	A	T	9	9	18	0	0	18	0	0
10	6781867	.	C	A	11	9	20	0	2	22	0	0
10	6781903	.	T	G	7	19	26	0	1	27	0	0
10	6781918	.	A	T	6	20	26	0	1	27	0	0
10	6782020	.	G	C	9	16	25	0	0	25	0	0
10	6782036	.	T	C	14	0	14	0	9	23	0	0
10	6782220	.	A	G	7	6	13	2	1	16	0	0
10	6782267	.	T	A	6	3	9	4	0	13	0	0
10	6782279	.	A	C	6	5	11	2	0	13	0	0
10	6782454	.	C	G	7	21	28	0	4	32	0	0
10	6782489	.	T	G	11	17	28	0	1	29	0	0
10	6782624	.	A	G	14	26	40	0	1	41	0	0
10	6782636	.	T	A	15	27	42	0	1	43	0	0
10	6782664	.	A	G	16	26	42	0	2	44	0	0
10	6786326	.	C	T	0	22	22	0	11	33	0	0
10	6786564	.	A	G	20	15	35	0	1	36	0	0
10	6804756	.	T	C	8	1	9	0	9	18	0	0
10	6824761	.	A	C	10	8	18	0	1	19	0	0
10	6824845	.	A	T	5	8	13	0	0	13	0	0
10	6824877	.	T	G	4	7	11	0	0	11	0	0
10	6831298	.	C	T	0	3	3	0	3	6	0	0
10	6831446	.	T	C	2	5	7	0	1	8	0	0
10	6834065	.	A	T	4	7	11	0	0	11	0	0
10	6834341	.	G	A	3	9	12	0	0	12	0	0
10	6834380	.	C	A	1	4	5	1	3	9	0	0
10	6851184	.	C	A	2	6	8	0	0	8	0	0
10	6944199	.	G	C	1	3	4	0	0	4	0	0
10	7210001	.	G	A	1	10	11	0	13	24	0	0
10	7221810	.	A	G	15	5	20	0	0	20	0	0
10	7222213	.	T	C	11	17	28	0	1	29	0	0
10	7224964	.	A	G	17	21	38	0	0	38	0	0
10	7231728	.	T	C	22	19	41	0	4	45	0	0
10	7231821	.	T	A	27	18	45	0	0	45	0	0
10	7231964	.	G	C	14	23	37	0	2	39	0	0
10	7232043	.	T	A	19	14	33	0	1	34	0	0
10	7232058	.	G	T	0	11	11	0	16	27	0	0
10	7232104	.	A	T	17	8	25	0	0	25	0	0
10	7232309	.	C	T	5	6	11	1	0	12	0	0
10	7232416	.	T	C	14	16	30	0	1	32	1	0
10	7232420	.	T	C	13	17	30	0	3	33	0	0
10	7233038	.	T	C	29	14	43	0	2	45	0	0
10	7233218	.	A	G	22	22	44	0	3	47	0	0
10	7233440	.	A	T	27	30	57	0	5	62	0	0
10	7233457	.	C	G	29	30	59	0	3	62	0	0
10	7233518	.	T	C	32	26	58	0	3	61	0	0
10	7233854	.	A	T	10	18	28	0	5	33	0	0
10	7233939	.	C	T	10	7	17	0	1	18	0	0
10	7284182	.	T	A	6	7	13	0	0	13	0	0
10	7284403	.	C	T	6	6	12	0	1	13	0	0
10	7284520	.	A	G	7	7	14	0	0	14	0	0
10	7284556	.	T	A	5	5	10	0	1	11	0	0
10	7284629	.	T	C	6	7	13	1	1	15	0	0
10	7311979	.	G	A	3	3	6	0	0	6	0	0
10	7311997	.	T	G	2	3	5	0	0	5	0	0
10	7312057	.	A	G	3	2	5	0	0	5	0	0
10	7564294	.	C	T	2	4	6	0	2	8	0	0
10	7593246	.	A	T	5	2	7	1	1	9	0	0
10	7593349	.	C	A	3	12	15	0	0	15	0	0
10	7617113	.	A	T	31	23	54	0	6	60	0	0
10	7617126	.	T	C	34	29	63	0	0	63	0	0
10	7617242	.	G	A	29	35	64	0	1	65	0	0
10	7617327	.	A	C	16	27	43	0	5	48	0	0
10	7617350	.	A	T	25	28	53	0	8	61	0	0
10	7617636	.	A	G	20	2	22	0	14	36	0	0
10	7640501	.	C	T	15	29	44	0	3	47	0	0
10	7640676	.	G	A	22	16	38	0	0	38	0	0
10	7653581	.	C	G	0	2	2	0	1	3	0	0
10	7653750	.	T	C	1	0	1	0	2	3	0	0
10	7671368	.	T	C	7	7	14	0	1	15	0	0
10	7671425	.	G	A	7	6	13	0	0	13	0	0
10	7672832	.	A	C	10	9	19	0	0	19	0	0
10	7672853	.	G	A	11	10	21	0	1	22	0	0
10	7673774	.	G	A	5	2	7	0	1	8	0	0
10	7673819	.	C	G	9	5	14	0	0	14	0	0
10	7673849	.	A	G	9	6	15	0	0	15	0	0
10	7674079	.	T	G	9	4	13	0	0	13	0	0
10	7674136	.	C	T	1	3	4	0	2	6	0	0
10	7674222	.	T	C	3	3	6	0	0	6	0	0
10	7674393	.	C	T	1	2	3	0	0	3	0	0
10	7674429	.	C	T	2	4	6	0	0	6	0	0
10	7674471	.	A	G	5	8	13	0	0	13	0	0
10	7674506	.	A	G	9	10	19	0	0	19	0	0
10	7678121	.	T	C	9	13	22	0	0	22	0	0
10	7678154	.	C	T	0	9	9	0	8	17	0	0
10	7678525	.	C	T	0	8	8	0	11	19	0	0
10	7700615	.	A	G	5	3	8	0	1	9	0	0
10	7700676	.	G	A	3	4	7	1	1	9	0	0
10	7701852	.	A	C	1	0	1	0	4	5	0	0
10	7709761	.	T	C	3	2	5	0	0	5	0	0
10	7712206	.	G	A	3	3	6	0	0	6	0	0
10	7713924	.	A	G	2	0	2	0	2	4	0	0
10	7721459	.	A	G	6	5	11	0	1	12	0	0
10	7721746	.	G	A	3	6	9	0	1	10	0	0
10	7722595	.	A	G	5	7	12	0	3	15	0	0
10	7722936	.	C	T	1	3	4	0	0	4	0	0
10	7723004	.	T	C	7	8	15	0	0	15	0	0
10	7723157	.	A	G	13	13	26	0	1	27	0	0
10	7723218	.	T	C	8	15	23	0	1	24	0	0
10	7723275	.	C	A	15	10	25	0	1	26	0	0
10	7723337	.	C	G	6	4	10	0	2	12	0	0
10	7723413	.	T	G	3	3	6	0	0	6	0	0
10	7727393	.	T	C	2	2	4	0	0	4	0	0
10	7727704	.	T	A	3	3	6	0	0	6	0	0
10	7734316	.	T	G	3	2	5	0	0	5	0	0
10	7734465	.	C	T	2	3	5	0	0	5	0	0
10	7770111	.	G	A	1	5	6	0	0	6	0	0
10	7770200	.	A	G	1	6	7	0	0	7	0	0
10	7770201	.	G	A	1	6	7	0	0	7	0	0
10	7771634	.	T	A	4	7	11	0	0	11	0	0
10	7771769	.	C	T	6	4	10	0	1	11	0	0
10	7771778	.	G	A	5	4	9	0	1	10	0	0
10	7772012	.	T	G	3	7	10	0	1	11	0	0
10	7772272	.	C	T	6	3	9	0	2	11	0	0
10	7804460	.	T	C	2	2	4	0	0	4	0	0
10	7804461	.	T	C	1	2	3	0	0	3	0	0
10	7810461	.	A	T	20	20	40	0	1	41	0	0
10	7810565	.	G	A	14	25	39	0	0	39	0	0
10	7811062	.	T	A	4	5	9	0	0	9	0	0
10	7811075	.	T	C	2	4	6	0	0	6	0	0
10	7811935	.	A	G	13	6	19	0	0	19	0	0
10	7815118	.	G	A	7	11	18	0	2	20	0	0
10	7815187	.	G	A	8	12	20	0	0	20	0	0
10	7821446	.	G	A	1	13	14	0	0	14	0	0
10	7831879	.	C	T	6	10	16	0	0	16	0	0
10	7901065	.	T	G	3	4	7	0	0	7	0	0
10	7902045	.	T	G	1	2	3	0	0	3	0	0
10	7916836	.	A	C	11	9	20	0	0	20	0	0
10	7916930	.	C	A	11	14	25	0	1	26	0	0
10	7917036	.	A	T	14	15	29	0	1	30	0	0
10	7917114	.	T	C	17	17	34	0	0	34	0	0
10	7917411	.	C	A	2	13	15	0	10	25	0	0
10	7917483	.	C	A	8	14	22	0	2	24	0	0
10	7917510	.	A	T	11	6	17	1	4	22	0	0
10	7917551	.	A	G	12	13	25	2	2	29	0	0
10	7917592	.	T	C	20	21	41	0	2	43	0	0
10	7917686	.	T	C	21	15	36	0	2	38	0	0
10	7917690	.	A	T	21	16	37	0	0	37	0	0
10	7920910	.	T	G	15	14	29	0	3	32	0	0
10	7920913	.	C	T	16	14	30	0	3	33	0	0
10	7922210	.	G	T	7	15	22	0	2	24	0	0
10	7922294	.	C	A	12	9	21	0	0	21	0	0
10	7926899	.	A	G	16	17	33	0	3	36	0	0
10	7929647	.	T	C	6	0	6	0	6	12	0	0
10	7936283	.	T	G	6	11	17	0	3	20	0	0
10	7938629	.	C	T	8	7	15	0	3	18	0	0
10	7938659	.	A	G	8	10	18	0	1	19	0	0
10	7938683	.	T	C	12	7	19	0	0	19	0	0
10	7959655	.	T	A	5	4	9	0	0	9	0	0
10	7968160	.	G	T	1	3	4	0	0	4	0	0
10	7968274	.	G	T	1	2	3	0	0	3	0	0
10	7984677	.	A	T	10	14	24	0	2	26	0	0
10	7986217	.	T	C	7	10	17	0	2	19	0	0
10	7986307	.	C	T	0	13	13	0	14	27	0	0
10	7986432	.	C	T	2	13	15	0	12	27	0	0
10	7989000	.	C	T	4	7	11	0	0	11	0	0
10	7989162	.	T	G	9	10	19	0	1	20	0	0
10	7989237	.	G	A	6	12	18	0	2	20	0	0
10	7989287	.	G	A	13	12	25	0	1	26	0	0
10	7989348	.	C	T	13	11	24	0	0	24	0	0
10	7989576	.	C	T	10	12	22	0	0	22	0	0
10	7992197	.	T	C	7	11	18	0	2	20	0	0
10	7996021	.	G	A	6	7	13	0	2	15	0	0
10	8001365	.	A	G	4	6	10	0	0	10	0	0
10	8005785	.	T	A	2	4	6	0	0	6	0	0
10	8009996	.	A	C	3	5	8	0	0	8	0	0
10	8035419	.	A	T	5	3	8	0	0	8	0	0
10	8036799	.	T	C	2	0	2	0	2	4	0	0
10	8036884	.	C	T	0	2	2	0	1	3	0	0
10	8036913	.	G	A	2	3	5	0	0	5	0	0
10	8037752	.	T	C	2	4	6	0	0	6	0	0
10	8037797	.	T	C	2	4	6	0	0	6	0	0
10	8041412	.	G	C	2	2	4	0	0	4	0	0
10	8091212	.	G	A	23	25	48	0	1	49	0	0
10	8097929	.	C	G	17	21	38	0	1	39	0	0
10	8160813	.	T	G	5	2	7	0	1	8	0	0
10	8160888	.	G	A	6	6	12	0	0	12	0	0
10	8160891	.	T	C	4	0	4	0	8	12	0	0
10	8161027	.	A	G	7	1	8	0	1	9	0	0
10	8161028	.	G	A	7	2	9	0	0	9	0	0
10	8163440	.	G	A	5	6	11	0	0	11	0	0
10	8164925	.	C	T	9	6	15	0	0	15	0	0
10	8170468	.	C	A	0	3	3	0	1	4	0	0
10	8175123	.	T	C	1	4	5	0	0	5	0	0
10	8175164	.	C	A	2	3	5	0	0	5	0	0
10	8177559	.	C	T	0	2	2	0	4	6	0	0
10	8177748	.	A	G	1	2	3	0	0	3	0	0
10	8217029	.	T	C	2	8	10	0	0	10	0	0
10	8236048	.	T	C	1	4	5	0	1	6	0	0
10	8265917	.	A	T	7	6	13	0	1	14	0	0
10	8265922	.	T	C	7	6	13	0	0	13	0	0
10	8265968	.	C	T	5	7	12	0	1	13	0	0
10	8265970	.	G	A	6	7	13	0	1	14	0	0
10	8266248	.	C	T	3	22	25	0	19	44	0	0
10	8266383	.	A	G	19	16	35	0	1	36	0	0
10	8269224	.	G	A	16	16	32	0	0	32	0	0
10	8269377	.	G	A	12	13	25	0	1	26	0	0
10	8269439	.	C	T	0	3	3	0	1	4	0	0
10	8269515	.	T	C	0	4	4	0	3	7	0	0
10	8278160	.	T	C	6	13	19	0	1	20	0	0
10	8278214	.	A	G	7	7	14	0	1	15	0	0
10	8282705	.	T	A	1	4	5	0	0	5	0	0
10	8295026	.	C	T	0	4	4	0	4	8	0	0
10	8295196	.	T	G	2	5	7	0	0	7	0	0
10	8295295	.	C	A	1	3	4	0	5	9	0	0
10	8299143	.	G	C	4	5	9	0	0	9	0	0
10	8335402	.	A	G	3	2	5	0	0	5	0	0
10	8357833	.	G	A	1	2	3	0	0	3	0	0
10	8358373	.	A	T	0	2	2	0	1	3	0	0
10	8412603	.	G	T	1	2	3	0	1	4	0	0
10	8434574	.	G	A	1	1	2	0	1	3	0	0
10	8630102	.	C	T	8	6	14	0	1	15	0	0
10	8630428	.	A	G	10	13	23	0	3	26	0	0
10	8630527	.	G	A	7	10	17	0	0	17	0	0
10	8630585	.	A	G	9	0	9	0	10	19	0	0
10	8630631	.	T	C	8	13	21	0	1	22	0	0
10	8630690	.	G	A	10	8	18	0	1	19	0	0
10	8630702	.	T	C	9	8	17	0	2	19	0	0
10	8630808	.	G	A	6	3	9	0	0	9	0	0
10	8630976	.	T	A	1	3	4	0	1	5	0	0
10	8630999	.	G	T	1	0	1	0	1	2	0	0
10	8631103	.	G	A	0	2	2	0	7	9	0	0
10	8631135	.	A	G	7	5	12	0	1	13	0	0
10	8631201	.	A	G	15	11	26	0	1	27	0	0
10	8670121	.	A	C	8	6	14	0	1	15	0	0
10	8670139	.	G	A	7	8	15	0	0	15	0	0
10	8672510	.	A	G	12	10	22	0	2	24	0	0
10	8672519	.	T	C	12	12	24	0	2	26	0	0
10	8672672	.	C	G	12	7	19	0	0	19	0	0
10	8672707	.	A	T	10	14	24	0	0	24	0	0
10	8829791	.	T	C	1	4	5	0	0	5	0	0
10	8835269	.	C	T	4	5	9	0	0	9	0	0
10	8835272	.	A	T	4	5	9	0	0	9	0	0
10	8840343	.	A	G	1	1	2	0	1	3	0	0
10	8883675	.	G	A	6	2	8	0	0	8	0	0
10	8883741	.	G	A	7	2	9	0	0	9	0	0
10	8950108	.	A	G	3	3	6	0	1	7	0	0
10	8970757	.	T	C	2	1	3	0	1	4	0	0
10	8970802	.	T	C	1	1	2	0	1	3	0	0
10	8976450	.	T	C	2	3	5	0	0	5	0	0
10	9006634	.	T	C	9	9	18	0	0	18	0	0
10	9169479	.	C	T	6	5	11	0	0	11	0	0
10	9169613	.	C	T	5	6	11	0	0	11	0	0
10	9177363	.	T	C	12	9	21	0	2	23	0	0
10	9181508	.	T	A	16	7	23	0	1	24	0	0
10	9184326	.	T	A	9	9	18	2	3	23	0	0
10	9184327	.	A	C	8	11	19	2	2	23	0	0
10	9184533	.	C	T	14	9	23	0	2	25	0	0
10	9234007	.	G	A	1	5	6	0	2	8	0	0
10	9234032	.	G	A	4	6	10	0	0	10	0	0
10	9234056	.	T	A	3	5	8	0	0	8	0	0
10	9234145	.	C	T	3	2	5	0	0	5	0	0
10	9234153	.	T	G	3	2	5	0	0	5	0	0
10	9234279	.	G	C	3	3	6	0	1	7	0	0
10	9234371	.	T	C	1	5	6	1	1	8	0	0
10	9234409	.	A	T	4	5	9	2	0	11	0	0
10	9234529	.	G	A	9	5	14	0	0	14	0	0
10	9234626	.	T	G	7	3	10	0	0	10	0	0
10	9234742	.	G	A	1	3	4	0	10	14	0	0
10	9235180	.	G	T	0	8	8	0	2	10	0	0
10	9235184	.	G	A	0	5	5	0	4	9	0	0
10	9235217	.	A	T	1	4	5	0	1	6	0	0
10	9305246	.	T	C	5	0	5	0	4	9	0	0
10	9305433	.	A	G	8	9	17	0	0	17	0	0
10	9305465	.	T	C	7	0	7	0	9	16	0	0
10	9308092	.	G	A	6	7	13	0	0	13	0	0
10	9308133	.	G	A	5	8	13	0	0	13	0	0
10	9334097	.	T	G	1	4	5	0	0	5	0	0
10	9346253	.	T	A	2	3	5	0	1	6	0	0
10	9347928	.	C	G	3	1	4	0	5	9	0	0
10	9361037	.	C	T	4	2	6	0	0	6	0	0
10	9361891	.	G	A	5	7	12	0	1	13	0	0
10	9361924	.	G	C	7	3	10	0	0	10	0	0
10	9369466	.	A	G	2	4	6	0	0	6	0	0
10	9370121	.	A	T	9	5	14	0	0	14	0	0
10	9370210	.	T	A	6	3	9	0	1	10	0	0
10	9370755	.	A	G	12	4	16	0	0	16	0	0
10	9390746	.	T	C	2	4	6	0	2	8	0	0
10	9390767	.	T	C	3	5	8	0	1	9	0	0
10	9394247	.	A	C	4	2	6	0	0	6	0	0
10	9394918	.	G	C	10	3	13	0	1	14	0	0
10	9395012	.	C	T	3	4	7	0	0	7	0	0
10	9410310	.	T	C	1	2	3	0	0	3	0	0
10	9626934	.	A	T	1	2	3	0	0	3	0	0
10	9632265	.	G	A	0	2	2	0	2	4	0	0
10	9632336	.	A	G	4	0	4	0	4	8	0	0
10	9644669	.	T	C	3	2	5	1	0	6	0	0
10	9701905	.	C	T	3	3	6	0	0	6	0	0
10	9704514	.	A	T	4	5	9	0	0	9	0	0
10	9714771	.	T	C	3	5	8	0	0	8	0	0
10	9714819	.	A	G	2	4	6	0	0	6	0	0
10	9781509	.	G	A	10	14	24	0	1	25	0	0
10	9784087	.	C	T	17	15	32	0	3	35	0	0
10	9800719	.	G	T	22	19	41	0	2	43	0	0
10	9802771	.	T	C	15	21	36	0	0	36	0	0
10	9806731	.	A	G	18	2	20	0	13	33	0	0
10	9807014	.	T	G	12	17	29	0	3	32	0	0
10	9807203	.	G	A	19	15	34	0	1	35	0	0
10	9836936	.	C	A	2	2	4	0	0	4	0	0
10	9837024	.	G	T	1	4	5	0	0	5	0	0
10	9837027	.	T	C	1	5	6	0	0	6	0	0
10	9837100	.	T	C	6	7	13	0	0	13	0	0
10	9846240	.	A	G	13	10	23	0	1	24	0	0
10	9846261	.	G	A	11	9	20	0	2	23	1	0
10	9856390	.	T	C	2	0	2	0	8	10	0	0
10	9856416	.	A	G	2	4	6	0	0	6	0	0
10	9895348	.	G	A	5	5	10	0	0	10	0	0
10	9899302	.	G	A	1	5	6	0	0	6	0	0
10	10210583	.	C	T	1	2	3	0	0	3	0	0
10	10254730	.	C	T	3	4	7	0	1	8	0	0
10	10254751	.	A	C	2	4	6	0	0	6	0	0
10	10254787	.	A	G	3	1	4	0	2	6	0	0
10	10254922	.	A	G	2	2	4	0	0	4	0	0
10	10261887	.	G	C	3	8	11	0	1	12	0	0
10	10261893	.	C	A	4	7	11	0	1	12	0	0
10	10262013	.	T	C	5	4	9	0	0	9	0	0
10	10269930	.	T	C	5	4	9	0	0	9	0	0
10	10317392	.	A	T	9	7	16	0	0	16	0	0
10	10325451	.	T	C	9	6	15	0	0	15	0	0
10	10325493	.	G	A	0	9	9	0	8	17	0	0
10	10380074	.	G	A	2	5	7	0	1	8	0	0
10	10564587	.	G	T	2	1	3	0	1	4	0	0
10	10729064	.	G	A	1	3	4	0	0	4	0	0
10	10764601	.	T	C	1	2	3	0	0	3	0	0
10	10782513	.	G	A	3	3	6	0	0	6	0	0
10	10860819	.	A	C	4	4	8	0	0	8	0	0
10	10860852	.	A	G	3	6	9	0	1	10	0	0
10	10861011	.	A	G	9	8	17	0	3	21	1	0
10	10861504	.	G	A	6	2	8	0	1	9	0	0
10	10862232	.	C	G	1	5	6	0	0	6	0	0
10	10880393	.	A	G	1	2	3	0	0	3	0	0
10	10880659	.	C	T	1	3	4	0	0	4	0	0
10	10880791	.	T	A	2	4	6	0	0	6	0	0
10	10880815	.	A	G	1	3	4	0	0	4	0	0
10	10880847	.	C	G	3	6	9	0	0	9	0	0
10	10880931	.	G	T	3	3	6	0	0	6	0	0
10	10930086	.	A	C	1	4	5	0	0	5	0	0
10	10930143	.	G	A	4	2	6	0	0	6	0	0
10	10930188	.	G	A	3	2	5	0	0	5	0	0
10	10935396	.	C	T	2	2	4	0	0	4	0	0
10	10935432	.	C	T	1	1	2	0	1	3	0	0
10	10935748	.	T	C	2	2	4	0	0	4	0	0
10	10997286	.	A	G	3	2	5	0	0	5	0	0
10	10997404	.	A	G	3	4	7	0	0	7	0	0
10	10997585	.	C	T	1	4	5	0	0	5	0	0
10	10997618	.	C	T	2	3	5	0	0	5	0	0
10	10997671	.	T	G	4	0	4	0	4	8	0	0
10	10997711	.	T	C	5	5	10	0	0	10	0	0
10	10997792	.	G	A	1	2	3	0	0	3	0	0
10	11001720	.	T	C	4	5	9	0	0	9	0	0
10	11001867	.	A	G	4	5	9	0	0	9	0	0
10	11001883	.	T	A	2	7	9	0	1	10	0	0
10	11001967	.	T	G	6	7	13	0	1	14	0	0
10	11001968	.	A	G	5	8	13	0	1	14	0	0
10	11003904	.	G	T	6	7	13	0	0	13	0	0
10	11003911	.	G	A	6	8	14	0	0	14	0	0
10	11146445	.	A	G	3	2	5	0	0	5	0	0
10	11146585	.	A	T	4	2	6	0	0	6	0	0
10	11166798	.	G	A	1	2	3	0	0	3	0	0
10	11183242	.	A	G	2	2	4	0	0	4	0	0
10	11281245	.	A	G	2	0	2	0	2	4	0	0
10	11281249	.	A	G	1	0	1	0	3	4	0	0
10	11281671	.	C	T	5	2	7	0	0	7	0	0
10	11281800	.	A	G	2	3	5	0	0	5	0	0
10	11281845	.	T	A	3	2	5	0	0	5	0	0
10	11282194	.	A	G	8	6	14	0	0	14	0	0
10	11286830	.	C	T	5	2	7	0	1	8	0	0
10	11287343	.	A	G	5	1	6	0	3	9	0	0
10	11298651	.	G	A	3	4	7	0	0	7	0	0
10	11298652	.	A	C	3	4	7	0	0	7	0	0
10	11298852	.	G	A	3	4	7	0	1	8	0	0
10	11298864	.	A	G	4	4	8	0	1	9	0	0
10	11298955	.	T	C	4	2	6	0	1	7	0	0
10	11298975	.	C	T	4	2	6	0	0	6	0	0
10	11309859	.	C	G	3	0	3	0	6	9	0	0
10	11310041	.	G	A	8	7	15	0	0	15	0	0
10	11310500	.	G	A	4	2	6	0	0	6	0	0
10	11310501	.	C	A	4	2	6	0	0	6	0	0
10	11310618	.	A	C	6	10	16	0	0	16	0	0
10	11310648	.	G	A	5	5	10	0	2	12	0	0
10	11310682	.	G	A	3	2	5	0	0	5	0	0
10	11311832	.	C	T	1	2	3	0	0	3	0	0
10	11322985	.	T	C	6	3	9	0	1	10	0	0
10	11323032	.	G	A	5	2	7	0	0	7	0	0
10	11327364	.	A	G	3	4	7	0	0	7	0	0
10	11327444	.	G	T	5	3	8	0	0	8	0	0
10	11327449	.	A	T	4	2	6	0	0	7	1	0
10	11327604	.	T	C	6	4	10	0	0	10	0	0
10	11327657	.	C	T	8	4	12	0	3	15	0	0
10	11327674	.	G	A	10	6	16	0	0	16	0	0
10	11331922	.	C	T	3	6	9	0	7	16	0	0
10	11332206	.	A	G	3	4	7	0	0	7	0	0
10	11334397	.	T	C	6	0	6	0	3	9	0	0
10	11334415	.	C	A	0	3	3	0	5	8	0	0
10	11339235	.	G	A	5	3	8	0	1	9	0	0
10	11339319	.	C	T	0	2	2	0	3	5	0	0
10	11347906	.	G	T	2	2	4	0	0	4	0	0
10	11347909	.	A	G	2	2	4	0	0	4	0	0
10	11347961	.	G	T	3	3	6	0	0	6	0	0
10	11348147	.	C	T	0	2	2	0	1	3	0	0
10	11362275	.	C	T	16	24	40	0	1	41	0	0
10	11370322	.	A	G	2	0	2	0	3	5	0	0
10	11370347	.	A	G	2	2	4	0	0	4	0	0
10	11370596	.	C	T	1	3	4	0	0	4	0	0
10	11394922	.	C	T	4	2	6	0	0	6	0	0
10	11403954	.	T	C	2	9	11	0	0	11	0	0
10	11501181	.	C	A	9	4	13	0	0	13	0	0
10	11773751	.	T	C	6	3	9	0	1	10	0	0
10	11779259	.	G	A	2	7	9	0	0	9	0	0
10	11790947	.	T	C	7	13	20	0	0	20	0	0
10	11805601	.	T	C	5	7	12	0	0	12	0	0
10	11838927	.	C	T	2	4	6	0	5	11	0	0
10	13063611	.	A	T	1	3	4	0	0	4	0	0
10	13063921	.	C	T	2	5	7	0	0	7	0	0
10	13238028	.	A	G	14	13	27	0	1	28	0	0
10	13238055	.	G	T	11	11	22	0	1	23	0	0
10	13283594	.	C	T	7	2	9	0	0	9	0	0
10	13283891	.	G	A	0	3	3	0	3	6	0	0
10	13286430	.	C	T	2	5	7	0	2	9	0	0
10	13286472	.	T	C	4	1	5	0	1	6	0	0
10	13460381	.	A	G	3	2	5	0	2	7	0	0
10	13460494	.	A	C	13	5	18	0	0	18	0	0
10	13460671	.	G	A	20	13	33	0	2	35	0	0
10	13460745	.	C	A	1	15	16	0	11	27	0	0
10	13460940	.	A	T	15	12	27	0	3	30	0	0
10	13461080	.	T	C	21	0	21	0	16	37	0	0
10	13461150	.	G	A	13	10	23	0	1	24	0	0
10	13476010	.	A	G	18	20	38	0	1	39	0	0
10	13529270	.	T	C	12	9	21	0	0	21	0	0
10	13536790	.	T	C	7	0	7	0	4	11	0	0
10	14275033	.	T	A	2	4	6	0	0	6	0	0
10	14491139	.	C	T	10	12	22	0	0	22	0	0
10	14493798	.	T	C	5	10	15	0	2	17	0	0
10	14493819	.	A	T	8	13	21	0	0	21	0	0
10	14493878	.	G	T	0	9	9	0	13	22	0	0
10	14493967	.	G	C	0	16	16	0	17	33	0	0
10	14530181	.	G	A	4	8	12	0	0	12	0	0
10	14533337	.	G	A	6	9	15	0	0	15	0	0
10	14533352	.	A	G	4	6	10	0	4	14	0	0
10	14542886	.	A	G	12	6	18	0	0	18	0	0
10	14543044	.	A	T	16	11	27	0	8	35	0	0
10	14543256	.	A	C	11	8	19	0	3	22	0	0
10	14543259	.	G	T	11	9	20	0	1	21	0	0
10	14543307	.	C	T	17	12	29	0	3	32	0	0
10	14545572	.	A	G	13	16	29	0	1	30	0	0
10	14871409	.	T	A	9	18	27	1	1	29	0	0
10	14871412	.	T	A	9	17	26	1	3	30	0	0
10	14871768	.	A	G	8	23	31	0	1	32	0	0
10	14871801	.	A	C	13	23	36	0	0	36	0	0
10	14872258	.	T	G	5	2	7	0	0	7	0	0
10	14872703	.	G	A	12	6	18	0	0	18	0	0
10	14929560	.	G	A	4	4	8	1	0	9	0	0
10	16562835	.	A	G	4	2	6	0	0	6	0	0
10	17923345	.	A	T	7	2	9	0	2	11	0	0
10	17924149	.	C	T	4	2	6	0	2	8	0	0
10	17924546	.	A	G	14	18	32	0	2	34	0	0
10	17924547	.	A	G	25	8	33	0	0	33	0	0
10	18911166	.	A	G	5	3	8	0	1	9	0	0
10	18927910	.	C	T	3	6	9	0	0	9	0	0
10	18930403	.	T	C	4	17	21	0	3	24	0	0
10	18934215	.	C	A	4	5	9	0	1	10	0	0
10	18934291	.	T	C	9	9	18	0	0	18	0	0
10	18934323	.	A	C	10	8	18	0	1	19	0	0
10	18934499	.	C	T	4	10	14	0	1	15	0	0
10	18934530	.	A	G	5	5	10	0	0	10	0	0
10	18934590	.	A	C	10	13	23	0	3	26	0	0
10	18934634	.	G	T	6	11	17	0	1	18	0	0
10	18934683	.	T	C	7	11	18	0	1	19	0	0
10	18934821	.	A	C	12	8	20	0	1	21	0	0
10	18935112	.	A	G	8	2	10	0	0	10	0	0
10	18935246	.	T	C	18	20	38	0	5	43	0	0
10	18935316	.	C	T	10	16	26	0	5	31	0	0
10	18935413	.	C	T	13	19	32	0	1	33	0	0
10	18935430	.	A	T	11	22	33	0	1	34	0	0
10	18935874	.	T	A	7	10	17	0	0	17	0	0
10	18973079	.	C	T	2	3	5	0	0	5	0	0
10	18973124	.	A	G	2	0	2	0	4	6	0	0
10	18977233	.	G	A	1	6	7	0	2	9	0	0
10	18992413	.	T	C	16	23	39	0	6	45	0	0
10	18999895	.	C	T	2	2	4	0	1	5	0	0
10	19017316	.	C	T	2	5	7	0	1	8	0	0
10	19020475	.	A	G	7	3	10	0	1	11	0	0
10	19020879	.	G	A	0	3	3	0	2	5	0	0
10	19021075	.	G	A	7	5	12	0	1	13	0	0
10	19021192	.	A	G	9	7	16	0	0	16	0	0
10	19021235	.	G	A	1	4	5	0	4	9	0	0
10	19339859	.	C	G	13	6	19	0	0	19	0	0
10	19428949	.	T	C	3	2	5	0	0	5	0	0
10	19554673	.	A	T	5	4	9	0	1	10	0	0
10	19562120	.	C	T	18	22	40	0	1	41	0	0
10	19564401	.	G	A	28	29	57	0	1	58	0	0
10	19565771	.	T	C	23	25	48	0	4	52	0	0
10	19565988	.	G	C	27	30	57	0	2	59	0	0
10	19566400	.	T	A	14	20	34	0	2	36	0	0
10	19566445	.	T	C	7	11	18	0	1	19	0	0
10	20083053	.	C	T	1	4	5	0	0	5	0	0
10	20087260	.	A	G	4	4	8	0	0	8	0	0
10	20087263	.	C	T	4	3	7	0	0	7	0	0
10	20087388	.	T	C	3	2	5	0	1	6	0	0
10	20093329	.	G	A	0	3	3	0	6	9	0	0
10	20100205	.	C	T	8	12	20	0	0	20	0	0
10	20100234	.	C	T	12	9	21	0	1	22	0	0
10	20100269	.	A	C	17	9	26	0	0	26	0	0
10	20103242	.	G	T	1	2	3	0	0	3	0	0
10	20103359	.	C	T	8	7	15	1	0	16	0	0
10	20103392	.	A	G	6	4	10	1	1	12	0	0
10	20103639	.	A	G	9	5	14	0	0	14	0	0
10	20105210	.	T	C	11	13	24	0	1	25	0	0
10	20128640	.	G	A	1	8	9	0	9	18	0	0
10	20128643	.	T	A	8	7	15	0	3	18	0	0
10	20131937	.	G	A	8	14	22	0	1	23	0	0
10	20136107	.	T	C	10	10	20	0	1	21	0	0
10	20137862	.	A	G	12	5	17	0	0	17	0	0
10	20143822	.	T	A	2	5	7	1	0	8	0	0
10	20143850	.	T	A	3	6	9	1	1	11	0	0
10	20146535	.	C	T	17	22	39	0	1	40	0	0
10	20147452	.	A	G	11	1	12	0	9	21	0	0
10	20215064	.	G	T	5	5	10	0	0	10	0	0
10	20218342	.	C	G	10	6	16	0	0	16	0	0
10	20233964	.	A	G	19	1	20	0	20	40	0	0
10	20234074	.	C	T	21	15	36	0	4	40	0	0
10	20256640	.	C	G	2	3	5	0	0	5	0	0
10	20276868	.	T	G	4	3	7	0	1	8	0	0
10	20276898	.	A	G	4	3	7	0	0	7	0	0
10	20276904	.	G	A	3	3	6	0	1	7	0	0
10	20287251	.	C	A	0	3	3	0	6	9	0	0
10	20351579	.	G	T	3	7	10	0	0	10	0	0
10	20351846	.	T	A	1	3	4	0	0	4	0	0
10	20351930	.	T	C	3	3	6	0	0	6	0	0
10	20368862	.	T	A	14	14	28	0	2	30	0	0
10	20368883	.	C	T	14	15	29	0	1	30	0	0
10	20371402	.	A	T	16	13	29	0	1	30	0	0
10	20371419	.	A	C	16	14	30	0	1	31	0	0
10	20371478	.	C	A	11	19	30	0	2	32	0	0
10	20371675	.	A	T	17	14	31	0	4	35	0	0
10	20395629	.	T	C	3	6	9	0	0	9	0	0
10	20398930	.	T	C	3	3	6	0	0	6	0	0
10	20401418	.	T	C	1	6	7	0	0	7	0	0
10	20401613	.	C	A	5	3	8	0	0	8	0	0
10	20401649	.	G	T	2	6	8	0	0	8	0	0
10	20401699	.	A	C	1	4	5	0	0	5	0	0
10	20401702	.	C	G	2	5	7	0	0	7	0	0
10	20468843	.	T	A	5	4	9	0	3	12	0	0
10	20468952	.	G	A	8	7	15	0	1	16	0	0
10	20469878	.	G	C	5	6	11	0	1	12	0	0
10	20472614	.	C	T	6	5	11	0	0	11	0	0
10	20472926	.	T	C	2	7	9	0	0	9	0	0
10	20473147	.	C	G	0	2	2	0	4	6	0	0
10	20473366	.	C	T	2	7	9	0	1	10	0	0
10	20473409	.	G	A	2	5	7	0	1	8	0	0
10	20473517	.	G	T	3	4	7	0	0	7	0	0
10	20505261	.	G	A	6	3	9	0	0	9	0	0
10	20505467	.	T	C	8	0	8	0	5	13	0	0
10	20505679	.	T	G	3	2	5	0	0	5	0	0
10	20508791	.	T	A	3	3	6	0	0	6	0	0
10	20527553	.	G	A	7	5	12	0	1	13	0	0
10	20527639	.	G	A	15	4	19	0	0	19	0	0
10	20527736	.	C	T	0	9	9	0	11	20	0	0
10	20527837	.	C	A	1	8	9	0	5	14	0	0
10	20529450	.	T	C	9	0	9	0	8	17	0	0
10	20532762	.	C	T	0	7	7	0	7	14	0	0
10	20543336	.	G	A	5	4	9	0	1	10	0	0
10	20546530	.	G	A	4	5	9	0	0	9	0	0
10	20546548	.	C	T	5	5	10	0	0	10	0	0
10	20558156	.	G	C	4	8	12	0	0	12	0	0
10	20558270	.	G	A	7	8	15	0	0	15	0	0
10	20558300	.	G	C	5	0	5	0	7	12	0	0
10	20562894	.	C	T	3	4	7	0	1	8	0	0
10	20565260	.	C	T	1	4	5	0	2	7	0	0
10	20590317	.	T	C	3	5	8	0	0	8	0	0
10	20590372	.	T	A	3	5	8	0	0	8	0	0
10	20590436	.	A	C	8	8	16	0	1	17	0	0
10	20590461	.	G	T	9	9	18	0	1	19	0	0
10	20590547	.	T	C	5	5	10	0	1	11	0	0
10	20590569	.	C	T	3	7	10	0	0	10	0	0
10	20591833	.	G	A	1	5	6	0	10	16	0	0
10	20592598	.	G	T	2	6	8	0	1	9	0	0
10	20598177	.	C	A	8	16	24	0	0	24	0	0
10	20598267	.	A	G	11	8	19	0	1	20	0	0
10	20598270	.	G	A	11	7	18	1	1	20	0	0
10	20604548	.	A	G	18	10	28	0	0	28	0	0
10	20604555	.	T	C	19	13	32	0	2	34	0	0
10	20604703	.	G	T	13	11	24	0	1	25	0	0
10	20605171	.	A	T	16	14	30	0	1	31	0	0
10	20636027	.	C	T	19	11	30	0	0	30	0	0
10	20636168	.	A	T	13	10	23	0	0	23	0	0
10	20636177	.	G	T	12	6	18	0	1	19	0	0
10	20636273	.	T	C	11	0	11	0	10	21	0	0
10	20636346	.	T	C	7	5	12	3	2	17	0	0
10	20636542	.	G	A	7	4	11	0	0	11	0	0
10	20636600	.	T	C	6	0	6	0	3	9	0	0
10	20920664	.	A	G	5	7	12	0	0	12	0	0
10	20971685	.	A	G	12	9	21	0	0	21	0	0
10	21043902	.	G	A	5	4	9	0	0	9	0	0
10	21044064	.	G	A	6	4	10	0	0	10	0	0
10	21044286	.	A	G	3	2	5	0	0	5	0	0
10	21044337	.	T	C	1	0	1	0	2	3	0	0
10	21044361	.	A	T	1	4	5	0	0	5	0	0
10	21044385	.	G	T	1	4	5	0	0	5	0	0
10	21046493	.	T	C	2	3	5	0	0	5	0	0
10	21437255	.	A	G	5	0	5	0	4	9	0	0
10	21442229	.	T	C	12	11	23	0	1	24	0	0
10	21443135	.	G	A	0	18	18	0	14	32	0	0
10	21443193	.	T	G	13	19	32	0	1	33	0	0
10	21443347	.	T	A	7	6	13	0	0	14	1	0
10	21452340	.	T	C	5	10	15	0	0	15	0	0
10	21452376	.	G	A	0	11	11	0	3	14	0	0
10	21452403	.	G	A	5	8	13	0	2	15	0	0
10	21459017	.	G	A	1	11	12	0	8	20	0	0
10	21459439	.	G	A	16	8	24	0	4	28	0	0
10	21462612	.	T	C	12	12	24	0	3	27	0	0
10	21470192	.	G	A	1	9	10	0	17	27	0	0
10	21523624	.	A	C	2	3	5	0	0	5	0	0
10	21524679	.	G	A	5	3	8	0	1	9	0	0
10	21524682	.	G	A	6	3	9	0	0	9	0	0
10	21525243	.	A	G	3	2	5	0	0	5	0	0
10	21525276	.	T	A	1	4	5	0	0	5	0	0
10	21579312	.	C	A	6	2	8	0	0	8	0	0
10	21579320	.	T	A	8	2	10	0	0	10	0	0
10	21646033	.	C	T	33	21	54	1	2	57	0	0
10	21646621	.	C	T	28	21	49	0	6	55	0	0
10	21646668	.	T	A	31	19	50	0	2	53	1	0
10	21646797	.	C	T	29	18	47	0	6	53	0	0
10	21646802	.	A	G	32	20	52	0	1	53	0	0
10	21646844	.	A	G	22	28	50	0	0	50	0	0
10	21647241	.	T	G	24	29	53	0	1	54	0	0
10	21647291	.	G	A	3	34	37	0	21	58	0	0
10	21647691	.	G	A	32	23	55	0	6	61	0	0
10	21656887	.	A	T	2	2	4	0	0	4	0	0
10	21658567	.	G	A	1	2	3	0	0	3	0	0
10	21679497	.	C	A	7	5	12	0	0	12	0	0
10	21703735	.	C	A	1	3	4	2	0	6	0	0
10	21704073	.	G	T	5	3	8	0	0	8	0	0
10	21720798	.	T	C	3	2	5	0	0	5	0	0
10	21720833	.	A	G	5	3	8	0	0	8	0	0
10	21720867	.	G	A	0	3	3	0	5	9	1	0
10	21729191	.	T	C	5	2	7	0	0	7	0	0
10	21761109	.	G	A	2	3	5	4	0	9	0	0
10	21778980	.	C	T	2	1	3	5	1	9	0	0
10	21780288	.	G	T	5	4	9	0	0	9	0	0
10	21780532	.	T	C	2	2	4	0	0	4	0	0
10	21780539	.	G	A	2	3	5	0	0	5	0	0
10	21781308	.	A	G	2	0	2	4	2	8	0	0
10	21781524	.	C	G	12	5	17	0	0	17	0	0
10	21781562	.	G	A	8	3	11	0	2	13	0	0
10	21781591	.	G	A	6	5	11	0	1	12	0	0
10	21781677	.	G	A	1	11	12	1	4	17	0	0
10	21781710	.	T	C	7	9	16	1	1	18	0	0
10	21781722	.	G	C	5	12	17	1	0	19	1	0
10	21783252	.	C	T	4	3	7	0	0	7	0	0
10	21783539	.	G	A	4	2	6	1	0	7	0	0
10	21783547	.	T	A	5	3	8	2	0	10	0	0
10	21783596	.	G	C	2	7	9	0	0	9	0	0
10	21783604	.	G	A	4	3	7	0	0	7	0	0
10	21783632	.	T	A	3	4	7	0	0	8	1	0
10	21783664	.	T	C	3	3	6	0	0	6	0	0
10	21783667	.	G	A	0	4	4	0	4	8	0	0
10	21783727	.	C	A	5	7	12	0	0	12	0	0
10	21783733	.	T	C	5	6	11	0	0	11	0	0
10	21784071	.	T	C	4	6	10	0	0	10	0	0
10	21784130	.	G	T	0	6	6	0	5	11	0	0
10	21784132	.	C	T	5	6	11	0	0	11	0	0
10	21784186	.	A	G	4	5	9	0	0	9	0	0
10	21784486	.	C	T	2	4	6	4	0	10	0	0
10	21784756	.	C	T	6	6	12	3	0	15	0	0
10	21784759	.	T	C	6	4	10	3	2	15	0	0
10	21785677	.	C	T	13	3	16	5	0	21	0	0
10	21786705	.	G	A	6	2	8	0	1	9	0	0
10	21786713	.	G	A	6	1	7	0	2	9	0	0
10	21786792	.	C	A	5	3	8	0	1	9	0	0
10	21786817	.	G	A	3	3	6	0	1	7	0	0
10	21786832	.	C	T	5	3	8	0	0	8	0	0
10	21786934	.	G	T	3	3	6	0	0	6	0	0
10	21787943	.	T	A	5	3	8	0	0	8	0	0
10	21788022	.	A	G	6	4	10	0	0	10	0	0
10	21788695	.	C	A	3	3	6	9	0	15	0	0
10	21790076	.	A	C	2	8	10	0	0	10	0	0
10	21790121	.	C	A	4	11	15	0	0	15	0	0
10	21790137	.	G	A	5	9	14	0	0	14	0	0
10	21790648	.	T	C	3	5	8	0	0	8	0	0
10	21790769	.	A	G	3	0	3	0	7	10	0	0
10	21790775	.	A	C	2	7	9	0	0	9	0	0
10	21790934	.	T	C	1	8	9	0	1	10	0	0
10	21791090	.	G	A	5	9	14	0	0	14	0	0
10	21791375	.	G	A	6	7	13	0	1	14	0	0
10	21791801	.	G	A	0	3	3	6	4	13	0	0
10	21794285	.	G	A	1	3	4	0	0	4	0	0
10	21794302	.	G	A	0	2	2	0	2	4	0	0
10	21794797	.	A	C	1	2	3	0	0	3	0	0
10	21794800	.	A	T	1	2	3	0	0	3	0	0
10	21795065	.	C	T	2	1	3	0	1	4	0	0
10	21795337	.	C	T	3	3	6	10	0	16	0	0
10	21795805	.	G	A	2	4	6	9	1	16	0	0
10	21797374	.	A	G	1	1	2	0	0	2	0	0
10	21797382	.	A	T	1	3	4	0	0	4	0	0
10	21798150	.	A	G	2	0	2	0	1	3	0	0
10	21798157	.	C	T	1	2	3	0	0	3	0	0
10	21798215	.	C	A	1	7	8	0	0	8	0	0
10	21798333	.	C	T	2	2	4	0	0	4	0	0
10	21798348	.	A	T	1	2	3	0	0	3	0	0
10	21798372	.	G	A	1	2	3	0	2	5	0	0
10	21798828	.	C	A	2	2	4	0	0	4	0	0
10	21799320	.	A	C	3	3	6	8	0	15	1	0
10	21799343	.	T	A	7	4	11	1	0	12	0	0
10	21799374	.	T	A	11	3	14	0	0	14	0	0
10	21801115	.	A	G	3	5	8	1	1	10	0	0
10	21801118	.	A	G	4	4	8	1	0	9	0	0
10	21801339	.	T	G	7	0	7	0	5	12	0	0
10	21801352	.	T	C	9	7	16	0	1	17	0	0
10	21801573	.	C	T	2	3	5	0	0	5	0	0
10	21801590	.	A	C	1	4	5	0	0	5	0	0
10	21801611	.	G	T	1	5	6	0	1	7	0	0
10	21801718	.	G	A	0	6	6	0	7	13	0	0
10	21801856	.	C	T	6	3	9	0	1	10	0	0
10	21801922	.	G	T	7	2	9	0	0	9	0	0
10	21801924	.	A	G	7	2	9	0	0	9	0	0
10	21802086	.	A	G	4	2	6	0	0	6	0	0
10	21802291	.	C	T	9	5	14	0	1	15	0	0
10	21802326	.	C	A	5	4	9	0	0	9	0	0
10	21802530	.	A	T	3	2	5	0	0	5	0	0
10	21802539	.	C	T	3	3	6	0	0	6	0	0
10	21802566	.	T	C	2	3	5	0	1	6	0	0
10	21802661	.	C	T	10	8	18	1	2	21	0	0
10	21802701	.	A	T	15	4	19	1	2	22	0	0
10	21802713	.	T	C	17	4	21	1	1	23	0	0
10	21803031	.	G	A	9	5	14	6	0	20	0	0
10	21805019	.	A	T	3	2	5	0	0	5	0	0
10	21805020	.	A	C	3	2	5	0	0	5	0	0
10	21805447	.	G	A	2	3	5	0	0	5	0	0
10	21805762	.	C	T	1	5	6	0	0	6	0	0
10	21805870	.	A	G	2	0	2	0	3	5	0	0
10	21806060	.	G	A	2	3	5	0	0	5	0	0
10	21806789	.	G	A	5	7	12	0	0	12	0	0
10	21818522	.	C	T	43	41	84	0	3	87	0	0
10	21818595	.	T	G	36	33	69	0	2	72	1	0
10	21818762	.	A	C	31	13	44	0	5	49	0	0
10	21818916	.	C	T	30	30	60	0	0	60	0	0
10	21819019	.	G	A	2	37	39	0	24	63	0	0
10	21819038	.	C	A	27	37	64	0	2	66	0	0
10	21819105	.	G	T	38	25	63	0	3	66	0	0
10	21819214	.	G	C	34	34	68	0	2	70	0	0
10	21819523	.	T	A	30	41	71	0	5	76	0	0
10	21819577	.	C	T	33	38	71	0	7	78	0	0
10	21819653	.	T	C	27	52	79	0	1	80	0	0
10	21819772	.	T	C	29	42	71	0	5	76	0	0
10	21819966	.	A	T	11	3	14	0	0	14	0	0
10	21944029	.	G	T	2	5	7	0	1	8	0	0
10	21944067	.	T	C	4	5	9	0	0	9	0	0
10	21944199	.	T	G	1	3	4	0	0	4	0	0
10	21944238	.	T	C	1	5	6	0	0	6	0	0
10	21944728	.	A	G	2	3	5	0	0	5	0	0
10	21944774	.	C	T	1	4	5	0	0	5	0	0
10	21944789	.	C	T	1	3	4	0	1	5	0	0
10	22012534	.	G	A	5	4	9	0	0	9	0	0
10	22030798	.	C	T	23	23	46	0	6	52	0	0
10	22030881	.	A	T	19	15	34	0	3	37	0	0
10	22031375	.	A	C	20	19	39	0	2	41	0	0
10	22031493	.	G	A	25	21	46	0	4	50	0	0
10	22031635	.	A	G	17	29	46	0	3	49	0	0
10	22031666	.	A	G	12	28	40	0	1	41	0	0
10	22031755	.	T	C	14	18	32	0	0	32	0	0
10	22031759	.	T	C	13	18	31	0	1	32	0	0
10	22031854	.	G	A	17	15	32	0	2	34	0	0
10	22035638	.	A	G	3	7	10	0	0	10	0	0
10	22036235	.	T	A	7	12	19	0	0	19	0	0
10	22041529	.	G	A	3	7	10	0	0	10	0	0
10	22041717	.	T	C	7	5	12	0	0	12	0	0
10	22044699	.	G	A	10	7	17	0	0	17	0	0
10	22044921	.	T	G	4	10	14	0	0	14	0	0
10	22044982	.	C	T	2	11	13	0	1	14	0	0
10	22045014	.	G	T	2	11	13	0	1	14	0	0
10	22051195	.	A	T	2	2	4	0	0	4	0	0
10	22051239	.	T	C	2	4	6	0	0	6	0	0
10	22051474	.	A	C	2	5	7	0	1	8	0	0
10	22052247	.	C	T	0	3	3	0	2	5	0	0
10	22054257	.	T	C	3	2	5	0	0	5	0	0
10	22137254	.	T	C	2	4	6	0	0	6	0	0
10	22163002	.	G	T	8	5	13	0	2	15	0	0
10	22475799	.	G	A	0	10	10	0	9	19	0	0
10	22477229	.	A	G	9	8	17	0	0	17	0	0
10	22477610	.	A	G	4	0	4	0	6	10	0	0
10	22477661	.	C	T	3	9	12	0	0	12	0	0
10	22477880	.	A	G	16	0	16	0	15	31	0	0
10	22516643	.	C	G	3	4	7	0	0	7	0	0
10	22516876	.	A	T	1	4	5	0	0	5	0	0
10	22516903	.	A	G	1	3	4	0	0	4	0	0
10	22516957	.	T	C	2	2	4	0	1	5	0	0
10	22518237	.	G	A	1	5	6	0	6	12	0	0
10	22518267	.	T	A	5	3	8	0	0	9	1	0
10	22519465	.	A	G	6	5	11	0	1	12	0	0
10	22530043	.	C	T	6	6	12	0	1	13	0	0
10	22530058	.	A	C	8	6	14	0	2	16	0	0
10	22530812	.	T	C	10	5	15	0	1	16	0	0
10	22531003	.	T	A	5	5	10	0	0	10	0	0
10	22531179	.	A	G	5	7	12	1	2	15	0	0
10	22531472	.	T	C	4	12	16	0	1	17	0	0
10	22531906	.	A	C	15	8	23	0	0	23	0	0
10	22531912	.	G	A	13	7	20	0	1	21	0	0
10	22532133	.	G	T	9	13	22	0	1	23	0	0
10	22532316	.	G	A	13	17	30	0	0	30	0	0
10	22532347	.	C	T	13	18	31	0	1	32	0	0
10	22532547	.	T	A	17	13	30	0	3	33	0	0
10	22532610	.	A	T	13	19	32	0	2	34	0	0
10	22532817	.	C	G	16	18	34	0	1	35	0	0
10	22745661	.	C	T	6	3	9	0	1	10	0	0
10	22747289	.	G	C	1	6	7	0	3	10	0	0
10	22747913	.	T	C	5	2	7	0	1	8	0	0
10	22748442	.	G	T	3	3	6	0	0	6	0	0
10	22748964	.	G	C	4	4	8	0	0	8	0	0
10	22749623	.	C	T	1	3	4	0	0	4	0	0
10	22749824	.	A	C	1	2	3	0	0	3	0	0
10	22751095	.	G	A	4	7	11	0	1	12	0	0
10	22753455	.	G	A	5	6	11	0	0	11	0	0
10	22753883	.	A	C	4	4	8	0	0	8	0	0
10	22755164	.	C	T	6	8	14	0	0	14	0	0
10	22758016	.	G	A	3	8	11	0	0	11	0	0
10	22758094	.	A	G	10	0	10	0	5	15	0	0
10	22758303	.	A	G	2	4	6	0	0	6	0	0
10	22758481	.	A	G	6	0	6	0	4	10	0	0
10	22760658	.	A	C	11	6	17	0	1	18	0	0
10	22786128	.	T	A	9	11	20	0	1	21	0	0
10	22786227	.	C	T	2	2	4	0	0	4	0	0
10	22789733	.	G	A	2	2	4	0	0	4	0	0
10	22790853	.	C	T	3	6	9	0	1	10	0	0
10	22791751	.	C	G	1	2	3	0	0	3	0	0
10	22811358	.	C	A	1	3	4	0	2	6	0	0
10	22811406	.	T	C	5	0	5	0	8	13	0	0
10	22811621	.	A	C	10	0	10	0	11	21	0	0
10	22812500	.	A	T	6	5	11	0	0	11	0	0
10	22813273	.	T	C	5	2	7	0	0	7	0	0
10	22814750	.	G	A	5	7	12	0	0	12	0	0
10	22838530	.	C	T	3	21	24	0	32	56	0	0
10	22841955	.	G	T	28	21	49	0	3	52	0	0
10	22845293	.	C	T	3	23	26	0	24	50	0	0
10	22854917	.	A	G	6	3	9	0	0	9	0	0
10	22856192	.	G	C	8	4	12	0	1	13	0	0
10	22856201	.	T	C	7	5	12	0	1	13	0	0
10	22859971	.	T	G	3	5	8	0	0	8	0	0
10	22861834	.	A	G	4	7	11	0	1	12	0	0
10	22861836	.	C	T	5	7	12	0	0	12	0	0
10	22893992	.	A	G	12	6	18	0	0	18	0	0
10	22894100	.	G	A	7	3	10	0	0	10	0	0
10	22895312	.	T	C	4	3	7	0	1	8	0	0
10	22895327	.	T	C	2	5	7	0	1	8	0	0
10	22896782	.	C	A	6	6	12	0	0	12	0	0
10	22896950	.	C	T	8	13	21	0	0	21	0	0
10	22896959	.	G	A	1	12	13	0	10	23	0	0
10	22897187	.	C	T	8	8	16	0	0	16	0	0
10	22906434	.	C	T	18	10	28	0	0	28	0	0
10	22906587	.	T	C	15	10	25	0	0	25	0	0
10	22906844	.	C	T	13	10	23	0	1	24	0	0
10	22906916	.	A	T	11	10	21	0	0	21	0	0
10	22912283	.	G	T	1	5	6	0	1	7	0	0
10	22912547	.	C	T	4	7	11	0	1	12	0	0
10	22915875	.	A	G	3	3	6	0	0	6	0	0
10	22915897	.	G	A	2	1	3	0	1	4	0	0
10	22915914	.	C	A	3	1	4	0	0	4	0	0
10	22915993	.	T	C	3	4	7	0	0	7	0	0
10	22916324	.	A	G	17	27	44	4	11	59	0	0
10	22916339	.	A	G	21	19	40	3	7	51	1	0
10	22916422	.	A	C	24	38	62	0	2	64	0	0
10	22916426	.	T	A	24	38	62	0	2	64	0	0
10	22916664	.	C	T	33	25	58	0	7	65	0	0
10	22916730	.	A	G	30	31	61	0	2	63	0	0
10	22918164	.	T	C	23	17	40	0	8	48	0	0
10	22918190	.	C	T	16	8	24	0	2	26	0	0
10	22918214	.	T	G	2	6	8	0	0	8	0	0
10	22922089	.	A	G	3	0	3	0	7	10	0	0
10	22924978	.	A	C	6	10	16	0	1	17	0	0
10	22925049	.	G	A	0	5	5	0	5	10	0	0
10	22925983	.	A	C	3	3	6	0	1	7	0	0
10	22955718	.	A	G	3	5	8	0	0	8	0	0
10	23024405	.	T	C	8	10	18	1	1	20	0	0
10	23024660	.	A	G	20	15	35	0	1	36	0	0
10	23024708	.	T	C	19	17	36	0	1	37	0	0
10	23024762	.	A	G	13	19	32	0	1	33	0	0
10	23060740	.	G	A	5	8	13	0	0	13	0	0
10	23061326	.	G	A	1	7	8	0	2	10	0	0
10	23065777	.	T	C	6	7	13	0	0	13	0	0
10	23068553	.	G	T	10	13	23	0	0	23	0	0
10	23068630	.	A	G	11	12	23	0	0	23	0	0
10	23068907	.	T	G	11	20	31	0	0	31	0	0
10	23068962	.	A	G	8	13	21	0	1	22	0	0
10	23068963	.	C	T	8	13	21	0	1	22	0	0
10	23071025	.	A	T	1	4	5	0	0	5	0	0
10	23071322	.	G	A	3	6	9	0	0	9	0	0
10	23071524	.	G	T	5	3	8	0	2	10	0	0
10	23071619	.	A	G	9	4	13	0	0	13	0	0
10	23071697	.	G	A	5	6	11	0	0	11	0	0
10	23071705	.	G	C	2	7	9	0	0	9	0	0
10	23078993	.	G	C	2	0	2	0	3	5	0	0
10	23122855	.	T	C	2	2	4	0	1	5	0	0
10	23126558	.	T	C	0	2	2	0	1	3	0	0
10	23138428	.	G	A	3	2	5	0	2	7	0	0
10	23139076	.	G	C	1	2	3	0	1	4	0	0
10	23139296	.	C	T	1	3	4	0	0	4	0	0
10	23141830	.	T	G	2	2	4	0	0	4	0	0
10	23220533	.	A	G	1	3	4	0	2	6	0	0
10	24325590	.	C	T	18	14	32	0	1	33	0	0
10	24334999	.	T	G	10	15	25	0	1	26	0	0
10	24373125	.	C	T	1	1	2	0	2	4	0	0
10	24373137	.	C	T	1	2	3	0	1	4	0	0
10	24373166	.	A	T	2	2	4	0	0	4	0	0
10	24373429	.	T	A	5	4	9	0	0	9	0	0
10	24422052	.	C	T	12	4	16	0	0	16	0	0
10	24422070	.	T	A	12	6	18	0	0	18	0	0
10	24422236	.	C	T	8	9	17	0	0	17	0	0
10	24425257	.	A	G	10	7	17	0	1	18	0	0
10	24426924	.	A	G	8	6	14	0	1	15	0	0
10	24427010	.	G	C	5	6	11	0	0	11	0	0
10	24429262	.	C	T	3	5	8	0	0	8	0	0
10	24429282	.	A	C	3	5	8	0	0	8	0	0
10	24429342	.	T	C	4	8	12	0	1	13	0	0
10	24429386	.	C	T	8	5	13	0	1	14	0	0
10	24431719	.	A	T	10	5	15	0	4	19	0	0
10	24431795	.	T	C	5	9	14	0	1	15	0	0
10	24431807	.	C	T	10	8	18	0	0	18	0	0
10	24437128	.	A	G	17	18	35	0	1	36	0	0
10	24441916	.	C	T	22	13	35	1	4	40	0	0
10	24442466	.	C	T	10	8	18	0	2	20	0	0
10	24442490	.	A	G	7	0	7	0	6	13	0	0
10	24564935	.	C	A	5	2	7	0	0	7	0	0
10	24566124	.	T	C	3	3	6	0	0	6	0	0
10	24600128	.	A	G	6	5	11	0	2	13	0	0
10	24609175	.	G	A	10	8	18	0	0	18	0	0
10	24614636	.	A	G	7	0	7	0	7	14	0	0
10	24614707	.	A	G	3	7	10	0	0	10	0	0
10	24614709	.	T	G	1	7	8	0	2	10	0	0
10	24616839	.	C	A	5	6	11	0	0	11	0	0
10	24617156	.	G	A	7	9	16	0	0	16	0	0
10	24617621	.	G	C	2	6	8	0	7	15	0	0
10	24617624	.	G	A	8	6	14	0	0	14	0	0
10	24621354	.	A	G	12	14	26	0	0	26	0	0
10	24621534	.	T	A	13	8	21	0	1	22	0	0
10	24621722	.	C	G	2	3	5	0	0	5	0	0
10	24621730	.	A	T	2	3	5	0	1	6	0	0
10	24621757	.	T	A	4	5	9	0	0	9	0	0
10	24650192	.	A	G	4	14	18	0	2	20	0	0
10	24652174	.	A	T	18	11	29	0	1	30	0	0
10	24654142	.	A	C	10	1	11	0	8	19	0	0
10	24654319	.	A	C	6	4	10	0	1	11	0	0
10	24654376	.	G	T	3	3	6	0	2	8	0	0
10	24654906	.	T	C	5	0	5	0	4	9	0	0
10	24662393	.	G	A	8	5	13	0	0	13	0	0
10	24677136	.	T	G	4	3	7	0	1	8	0	0
10	24677253	.	T	A	1	3	4	0	0	4	0	0
10	24685215	.	G	A	0	2	2	0	1	3	0	0
10	24686302	.	C	T	1	4	5	0	0	5	0	0
10	24710002	.	T	C	3	0	3	0	3	6	0	0
10	24710599	.	A	C	2	7	9	0	0	9	0	0
10	24710977	.	G	A	2	4	6	0	0	6	0	0
10	24725357	.	G	A	4	5	9	0	0	9	0	0
10	24725358	.	A	C	5	5	10	0	0	10	0	0
10	24725724	.	G	A	3	5	8	0	0	8	0	0
10	24725871	.	C	A	3	14	17	0	4	21	0	0
10	24726211	.	T	A	3	2	5	0	3	8	0	0
10	24726264	.	G	A	3	2	5	0	0	5	0	0
10	24726302	.	A	G	4	2	6	0	0	6	0	0
10	24726440	.	A	G	3	2	5	0	1	6	0	0
10	24726453	.	G	A	1	3	4	0	0	4	0	0
10	24726712	.	T	G	2	2	4	0	0	4	0	0
10	24727127	.	A	G	2	4	6	0	1	7	0	0
10	24753343	.	G	A	1	2	3	0	0	3	0	0
10	24762402	.	C	A	7	2	9	0	0	9	0	0
10	24762462	.	T	C	6	0	6	0	6	12	0	0
10	24762543	.	G	A	6	3	9	0	0	9	0	0
10	24762553	.	G	A	5	3	8	0	1	9	0	0
10	24762707	.	T	C	5	0	5	0	4	9	0	0
10	24762723	.	A	G	7	4	11	0	0	11	0	0
10	24762774	.	T	G	5	6	11	0	1	12	0	0
10	25205354	.	A	C	4	3	7	0	0	7	0	0
10	25205893	.	A	G	3	0	3	0	5	8	0	0
10	25209612	.	G	A	7	6	13	0	0	13	0	0
10	25210125	.	C	A	17	12	29	0	2	31	0	0
10	25214387	.	C	T	2	3	5	0	0	5	0	0
10	25214627	.	C	T	5	3	8	0	0	8	0	0
10	25214648	.	G	T	0	4	4	0	3	7	0	0
10	25222392	.	G	T	2	2	4	0	0	4	0	0
10	25262150	.	T	A	1	4	5	0	0	5	0	0
10	25262279	.	C	T	7	4	11	0	0	11	0	0
10	25262336	.	C	T	10	6	16	0	0	16	0	0
10	25269245	.	C	T	15	7	22	0	1	23	0	0
10	25269310	.	G	T	14	24	38	0	2	40	0	0
10	25269325	.	T	G	13	19	32	0	2	34	0	0
10	25269492	.	A	G	18	0	18	1	18	37	0	0
10	25269599	.	C	T	23	14	37	0	2	39	0	0
10	25269742	.	C	T	15	14	29	0	3	32	0	0
10	25269747	.	T	A	21	13	34	0	0	34	0	0
10	25269946	.	G	A	1	27	28	1	16	46	1	0
10	25269998	.	G	T	6	5	11	5	52	68	0	0
10	25270011	.	A	T	47	2	49	3	1	53	0	0
10	25270096	.	T	C	26	19	45	2	1	48	0	0
10	25270432	.	A	G	16	12	28	0	2	30	0	0
10	25270470	.	A	G	19	13	32	0	2	34	0	0
10	25270803	.	A	T	16	20	36	0	6	42	0	0
10	25270958	.	C	T	19	8	27	0	1	28	0	0
10	25271323	.	A	G	19	15	34	0	2	36	0	0
10	25312733	.	T	G	8	7	15	0	0	15	0	0
10	25312879	.	T	A	7	6	13	0	1	14	0	0
10	25329811	.	C	A	5	23	28	0	31	59	0	0
10	25330646	.	G	A	21	25	46	0	3	49	0	0
10	25336271	.	A	G	11	24	35	0	0	35	0	0
10	25338585	.	C	G	11	8	19	0	1	20	0	0
10	25338762	.	G	A	8	15	23	0	0	23	0	0
10	25381742	.	G	T	0	2	2	0	2	4	0	0
10	25383883	.	G	A	1	5	6	0	0	6	0	0
10	25403139	.	G	A	1	4	5	0	0	5	0	0
10	25403280	.	C	G	1	4	5	0	4	9	0	0
10	25403402	.	C	T	3	11	14	0	5	19	0	0
10	25410276	.	T	C	3	1	4	0	11	15	0	0
10	25410288	.	A	G	5	8	13	0	3	16	0	0
10	25410389	.	A	G	2	7	9	0	0	9	0	0
10	25436557	.	C	T	0	5	5	0	4	9	0	0
10	25461335	.	C	T	0	3	3	0	3	6	0	0
10	25573218	.	A	G	9	12	21	0	0	21	0	0
10	25573333	.	G	A	11	9	20	0	1	21	0	0
10	25573365	.	C	A	11	7	18	0	0	18	0	0
10	25574159	.	T	C	9	8	17	0	0	17	0	0
10	25574181	.	C	T	2	6	8	0	8	16	0	0
10	25574316	.	A	G	2	12	14	0	1	15	0	0
10	25580119	.	A	T	4	5	9	0	0	9	0	0
10	25580370	.	T	C	3	4	7	0	0	7	0	0
10	25582029	.	A	G	4	7	11	0	0	11	0	0
10	25582074	.	G	T	6	9	15	0	0	15	0	0
10	25582656	.	C	T	3	6	9	0	0	9	0	0
10	25583160	.	C	A	2	3	5	0	0	5	0	0
10	25585179	.	A	G	1	4	5	0	0	5	0	0
10	25600712	.	A	G	2	3	5	0	0	5	0	0
10	25601799	.	T	C	1	3	4	0	0	4	0	0
10	25615597	.	A	G	2	2	4	0	0	4	0	0
10	25625001	.	C	T	2	3	5	0	0	5	0	0
10	25694920	.	G	A	35	30	65	0	0	65	0	0
10	25697655	.	A	G	25	28	53	0	1	54	0	0
10	25697715	.	G	C	21	14	35	0	1	36	0	0
10	25700984	.	G	A	2	6	8	0	0	8	0	0
10	25701036	.	G	A	2	4	6	0	2	8	0	0
10	25701659	.	G	C	10	19	29	0	2	31	0	0
10	25701673	.	T	A	11	16	27	0	1	28	0	0
10	25701781	.	T	C	9	2	11	0	4	15	0	0
10	25704345	.	C	T	10	8	18	0	3	21	0	0
10	25706228	.	G	A	1	3	4	0	0	4	0	0
10	25830373	.	A	G	9	3	12	0	1	13	0	0
10	25830544	.	T	G	6	13	19	0	1	20	0	0
10	25830687	.	A	G	6	6	12	0	1	13	0	0
10	25830723	.	T	G	5	9	14	0	1	15	0	0
10	25837613	.	A	G	1	5	6	0	0	6	0	0
10	25948190	.	A	T	9	13	22	0	2	24	0	0
10	25960676	.	A	C	13	15	28	0	0	28	0	0
10	25960718	.	T	C	15	13	28	0	0	28	0	0
10	25960728	.	G	T	12	15	27	0	0	27	0	0
10	25961061	.	T	C	2	5	7	0	0	7	0	0
10	25961283	.	A	G	2	2	4	0	0	4	0	0
10	25961307	.	A	T	2	3	5	0	0	5	0	0
10	25961396	.	T	C	3	6	9	0	0	9	0	0
10	25961397	.	T	A	2	6	8	0	1	9	0	0
10	25961454	.	G	C	6	12	18	0	2	20	0	0
10	25961510	.	A	C	10	11	21	0	0	21	0	0
10	25961778	.	A	G	11	5	16	0	1	17	0	0
10	26111451	.	T	C	5	2	7	0	0	7	0	0
10	26111487	.	T	C	4	2	6	0	0	6	0	0
10	26111631	.	T	C	3	2	5	0	0	5	0	0
10	26112160	.	A	C	1	2	3	0	0	3	0	0
10	26113095	.	C	G	4	4	8	0	1	9	0	0
10	26113370	.	G	A	5	4	9	0	0	9	0	0
10	26113522	.	A	T	1	3	4	0	1	5	0	0
10	26113542	.	A	C	1	2	3	0	0	3	0	0
10	26113931	.	C	T	7	9	16	0	0	16	0	0
10	26114207	.	T	A	2	4	6	0	0	6	0	0
10	26114242	.	A	T	2	3	5	0	1	6	0	0
10	26114472	.	G	C	3	2	5	0	1	6	0	0
10	26114474	.	T	C	4	2	6	0	0	6	0	0
10	26114508	.	A	T	1	5	6	0	0	6	0	0
10	26114509	.	C	T	1	5	6	0	0	6	0	0
10	26114562	.	C	G	4	2	6	0	0	6	0	0
10	26114668	.	C	A	6	2	8	0	0	8	0	0
10	26114894	.	A	T	4	5	9	0	0	9	0	0
10	26114922	.	A	C	5	4	9	0	0	9	0	0
10	26114952	.	A	T	9	4	13	0	0	13	0	0
10	26115080	.	G	C	4	7	11	0	1	12	0	0
10	26115225	.	C	T	3	3	6	0	0	6	0	0
10	26118717	.	G	C	1	2	3	0	1	4	0	0
10	26121535	.	T	C	3	3	6	0	0	6	0	0
10	26123308	.	A	C	4	2	6	0	1	7	0	0
10	26123649	.	A	T	4	2	6	0	0	6	0	0
10	26123667	.	A	C	4	4	8	0	0	8	0	0
10	26126639	.	C	G	7	9	16	0	0	16	0	0
10	26126643	.	T	C	7	10	17	0	0	17	0	0
10	26126903	.	C	T	4	5	9	0	0	9	0	0
10	26126995	.	A	T	5	11	16	0	4	20	0	0
10	26127054	.	G	A	3	12	15	0	2	17	0	0
10	26127075	.	T	C	4	15	19	0	1	20	0	0
10	26127291	.	T	C	10	20	30	0	0	30	0	0
10	26127479	.	C	A	3	8	11	0	2	13	0	0
10	26127484	.	C	T	3	9	12	0	0	12	0	0
10	26127643	.	G	A	12	6	18	0	0	18	0	0
10	26127731	.	C	T	4	6	10	0	1	11	0	0
10	26127968	.	G	T	8	8	16	0	0	16	0	0
10	26128067	.	A	T	2	8	10	0	1	11	0	0
10	26128107	.	C	T	2	2	4	0	0	4	0	0
10	26131166	.	G	A	13	19	32	0	1	33	0	0
10	26131195	.	C	T	1	19	20	0	15	36	1	0
10	26131551	.	C	G	16	25	41	0	2	43	0	0
10	26131622	.	T	C	22	0	22	0	17	39	0	0
10	26131653	.	C	T	14	20	34	0	2	36	0	0
10	26131717	.	A	T	18	12	30	0	0	30	0	0
10	26131719	.	T	C	17	11	28	0	2	30	0	0
10	26131989	.	C	T	13	9	22	0	2	24	0	0
10	26132084	.	G	T	9	6	15	0	1	16	0	0
10	26132159	.	T	A	3	3	6	0	0	6	0	0
10	26132356	.	A	G	5	3	8	0	0	8	0	0
10	26132437	.	A	T	19	10	29	0	1	30	0	0
10	26132553	.	A	G	14	11	25	0	1	26	0	0
10	26132630	.	C	A	0	18	18	0	13	31	0	0
10	26139304	.	G	A	17	18	35	0	0	35	0	0
10	26139352	.	A	T	12	17	29	0	0	29	0	0
10	26141198	.	C	T	8	16	24	0	1	25	0	0
10	26144153	.	T	G	9	3	12	0	1	13	0	0
10	26144180	.	A	G	10	6	16	0	1	17	0	0
10	26144243	.	A	G	13	8	21	0	0	21	0	0
10	26144249	.	C	A	12	5	17	0	2	19	0	0
10	26150862	.	A	G	9	6	15	0	0	15	0	0
10	26155871	.	T	G	9	6	15	0	1	16	0	0
10	26204834	.	C	A	5	3	8	0	0	8	0	0
10	26204886	.	A	T	9	9	18	0	1	19	0	0
10	26204897	.	G	C	9	12	21	0	0	21	0	0
10	26205057	.	A	T	4	4	8	0	0	8	0	0
10	26205169	.	G	A	6	2	8	0	2	10	0	0
10	26205176	.	A	T	8	2	10	0	0	10	0	0
10	26205206	.	A	T	8	4	12	0	0	12	0	0
10	26205602	.	T	G	3	7	10	0	0	10	0	0
10	26205715	.	G	A	3	4	7	0	0	7	0	0
10	26205805	.	A	T	3	14	17	0	3	20	0	0
10	26205909	.	C	A	6	4	10	0	1	12	1	0
10	26206101	.	T	C	6	0	6	0	7	13	0	0
10	26206371	.	A	G	3	6	9	0	1	10	0	0
10	26206509	.	C	T	0	4	4	0	4	8	0	0
10	26209400	.	C	T	3	5	8	0	1	9	0	0
10	26269180	.	C	G	3	2	5	0	0	5	0	0
10	26269186	.	A	G	3	2	5	0	0	5	0	0
10	26269728	.	G	A	5	3	8	0	0	8	0	0
10	26270388	.	C	A	8	3	11	0	0	11	0	0
10	26271018	.	G	C	3	0	3	0	6	9	0	0
10	26271159	.	G	T	2	1	3	0	0	3	0	0
10	26271168	.	G	A	2	2	4	0	0	4	0	0
10	26271357	.	C	A	4	2	6	0	0	6	0	0
10	26272756	.	T	C	1	0	1	0	2	3	0	0
10	26273076	.	T	A	2	2	4	0	0	4	0	0
10	26273094	.	G	A	3	2	5	0	0	5	0	0
10	26273139	.	C	T	3	3	6	0	0	6	0	0
10	26273521	.	C	G	0	5	5	0	2	7	0	0
10	26273557	.	T	C	4	4	8	0	0	8	0	0
10	26504840	.	G	A	1	2	3	0	0	3	0	0
10	26505202	.	T	C	1	0	1	0	2	3	0	0
10	26505211	.	G	T	0	2	2	0	1	3	0	0
10	26508081	.	T	C	1	0	1	0	4	5	0	0
10	26512284	.	A	G	0	3	3	0	1	4	0	0
10	26512293	.	A	G	2	1	3	0	0	3	0	0
10	26543567	.	A	G	1	3	4	0	0	4	0	0
10	26544626	.	C	A	1	4	5	0	0	5	0	0
10	26551197	.	T	C	6	4	10	0	2	12	0	0
10	26551242	.	A	G	6	7	13	0	2	15	0	0
10	26553007	.	T	A	12	8	20	0	9	29	0	0
10	26560166	.	T	C	13	15	28	0	1	29	0	0
10	26560260	.	C	T	12	22	34	0	2	36	0	0
10	26565704	.	T	C	24	21	45	0	0	45	0	0
10	26565760	.	G	A	3	23	26	0	21	47	0	0
10	26566054	.	G	C	4	19	23	1	12	36	0	0
10	26566267	.	T	C	21	21	42	0	0	42	0	0
10	26566354	.	A	T	13	10	23	0	2	25	0	0
10	26566369	.	A	T	11	11	22	0	0	22	0	0
10	26566715	.	T	A	14	7	21	0	0	21	0	0
10	26566749	.	G	A	11	8	19	0	2	21	0	0
10	26566785	.	T	A	17	5	22	0	1	23	0	0
10	26566787	.	A	T	17	5	22	0	1	23	0	0
10	26566970	.	T	G	18	1	19	0	17	36	0	0
10	26567238	.	A	G	19	23	42	0	1	43	0	0
10	26567337	.	C	T	15	28	43	0	3	46	0	0
10	26567376	.	C	G	9	23	32	0	3	35	0	0
10	26567500	.	C	T	24	18	42	0	0	42	0	0
10	26567656	.	G	C	21	10	31	0	1	32	0	0
10	26567810	.	C	T	15	11	26	0	4	30	0	0
10	26567889	.	T	A	15	10	25	0	0	25	0	0
10	26567958	.	T	A	16	8	24	0	0	24	0	0
10	26568154	.	A	T	17	15	32	0	3	35	0	0
10	26568166	.	C	T	16	12	28	0	2	30	0	0
10	26568201	.	A	G	13	6	19	0	3	22	0	0
10	26568239	.	C	T	12	8	20	0	0	20	0	0
10	26568429	.	A	C	25	23	48	0	3	51	0	0
10	26568498	.	T	C	19	30	49	0	4	53	0	0
10	26568523	.	G	T	20	29	49	0	3	52	0	0
10	26568726	.	A	G	25	29	54	0	2	56	0	0
10	26569098	.	A	G	19	1	20	0	21	41	0	0
10	26569099	.	A	C	19	21	40	0	1	41	0	0
10	26569248	.	C	A	17	14	31	0	2	33	0	0
10	26574004	.	T	C	4	2	6	0	0	6	0	0
10	26578528	.	T	C	8	4	12	0	1	13	0	0
10	26583978	.	C	G	8	6	14	0	0	14	0	0
10	26596020	.	T	A	27	24	51	0	0	51	0	0
10	26596075	.	C	T	21	26	47	0	1	48	0	0
10	26596080	.	T	C	19	23	42	0	3	45	0	0
10	26656135	.	A	C	9	9	18	0	0	18	0	0
10	26933323	.	G	T	3	2	5	0	0	5	0	0
10	26944511	.	C	T	3	2	5	0	0	5	0	0
10	26944522	.	T	G	2	2	4	0	0	4	0	0
10	26958093	.	A	G	8	6	14	0	0	14	0	0
10	26958150	.	G	C	6	5	11	0	0	11	0	0
10	26958457	.	A	G	5	3	8	0	1	9	0	0
10	26959044	.	T	G	2	2	4	0	0	4	0	0
10	26959075	.	G	A	0	2	2	0	1	3	0	0
10	26959523	.	T	G	7	3	10	0	0	10	0	0
10	26959528	.	T	C	7	3	10	0	0	10	0	0
10	26959894	.	C	A	4	4	8	0	0	8	0	0
10	26960281	.	A	G	5	6	11	0	1	12	0	0
10	26960333	.	T	A	3	9	12	0	0	12	0	0
10	26965971	.	G	A	4	2	6	0	1	7	0	0
10	26972152	.	T	C	9	17	26	0	2	28	0	0
10	26972392	.	A	T	2	3	5	0	1	6	0	0
10	26972429	.	A	T	1	3	4	0	0	4	0	0
10	26973334	.	C	T	2	3	5	0	0	5	0	0
10	26973340	.	C	T	1	2	3	0	1	4	0	0
10	26977154	.	G	A	4	9	13	0	0	13	0	0
10	26978169	.	C	G	8	22	30	0	0	30	0	0
10	26982455	.	C	T	4	4	8	0	1	9	0	0
10	26982495	.	T	C	5	2	7	0	1	8	0	0
10	26982565	.	G	A	2	4	6	0	1	7	0	0
10	26982572	.	C	G	3	4	7	0	0	7	0	0
10	26982670	.	G	A	4	4	8	0	1	9	0	0
10	26982828	.	G	A	4	4	8	0	0	8	0	0
10	26983012	.	A	T	1	3	4	0	0	4	0	0
10	26983539	.	G	A	2	7	9	0	0	9	0	0
10	26983766	.	T	C	3	2	5	0	0	5	0	0
10	26987399	.	T	C	13	1	14	0	17	31	0	0
10	26989543	.	T	C	10	13	23	0	0	23	0	0
10	26989828	.	A	T	7	17	24	0	1	25	0	0
10	26989843	.	A	T	7	16	23	0	1	24	0	0
10	26990140	.	C	G	4	6	10	0	2	12	0	0
10	26991487	.	T	C	15	16	31	0	1	32	0	0
10	26991785	.	C	G	4	4	8	0	0	8	0	0
10	26991875	.	A	T	5	10	15	0	1	16	0	0
10	26991876	.	C	G	6	10	16	0	0	16	0	0
10	26991914	.	A	T	5	6	11	0	0	11	0	0
10	26991984	.	G	C	14	11	25	1	0	26	0	0
10	26997077	.	C	A	15	13	28	0	1	29	0	0
10	26997139	.	G	T	8	7	15	0	1	16	0	0
10	26997294	.	T	A	4	4	8	0	0	8	0	0
10	26998469	.	A	G	1	2	3	0	0	3	0	0
10	26998471	.	T	C	1	0	1	0	2	3	0	0
10	26999165	.	T	C	22	0	22	0	13	35	0	0
10	26999341	.	C	T	17	19	36	0	1	37	0	0
10	26999407	.	A	T	13	11	24	0	0	24	0	0
10	26999414	.	A	G	10	10	20	0	1	21	0	0
10	27006512	.	T	A	14	16	30	0	2	32	0	0
10	27006721	.	T	C	28	22	50	0	7	57	0	0
10	27046400	.	T	A	11	16	27	0	4	31	0	0
10	27054861	.	T	A	1	2	3	0	0	3	0	0
10	27057605	.	G	A	1	2	3	0	0	3	0	0
10	27058341	.	C	A	10	4	14	0	3	17	0	0
10	27058740	.	C	A	1	3	4	0	0	4	0	0
10	27091840	.	C	T	1	2	3	0	0	3	0	0
10	27092015	.	T	C	1	3	4	0	1	5	0	0
10	27092509	.	G	T	4	3	7	0	2	9	0	0
10	27183328	.	T	G	21	8	29	0	2	31	0	0
10	27183418	.	C	T	18	15	33	1	1	35	0	0
10	27183735	.	C	T	1	17	18	0	16	34	0	0
10	27184069	.	G	A	23	20	43	0	6	49	0	0
10	27184237	.	A	G	15	16	31	0	1	32	0	0
10	27184456	.	A	G	13	11	24	0	0	24	0	0
10	27184600	.	G	A	12	3	15	0	0	15	0	0
10	27184678	.	C	T	1	9	10	6	9	25	0	0
10	27184729	.	C	T	10	10	20	0	2	22	0	0
10	27184843	.	G	A	7	14	21	0	1	22	0	0
10	27184864	.	T	C	18	0	18	0	9	27	0	0
10	27184891	.	T	A	10	14	24	0	0	24	0	0
10	27184905	.	C	T	2	10	12	0	14	26	0	0
10	27185134	.	A	G	9	9	18	0	0	18	0	0
10	27190762	.	C	T	8	6	14	0	0	14	0	0
10	27196623	.	C	T	1	2	3	0	6	9	0	0
10	27196699	.	G	T	7	3	10	0	2	12	0	0
10	27196704	.	C	T	1	5	6	0	6	12	0	0
10	27977673	.	C	T	6	5	11	0	0	11	0	0
10	27977678	.	C	T	6	5	11	0	1	12	0	0
10	27978002	.	A	T	3	3	6	0	1	7	0	0
10	27978121	.	C	A	0	2	2	0	2	4	0	0
10	27978197	.	G	A	3	1	4	0	1	5	0	0
10	27984459	.	T	G	1	5	6	0	0	6	0	0
10	27984519	.	C	G	3	2	5	0	0	5	0	0
10	28030710	.	C	T	2	12	14	0	4	18	0	0
10	28030729	.	T	C	4	0	4	0	13	17	0	0
10	28030753	.	A	G	9	12	21	0	0	21	0	0
10	28030843	.	C	T	10	10	20	0	1	21	0	0
10	28036119	.	G	A	5	14	19	0	0	19	0	0
10	28037735	.	C	T	7	3	10	0	0	10	0	0
10	28038167	.	G	A	6	6	12	0	1	13	0	0
10	28039040	.	C	T	8	8	16	0	0	16	0	0
10	28040705	.	G	T	11	4	15	0	2	17	0	0
10	28041152	.	T	A	4	7	11	0	2	13	0	0
10	28041218	.	G	C	9	7	16	0	1	17	0	0
10	28043421	.	T	C	5	2	7	0	0	7	0	0
10	28057010	.	A	G	5	2	7	0	0	7	0	0
10	28057286	.	A	G	2	2	4	0	1	5	0	0
10	28057364	.	T	C	1	0	1	0	2	3	0	0
10	28161902	.	C	T	2	2	4	0	0	4	0	0
10	28165212	.	T	C	6	6	12	0	1	13	0	0
10	28168295	.	C	G	8	6	14	0	1	15	0	0
10	28168769	.	A	G	1	4	5	0	0	5	0	0
10	28168968	.	G	A	3	2	5	0	0	5	0	0
10	28169061	.	G	A	2	7	9	0	0	9	0	0
10	28172501	.	T	G	4	3	7	0	1	8	0	0
10	28308865	.	A	T	5	3	8	0	0	8	0	0
10	28308886	.	A	G	5	2	7	0	0	7	0	0
10	28311161	.	A	G	23	21	44	0	5	49	0	0
10	28315096	.	A	G	18	20	38	0	2	40	0	0
10	28315396	.	A	G	18	21	39	0	1	40	0	0
10	28315421	.	C	G	16	19	35	1	2	39	1	0
10	28319441	.	A	G	13	14	27	0	0	27	0	0
10	28320654	.	G	C	8	0	8	0	4	12	0	0
10	28321051	.	G	A	13	4	17	0	0	17	0	0
10	28328219	.	A	G	3	3	6	0	0	6	0	0
10	28328231	.	A	G	3	5	8	0	1	9	0	0
10	28332868	.	T	C	1	3	4	0	0	4	0	0
10	28334806	.	G	A	6	6	12	0	1	13	0	0
10	28339621	.	C	T	3	5	8	0	0	8	0	0
10	28349266	.	G	A	2	3	5	0	0	5	0	0
10	28350055	.	G	A	1	2	3	0	0	3	0	0
10	28355728	.	A	G	2	4	6	0	1	7	0	0
10	28370974	.	T	G	3	4	7	0	3	10	0	0
10	28371198	.	G	A	10	10	20	0	1	21	0	0
10	28371284	.	G	A	12	14	26	0	0	26	0	0
10	28371407	.	C	T	1	22	23	0	14	37	0	0
10	28376814	.	T	C	19	0	19	0	10	29	0	0
10	28376895	.	C	T	12	14	26	0	0	26	0	0
10	28695869	.	T	A	2	3	5	0	0	5	0	0
10	28723805	.	G	A	0	3	3	0	3	6	0	0
10	28724220	.	G	A	2	7	9	0	0	9	0	0
10	28730437	.	G	T	7	4	11	0	0	11	0	0
10	28730446	.	A	C	5	6	11	0	0	11	0	0
10	28730503	.	G	A	4	4	8	0	1	9	0	0
10	28730800	.	A	T	4	2	6	0	1	9	2	0
10	28730869	.	C	T	6	7	13	0	0	13	0	0
10	28730880	.	T	A	6	6	12	0	0	12	0	0
10	28730913	.	G	A	10	7	17	0	1	18	0	0
10	28731001	.	C	T	9	11	20	0	1	21	0	0
10	28731072	.	C	T	11	6	17	1	2	20	0	0
10	28731155	.	A	T	9	11	20	0	3	23	0	0
10	28731289	.	T	C	10	6	16	0	2	18	0	0
10	28731372	.	G	A	1	6	7	0	8	15	0	0
10	28732003	.	C	A	17	17	34	0	1	35	0	0
10	28732366	.	A	G	17	10	27	0	1	28	0	0
10	28732601	.	C	T	1	15	16	0	14	30	0	0
10	28732785	.	T	C	17	16	33	0	6	39	0	0
10	28733067	.	G	T	20	18	38	0	1	40	1	0
10	28733132	.	T	A	19	13	32	0	0	32	0	0
10	28737345	.	C	T	12	11	23	1	0	24	0	0
10	28743800	.	T	A	13	9	22	0	0	22	0	0
10	28745583	.	G	A	12	8	20	0	0	20	0	0
10	28748996	.	G	A	3	4	7	0	1	8	0	0
10	29166502	.	A	G	7	7	14	0	0	14	0	0
10	29185863	.	T	A	4	20	24	0	2	26	0	0
10	29187908	.	C	T	10	14	24	1	1	26	0	0
10	29201671	.	C	T	6	7	13	0	0	13	0	0
10	29205655	.	A	T	16	17	33	0	1	34	0	0
10	29223795	.	T	C	4	5	9	0	0	9	0	0
10	29224331	.	G	T	3	4	7	0	0	7	0	0
10	29224364	.	C	T	3	8	11	0	4	15	0	0
10	29224484	.	G	A	14	18	32	0	2	34	0	0
10	29224598	.	A	T	21	21	42	0	1	43	0	0
10	29224651	.	C	A	17	12	29	0	0	29	0	0
10	29225032	.	A	G	14	0	14	0	9	23	0	0
10	29265596	.	A	G	15	0	15	0	22	37	0	0
10	29265599	.	T	A	16	17	33	0	3	36	0	0
10	29266279	.	C	A	19	13	32	0	2	34	0	0
10	29266376	.	C	T	20	20	40	0	2	42	0	0
10	29270225	.	C	T	12	6	18	0	1	19	0	0
10	29271915	.	C	T	8	15	23	0	2	25	0	0
10	29578478	.	C	T	9	5	14	0	1	15	0	0
10	29661410	.	C	T	4	4	8	0	0	8	0	0
10	29661419	.	C	G	4	0	4	0	6	10	0	0
10	29678256	.	A	G	7	0	7	0	12	19	0	0
10	29678313	.	G	A	3	4	7	0	0	7	0	0
10	29705444	.	G	T	1	1	2	0	1	3	0	0
10	29736736	.	T	C	11	0	11	0	12	23	0	0
10	29736746	.	C	T	0	7	7	0	10	17	0	0
10	29736895	.	T	A	7	17	24	0	0	24	0	0
10	29738555	.	C	T	6	10	16	0	0	16	0	0
10	29742625	.	C	T	0	13	13	0	9	22	0	0
10	29742656	.	C	T	10	9	19	0	0	19	0	0
10	29742795	.	T	C	8	9	17	0	0	17	0	0
10	29751328	.	G	A	7	9	16	0	2	18	0	0
10	29751407	.	T	C	12	7	19	0	2	21	0	0
10	29761405	.	C	T	6	5	11	0	0	11	0	0
10	29762935	.	G	A	4	3	7	0	1	8	0	0
10	29762947	.	G	A	4	3	7	0	1	8	0	0
10	29763146	.	A	G	1	2	3	0	0	3	0	0
10	29766072	.	C	G	2	2	4	0	0	4	0	0
10	29782137	.	G	A	2	5	7	0	0	7	0	0
10	29788229	.	G	T	5	5	10	0	1	11	0	0
10	29815697	.	A	C	4	2	6	0	8	14	0	0
10	29815802	.	A	G	34	15	49	0	1	50	0	0
10	29816113	.	T	C	27	17	44	0	1	45	0	0
10	29816290	.	T	A	20	31	51	0	3	54	0	0
10	29816439	.	A	T	18	19	37	0	1	38	0	0
10	29816904	.	C	T	31	32	63	0	2	65	0	0
10	29817111	.	C	T	42	32	74	0	1	75	0	0
10	29817207	.	C	T	24	43	67	0	5	72	0	0
10	29817416	.	A	T	32	15	47	0	3	51	1	0
10	29823484	.	G	A	7	8	15	0	1	16	0	0
10	29824248	.	C	T	7	4	11	0	3	14	0	0
10	29824262	.	C	T	6	9	15	0	0	15	0	0
10	29851722	.	C	T	25	32	57	0	3	60	0	0
10	29852317	.	G	A	28	32	60	0	12	72	0	0
10	29852476	.	A	G	44	2	46	0	26	72	0	0
10	29852485	.	A	G	44	2	46	0	27	73	0	0
10	29876138	.	A	G	1	2	3	0	0	3	0	0
10	29892382	.	C	T	3	4	7	0	0	7	0	0
10	29892478	.	C	T	1	4	5	0	0	5	0	0
10	30576004	.	T	C	4	6	10	0	0	10	0	0
10	30576061	.	G	A	6	12	18	0	0	18	0	0
10	30618313	.	T	A	5	2	7	0	0	7	0	0
10	30618429	.	A	T	1	3	4	0	0	4	0	0
10	31020810	.	A	G	2	4	6	0	6	12	0	0
10	31021505	.	T	C	7	9	16	0	0	16	0	0
10	31021550	.	G	A	10	7	17	0	2	19	0	0
10	31021553	.	G	A	6	13	19	0	1	20	0	0
10	31021611	.	C	T	14	9	23	0	0	23	0	0
10	31021676	.	G	A	11	16	27	0	0	27	0	0
10	31023520	.	A	G	11	14	25	0	1	26	0	0
10	31032043	.	T	C	5	6	11	0	1	12	0	0
10	31034999	.	C	T	0	4	4	0	12	16	0	0
10	31035129	.	C	T	4	7	11	0	0	11	0	0
10	31035147	.	C	T	8	5	13	0	0	13	0	0
10	31624750	.	G	A	2	2	4	0	0	4	0	0
10	31628397	.	C	T	3	2	5	0	0	5	0	0
10	31628406	.	C	T	3	3	6	0	0	6	0	0
10	31628481	.	T	C	4	4	8	0	0	8	0	0
10	31632313	.	G	C	2	6	8	0	0	8	0	0
10	31632643	.	C	T	4	2	6	0	1	7	0	0
10	31632691	.	G	A	2	4	6	0	2	8	0	0
10	31632758	.	A	T	8	3	11	0	0	11	0	0
10	31632829	.	A	G	7	5	12	1	0	13	0	0
10	31632945	.	C	T	5	3	8	0	0	8	0	0
10	31633077	.	A	C	6	12	18	0	1	19	0	0
10	31633273	.	T	C	2	3	5	0	0	5	0	0
10	31633424	.	A	G	0	2	2	0	1	3	0	0
10	31633640	.	G	A	11	5	16	0	0	16	0	0
10	31633669	.	C	T	5	4	9	0	0	9	0	0
10	31725736	.	T	C	4	4	8	0	0	8	0	0
10	31726330	.	C	T	1	3	4	0	0	4	0	0
10	31738616	.	A	G	13	6	19	0	0	19	0	0
10	31739181	.	G	T	31	32	63	0	3	66	0	0
10	31739346	.	G	T	32	35	67	0	3	70	0	0
10	31751941	.	C	T	31	27	58	0	4	62	0	0
10	31757307	.	C	T	28	21	49	0	2	51	0	0
10	31772041	.	G	A	18	18	36	0	3	39	0	0
10	31782605	.	C	T	15	20	35	2	1	38	0	0
10	31800313	.	A	G	4	5	9	0	1	10	0	0
10	32037088	.	A	T	1	3	4	0	0	4	0	0
10	32037794	.	T	A	4	3	7	0	0	7	0	0
10	32038054	.	A	T	3	4	7	0	0	7	0	0
10	32038071	.	A	T	3	3	6	0	0	6	0	0
10	32062738	.	C	T	3	2	5	0	1	6	0	0
10	32063752	.	G	A	5	5	10	0	0	10	0	0
10	32064121	.	A	T	1	7	8	0	0	8	0	0
10	32064222	.	A	T	3	5	8	0	2	10	0	0
10	32122727	.	T	C	1	3	4	0	0	4	0	0
10	32122840	.	T	A	4	3	7	0	0	7	0	0
10	32122952	.	T	A	7	4	11	0	0	11	0	0
10	32265331	.	A	C	4	4	8	0	0	8	0	0
10	32265605	.	C	G	0	2	2	0	4	6	0	0
10	32413484	.	T	C	1	0	1	0	3	4	0	0
10	32561338	.	G	A	4	6	10	0	0	10	0	0
10	32561427	.	A	C	4	3	7	0	0	7	0	0
10	32561437	.	T	A	3	3	6	0	1	7	0	0
10	32561466	.	T	C	3	2	5	0	0	5	0	0
10	32561564	.	A	C	2	8	10	0	1	11	0	0
10	32561575	.	C	T	3	7	10	0	0	10	0	0
10	32561817	.	G	A	0	3	3	0	14	17	0	0
10	32561820	.	G	T	13	3	16	0	1	17	0	0
10	32561916	.	C	T	16	5	21	0	0	21	0	0
10	32562267	.	C	T	9	10	19	0	1	21	1	0
10	32577486	.	G	A	14	8	22	0	1	23	0	0
10	32577489	.	A	G	14	8	22	0	2	24	0	0
10	32577522	.	C	T	9	12	21	0	1	22	0	0
10	32577549	.	T	C	9	11	20	0	0	20	0	0
10	32577621	.	G	A	6	15	21	0	0	21	0	0
10	32657550	.	A	G	1	2	3	0	0	3	0	0
10	32857382	.	T	C	25	1	26	0	11	37	0	0
10	32857386	.	C	T	7	28	35	0	2	37	0	0
10	32857419	.	T	C	21	0	21	0	18	39	0	0
10	34661821	.	T	C	2	2	4	0	0	4	0	0
10	34661857	.	A	G	1	2	3	0	0	3	0	0
10	34676094	.	A	G	4	0	4	0	3	7	0	0
10	34676266	.	G	T	4	1	5	0	1	6	0	0
10	34677539	.	T	C	1	2	3	0	0	3	0	0
10	34677569	.	C	T	2	2	4	0	0	4	0	0
10	34677673	.	T	C	1	4	5	0	0	5	0	0
10	34699238	.	C	T	4	3	7	0	1	8	0	0
10	34701434	.	A	C	6	7	13	0	0	13	0	0
10	34703802	.	A	G	4	0	4	0	4	8	0	0
10	34707546	.	A	T	4	7	11	0	1	12	0	0
10	34709940	.	C	T	6	6	12	0	0	12	0	0
10	34724906	.	C	T	7	9	16	0	1	17	0	0
10	34729552	.	G	A	17	19	36	0	1	37	0	0
10	34729693	.	C	T	12	15	27	0	0	27	0	0
10	34733566	.	A	G	31	17	48	0	0	48	0	0
10	34733578	.	A	G	33	0	33	1	15	49	0	0
10	34733661	.	C	T	17	17	34	0	13	47	0	0
10	34733883	.	A	T	14	27	41	0	3	44	0	0
10	34734568	.	G	T	4	22	26	0	14	40	0	0
10	34734590	.	A	G	19	22	41	0	3	44	0	0
10	34734785	.	G	T	25	14	39	2	1	42	0	0
10	34737686	.	A	G	22	24	46	0	1	47	0	0
10	34738125	.	T	C	31	19	50	0	5	55	0	0
10	34741649	.	T	A	31	17	48	0	1	49	0	0
10	34743910	.	G	A	13	15	28	0	3	31	0	0
10	34754660	.	C	T	16	14	30	0	0	30	0	0
10	34756936	.	A	C	9	9	18	0	3	21	0	0
10	34772168	.	A	G	7	5	12	0	2	14	0	0
10	34813299	.	T	C	9	4	13	0	0	13	0	0
10	34867259	.	T	C	1	1	2	0	6	8	0	0
10	34867466	.	C	T	3	5	8	0	0	8	0	0
10	34958760	.	A	T	16	8	24	0	5	29	0	0
10	34961149	.	C	A	16	15	31	0	2	33	0	0
10	34973943	.	A	G	3	3	6	0	0	6	0	0
10	34984675	.	T	A	5	2	7	0	0	7	0	0
10	34984836	.	A	G	7	25	32	0	1	33	0	0
10	34984923	.	T	C	19	13	32	0	2	34	0	0
10	34984931	.	C	A	2	14	16	0	20	36	0	0
10	34989149	.	T	C	8	1	9	0	15	24	0	0
10	34998281	.	G	C	5	5	10	0	0	10	0	0
10	35002400	.	C	A	3	4	7	0	0	7	0	0
10	35006036	.	A	T	8	2	10	0	1	11	0	0
10	35006358	.	T	C	1	8	9	0	0	9	0	0
10	35006504	.	C	A	2	10	12	0	0	12	0	0
10	35008963	.	C	T	7	4	11	0	1	12	0	0
10	35011325	.	C	T	11	3	14	0	1	15	0	0
10	35011337	.	A	G	3	12	15	0	0	15	0	0
10	35012184	.	C	T	3	10	13	0	12	25	0	0
10	35025832	.	G	C	3	3	6	0	0	6	0	0
10	35029172	.	G	A	4	5	9	0	0	9	0	0
10	35032814	.	T	C	5	2	7	0	1	8	0	0
10	35033900	.	G	A	1	5	6	0	0	6	0	0
10	35046093	.	C	T	1	5	6	0	0	6	0	0
10	35103155	.	A	G	3	4	7	0	0	7	0	0
10	35220214	.	C	T	2	1	3	0	1	4	0	0
10	35241646	.	A	T	6	3	9	0	0	9	0	0
10	35242113	.	C	G	2	5	7	0	1	8	0	0
10	35245939	.	T	A	2	4	6	0	1	7	0	0
10	35245951	.	C	T	3	4	7	0	0	7	0	0
10	35248433	.	G	A	1	3	4	0	0	4	0	0
10	35250755	.	T	A	1	3	4	0	0	4	0	0
10	35265206	.	T	A	1	2	3	0	0	3	0	0
10	35266720	.	G	A	0	3	3	0	1	4	0	0
10	35281388	.	T	C	2	2	4	0	0	4	0	0
10	35300764	.	C	T	4	4	8	0	1	9	0	0
10	35302425	.	T	C	8	7	15	0	0	15	0	0
10	35304002	.	G	A	3	3	6	0	1	7	0	0
10	35307579	.	C	T	3	3	6	0	0	6	0	0
10	35312021	.	A	C	15	12	27	0	2	29	0	0
10	35312143	.	A	G	5	1	6	0	7	13	0	0
10	35314958	.	G	A	1	2	3	0	1	4	0	0
10	35314974	.	T	A	1	3	4	0	1	5	0	0
10	35538879	.	T	A	22	13	35	0	0	35	0	0
10	35539607	.	A	G	18	16	34	0	2	36	0	0
10	35539631	.	G	A	17	16	33	0	1	34	0	0
10	35540422	.	T	A	9	10	19	0	2	21	0	0
10	35540603	.	C	T	15	11	26	0	5	31	0	0
10	35540675	.	T	G	9	13	22	0	1	23	0	0
10	35540705	.	T	A	11	13	24	0	2	26	0	0
10	35540732	.	T	G	11	13	24	0	1	25	0	0
10	35540847	.	T	G	6	7	13	0	0	13	0	0
10	35541245	.	T	C	3	4	7	0	0	7	0	0
10	35541290	.	A	G	1	4	5	0	0	5	0	0
10	35579985	.	C	T	1	2	3	0	0	3	0	0
10	35584806	.	T	G	20	14	34	0	1	35	0	0
10	35584815	.	A	G	19	11	30	0	0	30	0	0
10	35584855	.	T	A	7	9	16	0	3	19	0	0
10	35585057	.	A	T	3	5	8	0	0	8	0	0
10	35585195	.	G	A	5	11	16	0	1	17	0	0
10	35585197	.	A	G	8	11	19	0	0	19	0	0
10	35585257	.	C	T	12	12	24	0	2	26	0	0
10	35585284	.	C	T	3	8	11	0	9	20	0	0
10	35592817	.	A	G	12	4	16	0	2	18	0	0
10	35592830	.	G	A	14	8	22	0	0	22	0	0
10	35595335	.	C	T	6	4	10	0	1	11	0	0
10	35595669	.	T	A	6	5	11	0	2	13	0	0
10	35602535	.	G	T	5	2	7	0	0	7	0	0
10	35602678	.	G	A	3	2	5	0	0	5	0	0
10	35607247	.	G	C	0	0	0	0	3	3	0	0
10	35607250	.	C	T	1	1	2	0	1	3	0	0
10	35609468	.	T	C	4	4	8	0	0	8	0	0
10	35609501	.	T	C	1	1	2	0	7	9	0	0
10	35654268	.	C	T	9	17	26	0	3	29	0	0
10	35654290	.	A	C	11	22	33	0	2	35	0	0
10	35654305	.	T	C	10	26	36	0	0	36	0	0
10	35664481	.	C	T	5	2	7	0	0	7	0	0
10	35664495	.	C	T	2	2	4	0	4	8	0	0
10	35664527	.	T	C	4	2	6	0	0	6	0	0
10	36443018	.	T	C	15	6	21	0	1	22	0	0
10	36443541	.	T	C	10	13	23	0	1	25	1	0
10	36443676	.	G	A	0	17	17	0	7	24	0	0
10	36443714	.	G	A	8	13	21	0	0	21	0	0
10	36443818	.	T	G	9	0	9	0	6	15	0	0
10	36446799	.	A	T	5	7	12	0	0	12	0	0
10	36451615	.	T	C	17	6	23	0	1	24	0	0
10	36451661	.	G	A	21	14	35	0	1	36	0	0
10	36454567	.	C	A	13	14	27	0	2	29	0	0
10	36454649	.	A	G	20	0	20	0	19	39	0	0
10	36454650	.	C	A	23	16	39	0	0	39	0	0
10	36454902	.	G	T	19	11	30	0	2	32	0	0
10	36455146	.	C	T	15	14	29	0	1	30	0	0
10	36455215	.	T	C	19	11	30	0	1	31	0	0
10	36455229	.	C	G	18	9	27	0	1	28	0	0
10	36455344	.	A	G	21	15	36	0	3	39	0	0
10	36455847	.	G	A	1	5	6	0	7	13	0	0
10	36476481	.	C	T	2	20	22	0	17	39	0	0
10	36476529	.	C	T	16	9	25	0	1	26	0	0
10	36476639	.	C	T	0	13	13	0	14	27	0	0
10	36476717	.	A	G	16	12	28	0	2	30	0	0
10	36476834	.	G	A	11	19	30	0	0	30	0	0
10	36476852	.	A	G	10	20	30	0	1	31	0	0
10	36476922	.	C	T	8	14	22	0	3	25	0	0
10	36481915	.	A	C	14	12	26	0	0	26	0	0
10	36482588	.	G	A	6	16	22	0	1	23	0	0
10	36487530	.	G	A	7	7	14	0	1	15	0	0
10	36489882	.	A	G	8	7	15	0	2	17	0	0
10	36489893	.	A	G	6	8	14	0	1	15	0	0
10	36492091	.	C	T	3	3	6	0	0	6	0	0
10	36494590	.	C	G	9	8	17	0	0	17	0	0
10	36495580	.	T	G	3	3	6	0	1	7	0	0
10	36496544	.	A	G	5	5	10	0	0	10	0	0
10	36496595	.	G	A	11	9	20	0	0	20	0	0
10	36498379	.	C	T	0	3	3	0	4	7	0	0
10	36498397	.	G	A	3	4	7	0	1	8	0	0
10	36500581	.	C	T	3	2	5	0	0	5	0	0
10	36500674	.	G	A	3	8	11	0	0	11	0	0
10	36504163	.	C	T	0	4	4	0	3	7	0	0
10	36506103	.	G	A	2	4	6	0	1	7	0	0
10	36506290	.	C	T	0	3	3	0	5	8	0	0
10	36506630	.	T	A	3	2	5	0	1	6	0	0
10	36518643	.	C	T	1	2	3	0	0	3	0	0
10	36558839	.	A	G	4	8	12	0	1	13	0	0
10	36558895	.	G	A	11	5	16	0	0	16	0	0
10	36570469	.	A	G	11	7	18	0	0	18	0	0
10	36572622	.	G	A	2	2	4	0	0	4	0	0
10	36572814	.	A	T	2	2	4	0	0	4	0	0
10	36613095	.	T	C	6	5	11	0	1	12	0	0
10	36613145	.	G	T	6	15	21	0	0	21	0	0
10	36613164	.	C	T	1	15	16	0	5	21	0	0
10	36613276	.	C	T	8	4	12	0	2	14	0	0
10	36615367	.	G	A	7	7	14	0	0	14	0	0
10	36615907	.	C	A	6	4	10	0	0	10	0	0
10	36618435	.	C	T	1	7	8	0	7	15	0	0
10	36618787	.	C	T	13	10	23	0	0	23	0	0
10	36625534	.	G	A	5	5	10	0	0	10	0	0
10	36625761	.	T	A	6	5	11	0	3	14	0	0
10	36627009	.	G	C	3	5	8	0	0	8	0	0
10	36627390	.	A	G	3	2	5	0	0	5	0	0
10	36627820	.	C	T	8	3	11	0	0	11	0	0
10	36628009	.	C	A	2	3	5	0	0	5	0	0
10	36628012	.	G	A	2	3	5	0	0	5	0	0
10	36628121	.	G	T	1	3	4	0	0	4	0	0
10	36628569	.	C	T	0	2	2	0	1	3	0	0
10	36628626	.	G	A	1	2	3	0	0	3	0	0
10	36628804	.	G	T	3	2	5	0	0	5	0	0
10	36670106	.	T	C	3	4	7	0	0	7	0	0
10	36673237	.	G	T	1	2	3	0	0	3	0	0
10	36688455	.	C	T	5	6	11	0	1	12	0	0
10	36689850	.	G	T	6	3	9	0	0	9	0	0
10	36691372	.	C	A	0	4	4	0	5	9	0	0
10	36691636	.	G	A	9	4	13	0	0	13	0	0
10	36695781	.	G	C	3	7	10	0	1	11	0	0
10	36695785	.	C	T	2	7	9	0	1	10	0	0
10	36704842	.	A	G	15	13	28	3	0	31	0	0
10	36706217	.	T	A	10	17	27	0	5	32	0	0
10	36708401	.	A	G	19	0	19	0	24	43	0	0
10	36708453	.	C	T	15	17	32	0	3	35	0	0
10	36710559	.	A	C	13	17	30	0	5	35	0	0
10	36710599	.	C	T	20	17	37	0	2	39	0	0
10	36710871	.	G	A	5	12	17	0	24	42	1	0
10	36710893	.	G	T	2	25	27	0	12	39	0	0
10	36711260	.	T	A	6	9	15	0	3	18	0	0
10	36711329	.	T	A	11	9	20	0	3	23	0	0
10	36711613	.	C	T	9	9	18	0	1	19	0	0
10	36774339	.	A	C	4	4	8	0	0	8	0	0
10	36774379	.	T	A	2	3	5	0	0	5	0	0
10	36796131	.	T	A	5	4	9	0	1	10	0	0
10	36800465	.	G	A	3	10	13	0	2	15	0	0
10	36800518	.	C	T	6	7	13	0	0	13	0	0
10	36800600	.	G	A	4	2	6	0	0	6	0	0
10	36800642	.	A	G	6	3	9	0	0	9	0	0
10	36807986	.	G	A	2	4	6	0	1	7	0	0
10	36808032	.	G	A	1	1	2	0	1	3	0	0
10	36811815	.	A	G	14	7	21	0	0	21	0	0
10	36812214	.	A	C	8	10	18	0	3	21	0	0
10	36814912	.	G	A	6	10	16	0	0	16	0	0
10	36815330	.	T	C	5	1	6	0	7	13	0	0
10	36817197	.	A	C	4	6	10	0	0	10	0	0
10	36817355	.	C	T	0	6	6	0	2	8	0	0
10	36817530	.	C	T	5	4	9	0	1	10	0	0
10	36817940	.	T	C	7	5	12	0	0	12	0	0
10	36817979	.	T	G	7	4	11	0	2	13	0	0
10	36819671	.	C	T	3	11	14	0	1	15	0	0
10	36820601	.	C	T	1	4	5	0	2	7	0	0
10	36820611	.	A	G	4	3	7	0	2	9	0	0
10	36820664	.	C	T	5	4	9	0	2	11	0	0
10	36820688	.	C	G	1	2	3	0	5	8	0	0
10	36820736	.	G	A	2	4	6	0	0	6	0	0
10	36820769	.	T	A	1	4	5	0	0	5	0	0
10	36820892	.	G	A	3	4	7	0	0	7	0	0
10	36825818	.	T	C	1	2	3	0	0	3	0	0
10	36825880	.	G	A	1	4	5	0	0	5	0	0
10	36828110	.	A	T	1	2	3	0	0	3	0	0
10	36828227	.	T	C	7	17	24	0	1	25	0	0
10	36828295	.	G	T	4	6	10	0	1	11	0	0
10	36828469	.	T	C	9	0	9	0	13	22	0	0
10	36828475	.	C	T	11	11	22	0	1	23	0	0
10	36835641	.	A	T	4	4	8	0	1	9	0	0
10	36835740	.	G	A	5	7	12	0	0	12	0	0
10	36838768	.	C	T	3	3	6	0	0	6	0	0
10	36841230	.	G	T	7	4	11	0	2	13	0	0
10	36843041	.	C	A	1	3	4	0	0	4	0	0
10	36843045	.	G	A	2	3	5	0	0	5	0	0
10	36852643	.	G	A	2	3	5	0	0	5	0	0
10	36878568	.	C	T	1	1	2	0	1	3	0	0
10	36950935	.	A	T	3	4	7	0	0	7	0	0
10	36951044	.	A	T	8	11	19	0	0	19	0	0
10	36951076	.	G	C	7	9	16	0	2	18	0	0
10	36951223	.	A	C	12	13	25	0	0	25	0	0
10	36951378	.	A	G	6	6	12	0	0	12	0	0
10	36951582	.	C	G	10	15	25	0	2	27	0	0
10	36951660	.	T	A	3	8	11	1	1	13	0	0
10	36963456	.	G	A	5	10	15	0	0	15	0	0
10	36967206	.	T	C	16	8	24	0	1	25	0	0
10	36969510	.	T	C	5	10	15	0	0	15	0	0
10	36969519	.	A	G	3	7	10	0	1	11	0	0
10	36974901	.	G	A	4	2	6	0	0	6	0	0
10	36976271	.	C	T	0	3	3	0	2	5	0	0
10	36999951	.	A	G	3	2	5	0	0	5	0	0
10	37007508	.	G	C	4	4	8	0	1	9	0	0
10	37137549	.	G	A	1	3	4	0	8	12	0	0
10	37145178	.	G	A	9	6	15	0	0	15	0	0
10	37152081	.	G	A	12	23	35	0	0	35	0	0
10	37152105	.	A	G	17	0	17	0	18	35	0	0
10	37163252	.	C	A	11	21	32	0	0	32	0	0
10	37167151	.	G	C	16	13	29	0	0	29	0	0
10	37227524	.	C	T	2	2	4	0	0	4	0	0
10	37234093	.	A	G	3	1	4	0	1	5	0	0
10	37236672	.	T	G	1	0	1	0	3	4	0	0
10	37239229	.	G	A	1	4	5	0	0	5	0	0
10	37252054	.	G	A	0	4	4	0	6	10	0	0
10	37253986	.	A	G	1	7	8	0	4	12	0	0
10	37394478	.	G	A	3	3	6	0	0	6	0	0
10	37394486	.	G	A	3	3	6	0	1	7	0	0
10	37394535	.	C	T	1	4	5	0	1	6	0	0
10	37394809	.	A	G	1	2	3	0	1	4	0	0
10	37764473	.	C	T	9	12	21	0	1	22	0	0
10	37779765	.	A	C	15	9	24	0	1	25	0	0
10	37779778	.	T	A	15	9	24	0	0	24	0	0
10	37783114	.	A	G	13	7	20	0	0	20	0	0
10	37783179	.	A	G	12	0	12	0	13	25	0	0
10	37783323	.	A	G	12	12	24	0	0	24	0	0
10	37783558	.	T	C	4	2	6	0	1	7	0	0
10	37783669	.	C	A	5	7	12	0	0	12	0	0
10	37992653	.	C	T	4	3	7	0	1	8	0	0
10	37992679	.	G	A	0	3	3	0	5	8	0	0
10	37992839	.	A	T	4	2	6	0	1	7	0	0
10	37997567	.	C	G	3	5	8	0	0	8	0	0
10	38000082	.	C	G	5	4	9	0	0	9	0	0
10	38000084	.	G	T	0	5	5	0	4	9	0	0
10	38003011	.	A	G	10	6	16	0	0	16	0	0
10	38006099	.	G	A	0	2	2	0	1	3	0	0
10	38006787	.	A	T	1	2	3	0	0	3	0	0
10	38007336	.	C	T	1	2	3	0	0	3	0	0
10	38040372	.	A	G	14	12	26	0	1	27	0	0
10	38040378	.	A	G	14	12	26	0	1	27	0	0
10	38074570	.	G	T	10	12	22	0	2	24	0	0
10	38149713	.	C	A	0	6	6	0	5	11	0	0
10	38149715	.	A	G	4	7	11	0	0	11	0	0
10	38170573	.	G	A	5	3	8	1	1	10	0	0
10	38170574	.	A	G	4	5	9	1	1	11	0	0
10	38170737	.	G	A	10	11	21	0	0	21	0	0
10	38171149	.	G	C	12	0	12	0	6	18	0	0
10	38171196	.	G	A	7	10	17	0	1	18	0	0
10	38171207	.	C	A	11	9	20	0	4	24	0	0
10	38171356	.	A	T	5	16	21	0	3	24	0	0
10	38171490	.	T	A	13	5	18	0	0	18	0	0
10	38173383	.	C	A	2	13	15	0	6	21	0	0
10	38177999	.	C	T	1	14	15	0	11	26	0	0
10	38178357	.	G	A	9	5	14	0	1	15	0	0
10	38180732	.	A	T	7	6	13	0	0	13	0	0
10	38199169	.	T	C	6	9	15	0	1	16	0	0
10	38201513	.	G	A	2	4	6	0	0	6	0	0
10	38211810	.	C	G	3	4	7	0	1	8	0	0
10	38235957	.	G	C	1	2	3	0	0	3	0	0
10	38243449	.	G	A	2	3	5	0	1	6	0	0
10	38243543	.	G	A	2	3	5	0	0	5	0	0
10	38256723	.	G	A	5	2	7	0	0	7	0	0
10	38257295	.	G	A	5	6	11	0	2	13	0	0
10	38257509	.	C	G	0	9	9	0	5	14	0	0
10	38257558	.	C	T	7	8	15	0	0	15	0	0
10	38257870	.	T	C	17	16	33	0	2	35	0	0
10	38258729	.	C	G	12	15	27	0	1	28	0	0
10	38259033	.	C	T	5	9	14	0	1	15	0	0
10	38259034	.	A	G	6	9	15	0	0	15	0	0
10	38259204	.	G	A	4	3	7	0	0	7	0	0
10	38259217	.	A	G	3	3	6	0	0	6	0	0
10	38259268	.	G	C	2	3	5	1	0	6	0	0
10	38259339	.	A	T	3	4	7	0	0	7	0	0
10	38259449	.	A	C	7	0	7	0	7	14	0	0
10	38259451	.	A	G	7	7	14	0	0	14	0	0
10	38260002	.	G	A	5	3	8	0	0	8	0	0
10	38260626	.	A	T	3	3	6	0	0	6	0	0
10	38261109	.	T	C	2	3	5	0	0	5	0	0
10	38665994	.	C	T	9	4	13	0	1	14	0	0
10	38666063	.	T	C	5	4	9	0	0	9	0	0
10	38686126	.	T	C	11	9	20	0	2	22	0	0
10	38695152	.	A	C	21	17	38	0	2	40	0	0
10	38695510	.	A	G	19	11	30	0	1	31	0	0
10	38695656	.	A	G	19	10	29	0	1	30	0	0
10	38695877	.	C	T	8	14	22	0	0	22	0	0
10	38695888	.	C	T	9	13	22	0	0	22	0	0
10	38712431	.	C	T	1	3	4	0	1	5	0	0
10	38712508	.	C	T	1	4	5	0	0	5	0	0
10	38723491	.	T	C	1	4	5	0	0	5	0	0
10	38723539	.	T	C	3	5	8	0	0	8	0	0
10	38724101	.	C	T	3	5	8	0	0	8	0	0
10	38726441	.	C	T	2	3	5	0	1	6	0	0
10	38775780	.	C	G	2	2	4	0	0	4	0	0
10	38891454	.	C	A	3	3	6	0	0	6	0	0
10	38922043	.	G	A	0	7	7	0	3	10	0	0
10	38924557	.	C	T	4	4	8	0	2	10	0	0
10	38924560	.	T	C	5	4	9	0	1	10	0	0
10	38934391	.	A	G	3	2	5	0	0	5	0	0
10	38940232	.	A	G	7	5	12	0	0	12	0	0
10	38943265	.	C	G	9	6	15	0	1	16	0	0
10	38950115	.	T	C	8	6	14	0	2	16	0	0
10	38950430	.	G	A	1	11	12	0	8	21	1	0
10	38950484	.	A	G	12	15	27	0	0	27	0	0
10	38950538	.	T	C	11	10	21	0	3	24	0	0
10	38954126	.	C	T	14	20	34	0	3	37	0	0
10	38954141	.	T	C	14	21	35	0	2	37	0	0
10	38954798	.	T	C	12	12	24	0	1	25	0	0
10	38954801	.	C	T	15	12	27	0	1	28	0	0
10	38957061	.	T	C	14	11	25	0	2	27	0	0
10	38957127	.	G	A	1	13	14	0	20	34	0	0
10	38957193	.	C	T	16	14	30	0	1	31	0	0
10	38957748	.	A	C	13	13	26	0	3	29	0	0
10	38957754	.	A	C	17	14	31	0	1	32	0	0
10	38969552	.	A	C	43	18	61	0	1	62	0	0
10	38969598	.	A	C	28	24	52	0	4	56	0	0
10	38969629	.	C	T	26	30	56	0	1	57	0	0
10	38969685	.	A	G	23	29	52	0	4	56	0	0
10	38969778	.	C	T	25	20	45	0	2	47	0	0
10	39011484	.	C	T	15	22	37	0	0	37	0	0
10	39086981	.	G	A	24	31	55	0	0	55	0	0
10	39087391	.	A	G	36	1	37	1	35	73	0	0
10	39087625	.	T	A	34	22	56	0	1	57	0	0
10	39087659	.	T	A	30	26	56	0	1	58	1	0
10	39091792	.	A	G	2	0	2	0	4	6	0	0
10	39102672	.	G	C	3	2	5	0	0	5	0	0
10	39102776	.	T	C	5	4	9	0	0	9	0	0
10	39110452	.	G	C	1	7	8	0	0	8	0	0
10	39115595	.	G	T	5	9	14	0	0	14	0	0
10	39115596	.	T	C	5	9	14	0	0	14	0	0
10	39120132	.	T	C	12	10	22	0	2	24	0	0
10	39130460	.	C	T	38	36	74	0	4	78	0	0
10	39152038	.	A	G	1	3	4	0	0	4	0	0
10	39175452	.	C	T	2	2	4	0	0	4	0	0
10	39177816	.	T	C	1	2	3	0	0	3	0	0
10	39179925	.	T	A	1	2	3	0	0	3	0	0
10	39179992	.	G	C	5	4	9	0	0	9	0	0
10	39181040	.	G	T	3	2	5	0	0	5	0	0
10	39181088	.	G	T	1	2	3	0	2	5	0	0
10	39182173	.	A	G	13	6	19	0	1	20	0	0
10	39182342	.	A	T	15	4	19	0	0	19	0	0
10	39182401	.	C	A	10	9	19	0	1	20	0	0
10	39182497	.	C	T	14	7	21	0	0	21	0	0
10	39182602	.	G	A	0	6	6	0	3	9	0	0
10	39182640	.	T	A	4	1	5	0	0	5	0	0
10	39182659	.	G	T	4	3	7	0	0	7	0	0
10	39182703	.	T	G	4	0	4	0	4	8	0	0
10	39182877	.	G	A	5	4	9	0	0	9	0	0
10	39199639	.	G	A	0	2	2	0	2	4	0	0
10	39205021	.	C	T	3	6	9	0	0	9	0	0
10	39205256	.	C	G	3	2	5	0	1	6	0	0
10	39206945	.	A	G	9	4	13	0	0	13	0	0
10	39207104	.	C	A	2	3	5	0	0	5	0	0
10	39207114	.	C	A	3	3	6	0	0	6	0	0
10	39207749	.	C	T	4	2	6	0	0	6	0	0
10	39216625	.	C	T	5	3	8	0	3	11	0	0
10	39219390	.	T	C	5	3	8	0	0	8	0	0
10	39219540	.	T	A	8	8	16	0	0	16	0	0
10	39222134	.	A	C	10	15	25	0	0	25	0	0
10	39222182	.	A	G	17	12	29	0	0	29	0	0
10	39225504	.	A	C	13	16	29	0	0	29	0	0
10	39225555	.	T	C	16	11	27	0	4	31	0	0
10	39231387	.	G	A	15	19	34	0	4	38	0	0
10	39266017	.	T	G	3	0	3	0	3	6	0	0
10	39266350	.	G	T	0	2	2	0	2	4	0	0
10	39266422	.	C	T	3	2	5	0	0	5	0	0
10	39266669	.	A	C	5	4	9	0	1	10	0	0
10	39266702	.	A	G	4	0	4	0	7	11	0	0
10	39266756	.	A	G	1	2	3	0	0	3	0	0
10	39266758	.	G	A	1	2	3	0	0	3	0	0
10	39267045	.	G	C	1	3	4	0	3	7	0	0
10	39277087	.	C	G	5	2	7	0	0	7	0	0
10	39285288	.	T	C	4	2	6	0	0	6	0	0
10	39286967	.	C	T	3	3	6	0	0	6	0	0
10	39287100	.	C	T	3	4	7	0	0	7	0	0
10	39289006	.	A	G	1	3	4	0	3	7	0	0
10	39289036	.	A	C	2	4	6	0	0	6	0	0
10	39292583	.	A	C	3	2	5	0	0	5	0	0
10	39293335	.	T	C	4	8	12	0	0	12	0	0
10	39293358	.	G	A	4	5	9	0	0	9	0	0
10	39293705	.	A	G	5	2	7	0	0	7	0	0
10	39293707	.	A	T	4	2	6	0	1	7	0	0
10	39294067	.	T	G	1	6	7	0	0	7	0	0
10	39307378	.	T	C	1	5	6	0	0	6	0	0
10	39904774	.	G	A	0	9	9	0	11	20	0	0
10	39904780	.	C	T	8	8	16	0	0	17	1	0
10	39904851	.	A	T	3	4	7	0	1	8	0	0
10	39904915	.	A	G	13	10	23	0	2	25	0	0
10	39904966	.	T	C	7	5	12	0	0	12	0	0
10	39905085	.	A	T	8	5	13	0	0	13	0	0
10	39905089	.	T	G	8	5	13	0	0	13	0	0
10	40109439	.	G	A	0	3	3	0	7	10	0	0
10	40110599	.	G	A	0	2	2	0	1	3	0	0
10	40110666	.	T	A	3	2	5	0	0	5	0	0
10	40110714	.	C	T	3	3	6	0	0	6	0	0
10	40110809	.	G	A	0	1	1	0	2	3	0	0
10	40110814	.	C	A	1	1	2	0	0	2	0	0
10	40110853	.	A	T	2	1	3	0	0	3	0	0
10	40111437	.	T	A	1	3	4	0	0	4	0	0
10	40111666	.	G	C	3	2	5	0	2	7	0	0
10	40111706	.	A	G	3	5	8	0	1	9	0	0
10	40111732	.	C	T	3	5	8	0	0	8	0	0
10	40111952	.	C	T	1	2	3	0	0	3	0	0
10	40111964	.	C	A	1	2	3	0	1	4	0	0
10	40112096	.	C	A	3	2	5	0	0	5	0	0
10	40112121	.	A	G	3	3	6	0	0	6	0	0
10	40112347	.	A	T	1	4	5	0	1	6	0	0
10	40112476	.	T	A	3	4	7	0	0	7	0	0
10	40112638	.	C	T	1	3	4	0	1	5	0	0
10	40112793	.	G	A	2	2	4	0	0	4	0	0
10	40112802	.	T	G	3	2	5	0	0	5	0	0
10	40113032	.	T	A	3	4	7	0	1	8	0	0
10	40113045	.	A	G	4	3	7	0	0	7	0	0
10	40113161	.	C	A	2	1	3	0	1	4	0	0
10	40113408	.	A	G	8	7	15	0	0	15	0	0
10	40113446	.	T	C	4	2	6	0	0	6	0	0
10	40236068	.	A	G	3	0	3	0	2	5	0	0
10	40262052	.	T	C	2	2	4	0	0	4	0	0
10	40274411	.	G	A	1	3	4	0	0	4	0	0
10	40274541	.	G	A	0	6	6	0	3	9	0	0
10	40303924	.	G	C	2	2	4	0	0	4	0	0
10	40303980	.	A	G	2	2	4	0	0	4	0	0
10	40307622	.	C	T	3	2	5	0	0	5	0	0
10	40311286	.	G	T	0	3	3	0	2	5	0	0
10	40314046	.	T	C	2	2	4	0	0	4	0	0
10	40314060	.	T	A	1	3	4	0	0	4	0	0
10	40314175	.	A	C	5	4	9	0	0	9	0	0
10	40314177	.	A	C	4	4	8	0	1	9	0	0
10	40316924	.	T	G	3	3	6	0	0	6	0	0
10	40317095	.	G	T	3	7	10	0	0	10	0	0
10	40317285	.	A	T	1	4	5	0	1	6	0	0
10	40317323	.	A	G	1	0	1	0	4	5	0	0
10	40317341	.	A	G	1	3	4	0	0	4	0	0
10	40822252	.	C	T	2	10	12	0	9	21	0	0
10	40825192	.	T	C	12	6	18	0	0	18	0	0
10	40826436	.	A	G	6	5	11	0	0	11	0	0
10	40826494	.	A	G	3	4	7	0	0	7	0	0
10	40826516	.	A	G	4	2	6	0	0	6	0	0
10	40859336	.	T	A	1	3	4	0	2	6	0	0
10	40859338	.	A	G	2	3	5	0	1	6	0	0
10	40859601	.	T	C	3	0	3	0	4	7	0	0
10	40859633	.	C	T	1	4	5	0	0	5	0	0
10	40859647	.	A	C	2	3	5	0	0	5	0	0
10	40859722	.	A	G	7	5	12	0	1	13	0	0
10	40859885	.	A	G	12	10	22	0	2	24	0	0
10	40859968	.	T	C	16	5	21	0	0	21	0	0
10	40860070	.	G	C	7	0	7	0	9	16	0	0
10	40861563	.	C	A	9	6	15	0	0	15	0	0
10	40861650	.	G	A	7	3	10	0	2	12	0	0
10	40861701	.	G	T	4	3	7	0	0	7	0	0
10	40866244	.	T	C	4	0	4	0	5	9	0	0
10	40872816	.	A	G	2	2	4	0	0	4	0	0
10	41107066	.	A	T	4	2	6	0	1	7	0	0
10	41108246	.	G	T	4	2	6	0	0	6	0	0
10	41190192	.	G	C	2	5	7	0	1	8	0	0
10	41192675	.	C	T	1	2	3	0	0	3	0	0
10	41362665	.	G	A	14	18	32	0	1	33	0	0
10	41362771	.	C	T	1	13	14	0	10	24	0	0
10	41368569	.	G	A	10	10	20	0	2	22	0	0
10	41368626	.	C	T	0	14	14	0	10	24	0	0
10	41373231	.	G	A	10	3	13	0	0	13	0	0
10	41376895	.	G	A	4	4	8	0	0	8	0	0
10	41379992	.	G	A	10	7	17	0	2	19	0	0
10	41380079	.	G	C	8	0	8	0	10	18	0	0
10	41607045	.	A	T	0	3	3	0	0	3	0	0
10	41607052	.	G	A	2	2	4	0	0	4	0	0
10	41607903	.	C	A	8	5	13	0	1	14	0	0
10	41607939	.	C	A	6	5	11	0	2	13	0	0
10	41608254	.	A	G	3	2	5	1	1	7	0	0
10	41608373	.	T	A	5	4	9	2	1	12	0	0
10	41608374	.	T	A	6	4	10	2	0	12	0	0
10	41608600	.	C	A	5	9	14	0	0	14	0	0
10	41608935	.	G	A	1	6	7	0	8	15	0	0
10	42021283	.	A	G	5	3	8	0	0	8	0	0
10	42136431	.	T	C	2	2	4	1	0	5	0	0
10	42136506	.	T	C	2	0	2	0	2	4	0	0
10	42137050	.	G	C	1	8	9	1	0	10	0	0
10	42701051	.	T	C	1	6	7	0	0	7	0	0
10	42738343	.	A	G	4	6	10	0	0	10	0	0
10	42739938	.	C	T	3	7	10	4	1	15	0	0
10	42930781	.	T	C	4	0	4	0	8	12	0	0
10	42930814	.	T	C	6	2	8	0	1	9	0	0
10	42930828	.	T	C	1	5	6	0	1	7	0	0
10	43546986	.	A	T	5	3	8	0	1	9	0	0
10	43863742	.	A	C	4	4	8	0	0	8	0	0
10	43863779	.	A	C	5	5	10	0	0	10	0	0
10	43863792	.	T	G	5	6	11	0	0	11	0	0
10	43863951	.	G	A	1	2	3	0	0	3	0	0
10	43936313	.	A	T	5	7	12	0	1	13	0	0
10	43937850	.	A	G	4	12	16	0	0	16	0	0
10	43950092	.	T	G	4	7	11	0	0	11	0	0
10	43999372	.	G	A	2	3	5	0	1	6	0	0
10	43999374	.	G	A	2	3	5	0	1	6	0	0
10	43999448	.	G	A	7	4	11	0	0	11	0	0
10	43999628	.	T	C	7	4	11	0	0	11	0	0
10	43999718	.	T	A	8	13	21	0	0	21	0	0
10	44010073	.	C	T	0	7	7	0	8	15	0	0
10	44015613	.	A	T	5	7	12	0	0	12	0	0
10	44057415	.	C	A	1	1	2	0	2	4	0	0
10	44131346	.	A	G	3	3	6	0	0	6	0	0
10	44137259	.	G	A	0	2	2	0	2	4	0	0
10	44180320	.	C	T	7	9	16	0	1	17	0	0
10	44189322	.	G	T	12	8	20	0	2	22	0	0
10	44314569	.	C	T	9	8	17	0	1	18	0	0
10	44314579	.	A	G	9	8	17	0	1	18	0	0
10	44320823	.	G	C	4	12	16	0	0	16	0	0
10	44337487	.	C	G	1	3	4	0	0	4	0	0
10	44337710	.	G	A	2	2	4	0	0	4	0	0
10	44340944	.	C	T	4	4	8	0	0	8	0	0
10	44345005	.	C	T	0	4	4	0	5	9	0	0
10	44346449	.	T	C	1	0	1	0	2	3	0	0
10	44348351	.	G	A	2	2	4	0	0	4	0	0
10	44353914	.	G	A	2	2	4	0	0	4	0	0
10	44363242	.	G	T	8	6	14	0	0	14	0	0
10	44364604	.	A	T	7	9	16	0	2	18	0	0
10	44364610	.	C	T	7	11	18	0	3	21	0	0
10	44371710	.	G	T	0	13	13	0	11	24	0	0
10	44375738	.	T	G	2	0	2	0	3	5	0	0
10	44375785	.	G	A	0	5	5	0	5	10	0	0
10	44410082	.	C	T	3	2	5	0	0	5	0	0
10	44410088	.	G	A	2	3	5	0	0	5	0	0
10	44437145	.	T	C	17	16	33	0	2	35	0	0
10	44465477	.	C	T	0	5	5	0	3	8	0	0
10	44466844	.	G	A	3	10	13	0	0	13	0	0
10	44503882	.	G	A	4	4	8	0	0	8	0	0
10	44513232	.	T	C	4	2	6	0	0	6	0	0
10	44513402	.	T	C	6	0	6	0	9	15	0	0
10	44513421	.	C	T	0	8	8	0	9	17	0	0
10	44515911	.	G	C	5	2	7	0	0	7	0	0
10	44516001	.	C	T	1	5	6	0	4	10	0	0
10	44516270	.	G	T	2	3	5	0	0	5	0	0
10	44516535	.	A	T	2	2	4	0	0	4	0	0
10	44640832	.	G	A	3	4	7	0	0	7	0	0
10	44640843	.	T	C	4	2	6	0	0	6	0	0
10	44640873	.	G	A	1	4	5	0	0	5	0	0
10	44641025	.	G	A	1	2	3	0	0	3	0	0
10	44648115	.	G	T	0	3	3	0	1	4	0	0
10	44648746	.	T	A	1	1	2	0	1	3	0	0
10	44652510	.	C	T	5	5	10	0	0	10	0	0
10	44652561	.	G	A	0	4	4	0	2	6	0	0
10	44656821	.	C	G	5	3	8	0	1	9	0	0
10	44656905	.	G	A	7	4	11	0	0	11	0	0
10	44663025	.	C	T	7	8	15	1	0	16	0	0
10	44663082	.	A	G	9	8	17	1	0	18	0	0
10	44663109	.	A	G	6	6	12	0	1	13	0	0
10	44665345	.	G	T	0	3	3	0	8	11	0	0
10	44665536	.	A	T	7	9	16	0	0	16	0	0
10	44665620	.	C	T	6	7	13	0	1	14	0	0
10	44669263	.	G	A	8	12	20	0	1	21	0	0
10	44669402	.	G	A	4	11	15	0	0	15	0	0
10	44669497	.	A	G	13	7	20	1	3	24	0	0
10	44669546	.	G	C	2	3	5	0	0	5	0	0
10	44669660	.	G	A	15	12	27	0	1	28	0	0
10	44669668	.	C	A	15	12	27	0	0	27	0	0
10	44669779	.	A	G	17	0	17	0	17	34	0	0
10	44669825	.	T	G	10	8	18	0	0	18	0	0
10	44669937	.	G	A	2	3	5	0	0	5	0	0
10	44670081	.	A	T	2	3	5	0	0	5	0	0
10	44670894	.	C	T	9	14	23	0	4	27	0	0
10	44670923	.	T	C	10	5	15	0	2	17	0	0
10	44671818	.	A	C	9	18	27	0	4	31	0	0
10	44672009	.	T	A	23	22	45	0	2	47	0	0
10	44672036	.	T	A	22	24	46	0	1	47	0	0
10	44692308	.	A	T	8	16	24	0	1	25	0	0
10	44692314	.	C	A	10	18	28	0	0	28	0	0
10	44693397	.	G	A	3	6	9	22	1	32	0	0
10	44693445	.	G	A	11	4	15	35	4	54	0	0
10	44693523	.	T	G	45	2	47	2	21	70	0	0
10	44693556	.	C	T	16	14	30	5	4	39	0	0
10	44693769	.	C	T	41	22	63	28	4	95	0	0
10	44693799	.	T	C	20	11	31	55	6	92	0	0
10	44694081	.	G	A	33	5	38	43	5	86	0	0
10	44694096	.	A	G	27	9	36	36	3	75	0	0
10	44694354	.	G	A	52	20	72	6	6	84	0	0
10	44733825	.	C	T	4	3	7	0	0	7	0	0
10	44738221	.	G	A	0	4	4	0	4	8	0	0
10	44738290	.	C	T	8	4	12	0	0	12	0	0
10	44745774	.	A	T	1	2	3	0	0	3	0	0
10	44899158	.	C	T	3	2	5	0	0	5	0	0
10	44899169	.	G	A	2	3	5	0	0	5	0	0
10	44900534	.	T	A	2	3	5	0	1	6	0	0
10	44900856	.	C	T	2	2	4	0	0	4	0	0
10	44900901	.	T	G	1	6	7	0	0	7	0	0
10	44914292	.	T	C	4	2	6	0	0	6	0	0
10	44914623	.	A	G	7	0	7	0	9	16	0	0
10	44914685	.	G	T	8	6	14	0	0	14	0	0
10	44914761	.	T	A	4	7	11	0	0	11	0	0
10	44979712	.	A	G	1	3	4	0	0	4	0	0
10	44980913	.	C	T	2	3	5	0	2	7	0	0
10	44989378	.	C	T	21	19	40	0	3	43	0	0
10	44989384	.	T	C	24	20	44	0	2	46	0	0
10	44990917	.	C	T	14	30	44	0	1	45	0	0
10	45055879	.	G	A	12	11	23	0	2	25	0	0
10	45055948	.	G	A	12	12	24	0	1	25	0	0
10	45059822	.	C	T	5	2	7	0	1	8	0	0
10	45064957	.	C	T	13	10	23	0	0	23	0	0
10	45105244	.	T	C	2	2	4	0	0	4	0	0
10	45203109	.	T	C	6	7	13	0	1	14	0	0
10	45203154	.	A	G	4	7	11	0	1	12	0	0
10	45203271	.	T	A	4	5	9	0	1	10	0	0
10	45203385	.	T	A	3	4	7	0	0	7	0	0
10	45203700	.	A	C	5	5	10	0	1	11	0	0
10	45203704	.	T	G	6	6	12	0	0	12	0	0
10	45203793	.	G	A	0	1	1	0	2	3	0	0
10	45204024	.	A	G	6	5	11	0	2	13	0	0
10	45204029	.	A	T	5	6	11	0	1	12	0	0
10	45204151	.	A	G	5	4	9	0	1	10	0	0
10	45204185	.	T	C	3	2	5	0	0	5	0	0
10	45204218	.	A	G	3	1	4	0	4	8	0	0
10	45204527	.	A	G	3	6	9	0	0	9	0	0
10	45204568	.	G	T	3	3	6	0	0	6	0	0
10	45204731	.	A	G	1	7	8	0	0	8	0	0
10	45204739	.	A	T	3	2	5	0	3	10	2	0
10	45204769	.	T	A	4	4	8	0	0	8	0	0
10	45204786	.	A	C	1	3	4	0	0	4	0	0
10	45205166	.	A	C	10	7	17	0	1	18	0	0
10	45205175	.	A	G	9	1	10	0	7	17	0	0
10	45205226	.	A	G	10	1	11	0	7	18	0	0
10	45205237	.	C	G	9	0	9	0	10	19	0	0
10	45205284	.	A	C	9	8	17	0	1	18	0	0
10	45205295	.	A	G	10	0	10	0	11	21	0	0
10	45205400	.	C	A	2	14	16	0	2	18	0	0
10	45205506	.	A	C	7	7	14	0	2	16	0	0
10	45205518	.	T	G	8	7	15	0	1	16	0	0
10	45205757	.	C	A	3	5	8	0	0	8	0	0
10	45205758	.	A	G	3	5	8	0	0	8	0	0
10	45206103	.	C	G	2	3	5	0	0	6	1	0
10	45206289	.	G	C	6	0	6	1	5	12	0	0
10	45206326	.	G	T	6	4	10	1	1	12	0	0
10	45206450	.	T	C	11	0	11	0	19	30	0	0
10	45206478	.	G	T	25	7	32	0	0	32	0	0
10	45208153	.	A	G	10	11	21	0	1	22	0	0
10	45208667	.	C	T	0	5	5	0	4	9	0	0
10	45208875	.	G	A	5	8	13	0	0	13	0	0
10	45208899	.	C	A	3	7	10	0	1	11	0	0
10	45213798	.	C	T	0	4	4	0	5	9	0	0
10	45214836	.	C	T	3	4	7	0	0	7	0	0
10	45214851	.	T	G	2	4	6	0	0	6	0	0
10	45222613	.	T	C	2	0	2	0	2	4	0	0
10	45229710	.	C	T	2	2	4	0	1	5	0	0
10	45248638	.	G	A	1	2	3	0	0	3	0	0
10	45313623	.	G	A	0	3	3	0	3	6	0	0
10	45313671	.	C	T	3	4	7	0	0	7	0	0
10	45322668	.	A	G	3	0	3	0	5	8	0	0
10	45325302	.	G	A	0	2	2	0	4	6	0	0
10	45334688	.	C	T	4	2	6	0	1	7	0	0
10	45336565	.	T	C	5	7	12	0	1	13	0	0
10	45340105	.	G	T	0	7	7	0	2	9	0	0
10	45340654	.	A	G	1	2	3	0	1	4	0	0
10	45340835	.	G	C	3	7	10	0	0	10	0	0
10	45340930	.	G	T	6	9	15	0	1	17	1	0
10	45341210	.	T	A	3	4	7	0	0	7	0	0
10	45341403	.	A	G	3	9	12	0	3	15	0	0
10	45341410	.	A	G	5	0	5	0	12	17	0	0
10	45341452	.	T	G	4	7	11	0	3	14	0	0
10	45341537	.	A	C	6	14	20	0	0	20	0	0
10	45341546	.	A	C	5	14	19	0	1	20	0	0
10	45341572	.	G	C	1	12	13	2	4	19	0	0
10	45341596	.	C	T	5	7	12	3	1	16	0	0
10	45341762	.	A	T	1	8	9	1	1	11	0	0
10	45349924	.	G	A	34	45	79	0	3	82	0	0
10	45351037	.	C	T	31	43	74	1	5	80	0	0
10	45352231	.	C	T	22	19	41	0	4	45	0	0
10	45375714	.	G	T	12	5	17	0	1	18	0	0
10	45375732	.	C	T	13	8	21	0	0	21	0	0
11	126334	.	G	A	26	14	40	0	3	43	0	0
11	126595	.	A	T	20	20	40	0	3	43	0	0
11	127139	.	G	A	14	14	28	0	0	28	0	0
11	185396	.	C	T	0	6	6	0	6	12	0	0
11	185624	.	T	A	15	16	31	0	1	33	1	0
11	185678	.	G	A	9	11	20	0	3	23	0	0
11	185775	.	C	T	1	22	23	0	15	38	0	0
11	185890	.	A	G	14	20	34	0	4	38	0	0
11	185902	.	A	G	16	19	35	0	3	38	0	0
11	186235	.	G	A	7	7	14	0	0	14	0	0
11	186526	.	A	T	4	3	7	0	0	7	0	0
11	186745	.	G	T	7	11	18	0	1	19	0	0
11	186798	.	T	G	9	10	19	0	3	22	0	0
11	186939	.	A	G	11	14	25	0	1	26	0	0
11	187022	.	C	A	9	10	19	0	4	23	0	0
11	187104	.	T	A	14	20	34	0	2	36	0	0
11	187399	.	A	C	13	10	23	0	1	24	0	0
11	221929	.	T	C	17	0	17	0	18	35	0	0
11	222488	.	C	G	11	7	18	0	0	18	0	0
11	222722	.	C	T	1	6	7	0	21	28	0	0
11	222729	.	C	T	1	8	9	0	19	28	0	0
11	222776	.	C	T	12	8	20	0	0	20	0	0
11	222787	.	A	G	13	6	19	0	0	19	0	0
11	222947	.	G	A	8	3	11	0	3	14	0	0
11	222965	.	T	C	10	0	10	2	2	14	0	0
11	223046	.	G	T	4	5	9	0	3	12	0	0
11	223051	.	T	A	5	4	9	0	3	12	0	0
11	223319	.	G	A	6	4	10	0	2	12	0	0
11	223806	.	A	G	12	8	20	0	0	20	0	0
11	233672	.	A	T	5	3	8	0	0	8	0	0
11	233674	.	G	A	4	2	6	0	2	8	0	0
11	236437	.	C	T	4	5	9	0	0	9	0	0
11	236515	.	T	C	4	5	9	0	4	13	0	0
11	236551	.	G	A	3	2	5	0	0	5	0	0
11	236602	.	A	C	4	0	4	0	6	10	0	0
11	260909	.	G	A	15	4	19	0	4	23	0	0
11	265097	.	T	G	18	14	32	0	0	32	0	0
11	265404	.	G	A	16	13	29	0	1	30	0	0
11	265497	.	C	T	2	6	8	0	10	18	0	0
11	265506	.	G	C	12	8	20	0	1	21	0	0
11	268887	.	G	A	7	5	12	0	0	12	0	0
11	270090	.	A	G	7	10	17	0	0	17	0	0
11	281887	.	A	T	3	2	5	1	0	6	0	0
11	281961	.	A	G	6	6	12	0	0	12	0	0
11	282193	.	T	G	6	8	14	0	2	16	0	0
11	282279	.	A	T	10	10	20	0	1	21	0	0
11	282362	.	T	C	5	4	9	0	0	9	0	0
11	282546	.	G	T	13	12	25	0	0	25	0	0
11	282553	.	A	G	12	13	25	0	0	25	0	0
11	282602	.	T	G	8	7	15	0	0	15	0	0
11	283164	.	G	C	4	6	10	0	0	10	0	0
11	284424	.	G	T	2	4	6	0	3	9	0	0
11	296453	.	T	A	11	3	14	0	1	15	0	0
11	304015	.	C	T	18	6	24	9	1	34	0	0
11	322076	.	G	A	0	14	14	0	10	24	0	0
11	338799	.	C	T	1	3	4	0	0	4	0	0
11	539573	.	A	C	0	9	9	0	3	12	0	0
11	675382	.	G	C	28	27	55	0	3	58	0	0
11	676856	.	T	C	30	19	49	0	8	57	0	0
11	677100	.	A	G	10	11	21	0	4	25	0	0
11	677264	.	T	C	26	12	38	0	8	46	0	0
11	677341	.	T	C	22	14	36	0	4	40	0	0
11	682905	.	C	T	21	14	35	0	4	39	0	0
11	682926	.	A	G	18	15	33	0	2	35	0	0
11	682943	.	G	A	15	14	29	0	0	29	0	0
11	687501	.	G	A	19	13	32	0	0	32	0	0
11	718214	.	G	A	22	6	28	0	2	30	0	0
11	718404	.	A	C	8	3	11	0	1	12	0	0
11	718454	.	A	G	6	10	16	1	0	17	0	0
11	762445	.	A	G	7	7	14	0	0	14	0	0
11	779785	.	C	A	1	7	8	0	1	9	0	0
11	780405	.	T	A	4	5	9	0	0	9	0	0
11	781714	.	G	A	0	2	2	0	4	6	0	0
11	813851	.	T	C	4	1	5	0	5	10	0	0
11	814048	.	A	G	4	3	7	0	1	8	0	0
11	1095064	.	G	A	4	3	7	0	0	7	0	0
11	1148869	.	G	A	19	18	37	0	0	37	0	0
11	1148889	.	G	A	20	14	34	0	2	36	0	0
11	1149105	.	C	T	21	22	43	0	2	45	0	0
11	1149593	.	A	G	30	15	45	7	3	55	0	0
11	1149812	.	C	T	6	29	35	1	26	62	0	0
11	1163295	.	C	T	32	22	54	0	1	55	0	0
11	1165993	.	G	A	32	21	53	0	3	56	0	0
11	1166326	.	G	C	22	2	24	0	21	45	0	0
11	1177389	.	C	A	4	9	13	0	14	27	0	0
11	1183007	.	G	A	14	11	25	0	1	26	0	0
11	1183602	.	C	T	1	7	8	0	16	24	0	0
11	1183739	.	G	T	5	11	16	0	0	16	0	0
11	1198390	.	G	C	12	15	27	0	1	28	0	0
11	1198419	.	G	A	11	12	23	0	0	23	0	0
11	1198450	.	G	A	15	12	27	0	1	28	0	0
11	1198507	.	G	T	13	12	25	0	1	26	0	0
11	1203619	.	G	A	9	5	14	0	0	14	0	0
11	1221865	.	A	G	15	7	22	0	0	22	0	0
11	1222025	.	T	G	6	9	15	0	0	15	0	0
11	1339419	.	C	T	0	3	3	0	4	7	0	0
11	1341402	.	C	T	0	4	4	0	6	10	0	0
11	1342778	.	G	A	3	6	9	0	0	9	0	0
11	1342826	.	A	G	3	7	10	0	0	10	0	0
11	1348596	.	A	G	5	9	14	0	0	14	0	0
11	1348821	.	A	C	7	4	11	0	1	12	0	0
11	1351542	.	C	T	0	5	5	0	3	8	0	0
11	1351563	.	T	G	3	8	11	0	0	11	0	0
11	1351611	.	A	G	2	5	7	0	1	8	0	0
11	1368265	.	G	A	1	3	4	0	0	4	0	0
11	1396343	.	T	C	15	17	32	0	6	38	0	0
11	1403797	.	T	C	5	0	5	0	5	10	0	0
11	1403821	.	A	C	6	3	9	0	0	9	0	0
11	1403921	.	A	C	3	6	9	0	0	9	0	0
11	1403969	.	G	A	4	2	6	0	0	6	0	0
11	1404031	.	A	C	1	4	5	0	0	5	0	0
11	1404481	.	C	A	7	5	12	0	0	12	0	0
11	1404640	.	T	C	1	0	1	0	5	6	0	0
11	1404642	.	A	G	1	4	5	0	1	6	0	0
11	1407178	.	A	C	2	2	4	0	0	4	0	0
11	1408791	.	G	T	1	3	4	0	0	4	0	0
11	1408802	.	G	T	1	3	4	0	0	4	0	0
11	1427981	.	T	C	14	0	14	0	11	25	0	0
11	1435736	.	A	G	10	5	15	0	0	15	0	0
11	1467114	.	T	C	9	0	9	0	14	23	0	0
11	1467130	.	C	A	0	14	14	0	11	25	0	0
11	1469842	.	C	T	8	6	14	0	2	16	0	0
11	1469859	.	A	G	10	9	19	0	0	19	0	0
11	1469895	.	A	G	9	12	21	0	0	21	0	0
11	1470503	.	G	A	5	10	15	0	0	15	0	0
11	1470535	.	G	C	3	9	12	0	2	14	0	0
11	1474629	.	C	T	10	10	20	0	1	21	0	0
11	1512626	.	A	G	1	3	4	0	0	4	0	0
11	1512660	.	A	T	1	5	6	0	0	6	0	0
11	1517289	.	C	A	2	3	5	0	0	5	0	0
11	1520436	.	A	G	2	2	4	0	0	4	0	0
11	1520693	.	G	A	1	4	5	0	0	5	0	0
11	1520797	.	A	G	2	2	4	0	0	4	0	0
11	1522194	.	C	G	13	0	13	0	12	25	0	0
11	1522205	.	G	T	16	10	26	0	1	27	0	0
11	1522291	.	T	C	9	6	15	0	0	15	0	0
11	1523846	.	T	C	2	3	5	0	1	6	0	0
11	1524079	.	T	C	6	8	14	0	0	14	0	0
11	1524108	.	C	T	7	10	17	0	0	17	0	0
11	1525081	.	G	C	13	9	22	0	0	22	0	0
11	1525389	.	G	T	20	21	41	3	1	46	1	0
11	1525416	.	T	A	21	18	39	0	2	41	0	0
11	1526749	.	A	G	19	12	31	0	2	33	0	0
11	1529260	.	A	G	17	17	34	0	0	34	0	0
11	1529526	.	G	A	19	13	32	0	1	33	0	0
11	1529743	.	G	A	18	11	29	0	0	29	0	0
11	1529789	.	A	C	18	13	31	0	0	31	0	0
11	1529796	.	A	T	17	12	29	0	3	32	0	0
11	1529838	.	A	G	19	17	36	0	0	36	0	0
11	1530027	.	G	A	12	12	24	0	0	24	0	0
11	1530295	.	A	C	25	9	34	0	2	36	0	0
11	1530363	.	A	G	18	20	38	0	2	40	0	0
11	1530489	.	A	G	15	0	15	0	13	28	0	0
11	1530541	.	A	G	13	11	24	0	5	29	0	0
11	1530584	.	G	A	2	15	17	0	16	33	0	0
11	1530593	.	G	T	13	14	27	0	2	29	0	0
11	1530642	.	G	A	9	16	25	0	2	27	0	0
11	1535427	.	C	A	1	6	7	0	0	7	0	0
11	1535471	.	T	C	1	2	3	0	0	3	0	0
11	1535877	.	G	A	4	3	7	0	0	7	0	0
11	1542605	.	A	G	11	0	11	0	7	18	0	0
11	1543974	.	A	G	12	6	18	0	1	19	0	0
11	1741883	.	C	T	2	2	4	0	0	4	0	0
11	1793477	.	A	C	1	2	3	0	0	3	0	0
11	1796482	.	C	T	2	2	4	0	0	4	0	0
11	1799763	.	G	A	0	2	2	0	1	3	0	0
11	1799778	.	C	T	1	2	3	0	0	3	0	0
11	1799838	.	C	T	2	2	4	0	0	4	0	0
11	1805726	.	G	T	1	2	3	0	2	5	0	0
11	1805810	.	T	C	2	4	6	0	1	7	0	0
11	1810104	.	C	T	4	4	8	0	0	8	0	0
11	1812288	.	A	G	1	0	1	0	7	8	0	0
11	1812951	.	T	A	3	5	8	0	0	8	0	0
11	1812961	.	C	T	5	3	8	0	0	8	0	0
11	1813240	.	A	G	9	5	14	0	0	14	0	0
11	1815978	.	C	T	11	8	19	0	1	20	0	0
11	1818005	.	C	T	6	5	11	0	0	11	0	0
11	1823329	.	T	G	8	0	8	0	4	12	0	0
11	1829952	.	C	T	6	3	9	0	0	9	0	0
11	1830621	.	T	C	4	4	8	0	0	8	0	0
11	1834124	.	T	C	6	6	12	0	0	12	0	0
11	1836995	.	C	G	11	1	12	0	13	25	0	0
11	1838725	.	G	C	1	13	14	0	8	22	0	0
11	1841961	.	G	C	12	11	23	0	0	23	0	0
11	1843339	.	G	T	12	9	21	0	1	22	0	0
11	1843771	.	C	A	15	13	28	0	1	29	0	0
11	1863846	.	T	G	19	22	41	0	2	43	0	0
11	1864095	.	C	A	15	22	37	0	2	39	0	0
11	1864216	.	C	T	15	8	23	0	2	25	0	0
11	1918503	.	A	C	1	2	3	0	0	3	0	0
11	1919016	.	T	A	4	4	8	0	0	8	0	0
11	1919054	.	T	G	6	0	6	0	4	10	0	0
11	1920009	.	C	T	2	5	7	0	2	9	0	0
11	1920069	.	A	T	5	5	10	0	1	11	0	0
11	1945034	.	T	A	10	9	19	0	1	20	0	0
11	1945036	.	C	T	11	9	20	0	2	22	0	0
11	1945229	.	C	T	8	10	18	0	0	18	0	0
11	1948373	.	A	T	4	3	7	0	0	7	0	0
11	1967076	.	C	A	3	4	7	0	0	7	0	0
11	1967111	.	T	A	2	2	4	0	0	4	0	0
11	2112554	.	A	G	5	2	7	0	0	7	0	0
11	2218261	.	C	G	0	2	2	0	2	4	0	0
11	2240120	.	A	C	17	10	27	0	2	29	0	0
11	2249884	.	A	G	30	24	54	0	9	63	0	0
11	2254335	.	T	C	5	4	9	0	1	10	0	0
11	2255025	.	T	G	7	5	12	0	1	13	0	0
11	2255027	.	T	G	8	5	13	0	0	13	0	0
11	2295604	.	A	G	1	3	4	0	0	4	0	0
11	2462791	.	A	G	6	5	11	0	1	12	0	0
11	2462830	.	A	G	6	3	9	0	1	10	0	0
11	2462831	.	G	A	6	3	9	0	0	9	0	0
11	2463127	.	A	G	2	0	2	0	3	5	0	0
11	2506878	.	C	T	1	4	5	0	0	5	0	0
11	2507001	.	G	A	0	3	3	0	3	6	0	0
11	2541797	.	T	C	2	5	7	0	1	8	0	0
11	2542391	.	C	T	3	7	10	0	0	10	0	0
11	2545018	.	A	G	2	4	6	0	0	6	0	0
11	2566191	.	C	T	3	7	10	0	1	11	0	0
11	2571635	.	A	G	3	3	6	0	0	6	0	0
11	2571685	.	C	A	4	3	7	0	0	7	0	0
11	2571686	.	A	T	4	3	7	0	0	7	0	0
11	2593620	.	T	A	3	2	5	0	0	5	0	0
11	2593645	.	T	G	2	4	6	0	0	6	0	0
11	2616881	.	T	A	3	4	7	0	0	7	0	0
11	2616956	.	T	C	11	16	27	0	0	27	0	0
11	2617031	.	T	A	22	15	37	0	2	39	0	0
11	2617072	.	A	G	17	7	24	0	4	28	0	0
11	2617179	.	A	G	10	6	16	0	0	16	0	0
11	2618036	.	A	G	7	8	15	0	0	15	0	0
11	2618114	.	C	A	6	3	9	0	0	9	0	0
11	2618653	.	C	A	11	5	16	0	0	16	0	0
11	2619054	.	T	G	6	8	14	0	1	15	0	0
11	2619089	.	G	A	8	8	16	0	3	19	0	0
11	2619129	.	C	A	10	10	20	0	2	22	0	0
11	2619333	.	G	A	2	3	5	0	0	5	0	0
11	2619515	.	T	A	9	13	22	0	0	22	0	0
11	2619538	.	T	A	10	7	17	0	1	18	0	0
11	2619588	.	G	C	4	1	5	0	6	11	0	0
11	2621839	.	G	A	2	5	7	0	0	7	0	0
11	2625178	.	G	A	3	6	9	0	0	9	0	0
11	2625224	.	T	A	3	7	10	0	0	10	0	0
11	2625247	.	T	C	3	6	9	0	0	9	0	0
11	2655888	.	G	C	2	4	6	0	0	6	0	0
11	2656062	.	C	G	2	3	5	0	1	6	0	0
11	2664585	.	A	C	1	3	4	0	3	7	0	0
11	2665236	.	T	A	2	3	5	0	1	6	0	0
11	2673624	.	T	C	5	4	9	0	0	9	0	0
11	2675447	.	C	A	4	4	8	0	0	8	0	0
11	2675454	.	A	C	4	3	7	0	1	8	0	0
11	2677377	.	G	C	3	8	11	0	0	11	0	0
11	2677404	.	G	A	0	4	4	0	8	12	0	0
11	2677428	.	A	G	6	4	10	0	0	10	0	0
11	2677440	.	C	T	5	3	8	0	0	8	0	0
11	2677538	.	C	T	3	9	12	0	1	13	0	0
11	2678064	.	G	A	8	4	12	0	0	12	0	0
11	2678088	.	G	A	6	5	11	0	0	11	0	0
11	2680747	.	C	T	3	4	7	0	2	9	0	0
11	2681121	.	C	A	3	2	5	0	0	5	0	0
11	2681133	.	T	A	4	2	6	0	1	7	0	0
11	2681930	.	A	G	2	4	6	0	1	7	0	0
11	2681953	.	A	G	4	0	4	0	5	9	0	0
11	2682001	.	C	A	3	1	4	0	2	8	2	0
11	2682005	.	T	G	3	2	5	0	1	6	0	0
11	2682042	.	A	G	2	2	4	0	1	5	0	0
11	2682045	.	C	A	4	2	6	0	0	6	0	0
11	2682310	.	G	T	1	6	7	0	0	7	0	0
11	2682361	.	T	C	4	5	9	0	0	9	0	0
11	2682414	.	A	G	6	3	9	0	0	9	0	0
11	2682441	.	A	T	3	5	8	0	1	9	0	0
11	2682470	.	A	T	5	6	11	0	0	11	0	0
11	2682483	.	T	C	6	4	10	0	1	11	0	0
11	2682551	.	C	T	2	3	5	0	0	5	0	0
11	2682555	.	A	T	3	2	5	0	0	5	0	0
11	2682866	.	T	C	4	6	10	0	0	10	0	0
11	2683038	.	G	T	9	5	14	0	0	14	0	0
11	2683084	.	G	T	3	2	5	0	2	7	0	0
11	2683092	.	A	C	4	3	7	0	0	8	1	0
11	2683509	.	T	C	7	26	33	0	1	34	0	0
11	2687421	.	C	T	2	4	6	0	0	6	0	0
11	2687550	.	A	C	1	3	4	0	0	4	0	0
11	2688119	.	G	A	3	3	6	0	0	6	0	0
11	2688582	.	A	C	4	5	9	0	0	9	0	0
11	2688916	.	G	C	4	3	7	0	0	7	0	0
11	2689336	.	G	A	2	5	7	0	2	9	0	0
11	2689337	.	G	A	3	6	9	0	0	9	0	0
11	2690131	.	A	G	5	3	8	0	1	9	0	0
11	2690192	.	A	G	9	2	11	0	1	12	0	0
11	2690233	.	G	T	7	7	14	0	0	14	0	0
11	2690303	.	G	C	10	6	16	0	1	17	0	0
11	2690445	.	G	T	9	9	18	0	2	20	0	0
11	2690499	.	C	T	10	6	16	0	0	16	0	0
11	2690564	.	G	T	12	8	20	0	0	20	0	0
11	2690612	.	A	C	7	5	12	0	1	13	0	0
11	2690869	.	C	A	3	3	6	0	0	6	0	0
11	2690873	.	G	A	0	2	2	0	3	5	0	0
11	2692109	.	A	C	6	4	10	0	1	11	0	0
11	2692180	.	C	T	5	3	8	0	0	8	0	0
11	2692579	.	T	G	1	1	2	0	1	3	0	0
11	2702718	.	T	C	5	8	13	0	1	14	0	0
11	2702766	.	C	T	5	6	11	0	1	12	0	0
11	2702808	.	T	C	6	5	11	0	2	13	0	0
11	2705206	.	C	T	6	8	14	0	2	16	0	0
11	2705215	.	G	T	0	7	7	0	11	18	0	0
11	2705273	.	A	G	5	0	5	0	4	9	0	0
11	2705325	.	G	A	7	8	15	0	1	16	0	0
11	2705355	.	T	A	4	6	10	0	2	12	0	0
11	2706517	.	T	G	9	8	17	0	0	17	0	0
11	2706734	.	T	C	9	11	20	0	1	21	0	0
11	2706838	.	A	G	11	6	17	0	1	18	0	0
11	2710642	.	G	A	2	3	5	0	0	5	0	0
11	2743631	.	A	G	1	0	1	0	8	9	0	0
11	2743661	.	C	T	7	3	10	0	0	10	0	0
11	2745110	.	A	T	4	8	12	0	1	13	0	0
11	2745128	.	C	T	6	5	11	0	2	13	0	0
11	2755120	.	A	T	11	5	16	0	2	18	0	0
11	2756250	.	C	T	7	9	16	0	2	18	0	0
11	2757519	.	G	A	6	10	16	0	1	17	0	0
11	2757582	.	T	C	8	5	13	0	0	13	0	0
11	2758204	.	C	T	11	10	21	0	0	21	0	0
11	2759043	.	A	T	4	8	12	2	0	14	0	0
11	2759461	.	T	C	14	7	21	2	1	24	0	0
11	2759475	.	G	T	14	8	22	4	2	28	0	0
11	2759498	.	G	A	12	13	25	3	1	29	0	0
11	2759541	.	C	A	3	8	11	7	0	18	0	0
11	2759833	.	G	A	1	11	12	0	11	23	0	0
11	2759843	.	G	A	4	15	19	0	8	27	0	0
11	2759901	.	T	G	12	15	27	0	1	28	0	0
11	2759903	.	A	T	15	11	26	0	1	27	0	0
11	2759938	.	A	G	16	10	26	0	1	27	0	0
11	2805410	.	C	A	4	4	8	0	2	10	0	0
11	2809744	.	C	T	9	4	13	0	1	14	0	0
11	2809777	.	A	G	7	1	8	0	3	11	0	0
11	2809804	.	A	G	4	7	11	0	1	12	0	0
11	2813856	.	G	C	9	6	15	0	3	18	0	0
11	2815790	.	C	G	20	10	30	0	0	30	0	0
11	2815845	.	C	T	14	17	31	0	1	32	0	0
11	2820876	.	T	G	14	14	28	0	2	30	0	0
11	2820900	.	A	C	11	12	23	0	3	26	0	0
11	2821427	.	T	C	13	13	26	0	2	28	0	0
11	2821430	.	C	G	13	0	13	0	15	28	0	0
11	2826184	.	T	C	21	15	36	0	0	36	0	0
11	2826338	.	G	T	18	14	32	0	1	33	0	0
11	2826485	.	C	A	11	5	16	0	0	16	0	0
11	2828276	.	C	A	20	8	28	0	0	28	0	0
11	2828388	.	G	A	15	14	29	0	2	31	0	0
11	2930652	.	G	A	1	2	3	0	0	3	0	0
11	3227302	.	A	T	3	2	5	0	0	5	0	0
11	3227451	.	C	T	1	2	3	0	0	3	0	0
11	3230284	.	G	A	4	6	10	0	0	10	0	0
11	3230820	.	G	A	1	3	4	0	1	5	0	0
11	3235543	.	C	T	2	3	5	0	0	5	0	0
11	3238484	.	A	G	6	5	11	0	2	13	0	0
11	3238651	.	C	T	4	3	7	0	1	8	0	0
11	3238720	.	T	C	5	6	11	0	2	13	0	0
11	3240457	.	G	A	0	15	15	0	11	26	0	0
11	3243124	.	A	G	11	0	11	0	12	23	0	0
11	3246120	.	A	G	6	10	16	0	0	16	0	0
11	3246133	.	A	G	6	11	17	0	0	17	0	0
11	3246590	.	A	C	3	6	9	15	0	24	0	0
11	3249127	.	T	A	6	4	10	0	0	10	0	0
11	3249131	.	G	A	6	4	10	0	0	10	0	0
11	3249253	.	C	T	7	8	15	0	2	17	0	0
11	3249346	.	C	T	6	9	15	0	0	15	0	0
11	3249370	.	A	G	3	0	3	0	6	9	0	0
11	3317226	.	T	C	15	18	33	0	1	34	0	0
11	3317229	.	G	T	15	18	33	0	1	34	0	0
11	3317389	.	A	T	12	17	29	0	0	29	0	0
11	3321141	.	A	T	6	3	9	0	0	9	0	0
11	3321152	.	C	T	0	3	3	0	7	10	0	0
11	3336529	.	T	G	4	2	6	0	0	6	0	0
11	3336700	.	T	G	28	26	54	0	3	57	0	0
11	3336793	.	C	T	31	43	74	0	3	77	0	0
11	3337038	.	A	G	33	34	67	0	8	75	0	0
11	3337253	.	A	G	30	35	65	0	0	65	0	0
11	3337256	.	T	C	31	1	32	0	34	66	0	0
11	3337481	.	T	G	28	30	58	0	1	59	0	0
11	3337482	.	A	T	26	30	56	0	3	59	0	0
11	3337718	.	G	C	15	34	49	0	3	52	0	0
11	3338060	.	C	G	21	23	44	0	0	44	0	0
11	3338144	.	T	C	35	26	61	0	7	68	0	0
11	3338236	.	T	C	29	3	32	1	30	63	0	0
11	3338288	.	T	A	38	23	61	2	2	65	0	0
11	3338299	.	T	G	36	20	56	2	3	61	0	0
11	3338420	.	A	T	32	29	61	0	5	66	0	0
11	3338431	.	C	T	4	26	30	0	34	64	0	0
11	3338491	.	G	A	23	28	51	0	3	54	0	0
11	3338514	.	C	A	30	26	56	0	3	59	0	0
11	3338618	.	T	C	34	17	51	0	3	54	0	0
11	3338638	.	A	G	36	19	55	0	1	56	0	0
11	3338933	.	A	G	24	18	42	0	5	47	0	0
11	3339098	.	T	C	18	1	19	0	15	34	0	0
11	3339152	.	C	T	9	10	19	0	3	22	0	0
11	3341296	.	G	A	19	17	36	0	1	37	0	0
11	3345676	.	A	G	3	3	6	0	0	6	0	0
11	3345952	.	T	C	6	6	12	0	1	13	0	0
11	3346717	.	C	T	2	2	4	0	0	4	0	0
11	3346797	.	T	C	3	0	3	0	7	10	0	0
11	3347351	.	T	C	3	2	5	0	0	5	0	0
11	3367789	.	T	C	5	0	5	0	3	8	0	0
11	3367924	.	G	C	12	12	24	0	1	25	0	0
11	3367937	.	T	C	12	8	20	0	0	20	0	0
11	3369843	.	G	A	5	3	8	0	0	8	0	0
11	3373418	.	A	G	6	11	17	0	1	18	0	0
11	3373448	.	G	A	9	6	15	0	1	16	0	0
11	3373996	.	C	T	0	3	3	0	5	8	0	0
11	3377127	.	T	C	4	0	4	0	7	11	0	0
11	3379999	.	G	T	4	3	7	0	0	7	0	0
11	3380012	.	C	G	4	3	7	0	0	7	0	0
11	3380135	.	A	G	2	2	4	0	0	4	0	0
11	3381261	.	C	A	3	3	6	0	0	6	0	0
11	3395069	.	G	A	8	12	20	0	0	20	0	0
11	3395070	.	A	T	7	12	19	0	1	20	0	0
11	3395303	.	G	A	7	8	15	0	1	16	0	0
11	3395324	.	C	T	5	12	17	0	1	18	0	0
11	3401899	.	C	A	4	3	7	0	0	7	0	0
11	3520631	.	A	G	2	4	6	0	0	6	0	0
11	3523724	.	A	G	5	9	14	0	0	14	0	0
11	3523826	.	G	A	5	14	19	0	0	19	0	0
11	3523976	.	A	C	5	0	5	0	5	10	0	0
11	3523991	.	C	T	7	4	11	0	1	12	0	0
11	3524064	.	G	T	9	8	17	0	1	18	0	0
11	3524111	.	G	A	9	10	19	0	1	20	0	0
11	3524121	.	A	G	11	9	20	0	0	20	0	0
11	3524236	.	C	T	17	12	29	0	0	29	0	0
11	3524397	.	T	C	7	6	13	0	1	14	0	0
11	3524462	.	C	T	11	6	17	0	1	18	0	0
11	3524541	.	A	T	13	8	21	0	0	21	0	0
11	3524724	.	T	A	4	4	8	0	0	8	0	0
11	3524849	.	G	A	14	4	18	0	2	20	0	0
11	3526521	.	A	G	3	9	12	0	0	12	0	0
11	3526605	.	C	G	14	10	24	0	1	25	0	0
11	3528320	.	A	T	9	4	13	0	1	14	0	0
11	3535326	.	A	G	3	2	5	0	0	5	0	0
11	3535431	.	T	C	1	1	2	0	0	2	0	0
11	3535434	.	A	G	1	2	3	0	0	3	0	0
11	3550448	.	A	G	7	6	13	0	2	16	1	0
11	3550454	.	T	A	12	8	20	0	0	20	0	0
11	3550588	.	T	C	23	1	24	0	19	43	0	0
11	3551309	.	A	G	23	31	54	0	2	56	0	0
11	3551944	.	G	A	33	19	52	1	2	55	0	0
11	3563124	.	G	A	3	3	6	0	0	6	0	0
11	3563644	.	C	T	0	3	3	0	4	7	0	0
11	3563647	.	G	A	4	4	8	0	0	8	0	0
11	3563680	.	A	G	3	4	7	0	0	7	0	0
11	3593309	.	T	C	4	6	10	1	0	11	0	0
11	3593490	.	A	C	9	13	22	0	0	22	0	0
11	3593748	.	A	G	9	12	21	0	1	22	0	0
11	3593791	.	G	C	11	11	22	1	1	24	0	0
11	3593988	.	G	T	8	15	23	0	1	24	0	0
11	3594029	.	T	C	10	10	20	1	1	22	0	0
11	3594217	.	G	T	9	13	22	0	4	26	0	0
11	3594277	.	T	G	13	16	29	0	3	32	0	0
11	3594321	.	T	C	12	0	12	0	16	28	0	0
11	3594327	.	T	A	10	16	26	0	1	27	0	0
11	3594366	.	A	G	9	13	22	0	3	25	0	0
11	3594419	.	A	G	5	13	18	0	1	19	0	0
11	3594452	.	T	G	4	4	8	1	5	14	0	0
11	3594828	.	T	C	7	0	7	0	8	15	0	0
11	3595308	.	G	A	8	8	16	0	0	16	0	0
11	3595579	.	A	G	5	8	13	0	1	14	0	0
11	3630697	.	A	T	2	2	4	0	0	4	0	0
11	3630875	.	G	A	4	2	6	0	0	6	0	0
11	3631100	.	A	G	4	3	7	0	1	8	0	0
11	3632213	.	C	T	1	3	4	0	0	4	0	0
11	3632267	.	G	A	1	1	2	0	1	3	0	0
11	3632272	.	G	A	1	2	3	0	0	3	0	0
11	3848283	.	G	A	15	16	31	0	1	32	0	0
11	3848323	.	C	T	0	15	15	1	17	33	0	0
11	3848656	.	C	T	10	13	23	0	3	26	0	0
11	3860159	.	A	T	2	3	5	0	0	5	0	0
11	3893635	.	C	T	15	22	37	0	1	38	0	0
11	3893636	.	T	G	14	23	37	0	1	38	0	0
11	3893918	.	G	A	19	21	40	0	0	40	0	0
11	3893928	.	G	C	13	21	34	0	2	36	0	0
11	3894023	.	T	C	20	30	50	0	0	50	0	0
11	3898730	.	C	A	3	18	21	0	11	32	0	0
11	3898736	.	A	G	10	19	29	0	0	29	0	0
11	3899066	.	C	A	3	12	15	0	12	27	0	0
11	3899117	.	G	A	7	10	17	0	1	18	0	0
11	3901733	.	C	G	0	12	12	0	8	20	0	0
11	3904469	.	A	G	8	9	17	0	1	18	0	0
11	3904517	.	C	G	1	9	10	0	11	21	0	0
11	3904564	.	C	T	7	9	16	0	1	17	0	0
11	3904666	.	A	G	8	8	16	0	0	16	0	0
11	3904674	.	T	G	9	5	14	0	0	14	0	0
11	3905928	.	A	G	4	9	13	0	2	15	0	0
11	3917723	.	A	G	11	16	27	0	0	27	0	0
11	3921491	.	A	G	21	10	31	0	1	32	0	0
11	3921563	.	T	A	21	9	30	0	0	30	0	0
11	3922983	.	G	A	12	8	20	0	2	22	0	0
11	3925822	.	T	C	5	0	5	0	10	15	0	0
11	3925906	.	A	G	8	7	15	0	1	16	0	0
11	3925939	.	T	C	8	8	16	0	1	17	0	0
11	3928044	.	A	T	5	3	8	0	0	8	0	0
11	3928168	.	T	C	5	2	7	0	0	7	0	0
11	3931773	.	C	T	8	5	13	0	0	13	0	0
11	3933807	.	G	A	3	3	6	0	0	6	0	0
11	3933956	.	A	G	5	5	10	0	0	10	0	0
11	3934190	.	A	G	3	4	7	0	1	8	0	0
11	3934319	.	T	G	0	2	2	0	3	5	0	0
11	3936378	.	T	A	4	3	7	0	0	7	0	0
11	3938816	.	G	A	1	2	3	0	0	3	0	0
11	3941180	.	C	T	1	2	3	0	1	4	0	0
11	3952936	.	T	C	3	0	3	0	4	7	0	0
11	3963581	.	C	T	7	6	13	0	1	14	0	0
11	3963608	.	G	T	6	6	12	0	0	12	0	0
11	3964193	.	T	A	2	6	8	0	0	8	0	0
11	3965837	.	G	A	3	5	8	0	0	8	0	0
11	3965867	.	C	T	4	3	7	0	0	7	0	0
11	3965984	.	T	A	9	5	14	0	0	14	0	0
11	3966360	.	G	C	0	8	8	0	5	13	0	0
11	3967408	.	A	G	4	0	4	0	9	13	0	0
11	3967445	.	A	G	4	6	10	0	0	10	0	0
11	3968866	.	T	C	3	12	15	0	2	17	0	0
11	3968877	.	G	A	3	13	16	0	1	17	0	0
11	3968915	.	T	G	7	11	18	0	2	20	0	0
11	3968930	.	A	G	7	1	8	0	9	17	0	0
11	3970703	.	T	A	2	3	5	0	0	5	0	0
11	3970713	.	T	A	2	2	4	0	0	4	0	0
11	3971897	.	A	G	3	2	5	0	0	5	0	0
11	3971943	.	T	A	3	2	5	0	0	5	0	0
11	3972248	.	C	T	2	4	6	0	0	6	0	0
11	3977745	.	C	T	1	2	3	0	0	3	0	0
11	3993452	.	G	A	1	5	6	0	3	9	0	0
11	3993470	.	A	T	2	2	4	0	0	4	0	0
11	3994901	.	C	A	6	3	9	0	1	10	0	0
11	3995459	.	G	A	4	4	8	0	0	8	0	0
11	3995479	.	G	T	2	6	8	0	1	9	0	0
11	3997023	.	T	C	5	0	5	0	3	8	0	0
11	3997029	.	C	A	0	2	2	0	6	8	0	0
11	4001816	.	A	G	6	4	10	0	1	11	0	0
11	4004042	.	G	C	3	3	6	0	1	7	0	0
11	4006924	.	C	T	1	6	7	0	4	11	0	0
11	4006956	.	C	T	3	3	6	0	0	6	0	0
11	4010895	.	C	T	2	5	7	0	0	7	0	0
11	4011001	.	T	C	5	0	5	0	4	9	0	0
11	4014428	.	A	T	3	2	5	0	0	5	0	0
11	4023804	.	G	A	1	2	3	0	0	3	0	0
11	4023813	.	T	G	1	2	3	0	0	3	0	0
11	4113825	.	G	A	0	2	2	0	3	5	0	0
11	4128836	.	A	T	9	14	23	0	2	25	0	0
11	4131300	.	A	T	15	7	22	0	0	22	0	0
11	4131423	.	T	A	12	10	22	0	2	24	0	0
11	4132110	.	G	T	17	11	28	0	1	29	0	0
11	4132296	.	A	C	28	23	51	0	2	53	0	0
11	4132378	.	G	C	12	15	27	0	4	31	0	0
11	4132440	.	A	G	13	7	20	0	3	23	0	0
11	4132599	.	T	C	9	4	13	0	1	14	0	0
11	5643174	.	A	G	3	0	3	0	3	6	0	0
11	5648343	.	A	C	1	8	9	0	0	9	0	0
11	5650916	.	T	C	1	2	3	0	0	3	0	0
11	5658587	.	T	A	5	4	9	0	0	9	0	0
11	5658751	.	A	G	7	6	13	0	0	13	0	0
11	5658889	.	A	G	2	2	4	0	1	5	0	0
11	5658941	.	A	G	6	4	10	0	1	11	0	0
11	5659054	.	C	G	7	3	10	0	0	10	0	0
11	5659097	.	G	A	9	6	15	0	1	16	0	0
11	5659177	.	T	A	4	3	7	0	2	9	0	0
11	5659266	.	T	C	2	3	5	0	1	6	0	0
11	5659300	.	C	A	1	2	3	0	0	3	0	0
11	5669907	.	G	A	1	5	6	0	6	12	0	0
11	5669917	.	A	T	6	6	12	0	0	12	0	0
11	5669950	.	T	C	7	4	11	0	0	11	0	0
11	5674134	.	G	A	5	4	9	0	0	9	0	0
11	5674150	.	A	G	4	4	8	0	1	9	0	0
11	5674183	.	G	C	7	5	12	0	0	12	0	0
11	5674731	.	T	G	7	0	7	0	10	17	0	0
11	5817345	.	T	C	8	5	13	0	0	13	0	0
11	5817397	.	A	T	7	5	12	0	0	12	0	0
11	5817472	.	C	A	3	3	6	0	2	8	0	0
11	5821096	.	C	G	14	4	18	0	1	19	0	0
11	5825477	.	T	C	7	9	16	0	1	17	0	0
11	5836012	.	G	A	6	18	24	0	1	25	0	0
11	5843388	.	T	C	25	26	51	0	0	51	0	0
11	5844303	.	T	A	27	20	47	0	3	50	0	0
11	5844333	.	T	C	16	19	35	0	3	38	0	0
11	5844525	.	G	A	26	25	51	0	0	51	0	0
11	5844579	.	G	A	3	26	29	0	18	47	0	0
11	5847511	.	G	A	37	17	54	0	2	56	0	0
11	5852424	.	G	T	7	31	38	1	21	60	0	0
11	5923335	.	C	A	20	20	40	0	1	41	0	0
11	5923471	.	A	T	9	3	12	0	1	13	0	0
11	5923515	.	G	A	0	3	3	0	5	8	0	0
11	5945410	.	A	T	2	4	6	0	0	6	0	0
11	5945836	.	A	T	2	9	11	0	3	14	0	0
11	5945840	.	G	A	3	10	13	0	3	16	0	0
11	5945919	.	T	A	4	7	11	0	0	11	0	0
11	5946023	.	T	A	10	11	21	2	6	29	0	0
11	5946564	.	T	C	13	13	26	0	1	27	0	0
11	5946854	.	G	C	16	10	26	0	5	31	0	0
11	5947191	.	T	G	20	10	30	0	0	30	0	0
11	5953436	.	G	T	4	9	13	0	0	13	0	0
11	5953521	.	T	C	4	0	4	0	9	13	0	0
11	5953547	.	C	T	0	6	6	0	6	12	0	0
11	6031426	.	A	G	1	2	3	0	0	3	0	0
11	6034351	.	C	A	2	2	4	0	1	5	0	0
11	6034530	.	T	C	1	3	4	0	0	4	0	0
11	6051431	.	G	A	10	6	16	0	1	17	0	0
11	6051632	.	G	A	8	5	13	0	0	13	0	0
11	6051648	.	C	T	1	5	6	0	9	15	0	0
11	6051679	.	C	T	9	12	21	0	0	21	0	0
11	6051880	.	A	C	9	0	9	0	12	21	0	0
11	6057335	.	G	A	10	7	17	0	1	18	0	0
11	6062107	.	T	A	8	4	12	0	0	12	0	0
11	6064265	.	C	T	2	2	4	0	0	4	0	0
11	6072084	.	A	G	1	2	3	0	0	3	0	0
11	6072096	.	A	T	2	2	4	0	0	4	0	0
11	6072398	.	C	T	1	3	4	0	0	4	0	0
11	6072558	.	A	G	1	2	3	0	0	3	0	0
11	6072799	.	G	A	1	2	3	0	1	4	0	0
11	6072818	.	G	A	1	4	5	0	1	6	0	0
11	6073736	.	C	T	1	3	4	0	2	6	0	0
11	6073759	.	G	T	4	6	10	0	0	10	0	0
11	6073807	.	T	G	2	0	2	0	3	5	0	0
11	6074110	.	T	G	2	4	6	0	0	6	0	0
11	6074175	.	G	T	3	3	6	0	0	6	0	0
11	6098193	.	C	A	1	2	3	0	0	3	0	0
11	6098395	.	G	T	3	4	7	0	0	7	0	0
11	6098400	.	A	G	2	3	5	0	0	5	0	0
11	6132985	.	T	G	3	4	7	0	2	9	0	0
11	6133293	.	G	C	4	5	9	0	0	9	0	0
11	6133477	.	T	A	4	3	7	0	0	7	0	0
11	6144450	.	T	C	4	3	7	0	1	8	0	0
11	6144604	.	A	T	3	2	5	0	1	6	0	0
11	6144607	.	T	G	3	3	6	0	0	6	0	0
11	6144776	.	T	C	4	5	9	0	0	9	0	0
11	6144800	.	G	A	7	2	9	0	0	9	0	0
11	6144872	.	C	T	6	2	8	0	0	8	0	0
11	6168047	.	C	T	1	2	3	0	0	3	0	0
11	6168071	.	T	C	2	1	3	0	1	4	0	0
11	6170596	.	C	A	2	2	4	0	0	4	0	0
11	6170662	.	T	C	3	2	5	0	1	6	0	0
11	6172327	.	G	A	3	3	6	0	1	7	0	0
11	6172366	.	T	G	3	2	5	0	0	5	0	0
11	6183030	.	T	C	15	19	34	0	2	36	0	0
11	6187412	.	C	G	2	10	12	0	16	28	0	0
11	6197495	.	C	T	0	9	9	0	12	21	0	0
11	6262189	.	T	C	4	7	11	0	0	11	0	0
11	6286793	.	T	C	1	2	3	0	0	3	0	0
11	6289556	.	T	C	1	2	3	0	0	3	0	0
11	6290039	.	C	T	1	2	3	0	0	3	0	0
11	6428893	.	G	T	11	12	23	0	0	23	0	0
11	6446950	.	G	A	1	2	3	0	0	3	0	0
11	6450624	.	G	A	1	2	3	0	0	3	0	0
11	6456177	.	C	T	13	8	21	0	0	21	0	0
11	6456677	.	T	C	22	24	46	0	1	47	0	0
11	6456829	.	C	T	27	26	53	0	0	53	0	0
11	6456934	.	C	A	4	3	7	0	1	8	0	0
11	6457442	.	G	A	11	9	20	0	3	23	0	0
11	6457473	.	C	A	12	8	20	0	1	21	0	0
11	6457500	.	A	T	20	7	27	0	0	27	0	0
11	6457518	.	T	C	23	10	33	0	0	33	0	0
11	6457594	.	C	A	7	6	13	0	1	14	0	0
11	6457619	.	T	C	3	6	9	0	2	11	0	0
11	6869480	.	G	T	1	3	4	0	2	6	0	0
11	6977580	.	G	A	2	2	4	0	0	4	0	0
11	6977626	.	T	C	2	2	4	0	0	4	0	0
11	10468756	.	T	C	3	6	9	0	0	9	0	0
11	10468772	.	T	A	2	4	6	0	1	7	0	0
11	10670439	.	T	C	21	14	35	1	17	53	0	0
11	10672158	.	T	C	1	2	3	0	0	3	0	0
11	10672159	.	T	C	1	2	3	0	0	3	0	0
11	12720049	.	T	A	15	14	29	0	1	30	0	0
11	12727225	.	A	G	17	19	36	0	1	37	0	0
11	12727446	.	C	T	22	22	44	0	0	44	0	0
11	12727685	.	T	C	16	15	31	0	2	33	0	0
11	12727708	.	C	A	12	13	25	0	0	25	0	0
11	12727829	.	T	A	8	3	11	0	1	12	0	0
11	12727853	.	A	T	9	2	11	0	0	11	0	0
11	12727879	.	A	C	8	4	12	0	1	13	0	0
11	12727990	.	T	A	9	15	24	0	0	24	0	0
11	12727999	.	C	T	9	11	20	0	1	21	0	0
11	12728195	.	T	G	10	9	19	0	1	20	0	0
11	12728249	.	C	T	8	9	17	0	0	17	0	0
11	12732419	.	T	C	4	2	6	0	0	6	0	0
11	12732431	.	A	C	3	2	5	0	1	6	0	0
11	12732521	.	T	C	6	0	6	0	9	15	0	0
11	12732569	.	C	T	11	4	15	0	0	15	0	0
11	12732573	.	T	G	5	7	12	0	0	12	0	0
11	12732696	.	T	A	3	7	10	0	0	10	0	0
11	12732699	.	A	T	3	7	10	0	1	11	0	0
11	12732980	.	T	C	5	4	9	0	0	9	0	0
11	12733104	.	G	A	4	5	9	0	1	10	0	0
11	12733167	.	T	C	3	0	3	0	2	5	0	0
11	12733235	.	T	C	2	1	3	0	5	8	0	0
11	12733278	.	G	C	2	6	8	0	0	8	0	0
11	12733362	.	A	G	2	7	9	0	0	9	0	0
11	12733815	.	C	T	3	4	7	0	1	8	0	0
11	12733892	.	T	G	5	3	8	0	1	9	0	0
11	12734007	.	C	T	3	8	11	0	1	12	0	0
11	12734223	.	G	A	4	5	9	0	0	9	0	0
11	12741394	.	G	A	6	2	8	0	0	8	0	0
11	12744740	.	T	C	4	12	16	0	0	16	0	0
11	12751500	.	G	A	4	10	14	0	0	14	0	0
11	12751831	.	T	C	4	5	9	0	0	9	0	0
11	12752161	.	A	T	6	4	10	0	0	10	0	0
11	12767964	.	A	G	7	1	8	0	10	18	0	0
11	12767982	.	T	C	5	8	13	0	3	16	0	0
11	12768214	.	G	A	1	9	10	0	15	25	0	0
11	12768221	.	C	T	14	11	25	0	0	25	0	0
11	12768351	.	A	G	15	8	23	0	1	24	0	0
11	12768394	.	A	C	11	7	18	0	1	19	0	0
11	12768480	.	C	T	4	7	11	0	0	11	0	0
11	12782802	.	G	A	3	2	5	0	0	5	0	0
11	12783139	.	T	A	5	5	10	0	0	10	0	0
11	12792803	.	C	T	1	3	4	0	0	4	0	0
11	12860525	.	T	C	3	4	7	0	0	7	0	0
11	12860552	.	G	A	0	3	3	0	4	7	0	0
11	12860924	.	A	G	0	3	3	0	1	4	0	0
11	12860931	.	C	G	1	4	5	0	0	5	0	0
11	12861196	.	A	G	4	7	11	0	0	11	0	0
11	12864070	.	C	T	9	6	15	0	1	16	0	0
11	12864361	.	A	G	2	0	2	0	3	5	0	0
11	12869192	.	G	T	1	8	9	0	9	18	0	0
11	12869309	.	T	C	5	10	15	0	0	15	0	0
11	12869409	.	C	A	8	8	16	0	0	16	0	0
11	12869414	.	C	T	8	7	15	0	1	16	0	0
11	12872304	.	C	G	2	4	6	0	1	7	0	0
11	12872962	.	T	A	1	2	3	0	0	3	0	0
11	12872971	.	A	G	1	0	1	0	1	2	0	0
11	13055470	.	G	A	18	26	44	0	4	48	0	0
11	13055694	.	C	A	5	13	18	0	5	23	0	0
11	13079183	.	C	A	3	2	5	0	1	6	0	0
11	13088062	.	G	T	0	6	6	0	7	13	0	0
11	13094203	.	C	T	6	19	25	0	2	27	0	0
11	13094368	.	T	A	13	7	20	0	0	20	0	0
11	13094473	.	A	T	23	17	40	0	0	40	0	0
11	13094581	.	C	T	4	25	29	0	22	51	0	0
11	13094668	.	C	A	23	20	43	0	2	45	0	0
11	13094678	.	T	C	19	17	36	0	5	41	0	0
11	13094778	.	T	C	17	18	35	0	2	37	0	0
11	13095049	.	G	A	15	16	31	0	0	31	0	0
11	13188425	.	G	C	4	3	7	0	0	7	0	0
11	13188527	.	A	G	4	1	5	0	3	8	0	0
11	13188669	.	C	T	2	7	9	0	0	9	0	0
11	13189339	.	G	T	5	2	7	0	0	7	0	0
11	13189461	.	A	G	6	5	11	0	1	12	0	0
11	13189469	.	A	G	8	5	13	0	0	13	0	0
11	13189592	.	G	A	7	3	10	0	0	10	0	0
11	13189623	.	T	A	6	5	11	0	0	11	0	0
11	13189627	.	T	G	6	3	9	0	0	10	1	0
11	13208755	.	T	A	33	14	47	0	2	49	0	0
11	13209037	.	T	G	32	29	61	0	2	63	0	0
11	13209391	.	C	T	30	27	57	0	1	59	1	0
11	13210604	.	G	A	23	28	51	0	4	55	0	0
11	13210650	.	A	C	31	30	61	0	3	64	0	0
11	13210897	.	A	T	35	25	60	0	2	62	0	0
11	13212234	.	T	C	43	35	78	0	2	80	0	0
11	13212306	.	C	T	36	26	62	0	5	67	0	0
11	13212333	.	T	C	34	26	60	0	3	63	0	0
11	13212357	.	T	C	33	26	59	0	10	69	0	0
11	13212567	.	T	C	36	27	63	0	6	69	0	0
11	13212908	.	T	A	25	30	55	0	1	56	0	0
11	13280346	.	T	A	4	3	7	0	0	7	0	0
11	13280420	.	G	C	3	7	10	0	1	11	0	0
11	13280565	.	T	C	18	6	24	0	9	33	0	0
11	13280579	.	A	C	18	6	24	0	8	32	0	0
11	13281122	.	T	C	10	18	28	0	3	31	0	0
11	13281158	.	A	T	10	15	25	0	0	25	0	0
11	13281238	.	A	G	4	5	9	0	3	12	0	0
11	13281243	.	C	A	7	7	14	0	1	15	0	0
11	13281331	.	A	T	13	6	19	0	1	20	0	0
11	13281594	.	T	C	16	13	29	0	2	31	0	0
11	13281734	.	G	A	12	12	24	0	0	24	0	0
11	13281864	.	C	T	3	3	6	0	0	6	0	0
11	13281979	.	A	G	14	6	20	0	0	20	0	0
11	13282108	.	A	G	10	3	13	0	0	13	0	0
11	13282124	.	G	C	9	5	14	0	1	16	1	0
11	13282201	.	G	T	7	5	12	0	2	14	0	0
11	13282439	.	C	A	6	5	11	0	0	11	0	0
11	13282443	.	G	A	6	5	11	0	0	11	0	0
11	13283335	.	A	G	12	9	21	0	1	22	0	0
11	13283368	.	C	A	9	12	21	0	0	21	0	0
11	13283398	.	G	C	8	6	14	0	1	15	0	0
11	13283403	.	T	G	10	5	15	0	2	17	0	0
11	13283447	.	G	A	8	7	15	0	0	15	0	0
11	13283476	.	C	T	9	5	14	0	0	14	0	0
11	13283569	.	G	A	8	6	14	0	0	14	0	0
11	13283634	.	C	T	4	6	10	0	0	10	0	0
11	13283713	.	G	A	9	7	16	0	1	17	0	0
11	13292084	.	A	G	3	5	8	0	0	8	0	0
11	13292105	.	C	T	0	4	4	0	4	8	0	0
11	13292462	.	C	T	8	4	12	0	1	13	0	0
11	13292576	.	C	T	1	2	3	0	5	8	0	0
11	13305874	.	T	C	1	2	3	0	0	3	0	0
11	13306186	.	C	T	2	2	4	0	0	4	0	0
11	13313208	.	C	T	1	2	3	0	0	3	0	0
11	13424477	.	G	C	2	3	5	0	0	5	0	0
11	13424478	.	G	A	2	3	5	0	0	5	0	0
11	13503124	.	T	G	1	0	1	0	3	4	0	0
11	13504149	.	A	G	1	2	3	0	0	3	0	0
11	13504343	.	A	C	5	2	7	0	0	7	0	0
11	13504403	.	C	T	6	2	8	0	0	8	0	0
11	13504563	.	A	C	2	3	5	0	0	5	0	0
11	13505186	.	C	A	7	9	16	0	1	17	0	0
11	13505247	.	A	T	6	2	8	0	0	9	1	0
11	13505401	.	A	G	5	0	5	0	4	9	0	0
11	13529810	.	T	C	3	2	5	0	0	5	0	0
11	13532024	.	G	T	5	2	7	0	0	7	0	0
11	13532034	.	G	A	0	2	2	0	6	8	0	0
11	13532070	.	T	G	4	0	4	0	3	7	0	0
11	13532071	.	T	C	4	3	7	0	0	7	0	0
11	13532567	.	T	C	3	6	9	0	0	9	0	0
11	13532763	.	C	T	6	5	11	0	0	11	0	0
11	13532922	.	C	T	5	3	8	0	0	8	0	0
11	13533094	.	T	G	3	7	10	0	1	11	0	0
11	13533124	.	G	A	5	6	11	0	0	11	0	0
11	13533214	.	A	G	4	0	4	0	8	12	0	0
11	13533388	.	T	A	4	8	12	0	0	12	0	0
11	13533429	.	G	T	7	7	14	0	0	14	0	0
11	13636198	.	C	T	2	6	8	0	0	8	0	0
11	13789377	.	T	C	1	4	5	0	0	5	0	0
11	14062357	.	C	T	0	2	2	0	1	3	0	0
11	14062368	.	C	T	1	2	3	0	0	3	0	0
11	14062453	.	C	G	1	2	3	0	0	3	0	0
11	14062583	.	C	T	4	2	6	0	0	6	0	0
11	14062662	.	A	G	1	1	2	0	0	2	0	0
11	14062667	.	A	G	1	2	3	0	0	3	0	0
11	14063678	.	T	A	4	4	8	2	1	11	0	0
11	14063679	.	T	A	4	5	9	2	0	11	0	0
11	14064006	.	C	G	2	3	5	0	0	5	0	0
11	14064487	.	G	C	5	5	10	0	0	10	0	0
11	14064523	.	C	T	7	5	12	0	0	12	0	0
11	14073049	.	T	A	8	6	14	0	1	15	0	0
11	14073192	.	G	T	2	4	6	0	0	6	0	0
11	14073444	.	C	T	11	5	16	0	3	19	0	0
11	14073503	.	G	A	13	5	18	0	0	18	0	0
11	14073560	.	T	A	12	8	20	0	1	21	0	0
11	14073730	.	G	T	6	13	19	0	2	21	0	0
11	14073857	.	C	A	10	4	14	0	1	15	0	0
11	14073858	.	A	T	9	5	14	0	0	14	0	0
11	14074125	.	T	C	7	7	14	0	0	14	0	0
11	14074245	.	T	C	9	7	16	0	0	16	0	0
11	14074584	.	T	G	3	4	7	0	0	7	0	0
11	14074628	.	T	A	5	3	8	0	0	8	0	0
11	14074649	.	A	G	4	2	6	0	0	6	0	0
11	14074951	.	C	T	2	9	11	0	0	11	0	0
11	14074952	.	A	T	1	9	10	0	1	11	0	0
11	14075147	.	G	A	9	6	15	0	1	16	0	0
11	14075302	.	A	G	3	9	12	0	0	12	0	0
11	14101295	.	C	A	1	2	3	0	1	4	0	0
11	14112469	.	T	C	1	2	3	0	0	3	0	0
11	14119690	.	C	G	3	4	7	0	0	7	0	0
11	14132176	.	C	G	3	0	3	0	4	7	0	0
11	14137563	.	C	T	5	2	7	0	1	8	0	0
11	14137901	.	C	A	4	6	10	0	1	11	0	0
11	14137988	.	C	T	9	9	18	0	0	18	0	0
11	14138006	.	T	G	9	8	17	0	1	18	0	0
11	14143452	.	C	A	9	10	19	0	0	19	0	0
11	14143499	.	G	A	0	4	4	0	5	9	0	0
11	14199913	.	G	C	0	9	9	0	11	20	0	0
11	14266826	.	G	T	3	13	16	0	10	26	0	0
11	14267075	.	T	C	18	10	28	0	1	29	0	0
11	14267076	.	G	A	19	11	30	0	0	30	0	0
11	14267239	.	C	G	8	4	12	0	0	12	0	0
11	14289047	.	G	C	1	2	3	0	0	3	0	0
11	14291203	.	G	A	1	1	2	0	1	3	0	0
11	14318207	.	T	A	6	5	11	0	0	11	0	0
11	14318637	.	A	G	4	3	7	0	2	9	0	0
11	14333489	.	T	C	2	2	4	0	1	5	0	0
11	14338397	.	C	G	5	2	7	0	0	7	0	0
11	14338454	.	C	G	2	3	5	0	0	5	0	0
11	14338460	.	G	A	3	2	5	0	0	5	0	0
11	14341161	.	A	G	2	1	3	0	1	4	0	0
11	14341163	.	G	A	2	2	4	0	0	4	0	0
11	14341498	.	T	A	3	3	6	0	0	6	0	0
11	14341510	.	A	C	2	3	5	0	0	5	0	0
11	14341557	.	G	A	4	2	6	0	0	6	0	0
11	14342379	.	A	C	1	3	4	0	1	5	0	0
11	14343653	.	G	T	4	1	5	1	2	8	0	0
11	14343658	.	A	T	5	2	7	1	0	8	0	0
11	14344976	.	G	T	3	3	6	0	0	6	0	0
11	14344989	.	G	A	0	4	4	0	2	6	0	0
11	14345156	.	C	A	1	2	3	0	0	3	0	0
11	14345562	.	T	G	5	4	9	0	0	9	0	0
11	14345753	.	A	G	8	12	20	0	1	21	0	0
11	14345830	.	T	C	2	4	6	0	0	6	0	0
11	14345884	.	T	G	1	5	6	0	0	6	0	0
11	14345910	.	A	T	3	5	8	0	1	9	0	0
11	14345922	.	T	G	4	4	8	0	0	8	0	0
11	14639030	.	T	C	4	6	10	0	2	12	0	0
11	14640002	.	G	T	0	4	4	0	2	6	0	0
11	14640155	.	A	G	2	3	5	0	0	5	0	0
11	14749156	.	G	A	3	5	8	0	1	9	0	0
11	14751068	.	T	C	2	6	8	0	2	10	0	0
11	14955592	.	A	G	11	7	18	0	4	22	0	0
11	15250544	.	T	C	15	9	24	0	0	24	0	0
11	15586740	.	C	A	3	2	5	0	1	6	0	0
11	15586757	.	T	C	3	3	6	0	0	6	0	0
11	15586792	.	T	G	1	4	5	0	0	5	0	0
11	15833846	.	T	C	7	7	14	0	1	15	0	0
11	15834265	.	T	C	4	4	8	0	0	8	0	0
11	15834436	.	T	A	8	6	14	0	0	14	0	0
11	15850735	.	C	T	1	4	5	0	0	5	0	0
11	15874809	.	C	A	0	4	4	0	3	7	0	0
11	15874820	.	A	G	3	5	8	0	0	8	0	0
11	15887006	.	A	G	2	2	4	0	0	4	0	0
11	15888117	.	G	C	0	3	3	0	2	5	0	0
11	15894885	.	G	A	1	3	4	0	4	8	0	0
11	15910604	.	G	C	7	5	12	0	0	12	0	0
11	15975556	.	C	T	1	5	6	0	1	7	0	0
11	16005711	.	C	T	3	8	11	0	0	11	0	0
11	16005862	.	G	A	3	4	7	0	0	7	0	0
11	16005883	.	G	T	2	4	6	0	0	6	0	0
11	16005985	.	A	T	2	5	7	0	1	8	0	0
11	16006016	.	C	T	1	4	5	0	0	5	0	0
11	16006030	.	C	T	1	4	5	0	0	5	0	0
11	16006215	.	A	T	1	4	5	0	0	5	0	0
11	16006218	.	G	A	1	3	4	0	0	4	0	0
11	16006551	.	C	A	1	2	3	0	0	3	0	0
11	16006553	.	T	A	0	2	2	0	1	3	0	0
11	16010468	.	A	G	4	0	4	0	3	7	0	0
11	16010502	.	A	G	2	0	2	0	4	6	0	0
11	16010656	.	T	C	9	5	14	2	0	16	0	0
11	16010788	.	C	A	8	6	14	0	0	14	0	0
11	16010799	.	G	C	7	7	14	0	1	15	0	0
11	16010842	.	C	T	6	3	9	0	0	9	0	0
11	16010849	.	A	G	5	0	5	0	4	9	0	0
11	16010978	.	G	A	5	5	10	0	1	11	0	0
11	16010986	.	A	T	5	6	11	0	0	11	0	0
11	16011185	.	C	A	2	4	6	0	0	6	0	0
11	16011414	.	G	A	3	2	5	0	0	5	0	0
11	16011622	.	T	C	12	4	16	0	1	17	0	0
11	16011632	.	T	G	14	0	14	0	5	19	0	0
11	16011705	.	T	C	11	9	20	0	6	26	0	0
11	16011745	.	C	G	18	4	22	0	0	22	0	0
11	16011770	.	T	C	20	11	31	0	1	32	0	0
11	16011807	.	T	C	15	15	30	0	1	31	0	0
11	16012021	.	G	A	14	7	21	0	1	22	0	0
11	16012117	.	G	T	2	17	19	0	15	34	0	0
11	16012140	.	G	A	3	16	19	0	14	33	0	0
11	16012152	.	A	G	17	0	17	0	17	34	0	0
11	16012191	.	C	T	11	15	26	0	1	27	0	0
11	16012201	.	C	T	11	13	24	0	2	26	0	0
11	16012251	.	T	A	12	9	21	0	0	21	0	0
11	16012256	.	C	T	13	9	22	0	0	22	0	0
11	16012316	.	T	G	10	10	20	0	0	20	0	0
11	16012364	.	G	T	1	7	8	0	8	16	0	0
11	16012414	.	T	C	10	6	16	0	0	16	0	0
11	16012508	.	A	C	8	5	13	0	0	13	0	0
11	16012512	.	C	T	7	4	11	0	1	12	0	0
11	16012654	.	A	G	9	0	9	0	9	18	0	0
11	16012785	.	T	G	13	16	29	0	3	32	0	0
11	16012786	.	A	G	13	17	30	0	2	32	0	0
11	16012829	.	G	T	14	17	31	0	1	32	0	0
11	16012882	.	G	A	17	13	30	0	0	30	0	0
11	16013018	.	T	C	11	8	19	0	1	20	0	0
11	16013036	.	T	A	3	7	10	0	0	10	0	0
11	16099700	.	G	A	5	10	15	0	2	17	0	0
11	16104175	.	T	C	5	4	9	0	1	10	0	0
11	16115692	.	C	T	4	11	15	0	0	15	0	0
11	16143781	.	T	C	15	22	37	0	0	37	0	0
11	16143829	.	T	C	19	18	37	0	2	39	0	0
11	16153290	.	C	T	6	6	12	0	0	12	0	0
11	16158555	.	G	A	13	6	19	0	0	19	0	0
11	16159056	.	A	G	8	5	13	0	0	13	0	0
11	16159316	.	C	T	9	4	13	0	0	13	0	0
11	16159875	.	T	C	8	8	16	0	3	19	0	0
11	16159903	.	C	T	8	7	15	0	0	15	0	0
11	16160137	.	A	G	11	0	11	0	17	28	0	0
11	16165293	.	T	C	13	9	22	0	3	25	0	0
11	16165298	.	G	A	3	9	12	0	10	22	0	0
11	16165605	.	T	A	19	7	26	0	0	26	0	0
11	16165665	.	A	G	20	10	30	0	0	30	0	0
11	16165710	.	T	A	12	8	20	0	3	23	0	0
11	16165756	.	G	A	18	8	26	0	0	26	0	0
11	16169352	.	T	C	1	2	3	0	0	3	0	0
11	16180033	.	G	A	32	24	56	0	2	58	0	0
11	16184739	.	A	G	13	21	34	0	1	35	0	0
11	16184865	.	A	T	10	17	27	1	2	30	0	0
11	16237915	.	C	G	3	3	6	0	0	6	0	0
11	16238173	.	C	T	5	3	8	0	0	8	0	0
11	16586045	.	G	T	1	4	5	0	0	5	0	0
11	16586747	.	A	G	2	5	7	0	0	7	0	0
11	16587715	.	A	G	5	13	18	0	1	19	0	0
11	16587873	.	A	T	4	2	6	0	1	7	0	0
11	16587901	.	C	T	3	2	5	0	0	5	0	0
11	16738655	.	C	T	7	5	12	0	0	12	0	0
11	16739039	.	C	T	1	8	9	0	5	14	0	0
11	16849887	.	T	G	2	4	6	0	0	6	0	0
11	16849896	.	G	A	2	4	6	0	0	6	0	0
11	17511788	.	T	C	6	6	12	0	0	12	0	0
11	17511902	.	C	A	7	3	10	0	0	10	0	0
11	17512139	.	T	C	11	9	20	1	2	23	0	0
11	17512289	.	T	C	10	7	17	1	2	20	0	0
11	17513174	.	A	G	2	2	4	0	0	4	0	0
11	17513424	.	T	A	1	1	2	0	1	3	0	0
11	17513440	.	A	G	1	2	3	0	0	3	0	0
11	17513526	.	G	A	0	3	3	0	2	5	0	0
11	17513554	.	T	A	1	2	3	0	0	3	0	0
11	17597424	.	G	A	3	5	8	0	0	8	0	0
11	17713672	.	T	C	7	5	12	0	0	12	0	0
11	17757767	.	T	C	5	17	22	0	3	25	0	0
11	17757859	.	T	C	7	7	14	0	0	14	0	0
11	17758008	.	T	C	2	4	6	0	0	6	0	0
11	17758019	.	C	T	4	2	6	0	0	6	0	0
11	17758113	.	T	A	3	2	5	0	0	5	0	0
11	17763137	.	A	G	17	11	28	0	1	29	0	0
11	17763160	.	T	C	19	11	30	0	1	31	0	0
11	17763173	.	C	A	17	12	29	0	0	29	0	0
11	17763393	.	C	T	8	12	20	0	1	21	0	0
11	17765170	.	C	T	5	7	12	0	0	12	0	0
11	17765618	.	T	C	3	0	3	0	5	8	0	0
11	17769238	.	C	T	9	10	19	0	1	20	0	0
11	17769801	.	A	T	5	10	15	0	0	15	0	0
11	17770594	.	C	T	5	9	14	0	0	14	0	0
11	17770627	.	T	C	5	6	11	0	0	11	0	0
11	17770928	.	T	C	8	3	11	0	0	11	0	0
11	17770931	.	A	C	7	3	10	0	1	11	0	0
11	17771185	.	T	C	5	4	9	0	0	9	0	0
11	17771248	.	T	C	5	6	11	0	1	12	0	0
11	17771478	.	C	T	5	4	9	0	0	9	0	0
11	17774970	.	G	T	2	5	7	0	1	8	0	0
11	17778492	.	T	A	4	4	8	0	0	8	0	0
11	17778528	.	T	C	4	0	4	0	4	8	0	0
11	17778597	.	A	G	1	3	4	0	0	4	0	0
11	17778618	.	T	G	2	4	6	0	0	6	0	0
11	17779023	.	T	C	1	1	2	0	1	3	0	0
11	17779028	.	T	G	0	2	2	0	1	3	0	0
11	17779254	.	T	C	2	0	2	0	5	7	0	0
11	17779279	.	C	A	1	5	6	0	0	6	0	0
11	17779416	.	T	C	3	2	5	0	0	5	0	0
11	17779435	.	G	T	5	2	7	0	0	7	0	0
11	17779630	.	G	A	4	2	6	0	0	6	0	0
11	17779656	.	C	T	0	3	3	0	4	7	0	0
11	17782529	.	A	C	1	0	1	0	4	5	0	0
11	17782683	.	G	A	2	3	5	0	0	5	0	0
11	17782845	.	C	T	2	5	7	0	0	7	0	0
11	17782849	.	A	G	2	5	7	0	0	7	0	0
11	17785402	.	T	G	15	8	23	1	2	26	0	0
11	17785412	.	C	A	17	8	25	1	2	28	0	0
11	17785591	.	A	G	21	7	28	0	0	28	0	0
11	17789069	.	G	T	9	16	25	0	0	25	0	0
11	17789210	.	T	C	13	11	24	0	1	25	0	0
11	17789550	.	A	G	9	12	21	0	1	22	0	0
11	17792991	.	C	T	2	7	9	0	3	12	0	0
11	17793676	.	G	A	4	7	11	0	1	12	0	0
11	17796869	.	C	T	0	3	3	0	7	10	0	0
11	17797072	.	T	C	5	0	5	0	4	9	0	0
11	17797280	.	G	A	3	4	7	0	2	9	0	0
11	17987289	.	C	A	3	5	8	0	0	8	0	0
11	18223383	.	C	T	4	7	11	0	2	13	0	0
11	18238076	.	C	T	8	9	17	0	0	17	0	0
11	18244388	.	T	C	9	12	21	0	5	26	0	0
11	18271303	.	G	A	5	2	7	0	0	7	0	0
11	18277370	.	C	T	1	5	6	0	4	10	0	0
11	18277388	.	G	A	7	3	10	0	2	12	0	0
11	18283525	.	T	C	3	0	3	0	5	8	0	0
11	18287280	.	A	G	5	9	14	0	0	14	0	0
11	18287283	.	A	T	6	9	15	0	1	16	0	0
11	18287693	.	A	G	14	5	19	0	1	20	0	0
11	18287779	.	G	A	4	8	12	0	2	14	0	0
11	18287895	.	T	G	11	3	14	0	0	14	0	0
11	18288018	.	T	C	13	6	19	0	1	20	0	0
11	18288212	.	T	C	7	8	15	0	2	17	0	0
11	18289425	.	T	G	6	5	11	0	0	11	0	0
11	18290095	.	G	A	10	5	15	0	1	16	0	0
11	18291865	.	A	G	10	9	19	0	0	19	0	0
11	18291961	.	C	T	2	5	7	0	8	15	0	0
11	18292633	.	A	G	6	6	12	0	0	12	0	0
11	18292699	.	T	A	6	4	10	0	0	10	0	0
11	18293166	.	A	G	8	6	14	0	0	14	0	0
11	18294857	.	A	G	3	2	5	0	0	5	0	0
11	18295057	.	T	C	4	3	7	0	0	7	0	0
11	18297113	.	A	G	1	1	2	0	1	3	0	0
11	18299674	.	A	G	1	4	5	0	1	6	0	0
11	18304271	.	T	A	2	5	7	0	0	7	0	0
11	18305756	.	G	A	1	3	4	0	0	4	0	0
11	18305804	.	C	G	1	4	5	0	0	5	0	0
11	18345539	.	C	A	2	4	6	0	0	6	0	0
11	18345580	.	T	C	3	3	6	0	0	6	0	0
11	18345719	.	T	G	5	3	8	0	0	8	0	0
11	18345825	.	A	T	1	2	3	0	0	3	0	0
11	18345887	.	C	G	3	5	8	0	0	8	0	0
11	18346745	.	C	T	1	2	3	0	0	3	0	0
11	18346746	.	C	A	1	2	3	0	0	3	0	0
11	18346827	.	C	T	0	2	2	0	3	5	0	0
11	18397105	.	T	C	2	2	4	0	0	4	0	0
11	18397505	.	C	T	1	2	3	0	0	3	0	0
11	18399303	.	A	G	1	2	3	0	0	3	0	0
11	18535666	.	C	T	19	18	37	1	3	41	0	0
11	18535761	.	G	C	21	22	43	0	0	43	0	0
11	18537180	.	A	G	6	4	10	0	3	13	0	0
11	18537244	.	G	A	13	11	24	1	2	27	0	0
11	18537447	.	T	C	9	4	13	0	1	14	0	0
11	18537561	.	T	A	7	8	15	0	0	15	0	0
11	18537636	.	T	A	9	7	16	0	0	16	0	0
11	18538219	.	A	T	11	12	23	0	1	24	0	0
11	18538259	.	G	T	8	13	21	0	2	23	0	0
11	18538336	.	A	C	3	0	3	0	15	18	0	0
11	18538362	.	T	C	10	0	10	0	11	21	0	0
11	18542585	.	A	G	2	3	5	0	0	5	0	0
11	18543520	.	T	A	2	4	6	0	0	6	0	0
11	18543543	.	T	A	2	3	5	0	0	5	0	0
11	18543828	.	T	C	1	2	3	0	0	3	0	0
11	18546088	.	G	T	6	2	8	0	0	8	0	0
11	18546276	.	T	A	2	4	6	0	1	7	0	0
11	18547125	.	A	G	13	8	21	0	1	22	0	0
11	18551011	.	C	A	0	4	4	0	5	9	0	0
11	18551077	.	G	A	8	2	10	0	0	10	0	0
11	18551089	.	G	A	6	4	10	0	0	10	0	0
11	18551605	.	C	T	1	7	8	0	1	9	0	0
11	18561493	.	G	A	1	3	4	0	0	4	0	0
11	18568971	.	G	A	12	8	20	0	1	21	0	0
11	18572364	.	T	C	10	0	10	0	10	20	0	0
11	18572574	.	G	A	8	8	16	0	1	17	0	0
11	18572586	.	C	T	9	7	16	0	0	16	0	0
11	18572640	.	T	G	4	9	13	0	0	13	0	0
11	18572648	.	G	A	4	8	12	0	3	15	0	0
11	18572751	.	G	A	7	12	19	0	0	19	0	0
11	18575161	.	C	G	2	4	6	0	1	7	0	0
11	18575173	.	G	T	2	6	8	0	0	8	0	0
11	18575258	.	T	G	2	3	5	0	0	5	0	0
11	18575326	.	G	T	3	4	7	0	0	7	0	0
11	18577787	.	A	G	5	5	10	0	1	11	0	0
11	18579921	.	C	T	0	6	6	0	2	8	0	0
11	18580059	.	C	T	0	3	3	0	3	7	1	0
11	18586264	.	T	C	3	0	3	0	6	9	0	0
11	18587719	.	T	G	5	2	7	0	1	8	0	0
11	18587720	.	A	G	6	2	8	0	0	8	0	0
11	18677979	.	A	G	3	2	5	0	0	5	0	0
11	18678027	.	G	A	1	4	5	0	1	6	0	0
11	18681547	.	A	G	1	0	1	0	2	3	0	0
11	18681607	.	G	A	8	5	13	0	0	13	0	0
11	18682694	.	A	G	4	5	9	0	0	9	0	0
11	18697720	.	A	G	10	12	22	0	3	25	0	0
11	18697817	.	T	G	9	11	20	0	1	21	0	0
11	18697822	.	A	G	9	0	9	0	11	20	0	0
11	18698138	.	A	G	2	0	2	0	10	12	0	0
11	18698184	.	G	A	0	7	7	0	4	11	0	0
11	18698221	.	A	C	2	5	7	0	1	8	0	0
11	18698526	.	G	A	10	8	18	0	0	18	0	0
11	18699104	.	T	C	14	11	25	0	0	25	0	0
11	18704378	.	G	C	7	0	7	0	5	12	0	0
11	18704500	.	G	A	20	10	30	0	1	31	0	0
11	18704620	.	C	T	0	17	17	0	26	43	0	0
11	18705108	.	A	G	26	21	47	0	0	47	0	0
11	18784949	.	A	T	13	8	21	0	1	22	0	0
11	18785130	.	A	G	18	18	36	0	3	39	0	0
11	18785250	.	C	T	0	20	20	0	20	40	0	0
11	18785294	.	T	G	18	18	36	0	0	36	0	0
11	18785296	.	C	T	17	18	35	0	0	35	0	0
11	18785346	.	A	T	19	14	33	0	1	34	0	0
11	18785410	.	G	A	9	15	24	0	0	24	0	0
11	18785421	.	A	G	12	14	26	0	0	26	0	0
11	18785570	.	T	A	11	7	18	0	0	18	0	0
11	18785600	.	A	T	5	7	12	0	0	12	0	0
11	18785623	.	A	T	7	5	12	0	0	12	0	0
11	18785749	.	C	G	4	5	9	0	0	9	0	0
11	18785921	.	G	A	12	15	27	0	0	27	0	0
11	18785975	.	T	C	10	20	30	0	0	30	0	0
11	18785997	.	T	A	7	16	23	0	1	24	0	0
11	18786085	.	A	T	6	14	20	0	3	23	0	0
11	18786250	.	A	C	14	20	34	0	0	34	0	0
11	18786329	.	C	A	2	14	16	0	14	30	0	0
11	18794157	.	C	A	0	2	2	0	8	10	0	0
11	18799800	.	C	T	1	3	4	0	0	4	0	0
11	18802570	.	T	C	7	3	10	0	0	10	0	0
11	18802815	.	G	C	2	3	5	0	1	6	0	0
11	18802865	.	C	G	6	3	9	0	0	9	0	0
11	18802879	.	A	G	8	3	11	0	1	12	0	0
11	18805988	.	A	T	3	3	6	0	0	7	1	0
11	18806030	.	A	G	4	2	6	0	0	6	0	0
11	19042020	.	T	C	6	4	10	0	0	10	0	0
11	19042026	.	A	G	6	3	9	0	1	10	0	0
11	19068394	.	C	T	14	14	28	0	1	29	0	0
11	19072608	.	T	A	20	17	37	0	1	38	0	0
11	19072746	.	A	T	20	14	34	0	1	35	0	0
11	19084820	.	C	T	9	8	17	0	0	17	0	0
11	19085099	.	G	A	8	7	15	0	0	15	0	0
11	19089286	.	A	G	23	19	42	0	3	45	0	0
11	19089362	.	A	G	31	26	57	0	3	60	0	0
11	19089368	.	C	T	31	25	56	0	4	60	0	0
11	19089608	.	G	A	4	21	25	0	32	57	0	0
11	19089839	.	G	A	3	18	21	0	30	51	0	0
11	19090203	.	G	A	1	20	21	0	15	36	0	0
11	19434043	.	G	C	4	4	8	0	0	8	0	0
11	19434095	.	A	C	5	4	9	0	0	9	0	0
11	19434132	.	T	C	2	4	6	0	0	6	0	0
11	19434239	.	T	C	4	3	7	0	1	8	0	0
11	19434279	.	T	C	3	6	9	0	0	9	0	0
11	19434290	.	T	C	4	5	9	0	0	9	0	0
11	19456886	.	C	T	3	2	5	0	0	5	0	0
11	19462920	.	C	T	4	4	8	0	1	9	0	0
11	19464759	.	C	G	3	7	10	0	0	10	0	0
11	19464813	.	A	G	4	6	10	0	2	12	0	0
11	19464957	.	C	G	2	0	2	0	7	9	0	0
11	19465029	.	T	C	5	7	12	0	1	13	0	0
11	19465080	.	T	C	9	8	17	0	4	21	0	0
11	19465428	.	C	T	12	6	18	0	2	20	0	0
11	19467792	.	G	A	1	14	15	0	12	27	0	0
11	19467838	.	C	T	10	19	29	0	2	31	0	0
11	19468104	.	C	T	19	14	33	0	1	34	0	0
11	19468123	.	T	C	20	14	34	0	2	36	0	0
11	19468301	.	A	G	15	0	15	0	12	27	0	0
11	19468547	.	C	A	15	12	27	0	2	29	0	0
11	19468697	.	G	T	13	14	27	0	1	28	0	0
11	19468718	.	A	G	13	12	25	0	2	27	0	0
11	19502433	.	C	T	15	11	26	0	1	27	0	0
11	19502479	.	T	C	15	11	26	0	1	27	0	0
11	19503920	.	T	A	13	15	28	0	0	28	0	0
11	19506155	.	A	G	10	17	27	0	1	28	0	0
11	19506260	.	C	T	5	16	21	0	1	22	0	0
11	19509643	.	T	C	24	17	41	0	1	42	0	0
11	19511392	.	G	A	18	13	31	1	2	34	0	0
11	19511922	.	A	C	3	3	6	0	1	7	0	0
11	19511983	.	G	A	4	5	9	0	0	9	0	0
11	19512285	.	T	C	3	6	9	0	0	9	0	0
11	19512430	.	C	T	0	7	7	0	9	16	0	0
11	19513031	.	C	T	5	2	7	0	0	7	0	0
11	19513033	.	T	A	5	2	7	0	0	7	0	0
11	19513358	.	T	C	3	3	6	0	0	6	0	0
11	19513364	.	T	C	2	1	3	0	3	6	0	0
11	19513395	.	A	G	2	5	7	0	1	8	0	0
11	19604223	.	A	C	7	11	18	0	0	18	0	0
11	19606676	.	T	C	9	9	18	0	2	20	0	0
11	19607131	.	T	C	15	9	24	0	3	27	0	0
11	19625416	.	T	C	36	9	45	0	1	46	0	0
11	19626125	.	C	T	3	2	5	0	0	5	0	0
11	19733388	.	A	G	1	3	4	0	0	4	0	0
11	19951047	.	A	G	0	2	2	0	1	3	0	0
11	19999131	.	T	C	1	2	3	0	0	3	0	0
11	20017802	.	A	G	4	7	11	0	0	11	0	0
11	20058882	.	C	A	6	3	9	0	0	9	0	0
11	20091921	.	G	T	1	4	5	0	0	5	0	0
11	20979901	.	A	C	3	3	6	0	0	6	0	0
11	21156085	.	T	A	4	2	6	0	0	6	0	0
11	21158792	.	G	A	1	3	4	0	0	4	0	0
11	21158858	.	G	A	3	2	5	0	0	5	0	0
11	21173971	.	T	C	1	2	3	0	0	3	0	0
11	21217542	.	T	C	1	2	3	0	0	3	0	0
11	21259435	.	A	C	2	2	4	0	1	5	0	0
11	21259773	.	G	C	9	3	12	0	0	12	0	0
11	21260009	.	T	C	3	3	6	0	0	6	0	0
11	21260018	.	A	T	4	2	6	0	0	6	0	0
11	21260213	.	G	A	2	2	4	0	0	4	0	0
11	21260546	.	G	A	1	2	3	0	1	4	0	0
11	21260676	.	C	T	7	6	13	0	0	13	0	0
11	21260750	.	C	T	4	3	7	0	0	7	0	0
11	21260985	.	A	T	4	2	6	0	0	6	0	0
11	21278950	.	T	A	17	14	31	0	1	32	0	0
11	21279194	.	G	T	22	10	32	0	0	32	0	0
11	21280202	.	A	T	7	11	18	0	1	19	0	0
11	21280504	.	A	C	5	12	17	0	2	19	0	0
11	21280555	.	A	T	3	8	11	0	1	12	0	0
11	21280575	.	G	C	1	3	4	0	0	4	0	0
11	21280689	.	T	A	9	4	13	0	1	14	0	0
11	21280801	.	T	A	6	4	10	0	1	11	0	0
11	21280974	.	G	A	6	3	9	0	1	10	0	0
11	21281087	.	C	T	14	7	21	0	0	21	0	0
11	21281110	.	G	A	19	10	29	0	0	29	0	0
11	21281219	.	G	A	11	4	15	0	3	18	0	0
11	21281269	.	T	C	7	5	12	0	0	12	0	0
11	21281273	.	A	G	9	5	14	0	0	14	0	0
11	21281516	.	G	A	9	7	16	1	1	18	0	0
11	21281774	.	T	C	2	9	11	0	0	11	0	0
11	21281821	.	A	T	1	4	5	0	1	6	0	0
11	21281876	.	T	C	3	3	6	0	0	6	0	0
11	21281878	.	T	C	4	2	6	0	0	6	0	0
11	21281916	.	A	G	0	6	6	0	1	7	0	0
11	21282068	.	G	A	7	4	11	0	1	12	0	0
11	21282072	.	G	A	8	4	12	0	0	12	0	0
11	21282414	.	G	A	2	6	8	0	1	9	0	0
11	21282424	.	C	G	4	6	10	0	1	11	0	0
11	21282500	.	C	A	9	5	14	0	0	14	0	0
11	21282571	.	G	A	6	8	14	0	0	14	0	0
11	21282673	.	G	T	3	12	15	0	1	16	0	0
11	21282747	.	T	C	4	7	11	0	0	11	0	0
11	21282957	.	T	C	9	0	9	0	5	14	0	0
11	21283211	.	G	A	7	3	10	0	0	10	0	0
11	21284382	.	G	A	3	5	8	0	0	8	0	0
11	21284588	.	A	G	3	8	11	0	0	11	0	0
11	21284701	.	A	C	7	0	7	0	8	15	0	0
11	21284733	.	C	T	5	8	13	0	1	14	0	0
11	21323564	.	A	G	4	7	11	0	0	11	0	0
11	21352744	.	G	C	5	3	8	0	0	8	0	0
11	21352773	.	A	T	1	1	2	0	1	3	0	0
11	21363229	.	T	C	2	3	5	0	0	5	0	0
11	21364957	.	T	A	1	2	3	0	0	3	0	0
11	21407500	.	G	A	5	8	13	0	2	15	0	0
11	21407692	.	C	G	14	17	31	0	1	32	0	0
11	21407782	.	G	T	13	8	21	0	3	24	0	0
11	21409415	.	A	T	11	7	18	0	4	22	0	0
11	21409417	.	T	C	11	10	21	0	0	21	0	0
11	21427219	.	T	C	3	3	6	0	0	6	0	0
11	21434465	.	G	A	1	2	3	0	0	3	0	0
11	21593849	.	A	T	3	3	6	0	0	6	0	0
11	21593869	.	G	C	2	2	4	0	0	4	0	0
11	21594510	.	C	T	1	3	4	0	0	4	0	0
11	21594552	.	G	A	1	3	4	0	0	4	0	0
11	21595189	.	G	A	3	4	7	0	0	7	0	0
11	21595191	.	G	A	0	4	4	0	3	7	0	0
11	21595615	.	G	A	1	2	3	0	0	3	0	0
11	21596492	.	A	G	4	0	4	0	4	8	0	0
11	21597166	.	A	G	11	0	11	0	9	20	0	0
11	21597584	.	T	C	5	10	15	0	0	15	0	0
11	21597659	.	T	C	3	5	8	0	1	9	0	0
11	21597676	.	C	A	4	5	9	0	1	10	0	0
11	21597702	.	A	G	2	4	6	0	0	6	0	0
11	21597754	.	T	G	3	4	7	0	0	7	0	0
11	21597988	.	C	T	8	5	13	0	0	13	0	0
11	21598002	.	T	C	6	3	9	0	2	11	0	0
11	21598036	.	T	C	5	7	12	0	0	12	0	0
11	21598121	.	G	A	1	7	8	0	9	17	0	0
11	22091956	.	C	A	9	14	23	0	3	26	0	0
11	22092158	.	G	A	15	14	29	1	0	30	0	0
11	22092244	.	A	T	15	8	23	0	0	23	0	0
11	22092689	.	T	A	6	7	13	0	1	14	0	0
11	22092743	.	T	A	3	4	7	0	0	7	0	0
11	22093634	.	G	A	19	19	38	0	2	40	0	0
11	22093848	.	A	C	16	16	32	0	2	34	0	0
11	22094072	.	T	C	9	17	26	0	5	31	0	0
11	22289589	.	A	C	1	3	4	0	0	4	0	0
11	22363756	.	A	T	12	11	23	0	1	24	0	0
11	22363768	.	A	T	11	10	21	0	1	22	0	0
11	22363994	.	T	G	16	6	22	0	0	22	0	0
11	22364128	.	A	T	9	6	15	0	0	15	0	0
11	22364140	.	T	A	9	7	16	0	0	16	0	0
11	22364228	.	G	A	9	8	17	0	0	17	0	0
11	22364359	.	A	G	5	6	11	0	0	11	0	0
11	22364416	.	A	G	6	10	16	0	0	16	0	0
11	22364502	.	C	A	0	8	8	0	9	17	0	0
11	22364558	.	T	C	6	5	11	0	0	11	0	0
11	22366841	.	T	C	17	11	28	0	0	28	0	0
11	22367200	.	A	T	15	7	22	0	2	25	1	0
11	22367251	.	A	G	16	12	28	0	1	29	0	0
11	22369932	.	G	A	9	3	12	0	1	13	0	0
11	22369981	.	A	G	16	6	22	0	0	22	0	0
11	22369991	.	C	A	17	8	25	0	0	25	0	0
11	22371944	.	T	G	2	8	10	0	0	10	0	0
11	22371990	.	T	G	2	4	6	0	1	7	0	0
11	22374890	.	G	A	0	2	2	0	4	6	0	0
11	22495182	.	T	C	3	2	5	0	1	6	0	0
11	22505058	.	T	C	5	2	7	0	1	8	0	0
11	22582243	.	G	C	1	2	3	0	3	6	0	0
11	22582607	.	T	C	1	4	5	0	0	5	0	0
11	22582706	.	T	C	6	5	11	0	0	11	0	0
11	22582739	.	A	T	8	6	14	0	0	14	0	0
11	22582773	.	G	A	2	4	6	0	10	16	0	0
11	22582830	.	T	C	7	4	11	0	0	11	0	0
11	22582878	.	A	G	7	3	10	0	0	10	0	0
11	22582923	.	C	T	4	4	8	0	1	9	0	0
11	22583139	.	G	T	7	2	9	0	0	9	0	0
11	22583547	.	G	T	13	3	16	0	0	16	0	0
11	22583759	.	T	C	6	5	11	0	0	11	0	0
11	22583858	.	C	A	12	6	18	0	1	19	0	0
11	22583974	.	T	C	6	6	12	0	0	12	0	0
11	22583984	.	T	C	7	5	12	0	0	12	0	0
11	22584173	.	G	A	10	8	18	0	0	18	0	0
11	22584229	.	T	C	9	9	18	0	0	18	0	0
11	22584365	.	G	A	9	2	11	0	2	13	0	0
11	22623334	.	T	A	2	4	6	0	0	6	0	0
11	22623502	.	T	G	2	3	5	0	0	5	0	0
11	22624550	.	A	G	4	6	10	0	0	10	0	0
11	22624777	.	C	A	2	5	7	0	0	7	0	0
11	22624778	.	C	A	2	5	7	0	0	7	0	0
11	22629148	.	C	A	3	5	8	0	0	8	0	0
11	22630190	.	T	A	5	3	8	0	0	8	0	0
11	22630252	.	G	T	5	2	7	0	0	7	0	0
11	22891305	.	C	G	17	17	34	0	0	34	0	0
11	22891574	.	G	A	27	7	34	0	2	36	0	0
11	22891575	.	T	C	21	0	21	0	16	37	0	0
11	22891624	.	C	T	23	12	35	0	1	36	0	0
11	22891683	.	G	A	27	21	48	0	0	48	0	0
11	22891692	.	C	T	1	21	22	0	25	47	0	0
11	22892028	.	C	T	14	14	28	0	1	29	0	0
11	22892205	.	A	G	20	23	43	0	1	44	0	0
11	22892345	.	C	A	2	11	13	0	9	22	0	0
11	22892395	.	G	A	18	11	29	0	0	29	0	0
11	22892432	.	C	T	20	5	25	0	1	26	0	0
11	22892534	.	G	A	16	13	29	0	1	30	0	0
11	22892573	.	G	A	18	16	34	0	1	35	0	0
11	22892859	.	A	T	17	10	27	0	1	28	0	0
11	22906133	.	T	G	16	13	29	0	0	29	0	0
11	22906383	.	T	C	7	11	18	0	0	18	0	0
11	22911841	.	C	G	6	5	11	0	2	13	0	0
11	22920796	.	T	A	17	17	34	0	0	34	0	0
11	22921124	.	G	T	33	25	58	0	3	61	0	0
11	22921168	.	C	T	36	26	62	0	5	67	0	0
11	22921326	.	G	A	23	20	43	0	3	46	0	0
11	22921568	.	G	C	28	29	57	0	2	59	0	0
11	22921800	.	T	G	22	21	43	0	3	46	0	0
11	22921865	.	T	C	30	2	32	0	26	58	0	0
11	22921953	.	C	T	16	21	37	0	3	40	0	0
11	22922075	.	A	G	31	16	47	0	3	50	0	0
11	22922114	.	A	T	28	19	47	0	3	50	0	0
11	22922115	.	A	T	28	20	48	0	1	49	0	0
11	22922251	.	C	T	24	22	46	0	1	47	0	0
11	22922266	.	A	G	21	24	45	0	3	48	0	0
11	22922290	.	A	G	21	20	41	0	4	45	0	0
11	22922309	.	T	A	21	25	46	0	2	48	0	0
11	22922333	.	A	T	24	27	51	0	1	52	0	0
11	22922355	.	A	T	25	21	46	0	2	48	0	0
11	22922405	.	G	A	20	21	41	0	1	42	0	0
11	22922668	.	T	C	19	31	50	0	4	54	0	0
11	22922762	.	T	A	28	19	47	0	2	49	0	0
11	22922841	.	C	A	24	18	42	1	1	44	0	0
11	22922909	.	A	T	26	13	39	0	1	40	0	0
11	22923397	.	A	T	22	14	36	0	1	37	0	0
11	22923485	.	G	T	26	21	47	0	4	51	0	0
11	22923613	.	T	C	23	2	25	0	22	47	0	0
11	22924449	.	C	T	14	10	24	0	1	26	1	0
11	22924505	.	A	C	11	7	18	0	0	18	0	0
11	22924650	.	A	C	11	9	20	0	1	21	0	0
11	22924746	.	C	T	2	14	16	0	4	20	0	0
11	22925048	.	G	A	3	8	11	0	1	12	0	0
11	22925266	.	G	A	17	13	30	0	2	32	0	0
11	22925370	.	A	G	27	12	39	0	3	42	0	0
11	22926213	.	A	C	9	0	9	0	13	22	0	0
11	22950984	.	C	T	16	11	27	0	0	27	0	0
11	22964006	.	G	T	12	11	23	0	1	24	0	0
11	22969056	.	T	C	6	0	6	0	3	9	0	0
11	22984008	.	G	A	1	2	3	0	0	3	0	0
11	22995813	.	A	G	1	3	4	0	1	5	0	0
11	23312451	.	T	A	8	3	11	0	0	11	0	0
11	23312543	.	G	A	4	5	9	0	1	10	0	0
11	23312583	.	G	T	6	2	8	0	0	8	0	0
11	23313911	.	G	A	10	3	13	0	0	13	0	0
11	23313928	.	T	C	10	5	15	0	1	16	0	0
11	23343154	.	A	G	8	19	27	0	1	28	0	0
11	23343231	.	G	A	10	9	19	2	2	23	0	0
11	23343594	.	T	A	11	10	21	0	0	21	0	0
11	23343775	.	A	G	9	8	17	0	0	17	0	0
11	23344143	.	C	A	14	7	21	0	0	21	0	0
11	23344421	.	G	C	12	10	22	0	2	24	0	0
11	23344790	.	T	A	12	9	21	0	1	22	0	0
11	23352194	.	C	T	8	12	20	0	1	21	0	0
11	23353706	.	C	T	3	2	5	0	0	5	0	0
11	23377379	.	A	G	4	2	6	0	1	7	0	0
11	23595538	.	G	T	8	4	12	0	0	12	0	0
11	23595627	.	C	T	5	11	16	0	1	17	0	0
11	23595766	.	C	A	8	13	21	0	0	21	0	0
11	23596240	.	A	G	12	9	21	0	1	22	0	0
11	23596264	.	G	T	10	5	15	0	1	16	0	0
11	23596333	.	T	C	11	15	26	0	0	26	0	0
11	23596477	.	A	C	4	0	4	0	1	5	0	0
11	23596725	.	T	C	9	11	20	0	0	20	0	0
11	23596732	.	A	T	8	13	21	0	0	21	0	0
11	23597047	.	G	A	3	2	5	0	0	5	0	0
11	23597310	.	A	G	4	8	12	0	2	14	0	0
11	23597589	.	C	T	0	6	6	0	3	9	0	0
11	23604921	.	T	C	3	5	8	0	0	8	0	0
11	23604954	.	A	G	3	4	7	0	1	8	0	0
11	23843362	.	A	G	2	3	5	0	0	5	0	0
11	23845323	.	C	T	3	2	5	0	1	6	0	0
11	23845329	.	C	A	2	3	5	0	1	6	0	0
11	23856440	.	A	G	2	6	8	0	0	8	0	0
11	23879654	.	C	A	11	11	22	0	0	22	0	0
11	23879825	.	A	T	7	7	14	0	1	15	0	0
11	23880084	.	T	C	9	9	18	1	0	19	0	0
11	23880476	.	T	G	8	3	11	0	0	11	0	0
11	23880486	.	G	T	8	8	16	0	0	16	0	0
11	23880607	.	C	T	4	9	13	0	2	15	0	0
11	23880631	.	G	T	7	5	12	0	2	14	0	0
11	23881038	.	C	A	1	5	6	0	1	7	0	0
11	23881070	.	C	T	6	7	13	0	2	15	0	0
11	23881101	.	G	A	8	6	14	0	1	15	0	0
11	23881131	.	G	C	8	4	12	0	0	12	0	0
11	23881152	.	G	A	0	9	9	0	6	15	0	0
11	23881238	.	A	T	1	5	6	0	0	6	0	0
11	23881247	.	A	T	1	3	4	0	0	4	0	0
11	23881683	.	A	T	2	3	5	0	0	5	0	0
11	23881719	.	T	A	3	3	6	0	0	6	0	0
11	23881784	.	G	A	3	2	5	0	0	5	0	0
11	23881866	.	A	G	5	7	12	0	1	13	0	0
11	23882525	.	T	C	10	9	19	0	0	20	1	0
11	23882572	.	A	T	15	8	23	0	1	24	0	0
11	23882646	.	A	T	11	16	27	0	1	28	0	0
11	23882655	.	C	T	16	12	28	0	3	31	0	0
11	23882747	.	C	T	18	13	31	1	0	32	0	0
11	23882748	.	C	T	16	13	29	1	1	31	0	0
11	23882836	.	A	G	14	8	22	0	3	25	0	0
11	23883302	.	G	A	8	11	19	0	0	19	0	0
11	23883699	.	A	T	15	5	20	0	0	20	0	0
11	23884416	.	G	A	31	18	49	0	2	51	0	0
11	23884419	.	T	A	20	29	49	0	1	50	0	0
11	23884742	.	G	A	16	17	33	0	1	34	0	0
11	23976169	.	C	T	4	6	10	0	0	10	0	0
11	24035841	.	G	T	0	10	10	0	4	14	0	0
11	24036035	.	C	T	6	6	12	0	0	12	0	0
11	24038115	.	A	G	9	9	18	0	1	19	0	0
11	24038795	.	T	G	7	15	22	0	1	23	0	0
11	24039086	.	A	G	18	11	29	0	4	33	0	0
11	24039241	.	A	G	18	0	18	0	25	43	0	0
11	24039246	.	T	G	21	18	39	0	3	42	0	0
11	24039728	.	G	A	18	11	29	0	0	29	0	0
11	24039732	.	C	T	17	10	27	0	3	30	0	0
11	24039773	.	A	C	19	10	29	0	0	29	0	0
11	24039791	.	A	C	17	15	32	0	3	35	0	0
11	24039912	.	T	C	16	14	30	0	2	32	0	0
11	24039949	.	C	A	15	12	27	0	1	29	1	0
11	24043500	.	C	T	9	13	22	0	4	26	0	0
11	24044318	.	G	T	19	15	34	0	1	35	0	0
11	24044351	.	C	T	13	10	23	0	2	25	0	0
11	24044413	.	T	A	12	6	18	0	0	18	0	0
11	24046235	.	C	T	5	2	7	0	2	9	0	0
11	24050607	.	G	A	4	10	14	0	1	15	0	0
11	24054530	.	T	G	1	2	3	0	1	4	0	0
11	24055699	.	A	T	11	4	15	0	1	16	0	0
11	24055884	.	A	G	10	0	10	0	15	25	0	0
11	24056205	.	C	T	15	18	33	0	0	33	0	0
11	24056377	.	G	C	23	12	35	0	5	40	0	0
11	24058749	.	G	A	9	5	14	0	1	15	0	0
11	24058963	.	G	A	8	8	16	0	1	17	0	0
11	24059236	.	T	A	3	4	7	0	0	7	0	0
11	24059268	.	G	A	5	5	10	0	0	10	0	0
11	24059476	.	A	T	4	5	9	0	1	10	0	0
11	24059630	.	C	A	2	2	4	0	0	4	0	0
11	24059873	.	A	T	2	6	8	0	0	8	0	0
11	24060014	.	C	G	6	4	10	0	0	10	0	0
11	24187748	.	A	G	8	3	11	0	1	12	0	0
11	24188088	.	G	T	8	16	24	0	2	26	0	0
11	24188221	.	C	T	1	5	6	0	9	15	0	0
11	24188227	.	G	T	6	8	14	0	0	14	0	0
11	24188385	.	T	A	11	5	16	0	0	16	0	0
11	24188436	.	T	A	17	6	23	0	1	24	0	0
11	24188437	.	G	T	16	6	22	0	2	24	0	0
11	24188884	.	C	T	0	7	7	1	6	14	0	0
11	24189765	.	G	A	10	4	14	0	1	15	0	0
11	24189811	.	G	C	3	10	13	0	0	13	0	0
11	24190606	.	C	T	5	4	9	0	0	9	0	0
11	24190989	.	A	T	1	4	5	0	0	5	0	0
11	24330791	.	G	T	2	4	6	0	1	7	0	0
11	24340745	.	T	A	8	7	15	0	1	16	0	0
11	24340931	.	G	A	4	3	7	1	1	9	0	0
11	24343537	.	T	C	26	14	40	0	0	40	0	0
11	24344983	.	T	G	23	13	36	0	3	39	0	0
11	24360891	.	C	G	2	3	5	0	0	5	0	0
11	24360924	.	A	G	3	8	11	0	0	11	0	0
11	24361207	.	T	G	2	4	6	0	0	6	0	0
11	24369398	.	G	A	3	2	5	0	0	5	0	0
11	24369586	.	A	G	4	4	8	0	1	9	0	0
11	24379360	.	C	T	3	3	6	0	0	6	0	0
11	24379384	.	G	A	2	4	6	0	0	6	0	0
11	24382547	.	C	T	0	2	2	0	1	3	0	0
11	24471518	.	C	T	1	6	7	0	6	13	0	0
11	24472065	.	A	G	1	2	3	0	1	4	0	0
11	24472145	.	T	A	4	3	7	0	0	7	0	0
11	24472176	.	A	G	5	4	9	0	1	10	0	0
11	24474181	.	G	A	3	3	6	0	1	7	0	0
11	24474384	.	G	A	6	5	11	0	0	11	0	0
11	24474483	.	A	C	3	4	7	0	0	7	0	0
11	24478940	.	G	A	4	2	6	0	0	6	0	0
11	24645757	.	T	C	1	4	5	0	1	6	0	0
11	24658281	.	G	A	4	2	6	0	0	6	0	0
11	24658335	.	T	C	3	5	8	0	0	8	0	0
11	24658606	.	G	A	2	11	13	0	3	16	0	0
11	24658696	.	C	T	7	10	17	0	0	17	0	0
11	24662794	.	A	G	3	0	3	0	6	9	0	0
11	24662898	.	C	A	6	9	15	0	0	15	0	0
11	24663074	.	C	A	3	2	5	0	0	5	0	0
11	24663768	.	G	A	2	5	7	0	0	7	0	0
11	24663808	.	T	C	3	8	11	0	1	12	0	0
11	24672571	.	C	T	1	4	5	0	3	8	0	0
11	24747901	.	A	G	1	2	3	0	2	5	0	0
11	24748102	.	C	T	1	6	7	0	0	7	0	0
11	24782271	.	G	A	1	4	5	0	2	7	0	0
11	24786466	.	T	A	5	2	7	0	0	7	0	0
11	24789357	.	C	G	4	4	8	0	0	8	0	0
11	24792102	.	T	A	4	12	16	0	1	17	0	0
11	24792201	.	G	A	5	5	10	0	1	11	0	0
11	24796820	.	T	G	14	0	14	0	16	30	0	0
11	24799378	.	G	A	14	9	23	0	1	24	0	0
11	24799408	.	G	A	2	7	9	0	8	17	0	0
11	24799433	.	T	G	6	4	10	0	0	10	0	0
11	24799495	.	T	A	4	2	6	0	0	6	0	0
11	24804565	.	A	T	6	11	17	0	1	18	0	0
11	24805106	.	A	C	8	3	11	0	3	14	0	0
11	24807966	.	A	G	7	10	17	0	3	20	0	0
11	24809738	.	C	T	21	14	35	0	5	41	1	0
11	24810510	.	C	A	13	17	30	0	2	32	0	0
11	24813651	.	G	A	11	12	23	0	3	26	0	0
11	24813810	.	A	G	20	19	39	0	0	39	0	0
11	24814014	.	A	G	17	19	36	0	2	38	0	0
11	24814110	.	G	T	13	21	34	0	3	37	0	0
11	24816471	.	C	T	4	3	7	0	0	7	0	0
11	24816472	.	C	T	4	3	7	0	0	7	0	0
11	24816648	.	G	A	3	3	6	0	1	7	0	0
11	24817054	.	T	A	5	9	14	0	1	15	0	0
11	24817198	.	G	A	5	2	7	0	0	7	0	0
11	24817207	.	C	T	4	2	6	0	0	6	0	0
11	24819667	.	C	T	7	6	13	0	0	13	0	0
11	24823323	.	G	A	0	5	5	0	2	7	0	0
11	24825549	.	C	T	3	6	9	0	1	10	0	0
11	24825583	.	G	A	3	4	7	0	0	7	0	0
11	24825598	.	C	T	3	3	6	0	0	6	0	0
11	24833382	.	G	A	3	2	5	0	0	5	0	0
11	24835762	.	A	C	7	7	14	0	0	14	0	0
11	24835764	.	A	G	7	7	14	0	0	14	0	0
11	24836409	.	C	T	8	3	11	0	0	11	0	0
11	24843031	.	C	A	8	6	14	0	1	15	0	0
11	24843058	.	G	A	1	3	4	0	6	10	0	0
11	24843079	.	A	G	5	0	5	0	4	9	0	0
11	24843154	.	G	A	0	8	8	0	2	10	0	0
11	24843219	.	C	T	4	5	9	0	0	9	0	0
11	24848221	.	T	A	13	19	32	0	0	32	0	0
11	24848409	.	G	T	16	17	33	0	1	34	0	0
11	24850428	.	A	G	14	12	26	0	3	29	0	0
11	24851182	.	A	T	11	11	22	0	3	25	0	0
11	24869046	.	G	A	2	4	6	0	0	6	0	0
11	24874841	.	A	G	7	4	11	0	2	13	0	0
11	24875331	.	T	C	11	6	17	0	0	17	0	0
11	24875382	.	G	C	5	4	9	0	0	9	0	0
11	24878011	.	C	T	4	2	6	0	0	6	0	0
11	24884840	.	G	C	13	5	18	0	0	18	0	0
11	24884967	.	C	T	11	6	17	0	2	19	0	0
11	24885282	.	T	C	6	4	10	0	1	11	0	0
11	24885332	.	C	T	6	3	9	0	0	9	0	0
11	24885357	.	A	T	8	3	11	0	0	11	0	0
11	24885682	.	A	G	1	2	3	0	0	3	0	0
11	24885734	.	T	C	3	2	5	0	1	6	0	0
11	24885738	.	A	G	3	1	4	0	1	5	0	0
11	24885810	.	A	C	3	3	6	0	0	6	0	0
11	24885901	.	A	T	10	3	13	0	0	13	0	0
11	24885928	.	C	T	9	5	14	0	1	15	0	0
11	24885937	.	C	T	8	4	12	0	1	13	0	0
11	24886152	.	C	A	14	18	32	1	0	33	0	0
11	24886499	.	T	A	5	3	8	0	0	8	0	0
11	24886602	.	G	T	1	6	7	0	6	13	0	0
11	24886672	.	T	C	7	12	19	0	2	21	0	0
11	24886686	.	G	T	14	5	19	0	1	20	0	0
11	24886739	.	G	T	13	9	22	0	0	22	0	0
11	24886754	.	G	A	13	9	22	0	0	22	0	0
11	24887321	.	T	C	21	10	31	0	2	33	0	0
11	24887501	.	C	T	14	12	26	0	1	27	0	0
11	24887523	.	A	G	10	7	17	0	1	18	0	0
11	24887703	.	C	T	6	9	15	0	4	19	0	0
11	24888272	.	C	T	13	10	23	0	0	23	0	0
11	24888379	.	C	A	14	22	36	0	0	36	0	0
11	24888560	.	A	T	4	7	11	0	1	12	0	0
11	24901897	.	C	T	21	19	40	0	2	42	0	0
11	24902157	.	A	T	19	23	42	0	6	48	0	0
11	24903143	.	G	T	22	20	42	0	0	43	1	0
11	24905477	.	C	T	27	22	49	0	1	50	0	0
11	24905526	.	G	T	24	13	37	0	0	37	0	0
11	24905541	.	C	T	21	13	34	0	1	35	0	0
11	24905574	.	G	A	21	16	37	0	2	39	0	0
11	24905576	.	C	A	23	16	39	0	1	40	0	0
11	24905632	.	T	G	19	22	41	0	0	41	0	0
11	24905692	.	G	A	1	13	14	0	34	48	0	0
11	24905742	.	C	T	31	13	44	0	1	45	0	0
11	24905748	.	A	G	27	15	42	0	1	43	0	0
11	24906177	.	G	T	7	16	23	0	0	23	0	0
11	24906178	.	G	A	7	16	23	0	0	23	0	0
11	24966841	.	G	A	0	2	2	0	1	3	0	0
11	24978597	.	C	T	5	2	7	0	0	7	0	0
11	24980684	.	C	T	3	3	6	0	0	6	0	0
11	24980714	.	A	C	5	2	7	0	1	8	0	0
11	24981190	.	A	T	3	4	7	0	0	7	0	0
11	24987085	.	T	C	6	4	10	0	2	12	0	0
11	24987226	.	C	T	5	10	15	0	0	15	0	0
11	24992298	.	A	G	12	6	18	0	0	18	0	0
11	24992445	.	T	A	12	15	27	0	0	27	0	0
11	24992522	.	T	G	7	0	7	0	9	16	0	0
11	24992539	.	G	C	13	11	24	0	1	25	0	0
11	24992899	.	C	A	12	10	22	0	0	22	0	0
11	24992928	.	G	A	10	6	16	0	0	16	0	0
11	24994833	.	A	C	2	5	7	0	0	7	0	0
11	25025783	.	T	G	8	4	12	0	0	12	0	0
11	25026004	.	C	G	8	4	12	0	1	13	0	0
11	25026437	.	A	G	7	6	13	0	0	13	0	0
11	25026450	.	A	T	8	8	16	0	0	16	0	0
11	25031086	.	T	A	8	9	17	0	0	17	0	0
11	25031272	.	A	C	11	11	22	0	0	22	0	0
11	25031362	.	C	T	10	6	16	0	1	17	0	0
11	25031497	.	A	T	12	9	21	0	1	22	0	0
11	25031527	.	G	A	9	13	22	0	1	23	0	0
11	25035439	.	C	T	14	6	20	0	0	20	0	0
11	25036942	.	C	T	16	5	21	0	0	21	0	0
11	25037017	.	C	T	14	13	27	0	2	29	0	0
11	25038572	.	T	C	14	13	27	0	0	27	0	0
11	25038625	.	G	C	12	11	23	0	1	24	0	0
11	25038652	.	G	A	1	11	12	0	11	23	0	0
11	25040808	.	A	T	6	13	19	0	4	23	0	0
11	25041204	.	C	T	11	8	19	0	1	20	0	0
11	25041607	.	G	C	2	27	29	0	14	43	0	0
11	25053236	.	C	T	3	3	6	0	0	6	0	0
11	25053820	.	G	A	1	2	3	0	0	3	0	0
11	25053952	.	G	A	2	4	6	0	0	6	0	0
11	25054092	.	G	A	2	5	7	0	0	7	0	0
11	25054095	.	G	A	2	5	7	0	0	7	0	0
11	25059156	.	T	A	1	5	6	0	0	6	0	0
11	25061104	.	G	A	1	6	7	0	1	8	0	0
11	25062285	.	A	G	4	2	6	0	0	6	0	0
11	25062296	.	A	C	5	2	7	0	0	7	0	0
11	25062382	.	T	A	1	2	3	0	0	3	0	0
11	25062395	.	A	C	1	2	3	0	0	3	0	0
11	25062499	.	T	C	3	2	5	0	0	5	0	0
11	25062793	.	A	G	4	1	5	0	1	6	0	0
11	25062795	.	A	G	3	2	5	0	1	6	0	0
11	25062949	.	A	C	1	4	5	0	0	5	0	0
11	25062973	.	T	G	1	3	4	0	0	4	0	0
11	25063054	.	A	C	2	3	5	0	0	5	0	0
11	25063080	.	G	A	2	3	5	0	0	5	0	0
11	25063291	.	A	T	3	5	8	0	0	8	0	0
11	25063293	.	T	C	4	5	9	0	0	9	0	0
11	25064623	.	C	G	12	6	18	0	1	19	0	0
11	25101665	.	C	T	17	6	23	0	1	24	0	0
11	25129232	.	C	G	37	0	37	0	30	67	0	0
11	25132510	.	T	C	35	39	74	0	3	77	0	0
11	25138485	.	A	C	32	34	66	0	7	73	0	0
11	25138656	.	T	C	48	27	75	1	7	83	0	0
11	25138673	.	T	A	41	28	69	0	1	70	0	0
11	25138845	.	C	T	30	36	66	0	10	76	0	0
11	25139000	.	G	C	28	22	50	0	1	51	0	0
11	25167856	.	T	C	3	2	5	0	0	5	0	0
11	25169680	.	G	A	1	4	5	0	0	5	0	0
11	25169704	.	T	C	4	2	6	0	0	6	0	0
11	25169749	.	G	A	0	3	3	0	3	6	0	0
11	25178862	.	C	T	10	6	16	0	2	18	0	0
11	25178865	.	T	A	8	7	15	0	1	16	0	0
11	25179014	.	C	T	7	7	14	0	1	15	0	0
11	25179057	.	A	C	5	7	12	0	0	12	0	0
11	25179069	.	A	G	5	4	9	0	1	10	0	0
11	25179099	.	C	T	7	6	13	0	0	13	0	0
11	25179365	.	G	T	2	2	4	0	4	8	0	0
11	25179430	.	T	A	4	8	12	0	0	12	0	0
11	25179641	.	C	T	11	7	18	0	0	18	0	0
11	25179659	.	A	T	14	9	23	0	0	23	0	0
11	25180225	.	C	T	2	6	8	0	0	8	0	0
11	25180243	.	A	G	3	5	8	0	0	8	0	0
11	25260187	.	C	T	8	19	27	1	1	29	0	0
11	25261660	.	T	A	3	3	6	0	2	8	0	0
11	25265777	.	G	A	3	13	16	0	8	24	0	0
11	25265950	.	T	C	12	17	29	0	1	30	0	0
11	25302183	.	C	T	9	6	15	0	0	15	0	0
11	25303803	.	C	T	6	5	11	0	1	12	0	0
11	25303887	.	T	C	7	13	20	0	2	22	0	0
11	25306433	.	T	C	5	6	11	0	0	11	0	0
11	25307345	.	T	C	14	14	28	1	1	30	0	0
11	25310329	.	G	C	9	13	22	0	0	22	0	0
11	25310777	.	T	G	7	9	16	0	2	18	0	0
11	25310859	.	A	T	13	14	27	0	2	29	0	0
11	25311276	.	A	G	21	15	36	1	0	37	0	0
11	25313916	.	C	T	0	4	4	0	2	6	0	0
11	25314910	.	C	T	13	7	20	0	0	20	0	0
11	25318295	.	G	A	2	2	4	0	0	4	0	0
11	25403825	.	A	G	4	2	6	0	1	7	0	0
11	25403830	.	A	T	3	2	5	0	1	6	0	0
11	25405910	.	C	T	1	7	8	0	0	8	0	0
11	25406186	.	T	C	3	6	9	0	0	9	0	0
11	25406343	.	A	G	4	9	13	0	0	13	0	0
11	25406366	.	T	G	5	0	5	0	9	14	0	0
11	25406381	.	C	T	5	10	15	0	0	15	0	0
11	25406534	.	C	T	5	4	9	0	0	9	0	0
11	25407014	.	G	A	2	5	7	0	1	8	0	0
11	25407380	.	C	T	10	7	17	0	0	17	0	0
11	25407626	.	T	C	8	7	15	0	0	15	0	0
11	25407987	.	A	T	9	12	21	0	0	21	0	0
11	25408139	.	C	T	21	14	35	0	0	35	0	0
11	25408283	.	C	G	8	15	23	0	2	25	0	0
11	25408352	.	T	C	12	6	18	0	2	20	0	0
11	25436813	.	G	C	3	4	7	0	0	7	0	0
11	25436961	.	T	A	13	17	30	0	1	31	0	0
11	25437080	.	C	T	15	11	26	0	2	28	0	0
11	25437299	.	C	T	18	12	30	0	1	31	0	0
11	25437417	.	C	T	10	25	35	0	0	35	0	0
11	25437684	.	G	A	11	9	20	0	2	22	0	0
11	25437866	.	T	G	8	12	20	0	1	21	0	0
11	25437901	.	G	A	13	13	26	0	0	26	0	0
11	25439860	.	G	T	11	9	20	0	2	22	0	0
11	25440511	.	G	A	8	9	17	0	2	19	0	0
11	25440649	.	G	C	6	0	6	0	6	12	0	0
11	25442057	.	A	C	4	1	5	0	3	8	0	0
11	25442096	.	C	T	8	4	12	0	0	12	0	0
11	25442147	.	G	T	6	4	10	0	0	10	0	0
11	25442313	.	A	G	6	4	10	0	1	11	0	0
11	25442424	.	A	G	6	6	12	0	0	12	0	0
11	25442457	.	G	T	5	3	8	0	0	8	0	0
11	25449437	.	T	A	4	3	7	0	0	7	0	0
11	25487730	.	G	A	1	2	3	0	1	4	0	0
11	25540580	.	G	C	2	4	6	0	0	6	0	0
11	25540583	.	G	A	0	4	4	0	2	6	0	0
11	25542320	.	A	T	2	2	4	0	1	5	0	0
11	25548043	.	G	T	1	9	10	0	13	23	0	0
11	25550770	.	C	G	2	2	4	0	0	4	0	0
11	25560159	.	A	T	4	4	8	0	0	8	0	0
11	25565778	.	A	T	1	2	3	0	1	4	0	0
11	25565823	.	A	G	2	0	2	0	2	4	0	0
11	25565876	.	T	A	3	2	5	0	0	5	0	0
11	25565892	.	T	C	3	3	6	0	0	6	0	0
11	25570711	.	A	C	3	5	8	0	0	8	0	0
11	25572090	.	G	A	2	5	7	0	0	7	0	0
11	25573888	.	T	A	9	5	14	0	0	15	1	0
11	25573921	.	T	A	4	5	9	0	1	10	0	0
11	25575139	.	A	G	6	11	17	0	0	17	0	0
11	25575365	.	C	T	3	4	7	0	1	8	0	0
11	25575725	.	A	T	8	6	14	0	0	14	0	0
11	25575872	.	A	G	9	0	9	0	13	22	0	0
11	25616095	.	G	A	4	7	11	0	0	11	0	0
11	25617944	.	A	G	9	12	21	0	2	23	0	0
11	25618218	.	C	T	9	7	16	0	0	16	0	0
11	25618353	.	T	A	6	12	18	0	0	18	0	0
11	25618408	.	C	T	7	6	13	0	0	13	0	0
11	25630136	.	T	G	1	2	3	0	0	3	0	0
11	25630660	.	C	T	8	7	15	0	0	15	0	0
11	25631050	.	T	G	10	1	11	0	6	17	0	0
11	25631296	.	A	G	1	4	5	0	0	5	0	0
11	25631310	.	C	T	2	4	6	0	0	6	0	0
11	25668729	.	C	A	2	4	6	0	0	6	0	0
11	25668776	.	T	C	2	2	4	0	0	4	0	0
11	25668782	.	G	A	0	2	2	0	2	4	0	0
11	25678671	.	C	T	4	4	8	0	0	8	0	0
11	25678793	.	C	T	2	3	5	1	0	6	0	0
11	25678971	.	T	A	2	5	7	0	2	9	0	0
11	25679010	.	A	T	2	6	8	0	1	9	0	0
11	25681340	.	C	T	4	2	6	0	0	6	0	0
11	25681594	.	C	T	6	7	13	0	0	13	0	0
11	25681602	.	C	A	6	6	12	0	0	12	0	0
11	25681659	.	G	A	0	3	3	0	4	7	0	0
11	25681677	.	G	A	1	3	4	0	4	8	0	0
11	25681863	.	C	T	5	1	6	0	0	6	0	0
11	25684396	.	C	T	5	4	9	0	1	10	0	0
11	25686079	.	T	A	5	21	26	0	1	27	0	0
11	25689209	.	T	C	12	10	22	0	2	24	0	0
11	25689233	.	G	C	10	12	22	0	2	24	0	0
11	25689551	.	T	C	7	8	15	0	0	15	0	0
11	25689561	.	T	A	9	5	14	0	0	14	0	0
11	25695643	.	T	C	1	7	8	0	0	8	0	0
11	25695724	.	C	A	2	2	4	0	1	5	0	0
11	25695733	.	C	T	1	2	3	0	1	4	0	0
11	25698776	.	G	C	1	2	3	0	0	3	0	0
11	25698917	.	C	T	2	2	4	0	1	5	0	0
11	25699406	.	G	A	1	4	5	0	1	6	0	0
11	25699505	.	C	A	5	4	9	0	2	11	0	0
11	25702397	.	C	T	11	9	20	0	1	21	0	0
11	25705225	.	C	T	9	5	14	0	1	15	0	0
11	25713028	.	A	G	3	7	10	0	0	10	0	0
11	25713124	.	T	A	8	4	12	0	0	12	0	0
11	25713361	.	T	A	10	4	14	0	2	16	0	0
11	25713362	.	T	A	10	5	15	0	2	17	0	0
11	25713526	.	A	G	3	7	10	0	1	11	0	0
11	25713683	.	G	A	3	5	8	0	1	9	0	0
11	25713725	.	T	A	5	7	12	0	0	12	0	0
11	25713727	.	A	C	8	4	12	0	0	12	0	0
11	25713842	.	T	A	6	5	11	0	0	11	0	0
11	25713871	.	T	C	6	5	11	0	0	11	0	0
11	25713913	.	T	C	1	4	5	0	1	6	0	0
11	25714148	.	G	A	1	8	9	0	2	11	0	0
11	25714425	.	G	T	6	3	9	0	0	9	0	0
11	25714441	.	C	A	2	6	8	0	1	9	0	0
11	25718194	.	C	T	6	7	13	0	0	13	0	0
11	25718438	.	T	G	4	7	11	0	0	11	0	0
11	25721865	.	C	T	4	5	9	0	0	9	0	0
11	25743116	.	C	T	5	4	9	0	0	9	0	0
11	25743158	.	C	T	5	3	8	0	1	9	0	0
11	25743414	.	G	A	7	8	15	0	1	16	0	0
11	25743531	.	G	A	0	5	5	0	10	15	0	0
11	25748876	.	A	G	8	7	15	0	0	15	0	0
11	25749579	.	T	A	3	5	8	0	0	8	0	0
11	25749826	.	A	C	16	29	45	0	7	52	0	0
11	25749873	.	T	A	30	23	53	1	2	56	0	0
11	25750003	.	G	A	15	11	26	0	5	31	0	0
11	25750008	.	A	G	12	14	26	0	2	28	0	0
11	25783118	.	C	T	0	5	5	0	5	10	0	0
11	25783432	.	G	A	3	12	15	0	0	15	0	0
11	25783704	.	C	T	7	18	25	0	0	25	0	0
11	25789211	.	C	G	2	3	5	0	1	6	0	0
11	25791044	.	C	A	0	3	3	0	1	4	0	0
11	25893627	.	C	T	11	8	19	0	1	20	0	0
11	25893943	.	A	G	8	7	15	0	0	15	0	0
11	25894003	.	T	C	7	5	12	0	0	12	0	0
11	25944661	.	A	C	6	6	12	0	0	12	0	0
11	26180292	.	C	T	0	5	5	0	5	10	0	0
11	26180460	.	G	A	4	3	7	0	2	9	0	0
11	26190562	.	A	T	10	5	15	0	1	16	0	0
11	26190763	.	C	T	7	9	16	0	1	17	0	0
11	26191478	.	T	A	12	9	21	0	1	22	0	0
11	26191901	.	A	T	6	7	13	0	0	13	0	0
11	26193071	.	G	A	2	2	4	0	0	4	0	0
11	26193377	.	C	T	0	3	3	0	3	6	0	0
11	26193721	.	T	G	2	4	6	0	0	6	0	0
11	26194061	.	T	G	2	2	4	0	0	4	0	0
11	26194289	.	C	A	2	2	4	0	0	4	0	0
11	26195196	.	G	T	1	2	3	0	0	3	0	0
11	26229093	.	G	A	23	13	36	0	1	37	0	0
11	26229801	.	G	A	15	13	28	0	1	29	0	0
11	26229809	.	T	C	16	14	30	0	0	31	1	0
11	26229900	.	C	T	1	8	9	0	19	28	0	0
11	26230425	.	G	C	14	9	23	0	2	25	0	0
11	26230774	.	T	A	9	5	14	0	1	15	0	0
11	26230972	.	A	G	11	5	16	0	2	18	0	0
11	26231804	.	T	C	11	5	16	0	2	18	0	0
11	26231890	.	G	A	12	8	20	0	0	20	0	0
11	26231971	.	T	C	6	3	9	0	0	9	0	0
11	26232038	.	A	T	3	1	4	0	2	6	0	0
11	26232658	.	C	G	2	2	4	0	1	5	0	0
11	26367130	.	T	C	2	2	4	0	0	4	0	0
11	26367131	.	G	A	2	2	4	0	0	4	0	0
11	26367201	.	C	T	3	5	8	0	0	8	0	0
11	26369132	.	G	A	3	4	7	0	0	7	0	0
11	26369402	.	A	T	2	2	4	0	0	4	0	0
11	26370780	.	A	G	7	5	12	0	0	12	0	0
11	26370804	.	G	A	7	6	13	0	0	13	0	0
11	26371212	.	G	T	7	3	10	0	2	12	0	0
11	26371216	.	C	T	8	3	11	0	0	11	0	0
11	26372296	.	C	T	0	9	9	0	5	14	0	0
11	26373641	.	G	A	3	7	10	0	0	10	0	0
11	26373647	.	C	T	0	7	7	0	4	11	0	0
11	26374063	.	G	A	2	2	4	0	1	5	0	0
11	26380812	.	C	T	2	2	4	0	0	4	0	0
11	26380977	.	G	A	4	3	7	0	0	7	0	0
11	26381100	.	C	T	2	3	5	0	0	5	0	0
11	26381313	.	T	A	2	3	5	0	0	5	0	0
11	26381908	.	G	A	5	7	12	0	0	12	0	0
11	26382551	.	A	G	6	0	6	0	14	20	0	0
11	26382756	.	T	C	11	15	26	0	1	27	0	0
11	26383068	.	C	T	5	7	12	0	1	13	0	0
11	26383120	.	T	C	8	8	16	0	1	17	0	0
11	26383338	.	G	T	2	5	7	0	3	10	0	0
11	26397833	.	A	G	7	0	7	0	13	20	0	0
11	26398012	.	T	C	4	8	12	0	1	13	0	0
11	26398081	.	A	T	5	12	17	0	0	17	0	0
11	26400796	.	C	T	3	3	6	0	2	8	0	0
11	26400841	.	T	C	10	4	14	0	1	15	0	0
11	26400916	.	C	T	16	12	28	0	0	28	0	0
11	26401116	.	G	A	0	2	2	0	3	5	0	0
11	26401248	.	G	T	9	5	14	0	1	15	0	0
11	26401407	.	C	T	11	7	18	0	1	19	0	0
11	26401413	.	C	T	11	10	21	0	0	21	0	0
11	26545779	.	A	G	2	2	4	0	0	4	0	0
11	26545819	.	A	G	3	3	6	0	1	7	0	0
11	26550317	.	G	A	3	2	5	0	0	5	0	0
11	26561301	.	T	G	3	3	6	0	0	6	0	0
11	26562132	.	C	A	2	5	7	0	0	7	0	0
11	26562292	.	T	A	0	3	3	0	1	4	0	0
11	26562306	.	C	G	1	3	4	0	0	4	0	0
11	26562327	.	G	T	0	2	2	0	2	4	0	0
11	26610919	.	C	A	22	23	45	0	3	48	0	0
11	26614389	.	T	C	22	34	56	1	3	60	0	0
11	26614487	.	G	T	23	29	52	0	4	56	0	0
11	26614552	.	G	C	3	35	38	0	21	59	0	0
11	26614615	.	T	A	29	25	54	0	1	55	0	0
11	26614649	.	A	G	36	0	36	0	20	56	0	0
11	26615112	.	T	G	21	20	41	0	0	41	0	0
11	26615294	.	G	A	20	15	35	0	2	37	0	0
11	26683200	.	C	A	10	4	14	0	0	14	0	0
11	26683250	.	C	T	5	5	10	0	1	11	0	0
11	26683692	.	A	T	4	8	12	0	0	12	0	0
11	26686150	.	T	C	1	2	3	0	0	3	0	0
11	26686179	.	C	T	1	2	3	0	1	4	0	0
11	26695838	.	G	A	2	2	4	0	1	5	0	0
11	26695904	.	C	T	1	4	5	0	0	5	0	0
11	26704347	.	C	A	2	17	19	1	20	40	0	0
11	26704960	.	A	T	13	5	18	0	4	22	0	0
11	26705196	.	C	T	14	17	31	0	1	32	0	0
11	26705239	.	C	A	19	13	32	0	4	36	0	0
11	26705738	.	G	T	12	11	23	0	0	23	0	0
11	26705995	.	C	A	14	5	19	3	4	26	0	0
11	26706015	.	G	A	15	7	22	4	0	26	0	0
11	26706572	.	C	T	1	8	9	0	12	21	0	0
11	26706862	.	A	C	10	10	20	0	1	21	0	0
11	26707325	.	T	C	10	2	12	0	20	32	0	0
11	26707634	.	A	G	13	17	30	0	5	35	0	0
11	26707679	.	G	A	9	14	23	0	2	25	0	0
11	26707733	.	A	G	12	13	25	0	1	26	0	0
11	26715590	.	C	T	7	8	15	0	0	15	0	0
11	26739994	.	T	G	2	3	5	0	0	5	0	0
11	26740784	.	A	G	2	2	4	0	1	5	0	0
11	27136614	.	C	T	4	3	7	0	0	7	0	0
11	27195745	.	A	T	3	4	7	0	0	7	0	0
11	27486825	.	C	T	7	4	11	0	2	13	0	0
11	27487296	.	T	C	7	6	13	0	0	13	0	0
11	27487368	.	T	A	5	6	11	0	0	11	0	0
11	27487411	.	A	G	8	10	18	0	1	19	0	0
11	27487557	.	G	T	7	6	13	0	0	13	0	0
11	27487689	.	T	C	10	4	14	0	1	15	0	0
11	27488158	.	C	T	1	5	6	0	0	6	0	0
11	27488300	.	A	G	4	4	8	0	0	8	0	0
11	27488312	.	C	T	6	4	10	0	1	11	0	0
11	27488369	.	G	C	9	8	17	0	1	18	0	0
11	27495632	.	C	T	1	3	4	0	0	4	0	0
11	27512047	.	T	A	2	2	4	0	1	5	0	0
11	27516630	.	T	G	6	4	10	0	1	11	0	0
11	27516662	.	G	A	6	5	11	0	1	12	0	0
11	27516768	.	G	C	5	4	9	0	0	9	0	0
11	27516891	.	C	T	0	3	3	0	4	7	0	0
11	27517115	.	G	A	2	5	7	0	0	7	0	0
11	27517122	.	T	G	2	4	6	0	0	6	0	0
11	27517168	.	T	C	4	3	7	0	0	7	0	0
11	27517238	.	C	T	2	2	4	0	4	8	0	0
11	27517635	.	C	T	0	1	1	0	2	3	0	0
11	27517653	.	C	T	2	2	4	0	0	4	0	0
11	27517776	.	G	T	4	3	7	0	0	7	0	0
11	27644826	.	A	G	13	11	24	0	4	28	0	0
11	27644922	.	G	A	15	10	25	0	2	27	0	0
11	27645871	.	G	A	2	2	4	0	0	4	0	0
11	27646063	.	T	A	5	8	13	0	0	14	1	0
11	27646172	.	T	C	2	9	11	1	0	12	0	0
11	27646210	.	G	C	9	10	19	1	1	21	0	0
11	27646298	.	A	G	9	14	23	0	2	25	0	0
11	27649527	.	G	A	11	13	24	0	2	26	0	0
11	27655732	.	A	G	16	7	23	0	0	23	0	0
11	27655774	.	C	T	3	6	9	0	21	30	0	0
11	27661241	.	C	T	1	12	13	0	13	26	0	0
11	27668314	.	A	G	3	8	11	0	0	11	0	0
11	27669744	.	G	C	11	5	16	0	1	17	0	0
11	27671163	.	C	T	3	5	8	0	2	10	0	0
11	27671251	.	G	A	6	7	13	0	1	14	0	0
11	27673289	.	C	T	4	6	10	0	1	11	0	0
11	27677815	.	C	T	0	3	3	0	4	7	0	0
11	27677939	.	T	G	2	5	7	0	1	8	0	0
11	27677948	.	G	A	2	6	8	0	0	8	0	0
11	27705165	.	G	A	8	11	19	0	0	19	0	0
11	27705215	.	T	A	6	11	17	0	1	18	0	0
11	27705219	.	G	T	8	10	18	0	2	20	0	0
11	27705308	.	G	A	18	14	32	0	2	34	0	0
11	27705960	.	G	A	11	12	23	0	0	23	0	0
11	27706308	.	G	A	8	3	11	0	1	12	0	0
11	27706434	.	T	A	2	2	4	0	1	5	0	0
11	27706441	.	T	C	3	1	4	0	3	7	0	0
11	27706741	.	T	A	6	4	10	0	1	11	0	0
11	27706742	.	A	C	6	5	11	0	0	11	0	0
11	27708665	.	A	C	6	8	14	0	0	14	0	0
11	27710381	.	G	T	5	5	10	0	1	11	0	0
11	27713556	.	G	T	6	6	12	0	0	12	0	0
11	27719203	.	A	G	3	5	8	0	0	8	0	0
11	27719956	.	G	T	5	2	7	0	0	7	0	0
11	27725145	.	T	G	1	3	4	0	1	5	0	0
11	27727592	.	G	A	3	4	7	0	0	7	0	0
11	27727631	.	A	G	3	5	8	0	0	8	0	0
11	27738569	.	G	C	3	5	8	0	0	8	0	0
11	27743683	.	G	A	2	2	4	0	0	4	0	0
11	27817706	.	T	A	3	8	11	0	3	14	0	0
11	27817767	.	G	A	3	3	6	0	0	6	0	0
11	27817948	.	C	T	0	2	2	0	3	5	0	0
11	27817986	.	C	T	1	3	4	0	0	5	1	0
11	27818236	.	A	C	5	7	12	0	1	13	0	0
11	27818239	.	T	C	6	8	14	0	0	14	0	0
11	27818343	.	G	C	11	8	19	0	0	19	0	0
11	27820431	.	T	G	8	4	12	0	0	12	0	0
11	27820992	.	C	T	0	2	2	0	4	6	0	0
11	27828919	.	A	T	9	13	22	0	0	22	0	0
11	27829592	.	A	G	11	8	19	0	1	20	0	0
11	27829702	.	T	C	18	12	30	0	0	30	0	0
11	27829772	.	G	A	16	11	27	0	1	28	0	0
11	27829928	.	G	A	13	13	26	0	3	29	0	0
11	27835073	.	T	C	10	14	24	0	0	24	0	0
11	27835372	.	C	A	4	12	16	0	0	16	0	0
11	27836045	.	T	C	11	5	16	0	0	16	0	0
11	27840160	.	A	G	8	7	15	0	1	16	0	0
11	27845701	.	A	G	1	4	5	0	0	5	0	0
11	27896518	.	C	T	1	3	4	0	3	7	0	0
11	28005535	.	C	T	3	3	6	0	0	6	0	0
11	28123548	.	T	A	1	2	3	0	1	4	0	0
11	28123550	.	G	A	1	2	3	0	1	4	0	0
11	28123627	.	C	T	1	4	5	0	0	5	0	0
11	28123665	.	G	A	2	3	5	0	0	5	0	0
11	28124010	.	C	G	2	3	5	0	0	5	0	0
11	28124052	.	T	A	2	4	6	0	0	6	0	0
11	28124161	.	G	C	1	3	4	0	0	4	0	0
11	28124217	.	G	A	0	3	3	0	3	6	0	0
11	28124544	.	C	T	1	3	4	0	0	4	0	0
11	28124776	.	C	T	5	2	7	0	0	7	0	0
11	28125578	.	A	T	2	3	5	0	0	5	0	0
11	28400163	.	C	T	3	2	5	0	0	5	0	0
11	28410154	.	C	T	2	2	4	0	0	4	0	0
11	28410157	.	T	C	1	2	3	0	1	4	0	0
11	28419255	.	A	G	3	0	3	0	3	6	0	0
11	28419948	.	C	T	2	2	4	0	0	4	0	0
11	28420051	.	A	G	1	0	1	0	3	4	0	0
11	28420264	.	T	G	6	0	6	0	9	15	0	0
11	28420600	.	G	A	1	4	5	0	2	7	0	0
11	28420602	.	T	C	2	5	7	0	0	7	0	0
11	28421115	.	T	G	6	7	13	0	0	13	0	0
11	28421234	.	A	G	4	0	4	0	3	7	0	0
11	28422071	.	G	A	2	3	5	0	0	5	0	0
11	28422273	.	C	T	7	8	15	0	4	19	0	0
11	28422542	.	A	G	13	8	21	0	1	22	0	0
11	28422892	.	C	A	8	9	17	0	1	19	1	0
11	28423137	.	A	G	7	1	8	0	5	13	0	0
11	28423147	.	T	A	7	7	14	0	0	14	0	0
11	28423325	.	C	T	10	9	19	0	0	19	0	0
11	28423457	.	T	C	13	5	18	0	0	18	0	0
11	28423628	.	A	T	17	13	30	0	1	31	0	0
11	28477137	.	C	T	3	3	6	0	1	7	0	0
11	28477338	.	T	C	1	4	5	0	0	5	0	0
11	28477697	.	T	C	3	3	6	0	0	6	0	0
11	28477720	.	T	A	2	3	5	0	0	5	0	0
11	28478026	.	T	C	4	5	9	0	0	9	0	0
11	28513792	.	A	G	7	6	13	0	0	13	0	0
11	28513960	.	T	C	8	2	10	0	1	11	0	0
11	28514053	.	G	A	3	5	8	0	0	9	1	0
11	28514089	.	T	C	3	6	9	0	0	9	0	0
11	28514946	.	T	C	1	2	3	0	0	3	0	0
11	28514963	.	C	T	1	4	5	0	0	5	0	0
11	28643141	.	G	A	19	32	51	0	3	54	0	0
11	28643281	.	A	T	27	23	50	0	2	52	0	0
11	28643890	.	G	C	20	22	42	0	2	44	0	0
11	28644087	.	A	C	29	22	51	0	2	53	0	0
11	28644110	.	T	C	24	1	25	0	27	52	0	0
11	28661028	.	A	G	18	33	51	0	4	55	0	0
11	28789260	.	C	T	15	8	23	0	1	24	0	0
11	28808965	.	G	A	6	5	11	0	0	11	0	0
11	29331413	.	A	G	1	5	6	0	0	6	0	0
11	29331532	.	A	G	6	3	9	0	0	9	0	0
11	29331609	.	T	C	9	10	19	0	0	19	0	0
11	29331695	.	A	G	13	10	23	0	0	23	0	0
11	29331854	.	T	C	5	7	12	0	0	12	0	0
11	29332113	.	T	G	9	5	14	0	2	16	0	0
11	29332255	.	T	C	7	0	7	0	5	12	0	0
11	29332357	.	A	G	3	5	8	0	0	8	0	0
11	29332591	.	G	A	8	3	11	0	1	12	0	0
11	29332652	.	A	T	7	4	11	0	0	11	0	0
11	29332662	.	T	G	5	5	10	0	1	11	0	0
11	29332982	.	T	C	3	3	6	0	0	6	0	0
11	29333807	.	A	G	1	2	3	0	0	3	0	0
11	29334137	.	A	T	2	2	4	0	0	4	0	0
11	29575390	.	G	A	15	20	35	0	2	37	0	0
11	29575429	.	G	T	19	24	43	0	3	46	0	0
11	29575527	.	C	T	25	16	41	0	3	44	0	0
11	29575897	.	C	T	15	15	30	0	2	32	0	0
11	29576344	.	T	A	6	2	8	0	0	8	0	0
11	29577107	.	G	A	8	9	17	0	0	17	0	0
11	29577163	.	C	T	10	9	19	0	1	20	0	0
11	29577431	.	T	C	4	6	10	0	0	10	0	0
11	29577481	.	T	A	5	5	10	0	1	11	0	0
11	29577566	.	C	T	5	10	15	0	1	16	0	0
11	29577598	.	T	C	6	1	7	0	12	19	0	0
11	29578070	.	C	T	1	10	11	0	10	21	0	0
11	29578133	.	T	C	9	0	9	0	15	24	0	0
11	29578139	.	A	G	8	14	22	0	0	22	0	0
11	29578265	.	G	A	8	15	23	0	0	23	0	0
11	29581774	.	T	C	9	0	9	0	14	23	0	0
11	29581828	.	A	G	12	8	20	0	1	21	0	0
11	29587885	.	A	G	5	7	12	0	0	12	0	0
11	29587927	.	T	C	6	7	13	0	0	13	0	0
11	29588525	.	G	A	9	8	17	0	0	17	0	0
11	29589199	.	T	C	10	14	24	0	0	24	0	0
11	29589370	.	C	T	6	10	16	0	3	19	0	0
11	29589512	.	T	G	9	7	16	0	2	18	0	0
11	29589578	.	T	C	5	0	5	0	8	13	0	0
11	29589602	.	T	A	8	8	16	0	1	17	0	0
11	29593372	.	T	C	3	6	9	0	0	9	0	0
11	29596227	.	A	G	3	3	6	0	0	6	0	0
11	29601936	.	T	C	4	3	7	0	1	8	0	0
11	29607633	.	A	G	2	2	4	0	0	4	0	0
11	29609844	.	G	A	1	5	6	0	0	6	0	0
11	29614086	.	T	C	2	3	5	0	0	5	0	0
11	29617672	.	G	A	3	2	5	0	0	5	0	0
11	29637556	.	T	C	2	4	6	0	0	6	0	0
11	29685616	.	T	G	2	2	4	0	0	4	0	0
11	29757258	.	T	C	10	8	18	0	2	20	0	0
11	29757636	.	A	C	11	8	19	0	1	20	0	0
11	29760548	.	C	T	1	12	13	0	4	17	0	0
11	29762946	.	G	A	12	10	22	0	1	23	0	0
11	29764554	.	A	G	8	12	20	0	2	22	0	0
11	29768048	.	T	C	4	2	6	0	0	6	0	0
11	29776479	.	A	G	1	2	3	0	0	3	0	0
11	29781864	.	T	G	1	2	3	0	0	3	0	0
11	29785388	.	C	T	3	2	5	0	0	5	0	0
11	29785434	.	A	G	2	8	10	0	0	10	0	0
11	29785694	.	T	G	3	3	6	0	0	6	0	0
11	29785731	.	A	G	3	4	7	0	1	8	0	0
11	29786061	.	G	A	3	2	5	0	0	5	0	0
11	29786398	.	G	A	1	2	3	0	0	3	0	0
11	29786401	.	T	C	2	2	4	0	0	4	0	0
11	29789405	.	A	C	12	5	17	0	0	17	0	0
11	29789776	.	T	A	2	4	6	0	0	6	0	0
11	29790631	.	A	G	1	0	1	0	6	7	0	0
11	29791911	.	C	A	21	25	46	0	1	48	1	0
11	29793547	.	T	C	31	14	45	0	3	48	0	0
11	29793553	.	T	C	29	16	45	0	4	49	0	0
11	29793694	.	A	C	9	12	21	0	1	22	0	0
11	29793726	.	C	A	8	16	24	0	0	24	0	0
11	29794009	.	A	G	21	19	40	0	0	40	0	0
11	29795893	.	A	C	3	7	10	0	0	10	0	0
11	29796270	.	A	C	5	0	5	0	11	16	0	0
11	29796512	.	A	C	2	0	2	0	2	4	0	0
11	29815351	.	A	G	1	2	3	0	0	3	0	0
11	29818203	.	T	C	3	2	5	0	2	7	0	0
11	29876974	.	C	A	4	5	9	0	0	9	0	0
11	29877077	.	A	G	4	3	7	0	2	9	0	0
11	29909493	.	T	C	6	2	8	0	2	10	0	0
11	29917851	.	G	T	4	2	6	0	2	8	0	0
11	29917861	.	A	T	4	2	6	0	0	6	0	0
11	29917966	.	G	T	2	2	4	0	1	5	0	0
11	29918069	.	T	C	2	7	9	0	2	11	0	0
11	29918109	.	A	T	9	2	11	2	1	14	0	0
11	29918110	.	A	G	9	3	12	2	0	14	0	0
11	29918168	.	T	C	7	11	18	0	2	20	0	0
11	29918294	.	G	T	9	3	12	0	0	12	0	0
11	29918306	.	A	G	9	5	14	0	1	15	0	0
11	29936156	.	G	A	1	3	4	0	0	4	0	0
11	29936168	.	T	C	0	3	3	0	0	3	0	0
11	29936562	.	G	T	1	4	5	0	0	5	0	0
11	30083525	.	A	G	5	2	7	0	0	7	0	0
11	30083603	.	C	A	3	4	7	0	0	7	0	0
11	30084212	.	C	T	1	2	3	0	1	4	0	0
11	30086845	.	A	C	5	4	9	0	0	9	0	0
11	30087007	.	C	T	7	7	14	0	0	14	0	0
11	30087147	.	T	G	3	1	4	0	5	9	0	0
11	30087271	.	A	G	6	2	8	0	0	8	0	0
11	30087274	.	T	C	5	2	7	0	1	8	0	0
11	30087312	.	A	T	3	8	11	0	1	12	0	0
11	30087429	.	G	A	7	7	14	0	1	15	0	0
11	30087756	.	A	T	3	3	6	0	0	6	0	0
11	30087885	.	C	T	8	3	11	0	0	11	0	0
11	30088392	.	A	T	12	8	20	0	1	21	0	0
11	30088427	.	G	A	10	5	15	0	0	15	0	0
11	30088560	.	G	T	11	8	19	0	1	20	0	0
11	30089649	.	A	G	16	9	25	0	0	25	0	0
11	30089671	.	G	A	17	4	21	0	1	22	0	0
11	30106387	.	G	C	2	2	4	0	0	4	0	0
11	30106429	.	C	T	3	6	9	0	0	9	0	0
11	30106459	.	C	A	7	2	9	0	0	9	0	0
11	30106790	.	A	C	4	4	8	0	0	8	0	0
11	30107224	.	G	T	3	4	7	0	0	7	0	0
11	30107299	.	T	G	3	10	13	0	3	16	0	0
11	30107366	.	A	G	2	11	13	0	0	13	0	0
11	30107405	.	T	C	6	6	12	0	0	12	0	0
11	30107417	.	C	T	5	4	9	0	1	10	0	0
11	30118970	.	A	G	5	8	13	0	0	13	0	0
11	30122741	.	G	A	2	2	4	0	1	5	0	0
11	30123439	.	G	A	1	3	4	0	0	4	0	0
11	30147877	.	G	A	3	3	6	0	0	6	0	0
11	30222912	.	T	C	7	13	20	0	1	21	0	0
11	30222963	.	G	A	2	15	17	0	10	27	0	0
11	30231104	.	C	T	29	11	40	0	5	45	0	0
11	30231269	.	A	G	22	20	42	0	2	44	0	0
11	30231416	.	T	A	19	13	32	0	0	32	0	0
11	30251529	.	A	T	1	4	5	0	1	6	0	0
11	30251551	.	T	C	1	3	4	0	0	4	0	0
11	30251859	.	A	T	4	3	7	0	2	9	0	0
11	30251912	.	A	G	1	4	5	0	0	5	0	0
11	30264067	.	C	T	1	2	3	0	0	3	0	0
11	30366944	.	G	A	2	2	4	0	0	4	0	0
11	30367192	.	T	A	3	2	5	0	1	6	0	0
11	30367196	.	C	A	3	1	4	0	2	6	0	0
11	30367235	.	C	A	1	2	3	0	0	3	0	0
11	30642065	.	A	G	3	2	5	0	3	8	0	0
11	30642164	.	A	G	6	4	10	0	0	10	0	0
11	31269295	.	A	G	2	2	4	0	1	5	0	0
11	31558251	.	G	A	0	4	4	0	9	13	0	0
11	31558634	.	C	A	12	10	22	0	0	22	0	0
11	31558782	.	C	T	8	8	16	0	0	16	0	0
11	31602828	.	G	T	7	10	17	0	1	18	0	0
11	31603346	.	G	A	0	3	3	0	6	9	0	0
11	31620889	.	C	A	1	2	3	0	0	3	0	0
11	31621001	.	C	G	2	2	4	0	0	4	0	0
11	31621106	.	C	A	2	2	4	0	1	5	0	0
11	31649781	.	G	A	0	7	7	0	6	13	0	0
11	31653670	.	T	G	4	0	4	0	5	9	0	0
11	31653700	.	T	C	3	2	5	0	2	7	0	0
11	31664070	.	T	C	9	7	16	0	0	16	0	0
11	31664108	.	T	C	8	4	12	0	0	12	0	0
11	31667490	.	C	A	7	5	12	0	0	12	0	0
11	31667592	.	C	T	12	13	25	0	1	26	0	0
11	31667658	.	C	T	14	13	27	0	0	27	0	0
11	31667946	.	G	A	8	8	16	0	0	16	0	0
11	31668112	.	A	G	4	2	6	0	0	6	0	0
11	31668186	.	A	G	1	2	3	0	1	5	1	0
11	31668191	.	A	T	1	1	2	0	0	3	1	0
11	31668330	.	C	A	3	8	11	0	2	13	0	0
11	31668394	.	T	G	3	5	8	0	0	8	0	0
11	31668540	.	T	A	1	2	3	0	0	3	0	0
11	31668737	.	T	A	1	4	5	0	0	5	0	0
11	31668824	.	T	A	8	3	11	0	1	12	0	0
11	31668893	.	T	C	5	3	8	0	0	8	0	0
11	31668964	.	G	C	1	2	3	0	0	3	0	0
11	31669769	.	C	T	2	2	4	3	0	7	0	0
11	31670123	.	A	T	0	2	2	0	0	2	0	0
11	31670130	.	T	A	1	2	3	0	0	3	0	0
11	31670216	.	A	T	5	6	11	0	1	12	0	0
11	31670534	.	T	C	2	3	5	0	1	6	0	0
11	31670605	.	T	A	2	5	7	0	0	7	0	0
11	31670610	.	A	T	1	6	7	0	0	7	0	0
11	31670648	.	T	C	1	4	5	0	0	5	0	0
11	31670686	.	A	G	1	3	4	0	0	4	0	0
11	31670724	.	A	G	2	0	2	0	5	7	0	0
11	31670749	.	C	A	3	3	6	0	0	6	0	0
11	31670789	.	C	T	7	6	13	1	1	15	0	0
11	31670808	.	C	A	10	9	19	1	0	20	0	0
11	31670830	.	T	C	9	8	17	1	2	20	0	0
11	31670868	.	T	C	9	10	19	0	0	19	0	0
11	31670881	.	T	A	7	12	19	0	0	19	0	0
11	31671060	.	A	G	4	0	4	0	5	9	0	0
11	31671072	.	T	C	3	4	7	0	1	8	0	0
11	31671165	.	G	C	4	12	16	0	1	17	0	0
11	31671189	.	A	G	2	9	11	0	0	11	0	0
11	31671326	.	G	T	0	7	7	0	6	13	0	0
11	31671328	.	T	G	7	7	14	0	0	14	0	0
11	32576695	.	C	T	11	8	19	0	6	25	0	0
11	32577076	.	T	A	6	3	9	0	1	10	0	0
11	32577258	.	C	T	2	9	11	0	13	24	0	0
11	32577404	.	A	G	16	13	29	0	3	32	0	0
11	32577439	.	G	A	11	17	28	0	3	31	0	0
11	32577800	.	G	A	15	16	31	0	2	33	0	0
11	32577830	.	G	A	21	15	36	0	2	38	0	0
11	32578082	.	C	T	9	15	24	0	3	27	0	0
11	32720124	.	C	T	16	6	22	0	1	23	0	0
11	32720427	.	A	T	8	3	11	0	0	11	0	0
11	32720505	.	C	T	6	3	9	0	0	9	0	0
11	32720730	.	C	G	7	4	11	0	1	12	0	0
11	32721144	.	A	G	7	7	14	0	0	14	0	0
11	32721168	.	A	G	8	7	15	0	0	15	0	0
11	32721333	.	A	G	5	3	8	0	0	8	0	0
11	32721492	.	A	C	1	0	1	0	2	3	0	0
11	32721498	.	T	G	1	3	4	0	0	4	0	0
11	32721765	.	A	G	3	3	6	0	0	6	0	0
11	32721843	.	G	A	2	2	4	0	0	4	0	0
11	33530220	.	A	G	4	2	6	0	0	6	0	0
11	33537327	.	A	G	3	2	5	0	0	5	0	0
11	33539693	.	T	C	4	3	7	0	0	7	0	0
11	33545056	.	A	T	3	6	9	0	0	9	0	0
11	33551200	.	T	C	5	5	10	0	1	11	0	0
11	33553873	.	T	C	6	8	14	0	0	14	0	0
11	33554087	.	G	A	8	10	18	0	0	18	0	0
11	33554116	.	G	A	7	16	23	0	0	23	0	0
11	33554535	.	T	C	9	10	19	0	1	20	0	0
11	33598663	.	T	A	4	3	7	0	0	7	0	0
11	33599038	.	T	C	6	5	11	0	2	13	0	0
11	33599148	.	T	C	9	12	21	0	3	24	0	0
11	33599187	.	T	C	13	0	13	0	10	23	0	0
11	33599223	.	A	G	13	8	21	0	4	25	0	0
11	33599240	.	A	T	15	9	24	0	1	25	0	0
11	33599464	.	C	T	1	6	7	0	10	17	0	0
11	33599900	.	C	T	0	7	7	0	2	9	0	0
11	33599947	.	C	G	1	2	3	0	0	3	0	0
11	33600015	.	G	A	3	6	9	0	0	9	0	0
11	33600174	.	G	A	22	7	29	0	1	30	0	0
11	33600215	.	A	G	24	8	32	0	1	33	0	0
11	33600350	.	T	G	4	4	8	0	1	9	0	0
11	33600742	.	A	T	8	4	12	0	1	13	0	0
11	33600862	.	G	A	2	2	4	0	1	5	0	0
11	33610214	.	A	G	1	3	4	0	0	4	0	0
11	33827023	.	G	A	3	6	9	0	0	9	0	0
11	33829443	.	A	G	3	11	14	0	0	14	0	0
11	33829515	.	A	G	4	6	10	0	0	10	0	0
11	33832679	.	C	T	10	10	20	0	0	20	0	0
11	33834700	.	A	G	7	15	22	0	0	22	0	0
11	33835385	.	C	A	7	10	17	0	1	18	0	0
11	33835542	.	T	C	7	11	18	0	0	18	0	0
11	33839169	.	C	T	7	13	20	0	1	21	0	0
11	33841788	.	C	T	13	17	30	0	1	31	0	0
11	33841984	.	C	T	10	15	25	0	3	28	0	0
11	33842542	.	C	T	6	6	12	0	0	12	0	0
11	33846497	.	T	C	5	6	11	0	2	13	0	0
11	33846519	.	T	C	11	6	17	0	1	18	0	0
11	33846657	.	G	A	4	5	9	0	0	9	0	0
11	33846729	.	T	C	5	0	5	0	6	11	0	0
11	33847123	.	C	T	2	5	7	0	0	7	0	0
11	33847293	.	G	A	3	2	5	0	2	7	0	0
11	33855666	.	G	A	3	2	5	0	0	5	0	0
11	33857833	.	T	C	4	2	6	0	2	8	0	0
11	33870464	.	A	T	9	5	14	0	0	14	0	0
11	33871043	.	T	G	13	4	17	0	1	18	0	0
11	33871099	.	G	A	3	4	7	0	1	8	0	0
11	33871343	.	G	T	4	6	10	0	0	10	0	0
11	33871358	.	G	T	8	7	15	0	0	15	0	0
11	33871378	.	G	T	12	8	20	0	1	21	0	0
11	33871575	.	A	G	21	17	38	0	0	38	0	0
11	33871897	.	C	T	12	13	25	1	2	28	0	0
11	33871931	.	G	C	17	5	22	1	1	24	0	0
11	33871932	.	C	A	15	6	21	1	3	25	0	0
11	33872029	.	C	T	0	6	6	1	16	23	0	0
11	33872038	.	G	C	9	0	9	1	12	22	0	0
11	33872289	.	T	C	12	0	12	0	5	17	0	0
11	33872411	.	A	C	13	7	20	0	1	21	0	0
11	33872564	.	G	T	18	10	28	0	0	28	0	0
11	33872684	.	C	T	15	4	19	0	2	21	0	0
11	33872699	.	A	G	14	3	17	0	2	19	0	0
11	33872759	.	A	G	11	3	14	1	1	16	0	0
11	33872763	.	A	C	12	3	15	1	0	16	0	0
11	33872829	.	C	T	1	9	10	0	8	18	0	0
11	33873539	.	C	T	0	10	10	0	12	22	0	0
11	33873578	.	A	C	18	5	23	0	0	23	0	0
11	33880086	.	A	G	13	2	15	0	1	16	0	0
11	33880089	.	C	T	0	3	3	0	13	16	0	0
11	33887086	.	C	T	0	3	3	0	2	5	0	0
11	33998436	.	A	T	5	2	7	0	0	7	0	0
11	34220083	.	G	A	3	4	7	0	0	7	0	0
11	34220129	.	C	T	4	4	8	0	0	8	0	0
11	34220436	.	T	C	6	1	7	0	5	12	0	0
11	34228108	.	G	A	1	2	3	0	0	3	0	0
11	34232662	.	A	G	6	3	9	0	0	9	0	0
11	34235427	.	C	A	5	10	15	0	2	17	0	0
11	34235498	.	C	G	3	5	8	0	1	9	0	0
11	34235528	.	T	C	6	3	9	0	0	9	0	0
11	34235825	.	A	T	10	11	21	0	1	22	0	0
11	34235858	.	A	C	12	8	20	0	0	20	0	0
11	34235918	.	A	G	15	0	15	0	7	22	0	0
11	34236092	.	G	T	7	9	16	0	1	17	0	0
11	34237150	.	C	T	8	3	11	0	3	14	0	0
11	34237217	.	A	G	9	7	16	0	0	16	0	0
11	34911094	.	A	G	4	14	18	0	1	19	0	0
11	34911229	.	G	A	4	13	17	1	2	20	0	0
11	34913997	.	G	T	0	6	6	0	1	7	0	0
11	35438612	.	A	C	2	8	10	0	5	15	0	0
11	35440173	.	T	A	16	7	23	0	2	25	0	0
11	36046521	.	T	A	2	4	6	0	0	6	0	0
11	36046523	.	A	C	1	3	4	0	1	5	0	0
11	36146021	.	C	T	1	2	3	0	0	3	0	0
11	36158839	.	G	T	2	2	4	0	0	4	0	0
11	36205992	.	C	T	4	3	7	0	0	7	0	0
11	36208199	.	G	A	3	7	10	0	0	10	0	0
11	36208328	.	G	A	0	3	3	0	3	6	0	0
11	36214517	.	C	T	21	15	36	0	1	37	0	0
11	36214815	.	G	A	3	15	18	0	16	34	0	0
11	36214859	.	C	T	12	17	29	0	0	29	0	0
11	36214955	.	A	T	16	14	30	0	1	31	0	0
11	36215346	.	G	A	13	14	27	1	4	32	0	0
11	36215399	.	A	G	16	13	29	0	2	31	0	0
11	36218548	.	G	C	10	4	14	0	0	14	0	0
11	36222707	.	G	A	2	3	5	0	0	5	0	0
11	36224767	.	G	A	3	2	5	0	0	5	0	0
11	36224780	.	T	C	2	0	2	0	3	5	0	0
11	36227589	.	C	G	1	3	4	0	0	4	0	0
11	36228124	.	G	A	1	2	3	0	0	3	0	0
11	36269682	.	G	A	8	7	15	0	0	15	0	0
11	36269768	.	A	G	6	7	13	0	0	13	0	0
11	36269788	.	A	G	9	9	18	0	1	19	0	0
11	36281939	.	T	G	11	8	19	0	2	21	0	0
11	36281943	.	G	A	12	7	19	0	1	20	0	0
11	36282417	.	G	T	9	7	16	0	0	16	0	0
11	36282450	.	G	T	10	5	15	0	4	19	0	0
11	36282494	.	G	T	12	3	15	0	1	16	0	0
11	36282501	.	C	T	15	2	17	0	2	19	0	0
11	36282612	.	G	A	6	4	10	0	2	12	0	0
11	36282621	.	T	C	6	0	6	0	4	10	0	0
11	36282701	.	T	G	5	2	7	0	1	8	0	0
11	36282710	.	G	T	4	2	6	0	0	6	0	0
11	36282792	.	G	C	2	2	4	0	0	4	0	0
11	36283050	.	T	C	3	2	5	0	0	5	0	0
11	36283061	.	A	G	3	2	5	0	0	5	0	0
11	36283728	.	A	G	9	6	15	0	2	17	0	0
11	36343167	.	G	C	21	14	35	0	2	37	0	0
11	36343339	.	A	T	15	17	32	0	0	32	0	0
11	36346578	.	A	T	7	11	18	0	3	21	0	0
11	36373059	.	C	T	0	2	2	1	1	4	0	0
11	36373430	.	G	A	2	2	4	0	0	4	0	0
11	36373459	.	A	T	1	3	4	0	0	4	0	0
11	36374922	.	T	A	2	3	5	0	0	5	0	0
11	36374944	.	T	G	3	3	6	0	0	6	0	0
11	36374958	.	T	C	3	4	7	2	0	9	0	0
11	36374993	.	G	T	4	2	6	1	0	7	0	0
11	36375120	.	T	G	2	3	5	4	0	9	0	0
11	36375177	.	G	A	2	3	5	0	0	5	0	0
11	36375293	.	G	A	1	6	7	1	0	8	0	0
11	36375367	.	T	C	1	8	9	0	0	9	0	0
11	36375671	.	C	T	9	13	22	0	0	22	0	0
11	36375708	.	A	G	8	13	21	0	0	21	0	0
11	36375774	.	A	T	13	4	17	0	0	17	0	0
11	36375852	.	T	G	5	5	10	0	2	12	0	0
11	36393111	.	A	G	3	0	3	0	5	8	0	0
11	36393150	.	T	A	4	2	6	0	2	8	0	0
11	36395136	.	A	T	1	3	4	0	0	4	0	0
11	36395728	.	T	C	7	3	10	1	0	11	0	0
11	36398192	.	G	A	0	2	2	0	7	9	0	0
11	36398318	.	A	G	5	2	7	0	0	7	0	0
11	36398531	.	A	G	9	0	9	0	8	17	0	0
11	36398558	.	T	A	8	4	12	0	0	12	0	0
11	36422295	.	G	T	1	1	2	0	1	3	0	0
11	36422342	.	C	G	1	2	3	0	1	4	0	0
11	36422351	.	G	A	1	3	4	0	1	5	0	0
11	36430045	.	A	G	2	2	4	0	0	4	0	0
11	36452372	.	G	A	2	2	4	0	0	4	0	0
11	36452453	.	C	A	4	2	6	0	1	7	0	0
11	36452534	.	C	A	2	5	7	0	1	8	0	0
11	36452688	.	A	G	5	7	12	0	0	12	0	0
11	36456056	.	T	C	9	6	15	0	1	16	0	0
11	36456058	.	T	G	9	6	15	0	0	15	0	0
11	36456101	.	T	A	2	8	10	0	0	10	0	0
11	36456125	.	A	C	4	0	4	0	6	10	0	0
11	36460829	.	G	A	13	10	23	0	0	23	0	0
11	36463965	.	T	C	4	8	12	0	0	12	0	0
11	36468047	.	G	A	6	3	9	0	1	10	0	0
11	36470493	.	C	T	0	2	2	0	3	5	0	0
11	36471901	.	C	T	4	2	6	0	0	6	0	0
11	36473924	.	G	A	3	2	5	0	0	5	0	0
11	36474978	.	A	G	2	2	4	0	0	4	0	0
11	36477626	.	G	A	6	2	8	0	0	8	0	0
11	36477803	.	C	T	2	3	5	0	0	5	0	0
11	36482269	.	A	G	2	3	5	0	0	5	0	0
11	36484836	.	G	A	9	4	13	0	0	13	0	0
11	36485042	.	A	G	9	0	9	0	5	14	0	0
11	36489169	.	G	C	12	5	17	0	1	18	0	0
11	36489205	.	T	C	3	9	12	0	1	13	0	0
11	36489428	.	A	T	6	3	9	0	0	9	0	0
11	36489706	.	T	C	3	9	12	0	0	12	0	0
11	36689425	.	T	C	11	4	15	0	0	15	0	0
11	36695094	.	A	G	2	2	4	0	0	4	0	0
11	36695103	.	G	A	2	2	4	0	0	4	0	0
11	36793697	.	G	T	2	4	6	0	0	6	0	0
11	36793859	.	G	A	5	2	7	0	0	7	0	0
11	36795564	.	G	T	4	10	14	0	0	14	0	0
11	36797149	.	C	T	1	6	7	0	6	13	0	0
11	36801796	.	G	A	7	3	10	0	0	10	0	0
11	36806296	.	A	G	4	7	11	0	0	11	0	0
11	36816163	.	T	C	1	4	5	0	1	6	0	0
11	36818820	.	A	T	1	3	4	0	0	5	1	0
11	36819529	.	C	T	2	2	4	0	0	4	0	0
11	36995485	.	A	G	2	2	4	0	0	4	0	0
11	36995494	.	A	G	2	2	4	0	0	4	0	0
11	37001740	.	C	T	1	2	3	0	0	3	0	0
11	37002607	.	C	T	2	3	5	0	0	5	0	0
11	37002616	.	G	A	2	4	6	0	0	6	0	0
11	37004670	.	C	T	1	3	4	0	0	4	0	0
11	37015956	.	C	T	2	3	5	0	0	5	0	0
11	37015968	.	T	C	2	2	4	0	0	4	0	0
11	37031950	.	C	T	9	4	13	0	0	13	0	0
11	37032055	.	G	A	16	7	23	0	3	26	0	0
11	37032626	.	T	C	6	4	10	0	1	11	0	0
11	37032739	.	C	T	6	4	10	0	0	10	0	0
11	37032740	.	A	T	6	3	9	0	1	10	0	0
11	37032854	.	C	A	11	4	15	0	0	15	0	0
11	37033333	.	A	C	16	4	20	0	0	20	0	0
11	37033348	.	C	A	15	4	19	0	0	19	0	0
11	37033373	.	C	T	10	4	14	0	0	14	0	0
11	37033475	.	T	C	3	3	6	0	0	6	0	0
11	37033505	.	G	A	0	2	2	0	3	5	0	0
11	37033516	.	G	A	5	2	7	0	0	7	0	0
11	37033603	.	T	A	5	2	7	0	3	10	0	0
11	37033676	.	C	T	6	7	13	0	1	14	0	0
11	37033813	.	C	G	11	5	16	0	0	16	0	0
11	37033846	.	G	C	9	7	16	0	0	16	0	0
11	37033855	.	T	A	8	8	16	0	0	16	0	0
11	37034390	.	T	C	5	2	7	0	0	7	0	0
11	37035240	.	T	A	9	6	15	0	1	16	0	0
11	37035454	.	A	G	12	1	13	0	15	28	0	0
11	37080550	.	C	T	2	3	5	0	0	5	0	0
11	37080971	.	G	T	2	2	4	0	0	4	0	0
11	37101165	.	A	G	1	2	3	0	0	3	0	0
11	37101169	.	T	C	1	2	3	0	0	3	0	0
11	37101460	.	G	A	0	2	2	0	3	5	0	0
11	37101479	.	A	T	1	2	3	0	0	3	0	0
11	37101616	.	T	A	2	3	5	0	0	5	0	0
11	37101876	.	A	G	1	0	1	0	2	3	0	0
11	37137676	.	G	T	1	2	3	0	0	3	0	0
11	37159902	.	G	A	3	4	7	0	0	7	0	0
11	37159994	.	T	A	2	0	2	0	0	2	0	0
11	37161822	.	G	A	0	4	4	0	2	6	0	0
11	37162529	.	G	A	4	6	10	0	0	10	0	0
11	37163874	.	A	G	5	2	7	0	1	8	0	0
11	37164191	.	G	C	1	4	5	0	1	6	0	0
11	37164510	.	T	C	2	7	9	0	1	10	0	0
11	37167289	.	A	G	5	5	10	0	1	11	0	0
11	37167669	.	C	T	9	8	17	0	0	17	0	0
11	37167955	.	G	A	3	7	10	0	0	10	0	0
11	37168147	.	T	C	7	5	12	0	1	13	0	0
11	37168162	.	T	A	9	6	15	0	0	15	0	0
11	37169108	.	A	G	9	10	19	0	1	20	0	0
11	37169144	.	G	A	13	11	24	0	0	24	0	0
11	37169269	.	G	A	16	9	25	0	2	27	0	0
11	37169931	.	T	C	3	3	6	0	0	6	0	0
11	37169958	.	C	T	1	2	3	0	0	3	0	0
11	37170045	.	G	C	1	2	3	0	0	3	0	0
11	37170409	.	A	G	18	0	18	1	19	38	0	0
11	37274727	.	A	T	1	3	4	0	0	4	0	0
11	37297811	.	A	T	25	17	42	0	4	46	0	0
11	37297951	.	T	C	31	14	45	0	1	46	0	0
11	37298028	.	T	A	13	15	28	2	6	36	0	0
11	37298718	.	G	A	16	14	30	0	3	33	0	0
11	37431722	.	C	T	5	5	10	0	0	10	0	0
11	37431953	.	C	T	37	22	59	0	2	61	0	0
11	37434255	.	T	G	17	14	31	0	2	33	0	0
11	37434259	.	T	G	17	16	33	0	1	34	0	0
11	37434618	.	C	T	15	25	40	0	1	41	0	0
11	37441257	.	T	G	21	16	37	0	2	39	0	0
11	37442557	.	G	A	10	9	19	0	0	19	0	0
11	37442772	.	G	T	7	10	17	0	2	19	0	0
11	37445084	.	G	A	9	6	15	0	1	16	0	0
11	37446173	.	T	A	1	3	4	0	1	5	0	0
11	37446700	.	C	T	7	6	13	0	1	14	0	0
11	37446736	.	C	G	5	8	13	0	0	13	0	0
11	37548471	.	C	T	1	1	2	0	1	3	0	0
11	37613577	.	G	A	13	10	23	0	0	23	0	0
11	37628230	.	C	T	31	30	61	0	0	61	0	0
11	37628595	.	T	C	21	19	40	0	3	43	0	0
11	37628816	.	T	C	16	24	40	0	2	42	0	0
11	37628831	.	C	T	15	23	38	0	2	40	0	0
11	37628863	.	T	A	19	26	45	0	1	46	0	0
11	37629046	.	G	A	24	23	47	0	2	49	0	0
11	37709031	.	A	C	10	4	14	0	0	14	0	0
11	37709033	.	A	G	11	4	15	0	0	15	0	0
11	37709133	.	G	A	12	11	23	3	1	27	0	0
11	37709303	.	C	A	17	8	25	0	0	25	0	0
11	37709334	.	T	C	12	9	21	0	3	24	0	0
11	37709450	.	T	C	8	0	8	0	8	16	0	0
11	37709475	.	C	A	7	6	13	0	1	14	0	0
11	37709542	.	T	C	6	2	8	0	0	8	0	0
11	37709545	.	G	A	6	2	8	0	0	8	0	0
11	37709677	.	A	G	8	8	16	0	1	17	0	0
11	37709998	.	A	C	4	5	9	0	1	10	0	0
11	37710026	.	T	A	5	4	9	0	2	11	0	0
11	37710272	.	G	A	3	6	9	0	0	9	0	0
11	37710327	.	A	G	4	5	9	0	0	9	0	0
11	37710386	.	G	C	6	0	6	0	3	9	0	0
11	37710680	.	A	G	3	3	6	0	0	6	0	0
11	37710709	.	T	C	4	0	4	0	4	8	0	0
11	37710960	.	A	G	5	3	8	0	1	9	0	0
11	37710962	.	A	G	5	4	9	0	0	9	0	0
11	37711005	.	G	A	3	7	10	0	1	11	0	0
11	37720622	.	C	A	17	11	28	0	1	29	0	0
11	37720658	.	G	A	18	17	35	0	2	37	0	0
11	37720671	.	A	G	16	12	28	0	0	28	0	0
11	37722445	.	G	A	24	17	41	0	2	43	0	0
11	37725854	.	C	T	13	14	27	0	0	27	0	0
11	37828866	.	T	C	1	2	3	0	0	3	0	0
11	37829325	.	C	T	1	3	4	0	0	4	0	0
11	37829505	.	C	A	1	3	4	0	1	5	0	0
11	37829642	.	T	C	2	1	3	0	1	4	0	0
11	37829859	.	A	C	2	3	5	0	1	6	0	0
11	37830353	.	A	G	1	3	4	0	2	6	0	0
11	37830436	.	C	G	1	1	2	0	2	4	0	0
11	37830531	.	G	A	0	3	3	0	2	5	0	0
11	37830890	.	A	T	2	4	6	0	0	6	0	0
11	37831082	.	T	G	4	8	12	0	1	13	0	0
11	37848872	.	C	T	1	0	1	0	2	3	0	0
11	37854047	.	T	G	1	2	3	0	0	3	0	0
11	38508466	.	T	C	3	0	3	0	2	5	0	0
11	38540251	.	T	A	8	3	11	0	4	15	0	0
11	38540288	.	C	A	12	3	15	0	2	17	0	0
11	38807987	.	C	T	5	4	9	0	0	9	0	0
11	38844445	.	G	C	6	5	11	0	1	12	0	0
11	38844481	.	T	C	5	5	10	0	1	11	0	0
11	38844510	.	C	T	3	8	11	0	0	11	0	0
11	38844541	.	T	A	2	8	10	0	0	10	0	0
11	38846017	.	G	A	1	4	5	0	2	7	0	0
11	38846361	.	G	A	8	6	14	0	1	15	0	0
11	38850244	.	G	A	2	3	5	0	4	9	0	0
11	38865710	.	A	G	12	13	25	0	0	25	0	0
11	38875221	.	A	G	21	18	39	0	2	41	0	0
11	38875283	.	A	T	20	15	35	0	2	37	0	0
11	38875352	.	G	A	24	17	41	0	2	43	0	0
11	38875397	.	T	G	26	14	40	0	2	42	0	0
11	38875484	.	A	C	23	17	40	0	1	41	0	0
11	38875660	.	T	C	25	14	39	0	2	41	0	0
11	38875867	.	T	C	11	6	17	0	2	19	0	0
11	39044541	.	G	C	3	2	5	0	2	7	0	0
11	39076002	.	T	A	2	5	7	0	0	8	1	0
11	39077749	.	T	C	3	1	4	0	2	6	0	0
11	39109555	.	C	T	8	8	16	0	0	16	0	0
11	39110046	.	C	T	9	6	15	0	0	15	0	0
11	39112035	.	A	G	12	9	21	0	1	22	0	0
11	39112190	.	T	A	2	4	6	0	0	6	0	0
11	39112202	.	C	T	3	2	5	0	0	5	0	0
11	39112957	.	G	A	6	2	8	0	0	8	0	0
11	39113410	.	C	T	0	3	3	0	1	4	0	0
11	39113423	.	C	G	1	6	7	0	0	7	0	0
11	39113449	.	G	T	1	4	5	0	1	6	0	0
11	39113584	.	G	A	1	2	3	0	0	3	0	0
11	39135160	.	T	A	27	19	46	0	0	46	0	0
11	39135834	.	C	G	22	19	41	0	4	45	0	0
11	39141536	.	A	C	22	26	48	0	1	49	0	0
11	39141732	.	T	G	11	20	31	1	0	32	0	0
11	39877711	.	C	T	4	2	6	0	0	6	0	0
11	39878200	.	A	G	2	0	2	0	4	6	0	0
11	39878442	.	A	C	4	4	8	0	0	8	0	0
11	39878558	.	A	C	2	2	4	0	0	4	0	0
11	39879316	.	A	G	5	5	10	0	1	11	0	0
11	39888410	.	T	A	1	1	2	0	1	3	0	0
11	39905164	.	C	T	8	4	12	0	1	13	0	0
11	39906110	.	C	T	4	4	8	0	3	11	0	0
11	39907021	.	C	G	7	11	18	0	3	21	0	0
11	39907585	.	G	A	7	8	15	0	0	15	0	0
11	39907618	.	C	G	5	7	12	0	0	12	0	0
11	39908020	.	T	G	9	9	18	0	2	20	0	0
11	39916450	.	G	A	15	4	19	0	0	19	0	0
11	39922402	.	G	A	3	18	21	0	12	33	0	0
11	39922407	.	G	A	12	16	28	0	0	28	0	0
11	39922714	.	A	C	14	8	22	0	2	24	0	0
11	39923551	.	T	A	14	15	29	0	3	32	0	0
11	39923653	.	C	T	11	10	21	0	0	21	0	0
11	39924083	.	A	T	12	19	31	0	2	33	0	0
11	39924235	.	G	C	14	9	23	1	1	25	0	0
11	39924243	.	G	T	12	7	19	1	4	24	0	0
11	39924341	.	C	G	11	15	26	0	2	28	0	0
11	39924358	.	T	C	13	12	25	0	4	29	0	0
11	39924413	.	G	A	8	13	21	0	2	23	0	0
11	39924639	.	C	T	19	16	35	1	1	37	0	0
11	39924652	.	C	T	20	14	34	1	3	38	0	0
11	39924711	.	A	T	13	17	30	0	1	31	0	0
11	39924736	.	A	G	11	18	29	0	1	30	0	0
11	39924783	.	T	A	12	20	32	0	3	35	0	0
11	39924784	.	A	T	12	23	35	0	1	36	0	0
11	39924929	.	G	A	17	5	22	1	5	28	0	0
11	39924946	.	C	T	18	11	29	1	4	34	0	0
11	39924989	.	G	T	16	19	35	0	1	36	0	0
11	39924999	.	C	T	16	15	31	0	4	35	0	0
11	39925225	.	C	A	20	26	46	0	1	47	0	0
11	39925458	.	G	A	15	11	26	0	7	33	0	0
11	39925529	.	C	T	13	15	28	0	3	31	0	0
11	39926041	.	C	T	24	19	43	0	1	44	0	0
11	39926216	.	A	G	11	20	31	0	5	36	0	0
11	39941661	.	A	G	6	0	6	0	9	15	0	0
11	39949703	.	C	T	9	5	14	0	1	15	0	0
11	39954026	.	T	G	8	10	18	0	1	19	0	0
11	39954319	.	G	A	0	15	15	0	7	22	0	0
11	39969260	.	A	C	1	2	3	0	0	3	0	0
11	39976568	.	G	T	1	3	4	0	0	4	0	0
11	39998695	.	T	G	2	2	4	0	0	4	0	0
11	39998697	.	T	G	2	0	2	0	2	4	0	0
11	40002228	.	T	G	2	3	5	0	1	6	0	0
11	40009094	.	A	G	3	2	5	0	0	5	0	0
11	40014079	.	A	G	7	5	12	0	1	13	0	0
11	40014346	.	G	A	3	7	10	0	0	10	0	0
11	40015113	.	G	A	3	2	5	0	0	5	0	0
11	40015380	.	C	G	1	5	6	0	1	7	0	0
11	40015529	.	T	C	7	5	12	0	0	12	0	0
11	40015537	.	G	A	6	4	10	0	1	11	0	0
11	40015696	.	C	T	2	5	7	0	0	7	0	0
11	40015797	.	A	G	1	4	5	0	0	5	0	0
11	40016253	.	C	T	1	3	4	0	0	4	0	0
11	40016261	.	A	T	1	4	5	0	0	5	0	0
11	40016524	.	G	A	0	6	6	0	1	7	0	0
11	40016528	.	T	C	1	6	7	0	0	7	0	0
11	40016649	.	A	C	2	6	8	0	2	10	0	0
11	40017183	.	G	T	9	6	15	1	1	17	0	0
11	40017290	.	G	C	9	4	13	0	0	13	0	0
11	40017333	.	A	T	7	8	15	1	1	17	0	0
11	40017501	.	A	T	5	6	11	0	0	11	0	0
11	40017504	.	T	A	5	6	11	0	0	11	0	0
11	40017604	.	T	C	10	7	17	0	3	20	0	0
11	40017698	.	T	C	2	10	12	0	1	13	0	0
11	40017829	.	A	G	2	4	6	0	0	6	0	0
11	40017865	.	T	A	1	4	5	3	0	8	0	0
11	40017885	.	G	A	2	4	6	3	0	9	0	0
11	40017949	.	A	T	5	5	10	0	2	12	0	0
11	40017994	.	T	C	8	7	15	0	0	15	0	0
11	40018042	.	T	C	12	14	26	0	0	26	0	0
11	40018633	.	G	A	11	12	23	0	1	24	0	0
11	40018668	.	A	T	11	11	22	0	2	24	0	0
11	40018799	.	G	T	0	5	5	0	7	12	0	0
11	40019076	.	G	A	3	3	6	0	1	7	0	0
11	40019078	.	A	G	3	0	3	0	4	7	0	0
11	40019232	.	C	T	7	3	10	0	2	12	0	0
11	40019276	.	A	C	14	5	19	0	1	20	0	0
11	40019278	.	T	A	15	6	21	0	0	21	0	0
11	40020683	.	G	T	12	9	21	0	1	22	0	0
11	40020928	.	G	A	17	20	37	0	0	37	0	0
11	40020950	.	A	G	13	12	25	0	4	29	0	0
11	40655819	.	T	C	12	4	16	0	0	16	0	0
11	40658079	.	A	C	10	7	17	0	0	17	0	0
11	40658091	.	A	T	7	5	12	0	1	13	0	0
11	40658154	.	C	G	10	0	10	0	6	16	0	0
11	40658232	.	C	T	7	6	13	0	0	13	0	0
11	40658352	.	G	A	0	6	6	0	5	11	0	0
11	40661378	.	T	C	6	7	13	1	0	14	0	0
11	40665545	.	T	C	18	6	24	0	3	27	0	0
11	40665602	.	G	T	3	14	17	0	20	37	0	0
11	40673797	.	C	T	20	13	33	0	2	35	0	0
11	40673877	.	A	G	12	9	21	0	3	24	0	0
11	40677891	.	A	T	27	21	48	0	1	49	0	0
11	40677967	.	T	C	49	15	64	0	1	65	0	0
11	40678385	.	T	G	28	33	61	0	5	66	0	0
11	40678445	.	A	C	32	0	32	0	35	68	1	0
11	40680890	.	A	G	31	27	58	0	1	59	0	0
11	40840238	.	T	C	2	5	7	0	0	7	0	0
11	40840407	.	T	C	4	3	7	0	0	7	0	0
11	40843208	.	T	C	9	4	13	0	0	13	0	0
11	40843814	.	T	C	6	6	12	0	2	14	0	0
11	40844162	.	T	C	8	4	12	1	0	13	0	0
11	40844195	.	A	T	7	6	13	1	2	16	0	0
11	40845117	.	T	C	5	5	10	0	1	11	0	0
11	41066190	.	T	G	18	0	18	0	9	27	0	0
11	41066765	.	T	G	14	10	24	0	2	26	0	0
11	41066871	.	C	T	8	14	22	0	1	23	0	0
11	41066888	.	C	T	10	16	26	0	1	27	0	0
11	41066950	.	A	G	13	20	33	0	2	36	1	0
11	41067275	.	G	A	2	14	16	0	0	16	0	0
11	41067430	.	A	T	3	13	16	0	1	17	0	0
11	41067442	.	C	T	2	16	18	0	0	18	0	0
11	41067488	.	A	C	4	8	12	0	1	13	0	0
11	41067502	.	G	A	4	11	15	0	1	16	0	0
11	41067613	.	A	G	1	5	6	0	1	7	0	0
11	41078289	.	T	C	3	0	3	0	3	6	0	0
11	41078522	.	C	A	6	5	11	0	1	12	0	0
11	41078578	.	A	T	11	8	19	0	0	19	0	0
11	41078762	.	A	T	15	15	30	0	2	32	0	0
11	41084325	.	T	G	17	9	26	0	1	27	0	0
11	41089631	.	G	T	3	3	6	0	0	6	0	0
11	41089641	.	T	C	3	2	5	0	0	5	0	0
11	41090478	.	A	C	6	2	8	0	0	8	0	0
11	41090479	.	A	C	6	2	8	0	0	8	0	0
11	41101800	.	T	A	2	3	5	0	0	5	0	0
11	41101866	.	C	T	1	2	3	0	0	3	0	0
11	41101910	.	G	A	3	6	9	0	0	9	0	0
11	41101918	.	C	T	3	7	10	0	0	10	0	0
11	41101948	.	A	G	4	0	4	0	4	8	0	0
11	41102013	.	A	G	3	0	3	0	4	7	0	0
11	41102026	.	T	C	1	6	7	0	1	8	0	0
11	41102205	.	A	G	5	3	8	0	0	8	0	0
11	41104549	.	A	G	2	3	5	0	1	6	0	0
11	41104954	.	C	T	11	3	14	0	0	14	0	0
11	41105030	.	G	A	0	7	7	0	9	16	0	0
11	41105144	.	T	G	5	0	5	0	7	12	0	0
11	41111301	.	A	G	12	12	24	0	0	24	0	0
11	41111334	.	T	C	11	10	21	0	2	23	0	0
11	41111370	.	C	T	7	10	17	0	2	19	0	0
11	41111422	.	A	G	7	11	18	0	0	18	0	0
11	41111431	.	A	C	6	9	15	0	0	15	0	0
11	41111561	.	T	A	3	6	9	0	0	9	0	0
11	41111603	.	T	A	4	7	11	0	0	11	0	0
11	41111735	.	G	A	8	6	14	0	1	15	0	0
11	41114055	.	C	T	2	6	8	0	5	13	0	0
11	41114090	.	G	T	7	4	11	0	0	11	0	0
11	41114186	.	A	C	7	3	10	0	1	11	0	0
11	41125040	.	A	G	2	4	6	0	0	6	0	0
11	41132195	.	A	G	2	3	5	0	1	6	0	0
11	41216315	.	C	T	0	4	4	0	2	6	0	0
11	41216395	.	A	G	2	2	4	0	2	6	0	0
11	41216413	.	C	A	4	5	9	0	0	9	0	0
11	41216455	.	T	C	2	0	2	0	11	13	0	0
11	41216505	.	G	C	5	9	14	0	2	16	0	0
11	41220596	.	G	A	11	10	21	0	2	23	0	0
11	41220613	.	C	T	2	9	11	0	11	22	0	0
11	41220683	.	T	A	16	7	23	0	1	24	0	0
11	41222940	.	A	G	11	10	21	0	0	21	0	0
11	41306035	.	G	A	0	2	2	0	2	4	0	0
11	41307691	.	T	C	6	11	17	0	1	18	0	0
11	41307733	.	A	G	5	12	17	0	2	19	0	0
11	41307844	.	T	C	7	4	11	0	2	13	0	0
11	41363778	.	G	A	0	8	8	0	5	13	0	0
11	41372906	.	G	T	1	3	4	0	0	4	0	0
11	41375027	.	C	G	7	6	13	0	0	13	0	0
11	41459981	.	G	C	1	26	27	0	19	46	0	0
11	41461417	.	C	G	13	21	34	0	3	37	0	0
11	41463534	.	C	G	14	19	33	1	2	36	0	0
11	41468791	.	C	T	12	26	38	2	2	42	0	0
11	41473980	.	G	T	9	16	25	0	1	26	0	0
11	41474041	.	T	A	12	9	21	0	3	24	0	0
11	41474042	.	G	T	13	11	24	0	0	24	0	0
11	41669291	.	C	T	0	2	2	0	1	3	0	0
11	41699744	.	A	C	4	4	8	0	0	8	0	0
11	41838930	.	T	A	2	3	5	0	1	6	0	0
11	41838933	.	C	A	2	4	6	0	0	6	0	0
11	41838991	.	T	G	3	0	3	0	6	9	0	0
11	41838999	.	G	T	2	5	7	0	0	7	0	0
11	41844342	.	T	C	15	6	21	0	0	21	0	0
11	41844396	.	A	G	8	0	8	0	8	16	0	0
11	41845916	.	C	T	6	3	9	0	0	9	0	0
11	41849977	.	C	T	0	5	5	0	7	12	0	0
11	41850058	.	A	G	5	4	9	0	0	9	0	0
11	41850559	.	G	A	3	5	8	0	1	9	0	0
11	41850565	.	G	A	3	6	9	0	0	9	0	0
11	41946225	.	A	G	1	2	3	0	0	3	0	0
11	41948344	.	C	T	1	3	4	0	0	4	0	0
11	41952555	.	C	T	3	2	5	0	0	5	0	0
11	41958058	.	C	T	2	5	7	0	0	7	0	0
11	41958278	.	A	T	7	10	17	0	1	18	0	0
11	41958317	.	T	C	8	9	17	0	0	17	0	0
11	41960058	.	A	C	10	7	17	0	3	20	0	0
11	41960059	.	C	T	13	7	20	0	0	20	0	0
11	41960101	.	A	G	7	14	21	0	0	21	0	0
11	41960111	.	C	T	9	12	21	0	1	22	0	0
11	41982546	.	G	A	0	4	4	0	5	9	0	0
11	42128555	.	T	A	4	4	8	0	1	9	0	0
11	42128615	.	A	C	4	6	10	0	0	10	0	0
11	42131413	.	T	C	5	0	5	0	5	10	0	0
11	42134733	.	C	G	7	3	10	0	0	10	0	0
11	42305630	.	A	T	0	3	3	0	1	4	0	0
11	42305868	.	C	A	1	9	10	0	6	16	0	0
11	42306017	.	G	A	6	15	21	0	2	23	0	0
11	42306049	.	T	C	9	0	9	3	13	25	0	0
11	42306627	.	C	T	2	15	17	0	6	23	0	0
11	42306928	.	A	T	19	13	32	0	1	33	0	0
11	42307147	.	T	A	11	17	28	0	1	29	0	0
11	42307400	.	A	T	14	9	23	0	0	23	0	0
11	42307671	.	G	A	6	9	15	0	1	16	0	0
11	42315414	.	A	C	7	0	7	0	15	22	0	0
11	42319340	.	C	T	15	5	20	0	0	20	0	0
11	42319372	.	C	A	13	4	17	0	0	17	0	0
11	42325535	.	C	T	8	12	20	0	0	20	0	0
11	42327184	.	G	T	8	10	18	0	0	18	0	0
11	42341009	.	G	A	13	5	18	0	0	18	0	0
11	42350581	.	G	A	6	7	13	0	2	15	0	0
11	42350847	.	C	T	9	5	14	0	0	14	0	0
11	42363236	.	G	A	1	5	6	0	0	6	0	0
11	42417409	.	T	C	2	4	6	0	0	6	0	0
11	42417479	.	T	G	2	4	6	0	1	7	0	0
11	42458272	.	A	G	0	0	0	0	3	3	0	0
11	42458475	.	A	T	1	2	3	0	0	3	0	0
11	42458482	.	A	G	0	1	1	0	2	3	0	0
11	42500643	.	A	T	3	2	5	0	0	5	0	0
11	42501331	.	G	T	0	3	3	0	1	4	0	0
11	42501536	.	G	T	1	2	3	0	0	3	0	0
11	42502004	.	A	G	3	3	6	0	0	6	0	0
11	42502108	.	T	A	3	4	7	0	0	7	0	0
11	42502164	.	C	T	3	2	5	0	1	6	0	0
11	42502203	.	T	C	5	4	9	0	0	9	0	0
11	42502261	.	T	C	2	3	5	0	0	5	0	0
11	42502313	.	G	T	1	2	3	0	0	3	0	0
11	42502349	.	A	G	1	1	2	0	2	4	0	0
11	42502661	.	C	A	2	2	4	0	0	4	0	0
11	42521982	.	C	G	3	5	8	0	0	8	0	0
11	42521985	.	G	A	4	3	7	0	1	8	0	0
11	42522109	.	A	G	3	3	6	0	0	6	0	0
11	42522147	.	C	G	1	5	6	0	2	8	0	0
11	42522162	.	A	T	5	2	7	0	0	8	1	0
11	42532660	.	T	G	9	5	14	0	0	14	0	0
11	42532886	.	T	A	3	7	10	0	0	10	0	0
11	42533125	.	C	T	4	7	11	0	1	12	0	0
11	42533318	.	G	A	7	3	10	0	0	10	0	0
11	42533321	.	T	G	7	3	10	0	0	10	0	0
11	42539476	.	G	A	1	6	7	0	1	8	0	0
11	42557693	.	A	G	38	32	70	0	2	72	0	0
11	42560439	.	G	A	24	35	59	0	2	61	0	0
11	42560475	.	C	T	30	31	61	0	2	63	0	0
11	42561212	.	C	A	2	5	7	0	1	8	0	0
11	42615091	.	A	T	7	5	12	0	0	12	0	0
11	42615275	.	A	C	9	3	12	0	0	12	0	0
11	42715511	.	T	C	1	4	5	0	0	5	0	0
11	42718743	.	T	A	1	3	4	0	0	4	0	0
11	42719046	.	G	A	5	3	8	0	0	8	0	0
11	42730657	.	A	G	22	16	38	0	3	41	0	0
11	42730931	.	C	T	14	20	34	0	0	34	0	0
11	42731172	.	G	C	18	15	33	1	1	35	0	0
11	42731173	.	G	T	19	15	34	1	0	35	0	0
11	42771442	.	G	A	2	2	4	0	0	4	0	0
11	42783985	.	G	A	3	2	5	0	0	5	0	0
11	42801508	.	T	A	3	2	5	0	1	6	0	0
11	42801547	.	C	T	3	3	6	0	0	6	0	0
11	42808988	.	C	T	4	4	8	0	0	8	0	0
11	42809233	.	A	G	4	2	6	0	1	7	0	0
11	42809345	.	T	C	4	7	11	0	0	11	0	0
11	42809717	.	G	A	1	4	5	0	4	9	0	0
11	42811938	.	G	A	1	4	5	0	5	10	0	0
11	42815207	.	C	A	4	3	7	0	0	7	0	0
11	42815261	.	G	A	4	3	7	0	0	7	0	0
11	42815582	.	A	T	2	2	4	0	0	4	0	0
11	42816152	.	G	A	0	4	4	0	8	12	0	0
11	42816189	.	G	A	10	6	16	0	1	17	0	0
11	42816208	.	A	T	14	5	19	0	3	22	0	0
11	42816263	.	G	C	3	5	8	0	11	19	0	0
11	42816765	.	C	A	3	2	5	1	0	6	0	0
11	42816811	.	A	C	5	4	9	0	0	9	0	0
11	42816841	.	G	T	3	4	7	0	0	7	0	0
11	42816886	.	C	T	1	5	6	0	0	6	0	0
11	42817075	.	T	G	3	0	3	0	4	7	0	0
11	42817459	.	A	T	8	15	23	0	1	24	0	0
11	42817476	.	G	C	1	9	10	0	13	23	0	0
11	42817598	.	A	G	7	0	7	0	7	14	0	0
11	42912038	.	C	A	5	2	7	0	0	7	0	0
11	42912039	.	A	G	4	2	6	0	2	8	0	0
11	42912126	.	A	G	3	2	5	0	0	5	0	0
11	42913124	.	T	C	1	2	3	0	0	3	0	0
11	42916130	.	T	C	2	2	4	0	1	5	0	0
11	42933019	.	A	G	3	3	6	0	0	6	0	0
11	42933696	.	A	G	6	9	15	0	1	16	0	0
11	42933703	.	T	C	10	8	18	0	0	18	0	0
11	42933780	.	G	A	7	3	10	0	1	11	0	0
11	42939803	.	T	C	8	8	16	0	2	18	0	0
11	42940748	.	C	T	11	3	14	0	0	14	0	0
11	42942921	.	C	T	0	6	6	0	5	11	0	0
11	42942930	.	G	A	4	5	9	0	0	9	0	0
11	43470337	.	T	C	1	3	4	0	0	4	0	0
11	44328905	.	A	G	17	14	31	0	3	34	0	0
11	44328956	.	T	C	16	20	36	0	2	38	0	0
11	44329050	.	A	G	13	25	38	0	1	39	0	0
11	44329172	.	C	T	23	19	42	0	1	43	0	0
11	44334935	.	T	A	18	16	34	0	2	36	0	0
11	44358817	.	G	T	0	6	6	0	4	10	0	0
11	44361689	.	C	G	11	4	15	0	0	15	0	0
11	44361701	.	C	T	11	7	18	0	0	18	0	0
11	44400918	.	G	A	4	4	8	0	0	8	0	0
11	44400960	.	G	T	3	7	10	0	0	10	0	0
11	44401057	.	C	A	5	8	13	0	0	13	0	0
11	44401275	.	G	A	12	10	22	0	0	22	0	0
11	44401437	.	G	A	1	4	5	0	1	6	0	0
11	44468838	.	G	A	3	5	8	0	1	10	1	0
11	44468842	.	T	C	4	5	9	0	1	10	0	0
11	44606717	.	T	G	3	1	4	0	0	4	0	0
11	44606732	.	T	C	4	2	6	0	0	6	0	0
11	44606844	.	G	T	6	9	15	0	0	15	0	0
11	44607052	.	G	A	17	8	25	0	0	25	0	0
11	44612357	.	A	G	4	3	7	0	1	8	0	0
11	44619132	.	A	T	4	2	6	0	0	6	0	0
11	44622594	.	C	T	6	2	8	0	0	8	0	0
11	44624723	.	A	C	4	2	6	0	0	6	0	0
11	44633294	.	T	C	9	5	14	0	0	14	0	0
11	44634908	.	G	A	1	3	4	0	2	6	0	0
11	44635430	.	C	A	1	3	4	0	0	4	0	0
11	44635441	.	T	C	1	3	4	0	0	4	0	0
11	44637569	.	T	A	7	4	11	0	1	12	0	0
11	44637950	.	A	G	23	29	52	1	5	58	0	0
11	44643882	.	C	T	20	23	43	0	2	45	0	0
11	44647227	.	A	C	22	0	22	0	26	48	0	0
11	44647269	.	T	G	14	22	36	0	0	36	0	0
11	44723130	.	C	G	5	9	14	0	1	15	0	0
11	44723353	.	G	A	0	14	14	0	19	33	0	0
11	44723374	.	T	C	18	10	28	0	2	30	0	0
11	44723416	.	T	G	19	0	19	0	15	34	0	0
11	44723653	.	T	G	16	17	33	0	4	37	0	0
11	44723746	.	A	G	19	22	41	0	5	46	0	0
11	44725596	.	C	T	23	18	41	0	3	44	0	0
11	44725926	.	G	A	3	25	28	0	29	57	0	0
11	44852248	.	A	G	6	0	6	0	6	12	0	0
11	44852285	.	C	A	5	4	9	0	1	10	0	0
11	44852988	.	T	A	2	2	4	0	0	4	0	0
11	44853172	.	C	A	3	2	5	0	0	5	0	0
11	44853325	.	T	C	2	2	4	0	1	5	0	0
11	44853908	.	A	T	3	4	7	2	1	10	0	0
11	44854335	.	T	C	4	2	6	0	0	6	0	0
11	44854479	.	A	C	4	3	7	0	0	7	0	0
11	44854631	.	C	T	2	2	4	0	0	4	0	0
11	44854636	.	G	T	1	1	2	0	0	2	0	0
11	44854894	.	T	G	9	11	20	0	1	21	0	0
11	44854918	.	G	A	2	10	12	0	9	21	0	0
11	44854996	.	T	C	10	9	19	0	2	21	0	0
11	44855027	.	G	A	1	7	8	0	12	20	0	0
11	44880288	.	A	G	10	13	23	0	3	26	0	0
11	44880291	.	T	A	10	15	25	0	1	26	0	0
11	44880332	.	G	A	19	15	34	0	0	34	0	0
11	44880345	.	C	G	15	18	33	0	1	34	0	0
11	44887200	.	G	A	15	15	30	0	0	30	0	0
11	44887224	.	T	C	20	0	20	0	18	38	0	0
11	44887612	.	G	T	29	13	42	0	1	43	0	0
11	44891507	.	G	A	16	17	33	0	2	35	0	0
11	44892859	.	T	A	20	15	35	0	0	35	0	0
11	44892883	.	G	A	14	13	27	0	3	30	0	0
11	44892943	.	G	A	12	11	23	0	1	24	0	0
11	44892979	.	T	A	12	9	21	0	2	23	0	0
11	44894409	.	T	C	4	0	4	1	7	12	0	0
11	44897584	.	C	T	3	12	15	0	1	16	0	0
11	44897647	.	A	C	6	8	14	0	1	15	0	0
11	44901315	.	C	T	1	9	10	0	10	20	0	0
11	44901373	.	C	A	23	36	59	0	3	62	0	0
11	44906468	.	A	G	4	3	7	0	0	7	0	0
11	44910758	.	T	G	19	10	29	0	1	30	0	0
11	44912485	.	C	A	0	6	6	0	6	12	0	0
11	44912992	.	C	T	0	8	8	0	9	17	0	0
11	44913176	.	C	A	1	12	13	0	12	25	0	0
11	44914943	.	G	C	10	7	17	0	1	18	0	0
11	44922524	.	T	G	2	4	6	0	0	6	0	0
11	44927833	.	G	T	2	4	6	0	0	6	0	0
11	44935375	.	A	G	6	10	16	0	1	17	0	0
11	44953608	.	C	T	1	2	3	0	0	3	0	0
11	44953620	.	C	T	1	2	3	0	0	3	0	0
11	44953880	.	G	T	5	2	7	0	0	8	1	0
11	44960620	.	G	A	5	4	9	0	0	9	0	0
11	45123918	.	C	T	2	2	4	0	0	4	0	0
11	45125627	.	T	C	4	7	11	0	0	11	0	0
11	45126985	.	A	G	3	4	7	0	0	7	0	0
11	45127029	.	C	T	4	2	6	0	0	6	0	0
11	45127191	.	G	A	10	9	19	0	3	22	0	0
11	45127335	.	C	T	1	4	5	0	9	14	0	0
11	45127374	.	G	A	9	4	13	0	1	14	0	0
11	45129287	.	G	A	7	4	11	0	0	11	0	0
11	45130676	.	A	G	3	2	5	0	0	5	0	0
11	45130874	.	C	A	0	3	3	0	3	6	0	0
11	45131119	.	C	T	3	3	6	0	1	7	0	0
11	45139844	.	A	G	5	5	10	0	1	11	0	0
11	45140116	.	C	G	8	7	15	0	0	15	0	0
11	45141286	.	T	C	14	12	26	0	1	28	1	0
11	45147865	.	G	C	3	5	8	0	0	8	0	0
11	45148705	.	T	C	3	0	3	0	6	9	0	0
11	45161950	.	T	C	8	0	8	0	5	13	0	0
11	45162241	.	A	T	9	7	16	0	1	17	0	0
11	45162416	.	T	C	24	1	25	0	11	36	0	0
11	45167709	.	G	A	5	4	9	0	0	9	0	0
11	45223968	.	G	A	0	3	3	0	1	4	0	0
11	45234948	.	C	T	2	3	5	0	1	6	0	0
11	45235063	.	A	G	1	0	1	0	3	4	0	0
11	45242450	.	C	T	10	5	15	0	1	16	0	0
11	45242912	.	T	C	10	11	21	0	1	22	0	0
11	45245862	.	G	A	0	4	4	0	1	5	0	0
11	45262079	.	C	T	6	7	13	0	0	13	0	0
11	45262138	.	C	G	5	0	5	0	6	11	0	0
11	45262155	.	T	C	6	6	12	0	1	13	0	0
11	45262186	.	G	A	2	8	10	0	9	19	0	0
11	45262379	.	G	T	8	9	17	0	2	19	0	0
11	45265828	.	C	T	5	8	13	0	1	14	0	0
11	45269752	.	T	C	12	16	28	0	4	32	0	0
11	45272686	.	G	A	0	7	7	1	9	17	0	0
11	45287575	.	G	A	4	6	10	0	0	10	0	0
11	45290463	.	A	G	4	11	15	0	1	16	0	0
11	45290884	.	C	T	6	4	10	0	0	10	0	0
11	45291926	.	G	A	5	10	15	0	2	17	0	0
11	45292918	.	G	A	1	11	12	0	14	26	0	0
11	45294523	.	C	G	13	1	14	3	4	21	0	0
11	45294553	.	C	A	14	7	21	0	1	22	0	0
11	45294734	.	T	C	7	17	24	0	1	25	0	0
11	45294807	.	T	C	16	0	16	0	0	16	0	0
11	45326832	.	G	A	1	2	3	0	0	3	0	0
11	45326834	.	T	C	1	2	3	0	0	3	0	0
11	45342625	.	C	T	2	2	4	0	0	4	0	0
11	45342676	.	A	T	3	2	5	0	1	6	0	0
11	45342757	.	A	G	1	3	4	0	0	4	0	0
11	45342823	.	G	A	4	2	6	0	2	8	0	0
11	45342861	.	A	C	2	3	5	0	0	5	0	0
11	45342924	.	T	C	4	2	6	0	0	6	0	0
11	45343033	.	A	G	2	3	5	0	1	6	0	0
11	45343045	.	C	G	4	2	6	0	0	6	0	0
11	45343231	.	T	A	4	5	9	0	0	9	0	0
11	45343264	.	A	T	2	7	9	0	1	10	0	0
11	45344090	.	C	T	3	3	6	0	0	6	0	0
11	45344129	.	G	A	5	4	9	0	0	9	0	0
11	45348465	.	G	A	5	2	7	0	0	7	0	0
11	45355022	.	C	G	18	12	30	0	0	30	0	0
11	45355473	.	C	T	3	13	16	0	13	29	0	0
11	45355717	.	A	G	26	5	31	1	1	33	0	0
11	45356058	.	A	C	16	0	16	0	3	19	0	0
11	45356060	.	A	C	17	2	19	0	1	20	0	0
11	45356114	.	G	A	9	14	23	0	2	25	0	0
11	45356660	.	C	T	1	13	14	0	16	30	0	0
11	45359878	.	C	T	8	6	14	0	0	14	0	0
11	45362172	.	A	T	6	8	14	0	1	15	0	0
11	45362719	.	C	T	4	4	8	0	2	10	0	0
11	45362734	.	G	A	0	11	11	0	0	11	0	0
11	45363073	.	G	A	5	3	8	0	0	8	0	0
11	45366754	.	T	C	2	0	2	0	4	6	0	0
11	45366798	.	T	A	3	4	7	0	0	7	0	0
11	45372043	.	C	T	1	3	4	0	3	7	0	0
11	45391727	.	T	C	9	11	20	0	1	21	0	0
11	45391788	.	C	T	13	9	22	0	0	22	0	0
11	45393520	.	A	C	13	5	18	0	43	61	0	0
11	45395572	.	G	A	5	32	37	0	23	60	0	0
11	45397372	.	C	T	24	24	48	1	1	50	0	0
11	45398744	.	A	G	24	37	61	2	3	66	0	0
11	45398804	.	T	C	26	35	61	0	4	65	0	0
11	45399389	.	A	G	34	27	61	0	1	62	0	0
11	45399491	.	C	T	24	25	49	1	7	57	0	0
11	45399799	.	G	T	20	15	35	0	1	36	0	0
11	45399925	.	C	T	24	15	39	0	4	43	0	0
11	45399985	.	G	T	2	15	17	0	18	35	0	0
11	45402945	.	G	A	15	11	26	0	1	27	0	0
11	45403525	.	G	A	9	16	25	0	1	26	0	0
11	45403733	.	G	A	17	9	26	0	1	27	0	0
11	45403800	.	T	A	17	17	34	0	0	34	0	0
11	45403854	.	G	A	21	13	34	0	0	34	0	0
11	45407215	.	G	A	16	14	30	0	0	30	0	0
11	45419948	.	C	G	2	8	10	0	12	22	0	0
11	45425665	.	C	T	2	2	4	0	0	4	0	0
11	45456290	.	G	A	1	4	5	0	0	5	0	0
11	45460271	.	G	A	1	3	4	0	6	10	0	0
11	45461498	.	G	A	0	17	17	0	7	24	0	0
11	45463352	.	T	C	10	12	22	0	0	22	0	0
11	45463661	.	G	A	0	4	4	0	19	23	0	0
11	45463730	.	G	A	2	10	12	0	16	28	0	0
11	45463835	.	G	T	12	6	18	0	2	20	0	0
11	45463979	.	T	A	6	8	14	0	6	20	0	0
11	45464041	.	T	C	7	5	12	0	0	12	0	0
11	45464673	.	C	T	10	6	16	0	1	17	0	0
11	45464762	.	A	T	10	11	21	0	1	22	0	0
11	45464835	.	G	A	12	8	20	0	1	21	0	0
11	45465080	.	T	A	11	7	18	0	1	19	0	0
11	45468802	.	A	G	2	4	6	0	0	6	0	0
11	45468906	.	T	A	1	5	6	0	0	6	0	0
11	45468956	.	C	A	4	4	8	0	1	9	0	0
11	45468959	.	G	A	3	3	6	0	2	8	0	0
11	45469483	.	T	C	3	7	10	0	1	11	0	0
11	45469489	.	G	A	7	3	10	0	0	10	0	0
11	45469914	.	G	T	3	3	6	0	0	6	0	0
11	45470277	.	C	T	4	15	19	0	4	23	0	0
12	560797	.	T	C	2	4	6	0	0	6	0	0
12	632298	.	C	T	1	4	5	0	0	5	0	0
12	1388305	.	A	T	1	6	7	0	0	7	0	0
12	2849970	.	A	G	1	5	6	0	3	9	0	0
12	2850025	.	A	G	4	4	8	0	0	8	0	0
12	2850494	.	T	C	3	0	3	0	4	7	0	0
12	2850496	.	T	C	4	0	4	0	4	8	0	0
12	2850532	.	T	C	8	5	13	0	0	13	0	0
12	3271061	.	A	G	3	2	5	2	0	7	0	0
12	3271390	.	A	G	5	7	12	0	0	12	0	0
12	3271391	.	A	G	3	7	10	0	2	12	0	0
12	3271553	.	G	A	5	4	9	0	2	11	0	0
12	3271873	.	A	T	0	6	6	1	1	8	0	0
12	3272111	.	A	C	2	10	12	0	0	12	0	0
12	3272114	.	A	G	2	10	12	0	0	12	0	0
12	3272148	.	A	G	8	7	15	0	0	15	0	0
12	3272348	.	T	C	9	2	11	0	1	12	0	0
12	3272421	.	A	G	7	7	14	0	4	18	0	0
12	3287912	.	G	A	9	2	11	0	1	12	0	0
12	3371230	.	C	T	1	3	4	0	1	5	0	0
12	3571986	.	C	T	18	17	35	0	1	36	0	0
12	3574348	.	G	A	16	18	34	0	1	35	0	0
12	3574489	.	G	A	5	6	11	0	0	11	0	0
12	3714149	.	G	T	4	7	11	0	1	12	0	0
12	3714183	.	G	A	9	10	19	0	4	23	0	0
12	3714213	.	T	A	10	17	27	0	1	28	0	0
12	3714315	.	C	T	8	8	16	0	2	18	0	0
12	3714330	.	A	T	11	9	20	0	0	20	0	0
12	3714578	.	T	C	3	0	3	0	9	12	0	0
12	3714602	.	T	C	3	5	8	0	1	9	0	0
12	3714746	.	C	T	4	4	8	1	0	9	0	0
12	3715016	.	A	G	9	3	12	0	0	12	0	0
12	3715134	.	G	A	4	4	8	0	1	9	0	0
12	3715192	.	G	A	12	4	16	0	1	17	0	0
12	3715196	.	C	T	0	0	0	0	16	16	0	0
12	3715292	.	T	G	5	11	16	0	0	16	0	0
12	3715327	.	C	A	8	5	13	0	0	13	0	0
12	3715329	.	C	G	8	4	12	0	1	13	0	0
12	3715365	.	T	C	5	4	9	0	1	10	0	0
12	3715431	.	T	C	4	2	6	0	1	7	0	0
12	3715544	.	T	C	5	6	11	0	1	12	0	0
12	3715588	.	C	A	3	4	7	0	0	7	0	0
12	3715638	.	T	C	3	5	8	0	0	8	0	0
12	3715904	.	G	A	4	4	8	0	1	9	0	0
12	3716621	.	G	C	10	6	16	0	0	16	0	0
12	3723786	.	C	G	10	8	18	0	0	18	0	0
12	3723963	.	G	A	0	12	12	0	10	22	0	0
12	3726646	.	T	A	11	11	22	0	1	23	0	0
12	3740717	.	C	A	8	5	13	0	3	16	0	0
12	3740724	.	T	A	10	5	15	0	1	16	0	0
12	3740784	.	C	T	5	7	12	0	0	12	0	0
12	3740803	.	G	A	5	6	11	0	1	12	0	0
12	3740961	.	C	A	1	5	6	0	5	11	0	0
12	3747652	.	G	C	4	7	11	0	0	11	0	0
12	3749502	.	A	G	2	4	6	0	0	6	0	0
12	3749505	.	C	T	0	5	5	0	2	7	0	0
12	3753166	.	C	T	0	2	2	0	7	9	0	0
12	3789489	.	T	A	3	3	6	0	0	6	0	0
12	3789772	.	T	G	5	2	7	0	0	7	0	0
12	3806732	.	C	T	1	4	5	0	0	5	0	0
12	3848176	.	A	G	2	5	7	0	2	9	0	0
12	3851181	.	C	T	1	3	4	0	0	4	0	0
12	3860624	.	G	A	0	3	3	0	3	6	0	0
12	3875396	.	G	T	5	5	10	0	0	10	0	0
12	3875399	.	A	G	5	4	9	0	0	9	0	0
12	3875727	.	T	C	1	3	4	0	0	4	0	0
12	3875892	.	A	G	1	0	1	0	6	7	0	0
12	3880661	.	A	G	7	0	7	0	11	18	0	0
12	3890159	.	G	T	1	3	4	0	1	5	0	0
12	3921813	.	G	A	3	4	7	0	0	7	0	0
12	3921894	.	T	C	1	3	4	0	0	4	0	0
12	3922047	.	A	G	2	2	4	0	1	5	0	0
12	3922068	.	A	T	3	3	6	0	0	6	0	0
12	3922086	.	A	C	4	2	6	0	0	6	0	0
12	3922536	.	A	G	8	7	15	0	7	22	0	0
12	3922549	.	G	A	1	9	10	0	11	21	0	0
12	3922764	.	A	G	6	4	10	0	0	10	0	0
12	3922844	.	G	A	2	3	5	0	0	5	0	0
12	3944488	.	C	G	1	24	25	0	33	58	0	0
12	3944543	.	A	G	24	43	67	0	3	70	0	0
12	3946833	.	G	A	29	28	57	0	7	64	0	0
12	3947276	.	A	G	23	28	51	0	1	52	0	0
12	3947484	.	A	G	18	24	42	0	1	43	0	0
12	3947902	.	G	A	26	24	50	0	1	51	0	0
12	3947929	.	A	G	24	17	41	0	5	46	0	0
12	3948593	.	C	T	27	21	48	0	2	50	0	0
12	3948701	.	G	A	23	27	50	0	3	53	0	0
12	3949194	.	A	G	19	26	45	0	0	45	0	0
12	3953155	.	T	A	11	8	19	0	1	20	0	0
12	3953946	.	A	G	6	16	22	0	2	24	0	0
12	3954003	.	T	G	4	7	11	0	2	13	0	0
12	3956864	.	A	G	12	15	27	0	0	27	0	0
12	3957973	.	A	G	9	14	23	0	0	23	0	0
12	3964631	.	G	A	17	12	29	0	0	29	0	0
12	3964770	.	A	G	13	16	29	0	0	29	0	0
12	3964937	.	C	G	18	11	29	0	1	30	0	0
12	3965002	.	G	T	15	15	30	2	0	32	0	0
12	3965168	.	T	C	8	17	25	0	3	28	0	0
12	3967756	.	A	G	9	14	23	0	1	24	0	0
12	3971655	.	A	G	3	4	7	0	0	7	0	0
12	3974755	.	C	T	0	5	5	0	5	10	0	0
12	3998925	.	T	A	1	2	3	0	0	3	0	0
12	3998961	.	A	T	1	4	5	0	0	5	0	0
12	3999002	.	A	G	1	4	5	0	0	5	0	0
12	3999071	.	C	T	1	3	4	0	1	5	0	0
12	4002615	.	A	T	3	7	10	0	2	12	0	0
12	4002709	.	A	G	5	13	18	0	1	19	0	0
12	4004344	.	C	T	6	7	13	0	0	13	0	0
12	4004448	.	C	T	1	8	9	0	7	16	0	0
12	4009150	.	G	A	7	5	12	0	1	13	0	0
12	4009165	.	A	G	5	5	10	0	0	10	0	0
12	4009202	.	G	A	2	7	9	0	0	9	0	0
12	4009337	.	G	A	5	4	9	0	0	9	0	0
12	4009392	.	C	A	0	7	7	0	5	12	0	0
12	4016206	.	C	T	2	2	4	0	0	4	0	0
12	4020204	.	T	C	2	3	5	0	0	5	0	0
12	4022458	.	A	G	1	2	3	0	0	3	0	0
12	4052361	.	T	G	2	4	6	0	0	6	0	0
12	4064303	.	G	A	1	4	5	0	0	5	0	0
12	4144811	.	A	G	1	2	3	0	0	3	0	0
12	4145017	.	C	T	2	2	4	0	1	5	0	0
12	4220453	.	A	G	1	2	3	0	0	3	0	0
12	4220656	.	T	C	1	3	4	0	0	4	0	0
12	4226155	.	A	G	3	0	3	0	2	5	0	0
12	4227365	.	G	A	3	4	7	0	0	7	0	0
12	4227374	.	A	G	2	2	4	0	1	5	0	0
12	4232001	.	C	T	4	2	6	0	0	6	0	0
12	4232313	.	A	G	2	0	2	0	3	5	0	0
12	4232320	.	C	T	2	3	5	0	2	7	0	0
12	4232425	.	G	A	10	8	18	0	0	18	0	0
12	4232434	.	C	A	8	10	18	0	1	19	0	0
12	4234489	.	G	C	4	8	12	0	1	14	1	0
12	4238122	.	T	C	5	4	9	0	2	11	0	0
12	4238704	.	T	A	3	3	6	0	0	6	0	0
12	4238720	.	T	C	3	3	6	0	0	6	0	0
12	4601361	.	G	A	5	4	9	0	0	9	0	0
12	4601769	.	A	G	31	16	47	0	2	49	0	0
12	4602047	.	T	A	23	8	31	2	0	33	0	0
12	4602245	.	G	A	12	21	33	0	0	33	0	0
12	4602399	.	A	T	20	20	40	0	0	40	0	0
12	4602436	.	A	T	20	14	34	0	0	34	0	0
12	4606669	.	C	T	19	19	38	0	4	42	0	0
12	4609143	.	C	T	14	22	36	0	1	37	0	0
12	4609343	.	C	G	1	14	15	0	19	34	0	0
12	4609364	.	A	G	23	16	39	0	0	39	0	0
12	4609391	.	T	C	27	13	40	0	0	40	0	0
12	4609409	.	C	T	23	15	38	0	0	38	0	0
12	4611092	.	C	T	1	12	13	0	16	29	0	0
12	4611128	.	C	T	17	10	27	0	2	29	0	0
12	4611521	.	T	C	15	0	15	0	23	38	0	0
12	4615281	.	T	C	14	0	14	0	6	20	0	0
12	4616967	.	C	G	7	12	19	0	2	21	0	0
12	4616974	.	G	A	8	11	19	0	0	19	0	0
12	4617024	.	G	T	12	6	18	0	0	18	0	0
12	4617065	.	G	A	13	4	17	0	4	21	0	0
12	4617070	.	T	C	13	7	20	0	3	23	0	0
12	4617102	.	G	C	16	3	19	0	6	25	0	0
12	4617243	.	G	A	13	15	28	0	0	28	0	0
12	4617274	.	G	A	9	12	21	0	2	23	0	0
12	4617286	.	T	C	12	0	12	0	11	23	0	0
12	4619179	.	A	G	1	3	4	0	1	5	0	0
12	4619230	.	G	T	2	5	7	0	0	7	0	0
12	4619553	.	C	T	5	5	10	0	0	10	0	0
12	4621480	.	G	A	3	4	7	0	0	7	0	0
12	4644028	.	A	C	2	2	4	0	0	4	0	0
12	4645291	.	G	T	4	3	7	0	1	8	0	0
12	4648530	.	G	A	2	2	4	0	1	5	0	0
12	4686524	.	G	A	3	2	5	0	0	5	0	0
12	4690311	.	A	G	2	2	4	0	3	7	0	0
12	4690668	.	G	C	1	4	5	0	0	5	0	0
12	4690785	.	T	C	3	5	8	0	1	9	0	0
12	4691146	.	A	G	2	7	9	0	0	9	0	0
12	4712234	.	T	C	4	6	10	0	1	11	0	0
12	4713010	.	C	A	6	7	13	0	1	14	0	0
12	4715953	.	A	G	5	0	5	0	9	14	0	0
12	4715968	.	G	A	6	9	15	0	0	15	0	0
12	4716361	.	A	G	3	7	10	0	0	10	0	0
12	4716375	.	T	C	4	7	11	0	0	11	0	0
12	4720264	.	T	C	12	5	17	0	0	17	0	0
12	4721721	.	C	G	9	10	19	0	0	19	0	0
12	4721727	.	A	G	8	0	8	0	9	17	0	0
12	4724397	.	A	T	8	13	21	0	2	23	0	0
12	4724455	.	A	G	10	0	10	0	12	22	0	0
12	4724464	.	T	C	8	13	21	0	0	21	0	0
12	4724553	.	G	A	16	9	25	0	1	26	0	0
12	4724634	.	G	A	1	5	6	0	5	11	0	0
12	4724710	.	G	A	9	5	14	0	0	14	0	0
12	4724787	.	T	G	9	12	21	0	0	21	0	0
12	4724983	.	G	A	9	16	25	0	0	25	0	0
12	4725170	.	A	T	11	8	19	0	1	20	0	0
12	4725371	.	A	G	12	12	24	0	4	28	0	0
12	4733968	.	C	T	15	10	25	0	1	26	0	0
12	4734008	.	G	T	12	15	27	0	4	31	0	0
12	4734068	.	G	T	19	10	29	0	3	32	0	0
12	4734306	.	A	T	25	10	35	0	1	36	0	0
12	4734312	.	A	G	23	11	34	0	1	35	0	0
12	4734418	.	T	G	17	10	27	0	4	31	0	0
12	4734476	.	T	C	18	1	19	0	12	31	0	0
12	4734925	.	C	T	25	17	42	0	4	46	0	0
12	4734967	.	G	A	25	18	43	0	0	43	0	0
12	4734979	.	C	T	2	14	16	0	25	41	0	0
12	4751860	.	C	T	5	8	13	0	0	13	0	0
12	4752981	.	G	A	7	5	12	0	0	12	0	0
12	4753014	.	A	G	12	8	20	0	0	20	0	0
12	4753020	.	A	G	12	7	19	0	2	21	0	0
12	4753095	.	C	T	10	7	17	0	0	17	0	0
12	4753104	.	C	T	0	6	6	0	11	17	0	0
12	4754639	.	G	T	7	6	13	0	0	13	0	0
12	4961256	.	A	G	2	2	4	0	1	5	0	0
12	4961930	.	A	G	3	3	6	0	0	6	0	0
12	4961955	.	A	C	3	6	9	0	0	9	0	0
12	4962195	.	A	G	5	0	5	0	4	9	0	0
12	4962640	.	C	A	1	3	4	0	0	4	0	0
12	4962643	.	G	T	0	2	2	0	2	4	0	0
12	5044104	.	A	G	4	0	4	0	4	8	0	0
12	5044106	.	G	A	3	4	7	0	1	8	0	0
12	5044462	.	A	T	1	2	3	0	0	3	0	0
12	5044545	.	A	G	1	0	1	0	4	5	0	0
12	5059785	.	T	C	1	3	4	0	0	4	0	0
12	5059868	.	C	G	2	2	4	0	0	4	0	0
12	5064179	.	G	A	0	2	2	0	5	7	0	0
12	5070290	.	G	A	1	7	8	0	0	8	0	0
12	5071104	.	T	A	5	4	9	0	2	11	0	0
12	5084514	.	C	T	1	3	4	0	0	4	0	0
12	5090591	.	T	C	9	5	14	0	0	14	0	0
12	5091368	.	A	T	6	9	15	0	1	16	0	0
12	5115992	.	C	A	1	3	4	0	0	4	0	0
12	5116192	.	A	G	31	28	59	1	1	61	0	0
12	5119802	.	T	C	11	19	30	0	1	31	0	0
12	5180489	.	G	A	4	3	7	0	1	8	0	0
12	5182460	.	T	C	4	3	7	0	0	7	0	0
12	5182718	.	G	A	4	2	6	0	0	6	0	0
12	5185627	.	G	A	3	6	9	0	0	9	0	0
12	5222251	.	T	C	1	2	3	0	0	3	0	0
12	5388700	.	C	T	1	4	5	0	0	5	0	0
12	5398386	.	T	A	1	3	4	0	0	4	0	0
12	5398514	.	T	G	5	2	7	0	0	7	0	0
12	5399803	.	G	A	7	4	11	0	0	11	0	0
12	5399832	.	G	C	7	6	13	0	0	13	0	0
12	5404160	.	T	C	8	0	8	0	11	19	0	0
12	5404181	.	G	C	5	1	6	0	7	13	0	0
12	5404403	.	C	T	0	2	2	0	1	3	0	0
12	5407930	.	A	T	1	3	4	0	1	5	0	0
12	5424239	.	G	A	1	2	3	0	0	3	0	0
12	5424326	.	A	T	2	4	6	0	0	6	0	0
12	5427456	.	T	A	7	5	12	0	0	12	0	0
12	5427491	.	T	G	5	4	9	0	0	9	0	0
12	5451783	.	A	G	2	3	5	0	0	5	0	0
12	5452625	.	A	G	2	3	5	0	0	5	0	0
12	5576096	.	C	T	3	5	8	0	1	9	0	0
12	5599399	.	T	G	1	2	3	0	0	3	0	0
12	5599421	.	C	G	1	3	4	0	0	4	0	0
12	7237756	.	G	A	2	2	4	0	1	5	0	0
12	7610969	.	T	C	4	5	9	0	0	9	0	0
12	7611286	.	T	C	2	3	5	0	0	5	0	0
12	7611526	.	T	C	7	5	12	0	0	12	0	0
12	7611527	.	T	C	8	0	8	0	4	12	0	0
12	7612441	.	T	C	4	2	6	0	1	7	0	0
12	10367980	.	G	A	2	2	4	0	0	4	0	0
12	10493576	.	T	A	1	5	6	0	0	6	0	0
12	10493597	.	G	A	0	6	6	0	0	6	0	0
12	11389082	.	T	C	10	4	14	0	0	14	0	0
12	11389229	.	T	C	12	6	18	0	0	18	0	0
12	11390304	.	T	C	10	3	13	0	0	13	0	0
12	11390306	.	T	C	10	3	13	0	0	13	0	0
12	11390365	.	T	C	2	3	5	0	1	6	0	0
12	13473314	.	A	G	3	3	6	0	0	6	0	0
12	13475225	.	A	G	17	6	23	0	0	23	0	0
12	18529360	.	A	T	1	2	3	0	0	3	0	0
12	18913503	.	A	G	6	5	11	0	0	11	0	0
12	18913602	.	A	G	9	7	16	0	0	16	0	0
12	18913850	.	A	G	12	5	17	0	0	17	0	0
12	19062233	.	A	G	13	5	18	0	1	19	0	0
12	19144930	.	G	A	2	2	4	0	1	5	0	0
12	19339022	.	G	T	1	3	4	0	0	4	0	0
12	24637148	.	G	T	4	2	6	0	1	7	0	0
12	25094200	.	T	C	10	6	16	0	0	16	0	0
12	25094201	.	T	C	8	9	17	0	0	17	0	0
12	25094282	.	T	C	6	3	9	0	1	10	0	0
12	25094300	.	T	C	3	3	6	0	1	7	0	0
12	25094358	.	T	C	6	3	9	0	0	9	0	0
12	25094522	.	T	C	15	6	21	0	0	21	0	0
12	25768836	.	T	C	9	8	17	0	1	18	0	0
12	27229078	.	A	G	21	7	28	0	0	28	0	0
12	28072821	.	C	G	22	12	34	0	1	35	0	0
12	28948117	.	T	C	2	5	7	0	0	7	0	0
12	28949067	.	A	G	3	3	6	0	0	6	0	0
12	28949112	.	C	A	1	7	8	0	1	9	0	0
12	28950009	.	T	C	2	0	2	0	4	6	0	0
12	28950678	.	G	T	3	4	7	0	0	7	0	0
12	28951019	.	C	T	0	3	3	0	2	5	0	0
12	28956533	.	A	G	1	0	1	0	2	3	0	0
12	28956566	.	T	C	2	2	4	0	0	4	0	0
12	28959298	.	C	T	1	4	5	0	0	5	0	0
12	28960284	.	T	C	6	8	14	0	1	15	0	0
12	28960321	.	G	A	4	3	7	0	2	9	0	0
12	28960441	.	C	T	4	4	8	0	1	9	0	0
12	28960481	.	A	G	6	4	10	0	0	10	0	0
12	29063346	.	G	A	3	2	5	0	0	5	0	0
12	29102585	.	T	C	9	4	13	0	2	15	0	0
12	29103041	.	T	A	6	5	11	0	0	11	0	0
12	29173678	.	C	G	2	3	5	0	0	5	0	0
12	29207473	.	G	A	1	2	3	0	2	5	0	0
12	29207533	.	T	C	1	3	4	0	0	4	0	0
12	29207590	.	G	A	0	4	4	0	2	6	0	0
12	29207683	.	G	T	6	2	8	0	1	9	0	0
12	29208099	.	T	G	5	3	8	0	1	9	0	0
12	29209834	.	G	A	4	12	16	0	0	16	0	0
12	29209840	.	A	T	4	10	14	0	1	15	0	0
12	29209947	.	T	G	1	4	5	0	0	5	0	0
12	29210371	.	C	A	12	13	25	0	0	25	0	0
12	29210435	.	C	G	12	7	19	0	2	21	0	0
12	29210600	.	C	T	8	8	16	0	0	16	0	0
12	29210719	.	T	A	14	12	26	0	1	27	0	0
12	29210873	.	T	A	10	3	13	0	1	14	0	0
12	29210917	.	T	C	6	7	13	0	0	13	0	0
12	29211017	.	C	T	5	7	12	0	2	14	0	0
12	29211082	.	G	A	5	8	13	0	2	15	0	0
12	29211195	.	T	A	8	13	21	0	3	24	0	0
12	29211232	.	G	A	2	17	19	0	14	33	0	0
12	29211289	.	T	A	22	10	32	0	0	32	0	0
12	29211292	.	A	G	21	10	31	0	1	32	0	0
12	29223498	.	A	G	5	5	10	0	0	10	0	0
12	29223612	.	T	G	4	3	7	0	0	7	0	0
12	29223751	.	G	C	1	3	4	0	1	5	0	0
12	29223811	.	C	A	1	4	5	0	1	6	0	0
12	29223818	.	A	G	4	2	6	0	0	6	0	0
12	29223847	.	C	T	2	5	7	0	0	7	0	0
12	29223921	.	G	A	3	8	11	0	0	11	0	0
12	29223969	.	A	T	4	5	9	0	0	9	0	0
12	29224065	.	G	A	2	2	4	0	1	5	0	0
12	29224182	.	T	C	2	2	4	0	0	4	0	0
12	29224521	.	A	T	3	6	9	0	0	9	0	0
12	29224609	.	A	C	3	2	5	0	0	5	0	0
12	29224655	.	T	C	2	1	3	0	1	4	0	0
12	29224687	.	C	T	1	2	3	0	1	4	0	0
12	29224836	.	A	T	1	3	4	0	0	4	0	0
12	29244329	.	G	A	0	2	2	0	1	3	0	0
12	29244332	.	C	T	1	2	3	0	0	3	0	0
12	29251251	.	T	C	2	2	4	0	0	4	0	0
12	29251408	.	T	C	1	2	3	0	0	3	0	0
12	29258629	.	G	T	4	1	5	0	0	5	0	0
12	29260865	.	A	G	5	3	8	0	1	9	0	0
12	29262564	.	A	G	4	0	4	0	4	8	0	0
12	29266917	.	T	C	2	9	11	0	0	11	0	0
12	29269576	.	C	A	2	3	5	0	0	5	0	0
12	29269689	.	G	A	3	5	8	0	0	8	0	0
12	29269695	.	A	G	3	0	3	0	4	7	0	0
12	29269726	.	C	G	2	4	6	0	0	6	0	0
12	29269770	.	G	T	0	5	5	0	4	9	0	0
12	29269774	.	T	G	3	5	8	0	0	8	0	0
12	29350773	.	C	A	3	4	7	0	0	7	0	0
12	29351320	.	A	G	17	18	35	0	2	37	0	0
12	29351810	.	A	G	7	18	25	0	1	26	0	0
12	29358277	.	T	C	13	13	26	0	2	28	0	0
12	29358370	.	G	C	8	0	8	0	11	19	0	0
12	29358384	.	A	G	6	7	13	0	3	16	0	0
12	29358418	.	A	G	8	5	13	0	1	14	0	0
12	29624017	.	G	A	12	13	25	0	0	25	0	0
12	29624272	.	C	A	5	3	8	0	0	8	0	0
12	29624611	.	T	C	2	0	2	0	4	6	0	0
12	29806358	.	C	G	1	0	1	0	3	4	0	0
12	29811009	.	A	G	2	0	2	0	4	6	0	0
12	29843460	.	A	G	16	19	35	0	5	40	0	0
12	29844434	.	T	C	9	8	17	0	1	18	0	0
12	29873273	.	C	G	4	10	14	0	2	16	0	0
12	29921114	.	T	G	7	6	13	0	0	13	0	0
12	29947132	.	A	G	2	3	5	0	1	6	0	0
12	29947147	.	C	A	3	5	8	0	0	8	0	0
12	29968087	.	T	C	2	0	2	0	3	5	0	0
12	30192526	.	A	T	4	5	9	0	0	9	0	0
12	30200741	.	C	T	4	10	14	0	1	15	0	0
12	30207912	.	G	A	2	3	5	0	1	6	0	0
12	30208905	.	T	C	2	2	4	0	1	5	0	0
12	30211165	.	T	A	4	4	8	0	0	8	0	0
12	30216034	.	C	A	4	2	6	0	0	6	0	0
12	30216436	.	T	C	6	7	13	0	0	13	0	0
12	30216490	.	T	C	2	6	8	0	0	8	0	0
12	30216693	.	C	T	2	0	2	0	1	3	0	0
12	30216697	.	G	A	1	2	3	0	2	5	0	0
12	30217423	.	T	C	3	2	5	0	0	5	0	0
12	30217447	.	A	G	1	2	3	0	0	3	0	0
12	30217569	.	A	G	5	5	10	0	0	10	0	0
12	30217589	.	A	T	9	5	14	0	0	14	0	0
12	30217705	.	G	A	3	7	10	0	6	16	0	0
12	30217747	.	C	T	7	2	9	0	0	9	0	0
12	30217782	.	T	G	5	3	8	0	0	8	0	0
12	30217783	.	C	A	3	3	6	0	2	8	0	0
12	30217966	.	G	A	3	5	8	0	1	9	0	0
12	30217986	.	C	T	9	3	12	0	0	12	0	0
12	30218069	.	A	T	0	1	1	0	5	6	0	0
12	30218086	.	G	T	3	1	4	0	1	5	0	0
12	30218135	.	C	A	5	5	10	0	0	10	0	0
12	30218150	.	G	A	10	4	14	0	1	15	0	0
12	30218173	.	C	T	6	14	20	0	0	20	0	0
12	30219306	.	A	T	15	21	36	0	1	38	1	0
12	30219739	.	G	A	7	8	15	0	3	18	0	0
12	30219804	.	C	T	12	14	26	2	1	29	0	0
12	30292463	.	A	G	2	0	2	0	3	5	0	0
12	30299061	.	T	C	3	2	5	0	0	5	0	0
12	30299073	.	C	T	4	3	7	0	0	7	0	0
12	30302941	.	A	T	4	10	14	0	1	15	0	0
12	30303081	.	C	A	5	4	9	0	1	10	0	0
12	30304883	.	C	T	6	2	8	0	0	8	0	0
12	30304909	.	A	G	6	3	9	0	1	10	0	0
12	30305983	.	T	C	5	8	13	0	0	13	0	0
12	30307788	.	G	T	5	2	7	0	0	7	0	0
12	30307913	.	G	T	8	14	22	0	4	26	0	0
12	30382341	.	C	T	2	6	8	0	0	8	0	0
12	30383960	.	G	A	0	4	4	0	3	7	0	0
12	30385562	.	C	T	7	9	16	0	0	16	0	0
12	30391136	.	G	A	1	2	3	0	1	4	0	0
12	30418108	.	T	C	11	7	18	0	1	19	0	0
12	30418513	.	C	G	5	8	13	0	1	14	0	0
12	30419123	.	A	T	7	7	14	0	2	16	0	0
12	30419134	.	C	A	10	9	19	0	0	19	0	0
12	30419260	.	T	G	15	12	27	0	1	29	1	0
12	30419646	.	T	C	13	7	20	0	1	21	0	0
12	30419655	.	T	C	11	7	18	0	0	18	0	0
12	30419695	.	T	C	6	6	12	0	2	14	0	0
12	30419727	.	A	G	5	3	8	0	0	8	0	0
12	30442406	.	C	A	5	3	8	0	0	8	0	0
12	30442783	.	G	A	1	6	7	0	0	7	0	0
12	30443462	.	T	C	2	2	4	0	0	4	0	0
12	30459006	.	G	A	3	2	5	0	0	5	0	0
12	30459404	.	G	A	2	2	4	0	1	5	0	0
12	30459422	.	A	C	1	2	3	0	0	3	0	0
12	30459584	.	C	T	5	2	7	0	0	7	0	0
12	30459585	.	C	T	5	2	7	0	0	7	0	0
12	30460333	.	C	A	3	2	5	0	0	5	0	0
12	30460656	.	T	A	2	1	3	0	1	4	0	0
12	30461485	.	T	A	1	2	3	0	0	3	0	0
12	30741328	.	T	G	3	5	8	0	0	8	0	0
12	30796306	.	C	T	2	2	4	0	0	4	0	0
12	30796322	.	C	A	2	2	4	0	0	4	0	0
12	30796345	.	C	T	1	2	3	0	1	4	0	0
12	30798079	.	G	A	4	5	9	0	0	9	0	0
12	30798085	.	A	T	5	4	9	0	0	9	0	0
12	30800128	.	G	A	4	6	10	0	0	10	0	0
12	30803196	.	T	C	7	2	9	0	1	10	0	0
12	30805359	.	T	C	4	2	6	0	0	6	0	0
12	30806928	.	G	T	0	5	5	0	5	10	0	0
12	30807038	.	A	G	7	13	20	0	0	20	0	0
12	30807290	.	A	G	5	4	9	0	0	9	0	0
12	30807330	.	T	A	4	5	9	0	1	10	0	0
12	30807458	.	C	T	7	4	11	0	1	12	0	0
12	30807494	.	G	A	5	4	9	0	0	9	0	0
12	30807504	.	A	C	6	2	8	0	1	9	0	0
12	30807714	.	A	G	11	3	14	1	0	15	0	0
12	30807985	.	T	C	3	2	5	0	1	6	0	0
12	30807988	.	A	G	2	3	5	0	0	5	0	0
12	30808051	.	A	G	1	8	9	0	0	9	0	0
12	30808094	.	C	T	5	11	16	0	1	17	0	0
12	30808150	.	T	A	5	11	16	0	1	17	0	0
12	30808342	.	A	T	7	8	15	0	1	16	0	0
12	30808531	.	G	C	9	6	15	0	1	16	0	0
12	30808812	.	A	G	5	0	5	0	3	8	0	0
12	30808817	.	T	G	5	5	10	0	0	10	0	0
12	30979815	.	A	C	14	14	28	0	3	31	0	0
12	30980566	.	G	A	34	22	56	0	1	57	0	0
12	30981795	.	G	A	21	31	52	0	0	52	0	0
12	30986452	.	G	A	27	26	53	1	2	56	0	0
12	31012667	.	C	T	1	3	4	0	0	4	0	0
12	31102981	.	A	G	2	5	7	0	0	7	0	0
12	31435977	.	T	A	13	12	25	0	0	25	0	0
12	31438056	.	G	T	12	10	22	0	0	22	0	0
12	31438352	.	A	T	4	6	10	0	1	11	0	0
12	31438440	.	C	A	3	5	8	0	0	8	0	0
12	31520603	.	T	C	1	4	5	0	0	5	0	0
12	31528169	.	G	C	0	2	2	0	3	5	0	0
12	31531950	.	T	G	2	4	6	1	2	9	0	0
12	31532342	.	A	C	7	4	11	0	0	11	0	0
12	31532371	.	G	A	1	3	4	0	8	12	0	0
12	31532577	.	T	C	5	6	11	0	0	11	0	0
12	31532638	.	A	C	9	3	12	0	0	12	0	0
12	31532715	.	T	C	7	6	13	1	0	14	0	0
12	31533505	.	A	T	3	3	6	0	0	6	0	0
12	31533510	.	T	A	3	3	6	0	0	6	0	0
12	31533898	.	A	G	3	4	7	0	1	8	0	0
12	31533899	.	A	G	3	4	7	0	1	8	0	0
12	31629611	.	C	T	6	3	9	0	0	9	0	0
12	31630829	.	G	A	1	9	10	0	8	18	0	0
12	31631082	.	T	C	3	5	8	0	0	8	0	0
12	31631116	.	A	T	4	1	5	0	1	6	0	0
12	31631190	.	G	T	1	3	4	0	0	4	0	0
12	31665096	.	G	A	0	2	2	0	1	3	0	0
12	31694713	.	C	T	2	1	3	0	1	4	0	0
12	31704077	.	A	C	5	6	11	0	0	11	0	0
12	31704458	.	G	A	0	3	3	0	2	5	0	0
12	31704485	.	A	G	2	0	2	0	5	7	0	0
12	31704548	.	T	C	2	3	5	0	0	5	0	0
12	31708020	.	C	T	2	3	5	0	0	5	0	0
12	31708025	.	G	A	2	3	5	0	0	5	0	0
12	31708082	.	G	A	3	3	6	0	0	6	0	0
12	31708125	.	C	A	3	2	5	0	0	5	0	0
12	31708793	.	G	A	1	2	3	0	0	3	0	0
12	31709852	.	A	T	1	5	6	0	0	6	0	0
12	31709902	.	G	A	5	3	8	0	0	8	0	0
12	31709964	.	G	T	7	2	9	0	0	9	0	0
12	31720799	.	C	T	20	21	41	0	3	44	0	0
12	31721486	.	G	A	14	8	22	0	1	23	0	0
12	31722593	.	G	T	8	12	20	0	3	23	0	0
12	31722811	.	G	T	6	7	13	0	3	16	0	0
12	31722875	.	A	C	23	1	24	0	20	44	0	0
12	31724245	.	A	C	18	18	36	0	1	37	0	0
12	31724252	.	C	T	17	21	38	0	0	38	0	0
12	31729236	.	G	A	2	3	5	0	1	6	0	0
12	31729441	.	A	C	1	3	4	0	0	4	0	0
12	31729455	.	G	T	1	3	4	0	0	4	0	0
12	31741463	.	C	T	2	5	7	0	0	7	0	0
12	31743995	.	C	T	4	2	6	0	1	7	0	0
12	31753752	.	C	T	5	6	11	0	0	11	0	0
12	31753755	.	C	T	5	5	10	0	0	10	0	0
12	31764523	.	T	C	12	6	18	0	2	20	0	0
12	31764526	.	C	A	13	6	19	0	1	20	0	0
12	31765407	.	G	A	11	12	23	0	2	25	0	0
12	31765517	.	T	C	6	3	9	0	1	10	0	0
12	31765540	.	T	G	10	4	14	0	0	14	0	0
12	31783185	.	G	A	1	3	4	0	2	6	0	0
12	31785314	.	C	T	4	2	6	0	0	6	0	0
12	31785545	.	G	A	5	2	7	0	0	7	0	0
12	31789799	.	C	T	9	14	23	0	4	27	0	0
12	31794655	.	G	A	8	11	19	0	1	20	0	0
12	31909450	.	T	C	3	2	5	0	0	5	0	0
12	31919122	.	C	T	1	2	3	0	0	3	0	0
12	31919143	.	T	G	1	2	3	0	0	3	0	0
12	32039443	.	C	T	2	12	14	0	12	26	0	0
12	32039527	.	A	G	18	5	23	0	1	24	0	0
12	32039635	.	A	C	19	13	32	0	0	32	0	0
12	32039678	.	C	T	20	19	39	0	2	41	0	0
12	32039937	.	G	A	22	10	32	0	2	34	0	0
12	32039958	.	T	C	22	0	22	0	13	35	0	0
12	32040093	.	G	A	24	17	41	0	2	43	0	0
12	32045155	.	G	A	16	12	28	0	1	29	0	0
12	32045212	.	T	C	19	0	19	0	8	27	0	0
12	32051434	.	C	A	11	6	17	0	0	17	0	0
12	32051488	.	G	A	9	13	22	0	0	22	0	0
12	32066061	.	C	A	12	5	17	0	2	19	0	0
12	32068470	.	C	A	3	2	5	0	0	5	0	0
12	32068487	.	A	G	3	4	7	0	0	7	0	0
12	32068700	.	A	T	5	5	10	0	0	10	0	0
12	32160773	.	A	G	3	0	3	0	4	7	0	0
12	32160839	.	A	G	6	3	9	0	1	10	0	0
12	32161043	.	T	C	5	4	9	0	0	9	0	0
12	32162360	.	T	C	7	7	14	1	0	15	0	0
12	32162411	.	T	A	7	4	11	0	1	12	0	0
12	32188729	.	C	T	0	2	2	0	1	3	0	0
12	32373490	.	C	T	1	2	3	0	0	3	0	0
12	32389692	.	C	T	5	2	7	0	0	7	0	0
12	32389713	.	G	T	3	3	6	0	0	6	0	0
12	32976148	.	T	C	7	5	12	0	0	12	0	0
12	33151402	.	G	A	3	8	11	0	10	21	0	0
12	33151453	.	C	T	8	11	19	0	0	19	0	0
12	33245427	.	G	A	8	6	14	0	1	15	0	0
12	33245677	.	G	A	7	2	9	0	1	10	0	0
12	33245688	.	G	T	2	9	11	0	0	11	0	0
12	33246010	.	A	T	4	11	15	0	1	16	0	0
12	33247295	.	T	C	15	21	36	0	1	37	0	0
12	33247611	.	T	A	18	11	29	0	1	31	1	0
12	33248025	.	G	A	3	22	25	0	26	51	0	0
12	33248193	.	C	A	25	27	52	0	2	54	0	0
12	33248343	.	G	A	5	19	24	0	28	52	0	0
12	33320944	.	C	T	9	9	18	0	0	18	0	0
12	33329791	.	C	G	8	17	25	0	3	28	0	0
12	33331496	.	C	A	13	12	25	0	3	28	0	0
12	33331523	.	T	C	14	10	24	0	0	24	0	0
12	33331541	.	A	C	3	5	8	0	13	21	0	0
12	33331691	.	T	G	10	7	17	0	1	18	0	0
12	33331724	.	C	T	10	8	18	0	0	18	0	0
12	33335714	.	A	C	18	15	33	0	2	35	0	0
12	33335739	.	C	T	7	13	20	0	2	22	0	0
12	33335770	.	G	A	2	16	18	0	8	26	0	0
12	33335904	.	T	G	22	7	29	0	1	30	0	0
12	33335949	.	C	T	22	6	28	0	3	31	0	0
12	33336044	.	T	G	25	1	26	0	28	54	0	0
12	33336073	.	G	A	1	24	25	0	22	47	0	0
12	33336203	.	G	A	16	23	39	3	0	42	0	0
12	33336271	.	G	A	1	18	19	3	7	29	0	0
12	33350289	.	C	T	1	2	3	0	2	5	0	0
12	33351044	.	T	C	5	3	8	0	1	9	0	0
12	33351045	.	T	C	1	6	7	0	0	7	0	0
12	33351441	.	T	A	5	4	9	0	1	10	0	0
12	33352595	.	C	T	1	3	4	0	2	6	0	0
12	33352601	.	C	T	1	4	5	0	1	6	0	0
12	33352709	.	A	G	2	4	6	0	0	6	0	0
12	33352742	.	G	A	1	2	3	0	0	3	0	0
12	33352805	.	T	G	1	2	3	0	1	4	0	0
12	33352816	.	A	G	1	3	4	0	0	4	0	0
12	33352862	.	C	T	1	2	3	0	0	3	0	0
12	33372076	.	T	C	2	2	4	0	0	4	0	0
12	33386322	.	C	T	1	3	4	0	0	4	0	0
12	33386371	.	G	C	1	2	3	0	0	3	0	0
12	33391457	.	G	A	1	2	3	0	0	3	0	0
12	33434946	.	G	A	1	6	7	0	1	8	0	0
12	33437562	.	A	G	2	3	5	0	0	5	0	0
12	33437882	.	G	A	0	7	7	0	5	12	0	0
12	33438250	.	G	A	2	3	5	0	4	9	0	0
12	33439860	.	C	A	7	6	13	0	0	13	0	0
12	33440022	.	C	T	4	9	13	0	0	13	0	0
12	33440025	.	T	C	4	9	13	0	0	13	0	0
12	33440135	.	A	G	7	14	21	0	0	21	0	0
12	33440146	.	A	G	5	0	5	0	11	16	0	0
12	33440200	.	C	T	11	9	20	0	1	21	0	0
12	33442578	.	C	T	2	10	12	0	1	13	0	0
12	33442675	.	G	A	3	6	9	1	1	11	0	0
12	33442924	.	G	A	4	6	10	0	0	10	0	0
12	33444839	.	T	C	11	10	21	0	2	23	0	0
12	33448124	.	T	A	13	18	31	0	1	32	0	0
12	33448253	.	C	T	16	4	20	0	0	20	0	0
12	33448411	.	C	T	6	3	9	0	0	9	0	0
12	33448446	.	G	A	5	2	7	0	0	7	0	0
12	33448477	.	A	G	3	1	4	0	2	6	0	0
12	33448528	.	C	G	4	2	6	0	0	6	0	0
12	33449229	.	T	A	21	14	35	0	1	37	1	0
12	33449902	.	T	A	13	6	19	2	2	23	0	0
12	33449924	.	A	G	12	2	14	1	9	24	0	0
12	33450194	.	G	A	5	14	19	0	25	44	0	0
12	33450332	.	T	C	16	15	31	0	3	34	0	0
12	33450368	.	T	A	10	11	21	0	0	21	0	0
12	33450429	.	G	A	9	6	15	0	0	15	0	0
12	33450435	.	A	G	6	1	7	0	6	13	0	0
12	33453734	.	T	A	4	5	9	0	0	9	0	0
12	33461576	.	G	A	0	2	2	0	3	5	0	0
12	33467556	.	A	C	2	5	7	0	2	9	0	0
12	33469083	.	T	C	2	7	9	0	0	9	0	0
12	33472148	.	A	T	10	10	20	0	0	20	0	0
12	33473481	.	G	A	2	16	18	0	15	33	0	0
12	33473486	.	C	T	13	16	29	0	3	32	0	0
12	33473678	.	A	C	3	6	9	1	0	10	0	0
12	33473806	.	C	A	8	5	13	0	0	13	0	0
12	33473844	.	C	T	5	10	15	0	0	15	0	0
12	33473874	.	A	T	6	7	13	0	0	13	0	0
12	33536637	.	A	G	3	5	8	0	1	13	4	0
12	33536658	.	A	G	2	0	2	0	7	9	0	0
12	33536717	.	C	T	4	4	8	0	0	8	0	0
12	33536722	.	A	C	6	4	10	0	0	10	0	0
12	33536754	.	A	G	8	7	15	0	0	15	0	0
12	33561661	.	C	A	7	8	15	0	0	15	0	0
12	33561662	.	C	T	7	6	13	0	2	15	0	0
12	33568017	.	A	G	8	6	14	0	3	17	0	0
12	33570318	.	G	A	6	4	10	0	1	11	0	0
12	33573002	.	G	T	4	5	9	0	0	9	0	0
12	33574748	.	G	A	5	3	8	0	2	10	0	0
12	33574787	.	C	T	2	3	5	0	1	6	0	0
12	33602776	.	C	T	11	17	28	0	1	29	0	0
12	33603386	.	G	T	7	9	16	0	2	18	0	0
12	33603611	.	C	T	12	13	25	0	3	28	0	0
12	33603997	.	C	T	4	2	6	0	0	6	0	0
12	33604298	.	A	G	6	7	13	0	0	13	0	0
12	33604364	.	C	A	5	6	11	0	0	11	0	0
12	33604445	.	G	A	3	5	8	0	1	9	0	0
12	33606475	.	T	G	6	3	9	0	0	9	0	0
12	33606478	.	A	G	5	3	8	0	1	9	0	0
12	33738927	.	T	G	6	6	12	0	2	14	0	0
12	33738956	.	A	C	5	7	12	0	0	12	0	0
12	33743789	.	A	G	3	4	7	0	0	7	0	0
12	33744549	.	G	A	3	5	8	0	0	8	0	0
12	33763334	.	T	C	2	0	2	0	2	4	0	0
12	33790234	.	G	A	1	2	3	0	0	3	0	0
12	33794681	.	G	A	3	2	5	0	1	6	0	0
12	33807357	.	C	T	1	4	5	0	0	5	0	0
12	33813260	.	A	T	4	6	10	0	0	10	0	0
12	33817399	.	A	T	8	12	20	0	1	21	0	0
12	33818654	.	A	G	10	13	23	0	2	25	0	0
12	33818925	.	C	T	7	4	11	0	1	12	0	0
12	33818973	.	C	G	2	4	6	0	0	6	0	0
12	33819078	.	C	G	1	2	3	0	0	3	0	0
12	33832286	.	G	A	1	3	4	0	0	4	0	0
12	33832529	.	G	A	1	4	5	0	0	5	0	0
12	33832952	.	T	G	1	2	3	0	0	3	0	0
12	33832985	.	G	A	1	2	3	0	0	3	0	0
12	33912518	.	G	C	0	5	5	1	3	9	0	0
12	33912635	.	T	C	2	3	5	0	0	5	0	0
12	33912656	.	C	T	2	2	4	0	0	4	0	0
12	33912758	.	C	A	3	5	8	0	0	8	0	0
12	33912946	.	C	A	4	6	10	0	0	10	0	0
12	33912982	.	G	T	9	7	16	0	2	18	0	0
12	33913000	.	G	A	9	8	17	0	0	17	0	0
12	33913154	.	G	A	1	4	5	0	0	5	0	0
12	33913578	.	G	A	0	6	6	0	3	9	0	0
12	33913698	.	T	A	2	4	6	0	1	7	0	0
12	33913705	.	T	C	2	4	6	0	0	6	0	0
12	33913805	.	C	A	1	4	5	1	0	6	0	0
12	33913853	.	T	C	2	3	5	0	0	5	0	0
12	33913856	.	T	C	2	4	6	0	0	6	0	0
12	33913964	.	T	G	7	9	16	0	0	16	0	0
12	33914967	.	A	C	4	6	10	0	0	10	0	0
12	33914985	.	G	T	7	2	9	0	0	9	0	0
12	33919851	.	C	T	1	5	6	0	1	7	0	0
12	33920483	.	G	A	5	3	8	0	0	8	0	0
12	33920627	.	T	C	3	6	9	0	1	10	0	0
12	33920693	.	G	T	4	6	10	0	1	11	0	0
12	33920826	.	T	C	4	6	10	0	0	10	0	0
12	33933495	.	A	G	12	1	13	0	9	22	0	0
12	33933979	.	C	T	14	17	31	0	1	32	0	0
12	33934082	.	G	A	2	13	15	0	10	25	0	0
12	33934099	.	G	A	0	12	12	0	12	24	0	0
12	33934768	.	G	T	21	17	38	0	3	41	0	0
12	33935010	.	C	A	14	12	26	0	1	27	0	0
12	33935019	.	G	T	1	10	11	0	15	26	0	0
12	33966470	.	G	A	13	8	21	0	1	22	0	0
12	33966499	.	C	T	0	12	12	0	15	27	0	0
12	33966790	.	T	G	17	33	50	0	5	55	0	0
12	33966905	.	C	T	22	15	37	0	0	37	0	0
12	33967283	.	C	T	17	20	37	0	3	40	0	0
12	33967897	.	A	C	6	3	9	0	0	9	0	0
12	33967918	.	A	G	6	3	9	0	2	11	0	0
12	33967968	.	T	G	8	11	19	0	1	20	0	0
12	33968027	.	T	A	20	18	38	0	2	40	0	0
12	33968073	.	T	A	31	10	41	0	3	44	0	0
12	33968145	.	C	T	17	13	30	0	1	31	0	0
12	33968419	.	C	A	1	17	18	0	21	39	0	0
12	33971333	.	G	T	14	9	23	0	0	23	0	0
12	33971461	.	T	C	8	8	16	0	3	19	0	0
12	33972294	.	G	T	19	16	35	0	2	37	0	0
12	33977916	.	C	T	1	2	3	0	0	3	0	0
12	33987978	.	A	T	3	3	6	1	0	7	0	0
12	33988094	.	T	A	1	2	3	0	0	3	0	0
12	33991521	.	G	A	17	17	34	0	3	37	0	0
12	33991622	.	T	C	19	13	32	0	5	37	0	0
12	33991781	.	T	C	19	27	46	0	4	50	0	0
12	33991867	.	A	T	32	21	53	0	2	55	0	0
12	33991882	.	T	A	27	29	56	0	0	56	0	0
12	33991987	.	A	C	24	21	45	0	0	46	1	0
12	33992376	.	A	G	19	10	29	0	2	31	0	0
12	33992418	.	G	T	28	24	52	0	1	53	0	0
12	33993152	.	A	T	21	20	41	0	2	43	0	0
12	33993320	.	C	T	3	14	17	0	17	34	0	0
12	33997285	.	C	T	8	5	13	0	0	13	0	0
12	33997303	.	T	A	4	9	13	0	0	13	0	0
12	33997324	.	G	A	8	5	13	0	1	14	0	0
12	34127785	.	C	T	2	3	5	0	0	5	0	0
12	34167972	.	C	T	2	4	6	0	0	6	0	0
12	34179962	.	C	T	8	8	16	0	0	16	0	0
12	34180040	.	C	A	8	6	14	0	0	14	0	0
12	34187335	.	C	T	9	9	18	0	1	19	0	0
12	34187341	.	G	T	0	10	10	0	11	21	0	0
12	34187407	.	A	G	8	0	8	0	9	17	0	0
12	34192041	.	G	A	0	4	4	0	8	12	0	0
12	34192387	.	C	A	3	3	6	0	0	6	0	0
12	34192454	.	C	T	4	3	7	0	0	7	0	0
12	34192551	.	C	T	6	6	12	0	1	13	0	0
12	34192679	.	T	C	5	10	15	0	0	15	0	0
12	34192816	.	T	G	1	0	1	0	2	3	0	0
12	34192869	.	C	T	3	3	6	0	0	6	0	0
12	34192870	.	G	A	0	2	2	0	4	6	0	0
12	34209402	.	T	A	4	5	9	0	1	10	0	0
12	34209468	.	G	C	1	0	1	0	4	5	0	0
12	34276956	.	G	A	2	4	6	0	0	6	0	0
12	34277081	.	C	G	1	2	3	0	0	3	0	0
12	34396996	.	A	G	4	0	4	0	2	6	0	0
12	34564322	.	T	G	6	4	10	0	1	11	0	0
12	34564586	.	A	G	1	2	3	0	1	4	0	0
12	34564786	.	G	A	9	4	13	0	0	13	0	0
12	34565787	.	T	A	3	4	7	0	0	7	0	0
12	34577306	.	C	T	1	4	5	0	0	5	0	0
12	34580552	.	A	G	3	5	8	0	0	8	0	0
12	34609979	.	A	T	1	2	3	0	0	3	0	0
12	34610012	.	G	A	0	2	2	0	1	3	0	0
12	34819743	.	C	T	1	2	3	0	0	3	0	0
12	34820013	.	G	A	3	4	7	0	0	7	0	0
12	34820046	.	A	G	4	4	8	0	0	8	0	0
12	34820065	.	C	T	2	3	5	0	0	5	0	0
12	34820521	.	G	C	5	6	11	0	0	11	0	0
12	34820574	.	C	A	3	8	11	0	0	11	0	0
12	34820760	.	C	T	2	3	5	0	0	5	0	0
12	34821135	.	T	C	5	4	9	0	0	9	0	0
12	34821374	.	T	C	3	2	5	0	0	5	0	0
12	34821513	.	G	T	1	3	4	0	1	5	0	0
12	34821732	.	C	T	3	2	5	0	0	5	0	0
12	34840207	.	T	G	2	2	4	0	1	5	0	0
12	34840421	.	C	T	3	2	5	0	0	5	0	0
12	34841886	.	A	T	2	4	6	0	2	8	0	0
12	34845615	.	C	A	7	5	12	0	0	12	0	0
12	34845623	.	C	G	6	4	10	0	0	10	0	0
12	34845793	.	T	A	8	6	14	0	1	15	0	0
12	34845923	.	C	A	3	5	8	0	0	8	0	0
12	34845942	.	A	G	7	5	12	0	0	12	0	0
12	34846091	.	G	A	5	6	11	0	1	12	0	0
12	34846175	.	A	G	7	16	23	0	0	23	0	0
12	34846191	.	A	G	7	16	23	0	0	23	0	0
12	34846254	.	A	G	5	8	13	0	0	13	0	0
12	34846577	.	A	G	3	3	6	1	0	7	0	0
12	34847137	.	T	C	2	4	6	0	0	6	0	0
12	34847139	.	G	T	2	4	6	0	0	6	0	0
12	34847247	.	T	C	2	3	5	0	0	5	0	0
12	34847446	.	C	G	10	13	23	0	0	23	0	0
12	34851117	.	G	A	6	4	10	0	0	10	0	0
12	34859100	.	T	A	2	3	5	0	0	5	0	0
12	34859129	.	A	C	2	3	5	0	0	5	0	0
12	34876420	.	G	A	2	4	6	0	0	6	0	0
12	34876712	.	A	G	4	4	8	0	0	8	0	0
12	34876837	.	G	A	7	4	11	0	0	11	0	0
12	34877064	.	G	A	2	3	5	0	0	5	0	0
12	34891780	.	G	A	0	3	3	0	6	9	0	0
12	34891911	.	A	T	5	4	9	0	1	10	0	0
12	34892024	.	A	G	7	3	10	0	0	10	0	0
12	34892087	.	C	A	5	3	8	1	0	9	0	0
12	34981205	.	G	A	0	5	5	0	3	8	0	0
12	35012004	.	C	T	6	3	9	0	1	10	0	0
12	35012127	.	T	C	6	13	19	1	0	20	0	0
12	35018127	.	C	T	16	15	31	0	1	32	0	0
12	35018320	.	T	G	13	2	15	0	17	32	0	0
12	35051265	.	C	T	9	11	20	0	3	23	0	0
12	35099532	.	G	T	3	5	8	0	1	9	0	0
12	35103300	.	C	T	2	2	4	0	1	5	0	0
12	35103606	.	T	C	7	0	7	0	4	11	0	0
12	35119833	.	C	A	2	4	6	0	0	6	0	0
12	35146537	.	G	A	0	2	2	0	1	3	0	0
12	35167333	.	A	G	3	3	6	0	1	7	0	0
12	35189264	.	G	T	4	4	8	0	0	8	0	0
12	35189295	.	C	T	2	4	6	0	1	7	0	0
12	35191841	.	T	A	3	9	12	0	0	12	0	0
12	35191856	.	C	T	10	5	15	0	0	15	0	0
12	35325811	.	C	T	3	3	6	0	0	6	0	0
12	35328139	.	C	T	2	5	7	0	0	7	0	0
12	35332283	.	T	A	2	4	6	0	0	6	0	0
12	35334652	.	C	G	5	8	13	0	1	14	0	0
12	35339212	.	A	G	8	3	11	0	0	11	0	0
12	35339263	.	A	T	9	5	14	0	0	14	0	0
12	35346498	.	G	A	26	25	51	0	3	54	0	0
12	35346597	.	A	T	39	25	64	0	2	66	0	0
12	35346842	.	T	C	17	25	42	0	3	45	0	0
12	35346873	.	C	T	21	30	51	0	2	53	0	0
12	35347002	.	A	T	20	25	45	0	3	48	0	0
12	35347078	.	G	A	31	31	62	0	0	62	0	0
12	35347084	.	C	T	1	29	30	0	33	63	0	0
12	35347318	.	C	T	24	32	56	0	3	59	0	0
12	35347485	.	T	G	24	17	41	0	5	46	0	0
12	35347795	.	C	T	0	10	10	0	5	15	0	0
12	35347951	.	A	G	27	16	43	0	1	44	0	0
12	35350686	.	G	A	20	11	31	0	4	35	0	0
12	35351392	.	G	T	14	10	24	1	5	30	0	0
12	35381729	.	T	C	6	0	6	0	15	21	0	0
12	35386919	.	A	G	4	8	12	0	0	12	0	0
12	35543736	.	T	G	8	9	17	0	0	17	0	0
12	35543971	.	T	G	11	16	27	0	0	27	0	0
12	35544320	.	T	G	7	12	19	0	0	19	0	0
12	35544460	.	A	G	7	11	18	0	0	18	0	0
12	35544596	.	C	A	7	7	14	0	0	14	0	0
12	35544968	.	A	G	12	12	24	0	1	25	0	0
12	35551120	.	G	A	3	2	5	0	0	5	0	0
12	35556821	.	G	C	2	2	4	0	0	4	0	0
12	35559614	.	T	G	2	3	5	0	0	5	0	0
12	35568303	.	C	G	4	2	6	0	0	6	0	0
12	35593188	.	C	T	22	17	39	0	0	39	0	0
12	35593469	.	T	A	12	5	17	0	0	17	0	0
12	35593729	.	A	G	13	0	13	0	8	21	0	0
12	35594069	.	T	A	14	14	28	0	1	29	0	0
12	35594154	.	C	T	12	15	27	0	2	29	0	0
12	35594169	.	C	T	11	12	23	0	0	23	0	0
12	35594436	.	C	T	12	11	23	0	1	24	0	0
12	35594474	.	A	G	16	18	34	0	0	34	0	0
12	35594495	.	G	A	1	15	16	0	13	29	0	0
12	35594512	.	T	C	18	16	34	0	0	34	0	0
12	35594541	.	C	A	20	13	33	0	0	33	0	0
12	35594605	.	C	T	14	20	34	0	5	39	0	0
12	35594623	.	T	A	19	19	38	0	1	39	0	0
12	35674952	.	G	A	8	5	13	0	1	14	0	0
12	35689209	.	C	T	9	3	12	0	1	13	0	0
12	35689210	.	A	G	9	4	13	0	1	14	0	0
12	35704426	.	G	T	25	19	44	0	1	45	0	0
12	35704435	.	G	T	31	18	49	0	1	50	0	0
12	35704735	.	A	G	15	11	26	0	1	27	0	0
12	35704852	.	G	A	15	17	32	0	0	32	0	0
12	35704921	.	A	C	16	14	30	0	2	32	0	0
12	35704996	.	T	G	21	9	30	0	1	31	0	0
12	35705131	.	C	T	25	11	36	0	1	37	0	0
12	35705140	.	A	C	21	0	21	0	8	30	1	0
12	35705224	.	A	G	15	14	29	0	3	32	0	0
12	35705252	.	T	G	17	15	32	0	0	32	0	0
12	35705323	.	G	A	13	15	28	0	0	28	0	0
12	35705367	.	C	T	1	12	13	0	13	26	0	0
12	35705565	.	C	T	2	8	10	0	10	20	0	0
12	35705606	.	A	T	4	12	16	0	0	16	0	0
12	35705661	.	T	C	4	12	16	0	1	17	0	0
12	35705926	.	C	T	13	14	27	0	1	28	0	0
12	35706091	.	C	T	14	9	23	0	2	25	0	0
12	35706124	.	A	G	12	6	18	0	2	20	0	0
12	35706253	.	A	T	5	9	14	0	0	14	0	0
12	35706304	.	A	G	7	7	14	0	0	14	0	0
12	35706524	.	G	A	7	9	16	0	0	16	0	0
12	35706568	.	C	T	10	14	24	0	2	26	0	0
12	35706859	.	C	T	0	12	12	0	4	17	1	0
12	35706970	.	G	T	7	7	14	0	0	14	0	0
12	35707155	.	C	T	5	6	11	0	0	11	0	0
12	35707171	.	T	C	6	6	12	0	0	12	0	0
12	35707225	.	G	A	4	5	9	0	1	10	0	0
12	35707537	.	A	G	6	3	9	0	0	9	0	0
12	35707636	.	G	A	4	3	7	0	0	7	0	0
12	35707660	.	A	C	2	3	5	0	1	6	0	0
12	35707747	.	A	G	4	2	6	0	0	6	0	0
12	35707963	.	T	C	3	2	5	0	10	15	0	0
12	35707987	.	G	A	2	7	9	0	1	10	0	0
12	35708235	.	A	G	6	2	8	0	1	9	0	0
12	35708950	.	G	A	2	6	8	0	0	8	0	0
12	35709007	.	G	A	2	6	8	0	0	8	0	0
12	35709028	.	A	G	3	4	7	0	0	7	0	0
12	35716116	.	T	G	1	4	5	0	0	5	0	0
12	35813466	.	A	G	1	2	3	0	0	3	0	0
12	35837354	.	C	T	0	3	3	0	3	6	0	0
12	35837425	.	T	A	6	6	12	0	0	12	0	0
12	35837468	.	C	A	7	3	10	0	1	11	0	0
12	35837499	.	G	C	6	3	9	0	0	9	0	0
12	35837503	.	T	G	6	2	8	0	1	9	0	0
12	35837629	.	T	A	7	2	9	0	0	9	0	0
12	35837828	.	T	A	3	5	8	0	0	8	0	0
12	35837842	.	G	A	4	3	7	0	0	7	0	0
12	35838070	.	T	A	4	3	7	0	0	7	0	0
12	35838102	.	A	G	3	2	5	0	1	6	0	0
12	35838537	.	G	C	1	3	4	0	0	4	0	0
12	35838542	.	A	C	1	2	3	0	0	3	0	0
12	35838836	.	G	T	1	3	4	0	0	4	0	0
12	35838882	.	A	C	3	5	8	0	0	8	0	0
12	35839090	.	C	T	0	3	3	0	4	7	0	0
12	35839159	.	C	T	3	3	6	0	0	6	0	0
12	35839165	.	C	G	3	3	6	0	0	6	0	0
12	35839261	.	C	A	6	2	8	0	1	9	0	0
12	35839680	.	G	A	3	3	6	0	2	8	0	0
12	35839879	.	C	A	0	5	5	0	6	11	0	0
12	35839919	.	C	G	1	3	4	0	4	8	0	0
12	35840003	.	T	C	4	0	4	0	2	6	0	0
12	35840008	.	C	A	4	2	6	0	0	6	0	0
12	35840543	.	A	C	9	4	13	0	0	13	0	0
12	35840717	.	A	G	5	4	9	0	0	9	0	0
12	35841438	.	G	A	3	2	5	0	0	5	0	0
12	35841457	.	G	A	5	1	6	0	2	8	0	0
12	35847493	.	A	T	1	3	4	0	0	4	0	0
12	35847535	.	T	C	2	2	4	0	0	4	0	0
12	35847538	.	C	T	2	2	4	0	0	4	0	0
12	35875766	.	A	G	1	2	3	0	0	3	0	0
12	35980632	.	T	C	3	2	5	0	0	5	0	0
12	35980758	.	C	T	3	6	9	0	0	10	1	0
12	35980764	.	T	C	3	6	9	0	0	9	0	0
12	35980817	.	T	A	2	3	5	0	0	5	0	0
12	35980917	.	T	G	8	7	15	0	1	16	0	0
12	35981031	.	T	A	1	2	3	0	0	3	0	0
12	35981206	.	T	C	3	0	3	0	6	9	0	0
12	35981260	.	T	A	2	7	9	0	0	9	0	0
12	35981627	.	C	T	5	5	10	0	0	10	0	0
12	35981713	.	C	T	1	10	11	0	4	15	0	0
12	35981795	.	T	A	5	9	14	0	0	14	0	0
12	35981832	.	A	G	6	8	14	0	0	14	0	0
12	35988544	.	A	G	4	9	13	0	0	13	0	0
12	35988553	.	G	A	4	5	9	0	2	11	0	0
12	36105341	.	A	G	5	6	11	0	0	11	0	0
12	36105410	.	G	T	1	3	4	0	0	4	0	0
12	36106238	.	C	T	1	4	5	0	0	5	0	0
12	36135764	.	C	T	6	5	11	0	0	11	0	0
12	36158056	.	A	C	18	14	32	0	4	36	0	0
12	36158098	.	G	C	17	15	32	0	0	32	0	0
12	36158099	.	T	C	17	14	31	0	1	32	0	0
12	36158225	.	T	C	11	17	28	0	0	28	0	0
12	36158349	.	G	A	2	22	24	0	19	43	0	0
12	36158538	.	C	T	4	7	11	0	2	13	0	0
12	36159597	.	C	G	15	8	23	2	0	25	0	0
12	36413937	.	A	T	4	6	10	0	0	10	0	0
12	36416669	.	T	C	4	2	6	0	0	6	0	0
12	36416675	.	T	C	4	3	7	0	0	7	0	0
12	36416714	.	G	A	2	3	5	0	0	5	0	0
12	36416732	.	G	C	1	3	4	0	0	4	0	0
12	36420420	.	G	A	2	2	4	0	0	4	0	0
12	36422537	.	A	G	3	3	6	0	0	6	0	0
12	36424613	.	G	A	5	4	9	0	0	9	0	0
12	36424618	.	G	A	5	7	12	0	0	12	0	0
12	36462038	.	G	A	1	4	5	0	0	5	0	0
12	36471122	.	A	T	2	3	5	0	1	6	0	0
12	36471149	.	A	C	1	4	5	0	0	5	0	0
12	36471279	.	A	G	1	2	3	0	0	3	0	0
12	36471473	.	A	T	1	2	3	0	0	3	0	0
12	36471477	.	C	A	1	2	3	0	0	3	0	0
12	36670221	.	C	A	1	2	3	0	0	3	0	0
12	36670231	.	A	T	1	2	3	0	0	3	0	0
12	36671019	.	T	C	2	2	4	0	0	4	0	0
12	36739440	.	C	T	1	2	3	0	0	3	0	0
12	36895057	.	T	C	2	3	5	0	1	6	0	0
12	36895067	.	G	A	2	6	8	0	0	8	0	0
12	36952648	.	T	G	1	0	1	1	4	6	0	0
12	36952744	.	C	T	6	7	13	0	0	13	0	0
12	36960197	.	T	C	10	5	15	0	1	16	0	0
12	36960200	.	A	T	11	5	16	0	1	17	0	0
12	37003216	.	C	A	3	2	5	0	0	5	0	0
12	37005013	.	G	T	2	2	4	0	0	4	0	0
12	37005350	.	T	C	1	2	3	0	0	3	0	0
12	37005586	.	A	G	2	0	2	0	4	6	0	0
12	37275601	.	C	T	1	2	3	0	0	3	0	0
12	37275712	.	A	T	5	2	7	0	0	7	0	0
12	37275719	.	G	T	4	3	7	0	0	7	0	0
12	37277295	.	C	T	2	4	6	0	1	7	0	0
12	37408690	.	T	C	1	0	1	1	5	7	0	0
12	38556545	.	A	G	2	2	4	0	0	4	0	0
12	38556562	.	G	T	2	4	6	0	0	6	0	0
12	38561258	.	C	A	13	15	28	0	0	28	0	0
12	38687907	.	T	A	2	2	4	0	0	4	0	0
12	38802875	.	T	C	2	2	4	0	0	4	0	0
12	38803168	.	A	G	1	2	3	0	0	3	0	0
12	38803377	.	G	A	1	4	5	0	7	12	0	0
12	38803411	.	A	G	11	0	11	0	7	18	0	0
12	38803649	.	G	C	4	6	10	0	0	10	0	0
12	38804005	.	G	T	7	5	12	0	2	14	0	0
12	38804027	.	A	G	3	6	9	0	1	10	0	0
12	38804561	.	C	G	2	2	4	0	1	5	0	0
12	38842158	.	G	A	1	2	3	0	0	3	0	0
12	38850285	.	T	A	2	4	6	0	1	7	0	0
12	39744954	.	G	C	0	4	4	0	3	7	0	0
12	40348899	.	G	T	0	2	2	0	3	5	0	0
12	40478325	.	A	C	8	3	11	0	0	11	0	0
12	40502531	.	G	A	1	7	8	0	0	8	0	0
12	40502547	.	C	T	1	7	8	0	1	9	0	0
12	40502610	.	G	A	0	3	3	0	4	7	0	0
12	40518088	.	C	T	4	13	17	0	0	17	0	0
12	40518094	.	T	C	4	12	16	0	0	16	0	0
12	40518217	.	C	T	3	3	6	0	0	6	0	0
12	41437046	.	G	A	9	6	15	0	1	16	0	0
12	41455861	.	T	C	3	1	4	0	1	5	0	0
12	41461030	.	C	T	5	8	13	0	0	13	0	0
12	41461051	.	C	T	6	7	13	0	1	14	0	0
12	41466801	.	C	G	9	1	10	0	16	26	0	0
12	41467003	.	C	T	15	15	30	0	3	33	0	0
12	41467207	.	C	A	14	8	22	0	3	25	0	0
12	41535886	.	A	C	4	5	9	0	1	10	0	0
12	41535898	.	C	T	5	4	9	0	1	10	0	0
12	41535937	.	T	A	8	6	14	0	0	14	0	0
12	41539059	.	G	A	7	6	13	0	1	14	0	0
12	41539161	.	C	T	4	4	8	0	0	8	0	0
12	41539464	.	G	A	4	4	8	0	0	8	0	0
12	41549214	.	G	A	2	11	13	0	3	16	0	0
12	41549386	.	G	A	17	16	33	0	0	33	0	0
12	41549404	.	C	G	14	12	26	0	0	26	0	0
12	41549434	.	C	G	13	12	25	0	1	26	0	0
12	41549443	.	A	G	9	1	10	0	13	23	0	0
12	41580940	.	G	T	13	9	22	0	0	22	0	0
12	41581092	.	A	G	17	8	25	0	1	26	0	0
12	41584666	.	G	A	9	8	17	0	1	18	0	0
12	41584755	.	C	T	10	10	20	0	1	21	0	0
12	41589789	.	T	G	5	8	13	0	0	13	0	0
12	41593093	.	T	A	3	5	8	0	1	9	0	0
12	41606683	.	T	C	2	0	2	0	3	5	0	0
12	41606686	.	G	T	2	3	5	0	0	5	0	0
12	41631703	.	A	T	2	5	7	0	0	7	0	0
12	41631964	.	C	G	19	10	29	0	0	29	0	0
12	41632117	.	A	G	13	29	42	0	7	49	0	0
12	41643214	.	C	T	9	9	18	0	2	20	0	0
12	41643217	.	G	A	10	9	19	0	1	20	0	0
12	41647273	.	T	C	12	10	22	0	0	22	0	0
12	41653678	.	A	G	11	14	25	0	1	26	0	0
12	41656554	.	G	A	18	12	30	0	1	31	0	0
12	41698040	.	A	T	8	12	20	0	4	24	0	0
12	41698070	.	T	A	12	11	23	0	1	24	0	0
12	41702044	.	A	C	12	16	28	1	3	32	0	0
12	41723165	.	A	T	5	7	12	0	0	12	0	0
12	41723482	.	G	A	7	9	16	1	0	17	0	0
12	41723608	.	T	A	16	8	24	0	1	25	0	0
12	41732013	.	C	T	0	3	3	0	7	10	0	0
12	41735790	.	T	C	4	4	8	0	1	9	0	0
12	41739297	.	G	T	5	6	11	0	0	11	0	0
12	45216701	.	A	T	2	44	46	0	1	47	0	0
12	46629332	.	T	C	1	8	9	1	0	10	0	0
12	46630927	.	G	T	9	14	23	0	0	23	0	0
12	46630946	.	C	A	14	9	23	0	1	24	0	0
12	46631120	.	A	G	3	1	4	0	1	5	0	0
12	46688007	.	C	T	6	3	9	0	1	10	0	0
12	46688275	.	A	G	9	6	15	0	0	15	0	0
12	46693103	.	C	T	9	7	16	0	2	18	0	0
12	46695714	.	A	G	6	2	8	0	0	8	0	0
12	46698280	.	G	T	0	2	2	0	1	3	0	0
12	46698283	.	T	A	1	2	3	0	0	3	0	0
12	46852982	.	C	T	2	4	6	0	0	6	0	0
12	46855065	.	A	G	6	0	6	0	9	15	0	0
12	46857326	.	A	C	4	3	7	0	0	7	0	0
12	46863553	.	C	T	7	12	19	0	1	20	0	0
12	46915452	.	T	C	3	4	7	0	1	8	0	0
12	46930412	.	G	C	3	6	9	0	1	10	0	0
12	46930676	.	T	C	4	5	9	0	0	9	0	0
12	46937292	.	A	C	8	12	20	0	1	21	0	0
12	46937351	.	T	C	7	12	19	0	2	21	0	0
12	46937422	.	A	T	7	9	16	0	1	17	0	0
12	46937461	.	G	A	9	6	15	0	1	17	1	0
12	46937711	.	A	G	10	2	12	0	10	22	0	0
12	46953552	.	A	G	1	5	6	0	0	6	0	0
12	46953609	.	C	A	1	4	5	0	0	5	0	0
12	46959935	.	T	C	3	6	9	0	1	10	0	0
12	46969557	.	C	T	4	3	7	0	0	7	0	0
12	46976021	.	C	T	9	8	17	0	0	17	0	0
12	46985509	.	C	A	5	8	13	0	0	13	0	0
12	46985666	.	T	C	5	3	8	0	0	8	0	0
12	46985884	.	G	T	5	7	12	0	1	13	0	0
12	46985886	.	C	A	6	8	14	0	0	14	0	0
12	47044800	.	A	T	3	2	5	0	0	5	0	0
12	47055306	.	A	G	13	8	21	1	4	26	0	0
12	47055546	.	C	T	12	4	16	0	3	19	0	0
12	47055609	.	A	G	9	1	10	0	17	27	0	0
12	47062488	.	C	T	19	7	26	0	0	26	0	0
12	47062548	.	T	C	11	8	19	0	1	20	0	0
12	47063007	.	G	A	11	8	19	0	0	19	0	0
12	47064418	.	T	C	13	18	31	0	2	33	0	0
12	47068624	.	C	T	11	11	22	0	1	23	0	0
12	47068657	.	A	G	13	0	13	0	9	22	0	0
12	47068738	.	C	T	7	18	25	0	1	26	0	0
12	47099943	.	C	T	1	2	3	0	0	3	0	0
12	47100471	.	T	C	0	2	2	0	1	3	0	0
12	47109480	.	C	T	1	2	3	0	0	3	0	0
12	47241630	.	C	T	1	3	4	0	0	4	0	0
12	47258993	.	T	G	1	0	1	0	2	3	0	0
12	47275118	.	T	A	3	8	11	0	0	11	0	0
12	47275233	.	A	G	5	0	5	0	7	12	0	0
12	47283544	.	G	C	2	3	5	0	0	5	0	0
12	47291529	.	G	C	3	6	9	0	3	12	0	0
12	47291703	.	G	A	5	7	12	0	1	13	0	0
12	47295523	.	C	T	1	3	4	0	0	4	0	0
12	47295939	.	C	T	6	12	18	0	0	18	0	0
12	47296596	.	C	T	6	4	10	0	0	10	0	0
12	47296608	.	T	A	5	5	10	0	0	10	0	0
12	47302786	.	G	A	1	8	9	0	4	13	0	0
12	47302828	.	C	T	6	5	11	0	0	11	0	0
12	47302831	.	G	A	6	5	11	0	1	12	0	0
12	47325323	.	G	T	2	7	9	0	4	13	0	0
12	47327631	.	C	T	8	5	13	0	0	13	0	0
12	47331855	.	C	T	4	7	11	0	0	11	0	0
12	47331864	.	C	T	8	5	13	0	0	13	0	0
12	47332134	.	A	T	8	6	14	0	0	14	0	0
12	47332236	.	A	G	6	10	16	0	0	16	0	0
12	47332326	.	C	A	11	10	21	0	1	22	0	0
12	47332575	.	A	G	4	12	16	0	1	17	0	0
12	47332635	.	G	A	11	12	23	0	1	24	0	0
12	47332827	.	C	T	14	9	23	0	0	23	0	0
12	47335257	.	C	T	9	11	20	0	2	22	0	0
12	47338311	.	A	G	11	14	25	0	1	26	0	0
12	47344423	.	T	C	16	22	38	1	0	39	0	0
12	47355211	.	C	T	17	14	31	0	3	34	0	0
12	47449784	.	A	G	5	0	5	0	6	11	0	0
12	47449793	.	C	A	5	6	11	0	0	11	0	0
12	47449967	.	G	A	5	3	8	0	0	8	0	0
12	47449997	.	G	A	3	3	6	0	3	9	0	0
12	47480469	.	A	T	2	2	4	0	4	8	0	0
12	47480565	.	T	A	9	10	19	0	1	20	0	0
12	47510101	.	T	C	8	3	11	0	0	11	0	0
12	47523795	.	A	C	18	18	36	0	2	38	0	0
12	47536254	.	C	T	17	15	32	0	2	34	0	0
12	47540999	.	A	C	13	20	33	0	4	37	0	0
12	47544339	.	G	T	3	3	6	0	0	6	0	0
12	47593325	.	G	C	3	0	3	0	2	5	0	0
12	47593373	.	G	A	4	4	8	0	0	8	0	0
12	47641659	.	C	T	1	12	13	14	17	44	0	0
12	47645851	.	G	A	16	15	31	0	1	32	0	0
12	47646485	.	G	A	8	5	13	0	0	13	0	0
12	47786073	.	C	T	0	3	3	0	2	5	0	0
12	47788524	.	T	C	4	3	7	0	0	7	0	0
12	47842232	.	T	C	2	3	5	0	1	6	0	0
12	47851950	.	T	C	1	2	3	0	0	3	0	0
12	48419359	.	T	G	2	3	5	0	0	5	0	0
12	48419420	.	A	G	3	3	6	0	0	6	0	0
12	48419805	.	C	T	1	2	3	0	0	3	0	0
12	48436863	.	T	C	4	1	5	0	3	8	0	0
12	48469825	.	C	T	13	16	29	0	2	31	0	0
12	48470519	.	T	C	2	2	4	0	0	4	0	0
12	48476965	.	A	T	23	20	43	0	3	46	0	0
12	48476995	.	T	C	9	0	9	0	13	22	0	0
12	48480740	.	G	A	2	2	4	0	0	4	0	0
12	48525046	.	G	A	1	6	7	0	0	7	0	0
12	48528736	.	G	A	3	4	7	0	1	8	0	0
12	48529757	.	C	T	3	4	7	0	0	7	0	0
12	48532581	.	A	G	2	8	10	0	3	13	0	0
12	48566635	.	G	T	0	3	3	0	1	4	0	0
12	48614674	.	A	G	2	2	4	0	0	4	0	0
12	48614731	.	A	G	3	2	5	0	0	5	0	0
12	48626349	.	A	C	1	2	3	0	1	4	0	0
12	48627049	.	T	G	2	3	5	0	0	5	0	0
12	48674400	.	C	G	6	2	8	0	1	9	0	0
12	48674408	.	C	A	8	4	12	0	0	12	0	0
12	48677792	.	G	A	4	4	8	0	1	9	0	0
12	48678364	.	G	A	9	4	13	0	0	13	0	0
12	48678396	.	G	A	0	5	5	0	7	12	0	0
12	48680110	.	C	G	5	5	10	0	2	12	0	0
12	48681658	.	T	C	11	9	20	0	0	20	0	0
12	48681711	.	T	C	8	7	15	0	1	16	0	0
12	48681826	.	A	T	10	6	16	0	1	17	0	0
12	48681827	.	T	A	10	6	16	0	1	17	0	0
12	48681964	.	A	G	11	7	18	0	1	19	0	0
12	48681977	.	C	T	10	7	17	0	2	19	0	0
12	48682058	.	G	A	1	5	6	0	4	10	0	0
12	48682089	.	G	T	5	5	10	0	0	10	0	0
12	48682104	.	T	A	4	6	10	0	0	10	0	0
12	48682237	.	C	G	7	8	15	0	0	15	0	0
12	48682266	.	C	T	9	9	18	0	0	18	0	0
12	48682301	.	G	A	2	9	11	0	5	16	0	0
12	48682530	.	G	C	9	4	13	0	0	13	0	0
12	48803225	.	T	C	9	5	14	0	1	15	0	0
12	48804074	.	G	C	10	10	20	0	0	20	0	0
12	48807955	.	T	C	11	13	24	1	0	25	0	0
12	48810557	.	G	T	0	14	14	0	12	26	0	0
12	48810558	.	C	T	11	14	25	0	1	26	0	0
12	48810865	.	C	T	3	9	12	0	1	13	0	0
12	48810960	.	G	A	0	10	10	0	9	19	0	0
12	48811035	.	T	C	8	12	20	0	2	22	0	0
12	48826461	.	T	C	10	6	16	0	0	16	0	0
12	48828467	.	G	A	0	3	3	0	8	11	0	0
12	48829397	.	T	C	4	2	6	0	0	6	0	0
12	48836141	.	T	C	15	16	31	0	1	32	0	0
12	48836553	.	A	C	16	16	32	0	0	32	0	0
12	48836650	.	G	T	7	2	9	0	1	10	0	0
12	48836966	.	G	T	13	6	19	0	1	20	0	0
12	48837047	.	T	G	12	11	23	0	0	23	0	0
12	48837219	.	C	G	12	14	26	1	2	29	0	0
12	48867236	.	G	A	1	1	2	0	1	3	0	0
12	48959393	.	A	G	2	3	5	0	0	5	0	0
12	48959630	.	G	A	4	2	6	0	0	6	0	0
12	48979161	.	T	C	7	0	7	0	7	14	0	0
12	48979219	.	T	C	3	0	3	0	5	8	0	0
12	48979234	.	T	C	4	0	4	0	4	8	0	0
12	48979256	.	G	T	3	2	5	0	0	5	0	0
12	48979362	.	A	C	11	2	13	0	5	18	0	0
12	48979609	.	C	T	0	4	4	0	10	14	0	0
12	48979648	.	C	T	1	6	7	0	0	7	0	0
12	48982536	.	T	C	4	0	4	0	4	8	0	0
12	48982539	.	C	T	0	5	5	0	3	8	0	0
12	48983799	.	C	T	0	3	3	0	2	5	0	0
12	48984334	.	T	C	1	0	1	0	2	3	0	0
12	49004058	.	C	T	0	12	12	0	20	32	0	0
12	49004071	.	C	T	1	10	11	0	19	30	0	0
12	49005119	.	G	T	9	10	19	1	3	23	0	0
12	49034603	.	C	T	6	2	8	0	0	8	0	0
12	49035182	.	G	A	0	9	9	0	2	11	0	0
12	49114550	.	G	T	3	20	23	0	12	35	0	0
12	49114592	.	A	G	16	1	17	0	4	21	0	0
12	49125949	.	A	G	1	3	4	0	0	4	0	0
12	49148399	.	A	G	12	13	25	0	0	25	0	0
12	49149457	.	C	T	1	12	13	0	6	19	0	0
12	49158090	.	T	C	8	0	8	0	12	20	0	0
12	49158990	.	G	A	22	22	44	1	1	46	0	0
12	49159802	.	A	G	15	6	21	13	3	37	0	0
12	49160120	.	G	A	14	11	25	7	2	34	0	0
12	49161825	.	A	G	2	2	4	31	1	36	0	0
12	49161860	.	T	C	10	13	23	16	2	41	0	0
12	49166926	.	C	T	12	7	19	0	1	20	0	0
13	111572	.	G	A	0	3	3	0	8	11	0	0
13	111804	.	C	T	10	4	14	0	1	15	0	0
13	112162	.	T	G	8	2	10	0	8	18	0	0
13	343567	.	G	T	2	5	7	0	1	8	0	0
13	343581	.	C	G	0	3	3	1	2	6	0	0
13	809305	.	A	G	3	7	10	0	2	12	0	0
13	809779	.	A	G	9	4	13	0	1	14	0	0
13	1168824	.	G	A	1	2	3	0	0	3	0	0
13	1422111	.	G	A	1	8	9	0	0	9	0	0
13	2417235	.	C	T	3	2	5	1	0	6	0	0
13	2417251	.	C	T	3	2	5	0	0	5	0	0
13	2427331	.	T	C	3	12	15	0	0	15	0	0
13	3155196	.	T	A	1	4	5	0	1	6	0	0
13	3264323	.	C	A	6	9	15	0	1	16	0	0
13	3264406	.	C	T	4	7	11	0	0	11	0	0
13	3269340	.	G	A	11	8	19	0	0	19	0	0
13	3270123	.	A	G	13	6	19	0	0	19	0	0
13	3272706	.	C	A	0	3	3	0	1	4	0	0
13	3272735	.	G	C	2	5	7	0	0	7	0	0
13	3279588	.	C	T	1	2	3	0	1	4	0	0
13	3282127	.	T	C	5	6	11	0	0	11	0	0
13	3287268	.	C	A	4	4	8	0	0	8	0	0
13	3299514	.	C	G	4	1	5	0	1	6	0	0
13	3369252	.	T	C	3	2	5	0	0	5	0	0
13	3370596	.	T	C	2	0	2	0	3	5	0	0
13	3874427	.	A	G	3	4	7	0	0	7	0	0
13	3874815	.	T	C	2	0	2	0	2	4	0	0
13	3874831	.	T	C	1	2	3	0	1	4	0	0
13	3881152	.	T	G	2	4	6	0	1	7	0	0
13	3881204	.	T	C	9	4	13	0	1	14	0	0
13	3881208	.	G	T	8	4	12	0	1	13	0	0
13	3881269	.	C	G	2	7	9	0	0	9	0	0
13	3885350	.	A	C	5	4	9	0	0	9	0	0
13	3885359	.	G	T	5	4	9	0	0	9	0	0
13	3916150	.	A	G	18	7	25	0	1	26	0	0
13	3916198	.	A	G	10	16	26	0	0	26	0	0
13	3916377	.	G	A	14	13	27	0	2	29	0	0
13	3919020	.	T	C	13	0	13	0	19	32	0	0
13	3919057	.	A	C	14	11	25	0	2	27	0	0
13	3919136	.	A	T	10	8	18	0	2	20	0	0
13	3919167	.	A	G	11	15	26	0	0	26	0	0
13	3919555	.	T	C	8	11	19	0	0	19	0	0
13	3919632	.	A	G	9	14	23	0	0	23	0	0
13	3919672	.	T	G	9	12	21	0	0	21	0	0
13	3919686	.	G	A	8	7	15	0	1	16	0	0
13	3920759	.	C	T	0	7	7	0	7	14	0	0
13	3922791	.	T	C	6	3	9	0	1	10	0	0
13	3936482	.	C	G	5	5	10	0	0	10	0	0
13	3938574	.	C	A	2	4	6	0	0	6	0	0
13	3938619	.	C	A	6	4	10	0	0	10	0	0
13	3942055	.	G	A	0	4	4	0	6	10	0	0
13	3949847	.	G	A	10	13	23	0	0	23	0	0
13	3950007	.	G	A	5	12	17	0	1	19	1	0
13	3950074	.	A	T	14	10	24	0	0	24	0	0
13	3950181	.	T	C	22	12	34	0	2	36	0	0
13	3950497	.	G	T	19	8	27	0	0	27	0	0
13	3950669	.	T	A	9	8	17	0	1	18	0	0
13	3954611	.	C	T	5	5	10	0	0	10	0	0
13	3958895	.	C	T	5	3	8	0	1	9	0	0
13	3965966	.	G	A	13	22	35	0	3	38	0	0
13	3980164	.	C	T	1	3	4	0	1	5	0	0
13	3982711	.	C	T	4	2	6	0	0	6	0	0
13	4213240	.	G	A	4	4	8	0	0	8	0	0
13	4213291	.	A	C	5	4	9	0	0	9	0	0
13	4213300	.	C	T	3	5	8	0	0	8	0	0
13	4213804	.	G	A	11	12	23	0	2	25	0	0
13	4226664	.	C	A	16	11	27	0	1	28	0	0
13	4231438	.	T	A	12	11	23	0	2	25	0	0
13	4231819	.	G	A	16	14	30	1	3	34	0	0
13	4232051	.	G	A	2	9	11	0	1	12	0	0
13	4232054	.	A	T	2	8	10	0	0	10	0	0
13	4232171	.	C	T	22	18	40	0	2	42	0	0
13	4232280	.	T	C	34	21	55	1	0	56	0	0
13	4232284	.	T	C	33	21	54	1	2	57	0	0
13	4232324	.	T	G	27	18	45	1	1	47	0	0
13	4232358	.	A	T	25	9	34	0	2	37	1	0
13	4232400	.	A	T	25	12	37	1	2	40	0	0
13	4232718	.	G	A	15	8	23	0	0	23	0	0
13	4233030	.	C	T	2	21	23	0	17	40	0	0
13	4233033	.	G	A	22	14	36	0	0	36	0	0
13	4233167	.	T	A	20	16	36	0	0	36	0	0
13	4233361	.	G	T	9	16	25	0	0	25	0	0
13	4233365	.	G	A	15	9	24	0	1	25	0	0
13	4233625	.	T	A	14	8	22	0	0	22	0	0
13	4233779	.	G	A	19	10	29	0	1	30	0	0
13	4233889	.	G	A	5	6	11	0	2	13	0	0
13	4233911	.	G	C	9	10	19	0	0	19	0	0
13	4233952	.	T	G	10	12	22	0	0	22	0	0
13	4234337	.	G	A	6	13	19	0	0	19	0	0
13	4234349	.	G	T	12	6	18	0	0	18	0	0
13	4234655	.	G	A	19	16	35	0	1	36	0	0
13	4256617	.	A	G	4	2	6	0	0	6	0	0
13	4307752	.	A	G	5	20	25	0	1	26	0	0
13	4307782	.	C	T	27	9	36	0	2	38	0	0
13	4307934	.	T	C	25	20	45	0	1	46	0	0
13	4308269	.	G	A	14	11	25	0	0	25	0	0
13	4308841	.	T	G	9	13	22	0	1	23	0	0
13	4309166	.	T	G	18	10	28	0	2	30	0	0
13	4310247	.	G	A	8	13	21	0	0	21	0	0
13	4310440	.	G	C	9	1	10	0	21	31	0	0
13	4310511	.	C	T	1	8	9	0	16	25	0	0
13	4310565	.	G	A	13	12	25	0	0	25	0	0
13	4310568	.	A	T	14	10	24	0	1	25	0	0
13	4310610	.	C	T	10	11	21	0	2	23	0	0
13	4311081	.	T	C	6	5	11	0	3	14	0	0
13	4311578	.	T	C	10	0	10	1	10	21	0	0
13	4311699	.	G	T	6	8	14	0	0	14	0	0
13	4311912	.	C	T	6	3	9	0	0	9	0	0
13	4317628	.	C	T	0	3	3	0	3	6	0	0
13	4320905	.	T	C	2	2	4	0	1	5	0	0
13	4321153	.	T	C	3	3	6	0	0	6	0	0
13	4321382	.	C	T	2	2	4	0	0	4	0	0
13	4321507	.	A	C	2	0	2	0	5	7	0	0
13	4321741	.	T	G	1	2	3	0	0	3	0	0
13	4339382	.	C	T	5	16	21	0	3	24	0	0
13	4343183	.	C	T	0	4	4	0	6	10	0	0
13	4343216	.	A	T	7	10	17	0	1	18	0	0
13	4343221	.	T	A	5	9	14	0	3	17	0	0
13	4343490	.	G	A	5	8	13	0	2	15	0	0
13	4343931	.	G	A	6	3	9	0	0	10	1	0
13	4344100	.	C	G	4	3	7	0	0	7	0	0
13	4344159	.	C	G	6	4	10	0	1	11	0	0
13	4347474	.	T	G	3	4	7	0	0	7	0	0
13	4349830	.	G	T	2	2	4	0	0	4	0	0
13	4350523	.	G	T	1	1	2	0	1	3	0	0
13	4352724	.	C	T	2	2	4	0	0	4	0	0
13	4354424	.	G	T	0	2	2	0	1	3	0	0
13	4368536	.	T	C	3	7	10	0	0	10	0	0
13	4398802	.	A	G	5	0	5	0	3	8	0	0
13	4399511	.	A	T	3	2	5	0	0	5	0	0
13	4399564	.	C	T	5	3	8	0	1	9	0	0
13	4399718	.	C	G	8	3	11	0	2	13	0	0
13	4399891	.	A	G	1	7	8	4	0	12	0	0
13	4400339	.	G	A	3	5	8	0	1	9	0	0
13	4400409	.	G	C	6	9	15	0	0	15	0	0
13	4400462	.	A	C	5	1	6	3	1	10	0	0
13	4400464	.	C	G	5	2	7	3	0	10	0	0
13	4400550	.	T	G	3	4	7	0	0	7	0	0
13	4400698	.	A	T	7	3	10	0	0	10	0	0
13	4400704	.	T	A	7	3	10	0	1	11	0	0
13	4406816	.	T	C	19	16	35	1	2	38	0	0
13	4406937	.	T	A	14	5	19	0	0	19	0	0
13	4657721	.	G	C	7	6	13	0	0	13	0	0
13	4663375	.	G	A	8	9	17	0	0	17	0	0
13	4663402	.	C	T	8	6	14	0	0	14	0	0
13	4663444	.	A	G	6	5	11	0	0	11	0	0
13	4664226	.	A	G	3	3	6	0	0	6	0	0
13	4712874	.	G	A	14	9	23	0	0	23	0	0
13	4713193	.	C	G	8	10	18	0	2	20	0	0
13	4713254	.	G	A	10	7	17	0	0	17	0	0
13	4713373	.	T	A	7	9	16	0	1	17	0	0
13	4713478	.	G	A	12	3	15	0	0	15	0	0
13	4713702	.	A	T	7	3	10	0	0	10	0	0
13	4713773	.	C	A	7	8	15	0	0	15	0	0
13	4714017	.	C	A	9	9	18	0	1	19	0	0
13	4872121	.	C	T	4	2	6	0	0	6	0	0
13	4899623	.	A	G	5	4	9	0	1	10	0	0
13	4945774	.	T	A	4	4	8	0	0	8	0	0
13	4956118	.	G	A	9	10	19	0	0	19	0	0
13	4968819	.	T	A	11	15	26	0	1	27	0	0
13	4968849	.	A	G	17	9	26	0	2	28	0	0
13	4968931	.	T	A	20	16	36	1	0	37	0	0
13	4969167	.	A	G	7	17	24	1	1	26	0	0
13	4969175	.	A	G	14	2	16	1	9	26	0	0
13	4973701	.	T	A	6	7	13	1	0	14	0	0
13	4973856	.	C	T	1	9	10	0	9	19	0	0
13	4978620	.	G	A	9	5	14	0	1	15	0	0
13	4978785	.	C	T	0	10	10	0	10	20	0	0
13	4978821	.	T	C	10	0	10	0	12	22	0	0
13	4978885	.	T	C	4	10	14	0	2	16	0	0
13	4978887	.	C	A	6	11	17	0	0	17	0	0
13	4979150	.	C	T	7	5	12	0	0	12	0	0
13	4979163	.	A	T	4	6	10	0	0	10	0	0
13	4979420	.	T	C	4	12	16	0	0	16	0	0
13	4979550	.	A	G	6	5	11	0	1	12	0	0
13	4979607	.	G	T	8	6	14	0	0	14	0	0
13	4979799	.	T	C	6	0	6	0	3	9	0	0
13	4982091	.	C	T	0	3	3	0	5	8	0	0
13	4984402	.	A	T	2	2	4	0	0	4	0	0
13	4987659	.	C	A	0	2	2	0	1	3	0	0
13	4995574	.	T	C	21	13	34	0	1	35	0	0
13	4995638	.	G	T	1	16	17	0	12	29	0	0
13	4995788	.	C	T	16	14	30	0	2	32	0	0
13	5016758	.	G	C	8	8	16	0	1	17	0	0
13	5017657	.	A	G	12	14	26	0	0	26	0	0
13	5017699	.	G	A	14	13	27	0	1	28	0	0
13	5025842	.	G	T	2	16	18	0	17	35	0	0
13	5025938	.	A	G	16	0	16	0	23	39	0	0
13	5026062	.	A	G	22	20	42	0	2	44	0	0
13	5028407	.	G	A	35	26	61	0	3	64	0	0
13	5028414	.	T	C	32	23	55	0	6	61	0	0
13	5028471	.	T	G	24	34	58	0	3	61	0	0
13	5028538	.	T	G	25	28	53	1	1	55	0	0
13	5028751	.	T	C	45	24	69	0	1	70	0	0
13	5028802	.	T	C	36	22	58	0	4	62	0	0
13	5031526	.	C	T	4	3	7	0	0	7	0	0
13	5031662	.	A	T	2	3	5	0	0	5	0	0
13	5031689	.	T	A	1	4	5	0	0	5	0	0
13	5038011	.	A	G	1	2	3	0	0	3	0	0
13	5043828	.	T	G	1	3	4	0	0	4	0	0
13	5069839	.	C	T	2	2	4	0	0	4	0	0
13	5245655	.	T	C	1	1	2	0	1	3	0	0
13	5491234	.	G	A	31	16	47	0	1	48	0	0
13	5531709	.	A	G	17	21	38	0	3	41	0	0
13	5568993	.	G	A	9	8	17	0	0	17	0	0
13	5569344	.	C	T	4	2	6	0	0	6	0	0
13	5871834	.	C	T	0	2	2	0	2	4	0	0
13	5936945	.	T	G	3	2	5	0	0	5	0	0
13	5959654	.	T	C	2	4	6	0	0	6	0	0
13	5978865	.	T	C	2	5	7	0	0	7	0	0
13	6075915	.	T	G	1	2	3	0	0	3	0	0
13	6119865	.	C	T	3	3	6	0	0	6	0	0
13	6125154	.	T	C	1	5	6	0	0	6	0	0
13	6125207	.	A	T	1	3	4	0	0	4	0	0
13	6125217	.	G	A	0	2	2	0	4	6	0	0
13	6189925	.	T	G	3	0	3	0	4	7	0	0
13	6191523	.	C	A	6	6	12	0	0	12	0	0
13	6192433	.	C	A	2	5	7	0	0	7	0	0
13	6194867	.	T	A	11	3	14	0	1	15	0	0
13	6195043	.	T	G	5	0	5	0	11	16	0	0
13	6195055	.	A	T	11	5	16	0	1	17	0	0
13	6199336	.	G	A	1	7	8	0	3	11	0	0
13	6199375	.	T	C	4	5	9	0	0	9	0	0
13	6204583	.	G	A	12	5	17	0	0	17	0	0
13	6204957	.	T	C	10	8	18	0	2	20	0	0
13	6205311	.	G	A	6	7	13	0	0	13	0	0
13	6233482	.	A	C	2	2	4	0	1	5	0	0
13	6236772	.	G	A	3	7	10	0	0	10	0	0
13	6236796	.	C	T	4	5	9	0	1	10	0	0
13	6236901	.	G	A	10	8	18	0	1	19	0	0
13	6238204	.	G	A	7	11	18	0	0	18	0	0
13	6238466	.	T	C	10	12	22	0	2	24	0	0
13	6238658	.	G	T	2	14	16	0	9	25	0	0
13	6238762	.	A	G	6	9	15	0	1	16	0	0
13	6238883	.	A	G	10	10	20	0	3	23	0	0
13	6238972	.	G	A	5	11	16	0	0	16	0	0
13	6239031	.	C	T	3	6	9	0	2	11	0	0
13	6239091	.	A	T	6	7	13	0	3	16	0	0
13	6239112	.	A	G	5	10	15	0	1	16	0	0
13	6271490	.	T	C	1	2	3	0	0	3	0	0
13	6279570	.	C	T	0	2	2	0	1	3	0	0
13	6961186	.	A	G	4	2	6	0	0	6	0	0
13	7170250	.	C	T	4	2	6	0	0	6	0	0
13	7171155	.	C	T	1	2	3	0	3	6	0	0
13	7196540	.	T	C	1	2	3	0	0	3	0	0
13	7243397	.	T	C	1	3	4	0	0	4	0	0
13	7243431	.	A	G	1	3	4	0	0	4	0	0
13	7243484	.	C	T	4	8	12	0	0	12	0	0
13	7255659	.	T	C	8	10	18	0	1	19	0	0
13	7255664	.	G	A	8	10	18	0	2	20	0	0
13	7307382	.	A	C	1	2	3	0	0	3	0	0
13	7307512	.	T	C	3	2	5	0	0	5	0	0
13	7309507	.	A	T	3	2	5	0	0	5	0	0
13	7310386	.	C	A	3	3	6	0	0	6	0	0
13	7310428	.	G	A	4	3	7	0	0	7	0	0
13	7310628	.	A	C	1	3	4	0	0	4	0	0
13	7311089	.	C	T	2	4	6	0	0	6	0	0
13	7311476	.	C	T	2	3	5	0	1	6	0	0
13	7311986	.	A	C	3	5	8	0	0	8	0	0
13	7312015	.	T	A	2	3	5	0	1	6	0	0
13	7312201	.	T	A	3	2	5	0	2	7	0	0
13	7312225	.	G	C	4	3	7	0	0	7	0	0
13	7312527	.	G	A	0	2	2	0	5	7	0	0
13	7312675	.	C	T	1	1	2	0	1	3	0	0
13	7312713	.	T	A	2	3	5	0	0	5	0	0
13	7313066	.	T	G	5	4	9	1	0	10	0	0
13	7313185	.	T	C	6	6	12	0	0	12	0	0
13	7313304	.	A	G	5	6	11	0	0	11	0	0
13	7313324	.	T	A	8	4	12	0	1	13	0	0
13	7313436	.	T	C	1	3	4	0	0	4	0	0
13	7313613	.	C	T	5	2	7	0	2	9	0	0
13	7313641	.	C	A	7	6	13	0	1	14	0	0
13	7313703	.	C	T	4	13	17	0	4	21	0	0
13	7313827	.	C	T	9	7	16	0	0	16	0	0
13	7314049	.	T	C	9	3	12	0	0	12	0	0
13	7314300	.	T	C	6	4	10	0	0	10	0	0
13	7314567	.	C	A	6	6	12	0	1	13	0	0
13	7314568	.	T	G	5	7	12	0	1	13	0	0
13	7314736	.	A	C	7	6	13	0	1	14	0	0
13	7315123	.	C	T	14	13	27	0	3	30	0	0
13	7315174	.	C	A	13	13	26	0	1	27	0	0
13	7315197	.	A	G	13	1	14	0	12	26	0	0
13	7315234	.	A	G	14	13	27	0	1	28	0	0
13	7315597	.	A	G	13	1	14	0	7	21	0	0
13	7316157	.	G	T	11	14	25	1	2	28	0	0
13	7316207	.	C	T	10	7	17	1	0	18	0	0
13	7316463	.	G	A	13	12	25	0	1	26	0	0
13	7316484	.	A	T	10	15	25	0	1	26	0	0
13	7316532	.	C	A	9	15	24	0	3	27	0	0
13	7316537	.	A	C	8	20	28	0	2	30	0	0
13	7316784	.	G	A	11	9	20	0	0	20	0	0
13	7316830	.	C	G	10	6	16	0	2	18	0	0
13	7316903	.	G	A	4	2	6	0	0	6	0	0
13	7346655	.	C	A	11	9	20	1	0	21	0	0
13	7346683	.	A	G	15	12	27	1	0	28	0	0
13	7346798	.	A	G	16	22	38	0	1	39	0	0
13	7346928	.	A	C	18	10	28	0	1	29	0	0
13	7347026	.	A	G	15	15	30	0	1	31	0	0
13	7347060	.	G	T	12	10	22	0	0	22	0	0
13	7347061	.	A	T	12	9	21	0	1	22	0	0
13	7347125	.	G	A	10	6	16	0	1	17	0	0
13	7725965	.	C	T	2	2	4	0	0	4	0	0
13	7744319	.	A	G	3	4	7	0	1	8	0	0
13	7744443	.	G	A	6	13	19	0	0	19	0	0
13	7745463	.	C	G	8	3	11	0	2	13	0	0
13	7745544	.	C	T	8	5	13	0	0	13	0	0
13	7745705	.	G	A	4	4	8	0	2	10	0	0
13	7745814	.	C	A	6	3	9	0	0	9	0	0
13	7745866	.	A	G	2	0	2	0	3	5	0	0
13	7745962	.	A	G	1	2	3	0	2	5	0	0
13	7747223	.	A	G	2	3	5	0	2	7	0	0
13	7747299	.	A	G	2	5	7	0	0	7	0	0
13	7747338	.	A	G	4	0	4	0	3	7	0	0
13	7747513	.	C	G	7	6	13	0	1	14	0	0
13	7747738	.	T	C	6	12	18	0	0	18	0	0
13	7747760	.	T	C	8	13	21	0	1	22	0	0
13	7748021	.	G	T	4	12	16	0	0	16	0	0
13	7748424	.	T	C	12	7	19	0	0	19	0	0
13	7748497	.	T	G	8	5	13	0	0	13	0	0
13	7748533	.	T	G	5	8	13	0	1	14	0	0
13	7748794	.	G	A	1	19	20	0	14	34	0	0
13	7748882	.	A	T	12	15	27	0	4	31	0	0
13	7748995	.	T	A	9	13	22	1	2	25	0	0
13	7749000	.	G	C	6	16	22	1	3	26	0	0
13	7753123	.	T	C	5	0	5	0	6	11	0	0
13	7755764	.	A	C	34	0	34	0	19	53	0	0
13	7755875	.	T	C	23	0	23	0	22	45	0	0
13	7759403	.	T	C	24	21	45	0	1	46	0	0
13	7763810	.	A	G	17	20	37	0	1	38	0	0
13	7766936	.	C	T	2	12	14	0	8	22	0	0
13	8142558	.	A	G	2	6	8	0	0	8	0	0
13	8152771	.	T	C	2	4	6	0	1	7	0	0
13	8270424	.	T	C	5	3	8	0	0	8	0	0
13	8270437	.	T	A	4	2	6	0	0	6	0	0
13	8277402	.	G	T	1	2	3	0	0	3	0	0
13	8277667	.	A	G	2	2	4	0	0	4	0	0
13	8281655	.	A	C	5	6	11	0	0	11	0	0
13	8281669	.	C	A	4	4	8	0	2	10	0	0
13	8281828	.	G	A	2	6	8	0	1	9	0	0
13	8281876	.	G	T	5	7	12	0	0	12	0	0
13	8281882	.	T	G	4	6	10	0	1	11	0	0
13	8285256	.	T	A	5	4	9	0	0	9	0	0
13	8285430	.	G	A	3	2	5	0	2	7	0	0
13	8290860	.	A	C	1	2	3	0	0	3	0	0
13	8320743	.	A	G	3	5	8	0	1	9	0	0
13	8320852	.	C	G	2	4	6	0	0	6	0	0
13	8320855	.	C	G	2	3	5	0	1	6	0	0
13	8326274	.	T	C	3	5	8	0	2	10	0	0
13	8330568	.	G	A	6	2	8	0	1	9	0	0
13	8333864	.	G	A	1	3	4	0	0	4	0	0
13	8333942	.	G	A	4	2	6	0	0	6	0	0
13	8348161	.	G	A	1	4	5	0	0	5	0	0
13	8375857	.	T	C	5	0	5	0	7	12	0	0
13	8375932	.	A	T	21	12	33	0	2	35	0	0
13	8375935	.	C	A	22	14	36	0	0	36	0	0
13	8375981	.	A	G	23	25	48	0	2	50	0	0
13	8376064	.	A	G	18	9	27	0	0	27	0	0
13	8376077	.	C	G	15	9	24	0	0	24	0	0
13	8376184	.	C	T	10	5	15	0	1	16	0	0
13	8376187	.	G	A	11	6	17	0	0	17	0	0
13	8376301	.	A	T	8	13	21	0	0	21	0	0
13	8376317	.	T	A	10	8	18	0	1	19	0	0
13	8376355	.	C	T	9	6	15	0	0	15	0	0
13	8376613	.	T	G	7	7	14	0	0	14	0	0
13	8376675	.	C	A	0	8	8	0	12	20	0	0
13	8376727	.	T	A	16	2	18	0	0	18	0	0
13	8376731	.	C	T	14	3	17	0	0	17	0	0
13	8376765	.	C	A	9	4	13	0	3	16	0	0
13	8376845	.	A	G	7	9	16	0	2	18	0	0
13	8376882	.	C	T	1	6	7	0	5	12	0	0
13	8376896	.	T	C	5	5	10	0	1	11	0	0
13	8377327	.	A	G	3	2	5	0	0	5	0	0
13	8377334	.	A	G	5	2	7	0	0	7	0	0
13	8377624	.	C	T	2	2	4	0	0	4	0	0
13	8378018	.	A	C	2	2	4	0	0	4	0	0
13	8378511	.	A	T	4	4	8	0	0	8	0	0
13	8378559	.	C	A	4	2	6	0	0	6	0	0
13	8378588	.	C	A	0	2	2	0	4	6	0	0
13	8378601	.	T	C	4	2	6	0	0	6	0	0
13	8378698	.	C	A	1	2	3	0	0	3	0	0
13	8379079	.	A	C	6	0	6	0	3	9	0	0
13	8379096	.	T	G	1	3	4	0	1	5	0	0
13	8379119	.	C	T	2	5	7	0	0	7	0	0
13	8380477	.	T	C	1	2	3	0	0	3	0	0
13	8381285	.	C	T	2	2	4	0	0	4	0	0
13	8453381	.	G	T	1	2	3	0	0	3	0	0
13	8453433	.	G	A	1	3	4	0	1	5	0	0
13	8453690	.	C	T	1	2	3	0	0	3	0	0
13	8465007	.	G	T	1	3	4	0	0	4	0	0
13	8600654	.	A	T	1	2	3	0	0	3	0	0
13	8622801	.	T	C	1	3	4	0	0	4	0	0
13	8623517	.	A	C	1	2	3	0	0	3	0	0
13	8624760	.	T	A	3	2	5	0	0	5	0	0
13	8625050	.	A	G	2	0	2	0	2	4	0	0
13	8625102	.	T	C	2	2	4	0	0	4	0	0
13	8625106	.	T	A	2	2	4	0	0	4	0	0
13	8625167	.	T	C	3	2	5	0	0	5	0	0
13	8625210	.	C	G	2	3	5	0	1	6	0	0
13	8625247	.	T	C	2	4	6	0	0	6	0	0
13	8626645	.	T	A	3	5	8	0	0	8	0	0
13	8626699	.	C	T	2	5	7	0	0	7	0	0
13	8626841	.	C	T	8	4	12	0	0	12	0	0
13	8627056	.	T	C	2	5	7	0	1	8	0	0
13	8627302	.	C	A	5	4	9	0	0	9	0	0
13	8627521	.	G	A	0	4	4	0	3	7	0	0
13	8627532	.	G	A	3	5	8	0	0	8	0	0
13	8627586	.	G	T	4	4	8	0	0	8	0	0
13	8627634	.	T	A	3	7	10	0	1	11	0	0
13	8627819	.	T	C	1	3	4	0	0	4	0	0
13	8683804	.	C	T	1	5	6	0	0	6	0	0
13	8683879	.	A	T	3	4	7	0	0	7	0	0
13	8684134	.	A	G	3	7	10	0	0	10	0	0
13	8684175	.	C	T	2	3	5	0	0	5	0	0
13	8684460	.	A	G	2	8	10	0	0	10	0	0
13	8684464	.	G	A	2	9	11	0	0	11	0	0
13	8684499	.	C	T	4	8	12	0	1	13	0	0
13	8684513	.	T	C	7	8	15	0	2	17	0	0
13	8684608	.	G	A	2	8	10	0	1	11	0	0
13	8684705	.	A	G	4	9	13	0	0	13	0	0
13	8685051	.	C	T	0	5	5	0	4	9	0	0
13	8685176	.	C	T	1	4	5	0	1	6	0	0
13	8685217	.	A	T	2	5	7	0	0	7	0	0
13	8685228	.	G	C	2	5	7	0	0	7	0	0
13	8685278	.	C	A	7	6	13	0	0	13	0	0
13	8685417	.	G	A	1	6	7	0	2	9	0	0
13	8685496	.	A	T	7	6	13	0	3	16	0	0
13	8685542	.	G	A	10	5	15	0	1	16	0	0
13	8692306	.	C	T	7	9	16	0	1	17	0	0
13	8692395	.	A	G	4	7	11	0	0	11	0	0
13	8692776	.	T	G	4	4	8	0	1	9	0	0
13	8777701	.	G	A	17	13	30	0	1	31	0	0
13	8777724	.	T	C	16	9	25	0	2	27	0	0
13	8778490	.	G	A	39	29	68	0	2	70	0	0
13	8778501	.	G	T	45	21	66	0	6	72	0	0
13	8778548	.	G	A	34	27	61	0	9	70	0	0
13	8781222	.	T	C	2	3	5	0	0	5	0	0
13	8781266	.	A	G	1	2	3	0	0	3	0	0
13	8781577	.	A	G	31	35	66	0	2	68	0	0
13	8781786	.	C	T	29	31	60	0	3	63	0	0
13	8781789	.	A	C	29	33	62	0	3	65	0	0
13	8785294	.	C	G	17	15	32	0	0	32	0	0
13	8785327	.	T	C	9	4	13	0	0	13	0	0
13	8937472	.	T	G	2	2	4	0	0	4	0	0
13	8945365	.	C	T	2	3	5	0	0	5	0	0
13	8945642	.	C	G	4	4	8	0	1	9	0	0
13	8945646	.	T	G	4	5	9	0	0	9	0	0
13	8946981	.	T	C	2	3	5	0	0	5	0	0
13	8947046	.	G	A	2	2	4	0	0	4	0	0
13	8947095	.	C	T	3	3	6	0	0	6	0	0
13	8950686	.	G	A	4	4	8	0	0	8	0	0
13	8950783	.	C	G	5	8	13	0	0	13	0	0
13	8950795	.	C	A	10	5	15	0	0	15	0	0
13	8950829	.	A	G	1	8	9	0	1	10	0	0
13	9300177	.	A	G	5	2	7	0	0	7	0	0
13	9300224	.	C	T	0	1	1	0	5	6	0	0
13	9300239	.	G	T	2	2	4	0	0	4	0	0
13	9307202	.	C	T	0	13	13	0	14	27	0	0
13	9307646	.	T	C	8	15	23	0	0	23	0	0
13	9311011	.	G	T	6	12	18	0	3	21	0	0
13	9314040	.	T	A	29	45	74	0	2	77	1	0
13	9314104	.	C	T	3	28	31	0	38	69	0	0
13	9314322	.	G	A	35	30	65	0	3	68	0	0
13	9314340	.	C	T	37	34	71	0	3	74	0	0
13	9314532	.	T	C	40	12	52	0	30	83	1	0
13	9314657	.	C	T	35	36	71	0	3	74	0	0
13	9314680	.	G	A	24	41	65	0	5	70	0	0
13	9314800	.	T	C	41	40	81	0	3	84	0	0
13	9314935	.	G	A	33	40	73	0	5	78	0	0
13	9315004	.	C	T	40	34	74	0	3	77	0	0
13	9315019	.	T	C	36	29	65	0	10	75	0	0
13	9315192	.	T	C	27	43	70	0	3	73	0	0
13	9315321	.	G	T	40	42	82	0	3	85	0	0
13	9317915	.	T	C	40	45	85	0	2	87	0	0
13	9318491	.	G	C	26	47	73	0	4	77	0	0
13	9318638	.	G	C	20	4	24	0	48	72	0	0
13	9318644	.	T	C	21	47	68	0	3	71	0	0
13	9318682	.	T	C	19	2	21	0	48	69	0	0
13	9318699	.	A	T	23	44	67	0	4	72	1	0
13	9340093	.	C	T	1	8	9	0	7	16	0	0
13	9340199	.	T	C	12	6	18	0	0	18	0	0
13	9340527	.	C	T	12	5	17	0	1	18	0	0
13	9340609	.	C	A	1	7	8	0	12	20	0	0
13	9340671	.	G	A	13	9	22	0	3	25	0	0
13	9343329	.	T	C	13	8	21	0	1	22	0	0
13	9344878	.	A	T	7	14	21	0	0	21	0	0
13	9345182	.	A	C	14	7	21	0	1	22	0	0
13	9351194	.	T	C	11	12	23	0	2	25	0	0
13	9358449	.	C	T	8	7	15	0	1	16	0	0
13	9361825	.	T	C	13	4	17	0	1	18	0	0
13	9362035	.	T	A	2	6	8	0	1	9	0	0
13	9367117	.	G	T	11	5	16	0	0	16	0	0
13	9367537	.	A	G	8	6	14	0	2	16	0	0
13	9367562	.	T	A	11	9	20	0	2	22	0	0
13	9367600	.	G	T	10	6	16	0	2	18	0	0
13	9374533	.	A	G	1	2	3	0	0	3	0	0
13	9524550	.	C	T	1	5	6	0	0	6	0	0
13	9524553	.	A	C	1	0	1	0	5	6	0	0
13	9760400	.	G	C	1	2	3	0	0	3	0	0
13	9760413	.	C	A	1	3	4	0	0	4	0	0
13	9828933	.	G	T	6	5	11	0	1	12	0	0
13	9829232	.	T	C	3	4	7	0	0	7	0	0
13	9829252	.	T	A	1	3	4	0	0	4	0	0
13	9829289	.	T	C	3	6	9	0	0	9	0	0
13	9829406	.	A	C	2	2	4	0	0	4	0	0
13	9829408	.	G	A	2	2	4	0	0	4	0	0
13	9829855	.	C	T	6	4	10	0	1	11	0	0
13	9830089	.	T	C	1	5	6	0	1	7	0	0
13	9830147	.	A	T	1	7	8	0	0	8	0	0
13	9830148	.	C	G	1	7	8	0	0	8	0	0
13	9830399	.	C	T	3	2	5	0	0	5	0	0
13	9830417	.	C	A	3	2	5	0	1	6	0	0
13	9830518	.	A	T	2	6	8	0	0	8	0	0
13	9830521	.	A	C	2	5	7	0	0	7	0	0
13	9830554	.	A	G	4	6	10	0	0	10	0	0
13	9830597	.	C	A	3	2	5	0	1	6	0	0
13	9831056	.	G	C	4	4	8	0	0	8	0	0
13	9831116	.	A	G	10	12	22	0	2	24	0	0
13	9836485	.	A	T	4	5	9	0	0	9	0	0
13	9839813	.	G	A	5	5	10	1	0	11	0	0
13	9840152	.	G	A	3	2	5	0	0	5	0	0
13	9841702	.	T	A	7	8	15	0	3	18	0	0
13	9844527	.	A	G	14	2	16	0	11	27	0	0
13	9844746	.	T	C	19	16	35	1	6	42	0	0
13	9855508	.	G	T	12	10	22	1	1	24	0	0
13	9855874	.	G	A	12	20	32	0	2	34	0	0
13	9856143	.	G	A	4	14	18	0	4	22	0	0
13	9856192	.	A	G	12	10	22	0	3	25	0	0
13	9856493	.	A	T	28	8	36	0	3	39	0	0
13	9856816	.	G	A	7	12	19	0	2	21	0	0
13	9856993	.	T	A	18	5	23	1	4	28	0	0
13	9866857	.	G	A	1	3	4	0	2	6	0	0
13	10258734	.	T	G	4	1	5	0	12	17	0	0
13	10895731	.	T	G	11	7	18	0	3	21	0	0
13	10906719	.	G	A	7	15	22	0	3	25	0	0
13	10906817	.	T	C	12	9	21	0	2	23	0	0
13	10910423	.	G	T	0	17	17	0	14	31	0	0
13	10922497	.	T	G	2	4	6	0	0	6	0	0
13	10922536	.	C	T	4	3	7	0	0	7	0	0
13	10922613	.	A	T	9	12	21	0	0	21	0	0
13	10922660	.	G	A	4	7	11	0	1	12	0	0
13	10982404	.	C	T	14	11	25	0	1	26	0	0
13	10982444	.	G	A	13	12	25	0	3	28	0	0
13	10982472	.	T	G	8	13	21	0	2	23	0	0
13	10982966	.	A	T	10	16	26	0	2	28	0	0
13	10983139	.	C	T	3	4	7	0	0	7	0	0
13	10983231	.	G	A	8	4	12	0	4	16	0	0
13	10983482	.	T	A	14	5	19	0	0	19	0	0
13	10983788	.	T	C	6	8	14	0	1	15	0	0
13	10984205	.	G	A	16	19	35	0	1	36	0	0
13	10990959	.	G	A	3	7	10	0	1	11	0	0
13	10990973	.	T	C	2	0	2	0	8	10	0	0
13	10994107	.	A	G	4	12	16	0	0	16	0	0
13	10997566	.	A	G	7	6	13	0	0	13	0	0
13	11001998	.	A	G	7	4	11	0	0	11	0	0
13	11002013	.	A	C	7	0	7	0	5	12	0	0
13	11002052	.	A	G	4	3	7	0	3	10	0	0
13	11002234	.	C	T	0	6	6	0	3	9	0	0
13	11002247	.	G	A	4	5	9	0	0	9	0	0
13	11002541	.	A	G	4	6	10	0	0	10	0	0
13	11002697	.	A	G	1	6	7	0	0	7	0	0
13	11003297	.	C	T	1	2	3	0	1	4	0	0
13	11012349	.	C	T	2	2	4	0	0	4	0	0
13	11012430	.	T	A	4	2	6	0	0	6	0	0
13	11012437	.	C	T	4	1	5	0	1	6	0	0
13	11012469	.	T	C	2	3	5	0	1	6	0	0
13	11029585	.	G	T	2	3	5	0	0	5	0	0
13	11083167	.	A	G	1	3	4	0	0	4	0	0
13	11086319	.	C	G	2	0	2	0	3	5	0	0
13	11119837	.	A	G	3	3	6	0	0	6	0	0
13	11166435	.	G	A	2	4	6	0	0	6	0	0
13	11166467	.	A	G	2	3	5	0	0	5	0	0
13	11166508	.	A	G	1	3	4	0	0	4	0	0
13	11166524	.	A	T	1	3	4	0	1	5	0	0
13	11175605	.	G	A	1	2	3	0	1	4	0	0
13	11184784	.	G	A	4	4	8	0	0	8	0	0
13	11441080	.	T	A	8	13	21	0	1	22	0	0
13	11442090	.	A	T	16	9	25	0	3	28	0	0
13	11443349	.	C	T	4	4	8	0	21	29	0	0
13	11443457	.	T	A	27	19	46	0	1	47	0	0
13	11443881	.	C	T	26	15	41	0	1	42	0	0
13	11444022	.	A	T	14	18	32	0	0	32	0	0
13	11444263	.	G	A	2	18	20	0	21	41	0	0
13	11444295	.	C	T	27	20	47	0	0	47	0	0
13	11444801	.	T	A	22	16	38	0	3	41	0	0
13	11489965	.	T	C	9	7	16	0	0	16	0	0
13	11489999	.	C	A	10	11	21	0	3	24	0	0
13	11490035	.	A	G	12	12	24	0	1	25	0	0
13	11490065	.	G	A	10	6	16	0	2	18	0	0
13	11490084	.	G	A	10	6	16	0	0	16	0	0
13	11490214	.	A	C	3	2	5	0	0	5	0	0
13	11490300	.	G	T	4	5	9	0	1	10	0	0
13	11490626	.	G	A	7	5	12	0	0	12	0	0
13	11500299	.	T	C	5	0	5	0	7	12	0	0
13	11536901	.	T	A	1	8	9	0	0	9	0	0
13	11550734	.	G	T	0	5	5	0	3	8	0	0
13	11550741	.	T	C	3	5	8	0	0	8	0	0
13	11674874	.	A	G	2	2	4	0	0	4	0	0
13	11675148	.	G	A	10	7	17	0	1	18	0	0
13	11675185	.	A	G	13	5	18	0	0	18	0	0
13	11675270	.	G	A	3	5	8	0	0	8	0	0
13	11675343	.	C	G	3	3	6	0	2	8	0	0
13	11675378	.	T	C	2	3	5	0	0	5	0	0
13	11675584	.	C	T	4	2	6	0	1	7	0	0
13	11675855	.	T	G	4	1	5	0	1	6	0	0
13	11675912	.	A	T	6	2	8	0	0	8	0	0
13	11676403	.	C	T	3	2	5	0	0	5	0	0
13	11676694	.	G	A	3	2	5	0	0	5	0	0
13	11676787	.	A	C	2	0	2	1	2	5	0	0
13	11677896	.	C	T	0	3	3	0	1	4	0	0
13	11746459	.	C	A	17	24	41	0	1	42	0	0
13	11751402	.	G	A	16	15	31	0	1	32	0	0
13	11767651	.	T	C	6	5	11	0	0	11	0	0
13	11767768	.	A	G	8	9	17	0	0	17	0	0
13	11775095	.	G	A	4	5	9	0	0	9	0	0
13	11781751	.	C	T	1	4	5	0	4	9	0	0
13	11781769	.	A	G	2	2	4	0	0	4	0	0
13	11836187	.	C	T	1	3	4	0	0	4	0	0
13	11852302	.	C	T	3	3	6	0	0	6	0	0
13	11868812	.	A	G	5	4	9	0	1	10	0	0
13	11869049	.	G	T	11	4	15	0	0	15	0	0
13	11869127	.	C	T	7	6	13	0	1	14	0	0
13	11869143	.	T	C	10	5	15	0	0	15	0	0
13	11869219	.	G	T	0	4	4	0	1	5	0	0
13	11869220	.	G	T	0	3	3	0	2	5	0	0
13	11869357	.	G	T	7	3	10	0	1	11	0	0
13	11876698	.	T	G	3	4	7	0	0	7	0	0
13	11876841	.	G	A	4	5	9	0	0	9	0	0
13	11876850	.	G	A	4	5	9	0	0	9	0	0
13	11911904	.	A	G	7	4	11	0	1	12	0	0
13	11921543	.	T	C	3	5	8	0	0	8	0	0
13	11923834	.	G	C	6	9	15	0	1	16	0	0
13	11926692	.	C	G	5	5	10	0	1	11	0	0
13	11927341	.	C	G	6	7	13	0	1	14	0	0
13	11927347	.	T	A	4	7	11	0	0	11	0	0
13	11927491	.	T	C	9	10	19	0	0	19	0	0
13	11927603	.	A	G	4	6	10	0	0	10	0	0
13	11927735	.	T	C	8	4	12	0	1	13	0	0
13	11927829	.	A	T	6	7	13	0	5	18	0	0
13	11927830	.	T	G	11	6	17	0	1	18	0	0
13	11966316	.	A	G	2	3	5	0	0	5	0	0
13	11977394	.	A	T	4	6	10	0	0	10	0	0
13	11984768	.	A	C	6	10	16	0	0	16	0	0
13	11984857	.	T	A	3	4	7	0	2	9	0	0
13	11989357	.	T	C	23	13	36	0	2	38	0	0
13	11989468	.	A	C	18	17	35	0	2	37	0	0
13	11989554	.	A	G	21	19	40	0	3	43	0	0
13	11989629	.	C	T	30	17	47	0	0	47	0	0
13	11989633	.	T	C	29	15	44	0	0	44	0	0
13	11989698	.	C	T	18	15	33	0	2	35	0	0
13	11990118	.	G	A	23	15	38	0	2	40	0	0
13	11990175	.	T	C	20	1	21	0	14	35	0	0
13	11990294	.	A	G	11	17	28	0	3	31	0	0
13	11990329	.	T	G	13	17	30	0	1	31	0	0
13	11990389	.	G	T	18	12	30	0	2	32	0	0
13	11993451	.	A	T	18	11	29	0	0	29	0	0
13	12000699	.	T	C	3	3	6	0	1	7	0	0
13	12000700	.	G	C	3	4	7	0	0	7	0	0
13	12000906	.	T	A	6	5	11	0	1	12	0	0
13	12001110	.	T	C	3	2	5	0	0	5	0	0
13	12001254	.	A	G	2	3	5	0	0	5	0	0
13	12005588	.	C	T	0	2	2	0	4	6	0	0
13	12045797	.	A	T	4	5	9	0	0	9	0	0
13	12087528	.	G	A	2	14	16	0	14	30	0	0
13	12088223	.	C	G	24	12	36	0	2	38	0	0
13	12088255	.	A	G	18	12	30	0	2	32	0	0
13	12088327	.	A	G	14	17	31	0	1	32	0	0
13	12088406	.	T	C	8	15	23	0	2	25	0	0
13	12088795	.	T	C	5	4	9	0	0	9	0	0
13	12201923	.	C	G	2	2	4	0	1	5	0	0
13	12202096	.	A	T	2	2	4	0	0	4	0	0
13	12207170	.	A	T	6	9	15	0	0	15	0	0
13	12207583	.	G	T	10	3	13	0	1	14	0	0
13	12207591	.	A	T	9	4	13	0	0	13	0	0
13	12207656	.	C	T	7	10	17	0	0	17	0	0
13	12300502	.	G	A	1	3	4	0	0	4	0	0
13	12372552	.	C	A	6	4	10	1	1	12	0	0
13	12372596	.	C	G	6	9	15	0	0	15	0	0
13	12372609	.	C	G	5	5	10	0	2	12	0	0
13	12372777	.	A	G	6	5	11	0	1	12	0	0
13	12373033	.	A	G	4	0	4	0	9	13	0	0
13	12373059	.	T	C	3	7	10	0	1	11	0	0
13	12373093	.	A	T	4	2	6	0	1	7	0	0
13	12373126	.	T	G	7	7	14	0	0	14	0	0
13	12373153	.	T	C	4	9	13	0	0	13	0	0
13	12373262	.	C	T	5	6	11	0	0	11	0	0
13	12373274	.	A	T	4	7	11	0	0	11	0	0
13	12373332	.	T	G	4	4	8	1	0	9	0	0
13	12373430	.	T	A	6	8	14	0	0	14	0	0
13	12373460	.	A	G	4	8	12	0	0	12	0	0
13	12373572	.	C	T	3	2	5	0	0	5	0	0
13	12373679	.	T	C	2	5	7	0	0	7	0	0
13	12374414	.	A	G	3	7	10	0	1	11	0	0
13	12374710	.	A	G	9	1	10	0	8	18	0	0
13	12374771	.	A	G	11	6	17	0	0	17	0	0
13	12374775	.	T	G	10	6	16	0	1	17	0	0
13	12374901	.	C	A	9	10	19	0	0	19	0	0
13	12374910	.	G	A	0	10	10	0	10	20	0	0
13	12374954	.	A	C	6	9	15	0	0	15	0	0
13	12375198	.	A	G	15	11	26	0	3	29	0	0
13	12375348	.	C	A	6	8	14	0	0	14	0	0
13	12375389	.	A	G	9	10	19	0	3	22	0	0
13	12378315	.	T	A	5	7	12	0	0	12	0	0
13	12378356	.	T	G	9	10	19	0	2	21	0	0
13	12378407	.	T	C	11	8	19	0	1	20	0	0
13	12385182	.	A	G	13	11	24	0	0	24	0	0
13	12385538	.	G	T	11	7	18	0	0	18	0	0
13	12387658	.	G	A	10	10	20	0	1	21	0	0
13	12419787	.	C	T	2	4	6	0	0	6	0	0
13	12423756	.	T	C	3	3	6	0	0	6	0	0
13	12441437	.	A	G	3	3	6	0	1	7	0	0
13	12443656	.	C	T	2	2	4	0	1	5	0	0
13	12443951	.	C	T	4	3	7	0	0	7	0	0
13	12444014	.	T	C	4	3	7	0	0	7	0	0
13	12444218	.	A	T	3	1	4	0	2	6	0	0
13	12447952	.	T	C	6	7	13	0	0	13	0	0
13	12447961	.	A	C	6	6	12	0	0	12	0	0
13	12450980	.	G	T	7	2	9	0	0	9	0	0
13	12451397	.	T	C	5	8	13	0	0	13	0	0
13	12479328	.	G	C	2	3	5	0	1	6	0	0
13	12479382	.	C	A	6	3	9	0	1	10	0	0
13	12479490	.	G	A	15	10	25	0	4	29	0	0
13	12482650	.	A	C	8	19	27	0	1	28	0	0
13	12485035	.	G	A	13	12	25	0	0	25	0	0
13	12489360	.	A	G	7	5	12	0	0	12	0	0
13	12489553	.	T	A	4	2	6	1	0	7	0	0
13	12494069	.	C	T	2	2	4	0	0	4	0	0
13	12494485	.	A	T	1	3	4	0	0	4	0	0
13	12624860	.	C	T	5	9	14	0	0	14	0	0
13	12628901	.	C	T	16	13	29	0	0	29	0	0
13	12632260	.	A	G	11	0	11	0	9	20	0	0
13	12632946	.	T	A	7	6	13	0	0	13	0	0
13	12632967	.	T	C	8	4	12	0	0	12	0	0
13	12633014	.	C	G	6	5	11	0	0	11	0	0
13	12635858	.	T	A	2	3	5	0	0	5	0	0
13	12665126	.	A	G	5	5	10	1	1	12	0	0
13	12665152	.	T	C	4	3	7	0	0	7	0	0
13	12665227	.	C	A	6	4	10	0	0	10	0	0
13	12665328	.	C	A	5	4	9	0	0	9	0	0
13	12665546	.	T	C	11	7	18	0	0	18	0	0
13	12665587	.	C	T	2	5	7	0	11	18	0	0
13	12665678	.	T	A	4	5	9	0	0	9	0	0
13	12665699	.	T	C	2	4	6	0	0	6	0	0
13	12665945	.	A	C	3	5	8	0	0	8	0	0
13	12665963	.	A	G	4	4	8	0	0	8	0	0
13	12666038	.	G	A	5	4	9	0	1	10	0	0
13	12666182	.	C	T	0	3	3	0	3	6	0	0
13	12666362	.	A	G	8	3	11	0	0	11	0	0
13	12675939	.	A	G	1	2	3	0	0	3	0	0
13	12681150	.	T	C	1	4	5	0	1	6	0	0
13	12681183	.	C	A	3	0	3	0	2	5	0	0
13	12681188	.	C	A	1	2	3	0	1	4	0	0
13	12681443	.	G	A	2	2	4	0	0	4	0	0
13	12681553	.	T	A	1	2	3	0	0	3	0	0
13	12681716	.	T	C	1	2	3	0	0	3	0	0
13	12739555	.	A	G	3	3	6	0	0	6	0	0
13	12739630	.	C	G	1	0	1	0	3	4	0	0
13	12739939	.	C	T	3	6	9	0	0	9	0	0
13	12740092	.	G	T	2	2	4	0	2	6	0	0
13	12740129	.	C	T	5	2	7	0	0	7	0	0
13	12740236	.	A	G	6	6	12	0	3	15	0	0
13	12740263	.	T	G	8	0	8	0	6	14	0	0
13	12740674	.	G	A	6	7	13	0	0	13	0	0
13	12765738	.	T	G	3	3	6	0	0	6	0	0
13	12769323	.	T	C	2	2	4	0	0	4	0	0
13	12778142	.	T	C	2	2	4	0	1	5	0	0
13	12778653	.	A	C	1	4	5	0	0	5	0	0
13	12778862	.	T	A	3	4	7	0	0	7	0	0
13	12904840	.	C	A	2	2	4	0	0	4	0	0
13	12918191	.	T	C	3	2	5	0	0	5	0	0
13	12918194	.	T	C	3	1	4	0	0	4	0	0
13	12918227	.	G	C	4	2	6	0	0	6	0	0
13	12920645	.	A	C	2	4	6	0	0	6	0	0
13	12920651	.	A	T	1	3	4	0	0	4	0	0
13	12920837	.	T	C	5	3	8	0	0	8	0	0
13	12920924	.	C	T	2	3	5	0	0	5	0	0
13	12940084	.	C	T	1	2	3	0	1	4	0	0
13	12943630	.	G	A	6	3	9	0	0	9	0	0
13	12946108	.	G	A	3	3	6	1	2	9	0	0
13	12955278	.	T	C	3	3	6	0	1	7	0	0
13	12955335	.	C	T	5	5	10	0	0	10	0	0
13	12955377	.	C	T	7	6	13	0	0	13	0	0
13	12955549	.	C	T	6	7	13	0	0	13	0	0
13	12955615	.	T	C	7	3	10	0	0	10	0	0
13	12957817	.	G	A	14	9	23	0	2	25	0	0
13	12961126	.	T	A	10	8	18	0	0	18	0	0
13	12961141	.	C	T	8	5	13	0	1	14	0	0
13	12963052	.	C	T	6	11	17	0	2	19	0	0
13	12971757	.	A	C	9	16	25	0	3	28	0	0
13	12971763	.	A	G	10	0	10	0	19	29	0	0
13	12974602	.	A	G	17	13	30	0	0	30	0	0
13	12985253	.	G	A	1	17	18	0	21	39	0	0
13	12985291	.	G	A	19	21	40	0	0	40	0	0
13	12985539	.	T	C	24	11	35	0	1	36	0	0
13	12985540	.	A	G	22	0	22	0	13	35	0	0
13	12994199	.	C	A	9	2	11	0	2	13	0	0
13	12994364	.	A	G	7	5	12	0	5	17	0	0
13	12994395	.	A	G	9	7	16	0	0	17	1	0
13	12994738	.	A	T	11	13	24	0	2	26	0	0
13	12994801	.	A	G	13	13	26	0	0	26	0	0
13	12994802	.	G	T	13	11	24	0	2	26	0	0
13	12997845	.	C	T	9	5	14	0	2	16	0	0
13	12997966	.	A	G	6	3	9	0	1	10	0	0
13	12999701	.	G	T	2	6	8	0	0	8	0	0
13	13008910	.	C	T	1	2	3	0	0	3	0	0
13	13008939	.	C	T	3	3	6	0	0	6	0	0
13	13012030	.	G	C	3	2	5	0	0	5	0	0
13	13019148	.	C	T	1	2	3	0	0	3	0	0
13	13019277	.	C	G	1	2	3	0	0	3	0	0
13	13052882	.	G	A	0	3	3	0	1	4	0	0
13	13075034	.	T	C	2	6	8	0	1	9	0	0
13	13091046	.	C	A	7	7	14	0	1	15	0	0
13	13091079	.	T	C	7	5	12	0	1	13	0	0
13	13094050	.	T	A	3	3	6	0	0	6	0	0
13	13099615	.	A	G	2	2	4	0	1	5	0	0
13	13213678	.	A	G	5	3	8	0	1	9	0	0
13	13213900	.	T	C	1	0	1	1	4	6	0	0
13	13214412	.	G	A	12	21	33	0	1	34	0	0
13	13214462	.	T	A	16	18	34	0	1	35	0	0
13	13215426	.	T	G	3	4	7	0	1	8	0	0
13	13215767	.	T	A	1	2	3	0	2	5	0	0
13	13215796	.	G	A	2	2	4	0	1	5	0	0
13	13215984	.	T	C	3	2	5	0	0	5	0	0
13	13216092	.	G	A	5	5	10	0	0	10	0	0
13	13216251	.	G	A	5	4	9	0	0	9	0	0
13	13693781	.	A	T	6	5	11	0	0	11	0	0
13	13697957	.	G	A	0	2	2	0	3	5	0	0
13	13698433	.	T	C	7	3	10	0	0	10	0	0
13	13700335	.	A	C	5	2	7	0	0	7	0	0
13	13704011	.	T	G	6	8	14	0	0	14	0	0
13	13713106	.	C	G	7	6	13	0	0	13	0	0
13	13724919	.	T	A	10	3	13	0	0	13	0	0
13	13737474	.	G	C	24	16	40	0	2	42	0	0
13	13737514	.	A	G	24	2	26	0	23	49	0	0
13	13737524	.	G	A	25	25	50	0	3	53	0	0
13	13737612	.	G	C	3	9	12	0	35	47	0	0
13	13796754	.	A	C	2	3	5	0	0	5	0	0
13	13913140	.	G	C	3	9	12	0	4	16	0	0
13	13917976	.	C	T	6	3	9	0	2	11	0	0
13	13943220	.	A	G	5	3	8	0	0	8	0	0
13	13943234	.	A	T	3	4	7	0	0	7	0	0
13	13943372	.	C	A	5	3	8	0	0	8	0	0
13	13943562	.	G	T	6	4	10	0	0	10	0	0
13	13943670	.	A	C	2	6	8	1	0	9	0	0
13	13943684	.	G	T	2	7	9	1	0	10	0	0
13	13943788	.	T	C	7	9	16	0	0	16	0	0
13	13943959	.	T	C	8	6	14	0	0	14	0	0
13	13943983	.	A	G	9	9	18	0	0	18	0	0
13	13944064	.	A	G	10	5	15	0	0	15	0	0
13	13988395	.	A	C	1	2	3	0	1	4	0	0
13	13988647	.	G	A	2	2	4	0	0	4	0	0
13	13997299	.	C	T	5	4	9	0	1	10	0	0
13	13997536	.	T	C	1	3	4	0	0	4	0	0
13	13997545	.	G	A	1	2	3	0	1	4	0	0
13	14002979	.	G	T	1	4	5	0	0	5	0	0
13	14003099	.	A	G	4	8	12	0	1	13	0	0
13	14004161	.	T	C	10	6	16	1	0	17	0	0
13	14004209	.	C	T	4	6	10	0	1	11	0	0
13	14004276	.	C	T	6	6	12	0	0	12	0	0
13	14092573	.	G	A	1	4	5	0	0	5	0	0
13	14104076	.	T	C	1	6	7	0	0	7	0	0
13	14137061	.	C	T	5	3	8	0	1	9	0	0
13	14181750	.	C	T	8	8	16	1	0	17	0	0
13	14181952	.	T	C	4	6	10	0	0	10	0	0
13	14190780	.	C	T	0	22	22	0	19	41	0	0
13	14191033	.	T	C	16	13	29	0	2	31	0	0
13	14191045	.	G	C	19	8	27	0	1	28	0	0
13	14191528	.	A	G	11	11	22	0	3	25	0	0
13	14191553	.	A	G	18	7	25	0	1	26	0	0
13	14191724	.	G	A	14	13	27	0	4	31	0	0
13	14191769	.	T	C	25	13	38	0	1	39	0	0
13	14191797	.	A	G	21	14	35	0	0	35	0	0
13	14192110	.	T	C	7	18	25	0	0	25	0	0
13	14192131	.	G	A	7	14	21	0	0	21	0	0
13	14192178	.	A	T	6	7	13	0	0	13	0	0
13	14192414	.	A	G	7	9	16	0	0	16	0	0
13	14192448	.	A	C	5	10	15	0	0	15	0	0
13	14192506	.	G	A	9	5	14	0	0	14	0	0
13	14192511	.	A	T	9	4	13	0	1	14	0	0
13	14192561	.	G	T	7	4	11	0	1	12	0	0
13	14194055	.	C	G	6	7	13	0	0	13	0	0
13	14194109	.	C	G	7	5	12	0	0	12	0	0
13	14194110	.	C	A	7	5	12	0	0	12	0	0
13	14194241	.	C	G	1	3	4	0	4	8	0	0
13	14194256	.	A	G	4	5	9	0	0	9	0	0
13	14194484	.	C	T	5	4	9	0	1	10	0	0
13	14194571	.	G	A	5	9	14	0	1	15	0	0
13	14194573	.	C	A	6	9	15	0	0	15	0	0
13	14194611	.	T	G	3	11	14	0	0	14	0	0
13	14194660	.	G	A	5	10	15	0	0	15	0	0
13	14194904	.	T	C	10	5	15	0	0	15	0	0
13	14199190	.	A	G	5	13	18	0	1	19	0	0
13	14220900	.	G	A	4	4	8	1	0	9	0	0
13	17752932	.	A	T	10	9	19	0	1	20	0	0
13	17752993	.	C	A	6	11	17	0	0	17	0	0
13	17753104	.	C	T	2	3	5	1	0	6	0	0
13	17754071	.	T	G	4	10	14	0	0	15	1	0
13	17754275	.	G	T	13	5	18	0	1	19	0	0
13	17754571	.	C	G	5	3	8	1	1	10	0	0
13	17754897	.	C	T	1	6	7	0	7	14	0	0
13	17755618	.	T	C	7	5	12	0	1	13	0	0
13	17755743	.	G	A	6	5	11	0	0	11	0	0
13	17755898	.	G	A	6	3	9	0	0	9	0	0
13	17755980	.	G	A	3	5	8	0	0	8	0	0
13	17755989	.	G	T	0	6	6	0	0	6	0	0
13	17756043	.	G	A	5	3	8	0	0	8	0	0
13	18019724	.	T	C	3	4	7	0	0	7	0	0
13	18019758	.	C	T	0	4	4	0	6	10	0	0
13	18019786	.	C	T	1	4	5	0	4	9	0	0
13	18032872	.	C	T	0	3	3	0	5	8	0	0
13	18033053	.	A	G	6	4	10	0	0	10	0	0
13	18033405	.	T	C	4	2	6	0	0	6	0	0
13	18069338	.	C	A	2	2	4	0	0	4	0	0
13	18073433	.	A	G	13	15	28	0	2	30	0	0
13	18073460	.	C	T	19	11	30	0	1	31	0	0
13	18073557	.	C	A	6	10	16	0	0	16	0	0
13	18073706	.	G	A	12	14	26	0	1	27	0	0
13	18076710	.	T	G	11	14	25	1	1	27	0	0
13	18076722	.	G	T	13	15	28	1	1	30	0	0
13	18076818	.	G	A	6	16	22	0	1	23	0	0
13	18077056	.	G	T	20	9	29	0	2	31	0	0
13	18077116	.	G	A	17	10	27	0	2	29	0	0
13	18077206	.	C	T	17	14	31	0	3	34	0	0
13	18083210	.	G	T	9	9	18	0	1	19	0	0
13	18083415	.	G	A	7	9	16	0	0	16	0	0
13	18087918	.	G	A	7	6	13	0	1	14	0	0
13	18088276	.	T	G	10	7	17	0	1	18	0	0
13	18088283	.	C	T	0	9	9	0	9	18	0	0
13	18092062	.	G	T	3	7	10	0	2	12	0	0
13	18102984	.	A	G	1	3	4	0	2	6	0	0
13	18104881	.	C	T	0	3	3	0	2	5	0	0
13	18105007	.	A	G	4	2	6	1	1	8	0	0
13	18105023	.	T	G	3	4	7	1	0	8	0	0
13	18105136	.	C	A	1	3	4	0	3	7	0	0
13	18105382	.	A	G	4	2	6	0	0	6	0	0
13	18109897	.	T	C	1	0	1	0	2	3	0	0
13	18110284	.	C	T	1	3	4	0	2	6	0	0
13	18113387	.	G	T	3	2	5	0	1	6	0	0
13	18179151	.	C	A	6	4	10	0	0	10	0	0
13	18179733	.	T	A	9	6	15	0	2	17	0	0
13	18179859	.	C	A	7	15	22	0	6	28	0	0
13	18189874	.	G	A	4	5	9	0	1	10	0	0
13	18195926	.	G	A	1	5	6	0	0	6	0	0
13	18276074	.	A	C	1	2	3	0	0	3	0	0
13	18295212	.	C	T	1	3	4	0	0	4	0	0
13	18295423	.	G	A	0	2	2	0	1	3	0	0
13	18321156	.	T	C	8	7	15	0	0	15	0	0
13	18323464	.	A	G	10	7	17	0	2	19	0	0
13	18323595	.	G	A	2	10	12	0	22	34	0	0
13	18323653	.	A	G	12	0	12	0	11	23	0	0
13	18323787	.	T	A	12	10	22	0	2	24	0	0
13	18358680	.	G	A	9	14	23	0	0	23	0	0
13	18358890	.	G	C	14	14	28	0	2	30	0	0
13	18359112	.	G	C	13	12	25	2	1	28	0	0
13	18359176	.	C	A	14	17	31	0	2	33	0	0
13	18359202	.	C	T	14	12	26	0	1	27	0	0
13	18359507	.	A	T	10	12	22	1	0	23	0	0
13	18359551	.	T	C	10	10	20	0	0	20	0	0
13	18359554	.	A	G	8	10	18	0	1	19	0	0
13	18375512	.	T	A	1	5	6	0	0	6	0	0
13	18379281	.	A	T	1	2	3	0	1	4	0	0
13	18394755	.	T	A	1	8	9	0	1	10	0	0
13	18397416	.	G	C	3	2	5	0	0	5	0	0
13	18401308	.	C	T	4	2	6	0	0	6	0	0
13	18409776	.	T	A	4	2	6	1	0	7	0	0
13	18410799	.	G	C	0	2	2	0	1	3	0	0
13	18418390	.	C	T	4	6	10	0	1	11	0	0
13	18418528	.	G	A	6	10	16	0	1	17	0	0
13	18428103	.	A	G	17	12	29	0	0	29	0	0
13	18431301	.	C	T	12	15	27	0	3	30	0	0
13	18431430	.	C	T	3	8	11	0	1	12	0	0
13	18434075	.	A	G	6	0	6	0	3	9	0	0
13	18434085	.	C	T	7	3	10	0	0	10	0	0
13	18434150	.	T	C	6	3	9	0	2	11	0	0
13	18434427	.	C	T	2	10	12	0	2	14	0	0
13	18434519	.	C	A	6	7	13	0	0	13	0	0
13	18434520	.	G	C	2	7	9	0	4	13	0	0
13	18434570	.	C	G	17	8	25	0	1	26	0	0
13	18434615	.	A	G	17	0	17	0	13	30	0	0
13	18434794	.	C	A	8	8	16	0	1	17	0	0
13	18434902	.	C	T	9	7	16	0	3	19	0	0
13	18434957	.	G	A	9	5	14	0	0	14	0	0
13	18434962	.	A	G	8	4	12	0	0	12	0	0
13	18435036	.	C	A	5	2	7	0	1	8	0	0
13	18498907	.	T	C	1	2	3	0	0	3	0	0
13	18499660	.	C	T	3	2	5	0	0	5	0	0
13	18499747	.	C	T	3	2	5	0	0	5	0	0
13	18499864	.	C	T	2	2	4	0	2	6	0	0
13	18503693	.	C	T	4	2	6	0	0	6	0	0
13	18507715	.	A	C	2	6	8	0	0	8	0	0
13	18509592	.	G	A	0	7	7	0	5	12	0	0
13	18509940	.	C	T	2	8	10	0	0	10	0	0
13	18510033	.	C	G	5	0	5	0	3	8	0	0
13	18510204	.	T	C	4	13	17	0	1	18	0	0
13	18510324	.	A	G	6	6	12	0	0	12	0	0
13	18511023	.	C	T	12	7	19	0	1	20	0	0
13	18511140	.	A	G	20	0	20	0	15	35	0	0
13	18511637	.	A	C	6	13	19	0	2	21	0	0
13	18512082	.	C	G	16	12	28	0	4	32	0	0
13	18663103	.	G	A	5	3	8	0	0	8	0	0
13	18669200	.	G	T	9	13	22	0	5	27	0	0
13	18677437	.	T	C	5	5	10	0	0	10	0	0
13	18677467	.	G	A	4	3	7	0	0	7	0	0
13	18678392	.	G	A	6	2	8	0	0	8	0	0
13	18680027	.	G	A	2	4	6	0	0	6	0	0
13	18689043	.	C	T	3	3	6	0	1	7	0	0
13	18801566	.	G	A	4	4	8	0	0	8	0	0
13	18801615	.	G	A	1	2	3	0	0	3	0	0
13	19304688	.	A	G	20	16	36	0	1	37	0	0
13	19316930	.	G	C	9	15	24	0	2	26	0	0
13	19317016	.	T	A	6	8	14	0	0	14	0	0
13	19317018	.	C	G	4	8	12	0	1	13	0	0
13	19317499	.	G	C	9	6	15	0	2	17	0	0
13	19627266	.	A	C	2	4	6	0	0	6	0	0
13	19629032	.	G	T	2	3	5	0	0	5	0	0
13	19629266	.	C	G	5	4	9	0	1	10	0	0
13	19639198	.	A	G	2	2	4	0	0	4	0	0
13	19639205	.	G	A	4	2	6	0	0	6	0	0
13	19639238	.	T	C	4	4	8	0	0	8	0	0
13	19639256	.	T	C	6	0	6	0	3	9	0	0
13	19768396	.	G	T	14	12	26	2	2	30	0	0
13	19799192	.	A	G	9	13	22	0	1	23	0	0
13	19799467	.	G	A	12	10	22	0	0	22	0	0
13	19799611	.	C	A	1	10	11	0	11	22	0	0
13	19799623	.	T	C	13	11	24	0	2	26	0	0
13	19799646	.	C	A	3	9	12	0	13	26	1	0
13	20392670	.	G	C	5	0	5	0	8	14	1	0
13	20392704	.	G	A	13	6	19	0	0	19	0	0
13	20392714	.	G	T	12	6	18	0	2	20	0	0
13	20392752	.	G	A	16	5	21	0	0	21	0	0
13	20392788	.	A	G	16	7	23	0	1	24	0	0
13	20401263	.	C	A	3	12	15	0	15	30	0	0
13	20401267	.	T	C	11	13	24	0	5	29	0	0
13	20401392	.	C	T	15	5	20	0	1	21	0	0
13	20425191	.	A	G	4	4	8	0	0	8	0	0
13	20425396	.	C	T	0	3	3	0	3	6	0	0
13	20518608	.	A	T	0	2	2	0	1	3	0	0
13	20518620	.	C	T	0	2	2	0	1	3	0	0
13	21638634	.	C	T	0	3	3	0	1	4	0	0
13	21638955	.	C	A	1	5	6	0	0	6	0	0
13	21674509	.	T	C	1	4	5	0	1	6	0	0
13	21677961	.	G	A	5	4	9	0	0	9	0	0
13	21683057	.	A	C	6	7	13	0	0	13	0	0
13	21683546	.	C	T	12	16	28	0	1	29	0	0
13	21683636	.	G	A	20	12	32	0	1	33	0	0
13	21683762	.	C	T	2	14	16	0	16	32	0	0
13	21683928	.	G	A	20	20	40	0	4	44	0	0
13	21689373	.	G	A	5	2	7	0	0	7	0	0
13	21689530	.	A	T	7	7	14	0	1	15	0	0
13	21689667	.	A	T	1	2	3	0	1	4	0	0
13	21689883	.	T	G	10	11	21	0	0	21	0	0
13	21689982	.	G	A	4	4	8	0	0	8	0	0
13	21690053	.	T	A	3	3	6	0	0	6	0	0
13	21690104	.	C	T	1	4	5	0	9	14	0	0
13	21690229	.	A	C	5	7	12	2	2	16	0	0
13	21690507	.	T	A	12	13	25	0	1	26	0	0
13	21690636	.	T	C	15	4	19	0	1	20	0	0
13	21690877	.	A	C	7	0	7	1	4	12	0	0
13	21691386	.	G	A	7	3	10	0	0	10	0	0
13	21691609	.	C	T	2	2	4	0	0	4	0	0
13	21691671	.	G	A	5	7	12	0	0	12	0	0
13	21691695	.	T	A	7	4	11	0	1	12	0	0
13	21691787	.	C	G	6	9	15	0	0	15	0	0
13	21691843	.	G	A	4	9	13	0	0	13	0	0
13	21691935	.	A	G	6	5	11	0	0	11	0	0
13	21692084	.	T	A	2	4	6	0	1	7	0	0
13	21692085	.	C	A	3	3	6	0	1	7	0	0
13	21692328	.	C	A	10	4	14	0	4	18	0	0
13	21692338	.	C	T	9	8	17	0	0	17	0	0
13	21712507	.	G	A	9	9	18	0	0	18	0	0
13	21712526	.	G	A	10	7	17	0	1	18	0	0
13	21712755	.	G	C	4	7	11	0	0	11	0	0
13	21716581	.	T	C	3	6	9	0	1	10	0	0
13	21723514	.	G	C	6	5	11	0	0	11	0	0
13	21727796	.	T	A	2	4	6	0	3	9	0	0
13	21735278	.	C	T	2	3	5	0	0	5	0	0
13	21818793	.	C	T	1	2	3	0	0	3	0	0
13	21818812	.	C	T	3	2	5	0	1	6	0	0
13	21819997	.	G	A	2	4	6	0	0	6	0	0
13	21820802	.	A	T	7	6	13	0	0	13	0	0
13	21821393	.	A	C	2	2	4	0	0	4	0	0
13	21856576	.	A	T	2	6	8	0	0	8	0	0
13	21861775	.	A	C	2	3	5	0	0	5	0	0
13	21861777	.	G	A	2	3	5	0	0	5	0	0
13	21862288	.	T	A	4	7	11	0	1	12	0	0
13	21866324	.	C	T	4	3	7	0	0	7	0	0
13	21866357	.	A	C	4	5	9	0	1	10	0	0
13	21870319	.	G	C	4	6	10	0	0	10	0	0
13	21870323	.	T	C	3	5	8	0	1	9	0	0
13	21870374	.	G	A	0	12	12	0	11	23	0	0
13	21870467	.	G	C	2	16	18	0	7	26	1	0
13	21870575	.	A	G	7	1	8	0	16	24	0	0
13	21870608	.	A	T	9	13	22	0	1	23	0	0
13	21870629	.	C	T	11	9	20	0	2	22	0	0
13	21874107	.	C	T	16	7	23	0	1	24	0	0
13	21874128	.	G	T	4	13	17	0	3	20	0	0
13	21874149	.	G	T	2	7	9	0	11	20	0	0
13	21884298	.	C	T	12	15	27	0	0	27	0	0
13	21884407	.	T	C	10	11	21	0	1	22	0	0
13	21884408	.	C	T	9	11	20	0	2	22	0	0
13	21884467	.	C	T	9	10	19	0	1	20	0	0
13	21884979	.	T	C	12	7	19	0	3	22	0	0
13	21884980	.	C	T	10	9	19	0	3	22	0	0
13	21885250	.	C	T	20	22	42	1	2	45	0	0
13	22065089	.	G	A	2	3	5	0	0	5	0	0
13	22084034	.	C	T	5	8	13	0	0	13	0	0
13	22087988	.	C	T	7	12	19	0	0	19	0	0
13	22088061	.	T	G	13	1	14	0	5	19	0	0
13	22088105	.	G	A	10	9	19	0	2	21	0	0
13	22094800	.	T	C	7	14	21	0	0	21	0	0
13	22094871	.	T	G	7	17	24	0	1	25	0	0
13	22095340	.	C	T	9	12	21	0	2	23	0	0
13	22095589	.	G	A	4	16	20	0	0	20	0	0
13	22095594	.	T	A	4	17	21	0	0	21	0	0
13	22119935	.	T	C	5	5	10	0	1	11	0	0
13	22206667	.	A	T	12	12	24	0	0	24	0	0
13	22238209	.	T	C	16	20	36	0	0	36	0	0
13	22238233	.	G	A	17	19	36	0	1	37	0	0
13	22241027	.	G	A	17	23	40	0	0	40	0	0
13	22241123	.	G	T	2	17	19	0	15	34	0	0
13	22241374	.	A	C	24	20	44	0	2	46	0	0
13	22241482	.	G	C	12	14	26	0	1	27	0	0
13	22241648	.	T	G	28	14	42	0	2	44	0	0
13	22241821	.	T	C	20	19	39	0	8	47	0	0
13	22242394	.	C	G	20	28	48	0	4	52	0	0
13	22242837	.	T	G	25	25	50	0	2	53	1	0
13	22316792	.	A	G	1	0	1	0	2	3	0	0
13	22351910	.	A	G	2	3	5	0	0	5	0	0
13	22357105	.	C	A	2	2	4	0	0	4	0	0
13	22357236	.	T	G	3	2	5	0	0	5	0	0
13	22357823	.	C	T	3	2	5	0	0	5	0	0
13	22358021	.	A	G	3	3	6	0	0	6	0	0
13	22358174	.	G	A	0	4	4	0	4	8	0	0
13	22361332	.	G	A	6	4	10	0	0	10	0	0
13	22361718	.	A	C	4	6	10	0	1	11	0	0
13	22364908	.	T	C	8	8	16	0	1	17	0	0
13	22365016	.	C	T	14	8	22	0	2	24	0	0
13	22365404	.	C	T	10	11	21	0	0	21	0	0
13	22365461	.	A	G	6	16	22	0	1	23	0	0
13	22367600	.	C	A	11	12	23	0	0	23	0	0
13	22369295	.	T	C	6	5	11	0	0	11	0	0
13	22372075	.	T	C	16	19	35	0	2	37	0	0
13	22372154	.	T	C	12	17	29	0	5	34	0	0
13	22372175	.	A	G	10	20	30	0	4	34	0	0
13	22372205	.	A	G	8	22	30	0	3	33	0	0
13	22372737	.	C	T	7	11	18	0	1	19	0	0
13	22372932	.	G	T	12	5	17	0	0	17	0	0
13	22373241	.	G	A	1	16	17	0	11	28	0	0
13	22373336	.	C	A	13	9	22	0	1	23	0	0
13	22373761	.	G	A	14	7	21	3	0	24	0	0
13	22373931	.	C	T	3	10	13	0	0	13	0	0
13	22373940	.	A	G	3	9	12	0	2	14	0	0
13	22617913	.	T	G	2	0	2	0	2	4	0	0
13	22618320	.	A	G	1	0	1	0	3	4	0	0
13	22620302	.	C	G	2	2	4	0	0	4	0	0
13	22659195	.	C	G	11	0	11	0	19	30	0	0
13	22672354	.	A	T	25	18	43	0	4	47	0	0
13	22672791	.	C	G	20	14	34	1	0	35	0	0
13	22672825	.	T	C	22	1	23	0	0	23	0	0
13	22672833	.	T	A	21	0	21	0	0	21	0	0
13	22672952	.	G	A	4	12	16	0	0	16	0	0
13	22673006	.	A	C	2	10	12	0	2	14	0	0
13	22673068	.	A	T	4	8	12	0	0	12	0	0
13	22679837	.	G	A	1	3	4	0	0	4	0	0
13	22683416	.	A	T	3	5	8	0	0	8	0	0
13	22705172	.	G	C	1	2	3	0	0	3	0	0
13	22735063	.	T	C	9	3	12	0	1	13	0	0
13	22735139	.	A	G	6	5	11	0	1	12	0	0
13	22742791	.	G	A	13	9	22	0	0	22	0	0
13	22744359	.	A	G	1	10	11	0	1	12	0	0
13	22867888	.	G	A	0	4	4	0	7	11	0	0
13	22867910	.	A	G	4	5	9	0	0	9	0	0
13	22867953	.	G	T	3	5	8	0	1	9	0	0
13	22868447	.	G	A	1	2	3	0	2	5	0	0
13	22868456	.	T	C	2	2	4	0	1	5	0	0
13	22871900	.	C	A	4	8	12	0	1	13	0	0
13	22871989	.	A	G	4	3	7	0	0	7	0	0
13	22872375	.	G	T	2	2	4	0	0	4	0	0
13	22872406	.	G	T	2	2	4	0	0	4	0	0
13	22872519	.	T	A	1	3	4	0	1	5	0	0
13	22872538	.	C	T	2	3	5	0	0	5	0	0
13	22873022	.	C	T	3	2	5	0	1	6	0	0
13	22873030	.	G	T	5	2	7	0	0	7	0	0
13	22876576	.	T	C	8	0	8	0	7	15	0	0
13	22876623	.	G	A	6	15	21	0	0	21	0	0
13	22876678	.	A	T	9	7	16	0	0	16	0	0
13	22877076	.	C	T	21	13	34	0	1	35	0	0
13	22877130	.	G	T	16	16	32	0	1	33	0	0
13	22878754	.	G	A	12	25	37	0	4	41	0	0
13	22879149	.	A	T	16	10	26	0	0	26	0	0
13	22890835	.	A	C	17	2	19	0	19	38	0	0
13	22898042	.	A	G	11	11	22	0	1	23	0	0
13	22900733	.	G	A	3	7	10	0	0	10	0	0
13	22900742	.	A	T	5	6	11	0	1	12	0	0
13	22902882	.	A	C	3	8	11	0	0	11	0	0
13	22902987	.	G	A	5	6	11	0	1	12	0	0
13	22970288	.	C	T	1	2	3	0	0	3	0	0
13	22970289	.	T	C	1	2	3	0	0	3	0	0
13	22970628	.	G	A	1	2	3	0	1	4	0	0
13	22970688	.	T	C	2	3	5	1	0	6	0	0
13	22970816	.	T	G	3	2	5	0	0	5	0	0
13	22973314	.	A	G	31	26	57	0	3	60	0	0
13	22973348	.	A	G	25	30	55	0	2	57	0	0
13	22973531	.	T	C	28	0	28	0	24	52	0	0
13	22973895	.	A	G	29	16	45	0	5	50	0	0
13	22974033	.	A	G	23	23	46	0	6	52	0	0
13	22974108	.	C	T	27	11	38	0	2	40	0	0
13	22976067	.	C	A	14	23	37	0	1	38	0	0
13	22976070	.	G	A	11	23	34	0	2	36	0	0
13	22976383	.	T	C	15	0	15	0	13	28	0	0
13	22977283	.	G	A	18	20	38	0	0	38	0	0
13	22977319	.	A	G	17	16	33	0	0	33	0	0
13	22977343	.	A	G	16	12	28	0	1	29	0	0
13	22978059	.	T	C	19	0	19	0	9	28	0	0
13	22978062	.	G	A	20	10	30	0	0	30	0	0
13	23007677	.	A	G	1	2	3	0	0	3	0	0
13	23020947	.	C	T	1	2	3	0	0	3	0	0
13	23037831	.	C	A	13	5	18	0	0	18	0	0
13	23042321	.	A	G	6	5	11	0	1	12	0	0
13	23042387	.	C	G	6	4	10	0	1	11	0	0
13	23042676	.	A	G	9	12	21	0	0	21	0	0
13	23042745	.	G	A	7	6	13	0	1	14	0	0
13	23042929	.	G	T	4	9	13	0	0	13	0	0
13	23043112	.	T	C	5	2	7	0	1	8	0	0
13	23043117	.	A	G	4	3	7	0	1	8	0	0
13	23045229	.	G	A	4	3	7	0	1	8	0	0
13	23058975	.	G	A	4	3	7	0	9	16	0	0
13	23064735	.	T	C	5	4	9	0	0	9	0	0
13	23070787	.	C	T	3	5	8	0	1	9	0	0
13	23070895	.	T	C	12	7	19	0	0	19	0	0
13	23084177	.	C	G	21	8	29	1	2	32	0	0
13	23084841	.	G	C	10	18	28	0	0	28	0	0
13	23090190	.	A	C	7	10	17	0	2	19	0	0
13	23094356	.	T	C	6	0	6	0	6	12	0	0
13	23094895	.	G	T	5	8	13	0	2	15	0	0
13	23128675	.	A	G	6	0	6	0	2	8	0	0
13	23204849	.	A	C	2	3	5	0	0	5	0	0
13	23212821	.	A	G	3	4	7	0	0	7	0	0
13	23222899	.	A	T	5	3	8	0	0	8	0	0
13	23223122	.	A	G	2	6	8	0	0	8	0	0
13	23223469	.	T	A	7	6	13	0	0	13	0	0
13	23223486	.	C	T	5	7	12	0	1	13	0	0
13	23223567	.	C	T	3	7	10	0	1	11	0	0
13	23223572	.	C	T	3	7	10	0	1	11	0	0
13	23223675	.	C	A	4	3	7	0	1	8	0	0
13	23223875	.	C	A	4	4	8	0	3	11	0	0
13	23224087	.	G	A	8	9	17	0	0	17	0	0
13	23224113	.	A	T	8	5	13	0	0	13	0	0
13	23224360	.	A	G	8	7	15	0	0	15	0	0
13	23224363	.	T	G	8	7	15	0	0	15	0	0
13	23224427	.	C	T	13	8	21	0	0	21	0	0
13	23224470	.	G	A	15	7	22	0	1	23	0	0
13	23224605	.	G	T	14	5	19	0	0	19	0	0
13	23224727	.	C	T	11	7	18	0	1	19	0	0
13	23224735	.	A	G	9	7	16	0	2	18	0	0
13	23224821	.	T	A	8	16	24	0	1	25	0	0
13	23224860	.	T	A	13	10	23	0	0	23	0	0
13	23225541	.	T	C	10	12	22	0	1	23	0	0
13	23225776	.	T	A	10	11	21	0	0	21	0	0
13	23226114	.	G	A	1	14	15	0	13	28	0	0
13	23226213	.	A	C	15	10	25	0	0	25	0	0
13	23234398	.	C	T	1	2	3	0	0	3	0	0
13	23241260	.	A	G	3	4	7	0	0	7	0	0
13	23314904	.	T	G	7	7	14	0	0	14	0	0
13	23382393	.	G	A	11	15	26	0	0	26	0	0
13	23382572	.	T	C	15	17	32	0	4	36	0	0
13	23387252	.	T	C	8	8	16	0	1	17	0	0
13	23387337	.	C	T	7	3	10	0	0	10	0	0
13	23669773	.	C	T	1	4	5	0	0	5	0	0
13	23675183	.	C	T	3	2	5	0	1	6	0	0
13	23675510	.	T	C	3	3	6	0	0	6	0	0
13	23675892	.	G	C	0	2	2	0	2	4	0	0
13	23676856	.	G	A	0	2	2	0	3	5	0	0
13	23676913	.	C	A	6	3	9	0	0	9	0	0
13	23679888	.	G	A	2	2	4	0	0	4	0	0
13	23685075	.	G	A	1	4	5	0	0	5	0	0
13	23685301	.	G	A	5	2	7	0	1	8	0	0
13	23685361	.	T	G	1	0	1	0	5	6	0	0
13	23692515	.	C	T	6	4	10	0	4	14	0	0
13	23692572	.	C	T	9	5	14	0	0	14	0	0
13	23703048	.	G	C	4	6	10	0	1	11	0	0
13	23703053	.	T	C	5	7	12	0	0	12	0	0
13	23709532	.	C	T	11	15	26	0	0	26	0	0
13	23709562	.	T	C	15	15	30	0	3	33	0	0
13	23709592	.	A	G	16	18	34	0	2	36	0	0
13	23711937	.	G	A	20	12	32	0	3	35	0	0
13	23728490	.	T	A	4	5	9	0	0	9	0	0
13	23730801	.	G	A	9	6	15	0	0	15	0	0
13	23882377	.	A	G	2	2	4	0	0	4	0	0
13	23882686	.	C	T	3	4	7	0	0	7	0	0
13	23898045	.	T	G	17	14	31	0	1	32	0	0
13	23901334	.	C	T	11	11	22	0	3	25	0	0
13	23901349	.	T	C	10	10	20	0	4	24	0	0
13	23901502	.	A	G	10	15	25	0	2	27	0	0
13	23901555	.	A	G	10	0	10	0	11	21	0	0
13	23901570	.	T	C	10	9	19	0	2	21	0	0
13	23920791	.	A	G	6	12	18	0	2	20	0	0
13	23931192	.	T	C	5	0	5	0	6	11	0	0
13	23940708	.	T	C	2	0	2	0	4	6	0	0
13	23940754	.	C	A	2	10	12	0	1	13	0	0
13	23943040	.	T	G	6	6	12	0	0	12	0	0
13	23996192	.	G	A	6	4	10	0	0	10	0	0
13	23999129	.	G	A	5	8	13	0	0	13	0	0
13	24002850	.	T	C	4	3	7	0	0	7	0	0
13	24014578	.	T	C	2	2	4	0	0	4	0	0
13	24023036	.	G	T	8	3	11	0	0	11	0	0
13	24034206	.	A	G	2	2	4	0	0	4	0	0
13	24034215	.	G	A	2	2	4	0	0	4	0	0
13	24046953	.	G	A	0	2	2	0	2	4	0	0
13	24056221	.	C	T	5	8	13	0	4	17	0	0
13	24068790	.	C	T	1	12	13	0	13	26	0	0
13	24069624	.	C	A	14	9	23	0	1	24	0	0
13	24069902	.	A	T	10	7	17	0	1	18	0	0
13	24070242	.	C	T	0	13	13	0	3	16	0	0
13	24070578	.	G	A	2	2	4	0	3	7	0	0
13	24070730	.	C	T	8	7	15	0	2	17	0	0
13	24234815	.	C	A	3	3	6	0	1	7	0	0
13	24241436	.	A	G	4	3	7	0	0	7	0	0
13	24266756	.	G	C	1	2	3	0	0	3	0	0
13	24275663	.	G	A	1	2	3	0	0	3	0	0
13	24276128	.	T	A	4	3	7	0	0	7	0	0
13	24292398	.	G	A	5	4	9	0	0	9	0	0
13	24292419	.	G	A	7	3	10	0	0	10	0	0
13	24292796	.	T	A	11	13	24	0	3	27	0	0
13	24292800	.	A	T	12	15	27	0	0	27	0	0
13	24292866	.	C	A	8	16	24	0	14	38	0	0
13	24293162	.	C	A	10	17	27	0	2	29	0	0
13	24293218	.	T	A	22	13	35	0	0	35	0	0
13	24293220	.	G	C	22	12	34	0	2	36	0	0
13	24293448	.	A	G	21	17	38	0	1	39	0	0
13	24293465	.	C	T	4	20	24	0	13	37	0	0
13	24293615	.	G	A	16	17	33	0	10	43	0	0
13	24293691	.	G	A	17	28	45	0	1	46	0	0
13	24293698	.	C	T	27	15	42	0	0	42	0	0
13	24293940	.	G	A	21	10	31	0	2	33	0	0
13	24294046	.	A	G	12	11	23	0	0	23	0	0
13	24295999	.	T	C	0	6	6	0	0	6	0	0
13	24296013	.	C	T	3	2	5	0	1	6	0	0
13	24296430	.	C	A	1	10	11	0	0	11	0	0
13	24303667	.	C	A	9	7	16	0	0	16	0	0
13	24305975	.	T	G	6	6	12	0	0	12	0	0
13	24372095	.	G	T	3	4	7	0	0	7	0	0
13	24372764	.	T	C	1	0	1	0	2	3	0	0
13	24372771	.	C	T	1	2	3	0	0	3	0	0
13	24373003	.	G	A	1	2	3	0	0	3	0	0
13	24379015	.	A	G	1	3	4	0	1	5	0	0
13	24382510	.	C	A	8	4	12	0	1	13	0	0
13	24382539	.	T	C	3	8	11	0	0	11	0	0
13	24382578	.	G	A	8	3	11	0	0	11	0	0
13	24383528	.	T	G	3	0	3	0	4	7	0	0
13	24384282	.	G	C	6	5	11	0	0	11	0	0
13	24384425	.	A	T	8	6	14	0	2	16	0	0
13	24384807	.	G	A	6	9	15	0	3	18	0	0
13	24387484	.	G	T	7	6	13	0	0	13	0	0
13	24401618	.	A	G	3	7	10	0	1	11	0	0
13	24401626	.	G	C	0	3	3	0	8	11	0	0
13	24401663	.	C	A	4	4	8	0	2	10	0	0
13	24401769	.	C	A	2	2	4	0	0	4	0	0
13	24401776	.	T	A	1	2	3	0	1	4	0	0
13	24402490	.	G	A	0	8	8	0	8	16	0	0
13	24402560	.	T	C	5	7	12	0	0	12	0	0
13	24411553	.	T	C	15	12	27	0	2	29	0	0
13	24424572	.	C	T	0	2	2	0	1	3	0	0
13	24424724	.	T	C	5	2	7	0	1	8	0	0
13	24424875	.	C	A	1	2	3	0	0	3	0	0
13	24425112	.	T	C	1	0	1	0	2	3	0	0
13	24425133	.	G	A	2	2	4	0	0	4	0	0
13	24425630	.	C	A	1	2	3	0	1	4	0	0
13	24431365	.	T	G	6	8	14	0	0	14	0	0
13	24431784	.	T	G	11	22	33	0	5	38	0	0
13	24432162	.	G	C	10	13	23	0	4	27	0	0
13	24432212	.	T	C	13	0	13	0	11	24	0	0
13	24432350	.	C	T	2	8	10	0	19	29	0	0
13	24436054	.	G	A	6	3	9	0	1	10	0	0
13	24437225	.	G	A	4	5	9	0	1	10	0	0
13	24522570	.	G	T	2	3	5	0	0	5	0	0
13	24523321	.	G	A	9	7	16	0	0	18	2	0
13	24523425	.	A	G	2	5	7	0	1	8	0	0
13	24523731	.	A	G	4	2	6	0	0	6	0	0
13	24524206	.	G	A	5	8	13	0	1	14	0	0
13	24579187	.	A	T	11	11	22	0	0	22	0	0
13	24580372	.	G	A	12	10	22	1	2	25	0	0
13	24580411	.	G	A	16	15	31	1	0	32	0	0
13	24580441	.	A	G	15	0	15	0	14	29	0	0
13	24580705	.	C	T	17	6	23	0	2	25	0	0
13	24580869	.	T	C	13	9	22	0	1	23	0	0
13	24580941	.	T	C	12	10	22	0	0	22	0	0
13	24581274	.	G	A	16	21	37	0	0	37	0	0
13	24581316	.	C	A	20	17	37	0	1	38	0	0
13	24581334	.	G	C	23	18	41	0	3	44	0	0
13	24581358	.	T	C	22	20	42	0	0	42	0	0
13	24581748	.	A	C	18	12	30	0	0	30	0	0
13	24581798	.	T	A	9	7	16	0	2	18	0	0
13	24581840	.	T	G	18	10	28	0	4	32	0	0
13	24581854	.	C	T	24	13	37	0	1	38	0	0
13	24581982	.	G	A	1	13	14	0	18	32	0	0
13	24582047	.	A	G	13	14	27	0	1	28	0	0
13	24582110	.	C	T	9	12	21	0	0	21	0	0
13	24582122	.	T	C	8	12	20	0	0	20	0	0
13	24582211	.	C	T	4	6	10	0	1	11	0	0
13	24663625	.	C	A	1	3	4	0	0	4	0	0
13	24665869	.	C	T	5	3	8	0	1	9	0	0
13	24669179	.	G	A	0	4	4	0	0	4	0	0
13	24702275	.	C	T	2	7	9	0	1	10	0	0
13	24702383	.	G	A	9	8	17	0	2	19	0	0
13	24702415	.	T	C	10	9	19	0	0	19	0	0
13	24702743	.	C	T	4	8	12	0	0	12	0	0
13	24702822	.	A	C	3	8	11	0	0	11	0	0
13	24702883	.	A	T	15	10	25	0	0	25	0	0
13	24702974	.	T	C	8	11	19	0	1	20	0	0
13	24702996	.	G	A	5	13	18	0	0	18	0	0
13	24703319	.	C	T	1	4	5	0	0	5	0	0
13	24703325	.	A	T	1	3	4	0	0	4	0	0
13	24703473	.	G	T	3	4	7	0	2	9	0	0
13	24703490	.	G	A	1	4	5	0	1	6	0	0
13	24704032	.	A	G	3	3	6	0	0	6	0	0
13	24704102	.	C	A	3	9	12	0	1	13	0	0
13	24704191	.	A	T	7	11	18	0	1	19	0	0
13	24716363	.	T	C	3	3	6	0	2	8	0	0
13	24716375	.	A	T	3	3	6	0	1	7	0	0
13	24716415	.	T	C	1	6	7	0	0	7	0	0
13	24737309	.	A	C	1	2	3	0	0	3	0	0
13	24740703	.	C	A	1	1	2	0	1	3	0	0
13	24742835	.	G	A	6	3	9	0	0	9	0	0
13	24742836	.	T	A	6	3	9	0	0	9	0	0
13	24743234	.	A	C	2	2	4	0	0	4	0	0
13	24781605	.	T	C	6	19	25	0	0	25	0	0
13	24785591	.	C	A	14	9	23	0	1	24	0	0
13	24791020	.	A	G	3	3	6	0	0	6	0	0
13	24804224	.	G	C	1	3	4	0	0	4	0	0
13	24804321	.	T	C	2	2	4	0	0	4	0	0
13	24804804	.	A	G	1	3	4	0	0	4	0	0
13	24806423	.	T	C	3	0	3	0	2	5	0	0
13	24826382	.	G	A	1	3	4	0	0	4	0	0
13	24826389	.	T	C	0	0	0	0	3	3	0	0
13	24834358	.	A	G	6	5	11	0	0	11	0	0
13	24836958	.	C	T	10	7	17	0	0	17	0	0
13	24837246	.	T	C	5	4	9	0	0	9	0	0
13	24837253	.	T	A	4	3	7	0	2	9	0	0
13	24837392	.	A	G	16	8	24	0	6	30	0	0
13	24837407	.	T	A	25	8	33	0	0	33	0	0
13	24837876	.	T	C	8	4	12	0	0	12	0	0
13	24871485	.	C	T	15	12	27	0	3	30	0	0
13	24872733	.	G	A	10	4	14	0	1	15	0	0
13	24873141	.	C	A	1	10	11	0	6	17	0	0
13	24873186	.	A	T	4	6	10	0	1	11	0	0
13	24873267	.	G	A	9	12	21	0	0	21	0	0
13	24873480	.	A	G	9	11	20	0	0	20	0	0
13	24873579	.	C	T	2	7	9	0	0	9	0	0
13	24873597	.	G	T	2	8	10	0	0	10	0	0
13	24873990	.	A	G	1	7	8	0	0	8	0	0
13	24873995	.	T	G	1	6	7	0	0	7	0	0
13	24874837	.	A	G	7	4	11	0	1	12	0	0
13	24874894	.	T	A	7	7	14	0	0	14	0	0
13	24874934	.	A	G	2	5	7	0	2	9	0	0
13	24919010	.	C	A	8	4	12	0	0	12	0	0
13	24919317	.	C	T	10	4	14	0	1	15	0	0
13	24919518	.	T	C	6	4	10	0	0	10	0	0
13	24919969	.	A	T	3	5	8	0	0	8	0	0
13	24920098	.	C	T	14	13	27	0	1	28	0	0
13	24986203	.	G	A	3	7	10	0	3	13	0	0
13	24986238	.	G	T	3	8	11	0	2	13	0	0
13	24986272	.	T	C	9	0	9	0	5	14	0	0
13	25207064	.	G	C	3	1	4	0	0	4	0	0
13	25207068	.	C	T	3	1	4	0	1	5	0	0
13	25207368	.	A	G	3	2	5	0	1	6	0	0
13	25208276	.	A	G	3	3	6	0	0	6	0	0
13	25208484	.	T	G	4	3	7	0	1	8	0	0
13	25208501	.	G	T	3	3	6	0	0	6	0	0
13	25208545	.	T	A	1	3	4	0	0	4	0	0
13	25208675	.	T	C	2	3	5	0	1	6	0	0
13	25212540	.	C	A	3	4	7	0	0	7	0	0
13	25212657	.	A	G	1	2	3	0	0	3	0	0
13	25229573	.	G	A	1	2	3	0	0	3	0	0
13	25242602	.	C	T	1	2	3	0	0	3	0	0
13	25364915	.	A	T	1	3	4	0	0	4	0	0
13	25366749	.	T	A	3	6	9	0	0	9	0	0
13	25369449	.	C	T	8	3	11	0	3	14	0	0
13	25371436	.	A	G	7	6	13	0	0	13	0	0
13	25372806	.	G	A	11	7	18	0	2	20	0	0
13	25378590	.	G	A	3	20	23	0	5	28	0	0
13	25378924	.	T	G	16	11	27	1	0	28	0	0
13	25379263	.	A	T	20	13	33	0	2	35	0	0
13	25379304	.	A	G	17	1	18	0	20	38	0	0
13	25379352	.	A	C	15	12	27	0	5	32	0	0
13	25383915	.	C	T	6	7	13	0	0	13	0	0
13	25384145	.	A	G	3	3	6	0	4	10	0	0
13	25384223	.	A	G	7	6	13	0	0	13	0	0
13	25386904	.	C	T	9	8	17	0	0	17	0	0
13	25388389	.	G	A	5	8	13	0	1	14	0	0
13	25388644	.	T	C	5	6	11	0	1	12	0	0
13	25388658	.	T	A	5	8	13	0	0	13	0	0
13	25388708	.	G	T	6	7	13	0	0	13	0	0
13	25428952	.	C	G	11	5	16	0	0	16	0	0
13	25429048	.	T	A	6	7	13	0	0	13	0	0
13	25429079	.	C	T	8	6	14	0	1	15	0	0
13	25429145	.	G	A	5	7	12	0	1	13	0	0
13	25436336	.	A	T	14	11	25	0	3	28	0	0
13	25436360	.	A	T	10	8	18	0	2	20	0	0
13	25436381	.	G	A	10	8	18	0	1	19	0	0
13	25449688	.	A	C	2	7	9	0	0	9	0	0
13	25472735	.	G	A	12	15	27	0	0	27	0	0
13	25472756	.	T	C	18	13	31	0	2	33	0	0
13	25472859	.	G	A	16	21	37	0	1	38	0	0
13	25473039	.	C	T	20	28	48	0	1	49	0	0
13	25473325	.	G	A	25	15	40	0	2	42	0	0
13	25475889	.	C	T	15	15	30	0	0	30	0	0
13	25475904	.	A	G	13	15	28	0	0	28	0	0
13	25477249	.	G	A	16	8	24	0	0	24	0	0
13	25478749	.	A	T	3	3	6	0	0	6	0	0
13	25484638	.	G	T	6	12	18	0	3	21	0	0
13	25492923	.	A	T	7	4	11	1	1	13	0	0
13	25492992	.	C	G	5	5	10	0	0	10	0	0
13	25497320	.	A	G	10	0	10	0	11	21	0	0
13	25497575	.	T	C	10	6	16	0	1	17	0	0
13	25497581	.	C	T	10	7	17	0	1	18	0	0
13	25497700	.	G	C	9	15	24	0	0	25	1	0
13	25497880	.	T	C	9	9	18	0	2	20	0	0
13	25516204	.	T	C	2	4	6	0	1	7	0	0
13	25519063	.	G	A	0	3	3	0	1	4	0	0
13	25523608	.	C	T	3	1	4	0	1	5	0	0
13	25523629	.	T	C	2	3	5	0	0	5	0	0
13	25523677	.	G	A	0	3	3	0	3	6	0	0
13	25530063	.	C	T	2	3	5	0	0	5	0	0
13	25532352	.	C	T	11	11	22	0	1	23	0	0
13	25532509	.	T	A	13	12	25	0	3	28	0	0
13	25532574	.	C	A	5	15	20	0	3	23	0	0
13	25532706	.	T	C	7	6	13	0	0	13	0	0
13	25533175	.	T	C	11	14	25	0	1	26	0	0
13	25533233	.	G	A	18	5	23	0	4	27	0	0
13	25533258	.	T	A	20	6	26	0	3	29	0	0
13	25533657	.	C	G	8	0	8	0	14	22	0	0
13	25534165	.	T	C	15	5	20	0	4	24	0	0
13	25534407	.	C	T	18	14	32	0	2	34	0	0
13	25535405	.	G	A	2	7	9	0	0	9	0	0
13	25551781	.	C	A	4	3	7	0	0	7	0	0
13	25551865	.	T	C	4	4	8	0	0	8	0	0
13	25552219	.	T	C	4	2	6	0	0	6	0	0
13	25559610	.	G	A	3	4	7	0	0	7	0	0
13	25560416	.	C	T	3	3	6	0	0	6	0	0
13	25563221	.	C	A	6	4	10	0	0	10	0	0
13	25565379	.	T	C	11	12	23	0	1	24	0	0
13	25566057	.	G	A	0	3	3	0	6	9	0	0
13	25566205	.	A	T	7	4	11	0	0	11	0	0
13	25566222	.	C	T	6	5	11	0	0	11	0	0
13	25569865	.	A	G	10	9	19	0	1	20	0	0
13	25569874	.	A	G	12	9	21	0	2	23	0	0
13	25569940	.	A	C	5	6	11	0	1	12	0	0
13	25570008	.	T	C	7	6	13	0	1	14	0	0
13	25570013	.	C	T	7	3	10	0	3	13	0	0
13	25570104	.	C	T	8	6	14	0	0	14	0	0
13	25570108	.	T	A	7	5	12	0	0	12	0	0
13	25570341	.	T	C	5	0	5	0	4	9	0	0
13	25570427	.	T	A	11	5	16	0	1	17	0	0
13	25570561	.	A	C	7	6	13	0	0	13	0	0
13	25570715	.	C	T	9	5	14	0	1	15	0	0
13	25570842	.	A	T	8	6	14	0	0	14	0	0
13	25571113	.	A	T	4	5	9	0	0	9	0	0
13	25571274	.	C	T	7	8	15	0	1	16	0	0
13	25573189	.	G	A	4	3	7	0	0	7	0	0
13	25573397	.	C	T	7	2	9	0	0	9	0	0
13	25575396	.	C	T	4	0	4	0	3	7	0	0
13	25575411	.	A	C	4	2	6	0	1	7	0	0
13	25575453	.	G	A	5	3	8	0	0	8	0	0
13	25581121	.	T	C	5	7	12	0	1	13	0	0
13	25584993	.	A	T	5	5	10	0	0	10	0	0
13	25585785	.	T	C	1	3	4	0	0	4	0	0
13	25589241	.	G	A	5	5	10	0	0	10	0	0
13	25724747	.	G	A	3	7	10	0	1	11	0	0
13	25726378	.	C	G	3	5	8	0	1	9	0	0
13	25728037	.	G	A	2	7	9	0	0	9	0	0
13	25728453	.	A	C	4	9	13	0	0	13	0	0
13	25728606	.	A	T	6	5	11	0	2	13	0	0
13	25728738	.	A	C	4	3	7	0	0	7	0	0
13	25728747	.	A	G	3	3	6	0	0	6	0	0
13	25728836	.	T	C	5	4	9	0	0	9	0	0
13	25729440	.	G	A	4	5	9	0	0	9	0	0
13	25730774	.	C	T	3	3	6	0	0	6	0	0
13	25824616	.	T	A	15	16	31	0	2	33	0	0
13	25824718	.	C	T	18	11	29	0	5	34	0	0
13	25825016	.	G	A	20	12	32	0	1	33	0	0
13	25825263	.	A	T	5	9	14	0	0	14	0	0
13	25826362	.	T	C	20	0	20	0	7	27	0	0
13	25827129	.	T	G	5	7	12	0	4	16	0	0
13	25827421	.	G	A	7	16	23	0	4	27	0	0
13	25846994	.	C	A	12	8	20	0	1	21	0	0
13	25847136	.	T	A	9	8	17	0	0	17	0	0
13	25847144	.	G	T	11	5	16	0	0	16	0	0
13	25847176	.	G	A	7	5	12	0	0	12	0	0
13	25847226	.	T	G	6	5	11	0	1	12	0	0
13	25847928	.	C	T	2	2	4	0	1	5	0	0
13	25847973	.	G	T	3	4	7	0	0	7	0	0
13	25849234	.	T	G	7	3	10	0	0	10	0	0
13	25850874	.	G	A	5	4	9	0	1	10	0	0
13	25851753	.	C	T	3	3	6	0	0	6	0	0
13	25851883	.	G	A	2	3	5	0	0	5	0	0
13	27036660	.	T	C	5	3	8	0	2	10	0	0
13	28515205	.	T	C	1	7	8	0	0	8	0	0
13	29385831	.	G	A	1	9	10	0	0	10	0	0
13	29992513	.	T	C	2	2	4	0	1	5	0	0
13	29992519	.	T	C	4	2	6	0	0	6	0	0
13	30009021	.	T	A	9	3	12	0	1	13	0	0
13	32446278	.	G	A	7	3	10	0	1	11	0	0
13	32452775	.	C	T	3	11	14	0	0	14	0	0
13	32452924	.	G	T	6	4	10	0	0	11	1	0
13	32453227	.	G	T	3	2	5	0	0	5	0	0
13	32453362	.	T	G	2	3	5	0	0	5	0	0
13	32453582	.	A	G	4	4	8	0	0	8	0	0
13	32453661	.	G	T	4	4	8	0	0	8	0	0
13	32454546	.	A	G	4	1	5	0	2	7	0	0
13	32454617	.	G	A	1	2	3	0	1	4	0	0
13	32455754	.	C	T	4	7	11	0	0	11	0	0
13	32456736	.	G	T	2	4	6	1	0	7	0	0
13	32580616	.	G	A	5	4	9	0	0	9	0	0
13	32580618	.	C	G	5	4	9	0	0	9	0	0
13	32583864	.	C	T	3	13	16	0	0	16	0	0
13	32583915	.	G	A	9	4	13	0	0	13	0	0
13	32588892	.	A	G	6	6	12	0	0	12	0	0
13	32591702	.	C	T	5	4	9	0	0	9	0	0
13	32592973	.	C	T	6	3	9	0	1	10	0	0
13	32595257	.	C	T	6	4	10	0	0	10	0	0
13	32620662	.	A	G	1	2	3	0	0	3	0	0
13	32638668	.	C	T	7	7	14	0	1	15	0	0
13	32641146	.	A	T	2	3	5	0	0	5	0	0
13	32641767	.	T	G	2	2	4	0	1	5	0	0
13	32642185	.	A	G	5	6	11	0	0	11	0	0
13	32642215	.	A	G	5	6	11	0	0	11	0	0
13	32642251	.	G	A	11	6	17	0	1	18	0	0
13	32642293	.	A	G	9	7	16	0	1	17	0	0
13	32642369	.	T	C	6	7	13	0	1	14	0	0
13	32642410	.	G	T	7	6	13	0	2	15	0	0
13	32642528	.	A	T	9	9	18	0	1	19	0	0
13	32642568	.	A	T	5	6	11	0	1	12	0	0
13	32642618	.	T	A	4	3	7	0	1	8	0	0
13	32642684	.	T	C	8	0	8	0	3	11	0	0
13	32642690	.	T	C	6	2	8	0	2	10	0	0
13	32642964	.	C	T	2	2	4	0	0	4	0	0
13	32643143	.	G	A	2	3	5	0	1	6	0	0
13	32643840	.	A	G	3	2	5	0	0	5	0	0
13	32726030	.	T	C	1	2	3	0	0	3	0	0
13	32812265	.	G	T	1	3	4	0	0	4	0	0
13	32812788	.	A	C	1	2	3	0	0	3	0	0
13	32812885	.	A	G	7	0	7	0	2	9	0	0
13	32815668	.	G	A	5	9	14	0	0	14	0	0
13	32815884	.	T	C	16	10	26	0	0	26	0	0
13	32815981	.	A	T	9	14	23	0	2	25	0	0
13	32816055	.	G	C	13	13	26	0	1	27	0	0
13	32816128	.	T	G	17	17	34	0	0	34	0	0
13	32816338	.	C	G	10	17	27	0	0	27	0	0
13	32825503	.	A	G	7	9	16	0	0	16	0	0
13	32826966	.	T	C	8	5	13	0	2	15	0	0
13	32826978	.	A	G	8	4	12	0	2	15	1	0
13	32827434	.	C	T	8	7	15	0	2	17	0	0
13	32830255	.	G	T	4	6	10	0	1	11	0	0
13	32831770	.	C	T	5	6	11	0	0	11	0	0
13	32831965	.	T	C	1	4	5	0	1	6	0	0
13	32831971	.	T	C	2	6	8	0	0	8	0	0
13	32832055	.	A	G	7	4	11	0	0	11	0	0
13	32832058	.	T	A	5	4	9	0	2	11	0	0
13	32833326	.	T	C	7	5	12	0	2	14	0	0
13	32833359	.	A	G	7	5	12	0	0	12	0	0
13	32833364	.	A	C	7	4	11	0	1	12	0	0
13	32834925	.	T	C	5	4	9	0	0	9	0	0
13	32838241	.	C	A	1	4	5	0	0	5	0	0
13	32838468	.	A	G	5	3	8	0	0	8	0	0
13	32844777	.	C	T	0	2	2	0	2	4	0	0
13	32901607	.	G	A	8	2	10	0	0	10	0	0
13	32993962	.	C	T	1	9	10	0	8	18	0	0
13	32994526	.	T	C	8	13	21	0	0	21	0	0
13	32994565	.	T	A	10	6	16	0	0	16	0	0
13	32994697	.	G	T	5	5	10	0	2	12	0	0
13	32994736	.	A	G	9	6	15	0	0	15	0	0
13	32994841	.	A	G	7	5	12	0	0	12	0	0
13	32997196	.	A	T	11	7	18	0	1	19	0	0
13	32997224	.	C	A	8	21	29	0	2	31	0	0
13	32997260	.	T	C	8	18	26	0	1	27	0	0
13	32997424	.	G	T	12	13	25	3	1	29	0	0
13	32997517	.	T	A	7	19	26	1	4	31	0	0
13	33000574	.	C	T	1	19	20	0	20	40	0	0
13	33000586	.	T	C	17	20	37	0	0	37	0	0
13	33005284	.	T	C	11	25	36	0	2	38	0	0
13	33005346	.	G	A	17	34	51	0	2	53	0	0
13	33007766	.	C	T	11	44	55	0	1	56	0	0
13	33020054	.	T	C	3	0	3	0	2	5	0	0
13	33021814	.	G	T	3	5	8	0	0	8	0	0
13	33024599	.	C	A	1	3	4	0	0	4	0	0
13	33024743	.	A	C	3	7	10	0	0	10	0	0
13	33024789	.	G	C	14	14	28	0	0	28	0	0
13	33028797	.	A	G	7	10	17	0	2	19	0	0
13	33029576	.	A	T	9	7	16	0	3	19	0	0
13	33029594	.	G	A	1	8	9	0	10	19	0	0
13	33033330	.	C	T	26	25	51	0	1	52	0	0
13	33033688	.	T	C	19	27	46	2	1	49	0	0
13	33040593	.	A	G	3	2	5	0	0	5	0	0
13	33041038	.	A	T	3	2	5	0	0	5	0	0
13	33041118	.	C	A	2	2	4	0	1	5	0	0
13	33041157	.	T	G	8	4	12	0	0	12	0	0
13	33048096	.	G	A	4	3	7	0	0	7	0	0
13	33059179	.	C	T	10	8	18	0	0	18	0	0
13	33059182	.	C	T	8	10	18	0	0	18	0	0
13	33062367	.	C	T	9	8	17	0	0	17	0	0
13	33065670	.	G	A	14	7	21	0	2	23	0	0
13	33067622	.	T	C	4	2	6	0	0	6	0	0
13	33067624	.	C	T	2	3	5	0	1	6	0	0
13	33070366	.	G	A	3	5	8	0	0	8	0	0
13	33077094	.	C	T	5	2	7	0	0	7	0	0
13	33078885	.	C	A	1	2	3	0	1	4	0	0
13	33079573	.	A	G	2	2	4	0	0	4	0	0
13	33122120	.	G	A	8	8	16	0	3	19	0	0
13	33122141	.	T	C	9	2	11	0	2	13	0	0
13	33122312	.	C	A	12	4	16	0	0	16	0	0
13	33122586	.	G	A	3	3	6	0	0	6	0	0
13	33122594	.	G	A	8	2	10	0	1	11	0	0
13	33122847	.	T	G	14	0	14	0	12	26	0	0
13	33122853	.	C	A	12	11	23	0	5	28	0	0
13	33122941	.	C	T	16	10	26	0	3	29	0	0
13	33122949	.	G	C	20	3	23	0	3	26	0	0
13	33123031	.	T	A	8	16	24	0	0	24	0	0
13	33123154	.	C	A	11	7	18	0	0	18	0	0
13	33174415	.	A	T	5	2	7	0	3	10	0	0
13	33174533	.	G	A	8	7	15	0	0	15	0	0
13	33174681	.	G	A	11	4	15	0	3	18	0	0
13	33174732	.	A	G	5	6	11	0	1	12	0	0
13	33174759	.	G	A	7	4	11	0	1	12	0	0
13	33174964	.	T	C	8	0	8	0	5	13	0	0
13	33175126	.	C	A	4	5	9	0	0	9	0	0
13	33175314	.	A	G	3	7	10	0	1	11	0	0
13	33177637	.	A	G	11	8	19	0	0	19	0	0
13	33187199	.	G	A	1	3	4	0	2	6	0	0
13	33190239	.	G	C	2	1	3	0	3	6	0	0
13	33190245	.	A	G	2	2	4	0	2	6	0	0
13	33194242	.	C	T	3	3	6	0	0	6	0	0
13	33194245	.	A	G	4	3	7	0	0	7	0	0
13	33194458	.	G	A	3	4	7	0	0	7	0	0
13	33195115	.	C	T	1	2	3	0	0	3	0	0
13	33196698	.	A	G	2	2	4	0	0	4	0	0
13	33211397	.	T	A	6	5	11	0	0	11	0	0
13	33214492	.	T	C	5	7	12	0	0	12	0	0
13	33214804	.	G	A	14	15	29	0	1	30	0	0
13	33214985	.	C	T	15	9	24	0	0	24	0	0
13	33224678	.	G	A	2	5	7	0	0	7	0	0
13	33224706	.	T	G	4	5	9	0	0	9	0	0
13	33224716	.	G	A	4	4	8	0	0	8	0	0
13	33224932	.	C	T	0	5	5	0	4	9	0	0
13	33225029	.	G	A	4	2	6	0	1	7	0	0
13	33225049	.	A	G	2	5	7	0	0	7	0	0
13	33227271	.	G	C	5	6	11	0	0	11	0	0
13	33230436	.	C	A	16	11	27	1	2	30	0	0
13	33234522	.	C	T	0	11	11	0	19	30	0	0
13	33236691	.	A	G	14	9	23	0	2	25	0	0
13	33236902	.	C	T	13	8	21	0	3	24	0	0
13	33238954	.	A	G	7	13	20	0	0	20	0	0
13	33238960	.	G	A	6	14	20	0	2	22	0	0
13	33239219	.	G	A	15	6	21	0	1	22	0	0
13	33239237	.	T	C	5	0	5	0	9	14	0	0
13	33248351	.	C	T	10	9	19	0	2	21	0	0
13	33248443	.	T	C	12	7	19	0	1	20	0	0
13	33248677	.	T	A	8	9	17	1	1	19	0	0
13	33261228	.	C	T	14	35	49	0	3	52	0	0
13	33261303	.	A	T	24	31	55	0	0	55	0	0
13	33261326	.	A	T	28	26	54	0	2	56	0	0
13	33261340	.	C	T	26	19	45	0	3	48	0	0
13	33261389	.	T	G	36	13	49	0	4	53	0	0
13	33261577	.	C	G	27	20	47	0	3	50	0	0
13	33261889	.	C	T	27	22	49	0	1	50	0	0
13	33262044	.	C	A	33	24	57	0	2	59	0	0
13	33262721	.	A	T	15	16	31	0	0	31	0	0
13	33262749	.	A	C	16	11	27	0	1	28	0	0
13	33262956	.	C	A	17	17	34	0	1	35	0	0
13	33262997	.	A	G	13	24	37	0	1	38	0	0
13	33263138	.	C	A	3	7	10	0	0	10	0	0
13	33263385	.	G	A	6	5	11	0	2	13	0	0
13	33263503	.	G	T	24	11	35	0	3	38	0	0
13	33263568	.	G	A	14	16	30	0	3	33	0	0
13	33263774	.	G	A	5	6	11	1	1	13	0	0
13	33263860	.	A	T	9	5	14	0	0	14	0	0
13	33263862	.	A	C	16	0	16	0	0	16	0	0
13	33263940	.	T	C	15	12	27	0	2	29	0	0
13	33264315	.	T	C	17	11	28	0	2	30	0	0
13	33264318	.	C	T	15	13	28	0	3	31	0	0
13	33264470	.	A	G	16	9	25	0	2	27	0	0
13	33265061	.	G	T	13	12	25	0	2	27	0	0
13	33265062	.	G	T	16	12	28	0	0	28	0	0
13	33265323	.	A	C	13	18	31	0	1	32	0	0
13	33265364	.	G	T	14	21	35	0	3	38	0	0
13	33268757	.	A	T	2	3	5	0	1	6	0	0
13	33268791	.	T	C	1	2	3	0	0	3	0	0
13	33271293	.	G	A	0	3	3	0	2	5	0	0
13	33271332	.	C	T	2	2	4	0	1	5	0	0
13	33273081	.	C	A	1	4	5	0	0	5	0	0
13	33273106	.	C	T	2	4	6	0	0	6	0	0
13	33276011	.	G	A	6	4	10	0	0	10	0	0
13	33276048	.	T	C	6	4	10	0	0	10	0	0
13	33280769	.	C	A	6	5	11	0	1	12	0	0
13	33281138	.	G	T	0	2	2	0	6	8	0	0
13	33281218	.	G	A	0	4	4	0	4	8	0	0
13	33311074	.	G	A	7	5	12	0	0	12	0	0
13	33313037	.	T	C	2	6	8	0	0	8	0	0
13	33313066	.	C	A	5	2	7	0	1	8	0	0
13	33314840	.	A	T	4	4	8	0	2	10	0	0
13	33315099	.	T	C	7	0	7	0	8	15	0	0
13	33396343	.	C	T	1	4	5	0	14	19	0	0
13	33398445	.	C	A	1	14	15	0	16	31	0	0
13	33398668	.	C	A	3	7	10	0	0	10	0	0
13	33448134	.	A	G	3	2	5	0	0	5	0	0
13	33609129	.	T	C	4	4	8	0	0	8	0	0
13	33612347	.	C	T	9	3	12	0	0	12	0	0
13	33614712	.	C	A	6	6	12	0	1	13	0	0
13	33614751	.	T	C	6	5	11	0	1	12	0	0
13	33616880	.	T	C	9	0	9	0	4	13	0	0
13	33617129	.	T	A	1	4	5	0	0	5	0	0
13	33622472	.	G	A	2	3	5	0	1	6	0	0
13	33622486	.	A	G	1	3	4	0	1	5	0	0
13	33622519	.	T	C	3	3	6	1	0	7	0	0
13	33624713	.	C	G	3	2	5	0	1	6	0	0
13	33631381	.	T	A	1	4	5	0	0	5	0	0
13	33635645	.	A	G	1	3	4	0	0	4	0	0
13	33636073	.	G	T	3	4	7	0	0	7	0	0
13	33645567	.	C	T	8	5	13	0	0	13	0	0
13	33645569	.	C	T	5	7	12	0	0	12	0	0
13	33645649	.	A	T	5	3	8	0	2	10	0	0
13	33645754	.	T	C	6	5	11	0	1	12	0	0
13	33645838	.	A	C	5	4	9	0	0	9	0	0
13	33645839	.	A	T	5	4	9	0	0	9	0	0
13	33645892	.	C	T	4	3	7	0	0	7	0	0
13	33646063	.	C	G	4	4	8	0	1	9	0	0
13	33646123	.	T	A	4	9	13	0	0	13	0	0
13	33646132	.	A	T	4	9	13	0	0	13	0	0
13	33646224	.	C	T	6	3	9	0	0	9	0	0
13	33646615	.	G	A	6	5	11	0	0	11	0	0
13	33654890	.	G	A	2	3	5	0	0	5	0	0
13	33654902	.	T	C	2	2	4	0	0	4	0	0
13	33656297	.	A	C	1	1	2	0	1	3	0	0
13	33658653	.	T	A	2	4	6	0	0	6	0	0
13	33667422	.	G	A	0	2	2	0	1	3	0	0
13	33682216	.	C	T	13	18	31	2	0	33	0	0
13	33682217	.	A	T	13	18	31	2	0	33	0	0
13	33682379	.	C	A	12	11	23	0	0	23	0	0
13	33682474	.	T	G	7	5	12	0	0	12	0	0
13	33682482	.	A	T	6	7	13	0	0	13	0	0
13	33682548	.	A	G	5	2	7	0	0	7	0	0
13	33682682	.	G	A	27	26	53	0	2	55	0	0
13	33683609	.	T	C	36	31	67	0	3	70	0	0
13	33683696	.	A	G	19	33	52	0	5	57	0	0
13	33683701	.	G	C	21	37	58	0	0	58	0	0
13	33813452	.	T	G	11	11	22	0	1	23	0	0
13	33813792	.	C	T	8	6	14	0	1	15	0	0
13	33814644	.	A	C	6	6	12	0	1	13	0	0
13	33814647	.	T	A	6	6	12	0	1	13	0	0
13	33814773	.	C	T	8	9	17	0	0	17	0	0
13	33815863	.	C	A	8	6	14	0	0	14	0	0
13	33815992	.	C	T	5	5	10	0	1	11	0	0
13	33816231	.	T	G	2	2	4	0	0	4	0	0
13	33816518	.	T	C	4	4	8	0	0	8	0	0
13	33968509	.	C	T	6	10	16	0	0	16	0	0
13	34217398	.	C	T	10	10	20	0	0	20	0	0
13	34483567	.	G	A	0	7	7	0	15	22	0	0
13	34488737	.	T	G	13	10	23	0	1	24	0	0
13	34523224	.	G	A	11	13	24	0	0	24	0	0
13	34554179	.	C	T	18	14	32	0	2	34	0	0
13	34746145	.	A	T	2	4	6	0	0	6	0	0
13	34747807	.	G	T	2	1	3	0	0	3	0	0
13	34747819	.	A	T	0	2	2	0	1	3	0	0
13	34748199	.	C	A	5	3	8	0	0	8	0	0
13	34748362	.	C	T	6	3	9	0	0	9	0	0
13	34748516	.	C	T	7	3	10	0	0	10	0	0
13	34748527	.	G	A	4	6	10	0	0	10	0	0
13	34748570	.	C	A	2	10	12	0	1	13	0	0
13	34748642	.	T	A	1	2	3	0	1	4	0	0
13	34748791	.	G	T	3	2	5	0	0	5	0	0
13	34748891	.	A	T	8	3	11	0	1	12	0	0
13	34748892	.	G	A	7	3	10	0	2	12	0	0
13	34748990	.	T	A	4	6	10	0	0	10	0	0
13	34749507	.	A	G	11	4	15	0	0	15	0	0
13	34749536	.	A	T	10	3	13	0	0	13	0	0
13	34749616	.	C	T	8	6	14	0	0	14	0	0
13	34749693	.	C	T	9	6	15	0	0	15	0	0
13	34749743	.	G	T	8	9	17	0	0	17	0	0
13	34749786	.	A	C	11	8	19	0	1	20	0	0
13	34750212	.	A	T	2	2	4	0	0	4	0	0
13	34765346	.	T	G	2	3	5	0	0	5	0	0
13	34765569	.	T	G	3	2	5	0	0	5	0	0
13	34766034	.	C	A	1	3	4	0	3	7	0	0
13	34766238	.	G	A	4	3	7	0	0	7	0	0
13	35042138	.	C	T	13	17	30	0	0	30	0	0
13	35042237	.	G	A	12	14	26	0	2	28	0	0
13	35042279	.	G	A	18	7	25	0	0	25	0	0
13	35042354	.	G	T	7	16	23	0	0	23	0	0
13	35051624	.	C	T	1	6	7	0	2	9	0	0
13	35051786	.	T	C	2	8	10	0	0	10	0	0
13	35051880	.	G	A	3	2	5	0	0	5	0	0
13	35386829	.	G	C	1	3	4	0	0	4	0	0
13	35388509	.	C	T	1	2	3	0	0	3	0	0
13	35389670	.	C	T	4	3	7	0	0	7	0	0
13	35478781	.	T	A	1	3	4	0	0	4	0	0
13	35510945	.	T	C	2	3	5	0	0	5	0	0
13	35511339	.	A	G	3	6	9	0	0	9	0	0
13	35511612	.	C	T	6	6	12	0	0	12	0	0
13	35522132	.	A	G	3	3	6	0	0	6	0	0
13	35722703	.	G	A	1	2	3	0	0	3	0	0
13	35728973	.	G	A	1	2	3	0	4	7	0	0
13	35744431	.	T	A	5	2	7	0	0	7	0	0
13	35744566	.	A	G	2	3	5	0	0	5	0	0
13	35745686	.	T	C	6	3	9	0	0	9	0	0
13	35746343	.	A	G	8	0	8	0	5	13	0	0
13	35746637	.	C	T	4	4	8	0	0	8	0	0
13	35746775	.	T	C	4	6	10	0	0	10	0	0
13	35747177	.	T	G	11	11	22	0	1	23	0	0
13	35747420	.	T	C	15	7	22	0	2	24	0	0
13	35747510	.	G	A	13	12	25	0	0	25	0	0
13	35747564	.	A	G	17	14	31	0	3	34	0	0
13	35748109	.	C	G	24	11	35	0	3	38	0	0
13	35748144	.	A	G	21	14	35	0	3	38	0	0
13	35748238	.	T	A	18	15	33	0	0	33	0	0
13	35748249	.	G	A	18	12	30	0	2	32	0	0
13	35748412	.	A	C	16	21	37	0	1	38	0	0
13	35748541	.	G	A	4	8	12	0	0	12	0	0
13	35748566	.	C	T	4	2	6	0	0	6	0	0
13	35750836	.	G	A	17	9	26	0	0	26	0	0
13	35751162	.	T	A	10	14	24	0	4	28	0	0
13	35753242	.	G	A	6	8	14	0	0	14	0	0
13	35757260	.	G	A	7	6	13	0	3	16	0	0
13	35758093	.	T	C	7	0	7	0	5	12	0	0
13	35758111	.	G	T	7	3	10	0	2	12	0	0
13	35758223	.	G	A	7	7	14	1	1	16	0	0
13	35759904	.	G	A	13	11	24	0	1	25	0	0
13	35787680	.	G	T	5	2	7	0	0	7	0	0
13	35787722	.	G	A	0	2	2	0	3	5	0	0
13	35787735	.	T	C	3	2	5	0	0	5	0	0
13	35788128	.	G	T	10	16	26	0	1	27	0	0
13	35788222	.	G	A	8	11	19	0	0	19	0	0
13	35788302	.	A	C	7	12	19	0	0	19	0	0
13	35788313	.	T	C	6	11	17	0	1	18	0	0
13	35791455	.	A	G	13	10	23	1	0	25	1	0
13	35796882	.	C	T	9	13	22	0	1	23	0	0
13	35796894	.	G	A	10	13	23	0	0	23	0	0
13	35796924	.	C	T	0	10	10	0	12	22	0	0
13	35798960	.	T	C	7	6	13	0	0	13	0	0
13	35798966	.	G	C	7	5	12	0	0	12	0	0
13	35799200	.	G	T	7	4	11	0	2	13	0	0
13	35801258	.	G	A	10	6	16	0	1	17	0	0
13	35803109	.	T	C	11	0	11	0	7	18	0	0
13	35808197	.	G	T	8	9	17	0	1	18	0	0
13	35813549	.	A	G	3	7	10	0	0	10	0	0
13	35813666	.	C	T	0	3	3	0	3	6	0	0
13	35814762	.	A	T	6	2	8	0	0	8	0	0
13	35821652	.	T	A	2	2	4	0	0	4	0	0
13	35824278	.	A	G	1	3	4	0	0	4	0	0
13	35824455	.	G	T	2	2	4	0	0	4	0	0
13	35824599	.	A	G	3	3	6	0	0	6	0	0
13	35871825	.	C	T	4	2	6	0	1	7	0	0
13	35884611	.	T	C	3	2	5	0	1	6	0	0
13	35904775	.	C	G	3	4	7	0	0	7	0	0
13	35905024	.	G	A	5	2	7	0	0	7	0	0
13	35905265	.	A	G	4	2	6	0	0	6	0	0
13	35905334	.	C	T	0	5	5	0	4	9	0	0
13	35907938	.	G	A	1	3	4	0	0	4	0	0
13	35941320	.	G	C	0	3	3	0	1	4	0	0
13	35950720	.	G	A	5	6	11	0	1	12	0	0
13	35950753	.	C	A	6	11	17	0	0	17	0	0
13	35953558	.	G	A	8	6	14	0	0	14	0	0
13	36039807	.	T	C	16	13	29	0	1	30	0	0
13	36039828	.	T	C	21	0	21	0	14	35	0	0
13	36039938	.	G	A	32	23	55	0	3	58	0	0
13	36040278	.	T	C	16	0	16	0	25	41	0	0
13	36040429	.	C	T	14	3	17	0	1	18	0	0
13	36040611	.	C	T	0	13	13	3	6	22	0	0
13	36042020	.	T	A	18	13	31	0	2	33	0	0
13	36042057	.	C	T	17	13	30	0	4	34	0	0
13	36042091	.	G	C	13	13	26	0	0	26	0	0
13	36043781	.	T	A	13	22	35	0	0	35	0	0
13	36043796	.	T	C	16	0	16	0	17	33	0	0
13	36043820	.	T	C	16	0	16	0	15	31	0	0
13	36044370	.	C	T	12	7	19	0	1	20	0	0
13	36045705	.	G	A	14	6	20	0	0	20	0	0
13	36047444	.	G	A	6	2	8	0	1	9	0	0
13	36048658	.	A	C	4	4	8	0	0	8	0	0
13	36048931	.	A	G	6	3	9	0	1	10	0	0
13	36054289	.	A	G	7	5	12	0	2	14	0	0
13	36054432	.	A	C	6	7	13	0	1	14	0	0
13	36057124	.	C	T	8	5	13	1	1	15	0	0
13	36060640	.	G	A	21	16	37	0	1	38	0	0
13	36060679	.	T	G	13	13	26	0	3	29	0	0
13	36062661	.	T	A	6	10	16	0	2	18	0	0
13	36067938	.	A	G	2	7	9	0	0	9	0	0
13	36072451	.	C	T	0	3	3	0	2	5	0	0
13	36074085	.	T	C	5	0	5	0	7	12	0	0
13	36074176	.	G	A	5	3	8	0	0	8	0	0
13	36079184	.	T	C	2	0	2	0	3	5	0	0
13	36084138	.	C	A	0	2	2	0	1	3	0	0
13	36086415	.	G	A	2	2	4	0	0	4	0	0
13	36102706	.	C	T	1	2	3	0	1	4	0	0
13	36103044	.	G	T	2	3	5	0	0	5	0	0
13	36135287	.	T	A	3	4	7	0	0	7	0	0
13	36138360	.	G	A	13	10	23	0	1	24	0	0
13	36151234	.	G	A	1	8	9	0	11	20	0	0
13	36151407	.	G	C	3	2	5	0	1	6	0	0
13	36151636	.	C	T	9	13	22	0	0	22	0	0
13	36151858	.	G	C	18	18	36	0	0	36	0	0
13	36151868	.	A	G	15	14	29	0	3	32	0	0
13	36152030	.	C	A	20	24	44	0	3	47	0	0
13	36152069	.	A	C	23	17	40	0	2	42	0	0
13	36152102	.	T	A	25	17	42	0	1	43	0	0
13	36152108	.	T	C	26	18	44	0	0	44	0	0
13	36152202	.	T	C	25	11	36	0	3	39	0	0
13	36152269	.	T	G	23	19	42	0	2	44	0	0
13	36152758	.	C	T	19	12	31	0	0	31	0	0
13	36168740	.	G	A	2	4	6	0	1	7	0	0
13	36168846	.	T	C	2	1	3	0	1	4	0	0
13	36175915	.	A	G	1	3	4	0	0	4	0	0
13	36530629	.	A	G	30	35	65	0	3	68	0	0
13	36531957	.	A	G	37	29	66	0	2	69	1	0
13	36532607	.	G	T	33	30	63	0	5	68	0	0
13	36532752	.	G	A	38	19	57	8	0	65	0	0
13	36533174	.	C	T	31	21	52	0	4	56	0	0
13	36534273	.	T	C	29	19	48	0	0	48	0	0
13	36537510	.	T	A	4	9	13	0	0	13	0	0
13	36558152	.	C	T	5	3	8	0	0	8	0	0
13	36560808	.	G	A	5	10	15	0	0	15	0	0
13	36568867	.	A	G	14	29	43	0	3	46	0	0
13	36568897	.	G	A	15	21	36	0	4	40	0	0
13	36569330	.	G	A	25	18	43	0	4	47	0	0
13	36579281	.	G	A	10	15	25	0	0	25	0	0
13	36579356	.	G	C	11	9	20	0	2	22	0	0
13	36589020	.	G	A	25	11	36	0	3	39	0	0
13	36589365	.	C	T	15	13	28	0	2	30	0	0
13	36589401	.	A	G	24	11	35	0	1	36	0	0
13	36589556	.	A	G	23	14	37	0	4	41	0	0
13	36592521	.	A	G	29	1	30	0	14	45	1	0
13	36592619	.	G	T	17	16	33	0	2	35	0	0
13	36592732	.	T	C	15	12	27	0	4	31	0	0
13	36592952	.	A	G	21	11	32	0	2	34	0	0
13	36592969	.	T	C	21	14	35	0	3	38	0	0
13	36593052	.	G	A	24	14	38	0	3	41	0	0
13	36593121	.	C	T	14	12	26	0	4	30	0	0
13	36593278	.	T	C	24	22	46	0	2	48	0	0
13	36593478	.	C	A	19	18	37	0	2	39	0	0
13	36605649	.	G	A	1	13	14	0	6	20	0	0
13	36605682	.	T	C	13	7	20	0	0	20	0	0
13	36605851	.	G	A	2	9	11	0	12	23	0	0
13	36606012	.	C	T	2	14	16	0	0	16	0	0
13	36606023	.	T	C	2	10	12	0	1	13	0	0
13	36606073	.	C	A	9	14	23	0	0	23	0	0
13	36606422	.	C	T	19	15	34	0	2	36	0	0
13	36606632	.	A	T	2	3	5	4	1	10	0	0
13	36606657	.	C	T	8	5	13	4	0	17	0	0
13	36606724	.	C	A	12	11	23	0	0	23	0	0
13	36606725	.	A	G	12	11	23	0	0	23	0	0
13	36614574	.	C	T	4	2	6	0	0	6	0	0
13	36625784	.	T	C	5	5	10	0	0	10	0	0
13	36625821	.	G	A	5	5	10	0	2	12	0	0
13	36636464	.	A	G	18	0	18	0	29	47	0	0
13	36636491	.	C	T	18	25	43	0	2	45	0	0
13	36638783	.	C	T	19	18	37	0	1	38	0	0
13	36638906	.	C	A	5	4	9	0	0	9	0	0
13	36639424	.	A	G	14	11	25	0	1	26	0	0
13	36639598	.	C	T	7	10	17	0	0	17	0	0
13	36640032	.	A	G	10	12	22	0	1	23	0	0
13	36640063	.	G	C	9	6	15	0	2	17	0	0
13	36640555	.	T	G	9	11	20	0	6	26	0	0
13	36647442	.	A	G	1	5	6	0	0	6	0	0
13	36655240	.	C	T	2	2	4	0	0	4	0	0
13	36655884	.	T	C	4	3	7	0	0	7	0	0
13	36680611	.	G	A	0	8	8	0	7	15	0	0
13	36683911	.	C	T	6	8	14	0	0	14	0	0
13	36691543	.	T	C	9	14	23	0	0	23	0	0
13	36696032	.	A	G	1	2	3	0	0	3	0	0
13	36705895	.	G	A	2	3	5	0	0	5	0	0
13	36706013	.	T	G	7	9	16	0	1	17	0	0
13	36713450	.	T	C	2	5	7	0	1	8	0	0
13	36717012	.	A	G	4	1	5	0	1	6	0	0
13	36764791	.	C	T	14	6	20	0	2	22	0	0
13	36764838	.	C	G	4	15	19	0	1	20	0	0
13	36771815	.	G	A	10	9	19	0	0	19	0	0
13	36781068	.	G	C	2	14	16	0	16	32	0	0
13	36781407	.	A	G	25	1	26	0	23	49	0	0
13	36783998	.	G	A	6	23	29	0	29	58	0	0
13	36784262	.	G	A	0	12	12	0	15	27	0	0
13	36784347	.	G	A	1	6	7	0	4	11	0	0
13	36784350	.	G	A	5	3	8	0	2	10	0	0
13	36787176	.	C	A	1	2	3	0	0	3	0	0
13	36787184	.	T	C	1	2	3	0	0	3	0	0
13	36792193	.	G	C	3	3	6	0	0	6	0	0
13	36800799	.	C	T	4	3	7	0	0	7	0	0
13	36801649	.	C	T	2	1	3	0	1	4	0	0
13	36868564	.	G	A	17	17	34	0	0	34	0	0
13	36868635	.	T	G	22	17	39	0	3	42	0	0
13	36868938	.	C	A	26	22	48	2	1	51	0	0
13	36869639	.	C	T	6	25	31	1	32	64	0	0
13	36872777	.	A	G	20	17	37	0	4	41	0	0
13	36872814	.	A	C	15	1	16	0	20	36	0	0
13	36879965	.	T	C	11	0	11	0	12	24	1	0
13	36879983	.	G	A	10	10	20	0	1	21	0	0
13	36880028	.	A	C	5	0	5	0	10	15	0	0
13	36887746	.	C	A	2	8	10	0	8	18	0	0
13	36887779	.	G	A	3	8	11	0	1	12	0	0
13	36898229	.	G	A	9	9	18	0	0	18	0	0
13	36910378	.	G	A	11	6	17	0	1	18	0	0
13	36910387	.	C	T	10	4	14	0	0	14	0	0
13	36910591	.	A	G	6	6	12	0	0	12	0	0
13	36910729	.	G	C	7	11	18	0	2	20	0	0
13	36911037	.	T	C	9	1	10	0	10	20	0	0
13	36926967	.	G	A	2	7	9	0	0	9	0	0
13	36932023	.	C	T	6	9	15	0	0	15	0	0
13	36932289	.	G	A	6	5	11	0	1	12	0	0
13	36932356	.	A	G	6	4	10	0	1	11	0	0
13	36932581	.	A	C	2	2	4	0	0	4	0	0
13	36932907	.	G	A	3	4	7	0	0	7	0	0
13	36932912	.	A	G	3	5	8	0	0	8	0	0
13	36932970	.	T	G	9	5	14	0	1	15	0	0
13	36933206	.	C	T	5	4	9	0	1	10	0	0
13	36990431	.	G	A	1	1	2	0	1	3	0	0
13	36994954	.	T	G	4	4	8	0	0	8	0	0
13	36995832	.	G	A	2	2	4	0	0	4	0	0
13	36995873	.	G	T	1	3	4	0	0	4	0	0
13	36995874	.	A	G	0	3	3	0	1	4	0	0
13	36996681	.	C	T	3	5	8	0	0	8	0	0
13	36997170	.	G	T	2	4	6	0	0	6	0	0
13	36997459	.	G	A	0	5	5	0	5	10	0	0
13	37055867	.	A	G	1	3	4	0	0	4	0	0
13	37065596	.	C	A	1	3	4	0	0	4	0	0
13	37071768	.	G	A	1	2	3	0	0	3	0	0
13	37071841	.	A	G	5	4	9	0	0	9	0	0
13	37075501	.	T	A	6	5	11	0	1	12	0	0
13	37075528	.	T	A	3	5	8	0	2	10	0	0
13	37075547	.	T	A	4	4	8	0	1	9	0	0
13	37075970	.	A	G	7	5	12	0	2	14	0	0
13	37075986	.	C	G	6	3	9	0	2	11	0	0
13	37076093	.	A	T	3	12	15	0	3	18	0	0
13	37076152	.	A	G	5	9	14	0	0	14	0	0
13	37076337	.	T	C	21	5	26	0	0	26	0	0
13	37076373	.	T	G	7	13	20	0	0	20	0	0
13	37076382	.	C	T	0	10	10	0	9	19	0	0
13	37076415	.	T	C	8	7	15	0	0	15	0	0
13	37076710	.	C	T	8	5	13	0	0	13	0	0
13	37076934	.	C	T	4	6	10	0	0	10	0	0
13	37076960	.	A	C	2	6	8	0	0	8	0	0
13	37077127	.	T	C	6	4	10	0	0	10	0	0
13	37077629	.	T	C	2	2	4	0	0	4	0	0
13	37077829	.	C	A	2	6	8	0	2	10	0	0
13	37077844	.	G	A	3	5	8	0	0	8	0	0
13	37077903	.	A	G	10	4	14	0	0	14	0	0
13	37077961	.	C	T	0	4	4	0	8	12	0	0
13	37078181	.	C	T	2	3	5	0	10	15	0	0
13	37090658	.	A	G	2	4	6	0	0	6	0	0
13	37090700	.	A	C	1	2	3	0	1	4	0	0
13	37303235	.	A	G	4	5	9	0	0	9	0	0
13	37303316	.	C	T	0	3	3	0	1	4	0	0
13	37421509	.	C	T	0	17	17	0	5	22	0	0
13	37421604	.	A	C	14	13	27	0	2	29	0	0
13	37422417	.	C	T	2	17	19	0	18	37	0	0
13	37425730	.	G	A	3	7	10	0	1	11	0	0
13	37426052	.	A	G	3	2	5	0	0	5	0	0
13	37429222	.	C	T	2	6	8	0	1	9	0	0
13	37429469	.	G	A	2	2	4	0	0	4	0	0
13	37432564	.	A	G	2	3	5	0	0	5	0	0
13	37432570	.	A	G	2	3	5	0	0	5	0	0
13	37469340	.	C	G	1	3	4	0	0	4	0	0
13	37469396	.	T	C	3	4	7	0	0	7	0	0
13	37469488	.	G	C	1	4	5	0	0	5	0	0
13	37470539	.	T	G	1	3	4	0	0	4	0	0
13	37470562	.	T	C	1	2	3	0	0	3	0	0
13	37470777	.	C	A	2	4	6	0	0	6	0	0
13	37472515	.	C	G	1	2	3	0	1	4	0	0
13	37472557	.	T	C	1	3	4	0	0	4	0	0
13	37528544	.	T	C	3	4	7	0	0	7	0	0
13	37528612	.	T	A	5	2	7	0	0	7	0	0
13	37528793	.	T	G	1	5	6	0	1	7	0	0
13	37532764	.	G	T	1	2	3	0	0	3	0	0
13	37545366	.	A	C	1	2	3	0	0	3	0	0
13	37545372	.	T	C	2	2	4	0	0	4	0	0
13	37623591	.	C	T	2	2	4	0	0	4	0	0
13	37623688	.	A	G	1	4	5	0	0	5	0	0
13	37645760	.	A	G	5	3	8	0	0	8	0	0
13	37659570	.	C	T	1	1	2	0	1	3	0	0
13	37668539	.	C	A	1	1	2	0	1	3	0	0
13	37668546	.	A	G	1	2	3	0	0	3	0	0
13	37671948	.	T	C	7	4	11	0	0	11	0	0
13	37671949	.	T	C	7	4	11	0	0	11	0	0
13	37672082	.	T	G	6	10	16	0	1	17	0	0
13	37672087	.	A	C	9	8	17	0	1	18	0	0
13	37672129	.	G	A	1	5	6	0	15	21	0	0
13	37672133	.	G	A	15	5	20	0	1	21	0	0
13	37672716	.	C	T	10	13	23	0	1	24	0	0
13	37672777	.	A	G	16	8	24	0	0	24	0	0
13	37673230	.	A	T	5	6	11	0	0	11	0	0
13	38304688	.	G	A	2	3	5	0	0	5	0	0
13	38304739	.	C	A	4	3	7	0	0	7	0	0
13	38304791	.	C	A	1	6	7	0	0	7	0	0
13	39114793	.	A	G	2	4	6	0	0	6	0	0
13	39657068	.	A	G	2	8	10	0	0	10	0	0
13	39657140	.	C	T	0	3	3	0	7	10	0	0
13	39657285	.	T	C	1	2	3	0	0	3	0	0
13	40352476	.	A	G	10	8	18	0	1	19	0	0
13	40498347	.	T	C	1	2	3	0	0	3	0	0
13	40749004	.	T	C	2	3	5	0	0	5	0	0
13	42400473	.	C	T	4	5	9	0	1	10	0	0
13	42481256	.	A	G	19	14	33	0	2	35	0	0
13	42481575	.	T	C	13	19	32	0	2	34	0	0
13	42485110	.	G	A	5	9	14	0	2	16	0	0
13	42487319	.	T	C	9	9	18	0	1	19	0	0
13	42490775	.	C	T	4	4	8	0	2	10	0	0
13	42500513	.	A	T	4	3	7	0	1	8	0	0
13	42502659	.	T	A	2	3	5	0	0	5	0	0
13	42502713	.	T	C	1	5	6	0	2	8	0	0
13	42507075	.	C	T	2	7	9	0	0	9	0	0
13	42523951	.	A	G	3	2	5	0	0	5	0	0
13	42523969	.	G	C	3	2	5	0	0	5	0	0
13	42606871	.	G	A	2	4	6	0	0	6	0	0
13	42606895	.	G	T	2	4	6	0	0	6	0	0
13	42610840	.	A	G	2	0	2	1	2	5	0	0
13	42611086	.	T	C	4	2	6	0	0	6	0	0
13	42611117	.	G	C	2	2	4	0	0	4	0	0
13	42616301	.	A	C	7	4	11	0	1	12	0	0
13	42616527	.	C	A	2	3	5	0	0	5	0	0
13	42622013	.	C	T	2	6	8	0	0	8	0	0
13	42626622	.	C	T	1	8	9	0	7	16	0	0
13	42628463	.	T	C	2	4	6	0	1	7	0	0
13	42672885	.	T	G	2	3	5	0	1	6	0	0
13	42676262	.	T	A	16	15	31	0	0	31	0	0
13	42676516	.	C	A	19	11	30	0	0	31	1	0
13	42678806	.	C	T	12	20	32	0	2	34	0	0
13	42681514	.	G	A	1	7	8	0	0	8	0	0
13	42681759	.	G	T	13	10	23	0	1	24	0	0
13	42682255	.	T	A	16	6	22	0	2	25	1	0
13	42682282	.	T	C	18	9	27	0	1	28	0	0
13	42691626	.	A	G	14	6	20	0	0	20	0	0
13	42691644	.	G	A	13	5	18	0	0	18	0	0
13	42693028	.	C	T	0	3	3	0	4	7	0	0
13	42693030	.	G	A	3	3	6	0	1	7	0	0
13	42720896	.	G	A	1	3	4	0	0	4	0	0
13	42726545	.	T	C	3	0	3	0	2	5	0	0
13	43223722	.	T	G	22	17	39	0	4	43	0	0
13	43223961	.	G	A	21	15	36	0	0	36	0	0
13	43226429	.	C	T	3	18	21	0	10	31	0	0
13	43229923	.	G	A	11	18	29	0	1	30	0	0
13	43232179	.	A	G	11	8	19	0	0	19	0	0
13	43232266	.	G	A	7	8	15	0	0	15	0	0
13	43237120	.	A	G	8	7	15	0	0	15	0	0
13	43237153	.	G	A	5	6	11	0	1	12	0	0
13	43237189	.	A	C	4	4	8	0	0	8	0	0
13	43238513	.	C	A	13	10	23	0	0	23	0	0
13	43307280	.	T	C	1	5	6	0	1	7	0	0
13	43406891	.	A	G	3	2	5	0	0	5	0	0
13	43508674	.	A	T	19	12	31	0	1	32	0	0
13	43509318	.	G	A	8	18	26	0	0	26	0	0
13	43509609	.	G	A	10	13	23	0	3	26	0	0
13	43512320	.	C	T	1	4	5	0	6	11	0	0
13	43515153	.	G	A	4	4	8	0	0	8	0	0
13	43515168	.	T	A	2	4	6	0	0	6	0	0
13	43637067	.	T	C	2	2	4	0	0	4	0	0
13	43637079	.	A	G	1	1	2	0	2	4	0	0
13	43647035	.	T	C	3	6	9	0	0	9	0	0
13	43650515	.	A	G	2	2	4	0	0	4	0	0
13	43650529	.	C	A	2	2	4	0	0	4	0	0
13	43650583	.	G	A	3	1	4	0	0	4	0	0
13	43650592	.	G	C	4	2	6	0	0	6	0	0
13	43650627	.	A	T	12	6	18	0	0	18	0	0
13	43658881	.	G	A	21	9	30	1	4	35	0	0
13	43659018	.	C	T	13	6	19	0	2	21	0	0
13	43659107	.	G	A	0	15	15	0	13	28	0	0
13	43659357	.	G	T	7	15	22	0	3	25	0	0
13	44808632	.	A	G	9	11	20	0	0	20	0	0
13	44827661	.	C	T	3	3	6	0	1	7	0	0
13	44827684	.	C	G	4	4	8	0	0	8	0	0
13	44888282	.	C	T	13	8	21	0	0	21	0	0
13	44888309	.	A	C	9	4	13	0	4	17	0	0
13	44888950	.	A	G	2	4	6	0	0	6	0	0
13	45015443	.	T	C	16	28	44	0	2	47	1	0
13	45015503	.	T	C	18	29	47	0	2	49	0	0
13	45015655	.	T	G	21	31	52	0	3	55	0	0
13	45015776	.	T	C	26	40	66	0	5	71	0	0
13	45016119	.	G	A	27	34	61	0	1	62	0	0
13	45018600	.	A	G	34	30	64	0	5	69	0	0
13	45018732	.	G	A	29	40	69	0	7	76	0	0
13	45018738	.	T	C	21	4	25	0	48	73	0	0
13	45019001	.	A	C	31	0	31	0	39	70	0	0
13	45036033	.	A	C	8	0	8	0	3	11	0	0
13	45039294	.	G	A	5	3	8	0	0	8	0	0
13	45039330	.	T	A	3	5	8	0	0	8	0	0
13	45431684	.	C	T	2	5	7	0	0	7	0	0
13	45442952	.	C	T	4	1	5	0	1	6	0	0
13	45468567	.	A	T	14	40	54	3	3	61	1	0
13	45468827	.	G	C	26	3	29	0	47	76	0	0
13	45470601	.	A	G	30	32	62	2	2	66	0	0
13	45470764	.	T	C	41	18	59	0	2	61	0	0
13	45470831	.	G	T	28	19	47	0	2	49	0	0
13	45470865	.	G	A	26	15	41	0	3	44	0	0
13	45470867	.	C	A	28	12	40	0	3	43	0	0
13	45470982	.	C	T	15	16	31	0	0	31	0	0
13	45470983	.	A	G	15	16	31	0	0	31	0	0
13	45471048	.	A	G	16	18	34	0	1	35	0	0
13	45471052	.	A	G	16	21	37	0	0	37	0	0
13	45471201	.	T	C	28	0	28	0	23	51	0	0
13	45471243	.	G	A	24	25	49	0	2	51	0	0
13	45471367	.	A	T	26	18	44	0	4	48	0	0
13	45471615	.	A	G	30	24	54	0	4	58	0	0
13	45471624	.	T	C	25	25	50	0	6	56	0	0
13	45471888	.	C	T	2	16	18	0	18	36	0	0
13	45472124	.	T	G	7	8	15	0	0	15	0	0
13	45472793	.	T	C	37	2	39	0	30	69	0	0
13	45473011	.	G	A	41	31	72	0	1	73	0	0
13	45475204	.	T	C	34	9	43	0	2	45	0	0
13	45475208	.	A	C	35	10	45	0	0	45	0	0
13	45476400	.	C	T	13	7	20	0	0	20	0	0
13	45476731	.	A	T	17	17	34	0	1	35	0	0
13	45481475	.	G	A	21	20	41	0	1	42	0	0
13	45481618	.	A	G	15	11	26	0	0	26	0	0
13	45481703	.	G	T	15	10	25	0	0	25	0	0
13	45481736	.	A	G	11	11	22	0	0	22	0	0
13	45481740	.	A	G	10	10	20	0	3	23	0	0
13	45481792	.	A	G	1	8	9	0	1	10	0	0
13	45488209	.	A	G	8	9	17	0	2	19	0	0
13	45494573	.	C	T	18	17	35	0	1	36	0	0
13	45494757	.	G	A	12	27	39	0	1	40	0	0
13	45494769	.	C	A	13	24	37	0	0	37	0	0
13	45495189	.	G	T	1	16	17	0	28	45	0	0
13	45524500	.	T	C	8	4	12	0	1	13	0	0
13	45557259	.	G	A	1	4	5	0	13	18	0	0
13	45565646	.	G	A	0	9	9	0	11	20	0	0
13	45570300	.	A	C	10	6	16	0	1	17	0	0
13	45786228	.	T	C	5	0	5	0	4	9	0	0
13	45786231	.	T	C	2	3	5	0	3	8	0	0
13	45991772	.	T	C	19	26	45	0	0	45	0	0
13	45991801	.	C	T	19	23	42	0	2	44	0	0
13	45999530	.	G	A	2	13	15	0	20	35	0	0
13	45999723	.	C	T	19	20	39	0	6	45	0	0
13	46000060	.	G	A	2	7	9	1	5	15	0	0
13	46179682	.	C	T	32	22	54	0	6	60	0	0
13	46179689	.	G	A	34	25	59	0	1	60	0	0
13	46179722	.	A	T	28	22	50	0	2	52	0	0
13	46179806	.	T	A	27	33	60	0	0	60	0	0
13	46179814	.	A	G	29	34	63	0	1	64	0	0
13	46298616	.	C	T	8	5	13	0	0	13	0	0
13	46298763	.	C	T	10	10	20	0	2	22	0	0
13	46298775	.	T	G	10	9	19	0	2	21	0	0
13	46298843	.	G	C	4	4	8	0	1	9	0	0
13	46298973	.	T	C	5	5	10	0	1	11	0	0
13	46298988	.	T	C	10	2	12	0	0	12	0	0
13	46299016	.	C	G	13	4	17	0	0	17	0	0
13	46299025	.	C	T	10	4	14	0	3	17	0	0
13	46299310	.	T	A	1	2	3	4	0	7	0	0
13	46299503	.	C	T	6	7	13	0	1	14	0	0
13	46299669	.	T	A	8	6	14	0	0	14	0	0
13	46299909	.	C	T	1	4	5	0	9	14	0	0
13	46299968	.	C	G	0	3	3	0	5	10	2	0
13	46299989	.	A	T	4	3	7	0	1	8	0	0
13	46300247	.	A	T	7	8	15	0	0	15	0	0
13	46321988	.	C	T	0	2	2	0	4	6	0	0
13	46520899	.	T	G	7	4	11	0	0	11	0	0
13	46520985	.	G	A	5	4	9	1	1	11	0	0
13	46521542	.	C	T	1	7	8	0	5	13	0	0
13	46521633	.	G	A	11	8	19	0	2	21	0	0
13	46521664	.	C	A	11	10	21	0	2	23	0	0
13	46552414	.	G	T	8	6	14	0	3	17	0	0
13	46552429	.	G	A	10	7	17	0	2	19	0	0
13	46832231	.	T	C	21	6	27	0	0	27	0	0
13	46833924	.	T	C	3	2	5	0	0	5	0	0
13	46834005	.	T	C	4	2	6	0	0	6	0	0
13	46988414	.	C	T	13	17	30	0	0	30	0	0
13	46988445	.	C	T	14	18	32	0	0	32	0	0
13	46988457	.	C	A	3	19	22	0	17	39	0	0
13	46990974	.	C	A	0	15	15	0	11	26	0	0
13	47834276	.	C	A	1	2	3	0	0	3	0	0
13	47835598	.	A	C	3	3	6	0	0	6	0	0
13	47839071	.	C	T	3	8	11	0	1	12	0	0
13	47839119	.	A	T	4	2	6	0	1	7	0	0
13	48067195	.	G	T	5	4	9	0	0	9	0	0
13	48067223	.	C	T	0	4	4	0	3	7	0	0
13	48086469	.	A	C	5	3	8	0	2	10	0	0
13	48100564	.	C	T	5	3	8	0	1	9	0	0
13	48104890	.	A	G	5	6	11	0	1	12	0	0
13	48105447	.	C	T	8	3	11	0	0	11	0	0
13	48105520	.	C	T	2	4	6	0	0	6	0	0
13	48105627	.	T	C	4	3	7	0	1	8	0	0
13	48105669	.	C	T	0	3	3	0	3	6	0	0
13	48105953	.	T	A	3	5	8	0	1	9	0	0
13	48106903	.	T	G	2	2	4	0	1	5	0	0
13	48106943	.	A	G	3	2	5	0	2	7	0	0
13	48107120	.	T	A	2	2	4	0	0	4	0	0
13	48107404	.	A	G	1	3	4	0	0	4	0	0
13	48107413	.	T	C	1	2	3	0	0	3	0	0
13	48107706	.	G	A	1	2	3	0	0	3	0	0
13	48107927	.	A	T	1	1	2	0	0	2	0	0
13	48107947	.	C	G	2	3	5	0	0	5	0	0
13	48111539	.	C	A	0	3	3	0	1	4	0	0
13	48748722	.	A	G	2	2	4	0	1	5	0	0
13	48758525	.	T	C	1	2	3	0	0	3	0	0
13	48766270	.	C	T	1	3	4	0	1	5	0	0
13	49153904	.	T	C	2	9	11	0	0	11	0	0
13	49443868	.	T	C	21	0	21	0	22	43	0	0
13	49444210	.	C	G	13	22	35	0	0	35	0	0
13	49444446	.	C	A	10	17	27	0	1	28	0	0
13	49544560	.	T	A	1	4	5	1	0	6	0	0
13	49544833	.	C	T	20	12	32	0	1	33	0	0
13	49544873	.	T	A	21	19	40	0	0	40	0	0
13	49545039	.	A	G	22	27	49	0	1	50	0	0
13	49575322	.	A	G	19	28	47	0	2	49	0	0
13	49585301	.	T	C	20	20	40	0	1	41	0	0
13	49585341	.	T	A	18	13	31	0	0	31	0	0
13	49585344	.	A	T	17	12	29	0	1	30	0	0
13	49597306	.	T	C	4	0	4	0	2	6	0	0
13	50070274	.	C	T	0	4	4	0	2	6	0	0
13	50080872	.	C	T	2	3	5	0	0	5	0	0
13	50093930	.	C	A	0	2	2	0	1	3	0	0
13	50168735	.	C	T	3	4	7	0	0	7	0	0
13	50168744	.	T	A	3	4	7	0	0	7	0	0
13	50168991	.	T	A	9	3	12	0	2	14	0	0
13	50169004	.	C	T	14	4	18	0	1	19	0	0
13	50169193	.	G	T	2	6	8	0	0	8	0	0
13	50169618	.	A	G	9	9	18	0	0	18	0	0
13	50170016	.	C	T	6	2	8	0	0	8	0	0
13	50170055	.	C	T	2	4	6	0	0	6	0	0
13	50170092	.	G	A	4	3	7	0	0	7	0	0
13	50236399	.	T	C	1	0	1	0	4	5	0	0
13	50236437	.	C	T	2	4	6	0	0	6	0	0
13	50243381	.	C	A	10	11	21	1	0	22	0	0
13	50243387	.	A	C	11	11	22	1	0	23	0	0
13	50349099	.	G	A	5	1	6	0	2	8	0	0
13	50349475	.	A	C	8	12	20	0	0	20	0	0
13	50349532	.	G	A	14	8	22	0	1	23	0	0
13	50349586	.	C	T	12	17	29	0	2	31	0	0
13	50352535	.	G	A	13	9	22	0	1	23	0	0
13	50352538	.	T	C	8	10	18	0	2	20	0	0
13	50352780	.	G	C	9	9	18	0	0	18	0	0
13	50353171	.	A	G	5	7	12	0	0	12	0	0
13	50353192	.	A	G	4	5	9	0	2	11	0	0
13	50359690	.	G	A	3	3	6	0	1	7	0	0
13	50371951	.	A	G	9	8	17	1	0	18	0	0
13	50387503	.	G	A	5	5	10	0	0	10	0	0
13	50397388	.	G	A	3	2	5	0	0	5	0	0
13	50410268	.	C	T	0	3	3	0	1	4	0	0
13	50670846	.	A	T	4	3	7	0	0	7	0	0
13	50670911	.	G	C	2	6	8	1	0	9	0	0
13	50712066	.	G	T	4	6	10	0	0	10	0	0
13	50715527	.	G	A	1	3	4	0	0	4	0	0
13	51147038	.	G	A	6	2	8	0	1	9	0	0
13	51147152	.	G	A	7	3	10	0	0	10	0	0
13	51147164	.	A	G	5	2	7	0	1	8	0	0
13	51162561	.	A	G	4	3	7	0	0	7	0	0
13	51162579	.	T	G	2	3	5	0	1	6	0	0
13	51503093	.	T	A	1	1	2	0	1	3	0	0
13	51503524	.	G	A	1	3	4	0	1	5	0	0
13	51580096	.	G	T	0	6	6	0	2	8	0	0
13	51580105	.	T	C	2	7	9	0	0	9	0	0
13	51582507	.	T	G	4	5	9	0	0	9	0	0
13	51583019	.	C	A	7	9	16	0	0	16	0	0
13	51583043	.	T	C	9	9	18	0	2	20	0	0
13	51583130	.	A	G	15	0	15	0	12	27	0	0
13	51719767	.	A	C	2	3	5	0	1	6	0	0
13	51719850	.	G	A	1	2	3	0	6	9	0	0
13	51719871	.	T	C	3	3	6	0	0	6	0	0
13	51720126	.	C	A	5	4	9	0	0	9	0	0
13	51720142	.	A	G	2	4	6	0	1	7	0	0
13	51720240	.	T	C	6	6	12	0	0	12	0	0
13	51720291	.	A	G	8	1	9	0	4	13	0	0
13	51720993	.	G	C	0	7	7	0	7	14	0	0
13	51721143	.	T	C	10	10	20	0	0	20	0	0
13	51728165	.	G	C	14	15	29	0	1	30	0	0
13	51728227	.	G	A	9	11	20	0	2	22	0	0
13	51728520	.	G	A	10	12	22	0	1	24	1	0
13	51728782	.	C	G	8	8	16	0	5	21	0	0
13	51728937	.	A	G	5	16	21	0	5	26	0	0
13	51729970	.	A	G	2	3	5	1	1	7	0	0
13	51893754	.	A	T	7	9	16	0	1	17	0	0
13	51893891	.	G	A	6	8	14	0	0	14	0	0
13	51893981	.	C	T	4	32	36	6	30	72	0	0
13	51894142	.	T	C	9	8	17	1	2	20	0	0
13	51894204	.	C	T	17	18	35	0	5	40	0	0
13	51894264	.	C	T	4	18	22	1	14	37	0	0
13	51899727	.	G	A	10	14	24	0	3	27	0	0
13	51903034	.	A	G	5	11	16	11	0	27	0	0
13	51956414	.	T	C	0	5	5	0	0	5	0	0
13	51956418	.	G	A	1	5	6	0	0	6	0	0
13	51961978	.	C	T	5	10	15	0	0	15	0	0
13	51962211	.	C	T	5	11	16	0	0	16	0	0
13	51962752	.	G	A	1	7	8	0	8	16	0	0
13	51967259	.	G	A	1	6	7	0	0	7	0	0
13	51969123	.	C	T	0	2	2	0	2	4	0	0
13	51969126	.	A	G	2	2	4	0	0	4	0	0
13	51972910	.	C	T	2	2	4	0	1	5	0	0
13	51982730	.	A	G	14	2	16	0	18	34	0	0
13	51982742	.	A	G	12	2	14	0	22	36	0	0
13	51982853	.	C	A	13	16	29	0	0	29	0	0
13	51984964	.	C	T	16	12	28	0	1	29	0	0
13	52013166	.	A	C	1	2	3	0	0	3	0	0
13	52013739	.	T	C	4	2	6	0	1	7	0	0
13	52013766	.	C	T	4	2	6	0	1	7	0	0
13	52014032	.	G	C	2	5	7	1	0	8	0	0
13	52108428	.	G	A	1	2	3	0	0	3	0	0
13	52108464	.	C	G	0	2	2	0	1	3	0	0
13	52108574	.	A	G	1	4	5	0	0	5	0	0
13	52108912	.	G	C	2	2	4	0	0	4	0	0
13	52108989	.	C	T	0	2	2	0	2	4	0	0
14	548928	.	C	T	2	2	4	0	0	4	0	0
14	565193	.	T	G	1	3	4	0	0	4	0	0
14	565260	.	A	T	3	1	4	0	1	5	0	0
14	684179	.	G	A	17	16	33	0	0	33	0	0
14	699481	.	G	T	1	4	5	0	0	5	0	0
14	699496	.	A	C	1	4	5	0	0	5	0	0
14	715123	.	G	C	5	4	9	0	0	9	0	0
14	715126	.	T	C	4	4	8	0	0	8	0	0
14	715201	.	C	T	1	4	5	0	0	5	0	0
14	715207	.	A	G	1	0	1	0	4	5	0	0
14	717927	.	G	A	3	5	8	0	0	8	0	0
14	718194	.	A	C	2	4	6	0	0	6	0	0
14	719447	.	A	G	2	10	12	0	0	12	0	0
14	719926	.	A	G	5	8	13	0	0	13	0	0
14	723539	.	T	C	9	2	11	0	0	11	0	0
14	723542	.	T	C	9	3	12	0	0	12	0	0
14	729870	.	G	T	1	4	5	0	3	8	0	0
14	757469	.	G	T	2	2	4	0	0	4	0	0
14	757567	.	T	C	0	0	0	0	4	4	0	0
14	757606	.	C	A	3	2	5	0	0	5	0	0
14	757716	.	T	G	4	2	6	0	0	7	1	0
14	757817	.	A	T	3	2	5	0	0	5	0	0
14	791696	.	T	A	6	3	9	0	0	9	0	0
14	791707	.	T	A	5	3	8	0	0	8	0	0
14	791989	.	G	T	6	2	8	0	0	8	0	0
14	792499	.	C	G	3	0	3	0	7	10	0	0
14	792536	.	A	C	2	5	7	0	0	7	0	0
14	792686	.	G	A	1	4	5	0	0	5	0	0
14	863767	.	A	G	6	6	12	0	2	14	0	0
14	863807	.	A	T	10	12	22	0	2	24	0	0
14	863868	.	G	T	18	13	31	0	0	31	0	0
14	863949	.	T	C	14	8	22	0	0	22	0	0
14	868838	.	G	A	13	11	24	0	2	26	0	0
14	868855	.	A	G	8	11	19	0	3	22	0	0
14	919604	.	C	G	1	3	4	0	0	4	0	0
14	937241	.	T	C	1	3	4	0	0	4	0	0
14	937849	.	A	C	1	4	5	0	0	5	0	0
14	937937	.	C	T	0	3	3	0	5	8	0	0
14	937941	.	C	T	2	2	4	0	5	9	0	0
14	938290	.	C	A	1	2	3	0	0	3	0	0
14	938292	.	A	G	1	1	2	0	1	3	0	0
14	938508	.	T	C	1	2	3	2	0	5	0	0
14	938531	.	A	C	1	2	3	2	0	5	0	0
14	938744	.	A	G	1	2	3	0	0	3	0	0
14	941408	.	C	G	1	4	5	0	0	5	0	0
14	942378	.	G	A	3	2	5	0	1	6	0	0
14	994353	.	G	T	1	2	3	0	1	4	0	0
14	994413	.	C	T	3	1	4	0	2	6	0	0
14	994437	.	T	C	4	2	6	0	0	6	0	0
14	997203	.	A	G	1	2	3	0	0	3	0	0
14	997273	.	T	A	2	2	4	0	0	4	0	0
14	997484	.	A	G	3	0	3	0	3	6	0	0
14	997603	.	T	C	1	4	5	0	1	6	0	0
14	997651	.	A	C	3	4	7	0	0	7	0	0
14	997705	.	C	A	6	7	13	0	0	13	0	0
14	997853	.	C	T	1	3	4	0	0	4	0	0
14	1119225	.	C	T	3	2	5	0	1	6	0	0
14	1119423	.	A	G	5	2	7	0	5	12	0	0
14	1119432	.	T	C	5	4	9	0	2	11	0	0
14	1119993	.	T	C	8	6	14	0	1	15	0	0
14	1120017	.	T	C	12	5	17	0	1	18	0	0
14	1120072	.	C	A	8	14	22	0	0	22	0	0
14	1120154	.	T	C	10	7	17	0	0	17	0	0
14	1120178	.	C	T	9	5	14	0	0	14	0	0
14	1120196	.	T	G	4	0	4	0	6	10	0	0
14	1120236	.	C	T	6	8	14	0	0	14	0	0
14	1120452	.	G	T	1	5	6	0	5	11	0	0
14	1121029	.	A	G	4	7	11	0	1	12	0	0
14	1121068	.	C	T	6	2	8	0	0	8	0	0
14	1121303	.	G	C	1	6	7	0	0	7	0	0
14	1121413	.	C	T	1	2	3	0	0	3	0	0
14	1127693	.	G	A	5	3	8	0	0	8	0	0
14	1138611	.	C	A	2	3	5	0	0	5	0	0
14	1138626	.	G	A	0	1	1	0	5	6	0	0
14	1139509	.	C	T	4	3	7	0	0	7	0	0
14	1150594	.	A	G	9	7	16	0	1	17	0	0
14	1152544	.	C	A	11	11	22	0	4	26	0	0
14	1153665	.	T	C	8	13	21	0	1	22	0	0
14	1153830	.	T	A	10	7	17	0	0	17	0	0
14	1159869	.	A	G	10	0	10	0	15	25	0	0
14	1160333	.	C	T	16	12	28	0	2	30	0	0
14	1160427	.	T	G	14	18	32	0	0	32	0	0
14	1171023	.	T	C	5	7	12	0	0	12	0	0
14	1171052	.	T	A	6	9	15	0	0	15	0	0
14	1171081	.	T	A	5	4	9	0	1	10	0	0
14	1178316	.	T	G	3	2	5	0	0	5	0	0
14	1192448	.	G	A	5	17	22	0	1	23	0	0
14	1192681	.	C	T	8	6	14	0	1	15	0	0
14	1194090	.	C	T	1	10	11	0	5	16	0	0
14	1194133	.	G	A	6	10	16	0	0	16	0	0
14	1194154	.	C	T	0	6	6	0	9	15	0	0
14	1196658	.	T	G	2	6	8	0	0	8	0	0
14	1200460	.	T	G	2	3	5	0	1	6	0	0
14	1200545	.	G	T	4	10	14	0	0	14	0	0
14	1200842	.	A	C	1	3	4	0	0	4	0	0
14	1203713	.	A	G	16	23	39	0	4	43	0	0
14	1203770	.	G	T	21	18	39	0	4	43	0	0
14	1204197	.	A	T	21	19	40	0	2	43	1	0
14	1204299	.	G	A	18	13	31	0	0	31	0	0
14	1225227	.	C	T	0	5	5	0	8	13	0	0
14	1888624	.	T	C	10	3	13	2	47	62	0	0
14	2161358	.	A	G	1	5	6	0	1	7	0	0
14	2360116	.	T	A	1	3	4	0	0	4	0	0
14	2384096	.	T	G	8	3	11	0	1	12	0	0
14	4047853	.	T	G	4	10	14	0	0	14	0	0
14	4193501	.	T	C	3	3	6	0	1	7	0	0
14	5588315	.	A	T	2	3	5	0	2	7	0	0
14	5998939	.	T	A	0	2	2	0	0	2	0	0
14	5998940	.	A	G	1	2	3	0	0	3	0	0
14	6000376	.	A	G	1	3	4	0	0	4	0	0
14	6003556	.	A	G	1	0	1	1	4	6	0	0
14	6333022	.	T	C	5	8	13	0	1	14	0	0
14	6334412	.	C	T	1	3	4	0	0	4	0	0
14	6607673	.	A	C	2	1	3	0	7	10	0	0
14	6612978	.	A	T	5	2	7	0	0	7	0	0
14	6624558	.	A	G	10	1	11	0	10	21	0	0
14	6625521	.	G	C	24	39	63	1	4	68	0	0
14	6625575	.	C	G	43	1	44	1	8	54	1	0
14	6625794	.	A	G	6	16	22	0	2	24	0	0
14	6625805	.	A	G	12	7	19	0	1	20	0	0
14	7170558	.	T	C	3	6	9	0	1	10	0	0
14	7170559	.	T	C	3	7	10	0	0	10	0	0
14	7915612	.	T	C	5	2	7	0	1	8	0	0
14	8266799	.	G	T	1	2	3	1	1	5	0	0
14	8269327	.	A	G	2	1	3	0	0	3	0	0
14	8571866	.	A	G	5	2	7	0	2	9	0	0
14	8770436	.	A	C	8	2	10	0	2	12	0	0
14	8770589	.	C	T	5	7	12	0	0	12	0	0
14	8771516	.	C	T	1	2	3	0	0	3	0	0
14	8806587	.	A	C	3	1	4	0	7	11	0	0
14	8806590	.	A	G	3	7	10	0	0	10	0	0
14	8806680	.	T	C	10	9	19	0	0	19	0	0
14	8806722	.	A	G	10	9	19	0	3	22	0	0
14	8806730	.	G	T	14	10	24	0	0	24	0	0
14	8809693	.	A	G	7	13	20	0	8	28	0	0
14	8816113	.	T	C	8	11	19	0	0	19	0	0
14	8816135	.	A	T	12	11	23	0	2	25	0	0
14	8816194	.	C	T	16	12	28	0	0	28	0	0
14	8816261	.	G	A	14	6	20	0	1	21	0	0
14	8816283	.	T	G	14	10	24	0	0	24	0	0
14	8816339	.	A	G	8	10	18	0	0	18	0	0
14	8816457	.	A	G	4	9	13	0	0	13	0	0
14	8816482	.	A	T	3	10	13	0	1	14	0	0
14	8816695	.	C	G	4	4	8	0	0	8	0	0
14	8816755	.	A	C	9	0	9	0	6	15	0	0
14	8816782	.	G	A	13	7	20	0	1	21	0	0
14	8816848	.	A	G	15	4	19	1	0	20	0	0
14	8816877	.	C	A	1	5	6	1	10	17	0	0
14	8819082	.	T	C	4	0	4	0	6	10	0	0
14	8821677	.	G	A	4	7	11	0	1	12	0	0
14	8830236	.	G	T	2	4	6	0	0	6	0	0
14	8832736	.	A	C	1	5	6	0	0	6	0	0
14	8836160	.	G	A	1	2	3	0	0	3	0	0
14	8836298	.	T	C	2	2	4	0	1	5	0	0
14	8841352	.	A	T	1	3	4	0	0	4	0	0
14	8947464	.	A	T	2	4	6	0	1	7	0	0
14	8947497	.	C	A	3	4	7	0	0	7	0	0
14	8982390	.	C	T	8	21	29	0	0	29	0	0
14	8991718	.	A	T	13	19	32	0	2	34	0	0
14	8991823	.	T	C	14	12	26	0	1	27	0	0
14	9001411	.	G	A	13	17	30	0	0	30	0	0
14	9001426	.	C	T	16	16	32	0	1	33	0	0
14	9001752	.	C	G	8	2	10	0	16	26	0	0
14	9001875	.	T	C	13	19	32	0	1	33	0	0
14	9033783	.	G	A	6	4	10	0	1	11	0	0
14	9034114	.	A	G	4	9	13	0	0	13	0	0
14	9034128	.	T	G	3	9	12	0	0	12	0	0
14	9034161	.	C	T	4	8	12	0	0	12	0	0
14	9034307	.	G	A	5	4	9	0	0	9	0	0
14	9034430	.	T	C	11	8	19	0	1	20	0	0
14	9034544	.	T	C	3	0	3	0	7	10	0	0
14	9034701	.	C	T	0	3	3	1	10	14	0	0
14	9034742	.	C	T	4	6	10	0	3	13	0	0
14	9034743	.	T	C	4	0	4	0	9	13	0	0
14	9034932	.	A	G	7	11	18	0	0	18	0	0
14	9035051	.	C	G	5	5	10	0	1	11	0	0
14	9035100	.	C	T	11	6	17	0	2	19	0	0
14	9035110	.	C	T	1	15	16	0	5	21	0	0
14	9035175	.	G	A	9	5	14	0	2	16	0	0
14	9035249	.	G	T	5	4	9	0	0	9	0	0
14	9035337	.	A	C	1	4	5	0	0	5	0	0
14	9035541	.	C	T	1	3	4	0	1	5	0	0
14	9035740	.	A	G	5	5	10	0	0	10	0	0
14	9035786	.	C	G	1	4	5	0	0	5	0	0
14	9035866	.	A	G	6	6	12	0	1	13	0	0
14	9035873	.	T	C	5	4	9	0	2	11	0	0
14	9036219	.	A	T	2	3	5	0	0	5	0	0
14	9036480	.	C	T	5	2	7	0	1	8	0	0
14	9036530	.	C	T	1	4	5	0	0	5	0	0
14	9036624	.	C	T	4	5	9	0	0	9	0	0
14	9040928	.	C	A	6	6	12	0	0	12	0	0
14	9050440	.	G	C	4	0	4	0	2	6	0	0
14	9055913	.	C	T	1	3	4	0	1	5	0	0
14	9055915	.	G	A	0	3	3	0	1	4	0	0
14	9142412	.	A	T	11	6	17	0	2	19	0	0
14	9142602	.	A	T	26	18	44	0	5	49	0	0
14	9142795	.	T	C	20	19	39	0	0	39	0	0
14	9142893	.	T	C	20	1	21	0	18	39	0	0
14	9142911	.	T	C	22	0	22	0	20	42	0	0
14	9142952	.	C	T	4	18	22	0	17	39	0	0
14	9143081	.	G	C	26	2	28	0	24	52	0	0
14	9143150	.	A	C	25	0	25	3	15	43	0	0
14	9143179	.	C	T	3	10	13	4	32	49	0	0
14	9143427	.	A	T	27	20	47	0	1	48	0	0
14	9143446	.	T	C	20	0	20	0	17	37	0	0
14	9143878	.	T	C	16	11	27	1	4	32	0	0
14	9144099	.	T	C	18	20	38	0	1	39	0	0
14	9144191	.	A	G	17	18	35	0	1	36	0	0
14	9144248	.	A	G	10	11	21	0	1	22	0	0
14	9144361	.	A	G	8	6	14	0	0	14	0	0
14	9144658	.	A	G	7	8	15	0	1	16	0	0
14	9145050	.	G	A	16	11	27	0	2	29	0	0
14	9157880	.	T	A	7	11	18	2	1	21	0	0
14	9158367	.	A	G	11	12	23	1	0	24	0	0
14	9159845	.	A	G	8	8	16	0	1	17	0	0
14	9159860	.	G	C	11	1	12	0	7	19	0	0
14	9163286	.	G	A	8	12	20	0	0	20	0	0
14	9173909	.	C	T	10	8	18	0	3	21	0	0
14	9177619	.	G	A	7	9	16	0	0	16	0	0
14	9344247	.	G	A	6	3	9	0	0	9	0	0
14	9344250	.	C	T	6	4	10	0	1	11	0	0
14	9344366	.	T	G	6	4	10	0	0	10	0	0
14	9405178	.	A	G	2	3	5	0	0	5	0	0
14	9405570	.	T	A	12	13	25	0	0	25	0	0
14	9405571	.	G	C	12	12	24	0	1	25	0	0
14	9405728	.	G	C	9	0	9	0	16	25	0	0
14	9405760	.	T	C	5	17	22	0	0	22	0	0
14	9405927	.	C	T	4	11	15	0	1	16	0	0
14	9405940	.	A	C	3	9	12	0	0	12	0	0
14	9406070	.	A	G	1	5	6	0	0	6	0	0
14	9406320	.	T	C	9	0	9	0	11	20	0	0
14	9406453	.	A	T	8	14	22	0	2	24	0	0
14	9406485	.	A	G	6	13	19	0	1	20	0	0
14	9406509	.	T	C	4	11	15	0	1	16	0	0
14	9406607	.	T	C	4	6	10	0	0	10	0	0
14	9406773	.	T	A	8	4	12	0	1	13	0	0
14	9406791	.	A	G	5	5	10	0	3	13	0	0
14	9407074	.	A	T	1	2	3	0	0	3	0	0
14	9407707	.	C	T	3	4	7	0	0	7	0	0
14	9407763	.	A	G	2	2	4	0	1	5	0	0
14	9407791	.	G	A	1	2	3	0	0	3	0	0
14	9408260	.	C	G	4	7	11	0	0	11	0	0
14	9408320	.	T	G	5	5	10	0	0	10	0	0
14	9420810	.	G	A	2	2	4	0	0	4	0	0
14	9420871	.	C	A	4	2	6	0	0	6	0	0
14	9475490	.	G	C	6	4	10	0	0	10	0	0
14	9475796	.	T	A	1	3	4	0	0	4	0	0
14	9481647	.	C	A	4	4	8	0	0	8	0	0
14	9481924	.	C	T	2	3	5	0	0	5	0	0
14	9481926	.	G	T	2	3	5	0	0	5	0	0
14	9482062	.	A	G	2	3	5	0	0	5	0	0
14	9485121	.	A	T	5	8	13	0	0	13	0	0
14	9485366	.	T	A	3	5	8	0	1	9	0	0
14	9494939	.	A	G	3	2	5	0	6	11	0	0
14	9495107	.	G	A	0	6	6	0	7	13	0	0
14	9498163	.	C	T	9	5	14	0	2	16	0	0
14	9498308	.	G	A	5	6	11	0	1	12	0	0
14	9498570	.	C	T	14	5	19	0	0	19	0	0
14	9498728	.	A	T	4	10	14	0	1	15	0	0
14	9498841	.	C	G	11	11	22	0	0	22	0	0
14	9498879	.	T	A	12	11	23	0	2	25	0	0
14	9499048	.	G	T	9	13	22	0	0	22	0	0
14	9508126	.	T	C	1	3	4	0	0	4	0	0
14	9508272	.	G	C	1	2	3	0	1	4	0	0
14	9516521	.	C	T	2	3	5	0	0	5	0	0
14	9516565	.	C	T	4	4	8	0	0	8	0	0
14	9584685	.	T	C	3	2	5	0	0	5	0	0
14	9584717	.	A	G	2	1	3	0	1	4	0	0
14	9587735	.	C	T	1	2	3	0	1	4	0	0
14	9588210	.	G	A	0	3	3	0	2	5	0	0
14	9588221	.	G	C	1	4	5	0	0	5	0	0
14	9588591	.	A	C	1	3	4	1	0	5	0	0
14	9589101	.	G	T	2	2	4	0	0	4	0	0
14	9592534	.	A	G	1	2	3	0	0	3	0	0
14	9592785	.	A	G	1	2	3	0	0	3	0	0
14	9593505	.	A	G	29	10	39	0	3	42	0	0
14	9593610	.	T	A	27	10	37	0	0	37	0	0
14	9593622	.	A	T	29	9	38	0	0	38	0	0
14	9593974	.	C	T	22	14	36	0	0	36	0	0
14	9594466	.	G	A	7	6	13	0	0	13	0	0
14	9594577	.	C	T	14	7	21	0	2	23	0	0
14	9594578	.	A	G	12	8	20	0	2	22	0	0
14	9594623	.	C	T	12	12	24	0	0	24	0	0
14	9594677	.	G	C	8	14	22	0	0	22	0	0
14	9595086	.	A	C	13	5	18	0	0	18	0	0
14	9595119	.	G	A	4	8	12	0	1	13	0	0
14	9595221	.	T	C	6	11	17	0	0	17	0	0
14	9595231	.	T	C	8	0	8	0	8	16	0	0
14	9595330	.	T	C	8	9	17	0	2	19	0	0
14	9595401	.	A	G	8	6	14	0	0	14	0	0
14	9595427	.	C	T	1	9	10	0	0	10	0	0
14	9595593	.	T	G	3	7	10	0	0	10	0	0
14	9595890	.	C	T	7	10	17	0	1	18	0	0
14	9595992	.	C	A	8	11	19	0	1	20	0	0
14	9596338	.	C	T	10	9	19	0	0	19	0	0
14	9717978	.	C	A	0	7	7	0	8	15	0	0
14	9739987	.	G	T	3	4	7	0	1	8	0	0
14	9821794	.	C	T	0	3	3	0	5	8	0	0
14	10338507	.	G	C	9	5	14	0	0	14	0	0
14	10338942	.	A	G	2	4	6	0	1	7	0	0
14	10339032	.	G	A	3	2	5	0	1	6	0	0
14	10339081	.	T	G	7	5	12	0	1	13	0	0
14	10339883	.	A	C	12	12	24	0	1	25	0	0
14	10339943	.	A	G	14	8	22	0	0	22	0	0
14	10340068	.	G	A	15	11	26	0	0	26	0	0
14	10340096	.	G	A	13	9	22	0	1	23	0	0
14	10340189	.	T	A	16	6	22	0	2	24	0	0
14	10340193	.	C	G	17	7	24	0	1	25	0	0
14	10340250	.	A	T	15	6	21	0	1	22	0	0
14	10340288	.	C	A	11	10	21	0	1	22	0	0
14	10340358	.	G	A	7	9	16	0	0	16	0	0
14	10340606	.	A	G	13	7	20	0	3	23	0	0
14	10340642	.	T	A	18	5	23	0	0	23	0	0
14	10340840	.	C	A	15	13	28	0	1	29	0	0
14	10341108	.	A	G	11	4	15	0	1	16	0	0
14	10341237	.	A	T	3	4	7	0	0	7	0	0
14	10341586	.	C	T	1	7	8	0	9	17	0	0
14	10341627	.	A	T	9	9	18	0	0	18	0	0
14	10341966	.	A	C	10	4	14	1	2	17	0	0
14	10342066	.	A	G	7	2	9	0	2	11	0	0
14	10342076	.	T	C	7	3	10	0	0	10	0	0
14	10342379	.	A	C	5	0	5	0	7	12	0	0
14	10342403	.	T	G	4	4	8	0	2	10	0	0
14	10342418	.	A	T	6	2	8	0	0	8	0	0
14	10342570	.	G	A	7	4	11	0	0	11	0	0
14	10342591	.	C	A	0	5	5	0	8	13	0	0
14	10342926	.	G	A	4	4	8	0	2	10	0	0
14	10342929	.	T	A	4	4	8	0	0	8	0	0
14	10342971	.	G	T	5	3	8	0	0	8	0	0
14	10343112	.	C	T	2	2	4	0	0	4	0	0
14	10343752	.	T	C	4	0	4	0	3	7	0	0
14	10344032	.	A	C	5	4	9	0	0	9	0	0
14	10344075	.	C	A	3	4	7	0	0	7	0	0
14	10344218	.	G	A	3	3	6	0	1	7	0	0
14	10344451	.	C	T	2	3	5	0	0	5	0	0
14	10356522	.	A	G	3	3	6	0	0	6	0	0
14	10374674	.	T	G	3	2	5	0	1	6	0	0
14	10374709	.	T	A	2	4	6	0	0	6	0	0
14	10374716	.	G	T	2	4	6	0	0	6	0	0
14	10374792	.	A	C	2	3	5	0	0	5	0	0
14	10379652	.	G	A	5	5	10	0	1	11	0	0
14	10384529	.	C	T	1	3	4	1	0	5	0	0
14	10384607	.	T	A	1	2	3	0	0	3	0	0
14	11048599	.	A	G	2	2	4	0	1	5	0	0
14	11053934	.	G	C	4	6	10	0	2	12	0	0
14	11069560	.	C	T	9	11	20	0	0	20	0	0
14	11069593	.	C	T	10	5	15	0	2	17	0	0
14	11069774	.	G	A	4	7	11	0	1	12	0	0
14	11070008	.	C	T	2	2	4	0	0	4	0	0
14	11070018	.	T	A	4	1	5	0	0	5	0	0
14	11261691	.	C	T	2	2	4	0	0	4	0	0
14	11261718	.	T	C	2	2	4	0	0	4	0	0
14	11263096	.	C	A	2	2	4	0	0	4	0	0
14	11263479	.	T	A	1	3	4	0	1	5	0	0
14	11263899	.	A	G	2	0	2	0	3	5	0	0
14	11264058	.	C	T	3	4	7	0	1	8	0	0
14	11264726	.	A	T	8	5	13	0	1	14	0	0
14	11265310	.	A	G	6	5	11	0	0	11	0	0
14	11265312	.	T	C	5	5	10	0	1	11	0	0
14	11265567	.	C	T	4	5	9	0	0	9	0	0
14	11266644	.	A	T	3	18	21	0	0	21	0	0
14	11267900	.	A	T	15	14	29	0	2	31	0	0
14	11268145	.	G	A	5	6	11	0	2	13	0	0
14	11268224	.	A	T	1	2	3	0	0	3	0	0
14	11300154	.	G	A	2	2	4	0	0	4	0	0
14	11300179	.	T	G	2	2	4	0	0	4	0	0
14	11300238	.	G	A	3	2	5	0	0	5	0	0
14	11300298	.	C	T	1	3	4	0	0	4	0	0
14	11301027	.	G	A	5	16	21	0	0	21	0	0
14	11301069	.	A	G	16	0	16	0	9	25	0	0
14	11302190	.	C	A	15	6	21	0	1	22	0	0
14	11302392	.	G	A	3	3	6	0	0	6	0	0
14	11302492	.	G	A	3	3	6	0	0	6	0	0
14	11302518	.	A	G	2	2	4	0	1	5	0	0
14	11302565	.	T	A	2	6	8	0	0	8	0	0
14	11302744	.	G	A	3	5	8	0	0	8	0	0
14	11302868	.	C	T	1	2	3	0	0	3	0	0
14	11302881	.	T	C	1	3	4	0	0	4	0	0
14	11303025	.	A	G	4	0	4	0	3	7	0	0
14	11303157	.	A	C	6	4	10	0	1	11	0	0
14	11303819	.	T	G	6	3	9	0	0	9	0	0
14	11303973	.	C	T	2	2	4	0	0	4	0	0
14	11964013	.	C	T	5	2	7	0	0	7	0	0
14	12021308	.	C	G	8	7	15	0	0	15	0	0
14	12021366	.	T	C	10	3	13	0	0	13	0	0
14	12021550	.	T	C	2	5	7	0	0	7	0	0
14	12021926	.	A	T	8	12	20	0	1	21	0	0
14	12022056	.	C	T	7	5	12	0	1	13	0	0
14	12036538	.	C	G	3	6	9	0	2	11	0	0
14	12036731	.	A	G	5	4	9	0	0	9	0	0
14	12036768	.	A	C	5	0	5	0	4	9	0	0
14	12050868	.	A	C	2	0	2	0	3	5	0	0
14	12069754	.	C	T	20	17	37	1	3	41	0	0
14	12071446	.	A	G	6	12	18	0	0	18	0	0
14	12077109	.	C	T	6	8	14	0	0	14	0	0
14	12085165	.	T	C	12	10	22	0	0	22	0	0
14	12085267	.	G	A	6	8	14	0	2	16	0	0
14	12099566	.	G	T	4	7	11	0	1	12	0	0
14	12099605	.	T	G	3	5	8	0	0	8	0	0
14	12110747	.	A	C	1	2	3	0	0	3	0	0
14	12111100	.	A	T	4	2	6	0	0	6	0	0
14	12111109	.	G	A	3	1	4	0	1	5	0	0
14	12157456	.	C	T	4	6	10	0	0	10	0	0
14	12159384	.	C	G	6	12	18	0	0	18	0	0
14	12162692	.	C	T	12	13	25	0	2	27	0	0
14	12162731	.	A	C	14	14	28	0	0	28	0	0
14	12164364	.	C	A	27	23	50	0	2	52	0	0
14	12166656	.	A	G	23	19	42	0	3	45	0	0
14	12166956	.	C	T	22	13	35	0	2	37	0	0
14	12166974	.	A	G	24	16	40	0	2	42	0	0
14	12167321	.	T	A	19	28	47	0	1	48	0	0
14	12167615	.	G	A	1	12	13	0	19	32	0	0
14	12167670	.	C	T	11	7	18	0	0	18	0	0
14	12167679	.	A	T	8	6	14	0	0	14	0	0
14	12175124	.	A	G	1	2	3	0	0	3	0	0
14	12175310	.	C	T	1	2	3	0	0	3	0	0
14	12175914	.	A	G	2	3	5	0	0	5	0	0
14	12175964	.	T	A	2	4	6	0	0	6	0	0
14	12175982	.	T	G	1	0	1	0	5	6	0	0
14	12176008	.	G	A	1	3	4	0	0	4	0	0
14	12179114	.	T	C	2	3	5	0	2	7	0	0
14	12179124	.	T	A	4	2	6	0	1	7	0	0
14	12189856	.	C	T	5	7	12	0	0	12	0	0
14	12191579	.	T	A	6	2	8	0	1	9	0	0
14	12191615	.	A	G	9	1	10	0	9	19	0	0
14	12195119	.	T	A	6	7	13	0	0	13	0	0
14	12205329	.	T	C	12	5	17	0	0	17	0	0
14	12205521	.	C	T	15	5	20	0	0	23	3	0
14	12205566	.	T	C	15	8	23	0	0	23	0	0
14	12370570	.	A	G	3	3	6	0	0	6	0	0
14	12436937	.	T	C	4	2	6	0	0	6	0	0
14	12452477	.	C	T	3	4	7	0	0	7	0	0
14	12452516	.	G	A	0	6	6	0	3	9	0	0
14	12465519	.	C	A	9	14	23	0	0	23	0	0
14	12472233	.	C	T	16	12	28	0	0	28	0	0
14	12473312	.	A	C	2	2	4	0	0	4	0	0
14	12473599	.	T	A	4	3	7	0	1	8	0	0
14	12473932	.	T	C	2	4	6	0	0	6	0	0
14	12474159	.	T	C	5	2	7	0	0	7	0	0
14	12481591	.	C	T	3	4	7	0	1	8	0	0
14	12481600	.	T	C	4	4	8	0	0	8	0	0
14	12486294	.	C	T	5	7	12	0	5	17	0	0
14	12535403	.	T	G	23	19	42	0	2	44	0	0
14	12535622	.	G	T	37	10	47	0	1	48	0	0
14	12535775	.	G	T	15	9	24	0	1	25	0	0
14	12535901	.	A	G	7	4	11	0	1	12	0	0
14	12536004	.	T	A	3	9	12	0	1	13	0	0
14	12536229	.	G	A	19	14	33	0	1	34	0	0
14	12536420	.	T	G	24	21	45	0	6	51	0	0
14	12605791	.	T	C	5	3	8	0	0	8	0	0
14	12605900	.	T	C	4	2	6	1	0	7	0	0
14	12636012	.	A	T	1	2	3	0	0	3	0	0
14	13524092	.	A	G	4	7	11	0	0	11	0	0
14	13525082	.	A	G	6	7	13	0	1	14	0	0
14	14094032	.	C	T	2	4	6	0	1	7	0	0
14	14225233	.	C	G	3	4	7	0	0	7	0	0
14	14315233	.	C	T	2	4	6	0	0	6	0	0
14	14502450	.	C	T	2	4	6	0	0	6	0	0
14	14502708	.	T	C	3	6	9	0	0	9	0	0
14	14502846	.	C	T	5	7	12	0	1	13	0	0
14	14502885	.	C	T	4	6	10	0	1	11	0	0
14	14532450	.	T	C	16	14	30	0	2	32	0	0
14	14532696	.	T	G	14	15	29	0	3	32	0	0
14	14532831	.	A	G	11	8	19	0	0	19	0	0
14	14534219	.	G	A	17	13	30	0	2	32	0	0
14	14566166	.	C	T	3	2	5	0	0	5	0	0
14	14582432	.	A	G	1	2	3	0	0	3	0	0
14	14593175	.	T	C	3	2	5	0	0	5	0	0
14	14593624	.	A	G	6	4	10	0	1	11	0	0
14	14593784	.	A	G	2	3	5	0	0	5	0	0
14	14593785	.	A	G	4	2	6	0	0	6	0	0
14	14593889	.	G	A	4	9	13	0	0	13	0	0
14	14595535	.	A	G	4	8	12	0	0	12	0	0
14	14595576	.	T	G	4	5	9	0	1	10	0	0
14	14595695	.	A	C	4	2	6	0	1	7	0	0
14	14595734	.	C	G	6	6	12	0	0	12	0	0
14	14662597	.	A	T	21	15	36	0	2	38	0	0
14	14662606	.	A	G	21	14	35	0	1	36	0	0
14	14662663	.	C	T	21	7	28	0	3	31	0	0
14	14662684	.	C	T	19	7	26	0	2	28	0	0
14	14664974	.	T	C	12	12	24	0	0	24	0	0
14	14664998	.	G	A	9	13	22	0	0	22	0	0
14	14665175	.	T	C	11	15	26	0	2	28	0	0
14	14665229	.	A	G	11	14	25	0	4	29	0	0
14	14665270	.	T	G	4	8	12	0	1	13	0	0
14	14665432	.	A	G	1	3	4	0	0	4	0	0
14	14665502	.	C	G	8	6	14	0	1	15	0	0
14	14666173	.	A	T	9	10	19	0	0	19	0	0
14	14666394	.	G	A	13	20	33	0	0	33	0	0
14	14690710	.	G	T	15	9	24	6	3	33	0	0
14	14690831	.	C	A	14	8	22	37	0	59	0	0
14	14690837	.	G	A	11	8	19	41	0	60	0	0
14	14694930	.	A	G	24	15	39	0	2	41	0	0
14	14695136	.	A	G	18	18	36	1	0	37	0	0
14	14695181	.	A	G	12	15	27	1	2	30	0	0
14	14695864	.	T	C	15	0	15	0	18	33	0	0
14	14722530	.	A	T	9	13	22	0	1	23	0	0
14	14722556	.	T	C	9	11	20	0	3	23	0	0
14	14722929	.	G	A	8	13	21	0	0	21	0	0
14	14723381	.	A	T	6	10	16	0	0	17	1	0
14	14723410	.	G	T	5	6	11	0	0	11	0	0
14	14723486	.	T	A	2	5	7	0	0	7	0	0
14	14724026	.	C	T	5	2	7	0	0	7	0	0
14	14724951	.	G	A	31	23	54	0	5	59	0	0
14	14724953	.	A	G	38	17	55	0	6	61	0	0
14	14724987	.	G	A	27	28	55	0	5	60	0	0
14	14725132	.	A	T	28	15	43	1	8	52	0	0
14	14725314	.	G	A	26	34	60	0	3	63	0	0
14	14728192	.	G	T	20	9	29	28	1	58	0	0
14	14729069	.	G	A	25	29	54	3	5	62	0	0
14	14739116	.	T	C	6	5	11	0	0	11	0	0
14	14836656	.	T	C	8	3	11	0	0	11	0	0
14	14837729	.	A	C	4	2	6	0	0	6	0	0
14	14844346	.	A	C	1	3	4	0	0	4	0	0
14	14844658	.	T	G	4	4	8	0	0	8	0	0
14	14845532	.	G	A	0	2	2	0	4	6	0	0
14	14854201	.	G	C	1	2	3	0	0	3	0	0
14	14855017	.	T	C	6	3	9	0	0	9	0	0
14	14855139	.	T	A	2	6	8	0	0	8	0	0
14	14855205	.	C	G	5	2	7	0	0	7	0	0
14	14855456	.	C	T	5	3	8	0	1	9	0	0
14	14856959	.	G	A	2	2	4	0	0	4	0	0
14	14856962	.	T	C	3	2	5	0	0	5	0	0
14	14864897	.	A	G	2	1	3	0	1	4	0	0
14	15070912	.	A	G	3	6	9	0	0	9	0	0
14	15071502	.	C	T	5	4	9	0	2	11	0	0
14	15086220	.	G	A	8	8	16	0	1	17	0	0
14	15087088	.	C	T	3	2	5	0	0	5	0	0
14	15099780	.	T	C	4	3	7	0	0	7	0	0
14	15155901	.	A	G	4	0	4	0	4	8	0	0
14	15155955	.	T	G	1	3	4	0	1	5	0	0
14	15662731	.	G	A	4	4	8	0	1	9	0	0
14	15662795	.	G	C	5	5	10	0	0	10	0	0
14	15662836	.	A	T	7	5	12	0	0	12	0	0
14	15663014	.	C	T	7	9	16	1	1	18	0	0
14	15663053	.	T	A	6	6	12	1	2	15	0	0
14	15663175	.	T	C	3	4	7	0	0	7	0	0
14	15663198	.	T	C	4	2	6	0	1	7	0	0
14	15663806	.	C	G	5	3	8	0	1	9	0	0
14	15663883	.	G	A	4	2	6	0	0	6	0	0
14	15663910	.	G	A	3	3	6	0	0	6	0	0
14	15663925	.	C	T	0	2	2	0	3	5	0	0
14	15664251	.	T	A	12	3	15	0	1	16	0	0
14	15664263	.	T	C	8	3	11	0	3	14	0	0
14	15664532	.	T	A	1	2	3	0	5	8	0	0
14	15664843	.	A	G	1	3	4	0	0	4	0	0
14	15677790	.	C	T	0	1	1	0	2	3	0	0
14	15677882	.	C	T	2	3	5	0	0	5	0	0
14	15677907	.	A	G	1	3	4	0	0	4	0	0
14	15678362	.	G	A	5	2	7	0	0	7	0	0
14	15760375	.	A	C	3	2	5	0	0	5	0	0
14	15808004	.	C	A	3	4	7	0	0	7	0	0
14	15812577	.	A	G	4	6	10	0	1	11	0	0
14	15812685	.	C	T	2	3	5	0	0	5	0	0
14	15812732	.	A	C	1	2	3	0	1	4	0	0
14	15813702	.	G	T	9	3	12	0	1	13	0	0
14	15813985	.	G	A	0	2	2	0	3	5	0	0
14	15814770	.	C	T	12	7	19	0	0	19	0	0
14	15972435	.	C	A	7	3	10	0	1	11	0	0
14	15972491	.	T	A	3	12	15	0	0	15	0	0
14	15972597	.	G	A	6	4	10	1	0	11	0	0
14	15972666	.	G	A	4	5	9	0	1	10	0	0
14	15973920	.	G	A	3	6	9	0	0	9	0	0
14	15973981	.	C	A	5	5	10	0	0	10	0	0
14	15974188	.	T	A	2	3	5	0	2	7	0	0
14	15974232	.	G	A	2	3	5	0	0	5	0	0
14	15980828	.	T	A	2	3	5	0	0	5	0	0
14	16042530	.	C	A	2	7	9	0	0	9	0	0
14	16069264	.	A	C	2	4	6	0	1	7	0	0
14	16072889	.	G	C	1	6	7	0	0	7	0	0
14	16084339	.	C	T	2	3	5	0	0	5	0	0
14	16090261	.	C	T	6	6	12	0	0	12	0	0
14	16090764	.	T	C	8	8	16	0	1	17	0	0
14	16090939	.	A	C	7	7	14	0	1	15	0	0
14	16091586	.	T	A	10	17	27	0	3	30	0	0
14	16091709	.	T	G	7	5	12	0	1	13	0	0
14	16091765	.	T	C	8	5	13	0	0	13	0	0
14	16093983	.	G	A	9	6	15	0	0	15	0	0
14	16115353	.	A	G	8	7	15	0	2	17	0	0
14	16122866	.	T	C	19	19	38	0	0	38	0	0
14	16122913	.	G	A	2	14	16	0	19	35	0	0
14	16127308	.	C	T	10	2	12	0	1	13	0	0
14	16127346	.	G	T	11	4	15	0	0	15	0	0
14	16127362	.	C	A	1	4	5	0	13	18	0	0
14	16130167	.	C	G	18	18	36	0	2	38	0	0
14	16145112	.	T	A	6	2	8	0	0	8	0	0
14	16208059	.	T	G	3	7	10	0	1	11	0	0
14	16383196	.	G	A	4	2	6	0	0	6	0	0
14	16383869	.	T	C	1	3	4	0	0	4	0	0
14	16434363	.	C	A	20	4	24	0	1	25	0	0
14	16435150	.	G	A	24	14	38	0	1	39	0	0
14	16484633	.	G	T	3	4	7	0	3	10	0	0
14	16484713	.	A	G	5	8	13	0	0	13	0	0
14	16484763	.	C	T	0	9	9	0	5	14	0	0
14	16485222	.	C	T	0	7	7	0	6	13	0	0
14	16606649	.	C	A	2	4	6	0	4	10	0	0
14	16754192	.	A	C	1	2	3	0	0	3	0	0
14	16769067	.	A	G	12	10	22	0	3	25	0	0
14	16769109	.	T	C	11	13	24	0	1	25	0	0
14	16769189	.	C	T	13	11	24	0	0	24	0	0
14	16769246	.	C	T	10	13	23	0	3	26	0	0
14	16769550	.	A	G	12	0	12	0	16	28	0	0
14	16770338	.	T	A	12	6	18	0	2	20	0	0
14	16770646	.	C	A	16	14	30	0	0	30	0	0
14	16770847	.	C	T	8	24	32	0	1	33	0	0
14	16770959	.	T	A	10	14	24	0	1	25	0	0
14	16771194	.	A	T	4	5	9	0	0	9	0	0
14	16771265	.	A	T	8	11	19	0	1	20	0	0
14	16771339	.	T	C	5	6	11	0	0	11	0	0
14	16771340	.	A	G	3	0	3	0	8	11	0	0
14	16777708	.	T	C	3	2	5	0	0	5	0	0
14	16947242	.	G	A	2	2	4	0	0	4	0	0
14	16968227	.	T	C	3	2	5	0	0	5	0	0
14	16968260	.	C	T	2	2	4	0	0	4	0	0
14	16968302	.	T	C	3	2	5	0	0	5	0	0
14	17003333	.	G	A	1	2	3	0	1	4	0	0
14	17003628	.	G	A	1	5	6	0	0	6	0	0
14	17016521	.	G	A	9	5	14	0	2	16	0	0
14	17016650	.	C	T	6	9	15	0	2	17	0	0
14	17025109	.	A	T	7	3	10	0	0	10	0	0
14	17025353	.	G	C	4	4	8	0	0	8	0	0
14	17025388	.	A	T	3	4	7	0	0	7	0	0
14	17025472	.	T	A	7	5	12	0	0	12	0	0
14	17025539	.	A	G	6	4	10	0	1	11	0	0
14	17025574	.	A	G	9	4	13	0	0	13	0	0
14	17025586	.	C	T	7	7	14	0	0	14	0	0
14	17025807	.	T	C	4	8	12	0	1	13	0	0
14	17025960	.	A	T	6	8	14	0	1	15	0	0
14	17026080	.	A	T	3	0	3	2	2	7	0	0
14	17026103	.	G	A	5	4	9	1	1	11	0	0
14	17026534	.	G	A	8	8	16	0	1	17	0	0
14	17026550	.	C	T	8	9	17	0	4	21	0	0
14	17026724	.	T	C	11	14	25	0	3	28	0	0
14	17026840	.	T	C	8	9	17	0	1	18	0	0
14	17065493	.	C	T	4	3	7	0	0	7	0	0
14	17066253	.	T	C	3	3	6	1	0	7	0	0
14	17197240	.	A	C	2	4	6	0	0	6	0	0
14	17198928	.	A	G	4	6	10	0	1	11	0	0
14	17198953	.	G	A	5	4	9	0	0	9	0	0
14	17198988	.	T	G	4	4	8	0	0	8	0	0
14	17199349	.	C	T	7	13	20	0	0	20	0	0
14	17199990	.	A	G	17	30	47	0	0	47	0	0
14	17200159	.	C	T	14	13	27	0	1	28	0	0
14	17200174	.	G	T	3	13	16	0	17	33	0	0
14	17200407	.	C	A	14	9	23	0	0	23	0	0
14	17200482	.	T	C	7	15	22	0	1	23	0	0
14	17200653	.	A	C	9	18	27	0	1	28	0	0
14	17230387	.	C	T	0	2	2	0	4	6	0	0
14	17230601	.	A	G	6	9	15	0	0	15	0	0
14	17233541	.	C	T	15	14	29	0	0	29	0	0
14	17240569	.	G	T	9	6	15	0	1	16	0	0
14	17240587	.	A	G	9	8	17	0	0	17	0	0
14	17266013	.	A	T	12	6	18	0	2	20	0	0
14	17275609	.	T	A	10	7	17	0	1	18	0	0
14	17275708	.	C	G	9	9	18	0	0	18	0	0
14	17278972	.	C	T	5	8	13	0	0	13	0	0
14	17279305	.	T	C	2	6	8	0	1	9	0	0
14	17281713	.	G	A	8	8	16	0	0	16	0	0
14	17281727	.	C	G	6	8	14	0	1	15	0	0
14	17282058	.	G	A	6	6	12	0	0	12	0	0
14	17282061	.	C	T	6	4	10	0	1	11	0	0
14	17282095	.	C	G	6	4	10	0	0	10	0	0
14	17282100	.	C	T	1	4	5	0	4	9	0	0
14	17282160	.	C	T	6	7	13	0	0	13	0	0
14	17348773	.	C	T	1	2	3	0	0	3	0	0
14	17348794	.	A	G	1	2	3	0	0	3	0	0
14	17348922	.	A	G	2	0	2	0	3	5	0	0
14	17349069	.	G	C	4	3	7	0	0	7	0	0
14	17349104	.	G	T	2	5	7	0	1	8	0	0
14	17349464	.	T	C	8	10	18	0	1	19	0	0
14	17349472	.	C	T	7	7	14	0	3	17	0	0
14	17349639	.	T	C	8	6	14	0	1	15	0	0
14	17349656	.	T	C	8	6	14	0	1	15	0	0
14	17443682	.	A	T	1	2	3	0	0	3	0	0
14	17443774	.	C	G	2	4	6	0	0	6	0	0
14	17568072	.	T	A	6	6	12	0	0	12	0	0
14	17568099	.	A	G	7	8	15	0	0	15	0	0
14	17572743	.	T	C	4	6	10	0	1	11	0	0
14	17575834	.	C	G	11	8	19	0	0	19	0	0
14	17575868	.	G	A	11	7	18	0	4	22	0	0
14	17575872	.	C	T	11	10	21	0	1	22	0	0
14	17580662	.	G	A	12	9	21	0	3	24	0	0
14	17580917	.	G	A	30	18	48	0	8	56	0	0
14	17580922	.	C	A	36	19	55	0	1	56	0	0
14	17581036	.	C	A	27	18	45	0	1	46	0	0
14	17586527	.	A	G	15	19	34	0	2	36	0	0
14	17586693	.	G	A	15	15	30	0	1	31	0	0
14	17588131	.	G	T	12	16	28	0	2	30	0	0
14	17593654	.	T	A	4	7	11	0	0	11	0	0
14	17593685	.	G	C	7	14	21	0	0	21	0	0
14	17593767	.	A	T	13	17	30	0	1	31	0	0
14	17593783	.	T	A	16	19	35	0	0	35	0	0
14	17593803	.	A	T	20	17	37	0	2	39	0	0
14	17593823	.	A	T	18	11	29	0	3	32	0	0
14	17593992	.	T	A	7	12	19	0	2	21	0	0
14	17594137	.	G	A	7	3	10	0	1	11	0	0
14	17594556	.	C	T	11	6	17	0	0	17	0	0
14	17595063	.	G	A	3	3	6	0	1	7	0	0
14	17595121	.	G	A	4	4	8	0	2	10	0	0
14	17595264	.	T	A	6	6	12	0	0	12	0	0
14	18667559	.	T	C	23	20	43	0	1	44	0	0
14	18667852	.	T	C	13	20	33	0	4	37	0	0
14	18668731	.	A	G	6	7	13	0	0	13	0	0
14	18669481	.	C	A	19	12	31	0	1	32	0	0
14	18670446	.	C	T	7	9	16	0	1	17	0	0
14	18670582	.	T	A	8	8	16	0	1	17	0	0
14	18671011	.	A	T	1	6	7	0	0	7	0	0
14	18672491	.	C	T	5	5	10	0	2	12	0	0
14	19259292	.	A	G	6	6	12	0	0	12	0	0
14	19260261	.	A	G	6	9	15	0	7	22	0	0
14	19261044	.	C	T	23	18	41	0	3	44	0	0
14	19553160	.	A	G	3	2	5	0	0	5	0	0
14	20159151	.	T	C	2	4	6	0	0	6	0	0
14	20188941	.	G	A	2	10	12	0	16	28	0	0
14	20189180	.	T	C	15	6	21	0	4	25	0	0
14	20189188	.	G	A	15	11	26	0	2	28	0	0
14	20189339	.	T	A	5	6	11	0	0	11	0	0
14	20190023	.	A	C	10	12	22	0	0	22	0	0
14	20190297	.	C	G	22	20	42	0	2	44	0	0
14	20190494	.	G	T	3	19	22	0	16	38	0	0
14	20190532	.	G	A	23	14	37	0	4	41	0	0
14	20703272	.	A	G	1	2	3	0	0	3	0	0
14	20706109	.	A	C	1	3	4	0	1	5	0	0
14	20730907	.	T	A	2	2	4	0	0	4	0	0
14	20730958	.	A	T	1	3	4	0	1	5	0	0
14	20731633	.	A	T	1	3	4	0	0	4	0	0
14	20731656	.	T	A	2	3	5	0	1	6	0	0
14	20731675	.	A	T	3	3	6	0	0	6	0	0
14	20731756	.	G	A	2	3	5	0	0	5	0	0
14	20731797	.	C	T	4	2	6	0	0	6	0	0
14	20731904	.	T	C	2	4	6	0	0	6	0	0
14	20732457	.	T	C	2	2	4	0	1	5	0	0
14	20732474	.	G	C	1	2	3	0	2	5	0	0
14	20732546	.	G	C	3	2	5	0	0	5	0	0
14	20735084	.	C	G	1	4	5	0	1	6	0	0
14	20735388	.	T	G	15	8	23	0	1	24	0	0
14	20735481	.	T	C	7	17	24	1	0	25	0	0
14	20735525	.	T	A	7	7	14	1	2	17	0	0
14	20735585	.	G	T	7	4	11	0	0	11	0	0
14	20735626	.	G	T	8	4	12	0	0	13	1	0
14	20735841	.	A	G	8	0	8	0	11	19	0	0
14	20736251	.	A	G	10	13	23	0	1	24	0	0
14	20736829	.	A	G	4	0	4	0	5	9	0	0
14	20869833	.	G	A	1	4	5	0	0	5	0	0
14	20869866	.	C	A	3	4	7	0	0	7	0	0
14	20869943	.	T	C	8	0	8	0	6	14	0	0
14	20869949	.	G	A	7	5	12	0	0	12	0	0
14	20870141	.	G	T	8	7	15	0	0	15	0	0
14	20870153	.	A	G	6	4	10	0	0	10	0	0
14	20870257	.	A	G	3	8	11	0	2	13	0	0
14	20870321	.	G	T	4	11	15	0	0	15	0	0
14	20879947	.	T	G	4	5	9	0	1	10	0	0
14	20881493	.	C	T	1	4	5	0	0	5	0	0
14	20896049	.	T	G	5	0	5	0	3	8	0	0
14	20896058	.	C	T	6	2	8	0	0	8	0	0
14	20898296	.	C	T	3	2	5	0	0	5	0	0
14	20988209	.	T	C	2	3	5	0	0	5	0	0
14	20994005	.	T	C	3	2	5	0	0	5	0	0
14	20994047	.	A	G	1	0	1	0	4	5	0	0
14	20994051	.	G	A	0	4	4	0	1	5	0	0
14	20994167	.	C	T	3	3	6	0	1	7	0	0
14	20994695	.	G	A	4	4	8	0	1	9	0	0
14	20994967	.	T	C	4	2	6	0	0	6	0	0
14	20996393	.	C	T	3	8	11	0	0	11	0	0
14	20996394	.	A	T	3	7	10	0	1	11	0	0
14	21000170	.	C	G	7	10	17	1	2	20	0	0
14	21000193	.	T	C	7	4	11	0	7	18	0	0
14	21000256	.	C	A	5	6	11	0	0	11	0	0
14	21000257	.	A	G	5	5	10	0	1	11	0	0
14	21000323	.	T	A	8	2	10	0	1	11	0	0
14	21000325	.	G	A	1	3	4	0	7	11	0	0
14	21000375	.	A	G	1	0	1	0	3	4	0	0
14	21067202	.	C	G	3	4	7	0	0	7	0	0
14	21067455	.	G	A	5	8	13	0	0	13	0	0
14	21067935	.	A	G	6	10	16	0	0	16	0	0
14	21067938	.	T	C	7	8	15	0	0	15	0	0
14	21071965	.	T	C	8	5	13	0	2	15	0	0
14	21072037	.	G	A	9	7	16	0	1	17	0	0
14	21072729	.	A	G	9	13	22	0	0	22	0	0
14	21072792	.	C	T	10	6	16	0	0	16	0	0
14	21072834	.	C	T	9	6	15	0	1	16	0	0
14	21072852	.	G	A	8	6	14	0	0	14	0	0
14	21078274	.	G	A	4	5	9	0	0	9	0	0
14	21078277	.	T	C	5	5	10	0	0	10	0	0
14	21079937	.	G	C	1	0	1	0	4	5	0	0
14	21079991	.	A	T	8	4	12	0	0	12	0	0
14	21087521	.	C	A	3	4	7	0	0	7	0	0
14	21090848	.	A	C	5	0	5	0	4	9	0	0
14	21111740	.	T	C	0	2	2	0	1	3	0	0
14	21124321	.	T	C	6	12	18	0	0	18	0	0
14	21124360	.	G	T	9	10	19	0	0	19	0	0
14	21124469	.	A	G	3	3	6	0	0	6	0	0
14	21129362	.	T	G	5	6	11	0	2	13	0	0
14	21129629	.	G	T	9	7	16	0	1	17	0	0
14	21132180	.	G	A	5	5	10	0	0	10	0	0
14	21159943	.	T	G	8	0	8	0	6	14	0	0
14	21159949	.	A	T	8	7	15	0	1	16	0	0
14	21183865	.	G	A	14	12	26	0	0	26	0	0
14	21183910	.	A	G	10	12	22	0	0	22	0	0
14	21187563	.	C	T	9	14	23	0	1	24	0	0
14	21187631	.	C	T	13	15	28	0	0	28	0	0
14	21195795	.	C	T	13	22	35	0	0	35	0	0
14	21198328	.	A	C	17	23	40	0	4	44	0	0
14	21198349	.	T	A	13	14	27	0	3	31	1	0
14	21198391	.	A	C	13	15	28	0	1	29	0	0
14	21198403	.	T	C	16	16	32	0	4	36	0	0
14	21198689	.	T	A	15	10	25	0	0	25	0	0
14	21198818	.	C	T	16	16	32	0	1	33	0	0
14	21199092	.	G	T	15	5	20	0	0	20	0	0
14	21204542	.	G	A	3	3	6	0	1	7	0	0
14	21204553	.	T	A	3	6	9	0	0	9	0	0
14	21204814	.	T	A	6	10	16	0	0	16	0	0
14	21205297	.	T	C	2	2	4	0	0	4	0	0
14	21205429	.	T	C	6	0	6	0	22	28	0	0
14	21205471	.	G	A	14	22	36	0	1	37	0	0
14	21205623	.	G	T	6	17	23	0	3	26	0	0
14	21211802	.	A	C	6	9	15	0	2	17	0	0
14	21211859	.	T	A	5	5	10	0	1	11	0	0
14	21238759	.	T	C	9	5	14	0	4	18	0	0
14	21238782	.	T	A	8	8	16	0	2	18	0	0
14	21241695	.	G	A	2	18	20	0	15	35	0	0
14	21241870	.	T	A	4	4	8	0	1	9	0	0
14	21241899	.	A	G	4	7	11	0	0	11	0	0
14	21242082	.	T	A	8	10	18	3	0	21	0	0
14	21242148	.	C	T	9	6	15	0	1	16	0	0
14	21245050	.	T	G	4	2	6	0	0	6	0	0
14	21245060	.	T	C	4	1	5	0	0	5	0	0
14	21245142	.	C	T	3	6	9	0	0	9	0	0
14	21245180	.	T	G	5	6	11	0	1	12	0	0
14	21245315	.	G	T	9	5	14	0	1	15	0	0
14	21245616	.	A	G	1	2	3	0	1	4	0	0
14	21332964	.	G	A	34	27	61	0	6	67	0	0
14	21333795	.	G	A	34	34	68	0	5	73	0	0
14	21333867	.	C	A	7	27	34	0	40	74	0	0
14	21333957	.	G	A	48	36	84	0	4	88	0	0
14	21334257	.	G	T	31	28	59	0	5	64	0	0
14	21334338	.	A	G	28	35	63	0	3	66	0	0
14	21334840	.	G	C	35	19	54	0	7	61	0	0
14	21334968	.	G	A	29	20	49	0	1	50	0	0
14	21334985	.	G	T	25	18	43	0	1	44	0	0
14	21597044	.	A	G	27	15	42	0	3	45	0	0
14	21597140	.	C	A	28	16	44	1	10	55	0	0
14	21597264	.	G	A	15	21	36	0	0	36	0	0
14	21597363	.	A	G	22	14	36	0	6	42	0	0
14	21597425	.	G	A	17	4	21	0	9	30	0	0
14	21597451	.	T	C	13	7	20	0	1	21	0	0
14	21597469	.	T	C	8	5	13	0	2	15	0	0
14	21597671	.	T	C	17	13	30	0	3	33	0	0
14	21597730	.	C	T	25	18	43	0	4	47	0	0
14	21597755	.	T	A	20	17	37	1	0	38	0	0
14	21597814	.	C	T	15	20	35	1	0	36	0	0
14	21598035	.	C	T	17	14	31	0	7	38	0	0
14	21598354	.	T	C	14	0	14	0	13	27	0	0
14	21598372	.	G	A	16	8	24	0	2	26	0	0
14	21598402	.	C	A	9	9	18	0	1	19	0	0
14	21598488	.	C	T	20	10	30	0	3	33	0	0
14	21598724	.	T	G	18	5	23	0	2	25	0	0
14	21598831	.	G	T	19	19	38	0	1	40	1	0
14	21603294	.	G	C	21	22	43	0	1	44	0	0
14	21603335	.	A	G	21	23	44	0	1	45	0	0
14	21609707	.	A	G	19	19	38	0	1	39	0	0
14	21609733	.	A	G	19	17	36	0	1	37	0	0
14	21616066	.	T	C	4	7	11	2	0	13	0	0
14	21617939	.	G	A	9	5	14	0	2	16	0	0
14	21617947	.	G	C	9	4	13	0	1	14	0	0
14	21623128	.	A	T	9	14	23	0	1	24	0	0
14	21623324	.	C	T	12	7	19	0	0	19	0	0
14	21630153	.	A	G	18	9	27	0	0	27	0	0
14	21636953	.	G	A	16	11	27	0	2	29	0	0
14	21636965	.	A	G	21	10	31	0	0	31	0	0
14	21639583	.	A	G	6	6	12	0	0	12	0	0
14	21643550	.	T	C	5	7	12	0	1	13	0	0
14	21643647	.	T	A	4	3	7	0	0	7	0	0
14	21646110	.	G	A	7	3	10	0	0	10	0	0
14	21652399	.	G	T	3	2	5	0	1	6	0	0
14	21654600	.	G	A	2	6	8	0	1	9	0	0
14	21654748	.	G	C	1	3	4	0	0	4	0	0
14	21655177	.	T	C	1	2	3	0	0	3	0	0
14	21655533	.	T	C	2	1	3	0	1	4	0	0
14	21689852	.	C	T	24	28	52	0	4	56	0	0
14	21693251	.	G	A	30	37	67	0	5	72	0	0
14	21693584	.	T	G	35	25	60	0	4	64	0	0
14	21723413	.	A	G	1	0	1	0	2	3	0	0
14	21745784	.	G	A	6	4	10	0	0	10	0	0
14	21745871	.	C	A	3	4	7	0	0	7	0	0
14	21745879	.	A	T	3	4	7	0	0	7	0	0
14	21745917	.	G	C	6	2	8	0	0	8	0	0
14	21746096	.	A	T	3	2	5	0	2	7	0	0
14	21746148	.	T	C	4	2	6	0	0	6	0	0
14	21746226	.	T	G	7	3	10	0	1	11	0	0
14	21750970	.	C	T	4	5	9	0	0	9	0	0
14	21751124	.	G	A	4	2	6	0	0	6	0	0
14	21759501	.	C	T	1	1	2	0	1	3	0	0
14	21766410	.	C	T	2	3	5	0	0	5	0	0
14	21766428	.	A	G	2	2	4	0	1	5	0	0
14	21768244	.	G	A	1	2	3	0	2	5	0	0
14	21768418	.	G	A	3	2	5	0	0	5	0	0
14	21770666	.	C	G	2	2	4	0	1	5	0	0
14	21772412	.	C	T	7	5	12	0	0	12	0	0
14	21779102	.	C	T	6	8	14	3	1	18	0	0
14	21779141	.	G	A	2	3	5	4	12	21	0	0
14	21779241	.	G	A	6	8	14	0	1	15	0	0
14	21779518	.	C	T	7	8	15	0	1	16	0	0
14	21779914	.	C	A	1	3	4	0	0	4	0	0
14	21779975	.	C	A	3	8	11	0	1	12	0	0
14	21779977	.	G	A	8	3	11	0	1	12	0	0
14	21780155	.	C	G	8	11	19	0	0	19	0	0
14	21780206	.	A	G	8	12	20	0	0	20	0	0
14	21780274	.	A	C	7	12	19	0	2	21	0	0
14	21780321	.	T	C	7	8	15	0	2	17	0	0
14	21790748	.	C	T	3	5	8	0	2	10	0	0
14	21801383	.	G	A	6	12	18	0	0	18	0	0
14	21804912	.	T	C	5	16	21	0	3	24	0	0
14	21806190	.	C	T	12	16	28	0	2	30	0	0
14	21806196	.	G	C	0	14	14	0	14	28	0	0
14	21813696	.	G	A	14	23	37	0	0	37	0	0
14	21816388	.	T	C	25	18	43	0	0	43	0	0
14	21834912	.	C	T	5	5	10	0	0	10	0	0
14	21838379	.	T	C	8	7	15	2	0	17	0	0
14	21840858	.	A	G	4	0	4	0	5	9	0	0
14	21842804	.	T	C	9	19	28	0	2	30	0	0
14	21843726	.	G	A	1	8	9	0	10	19	0	0
14	21844187	.	T	A	12	13	25	0	3	28	0	0
14	21844486	.	C	T	4	5	9	0	1	10	0	0
14	21924048	.	G	A	4	2	6	0	0	6	0	0
14	21924273	.	A	G	5	5	10	0	0	10	0	0
14	21924382	.	A	G	4	6	10	0	0	10	0	0
14	21928614	.	A	G	1	2	3	0	0	3	0	0
14	22104906	.	T	C	11	9	20	0	2	22	0	0
14	22104948	.	G	A	9	24	33	0	0	33	0	0
14	22108215	.	C	T	10	7	17	0	4	21	0	0
14	22109640	.	A	T	1	2	3	0	0	3	0	0
14	22132510	.	A	T	11	14	25	0	5	30	0	0
14	22132536	.	A	T	11	20	31	0	3	34	0	0
14	22134069	.	G	A	19	13	32	0	5	37	0	0
14	22139160	.	T	C	23	28	51	0	2	53	0	0
14	22139194	.	C	T	26	26	52	0	0	52	0	0
14	22139254	.	G	A	37	23	60	0	2	62	0	0
14	22139308	.	C	T	18	38	56	0	5	61	0	0
14	22139358	.	G	A	40	19	59	0	2	61	0	0
14	22139392	.	G	T	36	20	56	0	2	58	0	0
14	22139668	.	G	A	2	24	26	0	35	61	0	0
14	22139816	.	G	A	8	20	28	0	33	61	0	0
14	22140150	.	G	A	8	7	15	0	0	15	0	0
14	22140158	.	T	C	6	6	12	0	3	15	0	0
14	22140417	.	T	C	10	8	18	0	1	19	0	0
14	22140542	.	G	A	5	15	20	0	2	22	0	0
14	22145661	.	G	C	7	0	7	0	10	18	1	0
14	22151827	.	A	T	8	12	20	0	0	20	0	0
14	22151913	.	C	T	14	16	30	0	1	31	0	0
14	22151958	.	T	A	12	10	22	0	5	27	0	0
14	22151966	.	A	C	11	9	20	0	2	22	0	0
14	22172138	.	C	T	9	4	13	0	0	13	0	0
14	22249344	.	G	A	7	9	16	0	0	16	0	0
14	22254184	.	T	C	15	16	31	0	1	32	0	0
14	22272340	.	G	A	33	17	50	0	0	50	0	0
14	22272351	.	G	A	28	19	47	0	3	50	0	0
14	22272749	.	A	G	20	1	21	0	22	43	0	0
14	22364055	.	A	G	2	0	2	0	3	5	0	0
14	22364119	.	G	A	1	3	4	0	0	4	0	0
14	22367619	.	A	G	0	2	2	0	1	3	0	0
14	22367876	.	T	C	1	0	1	0	2	3	0	0
14	22370317	.	A	T	1	3	4	0	0	4	0	0
14	22370345	.	G	C	2	4	6	0	0	6	0	0
14	22370462	.	T	C	3	2	5	0	0	5	0	0
14	22434336	.	G	C	0	4	4	0	5	9	0	0
14	22434387	.	C	T	5	2	7	0	0	7	0	0
14	22437413	.	G	T	1	6	7	0	0	7	0	0
14	22438924	.	A	G	1	5	6	0	0	6	0	0
14	22439210	.	G	T	3	2	5	0	1	6	0	0
14	22439455	.	A	T	2	2	4	0	0	4	0	0
14	22439955	.	T	A	3	4	7	0	0	7	0	0
14	22440897	.	C	A	2	2	4	0	0	4	0	0
14	22440918	.	G	A	1	3	4	0	0	4	0	0
14	22441000	.	G	C	4	8	12	0	0	12	0	0
14	22441057	.	T	C	3	9	12	0	0	12	0	0
14	22441110	.	G	A	6	4	10	0	0	10	0	0
14	22441210	.	A	T	5	2	7	2	1	10	0	0
14	22441532	.	T	C	2	7	9	0	0	9	0	0
14	22441581	.	C	A	8	9	17	0	1	18	0	0
14	22441793	.	G	A	3	8	11	0	10	21	0	0
14	22441873	.	T	C	6	4	10	0	1	11	0	0
14	22469807	.	C	T	3	2	5	0	0	5	0	0
14	22469887	.	C	G	1	1	2	0	1	3	0	0
14	22469917	.	T	C	1	2	3	0	0	3	0	0
14	22470154	.	T	C	5	5	10	0	0	10	0	0
14	22470213	.	T	C	5	3	8	0	1	9	0	0
14	22478282	.	G	A	4	3	7	0	0	7	0	0
14	22478454	.	C	T	2	5	7	0	2	9	0	0
14	22478841	.	C	T	2	2	4	0	0	4	0	0
14	22478845	.	G	A	2	2	4	0	0	4	0	0
14	22509843	.	C	A	7	4	11	0	0	11	0	0
14	22523584	.	A	G	1	5	6	0	0	6	0	0
14	22523608	.	C	A	4	6	10	0	0	10	0	0
14	22523633	.	T	C	5	5	10	0	0	10	0	0
14	22523644	.	C	T	5	4	9	0	0	9	0	0
14	22708325	.	A	G	3	7	10	0	1	11	0	0
14	22708389	.	C	T	9	10	19	0	0	19	0	0
14	22708401	.	C	A	9	8	17	0	1	18	0	0
14	22708446	.	C	T	7	9	16	0	2	18	0	0
14	22708771	.	T	A	2	2	4	0	0	4	0	0
14	23076349	.	A	T	1	3	4	0	0	4	0	0
14	23172012	.	T	C	1	2	3	0	0	3	0	0
14	23409971	.	A	G	5	5	10	0	0	10	0	0
14	23411619	.	C	G	4	0	4	0	7	11	0	0
14	23411712	.	G	T	0	4	4	0	3	7	0	0
14	23455989	.	G	A	8	9	17	0	0	17	0	0
14	23463681	.	G	A	1	10	11	0	2	13	0	0
14	23463708	.	A	G	3	9	12	0	0	12	0	0
14	23463717	.	A	G	4	0	4	0	8	12	0	0
14	23463760	.	C	A	6	5	11	0	1	12	0	0
14	23478997	.	G	C	7	8	15	0	1	16	0	0
14	23628158	.	C	T	1	2	3	0	0	3	0	0
14	23663911	.	G	C	4	8	12	0	0	12	0	0
14	23664063	.	T	G	5	4	9	0	0	9	0	0
14	23665987	.	G	A	6	6	12	0	2	14	0	0
14	23666002	.	C	T	8	6	14	0	0	14	0	0
14	23666203	.	T	C	9	7	16	0	1	17	0	0
14	23666227	.	G	A	3	7	10	0	11	21	0	0
14	23666266	.	C	A	10	10	20	0	1	21	0	0
14	23666431	.	G	A	10	10	20	0	0	20	0	0
14	23666491	.	G	A	3	5	8	0	5	13	0	0
14	23666625	.	C	T	8	9	17	0	1	18	0	0
14	23668714	.	T	C	12	7	19	0	0	19	0	0
14	23668724	.	C	A	13	5	18	0	0	18	0	0
14	23671197	.	A	G	14	0	14	0	12	26	0	0
14	23671248	.	T	C	12	11	23	0	1	24	0	0
14	23671361	.	C	G	18	11	29	0	1	30	0	0
14	23673373	.	G	A	3	23	26	0	19	45	0	0
14	23673499	.	A	G	14	9	23	4	1	28	0	0
14	23673514	.	G	A	11	13	24	4	2	30	0	0
14	23679564	.	T	C	5	2	7	0	2	9	0	0
14	23679592	.	T	C	4	2	6	0	0	6	0	0
14	23679671	.	G	A	2	2	4	0	0	4	0	0
14	23679674	.	T	G	2	2	4	0	0	4	0	0
14	23680405	.	T	C	2	0	2	0	3	5	0	0
14	23687872	.	G	C	5	2	7	0	1	8	0	0
14	23689974	.	A	T	5	2	7	0	1	8	0	0
14	23693914	.	T	C	2	2	4	0	0	4	0	0
14	23700121	.	T	C	20	14	34	0	1	35	0	0
14	23700142	.	G	T	19	12	31	0	4	35	0	0
14	23702730	.	G	A	19	16	35	0	2	37	0	0
14	23707976	.	A	G	26	9	35	0	0	35	0	0
14	23717277	.	A	T	10	8	18	0	1	19	0	0
14	23717289	.	A	T	12	9	21	0	1	22	0	0
14	23720196	.	A	T	21	22	43	0	2	45	0	0
14	23725824	.	T	A	9	11	20	0	2	22	0	0
14	23726124	.	G	T	25	24	49	0	3	52	0	0
14	23726413	.	G	A	36	27	63	1	5	69	0	0
14	23726547	.	C	T	18	33	51	0	2	53	0	0
14	23732056	.	C	A	5	4	9	0	0	9	0	0
14	23732117	.	T	C	4	10	14	0	0	14	0	0
14	23732134	.	C	T	3	11	14	0	0	14	0	0
14	23732167	.	C	A	2	9	11	0	0	11	0	0
14	23732194	.	T	G	3	6	9	0	0	9	0	0
14	23732209	.	A	T	6	3	9	0	0	9	0	0
14	23732299	.	C	T	0	9	9	0	8	17	0	0
14	23732324	.	T	C	11	0	11	0	10	21	0	0
14	23732368	.	C	A	0	7	7	0	8	15	0	0
14	23732396	.	A	G	5	10	15	0	0	15	0	0
14	23732444	.	G	T	7	14	21	0	1	22	0	0
14	23732497	.	C	A	12	11	23	0	2	25	0	0
14	23732547	.	T	A	7	8	15	0	1	16	0	0
14	23732639	.	G	A	3	2	5	0	0	5	0	0
14	23732734	.	G	A	1	6	7	0	1	8	0	0
14	23732824	.	T	A	5	2	7	0	0	7	0	0
14	23732916	.	C	T	2	4	6	0	0	6	0	0
14	23732929	.	T	G	1	5	6	0	0	6	0	0
14	23733097	.	A	G	4	7	11	0	0	11	0	0
14	23733220	.	G	A	4	7	11	0	0	11	0	0
14	23737569	.	A	T	4	9	13	1	0	14	0	0
14	23737655	.	G	A	1	1	2	0	2	4	0	0
14	23737661	.	C	T	0	2	2	0	1	3	0	0
14	23748436	.	G	A	13	4	17	0	2	19	0	0
14	23748654	.	A	G	12	10	22	0	5	27	0	0
14	23756637	.	A	G	7	3	10	0	0	10	0	0
14	23756680	.	A	G	4	4	8	0	0	8	0	0
14	23756752	.	T	G	6	13	19	0	0	19	0	0
14	23756809	.	G	T	6	11	17	0	2	19	0	0
14	23765748	.	T	C	4	7	11	0	1	12	0	0
14	23798649	.	C	G	3	7	10	0	0	10	0	0
14	23798675	.	G	C	3	4	7	0	0	7	0	0
14	23798699	.	A	C	4	5	9	0	1	10	0	0
14	23799076	.	G	T	6	3	9	0	0	9	0	0
14	23799095	.	G	T	4	4	8	0	1	9	0	0
14	23811956	.	T	C	1	2	3	0	0	3	0	0
14	23812581	.	C	T	2	2	4	0	0	4	0	0
14	23966629	.	A	C	2	4	6	0	0	6	0	0
14	23968042	.	C	T	4	2	6	0	0	6	0	0
14	23968612	.	A	T	2	6	8	0	0	8	0	0
14	23968619	.	T	A	4	4	8	0	0	8	0	0
14	23968678	.	T	G	2	5	7	0	0	7	0	0
14	23968743	.	C	T	7	11	18	0	0	18	0	0
14	23968774	.	T	C	9	8	17	0	0	17	0	0
14	23968781	.	C	A	8	6	14	0	1	15	0	0
14	23968925	.	G	A	1	2	3	0	0	3	0	0
14	23968932	.	T	C	2	1	3	0	0	3	0	0
14	23969295	.	G	A	0	2	2	0	4	6	0	0
14	23969333	.	T	G	3	0	3	0	3	6	0	0
14	23969374	.	A	C	3	5	8	0	0	8	0	0
14	23969378	.	G	A	3	5	8	0	0	8	0	0
14	23969443	.	G	C	3	5	8	0	0	8	0	0
14	23969446	.	T	C	4	5	9	0	0	9	0	0
14	23969485	.	G	A	8	6	14	0	0	14	0	0
14	23969518	.	T	C	11	5	16	0	3	19	0	0
14	23969779	.	C	G	9	4	13	0	0	13	0	0
14	23970887	.	T	C	7	8	15	1	1	17	0	0
14	23972572	.	G	A	8	7	15	0	0	15	0	0
14	23972587	.	C	T	5	6	11	0	1	12	0	0
14	23976245	.	C	T	7	5	12	0	3	15	0	0
14	23981999	.	T	C	7	14	21	0	1	22	0	0
14	23982623	.	A	T	17	17	34	0	3	37	0	0
14	23991507	.	C	T	16	27	43	0	0	43	0	0
14	23991588	.	G	A	18	18	36	0	2	38	0	0
14	23993952	.	A	G	19	23	42	0	3	45	0	0
14	23993958	.	G	A	21	18	39	0	4	43	0	0
14	23999002	.	G	C	27	17	44	0	0	44	0	0
14	23999086	.	G	A	25	21	46	0	3	49	0	0
14	23999112	.	A	G	27	17	44	0	3	47	0	0
14	23999225	.	A	G	23	20	43	0	0	43	0	0
14	23999239	.	G	C	1	20	21	0	18	39	0	0
14	23999466	.	C	A	8	14	22	0	2	24	0	0
14	24001663	.	C	T	1	2	3	0	0	3	0	0
14	24316809	.	A	T	15	6	21	0	1	22	0	0
14	24317301	.	G	T	32	30	62	0	1	63	0	0
14	24317314	.	T	C	38	28	66	0	1	67	0	0
14	24317508	.	T	C	28	28	56	0	5	61	0	0
14	24317685	.	T	A	29	30	59	0	2	61	0	0
14	24317717	.	T	A	31	23	54	0	1	55	0	0
14	24318087	.	A	T	28	19	47	0	0	47	0	0
14	24318102	.	A	T	20	30	50	0	1	51	0	0
14	24318160	.	T	G	21	11	32	1	2	35	0	0
14	24318196	.	G	A	17	15	32	1	2	35	0	0
14	24318232	.	G	C	18	17	35	3	4	42	0	0
14	24318335	.	G	T	16	17	33	0	1	34	0	0
14	24318479	.	A	T	19	20	39	0	5	44	0	0
14	24318631	.	C	T	14	22	36	0	1	37	0	0
14	24318652	.	G	A	15	19	34	0	4	38	0	0
14	24318709	.	A	T	19	14	33	0	1	34	0	0
14	24318723	.	T	C	22	13	35	0	3	38	0	0
14	24318868	.	T	C	23	27	50	0	2	52	0	0
14	24325537	.	T	C	29	17	46	0	4	50	0	0
14	24332817	.	A	T	15	19	34	0	0	34	0	0
14	24333761	.	A	G	15	13	28	0	0	28	0	0
14	24391361	.	A	G	5	6	11	0	1	12	0	0
14	24391397	.	G	A	5	4	9	0	0	9	0	0
14	24401077	.	C	T	0	15	15	0	15	30	0	0
14	24401209	.	T	G	13	14	27	0	1	28	0	0
14	24401393	.	A	G	9	7	16	0	3	19	0	0
14	24401700	.	C	A	0	15	15	0	18	33	0	0
14	24401844	.	T	A	10	17	27	0	4	31	0	0
14	24410373	.	G	A	6	8	14	0	5	19	0	0
14	24410384	.	T	C	8	0	8	0	15	23	0	0
14	24410553	.	C	A	10	8	18	0	0	18	0	0
14	24410556	.	T	C	7	8	15	0	1	16	0	0
14	24492051	.	G	C	6	8	14	0	1	15	0	0
14	24492225	.	G	A	5	7	12	0	0	12	0	0
14	24492666	.	C	A	5	5	10	0	1	11	0	0
14	24492667	.	T	A	5	4	9	0	2	11	0	0
14	24497832	.	G	T	1	4	5	0	1	6	0	0
14	24497904	.	T	C	3	0	3	0	6	9	0	0
14	24512823	.	G	A	1	3	4	0	0	4	0	0
14	24531362	.	A	T	1	2	3	0	0	3	0	0
14	24541903	.	C	G	1	2	3	0	2	5	0	0
14	24848588	.	A	G	2	0	2	0	2	4	0	0
14	24848595	.	T	G	2	2	4	0	0	4	0	0
14	24873121	.	A	G	1	0	1	0	5	6	0	0
14	24873135	.	G	A	3	3	6	0	0	6	0	0
14	24873487	.	A	G	5	4	9	0	1	10	0	0
14	24984997	.	C	T	1	2	3	0	0	3	0	0
14	24987643	.	G	T	4	7	11	0	0	11	0	0
14	24994819	.	G	A	1	2	3	0	2	5	0	0
14	24997871	.	C	T	6	5	11	0	0	11	0	0
14	24998002	.	T	C	4	5	9	0	1	10	0	0
14	24998019	.	A	T	5	5	10	0	0	10	0	0
14	24998076	.	A	G	9	0	9	0	9	18	0	0
14	24998345	.	C	A	6	3	9	0	1	10	0	0
14	24998395	.	C	T	6	14	20	0	0	20	0	0
14	24998430	.	G	A	1	11	12	0	3	15	0	0
14	24998565	.	T	C	8	13	21	0	3	24	0	0
14	24998616	.	A	C	11	7	18	0	0	18	0	0
14	24998737	.	A	C	10	12	22	0	0	22	0	0
14	24998804	.	A	G	6	0	6	0	8	14	0	0
14	24999546	.	T	A	15	12	27	0	1	28	0	0
14	24999722	.	T	C	11	8	19	1	1	21	0	0
14	25000623	.	A	C	9	22	31	0	1	32	0	0
14	25000686	.	T	A	11	13	24	0	0	24	0	0
14	25000803	.	T	G	13	14	27	0	0	27	0	0
14	25001250	.	C	T	5	3	8	0	2	10	0	0
14	25034940	.	C	T	0	4	4	0	3	7	0	0
14	25063434	.	T	A	1	4	5	0	0	5	0	0
14	25063538	.	T	C	1	4	5	0	0	5	0	0
14	25063617	.	A	G	6	16	22	0	3	25	0	0
14	25066002	.	C	A	2	18	20	0	24	45	1	0
14	25066010	.	T	A	25	15	40	0	1	41	0	0
14	25066722	.	T	A	23	10	33	0	0	33	0	0
14	25067471	.	C	T	18	11	29	0	4	33	0	0
14	25067665	.	C	T	17	13	30	0	0	30	0	0
14	25067700	.	C	A	16	14	30	0	1	31	0	0
14	25067857	.	G	A	22	11	33	0	1	34	0	0
14	25067862	.	A	C	25	11	36	0	1	37	0	0
14	25067984	.	C	T	20	7	27	0	1	28	0	0
14	25068007	.	G	C	18	6	24	0	1	25	0	0
14	25068206	.	G	T	17	15	32	0	0	32	0	0
14	25068215	.	T	G	22	17	39	0	2	41	0	0
14	25071338	.	C	T	2	12	14	0	21	35	0	0
14	25072307	.	G	T	20	14	34	0	1	35	0	0
14	25072351	.	C	T	22	9	31	0	1	32	0	0
14	25072843	.	A	T	15	8	23	0	2	25	0	0
14	25073511	.	C	T	10	7	17	0	0	17	0	0
14	25075173	.	G	A	8	5	13	0	0	13	0	0
14	25076609	.	A	T	4	7	11	0	0	11	0	0
14	25076628	.	C	A	3	6	9	0	2	11	0	0
14	25080035	.	A	G	23	19	42	0	3	45	0	0
14	25084872	.	A	G	25	17	42	0	2	44	0	0
14	25090031	.	C	T	10	11	21	0	2	23	0	0
14	25091043	.	C	G	12	21	33	0	1	34	0	0
14	25091063	.	A	G	14	20	34	0	1	35	0	0
14	25091453	.	C	T	16	11	27	0	1	28	0	0
14	25091467	.	C	T	15	8	23	0	1	24	0	0
14	25092940	.	A	C	8	5	13	0	0	13	0	0
14	25093710	.	G	A	6	7	13	0	2	15	0	0
14	25482568	.	T	G	1	2	3	0	0	3	0	0
14	25501772	.	C	T	10	3	13	0	5	18	0	0
14	25501870	.	C	A	10	11	21	0	1	22	0	0
14	25510803	.	A	G	8	3	11	0	0	11	0	0
14	25535003	.	C	T	0	15	15	0	3	18	0	0
14	25535005	.	T	C	2	13	15	0	3	18	0	0
14	25535067	.	A	T	10	15	25	0	0	25	0	0
14	25535167	.	T	G	12	13	25	1	5	31	0	0
14	25535607	.	G	A	23	21	44	0	0	44	0	0
14	25535706	.	G	T	25	27	52	0	1	53	0	0
14	25535742	.	T	A	22	20	42	2	0	44	0	0
14	25535768	.	G	T	14	16	30	3	3	36	0	0
14	25535820	.	C	T	1	10	11	0	16	27	0	0
14	25535836	.	G	A	16	5	21	0	0	21	0	0
14	25536132	.	T	C	21	7	28	0	0	28	0	0
14	25536148	.	G	A	15	7	22	0	2	24	0	0
14	25536187	.	G	T	14	4	18	0	1	19	0	0
14	25536531	.	T	G	16	15	31	0	1	32	0	0
14	25536577	.	G	C	19	11	30	0	3	33	0	0
14	25536619	.	A	G	16	17	33	0	1	34	0	0
14	25536657	.	A	C	14	19	33	0	2	35	0	0
14	25536770	.	A	T	17	14	31	0	2	33	0	0
14	25536782	.	C	T	2	15	17	0	15	32	0	0
14	25537019	.	C	A	9	13	22	0	3	25	0	0
14	25537068	.	G	A	13	13	26	0	1	27	0	0
14	25537136	.	T	C	14	13	27	0	0	27	0	0
14	25537145	.	G	A	12	15	27	0	2	29	0	0
14	25537189	.	A	T	17	21	38	0	0	38	0	0
14	25537200	.	C	T	15	21	36	0	2	38	0	0
14	25537307	.	A	T	6	13	19	0	1	20	0	0
14	25537332	.	T	A	8	10	18	0	1	20	1	0
14	25537345	.	A	G	7	13	20	0	0	20	0	0
14	25537405	.	A	G	9	12	21	0	0	21	0	0
14	25537700	.	C	T	0	10	10	0	9	19	0	0
14	25537975	.	G	T	16	13	29	0	2	31	0	0
14	25538121	.	T	C	9	17	26	0	0	26	0	0
14	25538402	.	G	A	5	13	18	0	0	18	0	0
14	25538433	.	T	A	5	10	15	0	0	15	0	0
14	25538618	.	T	A	10	10	20	0	0	20	0	0
14	25538803	.	T	A	6	11	17	0	2	19	0	0
14	25539423	.	C	T	0	9	9	0	12	21	0	0
14	25591134	.	A	G	6	15	21	0	0	21	0	0
14	25591176	.	T	G	8	12	20	0	0	20	0	0
14	25591182	.	C	T	0	9	9	0	7	16	0	0
14	25905868	.	A	G	1	1	2	0	1	3	0	0
14	25905869	.	A	G	1	2	3	0	0	3	0	0
14	25906074	.	A	G	4	4	8	0	0	8	0	0
14	25906517	.	C	T	2	2	4	0	1	5	0	0
14	25906577	.	A	T	2	2	4	0	0	4	0	0
14	25906652	.	G	T	5	3	8	0	0	8	0	0
14	25906891	.	C	T	3	5	8	0	0	8	0	0
14	25907081	.	T	A	2	3	5	0	1	6	0	0
14	25907610	.	A	G	4	2	6	0	0	6	0	0
14	25907704	.	T	C	2	2	4	0	0	4	0	0
14	25907737	.	T	C	0	2	2	0	2	4	0	0
14	25908030	.	A	G	3	3	6	0	0	6	0	0
14	25908113	.	A	C	3	2	5	0	0	5	0	0
14	25908149	.	A	T	1	2	3	0	0	3	0	0
14	25908659	.	G	C	1	2	3	0	1	4	0	0
14	25908680	.	A	T	1	2	3	0	0	3	0	0
14	25909047	.	T	A	3	2	5	0	0	5	0	0
14	25909048	.	A	T	0	1	1	0	4	5	0	0
14	25909103	.	C	A	2	3	5	0	0	5	0	0
14	25909213	.	C	T	8	10	18	0	0	18	0	0
14	25909258	.	T	G	6	10	16	0	0	16	0	0
14	25909260	.	C	T	7	10	17	0	0	17	0	0
14	25909587	.	A	T	2	2	4	0	0	4	0	0
14	25910106	.	C	A	8	1	9	0	0	9	0	0
14	25910126	.	T	A	4	3	7	0	0	7	0	0
14	25910186	.	C	A	5	5	10	0	0	10	0	0
14	25910249	.	G	A	7	6	13	0	1	14	0	0
14	25910276	.	C	T	10	6	16	0	1	17	0	0
14	25910296	.	A	G	14	11	25	1	0	26	0	0
14	25910373	.	T	C	8	8	16	0	1	17	0	0
14	25910407	.	A	G	13	7	20	0	0	20	0	0
14	25910414	.	C	G	13	7	20	0	0	20	0	0
14	25910542	.	C	T	15	13	28	0	1	29	0	0
14	25910715	.	T	C	9	7	16	0	2	18	0	0
14	25910747	.	C	T	11	11	22	0	0	22	0	0
14	25910834	.	T	A	20	15	35	0	1	36	0	0
14	25911097	.	C	T	12	13	25	0	4	29	0	0
14	25923458	.	T	A	2	2	4	0	0	4	0	0
14	25923729	.	T	A	6	12	18	0	0	18	0	0
14	25923745	.	G	A	6	11	17	0	0	17	0	0
14	25923771	.	A	G	5	13	18	0	0	18	0	0
14	25923809	.	G	A	6	7	13	0	0	13	0	0
14	25923829	.	C	T	0	8	8	0	3	11	0	0
14	25923844	.	T	G	4	4	8	0	0	8	0	0
14	25923971	.	T	A	4	6	10	0	0	10	0	0
14	25924369	.	T	A	3	7	10	0	0	10	0	0
14	25924384	.	A	G	4	6	10	0	1	11	0	0
14	25924429	.	C	T	0	5	5	0	2	7	0	0
14	25924495	.	A	C	1	3	4	0	1	5	0	0
14	25924625	.	A	T	3	2	5	0	1	6	0	0
14	25924764	.	A	T	4	8	12	0	0	12	0	0
14	25924928	.	T	A	4	7	11	0	0	11	0	0
14	25924931	.	G	A	4	6	10	0	0	10	0	0
14	25925081	.	G	T	7	6	13	0	0	13	0	0
14	25925118	.	A	T	3	4	7	0	1	8	0	0
14	25925338	.	C	A	4	3	7	0	0	7	0	0
14	25925552	.	C	A	2	2	4	0	0	4	0	0
14	25925600	.	C	T	4	3	7	0	0	7	0	0
14	25926041	.	G	A	11	10	21	0	1	22	0	0
14	25926048	.	C	T	1	12	13	0	8	21	0	0
14	25926195	.	G	A	14	14	28	0	1	29	0	0
14	25926351	.	G	A	10	19	29	0	5	34	0	0
14	25939358	.	A	C	12	3	15	0	1	16	0	0
14	25939360	.	C	A	14	3	17	0	0	17	0	0
14	25939493	.	T	C	16	15	31	0	1	32	0	0
14	25939622	.	G	A	19	15	34	0	1	35	0	0
14	25983160	.	G	A	7	7	14	0	0	14	0	0
14	25983210	.	T	A	8	17	25	0	0	25	0	0
14	25985448	.	A	C	17	9	26	0	3	29	0	0
14	26009201	.	T	C	2	3	5	0	1	6	0	0
14	26009202	.	C	T	2	4	6	0	0	6	0	0
14	26009267	.	G	A	0	2	2	0	1	3	0	0
14	26011987	.	G	A	0	3	3	0	5	8	0	0
14	26012017	.	G	A	5	2	7	0	0	7	0	0
14	26012026	.	A	G	5	0	5	0	2	7	0	0
14	26064953	.	T	C	1	3	4	0	0	4	0	0
14	26064971	.	G	C	2	2	4	0	1	5	0	0
14	26065321	.	T	C	2	7	9	0	0	9	0	0
14	26065391	.	G	A	7	8	15	0	1	16	0	0
14	26065479	.	G	A	2	5	7	0	1	8	0	0
14	26065490	.	G	A	2	6	8	0	2	10	0	0
14	26065818	.	T	G	2	6	8	0	0	8	0	0
14	26065860	.	C	T	1	5	6	0	0	6	0	0
14	26065876	.	C	T	1	3	4	0	0	4	0	0
14	26066198	.	T	G	1	2	3	0	1	4	0	0
14	26066204	.	C	T	1	2	3	0	1	4	0	0
14	26066969	.	T	C	2	4	6	0	1	7	0	0
14	26067563	.	A	G	2	5	7	0	0	7	0	0
14	26067628	.	A	G	4	3	7	0	0	7	0	0
14	26067632	.	C	T	4	3	7	0	0	7	0	0
14	26067685	.	G	T	4	8	12	0	0	12	0	0
14	26067697	.	G	A	3	8	11	0	0	11	0	0
14	26067757	.	T	A	2	5	7	0	2	9	0	0
14	26103511	.	T	G	11	9	20	0	2	22	0	0
14	26103547	.	T	A	15	14	29	0	5	34	0	0
14	26104293	.	G	A	18	19	37	0	4	41	0	0
14	26104299	.	A	G	18	19	37	0	3	40	0	0
14	26104350	.	C	A	1	24	25	0	14	39	0	0
14	26104442	.	C	T	17	21	38	0	1	39	0	0
14	26104503	.	C	T	16	17	33	0	1	34	0	0
14	26104674	.	A	T	8	7	15	0	0	15	0	0
14	26104679	.	A	C	8	0	8	0	6	14	0	0
14	26104710	.	G	T	7	6	13	0	1	14	0	0
14	26104801	.	C	A	4	6	10	0	0	10	0	0
14	26104829	.	A	G	5	5	10	0	1	11	0	0
14	26104854	.	C	T	5	4	9	0	0	9	0	0
14	26105074	.	A	C	9	8	17	0	0	17	0	0
14	26105086	.	A	C	10	10	20	0	1	21	0	0
14	26105136	.	G	A	13	7	20	0	1	21	0	0
14	26105164	.	C	A	11	7	18	0	2	20	0	0
14	26105183	.	G	T	9	5	14	0	2	16	0	0
14	26105220	.	A	T	13	3	16	0	1	17	0	0
14	26105439	.	C	G	8	7	15	0	0	15	0	0
14	26105488	.	G	A	7	7	14	0	3	17	0	0
14	26105492	.	T	A	8	6	14	0	0	14	0	0
14	26105699	.	T	A	5	4	9	1	1	11	0	0
14	26105762	.	A	T	8	6	14	0	4	18	0	0
14	26105952	.	G	T	2	3	5	0	6	11	0	0
14	26106163	.	G	T	14	6	20	0	0	20	0	0
14	26106500	.	C	A	9	14	23	0	0	23	0	0
14	26106892	.	A	G	15	17	32	0	0	32	0	0
14	26108958	.	T	G	11	11	22	0	2	24	0	0
14	26109353	.	T	G	9	6	15	0	1	16	0	0
14	26109356	.	G	A	8	7	15	0	1	16	0	0
14	26109430	.	A	G	4	5	9	0	0	9	0	0
14	26114037	.	A	T	3	8	11	0	0	11	0	0
14	26114044	.	A	C	4	7	11	0	1	12	0	0
14	26114200	.	G	A	3	5	8	0	0	8	0	0
14	26114277	.	G	A	7	4	11	0	1	12	0	0
14	26127373	.	G	A	5	5	10	0	0	10	0	0
14	26127375	.	T	A	4	5	9	0	2	11	0	0
14	26127754	.	T	A	4	3	7	0	0	7	0	0
14	26135471	.	G	A	3	3	6	0	0	6	0	0
14	26135489	.	A	G	1	2	3	0	3	6	0	0
14	26135846	.	T	A	3	4	7	0	0	7	0	0
14	26135894	.	A	G	1	5	6	0	0	6	0	0
14	26147181	.	A	G	6	3	9	0	0	9	0	0
14	26149915	.	G	T	1	2	3	0	0	3	0	0
14	26152543	.	A	C	2	2	4	0	0	4	0	0
14	26152550	.	T	C	2	2	4	0	0	4	0	0
14	26153186	.	T	C	1	0	1	0	2	3	0	0
14	26154623	.	T	C	1	0	1	0	2	3	0	0
14	26227681	.	G	A	3	4	7	0	0	7	0	0
14	26227843	.	G	C	0	2	2	0	2	4	0	0
14	26364396	.	A	G	1	2	3	0	0	3	0	0
14	26381406	.	A	G	4	3	7	0	0	7	0	0
14	26385496	.	G	A	2	5	7	0	1	8	0	0
14	26386005	.	A	G	3	2	5	0	0	5	0	0
14	26405027	.	G	A	12	8	20	0	0	20	0	0
14	26405077	.	G	A	17	9	26	0	2	28	0	0
14	26405153	.	A	G	10	7	17	0	2	19	0	0
14	26405205	.	A	G	11	9	20	0	2	22	0	0
14	26405269	.	T	A	6	5	11	0	2	13	0	0
14	26405323	.	G	A	7	2	9	0	2	11	0	0
14	26405457	.	G	A	9	9	18	0	2	20	0	0
14	26405686	.	A	C	12	16	28	0	2	30	0	0
14	26405861	.	C	T	11	12	23	0	0	23	0	0
14	26411104	.	T	C	7	7	14	0	0	14	0	0
14	26411688	.	G	A	6	6	12	0	0	12	0	0
14	26413681	.	A	C	21	5	26	1	3	30	0	0
14	26413771	.	C	T	18	10	28	0	1	29	0	0
14	26413800	.	G	T	15	13	28	0	1	29	0	0
14	26413895	.	T	C	13	12	25	0	0	25	0	0
14	26413896	.	T	A	13	12	25	0	0	25	0	0
14	26414115	.	C	A	18	18	36	0	2	38	0	0
14	26414157	.	C	T	23	11	34	0	1	35	0	0
14	26414205	.	G	T	21	6	27	0	1	28	0	0
14	26414226	.	C	G	13	5	18	0	3	21	0	0
14	26414692	.	C	T	8	16	24	0	0	24	0	0
14	26415876	.	G	C	9	8	17	0	0	17	0	0
14	26427363	.	C	A	2	2	4	1	0	6	1	0
14	26427836	.	T	A	4	4	8	0	0	8	0	0
14	26427848	.	T	C	4	2	6	0	0	6	0	0
14	26428078	.	T	C	3	2	5	0	0	5	0	0
14	26428125	.	G	C	2	4	6	0	0	6	0	0
14	26450421	.	T	A	3	3	6	0	0	6	0	0
14	26453167	.	G	C	11	10	21	0	0	21	0	0
14	26453375	.	C	T	13	10	23	0	1	24	0	0
14	26456225	.	A	G	15	12	27	0	2	29	0	0
14	26456274	.	T	C	8	16	24	0	1	25	0	0
14	26456379	.	G	A	12	16	28	0	1	29	0	0
14	26458019	.	C	T	10	12	22	0	1	23	0	0
14	26458040	.	A	G	8	15	23	0	0	23	0	0
14	26460891	.	A	G	2	2	4	0	0	4	0	0
14	26467621	.	C	A	2	3	5	0	0	5	0	0
14	26468849	.	A	G	1	2	3	0	0	3	0	0
14	26511360	.	A	C	2	3	5	0	0	5	0	0
14	26511605	.	G	A	6	11	17	0	0	17	0	0
14	26511798	.	G	A	6	5	11	0	1	12	0	0
14	26560939	.	T	C	2	2	4	0	0	4	0	0
14	26561769	.	T	G	1	2	3	0	0	3	0	0
14	26703965	.	A	T	2	2	4	0	0	4	0	0
14	26715764	.	C	T	4	3	7	0	0	7	0	0
14	26716118	.	T	A	6	8	14	0	1	15	0	0
14	26716139	.	T	C	8	11	19	0	1	20	0	0
14	26718058	.	T	C	7	5	12	0	1	13	0	0
14	26718332	.	T	A	10	2	12	0	0	12	0	0
14	26729141	.	C	A	19	27	46	0	0	46	0	0
14	26759515	.	C	T	1	2	3	0	0	3	0	0
14	26794058	.	G	T	1	1	2	0	1	3	0	0
14	26795013	.	C	A	6	3	9	0	1	10	0	0
14	26796049	.	G	T	7	6	13	0	0	13	0	0
14	26836144	.	T	G	4	0	4	0	6	10	0	0
14	26995454	.	T	C	17	13	30	0	2	32	0	0
14	26995551	.	T	A	10	7	17	0	0	17	0	0
14	26995773	.	G	A	9	14	23	0	0	23	0	0
14	26996299	.	C	A	12	5	17	0	2	19	0	0
14	26996301	.	A	T	12	5	17	0	1	18	0	0
14	26996363	.	A	C	6	2	8	0	1	9	0	0
14	26996543	.	A	C	12	9	21	0	0	21	0	0
14	26996709	.	C	T	6	2	8	0	0	8	0	0
14	26996738	.	C	T	7	3	10	0	0	10	0	0
14	26996851	.	A	T	5	8	13	0	0	13	0	0
14	26996926	.	T	A	6	5	11	0	0	11	0	0
14	26996954	.	G	C	9	6	15	0	0	15	0	0
14	26996974	.	A	C	8	5	13	0	1	14	0	0
14	26997003	.	G	A	8	6	14	0	0	14	0	0
14	26997143	.	C	A	7	2	9	0	0	9	0	0
14	26997192	.	A	T	12	4	16	1	0	17	0	0
14	26997208	.	A	G	14	4	18	1	0	19	0	0
14	26997387	.	C	T	7	2	9	0	0	9	0	0
14	26998140	.	G	A	2	3	5	0	0	5	0	0
14	26998507	.	G	A	7	5	12	0	0	12	0	0
14	26998520	.	G	A	5	2	7	0	0	7	0	0
14	26998605	.	C	T	1	12	13	0	7	20	0	0
14	26998828	.	A	T	6	3	9	0	0	9	0	0
14	26998961	.	T	G	1	8	9	0	0	9	0	0
14	26999437	.	G	A	1	2	3	0	0	3	0	0
14	27000158	.	T	C	3	0	3	0	4	7	0	0
14	27000602	.	A	G	2	4	6	0	0	6	0	0
14	27121828	.	G	A	1	3	4	0	0	4	0	0
14	27283114	.	G	A	1	2	3	0	0	3	0	0
14	27283150	.	C	T	2	2	4	0	0	4	0	0
14	27998855	.	A	T	18	6	24	1	1	26	0	0
14	27998856	.	A	G	16	5	21	1	4	26	0	0
14	27998933	.	T	A	34	21	55	1	1	57	0	0
14	27999236	.	A	T	16	18	34	0	3	37	0	0
14	27999252	.	C	T	24	18	42	0	3	45	0	0
14	27999422	.	G	T	21	32	53	0	1	54	0	0
14	27999471	.	C	T	30	15	45	1	6	52	0	0
14	27999591	.	G	A	25	16	41	0	0	41	0	0
14	28001696	.	G	A	17	16	33	0	2	35	0	0
14	28052187	.	G	A	5	2	7	0	1	8	0	0
14	28282150	.	G	A	0	3	3	0	1	4	0	0
14	28282528	.	A	G	4	3	7	0	0	7	0	0
14	28351739	.	C	T	6	3	9	0	0	9	0	0
14	28351793	.	C	T	3	2	5	0	1	6	0	0
14	28366021	.	A	G	5	3	8	0	4	12	0	0
14	28433011	.	T	C	14	14	28	0	1	29	0	0
14	28437306	.	A	G	10	2	12	0	0	12	0	0
14	28437309	.	T	C	9	1	10	0	0	10	0	0
14	28437343	.	T	A	6	3	9	0	0	9	0	0
14	28437362	.	A	G	5	4	9	0	0	9	0	0
14	28448811	.	A	T	2	7	9	0	1	10	0	0
14	28453158	.	T	C	7	12	19	0	1	20	0	0
14	28453257	.	A	C	2	3	5	0	0	5	0	0
14	28453269	.	C	T	2	6	8	0	0	8	0	0
14	28454613	.	A	T	7	16	23	0	0	23	0	0
14	28457968	.	G	A	1	13	14	0	18	32	0	0
14	28458175	.	G	A	9	14	23	0	1	24	0	0
14	28458270	.	T	C	14	18	32	0	0	32	0	0
14	28458345	.	G	A	0	17	17	0	9	26	0	0
14	28458456	.	C	A	11	8	19	0	1	20	0	0
14	28458974	.	A	G	5	8	13	0	1	14	0	0
14	28459292	.	G	C	2	12	14	0	14	28	0	0
14	28459324	.	T	A	12	18	30	0	0	30	0	0
14	28459613	.	T	A	2	3	5	0	0	5	0	0
14	28459664	.	A	G	3	5	8	0	0	8	0	0
14	28459703	.	C	A	0	6	6	0	3	9	0	0
14	28463736	.	A	G	1	1	2	0	1	3	0	0
14	28464895	.	T	A	6	2	8	0	0	8	0	0
14	28476731	.	C	A	2	3	5	0	0	5	0	0
14	28476977	.	C	T	3	4	7	0	0	7	0	0
14	28477115	.	A	G	6	4	10	0	3	13	0	0
14	28477384	.	C	T	4	3	7	0	0	7	0	0
14	28477400	.	A	G	5	0	5	0	4	9	0	0
14	28480476	.	A	G	6	7	13	0	0	13	0	0
14	28481362	.	C	T	5	7	12	0	0	12	0	0
14	28482808	.	C	T	9	14	23	1	0	24	0	0
14	28482883	.	G	A	6	5	11	0	3	14	0	0
14	28482920	.	G	A	8	10	18	0	0	18	0	0
14	28492984	.	C	T	1	2	3	0	1	4	0	0
14	28497705	.	C	T	3	4	7	0	0	7	0	0
14	28502783	.	C	T	4	7	11	0	0	11	0	0
14	28512717	.	C	T	4	4	8	0	2	10	0	0
14	28514328	.	C	G	4	2	6	0	0	7	1	0
14	28515941	.	C	T	13	8	21	0	1	22	0	0
14	28518305	.	G	A	0	15	15	0	16	31	0	0
14	28525002	.	A	C	9	4	13	0	0	13	0	0
14	28525353	.	C	T	10	11	21	0	1	22	0	0
14	28525367	.	G	A	14	14	28	0	1	29	0	0
14	28525948	.	C	T	13	4	17	0	1	18	0	0
14	28525969	.	A	G	11	5	16	0	0	16	0	0
14	28526046	.	C	T	16	9	25	0	1	26	0	0
14	28526815	.	G	T	14	14	28	0	1	29	0	0
14	28527130	.	T	G	12	10	22	0	1	23	0	0
14	29746497	.	A	G	1	2	3	0	0	3	0	0
14	29746533	.	A	G	3	2	5	0	1	6	0	0
14	29746716	.	T	C	3	3	6	0	0	6	0	0
14	29746740	.	G	A	1	3	4	0	4	8	0	0
14	29750758	.	C	T	5	8	13	0	0	13	0	0
14	29752254	.	G	A	2	2	4	0	0	4	0	0
14	29754477	.	C	A	1	3	4	0	0	4	0	0
14	29754762	.	C	A	4	5	9	0	0	9	0	0
14	29757958	.	A	T	12	13	25	0	1	26	0	0
14	29758103	.	C	T	13	9	22	0	0	22	0	0
14	29758333	.	G	A	1	16	17	0	13	30	0	0
14	29758526	.	T	C	13	11	24	0	2	26	0	0
14	29759439	.	A	T	1	4	5	0	1	6	0	0
14	29759570	.	A	T	5	6	11	0	0	11	0	0
14	29780229	.	C	A	2	2	4	0	0	4	0	0
14	29780244	.	G	A	2	2	4	0	0	4	0	0
14	29780782	.	T	C	5	2	7	0	0	7	0	0
14	29807562	.	T	C	7	6	13	0	0	13	0	0
14	29808109	.	C	A	3	8	11	0	1	12	0	0
14	29808195	.	G	A	10	5	15	0	2	17	0	0
14	29808222	.	G	A	13	6	19	0	0	19	0	0
14	29808251	.	C	A	14	7	21	0	0	21	0	0
14	29808436	.	T	C	2	6	8	0	0	8	0	0
14	29808473	.	C	T	6	6	12	1	2	15	0	0
14	29808743	.	C	T	1	6	7	0	6	13	0	0
14	29808785	.	C	A	2	4	6	0	13	19	0	0
14	29808812	.	T	C	17	8	25	0	0	25	0	0
14	29810430	.	C	T	11	8	19	0	1	20	0	0
14	29821164	.	G	A	4	5	9	0	0	9	0	0
14	29822513	.	T	A	8	4	12	0	0	12	0	0
14	29823306	.	C	T	7	5	12	0	0	12	0	0
14	29823375	.	G	T	4	6	10	0	0	10	0	0
14	29825265	.	T	C	1	6	7	0	0	7	0	0
14	29825412	.	C	T	1	2	3	0	1	4	0	0
14	29825421	.	T	A	1	3	4	0	0	4	0	0
14	29826029	.	C	T	4	3	7	0	0	7	0	0
14	29843189	.	C	G	0	2	2	0	3	5	0	0
14	30105929	.	C	T	2	3	5	0	0	5	0	0
14	30107800	.	C	A	1	3	4	0	0	4	0	0
14	30156943	.	T	A	5	3	8	0	0	8	0	0
14	30157026	.	G	A	6	4	10	0	3	13	0	0
14	30157030	.	A	T	6	8	14	0	0	14	0	0
14	30158168	.	C	T	1	2	3	0	4	7	0	0
14	30158174	.	C	T	3	3	6	0	0	6	0	0
14	30158323	.	G	A	1	2	3	0	0	3	0	0
14	30158352	.	G	A	2	3	5	0	0	5	0	0
14	30158365	.	A	G	3	2	5	0	0	5	0	0
14	30158495	.	C	T	0	3	3	0	3	6	0	0
14	30158528	.	T	C	1	4	5	0	0	5	0	0
14	30158869	.	G	T	4	2	6	0	0	6	0	0
14	30158875	.	A	G	2	4	6	0	0	6	0	0
14	30159210	.	T	C	1	2	3	0	0	3	0	0
14	30159536	.	C	T	2	6	8	0	0	8	0	0
14	30164041	.	C	T	1	3	4	0	0	4	0	0
14	30272965	.	C	A	2	2	4	0	0	4	0	0
14	30274044	.	A	C	0	2	2	0	0	2	0	0
14	30274051	.	A	T	1	2	3	0	0	3	0	0
14	30274274	.	T	A	3	3	6	0	0	6	0	0
14	30274282	.	A	T	3	3	6	0	0	6	0	0
14	30274548	.	G	T	0	4	4	0	1	5	0	0
14	30274620	.	G	A	1	2	3	0	2	5	0	0
14	30276294	.	A	G	3	6	9	0	0	9	0	0
14	30276438	.	A	C	3	5	8	0	1	9	0	0
14	30276522	.	A	G	3	0	3	0	2	5	0	0
14	30356616	.	A	T	3	2	5	0	0	5	0	0
14	30356947	.	T	A	5	2	7	0	0	7	0	0
14	30357204	.	C	T	2	5	7	0	1	8	0	0
14	30360991	.	G	A	4	5	9	0	0	9	0	0
14	30361051	.	A	G	3	5	8	0	1	9	0	0
14	30361057	.	C	T	4	6	10	0	0	10	0	0
14	30361275	.	G	A	4	3	7	0	0	7	0	0
14	30363022	.	C	G	2	2	4	0	0	4	0	0
14	30366107	.	A	G	2	3	5	0	0	5	0	0
14	30398618	.	G	A	1	5	6	0	1	7	0	0
14	30399386	.	G	T	2	4	6	0	0	6	0	0
14	30401100	.	C	T	4	2	6	0	0	6	0	0
14	30403613	.	T	C	5	2	7	0	0	7	0	0
14	30403716	.	T	C	3	4	7	0	0	7	0	0
14	30403813	.	A	G	5	5	10	0	0	10	0	0
14	30407577	.	G	C	1	4	5	0	5	10	0	0
14	30407638	.	C	A	8	9	17	0	0	17	0	0
14	30409289	.	C	T	5	8	13	0	0	13	0	0
14	30410882	.	G	A	0	8	8	0	7	15	0	0
14	30410911	.	G	A	7	4	11	0	2	13	0	0
14	30411143	.	C	T	10	4	14	0	1	15	0	0
14	30411292	.	T	C	13	9	22	0	1	23	0	0
14	30411707	.	C	T	2	2	4	0	0	4	0	0
14	30411724	.	T	C	2	2	4	0	1	5	0	0
14	30411825	.	G	A	13	7	20	0	1	21	0	0
14	30411895	.	T	A	1	3	4	0	2	6	0	0
14	30411937	.	A	G	1	3	4	0	0	4	0	0
14	30423734	.	A	G	1	3	4	0	0	4	0	0
14	30424342	.	G	C	0	2	2	0	2	4	0	0
14	30427551	.	A	G	2	3	5	0	0	5	0	0
14	30427682	.	T	C	4	3	7	0	0	7	0	0
14	30427688	.	A	G	5	3	8	0	0	8	0	0
14	30427834	.	G	A	4	6	10	0	2	12	0	0
14	30428031	.	C	T	3	3	6	0	2	8	0	0
14	30428319	.	A	G	4	6	10	1	1	12	0	0
14	30428322	.	A	G	5	5	10	1	1	12	0	0
14	30454527	.	C	T	0	10	10	0	5	15	0	0
14	30454651	.	T	A	5	3	8	0	0	8	0	0
14	30454917	.	C	T	1	7	8	0	9	17	0	0
14	30455029	.	C	A	6	2	8	0	0	8	0	0
14	30455121	.	C	T	4	11	15	0	0	15	0	0
14	30455134	.	T	A	4	11	15	0	0	15	0	0
14	30456201	.	A	T	1	3	4	0	0	4	0	0
14	30456373	.	T	G	7	8	15	0	4	19	0	0
14	30551452	.	A	T	8	6	14	0	3	17	0	0
14	30551488	.	C	T	10	9	19	0	0	19	0	0
14	30580906	.	A	G	6	6	12	0	1	13	0	0
14	30581000	.	A	C	5	0	5	0	5	10	0	0
14	30581152	.	G	A	5	6	11	0	0	11	0	0
14	30581245	.	A	T	5	4	9	0	0	9	0	0
14	30581308	.	C	T	1	5	6	0	8	14	0	0
14	30581329	.	C	A	6	6	12	0	2	14	0	0
14	30581485	.	C	T	1	6	7	0	4	11	0	0
14	30582003	.	G	A	6	2	8	0	1	9	0	0
14	30613469	.	C	A	18	16	34	0	1	35	0	0
14	30637988	.	C	T	4	24	28	0	28	56	0	0
14	30638071	.	G	A	25	22	47	0	1	48	0	0
14	30638087	.	G	A	29	22	51	0	2	53	0	0
14	30639165	.	A	G	29	17	46	0	2	48	0	0
14	30641256	.	G	A	14	12	26	0	1	27	0	0
14	30641872	.	A	G	11	16	27	0	2	29	0	0
14	30642594	.	T	G	6	6	12	0	1	13	0	0
14	30642618	.	G	A	8	10	18	0	0	18	0	0
14	30670041	.	T	A	1	3	4	0	0	4	0	0
14	30670049	.	T	G	1	2	3	0	0	3	0	0
14	30713964	.	T	C	27	22	49	0	0	49	0	0
14	30717305	.	T	C	12	9	21	0	1	22	0	0
14	30720073	.	T	C	7	0	7	0	12	19	0	0
14	30720354	.	C	T	2	6	8	0	9	17	0	0
14	30720399	.	C	T	1	3	4	0	8	12	0	0
14	30731175	.	G	T	2	8	10	0	7	17	0	0
14	30731849	.	A	C	8	3	11	0	3	14	0	0
14	30732064	.	C	G	9	12	21	0	2	23	0	0
14	30732136	.	C	G	18	12	30	0	1	31	0	0
14	30732229	.	T	C	15	15	30	0	2	32	0	0
14	30732899	.	C	T	9	5	14	0	3	17	0	0
14	30733237	.	T	G	14	1	15	0	24	39	0	0
14	30733279	.	C	A	12	15	27	0	1	28	0	0
14	30733411	.	A	G	14	15	29	0	0	29	0	0
14	30733779	.	G	A	0	11	11	0	13	24	0	0
14	30733990	.	T	C	24	14	38	0	1	39	0	0
14	30734215	.	A	T	12	23	35	0	1	36	0	0
14	30734221	.	A	G	13	0	13	0	24	37	0	0
14	30734295	.	A	G	16	17	33	0	7	40	0	0
14	30734347	.	A	G	22	25	47	0	0	47	0	0
14	30734389	.	A	T	24	18	42	0	2	44	0	0
14	30734390	.	T	A	24	17	41	0	3	44	0	0
14	30734516	.	T	C	29	22	51	0	0	51	0	0
14	30739687	.	T	C	2	2	4	0	0	4	0	0
14	30741117	.	G	T	1	2	3	0	0	3	0	0
14	30741118	.	T	G	0	2	2	0	1	3	0	0
14	30741299	.	G	A	1	2	3	0	2	5	0	0
14	30742071	.	G	A	2	2	4	0	0	4	0	0
14	30742260	.	G	A	2	2	4	0	0	4	0	0
14	30742265	.	T	G	2	2	4	0	0	4	0	0
14	30754639	.	T	G	3	0	3	0	2	5	0	0
14	30757309	.	C	T	5	4	9	0	1	10	0	0
14	30793048	.	A	C	2	2	4	0	1	5	0	0
14	30793472	.	C	T	3	6	9	0	1	10	0	0
14	30793842	.	C	T	2	2	4	0	0	4	0	0
14	30793858	.	G	A	0	1	1	0	2	3	0	0
14	30793925	.	C	G	3	4	7	0	1	8	0	0
14	30793941	.	A	C	3	3	6	0	0	6	0	0
14	30793962	.	A	G	3	4	7	0	0	7	0	0
14	30795633	.	T	C	27	24	51	0	3	54	0	0
14	30799000	.	T	C	36	26	62	0	2	64	0	0
14	30800809	.	A	C	40	23	63	0	4	67	0	0
14	30801043	.	C	A	36	35	71	0	1	72	0	0
14	30802958	.	G	A	6	2	8	0	0	8	0	0
14	30803026	.	G	A	5	3	8	0	0	8	0	0
14	30803058	.	C	A	1	3	4	0	4	8	0	0
14	30803247	.	T	G	5	5	10	0	2	12	0	0
14	30854710	.	A	T	23	26	49	0	3	52	0	0
14	30854808	.	G	A	21	2	23	0	8	31	0	0
14	30855117	.	A	C	31	24	55	0	2	57	0	0
14	30855218	.	A	G	27	18	45	0	3	48	0	0
14	30855303	.	C	T	2	14	16	0	22	38	0	0
14	30855668	.	A	T	22	15	37	0	2	39	0	0
14	30855973	.	T	G	13	8	21	0	1	22	0	0
14	30876422	.	A	C	11	8	19	0	1	20	0	0
14	30878226	.	T	G	3	1	4	0	0	4	0	0
14	30878587	.	G	A	11	3	14	0	0	14	0	0
14	30878604	.	C	T	8	3	11	0	1	12	0	0
14	30878707	.	C	A	4	3	7	0	1	8	0	0
14	30879257	.	T	C	1	0	1	0	3	4	0	0
14	30879274	.	T	G	0	4	4	0	0	4	0	0
14	30879343	.	C	T	2	8	10	0	0	10	0	0
14	30879389	.	T	C	5	5	10	0	0	10	0	0
14	30879392	.	A	G	5	4	9	0	1	10	0	0
14	30879573	.	C	T	2	2	4	0	0	4	0	0
14	30879619	.	A	G	4	2	6	0	1	7	0	0
14	30879620	.	A	C	4	3	7	0	0	7	0	0
14	30879698	.	T	A	2	2	4	0	0	4	0	0
14	30879736	.	T	C	2	3	5	0	1	6	0	0
14	30879778	.	T	C	4	2	6	0	0	6	0	0
14	30880248	.	T	G	9	3	12	0	0	12	0	0
14	30880361	.	A	G	9	4	13	0	0	13	0	0
14	30880534	.	A	G	1	2	3	0	0	3	0	0
14	30880645	.	A	G	4	3	7	0	0	7	0	0
14	30880817	.	A	G	11	3	14	0	1	15	0	0
14	30880846	.	T	C	5	3	8	0	2	10	0	0
14	30880916	.	T	C	1	0	1	0	2	3	0	0
14	30880918	.	A	G	1	2	3	0	0	3	0	0
14	30881073	.	A	T	4	2	6	0	0	6	0	0
14	30881219	.	C	T	3	2	5	0	0	5	0	0
14	30881327	.	A	G	3	3	6	0	0	6	0	0
14	30915268	.	C	T	3	6	9	0	0	9	0	0
14	30915322	.	G	A	3	3	6	0	0	6	0	0
14	30915608	.	T	A	4	5	9	0	1	10	0	0
14	30916113	.	A	G	1	0	1	0	2	3	0	0
14	30922349	.	T	C	9	7	16	0	0	16	0	0
14	30927355	.	C	G	2	4	6	0	0	6	0	0
14	30929601	.	C	T	4	7	11	0	0	11	0	0
14	30967732	.	C	T	0	4	4	0	6	10	0	0
14	30967975	.	T	G	4	2	6	0	0	6	0	0
14	30978589	.	G	T	17	11	28	0	2	30	0	0
14	30978700	.	T	C	22	14	36	0	4	40	0	0
14	30978706	.	G	A	25	14	39	0	1	40	0	0
14	30982248	.	T	C	19	1	20	0	11	31	0	0
14	30987702	.	T	A	15	13	28	0	1	29	0	0
14	30987930	.	G	A	13	29	42	0	1	43	0	0
14	30987985	.	A	G	21	18	39	0	1	40	0	0
14	30988627	.	A	G	15	10	25	0	2	27	0	0
14	30988664	.	C	T	8	7	15	0	1	16	0	0
14	30988707	.	T	G	3	11	14	0	1	15	0	0
14	30988817	.	C	T	2	3	5	0	1	6	0	0
14	30989292	.	C	G	0	7	7	0	4	11	0	0
14	30989908	.	A	G	10	4	14	0	2	16	0	0
14	30990321	.	T	A	7	9	16	0	0	16	0	0
14	30991272	.	C	T	1	4	5	0	7	12	0	0
14	30992515	.	A	T	1	3	4	0	0	4	0	0
14	30992593	.	A	G	2	3	5	0	1	6	0	0
14	31014047	.	G	A	4	5	9	0	0	9	0	0
14	31014113	.	T	A	4	8	12	0	1	13	0	0
14	31024053	.	A	G	3	4	7	0	0	7	0	0
14	31024077	.	C	A	3	4	7	0	0	7	0	0
14	31082249	.	C	T	6	4	10	0	0	10	0	0
14	31082400	.	T	C	7	6	13	0	1	14	0	0
14	31082501	.	T	G	5	5	10	0	0	10	0	0
14	31082519	.	C	T	1	4	5	0	7	12	0	0
14	31082569	.	C	T	8	5	13	0	2	15	0	0
14	31082857	.	C	T	8	11	19	0	0	19	0	0
14	31082975	.	A	G	8	5	13	0	1	14	0	0
14	31083110	.	C	A	10	9	19	0	0	19	0	0
14	31083227	.	G	A	9	10	19	0	0	19	0	0
14	31083242	.	C	A	1	8	9	0	11	20	0	0
14	31087245	.	T	A	5	3	8	0	0	8	0	0
14	31090259	.	C	T	5	5	10	0	0	10	0	0
14	31090339	.	C	T	7	7	14	0	1	15	0	0
14	31092483	.	C	A	6	3	9	0	0	9	0	0
14	31092489	.	T	G	5	3	8	0	0	8	0	0
14	31177220	.	T	C	3	3	6	0	1	7	0	0
14	31478767	.	G	A	3	1	4	0	1	5	0	0
14	31478929	.	A	G	2	2	4	0	0	4	0	0
14	31493317	.	C	T	2	6	8	0	0	8	0	0
14	31497559	.	C	T	8	3	11	0	1	12	0	0
14	31498413	.	T	C	4	10	14	0	0	14	0	0
14	31507444	.	G	A	12	6	18	0	0	18	0	0
14	31507476	.	A	G	11	0	11	0	5	16	0	0
14	31509944	.	C	G	2	2	4	0	0	4	0	0
14	31510055	.	G	A	0	4	4	0	3	7	0	0
14	31516506	.	A	G	2	9	11	0	0	11	0	0
14	31516509	.	G	A	0	9	9	0	2	11	0	0
14	31519018	.	A	C	5	3	8	0	1	9	0	0
14	31519051	.	A	G	6	3	9	0	0	9	0	0
14	31519340	.	G	A	8	7	15	0	1	16	0	0
14	31519616	.	A	T	1	2	3	0	0	3	0	0
14	31519730	.	T	A	8	11	19	0	0	19	0	0
14	31519777	.	T	A	5	8	13	0	1	15	1	0
14	31519948	.	T	C	11	10	21	0	0	21	0	0
14	31520295	.	C	G	2	4	6	0	1	7	0	0
14	31520316	.	G	A	7	4	11	0	1	12	0	0
14	31520336	.	A	G	8	0	8	0	3	11	0	0
14	31520371	.	A	T	10	4	14	0	1	15	0	0
14	31520483	.	T	C	12	21	33	0	0	33	0	0
14	31520555	.	T	C	6	14	20	0	0	20	0	0
14	31520626	.	A	T	4	8	12	0	0	12	0	0
14	31521442	.	G	A	0	5	5	0	1	6	0	0
14	31521446	.	T	C	1	5	6	0	0	6	0	0
14	31530186	.	A	G	5	5	10	0	2	12	0	0
14	31530350	.	A	G	6	9	15	0	0	15	0	0
14	31530388	.	T	C	9	8	17	0	0	17	0	0
14	31530421	.	G	A	7	5	12	0	1	13	0	0
14	31541318	.	C	T	23	14	37	0	2	39	0	0
14	31544922	.	A	T	11	13	24	0	5	29	0	0
14	31544947	.	C	T	10	14	24	0	0	24	0	0
14	31546470	.	A	T	7	10	17	0	0	17	0	0
14	31546493	.	A	G	8	1	9	0	8	17	0	0
14	31556263	.	T	C	7	17	24	0	0	24	0	0
14	31556344	.	A	G	10	15	25	0	2	27	0	0
14	31558943	.	A	G	8	7	15	0	3	18	0	0
14	31559000	.	T	G	14	11	25	0	1	26	0	0
14	31559062	.	A	G	11	7	18	0	0	18	0	0
14	31562713	.	G	A	14	10	24	0	1	25	0	0
14	31603318	.	A	C	3	2	5	0	1	6	0	0
14	31603320	.	G	A	3	2	5	0	1	6	0	0
14	31605874	.	A	G	2	2	4	0	1	5	0	0
14	31607897	.	A	G	4	3	7	0	0	7	0	0
14	31608076	.	G	T	5	3	8	0	0	8	0	0
14	31616186	.	C	T	10	11	21	0	0	21	0	0
14	31635358	.	T	C	0	2	2	0	1	3	0	0
14	31636382	.	T	C	6	2	8	0	0	8	0	0
14	31641769	.	C	T	3	8	11	0	0	11	0	0
14	31642712	.	C	T	2	2	4	0	0	4	0	0
14	31642965	.	A	T	3	5	8	0	1	9	0	0
14	31642991	.	C	T	2	5	7	0	0	7	0	0
14	31643411	.	A	T	2	2	4	0	1	5	0	0
14	31643645	.	A	C	3	4	7	0	0	7	0	0
14	31643749	.	C	A	3	4	7	0	2	9	0	0
14	31643781	.	A	G	4	11	15	0	0	15	0	0
14	31644218	.	T	C	12	10	22	0	1	23	0	0
14	31644229	.	C	G	12	0	12	0	12	24	0	0
14	31644488	.	T	C	11	3	14	0	0	14	0	0
14	31644542	.	C	T	6	2	8	0	0	8	0	0
14	31644805	.	C	T	5	3	8	0	1	9	0	0
14	31645022	.	C	T	1	2	3	0	3	6	0	0
14	31645082	.	A	G	9	7	16	0	1	17	0	0
14	31645473	.	C	G	6	6	12	0	1	13	0	0
14	31645683	.	A	T	6	5	11	0	0	11	0	0
14	31645962	.	A	G	8	5	13	0	0	13	0	0
14	31645989	.	T	A	6	3	9	0	0	9	0	0
14	31646039	.	C	A	7	7	14	0	0	14	0	0
14	31646486	.	A	T	5	2	7	0	1	8	0	0
14	31646650	.	A	G	8	0	8	0	12	20	0	0
14	31646655	.	T	C	7	12	19	0	1	20	0	0
14	31646869	.	A	G	9	8	17	0	0	17	0	0
14	31647135	.	A	T	11	11	22	0	0	22	0	0
14	31647217	.	A	G	20	6	26	0	2	28	0	0
14	31647291	.	G	C	12	9	21	0	2	23	0	0
14	31647335	.	G	T	14	15	29	0	0	29	0	0
14	31647682	.	A	G	13	5	18	0	1	19	0	0
14	31647730	.	T	C	11	10	21	0	0	21	0	0
14	31647829	.	C	A	8	6	14	0	1	15	0	0
14	31668859	.	T	A	15	7	22	0	1	23	0	0
14	31669304	.	C	A	9	6	15	0	0	15	0	0
14	31669551	.	T	C	4	14	18	0	0	18	0	0
14	31669558	.	C	A	4	13	17	0	0	17	0	0
14	31673775	.	A	G	4	4	8	0	1	9	0	0
14	31675852	.	G	T	3	6	9	0	0	9	0	0
14	31682168	.	T	C	1	2	3	0	0	3	0	0
14	31800369	.	T	C	5	0	5	0	7	12	0	0
14	31800371	.	A	G	5	7	12	0	0	12	0	0
14	31800589	.	G	A	12	8	20	0	1	21	0	0
14	31800875	.	G	A	8	3	11	0	0	11	0	0
14	31801196	.	G	A	5	3	8	0	0	8	0	0
14	31801428	.	C	G	6	8	14	0	0	14	0	0
14	31801454	.	C	T	0	9	9	0	6	15	0	0
14	31801483	.	A	G	5	7	12	0	0	12	0	0
14	31801904	.	A	G	5	10	15	0	1	16	0	0
14	31801979	.	T	C	8	4	12	0	1	13	0	0
14	31802156	.	T	C	3	3	6	0	0	6	0	0
14	31802443	.	A	G	1	7	8	0	1	9	0	0
14	31803044	.	C	A	1	3	4	0	0	4	0	0
14	31803150	.	T	C	1	2	3	0	0	3	0	0
14	31814000	.	C	G	5	3	8	0	0	8	0	0
14	31856891	.	G	T	12	11	23	0	3	26	0	0
14	31857773	.	T	A	17	14	31	0	1	32	0	0
14	31858123	.	G	A	21	23	44	0	1	45	0	0
14	31858492	.	T	G	11	11	22	0	0	22	0	0
14	31860525	.	C	T	16	17	33	1	4	38	0	0
14	31861179	.	A	G	7	8	15	0	0	15	0	0
14	31875637	.	T	C	1	2	3	0	1	4	0	0
14	31881740	.	A	G	3	4	7	0	1	8	0	0
14	31881791	.	G	T	1	3	4	0	0	4	0	0
14	31882246	.	G	T	1	5	6	0	2	9	1	0
14	31882481	.	A	G	1	0	1	0	4	5	0	0
14	31882507	.	T	C	3	2	5	0	0	5	0	0
14	31882587	.	T	C	5	2	7	0	0	7	0	0
14	31882709	.	A	T	4	5	9	0	0	9	0	0
14	31882714	.	A	T	5	5	10	1	0	11	0	0
14	31882817	.	T	A	3	2	5	0	0	5	0	0
14	31883188	.	A	T	4	1	5	0	2	7	0	0
14	31883426	.	C	T	3	3	6	0	0	6	0	0
14	31883472	.	A	C	3	2	5	0	1	6	0	0
14	31883475	.	A	T	3	4	7	0	0	7	0	0
14	31883735	.	G	A	2	4	6	0	7	13	0	0
14	31890748	.	T	C	4	0	4	0	4	8	0	0
14	31890817	.	G	A	6	4	10	0	0	10	0	0
14	31893726	.	C	G	1	3	4	0	0	4	0	0
14	31973439	.	C	T	3	2	5	0	0	5	0	0
14	31973448	.	T	C	2	2	4	0	1	5	0	0
14	32011834	.	C	A	18	10	28	0	1	29	0	0
14	32011929	.	C	G	0	20	20	0	14	34	0	0
14	32011993	.	T	C	7	18	25	0	4	29	0	0
14	32013167	.	C	A	0	8	8	0	8	16	0	0
14	32025140	.	A	T	7	9	16	0	0	16	0	0
14	32025381	.	T	C	6	6	12	1	0	13	0	0
14	32025732	.	G	T	5	2	7	0	0	7	0	0
14	32184937	.	C	T	21	15	36	0	2	38	0	0
14	32185199	.	A	G	12	15	27	0	0	27	0	0
14	32185374	.	C	T	6	12	18	0	1	19	0	0
14	32254558	.	C	T	4	5	9	0	0	9	0	0
14	32254770	.	C	T	3	4	7	0	1	8	0	0
14	32255068	.	G	T	3	3	6	0	0	6	0	0
14	32255124	.	C	T	2	2	4	0	1	5	0	0
14	32403594	.	G	C	3	8	11	0	2	13	0	0
14	32443552	.	T	A	8	10	18	0	2	20	0	0
14	32443572	.	A	C	7	11	18	0	3	21	0	0
14	32443696	.	A	G	18	14	32	0	2	35	1	0
14	32443727	.	C	T	2	11	13	0	15	28	0	0
14	32443734	.	A	T	15	9	24	0	0	24	0	0
14	32443841	.	A	T	11	6	17	0	1	18	0	0
14	32444064	.	C	G	18	13	31	0	1	32	0	0
14	32444114	.	C	G	9	10	19	0	3	22	0	0
14	32444121	.	C	T	8	12	20	0	2	22	0	0
14	32444392	.	C	T	4	7	11	0	1	12	0	0
14	32444614	.	G	A	13	6	19	0	0	19	0	0
14	32444615	.	T	C	14	4	18	0	2	20	0	0
14	32444651	.	G	A	15	4	19	0	0	19	0	0
14	32444854	.	G	T	12	10	22	0	2	24	0	0
14	32444878	.	C	A	9	10	19	0	1	20	0	0
14	32447862	.	G	A	7	7	14	0	0	14	0	0
14	32447915	.	T	C	8	0	8	0	5	13	0	0
14	32448068	.	T	C	3	9	12	0	0	12	0	0
14	32507833	.	T	C	5	0	5	0	4	9	0	0
14	32524195	.	C	T	1	2	3	0	0	3	0	0
14	32742955	.	A	T	9	3	12	0	1	13	0	0
14	32743736	.	G	A	7	5	12	0	0	12	0	0
14	32857002	.	C	T	7	6	13	0	0	13	0	0
14	32857704	.	G	A	0	7	7	0	0	7	0	0
14	32857812	.	A	C	7	7	14	0	1	15	0	0
14	32858004	.	G	C	1	11	12	0	15	27	0	0
14	32858012	.	C	T	15	14	29	0	0	29	0	0
14	32858080	.	C	A	12	10	22	0	1	23	0	0
14	32858244	.	T	C	13	12	25	0	2	27	0	0
14	32858364	.	C	T	5	19	24	0	0	24	0	0
14	32858570	.	C	T	12	14	26	0	0	26	0	0
14	32858578	.	C	G	13	12	25	0	0	25	0	0
14	32858638	.	G	A	7	11	18	0	1	19	0	0
14	32858701	.	C	T	9	13	22	0	0	22	0	0
14	32859554	.	C	T	11	15	26	0	0	26	0	0
14	32859908	.	G	T	9	13	22	1	0	23	0	0
14	32860345	.	A	G	12	4	16	0	1	17	0	0
14	32860374	.	T	C	8	0	8	0	12	20	0	0
14	32860434	.	C	T	7	10	17	0	4	21	0	0
14	32860692	.	T	A	17	18	35	0	2	37	0	0
14	32860704	.	G	A	16	17	33	0	2	35	0	0
14	32865916	.	G	A	9	4	13	0	0	13	0	0
14	32866234	.	C	T	10	3	13	0	0	13	0	0
14	32884065	.	C	T	1	11	12	0	9	21	0	0
14	32884876	.	T	C	2	0	2	0	2	4	0	0
14	32885319	.	T	A	4	5	9	0	0	9	0	0
14	32885453	.	G	T	3	2	5	0	0	5	0	0
14	32952043	.	C	T	2	7	9	0	0	9	0	0
14	32952148	.	C	T	1	8	9	0	0	9	0	0
14	32952180	.	T	A	5	5	10	0	0	10	0	0
14	32952312	.	A	T	4	5	9	0	1	10	0	0
14	32952576	.	C	T	8	7	15	0	1	16	0	0
14	32952665	.	C	T	0	4	4	0	10	14	0	0
14	32952857	.	T	A	5	3	8	0	0	8	0	0
14	32984047	.	G	A	4	4	8	0	1	9	0	0
14	32984084	.	G	A	4	5	9	0	0	9	0	0
14	32984128	.	C	A	9	9	18	0	1	19	0	0
14	32984414	.	G	T	3	4	7	0	0	7	0	0
14	32984627	.	C	G	2	2	4	0	0	4	0	0
14	33070588	.	C	A	5	17	22	0	31	57	4	0
14	33071522	.	A	G	23	16	39	0	4	43	0	0
14	33071814	.	G	A	19	14	33	0	0	33	0	0
14	33073954	.	G	A	20	20	40	0	2	42	0	0
14	33120461	.	G	A	11	3	14	0	0	14	0	0
14	33177681	.	A	G	6	6	12	0	0	12	0	0
14	33177949	.	G	C	6	0	6	0	8	14	0	0
14	33220216	.	A	G	1	7	8	0	0	8	0	0
14	33220710	.	C	T	2	2	4	0	0	4	0	0
14	33221349	.	C	T	2	5	7	0	0	7	0	0
14	33267946	.	T	C	13	17	30	0	0	30	0	0
14	33268211	.	T	A	10	7	17	0	0	17	0	0
14	33268330	.	C	A	9	8	17	0	2	19	0	0
14	33281240	.	T	A	31	28	59	0	2	61	0	0
14	33281777	.	C	T	7	8	15	0	27	42	0	0
14	33282050	.	C	T	28	17	45	0	6	51	0	0
14	33282119	.	A	G	28	33	61	0	4	65	0	0
14	33282245	.	A	T	25	22	47	0	1	48	0	0
14	33282246	.	A	C	24	19	43	0	5	48	0	0
14	33282347	.	C	T	2	28	30	0	26	56	0	0
14	33292079	.	A	G	14	11	25	0	1	26	0	0
14	33298637	.	C	T	23	22	45	0	0	45	0	0
14	33299087	.	T	C	27	9	36	0	0	36	0	0
14	33302331	.	G	A	3	4	7	0	0	7	0	0
14	33302380	.	T	C	2	0	2	0	3	5	0	0
14	33302745	.	T	C	6	2	8	0	0	8	0	0
14	33306505	.	C	T	24	17	41	0	3	44	0	0
14	33306583	.	T	C	19	20	39	0	2	41	0	0
14	33314102	.	G	A	28	16	44	0	0	44	0	0
14	33316828	.	A	G	11	10	21	0	1	22	0	0
14	33339531	.	T	A	7	2	9	0	1	10	0	0
14	33339617	.	C	T	11	3	14	0	0	14	0	0
14	33340099	.	C	T	9	7	16	0	0	16	0	0
14	33344536	.	T	G	6	6	12	0	0	12	0	0
14	33414168	.	C	T	39	41	80	0	1	81	0	0
14	33414885	.	C	T	13	18	31	0	2	33	0	0
14	33414894	.	C	T	14	15	29	0	3	32	0	0
14	33415120	.	G	C	1	11	12	0	7	19	0	0
14	33415210	.	A	G	15	10	25	0	0	25	0	0
14	33415337	.	C	T	10	8	18	0	0	18	0	0
14	33415410	.	T	G	8	1	9	0	4	13	0	0
14	33418525	.	G	C	9	7	16	0	0	16	0	0
14	33418766	.	A	G	15	18	33	0	1	34	0	0
14	33423037	.	C	T	11	15	26	0	1	27	0	0
14	33424854	.	A	C	24	2	26	0	25	51	0	0
14	33424869	.	C	T	25	21	46	0	2	48	0	0
14	33425008	.	A	T	17	15	32	0	0	32	0	0
14	33425013	.	C	T	2	13	15	0	16	31	0	0
14	33431674	.	G	A	1	3	4	0	0	4	0	0
14	33434218	.	G	A	1	4	5	0	0	5	0	0
14	33434536	.	C	T	3	3	6	0	0	6	0	0
14	33434902	.	A	G	2	3	5	0	0	5	0	0
14	33434976	.	T	C	2	2	4	0	0	4	0	0
14	33435231	.	G	A	5	4	9	0	0	9	0	0
14	33435306	.	T	G	7	9	16	0	2	18	0	0
14	33435311	.	A	G	6	9	15	0	0	15	0	0
14	33435384	.	G	A	8	10	18	0	0	18	0	0
14	33435460	.	G	T	8	9	17	0	2	19	0	0
14	33435540	.	T	A	9	10	19	0	1	20	0	0
14	33435573	.	T	A	4	10	14	0	1	15	0	0
14	33435598	.	C	T	3	11	14	0	1	15	0	0
14	33435686	.	T	C	7	8	15	0	0	15	0	0
14	33435714	.	G	A	4	4	8	0	0	8	0	0
14	33435893	.	C	T	1	10	11	0	3	14	0	0
14	33435916	.	T	G	5	14	19	0	0	19	0	0
14	33435948	.	G	A	10	9	19	0	0	19	0	0
14	33435967	.	C	T	10	6	16	0	0	16	0	0
14	33436091	.	A	T	16	18	34	0	1	35	0	0
14	33436311	.	A	G	23	19	42	0	9	51	0	0
14	33436650	.	A	T	11	16	27	0	3	30	0	0
14	33437248	.	C	T	17	21	38	0	1	39	0	0
14	33437262	.	T	G	21	24	45	0	2	47	0	0
14	33441928	.	C	T	16	19	35	0	3	38	0	0
14	33442006	.	A	G	20	24	44	0	3	47	0	0
14	33442066	.	T	C	18	14	32	0	1	33	0	0
14	33454561	.	T	C	12	0	12	0	6	18	0	0
14	33454570	.	C	T	1	7	8	0	10	18	0	0
14	33465057	.	A	G	3	4	7	0	0	7	0	0
14	33465603	.	C	T	14	7	21	0	0	21	0	0
14	33469026	.	C	A	22	20	42	0	2	44	0	0
14	33469094	.	T	A	31	23	54	0	0	55	1	0
14	33469177	.	C	A	21	13	34	0	2	36	0	0
14	33469180	.	A	G	21	0	21	0	15	36	0	0
14	33469241	.	A	G	17	0	17	0	13	30	0	0
14	33469281	.	G	A	14	16	30	0	2	32	0	0
14	33469419	.	G	A	0	2	2	1	10	13	0	0
14	33469609	.	C	T	9	9	18	0	1	19	0	0
14	33474168	.	G	A	2	5	7	0	0	7	0	0
14	33474221	.	T	C	3	0	3	0	5	8	0	0
14	33474230	.	T	C	3	5	8	0	0	8	0	0
14	33474745	.	T	C	16	0	16	0	12	28	0	0
14	33474762	.	G	C	14	8	22	0	1	23	0	0
14	33474809	.	T	C	6	0	6	0	13	19	0	0
14	33474869	.	A	C	11	0	11	0	8	19	0	0
14	33475273	.	G	C	7	4	11	0	1	12	0	0
14	33475767	.	C	T	4	3	7	0	0	7	0	0
14	33486539	.	A	C	3	4	7	0	1	8	0	0
14	33486543	.	C	G	4	4	8	0	0	8	0	0
14	33499239	.	A	T	8	9	17	0	1	18	0	0
14	33501772	.	C	A	14	5	19	0	0	19	0	0
14	33501922	.	A	G	12	8	20	0	0	20	0	0
14	33504572	.	A	G	15	9	24	0	1	25	0	0
14	33505058	.	A	G	18	0	18	0	12	30	0	0
14	33505500	.	A	C	10	19	29	0	4	33	0	0
14	33507743	.	C	T	10	10	20	0	3	23	0	0
14	33554764	.	C	T	4	3	7	0	1	8	0	0
14	33557503	.	C	A	2	3	5	0	1	6	0	0
14	33557521	.	C	T	4	5	9	0	0	9	0	0
14	33562482	.	C	T	10	16	26	0	0	26	0	0
14	33562504	.	G	C	14	14	28	0	0	28	0	0
14	33564955	.	C	T	12	10	22	0	1	23	0	0
14	33564956	.	T	G	12	11	23	0	1	24	0	0
14	33564994	.	A	G	13	7	20	0	2	22	0	0
14	33565054	.	C	A	7	8	15	0	2	17	0	0
14	33565153	.	T	C	8	12	20	0	1	21	0	0
14	33565170	.	C	T	9	12	21	0	2	23	0	0
14	33565209	.	C	T	4	12	16	0	1	17	0	0
14	33565275	.	C	A	17	10	27	0	0	27	0	0
14	33565296	.	C	A	15	11	26	0	0	26	0	0
14	33565477	.	G	T	7	10	17	0	3	20	0	0
14	33565665	.	T	C	13	15	28	0	0	28	0	0
14	33565675	.	T	G	8	4	12	0	2	14	0	0
14	33565794	.	A	C	13	4	17	0	2	19	0	0
14	33565797	.	T	G	12	0	12	0	5	17	0	0
14	33566052	.	G	T	12	5	17	0	0	17	0	0
14	33566058	.	A	C	10	3	13	0	1	14	0	0
14	33566128	.	A	G	10	4	14	0	0	14	0	0
14	33566151	.	A	G	9	3	12	0	0	12	0	0
14	33566515	.	G	A	1	15	16	0	11	27	0	0
14	33566617	.	C	T	8	10	18	0	0	18	0	0
14	33566651	.	A	G	11	11	22	0	1	23	0	0
14	33566744	.	G	T	18	9	27	0	2	29	0	0
14	33567023	.	T	A	14	11	25	0	1	26	0	0
14	33567024	.	T	A	13	12	25	0	1	26	0	0
14	33569124	.	A	G	1	1	2	0	1	3	0	0
14	33591985	.	T	A	7	2	9	0	0	9	0	0
14	33744608	.	T	C	5	8	13	0	0	13	0	0
14	33754000	.	C	T	8	4	12	0	1	13	0	0
14	33754476	.	G	A	2	4	6	0	9	15	0	0
14	33754581	.	C	T	6	7	13	0	0	13	0	0
14	33754587	.	C	T	8	7	15	0	0	15	0	0
14	33754710	.	T	G	5	12	17	0	1	18	0	0
14	33754766	.	T	C	9	14	23	0	0	23	0	0
14	33754793	.	T	A	15	11	26	0	1	27	0	0
14	33755394	.	A	C	8	8	16	0	1	17	0	0
14	33755590	.	T	C	9	13	22	0	2	24	0	0
14	33757169	.	A	C	23	29	52	0	2	54	0	0
14	33791135	.	A	G	2	2	4	0	0	4	0	0
14	33826267	.	A	T	10	8	18	0	2	20	0	0
14	33826305	.	G	A	17	7	24	0	0	24	0	0
14	33826371	.	T	C	5	12	17	0	4	21	0	0
14	33826385	.	A	G	5	11	16	0	3	19	0	0
14	33826453	.	G	A	7	13	20	0	1	21	0	0
14	33826580	.	T	A	7	12	19	0	0	19	0	0
14	33827170	.	T	C	5	9	14	0	3	17	0	0
14	33827188	.	C	T	8	10	18	0	1	19	0	0
14	33827345	.	T	C	3	5	8	1	0	9	0	0
14	33827434	.	T	C	5	3	8	0	1	9	0	0
14	33827584	.	C	G	4	7	11	0	2	13	0	0
14	33827698	.	A	T	5	5	10	0	1	11	0	0
14	33827732	.	C	A	8	4	12	0	1	13	0	0
14	33828002	.	C	T	0	6	6	0	3	9	0	0
14	33828777	.	C	A	5	3	8	0	0	8	0	0
14	33836543	.	A	G	2	3	5	0	1	6	0	0
14	33836567	.	T	C	4	2	6	0	0	6	0	0
14	33860183	.	G	C	2	8	10	0	0	10	0	0
14	33860250	.	T	A	11	8	19	0	2	21	0	0
14	33860262	.	C	T	2	12	14	0	12	26	0	0
14	33860480	.	C	G	25	20	45	0	0	45	0	0
14	33860567	.	C	A	15	21	36	0	5	41	0	0
14	33865704	.	A	G	15	8	23	0	0	23	0	0
14	33865764	.	C	T	11	12	23	0	3	26	0	0
14	33868606	.	G	A	9	9	18	0	0	18	0	0
14	33868723	.	G	A	10	15	25	0	3	28	0	0
14	33872095	.	G	C	1	3	4	0	0	4	0	0
14	33883090	.	T	G	3	3	6	0	0	6	0	0
14	33883098	.	C	T	3	3	6	0	0	6	0	0
14	33889544	.	T	C	4	2	6	0	0	6	0	0
14	33891229	.	G	A	9	12	21	0	2	23	0	0
14	33891981	.	A	T	6	4	10	0	0	10	0	0
14	33892044	.	A	T	8	6	14	0	0	14	0	0
14	33892126	.	A	T	10	13	23	0	1	24	0	0
14	33892153	.	T	C	15	11	26	0	0	26	0	0
14	33892441	.	C	G	2	9	11	0	0	11	0	0
14	33899145	.	T	A	3	8	11	0	1	12	0	0
14	33899629	.	C	T	23	18	41	0	5	46	0	0
14	33899674	.	T	C	23	1	24	0	19	43	0	0
14	33899705	.	T	C	15	9	24	0	5	29	0	0
14	33899786	.	G	A	15	12	27	0	5	32	0	0
14	33899912	.	C	A	2	17	19	0	22	41	0	0
14	33900155	.	T	C	24	0	24	0	14	38	0	0
14	33900229	.	C	A	11	11	22	0	0	22	0	0
14	33900552	.	A	T	23	17	40	0	0	40	0	0
14	33900575	.	A	T	19	16	35	0	2	37	0	0
14	33900611	.	G	A	20	20	40	0	0	40	0	0
14	33900663	.	T	A	21	17	38	0	0	38	0	0
14	33900955	.	A	T	6	15	21	1	0	22	0	0
14	33901129	.	C	T	17	12	29	4	1	34	0	0
14	33901217	.	T	A	13	4	17	1	0	18	0	0
14	33901221	.	T	C	10	3	13	1	2	16	0	0
14	33901293	.	A	C	11	17	28	0	0	28	0	0
14	33901445	.	T	G	7	8	15	0	0	15	0	0
14	33901493	.	G	A	2	3	5	0	0	5	0	0
14	33901496	.	A	T	2	2	4	0	0	4	0	0
14	33901704	.	G	A	20	8	28	0	0	28	0	0
14	33901766	.	G	C	25	11	36	0	1	37	0	0
14	33901790	.	C	G	2	11	13	0	17	30	0	0
14	33901807	.	A	G	17	11	28	0	2	30	0	0
14	33901865	.	C	A	15	7	22	0	3	25	0	0
14	33901907	.	G	A	13	12	25	0	2	27	0	0
14	33901946	.	A	T	13	12	25	0	2	27	0	0
14	33901957	.	C	A	16	11	27	0	2	29	0	0
14	33901993	.	G	A	10	10	20	0	1	21	0	0
14	33902094	.	G	A	16	10	26	0	0	26	0	0
14	33903006	.	C	A	12	12	24	0	3	27	0	0
14	33903090	.	G	A	9	10	19	0	0	19	0	0
14	33909978	.	C	T	10	7	17	0	2	19	0	0
14	33910014	.	T	A	8	8	16	0	0	16	0	0
14	33916050	.	A	G	4	10	14	0	0	15	1	0
14	33916539	.	G	A	11	4	15	0	2	17	0	0
14	33916671	.	C	T	0	12	12	0	10	22	0	0
14	33916861	.	G	A	10	5	15	0	1	16	0	0
14	33936366	.	A	T	2	11	13	0	0	13	0	0
14	33941169	.	G	A	3	5	8	0	1	9	0	0
14	33941274	.	T	C	5	8	13	0	0	13	0	0
14	33941436	.	C	T	0	8	8	0	3	11	0	0
14	33943652	.	G	A	1	2	3	0	0	3	0	0
14	33983741	.	G	T	19	8	27	2	0	29	0	0
14	33983904	.	T	C	25	26	51	0	3	54	0	0
14	33983966	.	G	A	17	38	55	0	2	57	0	0
14	33984300	.	A	G	17	12	29	0	9	38	0	0
14	33984402	.	G	A	12	15	27	1	1	29	0	0
14	33984436	.	A	T	3	10	13	0	0	13	0	0
14	33984610	.	A	G	25	29	54	1	1	56	0	0
14	33989580	.	G	A	28	15	43	0	2	45	0	0
14	33991784	.	G	A	9	17	26	1	1	28	0	0
14	33991799	.	G	T	11	13	24	1	0	25	0	0
14	33997606	.	G	A	6	6	12	0	1	13	0	0
14	33997861	.	A	G	7	3	10	0	0	10	0	0
14	33997873	.	G	A	7	6	13	0	0	13	0	0
14	33998078	.	G	A	6	4	10	0	0	10	0	0
14	33998156	.	A	G	6	7	13	0	2	15	0	0
14	34002325	.	G	A	2	5	7	0	2	9	0	0
14	34002547	.	A	G	2	3	5	0	0	5	0	0
14	34002571	.	T	A	4	3	7	0	0	7	0	0
14	34003447	.	G	A	5	2	7	0	0	7	0	0
14	34064313	.	C	T	3	2	5	0	0	5	0	0
14	34064371	.	A	T	8	4	12	0	0	12	0	0
14	34065115	.	A	T	9	7	16	0	1	17	0	0
14	34065178	.	G	A	6	4	10	0	1	11	0	0
14	34065290	.	T	C	9	10	19	0	0	19	0	0
14	34065454	.	G	A	12	11	23	1	0	24	0	0
14	34065568	.	C	G	6	2	8	0	9	17	0	0
14	34065586	.	G	A	11	5	16	0	0	16	0	0
14	34065879	.	G	A	3	3	6	0	0	6	0	0
14	34068110	.	A	G	4	5	9	0	1	10	0	0
14	34068458	.	C	T	4	2	6	0	0	6	0	0
14	34075094	.	T	G	3	0	3	0	11	14	0	0
14	34077401	.	C	A	5	13	18	0	1	19	0	0
14	34077406	.	A	T	11	6	17	0	1	18	0	0
14	34079322	.	C	T	14	8	22	0	1	23	0	0
14	34079362	.	G	A	11	7	18	0	0	18	0	0
14	34082287	.	G	A	9	8	17	0	1	18	0	0
14	34082311	.	G	A	9	12	21	0	1	22	0	0
14	34082628	.	C	A	5	7	12	0	1	13	0	0
14	34082694	.	T	A	12	5	17	0	0	17	0	0
14	34089653	.	G	A	8	12	20	0	0	20	0	0
14	34089676	.	C	T	7	13	20	0	2	22	0	0
14	34089707	.	T	C	6	8	14	0	1	15	0	0
14	34089864	.	C	T	9	8	17	0	0	17	0	0
14	34089900	.	G	A	10	6	16	0	0	16	0	0
14	34089941	.	A	G	11	8	19	0	0	19	0	0
14	34090001	.	G	T	0	3	3	0	12	15	0	0
14	34090169	.	T	C	7	8	15	0	1	16	0	0
14	34090248	.	C	G	6	9	15	1	1	17	0	0
14	34090342	.	G	A	14	5	19	0	1	20	0	0
14	34090422	.	A	G	6	3	9	0	0	9	0	0
14	34091123	.	G	T	5	8	13	0	0	13	0	0
14	34091134	.	A	C	7	7	14	0	1	16	1	0
14	34091238	.	C	A	10	12	22	0	3	25	0	0
14	34091423	.	C	T	10	12	22	0	4	26	0	0
14	34091461	.	G	T	11	7	18	0	1	19	0	0
14	34091787	.	T	A	8	17	25	0	1	26	0	0
14	34091805	.	C	A	11	10	21	0	2	23	0	0
14	34091851	.	C	T	16	11	27	0	0	27	0	0
14	34091971	.	G	A	22	14	36	0	0	36	0	0
14	34092369	.	C	T	15	15	30	1	1	32	0	0
14	34092507	.	T	G	22	13	35	0	1	36	0	0
14	34125983	.	T	A	2	3	5	0	2	7	0	0
14	34126353	.	A	T	28	20	48	0	3	52	1	0
14	34127403	.	A	G	2	6	8	1	0	9	0	0
14	34127445	.	A	G	5	12	17	1	1	19	0	0
14	34127457	.	C	T	8	13	21	0	1	22	0	0
14	34127492	.	G	T	13	14	27	0	2	29	0	0
14	34127507	.	T	G	17	9	26	0	2	28	0	0
14	34127675	.	A	G	7	5	12	0	2	14	0	0
14	34127686	.	A	T	3	4	7	0	4	11	0	0
14	34127881	.	A	T	8	3	11	0	0	11	0	0
14	34127884	.	C	T	8	3	11	0	0	11	0	0
14	34127925	.	T	A	11	4	15	0	1	16	0	0
14	34127967	.	C	T	10	3	13	0	2	15	0	0
14	34128023	.	C	T	3	5	8	0	0	8	0	0
14	34128371	.	G	T	15	4	19	0	1	20	0	0
14	34128477	.	A	C	11	1	12	0	13	25	0	0
14	34128516	.	C	T	8	8	16	0	5	21	0	0
14	34128565	.	T	G	15	13	28	0	1	29	0	0
14	34128796	.	G	T	9	6	15	0	1	16	0	0
14	34128930	.	G	T	6	3	9	0	1	10	0	0
14	34129103	.	A	G	9	9	18	0	1	19	0	0
14	34129159	.	T	C	12	10	22	0	1	23	0	0
14	34129338	.	A	T	9	11	20	0	0	20	0	0
14	34129353	.	T	C	12	0	12	0	11	23	0	0
14	34129377	.	G	T	10	11	21	0	1	22	0	0
14	34129545	.	G	A	4	7	11	0	0	11	0	0
14	34129558	.	A	T	7	9	16	0	1	17	0	0
14	34153801	.	A	G	4	4	8	1	0	9	0	0
14	34154815	.	A	G	3	5	8	0	0	8	0	0
14	34180461	.	A	G	2	2	4	0	0	4	0	0
14	34182101	.	C	T	1	2	3	0	0	3	0	0
14	34182107	.	A	T	1	2	3	0	0	3	0	0
14	34195879	.	C	T	0	3	3	0	1	4	0	0
14	34488456	.	T	C	7	37	44	0	4	48	0	0
14	34556534	.	T	C	3	1	4	0	1	5	0	0
14	34556826	.	C	G	7	4	11	0	1	12	0	0
14	34562998	.	C	A	1	2	3	0	0	3	0	0
14	34634281	.	T	C	1	3	4	0	0	4	0	0
14	34634415	.	T	A	3	5	8	0	0	8	0	0
14	34634584	.	C	A	10	5	15	0	0	15	0	0
14	34634788	.	G	A	3	7	10	0	0	10	0	0
14	34635144	.	C	T	7	4	11	0	1	12	0	0
14	34635541	.	A	G	5	4	9	0	0	9	0	0
14	34637134	.	A	T	9	4	13	0	1	14	0	0
14	34670750	.	C	G	3	4	7	0	1	8	0	0
14	34672611	.	C	T	3	3	6	0	2	8	0	0
14	34712839	.	G	A	1	3	4	0	0	4	0	0
14	34792627	.	T	C	5	5	10	0	0	10	0	0
14	34797734	.	C	A	7	8	15	0	0	15	0	0
14	35495820	.	T	C	10	3	13	1	0	14	0	0
14	35804833	.	A	G	20	10	30	0	3	33	0	0
14	35895960	.	C	A	4	5	9	3	0	12	0	0
14	35895983	.	G	A	4	4	8	0	2	10	0	0
14	35896005	.	T	C	4	3	7	0	1	8	0	0
14	36229211	.	T	A	4	4	8	0	0	8	0	0
14	36229227	.	T	G	4	6	10	0	0	10	0	0
14	36229415	.	C	T	1	4	5	0	1	6	0	0
14	36246854	.	C	T	11	6	17	0	1	18	0	0
14	36259377	.	G	A	0	15	15	0	7	22	0	0
14	36267395	.	C	A	12	15	27	0	1	28	0	0
14	36268152	.	C	T	15	12	27	0	2	29	0	0
14	36268339	.	C	T	17	14	31	0	0	31	0	0
14	36268426	.	T	C	16	10	26	0	0	26	0	0
14	36329023	.	C	A	0	3	3	0	1	4	0	0
14	36348878	.	G	A	20	35	55	0	1	56	0	0
14	36349387	.	A	T	33	33	66	1	5	72	0	0
14	36349409	.	A	G	34	25	59	1	15	75	0	0
14	36349607	.	C	G	8	35	43	0	39	82	0	0
14	36350639	.	G	T	32	36	68	0	2	70	0	0
14	36350669	.	T	C	35	4	39	0	31	70	0	0
14	36350917	.	A	T	39	23	62	0	1	64	1	0
14	36350932	.	T	A	40	19	59	0	2	61	0	0
14	36350980	.	T	C	25	0	25	3	31	59	0	0
14	36351004	.	C	T	25	23	48	3	2	55	2	0
14	36351064	.	G	A	34	19	53	0	3	56	0	0
14	36351143	.	A	G	42	22	64	0	1	65	0	0
14	36351148	.	C	T	41	22	63	0	1	64	0	0
14	36351209	.	G	A	39	22	61	0	0	61	0	0
14	36351217	.	A	G	36	25	61	0	0	61	0	0
14	36351347	.	G	A	18	30	48	0	7	55	0	0
14	36351350	.	C	T	33	22	55	0	1	56	0	0
14	36352148	.	T	C	27	3	30	0	33	63	0	0
14	36352265	.	G	A	30	36	66	0	5	71	0	0
14	36363689	.	G	A	21	12	33	0	2	35	0	0
14	36428528	.	T	C	1	3	4	0	0	4	0	0
14	36428614	.	A	G	1	2	3	0	0	3	0	0
14	36428665	.	T	G	3	3	6	0	1	7	0	0
14	36428910	.	A	T	3	2	5	0	0	5	0	0
14	36430603	.	G	T	5	8	13	0	0	13	0	0
14	36433568	.	T	C	9	0	9	0	7	16	0	0
14	36434258	.	C	T	4	6	10	0	0	10	0	0
14	36437002	.	T	C	5	8	13	0	0	13	0	0
14	36660823	.	A	C	1	2	3	0	0	3	0	0
14	36708909	.	A	G	1	2	3	0	1	4	0	0
14	36717230	.	T	C	2	3	5	0	0	5	0	0
14	36717315	.	A	G	2	0	2	0	4	6	0	0
14	36717320	.	A	G	2	4	6	0	0	6	0	0
14	36717689	.	C	T	3	2	5	0	0	5	0	0
14	36718265	.	C	T	1	2	3	0	0	3	0	0
14	36720770	.	C	T	6	4	10	0	2	12	0	0
14	36720980	.	A	G	6	3	9	0	0	9	0	0
14	36720985	.	A	G	5	3	8	0	1	9	0	0
14	36721033	.	A	G	4	0	4	0	7	11	0	0
14	36721102	.	T	A	5	8	13	0	3	16	0	0
14	36721153	.	G	A	8	4	12	0	2	14	0	0
14	36721175	.	C	G	6	4	10	0	0	10	0	0
14	36721229	.	G	A	3	7	10	0	1	11	0	0
14	36721379	.	G	C	4	7	11	0	0	11	0	0
14	36721437	.	G	A	1	12	13	0	2	15	0	0
14	36721497	.	C	G	4	6	10	0	1	11	0	0
14	36721564	.	G	A	5	4	9	0	0	9	0	0
14	36721599	.	C	A	4	3	7	0	0	7	0	0
14	36721724	.	T	A	4	3	7	0	0	7	0	0
14	36721730	.	T	A	3	2	5	0	3	8	0	0
14	36721984	.	G	C	3	2	5	0	0	5	0	0
14	36722095	.	T	C	8	3	11	0	0	11	0	0
14	36722140	.	C	A	7	4	11	0	0	11	0	0
14	36722364	.	C	T	6	8	14	0	1	15	0	0
14	36722405	.	G	A	6	11	17	0	1	18	0	0
14	36722568	.	A	T	11	5	16	0	0	16	0	0
14	36722904	.	G	A	2	4	6	0	11	17	0	0
14	36723134	.	A	T	5	5	10	0	0	10	0	0
14	36723213	.	G	A	7	4	11	0	1	12	0	0
14	36723270	.	A	G	8	0	8	0	6	14	0	0
14	36723276	.	T	C	9	5	14	0	2	16	0	0
14	36723326	.	C	T	13	6	19	0	2	21	0	0
14	36723367	.	A	C	18	5	23	0	0	23	0	0
14	36723402	.	C	G	12	8	20	0	6	26	0	0
14	36723690	.	C	G	9	8	17	1	0	18	0	0
14	36723694	.	C	A	8	5	13	1	0	14	0	0
14	36738073	.	G	A	1	1	2	0	0	2	0	0
14	36738081	.	T	G	1	2	3	0	0	3	0	0
14	36752477	.	T	C	6	5	11	0	0	11	0	0
14	36761340	.	A	C	1	0	1	0	2	3	0	0
14	36763225	.	A	G	2	3	5	0	0	5	0	0
14	36765662	.	G	A	4	6	10	0	0	10	0	0
14	36765721	.	C	T	15	7	22	0	0	22	0	0
14	36766273	.	A	T	10	16	26	0	0	26	0	0
14	36766394	.	A	C	6	9	15	0	1	16	0	0
14	36766624	.	T	A	11	7	18	0	1	19	0	0
14	36803100	.	G	T	5	5	10	0	0	10	0	0
14	36863407	.	T	C	2	0	2	0	2	4	0	0
14	37784752	.	A	C	3	0	3	0	6	9	0	0
14	39876050	.	G	C	0	3	3	0	1	4	0	0
14	39953337	.	T	A	1	2	3	0	0	3	0	0
14	39953446	.	C	T	1	4	5	0	1	6	0	0
14	39953855	.	T	A	1	2	3	0	0	3	0	0
14	39954169	.	C	T	1	2	3	0	0	3	0	0
14	39954272	.	A	G	1	6	7	0	0	7	0	0
14	39954423	.	A	T	1	2	3	0	0	3	0	0
14	39954513	.	C	T	2	3	5	0	0	5	0	0
14	39954789	.	C	T	4	2	6	0	0	6	0	0
14	39954835	.	G	A	4	3	7	1	0	8	0	0
14	39954963	.	C	T	2	2	4	0	1	5	0	0
14	39955231	.	T	A	4	2	6	0	0	6	0	0
14	39955448	.	C	T	5	8	13	0	0	13	0	0
14	39955457	.	C	A	10	5	15	0	1	16	0	0
14	39955612	.	A	T	7	9	16	0	3	20	1	0
14	39955646	.	T	C	7	7	14	0	0	14	0	0
14	39955772	.	T	A	12	5	17	0	0	17	0	0
14	39955823	.	T	C	9	4	13	0	1	14	0	0
14	39955872	.	G	A	1	4	5	0	3	8	0	0
14	39955927	.	A	G	1	0	1	0	4	5	0	0
14	39956075	.	G	A	2	6	8	0	0	8	0	0
14	39956380	.	T	C	5	3	8	0	1	9	0	0
14	39956804	.	G	T	4	5	9	0	0	9	0	0
14	39956825	.	T	C	4	4	8	0	0	8	0	0
14	39957304	.	T	G	2	2	4	0	0	4	0	0
14	40303348	.	A	T	12	22	34	0	2	36	0	0
14	40303366	.	C	T	17	20	37	0	5	42	0	0
14	40303775	.	T	C	16	2	18	3	7	28	0	0
14	40304488	.	C	G	2	19	21	2	11	34	0	0
14	40305230	.	G	A	20	7	27	0	2	30	1	0
14	40305287	.	C	A	1	17	18	0	25	43	0	0
14	40305635	.	C	T	1	19	20	0	8	28	0	0
14	40305659	.	C	T	1	16	17	0	11	28	0	0
14	40387603	.	C	T	11	12	23	0	0	23	0	0
14	40387627	.	G	A	4	8	12	0	4	16	0	0
14	40388107	.	A	G	6	12	18	0	2	20	0	0
14	40388185	.	A	G	13	7	20	0	0	20	0	0
14	40388440	.	G	A	5	6	11	0	0	11	0	0
14	40388460	.	T	G	5	6	11	0	1	12	0	0
14	40388629	.	T	C	11	6	17	0	1	18	0	0
14	40389145	.	C	G	2	5	7	0	0	7	0	0
14	40389823	.	T	A	1	1	2	0	0	2	0	0
14	41278386	.	C	T	22	20	42	0	1	43	0	0
14	42172527	.	G	A	0	3	3	0	2	5	0	0
14	42172732	.	G	A	0	3	3	0	1	4	0	0
14	42173572	.	A	T	5	2	7	0	0	7	0	0
14	42173803	.	C	T	4	4	8	0	0	8	0	0
14	42174385	.	C	T	7	4	11	0	0	11	0	0
14	42174401	.	C	T	6	4	10	0	0	10	0	0
14	42174645	.	A	T	12	7	19	0	0	19	0	0
14	42174724	.	C	T	11	12	23	0	1	24	0	0
14	42178503	.	C	T	17	19	36	0	0	36	0	0
14	42178626	.	C	T	6	17	23	0	1	24	0	0
14	42178728	.	G	A	10	8	18	0	0	18	0	0
14	42178974	.	G	A	14	13	27	0	0	27	0	0
14	42978789	.	G	A	13	7	20	0	0	20	0	0
14	42978975	.	A	G	22	12	34	0	3	37	0	0
14	42978980	.	A	C	18	15	33	0	1	34	0	0
14	42979090	.	T	A	7	8	15	0	1	16	0	0
14	42979233	.	G	C	14	20	34	1	2	37	0	0
14	42979513	.	C	T	26	15	41	0	3	44	0	0
14	42997943	.	G	A	18	17	35	0	1	36	0	0
14	42998114	.	G	A	10	17	27	0	2	29	0	0
14	42998740	.	A	G	12	10	22	1	3	26	0	0
14	42998900	.	G	A	6	7	13	0	0	13	0	0
14	42999314	.	C	T	6	4	10	0	1	11	0	0
14	42999662	.	T	C	5	7	12	0	1	13	0	0
14	43577704	.	G	A	4	9	13	0	0	13	0	0
14	43577916	.	G	A	8	5	13	0	1	14	0	0
14	43579983	.	A	G	12	7	19	0	1	20	0	0
14	43580004	.	A	G	14	6	20	0	1	21	0	0
14	43590849	.	C	T	4	3	7	0	0	7	0	0
14	43591152	.	G	T	10	11	21	0	2	23	0	0
14	43591188	.	G	A	11	12	23	0	2	25	0	0
14	43596699	.	G	A	9	9	18	0	0	18	0	0
14	43596774	.	C	A	7	8	15	0	1	16	0	0
14	43598196	.	C	T	2	6	8	0	4	12	0	0
14	43605462	.	C	T	4	12	16	0	0	16	0	0
14	43605498	.	T	C	5	0	5	0	12	17	0	0
14	43612822	.	T	C	4	6	10	0	1	11	0	0
14	43615151	.	G	A	3	6	9	0	0	9	0	0
14	43615244	.	C	G	2	3	5	0	0	5	0	0
14	44589624	.	C	T	7	8	15	0	3	18	0	0
14	44589711	.	T	A	5	9	14	0	4	18	0	0
14	44589834	.	A	G	7	7	14	0	1	15	0	0
14	44589972	.	T	A	6	2	8	0	1	9	0	0
14	44589978	.	G	A	9	2	11	0	0	11	0	0
14	44590297	.	G	C	7	18	25	0	1	26	0	0
14	44590301	.	A	G	6	0	6	0	22	28	0	0
14	44590644	.	C	T	21	19	40	0	1	41	0	0
14	44590838	.	T	A	14	10	24	1	0	25	0	0
14	44590935	.	G	A	2	10	12	0	13	25	0	0
14	44590992	.	A	G	13	11	24	0	1	25	0	0
14	44824713	.	A	G	2	2	4	0	0	4	0	0
14	45200749	.	A	G	2	2	4	0	0	4	0	0
14	45201091	.	A	G	3	2	5	0	1	6	0	0
14	45201143	.	A	G	4	2	6	0	2	8	0	0
14	45201361	.	C	T	3	4	7	0	0	7	0	0
14	45271464	.	G	A	3	2	5	0	1	6	0	0
14	45271622	.	T	C	2	2	4	0	0	4	0	0
14	45276671	.	C	T	4	3	7	0	0	7	0	0
14	45293316	.	T	G	4	4	8	0	0	8	0	0
14	45293345	.	C	G	6	0	6	0	5	12	1	0
14	45293390	.	G	A	10	4	14	0	1	15	0	0
14	45293511	.	G	A	0	3	3	0	4	7	0	0
14	45293599	.	G	T	1	5	6	0	0	6	0	0
14	45293625	.	A	G	2	3	5	0	0	5	0	0
14	45293640	.	T	A	2	3	5	0	0	5	0	0
14	45293722	.	G	A	4	2	6	0	0	6	0	0
14	45293898	.	C	T	1	3	4	0	0	4	0	0
14	45293956	.	G	A	1	3	4	0	0	4	0	0
14	45293965	.	G	A	1	3	4	0	0	4	0	0
14	45293995	.	G	A	4	3	7	0	3	10	0	0
14	45294114	.	C	A	5	4	9	0	0	10	1	0
14	45295314	.	T	C	5	4	9	0	1	10	0	0
14	45295547	.	A	G	2	2	4	0	1	5	0	0
14	45312096	.	C	T	2	2	4	0	2	6	0	0
14	45341646	.	T	C	14	4	18	0	1	19	0	0
14	45435597	.	T	C	2	2	4	0	0	4	0	0
14	45435891	.	T	C	8	5	13	0	1	14	0	0
14	45435978	.	T	C	4	0	4	0	3	7	0	0
14	45435982	.	T	C	3	3	6	0	0	6	0	0
14	45530665	.	T	C	2	4	6	0	0	6	0	0
14	45534043	.	T	G	4	5	9	0	1	10	0	0
14	45534178	.	A	G	6	3	9	0	0	9	0	0
14	45534256	.	A	G	5	3	8	0	1	9	0	0
14	45534262	.	C	T	0	2	2	0	6	8	0	0
14	45542357	.	T	A	3	3	6	0	2	8	0	0
14	45548614	.	G	A	2	3	5	0	0	5	0	0
14	45548663	.	C	T	2	2	4	0	1	5	0	0
14	45548669	.	G	T	3	2	5	0	0	5	0	0
14	45565914	.	G	T	2	4	6	0	0	6	0	0
14	45565915	.	A	T	2	4	6	0	0	6	0	0
14	45568736	.	G	T	5	7	12	0	1	13	0	0
14	45570967	.	G	A	14	11	25	0	2	27	0	0
14	45571124	.	A	T	8	6	14	0	2	16	0	0
14	45571501	.	G	A	9	15	24	0	3	27	0	0
14	45571593	.	C	T	11	8	19	1	1	21	0	0
14	45571679	.	T	C	10	4	14	0	0	14	0	0
14	45575139	.	G	A	5	7	12	0	2	14	0	0
14	45575203	.	C	A	11	5	16	1	1	18	0	0
14	45575214	.	T	C	13	0	13	1	8	22	0	0
14	45575336	.	A	G	13	13	26	0	1	27	0	0
14	45575495	.	T	C	12	12	24	0	1	25	0	0
14	45581382	.	T	C	21	12	33	0	1	34	0	0
14	45582312	.	C	A	1	8	9	0	16	25	0	0
14	45582314	.	T	A	12	10	22	0	1	23	0	0
14	45584078	.	T	C	13	0	13	0	4	17	0	0
14	45584312	.	T	C	8	5	13	0	0	13	0	0
14	45586237	.	G	A	9	4	13	0	0	13	0	0
14	45590653	.	T	A	1	5	6	0	0	6	0	0
14	45600354	.	T	G	2	2	4	0	0	4	0	0
14	45600360	.	C	T	2	2	4	0	0	4	0	0
14	45603874	.	C	T	12	8	20	0	0	20	0	0
14	45603951	.	T	C	15	0	15	0	10	25	0	0
14	45603976	.	G	A	10	10	20	0	0	20	0	0
14	45604392	.	C	T	2	6	8	0	11	19	0	0
14	45608886	.	A	G	11	7	18	0	1	19	0	0
14	45614526	.	C	G	7	0	7	1	9	17	0	0
14	45614795	.	A	G	6	0	6	0	3	9	0	0
14	45631345	.	C	T	2	8	10	0	4	14	0	0
14	45631716	.	C	T	9	11	20	0	3	23	0	0
14	45631768	.	G	T	23	21	44	0	1	45	0	0
14	45632834	.	A	C	25	40	65	0	3	68	0	0
14	45632967	.	T	C	26	1	27	0	22	49	0	0
14	45634860	.	A	T	37	47	84	0	6	90	0	0
14	45634960	.	C	T	12	18	30	1	25	56	0	0
14	45635333	.	C	T	16	48	64	0	33	97	0	0
14	45635767	.	T	C	53	44	97	1	8	106	0	0
14	45636078	.	A	G	26	4	30	0	3	33	0	0
14	45636701	.	G	A	38	12	50	0	8	58	0	0
14	45636800	.	A	G	45	15	60	3	13	76	0	0
14	45636844	.	A	T	38	32	70	1	5	76	0	0
14	45637058	.	C	G	15	21	36	0	4	40	0	0
14	45637103	.	A	C	18	1	19	0	28	47	0	0
14	45637200	.	C	T	30	44	74	0	2	76	0	0
14	45637201	.	T	A	27	44	71	0	4	75	0	0
14	45637382	.	A	G	33	24	57	0	4	61	0	0
14	45637545	.	T	G	13	23	36	0	6	42	0	0
14	45637702	.	C	T	35	17	52	0	5	57	0	0
14	45637804	.	G	T	29	33	62	17	2	81	0	0
14	45638280	.	G	C	25	31	56	0	4	60	0	0
14	45638509	.	C	T	24	24	48	0	0	48	0	0
14	45638562	.	T	G	25	20	45	0	2	47	0	0
14	45638563	.	T	A	21	21	42	0	3	46	1	0
14	45790155	.	G	A	4	3	7	0	0	7	0	0
14	45928059	.	T	A	1	3	4	0	0	4	0	0
14	45928306	.	G	A	1	2	3	0	0	3	0	0
14	45928333	.	T	G	1	4	5	0	0	5	0	0
14	45929100	.	A	T	1	2	3	0	1	4	0	0
14	45929409	.	C	T	5	3	8	0	1	9	0	0
14	45930135	.	T	C	3	6	9	0	0	9	0	0
14	45930196	.	A	C	3	7	10	0	0	10	0	0
14	45930399	.	C	T	4	4	8	0	0	8	0	0
14	45930508	.	A	G	5	6	11	0	0	11	0	0
14	45930515	.	G	A	5	4	9	0	0	9	0	0
14	45930735	.	T	G	6	3	9	0	0	11	2	0
14	45930744	.	A	G	1	7	8	0	1	9	0	0
14	45930794	.	G	A	2	5	7	0	1	8	0	0
14	45931079	.	C	G	9	4	13	0	0	13	0	0
14	45931194	.	G	T	4	12	16	0	1	17	0	0
14	45931504	.	C	G	12	11	23	0	1	24	0	0
14	45931637	.	C	T	13	8	21	0	1	22	0	0
14	45931899	.	C	T	7	5	12	0	1	13	0	0
14	45932128	.	T	G	10	5	15	0	1	16	0	0
14	46007306	.	A	G	8	3	11	0	2	13	0	0
14	46007321	.	G	A	8	3	11	0	1	12	0	0
14	46009611	.	G	A	3	7	10	0	0	10	0	0
14	46009683	.	A	T	8	3	11	0	2	13	0	0
14	46010711	.	C	T	7	7	14	0	0	14	0	0
14	46010909	.	T	C	5	11	16	0	0	17	1	0
14	46012960	.	T	C	5	12	17	0	0	17	0	0
14	46013121	.	A	T	5	5	10	0	1	11	0	0
14	46013402	.	C	T	6	21	27	1	1	29	0	0
14	46015888	.	C	A	15	15	30	0	0	30	0	0
14	46016107	.	A	G	11	21	32	0	4	36	0	0
14	46017969	.	G	A	11	14	25	0	1	26	0	0
14	46018029	.	C	T	15	10	25	0	2	27	0	0
14	46028329	.	G	T	2	3	5	0	0	6	1	0
14	46028330	.	T	A	3	3	6	0	0	6	0	0
14	46037489	.	T	C	3	2	5	0	1	6	0	0
14	46037611	.	C	G	3	3	6	0	0	6	0	0
14	46039751	.	T	C	5	3	8	0	1	9	0	0
14	46039904	.	C	G	1	0	1	0	5	6	0	0
14	46040318	.	T	C	10	3	13	0	0	13	0	0
14	46041763	.	T	G	2	3	5	0	0	5	0	0
14	46041800	.	C	T	6	3	9	0	1	10	0	0
14	46041861	.	A	T	8	7	15	0	0	15	0	0
14	46042005	.	T	C	1	3	4	0	0	4	0	0
14	46048396	.	A	G	12	6	18	0	1	19	0	0
14	46048644	.	C	T	0	12	12	0	11	24	1	0
14	46048704	.	C	G	1	15	16	0	15	31	0	0
14	46048875	.	T	C	12	15	27	0	3	30	0	0
14	46052172	.	T	A	8	5	13	0	0	13	0	0
14	46052244	.	G	T	5	7	12	0	0	12	0	0
14	46067317	.	A	T	8	4	12	0	0	12	0	0
14	46074433	.	C	T	5	2	7	0	0	7	0	0
14	46074568	.	C	T	5	2	7	0	1	8	0	0
14	46074576	.	G	A	6	6	12	0	0	12	0	0
14	46074626	.	C	G	4	7	11	0	0	11	0	0
14	46074646	.	G	T	4	6	10	0	2	12	0	0
14	46075640	.	A	C	12	4	16	0	0	16	0	0
14	46075749	.	A	G	12	5	17	0	1	18	0	0
14	46076293	.	G	A	3	2	5	0	0	5	0	0
14	46076846	.	C	A	3	2	5	0	1	6	0	0
14	46088595	.	T	A	4	2	6	0	0	6	0	0
14	46088921	.	A	G	4	6	10	0	1	11	0	0
14	46089176	.	C	T	7	4	11	0	0	11	0	0
14	46089234	.	C	G	5	4	9	0	0	9	0	0
14	46089242	.	A	C	5	2	7	0	0	7	0	0
14	46089297	.	A	C	2	1	3	0	2	5	0	0
14	46089433	.	T	G	1	5	6	0	0	6	0	0
14	46089515	.	T	C	5	3	8	0	0	8	0	0
14	46090015	.	G	A	6	5	11	0	0	11	0	0
14	46090508	.	T	A	4	4	8	0	0	8	0	0
14	46090636	.	A	G	3	2	5	0	0	5	0	0
14	46094922	.	C	T	6	13	19	0	2	21	0	0
14	46095043	.	A	G	27	18	45	0	2	47	0	0
14	46095058	.	A	G	26	17	43	0	3	46	0	0
14	46095108	.	A	G	30	24	54	0	2	56	0	0
14	46104150	.	C	T	23	14	37	0	10	48	1	0
14	46104222	.	C	T	2	26	28	0	23	51	0	0
14	46104935	.	G	A	21	18	39	0	3	42	0	0
14	46114944	.	G	A	9	21	30	0	0	30	0	0
14	46140812	.	C	A	4	6	10	0	0	10	0	0
14	46146715	.	G	A	6	8	14	0	3	17	0	0
14	46146730	.	G	A	4	9	13	0	1	14	0	0
14	46154358	.	C	A	13	9	22	0	2	24	0	0
14	46154561	.	G	A	1	10	11	0	7	18	0	0
14	46154713	.	A	G	7	7	14	0	1	15	0	0
14	46154723	.	G	A	9	8	17	0	2	19	0	0
14	46154798	.	T	C	13	7	20	0	3	23	0	0
14	46154854	.	G	T	0	13	13	0	15	28	0	0
14	46183683	.	A	G	2	4	6	0	1	7	0	0
14	46184640	.	A	G	1	0	1	0	2	3	0	0
14	46184658	.	A	G	1	2	3	0	0	3	0	0
14	46185402	.	G	C	2	4	6	0	0	6	0	0
14	46186425	.	A	G	1	2	3	0	0	3	0	0
14	46186827	.	A	G	5	0	5	0	8	13	0	0
14	46187544	.	C	T	4	4	8	0	0	8	0	0
14	46187641	.	C	T	4	7	11	0	0	11	0	0
14	46187644	.	T	G	4	0	4	0	8	12	0	0
14	46187730	.	G	A	4	6	10	0	0	10	0	0
14	46187830	.	A	G	3	0	3	0	3	6	0	0
14	46187879	.	C	T	1	5	6	0	1	7	0	0
14	46187926	.	A	G	5	0	5	1	2	8	0	0
14	46188109	.	A	T	8	6	14	1	0	15	0	0
14	46188114	.	C	T	4	8	12	1	0	13	0	0
14	46188561	.	A	C	5	11	16	0	0	16	0	0
14	46188578	.	C	T	9	4	13	0	0	13	0	0
14	46189130	.	G	A	16	6	22	0	1	23	0	0
14	46189173	.	G	T	17	4	21	0	0	21	0	0
14	46189251	.	A	G	12	9	21	0	0	21	0	0
14	46189268	.	C	T	11	11	22	0	1	23	0	0
14	46189342	.	T	C	6	10	16	0	1	17	0	0
14	46189531	.	C	T	3	5	8	0	0	8	0	0
14	46200128	.	G	A	11	11	22	0	1	23	0	0
14	46200244	.	A	C	14	7	21	0	1	22	0	0
14	46200422	.	A	T	11	8	19	0	0	19	0	0
14	46200445	.	C	A	9	10	19	0	2	21	0	0
14	46200636	.	G	T	11	14	25	0	2	27	0	0
14	46200814	.	G	A	21	12	33	0	0	33	0	0
14	46204139	.	A	G	9	9	18	0	0	18	0	0
14	46206097	.	C	G	0	7	7	0	11	18	0	0
14	46208722	.	G	A	11	10	21	0	4	25	0	0
14	46208725	.	T	C	11	11	22	0	2	24	0	0
14	46208818	.	A	T	15	15	30	0	2	32	0	0
14	46219634	.	A	T	2	2	4	0	0	4	0	0
14	46297049	.	A	G	1	2	3	0	0	3	0	0
14	46346878	.	T	A	6	3	9	0	0	9	0	0
14	46352475	.	A	T	12	10	22	2	2	26	0	0
14	46352654	.	A	T	11	11	22	0	0	22	0	0
14	46353149	.	G	A	1	2	3	0	0	3	0	0
14	46353175	.	A	G	1	2	3	0	0	3	0	0
14	46360432	.	C	A	0	3	3	0	1	4	0	0
14	46382221	.	T	C	5	3	8	0	2	10	0	0
14	46382488	.	C	T	3	4	7	0	0	7	0	0
14	46385597	.	G	A	3	6	9	0	0	9	0	0
14	46442358	.	C	T	1	2	3	0	0	3	0	0
14	46456501	.	T	G	21	17	38	0	3	41	0	0
14	46456905	.	T	A	21	14	35	0	5	40	0	0
14	46456989	.	C	T	17	16	33	0	3	36	0	0
14	46457009	.	T	G	23	10	33	0	0	33	0	0
14	46457088	.	C	T	14	7	21	1	0	22	0	0
14	46457110	.	A	C	10	8	18	1	3	22	0	0
14	46457684	.	A	G	12	7	19	0	0	19	0	0
14	46457700	.	A	G	10	5	15	0	2	17	0	0
14	46457724	.	G	T	19	4	23	0	0	23	0	0
14	46457809	.	A	G	10	7	17	1	1	19	0	0
14	46458010	.	C	T	6	2	8	0	1	9	0	0
14	46458338	.	C	G	6	7	13	0	0	13	0	0
14	46458376	.	T	A	10	13	23	0	0	23	0	0
14	46458790	.	A	G	2	6	8	0	1	9	0	0
14	46458915	.	C	G	7	12	19	0	1	20	0	0
14	46459269	.	G	A	4	3	7	0	0	7	0	0
14	46633864	.	A	G	1	2	3	0	0	3	0	0
14	46668440	.	C	T	3	2	5	0	0	5	0	0
14	46678919	.	A	G	7	11	18	0	0	18	0	0
14	46679259	.	A	G	3	4	7	0	0	7	0	0
14	46679263	.	C	T	4	3	7	0	0	7	0	0
14	46679304	.	A	G	5	7	12	0	3	15	0	0
14	46679307	.	A	T	6	9	15	0	0	15	0	0
14	46679348	.	C	T	6	9	15	0	0	15	0	0
14	46679370	.	T	C	11	4	15	0	2	17	0	0
14	46679902	.	A	C	21	5	26	2	0	28	0	0
14	46679912	.	G	A	22	6	28	2	0	30	0	0
14	46679999	.	A	G	16	7	23	0	0	23	0	0
14	46680043	.	T	C	10	3	13	0	1	14	0	0
14	46680226	.	C	A	8	4	12	0	0	12	0	0
14	46680333	.	G	T	8	4	12	2	0	14	0	0
14	46680966	.	T	C	11	6	17	0	1	18	0	0
14	46681005	.	A	C	7	7	14	0	0	14	0	0
14	46681020	.	T	A	5	6	11	0	0	11	0	0
14	46681641	.	A	G	3	4	7	0	1	8	0	0
14	46682877	.	T	G	1	3	4	0	1	5	0	0
14	46682919	.	T	C	3	2	5	0	1	6	0	0
14	46682926	.	A	G	4	2	6	0	1	7	0	0
14	46683101	.	T	A	7	5	12	0	0	12	0	0
14	46683689	.	G	A	2	3	5	0	0	5	0	0
14	46683725	.	A	G	3	2	5	0	0	5	0	0
14	46684102	.	C	T	0	2	2	0	2	4	0	0
14	46684195	.	A	C	2	4	6	0	0	6	0	0
14	46684227	.	T	C	3	5	8	0	1	9	0	0
14	46684233	.	G	T	6	3	9	0	2	11	0	0
14	46684800	.	T	G	6	6	12	0	0	13	1	0
14	46873289	.	T	C	3	6	9	0	1	10	0	0
14	46873439	.	C	A	7	7	14	0	2	16	0	0
14	46873543	.	G	A	3	6	9	0	3	12	0	0
14	46873806	.	G	A	8	7	15	0	1	16	0	0
14	46873868	.	C	T	5	4	9	0	0	9	0	0
14	46874001	.	G	A	14	8	22	0	0	22	0	0
14	46874095	.	G	A	13	3	16	0	0	16	0	0
14	46874098	.	T	A	12	3	15	0	1	16	0	0
14	46874191	.	G	A	3	4	7	0	1	8	0	0
14	46874276	.	C	A	1	2	3	0	1	4	0	0
14	46874572	.	G	A	2	4	6	0	0	6	0	0
14	46874605	.	T	A	2	5	7	0	0	7	0	0
14	46874763	.	A	G	5	2	7	0	1	8	0	0
14	46876711	.	T	A	2	2	4	0	0	4	0	0
14	46876717	.	A	T	3	3	6	0	0	6	0	0
14	46876924	.	T	C	1	2	3	0	0	3	0	0
14	46876970	.	C	T	4	3	7	0	1	8	0	0
14	46877085	.	T	C	5	5	10	0	1	11	0	0
14	46881719	.	A	G	5	4	9	0	1	10	0	0
14	47783003	.	C	A	2	3	5	0	0	5	0	0
14	48932470	.	T	A	27	23	50	0	2	52	0	0
14	48932712	.	G	A	16	13	29	0	1	30	0	0
14	48932880	.	A	T	25	17	42	0	3	45	0	0
14	48932970	.	T	A	10	25	35	0	7	42	0	0
14	48933224	.	A	G	27	17	44	1	3	48	0	0
14	48933273	.	C	A	25	21	46	2	3	51	0	0
14	48933361	.	T	A	31	17	48	1	4	53	0	0
14	48933513	.	T	C	19	13	32	0	0	32	0	0
14	48933575	.	A	G	21	7	28	0	1	29	0	0
14	48933772	.	G	A	5	2	7	2	0	9	0	0
14	48934025	.	G	A	24	17	41	0	1	42	0	0
14	48934052	.	G	A	25	12	37	0	0	37	0	0
14	48934253	.	G	A	21	5	26	0	2	28	0	0
14	48934276	.	G	A	21	5	26	0	0	26	0	0
14	48934299	.	C	A	18	3	21	0	1	22	0	0
14	48934547	.	A	T	24	13	37	0	0	37	0	0
14	48934577	.	G	T	22	14	36	0	7	43	0	0
14	48934630	.	C	G	24	10	34	0	3	37	0	0
14	48934639	.	T	C	28	0	28	0	8	36	0	0
14	48934701	.	T	C	11	24	35	0	2	37	0	0
14	48934719	.	T	G	13	22	35	0	0	35	0	0
14	48934829	.	T	A	9	26	35	0	4	39	0	0
14	48945057	.	T	C	1	3	4	0	1	5	0	0
14	48945321	.	G	C	3	0	3	0	2	5	0	0
14	48960464	.	C	T	0	2	2	0	1	3	0	0
14	48964697	.	T	C	11	14	25	0	0	25	0	0
14	48995551	.	C	G	1	4	5	0	1	6	0	0
14	48997620	.	G	C	2	3	5	0	1	6	0	0
14	48997773	.	A	G	4	7	11	0	1	12	0	0
14	48997823	.	A	G	15	0	15	0	2	17	0	0
14	48997824	.	A	G	9	7	16	0	1	17	0	0
14	49021945	.	C	T	2	1	3	0	1	4	0	0
14	49021960	.	C	T	4	3	7	0	0	7	0	0
14	49022002	.	C	T	1	2	3	0	0	3	0	0
14	49022071	.	A	G	5	0	5	0	4	9	0	0
14	49022328	.	T	C	5	3	8	0	0	8	0	0
14	49029026	.	A	G	2	0	2	0	4	6	0	0
14	49029269	.	C	G	2	3	5	0	0	5	0	0
14	49029992	.	C	T	3	2	5	0	0	5	0	0
14	49030155	.	C	T	3	2	5	2	1	8	0	0
14	49030217	.	G	A	2	2	4	0	0	4	0	0
14	49030378	.	A	G	1	2	3	0	0	3	0	0
14	49030450	.	A	G	1	2	3	0	0	3	0	0
14	49031081	.	T	G	7	4	11	0	2	13	0	0
14	49031086	.	G	A	8	5	13	0	0	13	0	0
14	49031116	.	C	T	5	8	13	0	3	16	0	0
14	49031149	.	T	C	4	7	11	0	0	11	0	0
14	49031162	.	C	T	2	7	9	0	0	9	0	0
14	49031231	.	A	G	2	0	2	0	3	5	0	0
14	49031244	.	A	G	3	3	6	0	0	6	0	0
14	49031304	.	T	A	6	3	9	0	0	9	0	0
14	49031382	.	G	T	8	5	13	0	1	14	0	0
14	49031385	.	G	A	9	5	14	0	0	14	0	0
14	49040425	.	A	G	4	8	12	0	0	12	0	0
14	49040563	.	T	A	8	7	15	0	3	18	0	0
14	49040574	.	G	A	8	6	14	0	1	15	0	0
14	49040773	.	G	A	6	3	9	1	0	10	0	0
14	49047525	.	T	G	21	14	35	0	1	36	0	0
14	49053391	.	G	A	5	9	14	0	0	14	0	0
14	49053402	.	C	G	5	7	12	0	0	12	0	0
14	49053431	.	T	G	2	9	11	0	0	11	0	0
14	49053523	.	T	C	3	1	4	0	3	7	0	0
14	49057237	.	T	C	5	3	8	0	0	8	0	0
14	49119048	.	G	T	11	11	22	0	0	22	0	0
14	49119062	.	G	A	17	12	29	0	3	32	0	0
14	49119115	.	T	G	31	17	48	0	1	49	0	0
14	49119192	.	T	A	23	22	45	2	0	47	0	0
14	49119321	.	A	C	26	24	50	0	2	52	0	0
14	49119484	.	T	A	29	14	43	0	0	43	0	0
14	49124645	.	G	C	9	5	14	0	1	15	0	0
14	49124711	.	A	C	6	11	17	0	0	17	0	0
14	49126924	.	G	A	5	5	10	0	0	10	0	0
14	49135328	.	A	T	8	9	17	0	1	18	0	0
14	49136483	.	C	T	15	17	32	0	2	34	0	0
14	49136530	.	T	G	9	1	10	0	12	22	0	0
14	49136551	.	T	G	11	1	12	0	5	17	0	0
14	49136835	.	G	A	12	12	24	0	0	24	0	0
14	49136886	.	C	A	14	7	21	0	2	23	0	0
14	49136909	.	C	T	7	13	20	4	0	24	0	0
14	49172623	.	A	G	1	0	1	0	3	4	0	0
14	49174995	.	G	T	1	2	3	0	0	3	0	0
14	49195572	.	C	A	4	2	6	0	0	6	0	0
14	49196757	.	A	T	1	4	5	0	0	5	0	0
14	49196784	.	C	T	1	2	3	0	0	3	0	0
14	49199004	.	A	T	3	2	5	0	1	6	0	0
14	49202111	.	C	G	2	3	5	0	0	5	0	0
14	49203983	.	C	T	4	5	9	0	1	10	0	0
14	49206876	.	G	C	2	4	6	0	0	6	0	0
14	49206879	.	C	T	2	3	5	0	0	5	0	0
14	49206948	.	G	A	5	2	7	0	0	7	0	0
14	49209848	.	G	A	1	5	6	0	3	9	0	0
14	49209983	.	C	T	3	6	9	0	2	11	0	0
14	49210055	.	T	C	1	4	5	0	0	5	0	0
14	49210075	.	C	A	2	4	6	0	1	7	0	0
14	49210231	.	A	G	2	5	7	0	0	7	0	0
14	49210349	.	G	A	1	4	5	0	0	5	0	0
14	49210569	.	G	C	2	3	5	0	0	5	0	0
14	49210779	.	C	T	4	2	6	0	0	6	0	0
14	49210867	.	G	T	4	5	9	0	2	11	0	0
14	49211001	.	A	G	4	8	12	0	1	13	0	0
14	49211045	.	T	C	7	6	13	0	1	14	0	0
14	49211172	.	A	G	3	2	5	0	0	5	0	0
14	49211204	.	A	G	3	2	5	0	0	5	0	0
14	49211501	.	A	G	2	2	4	1	1	6	0	0
14	49211502	.	A	G	3	2	5	1	0	6	0	0
14	49211948	.	T	C	2	2	4	0	0	4	0	0
14	49211950	.	A	G	3	0	3	0	2	5	0	0
14	49212245	.	A	G	2	0	2	0	3	5	0	0
14	49212292	.	C	T	5	4	9	0	0	9	0	0
14	49212350	.	C	T	7	6	13	0	0	13	0	0
14	49212395	.	T	C	4	8	12	0	0	12	0	0
14	49212550	.	A	G	3	2	5	0	3	8	0	0
14	49212612	.	T	C	6	3	9	0	0	9	0	0
14	49212674	.	T	C	4	5	9	0	0	9	0	0
14	49212683	.	C	G	3	4	7	0	0	7	0	0
14	49212716	.	A	G	3	6	9	0	1	10	0	0
14	49212887	.	A	C	5	2	7	0	0	7	0	0
14	49212985	.	A	T	7	3	10	0	1	11	0	0
14	49212986	.	G	A	7	3	10	0	1	11	0	0
14	49213126	.	A	T	11	9	20	0	2	22	0	0
14	49213250	.	C	T	2	14	16	0	3	19	0	0
14	49214158	.	G	A	8	6	14	0	2	16	0	0
14	49214170	.	A	G	9	0	9	0	8	17	0	0
14	49214286	.	T	G	1	3	4	0	1	5	0	0
14	49214323	.	A	T	5	8	13	0	3	16	0	0
14	49214347	.	T	G	4	0	4	0	16	20	0	0
14	49231813	.	C	T	2	10	12	0	0	12	0	0
14	49231903	.	C	G	6	8	14	0	0	14	0	0
14	49233937	.	A	G	3	5	8	0	1	9	0	0
14	49236476	.	A	G	15	9	24	0	0	24	0	0
14	49237917	.	A	G	8	5	13	0	1	14	0	0
14	49244377	.	T	C	17	14	31	0	2	33	0	0
14	49244425	.	A	G	18	0	18	0	19	37	0	0
14	49244496	.	C	T	15	18	33	0	3	36	0	0
14	49244740	.	A	T	9	11	20	0	1	21	0	0
14	49244874	.	A	G	12	17	29	1	1	31	0	0
14	49245035	.	C	A	13	3	16	1	1	18	0	0
14	49245255	.	G	C	16	14	30	0	2	32	0	0
14	49430817	.	A	G	12	11	23	0	1	24	0	0
14	49430844	.	A	G	23	8	31	0	2	33	0	0
14	49760790	.	A	G	3	2	5	0	0	5	0	0
14	49865132	.	A	C	2	2	4	0	0	4	0	0
14	49865367	.	T	A	10	10	20	0	3	23	0	0
14	49865508	.	G	A	19	8	27	0	3	30	0	0
14	49865563	.	C	T	16	8	24	0	1	25	0	0
14	49865711	.	A	G	16	16	32	0	0	32	0	0
14	49865747	.	C	T	0	14	14	0	17	31	0	0
14	49878814	.	T	C	5	0	5	0	6	11	0	0
14	49938797	.	C	A	7	9	16	0	1	17	0	0
14	49939493	.	C	T	1	5	6	0	9	15	0	0
14	49939498	.	A	G	9	5	14	0	0	14	0	0
14	49943137	.	G	A	8	5	13	0	0	13	0	0
14	49943171	.	G	T	6	6	12	0	0	12	0	0
14	49943185	.	T	A	11	6	17	0	3	20	0	0
14	49947717	.	T	C	4	5	9	0	1	10	0	0
14	49947724	.	C	T	3	6	9	0	1	10	0	0
14	49947765	.	C	T	3	4	7	0	0	7	0	0
14	49947846	.	G	A	8	3	11	0	1	12	0	0
14	49947868	.	T	C	7	0	7	0	5	12	0	0
14	49948196	.	G	T	5	11	16	0	0	16	0	0
14	49948217	.	A	G	1	10	11	0	1	12	0	0
14	49948589	.	G	A	7	3	10	0	0	10	0	0
14	49952434	.	C	A	1	3	4	0	8	12	0	0
14	49952515	.	A	G	8	3	11	0	0	11	0	0
14	49952554	.	A	G	7	6	13	0	0	13	0	0
14	49952819	.	G	A	4	9	13	0	0	13	0	0
14	49962203	.	C	T	4	2	6	0	0	6	0	0
14	49962383	.	G	A	1	3	4	0	0	4	0	0
14	49970407	.	A	G	1	4	5	0	0	5	0	0
14	49996714	.	T	A	1	2	3	1	0	4	0	0
14	49996841	.	T	C	2	0	2	0	5	7	0	0
14	49996921	.	T	C	3	2	5	0	0	5	0	0
14	49997004	.	G	A	4	2	6	0	0	6	0	0
14	49997040	.	A	G	3	2	5	0	0	5	0	0
14	49997043	.	T	C	2	3	5	0	0	5	0	0
14	49997115	.	G	A	1	2	3	0	0	3	0	0
14	49997246	.	A	G	5	4	9	0	2	11	0	0
14	49997276	.	G	A	5	4	9	0	2	11	0	0
14	49997867	.	G	A	6	4	10	0	0	10	0	0
14	50798988	.	C	T	36	39	75	0	7	82	0	0
14	50808007	.	T	C	3	3	6	0	0	6	0	0
14	50808063	.	A	C	1	4	5	0	1	6	0	0
14	50962369	.	T	C	2	2	4	0	0	4	0	0
14	50972733	.	G	A	0	3	3	0	2	5	0	0
14	50972963	.	C	T	1	5	6	0	0	6	0	0
14	50973219	.	A	G	1	6	7	0	1	8	0	0
14	50973374	.	C	A	1	3	4	0	0	4	0	0
14	50974538	.	C	A	1	6	7	0	2	9	0	0
14	50974785	.	C	G	2	5	7	0	0	7	0	0
14	50974827	.	A	G	1	3	4	0	0	4	0	0
14	50994361	.	A	G	10	4	14	0	1	15	0	0
14	50994436	.	C	G	8	7	15	0	1	16	0	0
14	50994687	.	G	T	21	13	34	0	3	37	0	0
14	50994695	.	G	C	20	16	36	0	1	37	0	0
14	50999698	.	A	G	9	7	16	0	0	16	0	0
14	51002874	.	G	C	18	0	18	0	17	35	0	0
14	51012349	.	C	T	5	2	7	0	0	7	0	0
14	51014221	.	T	G	8	6	14	0	0	14	0	0
14	51015245	.	C	T	12	5	17	0	2	19	0	0
14	51015264	.	A	G	18	8	26	0	0	26	0	0
14	51015359	.	G	C	18	12	30	0	0	31	1	0
14	51017771	.	G	A	1	19	20	0	11	31	0	0
14	51017841	.	A	G	16	13	29	0	0	29	0	0
14	51017906	.	A	T	6	14	20	0	0	20	0	0
14	51017952	.	G	A	0	10	10	0	7	17	0	0
14	51024089	.	A	G	3	5	8	0	0	8	0	0
14	51829341	.	G	A	38	37	75	0	1	77	1	0
14	51830952	.	G	A	32	27	59	0	5	64	0	0
14	52354191	.	C	T	1	2	3	0	0	3	0	0
14	52358971	.	G	C	4	2	6	0	1	7	0	0
14	52366401	.	G	A	10	7	17	0	1	18	0	0
14	52379740	.	T	A	9	7	16	0	0	17	1	0
14	52379749	.	T	A	5	10	15	0	0	15	0	0
14	52381762	.	G	A	7	12	19	7	0	26	0	0
14	52383871	.	G	A	16	10	26	0	1	27	0	0
14	52386667	.	G	A	13	8	21	0	2	23	0	0
14	52388115	.	G	A	9	7	16	0	1	17	0	0
14	52388136	.	G	C	8	7	15	0	0	15	0	0
14	52388357	.	G	A	6	6	12	0	1	13	0	0
14	52388360	.	G	T	7	6	13	0	1	14	0	0
14	52399977	.	A	G	2	2	4	0	0	4	0	0
14	52408723	.	T	C	5	2	7	0	0	7	0	0
14	52411301	.	G	A	0	7	7	0	9	16	0	0
14	52411315	.	C	G	10	7	17	0	0	17	0	0
14	52413182	.	C	T	7	4	11	0	0	11	0	0
14	52417306	.	A	G	1	0	1	0	7	8	0	0
14	52417537	.	C	T	5	6	11	0	0	11	0	0
14	52417555	.	T	C	3	7	10	0	0	10	0	0
14	52418070	.	T	G	4	3	7	0	0	7	0	0
14	52418307	.	T	G	13	7	20	0	0	20	0	0
14	52418308	.	T	A	12	7	19	0	1	20	0	0
14	52418565	.	T	G	10	3	13	0	9	22	0	0
14	52418772	.	G	T	15	5	20	0	0	21	1	0
14	52418818	.	A	G	10	9	19	0	1	20	0	0
14	52419007	.	C	G	9	3	12	0	0	12	0	0
14	52419266	.	C	T	1	1	2	0	1	3	0	0
14	52476624	.	T	C	1	4	5	0	2	7	0	0
14	52490168	.	C	G	4	4	8	0	1	9	0	0
14	52490198	.	G	A	0	2	2	0	4	6	0	0
14	52494438	.	A	G	4	5	9	0	0	9	0	0
14	52494442	.	T	C	3	5	8	0	0	8	0	0
14	52517957	.	T	C	15	8	23	0	0	23	0	0
14	52518002	.	A	G	15	6	21	0	4	25	0	0
14	52518030	.	G	A	1	14	15	0	15	30	0	0
14	52518125	.	C	A	1	13	14	0	3	17	0	0
14	52518278	.	G	C	1	7	8	0	8	16	0	0
14	52518538	.	T	C	1	2	3	0	0	3	0	0
14	52518542	.	G	A	1	2	3	0	0	3	0	0
14	52520585	.	C	T	1	3	4	0	1	5	0	0
14	52520669	.	G	T	3	2	5	0	0	5	0	0
14	52522820	.	T	C	14	6	20	1	1	22	0	0
14	52522822	.	C	T	15	6	21	1	0	22	0	0
14	52522876	.	C	T	12	13	25	0	1	26	0	0
14	52523087	.	G	A	16	11	27	0	2	29	0	0
14	52523131	.	G	A	8	9	17	0	1	18	0	0
14	52523237	.	G	C	2	3	5	0	4	10	1	0
14	52523290	.	C	T	1	4	5	0	9	14	0	0
14	52523478	.	T	C	14	9	23	0	1	24	0	0
14	52523493	.	T	C	10	11	21	0	2	23	0	0
14	52523520	.	T	A	8	9	17	0	0	17	0	0
14	52523531	.	C	T	2	9	11	0	2	13	0	0
14	52523707	.	A	G	9	11	20	0	3	23	0	0
14	52523798	.	C	T	8	5	13	1	0	14	0	0
14	52524195	.	C	A	10	9	19	0	0	19	0	0
14	52524307	.	G	A	9	4	13	0	0	13	0	0
14	52524364	.	C	T	1	9	10	0	7	17	0	0
14	52524399	.	G	A	6	7	13	0	0	13	0	0
14	52524525	.	A	T	4	4	8	0	0	8	0	0
14	52524687	.	T	A	1	8	9	0	0	9	0	0
14	52524792	.	A	G	12	3	15	0	0	15	0	0
14	52524889	.	G	A	2	2	4	7	0	11	0	0
14	52524890	.	A	T	2	2	4	7	0	11	0	0
14	52525016	.	C	T	0	10	10	0	8	18	0	0
14	52525326	.	C	T	1	3	4	0	9	13	0	0
14	52525340	.	T	A	9	4	13	0	2	15	0	0
14	52525376	.	T	C	9	5	14	0	1	15	0	0
14	52525673	.	G	A	6	8	14	0	0	14	0	0
14	52525812	.	C	T	2	11	13	0	9	22	0	0
14	52528210	.	G	A	3	7	10	0	0	10	0	0
14	52531368	.	G	C	12	0	12	0	8	20	0	0
14	52531384	.	T	C	11	10	21	0	1	22	0	0
14	52533578	.	T	C	7	8	15	0	1	16	0	0
14	52533584	.	T	C	7	0	7	0	8	15	0	0
14	52538887	.	G	A	6	3	9	0	1	10	0	0
14	52565823	.	C	T	43	28	71	0	4	75	0	0
14	52571230	.	A	G	2	3	5	0	1	6	0	0
14	52574434	.	C	G	1	7	8	0	0	8	0	0
14	52574497	.	C	A	4	2	6	1	0	7	0	0
14	52574954	.	C	G	1	4	5	0	0	5	0	0
14	52574979	.	C	T	0	3	3	0	2	5	0	0
14	52575012	.	C	G	5	3	8	0	1	9	0	0
14	52575646	.	C	T	3	4	7	0	1	8	0	0
14	52575738	.	C	T	9	7	16	0	5	21	0	0
14	52575878	.	A	G	5	10	15	0	0	15	0	0
14	52575879	.	T	A	5	10	15	0	0	15	0	0
14	52577036	.	G	A	6	3	9	0	0	9	0	0
14	52583001	.	C	A	4	3	7	0	0	7	0	0
15	784276	.	T	G	1	2	3	6	0	9	0	0
15	784368	.	G	C	3	2	5	0	0	5	0	0
15	886216	.	A	G	1	0	1	0	3	4	0	0
15	908257	.	T	C	3	3	6	3	1	10	0	0
15	910070	.	T	A	1	2	3	0	0	3	0	0
15	1026038	.	C	T	2	3	5	0	0	5	0	0
15	1026045	.	T	A	2	3	5	0	0	5	0	0
15	1033435	.	A	T	11	3	14	0	1	15	0	0
15	1033479	.	T	G	4	2	6	0	0	6	0	0
15	1033564	.	G	T	8	4	12	0	0	12	0	0
15	1033853	.	A	G	8	5	13	0	0	13	0	0
15	1033955	.	C	T	0	4	4	0	8	12	0	0
15	1036614	.	C	T	2	4	6	0	0	6	0	0
15	1036677	.	C	T	4	4	8	0	4	12	0	0
15	1038152	.	A	T	4	3	7	0	0	7	0	0
15	1152067	.	T	C	1	3	4	0	0	4	0	0
15	1162495	.	G	C	1	2	3	0	0	3	0	0
15	1167166	.	G	A	1	2	3	0	2	5	0	0
15	1167179	.	C	T	1	2	3	0	0	3	0	0
15	1173067	.	C	T	1	2	3	0	0	3	0	0
15	1173542	.	C	T	7	5	12	0	0	12	0	0
15	1176447	.	G	A	0	6	6	0	4	10	0	0
15	1178927	.	C	A	7	6	13	0	1	14	0	0
15	1183930	.	G	T	14	9	23	0	0	23	0	0
15	1184660	.	A	G	5	2	7	1	0	8	0	0
15	1186181	.	A	G	8	8	16	0	0	16	0	0
15	1186202	.	C	T	0	7	7	0	10	17	0	0
15	1189664	.	C	T	14	13	27	0	1	28	0	0
15	1191750	.	A	G	21	9	30	0	0	30	0	0
15	1191792	.	G	A	3	11	14	0	12	26	0	0
15	1191822	.	A	G	14	0	14	0	10	24	0	0
15	1194590	.	A	G	10	8	18	0	1	19	0	0
15	1194619	.	G	A	1	11	12	0	13	25	0	0
15	1194633	.	A	G	10	12	22	0	0	22	0	0
15	1194670	.	G	A	17	8	25	0	0	25	0	0
15	1194739	.	G	T	14	3	17	0	1	18	0	0
15	1194754	.	T	C	7	2	9	0	2	11	0	0
15	1417032	.	G	A	2	13	15	0	21	36	0	0
15	1417104	.	C	T	18	11	29	0	2	31	0	0
15	1434192	.	T	A	24	12	36	0	3	39	0	0
15	1434228	.	T	C	25	9	34	0	3	37	0	0
15	1434885	.	T	C	12	12	24	0	0	24	0	0
15	1435024	.	T	C	18	18	36	1	1	38	0	0
15	1435047	.	A	G	15	29	44	0	2	46	0	0
15	1435176	.	A	G	20	0	20	0	20	40	0	0
15	1435196	.	G	A	28	14	42	0	3	45	0	0
15	1435368	.	T	A	19	18	37	0	1	38	0	0
15	1435462	.	G	A	2	13	15	0	16	31	0	0
15	1435626	.	G	A	18	9	27	0	3	30	0	0
15	1435680	.	T	A	20	10	30	0	0	30	0	0
15	1435699	.	A	T	15	6	21	0	2	23	0	0
15	1436041	.	C	A	18	8	26	2	1	29	0	0
15	1436072	.	T	A	22	19	41	1	3	45	0	0
15	1436154	.	T	C	7	34	41	0	1	42	0	0
15	1436386	.	G	A	0	18	18	3	39	60	0	0
15	1436457	.	C	A	12	12	24	1	15	40	0	0
15	1436461	.	A	G	10	15	25	1	13	39	0	0
15	1436537	.	C	T	26	18	44	0	0	44	0	0
15	1436629	.	T	C	6	13	19	0	2	21	0	0
15	1453457	.	T	A	1	2	3	0	0	3	0	0
15	1453468	.	A	T	1	2	3	0	0	3	0	0
15	1459450	.	C	G	2	4	6	0	1	7	0	0
15	1471406	.	C	G	1	0	1	0	2	3	0	0
15	1495037	.	C	A	4	10	14	0	18	32	0	0
15	1495040	.	C	T	20	9	29	0	1	30	0	0
15	1497353	.	G	A	13	9	22	0	1	23	0	0
15	1497398	.	C	G	12	7	19	0	1	20	0	0
15	1497443	.	A	G	12	6	18	0	1	19	0	0
15	1497982	.	T	A	8	6	14	0	1	15	0	0
15	1499732	.	C	T	6	9	15	0	0	15	0	0
15	1506392	.	A	G	2	4	6	0	0	6	0	0
15	1506503	.	C	T	0	8	8	0	3	11	0	0
15	1602952	.	A	G	13	16	29	0	2	31	0	0
15	1606802	.	G	C	11	0	11	0	18	29	0	0
15	1607707	.	G	A	8	14	22	0	1	23	0	0
15	1612770	.	T	C	8	9	17	0	2	19	0	0
15	1612845	.	C	T	0	6	6	0	7	13	0	0
15	1614119	.	G	A	4	4	8	0	1	9	0	0
15	1614128	.	C	T	0	4	4	0	5	9	0	0
15	1617111	.	G	A	5	6	11	0	1	12	0	0
15	1622341	.	C	T	8	7	15	0	0	15	0	0
15	1622390	.	G	C	11	0	11	0	11	22	0	0
15	1630962	.	T	C	4	0	4	0	3	7	0	0
15	1631004	.	C	A	1	5	6	0	0	6	0	0
15	1631011	.	T	A	2	3	5	0	0	5	0	0
15	1631086	.	T	C	1	5	6	0	0	6	0	0
15	1631209	.	T	C	4	0	4	0	13	17	0	0
15	1631241	.	C	G	10	7	17	0	0	17	0	0
15	1631528	.	G	A	3	14	17	1	1	19	0	0
15	1633353	.	A	G	2	13	15	0	0	15	0	0
15	1651295	.	G	A	7	18	25	0	0	25	0	0
15	1651298	.	A	G	6	13	19	0	5	24	0	0
15	1651555	.	G	C	2	0	2	0	4	6	0	0
15	1651634	.	C	A	4	4	8	0	0	8	0	0
15	1661684	.	T	C	2	3	5	0	0	5	0	0
15	1661732	.	T	C	2	10	12	0	0	12	0	0
15	1667756	.	C	T	1	6	7	0	0	7	0	0
15	1667813	.	T	C	3	7	10	0	0	10	0	0
15	1667991	.	A	G	5	0	5	0	5	10	0	0
15	1669719	.	C	T	12	11	23	0	1	24	0	0
15	1672050	.	G	A	0	14	14	0	10	24	0	0
15	1672060	.	G	A	8	12	20	0	2	22	0	0
15	1672130	.	C	T	4	8	12	0	0	12	0	0
15	1672151	.	A	C	4	4	8	0	2	10	0	0
15	1680090	.	C	T	4	3	7	0	0	7	0	0
15	1680092	.	A	C	4	3	7	0	0	7	0	0
15	1681700	.	A	G	5	4	9	0	0	9	0	0
15	1682577	.	C	T	0	2	2	0	1	3	0	0
15	1719371	.	C	T	1	3	4	0	3	7	0	0
15	1719389	.	A	G	3	3	6	0	0	6	0	0
15	1719413	.	C	T	1	3	4	0	1	5	0	0
15	1749973	.	G	C	3	2	5	0	0	5	0	0
15	1749984	.	A	T	4	2	6	0	1	7	0	0
15	1758058	.	G	A	4	2	6	1	0	7	0	0
15	1774417	.	T	C	1	2	3	0	0	3	0	0
15	1774489	.	G	A	0	6	6	0	7	13	0	0
15	1777913	.	C	A	4	3	7	0	0	7	0	0
15	1789281	.	T	A	10	14	24	1	1	26	0	0
15	1789302	.	T	C	10	14	24	1	0	25	0	0
15	1792532	.	T	G	8	9	17	0	1	18	0	0
15	1828388	.	C	T	9	5	14	0	0	14	0	0
15	1828401	.	C	T	6	8	14	0	0	14	0	0
15	1829166	.	C	T	22	18	40	0	1	41	0	0
15	1829310	.	A	G	18	21	39	0	2	41	0	0
15	1830323	.	A	G	8	9	17	0	1	18	0	0
15	1830452	.	G	A	13	10	23	0	1	24	0	0
15	1834326	.	A	G	16	19	35	0	0	35	0	0
15	1837854	.	T	G	15	11	26	0	1	27	0	0
15	1837878	.	G	T	14	13	27	0	0	27	0	0
15	1841328	.	T	C	6	9	15	0	2	17	0	0
15	1847246	.	C	G	7	11	18	0	2	20	0	0
15	1847299	.	G	A	6	7	13	0	1	14	0	0
15	1847310	.	T	A	3	7	10	0	1	11	0	0
15	1847533	.	C	T	7	3	10	0	2	12	0	0
15	1847588	.	A	T	7	6	13	0	1	14	0	0
15	1847679	.	A	G	11	5	16	0	1	17	0	0
15	1847728	.	G	A	11	11	22	0	1	23	0	0
15	1847755	.	G	T	9	12	21	0	1	22	0	0
15	1847931	.	G	A	8	8	16	0	0	16	0	0
15	1853010	.	A	C	5	4	9	0	1	10	0	0
15	1858914	.	G	C	5	0	5	0	5	10	0	0
15	1859013	.	G	A	1	2	3	0	0	3	0	0
15	1862015	.	A	T	2	3	5	0	1	6	0	0
15	1869631	.	A	T	1	4	5	0	0	5	0	0
15	1869712	.	C	T	4	2	6	0	0	6	0	0
15	1894694	.	A	G	3	7	10	0	0	10	0	0
15	1895469	.	G	A	9	11	20	0	0	20	0	0
15	1895505	.	G	C	14	4	18	0	0	18	0	0
15	1897576	.	T	C	6	14	20	0	0	20	0	0
15	1898359	.	G	T	5	3	8	0	0	8	0	0
15	1899831	.	G	A	12	15	27	0	9	36	0	0
15	1902271	.	C	T	6	6	12	0	0	12	0	0
15	1903029	.	A	G	13	5	18	0	1	19	0	0
15	1905412	.	T	C	5	4	9	0	0	9	0	0
15	1915751	.	A	G	3	2	5	0	0	5	0	0
15	1926926	.	A	T	3	3	6	0	1	7	0	0
15	1929484	.	G	T	3	3	6	0	0	6	0	0
15	1933275	.	G	A	1	3	4	0	0	4	0	0
15	2182569	.	G	A	8	13	21	0	1	22	0	0
15	2182752	.	G	C	11	18	29	0	0	29	0	0
15	2182848	.	C	T	11	6	17	0	1	18	0	0
15	2188261	.	G	T	0	3	3	0	0	3	0	0
15	2413923	.	T	G	6	4	10	0	1	11	0	0
15	2413970	.	T	G	3	0	3	0	7	10	0	0
15	2414007	.	A	G	4	2	6	0	0	6	0	0
15	2414140	.	T	A	2	2	4	0	0	4	0	0
15	2414160	.	C	T	2	2	4	0	1	5	0	0
15	2414177	.	G	A	5	3	8	0	1	9	0	0
15	2414584	.	G	T	2	2	4	0	1	5	0	0
15	2414635	.	T	C	3	3	6	0	0	6	0	0
15	2414652	.	T	G	2	2	4	0	0	4	0	0
15	2414867	.	A	G	4	2	6	0	0	6	0	0
15	2414868	.	A	G	4	2	6	0	0	6	0	0
15	2458691	.	C	T	1	2	3	0	0	3	0	0
15	2459903	.	A	G	2	3	5	0	1	6	0	0
15	2459963	.	C	T	2	2	4	0	0	4	0	0
15	2463308	.	T	C	3	3	6	1	2	9	0	0
15	2463309	.	G	C	3	4	7	1	1	9	0	0
15	2485111	.	T	C	4	3	7	0	0	7	0	0
15	2502722	.	T	C	1	2	3	0	0	3	0	0
15	2507763	.	G	A	2	2	4	0	0	5	1	0
15	2515421	.	C	T	7	4	11	0	2	13	0	0
15	2527105	.	G	A	4	3	7	0	2	9	0	0
15	2528777	.	G	A	3	5	8	0	0	8	0	0
15	2529072	.	A	G	4	0	4	0	4	8	0	0
15	2530457	.	A	G	2	0	2	0	2	4	0	0
15	2533340	.	A	G	7	3	10	0	0	10	0	0
15	2533397	.	A	G	3	3	6	0	1	7	0	0
15	2533468	.	C	G	2	4	6	0	0	6	0	0
15	2538060	.	A	G	4	3	7	0	1	8	0	0
15	2539821	.	G	A	4	8	12	0	0	12	0	0
15	2539958	.	C	A	8	3	11	0	1	12	0	0
15	2543388	.	G	T	3	6	9	0	0	9	0	0
15	2543476	.	C	T	7	5	12	0	0	12	0	0
15	2543478	.	T	C	6	5	11	0	1	12	0	0
15	2560436	.	A	G	3	2	5	0	1	6	0	0
15	2560484	.	C	T	3	2	5	0	0	5	0	0
15	2590559	.	A	T	6	2	8	0	0	8	0	0
15	2590856	.	C	T	1	5	6	0	7	13	0	0
15	2593089	.	C	T	2	2	4	0	0	4	0	0
15	2593092	.	T	C	2	2	4	0	1	5	0	0
15	2674223	.	A	C	2	2	4	0	0	4	0	0
15	2728221	.	C	T	5	8	13	0	18	31	0	0
15	2728330	.	A	G	19	18	37	0	9	46	0	0
15	2728573	.	C	T	23	10	33	0	2	35	0	0
15	2728641	.	A	C	5	10	15	0	1	16	0	0
15	2728652	.	C	T	5	11	16	0	0	16	0	0
15	2728678	.	G	A	5	13	18	0	0	18	0	0
15	2728806	.	T	G	7	21	28	0	1	29	0	0
15	2728880	.	C	T	1	11	12	0	16	28	0	0
15	2729057	.	G	C	21	5	26	0	0	26	0	0
15	2729971	.	T	C	5	2	7	0	0	7	0	0
15	2730253	.	T	C	9	2	11	0	0	11	0	0
15	2730284	.	T	C	1	1	2	0	11	13	0	0
15	2730292	.	T	C	9	3	12	0	2	14	0	0
15	2730321	.	C	T	8	8	16	0	0	16	0	0
15	2730358	.	T	C	9	5	14	0	0	14	0	0
15	2730364	.	G	C	8	6	14	0	0	14	0	0
15	2730533	.	T	C	11	8	19	0	0	19	0	0
15	2730536	.	G	C	10	0	10	0	8	18	0	0
15	2730705	.	G	A	2	3	5	0	1	6	0	0
15	2730744	.	T	C	4	2	6	0	0	6	0	0
15	2730794	.	T	G	3	2	5	0	0	5	0	0
15	2730798	.	T	G	4	2	6	0	1	7	0	0
15	2730927	.	C	T	3	6	9	0	13	22	0	0
15	2739915	.	G	C	11	6	17	0	1	18	0	0
15	2742070	.	A	T	2	4	6	0	0	6	0	0
15	2744699	.	G	A	1	5	6	0	1	7	0	0
15	2746309	.	A	G	1	6	7	0	0	7	0	0
15	2747608	.	G	A	2	2	4	0	0	4	0	0
15	2747614	.	A	G	3	2	5	0	0	5	0	0
15	2747650	.	C	T	1	5	6	0	0	6	0	0
15	2750716	.	G	T	1	3	4	0	1	5	0	0
15	2851218	.	A	G	1	3	4	0	0	4	0	0
15	2851511	.	A	G	5	7	12	0	0	12	0	0
15	2851550	.	G	A	6	3	9	0	0	9	0	0
15	2851569	.	A	C	7	3	10	0	0	10	0	0
15	2851590	.	C	A	7	2	9	0	0	9	0	0
15	2851862	.	T	C	2	1	3	1	4	8	0	0
15	2852199	.	T	C	3	4	7	0	0	7	0	0
15	2852436	.	T	C	4	3	7	0	0	7	0	0
15	2869241	.	T	C	3	2	5	0	0	5	0	0
15	2876938	.	A	G	4	2	6	0	0	6	0	0
15	2876956	.	G	T	0	3	3	0	6	9	0	0
15	2877011	.	T	A	3	2	5	0	1	6	0	0
15	2932941	.	C	A	1	2	3	0	0	3	0	0
15	2933810	.	G	A	1	2	3	0	0	3	0	0
15	2988126	.	T	A	16	12	28	0	0	28	0	0
15	2988136	.	T	G	15	18	33	0	1	34	0	0
15	2988414	.	C	A	12	16	28	0	3	31	0	0
15	2988420	.	C	T	1	15	16	0	14	30	0	0
15	2989361	.	T	G	7	9	16	0	0	16	0	0
15	2994265	.	C	T	1	9	10	0	7	17	0	0
15	2994309	.	T	G	8	11	19	0	5	24	0	0
15	2995080	.	T	C	10	8	18	0	1	19	0	0
15	2999008	.	C	T	10	8	18	0	0	18	0	0
15	2999113	.	C	A	3	4	7	0	10	17	0	0
15	2999209	.	G	A	10	4	14	0	1	15	0	0
15	3000194	.	T	C	6	12	18	0	0	18	0	0
15	3000311	.	C	T	8	6	14	1	1	16	0	0
15	3000472	.	C	A	6	6	12	0	0	12	0	0
15	3003682	.	T	C	5	0	5	0	9	14	0	0
15	3005511	.	C	T	8	5	13	0	1	14	0	0
15	3005538	.	G	A	6	4	10	0	0	10	0	0
15	3005556	.	C	A	2	5	7	0	5	12	0	0
15	3005578	.	A	G	5	4	9	0	1	10	0	0
15	3009695	.	A	C	4	0	4	0	6	10	0	0
15	3011241	.	C	T	0	6	6	0	3	9	0	0
15	3020470	.	G	A	2	3	5	0	0	5	0	0
15	3020475	.	G	A	2	3	5	0	0	5	0	0
15	3020598	.	T	A	2	2	4	1	1	6	0	0
15	3024971	.	G	T	6	5	11	0	0	11	0	0
15	3027321	.	T	A	5	4	9	0	0	9	0	0
15	3027378	.	T	C	3	0	3	0	4	7	0	0
15	3037393	.	T	C	0	0	0	0	4	4	0	0
15	3134874	.	T	C	0	2	2	0	1	3	0	0
15	3138704	.	A	G	2	2	4	0	0	4	0	0
15	3144060	.	C	T	3	3	6	0	0	6	0	0
15	3150705	.	T	C	1	3	4	0	0	4	0	0
15	3150717	.	T	G	0	2	2	0	1	3	0	0
15	3159972	.	A	G	2	2	4	0	2	6	0	0
15	3159973	.	A	G	4	2	6	0	0	6	0	0
15	3160980	.	A	G	5	3	8	0	0	8	0	0
15	3376837	.	T	C	4	10	14	0	0	14	0	0
15	3376850	.	T	G	4	10	14	0	0	14	0	0
15	3377050	.	C	G	5	3	8	0	0	8	0	0
15	3377205	.	A	C	1	2	3	0	0	3	0	0
15	3377453	.	G	A	0	3	3	0	1	4	0	0
15	3377727	.	T	G	7	5	12	0	0	12	0	0
15	3378164	.	A	C	4	3	7	0	0	7	0	0
15	3378189	.	C	T	7	6	13	0	1	14	0	0
15	3456168	.	A	G	12	10	22	0	0	22	0	0
15	3456169	.	C	T	12	10	22	0	0	22	0	0
15	3456223	.	T	C	8	0	8	0	8	16	0	0
15	3456306	.	T	A	12	12	24	0	2	26	0	0
15	3456353	.	G	A	11	7	18	0	0	18	0	0
15	3477016	.	C	T	1	2	3	0	5	8	0	0
15	3531036	.	G	C	1	3	4	0	0	4	0	0
15	3531087	.	T	C	1	4	5	0	0	5	0	0
15	3651308	.	C	G	4	2	6	0	0	6	0	0
15	3651359	.	T	C	7	4	11	0	1	12	0	0
15	3680515	.	T	C	1	6	7	0	0	7	0	0
15	3685012	.	T	C	2	6	8	0	1	9	0	0
15	3688748	.	A	G	2	2	4	0	0	4	0	0
15	3734944	.	C	A	7	6	13	0	0	13	0	0
15	3734950	.	G	A	7	6	13	0	0	13	0	0
15	3735338	.	T	C	1	0	1	0	5	6	0	0
15	3735446	.	C	T	5	2	7	0	1	8	0	0
15	3735977	.	C	T	0	2	2	0	1	3	0	0
15	3781357	.	G	A	2	2	4	0	0	4	0	0
15	3924803	.	A	G	1	4	5	0	1	6	0	0
15	3924873	.	A	G	3	2	5	0	1	6	0	0
15	5916651	.	A	T	1	1	2	0	1	3	0	0
15	5916682	.	A	T	4	2	6	0	0	6	0	0
15	6139807	.	T	G	9	0	9	0	25	34	0	0
15	6778835	.	C	T	5	2	7	0	0	7	0	0
15	6957221	.	C	G	9	10	19	0	3	22	0	0
15	8604835	.	A	C	11	12	23	2	1	26	0	0
15	8605259	.	C	A	13	13	26	0	1	27	0	0
15	8605318	.	G	A	10	20	30	0	0	30	0	0
15	8605452	.	C	A	9	16	25	0	1	26	0	0
15	8605838	.	T	A	12	12	24	0	0	24	0	0
15	8605839	.	A	T	12	12	24	0	0	24	0	0
15	8605972	.	T	A	10	9	19	0	0	19	0	0
15	8606207	.	A	T	5	5	10	0	0	10	0	0
15	8606224	.	G	A	3	5	8	0	1	9	0	0
15	8606256	.	A	C	6	11	17	0	0	17	0	0
15	8606464	.	A	G	13	12	25	0	0	25	0	0
15	8606501	.	G	A	11	8	19	0	3	22	0	0
15	8606507	.	G	A	9	11	20	0	1	21	0	0
15	8606555	.	C	T	2	9	11	0	2	13	0	0
15	8606601	.	A	C	8	9	17	0	2	19	0	0
15	8606619	.	A	G	11	9	20	0	3	23	0	0
15	8606733	.	T	C	7	7	14	0	1	15	0	0
15	8606739	.	A	T	8	10	18	0	0	18	0	0
15	8606799	.	T	G	4	5	9	0	2	11	0	0
15	8606872	.	C	A	8	8	16	0	0	16	0	0
15	8606897	.	T	C	10	3	13	0	0	13	0	0
15	8606940	.	T	G	8	13	21	0	1	22	0	0
15	8606943	.	T	G	8	12	20	0	2	22	0	0
15	8607025	.	T	A	11	13	24	0	1	25	0	0
15	8607182	.	T	A	11	9	20	0	2	22	0	0
15	8607365	.	G	T	11	11	22	0	5	27	0	0
15	8607846	.	T	A	6	7	13	0	0	13	0	0
15	8661671	.	C	T	6	4	10	0	0	10	0	0
15	8797850	.	T	C	23	24	47	0	4	51	0	0
15	8799007	.	A	G	34	12	46	0	3	49	0	0
15	8799060	.	T	G	19	29	48	0	4	52	0	0
15	8799065	.	A	G	27	21	48	0	3	51	0	0
15	8799141	.	T	A	26	22	48	0	0	48	0	0
15	8799462	.	T	A	28	16	44	1	1	46	0	0
15	8799713	.	G	A	24	34	58	0	1	59	0	0
15	8799730	.	T	G	23	4	27	0	32	59	0	0
15	8799831	.	T	C	14	19	33	0	4	37	0	0
15	8799856	.	G	A	19	13	32	0	3	35	0	0
15	8799872	.	C	A	20	10	30	0	4	34	0	0
15	8799892	.	C	T	22	12	34	0	1	35	0	0
15	8799916	.	T	C	14	11	25	0	2	27	0	0
15	8813971	.	G	A	2	3	5	0	2	7	0	0
15	8815050	.	C	T	1	2	3	0	0	3	0	0
15	8990820	.	G	A	1	4	5	0	0	5	0	0
15	8991530	.	A	G	1	4	5	0	0	5	0	0
15	8991591	.	T	C	3	5	8	0	1	9	0	0
15	8991684	.	C	T	1	2	3	0	0	3	0	0
15	8991691	.	C	G	2	2	4	0	0	4	0	0
15	8991738	.	A	G	2	3	5	0	0	5	0	0
15	8991757	.	G	C	1	3	4	0	0	4	0	0
15	8991952	.	T	G	1	2	3	0	0	3	0	0
15	8994163	.	G	A	1	2	3	0	0	3	0	0
15	8994175	.	G	A	1	2	3	0	0	3	0	0
15	9011178	.	C	T	1	6	7	0	0	7	0	0
15	9011230	.	G	A	2	5	7	0	0	7	0	0
15	9020621	.	C	T	1	3	4	0	0	4	0	0
15	9022711	.	A	G	1	2	3	0	0	3	0	0
15	9234102	.	A	C	18	16	34	0	3	37	0	0
15	9234114	.	A	G	22	20	42	0	3	45	0	0
15	9234156	.	A	C	22	32	54	0	3	57	0	0
15	9234634	.	A	T	21	22	43	0	4	47	0	0
15	9234885	.	A	G	29	32	61	0	10	71	0	0
15	9234960	.	C	T	25	37	62	0	0	62	0	0
15	9234972	.	T	C	26	35	61	0	3	64	0	0
15	9235081	.	C	G	36	32	68	0	0	68	0	0
15	9235128	.	A	C	33	28	61	0	3	64	0	0
15	9235254	.	A	G	29	28	57	0	3	60	0	0
15	9235319	.	C	T	35	31	66	0	3	69	0	0
15	9235461	.	T	G	43	13	56	1	6	63	0	0
15	9238101	.	G	A	29	24	53	0	4	58	1	0
15	9249293	.	G	A	25	26	51	0	3	54	0	0
15	9249344	.	C	T	25	34	59	0	0	59	0	0
15	9249346	.	A	G	23	35	58	0	1	59	0	0
15	9272219	.	G	T	10	10	20	7	2	29	0	0
15	9315612	.	C	A	5	4	9	0	0	9	0	0
15	9319051	.	T	C	8	0	8	0	12	20	0	0
15	9367812	.	G	A	9	7	16	0	0	16	0	0
15	9367842	.	T	C	6	5	11	0	2	13	0	0
15	9368757	.	G	A	6	6	12	0	0	12	0	0
15	9368834	.	A	G	9	7	16	0	1	17	0	0
15	9369114	.	T	C	5	10	15	0	2	17	0	0
15	9369344	.	G	T	5	5	10	1	1	12	0	0
15	9369571	.	A	T	8	5	13	0	0	13	0	0
15	9369610	.	A	T	7	6	13	0	0	13	0	0
15	9369651	.	G	C	9	8	17	0	0	17	0	0
15	9369689	.	G	A	10	7	17	0	0	17	0	0
15	9369733	.	C	T	9	6	15	0	0	15	0	0
15	9369737	.	C	G	6	7	13	0	1	14	0	0
15	9369949	.	C	A	1	10	11	0	0	12	1	0
15	9369950	.	T	C	2	9	11	0	1	12	0	0
15	9370477	.	A	G	3	3	6	0	0	6	0	0
15	9370492	.	C	G	3	2	5	0	0	5	0	0
15	9370534	.	T	A	5	8	13	0	0	13	0	0
15	9370553	.	C	T	9	5	14	0	1	15	0	0
15	9370919	.	G	T	2	3	5	0	1	6	0	0
15	9370967	.	T	C	2	0	2	1	4	7	0	0
15	9371303	.	G	A	6	5	11	0	1	12	0	0
15	9371564	.	A	G	7	4	11	0	2	13	0	0
15	9371678	.	A	G	3	3	6	0	0	6	0	0
15	9372053	.	T	C	4	3	7	0	0	7	0	0
15	9372281	.	C	T	4	3	7	0	1	8	0	0
15	9372356	.	T	A	2	3	5	0	0	5	0	0
15	9372500	.	G	A	3	3	6	0	0	6	0	0
15	9372539	.	G	A	1	2	3	0	0	3	0	0
15	9372929	.	C	T	2	2	4	0	0	4	0	0
15	9373205	.	G	A	2	2	4	0	0	4	0	0
15	9373698	.	T	C	1	2	3	0	0	3	0	0
15	9608710	.	A	C	4	0	4	0	2	6	0	0
15	10001851	.	A	G	17	20	37	0	0	37	0	0
15	10002281	.	G	A	11	9	20	0	3	23	0	0
15	10002317	.	G	A	8	11	19	0	0	19	0	0
15	10002524	.	T	C	5	4	9	0	0	9	0	0
15	10002545	.	C	T	6	7	13	0	1	14	0	0
15	10002591	.	A	G	10	8	18	0	0	18	0	0
15	10002882	.	C	A	2	2	4	0	0	4	0	0
15	10003274	.	C	T	14	7	21	0	5	26	0	0
15	10003379	.	G	A	11	9	20	0	0	20	0	0
15	10003647	.	C	T	0	10	10	0	12	22	0	0
15	10003767	.	C	T	1	6	7	0	3	10	0	0
15	10025010	.	T	C	3	2	5	0	0	5	0	0
15	10025185	.	A	G	4	4	8	0	1	9	0	0
15	10025508	.	A	G	2	2	4	0	0	4	0	0
15	10025601	.	G	C	1	0	1	0	6	7	0	0
15	10025949	.	C	T	1	2	3	0	1	4	0	0
15	10027257	.	T	C	1	4	5	0	0	5	0	0
15	10027296	.	A	G	1	3	4	0	0	4	0	0
15	10039775	.	A	G	1	4	5	0	0	5	0	0
15	10065645	.	A	G	2	2	4	0	0	4	0	0
15	10065663	.	A	G	2	2	4	0	0	4	0	0
15	10114854	.	T	C	2	0	2	0	2	4	0	0
15	10114884	.	G	A	2	2	4	0	0	4	0	0
15	10114932	.	C	T	1	2	3	0	0	3	0	0
15	11668065	.	A	G	4	4	8	0	1	9	0	0
15	11668633	.	C	T	3	5	8	0	1	9	0	0
15	11690967	.	T	C	5	6	11	0	3	14	0	0
15	11691008	.	T	G	7	0	7	0	7	14	0	0
15	11757580	.	T	A	7	8	15	0	3	18	0	0
15	11874077	.	T	C	3	2	5	0	0	5	0	0
15	11874647	.	T	C	5	3	8	0	0	8	0	0
15	11953046	.	C	G	0	2	2	0	1	3	0	0
15	11953123	.	A	C	2	3	5	0	0	5	0	0
15	11953682	.	C	T	1	2	3	0	0	3	0	0
15	12103781	.	G	T	2	3	5	0	0	5	0	0
15	12117601	.	T	A	1	2	3	0	0	3	0	0
15	12293289	.	G	A	11	13	24	0	2	26	0	0
15	12319008	.	C	A	14	6	20	0	2	23	1	0
15	12521382	.	T	G	5	5	10	0	3	13	0	0
15	12521405	.	T	G	9	7	16	0	1	17	0	0
15	12521472	.	G	A	15	10	25	0	0	25	0	0
15	12521506	.	A	G	14	8	22	0	0	22	0	0
15	12521680	.	A	C	12	16	28	0	0	28	0	0
15	12521745	.	A	G	7	5	12	0	0	12	0	0
15	12521964	.	A	T	4	3	7	0	1	8	0	0
15	12522031	.	A	T	4	3	7	0	0	7	0	0
15	12522094	.	A	T	3	2	5	0	0	5	0	0
15	12522104	.	T	C	2	3	5	0	0	5	0	0
15	12522132	.	T	G	3	4	7	0	0	7	0	0
15	12522179	.	A	G	6	8	14	0	0	14	0	0
15	12522514	.	G	A	6	4	10	0	0	10	0	0
15	12522673	.	A	G	3	7	10	0	1	11	0	0
15	12522736	.	C	G	5	7	12	0	1	13	0	0
15	12526620	.	G	T	7	9	16	0	2	18	0	0
15	12526623	.	G	T	8	8	16	0	3	19	0	0
15	12526710	.	G	A	6	9	15	0	5	20	0	0
15	12545614	.	G	T	2	2	4	0	0	4	0	0
15	13986586	.	C	T	4	3	7	0	9	16	0	0
15	15445876	.	T	C	2	2	4	0	1	5	0	0
15	15513764	.	T	G	2	2	4	0	0	4	0	0
15	16226577	.	A	G	1	8	9	0	0	9	0	0
15	16937179	.	T	C	5	12	17	0	5	22	0	0
15	16937203	.	T	C	6	11	17	0	2	19	0	0
15	16937216	.	T	C	14	4	18	0	1	19	0	0
15	16937375	.	T	C	4	5	9	0	1	10	0	0
15	16937396	.	T	C	3	4	7	0	2	9	0	0
15	16937653	.	T	C	0	8	8	0	1	9	0	0
15	16937662	.	T	C	0	0	0	0	11	11	0	0
15	16937692	.	T	C	8	4	12	0	1	13	0	0
15	16937702	.	T	C	7	0	7	0	5	12	0	0
15	17124283	.	A	G	11	7	18	0	1	19	0	0
15	17487544	.	A	G	11	9	20	0	1	21	0	0
15	20941492	.	T	A	6	3	9	0	2	11	0	0
15	22047194	.	T	C	2	3	5	0	0	5	0	0
15	22442713	.	A	T	1	11	12	0	0	12	0	0
15	23272020	.	T	A	1	4	5	0	1	6	0	0
15	23468340	.	C	G	0	9	9	0	0	9	0	0
15	23640676	.	A	C	7	0	7	0	33	40	0	0
15	23640678	.	A	C	4	0	4	0	35	39	0	0
15	23818422	.	T	C	17	5	22	0	0	22	0	0
15	24094697	.	T	C	1	8	9	0	0	9	0	0
15	24736413	.	A	G	5	4	9	1	1	11	0	0
15	25346623	.	T	C	1	2	3	0	0	3	0	0
15	25376332	.	A	T	1	4	5	0	0	5	0	0
15	25485278	.	A	G	4	5	9	0	0	9	0	0
15	28759873	.	A	C	5	1	6	0	18	24	0	0
15	30311238	.	C	T	1	8	9	0	0	9	0	0
15	30838498	.	G	A	0	7	7	0	7	14	0	0
15	30838501	.	A	G	7	4	11	1	9	21	0	0
15	30838991	.	C	A	8	10	18	0	6	24	0	0
15	30862848	.	T	C	15	8	23	0	2	25	0	0
15	31877363	.	C	T	4	3	7	0	0	7	0	0
15	31881825	.	G	A	2	2	4	0	0	4	0	0
15	31881873	.	G	A	0	2	2	0	2	4	0	0
15	31889005	.	T	G	3	3	6	0	0	6	0	0
15	31889086	.	A	G	1	7	8	0	0	8	0	0
15	31890902	.	T	G	4	2	6	0	0	6	0	0
15	31893536	.	A	C	6	5	11	0	0	11	0	0
15	31893599	.	C	T	4	5	9	0	1	10	0	0
15	31905040	.	G	A	9	17	26	0	0	26	0	0
15	31905097	.	A	G	14	13	27	0	0	27	0	0
15	31909454	.	A	C	14	14	28	0	1	29	0	0
15	31909819	.	G	A	2	6	8	0	5	13	0	0
15	32194031	.	C	T	4	2	6	0	0	6	0	0
15	32194048	.	T	C	3	2	5	0	0	5	0	0
15	32195020	.	C	T	1	2	3	0	0	3	0	0
15	32195395	.	T	C	6	2	8	0	0	8	0	0
15	32195432	.	G	A	1	4	5	0	0	5	0	0
15	32195521	.	T	C	1	2	3	0	0	3	0	0
15	32195840	.	T	A	2	2	4	0	0	4	0	0
15	32196412	.	C	T	3	4	7	0	1	8	0	0
15	32196685	.	A	T	2	2	4	0	0	4	0	0
15	32197313	.	T	A	4	3	7	0	0	7	0	0
15	32197354	.	G	T	2	3	5	0	1	6	0	0
15	32197453	.	A	G	1	1	2	0	1	3	0	0
15	32197458	.	T	C	1	1	2	0	1	3	0	0
15	32249188	.	G	A	16	10	26	0	0	26	0	0
15	32261461	.	G	C	1	10	11	3	14	28	0	0
15	32261464	.	T	C	10	14	24	3	2	29	0	0
15	32265889	.	T	C	13	18	31	0	1	32	0	0
15	32266557	.	A	T	9	11	20	1	1	22	0	0
15	32266921	.	G	A	1	11	12	0	13	25	0	0
15	32267078	.	A	G	5	8	13	0	0	13	0	0
15	32267120	.	C	A	1	5	6	0	0	6	0	0
15	32350066	.	A	G	9	6	15	9	0	24	0	0
15	32350116	.	G	T	8	11	19	0	0	19	0	0
15	32350515	.	A	G	11	7	18	0	4	22	0	0
15	32887739	.	A	G	8	0	8	0	4	12	0	0
15	32887858	.	A	G	4	5	9	0	0	9	0	0
15	32888117	.	A	G	18	5	23	1	1	25	0	0
15	33853701	.	C	T	2	4	6	0	2	8	0	0
15	33864152	.	A	G	6	7	13	0	0	13	0	0
15	33864266	.	G	A	8	9	17	0	0	17	0	0
15	33864585	.	G	A	13	6	19	0	1	20	0	0
15	33864713	.	T	C	4	4	8	2	0	10	0	0
15	33891825	.	G	A	21	12	33	0	0	33	0	0
15	33891826	.	G	A	20	12	32	0	1	33	0	0
15	33891869	.	G	T	18	6	24	0	1	25	0	0
15	33896117	.	G	T	14	5	19	0	0	19	0	0
15	33896177	.	T	C	15	13	28	0	2	30	0	0
15	33896213	.	T	C	15	1	16	0	13	29	0	0
15	33896303	.	T	A	14	10	24	0	0	24	0	0
15	33896306	.	A	G	10	14	24	0	0	24	0	0
15	33896832	.	T	C	5	8	13	0	2	15	0	0
15	33899556	.	C	G	5	3	8	0	1	9	0	0
15	33899808	.	T	A	6	11	17	0	1	18	0	0
15	33902388	.	C	G	0	3	3	0	2	5	0	0
15	33910546	.	G	C	7	5	12	0	0	12	0	0
15	33970841	.	A	G	16	0	16	0	19	35	0	0
15	33970854	.	C	T	20	18	38	0	0	38	0	0
15	33970907	.	C	T	23	11	34	0	3	37	0	0
15	33971097	.	G	C	16	15	31	0	4	35	0	0
15	33977716	.	A	T	11	17	28	0	5	33	0	0
15	33977760	.	A	G	12	0	12	0	18	30	0	0
15	33977942	.	A	C	10	8	18	0	0	18	0	0
15	33978613	.	G	A	2	3	5	0	0	5	0	0
15	33978633	.	T	C	2	2	4	0	0	4	0	0
15	34074558	.	C	T	4	4	8	0	0	8	0	0
15	34174532	.	T	A	21	17	38	0	0	38	0	0
15	34174568	.	T	A	18	13	31	0	2	33	0	0
15	34174585	.	C	A	23	0	23	0	2	25	0	0
15	34174635	.	T	C	15	9	24	0	1	25	0	0
15	34175101	.	T	C	22	18	40	0	1	41	0	0
15	34175359	.	G	A	11	7	18	0	3	21	0	0
15	34175426	.	T	A	8	12	20	0	0	20	0	0
15	34175718	.	G	A	7	5	12	0	0	12	0	0
15	34175917	.	C	T	12	9	21	1	0	22	0	0
15	34175929	.	C	T	12	11	23	0	1	24	0	0
15	34176203	.	A	T	8	10	18	0	1	19	0	0
15	34176214	.	C	T	9	8	17	0	0	17	0	0
15	34176379	.	A	C	16	5	21	0	1	22	0	0
15	34176841	.	A	T	6	5	11	0	0	11	0	0
15	34176993	.	G	A	10	5	15	0	3	18	0	0
15	34182135	.	G	A	5	4	9	0	0	9	0	0
15	34186690	.	A	T	4	4	8	1	2	11	0	0
15	34189452	.	G	A	6	5	11	0	1	12	0	0
15	34191187	.	T	G	4	0	4	0	10	14	0	0
15	34239191	.	C	T	1	2	3	0	0	3	0	0
15	34335044	.	T	A	2	3	5	0	0	5	0	0
15	34335130	.	T	C	4	2	6	0	0	6	0	0
15	34335147	.	G	A	5	3	8	0	0	8	0	0
15	34335272	.	C	T	4	3	7	0	0	7	0	0
15	34532525	.	C	T	8	9	17	0	0	17	0	0
15	34534245	.	C	G	4	3	7	0	0	7	0	0
15	34534265	.	C	T	2	5	7	0	1	8	0	0
15	34558428	.	G	A	5	4	9	0	1	10	0	0
15	34573337	.	C	T	4	3	7	0	0	7	0	0
15	34573343	.	A	G	3	5	8	0	0	8	0	0
15	34573597	.	A	T	8	4	12	0	0	12	0	0
15	34573952	.	T	A	5	3	8	0	0	8	0	0
15	34573959	.	A	T	5	3	8	0	0	8	0	0
15	34574116	.	G	A	7	7	14	0	0	14	0	0
15	34577749	.	G	A	6	3	9	0	1	10	0	0
15	34585286	.	C	A	3	2	5	0	0	5	0	0
15	34586304	.	A	G	3	3	6	0	0	6	0	0
15	34618456	.	T	G	9	9	18	0	1	19	0	0
15	34618669	.	A	T	14	16	30	0	0	30	0	0
15	34618906	.	C	A	10	14	24	0	3	27	0	0
15	34618948	.	T	G	14	20	34	0	2	36	0	0
15	34618958	.	G	A	14	21	35	0	0	35	0	0
15	34621868	.	G	A	15	11	26	0	1	27	0	0
15	34621875	.	G	A	8	16	24	0	1	25	0	0
15	34627792	.	T	A	10	12	22	0	0	22	0	0
15	34627874	.	T	C	15	12	27	0	1	28	0	0
15	34635321	.	C	A	5	2	7	0	0	7	0	0
15	34635336	.	A	C	7	0	7	0	2	9	0	0
15	34637582	.	C	T	1	5	6	0	6	12	0	0
15	34638847	.	C	T	0	6	6	0	2	8	0	0
15	34641384	.	G	A	3	6	9	0	1	10	0	0
15	35076003	.	C	T	3	3	6	0	0	6	0	0
15	35091591	.	A	G	5	2	7	1	0	8	0	0
15	35102954	.	T	C	1	2	3	1	1	5	0	0
15	35102957	.	G	T	2	2	4	1	0	5	0	0
15	35103145	.	T	C	4	3	7	0	0	7	0	0
15	35103256	.	A	G	1	5	6	0	1	7	0	0
15	35103263	.	G	A	1	6	7	0	0	7	0	0
15	35115699	.	A	G	1	3	4	1	0	5	0	0
15	35156366	.	G	A	1	3	4	0	0	4	0	0
15	35157052	.	T	A	9	4	13	0	0	13	0	0
15	35157054	.	G	A	9	3	12	0	1	13	0	0
15	35158661	.	T	G	10	9	19	0	0	19	0	0
15	35163492	.	T	G	8	6	14	0	1	15	0	0
15	35212318	.	A	T	1	3	4	0	0	4	0	0
15	35212386	.	T	C	4	2	6	0	0	6	0	0
15	35214784	.	T	A	7	6	13	0	0	13	0	0
15	35214859	.	A	C	12	1	13	0	12	25	0	0
15	35214901	.	G	A	9	16	25	0	4	29	0	0
15	35217424	.	G	A	6	3	9	0	2	11	0	0
15	35217475	.	T	C	8	10	18	0	0	18	0	0
15	35217487	.	C	A	0	11	11	0	10	21	0	0
15	35224269	.	G	C	4	7	11	0	0	11	0	0
15	35227221	.	A	T	17	3	20	1	2	23	0	0
15	35247678	.	A	T	14	15	29	0	1	30	0	0
15	35247687	.	A	G	13	15	28	0	0	28	0	0
15	35247729	.	A	G	12	16	28	0	1	29	0	0
15	35247762	.	T	C	8	12	20	0	2	22	0	0
15	35718398	.	A	C	1	2	3	0	1	4	0	0
15	35737680	.	T	C	1	3	4	0	0	4	0	0
15	35760970	.	G	A	1	2	3	0	0	3	0	0
15	35761024	.	T	C	2	4	6	0	0	6	0	0
15	35761027	.	A	G	1	4	5	0	1	6	0	0
15	35761126	.	G	A	0	2	2	0	4	6	0	0
15	35761225	.	G	A	3	6	9	0	0	9	0	0
15	35761516	.	T	C	4	5	9	0	0	9	0	0
15	35780654	.	G	A	1	1	2	0	1	3	0	0
15	35889139	.	G	A	4	4	8	0	0	8	0	0
15	35889183	.	C	A	2	2	4	0	1	5	0	0
15	35889443	.	G	T	5	3	8	0	0	8	0	0
15	35889474	.	G	A	1	4	5	0	2	7	0	0
15	35889810	.	G	A	2	3	5	0	1	6	0	0
15	35890148	.	C	T	2	3	5	0	1	6	0	0
15	35890372	.	T	A	4	2	6	0	0	6	0	0
15	35944474	.	A	C	3	2	5	0	0	5	0	0
15	37230358	.	C	A	7	2	9	0	1	10	0	0
15	37230360	.	C	A	0	8	8	0	1	9	0	0
15	37459438	.	T	C	2	0	2	0	2	4	0	0
15	37459443	.	T	C	1	3	4	0	0	4	0	0
15	37459819	.	T	C	3	1	4	0	2	6	0	0
15	37459841	.	T	C	1	3	4	0	2	6	0	0
15	37459979	.	T	C	3	7	10	0	0	10	0	0
15	37459988	.	T	C	4	0	4	0	7	11	0	0
15	37561708	.	A	G	2	0	2	0	2	4	0	0
15	38218190	.	G	C	1	7	8	0	0	8	0	0
15	38218192	.	A	G	1	6	7	0	1	8	0	0
15	38221279	.	T	C	3	2	5	0	1	6	0	0
15	38221433	.	A	C	3	4	7	0	0	7	0	0
15	38223632	.	C	T	4	2	6	0	1	7	0	0
15	38239605	.	G	A	4	4	8	0	0	8	0	0
15	38258644	.	A	G	3	1	4	0	3	7	0	0
15	38268705	.	T	A	6	2	8	0	0	8	0	0
15	38282687	.	T	C	12	6	18	0	0	18	0	0
15	38287983	.	G	A	10	3	13	2	1	16	0	0
15	38287995	.	A	G	8	3	11	2	1	14	0	0
15	38288104	.	A	C	5	6	11	0	1	12	0	0
15	38289831	.	A	G	7	7	14	0	3	17	0	0
15	38295122	.	T	C	10	9	19	0	1	20	0	0
15	38295158	.	T	C	8	6	14	0	3	17	0	0
15	38295347	.	G	A	14	11	25	0	1	26	0	0
15	38295485	.	C	G	20	13	33	0	1	34	0	0
15	38295545	.	C	T	14	9	23	0	0	23	0	0
15	38295679	.	C	A	5	6	11	0	2	13	0	0
15	38295771	.	G	A	6	10	16	0	1	17	0	0
15	38296305	.	A	G	12	13	25	0	1	26	0	0
15	38296377	.	A	G	6	10	16	0	1	17	0	0
15	38296449	.	T	C	14	9	23	0	3	26	0	0
15	38296885	.	A	G	12	0	12	0	11	23	0	0
15	38296900	.	T	A	13	11	24	0	3	27	0	0
15	38297071	.	T	C	24	21	45	0	1	46	0	0
15	38297214	.	C	T	22	29	51	0	1	52	0	0
15	38297364	.	C	T	11	24	35	0	5	40	0	0
15	38297372	.	A	G	11	28	39	0	2	41	0	0
15	39140568	.	G	A	1	3	4	0	3	7	0	0
15	39141498	.	A	G	5	4	9	0	0	9	0	0
15	39156787	.	T	G	7	0	7	0	6	13	0	0
15	39190103	.	T	G	6	0	6	0	6	12	0	0
15	39207024	.	T	A	12	11	23	0	2	25	0	0
15	39208087	.	G	A	1	11	12	0	10	22	0	0
15	39210450	.	G	A	0	1	1	0	21	22	0	0
15	39223884	.	A	T	7	10	17	0	2	19	0	0
15	39223980	.	T	G	19	14	33	0	1	34	0	0
15	39226661	.	A	T	21	7	28	1	1	30	0	0
15	39228113	.	A	T	17	12	29	0	1	30	0	0
15	39228120	.	A	C	18	12	30	0	1	31	0	0
15	39228174	.	A	G	18	10	28	0	2	30	0	0
15	39281843	.	T	G	8	7	15	0	1	16	0	0
15	39281875	.	A	C	15	4	19	0	1	20	0	0
15	39282007	.	G	C	17	1	18	0	12	30	0	0
15	39282070	.	A	G	14	7	21	0	1	22	0	0
15	39296706	.	A	G	7	8	15	0	2	17	0	0
15	39296751	.	C	T	1	7	8	0	5	14	1	0
15	39296790	.	C	T	2	9	11	0	3	14	0	0
15	39296841	.	A	G	3	5	8	0	0	8	0	0
15	39296982	.	T	C	8	12	20	0	0	20	0	0
15	39296997	.	T	C	8	10	18	0	1	19	0	0
15	39297051	.	G	A	12	16	28	0	4	32	0	0
15	39305598	.	G	A	1	5	6	0	0	6	0	0
15	39312461	.	G	A	3	2	5	0	0	5	0	0
15	39326908	.	A	T	3	3	6	0	0	6	0	0
15	39326914	.	T	C	3	0	3	0	3	6	0	0
15	39559006	.	G	A	1	2	3	0	0	3	0	0
15	39559045	.	A	G	1	1	2	0	1	3	0	0
15	39994313	.	T	C	4	3	7	0	0	7	0	0
15	40002242	.	C	T	4	6	10	0	1	11	0	0
15	40002319	.	C	T	8	6	14	0	1	15	0	0
15	40002325	.	C	T	7	7	14	0	0	14	0	0
15	40002561	.	T	A	6	5	11	0	0	11	0	0
15	40004742	.	C	G	7	7	14	0	0	14	0	0
15	40005174	.	T	G	2	2	4	0	0	4	0	0
15	40005279	.	C	T	4	7	11	0	0	11	0	0
15	40005318	.	T	A	5	9	14	0	0	14	0	0
15	40005342	.	A	T	6	8	14	0	2	16	0	0
15	40005527	.	T	A	10	10	20	0	1	21	0	0
15	40006090	.	A	C	7	11	18	0	1	19	0	0
15	40006136	.	T	C	9	10	19	0	0	19	0	0
15	40008449	.	C	T	19	8	27	0	0	27	0	0
15	40008454	.	C	A	20	6	26	0	2	28	0	0
15	40008537	.	G	T	0	14	14	0	17	31	0	0
15	40008544	.	C	A	17	12	29	0	2	31	0	0
15	40017144	.	A	G	25	24	49	0	3	52	0	0
15	40018500	.	T	C	28	32	60	1	4	65	0	0
15	40027138	.	C	T	30	36	66	0	7	73	0	0
15	40027194	.	A	T	30	37	67	0	3	70	0	0
15	40027279	.	T	C	34	27	61	0	3	64	0	0
15	40027484	.	T	G	22	3	25	0	35	60	0	0
15	40027540	.	A	C	24	29	53	0	4	57	0	0
15	40028103	.	T	A	35	25	60	1	5	66	0	0
15	40028280	.	A	G	42	11	53	0	2	55	0	0
15	40028457	.	T	G	35	33	68	1	2	71	0	0
15	40028568	.	G	A	34	30	64	0	0	64	0	0
15	40028574	.	A	G	24	31	55	0	10	65	0	0
15	40040982	.	G	A	0	3	3	0	1	4	0	0
15	40130431	.	A	G	10	5	15	0	0	15	0	0
15	40130631	.	A	G	19	6	25	0	0	25	0	0
15	40217543	.	T	C	5	2	7	0	0	7	0	0
15	40217640	.	T	C	2	0	2	0	2	4	0	0
15	40217890	.	T	C	5	2	7	0	0	7	0	0
15	41210721	.	G	A	3	3	6	0	0	6	0	0
15	41210739	.	A	G	2	3	5	0	0	5	0	0
15	41234895	.	G	A	4	5	9	0	0	9	0	0
15	41238388	.	G	C	2	2	4	0	1	5	0	0
15	41238715	.	C	T	4	3	7	0	0	7	0	0
15	41249834	.	C	T	0	2	2	0	1	3	0	0
15	41249853	.	A	T	1	4	5	0	0	5	0	0
15	41250075	.	G	A	1	2	3	0	0	3	0	0
15	41253052	.	G	A	1	2	3	0	0	3	0	0
15	41269412	.	G	A	1	2	3	0	0	3	0	0
15	41292003	.	G	A	4	2	6	0	0	6	0	0
15	41292134	.	G	A	5	6	11	0	0	11	0	0
15	41294625	.	T	C	4	3	7	0	2	9	0	0
15	41296910	.	T	C	3	1	4	0	3	7	0	0
15	41296953	.	A	G	5	5	10	0	0	10	0	0
15	41297117	.	A	G	2	4	6	0	0	6	0	0
15	41298905	.	A	G	4	3	7	0	0	7	0	0
15	41298937	.	T	A	5	6	11	0	0	11	0	0
15	41299003	.	T	C	1	3	4	0	0	4	0	0
15	41299073	.	G	A	5	4	9	0	0	9	0	0
15	41299096	.	T	C	6	3	9	0	0	9	0	0
15	41299108	.	C	T	5	3	8	0	0	8	0	0
15	41303747	.	G	A	3	2	5	0	0	5	0	0
15	41303773	.	A	C	5	2	7	0	0	7	0	0
15	41303886	.	A	T	4	2	6	0	1	7	0	0
15	41664144	.	T	A	3	3	6	0	0	6	0	0
15	41664145	.	A	C	3	2	5	0	1	6	0	0
15	41664198	.	C	T	1	2	3	0	1	4	0	0
15	41676929	.	G	A	12	6	18	0	0	18	0	0
15	41676968	.	A	T	6	5	11	0	0	11	0	0
15	41677058	.	C	T	5	6	11	0	0	11	0	0
15	41677130	.	G	A	7	5	12	0	0	12	0	0
15	41683071	.	G	A	1	6	7	0	0	7	0	0
15	41694132	.	C	T	7	6	13	0	3	16	0	0
15	41694163	.	T	A	3	4	7	0	1	8	0	0
15	41694230	.	A	C	3	3	6	0	0	6	0	0
15	41694316	.	T	A	4	5	9	0	0	9	0	0
15	41694894	.	T	A	2	2	4	0	3	7	0	0
15	41695120	.	T	C	4	3	7	0	0	7	0	0
15	41695179	.	T	A	4	6	10	0	0	10	0	0
15	41695270	.	A	T	7	4	11	0	0	11	0	0
15	41695274	.	C	T	7	4	11	0	0	11	0	0
15	41695429	.	G	A	6	5	11	0	0	11	0	0
15	41695481	.	A	T	4	4	8	0	0	8	0	0
15	41695549	.	G	A	3	3	6	0	0	6	0	0
15	41695554	.	C	T	3	4	7	0	0	7	0	0
15	41695590	.	G	T	5	4	9	0	0	9	0	0
15	41695682	.	A	G	4	3	7	0	1	9	1	0
15	41695683	.	C	T	6	2	8	0	1	9	0	0
15	41695725	.	T	C	4	3	7	0	0	7	0	0
15	41696344	.	C	A	3	2	5	0	0	5	0	0
15	41696410	.	G	A	4	2	6	0	0	6	0	0
15	41696500	.	G	A	4	2	6	0	0	6	0	0
15	41700377	.	T	C	2	0	2	0	3	5	0	0
15	41700394	.	A	T	1	3	4	0	0	4	0	0
15	41768064	.	T	C	2	3	5	0	0	5	0	0
15	41768169	.	G	A	1	4	5	0	0	5	0	0
15	41768945	.	T	C	0	3	3	0	0	3	0	0
15	41768952	.	T	C	2	2	4	0	0	4	0	0
15	41769431	.	T	C	1	4	5	0	0	5	0	0
15	41843107	.	C	T	4	3	7	0	0	7	0	0
15	41843134	.	T	A	2	2	4	0	0	4	0	0
15	41843144	.	C	T	1	2	3	0	0	3	0	0
15	41845038	.	G	C	6	5	11	0	0	11	0	0
15	41845059	.	A	C	6	3	9	0	3	12	0	0
15	41845139	.	C	T	5	4	9	0	0	9	0	0
15	41845253	.	A	T	6	4	10	0	0	10	0	0
15	41845310	.	G	T	3	5	8	0	1	9	0	0
15	41845678	.	A	T	3	3	6	0	0	6	0	0
15	41845681	.	C	A	3	3	6	0	0	6	0	0
15	41948220	.	C	G	4	4	8	0	0	8	0	0
15	41948270	.	T	A	4	7	11	0	0	11	0	0
15	41948764	.	G	A	6	2	8	0	0	8	0	0
15	41948842	.	G	A	1	2	3	0	0	3	0	0
15	41948986	.	C	A	3	5	8	0	0	8	0	0
15	41948999	.	C	G	3	3	6	0	1	7	0	0
15	41949768	.	C	T	1	2	3	0	5	8	0	0
15	41950245	.	G	T	1	4	5	0	0	5	0	0
15	41950369	.	G	A	1	3	4	0	1	5	0	0
15	41950379	.	G	A	2	4	6	0	0	6	0	0
15	41951048	.	T	G	1	4	5	0	0	5	0	0
15	41951049	.	G	A	1	4	5	0	0	5	0	0
15	42264934	.	C	T	10	3	13	0	0	13	0	0
15	42264955	.	C	T	1	5	6	0	14	20	0	0
15	42265263	.	A	G	18	17	35	0	1	36	0	0
15	42267408	.	T	A	16	12	28	0	1	29	0	0
15	42278936	.	T	A	4	4	8	0	1	9	0	0
15	42280689	.	G	A	4	5	9	1	0	10	0	0
15	42280719	.	T	A	7	3	10	0	0	10	0	0
15	42283746	.	C	T	3	5	8	0	1	9	0	0
15	42285766	.	A	G	6	0	6	0	5	11	0	0
15	42285767	.	G	T	6	5	11	0	0	11	0	0
15	42296654	.	A	G	9	0	9	0	13	22	0	0
15	42296717	.	T	G	7	1	8	0	12	20	0	0
15	42296753	.	C	T	6	9	15	0	1	16	0	0
15	42297528	.	A	G	7	0	7	0	10	17	0	0
15	42302990	.	A	G	13	5	18	0	1	19	0	0
15	42303020	.	A	T	8	6	14	0	3	17	0	0
15	42304851	.	C	T	6	7	13	0	1	14	0	0
15	42317072	.	T	A	6	4	10	0	1	11	0	0
15	42344874	.	C	G	5	5	10	0	1	11	0	0
15	42346771	.	C	A	2	3	5	0	0	5	0	0
15	42346818	.	A	T	2	3	5	0	0	5	0	0
15	42346902	.	C	T	3	12	15	0	0	15	0	0
15	42346951	.	A	T	6	8	14	0	0	14	0	0
15	42346958	.	C	T	7	6	13	0	0	13	0	0
15	42545582	.	G	A	3	3	6	0	0	6	0	0
15	42550961	.	C	T	2	2	4	0	1	5	0	0
15	42672669	.	T	C	1	3	4	0	0	4	0	0
15	42958677	.	C	T	2	3	5	0	0	5	0	0
15	42980862	.	T	C	2	2	4	0	0	4	0	0
15	42981137	.	C	A	3	7	10	0	1	11	0	0
15	42981281	.	A	T	4	3	7	0	0	7	0	0
15	42981303	.	T	A	5	3	8	0	0	8	0	0
15	42981345	.	A	G	2	0	2	0	3	5	0	0
15	42981395	.	T	A	4	4	8	0	0	9	1	0
15	43187423	.	T	C	25	46	71	0	1	72	0	0
15	43195924	.	G	A	37	50	87	1	2	90	0	0
15	43196102	.	A	T	25	52	77	0	1	78	0	0
15	43196106	.	A	G	24	5	29	0	47	76	0	0
15	43196202	.	C	A	16	47	63	0	2	65	0	0
15	43196306	.	C	T	34	37	71	0	6	77	0	0
15	43196341	.	T	A	33	38	71	0	8	79	0	0
15	43196483	.	C	A	21	52	73	0	0	73	0	0
15	43196491	.	T	C	23	45	68	0	5	73	0	0
15	43196803	.	G	A	1	2	3	0	0	3	0	0
15	43196804	.	A	C	1	2	3	0	0	3	0	0
15	43216326	.	G	T	5	5	10	0	2	12	0	0
15	43216350	.	A	G	5	2	7	0	0	7	0	0
15	43237625	.	G	T	4	7	11	0	1	12	0	0
15	43241989	.	A	C	7	4	11	0	0	11	0	0
15	43242006	.	G	A	4	5	9	0	0	9	0	0
15	43245362	.	A	G	23	21	44	0	0	44	0	0
15	43245371	.	T	A	24	21	45	0	2	47	0	0
15	43257039	.	T	C	7	17	24	0	1	25	0	0
15	43260531	.	G	A	9	8	17	0	0	17	0	0
15	43260609	.	A	G	10	4	14	0	1	15	0	0
15	43287371	.	C	G	3	2	5	0	2	7	0	0
15	43287431	.	G	A	6	2	8	0	0	8	0	0
15	43287481	.	T	G	4	4	8	0	0	8	0	0
15	43312689	.	T	C	1	2	3	0	0	3	0	0
15	43457873	.	T	A	2	2	4	0	0	4	0	0
15	43488094	.	C	T	4	4	8	0	0	8	0	0
15	43489679	.	T	C	5	6	11	0	1	12	0	0
15	43509743	.	A	G	8	0	8	0	11	19	0	0
15	43509864	.	T	C	7	3	10	0	3	13	0	0
15	43509961	.	C	A	5	2	7	0	0	7	0	0
15	43510116	.	A	C	4	6	10	0	1	11	0	0
15	43510448	.	A	T	6	4	10	0	0	10	0	0
15	43510452	.	T	G	4	4	8	0	1	9	0	0
15	43604190	.	G	A	1	1	2	0	1	3	0	0
15	43604224	.	G	A	2	6	8	0	0	8	0	0
15	43604325	.	G	A	5	4	9	0	0	9	0	0
15	43604690	.	T	A	1	3	4	0	0	4	0	0
15	43604903	.	C	G	5	5	10	0	0	10	0	0
15	43604928	.	A	G	3	5	8	0	0	8	0	0
15	43604988	.	G	C	2	3	5	0	0	5	0	0
15	43605337	.	G	A	1	2	3	0	0	3	0	0
15	43605379	.	T	G	2	2	4	0	0	4	0	0
15	43656522	.	A	G	1	2	3	0	0	3	0	0
15	43917471	.	C	T	1	4	5	0	0	5	0	0
15	43931714	.	C	T	1	5	6	0	0	6	0	0
15	43938527	.	C	T	1	6	7	0	0	7	0	0
15	43966993	.	C	T	1	2	3	0	0	3	0	0
15	43977993	.	A	T	2	2	4	0	0	4	0	0
15	43977995	.	A	T	2	2	4	0	0	4	0	0
15	43978036	.	C	G	1	2	3	0	0	3	0	0
15	43982146	.	T	C	6	3	9	0	0	9	0	0
15	44072776	.	T	C	4	0	4	2	3	9	0	0
15	44072782	.	G	A	3	4	7	2	1	10	0	0
15	44074653	.	A	G	3	2	5	0	0	5	0	0
15	44075125	.	C	T	0	2	2	0	5	7	0	0
15	44077766	.	A	T	4	2	6	0	0	6	0	0
15	44140324	.	T	G	4	0	4	0	4	8	0	0
15	44140360	.	G	A	4	4	8	0	0	8	0	0
15	44140458	.	G	A	2	2	4	0	0	4	0	0
15	44140546	.	T	C	1	2	3	0	1	4	0	0
15	44140780	.	A	G	1	9	10	0	0	10	0	0
15	44140991	.	T	C	2	5	7	0	0	7	0	0
15	44141311	.	A	G	1	5	6	0	0	6	0	0
15	44141644	.	A	C	4	8	12	0	0	12	0	0
15	44252374	.	T	C	2	2	4	0	0	4	0	0
15	44254986	.	A	C	2	3	5	0	0	5	0	0
15	44255001	.	G	A	5	4	9	0	0	9	0	0
15	44255130	.	A	T	2	5	7	0	1	8	0	0
15	44255212	.	A	C	9	7	16	0	0	16	0	0
15	44255438	.	A	G	3	0	3	0	3	6	0	0
15	44283812	.	A	G	2	3	5	0	0	5	0	0
15	44290546	.	C	T	2	2	4	0	1	5	0	0
15	44295044	.	G	A	2	2	4	0	0	4	0	0
15	44295262	.	A	G	2	0	2	0	5	7	0	0
15	44323349	.	T	C	7	5	12	0	0	12	0	0
15	44323436	.	G	A	1	5	6	0	2	8	0	0
15	44323442	.	G	A	3	5	8	0	0	8	0	0
15	44336923	.	A	T	8	4	12	0	0	12	0	0
15	44344283	.	G	A	1	4	5	0	6	11	0	0
15	44345243	.	T	A	6	4	10	0	0	10	0	0
15	44348323	.	C	A	5	2	7	0	1	8	0	0
15	44370890	.	C	A	3	2	5	0	0	5	0	0
15	44371076	.	C	T	1	2	3	0	1	4	0	0
15	44371129	.	C	T	5	2	7	0	0	7	0	0
15	44371289	.	C	T	7	3	10	0	1	11	0	0
15	44371484	.	T	C	1	3	4	0	1	5	0	0
15	44385117	.	T	C	5	4	9	0	0	9	0	0
15	44440314	.	G	T	4	3	7	0	0	7	0	0
15	44440352	.	G	A	6	3	9	0	0	9	0	0
15	44445243	.	C	T	3	6	9	0	0	9	0	0
15	44499653	.	T	A	25	27	52	0	4	56	0	0
15	44530288	.	T	C	9	0	9	0	9	18	0	0
15	44534976	.	G	A	11	8	19	0	1	20	0	0
15	44559576	.	C	G	12	4	16	0	0	16	0	0
15	44559636	.	T	C	7	0	7	0	8	15	0	0
15	44559646	.	T	A	6	4	10	0	2	12	0	0
15	44559749	.	A	G	3	9	12	0	1	13	0	0
15	44560414	.	T	G	7	6	13	1	0	14	0	0
15	44565727	.	T	A	6	7	13	0	0	13	0	0
15	44625286	.	G	A	1	2	3	0	0	3	0	0
15	44646664	.	G	A	8	6	14	0	1	15	0	0
15	44646676	.	T	C	6	5	11	0	0	11	0	0
15	44647485	.	A	G	7	5	12	0	0	12	0	0
15	44660651	.	C	T	4	2	6	0	0	6	0	0
15	44676968	.	G	A	2	4	6	0	2	8	0	0
15	44714650	.	A	G	1	3	4	0	0	4	0	0
15	44721553	.	G	A	1	3	4	0	0	4	0	0
15	44721559	.	G	A	2	3	5	0	0	5	0	0
15	44755886	.	C	T	0	3	3	0	3	6	0	0
15	45103853	.	C	A	2	4	6	0	0	6	0	0
15	45129761	.	T	C	1	2	3	0	0	3	0	0
15	45131436	.	T	G	1	2	3	0	0	3	0	0
15	45418610	.	G	A	10	19	29	0	2	31	0	0
15	45510169	.	T	A	9	7	16	0	3	19	0	0
15	45544630	.	T	C	4	2	6	0	0	6	0	0
15	45544687	.	C	T	3	2	5	0	0	5	0	0
15	45552439	.	G	C	2	2	4	0	0	4	0	0
15	45555208	.	A	T	4	7	11	0	1	12	0	0
15	45591739	.	G	C	4	4	8	0	1	9	0	0
15	45591753	.	C	G	5	6	11	0	1	12	0	0
15	45595456	.	A	T	2	4	6	0	1	7	0	0
15	45602730	.	T	C	6	5	11	0	3	14	0	0
15	45602878	.	G	A	9	2	11	0	0	11	0	0
15	45612497	.	G	A	0	4	4	0	6	10	0	0
15	45621750	.	C	T	4	2	6	0	0	6	0	0
15	45628074	.	G	A	6	8	14	0	0	14	0	0
15	45634793	.	G	A	13	15	28	0	2	30	0	0
15	45634864	.	T	G	8	8	16	0	1	17	0	0
15	45634865	.	C	T	6	8	14	0	3	17	0	0
15	45634995	.	T	C	2	3	5	0	0	5	0	0
15	45635165	.	G	C	2	2	4	0	0	4	0	0
15	45635178	.	G	A	0	3	3	0	1	4	0	0
15	45635848	.	C	T	14	5	19	0	0	19	0	0
15	45635999	.	G	A	10	7	17	0	1	18	0	0
15	45636066	.	G	A	2	2	4	0	0	4	0	0
15	45636160	.	C	A	1	4	5	0	0	5	0	0
15	45636336	.	A	C	1	3	4	0	0	4	0	0
15	45636504	.	G	T	5	4	9	0	0	9	0	0
15	45637224	.	A	G	14	9	23	0	2	25	0	0
15	46108618	.	G	A	0	5	5	0	2	7	0	0
15	46108696	.	T	C	4	4	8	0	0	8	0	0
15	46108922	.	A	G	4	0	4	0	7	11	0	0
15	46111047	.	T	A	3	4	7	0	0	7	0	0
15	46111152	.	A	G	1	0	1	0	3	4	0	0
15	46111254	.	A	G	2	2	4	0	0	4	0	0
15	46111410	.	A	G	3	3	6	0	0	6	0	0
15	46116133	.	G	A	4	5	9	0	0	9	0	0
15	46116136	.	T	G	4	0	4	0	3	7	0	0
15	46116352	.	A	G	8	4	12	0	1	13	0	0
15	46643768	.	T	C	12	22	34	0	3	37	0	0
15	46649525	.	A	G	13	20	33	0	1	34	0	0
15	46652124	.	A	G	8	11	19	0	0	19	0	0
15	46662011	.	G	T	16	5	21	1	3	25	0	0
15	46662143	.	C	T	7	4	11	1	1	13	0	0
15	46662353	.	T	C	10	9	19	0	0	19	0	0
15	46662393	.	T	C	22	4	26	0	1	27	0	0
15	46662396	.	T	C	22	3	25	0	2	27	0	0
15	46666181	.	T	C	10	0	10	0	8	18	0	0
15	46668250	.	T	A	12	7	19	0	0	19	0	0
15	46687234	.	T	C	2	0	2	0	2	4	0	0
15	46687341	.	T	G	1	3	4	0	0	4	0	0
15	46722651	.	G	A	1	3	4	0	0	4	0	0
15	46722863	.	G	A	4	4	8	0	1	9	0	0
15	46722881	.	A	T	1	3	4	0	0	4	0	0
15	46726371	.	T	C	9	6	15	0	0	15	0	0
15	46727382	.	G	A	5	3	8	0	0	8	0	0
15	46727571	.	G	A	4	2	6	0	0	6	0	0
15	47083234	.	G	A	1	3	4	0	0	4	0	0
15	47083980	.	G	A	0	3	3	0	1	4	0	0
15	47107256	.	A	G	1	2	3	0	0	3	0	0
15	47336295	.	G	A	13	18	31	0	0	31	0	0
15	47386982	.	T	A	3	7	10	1	1	12	0	0
15	47410231	.	C	A	8	5	13	0	1	14	0	0
15	47418607	.	G	A	3	10	13	0	6	19	0	0
15	47418627	.	G	A	7	12	19	0	0	19	0	0
15	47419090	.	G	A	3	7	10	0	19	29	0	0
15	47419096	.	C	T	15	10	25	0	5	30	0	0
15	47419240	.	C	T	13	22	35	1	4	40	0	0
15	47419394	.	C	T	24	13	37	0	1	38	0	0
15	47419395	.	A	T	23	14	37	0	1	38	0	0
15	47420838	.	T	A	24	22	46	0	3	49	0	0
15	47420920	.	G	C	1	32	33	0	1	34	0	0
15	47421203	.	T	C	20	11	31	0	0	31	0	0
15	47421329	.	A	G	14	14	28	0	1	29	0	0
15	47421669	.	C	T	22	14	36	0	2	38	0	0
15	47421675	.	G	C	16	20	36	0	0	36	0	0
15	47448673	.	C	T	1	2	3	0	1	4	0	0
15	47448679	.	A	C	2	2	4	0	0	4	0	0
15	47448720	.	T	G	1	3	4	0	1	5	0	0
15	47448721	.	T	A	1	2	3	0	2	5	0	0
15	47452875	.	G	A	5	3	8	0	0	8	0	0
15	47452895	.	C	A	5	4	9	0	1	10	0	0
15	47453236	.	C	T	4	4	8	0	0	8	0	0
15	47453251	.	A	T	5	5	10	0	0	10	0	0
15	47453288	.	C	G	3	4	7	0	0	7	0	0
15	47453734	.	T	G	2	3	5	0	0	5	0	0
15	47774397	.	A	C	8	0	8	2	21	31	0	0
15	47830665	.	C	T	2	4	6	0	0	6	0	0
15	47830837	.	G	T	4	2	6	0	1	7	0	0
15	47830973	.	C	A	11	4	15	0	1	16	0	0
15	47831096	.	C	T	10	16	26	0	0	26	0	0
15	47831195	.	G	C	10	10	20	0	0	21	1	0
15	47831249	.	C	T	9	4	13	0	0	13	0	0
15	47831265	.	T	A	6	3	9	0	1	10	0	0
15	47831495	.	C	G	13	13	26	0	1	27	0	0
15	47831511	.	C	T	2	16	18	0	11	29	0	0
15	47831565	.	C	A	15	10	25	0	1	26	0	0
15	47831731	.	T	G	3	3	6	0	1	7	0	0
15	47831869	.	G	A	6	2	8	0	1	9	0	0
15	47831983	.	G	A	1	3	4	0	0	4	0	0
15	47831992	.	A	T	1	3	4	0	0	4	0	0
15	47832190	.	G	A	2	3	5	0	0	5	0	0
15	47832203	.	C	A	0	3	3	0	2	5	0	0
15	47832424	.	T	G	3	5	8	0	0	8	0	0
15	47832681	.	G	A	4	2	6	0	0	6	0	0
15	47832930	.	C	T	6	3	9	1	0	10	0	0
15	47832931	.	C	T	0	3	3	1	6	10	0	0
15	47833083	.	G	A	2	5	7	0	4	11	0	0
15	47833493	.	C	T	0	2	2	0	5	7	0	0
15	47833875	.	A	G	1	2	3	0	0	3	0	0
15	47833902	.	G	T	1	4	5	0	0	5	0	0
15	47833971	.	C	A	0	3	3	0	1	4	0	0
15	47834202	.	T	C	2	1	3	0	4	7	0	0
15	47834327	.	C	G	4	3	7	0	0	7	0	0
15	47834487	.	C	T	1	4	5	0	3	8	0	0
15	47845908	.	A	G	18	25	43	0	0	43	0	0
15	47847180	.	T	C	10	0	10	0	22	32	0	0
15	47847373	.	G	A	11	24	35	0	0	35	0	0
15	47848495	.	C	T	22	15	37	0	1	38	0	0
15	47851205	.	T	A	30	35	65	0	0	65	0	0
15	47851342	.	C	G	56	8	64	3	3	70	0	0
15	47851455	.	T	G	32	33	65	0	2	67	0	0
15	47851486	.	G	A	33	32	65	0	2	67	0	0
15	47851522	.	C	T	5	33	38	0	32	70	0	0
15	47851751	.	A	G	34	20	54	0	2	56	0	0
15	47851828	.	G	A	26	16	42	0	3	45	0	0
15	47851978	.	C	T	10	4	14	0	2	17	1	0
15	47851979	.	A	G	12	5	17	0	0	17	0	0
15	47852049	.	G	T	20	14	34	0	0	34	0	0
15	47855085	.	A	G	27	21	48	3	2	53	0	0
15	47856418	.	T	C	48	21	69	4	2	75	0	0
15	47860443	.	C	T	0	21	21	0	15	36	0	0
16	815859	.	C	T	8	10	18	0	1	19	0	0
16	815967	.	G	A	12	10	22	0	1	23	0	0
16	816096	.	A	G	9	16	25	0	1	26	0	0
16	817431	.	T	C	15	12	27	0	1	29	1	0
16	1199273	.	C	T	2	4	6	0	0	6	0	0
16	1199324	.	C	T	1	4	5	0	2	7	0	0
16	1199740	.	A	G	2	3	5	0	0	5	0	0
16	1199741	.	C	T	2	3	5	0	0	5	0	0
16	1207227	.	G	A	5	4	9	0	0	9	0	0
16	1207948	.	C	G	0	6	6	0	1	7	0	0
16	1209528	.	C	T	4	3	7	0	0	7	0	0
16	1209985	.	T	G	3	4	7	0	0	7	0	0
16	1210280	.	G	A	3	6	9	0	0	9	0	0
16	1210403	.	C	T	9	12	21	0	0	21	0	0
16	1228093	.	A	C	8	8	16	0	0	16	0	0
16	1230470	.	C	T	10	7	17	0	0	17	0	0
16	1234138	.	A	T	19	6	25	0	0	25	0	0
16	1239500	.	T	C	23	19	42	0	3	45	0	0
16	1334452	.	C	T	3	4	7	0	1	8	0	0
16	1355316	.	A	T	15	11	26	0	0	26	0	0
16	1355720	.	T	C	9	14	23	0	1	24	0	0
16	1359119	.	T	C	16	16	32	0	1	33	0	0
16	1397484	.	A	T	1	2	3	0	0	3	0	0
16	1397779	.	A	T	3	2	5	0	0	5	0	0
16	1397781	.	C	T	3	2	5	0	0	5	0	0
16	1398447	.	G	A	5	2	7	0	0	7	0	0
16	1398530	.	A	G	1	2	3	0	0	3	0	0
16	1398604	.	A	G	3	0	3	0	4	7	0	0
16	1398877	.	A	T	2	2	4	0	0	4	0	0
16	1398878	.	A	G	2	1	3	0	1	4	0	0
16	1466528	.	C	G	0	2	2	0	1	3	0	0
16	1466850	.	A	G	2	2	4	0	0	4	0	0
16	1467075	.	G	A	2	2	4	0	0	4	0	0
16	1469577	.	T	C	1	2	3	0	0	3	0	0
16	1469578	.	G	C	1	0	1	0	2	3	0	0
16	1523892	.	A	G	4	5	9	0	0	9	0	0
16	1523911	.	G	C	5	0	5	0	7	12	0	0
16	1549920	.	A	G	2	5	7	0	0	7	0	0
16	1551146	.	T	G	3	9	12	0	0	12	0	0
16	1569758	.	A	G	1	2	3	0	0	3	0	0
16	1906682	.	C	A	2	3	5	0	0	5	0	0
16	2009844	.	T	G	3	2	5	0	0	5	0	0
16	2033947	.	A	G	1	0	1	0	3	4	0	0
16	2043021	.	C	T	8	7	15	0	0	15	0	0
16	2043122	.	G	C	1	5	6	0	11	17	0	0
16	2071535	.	G	A	1	6	7	1	9	17	0	0
16	2102189	.	A	T	5	2	7	0	0	7	0	0
16	2102245	.	A	G	5	3	8	0	0	8	0	0
16	2102384	.	A	C	2	2	4	0	0	4	0	0
16	2102385	.	G	C	2	2	4	0	0	4	0	0
16	2102468	.	A	T	0	8	8	0	2	10	0	0
16	2102495	.	A	G	1	0	1	0	4	5	0	0
16	2102683	.	C	T	2	3	5	0	0	5	0	0
16	2102743	.	A	T	10	1	11	0	2	13	0	0
16	2103052	.	C	T	17	10	27	0	1	28	0	0
16	2103058	.	G	T	14	11	25	0	1	26	0	0
16	2103088	.	G	A	1	11	12	0	14	26	0	0
16	2103167	.	C	T	9	4	13	0	0	13	0	0
16	2103209	.	C	T	6	7	13	0	3	16	0	0
16	2103241	.	T	A	10	9	19	0	0	19	0	0
16	2103268	.	A	T	11	13	24	0	0	24	0	0
16	2103307	.	T	C	17	11	28	1	1	30	0	0
16	2103714	.	A	T	3	4	7	0	2	9	0	0
16	2103783	.	A	T	2	2	4	0	1	5	0	0
16	2103798	.	C	T	3	1	4	0	0	4	0	0
16	2104114	.	T	A	3	3	6	1	0	7	0	0
16	2104181	.	T	A	2	2	4	0	1	5	0	0
16	2104312	.	A	C	8	22	30	0	3	33	0	0
16	2104400	.	T	C	11	17	28	0	2	30	0	0
16	2104597	.	T	C	34	21	55	0	0	55	0	0
16	2104604	.	A	G	32	1	33	0	22	55	0	0
16	2105035	.	A	G	6	6	12	0	0	12	0	0
16	2353020	.	C	A	4	3	7	0	1	8	0	0
16	2353023	.	T	C	4	3	7	0	0	7	0	0
16	2353191	.	C	A	6	3	9	0	1	10	0	0
16	2360324	.	C	T	1	2	3	0	0	3	0	0
16	2365716	.	G	A	4	3	7	0	2	9	0	0
16	2382011	.	G	T	1	4	5	0	0	5	0	0
16	2388306	.	T	A	1	2	3	0	0	3	0	0
16	2388309	.	A	T	0	2	2	0	1	3	0	0
16	2472263	.	G	A	8	8	16	0	0	16	0	0
16	2472284	.	T	C	8	8	16	0	0	16	0	0
16	2484064	.	C	T	0	4	4	0	12	16	0	0
16	2485904	.	G	A	11	4	15	0	1	16	0	0
16	2494323	.	T	C	6	0	6	0	4	10	0	0
16	2495649	.	G	C	5	3	8	0	0	8	0	0
16	2517184	.	G	T	5	7	12	0	2	14	0	0
16	2519056	.	T	C	10	3	13	0	1	14	0	0
16	2519071	.	T	C	7	5	12	0	0	12	0	0
16	2525891	.	A	G	6	3	9	0	2	11	0	0
16	2537986	.	G	A	3	4	7	0	1	8	0	0
16	2542782	.	G	C	2	2	4	0	0	4	0	0
16	2545290	.	C	T	0	2	2	0	1	3	0	0
16	2558252	.	G	C	1	3	4	0	0	4	0	0
16	2567316	.	A	G	10	1	11	0	5	16	0	0
16	2568847	.	G	A	0	6	6	0	15	21	0	0
16	2574963	.	C	T	6	13	19	0	1	20	0	0
16	2577717	.	T	A	9	10	19	0	0	19	0	0
16	2580255	.	T	A	13	9	22	0	0	22	0	0
16	2637597	.	A	T	2	3	5	0	0	5	0	0
16	2637703	.	C	A	1	3	4	0	0	4	0	0
16	2637811	.	T	C	2	5	7	0	0	7	0	0
16	2843932	.	T	C	5	6	11	0	1	12	0	0
16	2843950	.	A	C	5	5	10	0	1	12	1	0
16	2987434	.	T	A	1	3	4	0	0	4	0	0
16	3089158	.	C	T	2	7	9	0	0	9	0	0
16	3091150	.	C	T	1	4	5	0	1	6	0	0
16	3091178	.	C	T	2	3	5	0	0	5	0	0
16	3091195	.	A	G	1	2	3	0	0	3	0	0
16	3091279	.	A	C	2	8	10	0	0	10	0	0
16	3091288	.	G	A	4	7	11	0	0	11	0	0
16	3095897	.	T	C	1	3	4	0	0	4	0	0
16	3096160	.	C	G	1	5	6	0	0	6	0	0
16	3096166	.	T	C	1	5	6	0	0	6	0	0
16	3096319	.	T	C	4	6	10	0	1	11	0	0
16	3096384	.	C	T	3	6	9	0	0	9	0	0
16	3096420	.	T	C	3	7	10	0	0	10	0	0
16	3096446	.	A	T	4	9	13	0	1	14	0	0
16	3096516	.	G	A	5	6	11	0	1	12	0	0
16	3463895	.	A	G	4	3	7	0	1	8	0	0
16	3470212	.	G	A	3	4	7	0	2	9	0	0
16	3470332	.	A	G	3	2	5	0	1	6	0	0
16	3499306	.	G	A	2	3	5	0	0	5	0	0
16	3548551	.	T	C	2	0	2	0	2	4	0	0
16	4100650	.	C	G	3	2	5	0	0	5	0	0
16	4110155	.	C	A	3	3	6	0	0	6	0	0
16	4117624	.	G	A	2	6	8	0	0	8	0	0
16	4117682	.	G	C	3	7	10	0	1	11	0	0
16	4118991	.	G	A	1	2	3	0	0	3	0	0
16	4124384	.	C	T	3	2	5	0	0	5	0	0
16	4126464	.	C	T	5	2	7	0	0	7	0	0
16	4126903	.	C	A	3	9	12	0	1	13	0	0
16	4126927	.	C	T	11	3	14	0	0	14	0	0
16	4128322	.	C	T	6	4	10	0	1	11	0	0
16	4129136	.	T	A	5	4	9	0	2	11	0	0
16	4131062	.	T	C	9	5	14	0	0	14	0	0
16	4163503	.	C	T	3	4	7	0	0	7	0	0
16	4168036	.	T	A	4	2	6	2	0	8	0	0
16	4197130	.	T	A	6	5	11	0	0	11	0	0
16	4200749	.	G	T	8	7	15	0	0	15	0	0
16	4201948	.	C	G	11	11	22	0	1	23	0	0
16	4202038	.	C	T	8	7	15	0	0	15	0	0
16	4202128	.	A	G	12	11	23	0	2	25	0	0
16	4287757	.	C	G	3	9	12	0	1	14	1	0
16	4287783	.	C	T	3	7	10	0	1	11	0	0
16	4287936	.	C	T	0	2	2	0	4	6	0	0
16	4288078	.	C	A	0	3	3	0	2	5	0	0
16	4288081	.	T	A	3	2	5	0	0	5	0	0
16	4288656	.	T	A	7	8	15	0	1	16	0	0
16	4513775	.	A	G	1	7	8	0	0	8	0	0
16	4513876	.	A	T	7	8	15	0	1	16	0	0
16	4513901	.	T	C	8	13	21	0	0	21	0	0
16	4513920	.	C	G	10	11	21	0	1	22	0	0
16	4514114	.	T	C	6	1	7	0	7	14	0	0
16	4514467	.	A	T	4	6	10	1	0	11	0	0
16	4514592	.	A	C	5	6	11	0	0	11	0	0
16	4514594	.	T	A	4	6	10	0	1	11	0	0
16	4514633	.	T	C	6	8	14	0	0	14	0	0
16	4514666	.	T	C	10	0	10	0	8	18	0	0
16	4514746	.	T	C	7	1	8	1	4	13	0	0
16	4514795	.	T	C	5	5	10	1	0	12	1	0
16	4517456	.	C	T	2	3	5	0	0	5	0	0
16	4517477	.	G	A	3	3	6	0	0	6	0	0
16	4517606	.	A	G	4	4	8	0	1	9	0	0
16	4533768	.	T	C	6	9	15	0	2	17	0	0
16	4538422	.	A	G	7	7	14	0	1	15	0	0
16	4540805	.	G	T	16	17	33	0	2	35	0	0
16	4540864	.	G	C	4	7	11	0	1	12	0	0
16	4541022	.	A	C	3	9	12	0	1	13	0	0
16	4541061	.	T	G	8	7	15	0	2	17	0	0
16	4541085	.	T	C	11	6	17	1	0	18	0	0
16	4541146	.	G	A	7	3	10	1	0	11	0	0
16	4541233	.	T	C	9	12	21	0	1	22	0	0
16	4541250	.	C	T	7	13	20	0	1	21	0	0
16	4541281	.	A	T	8	6	14	0	0	14	0	0
16	4541931	.	A	C	8	3	11	1	3	15	0	0
16	4541936	.	G	C	8	6	14	1	0	15	0	0
16	4542055	.	C	T	7	3	10	0	0	10	0	0
16	4542060	.	C	T	6	2	8	0	1	9	0	0
16	4542252	.	A	G	2	2	4	0	4	8	0	0
16	4542518	.	C	T	2	13	15	0	13	28	0	0
16	4545454	.	T	C	10	9	19	0	3	22	0	0
16	4546606	.	A	C	11	0	11	0	9	20	0	0
16	4546651	.	G	A	6	10	16	0	1	17	0	0
16	4573588	.	A	G	3	2	5	0	0	5	0	0
16	4587184	.	C	T	1	4	5	1	0	6	0	0
16	4587187	.	G	A	2	2	4	1	0	5	0	0
16	4615993	.	C	A	12	11	23	0	1	24	0	0
16	4616071	.	A	T	23	11	34	1	1	36	0	0
16	4619598	.	A	T	8	15	23	0	1	24	0	0
16	4619614	.	A	G	10	13	23	0	1	24	0	0
16	4628953	.	T	C	4	3	7	0	1	8	0	0
16	4630127	.	G	T	4	5	9	0	0	9	0	0
16	4630143	.	C	T	3	4	7	0	2	9	0	0
16	4695172	.	G	C	0	4	4	0	2	6	0	0
16	4695530	.	A	G	4	2	6	0	0	6	0	0
16	4697599	.	A	G	4	0	4	0	3	7	0	0
16	4697713	.	A	G	5	0	5	0	3	8	0	0
16	4697821	.	G	A	7	3	10	0	0	10	0	0
16	4697829	.	C	G	3	4	7	0	0	7	0	0
16	4700766	.	T	C	4	5	9	0	0	9	0	0
16	4707211	.	G	T	1	4	5	0	12	17	0	0
16	4707480	.	G	A	3	3	6	0	0	6	0	0
16	4711553	.	T	C	1	2	3	0	0	3	0	0
16	4746675	.	A	C	1	7	8	0	0	8	0	0
16	4755816	.	A	T	8	6	14	0	0	14	0	0
16	4759113	.	G	A	4	7	11	0	0	11	0	0
16	4770454	.	A	C	3	2	5	0	0	5	0	0
16	4772950	.	A	G	1	2	3	0	1	4	0	0
16	4782335	.	C	T	1	2	3	0	0	3	0	0
16	4784020	.	T	C	2	3	5	0	0	5	0	0
16	4842203	.	T	A	3	6	9	0	0	9	0	0
16	4842308	.	A	G	3	2	5	0	1	6	0	0
16	4860516	.	A	G	5	3	8	0	1	9	0	0
16	4867445	.	C	T	7	7	14	0	1	15	0	0
16	4867487	.	C	T	13	4	17	0	3	20	0	0
16	4869973	.	G	A	2	6	8	0	0	8	0	0
16	4870180	.	C	T	7	8	15	0	0	15	0	0
16	4872260	.	C	T	5	6	11	0	1	12	0	0
16	4872281	.	G	A	5	5	10	0	0	10	0	0
16	4872320	.	G	A	6	6	12	0	1	13	0	0
16	4872453	.	C	T	3	8	11	0	0	11	0	0
16	4875417	.	C	T	5	3	8	0	1	9	0	0
16	4876470	.	C	T	4	5	9	0	1	10	0	0
16	4879768	.	T	C	1	7	8	0	0	8	0	0
16	4882206	.	C	T	10	7	17	0	0	17	0	0
16	4882491	.	C	T	8	3	11	0	0	11	0	0
16	4882492	.	G	A	1	3	4	0	7	11	0	0
16	4885458	.	T	A	9	11	20	0	2	22	0	0
16	4895423	.	T	C	4	15	19	0	1	20	0	0
16	5014391	.	A	G	4	2	6	0	1	7	0	0
16	5014564	.	A	G	7	12	19	0	0	19	0	0
16	5025494	.	G	A	8	10	18	0	2	20	0	0
16	5105221	.	G	A	12	11	23	0	1	24	0	0
16	5145459	.	T	C	7	14	21	0	2	23	0	0
16	5145599	.	C	A	22	10	32	0	3	35	0	0
16	5145622	.	G	A	19	16	35	0	1	36	0	0
16	5149298	.	T	C	13	13	26	0	2	28	0	0
16	5153956	.	T	C	17	13	30	0	0	30	0	0
16	5159283	.	A	G	1	3	4	0	2	6	0	0
16	5159289	.	C	T	1	4	5	0	1	6	0	0
16	5163275	.	T	C	1	7	8	0	2	10	0	0
16	5164569	.	C	T	3	5	8	0	0	8	0	0
16	5166015	.	G	A	0	12	12	0	11	23	0	0
16	5166030	.	C	T	10	11	21	0	1	22	0	0
16	5166288	.	G	A	12	10	22	0	1	23	0	0
16	5166332	.	T	A	16	9	25	0	1	26	0	0
16	5166351	.	T	C	12	9	21	0	1	23	1	0
16	5166546	.	G	A	3	12	15	0	1	16	0	0
16	5166645	.	A	C	4	15	19	2	0	21	0	0
16	5166719	.	A	G	9	7	16	1	2	19	0	0
16	5166805	.	A	G	6	1	7	0	9	16	0	0
16	5166889	.	G	T	9	9	18	0	0	18	0	0
16	5166977	.	G	T	7	7	14	0	0	14	0	0
16	5167030	.	G	A	8	4	12	0	0	12	0	0
16	5167249	.	A	C	3	8	11	0	0	11	0	0
16	5167257	.	A	G	8	3	11	0	1	12	0	0
16	5187795	.	G	A	3	2	5	0	0	5	0	0
16	5188029	.	A	C	3	7	10	0	0	10	0	0
16	5190168	.	C	T	1	6	7	0	1	8	0	0
16	5190210	.	C	T	2	5	7	0	0	7	0	0
16	5190590	.	A	G	3	3	6	0	0	6	0	0
16	5193353	.	C	T	3	4	7	0	0	7	0	0
16	5193605	.	T	G	4	3	7	0	1	8	0	0
16	5193644	.	G	A	8	6	14	0	0	14	0	0
16	5196630	.	C	T	8	3	11	0	0	11	0	0
16	5199381	.	C	T	2	3	5	0	1	6	0	0
16	5199399	.	C	T	4	3	7	0	0	7	0	0
16	5199503	.	C	T	5	3	8	0	0	8	0	0
16	5205146	.	G	A	0	3	3	0	2	5	0	0
16	5216548	.	G	A	3	8	11	1	1	13	0	0
16	5216707	.	G	C	3	5	8	0	0	8	0	0
16	5221680	.	A	C	2	2	4	0	0	4	0	0
16	5221888	.	T	C	6	6	12	0	0	12	0	0
16	5223355	.	G	A	7	6	13	0	0	13	0	0
16	5223375	.	A	G	7	9	16	0	1	17	0	0
16	5223454	.	C	T	7	10	17	0	0	17	0	0
16	5223470	.	G	A	7	8	15	0	0	15	0	0
16	5223740	.	C	T	11	4	15	0	0	15	0	0
16	5224328	.	A	G	18	8	26	0	0	26	0	0
16	5230627	.	G	A	3	14	17	0	8	25	0	0
16	5230782	.	A	T	10	11	21	0	4	25	0	0
16	5251783	.	G	A	0	2	2	0	4	6	0	0
16	5475185	.	C	T	1	2	3	0	0	3	0	0
16	5475197	.	C	T	1	2	3	0	0	3	0	0
16	5493285	.	A	G	1	3	4	0	0	4	0	0
16	5496874	.	C	A	4	2	6	0	0	6	0	0
16	5496904	.	T	G	3	4	7	0	0	7	0	0
16	5612617	.	A	T	2	2	4	0	0	4	0	0
16	5612631	.	A	T	1	3	4	0	1	5	0	0
16	5633881	.	C	T	2	2	4	0	0	4	0	0
16	5636328	.	T	G	4	0	4	0	3	7	0	0
16	5700055	.	G	A	0	2	2	0	3	5	0	0
16	5700058	.	T	C	3	2	5	0	0	5	0	0
16	5700402	.	A	G	1	2	3	0	0	3	0	0
16	5700534	.	C	T	2	4	6	0	0	6	0	0
16	5702948	.	C	T	2	2	4	0	0	4	0	0
16	5705811	.	G	T	0	3	3	0	3	6	0	0
16	5708077	.	C	A	6	3	9	0	0	9	0	0
16	5708175	.	C	T	1	5	6	0	0	6	0	0
16	5708181	.	G	A	1	3	4	0	3	7	0	0
16	5710627	.	G	T	1	2	3	0	0	3	0	0
16	5776245	.	T	C	16	12	28	0	3	31	0	0
16	5778882	.	A	G	16	24	40	0	0	40	0	0
16	5778913	.	T	C	19	22	41	0	1	43	1	0
16	5786977	.	G	A	10	10	20	1	1	22	0	0
16	5786989	.	C	T	1	9	10	1	13	24	0	0
16	5787396	.	A	G	9	4	13	0	5	18	0	0
16	5787399	.	T	A	10	8	18	0	0	18	0	0
16	5787436	.	C	A	9	5	14	0	3	17	0	0
16	5787562	.	G	A	8	7	15	0	1	16	0	0
16	5787670	.	A	G	3	6	9	0	0	9	0	0
16	5787671	.	G	C	6	3	9	0	0	9	0	0
16	5787911	.	T	G	5	5	10	0	2	12	0	0
16	5788163	.	T	A	3	5	8	0	0	8	0	0
16	5788716	.	C	T	0	4	4	0	4	8	0	0
16	5789124	.	C	A	1	5	6	0	10	16	0	0
16	5789340	.	G	C	6	0	6	0	5	11	0	0
16	5795721	.	C	T	0	4	4	0	8	12	0	0
16	5800670	.	C	T	0	3	3	0	8	11	0	0
16	5806440	.	G	A	1	4	5	0	0	5	0	0
16	5806578	.	G	T	3	3	6	0	0	6	0	0
16	5808868	.	G	T	6	2	8	0	0	8	0	0
16	5808931	.	G	A	3	5	8	0	0	8	0	0
16	5819970	.	T	A	3	3	6	0	0	6	0	0
16	6182755	.	C	T	29	20	49	0	3	52	0	0
16	6191514	.	A	G	33	23	56	0	1	57	0	0
16	6191526	.	G	C	33	22	55	0	3	58	0	0
16	6191622	.	C	G	29	25	54	1	2	57	0	0
16	6192811	.	A	G	13	21	34	0	3	37	0	0
16	6197593	.	G	A	8	11	19	0	1	20	0	0
16	6205657	.	G	T	11	9	20	0	1	21	0	0
16	6356766	.	A	G	6	6	12	0	2	14	0	0
16	6356823	.	T	A	6	6	12	0	0	12	0	0
16	6356850	.	T	C	5	4	9	0	0	9	0	0
16	6362221	.	A	T	4	2	6	0	0	6	0	0
16	6387037	.	G	A	17	28	45	0	3	48	0	0
16	6387121	.	G	A	24	23	47	0	4	51	0	0
16	6387143	.	A	C	33	2	35	0	21	56	0	0
16	6387157	.	A	C	42	20	62	0	1	63	0	0
16	6650631	.	C	A	3	2	5	0	0	5	0	0
16	6653587	.	T	A	1	3	4	0	0	4	0	0
16	6653875	.	G	T	4	4	8	0	0	8	0	0
16	6653883	.	A	G	2	5	7	0	0	7	0	0
16	6745636	.	T	C	2	3	5	0	0	5	0	0
16	6746003	.	C	T	2	2	4	0	0	4	0	0
16	6746038	.	C	A	2	2	4	0	0	4	0	0
16	6747256	.	G	T	10	4	14	0	0	14	0	0
16	6770441	.	A	G	4	2	6	0	1	7	0	0
16	6770455	.	G	A	4	3	7	0	0	7	0	0
16	6771841	.	T	C	2	2	4	0	0	4	0	0
16	6779823	.	C	T	3	2	5	0	0	5	0	0
16	6784866	.	C	T	5	9	14	0	1	15	0	0
16	6787491	.	G	A	1	8	9	0	8	17	0	0
16	6787801	.	A	G	5	0	5	0	6	11	0	0
16	6790964	.	C	T	7	4	11	0	1	12	0	0
16	6790978	.	C	T	4	2	6	0	0	6	0	0
16	6792044	.	C	T	4	9	13	0	1	14	0	0
16	6792059	.	C	G	6	7	13	0	0	13	0	0
16	6796118	.	C	T	5	5	10	0	0	10	0	0
16	6800043	.	G	A	0	4	4	0	8	12	0	0
16	6800127	.	A	G	5	0	5	0	7	12	0	0
16	6800209	.	G	A	5	5	10	0	0	10	0	0
16	6800211	.	A	G	5	1	6	0	4	10	0	0
16	6800330	.	G	C	1	4	5	1	1	7	0	0
16	6800383	.	G	A	5	5	10	0	0	10	0	0
16	6803410	.	C	T	12	3	15	0	0	15	0	0
16	6803429	.	T	C	16	10	26	0	0	26	0	0
16	6803650	.	A	T	19	19	38	5	1	44	0	0
16	6803725	.	T	C	14	20	34	0	2	36	0	0
16	6803887	.	A	G	12	23	35	0	2	37	0	0
16	6820746	.	G	C	14	11	25	0	3	28	0	0
16	6821214	.	G	A	10	16	26	0	0	26	0	0
16	6821248	.	C	T	1	15	16	0	6	22	0	0
16	6821332	.	A	G	7	14	21	0	2	23	0	0
16	6821423	.	A	G	9	13	22	0	2	24	0	0
16	6821465	.	C	T	2	7	9	0	14	23	0	0
16	6821995	.	T	C	11	0	11	0	11	22	0	0
16	6822014	.	G	A	7	13	20	0	0	20	0	0
16	6864838	.	G	A	0	2	2	0	1	3	0	0
16	6923836	.	A	G	3	3	6	0	1	7	0	0
16	6923879	.	G	A	2	2	4	0	1	5	0	0
16	6929832	.	G	A	4	3	7	0	0	7	0	0
16	6929860	.	G	A	3	5	8	0	0	8	0	0
16	6932735	.	A	T	3	2	5	0	0	5	0	0
16	6933004	.	T	C	1	4	5	0	0	5	0	0
16	6933030	.	A	C	2	5	7	0	1	8	0	0
16	6937252	.	C	T	4	3	7	0	0	7	0	0
16	6938038	.	A	T	2	2	4	0	0	4	0	0
16	6938092	.	A	G	2	3	5	0	0	5	0	0
16	6944766	.	T	C	8	15	23	0	1	24	0	0
16	6955048	.	G	A	20	20	40	0	3	43	0	0
16	6955368	.	A	G	15	7	22	1	0	23	0	0
16	7184562	.	C	T	2	2	4	0	1	5	0	0
16	7202513	.	A	C	3	0	3	0	0	6	3	0
16	7203408	.	G	T	1	2	3	0	0	3	0	0
16	7217013	.	A	G	9	9	18	0	1	19	0	0
16	7217052	.	G	T	17	7	24	0	1	25	0	0
16	7220142	.	A	G	11	8	19	0	2	21	0	0
16	7221846	.	C	T	0	5	5	0	6	11	0	0
16	7226998	.	G	A	1	3	4	0	0	4	0	0
16	7242677	.	C	T	1	1	2	0	1	3	0	0
16	7242729	.	A	T	3	2	5	0	1	6	0	0
16	7242735	.	T	A	3	2	5	0	0	5	0	0
16	7242821	.	A	T	2	5	7	0	0	7	0	0
16	7242878	.	A	G	9	6	15	1	0	16	0	0
16	7242961	.	A	G	6	3	9	0	0	9	0	0
16	7250782	.	A	T	2	10	12	0	1	13	0	0
16	7252871	.	T	C	4	24	28	0	0	28	0	0
16	7254778	.	G	A	2	22	24	0	15	39	0	0
16	7259719	.	T	C	13	12	25	0	2	27	0	0
16	7259869	.	T	A	2	11	13	0	0	13	0	0
16	7259900	.	A	G	5	16	21	0	1	22	0	0
16	7259956	.	A	T	14	22	36	0	0	36	0	0
16	7259957	.	G	A	15	21	36	0	1	37	0	0
16	7260097	.	A	T	1	11	12	0	1	13	0	0
16	7260156	.	T	C	2	7	9	0	0	9	0	0
16	7260262	.	G	A	2	7	9	0	0	9	0	0
16	7260280	.	T	A	4	7	11	0	0	11	0	0
16	7315654	.	A	T	2	2	4	0	0	4	0	0
16	7376648	.	C	T	3	2	5	0	0	5	0	0
16	7376900	.	A	G	4	7	11	0	0	11	0	0
16	7385689	.	C	T	7	3	10	0	0	10	0	0
16	7385807	.	C	T	8	5	13	0	1	14	0	0
16	7415215	.	G	A	13	5	18	0	2	20	0	0
16	7415254	.	T	A	11	9	20	0	1	21	0	0
16	7415423	.	C	A	14	8	22	0	0	22	0	0
16	7415435	.	G	A	12	9	21	1	1	23	0	0
16	7415542	.	A	T	14	6	20	0	2	22	0	0
16	7415559	.	C	A	13	5	18	0	1	19	0	0
16	7415761	.	G	A	13	9	22	0	0	22	0	0
16	7415793	.	G	A	11	6	17	0	2	19	0	0
16	7416236	.	C	T	8	11	19	0	1	20	0	0
16	7416320	.	C	T	15	10	25	0	3	28	0	0
16	7416352	.	T	A	13	6	19	0	0	19	0	0
16	7416478	.	G	A	3	3	6	0	0	6	0	0
16	7626589	.	T	C	7	7	14	0	1	15	0	0
16	7630612	.	T	C	16	7	23	0	3	26	0	0
16	7635527	.	C	T	19	7	26	0	1	27	0	0
16	7635721	.	T	A	11	16	27	0	3	30	0	0
16	7638788	.	T	C	15	14	29	0	0	29	0	0
16	7638815	.	A	T	18	16	34	0	0	34	0	0
16	7638828	.	A	G	16	1	17	0	14	31	0	0
16	7638866	.	A	T	15	16	31	0	1	32	0	0
16	7638979	.	C	T	18	18	36	1	2	39	0	0
16	7638984	.	C	A	16	18	34	0	2	36	0	0
16	7639085	.	A	C	29	17	46	0	1	47	0	0
16	7639100	.	T	A	27	19	46	0	2	48	0	0
16	7639401	.	A	C	25	24	49	0	8	57	0	0
16	7639527	.	C	T	18	16	34	0	1	35	0	0
16	7639534	.	G	C	2	18	20	0	18	38	0	0
16	7639621	.	C	T	20	19	39	0	2	41	0	0
16	7639643	.	A	T	22	17	39	0	2	41	0	0
16	7639684	.	A	G	19	9	28	0	3	31	0	0
16	7639774	.	T	A	14	16	30	0	3	34	1	0
16	7639856	.	T	C	15	20	35	0	3	38	0	0
16	7640116	.	A	G	20	20	40	0	4	44	0	0
16	7640127	.	G	A	4	25	29	0	19	48	0	0
16	7640390	.	C	T	26	9	35	0	0	35	0	0
16	7640410	.	A	G	29	12	41	0	0	41	0	0
16	7640425	.	T	A	24	18	42	0	4	46	0	0
16	7640757	.	T	A	15	16	31	0	2	33	0	0
16	7640999	.	G	A	6	3	9	0	0	9	0	0
16	7711556	.	C	A	2	2	4	0	1	5	0	0
16	7716184	.	C	G	5	3	8	0	0	8	0	0
16	7725555	.	A	T	6	5	11	0	0	11	0	0
16	7728408	.	C	T	5	3	8	0	0	8	0	0
16	7743398	.	C	T	1	8	9	0	7	16	0	0
16	7743598	.	T	A	5	3	8	0	0	8	0	0
16	7743687	.	A	G	5	3	8	0	0	8	0	0
16	7744638	.	C	T	2	2	4	0	1	5	0	0
16	7745027	.	C	A	3	4	7	0	1	8	0	0
16	7745053	.	C	G	4	5	9	0	0	9	0	0
16	7745464	.	T	G	2	3	5	0	1	6	0	0
16	7746040	.	G	A	3	2	5	0	0	5	0	0
16	7746152	.	A	T	2	5	7	0	0	7	0	0
16	7746153	.	G	A	2	5	7	0	0	7	0	0
16	7746193	.	G	A	1	4	5	0	0	5	0	0
16	7746859	.	G	A	6	2	8	0	0	8	0	0
16	7758386	.	C	T	3	2	5	0	0	5	0	0
16	7803023	.	T	C	9	9	18	0	0	18	0	0
16	7803298	.	T	C	5	5	10	0	1	11	0	0
16	7803340	.	T	C	4	6	10	0	0	10	0	0
16	7803401	.	A	G	5	0	5	0	0	8	3	0
16	7803418	.	G	C	3	4	7	0	0	7	0	0
16	7803560	.	A	G	7	8	15	0	1	16	0	0
16	7803627	.	T	A	10	7	17	0	0	17	0	0
16	7803765	.	C	G	12	7	19	0	1	20	0	0
16	7803782	.	C	A	2	5	7	0	10	17	0	0
16	7803825	.	A	T	9	5	14	0	2	16	0	0
16	7803859	.	A	C	6	6	12	0	0	12	0	0
16	7803923	.	T	A	8	4	12	0	0	12	0	0
16	7803971	.	T	A	5	5	10	0	0	10	0	0
16	7804269	.	A	T	5	3	8	0	1	9	0	0
16	7804270	.	C	T	5	4	9	0	0	9	0	0
16	7804355	.	C	G	6	6	12	0	0	12	0	0
16	7804391	.	T	C	4	0	4	0	4	8	0	0
16	7804569	.	C	A	2	2	4	0	1	5	0	0
16	7804588	.	C	A	3	3	6	0	0	6	0	0
16	7804688	.	C	T	0	2	2	0	1	3	0	0
16	7804914	.	C	T	2	2	4	0	0	4	0	0
16	7804990	.	A	C	2	2	4	0	1	5	0	0
16	7821241	.	C	T	3	3	6	0	0	6	0	0
16	7821244	.	G	A	2	4	6	0	0	6	0	0
16	7985896	.	T	A	5	2	7	0	0	7	0	0
16	7998969	.	A	G	1	3	4	0	0	4	0	0
16	7999499	.	C	A	6	2	8	0	0	8	0	0
16	8040833	.	C	G	6	4	10	0	0	10	0	0
16	8041234	.	G	A	1	3	4	0	6	10	0	0
16	8041261	.	T	A	5	3	8	0	0	8	0	0
16	8051941	.	T	C	12	0	12	0	21	33	0	0
16	8052033	.	T	C	10	14	24	0	4	28	0	0
16	8052049	.	G	A	12	18	30	1	0	31	0	0
16	8052145	.	C	A	22	18	40	0	1	41	0	0
16	8052537	.	C	T	15	7	22	0	1	23	0	0
16	8052606	.	T	C	13	1	14	0	14	28	0	0
16	8052651	.	T	C	16	11	27	0	1	28	0	0
16	8052673	.	G	C	19	0	19	0	11	30	0	0
16	8052747	.	A	G	11	7	18	0	1	20	1	0
16	8052831	.	T	A	8	13	21	0	2	23	0	0
16	8052866	.	C	A	1	6	7	2	6	15	0	0
16	8052909	.	T	A	5	5	10	6	0	16	0	0
16	8052982	.	T	C	7	5	12	0	0	12	0	0
16	8053206	.	T	G	9	6	15	0	0	15	0	0
16	8053403	.	C	T	16	11	27	0	0	27	0	0
16	8053485	.	C	T	16	6	22	0	1	23	0	0
16	8053716	.	A	G	13	17	30	0	2	32	0	0
16	8053717	.	T	C	12	18	30	0	2	32	0	0
16	8054260	.	T	G	1	3	4	0	0	4	0	0
16	8054290	.	C	T	1	6	7	0	0	7	0	0
16	8054389	.	C	T	1	4	5	0	3	8	0	0
16	8054434	.	T	C	4	0	4	0	9	13	0	0
16	8055037	.	A	G	4	3	7	0	0	7	0	0
16	8059585	.	T	C	4	5	9	0	1	10	0	0
16	8066237	.	A	C	4	3	7	0	2	9	0	0
16	8066318	.	A	G	7	4	11	0	0	11	0	0
16	8119976	.	A	G	5	3	8	0	0	8	0	0
16	8120171	.	C	T	2	5	7	0	0	7	0	0
16	8139786	.	T	C	2	2	4	0	0	4	0	0
16	8161708	.	G	A	1	2	3	0	2	5	0	0
16	8161875	.	C	T	1	2	3	0	0	3	0	0
16	8298915	.	T	C	3	3	6	0	0	6	0	0
16	8299025	.	T	A	7	4	11	0	1	12	0	0
16	8299037	.	A	T	6	4	10	0	1	11	0	0
16	8299123	.	T	A	12	5	17	0	0	17	0	0
16	8299302	.	G	A	2	3	5	0	0	5	0	0
16	8299308	.	T	A	3	3	6	0	1	7	0	0
16	8299410	.	T	A	4	3	7	1	1	9	0	0
16	8299462	.	G	C	5	2	7	0	0	7	0	0
16	8299705	.	G	A	5	2	7	0	0	7	0	0
16	8300218	.	T	A	3	4	7	0	1	8	0	0
16	8300225	.	C	T	0	4	4	0	3	7	0	0
16	8300255	.	G	A	4	4	8	0	0	8	0	0
16	8300269	.	T	C	3	2	5	0	0	5	0	0
16	8300823	.	T	A	2	2	4	0	0	4	0	0
16	8300895	.	C	G	2	3	5	0	0	5	0	0
16	8300989	.	A	G	2	3	5	0	0	5	0	0
16	8301102	.	A	G	2	2	4	0	1	5	0	0
16	8531571	.	A	G	6	6	12	1	0	13	0	0
16	8531907	.	C	A	0	3	3	0	0	4	1	0
16	8531983	.	T	A	2	2	4	0	0	4	0	0
16	8532430	.	G	T	5	3	8	0	0	8	0	0
16	8535966	.	C	T	0	6	6	0	3	9	0	0
16	8539363	.	T	C	1	0	1	0	4	5	0	0
16	8540664	.	G	T	1	2	3	0	0	3	0	0
16	8752017	.	T	A	13	22	35	0	1	36	0	0
16	8752091	.	A	G	13	14	27	0	1	28	0	0
16	8752223	.	C	T	12	16	28	0	4	32	0	0
16	8752316	.	G	T	8	14	22	0	1	23	0	0
16	8752334	.	C	T	1	11	12	0	10	22	0	0
16	8759975	.	G	A	9	16	25	0	0	25	0	0
16	8771162	.	G	A	1	3	4	0	0	4	0	0
16	8771173	.	T	G	1	2	3	0	0	3	0	0
16	8788386	.	T	C	2	4	6	0	0	6	0	0
16	8788446	.	A	G	2	7	9	0	0	9	0	0
16	8788629	.	T	C	7	0	7	0	5	12	0	0
16	8788659	.	G	C	4	3	7	0	0	7	0	0
16	8816122	.	G	A	1	4	5	0	0	5	0	0
16	8819113	.	T	C	2	2	4	0	0	4	0	0
16	9276038	.	T	A	10	13	23	0	0	24	1	0
16	9281297	.	T	C	9	7	16	0	2	18	0	0
16	9281534	.	G	A	6	8	14	0	1	15	0	0
16	9286987	.	A	G	1	5	6	0	0	6	0	0
16	9297728	.	C	T	4	2	6	0	0	6	0	0
16	9299700	.	C	T	2	3	5	0	0	5	0	0
16	9412024	.	A	T	4	4	8	0	0	8	0	0
16	9412048	.	T	C	4	6	10	0	0	10	0	0
16	9412125	.	A	G	3	3	6	0	0	6	0	0
16	9412151	.	T	C	3	4	7	0	0	7	0	0
16	9412177	.	A	G	4	0	4	0	3	7	0	0
16	9412302	.	C	T	2	5	7	0	0	7	0	0
16	9412348	.	C	T	2	2	4	0	1	5	0	0
16	9412350	.	C	T	3	2	5	0	0	5	0	0
16	9412401	.	C	T	3	6	9	0	1	10	0	0
16	9412878	.	C	T	1	2	3	0	0	3	0	0
16	9412994	.	G	T	1	3	4	0	0	4	0	0
16	9415176	.	A	G	4	2	6	0	0	6	0	0
16	9415697	.	T	C	4	8	12	0	0	12	0	0
16	9415749	.	G	A	5	3	8	0	2	10	0	0
16	9416017	.	A	G	4	3	7	0	0	7	0	0
16	9433766	.	T	A	2	3	5	0	0	5	0	0
16	9433786	.	A	G	3	2	5	0	0	5	0	0
16	9433915	.	C	T	0	5	5	0	4	9	0	0
16	9434023	.	G	A	5	4	9	0	1	10	0	0
16	9434036	.	G	A	5	6	11	0	3	14	0	0
16	9437789	.	G	A	10	11	21	0	1	22	0	0
16	9438075	.	A	G	9	7	16	0	1	17	0	0
16	9440440	.	T	C	2	5	7	0	0	7	0	0
16	9585301	.	A	C	3	2	5	0	0	5	0	0
16	9596127	.	C	T	6	2	8	0	0	8	0	0
16	9603382	.	T	C	6	4	10	0	0	10	0	0
16	9605806	.	A	G	6	6	12	0	0	12	0	0
16	9605947	.	A	G	14	6	20	0	1	21	0	0
16	9606011	.	G	T	14	4	18	0	1	19	0	0
16	9606024	.	C	T	12	3	15	0	0	15	0	0
16	9714080	.	G	A	3	2	5	0	0	5	0	0
16	9716237	.	C	A	5	4	9	0	0	9	0	0
16	9716258	.	T	C	4	2	6	0	0	6	0	0
16	9722128	.	A	T	2	3	5	0	1	6	0	0
16	9724878	.	A	T	3	10	13	0	0	13	0	0
16	9724909	.	T	A	2	11	13	0	1	14	0	0
16	9725137	.	A	T	5	2	7	0	0	7	0	0
16	9725196	.	C	G	1	2	3	0	0	3	0	0
16	9745384	.	A	G	1	0	1	0	2	3	0	0
16	9751693	.	A	C	3	3	6	0	2	8	0	0
16	9752999	.	A	G	1	2	3	0	0	3	0	0
16	9753005	.	C	G	1	3	4	0	0	4	0	0
16	9753083	.	A	T	1	2	3	0	0	3	0	0
16	9755701	.	G	A	7	3	10	0	1	11	0	0
16	9755719	.	G	T	1	3	4	0	8	12	0	0
16	9758164	.	C	T	5	5	10	1	0	11	0	0
16	9758944	.	G	A	1	9	10	0	6	16	0	0
16	9758958	.	T	C	4	8	12	0	1	13	0	0
16	9759090	.	T	C	0	8	8	0	1	9	0	0
16	9759244	.	A	G	10	6	16	0	0	16	0	0
16	9759336	.	C	T	4	7	11	0	0	11	0	0
16	9759376	.	C	T	3	10	13	0	0	13	0	0
16	9759464	.	C	G	6	3	9	0	0	9	0	0
16	9759554	.	G	A	0	7	7	0	6	13	0	0
16	9759605	.	A	T	4	9	13	0	1	14	0	0
16	9759820	.	T	A	6	4	10	0	3	13	0	0
16	9760006	.	C	T	4	5	9	0	1	10	0	0
16	9760597	.	A	G	6	0	6	0	3	9	0	0
16	9760718	.	T	C	1	5	6	0	0	6	0	0
16	9761004	.	A	G	7	7	14	0	0	14	0	0
16	9761141	.	G	A	1	11	12	0	10	22	0	0
16	9761246	.	A	G	11	0	11	0	11	22	0	0
16	9761339	.	A	C	7	9	16	0	5	21	0	0
16	9766586	.	A	C	8	3	11	0	0	11	0	0
16	9769846	.	C	T	7	6	13	0	2	15	0	0
16	9777613	.	A	G	13	23	36	0	1	37	0	0
16	9781031	.	T	C	11	10	21	0	0	21	0	0
16	9785860	.	G	A	19	16	35	0	1	36	0	0
16	9785868	.	T	G	18	19	37	0	3	40	0	0
16	9785990	.	G	A	11	9	20	0	3	23	0	0
16	9787392	.	T	A	9	3	12	0	1	13	0	0
16	9787642	.	C	A	4	2	6	0	0	6	0	0
16	9787684	.	C	A	5	2	7	0	1	8	0	0
16	9788005	.	C	T	15	23	38	0	2	40	0	0
16	9788019	.	T	A	23	13	36	0	0	36	0	0
16	9788110	.	C	T	5	5	10	0	1	11	0	0
16	9788194	.	A	C	3	3	6	0	0	6	0	0
16	9788260	.	A	G	5	2	7	0	0	7	0	0
16	9788486	.	G	A	11	9	20	0	1	21	0	0
16	9789007	.	A	T	15	12	27	1	0	28	0	0
16	9789317	.	T	C	6	12	18	0	2	20	0	0
16	9789984	.	T	C	13	12	25	0	2	27	0	0
16	9807287	.	G	T	2	3	5	0	0	5	0	0
16	9807425	.	C	A	4	4	8	0	0	8	0	0
16	9807463	.	A	G	4	5	9	0	0	9	0	0
16	9807475	.	C	T	2	5	7	0	1	9	1	0
16	9811450	.	G	A	2	3	5	0	0	5	0	0
16	9811675	.	G	A	2	3	5	0	0	5	0	0
16	9813388	.	G	A	2	4	6	0	0	6	0	0
16	9813415	.	C	T	3	4	7	0	0	7	0	0
16	9825891	.	G	A	1	2	3	0	0	3	0	0
16	9825893	.	C	G	0	2	2	0	1	3	0	0
16	9833887	.	T	A	34	19	53	0	1	54	0	0
16	9833889	.	C	A	33	19	52	0	2	54	0	0
16	9833936	.	A	G	24	25	49	0	0	49	0	0
16	9833974	.	G	A	19	24	43	0	4	47	0	0
16	9834135	.	A	C	32	16	48	0	1	49	0	0
16	9835058	.	G	A	8	7	15	1	17	33	0	0
16	9835250	.	C	G	18	18	36	0	1	37	0	0
16	9847182	.	T	C	15	12	27	0	2	29	0	0
16	9868953	.	C	T	10	16	26	0	3	29	0	0
16	9980299	.	A	T	12	8	20	1	4	25	0	0
16	10031406	.	C	T	0	2	2	0	2	4	0	0
16	10031572	.	C	A	1	2	3	0	1	4	0	0
16	10038806	.	A	T	2	4	6	0	0	6	0	0
16	10055838	.	C	T	3	4	7	0	0	7	0	0
16	10055952	.	A	G	4	6	10	0	0	10	0	0
16	10055956	.	G	C	4	0	4	0	6	10	0	0
16	10056127	.	T	G	13	7	20	0	0	20	0	0
16	10066194	.	G	A	5	3	8	0	0	8	0	0
16	10071730	.	G	A	2	5	7	0	1	8	0	0
16	10097449	.	G	A	5	4	9	0	0	9	0	0
16	10098423	.	A	T	3	2	5	0	0	5	0	0
16	10098447	.	A	G	3	2	5	0	0	5	0	0
16	10199957	.	A	G	1	2	3	0	1	4	0	0
16	10205161	.	G	T	2	2	4	0	0	4	0	0
16	10210208	.	C	T	1	3	4	0	0	4	0	0
16	10213523	.	A	T	1	2	3	0	0	3	0	0
16	10264382	.	T	A	1	2	3	0	0	3	0	0
16	10284582	.	A	T	3	8	11	0	0	11	0	0
16	10284593	.	T	A	2	7	9	0	0	9	0	0
16	10287677	.	T	G	5	6	11	0	1	12	0	0
16	10287699	.	A	G	4	6	10	0	1	11	0	0
16	10288311	.	G	C	6	4	10	0	0	10	0	0
16	10288859	.	A	T	2	6	8	0	0	8	0	0
16	10288882	.	T	A	2	7	9	0	0	9	0	0
16	10288951	.	G	A	2	3	5	0	1	6	0	0
16	10292715	.	C	T	4	5	9	0	0	9	0	0
16	10292716	.	T	C	4	0	4	0	5	9	0	0
16	10292782	.	A	G	1	3	4	0	1	5	0	0
16	10325723	.	G	A	3	5	8	0	4	12	0	0
16	10325732	.	T	C	6	7	13	0	0	13	0	0
16	10325870	.	C	T	6	13	19	0	0	19	0	0
16	10325960	.	G	A	0	16	16	0	12	28	0	0
16	10326305	.	G	A	2	17	19	0	25	44	0	0
16	10326704	.	C	T	42	21	63	0	2	65	0	0
16	10326737	.	A	G	26	31	57	0	1	58	0	0
16	10326990	.	G	A	6	19	25	0	21	46	0	0
16	10326993	.	A	T	20	23	43	0	1	44	0	0
16	10327128	.	C	T	16	17	33	0	3	36	0	0
16	10327530	.	C	A	19	20	39	0	0	39	0	0
16	10337988	.	C	T	1	3	4	0	0	4	0	0
16	10338255	.	C	G	2	5	7	0	0	7	0	0
16	10338290	.	G	A	0	4	4	0	4	8	0	0
16	10338338	.	T	G	3	2	5	0	1	6	0	0
16	10339682	.	G	A	1	2	3	0	0	3	0	0
16	10339872	.	G	T	6	4	10	0	0	10	0	0
16	10340349	.	G	A	4	2	6	0	0	6	0	0
16	10340399	.	A	T	1	3	4	0	0	4	0	0
16	10340621	.	T	A	0	2	2	0	0	2	0	0
16	10340630	.	G	C	2	2	4	0	0	4	0	0
16	10340840	.	G	A	6	5	11	0	0	11	0	0
16	10340935	.	G	C	2	5	7	0	0	7	0	0
16	10340941	.	T	C	5	2	7	0	0	7	0	0
16	10341470	.	G	A	2	2	4	0	1	5	0	0
16	10341508	.	A	G	2	4	6	0	0	6	0	0
16	10341548	.	G	A	2	6	8	0	0	8	0	0
16	10341778	.	C	A	11	4	15	0	0	15	0	0
16	10341816	.	A	C	2	5	7	0	0	7	0	0
16	10341881	.	A	G	1	6	7	0	0	7	0	0
16	10342275	.	C	T	6	4	10	0	1	11	0	0
16	10345223	.	T	C	5	9	14	0	1	15	0	0
16	10345720	.	A	G	8	9	17	0	1	18	0	0
16	10367475	.	C	A	5	3	8	0	0	8	0	0
16	10367499	.	C	T	2	3	5	0	0	5	0	0
16	10367624	.	G	A	0	4	4	0	3	7	0	0
16	10367674	.	C	T	3	5	8	0	0	8	0	0
16	10369027	.	T	A	1	7	8	0	0	8	0	0
16	10413724	.	A	C	2	6	8	0	0	8	0	0
16	10413726	.	G	T	6	2	8	0	0	8	0	0
16	10413777	.	T	A	2	7	9	0	0	9	0	0
16	10413957	.	T	C	3	11	14	0	1	15	0	0
16	10417124	.	G	C	10	12	22	1	1	24	0	0
16	10426612	.	T	A	2	2	4	0	0	4	0	0
16	10426975	.	A	T	2	4	6	0	1	7	0	0
16	10427722	.	A	T	4	5	9	0	0	9	0	0
16	10427746	.	T	G	3	3	6	0	0	6	0	0
16	10432015	.	C	A	3	2	5	0	0	5	0	0
16	10440612	.	G	A	0	2	2	0	4	6	0	0
16	10444033	.	C	A	3	2	5	0	0	5	0	0
16	10445228	.	C	T	1	3	4	0	0	4	0	0
16	10447409	.	A	G	2	2	4	0	0	4	0	0
16	10447453	.	C	T	2	4	6	0	0	6	0	0
16	10447923	.	C	A	3	2	5	0	0	5	0	0
16	10447983	.	C	T	2	2	4	0	0	4	0	0
16	10448008	.	G	C	2	3	5	0	0	5	0	0
16	10458749	.	A	G	4	2	6	0	0	6	0	0
16	10459006	.	C	A	4	4	8	0	0	8	0	0
16	10464534	.	A	C	11	8	19	0	0	19	0	0
16	10464570	.	T	C	13	6	19	0	1	20	0	0
16	10464571	.	C	T	6	12	18	0	2	20	0	0
16	10464609	.	A	G	10	5	15	0	0	15	0	0
16	10468283	.	T	C	7	7	14	0	1	15	0	0
16	10472192	.	T	C	8	13	21	0	1	22	0	0
16	10475006	.	C	T	18	13	31	0	0	31	0	0
16	10475645	.	C	T	10	9	19	0	1	20	0	0
16	10477905	.	A	G	10	13	23	0	3	26	0	0
16	10478061	.	G	T	17	18	35	0	2	37	0	0
16	10481425	.	C	T	27	9	36	0	0	36	0	0
16	10485445	.	G	A	24	17	41	0	4	45	0	0
16	10502065	.	A	G	13	6	19	0	2	21	0	0
16	10502069	.	A	G	8	10	18	0	1	19	0	0
16	10502169	.	G	A	7	7	14	0	0	14	0	0
16	10634013	.	A	G	6	0	6	0	8	14	0	0
16	10634027	.	A	G	3	1	4	0	8	12	0	0
16	10634460	.	T	C	3	1	4	0	1	5	0	0
16	10634510	.	C	T	3	3	6	0	0	6	0	0
16	10634818	.	T	C	3	2	5	1	0	6	0	0
16	10634846	.	T	C	4	3	7	1	1	9	0	0
16	10635148	.	G	A	2	3	5	0	2	7	0	0
16	10635889	.	T	G	0	9	9	0	1	10	0	0
16	10635890	.	T	G	0	10	10	0	0	10	0	0
16	10636168	.	C	T	7	12	19	0	0	19	0	0
16	10636947	.	T	G	6	0	6	0	7	13	0	0
16	10637050	.	C	T	13	15	28	0	0	28	0	0
16	10637259	.	A	G	9	12	21	0	3	24	0	0
16	10637510	.	T	C	10	9	19	0	2	21	0	0
16	10637701	.	T	A	9	9	18	0	0	18	0	0
16	10637705	.	A	C	9	10	19	0	0	19	0	0
16	10724845	.	G	C	2	2	4	0	0	4	0	0
16	10731333	.	C	T	3	4	7	0	0	7	0	0
16	10731388	.	G	C	5	5	10	0	4	14	0	0
16	10731717	.	C	G	5	3	8	0	2	10	0	0
16	10731819	.	T	G	2	2	4	0	0	4	0	0
16	10732162	.	T	C	1	2	3	0	0	3	0	0
16	10732174	.	C	A	1	2	3	0	0	3	0	0
16	10732197	.	T	A	1	3	4	0	0	4	0	0
16	10732313	.	C	A	2	2	4	0	0	4	0	0
16	10733829	.	G	C	4	5	9	0	1	10	0	0
16	10734190	.	T	C	5	2	7	0	1	8	0	0
16	10776922	.	A	C	4	5	9	0	0	9	0	0
16	10795620	.	G	A	4	7	11	0	0	11	0	0
16	10795647	.	T	C	5	4	9	0	0	9	0	0
16	10798995	.	A	T	5	6	11	0	0	11	0	0
16	10801121	.	G	A	1	9	10	0	0	10	0	0
16	10801374	.	T	C	7	9	16	0	0	16	0	0
16	10801422	.	G	A	5	8	13	0	0	13	0	0
16	10801682	.	C	T	6	4	10	0	1	11	0	0
16	10801772	.	C	T	2	8	10	0	1	11	0	0
16	10804843	.	T	C	18	15	33	0	1	34	0	0
16	10804862	.	A	T	20	12	32	0	0	32	0	0
16	10804878	.	C	T	19	11	30	0	0	30	0	0
16	10806318	.	C	T	14	9	23	0	0	23	0	0
16	10807471	.	A	G	12	16	28	0	2	30	0	0
16	10813138	.	A	C	22	22	44	0	1	45	0	0
16	10815877	.	T	C	23	38	61	0	0	61	0	0
16	10815907	.	A	G	47	1	48	0	16	64	0	0
16	10820667	.	T	C	38	28	66	0	1	67	0	0
16	10828887	.	T	C	4	5	9	0	2	11	0	0
16	10829019	.	T	C	10	19	29	0	2	31	0	0
16	10829139	.	A	G	11	11	22	0	0	22	0	0
16	10829235	.	G	A	1	9	10	0	1	11	0	0
16	10829256	.	T	A	18	4	22	0	2	24	0	0
16	10829276	.	T	A	16	6	22	1	1	24	0	0
16	10829872	.	G	C	4	17	21	0	2	23	0	0
16	10829968	.	T	G	16	8	24	0	3	27	0	0
16	10830309	.	T	A	11	6	17	0	1	18	0	0
16	10830431	.	G	A	9	23	32	0	2	34	0	0
16	10833987	.	G	A	6	3	9	0	0	9	0	0
16	10833993	.	C	T	2	7	9	0	1	10	0	0
16	10834715	.	A	C	4	8	12	0	3	15	0	0
16	10841177	.	A	G	8	3	11	0	0	11	0	0
16	10843402	.	A	G	5	0	5	0	8	13	0	0
16	10856130	.	A	G	6	6	12	0	2	14	0	0
16	10859434	.	C	T	29	19	48	0	4	52	0	0
16	10859435	.	T	C	29	19	48	0	3	51	0	0
16	10862159	.	T	A	12	22	34	1	2	37	0	0
16	10862162	.	T	A	14	20	34	1	1	36	0	0
16	10862279	.	A	G	22	12	34	0	1	35	0	0
16	10862280	.	G	T	21	13	34	0	0	34	0	0
16	10862331	.	C	G	17	12	29	0	7	36	0	0
16	10862773	.	T	C	29	20	49	0	1	50	0	0
16	10919019	.	G	A	2	2	4	0	1	5	0	0
16	10919100	.	G	A	1	3	4	0	0	4	0	0
16	10919290	.	C	T	2	4	6	0	3	9	0	0
16	10919317	.	C	T	1	2	3	0	3	6	0	0
16	10990177	.	G	A	0	2	2	0	4	6	0	0
16	10990445	.	T	A	2	3	5	0	0	5	0	0
16	10990944	.	C	A	2	3	5	0	0	5	0	0
16	11139933	.	A	G	3	2	5	0	0	5	0	0
16	11140993	.	A	G	4	3	7	0	0	7	0	0
16	11142340	.	A	C	1	0	1	0	6	7	0	0
16	11142341	.	G	C	2	0	2	0	5	7	0	0
16	11222031	.	T	A	13	10	23	3	1	27	0	0
16	11774678	.	T	C	1	3	4	0	0	4	0	0
16	11965486	.	T	C	2	2	4	0	1	5	0	0
16	11965673	.	G	T	21	24	45	3	4	52	0	0
16	11965803	.	G	T	22	19	41	0	0	41	0	0
16	11965931	.	T	C	23	2	25	0	17	42	0	0
16	11970239	.	C	T	16	10	26	0	1	27	0	0
16	11974658	.	G	A	5	8	13	0	0	13	0	0
16	11974703	.	G	A	5	4	9	0	3	12	0	0
16	11974720	.	G	T	5	6	11	0	0	11	0	0
16	11978045	.	G	A	8	9	17	0	2	19	0	0
16	11980484	.	C	T	0	2	2	0	9	11	0	0
16	11982471	.	G	A	7	6	13	1	1	15	0	0
16	11982519	.	G	T	8	5	13	1	0	14	0	0
16	11985606	.	C	T	5	7	12	0	1	13	0	0
16	12000211	.	C	A	2	2	4	0	0	4	0	0
16	12000212	.	C	T	2	2	4	0	0	4	0	0
16	12064771	.	T	A	5	10	15	0	0	15	0	0
16	12064946	.	C	T	11	10	21	0	1	22	0	0
16	12065025	.	G	A	9	12	21	0	0	21	0	0
16	12065201	.	C	T	20	13	33	0	0	33	0	0
16	12065392	.	G	A	13	11	24	0	0	24	0	0
16	12073577	.	G	A	2	2	4	0	0	4	0	0
16	12078976	.	C	T	7	2	9	0	0	9	0	0
16	12078982	.	C	T	8	2	10	0	0	10	0	0
16	12092428	.	A	G	1	3	4	0	0	4	0	0
16	12095076	.	C	T	2	2	4	0	0	4	0	0
16	12097241	.	T	C	1	3	4	0	0	4	0	0
16	12097325	.	G	A	3	5	8	0	0	8	0	0
16	12097354	.	G	T	5	5	10	0	1	11	0	0
16	12102412	.	A	T	20	23	43	0	0	43	0	0
16	12102671	.	T	C	32	40	72	0	4	76	0	0
16	12102708	.	A	G	29	37	66	0	3	69	0	0
16	12103083	.	T	C	34	3	37	0	31	68	0	0
16	12103331	.	T	A	34	23	57	0	4	61	0	0
16	12103344	.	A	G	29	30	59	0	1	60	0	0
16	12103530	.	G	A	22	28	50	0	6	56	0	0
16	12103540	.	G	A	34	24	58	0	1	59	0	0
16	12103598	.	G	A	31	20	51	0	1	52	0	0
16	12103732	.	C	T	2	15	17	0	16	33	0	0
16	12103749	.	C	T	16	13	29	0	2	31	0	0
16	12103982	.	G	A	27	28	55	0	1	56	0	0
16	12104042	.	C	T	23	27	50	0	1	51	0	0
16	12104043	.	A	T	22	27	49	0	2	51	0	0
16	12104083	.	C	T	30	27	57	2	1	60	0	0
16	12104209	.	A	C	25	15	40	1	3	44	0	0
16	12104281	.	C	T	17	11	28	0	1	29	0	0
16	12104290	.	T	C	19	8	27	0	0	27	0	0
16	12104316	.	T	A	21	18	39	5	0	44	0	0
16	12104601	.	G	A	35	19	54	1	5	60	0	0
16	12104665	.	A	G	32	17	49	3	3	55	0	0
16	12104778	.	T	C	14	11	25	0	5	30	0	0
16	12104794	.	C	T	21	10	31	0	3	34	0	0
16	12105206	.	A	G	26	15	41	0	1	42	0	0
16	12105265	.	T	A	28	9	37	0	1	38	0	0
16	12105443	.	A	T	11	3	14	1	0	15	0	0
16	12105689	.	C	T	2	20	22	0	20	42	0	0
16	12105796	.	C	T	4	22	26	0	21	47	0	0
16	12114975	.	G	A	20	13	33	0	0	34	1	0
16	12117537	.	G	A	6	6	12	0	1	13	0	0
16	12117645	.	G	A	16	13	29	0	0	29	0	0
16	12117648	.	G	A	15	13	28	0	0	28	0	0
16	12118207	.	G	A	12	8	20	0	1	21	0	0
16	12118210	.	C	T	13	7	20	0	0	20	0	0
16	12135754	.	G	A	7	2	9	0	1	10	0	0
16	12138841	.	G	A	1	3	4	0	0	4	0	0
16	12138940	.	A	G	1	5	6	0	0	6	0	0
16	12174891	.	C	T	2	4	6	0	0	6	0	0
16	12174949	.	G	T	6	4	10	0	1	11	0	0
16	12175594	.	A	G	9	6	15	0	0	15	0	0
16	12245751	.	T	C	29	31	60	0	3	63	0	0
16	12245954	.	C	T	36	26	62	0	2	64	0	0
16	12254457	.	C	T	28	33	61	0	3	64	0	0
16	12254469	.	T	C	28	31	59	0	3	62	0	0
16	12254592	.	T	C	36	22	58	0	4	62	0	0
16	12254674	.	C	T	26	22	48	0	1	49	0	0
16	12254776	.	A	T	32	19	51	0	2	53	0	0
16	12256585	.	C	T	9	12	21	0	2	23	0	0
16	12256614	.	G	A	19	17	36	0	0	36	0	0
16	12256629	.	A	G	19	19	38	0	4	42	0	0
16	12256681	.	C	A	6	28	34	0	22	56	0	0
16	12256801	.	C	T	35	25	60	0	2	62	0	0
16	12256816	.	G	T	36	18	54	0	4	58	0	0
16	12257154	.	T	C	19	22	41	0	4	45	0	0
16	12257216	.	A	T	28	22	50	0	3	53	0	0
16	12257506	.	G	A	23	12	35	0	2	38	1	0
16	12257904	.	C	T	27	25	52	0	3	55	0	0
16	12257921	.	T	G	20	21	41	0	8	49	0	0
16	12258044	.	C	T	18	10	28	0	1	29	0	0
16	12258128	.	A	T	9	10	19	0	1	20	0	0
16	12258264	.	G	C	10	6	16	0	1	17	0	0
16	12258268	.	C	T	10	6	16	0	0	16	0	0
16	12258302	.	A	T	3	9	12	0	1	13	0	0
16	12258593	.	T	G	11	8	19	0	0	19	0	0
16	12258733	.	A	T	14	8	22	0	1	23	0	0
16	12258999	.	G	C	12	14	26	0	2	28	0	0
16	12259298	.	G	C	29	17	46	0	1	48	1	0
16	12259302	.	A	T	31	16	47	0	0	48	1	0
16	12259589	.	G	A	13	14	27	0	0	27	0	0
16	12259678	.	T	C	19	11	30	0	2	32	0	0
16	12259737	.	A	T	13	14	27	0	2	29	0	0
16	12260002	.	T	G	10	12	22	0	1	23	0	0
16	12260134	.	A	T	9	5	14	0	0	14	0	0
16	12260291	.	G	T	12	12	24	0	2	26	0	0
16	12261211	.	A	G	6	11	17	0	0	17	0	0
16	12261625	.	A	G	9	7	16	0	0	16	0	0
16	12262453	.	T	G	9	5	14	0	0	14	0	0
16	12262762	.	T	A	3	4	7	0	0	7	0	0
16	12263047	.	C	T	0	7	7	0	12	19	0	0
16	12263385	.	G	A	6	10	16	0	1	17	0	0
16	12264912	.	A	T	15	6	21	0	2	23	0	0
16	12264999	.	T	C	8	0	8	0	8	16	0	0
16	12265237	.	A	G	3	5	8	0	0	8	0	0
16	12266073	.	G	A	5	9	14	0	0	14	0	0
16	12273636	.	G	A	0	24	24	0	28	52	0	0
16	12276030	.	G	A	19	15	34	0	3	37	0	0
16	12276033	.	A	T	17	16	33	0	1	34	0	0
16	12276065	.	A	T	20	11	31	0	3	34	0	0
16	12276102	.	G	A	9	9	18	0	0	18	0	0
16	12286264	.	C	A	4	3	7	0	1	8	0	0
16	12292467	.	G	A	0	18	18	0	18	36	0	0
16	12292599	.	T	C	11	23	34	0	3	37	0	0
16	12292622	.	G	A	13	22	35	0	6	41	0	0
16	12292648	.	T	C	13	24	37	0	1	38	0	0
16	12294316	.	C	A	6	13	19	0	0	19	0	0
16	12637271	.	G	A	2	2	4	0	0	4	0	0
16	12637552	.	A	T	1	2	3	0	0	3	0	0
16	12637681	.	T	G	1	4	5	0	0	5	0	0
16	12637779	.	C	T	4	7	11	0	0	11	0	0
16	12637822	.	T	C	6	4	10	0	0	10	0	0
16	12637824	.	G	A	0	4	4	0	6	10	0	0
16	12638030	.	A	C	3	2	5	0	0	5	0	0
16	12638062	.	A	G	1	2	3	0	0	3	0	0
16	12638612	.	C	G	7	3	10	1	0	11	0	0
16	12638622	.	A	G	7	3	10	1	0	11	0	0
16	12639125	.	A	T	9	4	13	0	0	13	0	0
16	12639184	.	C	G	3	4	7	0	0	7	0	0
16	12639285	.	T	A	2	4	6	0	3	9	0	0
16	12639291	.	C	T	4	6	10	0	1	11	0	0
16	12639320	.	C	G	3	6	9	0	0	9	0	0
16	12639488	.	G	A	1	2	3	2	1	6	0	0
16	12682597	.	G	T	2	2	4	0	0	4	0	0
16	12682607	.	C	T	1	2	3	0	1	4	0	0
16	12730380	.	A	G	1	3	4	0	3	7	0	0
16	12738324	.	G	A	5	3	8	0	0	8	0	0
16	12738351	.	T	C	5	3	8	0	0	8	0	0
16	12740779	.	C	T	9	4	13	0	0	13	0	0
16	12740949	.	C	G	4	7	11	0	1	12	0	0
16	12743927	.	G	A	0	7	7	0	5	12	0	0
16	12748944	.	A	G	21	8	29	0	1	30	0	0
16	12755992	.	C	T	39	11	50	0	0	50	0	0
16	12756094	.	A	C	29	11	40	0	0	40	0	0
16	12756255	.	C	T	14	10	24	0	2	26	0	0
16	12794075	.	C	G	7	6	13	0	0	13	0	0
16	12807038	.	G	A	3	2	5	0	2	7	0	0
16	12812496	.	T	C	1	2	3	0	0	3	0	0
16	12814102	.	A	T	7	9	16	0	0	16	0	0
16	12816486	.	T	C	8	5	13	0	0	13	0	0
16	12816745	.	A	C	6	7	13	0	1	14	0	0
16	12816975	.	G	A	8	5	13	0	2	15	0	0
16	12818220	.	G	T	17	12	29	0	1	30	0	0
16	12820952	.	C	T	3	10	13	0	5	18	0	0
16	12821091	.	C	A	30	17	47	0	2	49	0	0
16	12821106	.	C	T	22	27	49	0	2	51	0	0
16	12821221	.	G	A	22	15	37	0	1	38	0	0
16	12821300	.	G	C	0	13	13	0	20	33	0	0
16	12821449	.	G	A	21	21	42	0	1	43	0	0
16	12821459	.	A	G	22	21	43	0	2	45	0	0
16	12882612	.	C	T	3	16	19	0	28	47	0	0
16	12883126	.	G	A	23	13	36	1	9	46	0	0
16	12883618	.	C	T	19	11	30	0	4	34	0	0
16	12884054	.	A	T	13	19	32	1	2	35	0	0
16	12884510	.	A	T	9	9	18	0	1	19	0	0
16	12884513	.	G	A	9	7	16	0	2	18	0	0
16	12953670	.	C	T	7	4	11	0	1	12	0	0
16	12963064	.	T	C	1	1	2	0	2	4	0	0
16	12963079	.	A	T	2	4	6	0	1	7	0	0
16	12963274	.	A	T	10	8	18	0	0	18	0	0
16	12963368	.	G	A	15	9	24	0	1	25	0	0
16	12963384	.	C	T	0	9	9	0	18	27	0	0
16	12963975	.	A	G	24	20	44	0	2	46	0	0
16	12967855	.	G	A	13	7	20	0	0	20	0	0
16	12981637	.	G	A	5	9	14	0	1	15	0	0
16	12984488	.	C	G	7	7	14	0	0	14	0	0
16	13109726	.	T	C	1	2	3	0	0	3	0	0
16	13179335	.	G	A	2	4	6	0	0	6	0	0
16	13180193	.	G	A	1	2	3	0	0	3	0	0
16	13180389	.	T	C	3	6	9	0	0	9	0	0
16	13181465	.	T	C	6	7	13	0	2	15	0	0
16	13600680	.	A	C	19	12	31	1	2	34	0	0
16	13601013	.	A	G	12	11	23	0	1	24	0	0
16	13601026	.	T	C	12	14	26	0	0	26	0	0
16	13601228	.	A	T	7	7	14	0	2	16	0	0
16	13601286	.	G	T	4	6	10	0	1	11	0	0
16	13601964	.	T	C	14	0	14	0	7	21	0	0
16	13602164	.	T	C	11	12	23	0	0	23	0	0
16	13602454	.	T	A	13	10	23	0	2	25	0	0
16	13602488	.	T	C	7	11	18	0	2	20	0	0
16	13602800	.	T	A	9	10	19	0	2	21	0	0
16	13602922	.	A	G	7	9	16	0	1	17	0	0
16	13603007	.	T	G	6	13	19	0	2	21	0	0
16	13606896	.	A	T	8	3	11	0	1	12	0	0
16	13610651	.	A	T	13	12	25	0	2	27	0	0
16	13611035	.	G	A	8	4	12	0	0	12	0	0
16	13612999	.	T	A	2	2	4	0	1	5	0	0
16	13613104	.	T	C	3	5	8	0	0	8	0	0
16	13616698	.	A	T	11	15	26	0	3	29	0	0
16	13616862	.	G	C	10	9	19	0	1	20	0	0
16	13617152	.	C	T	10	19	29	0	0	29	0	0
16	13617291	.	G	A	3	7	10	0	1	11	0	0
16	13618172	.	C	G	6	12	18	1	1	20	0	0
16	13618374	.	A	T	13	10	23	0	5	28	0	0
16	13618662	.	T	A	10	7	17	0	1	18	0	0
16	13623642	.	T	A	5	6	11	0	0	11	0	0
16	13643504	.	C	T	1	14	15	0	15	30	0	0
16	13643974	.	C	T	4	6	10	0	7	17	0	0
16	13644781	.	T	A	4	2	6	0	3	9	0	0
16	13645495	.	C	T	1	5	6	0	1	7	0	0
16	13673660	.	T	A	7	2	9	0	0	9	0	0
16	13673734	.	A	C	4	8	12	0	0	13	1	0
16	13674176	.	T	G	6	10	16	0	0	16	0	0
16	13679037	.	A	G	3	3	6	0	0	6	0	0
16	13685800	.	G	A	7	3	10	0	0	10	0	0
16	13701482	.	C	T	10	14	24	0	1	25	0	0
16	13701599	.	A	G	3	7	10	0	0	10	0	0
16	13721408	.	C	T	2	6	8	0	2	10	0	0
16	13729810	.	C	T	8	9	17	0	3	20	0	0
16	13741610	.	G	A	3	5	8	0	0	8	0	0
16	13743390	.	G	A	4	8	12	0	0	12	0	0
16	13780375	.	G	A	2	5	7	0	0	7	0	0
16	13789765	.	G	A	1	2	3	0	0	3	0	0
16	13810372	.	G	A	2	2	4	0	0	4	0	0
16	13810417	.	G	A	1	1	2	0	1	3	0	0
16	13810528	.	C	T	2	2	4	0	0	4	0	0
16	13818640	.	T	A	4	2	6	0	0	6	0	0
16	13818644	.	G	A	4	1	5	0	1	6	0	0
16	13826195	.	C	T	6	8	14	0	1	15	0	0
16	13833484	.	T	A	6	4	10	0	1	11	0	0
16	13841360	.	T	A	11	11	22	0	2	24	0	0
16	13845350	.	G	A	16	12	28	0	0	28	0	0
16	13845368	.	G	A	0	12	12	0	12	24	0	0
16	13845571	.	T	A	12	8	20	0	1	21	0	0
16	13855121	.	C	T	5	4	9	0	0	9	0	0
16	13855142	.	T	C	7	4	11	0	1	12	0	0
16	13855179	.	A	G	8	0	8	0	6	14	0	0
16	13855482	.	T	A	5	5	10	0	0	10	0	0
16	13856554	.	T	C	3	3	6	0	1	7	0	0
16	13858356	.	C	A	6	17	23	0	1	24	0	0
16	13858436	.	C	A	21	6	27	0	0	27	0	0
16	13858570	.	C	T	13	21	34	0	2	36	0	0
16	13858673	.	T	C	15	8	23	0	0	23	0	0
16	13858866	.	T	A	13	12	25	2	0	27	0	0
16	13870827	.	C	T	2	5	7	0	1	8	0	0
16	13883968	.	C	A	6	10	16	0	1	17	0	0
16	13883980	.	A	C	9	10	19	0	0	19	0	0
16	14010210	.	G	T	2	3	5	0	0	5	0	0
16	14010241	.	C	A	3	2	5	0	0	5	0	0
16	14010693	.	G	T	2	2	4	0	0	4	0	0
16	14021817	.	G	T	7	10	17	0	1	18	0	0
16	14022252	.	G	A	1	12	13	0	14	28	1	0
16	14022520	.	G	A	13	5	18	0	0	18	0	0
16	14022830	.	T	C	1	2	3	0	0	3	0	0
16	14023087	.	A	C	1	1	2	0	1	3	0	0
16	14029424	.	A	C	3	3	6	0	0	6	0	0
16	14029437	.	T	C	1	3	4	0	0	4	0	0
16	14055284	.	A	T	4	9	13	0	4	17	0	0
16	14095097	.	C	T	0	9	9	0	11	20	0	0
16	14115928	.	G	T	15	8	23	0	0	23	0	0
16	14115931	.	G	A	15	8	23	0	0	23	0	0
16	14133851	.	G	A	3	7	10	0	0	10	0	0
16	14133874	.	C	T	0	8	8	0	0	8	0	0
16	14133907	.	C	T	4	6	10	0	0	10	0	0
16	14154226	.	C	T	9	3	12	0	0	12	0	0
16	14154240	.	T	A	2	6	8	0	0	8	0	0
16	14154708	.	G	A	5	4	9	0	0	9	0	0
16	14154798	.	C	T	0	5	5	0	4	9	0	0
16	14154870	.	A	G	6	12	18	0	0	18	0	0
16	14154944	.	C	T	3	4	7	0	1	8	0	0
16	14155038	.	G	A	5	4	9	0	0	9	0	0
16	14155339	.	C	T	1	4	5	0	0	5	0	0
16	14156556	.	T	C	1	3	4	0	0	4	0	0
16	14202197	.	T	A	10	10	20	0	0	20	0	0
16	14206289	.	G	A	5	2	7	0	0	7	0	0
16	14209195	.	G	A	8	8	16	0	0	16	0	0
16	14209348	.	T	C	15	6	21	0	0	21	0	0
16	14210949	.	A	C	10	10	20	0	0	20	0	0
16	14212079	.	G	C	4	5	9	0	10	19	0	0
16	14214534	.	G	A	6	5	11	0	0	11	0	0
16	14214543	.	A	G	6	5	11	0	0	11	0	0
16	14227913	.	C	T	2	2	4	0	0	4	0	0
16	14228668	.	A	G	1	5	6	0	1	7	0	0
16	14228677	.	C	T	3	2	5	0	0	5	0	0
16	14228902	.	C	T	4	5	9	0	0	9	0	0
16	14229031	.	T	A	4	2	6	0	0	6	0	0
16	14229397	.	A	G	1	2	3	0	0	3	0	0
16	14229501	.	A	C	2	3	5	0	0	5	0	0
16	14229539	.	C	T	3	2	5	0	1	6	0	0
16	14229575	.	C	T	1	1	2	0	0	2	0	0
16	14229585	.	G	A	0	2	2	0	1	3	0	0
16	14229857	.	G	T	1	2	3	0	0	3	0	0
16	14229870	.	A	T	1	2	3	0	0	3	0	0
16	14230514	.	T	A	2	2	4	0	0	4	0	0
16	14230517	.	C	T	2	2	4	0	0	4	0	0
16	14230570	.	C	T	3	5	8	0	0	8	0	0
16	14230635	.	T	C	5	2	7	0	1	8	0	0
16	14230693	.	G	A	5	3	8	0	0	8	0	0
16	14230719	.	A	T	5	5	10	0	0	10	0	0
16	14231038	.	A	G	7	11	18	0	2	20	0	0
16	14231063	.	G	A	0	13	13	0	6	19	0	0
16	14231079	.	G	A	0	10	10	0	7	17	0	0
16	14231207	.	T	A	10	3	13	0	0	13	0	0
16	14231250	.	T	A	1	5	6	0	1	7	0	0
16	14231941	.	A	G	13	11	24	1	1	26	0	0
16	14231952	.	A	T	12	14	26	1	2	29	0	0
16	14232005	.	G	A	15	13	28	0	2	30	0	0
16	14277577	.	G	A	7	3	10	0	1	11	0	0
16	14290484	.	C	T	1	4	5	0	0	5	0	0
16	14416520	.	C	T	5	2	7	0	0	7	0	0
16	14416599	.	C	T	3	11	14	0	1	15	0	0
16	14416876	.	T	G	7	5	12	0	0	12	0	0
16	14588209	.	G	A	3	4	7	0	0	7	0	0
16	14627294	.	G	A	4	4	8	0	0	8	0	0
16	14638413	.	G	A	2	4	6	0	0	7	1	0
16	14664767	.	T	A	3	6	9	0	0	9	0	0
16	14670907	.	G	T	5	2	7	0	0	7	0	0
16	14670994	.	T	A	2	5	7	0	0	7	0	0
16	14671135	.	A	G	2	5	7	0	0	7	0	0
16	14671227	.	C	T	2	5	7	0	0	7	0	0
16	14675175	.	C	T	12	6	18	0	0	18	0	0
16	14675373	.	A	C	9	7	16	0	0	16	0	0
16	14675413	.	G	T	4	7	11	0	5	16	0	0
16	14675487	.	T	A	3	6	9	0	3	12	0	0
16	14675572	.	G	A	12	9	21	0	0	21	0	0
16	14901812	.	C	T	1	6	7	0	0	7	0	0
16	14973890	.	G	A	0	4	4	0	6	10	0	0
16	14973968	.	A	T	1	3	4	0	0	4	0	0
16	14973989	.	A	T	3	3	6	0	0	6	0	0
16	15019105	.	T	G	3	0	3	0	7	10	0	0
16	15031839	.	C	T	3	3	6	0	0	6	0	0
16	15034797	.	G	A	2	7	9	0	10	19	0	0
16	15037778	.	C	T	14	7	21	0	0	21	0	0
16	15048645	.	G	A	3	5	8	0	0	8	0	0
16	15048646	.	A	G	8	2	10	0	0	10	0	0
16	15048737	.	A	T	3	4	7	0	0	7	0	0
16	15049133	.	A	G	2	7	9	0	0	9	0	0
16	15049278	.	A	T	4	2	6	0	0	6	0	0
16	15049594	.	A	G	1	0	1	0	4	5	0	0
16	15050112	.	C	G	12	6	18	0	0	18	0	0
16	15050135	.	C	T	12	5	17	0	0	17	0	0
16	15050277	.	G	A	10	11	21	0	1	22	0	0
16	15050623	.	C	T	16	5	21	0	2	23	0	0
16	15143512	.	G	A	2	3	5	0	1	6	0	0
16	15193716	.	G	A	2	4	6	0	0	6	0	0
16	15262854	.	G	T	1	2	3	0	0	3	0	0
16	15262870	.	G	A	2	3	5	0	0	5	0	0
16	16041698	.	A	T	5	6	11	0	0	11	0	0
16	16042240	.	G	A	3	4	7	0	0	7	0	0
16	16043191	.	T	G	2	2	4	0	3	8	1	0
16	16043218	.	A	G	4	3	7	0	1	8	0	0
16	16069884	.	A	G	5	4	9	0	1	10	0	0
16	16103927	.	C	T	1	2	3	0	0	3	0	0
16	16113853	.	G	A	2	3	5	0	1	6	0	0
16	16120849	.	C	T	2	3	5	0	1	6	0	0
16	16165179	.	T	A	32	29	61	0	1	62	0	0
16	16165418	.	C	T	32	36	68	0	2	70	0	0
16	16182195	.	T	C	35	19	54	0	2	56	0	0
16	16232902	.	A	T	13	14	27	0	0	27	0	0
16	16232911	.	A	G	13	13	26	0	0	26	0	0
16	16233124	.	T	G	6	6	12	0	0	12	0	0
16	16233250	.	T	G	16	7	23	0	1	24	0	0
16	16233715	.	T	C	6	0	6	1	5	12	0	0
16	16233907	.	A	T	6	6	12	0	0	12	0	0
16	16233937	.	G	T	10	10	20	0	1	21	0	0
16	16233952	.	C	A	1	12	13	0	7	20	0	0
16	16234297	.	C	T	7	5	12	0	0	12	0	0
16	16234309	.	C	A	1	6	7	0	5	12	0	0
16	16234516	.	A	C	7	7	14	0	1	15	0	0
16	16234633	.	T	C	8	0	8	0	3	11	0	0
16	16234642	.	C	T	5	3	8	0	0	8	0	0
16	16234747	.	T	A	13	6	19	0	0	19	0	0
16	16234948	.	C	T	0	4	4	0	7	11	0	0
16	16235056	.	G	C	5	7	12	0	0	12	0	0
16	16237745	.	G	C	2	3	5	0	0	5	0	0
16	16270448	.	T	G	3	0	3	0	2	5	0	0
16	16276678	.	G	A	2	3	5	0	0	5	0	0
16	16277689	.	A	G	4	2	6	0	0	6	0	0
16	16277728	.	G	A	5	2	7	0	0	7	0	0
16	16277810	.	G	A	3	3	6	0	0	6	0	0
16	16277954	.	G	A	5	4	9	0	0	9	0	0
16	16278013	.	A	T	4	3	7	0	0	7	0	0
16	16278043	.	T	C	1	3	4	1	1	6	0	0
16	16278172	.	G	T	1	7	8	0	4	12	0	0
16	16278356	.	C	A	1	2	3	0	0	3	0	0
16	16281479	.	A	C	5	8	13	0	1	14	0	0
16	16281740	.	A	C	4	5	9	0	0	9	0	0
16	16283550	.	C	T	6	7	13	0	0	13	0	0
16	16284057	.	T	C	6	8	14	0	0	14	0	0
16	16284159	.	G	A	1	4	5	0	14	19	0	0
16	16284192	.	C	A	14	7	21	0	0	21	0	0
16	16289121	.	C	T	18	11	29	0	3	32	0	0
16	16297057	.	G	A	13	14	27	0	0	27	0	0
16	16302166	.	T	C	11	12	23	0	0	23	0	0
16	16302244	.	A	G	6	0	6	0	15	21	0	0
16	16302247	.	A	T	5	13	18	0	1	19	0	0
16	16302371	.	A	C	5	9	14	0	2	16	0	0
16	16302426	.	T	A	9	11	20	0	1	21	0	0
16	16302477	.	G	A	1	9	10	0	4	14	0	0
16	16302835	.	T	C	4	11	15	0	1	16	0	0
16	16303025	.	C	T	16	18	34	0	3	37	0	0
16	16303065	.	A	G	12	16	28	0	2	30	0	0
16	16303086	.	T	A	9	12	21	0	2	23	0	0
16	16303163	.	G	A	3	21	24	0	4	28	0	0
16	16303196	.	A	G	10	0	10	0	16	26	0	0
16	16303293	.	T	G	10	10	20	0	1	21	0	0
16	16547388	.	C	T	12	4	16	0	2	18	0	0
16	16553899	.	C	T	11	5	16	0	0	16	0	0
16	16554693	.	A	T	4	2	6	0	0	6	0	0
16	16554695	.	T	C	4	2	6	0	0	6	0	0
16	16555170	.	G	A	0	2	2	0	1	3	0	0
16	16555484	.	A	C	7	8	15	0	1	16	0	0
16	16555611	.	A	G	12	11	23	0	0	23	0	0
16	16555628	.	A	T	8	13	21	0	1	22	0	0
16	16555975	.	T	A	9	5	14	0	0	14	0	0
16	16556223	.	C	A	9	4	13	0	0	13	0	0
16	16565998	.	C	T	7	5	12	0	1	13	0	0
16	16569578	.	C	G	5	3	8	0	1	9	0	0
16	16586290	.	G	A	3	7	10	0	1	11	0	0
16	16590439	.	C	T	0	4	4	0	5	9	0	0
16	16597649	.	C	T	1	2	3	0	0	3	0	0
16	16597660	.	T	C	1	2	3	0	0	3	0	0
16	16598043	.	G	A	3	2	5	0	0	5	0	0
16	16598049	.	T	C	2	2	4	0	0	4	0	0
16	16598146	.	T	C	3	2	5	0	0	5	0	0
16	16598179	.	G	A	4	2	6	0	0	6	0	0
16	16598232	.	C	T	0	3	3	0	3	6	0	0
16	16912252	.	T	G	1	2	3	0	0	3	0	0
16	16921134	.	G	A	1	2	3	0	0	3	0	0
16	16924638	.	T	C	2	2	4	0	1	5	0	0
16	16928396	.	T	C	5	5	10	0	0	10	0	0
16	16928424	.	A	G	5	3	8	0	0	8	0	0
16	16940592	.	A	T	1	3	4	0	0	4	0	0
16	16940824	.	A	C	5	7	12	0	0	12	0	0
16	16941019	.	T	C	5	12	17	0	0	17	0	0
16	16941162	.	T	C	4	7	11	0	0	11	0	0
16	16941270	.	G	A	0	8	8	0	7	15	0	0
16	16941343	.	G	A	2	8	10	0	1	11	0	0
16	16941527	.	A	C	2	3	5	0	0	5	0	0
16	16941533	.	G	T	2	3	5	0	0	5	0	0
16	16941741	.	C	T	6	6	12	0	1	13	0	0
16	16941776	.	A	T	8	3	11	0	0	11	0	0
16	16941979	.	C	A	7	2	9	0	1	10	0	0
16	16942001	.	G	A	1	4	5	0	8	13	0	0
16	16942097	.	C	T	3	2	5	0	1	6	0	0
16	16942293	.	T	A	5	3	8	0	2	10	0	0
16	16942906	.	C	G	6	14	20	0	0	20	0	0
16	16943024	.	C	T	9	9	18	0	0	18	0	0
16	16943111	.	A	G	13	4	17	0	2	19	0	0
16	16943348	.	C	A	12	9	21	0	1	22	0	0
16	16943720	.	G	A	12	8	20	0	1	21	0	0
16	16943930	.	G	T	11	6	17	0	8	25	0	0
16	16944259	.	A	T	17	11	28	0	1	29	0	0
16	16944260	.	C	T	17	11	28	0	0	28	0	0
16	16944348	.	G	A	13	8	21	0	3	24	0	0
16	16944941	.	G	T	16	14	30	0	0	30	0	0
16	16945128	.	T	G	4	13	17	0	0	17	0	0
16	16945261	.	A	G	5	4	9	0	0	9	0	0
16	16945585	.	A	C	4	2	6	0	4	10	0	0
16	16985499	.	C	T	37	28	65	2	2	69	0	0
16	16985511	.	A	T	38	32	70	1	1	72	0	0
16	17062417	.	A	G	3	2	5	0	0	5	0	0
16	17062727	.	C	T	2	2	4	0	0	4	0	0
16	17063100	.	A	T	2	4	6	0	0	6	0	0
16	17120136	.	C	T	8	8	16	0	1	17	0	0
16	17161877	.	A	G	2	7	9	0	0	9	0	0
16	17162499	.	G	A	4	2	6	0	0	6	0	0
16	17162558	.	G	A	3	2	5	0	0	5	0	0
16	17192957	.	G	A	6	5	11	0	1	12	0	0
16	17193489	.	C	G	3	4	7	0	0	7	0	0
16	17193510	.	G	C	2	3	5	0	0	5	0	0
16	17195343	.	A	G	3	3	6	0	0	6	0	0
16	17235251	.	G	A	3	3	6	0	0	6	0	0
16	17235677	.	C	T	2	2	4	0	0	4	0	0
16	17252774	.	G	T	5	6	11	0	0	11	0	0
16	17253023	.	G	A	1	13	14	0	6	20	0	0
16	17253105	.	C	A	3	7	10	0	0	10	0	0
16	17256113	.	C	T	2	4	6	0	1	7	0	0
16	17302526	.	T	C	6	5	11	0	0	11	0	0
16	17302821	.	A	G	4	4	8	0	0	8	0	0
16	17305481	.	T	C	4	3	7	0	3	10	0	0
16	17305579	.	G	A	4	2	6	0	1	7	0	0
16	17305597	.	C	T	3	4	7	0	1	9	1	0
16	17305620	.	A	G	6	4	10	0	0	10	0	0
16	17465977	.	T	A	4	7	11	0	1	12	0	0
16	17466824	.	A	T	2	4	6	0	0	6	0	0
16	17466839	.	T	G	4	5	9	0	0	9	0	0
16	17548995	.	C	A	2	1	3	0	1	4	0	0
16	17549176	.	G	T	6	3	9	0	0	9	0	0
16	17549282	.	G	T	5	2	7	0	0	7	0	0
16	17580036	.	C	T	3	7	10	0	0	10	0	0
16	17586579	.	T	C	1	0	1	0	3	4	0	0
16	17646269	.	T	C	9	5	14	0	2	16	0	0
16	17798055	.	T	C	7	8	15	0	2	17	0	0
16	17798056	.	C	T	7	9	16	0	0	16	0	0
16	18535689	.	G	A	5	7	12	0	1	13	0	0
16	18568933	.	C	T	6	4	10	0	2	12	0	0
16	19100141	.	C	T	4	2	6	0	0	6	0	0
16	19100144	.	T	A	3	2	5	0	1	6	0	0
16	19124404	.	T	C	5	5	10	0	0	10	0	0
16	19124452	.	A	G	5	5	10	0	1	11	0	0
16	19126439	.	A	G	1	0	1	0	5	6	0	0
16	19136123	.	A	G	3	6	9	0	1	10	0	0
16	19136328	.	C	T	8	3	11	0	0	11	0	0
16	19143714	.	G	T	4	5	9	0	0	9	0	0
16	19145102	.	C	T	4	6	10	0	0	10	0	0
16	19150643	.	A	T	13	6	19	0	1	20	0	0
16	19150678	.	C	T	12	5	17	0	0	17	0	0
16	19150973	.	A	G	6	2	8	0	0	8	0	0
16	19151174	.	C	A	6	3	9	0	0	9	0	0
16	19151534	.	T	C	3	6	9	0	0	9	0	0
16	19151656	.	G	T	4	9	13	1	0	14	0	0
16	19538923	.	G	A	2	2	4	0	1	5	0	0
16	19840562	.	T	C	14	10	24	0	2	26	0	0
16	19840645	.	T	A	16	5	21	2	1	24	0	0
16	19840658	.	A	C	11	8	19	1	2	22	0	0
16	19840792	.	C	T	15	14	29	0	3	32	0	0
16	19841213	.	G	A	14	15	29	0	0	29	0	0
16	19841215	.	C	T	14	15	29	0	0	29	0	0
16	19841443	.	G	C	9	9	18	0	0	18	0	0
16	19841501	.	T	C	7	8	15	0	0	15	0	0
16	19841502	.	A	T	8	5	13	0	2	15	0	0
16	19841591	.	A	G	15	8	23	0	2	25	0	0
16	19841720	.	A	G	13	7	20	0	1	21	0	0
16	19841786	.	A	T	8	11	19	0	0	19	0	0
16	19841890	.	G	A	3	7	10	0	0	10	0	0
16	19841922	.	G	A	8	3	11	0	0	11	0	0
16	19842493	.	G	A	4	11	15	0	1	16	0	0
16	19842530	.	A	G	2	8	10	0	3	13	0	0
16	19843053	.	G	T	7	10	17	0	3	20	0	0
16	19843056	.	G	T	9	8	17	0	2	19	0	0
16	19850746	.	G	A	8	13	21	0	1	22	0	0
16	19853074	.	G	A	14	10	24	2	2	28	0	0
16	19853098	.	C	T	12	14	26	2	2	30	0	0
16	19853125	.	A	T	15	7	22	1	3	26	0	0
16	19853230	.	A	C	13	5	18	0	0	18	0	0
16	19854886	.	C	T	0	5	5	0	4	9	0	0
16	19864588	.	G	T	3	5	8	0	1	9	0	0
16	19878856	.	G	A	2	3	5	0	1	6	0	0
16	20140877	.	T	G	4	2	6	0	0	6	0	0
16	20151309	.	C	T	6	11	17	0	0	17	0	0
16	20151397	.	C	T	9	12	21	0	0	21	0	0
16	20151460	.	C	T	5	7	12	0	0	12	0	0
16	20151841	.	T	C	11	4	15	0	1	16	0	0
16	20151991	.	G	A	14	10	24	0	0	24	0	0
16	20152044	.	C	A	7	4	11	0	1	15	3	0
16	20152128	.	G	A	4	8	12	0	5	17	0	0
16	20152474	.	A	G	6	6	12	0	0	12	0	0
16	20164230	.	A	G	6	3	9	0	0	9	0	0
16	20238597	.	T	C	1	1	2	0	0	2	0	0
16	20238911	.	C	T	2	4	6	0	0	6	0	0
16	20265655	.	T	C	0	3	3	0	6	9	0	0
16	20266055	.	T	C	1	3	4	0	0	4	0	0
16	20266109	.	T	A	4	3	7	0	0	7	0	0
16	20266321	.	T	C	2	2	4	0	0	4	0	0
16	20266799	.	A	C	7	7	14	0	0	14	0	0
16	20266840	.	T	A	5	7	12	0	1	13	0	0
16	20267152	.	G	T	2	3	5	0	0	5	0	0
16	20267340	.	T	C	2	10	12	0	0	12	0	0
16	20267347	.	T	C	2	0	2	0	10	12	0	0
16	20267424	.	A	T	4	2	6	0	0	6	0	0
16	20268470	.	C	T	2	4	6	0	0	6	0	0
16	20289511	.	T	C	1	3	4	0	0	4	0	0
16	20289537	.	T	C	1	3	4	0	0	4	0	0
16	20298802	.	C	T	1	2	3	0	0	3	0	0
16	20304308	.	G	A	0	2	2	0	1	3	0	0
16	20318550	.	G	A	1	5	6	0	1	7	0	0
16	20324870	.	C	T	9	5	14	0	0	14	0	0
16	20324891	.	A	G	4	10	14	0	1	15	0	0
16	20402034	.	A	C	4	0	4	0	3	7	0	0
16	20492447	.	G	T	4	2	6	0	1	7	0	0
16	20512661	.	T	C	10	5	15	0	0	15	0	0
16	20513103	.	T	G	10	1	11	0	10	21	0	0
16	20513152	.	A	G	5	12	17	0	1	18	0	0
16	20514738	.	G	A	5	9	14	0	1	15	0	0
16	20800347	.	C	T	6	10	16	0	1	17	0	0
16	20806487	.	C	T	27	18	45	0	5	50	0	0
16	20813628	.	C	T	2	18	20	0	16	36	0	0
16	20822881	.	T	C	13	13	26	0	1	27	0	0
16	20824508	.	C	G	13	10	23	0	1	24	0	0
16	20824566	.	C	T	17	9	26	0	1	27	0	0
16	20826697	.	T	C	13	16	29	0	0	29	0	0
16	20826703	.	G	A	16	14	30	0	1	31	0	0
16	20836206	.	C	T	8	14	22	0	0	22	0	0
16	20836218	.	G	A	15	7	22	0	1	23	0	0
16	20855582	.	G	A	7	9	16	0	0	16	0	0
16	20855636	.	C	T	10	4	14	0	1	15	0	0
16	20889325	.	C	T	7	7	14	0	1	15	0	0
16	21038585	.	A	T	9	3	12	0	1	13	0	0
16	21038697	.	A	C	8	7	15	0	2	17	0	0
16	21038801	.	T	A	15	9	24	0	2	26	0	0
16	21038832	.	T	A	11	13	24	0	2	26	0	0
16	21038924	.	G	A	15	4	19	0	2	21	0	0
16	21039939	.	G	C	6	8	14	0	0	14	0	0
16	21398935	.	G	A	2	2	4	0	0	4	0	0
16	21417168	.	C	G	3	4	7	0	0	7	0	0
16	21442772	.	A	T	1	2	3	0	0	3	0	0
16	21443274	.	C	T	1	2	3	0	0	3	0	0
16	21444882	.	A	G	2	1	3	0	2	5	0	0
16	21548398	.	T	C	4	6	10	0	1	11	0	0
16	21548456	.	C	T	9	6	15	0	0	15	0	0
16	21548547	.	G	A	14	9	23	0	0	23	0	0
16	21548556	.	G	A	13	10	23	0	0	23	0	0
16	21548625	.	G	T	6	6	12	0	4	16	0	0
16	21548776	.	C	T	11	6	17	0	2	19	0	0
16	21548881	.	T	C	8	7	15	0	1	16	0	0
16	21548891	.	A	T	9	7	16	0	1	17	0	0
16	21549022	.	C	T	2	10	12	0	10	22	0	0
16	21549520	.	C	T	0	8	8	0	9	17	0	0
16	21549539	.	A	C	6	3	9	0	2	11	0	0
16	21549924	.	C	T	4	6	10	0	0	10	0	0
16	21550251	.	C	A	4	2	6	0	1	7	0	0
16	21550255	.	T	A	3	1	4	0	3	7	0	0
16	21550318	.	C	T	2	2	4	0	0	4	0	0
16	21651780	.	T	C	3	0	3	0	8	11	0	0
16	21652059	.	T	A	10	14	24	0	0	24	0	0
16	21655336	.	C	T	9	6	15	0	2	17	0	0
16	21655611	.	G	A	9	9	18	0	0	18	0	0
16	21663023	.	G	A	2	2	4	0	1	5	0	0
16	21665403	.	G	C	2	5	7	0	1	8	0	0
16	21665605	.	G	T	6	4	10	0	0	10	0	0
16	21673726	.	A	G	6	3	9	0	0	9	0	0
16	21673735	.	G	A	3	6	9	0	0	9	0	0
16	21689469	.	C	T	0	3	3	0	3	6	0	0
16	21691065	.	T	G	1	4	5	0	0	5	0	0
16	21691101	.	T	C	1	2	3	0	0	3	0	0
16	21734574	.	A	G	8	5	13	0	1	14	0	0
16	21738666	.	A	T	9	5	14	0	1	15	0	0
16	21739233	.	G	A	11	12	23	0	0	23	0	0
16	21763843	.	G	A	7	14	21	0	1	22	0	0
16	21769044	.	G	A	10	15	25	0	1	26	0	0
16	21777508	.	G	C	5	0	5	0	4	9	0	0
16	21780023	.	G	A	6	4	10	0	0	10	0	0
16	21782076	.	C	A	4	5	9	0	0	9	0	0
16	21892052	.	G	A	6	2	8	0	2	10	0	0
16	21892068	.	G	A	6	5	11	0	0	11	0	0
16	21892173	.	G	A	5	6	11	0	1	13	1	0
16	21892304	.	T	C	18	0	18	0	10	28	0	0
16	21892312	.	C	A	20	6	26	0	3	29	0	0
16	21898159	.	T	A	8	9	17	0	0	17	0	0
16	21898267	.	A	T	7	8	15	0	0	15	0	0
16	21898279	.	C	T	7	11	18	0	0	18	0	0
16	21899211	.	C	T	11	10	21	0	0	21	0	0
16	21899384	.	C	G	1	5	6	0	8	14	0	0
16	21900294	.	A	G	7	8	15	0	0	15	0	0
16	21900333	.	C	A	2	9	11	0	8	19	0	0
16	21902949	.	G	A	5	4	9	0	1	10	0	0
16	21903803	.	A	G	10	4	14	0	2	16	0	0
16	21903845	.	C	T	6	5	11	0	2	13	0	0
16	21903911	.	C	A	0	3	3	0	7	10	0	0
16	21904091	.	G	A	5	5	10	0	0	10	0	0
16	21905814	.	G	A	9	9	18	0	0	18	0	0
16	21906282	.	A	C	4	0	4	0	8	12	0	0
16	21908428	.	T	C	1	0	1	0	3	4	0	0
16	21908890	.	A	G	1	2	3	0	0	3	0	0
16	21912092	.	G	C	2	3	5	0	0	5	0	0
16	21912189	.	A	G	2	3	5	0	0	5	0	0
16	21912963	.	C	A	5	4	9	0	0	9	0	0
16	21912997	.	G	A	6	8	14	0	0	14	0	0
16	21913069	.	T	A	7	6	13	0	1	14	0	0
16	21913091	.	T	A	5	6	11	0	1	12	0	0
16	21913221	.	A	C	2	4	6	0	0	6	0	0
16	21913227	.	G	C	1	2	3	0	0	3	0	0
16	21917148	.	A	C	3	1	4	0	1	5	0	0
16	21934562	.	C	A	2	2	4	0	0	4	0	0
16	21937834	.	C	G	5	2	7	0	0	7	0	0
16	21937991	.	G	T	0	3	3	0	2	5	0	0
16	22354677	.	A	G	4	3	7	0	0	7	0	0
16	22358841	.	T	A	7	6	13	0	0	13	0	0
16	22358944	.	A	T	5	8	13	0	0	13	0	0
16	22358947	.	T	A	7	8	15	0	1	16	0	0
16	22360552	.	G	A	8	10	18	0	0	18	0	0
16	22360577	.	G	A	7	13	20	0	1	21	0	0
16	22361101	.	T	C	11	11	22	0	1	23	0	0
16	22363956	.	G	A	18	5	23	0	1	24	0	0
16	22363957	.	G	A	20	4	24	0	0	24	0	0
16	22364064	.	C	T	12	14	26	0	0	26	0	0
16	22364067	.	T	G	14	12	26	0	1	27	0	0
16	22364241	.	A	C	27	7	34	0	2	36	0	0
16	22364501	.	A	C	4	4	8	0	0	8	0	0
16	22365562	.	C	G	7	7	14	0	0	14	0	0
16	22365616	.	C	T	6	3	9	0	0	9	0	0
16	22368962	.	T	A	4	4	8	0	0	8	0	0
16	22649862	.	T	G	2	3	5	0	0	5	0	0
16	22673219	.	C	T	2	6	8	0	0	8	0	0
16	22673234	.	C	T	2	5	7	0	0	7	0	0
16	22673528	.	C	G	13	7	20	0	0	20	0	0
16	22673804	.	G	T	6	3	9	0	1	10	0	0
16	22673817	.	G	T	6	2	8	0	1	9	0	0
16	22674181	.	A	C	5	3	8	0	0	8	0	0
16	22674427	.	C	T	3	7	10	0	0	10	0	0
16	22674490	.	G	A	3	3	6	0	0	6	0	0
16	22675081	.	T	A	4	4	8	0	0	8	0	0
16	22675110	.	A	T	7	4	11	0	0	11	0	0
16	22675253	.	C	T	3	7	10	0	0	10	0	0
16	22675310	.	T	A	6	7	13	0	3	16	0	0
16	22675367	.	C	A	5	5	10	0	1	11	0	0
16	22675418	.	T	C	2	7	9	0	4	13	0	0
16	22675574	.	T	C	7	9	16	1	0	17	0	0
16	22675663	.	T	C	6	7	13	0	0	13	0	0
16	22675795	.	G	A	2	2	4	1	4	9	0	0
16	22676478	.	G	C	3	8	11	0	1	12	0	0
16	22676527	.	C	T	7	5	12	1	0	13	0	0
16	22676589	.	G	T	15	9	24	0	1	25	0	0
16	22676671	.	T	A	10	13	23	0	1	24	0	0
16	22677037	.	C	A	12	8	20	0	5	25	0	0
16	22677086	.	G	A	9	18	27	0	2	29	0	0
16	22677206	.	C	A	18	5	23	0	0	23	0	0
16	22677276	.	A	G	12	13	25	0	1	26	0	0
16	22677537	.	A	G	2	7	9	0	1	10	0	0
16	22677658	.	T	C	1	5	6	0	0	6	0	0
16	22750244	.	A	T	16	12	28	0	1	29	0	0
16	22750506	.	A	G	19	27	46	0	2	48	0	0
16	22750566	.	G	A	26	16	42	0	0	42	0	0
16	22750579	.	A	G	22	16	38	0	1	39	0	0
16	22750610	.	A	T	19	23	42	0	0	42	0	0
16	22750693	.	G	A	21	17	38	2	4	44	0	0
16	22750718	.	A	T	22	8	30	2	3	35	0	0
16	22750754	.	G	A	17	11	28	0	2	30	0	0
16	22750781	.	A	G	17	17	34	0	0	34	0	0
16	22750839	.	A	G	11	9	20	0	1	21	0	0
16	22751093	.	C	A	6	15	21	0	1	22	0	0
16	22751101	.	C	T	3	13	16	0	2	18	0	0
16	22751129	.	T	A	6	11	17	0	0	17	0	0
16	22751141	.	T	G	5	6	11	0	0	11	0	0
16	22751167	.	T	A	7	10	17	0	0	17	0	0
16	22751181	.	C	T	7	10	17	0	0	17	0	0
16	22751221	.	G	C	4	6	10	0	0	10	0	0
16	22751325	.	T	C	1	2	3	0	0	3	0	0
16	22751376	.	A	C	2	3	5	0	0	5	0	0
16	22751426	.	T	C	7	6	13	0	0	13	0	0
16	22751926	.	C	T	7	8	15	0	0	15	0	0
16	22752154	.	G	A	14	21	35	0	0	35	0	0
16	22752182	.	G	T	19	10	29	0	2	31	0	0
16	22752274	.	G	C	10	3	13	0	1	16	2	0
16	22752279	.	T	C	7	4	11	0	4	15	0	0
16	22752531	.	T	C	6	7	13	0	0	13	0	0
16	22752624	.	C	T	3	10	13	0	2	15	0	0
16	22752625	.	G	A	11	3	14	0	1	15	0	0
16	22752779	.	A	G	1	1	2	0	0	2	0	0
16	22752804	.	T	C	2	2	4	0	1	5	0	0
16	22752829	.	C	A	3	3	6	0	0	6	0	0
16	22752868	.	C	T	2	5	7	0	0	7	0	0
16	22752954	.	T	C	8	6	14	0	1	15	0	0
16	22753017	.	G	A	3	2	5	0	0	5	0	0
16	22753068	.	G	A	3	4	7	0	0	7	0	0
16	22753116	.	C	A	0	4	4	0	12	16	0	0
16	22753185	.	C	T	11	6	17	0	3	20	0	0
16	22753380	.	T	G	17	9	26	0	1	27	0	0
16	22753452	.	G	A	13	6	19	0	0	19	0	0
16	22753574	.	C	T	2	15	17	1	13	31	0	0
16	22753583	.	T	C	12	0	12	1	17	30	0	0
16	22753626	.	C	T	15	11	26	1	2	29	0	0
16	22753631	.	C	T	14	11	25	0	3	28	0	0
16	22753784	.	T	C	13	0	13	0	8	21	0	0
16	22754238	.	A	G	1	5	6	0	1	7	0	0
16	22767597	.	A	G	1	5	6	0	0	6	0	0
16	22767732	.	A	G	1	2	3	0	0	3	0	0
16	22767796	.	C	G	1	4	5	0	0	5	0	0
16	22769586	.	G	T	3	2	5	0	0	5	0	0
16	22771212	.	T	A	1	4	5	0	0	5	0	0
16	22779311	.	G	A	3	3	6	0	1	7	0	0
16	22779318	.	T	A	3	4	7	0	0	7	0	0
16	22782306	.	A	T	11	16	27	0	0	27	0	0
16	22782308	.	A	T	12	16	28	0	0	28	0	0
16	22782422	.	C	T	2	14	16	0	12	28	0	0
16	22782443	.	A	T	16	15	31	0	0	31	0	0
16	22782458	.	T	C	17	12	29	0	0	29	0	0
16	22782682	.	T	G	14	4	18	0	1	19	0	0
16	22782904	.	G	C	9	6	15	0	3	18	0	0
16	22783338	.	C	G	0	13	13	0	10	23	0	0
16	22783978	.	A	G	7	13	20	0	1	21	0	0
16	22783995	.	T	C	6	0	6	0	12	18	0	0
16	22796434	.	T	G	12	12	24	0	0	24	0	0
16	22866015	.	T	C	2	3	5	0	0	5	0	0
16	22866017	.	C	A	3	3	6	0	0	6	0	0
16	22872011	.	A	G	3	0	3	0	8	11	0	0
16	22872317	.	A	C	8	5	13	0	1	14	0	0
16	22872602	.	G	A	6	4	10	0	1	11	0	0
16	22872657	.	A	C	11	8	19	0	1	20	0	0
16	22872693	.	T	C	16	6	22	0	1	23	0	0
16	22872694	.	C	T	16	7	23	0	0	23	0	0
16	22878965	.	T	A	13	10	23	0	0	23	0	0
16	22879035	.	A	G	10	0	10	0	4	14	0	0
16	23557414	.	A	G	6	4	10	0	1	11	0	0
16	23961572	.	C	G	11	0	11	0	10	21	0	0
16	23961950	.	C	A	20	10	30	0	2	32	0	0
16	23962010	.	T	C	20	8	28	0	2	30	0	0
16	23963246	.	C	T	25	23	48	0	3	51	0	0
16	23963315	.	G	T	17	28	45	0	2	47	0	0
16	23973477	.	G	A	25	31	56	0	2	59	1	0
16	24190674	.	C	T	1	3	4	0	0	4	0	0
16	24190746	.	G	C	2	2	4	0	0	4	0	0
16	24213444	.	T	A	21	18	39	0	0	39	0	0
16	24213446	.	T	A	24	17	41	0	1	42	0	0
16	24213538	.	G	T	25	27	52	0	4	56	0	0
16	24213657	.	G	A	28	26	54	2	1	57	0	0
16	24213666	.	T	G	24	26	50	2	5	57	0	0
16	24213793	.	T	C	24	26	50	0	2	52	0	0
16	24214023	.	A	G	32	27	59	0	5	64	0	0
16	24214106	.	T	C	21	1	22	0	27	49	0	0
16	24214468	.	T	C	27	26	53	0	0	54	1	0
16	24261594	.	C	G	16	11	27	0	2	29	0	0
16	24277750	.	C	T	6	14	20	0	1	21	0	0
16	24302164	.	G	A	11	7	18	0	0	18	0	0
16	24552024	.	A	T	4	3	7	0	0	7	0	0
16	24552032	.	G	A	4	3	7	0	1	8	0	0
16	24553018	.	G	T	5	3	8	0	1	9	0	0
16	24553082	.	T	A	5	4	9	0	1	10	0	0
16	24553141	.	T	A	1	6	7	0	0	7	0	0
16	24553450	.	T	C	8	6	14	0	1	15	0	0
16	24553633	.	A	G	1	3	4	0	0	4	0	0
16	24554438	.	T	A	6	3	9	0	1	10	0	0
16	24554475	.	A	G	7	7	14	0	2	16	0	0
16	24590767	.	T	A	16	11	27	1	0	28	0	0
16	24590823	.	C	T	22	15	37	0	3	40	0	0
16	24591172	.	A	G	15	20	35	0	2	37	0	0
16	24591245	.	A	T	8	11	19	1	1	21	0	0
16	24591258	.	A	G	8	11	19	1	1	21	0	0
16	24591287	.	C	T	3	9	12	1	11	24	0	0
16	24591330	.	A	G	14	9	23	0	1	24	0	0
16	24591360	.	G	A	14	8	22	0	1	23	0	0
16	24591410	.	G	A	6	7	13	0	3	16	0	0
16	24591693	.	G	C	31	14	45	0	3	48	0	0
16	24591751	.	C	T	29	13	42	0	2	44	0	0
16	24591794	.	G	T	14	23	37	0	0	38	1	0
16	24632231	.	C	T	9	5	14	0	1	15	0	0
16	24645448	.	C	G	11	5	16	0	0	16	0	0
16	24645620	.	T	G	10	8	18	0	0	18	0	0
16	24669991	.	T	C	3	7	10	0	0	10	0	0
16	24670772	.	C	A	0	2	2	0	1	3	0	0
16	24695160	.	G	T	8	26	34	0	0	34	0	0
16	24695301	.	T	C	30	17	47	0	3	51	1	0
16	24695322	.	G	T	0	20	20	0	31	51	0	0
16	24695520	.	G	A	36	37	73	0	6	79	0	0
16	24695525	.	A	C	35	38	73	0	2	75	0	0
16	24695681	.	A	T	37	26	63	1	2	66	0	0
16	24730634	.	C	A	5	7	12	0	0	12	0	0
16	24732602	.	A	G	7	0	7	0	7	14	0	0
16	24819613	.	C	T	0	3	3	0	3	6	0	0
16	24820061	.	A	G	2	2	4	0	1	5	0	0
16	24820163	.	C	T	2	2	4	0	0	4	0	0
16	24896386	.	T	G	0	3	3	0	0	3	0	0
16	24990141	.	G	A	2	2	4	0	0	4	0	0
16	24990672	.	C	T	5	2	7	0	0	7	0	0
16	24990850	.	C	T	4	5	9	0	0	9	0	0
16	24991164	.	G	T	0	3	3	0	5	8	0	0
16	24991225	.	C	G	7	8	15	0	1	16	0	0
16	24991239	.	G	A	0	6	6	0	9	15	0	0
16	24991593	.	A	T	5	6	11	0	2	13	0	0
16	24991636	.	G	A	4	2	6	0	0	6	0	0
16	24991637	.	C	T	4	1	5	0	1	6	0	0
16	24991763	.	G	C	2	4	6	0	0	6	0	0
16	24991919	.	T	A	5	5	10	0	0	10	0	0
16	24991940	.	T	A	10	4	14	0	0	14	0	0
16	24992017	.	A	C	3	8	11	0	0	11	0	0
16	24992080	.	A	G	1	4	5	0	1	6	0	0
16	24992477	.	C	G	4	4	8	0	0	8	0	0
16	25012935	.	T	A	1	2	3	0	0	3	0	0
16	25033191	.	C	T	2	2	4	0	0	4	0	0
16	25033809	.	G	A	1	2	3	0	1	4	0	0
16	25034683	.	A	T	7	6	13	0	0	13	0	0
16	25034715	.	C	T	6	9	15	0	0	15	0	0
16	25036217	.	C	T	3	9	12	0	2	14	0	0
16	25038185	.	A	T	12	7	19	0	3	22	0	0
16	25038429	.	C	T	11	11	22	0	5	27	0	0
16	25038696	.	A	T	6	4	10	0	1	11	0	0
16	25068794	.	A	G	2	0	2	0	2	4	0	0
16	25071019	.	G	A	3	2	5	0	1	6	0	0
16	25071614	.	C	T	11	8	19	0	1	20	0	0
16	25071782	.	G	A	0	10	10	0	6	16	0	0
16	25072355	.	G	A	8	9	17	0	0	17	0	0
16	25078715	.	A	G	6	6	12	0	2	14	0	0
16	25078907	.	T	A	6	5	11	0	1	12	0	0
16	25079407	.	A	C	4	5	9	1	0	10	0	0
16	25080042	.	G	T	2	2	4	0	0	4	0	0
16	25080190	.	T	A	1	3	4	0	0	4	0	0
16	25080207	.	C	T	2	3	5	0	0	5	0	0
16	25080252	.	A	T	7	2	9	0	0	9	0	0
16	25080306	.	T	C	6	4	10	0	2	12	0	0
16	25080367	.	G	A	3	4	7	0	0	7	0	0
16	25104031	.	T	C	17	18	35	0	1	36	0	0
16	25104454	.	C	G	15	14	29	0	2	31	0	0
16	25104543	.	C	T	7	14	21	0	2	23	0	0
16	25104850	.	A	C	16	15	31	0	2	33	0	0
16	25104899	.	T	G	17	21	38	0	2	40	0	0
16	25104941	.	T	C	23	12	35	0	3	38	0	0
16	25111665	.	C	A	3	2	5	0	0	5	0	0
16	25111794	.	G	A	1	3	4	0	0	4	0	0
16	25111899	.	G	A	3	2	5	0	1	6	0	0
16	25111920	.	G	A	1	2	3	0	4	7	0	0
16	25112001	.	A	G	3	2	5	0	0	5	0	0
16	25112769	.	C	T	3	4	7	0	0	7	0	0
16	25113741	.	G	A	0	2	2	0	4	6	0	0
16	25121970	.	C	T	2	6	8	0	0	8	0	0
16	25122240	.	C	T	7	3	10	0	0	10	0	0
16	25122387	.	C	T	3	4	7	0	0	7	0	0
16	25122798	.	C	T	4	5	9	0	0	9	0	0
16	25123037	.	G	A	7	3	10	0	0	10	0	0
16	25123058	.	A	G	6	3	9	0	1	10	0	0
16	25123382	.	G	T	6	5	11	0	1	12	0	0
16	25123610	.	T	A	4	4	8	0	0	9	1	0
16	25123832	.	A	G	6	3	9	0	0	9	0	0
16	25123843	.	T	A	5	5	10	0	0	10	0	0
16	25123884	.	C	G	4	9	13	0	0	13	0	0
16	25124500	.	G	A	5	5	10	0	0	10	0	0
16	25124750	.	G	A	9	5	14	0	0	14	0	0
16	25145978	.	G	A	0	2	2	0	2	4	0	0
16	25146020	.	T	C	1	3	4	0	0	4	0	0
16	25148725	.	C	T	1	2	3	0	0	3	0	0
16	25149474	.	C	T	1	2	3	0	0	3	0	0
16	25150307	.	T	G	1	0	1	0	2	3	0	0
16	25151012	.	T	C	2	5	7	0	0	7	0	0
16	25151059	.	G	A	1	3	4	0	2	6	0	0
16	25151079	.	A	G	2	1	3	0	2	5	0	0
16	25154081	.	A	C	3	5	8	0	0	8	0	0
16	25154115	.	C	T	5	3	8	0	0	8	0	0
16	25161315	.	T	C	5	4	9	0	2	11	0	0
16	25161693	.	G	A	5	6	11	0	1	12	0	0
16	25161873	.	G	A	5	10	15	0	8	23	0	0
16	25161876	.	T	C	10	11	21	0	1	22	0	0
16	25162782	.	T	G	1	3	4	0	0	4	0	0
16	25168548	.	G	A	14	4	18	0	3	21	0	0
16	25168765	.	C	A	12	11	23	0	1	24	0	0
16	25169336	.	G	A	9	13	22	0	0	22	0	0
16	25169616	.	A	T	3	6	9	0	0	9	0	0
16	25176510	.	G	A	1	3	4	0	0	4	0	0
16	25180397	.	A	C	4	6	10	0	0	10	0	0
16	25180415	.	C	T	3	6	9	0	0	9	0	0
16	25180658	.	C	A	6	2	8	0	1	9	0	0
16	25180674	.	T	A	5	2	7	0	0	7	0	0
16	25180775	.	G	A	2	4	6	0	4	10	0	0
16	25180942	.	A	G	9	0	9	0	5	14	0	0
16	25181046	.	A	G	6	8	14	0	0	14	0	0
16	25181095	.	C	T	5	8	13	0	1	14	0	0
16	25181194	.	G	C	4	3	7	0	1	8	0	0
16	25181256	.	G	A	5	2	7	0	1	8	0	0
16	25181291	.	T	C	3	2	5	3	0	8	0	0
16	25232250	.	T	C	2	2	4	0	0	4	0	0
16	25232288	.	C	A	0	2	2	0	7	9	0	0
16	25232421	.	T	C	6	5	11	0	0	11	0	0
16	25232433	.	C	T	0	5	5	0	4	9	0	0
16	25232707	.	C	T	2	3	5	0	0	5	0	0
16	25272196	.	C	G	2	1	3	0	1	4	0	0
16	25272351	.	C	T	1	2	3	0	0	3	0	0
16	25275909	.	A	C	5	18	23	0	1	24	0	0
16	25275957	.	C	T	16	11	27	0	2	29	0	0
16	25276281	.	G	A	13	15	28	0	0	28	0	0
16	25276387	.	T	A	12	11	23	0	0	23	0	0
16	25285506	.	G	A	22	13	35	0	1	36	0	0
16	25285507	.	G	A	21	14	35	0	1	36	0	0
16	25296806	.	G	T	4	1	5	0	1	6	0	0
16	25308516	.	C	T	3	3	6	0	0	6	0	0
16	25308986	.	G	A	3	4	7	0	1	8	0	0
16	25311000	.	T	C	5	5	10	0	0	10	0	0
16	25311038	.	A	T	4	3	7	0	0	7	0	0
16	25311772	.	G	A	2	6	8	0	0	8	0	0
16	25314682	.	C	T	8	7	15	0	0	15	0	0
16	25317000	.	G	A	3	2	5	0	0	5	0	0
16	25327155	.	C	A	6	9	15	1	0	16	0	0
16	25327181	.	C	T	7	9	16	1	0	17	0	0
16	25327202	.	G	A	6	10	16	0	0	16	0	0
16	25327730	.	C	T	8	6	14	0	0	14	0	0
16	25329319	.	C	T	3	4	7	0	0	7	0	0
16	25333270	.	A	G	12	9	21	0	1	22	0	0
16	25337248	.	C	A	21	12	33	0	6	39	0	0
16	25337286	.	C	T	20	22	42	0	4	46	0	0
16	25337319	.	G	A	10	21	31	0	0	31	0	0
16	25348767	.	G	A	3	4	7	0	0	7	0	0
16	25348860	.	C	T	2	3	5	0	0	5	0	0
16	25349581	.	G	T	5	4	9	0	0	9	0	0
16	25351283	.	A	T	1	6	7	0	0	7	0	0
16	25360557	.	T	A	11	12	23	0	0	23	0	0
16	25360762	.	G	A	3	3	6	0	0	6	0	0
16	25364405	.	C	T	1	4	5	0	0	5	0	0
16	25364479	.	T	C	7	10	17	0	1	18	0	0
16	25364589	.	T	C	8	15	23	0	2	25	0	0
16	25364742	.	T	C	7	1	8	0	8	16	0	0
16	25365156	.	C	T	6	3	9	0	0	9	0	0
16	25367503	.	G	A	6	2	8	0	1	9	0	0
16	25367674	.	A	T	7	3	10	0	0	10	0	0
16	25367683	.	A	G	8	2	10	0	0	10	0	0
16	25367788	.	A	G	4	5	9	0	0	9	0	0
16	25367902	.	C	T	0	4	4	0	1	5	0	0
16	25367917	.	C	G	1	4	5	0	0	5	0	0
16	25367938	.	G	C	2	0	2	0	5	7	0	0
16	25373823	.	C	T	4	4	8	0	0	8	0	0
16	25373979	.	T	A	7	11	18	1	0	19	0	0
16	25374275	.	T	C	8	6	14	0	0	14	0	0
16	25374507	.	T	C	7	0	7	0	11	18	0	0
16	25375019	.	T	C	4	0	4	0	4	8	0	0
16	25376046	.	T	A	7	4	11	0	1	12	0	0
16	25389094	.	G	A	8	4	12	0	1	13	0	0
16	25389106	.	C	T	6	6	12	0	0	12	0	0
16	25395154	.	G	T	7	10	17	0	0	17	0	0
16	25395702	.	G	T	4	11	15	0	1	16	0	0
16	25399585	.	A	T	3	10	13	0	0	13	0	0
16	25399588	.	A	T	4	11	15	0	0	15	0	0
16	25400055	.	G	C	3	5	8	0	0	8	0	0
16	25400061	.	A	T	3	4	7	0	0	7	0	0
16	25445746	.	G	A	3	2	5	0	0	5	0	0
16	25454790	.	C	T	3	4	7	0	0	7	0	0
16	25470975	.	A	G	2	3	5	0	0	5	0	0
16	25477428	.	G	A	1	3	4	0	0	4	0	0
16	25498402	.	T	A	4	2	6	0	0	6	0	0
16	25500137	.	A	G	2	4	6	0	0	6	0	0
16	25500223	.	T	C	6	3	9	0	0	9	0	0
16	25504192	.	G	C	21	14	35	0	2	37	0	0
16	25504337	.	G	A	18	16	34	0	0	34	0	0
16	25504466	.	C	T	10	12	22	0	1	23	0	0
16	25504467	.	G	A	12	8	20	0	2	22	0	0
16	25504792	.	G	C	20	26	46	0	4	50	0	0
16	25504900	.	G	A	25	24	49	0	3	52	0	0
16	25535229	.	C	T	0	4	4	0	3	7	0	0
16	25548275	.	C	T	1	2	3	0	0	3	0	0
16	25556650	.	T	A	15	13	28	0	1	29	0	0
16	25556697	.	A	G	11	18	29	0	0	29	0	0
16	25556710	.	C	T	11	16	27	0	1	28	0	0
16	25556766	.	C	G	0	9	9	0	7	16	0	0
16	25556780	.	A	G	6	9	15	0	1	16	0	0
16	25556802	.	C	A	6	8	14	0	2	16	0	0
16	25556930	.	A	G	9	12	21	0	0	21	0	0
16	25556966	.	T	A	13	9	22	0	1	23	0	0
16	25557400	.	A	G	4	3	7	0	0	7	0	0
16	25557403	.	T	C	2	2	4	0	1	5	0	0
16	25557690	.	C	T	7	4	11	0	0	11	0	0
16	25557806	.	C	T	10	8	18	0	0	18	0	0
16	25558135	.	C	T	8	4	12	0	4	16	0	0
16	25558223	.	A	G	5	4	9	0	0	9	0	0
16	25558351	.	C	T	1	4	5	0	4	9	0	0
16	25558439	.	G	T	8	8	16	1	1	18	0	0
16	25558704	.	T	G	6	8	14	0	2	16	0	0
16	25558829	.	C	T	6	5	11	0	1	12	0	0
16	25558892	.	G	A	4	5	9	0	0	9	0	0
16	25558986	.	A	G	6	5	11	0	0	11	0	0
16	25559028	.	A	C	7	3	10	0	0	10	0	0
16	25559193	.	A	G	6	5	11	0	0	11	0	0
16	25559495	.	T	A	3	5	8	0	0	8	0	0
16	25559743	.	A	T	5	8	13	1	0	14	0	0
16	25559837	.	G	A	2	2	4	0	0	4	0	0
16	25559848	.	T	C	1	4	5	0	0	5	0	0
16	25560135	.	T	C	2	0	2	0	3	5	0	0
16	25560184	.	A	G	4	3	7	0	0	7	0	0
16	25560322	.	G	A	3	5	8	0	1	9	0	0
16	25560526	.	T	C	1	4	5	0	0	5	0	0
16	25561681	.	T	A	6	2	8	0	0	8	0	0
16	25561699	.	T	C	5	3	8	0	0	8	0	0
16	25561795	.	C	A	2	6	8	0	0	8	0	0
16	25597510	.	G	A	2	2	4	0	1	5	0	0
16	25642663	.	G	A	13	12	25	0	3	28	0	0
16	25642673	.	C	T	15	17	32	0	0	32	0	0
16	25643038	.	G	A	14	8	22	0	0	22	0	0
16	25643041	.	G	A	7	9	16	0	8	24	0	0
16	25643113	.	G	C	24	9	33	0	1	34	0	0
16	25643452	.	T	A	6	13	19	0	1	20	0	0
16	25643818	.	G	T	10	7	17	0	0	17	0	0
16	25644357	.	C	A	6	3	9	0	0	9	0	0
16	25644378	.	A	T	9	6	15	0	0	15	0	0
16	25673249	.	T	A	8	8	16	0	1	17	0	0
16	25683018	.	T	C	9	3	12	0	2	14	0	0
16	25683387	.	C	T	0	12	12	0	8	20	0	0
16	25698449	.	A	C	2	3	5	0	0	5	0	0
16	25800544	.	G	A	1	3	4	0	0	4	0	0
16	25800756	.	A	G	2	2	4	0	1	5	0	0
16	25812695	.	C	T	1	4	5	0	0	5	0	0
16	26043044	.	T	A	3	5	8	0	0	8	0	0
16	26141688	.	T	A	10	4	14	0	1	15	0	0
16	26141689	.	G	T	9	3	12	0	2	15	1	0
16	26141785	.	C	A	0	5	5	0	12	17	0	0
16	26141817	.	T	G	10	10	20	0	0	20	0	0
16	26142105	.	C	T	5	6	11	0	0	11	0	0
16	26142311	.	A	C	9	5	14	0	2	16	0	0
16	26142646	.	A	C	4	3	7	0	0	7	0	0
16	26142652	.	A	G	5	3	8	0	0	8	0	0
16	26142773	.	G	A	6	6	12	0	0	12	0	0
16	26142779	.	C	T	4	7	11	0	0	11	0	0
16	26142900	.	T	C	9	0	9	0	7	16	0	0
16	26143082	.	A	G	1	2	3	0	0	3	0	0
16	26143332	.	T	C	8	6	14	0	0	14	0	0
16	26143371	.	T	G	4	6	10	0	1	11	0	0
16	26143538	.	C	T	4	2	6	0	0	6	0	0
16	26143561	.	C	T	6	4	10	0	0	10	0	0
16	26146174	.	G	A	8	8	16	0	2	18	0	0
16	26146736	.	G	A	5	3	8	0	0	8	0	0
16	26148741	.	C	T	2	5	7	0	0	7	0	0
16	26148962	.	C	A	4	3	7	0	1	8	0	0
16	26148963	.	C	A	5	3	8	0	0	8	0	0
16	26149005	.	A	T	3	5	8	0	1	9	0	0
16	26153641	.	T	A	6	7	13	0	1	14	0	0
16	26169515	.	T	G	4	3	7	0	0	7	0	0
16	26234460	.	C	T	1	8	9	0	0	9	0	0
16	26235386	.	G	A	2	2	4	0	1	5	0	0
16	26236259	.	C	T	2	5	7	0	0	7	0	0
16	26380517	.	G	T	1	2	3	0	0	3	0	0
16	26380536	.	A	G	5	3	8	0	0	8	0	0
16	26380784	.	C	T	3	14	17	0	15	32	0	0
16	26380866	.	G	A	10	12	22	0	1	23	0	0
16	26381192	.	T	G	12	15	27	0	2	29	0	0
16	26381271	.	C	T	10	12	22	0	2	24	0	0
16	26381344	.	T	G	10	10	20	1	5	26	0	0
16	26381416	.	C	T	2	20	22	0	17	39	0	0
16	26381463	.	C	T	1	13	14	0	23	37	0	0
16	26381768	.	C	T	2	10	12	0	12	24	0	0
16	26382084	.	T	C	15	5	20	0	1	21	0	0
16	26382225	.	A	T	13	10	23	0	1	24	0	0
16	26382243	.	G	A	16	12	28	0	1	29	0	0
16	26382308	.	T	C	22	13	35	0	3	38	0	0
16	26382453	.	T	C	6	0	6	0	14	20	0	0
16	26382585	.	A	G	4	5	9	0	0	9	0	0
16	26382942	.	T	C	16	12	28	0	0	28	0	0
16	26383016	.	C	T	4	13	17	0	26	43	0	0
16	26384188	.	C	G	5	3	8	0	0	8	0	0
16	26384417	.	G	A	8	4	12	0	0	12	0	0
16	26386817	.	T	C	4	3	7	0	0	7	0	0
16	26439576	.	A	G	1	3	4	0	1	5	0	0
16	26440252	.	G	A	4	4	8	0	0	8	0	0
16	26441526	.	T	A	0	1	1	0	1	2	0	0
16	26441532	.	T	C	0	2	2	0	1	3	0	0
16	26443781	.	G	A	2	2	4	0	0	4	0	0
16	26443835	.	C	T	2	2	4	0	1	5	0	0
16	26443958	.	A	T	3	2	5	0	0	5	0	0
16	26443976	.	C	T	3	3	6	0	0	6	0	0
16	26444189	.	A	G	3	3	6	0	0	6	0	0
16	26444431	.	T	A	4	7	11	0	1	12	0	0
16	26444443	.	A	G	6	5	11	0	1	12	0	0
16	26444505	.	C	T	6	8	14	0	0	14	0	0
16	26444668	.	C	T	2	2	4	0	2	6	0	0
16	26444748	.	G	A	4	7	11	0	0	11	0	0
16	26444776	.	G	A	4	6	10	0	0	10	0	0
16	26444830	.	G	A	0	5	5	0	3	8	0	0
16	26445484	.	T	C	5	3	8	0	0	8	0	0
16	26445512	.	A	C	4	2	6	0	1	7	0	0
16	26445547	.	A	G	4	2	6	0	0	6	0	0
16	26445571	.	G	C	5	2	7	0	0	7	0	0
16	26482851	.	T	A	1	3	4	0	1	5	0	0
16	26482917	.	A	T	5	3	8	0	0	8	0	0
16	26483276	.	A	G	1	4	5	0	0	5	0	0
16	26643598	.	G	C	4	5	9	0	0	9	0	0
16	26702648	.	A	C	2	4	6	0	0	6	0	0
16	26702780	.	G	T	0	11	11	0	8	19	0	0
16	26702786	.	G	A	0	8	8	0	10	18	0	0
16	26706875	.	C	T	7	3	10	0	5	15	0	0
16	26707494	.	A	G	1	3	4	1	2	7	0	0
16	26710900	.	C	A	10	14	24	0	2	26	0	0
16	26710954	.	A	T	8	11	19	0	1	20	0	0
16	26710957	.	G	A	9	10	19	0	1	20	0	0
16	26713964	.	G	T	15	11	26	0	0	26	0	0
16	26717318	.	C	T	8	11	19	0	0	19	0	0
16	26717457	.	C	A	7	11	18	0	0	18	0	0
16	26766926	.	G	A	7	7	14	0	0	14	0	0
16	26769118	.	C	T	7	3	10	0	0	10	0	0
16	26816799	.	A	G	7	3	10	0	0	10	0	0
16	26816806	.	G	T	8	2	10	0	0	10	0	0
16	26816852	.	G	T	5	7	12	0	0	12	0	0
16	26816918	.	T	A	5	2	7	0	0	7	0	0
16	26817046	.	T	G	3	7	10	0	0	10	0	0
16	26817069	.	C	T	1	6	7	0	6	13	0	0
16	26817178	.	T	A	4	6	10	0	1	11	0	0
16	26817358	.	C	T	2	7	9	0	0	9	0	0
16	26817754	.	C	T	0	4	4	0	4	8	0	0
16	26850833	.	C	T	3	9	12	0	2	14	0	0
16	26850845	.	T	C	7	13	20	0	0	20	0	0
16	26850885	.	C	T	8	17	25	0	0	25	0	0
16	26851025	.	C	G	3	4	7	1	0	8	0	0
16	26851036	.	T	A	1	3	4	0	1	5	0	0
16	26851110	.	A	C	5	8	13	0	0	13	0	0
16	26851161	.	C	T	0	4	4	0	7	11	0	0
16	26851191	.	C	T	9	5	14	0	0	14	0	0
16	26851236	.	C	T	0	12	12	0	5	17	0	0
16	26851445	.	T	A	10	12	22	0	0	22	0	0
16	26855729	.	C	A	10	9	19	0	0	19	0	0
16	26855786	.	G	A	12	13	25	0	0	25	0	0
16	26855833	.	C	A	0	9	9	0	9	18	0	0
16	26855859	.	C	A	0	10	10	0	14	24	0	0
16	27064764	.	T	C	4	2	6	0	0	6	0	0
16	27064864	.	A	G	6	6	12	0	1	13	0	0
16	27069608	.	A	G	5	0	5	0	7	12	0	0
16	27072488	.	G	A	0	3	3	0	3	6	0	0
16	27080221	.	T	C	6	4	10	0	0	10	0	0
16	27089100	.	T	G	9	7	16	0	1	17	0	0
16	27098305	.	T	C	14	10	24	0	0	24	0	0
16	27098530	.	A	G	6	7	13	0	0	13	0	0
16	27098549	.	A	T	7	5	12	0	0	12	0	0
16	27099508	.	G	A	6	6	12	0	0	12	0	0
16	27100042	.	T	G	1	7	8	0	0	8	0	0
16	27100133	.	A	C	12	6	18	0	2	20	0	0
16	27100139	.	A	T	16	8	24	0	0	24	0	0
16	27100198	.	T	A	14	15	29	0	2	31	0	0
16	27100222	.	T	C	16	14	30	0	1	31	0	0
16	27126647	.	C	T	1	18	19	0	11	30	0	0
16	27126998	.	A	G	8	8	16	0	2	18	0	0
16	27126999	.	T	A	10	8	18	0	0	18	0	0
16	27127157	.	G	C	16	24	40	0	1	41	0	0
16	27127158	.	C	A	16	23	39	0	2	41	0	0
16	27127576	.	T	C	11	14	25	0	2	27	0	0
16	27127959	.	G	A	14	21	35	0	0	35	0	0
16	27131005	.	C	T	1	8	9	0	12	21	0	0
16	27138207	.	C	G	2	4	6	0	0	6	0	0
16	27138391	.	C	G	12	4	16	0	0	16	0	0
16	27148691	.	C	T	6	6	12	0	0	12	0	0
16	27158741	.	A	T	5	4	9	0	0	9	0	0
16	27161089	.	G	A	3	2	5	0	0	5	0	0
16	27169529	.	G	A	11	6	17	0	1	18	0	0
16	27169586	.	G	A	9	4	13	0	0	13	0	0
16	27169664	.	A	T	6	9	15	0	2	17	0	0
16	27169809	.	G	A	11	4	15	0	1	16	0	0
16	27216207	.	C	G	5	4	9	0	0	9	0	0
16	27216701	.	C	T	4	4	8	0	2	10	0	0
16	27216845	.	C	T	0	4	4	0	4	8	0	0
16	27216970	.	G	A	1	2	3	0	0	3	0	0
16	27224450	.	G	C	21	15	36	2	2	40	0	0
16	27225215	.	C	A	17	15	32	0	1	33	0	0
16	27231337	.	T	A	26	22	48	0	2	50	0	0
16	27231416	.	C	T	21	35	56	0	3	59	0	0
16	27345418	.	C	T	1	3	4	0	0	4	0	0
16	27345748	.	C	T	2	2	4	0	0	4	0	0
16	27354980	.	G	A	1	2	3	0	3	6	0	0
16	27356127	.	G	A	4	6	10	0	0	10	0	0
16	27368175	.	G	A	4	9	13	0	0	13	0	0
16	27368290	.	G	A	0	8	8	0	11	19	0	0
16	27368315	.	G	A	0	11	11	0	9	20	0	0
16	27368577	.	A	G	10	12	22	0	2	24	0	0
16	27368688	.	A	C	16	12	28	0	3	31	0	0
16	27368756	.	A	G	9	2	11	0	1	12	0	0
16	27368823	.	T	G	13	10	23	0	2	25	0	0
16	27368863	.	C	T	11	13	24	0	0	24	0	0
16	27417415	.	C	A	3	10	13	0	1	14	0	0
16	27417573	.	T	C	12	12	24	0	0	24	0	0
16	27417659	.	T	G	11	14	25	0	4	29	0	0
16	27417925	.	A	T	11	22	33	0	2	35	0	0
16	27427064	.	A	G	6	8	14	0	0	14	0	0
16	27427760	.	G	A	8	6	14	0	0	14	0	0
16	27428048	.	G	A	4	5	9	0	0	9	0	0
16	27431597	.	G	A	3	8	11	1	1	13	0	0
16	27508505	.	G	A	7	4	11	0	1	12	0	0
16	27513694	.	T	C	5	6	11	0	0	11	0	0
16	27529856	.	G	A	6	4	10	0	1	11	0	0
16	27532506	.	C	T	0	6	6	0	1	7	0	0
16	27533500	.	C	G	2	2	4	0	0	4	0	0
16	27554909	.	C	G	12	10	22	0	0	23	1	0
16	27555010	.	T	C	14	10	24	0	1	25	0	0
16	27555011	.	A	C	14	10	24	0	1	25	0	0
16	27555069	.	C	T	8	14	22	0	0	22	0	0
16	27555221	.	C	T	15	8	23	0	5	28	0	0
16	27555395	.	G	A	9	11	20	0	0	20	0	0
16	27568835	.	A	T	1	2	3	0	0	3	0	0
16	27578391	.	T	C	1	2	3	0	0	3	0	0
16	27578538	.	C	A	3	4	7	0	0	7	0	0
16	27621786	.	A	T	10	4	14	0	0	14	0	0
16	27622109	.	G	A	3	3	6	0	0	6	0	0
16	27626240	.	A	G	31	19	50	0	8	58	0	0
16	27626566	.	G	T	27	25	52	0	4	56	0	0
16	27627051	.	T	C	19	30	49	0	0	49	0	0
16	27629038	.	C	T	3	21	24	0	19	44	1	0
16	27629343	.	A	G	21	16	37	0	1	38	0	0
16	27629365	.	G	T	17	20	37	0	1	38	0	0
16	27629639	.	C	A	30	18	48	0	0	48	0	0
16	27629798	.	A	T	20	13	33	0	3	36	0	0
16	27630174	.	A	T	25	17	42	0	0	42	0	0
16	27630207	.	C	T	20	13	33	0	1	34	0	0
16	27630302	.	A	T	20	13	33	0	1	34	0	0
16	27630552	.	G	A	12	7	19	0	2	21	0	0
16	27630663	.	G	A	11	15	26	0	1	27	0	0
16	27631229	.	A	T	9	5	14	0	0	14	0	0
16	27631585	.	T	A	9	17	26	0	0	26	0	0
16	27631690	.	T	G	7	10	17	0	0	17	0	0
16	27631695	.	T	C	11	6	17	0	1	18	0	0
16	27631741	.	C	A	4	5	9	0	2	11	0	0
16	27631751	.	T	A	3	5	8	0	0	8	0	0
16	27632153	.	C	T	6	3	9	0	1	10	0	0
16	27632189	.	G	A	6	5	11	0	0	11	0	0
16	27632228	.	C	T	3	5	8	0	0	8	0	0
16	27632766	.	G	T	5	2	7	0	0	7	0	0
16	27632768	.	G	T	5	2	7	0	0	7	0	0
16	27632934	.	T	C	3	7	10	0	0	10	0	0
16	27633002	.	G	A	3	2	5	0	0	5	0	0
16	27633812	.	C	T	2	5	7	0	0	7	0	0
16	27633839	.	T	C	2	0	2	0	3	5	0	0
16	27669917	.	T	G	2	6	8	0	1	9	0	0
16	27670010	.	A	T	2	4	6	0	0	6	0	0
16	27672033	.	A	G	1	2	3	0	0	3	0	0
16	27735389	.	A	G	5	5	10	0	1	11	0	0
16	27735451	.	A	G	4	3	7	0	1	8	0	0
16	27735663	.	T	C	2	5	7	0	0	7	0	0
16	27737205	.	G	A	1	2	3	0	0	3	0	0
16	27737208	.	C	A	1	2	3	0	0	3	0	0
16	28112706	.	A	T	5	5	10	0	0	10	0	0
16	28112772	.	G	A	9	6	15	1	0	16	0	0
16	28113049	.	G	A	2	6	8	0	0	8	0	0
16	28256800	.	G	T	9	7	16	0	1	17	0	0
16	28263526	.	G	A	4	6	10	0	1	11	0	0
16	28264350	.	C	T	11	3	14	0	1	15	0	0
16	28268273	.	C	A	2	4	6	0	0	6	0	0
16	28270118	.	C	T	2	4	6	0	0	6	0	0
16	28270443	.	T	C	3	2	5	0	0	5	0	0
16	28272554	.	T	C	5	4	9	0	0	9	0	0
16	28272555	.	G	A	5	4	9	0	0	9	0	0
16	28276389	.	C	T	5	5	10	1	1	12	0	0
16	28278360	.	T	C	3	2	5	0	0	5	0	0
16	28280057	.	T	C	1	4	5	0	0	5	0	0
16	28370872	.	T	A	7	4	11	0	0	11	0	0
16	28370943	.	A	T	6	7	13	0	0	13	0	0
16	28493263	.	A	T	1	2	3	0	1	4	0	0
16	28573328	.	G	C	0	4	4	0	3	7	0	0
16	28573665	.	C	A	4	2	6	0	0	6	0	0
16	28573871	.	A	C	5	6	11	0	0	11	0	0
16	28573928	.	C	T	3	5	8	0	0	8	0	0
16	28574403	.	C	T	3	7	10	0	0	10	0	0
16	28574531	.	T	G	5	9	14	0	0	14	0	0
16	28574664	.	G	A	5	2	7	0	2	9	0	0
16	28591186	.	T	A	16	7	23	0	2	25	0	0
16	28591277	.	A	G	10	16	26	0	0	26	0	0
16	28591312	.	G	A	0	13	13	0	16	29	0	0
16	28591353	.	A	C	13	14	27	0	1	28	0	0
16	28591385	.	C	G	7	15	22	0	0	22	0	0
16	28592667	.	G	C	4	1	5	0	8	13	0	0
16	28592758	.	A	T	8	6	14	0	2	16	0	0
16	28593430	.	G	A	8	7	15	0	1	16	0	0
16	28593679	.	T	C	5	0	5	0	7	12	0	0
16	28593705	.	C	T	5	3	8	0	0	8	0	0
16	28624646	.	C	T	2	2	4	0	0	4	0	0
16	28624648	.	G	C	1	2	3	0	2	5	0	0
16	28626282	.	G	A	2	4	6	0	0	6	0	0
16	28626997	.	C	T	5	5	10	0	0	10	0	0
16	28627005	.	C	T	5	5	10	0	0	10	0	0
16	28627127	.	C	T	3	8	11	0	0	11	0	0
16	28627198	.	T	A	4	4	8	0	1	9	0	0
16	28627341	.	T	G	7	10	17	0	1	18	0	0
16	28627342	.	T	A	5	11	16	0	1	18	1	0
16	28629299	.	C	T	1	8	9	0	7	16	0	0
16	28629504	.	C	T	5	4	9	0	0	9	0	0
16	28634954	.	G	A	2	5	7	0	2	9	0	0
16	28664967	.	T	C	6	2	8	0	0	8	0	0
16	28664970	.	T	G	3	5	8	0	0	8	0	0
16	28667189	.	C	A	1	2	3	0	0	3	0	0
16	28678847	.	G	A	1	2	3	0	0	3	0	0
16	28842438	.	C	T	16	15	31	0	3	34	0	0
16	28856026	.	G	A	7	8	15	0	0	15	0	0
16	28983897	.	G	A	2	2	4	0	1	5	0	0
16	28990523	.	C	G	6	5	11	0	0	11	0	0
16	29010155	.	T	A	2	3	5	0	0	5	0	0
16	29010826	.	A	T	2	6	8	0	0	8	0	0
16	29012961	.	C	T	8	3	11	0	1	12	0	0
16	29012992	.	A	G	10	0	10	0	5	15	0	0
16	29013039	.	C	G	9	4	13	0	0	13	0	0
16	29013126	.	C	T	5	3	8	0	1	9	0	0
16	29013134	.	C	A	4	4	8	0	1	9	0	0
16	29013377	.	C	T	9	3	12	0	1	13	0	0
16	29014091	.	A	T	4	2	6	0	1	7	0	0
16	29014109	.	T	C	6	4	10	0	0	10	0	0
16	29016659	.	C	T	6	6	12	0	0	12	0	0
16	29016904	.	T	C	9	7	16	0	0	16	0	0
16	29017221	.	T	C	6	6	12	0	1	13	0	0
16	29019039	.	G	A	13	11	24	0	0	24	0	0
16	29020482	.	G	T	19	18	37	1	0	38	0	0
16	29022955	.	C	A	15	6	21	0	0	21	0	0
16	29023266	.	A	T	7	3	10	0	1	11	0	0
16	29024280	.	T	G	11	0	11	0	7	18	0	0
16	29024341	.	T	C	3	6	9	0	0	9	0	0
16	29024405	.	C	T	8	6	14	0	0	14	0	0
16	29024409	.	C	T	9	6	15	0	1	16	0	0
16	29024512	.	A	T	6	9	15	0	1	16	0	0
16	29024551	.	A	T	8	10	18	0	0	18	0	0
16	29024552	.	T	G	8	9	17	0	1	18	0	0
16	29029392	.	G	A	3	2	5	0	1	6	0	0
16	29029444	.	G	A	4	4	8	0	0	8	0	0
16	29029476	.	A	G	4	2	6	0	1	7	0	0
16	29029596	.	T	A	2	6	8	0	0	8	0	0
16	29051841	.	C	G	4	3	7	0	0	7	0	0
16	29051842	.	C	A	3	3	6	0	1	7	0	0
16	29052653	.	A	T	2	6	8	0	0	8	0	0
16	29052752	.	C	G	3	0	3	0	3	6	0	0
16	29052914	.	G	A	5	5	10	0	0	10	0	0
16	29052991	.	C	T	2	9	11	0	0	11	0	0
16	29053045	.	T	A	6	7	13	0	0	13	0	0
16	29053534	.	A	G	1	4	5	0	0	5	0	0
16	29053668	.	A	G	1	6	7	0	0	7	0	0
16	29053915	.	A	C	10	2	12	0	0	12	0	0
16	29054122	.	G	A	2	2	4	0	0	4	0	0
16	29073621	.	T	A	10	3	13	0	1	14	0	0
16	29074254	.	G	A	26	23	49	0	3	52	0	0
16	29074459	.	T	A	10	9	19	2	4	25	0	0
16	29075137	.	C	T	11	14	25	2	1	28	0	0
16	29075195	.	A	G	15	12	27	2	1	30	0	0
16	29075222	.	T	A	12	7	19	0	2	21	0	0
16	29075305	.	G	A	7	13	20	0	2	22	0	0
16	29075343	.	G	A	18	14	32	0	2	34	0	0
16	29075347	.	C	G	14	18	32	0	0	33	1	0
16	29075674	.	C	A	15	13	28	0	2	30	0	0
16	29075870	.	G	T	10	12	22	0	1	23	0	0
16	29075959	.	C	T	9	6	15	0	1	16	0	0
16	29075962	.	C	T	6	8	14	0	2	16	0	0
16	29076270	.	G	T	13	16	29	0	4	33	0	0
16	29076407	.	C	T	0	18	18	0	15	33	0	0
16	29076471	.	G	A	19	9	28	0	2	30	0	0
16	29076575	.	C	G	0	14	14	0	13	27	0	0
16	29076633	.	G	A	14	12	26	0	3	29	0	0
16	29076669	.	A	G	18	11	29	0	1	30	0	0
16	29076678	.	T	C	20	0	20	0	8	28	0	0
16	29111066	.	T	C	6	0	6	0	6	12	0	0
16	29225676	.	C	T	1	2	3	0	0	3	0	0
16	29225873	.	C	G	10	10	20	0	0	20	0	0
16	29226129	.	A	T	5	9	14	0	0	14	0	0
16	29226151	.	C	A	7	7	14	0	0	14	0	0
16	29226588	.	A	T	2	6	8	0	0	8	0	0
16	29265958	.	A	G	13	6	19	0	3	22	0	0
16	29265992	.	A	C	14	5	19	0	0	19	0	0
16	29266332	.	G	C	7	5	12	0	0	12	0	0
16	29266371	.	T	A	6	5	11	0	1	12	0	0
16	29266456	.	T	A	5	2	7	0	0	7	0	0
16	29266775	.	A	G	3	4	7	0	0	7	0	0
16	29266778	.	C	G	3	4	7	0	0	7	0	0
16	29310150	.	T	A	6	7	13	0	2	15	0	0
16	29310455	.	C	T	28	15	43	0	2	45	0	0
16	29310530	.	C	A	27	14	41	0	1	42	0	0
16	29310541	.	A	G	25	12	37	0	1	38	0	0
16	29310760	.	C	A	14	15	29	0	1	30	0	0
16	29310893	.	G	A	13	4	17	0	4	21	0	0
16	29311381	.	G	A	15	11	26	0	0	26	0	0
16	29311493	.	A	G	21	14	35	0	0	35	0	0
16	29311720	.	T	C	11	11	22	0	1	23	0	0
16	29314147	.	C	A	13	5	18	0	0	18	0	0
16	29320647	.	A	G	7	10	17	0	2	19	0	0
16	29320674	.	T	G	7	9	16	0	1	17	0	0
16	29320870	.	T	C	2	0	2	0	4	6	0	0
16	29321269	.	C	T	2	5	7	0	0	7	0	0
16	29321290	.	C	T	2	4	6	0	1	7	0	0
16	29321310	.	C	T	2	3	5	0	2	7	0	0
16	29323307	.	T	C	5	3	8	0	0	8	0	0
16	29323864	.	C	T	2	2	4	0	2	6	0	0
16	29369809	.	C	A	1	2	3	0	0	3	0	0
16	29370972	.	A	G	3	3	6	0	0	6	0	0
16	29371029	.	C	T	0	3	3	0	1	4	0	0
16	29371084	.	T	A	3	3	6	1	0	7	0	0
16	29371164	.	A	G	1	3	4	0	1	5	0	0
16	29371187	.	T	C	2	2	4	0	0	4	0	0
16	29374075	.	A	C	3	2	5	0	1	6	0	0
16	29381204	.	G	T	5	3	8	0	0	8	0	0
16	29381391	.	T	C	2	5	7	0	0	7	0	0
16	29384090	.	T	C	9	5	14	0	0	14	0	0
16	29384099	.	T	A	9	3	12	0	0	12	0	0
16	29407754	.	C	T	6	4	10	0	1	11	0	0
16	29407791	.	C	A	12	6	18	0	0	18	0	0
16	29408024	.	A	C	26	14	40	0	2	42	0	0
16	29408926	.	A	T	24	14	38	0	0	38	0	0
16	29408948	.	T	A	11	18	29	0	1	30	0	0
16	29409134	.	A	G	1	2	3	0	1	4	0	0
16	29409361	.	T	C	20	13	33	0	1	34	0	0
16	29409476	.	T	C	35	10	45	0	4	49	0	0
16	29409544	.	T	C	22	11	33	1	1	35	0	0
16	29409571	.	A	T	12	17	29	0	1	30	0	0
16	29409646	.	T	G	18	15	33	0	6	39	0	0
16	29410425	.	A	G	22	25	47	0	2	49	0	0
16	29410520	.	A	G	11	18	29	0	2	31	0	0
16	29411209	.	G	A	22	21	43	0	4	47	0	0
16	29413193	.	C	T	0	11	11	0	15	26	0	0
16	29414004	.	A	C	6	8	14	0	0	14	0	0
16	29421026	.	C	T	1	5	6	0	0	6	0	0
16	29425278	.	G	A	4	2	6	0	0	6	0	0
16	29456052	.	A	G	1	4	5	0	1	6	0	0
16	29456966	.	G	A	5	3	8	0	0	8	0	0
16	29456996	.	A	G	4	2	6	0	0	6	0	0
16	29457158	.	A	G	1	4	5	0	0	5	0	0
16	29457473	.	T	A	8	4	12	0	0	12	0	0
16	29586680	.	A	G	9	8	17	0	3	20	0	0
16	29587067	.	G	A	5	2	7	0	1	8	0	0
16	29587672	.	G	A	2	2	4	0	3	7	0	0
16	29642184	.	T	C	8	7	15	0	2	17	0	0
16	29644223	.	C	T	8	6	14	0	0	14	0	0
16	29663968	.	T	C	1	2	3	0	0	3	0	0
16	29676606	.	C	T	2	3	5	0	0	5	0	0
16	29686355	.	G	C	5	5	10	0	0	10	0	0
16	29686370	.	G	T	5	8	13	0	1	14	0	0
16	29691160	.	A	T	1	2	3	0	0	3	0	0
16	29693999	.	A	G	3	5	8	0	0	8	0	0
16	29695795	.	A	T	1	2	3	0	0	3	0	0
16	29696212	.	G	C	1	3	4	0	0	4	0	0
16	30036400	.	T	A	2	2	4	0	0	4	0	0
16	30267228	.	A	G	8	0	8	0	10	18	0	0
16	30268145	.	C	T	8	7	15	0	0	15	0	0
16	30268242	.	T	C	7	6	13	0	0	13	0	0
16	30268290	.	G	A	4	4	8	0	0	8	0	0
16	30268475	.	A	C	2	4	6	0	1	7	0	0
16	30268633	.	C	T	6	3	9	0	1	10	0	0
16	30268660	.	A	G	7	6	13	0	2	15	0	0
16	30268675	.	C	T	8	6	14	0	0	14	0	0
16	30269159	.	A	C	8	4	12	0	0	12	0	0
16	30270332	.	G	T	1	6	7	0	11	18	0	0
16	30270381	.	T	G	7	5	12	0	0	13	1	0
16	30270601	.	C	T	20	13	33	0	2	35	0	0
16	30322796	.	C	T	3	4	7	0	0	7	0	0
16	30322928	.	G	A	1	2	3	0	0	3	0	0
16	30323212	.	T	A	1	2	3	0	1	4	0	0
16	30323278	.	A	C	4	3	7	0	0	7	0	0
16	30408725	.	A	T	2	2	4	0	0	4	0	0
16	30408917	.	A	G	23	18	41	0	3	44	0	0
16	30409055	.	A	T	22	35	57	0	1	58	0	0
16	30409313	.	A	T	31	25	56	0	0	56	0	0
16	30415027	.	C	T	20	26	46	0	2	48	0	0
16	30417511	.	A	G	13	20	33	0	2	35	0	0
16	30417977	.	A	G	13	7	20	0	0	20	0	0
16	30417986	.	A	G	12	7	19	0	0	19	0	0
16	30419504	.	A	G	14	8	22	0	1	23	0	0
16	30420547	.	C	T	3	5	8	0	1	9	0	0
16	30422582	.	C	G	9	17	26	0	2	28	0	0
16	30422807	.	T	C	13	0	13	0	10	23	0	0
16	30422891	.	G	A	10	9	19	0	2	21	0	0
16	30423297	.	A	C	3	4	7	0	1	8	0	0
16	30423313	.	C	T	3	4	7	0	0	7	0	0
16	30423339	.	T	C	4	2	6	0	0	6	0	0
16	30423348	.	T	C	4	2	6	0	0	6	0	0
16	30423680	.	G	C	5	3	8	0	0	8	0	0
16	30423953	.	G	A	10	14	24	0	2	26	0	0
16	30426496	.	T	A	1	6	7	0	0	7	0	0
16	30434215	.	T	A	1	3	4	0	0	4	0	0
16	30515689	.	A	T	1	2	3	0	0	3	0	0
16	30518702	.	T	A	1	5	6	0	0	6	0	0
16	30521704	.	A	T	5	8	13	2	0	15	0	0
16	30522108	.	T	A	3	2	5	0	0	5	0	0
16	30522109	.	T	G	2	2	4	0	1	5	0	0
16	30522176	.	G	C	2	8	10	0	2	12	0	0
16	30522317	.	G	C	5	5	10	0	1	11	0	0
16	30522334	.	C	T	5	6	11	0	0	11	0	0
16	30522471	.	T	G	2	3	5	0	0	5	0	0
16	30522688	.	A	T	1	6	7	0	0	7	0	0
16	30522852	.	G	A	0	3	3	0	0	3	0	0
16	30522862	.	T	C	4	0	4	0	4	8	0	0
16	30522923	.	C	T	0	11	11	0	3	14	0	0
16	30525371	.	T	C	2	0	2	0	4	6	0	0
16	30525458	.	A	G	3	6	9	0	0	9	0	0
16	30525499	.	A	G	5	5	10	0	0	10	0	0
16	30530401	.	C	T	3	3	6	0	1	7	0	0
16	30531304	.	C	T	4	10	14	0	0	14	0	0
16	30531358	.	T	C	1	3	4	0	0	4	0	0
16	30537749	.	C	A	2	3	5	0	0	5	0	0
16	30737594	.	A	G	12	13	25	0	1	26	0	0
16	30737638	.	C	T	17	10	27	0	1	28	0	0
16	30737770	.	A	G	18	25	43	0	1	44	0	0
16	30738108	.	C	T	0	18	18	0	10	28	0	0
16	30740719	.	T	G	11	15	26	0	2	28	0	0
16	30760879	.	A	C	8	0	8	0	8	16	0	0
16	30772417	.	C	T	2	10	12	0	17	30	1	0
16	30785451	.	T	C	8	7	15	0	1	16	0	0
16	30788182	.	A	G	8	6	14	0	0	14	0	0
16	30794822	.	T	G	5	3	8	0	0	9	1	0
16	30800501	.	G	A	5	8	13	0	0	13	0	0
16	30808411	.	T	C	6	4	10	0	0	10	0	0
16	30808429	.	C	T	1	5	6	0	4	10	0	0
16	30826525	.	A	G	1	2	3	0	0	3	0	0
16	30826614	.	A	C	3	2	5	0	2	7	0	0
16	30869597	.	C	G	0	4	4	0	1	5	0	0
16	30869623	.	A	T	2	3	5	0	0	5	0	0
16	30908705	.	G	C	2	2	4	0	0	4	0	0
16	30908825	.	A	C	3	5	8	0	0	8	0	0
16	30909201	.	A	G	1	3	4	0	1	5	0	0
16	30909346	.	C	T	4	3	7	0	0	7	0	0
16	30909367	.	A	G	3	4	7	0	0	7	0	0
16	30910272	.	A	G	2	3	5	0	0	5	0	0
16	30910338	.	T	G	2	2	4	0	0	4	0	0
16	30910347	.	A	C	2	1	3	0	1	4	0	0
16	30914543	.	C	G	1	2	3	0	0	3	0	0
16	30918951	.	A	T	1	2	3	0	0	3	0	0
16	30948760	.	C	T	1	6	7	0	0	7	0	0
16	30948813	.	C	A	3	5	8	0	0	8	0	0
16	30948834	.	G	C	2	5	7	0	0	7	0	0
16	30948870	.	T	C	1	3	4	0	0	4	0	0
16	30948876	.	T	A	3	3	6	0	0	6	0	0
16	30980501	.	G	A	1	2	3	0	1	4	0	0
16	30983131	.	C	T	0	2	2	0	1	3	0	0
16	30983137	.	T	A	1	2	3	0	0	3	0	0
16	31186631	.	A	T	11	10	21	0	1	22	0	0
16	31187097	.	C	T	1	5	6	0	4	10	0	0
16	31187322	.	A	G	8	5	13	0	1	14	0	0
16	31188481	.	G	A	7	4	11	0	2	13	0	0
16	31260754	.	G	A	3	7	10	0	0	10	0	0
16	31261003	.	A	T	7	7	14	0	0	14	0	0
16	31261213	.	C	A	0	3	3	0	6	9	0	0
16	31261344	.	C	T	8	3	11	0	1	12	0	0
16	31267559	.	C	T	2	5	7	0	4	11	0	0
16	31268860	.	G	C	3	0	3	0	3	6	0	0
16	31268893	.	C	A	5	4	9	0	0	9	0	0
16	31272424	.	C	G	5	5	10	0	0	10	0	0
16	31274491	.	G	A	1	4	5	0	0	5	0	0
16	31280355	.	G	A	2	3	5	0	0	5	0	0
16	31314157	.	G	A	1	3	4	0	0	4	0	0
16	31429409	.	A	G	2	2	4	0	0	4	0	0
16	31435306	.	A	T	1	3	4	0	0	4	0	0
16	31437115	.	A	G	15	16	31	0	2	33	0	0
16	31437955	.	A	G	29	25	54	2	2	58	0	0
16	31444428	.	G	A	9	8	17	0	2	19	0	0
16	31444843	.	A	T	8	14	22	0	1	23	0	0
16	31445516	.	T	C	15	7	22	0	2	24	0	0
16	31454477	.	G	C	2	3	5	0	0	5	0	0
16	31454495	.	G	T	2	3	5	0	0	5	0	0
16	31454548	.	A	G	1	2	3	0	1	4	0	0
16	31454614	.	G	C	2	2	4	0	0	4	0	0
16	31454928	.	T	A	3	2	5	0	1	6	0	0
16	31455092	.	T	C	2	3	5	0	0	5	0	0
16	31516398	.	A	G	3	4	7	0	0	7	0	0
16	31602170	.	A	G	5	3	8	0	1	9	0	0
16	31608101	.	C	T	0	2	2	0	6	8	0	0
16	31608967	.	G	T	3	6	9	0	0	9	0	0
16	31609241	.	C	T	1	4	5	0	5	10	0	0
16	31610375	.	C	T	3	3	6	0	1	7	0	0
16	31614272	.	C	G	5	4	9	0	0	9	0	0
16	31614918	.	G	A	4	4	8	0	0	8	0	0
16	31615114	.	G	A	2	2	4	0	1	5	0	0
16	31728192	.	A	G	1	4	5	0	0	5	0	0
16	31762960	.	C	T	14	19	33	0	1	34	0	0
16	31763316	.	T	C	22	14	36	0	1	37	0	0
16	31763318	.	C	T	22	13	35	0	1	36	0	0
16	31763668	.	C	G	11	16	27	0	3	30	0	0
16	31763743	.	T	A	23	26	49	0	1	50	0	0
16	31763751	.	A	C	21	28	49	0	2	51	0	0
16	31763785	.	G	A	31	14	45	0	0	45	0	0
16	31763786	.	C	A	28	13	41	0	4	45	0	0
16	31763880	.	A	G	15	18	33	0	0	33	0	0
16	31764987	.	C	T	13	8	21	0	1	22	0	0
16	31766937	.	T	A	13	5	18	0	0	18	0	0
16	31767116	.	T	C	5	0	5	0	11	16	0	0
16	31767152	.	A	G	14	7	21	0	1	22	0	0
16	31767163	.	G	A	12	8	20	0	0	20	0	0
16	31768343	.	C	G	14	9	23	0	1	24	0	0
16	31768394	.	T	C	15	5	20	0	1	21	0	0
16	31768436	.	T	C	13	11	24	0	0	24	0	0
16	31769317	.	G	A	18	14	32	0	1	33	0	0
16	31769395	.	A	G	10	10	20	0	0	20	0	0
16	31769428	.	G	A	7	7	14	0	0	14	0	0
16	31770050	.	T	C	11	0	11	0	7	18	0	0
16	31776125	.	C	T	8	2	10	0	1	11	0	0
16	31780108	.	C	T	0	5	5	0	2	7	0	0
16	31789327	.	C	T	1	2	3	0	0	3	0	0
16	31812797	.	G	T	2	2	4	0	0	4	0	0
16	31815638	.	C	T	19	11	30	0	1	31	0	0
16	31815878	.	G	A	7	13	20	0	0	20	0	0
16	31816005	.	C	A	12	9	21	1	1	23	0	0
16	31816336	.	C	T	0	9	9	0	7	16	0	0
16	31816596	.	C	T	11	11	22	0	3	25	0	0
16	31827642	.	T	A	18	12	30	0	0	31	1	0
16	31827703	.	C	T	19	12	31	0	2	33	0	0
16	31832606	.	A	G	21	1	22	0	32	54	0	0
16	31834505	.	G	A	1	2	3	0	1	4	0	0
16	31834930	.	G	A	0	2	2	0	1	3	0	0
16	31836146	.	G	A	1	2	3	0	0	3	0	0
16	31853932	.	T	A	4	2	6	0	0	6	0	0
16	31855575	.	C	T	3	2	5	0	0	5	0	0
16	31855576	.	C	T	3	2	5	0	0	5	0	0
16	31855814	.	T	G	1	1	2	0	4	6	0	0
16	31856239	.	A	G	2	3	5	0	0	5	0	0
16	31856276	.	G	A	0	3	3	0	2	5	0	0
16	31859227	.	T	C	18	18	36	0	1	37	0	0
16	31859310	.	A	G	24	16	40	1	4	45	0	0
16	31859341	.	C	T	29	12	41	1	1	43	0	0
16	31859371	.	T	C	22	12	34	4	2	40	0	0
16	31859416	.	T	C	7	17	24	4	3	31	0	0
16	31859425	.	C	T	3	18	21	1	3	25	0	0
16	31859686	.	G	A	8	10	18	0	1	19	0	0
16	31868443	.	G	A	20	13	33	0	0	33	0	0
16	31922892	.	A	G	36	23	59	0	2	61	0	0
16	31923083	.	G	A	44	30	74	0	2	76	0	0
16	31923435	.	A	G	32	33	65	0	3	68	0	0
16	31924485	.	T	C	31	25	56	0	2	58	0	0
16	31924501	.	A	C	31	27	58	0	1	59	0	0
16	31925035	.	A	G	2	2	4	0	0	4	0	0
16	31925727	.	G	A	5	4	9	0	0	9	0	0
16	31927369	.	C	A	2	3	5	0	0	5	0	0
16	31958957	.	G	T	6	3	9	0	0	9	0	0
16	31959098	.	G	A	2	4	6	0	2	8	0	0
16	31959156	.	G	A	4	3	7	0	0	7	0	0
16	31959179	.	T	G	5	5	10	0	1	11	0	0
16	31959225	.	G	A	3	8	11	0	0	11	0	0
16	31959231	.	A	T	3	8	11	0	0	11	0	0
16	31959612	.	G	A	5	5	10	0	0	10	0	0
16	31960037	.	G	A	1	5	6	0	4	10	0	0
16	31960064	.	G	C	6	6	12	0	1	13	0	0
16	31960145	.	C	T	13	11	24	0	1	25	0	0
16	31960152	.	C	T	8	9	17	0	4	21	0	0
16	32009736	.	A	T	8	5	13	0	0	13	0	0
16	32011649	.	C	T	8	6	14	0	1	15	0	0
16	32011673	.	A	G	8	7	15	0	0	15	0	0
16	32013272	.	G	A	1	3	4	0	1	5	0	0
16	32013891	.	G	A	1	4	5	0	0	5	0	0
16	32021999	.	C	T	6	2	8	0	0	8	0	0
16	32023124	.	T	A	2	9	11	0	0	11	0	0
16	32025648	.	T	A	9	13	22	0	1	23	0	0
16	32025978	.	G	A	5	5	10	0	1	11	0	0
16	32025987	.	T	A	5	6	11	0	1	12	0	0
16	32026063	.	G	A	1	6	7	0	15	22	0	0
16	32026105	.	T	A	15	4	19	0	0	19	0	0
16	32026154	.	T	G	3	3	6	0	1	7	0	0
16	32026250	.	C	T	1	2	3	0	0	3	0	0
16	32051854	.	A	C	6	6	12	0	1	13	0	0
16	32052004	.	T	G	11	6	17	0	2	19	0	0
16	32052283	.	T	A	12	6	18	0	2	20	0	0
16	32052307	.	T	C	8	7	15	0	1	16	0	0
16	32052328	.	T	A	9	7	16	0	0	16	0	0
16	32052404	.	G	T	1	6	7	0	6	13	0	0
16	32055726	.	T	G	8	12	20	0	2	22	0	0
16	32057809	.	T	C	8	9	17	0	1	18	0	0
16	32057853	.	G	A	0	9	9	0	14	23	0	0
16	32068452	.	C	A	1	2	3	0	0	3	0	0
16	32069310	.	T	A	5	4	9	0	0	9	0	0
16	32069653	.	A	G	5	3	8	0	0	8	0	0
16	32070489	.	A	G	4	1	5	0	2	7	0	0
16	32070570	.	C	T	4	3	7	0	0	7	0	0
16	32070981	.	G	C	6	3	9	0	1	10	0	0
16	32071997	.	C	A	6	4	10	0	0	10	0	0
16	32072334	.	A	G	10	4	14	0	0	14	0	0
16	32073301	.	A	C	17	14	31	0	4	35	0	0
16	32073507	.	A	C	21	14	35	0	0	35	0	0
16	32073555	.	A	G	18	14	32	0	1	33	0	0
16	32073760	.	G	A	14	13	27	0	3	30	0	0
16	32074041	.	G	A	18	14	32	0	2	34	0	0
16	32074257	.	A	G	19	1	20	0	24	44	0	0
16	32074293	.	T	A	20	20	40	0	1	41	0	0
16	32074294	.	A	G	19	18	37	0	4	41	0	0
16	32080069	.	G	T	1	9	10	0	8	18	0	0
16	32080099	.	G	A	5	3	8	0	1	9	0	0
16	32080196	.	T	C	3	3	6	0	0	6	0	0
16	32080206	.	T	C	4	3	7	0	1	8	0	0
16	32080306	.	T	A	13	3	16	0	1	17	0	0
16	32080508	.	T	A	13	19	32	0	2	34	0	0
16	32082589	.	G	A	7	5	12	0	0	12	0	0
16	32082597	.	G	A	6	5	11	0	1	12	0	0
16	32085778	.	A	C	4	3	7	0	0	7	0	0
16	32086136	.	C	T	7	4	11	0	3	14	0	0
16	32088580	.	T	A	10	5	15	0	0	15	0	0
16	32090349	.	C	T	16	11	27	0	2	29	0	0
16	32110659	.	A	G	12	12	24	0	0	24	0	0
16	32111246	.	G	T	14	7	21	0	1	22	0	0
16	32113155	.	G	A	11	12	23	0	1	24	0	0
16	32113218	.	G	A	7	13	20	0	0	20	0	0
16	32116790	.	A	T	8	13	21	0	0	21	0	0
16	32117345	.	T	A	8	6	14	0	4	18	0	0
16	32119581	.	C	A	3	3	6	0	0	6	0	0
16	32119618	.	C	T	2	3	5	0	1	6	0	0
16	32120138	.	G	T	2	3	5	0	0	5	0	0
16	32120141	.	T	C	2	0	2	0	3	5	0	0
16	32120173	.	G	A	3	6	9	0	0	9	0	0
16	32120204	.	G	T	3	3	6	0	2	9	1	0
16	32141544	.	A	G	9	0	9	0	4	13	0	0
16	32141565	.	A	C	8	4	12	0	0	12	0	0
16	32141604	.	A	T	3	5	8	0	1	9	0	0
16	32144337	.	T	C	4	4	8	0	0	8	0	0
16	32144377	.	T	C	6	3	9	0	1	10	0	0
16	32144854	.	G	T	2	7	9	0	3	12	0	0
16	32144989	.	T	C	6	3	9	0	0	9	0	0
16	32145160	.	T	A	3	8	11	0	0	11	0	0
16	32145391	.	G	A	3	3	6	0	0	6	0	0
16	32145547	.	T	C	5	5	10	0	0	10	0	0
16	32145636	.	A	G	6	13	19	0	0	19	0	0
16	32197969	.	C	T	14	13	27	0	3	30	0	0
16	32267128	.	G	A	1	5	6	0	1	7	0	0
16	32267203	.	G	A	0	4	4	0	7	11	0	0
16	32273066	.	G	T	2	3	5	0	1	6	0	0
16	32273192	.	G	A	0	9	9	0	8	17	0	0
16	32275601	.	T	A	8	8	16	0	1	17	0	0
16	32275628	.	A	T	11	6	17	0	1	18	0	0
16	32285404	.	G	A	3	2	5	0	0	5	0	0
16	32561581	.	T	A	1	5	6	0	0	6	0	0
16	32561618	.	T	C	2	4	6	0	3	9	0	0
16	32562038	.	A	T	4	6	10	0	1	11	0	0
16	32562817	.	A	T	5	3	8	0	1	9	0	0
16	33595712	.	G	T	1	1	2	0	3	5	0	0
16	33735849	.	A	T	2	2	4	0	0	4	0	0
16	33736038	.	G	A	1	2	3	0	0	3	0	0
16	33736196	.	A	C	1	4	5	0	1	6	0	0
16	33773770	.	C	A	1	2	3	0	0	3	0	0
16	33774584	.	C	A	0	2	2	0	2	4	0	0
16	33919623	.	G	A	3	3	6	0	0	6	0	0
16	33923421	.	G	T	7	3	10	1	0	11	0	0
16	33923448	.	G	T	3	15	18	1	0	19	0	0
16	33923514	.	G	A	11	6	17	0	0	17	0	0
16	33925132	.	G	C	2	13	15	0	0	15	0	0
16	33925565	.	T	G	3	5	8	0	1	9	0	0
16	33928015	.	G	A	0	2	2	0	2	4	0	0
16	33933213	.	C	T	10	7	17	0	1	18	0	0
16	33933496	.	G	C	3	2	5	0	2	7	0	0
16	33933498	.	C	T	3	3	6	0	1	7	0	0
16	33933732	.	G	A	2	6	8	0	4	12	0	0
16	33939859	.	C	T	6	7	13	0	0	13	0	0
16	33940098	.	G	A	3	3	6	0	0	6	0	0
16	33940122	.	G	A	3	6	9	0	0	9	0	0
16	33940364	.	A	G	1	0	1	0	9	10	0	0
16	33953968	.	C	T	4	2	6	0	0	6	0	0
16	33972008	.	G	A	1	2	3	0	1	4	0	0
16	33972037	.	A	C	2	3	5	0	0	5	0	0
16	33972067	.	A	G	2	3	5	0	1	6	0	0
16	33972193	.	G	A	0	3	3	0	3	6	0	0
16	33972454	.	C	T	1	3	4	0	1	5	0	0
16	33978019	.	A	G	2	0	2	0	4	6	0	0
16	33981873	.	A	G	6	0	6	0	3	9	0	0
16	33983784	.	T	G	3	7	10	0	0	10	0	0
16	33983904	.	C	T	8	5	13	0	0	13	0	0
16	33984190	.	C	T	6	2	8	0	1	9	0	0
16	33985050	.	G	T	2	13	15	0	18	33	0	0
16	33985362	.	C	T	13	9	22	0	0	22	0	0
16	33986179	.	A	T	15	15	30	0	2	32	0	0
16	33986452	.	T	G	21	18	39	0	2	41	0	0
16	33989933	.	G	A	0	3	3	0	2	5	0	0
16	33996739	.	C	T	2	9	11	0	0	11	0	0
16	34004562	.	G	A	1	11	12	0	6	18	0	0
16	34004595	.	T	C	9	14	23	0	1	24	0	0
16	34004862	.	C	T	7	5	12	0	0	12	0	0
16	34005290	.	C	T	8	3	11	0	1	12	0	0
16	34005415	.	C	T	5	5	10	0	1	11	0	0
16	34005500	.	C	A	10	5	15	0	1	16	0	0
16	34005577	.	A	G	9	4	13	0	0	13	0	0
16	34005669	.	C	T	8	12	20	0	0	20	0	0
16	34005686	.	C	T	11	11	22	0	2	24	0	0
16	34005812	.	T	A	12	6	18	0	2	20	0	0
16	34006020	.	G	C	5	7	12	0	0	12	0	0
16	34006051	.	G	A	3	4	7	0	0	7	0	0
16	34006222	.	A	T	2	2	4	0	1	5	0	0
16	34054141	.	A	G	4	4	8	0	0	8	0	0
16	34054171	.	A	G	2	2	4	0	1	5	0	0
16	34054345	.	A	G	4	0	4	0	3	7	0	0
16	34054464	.	C	A	3	2	5	0	0	5	0	0
16	34054712	.	T	G	5	0	5	0	4	9	0	0
16	34055599	.	T	A	3	2	5	0	0	5	0	0
16	34055747	.	A	T	1	2	3	0	0	3	0	0
16	34055754	.	C	T	2	2	4	0	0	4	0	0
16	34055788	.	T	C	1	3	4	0	0	4	0	0
16	34055965	.	A	T	1	1	2	0	3	5	0	0
16	34055966	.	T	G	2	3	5	0	0	5	0	0
16	34056408	.	A	G	3	4	7	0	0	7	0	0
16	34160860	.	T	G	4	3	7	0	0	7	0	0
16	34173000	.	T	C	3	8	11	0	0	11	0	0
16	34173331	.	G	A	6	3	9	0	1	10	0	0
16	34173954	.	G	T	5	2	7	0	1	8	0	0
16	34174206	.	T	C	2	2	4	0	0	4	0	0
16	34185906	.	A	T	5	4	9	0	1	10	0	0
16	34200704	.	C	T	24	16	40	0	3	43	0	0
16	34201023	.	A	G	23	16	39	0	0	39	0	0
16	34208582	.	T	C	12	0	12	0	16	28	0	0
16	34208696	.	A	G	20	12	32	0	1	33	0	0
16	34212477	.	A	G	6	7	13	0	0	13	0	0
16	34212516	.	A	G	7	9	16	0	0	17	1	0
16	34212565	.	G	A	8	13	21	0	4	25	0	0
16	34212567	.	G	C	8	14	22	0	1	23	0	0
16	34212630	.	T	C	16	4	20	0	22	42	0	0
16	34212676	.	G	C	12	3	15	0	13	28	0	0
16	34222439	.	T	G	14	9	23	0	4	27	0	0
16	34225173	.	T	C	11	9	20	0	3	23	0	0
16	34225392	.	A	G	10	12	22	0	1	23	0	0
16	34225472	.	G	A	12	7	19	0	1	20	0	0
16	34267991	.	G	C	1	5	6	0	1	7	0	0
16	34321568	.	A	T	7	10	17	0	2	19	0	0
16	34322036	.	G	T	5	6	11	0	0	11	0	0
16	34322253	.	C	A	11	2	13	0	1	14	0	0
16	34322346	.	G	A	10	15	25	0	3	28	0	0
16	34322372	.	C	T	2	14	16	0	9	26	1	0
16	34331489	.	A	G	3	7	10	0	1	11	0	0
16	34337976	.	A	T	10	6	16	0	1	17	0	0
16	34338475	.	A	G	11	11	22	0	0	22	0	0
16	34339432	.	A	T	11	6	17	0	0	17	0	0
16	34339693	.	C	T	2	6	8	0	0	8	0	0
16	34339857	.	T	G	1	4	5	0	0	5	0	0
16	34340397	.	A	C	2	5	7	0	0	7	0	0
16	34340520	.	G	T	1	2	3	0	1	4	0	0
16	34340538	.	C	T	1	2	3	0	0	3	0	0
16	34342541	.	C	T	1	2	3	0	0	3	0	0
16	34342542	.	A	G	1	2	3	0	0	3	0	0
16	34497550	.	T	C	4	2	6	0	1	7	0	0
16	34499892	.	A	C	3	4	7	0	1	8	0	0
16	34499940	.	A	G	5	7	12	0	0	12	0	0
16	34500507	.	T	C	7	21	28	0	1	29	0	0
16	34500542	.	G	C	13	8	21	0	1	22	0	0
16	34500582	.	G	A	8	5	13	2	0	15	0	0
16	34500589	.	G	C	1	8	9	2	3	14	0	0
16	34500683	.	A	G	3	2	5	1	1	7	0	0
16	34500899	.	G	A	17	12	29	0	0	29	0	0
16	34501279	.	A	T	4	0	4	0	9	13	0	0
16	34501292	.	A	G	6	6	12	0	8	20	0	0
16	34501348	.	C	T	10	13	23	2	0	25	0	0
16	34501380	.	C	T	10	9	19	2	2	23	0	0
16	34501496	.	G	A	1	7	8	0	13	21	0	0
16	34525621	.	C	A	46	30	76	0	6	82	0	0
16	34526092	.	C	G	32	37	69	0	4	73	0	0
16	34526093	.	A	C	26	36	62	0	11	73	0	0
16	34526795	.	A	T	29	39	68	0	4	73	1	0
16	34526926	.	A	T	21	27	48	1	22	71	0	0
16	34532040	.	C	T	5	5	10	0	0	10	0	0
16	34532205	.	G	A	1	8	9	0	7	16	0	0
16	34532635	.	T	C	1	7	8	0	1	9	0	0
16	34532782	.	C	G	4	3	7	0	0	7	0	0
16	34532843	.	T	C	7	3	10	0	0	10	0	0
16	34930635	.	A	G	8	6	14	0	1	15	0	0
16	34930719	.	C	T	0	6	6	0	7	13	0	0
16	34948262	.	C	T	7	4	11	0	0	11	0	0
16	34953166	.	C	T	3	3	6	0	2	8	0	0
16	34975908	.	A	G	5	6	11	0	0	11	0	0
16	35043863	.	C	T	2	3	5	0	0	5	0	0
16	35372069	.	C	T	5	2	7	0	0	7	0	0
16	35376598	.	G	T	3	4	7	0	1	8	0	0
16	35376825	.	C	T	7	12	19	0	0	19	0	0
16	35409483	.	C	T	2	16	18	0	27	45	0	0
16	35409783	.	G	A	17	14	31	0	2	33	0	0
16	35414455	.	A	G	15	9	24	0	4	28	0	0
16	35414470	.	T	C	17	13	30	0	1	31	0	0
16	35414991	.	C	T	10	12	22	0	0	22	0	0
16	35416113	.	A	G	19	17	36	0	3	39	0	0
16	35416158	.	C	T	15	19	34	0	0	34	0	0
16	35416786	.	A	G	18	16	34	0	1	35	0	0
16	35418744	.	T	C	9	0	9	0	19	28	0	0
16	35420600	.	T	C	12	0	12	0	19	31	0	0
16	35423585	.	C	T	3	7	10	0	10	20	0	0
16	35426998	.	T	C	7	0	7	0	8	15	0	0
16	35536574	.	C	A	10	9	19	0	0	19	0	0
16	35536576	.	G	A	1	9	10	0	8	18	0	0
16	35536848	.	G	A	6	8	14	0	1	15	0	0
16	35536900	.	A	G	13	6	19	1	1	21	0	0
16	35536960	.	T	C	13	14	27	0	2	29	0	0
16	35536990	.	C	T	17	12	29	0	0	29	0	0
16	35537153	.	G	A	15	8	23	0	0	23	0	0
16	35537270	.	C	A	16	8	24	0	0	24	0	0
16	35556303	.	C	T	2	7	9	0	0	9	0	0
16	35556365	.	A	G	1	2	3	0	1	4	0	0
16	35562804	.	A	G	6	4	10	0	1	11	0	0
16	35661979	.	A	G	2	5	7	0	0	7	0	0
16	35718538	.	A	G	3	4	7	0	1	8	0	0
16	35750714	.	T	A	12	9	21	0	1	22	0	0
16	35752670	.	C	T	17	13	30	0	0	30	0	0
16	35752785	.	T	C	11	18	29	0	1	30	0	0
16	35762009	.	C	A	5	11	16	1	2	19	0	0
16	35762010	.	A	C	4	13	17	1	1	19	0	0
16	35764580	.	C	T	9	11	20	0	1	21	0	0
16	35773005	.	A	G	12	12	24	1	2	27	0	0
16	36041247	.	G	A	6	6	12	0	0	12	0	0
16	36075471	.	G	A	4	12	16	0	2	18	0	0
16	36075478	.	T	A	5	13	18	0	0	18	0	0
16	36075677	.	C	A	7	8	15	0	2	17	0	0
16	36075999	.	A	G	14	8	22	0	0	22	0	0
16	36076082	.	G	A	6	16	22	0	0	22	0	0
16	36080364	.	C	T	12	9	21	0	1	22	0	0
16	36080376	.	A	C	12	10	22	0	3	25	0	0
16	36118070	.	T	C	4	0	4	0	7	11	0	0
16	36118166	.	T	C	5	0	5	0	4	9	0	0
16	36150674	.	A	G	8	8	16	0	0	16	0	0
16	36150707	.	C	T	6	7	13	0	1	14	0	0
16	36150949	.	C	T	10	14	24	0	2	27	1	0
16	36150964	.	C	T	13	17	30	0	0	30	0	0
16	36151000	.	C	A	16	16	32	0	1	33	0	0
16	36159928	.	T	C	13	16	29	0	2	31	0	0
16	36162013	.	C	T	14	19	33	0	2	35	0	0
16	36162201	.	A	G	6	12	18	0	1	19	0	0
16	36162584	.	G	C	0	10	10	0	8	18	0	0
16	36162650	.	T	C	20	9	29	0	4	33	0	0
16	36162727	.	A	G	18	12	30	0	2	32	0	0
16	36162754	.	A	G	17	13	30	0	0	30	0	0
16	36162938	.	G	T	10	4	14	0	0	14	0	0
16	36163005	.	G	A	10	8	18	0	1	19	0	0
16	36163006	.	A	C	10	9	19	0	0	19	0	0
16	36168251	.	C	T	5	6	11	0	1	12	0	0
16	36168317	.	G	C	7	10	17	0	0	17	0	0
16	36168416	.	T	C	7	6	13	0	0	13	0	0
16	36168450	.	A	T	5	2	7	0	0	7	0	0
16	36168510	.	A	T	6	3	9	0	0	9	0	0
16	36168575	.	T	G	5	3	8	0	3	11	0	0
16	36168787	.	T	A	2	9	11	0	0	11	0	0
16	36168994	.	C	T	2	4	6	0	1	7	0	0
16	36169007	.	T	C	2	4	6	0	1	7	0	0
16	36169057	.	T	G	2	3	5	1	1	7	0	0
16	36169150	.	T	C	6	5	11	0	0	11	0	0
16	36169568	.	G	T	5	4	9	0	0	9	0	0
16	36169868	.	A	C	4	0	4	0	4	8	0	0
16	36171552	.	A	G	3	2	5	0	0	5	0	0
16	36172961	.	A	G	3	4	7	0	0	7	0	0
16	36172982	.	C	T	4	3	7	0	0	7	0	0
16	36173406	.	A	T	3	4	7	0	2	9	0	0
16	36180591	.	A	G	2	2	4	0	0	4	0	0
16	36180753	.	A	G	3	4	7	0	0	7	0	0
16	36180810	.	T	A	1	3	4	0	0	4	0	0
16	36721560	.	A	T	4	12	16	0	1	17	0	0
16	36724010	.	C	G	1	10	11	1	12	24	0	0
16	36729322	.	A	T	2	4	6	0	1	7	0	0
16	36729352	.	G	T	5	4	9	0	0	10	1	0
16	36729373	.	A	G	7	6	13	0	0	13	0	0
16	36731307	.	A	G	10	8	18	0	0	18	0	0
16	36743328	.	G	A	2	2	4	0	0	4	0	0
16	36743351	.	G	A	1	4	5	0	0	5	0	0
16	36743757	.	T	C	2	3	5	0	0	5	0	0
16	36743787	.	A	G	2	3	5	0	0	5	0	0
16	36749242	.	T	G	2	1	3	0	1	4	0	0
16	36752278	.	T	C	1	3	4	0	0	4	0	0
16	36759908	.	A	T	6	5	11	0	0	11	0	0
16	36759937	.	A	G	6	4	10	0	0	10	0	0
16	36759999	.	C	A	1	2	3	0	0	3	0	0
16	36760007	.	G	A	1	2	3	0	0	3	0	0
16	36766180	.	T	G	25	8	33	0	0	33	0	0
16	36766467	.	G	T	13	9	22	0	2	25	1	0
16	36908844	.	C	A	4	2	6	0	0	6	0	0
16	36914935	.	T	C	5	2	7	0	0	7	0	0
16	36918992	.	G	A	3	2	5	0	2	7	0	0
16	36923298	.	C	T	3	3	6	0	0	6	0	0
16	36925462	.	G	A	1	2	3	0	5	8	0	0
16	36926775	.	C	A	10	5	15	0	3	18	0	0
16	36926779	.	A	C	12	6	18	0	0	18	0	0
16	36928169	.	A	T	10	5	15	0	0	15	0	0
16	36928179	.	A	C	8	4	12	0	1	13	0	0
16	36928429	.	A	G	17	14	31	0	0	31	0	0
16	36931728	.	T	C	20	8	28	0	0	28	0	0
16	36931822	.	T	C	7	5	12	1	1	14	0	0
16	36934191	.	T	A	6	3	9	0	0	9	0	0
16	36934340	.	C	A	1	3	4	0	7	11	0	0
16	36934398	.	G	C	7	5	12	1	3	16	0	0
16	36939973	.	T	C	3	1	4	1	3	8	0	0
16	36939982	.	A	G	3	4	7	1	0	8	0	0
16	36940045	.	C	T	5	7	12	0	1	13	0	0
16	36941706	.	T	C	6	9	15	0	0	15	0	0
16	36941961	.	T	C	2	0	2	0	2	4	0	0
16	36942068	.	C	A	3	3	6	0	0	6	0	0
16	36945182	.	T	G	1	3	4	0	0	4	0	0
16	36945288	.	G	A	1	3	4	0	0	4	0	0
16	36974719	.	T	C	7	3	10	0	0	10	0	0
16	36975141	.	G	A	9	16	25	0	1	26	0	0
16	36975146	.	C	T	1	16	17	0	10	27	0	0
16	36975183	.	G	C	15	15	30	0	1	31	0	0
16	36975318	.	T	A	12	7	19	0	2	21	0	0
16	36976721	.	A	G	11	7	18	0	0	18	0	0
16	36977268	.	G	A	4	2	6	0	0	6	0	0
16	36979518	.	G	A	14	7	21	0	0	21	0	0
16	36979521	.	A	G	10	7	17	0	3	20	0	0
16	37167442	.	G	C	4	19	23	0	1	24	0	0
16	37167545	.	T	A	2	8	10	0	2	12	0	0
16	37167589	.	T	G	3	12	15	0	0	15	0	0
16	37167968	.	G	A	1	6	7	0	0	7	0	0
16	37306905	.	G	A	7	6	13	0	2	15	0	0
16	37323594	.	A	C	6	5	11	0	2	13	0	0
16	37552348	.	A	C	1	1	2	0	1	3	0	0
16	37552966	.	G	A	1	5	6	0	0	6	0	0
16	37563601	.	G	A	1	5	6	0	0	6	0	0
16	37563643	.	T	G	1	0	1	0	7	8	0	0
16	37565676	.	C	G	4	3	7	0	0	7	0	0
16	37593444	.	G	A	7	8	15	0	0	15	0	0
16	37614071	.	A	G	12	7	19	0	1	20	0	0
16	37617219	.	A	G	10	0	10	1	12	23	0	0
16	37617304	.	A	G	10	0	10	0	17	27	0	0
16	37617738	.	T	C	16	17	33	0	0	33	0	0
16	37627218	.	T	G	17	9	26	1	5	32	0	0
16	37627762	.	G	A	4	18	22	0	18	40	0	0
16	37627997	.	T	G	19	21	40	0	3	43	0	0
16	37947769	.	T	C	5	5	10	0	0	10	0	0
16	37948242	.	C	G	4	2	6	0	0	6	0	0
16	37948256	.	G	T	3	4	7	0	0	7	0	0
16	37948355	.	C	T	9	5	14	0	0	14	0	0
16	37948389	.	G	T	9	8	17	0	0	17	0	0
16	37948624	.	G	A	8	3	11	0	0	11	0	0
16	37948625	.	G	A	8	3	11	0	0	11	0	0
16	37963955	.	T	A	3	5	8	0	1	9	0	0
16	37964100	.	C	T	1	6	7	0	0	7	0	0
16	38019553	.	C	G	1	2	3	0	0	3	0	0
16	38125293	.	G	C	2	3	5	0	0	5	0	0
16	38125299	.	G	C	2	3	5	0	0	5	0	0
16	38125650	.	T	C	2	2	4	0	1	5	0	0
16	38127708	.	T	A	1	3	4	0	0	4	0	0
16	38135699	.	T	C	9	9	18	0	0	18	0	0
16	38135763	.	A	G	10	4	14	1	1	16	0	0
16	38136117	.	C	T	7	7	14	0	0	14	0	0
16	38136278	.	C	T	9	15	24	0	0	24	0	0
16	38136317	.	G	A	13	8	21	0	2	23	0	0
16	38136346	.	C	T	15	6	21	0	0	21	0	0
16	38136491	.	G	C	4	5	9	0	0	9	0	0
16	38154203	.	G	A	4	2	6	0	0	6	0	0
16	38154236	.	A	G	1	1	2	0	1	3	0	0
16	38157102	.	T	A	1	3	4	0	1	5	0	0
16	38167493	.	G	C	3	2	5	0	0	5	0	0
16	38167511	.	C	T	1	3	4	0	0	4	0	0
16	38168009	.	A	G	5	3	8	0	0	8	0	0
16	38168095	.	G	A	0	3	3	0	3	6	0	0
16	38188955	.	G	A	1	3	4	0	5	9	0	0
16	38189099	.	T	C	2	3	5	0	0	5	0	0
16	38191645	.	C	T	6	2	8	0	0	8	0	0
16	38194017	.	T	C	6	3	9	0	0	9	0	0
16	38199647	.	G	A	9	6	15	0	0	15	0	0
16	38351061	.	T	A	2	3	5	0	1	6	0	0
16	38355299	.	G	A	7	7	14	0	2	16	0	0
16	38454611	.	A	T	3	0	3	1	0	4	0	0
16	38499053	.	C	T	0	5	5	0	1	6	0	0
16	38518207	.	G	A	1	1	2	0	1	3	0	0
16	38556912	.	G	A	11	12	23	0	1	24	0	0
16	38556922	.	C	G	3	13	16	0	11	27	0	0
16	38557876	.	G	C	27	1	28	0	24	52	0	0
16	38568644	.	G	C	20	22	42	0	2	44	0	0
16	38729548	.	G	A	6	9	15	0	1	16	0	0
16	38729551	.	G	T	2	6	8	0	8	16	0	0
16	38943253	.	C	T	12	7	19	0	1	20	0	0
16	38943547	.	A	G	7	0	7	0	6	13	0	0
16	39146871	.	A	C	11	4	15	0	0	15	0	0
16	39147355	.	G	C	16	6	22	0	1	23	0	0
16	39147386	.	C	A	18	6	24	0	3	27	0	0
16	39154953	.	G	A	12	6	18	0	1	19	0	0
16	39157751	.	C	A	13	10	23	0	2	25	0	0
16	39157885	.	T	A	15	17	32	0	1	33	0	0
16	39160458	.	A	C	16	16	32	0	3	35	0	0
16	39162786	.	C	T	22	21	43	0	1	44	0	0
16	39164213	.	G	A	16	18	34	1	0	35	0	0
16	39166773	.	C	T	17	26	43	0	1	44	0	0
16	39166854	.	C	T	24	21	45	0	1	46	0	0
16	39167028	.	C	A	26	16	42	0	3	45	0	0
16	39167088	.	C	T	16	10	26	0	0	26	0	0
16	39185580	.	G	A	19	8	27	0	1	28	0	0
16	39191557	.	T	C	14	0	14	0	14	28	0	0
16	39233028	.	C	T	3	2	5	0	0	5	0	0
16	39238539	.	A	T	5	5	10	0	1	11	0	0
16	39238547	.	A	T	5	5	10	0	0	10	0	0
16	39244286	.	T	C	20	16	36	0	2	38	0	0
16	39248745	.	T	A	12	7	19	0	0	19	0	0
16	39248765	.	G	C	13	6	19	0	1	20	0	0
16	39248811	.	C	G	7	5	12	0	1	13	0	0
16	39248813	.	T	A	6	5	11	0	0	11	0	0
16	39248864	.	G	A	4	4	8	0	0	8	0	0
16	39248886	.	C	A	4	5	9	0	0	9	0	0
16	39248976	.	G	A	9	7	16	0	0	16	0	0
16	39249056	.	G	A	13	8	21	0	2	23	0	0
16	39249229	.	C	T	4	5	9	0	0	9	0	0
16	39249350	.	A	C	3	3	6	0	1	7	0	0
16	39249506	.	G	A	5	2	7	0	0	7	0	0
16	39250197	.	C	T	1	2	3	0	0	3	0	0
16	39253200	.	G	A	4	2	6	0	0	6	0	0
16	39271329	.	A	C	3	4	7	0	0	7	0	0
16	39323626	.	T	G	2	0	2	0	5	7	0	0
16	39323716	.	C	T	4	5	9	0	1	10	0	0
16	39323809	.	T	C	2	7	9	0	0	9	0	0
16	39325084	.	A	G	3	0	3	0	4	7	0	0
16	39325121	.	G	A	4	2	6	0	0	6	0	0
16	39361889	.	C	T	4	2	6	0	1	7	0	0
16	39362312	.	G	T	0	5	5	0	11	16	0	0
16	39372345	.	G	A	11	4	15	0	0	15	0	0
16	39372372	.	T	C	8	4	12	0	2	14	0	0
16	39372735	.	G	C	2	9	11	0	15	26	0	0
16	39372780	.	C	A	14	13	27	0	1	28	0	0
16	39378744	.	A	G	16	0	16	0	9	25	0	0
16	39382047	.	C	G	8	9	17	0	0	17	0	0
16	39382084	.	C	T	9	6	15	0	0	15	0	0
16	39382098	.	G	A	6	7	13	0	0	13	0	0
16	39382208	.	T	C	5	5	10	0	2	12	0	0
16	39382467	.	C	G	5	5	10	0	0	10	0	0
16	39382482	.	G	A	4	5	9	0	0	9	0	0
16	39385568	.	T	G	11	0	11	2	3	16	0	0
16	39385755	.	T	C	18	0	18	0	11	29	0	0
16	39386184	.	T	C	19	11	30	0	2	32	0	0
16	39386239	.	T	A	16	18	34	0	2	36	0	0
16	39386915	.	C	T	16	15	31	0	0	31	0	0
16	39390139	.	T	C	13	1	14	0	24	38	0	0
16	39390175	.	G	A	13	23	36	0	2	38	0	0
16	39393370	.	A	G	17	13	30	0	0	30	0	0
16	39399140	.	A	C	5	0	5	0	4	9	0	0
16	39413514	.	C	T	5	5	10	0	0	10	0	0
16	39505554	.	G	C	4	4	8	0	0	8	0	0
16	39526591	.	A	G	1	2	3	0	1	4	0	0
16	39643512	.	G	A	3	3	6	0	0	6	0	0
16	40031649	.	A	G	5	4	9	0	1	10	0	0
16	40131552	.	T	A	1	2	3	0	0	3	0	0
16	40131556	.	T	G	1	2	3	0	0	3	0	0
16	40153313	.	G	C	5	2	7	0	0	7	0	0
16	40340844	.	C	A	4	4	8	0	0	8	0	0
16	40340847	.	A	G	3	0	3	0	5	8	0	0
16	40340953	.	C	G	4	0	4	0	3	7	0	0
16	40340967	.	A	G	3	2	5	0	0	5	0	0
16	40341255	.	C	G	5	3	8	0	0	8	0	0
16	40341264	.	C	T	3	3	6	0	1	7	0	0
16	40346609	.	A	G	2	4	6	0	0	6	0	0
16	40346654	.	C	T	3	2	5	0	0	5	0	0
16	40347546	.	T	A	1	3	4	0	0	4	0	0
16	40425996	.	C	G	2	3	5	0	0	5	0	0
16	40491931	.	A	G	8	4	12	0	3	15	0	0
16	40495482	.	C	T	0	5	5	0	3	8	0	0
16	40503994	.	G	A	8	7	15	0	1	16	0	0
16	40560713	.	C	T	3	9	12	0	0	12	0	0
16	40563673	.	G	T	2	2	4	0	0	4	0	0
16	40568162	.	A	G	3	0	3	0	2	5	0	0
16	40568274	.	G	A	0	3	3	0	1	4	0	0
16	40568336	.	A	G	2	1	3	0	7	10	0	0
16	40569480	.	C	G	4	6	10	0	0	10	0	0
16	40580607	.	C	T	1	4	5	0	0	5	0	0
16	40606844	.	T	A	3	4	7	0	1	8	0	0
16	40606883	.	G	A	2	3	5	0	1	6	0	0
16	40607436	.	C	T	2	3	5	0	0	5	0	0
16	40622799	.	G	A	1	1	2	0	1	3	0	0
16	40633384	.	C	T	1	2	3	0	0	3	0	0
16	40954538	.	C	T	3	7	10	0	1	11	0	0
16	40954866	.	T	C	7	8	15	0	0	15	0	0
16	40954983	.	A	C	18	10	28	0	1	29	0	0
16	40955515	.	G	T	16	3	19	0	0	19	0	0
16	40955525	.	C	T	13	4	17	0	1	18	0	0
16	40955722	.	G	C	3	2	5	0	0	5	0	0
16	40992113	.	G	C	3	2	5	0	0	5	0	0
16	41026725	.	G	C	16	4	20	3	2	25	0	0
16	41026735	.	G	A	23	4	27	2	1	30	0	0
16	41029443	.	G	A	4	4	8	0	0	8	0	0
16	41029588	.	G	A	0	7	7	0	4	11	0	0
16	41029626	.	G	T	3	3	6	0	1	7	0	0
16	41029795	.	C	T	1	2	3	0	0	3	0	0
16	41029836	.	A	G	2	3	5	0	2	7	0	0
16	41030017	.	A	C	8	7	15	0	1	16	0	0
16	41030137	.	A	G	7	4	11	0	1	12	0	0
16	41030560	.	T	C	6	2	8	0	0	8	0	0
16	41052169	.	C	T	2	2	4	1	0	5	0	0
16	41112493	.	C	T	5	5	10	0	2	12	0	0
16	41112571	.	T	C	5	5	10	0	2	12	0	0
16	41112861	.	G	C	8	0	8	0	5	13	0	0
16	41113676	.	T	G	5	7	12	0	1	13	0	0
16	41113698	.	A	T	2	7	9	0	0	9	0	0
16	41113752	.	G	A	10	5	15	0	0	15	0	0
16	41113755	.	C	T	6	10	16	0	0	16	0	0
16	41114779	.	G	A	4	3	7	0	0	7	0	0
16	41114800	.	A	T	4	5	9	0	1	10	0	0
16	41114890	.	C	T	5	3	8	0	0	8	0	0
16	41114976	.	G	T	3	2	5	0	0	5	0	0
16	41115079	.	T	G	2	3	5	0	0	5	0	0
16	41115997	.	A	T	3	2	5	0	0	5	0	0
16	41115998	.	C	T	0	1	1	0	4	5	0	0
16	41116873	.	C	A	1	2	3	0	1	4	0	0
16	41345674	.	A	T	10	9	19	0	0	19	0	0
16	41345725	.	A	G	4	4	8	0	2	10	0	0
16	41345826	.	G	T	4	10	14	0	1	15	0	0
16	41346007	.	C	A	1	9	10	0	15	25	0	0
16	41353140	.	G	A	11	8	19	0	1	20	0	0
16	41393773	.	C	T	4	6	10	0	2	12	0	0
16	41467838	.	G	A	0	2	2	0	1	3	0	0
16	41468848	.	T	G	9	7	16	0	2	18	0	0
16	41469008	.	G	A	6	4	10	0	0	10	0	0
16	41469029	.	C	A	5	2	7	0	2	9	0	0
16	41469130	.	T	A	6	2	8	0	0	8	0	0
16	41469305	.	A	G	4	2	6	0	0	6	0	0
16	41469329	.	G	A	6	4	10	0	0	10	0	0
16	41469390	.	A	C	7	9	16	0	2	18	0	0
16	41469426	.	T	A	8	10	18	0	2	20	0	0
16	41470188	.	T	G	1	3	4	0	0	4	0	0
16	41471881	.	C	T	1	2	3	0	3	6	0	0
16	41473020	.	C	T	2	2	4	0	2	6	0	0
16	41507316	.	C	A	0	2	2	0	1	3	0	0
16	41507385	.	G	T	1	2	3	0	1	4	0	0
16	41507386	.	G	T	2	2	4	0	0	4	0	0
16	41532696	.	C	T	1	2	3	0	0	3	0	0
16	41532699	.	C	T	1	2	3	0	0	3	0	0
16	41535587	.	G	A	4	1	5	0	2	7	0	0
16	41535590	.	G	C	5	0	5	0	2	7	0	0
16	41585743	.	C	T	0	2	2	0	1	3	0	0
16	41589214	.	A	G	4	5	9	0	0	9	0	0
16	41599917	.	C	T	2	2	4	0	0	4	0	0
16	41701149	.	G	A	1	2	3	0	0	3	0	0
16	41717479	.	G	A	3	2	5	0	1	6	0	0
16	41717482	.	A	G	3	3	6	0	0	6	0	0
16	41717666	.	G	A	2	5	7	0	6	13	0	0
16	41720533	.	G	T	7	5	12	0	0	12	0	0
16	41720536	.	T	G	6	6	12	0	0	12	0	0
16	41720587	.	T	C	7	5	12	0	1	13	0	0
16	41723228	.	T	G	8	0	8	0	11	19	0	0
16	41723280	.	A	G	8	1	9	0	10	19	0	0
16	41723778	.	C	G	3	1	4	0	7	11	0	0
16	41725215	.	T	C	7	7	14	0	0	14	0	0
16	41725238	.	T	C	9	6	15	0	0	15	0	0
16	41727162	.	T	G	10	9	19	1	0	20	0	0
16	41727376	.	C	A	15	9	24	0	0	24	0	0
16	41730407	.	G	A	14	10	24	0	0	24	0	0
16	41730625	.	C	G	15	12	27	0	1	28	0	0
16	41731928	.	A	T	3	4	7	0	0	7	0	0
16	41731929	.	C	A	3	4	7	0	0	7	0	0
16	41732009	.	G	T	5	6	11	0	1	12	0	0
16	41732031	.	G	T	0	5	5	0	7	12	0	0
16	41732067	.	T	C	6	3	9	0	4	13	0	0
16	41732158	.	C	A	3	6	9	0	1	10	0	0
16	41732166	.	C	T	1	7	8	0	0	8	0	0
16	41732262	.	T	C	3	8	11	0	1	12	0	0
16	41732295	.	G	T	5	7	12	0	0	12	0	0
16	41732343	.	C	T	5	2	7	0	0	7	0	0
16	41732366	.	A	G	4	2	6	0	0	6	0	0
16	41740704	.	A	T	5	8	13	0	0	13	0	0
16	41740815	.	T	A	1	4	5	0	0	5	0	0
16	41741050	.	C	T	0	4	4	0	6	10	0	0
16	41741199	.	A	T	4	3	7	0	0	7	0	0
16	41741457	.	G	A	1	2	3	0	0	3	0	0
16	41794900	.	C	A	4	18	22	0	19	41	0	0
16	41801525	.	G	T	10	14	24	0	2	26	0	0
16	41873717	.	T	A	7	9	16	0	1	17	0	0
16	41873797	.	G	A	7	4	11	0	0	11	0	0
16	41873992	.	C	T	6	6	12	0	1	13	0	0
16	41874039	.	G	C	9	5	14	0	1	15	0	0
16	41891572	.	C	T	19	11	30	0	2	32	0	0
16	41891662	.	A	C	12	15	27	0	0	27	0	0
16	41896361	.	G	A	19	8	27	0	2	29	0	0
16	41897244	.	A	G	10	12	22	0	0	22	0	0
16	41897332	.	A	G	15	20	35	0	0	35	0	0
16	41897347	.	G	A	14	20	34	0	2	36	0	0
16	41897375	.	A	T	15	26	41	0	0	41	0	0
16	41897452	.	C	A	14	10	24	0	1	25	0	0
16	41897593	.	A	C	6	9	15	0	3	18	0	0
16	41897599	.	A	T	9	9	18	0	1	19	0	0
16	41903475	.	A	T	9	10	19	0	0	19	0	0
16	41903686	.	G	A	16	13	29	0	1	30	0	0
16	41903770	.	T	C	12	12	24	0	1	25	0	0
16	41903801	.	T	G	13	11	24	0	2	26	0	0
16	41903957	.	T	C	14	13	27	0	1	28	0	0
16	41904121	.	T	G	7	10	17	0	1	18	0	0
16	41904209	.	T	C	7	10	17	0	2	19	0	0
16	41904261	.	G	A	14	6	20	0	1	21	0	0
16	41904430	.	C	A	8	15	23	0	0	23	0	0
16	41904440	.	C	A	1	13	14	0	10	24	0	0
16	41904615	.	T	C	16	0	16	1	12	29	0	0
16	41904650	.	G	A	14	3	17	1	4	22	0	0
16	41904879	.	A	T	6	6	12	0	1	13	0	0
16	41904961	.	A	G	3	7	10	0	2	12	0	0
16	41905631	.	A	G	10	9	19	0	1	20	0	0
16	41905666	.	A	G	10	6	16	0	2	18	0	0
16	41905682	.	G	T	11	9	20	0	0	20	0	0
16	41905720	.	T	A	4	7	11	0	1	12	0	0
16	41905807	.	G	C	9	7	16	0	1	17	0	0
16	41912225	.	G	A	14	7	21	0	2	23	0	0
16	41925227	.	G	C	6	0	6	0	10	16	0	0
16	41933222	.	A	C	3	7	10	0	0	10	0	0
16	41933411	.	G	A	2	3	5	0	1	6	0	0
16	42046274	.	A	C	4	4	8	0	0	8	0	0
16	42046734	.	C	A	1	3	4	0	0	4	0	0
16	42072207	.	T	A	15	8	23	0	3	26	0	0
16	42072719	.	A	C	28	9	37	0	1	38	0	0
16	42073086	.	A	G	4	4	8	0	0	8	0	0
16	42073488	.	T	C	16	1	17	0	14	31	0	0
16	42083039	.	G	A	5	3	8	0	1	9	0	0
16	42091814	.	A	G	13	13	26	0	1	27	0	0
16	42161312	.	G	A	1	2	3	0	0	3	0	0
16	42161402	.	C	G	0	2	2	0	1	3	0	0
16	42177840	.	C	T	11	8	19	0	0	19	0	0
16	42178002	.	C	T	2	3	5	1	16	22	0	0
16	42178012	.	A	G	20	6	26	1	1	28	0	0
16	42179879	.	C	A	14	7	21	0	4	25	0	0
16	42180271	.	G	A	10	10	20	0	2	22	0	0
16	42186022	.	G	A	1	3	4	0	1	5	0	0
16	42186043	.	A	T	2	3	5	0	0	5	0	0
16	42193489	.	G	A	1	3	4	0	0	4	0	0
16	42207600	.	A	G	1	2	3	0	0	3	0	0
16	42322458	.	T	G	52	33	85	0	2	87	0	0
16	42322623	.	T	G	13	16	29	2	43	74	0	0
16	42322636	.	A	C	19	2	21	2	70	93	0	0
16	42373933	.	A	C	29	20	49	0	3	52	0	0
16	42374020	.	C	T	1	37	38	0	11	49	0	0
16	42374080	.	G	T	15	29	44	0	3	47	0	0
16	42374254	.	C	T	18	25	43	0	1	44	0	0
16	42374290	.	G	A	17	31	48	0	2	50	0	0
16	42374425	.	A	G	22	14	36	0	2	38	0	0
16	42374434	.	A	C	21	15	36	0	1	37	0	0
16	42390176	.	T	C	10	0	10	0	10	20	0	0
16	42424189	.	G	A	12	12	24	0	3	27	0	0
16	42424240	.	G	A	14	5	19	0	1	20	0	0
16	42424348	.	T	C	11	11	22	0	0	22	0	0
16	42424352	.	G	A	12	9	21	0	1	22	0	0
16	42424504	.	C	A	4	9	13	0	0	13	0	0
16	42424505	.	A	C	3	9	12	0	0	12	0	0
16	42424653	.	G	C	2	5	7	0	1	8	0	0
16	42424762	.	G	A	15	8	23	0	2	25	0	0
16	42441986	.	T	C	4	5	9	0	0	9	0	0
16	42443965	.	G	A	4	2	6	0	0	6	0	0
16	42452554	.	T	C	2	6	8	0	0	8	0	0
16	42452557	.	G	A	2	6	8	0	0	8	0	0
16	42452591	.	C	G	3	5	8	0	0	8	0	0
16	42452592	.	T	A	3	5	8	0	0	8	0	0
16	42453542	.	C	T	2	2	4	0	3	7	0	0
16	42472146	.	G	T	2	3	5	0	0	5	0	0
16	42472499	.	T	A	2	2	4	0	0	4	0	0
16	42472715	.	C	T	4	2	6	0	0	6	0	0
16	42472847	.	A	T	2	2	4	0	0	4	0	0
16	42487947	.	A	G	9	9	18	0	9	27	0	0
16	42490255	.	C	T	12	10	22	0	0	22	0	0
16	42490264	.	T	C	12	8	20	0	1	21	0	0
16	42493796	.	G	C	1	13	14	0	18	32	0	0
16	42493900	.	A	T	8	9	17	3	1	21	0	0
16	42494084	.	G	A	2	9	11	0	5	16	0	0
16	42494143	.	A	T	5	8	13	0	0	13	0	0
16	42494201	.	C	A	2	3	5	0	0	5	0	0
16	42700451	.	C	T	1	3	4	0	0	4	0	0
16	42710536	.	G	A	1	3	4	0	0	4	0	0
16	42833084	.	T	C	13	7	20	0	1	21	0	0
16	42842991	.	G	C	16	11	27	0	0	27	0	0
16	42842995	.	A	G	14	11	25	0	1	26	0	0
16	42843128	.	G	A	6	10	16	0	0	16	0	0
16	42900256	.	T	C	6	3	9	0	0	9	0	0
16	42900326	.	T	G	4	0	4	0	1	7	2	0
16	42900334	.	G	A	0	4	4	0	2	6	0	0
16	42900598	.	G	A	2	7	9	0	4	13	0	0
16	42938992	.	G	T	6	5	11	0	1	12	0	0
16	42939061	.	A	T	1	5	6	0	0	6	0	0
16	42939097	.	A	G	1	4	5	0	0	5	0	0
16	42939124	.	T	A	2	3	5	0	0	5	0	0
16	42939351	.	T	C	8	14	22	0	1	23	0	0
16	42939443	.	A	C	10	0	10	0	12	22	0	0
16	42939479	.	A	G	19	10	29	0	1	30	0	0
16	42939480	.	C	T	3	7	10	0	21	31	0	0
16	42939561	.	G	C	13	10	23	0	2	25	0	0
16	42939695	.	A	G	12	7	19	0	1	20	0	0
16	42939993	.	A	C	4	4	8	0	2	10	0	0
16	42940157	.	G	A	3	2	5	0	0	5	0	0
16	42940259	.	A	G	5	3	8	0	0	8	0	0
16	42940336	.	A	G	2	2	4	0	1	5	0	0
16	42940836	.	A	C	3	2	5	0	0	5	0	0
16	42940916	.	G	A	4	3	7	0	0	7	0	0
16	42941124	.	C	A	6	7	13	0	0	13	0	0
16	42941189	.	C	A	2	6	8	0	1	9	0	0
16	42949149	.	G	A	7	4	11	0	0	11	0	0
16	42949151	.	C	T	0	6	6	0	4	10	0	0
16	42975687	.	C	T	0	2	2	0	1	3	0	0
16	43001246	.	G	C	6	1	7	0	8	15	0	0
16	43001354	.	C	T	1	20	21	0	12	33	0	0
16	43003080	.	A	G	12	12	24	0	1	25	0	0
16	43026164	.	G	T	2	5	7	0	0	7	0	0
16	43026201	.	G	T	3	4	7	0	0	7	0	0
16	43028153	.	T	A	5	4	9	0	0	9	0	0
16	43028156	.	G	A	5	3	8	0	0	9	1	0
16	43028295	.	T	C	12	10	22	0	1	23	0	0
16	43028303	.	C	T	11	8	19	0	1	20	0	0
16	43028353	.	G	A	6	5	11	0	0	11	0	0
16	43028369	.	A	G	9	4	13	0	0	13	0	0
16	43028453	.	C	T	14	8	22	0	0	22	0	0
16	43028542	.	A	T	15	8	23	0	2	25	0	0
16	43028546	.	C	T	15	8	23	0	1	24	0	0
16	43028626	.	A	C	8	5	13	0	2	15	0	0
16	43032146	.	A	C	2	0	2	0	4	6	0	0
16	43032175	.	C	A	3	3	6	0	0	6	0	0
16	43039305	.	T	C	0	2	2	0	1	3	0	0
16	43126424	.	A	T	4	2	6	0	0	6	0	0
16	43126425	.	C	T	4	2	6	0	0	6	0	0
16	43126502	.	G	T	3	6	9	0	2	11	0	0
16	43126546	.	A	C	8	0	8	0	5	13	0	0
16	43126566	.	G	A	4	9	13	0	0	13	0	0
16	43126603	.	A	T	8	4	12	0	0	12	0	0
16	43126886	.	A	G	8	5	13	0	0	13	0	0
16	43126887	.	C	T	0	5	5	0	8	13	0	0
16	43145476	.	T	A	2	3	5	0	0	5	0	0
16	43145747	.	A	G	1	0	1	0	4	5	0	0
16	43145812	.	T	C	3	2	5	0	1	6	0	0
16	43149664	.	C	T	1	2	3	0	1	4	0	0
16	43149687	.	C	G	1	2	3	0	1	4	0	0
16	43149733	.	C	T	1	2	3	0	0	3	0	0
16	43971245	.	T	C	5	3	8	0	0	8	0	0
16	43971248	.	G	A	4	3	7	0	0	7	0	0
16	44044497	.	C	T	3	2	5	0	0	5	0	0
16	44338921	.	T	A	27	28	55	0	0	55	0	0
16	44339284	.	C	T	2	16	18	0	22	40	0	0
16	44339466	.	A	G	21	16	37	0	2	39	0	0
16	44339475	.	A	G	20	20	40	0	2	42	0	0
16	44342679	.	C	T	22	17	39	0	3	42	0	0
16	44379120	.	A	G	17	13	30	0	0	30	0	0
16	44379168	.	T	C	17	12	29	0	0	29	0	0
16	44379219	.	T	A	15	15	30	0	0	30	0	0
16	44683133	.	C	T	3	2	5	0	0	5	0	0
16	45080719	.	G	T	0	1	1	1	1	3	0	0
16	45080720	.	A	G	1	2	3	1	0	4	0	0
16	46088959	.	C	T	1	7	8	1	0	9	0	0
16	46399586	.	T	C	4	4	8	0	0	8	0	0
16	46464219	.	G	A	8	6	14	1	0	15	0	0
16	46464279	.	G	A	14	5	19	0	2	21	0	0
16	48572693	.	G	A	1	2	3	0	3	6	0	0
16	48746783	.	A	T	2	6	8	0	1	9	0	0
16	51183892	.	A	T	9	4	13	0	2	15	0	0
16	51885808	.	G	A	35	28	63	3	6	72	0	0
16	51885855	.	A	T	37	34	71	3	4	78	0	0
16	51888929	.	C	T	32	30	62	0	2	64	0	0
16	51950697	.	T	A	33	13	46	0	3	49	0	0
16	51950726	.	C	A	23	31	54	0	4	58	0	0
16	51950754	.	C	T	24	36	60	0	3	63	0	0
16	51950814	.	A	T	34	0	34	0	0	34	0	0
16	51950877	.	G	C	23	30	53	1	2	56	0	0
16	51951690	.	T	C	7	20	27	0	1	28	0	0
16	51951691	.	T	C	12	17	29	0	1	30	0	0
16	51951861	.	G	C	18	16	34	1	0	35	0	0
16	51952002	.	T	G	11	16	27	0	2	29	0	0
16	51952023	.	A	T	11	19	30	0	4	34	0	0
16	51952063	.	A	C	5	21	26	0	0	26	0	0
16	51952817	.	C	T	12	3	15	0	0	15	0	0
16	51952826	.	C	A	4	13	17	0	0	17	0	0
16	51953009	.	G	A	26	15	41	0	2	43	0	0
16	51953048	.	T	C	25	26	51	0	3	54	0	0
16	51953057	.	T	A	25	24	49	0	1	50	0	0
16	51953189	.	G	T	22	11	33	0	4	38	1	0
16	51954683	.	C	T	0	20	20	0	6	26	0	0
16	51955675	.	G	A	16	18	34	0	0	34	0	0
16	51955696	.	G	A	14	17	31	0	0	31	0	0
16	51962068	.	A	G	7	16	23	0	1	24	0	0
16	51966774	.	C	G	15	12	27	0	0	27	0	0
16	52708884	.	A	T	6	2	8	0	1	9	0	0
16	52861086	.	C	G	0	2	2	0	1	3	0	0
16	53624284	.	C	T	1	5	6	0	0	6	0	0
16	54303524	.	T	G	1	2	3	0	0	3	0	0
16	54474942	.	G	A	6	7	13	0	1	14	0	0
16	54474943	.	C	T	6	7	13	0	1	14	0	0
16	54475037	.	G	A	16	8	24	0	2	26	0	0
16	54475064	.	G	A	7	12	19	0	0	19	0	0
16	54478053	.	A	G	11	6	17	0	0	17	0	0
16	54498049	.	G	A	3	4	7	0	2	9	0	0
16	54568755	.	C	A	5	5	10	0	0	10	0	0
16	54570431	.	C	T	3	2	5	0	0	5	0	0
16	54571483	.	T	A	2	4	6	0	0	6	0	0
16	54571484	.	G	T	2	4	6	0	0	6	0	0
16	54574177	.	T	C	1	4	5	0	0	5	0	0
16	54580891	.	G	A	5	5	10	0	0	10	0	0
16	54585729	.	G	C	1	5	6	0	2	8	0	0
16	54585799	.	C	T	4	4	8	0	0	8	0	0
16	54588989	.	G	A	12	11	23	0	0	23	0	0
16	54590186	.	G	A	2	11	13	0	3	16	0	0
16	54590219	.	A	G	11	0	11	0	8	19	0	0
16	54590594	.	C	T	8	13	21	0	2	23	0	0
16	54594047	.	A	C	9	13	22	2	9	33	0	0
16	54594103	.	T	C	27	12	39	2	5	46	0	0
16	54594270	.	A	T	5	21	26	1	2	29	0	0
16	54594334	.	G	T	24	10	34	1	0	35	0	0
16	54594413	.	C	T	15	17	32	0	3	35	0	0
16	54594421	.	A	G	11	18	29	0	5	34	0	0
16	54636061	.	C	G	0	4	4	0	7	11	0	0
16	54636225	.	C	G	1	4	5	0	6	11	0	0
16	54639451	.	G	A	3	3	6	0	0	6	0	0
16	54780612	.	G	A	14	10	24	0	0	24	0	0
16	54782373	.	T	C	17	14	31	0	1	32	0	0
16	54782542	.	G	A	1	21	22	0	20	42	0	0
16	54785285	.	G	A	2	3	5	0	1	6	0	0
16	54785573	.	C	G	26	22	48	0	5	53	0	0
16	54785894	.	A	G	13	10	23	0	1	24	0	0
16	54785979	.	T	A	6	4	10	2	0	14	2	0
16	54785983	.	G	T	9	2	11	2	0	13	0	0
16	54786022	.	G	A	8	5	13	1	1	15	0	0
16	54786967	.	C	T	22	19	41	2	0	43	0	0
16	54787564	.	T	G	3	6	9	0	2	11	0	0
16	54787578	.	G	A	7	3	10	0	1	11	0	0
16	54787725	.	C	T	2	19	21	0	22	43	0	0
16	54793964	.	C	A	21	20	41	0	5	46	0	0
16	54794100	.	G	A	17	22	39	0	0	39	0	0
16	54794760	.	G	A	1	2	3	13	0	16	0	0
16	54795141	.	A	G	12	7	19	0	0	19	0	0
16	54800128	.	A	T	11	7	18	0	1	19	0	0
16	54806967	.	C	A	0	2	2	0	2	4	0	0
16	54948620	.	T	C	4	2	6	0	0	6	0	0
16	54960951	.	A	C	7	4	11	0	0	11	0	0
16	54964128	.	G	T	3	5	8	0	0	8	0	0
16	54964224	.	C	A	0	4	4	0	4	8	0	0
16	54964281	.	G	C	4	4	8	0	0	8	0	0
16	54964287	.	G	A	4	4	8	0	0	8	0	0
16	54969116	.	G	A	4	2	6	0	0	6	0	0
16	55004723	.	C	G	28	15	43	0	1	44	0	0
16	55007670	.	G	A	23	19	42	0	1	43	0	0
16	55012538	.	G	T	5	12	17	0	0	17	0	0
16	55012643	.	G	A	5	3	8	0	1	9	0	0
16	55083392	.	G	T	2	2	4	0	0	4	0	0
16	55095692	.	T	A	1	2	3	0	0	3	0	0
16	55102387	.	C	T	3	2	5	0	0	5	0	0
16	55102422	.	C	G	2	0	2	0	2	4	0	0
16	55106058	.	T	A	3	5	8	0	0	8	0	0
16	55106207	.	T	C	12	11	23	0	0	23	0	0
16	55106223	.	A	G	17	11	28	0	2	30	0	0
16	55106279	.	C	A	12	30	42	0	1	43	0	0
16	55106367	.	A	C	14	16	30	3	0	33	0	0
16	55106405	.	G	A	12	9	21	3	0	24	0	0
16	55106443	.	C	T	8	10	18	0	2	20	0	0
16	55108801	.	C	T	15	11	26	2	2	30	0	0
16	55122779	.	T	C	13	17	30	0	1	31	0	0
16	55181068	.	G	A	0	3	3	0	1	4	0	0
16	55181565	.	G	A	0	3	3	0	2	5	0	0
17	69894	.	A	G	11	8	19	0	1	20	0	0
17	71063	.	T	C	6	2	8	0	0	8	0	0
17	118732	.	A	G	1	2	3	0	0	3	0	0
17	132932	.	A	C	6	3	9	0	0	9	0	0
17	133001	.	C	G	9	9	18	0	1	19	0	0
17	133232	.	G	A	0	2	2	0	6	8	0	0
17	136304	.	A	G	13	22	35	0	1	36	0	0
17	136599	.	G	A	16	19	35	0	1	36	0	0
17	139103	.	C	T	1	3	4	0	0	4	0	0
17	346672	.	A	C	3	2	5	0	0	5	0	0
17	599913	.	T	A	2	4	6	0	1	7	0	0
17	600039	.	A	T	6	5	11	0	0	11	0	0
17	604853	.	G	A	1	2	3	0	0	3	0	0
17	604934	.	T	G	6	2	8	0	0	8	0	0
17	604955	.	A	G	3	3	6	0	0	6	0	0
17	605332	.	G	A	1	4	5	0	0	5	0	0
17	605512	.	G	A	3	3	6	0	0	6	0	0
17	636178	.	C	T	4	3	7	0	0	7	0	0
17	660617	.	C	A	5	22	27	0	23	50	0	0
17	681127	.	G	A	8	15	23	0	0	23	0	0
17	734235	.	T	C	17	0	17	0	16	33	0	0
17	734244	.	T	C	21	13	34	0	2	36	0	0
17	734492	.	T	C	4	0	4	0	7	11	0	0
17	735297	.	C	G	2	3	5	1	4	10	0	0
17	735511	.	T	C	2	0	2	0	2	4	0	0
17	735520	.	G	A	1	2	3	0	1	4	0	0
17	742225	.	C	T	5	14	19	0	1	20	0	0
17	742274	.	A	T	10	10	20	0	0	20	0	0
17	743576	.	T	A	8	5	13	0	0	13	0	0
17	743851	.	C	A	15	17	32	0	2	34	0	0
17	811856	.	G	A	4	4	8	0	0	8	0	0
17	860339	.	G	A	11	12	23	0	1	24	0	0
17	860451	.	C	G	9	14	23	0	2	25	0	0
17	860501	.	G	A	9	8	17	0	1	18	0	0
17	860645	.	C	T	1	7	8	0	8	16	0	0
17	860704	.	G	A	9	10	19	0	0	19	0	0
17	860852	.	A	G	8	6	14	0	0	14	0	0
17	861065	.	G	A	4	2	6	0	0	6	0	0
17	867896	.	G	T	7	4	11	0	0	11	0	0
17	945704	.	G	C	2	2	4	0	1	5	0	0
17	945731	.	T	C	1	2	3	0	0	3	0	0
17	973958	.	A	G	6	4	10	0	0	10	0	0
17	974775	.	C	T	3	8	11	0	0	11	0	0
17	974838	.	G	T	11	4	15	0	0	15	0	0
17	979925	.	A	T	13	10	23	1	0	24	0	0
17	1122515	.	G	A	4	4	8	0	0	8	0	0
17	1122530	.	T	G	6	3	9	0	0	9	0	0
17	1137580	.	T	C	2	0	2	0	5	7	0	0
17	1141376	.	G	T	4	4	8	0	0	8	0	0
17	1150139	.	G	A	6	2	8	0	0	8	0	0
17	1174853	.	C	T	1	2	3	0	0	3	0	0
17	1355673	.	T	C	1	3	4	0	0	4	0	0
17	1360206	.	T	G	3	0	3	0	2	5	0	0
17	1360292	.	G	T	1	5	6	0	3	9	0	0
17	1362172	.	C	T	2	2	4	0	1	5	0	0
17	1366808	.	T	C	3	3	6	0	0	6	0	0
17	1591201	.	T	C	4	3	7	0	0	7	0	0
17	1605470	.	G	A	1	6	7	0	0	7	0	0
17	1605942	.	T	C	1	1	2	0	0	2	0	0
17	1605946	.	T	C	0	2	2	0	0	2	0	0
17	1704754	.	C	T	1	2	3	0	0	3	0	0
17	2063925	.	A	G	24	26	50	0	2	52	0	0
17	2091858	.	G	A	3	22	25	0	19	44	0	0
17	2095454	.	T	C	23	23	46	0	7	53	0	0
17	2095525	.	A	G	18	1	19	0	43	62	0	0
17	2109014	.	C	T	0	21	21	0	6	27	0	0
17	2110588	.	G	A	13	18	31	0	3	34	0	0
17	2110642	.	C	G	12	18	30	0	2	32	0	0
17	2110657	.	T	C	13	0	13	0	20	33	0	0
17	2115464	.	A	T	13	18	31	0	1	32	0	0
17	2121955	.	T	A	20	12	32	0	0	33	1	0
17	2122175	.	A	G	13	13	26	0	3	29	0	0
17	2122252	.	C	T	14	19	33	0	2	35	0	0
17	2373940	.	T	C	2	0	2	0	8	10	0	0
17	2479620	.	C	A	7	4	11	0	0	11	0	0
17	2498487	.	T	C	6	3	9	0	0	9	0	0
17	2498615	.	C	G	3	5	8	0	0	8	0	0
17	2696890	.	C	G	2	4	6	0	0	6	0	0
17	2697973	.	A	T	3	2	5	4	0	9	0	0
17	2698146	.	A	G	1	3	4	0	0	4	0	0
17	2704135	.	G	T	2	2	4	0	0	4	0	0
17	3183532	.	G	A	1	2	3	0	0	3	0	0
17	3446847	.	T	C	3	4	7	0	0	7	0	0
17	3556184	.	C	A	9	7	16	0	0	16	0	0
17	3566811	.	A	G	6	9	15	1	2	18	0	0
17	3566844	.	T	A	6	13	19	0	1	20	0	0
17	3569047	.	T	C	12	11	23	0	3	26	0	0
17	3569050	.	A	C	14	12	26	0	0	26	0	0
17	3569169	.	A	G	12	10	22	0	2	24	0	0
17	3569264	.	A	C	6	6	12	0	0	12	0	0
17	3569298	.	A	G	3	7	10	0	0	10	0	0
17	3841153	.	A	G	3	5	8	1	0	9	0	0
17	3854287	.	C	T	0	4	4	0	4	8	0	0
17	3855697	.	C	T	0	5	5	0	1	6	0	0
17	3860794	.	C	G	6	2	8	0	0	9	1	0
17	3860797	.	T	C	6	0	6	0	3	9	0	0
17	3868759	.	A	C	2	0	2	0	2	4	0	0
17	3868765	.	T	C	2	0	2	0	2	4	0	0
17	4054565	.	C	T	2	2	4	0	0	4	0	0
17	4227439	.	G	A	1	4	5	0	0	5	0	0
17	4228018	.	C	T	0	2	2	0	3	5	0	0
17	4240385	.	T	A	7	2	9	0	1	10	0	0
17	4297232	.	G	A	17	7	24	0	0	24	0	0
17	4297546	.	C	T	16	16	32	0	3	35	0	0
17	4297551	.	A	C	17	14	31	0	2	33	0	0
17	4297600	.	T	C	22	7	29	0	0	29	0	0
17	4297608	.	G	C	18	0	18	0	11	29	0	0
17	4297697	.	A	T	4	8	12	0	3	15	0	0
17	4297819	.	A	T	3	2	5	0	1	6	0	0
17	4297957	.	G	C	15	0	15	0	12	27	0	0
17	4298174	.	C	T	18	13	31	0	0	31	0	0
17	4298190	.	T	A	14	17	31	0	3	34	0	0
17	4298221	.	T	A	11	18	29	0	4	33	0	0
17	4298307	.	A	T	18	4	22	0	0	22	0	0
17	4298326	.	T	G	12	9	21	0	3	24	0	0
17	4298349	.	T	A	13	15	28	0	4	32	0	0
17	4298768	.	T	G	6	8	14	0	1	15	0	0
17	4298990	.	A	G	12	10	22	0	0	22	0	0
17	4298996	.	C	T	11	14	25	0	1	26	0	0
17	4299030	.	C	G	8	13	21	1	0	22	0	0
17	4299031	.	C	T	6	13	19	1	2	22	0	0
17	4304841	.	G	A	13	23	36	0	1	37	0	0
17	4307242	.	T	C	11	0	11	0	14	25	0	0
17	4313342	.	G	A	9	4	13	0	2	15	0	0
17	4368935	.	A	T	3	2	5	0	0	5	0	0
17	4368968	.	G	A	3	2	5	0	1	6	0	0
17	4369415	.	T	G	4	2	6	0	0	6	0	0
17	4369418	.	G	A	4	2	6	0	0	6	0	0
17	4378210	.	G	A	13	4	17	0	0	17	0	0
17	4378219	.	C	T	15	5	20	0	1	21	0	0
17	4385982	.	C	T	2	3	5	0	1	6	0	0
17	4386026	.	T	A	1	2	3	0	1	4	0	0
17	5061184	.	G	C	3	3	6	0	0	6	0	0
17	5629260	.	C	T	2	4	6	0	1	7	0	0
17	5768756	.	T	C	1	0	1	0	4	5	0	0
17	5768776	.	A	C	2	4	6	0	0	6	0	0
17	5768792	.	C	T	1	3	4	0	0	4	0	0
17	5819186	.	G	A	1	6	7	0	1	8	0	0
17	5819615	.	A	T	1	4	5	0	0	5	0	0
17	5819634	.	A	C	1	3	4	0	0	4	0	0
17	5819951	.	C	T	3	3	6	0	0	6	0	0
17	5819969	.	C	T	3	2	5	0	0	5	0	0
17	5820170	.	C	T	6	4	10	0	0	10	0	0
17	5820209	.	T	C	4	3	7	0	0	7	0	0
17	5821130	.	C	T	5	3	8	0	0	8	0	0
17	5821134	.	A	G	4	3	7	0	0	7	0	0
17	5821476	.	G	A	1	4	5	0	0	5	0	0
17	5821578	.	C	T	2	3	5	0	0	5	0	0
17	5896025	.	G	A	12	11	23	0	0	23	0	0
17	5916392	.	A	G	8	15	23	0	4	27	0	0
17	5926722	.	T	C	21	22	43	0	0	43	0	0
17	5926981	.	A	T	20	18	38	0	0	38	0	0
17	5927085	.	C	A	14	20	34	0	1	35	0	0
17	5927101	.	T	C	9	16	25	0	1	26	0	0
17	5927172	.	G	A	2	4	6	0	1	7	0	0
17	6016386	.	C	T	2	2	4	0	0	4	0	0
17	6016640	.	T	C	2	2	4	0	0	4	0	0
17	6100980	.	G	A	1	2	3	0	0	3	0	0
17	6101565	.	G	A	3	2	5	0	0	5	0	0
17	6279806	.	C	A	10	11	21	0	1	22	0	0
17	6279876	.	G	T	2	7	9	0	12	21	0	0
17	6358538	.	C	T	0	2	2	0	1	3	0	0
17	6394106	.	C	T	1	2	3	0	0	3	0	0
17	6395381	.	G	C	1	3	4	0	0	4	0	0
17	6395560	.	T	C	3	0	3	0	4	7	0	0
17	6396474	.	A	T	2	2	4	0	0	4	0	0
17	6396513	.	A	G	1	2	3	0	0	3	0	0
17	6438226	.	C	T	8	7	15	0	0	15	0	0
17	6438334	.	A	G	4	5	9	0	0	9	0	0
17	6438383	.	C	A	2	2	4	0	0	4	0	0
17	6438387	.	T	C	1	2	3	0	0	3	0	0
17	6438630	.	T	A	10	7	17	0	1	18	0	0
17	6444514	.	T	A	4	6	10	0	1	11	0	0
17	6447418	.	G	T	8	3	11	0	0	11	0	0
17	6449404	.	C	T	1	3	4	0	3	7	0	0
17	6452854	.	C	T	3	1	4	0	1	5	0	0
17	6452857	.	T	C	3	2	5	0	0	5	0	0
17	6462023	.	A	T	7	7	14	0	0	14	0	0
17	6462228	.	G	A	2	3	5	0	0	5	0	0
17	6491338	.	A	C	2	2	4	0	0	4	0	0
17	6491381	.	C	T	0	2	2	0	2	4	0	0
17	6544615	.	T	C	3	2	5	0	0	5	0	0
17	6555836	.	G	A	3	2	5	0	0	5	0	0
17	6555837	.	C	T	2	3	5	0	0	5	0	0
17	6715755	.	T	A	28	25	53	0	3	56	0	0
17	6716412	.	G	T	30	30	60	0	1	61	0	0
17	6716472	.	G	A	33	27	60	0	2	62	0	0
17	6730114	.	G	A	31	22	53	0	2	55	0	0
17	6737970	.	C	A	1	19	20	0	24	44	0	0
17	6758867	.	T	G	3	6	9	0	1	10	0	0
17	7781458	.	T	A	1	3	4	0	0	4	0	0
17	7781958	.	C	A	2	3	5	0	0	5	0	0
17	7781974	.	C	T	1	2	3	0	0	3	0	0
17	7802799	.	A	G	5	5	10	0	0	10	0	0
17	7841786	.	G	T	1	3	4	0	0	4	0	0
17	7841845	.	C	T	1	2	3	0	0	3	0	0
17	7844994	.	G	A	8	3	11	0	0	11	0	0
17	7845364	.	G	C	18	19	37	0	0	37	0	0
17	7845412	.	T	C	22	18	40	0	0	40	0	0
17	7845566	.	C	T	10	15	25	0	1	26	0	0
17	7861124	.	C	T	11	22	33	0	2	35	0	0
17	7868632	.	G	A	27	23	50	0	2	52	0	0
17	7879348	.	T	C	12	25	37	0	2	39	0	0
17	7882941	.	G	A	7	13	20	0	0	20	0	0
17	7882998	.	G	A	8	14	22	0	0	22	0	0
17	7885662	.	A	G	12	12	24	0	1	25	0	0
17	7894976	.	T	A	11	13	24	0	0	24	0	0
17	7895023	.	G	A	14	7	21	0	2	23	0	0
17	7896356	.	C	T	0	16	16	0	12	28	0	0
17	7896390	.	C	T	2	18	20	0	11	31	0	0
17	7896478	.	C	T	15	11	26	0	1	27	0	0
17	7901137	.	C	T	16	8	24	0	0	24	0	0
17	7906568	.	G	T	12	6	18	0	0	18	0	0
17	7906612	.	G	A	3	11	14	0	1	15	0	0
17	7906646	.	T	A	9	6	15	0	4	19	0	0
17	7907851	.	C	T	6	4	10	0	2	12	0	0
17	7917997	.	G	A	8	8	16	0	0	16	0	0
17	7926040	.	G	A	4	10	14	0	1	15	0	0
17	7926076	.	C	T	6	5	11	0	1	12	0	0
17	7928263	.	A	G	6	7	13	0	0	13	0	0
17	7928600	.	C	A	0	7	7	0	6	13	0	0
17	7931737	.	G	A	3	2	5	0	0	5	0	0
17	7942122	.	G	A	4	2	6	0	0	6	0	0
17	7942127	.	T	C	3	2	5	0	0	5	0	0
17	7942191	.	T	G	4	2	6	0	0	6	0	0
17	7945421	.	C	G	2	4	6	0	0	6	0	0
17	7949042	.	G	A	4	3	7	0	0	7	0	0
17	7949066	.	G	A	4	3	7	0	0	7	0	0
17	7963202	.	G	C	1	3	4	0	0	4	0	0
17	7963282	.	G	A	2	3	5	0	0	5	0	0
17	7963294	.	G	A	4	4	8	0	0	8	0	0
17	7974804	.	T	C	4	6	10	0	0	10	0	0
17	7978112	.	T	G	2	2	4	0	0	4	0	0
17	7981566	.	C	T	3	1	4	0	1	5	0	0
17	7983068	.	A	G	2	2	4	0	0	4	0	0
17	8002895	.	G	T	1	2	3	0	0	3	0	0
17	8197569	.	C	A	2	2	4	0	0	4	0	0
17	8199824	.	G	A	3	3	6	0	0	6	0	0
17	8199896	.	T	C	1	2	3	0	0	3	0	0
17	8202712	.	G	A	0	4	4	0	9	13	0	0
17	8202742	.	G	A	1	3	4	0	8	12	0	0
17	8202778	.	T	C	9	7	16	0	0	16	0	0
17	8203468	.	G	A	5	6	11	0	0	11	0	0
17	8203498	.	G	A	5	5	10	0	2	12	0	0
17	8204086	.	G	C	10	4	14	0	2	16	0	0
17	8204087	.	C	T	11	4	15	0	0	15	0	0
17	8204248	.	A	G	6	1	7	0	13	20	0	0
17	8204533	.	C	T	12	8	20	0	0	20	0	0
17	8204755	.	A	G	23	9	32	0	4	36	0	0
17	8204818	.	A	G	21	10	31	0	1	32	0	0
17	8204935	.	T	C	13	20	33	0	3	36	0	0
17	8204962	.	C	T	11	20	31	0	3	34	0	0
17	8205697	.	A	G	12	23	35	0	1	36	0	0
17	8209315	.	T	C	9	12	21	0	2	23	0	0
17	8209327	.	C	T	14	9	23	0	1	24	0	0
17	8209837	.	T	A	19	15	34	0	3	37	0	0
17	8209931	.	C	A	13	18	31	0	0	31	0	0
17	8209944	.	A	G	18	12	30	0	2	32	0	0
17	8210203	.	G	A	18	7	25	0	1	26	0	0
17	8210242	.	C	T	22	8	30	0	1	31	0	0
17	8210411	.	A	G	15	15	30	0	1	31	0	0
17	8210466	.	A	G	18	1	19	0	8	27	0	0
17	8229964	.	C	T	4	3	7	0	1	8	0	0
17	8245790	.	C	A	1	5	6	0	3	9	0	0
17	8245868	.	G	A	3	2	5	0	0	5	0	0
17	8245903	.	T	C	3	0	3	0	3	6	0	0
17	8246281	.	G	A	4	2	6	0	0	6	0	0
17	8246329	.	T	C	3	5	8	0	0	8	0	0
17	8246341	.	A	G	2	4	6	0	0	6	0	0
17	8248987	.	A	G	1	2	3	0	0	3	0	0
17	8249153	.	A	T	3	3	6	0	0	6	0	0
17	8253267	.	A	G	1	2	3	0	0	3	0	0
17	8261762	.	C	T	3	1	4	0	1	5	0	0
17	8261769	.	G	A	2	2	4	0	0	4	0	0
17	8261864	.	A	T	1	2	3	0	0	3	0	0
17	8284514	.	C	T	3	4	7	0	0	7	0	0
17	8286764	.	C	T	3	2	5	0	0	5	0	0
17	8286877	.	A	G	0	2	2	0	0	2	0	0
17	8286879	.	C	A	1	2	3	0	0	3	0	0
17	8502883	.	G	A	3	4	7	0	1	8	0	0
17	8502934	.	A	G	4	3	7	0	1	8	0	0
17	8562349	.	A	G	1	2	3	0	0	3	0	0
17	8597174	.	T	A	11	17	28	0	5	33	0	0
17	8597702	.	A	T	16	21	37	0	4	41	0	0
17	8597965	.	T	A	25	17	42	0	0	42	0	0
17	8611580	.	G	A	27	18	45	0	2	47	0	0
17	8623396	.	G	A	9	19	28	0	3	31	0	0
17	8623456	.	T	C	15	16	31	0	2	33	0	0
17	8727654	.	A	T	5	2	7	0	0	7	0	0
17	8754388	.	C	T	1	2	3	0	0	3	0	0
17	8766176	.	G	A	1	4	5	0	0	5	0	0
17	8772665	.	C	T	1	2	3	0	0	3	0	0
17	8780716	.	G	A	4	2	6	0	0	6	0	0
17	8782396	.	C	T	3	3	6	0	0	6	0	0
17	8782484	.	C	T	6	3	9	0	1	10	0	0
17	8784682	.	T	C	4	6	10	0	0	10	0	0
17	8784742	.	G	A	0	6	6	0	4	10	0	0
17	8785801	.	T	C	2	4	6	0	1	7	0	0
17	8785804	.	T	C	3	3	6	0	0	6	0	0
17	8789449	.	G	A	4	4	8	0	1	9	0	0
17	8791468	.	A	G	2	6	8	0	1	9	0	0
17	8791573	.	A	T	6	3	9	0	1	10	0	0
17	8791841	.	T	G	4	4	8	0	0	8	0	0
17	8791863	.	C	T	1	4	5	0	1	6	0	0
17	8791907	.	A	G	1	0	1	0	4	5	0	0
17	8927638	.	A	G	8	9	17	0	1	18	0	0
17	8927641	.	A	G	9	6	15	0	1	16	0	0
17	8934223	.	G	A	13	19	32	0	2	34	0	0
17	8934307	.	C	T	16	12	28	0	1	29	0	0
17	8937918	.	G	A	17	6	23	0	1	24	0	0
17	8938023	.	C	T	17	16	33	0	1	34	0	0
17	8938249	.	T	C	16	20	36	0	1	37	0	0
17	8938269	.	G	A	18	15	33	0	2	35	0	0
17	8938305	.	T	A	22	12	34	0	2	36	0	0
17	8941309	.	T	C	9	10	19	0	1	20	0	0
17	8941320	.	C	T	9	8	17	0	1	18	0	0
17	8951606	.	C	G	0	8	8	0	13	21	0	0
17	8951644	.	C	T	2	14	16	0	11	27	0	0
17	8951655	.	T	C	16	14	30	0	3	33	0	0
17	8951867	.	C	T	3	11	14	0	19	33	0	0
17	8964520	.	G	A	10	10	20	0	0	20	0	0
17	8969278	.	A	G	11	10	21	0	2	23	0	0
17	8969296	.	G	A	16	13	29	0	1	30	0	0
17	9042608	.	G	C	2	4	6	0	0	6	0	0
17	9143323	.	G	A	2	5	7	0	1	8	0	0
17	9225184	.	G	A	1	6	7	0	7	14	0	0
17	9225223	.	A	G	3	4	7	0	2	9	0	0
17	9253504	.	A	T	1	4	5	0	0	5	0	0
17	9254269	.	T	A	5	3	8	0	0	8	0	0
17	9255196	.	G	A	0	9	9	0	3	12	0	0
17	9255547	.	G	C	11	16	27	0	0	27	0	0
17	9255703	.	C	T	10	11	21	0	0	21	0	0
17	9266298	.	C	T	14	15	29	0	1	30	0	0
17	9266501	.	G	T	2	16	18	0	17	35	0	0
17	9601121	.	G	C	1	3	4	0	0	4	0	0
17	9601133	.	C	T	0	3	3	0	0	3	0	0
17	9884342	.	A	G	3	3	6	0	0	6	0	0
17	9888958	.	C	G	5	2	7	0	0	7	0	0
17	9889127	.	T	A	6	4	10	0	3	13	0	0
17	9889223	.	C	T	2	5	7	0	2	9	0	0
17	9889313	.	T	A	5	2	7	0	4	11	0	0
17	9889427	.	G	A	3	10	13	0	1	14	0	0
17	9889728	.	A	T	5	6	11	0	1	12	0	0
17	9889745	.	A	G	10	0	10	0	7	17	0	0
17	9944725	.	A	G	6	5	11	0	0	11	0	0
17	9944848	.	T	A	6	4	10	0	1	11	0	0
17	9944996	.	G	T	0	6	6	0	2	8	0	0
17	9944999	.	G	A	1	8	9	0	0	9	0	0
17	9945176	.	T	A	8	7	15	0	0	15	0	0
17	9945178	.	T	G	8	7	15	0	0	15	0	0
17	9951885	.	G	A	6	4	10	0	0	10	0	0
17	9952033	.	C	T	1	10	11	0	3	14	0	0
17	9957913	.	T	A	2	2	4	0	0	4	0	0
17	9962399	.	C	A	7	5	12	0	0	12	0	0
17	9963519	.	G	A	0	6	6	0	4	10	0	0
17	9964032	.	T	A	4	2	6	0	2	10	2	0
17	9964125	.	T	A	2	2	4	2	2	8	0	0
17	9964177	.	C	A	3	2	5	0	0	5	0	0
17	9964334	.	T	A	1	2	3	0	1	4	0	0
17	9964912	.	G	A	2	6	8	0	1	9	0	0
17	9964944	.	C	A	5	3	8	0	1	9	0	0
17	9964954	.	T	A	2	2	4	0	2	6	0	0
17	9965344	.	T	A	2	2	4	0	0	4	0	0
17	9967566	.	G	A	2	3	5	0	0	5	0	0
17	10143808	.	A	G	3	6	9	0	1	10	0	0
17	11378933	.	G	A	7	2	9	0	1	10	0	0
17	11378935	.	C	A	9	1	10	0	1	11	0	0
17	12073097	.	A	G	3	0	3	0	6	9	0	0
17	12073108	.	T	C	1	7	8	0	1	9	0	0
17	15633530	.	C	T	4	2	6	1	2	9	0	0
17	15633721	.	T	C	6	6	12	0	1	13	0	0
17	15633987	.	T	C	1	8	9	0	0	9	0	0
17	15741239	.	A	G	2	2	4	0	0	4	0	0
17	15965395	.	A	G	4	2	6	0	1	7	0	0
17	15965397	.	A	G	2	2	4	0	3	7	0	0
17	17130837	.	T	A	7	1	8	0	0	8	0	0
17	18070138	.	G	A	5	17	22	0	5	27	0	0
17	18176364	.	G	T	12	3	15	0	0	15	0	0
17	18179927	.	T	C	19	6	25	2	6	33	0	0
17	19420197	.	C	T	16	11	27	0	0	27	0	0
17	19420434	.	C	T	3	7	10	0	8	18	0	0
17	19420563	.	T	G	12	9	21	0	5	26	0	0
17	19421109	.	C	G	14	11	25	0	2	27	0	0
17	19421248	.	T	G	12	13	25	0	0	25	0	0
17	19421636	.	T	C	9	0	9	0	8	17	0	0
17	19421667	.	A	G	4	9	13	0	1	14	0	0
17	19421948	.	C	T	6	11	17	1	1	19	0	0
17	19421955	.	A	T	6	14	20	0	1	21	0	0
17	19422452	.	C	T	2	4	6	0	4	10	0	0
17	19423145	.	C	T	3	3	6	0	0	6	0	0
17	19423375	.	A	T	4	3	7	0	1	8	0	0
17	19423586	.	A	T	2	2	4	0	1	5	0	0
17	19423713	.	G	A	6	4	10	0	0	10	0	0
17	19429290	.	T	C	5	0	5	0	4	9	0	0
17	19431175	.	C	A	0	2	2	0	2	4	0	0
17	19431565	.	G	A	5	2	7	0	0	7	0	0
17	19440149	.	T	G	2	3	5	0	0	5	0	0
17	19440492	.	G	A	2	2	4	0	0	4	0	0
17	19440500	.	T	G	2	2	4	0	0	4	0	0
17	19506575	.	A	C	1	3	4	0	0	4	0	0
17	19506934	.	G	A	0	2	2	0	2	4	0	0
17	19506943	.	A	C	2	2	4	0	1	5	0	0
17	19607654	.	A	T	6	12	18	0	1	19	0	0
17	19607835	.	T	A	7	6	13	0	1	14	0	0
17	19607950	.	C	G	3	3	6	0	0	6	0	0
17	19607983	.	T	G	2	3	5	0	0	5	0	0
17	19607991	.	T	C	1	0	1	0	3	4	0	0
17	19608612	.	C	T	0	2	2	0	1	3	0	0
17	19692573	.	A	C	4	6	10	0	0	10	0	0
17	19715899	.	T	C	20	13	33	0	1	34	0	0
17	19754794	.	T	C	1	2	3	0	0	3	0	0
17	19754800	.	G	A	1	2	3	0	0	3	0	0
17	19754993	.	G	A	3	1	4	0	1	5	0	0
17	19755032	.	C	T	1	4	5	0	3	8	0	0
17	19756186	.	C	A	0	2	2	0	4	6	0	0
17	19757037	.	C	T	1	2	3	0	0	3	0	0
17	19757062	.	G	C	2	2	4	0	0	4	0	0
17	19831910	.	G	C	2	2	4	0	0	4	0	0
17	19831980	.	A	T	1	2	3	0	0	3	0	0
17	19832282	.	A	G	3	2	5	0	0	5	0	0
17	19832895	.	T	C	3	5	8	0	0	8	0	0
17	20147644	.	G	C	2	2	4	0	0	4	0	0
17	20147756	.	A	C	3	6	9	0	1	10	0	0
17	20147771	.	A	G	3	7	10	0	0	10	0	0
17	20147804	.	C	A	2	3	5	0	0	5	0	0
17	20148867	.	G	A	5	3	8	0	0	8	0	0
17	20184537	.	A	G	2	2	4	0	0	4	0	0
17	20185775	.	G	A	1	2	3	0	0	3	0	0
17	20188819	.	T	G	2	4	6	0	0	6	0	0
17	20188836	.	C	T	2	4	6	0	0	6	0	0
17	20189047	.	A	T	4	15	19	0	1	20	0	0
17	20191941	.	A	G	2	2	4	0	0	4	0	0
17	20191956	.	A	G	1	2	3	0	0	3	0	0
17	20195988	.	G	C	1	4	5	0	0	5	0	0
17	20196194	.	A	G	4	3	7	0	0	7	0	0
17	20196770	.	G	A	7	2	9	0	1	10	0	0
17	20196809	.	A	G	5	2	7	0	2	9	0	0
17	20198764	.	G	T	3	5	8	0	0	8	0	0
17	20198914	.	T	C	1	0	1	0	2	3	0	0
17	20198989	.	C	T	0	2	2	0	2	4	0	0
17	20198991	.	T	C	2	2	4	0	0	4	0	0
17	20202365	.	C	G	1	6	7	0	2	9	0	0
17	20202391	.	G	A	7	3	10	0	0	10	0	0
17	20206941	.	T	A	1	3	4	0	0	4	0	0
17	20207260	.	T	A	1	2	3	0	0	3	0	0
17	20214653	.	G	A	2	4	6	0	0	6	0	0
17	20214664	.	C	T	3	4	7	0	0	7	0	0
17	20214757	.	T	C	1	2	3	0	0	3	0	0
17	20214766	.	T	C	2	0	2	0	2	4	0	0
17	20215498	.	G	A	4	2	6	0	1	7	0	0
17	20215570	.	A	C	2	0	2	0	3	5	0	0
17	20215739	.	T	C	3	4	7	0	1	8	0	0
17	20232143	.	C	T	2	2	4	0	0	4	0	0
17	20232144	.	C	A	2	2	4	0	0	4	0	0
17	20232189	.	T	A	2	3	5	0	0	5	0	0
17	20232526	.	G	T	2	2	4	0	0	4	0	0
17	20235494	.	G	A	1	3	4	0	0	4	0	0
17	20243035	.	A	G	12	0	12	0	23	35	0	0
17	20243375	.	C	A	23	24	47	0	2	49	0	0
17	20243564	.	G	A	14	14	28	0	3	31	0	0
17	20243611	.	G	A	14	13	27	0	2	29	0	0
17	20248398	.	A	G	21	8	29	0	1	30	0	0
17	20248455	.	A	T	17	10	27	0	1	28	0	0
17	20248479	.	T	C	17	13	30	0	3	33	0	0
17	20248500	.	C	G	1	9	10	0	19	29	0	0
17	20248705	.	T	C	11	0	11	0	15	26	0	0
17	20256603	.	A	C	5	10	15	0	0	15	0	0
17	20256669	.	A	G	11	9	20	0	1	21	0	0
17	20256894	.	T	C	7	4	11	0	2	13	0	0
17	20256921	.	A	G	5	5	10	0	2	12	0	0
17	20256948	.	G	C	4	0	4	0	9	13	0	0
17	20264097	.	C	T	5	6	11	0	1	12	0	0
17	20268379	.	G	A	6	6	12	0	0	12	0	0
17	20268442	.	C	T	5	4	9	0	0	9	0	0
17	20287338	.	C	T	2	2	4	0	0	4	0	0
17	20287443	.	A	T	5	2	7	0	0	7	0	0
17	20321569	.	G	A	3	5	8	0	0	8	0	0
17	20321614	.	C	T	0	4	4	0	3	7	0	0
17	20324012	.	T	C	5	3	8	0	0	8	0	0
17	20324036	.	C	T	0	3	3	0	8	11	0	0
17	20324051	.	A	G	4	6	10	0	2	12	0	0
17	20324084	.	T	C	6	0	6	0	8	14	0	0
17	20324114	.	C	T	4	8	12	0	5	17	0	0
17	20324144	.	G	A	6	6	12	0	0	12	0	0
17	20429983	.	C	T	1	2	3	0	0	3	0	0
17	20517926	.	A	G	5	2	7	0	0	7	0	0
17	20518389	.	A	G	2	0	2	0	3	5	0	0
17	20582140	.	T	C	2	2	4	0	0	4	0	0
17	20585284	.	C	T	2	3	5	0	0	5	0	0
17	20587947	.	T	A	3	2	5	0	1	6	0	0
17	20605376	.	C	T	3	2	5	0	0	5	0	0
17	20653983	.	T	C	7	5	12	0	0	12	0	0
17	20654140	.	G	A	3	6	9	0	0	9	0	0
17	20654948	.	T	A	2	2	4	0	0	4	0	0
17	20655086	.	T	A	6	3	9	0	0	9	0	0
17	20655106	.	C	T	0	3	3	0	2	5	0	0
17	20674063	.	C	T	10	4	14	0	0	14	0	0
17	20674489	.	T	C	16	0	16	0	15	31	0	0
17	20674755	.	A	T	2	2	4	0	0	4	0	0
17	20674794	.	C	T	7	9	16	1	0	17	0	0
17	20674889	.	T	A	15	18	33	0	0	33	0	0
17	20684685	.	A	T	13	12	25	0	9	34	0	0
17	20695604	.	G	A	6	4	10	0	1	11	0	0
17	20695941	.	C	A	0	1	1	0	5	6	0	0
17	20701602	.	A	G	25	24	49	0	2	51	0	0
17	20701999	.	G	A	25	21	46	0	1	47	0	0
17	20702030	.	C	T	2	16	18	0	23	41	0	0
17	20702056	.	G	A	21	17	38	0	0	38	0	0
17	20719067	.	G	C	15	8	23	0	1	24	0	0
17	20719232	.	A	G	5	7	12	0	2	14	0	0
17	20719248	.	C	T	6	3	9	0	0	9	0	0
17	20719746	.	G	T	10	3	13	0	0	13	0	0
17	20720046	.	C	T	4	6	10	0	14	24	0	0
17	20720121	.	G	T	11	12	23	0	0	23	0	0
17	20720334	.	C	T	12	13	25	0	0	25	0	0
17	20720581	.	G	A	6	9	15	0	3	18	0	0
17	20720739	.	G	T	11	7	18	0	0	18	0	0
17	20721597	.	A	G	4	4	8	0	0	8	0	0
17	20722113	.	C	A	12	3	15	0	0	15	0	0
17	20722389	.	A	G	2	2	4	0	1	5	0	0
17	20722955	.	A	G	7	9	16	0	0	16	0	0
17	20723081	.	A	T	1	4	5	0	0	5	0	0
17	20723407	.	A	G	4	7	11	0	2	13	0	0
17	20724187	.	A	T	3	2	5	0	0	5	0	0
17	20724318	.	C	T	6	4	10	0	0	10	0	0
17	20724675	.	A	G	2	6	8	0	0	8	0	0
17	20725296	.	T	C	3	3	6	0	0	6	0	0
17	20725474	.	A	C	5	2	7	0	1	8	0	0
17	20731097	.	C	T	1	3	4	0	0	4	0	0
17	20734207	.	G	A	4	4	8	0	0	8	0	0
17	20795992	.	G	A	1	3	4	0	0	4	0	0
17	20963653	.	T	C	13	17	30	0	1	31	0	0
17	20963664	.	T	C	12	14	26	0	2	28	0	0
17	20964611	.	G	A	3	5	8	0	0	8	0	0
17	20964669	.	A	G	6	4	10	0	0	10	0	0
17	20964978	.	A	G	5	7	12	0	1	13	0	0
17	20965143	.	G	A	8	4	12	0	2	14	0	0
17	20965182	.	C	T	1	8	9	0	11	20	0	0
17	20965194	.	G	T	12	10	22	0	1	23	0	0
17	20965295	.	T	G	11	5	16	0	0	16	0	0
17	20978673	.	A	G	9	4	13	0	1	14	0	0
17	20978972	.	G	A	6	3	9	0	0	9	0	0
17	21102352	.	T	A	5	4	9	0	0	9	0	0
17	21102367	.	G	A	4	7	11	0	0	11	0	0
17	21104883	.	A	G	1	3	4	0	0	4	0	0
17	21120781	.	G	A	9	6	15	0	0	15	0	0
17	21123435	.	G	A	2	10	12	0	3	15	0	0
17	21123461	.	A	T	2	6	8	0	0	8	0	0
17	21123537	.	T	C	5	2	7	0	0	7	0	0
17	21147021	.	C	T	7	6	13	0	2	15	0	0
17	21151945	.	C	A	4	6	10	0	1	11	0	0
17	21151996	.	C	T	2	7	9	0	0	9	0	0
17	21152038	.	T	C	1	5	6	0	0	6	0	0
17	21152059	.	T	A	1	3	4	0	2	6	0	0
17	21152106	.	G	A	3	2	5	0	1	6	0	0
17	21152145	.	A	C	3	6	9	0	1	10	0	0
17	21154691	.	A	G	7	7	14	0	0	14	0	0
17	21154957	.	C	A	7	9	16	0	0	16	0	0
17	21155425	.	C	A	13	6	19	0	1	20	0	0
17	21155625	.	T	G	2	2	4	0	0	4	0	0
17	21155817	.	T	C	16	13	29	0	0	29	0	0
17	21156091	.	A	G	8	5	13	0	0	13	0	0
17	21156140	.	G	T	7	2	9	0	8	17	0	0
17	21156162	.	A	G	9	14	23	0	1	24	0	0
17	21156207	.	A	C	16	10	26	0	3	30	1	0
17	21156220	.	C	T	16	9	25	0	4	29	0	0
17	21156265	.	T	A	10	5	15	0	1	16	0	0
17	21156720	.	A	C	3	4	7	0	0	7	0	0
17	21156808	.	A	T	6	10	16	0	0	16	0	0
17	21156858	.	T	G	1	2	3	0	1	4	0	0
17	21156860	.	T	C	1	3	4	0	0	4	0	0
17	21158231	.	T	A	3	4	7	0	0	7	0	0
17	21158527	.	G	A	2	2	4	0	0	4	0	0
17	21158549	.	T	G	3	2	5	0	2	7	0	0
17	21160107	.	G	A	4	7	11	0	0	11	0	0
17	21162573	.	T	C	2	6	8	0	1	9	0	0
17	21245326	.	A	G	2	3	5	0	0	5	0	0
17	21310117	.	G	A	2	2	4	0	0	4	0	0
17	21310929	.	G	A	2	2	4	0	0	4	0	0
17	21372616	.	C	T	3	8	11	0	23	34	0	0
17	21372810	.	G	T	26	29	55	0	1	56	0	0
17	21373062	.	G	A	22	21	43	0	3	46	0	0
17	21373105	.	C	G	3	21	24	0	18	42	0	0
17	21377133	.	G	A	12	11	23	0	0	23	0	0
17	21396399	.	A	G	4	6	10	0	1	11	0	0
17	21396444	.	A	G	6	7	13	0	0	13	0	0
17	21396462	.	A	G	5	8	13	0	0	13	0	0
17	21433014	.	C	T	0	6	6	0	4	10	0	0
17	21433074	.	G	A	7	6	13	0	1	14	0	0
17	21433396	.	C	T	0	7	7	0	2	9	0	0
17	21433425	.	A	G	2	6	8	0	1	9	0	0
17	21433497	.	G	T	3	2	5	0	0	5	0	0
17	21433498	.	G	T	3	2	5	0	0	5	0	0
17	21433680	.	C	A	8	5	13	1	0	14	0	0
17	21547779	.	A	G	1	2	3	0	0	3	0	0
17	21560706	.	A	T	3	3	6	0	0	6	0	0
17	21560738	.	A	G	6	5	11	0	0	11	0	0
17	21560763	.	T	C	7	7	14	0	0	14	0	0
17	21617536	.	T	C	3	2	5	0	0	5	0	0
17	21617586	.	C	T	1	4	5	0	0	5	0	0
17	21791668	.	T	C	7	0	7	0	9	16	0	0
17	21817552	.	G	C	3	2	5	0	0	5	0	0
17	21818245	.	C	T	3	4	7	0	0	7	0	0
17	21818266	.	T	C	2	3	5	0	0	5	0	0
17	21820366	.	C	T	4	8	12	0	0	12	0	0
17	21820378	.	C	T	3	8	11	0	0	11	0	0
17	21820583	.	G	A	9	4	13	0	0	13	0	0
17	21820744	.	A	T	6	6	12	0	1	13	0	0
17	21820772	.	A	G	6	4	10	0	2	12	0	0
17	21820879	.	C	T	12	10	22	0	0	22	0	0
17	21821381	.	A	G	9	9	18	0	1	19	0	0
17	21821405	.	T	C	10	6	16	0	0	16	0	0
17	21821627	.	C	T	5	9	14	0	0	14	0	0
17	21821653	.	T	C	6	2	8	0	1	9	0	0
17	21821856	.	C	T	9	9	18	0	1	19	0	0
17	21821958	.	C	T	5	7	12	0	0	12	0	0
17	21904009	.	G	A	2	8	10	0	12	22	0	0
17	21905752	.	A	C	10	7	17	11	0	28	0	0
17	21911999	.	T	C	24	17	41	0	1	42	0	0
17	21912381	.	T	C	15	7	22	0	3	25	0	0
17	21912489	.	T	C	13	9	22	0	1	23	0	0
17	21912517	.	T	C	19	4	23	0	1	24	0	0
17	21912554	.	G	T	18	9	27	0	1	28	0	0
17	21912597	.	C	A	11	9	20	0	2	22	0	0
17	21912622	.	C	A	11	8	19	0	1	20	0	0
17	21912676	.	A	T	5	14	19	0	0	19	0	0
17	21912708	.	T	A	7	13	20	0	0	20	0	0
17	21912797	.	T	C	11	8	19	0	0	19	0	0
17	21912874	.	A	G	15	15	30	0	0	30	0	0
17	21912890	.	G	T	13	10	23	0	1	24	0	0
17	21952787	.	G	A	0	6	6	0	4	10	0	0
17	21954957	.	C	T	5	5	10	0	0	10	0	0
17	21955115	.	T	C	5	6	11	0	1	12	0	0
17	21958945	.	A	G	4	0	4	0	12	16	0	0
17	21959239	.	A	T	5	6	11	0	2	13	0	0
17	21975525	.	G	A	0	4	4	0	6	10	0	0
17	21975528	.	C	G	6	4	10	0	1	11	0	0
17	22003274	.	A	G	7	3	10	0	0	10	0	0
17	22003324	.	A	T	2	3	5	0	1	6	0	0
17	22003417	.	C	T	1	6	7	0	2	9	0	0
17	22032345	.	T	A	3	4	7	1	1	9	0	0
17	22032679	.	A	C	2	5	7	0	0	7	0	0
17	22033020	.	G	A	5	4	9	0	0	9	0	0
17	22033142	.	T	C	6	0	6	0	8	14	0	0
17	22035770	.	T	C	4	0	4	0	3	7	0	0
17	22035945	.	C	T	0	3	3	0	4	7	0	0
17	22036427	.	C	T	2	3	5	0	0	5	0	0
17	22036659	.	G	T	2	3	5	0	1	6	0	0
17	22036686	.	A	G	6	5	11	0	0	11	0	0
17	22036896	.	G	A	3	3	6	0	0	6	0	0
17	22044272	.	T	C	5	0	5	0	4	9	0	0
17	22051176	.	A	G	1	4	5	0	1	6	0	0
17	22052074	.	G	A	3	5	8	0	1	9	0	0
17	22058188	.	C	T	2	5	7	0	0	7	0	0
17	22062275	.	C	T	3	6	9	0	0	9	0	0
17	22074703	.	C	T	4	2	6	0	0	6	0	0
17	22088716	.	T	G	5	3	8	0	1	9	0	0
17	22090897	.	T	G	6	0	6	0	4	10	0	0
17	22091044	.	T	G	5	2	7	0	0	7	0	0
17	22091120	.	A	T	1	6	7	0	0	7	0	0
17	22108065	.	G	A	11	12	23	0	3	26	0	0
17	22108207	.	A	T	9	8	17	0	2	19	0	0
17	22111379	.	T	G	11	7	18	0	0	18	0	0
17	22111386	.	T	C	10	0	10	0	7	17	0	0
17	22111610	.	G	A	9	6	15	0	2	17	0	0
17	22113050	.	T	C	10	6	16	0	0	16	0	0
17	22471649	.	G	A	0	4	4	0	1	5	0	0
17	22500600	.	G	A	9	6	15	0	0	15	0	0
17	22500627	.	C	T	13	5	18	0	1	19	0	0
17	22500898	.	T	G	6	0	6	0	10	16	0	0
17	22500937	.	G	A	1	5	6	0	5	11	0	0
17	22500972	.	A	C	5	5	10	0	0	10	0	0
17	22501063	.	G	A	0	7	7	0	6	13	0	0
17	22501309	.	G	A	7	7	14	0	0	14	0	0
17	22501353	.	G	A	6	7	13	0	1	14	0	0
17	22501447	.	T	A	4	9	13	0	1	14	0	0
17	22501490	.	T	C	6	5	11	0	1	12	0	0
17	22501493	.	C	A	5	6	11	0	2	13	0	0
17	22501547	.	C	A	7	9	16	0	1	17	0	0
17	22501645	.	G	T	3	5	8	0	0	8	0	0
17	22501858	.	C	T	2	4	6	0	1	7	0	0
17	22524100	.	A	G	1	1	2	2	1	5	0	0
17	22524581	.	T	C	2	7	9	0	0	9	0	0
17	22582313	.	C	T	22	9	31	0	0	31	0	0
17	22584847	.	G	A	24	19	43	0	2	45	0	0
17	22585264	.	T	A	17	29	46	0	2	48	0	0
17	22585273	.	C	T	27	17	44	0	5	49	0	0
17	22585337	.	T	A	19	17	36	0	2	38	0	0
17	22650586	.	C	T	4	2	6	0	0	6	0	0
17	22650641	.	C	A	2	3	5	0	0	5	0	0
17	22652799	.	T	A	2	3	5	0	0	5	0	0
17	22652825	.	G	T	4	2	6	0	0	6	0	0
17	22653491	.	C	T	4	6	10	0	1	11	0	0
17	22653710	.	C	T	7	3	10	0	0	10	0	0
17	22654096	.	C	T	3	3	6	0	1	7	0	0
17	22659176	.	G	T	1	4	5	0	5	10	0	0
17	22659206	.	G	A	2	4	6	0	1	7	0	0
17	22659957	.	A	G	2	1	3	0	6	9	0	0
17	22662759	.	T	C	2	10	12	0	0	12	0	0
17	22669012	.	G	A	2	7	9	0	9	18	0	0
17	22669060	.	C	T	10	10	20	0	2	22	0	0
17	22669511	.	A	C	6	8	14	0	1	15	0	0
17	22687408	.	C	A	13	14	27	0	0	27	0	0
17	22687409	.	C	G	13	14	27	0	0	27	0	0
17	22687451	.	T	C	15	10	25	0	0	25	0	0
17	22687500	.	T	G	13	11	24	0	2	26	0	0
17	22687558	.	T	A	21	14	35	0	1	36	0	0
17	22687561	.	G	A	20	13	33	0	5	38	0	0
17	22687729	.	T	C	18	24	42	0	3	45	0	0
17	22687842	.	T	A	16	21	37	0	1	38	0	0
17	22713696	.	C	T	10	10	20	0	1	21	0	0
17	22723479	.	T	C	14	12	26	0	2	28	0	0
17	22723515	.	C	T	10	15	25	0	4	29	0	0
17	22729079	.	T	C	11	15	26	0	1	27	0	0
17	22729772	.	T	A	14	12	26	0	1	28	1	0
17	22729796	.	G	A	2	13	15	0	17	32	0	0
17	22729886	.	C	T	11	8	19	0	0	19	0	0
17	22738350	.	G	A	16	9	25	0	0	25	0	0
17	22741044	.	C	T	9	13	22	0	0	22	0	0
17	22741070	.	G	A	2	11	13	0	7	20	0	0
17	22741096	.	A	T	10	7	17	0	0	17	0	0
17	22741437	.	A	T	14	16	30	0	0	30	0	0
17	22805016	.	G	A	3	4	7	0	0	7	0	0
17	22916905	.	C	T	11	4	15	0	0	15	0	0
17	22918258	.	A	G	4	3	7	0	0	7	0	0
17	22937684	.	A	T	2	9	11	0	0	11	0	0
17	22937719	.	A	T	3	5	8	0	2	10	0	0
17	22944875	.	A	G	8	5	13	0	1	14	0	0
17	22944887	.	A	G	6	6	12	0	1	13	0	0
17	22946926	.	C	T	3	2	5	0	0	5	0	0
17	22946930	.	A	G	2	2	4	0	1	5	0	0
17	23212811	.	G	A	1	5	6	0	0	6	0	0
17	23213219	.	G	A	1	2	3	0	0	3	0	0
17	23215411	.	T	C	5	5	10	0	0	10	0	0
17	23215612	.	G	A	5	3	8	0	0	8	0	0
17	23215678	.	A	T	3	2	5	0	0	5	0	0
17	23216461	.	C	T	4	5	9	0	1	10	0	0
17	23220627	.	A	G	3	4	7	0	0	7	0	0
17	23220698	.	T	A	5	6	11	0	0	11	0	0
17	23222460	.	C	G	8	5	13	0	1	14	0	0
17	23223166	.	C	G	3	7	10	0	0	10	0	0
17	23224626	.	C	T	4	5	9	0	0	9	0	0
17	23224680	.	G	A	5	8	13	0	0	13	0	0
17	23224743	.	A	G	8	0	8	0	10	18	0	0
17	23224800	.	G	A	5	9	14	0	0	14	0	0
17	23226667	.	C	T	14	8	22	0	0	22	0	0
17	23231130	.	C	T	13	12	25	0	1	26	0	0
17	23300837	.	C	G	9	3	12	0	0	12	0	0
17	23300879	.	G	A	8	7	15	0	1	16	0	0
17	23300888	.	T	C	9	6	15	0	1	16	0	0
17	23301102	.	C	T	8	9	17	0	1	18	0	0
17	23301303	.	G	A	18	17	35	0	1	36	0	0
17	23301372	.	C	T	24	16	40	0	0	40	0	0
17	23301390	.	G	A	1	24	25	0	17	42	0	0
17	23301433	.	G	T	25	25	50	0	1	51	0	0
17	23301484	.	G	A	29	19	48	0	0	48	0	0
17	23301799	.	A	G	12	4	16	0	2	18	0	0
17	23301890	.	G	A	2	2	4	0	0	4	0	0
17	23434216	.	G	A	8	7	15	0	0	15	0	0
17	23434264	.	A	G	8	5	13	0	1	14	0	0
17	23434389	.	T	C	4	0	4	0	4	8	0	0
17	23437629	.	C	A	5	4	9	0	0	9	0	0
17	23437641	.	A	G	3	3	6	0	0	6	0	0
17	23437677	.	C	G	1	3	4	0	0	4	0	0
17	23441680	.	C	T	4	3	7	0	0	7	0	0
17	23441698	.	A	G	2	3	5	0	1	6	0	0
17	23444415	.	A	G	1	3	4	0	0	4	0	0
17	23542264	.	T	A	3	2	5	0	0	5	0	0
17	23542322	.	C	A	4	3	7	0	0	7	0	0
17	23542616	.	A	G	1	3	4	0	0	4	0	0
17	23542677	.	G	A	1	5	6	0	0	6	0	0
17	23549232	.	A	G	5	0	5	0	4	9	0	0
17	23549293	.	A	G	6	0	6	0	3	9	0	0
17	23549416	.	G	A	4	5	9	0	1	10	0	0
17	23549710	.	G	T	6	6	12	0	1	13	0	0
17	23551512	.	T	C	3	2	5	0	0	5	0	0
17	23551536	.	C	T	5	3	8	0	0	8	0	0
17	23574682	.	G	A	4	4	8	0	0	8	0	0
17	23575413	.	A	G	2	4	6	0	1	7	0	0
17	23656034	.	A	C	25	1	26	0	22	48	0	0
17	23656112	.	C	T	0	22	22	0	13	35	0	0
17	23659853	.	C	T	17	29	46	0	1	47	0	0
17	23711184	.	A	T	9	7	16	0	1	17	0	0
17	23711421	.	A	C	8	12	20	0	1	22	1	0
17	23711775	.	C	T	1	10	11	0	15	26	0	0
17	23722882	.	A	T	2	7	9	0	1	10	0	0
17	23727637	.	G	T	3	6	9	0	1	10	0	0
17	23757541	.	G	A	0	2	2	0	2	4	0	0
17	23762847	.	G	A	0	5	5	0	2	7	0	0
17	23764591	.	T	C	3	3	6	0	0	6	0	0
17	23820614	.	A	G	11	5	16	0	0	16	0	0
17	23821410	.	C	T	10	7	17	0	0	17	0	0
17	23821480	.	T	A	7	6	13	0	0	13	0	0
17	23822749	.	C	T	3	7	10	0	0	10	0	0
17	23822856	.	G	A	1	4	5	0	0	5	0	0
17	23824504	.	A	G	1	4	5	0	0	5	0	0
17	23929692	.	A	G	2	0	2	0	4	6	0	0
17	23935259	.	C	T	4	3	7	0	0	7	0	0
17	23937626	.	T	G	5	11	16	0	1	17	0	0
17	23940102	.	C	A	10	17	27	0	0	28	1	0
17	23948365	.	A	G	24	11	35	0	3	38	0	0
17	23948396	.	C	T	22	11	33	0	3	36	0	0
17	23952672	.	G	C	14	32	46	0	1	47	0	0
17	23956882	.	G	A	8	21	29	0	1	30	0	0
17	23956925	.	G	A	0	19	19	0	9	28	0	0
17	23964568	.	A	T	4	2	6	0	0	6	0	0
17	23964576	.	G	T	3	1	4	0	0	4	0	0
17	23964637	.	T	C	3	3	6	0	0	6	0	0
17	23964690	.	T	A	5	10	15	0	0	15	0	0
17	23964719	.	A	G	6	8	14	0	1	15	0	0
17	23964732	.	T	C	4	9	13	0	0	13	0	0
17	23965241	.	G	T	1	6	7	0	1	8	0	0
17	23965283	.	T	A	7	6	13	0	0	13	0	0
17	23965475	.	G	C	5	2	7	0	0	7	0	0
17	23965694	.	A	C	7	3	10	0	0	10	0	0
17	23965983	.	C	A	3	5	8	0	0	8	0	0
17	23986153	.	A	G	9	0	9	0	12	21	0	0
17	23986585	.	T	C	13	15	28	0	1	29	0	0
17	24111400	.	G	A	0	3	3	0	3	6	0	0
17	24182184	.	T	A	5	2	7	0	0	7	0	0
17	24186029	.	C	T	6	6	12	0	0	12	0	0
17	24186042	.	T	C	5	5	10	0	0	10	0	0
17	24222649	.	G	A	9	6	15	0	1	16	0	0
17	24222730	.	T	A	10	9	19	0	0	19	0	0
17	24222752	.	A	T	7	7	14	0	1	15	0	0
17	24222771	.	G	T	9	10	19	0	0	19	0	0
17	24247670	.	G	T	8	7	15	0	0	15	0	0
17	24254467	.	G	A	0	10	10	0	7	17	0	0
17	24268278	.	G	A	11	13	24	0	4	28	0	0
17	24313692	.	G	A	1	2	3	0	0	3	0	0
17	24314068	.	G	A	3	4	7	0	0	7	0	0
17	24314331	.	A	G	11	7	18	0	0	18	0	0
17	24314468	.	A	T	8	5	13	0	0	13	0	0
17	24314986	.	G	A	1	11	12	0	9	21	0	0
17	24319071	.	A	C	3	10	13	0	0	13	0	0
17	24339217	.	G	T	2	2	4	0	0	4	0	0
17	24364368	.	G	A	4	3	7	0	0	7	0	0
17	24439623	.	T	A	1	2	3	0	1	4	0	0
17	24442526	.	G	A	1	6	7	0	5	12	0	0
17	24443182	.	G	C	4	2	6	0	2	8	0	0
17	24444239	.	T	G	2	13	15	0	1	16	0	0
17	24452168	.	A	G	4	3	7	0	0	7	0	0
17	24463526	.	G	A	4	7	11	1	0	12	0	0
17	24464939	.	A	C	11	6	17	0	2	19	0	0
17	24464987	.	A	T	6	14	20	0	0	21	1	0
17	24469255	.	G	A	7	8	15	0	0	15	0	0
17	24469752	.	A	C	18	15	33	0	1	34	0	0
17	24470146	.	C	A	17	18	35	0	0	35	0	0
17	24470875	.	G	T	0	2	2	0	3	5	0	0
17	24484184	.	T	A	3	4	7	0	0	7	0	0
17	24484202	.	G	T	4	2	6	0	0	6	0	0
17	24537442	.	G	T	2	4	6	0	1	7	0	0
17	24537450	.	T	A	2	5	7	0	1	8	0	0
17	24550541	.	G	A	2	2	4	0	0	4	0	0
17	24551263	.	C	T	2	3	5	0	0	5	0	0
17	24576885	.	G	A	4	2	6	0	1	7	0	0
17	24576898	.	T	C	2	1	3	0	2	5	0	0
17	24579134	.	A	C	3	0	3	0	6	9	0	0
17	24579158	.	T	C	1	4	5	0	2	7	0	0
17	24579293	.	T	C	1	6	7	0	0	7	0	0
17	24599488	.	C	G	3	2	5	0	1	6	0	0
17	24599509	.	T	G	3	2	5	0	0	5	0	0
17	24599746	.	C	A	3	4	7	0	0	7	0	0
17	24600150	.	A	C	4	2	6	0	0	6	0	0
17	24600595	.	G	A	0	4	4	0	4	8	0	0
17	24600767	.	G	A	4	4	8	0	2	10	0	0
17	24600976	.	G	A	6	4	10	0	1	11	0	0
17	24601072	.	G	A	0	7	7	0	6	13	0	0
17	24601579	.	T	A	12	16	28	0	0	28	0	0
17	24601924	.	C	T	8	15	23	0	1	24	0	0
17	24612661	.	G	T	7	8	15	0	0	15	0	0
17	24612726	.	A	G	5	10	15	0	2	17	0	0
17	24614468	.	C	T	32	16	48	0	6	54	0	0
17	24615181	.	C	T	4	2	6	0	1	7	0	0
17	24615205	.	A	G	9	12	21	0	1	22	0	0
17	24617888	.	C	A	10	25	35	0	1	36	0	0
17	24618912	.	C	T	8	7	15	0	1	16	0	0
17	24618945	.	C	T	7	6	13	0	0	13	0	0
17	24619650	.	A	G	2	4	6	0	0	6	0	0
17	24619693	.	A	G	5	0	5	0	9	14	0	0
17	24622623	.	G	T	15	15	30	0	2	32	0	0
17	24622644	.	G	A	14	11	25	0	2	27	0	0
17	24624477	.	G	C	3	2	5	0	0	5	0	0
17	24624646	.	A	G	2	2	4	0	0	4	0	0
17	24624673	.	A	G	2	2	4	0	1	5	0	0
17	24644783	.	G	A	1	2	3	0	2	5	0	0
17	24672060	.	C	A	1	3	4	0	0	4	0	0
17	24685850	.	C	T	6	12	18	0	0	18	0	0
17	24686352	.	C	T	4	9	13	0	1	14	0	0
17	24686443	.	A	T	3	5	8	0	0	8	0	0
17	24686511	.	G	A	1	3	4	0	1	5	0	0
17	24686574	.	A	G	1	2	3	0	0	3	0	0
17	24686575	.	C	G	1	2	3	0	0	3	0	0
17	24686644	.	G	A	3	3	6	0	0	6	0	0
17	24686651	.	G	T	0	3	3	0	3	6	0	0
17	24687392	.	C	A	1	3	4	0	0	4	0	0
17	24687602	.	G	C	2	6	8	0	0	8	0	0
17	24687693	.	G	T	2	2	4	0	0	4	0	0
17	24690050	.	G	A	1	5	6	0	1	7	0	0
17	24690119	.	C	T	6	3	9	0	1	10	0	0
17	24690615	.	G	A	8	8	16	0	0	16	0	0
17	24691987	.	C	T	8	6	14	0	1	15	0	0
17	24692030	.	A	C	3	3	6	0	0	6	0	0
17	24693207	.	T	C	5	13	18	0	1	19	0	0
17	24694145	.	A	G	9	8	17	0	1	18	0	0
17	24694573	.	T	A	6	3	9	0	0	9	0	0
17	24694664	.	C	A	4	2	6	0	2	8	0	0
17	24694695	.	G	A	1	3	4	0	2	6	0	0
17	24694742	.	C	A	1	3	4	0	1	5	0	0
17	24694877	.	C	G	4	4	8	0	0	8	0	0
17	24695096	.	C	A	6	2	8	0	0	8	0	0
17	24695683	.	T	A	6	9	15	0	4	19	0	0
17	24695743	.	G	A	11	15	26	0	1	27	0	0
17	24695815	.	G	C	12	0	12	0	7	19	0	0
17	24695968	.	G	C	10	10	20	0	0	20	0	0
17	24696047	.	G	T	17	10	27	0	3	30	0	0
17	24696142	.	A	C	7	5	12	0	2	14	0	0
17	24696274	.	T	C	5	4	9	0	1	10	0	0
17	24696658	.	C	A	14	4	18	0	1	19	0	0
17	24696716	.	A	G	13	9	22	0	3	25	0	0
17	24699483	.	G	A	6	10	16	0	0	16	0	0
17	24701496	.	C	T	4	4	8	0	0	8	0	0
17	24709204	.	C	T	8	16	24	0	0	24	0	0
17	24709292	.	T	C	5	0	5	0	4	9	0	0
17	24709443	.	T	G	2	8	10	0	0	10	0	0
17	24709730	.	A	T	3	4	7	0	0	7	0	0
17	24709757	.	G	T	2	4	6	0	0	6	0	0
17	24712929	.	C	T	5	6	11	0	1	12	0	0
17	24712985	.	C	T	0	3	3	0	8	11	0	0
17	24715189	.	A	G	6	4	10	0	1	11	0	0
17	24720964	.	G	C	5	9	14	0	0	14	0	0
17	24721345	.	G	A	6	6	12	0	3	15	0	0
17	24721378	.	C	A	6	10	16	0	1	17	0	0
17	24721384	.	G	A	7	10	17	0	2	19	0	0
17	24721462	.	G	A	0	8	8	0	4	12	0	0
17	24722402	.	C	T	6	9	15	0	0	15	0	0
17	24722441	.	A	G	7	4	11	0	2	13	0	0
17	24725877	.	C	A	14	18	32	0	0	32	0	0
17	24726035	.	A	T	16	10	26	0	0	26	0	0
17	24726134	.	A	G	10	1	11	0	10	21	0	0
17	24726239	.	G	T	17	9	26	0	1	27	0	0
17	24726276	.	A	G	9	13	22	0	0	22	0	0
17	24726533	.	T	A	13	10	23	0	2	25	0	0
17	24726585	.	C	T	14	12	26	0	2	28	0	0
17	24726613	.	G	A	8	15	23	0	2	25	0	0
17	24726637	.	A	G	12	11	23	0	2	25	0	0
17	24726737	.	T	C	16	14	30	0	0	30	0	0
17	24726753	.	G	A	14	13	27	0	2	29	0	0
17	24726996	.	A	G	13	11	24	0	2	26	0	0
17	24727037	.	C	T	12	11	23	0	2	25	0	0
17	24727130	.	T	G	12	0	12	0	8	20	0	0
17	24727186	.	C	G	9	11	20	0	0	20	0	0
17	24747328	.	A	C	2	2	4	0	0	4	0	0
17	24787248	.	G	A	5	6	11	0	1	12	0	0
17	24787736	.	C	A	3	3	6	0	1	7	0	0
17	24787774	.	A	T	3	5	8	0	0	8	0	0
17	24817636	.	A	G	1	2	3	0	1	4	0	0
17	24820044	.	C	T	1	5	6	0	2	8	0	0
17	24820052	.	T	C	2	6	8	0	0	8	0	0
17	24820134	.	T	C	2	3	5	0	0	5	0	0
17	24820136	.	G	C	2	3	5	0	0	5	0	0
17	24820469	.	T	C	3	2	5	0	0	5	0	0
17	24820502	.	G	T	3	2	5	0	0	5	0	0
17	24820559	.	C	T	1	3	4	0	0	4	0	0
17	24820587	.	C	T	2	2	4	0	0	4	0	0
17	24820683	.	T	A	5	2	7	0	1	8	0	0
17	24821697	.	T	C	7	8	15	0	0	15	0	0
17	24821720	.	G	A	4	4	8	0	0	8	0	0
17	24834743	.	C	T	8	12	20	0	1	21	0	0
17	24835158	.	A	T	7	16	23	0	1	24	0	0
17	24835251	.	G	C	12	8	20	0	1	21	0	0
17	24835547	.	A	T	5	5	10	0	0	10	0	0
17	24855813	.	T	C	2	1	3	0	1	4	0	0
17	24855867	.	T	G	9	5	14	1	2	17	0	0
17	24856019	.	G	A	15	20	35	0	0	35	0	0
17	24856088	.	C	G	14	17	31	0	2	33	0	0
17	24856648	.	G	T	8	7	15	0	1	16	0	0
17	24861176	.	C	T	0	10	10	0	11	21	0	0
17	24861252	.	G	A	11	7	18	0	2	20	0	0
17	24861558	.	A	G	5	11	16	0	2	18	0	0
17	24866585	.	G	T	2	5	7	0	0	7	0	0
17	24869963	.	G	A	5	2	7	0	0	7	0	0
17	24872642	.	G	A	10	5	15	0	0	15	0	0
17	24872714	.	T	A	7	5	12	0	0	12	0	0
17	24874327	.	C	A	4	4	8	0	0	8	0	0
17	24874342	.	T	C	2	3	5	0	1	6	0	0
17	24884394	.	A	G	4	5	9	0	0	9	0	0
17	24887118	.	T	C	3	4	7	0	0	7	0	0
17	24887419	.	G	A	2	2	4	0	0	4	0	0
17	24926623	.	G	A	4	3	7	0	0	7	0	0
17	24926748	.	G	C	2	3	5	0	0	5	0	0
17	25125576	.	A	G	3	0	3	0	2	5	0	0
17	25140974	.	C	T	2	2	4	0	0	4	0	0
17	25155779	.	C	T	1	2	3	0	0	3	0	0
17	25167346	.	G	A	2	3	5	0	0	5	0	0
17	25173643	.	A	G	4	0	4	0	7	11	0	0
17	25173803	.	T	C	2	2	4	0	0	4	0	0
17	25173899	.	A	T	1	3	4	0	1	5	0	0
17	25175072	.	C	T	1	4	5	0	0	5	0	0
17	25175100	.	T	A	2	3	5	0	0	5	0	0
17	25289571	.	C	A	8	4	12	0	1	13	0	0
17	25289889	.	C	T	4	2	6	0	0	6	0	0
17	25289905	.	A	G	4	2	6	0	0	6	0	0
17	25289930	.	A	T	6	2	8	0	2	10	0	0
17	25290396	.	C	T	7	6	13	0	0	13	0	0
17	25290481	.	G	A	1	7	8	0	6	14	0	0
17	25290657	.	C	T	5	8	13	0	0	13	0	0
17	25291068	.	A	G	7	0	7	0	6	13	0	0
17	25297908	.	C	T	5	4	9	0	0	9	0	0
17	25298003	.	T	G	2	6	8	0	0	8	0	0
17	25302891	.	G	A	2	5	7	0	0	7	0	0
17	25302909	.	G	A	5	8	13	0	0	13	0	0
17	25305778	.	C	T	3	2	5	0	1	6	0	0
17	25306107	.	G	A	2	8	10	0	0	10	0	0
17	25311113	.	A	T	1	1	2	0	1	3	0	0
17	25336507	.	T	C	2	3	5	0	1	6	0	0
17	25337466	.	C	T	4	3	7	0	0	7	0	0
17	25341745	.	T	A	1	2	3	0	0	3	0	0
17	25341751	.	A	C	1	2	3	0	0	3	0	0
17	25341932	.	C	G	2	3	5	0	0	5	0	0
17	25341977	.	A	T	6	3	9	0	0	9	0	0
17	25342003	.	T	A	3	5	8	0	0	8	0	0
17	25392917	.	G	A	5	4	9	0	0	9	0	0
17	25393034	.	A	C	5	5	10	0	1	11	0	0
17	25393073	.	C	T	2	6	8	0	5	13	0	0
17	25395198	.	G	C	2	2	4	0	0	4	0	0
17	25395199	.	C	A	2	2	4	0	0	4	0	0
17	25412090	.	C	T	1	5	6	0	0	6	0	0
17	25412123	.	T	C	1	4	5	0	0	5	0	0
17	25412133	.	G	A	1	3	4	0	2	6	0	0
17	25418707	.	T	G	1	4	5	0	1	6	0	0
17	25420065	.	T	C	2	2	4	0	0	4	0	0
17	25420151	.	A	G	6	8	14	0	2	16	0	0
17	25420236	.	A	C	12	2	14	0	1	15	0	0
17	25420937	.	C	T	10	6	16	0	0	16	0	0
17	25424205	.	C	A	10	9	19	0	1	20	0	0
17	25424239	.	C	T	9	6	15	2	0	17	0	0
17	25424296	.	T	C	12	5	17	0	0	17	0	0
17	25424330	.	T	A	8	11	19	0	3	22	0	0
17	25424331	.	C	A	10	10	20	0	2	22	0	0
17	25424462	.	G	T	9	9	18	0	0	18	0	0
17	25424568	.	A	G	7	12	19	0	5	24	0	0
17	25424597	.	C	T	10	16	26	0	0	26	0	0
17	25424664	.	G	A	17	13	30	0	2	32	0	0
17	25424770	.	G	A	1	6	7	0	9	16	0	0
17	25424771	.	A	G	10	6	16	0	0	16	0	0
17	25425081	.	G	T	3	7	10	0	0	10	0	0
17	25425094	.	A	G	3	9	12	0	0	12	0	0
17	25425146	.	T	A	13	8	21	0	2	23	0	0
17	25431447	.	C	T	3	3	6	0	0	6	0	0
17	25431492	.	G	A	3	2	5	0	0	5	0	0
17	25431493	.	A	T	3	2	5	0	0	5	0	0
17	25434250	.	G	T	12	18	30	0	1	31	0	0
17	25435992	.	A	G	18	26	44	0	4	48	0	0
17	25436073	.	T	C	30	23	53	0	5	58	0	0
17	25436591	.	A	T	18	22	40	0	2	42	0	0
17	25437384	.	A	G	22	0	22	0	25	47	0	0
17	25439909	.	G	A	27	24	51	0	2	53	0	0
17	25439949	.	C	T	24	23	47	1	1	49	0	0
17	25439950	.	C	A	24	24	48	1	0	49	0	0
17	25444580	.	T	A	3	2	5	0	1	6	0	0
17	25474261	.	C	T	3	3	6	0	0	6	0	0
17	25478710	.	A	G	4	2	6	0	0	6	0	0
17	25478896	.	C	T	6	2	8	0	0	8	0	0
17	25478897	.	T	G	6	2	8	0	0	8	0	0
17	25479147	.	T	A	5	3	8	0	0	8	0	0
17	25479151	.	A	C	5	1	6	0	0	6	0	0
17	25479240	.	C	T	5	2	7	0	0	7	0	0
17	25479594	.	T	A	4	8	12	0	0	13	1	0
17	25479640	.	A	G	12	13	25	0	1	26	0	0
17	25479792	.	G	A	21	8	29	0	1	30	0	0
17	25479874	.	T	A	13	12	25	0	0	25	0	0
17	25479920	.	A	G	12	8	20	0	1	21	0	0
17	25479980	.	C	T	7	6	13	0	2	15	0	0
17	25549056	.	T	C	1	2	3	0	0	3	0	0
17	25549372	.	G	T	1	4	5	0	1	6	0	0
17	25549557	.	T	C	2	4	6	0	0	6	0	0
17	25549574	.	C	T	2	3	5	0	0	5	0	0
17	25549724	.	G	A	1	3	4	0	0	4	0	0
17	25549727	.	A	G	1	2	3	0	0	3	0	0
17	25550271	.	G	A	2	2	4	0	0	4	0	0
17	25550449	.	G	A	5	5	10	0	0	10	0	0
17	25550450	.	G	A	5	5	10	0	0	10	0	0
17	25559491	.	A	G	6	5	11	0	0	11	0	0
17	25562160	.	A	G	3	6	9	0	0	9	0	0
17	25562198	.	G	T	7	5	12	0	0	12	0	0
17	25563542	.	G	A	7	3	10	0	0	10	0	0
17	25563738	.	G	A	4	2	6	0	0	6	0	0
17	25563843	.	A	T	1	2	3	0	0	3	0	0
17	25565040	.	C	T	1	3	4	0	0	4	0	0
17	25565058	.	G	A	1	3	4	0	0	4	0	0
17	25565267	.	A	G	1	3	4	0	0	4	0	0
17	25565938	.	G	T	1	4	5	0	0	5	0	0
17	25585686	.	C	T	6	2	8	0	1	9	0	0
17	25585750	.	G	T	4	9	13	0	0	13	0	0
17	25585755	.	A	C	3	7	10	0	1	11	0	0
17	25593557	.	G	A	2	2	4	0	0	4	0	0
17	25593566	.	A	G	2	2	4	0	0	4	0	0
17	25593945	.	G	A	1	3	4	0	1	5	0	0
17	25600129	.	A	C	4	5	9	0	0	9	0	0
17	25600571	.	G	A	3	3	6	0	0	6	0	0
17	25602744	.	C	T	3	5	8	0	0	8	0	0
17	25606154	.	G	A	1	8	9	1	17	27	0	0
17	25606161	.	C	T	13	10	23	1	3	27	0	0
17	25606421	.	T	A	13	8	21	0	0	21	0	0
17	25607051	.	T	C	1	2	3	0	0	3	0	0
17	25607094	.	G	C	1	0	1	0	3	4	0	0
17	25610895	.	G	T	10	12	22	0	1	23	0	0
17	25610975	.	C	T	1	7	8	0	6	14	0	0
17	25610989	.	C	T	6	8	14	0	2	16	0	0
17	25611011	.	A	G	5	11	16	0	0	16	0	0
17	25611067	.	A	C	7	11	18	0	0	18	0	0
17	25611091	.	C	A	1	7	8	0	8	16	0	0
17	25612941	.	G	C	9	13	22	0	1	24	1	0
17	25612978	.	G	A	12	11	23	0	0	23	0	0
17	25615493	.	A	G	3	5	8	0	1	9	0	0
17	25615609	.	T	A	5	4	9	0	0	9	0	0
17	25616374	.	C	T	4	4	8	0	0	8	0	0
17	25617760	.	G	T	3	2	5	0	1	6	0	0
17	25617950	.	G	T	5	6	11	0	0	11	0	0
17	25617967	.	T	A	5	4	9	0	0	9	0	0
17	25618850	.	G	T	7	3	10	0	0	10	0	0
17	25621178	.	C	T	2	2	4	0	0	4	0	0
17	25636167	.	G	A	30	22	52	0	2	54	0	0
17	25636381	.	C	T	6	22	28	0	41	69	0	0
17	25636412	.	A	G	44	22	66	0	5	71	0	0
17	25636539	.	T	C	37	2	39	0	36	75	0	0
17	25636594	.	C	T	13	34	47	0	31	78	0	0
17	25636679	.	C	T	1	28	29	0	38	67	0	0
17	25637106	.	A	C	33	27	60	0	5	65	0	0
17	25637676	.	T	C	24	0	24	0	30	54	0	0
17	25640476	.	G	A	16	18	34	0	3	37	0	0
17	25858581	.	G	T	1	2	3	0	0	3	0	0
17	25877694	.	G	A	0	3	3	0	2	5	0	0
17	25885012	.	T	G	1	2	3	0	0	3	0	0
17	25885415	.	T	A	5	8	13	0	3	16	0	0
17	25885418	.	C	G	4	10	14	0	1	15	0	0
17	26298967	.	C	T	1	2	3	0	0	3	0	0
17	26325286	.	C	T	2	1	3	0	1	4	0	0
17	26335000	.	G	A	8	2	10	0	0	10	0	0
17	26346175	.	T	A	4	8	12	0	0	12	0	0
17	26362130	.	G	A	6	5	11	0	1	12	0	0
17	26362500	.	C	T	7	5	12	0	0	12	0	0
17	26362512	.	A	C	6	8	14	0	0	14	0	0
17	26362539	.	C	T	4	9	13	0	1	14	0	0
17	26362741	.	C	T	5	3	8	0	0	8	0	0
17	26477743	.	A	C	8	3	11	0	3	14	0	0
17	26477747	.	T	A	5	5	10	0	2	12	0	0
17	26477795	.	A	C	8	5	13	0	1	14	0	0
17	26477808	.	G	T	9	6	15	0	0	15	0	0
17	26477857	.	T	C	8	18	26	0	2	28	0	0
17	26477860	.	C	T	8	20	28	0	0	28	0	0
17	26478023	.	T	C	12	8	20	0	0	20	0	0
17	26478403	.	T	G	7	11	18	0	3	21	0	0
17	26478592	.	A	G	7	14	21	0	2	23	0	0
17	26478818	.	T	C	16	0	16	0	17	33	0	0
17	26478837	.	A	C	0	2	2	0	2	4	0	0
17	26478952	.	G	A	18	10	28	0	1	29	0	0
17	26478986	.	A	G	10	13	23	0	1	24	0	0
17	26479063	.	A	G	7	9	16	0	2	18	0	0
17	26479145	.	T	C	13	15	28	0	0	28	0	0
17	26479916	.	G	T	3	4	7	0	0	7	0	0
17	26479997	.	A	T	2	1	3	0	1	4	0	0
17	26480086	.	G	T	2	5	7	0	0	7	0	0
17	26480250	.	A	C	1	3	4	0	0	4	0	0
17	26480254	.	G	A	1	2	3	0	0	3	0	0
17	26480421	.	A	G	5	8	13	0	0	13	0	0
17	26480423	.	T	C	5	8	13	0	0	13	0	0
17	26480622	.	A	T	8	4	12	0	1	13	0	0
17	26480683	.	A	G	4	5	9	0	0	9	0	0
17	26480926	.	T	G	3	4	7	0	0	7	0	0
17	26502013	.	A	G	1	3	4	0	0	4	0	0
17	26502107	.	G	A	3	5	8	0	0	8	0	0
17	26516748	.	G	C	1	4	5	0	0	5	0	0
17	26516868	.	A	G	0	3	3	0	0	3	0	0
17	26516878	.	G	A	2	2	4	0	0	4	0	0
17	26585135	.	G	T	2	4	6	0	1	7	0	0
17	26585163	.	A	T	4	3	7	0	0	7	0	0
17	26585727	.	C	T	8	10	18	0	0	18	0	0
17	26585748	.	A	G	13	0	13	0	7	20	0	0
17	26585763	.	T	A	12	12	24	0	0	24	0	0
17	26590001	.	T	G	15	5	20	0	3	23	0	0
17	26590054	.	C	T	10	5	15	0	2	17	0	0
17	26590091	.	C	T	7	5	12	0	0	12	0	0
17	26590170	.	A	T	6	4	10	0	1	11	0	0
17	26590330	.	T	C	6	4	10	0	1	11	0	0
17	26590495	.	A	G	2	6	8	0	0	8	0	0
17	26590536	.	G	A	2	4	6	0	0	6	0	0
17	26590650	.	G	T	6	5	11	0	0	11	0	0
17	26594931	.	C	T	8	6	14	0	0	14	0	0
17	26594968	.	G	C	4	5	9	0	0	9	0	0
17	26599208	.	C	T	0	6	6	0	6	12	0	0
17	26600555	.	T	A	3	3	6	0	0	6	0	0
17	26600639	.	G	A	3	5	8	0	0	8	0	0
17	26600667	.	C	T	2	5	7	0	0	7	0	0
17	26600877	.	T	G	0	3	3	0	1	4	0	0
17	26600881	.	G	A	2	3	5	0	1	6	0	0
17	26603369	.	A	T	4	5	9	0	0	9	0	0
17	26604751	.	G	C	4	3	7	0	0	7	0	0
17	26604758	.	C	T	5	3	8	0	0	8	0	0
17	26604801	.	C	A	2	1	3	0	1	4	0	0
17	26639659	.	C	T	4	5	9	0	0	9	0	0
17	26639725	.	A	G	4	0	4	0	4	8	0	0
17	26642775	.	C	A	4	3	7	0	1	8	0	0
17	26642817	.	T	G	2	0	2	0	6	8	0	0
17	26642818	.	T	C	3	5	8	0	0	8	0	0
17	26657852	.	T	C	7	11	18	1	2	21	0	0
17	26662347	.	C	T	8	7	15	0	0	15	0	0
17	26683466	.	T	C	13	8	21	0	4	25	0	0
17	26683526	.	C	T	25	13	38	0	0	38	0	0
17	26689753	.	G	A	14	19	33	0	11	44	0	0
17	26689768	.	C	A	32	8	40	0	2	42	0	0
17	26689792	.	C	A	6	29	35	0	2	37	0	0
17	26690112	.	T	A	24	11	35	0	1	36	0	0
17	26690250	.	C	T	10	7	17	1	0	18	0	0
17	26690276	.	C	T	11	12	23	0	0	23	0	0
17	26690478	.	C	T	5	18	23	0	0	23	0	0
17	26690558	.	G	A	2	12	14	0	18	32	0	0
17	26714009	.	C	T	42	28	70	0	4	74	0	0
17	26741362	.	A	G	1	0	1	0	2	3	0	0
17	26744207	.	G	C	2	2	4	0	0	4	0	0
17	26744489	.	G	A	2	2	4	0	0	4	0	0
17	26744840	.	A	G	2	2	4	0	0	4	0	0
17	26744981	.	C	T	3	2	5	0	2	7	0	0
17	26745106	.	T	C	1	1	2	0	1	3	0	0
17	26745110	.	C	T	2	3	5	0	0	5	0	0
17	26747348	.	A	G	1	2	3	0	0	3	0	0
17	26747552	.	G	C	4	4	8	0	0	8	0	0
17	26750125	.	T	C	2	2	4	0	0	4	0	0
17	26810380	.	C	T	19	21	40	0	1	41	0	0
17	26813285	.	T	C	10	25	35	1	3	39	0	0
17	26831861	.	G	A	3	2	5	0	0	5	0	0
17	26832713	.	C	T	1	3	4	0	1	5	0	0
17	26832738	.	A	G	1	3	4	0	1	5	0	0
17	26846203	.	C	T	11	9	20	0	0	20	0	0
17	26846650	.	G	A	9	4	13	0	4	17	0	0
17	26846707	.	G	A	1	5	6	0	5	11	0	0
17	26846901	.	T	G	6	15	21	0	0	21	0	0
17	26879854	.	A	C	13	16	29	0	2	31	0	0
17	26879869	.	A	G	17	11	28	0	1	29	0	0
17	26879893	.	A	G	20	21	41	0	1	42	0	0
17	26880107	.	G	A	21	17	38	0	3	41	0	0
17	26880231	.	T	C	34	20	54	1	1	56	0	0
17	26880424	.	T	C	28	25	53	0	4	57	0	0
17	26880926	.	T	C	22	4	26	0	19	45	0	0
17	26880964	.	A	G	28	24	52	0	6	58	0	0
17	26881131	.	T	A	25	15	40	0	2	42	0	0
17	26881354	.	A	G	15	24	39	0	2	41	0	0
17	26881777	.	A	G	17	19	36	3	3	42	0	0
17	26911747	.	A	G	9	8	17	0	2	19	0	0
17	26926548	.	G	A	1	3	4	0	0	4	0	0
17	26928727	.	T	C	1	4	5	0	1	6	0	0
17	26928737	.	A	G	1	5	6	0	1	7	0	0
17	26928765	.	C	T	3	6	9	0	0	9	0	0
17	26929475	.	T	C	4	5	9	0	0	9	0	0
17	26929577	.	C	A	6	5	11	0	1	12	0	0
17	26929649	.	A	G	5	4	9	0	0	9	0	0
17	26929654	.	T	A	4	4	8	0	0	8	0	0
17	26929893	.	G	A	9	3	12	0	1	13	0	0
17	26933223	.	A	G	1	5	6	0	1	7	0	0
17	26934417	.	C	T	0	3	3	0	4	7	0	0
17	26935254	.	G	T	4	3	7	0	1	8	0	0
17	26935274	.	G	T	4	2	6	0	1	7	0	0
17	26985158	.	G	A	1	6	7	0	9	16	0	0
17	26985544	.	T	A	3	7	10	0	1	11	0	0
17	26985586	.	C	T	2	9	11	0	1	12	0	0
17	26985638	.	T	G	5	6	11	0	1	12	0	0
17	26985656	.	T	A	6	7	13	0	1	14	0	0
17	26985692	.	G	T	6	9	15	0	0	15	0	0
17	27064840	.	G	C	1	2	3	0	0	3	0	0
17	27154580	.	C	A	2	2	4	0	0	4	0	0
17	27154695	.	A	G	1	2	3	0	1	4	0	0
17	27158692	.	C	T	3	3	6	0	0	6	0	0
17	27160912	.	G	A	4	2	6	0	1	7	0	0
17	27164530	.	C	T	3	3	6	0	0	6	0	0
17	27166221	.	T	C	3	3	6	0	0	6	0	0
17	27166257	.	T	C	1	2	3	0	0	3	0	0
17	27166521	.	C	T	4	3	7	0	0	7	0	0
17	27168957	.	G	T	1	5	6	0	7	13	0	0
17	27169561	.	T	G	4	10	14	2	0	16	0	0
17	27169783	.	A	C	3	5	8	0	2	10	0	0
17	27170017	.	G	A	4	6	10	0	10	20	0	0
17	27170153	.	A	T	5	4	9	0	3	12	0	0
17	27170390	.	G	T	3	2	5	0	0	5	0	0
17	27170516	.	G	A	0	3	3	0	10	13	0	0
17	27170549	.	G	A	6	6	12	0	0	12	0	0
17	27170605	.	T	G	5	10	15	0	1	16	0	0
17	27170678	.	C	A	7	8	15	0	2	17	0	0
17	27170730	.	T	G	5	13	18	0	1	19	0	0
17	27170746	.	A	T	4	15	19	0	0	19	0	0
17	27171314	.	A	C	5	5	10	0	0	10	0	0
17	27176967	.	G	C	2	2	4	0	0	4	0	0
17	27177064	.	C	T	1	3	4	0	0	4	0	0
17	27177083	.	G	A	0	3	3	0	1	4	0	0
17	27177251	.	A	G	2	2	4	0	0	4	0	0
17	27177302	.	A	G	1	0	1	0	2	3	0	0
17	27177864	.	C	T	2	5	7	0	0	7	0	0
17	27178024	.	T	A	3	3	6	0	0	6	0	0
17	27178088	.	T	A	1	2	3	0	0	3	0	0
17	27178191	.	G	A	2	2	4	0	0	4	0	0
17	27178232	.	A	G	2	3	5	0	0	5	0	0
17	27178273	.	G	T	2	2	4	0	0	4	0	0
17	27178356	.	T	A	3	2	5	0	1	6	0	0
17	27178383	.	C	G	3	4	7	0	0	7	0	0
17	27178401	.	C	T	4	2	6	0	1	7	0	0
17	27178557	.	C	T	1	6	7	0	0	7	0	0
17	27178638	.	C	G	3	4	7	0	0	7	0	0
17	27178730	.	C	A	1	2	3	0	0	3	0	0
17	27178870	.	T	C	2	3	5	0	0	5	0	0
17	27179189	.	A	G	2	4	6	0	1	7	0	0
17	27179203	.	G	T	0	2	2	0	1	3	0	0
17	27179848	.	A	G	3	2	5	0	0	5	0	0
17	27180407	.	T	A	7	4	11	0	0	11	0	0
17	27180447	.	A	T	2	5	7	0	1	8	0	0
17	27180847	.	A	G	1	5	6	0	0	6	0	0
17	27181021	.	T	C	7	8	15	0	0	15	0	0
17	27181048	.	C	G	7	10	17	0	0	17	0	0
17	27181129	.	G	A	15	6	21	0	0	21	0	0
17	27181130	.	G	A	15	6	21	0	0	21	0	0
17	27181257	.	A	C	8	13	21	0	0	21	0	0
17	27181323	.	A	G	16	0	16	0	10	26	0	0
17	27181411	.	A	G	10	0	10	0	8	18	0	0
17	27181427	.	C	T	8	5	13	0	0	13	0	0
17	27181618	.	C	A	3	3	6	0	0	6	0	0
17	27181680	.	C	T	4	3	7	0	1	8	0	0
17	27182039	.	T	C	16	8	24	0	0	24	0	0
17	27182114	.	A	G	4	6	10	0	1	11	0	0
17	27182146	.	C	T	5	6	11	0	2	13	0	0
17	27182331	.	T	G	4	4	8	0	0	8	0	0
17	27182340	.	C	T	4	4	8	0	0	8	0	0
17	27182449	.	G	T	5	8	13	0	1	14	0	0
17	27182484	.	T	C	7	12	19	0	0	19	0	0
17	27182645	.	G	T	11	16	27	0	0	27	0	0
17	27182649	.	A	G	11	16	27	0	1	28	0	0
17	27182769	.	A	G	9	10	19	0	0	19	0	0
17	27182894	.	T	C	10	11	21	0	1	22	0	0
17	27182925	.	A	T	8	11	19	0	1	20	0	0
17	27182979	.	C	T	9	7	16	0	0	16	0	0
17	27183219	.	G	T	7	2	9	0	0	9	0	0
17	27192033	.	G	C	1	3	4	0	0	4	0	0
17	27192048	.	G	A	1	3	4	0	0	4	0	0
17	27192698	.	C	T	1	3	4	0	1	5	0	0
17	27194087	.	G	A	2	3	5	0	0	5	0	0
17	27194168	.	A	G	5	4	9	0	0	9	0	0
17	27194183	.	A	G	3	3	6	0	2	8	0	0
17	27272913	.	T	C	9	3	12	0	1	13	0	0
17	27401038	.	A	T	10	5	15	0	5	20	0	0
17	27401304	.	C	T	2	1	3	0	3	6	0	0
17	27408386	.	A	G	10	14	24	0	3	27	0	0
17	27408472	.	C	T	11	15	26	0	6	32	0	0
17	27408836	.	T	G	4	13	17	1	3	21	0	0
17	27408889	.	T	C	8	14	22	1	1	24	0	0
17	27413564	.	T	C	12	10	22	0	4	26	0	0
17	27413705	.	T	C	8	9	17	0	0	17	0	0
17	27414035	.	G	A	6	3	9	0	1	10	0	0
17	27414098	.	C	A	8	8	16	0	0	16	0	0
17	27414203	.	G	A	6	10	16	0	0	16	0	0
17	27414215	.	C	T	0	8	8	0	9	17	0	0
17	27414367	.	A	G	15	4	19	0	0	19	0	0
17	27414658	.	T	C	5	6	11	0	1	12	0	0
17	27414701	.	A	G	3	4	7	0	1	8	0	0
17	27414791	.	A	G	6	5	11	0	0	11	0	0
17	27414815	.	G	A	7	6	13	0	0	13	0	0
17	27415010	.	C	T	0	5	5	0	2	7	0	0
17	27447193	.	C	T	1	2	3	0	0	3	0	0
17	27723800	.	G	T	6	7	13	0	0	13	0	0
17	27807455	.	T	C	13	14	27	0	0	27	0	0
17	27808190	.	A	G	6	0	6	0	8	14	0	0
17	27808335	.	A	G	16	8	24	0	3	27	0	0
17	27808686	.	G	A	4	5	9	0	0	9	0	0
17	27808700	.	G	A	4	7	11	0	0	11	0	0
17	27808987	.	G	T	2	25	27	0	22	49	0	0
17	27809548	.	T	A	16	10	26	0	0	26	0	0
17	27809631	.	G	T	0	5	5	0	13	18	0	0
17	27809779	.	C	A	24	18	42	0	1	43	0	0
17	27809885	.	A	G	20	20	40	0	3	43	0	0
17	27811199	.	T	A	11	4	15	0	0	15	0	0
17	27811209	.	A	G	12	4	16	0	1	17	0	0
17	27811277	.	C	G	9	4	13	0	0	13	0	0
17	27812525	.	A	C	18	10	28	0	1	29	0	0
17	27812562	.	G	A	3	11	14	0	18	32	0	0
17	27812702	.	A	T	17	8	25	1	2	28	0	0
17	27812780	.	T	A	5	3	8	0	0	8	0	0
17	27812789	.	A	G	5	1	6	0	2	8	0	0
17	27812885	.	C	T	6	2	8	0	0	8	0	0
17	27813221	.	C	T	18	9	27	0	1	28	0	0
17	27813222	.	A	G	19	9	28	0	0	28	0	0
17	27813549	.	C	G	9	5	14	0	1	15	0	0
17	27813553	.	C	G	8	5	13	0	1	14	0	0
17	28049663	.	A	T	3	2	5	0	0	5	0	0
17	28050500	.	T	A	3	3	6	0	1	7	0	0
17	28050530	.	A	G	2	3	5	0	0	5	0	0
17	28051129	.	G	A	2	3	5	0	0	5	0	0
17	28051465	.	T	C	4	2	6	0	0	6	0	0
17	28052322	.	C	A	7	3	10	0	0	10	0	0
17	28067389	.	C	T	4	4	8	0	0	8	0	0
17	28067472	.	A	C	4	9	13	0	2	15	0	0
17	28067618	.	A	G	2	7	9	0	0	9	0	0
17	28067856	.	C	T	5	4	9	0	0	9	0	0
17	28068083	.	T	C	3	3	6	0	0	6	0	0
17	28068087	.	G	T	2	3	5	0	0	6	1	0
17	28068168	.	G	A	3	3	6	0	1	7	0	0
17	28068262	.	T	G	2	0	2	0	4	6	0	0
17	28068276	.	C	T	2	4	6	0	0	6	0	0
17	28068507	.	A	G	3	7	10	0	0	10	0	0
17	28068514	.	T	C	3	8	11	0	0	11	0	0
17	28068916	.	C	T	5	7	12	0	0	12	0	0
17	28069170	.	G	A	11	14	25	0	0	25	0	0
17	28069341	.	G	T	6	12	18	0	1	19	0	0
17	28069342	.	T	C	6	12	18	0	1	19	0	0
17	28069645	.	G	T	11	9	20	0	2	22	0	0
17	28069716	.	G	C	11	18	29	0	1	30	0	0
17	28069787	.	G	A	1	13	14	0	20	34	0	0
17	28070078	.	G	C	10	14	24	0	0	24	0	0
17	28070167	.	C	T	8	14	22	0	0	22	0	0
17	28070284	.	G	A	9	8	17	0	1	18	0	0
17	28070286	.	A	C	7	7	14	0	3	17	0	0
17	28070481	.	T	A	17	14	31	0	0	31	0	0
17	28070600	.	C	A	15	10	25	0	1	26	0	0
17	28070840	.	G	A	10	6	16	0	0	16	0	0
17	28070879	.	T	G	8	7	15	0	0	15	0	0
17	28070897	.	T	A	6	9	15	0	0	15	0	0
17	28071029	.	A	T	4	1	5	0	1	6	0	0
17	28071260	.	A	G	8	8	16	0	1	17	0	0
17	28084592	.	C	T	18	10	28	0	1	29	0	0
17	28084733	.	T	C	19	16	35	5	2	42	0	0
17	28084869	.	A	C	23	24	47	0	2	49	0	0
17	28084996	.	A	T	26	18	44	0	0	44	0	0
17	28097235	.	G	A	11	8	19	0	0	19	0	0
17	28097672	.	T	C	3	10	13	0	2	15	0	0
17	28100598	.	C	T	0	12	12	0	7	19	0	0
17	28166980	.	C	T	5	7	12	0	0	12	0	0
17	28167235	.	T	C	7	0	7	0	10	17	0	0
17	28167439	.	G	A	6	11	17	0	0	17	0	0
17	28168054	.	A	G	6	4	10	0	0	10	0	0
17	28168363	.	G	A	3	2	5	0	1	6	0	0
17	28168366	.	G	A	4	2	6	0	0	6	0	0
17	28408024	.	A	C	2	4	6	0	0	6	0	0
17	28423698	.	T	C	1	3	4	0	0	4	0	0
17	28461857	.	G	A	0	2	2	0	3	5	0	0
17	28497878	.	T	C	10	4	14	0	0	14	0	0
17	28560736	.	T	C	8	9	17	0	1	18	0	0
17	28563725	.	G	A	13	12	25	0	3	28	0	0
17	28657421	.	G	T	4	2	6	0	0	6	0	0
17	28661628	.	C	G	4	0	4	0	3	7	0	0
17	28661931	.	G	T	0	3	3	0	5	8	0	0
17	28668465	.	T	C	10	4	14	0	1	15	0	0
17	28668627	.	C	T	3	4	7	0	0	7	0	0
17	28669185	.	G	A	1	3	4	0	0	4	0	0
17	28669196	.	T	C	1	3	4	0	0	4	0	0
17	28680051	.	C	T	1	3	4	0	0	4	0	0
17	28680634	.	G	A	1	3	4	0	0	4	0	0
17	28695753	.	C	T	6	5	11	0	1	12	0	0
17	28701100	.	G	A	14	9	23	0	0	23	0	0
17	28707268	.	T	A	4	3	7	0	0	7	0	0
17	28724530	.	A	G	5	1	6	0	4	10	0	0
17	28724539	.	A	T	4	4	8	0	0	8	0	0
17	28724833	.	T	C	9	7	16	0	0	16	0	0
17	28725346	.	A	G	3	0	3	0	9	12	0	0
17	28730705	.	C	T	5	7	12	1	0	13	0	0
17	28738387	.	C	T	3	4	7	0	1	8	0	0
17	28738675	.	A	G	8	0	8	0	6	14	0	0
17	28741442	.	G	A	6	11	17	0	0	17	0	0
17	28741467	.	G	A	0	7	7	0	13	20	0	0
17	28741540	.	A	G	8	0	8	0	12	21	1	0
17	28741752	.	C	T	13	7	20	0	1	21	0	0
17	28741934	.	C	T	8	11	19	0	4	23	0	0
17	28742263	.	G	C	16	13	29	0	1	30	0	0
17	28742385	.	T	A	10	10	20	0	1	21	0	0
17	28742505	.	T	G	22	18	40	0	2	42	0	0
17	28742559	.	C	T	24	16	40	0	0	40	0	0
17	28742681	.	C	T	5	8	13	0	0	13	0	0
17	28742755	.	C	A	5	2	7	0	0	7	0	0
17	28771228	.	T	A	8	12	20	0	1	21	0	0
17	28778186	.	C	T	12	8	20	0	0	20	0	0
17	28784090	.	G	T	10	10	20	0	1	21	0	0
17	28785010	.	G	A	8	5	13	0	1	14	0	0
17	28786873	.	G	A	4	10	14	0	1	15	0	0
17	28789014	.	C	T	0	6	6	0	10	16	0	0
17	28948905	.	G	A	3	3	6	0	0	6	0	0
17	28968461	.	T	C	22	15	37	0	1	38	0	0
17	28968969	.	A	G	5	3	8	0	3	11	0	0
17	29117355	.	G	A	6	2	8	0	1	9	0	0
17	29117383	.	G	A	1	3	4	0	0	4	0	0
17	29227594	.	G	A	3	4	7	0	0	7	0	0
17	29227600	.	G	A	2	4	6	0	1	7	0	0
17	29227691	.	T	A	2	3	5	0	0	5	0	0
17	29228114	.	G	A	3	7	10	0	0	10	0	0
17	29228222	.	A	G	2	3	5	0	1	6	0	0
17	29251810	.	G	C	3	6	9	0	0	9	0	0
17	29252043	.	C	T	3	6	9	0	4	13	0	0
17	29252122	.	C	A	7	8	15	0	0	15	0	0
17	29252218	.	C	T	6	5	11	0	0	11	0	0
17	29252254	.	C	T	6	3	9	0	0	9	0	0
17	29252295	.	T	C	7	4	11	0	2	13	0	0
17	29252665	.	G	C	2	2	4	0	0	4	0	0
17	29252754	.	C	G	0	4	4	0	4	8	0	0
17	29270021	.	C	T	0	3	3	0	1	4	0	0
17	29282893	.	A	T	4	5	9	0	0	9	0	0
17	29282901	.	C	A	3	4	7	0	1	8	0	0
17	29283036	.	C	G	0	2	2	0	1	3	0	0
17	29283380	.	T	A	2	6	8	0	1	9	0	0
17	29283866	.	T	C	6	4	10	0	1	11	0	0
17	29283902	.	G	A	3	7	10	0	0	10	0	0
17	29283920	.	A	C	1	0	1	0	5	6	0	0
17	29288057	.	G	T	3	7	10	0	1	11	0	0
17	29288718	.	A	G	6	7	13	0	1	14	0	0
17	29297901	.	A	G	0	2	2	0	1	3	0	0
17	29297907	.	C	A	0	2	2	0	1	3	0	0
17	29298224	.	A	G	2	2	4	0	0	4	0	0
17	29300641	.	A	T	3	3	6	0	0	6	0	0
17	29300650	.	A	G	2	2	4	0	0	4	0	0
17	29301058	.	G	C	1	2	3	0	1	4	0	0
17	29306749	.	C	A	2	2	4	0	0	4	0	0
17	29308706	.	G	A	3	3	6	0	0	6	0	0
17	29334520	.	T	A	9	7	16	0	0	16	0	0
17	29335645	.	G	A	7	5	12	0	0	12	0	0
17	29339149	.	T	G	12	11	23	0	2	25	0	0
17	29341118	.	C	T	6	17	23	0	0	23	0	0
17	29341597	.	T	C	7	12	19	0	3	22	0	0
17	29342904	.	G	A	1	4	5	0	9	14	0	0
17	29342947	.	C	T	5	12	17	0	2	19	0	0
17	29343143	.	T	C	14	15	29	0	1	30	0	0
17	29343153	.	G	A	14	18	32	0	0	32	0	0
17	29343358	.	A	G	14	12	26	0	1	27	0	0
17	29343494	.	A	G	7	10	17	0	1	18	0	0
17	29349739	.	G	A	0	2	2	0	1	3	0	0
17	29364518	.	G	A	1	5	6	0	1	7	0	0
17	29367320	.	T	C	4	4	8	0	2	10	0	0
17	29369029	.	C	T	6	5	11	0	0	11	0	0
17	29369072	.	T	C	3	7	10	0	0	10	0	0
17	29369114	.	T	C	5	7	12	0	0	12	0	0
17	29369213	.	T	G	4	6	10	0	1	11	0	0
17	29369612	.	A	G	4	4	8	0	2	10	0	0
17	29369713	.	A	C	3	7	10	0	1	11	0	0
17	29369748	.	C	T	8	8	16	0	0	16	0	0
17	29369780	.	C	A	8	3	11	0	2	13	0	0
17	29370100	.	A	C	4	3	7	0	0	7	0	0
17	29798098	.	A	G	3	6	9	0	1	10	0	0
17	29798312	.	C	A	2	10	12	0	10	22	0	0
17	29804291	.	G	C	6	6	12	0	1	13	0	0
17	29841590	.	A	T	4	8	12	0	1	13	0	0
17	29877079	.	C	T	0	3	3	0	2	5	0	0
17	29877094	.	A	G	2	3	5	0	0	5	0	0
17	30411205	.	C	T	1	2	3	0	0	3	0	0
17	30411208	.	A	G	1	2	3	0	0	3	0	0
17	30414430	.	C	T	2	2	4	0	0	4	0	0
17	30416997	.	T	C	2	3	5	0	0	5	0	0
17	30458569	.	C	T	2	2	4	0	0	4	0	0
17	30464806	.	A	T	7	3	10	0	0	10	0	0
17	30465779	.	T	A	4	2	6	0	0	6	0	0
17	30466395	.	T	C	1	3	4	0	0	4	0	0
17	30468428	.	C	T	7	5	12	0	2	14	0	0
17	30469200	.	C	A	8	6	14	0	0	14	0	0
17	30469350	.	A	T	3	6	9	0	0	9	0	0
17	30469364	.	T	C	6	3	9	0	0	9	0	0
17	30470034	.	C	T	3	3	6	0	0	6	0	0
17	30473847	.	A	T	4	2	6	0	0	6	0	0
17	30474161	.	A	G	5	12	17	0	1	18	0	0
17	30474226	.	A	G	1	6	7	0	1	8	0	0
17	30476939	.	C	A	2	7	9	0	10	19	0	0
17	30476978	.	A	G	7	5	12	0	1	13	0	0
17	30478808	.	A	G	2	4	6	0	0	6	0	0
17	30478943	.	A	G	4	3	7	0	1	8	0	0
17	30479161	.	A	G	2	5	7	0	1	8	0	0
17	30479359	.	T	C	3	4	7	0	1	8	0	0
17	30479422	.	C	T	4	4	8	0	0	8	0	0
17	30479425	.	G	A	4	4	8	0	0	8	0	0
17	30486671	.	T	C	4	0	4	0	9	13	0	0
17	30486971	.	G	A	4	2	6	0	1	7	0	0
17	30487040	.	G	A	6	6	12	0	0	12	0	0
17	30487094	.	G	C	2	5	7	0	0	7	0	0
17	30492088	.	C	T	2	2	4	0	0	4	0	0
17	30492999	.	A	C	3	0	3	0	4	7	0	0
17	30493290	.	T	C	5	4	9	0	0	9	0	0
17	30493770	.	T	C	2	0	2	0	2	4	0	0
17	30494073	.	T	G	9	7	16	0	0	16	0	0
17	30496317	.	C	T	3	3	6	0	0	6	0	0
17	30498084	.	C	T	3	5	8	0	0	8	0	0
17	30505439	.	T	C	2	0	2	0	3	5	0	0
17	30506896	.	A	G	3	2	5	0	0	5	0	0
17	30506899	.	G	A	3	1	4	0	1	5	0	0
17	30585604	.	C	T	2	2	4	0	1	5	0	0
17	30585682	.	A	T	1	2	3	0	0	3	0	0
17	30586485	.	C	T	1	2	3	0	0	3	0	0
17	30587288	.	T	C	2	3	5	0	0	5	0	0
17	30587324	.	T	G	2	0	2	0	6	8	0	0
17	30587325	.	A	G	2	6	8	0	0	8	0	0
17	30589166	.	T	C	4	3	7	0	0	7	0	0
17	30589732	.	G	A	0	3	3	0	2	5	0	0
17	30589740	.	G	A	2	3	5	0	0	5	0	0
17	30590020	.	A	G	7	5	12	0	0	12	0	0
17	30590075	.	A	T	11	6	17	0	1	18	0	0
17	30590271	.	G	T	10	11	21	0	2	23	0	0
17	30590273	.	C	G	11	10	21	0	2	23	0	0
17	30590325	.	C	T	10	12	22	0	1	23	0	0
17	30590367	.	G	A	5	9	14	0	0	14	0	0
17	30590515	.	C	A	4	3	7	0	1	8	0	0
17	30590541	.	C	T	3	4	7	0	0	7	0	0
17	30590661	.	G	A	5	2	7	0	0	7	0	0
17	30590663	.	T	A	4	2	6	0	1	7	0	0
17	30590838	.	T	C	5	14	19	0	0	19	0	0
17	30590842	.	C	A	4	14	18	0	1	19	0	0
17	30749304	.	C	A	3	2	5	0	0	5	0	0
17	30784396	.	A	G	2	0	2	0	2	4	0	0
17	30784400	.	C	T	2	2	4	0	0	4	0	0
17	30816937	.	T	C	1	2	3	0	0	3	0	0
17	30817044	.	G	A	2	4	6	0	0	6	0	0
17	30817119	.	T	A	3	6	9	0	0	9	0	0
17	30817170	.	A	G	2	6	8	0	0	8	0	0
17	30857288	.	A	G	10	16	26	0	1	27	0	0
17	30857431	.	A	T	8	6	14	0	1	15	0	0
17	30857433	.	A	T	7	6	13	0	2	15	0	0
17	30858809	.	C	T	1	14	15	0	16	31	0	0
17	30860630	.	G	T	10	13	23	0	0	23	0	0
17	30862909	.	A	G	12	9	21	0	0	21	0	0
17	30912562	.	C	A	7	8	15	0	1	16	0	0
17	30936802	.	C	T	2	7	9	0	8	17	0	0
17	30979170	.	T	C	8	13	21	0	3	24	0	0
17	30979208	.	T	C	8	12	20	0	0	20	0	0
17	30979339	.	T	C	11	10	21	0	0	21	0	0
17	30979391	.	T	C	11	0	11	0	17	28	0	0
17	30979518	.	G	A	7	9	16	0	1	17	0	0
17	30980336	.	A	G	8	13	21	0	0	21	0	0
17	30986665	.	T	C	9	12	21	0	0	21	0	0
17	30986712	.	G	T	9	7	16	0	0	16	0	0
17	30992178	.	T	C	7	8	15	0	0	15	0	0
17	30995008	.	G	A	7	2	9	0	1	10	0	0
17	31014189	.	G	A	6	5	11	0	0	11	0	0
17	31014192	.	T	C	4	3	7	0	1	8	0	0
17	31021588	.	A	G	5	5	10	0	0	10	0	0
17	31058807	.	C	A	1	2	3	0	0	3	0	0
17	31198945	.	C	T	2	3	5	0	0	5	0	0
17	31200222	.	T	C	6	6	12	0	0	12	0	0
17	31200247	.	C	A	6	5	11	0	1	12	0	0
17	31200394	.	G	C	4	4	8	0	0	8	0	0
17	31200475	.	A	T	4	3	7	0	0	7	0	0
17	31200481	.	C	T	3	3	6	0	0	6	0	0
17	31200621	.	C	T	2	5	7	0	0	7	0	0
17	31201348	.	A	G	8	0	8	0	12	20	0	0
17	31201523	.	A	T	13	6	19	0	2	21	0	0
17	31201894	.	A	C	8	10	18	0	2	20	0	0
17	31201954	.	A	G	13	12	25	0	2	27	0	0
17	31205360	.	G	A	3	4	7	0	1	8	0	0
17	31205375	.	T	A	2	5	7	0	2	9	0	0
17	31205508	.	G	A	4	4	8	0	0	8	0	0
17	31205563	.	G	T	4	2	6	0	0	6	0	0
17	31205579	.	G	A	6	2	8	0	0	8	0	0
17	31205600	.	T	C	7	1	8	0	2	10	0	0
17	31205614	.	G	A	7	2	9	0	0	9	0	0
17	31205985	.	A	G	6	3	9	0	0	9	0	0
17	31212043	.	A	G	2	1	3	0	2	5	0	0
17	31212080	.	T	G	3	1	4	0	1	5	0	0
17	31214459	.	A	T	7	5	12	0	3	15	0	0
17	31214665	.	G	C	10	0	10	0	5	15	0	0
17	31217113	.	T	A	9	9	18	0	0	18	0	0
17	31219140	.	C	T	2	3	5	0	7	12	0	0
17	31219208	.	T	C	8	0	8	0	3	11	0	0
17	31222505	.	A	T	11	12	23	0	1	25	1	0
17	31228767	.	G	C	21	12	33	0	1	34	0	0
17	31228801	.	C	T	15	7	22	0	0	22	0	0
17	31228837	.	G	A	0	9	9	0	15	24	0	0
17	31228900	.	T	C	9	8	17	0	1	18	0	0
17	31228942	.	G	A	4	2	6	0	0	6	0	0
17	31277169	.	A	T	9	11	20	0	0	20	0	0
17	31277443	.	A	G	17	10	27	0	0	27	0	0
17	31277758	.	A	T	5	3	8	0	0	8	0	0
17	31277820	.	C	A	13	11	24	0	0	24	0	0
17	31277855	.	G	A	11	14	25	0	3	28	0	0
17	31277987	.	T	C	10	0	10	0	12	22	0	0
17	31278022	.	G	A	10	13	23	0	2	25	0	0
17	31278433	.	C	A	14	19	33	0	2	35	0	0
17	31283510	.	C	G	0	5	5	0	8	13	0	0
17	31286221	.	G	A	7	3	10	0	0	10	0	0
17	31297284	.	G	A	6	4	10	0	1	11	0	0
17	31297746	.	C	T	1	3	4	0	4	8	0	0
17	31297768	.	G	T	4	4	8	0	0	8	0	0
17	31297791	.	C	T	3	5	8	0	0	8	0	0
17	31298349	.	C	T	0	5	5	0	2	7	0	0
17	31307837	.	A	G	2	2	4	0	0	4	0	0
17	31346575	.	A	G	1	2	3	0	0	3	0	0
17	31346582	.	T	C	1	3	4	0	0	4	0	0
17	31346653	.	C	T	6	10	16	0	0	16	0	0
17	31346695	.	A	G	12	5	17	0	0	17	0	0
17	31346712	.	G	A	8	7	15	0	4	19	0	0
17	31346840	.	A	G	12	9	21	0	2	23	0	0
17	31347029	.	T	A	13	20	33	0	0	33	0	0
17	31347046	.	T	G	17	13	30	0	3	33	0	0
17	31347193	.	A	C	17	8	25	0	1	26	0	0
17	31347254	.	A	G	20	14	34	0	3	37	0	0
17	31347344	.	C	G	15	12	27	0	1	28	0	0
17	31355841	.	C	T	4	6	10	0	1	11	0	0
17	31357531	.	C	T	10	5	15	0	0	15	0	0
17	31360631	.	T	C	4	3	7	0	0	7	0	0
17	31360763	.	G	A	3	2	5	0	0	5	0	0
17	31360804	.	C	T	6	4	10	1	0	11	0	0
17	31360854	.	G	A	8	6	14	0	0	14	0	0
17	31376532	.	C	T	1	2	3	0	0	3	0	0
17	31376560	.	C	A	1	3	4	0	1	5	0	0
17	31385102	.	A	T	1	3	4	0	0	4	0	0
17	31385111	.	G	T	1	3	4	0	0	4	0	0
17	31393786	.	T	C	2	3	5	0	0	5	0	0
17	31393845	.	A	G	3	0	3	0	5	8	0	0
17	31393855	.	T	A	3	4	7	0	0	7	0	0
17	31393962	.	A	T	2	3	5	0	0	5	0	0
17	31545776	.	C	G	1	3	4	0	4	8	0	0
17	31545911	.	C	G	2	2	4	0	0	4	0	0
17	31545935	.	A	G	2	2	4	0	0	4	0	0
17	31546169	.	G	A	3	4	7	0	0	7	0	0
17	31588923	.	C	T	1	2	3	0	0	3	0	0
17	31588961	.	C	T	1	2	3	0	1	4	0	0
17	31607739	.	G	A	1	4	5	0	0	5	0	0
17	31611632	.	C	T	0	2	2	0	1	3	0	0
17	31611947	.	T	C	5	5	10	0	0	10	0	0
17	31616799	.	T	C	10	16	26	0	0	26	0	0
17	31618624	.	C	T	16	14	30	0	1	31	0	0
17	31618636	.	T	C	17	11	28	0	2	30	0	0
17	31618953	.	T	C	17	27	44	0	0	44	0	0
17	31618962	.	A	G	17	24	41	0	1	42	0	0
17	31621894	.	C	T	7	5	12	0	0	12	0	0
17	31621921	.	C	A	5	3	8	0	0	8	0	0
17	31622024	.	C	A	12	5	17	0	0	17	0	0
17	31622083	.	A	C	9	12	21	0	0	21	0	0
17	31622123	.	C	A	9	14	23	0	1	24	0	0
17	31622233	.	T	A	7	5	12	0	1	13	0	0
17	31622367	.	A	G	9	7	16	0	0	16	0	0
17	31622662	.	C	T	7	6	13	0	0	13	0	0
17	31622995	.	G	A	1	4	5	0	0	5	0	0
17	31623588	.	A	G	4	5	9	0	0	9	0	0
17	31623635	.	C	T	5	8	13	0	0	13	0	0
17	31623646	.	A	G	6	6	12	0	1	13	0	0
17	31623829	.	G	C	14	12	26	0	0	26	0	0
17	31624119	.	A	T	6	4	10	0	2	12	0	0
17	31624604	.	A	G	12	7	19	0	1	20	0	0
17	31624652	.	C	T	1	13	14	0	13	27	0	0
17	31624682	.	A	G	8	16	24	0	0	24	0	0
17	31624716	.	T	A	13	13	26	0	0	26	0	0
17	31628812	.	C	A	0	6	6	0	10	16	0	0
17	31628953	.	G	T	9	10	19	0	0	19	0	0
17	31632288	.	T	C	3	5	8	0	0	8	0	0
17	31632330	.	A	G	7	12	19	0	0	19	0	0
17	31633027	.	A	G	4	6	10	0	1	11	0	0
17	31633186	.	C	T	8	8	16	0	2	18	0	0
17	31639014	.	C	T	1	3	4	0	8	12	0	0
17	31639721	.	T	C	1	3	4	0	0	4	0	0
17	31652820	.	T	A	1	2	3	0	0	3	0	0
17	31668039	.	A	G	2	3	5	0	0	5	0	0
17	31697158	.	A	G	2	2	4	0	0	4	0	0
17	31699881	.	G	T	2	3	5	1	0	6	0	0
17	31699931	.	A	G	2	4	6	0	0	6	0	0
17	31700087	.	T	C	2	4	6	0	0	6	0	0
17	31704848	.	G	A	2	2	4	0	1	5	0	0
17	31704999	.	G	A	3	4	7	0	1	8	0	0
17	31711802	.	G	A	1	3	4	0	0	4	0	0
17	31718630	.	G	A	7	2	9	0	1	10	0	0
17	31721451	.	G	A	1	6	7	0	6	13	0	0
17	31739475	.	C	T	2	4	6	0	0	6	0	0
17	31744849	.	C	T	4	2	6	0	0	6	0	0
17	31745597	.	C	A	9	4	13	0	0	13	0	0
17	31746341	.	T	A	12	6	18	0	2	20	0	0
17	31746553	.	T	C	10	11	21	0	2	23	0	0
17	31746833	.	G	A	10	8	18	0	1	19	0	0
17	31796240	.	C	T	13	13	26	0	4	30	0	0
17	31796481	.	T	G	13	8	21	0	0	21	0	0
17	31796576	.	G	A	17	9	26	0	0	26	0	0
17	31796821	.	T	A	13	5	18	0	0	18	0	0
17	31806207	.	A	T	2	4	6	0	0	6	0	0
17	31806710	.	T	C	1	2	3	0	0	3	0	0
17	31807063	.	G	A	3	4	7	0	0	7	0	0
17	31807085	.	G	A	3	5	8	0	0	8	0	0
17	31820605	.	T	C	6	5	11	0	0	11	0	0
17	31935226	.	C	T	1	3	4	0	0	4	0	0
17	31935486	.	C	T	1	1	2	0	1	3	0	0
17	31935600	.	T	C	3	2	5	0	0	5	0	0
17	32322173	.	T	G	2	2	4	0	0	4	0	0
17	32322192	.	T	C	1	2	3	0	0	3	0	0
17	32359449	.	T	C	2	2	4	0	0	4	0	0
17	32366387	.	A	G	3	4	7	0	0	7	0	0
17	32366543	.	A	G	4	6	10	0	0	10	0	0
17	32367193	.	A	G	3	6	9	0	0	9	0	0
17	32367238	.	A	C	3	3	6	0	0	6	0	0
17	32391121	.	G	A	1	2	3	0	0	3	0	0
17	32391127	.	A	G	1	3	4	0	0	4	0	0
17	32500495	.	G	A	19	19	38	0	2	40	0	0
17	32503110	.	G	A	1	27	28	0	24	52	0	0
17	32516973	.	T	C	25	24	49	0	2	51	0	0
17	32524654	.	C	T	32	24	56	0	4	60	0	0
17	32524851	.	T	G	29	42	71	1	1	73	0	0
17	32532794	.	G	T	1	2	3	0	0	3	0	0
17	32532795	.	C	T	1	2	3	0	0	3	0	0
17	32535870	.	C	A	1	3	4	0	0	4	0	0
17	32535977	.	T	C	2	2	4	0	0	4	0	0
17	32536067	.	G	C	3	3	6	0	1	7	0	0
17	32536401	.	C	T	3	2	5	0	0	5	0	0
17	32538360	.	C	G	2	5	7	0	0	7	0	0
17	32538608	.	A	G	3	0	3	0	2	5	0	0
17	32538638	.	A	G	3	3	6	0	0	6	0	0
17	32542518	.	A	C	4	6	10	0	0	10	0	0
17	32549402	.	T	C	1	5	6	0	0	6	0	0
17	32549416	.	G	A	1	7	8	0	0	8	0	0
17	32549725	.	C	G	3	6	9	0	0	9	0	0
17	32607414	.	A	G	2	3	5	0	0	5	0	0
17	32622942	.	A	G	5	3	8	0	1	9	0	0
17	32622966	.	C	A	7	5	12	0	0	12	0	0
17	32623004	.	T	G	9	1	10	0	7	17	0	0
17	32623009	.	T	G	9	8	17	0	1	18	0	0
17	32624653	.	A	C	12	4	16	0	0	16	0	0
17	32624668	.	A	T	10	3	13	0	2	15	0	0
17	32624707	.	T	C	8	4	12	0	2	14	0	0
17	32624910	.	T	C	7	13	20	0	0	20	0	0
17	32624916	.	A	T	8	12	20	0	0	20	0	0
17	32631400	.	C	T	9	5	14	0	0	14	0	0
17	32631513	.	A	T	8	7	15	0	2	17	0	0
17	32631533	.	A	G	7	13	20	0	0	20	0	0
17	32631560	.	G	T	7	21	28	0	0	28	0	0
17	32631603	.	C	G	8	18	26	0	3	29	0	0
17	32634254	.	C	T	4	10	14	0	0	14	0	0
17	32636025	.	A	T	8	7	15	0	1	16	0	0
17	32636179	.	T	C	5	0	5	0	6	11	0	0
17	33306121	.	A	G	1	4	5	0	0	5	0	0
17	34105333	.	G	A	0	6	6	0	7	13	0	0
17	34141488	.	T	G	8	5	13	0	0	13	0	0
17	34157059	.	T	C	7	8	15	0	0	15	0	0
17	34158945	.	G	A	10	7	17	0	0	17	0	0
17	34162932	.	G	C	15	10	25	0	0	25	0	0
17	34173297	.	C	T	9	14	23	2	0	25	0	0
17	34182672	.	G	A	2	7	9	0	11	20	0	0
17	34182949	.	C	T	11	17	28	0	1	29	0	0
17	34183002	.	T	C	19	14	33	0	3	36	0	0
17	34183320	.	T	G	32	23	55	0	2	58	1	0
17	34183497	.	T	C	13	21	34	0	3	37	0	0
17	34183512	.	A	T	15	20	35	0	4	39	0	0
17	34244437	.	G	T	3	8	11	0	0	11	0	0
17	34246289	.	T	C	7	5	12	0	1	13	0	0
17	34246295	.	A	G	7	6	13	0	0	13	0	0
17	34254065	.	A	G	18	6	24	0	1	25	0	0
17	34807498	.	T	A	21	21	42	0	2	44	0	0
17	34807781	.	C	T	10	5	15	0	0	15	0	0
17	34807836	.	A	C	9	7	16	0	0	16	0	0
17	34807961	.	G	A	8	5	13	0	0	13	0	0
17	34808024	.	T	C	5	4	9	0	1	10	0	0
17	34809810	.	G	A	2	3	5	0	0	5	0	0
17	34809989	.	T	C	1	3	4	0	1	5	0	0
17	34811404	.	A	C	2	3	5	0	0	5	0	0
17	34811429	.	C	G	1	3	4	0	1	5	0	0
17	35198102	.	C	T	1	2	3	0	0	3	0	0
17	35198221	.	G	A	0	2	2	0	1	3	0	0
17	35203236	.	T	C	1	3	4	0	0	4	0	0
17	35203398	.	T	C	1	3	4	0	0	4	0	0
17	35208080	.	T	C	3	5	8	0	0	8	0	0
17	35210811	.	T	C	4	6	10	0	1	11	0	0
17	35210853	.	A	G	3	5	8	0	0	8	0	0
17	35210868	.	C	A	4	4	8	0	1	9	0	0
17	35213989	.	G	A	6	4	10	0	1	11	0	0
17	35222582	.	G	A	2	8	10	0	4	14	0	0
17	35222762	.	C	A	8	4	12	0	0	12	0	0
17	35222864	.	G	A	11	4	15	0	0	15	0	0
17	35222883	.	T	C	10	4	14	0	2	16	0	0
17	35222994	.	A	T	4	5	9	0	1	10	0	0
17	35223051	.	A	T	4	4	8	0	2	10	0	0
17	35223057	.	A	G	4	4	8	0	0	8	0	0
17	35223151	.	T	C	4	10	14	0	0	14	0	0
17	35223195	.	C	T	3	6	9	0	0	9	0	0
17	35223368	.	G	A	1	7	8	0	8	16	0	0
17	35226377	.	G	A	2	12	14	0	1	15	0	0
17	35229163	.	T	A	8	10	18	0	0	18	0	0
17	35244344	.	C	T	3	2	5	0	0	5	0	0
17	35244346	.	C	T	3	1	4	0	1	5	0	0
17	35244404	.	C	G	6	3	9	0	0	9	0	0
17	35244431	.	T	C	6	5	11	0	0	11	0	0
17	35246383	.	G	A	2	4	6	0	0	6	0	0
17	35246994	.	A	G	5	4	9	0	0	9	0	0
17	35247012	.	T	A	4	3	7	0	0	7	0	0
17	35247203	.	G	A	2	4	6	0	0	6	0	0
17	35247682	.	T	C	3	0	3	0	14	17	0	0
17	35247838	.	T	C	16	11	27	0	0	27	0	0
17	35248038	.	C	T	6	11	17	0	1	18	0	0
17	35248121	.	T	A	6	6	12	0	2	14	0	0
17	35248264	.	G	A	14	8	22	0	1	23	0	0
17	35248830	.	G	T	3	4	7	0	0	7	0	0
17	35248831	.	T	G	3	4	7	0	0	7	0	0
17	35248908	.	C	T	0	2	2	0	3	5	0	0
17	35249136	.	G	A	4	3	7	0	0	7	0	0
17	35249141	.	T	G	4	3	7	0	0	7	0	0
17	35249206	.	C	A	5	4	9	0	0	9	0	0
17	35249230	.	T	G	5	3	8	0	1	9	0	0
17	35249422	.	A	C	9	8	17	0	0	17	0	0
17	35249577	.	G	A	18	6	24	0	0	24	0	0
17	35249688	.	A	G	11	7	18	0	1	19	0	0
17	35249795	.	T	C	7	0	7	1	7	15	0	0
17	35250060	.	C	A	1	4	5	0	9	14	0	0
17	35250300	.	C	T	10	8	18	0	1	19	0	0
17	35250328	.	G	A	8	9	17	0	0	17	0	0
17	35261077	.	T	C	4	2	6	0	0	6	0	0
17	35267038	.	G	T	5	5	10	0	0	10	0	0
17	35267068	.	A	T	5	5	10	0	0	10	0	0
17	35269992	.	A	G	6	5	11	0	1	12	0	0
17	35276147	.	C	G	4	2	6	0	0	6	0	0
17	35278418	.	G	A	1	2	3	0	0	3	0	0
17	35278679	.	A	G	2	2	4	0	0	4	0	0
17	35286771	.	T	A	2	2	4	0	0	4	0	0
17	35287371	.	C	T	3	2	5	0	0	5	0	0
17	35287600	.	A	G	3	2	5	0	0	5	0	0
17	35881126	.	G	T	16	15	31	0	0	31	0	0
17	35881148	.	T	C	15	10	25	0	0	25	0	0
17	36588754	.	C	T	4	6	10	0	1	11	0	0
17	36589295	.	C	T	4	6	10	0	1	11	0	0
17	36589435	.	C	A	5	8	13	0	1	14	0	0
17	36589554	.	G	A	4	5	9	0	1	10	0	0
17	36867298	.	C	T	1	4	5	0	13	18	0	0
17	36867355	.	T	C	12	5	17	0	1	18	0	0
17	36867450	.	T	C	8	5	13	0	0	13	0	0
17	36867471	.	G	A	10	9	19	0	1	20	0	0
17	36867558	.	T	C	2	0	2	0	7	9	0	0
17	36867568	.	A	G	4	5	9	0	1	10	0	0
17	36867738	.	T	C	5	1	6	0	14	20	0	0
17	36867915	.	A	G	14	10	24	0	2	26	0	0
17	36867945	.	T	C	13	0	13	0	12	25	0	0
17	36867951	.	A	G	15	9	24	0	1	25	0	0
17	36872564	.	C	T	0	7	7	0	7	14	0	0
17	36884529	.	A	G	6	4	10	0	0	10	0	0
17	36899746	.	A	T	32	11	43	0	3	46	0	0
17	36899760	.	T	A	31	16	47	0	0	47	0	0
17	36899853	.	T	C	26	22	48	0	4	52	0	0
17	36905905	.	A	G	25	11	36	0	0	36	0	0
17	36905998	.	A	G	20	15	35	0	1	36	0	0
17	36906007	.	G	C	21	1	22	0	15	37	0	0
17	36909904	.	C	T	2	15	17	0	9	26	0	0
17	36911113	.	T	C	18	1	19	0	16	35	0	0
17	36914689	.	C	T	2	10	12	0	11	23	0	0
17	36915353	.	A	G	7	6	13	0	1	14	0	0
17	36929111	.	T	C	6	4	10	0	0	10	0	0
17	36929198	.	C	T	8	6	14	0	0	14	0	0
17	36937975	.	G	A	21	24	45	0	1	46	0	0
17	36938035	.	C	T	17	22	39	0	0	39	0	0
17	36938761	.	T	A	20	17	37	0	1	38	0	0
17	36938819	.	G	A	18	16	34	0	3	37	0	0
17	36938979	.	A	G	13	10	23	0	2	25	0	0
17	36939029	.	A	G	13	6	19	0	0	19	0	0
17	36939064	.	A	G	10	7	17	0	0	17	0	0
17	36939400	.	T	A	7	9	16	0	0	16	0	0
17	36939493	.	G	A	8	5	13	0	0	13	0	0
17	36939574	.	A	G	5	12	17	0	1	18	0	0
17	36939698	.	G	C	10	9	19	0	2	21	0	0
17	36939736	.	C	T	11	13	24	0	1	25	0	0
17	36939973	.	T	G	2	3	5	0	1	6	0	0
17	36940074	.	T	C	12	6	18	0	2	20	0	0
17	36940236	.	T	C	3	0	3	0	12	15	0	0
17	36940424	.	C	A	5	10	15	0	2	17	0	0
17	36940451	.	G	A	6	3	9	0	1	10	0	0
17	36940974	.	T	G	7	9	16	0	2	18	0	0
17	36940977	.	T	C	7	8	15	0	2	17	0	0
17	36941121	.	A	C	6	10	16	0	0	16	0	0
17	36941291	.	C	T	1	8	9	0	6	15	0	0
17	36941352	.	G	A	7	2	9	0	0	9	0	0
17	36941523	.	A	G	2	2	4	0	0	4	0	0
17	36941788	.	G	T	5	7	12	0	0	12	0	0
17	36941812	.	G	A	4	7	11	0	0	11	0	0
17	36947137	.	T	C	6	6	12	0	0	12	0	0
17	36947218	.	G	A	7	4	11	0	0	11	0	0
17	36951602	.	C	A	5	8	13	0	0	13	0	0
17	36956946	.	A	G	5	2	7	0	1	8	0	0
17	36957029	.	T	C	2	3	5	0	0	5	0	0
17	36962179	.	G	A	3	2	5	0	1	6	0	0
17	36970937	.	T	C	3	4	7	0	1	8	0	0
17	37013465	.	A	G	4	3	7	0	0	7	0	0
17	37070262	.	G	C	3	3	6	0	0	6	0	0
17	37070497	.	T	C	7	2	9	0	6	15	0	0
17	37070550	.	C	G	9	9	18	1	0	19	0	0
17	37073530	.	G	A	8	9	17	0	0	17	0	0
17	37076276	.	C	A	0	4	4	0	4	8	0	0
17	37086637	.	A	T	2	10	12	0	1	13	0	0
17	37086670	.	C	T	0	7	7	0	3	10	0	0
17	37088463	.	T	C	7	1	8	0	5	13	0	0
17	37088514	.	G	A	7	7	14	0	3	17	0	0
17	37134165	.	G	T	3	7	10	0	1	11	0	0
17	37143651	.	A	G	6	6	12	0	1	13	0	0
17	37143669	.	C	G	5	9	14	0	0	14	0	0
17	37156496	.	G	T	3	4	7	0	0	7	0	0
17	37156512	.	T	A	1	2	3	0	1	4	0	0
17	37162953	.	A	T	1	2	3	0	1	4	0	0
17	37163291	.	A	G	1	2	3	0	0	3	0	0
17	37164035	.	G	A	2	2	4	0	1	5	0	0
17	37164122	.	A	T	1	2	3	0	0	3	0	0
17	37204273	.	A	C	3	6	9	0	0	9	0	0
17	37204417	.	G	A	20	10	30	0	3	33	0	0
17	37204484	.	T	C	15	0	15	0	14	29	0	0
17	37210305	.	C	T	2	15	17	0	27	44	0	0
17	37212127	.	A	G	14	15	29	0	1	30	0	0
17	37212154	.	T	C	14	10	24	0	0	24	0	0
17	37212485	.	T	A	15	13	28	0	1	29	0	0
17	37212592	.	T	G	14	9	23	0	2	25	0	0
17	37212616	.	G	T	9	11	20	0	0	20	0	0
17	37212634	.	C	T	11	6	17	0	3	20	0	0
17	37212725	.	T	C	13	16	29	0	0	29	0	0
17	37212757	.	T	C	18	11	29	0	2	31	0	0
17	37212832	.	G	A	14	16	30	0	3	33	0	0
17	37213231	.	C	T	17	9	26	0	0	26	0	0
17	37213416	.	G	T	6	9	15	0	0	15	0	0
17	37213677	.	T	C	11	6	17	0	0	17	0	0
17	37213887	.	G	A	6	4	10	0	1	11	0	0
17	37213900	.	C	A	7	4	11	0	0	11	0	0
17	37213928	.	T	C	5	5	10	0	0	10	0	0
17	37213999	.	A	G	11	12	23	0	1	24	0	0
17	37214022	.	C	T	16	9	25	0	1	26	0	0
17	37220566	.	C	A	1	2	3	0	0	3	0	0
17	37220647	.	A	C	2	2	4	0	1	5	0	0
17	37228020	.	C	A	2	2	4	0	0	4	0	0
17	37231271	.	C	G	2	3	5	0	0	5	0	0
17	37234489	.	T	C	3	4	7	0	0	7	0	0
17	37237230	.	T	C	6	6	12	0	1	13	0	0
17	37239402	.	T	G	2	3	5	0	0	5	0	0
17	37239981	.	C	T	8	8	16	0	1	17	0	0
17	37240088	.	T	C	9	7	16	0	1	17	0	0
17	37241661	.	A	G	12	10	22	0	1	23	0	0
17	37241676	.	T	G	13	0	13	0	13	26	0	0
17	37241700	.	C	T	9	14	23	0	0	23	0	0
17	37252299	.	T	A	13	5	18	0	0	18	0	0
17	37252352	.	G	A	13	10	23	0	0	23	0	0
17	37252374	.	G	T	1	15	16	0	13	29	0	0
17	37252441	.	A	T	8	11	19	0	2	21	0	0
17	37252716	.	G	A	3	9	12	0	12	24	0	0
17	37253832	.	C	G	1	0	1	0	2	3	0	0
17	37263068	.	T	C	2	2	4	0	0	4	0	0
17	37267740	.	A	G	1	0	1	0	3	4	0	0
17	37280857	.	A	C	2	2	4	0	0	4	0	0
17	37280860	.	A	G	1	2	3	0	1	4	0	0
17	37281303	.	A	C	5	2	7	0	0	7	0	0
17	37281309	.	G	A	5	3	8	0	0	8	0	0
17	37317636	.	G	A	2	2	4	0	0	4	0	0
17	37317756	.	A	G	2	4	6	0	1	7	0	0
17	37317809	.	T	C	2	1	3	0	3	6	0	0
17	37317885	.	A	C	2	2	4	0	0	4	0	0
17	37323060	.	T	G	2	0	2	0	10	12	0	0
17	37323168	.	G	A	0	3	3	0	3	6	0	0
17	37323303	.	C	T	4	3	7	0	0	7	0	0
17	37323306	.	T	C	4	2	6	0	0	6	0	0
17	37350708	.	C	T	6	4	10	0	1	11	0	0
17	37352961	.	C	A	2	5	7	0	0	7	0	0
17	37353043	.	T	C	4	2	6	0	0	6	0	0
17	37361233	.	C	T	5	2	7	0	0	7	0	0
17	37361349	.	C	T	2	5	7	0	0	7	0	0
17	37361556	.	T	A	3	4	7	0	0	7	0	0
17	37361605	.	G	A	0	5	5	0	4	9	0	0
17	37361669	.	C	T	3	3	6	0	0	6	0	0
17	37362139	.	C	G	8	5	13	0	1	14	0	0
17	37362153	.	G	T	6	8	14	0	1	15	0	0
17	37362181	.	C	T	3	5	8	0	0	8	0	0
17	37362198	.	C	T	3	4	7	0	1	8	0	0
17	37362298	.	C	G	5	2	7	0	0	7	0	0
17	37362380	.	C	A	3	7	10	1	0	11	0	0
17	37362574	.	T	A	3	5	8	0	3	11	0	0
17	37362851	.	A	T	2	6	8	0	0	8	0	0
17	37362876	.	T	C	2	5	7	0	0	7	0	0
17	37363191	.	T	A	1	3	4	0	0	4	0	0
17	37363309	.	C	G	6	6	12	0	0	12	0	0
17	37363737	.	A	C	2	1	3	0	2	5	0	0
17	37363802	.	T	A	6	7	13	0	1	14	0	0
17	37363809	.	C	T	5	9	14	0	1	15	0	0
17	37363855	.	T	G	2	6	8	0	0	8	0	0
17	37363857	.	T	C	1	6	7	0	0	7	0	0
17	37363959	.	A	T	6	3	9	0	0	9	0	0
17	37364009	.	A	G	3	0	3	0	5	8	0	0
17	37364026	.	A	G	5	0	5	0	3	8	0	0
17	37364061	.	G	T	4	10	14	0	1	15	0	0
17	37364517	.	C	T	9	8	17	0	1	18	0	0
17	37364533	.	T	C	10	6	16	0	1	17	0	0
17	37364620	.	C	T	7	12	19	0	0	19	0	0
17	37364676	.	A	C	10	7	17	0	1	18	0	0
17	37365020	.	A	G	15	12	27	0	1	28	0	0
17	37365455	.	T	C	1	3	4	0	0	4	0	0
17	37365465	.	T	G	1	3	4	0	0	4	0	0
17	37385920	.	T	A	1	3	4	0	1	5	0	0
17	37388782	.	G	A	5	4	9	0	0	9	0	0
17	37446789	.	A	C	15	2	17	0	4	21	0	0
17	38854336	.	T	C	1	2	3	0	0	3	0	0
17	38927932	.	T	C	4	2	6	0	0	6	0	0
17	38928775	.	C	T	4	2	6	0	0	6	0	0
17	38928947	.	A	T	1	3	4	0	0	4	0	0
17	38929142	.	T	G	5	4	9	0	1	10	0	0
17	38938727	.	G	A	1	2	3	0	0	3	0	0
17	38941109	.	C	T	0	2	2	0	1	3	0	0
17	38941286	.	G	A	1	2	3	0	0	3	0	0
17	39717616	.	T	C	1	4	5	0	0	5	0	0
17	39717645	.	A	G	2	0	2	0	4	6	0	0
17	39720791	.	T	C	2	6	8	0	0	8	0	0
17	39728423	.	T	A	8	8	16	0	1	17	0	0
17	39729014	.	G	A	7	9	16	0	0	16	0	0
17	39732512	.	C	T	14	6	20	0	0	20	0	0
17	39732573	.	C	A	8	8	16	0	1	17	0	0
17	39732584	.	G	A	9	8	17	0	0	17	0	0
17	39736088	.	T	A	9	8	17	2	4	23	0	0
17	39736103	.	G	A	12	7	19	2	2	23	0	0
17	39736130	.	T	C	12	6	18	0	1	19	0	0
17	39739842	.	A	T	10	4	14	0	2	16	0	0
17	39748300	.	A	T	1	2	3	0	0	3	0	0
17	39862536	.	C	G	1	8	9	0	1	10	0	0
17	39863633	.	C	T	4	2	6	0	0	6	0	0
17	40860266	.	C	T	2	2	4	0	0	4	0	0
17	40880042	.	G	A	2	2	4	0	0	4	0	0
17	40888907	.	A	C	2	2	4	0	0	4	0	0
17	40888909	.	G	C	2	2	4	0	0	4	0	0
17	40890107	.	G	T	2	3	5	0	0	5	0	0
17	40893919	.	A	T	1	3	4	0	0	4	0	0
17	40900686	.	T	G	4	6	10	0	1	11	0	0
17	40901439	.	T	C	2	4	6	0	1	7	0	0
17	40901695	.	G	C	6	8	14	0	1	15	0	0
17	40901712	.	C	G	5	5	10	0	0	10	0	0
17	40901752	.	G	A	5	4	9	0	0	9	0	0
17	40901799	.	A	C	7	4	11	0	0	11	0	0
17	40901804	.	A	T	6	3	9	0	0	9	0	0
17	40902065	.	G	A	5	5	10	0	0	10	0	0
17	40902148	.	G	T	4	3	7	0	2	9	0	0
17	40902180	.	G	C	9	5	14	0	0	14	0	0
17	40902256	.	G	T	5	3	8	0	0	8	0	0
17	40902297	.	A	G	5	10	15	0	3	18	0	0
17	40902347	.	C	T	12	9	21	0	0	21	0	0
17	40902598	.	G	A	10	6	16	0	0	16	0	0
17	40902629	.	A	T	9	8	17	0	0	17	0	0
17	40902657	.	A	C	8	10	18	0	0	18	0	0
17	40902830	.	A	T	8	7	15	0	1	16	0	0
17	40903162	.	C	T	5	6	11	0	1	12	0	0
17	40990061	.	T	A	9	19	28	0	2	30	0	0
17	40990097	.	T	A	10	15	25	0	1	26	0	0
17	40999460	.	A	G	15	15	30	0	1	31	0	0
17	40999697	.	C	G	6	7	13	0	0	13	0	0
17	40999700	.	C	A	6	6	12	0	1	13	0	0
17	40999732	.	A	G	4	5	9	0	1	10	0	0
17	40999964	.	G	T	1	2	3	0	0	3	0	0
17	41084623	.	C	T	4	2	6	0	0	6	0	0
17	41092465	.	C	T	3	6	9	0	0	9	0	0
17	41121783	.	C	G	3	3	6	0	0	6	0	0
17	41254741	.	C	T	12	7	19	0	1	20	0	0
17	41264165	.	C	A	3	2	5	0	0	5	0	0
17	41314040	.	G	T	0	4	4	0	7	11	0	0
17	41314097	.	T	C	3	8	11	0	3	14	0	0
17	41314471	.	G	A	10	11	21	0	0	21	0	0
17	41314501	.	A	G	7	6	13	0	0	13	0	0
17	41317030	.	C	G	21	8	29	0	2	31	0	0
17	41317234	.	A	G	7	1	8	0	14	22	0	0
17	41317494	.	G	A	13	13	26	0	0	26	0	0
17	41317999	.	G	A	15	19	34	0	0	34	0	0
17	41318310	.	A	G	19	12	31	0	2	33	0	0
17	41318392	.	G	A	6	5	11	0	1	12	0	0
17	41318436	.	G	A	2	3	5	0	0	5	0	0
17	41464090	.	G	A	0	4	4	0	6	10	0	0
17	41465504	.	A	C	7	11	18	0	0	18	0	0
17	41465922	.	G	A	2	2	4	0	0	4	0	0
17	41475863	.	T	C	15	12	27	0	0	27	0	0
17	41476104	.	T	C	18	0	18	0	23	41	0	0
17	41476161	.	A	G	29	15	44	0	5	49	0	0
17	41476279	.	G	A	17	19	36	0	0	36	0	0
17	41476298	.	T	A	13	14	27	0	1	29	1	0
17	41476393	.	G	T	16	7	23	0	3	26	0	0
17	41476833	.	T	C	6	7	13	0	1	14	0	0
17	41476906	.	A	C	6	0	6	0	5	11	0	0
17	41476917	.	C	T	0	4	4	0	7	11	0	0
17	41476970	.	T	C	13	7	20	0	0	20	0	0
17	41476994	.	G	A	12	9	21	0	0	21	0	0
17	41477007	.	C	T	1	10	11	0	12	23	0	0
17	41477157	.	T	C	12	7	19	0	0	19	0	0
17	41477324	.	G	A	8	3	11	0	3	14	0	0
17	41558269	.	G	C	5	6	11	0	0	11	0	0
17	41571328	.	T	A	6	4	10	0	0	11	1	0
17	41583555	.	C	G	0	4	4	0	1	5	0	0
17	41583747	.	G	T	4	4	8	0	1	9	0	0
17	41583768	.	T	C	1	0	1	0	4	5	0	0
17	41583786	.	A	G	2	3	5	0	0	5	0	0
17	41592172	.	A	C	4	4	8	0	0	8	0	0
17	41601633	.	G	A	3	3	6	0	0	6	0	0
17	41610991	.	G	A	2	2	4	0	0	4	0	0
17	41630748	.	G	A	1	2	3	0	1	4	0	0
17	41630749	.	A	T	2	2	4	0	0	4	0	0
17	41659641	.	C	T	0	2	2	0	2	4	0	0
17	41992262	.	T	G	1	0	1	0	3	4	0	0
17	41994868	.	A	G	1	0	1	0	2	3	0	0
17	42003872	.	C	T	1	5	6	0	1	7	0	0
17	42027915	.	C	T	4	5	9	0	1	10	0	0
17	42032119	.	T	C	8	5	13	0	0	13	0	0
17	42611545	.	C	T	4	3	7	0	0	7	0	0
17	42611579	.	C	A	5	4	9	0	0	9	0	0
17	42611581	.	C	T	5	4	9	0	0	9	0	0
17	42871419	.	G	T	16	17	33	0	0	33	0	0
17	43013675	.	G	A	37	21	58	0	2	60	0	0
17	43017672	.	C	T	15	9	24	0	1	25	0	0
17	43017687	.	G	A	17	9	26	0	1	27	0	0
17	43017830	.	A	G	13	8	21	0	1	22	0	0
17	43017863	.	A	C	16	10	26	0	1	27	0	0
17	43018037	.	G	A	1	11	12	0	12	24	0	0
17	43018124	.	A	G	17	1	18	0	13	31	0	0
17	43018273	.	G	A	23	21	44	0	3	47	0	0
17	43018382	.	T	G	12	15	27	0	1	28	0	0
17	43018502	.	T	A	18	23	41	0	3	44	0	0
17	43018549	.	C	G	10	23	33	0	1	34	0	0
17	43018638	.	A	T	21	16	37	0	0	37	0	0
17	43018815	.	A	G	17	12	29	0	4	33	0	0
17	43018899	.	T	A	11	17	28	0	0	28	0	0
17	43030696	.	T	C	2	9	11	0	2	13	0	0
17	43030737	.	T	G	10	13	23	0	0	23	0	0
17	43030828	.	G	A	15	7	22	1	1	24	0	0
17	43031495	.	G	A	8	6	14	0	1	15	0	0
17	43033177	.	G	A	21	11	32	0	3	35	0	0
17	43035798	.	T	C	15	24	39	0	0	39	0	0
17	43035958	.	A	G	11	10	21	0	2	24	1	0
17	43035964	.	A	G	18	7	25	0	2	27	0	0
17	43035996	.	G	T	17	14	31	0	1	32	0	0
17	43036025	.	A	G	14	15	29	0	2	31	0	0
17	43036055	.	T	C	11	12	23	0	0	23	0	0
17	43036075	.	T	G	8	13	21	0	1	22	0	0
17	43036109	.	A	G	9	7	16	0	0	16	0	0
17	43039706	.	A	G	3	2	5	0	1	6	0	0
17	43040422	.	T	A	4	5	9	0	0	9	0	0
17	43075560	.	G	T	2	3	5	0	0	5	0	0
17	43075561	.	G	A	2	3	5	0	0	5	0	0
17	43077327	.	C	T	3	6	9	0	0	9	0	0
17	43082871	.	G	A	5	2	7	0	0	7	0	0
17	43082976	.	A	T	4	4	8	0	0	8	0	0
17	43165668	.	G	T	1	1	2	0	1	3	0	0
17	43297465	.	T	C	1	2	3	0	0	3	0	0
17	43297561	.	T	G	3	4	7	0	1	8	0	0
17	43297946	.	G	C	6	9	15	0	0	15	0	0
17	43298011	.	G	A	11	12	23	0	1	24	0	0
17	43298068	.	G	A	9	13	22	0	0	22	0	0
17	43302492	.	G	A	14	7	21	0	0	21	0	0
17	43309095	.	A	G	8	6	14	0	0	14	0	0
17	43309164	.	C	T	1	4	5	0	3	8	0	0
17	43315085	.	C	T	3	5	8	0	2	10	0	0
17	43391434	.	G	T	1	3	4	0	0	4	0	0
17	43391442	.	C	T	1	2	3	0	1	4	0	0
17	43436782	.	T	C	27	0	27	0	18	45	0	0
17	43437305	.	G	C	33	11	44	2	1	47	0	0
17	43437365	.	C	G	28	14	42	0	6	48	0	0
17	43439720	.	G	T	14	21	35	0	5	40	0	0
17	43441575	.	A	T	22	10	32	0	3	35	0	0
17	43453507	.	T	C	9	6	15	0	2	17	0	0
17	43453531	.	G	A	10	7	17	0	0	17	0	0
17	43456825	.	C	T	9	8	17	0	0	17	0	0
17	43456900	.	G	A	6	10	16	0	0	16	0	0
17	43456921	.	T	C	11	5	16	0	2	18	0	0
17	43461181	.	G	A	5	6	11	0	0	11	0	0
17	43469204	.	A	C	6	11	17	0	0	17	0	0
17	43469377	.	G	A	5	6	11	0	0	11	0	0
17	43473913	.	T	C	8	9	17	0	1	18	0	0
17	43475577	.	G	A	0	15	15	0	7	22	0	0
17	43475619	.	A	G	6	0	6	0	15	21	0	0
17	43475691	.	T	A	2	6	8	0	0	8	0	0
17	43475712	.	A	G	2	0	2	0	3	5	0	0
17	43476046	.	C	T	6	3	9	0	0	9	0	0
17	43476137	.	T	A	10	12	22	0	0	22	0	0
17	43513109	.	G	A	11	9	20	0	0	20	0	0
17	43516464	.	T	A	8	9	17	0	0	17	0	0
17	43516502	.	G	T	7	6	13	0	0	13	0	0
17	43516506	.	A	C	7	5	12	0	1	13	0	0
17	43516548	.	A	G	7	9	16	0	0	16	0	0
17	43516579	.	T	C	4	0	4	0	12	16	0	0
17	43519741	.	C	T	2	2	4	0	0	4	0	0
17	43520136	.	G	A	2	4	6	0	0	6	0	0
17	43520158	.	A	G	3	6	9	0	0	9	0	0
17	43520191	.	G	A	4	6	10	0	0	10	0	0
17	43522776	.	A	G	3	5	8	0	0	8	0	0
17	43522782	.	T	C	5	0	5	0	4	9	0	0
17	43537865	.	C	T	3	4	7	0	1	8	0	0
17	43538018	.	A	C	5	6	11	0	1	12	0	0
17	43538035	.	C	T	1	6	7	0	2	9	0	0
17	43538081	.	G	A	1	4	5	0	0	5	0	0
17	43538097	.	C	T	1	5	6	0	0	6	0	0
17	43538131	.	G	A	3	3	6	0	1	7	0	0
17	43538209	.	C	T	9	7	16	0	2	18	0	0
17	43547945	.	A	G	3	3	6	0	0	6	0	0
17	43551547	.	G	T	3	4	7	0	0	7	0	0
17	43551835	.	A	G	1	2	3	0	1	4	0	0
17	43551841	.	G	C	2	2	4	0	0	4	0	0
17	43565680	.	A	T	5	2	7	1	0	8	0	0
17	43565697	.	C	A	5	3	8	1	0	9	0	0
17	43611513	.	C	T	2	2	4	0	0	4	0	0
17	43611752	.	C	T	1	2	3	0	2	5	0	0
17	43660232	.	G	A	6	8	14	0	0	14	0	0
17	43660779	.	T	C	8	7	15	0	1	16	0	0
17	43661106	.	T	G	6	3	9	0	1	10	0	0
17	43663611	.	T	G	4	6	10	0	0	10	0	0
17	43663789	.	A	C	14	18	32	0	3	35	0	0
17	43663870	.	G	A	17	25	42	0	0	42	0	0
17	43664128	.	G	C	15	16	31	0	4	35	0	0
17	43664580	.	A	G	7	11	18	0	1	19	0	0
17	43664605	.	G	A	8	8	16	0	0	16	0	0
17	43708546	.	C	T	8	6	14	0	1	15	0	0
17	43708563	.	A	G	8	8	16	0	1	17	0	0
17	43708608	.	C	T	13	5	18	0	0	18	0	0
17	43708649	.	T	C	6	7	13	0	0	13	0	0
17	43711557	.	C	T	1	9	10	0	3	13	0	0
17	43715851	.	T	C	7	6	13	0	0	13	0	0
17	43716633	.	C	T	3	2	5	0	0	5	0	0
17	43716648	.	T	A	3	4	7	0	0	7	0	0
17	43847239	.	G	A	2	2	4	0	0	4	0	0
17	43851013	.	A	G	11	9	20	0	0	20	0	0
17	43853538	.	G	A	8	20	28	0	1	29	0	0
17	43853767	.	A	G	13	12	25	1	5	31	0	0
17	43853778	.	C	T	4	16	20	1	10	31	0	0
17	43854007	.	G	A	3	9	12	0	0	12	0	0
17	43854010	.	T	G	11	3	14	0	0	14	0	0
17	43856232	.	T	C	6	3	9	0	0	9	0	0
17	43859282	.	T	C	9	5	14	0	0	14	0	0
17	43863609	.	A	C	6	6	12	0	2	14	0	0
17	43863655	.	G	C	4	2	6	0	1	7	0	0
17	43863656	.	C	T	4	2	6	0	1	7	0	0
17	43879340	.	C	T	1	3	4	0	0	4	0	0
17	43879346	.	A	G	1	3	4	0	0	4	0	0
17	43926650	.	C	A	2	3	5	0	1	6	0	0
17	43946901	.	C	T	2	6	8	0	1	9	0	0
17	43951868	.	G	T	4	5	9	0	0	9	0	0
17	43952984	.	C	T	5	4	9	0	0	9	0	0
17	43953000	.	G	A	1	3	4	0	5	9	0	0
17	43954926	.	A	C	2	6	8	0	0	8	0	0
17	43987048	.	A	G	8	18	26	0	0	26	0	0
17	43996483	.	G	A	20	22	42	0	1	43	0	0
17	43996485	.	G	A	22	22	44	0	0	44	0	0
17	43996620	.	A	T	18	21	39	0	1	40	0	0
17	43996667	.	G	A	17	18	35	0	1	36	0	0
17	44001540	.	A	G	21	16	37	0	2	39	0	0
17	44001584	.	T	C	17	19	36	0	2	38	0	0
17	44002032	.	A	T	11	11	22	0	2	24	0	0
17	44006088	.	C	T	0	3	3	0	3	6	0	0
17	44006654	.	A	G	5	2	7	0	0	7	0	0
17	44007047	.	A	T	3	1	4	0	1	5	0	0
17	44046144	.	G	A	2	2	4	0	0	4	0	0
17	44413980	.	G	A	4	7	11	0	2	13	0	0
17	44414030	.	A	G	4	6	10	0	0	10	0	0
17	44420201	.	G	A	7	5	12	0	0	12	0	0
17	44420406	.	T	C	1	6	7	0	0	7	0	0
17	44420602	.	G	A	4	1	5	0	1	6	0	0
17	44443867	.	T	C	2	6	8	0	0	8	0	0
17	44443885	.	A	T	3	3	6	0	0	6	0	0
17	44443984	.	G	A	1	2	3	0	0	3	0	0
17	44444017	.	T	G	2	2	4	0	0	4	0	0
17	44451094	.	A	G	4	4	8	0	0	8	0	0
17	44453771	.	G	A	0	4	4	0	3	7	0	0
17	44463892	.	A	G	4	4	8	0	0	8	0	0
17	44463903	.	G	T	3	4	7	0	0	7	0	0
17	44473954	.	G	C	7	7	14	0	1	15	0	0
17	44474284	.	G	A	5	5	10	0	0	10	0	0
17	44474392	.	A	G	5	9	14	0	0	14	0	0
17	44474547	.	T	A	1	6	7	0	0	7	0	0
17	44474592	.	T	G	6	2	8	1	0	9	0	0
17	44474658	.	A	G	3	0	3	0	7	10	0	0
17	44475047	.	T	G	8	7	15	0	0	15	0	0
17	44475093	.	C	G	6	9	15	0	1	16	0	0
17	44475940	.	C	G	5	4	9	0	3	12	0	0
17	44476075	.	G	T	6	4	10	0	0	10	0	0
17	44502836	.	A	G	3	3	6	0	0	6	0	0
17	44539266	.	T	A	3	6	9	0	0	9	0	0
17	44540475	.	C	T	5	2	7	0	0	7	0	0
17	44542598	.	G	C	2	2	4	0	0	4	0	0
17	44756390	.	G	A	0	5	5	0	5	10	0	0
17	44756895	.	A	C	2	3	5	0	0	5	0	0
17	44756986	.	C	T	2	2	4	0	0	4	0	0
17	44760544	.	C	A	1	2	3	0	0	3	0	0
17	44760774	.	C	T	2	2	4	0	0	4	0	0
17	44760858	.	A	G	7	5	12	0	2	14	0	0
17	44761011	.	A	G	4	4	8	0	0	8	0	0
17	44761103	.	G	T	2	5	7	0	0	7	0	0
17	44761124	.	A	T	6	3	9	0	0	9	0	0
17	44761140	.	G	T	5	2	7	0	1	8	0	0
17	44761349	.	G	A	6	4	10	0	2	12	0	0
17	44761356	.	G	T	8	6	14	0	0	14	0	0
17	44761504	.	T	C	7	4	11	0	0	11	0	0
17	44761542	.	T	A	5	3	8	0	1	10	1	0
17	44768622	.	A	G	1	3	4	0	0	4	0	0
17	44776034	.	T	A	1	4	5	0	0	5	0	0
17	44865421	.	G	A	0	2	2	0	2	4	0	0
17	44873988	.	C	T	1	5	6	0	0	6	0	0
17	44884774	.	C	T	1	2	3	0	0	3	0	0
17	44884997	.	C	T	9	3	12	0	1	13	0	0
17	44899562	.	G	A	1	4	5	0	6	11	0	0
17	44911803	.	A	G	6	12	18	0	1	19	0	0
17	44921955	.	G	A	1	4	5	1	9	15	0	0
17	44921992	.	A	G	4	1	5	1	6	12	0	0
17	44922442	.	C	T	8	10	18	0	0	18	0	0
17	44922685	.	G	T	5	15	20	0	1	21	0	0
17	44922743	.	G	A	3	13	16	0	0	16	0	0
17	44922788	.	C	A	5	7	12	0	1	13	0	0
17	44922819	.	A	T	6	8	14	0	0	14	0	0
17	44922866	.	C	T	5	8	13	0	3	16	0	0
17	44923053	.	C	T	2	7	9	0	0	9	0	0
17	44923083	.	T	A	4	8	12	0	0	12	0	0
17	44923322	.	T	A	1	6	7	0	0	7	0	0
17	44923389	.	G	A	5	7	12	0	0	12	0	0
17	44923504	.	A	T	1	0	1	0	1	4	2	0
17	44923510	.	T	A	2	2	4	0	0	4	0	0
17	44923602	.	T	G	1	0	1	0	4	5	0	0
17	44962056	.	G	A	19	11	30	0	0	30	0	0
17	44962502	.	A	T	7	8	15	0	1	16	0	0
17	44962507	.	A	G	7	9	16	0	0	16	0	0
17	44962575	.	G	T	17	6	23	0	0	23	0	0
17	44962693	.	T	C	15	12	27	0	1	28	0	0
17	44962799	.	A	G	6	9	15	0	0	15	0	0
17	44962826	.	C	T	3	6	9	0	0	9	0	0
17	44962860	.	T	G	2	5	7	0	0	7	0	0
17	44962861	.	A	T	5	2	7	0	0	7	0	0
17	44962901	.	A	T	7	4	11	0	1	12	0	0
17	44967819	.	G	A	9	10	19	0	2	21	0	0
17	44968095	.	C	T	9	5	14	0	3	17	0	0
17	44981175	.	T	C	2	6	8	0	0	8	0	0
17	44981636	.	G	A	2	5	7	0	1	8	0	0
17	44981689	.	A	G	5	4	9	0	0	9	0	0
17	44981693	.	C	G	5	4	9	0	0	9	0	0
17	45002540	.	C	A	4	3	7	0	0	7	0	0
17	45002812	.	G	A	4	2	6	0	0	6	0	0
17	45005038	.	G	T	2	3	5	0	0	5	0	0
17	45010337	.	C	T	2	6	8	0	0	8	0	0
17	45010338	.	T	A	2	6	8	0	0	8	0	0
17	45018030	.	C	T	4	3	7	0	0	7	0	0
17	45018207	.	A	G	5	3	8	0	2	10	0	0
17	45022535	.	T	G	7	0	7	0	6	13	0	0
17	45028213	.	G	C	4	7	11	0	0	11	0	0
17	45028248	.	G	A	4	4	8	0	0	8	0	0
17	45028638	.	G	C	2	3	5	0	0	5	0	0
17	45028651	.	A	G	2	2	4	0	0	4	0	0
17	45073467	.	T	A	4	7	11	0	1	12	0	0
17	45073490	.	C	A	1	7	8	0	3	11	0	0
17	45076111	.	A	G	17	17	34	0	2	36	0	0
17	45082331	.	T	G	13	18	31	0	1	32	0	0
17	45082406	.	A	G	12	14	26	0	0	26	0	0
17	45082466	.	C	A	2	9	11	1	13	25	0	0
17	45085085	.	G	A	12	9	21	0	0	21	0	0
17	45085100	.	C	T	13	11	24	0	0	24	0	0
17	45093134	.	G	T	6	9	15	0	1	16	0	0
17	45093155	.	G	A	9	6	15	0	0	15	0	0
17	45099141	.	C	A	4	4	8	0	0	8	0	0
17	45106717	.	C	A	1	4	5	0	0	5	0	0
17	45138048	.	C	G	10	17	27	0	0	27	0	0
17	45138255	.	C	A	1	11	12	0	5	17	0	0
17	45138329	.	A	C	13	10	23	0	0	23	0	0
17	45138391	.	G	T	8	8	16	0	1	17	0	0
17	45138446	.	C	T	1	5	6	0	9	15	0	0
17	45138733	.	T	C	21	4	25	0	1	26	0	0
17	45138741	.	T	C	22	6	28	0	1	29	0	0
17	45139503	.	C	A	5	11	16	0	1	17	0	0
17	45139506	.	G	T	7	10	17	0	0	17	0	0
17	45139750	.	C	T	6	7	13	0	0	13	0	0
17	45139805	.	A	T	6	6	12	0	0	12	0	0
17	45139879	.	C	T	10	10	20	0	0	20	0	0
17	45139881	.	G	A	9	10	19	0	0	19	0	0
17	45145056	.	A	G	5	10	15	0	0	15	0	0
17	45145065	.	T	C	5	0	5	0	8	13	0	0
17	45145143	.	T	C	5	0	5	0	5	10	0	0
17	45148190	.	G	T	4	7	11	0	0	11	0	0
17	45148302	.	T	A	2	5	7	0	0	8	1	0
17	45148303	.	A	G	2	6	8	0	0	8	0	0
17	45216312	.	C	T	0	4	4	0	1	5	0	0
17	45216609	.	A	G	0	4	4	0	0	4	0	0
17	45216612	.	G	A	3	2	5	0	1	6	0	0
17	45254339	.	C	T	0	2	2	0	1	3	0	0
17	45295074	.	A	T	2	2	4	0	0	4	0	0
17	45302128	.	A	T	4	2	6	0	0	6	0	0
17	45302346	.	A	T	1	2	3	0	1	4	0	0
17	45348585	.	T	A	2	2	4	0	0	4	0	0
17	45348824	.	T	C	2	3	5	0	0	5	0	0
17	45349518	.	G	T	1	3	4	0	0	4	0	0
17	45350315	.	C	A	1	3	4	0	1	5	0	0
17	45350346	.	C	T	1	3	4	0	0	4	0	0
17	45352841	.	T	G	3	2	5	0	0	5	0	0
17	45362027	.	G	A	1	3	4	0	0	4	0	0
17	45402422	.	A	G	2	3	5	0	0	5	0	0
17	45402558	.	G	A	2	4	6	0	0	6	0	0
17	45402602	.	A	T	1	3	4	0	0	4	0	0
17	45402640	.	C	A	2	3	5	0	0	5	0	0
17	45455329	.	C	T	2	3	5	0	0	5	0	0
17	45474994	.	A	G	1	2	3	0	1	4	0	0
17	45482443	.	T	A	3	2	5	0	0	5	0	0
17	45532532	.	T	A	21	17	38	0	3	41	0	0
17	45532637	.	A	T	18	12	30	0	3	33	0	0
17	45639601	.	A	C	2	3	5	0	1	6	0	0
17	45646680	.	G	A	1	3	4	0	0	4	0	0
17	45732589	.	A	G	5	10	15	0	3	18	0	0
17	45732601	.	G	A	10	3	13	0	1	14	0	0
17	45732765	.	A	T	13	9	22	0	0	22	0	0
17	45732785	.	T	C	12	11	23	0	2	25	0	0
17	45732802	.	G	T	13	12	25	0	1	26	0	0
17	45733632	.	T	G	4	2	6	0	1	7	0	0
17	45733664	.	G	A	4	2	6	0	0	6	0	0
17	45733752	.	G	A	7	4	11	0	0	11	0	0
17	45734170	.	A	G	5	5	10	1	0	11	0	0
17	45744129	.	C	G	2	1	3	0	0	3	0	0
17	45744138	.	C	T	2	2	4	0	0	4	0	0
17	45748014	.	A	G	2	0	2	0	3	5	0	0
17	45751385	.	C	T	5	5	10	0	0	10	0	0
17	45756547	.	C	T	5	6	11	0	1	12	0	0
17	45759087	.	C	T	2	9	11	0	1	12	0	0
17	45762487	.	G	A	5	8	13	0	2	15	0	0
17	45765222	.	C	T	15	9	24	0	0	24	0	0
17	45774378	.	G	A	1	7	8	0	4	12	0	0
17	45774425	.	C	A	5	5	10	0	1	11	0	0
17	45987358	.	G	A	3	3	6	0	1	7	0	0
17	45988446	.	G	A	0	3	3	0	3	6	0	0
17	45988864	.	C	T	3	3	6	0	0	6	0	0
17	45988991	.	G	C	2	7	9	0	0	9	0	0
17	45989003	.	A	G	3	1	4	0	6	10	0	0
17	45989032	.	G	T	9	5	14	0	1	15	0	0
17	45989225	.	T	C	1	2	3	0	0	3	0	0
17	46387253	.	G	T	0	2	2	0	3	5	0	0
17	46457321	.	G	C	6	7	13	0	0	13	0	0
17	46457326	.	C	A	1	7	8	0	5	13	0	0
17	46852240	.	A	G	1	7	8	13	0	21	0	0
17	47135071	.	G	T	1	2	3	0	0	3	0	0
17	47169660	.	G	C	0	4	4	0	4	8	0	0
17	47175456	.	G	A	2	3	5	0	0	5	0	0
17	47175569	.	G	A	5	2	7	0	0	7	0	0
17	47188563	.	T	C	5	2	7	0	0	7	0	0
17	47188778	.	G	A	8	4	12	0	0	12	0	0
17	47188932	.	C	T	1	10	11	0	5	16	0	0
17	47188984	.	G	A	8	4	12	0	0	12	0	0
17	47189003	.	A	G	6	5	11	0	3	14	0	0
17	47189129	.	C	A	8	8	16	0	1	17	0	0
17	47189221	.	C	T	8	8	16	0	4	20	0	0
17	47189243	.	T	C	9	9	18	0	2	20	0	0
17	47189258	.	G	T	12	7	19	0	2	21	0	0
17	47189684	.	G	A	13	7	20	0	0	20	0	0
17	47189741	.	G	T	12	6	18	0	0	18	0	0
17	47189790	.	A	G	6	4	10	0	0	10	0	0
17	47189810	.	C	T	0	5	5	0	4	9	0	0
17	47189919	.	G	T	4	13	17	0	0	17	0	0
17	47189937	.	T	A	7	13	20	0	0	20	0	0
17	47190032	.	C	T	10	9	19	0	0	19	0	0
17	47190045	.	C	A	1	8	9	0	9	18	0	0
17	47190118	.	A	G	11	5	16	0	0	16	0	0
17	47190149	.	G	C	5	3	8	0	1	9	0	0
17	47190492	.	G	A	5	2	7	0	0	7	0	0
17	47190892	.	T	C	3	1	4	0	5	9	0	0
17	47190904	.	G	A	2	7	9	0	1	10	0	0
17	47190967	.	T	G	4	10	14	0	1	15	0	0
17	47191101	.	A	G	2	4	6	1	1	8	0	0
17	47191842	.	T	C	4	2	6	0	0	6	0	0
17	47192047	.	T	C	3	4	7	0	0	7	0	0
17	47192178	.	C	T	2	5	7	0	0	7	0	0
17	47192332	.	T	C	1	2	3	0	0	3	0	0
17	47192368	.	T	C	2	2	4	0	0	4	0	0
17	47192642	.	G	A	1	5	6	0	1	7	0	0
17	47192651	.	G	C	1	3	4	0	0	4	0	0
17	47192755	.	C	T	1	2	3	0	0	3	0	0
17	47193180	.	T	A	1	4	5	0	2	7	0	0
17	47193200	.	A	G	1	7	8	0	0	8	0	0
17	47193313	.	T	C	1	7	8	0	1	9	0	0
17	47193359	.	T	G	3	4	7	0	2	9	0	0
17	47193651	.	A	G	1	5	6	0	0	6	0	0
17	47193692	.	C	T	2	5	7	0	0	7	0	0
17	47193995	.	T	C	3	2	5	0	1	6	0	0
17	47196179	.	G	C	4	2	6	0	0	6	0	0
17	47196584	.	T	G	1	3	4	0	0	4	0	0
17	47196587	.	G	A	1	3	4	0	0	4	0	0
17	48758996	.	T	C	1	6	7	0	0	7	0	0
17	48906437	.	G	C	4	10	14	0	0	14	0	0
17	48908803	.	C	T	4	5	9	0	15	24	0	0
17	48911097	.	T	G	2	3	5	1	1	7	0	0
17	48911441	.	G	A	4	6	10	0	1	11	0	0
17	48911442	.	T	A	4	6	10	0	0	10	0	0
17	48915349	.	T	C	9	3	12	0	0	12	0	0
17	48915387	.	A	T	6	10	16	0	1	17	0	0
17	48922267	.	T	A	2	2	4	0	0	4	0	0
17	49008376	.	A	G	5	3	8	0	0	8	0	0
17	49011627	.	T	C	2	3	5	0	0	5	0	0
17	49014085	.	A	G	5	2	7	0	1	8	0	0
17	49014663	.	G	T	0	7	7	0	7	14	0	0
17	49018023	.	G	A	0	7	7	0	9	16	0	0
17	49018107	.	C	T	8	8	16	0	2	18	0	0
17	49018113	.	A	T	7	10	17	0	2	19	0	0
17	49018164	.	A	C	9	13	22	0	1	23	0	0
17	49018508	.	C	G	11	13	24	0	1	25	0	0
17	49018899	.	C	T	9	14	23	0	1	24	0	0
17	49018935	.	A	C	18	11	29	0	2	31	0	0
17	49019101	.	T	C	14	18	32	0	1	33	0	0
17	49019288	.	A	C	18	16	34	0	3	37	0	0
17	49019299	.	A	T	14	15	29	0	10	39	0	0
17	49019380	.	G	A	1	12	13	0	6	19	0	0
17	49137355	.	G	A	0	2	2	0	1	3	0	0
17	49208766	.	C	T	2	3	5	0	2	7	0	0
17	49208775	.	A	T	2	5	7	0	2	9	0	0
17	49212630	.	G	C	1	4	5	0	3	8	0	0
17	49217106	.	T	A	4	3	7	0	0	7	0	0
17	49217209	.	G	A	1	4	5	0	5	10	0	0
17	49217466	.	T	C	6	7	13	0	1	14	0	0
17	49217507	.	C	T	5	7	12	0	0	12	0	0
17	49217577	.	C	T	4	9	13	0	0	13	0	0
17	49217658	.	G	T	6	5	11	0	0	11	0	0
17	49217703	.	C	A	11	7	18	0	1	19	0	0
17	49217887	.	A	G	5	5	10	1	2	13	0	0
17	49306423	.	C	A	1	2	3	0	1	4	0	0
17	49306425	.	C	T	1	1	2	0	2	4	0	0
17	49326075	.	A	G	1	2	3	0	0	3	0	0
17	49416327	.	T	C	16	12	28	0	2	30	0	0
17	49416396	.	G	T	11	9	20	0	0	20	0	0
17	49418225	.	G	A	6	4	10	0	1	11	0	0
17	49418765	.	G	A	2	2	4	0	0	4	0	0
17	49418792	.	C	T	2	2	4	0	0	4	0	0
17	49419182	.	T	A	4	1	5	0	1	6	0	0
17	49419188	.	C	T	4	2	6	0	1	7	0	0
17	49419247	.	T	C	2	3	5	0	0	5	0	0
17	49419590	.	T	C	1	3	4	0	0	4	0	0
17	49419761	.	G	T	3	4	7	0	0	7	0	0
17	49420049	.	T	G	3	3	6	0	0	6	0	0
17	49420454	.	A	T	1	2	3	0	0	3	0	0
17	49420565	.	A	C	1	0	1	0	4	5	0	0
17	49481635	.	C	G	7	8	15	0	1	16	0	0
17	49481638	.	T	C	8	0	8	0	7	15	0	0
17	49485275	.	A	C	1	2	3	0	0	3	0	0
17	49503632	.	G	A	4	3	7	0	0	7	0	0
17	49503647	.	C	T	5	2	7	0	1	8	0	0
17	49503940	.	G	A	1	3	4	0	1	5	0	0
17	49507155	.	C	T	5	2	7	0	0	7	0	0
17	49509606	.	G	A	6	4	10	0	0	10	0	0
17	49518977	.	C	T	4	4	8	0	0	8	0	0
17	49519061	.	C	T	4	7	11	0	1	12	0	0
17	49519070	.	T	A	4	8	12	0	0	12	0	0
17	49522248	.	G	A	6	11	17	0	2	19	0	0
17	49526584	.	T	C	9	17	26	0	0	26	0	0
17	49526839	.	A	G	8	5	13	0	0	13	0	0
17	49527099	.	T	G	5	2	7	0	0	7	0	0
17	49527115	.	T	C	2	4	6	0	0	6	0	0
17	49527357	.	A	T	5	3	8	0	0	8	0	0
17	49528082	.	C	G	11	10	21	0	0	21	0	0
17	49528291	.	A	G	15	0	15	0	18	33	0	0
17	49631901	.	G	C	1	3	4	0	0	4	0	0
17	49632191	.	A	G	3	4	7	0	0	7	0	0
17	49632693	.	C	A	3	3	6	0	0	6	0	0
17	49641136	.	A	G	5	3	8	0	1	9	0	0
17	49641698	.	T	C	1	4	5	0	0	5	0	0
17	49786285	.	C	T	0	2	2	0	1	3	0	0
17	49983202	.	A	T	10	10	20	0	0	20	0	0
17	49983273	.	C	T	25	19	44	0	2	46	0	0
17	49983315	.	C	T	34	20	54	0	0	54	0	0
17	49992629	.	G	A	31	30	61	0	1	62	0	0
17	49998171	.	T	C	16	15	31	0	1	32	0	0
17	49998221	.	G	A	23	9	32	0	3	35	0	0
17	49998658	.	G	A	7	5	12	0	1	13	0	0
17	49998734	.	G	A	18	11	29	0	0	29	0	0
17	49998804	.	C	A	17	22	39	0	4	43	0	0
17	49999037	.	G	T	22	18	40	0	2	42	0	0
17	50002381	.	A	G	22	20	42	0	0	42	0	0
17	50007340	.	G	A	7	5	12	0	0	12	0	0
17	50009829	.	T	C	8	0	8	0	5	13	0	0
17	50009832	.	T	A	6	6	12	0	1	13	0	0
17	50010078	.	T	C	10	9	19	0	1	20	0	0
17	50010087	.	C	A	1	10	11	0	9	20	0	0
17	50099985	.	A	C	1	4	5	0	0	5	0	0
17	50100027	.	C	T	2	4	6	0	1	7	0	0
17	50101438	.	C	A	3	3	6	0	0	6	0	0
17	50107391	.	G	A	2	6	8	0	0	8	0	0
17	50110391	.	G	T	1	5	6	0	0	6	0	0
17	50110461	.	G	A	2	5	7	0	0	7	0	0
17	50110479	.	C	G	2	3	5	0	0	5	0	0
17	50110574	.	A	G	4	0	4	0	3	7	0	0
17	50110838	.	C	T	1	2	3	0	0	3	0	0
17	50111304	.	A	C	1	5	6	3	1	10	0	0
17	50111397	.	A	G	3	9	12	0	0	12	0	0
17	50111497	.	A	G	3	0	3	0	2	5	0	0
17	50111528	.	A	G	2	4	6	0	1	7	0	0
17	50111549	.	A	G	4	5	9	0	0	9	0	0
17	50111573	.	C	T	13	4	17	0	0	17	0	0
17	50111680	.	A	T	2	4	6	2	0	8	0	0
17	50112145	.	A	C	6	3	9	0	0	9	0	0
17	50112153	.	T	C	5	2	7	0	1	8	0	0
17	50113141	.	G	A	6	10	16	0	0	16	0	0
17	50113148	.	C	T	11	6	17	0	1	18	0	0
17	50113196	.	G	A	1	7	8	0	6	14	0	0
17	50113336	.	C	T	1	2	3	0	3	6	0	0
17	50113404	.	C	T	4	8	12	0	1	13	0	0
17	50141759	.	A	T	2	3	5	0	0	5	0	0
17	50141806	.	A	G	3	0	3	0	4	7	0	0
17	50141904	.	A	T	7	7	14	0	1	15	0	0
17	50172581	.	T	G	5	9	14	0	0	14	0	0
17	50176483	.	G	A	8	3	11	0	1	12	0	0
17	50176519	.	C	A	9	7	16	0	1	17	0	0
17	50180672	.	C	T	14	7	21	0	1	22	0	0
17	50185665	.	T	A	9	7	16	0	0	16	0	0
17	50185841	.	A	T	15	11	26	0	0	26	0	0
17	50185930	.	T	C	19	10	29	0	1	30	0	0
17	50185964	.	G	A	1	8	9	0	18	27	0	0
17	50186011	.	G	A	1	13	14	0	6	20	0	0
17	50186097	.	G	A	4	4	8	0	3	11	0	0
17	50186146	.	T	G	9	0	9	0	1	10	0	0
17	50229135	.	A	C	7	13	20	0	3	23	0	0
17	50229301	.	G	T	4	16	20	0	0	20	0	0
17	50229718	.	A	G	5	18	23	0	0	23	0	0
17	50245580	.	G	A	12	15	27	0	2	29	0	0
17	50245673	.	T	C	27	20	47	0	2	49	0	0
17	50245715	.	C	G	20	25	45	0	1	47	1	0
17	50245772	.	C	T	11	24	35	0	1	36	0	0
17	50247886	.	T	C	17	0	17	0	21	38	0	0
17	50247988	.	A	T	11	5	16	0	0	16	0	0
17	50275229	.	C	A	6	3	9	0	0	9	0	0
17	50278271	.	G	A	6	3	9	0	1	10	0	0
17	50278808	.	C	T	10	8	18	0	0	18	0	0
17	50278884	.	C	A	8	5	13	0	1	14	0	0
17	50284899	.	T	A	18	11	29	0	0	29	0	0
17	50285009	.	A	T	9	9	18	0	2	20	0	0
17	50285052	.	C	T	7	4	11	0	0	11	0	0
17	50285221	.	A	T	9	11	20	0	0	20	0	0
17	50415806	.	G	A	2	3	5	2	0	7	0	0
17	50415844	.	C	T	3	5	8	0	0	8	0	0
17	50415948	.	G	A	9	1	10	0	0	10	0	0
17	50416052	.	C	G	2	3	5	0	0	5	0	0
17	50416238	.	C	T	0	3	3	0	5	8	0	0
17	50416269	.	C	T	0	3	3	0	6	9	0	0
17	50416456	.	C	T	2	4	6	0	0	6	0	0
17	50416525	.	A	G	1	2	3	0	0	3	0	0
17	50416660	.	T	G	3	2	5	0	0	5	0	0
17	50416789	.	G	A	2	2	4	0	0	4	0	0
17	50416814	.	G	A	4	4	8	0	0	8	0	0
17	50417534	.	C	T	2	2	4	0	0	4	0	0
17	50417537	.	C	T	2	2	4	0	0	4	0	0
17	50424455	.	T	C	2	0	2	0	6	8	0	0
17	50424555	.	A	T	8	7	15	0	0	15	0	0
17	50424556	.	A	T	8	7	15	0	0	15	0	0
17	50424596	.	A	T	8	13	21	0	0	21	0	0
17	50424662	.	A	G	7	11	18	3	0	21	0	0
17	50424663	.	A	G	7	11	18	3	0	21	0	0
17	50424697	.	A	G	3	13	16	3	3	22	0	0
17	50424961	.	T	A	1	6	7	0	0	7	0	0
17	50425171	.	A	T	2	7	9	0	0	9	0	0
17	50425321	.	C	T	1	4	5	0	0	5	0	0
17	50425478	.	C	T	1	2	3	0	0	3	0	0
17	50425488	.	A	G	1	3	4	0	0	4	0	0
17	50425899	.	A	G	3	2	5	0	0	5	0	0
17	50426092	.	C	T	2	2	4	1	0	5	0	0
17	50426194	.	C	A	1	2	3	0	0	3	0	0
17	50434860	.	A	T	1	2	3	0	0	3	0	0
17	50450634	.	T	C	1	2	3	0	0	3	0	0
17	50460694	.	G	A	1	2	3	0	0	3	0	0
17	50657321	.	T	C	2	3	5	0	0	5	0	0
17	50664473	.	A	C	3	3	6	0	0	6	0	0
17	50682945	.	C	T	7	7	14	0	0	14	0	0
17	50688480	.	T	C	3	6	9	0	1	10	0	0
17	50689198	.	T	C	4	10	14	0	0	14	0	0
17	50689755	.	G	A	1	4	5	1	5	11	0	0
17	50689787	.	T	A	3	3	6	0	1	7	0	0
17	50689811	.	A	C	3	4	7	0	0	7	0	0
17	50689842	.	A	G	5	6	11	0	0	11	0	0
17	50839928	.	C	T	3	3	6	0	0	6	0	0
17	50840213	.	A	G	1	0	1	1	2	4	0	0
17	50840215	.	A	G	1	2	3	1	0	4	0	0
17	50840942	.	G	A	4	2	6	0	0	6	0	0
17	50840948	.	A	T	2	2	4	0	1	5	0	0
17	50976567	.	C	T	4	11	15	0	1	16	0	0
17	51020214	.	A	G	8	12	20	0	2	22	0	0
17	51080149	.	G	A	1	2	3	0	0	3	0	0
17	51206396	.	G	A	16	13	29	0	2	31	0	0
17	51206825	.	T	C	16	0	16	0	16	32	0	0
17	51206851	.	T	C	21	10	31	0	1	32	0	0
17	51206951	.	T	A	11	11	22	0	1	23	0	0
17	51207200	.	G	C	9	5	14	0	3	17	0	0
17	51209442	.	G	A	16	10	26	0	0	26	0	0
17	51213963	.	C	T	6	6	12	0	0	12	0	0
17	51214302	.	C	T	1	5	6	0	0	6	0	0
17	51218418	.	G	A	1	3	4	0	0	4	0	0
17	51224484	.	G	A	0	3	3	0	4	7	0	0
17	51226879	.	C	T	3	8	11	0	0	11	0	0
17	51229135	.	T	A	2	3	5	0	0	5	0	0
17	51229206	.	C	T	4	6	10	0	0	10	0	0
17	51229397	.	C	A	4	2	6	0	0	6	0	0
17	51229413	.	T	C	3	2	5	0	1	6	0	0
17	51229451	.	A	G	3	4	7	0	0	7	0	0
17	51229725	.	C	T	1	2	3	0	1	4	0	0
17	51231538	.	T	C	7	9	16	0	1	17	0	0
17	51231980	.	T	C	4	14	18	0	1	19	0	0
17	51232083	.	T	C	5	3	8	0	0	8	0	0
17	51232107	.	T	C	4	5	9	0	0	9	0	0
17	51232193	.	T	C	3	3	6	0	0	6	0	0
17	51232329	.	C	T	3	3	6	0	1	7	0	0
17	51232360	.	C	A	5	2	7	0	2	9	0	0
17	51232533	.	T	C	8	3	11	0	0	11	0	0
17	51232759	.	C	T	3	17	20	0	18	38	0	0
17	51253919	.	T	C	6	4	10	0	0	10	0	0
17	51256927	.	C	T	0	2	2	0	2	4	0	0
17	51256933	.	C	G	2	2	4	0	0	4	0	0
17	51257013	.	A	G	2	4	6	0	0	6	0	0
17	51257053	.	G	A	3	3	6	0	0	6	0	0
17	51257376	.	C	T	0	4	4	0	2	6	0	0
17	51276021	.	G	A	3	4	7	0	5	12	0	0
17	51301246	.	T	C	9	8	17	0	0	17	0	0
17	51303112	.	C	T	8	16	24	0	0	24	0	0
17	51303241	.	G	A	14	8	22	0	2	24	0	0
17	51305458	.	G	C	11	9	20	0	0	20	0	0
17	51313994	.	C	T	0	2	2	0	1	3	0	0
17	51314002	.	G	C	1	2	3	0	0	3	0	0
17	51682501	.	T	A	1	3	4	0	0	4	0	0
17	51708541	.	G	A	0	6	6	0	3	9	0	0
17	51711040	.	A	G	4	5	9	0	0	9	0	0
17	51711184	.	C	A	3	8	11	0	0	11	0	0
17	51711194	.	C	A	8	4	12	0	0	12	0	0
17	51711268	.	G	A	1	3	4	0	4	8	0	0
17	51715641	.	G	A	5	6	11	0	0	11	0	0
17	51720064	.	G	C	3	2	5	0	0	5	0	0
17	51720176	.	C	T	8	2	10	0	2	12	0	0
17	51720177	.	A	T	9	2	11	0	1	12	0	0
17	51720462	.	T	A	2	2	4	0	0	4	0	0
17	51720566	.	A	G	4	2	6	0	0	6	0	0
17	51720615	.	T	C	2	3	5	0	1	6	0	0
17	51720710	.	A	G	3	0	3	0	2	5	0	0
17	51749051	.	G	T	5	4	9	0	1	11	1	0
17	51749545	.	G	T	0	7	7	0	5	12	0	0
17	51752790	.	A	G	6	8	14	0	2	16	0	0
17	51753138	.	T	G	10	11	21	0	0	21	0	0
17	51757010	.	G	A	12	13	25	0	2	27	0	0
17	51757380	.	T	G	7	4	11	0	0	11	0	0
17	51757387	.	A	T	5	3	8	0	1	9	0	0
17	51780543	.	G	A	1	2	3	0	0	3	0	0
17	51789069	.	T	C	3	3	6	0	0	6	0	0
17	51789079	.	T	G	2	0	2	0	3	5	0	0
17	51789108	.	A	G	1	0	1	0	4	5	0	0
17	51797004	.	G	A	7	5	12	0	0	12	0	0
17	51797015	.	T	C	9	0	9	0	5	14	0	0
17	51797145	.	A	G	3	4	7	0	1	8	0	0
17	51797223	.	G	A	5	5	10	0	1	11	0	0
17	51797333	.	A	G	5	5	10	0	0	10	0	0
17	51797782	.	C	T	8	7	15	0	4	20	1	0
17	51797788	.	T	A	5	11	16	0	5	21	0	0
17	51797863	.	G	A	7	4	11	1	1	13	0	0
17	51804037	.	G	A	2	2	4	0	1	5	0	0
17	51806043	.	C	T	1	2	3	0	4	7	0	0
17	51822481	.	G	A	4	3	7	0	3	10	0	0
17	51823152	.	A	G	9	5	14	0	0	14	0	0
17	51823483	.	C	T	15	9	24	1	0	25	0	0
17	51823495	.	G	A	16	5	21	1	0	22	0	0
17	51823568	.	G	A	16	5	21	0	3	24	0	0
17	51823841	.	C	A	3	6	9	0	1	10	0	0
17	51823989	.	G	T	7	4	11	1	1	13	0	0
17	51824046	.	C	T	8	4	12	0	1	13	0	0
17	51824061	.	G	A	6	4	10	0	1	11	0	0
17	51824081	.	A	C	2	5	7	0	3	10	0	0
17	51824306	.	T	C	8	4	12	0	0	12	0	0
17	51824510	.	T	C	3	2	5	0	1	6	0	0
17	51824513	.	T	C	2	2	4	0	2	6	0	0
17	51824803	.	T	C	8	2	10	0	0	10	0	0
17	51825059	.	A	T	5	3	8	0	1	9	0	0
17	51825086	.	A	G	4	8	12	0	0	12	0	0
17	51825094	.	G	A	2	9	11	0	1	12	0	0
17	51825138	.	C	T	0	7	7	0	9	16	0	0
17	51825161	.	T	C	9	5	14	0	0	14	0	0
17	51825205	.	T	G	12	4	16	0	0	16	0	0
17	51825225	.	T	C	5	3	8	0	4	12	0	0
17	51825421	.	T	G	4	6	10	0	0	10	0	0
17	51825455	.	A	G	5	7	12	0	0	12	0	0
17	51825576	.	A	C	6	0	6	0	7	13	0	0
17	51825969	.	A	T	2	4	6	0	2	8	0	0
17	51826025	.	G	T	3	2	5	0	1	6	0	0
17	51826149	.	A	C	4	0	4	0	5	9	0	0
17	51826172	.	T	C	3	0	3	0	4	7	0	0
17	52036940	.	G	A	0	2	2	0	1	3	0	0
17	52059149	.	T	C	1	0	1	0	2	3	0	0
17	52063172	.	T	C	2	3	5	0	0	5	0	0
17	52076230	.	C	A	1	2	3	0	0	3	0	0
17	52528662	.	G	C	9	10	19	0	1	20	0	0
17	52533036	.	C	G	13	9	22	0	0	22	0	0
17	52533073	.	C	T	4	17	21	0	2	23	0	0
17	52534241	.	G	A	1	12	13	0	18	31	0	0
17	52534343	.	G	A	13	13	26	1	4	31	0	0
17	52541342	.	G	A	1	12	13	0	14	27	0	0
17	52553107	.	C	A	17	25	42	0	2	44	0	0
17	52553141	.	T	C	19	17	36	0	2	38	0	0
17	52553270	.	G	A	18	29	47	0	1	48	0	0
17	52566100	.	C	T	1	4	5	0	3	8	0	0
17	52566423	.	T	C	2	0	2	0	5	7	0	0
17	52566925	.	A	G	2	5	7	0	0	7	0	0
17	52568040	.	A	C	2	0	2	0	2	4	0	0
17	52574059	.	G	A	1	2	3	0	0	3	0	0
17	52574077	.	G	A	1	3	4	0	0	4	0	0
17	52578489	.	A	G	3	3	6	0	0	6	0	0
17	52578491	.	A	G	3	3	6	0	0	6	0	0
17	52624758	.	A	G	2	2	4	0	0	4	0	0
17	52624926	.	T	G	2	3	5	0	0	5	0	0
17	52630641	.	A	G	4	5	9	0	0	9	0	0
17	52630752	.	A	C	3	0	3	1	8	12	0	0
17	52630796	.	G	A	4	2	6	0	1	7	0	0
17	52630810	.	C	T	10	1	11	0	0	11	0	0
17	52630907	.	A	T	4	5	9	0	0	9	0	0
17	52632139	.	A	G	8	9	17	0	3	20	0	0
17	52632151	.	G	C	10	10	20	0	0	20	0	0
17	52635258	.	A	G	4	6	10	0	0	10	0	0
17	52635261	.	C	T	0	7	7	0	4	11	0	0
17	52635954	.	C	T	0	7	7	0	6	13	0	0
17	52636829	.	C	T	6	8	14	0	0	14	0	0
17	52636831	.	C	G	7	8	15	0	0	15	0	0
17	52639729	.	C	T	1	15	16	0	18	34	0	0
17	52640311	.	G	A	30	22	52	0	0	52	0	0
17	52640385	.	G	C	19	25	44	0	6	50	0	0
17	52640419	.	C	T	3	19	22	0	25	47	0	0
17	52640540	.	C	T	1	28	29	0	16	45	0	0
17	52640645	.	T	G	14	22	36	0	1	37	0	0
17	52641091	.	A	T	10	21	31	0	1	32	0	0
17	52641571	.	C	T	11	11	22	0	1	23	0	0
17	52641724	.	A	C	18	13	31	0	1	32	0	0
17	52641751	.	G	C	14	0	14	0	18	32	0	0
17	52650878	.	G	C	6	15	21	0	1	22	0	0
17	52856614	.	T	C	23	20	43	0	2	45	0	0
17	52920792	.	C	T	31	21	52	2	4	58	0	0
17	52940710	.	T	C	3	2	5	0	1	6	0	0
17	52983924	.	A	G	0	2	2	0	1	3	0	0
17	53186659	.	T	C	2	3	5	0	0	5	0	0
17	53197042	.	G	T	1	4	5	0	0	5	0	0
17	53250861	.	C	T	3	5	8	0	1	9	0	0
17	53250909	.	G	A	0	3	3	0	2	5	0	0
17	53298000	.	C	G	1	0	1	0	5	6	0	0
17	53298033	.	C	T	3	3	6	0	0	6	0	0
17	53298051	.	G	A	3	2	5	0	1	6	0	0
17	53299220	.	G	A	0	7	7	0	3	10	0	0
17	53299346	.	G	T	1	5	6	0	0	6	0	0
17	53299485	.	T	C	3	6	9	0	0	9	0	0
17	53302527	.	T	C	5	4	9	0	1	10	0	0
17	53303258	.	G	A	1	5	6	0	7	13	0	0
17	53303980	.	G	C	7	7	14	0	3	17	0	0
17	53304127	.	G	C	4	3	7	0	2	9	0	0
17	53304566	.	G	A	7	6	13	1	1	15	0	0
17	53304635	.	A	T	12	8	20	0	0	20	0	0
17	53304786	.	T	A	0	6	6	0	0	6	0	0
17	53305318	.	G	C	6	17	23	0	2	25	0	0
17	53305327	.	C	T	8	11	19	0	5	24	0	0
17	53307580	.	C	G	21	10	31	0	0	31	0	0
17	53308737	.	T	C	13	12	25	1	0	26	0	0
17	53308820	.	C	T	2	7	9	0	1	10	0	0
17	53314419	.	G	A	2	3	5	0	1	6	0	0
17	53315604	.	G	A	9	5	14	0	0	14	0	0
17	53315750	.	C	G	4	9	13	0	1	14	0	0
17	53317065	.	C	T	7	6	13	0	1	14	0	0
17	53317123	.	T	C	8	6	14	0	0	14	0	0
17	53317175	.	G	A	0	4	4	0	9	13	0	0
17	53317728	.	A	G	1	4	5	0	0	5	0	0
17	53317844	.	G	A	1	5	6	0	5	11	0	0
17	53317917	.	A	G	3	4	7	0	0	7	0	0
17	53346600	.	G	A	2	5	7	0	0	7	0	0
17	53346648	.	C	A	3	3	6	0	0	6	0	0
17	53393165	.	G	A	19	16	35	0	0	35	0	0
18	73543	.	T	A	1	5	6	0	0	6	0	0
18	97762	.	G	A	1	4	5	0	1	6	0	0
18	298740	.	C	T	5	4	9	0	0	9	0	0
18	302902	.	C	T	10	8	18	0	2	20	0	0
18	303136	.	G	T	1	5	6	0	3	9	0	0
18	316039	.	C	T	11	9	20	0	0	20	0	0
18	318821	.	T	C	8	11	19	0	0	19	0	0
18	318824	.	C	T	8	12	20	0	0	20	0	0
18	319731	.	G	A	7	6	13	0	0	13	0	0
18	321802	.	T	C	8	8	16	0	1	17	0	0
18	321820	.	C	T	10	6	16	0	1	17	0	0
18	321934	.	C	T	10	6	16	0	0	16	0	0
18	323840	.	G	A	2	8	10	0	6	16	0	0
18	324190	.	T	C	10	7	17	0	0	17	0	0
18	324243	.	G	A	9	5	14	0	1	15	0	0
18	324317	.	G	A	10	7	17	0	0	17	0	0
18	324325	.	A	G	10	7	17	0	0	17	0	0
18	324380	.	T	G	9	12	21	0	1	22	0	0
18	324409	.	C	T	14	10	24	0	2	26	0	0
18	324465	.	T	C	15	16	31	0	2	33	0	0
18	324692	.	A	T	12	15	27	0	0	27	0	0
18	324834	.	T	G	17	0	17	0	14	31	0	0
18	324835	.	G	T	18	12	30	0	2	32	0	0
18	325044	.	A	G	19	24	43	0	0	43	0	0
18	325189	.	C	T	23	23	46	0	5	51	0	0
18	325290	.	G	A	3	20	23	0	23	46	0	0
18	325312	.	G	T	26	21	47	0	0	47	0	0
18	325407	.	T	G	17	20	37	0	0	37	0	0
18	328733	.	A	G	4	5	9	0	0	9	0	0
18	328795	.	G	C	8	3	11	0	1	12	0	0
18	330474	.	A	G	8	10	18	0	0	18	0	0
18	333765	.	T	C	7	6	13	0	0	13	0	0
18	334018	.	C	T	9	5	14	0	2	16	0	0
18	334049	.	A	T	12	8	20	0	0	20	0	0
18	334298	.	T	C	5	8	13	0	1	14	0	0
18	334313	.	C	T	1	6	7	0	10	17	0	0
18	334431	.	T	G	11	3	14	0	0	14	0	0
18	334560	.	T	C	4	4	8	0	1	9	0	0
18	334634	.	G	A	9	4	13	0	0	13	0	0
18	334872	.	C	T	1	5	6	0	2	8	0	0
18	334876	.	T	A	6	2	8	0	0	8	0	0
18	334968	.	G	A	3	2	5	0	1	6	0	0
18	336607	.	T	G	10	8	18	0	0	18	0	0
18	606232	.	A	G	3	0	3	0	3	6	0	0
18	606277	.	A	T	7	5	12	1	0	13	0	0
18	606305	.	C	T	5	3	8	1	0	9	0	0
18	609365	.	A	G	3	5	8	0	0	8	0	0
18	609545	.	T	A	5	4	9	0	0	9	0	0
18	609559	.	C	A	3	3	6	0	0	6	0	0
18	609658	.	T	A	11	6	17	0	0	17	0	0
18	609667	.	C	G	10	5	15	0	1	16	0	0
18	609877	.	G	A	8	6	14	0	0	14	0	0
18	610327	.	A	G	3	1	4	0	8	12	0	0
18	610395	.	T	C	9	5	14	0	0	14	0	0
18	610397	.	T	C	9	5	14	0	0	14	0	0
18	610681	.	A	T	6	7	13	0	0	13	0	0
18	826451	.	C	T	3	2	5	0	2	7	0	0
18	939430	.	C	T	30	18	48	0	1	49	0	0
18	948938	.	C	T	35	26	61	3	6	70	0	0
18	950849	.	C	T	46	41	87	0	2	89	0	0
18	951327	.	T	C	29	35	64	0	8	72	0	0
18	951391	.	C	T	40	15	55	1	10	66	0	0
18	951536	.	C	T	10	18	28	0	4	32	0	0
18	955705	.	A	G	3	2	5	0	0	5	0	0
18	974067	.	C	A	1	2	3	0	0	3	0	0
18	1151566	.	C	T	0	2	2	0	2	4	0	0
18	1151618	.	A	C	2	2	4	0	0	4	0	0
18	1152125	.	T	C	3	4	7	0	1	8	0	0
18	1152141	.	A	C	3	0	3	0	3	6	0	0
18	1161054	.	T	A	16	20	36	0	2	38	0	0
18	1173819	.	G	A	22	18	40	0	3	43	0	0
18	1173856	.	G	A	25	23	48	0	2	50	0	0
18	1189420	.	G	A	18	17	35	0	1	36	0	0
18	1197218	.	G	T	14	8	22	0	1	23	0	0
18	1292083	.	C	G	9	11	20	0	0	20	0	0
18	1292668	.	T	C	10	0	10	0	13	23	0	0
18	1293121	.	G	A	11	10	21	0	2	23	0	0
18	1293182	.	G	A	8	7	15	0	0	15	0	0
18	1294572	.	T	C	6	0	6	0	5	11	0	0
18	1363189	.	G	A	2	3	5	0	0	5	0	0
18	2169254	.	A	T	1	2	3	0	0	3	0	0
18	2169260	.	C	A	1	2	3	0	0	3	0	0
18	2180285	.	A	G	2	2	4	0	0	4	0	0
18	2180603	.	A	G	2	4	6	0	0	6	0	0
18	2180636	.	C	T	3	5	8	0	0	8	0	0
18	2197638	.	A	C	1	3	4	0	0	4	0	0
18	2205302	.	T	A	3	5	8	0	0	8	0	0
18	2211091	.	T	C	6	4	10	0	2	12	0	0
18	2225632	.	C	T	7	8	15	0	2	17	0	0
18	2225661	.	C	T	15	6	21	0	0	21	0	0
18	2225947	.	T	C	1	3	4	0	1	5	0	0
18	2377645	.	T	C	11	0	11	0	16	27	0	0
18	2377860	.	G	A	13	3	16	0	2	18	0	0
18	2378495	.	T	A	7	4	11	0	1	12	0	0
18	2378510	.	C	A	2	7	9	0	0	9	0	0
18	2378687	.	A	C	8	4	12	0	1	13	0	0
18	2378713	.	T	G	6	7	13	0	2	15	0	0
18	2378722	.	C	T	1	5	6	0	8	14	0	0
18	2379073	.	G	A	1	3	4	1	2	7	0	0
18	2408886	.	G	A	8	8	16	0	2	18	0	0
18	2412660	.	T	C	7	5	12	0	0	12	0	0
18	2414993	.	T	C	3	5	8	0	1	9	0	0
18	2548878	.	G	A	2	2	4	0	0	4	0	0
18	2603576	.	T	G	7	5	12	0	0	12	0	0
18	2603786	.	A	G	3	6	9	0	0	9	0	0
18	2612259	.	A	G	6	5	11	0	0	11	0	0
18	2612293	.	A	G	4	7	11	0	0	11	0	0
18	2619228	.	A	G	4	4	8	0	0	8	0	0
18	2629272	.	G	C	2	6	8	0	0	8	0	0
18	2629347	.	A	G	4	2	6	0	0	6	0	0
18	2629415	.	C	T	2	4	6	0	0	6	0	0
18	2631290	.	A	G	3	3	6	0	1	7	0	0
18	2681965	.	G	A	10	8	18	0	1	19	0	0
18	2682182	.	C	T	0	9	9	0	20	29	0	0
18	2682203	.	A	T	21	7	28	0	1	29	0	0
18	2682610	.	T	C	13	17	30	0	0	30	0	0
18	2683085	.	T	C	3	0	3	1	3	7	0	0
18	2683137	.	A	T	4	2	6	2	0	8	0	0
18	2683143	.	G	A	4	2	6	2	0	8	0	0
18	2683175	.	T	G	6	4	10	2	0	12	0	0
18	2683181	.	C	T	6	4	10	2	1	13	0	0
18	2683365	.	G	T	0	8	8	0	0	8	0	0
18	2683988	.	T	C	3	3	6	0	0	6	0	0
18	2684456	.	T	C	3	4	7	0	0	7	0	0
18	2684458	.	A	G	3	4	7	0	0	7	0	0
18	2684589	.	T	C	6	0	6	0	4	10	0	0
18	2684731	.	A	C	1	3	4	0	1	5	0	0
18	2684750	.	G	A	1	2	3	0	0	3	0	0
18	2684872	.	A	G	14	7	21	0	1	22	0	0
18	2684889	.	A	T	12	6	18	0	0	18	0	0
18	2685263	.	A	G	11	10	21	0	1	22	0	0
18	2685297	.	A	G	11	5	16	0	0	16	0	0
18	2685312	.	G	A	7	4	11	0	0	11	0	0
18	2685348	.	C	T	0	2	2	0	12	14	0	0
18	2687992	.	C	T	9	4	13	0	1	14	0	0
18	2692381	.	A	C	2	5	7	0	1	8	0	0
18	2702458	.	G	A	11	3	14	0	0	14	0	0
18	2702524	.	C	T	8	6	14	0	1	15	0	0
18	2702536	.	A	G	6	6	12	0	3	15	0	0
18	2702569	.	C	T	1	5	6	0	8	14	0	0
18	2702888	.	T	C	4	1	5	0	8	13	0	0
18	2702976	.	A	C	1	7	8	0	1	9	0	0
18	2707108	.	G	A	1	6	7	0	1	8	0	0
18	2708467	.	G	A	1	3	4	0	1	5	0	0
18	2708505	.	C	T	2	3	5	0	0	5	0	0
18	2709395	.	G	A	2	2	4	0	0	4	0	0
18	2711894	.	C	G	1	6	7	0	0	7	0	0
18	2902985	.	A	G	2	0	2	0	4	6	0	0
18	2934938	.	C	T	7	2	9	0	2	11	0	0
18	2935480	.	C	T	6	9	15	0	0	15	0	0
18	3006843	.	C	T	3	2	5	0	1	6	0	0
18	3039440	.	A	G	34	34	68	0	2	70	0	0
18	3049752	.	T	G	30	16	46	0	3	49	0	0
18	3049756	.	A	G	18	24	42	0	4	46	0	0
18	3049869	.	G	A	0	6	6	0	1	7	0	0
18	3049973	.	A	G	1	0	1	0	4	5	0	0
18	3078582	.	C	T	5	2	7	0	0	7	0	0
18	3078672	.	C	T	1	6	7	0	1	8	0	0
18	3087662	.	G	A	2	4	6	0	0	6	0	0
18	3087695	.	T	G	3	3	6	0	0	6	0	0
18	3087704	.	T	A	3	3	6	0	1	7	0	0
18	3087776	.	G	A	5	4	9	0	0	9	0	0
18	3089906	.	T	C	1	3	4	0	2	6	0	0
18	3096656	.	T	A	3	2	5	0	0	5	0	0
18	3096739	.	C	T	1	2	3	0	0	3	0	0
18	3096873	.	G	A	3	3	6	0	1	7	0	0
18	3096914	.	A	C	2	2	4	0	0	4	0	0
18	3096926	.	C	T	2	2	4	0	0	4	0	0
18	3100651	.	A	G	2	14	16	0	0	16	0	0
18	3140747	.	G	A	4	3	7	0	0	7	0	0
18	3140800	.	G	A	0	2	2	0	4	6	0	0
18	3142685	.	A	G	12	5	17	1	1	19	0	0
18	3144677	.	G	A	2	9	11	0	11	22	0	0
18	3144742	.	A	T	7	8	15	0	0	15	0	0
18	3153072	.	G	C	5	11	16	0	1	17	0	0
18	3158375	.	C	T	0	2	2	0	2	4	0	0
18	3158739	.	A	G	11	13	24	0	0	24	0	0
18	3158776	.	G	A	12	7	19	0	2	21	0	0
18	3158896	.	C	T	4	3	7	2	1	10	0	0
18	3159140	.	C	A	3	4	7	0	1	8	0	0
18	3159249	.	C	A	4	3	7	0	0	7	0	0
18	3159324	.	C	G	4	3	7	0	0	7	0	0
18	3159326	.	C	A	4	3	7	0	0	7	0	0
18	3159965	.	A	T	3	9	12	0	0	12	0	0
18	3160148	.	C	G	0	3	3	0	2	5	0	0
18	3160188	.	A	T	6	5	11	0	0	11	0	0
18	3160218	.	C	T	1	6	7	0	8	15	0	0
18	3160308	.	A	G	5	5	10	0	0	10	0	0
18	3160354	.	C	T	0	5	5	0	6	11	0	0
18	3160406	.	T	C	5	0	5	0	5	10	0	0
18	3160422	.	A	G	4	4	8	0	0	8	0	0
18	3166045	.	C	G	0	5	5	0	3	8	0	0
18	3259736	.	C	T	20	9	29	0	1	30	0	0
18	3259807	.	C	A	10	20	30	1	3	34	0	0
18	3259847	.	C	T	19	19	38	0	0	38	0	0
18	3265657	.	T	C	8	14	22	0	0	22	0	0
18	3276085	.	G	C	14	14	28	0	1	29	0	0
18	3276187	.	A	G	19	0	19	0	15	34	0	0
18	3283882	.	T	C	24	20	44	0	2	46	0	0
18	3345141	.	T	A	3	2	5	0	0	5	0	0
18	3349011	.	T	C	2	6	8	0	0	8	0	0
18	3501282	.	C	T	2	2	4	0	0	4	0	0
18	3501283	.	C	G	2	2	4	0	0	4	0	0
18	3501529	.	C	A	1	1	2	0	2	4	0	0
18	3501550	.	A	G	1	3	4	0	1	5	0	0
18	3536868	.	A	T	7	9	16	0	0	16	0	0
18	3536937	.	T	C	5	9	14	0	0	14	0	0
18	3539989	.	C	T	1	4	5	0	7	12	0	0
18	3540027	.	C	T	5	9	14	0	1	15	0	0
18	3556542	.	A	G	12	11	23	0	0	23	0	0
18	3556626	.	C	T	0	10	10	0	12	22	0	0
18	3556935	.	C	T	3	7	10	0	0	10	0	0
18	3557043	.	A	T	2	4	6	0	0	6	0	0
18	3562608	.	A	G	1	3	4	0	1	5	0	0
18	3572547	.	G	A	9	6	15	0	0	15	0	0
18	3572878	.	T	C	4	5	9	0	2	11	0	0
18	3575938	.	C	A	5	11	16	1	0	17	0	0
18	3576104	.	C	T	14	7	21	0	2	23	0	0
18	5170063	.	A	G	37	11	48	0	5	53	0	0
18	5170069	.	A	G	13	1	14	0	40	54	0	0
18	5244649	.	C	A	2	2	4	0	0	4	0	0
18	5519138	.	A	G	5	3	8	0	4	12	0	0
18	5866378	.	C	A	1	8	9	0	0	9	0	0
18	7016069	.	T	C	2	3	5	1	0	6	0	0
18	7016525	.	T	C	1	2	3	0	0	3	0	0
18	7037599	.	G	A	3	2	5	0	0	5	0	0
18	7099981	.	A	G	3	3	6	0	0	6	0	0
18	7323715	.	T	C	3	1	4	0	0	4	0	0
18	7562237	.	T	C	1	6	7	0	2	9	0	0
18	7571628	.	C	T	2	6	8	0	2	10	0	0
18	10693077	.	G	A	6	5	11	0	1	12	0	0
18	10693085	.	T	A	7	5	12	0	0	12	0	0
18	10693123	.	C	T	7	3	10	0	2	12	0	0
18	10693155	.	T	A	5	3	8	0	0	8	0	0
18	10693322	.	A	T	11	5	16	0	1	17	0	0
18	10698083	.	T	C	5	4	9	0	1	10	0	0
18	10698161	.	T	G	8	8	16	0	2	18	0	0
18	10698215	.	T	C	9	4	13	0	1	14	0	0
18	10703669	.	A	G	4	2	6	0	0	6	0	0
18	10708346	.	G	A	3	3	6	0	0	6	0	0
18	10709870	.	C	A	3	2	5	0	1	6	0	0
18	10709876	.	C	A	4	3	7	0	0	7	0	0
18	10847743	.	C	T	4	3	7	0	1	8	0	0
18	10847872	.	A	G	4	6	10	0	0	10	0	0
18	10867181	.	A	C	7	13	20	0	0	20	0	0
18	10870806	.	T	C	6	10	16	0	0	16	0	0
18	10887826	.	A	G	6	4	10	0	0	10	0	0
18	10888245	.	A	C	1	4	5	0	0	5	0	0
18	10888551	.	T	C	4	6	10	0	1	11	0	0
18	10888836	.	T	C	7	9	16	0	0	16	0	0
18	10889049	.	C	G	6	0	6	0	3	9	0	0
18	10889880	.	G	A	1	3	4	0	5	9	0	0
18	10889901	.	T	A	5	6	11	0	0	11	0	0
18	10889951	.	G	A	8	7	15	0	0	15	0	0
18	10890432	.	G	A	6	5	11	0	0	11	0	0
18	10921408	.	A	T	12	4	16	0	3	19	0	0
18	10921630	.	A	T	7	9	16	0	1	17	0	0
18	10921734	.	T	C	7	16	23	0	0	23	0	0
18	10921791	.	T	C	7	14	21	0	2	23	0	0
18	10921855	.	T	C	9	9	18	0	1	19	0	0
18	10921857	.	G	A	1	7	8	0	11	20	1	0
18	10921927	.	C	T	4	9	13	0	0	13	0	0
18	11507253	.	T	G	3	2	5	0	0	5	0	0
18	11507263	.	G	A	2	3	5	0	0	5	0	0
18	11537535	.	T	C	2	3	5	0	0	5	0	0
18	11537703	.	T	G	3	0	3	0	4	7	0	0
18	11558148	.	T	C	1	0	1	0	2	3	0	0
18	12058480	.	T	A	3	2	5	0	0	5	0	0
18	12105432	.	T	C	4	3	7	0	0	7	0	0
18	12105548	.	G	A	0	5	5	0	1	6	0	0
18	12111431	.	A	C	3	4	7	0	0	7	0	0
18	12111625	.	A	G	3	2	5	0	0	5	0	0
18	12111628	.	A	T	3	2	5	0	0	5	0	0
18	12112105	.	T	C	5	4	9	0	0	9	0	0
18	12112153	.	T	C	2	2	4	0	0	4	0	0
18	12112219	.	C	T	6	2	8	0	0	8	0	0
18	12112726	.	C	T	4	3	7	0	0	7	0	0
18	12112750	.	G	A	4	4	8	0	0	8	0	0
18	12113515	.	C	A	10	6	16	0	0	16	0	0
18	12113516	.	C	T	11	6	17	0	0	17	0	0
18	12148050	.	T	G	1	0	1	0	2	3	0	0
18	12148056	.	C	T	1	2	3	0	0	3	0	0
18	12207046	.	A	G	2	4	6	0	1	7	0	0
18	12207070	.	C	A	6	3	9	0	0	9	0	0
18	12214299	.	A	G	4	3	7	0	0	7	0	0
18	12228217	.	C	A	4	6	10	0	0	10	0	0
18	12228758	.	C	T	9	4	13	0	0	13	0	0
18	12228834	.	G	C	4	3	7	0	0	7	0	0
18	12229120	.	A	T	4	9	13	0	2	15	0	0
18	12229223	.	A	C	6	3	9	0	0	9	0	0
18	12229245	.	C	T	2	4	6	0	1	7	0	0
18	12229405	.	G	A	6	3	9	0	1	10	0	0
18	12236113	.	G	A	3	6	9	0	3	12	0	0
18	12236126	.	T	A	9	3	12	0	0	12	0	0
18	12236351	.	C	T	8	12	20	0	0	20	0	0
18	12238082	.	G	A	9	8	17	0	0	17	0	0
18	12240681	.	C	T	9	6	15	0	0	15	0	0
18	12240740	.	G	C	8	5	13	0	0	13	0	0
18	12242967	.	C	T	2	8	10	0	7	17	0	0
18	12244667	.	G	A	2	4	6	0	0	6	0	0
18	12244760	.	T	C	1	2	3	0	0	3	0	0
18	12245525	.	A	G	2	3	5	0	0	5	0	0
18	12245576	.	A	G	4	3	7	0	0	7	0	0
18	12250727	.	G	A	1	2	3	0	0	3	0	0
18	12254398	.	A	G	1	1	2	0	0	2	0	0
18	12254409	.	G	A	1	2	3	0	0	3	0	0
18	12276859	.	C	T	17	10	27	0	1	28	0	0
18	12277052	.	A	G	6	6	12	0	3	15	0	0
18	12277206	.	G	C	17	17	34	0	2	36	0	0
18	12277490	.	G	A	26	15	41	0	1	42	0	0
18	12280269	.	C	T	20	15	35	0	1	36	0	0
18	12292017	.	G	A	17	9	26	0	1	27	0	0
18	12364876	.	G	A	4	3	7	0	0	7	0	0
18	12374168	.	A	G	2	2	4	0	0	4	0	0
18	12374497	.	C	T	0	2	2	0	1	3	0	0
18	12374521	.	A	G	1	3	4	0	0	4	0	0
18	12416410	.	A	T	2	3	5	0	0	5	0	0
18	12465290	.	G	A	6	2	8	0	0	8	0	0
18	12465316	.	C	T	3	4	7	0	1	8	0	0
18	12467834	.	G	C	2	0	2	0	4	6	0	0
18	12470136	.	G	A	2	2	4	0	0	4	0	0
18	12470148	.	A	G	1	2	3	0	0	3	0	0
18	12470211	.	C	T	1	2	3	0	2	5	0	0
18	12495185	.	C	T	2	2	4	0	0	4	0	0
18	12776727	.	C	T	7	5	12	0	1	13	0	0
18	12779357	.	T	A	6	7	13	0	1	14	0	0
18	14772522	.	G	A	4	3	7	0	0	7	0	0
18	14772889	.	A	G	7	3	10	0	0	10	0	0
18	14773068	.	G	T	6	2	8	0	0	8	0	0
18	14774646	.	C	G	2	3	5	0	0	5	0	0
18	14782677	.	C	T	2	4	6	0	0	6	0	0
18	14866506	.	G	A	9	4	13	0	3	16	0	0
18	14866508	.	C	T	11	4	15	0	1	16	0	0
18	14867144	.	A	C	7	0	7	0	6	13	0	0
18	14867153	.	C	T	8	7	15	0	0	15	0	0
18	14871133	.	C	T	2	5	7	0	0	7	0	0
18	14871145	.	A	G	1	5	6	0	0	6	0	0
18	14871280	.	A	C	1	0	1	0	2	3	0	0
18	14878691	.	C	G	0	2	2	0	2	4	0	0
18	14886129	.	C	T	1	3	4	0	1	5	0	0
18	14909768	.	G	A	3	3	6	0	0	6	0	0
18	14928654	.	C	T	7	5	12	0	0	12	0	0
18	14928681	.	T	C	5	5	10	0	0	10	0	0
18	14930095	.	T	C	3	5	8	0	0	8	0	0
18	15121484	.	G	A	2	4	6	0	0	6	0	0
18	15123008	.	C	A	4	4	8	0	0	8	0	0
18	15123011	.	A	G	4	4	8	0	0	8	0	0
18	15125122	.	G	A	5	5	10	0	0	10	0	0
18	15125193	.	A	C	3	6	9	0	0	9	0	0
18	15125418	.	C	A	9	3	12	0	0	12	0	0
18	15128960	.	T	C	4	3	7	0	0	7	0	0
18	15132383	.	T	C	7	3	10	0	0	10	0	0
18	15136657	.	A	G	4	0	4	0	3	7	0	0
18	15139004	.	T	A	5	2	7	0	0	7	0	0
18	15139150	.	G	A	9	9	18	0	1	19	0	0
18	15139540	.	C	T	6	14	20	0	1	21	0	0
18	15139757	.	G	A	3	2	5	0	0	5	0	0
18	15139784	.	T	C	3	2	5	0	0	5	0	0
18	15139908	.	A	T	1	2	3	0	0	3	0	0
18	15148199	.	T	C	6	2	8	0	1	9	0	0
18	15148207	.	A	C	5	3	8	0	2	10	0	0
18	15148248	.	T	C	3	4	7	0	2	9	0	0
18	15148259	.	A	C	3	6	9	0	0	9	0	0
18	15148290	.	A	C	1	4	5	0	1	6	0	0
18	15148304	.	T	C	3	0	3	0	6	9	0	0
18	15148482	.	A	G	3	2	5	0	0	5	0	0
18	15148886	.	G	A	6	3	9	0	1	10	0	0
18	15148912	.	A	G	5	3	8	0	0	8	0	0
18	15148954	.	T	C	3	4	7	0	0	7	0	0
18	15148985	.	A	G	3	4	7	0	0	7	0	0
18	15149067	.	G	A	2	2	4	0	0	4	0	0
18	15149068	.	G	T	2	2	4	0	0	4	0	0
18	15149475	.	T	C	5	1	6	0	2	8	0	0
18	15149538	.	T	C	3	4	7	0	0	7	0	0
18	15149550	.	C	T	3	2	5	0	0	5	0	0
18	15262036	.	A	G	0	2	2	0	1	3	0	0
18	15295925	.	C	T	1	3	4	0	9	13	0	0
18	15295976	.	G	T	7	4	11	0	1	12	0	0
18	15296062	.	G	A	9	3	12	1	3	16	0	0
18	15309513	.	T	C	7	0	7	0	4	11	0	0
18	15345409	.	G	C	2	2	4	0	0	4	0	0
18	15383683	.	C	T	3	2	5	0	0	5	0	0
18	15393324	.	G	A	4	3	7	0	0	7	0	0
18	15394086	.	G	C	3	5	8	0	0	8	0	0
18	15403754	.	C	T	3	2	5	0	0	5	0	0
18	15459835	.	T	A	3	5	8	0	0	8	0	0
18	15459871	.	C	T	1	2	3	0	0	3	0	0
18	15469742	.	G	A	2	2	4	0	0	4	0	0
18	15470114	.	T	G	6	4	10	0	1	11	0	0
18	15478391	.	T	G	3	3	6	0	0	6	0	0
18	15478394	.	G	A	3	2	5	0	1	6	0	0
18	15478597	.	A	G	2	2	4	0	0	4	0	0
18	15569644	.	T	C	1	3	4	0	1	5	0	0
18	15571066	.	A	G	3	2	5	0	1	6	0	0
18	15792294	.	T	G	13	17	30	0	5	35	0	0
18	15792368	.	G	C	24	18	42	0	2	44	0	0
18	15792459	.	A	C	17	28	45	0	2	47	0	0
18	15792596	.	T	A	27	21	48	0	1	49	0	0
18	15792611	.	A	G	19	23	42	0	7	49	0	0
18	15792743	.	T	A	24	21	45	0	1	46	0	0
18	15793064	.	A	G	4	10	14	0	0	14	0	0
18	15829588	.	A	G	9	7	16	0	1	17	0	0
18	15836835	.	A	G	4	4	8	1	1	10	0	0
18	15836961	.	C	T	11	3	14	0	0	14	0	0
18	15869816	.	C	A	1	3	4	0	0	4	0	0
18	15874454	.	T	C	3	2	5	0	0	5	0	0
18	15875196	.	G	A	2	5	7	0	0	7	0	0
18	16127885	.	A	G	18	14	32	0	4	36	0	0
18	16127927	.	A	C	15	12	27	0	2	29	0	0
18	16128427	.	T	A	3	5	8	0	0	8	0	0
18	16128730	.	A	G	4	5	9	0	0	9	0	0
18	16128960	.	T	G	22	14	36	0	2	38	0	0
18	16129149	.	C	T	6	15	21	0	3	24	0	0
18	16129210	.	A	C	23	13	36	0	2	38	0	0
18	16129583	.	T	A	17	21	38	0	2	40	0	0
18	16129862	.	C	T	26	19	45	0	1	46	0	0
18	16133772	.	C	G	3	5	8	0	1	9	0	0
18	16133773	.	T	A	3	5	8	0	1	9	0	0
18	16133822	.	T	C	1	2	3	0	1	4	0	0
18	16140047	.	G	A	8	2	10	0	0	10	0	0
18	16140337	.	G	T	1	10	11	0	15	26	0	0
18	16145618	.	T	G	25	22	47	0	1	48	0	0
18	16145621	.	C	T	25	23	48	0	0	48	0	0
18	16145994	.	C	G	11	5	16	0	0	16	0	0
18	16151809	.	T	A	5	2	7	0	0	7	0	0
18	16151936	.	G	A	5	3	8	0	0	8	0	0
18	16153487	.	T	C	3	0	3	0	3	6	0	0
18	16215844	.	A	G	2	2	4	0	0	4	0	0
18	16215860	.	G	A	2	2	4	0	0	4	0	0
18	16388195	.	G	A	2	3	5	0	0	5	0	0
18	16388342	.	G	A	3	2	5	0	0	5	0	0
18	16388387	.	G	A	2	2	4	0	0	4	0	0
18	16719963	.	T	C	8	4	12	0	0	12	0	0
18	16720197	.	G	A	9	6	15	0	1	16	0	0
18	16721705	.	G	A	19	8	27	1	4	32	0	0
18	16721741	.	G	A	17	14	31	0	2	33	0	0
18	16722124	.	G	A	21	21	42	0	0	42	0	0
18	16722584	.	G	A	12	13	25	0	2	27	0	0
18	16723514	.	T	C	8	20	28	0	2	30	0	0
18	16723520	.	A	G	10	1	11	0	18	29	0	0
18	16723785	.	A	G	21	0	21	0	17	38	0	0
18	16725225	.	G	A	2	22	24	0	13	37	0	0
18	16725309	.	C	T	21	9	30	0	1	31	0	0
18	16725917	.	A	G	29	13	42	1	1	44	0	0
18	16726011	.	C	T	9	8	17	0	7	24	0	0
18	16755962	.	C	A	15	22	37	0	1	38	0	0
18	16756001	.	C	T	15	22	37	0	2	39	0	0
18	16756058	.	T	A	11	14	25	0	0	25	0	0
18	16756065	.	G	A	12	13	25	0	1	26	0	0
18	16876903	.	A	G	6	3	9	0	1	10	0	0
18	16877282	.	C	T	4	5	9	0	0	9	0	0
18	16877283	.	A	G	3	4	7	0	2	9	0	0
18	16885979	.	T	G	6	4	10	0	0	10	0	0
18	16886079	.	C	T	9	4	13	0	0	13	0	0
18	16894571	.	T	A	10	6	16	0	2	18	0	0
18	16894594	.	T	G	7	7	14	0	0	14	0	0
18	16894630	.	A	G	7	10	17	0	0	17	0	0
18	16906522	.	A	G	1	2	3	0	0	3	0	0
18	16918725	.	G	A	1	1	2	0	1	3	0	0
18	16918760	.	C	A	3	2	5	0	0	5	0	0
18	16920972	.	G	A	2	2	4	0	0	4	0	0
18	16929772	.	G	A	12	14	26	3	1	30	0	0
18	16936429	.	G	A	3	3	6	0	0	6	0	0
18	16936758	.	T	C	2	3	5	0	1	6	0	0
18	16936787	.	A	G	2	3	5	0	0	5	0	0
18	16961046	.	A	G	9	10	19	1	0	20	0	0
18	16962778	.	A	G	7	7	14	0	1	15	0	0
18	16962783	.	C	T	8	8	16	0	0	16	0	0
18	16962823	.	C	T	9	10	19	0	2	21	0	0
18	16963091	.	C	G	10	9	19	0	2	21	0	0
18	16966911	.	T	C	12	7	19	0	0	19	0	0
18	16968314	.	T	C	18	11	29	0	1	30	0	0
18	16970059	.	G	A	3	3	6	0	0	6	0	0
18	16970455	.	A	T	9	12	21	0	1	22	0	0
18	16970459	.	G	A	1	11	12	0	12	24	0	0
18	16970598	.	C	T	16	9	25	1	0	26	0	0
18	16970795	.	A	T	11	3	14	2	0	16	0	0
18	16970997	.	G	C	3	9	12	0	18	30	0	0
18	16971129	.	C	T	15	8	23	0	1	24	0	0
18	16971155	.	A	T	14	7	21	0	1	22	0	0
18	16971255	.	T	A	2	3	5	0	0	5	0	0
18	16989846	.	A	C	1	3	4	0	1	5	0	0
18	16990122	.	C	T	2	2	4	0	6	10	0	0
18	16990150	.	G	T	7	2	9	0	0	9	0	0
18	16990385	.	A	C	4	0	4	0	4	8	0	0
18	16990520	.	C	T	3	4	7	0	2	9	0	0
18	16990550	.	A	G	4	7	11	0	2	13	0	0
18	17002614	.	T	C	9	1	10	0	9	19	0	0
18	17002653	.	A	G	9	9	18	0	0	18	0	0
18	17003602	.	A	G	10	5	15	0	0	15	0	0
18	17005917	.	T	C	2	2	4	0	0	4	0	0
18	17007458	.	G	A	3	3	6	0	0	6	0	0
18	17007521	.	G	A	2	5	7	0	0	7	0	0
18	17007527	.	C	T	2	5	7	0	0	7	0	0
18	17016613	.	G	A	2	2	4	0	0	4	0	0
18	17016697	.	T	C	2	2	4	0	0	5	1	0
18	17021778	.	A	C	2	2	4	0	0	4	0	0
18	17024399	.	T	G	2	4	6	0	1	7	0	0
18	17024422	.	A	G	0	5	5	0	1	6	0	0
18	17051417	.	G	A	1	2	3	0	0	3	0	0
18	17062323	.	G	A	3	4	7	0	0	7	0	0
18	17062336	.	T	C	3	4	7	0	0	7	0	0
18	17062364	.	T	G	5	3	8	0	0	8	0	0
18	17062487	.	G	T	5	3	8	0	0	8	0	0
18	17062611	.	C	T	4	4	8	0	0	8	0	0
18	17066978	.	T	C	2	3	5	0	0	5	0	0
18	17072022	.	T	C	2	2	4	0	0	4	0	0
18	17078575	.	A	T	4	4	8	0	0	8	0	0
18	17078593	.	T	C	4	7	11	0	0	11	0	0
18	17079541	.	T	C	18	6	24	3	2	29	0	0
18	17079724	.	C	T	0	9	9	0	14	23	0	0
18	17080089	.	G	C	6	10	16	0	0	16	0	0
18	17080122	.	A	G	6	5	11	0	2	13	0	0
18	17080131	.	T	C	5	2	7	0	8	15	0	0
18	17084489	.	C	T	0	7	7	0	3	10	0	0
18	17097893	.	T	C	7	7	14	0	0	14	0	0
18	17098009	.	G	T	6	7	13	0	3	16	0	0
18	17098317	.	T	A	7	3	10	0	1	11	0	0
18	17098562	.	T	A	4	9	13	0	1	14	0	0
18	17102046	.	C	T	0	9	9	0	5	14	0	0
18	17131006	.	A	G	6	5	11	0	0	11	0	0
18	17173629	.	A	G	2	2	4	0	0	4	0	0
18	17173638	.	C	T	1	2	3	0	1	4	0	0
18	17535741	.	A	T	0	20	20	0	2	22	0	0
18	17535748	.	A	T	11	9	20	0	4	24	0	0
18	17621515	.	G	A	1	4	5	0	0	5	0	0
18	17708252	.	A	G	1	8	9	0	0	9	0	0
18	18421825	.	T	G	10	2	12	0	1	13	0	0
18	18421826	.	T	G	7	6	13	0	0	13	0	0
18	19419200	.	A	T	4	3	7	0	0	7	0	0
18	19419307	.	C	T	6	11	17	0	0	17	0	0
18	19441492	.	C	G	12	8	20	0	1	21	0	0
18	19441561	.	T	C	13	10	23	0	2	25	0	0
18	19441585	.	C	A	11	11	22	0	0	22	0	0
18	19450486	.	T	C	24	29	53	0	4	57	0	0
18	19450563	.	A	T	22	37	59	0	1	60	0	0
18	19450642	.	A	T	23	23	46	0	6	52	0	0
18	19450692	.	A	G	25	18	43	3	2	48	0	0
18	19450755	.	A	G	24	34	58	2	4	64	0	0
18	19451023	.	C	T	22	22	44	1	0	45	0	0
18	19451117	.	C	T	11	14	25	0	1	26	0	0
18	19451427	.	G	A	51	31	82	0	5	87	0	0
18	19451430	.	T	C	49	8	57	0	26	83	0	0
18	19451477	.	G	A	46	37	83	0	4	88	1	0
18	19452594	.	G	A	26	48	74	0	1	75	0	0
18	19452639	.	A	G	31	37	68	0	9	77	0	0
18	19487779	.	G	A	17	16	33	0	0	33	0	0
18	19490515	.	C	T	18	18	36	0	1	37	0	0
18	19648878	.	T	C	2	5	7	0	0	7	0	0
18	19698833	.	T	C	5	9	14	0	1	15	0	0
18	19698854	.	G	A	6	7	13	0	0	13	0	0
18	19793720	.	G	A	1	2	3	0	0	3	0	0
18	19805440	.	T	C	3	2	5	0	1	6	0	0
18	19805464	.	C	T	2	2	4	0	0	4	0	0
18	19806014	.	A	G	3	0	3	0	4	7	0	0
18	19812874	.	T	C	6	5	11	0	0	11	0	0
18	19812943	.	A	T	5	11	16	0	0	16	0	0
18	19813002	.	A	G	7	11	18	0	0	18	0	0
18	19814181	.	A	G	7	8	15	0	0	15	0	0
18	19815743	.	A	T	6	15	21	0	2	23	0	0
18	19817682	.	G	A	4	2	6	0	1	7	0	0
18	19819719	.	C	A	5	4	9	0	0	9	0	0
18	19880767	.	G	T	0	4	4	0	3	7	0	0
18	19883812	.	G	T	0	6	6	0	7	13	0	0
18	19981553	.	G	A	9	3	12	0	0	12	0	0
18	19981733	.	A	G	3	2	5	0	0	5	0	0
18	20022806	.	T	C	2	5	7	0	0	7	0	0
18	20024856	.	T	C	1	7	8	0	1	9	0	0
18	20024889	.	G	A	4	6	10	0	0	10	0	0
18	20034058	.	T	A	3	4	7	0	0	7	0	0
18	20041825	.	T	C	8	13	21	0	1	22	0	0
18	20042088	.	C	T	18	18	36	0	2	38	0	0
18	20044847	.	T	C	21	12	33	0	2	35	0	0
18	20045197	.	T	C	1	4	5	0	1	6	0	0
18	20226023	.	C	A	1	2	3	0	0	3	0	0
18	20226131	.	G	T	1	2	3	0	0	3	0	0
18	20228760	.	C	T	1	2	3	0	2	5	0	0
18	20249005	.	G	T	1	10	11	0	7	18	0	0
18	20252129	.	C	T	5	5	10	0	0	10	0	0
18	20254384	.	C	T	6	5	11	0	0	11	0	0
18	20254398	.	G	A	0	4	4	0	8	12	0	0
18	20256275	.	C	T	6	13	19	0	1	20	0	0
18	20256379	.	A	G	4	6	10	0	2	12	0	0
18	20256491	.	T	A	8	4	12	0	1	13	0	0
18	20256492	.	A	T	4	8	12	0	1	13	0	0
18	20256539	.	G	A	5	7	12	0	2	14	0	0
18	20256770	.	C	G	8	0	8	0	13	21	0	0
18	20256781	.	C	A	11	0	11	0	14	25	0	0
18	20257005	.	G	A	3	17	20	0	14	34	0	0
18	20257159	.	C	G	11	12	23	0	1	24	0	0
18	20257200	.	A	T	14	10	24	0	1	25	0	0
18	20436731	.	C	G	0	1	1	0	1	2	0	0
18	20436741	.	T	G	1	2	3	0	0	3	0	0
18	20440913	.	T	A	1	2	3	0	0	3	0	0
18	20460291	.	A	G	3	4	7	0	0	7	0	0
18	20468514	.	G	T	2	6	8	0	3	11	0	0
18	20469150	.	G	A	1	2	3	0	1	4	0	0
18	20469275	.	T	A	3	2	5	0	0	5	0	0
18	20475854	.	C	T	4	7	11	0	0	11	0	0
18	20479008	.	A	G	10	7	17	0	0	17	0	0
18	20489224	.	G	A	2	3	5	0	0	5	0	0
18	20490510	.	A	T	2	2	4	0	0	4	0	0
18	20490672	.	G	A	1	3	4	0	0	4	0	0
18	20516628	.	T	C	1	1	2	0	0	2	0	0
18	20516811	.	T	C	2	4	6	0	0	6	0	0
18	20516863	.	A	C	2	8	10	0	0	10	0	0
18	20516869	.	T	G	2	8	10	0	0	10	0	0
18	20517000	.	G	A	1	2	3	0	0	3	0	0
18	20518915	.	C	G	2	5	7	0	0	7	0	0
18	20518961	.	A	C	4	2	6	0	0	6	0	0
18	20520964	.	A	G	2	4	6	0	0	6	0	0
18	20520982	.	G	T	2	4	6	0	0	6	0	0
18	20521053	.	T	G	2	2	4	0	0	4	0	0
18	20521431	.	A	T	1	4	5	0	0	5	0	0
18	20532660	.	G	A	5	2	7	0	0	7	0	0
18	20532685	.	T	C	5	2	7	0	0	7	0	0
18	20533934	.	G	A	5	3	8	0	0	8	0	0
18	20535074	.	T	A	8	5	13	0	0	13	0	0
18	20536533	.	A	G	9	0	9	0	4	13	0	0
18	20539548	.	G	A	0	9	9	0	8	17	0	0
18	20539703	.	T	A	4	6	10	0	0	10	0	0
18	20539844	.	T	A	5	5	10	0	1	11	0	0
18	20539979	.	T	A	5	6	11	0	0	11	0	0
18	20540144	.	G	A	3	8	11	0	2	13	0	0
18	20540216	.	A	G	2	2	4	0	0	4	0	0
18	20540313	.	G	T	3	2	5	0	1	6	0	0
18	20540581	.	G	T	3	4	7	0	1	8	0	0
18	20540606	.	A	T	4	3	7	0	0	7	0	0
18	20541575	.	A	C	6	10	16	0	1	17	0	0
18	20541735	.	A	G	10	7	17	0	0	17	0	0
18	20541863	.	C	G	3	2	5	0	1	6	0	0
18	20542107	.	C	T	2	12	14	0	9	23	0	0
18	20542128	.	T	G	11	6	17	0	1	18	0	0
18	20542214	.	A	T	10	3	13	0	2	15	0	0
18	20542388	.	T	G	9	8	17	0	3	20	0	0
18	20542398	.	A	C	7	8	15	0	3	18	0	0
18	20542503	.	G	A	12	16	28	0	2	30	0	0
18	20542562	.	T	G	15	20	35	0	2	37	0	0
18	20542647	.	C	T	6	15	21	0	1	22	0	0
18	20543466	.	T	A	8	12	20	0	0	20	0	0
18	20544691	.	G	A	6	4	10	0	1	11	0	0
18	20544901	.	G	C	4	4	8	0	0	9	1	0
18	20553607	.	T	C	3	6	9	0	1	10	0	0
18	20554066	.	C	T	1	3	4	0	3	7	0	0
18	20559518	.	C	T	5	5	10	0	0	10	0	0
18	20567749	.	A	T	1	2	3	0	0	3	0	0
18	20582109	.	G	A	5	12	17	0	0	17	0	0
18	20582222	.	G	A	6	10	16	0	2	18	0	0
18	20582303	.	C	T	0	6	6	0	4	10	0	0
18	20582314	.	C	G	3	8	11	0	0	11	0	0
18	20582356	.	C	T	4	5	9	0	0	9	0	0
18	20582361	.	T	C	4	4	8	0	0	8	0	0
18	20582392	.	C	T	0	4	4	0	6	10	0	0
18	20582629	.	T	C	4	8	12	0	3	15	0	0
18	20583127	.	C	T	11	5	16	0	0	16	0	0
18	20583154	.	G	T	8	4	12	0	0	12	0	0
18	20583398	.	C	T	1	7	8	0	0	8	0	0
18	20583511	.	T	C	3	0	3	0	3	6	0	0
18	20583592	.	A	T	1	2	3	0	0	3	0	0
18	20583610	.	A	T	1	2	3	0	0	3	0	0
18	20583763	.	A	G	3	5	8	0	2	10	0	0
18	20583820	.	A	T	3	4	7	1	0	8	0	0
18	20584077	.	G	A	2	3	5	0	0	5	0	0
18	20584098	.	T	A	5	2	7	0	0	7	0	0
18	20584797	.	G	A	1	3	4	0	0	4	0	0
18	20584801	.	C	T	1	3	4	0	0	4	0	0
18	20585314	.	C	T	6	3	9	0	0	9	0	0
18	20585407	.	A	G	0	2	2	0	2	4	0	0
18	20726304	.	T	C	26	2	28	0	29	57	0	0
18	20729281	.	C	T	2	18	20	0	24	44	0	0
18	20739268	.	G	T	12	14	26	0	0	26	0	0
18	20739298	.	C	T	10	8	18	0	0	18	0	0
18	20742029	.	C	G	13	16	29	0	0	29	0	0
18	20744164	.	T	C	8	4	12	0	0	12	0	0
18	20752848	.	G	A	15	13	28	0	3	31	0	0
18	20755763	.	G	A	9	9	18	0	0	18	0	0
18	20755787	.	G	T	11	5	16	0	0	16	0	0
18	20755843	.	G	C	12	6	18	0	1	19	0	0
18	20755844	.	C	A	14	6	20	0	1	21	0	0
18	20755971	.	G	T	9	5	14	0	0	14	0	0
18	20757663	.	G	A	6	2	8	0	0	8	0	0
18	20757934	.	C	T	11	9	20	0	2	22	0	0
18	20757977	.	A	C	9	0	9	0	10	19	0	0
18	20757979	.	G	A	7	9	16	0	4	20	0	0
18	20768407	.	C	T	9	9	18	0	4	22	0	0
18	20768818	.	T	A	5	2	7	0	1	8	0	0
18	20768977	.	C	T	2	5	7	0	0	7	0	0
18	20771078	.	T	C	2	1	3	0	3	6	0	0
18	20771085	.	A	G	5	2	7	0	0	7	0	0
18	20882098	.	C	T	3	3	6	0	0	6	0	0
18	21073091	.	A	G	2	2	4	0	0	4	0	0
18	21075715	.	A	C	5	4	9	0	0	9	0	0
18	21102086	.	C	T	1	3	4	0	5	9	0	0
18	21102088	.	A	G	6	3	9	0	0	9	0	0
18	21102764	.	C	T	0	2	2	0	3	5	0	0
18	21102797	.	G	T	5	4	9	0	1	10	0	0
18	21102914	.	G	A	2	3	5	0	0	5	0	0
18	21103334	.	A	C	2	3	5	0	0	5	0	0
18	21113258	.	G	A	0	2	2	0	1	3	0	0
18	21113273	.	T	C	2	2	4	0	0	4	0	0
18	21113533	.	G	A	1	2	3	0	0	3	0	0
18	21114475	.	T	C	3	2	5	0	0	5	0	0
18	21116381	.	C	A	7	6	13	0	0	13	0	0
18	21117589	.	C	A	5	6	11	0	0	11	0	0
18	21118232	.	C	G	10	3	13	0	0	13	0	0
18	21119498	.	G	A	8	5	13	0	1	14	0	0
18	21119562	.	G	A	13	5	18	0	0	18	0	0
18	21119579	.	A	T	15	10	25	0	0	25	0	0
18	21119854	.	T	C	11	12	23	0	1	24	0	0
18	21136729	.	C	T	6	10	16	0	3	19	0	0
18	21136948	.	C	T	7	19	26	0	1	27	0	0
18	21143473	.	A	T	18	14	32	0	2	34	0	0
18	21143787	.	C	A	15	8	23	0	0	23	0	0
18	21143938	.	C	G	14	12	26	0	0	26	0	0
18	21143998	.	C	T	14	13	27	1	3	31	0	0
18	21144005	.	C	A	11	15	26	1	3	30	0	0
18	21144060	.	G	A	2	18	20	0	16	36	0	0
18	21144800	.	A	T	2	7	9	0	0	9	0	0
18	21144880	.	G	T	9	8	17	0	1	19	1	0
18	21144965	.	G	C	2	6	8	0	7	15	0	0
18	21145142	.	A	G	9	14	23	0	5	28	0	0
18	21145290	.	G	T	7	11	18	0	0	18	0	0
18	21179325	.	T	C	11	0	11	0	6	17	0	0
18	21179730	.	A	G	8	10	18	5	2	25	0	0
18	21198961	.	G	T	19	18	37	0	2	39	0	0
18	21199165	.	G	T	19	8	27	0	6	33	0	0
18	21199185	.	T	G	9	8	17	0	12	29	0	0
18	21199515	.	T	C	27	22	49	1	4	54	0	0
18	21214976	.	T	C	12	13	25	0	1	26	0	0
18	21218734	.	G	A	17	16	33	0	2	35	0	0
18	21257600	.	A	T	18	6	24	0	1	25	0	0
18	21257657	.	T	C	6	24	30	0	0	30	0	0
18	21257786	.	G	A	22	6	28	0	0	28	0	0
18	21257867	.	G	A	9	17	26	0	1	27	0	0
18	21257946	.	C	T	15	4	19	0	3	22	0	0
18	21258083	.	G	A	15	8	23	0	1	24	0	0
18	21263120	.	G	A	5	15	20	0	0	20	0	0
18	21266885	.	G	A	6	2	8	0	0	8	0	0
18	21492325	.	T	C	11	7	18	0	0	18	0	0
18	21617864	.	G	A	3	21	24	0	22	46	0	0
18	21618343	.	C	T	17	19	36	0	3	39	0	0
18	21618379	.	A	G	21	16	37	0	0	37	0	0
18	21618496	.	G	A	24	13	37	0	0	37	0	0
18	21618659	.	C	A	11	13	24	0	1	25	0	0
18	21618731	.	G	T	15	24	39	0	1	40	0	0
18	21618910	.	G	T	25	28	53	1	1	55	0	0
18	21619011	.	C	T	22	13	35	0	2	37	0	0
18	21619018	.	A	T	19	16	35	0	2	37	0	0
18	21619055	.	G	T	26	17	43	0	3	46	0	0
18	21619260	.	C	T	19	16	35	0	1	36	0	0
18	21619284	.	G	T	17	15	32	1	1	34	0	0
18	21619672	.	A	G	26	23	49	3	0	52	0	0
18	21619686	.	G	A	23	20	43	3	0	46	0	0
18	21619777	.	A	G	35	16	51	3	2	56	0	0
18	21619799	.	T	G	29	22	51	0	1	52	0	0
18	21619948	.	C	T	21	17	38	1	3	42	0	0
18	21620082	.	A	T	25	13	38	0	1	39	0	0
18	21620376	.	A	C	25	27	52	0	2	54	0	0
18	21620426	.	G	A	3	22	25	0	30	55	0	0
18	21645492	.	G	A	8	12	20	0	0	20	0	0
18	21645627	.	A	G	12	12	24	0	0	24	0	0
18	21645902	.	G	C	18	0	18	0	15	33	0	0
18	21645965	.	G	A	16	12	28	0	2	30	0	0
18	21645989	.	T	G	14	14	28	0	0	28	0	0
18	21647419	.	T	C	6	5	11	0	3	14	0	0
18	21648522	.	C	T	9	5	14	0	1	15	0	0
18	21648582	.	A	G	7	4	11	0	2	13	0	0
18	21648627	.	C	T	2	9	11	0	1	12	0	0
18	21648633	.	A	T	4	7	11	0	0	11	0	0
18	21653937	.	C	T	12	7	19	0	0	19	0	0
18	21654124	.	A	C	7	1	8	0	3	11	0	0
18	21654145	.	C	T	6	6	12	0	0	12	0	0
18	21654375	.	C	A	5	4	9	0	1	10	0	0
18	21654432	.	T	C	6	7	13	0	2	15	0	0
18	21654489	.	C	T	5	6	11	0	3	14	0	0
18	21656271	.	C	A	5	2	7	0	0	7	0	0
18	21656274	.	G	A	2	4	6	0	0	6	0	0
18	21657642	.	T	G	1	4	5	0	0	5	0	0
18	21674320	.	G	T	1	2	3	0	0	3	0	0
18	21689043	.	G	C	9	11	20	0	2	22	0	0
18	21689052	.	A	G	11	12	23	0	1	24	0	0
18	21689079	.	G	A	9	9	18	0	3	21	0	0
18	21693120	.	A	G	8	8	16	0	0	16	0	0
18	21693213	.	G	A	4	11	15	0	4	19	0	0
18	21693441	.	G	A	10	6	16	0	2	18	0	0
18	21697776	.	C	T	3	10	13	0	1	14	0	0
18	21698855	.	G	T	6	7	13	0	1	15	1	0
18	21699581	.	A	T	2	6	8	0	1	9	0	0
18	21724334	.	G	A	3	3	6	0	0	6	0	0
18	21724480	.	A	G	1	2	3	0	0	3	0	0
18	21782362	.	T	G	2	3	5	0	0	5	0	0
18	21782467	.	A	C	3	5	8	0	0	8	0	0
18	21782500	.	A	G	2	2	4	0	1	5	0	0
18	21782506	.	G	C	4	1	5	0	0	5	0	0
18	21782577	.	G	A	2	2	4	0	2	6	0	0
18	21783009	.	T	G	6	2	8	0	0	8	0	0
18	21783010	.	A	C	6	1	7	0	1	8	0	0
18	21783049	.	G	C	3	2	5	0	2	7	0	0
18	21783077	.	C	T	5	2	7	0	1	8	0	0
18	21783087	.	G	A	3	2	5	0	1	6	0	0
18	21783257	.	G	T	3	2	5	0	1	6	0	0
18	21783279	.	G	A	3	5	8	0	0	8	0	0
18	21783325	.	A	T	4	6	10	0	1	11	0	0
18	21783368	.	G	A	2	8	10	0	0	10	0	0
18	21783494	.	A	C	3	5	8	0	0	8	0	0
18	21860755	.	C	T	10	6	16	0	0	16	0	0
18	21861134	.	T	A	14	9	23	0	1	24	0	0
18	21861225	.	T	A	15	16	31	0	0	31	0	0
18	21861381	.	G	T	9	6	15	0	0	15	0	0
18	21861497	.	A	T	5	8	13	0	0	13	0	0
18	21861688	.	C	A	4	3	7	0	1	8	0	0
18	21861749	.	T	C	9	3	12	0	0	12	0	0
18	21861760	.	G	T	7	3	10	0	0	10	0	0
18	21861934	.	C	T	9	6	15	0	0	15	0	0
18	21862000	.	G	C	10	10	20	0	1	21	0	0
18	21862076	.	C	T	1	8	9	0	11	20	0	0
18	21862141	.	T	C	6	0	6	0	6	12	0	0
18	21862175	.	C	T	1	6	7	0	6	13	0	0
18	21862237	.	G	T	7	5	12	0	0	12	0	0
18	21862346	.	T	A	9	3	12	0	0	12	0	0
18	21880098	.	T	C	4	0	4	0	10	14	0	0
18	21880191	.	T	C	4	0	4	0	5	9	0	0
18	21913799	.	A	T	12	11	23	0	1	24	0	0
18	21913907	.	G	C	16	14	30	0	0	30	0	0
18	21913988	.	C	A	16	12	28	0	3	31	0	0
18	21914018	.	C	A	16	10	26	0	3	29	0	0
18	21914225	.	C	T	4	15	19	0	13	32	0	0
18	21914281	.	G	A	19	6	25	0	1	26	0	0
18	21914283	.	C	A	16	7	23	0	4	27	0	0
18	21943185	.	A	C	2	2	4	0	0	4	0	0
18	22002476	.	G	A	3	3	6	0	0	6	0	0
18	22002508	.	C	T	8	5	13	0	0	13	0	0
18	22029828	.	A	C	7	0	7	0	7	14	0	0
18	22030435	.	C	T	1	3	4	0	0	4	0	0
18	22030661	.	T	C	1	0	1	0	2	3	0	0
18	22082366	.	T	C	1	2	3	0	0	3	0	0
18	22232775	.	T	C	2	2	4	0	0	4	0	0
18	22255005	.	C	T	2	4	6	0	0	6	0	0
18	22261064	.	C	A	4	3	7	0	0	7	0	0
18	22267741	.	C	T	5	3	8	0	0	8	0	0
18	22272969	.	C	A	6	9	15	0	0	15	0	0
18	22275051	.	T	C	9	11	20	0	0	20	0	0
18	22282766	.	A	T	15	4	19	0	2	21	0	0
18	22282809	.	A	T	9	18	27	0	2	29	0	0
18	22282923	.	G	T	14	12	26	0	0	26	0	0
18	22282960	.	C	T	13	10	23	0	0	23	0	0
18	22282961	.	A	G	14	10	24	0	0	24	0	0
18	22283087	.	C	A	9	9	18	0	0	18	0	0
18	22283116	.	T	A	9	6	15	0	1	16	0	0
18	22288282	.	C	A	1	5	6	0	0	6	0	0
18	22288650	.	T	C	6	9	15	0	2	17	0	0
18	22288659	.	C	T	6	11	17	0	1	18	0	0
18	22289075	.	T	C	5	8	13	0	1	14	0	0
18	22289314	.	C	T	7	4	11	0	0	11	0	0
18	22290900	.	G	A	14	19	33	0	0	33	0	0
18	22290933	.	C	T	14	11	25	0	0	25	0	0
18	22292215	.	A	T	12	15	27	0	0	27	0	0
18	22292286	.	G	A	17	9	26	0	1	27	0	0
18	22292339	.	A	T	14	10	24	0	0	24	0	0
18	22293123	.	T	A	0	2	2	0	0	2	0	0
18	22293129	.	G	T	2	2	4	0	0	4	0	0
18	22293191	.	T	G	6	4	10	0	0	10	0	0
18	22356989	.	C	T	8	9	17	0	0	17	0	0
18	22377096	.	A	T	19	23	42	0	1	43	0	0
18	22377372	.	G	A	2	31	33	0	23	56	0	0
18	22377471	.	C	T	17	19	36	0	2	38	0	0
18	22385900	.	G	A	27	23	50	0	6	56	0	0
18	22405895	.	A	T	7	7	14	0	0	14	0	0
18	22406162	.	C	T	0	3	3	0	7	10	0	0
18	22406187	.	T	A	4	2	6	0	1	7	0	0
18	22406375	.	T	A	3	4	7	0	0	7	0	0
18	22406379	.	G	A	4	3	7	0	0	7	0	0
18	22407365	.	C	T	2	5	7	0	2	9	0	0
18	22414542	.	T	G	5	2	7	0	0	7	0	0
18	22417058	.	C	T	14	4	18	0	0	18	0	0
18	22417082	.	G	A	2	4	6	0	13	19	0	0
18	22420551	.	A	T	1	6	7	0	0	7	0	0
18	22420558	.	C	A	0	6	6	0	1	7	0	0
18	22424532	.	T	C	4	3	7	0	0	7	0	0
18	22424536	.	A	G	5	0	5	0	4	9	0	0
18	22424601	.	A	G	8	0	8	0	12	20	0	0
18	22486579	.	A	T	4	7	11	0	0	11	0	0
18	22685266	.	G	A	0	4	4	0	2	6	0	0
18	22685329	.	T	C	1	7	8	0	1	9	0	0
18	22685380	.	A	T	4	4	8	0	1	9	0	0
18	22685608	.	C	A	9	3	12	0	1	13	0	0
18	22686269	.	A	T	6	8	14	0	0	14	0	0
18	22686320	.	G	A	5	2	7	0	0	7	0	0
18	22686358	.	G	A	4	3	7	0	0	7	0	0
18	22686588	.	C	A	2	6	8	0	1	9	0	0
18	22686723	.	C	T	4	3	7	0	0	7	0	0
18	22686789	.	G	A	8	8	16	0	0	17	1	0
18	22686795	.	C	G	10	7	17	0	1	18	0	0
18	22686927	.	G	A	0	4	4	0	0	4	0	0
18	22687312	.	G	A	7	11	18	0	1	19	0	0
18	22687527	.	G	C	10	19	29	0	1	30	0	0
18	22687575	.	T	A	17	27	44	0	0	44	0	0
18	22687599	.	A	T	22	14	36	0	2	38	0	0
18	22687666	.	C	T	22	16	38	0	0	38	0	0
18	22728794	.	A	G	9	13	22	0	3	25	0	0
18	22732391	.	A	G	5	10	15	0	3	18	0	0
18	22921942	.	C	T	12	17	29	0	1	30	0	0
18	22921950	.	T	C	13	19	32	0	0	32	0	0
18	22975090	.	T	C	35	21	56	0	3	59	0	0
18	22975297	.	A	C	31	24	55	0	3	58	0	0
18	23071049	.	A	G	3	2	5	0	0	5	0	0
18	23071190	.	G	A	2	2	4	0	0	4	0	0
18	23071243	.	G	A	2	3	5	0	1	6	0	0
18	23071467	.	C	G	1	0	1	0	2	3	0	0
18	23071744	.	C	A	2	3	5	0	0	5	0	0
18	23071849	.	G	A	3	2	5	0	0	5	0	0
18	23071884	.	A	C	2	4	6	0	0	6	0	0
18	23072164	.	G	A	1	3	4	0	0	4	0	0
18	23869784	.	T	A	22	22	44	0	2	46	0	0
18	23875111	.	A	C	6	6	12	0	0	13	1	0
18	24922149	.	G	A	3	1	4	0	2	6	0	0
18	24926768	.	A	G	3	0	3	0	2	5	0	0
18	24926925	.	T	C	3	7	10	0	0	10	0	0
18	24928941	.	A	G	7	3	10	0	1	11	0	0
18	24929079	.	T	G	5	6	11	0	0	11	0	0
18	24929406	.	A	G	3	0	3	0	4	7	0	0
18	24929413	.	G	A	3	3	6	0	1	7	0	0
18	24929465	.	T	C	5	5	10	0	2	12	0	0
18	24929633	.	C	T	8	5	13	0	1	14	0	0
18	24929720	.	C	T	15	8	23	0	0	23	0	0
18	24930530	.	T	C	13	11	24	0	1	25	0	0
18	24931326	.	G	A	14	13	27	0	2	29	0	0
18	24931699	.	T	C	15	22	37	0	1	38	0	0
18	24933638	.	C	G	15	6	21	0	1	22	0	0
18	24933769	.	C	A	13	12	25	0	0	25	0	0
18	24933799	.	A	G	11	17	28	0	1	29	0	0
18	24934333	.	A	T	10	8	18	0	1	19	0	0
18	24934719	.	G	C	9	11	20	0	2	22	0	0
18	24934950	.	G	A	5	6	11	0	1	12	0	0
18	24935099	.	A	G	20	13	33	0	1	34	0	0
18	24938712	.	A	G	4	7	11	0	2	13	0	0
18	24938805	.	A	G	6	14	20	0	1	21	0	0
18	24938871	.	T	C	9	6	15	0	3	18	0	0
18	24938919	.	C	T	14	6	20	0	1	21	0	0
18	24944039	.	A	T	6	7	13	0	1	14	0	0
18	24944045	.	T	C	9	4	13	0	1	14	0	0
18	24946637	.	T	C	8	5	13	0	1	14	0	0
18	24946727	.	T	A	7	7	14	0	1	15	0	0
18	24952182	.	G	A	4	6	10	0	0	10	0	0
18	24959289	.	G	A	3	2	5	0	0	5	0	0
18	24990332	.	A	G	1	2	3	0	0	3	0	0
18	25003359	.	A	T	11	2	13	0	4	17	0	0
18	25003448	.	G	C	6	2	8	0	0	8	0	0
18	25009233	.	C	T	11	8	19	0	1	20	0	0
18	25009253	.	C	T	15	10	25	0	0	25	0	0
18	25009326	.	C	A	11	10	21	0	1	22	0	0
18	25009407	.	T	C	9	8	17	0	4	21	0	0
18	25230543	.	C	T	1	2	3	0	0	3	0	0
18	25752722	.	G	A	20	14	34	0	1	35	0	0
18	25754551	.	G	A	9	4	13	0	0	13	0	0
18	25754580	.	G	T	7	3	10	0	1	11	0	0
18	25754690	.	T	G	6	2	8	1	0	9	0	0
18	25754693	.	A	G	4	0	4	1	3	8	0	0
18	25783752	.	G	A	1	2	3	0	0	3	0	0
18	25783812	.	T	A	1	1	2	0	1	3	0	0
18	26089305	.	G	C	3	3	6	0	0	6	0	0
18	26097091	.	G	T	37	33	70	0	1	71	0	0
18	26097428	.	G	A	38	27	65	0	2	67	0	0
18	26099274	.	A	T	35	26	61	0	3	64	0	0
18	26338420	.	C	T	1	2	3	0	0	3	0	0
18	26389326	.	G	A	8	8	16	0	0	16	0	0
18	26389401	.	C	T	8	10	18	0	1	19	0	0
18	26393716	.	C	A	13	17	30	0	0	30	0	0
18	26401680	.	T	C	15	14	29	0	2	31	0	0
18	26401719	.	T	C	12	13	25	0	1	26	0	0
18	26401938	.	A	C	17	9	26	0	2	28	0	0
18	26410176	.	T	C	10	3	13	0	0	13	0	0
18	26417753	.	G	A	0	10	10	0	16	26	0	0
18	26426448	.	G	A	5	5	10	0	0	10	0	0
18	26444942	.	C	T	1	2	3	0	0	3	0	0
18	26460723	.	G	T	3	6	9	0	0	9	0	0
18	26460747	.	G	T	3	4	7	0	2	9	0	0
18	26460773	.	A	T	5	2	7	0	0	7	0	0
18	26460846	.	C	A	5	2	7	0	0	7	0	0
18	26480138	.	T	A	2	2	4	0	1	5	0	0
18	26785160	.	A	C	4	2	6	0	0	7	1	0
18	26785162	.	T	A	5	2	7	0	0	7	0	0
18	26790510	.	A	T	6	10	16	0	1	17	0	0
18	26797112	.	G	A	4	5	9	0	0	9	0	0
18	26800148	.	A	C	5	8	13	0	2	15	0	0
18	26800167	.	C	G	3	9	12	0	1	13	0	0
18	26804218	.	G	A	3	7	10	0	0	10	0	0
18	26804233	.	T	A	4	7	11	0	0	11	0	0
18	26807229	.	T	A	3	2	5	0	0	5	0	0
18	26807304	.	C	T	2	5	7	0	1	8	0	0
18	26809791	.	G	T	6	4	10	0	1	11	0	0
18	26810434	.	G	C	2	2	4	0	0	4	0	0
18	26863223	.	T	A	1	2	3	0	0	3	0	0
18	26863230	.	T	C	1	2	3	0	0	3	0	0
18	26863666	.	T	C	6	0	6	0	5	11	0	0
18	26870137	.	G	A	8	6	14	0	3	17	0	0
18	26876449	.	A	C	4	3	7	0	0	7	0	0
18	26885649	.	A	G	2	3	5	0	0	5	0	0
18	26896160	.	G	C	0	3	3	0	3	6	0	0
18	26896277	.	T	C	8	7	15	0	0	15	0	0
18	26896571	.	C	T	2	5	7	0	0	7	0	0
18	26899453	.	T	C	12	9	21	0	2	23	0	0
18	26919226	.	C	T	10	9	19	0	5	24	0	0
18	26919227	.	T	A	14	9	23	0	1	24	0	0
18	26919865	.	T	C	9	5	14	0	0	14	0	0
18	26919989	.	T	A	24	21	45	0	1	46	0	0
18	26920116	.	T	C	4	4	8	0	1	9	0	0
18	26968799	.	G	A	14	9	23	0	1	24	0	0
18	26968822	.	T	C	13	0	13	0	6	19	0	0
18	26977226	.	T	C	3	4	7	0	0	7	0	0
18	27081050	.	C	T	1	2	3	0	1	4	0	0
18	27081056	.	T	C	2	2	4	0	0	4	0	0
18	27081275	.	A	G	3	2	5	0	0	5	0	0
18	27085060	.	A	G	1	2	3	0	0	3	0	0
18	27254538	.	G	A	3	3	6	0	1	7	0	0
18	27254709	.	A	C	2	2	4	0	0	4	0	0
18	27254726	.	T	C	1	4	5	0	0	5	0	0
18	27254774	.	T	C	1	2	3	0	2	5	0	0
18	27259047	.	A	G	1	0	1	0	2	3	0	0
18	27281456	.	A	G	1	3	4	0	0	4	0	0
18	27285741	.	C	T	3	2	5	0	0	5	0	0
18	27309512	.	T	C	6	5	11	0	0	11	0	0
18	27309873	.	C	T	10	20	30	0	3	33	0	0
18	27335583	.	T	C	9	12	21	0	0	21	0	0
18	27335597	.	G	A	12	12	24	0	2	26	0	0
18	27335780	.	A	T	7	9	16	0	0	16	0	0
18	27335828	.	A	G	2	7	9	0	0	9	0	0
18	27358388	.	A	C	2	2	4	0	1	5	0	0
18	27358499	.	G	A	2	4	6	0	1	7	0	0
18	27358537	.	C	T	1	3	4	0	0	4	0	0
18	27358538	.	C	T	1	3	4	0	0	4	0	0
18	27358709	.	A	G	1	3	4	0	1	5	0	0
18	27358841	.	C	T	2	4	6	0	0	6	0	0
18	27358844	.	C	T	2	4	6	0	0	6	0	0
18	27568352	.	A	G	10	7	17	0	2	19	0	0
18	39293066	.	A	G	12	20	32	0	4	36	0	0
18	39293067	.	A	G	33	2	35	0	1	36	0	0
18	39523002	.	T	C	1	4	5	0	0	5	0	0
18	40383282	.	T	A	4	5	9	0	1	10	0	0
18	40383665	.	T	A	4	3	7	0	0	7	0	0
18	40384022	.	G	T	0	11	11	0	8	19	0	0
18	40384160	.	C	T	10	3	13	0	0	13	0	0
18	40384214	.	T	C	6	4	10	0	0	10	0	0
18	40384253	.	A	G	4	5	9	0	0	9	0	0
18	40384277	.	T	A	3	5	8	0	0	8	0	0
18	40387506	.	C	T	10	13	23	0	0	23	0	0
18	40387606	.	G	A	11	12	23	0	1	24	0	0
18	40387650	.	T	A	12	14	26	0	0	26	0	0
18	40387811	.	T	A	8	8	16	0	1	17	0	0
18	40486532	.	T	C	2	2	4	0	2	6	0	0
18	40486632	.	A	G	2	3	5	0	0	5	0	0
18	40489539	.	G	A	9	11	20	0	1	21	0	0
18	40492253	.	T	C	7	5	12	0	1	13	0	0
18	40762874	.	T	A	4	2	6	0	0	6	0	0
18	41278644	.	T	C	2	2	4	0	0	4	0	0
18	41284700	.	C	T	4	2	6	0	0	6	0	0
18	41293901	.	A	T	3	6	9	0	0	9	0	0
18	41295246	.	C	T	5	10	15	0	0	15	0	0
18	41305867	.	C	T	2	5	7	0	2	9	0	0
18	41309305	.	G	A	16	9	25	0	1	26	0	0
18	41310196	.	A	G	4	0	4	0	8	12	0	0
18	41310464	.	G	A	0	14	14	0	14	28	0	0
18	41364697	.	T	C	1	0	1	0	3	4	0	0
18	41364890	.	T	C	2	2	4	0	1	5	0	0
18	41365011	.	A	G	3	3	6	0	0	6	0	0
18	41365125	.	G	A	3	5	8	0	0	8	0	0
18	41365236	.	C	A	3	2	5	0	0	5	0	0
18	41365308	.	C	T	1	4	5	0	0	5	0	0
18	41365482	.	C	T	3	2	5	0	1	6	0	0
18	41365649	.	G	T	2	2	4	0	0	4	0	0
18	41495859	.	A	G	17	18	35	0	2	37	0	0
18	41495865	.	A	T	18	17	35	0	1	36	0	0
18	41499679	.	A	G	15	6	21	0	1	22	0	0
18	41499683	.	T	C	17	6	23	0	1	24	0	0
18	41499789	.	C	T	16	9	25	0	2	27	0	0
18	41503578	.	C	A	18	19	37	0	1	38	0	0
18	41505624	.	A	G	22	1	23	0	19	42	0	0
18	41509564	.	C	G	19	14	33	0	0	33	0	0
18	41509716	.	G	T	19	10	29	0	1	30	0	0
18	41512217	.	C	T	5	14	19	0	0	19	0	0
18	41512370	.	G	A	9	9	18	0	2	20	0	0
18	41514977	.	C	A	2	2	4	0	0	4	0	0
18	41524354	.	G	A	28	24	52	0	5	57	0	0
18	41524364	.	C	A	29	23	52	0	3	55	0	0
18	41525864	.	T	C	27	17	44	0	1	45	0	0
18	41525880	.	G	A	1	18	19	0	27	46	0	0
18	41526014	.	C	G	15	0	15	0	21	36	0	0
18	41526026	.	A	G	17	20	37	0	0	37	0	0
18	41526247	.	T	A	26	18	44	0	0	44	0	0
18	41526299	.	T	A	17	13	30	0	1	31	0	0
18	41526318	.	A	G	11	11	22	0	5	27	0	0
18	41526380	.	C	T	9	9	18	0	4	22	0	0
18	41526381	.	T	C	11	7	18	0	2	20	0	0
18	41533072	.	C	T	6	5	11	1	1	13	0	0
18	41538770	.	G	A	10	13	23	0	1	25	1	0
18	41538795	.	A	G	9	10	19	0	0	19	0	0
18	41538856	.	G	A	4	5	9	0	0	9	0	0
18	41542790	.	T	G	3	6	9	0	0	9	0	0
18	41543076	.	C	T	9	8	17	0	1	18	0	0
18	41547273	.	T	G	2	4	6	0	0	6	0	0
18	41547308	.	C	T	1	2	3	0	0	3	0	0
18	41549817	.	T	A	1	3	4	0	0	4	0	0
18	41556239	.	G	A	0	5	5	0	4	9	0	0
18	41558711	.	C	T	2	6	8	0	0	8	0	0
18	41559028	.	C	T	2	3	5	0	0	5	0	0
18	41559074	.	C	T	1	2	3	0	0	3	0	0
18	41559141	.	A	G	2	2	4	0	0	4	0	0
18	41561248	.	C	T	3	2	5	0	0	5	0	0
18	41572445	.	T	C	2	2	4	0	0	4	0	0
18	41573681	.	T	C	2	4	6	0	0	6	0	0
18	41573696	.	A	G	2	4	6	0	0	6	0	0
18	41573813	.	A	G	1	0	1	0	4	5	0	0
18	41573948	.	G	A	0	2	2	0	6	8	0	0
18	41574340	.	C	T	1	4	5	0	0	5	0	0
18	41574557	.	T	C	1	3	4	0	0	4	0	0
18	41574608	.	T	C	2	5	7	0	0	7	0	0
18	41579975	.	T	A	7	4	11	0	0	11	0	0
18	41580151	.	A	T	3	8	11	0	0	11	0	0
18	41586440	.	T	C	5	6	11	0	0	11	0	0
18	41588148	.	A	G	6	0	6	0	8	14	0	0
18	41588166	.	C	T	5	9	14	0	1	15	0	0
18	41589613	.	A	C	9	4	13	0	2	15	0	0
18	41591247	.	T	G	14	4	18	0	0	18	0	0
18	41591250	.	T	G	15	3	18	0	0	18	0	0
18	41648941	.	T	C	11	5	16	0	1	17	0	0
18	41649061	.	C	T	5	7	12	0	0	12	0	0
18	41649114	.	T	C	5	1	6	0	1	7	0	0
18	41649571	.	A	G	9	11	20	0	0	20	0	0
18	41649949	.	C	T	1	2	3	0	4	7	0	0
18	41650171	.	C	T	5	5	10	0	0	10	0	0
18	41650222	.	C	T	7	9	16	0	2	18	0	0
18	41650396	.	G	A	4	5	9	0	0	9	0	0
18	41757350	.	C	A	7	18	25	0	3	28	0	0
18	41757373	.	G	C	13	21	34	0	1	35	0	0
18	41757449	.	G	A	17	25	42	0	3	45	0	0
18	41757454	.	G	A	15	28	43	0	0	43	0	0
18	41757669	.	C	T	22	27	49	0	3	52	0	0
18	41764434	.	G	A	19	29	48	0	1	49	0	0
18	41764452	.	G	C	18	1	19	0	30	49	0	0
18	41808695	.	T	C	2	4	6	0	0	6	0	0
18	42151412	.	A	C	20	1	21	0	10	31	0	0
18	42165295	.	A	C	8	6	14	0	0	14	0	0
18	42171988	.	T	C	6	0	6	0	4	10	0	0
18	42189660	.	G	A	6	5	11	0	0	11	0	0
18	42189675	.	A	C	6	0	6	0	4	10	0	0
18	42201141	.	C	G	7	8	15	0	0	15	0	0
18	42215403	.	C	T	4	3	7	0	0	7	0	0
18	42313749	.	T	C	2	2	4	0	0	4	0	0
18	42333382	.	C	T	1	2	3	0	0	3	0	0
18	43162650	.	T	C	4	4	8	0	0	8	0	0
18	43183845	.	T	C	5	11	16	0	0	16	0	0
18	43225614	.	T	C	10	6	16	0	1	17	0	0
18	43225650	.	C	T	13	10	23	0	0	23	0	0
18	43225683	.	C	T	18	13	31	0	0	31	0	0
18	43225896	.	C	T	20	24	44	0	4	48	0	0
18	44053453	.	T	C	3	2	5	1	0	6	0	0
18	44321063	.	A	G	6	4	10	0	1	11	0	0
18	44321260	.	T	A	7	7	14	0	1	15	0	0
18	44321323	.	C	T	11	6	17	0	1	18	0	0
18	44321424	.	A	C	3	2	5	0	0	5	0	0
18	44321949	.	T	C	3	6	9	0	0	9	0	0
18	44322280	.	T	C	2	3	5	0	0	5	0	0
18	44322381	.	T	A	2	4	6	0	2	8	0	0
18	44322481	.	C	T	2	14	16	0	8	24	0	0
18	44325470	.	A	G	5	8	13	0	1	14	0	0
18	44325526	.	A	T	8	5	13	0	1	14	0	0
18	44327944	.	A	G	4	7	11	0	0	11	0	0
18	44327953	.	G	A	5	6	11	0	0	11	0	0
18	44331117	.	G	C	2	4	6	0	0	6	0	0
18	44332725	.	C	T	4	3	7	0	1	8	0	0
18	44346150	.	C	A	0	2	2	0	1	3	0	0
18	44359312	.	T	C	1	2	3	0	0	3	0	0
18	44364647	.	C	A	26	21	47	0	2	49	0	0
18	44365064	.	C	A	25	32	57	0	5	63	1	0
18	44365114	.	T	A	38	22	60	0	5	65	0	0
18	44365650	.	T	C	24	16	40	0	4	44	0	0
18	44365714	.	C	A	23	29	52	0	2	54	0	0
18	44365717	.	A	G	22	32	54	0	0	54	0	0
18	44365977	.	T	C	18	18	36	0	3	39	0	0
18	44365987	.	T	A	19	18	37	0	0	37	0	0
18	44366079	.	T	A	4	3	7	0	0	7	0	0
18	44367241	.	A	T	23	20	43	0	0	43	0	0
18	44367426	.	C	T	23	24	47	0	0	47	0	0
18	44367488	.	G	A	27	26	53	0	0	53	0	0
18	44377404	.	C	A	19	7	26	0	1	27	0	0
18	44377417	.	C	T	19	7	26	0	2	28	0	0
18	44388421	.	C	T	8	10	18	0	3	21	0	0
18	44397330	.	G	A	11	7	18	0	2	20	0	0
18	44404609	.	C	T	9	12	21	0	0	21	0	0
18	44404872	.	C	T	6	10	16	0	2	18	0	0
18	44408841	.	G	A	7	3	10	1	1	12	0	0
18	44418164	.	C	T	6	4	10	0	2	12	0	0
18	44425093	.	A	G	4	10	14	0	0	14	0	0
18	44425105	.	C	T	3	9	12	0	1	13	0	0
18	44425150	.	A	C	6	7	13	0	0	13	0	0
18	44567471	.	A	C	1	2	3	0	0	3	0	0
18	44587696	.	C	A	4	4	8	0	0	8	0	0
18	44587777	.	C	A	4	2	6	0	0	6	0	0
18	44589770	.	G	C	4	7	11	0	0	11	0	0
18	44597048	.	G	A	4	2	6	0	1	7	0	0
18	44597308	.	C	A	26	21	47	0	4	52	1	0
18	44597850	.	A	G	16	12	28	0	0	28	0	0
18	44597884	.	G	A	14	10	24	0	1	25	0	0
18	44598234	.	C	T	1	15	16	0	13	29	0	0
18	44598371	.	C	T	11	8	19	0	0	19	0	0
18	44599837	.	G	A	10	21	31	1	4	36	0	0
18	44606194	.	G	A	5	10	15	0	0	15	0	0
18	44615685	.	G	A	8	10	18	0	0	18	0	0
18	44615770	.	G	A	16	10	26	0	2	28	0	0
18	44615819	.	T	C	11	13	24	0	3	27	0	0
18	44615861	.	A	T	9	12	21	0	3	24	0	0
18	44618795	.	G	T	9	23	32	0	1	33	0	0
18	44619049	.	T	G	13	16	29	0	0	29	0	0
18	44623527	.	G	A	11	8	19	0	1	20	0	0
18	44637898	.	G	A	4	6	10	0	0	10	0	0
18	44638087	.	G	T	0	3	3	0	5	8	0	0
18	44640464	.	C	T	1	5	6	0	1	7	0	0
18	44640663	.	C	G	4	4	8	0	1	9	0	0
18	44644443	.	C	A	8	6	14	0	0	14	0	0
18	44645008	.	A	T	6	7	13	0	2	15	0	0
18	44645350	.	A	G	4	0	4	0	2	6	0	0
18	44645368	.	T	C	4	3	7	0	0	7	0	0
18	44645485	.	A	G	1	2	3	0	0	3	0	0
18	44645617	.	G	A	2	14	16	0	10	26	0	0
18	44645782	.	G	C	14	7	21	0	2	23	0	0
18	44645870	.	T	A	5	8	13	0	1	14	0	0
18	44646048	.	C	T	3	5	8	0	0	8	0	0
18	44646215	.	C	T	10	5	15	0	1	16	0	0
18	44646467	.	A	C	14	11	25	0	0	25	0	0
18	44646504	.	C	T	9	10	19	0	2	21	0	0
18	44646587	.	G	A	0	11	11	0	9	20	0	0
18	44646678	.	C	T	16	9	25	0	0	25	0	0
18	44646781	.	A	G	9	10	19	0	0	19	0	0
18	44682124	.	C	T	1	4	5	0	0	5	0	0
18	44692777	.	T	C	4	10	14	0	1	15	0	0
18	44696096	.	C	T	6	10	16	0	0	16	0	0
18	44696319	.	A	C	6	3	9	0	0	9	0	0
18	44696451	.	A	T	3	3	6	0	0	6	0	0
18	44763419	.	T	C	2	2	4	0	0	4	0	0
18	44764392	.	A	T	2	4	6	0	0	6	0	0
18	44765491	.	A	G	2	0	2	0	3	5	0	0
18	44782413	.	G	A	2	3	5	0	0	5	0	0
18	44783771	.	C	T	3	2	5	0	0	5	0	0
18	44790506	.	T	C	2	4	6	0	0	6	0	0
18	44790635	.	A	G	4	4	8	0	0	8	0	0
18	44791251	.	A	C	3	3	6	0	0	6	0	0
18	44791318	.	C	A	3	4	7	0	0	7	0	0
18	44791362	.	T	A	2	2	4	0	0	4	0	0
18	44791774	.	A	G	2	2	4	0	1	5	0	0
18	44826427	.	C	T	1	11	12	0	12	24	0	0
18	44826554	.	T	G	11	15	26	0	1	27	0	0
18	44826910	.	C	T	10	7	17	3	1	21	0	0
18	44830217	.	C	T	5	7	12	0	1	13	0	0
18	44830247	.	G	A	7	7	14	0	0	14	0	0
18	44830283	.	G	A	14	7	21	0	1	22	0	0
18	44832693	.	C	A	15	12	27	0	2	29	0	0
18	44834165	.	T	C	13	0	13	0	9	22	0	0
18	44837085	.	T	C	8	7	15	0	1	16	0	0
18	44838285	.	G	A	6	16	22	0	1	23	0	0
18	44838342	.	G	A	14	13	27	0	0	27	0	0
18	44840994	.	C	T	10	20	30	0	1	31	0	0
18	44843531	.	C	A	9	7	16	0	1	17	0	0
18	44857803	.	C	A	8	3	11	0	0	11	0	0
18	44866841	.	C	T	11	14	25	0	0	25	0	0
18	44870505	.	G	A	1	6	7	0	6	13	0	0
18	44870526	.	G	A	1	4	5	0	7	12	0	0
18	44870541	.	G	A	2	5	7	0	7	14	0	0
18	44873083	.	C	T	9	9	18	0	0	18	0	0
18	44873993	.	G	T	13	17	30	0	4	34	0	0
18	44874249	.	T	G	3	0	3	0	8	11	0	0
18	44874252	.	C	T	3	8	11	0	0	11	0	0
18	44913653	.	G	T	9	6	15	0	0	15	0	0
18	44913760	.	A	G	4	4	8	0	0	8	0	0
18	45257475	.	C	T	2	5	7	0	0	7	0	0
18	45259886	.	T	C	3	6	9	0	3	12	0	0
18	45259930	.	C	T	5	3	8	0	0	8	0	0
18	45260228	.	T	C	5	3	8	0	0	8	0	0
18	45260316	.	A	C	1	6	7	0	0	7	0	0
18	45260321	.	G	T	0	2	2	0	6	8	0	0
18	45261085	.	G	A	2	2	4	0	0	4	0	0
18	45261319	.	A	T	6	3	9	0	1	10	0	0
18	45261369	.	G	T	7	8	15	0	1	16	0	0
18	45261438	.	G	A	4	7	11	0	0	11	0	0
18	45261845	.	T	A	2	6	8	0	0	8	0	0
18	45261882	.	T	C	7	5	12	0	0	12	0	0
18	45262227	.	C	T	11	3	14	0	1	15	0	0
18	45262351	.	C	T	8	4	12	0	0	12	0	0
18	45262687	.	G	T	11	10	21	0	1	22	0	0
18	45262855	.	A	C	8	10	18	0	0	18	0	0
18	45262865	.	T	C	8	11	19	0	1	20	0	0
18	45550831	.	G	C	1	7	8	0	5	13	0	0
18	45550839	.	A	C	5	9	14	0	2	16	0	0
18	45561677	.	G	T	9	12	21	0	1	22	0	0
18	45569037	.	G	A	1	5	6	1	14	21	0	0
18	45569075	.	C	A	14	6	20	0	1	21	0	0
18	45569092	.	A	G	10	0	10	0	4	14	0	0
18	45574140	.	A	G	9	18	27	0	4	31	0	0
18	45574275	.	A	T	11	10	21	0	0	21	0	0
18	45575079	.	G	A	0	11	11	0	14	25	0	0
18	45581704	.	C	A	21	11	32	0	0	32	0	0
18	45581784	.	C	T	16	12	28	0	0	28	0	0
18	45583038	.	A	C	14	13	27	0	1	28	0	0
18	45583042	.	G	A	1	13	14	0	15	29	0	0
18	45584036	.	C	T	19	7	26	0	0	26	0	0
18	45584368	.	T	C	20	17	37	0	4	41	0	0
18	45588336	.	C	T	23	19	42	0	2	44	0	0
18	45591836	.	A	T	7	22	29	0	1	30	0	0
18	45591929	.	G	A	14	16	30	0	0	30	0	0
18	45647838	.	G	A	2	12	14	1	14	29	0	0
18	45647940	.	C	T	18	10	28	0	0	28	0	0
18	45649613	.	C	T	16	11	27	0	3	30	0	0
18	45649658	.	G	T	18	11	29	0	0	29	0	0
18	45651032	.	C	T	21	24	45	0	1	46	0	0
18	45651559	.	T	A	17	21	38	0	2	40	0	0
18	45656062	.	T	C	19	13	32	0	3	35	0	0
18	45656089	.	T	C	17	17	34	0	3	37	0	0
18	45673979	.	A	G	1	2	3	0	0	3	0	0
18	45684977	.	T	C	1	3	4	0	0	4	0	0
18	45685805	.	A	C	1	3	4	0	0	4	0	0
18	45686267	.	G	A	3	2	5	0	0	5	0	0
18	45686500	.	A	G	3	3	6	0	0	6	0	0
18	45686840	.	T	C	4	3	7	0	0	7	0	0
18	45686882	.	G	A	0	3	3	0	8	11	0	0
18	45687258	.	G	C	3	4	7	0	0	7	0	0
18	45687882	.	C	T	7	2	9	0	0	9	0	0
18	45689081	.	C	T	7	6	13	0	0	13	0	0
18	45691123	.	G	A	2	7	9	0	0	9	0	0
18	45697623	.	A	G	1	3	4	0	2	6	0	0
18	45697833	.	A	T	3	3	6	0	0	6	0	0
18	45697909	.	C	T	4	2	6	0	2	8	0	0
18	45697999	.	T	C	2	3	5	0	2	7	0	0
18	45698032	.	A	G	5	0	5	0	3	8	0	0
18	45698344	.	C	A	2	4	6	0	0	6	0	0
18	45734477	.	T	C	15	4	19	0	0	19	0	0
18	45742051	.	C	A	14	11	25	0	2	27	0	0
18	45742059	.	G	A	13	14	27	0	1	28	0	0
18	45743004	.	G	C	7	0	7	0	11	18	0	0
18	45743518	.	G	A	5	4	9	0	2	11	0	0
18	45743522	.	G	A	5	5	10	0	0	10	0	0
18	45743555	.	C	A	8	4	12	0	0	12	0	0
18	45745504	.	A	T	7	6	13	0	0	13	0	0
18	45750912	.	A	C	3	0	3	0	6	9	0	0
18	45750915	.	A	G	3	4	7	0	2	9	0	0
18	45752094	.	C	T	0	3	3	0	3	6	0	0
18	45759309	.	G	T	7	12	19	0	0	19	0	0
18	45784225	.	A	G	33	42	75	0	5	80	0	0
18	45807903	.	C	G	3	0	3	0	4	7	0	0
18	45807942	.	G	C	1	4	5	0	7	12	0	0
18	45809872	.	A	G	4	0	4	0	7	11	0	0
18	45809892	.	T	C	5	3	8	0	0	8	0	0
18	45818602	.	C	T	5	10	15	0	0	15	0	0
18	45820510	.	G	A	2	3	5	0	8	13	0	0
18	45820588	.	A	G	13	9	22	0	1	23	0	0
18	45824315	.	C	T	5	10	15	1	1	17	0	0
18	45824467	.	G	A	0	5	5	0	11	16	0	0
18	45824607	.	G	A	8	8	16	0	0	16	0	0
18	45835115	.	C	T	12	16	28	0	2	30	0	0
18	45840471	.	T	A	13	11	24	0	0	24	0	0
18	45840504	.	C	T	10	18	28	0	3	31	0	0
18	45842491	.	T	C	15	23	38	1	1	40	0	0
18	45842679	.	G	A	2	22	24	0	17	41	0	0
18	45844458	.	C	T	17	16	33	0	3	37	1	0
18	45844473	.	A	T	21	18	39	0	1	41	1	0
18	45848355	.	C	T	20	24	44	0	0	44	0	0
18	45849283	.	C	T	17	21	38	0	2	40	0	0
18	45851540	.	G	A	1	14	15	0	23	38	0	0
18	45886957	.	G	T	1	3	4	0	0	4	0	0
18	45934646	.	G	A	0	2	2	0	2	4	0	0
18	45934691	.	G	T	1	1	2	0	1	3	0	0
18	45936773	.	G	A	1	3	4	0	0	4	0	0
18	45944522	.	G	A	2	2	4	0	0	4	0	0
18	45944546	.	C	T	1	3	4	0	0	4	0	0
18	45944903	.	G	T	3	2	5	0	1	6	0	0
18	45947880	.	C	A	2	3	5	0	0	5	0	0
18	45948071	.	C	A	2	2	4	0	0	4	0	0
18	45948213	.	G	A	4	2	6	0	0	6	0	0
18	45962500	.	A	G	22	13	35	0	0	35	0	0
18	45962581	.	T	C	17	13	30	0	1	31	0	0
18	45962593	.	G	C	17	11	28	0	3	31	0	0
18	45962668	.	C	T	20	11	31	0	2	33	0	0
18	45969252	.	C	A	25	17	42	0	1	43	0	0
18	45979887	.	C	T	17	17	34	0	3	37	0	0
18	45983268	.	A	C	15	18	33	0	2	35	0	0
18	46005023	.	T	A	5	3	8	0	0	8	0	0
18	46012631	.	C	T	2	5	7	0	0	7	0	0
18	46015830	.	G	A	4	2	6	0	0	6	0	0
18	46059425	.	A	C	3	4	7	0	0	7	0	0
18	46061242	.	G	A	5	2	7	0	0	7	0	0
18	46061326	.	C	A	6	2	8	0	1	9	0	0
18	46063648	.	C	T	5	6	11	0	1	12	0	0
18	46172805	.	A	G	5	0	5	2	2	9	0	0
18	46367691	.	G	C	11	7	18	0	2	20	0	0
18	46367733	.	G	A	8	10	18	0	1	19	0	0
18	46367772	.	C	G	0	11	11	0	10	21	0	0
18	46417181	.	C	T	15	9	24	0	0	24	0	0
18	46417342	.	A	G	16	20	36	0	1	37	0	0
18	46417402	.	G	A	15	14	29	0	1	30	0	0
18	46417624	.	T	C	12	4	16	0	2	18	0	0
18	46417714	.	G	C	11	11	22	0	1	23	0	0
18	46417775	.	T	C	19	0	19	0	13	32	0	0
18	46418632	.	G	A	6	10	16	0	0	16	0	0
18	46418818	.	C	A	4	4	8	0	0	8	0	0
18	46418860	.	C	T	1	8	9	0	3	12	0	0
18	46419056	.	C	T	5	6	11	0	3	14	0	0
18	46419124	.	T	C	5	6	11	0	0	11	0	0
18	46419275	.	T	C	10	5	15	0	1	16	0	0
18	46419451	.	A	T	2	5	7	0	0	7	0	0
18	46684230	.	A	T	3	2	5	0	0	5	0	0
18	46699773	.	G	A	16	21	37	0	1	38	0	0
18	46702492	.	G	A	15	10	25	0	0	25	0	0
18	46714896	.	A	G	5	3	8	0	0	8	0	0
18	47301204	.	T	C	4	3	7	0	1	8	0	0
18	47305433	.	A	G	11	9	20	0	1	21	0	0
18	47306677	.	T	G	2	2	4	1	0	5	0	0
18	47306782	.	A	G	2	4	6	0	0	6	0	0
18	47523393	.	A	G	3	2	5	0	0	5	0	0
18	48640143	.	G	C	0	3	3	0	3	6	0	0
18	48640155	.	G	C	0	3	3	0	2	5	0	0
18	48640284	.	C	G	1	0	1	0	2	3	0	0
18	48640417	.	G	C	2	2	4	0	0	4	0	0
18	48640420	.	A	G	2	2	4	0	0	4	0	0
18	48640707	.	C	T	2	3	5	0	0	5	0	0
18	48642161	.	A	T	2	2	4	0	0	4	0	0
18	48642335	.	C	T	2	2	4	0	0	4	0	0
18	48642372	.	T	C	2	4	6	0	0	6	0	0
18	48642373	.	T	C	1	4	5	0	1	6	0	0
18	48642821	.	C	T	1	2	3	0	0	3	0	0
18	48715931	.	A	C	1	2	3	0	0	3	0	0
18	48759970	.	A	C	6	7	13	1	0	14	0	0
18	48808043	.	A	G	2	3	5	0	0	5	0	0
18	48808099	.	A	G	3	3	6	0	0	6	0	0
18	48808185	.	C	T	1	4	5	0	0	5	0	0
18	48808372	.	G	A	3	3	6	0	0	6	0	0
18	48808396	.	A	G	4	3	7	0	0	7	0	0
18	48808552	.	T	C	5	2	7	0	0	7	0	0
18	48808708	.	T	A	3	2	5	0	0	5	0	0
18	48809226	.	G	A	11	4	15	0	0	15	0	0
18	48864665	.	C	T	3	2	5	0	0	5	0	0
18	48864668	.	T	C	3	2	5	0	0	5	0	0
18	48898641	.	C	T	3	5	8	0	1	9	0	0
18	48928230	.	C	T	9	11	20	0	0	20	0	0
18	48928240	.	A	G	9	0	9	0	12	21	0	0
18	48928342	.	A	G	17	0	17	0	12	29	0	0
18	48928387	.	T	A	10	13	23	0	1	24	0	0
18	48934524	.	T	C	11	16	27	0	0	27	0	0
18	48934593	.	T	C	12	12	24	0	2	26	0	0
18	48934805	.	A	G	14	16	30	0	1	31	0	0
18	48934833	.	T	C	14	18	32	0	1	33	0	0
18	48935170	.	G	A	15	19	34	0	1	35	0	0
18	48935279	.	T	G	13	25	38	0	3	41	0	0
18	48935282	.	T	G	16	26	42	0	1	43	0	0
18	48935394	.	A	T	15	14	29	0	2	31	0	0
18	48935709	.	A	G	12	24	36	0	2	38	0	0
18	48935907	.	T	C	5	9	14	0	3	17	0	0
18	48967500	.	T	C	1	2	3	0	0	3	0	0
18	48971165	.	T	C	2	11	13	0	0	13	0	0
18	48971192	.	A	G	3	7	10	0	0	10	0	0
18	48972490	.	A	T	7	6	13	0	1	14	0	0
18	49154130	.	A	G	2	3	5	0	0	5	0	0
18	49154131	.	A	G	3	2	5	0	0	5	0	0
18	49154207	.	A	G	8	4	12	0	2	14	0	0
18	49155520	.	A	G	12	7	19	0	2	21	0	0
18	49156077	.	A	G	14	0	14	0	9	23	0	0
18	49156113	.	A	G	9	4	13	0	2	15	0	0
18	49266589	.	A	G	3	7	10	3	0	13	0	0
18	49266635	.	A	G	4	3	7	0	2	9	0	0
18	49266932	.	A	G	2	2	4	5	0	9	0	0
18	49266998	.	A	G	5	6	11	0	0	11	0	0
18	49267191	.	A	T	0	3	3	0	0	3	0	0
18	49267199	.	C	T	3	0	3	0	1	4	0	0
18	49267605	.	A	G	7	6	13	5	0	18	0	0
18	49446470	.	G	A	0	3	3	0	4	7	0	0
18	50038325	.	G	T	0	7	7	0	1	8	0	0
18	50038539	.	A	G	5	3	8	0	3	11	0	0
18	50099441	.	A	G	2	3	5	0	0	5	0	0
18	50537645	.	A	G	14	4	18	2	1	21	0	0
18	50538289	.	T	C	16	7	23	0	1	24	0	0
18	50538340	.	T	C	7	18	25	0	0	25	0	0
18	50689583	.	G	A	1	0	1	0	0	1	0	0
18	50709147	.	C	A	3	2	5	0	18	23	0	0
19	175381	.	A	G	10	4	14	0	1	15	0	0
19	372246	.	A	G	10	7	17	0	0	17	0	0
19	372691	.	A	G	5	9	14	0	0	14	0	0
19	372694	.	A	G	11	4	15	0	0	15	0	0
19	372768	.	A	G	11	0	11	0	6	17	0	0
19	981432	.	C	T	2	9	11	0	6	17	0	0
19	981483	.	A	G	6	7	13	0	0	13	0	0
19	983651	.	T	G	3	7	10	0	0	10	0	0
19	1006213	.	G	A	1	4	5	0	2	7	0	0
19	1008043	.	T	C	1	1	2	0	2	4	0	0
19	1008049	.	A	G	1	0	1	0	3	4	0	0
19	1009031	.	C	T	2	2	4	0	0	4	0	0
19	1010362	.	T	C	1	4	5	0	0	5	0	0
19	1010529	.	C	A	5	3	8	0	0	8	0	0
19	1010592	.	C	T	6	3	9	0	0	9	0	0
19	1010901	.	C	T	3	4	7	0	0	7	0	0
19	1010904	.	T	A	3	4	7	0	0	7	0	0
19	1010962	.	T	A	1	5	6	0	0	6	0	0
19	1010983	.	C	T	0	1	1	0	1	2	0	0
19	1011091	.	C	T	1	1	2	0	2	4	0	0
19	1011329	.	C	A	1	2	3	0	0	3	0	0
19	1011400	.	C	T	1	4	5	0	0	5	0	0
19	1011530	.	A	G	4	4	8	0	0	8	0	0
19	1011697	.	A	C	2	2	4	0	0	4	0	0
19	1011917	.	T	C	2	3	5	0	0	5	0	0
19	1011926	.	T	C	2	3	5	0	0	5	0	0
19	1011955	.	T	G	2	4	6	0	0	6	0	0
19	1012085	.	A	C	3	4	7	0	0	7	0	0
19	1012459	.	A	G	3	1	4	0	1	5	0	0
19	1012474	.	T	C	3	4	7	0	2	9	0	0
19	1012683	.	C	T	2	3	5	0	0	5	0	0
19	1012888	.	A	T	4	5	9	0	1	10	0	0
19	1013144	.	G	A	7	4	11	1	8	20	0	0
19	1019153	.	T	C	17	0	17	0	13	30	0	0
19	1021490	.	C	T	8	7	15	0	1	16	0	0
19	1097579	.	A	G	9	1	10	0	7	17	0	0
19	1097613	.	T	C	13	6	19	0	2	21	0	0
19	1097616	.	T	C	14	7	21	0	1	22	0	0
19	1110528	.	G	A	12	13	25	0	4	29	0	0
19	1111871	.	T	C	8	13	21	0	2	23	0	0
19	1111882	.	G	T	10	12	22	0	2	24	0	0
19	1111982	.	T	G	9	4	13	0	1	14	0	0
19	1111983	.	G	A	9	4	13	0	1	14	0	0
19	1112032	.	C	A	8	9	17	0	1	18	0	0
19	1185244	.	T	C	6	5	11	0	0	11	0	0
19	1185281	.	G	A	1	3	4	0	2	6	0	0
19	1185343	.	G	A	0	4	4	0	6	10	0	0
19	1185485	.	A	G	8	7	15	0	0	15	0	0
19	1330675	.	C	T	1	3	4	0	5	9	0	0
19	1330780	.	C	G	8	4	12	0	0	12	0	0
19	1330862	.	G	A	1	2	3	0	1	4	0	0
19	1331172	.	T	C	4	7	11	0	0	11	0	0
19	1331296	.	C	T	1	8	9	0	8	17	0	0
19	1331344	.	C	A	7	5	12	0	0	12	0	0
19	1331443	.	T	C	6	0	6	0	6	12	0	0
19	1331446	.	C	T	7	4	11	0	0	11	0	0
19	1358114	.	A	G	6	6	12	0	1	13	0	0
19	1361459	.	C	T	2	3	5	0	0	5	0	0
19	1361932	.	C	T	4	4	8	0	0	8	0	0
19	1362021	.	T	G	1	5	6	0	0	6	0	0
19	1382119	.	T	C	2	2	4	0	1	5	0	0
19	1389704	.	C	T	15	6	21	0	1	22	0	0
19	1389886	.	C	T	8	7	15	0	2	17	0	0
19	1389892	.	C	A	9	6	15	0	1	16	0	0
19	1392134	.	G	A	1	13	14	0	17	31	0	0
19	1392177	.	A	C	12	6	18	0	0	18	0	0
19	1392178	.	C	T	12	5	17	0	1	18	0	0
19	1392482	.	T	C	8	9	17	0	0	17	0	0
19	1392657	.	T	C	17	8	25	0	2	27	0	0
19	1392713	.	A	G	19	14	33	0	3	36	0	0
19	1392718	.	A	T	18	14	32	0	3	35	0	0
19	1393073	.	T	A	5	24	29	0	1	30	0	0
19	1393085	.	C	A	6	24	30	0	1	31	0	0
19	1393176	.	C	T	7	7	14	0	1	15	0	0
19	1393199	.	A	G	7	9	16	0	0	16	0	0
19	1406694	.	G	T	8	5	13	0	0	13	0	0
19	1406967	.	G	T	2	5	7	0	2	9	0	0
19	1407180	.	T	C	4	6	10	0	1	11	0	0
19	1407181	.	T	A	7	4	11	0	0	11	0	0
19	1407731	.	G	A	2	2	4	0	1	5	0	0
19	1407795	.	A	G	5	5	10	0	0	10	0	0
19	1669830	.	G	A	1	3	4	0	0	4	0	0
19	1673756	.	C	T	4	5	9	0	0	9	0	0
19	1735559	.	C	T	2	3	5	0	0	5	0	0
19	1735595	.	A	T	4	2	6	0	0	6	0	0
19	1736291	.	A	G	2	2	4	0	0	4	0	0
19	1737162	.	A	T	1	4	5	0	2	7	0	0
19	1835945	.	G	A	0	3	3	0	2	5	0	0
19	1848021	.	T	C	3	5	8	0	0	8	0	0
19	1848143	.	C	G	3	5	8	0	0	8	0	0
19	1856556	.	C	G	14	14	28	0	1	29	0	0
19	1856641	.	T	A	9	13	22	1	1	24	0	0
19	1858785	.	G	A	9	15	24	0	1	25	0	0
19	1861691	.	A	G	4	6	10	0	2	12	0	0
19	1872897	.	G	A	9	14	23	0	0	23	0	0
19	1877536	.	G	C	31	20	51	0	1	52	0	0
19	1877544	.	G	T	29	15	44	0	2	46	0	0
19	1877662	.	C	G	9	6	15	1	1	17	0	0
19	1878618	.	G	A	4	6	10	0	1	11	0	0
19	1878630	.	C	G	4	11	15	0	1	16	0	0
19	1879854	.	C	T	5	3	8	0	0	8	0	0
19	1880595	.	C	G	9	4	13	0	2	15	0	0
19	1880602	.	T	C	5	9	14	0	1	15	0	0
19	1880836	.	G	A	1	8	9	0	3	12	0	0
19	1880886	.	T	C	4	3	7	0	0	7	0	0
19	1937137	.	T	A	1	2	3	0	0	3	0	0
19	1947078	.	T	A	1	3	4	0	0	4	0	0
19	1953543	.	A	T	15	16	31	0	3	34	0	0
19	1953583	.	G	T	23	10	33	0	0	33	0	0
19	1953742	.	C	T	19	14	33	0	1	34	0	0
19	1960987	.	T	G	12	11	23	0	0	23	0	0
19	1990839	.	G	C	1	2	3	0	0	3	0	0
19	1992908	.	G	C	1	3	4	0	0	4	0	0
19	1995441	.	A	G	6	3	9	0	0	9	0	0
19	1995590	.	T	G	5	3	8	0	0	8	0	0
19	1995594	.	A	G	5	3	8	0	0	8	0	0
19	1996248	.	A	T	5	5	10	0	0	10	0	0
19	1996323	.	T	A	3	5	8	0	0	8	0	0
19	1996366	.	A	G	3	4	7	0	0	7	0	0
19	1996550	.	G	A	6	4	10	0	0	10	0	0
19	1996577	.	C	T	4	5	9	0	0	9	0	0
19	1996656	.	G	A	1	3	4	0	0	4	0	0
19	1996685	.	T	A	2	2	4	0	0	4	0	0
19	1996810	.	G	C	4	4	8	0	0	8	0	0
19	1997066	.	C	T	3	2	5	0	0	5	0	0
19	1997074	.	T	G	2	2	4	0	1	5	0	0
19	1997120	.	G	A	1	4	5	0	0	5	0	0
19	1997159	.	T	C	7	7	14	0	0	14	0	0
19	1997165	.	C	T	6	7	13	0	0	13	0	0
19	1997638	.	T	A	10	4	14	0	0	14	0	0
19	1997658	.	A	T	4	8	12	0	0	12	0	0
19	1997676	.	T	C	4	5	9	0	1	10	0	0
19	1997733	.	C	T	8	2	10	0	0	10	0	0
19	1997767	.	C	G	13	5	18	0	0	18	0	0
19	1997868	.	T	A	9	4	13	0	2	15	0	0
19	1997978	.	G	A	7	4	11	0	2	13	0	0
19	1998153	.	C	A	6	9	15	0	3	18	0	0
19	1998160	.	A	T	7	13	20	0	0	20	0	0
19	2001572	.	C	T	1	2	3	0	1	4	0	0
19	2001618	.	A	C	6	5	11	0	0	11	0	0
19	2002992	.	A	G	3	0	3	0	6	9	0	0
19	2003634	.	T	C	3	2	5	0	1	6	0	0
19	2003644	.	G	C	0	2	2	0	2	4	0	0
19	2003767	.	C	T	7	6	13	0	0	13	0	0
19	2003902	.	A	T	12	8	20	0	0	20	0	0
19	2003962	.	G	T	1	10	11	0	12	23	0	0
19	2019480	.	C	T	0	2	2	0	4	6	0	0
19	2023996	.	G	A	1	2	3	0	0	3	0	0
19	2028006	.	T	C	2	2	4	0	0	4	0	0
19	2064762	.	G	C	1	2	3	0	1	4	0	0
19	2065004	.	T	G	2	2	4	0	0	4	0	0
19	2279086	.	T	G	3	4	7	0	0	7	0	0
19	2279284	.	C	T	7	2	9	0	0	9	0	0
19	2298917	.	T	A	4	3	7	0	0	7	0	0
19	2307248	.	C	A	9	2	11	0	1	12	0	0
19	2307268	.	C	T	7	4	11	0	1	12	0	0
19	2307374	.	C	T	2	2	4	0	0	4	0	0
19	2307544	.	T	C	9	3	12	1	1	14	0	0
19	2315511	.	C	T	0	3	3	0	5	8	0	0
19	2315721	.	A	G	2	7	9	0	0	9	0	0
19	2315961	.	G	A	4	4	8	0	0	8	0	0
19	2316510	.	T	C	2	3	5	0	0	5	0	0
19	2316729	.	G	C	2	3	5	0	0	5	0	0
19	2396022	.	C	T	2	2	4	0	0	4	0	0
19	2396037	.	G	A	3	2	5	1	0	6	0	0
19	2396464	.	T	A	3	1	4	0	1	5	0	0
19	2396492	.	C	A	1	2	3	0	1	4	0	0
19	2396643	.	G	A	3	4	7	0	0	7	0	0
19	2396647	.	C	T	4	3	7	0	0	7	0	0
19	2396681	.	G	A	2	3	5	0	1	6	0	0
19	2396898	.	G	A	1	2	3	0	0	3	0	0
19	2396926	.	G	A	1	2	3	0	0	3	0	0
19	2397381	.	G	C	2	5	7	0	0	7	0	0
19	2402609	.	T	A	4	4	8	0	0	8	0	0
19	2402611	.	T	A	4	3	7	0	0	8	1	0
19	2403804	.	C	G	1	4	5	0	0	5	0	0
19	2551178	.	A	G	2	3	5	0	1	6	0	0
19	2551214	.	C	T	4	3	7	0	0	7	0	0
19	2551727	.	C	T	8	4	12	0	0	12	0	0
19	2557750	.	A	G	3	11	14	0	0	14	0	0
19	2560883	.	T	G	5	3	8	8	0	16	0	0
19	2560950	.	A	G	5	5	10	0	0	10	0	0
19	2561445	.	C	A	9	1	10	0	0	10	0	0
19	2561583	.	A	T	8	10	18	1	1	20	0	0
19	2561596	.	T	A	10	13	23	1	1	25	0	0
19	2561637	.	G	T	2	15	17	0	18	35	0	0
19	2561739	.	G	A	2	11	13	0	5	18	0	0
19	2561811	.	A	G	6	16	22	0	0	22	0	0
19	2561833	.	A	G	12	13	25	0	0	25	0	0
19	2561861	.	A	G	13	3	16	0	0	16	0	0
19	2562179	.	T	C	3	2	5	0	0	5	0	0
19	2562464	.	A	G	8	7	15	0	0	15	0	0
19	2871511	.	A	G	7	10	17	0	1	18	0	0
19	2871553	.	C	T	7	10	17	0	0	17	0	0
19	2872162	.	G	A	12	9	21	0	1	22	0	0
19	2875896	.	T	A	3	5	8	0	1	9	0	0
19	2877563	.	C	T	2	2	4	0	0	4	0	0
19	2877569	.	G	C	1	3	4	0	0	4	0	0
19	2882754	.	A	C	8	3	11	0	0	11	0	0
19	2930521	.	T	C	2	3	5	0	0	5	0	0
19	2934321	.	A	G	3	3	6	0	0	6	0	0
19	2940996	.	G	T	3	2	5	0	0	5	0	0
19	3053041	.	C	T	1	2	3	0	0	3	0	0
19	3080647	.	G	A	3	1	4	0	0	4	0	0
19	3080657	.	T	G	3	3	6	0	1	7	0	0
19	3080712	.	T	A	5	6	11	0	0	11	0	0
19	3080907	.	A	T	2	3	5	0	0	5	0	0
19	3081206	.	G	T	4	5	9	0	0	9	0	0
19	3081388	.	A	G	7	0	7	0	4	11	0	0
19	3081394	.	A	G	4	6	10	0	0	10	0	0
19	3081927	.	G	A	3	7	10	0	2	12	0	0
19	3081933	.	G	A	1	7	8	0	5	13	0	0
19	3082102	.	C	T	11	8	19	0	1	20	0	0
19	3087025	.	A	G	2	10	12	0	0	12	0	0
19	3137727	.	C	T	2	30	32	0	26	58	0	0
19	3137761	.	C	A	17	35	52	0	1	53	0	0
19	3137803	.	A	T	20	23	43	0	7	50	0	0
19	3137888	.	T	C	14	0	14	0	29	43	0	0
19	3138166	.	G	T	18	3	21	0	1	24	2	0
19	3138325	.	A	C	17	16	33	0	0	33	0	0
19	3138355	.	T	G	17	16	33	0	4	37	0	0
19	3138638	.	T	C	10	0	10	0	7	17	0	0
19	3142240	.	T	C	7	7	14	0	0	14	0	0
19	3142260	.	T	C	9	0	9	0	6	15	0	0
19	3142286	.	C	G	8	10	18	0	0	18	0	0
19	3144567	.	A	G	2	8	10	0	0	10	0	0
19	3144841	.	T	A	3	7	10	0	0	10	0	0
19	3144859	.	C	T	2	8	10	0	0	10	0	0
19	3149296	.	A	C	3	4	7	0	1	8	0	0
19	3149320	.	T	G	4	4	8	0	0	8	0	0
19	3149692	.	A	G	1	3	4	0	0	4	0	0
19	3386580	.	T	A	6	3	9	0	1	10	0	0
19	3866165	.	T	C	9	9	18	0	4	22	0	0
19	4530264	.	T	C	1	2	3	0	0	3	0	0
19	4530872	.	G	T	1	5	6	0	3	9	0	0
19	4828428	.	A	T	1	2	3	0	0	3	0	0
19	4856678	.	A	G	2	3	5	0	0	5	0	0
19	4857526	.	C	T	6	3	9	0	0	9	0	0
19	4857697	.	C	A	3	2	5	0	0	5	0	0
19	4857746	.	G	A	2	3	5	0	0	5	0	0
19	4857802	.	C	T	2	6	8	0	0	8	0	0
19	4857910	.	A	G	5	3	8	0	2	10	0	0
19	4858000	.	C	T	4	4	8	0	0	8	0	0
19	4866727	.	T	C	3	5	8	0	0	8	0	0
19	4866919	.	T	C	6	13	19	0	2	21	0	0
19	4867132	.	G	A	1	4	5	0	5	10	0	0
19	4867232	.	C	G	6	9	15	0	1	16	0	0
19	4867274	.	G	A	0	4	4	0	9	13	0	0
19	4875595	.	A	G	8	6	14	0	0	14	0	0
19	4877141	.	T	C	6	5	11	0	1	12	0	0
19	4878751	.	C	T	4	5	9	0	1	10	0	0
19	4881345	.	G	T	3	7	10	0	0	10	0	0
19	4881414	.	T	C	5	9	14	0	0	14	0	0
19	4885398	.	A	G	6	10	16	0	0	16	0	0
19	4885431	.	A	G	3	7	10	0	2	12	0	0
19	4888471	.	T	G	9	7	16	0	2	18	0	0
19	4888684	.	T	C	21	9	30	0	2	32	0	0
19	4888693	.	T	C	18	9	27	0	4	31	0	0
19	4888720	.	A	G	13	13	26	0	2	28	0	0
19	4888744	.	A	G	17	12	29	0	0	29	0	0
19	4892530	.	G	T	1	13	14	0	11	25	0	0
19	4892628	.	A	G	7	5	12	0	1	13	0	0
19	4892787	.	C	T	8	8	16	0	1	17	0	0
19	4892940	.	G	A	1	10	11	0	8	19	0	0
19	4893033	.	A	G	3	0	3	0	9	12	0	0
19	4903907	.	C	T	17	7	24	0	1	25	0	0
19	4903971	.	A	T	9	17	26	0	0	26	0	0
19	4903998	.	A	G	6	14	20	0	2	22	0	0
19	4904041	.	C	T	9	8	17	0	4	21	0	0
19	4904127	.	C	T	15	5	20	0	2	22	0	0
19	4904407	.	T	C	4	2	6	0	0	6	0	0
19	4904467	.	G	A	6	4	10	0	0	10	0	0
19	4904470	.	A	G	5	0	5	0	5	10	0	0
19	4904747	.	A	C	7	5	12	0	1	13	0	0
19	4904767	.	T	C	11	7	18	0	1	19	0	0
19	4904972	.	T	C	11	9	20	0	0	20	0	0
19	4904991	.	T	C	10	7	17	0	0	17	0	0
19	4905175	.	G	A	15	6	21	0	2	23	0	0
19	4905229	.	T	C	9	6	15	0	3	18	0	0
19	4913087	.	A	G	3	5	8	0	0	8	0	0
19	4961603	.	C	T	4	5	9	0	0	9	0	0
19	4961656	.	A	G	3	7	10	0	0	10	0	0
19	4961950	.	A	T	12	11	23	0	0	23	0	0
19	4961977	.	A	T	6	12	18	0	0	18	0	0
19	4973136	.	G	A	0	6	6	0	2	8	0	0
19	4976906	.	C	T	4	4	8	0	0	8	0	0
19	4976925	.	C	G	5	4	9	0	0	9	0	0
19	4978656	.	A	G	1	0	1	0	3	4	0	0
19	4978704	.	C	G	1	2	3	0	1	4	0	0
19	4978716	.	A	G	1	2	3	0	1	4	0	0
19	4985064	.	T	A	6	5	11	0	0	11	0	0
19	4985105	.	A	G	4	2	6	0	0	6	0	0
19	4985125	.	C	T	2	3	5	0	0	5	0	0
19	4985151	.	T	A	2	2	4	0	1	5	0	0
19	4985444	.	T	C	5	2	7	0	0	7	0	0
19	4985465	.	T	A	3	2	5	0	0	6	1	0
19	4985720	.	A	T	2	1	3	0	1	4	0	0
19	4985721	.	T	A	2	2	4	0	0	4	0	0
19	4985882	.	T	C	2	4	6	0	0	6	0	0
19	5001119	.	C	T	2	11	13	2	20	35	0	0
19	5009251	.	A	C	15	9	24	0	6	30	0	0
19	5009353	.	G	A	16	11	27	0	2	29	0	0
19	5016071	.	T	C	17	13	30	0	1	31	0	0
19	5016302	.	T	G	18	10	28	0	3	31	0	0
19	5018307	.	A	G	9	9	18	0	0	18	0	0
19	5018340	.	A	G	9	13	22	0	0	22	0	0
19	5020451	.	G	A	10	10	20	0	0	20	0	0
19	5022301	.	C	T	11	9	20	0	4	24	0	0
19	5024424	.	G	A	7	11	18	0	0	18	0	0
19	5024436	.	C	T	6	12	18	0	0	18	0	0
19	5024685	.	T	C	8	12	20	0	1	21	0	0
19	5026119	.	A	G	4	7	11	0	0	11	0	0
19	5028136	.	G	A	11	5	16	0	1	17	0	0
19	5028605	.	A	G	5	5	10	0	0	10	0	0
19	5028719	.	C	T	0	5	5	0	4	9	0	0
19	5030214	.	G	T	7	3	10	0	0	10	0	0
19	5030274	.	G	A	6	5	11	0	1	12	0	0
19	5031455	.	A	C	2	5	7	0	0	7	0	0
19	5032178	.	T	C	7	6	13	0	0	13	0	0
19	5032199	.	A	C	6	5	11	0	2	13	0	0
19	5039491	.	A	T	3	3	6	0	0	6	0	0
19	5039530	.	T	C	1	0	1	0	3	4	0	0
19	5042062	.	T	C	2	0	2	0	3	5	0	0
19	5042074	.	G	A	2	3	5	0	0	5	0	0
19	5045606	.	C	T	0	3	3	1	2	6	0	0
19	5045639	.	A	G	1	2	3	1	0	4	0	0
19	5077173	.	C	T	23	21	44	0	2	46	0	0
19	5080124	.	T	A	20	30	50	0	2	52	0	0
19	5081758	.	T	C	32	11	43	0	2	45	0	0
19	5081796	.	C	T	28	17	45	0	0	45	0	0
19	5081987	.	G	A	2	16	18	0	26	44	0	0
19	5082095	.	A	G	21	20	41	0	5	46	0	0
19	5089755	.	C	G	39	29	68	0	0	68	0	0
19	5089900	.	C	G	38	2	40	0	28	68	0	0
19	5090070	.	A	T	22	35	57	0	4	61	0	0
19	5090071	.	G	T	23	36	59	0	2	61	0	0
19	5090264	.	G	A	27	21	48	0	2	50	0	0
19	5090357	.	T	C	26	17	43	0	5	48	0	0
19	5090379	.	C	T	25	26	51	0	3	54	0	0
19	5090409	.	G	A	28	27	55	0	3	58	0	0
19	5090483	.	A	T	30	25	55	0	3	58	0	0
19	5090583	.	C	T	6	3	9	0	0	9	0	0
19	5090677	.	A	C	11	2	13	0	1	14	0	0
19	5090691	.	A	G	12	3	15	0	0	15	0	0
19	5091483	.	T	C	34	28	62	0	9	71	0	0
19	5091688	.	T	C	4	4	8	0	0	8	0	0
19	5092392	.	G	A	2	1	3	0	1	4	0	0
19	5092401	.	T	G	2	1	3	0	0	3	0	0
19	5094288	.	G	T	7	5	12	0	1	13	0	0
19	5094389	.	C	T	8	4	12	0	2	14	0	0
19	5094471	.	T	C	10	13	23	0	0	23	0	0
19	5094504	.	A	G	10	12	22	0	0	22	0	0
19	5094616	.	C	T	2	22	24	0	8	32	0	0
19	5100191	.	G	A	8	12	20	0	0	20	0	0
19	5103213	.	A	G	1	7	8	0	0	8	0	0
19	5146708	.	C	T	5	6	11	0	0	11	0	0
19	5158795	.	A	G	42	31	73	0	7	80	0	0
19	5159157	.	C	A	33	35	68	1	5	74	0	0
19	5160048	.	C	G	31	29	60	0	7	67	0	0
19	5160121	.	T	C	25	1	26	0	29	55	0	0
19	5160133	.	C	A	4	32	36	0	22	58	0	0
19	5160201	.	A	G	30	28	58	0	3	61	0	0
19	5160302	.	T	C	38	0	38	0	14	52	0	0
19	5160310	.	C	T	3	17	20	0	35	55	0	0
19	5160379	.	T	A	27	23	50	0	2	52	0	0
19	5160996	.	A	T	28	17	45	1	3	49	0	0
19	5161750	.	A	G	27	22	49	0	7	56	0	0
19	5162105	.	G	A	25	26	51	0	0	51	0	0
19	5162252	.	A	T	25	29	54	0	1	55	0	0
19	5162253	.	T	C	26	1	27	0	28	55	0	0
19	5162544	.	A	G	13	21	34	0	1	35	0	0
19	5162827	.	C	T	14	20	34	0	2	36	0	0
19	5162839	.	T	C	16	0	16	0	19	35	0	0
19	5162923	.	C	T	15	17	32	0	0	32	0	0
19	5163031	.	C	T	18	10	28	0	4	32	0	0
19	5163747	.	G	A	14	6	20	0	0	20	0	0
19	5163910	.	T	C	32	17	49	0	2	51	0	0
19	5254510	.	A	G	17	14	31	0	1	32	0	0
19	5300076	.	A	G	2	2	4	0	0	4	0	0
19	5569864	.	A	C	1	3	4	0	0	4	0	0
19	5569981	.	C	T	2	2	4	0	0	4	0	0
19	5582319	.	G	T	4	3	7	0	1	8	0	0
19	5587716	.	C	T	3	10	13	0	2	15	0	0
19	5611586	.	T	C	15	6	21	0	1	22	0	0
19	5617832	.	T	C	14	13	27	0	0	27	0	0
19	5619892	.	G	A	11	15	26	0	2	28	0	0
19	5619931	.	A	G	7	15	22	0	1	23	0	0
19	5620094	.	A	T	13	6	19	0	2	21	0	0
19	5620175	.	T	G	11	9	20	0	1	21	0	0
19	5620208	.	G	T	14	10	24	0	0	24	0	0
19	5620459	.	T	C	11	22	33	0	3	36	0	0
19	5620525	.	C	T	19	22	41	0	1	42	0	0
19	5621131	.	A	G	19	1	20	0	21	41	0	0
19	5621165	.	G	A	17	15	32	0	1	33	0	0
19	5686916	.	C	T	3	2	5	0	0	5	0	0
19	5687082	.	G	T	0	2	2	0	1	3	0	0
19	5779170	.	C	T	3	3	6	0	0	6	0	0
19	5779601	.	T	C	13	10	23	0	2	25	0	0
19	5779897	.	T	C	13	15	28	0	2	30	0	0
19	5779946	.	G	C	8	15	23	0	2	25	0	0
19	5780032	.	C	G	3	10	13	0	9	22	0	0
19	5780301	.	T	A	9	15	24	1	3	28	0	0
19	5780342	.	A	C	12	0	12	0	15	27	0	0
19	5780989	.	G	A	9	5	14	0	0	14	0	0
19	5781316	.	G	T	3	3	6	0	0	6	0	0
19	5781367	.	T	C	6	5	11	1	0	12	0	0
19	5781397	.	A	G	7	3	10	1	0	11	0	0
19	5781421	.	T	G	4	2	6	1	0	8	1	0
19	5793484	.	C	G	3	3	6	0	1	7	0	0
19	5793532	.	T	C	6	5	11	0	0	11	0	0
19	5805773	.	T	G	5	6	11	0	0	11	0	0
19	5805833	.	G	A	6	6	12	0	1	13	0	0
19	5805839	.	G	A	6	5	11	0	1	12	0	0
19	5805869	.	A	G	4	3	7	0	0	7	0	0
19	6060309	.	A	T	14	15	29	0	1	30	0	0
19	6073362	.	T	C	6	5	11	0	0	11	0	0
19	6076813	.	C	A	5	5	10	0	0	10	0	0
19	6085987	.	A	G	16	8	24	1	2	27	0	0
19	6086441	.	C	G	17	20	37	0	0	37	0	0
19	6086577	.	C	T	1	14	15	0	22	37	0	0
19	6087130	.	T	A	6	12	18	0	0	18	0	0
19	6087146	.	C	T	0	12	12	0	5	17	0	0
19	6087186	.	A	T	7	12	19	0	1	20	0	0
19	6087619	.	T	C	10	0	10	0	6	16	0	0
19	6087894	.	G	A	11	6	17	0	3	20	0	0
19	6087948	.	A	T	12	10	22	1	0	23	0	0
19	6088000	.	C	T	1	10	11	1	13	25	0	0
19	6088166	.	T	C	9	10	19	0	0	19	0	0
19	6088259	.	A	C	6	14	20	0	2	22	0	0
19	6088419	.	A	T	12	8	20	0	5	25	0	0
19	6090702	.	T	C	8	11	19	0	1	20	0	0
19	6090732	.	T	A	12	4	16	0	2	18	0	0
19	6097416	.	A	G	9	12	21	0	0	21	0	0
19	6099984	.	G	A	9	10	19	0	0	19	0	0
19	6099992	.	G	A	7	11	18	0	1	19	0	0
19	6100027	.	G	A	7	8	15	0	0	15	0	0
19	6100037	.	C	T	7	5	12	0	1	13	0	0
19	6100073	.	T	G	11	6	17	0	0	17	0	0
19	6100139	.	G	C	7	0	7	0	11	19	1	0
19	6100198	.	C	A	5	6	11	0	1	12	0	0
19	6104838	.	C	T	0	6	6	0	5	11	0	0
19	6110968	.	A	T	8	2	10	0	0	10	0	0
19	6111085	.	G	A	1	3	4	0	1	5	0	0
19	6111214	.	A	G	8	6	14	0	5	19	0	0
19	6111223	.	A	G	10	8	18	0	1	19	0	0
19	6111268	.	G	A	7	12	19	0	1	20	0	0
19	6111366	.	C	T	2	4	6	0	6	12	0	0
19	6111460	.	C	G	2	4	6	0	0	6	0	0
19	6111793	.	G	A	2	3	5	0	1	6	0	0
19	6116638	.	A	G	3	2	5	0	0	5	0	0
19	6125926	.	G	A	2	6	8	0	0	8	0	0
19	6125941	.	C	T	3	6	9	0	0	9	0	0
19	6126001	.	G	A	3	2	5	0	0	5	0	0
19	6126625	.	G	A	1	2	3	0	0	3	0	0
19	6142187	.	C	A	0	5	5	0	3	9	1	0
19	6142714	.	A	T	11	9	20	0	0	20	0	0
19	6142803	.	A	G	12	14	26	0	0	26	0	0
19	6142951	.	A	G	3	5	8	0	0	8	0	0
19	6142970	.	C	T	4	4	8	0	1	9	0	0
19	6143278	.	A	C	1	3	4	0	0	4	0	0
19	6143373	.	T	C	5	4	9	0	1	10	0	0
19	6143583	.	C	G	5	5	10	0	1	11	0	0
19	6143610	.	T	A	2	5	7	0	1	8	0	0
19	6143919	.	T	C	2	5	7	0	0	7	0	0
19	6144101	.	T	A	1	7	8	0	1	9	0	0
19	6144342	.	A	G	1	2	3	0	1	4	0	0
19	6144722	.	C	T	4	2	6	0	0	6	0	0
19	6144822	.	C	G	1	2	3	0	0	3	0	0
19	6145610	.	A	G	5	3	8	0	0	8	0	0
19	6214772	.	G	A	9	10	19	0	0	19	0	0
19	6214835	.	G	T	4	8	12	0	0	12	0	0
19	6216392	.	A	G	3	4	7	0	1	8	0	0
19	6216471	.	A	C	1	4	5	0	0	5	0	0
19	6216606	.	G	A	2	6	8	0	2	10	0	0
19	6217133	.	T	A	2	2	4	0	0	4	0	0
19	6328442	.	T	C	30	17	47	0	51	98	0	0
19	6328514	.	A	C	48	36	84	1	7	92	0	0
19	6329154	.	C	T	2	32	34	0	25	59	0	0
19	6329236	.	A	G	35	21	56	3	3	62	0	0
19	6329237	.	G	A	33	21	54	3	5	62	0	0
19	6329301	.	A	C	40	30	70	0	4	74	0	0
19	6329533	.	C	T	10	31	41	0	41	82	0	0
19	6329660	.	C	T	10	14	24	0	46	75	5	0
19	6330050	.	T	C	30	32	62	0	5	67	0	0
19	6332902	.	C	A	5	28	33	0	32	65	0	0
19	6333448	.	G	A	28	24	52	0	5	57	0	0
19	6338207	.	A	G	22	24	46	0	2	48	0	0
19	6338261	.	A	G	15	19	34	0	1	35	0	0
19	6339131	.	A	G	26	21	47	0	0	47	0	0
19	6341941	.	A	G	28	17	45	0	2	47	0	0
19	6342076	.	C	G	23	8	31	0	2	33	0	0
19	6344573	.	G	T	15	22	37	0	1	38	0	0
19	6344621	.	C	T	12	17	29	0	2	31	0	0
19	6346506	.	C	G	14	9	23	0	4	27	0	0
19	6346587	.	C	T	2	8	10	0	13	23	0	0
19	6358232	.	A	G	6	5	11	0	1	12	0	0
19	6358244	.	C	A	6	5	11	0	1	12	0	0
19	6362636	.	A	G	5	1	6	0	3	9	0	0
19	6362804	.	T	A	6	9	15	0	0	16	1	0
19	6606673	.	T	A	1	3	4	0	0	4	0	0
19	6901023	.	T	C	2	1	3	1	1	5	0	0
19	6908433	.	A	C	1	2	3	0	0	3	0	0
19	6908495	.	A	T	2	2	4	0	0	4	0	0
19	6908520	.	T	C	1	3	4	1	0	5	0	0
19	6914370	.	A	C	3	2	5	0	0	5	0	0
19	6914415	.	T	C	3	2	5	3	0	8	0	0
19	6914589	.	T	C	3	2	5	0	0	5	0	0
19	6914706	.	T	G	2	0	2	0	2	4	0	0
19	6915030	.	T	C	4	2	6	0	0	6	0	0
19	6915234	.	G	A	0	4	4	0	1	5	0	0
19	6916019	.	T	C	5	1	6	0	2	8	0	0
19	6916029	.	G	A	5	2	7	0	0	7	0	0
19	6933697	.	G	T	0	2	2	0	1	3	0	0
19	6938364	.	A	T	6	3	9	0	0	9	0	0
19	6938377	.	A	T	7	3	10	0	0	10	0	0
19	6949256	.	G	A	1	8	9	0	10	19	0	0
19	6949316	.	C	A	8	12	20	0	0	20	0	0
19	6950393	.	G	A	12	10	22	0	2	24	0	0
19	6952600	.	T	C	14	16	30	0	2	32	0	0
19	6955061	.	C	T	19	6	25	0	2	27	0	0
19	6955130	.	C	T	13	12	25	0	1	26	0	0
19	6955131	.	C	T	14	11	25	0	1	26	0	0
19	6955198	.	C	A	21	10	31	0	0	31	0	0
19	6955411	.	C	T	11	8	19	0	1	20	0	0
19	6955475	.	T	C	7	8	15	0	0	15	0	0
19	6955609	.	C	G	11	11	22	0	2	24	0	0
19	6955620	.	G	A	1	11	12	0	9	21	0	0
19	6955920	.	G	A	18	8	26	0	1	27	0	0
19	6956058	.	T	C	19	20	39	1	0	40	0	0
19	6956060	.	G	A	18	19	37	1	2	40	0	0
19	6956135	.	A	G	26	6	32	0	1	33	0	0
19	6956665	.	C	A	10	12	22	0	3	25	0	0
19	6956728	.	T	A	14	13	27	0	0	27	0	0
19	6956829	.	T	A	20	6	26	0	2	28	0	0
19	6956835	.	C	G	20	5	25	0	1	26	0	0
19	6956881	.	T	C	11	8	19	0	2	21	0	0
19	6956892	.	T	A	10	7	17	0	0	17	0	0
19	6957127	.	A	T	30	12	42	0	4	46	0	0
19	6957131	.	C	A	26	12	38	0	6	44	0	0
19	6960653	.	C	A	13	5	18	0	2	20	0	0
19	6961610	.	G	A	6	6	12	1	0	13	0	0
19	6961674	.	A	G	6	4	10	0	1	11	0	0
19	6962786	.	T	C	5	2	7	0	1	8	0	0
19	6962787	.	T	C	3	5	8	0	0	8	0	0
19	6963996	.	G	A	1	5	6	0	0	6	0	0
19	6964041	.	A	G	1	6	7	0	0	7	0	0
19	6964058	.	T	C	1	3	4	0	0	4	0	0
19	6964249	.	C	G	6	3	9	0	0	9	0	0
19	6964273	.	C	A	7	5	12	0	1	13	0	0
19	6964364	.	C	T	5	6	11	0	0	11	0	0
19	6964381	.	T	C	5	9	14	0	0	14	0	0
19	6964417	.	A	G	2	7	9	0	0	9	0	0
19	6964866	.	C	T	1	2	3	1	0	4	0	0
19	6965717	.	A	G	1	2	3	0	0	3	0	0
19	6966003	.	C	A	2	1	3	0	0	3	0	0
19	6966022	.	A	G	3	3	6	0	0	6	0	0
19	6966208	.	G	A	6	3	9	0	0	9	0	0
19	6966271	.	T	G	4	2	6	0	0	6	0	0
19	6966781	.	A	T	4	4	8	0	0	8	0	0
19	6988778	.	T	C	2	2	4	0	1	5	0	0
19	6994712	.	A	C	1	3	4	0	0	4	0	0
19	6996114	.	C	A	1	2	3	0	0	3	0	0
19	6996131	.	A	G	1	3	4	0	0	4	0	0
19	6996152	.	T	C	1	3	4	0	0	4	0	0
19	7000068	.	C	T	4	3	7	0	0	7	0	0
19	7005821	.	A	G	1	2	3	0	0	3	0	0
19	7006215	.	C	T	4	2	6	0	0	6	0	0
19	7006709	.	G	T	0	2	2	0	1	3	0	0
19	7014778	.	T	A	5	3	8	0	0	8	0	0
19	7014815	.	C	T	6	7	13	0	0	13	0	0
19	7014863	.	T	G	5	8	13	0	0	13	0	0
19	7014909	.	C	A	6	4	10	0	0	10	0	0
19	7014912	.	G	A	6	4	10	0	0	10	0	0
19	7015111	.	A	G	3	2	5	0	0	5	0	0
19	7020179	.	G	A	8	7	15	0	1	16	0	0
19	7020775	.	T	C	4	3	7	0	0	7	0	0
19	7024591	.	T	G	3	3	6	0	1	7	0	0
19	7024593	.	C	T	3	4	7	0	0	7	0	0
19	7024627	.	T	C	4	4	8	0	1	9	0	0
19	7027810	.	A	T	2	2	4	0	3	7	0	0
19	7027927	.	G	A	1	2	3	0	0	3	0	0
19	7031333	.	A	G	2	2	4	0	0	4	0	0
19	7031350	.	G	A	2	2	4	0	0	4	0	0
19	7031368	.	T	G	2	2	4	0	0	4	0	0
19	7038904	.	T	A	4	4	8	0	0	8	0	0
19	7039113	.	G	A	2	4	6	0	0	6	0	0
19	7039308	.	G	A	5	4	9	0	1	10	0	0
19	7039335	.	T	C	3	0	3	0	4	7	0	0
19	7039344	.	G	A	2	4	6	0	0	6	0	0
19	7040158	.	A	G	1	5	6	0	0	6	0	0
19	7100564	.	A	T	13	5	18	0	2	20	0	0
19	7100810	.	A	T	1	2	3	0	0	3	0	0
19	7120539	.	G	A	2	2	4	0	0	4	0	0
19	7121648	.	C	G	2	3	5	0	0	5	0	0
19	7121786	.	C	T	5	4	9	0	0	9	0	0
19	7121807	.	C	G	6	3	9	0	0	9	0	0
19	7152971	.	G	T	1	7	8	0	2	10	0	0
19	7152974	.	G	A	4	7	11	0	0	11	0	0
19	7154729	.	A	G	19	19	38	0	3	41	0	0
19	7154770	.	A	C	21	13	34	0	2	36	0	0
19	7155001	.	A	T	17	8	25	0	3	28	0	0
19	7155034	.	A	G	19	10	29	0	1	30	0	0
19	7155065	.	T	C	16	19	35	0	1	36	0	0
19	7158469	.	C	T	5	5	10	0	1	11	0	0
19	7158546	.	A	G	6	0	6	0	6	12	0	0
19	7159062	.	G	A	0	7	7	0	6	13	0	0
19	7159107	.	T	C	9	7	16	0	1	17	0	0
19	7161452	.	G	A	6	3	9	0	0	9	0	0
19	7161527	.	A	G	3	0	3	0	6	9	0	0
19	7161539	.	G	T	2	7	9	0	1	10	0	0
19	7163872	.	C	T	8	6	14	0	1	15	0	0
19	7163908	.	A	G	8	6	14	0	1	15	0	0
19	7164022	.	G	A	10	14	24	0	0	24	0	0
19	7166211	.	C	T	9	16	25	0	1	26	0	0
19	7166454	.	C	A	14	9	23	0	0	23	0	0
19	7169204	.	A	C	11	16	27	0	1	28	0	0
19	7169228	.	C	T	12	15	27	0	2	29	0	0
19	7169304	.	G	A	14	4	18	0	3	21	0	0
19	7169587	.	A	G	5	3	8	0	1	9	0	0
19	7169588	.	G	A	5	4	9	0	0	9	0	0
19	7169770	.	A	C	13	9	22	1	1	24	0	0
19	7169809	.	C	T	9	11	20	0	0	20	0	0
19	7169880	.	T	C	12	10	22	0	1	23	0	0
19	7169886	.	G	A	10	10	20	0	3	23	0	0
19	7169929	.	G	A	15	10	25	0	1	26	0	0
19	7170128	.	A	G	8	6	14	0	3	17	0	0
19	7170191	.	A	C	7	8	15	0	1	16	0	0
19	7170228	.	A	T	5	10	15	0	1	16	0	0
19	7170642	.	C	T	4	3	7	0	0	7	0	0
19	7170653	.	G	A	1	2	3	0	0	3	0	0
19	7174417	.	C	A	4	2	6	0	0	6	0	0
19	7174456	.	T	C	4	2	6	0	0	6	0	0
19	7174486	.	G	T	5	2	7	0	0	7	0	0
19	7176913	.	G	A	0	2	2	0	6	8	0	0
19	7176915	.	C	A	6	2	8	0	0	8	0	0
19	7249800	.	A	G	8	10	18	0	1	19	0	0
19	7249811	.	T	C	8	9	17	0	3	20	0	0
19	7250372	.	T	C	2	2	4	0	0	4	0	0
19	7258085	.	A	G	5	4	9	0	0	9	0	0
19	7258118	.	C	T	2	2	4	0	0	4	0	0
19	7265377	.	T	C	4	2	6	0	0	6	0	0
19	7270102	.	G	A	2	2	4	0	0	4	0	0
19	7272224	.	C	A	2	2	4	0	0	4	0	0
19	7272935	.	G	A	2	3	5	0	1	6	0	0
19	7276063	.	A	T	1	4	5	0	0	5	0	0
19	7276106	.	G	A	11	14	25	0	5	30	0	0
19	7276149	.	A	G	24	23	47	0	3	50	0	0
19	7276194	.	T	A	32	26	58	0	2	60	0	0
19	7276559	.	G	A	37	33	70	0	4	74	0	0
19	7276610	.	G	A	38	36	74	0	6	80	0	0
19	7279235	.	A	G	27	34	61	3	3	67	0	0
19	7279721	.	A	G	34	20	54	0	3	57	0	0
19	7282541	.	C	T	33	22	55	0	1	56	0	0
19	7282554	.	G	A	32	25	57	0	1	58	0	0
19	7283427	.	C	A	35	21	56	0	0	56	0	0
19	7283499	.	A	G	25	19	44	1	1	47	1	0
19	7284840	.	C	T	3	14	17	0	16	33	0	0
19	7286301	.	A	G	23	13	36	0	0	36	0	0
19	7286355	.	A	G	15	16	31	0	0	31	0	0
19	7286421	.	T	A	23	17	40	0	1	41	0	0
19	7286742	.	A	G	20	8	28	0	0	28	0	0
19	7287600	.	T	C	15	14	29	0	0	29	0	0
19	7287603	.	G	A	15	13	28	0	1	29	0	0
19	7288195	.	A	G	15	5	20	0	2	22	0	0
19	7290175	.	A	G	12	10	22	0	1	23	0	0
19	7290214	.	A	G	13	10	23	0	1	24	0	0
19	7291642	.	A	T	4	10	14	0	3	17	0	0
19	7292621	.	G	A	1	2	3	0	1	4	0	0
19	7292636	.	A	T	1	3	4	0	1	5	0	0
19	7293138	.	A	G	2	4	6	0	0	6	0	0
19	7293174	.	C	T	2	3	5	0	0	5	0	0
19	7295279	.	G	A	8	6	14	0	0	14	0	0
19	7295572	.	G	C	1	3	4	0	0	4	0	0
19	7309154	.	G	A	13	15	28	0	0	28	0	0
19	7309391	.	C	A	24	21	45	0	1	46	0	0
19	7309522	.	G	C	25	19	44	0	1	45	0	0
19	7309556	.	T	A	23	17	40	0	1	41	0	0
19	7309557	.	T	A	23	17	40	0	1	41	0	0
19	7309754	.	T	G	12	13	25	0	3	28	0	0
19	7309929	.	A	T	18	20	38	0	1	39	0	0
19	7309968	.	G	T	19	19	38	0	1	40	1	0
19	7310117	.	T	C	17	0	17	0	15	32	0	0
19	7310131	.	C	T	11	14	25	0	1	26	0	0
19	7310154	.	A	T	13	13	26	0	1	27	0	0
19	7310974	.	T	G	17	6	23	0	0	23	0	0
19	7311678	.	T	G	14	10	24	0	2	26	0	0
19	7313933	.	C	G	17	19	36	0	1	37	0	0
19	7327462	.	A	G	9	9	18	0	0	18	0	0
19	7327519	.	C	T	8	8	16	0	1	17	0	0
19	7327564	.	G	T	6	9	15	0	0	15	0	0
19	7327570	.	T	C	4	10	14	0	1	15	0	0
19	7337862	.	C	A	9	2	11	0	0	11	0	0
19	7338033	.	C	T	1	13	14	0	8	22	0	0
19	7338125	.	C	T	12	8	20	0	0	20	0	0
19	7338150	.	G	A	8	3	11	0	2	13	0	0
19	7338218	.	A	T	4	3	7	0	2	9	0	0
19	7338309	.	C	T	0	7	7	0	9	16	0	0
19	7338402	.	C	T	1	4	5	0	10	15	0	0
19	7338425	.	T	C	6	4	10	0	3	13	0	0
19	7338444	.	T	C	7	0	7	0	8	15	0	0
19	7338969	.	C	T	10	4	14	0	0	14	0	0
19	7338978	.	T	C	11	0	11	0	4	15	0	0
19	7339008	.	T	G	5	2	7	0	0	7	0	0
19	7341385	.	A	G	1	4	5	0	0	5	0	0
19	7358131	.	A	G	1	4	5	0	0	5	0	0
19	7379637	.	T	C	1	0	1	0	3	4	0	0
19	7408277	.	C	T	1	2	3	0	0	3	0	0
19	7408360	.	T	G	2	3	5	0	0	5	0	0
19	7412062	.	T	C	4	6	10	0	1	11	0	0
19	7412320	.	C	T	4	16	20	0	0	20	0	0
19	7412358	.	A	T	4	12	16	0	0	16	0	0
19	7412490	.	T	C	3	8	11	0	0	11	0	0
19	7412586	.	T	C	1	2	3	0	0	3	0	0
19	7424794	.	G	A	7	6	13	0	0	13	0	0
19	7426637	.	C	T	5	3	8	0	1	9	0	0
19	7426814	.	C	T	3	2	5	0	1	6	0	0
19	7426832	.	G	A	4	2	6	0	1	7	0	0
19	7426967	.	T	C	11	10	21	0	1	22	0	0
19	7427099	.	C	A	9	10	19	0	0	19	0	0
19	7430160	.	T	C	13	5	18	0	1	19	0	0
19	7430607	.	G	A	3	16	19	0	16	35	0	0
19	7430652	.	C	T	15	10	25	0	1	26	0	0
19	7430700	.	A	G	7	1	8	0	8	16	0	0
19	7430715	.	C	A	8	6	14	0	0	14	0	0
19	7432806	.	A	C	3	4	7	0	0	7	0	0
19	7433068	.	T	A	4	3	7	0	0	7	0	0
19	7433454	.	G	A	4	4	8	0	0	8	0	0
19	7433637	.	C	A	4	2	6	0	0	6	0	0
19	7433746	.	A	C	2	2	4	0	0	4	0	0
19	7434139	.	T	C	2	2	4	0	1	5	0	0
19	7434161	.	G	T	2	4	6	0	0	6	0	0
19	7434252	.	T	C	2	2	4	0	0	4	0	0
19	7434555	.	C	T	1	4	5	0	1	6	0	0
19	7434611	.	G	C	3	7	10	0	0	10	0	0
19	7434813	.	G	A	2	3	5	0	0	5	0	0
19	7434866	.	C	T	3	3	6	0	0	6	0	0
19	7434881	.	C	T	0	3	3	0	3	6	0	0
19	7435078	.	A	G	1	3	4	0	0	4	0	0
19	7435083	.	A	C	1	3	4	0	0	4	0	0
19	7435535	.	C	A	1	2	3	0	0	3	0	0
19	7435605	.	T	C	3	2	5	0	0	5	0	0
19	7437053	.	A	G	3	4	7	0	0	7	0	0
19	7441832	.	T	A	2	3	5	0	0	5	0	0
19	7445676	.	G	A	5	7	12	6	2	20	0	0
19	7445897	.	C	T	29	31	60	0	1	61	0	0
19	7446050	.	T	C	28	26	54	0	1	55	0	0
19	7446137	.	G	T	17	32	49	0	1	51	1	0
19	7446286	.	G	T	26	31	57	0	1	58	0	0
19	7446495	.	G	T	29	33	62	0	7	69	0	0
19	7446621	.	C	A	33	23	56	0	7	63	0	0
19	7446702	.	T	C	28	33	61	0	4	65	0	0
19	7450572	.	G	A	28	28	56	0	9	65	0	0
19	7450658	.	T	C	19	9	28	0	1	29	0	0
19	7450750	.	A	G	6	2	8	0	3	11	0	0
19	7454109	.	A	C	2	3	5	0	0	5	0	0
19	7456364	.	T	C	4	3	7	0	0	7	0	0
19	7456371	.	A	C	3	4	7	0	0	7	0	0
19	7456722	.	C	G	4	4	8	0	0	8	0	0
19	7456793	.	A	G	1	7	8	0	1	9	0	0
19	7456816	.	C	G	1	5	6	0	0	6	0	0
19	7468556	.	G	T	7	4	11	0	1	12	0	0
19	7468580	.	C	T	9	5	14	0	0	14	0	0
19	7468746	.	T	A	3	9	12	0	0	12	0	0
19	7474242	.	T	C	11	8	19	0	0	19	0	0
19	7474245	.	T	G	11	0	11	0	9	20	0	0
19	7478159	.	A	G	10	13	23	0	1	24	0	0
19	7478283	.	C	T	5	13	18	0	0	18	0	0
19	7478356	.	G	A	5	7	12	0	0	12	0	0
19	7482931	.	C	T	7	6	13	0	1	14	0	0
19	7482993	.	G	A	3	4	7	0	0	7	0	0
19	7483059	.	A	T	5	5	10	0	1	11	0	0
19	7483469	.	T	G	4	9	13	0	1	14	0	0
19	7484313	.	T	A	4	3	7	0	0	7	0	0
19	7484834	.	A	G	2	4	6	0	0	6	0	0
19	7485117	.	C	T	2	2	4	0	0	4	0	0
19	7485457	.	C	T	2	1	3	0	1	4	0	0
19	7486791	.	T	C	2	3	5	0	0	5	0	0
19	7487321	.	C	T	3	3	6	0	1	7	0	0
19	7495867	.	A	T	13	12	25	0	2	27	0	0
19	7498046	.	T	C	14	14	28	0	2	30	0	0
19	7498079	.	A	G	12	13	25	0	4	29	0	0
19	7498103	.	A	G	10	13	23	0	0	23	0	0
19	7505591	.	A	G	14	16	30	0	3	33	0	0
19	7505907	.	A	G	16	1	17	0	16	33	0	0
19	7506036	.	A	G	12	0	12	0	7	19	0	0
19	7507833	.	A	T	5	7	12	0	0	12	0	0
19	7510223	.	T	C	3	6	9	0	0	9	0	0
19	7510348	.	T	C	5	5	10	0	0	10	0	0
19	7510501	.	G	A	0	4	4	0	7	11	0	0
19	7510567	.	C	T	7	9	16	0	1	17	0	0
19	7512406	.	C	G	11	9	20	0	0	20	0	0
19	7513085	.	C	T	9	3	12	0	1	13	0	0
19	7513291	.	A	C	11	9	20	0	0	20	0	0
19	7513406	.	A	T	7	10	17	0	1	18	0	0
19	7513631	.	A	G	9	4	13	0	0	13	0	0
19	7514025	.	T	C	9	5	14	0	0	14	0	0
19	7514341	.	A	G	3	5	8	0	0	8	0	0
19	7514344	.	A	G	4	5	9	0	1	10	0	0
19	7514852	.	A	G	7	7	14	0	1	15	0	0
19	7515336	.	A	T	8	11	19	0	1	20	0	0
19	7515356	.	G	A	11	10	21	0	1	22	0	0
19	7515423	.	A	G	10	7	17	0	2	19	0	0
19	7515458	.	A	G	11	3	14	0	2	16	0	0
19	7515468	.	T	G	10	3	13	0	0	13	0	0
19	7515787	.	A	T	9	9	18	0	4	22	0	0
19	7515829	.	C	T	9	16	25	0	0	25	0	0
19	7515845	.	A	T	10	16	26	0	4	30	0	0
19	7516035	.	A	G	10	14	24	0	0	24	0	0
19	7516063	.	A	C	8	14	22	0	1	23	0	0
19	7516169	.	C	A	15	15	30	0	0	30	0	0
19	7516183	.	T	G	11	13	24	0	3	27	0	0
19	7518370	.	T	C	3	3	6	0	0	6	0	0
19	7525148	.	C	T	2	5	7	0	2	9	0	0
19	7525222	.	T	G	5	4	9	0	0	9	0	0
19	7525337	.	C	A	5	3	8	0	1	9	0	0
19	7529754	.	C	G	0	4	4	0	3	7	0	0
19	7529948	.	A	G	4	3	7	0	0	7	0	0
19	7530663	.	C	A	3	3	6	0	1	7	0	0
19	7530925	.	T	G	2	2	4	0	0	4	0	0
19	7530949	.	G	T	2	2	4	0	0	4	0	0
19	7549916	.	G	A	7	5	12	0	0	12	0	0
19	7552736	.	C	G	4	4	8	0	2	10	0	0
19	7552737	.	G	T	0	5	5	0	5	10	0	0
19	7553368	.	T	C	3	8	11	0	0	11	0	0
19	7553416	.	C	T	8	5	13	0	0	13	0	0
19	7557447	.	C	A	7	7	14	0	0	14	0	0
19	7557538	.	T	C	10	7	17	0	1	18	0	0
19	7557589	.	T	G	6	0	6	0	10	16	0	0
19	7557619	.	A	T	3	12	15	0	3	18	0	0
19	7557773	.	A	T	11	9	20	0	1	21	0	0
19	7557793	.	G	C	16	10	26	1	1	28	0	0
19	7557992	.	C	T	6	10	16	0	1	17	0	0
19	7558009	.	G	A	6	14	20	0	0	20	0	0
19	7559818	.	G	T	9	10	19	0	0	19	0	0
19	7559905	.	A	G	8	10	18	0	0	18	0	0
19	7564073	.	A	G	9	14	23	0	0	23	0	0
19	7565142	.	G	A	19	14	33	0	1	34	0	0
19	7565244	.	A	G	16	15	31	0	1	32	0	0
19	7566488	.	A	T	9	3	12	0	4	17	1	0
19	7567021	.	T	A	23	14	37	0	0	37	0	0
19	7567196	.	A	C	2	3	5	0	0	5	0	0
19	7568342	.	A	G	1	0	1	0	2	3	0	0
19	7568348	.	T	G	1	0	1	0	2	3	0	0
19	7590151	.	T	C	1	2	3	0	0	3	0	0
19	7590501	.	T	C	2	1	3	0	1	4	0	0
19	7590506	.	G	A	2	1	3	0	1	4	0	0
19	7590590	.	T	A	1	4	5	0	1	6	0	0
19	7590773	.	A	T	1	1	2	0	1	3	0	0
19	7590810	.	T	A	2	2	4	0	1	5	0	0
19	7590964	.	G	A	0	2	2	0	4	6	0	0
19	7630689	.	A	T	4	3	7	0	1	8	0	0
19	7631700	.	G	A	1	8	9	0	15	24	0	0
19	7631784	.	A	G	4	16	20	0	0	20	0	0
19	7631829	.	C	A	3	10	13	0	0	13	0	0
19	7631860	.	T	C	12	8	20	0	1	21	0	0
19	7632056	.	C	T	8	3	11	0	1	12	0	0
19	7632216	.	C	T	5	11	16	0	1	17	0	0
19	7632348	.	G	A	3	14	17	0	7	24	0	0
19	7632470	.	C	T	5	7	12	0	0	12	0	0
19	7632526	.	T	C	8	5	13	0	0	13	0	0
19	7632837	.	C	T	9	7	16	0	2	18	0	0
19	7678986	.	G	A	0	2	2	0	1	3	0	0
19	7761855	.	C	T	4	4	8	0	0	8	0	0
19	7762934	.	G	A	5	3	8	0	0	8	0	0
19	7762958	.	G	A	0	3	3	0	4	7	0	0
19	7773391	.	C	G	4	2	6	0	0	6	0	0
19	7775547	.	A	T	8	8	16	0	5	21	0	0
19	7775552	.	T	C	13	7	20	0	1	21	0	0
19	7775789	.	G	A	1	5	6	0	4	10	0	0
19	7782743	.	G	T	1	15	16	0	9	25	0	0
19	7784681	.	T	A	14	15	29	0	1	30	0	0
19	7784684	.	T	A	14	15	29	0	3	32	0	0
19	7785138	.	C	T	24	15	39	0	2	41	0	0
19	7794887	.	C	T	19	13	32	0	2	34	0	0
19	7794893	.	A	T	17	12	29	0	5	34	0	0
19	7796842	.	C	A	10	12	22	0	7	29	0	0
19	7796951	.	T	C	12	12	24	0	2	26	0	0
19	7796975	.	T	C	12	13	25	0	0	25	0	0
19	7796986	.	A	T	12	12	24	0	1	25	0	0
19	7797259	.	T	A	23	13	36	0	1	37	0	0
19	7797539	.	T	G	30	15	45	0	0	45	0	0
19	7797651	.	G	T	11	10	21	0	2	23	0	0
19	7799225	.	A	G	2	5	7	0	0	7	0	0
19	7799226	.	A	T	1	5	6	0	1	7	0	0
19	7800812	.	A	G	4	5	9	0	0	9	0	0
19	7802700	.	G	A	6	7	13	0	2	15	0	0
19	7803424	.	C	A	9	10	19	0	0	19	0	0
19	7803435	.	A	T	7	9	16	0	1	17	0	0
19	7803460	.	G	T	0	9	9	0	9	18	0	0
19	7804785	.	A	C	8	12	20	0	1	21	0	0
19	7819726	.	G	A	3	2	5	1	6	12	0	0
19	7820040	.	T	C	8	10	18	0	0	18	0	0
19	7820079	.	T	A	6	11	17	1	1	19	0	0
19	7820107	.	G	A	6	10	16	1	0	17	0	0
19	7820466	.	C	A	3	4	7	0	3	10	0	0
19	7823285	.	G	A	13	6	19	0	1	20	0	0
19	7823306	.	G	A	12	4	16	0	0	16	0	0
19	7823330	.	C	T	11	6	17	0	1	18	0	0
19	7825163	.	C	T	5	3	8	0	0	8	0	0
19	7825181	.	G	C	5	6	11	0	1	12	0	0
19	7825259	.	G	A	10	13	23	0	0	23	0	0
19	7825300	.	A	G	8	8	16	0	0	16	0	0
19	7827016	.	G	A	8	6	14	0	0	14	0	0
19	7827377	.	C	T	1	5	6	0	5	11	0	0
19	7827579	.	G	A	5	3	8	0	0	8	0	0
19	7827666	.	A	G	3	4	7	0	0	7	0	0
19	7827672	.	G	C	2	4	6	0	0	6	0	0
19	7828600	.	T	C	3	3	6	0	0	6	0	0
19	7828621	.	C	A	2	3	5	0	0	5	0	0
19	7828912	.	G	A	2	3	5	0	2	7	0	0
19	7828930	.	T	G	3	3	6	0	1	7	0	0
19	7829094	.	T	G	1	5	6	0	0	6	0	0
19	7829506	.	A	T	1	2	3	0	0	3	0	0
19	7830064	.	A	G	1	2	3	0	0	3	0	0
19	7830268	.	G	A	1	3	4	0	0	4	0	0
19	7835774	.	G	A	2	2	4	0	0	4	0	0
19	7837736	.	T	C	2	5	7	0	0	7	0	0
19	7837810	.	T	C	1	2	3	0	0	3	0	0
19	7837811	.	A	T	1	2	3	0	0	3	0	0
19	7837915	.	A	G	1	0	1	0	2	3	0	0
19	8315418	.	G	A	7	2	9	0	2	11	0	0
19	8336328	.	G	A	7	2	9	0	1	10	0	0
19	8336640	.	G	C	10	11	21	1	3	25	0	0
19	8336642	.	C	T	10	11	21	1	2	24	0	0
19	8336689	.	G	A	5	6	11	0	0	11	0	0
19	8337182	.	A	G	3	0	3	0	2	5	0	0
19	8337185	.	C	G	3	2	5	0	0	5	0	0
19	8338616	.	T	A	5	14	19	0	2	21	0	0
19	8338649	.	T	A	9	15	24	0	0	24	0	0
19	8338711	.	C	G	8	6	14	0	0	14	0	0
19	8339202	.	T	A	11	15	26	0	0	26	0	0
19	8339302	.	A	G	13	16	29	0	2	31	0	0
19	8482053	.	T	A	3	5	8	0	0	8	0	0
19	8496701	.	C	T	2	3	5	0	1	6	0	0
19	8497743	.	C	A	2	5	7	0	0	7	0	0
19	8497744	.	A	C	2	5	7	0	0	7	0	0
19	8500688	.	T	C	7	9	16	0	0	16	0	0
19	8501067	.	C	T	4	6	10	0	1	11	0	0
19	8501075	.	A	T	5	5	10	0	1	11	0	0
19	8501218	.	G	A	9	7	16	0	3	19	0	0
19	8501490	.	G	T	3	10	13	0	7	20	0	0
19	8501499	.	T	C	8	11	19	0	2	21	0	0
19	8501526	.	T	A	7	14	21	0	0	21	0	0
19	8501535	.	C	T	5	15	20	0	4	24	0	0
19	8501703	.	A	C	7	3	10	1	0	11	0	0
19	8501901	.	A	T	10	13	23	0	1	24	0	0
19	8501961	.	G	A	1	2	3	0	10	13	0	0
19	8501962	.	G	A	11	2	13	0	0	13	0	0
19	8502133	.	C	T	4	6	10	0	0	10	0	0
19	8502166	.	G	T	2	11	13	0	6	19	0	0
19	8502225	.	T	A	14	14	28	0	0	28	0	0
19	8502244	.	G	A	9	13	22	0	1	23	0	0
19	8534126	.	G	C	7	4	11	0	0	11	0	0
19	8534320	.	C	A	10	4	14	0	0	14	0	0
19	8534339	.	A	C	16	8	24	0	1	25	0	0
19	8534426	.	G	A	17	8	25	0	2	27	0	0
19	8534428	.	A	G	18	8	26	0	0	26	0	0
19	8582809	.	A	G	7	9	16	0	0	16	0	0
19	8583065	.	A	G	6	7	13	0	0	13	0	0
19	8592419	.	A	G	2	3	5	0	2	7	0	0
19	8592906	.	C	T	7	3	10	0	0	10	0	0
19	8599547	.	A	G	6	3	9	0	0	9	0	0
19	8600156	.	G	A	2	2	4	0	0	4	0	0
19	8613041	.	G	C	4	2	6	0	0	6	0	0
19	8613146	.	A	G	1	2	3	0	0	3	0	0
19	8645192	.	A	C	5	4	9	0	0	9	0	0
19	8681470	.	G	A	5	5	10	0	0	10	0	0
19	8681509	.	G	A	5	3	8	0	0	8	0	0
19	8747688	.	G	A	26	44	70	0	3	73	0	0
19	8817121	.	C	A	6	8	14	0	1	15	0	0
19	8817480	.	A	G	19	23	42	1	3	46	0	0
19	8817608	.	G	A	29	20	49	0	2	51	0	0
19	8822347	.	A	G	20	17	37	0	2	39	0	0
19	8824364	.	A	G	18	5	23	0	3	26	0	0
19	8831907	.	C	T	3	20	23	1	15	39	0	0
19	8836805	.	C	T	9	8	17	0	4	21	0	0
19	8880614	.	C	G	7	6	13	0	2	15	0	0
19	8894119	.	T	A	13	6	19	0	0	19	0	0
19	8894138	.	A	G	11	7	18	0	0	18	0	0
19	8894229	.	T	C	10	9	19	0	1	20	0	0
19	8894905	.	G	T	7	8	15	0	0	15	0	0
19	8895074	.	G	A	8	16	24	0	1	25	0	0
19	8895163	.	T	C	5	13	18	0	2	20	0	0
19	8897625	.	A	C	1	0	1	0	2	3	0	0
19	8898184	.	G	A	2	5	7	0	0	7	0	0
19	8898188	.	G	A	2	5	7	0	0	7	0	0
19	8901045	.	T	C	2	2	4	0	0	4	0	0
19	8928718	.	G	A	9	7	16	0	0	16	0	0
19	8928767	.	G	C	8	14	22	0	0	22	0	0
19	8929035	.	T	C	6	5	11	0	0	11	0	0
19	8929488	.	C	T	0	13	13	0	11	24	0	0
19	8929549	.	T	C	4	0	4	0	10	14	0	0
19	8929669	.	A	G	4	11	15	1	5	21	0	0
19	8929678	.	A	G	7	10	17	1	4	22	0	0
19	8929743	.	T	A	6	10	16	0	1	18	1	0
19	8930187	.	A	G	11	14	25	0	0	25	0	0
19	8937285	.	G	A	4	2	6	0	1	7	0	0
19	8937377	.	T	C	6	4	10	0	0	10	0	0
19	8937485	.	A	G	3	5	8	0	2	10	0	0
19	8958892	.	A	G	18	12	30	0	4	34	0	0
19	8962835	.	C	T	12	8	20	0	0	20	0	0
19	8962840	.	A	C	11	0	11	0	5	16	0	0
19	8978611	.	C	T	2	2	4	0	0	4	0	0
19	8979659	.	A	G	1	3	4	0	0	4	0	0
19	8997627	.	T	C	4	10	14	0	0	14	0	0
19	9000665	.	C	T	30	22	52	0	0	52	0	0
19	9000674	.	T	C	30	21	51	0	2	53	0	0
19	9000718	.	G	A	4	20	24	0	22	46	0	0
19	9000838	.	C	T	23	10	33	0	3	36	0	0
19	9000855	.	T	A	20	11	31	0	3	34	0	0
19	9000907	.	A	G	20	1	21	0	15	36	0	0
19	9001100	.	C	T	17	12	29	1	0	30	0	0
19	9001180	.	A	G	19	18	37	0	0	37	0	0
19	9001246	.	C	T	15	13	28	0	0	28	0	0
19	9001317	.	G	A	13	20	33	0	2	35	0	0
19	9043657	.	T	A	1	2	3	0	1	4	0	0
19	9044799	.	T	A	4	3	7	0	0	7	0	0
19	9046467	.	G	A	5	3	8	0	0	8	0	0
19	9050609	.	C	G	13	6	19	0	0	19	0	0
19	9050631	.	T	C	10	8	18	0	3	21	0	0
19	9050737	.	G	C	3	7	10	0	0	10	0	0
19	9050745	.	A	G	3	6	9	0	0	9	0	0
19	9050823	.	A	G	4	5	9	0	2	11	0	0
19	9064759	.	T	C	16	8	24	0	1	25	0	0
19	9064777	.	C	A	18	7	25	0	2	27	0	0
19	9064822	.	A	G	13	10	23	0	1	24	0	0
19	9064853	.	T	C	8	10	18	0	4	22	0	0
19	9064885	.	G	A	9	6	15	0	2	17	0	0
19	9067211	.	G	A	15	6	21	0	1	22	0	0
19	9070546	.	T	G	7	1	8	0	4	12	0	0
19	9072451	.	C	T	10	5	15	0	0	15	0	0
19	9078840	.	A	T	16	20	36	0	1	37	0	0
19	9079084	.	T	C	13	11	24	0	3	27	0	0
19	9081228	.	T	C	15	24	39	1	2	42	0	0
19	9081272	.	C	T	15	14	29	2	2	33	0	0
19	9084630	.	G	A	2	13	15	0	19	34	0	0
19	9084634	.	A	G	16	1	17	0	16	33	0	0
19	9084797	.	A	T	20	21	41	0	1	42	0	0
19	9084848	.	G	A	2	24	26	0	16	42	0	0
19	9084859	.	G	T	18	23	41	0	0	41	0	0
19	9085835	.	A	G	14	15	29	0	2	31	0	0
19	9086132	.	C	A	27	27	54	2	0	56	0	0
19	9086416	.	T	A	9	3	12	0	1	13	0	0
19	9117210	.	T	C	2	2	4	0	0	4	0	0
19	9117216	.	C	A	2	2	4	0	0	4	0	0
19	9117402	.	G	A	2	4	6	0	0	6	0	0
19	9123493	.	C	T	3	4	7	0	0	7	0	0
19	9130441	.	G	A	7	5	12	0	0	12	0	0
19	9134017	.	G	A	0	10	10	0	7	17	0	0
19	9135065	.	A	G	7	0	7	0	9	16	0	0
19	9135754	.	A	T	8	10	18	0	0	18	0	0
19	9138695	.	A	G	7	0	7	0	12	19	0	0
19	9138850	.	C	A	9	8	17	0	0	17	0	0
19	9140675	.	A	T	10	14	24	0	1	25	0	0
19	9140750	.	T	C	8	16	24	0	2	26	0	0
19	9140950	.	T	C	13	8	21	0	2	23	0	0
19	9144175	.	G	A	1	5	6	0	10	16	0	0
19	9144228	.	T	G	4	5	9	0	0	9	0	0
19	9150074	.	T	C	4	3	7	0	2	9	0	0
19	9152720	.	C	A	13	15	28	0	0	28	0	0
19	9152841	.	A	T	15	7	22	0	1	23	0	0
19	9155691	.	C	T	19	12	31	0	1	32	0	0
19	9158481	.	A	T	15	12	27	0	0	27	0	0
19	9161621	.	C	T	18	21	39	0	1	40	0	0
19	9161631	.	T	G	18	22	40	0	3	43	0	0
19	9161824	.	T	C	13	16	29	0	1	30	0	0
19	9168699	.	T	C	27	9	36	0	3	39	0	0
19	9169162	.	G	C	9	7	16	0	0	16	0	0
19	9216201	.	T	A	12	3	15	0	4	19	0	0
19	9216221	.	A	C	12	9	21	0	0	21	0	0
19	9216367	.	G	A	9	11	20	0	2	22	0	0
19	9217143	.	C	T	14	15	29	0	1	30	0	0
19	9218405	.	G	A	16	12	28	0	1	29	0	0
19	9220849	.	T	C	15	12	27	0	0	27	0	0
19	9225567	.	C	T	25	22	47	0	2	49	0	0
19	9228326	.	A	T	19	20	39	0	1	40	0	0
19	9228378	.	A	G	19	0	19	0	10	29	0	0
19	9228380	.	C	T	20	9	29	0	1	30	0	0
19	9232751	.	A	G	3	3	6	0	0	6	0	0
19	9232753	.	C	A	0	3	3	0	2	5	0	0
19	9241653	.	T	A	1	4	5	0	0	5	0	0
19	9241666	.	A	G	1	3	4	0	0	4	0	0
19	9262543	.	T	C	1	2	3	0	0	3	0	0
19	9262904	.	C	T	2	3	5	0	0	5	0	0
19	9265048	.	T	C	6	6	12	0	0	12	0	0
19	9266027	.	A	G	1	3	4	0	0	4	0	0
19	9266063	.	A	G	4	2	6	0	0	6	0	0
19	9266076	.	A	G	3	2	5	0	0	5	0	0
19	9266121	.	T	C	4	4	8	0	0	8	0	0
19	9266749	.	T	C	4	2	6	0	2	8	0	0
19	9266793	.	A	C	3	4	7	0	0	7	0	0
19	9268589	.	A	G	5	0	5	0	3	8	0	0
19	9270836	.	T	C	3	7	10	0	0	10	0	0
19	9273997	.	A	G	9	0	9	0	4	13	0	0
19	9274428	.	T	A	10	9	19	0	0	19	0	0
19	9274497	.	G	A	13	6	19	0	0	19	0	0
19	9274574	.	C	T	7	4	11	0	1	12	0	0
19	9274705	.	C	T	10	6	16	0	1	17	0	0
19	9274891	.	G	T	9	10	19	0	1	20	0	0
19	9685695	.	A	G	32	24	56	0	2	58	0	0
19	9685714	.	A	C	28	24	52	0	3	55	0	0
19	9686078	.	C	A	19	11	30	0	0	30	0	0
19	9686099	.	G	T	20	11	31	0	0	31	0	0
19	9686160	.	T	C	20	18	38	0	0	38	0	0
19	9686199	.	G	T	11	19	30	0	5	35	0	0
19	9686474	.	G	A	19	9	28	0	0	28	0	0
19	9686503	.	A	G	15	10	25	0	1	26	0	0
19	9686548	.	T	A	13	7	20	0	1	21	0	0
19	9686575	.	T	A	11	12	23	0	0	24	1	0
19	9686616	.	A	T	15	10	25	0	1	26	0	0
19	9686646	.	C	T	17	6	23	0	1	24	0	0
19	9686678	.	T	A	20	5	25	0	0	25	0	0
19	9686806	.	T	C	9	6	15	0	2	17	0	0
19	9686905	.	T	C	5	0	5	0	8	13	0	0
19	9687033	.	C	T	15	15	30	0	1	31	0	0
19	9687073	.	G	A	13	21	34	0	3	37	0	0
19	9687146	.	T	C	20	24	44	0	0	44	0	0
19	9691780	.	A	G	11	6	17	0	0	17	0	0
19	9712444	.	G	A	2	6	8	0	0	8	0	0
19	9813608	.	G	A	14	34	48	0	3	51	0	0
19	9813905	.	A	G	7	13	20	0	2	22	0	0
19	9813942	.	A	G	4	9	13	0	3	16	0	0
19	9822610	.	G	A	15	12	27	0	0	27	0	0
19	9840924	.	C	T	6	12	18	0	1	19	0	0
19	9841006	.	A	G	12	14	26	1	1	28	0	0
19	9841035	.	G	A	12	7	19	0	0	19	0	0
19	9841054	.	T	C	10	0	10	0	3	13	0	0
19	9841523	.	G	A	8	15	23	0	1	24	0	0
19	9841728	.	T	C	7	11	18	0	0	18	0	0
19	9841825	.	C	T	11	5	16	0	0	16	0	0
19	9841902	.	A	T	11	12	23	0	1	24	0	0
19	9842252	.	T	C	17	14	31	0	1	32	0	0
19	9842306	.	A	G	18	13	31	0	1	32	0	0
19	9910842	.	G	A	14	14	28	0	2	30	0	0
19	9911419	.	G	A	5	8	13	0	0	13	0	0
19	9911855	.	G	A	4	8	12	0	1	13	0	0
19	9911863	.	A	T	3	6	9	0	0	10	1	0
19	9912063	.	C	T	7	7	14	0	4	18	0	0
19	9912169	.	G	A	3	4	7	0	0	7	0	0
19	9912496	.	A	G	4	3	7	0	1	8	0	0
19	9912756	.	C	A	7	9	16	0	0	16	0	0
19	9912807	.	C	T	8	5	13	0	0	13	0	0
19	9912824	.	A	T	10	4	14	0	0	14	0	0
19	9912946	.	A	T	4	6	10	0	3	13	0	0
19	9912993	.	C	A	7	5	12	0	0	12	0	0
19	9912998	.	T	C	6	4	10	0	0	10	0	0
19	9914424	.	T	A	3	5	8	0	1	9	0	0
19	9914737	.	A	G	0	5	5	0	1	6	0	0
19	9914845	.	G	A	4	4	8	0	1	9	0	0
19	9914866	.	T	A	6	6	12	0	1	13	0	0
19	10042507	.	C	T	1	2	3	0	0	3	0	0
19	10177290	.	G	A	7	17	24	0	4	28	0	0
19	10177397	.	T	G	13	18	31	0	3	34	0	0
19	10177951	.	A	G	17	16	33	0	2	35	0	0
19	10178339	.	T	A	16	10	26	0	0	26	0	0
19	10180561	.	C	T	2	11	13	0	12	25	0	0
19	10190085	.	A	G	1	3	4	0	1	5	0	0
19	10195432	.	T	C	2	5	7	0	0	7	0	0
19	10195756	.	T	G	4	7	11	0	0	11	0	0
19	10196113	.	T	C	3	6	9	0	0	9	0	0
19	10201566	.	T	G	10	14	24	0	1	25	0	0
19	10201719	.	A	G	18	12	30	0	1	31	0	0
19	10202598	.	T	C	8	0	8	0	10	18	0	0
19	10202682	.	T	C	9	0	9	0	16	25	0	0
19	10202756	.	T	A	12	7	19	0	1	20	0	0
19	10203480	.	C	T	2	6	8	0	12	20	0	0
19	10205946	.	C	T	1	3	4	0	0	4	0	0
19	10217742	.	A	G	12	14	26	0	3	29	0	0
19	10217844	.	T	A	11	7	18	0	2	20	0	0
19	10218136	.	T	A	19	19	38	0	0	38	0	0
19	10218807	.	C	T	0	8	8	0	8	16	0	0
19	10219001	.	C	T	12	14	26	0	1	27	0	0
19	10219051	.	T	A	12	8	20	0	1	21	0	0
19	10219186	.	C	A	16	18	34	0	0	34	0	0
19	10219209	.	T	G	15	15	30	0	1	31	0	0
19	10219387	.	T	C	19	11	30	0	2	32	0	0
19	10219542	.	G	A	18	17	35	0	0	35	0	0
19	10219547	.	T	C	19	15	34	0	4	38	0	0
19	10219749	.	C	T	11	16	27	0	0	27	0	0
19	10220013	.	G	A	18	23	41	0	1	42	0	0
19	10220064	.	A	T	24	16	40	0	0	40	0	0
19	10220421	.	A	G	13	21	34	0	0	34	0	0
19	10220448	.	C	G	0	22	22	0	14	36	0	0
19	10220651	.	T	C	20	3	23	0	26	49	0	0
19	10220790	.	C	T	20	19	39	0	0	39	0	0
19	10237365	.	C	A	1	4	5	0	6	11	0	0
19	10252588	.	T	C	2	5	7	1	1	9	0	0
19	10252679	.	A	T	6	4	10	0	0	10	0	0
19	10252958	.	T	C	1	2	3	1	1	5	0	0
19	10253058	.	A	T	3	7	10	0	1	11	0	0
19	10253316	.	T	C	11	10	21	0	0	21	0	0
19	10253347	.	T	C	8	6	14	0	1	15	0	0
19	10253545	.	G	A	3	3	6	0	0	6	0	0
19	10253759	.	A	G	8	3	11	0	1	12	0	0
19	10253915	.	T	C	4	3	7	0	1	8	0	0
19	10253985	.	G	A	3	2	5	0	0	5	0	0
19	10254772	.	C	T	7	4	11	0	1	12	0	0
19	10254840	.	C	T	1	3	4	0	6	10	0	0
19	10255370	.	T	C	4	2	6	0	0	6	0	0
19	10255387	.	T	A	3	5	8	0	1	9	0	0
19	10255499	.	A	G	1	4	5	0	0	5	0	0
19	10255680	.	G	A	5	2	7	0	0	7	0	0
19	10264727	.	T	G	2	6	8	0	0	8	0	0
19	10299174	.	A	C	11	15	26	1	1	28	0	0
19	10299383	.	G	A	13	15	28	0	5	33	0	0
19	10299579	.	C	A	12	11	23	0	1	24	0	0
19	10299593	.	A	G	9	5	14	0	0	14	0	0
19	10299706	.	C	T	3	15	18	0	21	39	0	0
19	10301236	.	T	C	12	20	32	0	1	33	0	0
19	10318746	.	G	A	3	2	5	0	0	5	0	0
19	10376210	.	T	G	4	3	7	0	0	7	0	0
19	10376610	.	A	C	20	12	32	0	2	34	0	0
19	10377097	.	C	T	15	27	42	1	2	45	0	0
19	10377534	.	G	T	11	12	23	0	2	25	0	0
19	10377633	.	A	G	11	12	23	0	4	27	0	0
19	10377777	.	T	C	11	16	27	0	0	27	0	0
19	10377815	.	A	C	17	16	33	0	1	34	0	0
19	10377892	.	A	C	19	16	35	0	0	35	0	0
19	10377911	.	A	T	17	21	38	0	0	39	1	0
19	10378192	.	G	A	22	23	45	0	0	45	0	0
19	10378457	.	A	T	11	13	24	0	3	27	0	0
19	10378544	.	C	T	13	10	23	0	2	25	0	0
19	10378599	.	T	C	15	16	31	0	1	32	0	0
19	10378618	.	C	T	16	15	31	0	0	31	0	0
19	10378700	.	A	G	12	8	20	0	0	20	0	0
19	10378848	.	C	T	9	6	15	0	2	17	0	0
19	10378868	.	T	C	7	1	8	0	10	18	0	0
19	10378889	.	C	T	6	10	16	0	2	18	0	0
19	10378959	.	C	A	13	11	24	0	2	26	0	0
19	10379011	.	T	C	8	5	13	0	1	14	0	0
19	10379088	.	C	G	5	10	15	0	0	15	0	0
19	10379183	.	C	A	6	5	11	0	1	12	0	0
19	10379192	.	C	T	5	5	10	0	1	11	0	0
19	10379314	.	C	T	2	10	12	0	9	21	0	0
19	10379321	.	C	T	7	13	20	0	1	21	0	0
19	10379369	.	C	T	8	10	18	0	2	20	0	0
19	10379475	.	A	G	12	11	23	0	1	24	0	0
19	10379555	.	T	G	12	10	22	0	1	23	0	0
19	10379575	.	A	G	11	9	20	0	1	21	0	0
19	10379821	.	T	A	6	25	31	0	3	34	0	0
19	10379833	.	T	G	6	21	27	0	0	27	0	0
19	10379873	.	A	G	8	14	22	0	1	23	0	0
19	10379965	.	T	C	9	5	14	0	1	15	0	0
19	10383100	.	A	G	5	12	17	0	0	17	0	0
19	10383112	.	G	T	10	7	17	0	1	18	0	0
19	10383532	.	G	A	6	4	10	0	0	10	0	0
19	10383533	.	T	A	4	4	8	0	2	10	0	0
19	10383616	.	C	T	0	6	6	0	13	19	0	0
19	10383631	.	C	T	0	11	11	0	5	16	0	0
19	10386619	.	C	T	11	4	15	0	0	15	0	0
19	10393072	.	A	G	2	2	4	0	1	5	0	0
19	10394835	.	T	G	3	2	5	0	0	5	0	0
19	10407312	.	C	T	24	22	46	0	5	51	0	0
19	10407546	.	A	T	25	25	50	0	2	52	0	0
19	10407732	.	T	A	32	25	57	0	4	61	0	0
19	10407767	.	G	T	26	33	59	0	1	60	0	0
19	10558602	.	T	C	6	4	10	0	0	10	0	0
19	10558604	.	G	A	6	4	10	0	0	10	0	0
19	10561001	.	A	G	12	10	22	0	1	23	0	0
19	10562737	.	T	C	10	8	18	0	1	19	0	0
19	10565385	.	C	T	7	12	19	0	0	19	0	0
19	10569122	.	T	C	6	8	14	0	0	14	0	0
19	10575315	.	T	C	5	5	10	0	1	11	0	0
19	10575318	.	G	T	5	6	11	0	0	11	0	0
19	10575565	.	G	C	2	8	10	0	12	22	0	0
19	10575824	.	T	G	7	8	15	0	0	15	0	0
19	10576120	.	G	T	6	4	10	0	1	11	0	0
19	10576138	.	G	T	7	4	11	0	0	11	0	0
19	10576482	.	C	T	1	5	6	0	0	6	0	0
19	10576520	.	T	C	4	3	7	0	1	8	0	0
19	10576909	.	G	A	11	7	18	0	3	21	0	0
19	10576970	.	A	T	16	10	26	0	0	26	0	0
19	10577011	.	T	G	15	0	15	0	12	27	0	0
19	10577194	.	T	A	9	6	15	0	0	15	0	0
19	10577253	.	T	A	2	9	11	0	0	11	0	0
19	10649711	.	T	A	6	3	9	0	0	9	0	0
19	10649722	.	T	C	6	3	9	0	0	9	0	0
19	10649830	.	G	T	7	4	11	0	0	11	0	0
19	10653644	.	C	T	4	2	6	0	0	6	0	0
19	10841477	.	G	T	10	9	19	0	2	21	0	0
19	10868103	.	T	C	1	2	3	0	0	3	0	0
19	10870038	.	T	C	1	6	7	0	0	7	0	0
19	10870602	.	G	A	7	5	12	0	1	13	0	0
19	10870702	.	T	G	0	9	9	0	0	9	0	0
19	10870737	.	A	G	5	5	10	0	1	11	0	0
19	10870845	.	C	T	4	2	6	0	0	6	0	0
19	10871235	.	G	A	4	4	8	0	0	8	0	0
19	10871719	.	A	G	9	6	15	0	1	16	0	0
19	10871803	.	C	T	0	6	6	0	12	18	0	0
19	10871823	.	A	G	11	9	20	0	0	20	0	0
19	10872397	.	C	T	12	17	29	0	4	33	0	0
19	10875854	.	A	G	12	15	27	0	0	27	0	0
19	10876446	.	C	T	12	11	23	0	0	23	0	0
19	10893211	.	T	C	1	2	3	1	1	5	0	0
19	10893284	.	G	A	1	3	4	0	0	4	0	0
19	10909939	.	G	A	2	2	4	0	0	4	0	0
19	11014789	.	A	G	3	2	5	0	0	5	0	0
19	11332302	.	T	A	9	4	13	0	4	17	0	0
19	12188083	.	G	T	19	29	48	0	6	54	0	0
19	12188207	.	A	G	25	22	47	0	2	49	0	0
19	12188243	.	A	G	30	20	50	0	1	52	1	0
19	12188249	.	A	G	31	21	52	0	1	53	0	0
19	12193578	.	G	C	25	19	44	0	3	47	0	0
19	12206504	.	T	G	10	12	22	0	2	24	0	0
19	12211809	.	T	C	18	18	36	0	0	36	0	0
19	12297178	.	C	T	4	3	7	0	3	10	0	0
19	12297375	.	A	G	5	6	11	0	1	13	1	0
19	12300840	.	G	A	9	5	14	0	0	14	0	0
19	12304095	.	C	T	3	5	8	0	1	9	0	0
19	12304137	.	A	G	3	8	11	0	0	11	0	0
19	12356418	.	G	A	1	5	6	0	12	18	0	0
19	12356511	.	C	A	7	5	12	0	1	13	0	0
19	12363275	.	C	T	9	12	21	1	0	22	0	0
19	12380004	.	A	T	9	16	25	0	5	30	0	0
19	12380029	.	A	T	12	16	28	0	1	29	0	0
19	12385998	.	A	G	3	12	15	0	2	17	0	0
19	12410252	.	A	G	2	4	6	0	0	6	0	0
19	12413422	.	C	A	2	4	6	0	0	6	0	0
19	12413479	.	C	T	5	5	10	0	0	10	0	0
19	12420188	.	G	A	1	4	5	0	6	11	0	0
19	12424420	.	A	T	9	9	18	0	2	20	0	0
19	12427675	.	G	A	11	5	16	0	1	17	0	0
19	12428228	.	A	G	4	3	7	0	0	7	0	0
19	12428413	.	C	G	5	2	7	0	0	7	0	0
19	12428634	.	A	G	9	13	22	0	2	24	0	0
19	12428646	.	A	G	14	11	25	0	0	25	0	0
19	12428741	.	T	C	14	18	32	0	2	34	0	0
19	12428754	.	A	G	19	12	31	0	0	31	0	0
19	12645583	.	G	T	12	7	19	0	0	19	0	0
19	12645661	.	C	T	10	7	17	0	1	18	0	0
19	12648372	.	T	C	3	6	9	0	0	9	0	0
19	12655554	.	G	A	0	5	5	0	2	7	0	0
19	12655606	.	G	C	3	3	6	0	0	6	0	0
19	12661671	.	T	G	4	2	6	0	2	8	0	0
19	12762981	.	G	C	3	7	10	0	0	10	0	0
19	12802035	.	C	A	4	4	8	0	0	8	0	0
19	12802554	.	T	C	2	3	5	0	0	5	0	0
19	12802662	.	T	C	7	4	11	0	0	11	0	0
19	12802665	.	T	C	6	4	10	0	1	11	0	0
19	12802956	.	C	T	3	5	8	0	0	8	0	0
19	12802986	.	T	C	6	4	10	0	0	10	0	0
19	12803053	.	T	C	4	6	10	0	2	12	0	0
19	12803218	.	A	G	4	4	8	0	0	8	0	0
19	12937143	.	A	G	3	7	10	0	1	11	0	0
19	12937176	.	G	C	5	8	13	0	2	15	0	0
19	12937249	.	A	G	14	22	36	0	0	36	0	0
19	12937364	.	G	A	16	19	35	0	0	35	0	0
19	12937444	.	T	C	15	0	15	0	15	30	0	0
19	12937542	.	C	T	12	13	25	0	4	29	0	0
19	12937574	.	A	G	13	14	27	0	1	28	0	0
19	12937785	.	G	A	7	5	12	0	0	12	0	0
19	12938160	.	G	T	8	1	9	0	3	12	0	0
19	12938386	.	T	C	4	2	6	0	0	6	0	0
19	12938575	.	T	A	5	4	9	0	2	11	0	0
19	12938578	.	A	G	7	1	8	0	2	10	0	0
19	12938817	.	A	T	1	4	5	0	0	5	0	0
19	12939183	.	T	C	2	2	4	0	1	5	0	0
19	12939223	.	G	A	5	2	7	0	0	7	0	0
19	12939380	.	T	C	3	2	5	0	0	5	0	0
19	12939385	.	G	A	4	2	6	0	0	6	0	0
19	12939471	.	A	T	11	6	17	0	0	17	0	0
19	12939482	.	C	A	9	5	14	0	1	15	0	0
19	12939628	.	G	A	12	4	16	0	1	17	0	0
19	13121476	.	C	T	5	7	12	0	0	12	0	0
19	13151155	.	A	G	5	1	6	0	27	33	0	0
19	13184781	.	A	T	15	14	29	0	0	29	0	0
19	13185127	.	G	A	17	11	28	0	2	30	0	0
19	13185378	.	C	A	20	22	42	0	2	44	0	0
19	13186340	.	C	T	25	19	44	2	0	46	0	0
19	13186357	.	A	G	20	17	37	2	4	43	0	0
19	13186673	.	A	G	15	16	31	0	1	32	0	0
19	13193382	.	T	A	7	3	10	0	0	10	0	0
19	13193956	.	T	C	5	0	5	0	5	10	0	0
19	13194073	.	T	A	1	9	10	0	2	12	0	0
19	13194133	.	C	T	3	13	16	0	0	16	0	0
19	13194246	.	A	G	8	6	14	0	1	15	0	0
19	13194309	.	T	G	8	8	16	0	0	16	0	0
19	13194522	.	T	C	8	0	8	0	4	12	0	0
19	13194812	.	T	A	8	4	12	0	2	14	0	0
19	13194902	.	G	T	10	4	14	0	0	14	0	0
19	13194930	.	T	C	6	4	10	0	0	10	0	0
19	13194974	.	C	G	2	4	6	0	0	6	0	0
19	13195023	.	A	T	5	6	11	0	0	11	0	0
19	13196073	.	A	G	4	2	6	0	0	6	0	0
19	13196586	.	A	G	1	2	3	0	0	3	0	0
19	13390921	.	G	C	1	2	3	0	0	3	0	0
19	13395156	.	T	A	5	3	8	0	0	8	0	0
19	13395347	.	G	A	1	10	11	0	9	20	0	0
19	13395737	.	A	G	5	8	13	0	3	16	0	0
19	13395819	.	T	C	13	9	22	0	0	22	0	0
19	13395959	.	G	T	14	12	26	0	2	28	0	0
19	13395962	.	T	G	14	12	26	0	0	26	0	0
19	13396252	.	C	T	4	6	10	0	0	10	0	0
19	13396481	.	T	C	23	13	36	0	2	38	0	0
19	13396486	.	G	C	24	10	34	0	2	36	0	0
19	13396619	.	C	A	5	11	16	0	0	16	0	0
19	13396702	.	C	G	12	9	21	0	0	21	0	0
19	13397219	.	A	G	3	11	14	0	1	15	0	0
19	13413068	.	A	T	11	8	19	1	0	20	0	0
19	13413387	.	T	C	1	5	6	0	1	7	0	0
19	13413432	.	C	A	3	4	7	0	3	10	0	0
19	13413445	.	A	G	4	3	7	0	1	8	0	0
19	13413547	.	A	G	1	4	5	0	1	6	0	0
19	13413615	.	A	G	3	9	12	0	0	12	0	0
19	13413727	.	G	A	1	4	5	0	1	6	0	0
19	13413752	.	A	G	3	2	5	0	2	7	0	0
19	13413776	.	G	C	4	3	7	0	0	7	0	0
19	13413844	.	C	T	7	4	11	0	1	12	0	0
19	13414896	.	C	T	3	3	6	0	0	6	0	0
19	13415169	.	C	T	11	19	30	0	0	30	0	0
19	13419582	.	T	C	17	19	36	0	3	39	0	0
19	13419696	.	A	G	18	1	19	0	21	40	0	0
19	13419948	.	A	C	16	10	26	0	6	32	0	0
19	13419986	.	C	G	14	21	35	0	0	35	0	0
19	13425618	.	T	C	6	7	13	0	2	15	0	0
19	13425707	.	A	G	5	8	13	0	0	13	0	0
19	13426090	.	A	T	4	4	8	0	0	8	0	0
19	13426863	.	T	G	4	0	4	0	3	7	0	0
19	13639492	.	T	A	9	12	21	0	1	22	0	0
19	13651691	.	G	T	5	7	12	0	0	12	0	0
19	13670103	.	C	T	2	6	8	0	16	24	0	0
19	13688974	.	G	A	7	8	15	0	2	17	0	0
19	13698141	.	G	A	4	12	16	0	0	16	0	0
19	13698643	.	G	A	13	13	26	0	0	26	0	0
19	13698685	.	T	C	8	10	18	0	3	21	0	0
19	13714963	.	A	G	14	11	25	0	2	27	0	0
19	13724014	.	T	C	22	22	44	0	3	47	0	0
19	13724320	.	T	G	15	11	26	0	2	28	0	0
19	13733583	.	C	G	17	14	31	0	0	31	0	0
19	13905442	.	T	A	7	12	19	0	0	19	0	0
19	13905469	.	T	G	12	14	26	0	0	26	0	0
19	13919292	.	A	T	8	8	16	0	2	18	0	0
19	13923051	.	A	T	7	5	12	0	0	12	0	0
19	13939827	.	T	C	9	4	13	2	1	16	0	0
19	13939839	.	G	C	16	5	21	2	1	24	0	0
19	13939883	.	C	G	18	16	34	0	1	35	0	0
19	13940106	.	A	G	14	19	33	0	2	35	0	0
19	13940123	.	A	T	16	16	32	0	2	34	0	0
19	13940168	.	G	A	14	22	36	1	3	40	0	0
19	13940227	.	G	T	18	23	41	0	3	44	0	0
19	13940423	.	G	T	20	18	38	0	3	41	0	0
19	13940500	.	C	T	16	24	40	0	0	40	0	0
19	13940614	.	T	C	13	18	31	0	0	31	0	0
19	13940936	.	C	A	13	9	22	0	2	24	0	0
19	13941161	.	C	T	18	22	40	0	0	40	0	0
19	13941285	.	T	C	12	16	28	0	0	28	0	0
19	13941311	.	C	T	15	13	28	0	0	28	0	0
19	13941403	.	T	A	9	17	26	0	1	27	0	0
19	13941442	.	T	C	13	15	28	0	2	31	1	0
19	13941448	.	A	G	15	16	31	0	1	32	0	0
19	13941505	.	G	C	23	10	33	1	2	36	0	0
19	13941526	.	G	T	23	6	29	1	0	30	0	0
19	13941667	.	T	A	24	21	45	0	3	48	0	0
19	13950183	.	T	C	6	8	14	0	1	15	0	0
19	14022823	.	G	A	3	2	5	0	1	6	0	0
19	14035815	.	A	T	5	3	8	0	0	8	0	0
19	14165408	.	G	A	3	10	13	0	7	20	0	0
19	14169238	.	T	A	9	17	26	0	0	26	0	0
19	14352629	.	C	A	1	2	3	0	0	3	0	0
19	14352661	.	C	T	2	3	5	0	0	5	0	0
19	14419398	.	T	C	1	2	3	0	0	3	0	0
19	14431424	.	T	A	1	3	4	0	0	4	0	0
19	14433417	.	A	G	1	4	5	0	0	5	0	0
19	14434077	.	A	G	8	12	20	0	0	20	0	0
19	14434078	.	G	A	8	12	20	0	0	20	0	0
19	14434441	.	A	T	8	6	14	0	0	14	0	0
19	14435968	.	T	C	12	17	29	0	1	30	0	0
19	14436033	.	A	T	7	12	19	0	1	20	0	0
19	14436060	.	C	T	13	8	21	0	0	21	0	0
19	14454521	.	G	A	1	2	3	0	0	3	0	0
19	14462446	.	G	A	1	5	6	0	1	7	0	0
19	14574068	.	T	A	1	2	3	0	0	3	0	0
19	15142926	.	C	T	3	2	5	1	0	6	0	0
19	15143973	.	T	G	2	2	4	0	0	4	0	0
19	15307766	.	C	T	1	4	5	0	0	5	0	0
19	15308389	.	G	T	8	11	19	0	0	19	0	0
19	15313034	.	A	C	5	6	11	0	1	12	0	0
19	15313115	.	G	A	8	3	11	0	1	12	0	0
19	15331663	.	T	C	10	4	14	0	1	15	0	0
19	15331686	.	T	C	6	6	12	0	0	12	0	0
19	15331699	.	C	T	0	4	4	0	9	13	0	0
19	15331805	.	C	A	8	4	12	0	0	12	0	0
19	15331970	.	T	C	10	0	10	0	4	14	0	0
19	15331978	.	G	A	10	4	14	0	1	15	0	0
19	15332115	.	G	T	4	2	6	0	0	6	0	0
19	15332116	.	A	G	4	2	6	0	0	6	0	0
19	15332911	.	T	C	3	2	5	0	0	5	0	0
19	15411142	.	G	A	2	2	4	0	0	4	0	0
19	15509935	.	G	T	1	2	3	0	0	3	0	0
19	15510498	.	C	T	1	3	4	0	0	4	0	0
19	15510503	.	T	C	1	2	3	0	1	4	0	0
19	15510543	.	T	C	1	2	3	0	0	3	0	0
19	15527165	.	C	T	2	3	5	0	0	5	0	0
19	15532120	.	G	C	3	2	5	0	1	6	0	0
19	15532159	.	C	T	3	3	6	0	1	7	0	0
19	15532186	.	A	G	2	1	3	0	3	6	0	0
19	15532386	.	G	C	2	4	6	0	0	6	0	0
19	15532391	.	C	T	2	4	6	0	1	7	0	0
19	15617983	.	A	C	1	2	3	0	0	3	0	0
19	15618501	.	G	A	4	2	6	0	0	6	0	0
19	15618951	.	G	A	5	6	11	0	0	11	0	0
19	15619503	.	C	T	7	7	14	0	0	14	0	0
19	15619584	.	A	G	6	8	14	0	1	15	0	0
19	15619675	.	A	G	4	0	4	0	9	13	0	0
19	15619842	.	C	T	1	2	3	0	1	4	0	0
19	15620715	.	G	A	1	3	4	0	0	4	0	0
19	15851707	.	C	A	10	11	21	0	2	23	0	0
19	15851710	.	G	A	12	11	23	0	0	23	0	0
19	15851777	.	G	A	11	14	25	0	1	26	0	0
19	15851890	.	C	T	9	8	17	0	1	18	0	0
19	15852389	.	T	A	8	7	15	0	0	15	0	0
19	15852965	.	C	T	0	4	4	0	4	8	0	0
19	15853153	.	C	T	4	10	14	0	1	15	0	0
19	15853275	.	A	G	9	13	22	0	1	23	0	0
19	15855335	.	A	T	11	4	15	0	1	16	0	0
19	16023901	.	C	T	6	5	11	0	0	11	0	0
19	16026881	.	G	A	7	4	11	0	0	11	0	0
19	16026907	.	G	T	0	4	4	0	4	8	0	0
19	16061860	.	G	A	5	2	7	0	0	7	0	0
19	16061892	.	T	C	3	5	8	0	0	8	0	0
19	16070475	.	A	G	2	2	4	0	0	4	0	0
19	16076887	.	C	T	6	3	9	0	0	9	0	0
19	16077033	.	C	T	5	3	8	0	0	8	0	0
19	16078744	.	C	A	3	6	9	0	0	9	0	0
19	16085862	.	A	T	8	9	17	0	0	17	0	0
19	16086025	.	T	A	13	7	20	0	1	21	0	0
19	16086937	.	G	A	12	5	17	0	0	17	0	0
19	16086957	.	T	C	6	10	16	0	1	17	0	0
19	16087201	.	T	C	5	3	8	0	2	10	0	0
19	16087503	.	T	A	2	5	7	0	0	7	0	0
19	16087527	.	C	T	2	5	7	0	1	8	0	0
19	16087538	.	G	A	3	6	9	0	1	10	0	0
19	16087726	.	A	G	3	2	5	0	1	6	0	0
19	16088506	.	T	C	2	2	4	0	0	4	0	0
19	16541333	.	C	T	2	2	4	0	0	4	0	0
19	16541375	.	A	T	1	3	4	0	0	4	0	0
19	16541378	.	G	A	1	3	4	0	0	4	0	0
19	16576532	.	G	A	3	5	8	0	0	8	0	0
19	16576574	.	A	T	5	5	10	0	0	10	0	0
19	16584121	.	G	A	1	3	4	0	11	15	0	0
19	16584205	.	C	T	4	5	9	0	1	10	0	0
19	16625154	.	G	T	6	5	11	0	0	11	0	0
19	16629317	.	A	G	10	4	14	0	0	14	0	0
19	16638661	.	C	T	13	7	20	2	2	24	0	0
19	16638786	.	C	T	10	17	27	0	2	29	0	0
19	16638906	.	C	G	6	10	16	0	1	17	0	0
19	16638951	.	A	G	11	7	18	0	1	19	0	0
19	16651469	.	T	C	10	16	26	0	0	26	0	0
19	16653867	.	T	C	12	5	17	0	1	18	0	0
19	16653977	.	T	C	11	10	21	0	0	21	0	0
19	16653998	.	T	C	10	9	19	0	1	20	0	0
19	16654012	.	T	C	13	8	21	0	1	22	0	0
19	16654277	.	G	A	3	10	13	0	22	35	0	0
19	16654640	.	A	G	24	17	41	0	2	43	0	0
19	17208187	.	G	A	4	3	7	0	0	7	0	0
19	17208304	.	C	T	5	3	8	0	0	8	0	0
19	17210687	.	A	T	2	2	4	0	0	4	0	0
19	17260250	.	C	G	4	5	9	0	0	9	0	0
19	17260422	.	T	G	1	0	1	0	4	5	0	0
19	17275632	.	C	A	4	2	6	0	0	6	0	0
19	17276921	.	A	T	10	5	15	0	1	16	0	0
19	17292566	.	T	C	1	2	3	0	0	3	0	0
19	17292831	.	A	T	3	3	6	0	0	6	0	0
19	17292898	.	T	A	8	6	14	0	0	14	0	0
19	17292905	.	G	A	7	6	13	0	1	14	0	0
19	17293153	.	T	G	3	3	6	0	1	7	0	0
19	17295656	.	G	A	14	6	20	0	1	21	0	0
19	17300130	.	G	A	10	3	13	0	0	13	0	0
19	17300536	.	C	T	9	8	17	0	1	18	0	0
19	17301292	.	A	G	7	7	14	0	0	14	0	0
19	17302363	.	T	A	7	4	11	0	1	12	0	0
19	17304888	.	A	G	5	5	10	0	1	11	0	0
19	17304891	.	T	C	4	4	8	0	2	10	0	0
19	17359046	.	A	G	1	2	3	0	0	3	0	0
19	17377786	.	T	G	1	4	5	0	0	5	0	0
19	17378142	.	G	A	6	3	9	0	1	10	0	0
19	17378361	.	C	T	11	8	19	0	0	19	0	0
19	17385412	.	T	A	1	5	6	0	0	6	0	0
19	17385445	.	C	T	5	3	8	0	0	8	0	0
19	17385479	.	T	G	4	2	6	0	0	6	0	0
19	17385486	.	G	T	4	2	6	0	0	6	0	0
19	17386556	.	G	T	26	27	53	0	7	61	1	0
19	17393069	.	T	C	39	18	57	0	4	61	0	0
19	17400470	.	C	T	2	5	7	0	0	7	0	0
19	17400653	.	G	C	7	7	14	0	1	15	0	0
19	17404237	.	C	T	17	16	33	0	0	33	0	0
19	17405304	.	C	T	23	27	50	0	3	53	0	0
19	17405364	.	C	T	30	25	55	0	0	55	0	0
19	17406014	.	A	T	21	25	46	0	1	47	0	0
19	17406081	.	A	C	20	18	38	0	2	40	0	0
19	17406082	.	G	A	19	18	37	0	1	39	1	0
19	17406271	.	T	G	15	13	28	0	2	30	0	0
19	17406656	.	C	G	24	0	24	0	31	55	0	0
19	17406770	.	T	G	29	26	55	0	0	55	0	0
19	17406918	.	T	C	24	9	33	0	3	36	0	0
19	17514860	.	T	A	13	22	35	0	2	37	0	0
19	17514897	.	T	C	15	0	15	0	17	32	0	0
19	17515048	.	T	C	5	6	11	0	1	12	0	0
19	17515142	.	T	A	4	2	6	0	0	6	0	0
19	17515148	.	G	T	2	3	5	0	0	5	0	0
19	17515297	.	T	A	2	3	5	0	3	8	0	0
19	17515347	.	G	C	4	4	8	0	1	9	0	0
19	17515812	.	A	G	0	3	3	0	1	4	0	0
19	17515990	.	G	A	2	2	4	0	0	4	0	0
19	17516039	.	G	A	2	6	8	0	1	9	0	0
19	17516070	.	A	G	7	9	16	0	1	17	0	0
19	17516103	.	G	C	6	1	7	0	12	19	0	0
19	17516130	.	T	C	4	21	25	0	1	26	0	0
19	17516162	.	A	T	11	16	27	0	1	28	0	0
19	17516195	.	T	C	12	1	13	0	10	23	0	0
19	17516211	.	G	T	12	9	21	1	1	23	0	0
19	17516330	.	A	G	16	8	24	0	4	28	0	0
19	17516390	.	A	G	14	16	30	0	1	31	0	0
19	17516482	.	A	C	25	3	28	0	6	34	0	0
19	17516489	.	T	A	15	10	25	0	2	27	0	0
19	17516585	.	C	A	7	7	14	0	1	15	0	0
19	17516920	.	A	G	12	10	22	0	0	22	0	0
19	17516922	.	A	G	12	10	22	0	0	22	0	0
19	17516962	.	T	C	7	6	13	0	0	13	0	0
19	17516997	.	A	G	8	7	15	0	1	16	0	0
19	17517105	.	T	C	12	3	15	0	2	17	0	0
19	17517136	.	T	C	9	3	12	0	2	14	0	0
19	17517241	.	T	G	2	4	6	0	0	6	0	0
19	17517768	.	T	G	10	4	14	0	0	14	0	0
19	17517816	.	T	C	7	5	12	0	1	13	0	0
19	17517821	.	A	G	8	6	14	0	0	14	0	0
19	17517912	.	T	G	9	6	15	1	0	16	0	0
19	17517928	.	C	G	7	4	11	0	1	12	0	0
19	17518071	.	C	T	6	6	12	0	0	12	0	0
19	17518179	.	A	T	7	8	15	0	1	16	0	0
19	17518231	.	T	C	9	8	17	0	0	17	0	0
19	17518276	.	G	C	7	3	10	0	0	10	0	0
19	17518330	.	T	C	6	6	12	0	1	13	0	0
19	17518351	.	C	A	0	9	9	0	5	14	0	0
19	17518366	.	A	T	4	8	12	0	0	12	0	0
19	17518489	.	T	A	5	5	10	0	0	10	0	0
19	17518531	.	T	G	10	4	14	2	2	18	0	0
19	17520859	.	A	G	5	3	8	0	0	8	0	0
19	17521027	.	A	T	9	9	18	0	0	18	0	0
19	17521060	.	C	A	5	9	14	0	0	14	0	0
19	17722355	.	T	C	7	3	10	0	1	11	0	0
19	17834671	.	T	A	5	4	9	0	0	9	0	0
19	18143837	.	C	T	4	7	11	1	0	12	0	0
19	18636530	.	A	T	2	4	6	0	0	6	0	0
19	18765109	.	C	T	3	3	6	0	0	6	0	0
19	18765165	.	C	T	3	2	5	0	0	5	0	0
19	18765612	.	C	T	4	2	6	0	1	7	0	0
19	18765784	.	G	T	8	3	11	0	0	11	0	0
19	18799466	.	T	C	2	2	4	0	0	4	0	0
19	18903694	.	C	T	3	2	5	0	0	5	0	0
19	19200483	.	A	G	8	10	18	0	0	18	0	0
19	19201301	.	T	G	12	10	22	0	1	23	0	0
19	19213871	.	C	T	6	11	17	0	1	18	0	0
19	19214295	.	T	G	15	11	26	0	2	28	0	0
19	19214316	.	T	A	14	8	22	0	0	22	0	0
19	19217233	.	T	C	2	2	4	0	0	4	0	0
19	19269659	.	T	C	3	3	6	0	0	6	0	0
19	19269931	.	G	A	3	3	6	0	0	6	0	0
19	19270468	.	C	T	5	4	9	0	0	9	0	0
19	19270623	.	T	C	1	6	7	0	0	7	0	0
19	19287981	.	G	A	17	20	37	0	1	38	0	0
19	19319164	.	T	C	13	14	27	0	1	28	0	0
19	19319229	.	C	T	15	12	27	0	0	27	0	0
19	19319315	.	G	A	8	17	25	0	0	25	0	0
19	19319337	.	A	G	13	8	21	0	0	21	0	0
19	19319556	.	T	C	9	0	9	0	6	15	0	0
19	19319626	.	A	C	5	5	10	0	0	10	0	0
19	19319692	.	C	T	2	8	10	0	5	15	0	0
19	19319724	.	A	G	8	7	15	0	1	16	0	0
19	19319814	.	T	A	8	6	14	0	0	14	0	0
19	19319852	.	T	A	6	3	9	0	1	10	0	0
19	19319864	.	T	A	2	7	9	0	1	10	0	0
19	19338885	.	T	A	5	5	10	0	0	10	0	0
19	19338923	.	T	A	3	4	7	0	0	7	0	0
19	19342328	.	C	T	2	3	5	0	0	5	0	0
19	19347856	.	T	C	4	10	14	0	0	14	0	0
19	19353790	.	G	A	6	5	11	0	0	11	0	0
19	19418066	.	G	A	3	10	13	0	0	13	0	0
19	19432598	.	C	T	11	14	25	0	1	26	0	0
19	19498760	.	T	C	1	2	3	0	1	4	0	0
19	19544615	.	C	T	5	8	13	0	0	13	0	0
19	19549921	.	T	C	11	6	17	0	1	18	0	0
19	19550141	.	T	G	9	15	24	0	1	25	0	0
19	19550184	.	G	T	10	11	21	0	4	25	0	0
19	19550381	.	T	G	15	11	26	0	1	27	0	0
19	19550601	.	C	A	12	10	22	0	2	24	0	0
19	19551819	.	G	A	12	4	16	0	0	16	0	0
19	19551828	.	A	G	11	3	14	0	0	14	0	0
19	19561923	.	C	T	1	9	10	0	8	18	0	0
19	19562669	.	A	G	4	2	6	0	1	7	0	0
19	19573913	.	C	T	1	6	7	0	7	14	0	0
19	19579200	.	C	T	8	8	16	0	1	17	0	0
19	19580971	.	C	T	0	8	8	0	7	15	0	0
19	19592010	.	C	T	0	6	6	0	2	8	0	0
19	19652494	.	G	A	0	2	2	0	2	4	0	0
19	19769016	.	C	A	6	8	14	0	0	14	0	0
19	19779232	.	C	A	3	3	6	0	0	6	0	0
19	19979049	.	C	T	5	4	9	0	0	9	0	0
19	20112056	.	G	C	21	38	59	0	2	62	1	0
19	20113526	.	G	A	27	24	51	0	2	53	0	0
19	20164058	.	G	A	0	4	4	0	5	9	0	0
19	20173714	.	G	A	1	2	3	0	4	7	0	0
19	20176418	.	G	A	2	8	10	0	5	15	0	0
19	20176665	.	G	T	13	6	19	0	1	20	0	0
19	20179257	.	G	A	10	11	21	0	2	23	0	0
19	20179291	.	G	A	9	9	18	0	1	19	0	0
19	20185030	.	C	T	19	10	29	0	2	31	0	0
19	20222814	.	G	A	1	4	5	0	0	5	0	0
19	20242955	.	T	C	0	2	2	0	0	2	0	0
19	20243214	.	A	T	1	4	5	0	0	5	0	0
19	20243263	.	G	T	3	2	5	0	0	5	0	0
19	20243814	.	G	A	4	2	6	0	0	6	0	0
19	20244004	.	T	A	3	3	6	0	1	7	0	0
19	20244346	.	T	A	2	2	4	0	0	4	0	0
19	20245197	.	T	C	1	5	6	0	0	6	0	0
19	20293373	.	G	T	2	3	5	0	0	5	0	0
19	20293390	.	C	T	2	3	5	1	0	6	0	0
19	20293548	.	C	G	1	2	3	0	0	3	0	0
19	20301843	.	T	A	2	2	4	0	0	4	0	0
19	20404559	.	G	A	6	2	8	0	2	10	0	0
19	20414805	.	C	G	0	8	8	0	9	17	0	0
19	20415143	.	T	A	5	5	10	0	2	12	0	0
19	20415146	.	T	C	7	0	7	0	6	13	0	0
19	20415242	.	G	A	5	4	9	0	0	9	0	0
19	20419171	.	G	T	5	2	7	0	0	7	0	0
19	20419172	.	T	G	5	2	7	0	0	7	0	0
19	20454087	.	G	A	2	5	7	0	0	7	0	0
19	20454123	.	A	G	7	5	12	0	0	12	0	0
19	20454324	.	G	A	1	2	3	0	1	4	0	0
19	20454393	.	G	A	2	2	4	0	0	4	0	0
19	20720782	.	T	C	13	24	37	0	2	39	0	0
19	20721025	.	C	T	25	19	44	1	3	48	0	0
19	20721135	.	G	A	29	29	58	0	0	58	0	0
19	20721215	.	C	T	18	28	46	0	10	56	0	0
19	20721761	.	A	C	9	28	37	2	9	48	0	0
19	20722093	.	C	A	19	17	36	0	3	39	0	0
19	20722144	.	C	T	16	13	29	0	4	33	0	0
19	20722330	.	C	G	2	4	6	0	1	7	0	0
19	20753194	.	G	T	4	3	7	1	1	9	0	0
19	20761382	.	C	T	2	2	4	0	6	10	0	0
19	20761710	.	T	G	3	6	9	0	0	9	0	0
19	20762228	.	T	C	8	6	14	0	1	15	0	0
19	20762239	.	G	A	5	7	12	0	0	12	0	0
19	20763798	.	G	A	5	3	8	0	0	8	0	0
19	20771317	.	G	A	2	3	5	0	0	5	0	0
19	20789481	.	G	A	0	4	4	0	1	5	0	0
19	20790572	.	T	C	8	15	23	0	0	23	0	0
19	20790809	.	C	T	11	13	24	0	0	24	0	0
19	20791295	.	T	C	12	15	27	0	2	29	0	0
19	20791525	.	T	G	3	6	9	0	2	11	0	0
19	20792049	.	T	A	1	7	8	0	0	8	0	0
19	20796566	.	C	T	21	21	42	1	1	44	0	0
19	20796605	.	C	T	9	19	28	1	0	29	0	0
19	20801521	.	G	A	2	2	4	0	0	4	0	0
19	21366697	.	C	T	0	2	2	0	1	3	0	0
19	21367862	.	C	T	2	4	6	0	0	6	0	0
19	21408969	.	C	T	8	2	10	0	0	10	0	0
19	21410404	.	G	A	8	5	13	0	1	14	0	0
19	21411022	.	C	T	5	9	14	0	0	14	0	0
19	21412041	.	C	T	10	16	26	0	4	31	1	0
19	21412293	.	A	G	10	6	16	0	0	16	0	0
19	21412755	.	T	C	10	14	24	0	1	25	0	0
19	21413152	.	G	A	1	16	17	0	14	31	0	0
19	21698413	.	G	A	8	7	15	0	0	15	0	0
19	21711267	.	G	C	3	6	9	0	0	9	0	0
19	21711681	.	A	G	4	3	7	0	1	8	0	0
19	21712031	.	A	T	3	3	6	0	0	6	0	0
19	21712032	.	C	G	3	3	6	0	0	6	0	0
19	21712179	.	C	T	2	2	4	0	0	4	0	0
19	21712285	.	T	A	1	3	4	0	0	4	0	0
19	21814362	.	A	C	40	27	67	0	10	77	0	0
19	21814372	.	T	A	46	38	84	0	2	86	0	0
19	21814408	.	T	C	48	56	104	0	4	108	0	0
19	21814457	.	C	T	43	68	111	0	5	116	0	0
19	21814515	.	C	T	58	42	100	0	13	113	0	0
19	21814644	.	T	G	42	41	83	0	0	83	0	0
19	21814852	.	T	C	42	46	88	0	4	92	0	0
19	21815151	.	C	T	14	38	52	0	40	92	0	0
19	21832562	.	A	G	10	6	16	0	0	16	0	0
19	21920449	.	C	T	1	2	3	0	0	3	0	0
19	21920638	.	C	T	1	3	4	0	0	4	0	0
19	22070497	.	G	A	1	4	5	0	1	6	0	0
19	22070526	.	C	A	3	4	7	0	0	7	0	0
19	22071792	.	T	C	2	2	4	0	0	4	0	0
19	22072839	.	T	G	3	4	7	2	0	9	0	0
19	22073191	.	A	T	8	5	13	0	0	14	1	0
19	22166818	.	T	A	2	2	4	0	1	5	0	0
19	22177104	.	G	A	0	6	6	0	7	13	0	0
19	22177122	.	G	A	1	6	7	0	5	12	0	0
19	22177164	.	T	C	3	6	9	0	0	9	0	0
19	22361962	.	A	C	12	8	20	0	2	22	0	0
19	22362260	.	A	C	6	7	13	0	0	13	0	0
19	22408563	.	C	G	6	5	11	0	1	12	0	0
19	22408746	.	T	C	5	11	16	0	0	16	0	0
19	22408905	.	G	A	9	4	13	0	0	13	0	0
19	22409431	.	G	T	8	4	12	0	2	14	0	0
19	22409533	.	G	A	11	3	14	0	0	14	0	0
19	22409994	.	G	C	8	10	18	0	0	18	0	0
19	22410447	.	C	T	2	4	6	0	0	6	0	0
19	22410578	.	C	G	0	9	9	0	7	16	0	0
19	22410665	.	G	A	7	6	13	0	2	15	0	0
19	22410707	.	C	T	0	4	4	0	5	9	0	0
19	22410923	.	T	A	7	3	10	0	0	10	0	0
19	22411136	.	G	A	5	8	13	0	0	13	0	0
19	22411991	.	T	G	2	3	5	0	0	5	0	0
19	22412240	.	G	A	1	3	4	0	0	4	0	0
19	22412822	.	C	T	3	2	5	0	0	5	0	0
19	22412827	.	G	A	3	1	4	0	0	4	0	0
19	22413071	.	T	C	1	3	4	0	1	5	0	0
19	22413080	.	C	T	1	3	4	0	1	5	0	0
19	22413296	.	C	T	6	3	9	0	1	10	0	0
19	22413377	.	A	G	3	2	5	0	0	5	0	0
19	22413713	.	A	G	2	4	6	0	0	6	0	0
19	22414918	.	G	A	2	2	4	0	0	4	0	0
19	22414925	.	T	C	2	2	4	0	0	4	0	0
19	22415905	.	T	A	1	3	4	0	0	4	0	0
19	22623421	.	G	A	1	2	3	0	0	3	0	0
19	22623596	.	G	A	6	2	8	0	1	9	0	0
19	22623638	.	G	T	8	4	12	0	0	12	0	0
19	22623724	.	G	T	3	2	5	0	0	5	0	0
19	22624319	.	T	C	1	1	2	0	6	8	0	0
19	22624484	.	T	A	7	2	9	0	0	9	0	0
19	22634093	.	G	A	12	5	17	0	0	17	0	0
19	22638250	.	C	A	9	10	19	0	2	21	0	0
19	22655190	.	A	G	8	6	14	0	1	15	0	0
19	22655690	.	T	C	5	7	12	0	3	15	0	0
19	22731075	.	C	T	1	5	6	0	0	6	0	0
19	22731086	.	A	G	1	5	6	0	0	6	0	0
19	22731315	.	C	A	2	4	6	0	0	6	0	0
19	22731316	.	C	A	2	4	6	0	0	6	0	0
19	22759523	.	C	A	0	4	4	0	5	9	0	0
19	22764168	.	T	G	7	3	10	0	0	10	0	0
19	22764259	.	A	G	1	2	3	0	1	4	0	0
19	22764274	.	G	A	1	3	4	0	1	5	0	0
19	22788903	.	G	A	3	2	5	0	0	5	0	0
19	22807233	.	A	T	2	2	4	0	1	5	0	0
19	22807317	.	G	A	1	3	4	0	0	4	0	0
19	23876484	.	C	T	2	3	5	0	0	5	0	0
19	23877308	.	C	T	1	2	3	0	0	3	0	0
19	23877478	.	A	T	4	4	8	0	0	8	0	0
19	23877497	.	C	T	3	3	6	0	0	6	0	0
19	23880428	.	C	T	0	2	2	0	2	4	0	0
19	23880677	.	C	A	0	2	2	0	1	3	0	0
19	23897803	.	T	A	6	2	8	0	2	10	0	0
19	23920598	.	G	T	4	9	13	0	13	26	0	0
19	23920826	.	T	G	6	7	13	0	2	15	0	0
19	23921127	.	T	C	11	8	19	0	1	20	0	0
19	23921147	.	C	G	10	1	11	0	8	19	0	0
19	23921282	.	T	A	5	11	16	0	1	17	0	0
19	23921381	.	G	A	14	8	22	0	3	25	0	0
19	23921617	.	A	G	17	11	28	0	0	28	0	0
19	23921662	.	A	G	11	0	11	0	15	26	0	0
19	23921669	.	G	A	2	13	15	0	14	29	0	0
19	23921858	.	A	G	3	9	12	0	1	13	0	0
19	23921898	.	T	C	4	3	7	0	0	7	0	0
19	23921905	.	T	C	4	3	7	0	0	7	0	0
19	23922030	.	T	C	2	2	4	0	0	4	0	0
19	23922077	.	A	C	3	2	5	0	0	6	1	0
19	23922082	.	G	T	3	2	5	0	0	5	0	0
19	23922237	.	T	G	17	0	17	0	14	31	0	0
19	23922260	.	A	T	15	13	28	0	1	29	0	0
19	23982575	.	T	G	12	9	21	0	0	21	0	0
19	24007465	.	G	A	10	16	26	0	1	27	0	0
19	24007471	.	C	T	14	7	21	0	3	24	0	0
19	24031592	.	C	T	22	13	35	0	0	35	0	0
19	24031761	.	T	A	29	17	46	0	0	46	0	0
19	24032122	.	T	A	14	22	36	0	1	37	0	0
19	24032386	.	G	A	0	8	8	0	9	17	0	0
19	24032407	.	C	A	8	8	16	0	2	18	0	0
19	24032502	.	T	G	9	14	23	0	2	25	0	0
19	24032528	.	C	T	12	13	25	0	2	27	0	0
19	24032766	.	A	T	19	25	44	0	3	47	0	0
19	24032867	.	T	A	23	23	46	2	1	49	0	0
19	24032907	.	T	C	16	24	40	3	1	44	0	0
19	24033226	.	A	C	20	22	42	0	13	55	0	0
19	24033288	.	A	G	29	29	58	0	0	58	0	0
19	24033494	.	G	A	5	33	38	0	33	71	0	0
19	24033686	.	C	T	24	28	52	0	5	57	0	0
19	24033804	.	C	T	37	28	65	0	1	66	0	0
19	24033856	.	A	C	26	32	58	0	1	59	0	0
19	24034115	.	C	T	36	25	61	0	3	64	0	0
19	24034148	.	T	C	27	25	52	2	10	64	0	0
19	24034169	.	T	C	30	22	52	1	4	57	0	0
19	24034276	.	T	G	31	36	67	0	4	71	0	0
19	24034410	.	G	A	31	32	63	0	1	64	0	0
19	24034437	.	G	A	3	42	45	0	25	70	0	0
19	24034525	.	C	T	25	40	65	0	3	68	0	0
19	24034573	.	T	A	28	31	59	0	3	62	0	0
19	24065367	.	T	G	1	7	8	0	0	8	0	0
19	24070243	.	G	A	1	3	4	0	0	4	0	0
19	24072602	.	C	T	2	3	5	0	0	5	0	0
19	24072644	.	T	G	3	0	3	0	6	9	0	0
19	24074533	.	T	C	4	7	11	0	2	13	0	0
19	24074564	.	G	A	5	6	11	0	0	11	0	0
19	24074617	.	G	A	0	5	5	0	4	9	0	0
19	24074632	.	C	A	3	6	9	0	1	10	0	0
19	24074679	.	C	T	2	2	4	0	2	6	0	0
19	24074716	.	A	G	6	0	6	0	5	11	0	0
19	24074773	.	C	A	6	3	9	0	1	10	0	0
19	24074794	.	A	G	4	4	8	0	0	8	0	0
19	24074812	.	G	A	4	4	8	0	0	8	0	0
19	24123657	.	T	A	2	2	4	0	0	4	0	0
19	24123917	.	G	C	5	3	8	0	1	9	0	0
19	24123919	.	A	T	6	3	9	0	0	9	0	0
19	24124448	.	C	T	5	2	7	0	0	7	0	0
19	24127564	.	T	A	1	3	4	0	1	5	0	0
19	24128178	.	A	G	3	3	6	0	1	7	0	0
19	24128252	.	G	A	3	2	5	0	0	5	0	0
19	24128693	.	T	C	2	3	5	0	0	5	0	0
19	24129199	.	A	T	3	3	6	0	0	6	0	0
19	24129244	.	C	T	4	3	7	0	0	7	0	0
19	24129398	.	G	A	2	4	6	0	0	6	0	0
19	24129464	.	A	T	3	3	6	0	0	6	0	0
19	24129494	.	A	T	4	2	6	0	0	6	0	0
19	24129728	.	C	A	1	4	5	0	0	5	0	0
19	24130139	.	G	A	4	2	6	0	0	6	0	0
19	24130179	.	G	T	7	7	14	0	1	15	0	0
19	24130541	.	T	G	5	5	10	0	0	10	0	0
19	24130685	.	C	G	3	3	6	0	1	7	0	0
19	24131162	.	C	G	5	5	10	2	2	14	0	0
19	24133938	.	G	T	3	2	5	0	1	6	0	0
19	24264105	.	G	A	2	4	6	0	0	6	0	0
19	24264106	.	C	G	0	4	4	0	1	5	0	0
19	24388639	.	T	C	2	3	5	0	0	5	0	0
19	24388987	.	A	G	1	0	1	0	5	6	0	0
19	24389170	.	G	A	0	2	2	0	4	6	0	0
19	24389280	.	G	A	4	2	6	0	0	6	0	0
19	24389282	.	A	G	4	2	6	0	0	6	0	0
19	24389357	.	G	A	1	2	3	0	1	4	0	0
19	24389605	.	G	A	2	1	3	0	1	4	0	0
19	24389618	.	T	A	2	1	3	0	1	4	0	0
19	24390379	.	A	C	4	3	7	0	0	7	0	0
19	24390433	.	T	A	3	2	5	0	0	5	0	0
19	24391232	.	A	G	5	1	6	0	4	10	0	0
19	24391234	.	A	T	5	5	10	0	0	10	0	0
19	24391280	.	T	G	5	3	8	0	0	8	0	0
19	24391289	.	G	A	5	2	7	0	0	7	0	0
19	24391373	.	T	C	2	3	5	0	0	5	0	0
19	24391477	.	A	T	3	4	7	0	0	7	0	0
19	24391726	.	G	A	4	3	7	0	0	7	0	0
19	24448985	.	T	C	6	0	6	0	4	10	0	0
19	24484690	.	T	A	3	5	8	0	0	8	0	0
19	24491086	.	A	T	7	5	12	0	0	12	0	0
19	24491140	.	G	T	6	3	9	0	0	9	0	0
19	24491224	.	C	T	4	2	6	0	2	8	0	0
19	24491230	.	A	T	5	2	7	0	0	7	0	0
19	24491268	.	C	T	3	2	5	0	1	6	0	0
19	24491588	.	T	A	4	3	7	0	0	7	0	0
19	24491982	.	G	C	9	9	18	0	1	19	0	0
19	24553388	.	A	G	1	2	3	0	1	4	0	0
19	24597082	.	T	G	2	0	2	0	2	4	0	0
19	24597091	.	C	T	2	2	4	0	0	4	0	0
19	24597268	.	A	G	1	2	3	0	0	3	0	0
19	24757063	.	T	C	2	6	8	0	0	8	0	0
19	24758037	.	G	C	3	4	7	0	0	7	0	0
19	24758040	.	T	G	3	4	7	0	0	7	0	0
19	24888024	.	A	G	13	17	30	0	1	31	0	0
19	24888090	.	A	T	21	9	30	0	1	31	0	0
19	24888187	.	C	T	12	15	27	0	1	28	0	0
19	24888195	.	A	T	13	9	22	0	2	24	0	0
19	24888398	.	G	A	2	21	23	0	25	48	0	0
19	24888748	.	T	C	22	19	41	0	4	45	0	0
19	24906427	.	G	A	0	3	3	0	3	6	0	0
19	24914462	.	C	T	4	7	11	0	0	11	0	0
19	24914660	.	A	T	1	2	3	0	0	3	0	0
19	24914687	.	G	T	1	3	4	0	0	4	0	0
19	24915208	.	A	T	1	2	3	1	0	4	0	0
19	24915680	.	A	G	5	3	8	0	0	8	0	0
19	24915688	.	C	T	6	3	9	0	0	9	0	0
19	24915782	.	G	A	1	5	6	0	2	8	0	0
19	24915796	.	A	G	4	3	7	0	1	8	0	0
19	24916007	.	T	G	7	4	11	0	2	13	0	0
19	24916427	.	C	T	5	7	12	0	0	12	0	0
19	24916445	.	A	T	5	6	11	0	1	12	0	0
19	24916543	.	A	T	4	5	9	0	2	11	0	0
19	24916766	.	T	G	6	6	12	0	1	13	0	0
19	25089839	.	A	G	10	8	18	0	2	20	0	0
19	25089979	.	A	G	11	8	19	0	2	21	0	0
19	25090032	.	T	G	11	11	22	0	1	23	0	0
19	25090079	.	A	G	16	10	26	0	1	27	0	0
19	25090231	.	T	C	14	13	27	0	1	28	0	0
19	25113207	.	C	A	6	15	21	0	0	21	0	0
19	25113524	.	T	C	14	8	22	0	3	25	0	0
19	25156378	.	T	A	3	2	5	0	1	6	0	0
19	25156572	.	C	T	10	5	15	0	1	16	0	0
19	25156639	.	T	C	6	0	6	0	12	18	0	0
19	25156669	.	T	C	6	11	17	0	0	17	0	0
19	25156717	.	A	C	8	10	18	0	1	19	0	0
19	25156774	.	T	A	14	10	24	0	1	25	0	0
19	25156959	.	A	T	17	14	31	0	0	32	1	0
19	25163587	.	G	A	13	7	20	0	2	22	0	0
19	25163633	.	G	T	9	6	15	0	1	16	0	0
19	25169531	.	A	C	2	0	2	0	3	6	1	0
19	25352503	.	G	A	7	7	14	0	3	17	0	0
19	25352789	.	T	C	5	12	17	0	1	18	0	0
19	25352901	.	A	T	14	7	21	0	1	22	0	0
19	25353088	.	A	G	12	13	25	0	0	25	0	0
19	25367246	.	G	A	10	7	17	0	0	17	0	0
19	25367270	.	T	C	9	0	9	0	7	16	0	0
19	25367414	.	A	C	6	0	6	0	5	11	0	0
19	25370392	.	G	A	6	5	11	0	0	11	0	0
19	25370730	.	C	T	7	3	10	0	0	10	0	0
19	25426850	.	G	T	1	2	3	0	0	3	0	0
19	25526483	.	G	A	3	8	11	0	7	18	0	0
19	25526529	.	T	C	9	7	16	0	0	16	0	0
19	25548114	.	C	G	11	13	24	0	1	25	0	0
19	25652962	.	C	T	12	27	39	0	3	42	0	0
19	25653042	.	C	T	17	18	35	2	6	43	0	0
19	25653147	.	C	T	11	9	20	0	2	22	0	0
19	25653170	.	G	T	4	8	12	0	7	19	0	0
19	25657306	.	C	A	5	4	9	0	0	9	0	0
19	25680169	.	A	T	8	5	13	0	1	14	0	0
19	25680170	.	C	T	8	4	12	0	2	14	0	0
19	25682029	.	G	A	5	6	11	0	0	11	0	0
19	25682044	.	A	G	7	3	10	0	1	11	0	0
19	25693539	.	T	C	4	2	6	0	0	6	0	0
19	25701309	.	A	G	2	4	6	0	0	6	0	0
19	26156423	.	C	T	4	2	6	0	0	6	0	0
19	26164906	.	G	A	19	21	40	0	1	41	0	0
19	26235083	.	G	A	9	9	18	0	0	18	0	0
19	26235089	.	C	T	8	8	16	0	1	17	0	0
19	26369614	.	C	T	4	5	9	0	0	9	0	0
19	26370720	.	A	T	3	4	7	0	0	7	0	0
19	26370726	.	C	T	5	2	7	0	0	7	0	0
19	26375471	.	C	T	7	2	9	0	1	10	0	0
19	26375643	.	T	G	7	3	10	0	0	10	0	0
19	26375699	.	G	T	5	4	9	0	0	9	0	0
19	26377775	.	A	T	1	3	4	0	0	4	0	0
19	26377946	.	T	A	4	7	11	0	1	12	0	0
19	26378250	.	T	C	6	7	13	0	3	16	0	0
19	26378265	.	G	A	10	7	17	0	4	21	0	0
19	26378285	.	G	A	10	10	20	0	0	20	0	0
19	26378447	.	T	A	6	3	9	0	3	12	0	0
19	26378451	.	G	A	4	6	10	0	1	11	0	0
19	26623634	.	C	T	3	2	5	0	0	5	0	0
19	26627729	.	T	A	1	4	5	0	0	5	0	0
19	26627730	.	C	T	1	4	5	0	0	5	0	0
19	26628037	.	A	G	0	2	2	0	2	4	0	0
19	26628173	.	T	A	1	4	5	0	0	5	0	0
19	26628225	.	G	A	7	3	10	0	0	10	0	0
19	26628244	.	C	T	6	2	8	0	0	8	0	0
19	26628279	.	C	T	3	4	7	0	0	7	0	0
19	26628287	.	G	A	2	3	5	0	0	5	0	0
19	26628333	.	C	T	3	2	5	0	0	5	0	0
19	26628825	.	G	A	1	5	6	0	0	6	0	0
19	26628980	.	C	A	2	3	5	0	0	5	0	0
19	26640232	.	C	T	2	3	5	0	0	5	0	0
19	26657193	.	T	C	3	4	7	0	0	7	0	0
19	26669225	.	G	A	6	2	8	0	0	8	0	0
19	26669228	.	T	C	6	1	7	0	1	8	0	0
19	26670618	.	A	G	7	1	8	0	12	20	0	0
19	26692201	.	G	A	1	2	3	0	0	3	0	0
19	26707150	.	T	C	1	3	4	0	0	4	0	0
19	26707167	.	A	G	1	2	3	0	2	5	0	0
19	26707203	.	C	G	2	4	6	0	1	7	0	0
19	26707245	.	A	T	2	2	4	0	0	4	0	0
19	26707384	.	T	C	3	2	5	0	0	5	0	0
19	26707435	.	C	G	5	0	5	0	3	8	0	0
19	26710828	.	C	T	2	5	7	0	0	7	0	0
19	26711151	.	A	T	2	4	6	0	0	6	0	0
19	26711397	.	G	A	2	4	6	0	1	7	0	0
19	26711534	.	A	G	5	5	10	0	0	10	0	0
19	26715006	.	A	G	6	0	6	0	7	13	0	0
19	26717511	.	G	T	2	3	5	0	1	6	0	0
19	26717549	.	T	C	2	3	5	0	0	5	0	0
19	26718261	.	G	C	3	2	5	0	0	5	0	0
19	26723474	.	G	C	1	4	5	0	0	5	0	0
19	26723498	.	A	G	3	2	5	0	0	5	0	0
19	26723690	.	G	A	6	3	9	0	0	9	0	0
19	26723705	.	A	T	5	3	8	0	0	8	0	0
19	26727535	.	G	A	0	2	2	0	12	14	0	0
19	26728070	.	G	A	11	5	16	0	0	16	0	0
19	26728079	.	A	C	5	11	16	0	0	16	0	0
19	26729597	.	A	T	11	7	18	0	0	18	0	0
19	26729651	.	T	C	8	5	13	0	0	13	0	0
19	26729811	.	A	C	5	5	10	0	1	11	0	0
19	26729867	.	C	T	7	7	14	0	2	16	0	0
19	26729887	.	T	A	6	5	11	0	1	12	0	0
19	26730073	.	A	T	4	2	6	0	0	6	0	0
19	26730077	.	G	T	2	3	5	0	1	6	0	0
19	26730108	.	A	G	8	0	8	0	4	12	0	0
19	26730545	.	C	T	14	21	35	0	1	36	0	0
19	26730642	.	T	C	24	1	25	0	26	51	0	0
19	26731183	.	C	T	0	16	16	0	9	25	0	0
19	26741296	.	C	G	23	21	44	0	2	46	0	0
19	26741378	.	T	C	22	0	22	0	22	44	0	0
19	26741427	.	G	A	21	20	41	0	4	45	0	0
19	26741831	.	C	T	2	19	21	0	21	42	0	0
19	26741918	.	G	T	16	15	31	0	0	31	0	0
19	26742224	.	T	C	10	11	21	0	0	21	0	0
19	26742321	.	G	A	12	14	26	0	4	30	0	0
19	26742379	.	A	C	12	0	12	0	11	23	0	0
19	26742598	.	A	T	15	17	32	0	0	32	0	0
19	26742716	.	T	A	16	18	34	0	1	35	0	0
19	26742732	.	A	G	22	17	39	0	0	39	0	0
19	26742751	.	C	T	15	23	38	0	1	39	0	0
19	26743295	.	A	T	23	14	37	0	1	38	0	0
19	26743446	.	T	A	20	23	43	0	2	45	0	0
19	26743781	.	G	A	15	13	28	0	2	30	0	0
19	26743808	.	C	T	14	14	28	0	1	29	0	0
19	26743900	.	T	A	10	7	17	0	1	18	0	0
19	26743943	.	C	T	15	7	22	0	1	23	0	0
19	26743984	.	A	G	16	6	22	1	0	23	0	0
19	26744235	.	G	T	12	8	20	0	2	22	0	0
19	26744840	.	C	T	15	13	28	0	1	29	0	0
19	26745392	.	T	A	12	9	21	0	3	24	0	0
19	26747192	.	C	T	6	4	10	0	1	11	0	0
19	26747682	.	G	A	6	3	9	0	0	9	0	0
19	26747979	.	C	T	5	7	12	0	2	14	0	0
19	26748003	.	T	G	7	6	13	0	2	15	0	0
19	26756636	.	G	A	2	3	5	0	2	7	0	0
19	26810460	.	C	T	3	4	7	0	1	8	0	0
19	26860799	.	T	C	12	0	12	0	10	22	0	0
19	26868876	.	C	T	5	3	8	0	0	8	0	0
19	26868899	.	G	A	5	7	12	0	0	12	0	0
19	26868963	.	A	G	4	2	6	1	0	7	0	0
19	26872886	.	T	C	6	2	8	0	9	17	0	0
19	26872898	.	C	T	7	12	19	0	1	20	0	0
19	26873020	.	C	T	14	7	21	0	0	21	0	0
19	26911189	.	T	C	1	7	8	0	0	8	0	0
19	26925280	.	G	A	10	11	21	0	1	22	0	0
19	26925296	.	T	C	7	10	17	0	0	17	0	0
19	26925526	.	G	A	2	10	12	0	0	12	0	0
19	26925582	.	T	C	3	7	10	0	0	10	0	0
19	26925583	.	G	A	3	7	10	0	0	10	0	0
19	26928320	.	C	T	12	11	23	1	1	25	0	0
19	26928356	.	A	G	18	12	30	0	1	31	0	0
19	26928399	.	A	C	15	11	26	0	2	28	0	0
19	26931520	.	G	A	9	5	14	0	1	15	0	0
19	26931680	.	T	A	9	7	16	0	1	17	0	0
19	26931730	.	T	A	12	7	19	0	1	20	0	0
19	26931732	.	A	T	8	11	19	0	0	19	0	0
19	26931765	.	G	A	0	6	6	0	10	16	0	0
19	26938030	.	G	A	3	2	5	0	0	5	0	0
19	26958604	.	G	A	2	3	5	0	1	6	0	0
19	26958687	.	T	G	1	3	4	0	0	4	0	0
19	26967634	.	G	T	9	8	17	0	1	18	0	0
19	26967737	.	A	C	4	4	8	0	0	8	0	0
19	26967780	.	C	T	8	6	14	0	1	15	0	0
19	26967783	.	T	G	6	8	14	0	0	14	0	0
19	27043887	.	A	G	6	9	15	0	0	15	0	0
19	27073262	.	A	G	3	2	5	0	0	5	0	0
19	27260629	.	C	T	1	2	3	0	0	3	0	0
19	27283472	.	A	T	8	3	11	0	1	12	0	0
19	27283557	.	C	A	9	5	14	0	0	14	0	0
19	27283940	.	C	T	6	7	13	0	0	13	0	0
19	27284178	.	G	A	9	5	14	0	1	15	0	0
19	27284195	.	T	G	11	4	15	0	1	16	0	0
19	27284387	.	A	G	5	6	11	0	0	11	0	0
19	27284741	.	C	T	9	3	12	0	1	13	0	0
19	27284744	.	C	T	7	6	13	0	0	13	0	0
19	27284817	.	A	C	4	4	8	0	0	8	0	0
19	27284860	.	C	T	5	2	7	0	0	7	0	0
19	27284957	.	G	A	6	5	11	0	0	11	0	0
19	27285085	.	T	C	6	0	6	0	4	10	0	0
19	27286354	.	C	T	4	3	7	0	0	7	0	0
19	27286390	.	G	T	4	1	5	0	1	6	0	0
19	27286406	.	C	T	5	3	8	0	0	8	0	0
19	27286444	.	C	T	3	2	5	0	0	5	0	0
19	27287204	.	T	C	6	2	8	0	2	10	0	0
19	27287294	.	T	G	7	10	17	0	0	17	0	0
19	27307583	.	G	A	3	2	5	0	0	5	0	0
19	27314393	.	C	G	5	5	10	0	0	10	0	0
19	27321615	.	A	G	12	4	16	0	1	17	0	0
19	27321843	.	G	A	6	3	9	0	1	10	0	0
19	27331814	.	T	C	1	4	5	0	1	6	0	0
19	27334273	.	A	T	5	6	11	0	1	12	0	0
19	27351218	.	G	A	3	5	8	0	0	8	0	0
19	27354331	.	C	A	9	6	15	0	2	17	0	0
19	27357250	.	C	A	12	5	17	0	1	18	0	0
19	27357485	.	A	T	8	17	25	0	3	28	0	0
19	27357567	.	T	A	9	8	17	0	0	17	0	0
19	27368719	.	T	C	9	7	16	0	0	16	0	0
19	27368808	.	G	T	2	3	5	0	1	6	0	0
19	27368870	.	A	G	4	5	9	0	1	10	0	0
19	27369147	.	G	A	1	2	3	0	1	4	0	0
19	27369553	.	T	C	4	5	9	0	0	9	0	0
19	27369613	.	T	C	4	0	4	0	6	10	0	0
19	27369659	.	A	T	3	3	6	0	1	7	0	0
19	27369853	.	T	A	1	5	6	0	2	8	0	0
19	27370034	.	A	G	1	2	3	0	0	3	0	0
19	27370041	.	G	A	0	2	2	0	0	2	0	0
19	27370232	.	C	A	2	3	5	0	1	6	0	0
19	27370662	.	C	T	0	2	2	0	2	4	0	0
19	27370682	.	G	A	4	2	6	0	0	6	0	0
19	27370805	.	C	T	0	2	2	0	3	5	0	0
19	27370827	.	C	T	1	2	3	0	2	5	0	0
19	27381336	.	T	C	1	2	3	0	0	3	0	0
19	27401412	.	G	A	4	6	10	0	1	11	0	0
19	27401515	.	C	T	4	4	8	0	1	9	0	0
19	27401680	.	G	A	4	5	9	0	0	9	0	0
19	27415248	.	G	A	6	3	9	0	0	9	0	0
19	27428120	.	T	A	1	2	3	0	1	4	0	0
19	27430904	.	T	A	4	5	9	0	0	9	0	0
19	27457166	.	T	C	10	0	10	0	10	20	0	0
19	27457213	.	T	C	7	10	17	0	1	18	0	0
19	27457505	.	G	T	11	8	19	0	0	19	0	0
19	27457516	.	T	G	6	7	13	0	1	14	0	0
19	27457607	.	C	T	8	7	15	0	0	15	0	0
19	27457621	.	T	A	6	9	15	0	1	16	0	0
19	27457749	.	C	T	7	14	21	0	1	22	0	0
19	27457892	.	T	C	11	8	19	0	0	19	0	0
19	27461139	.	C	T	1	9	10	0	5	15	0	0
19	27461183	.	C	T	8	5	13	0	0	13	0	0
19	27461560	.	C	T	0	7	7	0	7	14	0	0
19	27462092	.	A	T	2	3	5	0	0	5	0	0
19	27464344	.	A	T	10	18	28	0	0	28	0	0
19	27464420	.	C	T	1	3	4	0	0	4	0	0
19	27465119	.	G	A	2	2	4	0	1	5	0	0
19	27466189	.	C	G	17	13	30	0	1	31	0	0
19	27468598	.	G	A	13	25	38	0	2	40	0	0
19	27468606	.	C	T	12	22	34	0	2	36	0	0
19	27468983	.	A	C	15	8	23	3	1	27	0	0
19	27469060	.	C	G	1	9	10	0	10	20	0	0
19	27469130	.	A	G	12	5	17	0	0	17	0	0
19	27469178	.	A	C	10	6	16	0	1	17	0	0
19	27469184	.	G	A	9	7	16	0	0	16	0	0
19	27469224	.	A	C	3	2	5	0	0	5	0	0
19	27505122	.	G	A	0	2	2	0	7	9	0	0
19	27505191	.	G	A	0	2	2	0	16	18	0	0
19	27505211	.	G	A	10	8	18	0	0	18	0	0
19	27505962	.	G	T	7	7	14	0	1	15	0	0
19	27609998	.	C	T	17	13	30	0	0	30	0	0
19	27616055	.	C	T	11	14	25	0	4	29	0	0
19	27616337	.	G	A	14	12	26	0	2	28	0	0
19	27623285	.	C	T	4	4	8	0	1	9	0	0
19	27634823	.	C	T	7	8	15	0	0	15	0	0
19	28281242	.	T	A	3	3	6	0	0	6	0	0
19	28281343	.	G	A	16	18	34	0	0	34	0	0
19	28281351	.	T	G	18	19	37	0	0	37	0	0
19	28283749	.	C	T	5	31	36	0	22	58	0	0
19	28283786	.	C	T	28	27	55	0	2	57	0	0
19	28284146	.	T	A	6	6	12	0	0	12	0	0
19	28284203	.	A	T	13	16	29	0	2	31	0	0
19	28284220	.	T	A	15	13	28	0	1	29	0	0
19	28288148	.	C	T	17	13	30	0	0	30	0	0
19	28288480	.	G	A	11	5	16	0	2	18	0	0
19	28288489	.	C	T	10	7	17	0	0	17	0	0
19	28359920	.	G	A	13	10	23	0	1	24	0	0
19	28360028	.	T	G	15	14	29	0	2	31	0	0
19	28360029	.	C	T	14	15	29	0	2	31	0	0
19	28787154	.	C	T	20	17	37	0	2	39	0	0
19	28788220	.	A	G	15	9	24	0	2	26	0	0
19	28788430	.	T	A	15	20	35	0	3	38	0	0
19	28802039	.	A	G	4	3	7	0	1	8	0	0
19	28802954	.	C	A	10	17	27	0	6	33	0	0
19	28803173	.	G	A	21	16	37	0	1	38	0	0
19	28803267	.	G	A	3	14	17	1	17	35	0	0
19	28820643	.	C	T	19	20	39	0	0	39	0	0
19	28821230	.	G	A	4	11	15	0	0	15	0	0
19	28821333	.	G	A	1	18	19	0	14	33	0	0
19	28821334	.	G	T	14	18	32	0	1	33	0	0
19	28821383	.	A	C	7	14	21	0	0	21	0	0
19	28821666	.	G	C	16	16	32	0	0	32	0	0
19	28822057	.	T	C	22	6	28	0	0	28	0	0
19	28822187	.	C	T	9	10	19	0	5	24	0	0
19	28822521	.	A	G	11	5	16	0	0	16	0	0
19	28822794	.	A	T	5	2	7	0	0	7	0	0
19	28823124	.	C	T	3	5	8	0	0	8	0	0
19	28823162	.	T	C	1	8	9	0	0	9	0	0
19	28823385	.	A	T	8	7	15	0	2	17	0	0
19	29275205	.	T	C	1	1	2	0	0	2	0	0
19	29275211	.	A	G	1	1	2	0	1	3	0	0
19	29297366	.	C	G	4	2	6	0	0	6	0	0
19	29298659	.	C	A	1	0	1	0	0	2	1	0
19	29298942	.	A	C	2	2	4	0	0	4	0	0
19	29303871	.	A	C	2	2	4	0	0	4	0	0
19	29310226	.	G	A	0	5	5	1	1	7	0	0
19	29327825	.	A	G	8	0	8	0	5	13	0	0
19	29333382	.	C	T	3	9	12	0	0	12	0	0
19	29333400	.	C	A	9	1	10	0	1	11	0	0
19	29333418	.	G	T	7	2	9	0	0	9	0	0
19	29333565	.	G	A	9	4	13	0	0	13	0	0
19	29333597	.	A	C	3	5	8	0	0	8	0	0
19	29337897	.	A	T	3	3	6	0	1	7	0	0
19	29383644	.	C	T	1	9	10	0	9	19	0	0
19	29383675	.	G	C	7	10	17	2	1	20	0	0
19	29799885	.	C	T	36	44	80	0	7	87	0	0
19	29799900	.	T	C	40	31	71	0	11	82	0	0
19	29800229	.	A	G	43	29	72	0	4	76	0	0
19	29812799	.	G	T	1	13	14	0	8	22	0	0
19	29815096	.	T	C	34	21	55	0	4	59	0	0
19	29817914	.	C	G	38	20	58	0	2	60	0	0
19	29818142	.	C	T	26	22	48	0	6	54	0	0
19	29822615	.	C	T	1	15	16	0	16	32	0	0
19	29830215	.	G	A	19	19	38	0	0	38	0	0
19	29836645	.	T	C	5	0	5	0	7	12	0	0
19	29836779	.	A	G	5	3	8	0	1	9	0	0
19	29836821	.	T	G	6	5	11	0	0	11	0	0
19	29837134	.	C	T	1	4	5	0	0	5	0	0
19	29837310	.	A	G	3	4	7	0	1	8	0	0
19	29837371	.	G	T	4	5	9	0	0	9	0	0
19	29837380	.	A	G	5	4	9	0	0	9	0	0
19	29837619	.	T	A	3	3	6	0	0	6	0	0
19	29837705	.	C	T	1	4	5	0	4	9	0	0
19	29837964	.	C	T	5	9	14	0	2	16	0	0
19	29840445	.	C	G	1	5	6	0	2	8	0	0
19	29861961	.	C	A	0	4	4	0	9	13	0	0
19	29866548	.	G	T	2	3	5	0	0	5	0	0
19	29866559	.	G	A	3	2	5	0	0	5	0	0
19	29866630	.	C	T	2	6	8	0	2	10	0	0
19	29866882	.	G	A	3	4	7	0	1	8	0	0
19	29866918	.	G	A	3	2	5	0	0	5	0	0
19	30348804	.	G	A	22	14	36	0	7	43	0	0
19	30349310	.	A	T	16	15	31	0	2	33	0	0
19	30349553	.	C	G	0	7	7	0	14	21	0	0
19	30355383	.	T	C	17	15	32	0	0	32	0	0
19	30355907	.	A	T	14	9	23	0	1	24	0	0
19	30388080	.	G	T	2	2	4	0	0	4	0	0
19	30388091	.	C	T	5	2	7	0	0	7	0	0
19	30393919	.	C	A	7	5	12	0	1	13	0	0
19	30396440	.	T	G	21	0	21	0	7	28	0	0
19	30396777	.	C	T	15	19	34	0	2	37	1	0
19	30398392	.	T	C	15	8	23	0	2	25	0	0
19	30398395	.	T	C	14	7	21	0	2	23	0	0
19	30398632	.	T	C	5	4	9	0	0	9	0	0
19	30398763	.	T	G	3	3	6	0	0	6	0	0
19	30398909	.	T	C	2	8	10	0	0	10	0	0
19	30399047	.	A	T	9	4	13	0	0	13	0	0
19	30410519	.	C	A	15	11	26	0	3	29	0	0
19	30413354	.	G	A	11	20	31	0	1	32	0	0
19	30414279	.	G	A	4	7	11	0	1	12	0	0
19	30423199	.	A	T	8	4	12	0	0	12	0	0
19	30423209	.	A	G	7	4	11	0	0	11	0	0
19	30423366	.	A	G	5	8	13	0	0	13	0	0
19	30423368	.	G	A	6	8	14	0	0	14	0	0
19	30425616	.	G	T	8	4	12	0	0	12	0	0
19	30426436	.	C	A	13	4	17	0	1	18	0	0
19	30432697	.	A	G	9	10	19	0	2	21	0	0
19	30434753	.	A	G	9	6	15	0	1	16	0	0
19	30434939	.	C	T	11	9	20	0	0	20	0	0
19	30436629	.	G	A	11	5	16	0	0	16	0	0
19	30436825	.	A	G	7	5	12	0	0	12	0	0
19	30436891	.	G	A	9	4	13	0	0	13	0	0
19	30438496	.	G	A	4	6	10	0	0	10	0	0
19	30439733	.	C	T	2	9	11	0	0	11	0	0
19	30439754	.	C	T	3	12	15	0	0	15	0	0
19	30441396	.	A	G	6	3	9	0	0	9	0	0
19	30442717	.	C	A	6	4	10	0	0	10	0	0
19	30445915	.	C	A	3	3	6	0	1	7	0	0
19	30445927	.	A	G	5	4	9	0	0	9	0	0
19	30446181	.	T	A	2	5	7	1	0	8	0	0
19	30446552	.	T	C	2	2	4	1	0	5	0	0
19	30446567	.	G	T	2	4	6	0	0	6	0	0
19	30447533	.	C	T	7	3	10	0	0	10	0	0
19	30450302	.	T	C	3	3	6	0	1	7	0	0
19	30457648	.	C	T	5	3	8	0	0	8	0	0
19	30457770	.	A	T	3	6	9	0	0	9	0	0
19	30457811	.	C	A	5	4	9	0	0	9	0	0
19	30458121	.	C	T	6	4	10	0	0	10	0	0
19	30460936	.	T	A	5	7	12	0	0	12	0	0
19	30460953	.	C	T	3	6	9	0	0	9	0	0
19	30463210	.	G	C	5	6	11	0	1	12	0	0
19	30481692	.	T	C	16	0	16	0	9	25	0	0
19	30481799	.	T	A	14	11	25	0	0	25	0	0
19	30485029	.	G	A	18	15	33	0	0	33	0	0
19	30485085	.	T	C	14	11	25	0	0	25	0	0
19	30485247	.	T	G	6	9	15	0	1	16	0	0
19	30485253	.	A	G	6	9	15	0	0	15	0	0
19	30495908	.	C	T	3	5	8	0	0	8	0	0
19	30506619	.	C	T	2	2	4	0	1	5	0	0
19	30518480	.	T	A	14	29	43	0	3	46	0	0
19	30518646	.	A	C	17	29	46	0	8	54	0	0
19	30518906	.	A	G	18	18	36	0	2	38	0	0
19	30518973	.	C	T	27	20	47	1	2	50	0	0
19	30519319	.	A	G	8	8	16	0	1	17	0	0
19	30519324	.	C	T	12	10	22	0	0	22	0	0
19	30519459	.	T	A	7	11	18	0	1	19	0	0
19	30519510	.	T	C	3	5	8	0	0	8	0	0
19	30519802	.	C	T	14	16	30	0	2	32	0	0
19	30519803	.	T	G	11	17	28	0	3	31	0	0
19	30519858	.	A	G	9	17	26	0	3	29	0	0
19	30520061	.	T	G	15	12	27	0	0	27	0	0
19	30520214	.	C	T	16	21	37	0	2	39	0	0
19	30520337	.	A	G	19	12	31	0	3	34	0	0
19	30520419	.	G	A	15	20	35	0	0	35	0	0
19	30520431	.	C	G	10	19	29	0	1	30	0	0
19	30520567	.	T	A	21	15	36	0	2	38	0	0
19	30520569	.	T	A	20	16	36	0	2	38	0	0
19	30521256	.	G	A	3	9	12	0	1	13	0	0
19	30522182	.	T	C	6	12	18	0	0	18	0	0
19	30589376	.	T	G	1	0	1	0	8	9	0	0
19	30669930	.	A	G	18	9	27	0	3	30	0	0
19	30672935	.	T	C	21	21	42	0	1	43	0	0
19	30673004	.	T	A	25	21	46	0	3	49	0	0
19	30676543	.	G	A	24	22	46	0	1	47	0	0
19	30676699	.	C	T	22	21	43	0	0	43	0	0
19	30681938	.	G	A	3	19	22	0	19	41	0	0
19	30682680	.	G	A	28	37	65	1	0	66	0	0
19	30682781	.	C	A	27	27	54	0	2	56	0	0
19	30682947	.	A	G	22	23	45	0	4	49	0	0
19	30683129	.	A	C	30	25	55	0	1	56	0	0
19	30683395	.	A	T	31	21	52	0	1	53	0	0
19	30722979	.	C	T	3	5	8	0	0	8	0	0
19	30723172	.	C	T	8	5	13	0	0	13	0	0
19	30723251	.	A	T	3	5	8	0	2	10	0	0
19	30723308	.	T	C	7	0	7	0	4	11	0	0
19	30723554	.	C	G	1	2	3	0	0	3	0	0
19	30723675	.	A	T	6	5	11	0	0	11	0	0
19	30723691	.	G	A	6	3	9	0	0	9	0	0
19	30755362	.	C	A	1	3	4	0	0	4	0	0
19	30757713	.	A	G	2	6	8	0	1	9	0	0
19	30805698	.	C	G	13	7	20	0	1	21	0	0
19	30805886	.	A	C	5	12	17	0	0	17	0	0
19	30806957	.	C	A	4	5	9	0	1	10	0	0
19	30807557	.	A	G	11	6	17	0	0	17	0	0
19	30810911	.	A	T	1	3	4	0	1	5	0	0
19	30810916	.	T	G	1	4	5	0	0	5	0	0
19	30810958	.	T	C	3	3	6	0	0	6	0	0
19	30868063	.	C	G	2	2	4	0	1	5	0	0
19	30876669	.	G	A	1	4	5	0	0	5	0	0
19	30878424	.	G	A	1	3	4	0	0	4	0	0
19	30878688	.	C	T	4	4	8	0	0	8	0	0
19	30880083	.	C	G	4	2	6	0	0	6	0	0
19	30882576	.	G	T	5	6	11	0	0	11	0	0
19	30882688	.	T	C	11	3	14	0	0	14	0	0
19	30882743	.	G	A	5	4	9	1	0	10	0	0
19	30882973	.	A	T	11	10	21	0	0	21	0	0
19	30883224	.	C	T	8	6	14	0	0	14	0	0
19	30883298	.	G	A	7	11	18	0	0	18	0	0
19	30883302	.	G	A	8	10	18	0	0	18	0	0
19	30883476	.	A	T	7	6	13	0	1	14	0	0
19	30883549	.	T	C	9	4	13	0	2	15	0	0
19	30894883	.	G	A	10	10	20	0	1	21	0	0
19	30894980	.	A	G	9	12	21	0	0	21	0	0
19	30895163	.	G	A	5	6	11	0	0	11	0	0
19	30897438	.	T	C	4	0	4	0	6	10	0	0
19	30897545	.	T	A	1	3	4	0	0	4	0	0
19	30897585	.	A	C	1	5	6	0	1	7	0	0
19	30897916	.	C	A	3	7	10	0	0	10	0	0
19	30898050	.	C	T	3	4	7	0	1	8	0	0
19	30997246	.	C	A	2	2	4	0	1	5	0	0
19	30997247	.	A	C	3	2	5	0	0	5	0	0
19	30999947	.	T	C	6	0	6	0	7	13	0	0
19	31000077	.	C	T	1	10	11	0	8	19	0	0
19	31000207	.	T	C	12	15	27	0	1	28	0	0
19	31001318	.	T	G	7	8	15	0	0	15	0	0
19	31001417	.	A	G	7	12	19	0	1	20	0	0
19	31003330	.	A	T	8	5	13	0	0	13	0	0
19	31010033	.	A	C	16	13	29	0	0	29	0	0
19	31010061	.	T	A	10	17	27	0	1	28	0	0
19	31012900	.	G	A	16	9	25	0	0	25	0	0
19	31016410	.	A	T	12	13	25	0	2	27	0	0
19	31016458	.	C	A	12	11	23	0	1	24	0	0
19	31042572	.	C	G	1	3	4	0	1	5	0	0
19	31340089	.	G	A	3	9	12	0	1	13	0	0
19	31340777	.	A	G	4	4	8	0	1	9	0	0
19	31340882	.	C	G	1	3	4	0	6	10	0	0
19	31341000	.	C	T	8	6	14	0	1	15	0	0
19	31341829	.	C	T	3	3	6	0	1	7	0	0
19	31392375	.	C	T	11	4	15	0	0	15	0	0
19	31392700	.	G	A	11	17	28	0	0	28	0	0
19	31392803	.	C	T	1	11	12	0	10	22	0	0
19	31394550	.	A	G	6	8	14	0	0	14	0	0
19	31398961	.	A	G	2	3	5	0	0	5	0	0
19	31398979	.	A	G	1	2	3	0	0	3	0	0
19	31402418	.	T	C	6	8	14	0	1	15	0	0
19	31416787	.	G	A	1	4	5	0	0	5	0	0
19	31424215	.	C	G	2	0	2	0	3	5	0	0
19	31431021	.	T	C	6	7	13	0	1	14	0	0
19	31437956	.	A	G	7	8	15	0	2	17	0	0
19	31437974	.	G	A	10	10	20	0	0	20	0	0
19	31438009	.	G	T	7	7	14	2	0	16	0	0
19	31438016	.	T	C	6	0	6	2	8	16	0	0
19	31449834	.	T	G	18	15	33	0	1	34	0	0
19	31455562	.	T	C	9	11	20	0	2	22	0	0
19	31461620	.	C	G	3	6	9	0	3	12	0	0
19	31789533	.	C	G	5	10	15	0	21	36	0	0
19	31798031	.	T	A	1	6	7	0	0	7	0	0
19	31938681	.	A	G	10	2	12	0	0	12	0	0
19	32050593	.	A	T	12	14	26	0	2	28	0	0
19	33772298	.	A	C	7	0	7	0	12	19	0	0
19	33836605	.	G	A	11	4	15	0	0	15	0	0
19	33837007	.	G	T	22	8	30	0	1	31	0	0
19	33837183	.	G	A	27	3	30	0	1	31	0	0
19	33839595	.	G	A	15	4	19	0	1	20	0	0
19	33847935	.	A	T	10	6	16	0	0	16	0	0
19	33858734	.	A	G	1	3	4	0	0	4	0	0
19	33868335	.	T	C	3	3	6	0	0	6	0	0
19	33871868	.	C	T	3	6	9	0	1	10	0	0
19	33872816	.	T	G	7	9	16	0	0	16	0	0
19	33872859	.	G	A	1	7	8	0	7	15	0	0
19	33876062	.	C	G	2	0	2	0	7	9	0	0
19	33888520	.	A	C	26	22	48	0	4	52	0	0
19	33888881	.	T	G	29	23	52	0	5	57	0	0
19	33902586	.	G	A	13	8	21	0	1	22	0	0
19	33915802	.	C	T	5	6	11	0	2	13	0	0
19	33921715	.	A	G	9	10	19	0	1	20	0	0
19	33956909	.	C	T	11	4	15	0	0	15	0	0
19	33960517	.	G	A	5	7	12	0	1	13	0	0
19	33963773	.	G	T	6	4	10	0	0	10	0	0
19	33964282	.	G	A	3	2	5	0	1	6	0	0
19	33964353	.	A	G	5	4	9	0	0	9	0	0
19	33993507	.	C	T	4	1	5	0	1	6	0	0
19	33996170	.	G	A	3	3	6	0	0	6	0	0
19	34074028	.	G	A	10	8	18	0	0	18	0	0
19	34074072	.	A	G	9	5	14	0	4	18	0	0
19	34074386	.	T	G	14	7	21	0	1	22	0	0
19	34081003	.	A	G	9	12	21	0	1	22	0	0
19	34089132	.	T	G	6	5	11	0	1	12	0	0
19	34091772	.	A	G	1	1	2	0	1	3	0	0
19	34217866	.	T	C	1	2	3	0	0	3	0	0
19	34217867	.	G	A	1	2	3	0	0	3	0	0
19	34691678	.	T	C	1	0	1	0	2	3	0	0
19	34696829	.	T	A	2	6	8	0	0	8	0	0
19	34696921	.	C	T	4	6	10	0	0	10	0	0
19	34698294	.	G	A	2	5	7	0	0	7	0	0
19	34698321	.	A	T	2	4	6	0	0	6	0	0
19	34716569	.	C	T	1	2	3	0	2	5	0	0
19	34740911	.	A	C	1	2	3	0	0	3	0	0
19	34744060	.	T	G	7	4	11	0	0	11	0	0
19	34744231	.	T	C	5	6	11	0	2	13	0	0
19	34744288	.	C	A	13	5	18	0	0	18	0	0
19	34746659	.	G	A	7	8	15	0	0	15	0	0
19	34746810	.	T	G	3	4	7	0	0	7	0	0
19	34746826	.	G	A	3	4	7	0	0	7	0	0
19	34960061	.	A	T	5	8	13	0	1	14	0	0
19	34960099	.	A	G	8	5	13	0	1	14	0	0
19	34960143	.	A	G	10	6	16	0	1	17	0	0
19	34960147	.	G	A	10	7	17	0	0	17	0	0
19	34960190	.	C	G	1	6	7	0	18	25	0	0
19	34960198	.	T	C	18	8	26	0	2	28	0	0
19	34960315	.	T	A	7	10	17	0	1	18	0	0
19	34960574	.	A	G	9	1	10	0	0	10	0	0
19	34960694	.	T	A	4	5	9	0	1	10	0	0
19	34961152	.	C	T	5	7	12	0	1	13	0	0
19	34961269	.	A	G	2	4	6	0	0	6	0	0
19	35002450	.	G	A	2	4	6	0	0	6	0	0
19	35002527	.	G	A	0	4	4	0	2	6	0	0
19	35002714	.	A	C	3	6	9	0	0	9	0	0
19	35002723	.	T	C	3	6	9	0	0	9	0	0
19	35004117	.	A	C	2	7	9	0	0	9	0	0
19	35004135	.	C	T	1	6	7	0	1	8	0	0
19	35004868	.	C	A	3	2	5	0	0	5	0	0
19	35004869	.	C	A	3	2	5	0	0	5	0	0
19	35004920	.	G	A	7	3	10	0	0	10	0	0
19	35004941	.	T	C	8	4	12	0	1	13	0	0
19	35005318	.	G	A	10	11	21	0	4	25	0	0
19	35007021	.	G	A	1	3	4	0	4	8	0	0
19	35007220	.	G	A	18	16	34	0	0	34	0	0
19	35007235	.	G	A	18	17	35	0	0	35	0	0
19	35013166	.	G	T	7	3	10	0	0	10	0	0
19	35013806	.	C	T	22	26	48	0	1	49	0	0
19	35016477	.	C	T	24	14	38	0	3	41	0	0
19	35016553	.	T	G	20	14	34	0	1	35	0	0
19	35016646	.	A	T	22	10	32	0	5	37	0	0
19	35016696	.	T	G	11	19	30	0	1	31	0	0
19	35016835	.	C	T	13	7	20	0	1	21	0	0
19	35016962	.	T	A	7	8	15	0	0	15	0	0
19	35019339	.	C	A	1	2	3	0	0	3	0	0
19	35019490	.	T	A	1	5	6	0	0	6	0	0
19	35040003	.	G	T	2	6	8	0	4	12	0	0
19	35041158	.	T	A	39	14	53	0	5	58	0	0
19	35041308	.	A	G	24	25	49	0	2	51	0	0
19	35041458	.	T	C	19	0	19	0	31	50	0	0
19	35052411	.	G	T	11	16	27	0	1	28	0	0
19	35052435	.	T	C	12	1	13	0	13	26	0	0
19	35055889	.	A	G	15	16	31	0	1	32	0	0
19	35057860	.	G	T	9	13	22	0	1	23	0	0
19	35057869	.	C	T	13	13	26	0	0	26	0	0
19	35058232	.	T	C	20	14	34	0	1	35	0	0
19	35060217	.	A	C	9	13	22	0	1	23	0	0
19	35065906	.	A	T	5	10	15	0	2	17	0	0
19	35067367	.	G	A	6	9	15	0	0	15	0	0
19	35069299	.	G	T	8	10	18	0	0	18	0	0
19	35069755	.	C	A	13	9	22	0	2	24	0	0
19	35069934	.	T	G	9	4	13	0	0	13	0	0
19	35070015	.	C	T	10	10	20	0	0	20	0	0
19	35072613	.	A	C	14	11	25	0	0	25	0	0
19	35072712	.	G	C	9	0	9	0	7	16	0	0
19	35075637	.	C	T	2	6	8	0	8	16	0	0
19	35076301	.	C	T	0	7	7	0	4	11	0	0
19	35076773	.	G	A	3	3	6	0	1	7	0	0
19	35078584	.	T	C	4	0	4	0	9	13	0	0
19	35078632	.	T	C	6	0	6	0	5	11	0	0
19	35079259	.	C	T	2	4	6	0	0	6	0	0
19	35079515	.	A	T	3	4	7	0	0	7	0	0
19	35083010	.	G	A	3	4	7	0	2	9	0	0
19	35083019	.	C	T	4	5	9	0	0	9	0	0
19	35083182	.	C	T	4	4	8	0	0	8	0	0
19	35116228	.	A	G	4	3	7	0	0	7	0	0
19	35116297	.	T	C	3	3	6	0	1	7	0	0
19	35116405	.	A	G	4	3	7	0	0	7	0	0
19	35116438	.	G	A	4	6	10	0	0	10	0	0
19	35118842	.	T	C	3	2	5	0	1	6	0	0
19	35118860	.	G	T	4	2	6	0	0	6	0	0
19	35118911	.	C	A	4	3	7	0	0	7	0	0
19	35119039	.	T	C	1	2	3	0	0	3	0	0
19	35119052	.	A	G	1	2	3	0	1	4	0	0
19	35119205	.	G	A	2	4	6	0	0	6	0	0
19	35119436	.	C	T	4	4	8	0	0	8	0	0
19	35121381	.	T	C	2	3	5	0	0	5	0	0
19	35123452	.	A	T	1	2	3	0	0	3	0	0
19	35134092	.	G	T	1	2	3	0	0	3	0	0
19	35134181	.	G	A	1	3	4	0	0	4	0	0
19	35159665	.	G	T	4	3	7	0	0	7	0	0
19	35159668	.	G	A	4	1	5	0	0	5	0	0
19	35159721	.	A	G	2	3	5	0	0	5	0	0
19	35359341	.	C	T	29	30	59	0	1	60	0	0
19	35379998	.	A	G	1	3	4	0	1	5	0	0
19	35380031	.	G	A	1	3	4	0	0	4	0	0
19	35419202	.	A	G	4	2	6	0	0	6	0	0
19	35419215	.	T	A	3	2	5	0	0	5	0	0
19	35419292	.	T	A	2	4	6	0	2	8	0	0
19	35419300	.	A	T	2	3	5	0	0	5	0	0
19	35422354	.	T	C	5	18	23	0	1	24	0	0
19	35428735	.	G	A	7	18	25	0	0	26	1	0
19	35459414	.	A	G	23	15	38	0	7	45	0	0
19	35459737	.	G	A	23	20	43	0	0	43	0	0
19	35459801	.	A	T	17	23	40	0	0	40	0	0
19	35473080	.	C	A	2	10	12	0	19	31	0	0
19	35849232	.	A	G	2	0	2	0	2	4	0	0
19	36115044	.	G	A	6	2	8	0	1	9	0	0
19	36115210	.	G	A	4	7	11	0	0	11	0	0
19	36120265	.	C	T	0	4	4	0	2	6	0	0
19	36122534	.	C	T	7	7	14	0	0	14	0	0
19	36131818	.	G	A	2	2	4	0	1	5	0	0
19	36139613	.	C	T	3	3	6	0	0	6	0	0
19	37133533	.	C	A	7	2	9	0	1	11	1	0
19	37133825	.	G	A	3	5	8	0	0	8	0	0
19	37135759	.	G	A	5	2	7	0	0	7	0	0
19	37138388	.	G	A	0	7	7	0	18	25	0	0
19	37138643	.	G	A	2	17	19	0	12	31	0	0
19	37138743	.	C	T	9	10	19	1	0	20	0	0
19	37138769	.	G	A	9	6	15	1	0	18	2	0
19	37138955	.	A	G	13	11	24	0	0	24	0	0
19	37153949	.	G	A	1	2	3	0	0	3	0	0
19	37481628	.	C	A	1	1	2	0	1	3	0	0
19	37481658	.	C	T	1	3	4	0	0	4	0	0
19	37484508	.	A	C	3	3	6	0	0	6	0	0
19	37488593	.	C	T	3	3	6	0	0	6	0	0
19	37492351	.	G	A	2	6	8	0	0	8	0	0
19	37492514	.	A	T	3	3	6	0	0	6	0	0
19	37501935	.	A	G	18	22	40	0	3	43	0	0
19	37502105	.	A	G	29	26	55	0	6	61	0	0
19	37505808	.	G	A	9	6	15	0	1	16	0	0
19	37802904	.	A	G	3	0	3	0	3	6	0	0
19	37835367	.	G	A	2	3	5	0	0	5	0	0
19	37835433	.	A	C	2	3	5	0	0	5	0	0
19	37835502	.	A	G	5	1	6	0	1	7	0	0
19	37835508	.	T	C	4	2	6	0	1	7	0	0
19	37858144	.	G	C	6	4	10	0	1	11	0	0
19	37926003	.	C	T	20	18	38	0	1	39	0	0
19	37926066	.	C	A	12	17	29	0	2	31	0	0
19	37926653	.	A	T	9	12	21	0	3	24	0	0
19	37926666	.	C	A	12	13	25	0	0	25	0	0
19	37926816	.	T	G	20	24	44	0	3	47	0	0
19	37926865	.	G	A	31	16	47	0	0	47	0	0
19	37927304	.	G	T	0	22	22	0	9	31	0	0
19	38175515	.	G	C	1	3	4	0	1	5	0	0
19	38216247	.	A	G	5	3	8	0	0	8	0	0
19	38227086	.	T	G	7	3	10	1	1	12	0	0
19	38240541	.	A	G	3	0	3	0	5	8	0	0
19	38240844	.	C	T	3	2	5	0	0	5	0	0
19	38327186	.	T	C	3	2	5	0	0	5	0	0
19	38327377	.	A	T	2	3	5	0	0	5	0	0
19	38327459	.	C	T	2	2	4	0	1	5	0	0
19	38434994	.	C	A	1	2	3	0	0	3	0	0
19	38454026	.	T	C	1	2	3	0	1	4	0	0
19	38464589	.	C	T	2	3	5	0	0	5	0	0
19	38473901	.	G	T	1	3	4	0	0	4	0	0
19	40026661	.	T	C	14	12	26	0	3	29	0	0
19	40031002	.	G	A	24	35	59	0	6	65	0	0
19	40039603	.	G	A	10	19	29	0	0	29	0	0
19	40039606	.	T	A	10	18	28	0	1	29	0	0
19	40053055	.	A	G	19	0	19	0	30	49	0	0
19	40053061	.	A	T	17	31	48	0	3	51	0	0
19	40055030	.	A	G	14	28	42	0	2	44	0	0
19	40055305	.	A	G	13	0	13	0	7	20	0	0
19	40055318	.	A	G	16	8	24	0	1	25	0	0
19	40096548	.	G	A	3	4	7	0	0	7	0	0
19	40099478	.	G	A	1	1	2	0	1	3	0	0
19	40101840	.	G	A	4	4	8	0	0	8	0	0
19	40102040	.	A	C	5	5	10	0	0	10	0	0
19	40110840	.	G	A	1	5	6	0	7	13	0	0
19	40113305	.	G	A	1	12	13	0	13	26	0	0
19	40113425	.	C	A	7	7	14	0	1	15	0	0
19	40113549	.	T	G	5	5	10	0	0	10	0	0
19	40113677	.	C	G	8	6	14	0	1	15	0	0
19	40113692	.	G	T	7	6	13	0	0	13	0	0
19	40129387	.	A	T	1	4	5	0	2	7	0	0
19	40145423	.	C	T	3	2	5	0	0	5	0	0
19	40145888	.	G	A	4	3	7	0	0	7	0	0
19	40146215	.	G	A	0	2	2	0	5	7	0	0
19	40147821	.	G	A	0	5	5	0	6	11	0	0
19	40151970	.	G	A	3	5	8	0	1	9	0	0
19	40151983	.	C	T	3	5	8	0	0	8	0	0
19	40152569	.	G	A	4	5	9	0	0	9	0	0
19	40155144	.	C	A	4	8	12	0	1	13	0	0
19	40156870	.	T	C	12	6	18	0	0	18	0	0
19	40160049	.	T	C	19	10	29	0	0	29	0	0
19	40162945	.	C	A	11	10	21	0	6	27	0	0
19	40163256	.	C	T	12	18	30	0	0	30	0	0
19	40165405	.	A	G	21	16	37	0	1	38	0	0
19	40165681	.	A	G	7	0	7	0	5	12	0	0
19	40177406	.	G	T	0	3	3	0	5	8	0	0
19	40177762	.	T	C	7	4	11	0	0	11	0	0
19	40179763	.	G	A	0	2	2	0	7	9	0	0
19	40180011	.	C	T	6	4	10	0	0	10	0	0
19	40180100	.	A	G	4	7	11	0	0	11	0	0
19	40182571	.	T	A	2	2	4	0	0	4	0	0
19	40182574	.	C	T	1	2	3	0	0	3	0	0
19	40190997	.	A	C	1	0	1	0	3	4	0	0
19	40340319	.	A	G	12	13	25	0	2	27	0	0
19	40344730	.	A	C	25	13	38	0	1	39	0	0
19	40345966	.	G	T	24	21	45	0	3	48	0	0
19	40347600	.	T	G	13	0	13	0	18	31	0	0
19	40347702	.	T	A	23	20	43	0	3	46	0	0
19	40347760	.	T	A	31	11	42	0	2	44	0	0
19	40347785	.	A	T	27	7	34	1	2	37	0	0
19	40347842	.	G	T	0	8	8	1	3	12	0	0
19	40558221	.	C	T	1	5	6	0	0	6	0	0
19	40563396	.	C	T	2	5	7	0	0	7	0	0
19	40641356	.	C	G	4	0	4	0	5	9	0	0
19	40641379	.	A	G	3	2	5	0	1	6	0	0
19	40685447	.	A	G	7	1	8	0	6	14	0	0
19	40685518	.	G	A	1	3	4	0	5	9	0	0
19	40685520	.	T	C	5	2	7	0	1	8	0	0
19	40685664	.	A	G	4	5	9	0	2	11	0	0
19	40685845	.	G	A	3	4	7	0	1	8	0	0
19	40685875	.	G	A	4	6	10	0	0	10	0	0
19	40685935	.	A	G	5	4	9	0	1	10	0	0
19	40686662	.	T	A	8	3	11	0	1	12	0	0
19	40716977	.	T	C	3	3	6	0	0	6	0	0
19	40717209	.	T	A	5	4	9	0	1	10	0	0
19	40717649	.	C	A	7	5	12	0	1	13	0	0
19	40892312	.	T	C	7	6	13	0	0	13	0	0
19	40895763	.	G	A	11	11	22	0	2	24	0	0
19	40895826	.	T	C	12	10	22	0	0	22	0	0
19	40898468	.	C	T	9	9	18	0	1	19	0	0
19	40900059	.	T	A	6	7	13	0	0	13	0	0
19	40903335	.	G	A	7	6	13	0	1	14	0	0
19	40906094	.	G	A	8	9	17	0	0	17	0	0
19	40995653	.	A	T	1	2	3	0	0	3	0	0
19	41031941	.	G	A	0	13	13	0	9	22	0	0
19	41033898	.	C	T	16	16	32	0	1	33	0	0
19	41038728	.	T	A	1	2	3	0	0	3	0	0
19	41038942	.	C	A	23	22	45	0	2	47	0	0
19	41039012	.	G	C	25	2	27	0	36	63	0	0
19	41052229	.	G	A	31	15	46	0	5	51	0	0
19	41054464	.	T	C	19	0	19	1	23	43	0	0
19	41057049	.	C	A	21	20	41	0	5	46	0	0
19	41057079	.	G	A	16	17	33	0	1	34	0	0
19	41060384	.	C	T	2	10	12	0	8	20	0	0
19	41081198	.	T	C	2	2	4	0	0	4	0	0
19	41160117	.	G	A	1	2	3	0	0	3	0	0
19	41160202	.	A	T	3	3	6	0	0	6	0	0
19	41401637	.	C	A	9	11	20	0	3	23	0	0
19	41401727	.	C	T	0	13	13	0	6	19	0	0
19	41401878	.	G	A	12	11	23	0	1	24	0	0
19	41401926	.	A	G	21	8	29	0	2	31	0	0
19	41401928	.	G	A	24	8	32	0	0	32	0	0
19	41404250	.	G	A	29	25	54	0	2	56	0	0
19	41404273	.	C	T	3	28	31	0	29	60	0	0
19	41447257	.	A	G	3	4	7	0	1	8	0	0
19	41447420	.	A	G	4	2	6	0	0	6	0	0
19	41447427	.	A	G	5	3	8	0	0	8	0	0
19	41447548	.	A	G	6	3	9	0	0	9	0	0
19	41447600	.	G	T	3	2	5	0	2	7	0	0
19	41448040	.	G	A	6	4	10	0	0	10	0	0
19	41448047	.	G	T	8	4	12	0	0	12	0	0
19	41466725	.	T	C	3	5	8	0	0	8	0	0
19	41466726	.	G	A	3	4	7	0	1	8	0	0
19	41466777	.	G	A	1	6	7	0	8	15	0	0
19	41466783	.	T	C	9	6	15	0	0	15	0	0
19	41516139	.	T	G	8	4	12	0	1	13	0	0
19	41516204	.	G	T	13	3	16	0	1	17	0	0
19	41516209	.	A	C	13	0	13	0	4	17	0	0
19	41516281	.	C	A	6	2	8	0	0	8	0	0
19	41533987	.	A	T	2	2	4	0	0	4	0	0
19	41533991	.	A	T	2	4	6	0	0	6	0	0
19	41534035	.	G	C	1	2	3	0	0	3	0	0
19	41537398	.	A	C	2	3	5	0	0	5	0	0
19	41537442	.	G	A	2	2	4	0	0	4	0	0
19	41538932	.	G	A	1	2	3	0	2	5	0	0
19	41539133	.	C	T	3	2	5	0	0	5	0	0
19	41539216	.	A	T	2	2	4	0	0	4	0	0
19	41539346	.	G	C	4	2	6	0	0	6	0	0
19	41539467	.	T	C	2	2	4	0	1	5	0	0
19	41539606	.	T	C	3	6	9	0	0	9	0	0
19	41539708	.	G	C	5	3	8	1	0	9	0	0
19	41539821	.	G	T	4	2	6	0	0	6	0	0
19	41539868	.	A	C	3	7	10	0	0	10	0	0
19	41539935	.	G	A	4	2	6	0	0	6	0	0
19	41539962	.	C	A	2	2	4	0	0	4	0	0
19	41540396	.	C	T	1	3	4	0	0	4	0	0
19	41717013	.	G	C	0	4	4	0	3	7	0	0
19	41723561	.	C	T	8	3	11	0	1	12	0	0
19	41724049	.	G	A	1	5	6	0	1	7	0	0
19	41841261	.	C	A	11	7	18	0	0	18	0	0
19	41841824	.	T	C	8	15	23	0	0	23	0	0
19	41846849	.	G	T	9	8	17	0	0	17	0	0
19	41849679	.	A	G	11	10	21	0	1	22	0	0
19	41851698	.	G	T	5	5	10	0	0	10	0	0
19	41853967	.	G	T	16	5	21	0	0	21	0	0
19	41857795	.	G	A	9	5	14	0	0	14	0	0
19	41857846	.	C	T	6	6	12	0	0	12	0	0
19	41860157	.	G	A	5	4	9	0	0	9	0	0
19	41870495	.	G	A	2	2	4	0	0	4	0	0
19	41870515	.	T	A	1	4	5	0	0	5	0	0
19	41882212	.	G	A	2	3	5	0	0	5	0	0
19	41884108	.	A	G	5	4	9	0	0	9	0	0
19	41884129	.	C	T	0	3	3	0	4	7	0	0
19	41884162	.	G	A	2	3	5	0	0	5	0	0
19	41893332	.	A	G	1	2	3	0	0	3	0	0
19	41893335	.	C	T	1	2	3	0	0	3	0	0
19	41902743	.	A	G	3	4	7	0	0	7	0	0
19	42061290	.	C	T	8	6	14	0	0	14	0	0
19	42061441	.	C	G	10	9	19	0	0	19	0	0
19	42061455	.	A	G	10	7	17	0	0	17	0	0
19	42061491	.	C	T	15	9	24	0	0	24	0	0
19	42061521	.	A	G	10	11	21	0	4	25	0	0
19	42061605	.	A	G	15	2	17	0	13	30	0	0
19	42064424	.	G	A	2	2	4	0	0	4	0	0
19	42065010	.	C	T	15	10	25	0	2	27	0	0
19	42066899	.	T	C	18	14	32	0	1	33	0	0
19	42067065	.	T	C	21	9	30	0	1	31	0	0
19	42067149	.	T	C	19	13	32	0	2	34	0	0
19	42068537	.	A	C	21	14	35	0	1	36	0	0
19	42068818	.	A	G	3	2	5	0	0	5	0	0
19	42071867	.	T	A	2	2	4	0	0	4	0	0
19	42117777	.	A	T	14	11	25	0	1	26	0	0
19	42118040	.	T	G	12	12	24	0	4	28	0	0
19	42118441	.	T	A	6	3	9	0	0	9	0	0
19	42235042	.	G	C	3	5	8	0	0	8	0	0
19	42235161	.	G	T	6	8	14	0	0	14	0	0
19	42235205	.	A	G	4	11	15	0	2	17	0	0
19	42235286	.	A	T	5	6	11	0	2	13	0	0
19	42235453	.	T	G	1	2	3	0	1	4	0	0
19	42235655	.	A	C	7	9	16	0	5	21	0	0
19	42241740	.	G	T	8	4	12	0	0	12	0	0
19	42241755	.	G	T	9	4	13	0	1	14	0	0
19	42244118	.	G	A	4	9	13	0	0	13	0	0
19	42328467	.	T	C	11	14	25	0	3	28	0	0
19	42328510	.	C	T	21	21	42	0	0	42	0	0
19	42336375	.	G	A	17	18	35	0	3	38	0	0
19	42336526	.	C	T	30	18	48	0	2	50	0	0
19	42336636	.	C	T	24	20	44	0	4	48	0	0
19	42336675	.	C	T	24	15	39	0	2	41	0	0
19	42340452	.	A	G	10	0	10	0	23	33	0	0
19	42340455	.	C	T	10	22	32	0	3	35	0	0
19	42340508	.	G	C	29	12	41	0	5	46	0	0
19	42340658	.	G	A	5	31	36	0	26	62	0	0
19	42340855	.	G	A	5	23	28	0	22	50	0	0
19	42341530	.	T	C	27	20	47	0	4	51	0	0
19	42341613	.	T	A	19	26	45	1	2	49	1	0
19	42341693	.	G	A	21	24	45	0	1	46	0	0
19	42367500	.	T	A	4	4	8	0	0	8	0	0
19	42367531	.	G	A	4	2	6	0	0	6	0	0
19	42368065	.	C	T	1	5	6	0	3	9	0	0
19	42368511	.	A	C	5	4	9	0	0	9	0	0
19	42368619	.	T	A	8	2	10	0	1	11	0	0
19	42368620	.	T	C	8	0	8	0	4	12	0	0
19	42389797	.	C	T	0	3	3	0	2	5	0	0
19	42389876	.	C	T	0	5	5	0	1	6	0	0
19	42397530	.	A	G	5	10	15	0	1	16	0	0
19	42397975	.	G	A	18	13	31	0	1	32	0	0
19	42400567	.	A	G	18	15	33	1	3	37	0	0
19	42402060	.	G	A	12	14	26	0	2	28	0	0
19	42402382	.	A	G	8	8	16	0	1	17	0	0
19	42458099	.	T	C	15	15	30	1	0	31	0	0
19	42458112	.	T	A	16	16	32	1	0	33	0	0
19	42459868	.	T	A	20	21	41	0	2	43	0	0
19	42491132	.	G	T	9	7	16	0	0	16	0	0
19	42493255	.	C	T	5	11	16	0	0	16	0	0
19	42493353	.	T	A	5	6	11	0	1	12	0	0
19	42493986	.	G	T	7	6	13	0	1	14	0	0
19	42494130	.	T	C	13	0	13	0	9	22	0	0
19	42495678	.	T	G	7	12	19	0	0	19	0	0
19	42495829	.	G	A	6	10	16	0	0	16	0	0
19	42495850	.	G	A	3	5	8	0	1	9	0	0
19	42495901	.	A	G	5	4	9	0	0	9	0	0
19	42498376	.	C	T	5	3	8	0	0	8	0	0
19	42498378	.	A	C	4	3	7	0	0	7	0	0
19	42559818	.	G	T	3	2	5	0	0	5	0	0
19	42569517	.	T	A	3	6	9	0	0	9	0	0
19	42569528	.	C	A	2	5	7	0	0	7	0	0
19	42574042	.	C	A	5	2	7	0	2	9	0	0
19	42574662	.	A	T	1	4	5	0	0	5	0	0
19	42574781	.	C	T	0	2	2	0	1	3	0	0
19	42576742	.	G	A	1	4	5	0	0	5	0	0
19	42612392	.	C	T	2	2	4	0	1	5	0	0
19	42660271	.	G	C	1	2	3	0	0	3	0	0
19	42667987	.	C	T	4	4	8	0	0	8	0	0
19	42678624	.	G	A	0	4	4	0	5	9	0	0
19	42682502	.	A	G	5	6	11	0	1	12	0	0
19	42682504	.	G	A	0	7	7	0	5	12	0	0
19	42682628	.	G	A	11	4	15	0	1	16	0	0
19	42682678	.	C	T	9	2	11	0	1	12	0	0
19	42682699	.	C	A	6	3	9	0	0	9	0	0
19	42720248	.	C	T	2	3	5	0	2	7	0	0
19	42732770	.	G	C	4	3	7	0	0	7	0	0
19	42735350	.	C	A	8	3	11	0	0	11	0	0
19	42740353	.	G	C	7	4	11	0	2	13	0	0
19	42743837	.	G	A	5	5	10	0	2	12	0	0
19	42744744	.	C	T	6	9	15	0	3	18	0	0
19	42747212	.	G	A	1	5	6	0	3	9	0	0
19	42754892	.	C	T	5	9	14	0	3	17	0	0
19	42774755	.	G	A	21	11	32	0	2	34	0	0
19	42791291	.	T	C	21	24	45	0	0	45	0	0
19	42795751	.	A	G	24	34	58	0	3	61	0	0
19	42795799	.	C	T	30	32	62	0	2	64	0	0
19	42798696	.	C	T	27	27	54	0	2	56	0	0
19	42801687	.	G	A	8	24	32	0	30	62	0	0
19	42801708	.	T	A	34	24	58	0	1	59	0	0
19	42802018	.	C	A	36	32	68	0	2	70	0	0
19	42802075	.	T	C	29	30	59	0	3	62	0	0
19	42802077	.	C	T	29	32	61	0	0	61	0	0
19	42806823	.	C	T	1	2	3	0	0	3	0	0
19	42819316	.	C	A	1	5	6	0	1	7	0	0
19	42826201	.	T	C	3	4	7	0	1	8	0	0
19	42835133	.	C	T	4	2	6	0	0	6	0	0
19	42841599	.	A	C	3	5	8	0	1	9	0	0
19	42843642	.	A	G	2	8	10	0	1	11	0	0
19	42843725	.	A	C	8	4	12	0	2	14	0	0
19	42843751	.	A	T	5	8	13	0	2	15	0	0
19	42843894	.	A	G	10	13	23	0	1	24	0	0
19	42843917	.	T	C	12	9	21	0	3	24	0	0
19	42864222	.	G	T	3	4	7	0	0	7	0	0
19	42868330	.	T	C	3	8	11	0	0	11	0	0
19	42868446	.	A	G	5	11	16	0	0	16	0	0
19	42870307	.	T	G	10	0	10	1	7	18	0	0
19	42870512	.	C	T	12	13	25	0	1	26	0	0
19	42872200	.	G	C	15	21	36	0	0	36	0	0
19	42873858	.	G	A	2	12	14	0	10	24	0	0
19	42874075	.	C	G	10	6	16	0	3	19	0	0
19	42874172	.	C	T	14	10	24	0	1	25	0	0
19	42874188	.	A	G	14	0	14	0	10	24	0	0
19	42874231	.	C	T	13	17	30	0	2	32	0	0
19	42874301	.	G	A	16	11	27	1	3	31	0	0
19	42874336	.	G	C	15	10	25	1	1	27	0	0
19	42874414	.	T	C	15	7	22	0	4	26	0	0
19	42874564	.	G	A	7	7	14	0	0	14	0	0
19	42874674	.	A	G	19	13	32	0	1	33	0	0
19	42875103	.	A	T	11	10	21	0	0	21	0	0
19	42896148	.	G	A	0	2	2	0	1	3	0	0
19	42898813	.	C	T	1	3	4	0	0	4	0	0
19	42906166	.	T	C	4	2	6	0	0	6	0	0
19	42906169	.	G	A	0	2	2	0	4	6	0	0
19	42908916	.	T	A	4	4	8	1	0	9	0	0
19	42909168	.	C	T	6	7	13	0	0	13	0	0
19	42912376	.	C	A	11	11	22	0	1	23	0	0
19	42912394	.	G	A	2	12	14	0	8	22	0	0
19	42919465	.	C	T	0	7	7	0	10	17	0	0
19	42928845	.	C	A	2	5	7	0	3	10	0	0
19	42988059	.	C	T	25	35	60	0	1	61	0	0
19	42997087	.	G	A	7	2	9	0	0	9	0	0
19	42997106	.	C	G	6	3	9	0	2	11	0	0
19	42997337	.	C	G	2	3	5	0	0	5	0	0
19	43000034	.	G	C	21	0	21	0	10	31	0	0
19	43000067	.	C	T	13	8	21	0	0	21	0	0
19	43000070	.	A	G	11	7	18	0	0	18	0	0
19	43002605	.	A	C	9	10	19	0	1	20	0	0
19	43004118	.	G	A	6	5	11	0	2	13	0	0
19	43004133	.	T	C	5	5	10	0	0	10	0	0
19	43004221	.	T	G	6	8	14	0	0	14	0	0
19	43004259	.	A	G	9	8	17	0	1	18	0	0
19	43004283	.	T	C	10	5	15	0	2	17	0	0
19	43004297	.	C	A	4	10	14	0	1	15	0	0
19	43009476	.	C	T	7	4	11	0	1	12	0	0
19	43015255	.	A	C	6	4	10	0	0	10	0	0
19	43015276	.	C	A	3	4	7	0	0	7	0	0
19	43016360	.	C	T	1	2	3	0	0	3	0	0
19	43018243	.	T	C	18	10	28	0	4	32	0	0
19	43018257	.	G	A	0	22	22	0	13	35	0	0
19	43018352	.	T	C	14	10	24	0	3	27	0	0
19	43029462	.	G	A	4	23	27	0	26	53	0	0
19	43030654	.	G	A	33	21	54	0	0	54	0	0
19	43030655	.	A	G	33	21	54	0	0	54	0	0
19	43031169	.	G	A	4	22	26	0	17	44	1	0
19	43031261	.	G	A	1	4	5	0	6	11	0	0
19	43031264	.	A	G	9	2	11	0	0	11	0	0
19	43031340	.	G	T	1	2	3	0	0	3	0	0
19	43054736	.	A	G	2	3	5	0	0	5	0	0
19	43054854	.	C	T	5	2	7	0	1	8	0	0
19	43059329	.	C	T	5	2	7	0	0	7	0	0
19	43061448	.	G	A	4	6	10	0	0	10	0	0
19	43062374	.	T	A	2	3	5	0	1	6	0	0
19	43063825	.	C	A	3	4	7	0	0	7	0	0
19	43063846	.	C	T	2	2	4	0	0	4	0	0
19	43065875	.	C	T	2	7	9	0	0	9	0	0
19	43068174	.	C	G	0	4	4	4	1	9	0	0
19	43072588	.	T	C	13	11	24	0	1	25	0	0
19	43072645	.	G	A	4	10	14	0	11	25	0	0
19	43072663	.	C	T	14	10	24	0	1	25	0	0
19	43074584	.	T	A	12	13	25	0	1	26	0	0
19	43074635	.	C	T	9	12	21	0	2	23	0	0
19	43074668	.	G	T	12	10	22	0	1	23	0	0
19	43074692	.	G	C	13	12	25	0	0	25	0	0
19	43074716	.	G	A	13	6	19	0	2	21	0	0
19	43076458	.	C	T	4	10	14	0	0	14	0	0
19	43083844	.	C	T	15	16	31	0	0	31	0	0
19	43120316	.	C	T	31	20	51	13	0	64	0	0
19	43120471	.	T	C	30	37	67	1	5	73	0	0
19	43121440	.	G	A	40	34	74	4	2	80	0	0
19	43121700	.	G	A	5	2	7	77	0	84	0	0
19	43121736	.	G	A	26	18	44	37	2	83	0	0
19	43121784	.	C	T	34	38	72	2	4	78	0	0
19	43121826	.	T	C	39	32	71	2	5	78	0	0
19	43126014	.	G	A	11	20	31	7	1	39	0	0
19	43126104	.	C	T	11	7	18	34	0	52	0	0
19	43126113	.	C	T	9	11	20	28	1	49	0	0
19	43126140	.	C	T	16	16	32	1	0	33	0	0
19	43129049	.	G	T	0	12	12	0	20	32	0	0
19	43129076	.	A	G	20	15	35	0	4	39	0	0
19	43133087	.	A	G	14	16	30	0	1	31	0	0
19	43331541	.	T	C	1	3	4	0	0	4	0	0
19	43337999	.	T	C	1	2	3	0	0	3	0	0
19	43347289	.	A	C	4	2	6	0	0	6	0	0
19	43347290	.	G	T	4	2	6	0	0	6	0	0
19	43352555	.	G	T	0	3	3	0	7	10	0	0
19	43357169	.	C	T	3	4	7	0	1	8	0	0
19	43357197	.	C	A	1	4	5	0	2	7	0	0
19	43431787	.	T	C	1	2	3	0	0	3	0	0
19	43491739	.	T	A	6	4	10	0	0	10	0	0
19	43492136	.	G	A	2	4	6	0	0	6	0	0
19	43492280	.	T	C	4	5	9	0	0	9	0	0
19	43492361	.	G	A	0	3	3	0	1	4	0	0
19	43492363	.	T	A	1	2	3	0	1	4	0	0
19	43492439	.	G	A	2	3	5	0	2	7	0	0
19	43492955	.	T	C	6	4	10	0	1	11	0	0
19	43493300	.	G	A	3	2	5	0	0	5	0	0
19	43493372	.	G	A	2	3	5	0	0	5	0	0
19	43494040	.	A	C	4	9	13	0	1	14	0	0
19	43494128	.	G	A	1	4	5	0	0	5	0	0
19	43494452	.	G	T	3	4	7	0	1	8	0	0
19	43494456	.	G	C	3	4	7	0	0	7	0	0
19	43494700	.	C	T	11	11	22	0	0	22	0	0
19	43494911	.	C	T	10	6	16	0	0	16	0	0
19	43495202	.	C	G	4	0	4	0	13	17	0	0
19	43495376	.	G	A	0	9	9	0	16	25	0	0
19	43498940	.	A	G	12	15	27	0	1	28	0	0
19	43499311	.	C	T	15	12	27	0	2	29	0	0
19	43499616	.	T	C	15	20	35	0	2	37	0	0
19	43499930	.	G	T	11	11	22	0	0	22	0	0
19	43499942	.	A	T	8	8	16	0	3	19	0	0
19	43500163	.	C	T	1	5	6	0	1	7	0	0
19	43542758	.	A	C	5	3	8	0	0	8	0	0
19	43542840	.	T	A	1	5	6	0	0	6	0	0
19	43547605	.	T	C	8	13	21	0	0	21	0	0
19	43547685	.	A	T	5	7	12	0	0	12	0	0
19	43547843	.	T	G	8	10	18	1	0	19	0	0
19	43548820	.	C	T	1	1	2	0	1	3	0	0
19	43548910	.	T	A	15	5	20	0	0	20	0	0
19	43549200	.	C	T	3	21	24	0	17	41	0	0
19	43549215	.	T	C	23	12	35	0	2	37	0	0
19	43549305	.	A	G	13	14	27	0	2	29	0	0
19	43549554	.	C	T	5	5	10	0	1	11	0	0
19	43549622	.	A	G	4	6	10	0	1	11	0	0
19	43549860	.	G	T	7	6	13	0	1	14	0	0
19	43552135	.	C	T	3	6	9	5	0	14	0	0
19	43552189	.	C	A	1	5	6	0	10	16	0	0
19	43552223	.	G	C	6	5	11	0	1	12	0	0
19	43601908	.	G	A	1	2	3	0	0	3	0	0
19	43681439	.	C	T	2	2	4	0	0	4	0	0
19	43681496	.	G	A	2	2	4	0	0	4	0	0
19	43693915	.	C	T	1	2	3	0	0	3	0	0
19	43696851	.	T	C	5	4	9	0	0	9	0	0
19	43696938	.	G	A	0	2	2	0	5	7	0	0
19	43696953	.	G	A	2	4	6	0	0	6	0	0
19	43697484	.	T	C	2	2	4	0	0	4	0	0
19	43699765	.	T	A	2	4	6	0	0	6	0	0
19	43704324	.	G	A	6	2	8	0	1	9	0	0
19	43704375	.	C	T	6	5	11	0	0	11	0	0
19	43704744	.	C	T	5	6	11	0	0	11	0	0
19	43706681	.	T	C	13	6	19	0	1	20	0	0
19	43706684	.	C	T	13	7	20	0	0	20	0	0
19	43706736	.	G	A	2	11	13	0	7	20	0	0
19	43706808	.	G	C	4	9	13	0	0	13	0	0
19	43706848	.	T	C	1	5	6	0	2	8	0	0
19	43707228	.	T	G	1	3	4	0	0	4	0	0
19	43707261	.	A	T	1	5	6	0	0	6	0	0
19	43727110	.	A	C	0	2	2	0	1	3	0	0
19	43736765	.	G	A	2	7	9	0	4	13	0	0
19	43737796	.	C	G	4	2	6	0	1	7	0	0
19	43738237	.	C	T	17	17	34	0	4	38	0	0
19	43740988	.	A	C	16	20	36	0	1	37	0	0
19	43748671	.	A	C	10	8	18	0	0	18	0	0
19	43748672	.	G	C	10	7	17	0	1	18	0	0
19	43750020	.	T	C	5	0	5	1	5	11	0	0
19	43750085	.	A	G	4	8	12	0	0	12	0	0
19	43782397	.	G	T	27	32	59	0	3	62	0	0
19	43783581	.	C	T	28	32	60	0	1	61	0	0
19	43825877	.	G	T	7	4	11	0	3	14	0	0
19	43831544	.	G	A	8	12	20	0	1	21	0	0
19	43831701	.	C	T	10	9	19	0	2	21	0	0
19	43880674	.	C	T	5	16	21	0	0	21	0	0
19	43890059	.	G	A	1	9	10	0	5	15	0	0
19	43890068	.	G	A	0	5	5	0	9	14	0	0
19	43891949	.	C	T	6	11	17	0	1	18	0	0
19	43898915	.	C	A	23	17	40	0	2	42	0	0
19	43899208	.	T	A	4	2	6	0	1	7	0	0
19	43899451	.	A	T	14	7	21	0	1	22	0	0
19	43899787	.	A	T	6	4	10	0	1	11	0	0
19	43899851	.	A	G	8	7	15	0	3	18	0	0
19	43899891	.	G	A	10	7	17	0	0	17	0	0
19	43899936	.	G	A	14	5	19	0	1	20	0	0
19	43900013	.	A	G	4	6	10	0	2	12	0	0
19	43900144	.	T	C	15	2	17	0	2	19	0	0
19	43900309	.	G	C	5	7	12	0	1	13	0	0
19	43900310	.	G	A	5	7	12	0	1	13	0	0
19	43900453	.	C	A	17	7	24	0	1	25	0	0
19	43900470	.	C	T	6	12	18	0	0	18	0	0
19	43900568	.	G	A	5	7	12	0	2	14	0	0
19	43900585	.	A	T	7	13	20	0	1	21	0	0
19	43900630	.	C	T	10	17	27	0	1	28	0	0
19	43901062	.	A	G	3	3	6	0	3	11	2	0
19	43901305	.	A	C	10	17	27	0	0	27	0	0
19	43971087	.	A	G	5	5	10	0	0	10	0	0
19	43971171	.	T	C	3	6	9	0	0	9	0	0
19	43973986	.	T	G	2	0	2	2	6	10	0	0
19	43974224	.	A	T	16	9	25	1	1	27	0	0
19	43976249	.	G	A	4	4	8	0	0	8	0	0
19	43976286	.	C	T	7	4	11	0	0	11	0	0
19	44031701	.	G	T	1	2	3	0	0	3	0	0
19	44036517	.	T	A	1	2	3	0	1	4	0	0
19	44049577	.	A	G	2	2	4	0	0	4	0	0
19	44049755	.	G	A	22	22	44	0	0	44	0	0
19	44052585	.	A	C	38	34	72	0	1	73	0	0
19	44052588	.	A	G	35	35	70	0	3	73	0	0
19	44054457	.	C	T	40	20	60	0	0	60	0	0
19	44059793	.	G	C	4	3	7	0	2	9	0	0
19	44062448	.	G	A	4	3	7	0	0	7	0	0
19	44063620	.	T	C	3	4	7	0	0	7	0	0
19	44063765	.	G	T	4	4	8	0	0	8	0	0
19	44063766	.	T	G	3	4	7	0	1	8	0	0
19	44068328	.	G	A	21	8	29	0	3	32	0	0
19	44068378	.	C	A	15	22	37	0	1	38	0	0
19	44068543	.	G	A	12	17	29	0	1	30	0	0
19	45856213	.	T	C	3	2	5	0	1	6	0	0
19	45856414	.	A	G	25	16	41	0	1	42	0	0
19	45859824	.	C	T	24	19	43	1	4	48	0	0
19	45896193	.	C	T	7	8	15	0	1	16	0	0
19	45962080	.	T	G	1	2	3	0	0	3	0	0
19	45962161	.	A	C	1	3	4	0	2	6	0	0
19	45962171	.	A	G	1	3	4	0	0	4	0	0
19	45965617	.	A	G	6	0	6	3	12	21	0	0
19	45967297	.	C	G	6	0	6	0	7	13	0	0
19	45967372	.	G	A	11	7	18	0	0	18	0	0
19	45979394	.	A	G	4	4	8	0	0	8	0	0
19	45979431	.	A	C	2	1	3	0	1	4	0	0
19	45980156	.	T	C	3	2	5	0	0	5	0	0
19	45980161	.	A	G	3	2	5	0	0	5	0	0
19	45994212	.	A	G	5	4	9	0	0	9	0	0
19	45994263	.	T	C	7	3	10	0	0	10	0	0
19	45997964	.	A	G	3	5	8	0	0	8	0	0
19	45999081	.	G	A	3	3	6	0	1	7	0	0
19	45999146	.	G	A	3	3	6	0	1	7	0	0
19	46006195	.	G	A	3	3	6	0	0	6	0	0
19	46006267	.	G	A	5	5	10	0	0	10	0	0
19	46019644	.	A	T	7	5	12	0	3	15	0	0
19	46019645	.	A	T	11	5	16	0	0	16	0	0
19	46020177	.	A	C	9	0	9	0	9	18	0	0
19	46020228	.	G	A	9	10	19	0	2	21	0	0
19	46020276	.	C	T	1	8	9	0	10	19	0	0
19	46020462	.	G	A	11	17	28	0	0	28	0	0
19	46020471	.	G	T	13	12	25	0	2	27	0	0
19	46020544	.	G	C	10	1	11	0	9	20	0	0
19	46022418	.	A	G	11	10	21	0	2	23	0	0
19	46028151	.	T	A	10	11	21	0	1	22	0	0
19	46032475	.	A	G	5	4	9	0	0	9	0	0
19	46032485	.	G	T	4	5	9	0	0	9	0	0
19	46032527	.	G	T	2	4	6	0	0	6	0	0
19	46192394	.	G	A	1	2	3	0	0	3	0	0
19	46202060	.	T	C	1	2	3	0	0	3	0	0
19	46209516	.	T	A	4	4	8	0	0	8	0	0
19	46209522	.	A	T	4	4	8	0	0	8	0	0
19	46210054	.	T	G	4	3	7	0	1	8	0	0
19	46210120	.	G	T	6	3	9	0	1	10	0	0
19	46210209	.	A	T	6	7	13	0	0	13	0	0
19	46210242	.	G	C	5	7	12	0	1	13	0	0
19	46210286	.	A	G	6	4	10	0	1	11	0	0
19	46210596	.	C	A	6	2	8	0	0	8	0	0
19	46210600	.	C	G	6	2	8	0	1	9	0	0
19	46225972	.	G	A	14	9	23	0	1	24	0	0
19	46237787	.	C	T	12	22	34	0	1	35	0	0
19	46237794	.	A	T	11	21	32	0	1	33	0	0
19	46237844	.	G	T	0	17	17	0	14	31	0	0
19	46238199	.	G	A	2	6	8	0	11	19	0	0
19	46238227	.	T	C	12	8	20	0	1	21	0	0
19	46238297	.	T	G	3	15	18	0	0	18	0	0
19	46238366	.	T	C	7	7	14	0	0	14	0	0
19	46238382	.	G	A	1	10	11	0	8	19	0	0
19	46259649	.	A	G	5	4	9	1	2	12	0	0
19	46259660	.	A	T	7	7	14	1	2	17	0	0
19	46259709	.	G	A	2	10	12	1	8	21	0	0
19	46280672	.	G	T	1	10	11	0	9	20	0	0
19	46280861	.	G	A	0	4	4	0	7	11	0	0
19	46288632	.	T	C	8	6	14	0	1	15	0	0
19	46303140	.	C	T	18	19	37	0	1	38	0	0
19	46303320	.	G	A	16	16	32	0	2	34	0	0
19	46303330	.	G	A	1	16	17	0	18	35	0	0
19	46303414	.	C	T	27	21	48	0	0	48	0	0
19	46303457	.	A	T	28	22	50	0	2	52	0	0
19	46309787	.	G	A	1	2	3	0	0	3	0	0
19	46332910	.	G	A	1	4	5	0	3	8	0	0
19	46333761	.	A	C	1	3	4	0	1	5	0	0
19	46373704	.	T	G	10	12	22	0	1	23	0	0
19	46373705	.	G	T	10	11	21	0	1	22	0	0
19	46416926	.	A	G	6	3	9	0	0	9	0	0
19	47405935	.	C	T	13	12	25	0	2	27	0	0
19	47405946	.	G	T	14	16	30	0	0	30	0	0
19	47423600	.	T	C	5	5	10	0	0	10	0	0
19	47431333	.	G	A	10	3	13	0	1	14	0	0
19	47431459	.	C	T	13	11	24	0	2	26	0	0
19	47431501	.	C	T	0	8	8	0	11	19	0	0
19	47431510	.	A	G	10	10	20	0	1	21	0	0
19	47434142	.	T	C	5	0	5	0	8	13	0	0
19	47438149	.	C	G	5	5	10	0	2	12	0	0
19	47448486	.	G	A	6	4	10	0	1	11	0	0
19	47452971	.	A	C	6	1	7	0	12	19	0	0
19	47465242	.	C	T	0	4	4	0	2	6	0	0
19	47465387	.	C	A	1	9	10	0	2	12	0	0
19	47465577	.	A	G	4	11	15	0	0	15	0	0
19	47465652	.	C	T	4	4	8	0	1	9	0	0
19	47465745	.	A	G	1	2	3	0	0	3	0	0
19	47465754	.	A	G	1	2	3	0	0	3	0	0
19	47467792	.	A	G	2	2	4	0	0	4	0	0
19	47467919	.	T	C	2	0	2	0	3	5	0	0
19	47467988	.	A	G	1	2	3	1	0	4	0	0
19	47471886	.	A	C	4	2	6	0	0	6	0	0
19	47474703	.	T	C	3	3	6	0	0	6	0	0
19	47478108	.	G	A	9	5	14	0	0	14	0	0
19	47478140	.	G	A	6	4	10	0	0	10	0	0
19	47478161	.	C	T	5	4	9	0	0	9	0	0
19	47478842	.	C	T	6	6	12	0	2	14	0	0
19	47479051	.	G	T	10	8	18	0	1	19	0	0
19	47479084	.	A	G	9	8	17	0	0	17	0	0
19	47481235	.	C	T	5	2	7	0	0	7	0	0
19	47481393	.	A	T	3	4	7	0	0	7	0	0
19	47481435	.	C	A	1	7	8	0	1	9	0	0
19	47481449	.	T	C	2	4	6	0	0	6	0	0
19	47481484	.	T	G	1	4	5	0	0	5	0	0
19	47775947	.	G	A	1	2	3	0	0	3	0	0
19	47783172	.	A	G	2	4	6	0	0	6	0	0
19	47783307	.	G	A	1	3	4	0	0	4	0	0
19	47784172	.	C	T	7	5	12	0	0	12	0	0
19	47800607	.	T	C	6	0	6	0	13	19	0	0
19	47800673	.	A	C	13	9	22	0	0	22	0	0
19	47802932	.	A	G	10	13	23	0	1	24	0	0
19	47807819	.	C	T	2	5	7	1	9	17	0	0
19	47807855	.	G	A	8	12	20	0	1	21	0	0
19	47808044	.	A	G	10	4	14	0	1	15	0	0
19	47811955	.	A	G	7	3	10	0	1	11	0	0
19	47819698	.	G	A	4	2	6	0	2	8	0	0
19	47820986	.	G	A	1	3	4	0	0	4	0	0
19	47821025	.	A	G	3	3	6	0	0	6	0	0
19	47975976	.	T	C	9	11	20	0	5	25	0	0
19	47976325	.	C	T	24	23	47	0	3	50	0	0
19	47980813	.	C	T	13	19	32	0	6	38	0	0
19	47982822	.	C	T	1	15	16	0	13	29	0	0
19	47982843	.	G	A	11	16	27	0	4	31	0	0
19	47982891	.	G	T	19	20	39	0	1	40	0	0
19	47982897	.	A	G	18	22	40	0	1	41	0	0
19	47983014	.	C	G	16	17	33	0	2	35	0	0
19	47984483	.	C	T	15	7	22	0	0	22	0	0
19	47984970	.	G	A	16	13	29	0	0	29	0	0
19	47986324	.	C	T	3	10	13	0	10	23	0	0
19	47986411	.	G	A	11	12	23	0	1	24	0	0
19	47987084	.	C	T	2	8	10	0	9	19	0	0
19	47989408	.	G	A	6	3	9	0	1	10	0	0
19	47989417	.	T	C	6	4	10	0	2	12	0	0
19	47997402	.	C	T	1	10	11	0	7	18	0	0
19	48013172	.	A	G	6	6	12	0	2	14	0	0
19	48013584	.	G	A	8	9	17	0	1	18	0	0
19	48013940	.	C	T	1	6	7	0	6	13	0	0
19	48018305	.	C	G	5	6	11	0	1	12	0	0
19	48018307	.	A	G	5	6	11	0	0	11	0	0
19	48019072	.	A	G	1	1	2	0	2	4	0	0
19	48022989	.	T	G	18	18	36	1	2	39	0	0
19	48023309	.	A	G	24	4	28	1	28	57	0	0
19	48025326	.	C	T	6	3	9	0	0	9	0	0
19	48030734	.	C	T	5	5	10	0	1	11	0	0
19	48031094	.	T	C	5	4	9	0	1	10	0	0
19	48036716	.	C	T	21	20	41	1	1	43	0	0
19	48036809	.	T	G	25	2	27	0	20	47	0	0
19	48049279	.	T	G	8	9	17	0	1	18	0	0
19	48050152	.	C	A	10	9	19	0	0	19	0	0
19	48051070	.	C	G	8	0	8	0	8	16	0	0
19	48053315	.	A	C	14	12	26	0	0	26	0	0
19	48055131	.	G	A	2	16	18	0	14	32	0	0
19	48058778	.	C	T	26	17	43	0	1	44	0	0
19	48064509	.	A	G	3	0	3	0	2	5	0	0
19	48064520	.	A	G	3	0	3	0	3	6	0	0
19	48065917	.	A	C	5	2	7	0	0	7	0	0
19	48065970	.	C	T	3	3	6	0	0	6	0	0
19	48069366	.	T	C	9	6	15	0	0	15	0	0
19	48113914	.	A	G	9	7	16	0	0	16	0	0
19	48114098	.	G	A	0	13	13	0	9	22	0	0
19	48114268	.	G	A	3	14	17	0	12	29	0	0
19	48120142	.	G	T	1	24	25	0	22	47	0	0
19	48120238	.	A	G	12	0	12	0	17	29	0	0
19	48251302	.	G	A	1	2	3	0	1	4	0	0
2	177241	.	G	T	20	3	23	3	0	27	1	0
2	177243	.	G	C	21	4	25	3	0	28	0	0
2	281639	.	A	G	6	0	6	0	3	9	0	0
2	331581	.	A	G	1	2	3	0	1	4	0	0
2	374634	.	T	C	3	4	7	0	0	7	0	0
2	1213640	.	C	T	3	2	5	0	0	5	0	0
2	1215156	.	G	A	1	3	4	0	4	8	0	0
2	1215160	.	A	G	5	2	7	0	0	7	0	0
2	1220802	.	T	C	9	14	23	0	2	25	0	0
2	1595897	.	T	C	4	7	11	0	0	11	0	0
2	1597355	.	T	C	5	3	8	0	0	8	0	0
2	1597617	.	T	C	3	7	10	0	0	10	0	0
2	1860310	.	A	G	2	2	4	0	0	4	0	0
2	3027065	.	T	A	12	3	15	0	2	17	0	0
2	3027066	.	A	T	13	2	15	0	2	17	0	0
2	3027859	.	T	C	16	2	18	0	17	35	0	0
2	3027862	.	A	G	16	19	35	0	1	36	0	0
2	3027928	.	T	C	9	14	23	0	1	24	0	0
2	3028117	.	A	G	13	9	22	0	0	22	0	0
2	3028156	.	G	T	14	11	25	0	1	26	0	0
2	3028203	.	T	C	13	19	32	0	0	32	0	0
2	3028233	.	C	T	16	15	31	0	1	32	0	0
2	3028270	.	A	T	18	14	32	0	1	33	0	0
2	3028312	.	T	G	17	8	25	0	0	25	0	0
2	3028463	.	G	A	11	6	17	0	0	17	0	0
2	3028558	.	T	C	10	3	13	0	1	14	0	0
2	3028605	.	G	A	7	7	14	0	2	16	0	0
2	3028715	.	C	T	2	4	6	0	0	6	0	0
2	3028893	.	A	G	9	6	15	0	0	15	0	0
2	3028908	.	A	T	7	5	12	0	1	13	0	0
2	3029048	.	T	C	4	1	5	0	4	9	0	0
2	3029383	.	T	A	4	9	13	0	1	14	0	0
2	3029437	.	T	C	12	0	12	0	12	24	0	0
2	3032707	.	G	A	11	7	18	0	2	20	0	0
2	3032944	.	C	T	0	6	6	0	6	12	0	0
2	3034701	.	T	C	10	1	11	0	5	16	0	0
2	3034704	.	T	A	10	7	17	0	0	17	0	0
2	3034819	.	G	A	11	10	21	0	1	22	0	0
2	3056588	.	A	G	5	4	9	0	0	9	0	0
2	3056627	.	A	G	2	2	4	0	0	4	0	0
2	3056663	.	A	C	4	4	8	0	1	9	0	0
2	3061083	.	G	A	3	3	6	0	0	6	0	0
2	3062181	.	T	G	3	7	10	0	1	11	0	0
2	3062288	.	T	C	2	2	4	0	1	5	0	0
2	3062464	.	C	A	3	3	6	0	0	6	0	0
2	3064922	.	A	G	9	9	18	0	0	18	0	0
2	3064991	.	T	C	3	6	9	0	0	9	0	0
2	3065248	.	C	T	4	5	9	0	0	9	0	0
2	3065428	.	C	T	11	5	16	0	1	17	0	0
2	3065451	.	C	T	13	3	16	0	0	16	0	0
2	3065507	.	C	T	7	5	12	0	0	12	0	0
2	3065563	.	G	A	8	4	12	0	0	12	0	0
2	3065581	.	A	T	6	4	10	0	1	11	0	0
2	3065633	.	A	T	6	3	9	0	0	9	0	0
2	3066003	.	T	A	2	5	7	0	0	7	0	0
2	3066074	.	T	A	1	2	3	0	0	3	0	0
2	3066075	.	C	T	1	2	3	0	0	3	0	0
2	3066304	.	G	A	3	4	7	0	0	7	0	0
2	3066336	.	T	A	2	3	5	0	0	5	0	0
2	4045399	.	T	C	19	5	24	0	0	24	0	0
2	4045715	.	T	C	4	2	6	0	0	6	0	0
2	4729329	.	G	A	9	5	14	0	0	14	0	0
2	4729340	.	G	A	9	5	14	0	0	14	0	0
2	4729554	.	A	G	4	8	12	0	1	13	0	0
2	4729682	.	A	T	7	5	12	0	1	13	0	0
2	4729857	.	G	T	2	4	6	0	1	7	0	0
2	4730051	.	T	C	2	2	4	0	1	5	0	0
2	4735995	.	G	A	3	3	6	0	0	6	0	0
2	4736978	.	G	A	4	5	9	0	0	9	0	0
2	4737177	.	C	G	1	3	4	0	0	4	0	0
2	4748061	.	A	G	1	2	3	0	0	3	0	0
2	4754041	.	T	G	1	2	3	0	0	3	0	0
2	4900650	.	T	C	30	13	43	0	1	44	0	0
2	4900688	.	A	C	18	15	33	0	2	35	0	0
2	4900798	.	T	C	17	21	38	0	2	40	0	0
2	4903760	.	G	A	8	19	27	0	1	28	0	0
2	4907857	.	C	T	11	10	21	0	1	22	0	0
2	4916452	.	G	A	8	5	13	0	1	14	0	0
2	4930730	.	T	C	6	3	9	0	0	9	0	0
2	4948832	.	A	G	5	4	9	0	0	9	0	0
2	4948850	.	G	A	5	6	11	0	0	11	0	0
2	4950607	.	C	T	4	4	8	0	0	8	0	0
2	4956028	.	T	G	9	3	12	0	0	12	0	0
2	4984371	.	A	T	1	2	3	0	0	3	0	0
2	4995045	.	C	G	5	5	10	0	0	10	0	0
2	5014631	.	A	C	5	4	9	0	1	10	0	0
2	5407097	.	A	G	9	3	12	0	0	12	0	0
2	5407137	.	A	G	2	5	7	0	0	7	0	0
2	5407534	.	A	G	2	1	3	0	13	16	0	0
2	5407550	.	A	G	4	2	6	0	13	19	0	0
2	5544025	.	C	G	4	3	7	0	1	8	0	0
2	5544076	.	T	C	4	0	4	0	4	8	0	0
2	5544261	.	C	G	7	11	18	0	1	19	0	0
2	5546933	.	T	C	3	7	10	0	1	11	0	0
2	5555222	.	T	C	2	0	2	0	3	5	0	0
2	5555349	.	C	A	3	3	6	0	0	6	0	0
2	5555407	.	C	G	5	5	10	0	0	10	0	0
2	5578745	.	C	T	3	3	6	0	0	6	0	0
2	5578772	.	C	T	3	9	12	0	0	12	0	0
2	5578820	.	T	A	10	6	16	0	2	18	0	0
2	5578872	.	A	G	9	0	9	0	3	12	0	0
2	5578936	.	A	T	5	5	10	0	0	10	0	0
2	5579111	.	A	G	8	1	9	0	1	10	0	0
2	5579120	.	G	A	0	2	2	0	5	7	0	0
2	5579276	.	T	C	4	2	6	0	0	6	0	0
2	5579285	.	T	A	4	2	6	0	0	6	0	0
2	5579415	.	G	A	2	3	5	2	2	9	0	0
2	5579958	.	A	G	8	0	8	0	6	14	0	0
2	5580140	.	G	A	4	5	9	1	0	10	0	0
2	5580249	.	A	G	2	4	6	0	1	7	0	0
2	5580267	.	T	G	2	8	10	0	1	11	0	0
2	5580439	.	T	C	10	11	21	0	0	21	0	0
2	5580510	.	C	T	8	10	18	0	0	18	0	0
2	5580544	.	A	G	7	10	17	1	1	19	0	0
2	5580592	.	C	T	9	13	22	0	1	23	0	0
2	5580644	.	A	G	16	0	16	1	8	25	0	0
2	5580887	.	G	T	4	8	12	6	2	20	0	0
2	5581063	.	G	A	1	3	4	0	10	14	0	0
2	5581233	.	C	T	8	16	24	0	2	26	0	0
2	5581234	.	G	T	0	17	17	0	9	26	0	0
2	5581482	.	T	A	14	14	28	0	3	31	0	0
2	5581612	.	A	G	10	8	18	0	1	19	0	0
2	5581660	.	T	A	6	10	16	0	1	17	0	0
2	5601282	.	A	T	7	3	10	0	0	10	0	0
2	5621176	.	A	T	7	4	11	0	0	11	0	0
2	5621360	.	C	T	15	4	19	0	2	21	0	0
2	5621394	.	A	C	10	7	17	0	0	17	0	0
2	5644548	.	C	T	13	8	21	0	2	23	0	0
2	5677650	.	C	T	22	10	32	0	0	32	0	0
2	5681049	.	A	C	16	22	38	0	2	40	0	0
2	5681388	.	T	G	19	0	19	0	21	40	0	0
2	5681446	.	T	C	12	15	27	0	2	29	0	0
2	5709579	.	T	C	10	1	11	0	6	17	0	0
2	5709663	.	C	G	13	4	17	0	1	18	0	0
2	5709670	.	T	A	15	8	23	0	0	24	1	0
2	5709782	.	C	T	14	5	19	0	0	19	0	0
2	5709843	.	C	A	8	14	22	0	0	22	0	0
2	5709850	.	T	G	9	13	22	0	1	23	0	0
2	5711684	.	C	A	14	18	32	0	2	34	0	0
2	5714194	.	A	G	12	14	26	0	0	26	0	0
2	5714303	.	G	T	23	17	40	0	2	42	0	0
2	5714789	.	C	T	9	15	24	0	3	27	0	0
2	5714813	.	C	T	1	9	10	0	15	25	0	0
2	5716793	.	T	C	16	11	27	0	0	27	0	0
2	5721008	.	C	T	2	6	8	0	14	22	0	0
2	5723497	.	A	G	8	11	19	0	2	21	0	0
2	5723515	.	A	G	10	12	22	0	1	23	0	0
2	5735134	.	C	T	1	4	5	0	6	11	0	0
2	5735271	.	G	A	1	4	5	0	0	5	0	0
2	5736291	.	G	A	2	2	4	0	0	4	0	0
2	5740418	.	T	A	4	5	9	0	0	9	0	0
2	5740678	.	T	C	2	2	4	0	1	5	0	0
2	5741110	.	C	G	4	5	9	0	1	10	0	0
2	5741305	.	C	G	2	2	4	0	2	6	0	0
2	5741391	.	A	G	2	2	4	0	0	4	0	0
2	5741400	.	G	C	2	2	4	0	0	4	0	0
2	5741534	.	T	A	2	3	5	0	0	5	0	0
2	5749335	.	A	G	2	2	4	0	0	4	0	0
2	5809907	.	C	A	3	2	5	0	0	5	0	0
2	5809911	.	G	A	1	4	5	0	0	5	0	0
2	5811687	.	A	T	3	2	5	0	0	5	0	0
2	5811699	.	G	T	5	2	7	0	2	9	0	0
2	5811778	.	T	A	3	8	11	0	0	11	0	0
2	5811783	.	T	A	7	3	10	0	1	12	1	0
2	5811971	.	T	G	4	5	9	2	1	12	0	0
2	5812007	.	G	A	3	3	6	2	0	8	0	0
2	5812133	.	T	C	2	3	5	0	0	5	0	0
2	5812149	.	T	A	1	2	3	0	0	3	0	0
2	5813710	.	C	T	3	2	5	0	0	5	0	0
2	5814029	.	T	A	3	4	7	0	1	8	0	0
2	5830336	.	G	A	2	2	4	0	0	4	0	0
2	5844019	.	T	G	1	3	4	0	1	5	0	0
2	5866989	.	G	A	2	3	5	0	0	5	0	0
2	5872950	.	C	T	5	5	10	0	1	11	0	0
2	5882398	.	A	T	5	4	9	0	0	9	0	0
2	5882542	.	T	C	4	5	9	0	0	9	0	0
2	5882665	.	C	T	6	3	9	0	1	10	0	0
2	5882793	.	A	C	9	5	14	0	1	15	0	0
2	5882799	.	A	G	6	0	6	0	9	15	0	0
2	5883198	.	G	A	11	10	21	1	0	22	0	0
2	5909405	.	C	T	1	3	4	0	0	4	0	0
2	5919314	.	C	T	1	4	5	0	0	5	0	0
2	5923438	.	G	A	3	6	9	0	1	10	0	0
2	5923640	.	A	T	6	3	9	0	0	9	0	0
2	5923645	.	C	T	7	3	10	0	0	10	0	0
2	5923679	.	G	A	5	5	10	0	0	10	0	0
2	5923863	.	C	T	6	8	14	0	0	14	0	0
2	5923921	.	T	G	4	8	12	0	0	12	0	0
2	5923943	.	C	T	6	10	16	0	0	16	0	0
2	5923978	.	C	T	5	7	12	0	2	14	0	0
2	5924170	.	T	A	5	7	12	0	1	13	0	0
2	5924207	.	T	C	8	5	13	0	1	14	0	0
2	5934080	.	C	A	7	3	10	1	0	11	0	0
2	5934920	.	G	C	6	13	19	0	1	20	0	0
2	5935219	.	A	T	11	11	22	0	0	22	0	0
2	5935294	.	G	A	10	4	14	0	1	15	0	0
2	5935963	.	C	G	1	2	3	0	0	3	0	0
2	5936035	.	T	A	4	11	15	0	0	15	0	0
2	5936038	.	A	G	4	11	15	0	0	15	0	0
2	5936153	.	C	A	0	3	3	0	2	5	0	0
2	5936465	.	G	T	3	4	7	0	0	7	0	0
2	5936476	.	G	C	3	3	6	0	0	6	0	0
2	5936678	.	T	A	1	6	7	0	1	8	0	0
2	5936751	.	T	G	2	3	5	0	0	5	0	0
2	5936856	.	C	A	5	2	7	0	0	7	0	0
2	5936910	.	G	A	1	3	4	0	0	4	0	0
2	5937035	.	G	A	3	3	6	0	1	7	0	0
2	5937051	.	C	T	3	4	7	0	0	7	0	0
2	5937079	.	T	G	4	4	8	0	0	8	0	0
2	5941932	.	A	G	5	2	7	0	0	7	0	0
2	5941940	.	T	A	0	4	4	0	2	6	0	0
2	5942173	.	T	A	4	2	6	0	0	6	0	0
2	6005568	.	T	G	4	4	8	0	0	8	0	0
2	6026265	.	A	G	2	2	4	0	0	4	0	0
2	6033874	.	G	A	2	2	4	0	0	4	0	0
2	6034311	.	T	C	1	3	4	0	0	4	0	0
2	6037004	.	C	A	1	2	3	0	0	3	0	0
2	6042195	.	T	C	13	8	21	0	1	22	0	0
2	6052034	.	G	A	2	2	4	0	1	5	0	0
2	6052066	.	T	C	4	1	5	0	2	7	0	0
2	6052179	.	A	T	8	9	17	0	0	17	0	0
2	6052295	.	A	T	6	4	10	0	0	10	0	0
2	6052379	.	C	A	4	4	8	0	0	8	0	0
2	6052380	.	A	T	4	4	8	0	0	8	0	0
2	6052932	.	G	A	8	8	16	0	0	16	0	0
2	6054935	.	A	G	4	5	9	0	1	10	0	0
2	6058633	.	G	A	3	8	11	0	1	12	0	0
2	6077258	.	G	T	0	2	2	0	5	7	0	0
2	6082748	.	T	C	1	9	10	0	1	11	0	0
2	6082752	.	A	C	2	8	10	0	1	11	0	0
2	6087200	.	A	G	4	0	4	0	8	12	0	0
2	6091653	.	A	G	4	5	9	1	0	10	0	0
2	6091689	.	G	A	0	6	6	0	5	11	0	0
2	6091764	.	A	G	3	0	3	0	4	7	0	0
2	6091876	.	A	T	4	4	8	0	1	9	0	0
2	6091920	.	A	T	4	2	6	0	0	6	0	0
2	6091921	.	T	G	3	2	5	0	1	6	0	0
2	6106727	.	T	C	3	0	3	0	8	11	0	0
2	6106742	.	G	A	4	11	15	0	1	16	0	0
2	6107289	.	G	A	14	19	33	1	1	35	0	0
2	6107310	.	A	T	13	16	29	1	3	33	0	0
2	6126753	.	T	A	6	14	20	0	2	22	0	0
2	6126783	.	A	T	10	11	21	0	1	22	0	0
2	6126857	.	T	C	10	6	16	0	0	16	0	0
2	6143912	.	T	C	15	20	35	0	4	39	0	0
2	6144085	.	G	A	2	18	20	0	16	36	0	0
2	6149006	.	T	C	7	11	18	0	1	19	0	0
2	6149220	.	T	G	4	4	8	0	0	8	0	0
2	6149267	.	C	T	2	6	8	0	0	8	0	0
2	6186956	.	T	A	2	3	5	0	1	6	0	0
2	6187031	.	G	T	5	5	10	0	0	10	0	0
2	6187138	.	T	C	4	8	12	0	0	12	0	0
2	6191691	.	T	C	6	12	18	0	0	18	0	0
2	6191829	.	C	T	5	8	13	0	1	14	0	0
2	6194151	.	T	C	6	5	11	0	2	13	0	0
2	6196798	.	T	A	5	10	15	0	1	16	0	0
2	6196804	.	A	G	6	0	6	0	12	18	0	0
2	6196858	.	C	A	9	10	19	0	0	19	0	0
2	6197216	.	G	T	7	8	15	0	0	15	0	0
2	6197249	.	G	A	9	6	15	0	1	16	0	0
2	6258164	.	C	G	1	2	3	0	0	3	0	0
2	6258231	.	C	T	3	3	6	0	0	6	0	0
2	6258497	.	G	A	3	4	7	0	0	7	0	0
2	6258564	.	G	A	1	3	4	0	1	5	0	0
2	6258684	.	T	A	1	3	4	0	0	4	0	0
2	6265929	.	C	A	22	17	39	0	2	41	0	0
2	6266115	.	T	A	17	15	32	0	1	33	0	0
2	6292405	.	T	G	15	10	25	0	2	27	0	0
2	6292416	.	G	C	12	18	30	0	1	31	0	0
2	6292453	.	G	T	15	13	28	0	3	31	0	0
2	6323084	.	C	T	0	4	4	0	5	9	0	0
2	6326226	.	C	T	0	3	3	0	2	5	0	0
2	6334330	.	C	T	1	1	2	0	2	4	0	0
2	6334331	.	G	A	1	2	3	0	1	4	0	0
2	6734490	.	G	A	1	3	4	0	0	4	0	0
2	6790253	.	A	G	1	0	1	0	3	5	1	0
2	6805112	.	G	A	8	7	15	0	2	17	0	0
2	6886758	.	T	G	8	1	9	0	5	14	0	0
2	6886837	.	G	A	0	6	6	0	11	17	0	0
2	6888679	.	G	A	10	10	20	0	1	21	0	0
2	6931552	.	A	G	2	2	4	0	0	4	0	0
2	6948707	.	C	T	2	4	6	0	1	7	0	0
2	6952460	.	G	A	0	1	1	0	5	6	0	0
2	6958671	.	A	T	19	16	35	0	0	35	0	0
2	6958677	.	A	T	19	15	34	0	0	34	0	0
2	6958712	.	T	A	14	7	21	0	1	22	0	0
2	6958940	.	C	A	18	14	32	0	0	32	0	0
2	7042165	.	C	T	3	3	6	0	1	7	0	0
2	7046777	.	C	T	3	10	13	0	0	13	0	0
2	7051164	.	G	A	2	12	14	0	9	23	0	0
2	7056102	.	G	A	9	9	18	0	2	20	0	0
2	7056359	.	G	T	7	12	19	0	0	19	0	0
2	7056417	.	C	T	5	9	14	2	0	16	0	0
2	7056450	.	T	A	2	5	7	7	0	14	0	0
2	7056604	.	A	G	14	1	15	0	8	23	0	0
2	7056610	.	A	G	11	11	22	0	3	25	0	0
2	7056711	.	T	G	10	4	14	0	0	14	0	0
2	7056761	.	G	A	1	8	9	0	10	19	0	0
2	7056763	.	G	A	0	8	8	0	11	19	0	0
2	7057010	.	T	C	13	8	21	0	0	21	0	0
2	7132376	.	C	T	4	3	7	0	0	7	0	0
2	7137939	.	A	T	5	3	8	0	0	8	0	0
2	7150075	.	G	T	9	7	16	0	2	18	0	0
2	7150571	.	C	G	9	12	21	0	0	21	0	0
2	7150573	.	A	G	9	12	21	0	0	21	0	0
2	7150790	.	G	C	8	1	9	0	4	13	0	0
2	7150908	.	C	G	3	8	11	0	3	14	0	0
2	7150950	.	A	T	3	5	8	0	0	8	0	0
2	7150995	.	T	A	4	2	6	0	0	6	0	0
2	7150997	.	T	G	6	2	8	0	0	8	0	0
2	7151148	.	A	G	4	3	7	0	1	8	0	0
2	7151161	.	A	T	6	3	9	0	0	9	0	0
2	7151197	.	C	T	9	3	12	0	1	13	0	0
2	7151392	.	C	A	0	14	14	0	4	18	0	0
2	7151485	.	A	T	10	6	16	0	1	17	0	0
2	7151613	.	A	G	6	7	13	0	0	13	0	0
2	7151647	.	C	G	3	10	13	0	0	13	0	0
2	7151667	.	C	G	4	10	14	0	0	14	0	0
2	7151682	.	C	A	2	12	14	0	1	15	0	0
2	7151843	.	C	A	2	9	11	0	9	20	0	0
2	7152168	.	C	T	0	2	2	0	5	7	0	0
2	7152196	.	T	A	4	4	8	0	0	8	0	0
2	7152263	.	G	A	8	10	18	0	0	18	0	0
2	7152268	.	T	C	9	10	19	0	0	19	0	0
2	7152326	.	G	A	6	2	8	0	2	10	0	0
2	7152350	.	C	A	0	5	5	0	6	11	0	0
2	7152409	.	T	C	7	10	17	0	3	20	0	0
2	7152431	.	T	C	6	8	14	0	1	15	0	0
2	7152469	.	G	T	2	5	7	0	1	8	0	0
2	7152518	.	A	G	2	3	5	0	0	5	0	0
2	7152520	.	C	G	2	3	5	0	0	5	0	0
2	7152662	.	T	C	2	0	2	0	2	4	0	0
2	7153861	.	T	C	2	5	7	0	0	7	0	0
2	7153868	.	T	C	3	0	3	0	4	7	0	0
2	7154474	.	C	T	3	3	6	0	0	6	0	0
2	7154527	.	C	T	2	3	5	0	0	5	0	0
2	7154557	.	G	A	1	2	3	0	0	3	0	0
2	7155114	.	G	A	4	2	6	0	0	6	0	0
2	7163378	.	G	A	1	3	4	0	0	4	0	0
2	7168167	.	G	A	5	2	7	0	0	7	0	0
2	7168179	.	T	A	3	6	9	0	0	9	0	0
2	7168762	.	G	A	1	2	3	0	0	3	0	0
2	7238725	.	A	G	4	3	7	0	0	7	0	0
2	7239047	.	C	T	6	5	11	0	0	11	0	0
2	7239079	.	T	C	7	5	12	0	1	13	0	0
2	7239505	.	T	C	10	11	21	0	1	22	0	0
2	7239812	.	G	A	4	8	12	0	0	12	0	0
2	7239816	.	C	T	4	7	11	0	0	11	0	0
2	7239919	.	A	T	8	2	10	0	1	11	0	0
2	7240378	.	G	A	4	2	6	2	0	8	0	0
2	7240865	.	C	T	0	2	2	0	3	5	0	0
2	7241649	.	C	T	7	4	11	0	0	11	0	0
2	7241962	.	G	A	3	5	8	0	1	9	0	0
2	7241980	.	T	A	5	3	8	0	0	8	0	0
2	7422927	.	C	T	2	2	4	0	5	9	0	0
2	7720800	.	C	T	19	12	31	0	2	33	0	0
2	7720836	.	T	C	16	11	27	0	3	30	0	0
2	7720879	.	C	A	15	18	33	0	1	34	0	0
2	7726414	.	T	A	27	20	47	0	1	48	0	0
2	7726924	.	T	A	16	18	34	0	3	37	0	0
2	7764894	.	C	T	3	13	16	0	23	39	0	0
2	7764983	.	T	C	9	0	9	0	16	25	0	0
2	7765215	.	G	A	1	4	5	1	0	6	0	0
2	7765308	.	A	T	11	2	13	0	4	17	0	0
2	7765613	.	C	T	9	8	17	0	1	18	0	0
2	7765685	.	A	G	5	8	13	0	0	13	0	0
2	7767128	.	A	G	3	3	6	0	0	6	0	0
2	7767336	.	T	A	2	2	4	0	0	4	0	0
2	7767496	.	C	A	0	2	2	0	2	4	0	0
2	7767501	.	T	A	2	2	4	0	0	4	0	0
2	7767651	.	G	T	0	2	2	0	2	4	0	0
2	7768615	.	T	C	3	4	7	0	0	7	0	0
2	7768648	.	G	T	2	3	5	0	1	7	1	0
2	7923987	.	T	C	3	5	8	0	1	9	0	0
2	7924183	.	A	T	14	6	20	0	1	21	0	0
2	7924713	.	T	C	12	18	30	0	7	37	0	0
2	7924867	.	G	A	23	17	40	0	1	41	0	0
2	7937238	.	C	T	0	16	16	0	15	31	0	0
2	7943854	.	G	A	8	15	23	0	0	23	0	0
2	7954914	.	G	A	11	11	22	0	2	24	0	0
2	7956982	.	T	C	6	12	18	0	0	18	0	0
2	7959294	.	T	C	9	9	18	0	2	20	0	0
2	7979881	.	T	C	3	3	6	0	0	6	0	0
2	7979938	.	G	A	5	4	9	0	1	10	0	0
2	7982680	.	G	A	6	2	8	0	0	8	0	0
2	8017314	.	C	T	2	3	5	0	1	6	0	0
2	8060942	.	G	A	1	3	4	0	1	5	0	0
2	8062447	.	A	G	3	3	6	0	0	6	0	0
2	8065311	.	C	T	0	4	4	0	1	5	0	0
2	8072350	.	A	G	1	4	5	0	1	6	0	0
2	8112516	.	C	T	8	10	18	0	2	20	0	0
2	8112611	.	G	A	2	9	11	0	0	11	0	0
2	8112679	.	C	A	6	10	16	0	2	18	0	0
2	8112687	.	A	T	5	9	14	0	2	16	0	0
2	8113819	.	A	G	21	15	36	0	3	39	0	0
2	8114179	.	T	C	25	21	46	0	1	47	0	0
2	9978943	.	A	T	1	13	14	0	0	14	0	0
2	10477178	.	T	C	4	2	6	0	1	7	0	0
2	10477202	.	T	C	2	0	2	0	3	5	0	0
2	10604787	.	A	T	1	2	3	0	0	3	0	0
2	10605096	.	T	G	2	7	9	0	0	9	0	0
2	10605213	.	G	C	2	3	5	0	0	5	0	0
2	10606070	.	A	C	2	2	4	0	0	4	0	0
2	10606073	.	G	A	2	2	4	0	0	4	0	0
2	10606297	.	C	T	3	4	7	0	1	8	0	0
2	10606364	.	T	C	2	4	6	0	0	6	0	0
2	10606509	.	A	G	2	2	4	0	0	4	0	0
2	10606516	.	T	G	3	2	5	0	0	5	0	0
2	10642111	.	C	T	1	2	3	0	0	3	0	0
2	10642324	.	T	C	1	3	4	0	0	4	0	0
2	10678244	.	G	T	3	6	9	0	0	9	0	0
2	10685672	.	A	G	7	0	7	0	14	21	0	0
2	10685850	.	T	C	5	3	8	0	0	8	0	0
2	10685924	.	A	G	7	0	7	0	4	11	0	0
2	10686209	.	G	A	0	8	8	0	6	14	0	0
2	10686277	.	A	C	5	8	13	0	3	16	0	0
2	10686280	.	G	A	7	9	16	0	0	16	0	0
2	10686341	.	A	C	5	7	12	0	1	13	0	0
2	10686805	.	A	G	2	0	2	0	2	4	0	0
2	10686898	.	G	C	7	11	18	0	2	20	0	0
2	10687002	.	G	T	3	4	7	0	0	7	0	0
2	10698150	.	T	C	23	29	52	0	2	54	0	0
2	10791593	.	A	G	2	6	8	0	0	8	0	0
2	10808163	.	T	G	3	3	6	0	0	6	0	0
2	10813148	.	G	C	5	5	10	0	0	10	0	0
2	10813152	.	C	T	6	6	12	0	0	12	0	0
2	10813499	.	C	T	0	4	4	0	1	5	0	0
2	10813500	.	G	T	1	4	5	0	0	5	0	0
2	10829226	.	T	G	1	3	4	0	1	5	0	0
2	10829228	.	G	A	2	3	5	0	0	5	0	0
2	10841504	.	C	T	10	6	16	0	0	16	0	0
2	10841536	.	T	A	10	6	16	0	0	16	0	0
2	10846471	.	C	T	7	8	15	0	0	15	0	0
2	10857439	.	G	T	9	8	17	0	0	17	0	0
2	10878554	.	G	C	0	3	3	0	1	4	0	0
2	10878579	.	T	C	2	4	6	0	0	6	0	0
2	10881171	.	G	T	3	5	8	0	0	8	0	0
2	10881186	.	C	T	3	2	5	0	0	5	0	0
2	10914340	.	C	A	8	8	16	0	0	16	0	0
2	10916419	.	T	C	7	9	16	0	4	20	0	0
2	10926449	.	T	C	10	9	19	0	1	20	0	0
2	10931675	.	C	G	9	9	18	0	2	20	0	0
2	10938924	.	C	T	3	3	6	0	0	6	0	0
2	11022797	.	G	A	1	2	3	0	0	3	0	0
2	11110222	.	A	G	2	7	9	0	1	10	0	0
2	11117731	.	G	T	4	4	8	0	1	9	0	0
2	11125635	.	C	G	4	7	11	0	0	11	0	0
2	11125671	.	T	C	3	3	6	0	1	7	0	0
2	11125863	.	C	T	2	5	7	0	0	7	0	0
2	11125896	.	C	A	4	4	8	0	0	8	0	0
2	11126039	.	A	C	2	2	4	0	0	4	0	0
2	11483197	.	T	C	2	4	6	0	2	8	0	0
2	11490393	.	A	G	2	3	5	0	0	5	0	0
2	11497307	.	C	T	1	3	4	0	2	6	0	0
2	11497355	.	T	A	2	2	4	0	0	4	0	0
2	11503588	.	G	C	1	4	5	0	0	5	0	0
2	11503623	.	C	T	1	3	4	0	0	4	0	0
2	11508780	.	G	A	13	4	17	0	2	19	0	0
2	11509016	.	A	T	22	16	38	0	4	42	0	0
2	11509517	.	T	C	21	1	22	0	30	52	0	0
2	11633751	.	A	C	6	0	6	0	4	10	0	0
2	11640026	.	C	T	4	5	9	0	0	9	0	0
2	11640104	.	A	T	5	3	8	0	0	8	0	0
2	11648332	.	C	T	3	3	6	0	1	7	0	0
2	11651327	.	A	T	4	7	11	0	0	11	0	0
2	11651328	.	T	G	3	6	9	0	1	10	0	0
2	11651573	.	A	T	8	4	12	0	1	13	0	0
2	11656775	.	A	G	20	8	28	0	0	28	0	0
2	11661162	.	T	C	11	8	19	0	0	19	0	0
2	11662575	.	G	T	5	7	12	1	1	14	0	0
2	11662590	.	G	T	6	9	15	1	0	16	0	0
2	11662621	.	A	C	11	12	23	1	3	27	0	0
2	11830396	.	T	C	1	2	3	0	0	3	0	0
2	11832876	.	A	C	8	4	12	1	0	13	0	0
2	11849167	.	A	G	15	10	25	0	1	26	0	0
2	11849190	.	T	C	10	11	21	0	1	22	0	0
2	11849477	.	C	T	22	8	30	0	0	30	0	0
2	11849484	.	T	A	21	11	32	0	1	33	0	0
2	11849637	.	G	A	7	6	13	0	0	13	0	0
2	11849760	.	A	C	10	7	17	5	0	22	0	0
2	11849764	.	C	A	9	5	14	5	1	20	0	0
2	11849911	.	A	T	4	2	6	1	0	7	0	0
2	11850350	.	A	T	11	9	20	2	5	27	0	0
2	11850385	.	C	T	3	18	21	0	18	39	0	0
2	11850395	.	G	A	20	20	40	0	2	42	0	0
2	11850525	.	A	G	7	8	15	1	0	16	0	0
2	11850528	.	T	C	6	0	6	1	7	14	0	0
2	11850948	.	C	A	5	4	9	0	0	9	0	0
2	11851148	.	G	T	7	6	13	0	2	15	0	0
2	11851189	.	A	C	12	11	23	0	1	24	0	0
2	11851205	.	T	A	13	10	23	0	1	24	0	0
2	11851256	.	T	G	6	8	14	0	2	16	0	0
2	11851260	.	T	G	7	8	15	0	0	15	0	0
2	11851708	.	C	T	6	5	11	0	0	11	0	0
2	11851750	.	G	A	3	4	7	0	0	7	0	0
2	11853493	.	T	C	2	2	4	0	0	4	0	0
2	11936125	.	T	C	2	2	4	0	0	4	0	0
2	11939719	.	T	G	4	7	11	0	0	11	0	0
2	11944741	.	G	A	7	6	13	0	1	14	0	0
2	11945070	.	C	G	2	3	5	0	0	5	0	0
2	11945155	.	A	G	5	0	5	0	7	12	0	0
2	11945171	.	T	C	6	8	14	0	0	14	0	0
2	11945329	.	G	C	4	7	11	1	0	12	0	0
2	11945334	.	G	C	5	7	12	1	2	15	0	0
2	11945679	.	T	A	5	3	8	0	3	11	0	0
2	11945680	.	T	C	5	3	8	0	3	11	0	0
2	11945823	.	T	C	4	6	10	0	0	10	0	0
2	11965241	.	C	T	10	8	18	0	0	18	0	0
2	11965262	.	G	A	9	6	15	0	0	15	0	0
2	11976331	.	A	G	5	3	8	0	2	10	0	0
2	11976487	.	A	T	7	7	14	0	0	14	0	0
2	11976563	.	C	T	1	6	7	0	8	15	0	0
2	11976633	.	A	G	6	9	15	0	0	15	0	0
2	11976700	.	G	T	4	7	11	0	1	12	0	0
2	11976844	.	G	A	8	8	16	0	0	16	0	0
2	11976896	.	T	G	15	11	26	0	1	27	0	0
2	11977146	.	A	T	8	7	15	0	0	15	0	0
2	11977163	.	T	C	9	8	17	0	1	18	0	0
2	11991153	.	T	C	5	4	9	0	0	9	0	0
2	12105281	.	T	A	5	8	13	0	0	13	0	0
2	12106289	.	A	G	18	18	36	0	1	37	0	0
2	12106363	.	T	C	15	9	24	0	1	25	0	0
2	12106443	.	T	C	17	8	25	0	2	27	0	0
2	12106508	.	A	T	7	11	18	0	1	19	0	0
2	12106603	.	C	T	11	11	22	5	1	28	0	0
2	12106701	.	G	T	12	6	18	0	7	25	0	0
2	12106721	.	G	A	15	12	27	0	3	30	0	0
2	12106792	.	A	G	15	17	32	0	1	33	0	0
2	12106828	.	C	T	15	12	27	0	0	27	0	0
2	12106846	.	A	T	13	11	24	0	2	26	0	0
2	12106864	.	C	T	1	14	15	0	10	25	0	0
2	12106923	.	C	T	5	5	10	0	1	11	0	0
2	12107063	.	G	A	4	10	14	0	0	14	0	0
2	12107176	.	G	A	8	6	14	0	0	14	0	0
2	12107211	.	C	T	4	3	7	0	2	9	0	0
2	12107214	.	A	C	5	4	9	0	0	9	0	0
2	12107259	.	C	T	1	2	3	0	0	3	0	0
2	12107260	.	C	T	1	2	3	0	0	3	0	0
2	12107640	.	C	T	6	7	13	0	0	13	0	0
2	12107678	.	A	T	3	6	9	0	0	9	0	0
2	12107747	.	T	G	3	8	11	0	0	11	0	0
2	12107752	.	A	T	3	10	13	0	0	13	0	0
2	12107879	.	A	T	4	4	8	0	0	8	0	0
2	12107908	.	T	C	3	0	3	0	4	7	0	0
2	12107992	.	G	A	1	2	3	0	0	3	0	0
2	12107994	.	A	G	1	2	3	0	0	3	0	0
2	12108248	.	G	C	2	2	4	0	0	4	0	0
2	12108381	.	C	T	0	5	5	0	4	9	0	0
2	12108513	.	T	A	6	3	9	0	0	9	0	0
2	12108696	.	T	A	5	3	8	0	1	9	0	0
2	12108754	.	G	C	6	7	13	0	1	14	0	0
2	12109065	.	G	A	4	5	9	0	2	11	0	0
2	12109153	.	T	A	8	10	18	0	0	18	0	0
2	12109685	.	A	G	3	4	7	0	2	9	0	0
2	12116903	.	A	G	4	2	6	0	0	6	0	0
2	12265751	.	T	C	4	2	6	0	0	6	0	0
2	12265808	.	T	C	3	2	5	0	1	6	0	0
2	12265928	.	A	G	5	2	7	0	0	7	0	0
2	12269834	.	G	T	10	6	16	0	0	16	0	0
2	12279203	.	A	G	5	7	12	0	2	14	0	0
2	12279303	.	C	T	9	6	15	0	0	15	0	0
2	12279372	.	T	A	12	6	18	0	1	19	0	0
2	12279374	.	T	A	11	6	17	0	0	18	1	0
2	12279419	.	C	T	11	8	19	0	1	20	0	0
2	12279508	.	G	C	3	7	10	0	1	11	0	0
2	12279594	.	A	C	2	5	7	0	0	7	0	0
2	12302707	.	C	G	1	2	3	0	0	3	0	0
2	12376848	.	A	T	4	1	5	0	1	6	0	0
2	12376857	.	A	G	3	1	4	0	0	4	0	0
2	12378489	.	G	A	1	4	5	0	6	11	0	0
2	12378618	.	A	G	4	8	12	0	0	12	0	0
2	12379585	.	A	C	8	10	18	0	0	18	0	0
2	12379872	.	C	T	13	7	20	0	0	20	0	0
2	12386865	.	A	G	10	10	20	0	0	20	0	0
2	12394569	.	G	A	2	6	8	0	21	29	0	0
2	12396788	.	T	G	10	0	10	0	13	23	0	0
2	12396962	.	T	C	13	12	25	0	0	25	0	0
2	12396995	.	G	T	1	10	11	0	12	23	0	0
2	12397418	.	A	G	12	11	23	0	0	23	0	0
2	12404169	.	A	C	30	18	48	0	2	50	0	0
2	12404411	.	T	C	17	20	37	0	4	41	0	0
2	12406022	.	A	T	17	13	30	0	2	32	0	0
2	12406260	.	C	T	16	13	29	0	0	29	0	0
2	12406490	.	A	G	14	26	40	0	1	41	0	0
2	12407106	.	G	A	25	13	38	0	0	38	0	0
2	12407188	.	A	C	25	15	40	0	3	44	1	0
2	12407205	.	T	C	27	0	27	0	16	43	0	0
2	12407626	.	T	A	18	17	35	0	3	38	0	0
2	12407992	.	T	C	34	22	56	0	1	57	0	0
2	12408081	.	T	G	23	19	42	1	2	45	0	0
2	12410548	.	A	G	25	16	41	0	2	43	0	0
2	12417224	.	G	T	19	10	29	0	0	29	0	0
2	12420413	.	T	A	14	6	20	0	0	20	0	0
2	12429868	.	G	A	4	5	9	0	0	9	0	0
2	12436202	.	G	A	5	4	9	0	1	10	0	0
2	12632749	.	T	C	2	3	5	0	0	5	0	0
2	12998797	.	C	T	1	3	4	0	0	4	0	0
2	13000418	.	G	A	1	2	3	0	0	3	0	0
2	13003417	.	A	C	2	3	5	0	0	5	0	0
2	13003603	.	A	T	2	2	4	0	0	4	0	0
2	13007027	.	C	T	5	5	10	0	0	10	0	0
2	13007156	.	C	T	1	2	3	0	0	3	0	0
2	13007360	.	G	A	5	2	7	0	0	7	0	0
2	13007573	.	T	A	1	2	3	0	0	3	0	0
2	13010202	.	A	G	1	5	6	0	0	6	0	0
2	13010241	.	G	T	10	5	15	0	0	15	0	0
2	13010262	.	A	C	5	4	9	0	2	11	0	0
2	13014235	.	G	T	1	2	3	0	0	3	0	0
2	13020264	.	C	A	4	4	8	0	1	9	0	0
2	13020611	.	C	A	11	5	16	0	0	16	0	0
2	13023068	.	C	A	12	5	17	0	0	17	0	0
2	13026080	.	G	A	1	14	15	0	10	25	0	0
2	13035847	.	T	A	10	11	21	0	3	24	0	0
2	13035942	.	C	A	12	7	19	0	1	20	0	0
2	13036009	.	T	C	23	5	28	0	0	28	0	0
2	13036154	.	T	A	5	15	20	0	2	22	0	0
2	13036769	.	T	C	17	14	31	0	2	33	0	0
2	13036951	.	A	T	17	17	34	1	4	39	0	0
2	13037124	.	T	C	11	9	20	0	0	20	0	0
2	13185332	.	T	G	4	10	14	0	0	14	0	0
2	13185391	.	G	A	1	2	3	0	1	4	0	0
2	13185416	.	A	G	1	2	3	0	0	3	0	0
2	13186237	.	A	T	1	2	3	0	0	3	0	0
2	13186333	.	G	T	15	9	24	0	0	24	0	0
2	13186504	.	C	T	14	14	28	0	1	29	0	0
2	13186521	.	T	C	16	12	28	0	0	28	0	0
2	13186986	.	C	T	19	6	25	0	2	27	0	0
2	13187003	.	T	A	10	17	27	0	0	27	0	0
2	13187154	.	A	G	15	12	27	0	1	28	0	0
2	13187210	.	T	G	19	17	36	0	2	38	0	0
2	13187263	.	C	A	23	10	33	0	0	33	0	0
2	13187332	.	G	T	15	10	25	0	0	25	0	0
2	13187386	.	T	G	14	13	27	0	7	34	0	0
2	13187507	.	G	A	15	6	21	0	0	21	0	0
2	13187534	.	A	C	20	7	27	0	0	27	0	0
2	13187634	.	A	G	4	9	13	0	0	13	0	0
2	13187781	.	T	C	6	4	10	0	0	10	0	0
2	13187944	.	G	A	10	8	18	0	0	18	0	0
2	13187958	.	C	A	12	10	22	0	0	22	0	0
2	13188073	.	A	T	16	13	29	0	1	30	0	0
2	13215870	.	A	G	5	5	10	0	1	11	0	0
2	13215967	.	G	A	1	4	5	0	2	7	0	0
2	13223761	.	T	C	8	3	11	0	0	11	0	0
2	13223815	.	T	A	6	7	13	0	0	13	0	0
2	13223853	.	A	G	7	6	13	0	0	13	0	0
2	13223864	.	T	A	6	4	10	0	1	11	0	0
2	13223925	.	A	G	3	4	7	0	0	7	0	0
2	13224229	.	C	T	3	6	9	0	1	10	0	0
2	13224341	.	A	G	3	6	9	0	0	9	0	0
2	13224362	.	T	A	2	5	7	0	0	7	0	0
2	13237666	.	C	T	7	7	14	0	0	14	0	0
2	13237699	.	A	G	5	4	9	0	0	9	0	0
2	13259024	.	C	T	3	2	5	0	0	5	0	0
2	13259120	.	G	T	5	2	7	0	0	7	0	0
2	13265122	.	T	A	3	7	10	0	1	11	0	0
2	13265191	.	G	A	5	3	8	0	4	12	0	0
2	13266565	.	A	G	3	3	6	0	1	7	0	0
2	13267007	.	C	T	1	2	3	0	0	3	0	0
2	13694984	.	C	T	4	2	6	0	0	6	0	0
2	13710826	.	T	C	22	9	31	0	0	31	0	0
2	13717388	.	C	T	11	13	24	0	1	25	0	0
2	13717651	.	A	G	5	3	8	0	1	9	0	0
2	13743907	.	A	T	1	3	4	0	0	4	0	0
2	13764646	.	C	G	4	0	4	0	3	7	0	0
2	13773911	.	G	C	4	5	9	0	0	9	0	0
2	13800275	.	G	C	4	5	9	0	0	9	0	0
2	13927434	.	A	G	2	0	2	0	2	4	0	0
2	13940480	.	C	T	4	6	10	0	0	10	0	0
2	14278173	.	A	T	5	6	11	0	0	11	0	0
2	14298495	.	G	A	5	12	17	0	1	18	0	0
2	14366886	.	G	C	6	0	6	0	14	20	0	0
2	14445180	.	A	G	3	5	8	0	0	8	0	0
2	14445697	.	T	C	4	4	8	0	0	8	0	0
2	14447196	.	G	A	2	5	7	0	0	7	0	0
2	14456081	.	C	T	1	3	4	0	3	7	0	0
2	14485527	.	C	G	2	2	4	0	0	4	0	0
2	14998640	.	C	T	3	2	5	0	0	5	0	0
2	14998651	.	T	A	3	2	5	0	0	5	0	0
2	14998699	.	T	A	3	3	6	0	0	6	0	0
2	14998764	.	A	G	5	5	10	0	1	11	0	0
2	15031023	.	G	A	2	5	7	0	1	8	0	0
2	15031096	.	A	C	5	0	5	0	7	12	0	0
2	15035212	.	A	G	1	2	3	0	0	3	0	0
2	15035425	.	A	G	9	3	12	0	1	13	0	0
2	15035485	.	A	C	1	4	5	0	1	6	0	0
2	15036227	.	A	G	2	3	5	0	1	6	0	0
2	15070250	.	T	C	2	2	4	0	0	4	0	0
2	15074491	.	C	T	1	5	6	0	1	7	0	0
2	15074672	.	T	C	1	5	6	0	2	8	0	0
2	15075134	.	G	A	0	2	2	0	1	3	0	0
2	15075225	.	G	A	0	2	2	0	1	3	0	0
2	15102079	.	C	T	1	2	3	0	0	3	0	0
2	15109639	.	A	T	5	2	7	0	1	8	0	0
2	15109704	.	T	C	7	6	13	0	0	13	0	0
2	15109884	.	A	G	6	5	11	0	0	11	0	0
2	15110014	.	T	C	7	5	12	0	0	12	0	0
2	15111806	.	C	T	0	4	4	0	5	9	0	0
2	15111948	.	C	T	7	6	13	0	1	14	0	0
2	15112025	.	G	T	4	3	7	0	0	7	0	0
2	15114286	.	C	T	1	3	4	0	3	7	0	0
2	15116355	.	T	C	2	3	5	0	0	5	0	0
2	15116356	.	C	T	3	3	6	0	0	6	0	0
2	15344015	.	G	A	3	2	5	0	0	5	0	0
2	15344210	.	C	A	0	3	3	0	5	8	0	0
2	15864127	.	C	T	2	2	4	0	1	5	0	0
2	15864466	.	C	T	4	2	6	0	0	6	0	0
2	15864514	.	T	C	3	7	10	0	0	10	0	0
2	15864586	.	C	T	5	2	7	0	0	7	0	0
2	15900093	.	G	A	0	6	6	0	5	11	0	0
2	15942458	.	G	T	7	13	20	0	1	21	0	0
2	15942544	.	A	G	18	12	30	0	0	30	0	0
2	15942636	.	A	G	2	7	9	1	1	11	0	0
2	15942671	.	G	A	2	4	6	0	1	7	0	0
2	15942674	.	A	T	2	5	7	0	0	7	0	0
2	15942774	.	G	A	7	13	20	0	1	21	0	0
2	15942817	.	T	C	13	10	23	0	0	23	0	0
2	15942843	.	C	T	12	9	21	0	0	21	0	0
2	15942877	.	C	T	11	10	21	0	0	21	0	0
2	15942897	.	C	G	5	10	15	0	3	18	0	0
2	15943022	.	C	T	8	4	12	0	0	12	0	0
2	15943048	.	G	T	8	5	13	0	1	14	0	0
2	15943120	.	T	G	11	2	13	0	0	13	0	0
2	15943267	.	G	A	0	7	7	0	7	14	0	0
2	15993771	.	C	T	0	5	5	0	2	7	0	0
2	16164268	.	T	G	7	0	7	0	7	14	0	0
2	16165809	.	C	A	12	9	21	0	2	23	0	0
2	16169397	.	A	G	7	12	19	1	1	21	0	0
2	16172013	.	C	A	8	7	15	0	1	16	0	0
2	16172040	.	C	T	5	4	9	0	0	9	0	0
2	16174117	.	A	C	3	2	5	0	1	7	1	0
2	16174243	.	A	G	2	0	2	0	4	6	0	0
2	16176308	.	G	A	2	3	5	0	2	7	0	0
2	16177590	.	C	G	4	3	7	0	0	7	0	0
2	16185079	.	A	G	1	2	3	0	1	4	0	0
2	16188629	.	G	A	0	3	3	0	1	4	0	0
2	16188660	.	C	T	1	4	5	0	0	5	0	0
2	16188834	.	G	A	0	4	4	0	3	7	0	0
2	16191697	.	G	C	2	13	15	0	17	32	0	0
2	16191718	.	G	A	2	9	11	0	17	28	0	0
2	16191829	.	C	T	16	9	25	0	1	26	0	0
2	16191841	.	A	C	9	17	26	0	0	26	0	0
2	16191892	.	T	G	10	1	11	0	10	21	0	0
2	16194139	.	A	T	3	2	5	0	0	5	0	0
2	16198807	.	T	C	8	10	18	0	1	19	0	0
2	16198864	.	T	C	16	0	16	0	15	31	0	0
2	16199018	.	G	A	28	31	59	0	2	62	1	0
2	16199331	.	A	G	32	15	47	0	4	51	0	0
2	16199332	.	G	A	30	19	49	0	1	50	0	0
2	16199411	.	C	T	7	29	36	0	20	56	0	0
2	16204716	.	C	G	4	13	17	1	28	46	0	0
2	16206766	.	G	T	29	18	47	0	0	47	0	0
2	16206840	.	C	T	25	16	41	0	1	42	0	0
2	16207151	.	G	A	12	16	28	0	3	31	0	0
2	16209753	.	G	A	20	20	40	0	4	44	0	0
2	16212643	.	G	A	8	4	12	0	2	14	0	0
2	16212924	.	A	G	7	9	16	0	0	16	0	0
2	16212957	.	A	G	11	10	21	0	0	21	0	0
2	16216830	.	G	T	13	5	18	0	1	19	0	0
2	16254439	.	T	G	1	2	3	0	0	3	0	0
2	16254659	.	C	T	0	2	2	0	3	5	0	0
2	16269683	.	G	T	1	2	3	0	0	3	0	0
2	16376143	.	T	C	2	2	4	0	0	4	0	0
2	16376947	.	G	A	1	2	3	0	0	3	0	0
2	16377559	.	G	A	2	2	4	0	0	4	0	0
2	16387964	.	G	A	1	5	6	0	0	6	0	0
2	16397538	.	A	G	1	2	3	0	0	3	0	0
2	16397877	.	C	T	0	3	3	0	2	5	0	0
2	16452973	.	T	A	4	2	6	0	0	6	0	0
2	16454119	.	A	G	6	3	9	0	0	9	0	0
2	16454182	.	T	A	3	6	9	0	1	10	0	0
2	16463862	.	T	C	2	1	3	0	1	4	0	0
2	16466383	.	A	G	1	0	1	0	6	7	0	0
2	16466720	.	A	G	9	0	9	0	6	15	0	0
2	16472243	.	T	C	14	13	27	0	0	27	0	0
2	16472284	.	T	C	8	6	14	0	0	14	0	0
2	16472288	.	C	G	7	0	7	0	5	12	0	0
2	16475415	.	C	G	13	1	14	0	13	27	0	0
2	16475469	.	C	A	14	17	31	0	0	31	0	0
2	16475484	.	G	A	2	19	21	0	10	31	0	0
2	16478577	.	G	A	2	10	12	0	9	21	0	0
2	16478587	.	A	G	9	9	18	0	1	19	0	0
2	16548120	.	A	T	13	11	24	0	3	27	0	0
2	16548178	.	C	T	1	8	9	0	6	15	0	0
2	16548286	.	T	C	18	1	19	0	8	27	0	0
2	16548289	.	C	T	17	10	27	0	0	27	0	0
2	16548514	.	T	C	22	8	30	0	1	31	0	0
2	16565384	.	T	G	3	5	8	0	0	8	0	0
2	16565560	.	G	T	7	9	16	0	0	16	0	0
2	16594896	.	T	A	4	8	12	0	1	13	0	0
2	16618156	.	A	G	1	2	3	0	0	3	0	0
2	16631338	.	G	A	2	2	4	0	0	4	0	0
2	16631570	.	C	T	2	4	6	0	0	6	0	0
2	16632812	.	T	C	1	4	5	0	0	5	0	0
2	16637276	.	G	A	1	3	4	0	0	4	0	0
2	16637277	.	A	T	1	3	4	0	0	4	0	0
2	16638459	.	C	T	4	4	8	0	0	8	0	0
2	16639434	.	G	A	3	3	6	0	0	6	0	0
2	16639585	.	G	A	2	3	5	0	0	5	0	0
2	16639684	.	G	A	6	2	8	0	1	9	0	0
2	16639827	.	G	T	3	6	9	1	0	10	0	0
2	16643718	.	T	C	4	4	8	0	0	8	0	0
2	16645821	.	A	C	6	6	12	0	1	13	0	0
2	16646117	.	C	T	3	5	8	1	1	10	0	0
2	16646222	.	C	T	4	8	12	0	0	12	0	0
2	16646275	.	G	C	7	7	14	0	0	14	0	0
2	16646377	.	T	A	6	6	12	0	0	12	0	0
2	16646519	.	A	T	9	4	13	1	0	14	0	0
2	16646808	.	A	C	3	3	6	0	0	6	0	0
2	16698199	.	A	G	7	3	10	0	0	10	0	0
2	16698384	.	C	A	8	4	12	0	0	13	1	0
2	16699560	.	C	T	11	7	18	0	0	18	0	0
2	16699565	.	A	T	9	9	18	0	1	19	0	0
2	16699595	.	T	C	15	14	29	0	4	33	0	0
2	16702570	.	G	A	0	7	7	0	7	14	0	0
2	16706549	.	A	C	28	24	52	0	3	55	0	0
2	16706563	.	T	C	27	29	56	0	1	57	0	0
2	16706618	.	G	A	2	20	22	0	23	45	0	0
2	16706737	.	G	A	2	21	23	0	16	39	0	0
2	16706994	.	T	C	18	10	28	0	3	31	0	0
2	16707014	.	C	A	23	12	35	0	2	37	0	0
2	16707030	.	G	T	26	14	40	0	4	45	1	0
2	16707056	.	C	G	21	16	37	0	4	41	0	0
2	16707509	.	C	A	16	25	41	0	2	43	0	0
2	16707718	.	G	A	7	4	11	0	1	12	0	0
2	16731783	.	C	T	2	4	6	0	1	7	0	0
2	16735292	.	C	A	12	9	21	0	0	21	0	0
2	16790968	.	C	G	2	2	4	0	0	4	0	0
2	16791991	.	T	G	3	5	8	0	0	8	0	0
2	16792030	.	A	T	1	5	6	0	0	6	0	0
2	16819317	.	A	G	2	3	5	0	0	5	0	0
2	16821329	.	A	C	4	3	7	0	0	7	0	0
2	16821788	.	A	T	3	2	5	0	0	5	0	0
2	16822370	.	A	C	1	2	3	0	1	4	0	0
2	16824536	.	T	C	2	2	4	0	0	4	0	0
2	16826899	.	T	C	4	2	6	0	2	8	0	0
2	16827129	.	G	A	9	4	13	0	0	13	0	0
2	16829221	.	C	A	3	5	8	0	0	8	0	0
2	16829555	.	G	A	1	2	3	0	7	10	0	0
2	16833650	.	C	A	9	12	21	0	1	22	0	0
2	16833884	.	A	T	9	14	23	0	0	23	0	0
2	16837849	.	C	T	8	10	18	3	1	22	0	0
2	16857828	.	G	A	0	2	2	0	1	3	0	0
2	16862267	.	C	T	5	5	10	0	0	10	0	0
2	16862271	.	T	C	4	5	9	0	2	11	0	0
2	16866933	.	G	A	0	2	2	0	5	7	0	0
2	16867606	.	A	T	1	5	6	0	0	6	0	0
2	16867621	.	T	G	1	7	8	0	0	8	0	0
2	16885660	.	C	T	3	3	6	0	0	6	0	0
2	16885671	.	T	C	3	2	5	0	1	6	0	0
2	16885720	.	A	G	3	2	5	0	1	6	0	0
2	16885857	.	A	C	2	3	5	0	1	6	0	0
2	17267621	.	G	A	2	2	4	0	0	4	0	0
2	17267626	.	G	A	1	2	3	0	0	3	0	0
2	17267684	.	A	G	1	1	2	0	1	3	0	0
2	17267694	.	G	A	2	1	3	0	0	3	0	0
2	17450396	.	A	C	3	1	4	0	0	4	0	0
2	17450424	.	T	C	3	1	4	0	2	6	0	0
2	17450726	.	A	T	6	3	9	0	0	9	0	0
2	17450744	.	G	A	4	7	11	0	1	12	0	0
2	17450967	.	T	C	8	1	9	0	6	15	0	0
2	17451198	.	G	A	6	7	13	0	1	14	0	0
2	17451233	.	T	C	6	7	13	0	0	13	0	0
2	17451327	.	A	G	7	16	23	0	2	25	0	0
2	17451375	.	G	A	8	5	13	0	0	13	0	0
2	17451387	.	T	C	6	5	11	0	0	11	0	0
2	17468914	.	T	C	4	2	6	0	0	6	0	0
2	17468947	.	C	T	3	4	7	0	1	8	0	0
2	17469170	.	G	A	3	1	4	0	1	5	0	0
2	17469413	.	T	C	2	0	2	0	5	7	0	0
2	17469441	.	A	G	1	4	5	0	0	5	0	0
2	17473497	.	T	G	1	2	3	0	0	3	0	0
2	17477335	.	G	T	4	3	7	0	0	7	0	0
2	17578471	.	A	T	2	1	3	0	1	4	0	0
2	17578593	.	A	G	12	14	26	0	1	27	0	0
2	17578658	.	T	A	15	13	28	0	3	31	0	0
2	17578853	.	C	T	17	26	43	0	2	45	0	0
2	17579033	.	G	A	10	10	20	0	4	24	0	0
2	17579109	.	A	C	21	1	22	1	8	32	1	0
2	17579110	.	A	G	22	7	29	1	2	33	1	0
2	17579324	.	T	C	13	12	25	0	0	25	0	0
2	17579639	.	G	A	10	4	14	0	1	15	0	0
2	17579888	.	A	C	17	1	18	0	24	42	0	0
2	17579926	.	G	C	23	0	23	0	25	48	0	0
2	17604640	.	G	C	3	3	6	0	1	7	0	0
2	17617513	.	T	C	4	5	9	0	0	9	0	0
2	17629935	.	T	C	4	6	10	0	0	10	0	0
2	17644591	.	G	A	8	7	15	0	0	15	0	0
2	17651370	.	A	G	6	5	11	0	1	12	0	0
2	17656439	.	A	T	2	5	7	0	0	7	0	0
2	17656562	.	A	G	1	4	5	0	0	5	0	0
2	17688318	.	A	C	4	1	5	0	3	8	0	0
2	17698505	.	T	C	2	3	5	0	0	5	0	0
2	17704701	.	G	A	1	2	3	0	0	3	0	0
2	19272173	.	G	A	4	2	6	0	0	6	0	0
2	21766476	.	T	A	9	3	12	0	0	12	0	0
2	22396145	.	G	A	1	6	7	0	1	8	0	0
2	22733715	.	T	C	1	6	7	0	0	7	0	0
2	22791205	.	T	C	3	2	5	0	0	5	0	0
2	22799294	.	T	A	11	20	31	0	1	32	0	0
2	22802004	.	T	A	23	19	42	0	1	43	0	0
2	22802117	.	A	T	17	18	35	0	3	39	1	0
2	22802524	.	T	A	21	16	37	0	1	38	0	0
2	22803074	.	G	A	1	11	12	0	30	42	0	0
2	22803128	.	G	T	17	28	45	0	4	49	0	0
2	22803467	.	A	G	23	2	25	0	32	57	0	0
2	22855932	.	C	T	2	2	4	0	0	4	0	0
2	22860541	.	C	T	3	5	8	0	0	8	0	0
2	22860749	.	T	A	1	2	3	0	1	4	0	0
2	22933377	.	G	T	2	5	7	0	0	7	0	0
2	22933381	.	C	T	4	2	6	0	0	6	0	0
2	22933455	.	T	C	3	5	8	0	1	9	0	0
2	22944185	.	C	T	4	2	6	0	0	6	0	0
2	22957533	.	G	A	1	2	3	0	0	3	0	0
2	22962013	.	A	G	2	5	7	0	0	7	0	0
2	22970361	.	A	G	1	5	6	0	0	6	0	0
2	22970764	.	G	A	2	4	6	0	0	6	0	0
2	22971012	.	T	A	10	11	21	0	0	21	0	0
2	22979768	.	G	T	4	8	12	0	0	12	0	0
2	22993548	.	G	C	3	3	6	0	0	6	0	0
2	22994264	.	T	G	12	6	18	0	0	18	0	0
2	22994322	.	C	T	5	7	12	0	0	12	0	0
2	22994327	.	G	A	6	5	11	0	1	12	0	0
2	23004238	.	T	C	7	4	11	0	0	11	0	0
2	23023121	.	G	A	0	2	2	0	2	4	0	0
2	23023466	.	C	G	2	3	5	0	0	5	0	0
2	23023524	.	G	T	3	2	5	0	0	5	0	0
2	23024677	.	A	G	2	3	5	0	0	5	0	0
2	23024704	.	A	C	4	2	6	0	1	7	0	0
2	23071236	.	G	A	7	8	15	0	1	16	0	0
2	23077432	.	A	G	6	5	11	6	0	17	0	0
2	23078244	.	T	C	18	23	41	0	2	43	0	0
2	23078532	.	T	C	6	9	15	0	0	15	0	0
2	23082894	.	G	C	2	2	4	0	1	5	0	0
2	23082912	.	C	T	2	2	4	0	1	5	0	0
2	23085188	.	T	A	1	3	4	0	1	5	0	0
2	23085189	.	T	G	1	3	4	0	1	5	0	0
2	23090867	.	C	T	2	2	4	0	0	4	0	0
2	23098385	.	A	T	5	4	9	0	0	9	0	0
2	23098416	.	G	A	3	4	7	0	0	7	0	0
2	23098856	.	T	A	7	3	10	0	0	10	0	0
2	23099090	.	G	T	1	5	6	0	0	6	0	0
2	23099104	.	T	C	2	4	6	0	0	6	0	0
2	23165559	.	A	G	2	6	8	0	0	8	0	0
2	23172137	.	C	T	0	3	3	0	2	5	0	0
2	23232884	.	T	C	6	5	11	0	0	11	0	0
2	23238502	.	C	T	9	11	20	0	0	20	0	0
2	23245557	.	C	T	1	8	9	0	0	9	0	0
2	23254158	.	G	A	8	6	14	0	0	14	0	0
2	23274792	.	C	T	9	12	21	0	1	22	0	0
2	23292123	.	A	T	8	21	29	0	0	30	1	0
2	23292359	.	G	A	1	7	8	0	11	19	0	0
2	23292432	.	C	A	9	11	20	0	4	24	0	0
2	23292490	.	C	G	10	18	28	0	1	29	0	0
2	23292549	.	C	A	9	6	15	0	2	17	0	0
2	23292690	.	T	A	17	13	30	0	1	31	0	0
2	23292776	.	G	A	8	7	15	0	1	16	0	0
2	23292847	.	T	C	1	3	4	0	0	4	0	0
2	23293123	.	G	C	6	13	19	0	3	22	0	0
2	23293230	.	A	T	18	12	30	1	2	33	0	0
2	23293376	.	C	A	11	11	22	0	0	22	0	0
2	23352323	.	G	A	7	12	19	0	1	20	0	0
2	23361208	.	C	T	20	12	32	0	2	34	0	0
2	23361359	.	T	C	14	15	29	0	2	31	0	0
2	23379480	.	G	C	1	3	4	0	0	4	0	0
2	23379532	.	G	A	6	4	10	0	0	10	0	0
2	23379588	.	C	T	9	6	15	0	1	16	0	0
2	23379861	.	G	A	3	5	8	0	0	8	0	0
2	23380621	.	C	A	5	9	14	0	0	14	0	0
2	23381056	.	A	G	4	4	8	0	1	9	0	0
2	23387139	.	C	T	1	2	3	0	0	3	0	0
2	23711756	.	C	T	1	2	3	0	1	4	0	0
2	23711963	.	T	C	1	3	4	0	0	4	0	0
2	23716802	.	A	G	3	0	3	0	8	11	0	0
2	23721974	.	C	A	2	2	4	0	0	4	0	0
2	23722311	.	C	T	2	2	4	0	0	4	0	0
2	23722338	.	G	A	1	2	3	0	0	3	0	0
2	23722414	.	A	G	1	0	1	0	4	5	0	0
2	23722444	.	A	T	2	4	6	0	0	6	0	0
2	23722518	.	A	G	3	0	3	0	4	7	0	0
2	23722828	.	G	A	10	5	15	0	2	17	0	0
2	23722849	.	T	C	8	10	18	0	0	18	0	0
2	23723521	.	A	T	3	5	8	0	0	8	0	0
2	23723571	.	G	A	2	3	5	0	1	6	0	0
2	23723594	.	A	G	2	0	2	0	6	8	0	0
2	23723638	.	A	T	4	3	7	0	1	8	0	0
2	23724535	.	T	G	6	4	10	0	1	11	0	0
2	23725075	.	G	A	12	5	17	0	0	17	0	0
2	23725159	.	T	C	8	8	16	0	0	16	0	0
2	23725184	.	C	A	7	7	14	0	2	16	0	0
2	23725239	.	C	T	6	4	10	0	1	11	0	0
2	23725608	.	A	T	9	14	23	0	1	24	0	0
2	23725754	.	A	T	5	5	10	0	2	12	0	0
2	23725756	.	A	T	6	5	11	0	1	12	0	0
2	23725820	.	T	C	3	2	5	0	0	5	0	0
2	23725906	.	C	A	6	8	14	0	1	15	0	0
2	23725980	.	A	C	5	2	7	0	0	7	0	0
2	23725986	.	G	T	6	3	9	0	0	9	0	0
2	23726290	.	T	C	19	10	29	0	1	30	0	0
2	23726312	.	G	A	18	16	34	0	1	35	0	0
2	23726353	.	G	A	20	15	35	0	0	35	0	0
2	23726393	.	C	T	15	13	28	0	2	30	0	0
2	23796473	.	T	A	1	2	3	0	0	3	0	0
2	23796486	.	A	G	1	0	1	0	2	3	0	0
2	23803219	.	G	A	0	2	2	0	1	3	0	0
2	23804908	.	G	T	1	1	2	0	1	3	0	0
2	23816293	.	A	C	2	2	4	0	0	4	0	0
2	23817097	.	A	T	1	3	4	0	0	4	0	0
2	23817497	.	C	T	1	2	3	0	0	3	0	0
2	23818209	.	A	T	1	3	4	0	0	4	0	0
2	23818580	.	T	A	5	2	7	0	0	7	0	0
2	23818790	.	A	G	1	0	1	0	2	3	0	0
2	23819302	.	C	G	3	2	5	0	0	5	0	0
2	23819603	.	T	C	5	4	9	0	0	9	0	0
2	23819640	.	T	A	5	2	7	0	0	7	0	0
2	23819862	.	A	C	4	3	7	0	0	7	0	0
2	23820027	.	T	G	3	2	5	0	0	5	0	0
2	23937227	.	G	A	7	4	11	0	0	11	0	0
2	23943510	.	G	A	1	3	4	0	0	4	0	0
2	24028285	.	T	C	1	0	1	0	2	3	0	0
2	24202456	.	G	A	2	3	5	0	0	5	0	0
2	24218927	.	G	A	1	12	13	0	14	27	0	0
2	24222069	.	A	C	15	21	36	0	0	37	1	0
2	24223991	.	A	G	15	9	24	0	7	31	0	0
2	24238629	.	C	T	16	12	28	0	0	28	0	0
2	24248657	.	A	G	2	39	41	0	3	44	0	0
2	24249037	.	T	A	22	18	40	0	0	40	0	0
2	24249211	.	A	G	25	26	51	0	3	54	0	0
2	24249849	.	C	T	11	7	18	2	1	21	0	0
2	24250303	.	C	T	23	17	40	0	1	41	0	0
2	24250345	.	A	C	22	14	36	0	0	36	0	0
2	24250482	.	C	T	18	18	36	0	1	37	0	0
2	24251294	.	G	A	3	37	40	0	24	64	0	0
2	24251430	.	A	G	25	29	54	1	7	62	0	0
2	24251800	.	G	A	35	33	68	0	3	71	0	0
2	24251848	.	T	C	33	31	64	0	5	69	0	0
2	24252088	.	C	T	39	32	71	0	3	74	0	0
2	24310822	.	C	T	14	16	30	0	1	31	0	0
2	24310850	.	G	C	15	15	30	0	1	31	0	0
2	24310897	.	G	A	14	21	35	0	0	35	0	0
2	24311035	.	T	C	20	0	20	0	19	39	0	0
2	24311045	.	T	C	19	2	21	0	22	43	0	0
2	24311118	.	T	A	8	11	19	1	0	20	0	0
2	24311697	.	C	T	27	12	39	0	6	45	0	0
2	24311703	.	A	G	25	14	39	0	2	41	0	0
2	24311793	.	G	C	19	24	43	0	1	44	0	0
2	24311879	.	A	G	31	12	43	0	3	46	0	0
2	24313884	.	T	C	8	8	16	0	0	16	0	0
2	24314185	.	T	A	5	7	12	0	0	12	0	0
2	24315047	.	A	G	3	8	11	0	0	11	0	0
2	24315068	.	A	G	3	9	12	0	0	12	0	0
2	24316545	.	C	T	6	4	10	0	1	11	0	0
2	24317537	.	G	A	8	10	18	0	0	18	0	0
2	24319851	.	T	C	14	5	19	0	2	21	0	0
2	24319945	.	T	G	1	3	4	0	0	4	0	0
2	24321853	.	T	C	11	0	11	0	7	18	0	0
2	24322180	.	G	T	21	9	30	0	0	30	0	0
2	24326455	.	A	G	11	13	24	0	0	24	0	0
2	24326509	.	G	A	5	10	15	0	0	15	0	0
2	24331297	.	T	C	6	3	9	0	1	10	0	0
2	24335246	.	G	A	3	2	5	0	0	5	0	0
2	24348915	.	G	A	1	7	8	0	0	8	0	0
2	24376511	.	C	T	4	3	7	0	0	7	0	0
2	24385271	.	T	G	7	5	12	0	0	12	0	0
2	24385603	.	G	A	1	12	13	0	7	20	0	0
2	24385633	.	C	T	5	13	18	0	2	20	0	0
2	24385885	.	T	A	12	0	12	0	1	13	0	0
2	24386286	.	A	T	4	3	7	0	0	7	0	0
2	24414062	.	G	A	7	11	18	0	2	20	0	0
2	24432538	.	G	A	4	2	6	0	1	7	0	0
2	24461305	.	C	T	0	5	5	0	3	8	0	0
2	24461957	.	G	A	3	7	10	0	0	10	0	0
2	24508902	.	A	G	1	0	1	0	3	4	0	0
2	24541478	.	G	A	0	2	2	0	2	4	0	0
2	24548863	.	C	A	1	4	5	0	0	5	0	0
2	24549532	.	G	A	2	3	5	0	0	5	0	0
2	24558452	.	A	G	8	1	9	0	0	9	0	0
2	24558465	.	C	T	6	3	9	0	0	9	0	0
2	24558512	.	A	T	9	4	13	0	1	14	0	0
2	24558545	.	A	G	12	3	15	0	0	15	0	0
2	24558570	.	C	T	11	4	15	0	0	15	0	0
2	24559091	.	A	T	5	2	7	0	1	8	0	0
2	24560167	.	T	C	3	0	3	0	10	13	0	0
2	24560218	.	G	C	3	2	5	0	9	14	0	0
2	24560248	.	A	G	2	8	10	0	1	11	0	0
2	24560794	.	T	A	1	2	3	0	0	3	0	0
2	24561244	.	A	G	3	2	5	0	0	5	0	0
2	24565123	.	A	G	6	3	9	0	0	9	0	0
2	24682951	.	T	C	15	9	24	0	1	25	0	0
2	24683093	.	A	G	7	4	11	0	6	17	0	0
2	24701330	.	G	A	2	2	4	0	1	5	0	0
2	24737749	.	C	T	2	2	4	0	0	4	0	0
2	24737776	.	C	T	1	2	3	0	0	3	0	0
2	24751165	.	T	C	3	5	8	0	0	8	0	0
2	24751286	.	C	T	1	2	3	0	0	3	0	0
2	24751567	.	T	A	3	6	9	0	0	9	0	0
2	24751608	.	A	T	2	4	6	0	1	7	0	0
2	24751991	.	A	G	3	8	11	0	0	11	0	0
2	24752048	.	C	T	2	8	10	0	1	11	0	0
2	24752157	.	G	A	3	5	8	0	0	8	0	0
2	24752179	.	C	T	5	9	14	0	0	14	0	0
2	24752247	.	A	G	8	3	11	0	0	11	0	0
2	24752737	.	A	G	5	4	9	0	1	10	0	0
2	24753062	.	T	C	7	9	16	0	1	17	0	0
2	24753348	.	A	G	5	2	7	0	0	7	0	0
2	24753492	.	G	C	4	9	13	0	0	13	0	0
2	24753535	.	A	C	2	8	10	0	0	10	0	0
2	24754310	.	A	G	2	2	4	0	0	4	0	0
2	24754489	.	G	A	5	2	7	0	0	7	0	0
2	24754565	.	A	T	9	4	13	0	0	13	0	0
2	24754597	.	C	T	7	5	12	0	1	13	0	0
2	24754641	.	G	A	1	9	10	0	7	17	0	0
2	24754783	.	C	T	18	12	30	0	2	32	0	0
2	24754794	.	G	A	13	18	31	0	1	32	0	0
2	24754883	.	T	A	11	17	28	0	0	28	0	0
2	24755018	.	T	C	16	14	30	0	0	30	0	0
2	24763350	.	C	A	1	3	4	0	0	4	0	0
2	24766941	.	G	A	5	6	11	0	0	11	0	0
2	24773684	.	C	A	2	2	4	0	1	5	0	0
2	24774344	.	C	T	4	6	10	0	0	10	0	0
2	24863597	.	T	C	1	3	4	0	0	4	0	0
2	24863918	.	T	G	1	1	2	0	1	3	0	0
2	24864089	.	A	C	3	2	5	0	0	5	0	0
2	24864387	.	A	G	4	3	7	0	0	7	0	0
2	24865187	.	C	A	5	3	8	0	0	8	0	0
2	24866075	.	G	C	6	9	15	0	1	16	0	0
2	24873047	.	G	A	7	12	19	0	1	20	0	0
2	24875201	.	T	C	4	11	15	0	1	16	0	0
2	24876864	.	T	A	10	6	16	0	3	19	0	0
2	24877010	.	A	G	6	11	17	0	4	21	0	0
2	24877227	.	C	T	8	6	14	0	1	15	0	0
2	24877276	.	A	C	8	9	17	0	0	17	0	0
2	24877294	.	T	C	7	9	16	0	1	17	0	0
2	24877327	.	T	C	8	5	13	0	0	13	0	0
2	24877797	.	G	A	6	2	8	0	0	8	0	0
2	24878051	.	C	T	18	16	34	0	4	38	0	0
2	24878081	.	T	A	20	17	37	0	1	38	0	0
2	24878332	.	A	G	10	14	24	0	0	24	0	0
2	24943237	.	G	A	2	13	15	0	8	23	0	0
2	24943398	.	C	T	10	6	16	0	0	16	0	0
2	24943482	.	G	T	2	13	15	0	0	15	0	0
2	24943660	.	T	C	3	3	6	0	0	6	0	0
2	24943689	.	C	T	3	8	11	0	0	11	0	0
2	24943891	.	A	T	1	13	14	0	2	16	0	0
2	24943916	.	T	C	4	15	19	0	1	20	0	0
2	24943971	.	A	T	3	10	13	0	1	14	0	0
2	24944187	.	C	T	18	10	28	0	0	28	0	0
2	24944415	.	C	T	5	12	17	0	2	19	0	0
2	24944644	.	A	G	3	6	9	0	1	10	0	0
2	24947129	.	G	T	9	6	15	0	0	15	0	0
2	24952186	.	G	A	4	4	8	0	0	8	0	0
2	24952406	.	C	A	7	8	15	0	1	16	0	0
2	24952607	.	T	C	7	5	12	0	0	12	0	0
2	24956681	.	G	A	3	4	7	0	0	7	0	0
2	24956856	.	T	C	1	0	1	0	2	3	0	0
2	24957008	.	G	A	4	4	8	0	1	9	0	0
2	24957086	.	C	T	0	3	3	0	6	9	0	0
2	24958921	.	G	A	2	2	4	0	2	6	0	0
2	24958945	.	C	T	2	5	7	0	0	7	0	0
2	24959124	.	C	T	3	3	6	0	1	7	0	0
2	24959143	.	T	C	3	3	6	0	1	7	0	0
2	24961833	.	C	T	0	3	3	0	1	4	0	0
2	24964168	.	T	C	3	3	6	0	0	7	1	0
2	24964691	.	T	A	2	2	4	0	0	4	0	0
2	24969647	.	C	T	2	5	7	0	0	7	0	0
2	24970042	.	C	T	1	2	3	0	2	5	0	0
2	24970127	.	T	A	3	3	6	0	1	7	0	0
2	24990621	.	T	A	6	5	11	0	0	11	0	0
2	24990629	.	T	A	6	6	12	0	1	13	0	0
2	24990751	.	A	T	4	6	10	0	1	11	0	0
2	24990845	.	T	C	7	11	18	0	0	18	0	0
2	24991202	.	C	G	16	18	34	0	1	35	0	0
2	24991265	.	T	G	10	7	17	0	1	18	0	0
2	24991387	.	G	T	7	11	18	0	0	18	0	0
2	24991429	.	G	A	11	16	27	0	4	31	0	0
2	24991909	.	A	G	9	15	24	0	3	27	0	0
2	24992110	.	G	A	13	9	22	0	3	25	0	0
2	24992134	.	G	A	10	10	20	0	2	22	0	0
2	24992185	.	T	C	11	7	18	0	0	18	0	0
2	24992242	.	C	T	2	8	10	0	9	19	0	0
2	24992368	.	T	C	5	10	15	1	2	18	0	0
2	24992464	.	C	T	10	9	19	0	3	22	0	0
2	24992536	.	C	G	9	10	19	0	3	22	0	0
2	24992584	.	G	A	13	8	21	0	0	21	0	0
2	25074746	.	G	A	0	2	2	0	1	3	0	0
2	25086854	.	G	A	0	3	3	0	1	4	0	0
2	25097106	.	G	A	0	4	4	0	2	6	0	0
2	25097289	.	G	A	2	3	5	0	0	5	0	0
2	25097543	.	C	T	4	2	6	0	2	8	0	0
2	25097582	.	T	C	2	5	7	0	1	8	0	0
2	25099926	.	T	C	3	4	7	0	0	7	0	0
2	25105482	.	G	A	5	5	10	0	0	10	0	0
2	25105586	.	C	T	4	3	7	0	0	7	0	0
2	25105618	.	A	C	3	5	8	0	1	9	0	0
2	25105716	.	T	C	7	9	16	0	1	17	0	0
2	25105900	.	C	T	6	13	19	0	2	21	0	0
2	25105992	.	G	A	9	5	14	0	0	14	0	0
2	25106020	.	T	C	4	3	7	0	1	8	0	0
2	25106099	.	G	T	1	3	4	0	1	5	0	0
2	25106310	.	A	T	6	7	13	0	1	14	0	0
2	25106380	.	A	G	4	8	12	0	1	13	0	0
2	25106402	.	C	A	5	8	13	0	3	16	0	0
2	25106554	.	G	T	6	6	12	0	0	12	0	0
2	25106631	.	C	G	4	8	12	0	0	12	0	0
2	25106874	.	A	C	1	5	6	1	1	8	0	0
2	25106984	.	A	T	2	2	4	1	0	5	0	0
2	25107843	.	G	C	15	6	21	0	0	21	0	0
2	25107891	.	G	T	13	18	31	0	0	31	0	0
2	25108104	.	A	G	8	9	17	0	1	18	0	0
2	25108377	.	T	A	5	13	18	0	1	19	0	0
2	25118023	.	A	G	1	2	3	0	0	3	0	0
2	25118414	.	G	A	2	2	4	0	0	4	0	0
2	25125175	.	G	A	0	2	2	0	1	3	0	0
2	25126882	.	T	C	1	3	4	0	0	4	0	0
2	25126886	.	T	C	1	2	3	0	0	3	0	0
2	25127042	.	G	T	4	5	9	0	1	10	0	0
2	25127132	.	C	A	7	2	9	0	0	9	0	0
2	25127876	.	G	A	0	3	3	0	3	6	0	0
2	25128019	.	C	G	6	5	11	0	0	11	0	0
2	25128024	.	C	T	6	5	11	0	1	12	0	0
2	25128105	.	T	A	1	2	3	0	0	3	0	0
2	25128590	.	C	T	4	7	11	0	1	12	0	0
2	25128595	.	A	T	7	3	10	0	1	11	0	0
2	25128668	.	C	T	5	8	13	0	2	15	0	0
2	25128780	.	T	A	10	10	20	0	1	21	0	0
2	25128858	.	C	T	6	6	12	0	0	12	0	0
2	25290690	.	A	C	3	3	6	0	0	6	0	0
2	25542237	.	G	A	1	2	3	0	0	3	0	0
2	25542890	.	C	A	7	5	12	3	2	17	0	0
2	25542926	.	C	T	4	2	6	3	1	10	0	0
2	25601672	.	C	T	1	2	3	0	0	3	0	0
2	25631347	.	G	A	3	2	5	0	1	6	0	0
2	25772113	.	G	A	3	2	5	0	0	5	0	0
2	25794241	.	C	A	2	3	5	0	0	5	0	0
2	25798647	.	A	G	4	3	7	0	0	7	0	0
2	25815407	.	A	T	15	11	26	0	2	28	0	0
2	25815412	.	C	G	6	0	6	0	24	30	0	0
2	25815737	.	G	T	8	2	10	0	1	11	0	0
2	25815758	.	C	T	9	2	11	0	1	12	0	0
2	25815780	.	T	G	7	3	10	0	1	11	0	0
2	25816321	.	C	T	7	8	15	0	2	17	0	0
2	25816376	.	C	T	5	2	7	0	0	7	0	0
2	25816383	.	T	C	3	2	5	0	2	7	0	0
2	25839381	.	G	T	0	9	9	0	6	15	0	0
2	25843532	.	T	C	11	8	19	0	1	20	0	0
2	25843806	.	G	A	1	21	22	0	16	38	0	0
2	25844341	.	T	C	16	5	21	0	3	24	0	0
2	25844345	.	A	T	15	7	22	0	1	23	0	0
2	25844840	.	C	T	12	22	34	1	3	38	0	0
2	25947454	.	A	G	2	0	2	0	2	4	0	0
2	25947462	.	C	A	2	2	4	0	0	4	0	0
2	25984751	.	G	A	1	4	5	0	0	5	0	0
2	25984928	.	T	C	2	7	9	0	0	9	0	0
2	25984970	.	C	T	5	4	9	0	0	9	0	0
2	25984982	.	C	T	4	4	8	0	0	8	0	0
2	25985012	.	C	T	6	3	9	0	0	9	0	0
2	25985234	.	G	A	1	4	5	0	0	5	0	0
2	25985268	.	G	A	1	2	3	0	0	3	0	0
2	25985300	.	A	C	1	3	4	0	0	4	0	0
2	25985405	.	C	T	1	5	6	0	2	8	0	0
2	25985409	.	C	T	3	5	8	0	0	8	0	0
2	25988570	.	T	C	5	7	12	0	1	13	0	0
2	25988633	.	A	G	7	8	15	0	0	15	0	0
2	25988635	.	A	G	6	8	14	0	1	15	0	0
2	25988846	.	A	G	6	1	7	0	8	15	0	0
2	25988874	.	T	C	11	13	24	0	0	24	0	0
2	25988991	.	T	C	2	8	10	0	0	10	0	0
2	25988992	.	C	A	2	8	10	0	0	10	0	0
2	25989100	.	A	G	14	8	22	0	0	22	0	0
2	25989134	.	A	G	7	11	18	0	1	19	0	0
2	25989142	.	T	G	7	10	17	0	0	17	0	0
2	25989246	.	T	A	12	8	20	0	4	24	0	0
2	25989290	.	T	G	10	12	22	0	0	22	0	0
2	25990020	.	C	A	17	12	29	0	8	37	0	0
2	25990323	.	G	A	14	8	22	3	2	27	0	0
2	25990563	.	A	G	17	13	30	4	2	36	0	0
2	25990628	.	C	A	20	8	28	0	2	30	0	0
2	25990702	.	G	A	23	14	37	0	0	38	1	0
2	25990777	.	T	G	1	4	5	3	3	11	0	0
2	25997881	.	C	G	2	3	5	0	0	5	0	0
2	25997982	.	G	A	2	3	5	0	0	5	0	0
2	26156109	.	C	A	1	0	1	0	1	2	0	0
2	26156114	.	A	C	0	1	1	0	1	2	0	0
2	26156636	.	A	T	1	2	3	0	0	3	0	0
2	26199708	.	C	T	4	2	6	0	0	6	0	0
2	26199714	.	C	T	3	3	6	0	0	6	0	0
2	26207155	.	C	T	7	7	14	0	0	14	0	0
2	26207350	.	G	A	8	7	15	0	0	15	0	0
2	26207713	.	G	A	6	8	14	0	1	15	0	0
2	26207752	.	C	T	12	10	22	0	0	22	0	0
2	26207938	.	C	T	14	11	25	0	0	25	0	0
2	26208480	.	A	C	5	11	16	0	1	17	0	0
2	26208520	.	A	G	8	14	22	0	0	22	0	0
2	26208589	.	A	G	9	13	22	0	0	22	0	0
2	26208668	.	T	G	13	2	15	0	18	33	0	0
2	26208733	.	C	A	13	7	20	0	0	20	0	0
2	26208815	.	G	T	21	17	38	0	2	40	0	0
2	26209120	.	C	T	6	9	15	0	4	19	0	0
2	26209141	.	G	A	6	7	13	0	3	16	0	0
2	26209266	.	A	C	3	6	9	0	0	9	0	0
2	26209325	.	G	A	7	3	10	0	0	10	0	0
2	26240742	.	C	T	15	20	35	0	5	40	0	0
2	26240771	.	A	T	22	18	40	0	0	40	0	0
2	26240857	.	C	T	20	13	33	1	3	37	0	0
2	26277924	.	C	A	25	23	48	0	2	50	0	0
2	26278044	.	G	A	22	25	47	0	1	48	0	0
2	26282745	.	C	T	30	23	53	0	1	54	0	0
2	26282829	.	A	G	24	1	25	0	17	42	0	0
2	26283181	.	C	T	20	18	38	0	3	41	0	0
2	26283723	.	A	G	16	21	37	0	2	39	0	0
2	26283922	.	T	G	20	28	48	0	2	50	0	0
2	26299673	.	A	T	2	4	6	0	0	6	0	0
2	26300085	.	A	G	2	3	5	0	1	6	0	0
2	26300091	.	G	A	1	2	3	0	2	5	0	0
2	26300341	.	A	G	1	7	8	0	0	8	0	0
2	26303719	.	T	G	1	0	1	0	6	7	0	0
2	26303845	.	A	C	2	2	4	0	0	4	0	0
2	26304008	.	C	A	1	5	6	0	0	6	0	0
2	26304329	.	A	G	2	5	7	0	0	7	0	0
2	26422266	.	G	T	0	5	5	0	3	8	0	0
2	26422287	.	C	T	5	3	8	0	1	9	0	0
2	26422332	.	C	T	4	2	6	0	0	6	0	0
2	26443146	.	G	T	11	18	29	0	1	30	0	0
2	26443517	.	T	C	4	3	7	0	1	8	0	0
2	26444190	.	A	T	5	5	10	0	0	10	0	0
2	26444332	.	C	A	3	6	9	0	0	9	0	0
2	26444403	.	G	A	0	2	2	0	3	5	0	0
2	26463199	.	C	A	3	4	7	0	0	7	0	0
2	26463309	.	C	T	9	4	13	0	1	14	0	0
2	26463534	.	C	A	6	4	10	0	1	11	0	0
2	26467072	.	A	G	5	8	13	0	0	13	0	0
2	26467131	.	T	G	3	3	6	0	1	8	1	0
2	26467150	.	G	A	3	2	5	0	0	5	0	0
2	26467291	.	T	C	5	3	8	1	0	9	0	0
2	26468665	.	A	T	1	3	4	0	0	4	0	0
2	26469030	.	C	T	0	4	4	0	2	6	0	0
2	26470237	.	G	T	11	16	27	0	1	28	0	0
2	26470267	.	G	A	7	20	27	0	2	29	0	0
2	26470357	.	G	A	16	15	31	0	0	31	0	0
2	26470537	.	C	T	18	24	42	0	0	42	0	0
2	26470636	.	C	T	3	15	18	0	25	43	0	0
2	26470666	.	A	G	15	18	33	0	1	34	0	0
2	26473106	.	T	C	13	16	29	0	0	29	0	0
2	26473361	.	C	T	17	13	30	0	1	31	0	0
2	26481029	.	C	T	2	3	5	0	2	7	0	0
2	26483946	.	G	T	8	5	13	0	1	14	0	0
2	26486605	.	A	G	9	7	16	0	1	17	0	0
2	26489500	.	C	T	8	7	15	0	0	15	0	0
2	26491676	.	A	T	9	10	19	0	1	20	0	0
2	26499519	.	C	T	30	18	48	0	3	51	0	0
2	26500872	.	T	C	27	41	68	0	5	73	0	0
2	26500899	.	G	A	48	26	74	0	4	78	0	0
2	26500989	.	C	T	35	40	75	0	3	78	0	0
2	26501672	.	G	A	1	3	4	0	0	4	0	0
2	26501832	.	A	G	4	3	7	0	0	7	0	0
2	26577314	.	T	A	3	15	18	0	1	19	0	0
2	26578227	.	T	G	2	10	12	0	0	12	0	0
2	26599248	.	A	G	4	2	6	0	0	6	0	0
2	26607399	.	T	C	1	3	4	0	0	4	0	0
2	26607450	.	G	A	1	2	3	0	1	4	0	0
2	26607471	.	C	T	3	4	7	0	0	7	0	0
2	26610677	.	T	C	2	4	6	0	0	6	0	0
2	26612624	.	G	C	6	4	10	0	1	11	0	0
2	26619829	.	G	T	12	21	33	0	0	33	0	0
2	26627301	.	C	A	20	26	46	0	1	47	0	0
2	26627332	.	T	A	13	22	35	0	0	35	0	0
2	26631084	.	G	A	22	18	40	0	1	41	0	0
2	26632384	.	T	G	20	16	36	0	0	36	0	0
2	26638857	.	C	T	3	2	5	0	1	6	0	0
2	26639157	.	T	C	11	4	15	0	0	16	1	0
2	26662143	.	T	A	5	3	8	0	0	8	0	0
2	26665081	.	A	G	2	5	7	0	0	7	0	0
2	26665155	.	A	T	6	5	11	0	1	12	0	0
2	26665233	.	G	A	6	3	9	0	0	9	0	0
2	26665375	.	A	G	3	2	5	0	1	6	0	0
2	26665824	.	A	T	7	10	17	0	1	18	0	0
2	26672488	.	A	G	15	8	23	3	0	26	0	0
2	26672761	.	T	G	6	1	7	0	11	18	0	0
2	26672800	.	G	A	5	3	8	0	0	8	0	0
2	26677017	.	C	A	2	3	5	0	0	5	0	0
2	26677111	.	T	A	2	5	7	0	0	7	0	0
2	26677172	.	G	A	3	2	5	0	0	5	0	0
2	26680293	.	C	T	2	2	4	0	0	4	0	0
2	26680440	.	G	A	2	4	6	0	0	6	0	0
2	26680887	.	T	A	3	3	6	0	0	6	0	0
2	26681214	.	A	C	2	9	11	0	0	11	0	0
2	26682031	.	G	T	1	6	7	0	11	18	0	0
2	26684689	.	A	G	8	7	15	0	0	15	0	0
2	26686340	.	A	T	3	10	13	0	0	13	0	0
2	26697666	.	C	T	1	3	4	0	2	6	0	0
2	26697929	.	A	G	5	5	10	0	0	10	0	0
2	26714144	.	A	G	2	2	4	0	0	4	0	0
2	26714171	.	G	A	2	2	4	0	0	4	0	0
2	27048999	.	C	A	2	4	6	0	1	7	0	0
2	27064687	.	T	C	4	3	7	0	0	7	0	0
2	27075884	.	G	A	0	2	2	0	3	5	0	0
2	27075992	.	A	T	9	4	13	0	0	13	0	0
2	27094393	.	C	T	10	6	16	0	0	16	0	0
2	27540182	.	C	T	0	6	6	0	1	7	0	0
2	27540458	.	C	T	11	4	15	0	0	15	0	0
2	27540488	.	C	A	3	9	12	0	0	12	0	0
2	27540614	.	C	T	5	4	9	0	1	10	0	0
2	27540905	.	T	C	8	11	19	0	1	20	0	0
2	27541216	.	G	T	2	2	4	0	5	9	0	0
2	27541246	.	A	C	2	1	3	0	1	4	0	0
2	27541468	.	C	T	4	2	6	0	0	6	0	0
2	27541778	.	G	T	7	5	12	0	0	12	0	0
2	27541914	.	A	C	8	4	12	0	0	12	0	0
2	27542721	.	C	T	15	14	29	0	1	30	0	0
2	27542856	.	G	A	0	8	8	0	12	20	0	0
2	27542958	.	A	G	8	8	16	0	0	16	0	0
2	27543103	.	A	T	16	10	26	0	1	27	0	0
2	27543212	.	T	A	18	14	32	0	0	32	0	0
2	27543499	.	C	A	14	6	20	0	1	21	0	0
2	27614082	.	G	C	3	4	7	0	1	8	0	0
2	27635788	.	C	T	7	5	12	0	1	13	0	0
2	27635928	.	T	A	1	4	5	0	1	6	0	0
2	27641287	.	G	A	3	4	7	0	1	8	0	0
2	27642776	.	C	G	1	2	3	0	0	3	0	0
2	27658566	.	A	G	5	2	7	0	0	7	0	0
2	27658651	.	T	C	4	7	11	0	0	11	0	0
2	27658973	.	T	G	5	4	9	0	0	9	0	0
2	27659018	.	T	C	3	6	9	0	0	9	0	0
2	27662374	.	C	T	4	5	9	0	0	9	0	0
2	27662706	.	T	C	4	3	7	0	0	7	0	0
2	27662916	.	A	T	1	2	3	0	0	3	0	0
2	27663435	.	C	T	5	2	7	0	0	7	0	0
2	27664105	.	G	A	2	6	8	0	0	8	0	0
2	27664195	.	A	C	1	5	6	0	0	6	0	0
2	27664317	.	G	T	7	6	13	0	0	13	0	0
2	27664343	.	C	T	4	7	11	0	0	11	0	0
2	27664482	.	G	C	4	2	6	0	0	6	0	0
2	27664665	.	A	C	2	3	5	0	0	5	0	0
2	27670764	.	T	C	5	3	8	0	0	8	0	0
2	27672426	.	T	C	4	3	7	0	1	8	0	0
2	27672440	.	C	T	0	4	4	0	4	8	0	0
2	27672535	.	C	T	6	6	12	0	0	12	0	0
2	27673041	.	A	G	9	6	15	0	1	16	0	0
2	27673080	.	G	A	7	4	11	0	2	13	0	0
2	27673148	.	G	A	9	6	15	0	0	15	0	0
2	27673173	.	A	G	7	9	16	0	0	16	0	0
2	27673194	.	C	T	4	5	9	0	0	9	0	0
2	27774370	.	G	A	5	3	8	0	3	11	0	0
2	27812578	.	G	A	4	4	8	0	1	9	0	0
2	27812592	.	C	A	4	8	12	0	0	12	0	0
2	27827558	.	G	A	2	6	8	3	0	11	0	0
2	27827573	.	C	T	3	7	10	2	0	12	0	0
2	27843845	.	G	A	5	4	9	0	0	9	0	0
2	27845694	.	G	A	2	3	5	0	0	5	0	0
2	27845845	.	A	T	4	4	8	0	0	8	0	0
2	27846053	.	T	A	3	2	5	0	1	6	0	0
2	27846108	.	G	A	5	3	8	0	0	8	0	0
2	27933135	.	A	G	4	0	4	0	1	5	0	0
2	27933143	.	C	T	4	2	6	0	0	6	0	0
2	27957786	.	T	A	6	2	8	0	1	9	0	0
2	27963660	.	G	A	3	7	10	0	0	10	0	0
2	27963686	.	C	T	0	4	4	0	3	7	0	0
2	27966368	.	C	T	0	4	4	1	4	9	0	0
2	27966602	.	C	T	0	4	4	0	6	10	0	0
2	27966636	.	C	T	1	5	6	0	0	6	0	0
2	27969534	.	T	C	1	5	6	0	0	6	0	0
2	27969966	.	G	A	1	3	4	0	1	5	0	0
2	27969985	.	A	G	2	3	5	0	0	5	0	0
2	27970017	.	A	G	1	3	4	0	2	6	0	0
2	28049696	.	C	T	15	5	20	0	1	21	0	0
2	28049996	.	A	G	8	6	14	0	1	15	0	0
2	28050058	.	C	A	10	5	15	0	0	15	0	0
2	28050243	.	T	C	18	0	18	0	7	25	0	0
2	28050565	.	T	A	12	9	21	0	0	21	0	0
2	28050600	.	G	C	7	1	8	0	10	18	0	0
2	28050759	.	A	G	3	4	7	0	1	8	0	0
2	28050921	.	G	T	4	10	14	0	0	14	0	0
2	28050933	.	G	A	9	3	12	0	0	12	0	0
2	28051041	.	T	A	5	7	12	0	4	16	0	0
2	28051092	.	C	T	2	9	11	0	15	26	0	0
2	28051104	.	G	A	16	10	26	0	0	26	0	0
2	28057518	.	G	A	4	4	8	0	0	8	0	0
2	28930100	.	T	C	4	8	12	0	0	12	0	0
2	28934011	.	C	T	4	5	9	0	1	10	0	0
2	28934152	.	T	C	10	6	16	0	1	17	0	0
2	29037346	.	C	T	2	2	4	0	0	4	0	0
2	29289068	.	G	T	5	3	8	0	0	8	0	0
2	29317718	.	G	A	2	15	17	0	0	17	0	0
2	29352279	.	G	A	1	10	11	0	11	22	0	0
2	29352379	.	A	C	12	6	18	0	0	18	0	0
2	29352411	.	A	C	14	5	19	0	2	21	0	0
2	29352481	.	G	C	5	4	9	0	0	9	0	0
2	29352579	.	T	C	8	5	13	0	0	13	0	0
2	29352673	.	C	T	15	6	21	0	0	21	0	0
2	29477653	.	T	C	19	20	39	0	2	41	0	0
2	29477733	.	A	T	20	15	35	0	3	38	0	0
2	29477769	.	G	T	22	14	36	0	0	36	0	0
2	29482390	.	G	A	6	9	15	0	1	16	0	0
2	29482417	.	A	G	6	8	14	0	1	15	0	0
2	29485046	.	G	A	7	10	17	0	3	20	0	0
2	29485068	.	G	T	9	7	16	0	0	16	0	0
2	30116310	.	A	T	2	2	4	0	4	8	0	0
2	30568944	.	A	T	7	5	12	0	1	13	0	0
2	30568959	.	C	T	7	5	12	0	1	13	0	0
2	30574092	.	C	T	0	6	6	1	8	15	0	0
2	30586847	.	G	C	4	3	7	0	0	7	0	0
2	30611283	.	G	T	3	3	6	0	1	7	0	0
2	30613764	.	G	A	4	2	6	0	0	6	0	0
2	30618155	.	C	T	3	2	5	0	1	6	0	0
2	30741192	.	C	T	10	10	20	0	0	20	0	0
2	30743041	.	T	C	8	14	22	0	2	24	0	0
2	30743864	.	A	G	13	10	23	0	1	24	0	0
2	30743907	.	T	C	13	16	29	0	0	29	0	0
2	30743951	.	C	A	15	19	34	0	1	35	0	0
2	30747393	.	A	G	1	2	3	0	0	3	0	0
2	30747874	.	G	T	3	1	4	0	1	5	0	0
2	30752796	.	G	A	1	6	7	0	0	7	0	0
2	30753072	.	A	T	13	14	27	0	0	27	0	0
2	30753273	.	G	A	12	11	23	0	1	24	0	0
2	30753888	.	A	G	12	7	19	0	0	19	0	0
2	30753899	.	C	T	11	6	17	0	0	17	0	0
2	30753928	.	G	A	6	11	17	0	0	17	0	0
2	30753991	.	A	G	13	7	20	0	0	20	0	0
2	30754030	.	A	T	9	16	25	0	1	26	0	0
2	30754113	.	T	C	7	13	20	0	0	20	0	0
2	30754196	.	G	A	15	15	30	0	0	30	0	0
2	30754300	.	C	T	16	22	38	1	0	39	0	0
2	30754306	.	G	A	21	12	33	1	4	38	0	0
2	30754346	.	A	G	17	16	33	0	5	38	0	0
2	30754432	.	G	T	15	19	34	0	0	34	0	0
2	30754733	.	A	G	9	6	15	0	2	17	0	0
2	30754741	.	A	G	10	8	18	0	0	18	0	0
2	30754777	.	A	T	6	7	13	0	2	15	0	0
2	30754793	.	A	T	6	6	12	0	1	13	0	0
2	30754932	.	A	G	11	2	13	0	0	13	0	0
2	30755195	.	G	A	3	2	5	1	2	8	0	0
2	30755359	.	A	T	4	7	11	1	0	12	0	0
2	30755522	.	G	T	6	6	12	0	0	12	0	0
2	30762969	.	G	A	3	4	7	0	1	8	0	0
2	30960401	.	A	G	3	4	7	0	1	8	0	0
2	31687581	.	C	A	2	3	5	1	0	6	0	0
2	31687583	.	A	G	3	1	4	1	1	6	0	0
2	31707203	.	C	T	5	3	8	0	0	8	0	0
2	31891344	.	T	A	4	25	29	0	0	29	0	0
2	32392244	.	C	G	1	2	3	0	0	3	0	0
2	32392314	.	C	T	5	2	7	0	0	7	0	0
2	32392545	.	G	A	1	3	4	0	0	4	0	0
2	32392618	.	A	T	2	3	5	0	0	5	0	0
2	32392640	.	T	C	2	3	5	0	0	5	0	0
2	32392724	.	A	G	6	3	9	0	0	9	0	0
2	32392787	.	C	A	0	3	3	0	6	9	0	0
2	32392876	.	A	T	4	5	9	0	0	9	0	0
2	32392988	.	T	C	5	2	7	0	0	7	0	0
2	32393101	.	A	G	5	5	10	0	0	10	0	0
2	32393125	.	C	T	0	3	3	0	6	9	0	0
2	32393579	.	T	C	2	3	5	0	1	6	0	0
2	32393731	.	G	A	3	4	7	0	0	7	0	0
2	32394067	.	G	C	1	3	4	0	0	4	0	0
2	32475941	.	A	T	4	6	10	0	0	10	0	0
2	32477432	.	T	C	5	8	13	0	1	14	0	0
2	32483020	.	C	G	8	4	12	0	0	12	0	0
2	32485832	.	A	G	4	9	13	0	0	13	0	0
2	32485895	.	C	T	0	9	9	0	7	16	0	0
2	32485962	.	G	A	3	3	6	0	0	6	0	0
2	32494486	.	G	A	5	6	11	0	0	11	0	0
2	32505664	.	G	A	6	10	16	0	4	20	0	0
2	32505713	.	A	G	7	5	12	0	2	14	0	0
2	32505715	.	A	G	12	0	12	0	1	13	0	0
2	32507094	.	C	T	12	11	23	0	0	23	0	0
2	32507218	.	G	A	6	14	20	0	0	20	0	0
2	32508418	.	C	A	9	3	12	0	2	14	0	0
2	32509238	.	T	G	5	5	10	0	0	10	0	0
2	32509247	.	G	A	6	4	10	0	0	10	0	0
2	32509309	.	G	T	4	7	11	0	0	11	0	0
2	32509573	.	G	A	3	5	8	0	0	8	0	0
2	32509636	.	C	T	5	4	9	0	0	9	0	0
2	32515861	.	C	T	0	10	10	0	8	18	0	0
2	32516110	.	T	C	4	13	17	0	2	19	0	0
2	32516359	.	A	T	11	6	17	0	0	17	0	0
2	32516469	.	T	C	12	0	12	0	13	25	0	0
2	32519690	.	G	A	8	7	15	0	0	15	0	0
2	32531232	.	C	T	7	4	11	0	0	11	0	0
2	32561752	.	A	G	3	7	10	0	0	10	0	0
2	32561754	.	G	A	2	7	9	0	0	9	0	0
2	32562059	.	G	A	2	11	13	0	1	14	0	0
2	32569639	.	G	A	12	9	21	0	0	21	0	0
2	32569717	.	A	G	7	6	13	0	0	14	1	0
2	32569745	.	A	G	5	6	11	0	0	11	0	0
2	32569909	.	T	C	7	0	7	0	8	15	0	0
2	32569930	.	G	A	7	4	11	0	0	11	0	0
2	32577939	.	G	A	7	4	11	0	1	12	0	0
2	32578124	.	A	T	4	19	23	0	1	24	0	0
2	32578230	.	C	T	14	13	27	0	1	28	0	0
2	32578330	.	A	G	8	10	18	0	0	18	0	0
2	32578580	.	C	A	11	13	24	0	1	25	0	0
2	32578677	.	C	A	7	6	13	0	1	14	0	0
2	32583144	.	A	G	7	6	13	0	2	15	0	0
2	32583162	.	T	A	7	7	14	0	1	15	0	0
2	32583209	.	C	T	4	6	10	0	0	10	0	0
2	32583345	.	C	T	9	7	16	0	0	16	0	0
2	32583411	.	C	A	1	6	7	0	9	16	0	0
2	32583453	.	T	A	5	9	14	0	1	15	0	0
2	32583459	.	A	G	6	9	15	0	0	15	0	0
2	32583629	.	A	C	8	0	8	0	7	15	0	0
2	32583681	.	T	A	4	5	9	0	0	9	0	0
2	32583687	.	G	A	5	5	10	0	0	10	0	0
2	32588669	.	A	G	1	3	4	0	0	4	0	0
2	32590552	.	C	T	3	2	5	0	0	5	0	0
2	32590705	.	C	T	1	2	3	0	0	3	0	0
2	32594670	.	A	T	1	2	3	0	0	3	0	0
2	32594699	.	T	A	3	2	5	0	0	5	0	0
2	32637366	.	G	A	15	4	19	0	0	19	0	0
2	32637367	.	T	A	15	3	18	0	1	19	0	0
2	32665798	.	G	A	11	14	25	0	0	25	0	0
2	32666565	.	C	T	2	9	11	0	10	21	0	0
2	32667941	.	C	A	1	7	8	0	10	18	0	0
2	32676482	.	A	C	3	5	8	0	1	9	0	0
2	32679938	.	C	T	4	3	7	0	2	9	0	0
2	32680338	.	C	T	5	3	8	0	0	8	0	0
2	32680356	.	C	T	4	5	9	0	0	9	0	0
2	32686594	.	C	T	3	3	6	0	0	6	0	0
2	32749864	.	C	G	1	2	3	0	1	4	0	0
2	32749875	.	T	C	2	2	4	0	0	4	0	0
2	32752447	.	G	A	1	2	3	0	1	4	0	0
2	32756630	.	C	T	2	7	9	0	1	10	0	0
2	32814503	.	G	A	7	9	16	0	1	17	0	0
2	32814677	.	G	C	8	5	13	0	0	13	0	0
2	32814695	.	T	C	4	4	8	0	0	8	0	0
2	32817921	.	G	A	7	3	10	0	0	10	0	0
2	32820764	.	G	A	5	3	8	0	1	9	0	0
2	32821622	.	T	G	7	2	9	0	0	9	0	0
2	32823494	.	C	G	1	4	5	0	5	10	0	0
2	32824727	.	G	A	3	4	7	0	0	7	0	0
2	32824745	.	C	A	1	4	5	0	3	8	0	0
2	32824778	.	G	A	3	4	7	0	0	7	0	0
2	32824805	.	G	A	2	3	5	0	0	5	0	0
2	32824896	.	C	T	2	3	5	0	1	6	0	0
2	32825018	.	C	G	0	5	5	0	4	9	0	0
2	32825033	.	G	A	4	2	6	0	3	9	0	0
2	32825294	.	G	A	2	3	5	0	0	5	0	0
2	32825382	.	C	T	2	3	5	0	0	5	0	0
2	32825480	.	T	G	1	3	4	0	0	4	0	0
2	32827004	.	C	T	4	3	7	0	0	7	0	0
2	32827005	.	C	T	3	3	6	0	0	6	0	0
2	32828626	.	T	C	5	2	7	0	0	7	0	0
2	32828651	.	A	G	3	2	5	0	2	7	0	0
2	32828704	.	C	T	2	4	6	0	0	6	0	0
2	32828839	.	C	A	2	4	6	0	0	6	0	0
2	32829016	.	T	C	6	4	10	0	0	10	0	0
2	32831664	.	C	A	10	5	15	0	0	15	0	0
2	32833524	.	T	C	7	3	10	0	2	12	0	0
2	32849667	.	A	G	5	2	7	1	0	8	0	0
2	32850138	.	C	T	6	9	15	0	0	15	0	0
2	32850305	.	T	C	11	9	20	0	0	20	0	0
2	32850401	.	T	C	8	5	13	0	2	15	0	0
2	32850477	.	T	A	2	4	6	0	0	6	0	0
2	32850510	.	A	T	1	3	4	0	0	4	0	0
2	33209645	.	T	G	16	0	16	0	22	38	0	0
2	33216346	.	C	T	17	12	29	0	0	29	0	0
2	33216518	.	G	A	2	21	23	0	16	39	0	0
2	33216563	.	C	G	16	17	33	0	2	35	0	0
2	33417835	.	G	T	1	2	3	0	0	3	0	0
2	33418586	.	C	A	1	1	2	0	1	3	0	0
2	33418604	.	A	T	2	3	5	0	1	6	0	0
2	33419602	.	A	G	4	3	7	0	1	8	0	0
2	33419650	.	A	G	3	3	6	0	0	6	0	0
2	33419661	.	C	T	2	2	4	0	0	4	0	0
2	33420218	.	T	A	5	7	12	0	0	12	0	0
2	33420384	.	G	A	0	4	4	0	5	9	0	0
2	33420638	.	T	G	2	3	5	0	0	5	0	0
2	33420679	.	T	G	1	6	7	0	0	7	0	0
2	33420684	.	A	C	1	6	7	0	0	7	0	0
2	33420806	.	C	T	8	3	11	0	1	12	0	0
2	33420925	.	C	A	7	11	18	0	0	18	0	0
2	33421078	.	G	T	4	5	9	0	0	9	0	0
2	33421200	.	C	T	8	5	13	0	0	13	0	0
2	33421222	.	A	C	8	6	14	0	1	15	0	0
2	33421275	.	C	G	2	9	11	0	2	13	0	0
2	33421276	.	T	C	3	9	12	0	1	13	0	0
2	33421382	.	A	T	4	8	12	0	1	13	0	0
2	33421404	.	T	A	5	9	14	0	0	14	0	0
2	33421441	.	T	G	8	1	9	0	8	17	0	0
2	33421547	.	A	G	5	3	8	0	1	9	0	0
2	33421549	.	A	C	5	4	9	0	0	9	0	0
2	33421720	.	A	G	10	12	22	0	0	22	0	0
2	33421774	.	A	G	14	7	21	0	1	22	0	0
2	33421860	.	T	G	7	8	15	0	0	15	0	0
2	33421872	.	A	T	7	9	16	0	0	16	0	0
2	33421985	.	T	A	15	5	20	0	0	20	0	0
2	33422001	.	C	T	16	4	20	0	0	20	0	0
2	33422125	.	C	T	2	13	15	0	0	15	0	0
2	33422169	.	T	C	10	7	17	0	0	17	0	0
2	33422211	.	G	A	10	3	13	0	1	14	0	0
2	33422286	.	T	G	9	9	18	0	1	19	0	0
2	33422289	.	C	T	6	9	15	0	0	15	0	0
2	33422327	.	G	A	7	15	22	0	4	26	0	0
2	33477073	.	C	T	2	2	4	0	0	4	0	0
2	33477139	.	G	A	7	2	9	0	0	9	0	0
2	33522130	.	A	T	1	2	3	0	0	3	0	0
2	33645058	.	A	G	4	2	6	0	0	6	0	0
2	33645335	.	G	A	3	2	5	0	0	5	0	0
2	33645344	.	C	A	2	3	5	0	0	5	0	0
2	33681337	.	A	T	30	14	44	0	2	46	0	0
2	33687090	.	G	A	13	8	21	0	0	21	0	0
2	33687110	.	C	A	9	13	22	0	1	23	0	0
2	33821103	.	C	G	1	2	3	0	0	3	0	0
2	34008977	.	A	T	1	2	3	0	1	4	0	0
2	34009014	.	G	A	3	2	5	0	1	6	0	0
2	34022992	.	T	A	11	6	17	0	1	18	0	0
2	34024832	.	A	G	4	10	14	0	0	14	0	0
2	34025167	.	G	A	7	5	12	0	1	13	0	0
2	34029353	.	G	A	5	5	10	0	1	11	0	0
2	34071782	.	T	A	1	4	5	0	0	5	0	0
2	34119467	.	A	C	2	4	6	0	0	6	0	0
2	34119783	.	G	A	2	7	9	0	2	11	0	0
2	34122985	.	C	T	6	5	11	0	2	13	0	0
2	34126040	.	T	C	4	6	10	1	0	11	0	0
2	34126514	.	G	T	7	4	11	0	1	12	0	0
2	34173018	.	T	A	3	2	5	0	0	5	0	0
2	34173253	.	C	T	7	2	9	0	0	9	0	0
2	34173335	.	A	C	6	6	12	0	0	12	0	0
2	34173336	.	G	A	7	6	13	0	0	13	0	0
2	34381013	.	T	G	9	11	20	0	0	20	0	0
2	34381032	.	T	C	8	10	18	0	1	20	1	0
2	34381066	.	C	T	16	4	20	0	2	22	0	0
2	34555410	.	A	G	3	4	7	0	0	7	0	0
2	34573032	.	A	T	5	2	7	0	0	7	0	0
2	34698215	.	C	A	2	3	5	0	1	6	0	0
2	34714557	.	A	G	4	1	5	0	5	10	0	0
2	34924412	.	A	G	10	8	18	0	1	19	0	0
2	34962193	.	A	T	10	16	26	0	2	28	0	0
2	34962223	.	A	G	10	2	12	0	23	35	0	0
2	34970135	.	T	C	18	21	39	0	2	41	0	0
2	34970329	.	A	G	18	14	32	0	3	35	0	0
2	34981747	.	G	A	34	24	58	0	0	58	0	0
2	34981986	.	G	A	29	21	50	0	3	53	0	0
2	34982205	.	T	G	27	13	40	0	3	43	0	0
2	34982322	.	A	T	7	8	15	0	0	15	0	0
2	34986337	.	C	A	0	2	2	0	1	3	0	0
2	34986484	.	A	G	5	3	8	0	1	9	0	0
2	34986508	.	A	T	5	4	9	0	0	9	0	0
2	34986702	.	C	T	5	8	13	0	1	14	0	0
2	35012056	.	C	G	0	2	2	0	3	5	0	0
2	35126353	.	A	C	4	4	8	0	0	8	0	0
2	35437513	.	C	A	1	7	8	0	0	8	0	0
2	35457782	.	C	T	1	2	3	0	0	3	0	0
2	35473847	.	G	A	0	7	7	0	6	13	0	0
2	35473975	.	G	T	6	4	10	0	0	10	0	0
2	35474049	.	G	A	0	13	13	0	7	20	0	0
2	35474112	.	T	C	4	4	8	2	2	12	0	0
2	35593364	.	T	G	10	18	28	0	0	28	0	0
2	35594003	.	G	A	14	10	24	0	0	24	0	0
2	35595514	.	C	A	8	13	21	0	0	21	0	0
2	35595551	.	A	T	9	11	20	0	3	23	0	0
2	35598219	.	A	T	13	7	20	0	3	23	0	0
2	35598257	.	C	G	13	12	25	0	1	26	0	0
2	35601212	.	T	G	13	5	18	0	0	18	0	0
2	35605841	.	G	A	4	7	11	0	0	11	0	0
2	35607206	.	C	T	10	10	20	0	0	20	0	0
2	35608445	.	T	A	12	6	18	0	1	19	0	0
2	35610890	.	T	G	8	7	15	0	2	17	0	0
2	35611051	.	T	A	14	21	35	0	2	37	0	0
2	35611172	.	C	T	11	21	32	0	2	34	0	0
2	35611765	.	G	A	1	4	5	0	0	5	0	0
2	35730701	.	G	A	1	3	4	0	3	7	0	0
2	35731033	.	C	G	3	8	11	0	1	12	0	0
2	35731054	.	A	T	9	4	13	0	0	13	0	0
2	35731106	.	C	T	4	7	11	0	0	11	0	0
2	36073097	.	A	C	8	0	8	0	16	24	0	0
2	36712529	.	A	T	1	2	3	0	0	3	0	0
2	36714251	.	T	G	1	2	3	0	0	3	0	0
2	36720559	.	G	A	0	3	3	0	5	8	0	0
2	36722846	.	T	C	14	14	28	0	0	28	0	0
2	36724384	.	A	C	16	11	27	0	2	29	0	0
2	36727360	.	A	T	12	13	25	0	5	30	0	0
2	36816003	.	A	G	8	10	18	0	2	20	0	0
2	36816120	.	T	G	4	10	14	0	1	15	0	0
2	36816312	.	T	C	3	3	6	0	0	6	0	0
2	36816495	.	T	G	10	4	14	0	1	15	0	0
2	36816501	.	T	G	11	3	14	0	0	14	0	0
2	36816828	.	T	C	3	3	6	0	1	7	0	0
2	36817317	.	T	C	7	6	13	0	0	13	0	0
2	36817362	.	G	A	5	4	9	0	0	9	0	0
2	36819320	.	C	T	4	2	6	0	0	6	0	0
2	36828901	.	C	G	1	0	1	0	3	4	0	0
2	36834542	.	C	T	4	3	7	0	0	7	0	0
2	36834686	.	G	A	3	4	7	0	0	7	0	0
2	36838094	.	C	T	2	3	5	0	0	5	0	0
2	36838274	.	G	A	5	5	10	0	0	10	0	0
2	36838322	.	T	C	5	4	9	0	1	10	0	0
2	36838355	.	A	G	7	0	7	0	4	11	0	0
2	36840594	.	C	T	5	2	7	0	0	7	0	0
2	36840789	.	C	T	3	2	5	0	0	5	0	0
2	36844035	.	G	T	0	5	5	0	2	7	0	0
2	36852056	.	C	G	12	14	26	0	1	27	0	0
2	36853936	.	T	C	7	8	15	0	2	17	0	0
2	36853955	.	A	C	8	9	17	0	1	18	0	0
2	36854173	.	T	C	18	13	31	0	3	34	0	0
2	36854184	.	C	A	17	10	27	0	1	28	0	0
2	36889867	.	A	T	4	3	7	0	0	7	0	0
2	36892504	.	C	T	6	4	10	0	1	11	0	0
2	36892518	.	A	G	8	7	15	0	0	15	0	0
2	36919464	.	T	C	1	0	1	0	2	3	0	0
2	36919479	.	T	C	1	2	3	0	0	3	0	0
2	36921495	.	A	T	17	20	37	0	1	38	0	0
2	36921579	.	G	C	12	0	12	0	11	23	0	0
2	36921588	.	A	G	11	10	21	0	1	22	0	0
2	36922595	.	G	A	14	11	25	0	0	25	0	0
2	36922604	.	A	T	14	9	23	0	2	25	0	0
2	36922883	.	C	T	7	8	15	0	0	15	0	0
2	36922988	.	A	T	5	13	18	0	0	18	0	0
2	36923167	.	T	C	9	0	9	0	8	17	0	0
2	36924739	.	T	C	3	3	6	0	1	7	0	0
2	36941365	.	A	G	5	5	10	0	0	10	0	0
2	36990050	.	A	T	14	23	37	0	2	39	0	0
2	36990185	.	A	C	24	19	43	0	3	46	0	0
2	36990283	.	A	T	16	18	34	0	1	35	0	0
2	36990294	.	A	T	15	18	33	0	1	34	0	0
2	36990363	.	A	G	17	24	41	0	3	44	0	0
2	36990458	.	A	G	28	22	50	0	3	53	0	0
2	36992795	.	T	C	16	1	17	0	15	32	0	0
2	37043708	.	A	C	2	0	2	0	4	6	0	0
2	37089448	.	A	G	1	7	8	0	1	9	0	0
2	37098598	.	T	C	1	7	8	0	1	9	0	0
2	37123507	.	T	C	16	20	36	0	3	39	0	0
2	37123901	.	T	C	20	15	35	0	2	37	0	0
2	37124181	.	A	C	23	29	52	0	4	56	0	0
2	37124509	.	A	G	13	9	22	0	3	25	0	0
2	37124761	.	C	T	4	5	9	0	0	9	0	0
2	37124821	.	C	A	4	8	12	0	0	12	0	0
2	37124961	.	C	G	19	13	32	0	0	32	0	0
2	37128450	.	C	T	14	14	28	0	2	30	0	0
2	37138717	.	A	T	3	2	5	0	0	5	0	0
2	37141002	.	G	A	1	9	10	0	3	13	0	0
2	37145793	.	T	A	13	15	28	0	1	29	0	0
2	37145820	.	G	C	15	17	32	0	2	34	0	0
2	37146474	.	C	T	20	15	35	0	1	36	0	0
2	37146512	.	A	G	15	0	15	0	11	26	0	0
2	37189834	.	T	C	2	2	4	0	0	4	0	0
2	37191964	.	A	G	1	3	4	0	0	4	0	0
2	37193743	.	G	A	5	8	13	0	0	13	0	0
2	37195406	.	C	A	9	5	14	0	1	15	0	0
2	37195472	.	A	C	10	10	20	0	1	21	0	0
2	37201513	.	G	A	14	8	22	0	1	23	0	0
2	37205437	.	T	G	22	1	23	1	25	49	0	0
2	37205989	.	T	A	3	2	5	0	3	8	0	0
2	37257571	.	A	G	8	13	21	0	1	22	0	0
2	37261326	.	A	T	13	5	18	0	3	21	0	0
2	37263874	.	C	A	22	17	39	0	1	40	0	0
2	37264364	.	A	T	24	8	32	0	0	32	0	0
2	37264423	.	G	T	12	11	23	0	0	23	0	0
2	37264693	.	T	C	17	5	22	0	4	26	0	0
2	37264856	.	T	A	17	16	33	0	1	34	0	0
2	37264889	.	T	G	12	13	25	0	2	27	0	0
2	37264915	.	T	A	10	12	22	0	1	23	0	0
2	37264928	.	A	T	12	12	24	0	1	25	0	0
2	37265021	.	C	T	20	11	31	0	0	31	0	0
2	37265125	.	T	A	15	8	23	0	1	24	0	0
2	37265302	.	G	A	14	17	31	0	7	38	0	0
2	37265409	.	T	A	18	20	38	0	0	38	0	0
2	37267465	.	T	C	7	4	11	0	0	11	0	0
2	37267831	.	T	A	3	4	7	0	1	8	0	0
2	37272392	.	A	G	8	7	15	0	1	16	0	0
2	37274451	.	C	T	4	7	11	0	1	12	0	0
2	37274483	.	T	C	3	5	8	0	1	9	0	0
2	37274504	.	A	G	3	5	8	0	0	8	0	0
2	37280399	.	A	G	2	2	4	0	0	4	0	0
2	37280457	.	C	T	0	2	2	0	2	4	0	0
2	37307422	.	T	A	5	7	12	0	3	15	0	0
2	37307557	.	T	C	6	4	10	0	1	11	0	0
2	37365855	.	C	T	2	13	15	0	28	43	0	0
2	37366234	.	A	G	4	12	16	0	1	17	0	0
2	37366496	.	A	T	14	14	28	0	1	29	0	0
2	37366526	.	T	C	15	17	32	0	0	32	0	0
2	37366810	.	G	C	14	5	19	0	1	20	0	0
2	37366815	.	G	A	12	9	21	0	4	25	0	0
2	37375027	.	G	A	6	5	11	0	0	11	0	0
2	37379482	.	A	G	5	3	8	0	1	9	0	0
2	37383444	.	A	G	7	6	13	0	0	13	0	0
2	37424290	.	G	A	3	2	5	0	0	5	0	0
2	37428485	.	A	G	0	2	2	0	1	3	0	0
2	37428520	.	T	C	2	3	5	0	0	5	0	0
2	37428522	.	T	C	2	3	5	0	0	5	0	0
2	37428557	.	C	T	1	2	3	0	0	3	0	0
2	37428741	.	G	A	2	5	7	0	1	8	0	0
2	37428804	.	A	G	2	2	4	0	0	4	0	0
2	37433540	.	C	T	1	4	5	0	0	5	0	0
2	37436778	.	T	A	2	8	10	0	2	12	0	0
2	37455811	.	A	G	3	5	8	0	0	8	0	0
2	37458464	.	G	C	1	3	4	0	0	4	0	0
2	37469926	.	G	A	21	19	40	0	2	42	0	0
2	37469962	.	A	G	19	21	40	0	0	40	0	0
2	37470001	.	A	G	14	8	22	0	3	25	0	0
2	37471495	.	C	G	18	12	30	0	0	30	0	0
2	37496982	.	A	G	3	10	13	0	1	14	0	0
2	37502213	.	G	A	5	20	25	0	0	25	0	0
2	37502834	.	G	A	3	13	16	0	0	16	0	0
2	37545462	.	A	G	11	10	21	0	0	21	0	0
2	37545473	.	C	G	10	10	20	0	2	22	0	0
2	37545628	.	G	A	5	9	14	0	0	14	0	0
2	37546225	.	T	C	9	0	9	0	11	20	0	0
2	37555512	.	A	G	2	4	6	0	0	6	0	0
2	37559306	.	C	T	2	3	5	0	0	5	0	0
2	37559318	.	G	A	2	3	5	0	0	5	0	0
2	37564375	.	T	A	2	2	4	0	0	4	0	0
2	37656317	.	A	C	10	6	16	0	1	17	0	0
2	37656372	.	A	G	11	8	19	0	0	19	0	0
2	37656498	.	T	A	4	8	12	0	0	12	0	0
2	37656661	.	C	T	1	4	5	0	6	11	0	0
2	37656662	.	G	A	7	4	11	0	0	11	0	0
2	37664128	.	G	A	6	6	12	0	1	13	0	0
2	37778456	.	C	T	3	2	5	0	0	5	0	0
2	37823104	.	C	T	6	6	12	0	1	13	0	0
2	37823410	.	T	G	3	0	3	0	5	8	0	0
2	37827612	.	T	A	1	3	4	0	0	4	0	0
2	37827660	.	C	T	1	2	3	0	4	7	0	0
2	37827859	.	A	G	1	0	1	0	3	4	0	0
2	37827869	.	T	A	1	3	4	0	0	4	0	0
2	37827977	.	C	T	3	10	13	0	9	22	0	0
2	37830066	.	G	T	5	8	13	0	1	14	0	0
2	37830123	.	C	T	1	4	5	0	7	12	0	0
2	37830908	.	G	T	3	2	5	0	1	6	0	0
2	37830922	.	C	T	1	2	3	0	1	4	0	0
2	37831076	.	T	C	2	4	6	0	0	6	0	0
2	37834433	.	T	C	4	2	6	0	0	6	0	0
2	37837577	.	A	G	1	5	6	0	0	6	0	0
2	37840741	.	G	T	5	2	7	0	0	7	0	0
2	37841295	.	A	C	1	3	4	0	0	4	0	0
2	37841333	.	T	C	1	2	3	0	0	3	0	0
2	37867148	.	C	T	9	9	18	0	1	19	0	0
2	37867165	.	C	T	0	10	10	0	6	16	0	0
2	37892768	.	A	G	1	5	6	0	0	6	0	0
2	37892822	.	C	T	1	4	5	0	0	5	0	0
2	37895432	.	T	G	2	2	4	0	1	5	0	0
2	37895435	.	A	G	3	2	5	0	0	5	0	0
2	37990120	.	T	G	3	1	4	0	1	5	0	0
2	37990187	.	T	C	2	2	4	0	1	5	0	0
2	37990315	.	A	G	2	2	4	0	0	4	0	0
2	37995189	.	G	T	3	2	5	0	1	6	0	0
2	37998116	.	G	A	14	23	37	0	2	39	0	0
2	38000133	.	G	T	18	20	38	0	2	40	0	0
2	38000185	.	G	A	23	16	39	0	0	39	0	0
2	38004485	.	G	A	1	5	6	0	3	9	0	0
2	38004500	.	G	T	4	6	10	0	0	10	0	0
2	38008491	.	G	A	8	7	15	0	1	16	0	0
2	38008916	.	C	T	9	3	12	0	0	12	0	0
2	38018076	.	G	A	6	10	16	0	1	17	0	0
2	38032270	.	G	A	14	13	27	0	2	29	0	0
2	38033937	.	G	A	22	7	29	0	1	30	0	0
2	38033979	.	C	T	9	20	29	0	1	30	0	0
2	38034150	.	C	A	1	2	3	0	1	4	0	0
2	38056837	.	T	A	1	2	3	0	0	3	0	0
2	38056840	.	A	G	1	0	1	0	2	3	0	0
2	38064446	.	G	A	0	3	3	0	3	6	0	0
2	38064903	.	T	C	2	2	4	0	0	4	0	0
2	38065056	.	G	A	3	7	10	0	5	15	0	0
2	38065095	.	C	T	6	8	14	0	0	14	0	0
2	38065101	.	G	A	0	6	6	0	6	12	0	0
2	38065579	.	C	T	1	3	4	0	0	4	0	0
2	38065676	.	G	T	2	3	5	0	0	5	0	0
2	38068593	.	A	G	13	7	20	0	0	21	1	0
2	38068677	.	T	A	10	7	17	0	1	18	0	0
2	38072328	.	T	C	8	12	20	0	4	24	0	0
2	38072460	.	C	T	10	4	14	0	3	17	0	0
2	38072463	.	G	A	5	9	14	0	2	16	0	0
2	38072547	.	C	T	3	5	8	0	11	19	0	0
2	38072670	.	G	T	14	5	19	0	0	19	0	0
2	38072703	.	G	A	6	16	22	0	2	24	0	0
2	38073092	.	A	G	9	9	18	0	1	19	0	0
2	38076425	.	C	T	2	2	4	0	0	4	0	0
2	38076579	.	A	G	4	2	6	0	0	6	0	0
2	38087670	.	A	G	2	3	5	0	1	6	0	0
2	38087879	.	T	A	7	10	17	0	0	17	0	0
2	38088096	.	A	T	17	11	28	0	0	28	0	0
2	38088329	.	C	G	8	5	13	0	0	13	0	0
2	38088454	.	A	G	18	9	27	0	2	29	0	0
2	38088475	.	A	G	13	12	25	0	1	26	0	0
2	38088535	.	C	T	11	13	24	0	3	28	1	0
2	38092067	.	G	T	6	5	11	0	1	12	0	0
2	38095343	.	A	T	10	3	13	0	1	14	0	0
2	38098442	.	G	A	3	7	10	0	0	10	0	0
2	38098810	.	G	A	11	5	16	0	0	16	0	0
2	38098871	.	C	T	0	6	6	0	6	12	0	0
2	38101590	.	G	A	7	4	11	0	0	11	0	0
2	38101616	.	T	G	5	8	13	0	0	13	0	0
2	38102335	.	A	T	4	5	9	0	0	9	0	0
2	38106744	.	A	G	0	2	2	0	1	3	0	0
2	38112878	.	A	G	1	2	3	0	0	3	0	0
2	38112917	.	T	C	1	4	5	0	0	5	0	0
2	38121433	.	T	C	2	5	7	0	2	9	0	0
2	38121536	.	C	T	22	24	46	0	2	48	0	0
2	38121558	.	C	T	19	27	46	0	3	49	0	0
2	38123931	.	G	T	26	24	50	0	1	51	0	0
2	38124030	.	A	G	20	21	41	0	1	42	0	0
2	38151849	.	T	A	2	1	3	0	1	4	0	0
2	38152523	.	C	T	3	3	6	0	0	6	0	0
2	38152717	.	C	T	1	4	5	0	0	5	0	0
2	38153690	.	A	G	2	6	8	0	2	10	0	0
2	38153884	.	C	T	2	4	6	0	0	6	0	0
2	38153929	.	G	A	3	3	6	0	1	7	0	0
2	38154098	.	T	C	6	7	13	0	1	14	0	0
2	38154107	.	G	A	4	6	10	0	0	10	0	0
2	38154177	.	C	A	5	3	8	0	0	8	0	0
2	38154307	.	A	G	5	7	12	0	1	13	0	0
2	38154879	.	A	T	5	12	17	0	1	18	0	0
2	38155022	.	T	C	3	3	6	0	0	6	0	0
2	38155339	.	G	C	5	2	7	0	0	7	0	0
2	38155340	.	T	C	3	4	7	0	0	7	0	0
2	38155479	.	G	A	3	5	8	0	4	12	0	0
2	38155651	.	G	T	9	3	12	0	0	13	1	0
2	38155802	.	C	T	10	4	14	0	1	15	0	0
2	38156165	.	C	T	8	12	20	0	1	21	0	0
2	38156783	.	G	A	5	2	7	0	2	9	0	0
2	38182016	.	C	T	5	3	8	0	0	8	0	0
2	38182220	.	G	A	2	2	4	0	1	5	0	0
2	38198118	.	G	T	21	25	46	0	2	48	0	0
2	38198626	.	C	T	18	29	47	0	4	51	0	0
2	38198627	.	T	G	22	29	51	0	0	51	0	0
2	38199761	.	C	T	20	31	51	0	1	52	0	0
2	38199764	.	G	T	17	30	47	0	3	50	0	0
2	38200181	.	A	G	14	26	40	0	3	43	0	0
2	38200830	.	G	A	21	17	38	0	2	40	0	0
2	38201073	.	T	C	18	2	20	0	15	35	0	0
2	38201864	.	C	A	14	18	32	0	0	32	0	0
2	38202356	.	C	T	22	24	46	0	3	49	0	0
2	38202890	.	C	A	28	39	67	1	0	69	1	0
2	38204025	.	C	A	1	4	5	0	3	8	0	0
2	38204177	.	C	T	7	3	10	0	1	11	0	0
2	38204810	.	T	C	2	4	6	0	0	6	0	0
2	38213642	.	G	T	14	19	33	0	7	40	0	0
2	38214094	.	C	T	5	26	31	0	27	58	0	0
2	38214102	.	C	T	25	29	54	0	5	59	0	0
2	38214164	.	C	T	29	26	55	0	4	59	0	0
2	38214720	.	C	T	30	18	48	0	3	51	0	0
2	38214974	.	T	G	9	2	11	28	3	42	0	0
2	38215391	.	G	A	28	20	48	0	7	55	0	0
2	38215860	.	C	T	3	18	21	0	26	47	0	0
2	38216481	.	C	T	21	21	42	0	5	47	0	0
2	38216502	.	C	T	23	18	41	0	2	43	0	0
2	38216580	.	T	C	20	9	29	0	3	32	0	0
2	38227332	.	C	A	5	6	11	0	0	11	0	0
2	38265504	.	G	A	6	6	12	0	1	13	0	0
2	38266439	.	C	T	3	5	8	0	0	8	0	0
2	38269105	.	G	A	13	4	17	0	1	18	0	0
2	38269114	.	T	G	4	12	16	0	0	16	0	0
2	38269355	.	G	A	9	6	15	0	2	17	0	0
2	38288796	.	A	T	14	11	25	0	0	25	0	0
2	38289260	.	G	A	17	20	37	0	1	38	0	0
2	38289393	.	C	T	10	15	25	0	2	27	0	0
2	38289494	.	T	A	6	10	16	0	4	20	0	0
2	38289496	.	A	G	6	0	6	0	14	20	0	0
2	38289633	.	G	A	3	12	15	0	1	16	0	0
2	38301998	.	A	G	1	6	7	0	1	8	0	0
2	38373380	.	T	C	15	10	25	0	5	30	0	0
2	38378888	.	T	A	10	7	17	0	3	20	0	0
2	38391846	.	T	C	13	17	30	1	0	31	0	0
2	38391847	.	T	C	12	17	29	1	1	31	0	0
2	38391945	.	C	T	25	19	44	0	0	44	0	0
2	38695337	.	C	T	1	2	3	0	1	4	0	0
2	38699469	.	C	T	2	2	4	0	0	4	0	0
2	38699526	.	G	A	1	3	4	0	0	4	0	0
2	38708714	.	A	T	5	4	9	0	0	9	0	0
2	38708744	.	C	T	3	6	9	0	1	10	0	0
2	38708780	.	T	A	8	7	15	0	1	16	0	0
2	38847349	.	C	T	4	3	7	0	1	8	0	0
2	38852648	.	T	C	1	3	4	0	0	4	0	0
2	38861234	.	C	T	2	6	8	0	0	8	0	0
2	38862666	.	A	T	2	2	4	0	1	5	0	0
2	38862880	.	G	A	4	3	7	0	0	7	0	0
2	38880942	.	C	T	2	3	5	0	0	5	0	0
2	38880999	.	G	A	5	4	9	0	0	9	0	0
2	38881164	.	A	G	1	3	4	0	2	6	0	0
2	38887527	.	A	G	5	2	7	0	0	7	0	0
2	38887772	.	C	A	14	4	18	0	0	19	1	0
2	38887932	.	G	C	4	5	9	0	2	11	0	0
2	38888057	.	T	C	4	3	7	0	2	9	0	0
2	38888157	.	T	A	4	4	8	0	2	10	0	0
2	38888170	.	T	C	6	7	13	0	1	14	0	0
2	38888235	.	A	G	9	10	19	0	0	19	0	0
2	38888272	.	T	C	11	8	19	0	0	19	0	0
2	38888517	.	A	C	8	7	15	0	1	16	0	0
2	38888701	.	T	C	4	2	6	0	1	7	0	0
2	38888710	.	G	A	2	5	7	0	0	7	0	0
2	38888789	.	C	T	2	5	7	0	0	7	0	0
2	38888820	.	A	C	7	3	10	0	2	12	0	0
2	38888895	.	T	C	6	7	13	0	0	13	0	0
2	38888953	.	T	C	1	5	6	0	1	7	0	0
2	38889114	.	G	A	4	5	9	0	0	9	0	0
2	38889369	.	A	G	13	0	13	0	13	26	0	0
2	38889389	.	G	T	12	13	25	0	0	25	0	0
2	38889487	.	A	G	14	1	15	0	13	28	0	0
2	38889523	.	G	C	3	16	19	0	10	29	0	0
2	38890481	.	T	C	15	10	25	0	1	26	0	0
2	38890495	.	C	A	15	10	25	0	0	25	0	0
2	38977157	.	G	A	4	2	6	0	1	7	0	0
2	38977159	.	T	C	4	3	7	0	0	7	0	0
2	38977266	.	C	A	1	6	7	0	0	7	0	0
2	38977269	.	A	G	1	5	6	0	0	6	0	0
2	38997411	.	A	G	1	4	5	0	4	9	0	0
2	38997627	.	G	T	17	20	37	1	2	40	0	0
2	38997631	.	A	G	19	22	41	1	0	42	0	0
2	38998100	.	G	T	31	14	45	0	3	48	0	0
2	39001713	.	G	A	21	16	37	0	0	37	0	0
2	39001975	.	A	G	16	15	31	0	2	33	0	0
2	39001993	.	G	T	15	16	31	0	0	31	0	0
2	39002038	.	G	A	10	13	23	0	0	23	0	0
2	39002164	.	C	T	0	11	11	0	10	21	0	0
2	39002546	.	G	C	15	10	25	0	3	28	0	0
2	39002692	.	T	C	5	4	9	0	2	11	0	0
2	39005438	.	C	T	7	8	15	0	0	15	0	0
2	39005447	.	A	G	5	8	13	0	1	14	0	0
2	39011421	.	T	A	3	7	10	0	0	10	0	0
2	39013572	.	A	T	5	2	7	0	0	7	0	0
2	39028379	.	T	G	1	4	5	0	0	5	0	0
2	39028570	.	G	T	4	3	7	0	0	7	0	0
2	39028774	.	G	T	6	3	9	0	0	9	0	0
2	39028811	.	G	T	6	7	13	0	1	14	0	0
2	39036516	.	G	T	3	5	8	1	1	10	0	0
2	39063064	.	A	T	1	3	4	0	0	4	0	0
2	39063080	.	G	A	1	2	3	0	0	3	0	0
2	39063361	.	C	G	3	3	6	0	1	7	0	0
2	39068306	.	T	A	3	6	9	0	0	9	0	0
2	39068365	.	C	T	3	10	13	0	0	13	0	0
2	39068409	.	C	A	5	3	8	0	0	8	0	0
2	39082746	.	A	G	0	2	2	0	1	3	0	0
2	39082799	.	A	G	1	2	3	0	0	3	0	0
2	39549505	.	G	A	0	2	2	0	2	4	0	0
2	39549510	.	C	A	2	2	4	0	0	4	0	0
2	39549780	.	C	T	2	5	7	0	0	7	0	0
2	39549898	.	A	G	3	3	6	0	0	6	0	0
2	39550067	.	A	G	1	2	3	1	0	4	0	0
2	39550070	.	G	A	1	2	3	1	0	4	0	0
2	39550307	.	T	C	4	2	6	0	0	6	0	0
2	39550380	.	A	C	1	2	3	0	0	3	0	0
2	39550494	.	C	T	1	2	3	0	0	3	0	0
2	39550627	.	G	A	6	3	9	0	0	9	0	0
2	39550755	.	C	T	2	4	6	0	0	6	0	0
2	39550761	.	A	C	2	3	5	0	0	5	0	0
2	39550854	.	G	A	0	9	9	0	2	11	0	0
2	39550901	.	C	T	2	5	7	0	1	8	0	0
2	39551185	.	T	C	8	8	16	0	1	17	0	0
2	39551213	.	G	A	1	7	8	0	3	11	0	0
2	39551304	.	C	T	5	3	8	0	1	9	0	0
2	39551421	.	T	C	4	3	7	0	0	7	0	0
2	39551869	.	T	G	3	3	6	0	0	6	0	0
2	39553173	.	A	C	6	7	13	0	0	13	0	0
2	39553209	.	C	T	9	11	20	0	0	20	0	0
2	39553213	.	A	G	15	6	21	0	0	21	0	0
2	39553279	.	G	A	10	8	18	0	1	19	0	0
2	39553283	.	A	T	7	9	16	0	2	18	0	0
2	39553351	.	G	A	7	2	9	0	1	10	0	0
2	39553627	.	T	A	5	1	6	0	0	6	0	0
2	39553631	.	T	A	4	1	5	0	1	6	0	0
2	39554098	.	A	C	7	12	19	0	2	21	0	0
2	39554169	.	C	A	3	15	18	0	0	18	0	0
2	39554180	.	A	C	4	14	18	0	0	18	0	0
2	39554514	.	A	C	7	9	16	0	1	17	0	0
2	39584287	.	A	T	7	5	12	0	1	13	0	0
2	39584370	.	T	C	4	1	5	0	5	10	0	0
2	39584465	.	A	T	7	3	10	0	0	10	0	0
2	39584466	.	T	A	7	3	10	0	0	10	0	0
2	39584528	.	G	A	10	12	22	0	0	22	0	0
2	39585130	.	G	A	6	7	13	0	0	13	0	0
2	39649553	.	G	A	5	6	11	0	0	11	0	0
2	39649589	.	C	T	4	3	7	0	1	8	0	0
2	39649592	.	C	T	3	3	6	0	1	7	0	0
2	39649655	.	G	C	4	0	4	0	10	14	0	0
2	39649673	.	C	T	10	2	12	0	2	14	0	0
2	39649799	.	C	T	8	7	15	0	1	16	0	0
2	39650108	.	T	C	6	3	9	0	0	9	0	0
2	39650191	.	T	C	4	6	10	0	2	12	0	0
2	39731567	.	C	T	20	17	37	0	3	40	0	0
2	39732139	.	C	A	12	14	26	0	2	28	0	0
2	39732157	.	G	A	8	17	25	0	0	25	0	0
2	39732710	.	T	C	9	5	14	0	2	16	0	0
2	39732743	.	T	C	10	0	10	0	5	15	0	0
2	39732767	.	A	G	8	6	14	0	0	14	0	0
2	39732818	.	C	T	1	12	13	0	7	20	0	0
2	39732833	.	G	A	7	11	18	0	0	18	0	0
2	39732955	.	A	G	18	13	31	0	0	31	0	0
2	39732967	.	T	G	16	14	30	0	3	33	0	0
2	39733130	.	T	A	23	16	39	1	8	48	0	0
2	39733531	.	C	T	12	7	19	0	1	20	0	0
2	39734298	.	A	G	13	9	22	1	1	24	0	0
2	39734396	.	G	A	12	9	21	0	0	21	0	0
2	39734410	.	A	T	9	13	22	0	1	23	0	0
2	39734444	.	A	G	14	18	32	0	0	32	0	0
2	39734494	.	T	A	19	12	31	0	2	33	0	0
2	39735568	.	T	C	9	0	9	0	10	19	0	0
2	40067983	.	A	G	12	5	17	0	0	17	0	0
2	40068188	.	C	T	27	24	51	0	4	55	0	0
2	40068238	.	G	A	24	25	49	0	4	53	0	0
2	40068279	.	G	A	31	16	47	0	2	49	0	0
2	40068281	.	T	G	33	16	49	0	1	50	0	0
2	40068372	.	G	A	26	17	43	0	3	46	0	0
2	40068386	.	G	A	18	30	48	0	5	53	0	0
2	40069392	.	G	A	16	17	33	0	7	40	0	0
2	40070040	.	A	G	11	10	21	0	1	22	0	0
2	40074474	.	G	A	8	9	17	0	0	17	0	0
2	40088719	.	G	A	3	5	8	0	3	11	0	0
2	40088785	.	G	A	3	4	7	0	1	8	0	0
2	40090490	.	C	T	5	5	10	0	1	11	0	0
2	40094202	.	A	T	6	2	8	0	0	8	0	0
2	40094217	.	G	C	2	5	7	0	1	8	0	0
2	40100281	.	G	A	3	4	7	0	0	7	0	0
2	40343124	.	G	A	2	2	4	0	0	4	0	0
2	40407135	.	A	G	2	2	4	0	0	4	0	0
2	40500542	.	T	C	4	3	7	0	0	7	0	0
2	40500596	.	T	C	2	5	7	0	0	7	0	0
2	40507030	.	T	C	4	6	10	0	0	10	0	0
2	40507060	.	A	G	6	5	11	0	2	13	0	0
2	40513998	.	C	T	3	5	8	0	0	8	0	0
2	40830967	.	T	C	3	9	12	0	1	13	0	0
2	40831119	.	C	A	7	4	11	0	0	11	0	0
2	40831176	.	A	T	8	4	12	0	0	12	0	0
2	40831613	.	A	T	2	3	5	0	1	6	0	0
2	40831728	.	T	C	5	10	15	0	1	16	0	0
2	40831797	.	C	T	5	5	10	0	1	11	0	0
2	40831822	.	T	A	5	8	13	0	1	14	0	0
2	40832019	.	C	T	6	3	9	0	0	9	0	0
2	40832026	.	T	A	6	1	7	0	1	8	0	0
2	40832537	.	T	A	4	3	7	0	1	8	0	0
2	40832596	.	C	T	4	2	6	0	0	6	0	0
2	40832808	.	A	T	1	3	4	0	0	4	0	0
2	40832815	.	A	G	1	1	2	0	0	2	0	0
2	40832984	.	T	C	4	3	7	0	0	7	0	0
2	40833063	.	A	G	6	4	10	0	0	10	0	0
2	40833068	.	A	G	6	4	10	0	0	10	0	0
2	40833229	.	A	T	2	4	6	0	0	6	0	0
2	40850767	.	G	A	1	2	3	0	0	3	0	0
2	41524321	.	A	G	2	4	6	0	0	6	0	0
2	41532745	.	A	G	2	4	6	0	0	6	0	0
2	41532746	.	A	G	2	4	6	0	0	6	0	0
2	41539251	.	G	A	2	10	12	0	10	22	0	0
2	41542080	.	T	G	12	13	25	0	0	25	0	0
2	41542451	.	T	C	8	6	14	0	1	15	0	0
2	41542601	.	G	A	14	9	23	0	0	23	0	0
2	41542637	.	A	G	14	0	14	0	10	24	0	0
2	41556739	.	A	G	3	4	7	0	0	7	0	0
2	41563467	.	T	C	2	5	7	0	0	7	0	0
2	41563470	.	T	C	1	6	7	0	0	7	0	0
2	41563509	.	T	C	1	6	7	0	0	7	0	0
2	41563513	.	T	C	5	2	7	0	0	7	0	0
2	41563610	.	T	C	3	5	8	0	0	8	0	0
2	41563612	.	A	C	3	5	8	0	0	8	0	0
2	41563686	.	T	G	12	9	21	0	1	22	0	0
2	41563689	.	G	A	13	9	22	0	0	22	0	0
2	41566463	.	T	C	6	6	12	0	0	12	0	0
2	41566770	.	T	G	12	7	19	0	0	19	0	0
2	41566852	.	C	T	4	8	12	0	0	12	0	0
2	41569177	.	T	C	11	8	19	0	0	19	0	0
2	41578181	.	A	T	12	27	39	0	1	40	0	0
2	41578281	.	C	T	12	11	23	0	7	32	2	0
2	41578656	.	C	A	10	10	20	0	0	20	0	0
2	41578716	.	T	A	15	6	21	0	0	21	0	0
2	41578921	.	C	T	8	6	14	0	1	15	0	0
2	41579539	.	C	G	1	8	9	0	7	16	0	0
2	41579572	.	C	G	6	9	15	0	0	15	0	0
2	41579621	.	A	C	8	0	8	0	6	14	0	0
2	41579646	.	G	T	9	5	14	0	3	17	0	0
2	41579701	.	G	C	6	11	17	0	1	18	0	0
2	41579804	.	T	C	11	15	26	0	1	27	0	0
2	41579952	.	C	A	11	12	23	0	1	24	0	0
2	41579984	.	A	G	10	11	21	0	0	21	0	0
2	41580004	.	C	A	8	10	18	0	0	18	0	0
2	41580028	.	T	C	5	7	12	0	0	12	0	0
2	41580125	.	C	T	10	13	23	0	1	24	0	0
2	41580263	.	T	A	8	8	16	0	0	16	0	0
2	41580473	.	C	T	1	9	10	0	14	24	0	0
2	41580522	.	G	A	8	7	15	0	2	17	0	0
2	41580546	.	A	G	8	4	12	0	3	15	0	0
2	41580715	.	C	T	2	14	16	0	12	28	0	0
2	41580832	.	G	T	5	3	8	0	0	8	0	0
2	41580946	.	A	C	10	8	18	0	1	19	0	0
2	41580966	.	T	C	13	7	20	0	2	22	0	0
2	41581035	.	T	A	26	7	33	2	2	37	0	0
2	41581042	.	C	G	4	7	11	0	23	34	0	0
2	41581815	.	T	A	5	9	14	4	5	23	0	0
2	41581998	.	G	T	9	8	17	4	3	24	0	0
2	41582047	.	T	C	10	3	13	0	2	15	0	0
2	41582136	.	G	A	5	14	19	0	1	20	0	0
2	41582383	.	A	C	2	7	9	0	0	9	0	0
2	41582801	.	T	C	2	4	6	0	1	7	0	0
2	41582805	.	C	T	2	4	6	0	0	6	0	0
2	41582923	.	C	T	2	6	8	0	0	8	0	0
2	41583007	.	A	G	1	5	6	0	0	6	0	0
2	41583043	.	A	G	2	5	7	0	1	8	0	0
2	41583171	.	C	T	2	6	8	0	5	13	0	0
2	41585878	.	A	G	4	5	9	0	0	9	0	0
2	41597062	.	A	C	2	0	2	0	3	5	0	0
2	41599247	.	G	A	3	5	8	0	0	8	0	0
2	41620101	.	A	T	1	4	5	0	2	7	0	0
2	41835464	.	G	A	1	3	4	0	0	4	0	0
2	41846755	.	C	T	3	5	8	0	0	8	0	0
2	42021468	.	T	C	2	2	4	0	0	4	0	0
2	42039046	.	G	A	3	8	11	0	0	11	0	0
2	42039112	.	A	G	6	6	12	0	1	13	0	0
2	42049030	.	G	C	5	6	11	0	1	12	0	0
2	42049795	.	T	A	6	3	9	0	0	9	0	0
2	42049797	.	T	G	6	3	9	0	0	9	0	0
2	42051071	.	G	A	2	4	6	0	0	6	0	0
2	42063897	.	C	T	0	6	6	0	5	11	0	0
2	42068217	.	T	G	1	5	6	0	0	6	0	0
2	42071276	.	A	T	2	2	4	0	0	4	0	0
2	42074485	.	C	T	1	2	3	0	0	3	0	0
2	42074515	.	G	A	1	3	4	0	0	4	0	0
2	42081425	.	T	C	1	3	4	0	0	4	0	0
2	42102982	.	G	A	3	2	5	0	0	5	0	0
2	42156579	.	A	G	15	8	23	0	3	26	0	0
2	42156637	.	G	A	19	13	32	0	2	34	0	0
2	42158839	.	C	T	10	16	26	0	2	28	0	0
2	42159159	.	G	T	11	11	22	0	0	22	0	0
2	42161309	.	A	G	16	17	33	0	4	37	0	0
2	42161351	.	C	T	16	13	29	0	1	30	0	0
2	42168496	.	G	A	8	15	23	0	1	24	0	0
2	42168505	.	A	T	7	16	23	0	0	23	0	0
2	42176962	.	T	C	3	2	5	0	0	5	0	0
2	42177056	.	C	T	3	4	7	0	0	7	0	0
2	42177075	.	G	A	3	2	5	0	0	5	0	0
2	42179607	.	C	A	2	4	6	0	0	6	0	0
2	42179675	.	A	G	3	0	3	0	3	6	0	0
2	42184056	.	T	G	1	3	4	0	0	4	0	0
2	42200453	.	C	A	2	3	5	0	2	7	0	0
2	42202043	.	T	C	5	4	9	0	0	9	0	0
2	42206954	.	A	G	2	4	6	0	0	6	0	0
2	42210061	.	T	C	7	6	13	0	3	16	0	0
2	42210431	.	G	T	3	4	7	0	0	7	0	0
2	42221346	.	T	G	2	5	7	0	0	7	0	0
2	42221956	.	A	G	2	0	2	0	7	9	0	0
2	42224067	.	C	T	5	4	9	0	0	9	0	0
2	42224171	.	G	T	0	2	2	0	4	6	0	0
2	42224255	.	G	A	3	4	7	0	0	7	0	0
2	42224315	.	C	T	2	4	6	0	1	7	0	0
2	42224403	.	G	C	0	6	6	0	1	7	0	0
2	42224455	.	C	T	4	4	8	0	0	8	0	0
2	42224535	.	T	G	8	4	12	0	0	12	0	0
2	42224544	.	C	A	7	5	12	0	0	12	0	0
2	42224628	.	C	A	3	2	5	0	0	5	0	0
2	42224629	.	A	G	3	2	5	0	0	5	0	0
2	42354723	.	G	A	2	1	3	0	2	5	0	0
2	42355076	.	T	A	1	2	3	0	1	4	0	0
2	42355086	.	A	G	1	2	3	0	0	3	0	0
2	42361415	.	T	C	3	5	8	0	1	9	0	0
2	42361517	.	C	A	11	10	21	0	0	21	0	0
2	42361616	.	T	A	7	7	14	0	1	15	0	0
2	42361790	.	C	T	15	20	35	0	2	37	0	0
2	42370736	.	A	G	14	14	28	0	2	30	0	0
2	42373646	.	G	T	11	17	28	0	2	30	0	0
2	42374218	.	G	A	15	12	27	0	1	28	0	0
2	42374455	.	T	A	13	18	31	0	2	33	0	0
2	42382574	.	G	A	5	5	10	0	0	10	0	0
2	42382609	.	G	T	6	4	10	0	3	13	0	0
2	42382670	.	G	A	9	13	22	0	3	25	0	0
2	42382687	.	C	G	10	13	23	1	0	24	0	0
2	42382744	.	T	C	11	21	32	1	2	35	0	0
2	42382905	.	T	A	23	12	35	0	3	38	0	0
2	42383032	.	A	G	10	5	15	0	2	17	0	0
2	42383064	.	C	T	0	6	6	0	15	21	0	0
2	42383071	.	T	C	15	7	22	0	1	23	0	0
2	42383209	.	A	G	9	10	19	0	1	20	0	0
2	42383227	.	T	G	12	15	27	0	2	29	0	0
2	42383263	.	A	G	21	18	39	0	0	39	0	0
2	42383327	.	G	A	24	12	36	0	0	36	0	0
2	42383757	.	A	C	25	13	38	0	3	41	0	0
2	42383768	.	A	G	30	12	42	0	2	44	0	0
2	42383947	.	C	A	15	14	29	0	2	31	0	0
2	42384313	.	A	G	18	11	29	0	3	32	0	0
2	42384338	.	C	A	18	9	27	0	4	31	0	0
2	42384365	.	T	G	10	9	19	0	2	21	0	0
2	42384382	.	C	T	11	10	21	0	0	21	0	0
2	42384587	.	C	A	16	11	27	0	0	27	0	0
2	42384588	.	A	G	12	10	22	0	5	27	0	0
2	42384637	.	G	A	15	9	24	0	1	25	0	0
2	42384699	.	A	C	11	15	26	0	1	27	0	0
2	42384961	.	T	G	3	10	13	0	2	15	0	0
2	42385022	.	T	C	8	7	15	0	0	15	0	0
2	42385023	.	T	C	8	7	15	0	0	15	0	0
2	42385447	.	C	G	1	5	6	0	5	11	0	0
2	42385498	.	T	C	6	0	6	0	7	13	0	0
2	42388341	.	A	G	1	3	4	1	0	5	0	0
2	42391328	.	C	T	2	3	5	0	0	5	0	0
2	42393550	.	C	T	0	2	2	0	1	3	0	0
2	42396218	.	A	G	1	2	3	0	0	3	0	0
2	42399232	.	T	G	9	12	21	0	3	24	0	0
2	42401362	.	G	C	14	12	26	0	4	30	0	0
2	42407395	.	A	G	8	7	15	0	1	16	0	0
2	42420100	.	T	A	1	3	4	0	0	4	0	0
2	42420166	.	A	C	1	0	1	0	4	5	0	0
2	42420175	.	C	T	0	4	4	0	1	5	0	0
2	42420296	.	A	G	2	4	6	0	0	6	0	0
2	42420395	.	A	G	5	5	10	0	0	10	0	0
2	42420430	.	T	A	5	8	13	0	0	13	0	0
2	42420542	.	G	A	4	3	7	0	0	7	0	0
2	42420933	.	C	T	1	3	4	0	1	5	0	0
2	42420940	.	A	T	3	2	5	0	1	6	0	0
2	42421921	.	T	G	1	5	6	0	0	6	0	0
2	42422589	.	C	T	4	2	6	0	0	6	0	0
2	42424988	.	C	T	3	2	5	0	0	5	0	0
2	42432200	.	T	A	1	3	4	0	0	4	0	0
2	42501860	.	G	A	10	13	23	0	2	25	0	0
2	42504589	.	G	C	9	15	24	0	2	26	0	0
2	42508957	.	G	A	9	6	15	0	2	17	0	0
2	42508987	.	C	A	13	8	21	0	1	22	0	0
2	42510637	.	G	A	8	5	13	0	0	13	0	0
2	42510664	.	G	A	6	3	9	0	0	9	0	0
2	42511464	.	T	G	5	2	7	0	0	7	0	0
2	42511681	.	T	C	2	2	4	0	0	4	0	0
2	42514156	.	G	A	4	3	7	0	0	7	0	0
2	42514162	.	G	A	6	2	8	0	1	9	0	0
2	42517602	.	G	A	6	5	11	0	0	11	0	0
2	42519767	.	G	A	4	8	12	0	1	13	0	0
2	42519897	.	T	C	5	7	12	0	0	12	0	0
2	42526893	.	A	G	1	3	4	0	1	5	0	0
2	42526931	.	G	A	4	7	11	0	0	11	0	0
2	42530463	.	G	A	6	7	13	0	1	14	0	0
2	42542024	.	T	C	1	4	5	0	0	5	0	0
2	42546196	.	G	A	3	2	5	0	0	5	0	0
2	42552653	.	G	A	2	3	5	0	0	5	0	0
2	42597593	.	C	T	2	3	5	0	0	5	0	0
2	42599855	.	A	G	3	3	6	0	0	6	0	0
2	42599962	.	C	G	4	3	7	0	0	7	0	0
2	42609479	.	A	G	2	3	5	0	1	6	0	0
2	42617068	.	C	T	2	2	4	0	0	4	0	0
2	42746504	.	G	C	33	30	63	0	6	69	0	0
2	42746530	.	G	T	6	40	46	0	32	78	0	0
2	42746604	.	C	T	31	32	63	0	4	67	0	0
2	42746833	.	C	T	41	28	69	0	2	71	0	0
2	42747069	.	G	T	28	41	69	0	1	70	0	0
2	42747281	.	T	G	24	25	49	0	10	59	0	0
2	42747389	.	T	C	29	12	41	2	11	54	0	0
2	42748186	.	A	T	28	22	50	2	18	70	0	0
2	42748211	.	A	G	39	34	73	4	10	87	0	0
2	42748257	.	G	C	52	18	70	3	5	78	0	0
2	42776527	.	A	G	17	19	36	0	2	38	0	0
2	42776569	.	A	G	18	19	37	0	1	38	0	0
2	42776683	.	A	G	18	17	35	0	0	35	0	0
2	42780657	.	T	C	16	11	27	0	1	28	0	0
2	42814888	.	A	G	6	10	16	0	2	18	0	0
2	42814928	.	A	G	9	13	22	0	1	23	0	0
2	42817384	.	G	T	12	10	22	0	0	22	0	0
2	42817462	.	A	T	11	6	17	0	2	19	0	0
2	42817504	.	G	A	11	3	14	0	0	14	0	0
2	42925153	.	G	A	6	6	12	0	0	12	0	0
2	42930540	.	A	C	5	2	7	0	1	8	0	0
2	43082608	.	G	A	1	2	3	0	0	3	0	0
2	43113478	.	T	C	3	2	5	0	0	5	0	0
2	43159217	.	T	G	10	14	24	0	2	26	0	0
2	43159293	.	G	A	7	6	13	2	0	15	0	0
2	43159302	.	A	C	7	6	13	2	0	15	0	0
2	43159390	.	A	T	9	4	13	0	2	15	0	0
2	43159396	.	T	C	9	4	13	0	2	15	0	0
2	43159500	.	G	A	11	4	15	0	0	15	0	0
2	43159613	.	A	G	5	6	11	0	0	11	0	0
2	43159781	.	A	G	6	9	15	0	0	15	0	0
2	43159868	.	T	C	6	6	12	0	2	14	0	0
2	43163958	.	T	C	8	0	8	0	8	16	0	0
2	43168096	.	T	C	2	9	11	0	0	11	0	0
2	43168123	.	A	G	7	6	13	0	0	13	0	0
2	43385029	.	A	G	1	2	3	0	1	4	0	0
2	43586793	.	A	C	15	11	26	0	1	27	0	0
2	43587478	.	A	T	14	11	25	0	2	27	0	0
2	43589691	.	C	G	7	6	13	0	1	14	0	0
2	43589856	.	T	C	16	16	32	0	2	34	0	0
2	43590136	.	A	T	13	5	18	0	2	20	0	0
2	43593210	.	C	T	2	7	9	0	6	15	0	0
2	43593651	.	T	C	5	7	12	0	0	12	0	0
2	43593696	.	T	G	5	7	12	0	4	16	0	0
2	43714362	.	A	G	10	11	21	0	0	21	0	0
2	43723092	.	C	T	18	7	25	0	0	25	0	0
2	43739287	.	T	C	8	7	15	0	1	16	0	0
2	43739401	.	G	C	3	5	8	0	1	9	0	0
2	43795117	.	G	A	1	6	7	0	0	7	0	0
2	43796290	.	A	C	2	3	5	0	0	5	0	0
2	43796598	.	T	C	5	2	7	0	0	7	0	0
2	43796738	.	G	A	1	2	3	0	3	6	0	0
2	43796756	.	G	A	0	3	3	0	6	9	0	0
2	43810898	.	A	G	5	2	7	0	0	7	0	0
2	43813088	.	A	G	3	3	6	0	0	6	0	0
2	43813193	.	G	A	6	3	9	1	0	10	0	0
2	43817760	.	A	C	1	2	3	0	0	3	0	0
2	43817875	.	T	G	2	3	5	0	0	5	0	0
2	43962071	.	C	G	11	8	19	0	2	21	0	0
2	43962108	.	C	A	1	9	10	0	11	21	0	0
2	43962279	.	C	T	12	6	18	0	0	18	0	0
2	43962328	.	T	A	10	7	17	0	1	18	0	0
2	43962483	.	T	A	5	9	14	0	2	16	0	0
2	43962600	.	C	T	3	6	9	0	0	9	0	0
2	43962613	.	T	C	10	4	14	0	0	14	0	0
2	43962864	.	C	T	1	12	13	0	12	25	0	0
2	43962983	.	T	C	8	11	19	0	1	20	0	0
2	43963097	.	G	C	7	14	21	0	1	22	0	0
2	43963136	.	C	T	2	16	18	0	6	24	0	0
2	43963163	.	C	T	0	15	15	0	7	22	0	0
2	43963202	.	T	C	7	0	7	0	14	21	0	0
2	43963454	.	A	T	6	9	15	0	0	15	0	0
2	43963493	.	A	G	7	11	18	0	0	18	0	0
2	43976261	.	G	A	7	2	9	0	0	9	0	0
2	43976333	.	C	A	4	3	7	0	0	7	0	0
2	43976339	.	T	C	6	0	6	0	2	8	0	0
2	43983668	.	T	A	3	6	9	0	1	10	0	0
2	44192871	.	T	C	23	17	40	0	2	42	0	0
2	44192893	.	T	C	22	22	44	0	2	46	0	0
2	44193029	.	T	A	24	27	51	0	1	52	0	0
2	44193742	.	C	T	2	27	29	1	9	39	0	0
2	44193769	.	T	G	17	26	43	1	0	44	0	0
2	44259855	.	G	A	40	39	79	0	6	85	0	0
2	44260002	.	C	T	36	49	85	0	1	86	0	0
2	44260088	.	A	G	35	22	57	0	2	59	0	0
2	44260100	.	A	T	34	22	56	0	1	57	0	0
2	44260358	.	G	A	26	35	61	0	13	74	0	0
2	44260836	.	T	C	41	2	43	5	23	71	0	0
2	44261028	.	A	G	17	28	45	0	2	47	0	0
2	44263025	.	G	A	2	3	5	0	0	5	0	0
2	44276731	.	A	G	26	25	51	0	2	53	0	0
2	44301404	.	C	T	0	3	3	0	1	4	0	0
2	44304374	.	A	G	6	6	12	0	1	14	1	0
2	44304386	.	T	C	6	8	14	0	0	14	0	0
2	44304485	.	G	C	10	0	10	0	8	18	0	0
2	44304515	.	T	C	12	6	18	0	2	20	0	0
2	44331020	.	T	C	3	3	6	0	1	7	0	0
2	44338973	.	G	T	2	5	7	0	0	7	0	0
2	44339189	.	C	A	2	3	5	0	0	5	0	0
2	44340788	.	C	T	1	3	4	0	0	4	0	0
2	44362262	.	T	G	3	0	3	0	4	7	0	0
2	44362475	.	G	A	0	4	4	0	1	5	0	0
2	44362806	.	A	G	1	3	4	0	0	4	0	0
2	44383457	.	A	G	11	12	23	0	1	24	0	0
2	44398551	.	A	C	7	3	10	0	1	11	0	0
2	44398611	.	A	T	5	2	7	0	0	7	0	0
2	44446240	.	T	C	5	6	11	0	0	11	0	0
2	44446246	.	G	A	5	7	12	0	0	12	0	0
2	44470110	.	A	G	7	0	7	0	6	13	0	0
2	44484882	.	T	C	8	8	16	0	1	17	0	0
2	44508273	.	A	G	13	8	21	0	0	21	0	0
2	44509873	.	T	C	7	19	26	0	1	27	0	0
2	44510073	.	T	C	16	15	31	0	1	32	0	0
2	44510263	.	T	A	4	7	11	0	1	12	0	0
2	44510273	.	T	G	5	6	11	0	0	11	0	0
2	44510506	.	A	G	2	0	2	0	12	14	0	0
2	44510569	.	T	C	4	10	14	0	0	14	0	0
2	44510596	.	A	G	7	5	12	0	0	12	0	0
2	44550903	.	G	A	0	3	3	0	2	5	0	0
2	44550950	.	C	T	4	3	7	0	0	7	0	0
2	44554362	.	A	T	3	4	7	0	0	7	0	0
2	44556982	.	G	A	0	8	8	0	7	15	0	0
2	44556983	.	G	A	6	8	14	0	1	15	0	0
2	44557141	.	C	T	7	10	17	0	1	18	0	0
2	44557187	.	T	C	7	5	12	0	0	12	0	0
2	44678904	.	C	G	2	1	3	0	0	3	0	0
2	44678913	.	A	G	2	2	4	0	0	4	0	0
2	44679856	.	G	A	0	2	2	0	3	5	0	0
2	44682684	.	C	T	3	2	5	0	0	5	0	0
2	44690398	.	T	C	2	9	11	0	0	11	0	0
2	44692527	.	T	C	5	7	12	0	0	12	0	0
2	44692529	.	C	T	5	7	12	0	0	12	0	0
2	44692570	.	T	A	5	4	9	0	0	9	0	0
2	44692601	.	A	G	5	0	5	0	3	8	0	0
2	44692638	.	C	G	4	4	8	0	0	8	0	0
2	44692641	.	A	G	4	0	4	0	5	9	0	0
2	44692691	.	C	T	3	2	5	0	0	5	0	0
2	44692696	.	T	C	5	3	8	0	0	8	0	0
2	44692746	.	C	T	4	3	7	0	0	7	0	0
2	44693038	.	C	A	2	2	4	0	1	5	0	0
2	44693049	.	G	T	2	1	3	0	2	5	0	0
2	44693093	.	A	G	5	2	7	0	0	7	0	0
2	44693149	.	A	G	3	4	7	0	0	7	0	0
2	44693241	.	T	G	3	3	6	0	1	7	0	0
2	44697590	.	T	C	24	11	35	0	1	36	0	0
2	44720175	.	A	G	13	16	29	0	0	29	0	0
2	44720201	.	G	A	13	13	26	0	0	26	0	0
2	44720423	.	G	A	14	16	30	0	0	30	0	0
2	44752545	.	A	G	1	6	7	0	0	7	0	0
2	44757781	.	G	A	2	4	6	0	0	6	0	0
2	44757790	.	C	T	2	4	6	0	0	6	0	0
2	44757826	.	A	G	2	3	5	0	0	5	0	0
2	44757967	.	G	A	1	3	4	0	1	5	0	0
2	44923858	.	T	C	1	2	3	0	1	4	0	0
2	44923878	.	T	C	2	2	4	0	0	4	0	0
2	44924647	.	T	C	6	3	9	0	1	10	0	0
2	44924662	.	G	A	0	2	2	0	8	10	0	0
2	44924711	.	G	T	4	2	6	0	0	6	0	0
2	44925124	.	C	G	2	2	4	0	0	4	0	0
2	44944789	.	A	T	27	34	61	0	2	63	0	0
2	44961558	.	A	G	4	3	7	0	0	7	0	0
2	44961955	.	C	A	1	2	3	0	0	3	0	0
2	44962870	.	T	G	2	3	5	0	0	5	0	0
2	44962973	.	A	T	5	2	7	0	0	7	0	0
2	44963010	.	G	A	4	3	7	0	0	7	0	0
2	44963011	.	A	G	4	2	6	0	1	7	0	0
2	44963053	.	G	A	1	2	3	0	1	4	0	0
2	44963192	.	A	G	3	3	6	0	0	6	0	0
2	44963670	.	G	T	1	3	4	0	0	4	0	0
2	44964514	.	C	T	1	2	3	0	0	3	0	0
2	44964516	.	T	A	1	2	3	0	0	3	0	0
2	44964688	.	C	G	2	2	4	0	3	7	0	0
2	44965006	.	A	T	3	2	5	0	0	5	0	0
2	44975918	.	T	C	2	3	5	0	0	5	0	0
2	44980341	.	C	T	3	2	5	0	0	5	0	0
2	44980359	.	C	T	2	5	7	0	0	7	0	0
2	44980562	.	A	G	1	5	6	1	0	7	0	0
2	44980625	.	T	A	2	2	4	1	0	5	0	0
2	44980997	.	G	T	5	4	9	0	1	10	0	0
2	44981043	.	C	T	3	6	9	0	0	9	0	0
2	44981142	.	A	G	5	6	11	0	1	12	0	0
2	45116988	.	C	G	1	12	13	0	11	24	0	0
2	45117063	.	A	G	8	10	18	0	4	22	0	0
2	45117076	.	T	C	6	13	19	0	0	19	0	0
2	45117280	.	C	A	18	9	27	1	2	30	0	0
2	45117354	.	G	C	17	25	42	0	1	43	0	0
2	45117440	.	T	A	13	16	29	0	2	31	0	0
2	45117712	.	T	A	14	13	27	0	0	27	0	0
2	45129977	.	G	A	13	16	29	0	0	29	0	0
2	45132677	.	A	G	9	13	22	0	1	23	0	0
2	45139669	.	A	G	5	2	7	0	2	9	0	0
2	45139729	.	T	G	5	3	8	2	1	11	0	0
2	45139894	.	C	T	7	11	18	0	1	19	0	0
2	45142971	.	G	A	4	9	13	0	0	13	0	0
2	45143036	.	T	G	6	9	15	0	3	18	0	0
2	45144030	.	G	A	6	6	12	0	0	12	0	0
2	45144163	.	G	A	3	5	8	0	1	9	0	0
2	45145817	.	A	T	4	7	11	0	0	11	0	0
2	45145969	.	G	C	5	8	13	0	2	15	0	0
2	45145973	.	C	T	7	8	15	0	0	15	0	0
2	45149649	.	G	A	3	2	5	0	0	5	0	0
2	45149730	.	T	G	3	2	5	0	1	6	0	0
2	45149751	.	C	T	4	2	6	0	0	6	0	0
2	45152302	.	T	C	1	5	6	0	2	8	0	0
2	45152323	.	C	A	4	7	11	0	0	11	0	0
2	45152461	.	A	G	3	3	6	0	1	7	0	0
2	45153108	.	T	C	1	0	1	0	5	6	0	0
2	45354994	.	T	C	1	2	3	0	0	3	0	0
2	45355036	.	A	G	1	2	3	0	1	4	0	0
2	45355171	.	C	A	1	2	3	0	0	3	0	0
2	45358974	.	G	A	7	4	11	0	0	11	0	0
2	45359045	.	T	G	5	0	5	0	5	10	0	0
2	45359159	.	C	A	1	4	5	0	0	5	0	0
2	45359394	.	A	G	2	5	7	0	1	8	0	0
2	45359504	.	T	G	7	3	10	0	0	10	0	0
2	45362087	.	G	A	6	7	13	0	1	14	0	0
2	45362117	.	G	A	6	5	11	0	2	13	0	0
2	45362129	.	A	T	9	3	12	0	2	14	0	0
2	45376148	.	T	C	8	7	15	0	2	17	0	0
2	45406944	.	A	G	2	0	2	0	6	8	0	0
2	45410956	.	A	C	2	3	5	0	0	5	0	0
2	45412340	.	T	C	4	3	7	0	0	7	0	0
2	45419436	.	T	C	9	3	12	0	0	12	0	0
2	45419583	.	T	G	4	2	6	0	1	7	0	0
2	45491595	.	A	C	2	3	5	0	0	5	0	0
2	45491596	.	C	T	2	3	5	0	0	5	0	0
2	45491633	.	T	G	2	2	4	0	0	4	0	0
2	45491663	.	C	T	2	3	5	0	0	5	0	0
2	45492300	.	C	T	2	4	6	0	1	7	0	0
2	45492371	.	G	A	7	6	13	0	0	13	0	0
2	45492536	.	T	G	4	2	6	0	0	6	0	0
2	45492575	.	G	A	6	3	9	0	0	9	0	0
2	45655555	.	G	C	4	14	18	0	2	20	0	0
2	45655644	.	A	G	17	15	32	0	2	34	0	0
2	45655787	.	G	C	24	6	30	0	0	30	0	0
2	45656177	.	A	T	21	16	37	0	2	39	0	0
2	45656198	.	C	T	21	16	37	0	1	38	0	0
2	45656234	.	T	C	18	21	39	0	2	41	0	0
2	45656260	.	C	T	2	15	17	0	18	35	0	0
2	45656447	.	G	A	18	19	37	1	2	40	0	0
2	45661511	.	C	A	0	5	5	0	11	16	0	0
2	45663532	.	C	T	9	4	13	0	1	14	0	0
2	45663794	.	G	C	4	9	13	0	0	13	0	0
2	45665592	.	A	G	2	2	4	0	0	4	0	0
2	45665615	.	T	G	6	2	8	0	0	8	0	0
2	45666033	.	A	G	1	4	5	0	1	6	0	0
2	45666055	.	C	T	1	4	5	0	0	5	0	0
2	46140470	.	T	C	0	2	2	0	2	4	0	0
2	46140479	.	T	C	1	3	4	0	1	5	0	0
2	46140512	.	G	A	1	3	4	0	1	5	0	0
2	46140539	.	G	A	2	3	5	0	0	5	0	0
2	46172238	.	A	G	1	0	1	0	3	4	0	0
2	46175367	.	G	T	0	3	3	0	1	4	0	0
2	46175484	.	C	T	2	2	4	0	1	5	0	0
2	46176822	.	T	C	5	5	10	0	0	10	0	0
2	46181029	.	T	C	3	7	10	0	0	10	0	0
2	46183897	.	G	A	8	7	15	0	0	15	0	0
2	46183985	.	A	T	4	10	14	0	0	14	0	0
2	46184024	.	T	A	6	5	11	0	0	11	0	0
2	46184057	.	C	A	9	7	16	0	0	16	0	0
2	46184193	.	C	T	7	7	14	0	0	14	0	0
2	46184555	.	A	G	13	11	24	0	0	24	0	0
2	46715639	.	G	A	0	3	3	0	1	4	0	0
2	47472068	.	T	A	1	3	4	0	0	4	0	0
2	47495077	.	T	C	2	5	7	0	0	7	0	0
2	47500251	.	C	T	3	3	6	0	0	6	0	0
2	47506185	.	C	T	5	2	7	0	0	7	0	0
2	47506187	.	G	A	5	2	7	0	0	7	0	0
2	47511341	.	T	C	14	9	23	0	0	23	0	0
2	47512820	.	G	A	12	14	26	0	0	26	0	0
2	47513002	.	G	T	16	11	27	0	2	29	0	0
2	47513712	.	C	A	15	13	28	0	1	29	0	0
2	47513871	.	C	A	11	17	28	0	1	29	0	0
2	47514001	.	A	G	16	17	33	0	1	34	0	0
2	47514582	.	T	G	11	7	18	0	0	18	0	0
2	47514613	.	T	A	13	12	25	0	1	26	0	0
2	47514619	.	A	T	11	13	24	0	2	26	0	0
2	47514697	.	A	G	21	15	36	0	0	36	0	0
2	47514878	.	T	G	22	12	34	0	1	35	0	0
2	47515019	.	T	C	17	20	37	0	0	37	0	0
2	47515073	.	T	C	18	11	29	0	0	29	0	0
2	47515111	.	G	A	12	12	24	0	1	25	0	0
2	47515223	.	T	A	12	12	24	0	0	24	0	0
2	47582559	.	C	G	2	2	4	0	0	4	0	0
2	47582891	.	A	G	19	10	29	0	0	29	0	0
2	47583029	.	C	A	24	24	48	0	1	49	0	0
2	47583377	.	G	A	6	23	29	0	28	57	0	0
2	47583701	.	C	T	22	27	49	0	4	53	0	0
2	47583788	.	T	A	33	31	64	0	1	65	0	0
2	47584064	.	G	A	1	27	28	0	34	62	0	0
2	47584092	.	G	A	35	29	64	0	8	72	0	0
2	47584547	.	T	A	25	25	50	0	10	60	0	0
2	47584612	.	G	A	21	28	49	0	2	51	0	0
2	47584799	.	A	T	39	33	72	0	1	73	0	0
2	47587330	.	G	T	4	2	6	0	0	6	0	0
2	47587387	.	C	A	8	5	13	0	2	15	0	0
2	47587423	.	A	T	7	2	9	0	1	10	0	0
2	47587472	.	T	C	2	0	2	0	2	4	0	0
2	47587652	.	C	T	4	7	11	0	0	11	0	0
2	47587703	.	A	G	3	2	5	0	2	7	0	0
2	47633835	.	T	A	8	2	10	0	0	10	0	0
2	47633841	.	C	T	8	2	10	0	0	10	0	0
2	47644488	.	T	G	28	17	45	0	0	46	1	0
2	47648076	.	A	G	24	24	48	0	4	52	0	0
2	47648091	.	T	G	19	26	45	0	1	46	0	0
2	47651598	.	A	G	10	19	29	0	0	29	0	0
2	47652403	.	A	G	16	17	33	0	4	37	0	0
2	47652406	.	A	G	15	20	35	0	1	36	0	0
2	47658641	.	T	G	8	9	17	0	0	17	0	0
2	47658653	.	G	A	6	7	13	0	3	16	0	0
2	47658752	.	A	G	5	9	14	0	2	16	0	0
2	47661273	.	A	C	9	0	9	0	8	17	0	0
2	47662955	.	A	G	10	4	14	0	0	14	0	0
2	47805071	.	G	C	0	3	3	0	1	4	0	0
2	47829126	.	C	T	2	2	4	0	0	4	0	0
2	47916467	.	A	T	4	3	7	0	0	7	0	0
2	47916599	.	G	A	1	2	3	0	0	3	0	0
2	47918257	.	T	A	2	3	5	1	0	6	0	0
2	47918584	.	C	T	4	2	6	0	0	6	0	0
2	47918632	.	T	G	2	2	4	0	0	4	0	0
2	47918643	.	C	G	3	2	5	0	0	5	0	0
2	47955412	.	A	G	7	3	10	0	1	11	0	0
2	47955727	.	T	G	2	7	9	0	0	9	0	0
2	47955737	.	T	G	3	6	9	0	0	9	0	0
2	48105232	.	G	T	2	2	4	0	0	4	0	0
2	48112887	.	A	T	2	5	7	0	0	7	0	0
2	48113040	.	G	A	4	4	8	0	0	8	0	0
2	48115732	.	T	A	6	2	8	0	2	10	0	0
2	48115990	.	C	T	6	5	11	0	0	11	0	0
2	48118470	.	T	C	5	1	6	0	3	9	0	0
2	48118485	.	G	A	1	8	9	0	6	15	0	0
2	48119134	.	G	A	4	4	8	0	1	9	0	0
2	48119209	.	G	A	5	6	11	0	0	11	0	0
2	48119530	.	T	A	3	3	6	1	0	7	0	0
2	48119631	.	A	C	4	9	13	0	1	14	0	0
2	48119744	.	A	G	11	15	26	0	0	26	0	0
2	48119821	.	T	A	9	22	31	0	0	31	0	0
2	48120190	.	A	T	17	5	22	0	0	23	1	0
2	48120462	.	T	A	11	8	19	0	0	19	0	0
2	48120516	.	T	C	16	12	28	0	2	30	0	0
2	48120689	.	G	A	19	10	29	0	1	30	0	0
2	48120694	.	C	G	18	10	28	0	1	29	0	0
2	48120743	.	T	C	9	7	16	0	0	16	0	0
2	48120744	.	G	A	9	7	16	0	0	16	0	0
2	48120805	.	T	A	8	6	14	0	0	14	0	0
2	48120825	.	A	C	3	4	7	0	2	9	0	0
2	48120864	.	C	A	4	4	8	0	2	10	0	0
2	48120971	.	T	C	6	5	11	0	0	11	0	0
2	48121039	.	T	C	2	4	6	0	0	6	0	0
2	48121157	.	C	A	0	3	3	0	1	4	0	0
2	48121164	.	A	T	1	3	4	0	0	4	0	0
2	48121197	.	C	T	1	4	5	0	3	8	0	0
2	48121312	.	G	A	9	4	13	0	1	14	0	0
2	48121351	.	G	C	7	4	11	0	0	11	0	0
2	48121352	.	T	C	6	4	10	0	1	11	0	0
2	48121428	.	T	A	9	7	16	0	0	16	0	0
2	48121713	.	G	T	6	5	11	0	0	11	0	0
2	48121743	.	A	G	7	3	10	0	2	12	0	0
2	48127614	.	G	A	4	3	7	0	0	7	0	0
2	48127810	.	A	G	2	4	6	0	0	6	0	0
2	48137650	.	T	G	1	2	3	0	0	3	0	0
2	48142617	.	C	T	0	2	2	0	3	5	0	0
2	48153898	.	A	G	1	2	3	0	0	3	0	0
2	48203544	.	A	G	23	10	33	0	1	34	0	0
2	48203554	.	C	T	25	9	34	0	3	37	0	0
2	48203622	.	G	A	20	12	32	0	1	33	0	0
2	48203920	.	C	A	0	14	14	0	13	27	0	0
2	48207319	.	C	T	4	17	21	0	14	35	0	0
2	48212114	.	C	A	12	10	22	0	1	23	0	0
2	48217207	.	T	C	8	8	16	0	1	17	0	0
2	48217229	.	T	A	9	6	15	0	1	16	0	0
2	48221479	.	C	T	0	9	9	0	10	19	0	0
2	48232643	.	T	A	5	4	9	0	0	9	0	0
2	48239854	.	T	C	3	2	5	0	1	6	0	0
2	48284721	.	G	A	25	13	38	0	1	39	0	0
2	48285153	.	C	G	16	14	30	0	4	34	0	0
2	48285241	.	T	G	11	6	17	0	5	22	0	0
2	48285265	.	A	C	12	8	20	0	2	22	0	0
2	48290805	.	A	T	32	23	55	0	2	57	0	0
2	48290820	.	C	T	26	26	52	0	1	53	0	0
2	48304467	.	G	A	18	12	30	0	0	30	0	0
2	48309874	.	T	A	11	13	24	0	2	26	0	0
2	48309876	.	A	T	11	14	25	0	1	26	0	0
2	48309970	.	C	A	11	29	40	0	2	42	0	0
2	48310207	.	C	T	0	9	9	0	12	21	0	0
2	48310258	.	A	T	7	11	18	0	2	20	0	0
2	48310266	.	T	C	5	0	5	0	12	17	0	0
2	48310330	.	C	G	14	6	20	0	1	22	1	0
2	48310342	.	A	G	18	6	24	0	2	26	0	0
2	48310374	.	G	A	12	8	20	0	0	20	0	0
2	48313598	.	A	G	18	17	35	0	0	35	0	0
2	48317363	.	G	T	16	9	25	0	4	29	0	0
2	48317418	.	C	G	11	8	19	0	1	20	0	0
2	48317444	.	G	T	8	6	14	0	0	14	0	0
2	48323317	.	C	T	6	10	16	0	4	21	1	0
2	48323341	.	T	C	8	13	21	0	2	23	0	0
2	48323470	.	A	T	18	11	29	0	2	31	0	0
2	48323562	.	A	T	17	15	32	0	3	35	0	0
2	48323572	.	A	G	16	11	27	0	6	33	0	0
2	48323695	.	A	G	18	11	29	0	2	31	0	0
2	48323863	.	A	G	13	12	25	0	0	25	0	0
2	48326354	.	G	A	7	5	12	0	0	12	0	0
2	48326408	.	C	T	0	9	9	0	2	11	0	0
2	48332566	.	A	G	9	6	15	0	0	15	0	0
2	48335187	.	G	A	5	6	11	0	0	11	0	0
2	48343367	.	G	A	3	2	5	0	0	5	0	0
2	48478608	.	A	G	4	3	7	0	0	7	0	0
2	48478720	.	A	T	2	3	5	0	0	5	0	0
2	48533068	.	C	T	1	7	8	1	0	9	0	0
2	48533070	.	G	C	1	7	8	1	0	9	0	0
2	48546121	.	T	A	8	9	17	0	0	17	0	0
2	48552301	.	A	G	6	3	9	0	1	10	0	0
2	48552447	.	G	C	1	0	1	0	7	8	0	0
2	48552564	.	G	T	0	4	4	0	2	6	0	0
2	48552681	.	A	T	4	2	6	0	0	6	0	0
2	48552687	.	A	T	4	2	6	0	0	6	0	0
2	49007765	.	A	G	16	7	23	0	6	29	0	0
2	49007781	.	A	T	10	13	23	0	3	26	0	0
2	49008339	.	A	T	7	7	14	0	0	14	0	0
2	49008382	.	T	G	3	5	8	0	1	9	0	0
2	49017754	.	C	T	9	5	14	0	0	14	0	0
2	49609086	.	T	C	10	6	16	1	0	17	0	0
2	50892529	.	A	G	7	1	8	0	9	17	0	0
2	50892537	.	A	G	2	10	12	0	0	12	0	0
2	50892671	.	A	G	7	5	12	0	1	13	0	0
2	50892686	.	A	G	10	1	11	0	6	17	0	0
2	52052697	.	A	G	3	0	3	0	9	12	0	0
2	52052790	.	T	C	10	8	18	0	1	19	0	0
2	52057394	.	A	G	6	0	6	0	17	23	0	0
2	52060070	.	T	G	6	4	10	0	2	12	0	0
2	52060365	.	C	T	7	3	10	0	0	10	0	0
2	52060390	.	T	C	6	5	11	0	0	11	0	0
2	52060409	.	A	G	6	6	12	0	0	12	0	0
2	52060450	.	G	A	3	7	10	1	1	12	0	0
2	52060492	.	A	T	8	7	15	2	1	18	0	0
2	52062918	.	G	A	0	12	12	0	10	22	0	0
2	52062989	.	T	A	7	5	12	1	1	14	0	0
2	52063101	.	T	A	4	6	10	0	0	10	0	0
2	52063128	.	T	C	9	2	11	0	1	12	0	0
2	52063207	.	T	C	4	6	10	0	0	10	0	0
2	52063208	.	C	T	2	6	8	0	2	10	0	0
2	52063250	.	C	G	4	12	16	0	1	17	0	0
2	52814146	.	C	T	8	10	18	0	0	18	0	0
2	52815260	.	G	A	8	9	17	0	1	18	0	0
2	52815292	.	C	T	5	6	11	0	0	11	0	0
2	52826659	.	A	G	2	3	5	0	0	5	0	0
2	52827298	.	A	G	7	3	10	0	1	11	0	0
2	53423146	.	C	T	2	2	4	0	0	4	0	0
2	53720058	.	G	C	0	2	2	0	3	5	0	0
2	53720098	.	A	G	7	0	7	0	5	12	0	0
2	53720122	.	C	G	6	3	9	0	0	9	0	0
2	53721966	.	G	C	7	2	9	0	0	9	0	0
2	53724856	.	G	A	2	2	4	0	1	5	0	0
2	53750668	.	T	C	9	7	16	0	1	17	0	0
2	53750707	.	C	T	7	6	13	0	0	13	0	0
2	53750719	.	C	T	6	7	13	0	0	13	0	0
2	54832219	.	A	G	1	3	4	0	0	4	0	0
2	54832224	.	A	G	3	2	5	0	0	5	0	0
2	54832405	.	A	G	2	2	4	0	0	4	0	0
2	55210962	.	C	T	3	3	6	0	0	6	0	0
2	55211004	.	G	A	0	5	5	0	2	7	0	0
2	55211034	.	A	G	1	0	1	0	6	7	0	0
2	55211049	.	C	G	2	0	2	0	4	6	0	0
2	55430016	.	C	T	1	2	3	0	0	3	0	0
2	55430024	.	T	C	2	3	5	0	1	6	0	0
2	55430091	.	T	C	6	9	15	0	1	16	0	0
2	55430128	.	C	T	5	8	13	0	1	14	0	0
2	55430136	.	A	G	4	9	13	0	1	14	0	0
2	55433494	.	C	A	5	8	13	2	1	16	0	0
2	55444789	.	A	G	5	0	5	0	6	11	0	0
2	55444825	.	C	G	11	6	17	0	1	19	1	0
2	55444831	.	A	G	13	9	22	0	0	22	0	0
2	55488992	.	G	A	1	4	5	0	8	13	0	0
2	55489067	.	G	T	1	6	7	0	16	23	0	0
2	55489237	.	T	G	6	7	13	0	0	13	0	0
2	55489383	.	T	A	12	15	27	0	0	27	0	0
2	55490016	.	C	G	9	5	14	0	1	15	0	0
2	55490062	.	C	T	13	9	22	0	1	24	1	0
2	55490232	.	T	C	18	13	31	0	2	33	0	0
2	55490313	.	C	T	16	8	24	1	5	30	0	0
2	55490348	.	G	A	15	12	27	0	1	28	0	0
2	55490434	.	A	G	13	0	13	0	10	23	0	0
2	55490521	.	T	C	18	13	31	0	2	33	0	0
2	55490609	.	A	G	19	6	25	0	1	26	0	0
2	55490618	.	A	G	22	5	27	0	1	28	0	0
2	55490934	.	G	T	16	26	42	0	0	42	0	0
2	55491272	.	C	T	18	11	29	0	1	30	0	0
2	55491471	.	C	T	25	15	40	0	1	41	0	0
2	55491666	.	G	A	23	12	35	0	0	35	0	0
2	55491717	.	G	A	17	20	37	0	1	38	0	0
2	55491754	.	C	A	17	22	39	0	3	42	0	0
2	55491884	.	T	C	14	28	42	0	2	44	0	0
2	55491893	.	T	C	13	28	41	0	1	42	0	0
2	55491945	.	A	T	13	16	29	0	1	30	0	0
2	55492064	.	T	C	17	14	31	0	4	35	0	0
2	55492104	.	T	C	14	13	27	0	0	27	0	0
2	55492108	.	A	G	15	0	15	0	14	29	0	0
2	55492285	.	T	C	2	5	7	0	0	7	0	0
2	55492286	.	C	T	2	5	7	0	0	7	0	0
2	55785458	.	T	C	1	0	1	0	7	8	0	0
2	55962539	.	A	T	2	2	4	0	0	4	0	0
2	55962572	.	T	A	3	3	6	0	0	6	0	0
2	55962912	.	A	G	1	2	3	0	0	3	0	0
2	55963207	.	A	C	2	3	5	0	1	6	0	0
2	55963805	.	A	T	2	2	4	0	0	4	0	0
2	55963834	.	C	T	5	1	6	0	2	8	0	0
2	55964935	.	A	T	3	5	8	0	0	8	0	0
2	55964971	.	A	C	2	5	7	0	1	8	0	0
2	55965163	.	A	T	10	7	17	0	0	17	0	0
2	55965256	.	C	T	8	5	13	0	1	14	0	0
2	55965273	.	T	C	8	5	13	0	2	15	0	0
2	55965328	.	C	T	9	11	20	1	0	21	0	0
2	55965727	.	A	C	3	3	6	0	0	6	0	0
2	55965898	.	A	G	4	0	4	0	6	10	0	0
2	55965900	.	G	A	0	4	4	0	6	10	0	0
2	55966038	.	A	T	2	3	5	0	1	6	0	0
2	55966612	.	G	C	3	3	6	0	0	6	0	0
2	55966616	.	G	A	3	3	6	0	0	6	0	0
2	55966716	.	G	T	8	8	16	0	0	16	0	0
2	55966822	.	T	G	2	3	5	0	0	5	0	0
2	55966912	.	A	T	4	5	9	0	0	9	0	0
2	55967065	.	T	A	1	5	6	0	0	6	0	0
2	55967188	.	T	C	8	7	15	0	0	15	0	0
2	55967233	.	C	T	7	5	12	0	0	12	0	0
2	55967471	.	A	T	9	12	21	0	0	21	0	0
2	55967638	.	T	A	16	12	28	0	2	30	0	0
2	55967667	.	C	T	13	16	29	0	3	32	0	0
2	55967758	.	T	C	9	13	22	0	1	23	0	0
2	55967882	.	C	T	4	2	6	1	0	7	0	0
2	55967908	.	C	A	1	7	8	1	2	11	0	0
2	55967963	.	G	C	3	7	10	0	2	12	0	0
2	55967987	.	T	G	4	2	6	0	1	7	0	0
2	55968123	.	C	A	10	6	16	0	0	16	0	0
2	55968147	.	T	C	13	8	21	0	0	21	0	0
2	55968204	.	A	G	11	9	20	0	1	21	0	0
2	55968240	.	C	T	13	15	28	0	1	29	0	0
2	55968294	.	G	T	11	9	20	0	2	22	0	0
2	55968383	.	A	C	19	13	32	0	0	32	0	0
2	55968411	.	T	G	19	1	20	0	15	35	0	0
2	55968472	.	A	G	15	0	15	1	8	24	0	0
2	55968617	.	T	A	5	3	8	0	0	8	0	0
2	55968859	.	A	G	6	6	12	0	1	13	0	0
2	55968896	.	C	T	1	3	4	0	0	4	0	0
2	55968932	.	A	C	2	2	4	0	0	4	0	0
2	55969229	.	A	G	5	3	8	0	0	8	0	0
2	55970244	.	A	G	1	2	3	0	0	3	0	0
2	55970466	.	C	A	5	2	7	0	0	7	0	0
2	55970499	.	T	A	9	3	12	0	1	13	0	0
2	55970504	.	C	G	8	4	12	0	1	13	0	0
2	55970662	.	C	T	26	6	32	0	2	34	0	0
2	55970684	.	C	T	19	12	31	0	1	32	0	0
2	56060728	.	G	T	3	2	5	0	0	5	0	0
2	56060733	.	A	C	2	2	4	0	1	5	0	0
2	56060792	.	G	A	4	2	6	0	0	6	0	0
2	56060821	.	G	A	2	3	5	0	1	6	0	0
2	56060838	.	G	A	1	3	4	0	1	5	0	0
2	56060865	.	A	T	1	3	4	0	0	4	0	0
2	56061520	.	C	T	1	2	3	6	0	9	0	0
2	56125231	.	G	A	15	6	21	0	0	21	0	0
2	56125687	.	T	C	15	22	37	0	7	44	0	0
2	56125744	.	G	C	19	1	20	0	25	45	0	0
2	56125821	.	G	T	20	10	30	0	3	33	0	0
2	56125837	.	C	T	1	11	12	0	21	33	0	0
2	56125859	.	A	T	15	13	28	0	2	30	0	0
2	56126011	.	T	A	3	3	6	0	1	7	0	0
2	56126588	.	G	T	13	9	22	0	5	27	0	0
2	56126643	.	T	A	13	4	17	0	1	18	0	0
2	56126778	.	T	A	6	3	9	0	2	11	0	0
2	56127612	.	G	A	7	6	13	0	1	14	0	0
2	56127693	.	T	G	9	11	20	0	0	20	0	0
2	56127720	.	C	G	7	12	19	0	0	19	0	0
2	56127848	.	T	A	5	11	16	0	1	17	0	0
2	56127881	.	T	A	4	6	10	0	0	10	0	0
2	56127884	.	A	T	5	6	11	0	0	11	0	0
2	56128025	.	A	G	11	15	26	0	0	26	0	0
2	56128029	.	A	T	9	16	25	0	1	26	0	0
2	56128224	.	A	G	6	8	14	0	1	15	0	0
2	56128259	.	A	G	6	4	10	0	0	10	0	0
2	56128455	.	G	A	9	9	18	0	2	20	0	0
2	56128527	.	A	G	5	8	13	0	0	13	0	0
2	56128582	.	A	G	7	9	16	0	1	17	0	0
2	56128677	.	C	T	6	6	12	0	0	12	0	0
2	56128687	.	A	T	5	5	10	0	3	13	0	0
2	56128768	.	A	T	1	3	4	0	0	4	0	0
2	56129001	.	A	G	8	9	17	0	1	18	0	0
2	56129175	.	G	C	13	11	24	0	0	24	0	0
2	56129285	.	G	T	9	9	18	0	0	18	0	0
2	56129299	.	G	A	8	8	16	0	0	16	0	0
2	56129332	.	G	A	4	7	11	0	0	11	0	0
2	56129462	.	C	G	1	3	4	0	0	4	0	0
2	56129613	.	T	C	6	4	10	0	1	11	0	0
2	56129793	.	A	G	5	2	7	0	1	8	0	0
2	56130019	.	A	C	6	7	13	0	1	14	0	0
2	56130212	.	T	G	8	8	16	0	1	17	0	0
2	56130259	.	A	G	4	9	13	0	0	13	0	0
2	56130260	.	C	G	4	9	13	0	0	13	0	0
2	56130296	.	C	A	7	10	17	0	1	18	0	0
2	56169512	.	G	A	0	2	2	0	2	4	0	0
2	56187784	.	C	T	1	3	4	0	0	4	0	0
2	56200571	.	C	A	3	4	7	0	0	7	0	0
2	56200652	.	G	A	0	2	2	0	2	4	0	0
2	56216760	.	C	T	5	11	16	0	0	16	0	0
2	56219233	.	G	A	10	6	16	0	1	17	0	0
2	56226369	.	C	G	8	6	14	0	1	15	0	0
2	56226372	.	A	G	6	0	6	0	9	15	0	0
2	56226444	.	T	C	10	7	17	0	0	17	0	0
2	56233498	.	C	G	10	7	17	0	0	17	0	0
2	56233508	.	G	T	10	10	20	0	1	21	0	0
2	56234749	.	T	C	13	13	26	0	2	28	0	0
2	56339104	.	T	G	16	14	30	0	0	30	0	0
2	56344833	.	A	G	35	30	65	0	1	66	0	0
2	56356796	.	T	C	11	4	15	0	0	15	0	0
2	56356806	.	T	C	12	4	16	0	0	16	0	0
2	56359363	.	G	A	7	5	12	0	2	14	0	0
2	56359434	.	A	G	7	5	12	0	0	12	0	0
2	56359641	.	G	A	3	3	6	0	0	6	0	0
2	56361406	.	G	A	6	5	11	0	0	11	0	0
2	56361412	.	A	G	5	5	10	0	1	11	0	0
2	56472472	.	C	T	22	10	32	0	1	33	0	0
2	56472553	.	C	T	5	11	16	23	1	40	0	0
2	56472613	.	T	A	19	16	35	3	0	38	0	0
2	56472625	.	A	C	19	16	35	3	0	38	0	0
2	56476113	.	G	A	4	23	27	0	27	54	0	0
2	56476573	.	G	T	2	29	31	0	21	52	0	0
2	56476732	.	C	T	26	20	46	0	2	48	0	0
2	56476762	.	A	G	11	22	33	0	3	36	0	0
2	56476812	.	A	G	9	20	29	0	0	29	0	0
2	56476909	.	A	C	11	7	18	0	2	20	0	0
2	56508570	.	A	C	15	8	23	1	1	25	0	0
2	56508695	.	T	C	29	14	43	0	3	46	0	0
2	56508878	.	A	G	19	13	32	0	1	33	0	0
2	56508880	.	C	T	19	12	31	0	1	32	0	0
2	56509097	.	T	A	15	7	22	0	1	23	0	0
2	56509098	.	A	T	15	6	21	0	2	23	0	0
2	56510817	.	T	C	11	0	11	0	12	23	0	0
2	56511064	.	G	T	7	6	13	0	1	14	0	0
2	56511463	.	A	C	3	2	5	0	0	5	0	0
2	56511575	.	C	T	7	6	13	0	0	13	0	0
2	56511845	.	G	T	4	6	10	0	0	10	0	0
2	56511877	.	C	T	5	4	9	0	1	10	0	0
2	56511917	.	C	T	2	10	12	0	0	12	0	0
2	56512009	.	T	C	3	0	3	0	2	5	0	0
2	56512032	.	C	T	5	4	9	0	1	10	0	0
2	56512054	.	T	C	4	0	4	0	7	11	0	0
2	56512162	.	C	T	2	11	13	0	0	13	0	0
2	56513510	.	A	C	5	7	12	0	1	13	0	0
2	56513660	.	C	T	1	5	6	0	3	9	0	0
2	56513742	.	C	A	10	7	17	1	2	20	0	0
2	56513795	.	G	T	12	12	24	1	0	25	0	0
2	56541388	.	T	C	9	0	9	0	9	18	0	0
2	56541417	.	G	A	8	10	18	0	0	18	0	0
2	56557264	.	G	T	8	3	11	0	2	13	0	0
2	56572249	.	G	A	5	3	8	0	3	11	0	0
2	56574486	.	C	T	0	2	2	0	2	4	0	0
2	56574525	.	C	T	0	5	5	0	1	6	0	0
2	56643465	.	G	A	17	36	53	0	5	58	0	0
2	56645018	.	G	A	23	35	58	0	0	58	0	0
2	56649806	.	A	G	18	26	44	0	2	46	0	0
2	57076598	.	C	T	1	2	3	0	0	3	0	0
2	57076607	.	G	T	1	2	3	0	0	3	0	0
2	57082309	.	G	A	2	3	5	0	0	5	0	0
2	57143433	.	G	A	1	2	3	0	0	3	0	0
2	57143436	.	C	T	1	2	3	0	0	3	0	0
2	57151194	.	G	A	27	24	51	0	3	54	0	0
2	57151242	.	G	T	24	24	48	0	1	49	0	0
2	57151326	.	A	G	23	0	23	0	16	39	0	0
2	57152858	.	T	G	17	20	37	0	2	39	0	0
2	57156050	.	C	A	18	22	40	0	5	45	0	0
2	57156092	.	C	A	17	20	37	0	3	40	0	0
2	57157952	.	C	T	25	21	46	0	3	49	0	0
2	57159557	.	G	A	27	20	47	0	4	51	0	0
2	57159668	.	G	A	36	16	52	0	6	58	0	0
2	57160272	.	C	T	20	27	47	0	3	50	0	0
2	57164902	.	A	G	30	23	53	0	3	56	0	0
2	57165001	.	C	T	24	36	60	0	1	61	0	0
2	57165544	.	C	T	25	37	62	0	6	68	0	0
2	57165565	.	C	T	35	33	68	0	1	69	0	0
2	57212864	.	G	A	4	7	11	0	1	12	0	0
2	57212966	.	T	C	3	0	3	0	6	9	0	0
2	57216903	.	G	A	5	3	8	1	0	9	0	0
2	57225181	.	C	T	0	3	3	0	2	5	0	0
2	57225187	.	A	G	2	3	5	0	0	5	0	0
2	57227432	.	G	T	1	2	3	0	0	3	0	0
2	57240340	.	A	T	7	2	9	0	1	10	0	0
2	57240345	.	C	T	7	3	10	0	0	10	0	0
2	57240570	.	A	T	3	5	8	0	0	8	0	0
2	57240649	.	C	T	0	6	6	0	5	11	0	0
2	57240708	.	C	T	4	7	11	0	0	11	0	0
2	57240736	.	G	A	8	7	15	0	1	16	0	0
2	57247280	.	C	A	1	8	9	0	6	15	0	0
2	57251501	.	A	T	8	7	15	0	1	16	0	0
2	57268868	.	G	A	16	19	35	0	1	36	0	0
2	57268877	.	T	A	17	17	34	0	1	35	0	0
2	57269031	.	C	G	27	23	50	0	4	54	0	0
2	57269136	.	T	A	25	31	56	0	2	58	0	0
2	57284550	.	A	T	30	27	57	0	1	58	0	0
2	57416993	.	G	A	1	7	8	0	0	8	0	0
2	57417092	.	A	C	3	6	9	0	0	9	0	0
2	57417223	.	G	A	4	6	10	0	0	10	0	0
2	57420477	.	G	A	8	6	14	0	0	14	0	0
2	57433321	.	T	C	3	4	7	0	0	7	0	0
2	57433333	.	A	G	3	5	8	0	0	8	0	0
2	57893346	.	G	A	7	4	11	8	0	19	0	0
2	58013448	.	G	A	12	3	15	1	0	16	0	0
2	58013484	.	C	T	2	2	4	1	1	6	0	0
2	58412124	.	G	A	3	16	19	0	23	42	0	0
2	58516445	.	C	A	15	15	30	1	2	33	0	0
2	58523710	.	C	A	0	4	4	1	6	11	0	0
2	58541939	.	G	A	17	14	31	0	0	31	0	0
2	58541981	.	C	G	12	16	28	0	0	28	0	0
2	58546893	.	G	A	11	8	19	0	1	20	0	0
2	58560081	.	G	C	5	5	10	0	2	12	0	0
2	58581582	.	G	C	1	3	4	0	1	5	0	0
2	58639153	.	C	T	0	3	3	0	4	7	0	0
2	58742652	.	G	A	2	11	13	0	10	23	0	0
2	58778264	.	G	A	6	8	14	0	2	16	0	0
2	58785286	.	G	A	13	7	20	0	1	21	0	0
2	58789112	.	G	A	2	5	7	0	0	7	0	0
2	58793396	.	C	T	0	8	8	0	4	12	0	0
2	58793438	.	A	G	4	8	12	0	0	12	0	0
2	58793652	.	A	G	4	3	7	0	0	7	0	0
2	58793667	.	G	A	4	3	7	0	0	7	0	0
2	58845161	.	G	T	2	11	13	0	6	19	0	0
2	58848646	.	T	G	44	0	44	0	18	63	1	0
2	58848767	.	C	T	26	21	47	0	1	48	0	0
2	58868190	.	G	A	7	7	14	0	2	16	0	0
2	58868439	.	T	C	10	1	11	0	20	31	0	0
2	58868508	.	A	C	12	1	13	0	10	23	0	0
2	58868679	.	G	A	10	7	17	0	1	18	0	0
2	58869037	.	C	G	4	3	7	0	0	7	0	0
2	58869166	.	G	A	8	6	14	0	1	15	0	0
2	58869268	.	A	G	4	7	11	0	0	11	0	0
2	58869319	.	G	A	3	10	13	0	0	13	0	0
2	58878612	.	C	T	11	8	19	0	1	20	0	0
2	58887817	.	C	T	0	8	8	1	10	19	0	0
2	58888870	.	A	G	2	3	5	0	2	7	0	0
2	58892142	.	T	C	13	0	13	1	6	20	0	0
2	58898167	.	C	T	1	5	6	0	4	10	0	0
2	58898910	.	A	G	5	3	8	0	1	9	0	0
2	58917504	.	A	T	5	7	12	1	0	13	0	0
2	58919954	.	G	A	5	5	10	0	0	10	0	0
2	59023901	.	T	C	6	5	11	0	1	12	0	0
2	59045912	.	A	G	7	0	7	0	5	12	0	0
2	59054254	.	A	G	18	19	37	0	3	40	0	0
2	59056203	.	C	T	20	20	40	1	0	41	0	0
2	59056212	.	G	A	21	16	37	1	2	40	0	0
2	59057670	.	C	T	22	16	38	0	3	41	0	0
2	59063227	.	T	C	13	13	26	1	3	30	0	0
2	59136490	.	C	T	1	3	4	1	0	5	0	0
2	59136518	.	T	C	1	3	4	1	0	5	0	0
2	59136859	.	T	C	2	4	6	0	0	6	0	0
2	59137050	.	T	A	7	7	14	3	1	18	0	0
2	59137182	.	G	T	4	12	16	0	0	16	0	0
2	59137184	.	G	T	3	11	14	0	2	16	0	0
2	59143183	.	A	G	2	9	11	0	1	12	0	0
2	59556935	.	G	T	1	2	3	0	2	5	0	0
2	59565521	.	T	G	1	0	1	0	3	4	0	0
20	22311	.	G	A	1	2	3	0	0	3	0	0
20	66886	.	C	A	2	2	4	0	0	4	0	0
20	66919	.	C	T	4	2	6	0	0	6	0	0
20	67321	.	C	T	1	2	3	0	0	3	0	0
20	67388	.	C	A	1	2	3	0	0	3	0	0
20	67755	.	C	T	7	4	11	0	0	11	0	0
20	67867	.	T	G	1	4	5	0	0	5	0	0
20	75079	.	C	A	7	9	16	0	2	18	0	0
20	75121	.	C	T	8	9	17	0	1	18	0	0
20	75148	.	T	C	5	6	11	0	0	11	0	0
20	75266	.	G	A	0	7	7	0	5	12	0	0
20	75330	.	T	A	3	8	11	0	0	11	0	0
20	75374	.	A	G	10	4	14	0	0	14	0	0
20	75376	.	G	T	1	4	5	0	10	15	0	0
20	75889	.	C	T	10	10	20	0	1	21	0	0
20	76193	.	G	A	0	11	11	0	6	17	0	0
20	76209	.	A	G	13	8	21	0	0	21	0	0
20	87286	.	T	C	1	3	4	0	0	4	0	0
20	87796	.	A	G	1	3	4	0	1	5	0	0
20	88023	.	G	A	2	3	5	0	0	5	0	0
20	89176	.	A	G	6	8	14	0	3	17	0	0
20	89188	.	G	T	1	8	9	0	11	20	0	0
20	89567	.	G	A	8	16	24	0	2	26	0	0
20	89607	.	G	T	4	8	12	0	10	22	0	0
20	89625	.	T	A	10	10	20	0	1	21	0	0
20	89720	.	G	A	7	16	23	0	0	23	0	0
20	90003	.	A	T	16	9	25	0	1	26	0	0
20	90167	.	C	T	15	15	30	0	0	30	0	0
20	90242	.	T	C	8	18	26	0	0	26	0	0
20	90246	.	T	C	9	16	25	0	2	27	0	0
20	114147	.	G	A	6	8	14	0	2	16	0	0
20	114708	.	A	G	33	20	53	0	4	57	0	0
20	114776	.	A	G	35	16	51	0	1	52	0	0
20	116164	.	A	T	24	20	44	0	0	44	0	0
20	122227	.	A	T	5	2	7	0	0	7	0	0
20	122244	.	C	G	1	4	5	0	1	6	0	0
20	122702	.	C	T	0	7	7	0	5	12	0	0
20	151548	.	C	T	1	9	10	2	9	21	0	0
20	151846	.	C	T	19	10	29	0	2	31	0	0
20	152496	.	G	C	8	11	19	0	0	19	0	0
20	153992	.	C	T	2	3	5	0	6	11	0	0
20	160089	.	C	T	0	2	2	0	2	4	0	0
20	167406	.	G	A	1	2	3	0	0	3	0	0
20	186752	.	G	A	17	16	33	0	0	33	0	0
20	188449	.	A	G	19	6	25	0	0	25	0	0
20	188638	.	T	C	8	10	18	0	0	18	0	0
20	196767	.	G	A	13	5	18	0	1	19	0	0
20	196773	.	T	A	15	4	19	0	0	19	0	0
20	196838	.	G	A	11	10	21	0	1	22	0	0
20	197274	.	T	C	8	11	19	0	2	21	0	0
20	197560	.	C	G	11	14	25	0	1	26	0	0
20	197842	.	T	C	20	8	28	0	1	29	0	0
20	198040	.	G	T	13	6	19	0	2	21	0	0
20	198049	.	C	T	15	9	24	0	1	25	0	0
20	198112	.	G	T	13	17	30	0	1	31	0	0
20	198127	.	A	T	14	14	28	0	2	30	0	0
20	198352	.	G	A	14	10	24	0	3	27	0	0
20	199168	.	C	T	1	17	18	0	7	25	0	0
20	199504	.	C	T	2	10	12	0	1	13	0	0
20	199956	.	G	A	7	2	9	0	0	9	0	0
20	199962	.	T	C	1	3	4	0	1	5	0	0
20	200302	.	C	T	4	2	6	0	0	6	0	0
20	200544	.	C	T	0	7	7	0	3	10	0	0
20	200716	.	A	G	1	9	10	0	0	10	0	0
20	200770	.	T	C	1	0	1	0	8	9	0	0
20	200851	.	G	A	6	3	9	0	0	9	0	0
20	201718	.	G	A	2	7	9	0	0	9	0	0
20	201957	.	C	G	0	3	3	0	1	4	0	0
20	202384	.	G	A	2	2	4	0	1	5	0	0
20	202389	.	A	G	2	2	4	0	1	5	0	0
20	202480	.	T	C	2	2	4	0	0	4	0	0
20	254130	.	G	A	3	2	5	0	2	7	0	0
20	254601	.	C	T	5	2	7	0	0	7	0	0
20	255431	.	C	T	4	6	10	0	0	10	0	0
20	255433	.	C	G	4	6	10	0	0	10	0	0
20	255859	.	G	A	0	7	7	0	4	11	0	0
20	258687	.	G	A	2	4	6	1	1	8	0	0
20	259534	.	C	T	6	7	13	0	1	14	0	0
20	259602	.	T	C	6	5	11	1	0	12	0	0
20	259625	.	T	C	4	11	15	0	0	15	0	0
20	259763	.	C	T	3	11	14	0	1	15	0	0
20	259766	.	C	A	3	11	14	0	1	15	0	0
20	259847	.	C	T	5	4	9	0	0	9	0	0
20	329072	.	A	C	3	3	6	0	0	6	0	0
20	384585	.	G	T	0	2	2	0	2	4	0	0
20	405867	.	G	A	2	5	7	0	0	7	0	0
20	405925	.	A	C	6	4	10	0	0	10	0	0
20	405928	.	A	G	5	0	5	0	7	12	0	0
20	406264	.	T	A	2	2	4	0	1	5	0	0
20	409377	.	C	A	3	3	6	0	1	7	0	0
20	409524	.	C	T	2	3	5	0	0	5	0	0
20	409629	.	T	C	5	4	9	0	0	9	0	0
20	410832	.	A	T	11	12	23	0	0	23	0	0
20	410981	.	A	T	9	11	20	0	2	22	0	0
20	411063	.	T	A	3	7	10	0	1	11	0	0
20	423977	.	G	C	9	9	18	0	2	20	0	0
20	426390	.	T	C	4	5	9	0	0	9	0	0
20	426434	.	T	A	4	6	10	0	0	10	0	0
20	429984	.	G	A	3	5	8	0	0	8	0	0
20	430080	.	A	G	1	2	3	0	0	3	0	0
20	430703	.	A	C	4	6	10	0	0	10	0	0
20	431886	.	C	T	0	2	2	0	3	5	0	0
20	436661	.	T	C	3	2	5	0	0	5	0	0
20	522541	.	G	A	5	2	7	0	0	7	0	0
20	522778	.	C	T	2	2	4	0	1	5	0	0
20	522811	.	T	A	2	2	4	0	1	5	0	0
20	528561	.	C	T	15	5	20	0	1	21	0	0
20	530335	.	C	T	5	6	11	0	0	11	0	0
20	530405	.	G	A	0	3	3	0	12	15	0	0
20	530408	.	C	T	12	4	16	0	0	16	0	0
20	530443	.	C	T	8	7	15	0	0	15	0	0
20	530445	.	T	G	8	7	15	0	0	15	0	0
20	530536	.	C	T	3	7	10	0	1	11	0	0
20	530624	.	G	T	5	5	10	0	0	10	0	0
20	561037	.	C	T	1	2	3	0	0	3	0	0
20	603599	.	T	C	1	3	4	0	0	4	0	0
20	603647	.	T	C	1	4	5	0	0	5	0	0
20	605171	.	A	T	1	2	3	0	0	3	0	0
20	605264	.	C	T	2	3	5	0	0	5	0	0
20	605291	.	C	T	3	2	5	0	0	5	0	0
20	605471	.	G	A	2	4	6	0	0	6	0	0
20	700683	.	C	T	3	5	8	0	1	9	0	0
20	700686	.	A	T	5	5	10	0	0	10	0	0
20	700899	.	C	A	9	8	17	0	1	18	0	0
20	700995	.	C	T	3	7	10	0	1	11	0	0
20	707767	.	C	T	6	7	13	1	0	14	0	0
20	708026	.	G	A	9	7	16	0	1	17	0	0
20	752624	.	G	A	0	2	2	0	1	3	0	0
20	755725	.	G	A	5	2	7	0	1	8	0	0
20	757522	.	G	A	3	2	5	0	0	5	0	0
20	757525	.	C	A	2	3	5	0	0	5	0	0
20	761004	.	C	T	11	8	19	0	1	21	1	0
20	761006	.	G	C	9	12	21	0	1	22	0	0
20	764346	.	A	G	11	8	19	0	2	21	0	0
20	764355	.	G	A	8	9	17	0	1	18	0	0
20	764388	.	A	G	5	7	12	0	2	14	0	0
20	764436	.	T	C	7	10	17	0	1	18	0	0
20	764807	.	G	A	5	10	15	0	1	16	0	0
20	771986	.	C	G	11	7	18	0	0	18	0	0
20	772577	.	C	A	6	9	15	0	4	19	0	0
20	772700	.	C	T	11	8	19	0	1	20	0	0
20	775412	.	G	A	0	11	11	0	8	19	0	0
20	775487	.	C	T	8	9	17	0	1	18	0	0
20	775538	.	G	A	2	19	21	0	11	32	0	0
20	775562	.	C	T	11	20	31	0	2	33	0	0
20	775583	.	T	A	15	17	32	0	4	36	0	0
20	776171	.	C	T	21	17	38	0	4	42	0	0
20	776261	.	A	T	21	20	41	0	5	46	0	0
20	776630	.	G	T	13	10	23	3	5	31	0	0
20	776826	.	G	A	8	11	19	0	0	19	0	0
20	776961	.	G	T	17	3	20	0	2	22	0	0
20	844590	.	G	A	1	3	4	0	0	4	0	0
20	844592	.	C	G	1	3	4	0	0	4	0	0
20	845654	.	T	C	5	3	8	0	0	8	0	0
20	845679	.	G	A	0	3	3	0	5	8	0	0
20	847735	.	T	G	5	5	10	0	1	11	0	0
20	847758	.	T	A	4	5	9	0	0	9	0	0
20	847779	.	G	A	6	6	12	0	0	12	0	0
20	847820	.	G	A	0	12	12	0	3	15	0	0
20	847854	.	G	A	3	9	12	0	1	13	0	0
20	847887	.	T	A	6	7	13	0	0	13	0	0
20	851699	.	G	A	6	4	10	0	0	10	0	0
20	851746	.	G	A	4	6	10	0	0	10	0	0
20	851843	.	T	C	10	8	18	0	0	18	0	0
20	851876	.	C	T	9	15	24	0	1	25	0	0
20	852184	.	A	G	13	10	23	0	1	24	0	0
20	856170	.	G	A	8	19	27	0	4	31	0	0
20	856185	.	G	A	11	21	32	0	3	35	0	0
20	875008	.	C	G	7	6	13	0	0	13	0	0
20	880430	.	G	A	6	2	8	0	0	8	0	0
20	880447	.	A	G	7	3	10	0	0	10	0	0
20	880747	.	A	T	2	2	4	0	2	6	0	0
20	883163	.	C	T	1	9	10	0	3	13	0	0
20	888058	.	T	C	3	4	7	0	1	8	0	0
20	892055	.	C	T	4	4	8	0	0	8	0	0
20	902671	.	G	A	3	5	8	0	0	8	0	0
20	902712	.	A	T	2	6	8	0	0	8	0	0
20	908195	.	A	G	1	3	4	0	0	4	0	0
20	908294	.	A	G	4	7	11	0	0	11	0	0
20	944278	.	T	C	2	0	2	0	4	6	0	0
20	946681	.	G	A	10	16	26	0	0	26	0	0
20	1079035	.	G	A	6	3	9	0	1	10	0	0
20	1079084	.	G	C	2	3	5	0	1	6	0	0
20	1119975	.	C	G	2	2	4	0	0	4	0	0
20	1125135	.	G	A	1	7	8	0	5	13	0	0
20	1132865	.	T	C	1	0	1	0	2	3	0	0
20	1177879	.	A	T	7	4	11	0	0	11	0	0
20	1178040	.	T	A	4	6	10	0	0	10	0	0
20	1178041	.	T	C	4	5	9	0	1	10	0	0
20	1178725	.	A	G	4	2	6	0	0	6	0	0
20	1178759	.	G	C	4	4	8	0	0	8	0	0
20	1178955	.	T	A	0	7	7	0	2	9	0	0
20	1198485	.	C	T	3	7	10	0	0	10	0	0
20	1198558	.	A	T	5	10	15	0	1	16	0	0
20	1198819	.	T	A	12	7	19	3	1	23	0	0
20	1201917	.	A	T	3	5	8	0	1	9	0	0
20	1202099	.	T	C	7	4	11	0	0	11	0	0
20	1202107	.	C	T	7	4	11	0	0	11	0	0
20	1202134	.	A	T	6	2	8	0	0	8	0	0
20	1205980	.	G	A	1	5	6	0	0	6	0	0
20	1239504	.	T	C	1	3	4	0	0	4	0	0
20	1239507	.	C	T	1	3	4	0	0	4	0	0
20	1240552	.	A	T	4	4	8	0	0	8	0	0
20	1240684	.	G	A	2	8	10	0	1	11	0	0
20	1241409	.	A	T	7	5	12	0	2	14	0	0
20	1241467	.	G	C	0	10	10	0	0	10	0	0
20	1241596	.	T	G	3	6	9	0	0	9	0	0
20	1241960	.	A	G	1	3	4	0	0	4	0	0
20	1242029	.	A	T	1	2	3	0	0	3	0	0
20	1242042	.	G	A	2	2	4	0	0	4	0	0
20	1242269	.	C	T	0	2	2	0	1	3	0	0
20	1243358	.	T	G	2	3	5	0	0	5	0	0
20	1243367	.	A	G	2	2	4	0	0	4	0	0
20	1244066	.	G	A	1	2	3	0	0	3	0	0
20	1244166	.	A	G	3	5	8	0	0	8	0	0
20	1246641	.	C	A	3	3	6	0	1	7	0	0
20	1246870	.	C	T	2	3	5	0	0	5	0	0
20	1257193	.	G	A	2	2	4	0	0	4	0	0
20	1278796	.	G	A	2	10	12	0	0	12	0	0
20	1279033	.	G	A	6	5	11	0	0	11	0	0
20	1294012	.	T	G	13	8	21	0	0	21	0	0
20	1294062	.	C	G	12	11	23	0	1	24	0	0
20	1294626	.	A	T	6	3	9	0	0	9	0	0
20	1294735	.	T	C	2	4	6	1	4	11	0	0
20	1294863	.	T	G	12	6	18	0	2	20	0	0
20	1294903	.	C	G	10	9	19	0	2	22	1	0
20	1294970	.	A	G	19	10	29	3	1	33	0	0
20	1295274	.	T	C	1	3	4	1	0	5	0	0
20	1295312	.	T	C	8	5	13	1	1	15	0	0
20	1295840	.	G	A	16	13	29	0	1	30	0	0
20	1296022	.	G	C	12	11	23	1	5	30	1	0
20	1296114	.	G	A	17	14	31	0	1	32	0	0
20	1296139	.	A	G	14	12	26	0	4	30	0	0
20	1314478	.	A	G	3	3	6	0	0	6	0	0
20	1316764	.	A	G	2	3	5	0	0	5	0	0
20	1324404	.	G	A	7	4	11	0	0	11	0	0
20	1324976	.	C	A	7	3	10	0	0	10	0	0
20	1327545	.	A	T	8	7	15	0	2	17	0	0
20	1327776	.	C	A	2	2	4	0	0	4	0	0
20	1338988	.	T	G	5	0	5	0	4	9	0	0
20	1339084	.	G	A	3	3	6	0	0	6	0	0
20	1339657	.	T	C	4	6	10	0	0	10	0	0
20	1339924	.	G	A	3	3	6	0	0	6	0	0
20	1340015	.	G	A	0	6	6	0	3	9	0	0
20	1349357	.	G	A	0	7	7	0	4	11	0	0
20	1349739	.	A	G	3	0	3	0	5	8	0	0
20	1349947	.	G	A	0	3	3	0	6	9	0	0
20	1350101	.	G	A	0	5	5	0	5	10	0	0
20	1350123	.	A	G	5	2	7	0	0	7	0	0
20	1392459	.	G	A	2	2	4	0	0	4	0	0
20	1441815	.	A	C	17	20	37	0	4	43	2	0
20	1441825	.	T	C	20	20	40	0	2	42	0	0
20	1442358	.	G	T	11	11	22	0	0	22	0	0
20	1442468	.	G	A	11	11	22	0	0	22	0	0
20	1442515	.	A	T	16	8	24	0	0	24	0	0
20	1442522	.	C	A	8	11	19	0	0	19	0	0
20	1442582	.	G	T	11	11	22	0	0	22	0	0
20	1442624	.	C	T	19	18	37	0	0	37	0	0
20	1454065	.	T	C	12	13	25	1	2	28	0	0
20	1455104	.	G	A	13	5	18	0	2	20	0	0
20	1460979	.	C	A	9	4	13	0	1	14	0	0
20	1487612	.	T	C	5	4	9	0	0	9	0	0
20	1518414	.	G	A	7	2	9	0	0	9	0	0
20	1519699	.	A	G	2	3	5	0	0	5	0	0
20	2975610	.	A	G	5	2	7	0	0	7	0	0
20	2975614	.	A	G	0	4	4	0	1	5	0	0
20	2976114	.	A	G	14	4	18	2	1	21	0	0
20	2976218	.	A	G	14	14	28	6	0	34	0	0
20	2976909	.	C	A	21	5	26	0	4	30	0	0
20	2977257	.	C	T	24	19	43	1	2	46	0	0
20	2977417	.	C	A	14	4	18	3	2	23	0	0
20	2977418	.	C	A	14	4	18	3	2	23	0	0
20	2977645	.	A	G	17	17	34	2	1	37	0	0
20	2982943	.	T	C	2	2	4	2	1	7	0	0
20	3916456	.	T	A	6	2	8	0	1	9	0	0
20	3916464	.	C	T	6	5	11	0	0	11	0	0
20	3916621	.	T	G	6	2	8	0	0	8	0	0
20	3920746	.	T	G	2	3	5	0	1	6	0	0
20	3920873	.	T	A	6	9	15	0	1	16	0	0
20	3920875	.	G	A	6	10	16	0	0	16	0	0
20	3920977	.	G	A	1	4	5	0	9	14	0	0
20	3921127	.	A	T	6	5	11	0	0	11	0	0
20	3921184	.	G	A	1	6	7	0	1	8	0	0
20	3921202	.	T	C	4	8	12	0	0	12	0	0
20	3923735	.	C	G	6	4	10	0	1	11	0	0
20	3923794	.	A	T	1	8	9	0	1	10	0	0
20	3924098	.	A	T	7	11	18	0	1	19	0	0
20	3924349	.	G	A	7	4	11	0	0	11	0	0
20	3924430	.	G	A	0	5	5	0	8	13	0	0
20	3924528	.	C	A	5	11	16	0	1	17	0	0
20	3924824	.	A	C	5	2	7	0	0	7	0	0
20	3924884	.	G	T	5	2	7	0	0	7	0	0
20	3925146	.	A	T	9	6	15	0	0	15	0	0
20	3925260	.	T	G	5	0	5	0	2	7	0	0
20	3925261	.	A	G	5	2	7	0	0	7	0	0
20	3925537	.	T	C	9	11	20	2	1	23	0	0
20	3925544	.	T	A	13	9	22	2	1	25	0	0
20	3925842	.	C	A	11	2	13	1	1	15	0	0
20	3925889	.	C	T	12	6	18	2	0	20	0	0
20	3925907	.	T	A	3	9	12	2	0	14	0	0
20	3926020	.	C	T	12	4	16	1	1	18	0	0
20	3926337	.	C	T	3	4	7	5	1	13	0	0
20	3926655	.	T	C	33	5	38	1	1	40	0	0
20	3926679	.	G	T	24	5	29	1	1	31	0	0
20	3926721	.	T	C	20	9	29	0	3	32	0	0
20	3926736	.	T	A	20	9	29	0	2	31	0	0
20	3926907	.	T	G	21	16	37	0	3	40	0	0
20	3926928	.	T	A	25	16	41	0	3	44	0	0
20	3926951	.	A	G	29	17	46	0	1	47	0	0
20	3927267	.	C	A	24	17	41	0	3	44	0	0
20	3927326	.	A	G	18	22	40	0	3	43	0	0
20	3927446	.	C	G	9	20	29	0	0	29	0	0
20	3947058	.	C	A	1	3	4	0	0	4	0	0
20	3947100	.	C	T	4	5	9	0	0	9	0	0
20	3947116	.	A	G	0	7	7	0	0	7	0	0
20	3953593	.	T	C	3	5	8	0	1	9	0	0
20	3954813	.	G	C	3	4	7	0	0	7	0	0
20	3954846	.	A	T	6	5	11	0	0	11	0	0
20	3954870	.	C	T	0	4	4	0	9	13	0	0
20	3971246	.	G	C	1	4	5	0	0	5	0	0
20	3991392	.	G	A	1	2	3	0	0	3	0	0
20	3994351	.	T	G	2	2	4	0	1	5	0	0
20	4009491	.	C	T	1	3	4	0	0	4	0	0
20	4010256	.	T	C	3	3	6	0	0	6	0	0
20	4030825	.	G	A	1	2	3	0	0	3	0	0
20	4035837	.	G	A	9	7	16	0	0	16	0	0
20	4035858	.	G	C	9	5	14	0	0	14	0	0
20	4036272	.	G	T	5	2	7	0	0	7	0	0
20	4036462	.	A	G	3	2	5	0	2	7	0	0
20	4036559	.	T	G	3	5	8	0	1	9	0	0
20	4036587	.	T	C	5	5	10	0	0	10	0	0
20	4036720	.	T	C	3	5	8	0	0	8	0	0
20	4036795	.	T	C	4	5	9	0	1	10	0	0
20	4037016	.	T	C	3	3	6	0	0	6	0	0
20	4037349	.	T	C	1	2	3	0	0	3	0	0
20	4037409	.	T	A	1	3	4	0	1	5	0	0
20	4037461	.	G	T	2	2	4	0	0	4	0	0
20	4037500	.	C	T	3	2	5	0	0	5	0	0
20	4037823	.	G	C	2	0	2	0	2	4	0	0
20	4037824	.	T	G	2	2	4	0	0	4	0	0
20	4037942	.	C	T	2	3	5	0	0	5	0	0
20	4051810	.	A	C	0	4	4	0	0	4	0	0
20	4051818	.	C	T	1	4	5	0	0	5	0	0
20	4053012	.	G	A	0	4	4	0	5	9	0	0
20	4157066	.	A	C	3	3	6	0	0	6	0	0
20	4176863	.	G	A	0	2	2	0	1	3	0	0
20	4185382	.	G	A	0	2	2	0	1	3	0	0
20	4887996	.	G	T	10	5	15	0	0	15	0	0
20	4888004	.	A	G	9	4	13	0	0	13	0	0
20	4888037	.	T	C	8	5	13	0	1	14	0	0
20	4896120	.	G	T	1	8	9	0	0	9	0	0
20	4896201	.	G	A	2	13	15	0	1	16	0	0
20	4896240	.	A	C	2	10	12	0	4	16	0	0
20	4896297	.	T	G	3	4	7	0	1	8	0	0
20	4896300	.	T	A	2	2	4	0	3	7	0	0
20	4898563	.	A	T	9	22	31	0	1	32	0	0
20	4898683	.	C	T	25	15	40	1	2	43	0	0
20	4898776	.	C	T	23	16	39	0	3	42	0	0
20	4898784	.	T	C	21	14	35	0	4	39	0	0
20	4899342	.	T	G	14	12	26	0	2	28	0	0
20	4899935	.	A	T	10	7	17	0	2	19	0	0
20	4900600	.	G	A	5	6	11	0	0	11	0	0
20	4900609	.	T	C	4	0	4	0	7	11	0	0
20	4900697	.	T	C	10	9	19	0	0	19	0	0
20	4900855	.	C	T	5	3	8	0	1	9	0	0
20	4903334	.	G	C	6	7	13	0	0	13	0	0
20	4903456	.	A	G	5	5	10	0	0	10	0	0
20	4910953	.	G	A	4	2	6	0	0	6	0	0
20	4957041	.	T	A	1	3	4	0	0	4	0	0
20	5065736	.	T	G	3	2	5	0	0	5	0	0
20	5069389	.	G	A	6	5	11	0	0	11	0	0
20	5069565	.	G	A	5	4	9	0	0	9	0	0
20	5069613	.	G	A	1	2	3	0	0	3	0	0
20	5089011	.	C	T	5	3	8	0	0	8	0	0
20	5089150	.	C	A	2	5	7	0	0	7	0	0
20	5090938	.	G	A	1	2	3	0	6	9	0	0
20	5093872	.	A	T	5	6	11	0	0	11	0	0
20	5094205	.	A	C	3	2	5	0	0	5	0	0
20	5094207	.	G	A	2	3	5	0	2	7	0	0
20	6666528	.	A	C	3	2	5	0	0	5	0	0
20	6791151	.	G	C	4	4	8	0	1	9	0	0
20	6791662	.	A	G	2	0	2	0	3	5	0	0
20	6802441	.	A	C	1	4	5	0	0	5	0	0
20	6803170	.	G	T	6	3	9	0	0	9	0	0
20	6803213	.	T	G	6	4	10	0	0	10	0	0
20	6809612	.	C	T	4	10	14	0	0	14	0	0
20	6810046	.	T	C	3	4	7	0	0	7	0	0
20	6894902	.	A	G	2	3	5	0	0	5	0	0
20	6895083	.	G	T	1	4	5	0	0	5	0	0
20	6898118	.	A	G	2	3	5	0	0	5	0	0
20	8122717	.	C	T	3	2	5	0	1	6	0	0
20	9097322	.	A	G	1	3	4	0	0	4	0	0
20	9097597	.	T	A	8	6	14	0	0	14	0	0
20	9097639	.	A	G	4	8	12	0	1	13	0	0
20	9097666	.	T	C	5	7	12	0	1	13	0	0
20	9102068	.	T	C	3	5	8	0	0	8	0	0
20	9111228	.	A	G	3	4	7	0	2	9	0	0
20	9115236	.	G	T	3	3	6	0	0	6	0	0
20	9115241	.	G	A	3	2	5	0	0	5	0	0
20	9115393	.	G	A	1	4	5	0	0	5	0	0
20	9125070	.	G	A	1	3	4	0	0	4	0	0
20	9131049	.	C	T	1	2	3	0	0	3	0	0
20	9133034	.	T	C	1	4	5	0	0	5	0	0
20	9133040	.	G	T	0	3	3	0	2	5	0	0
20	9174014	.	T	C	17	21	38	0	2	40	0	0
20	9183159	.	T	G	16	14	30	0	1	31	0	0
20	9183337	.	T	C	9	1	10	0	14	24	0	0
20	9184696	.	T	C	7	5	12	0	1	13	0	0
20	9184708	.	C	T	7	5	12	0	2	14	0	0
20	9184928	.	C	A	2	8	10	0	2	12	0	0
20	9185479	.	G	T	14	8	22	0	0	22	0	0
20	9185515	.	T	C	16	10	26	0	0	26	0	0
20	9186200	.	A	G	14	10	24	1	1	26	0	0
20	9186310	.	T	C	4	10	14	0	0	14	0	0
20	9190238	.	A	T	7	9	16	0	0	16	0	0
20	9190468	.	T	G	5	3	8	0	0	8	0	0
20	9190510	.	C	T	2	5	7	0	0	7	0	0
20	9190637	.	G	T	4	5	9	0	0	9	0	0
20	9191144	.	G	A	4	5	9	0	1	10	0	0
20	9191203	.	G	T	5	3	8	0	0	8	0	0
20	9191353	.	T	G	3	3	6	0	0	6	0	0
20	9192375	.	T	A	2	2	4	0	0	4	0	0
20	9192444	.	C	T	4	2	6	0	0	6	0	0
20	9193285	.	C	T	1	3	4	0	1	5	0	0
20	9199482	.	C	T	2	2	4	0	0	4	0	0
20	9199598	.	C	T	2	3	5	0	0	5	0	0
20	9412642	.	C	T	14	9	23	0	1	24	0	0
20	9418744	.	A	G	3	13	16	0	0	16	0	0
20	9418804	.	T	C	10	10	20	0	0	20	0	0
20	9419014	.	A	T	8	7	15	0	2	17	0	0
20	9419218	.	G	A	11	15	26	0	0	26	0	0
20	9419314	.	C	T	13	9	22	0	2	24	0	0
20	9419575	.	C	T	16	14	30	0	0	30	0	0
20	9419716	.	T	C	13	15	28	0	8	36	0	0
20	9419842	.	C	T	15	10	25	0	0	25	0	0
20	9419896	.	C	T	18	13	31	0	0	31	0	0
20	9420018	.	C	T	16	15	31	0	2	33	0	0
20	9420168	.	T	C	12	20	32	0	1	33	0	0
20	9421011	.	A	G	22	0	22	0	26	48	0	0
20	9421515	.	G	A	2	4	6	0	0	6	0	0
20	9421563	.	G	A	1	5	6	0	0	6	0	0
20	9421672	.	C	T	0	12	12	0	11	24	1	0
20	9421690	.	G	T	11	10	21	0	1	22	0	0
20	9421732	.	T	A	7	14	21	0	2	23	0	0
20	9421781	.	T	C	10	0	10	0	7	17	0	0
20	9422045	.	G	A	8	10	18	0	1	19	0	0
20	9422536	.	G	A	10	13	23	0	0	23	0	0
20	9422566	.	G	A	6	10	16	0	1	17	0	0
20	9427737	.	G	T	3	2	5	0	0	5	0	0
20	9429315	.	G	T	28	8	36	1	3	40	0	0
20	9429363	.	G	A	28	15	43	0	3	46	0	0
20	9429370	.	C	T	24	16	40	0	4	44	0	0
20	9429414	.	T	C	25	1	26	0	22	48	0	0
20	9429648	.	A	G	27	34	61	1	2	64	0	0
20	9436314	.	A	T	5	17	22	0	2	24	0	0
20	9436363	.	A	G	18	11	29	0	2	31	0	0
20	9462312	.	T	A	14	10	24	0	0	24	0	0
20	9462412	.	G	T	14	10	24	0	0	24	0	0
20	9575868	.	T	C	10	0	10	0	11	21	0	0
20	9576550	.	C	T	2	4	6	0	1	7	0	0
20	9576710	.	C	G	0	7	7	0	2	9	0	0
20	9577157	.	G	A	5	4	9	0	0	9	0	0
20	9577250	.	A	G	5	7	12	0	0	12	0	0
20	9577487	.	G	A	2	3	5	0	0	5	0	0
20	9578089	.	C	T	1	2	3	0	0	3	0	0
20	9578090	.	C	T	1	2	3	0	0	3	0	0
20	9684857	.	C	T	1	2	3	0	0	3	0	0
20	9764211	.	T	C	6	6	12	0	0	12	0	0
20	9766973	.	G	A	6	6	12	0	0	12	0	0
20	9768191	.	C	T	16	4	20	0	1	21	0	0
20	9768230	.	C	T	12	9	21	0	1	22	0	0
20	9768330	.	A	G	10	11	21	0	0	21	0	0
20	9775889	.	A	G	19	20	39	0	2	41	0	0
20	9775934	.	T	C	15	25	40	0	2	42	0	0
20	9776270	.	G	A	9	3	12	0	2	14	0	0
20	9776525	.	T	C	4	1	5	0	1	6	0	0
20	9776579	.	T	C	3	2	5	0	0	5	0	0
20	9776770	.	A	G	8	4	12	0	0	12	0	0
20	9777182	.	C	T	3	3	6	0	1	7	0	0
20	9777200	.	G	A	1	2	3	0	0	3	0	0
20	9779333	.	T	C	2	0	2	0	3	5	0	0
20	9782747	.	C	A	4	3	7	0	1	8	0	0
20	9782913	.	T	C	4	3	7	0	1	8	0	0
20	9782990	.	T	C	3	6	9	0	0	9	0	0
20	9820430	.	T	C	5	7	12	0	0	12	0	0
20	9830642	.	T	C	31	22	53	1	8	62	0	0
20	9830684	.	G	T	23	23	46	0	2	48	0	0
20	9831443	.	G	A	32	23	55	0	2	57	0	0
20	9831703	.	T	A	43	21	64	0	1	65	0	0
20	9837587	.	G	A	43	25	68	0	2	70	0	0
20	9837593	.	T	C	38	24	62	0	6	68	0	0
20	9846751	.	A	G	38	22	60	2	4	66	0	0
20	9846989	.	T	C	32	39	71	0	4	75	0	0
20	9846997	.	A	T	30	38	68	0	4	72	0	0
20	9847078	.	T	C	29	28	57	0	4	61	0	0
20	9847252	.	G	T	17	10	27	0	1	28	0	0
20	9847298	.	T	G	18	19	37	0	1	38	0	0
20	9847304	.	G	A	19	15	34	0	3	37	0	0
20	9847529	.	A	T	30	24	54	0	0	54	0	0
20	9847772	.	T	C	24	27	51	0	1	53	1	0
20	9847895	.	C	T	23	29	52	0	2	54	0	0
20	9848116	.	C	T	40	16	56	0	4	60	0	0
20	9848181	.	A	T	48	14	62	0	0	62	0	0
20	9848196	.	T	G	44	20	64	0	2	66	0	0
20	9959377	.	G	A	4	4	8	0	0	8	0	0
20	9959699	.	T	A	7	4	11	0	0	11	0	0
20	9959725	.	C	T	4	3	7	0	0	7	0	0
20	9959794	.	T	C	5	4	9	0	1	10	0	0
20	9959890	.	G	A	3	6	9	0	0	9	0	0
20	9960635	.	G	A	4	5	9	0	0	9	0	0
20	9960859	.	G	T	1	3	4	0	0	4	0	0
20	9960974	.	C	T	1	2	3	0	0	3	0	0
20	10057929	.	T	C	5	2	7	0	0	7	0	0
20	10057993	.	C	G	2	10	12	0	9	21	0	0
20	10058109	.	T	A	11	11	22	0	0	22	0	0
20	10058111	.	A	G	10	10	20	0	2	22	0	0
20	10058242	.	T	C	12	9	21	0	1	22	0	0
20	10058350	.	C	T	9	17	26	0	1	27	0	0
20	10058441	.	A	T	12	11	23	0	0	23	0	0
20	10058476	.	T	A	15	13	28	0	1	29	0	0
20	10058796	.	G	A	5	4	9	0	0	9	0	0
20	10058829	.	T	A	6	4	10	0	0	10	0	0
20	10058853	.	C	A	5	7	12	0	0	12	0	0
20	10058897	.	C	T	4	6	10	0	0	10	0	0
20	10058901	.	G	C	4	6	10	0	0	10	0	0
20	10058948	.	T	A	4	7	11	0	1	12	0	0
20	10058993	.	T	C	7	0	7	0	10	17	0	0
20	10059194	.	G	A	5	9	14	0	1	15	0	0
20	10059278	.	A	G	7	9	16	0	0	16	0	0
20	10059815	.	A	G	3	2	5	0	0	5	0	0
20	10060483	.	A	C	5	7	12	0	0	12	0	0
20	10060586	.	C	T	1	2	3	0	0	3	0	0
20	10060768	.	G	C	2	4	6	0	0	6	0	0
20	10061250	.	G	C	2	2	4	0	0	4	0	0
20	10061563	.	C	T	1	3	4	0	0	4	0	0
20	10061778	.	T	C	1	2	3	0	0	3	0	0
20	10061837	.	C	T	1	2	3	0	0	3	0	0
20	10099362	.	T	A	6	3	9	3	0	12	0	0
20	10099363	.	C	T	6	3	9	3	0	12	0	0
20	10099640	.	G	A	11	5	16	0	2	18	0	0
20	10099932	.	C	A	10	5	15	0	0	15	0	0
20	10102593	.	G	A	18	12	30	0	2	32	0	0
20	10219360	.	T	C	2	4	6	0	0	6	0	0
20	10219396	.	A	T	1	6	7	0	1	8	0	0
20	10219447	.	G	A	2	3	5	0	0	5	0	0
20	10219829	.	C	G	4	2	6	0	0	6	0	0
20	10353335	.	T	C	1	3	4	0	0	4	0	0
20	10354482	.	T	G	6	2	8	0	1	9	0	0
20	13567560	.	T	C	4	4	8	0	1	9	0	0
20	13567574	.	T	C	1	7	8	0	0	8	0	0
20	13649244	.	T	C	1	0	1	0	3	4	0	0
20	13649297	.	T	C	1	2	3	0	0	3	0	0
20	14977165	.	G	A	2	12	14	0	12	26	0	0
20	14983779	.	C	T	14	5	19	0	0	19	0	0
20	14983788	.	C	T	15	4	19	0	0	19	0	0
20	14997711	.	G	C	14	8	22	0	0	22	0	0
20	14997729	.	G	A	12	11	23	0	1	24	0	0
20	14997753	.	T	A	16	15	31	0	1	32	0	0
20	15004153	.	T	C	22	16	38	0	1	39	0	0
20	15004205	.	C	T	20	18	38	0	5	43	0	0
20	15004321	.	C	T	21	19	40	0	0	40	0	0
20	15004334	.	A	C	20	20	40	0	1	41	0	0
20	15004518	.	A	G	7	14	21	0	1	22	0	0
20	15004575	.	C	A	8	12	20	0	4	24	0	0
20	15004611	.	A	C	16	11	27	0	1	28	0	0
20	15004710	.	C	T	13	18	31	0	4	35	0	0
20	15004746	.	T	A	17	13	30	0	5	35	0	0
20	15004751	.	T	G	13	17	30	0	3	33	0	0
20	15004806	.	C	T	12	10	22	0	1	23	0	0
20	15004825	.	A	T	11	8	19	0	3	22	0	0
20	15004862	.	T	C	14	8	22	0	2	24	0	0
20	15004874	.	A	G	11	0	11	0	13	24	0	0
20	15004992	.	A	G	17	7	24	0	1	25	0	0
20	15005055	.	A	C	5	3	8	0	1	9	0	0
20	15023488	.	T	C	10	9	19	0	3	22	0	0
20	15026847	.	C	T	0	11	11	0	13	24	0	0
20	15033954	.	A	G	9	8	17	0	2	19	0	0
20	15051770	.	G	A	1	2	3	0	0	3	0	0
20	15051791	.	G	A	1	3	4	0	0	4	0	0
20	15093822	.	G	C	1	2	3	0	1	4	0	0
20	15093847	.	T	C	2	2	4	0	0	4	0	0
20	15094168	.	A	G	5	3	8	0	0	8	0	0
20	15094356	.	C	T	1	3	4	0	1	5	0	0
20	15121566	.	A	G	2	3	5	0	0	5	0	0
20	15128402	.	C	G	1	2	3	0	0	3	0	0
20	15161326	.	T	C	2	2	4	0	0	4	0	0
20	15171711	.	C	T	14	13	27	0	3	30	0	0
20	15184455	.	C	T	18	20	38	0	2	40	0	0
20	15184458	.	A	G	21	1	22	0	18	40	0	0
20	15184527	.	T	A	17	19	36	0	5	41	0	0
20	15184568	.	T	G	19	27	46	0	0	46	0	0
20	15184611	.	A	T	16	12	28	0	0	28	0	0
20	15184629	.	T	G	11	9	20	0	0	20	0	0
20	15184654	.	C	T	6	14	20	0	1	21	0	0
20	15184671	.	A	G	12	6	18	0	0	18	0	0
20	15184748	.	C	G	1	3	4	0	0	4	0	0
20	15184859	.	G	C	1	3	4	0	0	4	0	0
20	15184862	.	C	T	1	3	4	0	0	4	0	0
20	15553003	.	C	T	8	13	21	0	0	21	0	0
20	15553159	.	A	G	13	8	21	0	3	24	0	0
20	15553366	.	G	T	17	9	26	0	2	28	0	0
20	15554247	.	A	G	13	18	31	0	1	32	0	0
20	15574202	.	G	A	3	3	6	0	0	6	0	0
20	15578007	.	G	A	1	2	3	0	3	6	0	0
20	15857317	.	G	C	10	17	27	0	1	28	0	0
20	15857761	.	T	A	23	25	48	0	2	50	0	0
20	15857805	.	T	A	17	24	41	0	3	44	0	0
20	15857850	.	C	T	18	17	35	0	4	39	0	0
20	15866267	.	A	G	16	13	29	0	0	29	0	0
20	15866414	.	T	C	9	10	19	0	2	21	0	0
20	15911808	.	A	G	9	8	17	0	2	19	0	0
20	15911880	.	C	T	7	18	25	0	0	25	0	0
20	15912102	.	T	C	5	11	16	0	1	17	0	0
20	15912167	.	A	G	4	5	9	0	1	10	0	0
20	15933419	.	G	A	11	10	21	0	0	21	0	0
20	15933489	.	T	C	12	0	12	0	8	20	0	0
20	15933553	.	G	A	18	6	24	0	3	27	0	0
20	15933659	.	C	T	14	8	22	0	1	23	0	0
20	15933852	.	C	T	5	5	10	0	0	10	0	0
20	15933904	.	C	A	13	0	13	0	5	18	0	0
20	15933961	.	C	T	12	6	18	0	3	21	0	0
20	15934395	.	G	T	5	7	12	0	4	16	0	0
20	15934459	.	G	A	4	11	15	0	0	15	0	0
20	15934519	.	A	G	5	9	14	0	0	14	0	0
20	15934526	.	G	T	5	9	14	0	0	14	0	0
20	15934639	.	G	C	1	6	7	0	2	9	0	0
20	15935078	.	T	G	3	5	8	0	1	9	0	0
20	15935109	.	A	T	3	3	6	0	0	6	0	0
20	15935141	.	T	G	2	5	7	0	1	8	0	0
20	15935146	.	A	C	2	5	7	0	1	8	0	0
20	15935650	.	A	C	4	2	6	0	0	6	0	0
20	15937445	.	G	T	3	2	5	0	0	5	0	0
20	15937613	.	G	A	4	3	7	0	1	8	0	0
20	15937709	.	G	A	4	4	8	0	0	8	0	0
20	15937735	.	A	T	3	4	7	0	0	7	0	0
20	15937763	.	A	G	2	2	4	0	0	4	0	0
20	15937833	.	G	T	1	3	4	0	0	4	0	0
20	15937839	.	T	G	2	3	5	0	0	5	0	0
20	15938179	.	A	T	2	1	3	0	0	3	0	0
20	15938200	.	G	A	2	3	5	0	0	5	0	0
20	15973728	.	T	C	3	0	3	0	2	5	0	0
20	15974445	.	G	A	2	2	4	0	1	5	0	0
20	16156367	.	A	G	1	2	3	0	0	3	0	0
20	16163348	.	T	C	8	11	19	0	1	20	0	0
20	16163447	.	T	C	8	0	8	0	5	13	0	0
20	16163552	.	G	A	11	12	23	0	0	23	0	0
20	16171113	.	G	C	4	0	4	0	4	8	0	0
20	16171155	.	T	C	4	0	4	0	4	8	0	0
20	16180070	.	G	C	1	4	5	0	4	9	0	0
20	16180103	.	G	T	4	5	9	0	0	9	0	0
20	16180127	.	T	C	2	6	8	0	0	8	0	0
20	16180469	.	G	A	2	1	3	0	2	5	0	0
20	16182839	.	G	A	0	3	3	0	2	5	0	0
20	16184525	.	C	T	4	3	7	0	0	7	0	0
20	16184594	.	T	C	1	4	5	0	0	5	0	0
20	16198986	.	G	A	0	14	14	0	14	28	0	0
20	16200983	.	T	A	4	10	14	0	1	15	0	0
20	16201017	.	C	T	7	12	19	0	1	20	0	0
20	16201109	.	T	A	12	4	16	0	1	17	0	0
20	16201163	.	T	A	18	7	25	1	0	26	0	0
20	16201394	.	G	A	12	10	22	0	0	22	0	0
20	16201649	.	A	C	16	11	27	0	1	28	0	0
20	16205412	.	T	C	1	0	1	0	2	3	0	0
20	16438258	.	A	T	7	12	19	0	1	20	0	0
20	16438557	.	A	C	6	9	15	0	2	17	0	0
20	16438658	.	A	T	6	9	15	0	0	15	0	0
20	16438776	.	C	G	6	8	14	0	1	15	0	0
20	16438785	.	G	T	7	9	16	0	1	17	0	0
20	16438837	.	T	C	8	0	8	0	9	17	0	0
20	16438957	.	T	G	8	7	15	0	2	17	0	0
20	16438958	.	C	G	10	6	16	0	1	17	0	0
20	16443545	.	G	A	10	10	20	0	3	23	0	0
20	16443677	.	T	C	16	12	28	0	2	31	1	0
20	16443701	.	T	A	12	11	23	0	5	28	0	0
20	16443740	.	C	T	12	9	21	0	1	22	0	0
20	16446685	.	A	G	9	11	20	0	1	21	0	0
20	16448913	.	G	T	6	5	11	0	1	12	0	0
20	16448930	.	T	C	6	5	11	0	1	12	0	0
20	16478011	.	A	G	1	2	3	0	0	3	0	0
20	16478612	.	T	C	2	0	2	0	2	4	0	0
20	16498767	.	A	G	1	2	3	0	0	3	0	0
20	16498881	.	C	T	0	2	2	0	1	3	0	0
20	16548833	.	C	T	0	3	3	0	1	4	0	0
20	16639964	.	G	A	0	6	6	0	1	7	0	0
20	16644943	.	A	G	5	0	5	0	6	11	0	0
20	16645004	.	T	C	4	4	8	0	0	8	0	0
20	16652964	.	G	A	0	8	8	0	4	12	0	0
20	16660218	.	G	A	2	24	26	0	18	44	0	0
20	16660327	.	G	C	16	17	33	0	1	34	0	0
20	16660462	.	A	T	17	12	29	0	0	29	0	0
20	16660567	.	G	A	13	12	25	0	1	26	0	0
20	16660652	.	G	A	9	13	22	0	0	22	0	0
20	16660707	.	G	A	1	9	10	0	12	22	0	0
20	16660808	.	C	T	4	5	9	0	1	10	0	0
20	16736960	.	G	A	14	17	31	0	2	33	0	0
20	16737485	.	C	T	15	14	29	0	0	29	0	0
20	16737524	.	T	C	14	18	32	0	3	35	0	0
20	16771318	.	C	T	39	30	69	0	7	76	0	0
20	16774513	.	A	T	35	35	70	0	2	72	0	0
20	16774868	.	A	G	34	29	63	1	5	69	0	0
20	16774970	.	T	A	30	34	64	1	4	69	0	0
20	16832788	.	G	T	13	9	22	0	0	22	0	0
20	16833019	.	C	T	0	8	8	0	11	19	0	0
20	16833089	.	A	G	9	10	19	0	1	20	0	0
20	16833096	.	A	G	9	8	17	0	0	17	0	0
20	16833125	.	C	T	7	8	15	1	0	16	0	0
20	16833284	.	A	T	8	5	13	0	0	13	0	0
20	16833806	.	C	A	6	5	11	0	0	11	0	0
20	16833893	.	A	G	5	2	7	0	0	7	0	0
20	16834096	.	T	C	5	2	7	0	1	8	0	0
20	16834307	.	C	A	0	3	3	0	7	10	0	0
20	16834525	.	A	G	9	10	19	0	0	19	0	0
20	16834647	.	T	C	6	2	8	0	1	9	0	0
20	16834778	.	T	C	1	6	7	0	0	7	0	0
20	16848908	.	C	T	7	6	13	0	1	14	0	0
20	16883691	.	A	T	3	2	5	0	1	6	0	0
20	16903806	.	T	A	9	4	13	0	1	14	0	0
20	16903878	.	T	A	5	6	11	0	0	11	0	0
20	16906564	.	C	T	7	4	11	0	1	12	0	0
20	17740260	.	G	C	1	4	5	0	0	5	0	0
20	17740261	.	T	C	1	4	5	0	0	5	0	0
20	17798876	.	C	T	7	7	14	0	1	15	0	0
20	17798930	.	C	T	7	8	15	0	0	15	0	0
20	17800493	.	T	C	14	5	19	0	2	21	0	0
20	17800843	.	A	C	9	4	13	0	2	15	0	0
20	17802868	.	C	T	9	9	18	0	0	18	0	0
20	17802874	.	A	G	9	10	19	0	0	19	0	0
20	17802964	.	A	G	8	0	8	0	7	15	0	0
20	17802979	.	C	T	8	10	18	0	0	18	0	0
20	17803572	.	T	C	4	14	18	0	0	18	0	0
20	17809123	.	G	A	18	16	34	0	0	34	0	0
20	17809141	.	T	C	16	17	33	0	1	34	0	0
20	17809177	.	C	T	15	20	35	0	0	35	0	0
20	17811587	.	G	A	20	17	37	0	2	39	0	0
20	17817433	.	T	G	25	20	45	0	1	46	0	0
20	17817659	.	G	T	6	23	29	0	0	29	0	0
20	17817926	.	G	T	10	20	30	0	0	31	1	0
20	17818291	.	T	C	13	12	25	0	10	35	0	0
20	17818445	.	T	A	23	17	40	0	1	41	0	0
20	17819008	.	T	C	42	0	42	0	1	43	0	0
20	18225441	.	C	A	6	7	13	0	0	13	0	0
20	18255474	.	A	G	8	1	9	0	18	27	0	0
20	18255810	.	T	C	10	21	31	0	1	32	0	0
20	18255931	.	A	T	12	19	31	0	1	32	0	0
20	18256176	.	T	A	4	3	7	0	1	8	0	0
20	18306290	.	T	A	16	10	26	0	3	29	0	0
20	18306298	.	T	G	15	7	22	0	7	29	0	0
20	18307075	.	T	C	19	0	19	0	15	34	0	0
20	18309277	.	C	T	12	14	26	0	2	28	0	0
20	18312803	.	T	C	15	13	28	0	3	31	0	0
20	18312839	.	T	C	15	15	30	0	2	32	0	0
20	18329356	.	A	T	2	2	4	0	0	4	0	0
20	18357820	.	T	C	10	7	17	0	1	18	0	0
20	18358002	.	T	C	3	5	8	0	0	8	0	0
20	18369979	.	G	A	7	11	18	0	0	18	0	0
20	18373014	.	T	G	4	3	7	0	0	7	0	0
20	18392845	.	C	T	28	16	44	0	0	44	0	0
20	18393249	.	T	C	12	15	27	1	1	29	0	0
20	18393359	.	A	T	12	14	26	0	1	27	0	0
20	18393376	.	C	T	17	13	30	0	1	31	0	0
20	18396134	.	A	G	12	19	31	0	3	34	0	0
20	18413987	.	T	C	5	1	6	0	8	14	0	0
20	18414262	.	C	T	6	3	9	0	1	10	0	0
20	18432732	.	C	T	7	4	11	0	0	11	0	0
20	18443435	.	G	A	4	3	7	0	0	7	0	0
20	18443554	.	C	T	1	4	5	0	0	5	0	0
20	18454644	.	G	A	2	2	4	0	0	4	0	0
20	18591638	.	G	T	15	19	34	1	5	40	0	0
20	18591704	.	G	A	26	18	44	0	0	44	0	0
20	18591716	.	A	C	25	15	40	0	5	45	0	0
20	18591743	.	A	T	23	12	35	0	0	35	0	0
20	18594958	.	C	A	30	22	52	1	0	53	0	0
20	18594980	.	T	A	24	27	51	1	3	55	0	0
20	18595296	.	T	G	11	0	11	0	24	35	0	0
20	18672064	.	C	T	2	15	17	0	1	18	0	0
20	18672094	.	T	C	4	8	12	0	0	12	0	0
20	18672733	.	A	T	5	14	19	0	0	19	0	0
20	18673132	.	C	T	6	13	19	0	1	20	0	0
20	18677343	.	G	A	8	15	23	0	1	24	0	0
20	18677391	.	T	G	11	1	12	0	4	16	0	0
20	18678023	.	T	C	20	8	28	0	0	28	0	0
20	18683158	.	T	C	18	21	39	0	1	40	0	0
20	18684922	.	A	T	26	13	39	0	2	41	0	0
20	18685139	.	G	A	20	6	26	0	0	26	0	0
20	18708770	.	T	C	23	22	45	0	1	47	1	0
20	18713067	.	T	C	27	28	55	0	4	59	0	0
20	18714024	.	C	T	2	11	13	0	0	13	0	0
20	18714242	.	C	A	1	3	4	0	0	4	0	0
20	18714282	.	A	G	3	0	3	0	2	5	0	0
20	18714824	.	G	A	2	6	8	0	2	10	0	0
20	18721340	.	G	T	4	2	6	0	0	6	0	0
20	18721383	.	A	T	3	2	5	0	0	5	0	0
20	18721775	.	T	G	8	9	17	0	1	18	0	0
20	18721910	.	G	A	16	6	22	0	1	23	0	0
20	18722089	.	G	C	9	10	19	0	0	19	0	0
20	18722312	.	A	C	10	10	20	0	1	22	1	0
20	18722565	.	A	T	13	10	23	0	4	27	0	0
20	18722630	.	C	T	0	3	3	0	6	9	0	0
20	18722860	.	A	T	3	5	8	0	1	9	0	0
20	18723062	.	C	T	4	5	9	0	0	9	0	0
20	18723105	.	C	T	9	6	15	0	1	16	0	0
20	18723239	.	G	T	6	8	14	1	1	16	0	0
20	18723244	.	G	T	7	8	15	1	0	16	0	0
20	18723301	.	T	G	5	7	12	0	2	14	0	0
20	18723327	.	T	C	6	0	6	0	7	13	0	0
20	18723401	.	T	C	9	0	9	0	7	16	0	0
20	18723441	.	G	A	5	8	13	0	0	13	0	0
20	18723459	.	T	C	2	7	9	0	1	10	0	0
20	18727472	.	T	C	4	5	9	0	0	9	0	0
20	18727506	.	T	C	7	3	10	0	1	11	0	0
20	18730498	.	G	A	4	4	8	0	0	8	0	0
20	18730840	.	T	C	4	4	8	0	0	8	0	0
20	18747199	.	C	A	2	2	4	0	0	4	0	0
20	18747210	.	G	A	2	2	4	0	0	4	0	0
20	18756613	.	A	G	4	2	6	0	0	6	0	0
20	18756628	.	A	G	2	3	5	0	0	5	0	0
20	18774207	.	C	G	1	2	3	0	0	3	0	0
20	18774552	.	G	A	5	4	9	0	0	9	0	0
20	18774616	.	A	G	8	6	14	0	1	15	0	0
20	18774618	.	T	C	7	6	13	0	2	15	0	0
20	18802651	.	G	A	1	3	4	0	0	4	0	0
20	18955563	.	A	T	1	2	3	0	0	3	0	0
20	18958106	.	C	G	2	5	7	0	0	7	0	0
20	18958159	.	T	C	4	6	10	0	1	11	0	0
20	18958477	.	G	A	0	4	4	0	1	5	0	0
20	18961835	.	T	C	5	3	8	0	0	8	0	0
20	18961838	.	C	T	4	3	7	0	1	8	0	0
20	18968826	.	C	T	7	7	14	0	0	14	0	0
20	18972850	.	T	A	10	12	22	0	0	22	0	0
20	18983543	.	T	G	7	15	22	0	2	24	0	0
20	18983567	.	T	C	10	15	25	0	0	25	0	0
20	18983625	.	G	A	17	13	30	0	3	33	0	0
20	18983755	.	T	C	7	10	17	0	1	18	0	0
20	18983767	.	T	C	8	9	17	0	1	18	0	0
20	18994993	.	G	T	2	4	6	0	0	6	0	0
20	18995519	.	G	A	0	2	2	0	5	7	0	0
20	18996133	.	T	A	13	8	21	0	0	21	0	0
20	18996331	.	C	T	11	5	16	0	0	16	0	0
20	18996832	.	T	C	3	9	12	0	0	12	0	0
20	18997305	.	A	G	18	18	36	0	2	38	0	0
20	18997853	.	G	C	10	14	24	0	2	26	0	0
20	18997875	.	A	G	9	7	16	3	0	19	0	0
20	19007198	.	G	T	2	4	6	0	2	8	0	0
20	19007210	.	C	A	2	6	8	0	1	9	0	0
20	19075250	.	C	A	1	2	3	0	0	3	0	0
20	19075259	.	C	A	1	2	3	0	0	3	0	0
20	19075298	.	G	A	1	2	3	0	0	3	0	0
20	19075371	.	G	A	0	2	2	0	1	3	0	0
20	19076687	.	G	A	3	2	5	0	0	5	0	0
20	19076873	.	C	T	3	3	6	0	0	6	0	0
20	19077156	.	T	C	8	7	15	0	3	18	0	0
20	19077628	.	A	G	5	12	17	0	4	21	0	0
20	19078061	.	A	T	1	2	3	0	0	3	0	0
20	19213235	.	G	A	8	6	14	0	0	14	0	0
20	19238509	.	A	T	6	12	18	0	1	19	0	0
20	19258639	.	T	C	12	10	22	0	0	22	0	0
20	19277495	.	C	A	2	6	8	0	0	8	0	0
20	19277551	.	C	T	0	2	2	0	2	4	0	0
20	19277893	.	C	T	3	6	9	0	2	11	0	0
20	19277921	.	A	T	2	6	8	0	0	8	0	0
20	19278011	.	T	A	9	4	13	0	0	13	0	0
20	19278132	.	C	T	5	9	14	0	1	15	0	0
20	19290958	.	T	C	3	4	7	0	0	7	0	0
20	19365664	.	C	T	1	3	4	0	0	4	0	0
20	19373510	.	A	T	1	7	8	0	0	8	0	0
20	19373511	.	G	T	1	7	8	0	0	8	0	0
20	19373616	.	T	C	7	14	21	0	2	23	0	0
20	19373647	.	C	T	13	16	29	0	1	30	0	0
20	19373653	.	T	A	11	17	28	0	1	29	0	0
20	19373720	.	T	C	13	0	13	1	14	28	0	0
20	19374043	.	A	C	5	0	5	0	9	14	0	0
20	19374728	.	G	A	11	2	13	0	0	13	0	0
20	19374755	.	A	G	9	3	12	0	2	14	0	0
20	19391641	.	A	G	5	5	10	0	0	10	0	0
20	19391704	.	A	G	6	5	11	0	1	12	0	0
20	19406620	.	A	G	3	3	6	0	2	8	0	0
20	19406643	.	C	T	1	2	3	0	2	5	0	0
20	19406709	.	A	C	3	3	6	0	0	6	0	0
20	19415161	.	A	G	2	4	6	0	0	6	0	0
20	19415260	.	G	A	2	4	6	0	0	6	0	0
20	19415309	.	T	C	3	0	3	0	5	8	0	0
20	19423908	.	A	G	1	2	3	0	0	3	0	0
20	19423997	.	C	T	3	5	8	0	0	8	0	0
20	19429846	.	C	T	2	2	4	0	0	4	0	0
20	19430075	.	A	G	3	0	3	0	4	7	0	0
20	19430092	.	T	C	3	5	8	0	0	8	0	0
20	19430352	.	C	A	4	4	8	0	0	8	0	0
20	19430640	.	T	C	4	10	14	0	0	14	0	0
20	19430641	.	G	A	4	8	12	0	2	14	0	0
20	19430736	.	A	G	7	0	7	0	15	22	0	0
20	19430782	.	G	A	6	4	10	0	3	13	0	0
20	19430790	.	C	T	9	9	18	0	0	18	0	0
20	19431012	.	T	C	11	8	19	0	0	19	0	0
20	19431360	.	C	G	3	4	7	0	0	7	0	0
20	19431477	.	T	A	6	5	11	0	0	11	0	0
20	19431631	.	G	C	8	5	13	0	1	14	0	0
20	19432007	.	G	T	5	7	12	0	0	12	0	0
20	19432150	.	T	A	9	5	14	0	0	14	0	0
20	19432213	.	A	G	10	3	13	0	0	13	0	0
20	19436389	.	G	C	4	14	18	0	0	18	0	0
20	19436890	.	T	C	9	0	9	0	0	9	0	0
20	19436899	.	C	A	9	7	16	0	0	16	0	0
20	19437624	.	T	C	7	0	7	0	5	12	0	0
20	19438082	.	T	C	5	0	5	0	4	9	0	0
20	19438146	.	T	C	8	0	8	0	5	13	0	0
20	19438193	.	T	A	7	2	9	0	0	9	0	0
20	19438458	.	T	A	4	3	7	0	0	7	0	0
20	19438460	.	T	G	4	3	7	0	0	7	0	0
20	19440796	.	T	C	2	7	9	0	2	11	0	0
20	19442994	.	G	A	5	5	10	0	0	10	0	0
20	19443060	.	C	T	0	4	4	0	7	11	0	0
20	19469513	.	G	A	6	3	9	0	0	9	0	0
20	19511225	.	T	A	1	4	5	0	1	6	0	0
20	19513054	.	G	A	4	11	15	0	2	17	0	0
20	19513093	.	G	A	3	7	10	0	2	12	0	0
20	19513258	.	C	T	4	4	8	0	1	9	0	0
20	19513289	.	A	T	5	5	10	0	0	10	0	0
20	19515966	.	G	T	5	6	11	0	1	12	0	0
20	19516035	.	A	G	7	0	7	0	6	13	0	0
20	19516068	.	C	T	12	11	23	0	1	24	0	0
20	19516206	.	T	A	7	7	14	0	0	14	0	0
20	19516246	.	G	T	7	6	13	0	0	13	0	0
20	19516274	.	C	A	9	4	13	0	0	13	0	0
20	19516286	.	T	C	9	3	12	0	1	13	0	0
20	19516315	.	G	C	10	7	17	0	0	17	0	0
20	19516360	.	A	G	8	1	9	0	10	19	0	0
20	19516392	.	T	C	11	8	19	0	0	19	0	0
20	19516406	.	T	G	12	0	12	0	7	19	0	0
20	19516537	.	T	C	7	8	15	0	1	16	0	0
20	19516713	.	C	A	3	3	6	0	0	6	0	0
20	19516746	.	A	G	5	5	10	0	0	10	0	0
20	19516772	.	T	C	6	2	8	0	1	9	0	0
20	19516803	.	T	C	11	8	19	1	2	22	0	0
20	19516837	.	G	A	8	8	16	1	4	21	0	0
20	19516850	.	T	C	13	11	24	0	1	25	0	0
20	19517027	.	C	G	11	14	25	0	0	25	0	0
20	19518685	.	A	G	9	14	23	0	1	24	0	0
20	19521387	.	G	A	5	4	9	0	0	9	0	0
20	19521657	.	C	T	5	11	16	0	1	17	0	0
20	19524966	.	A	G	10	15	25	0	0	25	0	0
20	19524978	.	G	A	7	16	23	0	5	28	0	0
20	19525535	.	G	A	1	2	3	0	0	3	0	0
20	19562848	.	C	G	6	3	9	0	0	9	0	0
20	19573889	.	C	A	8	7	15	0	2	17	0	0
20	19575264	.	G	A	10	4	14	0	0	14	0	0
20	19575271	.	A	G	10	2	12	0	1	13	0	0
20	19579897	.	G	A	1	2	3	0	0	3	0	0
20	19579940	.	G	A	5	4	9	0	0	9	0	0
20	19580158	.	T	G	7	4	11	0	0	11	0	0
20	19580205	.	G	T	10	6	16	0	0	17	1	0
20	19580234	.	C	T	12	8	20	0	2	22	0	0
20	19580360	.	G	T	9	6	15	0	4	19	0	0
20	19580362	.	C	A	13	6	19	0	0	20	1	0
20	19580525	.	C	A	10	6	16	0	0	16	0	0
20	19580584	.	T	C	12	1	13	0	11	24	0	0
20	19580654	.	C	T	13	9	22	0	0	22	0	0
20	19582896	.	G	A	17	11	28	0	1	29	0	0
20	19582955	.	C	T	12	9	21	0	3	24	0	0
20	19588759	.	G	A	9	6	15	0	0	15	0	0
20	19590288	.	G	A	5	9	14	0	1	15	0	0
20	20231857	.	C	T	11	11	22	0	1	23	0	0
20	20231919	.	A	G	10	13	23	0	4	27	0	0
20	20231995	.	G	C	16	10	26	0	1	27	0	0
20	20232347	.	A	T	16	15	31	0	0	31	0	0
20	20275095	.	A	T	5	7	12	0	0	12	0	0
20	20275244	.	G	T	9	7	16	0	2	18	0	0
20	20275306	.	C	T	8	8	16	0	3	19	0	0
20	20275322	.	T	A	8	12	20	0	0	20	0	0
20	20275439	.	G	A	14	17	31	0	2	33	0	0
20	20275519	.	A	G	12	5	17	0	5	22	0	0
20	20275609	.	T	A	13	21	34	0	2	36	0	0
20	20275661	.	C	T	2	17	19	0	11	30	0	0
20	20275766	.	T	G	10	12	22	0	4	26	0	0
20	20275776	.	T	C	15	0	15	0	13	28	0	0
20	20276130	.	G	A	5	2	7	1	0	8	0	0
20	20276607	.	T	G	10	6	16	0	1	17	0	0
20	20276730	.	G	C	3	8	11	0	1	12	0	0
20	20277162	.	T	C	9	3	12	2	0	14	0	0
20	20277183	.	T	C	8	4	12	1	0	13	0	0
20	20277337	.	A	T	9	10	19	0	0	19	0	0
20	20277370	.	T	C	9	9	18	0	1	19	0	0
20	20277460	.	G	C	9	10	19	0	0	19	0	0
20	20277481	.	A	T	9	10	19	0	0	19	0	0
20	20277525	.	T	C	8	0	8	0	7	15	0	0
20	20277530	.	A	T	8	7	15	0	0	15	0	0
20	20277903	.	C	T	2	5	7	0	0	7	0	0
20	20278161	.	G	C	3	0	3	0	4	7	0	0
20	20278213	.	G	A	1	3	4	0	1	5	0	0
20	20278442	.	G	C	4	2	6	0	1	7	0	0
20	20278461	.	G	C	3	0	3	0	2	5	0	0
20	20278692	.	A	C	2	4	6	0	0	6	0	0
20	20278703	.	C	T	2	3	5	0	0	5	0	0
20	20326945	.	A	T	10	4	14	0	0	14	0	0
20	20328137	.	G	A	25	36	61	0	3	64	0	0
20	20330095	.	C	A	20	16	36	0	2	38	0	0
20	20330256	.	T	C	18	19	37	0	1	38	0	0
20	20331235	.	T	A	13	20	33	0	2	35	0	0
20	20331740	.	A	G	18	15	33	0	0	33	0	0
20	20332079	.	G	A	17	11	28	0	0	28	0	0
20	20334705	.	G	A	5	9	14	0	1	15	0	0
20	20335543	.	A	G	6	4	10	0	0	10	0	0
20	20335739	.	G	C	5	4	9	0	0	9	0	0
20	20335784	.	A	T	7	9	16	0	0	16	0	0
20	20337215	.	G	A	6	11	17	0	2	19	0	0
20	20337263	.	A	C	3	8	11	0	1	12	0	0
20	20338509	.	A	G	6	3	9	0	1	10	0	0
20	20601233	.	C	G	12	16	28	0	1	29	0	0
20	20601651	.	T	G	9	12	21	1	5	27	0	0
20	20601883	.	A	T	14	16	30	0	2	32	0	0
20	20601884	.	A	C	14	16	30	0	2	32	0	0
20	20601985	.	T	C	19	9	28	1	0	29	0	0
20	20602097	.	A	T	10	8	18	0	0	19	1	0
20	20602167	.	T	C	7	3	10	0	1	11	0	0
20	20602232	.	T	C	16	5	21	1	1	23	0	0
20	20602290	.	G	T	8	9	17	0	2	19	0	0
20	20602370	.	A	T	9	7	16	0	1	17	0	0
20	20603131	.	T	A	9	11	20	0	0	20	0	0
20	20603389	.	T	G	3	4	7	0	0	7	0	0
20	20603443	.	T	G	4	2	6	0	0	6	0	0
20	20603906	.	G	A	2	3	5	0	1	6	0	0
20	20603966	.	A	T	1	2	3	0	0	3	0	0
20	20604015	.	T	G	1	2	3	0	1	4	0	0
20	20605136	.	T	C	6	6	12	0	0	12	0	0
20	20609663	.	G	A	4	3	7	0	0	7	0	0
20	20609735	.	G	C	5	0	5	0	8	14	1	0
20	20638004	.	A	T	1	3	4	0	0	4	0	0
20	20638008	.	A	C	1	4	5	0	0	5	0	0
20	20655141	.	G	C	7	2	9	0	1	10	0	0
20	20655142	.	T	C	7	2	9	0	1	10	0	0
20	20655339	.	A	T	5	5	10	0	0	10	0	0
20	20655357	.	G	A	0	6	6	0	4	10	0	0
20	20655394	.	C	G	4	0	4	0	9	13	0	0
20	20658851	.	G	T	5	3	8	0	2	10	0	0
20	20658954	.	C	T	11	7	18	0	0	18	0	0
20	20659009	.	T	C	11	9	20	0	1	21	0	0
20	20659067	.	G	A	7	7	14	0	0	14	0	0
20	20659188	.	C	G	9	5	14	0	0	14	0	0
20	20659305	.	T	C	8	11	19	0	3	22	0	0
20	20659306	.	C	T	7	13	20	0	2	22	0	0
20	20672289	.	T	C	19	34	53	0	1	54	0	0
20	20672335	.	C	T	23	24	47	5	1	53	0	0
20	20693557	.	G	A	2	2	4	0	0	4	0	0
20	20694918	.	A	T	26	44	70	0	4	75	1	0
20	20694999	.	C	T	16	20	36	1	5	42	0	0
20	20695642	.	G	T	2	28	30	0	33	63	0	0
20	20695779	.	T	A	40	21	61	0	7	68	0	0
20	20695829	.	A	T	22	29	51	0	0	52	1	0
20	20695856	.	A	T	21	22	43	0	1	44	0	0
20	20726287	.	G	T	28	31	59	0	1	60	0	0
20	20726291	.	G	A	2	29	31	0	31	62	0	0
20	20726966	.	T	C	28	35	63	0	4	67	0	0
20	20726993	.	C	A	28	30	58	0	5	63	0	0
20	20730008	.	C	G	26	33	59	0	3	62	0	0
20	20730061	.	C	G	25	24	49	0	3	52	0	0
20	20730141	.	A	T	21	18	39	0	0	39	0	0
20	20730151	.	G	A	15	17	32	0	5	37	0	0
20	20730182	.	T	A	10	11	21	0	0	21	0	0
20	20795897	.	G	A	1	3	4	0	0	4	0	0
20	20802754	.	C	A	5	4	9	0	2	11	0	0
20	20805438	.	T	C	7	9	16	0	0	16	0	0
20	20805643	.	G	C	0	10	10	0	11	21	0	0
20	20805690	.	C	T	6	9	15	0	0	15	0	0
20	20807987	.	C	T	9	4	13	0	2	15	0	0
20	20809666	.	T	C	13	4	17	0	0	17	0	0
20	20812728	.	T	C	18	16	34	0	2	36	0	0
20	20812852	.	C	A	6	18	24	0	0	25	1	0
20	20812876	.	C	T	8	17	25	0	0	25	0	0
20	20812898	.	T	C	11	12	23	0	2	26	1	0
20	20813014	.	G	A	13	9	22	0	2	24	0	0
20	20813033	.	A	G	14	0	14	0	12	26	0	0
20	20813162	.	T	C	17	15	32	0	1	33	0	0
20	20813197	.	A	C	14	17	31	0	2	33	0	0
20	20813367	.	A	C	11	9	20	0	2	22	0	0
20	20813414	.	T	C	11	12	23	0	1	24	0	0
20	20813439	.	A	G	13	11	24	0	0	24	0	0
20	20813458	.	T	C	14	13	27	0	0	27	0	0
20	20813568	.	A	C	20	12	32	1	0	33	0	0
20	20813570	.	G	A	19	12	31	1	1	33	0	0
20	20813624	.	G	A	10	7	17	0	2	19	0	0
20	20813685	.	A	T	8	6	14	0	0	14	0	0
20	20816875	.	G	A	38	35	73	0	9	82	0	0
20	20817011	.	G	A	34	37	71	0	6	77	0	0
20	20817921	.	A	G	31	34	65	0	11	76	0	0
20	20818523	.	A	G	34	32	66	0	4	70	0	0
20	20897037	.	T	G	1	5	6	0	0	6	0	0
20	20897090	.	G	A	1	3	4	0	0	4	0	0
20	20898260	.	C	G	1	2	3	0	1	4	0	0
20	20899436	.	T	A	2	2	4	0	0	4	0	0
20	20902714	.	C	G	1	2	3	0	0	3	0	0
20	20928239	.	C	G	3	16	19	0	17	36	0	0
20	20928272	.	C	T	21	19	40	0	4	44	0	0
20	20930149	.	G	A	13	5	18	0	1	19	0	0
20	20930889	.	G	A	3	6	9	0	2	11	0	0
20	20931142	.	C	G	5	6	11	0	1	12	0	0
20	20948025	.	A	G	3	2	5	0	0	5	0	0
20	20980554	.	C	A	4	5	9	0	0	9	0	0
20	20980716	.	C	T	5	4	9	0	1	10	0	0
20	21015747	.	A	C	4	8	12	0	1	14	1	0
20	21341814	.	T	C	1	2	3	0	1	4	0	0
20	21465782	.	A	G	1	0	1	0	2	3	0	0
20	21465982	.	C	T	3	6	9	0	0	9	0	0
20	21467733	.	G	T	2	3	5	0	0	5	0	0
20	21473644	.	A	G	5	6	11	0	0	11	0	0
20	21473674	.	C	T	6	9	15	0	1	16	0	0
20	21473681	.	T	C	5	12	17	0	0	17	0	0
20	21474271	.	A	G	8	12	20	0	1	21	0	0
20	21474700	.	A	G	5	9	14	0	2	16	0	0
20	21474715	.	A	C	5	8	13	0	1	14	0	0
20	21475432	.	A	T	6	6	12	0	1	13	0	0
20	21638903	.	T	C	1	3	4	0	0	4	0	0
20	21815659	.	G	T	16	15	31	0	3	34	0	0
20	21815986	.	C	T	1	12	13	0	17	30	0	0
20	21816061	.	C	G	14	14	28	0	1	29	0	0
20	21819062	.	T	C	19	16	35	0	2	37	0	0
20	21828117	.	T	C	5	7	12	0	1	13	0	0
20	21839504	.	G	A	6	3	9	0	1	10	0	0
20	21841312	.	G	A	7	11	18	0	2	20	0	0
20	21841316	.	G	T	7	9	16	0	1	17	0	0
20	21855195	.	T	C	7	8	15	1	1	17	0	0
20	21862963	.	C	T	0	8	8	0	3	11	0	0
20	21862975	.	C	T	0	5	5	0	5	10	0	0
20	21875111	.	G	A	2	4	6	0	0	6	0	0
20	21875162	.	G	A	4	4	8	0	0	8	0	0
20	21875165	.	T	G	4	4	8	0	0	8	0	0
20	22053358	.	T	C	4	10	14	0	0	14	0	0
20	23471985	.	G	A	1	5	6	0	0	6	0	0
20	23647925	.	G	C	2	2	4	0	0	4	0	0
20	23647927	.	A	C	2	2	4	0	0	4	0	0
20	23705743	.	A	T	11	3	14	1	0	15	0	0
20	24818673	.	G	A	14	14	28	0	4	32	0	0
20	24818922	.	T	C	20	11	31	0	2	33	0	0
20	24819184	.	G	A	2	3	5	0	2	7	0	0
20	24819582	.	C	T	1	14	15	0	16	31	0	0
20	24820032	.	T	C	4	4	8	0	2	10	0	0
20	24820383	.	T	C	4	4	8	1	6	15	0	0
20	24820405	.	G	A	8	8	16	1	1	18	0	0
20	24820566	.	A	T	4	5	9	0	0	9	0	0
20	24821023	.	T	G	8	6	14	0	1	15	0	0
20	24821094	.	C	T	1	4	5	0	10	15	0	0
20	24821604	.	G	A	2	5	7	0	1	8	0	0
20	24841039	.	G	A	2	2	4	0	1	5	0	0
20	24849453	.	C	T	0	3	3	0	2	5	0	0
20	25269827	.	T	A	1	2	3	0	1	4	0	0
20	25342837	.	G	A	1	5	6	0	9	15	0	0
20	25354604	.	G	C	4	4	8	0	1	9	0	0
20	25355725	.	C	A	5	3	8	0	1	9	0	0
20	25368785	.	A	G	3	3	6	0	1	7	0	0
20	25374871	.	A	G	3	3	6	0	0	6	0	0
20	25374908	.	G	A	4	2	6	0	1	7	0	0
20	25374912	.	G	A	6	2	8	0	0	8	0	0
20	25374965	.	G	T	5	3	8	0	0	8	0	0
20	25378556	.	C	T	0	3	3	0	1	4	0	0
20	25378787	.	C	A	2	4	6	0	0	6	0	0
20	25379771	.	T	C	5	3	8	0	0	8	0	0
20	25384473	.	A	T	4	4	8	0	0	8	0	0
20	25385938	.	A	C	2	2	4	0	1	5	0	0
20	25387931	.	T	C	6	7	13	0	0	13	0	0
20	25387940	.	A	C	6	1	7	0	6	13	0	0
20	25440607	.	A	G	4	6	10	0	0	10	0	0
20	25440628	.	T	G	5	5	10	0	0	10	0	0
20	25440648	.	C	G	6	7	13	0	0	13	0	0
20	25440731	.	G	A	7	10	17	0	0	17	0	0
20	25444903	.	G	A	6	3	9	0	0	9	0	0
20	25444943	.	G	A	4	3	7	0	1	8	0	0
20	25445182	.	A	T	12	7	19	0	0	19	0	0
20	25445213	.	C	T	4	7	11	0	0	11	0	0
20	25489625	.	C	T	1	2	3	0	0	3	0	0
20	25510798	.	C	T	5	4	9	0	2	11	0	0
20	25567532	.	T	A	0	2	2	0	1	3	0	0
20	25567535	.	A	G	1	2	3	0	0	3	0	0
20	25568000	.	G	T	1	3	4	0	0	4	0	0
20	25568779	.	G	A	1	3	4	0	0	4	0	0
20	25927310	.	A	G	13	12	25	0	1	26	0	0
20	26023822	.	T	C	2	7	9	0	0	9	0	0
20	26315894	.	T	C	4	5	9	0	0	9	0	0
20	26907743	.	G	A	4	4	8	0	0	8	0	0
20	26907806	.	T	C	7	7	14	0	0	14	0	0
20	26944090	.	C	T	12	11	23	0	1	24	0	0
20	26944762	.	C	A	3	17	20	0	1	21	0	0
20	26944951	.	C	T	5	5	10	0	0	10	0	0
20	26944971	.	G	A	7	7	14	0	0	14	0	0
20	26945115	.	A	T	2	8	10	0	2	12	0	0
20	26945394	.	C	T	8	11	19	0	0	19	0	0
20	26945793	.	T	A	17	5	22	1	1	24	0	0
20	26945950	.	T	A	12	10	22	0	2	24	0	0
20	26948002	.	T	G	1	5	6	0	0	6	0	0
20	26958653	.	C	A	7	3	10	0	0	10	0	0
20	26959572	.	C	T	5	3	8	0	0	8	0	0
20	26959900	.	G	A	0	6	6	0	8	14	0	0
20	26959902	.	G	C	8	6	14	0	1	15	0	0
20	26959955	.	A	C	5	2	7	0	1	8	0	0
20	26960001	.	A	T	4	6	10	0	0	10	0	0
20	26960102	.	T	C	7	7	14	0	0	14	0	0
20	26960220	.	C	A	7	7	14	0	1	15	0	0
20	26960430	.	C	T	1	7	8	0	0	8	0	0
20	26960580	.	G	A	2	9	11	0	1	12	0	0
20	26960843	.	C	T	9	8	17	1	0	18	0	0
20	26960877	.	G	A	0	4	4	1	8	13	0	0
20	26961353	.	G	A	4	4	8	0	1	9	0	0
20	26961419	.	A	T	6	8	14	0	1	15	0	0
20	26961469	.	A	G	9	6	15	0	2	17	0	0
20	26961643	.	C	T	3	2	5	0	0	5	0	0
20	26961655	.	A	T	4	1	5	0	2	7	0	0
20	26961694	.	A	T	7	2	9	0	0	9	0	0
20	26961862	.	T	C	10	10	20	0	0	20	0	0
20	26962057	.	A	G	14	0	14	0	10	24	0	0
20	26962077	.	G	A	0	14	14	0	12	27	1	0
20	26962225	.	T	A	17	11	28	0	2	30	0	0
20	26962318	.	G	A	3	9	12	0	6	18	0	0
20	27001864	.	T	A	11	8	19	0	0	19	0	0
20	27001867	.	C	T	10	8	18	0	0	18	0	0
20	27001903	.	C	T	11	12	23	0	1	24	0	0
20	27001915	.	T	C	12	10	22	0	2	24	0	0
20	27002007	.	A	G	8	3	11	0	0	11	0	0
20	27002175	.	T	G	5	11	16	0	0	16	0	0
20	27002595	.	T	G	9	6	15	0	1	16	0	0
20	27002769	.	T	A	5	2	7	0	1	8	0	0
20	27002778	.	A	G	4	2	6	0	0	6	0	0
20	27002989	.	G	A	3	9	12	0	1	13	0	0
20	27021593	.	C	A	16	13	29	0	2	31	0	0
20	27039339	.	A	C	35	24	59	0	2	61	0	0
20	27039400	.	G	A	32	31	63	0	1	64	0	0
20	27039523	.	C	T	23	30	53	0	2	55	0	0
20	27039550	.	A	T	21	29	50	0	1	51	0	0
20	27039577	.	C	T	29	19	48	0	2	50	0	0
20	27045501	.	G	A	32	25	57	0	1	58	0	0
20	27045703	.	A	G	19	29	48	0	4	52	0	0
20	27045719	.	T	C	15	22	37	0	3	40	0	0
20	27045858	.	T	A	11	10	21	0	0	21	0	0
20	27087600	.	T	A	6	9	15	0	0	15	0	0
20	27089281	.	C	T	3	4	7	0	1	8	0	0
20	27089613	.	T	C	1	2	3	0	1	4	0	0
20	27089674	.	A	G	2	4	6	0	2	8	0	0
20	27089954	.	G	A	3	4	7	0	1	8	0	0
20	27089995	.	C	T	2	4	6	0	0	6	0	0
20	27090340	.	A	G	2	7	9	0	0	9	0	0
20	27090409	.	C	T	4	5	9	0	1	10	0	0
20	27090551	.	A	T	1	4	5	0	0	5	0	0
20	27091064	.	G	A	3	5	8	0	0	8	0	0
20	27091206	.	G	A	10	6	16	0	0	16	0	0
20	27092182	.	C	T	13	5	18	0	1	19	0	0
20	27092231	.	C	T	16	11	27	0	2	29	0	0
20	27092245	.	A	G	15	10	25	0	0	25	0	0
20	27093198	.	A	T	1	2	3	0	1	4	0	0
20	27093219	.	T	C	3	2	5	0	0	5	0	0
20	27093269	.	G	C	2	2	4	0	0	4	0	0
20	27093335	.	G	A	4	8	12	0	1	13	0	0
20	27094615	.	A	G	0	3	3	0	1	4	0	0
20	27094624	.	C	T	1	6	7	0	0	7	0	0
20	27096400	.	C	A	10	6	16	0	0	16	0	0
20	27096469	.	G	T	0	8	8	0	11	19	0	0
20	27100005	.	T	C	10	7	17	0	0	17	0	0
20	27100011	.	A	T	8	8	16	0	0	16	0	0
20	27102325	.	C	T	4	6	10	0	0	10	0	0
20	27104562	.	C	T	13	10	23	0	1	24	0	0
20	27107089	.	C	T	10	5	15	0	0	15	0	0
20	27107140	.	C	A	8	9	17	0	0	17	0	0
20	27107173	.	A	C	12	12	24	0	2	26	0	0
20	27107545	.	G	T	0	6	6	0	5	11	0	0
20	27197849	.	A	T	1	2	3	0	0	3	0	0
20	27197862	.	A	G	0	2	2	0	1	3	0	0
20	27280859	.	C	G	1	0	1	0	4	5	0	0
20	27280877	.	C	A	2	6	8	0	0	8	0	0
20	27281203	.	A	G	2	2	4	0	0	4	0	0
20	27281295	.	T	A	1	4	5	0	0	5	0	0
20	27281678	.	A	C	8	7	15	1	0	17	1	0
20	27281827	.	C	G	3	2	5	2	1	8	0	0
20	27281833	.	G	A	4	3	7	2	0	9	0	0
20	27282340	.	A	C	3	4	7	0	0	7	0	0
20	27282561	.	T	C	8	8	16	0	0	16	0	0
20	27282598	.	T	A	3	7	10	0	2	12	0	0
20	27282788	.	C	A	3	4	7	0	1	8	0	0
20	27283404	.	A	C	3	9	12	0	0	12	0	0
20	27283604	.	G	A	9	4	13	0	0	13	0	0
20	27353250	.	G	A	2	11	13	0	0	13	0	0
20	27353265	.	C	T	2	13	15	0	0	15	0	0
20	27353982	.	A	G	5	9	14	0	1	15	0	0
20	27358859	.	G	A	11	8	19	0	1	20	0	0
20	27366122	.	G	A	8	4	12	0	3	15	0	0
20	27366597	.	T	G	12	12	24	0	0	24	0	0
20	27368882	.	A	C	21	9	30	0	1	31	0	0
20	27370340	.	G	A	17	20	37	0	0	37	0	0
20	27396384	.	T	A	8	8	16	0	0	16	0	0
20	27396385	.	A	T	8	8	16	0	0	16	0	0
20	27396478	.	A	T	10	12	22	0	0	22	0	0
20	27396489	.	C	T	9	10	19	0	1	20	0	0
20	27542951	.	A	G	2	4	6	0	0	6	0	0
20	27546032	.	C	T	3	5	8	0	0	8	0	0
20	27546071	.	A	G	1	5	6	0	0	6	0	0
20	27549217	.	A	G	2	5	7	0	0	7	0	0
20	27550104	.	G	T	2	2	4	0	0	4	0	0
20	27550856	.	T	G	2	0	2	0	2	4	0	0
20	27550866	.	G	A	1	3	4	0	0	4	0	0
20	27550959	.	G	A	2	5	7	0	0	7	0	0
20	27551113	.	A	T	4	4	8	0	0	8	0	0
20	27551123	.	G	T	4	10	14	0	1	15	0	0
20	27551329	.	A	G	4	7	11	0	0	11	0	0
20	27551363	.	G	A	3	6	9	0	0	9	0	0
20	27551492	.	C	G	2	2	4	0	0	4	0	0
20	27551624	.	C	T	3	6	9	0	1	10	0	0
20	27552286	.	G	T	2	1	3	0	1	4	0	0
20	27708306	.	A	G	4	6	10	0	1	11	0	0
20	27717493	.	A	G	1	6	7	0	0	7	0	0
20	27718091	.	G	A	2	3	5	0	1	6	0	0
20	27718097	.	A	T	3	3	6	0	0	6	0	0
20	27718418	.	A	C	5	2	7	0	0	8	1	0
20	27718549	.	T	A	2	4	6	2	1	9	0	0
20	27718824	.	C	G	2	4	6	0	0	6	0	0
20	27718834	.	G	T	2	4	6	0	0	6	0	0
20	27719088	.	A	G	1	4	5	1	1	7	0	0
20	27719602	.	T	C	2	2	4	0	1	5	0	0
20	27719693	.	C	T	4	8	12	0	1	13	0	0
20	27719713	.	G	A	5	7	12	0	1	13	0	0
20	27719859	.	T	C	11	3	14	0	1	15	0	0
20	27719869	.	T	A	11	5	16	0	0	16	0	0
20	27732628	.	A	G	5	3	8	0	0	8	0	0
20	27732688	.	A	T	11	4	15	0	0	15	0	0
20	27732832	.	A	G	4	3	7	0	1	8	0	0
20	27732879	.	C	T	1	4	5	0	4	9	0	0
20	27732911	.	T	A	4	3	7	0	1	8	0	0
20	27733009	.	C	T	1	4	5	0	4	9	0	0
20	27733568	.	C	T	6	3	9	0	0	9	0	0
20	27733686	.	C	A	0	3	3	0	2	5	0	0
20	27822132	.	A	G	4	3	7	0	1	8	0	0
20	28252152	.	G	T	1	4	5	0	1	6	0	0
20	28252167	.	A	G	1	3	4	0	0	4	0	0
20	28253930	.	A	C	8	6	14	0	0	14	0	0
20	28254141	.	A	G	6	2	8	0	0	8	0	0
20	28267512	.	A	T	28	24	52	0	6	58	0	0
20	28268623	.	T	C	38	22	60	0	1	61	0	0
20	28268828	.	A	G	32	2	34	0	32	66	0	0
20	28268888	.	C	T	37	26	63	0	0	64	1	0
20	28269024	.	A	T	30	26	56	0	1	57	0	0
20	28269165	.	G	A	27	17	44	0	3	47	0	0
20	28269181	.	C	T	27	23	50	0	1	51	0	0
20	28269210	.	A	G	24	0	24	0	23	47	0	0
20	28269219	.	A	C	25	21	46	0	2	48	0	0
20	28269355	.	T	C	31	25	56	0	9	65	0	0
20	28269418	.	T	G	19	10	29	0	0	29	0	0
20	28269958	.	T	A	2	2	4	0	0	4	0	0
20	28270049	.	A	G	1	2	3	0	2	5	0	0
20	28270416	.	A	G	3	3	6	0	1	7	0	0
20	28270442	.	A	G	4	5	9	0	0	9	0	0
20	28270474	.	G	T	5	5	10	0	0	10	0	0
20	28270493	.	C	T	1	2	3	0	4	7	0	0
20	28273541	.	C	T	0	6	6	1	1	8	0	0
20	28273631	.	A	G	3	3	6	0	0	6	0	0
20	28281578	.	C	G	5	3	8	0	0	8	0	0
20	28294732	.	G	T	3	3	6	0	0	6	0	0
20	28310920	.	A	G	1	7	8	0	0	8	0	0
20	28310979	.	C	A	2	5	7	0	0	7	0	0
20	28316845	.	G	T	4	2	6	0	2	8	0	0
20	28354951	.	A	G	10	5	15	0	0	15	0	0
20	28355029	.	C	T	4	7	11	0	2	13	0	0
20	28356989	.	T	C	6	4	10	0	0	10	0	0
20	28356998	.	G	A	5	3	8	0	0	8	0	0
20	28357055	.	G	T	6	5	11	0	0	11	0	0
20	28357184	.	A	G	2	6	8	0	2	10	0	0
20	28357190	.	C	T	2	7	9	0	0	9	0	0
20	28357253	.	C	T	5	6	11	0	0	11	0	0
20	28357570	.	A	G	5	4	9	0	1	10	0	0
20	28357580	.	G	A	5	6	11	0	0	11	0	0
20	28357610	.	A	G	6	6	12	0	0	12	0	0
20	28358114	.	G	A	0	2	2	0	1	3	0	0
20	28361249	.	G	T	1	2	3	0	0	3	0	0
20	28361289	.	G	T	0	2	2	0	1	3	0	0
20	28399987	.	C	A	0	5	5	0	5	10	0	0
20	28400232	.	A	T	4	3	7	0	0	7	0	0
20	28400390	.	C	T	0	5	5	0	3	8	0	0
20	28400422	.	C	T	8	4	12	0	0	12	0	0
20	28400455	.	A	C	9	5	14	0	0	14	0	0
20	28400506	.	T	A	11	11	22	0	0	22	0	0
20	28400704	.	A	G	15	10	25	0	3	28	0	0
20	28400783	.	C	A	10	7	17	0	0	17	0	0
20	28400823	.	T	C	9	7	16	0	0	16	0	0
20	28400945	.	C	G	6	7	13	0	1	14	0	0
20	28401066	.	A	T	8	4	12	0	0	12	0	0
20	28401084	.	C	G	8	6	14	0	0	14	0	0
20	28401147	.	A	G	9	12	21	0	3	24	0	0
20	28401232	.	T	A	4	8	12	1	0	13	0	0
20	28401268	.	G	T	4	6	10	1	0	11	0	0
20	28401793	.	A	G	1	1	2	0	0	2	0	0
20	28402067	.	T	C	3	2	5	0	0	5	0	0
20	28409601	.	C	T	3	2	5	0	0	5	0	0
20	28412846	.	C	T	1	3	4	0	0	4	0	0
20	28413925	.	C	T	5	4	9	0	1	10	0	0
20	28414423	.	T	C	6	4	10	0	0	10	0	0
20	28417175	.	G	C	4	3	7	0	1	8	0	0
20	28417184	.	G	A	3	3	6	0	1	7	0	0
20	28418494	.	T	A	6	3	9	0	2	11	0	0
20	28418503	.	C	T	5	5	10	0	0	10	0	0
20	28418550	.	A	G	1	2	3	0	0	3	0	0
20	28418587	.	C	T	1	4	5	0	1	6	0	0
20	28418939	.	T	C	5	8	13	0	1	14	0	0
20	28418951	.	T	A	7	8	15	0	0	15	0	0
20	28419015	.	A	T	10	8	18	0	0	18	0	0
20	28419133	.	A	T	2	2	4	0	1	5	0	0
20	28419755	.	G	C	1	2	3	0	1	4	0	0
20	28419831	.	T	C	7	5	12	0	0	13	1	0
20	28420234	.	T	A	5	11	16	0	0	16	0	0
20	28420361	.	C	T	8	8	16	0	2	18	0	0
20	28420522	.	G	A	3	10	13	0	0	13	0	0
20	28422842	.	C	A	4	2	6	0	0	6	0	0
20	28422854	.	C	G	2	4	6	0	0	6	0	0
20	28422920	.	A	G	2	4	6	0	2	8	0	0
20	28422927	.	T	C	3	0	3	0	4	7	0	0
20	28423035	.	G	T	4	8	12	0	1	13	0	0
20	28456574	.	T	C	3	7	10	0	1	11	0	0
20	28456616	.	C	T	4	5	9	0	0	9	0	0
20	28469934	.	G	A	4	7	11	0	2	13	0	0
20	28469982	.	A	G	6	6	12	0	0	12	0	0
20	28470057	.	T	C	3	3	6	0	0	6	0	0
20	28476107	.	T	C	3	5	8	0	0	8	0	0
20	28487287	.	T	C	4	6	10	0	0	10	0	0
20	28514822	.	G	C	5	0	5	0	4	9	0	0
20	28514878	.	T	C	5	5	10	0	0	10	0	0
20	28537376	.	G	T	2	2	4	0	1	5	0	0
20	28611658	.	C	T	1	4	5	0	0	5	0	0
20	28650328	.	A	C	21	14	35	0	1	36	0	0
20	28650945	.	A	T	15	16	31	0	2	33	0	0
20	28650946	.	T	G	12	14	26	0	7	33	0	0
20	28650980	.	T	C	15	18	33	0	2	35	0	0
20	28651239	.	A	G	16	20	36	0	3	39	0	0
20	28651693	.	G	T	12	10	22	0	1	23	0	0
20	28652277	.	G	C	18	16	34	0	0	34	0	0
20	28652449	.	G	C	13	9	22	0	0	22	0	0
20	28652485	.	G	A	11	15	26	2	4	32	0	0
20	28652597	.	G	C	14	10	24	0	1	25	0	0
20	28658597	.	T	C	9	6	15	0	0	15	0	0
20	28658666	.	A	C	5	15	20	0	2	22	0	0
20	28659924	.	A	G	7	3	10	0	1	11	0	0
20	28660582	.	G	A	4	3	7	0	0	7	0	0
20	28660729	.	T	C	5	1	6	0	3	9	0	0
20	28660795	.	G	A	5	5	10	0	0	10	0	0
20	28660828	.	G	T	4	3	7	0	0	7	0	0
20	28660837	.	T	C	2	3	5	1	0	6	0	0
20	28834684	.	T	C	1	3	4	0	0	4	0	0
20	28870843	.	T	C	39	22	61	0	1	62	0	0
20	28886991	.	T	A	1	2	3	0	0	3	0	0
20	29216103	.	G	T	6	2	8	0	0	8	0	0
20	29268179	.	A	G	8	3	11	0	0	11	0	0
20	29268225	.	A	G	7	3	10	0	3	13	0	0
20	29268260	.	A	G	9	4	13	0	1	14	0	0
20	29269095	.	T	C	12	0	12	0	9	21	0	0
20	29274435	.	G	C	13	0	13	0	16	29	0	0
20	29274441	.	C	G	14	14	28	0	3	31	0	0
20	31746445	.	C	T	19	14	33	0	4	37	0	0
20	31746604	.	C	T	12	11	23	0	2	25	0	0
20	31746611	.	A	T	14	10	24	0	0	24	0	0
20	31747116	.	A	T	19	6	25	2	2	29	0	0
20	31747673	.	C	A	2	17	19	0	12	31	0	0
20	31747792	.	C	T	1	6	7	0	16	23	0	0
20	31747860	.	C	T	2	9	11	2	14	27	0	0
20	31747984	.	C	T	10	6	16	0	0	16	0	0
20	31747988	.	A	C	10	4	14	0	1	15	0	0
20	31748032	.	G	T	7	5	12	0	0	12	0	0
20	31748124	.	T	C	13	0	13	0	11	24	0	0
20	31748178	.	T	C	12	16	28	0	0	28	0	0
20	31748363	.	A	G	12	8	20	0	2	22	0	0
20	31748431	.	A	G	14	4	18	0	1	19	0	0
20	31748448	.	A	C	9	7	16	0	0	16	0	0
20	31748961	.	T	C	7	0	7	0	0	7	0	0
20	31749207	.	C	T	3	7	10	0	8	18	0	0
20	32016477	.	G	A	1	2	3	0	0	3	0	0
20	32047448	.	T	A	11	8	19	0	0	19	0	0
20	32047546	.	C	T	11	10	21	0	1	22	0	0
20	32047640	.	T	A	14	17	31	0	3	34	0	0
20	32047741	.	A	C	16	22	38	0	0	38	0	0
20	32048117	.	A	G	22	5	27	0	4	31	0	0
20	32048369	.	T	A	13	17	30	0	3	33	0	0
20	32049056	.	G	T	14	11	25	0	1	26	0	0
20	32049178	.	G	T	21	10	31	0	2	33	0	0
20	32052708	.	G	A	17	10	27	0	0	27	0	0
20	32052873	.	C	T	2	11	13	0	13	26	0	0
20	32053122	.	G	A	6	6	12	0	0	12	0	0
20	32065517	.	G	A	4	2	6	0	0	6	0	0
20	32065650	.	C	T	4	3	7	0	0	7	0	0
20	32071416	.	G	A	4	2	6	0	0	6	0	0
20	32118621	.	G	A	2	2	4	0	0	4	0	0
20	32121325	.	C	T	5	2	7	0	1	8	0	0
20	32135154	.	T	A	4	6	10	0	0	10	0	0
20	32135666	.	C	T	6	6	12	0	1	13	0	0
20	32135673	.	T	C	6	6	12	0	1	13	0	0
20	32136921	.	G	A	3	7	10	0	0	10	0	0
20	32137423	.	G	A	3	2	5	0	1	6	0	0
20	32137638	.	A	G	8	13	21	0	1	22	0	0
20	32137866	.	C	T	13	8	21	0	0	21	0	0
20	32137886	.	C	T	12	7	19	0	2	21	0	0
20	32138111	.	C	T	8	13	21	0	1	22	0	0
20	32138127	.	C	T	18	10	28	0	0	28	0	0
20	32138305	.	T	C	10	9	19	0	2	21	0	0
20	32138360	.	T	C	17	9	26	0	1	27	0	0
20	32138400	.	A	G	23	5	28	0	0	28	0	0
20	32138478	.	A	G	15	17	32	0	2	34	0	0
20	32138692	.	G	A	18	15	33	0	1	34	0	0
20	32138754	.	T	C	17	14	31	0	2	33	0	0
20	32138828	.	C	T	23	19	42	0	5	47	0	0
20	32138965	.	A	T	6	6	12	0	0	12	0	0
20	32138977	.	G	A	2	5	7	0	3	10	0	0
20	32141838	.	G	A	2	3	5	0	0	5	0	0
20	32225711	.	G	A	5	4	9	0	2	11	0	0
20	32226995	.	G	T	8	5	13	0	0	13	0	0
20	32227025	.	C	T	7	8	15	0	0	15	0	0
20	32227268	.	G	A	10	8	18	0	1	19	0	0
20	32228872	.	A	G	13	22	35	0	3	38	0	0
20	32229047	.	G	A	23	12	35	0	1	36	0	0
20	32230017	.	A	C	18	18	36	0	1	37	0	0
20	32230205	.	T	G	23	2	25	0	13	38	0	0
20	32230362	.	C	A	14	8	22	0	2	24	0	0
20	32230470	.	T	C	19	10	29	0	0	29	0	0
20	32230472	.	A	C	21	10	31	0	0	31	0	0
20	32230518	.	C	A	25	11	36	0	0	36	0	0
20	32230521	.	G	A	5	13	18	0	21	39	0	0
20	32230555	.	C	A	17	14	31	0	3	34	0	0
20	32230574	.	T	A	20	17	37	0	1	38	0	0
20	32230592	.	T	A	14	15	29	0	3	32	0	0
20	32230680	.	A	G	13	16	29	0	2	31	0	0
20	32230720	.	C	G	8	18	26	0	1	27	0	0
20	32230893	.	C	T	17	13	30	0	1	31	0	0
20	32230957	.	C	T	16	16	32	0	3	35	0	0
20	32286875	.	C	T	13	14	27	0	1	28	0	0
20	32287041	.	C	G	8	4	12	0	2	14	0	0
20	32287178	.	G	A	4	6	10	0	1	11	0	0
20	32287203	.	G	A	4	3	7	0	1	8	0	0
20	32287349	.	C	G	6	11	17	0	0	17	0	0
20	32287736	.	T	C	10	4	14	0	1	15	0	0
20	32288208	.	T	A	6	3	9	0	0	9	0	0
20	32290149	.	T	A	4	9	13	0	1	14	0	0
20	32290160	.	G	A	2	8	10	0	1	11	0	0
20	32290435	.	A	G	7	4	11	0	1	12	0	0
20	32290679	.	G	A	5	7	12	0	2	14	0	0
20	32290828	.	C	T	0	3	3	0	5	8	0	0
20	32331316	.	A	G	1	3	4	0	0	4	0	0
20	32331317	.	G	A	1	3	4	0	0	4	0	0
20	32337625	.	T	C	3	4	7	0	0	7	0	0
20	32337734	.	A	C	1	2	3	0	0	3	0	0
20	32339234	.	G	A	0	6	6	0	1	7	0	0
20	32348548	.	T	C	1	2	3	0	0	3	0	0
20	32406066	.	T	C	1	3	4	0	0	4	0	0
20	32432156	.	T	C	25	10	35	0	0	35	0	0
20	32432532	.	C	T	16	9	25	0	1	26	0	0
20	32438053	.	G	T	3	3	6	0	0	6	0	0
20	32438054	.	G	T	3	3	6	0	0	6	0	0
20	32484573	.	C	T	2	3	5	0	0	5	0	0
20	32484582	.	T	C	2	3	5	0	0	5	0	0
20	32487507	.	T	C	1	7	8	0	0	8	0	0
20	32490403	.	C	T	12	5	17	0	0	17	0	0
20	32490480	.	C	T	4	5	9	0	0	9	0	0
20	32490894	.	G	A	5	3	8	0	0	8	0	0
20	32490980	.	T	C	2	3	5	0	0	5	0	0
20	32498335	.	C	T	2	3	5	0	0	5	0	0
20	32498517	.	C	T	2	4	6	0	0	6	0	0
20	32498690	.	C	T	2	3	5	0	0	5	0	0
20	32498869	.	A	G	1	4	5	0	1	6	0	0
20	32513987	.	G	A	5	9	14	0	0	14	0	0
20	32515968	.	C	T	7	10	17	0	0	17	0	0
20	32518298	.	T	C	1	1	2	0	0	2	0	0
20	32518306	.	G	A	1	2	3	0	0	3	0	0
20	32520330	.	T	C	13	10	23	0	1	24	0	0
20	32520461	.	G	A	5	8	13	0	2	15	0	0
20	32520779	.	A	G	8	6	14	0	1	15	0	0
20	32520899	.	A	T	4	4	8	0	2	10	0	0
20	32521048	.	A	T	9	7	16	0	3	19	0	0
20	32521175	.	T	A	21	16	37	0	0	37	0	0
20	32521186	.	T	C	20	13	33	0	1	34	0	0
20	32521220	.	T	C	12	16	28	1	2	31	0	0
20	32521266	.	T	G	19	8	27	1	2	30	0	0
20	32521488	.	T	C	11	8	19	0	4	23	0	0
20	32521517	.	A	T	12	14	26	0	5	31	0	0
20	32521534	.	T	A	16	13	29	0	1	30	0	0
20	32521605	.	G	A	19	12	31	0	4	35	0	0
20	32521618	.	T	C	23	15	38	0	1	39	0	0
20	32521719	.	A	C	22	8	30	0	4	34	0	0
20	32838695	.	C	A	2	1	3	0	1	4	0	0
20	32838710	.	A	T	2	2	4	0	0	4	0	0
20	32863413	.	A	G	2	3	5	0	0	5	0	0
20	32948512	.	G	A	2	2	4	0	0	4	0	0
20	33177904	.	C	T	6	4	10	0	0	10	0	0
20	33180111	.	T	C	4	7	11	0	0	11	0	0
20	33294503	.	A	T	4	6	10	1	0	11	0	0
20	33295692	.	T	A	10	4	14	0	1	15	0	0
20	33487238	.	C	T	1	3	4	0	0	4	0	0
20	33494027	.	C	A	15	8	23	0	0	23	0	0
20	33494165	.	A	G	14	14	28	0	1	29	0	0
20	33497087	.	A	T	6	4	10	0	0	10	0	0
20	33529425	.	C	T	1	3	4	0	0	4	0	0
20	33583700	.	T	A	1	2	3	0	0	3	0	0
20	33729262	.	A	G	1	2	3	0	0	3	0	0
20	33748745	.	G	A	2	2	4	0	1	5	0	0
20	33758874	.	C	T	7	4	11	0	0	11	0	0
20	33759043	.	T	C	2	4	6	0	3	9	0	0
20	33759067	.	C	T	1	5	6	0	5	11	0	0
20	33763208	.	G	A	3	8	11	0	0	11	0	0
20	33773493	.	G	A	6	5	11	0	0	11	0	0
20	33809476	.	T	C	3	2	5	0	0	5	0	0
20	33809707	.	A	G	15	13	28	0	1	29	0	0
20	33809783	.	C	A	9	14	23	0	1	24	0	0
20	33809846	.	G	C	19	15	34	0	1	35	0	0
20	33809927	.	T	A	13	12	25	0	2	27	0	0
20	33809971	.	C	A	8	9	17	0	2	19	0	0
20	33810274	.	T	G	5	2	7	0	1	8	0	0
20	33810310	.	T	A	2	3	5	0	1	6	0	0
20	33810496	.	G	A	3	2	5	0	3	8	0	0
20	33810921	.	T	C	6	0	6	0	18	24	0	0
20	33811400	.	A	T	3	2	5	0	0	5	0	0
20	33811435	.	G	A	3	4	7	0	0	7	0	0
20	33811436	.	C	A	2	4	6	0	0	6	0	0
20	33811519	.	G	T	12	9	21	0	0	21	0	0
20	33811574	.	G	T	9	8	17	0	1	18	0	0
20	33831964	.	A	C	9	0	9	0	5	14	0	0
20	33840638	.	T	C	7	3	10	0	0	10	0	0
20	33856373	.	T	C	4	2	6	0	1	7	0	0
20	33856416	.	A	T	2	4	6	0	0	6	0	0
20	33856421	.	T	C	2	4	6	0	0	6	0	0
20	33860144	.	G	A	3	2	5	0	0	5	0	0
20	33860147	.	G	A	4	2	6	0	1	7	0	0
20	33982016	.	G	A	12	3	15	0	0	15	0	0
20	33984086	.	G	C	9	10	19	0	2	21	0	0
20	34007128	.	G	A	2	3	5	0	0	5	0	0
20	34008178	.	C	A	5	3	8	0	0	8	0	0
20	34009919	.	G	A	1	8	9	0	4	13	0	0
20	34012790	.	T	A	5	6	11	0	2	13	0	0
20	34012798	.	T	C	5	8	13	0	2	15	0	0
20	34012837	.	A	T	10	11	21	0	0	21	0	0
20	34012885	.	G	A	11	8	19	0	1	20	0	0
20	34013073	.	T	G	10	11	21	0	1	22	0	0
20	34015654	.	C	T	2	5	7	0	14	21	0	0
20	34015845	.	C	T	9	6	15	0	2	17	0	0
20	34018783	.	C	T	4	7	11	0	1	12	0	0
20	34020861	.	T	A	2	5	7	0	0	7	0	0
20	34020891	.	G	A	4	5	9	0	1	10	0	0
20	34039390	.	G	A	2	4	6	0	1	7	0	0
20	34040132	.	C	A	19	10	29	0	3	32	0	0
20	34044813	.	G	A	9	12	21	0	0	21	0	0
20	34049024	.	T	C	3	0	3	0	2	5	0	0
20	34051237	.	C	T	7	8	15	0	0	15	0	0
20	34056162	.	A	G	7	3	10	0	0	10	0	0
20	34056206	.	C	G	5	3	8	0	0	8	0	0
20	34056656	.	A	G	4	3	7	0	2	9	0	0
20	34057323	.	C	A	3	5	8	0	0	8	0	0
20	34059259	.	C	T	5	3	8	0	0	8	0	0
20	34061784	.	C	T	1	2	3	0	0	3	0	0
20	34063974	.	T	A	1	2	3	0	0	3	0	0
20	34065620	.	G	A	1	2	3	0	0	3	0	0
20	34151818	.	C	A	5	6	11	0	2	13	0	0
20	34151873	.	C	T	6	7	13	0	0	13	0	0
20	34153975	.	G	A	7	7	14	0	1	15	0	0
20	34154076	.	C	T	3	4	7	0	1	8	0	0
20	34154619	.	C	A	9	5	14	0	6	20	0	0
20	34154982	.	G	T	16	7	23	0	0	23	0	0
20	34155192	.	T	C	6	12	18	0	0	18	0	0
20	34332683	.	C	A	11	13	24	0	2	26	0	0
20	34333733	.	T	C	14	8	22	0	2	24	0	0
20	34338371	.	T	C	4	8	12	0	0	12	0	0
20	34338884	.	G	A	0	16	16	0	22	38	0	0
20	34339786	.	T	A	19	32	51	0	6	57	0	0
20	34340047	.	C	T	28	22	50	0	5	55	0	0
20	34340176	.	G	A	2	28	30	0	22	52	0	0
20	34340200	.	C	T	15	25	40	0	5	45	0	0
20	34340520	.	T	C	27	16	43	0	6	49	0	0
20	34340675	.	A	C	16	25	41	0	2	43	0	0
20	34340678	.	A	T	25	16	41	0	2	43	0	0
20	34341000	.	C	T	17	22	39	0	1	40	0	0
20	34343953	.	G	C	2	2	4	0	0	4	0	0
20	34364936	.	A	G	2	5	7	0	2	9	0	0
20	34364991	.	C	T	7	3	10	0	0	10	0	0
20	34365095	.	T	A	6	5	11	0	0	11	0	0
20	34368191	.	A	C	3	4	7	0	0	7	0	0
20	34368274	.	G	A	1	3	4	0	0	4	0	0
20	34372821	.	A	T	2	2	4	0	0	4	0	0
20	34383313	.	C	G	1	2	3	0	0	3	0	0
20	34383322	.	T	C	1	2	3	0	0	3	0	0
20	34420823	.	A	G	24	21	45	0	0	45	0	0
20	34420860	.	A	G	28	16	44	0	3	47	0	0
20	34421155	.	C	T	23	16	39	0	2	41	0	0
20	34421159	.	G	A	25	19	44	0	0	44	0	0
20	34421672	.	G	A	18	10	28	0	2	30	0	0
20	34421701	.	T	C	16	10	26	0	3	29	0	0
20	34426660	.	T	G	15	14	29	0	5	34	0	0
20	34426759	.	A	C	17	12	29	0	4	33	0	0
20	34431337	.	G	A	13	5	18	0	1	19	0	0
20	34444945	.	T	C	4	4	8	0	0	8	0	0
20	34446718	.	G	A	2	3	5	0	0	5	0	0
20	34447025	.	A	G	2	2	4	0	1	5	0	0
20	34447049	.	G	A	3	2	5	0	0	6	1	0
20	34447522	.	T	C	5	2	7	0	0	7	0	0
20	34551222	.	A	G	3	3	6	0	1	7	0	0
20	34551246	.	G	A	7	2	9	0	1	10	0	0
20	34592483	.	C	T	2	3	5	0	0	5	0	0
20	34593729	.	G	A	3	3	6	0	0	6	0	0
20	34596468	.	A	T	3	3	6	0	0	6	0	0
20	34597127	.	C	T	4	3	7	0	0	7	0	0
20	34597244	.	A	G	7	7	14	0	1	15	0	0
20	34597292	.	G	A	3	8	11	0	1	12	0	0
20	34597631	.	C	T	10	4	14	0	2	17	1	0
20	34598076	.	T	A	4	11	15	0	0	15	0	0
20	34601127	.	A	G	19	13	32	0	2	34	0	0
20	34601175	.	G	A	16	13	29	0	6	35	0	0
20	34601214	.	A	T	17	15	32	0	0	32	0	0
20	34602340	.	C	T	13	16	29	0	1	30	0	0
20	34602576	.	T	G	14	17	31	0	0	31	0	0
20	34603575	.	G	T	16	9	25	0	0	25	0	0
20	34603661	.	C	T	15	17	32	0	1	33	0	0
20	34604241	.	C	A	21	23	44	0	0	44	0	0
20	34607970	.	C	T	9	5	14	0	1	15	0	0
20	34608194	.	C	T	6	17	23	0	0	23	0	0
20	34608272	.	T	C	6	6	12	0	0	12	0	0
20	34608404	.	T	G	10	6	16	0	0	16	0	0
20	34608458	.	A	C	8	10	18	0	1	19	0	0
20	34608519	.	T	C	4	6	10	0	1	11	0	0
20	34617729	.	G	A	2	3	5	0	0	5	0	0
20	34617780	.	A	T	2	3	5	0	0	5	0	0
20	34630192	.	T	C	7	10	17	1	0	18	0	0
20	34630381	.	C	T	6	4	10	0	0	10	0	0
20	34630861	.	C	T	4	4	8	0	1	9	0	0
20	34632577	.	T	C	7	6	13	0	0	13	0	0
20	34632587	.	C	T	6	3	9	0	2	11	0	0
20	34632864	.	C	A	4	7	11	0	2	13	0	0
20	34634979	.	T	C	5	8	13	0	0	13	0	0
20	34634988	.	T	C	5	7	12	0	0	12	0	0
20	34636529	.	A	T	8	9	17	0	1	18	0	0
20	34636536	.	G	A	7	8	15	0	0	15	0	0
20	34638185	.	A	G	10	0	10	0	5	15	0	0
20	34638235	.	G	A	1	7	8	0	7	15	0	0
20	34638251	.	G	A	8	8	16	0	0	16	0	0
20	34642805	.	A	G	5	8	13	0	0	13	0	0
20	34642931	.	G	A	3	5	8	0	2	10	0	0
20	34643007	.	A	G	7	10	17	0	3	20	0	0
20	34643051	.	T	C	9	13	22	0	0	22	0	0
20	34643054	.	A	G	10	12	22	0	0	22	0	0
20	34643163	.	A	G	10	11	21	0	0	21	0	0
20	34643386	.	A	T	3	2	5	0	1	6	0	0
20	34654142	.	A	T	2	3	5	0	0	5	0	0
20	34654167	.	G	A	2	7	9	0	1	10	0	0
20	34654180	.	C	T	4	4	8	0	0	9	1	0
20	34655902	.	G	C	4	0	4	0	3	7	0	0
20	34695326	.	C	T	7	7	14	0	0	14	0	0
20	34696329	.	A	C	4	7	11	0	1	12	0	0
20	34696628	.	A	T	5	6	11	0	0	11	0	0
20	34700135	.	G	T	5	5	10	0	0	10	0	0
20	34700237	.	G	T	0	4	4	0	7	11	0	0
20	34700238	.	T	C	6	5	11	0	0	11	0	0
20	34733259	.	A	G	6	0	6	0	9	15	0	0
20	34733553	.	C	A	6	10	16	0	0	16	0	0
20	34733752	.	C	T	8	16	24	1	1	26	0	0
20	34733819	.	G	A	8	7	15	1	1	17	0	0
20	34737818	.	A	G	4	6	10	0	0	10	0	0
20	34737886	.	T	A	5	9	14	0	0	14	0	0
20	34737920	.	C	A	7	4	11	0	0	11	0	0
20	34738198	.	G	A	29	10	39	0	2	41	0	0
20	34738272	.	A	G	25	12	37	0	0	37	0	0
20	34738314	.	G	A	13	21	34	0	3	37	0	0
20	34738397	.	G	T	10	9	19	0	1	20	0	0
20	34738756	.	A	G	11	9	20	0	1	21	0	0
20	34742840	.	G	A	13	12	25	0	0	25	0	0
20	34746019	.	G	A	15	12	27	0	0	27	0	0
20	34749672	.	G	A	9	9	18	0	1	19	0	0
20	34749747	.	G	A	10	9	19	0	1	20	0	0
20	34749754	.	C	T	10	9	19	0	1	20	0	0
20	34749793	.	C	T	8	6	14	0	1	15	0	0
20	34749794	.	A	G	8	7	15	0	0	15	0	0
20	34750025	.	G	C	15	3	18	0	1	19	0	0
20	34794939	.	C	T	34	27	61	0	4	65	0	0
20	34794988	.	C	G	32	25	57	0	5	62	0	0
20	34795111	.	C	A	38	31	69	0	9	78	0	0
20	34795126	.	A	G	35	36	71	0	4	75	0	0
20	34795221	.	A	T	43	22	65	0	3	69	1	0
20	34795418	.	G	C	40	19	59	0	5	64	0	0
20	34795559	.	C	T	6	34	40	0	28	68	0	0
20	34795631	.	T	G	49	18	67	0	3	70	0	0
20	34795689	.	C	T	37	45	82	0	6	88	0	0
20	34797252	.	G	T	38	39	77	1	1	79	0	0
20	34797532	.	C	A	35	23	58	0	4	62	0	0
20	34801164	.	C	T	1	3	4	0	0	4	0	0
20	34933209	.	C	A	34	34	68	6	6	80	0	0
20	34955791	.	C	T	36	31	67	1	7	75	0	0
20	34956159	.	A	T	15	7	22	0	0	22	0	0
20	34956164	.	T	A	15	7	22	0	0	22	0	0
20	34991739	.	T	A	3	8	11	0	0	11	0	0
20	34991776	.	G	A	5	4	9	0	1	10	0	0
20	34993974	.	G	A	2	2	4	0	0	4	0	0
20	35000029	.	C	T	2	4	6	0	0	6	0	0
20	35013931	.	G	C	1	4	5	0	0	5	0	0
20	35058727	.	T	A	7	5	12	0	0	12	0	0
20	35059085	.	G	A	1	7	8	0	6	14	0	0
20	35064521	.	G	A	17	17	34	0	1	35	0	0
20	35065345	.	G	A	3	12	15	0	20	35	0	0
20	35065588	.	G	A	22	20	42	0	2	44	0	0
20	35066821	.	G	A	3	13	16	0	35	51	0	0
20	35068702	.	T	C	18	19	37	3	3	43	0	0
20	35068730	.	T	A	10	0	10	4	16	30	0	0
20	35068765	.	A	T	8	13	21	2	7	30	0	0
20	35069756	.	A	G	16	17	33	0	4	37	0	0
20	35069928	.	C	T	15	25	40	0	2	42	0	0
20	35069963	.	A	C	21	21	42	0	0	42	0	0
20	35070176	.	C	T	18	19	37	0	0	37	0	0
20	35070340	.	C	T	12	15	27	0	4	31	0	0
20	35162012	.	T	G	1	2	3	0	0	3	0	0
20	35171257	.	C	T	3	3	6	0	1	7	0	0
20	35184527	.	T	A	1	4	5	0	0	5	0	0
20	35195185	.	G	A	2	6	8	0	6	14	0	0
20	35198110	.	A	G	5	5	10	0	0	10	0	0
20	35198116	.	G	A	5	6	11	0	0	11	0	0
20	35198780	.	G	A	1	5	6	0	5	11	0	0
20	35198810	.	A	C	5	4	9	0	0	9	0	0
20	35204668	.	C	T	6	6	12	0	1	13	0	0
20	35204773	.	C	T	4	12	16	0	0	16	0	0
20	35205061	.	C	T	5	14	19	0	0	19	0	0
20	35205182	.	T	C	3	4	7	0	1	8	0	0
20	35205361	.	T	A	2	2	4	0	0	4	0	0
20	35205552	.	T	G	2	0	2	0	7	9	0	0
20	35205600	.	A	T	6	7	13	0	0	13	0	0
20	35205626	.	T	G	9	0	9	0	7	16	0	0
20	35205772	.	T	A	9	7	16	0	1	17	0	0
20	35206023	.	G	A	16	6	22	0	1	23	0	0
20	35206101	.	A	T	4	8	12	1	2	15	0	0
20	35206272	.	T	C	4	5	9	0	0	9	0	0
20	35209012	.	G	A	8	4	12	0	0	12	0	0
20	35209080	.	T	A	7	6	13	1	2	16	0	0
20	35209405	.	C	T	12	14	26	0	2	28	0	0
20	35209625	.	G	A	8	13	21	0	1	22	0	0
20	35210047	.	T	C	15	0	15	0	9	24	0	0
20	35210175	.	C	A	14	15	29	0	1	30	0	0
20	35210176	.	T	C	16	0	16	0	15	31	0	0
20	35210212	.	G	T	12	14	26	0	0	26	0	0
20	35210282	.	T	C	5	0	5	0	13	18	0	0
20	35210306	.	T	C	10	5	15	0	0	15	0	0
20	35210538	.	C	G	7	3	10	0	1	11	0	0
20	35210575	.	C	T	6	5	11	0	0	11	0	0
20	35210649	.	A	G	10	4	14	0	0	14	0	0
20	35210853	.	A	T	5	4	9	0	1	10	0	0
20	35210909	.	T	C	5	3	8	0	0	8	0	0
20	35211062	.	A	G	2	4	6	0	1	7	0	0
20	35211354	.	C	A	1	2	3	0	5	8	0	0
20	35211393	.	T	G	8	2	10	0	1	11	0	0
20	35211515	.	C	T	1	5	6	0	5	11	0	0
20	35211537	.	G	A	4	4	8	0	0	8	0	0
20	35211641	.	C	T	4	3	7	0	1	8	0	0
20	35212064	.	T	A	2	6	8	0	0	8	0	0
20	35212070	.	G	A	2	5	7	0	1	8	0	0
20	35212366	.	T	C	3	3	6	0	0	6	0	0
20	35212398	.	A	G	3	5	8	0	0	8	0	0
20	35212405	.	C	T	5	3	8	0	0	8	0	0
20	35212946	.	T	A	4	4	8	0	1	9	0	0
20	35215773	.	C	G	0	3	3	0	4	7	0	0
20	35215776	.	G	C	4	3	7	0	0	7	0	0
20	35220065	.	G	A	1	4	5	0	1	6	0	0
20	35226227	.	T	A	1	2	3	0	0	3	0	0
20	35226587	.	G	T	0	4	4	0	1	5	0	0
20	35226602	.	C	T	0	3	3	0	2	5	0	0
20	35297212	.	T	G	6	0	6	0	7	13	0	0
20	35297648	.	C	T	5	7	12	1	2	15	0	0
20	35297693	.	G	A	13	4	17	0	2	19	0	0
20	35297819	.	T	C	6	6	12	0	0	12	0	0
20	35297832	.	A	C	11	0	11	0	0	11	0	0
20	35297931	.	C	T	1	3	4	0	0	4	0	0
20	35428633	.	T	C	31	26	57	0	11	68	0	0
20	35428910	.	A	G	37	26	63	0	0	63	0	0
20	35428931	.	T	A	28	29	57	0	5	62	0	0
20	35429017	.	T	A	23	10	33	0	4	37	0	0
20	35429269	.	C	T	34	32	66	0	6	72	0	0
20	35429299	.	A	G	36	29	65	0	2	67	0	0
20	35429384	.	C	T	35	36	71	0	3	74	0	0
20	35429610	.	A	T	36	35	71	0	3	74	0	0
20	35433262	.	G	C	14	14	28	0	1	29	0	0
20	35433264	.	G	C	17	14	31	0	0	31	0	0
20	35437838	.	G	C	8	3	11	0	1	12	0	0
20	35464735	.	C	G	0	5	5	0	4	9	0	0
20	35798083	.	C	G	10	3	13	0	2	15	0	0
20	35798370	.	G	A	20	13	33	0	4	37	0	0
20	35798717	.	A	G	10	5	15	0	0	15	0	0
20	35798973	.	T	A	5	10	15	0	1	16	0	0
20	35800001	.	G	A	11	4	15	0	10	25	0	0
20	35800043	.	G	T	10	8	18	0	7	25	0	0
20	35800249	.	C	T	6	7	13	0	1	14	0	0
20	35800349	.	C	T	9	5	14	0	0	14	0	0
20	35800520	.	G	A	10	3	13	0	0	13	0	0
20	35800749	.	G	A	7	3	10	0	0	10	0	0
20	35832168	.	G	A	3	1	4	0	1	5	0	0
20	35942981	.	T	C	2	1	3	0	1	4	0	0
20	35957401	.	C	A	2	2	4	0	0	4	0	0
20	35972539	.	T	C	5	3	8	0	0	8	0	0
20	35972544	.	G	A	5	2	7	0	1	8	0	0
20	35979899	.	G	T	5	7	12	0	0	12	0	0
20	35979910	.	T	G	2	4	6	0	0	6	0	0
20	35979983	.	G	C	3	5	8	0	1	9	0	0
20	35980009	.	A	G	4	4	8	0	0	8	0	0
20	35980021	.	C	T	4	5	9	0	0	9	0	0
20	35980091	.	T	C	4	3	7	0	1	8	0	0
20	36234334	.	T	A	3	4	7	0	1	8	0	0
20	36297304	.	C	T	9	13	22	0	1	23	0	0
20	36297356	.	G	A	1	12	13	0	12	25	0	0
20	36297418	.	C	A	20	5	25	0	1	26	0	0
20	36297448	.	C	T	4	19	23	0	0	23	0	0
20	36297518	.	G	A	0	14	14	0	10	25	1	0
20	36297832	.	C	T	13	6	19	0	0	19	0	0
20	36395691	.	T	A	1	3	4	0	0	4	0	0
20	36395694	.	A	T	1	2	3	0	0	3	0	0
20	36395895	.	G	A	4	3	7	0	0	7	0	0
20	36396668	.	A	G	5	5	10	0	0	10	0	0
20	36402167	.	G	T	3	2	5	0	0	5	0	0
20	36420218	.	A	C	12	16	28	0	2	30	0	0
20	36420713	.	C	T	3	15	18	0	16	34	0	0
20	36420804	.	G	T	17	10	27	0	2	29	0	0
20	36420982	.	G	A	11	9	20	0	2	22	0	0
20	36421219	.	G	A	7	12	19	0	3	22	0	0
20	36421362	.	G	A	12	6	18	0	0	18	0	0
20	36421530	.	A	C	12	0	12	0	8	20	0	0
20	36421757	.	C	T	1	8	9	0	9	18	0	0
20	36422043	.	G	A	24	15	39	0	3	42	0	0
20	36422098	.	C	A	8	20	28	0	2	30	0	0
20	36422291	.	G	T	11	7	18	0	0	18	0	0
20	36433247	.	G	A	11	16	27	0	2	29	0	0
20	36437314	.	A	G	5	4	9	0	1	10	0	0
20	36449286	.	G	A	9	5	14	0	0	14	0	0
20	36449385	.	C	T	8	3	11	0	1	12	0	0
20	36449442	.	A	C	7	7	14	0	0	14	0	0
20	36449601	.	C	T	4	6	10	0	0	10	0	0
20	36626195	.	A	G	25	0	25	0	8	33	0	0
20	36626248	.	G	A	22	10	32	0	1	33	0	0
20	36626335	.	C	T	8	11	19	0	2	21	0	0
20	36637941	.	C	T	2	5	7	0	0	7	0	0
20	36637999	.	G	A	3	4	7	0	1	8	0	0
20	36638133	.	A	T	7	2	9	0	0	9	0	0
20	36638169	.	T	C	1	7	8	0	0	8	0	0
20	36675273	.	T	C	5	4	9	0	1	10	0	0
20	36677574	.	G	A	5	5	10	0	0	10	0	0
20	36773579	.	G	T	0	3	3	0	1	4	0	0
20	36777354	.	A	C	1	2	3	0	1	4	0	0
20	36785477	.	G	A	1	4	5	0	0	5	0	0
20	36787170	.	A	G	0	1	1	0	3	4	0	0
20	36799816	.	A	G	6	7	13	0	1	14	0	0
20	36799934	.	C	T	0	9	9	0	6	15	0	0
20	36816972	.	C	T	3	5	8	0	1	9	0	0
20	36817162	.	T	G	2	3	5	0	0	5	0	0
20	36817184	.	G	A	0	3	3	0	4	7	0	0
20	36828948	.	A	C	8	6	14	0	1	15	0	0
20	36829418	.	G	A	3	3	6	0	8	14	0	0
20	36829428	.	A	C	8	6	14	0	0	14	0	0
20	36838717	.	C	T	7	9	16	0	1	17	0	0
20	36838871	.	C	T	12	6	18	0	2	20	0	0
20	36845996	.	C	T	0	6	6	0	1	7	0	0
20	36848264	.	T	A	0	4	4	0	0	4	0	0
20	36848272	.	G	A	1	4	5	0	0	5	0	0
20	36915481	.	G	A	14	12	26	0	2	28	0	0
20	36915493	.	A	T	12	13	25	0	1	26	0	0
20	36915529	.	G	A	14	10	24	0	2	26	0	0
20	36915826	.	C	A	7	9	16	0	1	17	0	0
20	36916050	.	A	G	11	10	21	0	1	22	0	0
20	36916187	.	T	C	8	0	8	0	9	17	0	0
20	36916428	.	A	T	9	4	13	0	0	13	0	0
20	36916429	.	A	T	10	4	14	0	0	14	0	0
20	36917037	.	C	T	6	16	22	0	4	26	0	0
20	36917631	.	C	T	6	4	10	0	0	10	0	0
20	37300798	.	G	A	4	3	7	0	1	8	0	0
20	37358885	.	G	A	0	10	10	0	12	22	0	0
20	37512259	.	G	A	17	15	32	0	1	33	0	0
20	37512503	.	T	G	2	4	6	0	0	6	0	0
20	37513257	.	C	A	19	17	36	0	4	40	0	0
20	37513632	.	A	G	22	30	52	0	0	52	0	0
20	37513702	.	G	A	37	18	55	0	1	56	0	0
20	37513753	.	G	T	22	22	44	0	7	51	0	0
20	37515525	.	G	T	10	17	27	0	1	28	0	0
20	37515607	.	T	G	10	8	18	0	1	19	0	0
20	37516363	.	C	T	8	15	23	0	1	24	0	0
20	37517962	.	T	C	12	0	12	0	15	27	0	0
20	37518718	.	A	T	5	7	12	0	0	12	0	0
20	37518823	.	A	G	5	7	12	0	0	12	0	0
20	37519399	.	G	A	5	3	8	0	2	10	0	0
20	37519453	.	G	T	4	2	6	0	1	7	0	0
20	37521010	.	T	C	1	0	1	0	3	4	0	0
20	37736041	.	T	A	11	9	20	0	1	21	0	0
20	37750661	.	A	G	1	2	3	0	0	3	0	0
20	37760596	.	G	C	5	3	8	0	1	9	0	0
20	37760614	.	C	A	2	5	7	0	1	8	0	0
20	37764120	.	A	G	2	0	2	0	4	6	0	0
20	37764500	.	C	A	5	2	7	0	0	7	0	0
20	37768543	.	G	A	11	10	21	0	0	21	0	0
20	37768627	.	T	A	11	8	19	0	1	20	0	0
20	37768712	.	A	C	13	10	23	0	2	25	0	0
20	37768862	.	T	C	6	2	8	0	0	8	0	0
20	37768995	.	T	A	9	10	19	0	0	19	0	0
20	37796473	.	A	C	1	2	3	0	0	3	0	0
20	37798892	.	C	T	1	2	3	0	0	3	0	0
20	37798912	.	G	A	2	2	4	0	0	4	0	0
20	37799497	.	T	C	9	3	12	0	2	14	0	0
20	37800444	.	C	A	2	3	5	0	2	7	0	0
20	37825839	.	C	T	2	3	5	0	0	5	0	0
20	37826300	.	G	T	1	3	4	0	0	4	0	0
20	37844090	.	A	T	2	2	4	0	0	4	0	0
20	37844298	.	C	G	1	4	5	0	0	5	0	0
20	37845858	.	G	A	6	4	10	0	1	11	0	0
20	37852670	.	T	C	5	6	11	0	0	11	0	0
20	37859577	.	T	C	10	7	17	0	0	17	0	0
20	37862303	.	C	G	3	5	8	0	2	10	0	0
20	37862414	.	T	C	7	8	15	0	1	16	0	0
20	37862466	.	C	G	2	6	8	0	2	10	0	0
20	37866514	.	C	T	4	3	7	0	0	7	0	0
20	37884692	.	A	G	1	0	1	0	2	3	0	0
20	37896247	.	T	C	4	3	7	0	0	7	0	0
20	37896256	.	T	C	3	3	6	0	0	6	0	0
20	37899220	.	A	G	10	7	17	0	1	18	0	0
20	37899289	.	T	C	9	4	13	0	1	14	0	0
20	37913114	.	G	A	5	2	7	0	0	7	0	0
20	37913237	.	G	A	3	5	8	0	0	8	0	0
20	37913752	.	T	C	8	3	11	0	0	11	0	0
20	37913767	.	T	G	2	6	8	0	1	9	0	0
20	37913866	.	A	G	8	5	13	0	1	14	0	0
20	37913988	.	T	G	4	9	13	0	0	13	0	0
20	37914057	.	G	A	8	4	12	0	0	12	0	0
20	37914395	.	A	G	2	4	6	0	0	6	0	0
20	37914497	.	T	C	6	6	12	0	0	12	0	0
20	37914517	.	C	T	6	7	13	0	0	13	0	0
20	37914651	.	C	T	2	2	4	0	0	4	0	0
20	37914668	.	G	T	2	4	6	0	1	7	0	0
20	37914709	.	A	C	4	9	13	0	1	14	0	0
20	37914722	.	C	T	6	8	14	0	1	15	0	0
20	37914750	.	C	A	4	7	11	0	1	12	0	0
20	37915027	.	C	T	5	9	14	0	0	14	0	0
20	37915217	.	A	T	11	10	21	0	0	21	0	0
20	37915479	.	C	T	8	8	16	0	0	16	0	0
20	37915619	.	T	G	6	14	20	0	0	20	0	0
20	37915658	.	T	C	11	5	16	0	0	16	0	0
20	37915859	.	C	T	2	7	9	0	3	12	0	0
20	37916043	.	T	A	7	3	10	0	1	11	0	0
20	37916154	.	A	G	5	5	10	1	1	12	0	0
20	37920726	.	A	G	8	10	18	0	0	18	0	0
20	37920822	.	C	T	2	6	8	0	10	18	0	0
20	37924995	.	G	T	10	9	19	0	0	19	0	0
20	37925455	.	A	C	6	6	12	0	0	12	0	0
20	37928136	.	T	G	7	4	11	0	1	12	0	0
20	37928465	.	C	T	0	7	7	0	3	10	0	0
20	37930672	.	C	G	2	2	4	0	0	4	0	0
20	37930874	.	C	T	0	2	2	0	3	5	0	0
20	38032694	.	G	C	4	9	13	0	0	13	0	0
20	38045807	.	T	G	6	9	15	0	0	15	0	0
20	38045859	.	G	T	6	5	11	0	1	12	0	0
20	38091838	.	G	A	16	8	24	0	0	24	0	0
20	38099500	.	C	T	21	7	28	0	1	29	0	0
20	38104076	.	G	A	23	10	33	0	1	34	0	0
20	38104077	.	T	A	22	9	31	0	4	35	0	0
20	38202228	.	T	C	1	2	3	0	0	3	0	0
20	38240907	.	G	A	7	5	12	0	1	13	0	0
20	38241567	.	T	A	4	3	7	0	0	7	0	0
20	38241719	.	G	T	3	2	5	0	0	5	0	0
20	38358534	.	T	C	7	7	14	0	0	14	0	0
20	38358657	.	A	C	6	3	9	0	1	10	0	0
20	38358660	.	C	A	4	6	10	0	0	10	0	0
20	38358752	.	C	T	4	2	6	0	1	7	0	0
20	38358755	.	G	C	0	3	3	0	4	7	0	0
20	38358864	.	T	C	5	2	7	0	0	7	0	0
20	38359181	.	T	C	4	3	7	0	0	7	0	0
20	38359258	.	G	A	3	6	9	0	0	9	0	0
20	38387193	.	A	G	1	2	3	0	0	3	0	0
20	38458149	.	C	T	2	3	5	0	0	5	0	0
20	38473700	.	C	T	7	8	15	0	0	15	0	0
20	38473805	.	A	T	5	3	8	0	1	9	0	0
20	38473817	.	C	T	3	5	8	0	0	8	0	0
20	38473886	.	T	C	5	4	9	0	1	10	0	0
20	38473940	.	T	G	3	0	3	0	9	12	0	0
20	38508375	.	G	A	2	4	6	0	1	7	0	0
20	38517640	.	C	T	11	16	27	0	2	29	0	0
20	38517929	.	T	A	7	5	12	0	2	14	0	0
20	38517941	.	C	T	9	7	16	0	0	16	0	0
20	38518015	.	C	T	11	10	21	0	5	26	0	0
20	38518082	.	T	G	13	9	22	0	2	24	0	0
20	38518267	.	A	G	8	11	19	0	1	20	0	0
20	38518454	.	T	G	9	14	23	0	0	23	0	0
20	38518878	.	T	A	1	3	4	0	1	5	0	0
20	38518906	.	C	T	2	3	5	0	0	5	0	0
20	38518920	.	T	C	2	2	4	0	1	5	0	0
20	38518993	.	G	T	4	3	7	0	1	8	0	0
20	38526041	.	G	A	1	2	3	0	0	3	0	0
20	38538249	.	G	A	0	3	3	0	4	7	0	0
20	38583632	.	G	A	0	2	2	0	1	3	0	0
20	38647369	.	T	C	4	5	9	0	0	9	0	0
20	38657824	.	C	T	9	4	13	0	0	13	0	0
20	38662649	.	A	G	9	4	13	0	0	13	0	0
20	38662697	.	G	T	7	7	14	0	0	14	0	0
20	38665194	.	G	A	7	9	16	0	0	16	0	0
20	38669813	.	A	G	4	2	6	0	0	6	0	0
20	38670230	.	G	A	7	9	16	0	1	17	0	0
20	38670397	.	C	T	5	3	8	0	0	8	0	0
20	38726421	.	A	T	9	6	15	0	2	18	1	0
20	38726664	.	C	T	13	7	20	0	0	20	0	0
20	38726935	.	C	T	15	7	22	0	2	24	0	0
20	38727047	.	A	G	12	12	24	0	0	24	0	0
20	38787014	.	T	A	6	8	14	0	0	14	0	0
20	38788358	.	C	A	1	2	3	0	0	3	0	0
20	38788624	.	G	A	2	11	13	0	0	13	0	0
20	38788676	.	C	T	3	5	8	0	0	8	0	0
20	38788749	.	A	C	6	4	10	0	2	12	0	0
20	38788887	.	G	A	4	5	9	0	0	9	0	0
20	38789855	.	T	C	9	8	17	0	1	18	0	0
20	38790283	.	A	G	7	7	14	0	0	14	0	0
20	38793405	.	G	A	9	6	15	0	0	15	0	0
20	38793414	.	C	T	1	5	6	0	7	13	0	0
20	38798501	.	A	C	4	6	10	0	0	10	0	0
20	38861536	.	T	C	2	6	8	0	0	8	0	0
20	38864559	.	A	G	3	2	5	0	0	5	0	0
20	38864684	.	A	G	5	3	8	0	0	8	0	0
20	38866779	.	T	C	4	3	7	0	0	7	0	0
20	38877848	.	G	A	2	6	8	0	0	8	0	0
20	38889148	.	C	T	6	6	12	0	0	12	0	0
20	38910374	.	A	G	9	7	16	0	0	16	0	0
20	39045960	.	A	T	13	10	23	0	1	24	0	0
20	39046032	.	T	C	7	6	13	0	2	15	0	0
20	39052063	.	A	T	14	14	28	0	1	29	0	0
20	39052100	.	T	A	17	14	31	0	3	34	0	0
20	39052254	.	C	T	2	22	24	0	20	44	0	0
20	39052505	.	C	A	17	18	35	0	2	37	0	0
20	39055706	.	T	A	8	7	15	0	0	15	0	0
20	39055731	.	G	T	5	5	10	0	3	13	0	0
20	39055868	.	T	A	9	5	14	0	0	14	0	0
20	39081196	.	A	G	7	4	11	0	3	14	0	0
20	39081322	.	C	T	1	6	7	1	0	8	0	0
20	39191354	.	T	C	6	6	12	0	0	12	0	0
20	39191708	.	C	T	7	6	13	0	1	14	0	0
20	39254961	.	A	G	3	0	3	0	5	8	0	0
20	39256735	.	G	A	0	7	7	0	7	14	0	0
20	39256968	.	C	T	7	3	10	0	1	11	0	0
20	39258672	.	G	T	1	3	4	0	0	4	0	0
20	39259836	.	G	A	1	9	10	0	0	10	0	0
20	39260481	.	T	A	3	3	6	0	0	6	0	0
20	39260578	.	C	T	7	3	10	0	1	11	0	0
20	39260755	.	C	T	35	22	57	0	0	57	0	0
20	39260837	.	G	A	28	38	66	0	4	70	0	0
20	39260865	.	T	G	30	39	69	0	5	74	0	0
20	39267227	.	T	G	13	13	26	0	1	27	0	0
20	39271725	.	T	C	12	13	25	0	1	26	0	0
20	39271731	.	G	A	13	11	24	0	0	24	0	0
20	39271833	.	C	G	10	12	22	0	0	22	0	0
20	39273910	.	A	T	14	9	23	0	1	24	0	0
20	39338845	.	C	T	3	2	5	0	0	5	0	0
20	39338929	.	C	T	2	5	7	0	1	8	0	0
20	39338965	.	T	C	7	7	14	0	1	15	0	0
20	39338981	.	G	T	10	8	18	0	1	19	0	0
20	39339030	.	T	C	8	7	15	0	0	15	0	0
20	39339169	.	A	G	14	9	23	0	1	24	0	0
20	39341517	.	G	A	16	8	24	0	0	24	0	0
20	39341520	.	T	C	14	7	21	0	1	22	0	0
20	39343397	.	T	C	6	11	17	0	0	17	0	0
20	39344085	.	T	C	8	8	16	0	1	17	0	0
20	39513664	.	A	G	1	3	4	0	0	4	0	0
20	39520942	.	C	A	7	3	10	0	0	10	0	0
20	39554698	.	G	A	1	4	5	0	0	5	0	0
20	39557001	.	A	G	4	3	7	0	1	8	0	0
20	39689513	.	T	C	0	4	4	0	2	6	0	0
20	39692433	.	C	A	1	2	3	0	0	3	0	0
20	39807080	.	G	A	3	3	6	0	1	7	0	0
20	40269926	.	T	C	5	0	5	0	10	15	0	0
20	40372729	.	G	A	19	12	31	0	2	33	0	0
20	40372760	.	T	A	17	16	33	0	1	34	0	0
20	40372811	.	A	G	20	17	37	0	1	38	0	0
20	40451106	.	C	T	1	3	4	0	0	4	0	0
20	40457669	.	G	C	6	2	8	0	1	9	0	0
20	40461550	.	G	A	9	5	14	0	1	15	0	0
20	40464613	.	C	G	8	9	17	0	0	17	0	0
20	40466540	.	C	T	14	13	27	0	4	31	0	0
20	40466662	.	C	T	22	24	46	0	2	48	0	0
20	40467044	.	C	T	29	19	48	0	5	53	0	0
20	40471756	.	A	T	30	37	67	0	5	72	0	0
20	40471844	.	C	T	21	28	49	3	0	52	0	0
20	40471875	.	G	C	0	5	5	4	6	25	10	0
20	40471886	.	T	A	13	15	28	4	4	36	0	0
20	40472009	.	T	A	39	26	65	0	4	69	0	0
20	40472075	.	C	A	37	27	64	1	1	66	0	0
20	40472175	.	G	C	32	32	64	2	3	70	1	0
20	40475815	.	C	T	12	7	19	0	0	19	0	0
20	40475872	.	G	A	15	11	26	0	2	28	0	0
20	40476030	.	A	C	11	3	14	0	0	14	0	0
20	40476094	.	G	A	12	5	17	0	1	18	0	0
20	40476165	.	C	T	17	20	37	0	2	39	0	0
20	40476214	.	A	T	23	12	35	0	11	46	0	0
20	40478035	.	G	A	17	14	31	0	2	33	0	0
20	40478289	.	A	C	11	18	29	0	0	29	0	0
20	40480227	.	G	T	9	8	17	0	0	17	0	0
20	40480250	.	C	T	15	6	21	0	0	21	0	0
20	40485077	.	T	G	2	5	7	0	0	7	0	0
20	40715260	.	A	G	32	22	54	0	2	56	0	0
20	40716899	.	G	A	25	24	49	0	6	55	0	0
20	40716911	.	A	G	26	25	51	0	3	54	0	0
20	40717271	.	G	T	13	5	18	0	5	23	0	0
20	40717418	.	G	A	5	6	11	0	2	13	0	0
20	40762073	.	A	G	2	2	4	0	0	4	0	0
20	40762361	.	T	C	5	2	7	0	0	7	0	0
20	40762505	.	G	T	1	1	2	0	1	3	0	0
20	40764004	.	G	A	1	4	5	0	1	6	0	0
20	40764132	.	G	T	3	3	6	0	0	6	0	0
20	40810988	.	T	C	1	4	5	0	0	5	0	0
20	40819423	.	C	G	5	5	10	0	1	11	0	0
20	40840802	.	G	A	8	5	13	0	1	14	0	0
20	40840963	.	A	C	1	6	7	0	0	7	0	0
20	41236764	.	G	A	0	2	2	0	4	6	0	0
20	41237380	.	A	G	3	0	3	0	4	7	0	0
20	41237731	.	G	A	1	3	4	0	0	4	0	0
20	41239038	.	T	C	2	2	4	0	0	4	0	0
20	41239439	.	T	C	6	7	13	0	1	14	0	0
20	41239461	.	C	T	3	7	10	0	1	11	0	0
20	41239604	.	C	T	5	7	12	0	1	13	0	0
20	41239624	.	G	A	9	9	18	0	2	20	0	0
20	41239753	.	G	T	1	5	6	0	5	11	0	0
20	41239760	.	G	A	1	6	7	0	5	12	0	0
20	41239838	.	A	G	3	3	6	0	0	6	0	0
20	41239899	.	G	T	3	6	9	0	2	11	0	0
20	41239916	.	A	T	1	5	6	0	0	6	0	0
20	41239946	.	A	G	6	5	11	0	0	11	0	0
20	41239977	.	T	C	7	2	9	0	1	10	0	0
20	41240107	.	G	C	1	4	5	0	0	5	0	0
20	41240108	.	A	G	1	0	1	0	4	5	0	0
20	41240148	.	A	G	5	0	5	0	8	13	0	0
20	41240480	.	A	G	8	0	8	0	7	15	0	0
20	41240512	.	A	C	6	6	12	0	0	12	0	0
20	41240643	.	G	A	0	4	4	0	7	11	0	0
20	41240736	.	T	C	7	4	11	0	0	11	0	0
20	41240958	.	A	G	15	8	23	0	0	23	0	0
20	41240986	.	A	G	17	0	17	0	10	27	0	0
20	41241316	.	G	C	5	10	15	0	1	16	0	0
20	41241350	.	C	A	8	8	16	0	1	17	0	0
20	41241355	.	C	T	10	7	17	0	0	17	0	0
20	41241443	.	A	C	6	3	9	0	1	10	0	0
20	41242045	.	G	A	2	19	21	0	9	30	0	0
20	41242347	.	G	A	4	2	6	0	0	6	0	0
20	41640701	.	A	C	5	6	11	0	0	11	0	0
20	41640743	.	G	A	4	7	11	0	0	11	0	0
20	41640903	.	T	C	2	3	5	0	0	5	0	0
20	41640917	.	A	G	3	3	6	0	0	6	0	0
20	41641019	.	A	T	5	2	7	0	0	7	0	0
20	41643457	.	C	T	10	8	18	0	0	18	0	0
20	41651639	.	C	T	5	4	9	0	1	10	0	0
20	41655513	.	G	A	1	7	8	0	8	16	0	0
20	41689967	.	A	G	15	13	28	0	1	29	0	0
20	41689979	.	C	T	12	14	26	0	3	29	0	0
20	41734344	.	C	T	10	12	22	0	1	23	0	0
20	41757835	.	A	G	15	13	28	0	2	30	0	0
20	41765105	.	T	C	14	11	25	0	3	28	0	0
20	41946745	.	A	G	2	2	4	0	1	5	0	0
20	41949354	.	G	T	1	2	3	0	3	6	0	0
20	41949355	.	C	T	3	3	6	0	0	6	0	0
20	41960702	.	G	A	0	2	2	0	1	3	0	0
20	41960908	.	C	T	3	3	6	0	1	7	0	0
20	41960962	.	C	T	4	2	6	0	0	6	0	0
20	41961076	.	G	A	4	2	6	0	0	6	0	0
20	41961113	.	C	T	4	2	6	0	0	6	0	0
20	41961229	.	A	T	4	4	8	0	0	8	0	0
20	41961779	.	C	T	7	3	10	0	0	10	0	0
20	41961880	.	G	A	5	2	7	0	0	7	0	0
20	41961909	.	A	T	6	3	9	0	0	9	0	0
20	41962677	.	C	G	6	0	6	0	4	10	0	0
20	41962872	.	A	G	7	6	13	0	0	13	0	0
20	41962923	.	A	T	7	4	11	1	0	12	0	0
20	41963188	.	G	A	5	2	7	0	0	7	0	0
20	41963398	.	T	G	4	5	9	0	0	9	0	0
20	41963451	.	G	A	0	7	7	0	5	12	0	0
20	41963530	.	A	G	8	10	18	0	0	18	0	0
20	41963652	.	C	T	8	13	21	0	0	21	0	0
20	41963660	.	C	T	10	10	20	0	0	20	0	0
20	41998601	.	C	G	12	4	16	0	2	18	0	0
20	41999025	.	C	A	12	6	18	0	0	18	0	0
20	41999046	.	G	A	14	5	19	0	0	19	0	0
20	41999106	.	A	G	6	11	17	0	1	18	0	0
20	42203465	.	T	C	2	4	6	0	1	7	0	0
20	42221387	.	A	T	4	4	8	0	0	8	0	0
20	42221710	.	C	T	13	7	20	0	1	21	0	0
20	42221713	.	C	T	11	5	16	0	4	20	0	0
20	42222296	.	A	C	6	9	15	0	1	16	0	0
20	42222444	.	A	T	3	7	10	1	0	11	0	0
20	42222546	.	A	T	5	5	10	0	1	11	0	0
20	42222549	.	A	T	5	7	12	0	0	12	0	0
20	42222621	.	T	C	9	8	17	0	0	17	0	0
20	42222769	.	T	C	10	3	13	0	0	13	0	0
20	42222770	.	T	C	3	10	13	0	0	13	0	0
20	42223350	.	A	T	2	4	6	0	0	6	0	0
20	42232554	.	A	G	3	4	7	0	0	7	0	0
20	42241224	.	T	G	5	2	7	0	0	7	0	0
20	42241367	.	C	T	0	4	4	0	3	7	0	0
20	42246990	.	C	T	2	3	5	0	0	5	0	0
20	42247018	.	G	C	2	2	4	0	0	4	0	0
20	42275414	.	C	T	10	5	15	0	0	15	0	0
20	42275441	.	G	A	1	6	7	0	7	14	0	0
20	42278043	.	C	T	8	7	15	0	0	15	0	0
20	42280829	.	C	T	4	9	13	0	0	13	0	0
20	42281248	.	T	G	4	2	6	1	0	7	0	0
20	42297038	.	C	T	3	2	5	0	0	5	0	0
20	42297042	.	T	C	3	0	3	0	3	6	0	0
20	42297080	.	T	A	2	4	6	0	1	7	0	0
20	42297456	.	T	C	1	2	3	0	0	3	0	0
20	42631316	.	G	A	0	2	2	0	1	3	0	0
20	42749752	.	A	G	2	2	4	0	0	4	0	0
20	43120256	.	T	G	10	6	16	0	1	17	0	0
20	43121333	.	T	C	6	4	10	0	0	10	0	0
20	43121501	.	T	C	5	0	5	0	4	9	0	0
20	43122161	.	T	C	4	2	6	0	0	6	0	0
20	43673532	.	G	A	4	2	6	0	0	6	0	0
20	43673634	.	G	A	0	4	4	0	3	7	0	0
20	43675840	.	G	A	0	2	2	0	1	3	0	0
20	43680616	.	C	A	3	2	5	0	0	5	0	0
20	43680700	.	G	A	1	3	4	0	0	4	0	0
20	43680752	.	C	T	2	4	6	0	1	7	0	0
20	43683238	.	A	G	8	0	8	0	7	15	0	0
20	43689138	.	T	A	6	6	12	0	2	14	0	0
20	43689254	.	C	A	5	12	17	0	0	17	0	0
20	43689418	.	G	A	0	15	15	0	8	23	0	0
20	43689727	.	T	C	1	5	6	0	0	6	0	0
20	43711968	.	A	G	2	2	4	0	0	4	0	0
20	43715032	.	T	A	1	3	4	0	0	4	0	0
20	43746738	.	A	G	1	9	10	0	0	10	0	0
20	43746749	.	C	T	0	10	10	0	2	12	0	0
20	43746780	.	C	T	2	9	11	0	1	12	0	0
20	43746890	.	T	C	5	0	5	0	14	19	0	0
20	43750362	.	A	G	6	11	17	0	3	20	0	0
20	43750680	.	A	G	7	11	18	0	0	18	0	0
20	43776373	.	T	C	22	22	44	0	2	46	0	0
20	43776456	.	T	A	30	19	49	0	0	49	0	0
20	43776841	.	G	A	26	34	60	0	2	62	0	0
20	43776842	.	A	G	37	25	62	0	1	63	0	0
20	43786415	.	T	C	15	6	21	0	0	21	0	0
20	43793065	.	T	C	8	8	16	0	1	17	0	0
20	43793193	.	G	A	21	17	38	1	0	39	0	0
20	43793329	.	C	T	14	13	27	0	4	31	0	0
20	43793410	.	C	A	1	6	7	0	19	26	0	0
20	43793428	.	G	A	17	12	29	0	1	30	0	0
20	43793666	.	C	T	1	10	11	0	10	21	0	0
20	43793683	.	G	A	6	11	17	0	3	20	0	0
20	43793702	.	C	T	14	15	29	0	0	29	0	0
20	43793867	.	A	C	13	8	21	0	0	21	0	0
20	43793901	.	A	G	10	11	21	0	2	23	0	0
20	43793960	.	A	T	17	12	29	0	1	30	0	0
20	43794004	.	G	A	17	21	38	0	1	39	0	0
20	43794053	.	A	T	23	23	46	0	3	49	0	0
20	43794488	.	A	G	14	10	24	0	0	24	0	0
20	43812584	.	G	A	9	3	12	0	1	14	1	0
20	43825607	.	A	G	6	5	11	0	0	11	0	0
20	43831482	.	T	C	8	8	16	0	2	18	0	0
20	43895806	.	G	A	5	5	10	0	0	10	0	0
20	43895827	.	T	A	1	3	4	0	1	5	0	0
20	44372854	.	G	C	4	8	12	0	2	14	0	0
20	44372973	.	C	A	8	6	14	0	1	15	0	0
20	44372977	.	C	T	8	7	15	0	2	17	0	0
20	44373336	.	G	A	13	23	36	1	0	37	0	0
20	44373378	.	A	G	12	20	32	1	0	33	0	0
20	44386452	.	C	T	3	12	15	0	19	34	0	0
20	44386501	.	A	G	26	9	35	0	2	37	0	0
20	44389647	.	G	A	11	14	25	1	0	26	0	0
20	44402769	.	C	T	10	10	20	0	2	22	0	0
20	44447798	.	G	T	8	9	17	0	0	17	0	0
20	44451262	.	G	A	5	7	12	0	0	12	0	0
20	44451286	.	C	A	0	5	5	0	7	12	0	0
20	44457311	.	G	C	5	0	5	0	7	12	0	0
20	44457314	.	A	G	8	5	13	0	0	13	0	0
20	44457593	.	C	T	1	4	5	0	0	5	0	0
20	44457659	.	A	T	1	2	3	0	0	3	0	0
20	44464453	.	C	T	1	5	6	0	6	12	0	0
20	44464502	.	G	T	12	6	18	0	0	18	0	0
20	44464579	.	T	C	11	8	19	0	0	19	0	0
20	44509653	.	C	T	1	5	6	0	2	8	0	0
20	44514469	.	C	T	0	3	3	0	3	6	0	0
20	44517604	.	C	T	7	3	10	0	0	10	0	0
20	44518070	.	G	T	2	2	4	0	0	4	0	0
20	44530085	.	T	A	2	2	4	0	0	4	0	0
20	44566955	.	T	G	8	11	19	0	2	21	0	0
20	44567001	.	G	A	5	14	19	0	1	20	0	0
20	44569943	.	C	A	11	4	15	0	2	17	0	0
20	44680479	.	C	A	1	2	3	0	0	3	0	0
20	44761074	.	A	G	1	2	3	0	0	3	0	0
20	44761518	.	T	C	3	2	5	0	0	5	0	0
20	44799458	.	T	A	7	7	14	0	1	15	0	0
20	45406783	.	C	T	7	11	18	0	3	21	0	0
20	45406870	.	G	A	16	13	29	0	1	30	0	0
20	45406997	.	T	C	9	6	15	0	1	16	0	0
20	45407313	.	T	A	9	11	20	0	1	21	0	0
20	45407327	.	T	C	11	0	11	0	8	19	0	0
20	45408047	.	T	C	11	11	22	0	0	22	0	0
20	45408179	.	G	C	5	8	13	0	1	14	0	0
20	45408345	.	G	A	6	3	9	0	0	9	0	0
20	45643846	.	G	T	2	2	4	0	2	6	0	0
20	45644095	.	C	T	4	4	8	0	1	9	0	0
20	45644096	.	T	G	5	4	9	0	1	10	0	0
20	45644163	.	G	T	10	3	13	0	0	13	0	0
20	45644275	.	G	A	6	10	16	0	0	16	0	0
20	45645560	.	A	G	6	3	9	0	0	9	0	0
20	45653434	.	A	G	1	2	3	4	0	7	0	0
20	45656899	.	A	G	3	3	6	0	0	6	0	0
20	45669311	.	C	T	10	15	25	0	0	25	0	0
20	45669353	.	C	T	2	8	10	0	17	27	0	0
20	45679302	.	T	G	7	4	11	0	0	11	0	0
20	45679303	.	T	A	7	4	11	0	0	11	0	0
20	45682240	.	A	C	8	3	11	0	2	13	0	0
20	45742126	.	C	T	1	7	8	0	0	8	0	0
20	45745423	.	C	T	2	7	9	0	1	10	0	0
20	45745930	.	A	G	6	0	6	0	5	11	0	0
20	45746063	.	C	T	8	6	14	0	1	15	0	0
20	45746064	.	A	G	9	6	15	0	1	16	0	0
20	45746297	.	C	T	10	9	19	0	0	19	0	0
20	45746402	.	G	A	17	13	30	0	2	32	0	0
20	45746432	.	C	T	11	11	22	0	4	26	0	0
20	45746486	.	T	C	14	14	28	0	1	29	0	0
20	45746524	.	T	A	16	11	27	0	1	28	0	0
20	45746567	.	C	T	12	10	22	0	1	23	0	0
20	45746588	.	C	A	14	13	27	0	0	27	0	0
20	45746797	.	T	C	12	16	28	0	0	28	0	0
20	45746807	.	A	C	9	15	24	0	2	26	0	0
20	45747089	.	A	T	21	25	46	0	0	46	0	0
20	45747098	.	A	G	18	22	40	0	1	41	0	0
20	45747125	.	G	A	2	19	21	0	17	38	0	0
20	45751304	.	T	C	14	21	35	0	3	38	0	0
20	45751364	.	T	A	17	14	31	0	0	31	0	0
20	45751561	.	G	C	2	13	15	0	11	26	0	0
20	45751989	.	T	A	5	5	10	0	1	11	0	0
20	45764707	.	C	T	3	5	8	0	0	8	0	0
20	45764722	.	T	C	4	3	7	0	0	7	0	0
20	45764857	.	G	A	1	3	4	0	0	4	0	0
20	45898775	.	C	T	3	2	5	0	0	5	0	0
20	46353024	.	G	T	2	3	5	0	1	6	0	0
20	46353253	.	G	A	4	3	7	0	0	7	0	0
20	46353259	.	G	A	3	3	6	0	1	7	0	0
20	46353321	.	A	T	5	3	8	0	1	9	0	0
20	46353428	.	C	T	3	3	6	0	2	8	0	0
20	46357199	.	C	G	3	3	6	0	0	6	0	0
20	46435243	.	G	A	2	1	3	0	1	4	0	0
20	46439988	.	A	G	3	0	3	0	6	9	0	0
20	46441612	.	G	A	1	6	7	0	4	11	0	0
20	46441627	.	C	T	4	6	10	0	0	10	0	0
20	46441695	.	G	C	6	6	12	0	0	12	0	0
20	46441724	.	C	A	3	5	8	0	0	8	0	0
20	46442397	.	T	C	5	5	10	0	1	11	0	0
20	46457175	.	A	T	12	15	27	0	0	28	1	0
20	46457334	.	T	C	16	1	17	0	8	25	0	0
20	46457376	.	A	G	10	20	30	0	0	30	0	0
20	46463315	.	T	A	7	11	18	0	0	18	0	0
20	46463327	.	T	C	7	0	7	0	10	17	0	0
20	46466920	.	G	A	6	4	10	0	0	10	0	0
20	46467054	.	T	C	4	5	9	0	2	11	0	0
20	46467174	.	A	C	10	6	16	0	0	16	0	0
20	46492279	.	T	C	2	3	5	0	0	5	0	0
20	46492305	.	A	C	1	3	4	0	0	4	0	0
20	46498023	.	C	A	1	4	5	0	0	5	0	0
20	46502423	.	T	A	4	3	7	0	0	7	0	0
20	46506079	.	G	A	1	4	5	0	3	8	0	0
20	46506203	.	T	A	4	8	12	0	1	13	0	0
20	46509336	.	G	A	0	2	2	0	2	4	0	0
20	46509343	.	A	G	2	0	2	0	2	4	0	0
20	46515625	.	G	A	4	2	6	0	2	8	0	0
20	46515680	.	C	T	4	4	8	0	0	8	0	0
20	46517286	.	C	G	10	8	18	0	0	18	0	0
20	46517429	.	C	T	11	6	17	0	2	19	0	0
20	46519076	.	A	G	8	7	15	0	0	15	0	0
20	46519082	.	G	A	3	8	11	0	5	16	0	0
20	46519148	.	T	A	7	11	18	0	4	22	0	0
20	46525639	.	T	A	13	11	24	0	1	25	0	0
20	46528643	.	T	C	4	9	13	0	1	14	0	0
20	46529398	.	G	A	8	6	14	0	0	14	0	0
20	46529479	.	T	C	6	4	10	0	1	11	0	0
20	46536906	.	T	G	19	21	40	0	6	46	0	0
20	46537039	.	A	T	26	29	55	0	0	55	0	0
20	46537231	.	C	G	26	18	44	0	3	47	0	0
20	46537239	.	C	T	18	23	41	0	5	46	0	0
20	46537404	.	G	A	16	10	26	1	3	30	0	0
20	46539619	.	A	G	15	28	43	0	1	44	0	0
20	46540898	.	A	G	12	8	20	0	1	21	0	0
20	46552431	.	C	T	3	17	20	0	3	23	0	0
20	46552965	.	G	T	30	21	51	0	4	55	0	0
20	46552966	.	G	T	30	22	52	0	2	54	0	0
20	46553020	.	T	G	27	33	60	0	2	62	0	0
20	46553274	.	G	C	35	23	58	0	1	59	0	0
20	46553512	.	T	C	1	4	5	0	0	5	0	0
20	46563938	.	A	G	1	1	2	0	2	4	0	0
20	46564267	.	C	T	1	2	3	0	0	3	0	0
20	46594507	.	C	T	2	3	5	2	0	7	0	0
20	46594523	.	A	G	3	2	5	4	0	9	0	0
20	46699344	.	T	C	1	3	4	0	0	4	0	0
20	46713607	.	C	T	3	4	7	0	0	7	0	0
20	46721084	.	G	A	7	3	10	0	0	10	0	0
20	46724740	.	C	T	12	8	20	0	1	21	0	0
20	46730654	.	T	C	10	7	17	0	0	17	0	0
20	46730663	.	G	A	8	8	16	0	1	17	0	0
20	46730734	.	C	T	11	9	20	0	4	24	0	0
20	46731010	.	T	A	7	6	13	0	1	14	0	0
20	46732848	.	T	A	12	15	27	0	2	29	0	0
20	46732887	.	C	T	14	13	27	0	1	28	0	0
20	46733096	.	C	T	1	3	4	0	7	11	0	0
20	46733764	.	A	G	5	10	15	0	0	15	0	0
20	46733809	.	G	A	11	7	18	0	0	18	0	0
20	46742633	.	A	C	3	3	6	0	0	6	0	0
20	46746711	.	G	A	2	5	7	0	7	14	0	0
20	46758870	.	C	G	2	2	4	0	0	4	0	0
20	46831124	.	T	C	9	8	17	0	0	17	0	0
20	46835112	.	A	G	1	3	4	0	0	4	0	0
20	46835432	.	G	A	4	2	6	0	0	6	0	0
20	46859259	.	A	G	2	3	5	0	0	5	0	0
20	46859328	.	G	A	3	4	7	0	0	7	0	0
20	46859418	.	A	G	2	5	7	0	0	7	0	0
20	46918894	.	A	T	1	2	3	0	0	3	0	0
20	46957559	.	G	T	27	21	48	0	3	51	0	0
20	46957575	.	C	G	23	25	48	0	5	53	0	0
20	46957600	.	T	A	23	20	43	0	3	46	0	0
20	46957650	.	A	T	31	17	48	0	0	48	0	0
20	46957803	.	T	A	19	25	44	1	3	48	0	0
20	46958136	.	C	T	15	15	30	0	1	31	0	0
20	46958478	.	T	C	19	0	19	0	26	45	0	0
20	46958705	.	G	T	17	17	34	0	0	34	0	0
20	46958766	.	T	A	12	21	33	0	0	33	0	0
20	46959135	.	T	C	23	18	41	0	3	44	0	0
20	46959147	.	A	T	22	17	39	0	4	44	1	0
20	46959465	.	C	A	13	6	19	0	1	20	0	0
20	46959477	.	A	T	13	9	22	0	0	22	0	0
20	46959504	.	T	C	10	7	17	0	2	19	0	0
20	46959525	.	T	C	15	0	15	0	9	24	0	0
20	46959543	.	A	T	15	12	27	0	1	28	0	0
20	46970314	.	A	G	1	3	4	0	0	4	0	0
20	46970344	.	T	A	1	2	3	0	0	3	0	0
20	46980230	.	A	G	3	2	5	0	0	5	0	0
20	46988087	.	C	T	1	1	2	0	1	3	0	0
20	47290466	.	A	T	3	3	6	0	0	6	0	0
20	47291133	.	C	T	0	2	2	0	5	7	0	0
20	47291137	.	G	A	3	1	4	0	1	5	0	0
20	47301729	.	A	G	4	5	9	0	0	9	0	0
20	47305152	.	G	A	3	6	9	0	0	9	0	0
20	47383913	.	A	G	18	10	28	0	1	29	0	0
20	47386932	.	T	G	12	9	21	0	2	23	0	0
20	47386965	.	T	C	10	10	20	0	0	20	0	0
20	47387067	.	T	C	7	9	16	0	1	17	0	0
20	47388431	.	G	A	12	4	16	0	1	17	0	0
20	47421471	.	C	A	6	8	14	0	1	15	0	0
20	47421554	.	A	G	3	4	7	0	0	7	0	0
20	47435018	.	T	A	12	16	28	0	2	30	0	0
20	47435065	.	G	T	0	12	12	0	13	25	0	0
20	47435186	.	C	A	14	9	23	0	0	23	0	0
20	47471391	.	A	G	29	0	29	0	22	51	0	0
20	47689531	.	G	A	2	6	8	0	0	8	0	0
20	47689570	.	A	G	8	13	21	0	0	21	0	0
20	47689621	.	A	T	14	16	30	0	1	32	1	0
20	47689647	.	A	C	14	0	14	0	14	28	0	0
20	47689671	.	T	C	10	14	24	0	1	25	0	0
20	47689801	.	C	T	18	12	30	0	3	33	0	0
20	47700034	.	T	C	9	0	9	0	14	23	0	0
20	47700055	.	C	T	9	14	23	0	0	23	0	0
20	47704959	.	C	T	0	3	3	0	2	5	0	0
20	47718334	.	T	C	12	0	12	0	11	23	0	0
20	47718458	.	T	C	15	8	23	0	0	23	0	0
20	47726010	.	G	A	6	3	9	0	0	9	0	0
20	47726049	.	C	G	3	3	6	0	1	7	0	0
20	47932268	.	G	T	16	14	30	0	0	30	0	0
20	47932424	.	T	C	15	20	35	0	1	36	0	0
20	47932867	.	T	C	11	20	31	0	2	33	0	0
20	47938981	.	C	T	2	14	16	0	13	29	0	0
20	47942600	.	G	A	8	7	15	0	0	15	0	0
20	47942651	.	A	G	10	7	17	0	0	17	0	0
20	47944132	.	C	T	0	5	5	0	10	15	0	0
20	47944151	.	G	A	8	6	14	0	0	14	0	0
20	47950971	.	G	A	3	3	6	0	1	7	0	0
20	47960793	.	A	G	1	2	3	0	1	4	0	0
20	47963967	.	T	C	2	3	5	0	0	5	0	0
20	47964299	.	C	T	1	2	3	0	0	3	0	0
20	47973078	.	A	G	2	4	6	0	1	7	0	0
20	47973272	.	T	C	3	2	5	0	0	5	0	0
20	47984494	.	C	T	3	4	7	0	1	8	0	0
20	47984650	.	T	G	1	3	4	0	1	5	0	0
20	48037036	.	T	C	1	3	4	0	0	4	0	0
20	48037061	.	G	C	1	3	4	0	1	5	0	0
20	48037071	.	G	A	1	3	4	0	0	4	0	0
20	48037765	.	A	G	4	3	7	0	0	7	0	0
20	48043220	.	G	A	3	2	5	0	1	6	0	0
20	48043401	.	G	A	2	4	6	0	0	6	0	0
20	48296314	.	T	C	10	0	10	0	5	15	0	0
20	48296315	.	A	G	11	4	15	0	0	15	0	0
20	48298716	.	C	T	10	6	16	0	1	17	0	0
20	48312445	.	A	G	3	2	5	0	0	5	0	0
20	48341712	.	T	C	5	0	5	0	4	9	0	0
20	48342821	.	G	A	2	2	4	0	0	4	0	0
20	48344049	.	T	C	3	0	3	0	2	5	0	0
20	50996515	.	G	T	1	23	24	0	19	43	0	0
20	50998672	.	T	A	16	22	38	0	3	41	0	0
20	50998746	.	A	G	16	24	40	0	1	41	0	0
20	50998858	.	C	T	29	20	49	0	3	52	0	0
20	50999024	.	C	G	16	28	44	0	6	50	0	0
20	50999297	.	C	A	2	6	8	0	0	8	0	0
20	50999311	.	T	C	2	3	5	0	0	5	0	0
20	51046115	.	C	G	2	2	4	0	0	4	0	0
20	51069662	.	G	A	10	6	16	0	0	16	0	0
20	51069864	.	A	G	6	1	7	0	5	12	0	0
20	51070017	.	A	G	8	11	19	0	0	19	0	0
20	51073334	.	T	A	8	9	17	0	1	18	0	0
20	51073369	.	A	T	13	6	19	0	0	19	0	0
20	51073449	.	G	A	0	7	7	0	12	19	0	0
20	51073692	.	G	A	8	8	16	0	0	16	0	0
20	51073783	.	G	A	6	12	18	0	0	18	0	0
20	51073800	.	G	A	6	12	18	0	1	19	0	0
20	51074317	.	C	T	5	3	8	0	1	9	0	0
20	51074352	.	A	T	5	3	8	0	1	9	0	0
20	51076822	.	G	A	1	3	4	0	0	4	0	0
20	51077133	.	A	T	1	2	3	0	0	3	0	0
20	51077187	.	A	G	4	2	6	0	0	6	0	0
20	51077210	.	T	A	3	2	5	0	0	5	0	0
20	51077826	.	A	T	2	2	4	0	0	4	0	0
20	51077844	.	A	G	2	2	4	0	0	4	0	0
20	51088683	.	G	A	21	17	38	0	0	38	0	0
20	51088802	.	A	T	40	23	63	0	4	67	0	0
20	51088920	.	C	T	29	28	57	0	4	61	0	0
20	51088967	.	C	A	22	32	54	0	4	58	0	0
20	51089054	.	T	C	27	15	42	0	5	47	0	0
20	51089236	.	T	C	28	1	29	4	24	57	0	0
20	51089243	.	T	C	24	27	51	4	4	59	0	0
20	51089332	.	T	C	21	21	42	0	8	50	0	0
20	51089559	.	G	A	32	20	52	0	2	55	1	0
20	51089877	.	G	A	28	14	42	0	2	44	0	0
20	51089883	.	A	G	26	18	44	0	1	45	0	0
20	51089919	.	A	G	30	29	59	0	3	62	0	0
20	51100498	.	T	C	6	8	14	0	0	14	0	0
20	51112208	.	C	T	15	12	27	0	2	29	0	0
20	51117664	.	G	A	18	14	32	0	3	35	0	0
20	51117706	.	C	G	20	1	21	0	20	41	0	0
20	51118314	.	T	C	27	21	48	0	3	51	0	0
20	51123088	.	C	T	15	20	35	0	0	35	0	0
20	51123151	.	A	T	14	17	31	0	0	31	0	0
20	51132127	.	C	G	13	7	20	0	1	21	0	0
20	51132208	.	A	G	25	15	40	0	2	42	0	0
20	51132219	.	A	G	24	14	38	0	3	41	0	0
20	51145837	.	A	G	11	9	20	0	1	21	0	0
20	51145888	.	T	C	9	0	9	0	13	22	0	0
20	51146152	.	T	G	8	12	20	0	1	21	0	0
20	51146194	.	A	G	10	11	21	0	0	21	0	0
20	51157061	.	C	T	2	16	18	0	7	25	0	0
20	51157082	.	T	C	11	14	25	0	1	26	0	0
20	51168559	.	A	T	8	4	12	0	0	12	0	0
20	51199791	.	T	C	29	31	60	0	5	65	0	0
20	51200015	.	C	T	34	20	54	0	7	61	0	0
20	51204759	.	C	T	28	36	64	0	5	69	0	0
20	51205691	.	T	G	29	38	67	0	7	74	0	0
20	51205745	.	G	A	40	36	76	0	4	80	0	0
20	51206976	.	C	A	33	41	74	0	3	77	0	0
20	51207030	.	C	T	45	33	78	0	1	79	0	0
20	51207051	.	G	A	41	35	76	0	4	80	0	0
20	51207609	.	C	A	37	39	76	0	5	81	0	0
20	51207726	.	C	T	29	47	76	0	7	83	0	0
20	51211459	.	A	G	43	14	57	0	28	85	0	0
20	51274609	.	C	T	0	2	2	0	2	4	0	0
20	51283410	.	G	A	2	9	11	0	1	12	0	0
20	51283424	.	C	T	0	9	9	0	2	11	0	0
20	51312886	.	C	T	3	2	5	0	0	5	0	0
20	51312894	.	T	C	3	2	5	0	0	5	0	0
20	51313049	.	C	T	4	4	8	0	0	8	0	0
20	51332239	.	C	T	3	2	5	0	2	7	0	0
20	51332296	.	A	G	1	6	7	0	1	8	0	0
20	51332338	.	G	A	1	2	3	0	8	11	0	0
20	51332401	.	C	T	4	2	6	0	0	6	0	0
20	51333547	.	G	A	5	5	10	0	1	11	0	0
20	51333698	.	A	C	2	4	6	0	0	6	0	0
20	51334081	.	G	A	3	10	13	0	1	14	0	0
20	51334173	.	G	T	5	5	10	0	0	10	0	0
20	51334193	.	G	T	3	4	7	0	0	7	0	0
20	51334229	.	C	T	3	2	5	0	0	5	0	0
20	51377158	.	G	A	11	14	25	0	0	25	0	0
20	51377261	.	G	A	12	8	20	0	0	20	0	0
20	51383804	.	C	G	2	3	5	0	0	5	0	0
20	51386444	.	G	T	4	3	7	0	0	7	0	0
20	51475236	.	A	G	1	0	1	1	2	4	0	0
20	51489450	.	T	G	1	2	3	0	0	3	0	0
20	51647836	.	A	G	2	2	4	0	1	5	0	0
20	51647872	.	A	T	7	4	11	0	0	11	0	0
20	51648072	.	A	G	9	5	14	0	0	14	0	0
20	51648114	.	T	G	5	7	12	0	0	12	0	0
20	51648719	.	T	C	3	3	6	0	0	6	0	0
20	51649767	.	C	T	2	3	5	0	1	6	0	0
20	51649935	.	G	A	4	2	6	0	0	6	0	0
20	51702896	.	T	C	3	0	3	0	5	8	0	0
20	51702942	.	T	C	2	2	4	0	0	4	0	0
20	51703146	.	A	T	4	3	7	0	0	7	0	0
20	51703153	.	C	T	4	4	8	0	0	8	0	0
20	51703406	.	T	C	12	10	22	0	5	27	0	0
20	51703445	.	C	T	1	15	16	0	10	26	0	0
20	51703939	.	G	A	12	8	20	0	0	20	0	0
20	51713103	.	G	A	5	3	8	0	0	8	0	0
20	51720465	.	A	G	0	5	5	0	3	8	0	0
20	51723227	.	A	G	2	3	5	0	0	5	0	0
20	51743891	.	T	C	14	10	24	0	0	24	0	0
20	51745943	.	G	A	7	9	16	0	3	19	0	0
20	51749074	.	C	T	4	6	10	0	0	10	0	0
20	51753509	.	G	A	0	7	7	0	10	17	0	0
20	51753512	.	G	T	7	9	16	0	1	17	0	0
20	51753562	.	C	T	5	2	7	0	0	7	0	0
20	51753788	.	C	G	2	3	5	0	0	5	0	0
20	51758611	.	A	C	13	8	21	1	1	23	0	0
20	51759191	.	A	C	12	9	21	0	4	25	0	0
20	51759562	.	G	A	17	10	27	0	0	27	0	0
20	51763248	.	G	T	10	11	21	0	1	22	0	0
20	51787392	.	T	C	3	5	8	0	0	8	0	0
20	51794071	.	A	G	7	6	13	0	1	14	0	0
20	51799178	.	G	T	1	4	5	0	1	6	0	0
20	51802242	.	G	A	3	8	11	0	1	12	0	0
20	51807785	.	A	G	4	6	10	0	0	10	0	0
20	51821154	.	G	A	2	2	4	0	0	4	0	0
20	51822544	.	C	T	0	2	2	0	1	3	0	0
20	51822557	.	C	A	1	2	3	0	0	3	0	0
20	51856586	.	G	A	1	2	3	0	1	4	0	0
20	51873991	.	C	A	4	2	6	0	0	6	0	0
20	51873999	.	G	A	2	3	5	0	0	5	0	0
20	51874222	.	T	C	2	2	4	0	0	4	0	0
20	51874225	.	G	A	2	1	3	0	1	4	0	0
20	52333070	.	A	G	1	5	6	1	0	7	0	0
20	52333385	.	G	A	7	3	10	0	0	10	0	0
20	52404347	.	G	A	4	3	7	0	0	7	0	0
20	52416080	.	C	T	2	2	4	0	0	4	0	0
20	52416107	.	C	T	1	4	5	0	0	5	0	0
20	52458800	.	G	C	3	2	5	0	1	6	0	0
20	52473266	.	C	T	5	4	9	0	0	9	0	0
20	52486247	.	G	A	4	3	7	0	0	7	0	0
20	52488094	.	A	C	1	2	3	0	0	3	0	0
20	52488106	.	G	A	1	2	3	0	0	3	0	0
20	52540721	.	A	G	3	4	7	0	0	7	0	0
20	52546252	.	C	T	20	11	31	0	1	32	0	0
20	52554022	.	G	T	10	8	18	0	1	20	1	0
20	52554065	.	A	C	13	16	29	0	0	29	0	0
20	52554222	.	G	A	9	17	26	0	0	26	0	0
20	52554283	.	C	T	10	18	28	0	1	29	0	0
20	52554547	.	A	C	18	11	29	0	1	30	0	0
20	52554685	.	A	G	17	26	43	0	1	44	0	0
20	52561670	.	A	G	30	23	53	0	1	54	0	0
20	52563215	.	C	A	27	21	48	1	6	55	0	0
20	52568373	.	C	G	8	10	18	0	2	20	0	0
20	52574900	.	G	A	4	33	37	0	20	57	0	0
20	52575020	.	A	G	32	1	33	0	36	69	0	0
20	52582594	.	A	T	9	3	12	1	1	14	0	0
20	52907598	.	T	C	1	0	1	0	5	6	0	0
20	52907631	.	A	T	1	7	8	0	0	8	0	0
20	53074579	.	G	A	6	5	11	0	0	11	0	0
20	53074615	.	T	C	2	0	2	0	4	6	0	0
20	53181085	.	C	T	4	4	8	0	2	10	0	0
20	53181091	.	G	A	1	4	5	0	4	9	0	0
20	53215338	.	A	G	9	0	9	2	5	16	0	0
20	53224594	.	C	T	9	5	14	0	1	15	0	0
20	53230903	.	G	T	1	12	13	0	6	19	0	0
20	53262237	.	G	T	0	10	10	0	7	17	0	0
20	53262283	.	C	T	11	7	18	0	1	19	0	0
20	53302300	.	G	A	2	4	6	0	1	7	0	0
20	53318814	.	G	T	4	5	9	0	0	9	0	0
20	53365862	.	C	T	3	2	5	0	0	5	0	0
20	53377661	.	A	G	4	1	5	0	8	13	0	0
20	53377691	.	G	A	4	5	9	0	1	10	0	0
20	53384643	.	A	G	3	5	8	0	1	9	0	0
20	53391922	.	G	T	6	4	10	0	0	10	0	0
20	53393594	.	T	C	8	12	20	0	0	20	0	0
20	53393669	.	C	A	9	8	17	0	1	18	0	0
20	53398790	.	C	T	10	5	15	0	1	16	0	0
20	53408347	.	A	G	2	2	4	0	0	4	0	0
20	53408394	.	A	C	1	3	4	0	0	4	0	0
20	53639931	.	C	A	3	11	14	0	1	15	0	0
20	53640199	.	A	T	1	3	4	1	2	7	0	0
20	53640200	.	T	C	1	4	5	1	1	7	0	0
20	53641462	.	T	C	6	12	18	1	1	20	0	0
20	53803637	.	C	T	7	7	14	0	0	14	0	0
20	53803783	.	T	A	3	4	7	0	3	10	0	0
20	53804342	.	A	G	9	4	13	0	1	14	0	0
20	53804470	.	G	A	4	5	9	0	0	11	2	0
20	53898770	.	C	T	1	20	21	0	13	34	0	0
20	53898930	.	G	A	13	8	21	0	1	22	0	0
20	53898968	.	A	T	19	13	32	0	2	34	0	0
20	53899023	.	G	C	14	25	39	0	0	39	0	0
20	53899035	.	G	A	13	25	38	0	4	42	0	0
20	53899063	.	G	A	26	8	34	0	1	35	0	0
20	53899104	.	A	C	17	2	19	0	13	32	0	0
20	53901098	.	T	A	4	7	11	0	1	12	0	0
20	53901136	.	G	C	5	7	12	1	2	15	0	0
20	53903856	.	T	C	4	10	14	1	2	17	0	0
20	53930457	.	G	A	1	2	3	0	0	3	0	0
20	53930466	.	C	T	0	3	3	0	1	4	0	0
20	53968126	.	A	G	22	32	54	0	2	56	0	0
20	53968273	.	A	G	28	14	42	3	0	45	0	0
20	53970281	.	C	T	16	20	36	1	4	41	0	0
20	53974508	.	T	C	6	9	15	0	1	17	1	0
20	53974565	.	G	A	7	11	18	0	0	18	0	0
20	53974580	.	G	A	9	12	21	0	0	21	0	0
20	53981487	.	C	T	5	9	14	1	0	15	0	0
20	53981577	.	T	G	6	2	8	0	0	8	0	0
20	54067345	.	A	G	5	6	11	0	3	14	0	0
20	54067639	.	G	A	15	8	23	0	0	23	0	0
20	54067894	.	G	A	4	3	7	0	0	7	0	0
20	54067908	.	G	A	4	3	7	0	0	7	0	0
20	54196604	.	A	G	1	1	2	0	0	2	0	0
20	54196615	.	C	T	3	2	5	0	0	5	0	0
20	54196791	.	T	C	14	0	14	0	16	30	0	0
20	54197263	.	G	C	14	19	33	0	2	35	0	0
20	54197287	.	A	T	23	12	35	0	0	35	0	0
20	54197383	.	G	A	16	17	33	0	0	33	0	0
20	54197473	.	A	G	18	9	27	0	0	27	0	0
20	54205704	.	C	T	35	26	61	0	5	66	0	0
20	54215115	.	A	G	11	13	24	0	4	28	0	0
20	54219286	.	T	C	36	0	36	0	23	59	0	0
20	54232738	.	A	G	20	19	39	0	2	41	0	0
20	54232772	.	G	C	19	2	21	0	21	42	0	0
20	54233207	.	T	C	16	0	16	0	10	26	0	0
20	54236421	.	A	C	9	7	16	0	0	16	0	0
20	54236423	.	G	A	9	7	16	0	0	16	0	0
20	54249577	.	G	C	19	23	42	0	1	44	1	0
20	54251406	.	T	C	21	24	45	0	2	47	0	0
20	54274516	.	T	C	8	5	13	0	1	14	0	0
20	54274521	.	A	T	9	3	12	0	1	13	0	0
20	54278190	.	C	T	5	5	10	0	1	11	0	0
20	54282796	.	A	G	6	12	18	0	2	20	0	0
20	54283025	.	G	T	1	7	8	0	13	21	0	0
20	54283659	.	A	G	15	0	15	0	8	23	0	0
20	54283695	.	A	G	21	10	31	0	1	32	0	0
20	54286797	.	G	T	21	5	26	0	4	30	0	0
20	54334389	.	C	G	1	0	1	0	3	4	0	0
20	54334417	.	G	T	1	2	3	0	2	5	0	0
20	54334478	.	C	T	1	3	4	0	2	6	0	0
20	54340260	.	G	C	5	6	11	0	1	12	0	0
20	54340285	.	C	T	8	3	11	0	0	11	0	0
20	54340359	.	G	A	0	2	2	0	3	5	0	0
20	54340700	.	T	C	1	2	3	0	0	3	0	0
20	54340990	.	G	A	0	4	4	0	1	5	0	0
20	54341203	.	T	A	4	6	10	0	1	11	0	0
20	54341210	.	A	G	7	4	11	0	0	11	0	0
20	54341252	.	A	G	6	4	10	0	0	10	0	0
20	54341438	.	C	T	2	3	5	0	0	5	0	0
20	54341453	.	C	T	2	3	5	0	0	5	0	0
20	54342388	.	A	G	1	7	8	0	1	9	0	0
20	54342674	.	T	C	3	5	8	0	0	8	0	0
20	54343496	.	G	A	11	6	17	0	1	18	0	0
20	54343695	.	A	T	9	6	15	0	0	15	0	0
20	54343720	.	A	T	9	6	15	0	0	15	0	0
20	54343866	.	G	A	7	4	11	0	0	11	0	0
20	54344125	.	C	A	2	8	10	0	0	10	0	0
20	54344373	.	T	G	6	7	13	0	1	14	0	0
20	54344386	.	T	A	8	5	13	0	1	14	0	0
20	54344533	.	G	A	9	11	20	0	2	22	0	0
20	54344711	.	A	G	12	0	12	0	9	21	0	0
20	54344795	.	G	A	10	7	17	0	0	17	0	0
20	54344815	.	G	T	5	6	11	0	2	13	0	0
20	54344900	.	T	G	7	6	13	0	0	13	0	0
20	54345798	.	C	T	2	2	4	0	3	7	0	0
20	54345895	.	C	T	11	19	30	0	1	31	0	0
20	54346124	.	A	T	12	7	19	0	1	20	0	0
20	54346361	.	A	G	1	4	5	0	2	7	0	0
20	54350102	.	C	T	8	5	13	0	0	13	0	0
20	54354804	.	A	G	1	3	4	0	0	4	0	0
20	54354813	.	T	G	1	3	4	0	0	4	0	0
20	54355807	.	A	G	11	0	11	0	10	21	0	0
20	54357955	.	C	T	20	11	31	0	1	32	0	0
20	54358601	.	A	G	2	0	2	0	7	9	0	0
20	54360077	.	T	G	16	0	16	0	8	24	0	0
20	54360143	.	G	A	5	3	8	0	0	8	0	0
20	54360148	.	G	T	0	2	2	0	5	7	0	0
20	54360359	.	T	G	1	2	3	0	0	3	0	0
20	54360818	.	C	T	2	4	6	0	0	6	0	0
20	54360901	.	G	A	2	2	4	0	0	4	0	0
20	54360939	.	G	A	1	2	3	0	0	3	0	0
20	54360940	.	A	G	1	2	3	0	0	3	0	0
20	54397846	.	A	G	3	0	3	1	4	8	0	0
20	54398005	.	G	A	1	3	4	0	6	10	0	0
20	54398242	.	C	T	7	4	11	0	1	12	0	0
20	54398449	.	G	A	0	8	8	0	4	12	0	0
20	54402121	.	C	T	6	9	15	2	0	17	0	0
20	54402157	.	G	T	0	6	6	0	9	15	0	0
20	54402211	.	G	A	1	4	5	0	13	19	1	0
20	54402346	.	G	A	9	2	11	0	4	15	0	0
20	54402400	.	C	G	11	1	12	0	11	23	0	0
20	54402553	.	C	T	15	18	33	0	0	33	0	0
20	54406954	.	G	A	24	13	37	0	1	38	0	0
20	54407196	.	G	A	2	14	16	0	21	37	0	0
20	54422636	.	G	A	19	19	38	2	3	43	0	0
20	54422780	.	C	G	13	8	21	0	0	21	0	0
20	54422796	.	T	C	15	5	20	0	0	20	0	0
20	54422830	.	T	C	13	0	13	0	9	22	0	0
20	54422868	.	T	G	16	11	27	0	1	28	0	0
20	54422884	.	G	A	13	11	24	0	1	25	0	0
20	54422909	.	C	T	12	14	26	0	0	26	0	0
20	54422929	.	G	A	9	11	20	0	5	25	0	0
20	54423005	.	T	C	17	9	26	1	0	27	0	0
20	54423217	.	C	T	2	8	10	0	20	30	0	0
20	54434895	.	G	A	10	13	23	0	3	26	0	0
20	54434918	.	C	T	8	17	25	0	3	28	0	0
20	54441757	.	A	C	27	35	62	0	2	64	0	0
20	54446877	.	G	A	31	23	54	0	1	55	0	0
20	54462151	.	G	C	23	17	40	0	0	40	0	0
20	54525439	.	T	C	5	8	13	0	0	13	0	0
20	54563425	.	A	G	15	10	25	0	0	25	0	0
20	54563995	.	G	A	8	3	11	0	0	11	0	0
20	54563998	.	G	C	6	3	9	0	0	9	0	0
20	54670746	.	T	C	1	2	3	0	0	3	0	0
20	54670770	.	T	G	1	3	4	0	0	4	0	0
20	54670966	.	A	G	3	3	6	0	2	8	0	0
20	54670984	.	T	A	2	6	8	0	1	9	0	0
20	54671032	.	A	C	4	7	11	0	0	11	0	0
20	54671864	.	T	G	2	1	3	0	1	4	0	0
20	54671989	.	G	A	0	5	5	0	1	6	0	0
20	54672009	.	A	C	1	6	7	0	0	7	0	0
20	54672839	.	A	G	4	0	4	0	7	11	0	0
20	54672869	.	T	C	5	6	11	0	1	12	0	0
20	54672891	.	T	C	5	5	10	0	1	11	0	0
20	54672974	.	G	A	0	5	5	0	10	15	0	0
20	54673175	.	T	C	4	2	6	0	1	7	0	0
20	54673198	.	T	A	5	3	8	0	1	9	0	0
20	54675294	.	T	C	6	5	11	0	0	11	0	0
20	54675308	.	C	G	6	1	7	0	5	12	0	0
20	54675356	.	C	T	5	11	16	0	1	17	0	0
20	54675391	.	T	C	6	9	15	0	0	15	0	0
20	54676529	.	A	G	6	0	6	0	17	23	0	0
20	54676532	.	T	G	6	18	24	0	0	24	0	0
20	54676583	.	C	T	11	3	14	0	1	15	0	0
20	54681734	.	G	A	9	10	19	0	0	19	0	0
20	54681797	.	T	A	8	12	20	0	0	20	0	0
20	54698791	.	C	T	6	4	10	0	0	10	0	0
20	54708193	.	T	C	10	6	16	0	1	17	0	0
20	54708277	.	G	A	1	6	7	0	10	17	0	0
20	54711535	.	G	C	5	2	7	0	1	8	0	0
20	54738249	.	C	G	5	4	9	1	0	10	0	0
20	54740904	.	G	A	18	10	28	0	2	30	0	0
20	54740907	.	A	G	18	0	18	0	13	31	0	0
20	54740955	.	C	T	8	14	22	0	2	24	0	0
20	54740976	.	G	T	0	11	11	0	10	21	0	0
20	54741763	.	G	A	6	8	14	0	0	14	0	0
20	54742641	.	C	G	7	15	22	0	2	24	0	0
20	54742714	.	C	T	10	8	18	0	3	21	0	0
20	54742912	.	A	C	12	7	19	0	1	20	0	0
20	54743917	.	G	A	22	10	32	0	3	35	0	0
20	54743937	.	C	T	16	11	27	0	0	27	0	0
20	54744230	.	C	T	17	20	37	0	2	39	0	0
20	54744314	.	A	G	22	0	22	0	19	41	0	0
20	54744363	.	A	G	21	0	21	0	16	38	1	0
20	54744419	.	A	G	23	14	37	2	1	40	0	0
21	238575	.	T	C	8	16	24	0	0	24	0	0
21	734962	.	A	G	14	0	14	0	16	30	0	0
21	735222	.	A	G	39	0	39	2	27	68	0	0
21	1907080	.	C	T	0	3	3	0	3	6	0	0
21	1934156	.	A	G	5	2	7	0	0	7	0	0
21	1991007	.	G	T	19	12	31	0	1	32	0	0
21	1991097	.	A	G	18	15	33	0	2	35	0	0
21	1991118	.	G	A	18	17	35	0	0	35	0	0
21	1991160	.	G	A	20	17	37	0	1	38	0	0
21	1996944	.	T	C	6	18	24	0	3	27	0	0
21	2014639	.	G	A	9	10	19	0	1	20	0	0
21	2025607	.	C	T	10	5	15	0	0	15	0	0
21	2030212	.	C	T	3	2	5	0	2	7	0	0
21	2031804	.	C	T	0	5	5	0	1	6	0	0
21	2031810	.	G	T	0	5	5	0	2	7	0	0
21	2031843	.	A	G	4	7	11	0	0	11	0	0
21	2031849	.	A	G	5	6	11	0	0	11	0	0
21	2031894	.	A	G	6	4	10	0	0	10	0	0
21	2033854	.	G	A	3	4	7	0	0	7	0	0
21	2033964	.	T	G	3	4	7	0	0	7	0	0
21	2042005	.	C	T	0	1	1	0	3	4	0	0
21	2119876	.	C	T	4	0	4	0	0	4	0	0
21	2119891	.	A	G	3	2	5	0	0	5	0	0
21	2120038	.	T	C	1	5	6	0	1	7	0	0
21	2120217	.	T	A	3	2	5	0	0	5	0	0
21	2120237	.	C	A	2	3	5	0	1	6	0	0
21	2208791	.	C	T	1	2	3	0	1	4	0	0
21	2281401	.	A	G	1	2	3	0	0	3	0	0
21	2738221	.	C	T	18	15	33	0	1	34	0	0
21	5004282	.	G	A	1	1	2	0	1	3	0	0
21	5368346	.	G	A	5	8	13	1	0	14	0	0
21	5368417	.	C	T	1	8	9	0	7	16	0	0
21	5368461	.	C	T	0	10	10	0	11	21	0	0
21	5368510	.	C	T	1	8	9	0	10	19	0	0
21	5370451	.	T	A	3	11	14	0	3	17	0	0
21	5372598	.	G	A	5	6	11	0	0	11	0	0
21	5372643	.	T	C	6	4	10	0	1	11	0	0
21	5372673	.	G	A	3	3	6	0	1	7	0	0
21	5374209	.	C	T	0	3	3	0	3	7	1	0
21	5374528	.	T	C	4	2	6	0	0	6	0	0
21	5601941	.	C	T	1	3	4	0	0	4	0	0
21	5781134	.	C	T	43	27	70	0	2	72	0	0
21	5782043	.	T	C	35	3	38	0	37	75	0	0
21	5789938	.	G	A	42	30	72	0	2	74	0	0
21	5796060	.	T	C	34	29	63	1	2	66	0	0
21	5797960	.	T	C	47	17	64	0	1	65	0	0
21	5798978	.	T	A	22	29	51	0	1	52	0	0
21	5802878	.	A	G	3	2	5	1	0	6	0	0
21	5803474	.	C	T	8	11	19	0	0	19	0	0
21	5803495	.	T	C	11	7	18	0	2	20	0	0
21	5807177	.	A	C	8	18	26	0	0	26	0	0
21	5813676	.	C	T	1	2	3	0	1	4	0	0
21	5816717	.	T	A	1	4	5	0	0	5	0	0
21	5816746	.	A	G	2	3	5	0	0	5	0	0
21	5822549	.	A	G	3	4	7	0	0	7	0	0
21	5884836	.	G	A	6	30	36	0	25	61	0	0
21	5884897	.	T	A	35	22	57	0	3	60	0	0
21	5884945	.	G	A	19	21	40	0	0	40	0	0
21	5885071	.	T	G	1	2	3	2	0	5	0	0
21	5920348	.	G	C	6	4	10	0	0	10	0	0
21	5920426	.	C	T	8	3	11	0	1	13	1	0
21	5920547	.	G	T	1	3	4	1	7	12	0	0
21	5926913	.	A	T	2	2	4	0	0	4	0	0
21	5926982	.	A	G	1	2	3	0	0	3	0	0
21	5932610	.	C	T	6	3	9	0	0	9	0	0
21	5938303	.	A	T	2	3	5	0	1	6	0	0
21	5938329	.	T	A	2	2	4	0	0	4	0	0
21	5938364	.	T	C	4	3	7	0	0	7	0	0
21	5938399	.	G	T	3	4	7	0	0	7	0	0
21	5938439	.	A	G	2	0	2	0	3	5	0	0
21	5942661	.	G	T	8	2	10	0	1	11	0	0
21	5942868	.	T	G	9	11	20	0	2	22	0	0
21	5942906	.	C	A	14	10	24	0	0	24	0	0
21	5942927	.	C	T	8	12	20	0	0	20	0	0
21	5948087	.	G	A	1	3	4	0	0	4	0	0
21	5966657	.	G	A	1	6	7	0	1	8	0	0
21	5971630	.	C	A	14	0	14	0	1	15	0	0
21	5971638	.	C	A	7	5	12	0	1	13	0	0
21	5971839	.	A	T	10	5	15	0	0	15	0	0
21	5971949	.	A	T	10	5	15	0	0	15	0	0
21	5971983	.	C	T	9	6	15	0	2	17	0	0
21	5972087	.	G	T	3	9	12	0	13	25	0	0
21	5972092	.	T	C	14	7	21	0	0	21	0	0
21	5972252	.	A	G	9	7	16	0	3	19	0	0
21	5972543	.	C	T	8	5	13	0	0	13	0	0
21	5972631	.	T	A	5	4	9	0	0	9	0	0
21	5979362	.	C	T	2	3	5	0	0	5	0	0
21	5979366	.	G	A	2	3	5	0	0	5	0	0
21	5982357	.	A	G	1	2	3	0	0	3	0	0
21	6120009	.	C	T	1	2	3	0	0	3	0	0
21	6133407	.	G	A	4	5	9	0	0	9	0	0
21	6133434	.	G	A	0	6	6	0	5	11	0	0
21	6133588	.	T	C	4	3	7	0	0	7	0	0
21	6133996	.	T	G	1	2	3	0	0	3	0	0
21	6134098	.	A	T	2	4	6	0	0	6	0	0
21	6134154	.	A	G	2	0	2	0	2	4	0	0
21	6134155	.	A	G	1	2	3	0	1	4	0	0
21	6134234	.	T	C	2	3	5	0	0	5	0	0
21	6134238	.	G	T	0	3	3	1	2	6	0	0
21	6137579	.	C	T	11	9	20	0	0	20	0	0
21	6145991	.	G	A	9	4	13	0	2	15	0	0
21	6147499	.	C	T	9	10	19	0	1	20	0	0
21	6148091	.	G	A	3	9	12	0	12	24	0	0
21	6149938	.	T	C	19	21	40	0	2	42	0	0
21	6150113	.	T	A	7	6	13	0	0	13	0	0
21	6417761	.	C	T	3	2	5	0	0	5	0	0
21	10284802	.	T	C	3	2	5	0	0	5	0	0
21	11493661	.	A	G	44	13	57	0	1	58	0	0
21	11494536	.	A	G	16	1	17	0	49	66	0	0
21	11501975	.	A	G	24	30	54	1	3	58	0	0
21	11502056	.	A	G	47	19	66	0	1	67	0	0
21	11502143	.	A	G	11	57	68	0	2	70	0	0
21	11774469	.	T	C	5	2	7	0	0	7	0	0
21	13611849	.	G	A	3	6	9	0	0	9	0	0
21	13612174	.	T	A	8	7	15	0	0	15	0	0
21	13612559	.	A	T	5	3	8	0	0	8	0	0
21	13613001	.	T	C	7	3	10	0	0	10	0	0
21	13613172	.	C	T	0	2	2	0	3	5	0	0
21	13613232	.	G	A	2	2	4	0	0	4	0	0
21	13613523	.	A	G	4	3	7	0	0	7	0	0
21	13613532	.	C	T	4	3	7	0	0	7	0	0
21	13614075	.	T	C	2	2	4	0	0	4	0	0
21	13614077	.	C	T	2	2	4	0	0	4	0	0
21	13615217	.	T	C	2	0	2	0	5	7	0	0
21	13619823	.	C	T	0	3	3	0	2	5	0	0
21	13702751	.	A	T	18	16	34	0	1	35	0	0
21	13714602	.	T	C	13	13	26	0	2	28	0	0
21	13714603	.	G	A	15	13	28	0	0	28	0	0
21	13715285	.	T	A	21	15	36	0	1	37	0	0
21	13715347	.	T	A	16	10	26	0	1	27	0	0
21	13715356	.	A	G	17	9	26	0	0	26	0	0
21	13751205	.	G	C	6	10	16	0	0	16	0	0
21	13771269	.	G	T	1	2	3	0	0	3	0	0
21	13794602	.	C	T	4	2	6	0	0	6	0	0
21	13794652	.	G	T	6	2	8	0	0	8	0	0
21	13796033	.	G	A	4	5	9	0	1	10	0	0
21	13796141	.	A	T	6	2	8	0	1	9	0	0
21	13796743	.	A	G	8	7	15	0	3	18	0	0
21	13895741	.	C	T	27	18	45	0	1	46	0	0
21	13895799	.	C	A	26	19	45	0	2	47	0	0
21	13895849	.	G	A	1	18	19	0	22	41	0	0
21	13895862	.	A	C	19	23	42	0	3	45	0	0
21	13909005	.	T	C	27	36	63	0	1	64	0	0
21	13919482	.	C	T	17	23	40	0	4	44	0	0
21	13919498	.	C	A	21	20	41	0	6	47	0	0
21	13920204	.	G	C	2	27	29	0	40	69	0	0
21	13920308	.	C	T	37	27	64	0	7	71	0	0
21	13920510	.	G	A	5	45	50	0	28	78	0	0
21	13920648	.	G	A	6	36	42	0	25	67	0	0
21	13980445	.	T	A	7	10	17	0	2	19	0	0
21	13980490	.	T	C	8	9	17	0	1	18	0	0
21	13980516	.	G	A	7	5	12	0	0	12	0	0
21	13980743	.	A	G	3	8	11	0	0	11	0	0
21	13981564	.	C	T	0	2	2	0	3	5	0	0
21	13981620	.	C	T	0	4	4	0	6	10	0	0
21	13981746	.	G	A	3	3	6	0	0	6	0	0
21	13981973	.	C	T	0	5	5	0	2	7	0	0
21	13981980	.	T	C	3	3	6	0	1	7	0	0
21	13982154	.	G	A	4	2	6	0	0	6	0	0
21	13982163	.	C	T	0	3	3	0	4	7	0	0
21	13982689	.	T	C	2	2	4	0	0	4	0	0
21	13982764	.	A	T	1	3	4	0	0	4	0	0
21	13983155	.	G	T	1	4	5	0	0	5	0	0
21	13983649	.	G	T	2	2	4	0	0	4	0	0
21	13983757	.	G	A	3	3	6	0	2	8	0	0
21	13995753	.	T	C	0	0	0	0	5	5	0	0
21	13995761	.	A	G	0	2	2	0	3	5	0	0
21	14217519	.	C	A	7	5	12	1	2	15	0	0
21	14217595	.	T	C	5	9	14	0	1	15	0	0
21	14217612	.	T	C	14	0	14	0	6	21	1	0
21	14217657	.	T	G	17	11	28	0	0	28	0	0
21	14217664	.	T	C	10	1	11	0	18	29	0	0
21	14217762	.	G	T	10	5	15	0	1	16	0	0
21	14224135	.	A	T	9	6	15	0	1	16	0	0
21	14224168	.	C	T	8	6	14	0	0	14	0	0
21	14226528	.	C	T	2	5	7	0	0	7	0	0
21	14226571	.	T	A	7	5	12	0	0	12	0	0
21	14226601	.	C	T	1	11	12	0	10	22	0	0
21	14226685	.	C	T	11	7	18	0	0	18	0	0
21	14228943	.	C	T	4	8	12	0	0	12	0	0
21	14232498	.	G	A	5	3	8	0	0	8	0	0
21	14235495	.	A	G	2	4	6	0	0	6	0	0
21	14241936	.	C	A	1	2	3	0	0	3	0	0
21	14250993	.	T	C	4	3	7	0	0	7	0	0
21	14251128	.	G	T	3	5	8	0	0	8	0	0
21	14254590	.	T	A	1	2	3	0	0	3	0	0
21	14381335	.	G	A	2	3	5	0	0	5	0	0
21	14381356	.	C	T	0	3	3	0	3	6	0	0
21	14381422	.	G	A	1	2	3	0	0	3	0	0
21	14381440	.	G	A	2	2	4	0	0	4	0	0
21	14644363	.	T	C	11	6	17	0	1	18	0	0
21	14644567	.	G	A	8	8	16	0	2	18	0	0
21	14644702	.	A	T	13	7	20	0	0	20	0	0
21	14644704	.	A	T	8	12	20	0	1	21	0	0
21	14644814	.	C	T	10	12	22	0	0	22	0	0
21	14644869	.	C	G	9	15	24	0	1	25	0	0
21	14644885	.	A	T	10	19	29	0	0	29	0	0
21	14644917	.	T	G	15	11	26	0	0	26	0	0
21	14644949	.	C	T	1	12	13	0	7	20	0	0
21	14644969	.	A	G	14	8	22	0	1	23	0	0
21	14645006	.	G	A	12	11	23	0	0	23	0	0
21	14645021	.	G	A	9	15	24	0	1	25	0	0
21	14645125	.	A	G	10	6	16	2	1	19	0	0
21	14645490	.	C	T	5	5	10	0	3	15	2	0
21	14645574	.	C	T	11	7	18	0	0	18	0	0
21	14645724	.	G	T	13	21	34	0	1	35	0	0
21	14645728	.	A	G	11	20	31	0	3	34	0	0
21	14645873	.	C	T	17	13	30	0	1	31	0	0
21	14654497	.	G	A	6	2	8	0	0	8	0	0
21	14657314	.	C	T	1	11	12	0	6	18	0	0
21	14659462	.	T	A	7	8	15	0	0	15	0	0
21	14659828	.	A	T	4	6	10	0	0	10	0	0
21	14659997	.	T	C	2	5	7	0	0	7	0	0
21	14660973	.	A	G	3	2	5	0	0	5	0	0
21	14663853	.	C	G	8	2	10	0	1	11	0	0
21	14664425	.	T	C	3	4	7	0	2	9	0	0
21	14664752	.	G	A	6	3	9	0	0	9	0	0
21	14664851	.	T	C	4	7	11	0	0	11	0	0
21	14665152	.	G	A	3	6	9	0	0	9	0	0
21	14665397	.	C	A	2	2	4	0	0	4	0	0
21	14665427	.	C	T	1	2	3	0	0	3	0	0
21	14665510	.	C	A	4	5	9	0	1	10	0	0
21	14701803	.	G	A	6	8	14	0	1	15	0	0
21	14701890	.	A	G	6	5	11	0	1	12	0	0
21	14701897	.	G	A	8	7	15	0	1	16	0	0
21	14701953	.	T	C	7	0	7	0	5	12	0	0
21	14702073	.	C	G	3	3	6	0	0	6	0	0
21	14702076	.	C	T	3	3	6	0	0	6	0	0
21	14702193	.	C	T	2	2	4	0	0	4	0	0
21	14702211	.	C	T	0	2	2	0	2	4	0	0
21	14704871	.	G	A	1	7	8	0	0	8	0	0
21	17192901	.	C	A	4	3	7	0	0	7	0	0
21	17241789	.	G	A	2	7	9	0	0	9	0	0
21	17243160	.	C	T	2	3	5	0	0	5	0	0
21	17246756	.	G	A	8	9	17	0	0	17	0	0
21	17253268	.	A	G	3	7	10	0	0	10	0	0
21	17255773	.	C	T	5	10	15	0	0	15	0	0
21	17256590	.	A	C	16	5	21	0	1	22	0	0
21	17258362	.	A	G	10	11	21	0	0	21	0	0
21	17258486	.	C	T	11	5	16	0	2	18	0	0
21	17258842	.	A	G	4	3	7	0	0	7	0	0
21	17258864	.	T	C	3	5	8	0	0	8	0	0
21	17259081	.	C	G	13	9	22	0	0	22	0	0
21	17259113	.	G	A	10	3	13	0	1	14	0	0
21	17259279	.	G	T	0	5	5	0	10	15	0	0
21	17259332	.	T	C	13	6	19	0	2	21	0	0
21	17259466	.	A	T	7	10	17	0	1	18	0	0
21	17322472	.	G	A	1	5	6	0	8	14	0	0
21	17322478	.	C	A	7	5	12	0	0	12	0	0
21	17322641	.	G	T	5	5	10	0	0	10	0	0
21	17325413	.	G	A	5	7	12	0	0	12	0	0
21	17325965	.	G	A	6	2	8	0	0	8	0	0
21	17327124	.	G	C	1	7	8	0	8	16	0	0
21	17327163	.	T	G	8	6	14	0	2	16	0	0
21	17327389	.	C	T	1	6	7	0	0	7	0	0
21	17327646	.	G	A	3	9	12	0	1	13	0	0
21	17333807	.	G	C	8	3	11	0	0	11	0	0
21	17335664	.	G	A	1	6	7	0	0	7	0	0
21	17335676	.	G	A	0	6	6	0	3	9	0	0
21	17335709	.	C	T	4	2	6	0	0	6	0	0
21	17337865	.	C	T	10	6	16	0	2	18	0	0
21	17337898	.	A	T	10	8	18	0	0	18	0	0
21	17338141	.	T	G	11	12	23	0	0	23	0	0
21	17338593	.	G	A	9	4	13	0	1	14	0	0
21	17338963	.	T	C	8	10	18	0	3	21	0	0
21	17339001	.	C	A	5	11	16	0	0	16	0	0
21	17339002	.	A	T	5	11	16	0	0	16	0	0
21	17339044	.	C	A	11	12	23	0	0	23	0	0
21	17339132	.	G	A	0	10	10	0	4	14	0	0
21	17339767	.	A	T	4	3	7	0	1	8	0	0
21	17413852	.	C	T	5	4	9	0	1	10	0	0
21	17419933	.	A	T	1	5	6	0	0	6	0	0
21	17419958	.	C	T	1	8	9	0	1	10	0	0
21	17420492	.	G	A	4	3	7	0	0	7	0	0
21	17420960	.	A	C	3	3	6	0	0	6	0	0
21	17478552	.	T	A	3	2	5	0	0	5	0	0
21	17478656	.	G	C	7	8	15	0	0	15	0	0
21	17480167	.	G	A	9	15	24	0	0	24	0	0
21	17480216	.	C	T	5	15	20	0	1	21	0	0
21	17482201	.	A	G	5	11	16	0	0	16	0	0
21	17568543	.	A	G	14	20	34	0	0	34	0	0
21	18950633	.	C	T	0	5	5	0	1	6	0	0
21	19006234	.	G	A	1	2	3	0	0	3	0	0
21	19008193	.	A	T	15	15	30	0	1	31	0	0
21	19008272	.	C	T	11	11	22	0	1	23	0	0
21	19008368	.	C	T	11	11	22	0	1	23	0	0
21	19008602	.	G	A	17	16	33	0	2	35	0	0
21	19008689	.	G	A	15	12	27	0	0	27	0	0
21	19008845	.	C	T	10	12	22	0	0	22	0	0
21	19009346	.	T	C	17	14	31	0	1	32	0	0
21	19009693	.	A	C	22	22	44	0	4	48	0	0
21	19010069	.	G	A	18	30	48	0	2	50	0	0
21	19010097	.	A	T	18	33	51	0	3	54	0	0
21	19010108	.	G	A	22	35	57	0	2	59	0	0
21	19013875	.	G	A	12	28	40	0	2	42	0	0
21	19014036	.	T	G	13	25	38	0	2	40	0	0
21	19014179	.	C	T	26	14	40	3	2	45	0	0
21	19014256	.	T	C	31	2	33	0	31	64	0	0
21	19014341	.	C	A	38	32	70	0	3	73	0	0
21	19014420	.	C	T	33	35	68	0	4	72	0	0
21	19014567	.	C	T	26	39	65	0	4	69	0	0
21	19014634	.	A	T	30	32	62	0	2	64	0	0
21	19014714	.	G	A	28	30	58	0	5	63	0	0
21	19014980	.	C	T	28	31	59	0	1	60	0	0
21	19015035	.	A	G	25	27	52	0	3	55	0	0
21	19015508	.	C	T	14	20	34	0	1	35	0	0
21	19017370	.	T	A	26	20	46	0	2	48	0	0
21	19018116	.	A	G	19	12	31	0	4	35	0	0
21	19018224	.	A	C	21	16	37	0	3	40	0	0
21	19018362	.	A	G	13	13	26	0	3	29	0	0
21	19018434	.	T	A	7	11	18	0	2	20	0	0
21	19061762	.	C	T	1	3	4	0	0	4	0	0
21	19063337	.	T	G	30	42	72	0	2	74	0	0
21	19066878	.	C	T	35	37	72	0	3	75	0	0
21	19067092	.	A	G	36	41	77	0	5	82	0	0
21	19073046	.	A	T	2	3	5	0	2	7	0	0
21	19073143	.	G	T	7	3	10	0	1	11	0	0
21	19073505	.	C	T	2	4	6	0	1	7	0	0
21	19073629	.	T	C	9	5	14	0	1	15	0	0
21	19324788	.	A	G	1	2	3	0	0	3	0	0
21	19328759	.	A	T	3	2	5	0	1	6	0	0
21	19329072	.	C	T	5	8	13	0	0	13	0	0
21	19329285	.	C	T	2	8	10	0	15	25	0	0
21	19329813	.	G	T	14	22	36	0	2	38	0	0
21	19345608	.	A	G	2	3	5	0	1	6	0	0
21	19441337	.	C	T	2	4	6	0	0	6	0	0
21	19602458	.	C	G	1	0	1	0	2	3	0	0
21	19763668	.	C	T	26	10	36	0	3	39	0	0
21	19763692	.	A	T	30	13	43	0	0	43	0	0
21	19763942	.	G	A	30	16	46	0	5	51	0	0
21	19764230	.	C	T	39	16	55	0	7	62	0	0
21	19764316	.	T	G	27	22	49	0	2	51	0	0
21	19764397	.	G	C	28	30	58	0	1	59	0	0
21	19764431	.	C	T	25	24	49	0	1	50	0	0
21	19764432	.	G	A	24	25	49	0	0	49	0	0
21	19764516	.	G	A	19	23	42	0	3	45	0	0
21	19764674	.	C	T	8	10	18	0	0	18	0	0
21	19764676	.	T	C	8	10	18	0	0	18	0	0
21	19765039	.	G	A	14	15	29	1	6	36	0	0
21	19785355	.	G	T	13	11	24	0	1	25	0	0
21	19785379	.	A	T	21	12	33	0	0	33	0	0
21	19792767	.	T	G	10	13	23	0	1	24	0	0
21	19795075	.	T	C	5	0	5	0	9	14	0	0
21	19804193	.	T	G	6	6	12	0	1	13	0	0
21	19805614	.	G	A	7	6	13	0	0	13	0	0
21	19807356	.	C	G	6	3	9	0	1	10	0	0
21	19872681	.	A	G	2	9	11	0	0	11	0	0
21	19904556	.	T	C	3	3	6	0	2	8	0	0
21	19904871	.	G	A	1	4	5	0	0	5	0	0
21	19911433	.	G	T	8	7	15	0	1	16	0	0
21	19911467	.	C	G	6	9	15	0	1	16	0	0
21	19945680	.	C	T	0	2	2	0	1	3	0	0
21	20039621	.	G	A	1	5	6	0	2	8	0	0
21	20039687	.	G	A	0	7	7	0	10	17	0	0
21	20080608	.	G	T	1	7	8	0	6	14	0	0
21	20089886	.	C	T	9	5	14	0	0	14	0	0
21	20101713	.	A	G	8	0	8	0	8	16	0	0
21	20103068	.	G	A	11	7	18	0	0	18	0	0
21	20103249	.	T	C	8	9	17	0	2	19	0	0
21	20106524	.	G	A	12	9	21	0	0	21	0	0
21	20106551	.	A	G	7	12	19	0	1	20	0	0
21	20108249	.	G	A	0	7	7	1	11	19	0	0
21	20108282	.	T	A	13	13	26	0	0	26	0	0
21	20108354	.	G	T	7	8	15	0	0	15	0	0
21	20108359	.	T	A	8	5	13	0	2	15	0	0
21	20113659	.	A	G	3	2	5	1	1	7	0	0
21	20113912	.	A	T	8	6	14	0	2	16	0	0
21	20114094	.	G	A	11	14	25	0	1	26	0	0
21	20114385	.	G	A	4	6	10	0	0	10	0	0
21	20395242	.	C	T	1	2	3	0	0	3	0	0
21	20633020	.	G	A	3	3	6	0	0	6	0	0
21	20633065	.	C	T	4	3	7	0	0	7	0	0
21	20633200	.	A	T	1	3	4	0	0	4	0	0
21	20633249	.	T	C	2	2	4	0	0	4	0	0
21	20634424	.	T	A	1	2	3	0	0	3	0	0
21	20635165	.	C	G	3	3	6	0	0	6	0	0
21	20635166	.	A	G	3	2	5	0	1	6	0	0
21	20635320	.	T	A	1	2	3	0	0	3	0	0
21	20635369	.	T	A	4	3	7	0	1	8	0	0
21	20635428	.	T	A	2	3	5	0	0	5	0	0
21	20636130	.	G	T	2	4	6	0	0	6	0	0
21	20636690	.	C	T	5	6	11	0	0	11	0	0
21	20914348	.	C	A	8	3	11	0	2	13	0	0
21	20915065	.	C	T	8	16	24	0	0	24	0	0
21	20915152	.	C	T	5	2	7	0	0	7	0	0
21	20916023	.	C	T	2	2	4	0	1	5	0	0
21	20919884	.	T	C	3	5	8	0	0	8	0	0
21	20933504	.	A	T	13	4	17	0	3	20	0	0
21	20933759	.	G	A	6	8	14	0	0	14	0	0
21	20933798	.	C	T	8	7	15	0	0	15	0	0
21	20938270	.	G	A	13	16	29	0	0	29	0	0
21	20938354	.	T	A	7	12	19	0	2	21	0	0
21	20938976	.	T	C	18	15	33	0	1	34	0	0
21	20938981	.	C	A	3	16	19	0	15	34	0	0
21	20939457	.	A	T	2	2	4	0	0	4	0	0
21	20950679	.	T	C	4	9	13	0	0	13	0	0
21	20950802	.	C	T	1	4	5	0	1	6	0	0
21	20950835	.	G	A	2	3	5	0	3	8	0	0
21	20951231	.	G	A	0	7	7	0	7	14	0	0
21	20951267	.	T	G	4	2	6	0	6	12	0	0
21	21017484	.	G	C	18	11	29	0	1	30	0	0
21	21017513	.	C	T	15	16	31	0	4	35	0	0
21	21017606	.	G	A	15	13	28	0	0	28	0	0
21	21020589	.	C	T	7	5	12	0	0	12	0	0
21	21028097	.	G	C	13	4	17	0	2	19	0	0
21	21049323	.	G	A	3	4	7	0	0	7	0	0
21	21051715	.	C	T	8	2	10	0	1	11	0	0
21	21057398	.	T	A	3	5	8	0	1	9	0	0
21	21065212	.	A	T	2	2	4	0	1	5	0	0
21	21069692	.	G	C	1	4	5	0	0	5	0	0
21	21072309	.	C	T	3	4	7	0	0	7	0	0
21	21079840	.	G	A	2	3	5	0	1	6	0	0
21	21079852	.	C	A	0	3	3	0	3	6	0	0
21	21170737	.	G	A	4	4	8	0	0	8	0	0
21	21170837	.	T	A	1	2	3	0	0	3	0	0
21	21170858	.	T	A	2	2	4	0	0	4	0	0
21	21170873	.	T	A	3	2	5	0	0	5	0	0
21	21230088	.	G	A	0	3	3	0	1	4	0	0
21	21233182	.	G	A	1	2	3	0	0	3	0	0
21	21233674	.	T	A	1	3	4	0	1	5	0	0
21	21235061	.	C	T	5	4	9	0	0	9	0	0
21	21236886	.	G	A	4	5	9	0	1	10	0	0
21	21236900	.	A	G	4	3	7	0	0	7	0	0
21	21238089	.	C	T	6	2	8	0	0	8	0	0
21	21238098	.	C	T	5	2	7	0	0	7	0	0
21	21238404	.	C	T	3	4	7	0	3	10	0	0
21	21239969	.	A	G	7	4	11	0	0	11	0	0
21	21240046	.	G	A	0	2	2	0	4	6	0	0
21	21240079	.	G	A	4	4	8	0	0	8	0	0
21	21240379	.	C	T	4	5	9	0	0	9	0	0
21	21240568	.	C	T	5	5	10	0	1	11	0	0
21	21241412	.	A	T	3	4	7	0	3	10	0	0
21	21241747	.	T	C	9	13	22	0	1	23	0	0
21	21269489	.	G	A	0	2	2	0	8	10	0	0
21	21269737	.	A	G	6	5	11	0	3	14	0	0
21	21269834	.	G	C	6	4	10	0	3	13	0	0
21	21277052	.	C	A	3	4	7	0	1	8	0	0
21	21279262	.	G	T	0	4	4	0	2	6	0	0
21	21279368	.	G	A	1	5	6	0	7	13	0	0
21	21279396	.	C	A	5	5	10	0	1	11	0	0
21	21279582	.	G	A	3	2	5	0	0	5	0	0
21	21279791	.	T	C	6	4	10	0	0	10	0	0
21	21294260	.	C	T	4	7	11	0	0	11	0	0
21	21294299	.	C	T	5	7	12	0	0	12	0	0
21	21294362	.	A	G	3	0	3	0	3	6	0	0
21	21295195	.	A	C	6	9	15	0	0	15	0	0
21	21297358	.	G	T	9	4	13	0	1	14	0	0
21	21297635	.	C	T	14	6	20	0	2	22	0	0
21	21297979	.	A	G	2	4	6	0	3	9	0	0
21	21298249	.	T	C	7	12	19	0	3	22	0	0
21	21298427	.	G	A	9	4	13	0	1	14	0	0
21	21298488	.	C	T	11	6	17	0	1	18	0	0
21	21298703	.	C	A	8	10	18	0	1	19	0	0
21	21298811	.	A	T	7	8	15	0	4	19	0	0
21	21298824	.	G	A	11	6	17	0	1	18	0	0
21	21343122	.	A	G	3	1	4	0	2	6	0	0
21	21343123	.	A	G	2	3	5	0	1	6	0	0
21	21343266	.	A	G	5	4	9	0	0	9	0	0
21	21347167	.	A	T	11	3	14	1	1	16	0	0
21	21450574	.	C	T	4	6	10	0	0	10	0	0
21	21451025	.	C	A	4	5	9	0	1	10	0	0
21	21513960	.	A	C	2	2	4	0	0	4	0	0
21	21525664	.	T	C	2	6	8	0	0	8	0	0
21	21525887	.	T	C	8	2	10	0	1	11	0	0
21	21525895	.	A	G	7	2	9	0	0	9	0	0
21	21633459	.	A	T	2	3	5	0	1	6	0	0
21	21633476	.	G	A	4	3	7	0	0	7	0	0
21	21633496	.	C	T	4	3	7	0	0	7	0	0
21	21633558	.	A	G	6	3	9	0	0	9	0	0
21	21633559	.	C	A	5	3	8	0	1	9	0	0
21	21633668	.	G	A	3	6	9	0	0	9	0	0
21	21633825	.	T	A	6	2	8	0	0	8	0	0
21	21640613	.	G	A	1	2	3	0	0	3	0	0
21	21744345	.	T	C	3	2	5	0	0	5	0	0
21	21745489	.	T	G	2	2	4	0	0	4	0	0
21	21745498	.	G	A	2	1	3	0	0	3	0	0
21	21745654	.	G	A	2	2	4	0	1	5	0	0
21	21750684	.	T	C	5	2	7	0	0	7	0	0
21	21750702	.	A	G	6	4	10	0	0	10	0	0
21	21754470	.	T	C	6	6	12	1	0	13	0	0
21	21754624	.	G	A	10	4	14	0	1	15	0	0
21	21794483	.	A	T	5	1	6	0	1	7	0	0
21	21820136	.	A	G	3	3	6	0	1	7	0	0
21	21820167	.	C	T	1	5	6	0	0	6	0	0
21	22038375	.	C	T	13	8	21	0	2	23	0	0
21	22073477	.	A	G	3	8	11	0	3	14	0	0
21	22082257	.	C	T	18	19	37	0	0	37	0	0
21	22099610	.	A	G	7	4	11	0	4	15	0	0
21	22101271	.	A	G	26	31	57	0	1	58	0	0
21	22101304	.	G	A	30	30	60	0	4	64	0	0
21	22101387	.	A	T	20	31	51	0	1	52	0	0
21	22101471	.	G	A	28	31	59	0	5	64	0	0
21	22101540	.	G	A	32	28	60	0	3	63	0	0
21	22101637	.	T	C	30	1	31	0	22	53	0	0
21	22101665	.	G	C	23	23	46	0	1	47	0	0
21	22101708	.	C	T	17	18	35	0	3	38	0	0
21	22101776	.	G	A	21	19	40	0	4	44	0	0
21	22101827	.	C	G	6	25	31	0	20	51	0	0
21	22101917	.	A	T	33	25	58	0	6	64	0	0
21	22102037	.	G	A	25	26	51	0	2	53	0	0
21	22102044	.	C	T	1	28	29	0	25	54	0	0
21	22102154	.	C	A	14	29	43	0	3	47	1	0
21	22102261	.	G	T	17	24	41	0	2	43	0	0
21	22102281	.	A	C	20	22	42	0	2	44	0	0
21	22102361	.	C	G	15	20	35	0	2	37	0	0
21	22102377	.	T	G	18	17	35	0	2	37	0	0
21	22102405	.	C	T	18	19	37	0	2	39	0	0
21	22102515	.	T	A	10	22	32	0	2	34	0	0
21	22102542	.	C	T	13	22	35	0	1	36	0	0
21	22102653	.	A	G	15	17	32	0	2	34	0	0
21	22102838	.	T	G	19	18	37	0	0	37	0	0
21	22102931	.	A	G	18	20	38	0	3	41	0	0
21	22110005	.	C	T	18	12	30	0	1	31	0	0
21	22110113	.	C	T	12	11	23	0	0	23	0	0
21	22111754	.	A	T	13	7	20	0	3	23	0	0
21	22116192	.	G	A	2	7	9	0	0	9	0	0
21	22116280	.	A	T	1	5	6	0	2	8	0	0
21	22116586	.	G	A	4	2	6	0	1	7	0	0
21	22116611	.	C	T	4	4	8	0	0	8	0	0
21	22120857	.	G	A	1	3	4	0	1	5	0	0
21	22121201	.	C	T	1	2	3	0	0	3	0	0
21	22132862	.	C	G	2	0	2	0	2	4	0	0
21	22135934	.	G	A	0	2	2	0	4	6	0	0
21	22138571	.	C	G	2	8	10	0	0	10	0	0
21	22140654	.	C	G	5	6	11	0	0	11	0	0
21	22140937	.	C	A	8	5	13	0	0	13	0	0
21	22142362	.	A	G	5	7	12	0	1	13	0	0
21	22142820	.	G	A	1	11	12	0	9	21	0	0
21	22309239	.	T	C	3	4	7	0	0	7	0	0
21	22330468	.	C	A	1	2	3	0	0	3	0	0
21	22330494	.	C	T	2	3	5	0	0	5	0	0
21	22330581	.	A	G	0	3	3	0	1	4	0	0
21	22330588	.	A	G	1	3	4	0	0	4	0	0
21	22346407	.	C	T	4	5	9	0	0	9	0	0
21	22346512	.	G	T	5	6	11	0	0	11	0	0
21	22347182	.	T	C	2	7	9	0	0	9	0	0
21	22347432	.	T	C	2	2	4	0	0	4	0	0
21	22386140	.	T	C	4	2	6	0	0	6	0	0
21	22386399	.	T	C	2	1	3	0	1	4	0	0
21	22388102	.	T	G	1	2	3	0	0	3	0	0
21	22391064	.	A	T	0	2	2	0	1	3	0	0
21	22394453	.	A	G	1	2	3	0	0	3	0	0
21	22394519	.	A	G	1	2	3	0	0	3	0	0
21	22405045	.	T	C	1	4	5	0	1	6	0	0
21	22407000	.	T	C	1	2	3	0	1	4	0	0
21	22410965	.	T	A	2	3	5	0	1	6	0	0
21	22412304	.	T	C	14	7	21	0	2	23	0	0
21	22412376	.	T	G	10	0	10	0	11	21	0	0
21	22421853	.	T	C	8	6	14	0	0	14	0	0
21	22422149	.	T	C	4	14	18	0	3	21	0	0
21	22422184	.	A	G	11	10	21	0	0	21	0	0
21	22422243	.	G	A	12	15	27	0	2	29	0	0
21	22422407	.	T	G	15	11	26	0	1	27	0	0
21	22447329	.	A	C	5	2	7	0	0	7	0	0
21	22447370	.	T	C	3	2	5	0	0	5	0	0
21	22447373	.	G	C	3	3	6	0	0	6	0	0
21	22448132	.	T	C	2	3	5	0	0	5	0	0
21	22448151	.	T	G	3	4	7	0	0	7	0	0
21	22448574	.	A	G	2	3	5	0	0	5	0	0
21	22448624	.	T	G	4	2	6	0	0	6	0	0
21	22448625	.	A	T	4	2	6	0	0	6	0	0
21	22448808	.	A	G	5	2	7	0	0	7	0	0
21	22479385	.	T	C	3	2	5	0	0	5	0	0
21	22479422	.	C	G	1	2	3	0	0	3	0	0
21	22549891	.	C	G	0	2	2	0	3	5	0	0
21	22630715	.	A	T	0	3	3	0	1	4	0	0
21	22630864	.	G	A	4	7	11	0	0	11	0	0
21	22631163	.	T	C	9	16	25	0	1	26	0	0
21	22631172	.	A	T	8	14	22	0	1	23	0	0
21	22633430	.	C	T	11	10	21	0	1	22	0	0
21	22633734	.	A	G	16	12	28	0	1	29	0	0
21	22633773	.	T	C	17	11	28	0	1	29	0	0
21	22634136	.	C	G	6	9	15	0	0	15	0	0
21	22634205	.	G	T	6	6	12	0	1	13	0	0
21	22634243	.	G	A	11	8	19	0	0	19	0	0
21	22634289	.	C	T	12	12	24	0	4	28	0	0
21	22697107	.	C	T	5	3	8	0	0	8	0	0
21	22697161	.	T	C	4	7	11	0	1	12	0	0
21	22698790	.	T	C	4	6	10	0	1	11	0	0
21	22699471	.	T	C	3	5	8	0	1	9	0	0
21	22699491	.	T	C	5	7	12	0	0	12	0	0
21	22699512	.	T	C	9	6	15	0	0	15	0	0
21	22699556	.	A	G	6	6	12	0	0	12	0	0
21	22699563	.	C	T	6	6	12	0	0	12	0	0
21	22699595	.	C	A	7	6	13	0	1	14	0	0
21	22699608	.	T	C	6	5	11	0	0	12	1	0
21	22699631	.	C	T	6	2	8	0	3	11	0	0
21	22699916	.	G	A	2	10	12	0	0	12	0	0
21	22699956	.	T	G	6	6	12	0	0	12	0	0
21	22702816	.	T	C	11	3	14	0	2	16	0	0
21	22704918	.	G	A	11	3	14	0	0	14	0	0
21	22704924	.	C	T	11	3	14	0	0	14	0	0
21	22706396	.	G	T	3	4	7	0	0	7	0	0
21	22706480	.	G	A	2	2	4	0	0	4	0	0
21	22708876	.	C	A	0	2	2	0	1	3	0	0
21	22785296	.	A	G	2	0	2	0	5	7	0	0
21	22785326	.	C	T	5	4	9	0	0	9	0	0
21	22789131	.	G	A	1	4	5	0	5	10	0	0
21	22789353	.	C	T	1	3	4	0	0	4	0	0
21	22791122	.	T	C	2	4	6	0	0	6	0	0
21	22791174	.	A	C	3	4	7	0	0	7	0	0
21	22793229	.	A	G	1	0	1	0	7	8	0	0
21	22793238	.	A	G	1	6	7	0	1	8	0	0
21	22795009	.	T	C	9	4	13	0	1	14	0	0
21	22795107	.	G	A	1	6	7	0	8	15	0	0
21	22795324	.	C	T	10	12	22	0	1	23	0	0
21	22795358	.	T	G	8	12	20	0	0	20	0	0
21	22795392	.	A	T	5	8	13	0	0	13	0	0
21	22795534	.	T	C	9	3	12	0	0	12	0	0
21	22795662	.	T	A	3	3	6	0	1	7	0	0
21	22845334	.	T	C	3	2	5	0	0	5	0	0
21	22846910	.	G	A	4	4	8	0	0	8	0	0
21	22846948	.	G	A	1	7	8	0	1	9	0	0
21	22846986	.	T	C	2	8	10	0	3	13	0	0
21	22847022	.	A	T	6	4	10	0	3	13	0	0
21	22847059	.	G	C	13	11	24	0	2	26	0	0
21	22847069	.	A	G	8	12	20	0	1	21	0	0
21	22847128	.	G	C	3	11	14	0	0	14	0	0
21	22847163	.	A	G	6	10	16	0	0	16	0	0
21	22847174	.	G	C	7	12	19	0	0	19	0	0
21	22847207	.	A	G	8	7	15	0	2	17	0	0
21	22847234	.	A	G	8	11	19	0	3	22	0	0
21	22847246	.	G	A	7	12	19	0	2	21	0	0
21	22847304	.	G	A	1	12	13	0	12	25	0	0
21	22847329	.	A	G	14	9	23	0	1	24	0	0
21	22847969	.	C	T	28	16	44	0	2	46	0	0
21	22847984	.	A	T	27	15	42	0	4	46	0	0
21	22848047	.	C	T	19	15	34	0	4	38	0	0
21	22848293	.	C	T	18	10	28	0	1	29	0	0
21	22848424	.	C	T	15	14	29	0	1	30	0	0
21	22850242	.	G	A	23	23	46	0	1	47	0	0
21	22850422	.	G	A	25	25	50	0	1	51	0	0
21	22851300	.	C	A	1	2	3	0	0	3	0	0
21	22876841	.	G	T	3	2	5	0	0	5	0	0
21	22877375	.	T	A	1	2	3	0	0	3	0	0
21	22878844	.	A	C	3	5	8	0	1	9	0	0
21	22878856	.	G	A	8	7	15	0	0	15	0	0
21	22878880	.	C	A	13	10	23	0	2	25	0	0
21	22878994	.	T	C	11	10	21	0	0	21	0	0
21	22879925	.	T	A	9	6	15	0	0	15	0	0
21	22883854	.	A	T	7	10	17	0	0	17	0	0
21	22886365	.	G	A	11	25	36	0	1	37	0	0
21	22887883	.	C	T	12	10	22	0	1	23	0	0
21	22887951	.	A	G	7	9	16	0	5	21	0	0
21	22888260	.	G	T	2	2	4	0	1	5	0	0
21	22888303	.	A	G	6	4	10	0	0	10	0	0
21	22888352	.	C	T	5	6	11	0	1	12	0	0
21	22888355	.	T	A	6	6	12	0	0	12	0	0
21	22889238	.	A	C	4	2	6	0	0	6	0	0
21	22892045	.	G	T	1	2	3	0	0	3	0	0
21	22901119	.	G	A	4	3	7	0	0	7	0	0
21	22922584	.	T	C	2	2	4	0	0	4	0	0
21	22922588	.	C	A	1	3	4	0	1	5	0	0
21	22960871	.	C	T	0	2	2	0	1	3	0	0
21	22961178	.	T	C	5	6	11	0	0	11	0	0
21	22961233	.	A	T	7	6	13	0	2	15	0	0
21	22965838	.	G	A	1	6	7	0	0	7	0	0
21	22965844	.	G	A	2	6	8	0	0	8	0	0
21	22965891	.	C	A	8	3	11	0	0	11	0	0
21	23019836	.	T	G	15	22	37	0	1	38	0	0
21	23019988	.	G	A	26	14	40	0	2	42	0	0
21	23020102	.	C	G	24	14	38	0	1	39	0	0
21	23024996	.	A	G	11	10	21	0	3	24	0	0
21	23025197	.	T	A	3	4	7	0	1	8	0	0
21	23027023	.	A	T	12	12	24	0	2	26	0	0
21	23028342	.	A	G	9	9	18	0	0	18	0	0
21	23028399	.	C	T	1	9	10	0	7	17	0	0
21	23028432	.	G	A	10	15	25	0	0	25	0	0
21	23029206	.	A	G	6	4	10	0	1	11	0	0
21	23029476	.	T	A	5	6	11	0	3	14	0	0
21	23034852	.	A	G	4	5	9	0	0	9	0	0
21	23036393	.	A	T	1	3	4	0	0	4	0	0
21	23036534	.	G	A	5	2	7	0	0	7	0	0
21	23037906	.	T	C	17	14	31	0	1	32	0	0
21	23041283	.	G	A	3	4	7	0	0	7	0	0
21	23042616	.	C	T	0	3	3	0	3	6	0	0
21	23046534	.	A	T	2	2	4	0	2	6	0	0
21	23160851	.	A	T	24	9	33	0	0	33	0	0
21	23161061	.	G	A	13	16	29	0	0	29	0	0
21	23162023	.	C	T	9	10	19	0	1	20	0	0
21	23163534	.	T	C	7	0	7	0	5	12	0	0
21	23163564	.	T	A	4	8	12	0	0	12	0	0
21	23163694	.	G	A	6	11	17	0	1	18	0	0
21	23163841	.	A	T	10	5	15	0	0	15	0	0
21	23163884	.	A	G	9	4	13	0	2	15	0	0
21	23163885	.	A	G	10	4	14	0	0	14	0	0
21	23163938	.	G	T	14	9	23	1	1	25	0	0
21	23163990	.	A	T	16	9	25	1	0	26	0	0
21	23169835	.	G	A	12	16	28	1	0	29	0	0
21	23175440	.	C	T	13	4	17	0	5	22	0	0
21	23307764	.	T	A	2	2	4	0	0	4	0	0
21	23338241	.	G	A	3	5	8	0	0	8	0	0
21	23350204	.	G	A	4	5	9	0	0	9	0	0
21	23352629	.	A	G	7	5	12	0	3	15	0	0
21	23352707	.	A	G	2	7	9	0	3	12	0	0
21	23352749	.	G	A	3	2	5	0	0	5	0	0
21	23352757	.	G	T	4	0	4	0	1	5	0	0
21	23367200	.	C	T	18	12	30	0	4	34	0	0
21	23367218	.	T	G	19	9	28	0	3	32	1	0
21	23467074	.	A	G	4	5	9	0	0	9	0	0
21	24531725	.	A	T	5	4	9	0	0	9	0	0
21	24531816	.	G	T	3	2	5	0	0	5	0	0
21	24531861	.	C	G	5	3	8	0	0	8	0	0
21	24532011	.	T	A	3	3	6	0	0	6	0	0
21	24532219	.	A	G	2	5	7	0	0	7	0	0
21	24532288	.	G	A	1	3	4	0	0	4	0	0
21	24532321	.	T	C	2	3	5	0	0	5	0	0
21	24536365	.	G	T	6	2	8	0	0	8	0	0
21	24536809	.	G	A	13	18	31	0	1	32	0	0
21	24536943	.	T	C	11	4	15	0	0	15	0	0
21	24537014	.	T	A	4	3	7	0	1	8	0	0
21	24539908	.	T	A	2	3	5	0	0	5	0	0
21	24539983	.	A	G	8	7	15	0	0	15	0	0
21	24540379	.	C	A	1	6	7	0	11	18	0	0
21	24540684	.	A	G	6	9	15	0	0	15	0	0
21	24540990	.	G	C	7	5	12	0	0	12	0	0
21	24541141	.	C	T	3	6	9	0	0	9	0	0
21	24541279	.	A	G	10	8	18	0	2	20	0	0
21	24541606	.	T	A	3	3	6	0	0	6	0	0
21	24548355	.	A	G	3	2	5	0	1	6	0	0
21	25037557	.	C	A	3	3	6	0	0	6	0	0
21	25044375	.	G	A	2	7	9	0	0	9	0	0
21	25044433	.	T	A	4	4	8	0	1	9	0	0
21	25044434	.	C	A	3	4	7	0	2	9	0	0
21	25044523	.	G	A	1	2	3	0	4	7	0	0
21	25044726	.	T	C	5	5	10	0	1	11	0	0
21	25044848	.	C	G	3	5	8	0	0	8	0	0
21	25044876	.	A	T	5	8	13	0	0	13	0	0
21	25046179	.	A	G	7	0	7	0	6	13	0	0
21	25046210	.	G	C	7	5	12	0	1	13	0	0
21	25046672	.	A	G	9	3	12	0	0	12	0	0
21	25046734	.	C	T	1	5	6	0	1	7	0	0
21	25046840	.	C	T	5	6	11	0	2	13	0	0
21	25083307	.	C	T	2	2	4	0	1	5	0	0
21	25083308	.	A	C	3	2	5	0	0	5	0	0
21	25092333	.	T	G	4	4	8	0	0	8	0	0
21	25092667	.	C	T	7	3	10	0	2	12	0	0
21	25103396	.	C	A	9	4	13	0	1	14	0	0
21	25103457	.	G	A	6	4	10	0	0	10	0	0
21	25103676	.	T	A	8	5	13	0	1	14	0	0
21	25110372	.	G	A	10	6	16	0	0	16	0	0
21	25115692	.	G	T	9	14	23	0	1	24	0	0
21	25117887	.	G	T	12	4	16	0	0	16	0	0
21	25117926	.	T	C	15	4	19	0	0	19	0	0
21	25117959	.	G	A	7	16	23	0	0	23	0	0
21	25118065	.	G	A	11	8	19	0	0	19	0	0
21	25123257	.	G	T	1	2	3	0	0	3	0	0
21	25125110	.	C	T	2	2	4	0	0	4	0	0
21	25127542	.	G	A	5	3	8	0	0	8	0	0
21	25135777	.	A	G	6	0	6	0	7	13	0	0
21	25142536	.	T	A	7	9	16	0	1	17	0	0
21	25156379	.	C	T	11	6	17	0	0	17	0	0
21	25171692	.	T	C	3	6	9	0	0	9	0	0
21	25181296	.	C	G	2	2	4	0	0	4	0	0
21	25181366	.	A	G	2	4	6	0	0	6	0	0
21	25181643	.	T	A	11	13	24	0	1	25	0	0
21	25182086	.	G	A	15	7	22	0	2	25	1	0
21	25182091	.	C	A	14	9	23	0	0	23	0	0
21	25182207	.	A	T	12	10	22	0	3	25	0	0
21	25182552	.	A	T	3	11	14	0	2	16	0	0
21	25182595	.	T	C	7	8	15	0	0	15	0	0
21	25182598	.	G	A	7	8	15	0	0	15	0	0
21	25182761	.	T	C	2	10	12	0	1	13	0	0
21	25182858	.	A	C	3	8	11	0	1	12	0	0
21	25183180	.	T	C	18	6	24	0	0	24	0	0
21	25183224	.	T	A	15	7	22	1	0	23	0	0
21	25183225	.	A	G	13	6	19	1	2	22	0	0
21	25207925	.	A	G	7	7	14	0	0	14	0	0
21	25207931	.	A	G	7	7	14	0	0	14	0	0
21	25210748	.	T	G	1	8	9	0	0	9	0	0
21	25210921	.	A	G	1	7	8	0	0	8	0	0
21	25210936	.	T	C	2	0	2	0	7	9	0	0
21	25247433	.	C	A	1	9	10	0	14	24	0	0
21	25250539	.	G	A	3	4	7	0	0	7	0	0
21	25250983	.	G	A	6	7	13	0	1	14	0	0
21	25251013	.	G	A	6	6	12	0	1	13	0	0
21	25251034	.	G	T	6	7	13	0	0	13	0	0
21	25251082	.	T	C	4	3	7	0	0	7	0	0
21	25254915	.	G	C	1	2	3	0	0	3	0	0
21	25257059	.	T	C	4	2	6	0	0	6	0	0
21	25257086	.	C	T	4	4	8	0	0	8	0	0
21	25380894	.	G	T	8	3	11	0	0	11	0	0
21	25384076	.	T	C	16	20	36	1	0	37	0	0
21	25386752	.	T	C	21	19	40	0	4	44	0	0
21	25399873	.	A	G	21	23	44	0	4	48	0	0
21	25407031	.	G	C	17	1	18	0	17	35	0	0
21	25407216	.	C	G	17	20	37	0	1	38	0	0
21	25425204	.	T	C	3	3	6	0	0	6	0	0
21	25425773	.	C	A	15	11	26	0	1	27	0	0
21	25425798	.	T	C	10	13	23	0	2	25	0	0
21	25425826	.	G	T	15	12	27	0	5	32	0	0
21	25425848	.	C	A	1	21	22	0	10	32	0	0
21	25425873	.	A	T	9	20	29	0	3	32	0	0
21	25439974	.	T	A	5	3	8	0	12	21	1	0
21	25440049	.	G	A	19	20	39	0	0	39	0	0
21	25440079	.	A	C	24	1	25	0	22	47	0	0
21	25440085	.	G	A	25	20	45	0	3	48	0	0
21	25449464	.	G	A	20	15	35	0	2	37	0	0
21	25450846	.	G	A	7	11	18	0	0	18	0	0
21	25452558	.	G	A	6	14	20	0	1	21	0	0
21	25458902	.	T	A	11	4	15	1	1	17	0	0
21	25460713	.	G	A	10	12	22	0	0	22	0	0
21	25460734	.	G	A	9	13	22	0	1	23	0	0
21	25463338	.	A	G	5	12	17	0	1	18	0	0
21	25522674	.	C	T	1	5	6	0	3	9	0	0
21	25540900	.	G	A	1	2	3	0	0	3	0	0
21	25541272	.	A	G	1	2	3	0	1	4	0	0
21	25541473	.	C	T	5	4	9	0	1	10	0	0
21	25542356	.	C	A	3	4	7	0	0	7	0	0
21	25542391	.	T	C	1	3	4	0	0	4	0	0
21	25542966	.	G	T	5	5	10	0	0	10	0	0
21	25561362	.	G	A	1	7	8	0	0	8	0	0
21	25561586	.	G	A	16	15	31	0	0	31	0	0
21	25561775	.	T	C	27	0	27	0	19	46	0	0
21	25570323	.	G	A	12	11	23	0	6	29	0	0
21	25570434	.	G	A	10	16	26	0	1	27	0	0
21	25571133	.	C	A	4	8	12	0	0	12	0	0
21	25571392	.	G	A	6	7	13	0	0	13	0	0
21	25571436	.	T	A	5	10	15	0	0	15	0	0
21	25571919	.	T	C	3	9	12	0	1	13	0	0
21	25572145	.	C	T	2	6	8	0	0	8	0	0
21	25572785	.	G	T	2	5	7	0	0	7	0	0
21	25605551	.	A	G	1	2	3	0	0	3	0	0
21	25605571	.	T	A	2	4	6	0	0	6	0	0
21	25605647	.	A	G	4	5	9	0	1	10	0	0
21	25606796	.	C	T	4	7	11	0	1	12	0	0
21	25606819	.	C	G	0	6	6	0	3	9	0	0
21	25606971	.	A	G	6	5	11	0	0	11	0	0
21	25610512	.	T	C	4	0	4	0	8	12	0	0
21	25611861	.	G	A	4	5	9	0	0	9	0	0
21	25611931	.	T	C	3	3	6	0	0	6	0	0
21	25617544	.	G	C	1	2	3	0	0	3	0	0
21	25617602	.	G	C	1	2	3	0	0	3	0	0
21	25620446	.	T	C	4	3	7	0	0	7	0	0
21	25622880	.	G	A	6	2	8	0	0	8	0	0
21	25645217	.	A	C	11	7	18	0	1	19	0	0
21	25645555	.	T	G	15	14	29	0	2	31	0	0
21	25645655	.	G	C	15	14	29	0	0	29	0	0
21	25663198	.	A	G	3	0	3	0	2	5	0	0
21	25663199	.	G	C	2	2	4	0	0	4	0	0
21	25671377	.	T	C	1	5	6	0	0	6	0	0
21	25685385	.	G	T	1	2	3	0	0	3	0	0
21	25694775	.	T	A	3	3	6	0	0	6	0	0
21	25694792	.	A	C	2	3	5	0	0	5	0	0
21	25703208	.	A	C	1	4	5	0	1	6	0	0
21	25722719	.	C	T	3	4	7	0	0	7	0	0
21	25774129	.	T	C	3	3	6	0	0	6	0	0
21	25817230	.	A	G	3	5	8	0	0	8	0	0
21	25818430	.	G	A	0	3	3	0	2	5	0	0
21	25818509	.	T	C	3	2	5	0	0	5	0	0
21	25819439	.	G	A	2	4	6	0	1	7	0	0
21	26021546	.	T	C	2	2	4	0	0	4	0	0
21	26021662	.	T	A	1	4	5	0	1	6	0	0
21	26022173	.	A	T	2	2	4	1	1	6	0	0
21	26022391	.	T	C	1	0	1	0	2	3	0	0
21	26022460	.	T	A	3	2	5	0	0	5	0	0
21	26022462	.	T	G	3	2	5	0	0	5	0	0
21	26023146	.	G	A	2	6	8	0	3	11	0	0
21	26023147	.	T	A	5	6	11	0	0	11	0	0
21	26023231	.	G	A	4	9	13	0	1	14	0	0
21	26026171	.	A	G	4	3	7	0	0	7	0	0
21	26030687	.	T	C	1	2	3	0	0	3	0	0
21	26043333	.	A	G	3	2	5	0	1	6	0	0
21	26050097	.	C	T	7	2	9	0	0	9	0	0
21	26050115	.	C	T	8	4	12	0	3	15	0	0
21	26050415	.	T	G	9	8	17	0	0	17	0	0
21	26053929	.	C	A	17	14	31	0	0	31	0	0
21	26054453	.	A	G	15	3	18	0	21	39	0	0
21	26057490	.	T	A	6	11	17	0	1	18	0	0
21	26057707	.	C	T	8	12	20	1	10	31	0	0
21	26057862	.	G	C	1	3	4	0	12	16	0	0
21	26057864	.	T	G	9	3	12	0	1	16	3	0
21	26058121	.	C	T	15	10	25	0	1	26	0	0
21	26058204	.	G	A	10	10	20	0	4	24	0	0
21	26058275	.	G	T	17	16	33	0	7	40	0	0
21	26058378	.	C	T	12	7	19	0	2	21	0	0
21	26058386	.	C	A	12	7	19	0	3	22	0	0
21	26073115	.	A	T	34	26	60	0	2	62	0	0
21	26080547	.	A	G	7	3	10	0	1	11	0	0
21	26152862	.	C	T	2	7	9	0	3	12	0	0
21	26153049	.	C	T	6	8	14	0	0	14	0	0
21	26153123	.	G	A	18	14	32	0	0	32	0	0
21	26161272	.	G	A	5	2	7	0	0	7	0	0
21	26184258	.	T	A	3	7	10	0	0	10	0	0
21	26184259	.	G	T	3	7	10	0	0	10	0	0
21	26389462	.	C	T	24	20	44	0	4	48	0	0
21	26390614	.	G	A	22	22	44	0	2	47	1	0
21	26390620	.	A	G	21	21	42	0	5	47	0	0
21	26401602	.	C	A	3	4	7	0	0	7	0	0
21	26415195	.	C	T	10	13	23	0	4	27	0	0
21	26417389	.	A	T	3	3	6	0	0	6	0	0
21	26417854	.	A	T	2	4	6	0	0	6	0	0
21	26438785	.	C	T	1	2	3	0	0	3	0	0
21	26486105	.	A	G	2	2	4	0	0	4	0	0
21	26522682	.	G	A	5	3	8	0	1	9	0	0
21	26523233	.	C	T	6	9	15	0	0	15	0	0
21	26523454	.	A	T	3	7	10	0	1	11	0	0
21	26524932	.	G	T	5	4	9	0	0	9	0	0
21	26527782	.	G	A	0	9	9	0	14	23	0	0
21	26530332	.	G	A	2	7	9	0	11	20	0	0
21	26530663	.	T	A	8	15	23	0	1	24	0	0
21	26530723	.	G	T	8	8	16	0	0	16	0	0
21	26530737	.	G	C	8	8	16	0	1	17	0	0
21	26530758	.	T	C	9	6	15	0	0	15	0	0
21	26531014	.	G	A	16	11	27	0	0	27	0	0
21	26531102	.	A	G	12	14	26	0	0	26	0	0
21	26545469	.	C	T	4	3	7	0	0	7	0	0
21	26545632	.	T	C	5	2	7	0	2	9	0	0
21	26549764	.	A	G	4	7	11	0	1	12	0	0
21	26549972	.	T	C	3	3	6	0	2	9	1	0
21	26553406	.	C	T	7	4	11	0	0	11	0	0
21	26553425	.	T	C	6	4	10	0	1	11	0	0
21	26553466	.	A	G	7	7	14	0	0	14	0	0
21	26553554	.	A	C	7	4	11	0	0	11	0	0
21	26553577	.	A	T	7	4	11	0	0	11	0	0
21	26553794	.	C	T	6	7	13	0	0	13	0	0
21	26553857	.	T	A	8	4	12	0	0	12	0	0
21	26553879	.	G	T	6	7	13	0	0	13	0	0
21	26554116	.	T	C	10	5	15	0	0	15	0	0
21	26554139	.	C	T	8	5	13	0	0	13	0	0
21	26620914	.	T	C	2	2	4	0	0	4	0	0
21	26621139	.	G	A	0	2	2	0	2	4	0	0
21	26634042	.	C	T	7	11	18	0	0	18	0	0
21	26662745	.	G	A	24	25	49	0	5	54	0	0
21	26663161	.	G	C	23	32	55	0	2	57	0	0
21	26664625	.	C	T	34	32	66	0	2	68	0	0
21	26664770	.	C	T	14	22	36	0	7	43	0	0
21	26665092	.	C	T	1	10	11	0	4	15	0	0
21	26665364	.	T	A	12	15	27	0	0	27	0	0
21	26665661	.	A	G	12	16	28	0	5	33	0	0
21	26665745	.	C	A	4	22	26	0	15	42	1	0
21	26665790	.	G	A	23	23	46	0	0	46	0	0
21	26665808	.	C	T	17	25	42	0	4	46	0	0
21	26665986	.	C	A	27	14	41	0	2	43	0	0
21	26668766	.	T	A	7	9	16	0	1	17	0	0
21	26668826	.	T	G	6	4	10	0	1	11	0	0
21	26668855	.	T	C	2	2	4	0	0	4	0	0
21	26669394	.	C	T	2	5	7	0	0	7	0	0
21	26669421	.	T	C	3	7	10	0	1	11	0	0
21	26669480	.	C	A	7	5	12	0	0	12	0	0
21	26669495	.	G	A	5	3	8	0	0	8	0	0
21	26670145	.	T	C	9	0	9	1	8	18	0	0
21	26670265	.	T	A	3	3	6	0	1	7	0	0
21	26670858	.	G	A	3	4	7	0	0	7	0	0
21	26671993	.	A	G	3	7	10	0	0	10	0	0
21	26672014	.	G	A	2	3	5	0	1	6	0	0
21	26672160	.	C	T	2	4	6	0	0	6	0	0
21	26672184	.	C	T	1	4	5	0	2	7	0	0
21	26672217	.	G	C	2	3	5	0	0	5	0	0
21	26672611	.	G	A	3	2	5	0	0	5	0	0
21	26677753	.	A	T	2	3	5	0	1	6	0	0
21	26677802	.	A	T	5	2	7	0	0	7	0	0
21	26678906	.	G	A	9	9	18	0	0	18	0	0
21	26678965	.	C	T	1	12	13	0	11	24	0	0
21	26679023	.	T	C	8	3	11	0	0	11	0	0
21	26684019	.	C	T	9	5	14	0	0	14	0	0
21	26684350	.	T	A	9	6	15	0	1	16	0	0
21	26685383	.	C	T	4	8	12	0	2	14	0	0
21	26689440	.	G	A	1	4	5	0	0	5	0	0
21	26691889	.	T	C	2	6	8	0	0	8	0	0
21	26691898	.	A	T	2	4	6	0	1	7	0	0
21	26697686	.	G	T	28	37	65	2	2	69	0	0
21	26706481	.	C	T	31	33	64	0	9	73	0	0
21	26706482	.	C	T	35	35	70	0	2	72	0	0
21	26706805	.	C	T	33	27	60	0	1	61	0	0
21	26706846	.	T	A	26	19	45	0	3	48	0	0
21	26710071	.	A	G	24	14	38	0	2	40	0	0
21	26710194	.	T	A	20	17	37	0	0	37	0	0
21	26710239	.	G	A	22	13	35	0	0	35	0	0
21	26710496	.	C	A	25	25	50	0	2	52	0	0
21	26714361	.	C	T	2	15	17	0	18	35	0	0
21	26714373	.	C	A	15	14	29	0	1	30	0	0
21	26721400	.	G	A	0	5	5	0	4	9	0	0
21	26721403	.	A	T	5	5	10	0	0	10	0	0
21	26722269	.	C	T	3	2	5	0	2	7	0	0
21	26722347	.	G	A	10	10	20	0	2	22	0	0
21	26722625	.	C	T	8	4	12	0	0	12	0	0
21	26722688	.	T	A	6	5	11	0	1	12	0	0
21	26724723	.	G	A	17	14	31	0	3	34	0	0
21	26724833	.	A	G	20	18	38	0	1	39	0	0
21	26725403	.	T	C	28	13	41	0	0	41	0	0
21	26726997	.	C	A	27	28	55	0	6	61	0	0
21	26731236	.	C	A	42	31	73	0	4	77	0	0
21	26731925	.	C	A	30	40	70	0	3	73	0	0
21	26908810	.	G	A	20	16	36	0	2	38	0	0
21	26909361	.	G	A	16	16	32	0	0	32	0	0
21	26909560	.	A	C	6	0	6	0	10	16	0	0
21	26914870	.	T	G	15	10	25	0	0	25	0	0
21	26914915	.	T	G	14	9	23	0	2	25	0	0
21	26915203	.	A	G	7	5	12	0	0	12	0	0
21	26915316	.	T	G	5	6	11	0	0	11	0	0
21	26915355	.	G	A	5	4	9	0	1	10	0	0
21	26915956	.	A	T	5	2	7	0	0	7	0	0
21	26916142	.	A	G	4	4	8	0	0	8	0	0
21	26916238	.	C	T	0	4	4	0	7	11	0	0
21	26917948	.	C	T	3	6	9	0	0	9	0	0
21	26917958	.	C	T	0	6	6	0	4	10	0	0
21	26918023	.	G	A	2	3	5	0	0	5	0	0
21	26961177	.	C	T	13	16	29	0	0	29	0	0
21	26961515	.	C	T	7	8	15	0	1	16	0	0
21	26961548	.	C	A	12	10	22	0	3	25	0	0
21	26965636	.	C	T	14	9	23	0	2	25	0	0
21	26965918	.	A	T	11	16	27	0	1	28	0	0
21	26966193	.	A	T	16	10	26	0	1	27	0	0
21	26966918	.	C	T	14	7	21	0	0	21	0	0
21	26967230	.	C	T	12	9	21	0	0	21	0	0
21	26967265	.	T	A	6	14	20	0	0	20	0	0
21	26967426	.	G	A	20	18	38	0	3	41	0	0
21	26967899	.	A	C	24	26	50	0	7	57	0	0
21	26968042	.	G	A	19	18	37	0	1	38	0	0
21	26968127	.	G	T	16	21	37	0	1	38	0	0
21	26968264	.	G	A	20	18	38	0	1	39	0	0
21	26968344	.	G	A	16	9	25	0	2	27	0	0
21	26968478	.	G	A	16	12	28	0	3	31	0	0
21	26995869	.	G	A	10	9	19	0	0	19	0	0
21	26996005	.	A	G	10	15	25	0	0	25	0	0
21	26996849	.	C	A	3	29	32	0	20	52	0	0
21	26996893	.	T	C	24	0	24	0	27	51	0	0
21	27047839	.	A	T	13	6	19	0	0	19	0	0
21	27047955	.	G	A	13	6	19	0	3	22	0	0
21	27048374	.	A	G	5	3	8	0	0	8	0	0
21	27048388	.	G	A	4	3	7	0	0	7	0	0
21	27055995	.	G	A	4	3	7	0	0	7	0	0
21	27055998	.	G	T	3	3	6	0	0	6	0	0
21	27058274	.	C	G	1	2	3	0	0	3	0	0
21	27061097	.	C	T	2	1	3	0	1	4	0	0
21	27061115	.	C	T	0	3	3	0	2	5	0	0
21	27061178	.	C	T	4	2	6	0	1	7	0	0
21	27119465	.	C	T	3	3	6	0	0	6	0	0
21	27119723	.	G	A	0	5	5	0	2	7	0	0
21	27119786	.	G	A	1	2	3	0	0	3	0	0
21	27189570	.	C	A	11	10	21	0	1	22	0	0
21	27190033	.	G	A	0	10	10	0	13	23	0	0
21	27198018	.	T	G	13	11	24	0	0	24	0	0
21	27198159	.	C	T	3	20	23	0	17	40	0	0
21	27198227	.	G	T	26	19	45	2	0	47	0	0
21	27198405	.	C	T	15	11	26	0	4	30	0	0
21	27198967	.	A	G	3	5	8	0	0	8	0	0
21	27199893	.	G	A	4	8	12	0	0	12	0	0
21	27205050	.	G	A	6	11	17	0	2	19	0	0
21	27213101	.	G	A	13	14	27	0	0	27	0	0
21	27213212	.	A	G	11	10	21	0	1	22	0	0
21	27286876	.	A	T	5	2	7	0	0	7	0	0
21	27286888	.	A	G	2	3	5	0	1	6	0	0
21	27305739	.	T	G	14	12	26	0	2	28	0	0
21	27305794	.	C	T	13	10	23	0	0	23	0	0
21	27312644	.	A	G	17	12	29	0	1	30	0	0
21	27312962	.	G	A	20	16	36	0	2	38	0	0
21	27318274	.	G	T	19	26	45	0	1	46	0	0
21	27324586	.	T	A	16	15	31	0	0	31	0	0
21	27324617	.	A	C	13	14	27	0	1	28	0	0
21	27332872	.	C	A	1	1	2	0	1	3	0	0
21	27341211	.	G	A	4	2	6	0	0	6	0	0
21	27341453	.	G	A	1	3	4	0	0	4	0	0
21	27343611	.	C	T	5	6	11	0	0	11	0	0
21	27343814	.	G	A	0	2	2	0	6	8	0	0
21	27344032	.	C	T	1	3	4	0	0	4	0	0
21	27344065	.	A	G	1	2	3	0	0	3	0	0
21	27351007	.	C	T	8	11	19	0	0	19	0	0
21	27351316	.	T	C	13	9	22	0	0	22	0	0
21	27353478	.	A	G	9	7	16	0	0	16	0	0
21	27354142	.	C	A	7	10	17	0	1	18	0	0
21	27354147	.	T	C	10	12	22	0	0	22	0	0
21	27354434	.	C	A	6	12	18	0	1	19	0	0
21	27354505	.	T	C	18	7	25	0	0	25	0	0
21	27354602	.	G	T	6	4	10	0	0	10	0	0
21	27354621	.	T	G	3	5	8	0	0	8	0	0
21	27356913	.	G	A	6	2	8	0	0	8	0	0
21	27357227	.	T	A	2	2	4	0	0	4	0	0
21	27357530	.	C	T	1	6	7	0	1	8	0	0
21	27374812	.	T	C	3	5	8	0	0	8	0	0
21	27375199	.	A	G	5	4	9	0	1	10	0	0
21	27375247	.	C	T	7	10	17	0	1	18	0	0
21	27377354	.	C	A	9	12	21	0	10	31	0	0
21	27377815	.	G	A	0	6	6	0	5	11	0	0
21	27378011	.	A	C	6	5	11	0	0	11	0	0
21	27378269	.	T	A	6	7	13	0	1	14	0	0
21	27378388	.	T	G	10	6	16	0	1	17	0	0
21	27378607	.	T	A	6	8	14	0	0	14	0	0
21	27378663	.	G	A	2	7	9	0	4	13	0	0
21	27407929	.	C	T	2	2	4	0	0	4	0	0
21	27476952	.	G	T	1	4	5	0	1	6	0	0
21	27480887	.	C	T	3	2	5	0	0	5	0	0
21	27483882	.	G	A	1	5	6	0	0	6	0	0
21	27488954	.	A	G	3	3	6	0	0	6	0	0
21	27514002	.	T	A	2	2	4	0	0	4	0	0
21	27523034	.	A	G	4	2	6	0	0	6	0	0
21	27523049	.	G	A	0	2	2	0	3	5	0	0
21	27526408	.	C	T	4	4	8	0	0	8	0	0
21	27530414	.	C	A	4	2	6	0	0	6	0	0
21	27536026	.	G	A	1	9	10	0	3	13	0	0
21	27543557	.	G	A	13	8	21	0	2	23	0	0
21	27549548	.	G	A	6	5	11	0	3	14	0	0
21	27549667	.	G	A	10	8	18	0	2	20	0	0
21	27552349	.	A	G	10	0	10	0	17	27	0	0
21	27552667	.	A	G	13	0	13	0	10	23	0	0
21	27553372	.	C	A	11	15	26	0	2	28	0	0
21	27554837	.	T	C	18	6	24	0	1	25	0	0
21	27554904	.	A	G	17	10	27	0	3	30	0	0
21	27554986	.	C	T	12	8	20	0	0	20	0	0
21	27555219	.	C	G	2	3	5	0	1	6	0	0
21	27555226	.	A	G	3	0	3	0	4	7	0	0
21	27555331	.	G	A	10	7	17	0	3	20	0	0
21	27586827	.	C	T	0	2	2	0	1	3	0	0
21	27602972	.	G	T	2	2	4	0	0	4	0	0
21	27603396	.	C	T	1	3	4	0	0	4	0	0
21	27636733	.	C	A	20	21	41	0	1	42	0	0
21	27636739	.	G	A	22	18	40	0	3	43	0	0
21	27637171	.	C	T	1	20	21	0	20	41	0	0
21	27637701	.	G	A	18	14	32	0	1	33	0	0
21	27637729	.	C	A	4	14	18	0	18	36	0	0
21	27637912	.	G	A	19	21	40	0	0	40	0	0
21	27637951	.	A	G	21	20	41	0	1	42	0	0
21	27637993	.	G	A	17	22	39	0	2	41	0	0
21	27638260	.	A	G	18	9	27	0	1	28	0	0
21	27657475	.	A	G	11	16	27	0	2	29	0	0
21	27669178	.	C	T	3	3	6	0	10	16	0	0
21	27881041	.	G	T	4	2	6	0	0	6	0	0
21	27881043	.	G	C	4	0	4	0	2	6	0	0
21	27881609	.	C	T	2	3	5	0	3	8	0	0
21	27881729	.	C	T	0	3	3	0	2	5	0	0
21	28051119	.	A	G	1	2	3	0	0	3	0	0
21	28051332	.	C	T	1	2	3	0	0	3	0	0
21	28076821	.	A	G	4	3	7	0	0	7	0	0
21	28493783	.	A	T	3	3	6	0	0	6	0	0
21	28493796	.	C	T	3	4	7	0	0	7	0	0
21	28493832	.	C	T	3	2	5	0	1	6	0	0
21	28496276	.	T	C	20	14	34	0	1	35	0	0
21	28500394	.	A	G	30	40	70	0	2	73	1	0
21	28500561	.	C	T	26	25	51	1	4	56	0	0
21	28512642	.	C	T	15	11	26	0	1	27	0	0
21	28512800	.	G	T	11	7	18	0	1	19	0	0
21	28512934	.	A	G	1	2	3	0	0	3	0	0
21	28512995	.	T	C	1	2	3	0	0	3	0	0
21	30692796	.	A	G	3	3	6	0	0	6	0	0
21	30692817	.	A	G	2	0	2	0	3	5	0	0
21	30693311	.	A	G	3	5	8	0	2	10	0	0
21	30693312	.	A	G	6	2	8	0	2	10	0	0
21	31167528	.	G	T	3	3	6	0	1	7	0	0
21	31176240	.	A	G	1	3	4	0	0	4	0	0
21	31183375	.	G	A	5	7	12	0	0	12	0	0
21	31183501	.	T	C	5	12	17	0	0	17	0	0
21	31183734	.	T	C	5	8	13	0	1	14	0	0
21	31183837	.	A	T	7	9	16	0	0	16	0	0
21	31233103	.	T	A	3	9	12	0	0	12	0	0
21	31233389	.	A	G	5	7	12	0	1	13	0	0
21	31233579	.	G	C	15	5	20	0	1	21	0	0
21	31233657	.	G	A	16	13	29	0	0	29	0	0
21	31237941	.	A	G	9	11	20	0	2	22	0	0
21	31238439	.	T	C	9	5	14	0	0	14	0	0
21	31241015	.	T	C	3	9	12	0	0	12	0	0
21	32281076	.	G	A	13	9	22	0	1	23	0	0
21	32281122	.	G	A	14	17	31	0	1	32	0	0
21	32281155	.	G	A	11	15	26	0	1	27	0	0
21	32281680	.	C	T	10	17	27	0	0	27	0	0
21	32283519	.	G	A	17	8	25	0	5	30	0	0
21	32284398	.	A	G	9	6	15	0	1	16	0	0
21	32285080	.	C	T	2	4	6	0	1	7	0	0
21	32285135	.	T	C	6	0	6	0	7	13	0	0
21	32285161	.	A	G	6	3	9	0	2	11	0	0
21	32342458	.	G	A	1	3	4	0	0	4	0	0
21	32343230	.	C	A	3	3	6	0	2	8	0	0
21	32343248	.	C	A	5	8	13	0	0	13	0	0
21	32343316	.	T	A	10	7	17	0	0	17	0	0
21	32343453	.	C	T	8	5	13	0	1	14	0	0
21	32343577	.	T	C	3	8	11	0	0	11	0	0
21	32343649	.	C	A	11	6	17	0	1	18	0	0
21	32344021	.	C	A	6	8	14	0	1	15	0	0
21	32345162	.	T	C	4	10	14	0	0	14	0	0
21	32345318	.	G	A	1	7	8	0	2	10	0	0
21	32345499	.	A	G	6	7	13	0	1	14	0	0
21	32345607	.	C	T	9	8	17	0	1	18	0	0
21	32345724	.	A	G	4	9	13	1	0	14	0	0
21	32345749	.	A	G	3	9	12	1	0	13	0	0
21	32345774	.	A	T	5	9	14	1	0	15	0	0
21	32345827	.	C	A	6	3	9	0	0	9	0	0
21	32346021	.	A	C	2	6	8	0	0	8	0	0
21	32346273	.	G	A	19	19	38	0	4	42	0	0
21	32346603	.	G	C	12	20	32	0	2	35	1	0
21	32346630	.	T	C	8	17	25	0	2	27	0	0
21	32346674	.	T	A	13	11	24	0	1	25	0	0
21	32346689	.	A	G	15	9	24	0	3	27	0	0
21	32346799	.	G	A	12	12	24	0	1	25	0	0
21	32346800	.	T	A	12	12	24	0	1	25	0	0
21	32346899	.	A	G	17	9	26	0	1	27	0	0
21	32346901	.	A	G	17	10	27	0	0	27	0	0
21	32347134	.	T	A	17	18	35	0	3	38	0	0
21	32347569	.	G	T	16	8	24	0	0	24	0	0
21	32347855	.	T	C	12	9	21	0	1	22	0	0
21	32347966	.	A	C	16	0	16	0	7	23	0	0
21	32348230	.	A	T	8	7	15	0	1	16	0	0
21	32348321	.	C	A	2	3	5	0	0	5	0	0
21	32348449	.	G	A	5	4	9	0	0	9	0	0
21	32348484	.	G	A	5	5	10	0	0	10	0	0
21	32348523	.	G	A	5	6	11	0	2	13	0	0
21	32348600	.	C	T	16	9	25	0	1	26	0	0
21	32348667	.	G	C	11	8	19	1	2	22	0	0
21	32348919	.	C	T	2	10	12	0	5	17	0	0
21	32349000	.	G	A	11	11	22	0	0	22	0	0
21	32349023	.	G	C	11	9	20	0	2	22	0	0
21	32349055	.	C	T	11	12	23	0	0	23	0	0
21	32352459	.	C	G	9	7	16	0	1	17	0	0
21	32353049	.	G	A	5	6	11	0	0	11	0	0
21	32354980	.	A	G	6	6	12	0	0	12	0	0
21	32457252	.	A	G	1	7	8	0	0	8	0	0
21	32457400	.	A	G	1	2	3	0	0	3	0	0
21	32457785	.	T	C	16	11	27	0	0	27	0	0
21	32457923	.	C	A	17	23	40	0	3	43	0	0
21	32457931	.	T	G	21	17	38	0	1	39	0	0
21	32457983	.	G	A	13	20	33	0	2	35	0	0
21	32458261	.	A	G	20	27	47	0	0	47	0	0
21	32458315	.	T	A	15	23	38	0	1	40	1	0
21	32460912	.	A	G	21	16	37	0	3	40	0	0
21	32466140	.	G	C	14	12	26	0	2	28	0	0
21	32467660	.	A	G	17	15	32	0	1	33	0	0
21	32467724	.	T	C	14	11	25	0	0	25	0	0
21	32476760	.	A	G	27	23	50	0	4	54	0	0
21	32477584	.	T	C	24	20	44	0	0	44	0	0
21	32477967	.	C	T	25	23	48	0	3	51	0	0
21	32477987	.	A	T	22	17	39	0	9	48	0	0
21	32478227	.	G	T	23	24	47	1	1	49	0	0
21	32482797	.	C	T	23	22	45	0	3	48	0	0
21	32482854	.	T	C	25	2	27	1	25	53	0	0
21	32758254	.	G	A	8	7	15	0	0	15	0	0
21	32758351	.	C	T	15	3	18	0	1	19	0	0
21	32758584	.	G	A	19	13	32	0	2	34	0	0
21	32759421	.	C	T	6	3	9	0	2	11	0	0
21	32766389	.	G	A	5	6	11	0	0	11	0	0
21	33058797	.	A	C	1	2	3	0	0	3	0	0
21	33058940	.	G	C	10	7	17	0	2	19	0	0
21	33066214	.	T	G	14	11	25	0	1	26	0	0
21	33069896	.	A	G	16	9	25	0	0	25	0	0
21	33211506	.	T	A	6	16	22	0	0	22	0	0
21	33211568	.	C	T	11	9	20	0	2	22	0	0
21	33211664	.	T	G	13	8	21	0	3	24	0	0
21	33211720	.	A	T	8	9	17	1	1	19	0	0
21	33211809	.	A	T	11	15	26	0	2	28	0	0
21	33213315	.	C	T	13	12	25	0	0	25	0	0
21	33213384	.	G	A	8	4	12	0	1	13	0	0
21	33218312	.	T	C	5	4	9	0	0	9	0	0
21	33218405	.	G	A	4	5	9	0	0	9	0	0
21	33447251	.	A	G	16	20	36	0	1	37	0	0
21	33463486	.	A	G	7	7	14	0	0	14	0	0
21	34001982	.	C	T	21	11	32	0	0	32	0	0
21	34002041	.	C	A	15	15	30	0	0	30	0	0
21	34002154	.	A	C	9	8	17	0	0	17	0	0
21	34002155	.	A	T	9	7	16	0	1	17	0	0
21	34002333	.	T	C	7	6	13	0	2	15	0	0
21	34002455	.	G	A	9	7	16	0	1	17	0	0
21	34002507	.	A	G	8	9	17	0	1	18	0	0
21	34026657	.	T	C	2	3	5	0	0	5	0	0
21	34031232	.	G	A	1	2	3	0	0	3	0	0
21	34057611	.	T	G	2	5	7	0	1	8	0	0
21	34059079	.	A	C	2	4	6	0	1	7	0	0
21	34074618	.	A	G	6	13	19	0	0	19	0	0
21	34074684	.	G	A	4	8	12	0	1	13	0	0
21	34074712	.	T	C	3	8	11	0	1	12	0	0
21	34074978	.	T	A	4	3	7	0	0	7	0	0
21	34114058	.	C	A	3	3	6	0	0	6	0	0
21	34128660	.	A	G	18	12	30	0	1	31	0	0
21	34129007	.	C	G	18	0	18	0	22	40	0	0
21	34129073	.	G	C	9	16	25	0	1	26	0	0
21	34129195	.	G	T	12	18	30	0	1	31	0	0
21	34129279	.	A	G	15	17	32	0	1	33	0	0
21	34129629	.	A	G	4	2	6	0	0	6	0	0
21	34176051	.	A	T	0	2	2	0	1	3	0	0
21	34195712	.	G	A	2	2	4	0	1	5	0	0
21	34199704	.	T	C	3	4	7	0	0	7	0	0
21	34211093	.	G	A	0	5	5	0	7	12	0	0
21	34364472	.	T	A	17	11	28	0	2	30	0	0
21	34364595	.	G	A	13	7	20	0	0	20	0	0
21	34365167	.	T	A	10	10	20	0	0	20	0	0
21	34391104	.	C	T	12	8	20	0	1	21	0	0
21	34391155	.	T	C	5	6	11	1	3	15	0	0
21	34392843	.	C	T	1	7	8	0	1	9	0	0
21	34424086	.	C	T	1	6	7	0	6	13	0	0
21	34424116	.	A	G	6	9	15	0	0	15	0	0
21	34428080	.	G	A	7	6	13	0	0	13	0	0
21	35305792	.	T	C	3	2	5	4	1	10	0	0
21	36598347	.	T	G	3	4	7	0	0	7	0	0
21	37107035	.	T	A	15	13	28	0	4	32	0	0
21	37107432	.	A	T	8	9	17	0	2	19	0	0
21	37107614	.	T	C	9	10	19	0	1	20	0	0
21	37107861	.	T	C	12	10	22	0	0	22	0	0
21	37108022	.	A	G	15	10	25	0	2	27	0	0
21	37108204	.	A	T	19	17	36	0	0	36	0	0
21	37184314	.	G	A	8	2	10	0	1	11	0	0
21	37690002	.	T	C	1	4	5	0	0	5	0	0
21	37690017	.	T	C	2	2	4	0	0	4	0	0
21	38013631	.	T	C	1	4	5	0	0	5	0	0
21	38315080	.	G	T	3	3	6	0	0	6	0	0
21	38509473	.	A	G	1	2	3	0	0	3	0	0
21	38587378	.	T	C	6	9	15	0	1	16	0	0
21	38589361	.	G	A	1	8	9	0	0	9	0	0
21	38717477	.	A	G	2	2	4	0	0	4	0	0
21	39365920	.	C	T	2	1	3	0	2	5	0	0
21	40045441	.	T	C	2	4	6	0	0	6	0	0
21	40045569	.	G	T	10	7	17	0	0	17	0	0
21	40045665	.	G	A	19	16	35	0	0	35	0	0
21	40045701	.	G	A	15	18	33	0	2	35	0	0
21	40045754	.	G	A	15	10	25	0	1	26	0	0
21	40048981	.	C	A	1	7	8	0	7	15	0	0
21	40049524	.	A	G	8	3	11	0	1	12	0	0
21	40049556	.	T	G	8	6	14	0	0	14	0	0
21	40049606	.	T	G	3	4	7	0	0	7	0	0
21	40054456	.	T	C	3	2	5	0	1	6	0	0
21	40355063	.	A	C	5	8	13	1	0	14	0	0
21	40355102	.	G	A	8	3	11	0	0	11	0	0
21	40355539	.	G	T	12	12	24	0	0	24	0	0
21	40355710	.	A	T	7	8	15	0	2	17	0	0
21	40355764	.	C	T	3	6	9	2	1	12	0	0
21	40355968	.	T	A	4	14	18	0	0	18	0	0
21	40364758	.	C	A	5	8	13	0	1	14	0	0
21	40365356	.	G	T	8	3	11	0	0	11	0	0
21	40368568	.	A	G	2	5	7	0	0	7	0	0
21	40369108	.	C	T	1	5	6	0	5	11	0	0
21	40373048	.	G	T	2	4	6	0	1	7	0	0
21	40373049	.	G	T	4	4	8	0	0	8	0	0
21	40373086	.	A	T	2	2	4	0	1	5	0	0
21	40377655	.	T	C	3	2	5	0	0	5	0	0
21	40377861	.	A	G	1	5	6	0	0	6	0	0
21	40381967	.	C	T	1	2	3	0	0	3	0	0
21	40382215	.	G	A	2	5	7	0	0	7	0	0
21	40402621	.	G	A	2	3	5	0	0	5	0	0
21	40402659	.	A	G	2	6	8	0	0	8	0	0
21	40402864	.	C	T	0	11	11	0	8	19	0	0
21	40403423	.	A	G	13	10	23	0	0	23	0	0
21	40403465	.	G	A	9	14	23	0	1	24	0	0
21	40403581	.	G	C	12	5	17	0	2	19	0	0
21	40410983	.	T	A	10	5	15	0	1	16	0	0
21	40411034	.	G	A	6	3	9	0	0	9	0	0
21	40411505	.	G	T	4	4	8	0	0	8	0	0
21	40466711	.	G	A	0	2	2	0	1	3	0	0
21	40466893	.	C	T	3	4	7	0	0	7	0	0
21	40467039	.	C	T	4	3	7	0	0	7	0	0
21	40474875	.	G	A	2	7	9	0	1	10	0	0
21	40475563	.	C	G	4	10	14	0	0	14	0	0
21	40475579	.	G	T	8	4	12	0	0	12	0	0
21	40528986	.	C	T	23	21	44	0	3	47	0	0
21	40531615	.	G	A	16	12	28	0	1	29	0	0
21	40531971	.	A	T	10	4	14	0	0	14	0	0
21	40531993	.	G	A	9	3	12	0	0	12	0	0
21	40532147	.	A	G	7	4	11	0	0	11	0	0
21	40532368	.	T	C	3	8	11	0	0	11	0	0
21	40532649	.	T	C	8	0	8	0	4	12	0	0
21	40532658	.	T	C	9	3	12	0	1	13	0	0
21	40532848	.	G	A	10	3	13	0	1	14	0	0
21	40532891	.	A	G	3	8	11	0	0	11	0	0
21	40532931	.	G	C	3	8	11	0	0	11	0	0
21	40533039	.	T	C	1	8	9	0	0	9	0	0
21	40533165	.	A	G	5	10	15	0	0	15	0	0
21	40537149	.	C	T	10	3	13	0	1	14	0	0
21	40537152	.	G	A	10	5	15	0	0	15	0	0
21	40537188	.	A	G	9	9	18	0	0	18	0	0
21	40546922	.	T	C	5	9	14	0	1	15	0	0
21	40547729	.	G	A	13	5	18	0	0	18	0	0
21	40553356	.	G	T	3	5	8	0	1	9	0	0
21	40553365	.	C	T	3	5	8	0	1	9	0	0
21	40579746	.	C	A	1	3	4	0	0	4	0	0
21	40619271	.	A	T	1	4	5	0	1	6	0	0
21	40619300	.	G	A	1	3	4	0	0	4	0	0
21	40673148	.	A	T	2	2	4	0	0	4	0	0
21	40673328	.	T	C	1	2	3	0	0	3	0	0
21	40685948	.	A	G	6	0	6	0	7	13	0	0
21	40685964	.	A	C	5	6	11	0	1	12	0	0
21	40685990	.	C	A	3	5	8	0	0	8	0	0
21	40686109	.	G	A	5	7	12	0	0	12	0	0
21	40709140	.	A	T	4	5	9	0	0	9	0	0
21	40714691	.	C	T	18	16	34	0	4	38	0	0
21	40715622	.	A	G	24	24	48	0	0	48	0	0
21	40715730	.	T	C	17	29	46	0	1	47	0	0
21	40715808	.	A	G	20	16	36	0	1	37	0	0
21	40717637	.	G	C	2	5	7	0	1	8	0	0
21	40731482	.	A	G	1	3	4	0	0	4	0	0
21	40936544	.	G	A	4	7	11	0	0	11	0	0
21	40938322	.	A	G	2	3	5	0	0	5	0	0
21	40959490	.	T	C	2	6	8	0	0	8	0	0
21	40959517	.	C	A	1	6	7	0	0	7	0	0
21	41028902	.	A	G	4	7	11	0	0	11	0	0
21	41029033	.	A	C	3	2	5	0	0	5	0	0
21	41029378	.	A	G	1	2	3	0	0	3	0	0
21	41034863	.	A	G	2	4	6	0	0	6	0	0
21	41046745	.	T	A	3	2	5	0	1	6	0	0
21	41046746	.	G	C	4	2	6	0	0	6	0	0
21	41049488	.	A	G	2	2	4	0	0	4	0	0
21	41256821	.	C	T	1	10	11	0	18	29	0	0
21	41257136	.	A	G	36	19	55	3	0	58	0	0
21	41257157	.	C	G	35	15	50	0	2	52	0	0
21	41257228	.	T	G	34	21	55	0	5	60	0	0
21	41257256	.	T	C	20	37	57	0	6	63	0	0
21	41257357	.	G	A	34	29	63	0	2	65	0	0
21	41257374	.	C	T	36	34	70	0	2	72	0	0
21	41257599	.	T	A	28	39	67	0	1	68	0	0
21	41293435	.	G	A	23	28	51	0	1	52	0	0
21	41305128	.	G	T	17	19	36	0	3	39	0	0
21	41305269	.	C	T	17	15	32	0	1	33	0	0
21	41305271	.	C	T	18	14	32	0	3	35	0	0
21	41311605	.	A	G	24	15	39	0	1	40	0	0
21	41311922	.	G	A	13	17	30	0	2	32	0	0
21	41312058	.	A	T	13	16	29	0	2	31	0	0
21	41538569	.	T	C	1	0	1	0	3	4	0	0
21	41598942	.	G	C	15	9	24	0	1	25	0	0
21	41598961	.	T	C	18	0	18	0	12	30	0	0
21	41599060	.	T	C	21	24	45	0	5	50	0	0
21	42044215	.	C	T	7	2	9	0	1	10	0	0
21	42046839	.	T	A	7	14	21	4	1	26	0	0
21	42046969	.	G	A	10	15	25	51	4	80	0	0
21	42777611	.	T	A	1	2	3	0	0	3	0	0
21	42778169	.	T	C	1	2	3	0	0	3	0	0
21	42779096	.	C	T	5	3	8	0	1	9	0	0
21	42917793	.	G	A	1	2	3	0	0	3	0	0
21	42954434	.	A	G	2	6	8	0	0	8	0	0
21	42971463	.	T	C	26	13	39	0	14	53	0	0
21	42971464	.	T	C	38	13	51	0	3	54	0	0
21	43420623	.	T	C	1	0	1	0	5	6	0	0
21	43477593	.	T	C	17	7	24	0	4	28	0	0
21	43477837	.	T	C	13	0	13	0	6	19	0	0
21	43506000	.	G	A	3	1	4	0	0	4	0	0
21	43506002	.	T	G	3	1	4	0	0	4	0	0
21	45352211	.	G	A	11	11	22	1	2	25	0	0
21	45352212	.	G	A	11	10	21	1	3	25	0	0
21	45551269	.	G	T	15	3	18	0	0	18	0	0
21	45673667	.	T	A	0	41	41	0	5	46	0	0
21	45838192	.	T	A	1	3	4	0	2	6	0	0
22	6910	.	A	G	5	3	8	0	1	9	0	0
22	11433	.	T	C	27	17	44	0	3	47	0	0
22	13985	.	C	T	28	22	50	0	1	52	1	0
22	13988	.	C	T	26	22	48	0	6	54	0	0
22	14278	.	C	T	22	26	48	0	2	50	0	0
22	15785	.	T	C	33	32	65	0	2	67	0	0
22	15819	.	T	C	38	31	69	0	2	71	0	0
22	15855	.	A	G	38	2	40	0	33	73	0	0
22	15860	.	C	G	43	32	75	0	0	75	0	0
22	15950	.	A	G	11	1	12	1	29	42	0	0
22	16047	.	G	A	16	18	34	0	5	39	0	0
22	16297	.	C	G	5	6	11	0	1	12	0	0
22	23325	.	C	T	3	4	7	0	1	8	0	0
22	23380	.	C	A	5	4	9	0	1	10	0	0
22	23417	.	C	T	5	3	8	0	1	9	0	0
22	23706	.	A	T	4	6	10	0	0	10	0	0
22	23842	.	A	C	11	3	14	0	0	14	0	0
22	23916	.	A	T	3	9	12	0	4	16	0	0
22	24117	.	C	T	2	9	11	0	2	13	0	0
22	24143	.	A	G	2	6	8	0	3	11	0	0
22	44508	.	A	C	5	3	8	0	0	8	0	0
22	44529	.	G	A	6	3	9	0	0	9	0	0
22	44826	.	A	T	7	4	11	0	0	11	0	0
22	46012	.	T	A	5	2	7	0	0	7	0	0
22	46968	.	G	A	1	2	3	0	0	3	0	0
22	47177	.	G	A	2	5	7	0	0	7	0	0
22	90083	.	A	C	5	10	15	0	0	15	0	0
22	90084	.	C	A	1	10	11	0	4	15	0	0
22	90134	.	C	G	10	7	17	0	2	19	0	0
22	94323	.	C	A	11	7	18	0	0	18	0	0
22	94699	.	A	G	3	3	6	0	5	11	0	0
22	94817	.	A	C	1	3	4	0	0	4	0	0
22	96200	.	C	T	2	4	6	0	1	7	0	0
22	96852	.	T	C	4	4	8	0	2	10	0	0
22	96959	.	T	C	7	9	16	0	3	19	0	0
22	97280	.	T	G	1	0	1	0	3	4	0	0
22	97438	.	C	A	1	7	8	0	0	8	0	0
22	97565	.	A	G	6	5	11	0	2	13	0	0
22	98523	.	A	G	2	6	8	0	0	8	0	0
22	101661	.	C	T	5	8	13	0	0	13	0	0
22	102261	.	C	A	20	21	41	0	3	44	0	0
22	105466	.	C	A	8	4	12	0	3	15	0	0
22	105548	.	T	G	6	0	6	0	5	11	0	0
22	105584	.	G	A	1	7	8	0	5	13	0	0
22	108003	.	G	A	9	11	20	0	0	20	0	0
22	133647	.	T	C	14	1	15	0	13	28	0	0
22	134008	.	C	T	1	17	18	0	20	38	0	0
22	134272	.	T	C	15	17	32	0	1	33	0	0
22	134353	.	T	C	10	17	27	0	2	29	0	0
22	134563	.	T	C	12	1	13	0	21	34	0	0
22	134848	.	C	A	13	15	28	0	2	30	0	0
22	134950	.	G	A	12	10	22	0	2	24	0	0
22	135045	.	C	T	8	7	15	0	1	16	0	0
22	135214	.	C	A	0	11	11	0	6	17	0	0
22	135678	.	T	C	11	6	17	0	1	18	0	0
22	135684	.	A	G	12	8	20	0	0	20	0	0
22	136183	.	T	A	4	5	9	0	0	9	0	0
22	136552	.	C	A	0	2	2	0	4	6	0	0
22	136704	.	C	A	2	2	4	0	0	4	0	0
22	137259	.	T	C	6	3	9	0	0	9	0	0
22	137786	.	G	A	1	3	4	0	0	4	0	0
22	138193	.	A	T	1	4	5	0	1	6	0	0
22	138198	.	T	A	2	3	5	0	0	5	0	0
22	138684	.	A	G	2	3	5	0	0	5	0	0
22	139396	.	T	A	2	3	5	0	0	5	0	0
22	139562	.	G	A	1	5	6	0	0	6	0	0
22	139696	.	G	T	1	0	1	0	1	2	0	0
22	139702	.	C	T	1	2	3	0	0	3	0	0
22	158468	.	A	T	4	5	9	2	1	12	0	0
22	158472	.	T	A	6	3	9	2	1	12	0	0
22	188043	.	C	T	2	2	4	0	0	4	0	0
22	192443	.	G	A	16	18	34	0	1	35	0	0
22	192713	.	C	T	2	3	5	0	23	28	0	0
22	192754	.	A	G	15	11	26	0	3	29	0	0
22	192953	.	A	G	15	9	24	0	1	25	0	0
22	193193	.	A	C	9	0	9	0	8	17	0	0
22	336325	.	T	C	17	22	39	0	0	39	0	0
22	336378	.	A	G	10	15	25	0	6	31	0	0
22	337063	.	A	G	13	30	43	0	1	44	0	0
22	337457	.	T	C	17	12	29	0	10	39	0	0
22	337606	.	G	T	16	17	33	0	0	33	0	0
22	337607	.	T	G	16	15	31	0	2	33	0	0
22	337705	.	C	T	23	19	42	0	3	45	0	0
22	337918	.	G	T	15	10	25	0	1	26	0	0
22	338187	.	G	A	27	14	41	2	0	43	0	0
22	338199	.	G	T	7	14	21	3	22	46	0	0
22	338226	.	C	T	28	12	40	7	0	47	0	0
22	338431	.	C	T	17	14	31	0	1	32	0	0
22	342167	.	A	G	5	2	7	5	1	13	0	0
22	344977	.	T	G	10	9	19	0	2	21	0	0
22	345794	.	C	G	12	9	21	0	1	22	0	0
22	346601	.	C	T	6	5	11	0	2	13	0	0
22	349378	.	G	A	27	26	53	0	1	54	0	0
22	354076	.	G	C	12	11	23	0	0	23	0	0
22	354269	.	T	C	18	24	42	1	0	43	0	0
22	354272	.	C	T	17	24	41	1	1	43	0	0
22	354466	.	C	T	13	13	26	0	2	28	0	0
22	354509	.	T	G	15	13	28	0	3	31	0	0
22	360302	.	A	G	13	22	35	0	2	37	0	0
22	367517	.	A	G	10	13	23	0	3	26	0	0
22	371121	.	T	G	16	9	25	0	0	25	0	0
22	371141	.	G	C	14	13	27	0	2	29	0	0
22	371689	.	C	T	21	11	32	0	5	37	0	0
22	371926	.	C	T	3	8	11	0	14	25	0	0
22	371933	.	T	C	14	1	15	0	6	21	0	0
22	404666	.	T	C	11	14	25	0	0	25	0	0
22	405177	.	T	C	25	16	41	0	2	43	0	0
22	405986	.	C	T	16	24	40	0	3	43	0	0
22	426243	.	C	T	2	4	6	0	0	6	0	0
22	431314	.	T	C	1	3	4	0	0	4	0	0
22	441271	.	G	A	2	3	5	0	1	6	0	0
22	443622	.	T	C	1	3	4	0	0	4	0	0
22	445860	.	A	G	1	2	3	0	0	3	0	0
22	446257	.	A	G	1	0	1	0	2	3	0	0
22	446686	.	G	C	1	6	7	0	1	8	0	0
22	448643	.	G	A	0	2	2	0	1	3	0	0
22	448644	.	C	A	1	2	3	0	0	3	0	0
22	451371	.	T	C	4	4	8	0	0	8	0	0
22	451533	.	G	A	0	5	5	0	2	7	0	0
22	452694	.	T	G	6	5	11	0	0	11	0	0
22	452748	.	A	G	6	0	6	0	6	12	0	0
22	452776	.	A	G	8	0	8	0	5	13	0	0
22	452784	.	A	G	9	4	13	0	0	13	0	0
22	453137	.	G	A	2	3	5	0	0	5	0	0
22	453170	.	C	A	4	4	8	0	0	8	0	0
22	461502	.	G	A	0	8	8	0	6	14	0	0
22	464971	.	T	A	3	5	8	0	1	9	0	0
22	465120	.	A	T	9	9	18	0	0	18	0	0
22	465609	.	A	G	3	1	4	0	3	7	0	0
22	468088	.	T	C	2	4	6	6	1	13	0	0
22	468375	.	T	C	4	12	16	6	1	23	0	0
22	473607	.	A	G	23	33	56	0	0	56	0	0
22	474787	.	C	A	3	23	26	0	15	41	0	0
22	479703	.	C	T	3	15	18	0	17	35	0	0
22	479754	.	C	T	14	17	31	0	2	33	0	0
22	481670	.	A	G	17	14	31	0	1	32	0	0
22	483593	.	G	T	17	12	29	1	3	33	0	0
22	483841	.	C	T	13	10	23	0	0	23	0	0
22	485328	.	A	C	15	1	16	2	11	29	0	0
22	485352	.	G	A	15	16	31	2	1	34	0	0
22	486713	.	C	T	9	9	18	1	2	21	0	0
22	489566	.	T	C	8	10	18	0	1	19	0	0
22	489694	.	G	T	9	6	15	0	0	15	0	0
22	534286	.	C	T	1	2	3	0	0	3	0	0
22	534484	.	A	G	3	2	5	0	0	5	0	0
22	534492	.	C	T	1	3	4	0	0	4	0	0
22	535020	.	T	A	2	2	4	0	0	4	0	0
22	551166	.	C	T	0	12	12	0	18	30	0	0
22	551262	.	A	G	17	11	28	0	1	29	0	0
22	552169	.	T	C	13	2	15	0	8	23	0	0
22	554411	.	T	C	10	0	10	0	11	21	0	0
22	555234	.	C	T	9	12	21	0	0	21	0	0
22	557733	.	G	A	16	13	29	0	1	30	0	0
22	557770	.	C	T	1	10	11	0	16	27	0	0
22	557886	.	G	A	13	7	20	0	1	21	0	0
22	563826	.	G	A	1	10	11	0	3	14	0	0
22	581442	.	C	T	1	2	3	0	1	4	0	0
22	581732	.	A	G	1	2	3	0	1	4	0	0
22	582525	.	A	C	6	5	11	0	0	11	0	0
22	583128	.	A	G	6	5	11	0	0	11	0	0
22	583343	.	A	G	5	4	9	0	2	11	0	0
22	583376	.	T	G	4	2	6	0	0	6	0	0
22	583390	.	T	C	3	4	7	0	0	7	0	0
22	583421	.	C	T	5	5	10	0	0	10	0	0
22	583538	.	A	C	12	4	16	0	1	17	0	0
22	591851	.	A	T	8	11	19	0	0	19	0	0
22	591937	.	A	G	16	17	33	0	3	36	0	0
22	591942	.	G	T	15	18	33	0	3	36	0	0
22	592029	.	A	G	16	12	28	0	3	31	0	0
22	592069	.	G	A	17	17	34	0	3	37	0	0
22	592107	.	T	A	11	25	36	0	1	37	0	0
22	593071	.	A	G	15	17	32	0	0	32	0	0
22	593708	.	C	T	13	18	31	0	3	34	0	0
22	593819	.	C	A	13	15	28	0	4	32	0	0
22	593828	.	G	A	13	17	30	0	2	32	0	0
22	593903	.	T	C	10	0	10	0	17	27	0	0
22	599951	.	A	T	16	12	28	1	2	31	0	0
22	613352	.	G	A	23	20	43	0	1	44	0	0
22	613355	.	C	G	23	22	45	0	0	45	0	0
22	613433	.	C	T	2	26	28	0	26	54	0	0
22	613572	.	T	A	37	14	51	0	5	56	0	0
22	613591	.	C	A	0	27	27	0	20	47	0	0
22	616076	.	T	G	33	23	56	0	5	61	0	0
22	617692	.	G	A	3	2	5	0	2	7	0	0
22	618149	.	G	A	19	27	46	0	1	47	0	0
22	637508	.	C	A	6	9	15	0	0	15	0	0
22	637517	.	G	C	8	10	18	0	0	18	0	0
22	710974	.	A	G	32	20	52	0	1	53	0	0
22	711158	.	T	G	27	20	47	0	6	53	0	0
22	711285	.	G	T	14	15	29	0	0	29	0	0
22	711337	.	T	A	15	5	20	0	1	21	0	0
22	711370	.	A	C	13	5	18	0	0	18	0	0
22	711437	.	C	T	8	5	13	0	0	13	0	0
22	711475	.	T	C	13	8	21	0	1	22	0	0
22	711725	.	A	T	23	15	38	0	3	41	0	0
22	712146	.	T	A	15	15	30	0	0	30	0	0
22	712160	.	A	G	14	15	29	0	4	33	0	0
22	712187	.	G	T	11	12	23	0	3	26	0	0
22	712222	.	G	A	15	9	24	0	6	30	0	0
22	712484	.	G	A	16	22	38	0	0	38	0	0
22	712578	.	A	G	11	17	28	0	1	29	0	0
22	728144	.	T	A	8	6	14	0	0	14	0	0
22	728176	.	C	T	8	3	11	0	0	11	0	0
22	729619	.	C	A	8	6	14	0	0	14	0	0
22	732794	.	T	A	6	3	9	1	0	10	0	0
22	741559	.	T	C	6	4	10	0	0	10	0	0
22	748837	.	C	T	6	8	14	0	1	15	0	0
22	748951	.	T	C	5	8	13	0	0	13	0	0
22	750695	.	T	C	8	8	16	0	0	16	0	0
22	750699	.	G	A	0	9	9	0	10	19	0	0
22	750759	.	C	A	10	5	15	0	0	15	0	0
22	750770	.	C	G	8	5	13	0	2	15	0	0
22	750863	.	T	C	5	10	15	0	0	15	0	0
22	751075	.	A	G	6	15	21	0	0	21	0	0
22	753210	.	C	T	4	10	14	0	0	14	0	0
22	753219	.	T	C	2	8	10	0	1	11	0	0
22	753267	.	A	G	5	0	5	0	3	8	0	0
22	770233	.	T	A	12	4	16	0	1	17	0	0
22	774989	.	T	C	14	0	14	0	22	36	0	0
22	779246	.	C	T	0	5	5	0	6	11	0	0
22	779255	.	G	A	7	4	11	0	0	11	0	0
22	779330	.	T	A	1	3	4	0	0	4	0	0
22	786611	.	T	C	6	4	10	0	2	12	0	0
22	796937	.	C	T	8	4	12	0	0	12	0	0
22	796994	.	G	T	1	12	13	0	5	18	0	0
22	797000	.	G	A	0	7	7	0	12	19	0	0
22	797117	.	G	A	10	8	18	0	0	18	0	0
22	799595	.	A	G	10	0	10	0	12	22	0	0
22	799712	.	C	T	12	9	21	0	2	23	0	0
22	803849	.	C	A	0	6	6	0	0	6	0	0
22	803871	.	G	A	2	4	6	0	0	6	0	0
22	804324	.	G	C	11	5	16	1	2	19	0	0
22	804409	.	C	T	18	20	38	0	1	39	0	0
22	808069	.	T	A	12	7	19	0	2	21	0	0
22	808134	.	G	A	10	7	17	0	1	18	0	0
22	808175	.	T	C	4	4	8	0	0	8	0	0
22	808228	.	A	G	5	7	12	0	1	13	0	0
22	808655	.	G	C	17	12	29	0	3	32	0	0
22	813148	.	C	G	0	1	1	0	5	6	0	0
22	813152	.	G	A	4	3	7	0	0	7	0	0
22	814622	.	T	G	3	3	6	0	0	6	0	0
22	820087	.	G	T	9	14	23	0	0	23	0	0
22	820660	.	A	G	16	11	27	0	2	29	0	0
22	820738	.	T	C	15	11	26	0	0	26	0	0
22	822601	.	A	C	15	0	15	0	13	28	0	0
22	822940	.	G	A	7	3	10	0	0	10	0	0
22	825091	.	T	A	9	11	20	0	1	21	0	0
22	825178	.	C	G	1	5	6	0	8	14	0	0
22	827256	.	A	T	6	2	8	0	1	9	0	0
22	831180	.	C	T	2	7	9	0	2	11	0	0
22	831345	.	A	G	3	3	6	0	0	6	0	0
22	831354	.	C	T	0	2	2	0	3	5	0	0
22	833990	.	T	C	5	4	9	0	0	9	0	0
22	856967	.	C	G	3	2	5	0	0	5	0	0
22	856981	.	G	C	4	2	6	0	0	6	0	0
22	857029	.	A	G	6	5	11	0	1	12	0	0
22	857350	.	T	C	7	1	8	0	3	11	0	0
22	857572	.	A	T	10	7	17	0	3	20	0	0
22	857630	.	A	G	8	7	15	0	0	15	0	0
22	857662	.	C	T	6	3	9	0	1	10	0	0
22	857720	.	A	G	11	10	21	0	1	22	0	0
22	857733	.	T	G	8	13	21	0	1	22	0	0
22	859511	.	T	C	9	1	10	0	12	22	0	0
22	861221	.	G	A	4	5	9	0	0	9	0	0
22	862526	.	C	T	1	6	7	0	2	9	0	0
22	868098	.	A	G	4	10	14	0	0	14	0	0
22	868114	.	T	C	5	9	14	0	0	14	0	0
22	868175	.	A	G	6	12	18	0	1	19	0	0
22	868312	.	A	G	7	14	21	0	0	21	0	0
22	868321	.	T	C	8	10	18	0	0	18	0	0
22	868353	.	T	A	8	13	21	0	1	22	0	0
22	868648	.	G	C	2	7	9	0	0	9	0	0
22	869514	.	C	T	2	3	5	0	0	5	0	0
22	869989	.	A	G	8	14	22	0	1	23	0	0
22	872055	.	C	T	1	5	6	0	3	9	0	0
22	872067	.	C	G	3	4	7	0	0	7	0	0
22	875483	.	T	C	1	0	1	0	2	3	0	0
22	877805	.	A	G	2	2	4	0	0	4	0	0
22	995476	.	T	A	1	2	3	0	0	3	0	0
22	995499	.	A	G	1	2	3	0	0	3	0	0
22	996026	.	G	T	2	2	4	0	0	4	0	0
22	1037180	.	G	C	2	4	6	0	0	6	0	0
22	1042716	.	C	G	1	3	4	0	0	4	0	0
22	1063028	.	C	T	1	2	3	0	0	3	0	0
22	1069191	.	G	A	2	4	6	0	0	6	0	0
22	1203320	.	A	T	12	9	21	0	1	22	0	0
22	1203373	.	A	T	12	15	27	0	3	30	0	0
22	1209816	.	T	C	1	3	4	0	0	4	0	0
22	1214289	.	T	C	3	2	5	0	0	5	0	0
22	1214535	.	T	G	1	2	3	0	1	4	0	0
22	1261762	.	C	A	4	2	6	0	0	6	0	0
22	1261999	.	G	A	4	5	9	0	0	9	0	0
22	1267013	.	C	T	3	3	6	0	0	6	0	0
22	1267045	.	A	G	4	2	6	0	1	7	0	0
22	1267081	.	G	A	3	2	5	0	2	7	0	0
22	1276710	.	A	T	6	8	14	0	1	15	0	0
22	1277766	.	A	G	2	3	5	0	1	6	0	0
22	1281832	.	C	A	1	2	3	0	0	3	0	0
22	1281951	.	G	A	3	3	6	0	1	7	0	0
22	1281978	.	T	C	1	3	4	0	1	5	0	0
22	1281993	.	A	G	1	3	4	0	0	4	0	0
22	1282176	.	T	A	1	3	4	0	1	5	0	0
22	1282296	.	G	T	8	6	14	0	0	14	0	0
22	1289769	.	A	G	1	0	1	0	2	3	0	0
22	1326647	.	A	C	7	8	15	0	0	15	0	0
22	1326851	.	C	A	1	3	4	0	2	6	0	0
22	1327074	.	A	G	6	3	9	0	0	9	0	0
22	1327979	.	G	A	4	6	10	0	5	15	0	0
22	1328001	.	C	T	6	3	9	0	1	10	0	0
22	1328402	.	T	C	7	4	11	0	0	11	0	0
22	1328660	.	A	T	12	4	16	0	2	18	0	0
22	1328708	.	G	A	16	15	31	0	1	32	0	0
22	1328748	.	A	G	14	0	14	0	20	34	0	0
22	1328880	.	A	C	6	3	9	0	1	10	0	0
22	1328890	.	A	G	7	0	7	0	3	10	0	0
22	1329010	.	A	C	3	5	8	0	0	8	0	0
22	1329024	.	T	C	4	3	7	0	0	7	0	0
22	1372968	.	G	A	1	2	3	0	0	3	0	0
22	1373672	.	T	C	6	3	9	0	1	10	0	0
22	1373676	.	T	A	6	3	9	0	0	9	0	0
22	1374783	.	C	T	2	2	4	0	1	5	0	0
22	1375083	.	T	C	6	6	12	0	0	12	0	0
22	1393837	.	G	A	2	2	4	0	0	4	0	0
22	1394148	.	T	A	1	2	3	0	1	4	0	0
22	1394218	.	C	A	6	2	8	0	0	8	0	0
22	1394290	.	G	A	2	2	4	0	0	4	0	0
22	1394393	.	A	G	2	0	2	0	2	4	0	0
22	1394717	.	T	A	3	4	7	0	2	9	0	0
22	1407074	.	A	G	3	9	12	0	0	12	0	0
22	1407152	.	T	C	1	4	5	0	0	5	0	0
22	1422934	.	A	G	1	0	1	0	4	5	0	0
22	1423754	.	A	T	1	3	4	0	0	4	0	0
22	1432003	.	G	A	4	2	6	0	0	6	0	0
22	1432198	.	C	T	1	2	3	0	0	3	0	0
22	1432746	.	A	G	0	1	1	0	1	2	0	0
22	1432758	.	G	C	3	2	5	0	0	5	0	0
22	1440977	.	A	G	2	0	2	0	2	4	0	0
22	1440989	.	A	C	2	2	4	0	1	5	0	0
22	1441154	.	A	G	2	2	4	0	3	7	0	0
22	1441200	.	C	G	1	0	1	0	4	5	0	0
22	1837500	.	A	T	2	2	4	5	0	9	0	0
22	2208094	.	A	G	1	2	3	7	0	10	0	0
22	2897580	.	T	C	18	2	20	0	17	37	0	0
22	2897681	.	A	G	12	18	30	0	1	31	0	0
22	2897742	.	G	A	17	11	28	0	0	28	0	0
22	2897997	.	G	C	12	11	23	0	4	27	0	0
22	2898089	.	C	A	2	20	22	0	10	32	0	0
22	2900999	.	G	A	12	20	32	0	3	35	0	0
22	2908264	.	T	G	8	14	22	0	0	22	0	0
22	2912869	.	G	T	9	14	23	1	2	26	0	0
22	2919050	.	A	G	7	6	13	0	1	14	0	0
22	2919501	.	C	T	7	6	13	0	4	17	0	0
22	2931544	.	T	A	3	9	12	2	0	14	0	0
22	2933861	.	G	C	8	9	17	0	1	18	0	0
22	2941886	.	C	T	3	6	9	0	0	9	0	0
22	2941888	.	C	T	3	6	9	0	0	9	0	0
22	2949133	.	G	C	3	3	6	0	0	6	0	0
22	2949146	.	G	A	3	2	5	0	0	5	0	0
22	2951416	.	C	G	0	3	3	0	5	8	0	0
22	3121191	.	T	G	7	7	14	0	0	14	0	0
22	3121451	.	C	A	0	13	13	0	9	22	0	0
22	3121531	.	A	T	4	8	12	0	2	14	0	0
22	3121683	.	T	A	6	9	15	0	1	16	0	0
22	3121725	.	T	G	8	8	16	0	5	21	0	0
22	3121789	.	A	T	14	17	31	0	0	31	0	0
22	3122004	.	A	G	10	4	14	0	0	14	0	0
22	3122258	.	C	T	15	16	31	0	3	34	0	0
22	3123805	.	G	A	2	4	6	0	0	6	0	0
22	3124031	.	G	A	6	3	9	0	0	9	0	0
22	3124071	.	C	T	0	3	3	0	2	5	0	0
22	3124132	.	G	T	5	8	13	0	0	13	0	0
22	3143236	.	C	T	1	7	8	0	2	10	0	0
22	3161346	.	C	T	8	4	12	0	0	12	0	0
22	3162335	.	T	C	4	2	6	0	0	6	0	0
22	3162405	.	G	A	2	4	6	0	0	6	0	0
22	3169448	.	C	T	0	2	2	0	1	4	1	0
22	3169529	.	T	C	2	3	5	0	0	5	0	0
22	3169723	.	T	C	1	3	4	0	1	5	0	0
22	3172774	.	C	T	2	4	6	0	0	6	0	0
22	3177005	.	C	T	0	4	4	0	1	5	0	0
22	3177026	.	G	C	3	0	3	0	2	5	0	0
22	3177063	.	G	A	3	2	5	0	0	5	0	0
22	3177196	.	T	G	2	2	4	0	0	4	0	0
22	3177227	.	A	G	1	3	4	0	0	4	0	0
22	3182452	.	G	C	2	0	2	0	2	4	0	0
22	3182457	.	T	C	3	2	5	0	0	5	0	0
22	3182698	.	G	C	2	2	4	0	0	4	0	0
22	3198047	.	C	T	1	4	5	0	0	5	0	0
22	3198158	.	C	T	1	4	5	0	0	5	0	0
22	3204054	.	G	A	4	4	8	0	0	8	0	0
22	3204322	.	A	T	2	2	4	0	0	4	0	0
22	3208098	.	A	G	4	4	8	0	0	8	0	0
22	3208281	.	A	G	5	6	11	0	0	11	0	0
22	3211809	.	C	T	7	2	9	0	0	9	0	0
22	3214180	.	C	A	2	4	6	0	0	6	0	0
22	3214279	.	G	A	9	3	12	0	0	12	0	0
22	3214309	.	G	A	3	5	8	0	1	9	0	0
22	3231677	.	T	G	8	9	17	0	0	17	0	0
22	3232506	.	C	T	4	2	6	0	1	7	0	0
22	3233872	.	G	A	1	2	3	2	7	12	0	0
22	3262925	.	C	T	2	6	8	0	9	17	0	0
22	3263129	.	T	C	11	7	18	0	0	18	0	0
22	3263672	.	G	T	6	7	13	0	4	17	0	0
22	3263760	.	G	A	10	4	14	0	0	14	0	0
22	3263776	.	T	G	10	3	13	0	0	13	0	0
22	3267636	.	C	T	4	7	11	0	0	11	0	0
22	3267645	.	C	A	2	6	8	0	3	11	0	0
22	3270740	.	T	C	3	3	6	0	1	7	0	0
22	3271943	.	G	A	1	3	4	0	0	4	0	0
22	3273835	.	T	C	1	3	4	0	0	4	0	0
22	3384831	.	G	A	20	29	49	0	3	52	0	0
22	3384844	.	C	T	22	30	52	0	1	53	0	0
22	3387859	.	G	A	15	9	24	0	0	24	0	0
22	3387946	.	T	C	2	0	2	0	6	8	0	0
22	3389606	.	A	G	9	3	12	0	0	12	0	0
22	3389615	.	T	C	9	3	12	0	0	12	0	0
22	3389803	.	G	A	11	7	18	0	1	19	0	0
22	3392768	.	A	T	3	5	8	0	3	11	0	0
22	3413993	.	G	A	2	3	5	0	0	5	0	0
22	4397125	.	A	G	1	1	2	0	2	4	0	0
22	4397947	.	A	G	2	4	6	0	0	6	0	0
22	4397966	.	C	G	1	6	7	0	0	7	0	0
22	4444165	.	C	T	1	2	3	0	0	3	0	0
22	4444620	.	T	C	2	2	4	0	0	4	0	0
22	4444935	.	T	C	1	5	6	0	0	6	0	0
22	4445071	.	A	G	2	0	2	0	5	7	0	0
22	4445269	.	T	C	3	5	8	0	0	8	0	0
22	4445669	.	A	G	1	3	4	0	0	4	0	0
22	4450449	.	T	A	4	9	13	0	1	14	0	0
22	4453459	.	G	T	2	9	11	0	5	16	0	0
22	4453504	.	C	T	8	4	12	0	0	12	0	0
22	4457622	.	G	C	7	13	20	0	1	21	0	0
22	4457781	.	T	C	12	6	18	0	0	18	0	0
22	4459772	.	T	C	13	10	23	0	2	25	0	0
22	4460297	.	A	G	10	10	20	0	3	23	0	0
22	4462713	.	C	G	13	9	22	0	1	23	0	0
22	4462800	.	T	C	10	7	17	0	3	20	0	0
22	4462889	.	A	G	7	6	13	0	2	15	0	0
22	4462890	.	C	A	9	6	15	0	0	15	0	0
22	4463160	.	C	T	3	8	11	0	1	12	0	0
22	4463192	.	G	A	0	5	5	0	4	9	0	0
22	4711814	.	A	T	3	4	7	0	0	7	0	0
22	4716716	.	A	G	5	5	10	0	0	10	0	0
22	4724020	.	C	T	9	8	17	0	0	17	0	0
22	4726694	.	A	G	8	7	15	0	0	15	0	0
22	4726733	.	T	G	6	6	12	0	0	12	0	0
22	4728712	.	A	G	5	1	6	0	6	12	0	0
22	4728730	.	C	T	4	4	8	0	1	9	0	0
22	4730881	.	G	A	7	9	16	0	3	19	0	0
22	4730882	.	A	T	8	11	19	0	0	19	0	0
22	4732627	.	C	A	22	14	36	0	0	36	0	0
22	4732952	.	A	G	2	0	2	0	2	4	0	0
22	4732961	.	T	C	2	2	4	0	0	4	0	0
22	4745227	.	C	T	8	5	13	0	0	13	0	0
22	4745421	.	A	G	21	15	36	0	2	38	0	0
22	4745642	.	G	A	8	12	20	0	2	22	0	0
22	4745677	.	C	G	9	13	22	0	1	23	0	0
22	4745682	.	A	T	12	14	26	0	1	27	0	0
22	4745779	.	C	T	1	18	19	0	12	31	0	0
22	4746120	.	A	T	14	9	23	0	0	23	0	0
22	4746401	.	A	G	6	3	9	0	0	9	0	0
22	4746577	.	C	A	6	10	16	0	0	16	0	0
22	4746721	.	C	T	20	14	34	0	2	36	0	0
22	4746750	.	C	T	15	14	29	0	1	30	0	0
22	4747278	.	A	C	2	5	7	0	0	7	0	0
22	4747456	.	C	A	4	2	6	0	0	6	0	0
22	4747684	.	C	T	6	3	9	0	0	9	0	0
22	4747832	.	C	T	7	5	12	0	0	12	0	0
22	4747862	.	C	T	9	4	13	0	0	13	0	0
22	4747921	.	G	T	3	6	9	0	2	11	0	0
22	4752478	.	C	T	10	5	15	0	0	15	0	0
22	4754306	.	C	T	5	6	11	0	1	12	0	0
22	4755338	.	A	G	4	5	9	0	0	9	0	0
22	4755656	.	C	T	1	2	3	0	2	5	0	0
22	4755681	.	G	A	2	4	6	0	1	7	0	0
22	4762663	.	C	T	3	12	15	0	16	31	0	0
22	4762664	.	A	G	15	14	29	0	2	31	0	0
22	4762773	.	T	C	24	12	36	0	1	37	0	0
22	4763125	.	G	A	14	22	36	0	5	41	0	0
22	4763474	.	C	A	3	10	13	0	10	23	0	0
22	4766818	.	C	T	8	10	18	0	1	19	0	0
22	4767534	.	C	T	5	5	10	0	1	11	0	0
22	4767738	.	C	G	1	7	8	0	0	8	0	0
22	4767754	.	C	T	1	7	8	0	0	8	0	0
22	4769024	.	C	G	2	4	6	0	0	6	0	0
22	4948000	.	T	G	3	0	3	0	2	5	0	0
22	4962472	.	T	A	4	13	17	0	1	18	0	0
22	4962550	.	A	C	10	1	11	0	6	17	0	0
22	4962559	.	G	A	5	9	14	0	3	17	0	0
22	4962590	.	A	G	12	6	18	0	4	22	0	0
22	4962610	.	A	T	12	11	23	0	1	24	0	0
22	4962635	.	A	G	16	13	29	0	0	29	0	0
22	4962878	.	G	A	9	19	28	0	2	30	0	0
22	4967354	.	G	T	16	10	26	0	5	31	0	0
22	4968955	.	A	G	13	13	26	0	0	26	0	0
22	4969021	.	A	G	8	12	20	0	0	20	0	0
22	4970773	.	T	C	8	0	8	0	7	15	0	0
22	4970797	.	G	C	8	3	11	0	0	11	0	0
22	4972848	.	T	G	4	8	12	0	2	14	0	0
22	4975236	.	T	A	6	13	19	0	1	20	0	0
22	4977106	.	G	A	4	3	7	0	0	7	0	0
22	4979470	.	C	T	3	2	5	0	2	7	0	0
22	4981480	.	T	A	1	2	3	0	0	3	0	0
22	5056607	.	A	G	10	12	22	0	1	23	0	0
22	5056760	.	T	G	16	17	33	0	0	33	0	0
22	5056978	.	A	T	6	7	13	0	1	14	0	0
22	5057034	.	G	T	8	10	18	0	1	19	0	0
22	5057254	.	T	A	6	7	13	0	0	13	0	0
22	5057421	.	C	A	0	8	8	0	9	17	0	0
22	5057489	.	T	A	6	6	12	0	3	15	0	0
22	5057504	.	T	A	8	9	17	0	0	17	0	0
22	5057562	.	G	T	6	12	18	0	1	19	0	0
22	5062457	.	G	A	9	8	17	0	1	18	0	0
22	5120172	.	C	T	5	9	14	0	0	14	0	0
22	5122486	.	A	C	2	2	4	0	0	4	0	0
22	5122498	.	C	A	3	2	5	0	0	5	0	0
22	5140122	.	A	G	4	6	10	0	0	10	0	0
22	5140649	.	G	A	4	5	9	0	0	9	0	0
22	5140840	.	C	T	0	3	3	0	3	6	0	0
22	5144566	.	G	C	9	8	17	1	0	18	0	0
22	5144750	.	T	A	5	5	10	0	0	10	0	0
22	5144882	.	T	G	3	5	8	0	0	8	0	0
22	5144981	.	T	C	10	8	18	0	0	18	0	0
22	5145109	.	C	A	4	8	12	0	0	12	0	0
22	5153823	.	A	G	3	3	6	0	0	6	0	0
22	5153853	.	C	T	2	2	4	0	0	4	0	0
22	5176514	.	C	G	1	2	3	0	0	3	0	0
22	5227738	.	C	T	8	11	19	0	1	20	0	0
22	5227869	.	C	T	7	3	10	0	1	11	0	0
22	5227870	.	C	G	7	3	10	0	1	11	0	0
22	5228124	.	G	T	0	8	8	0	4	12	0	0
22	5228158	.	C	T	3	7	10	0	1	11	0	0
22	5228882	.	A	C	2	3	5	1	0	6	0	0
22	5228889	.	A	G	2	3	5	3	0	8	0	0
22	5229048	.	G	A	2	2	4	1	0	5	0	0
22	5229267	.	A	C	6	7	13	3	1	17	0	0
22	5229315	.	A	C	3	4	7	0	0	7	0	0
22	5229320	.	G	A	0	3	3	0	1	4	0	0
22	5229751	.	A	C	2	1	3	0	0	3	0	0
22	5229775	.	C	T	2	2	4	1	0	5	0	0
22	5230201	.	T	C	2	4	6	1	1	8	0	0
22	5230339	.	A	G	13	4	17	2	0	19	0	0
22	5230455	.	A	C	2	4	6	11	0	17	0	0
22	5230751	.	G	C	4	9	13	0	0	13	0	0
22	5230794	.	T	A	7	15	22	0	1	23	0	0
22	5230839	.	A	G	13	13	26	3	2	31	0	0
22	5231035	.	C	T	6	2	8	0	1	9	0	0
22	5231044	.	T	C	5	2	7	0	0	7	0	0
22	5231145	.	T	C	3	9	12	0	0	12	0	0
22	5231263	.	A	G	9	10	19	0	1	20	0	0
22	5231354	.	C	T	8	14	22	0	0	22	0	0
22	5231696	.	A	G	10	19	29	0	0	29	0	0
22	5232088	.	T	G	13	8	21	0	3	24	0	0
22	5233560	.	C	T	3	9	12	0	3	15	0	0
22	5233620	.	G	A	7	3	10	0	0	10	0	0
22	5233657	.	C	T	0	2	2	0	4	6	0	0
22	5233712	.	C	A	3	3	6	0	0	6	0	0
22	5233920	.	T	C	14	14	28	0	0	28	0	0
22	5233975	.	T	C	6	6	12	0	0	12	0	0
22	5234042	.	T	A	7	4	11	0	0	11	0	0
22	5235322	.	G	A	7	4	11	0	0	11	0	0
22	5244560	.	T	C	6	3	9	0	0	9	0	0
22	5247846	.	G	A	1	7	8	0	0	8	0	0
22	5423266	.	A	T	3	2	5	0	0	5	0	0
22	5423296	.	G	T	0	3	3	0	3	6	0	0
22	5423305	.	A	G	4	0	4	0	2	6	0	0
22	5436580	.	G	A	2	2	4	0	0	4	0	0
22	5575088	.	C	T	6	9	15	0	1	16	0	0
22	5577139	.	T	C	9	11	20	0	0	20	0	0
22	5577196	.	A	G	10	0	10	0	5	15	0	0
22	5577211	.	T	C	11	4	15	0	1	16	0	0
22	5578880	.	T	C	14	13	27	0	0	27	0	0
22	5586896	.	T	C	22	14	36	0	1	37	0	0
22	5586902	.	C	T	20	16	36	0	2	38	0	0
22	5587039	.	C	T	16	22	38	0	2	40	0	0
22	5587124	.	G	A	16	21	37	0	2	39	0	0
22	5587204	.	A	G	14	3	17	0	24	41	0	0
22	5587285	.	A	C	19	6	25	0	2	27	0	0
22	5587416	.	C	A	1	2	3	0	0	3	0	0
22	5587420	.	G	T	1	2	3	0	0	3	0	0
22	5587826	.	T	C	28	32	60	0	2	62	0	0
22	5587930	.	T	C	18	31	49	2	2	53	0	0
22	5633984	.	G	T	2	2	4	0	0	4	0	0
22	5633986	.	A	G	3	2	5	0	0	5	0	0
22	5634158	.	A	T	5	4	9	0	0	9	0	0
22	5637164	.	G	A	2	3	5	0	0	5	0	0
22	5657155	.	G	A	4	9	13	0	1	14	0	0
22	5657191	.	C	T	0	8	8	0	9	17	0	0
22	5657278	.	A	T	1	4	5	0	0	5	0	0
22	5657365	.	C	T	11	7	18	0	0	18	0	0
22	5657456	.	T	C	3	1	4	0	4	8	0	0
22	5657704	.	T	C	5	12	17	0	1	18	0	0
22	5657731	.	T	C	7	0	7	0	11	18	0	0
22	5657800	.	T	A	13	5	18	0	0	18	0	0
22	5660962	.	T	C	9	4	13	0	0	13	0	0
22	5661524	.	C	T	0	6	6	0	4	10	0	0
22	5661530	.	G	T	5	5	10	0	0	10	0	0
22	5661785	.	G	A	2	2	4	0	0	4	0	0
22	5663260	.	T	A	2	3	5	0	1	6	0	0
22	5663275	.	G	A	1	4	5	0	1	6	0	0
22	5667582	.	A	G	15	7	22	0	2	24	0	0
22	5667596	.	T	G	16	9	25	0	1	26	0	0
22	5667629	.	T	C	19	8	27	0	0	27	0	0
22	5752315	.	G	A	18	5	23	0	0	23	0	0
22	5756066	.	G	A	31	15	46	1	2	49	0	0
22	5756317	.	C	T	9	6	15	0	0	15	0	0
22	5756340	.	A	T	5	5	10	0	0	10	0	0
22	5758678	.	C	T	10	14	24	0	3	27	0	0
22	5758689	.	A	T	12	15	27	0	5	32	0	0
22	5761968	.	G	A	7	5	12	0	1	13	0	0
22	5762097	.	C	T	4	3	7	0	0	7	0	0
22	5763846	.	G	A	6	3	9	0	0	9	0	0
22	5763881	.	A	G	5	3	8	0	1	9	0	0
22	5773482	.	G	A	2	2	4	0	0	4	0	0
22	5948123	.	A	G	0	5	5	0	1	6	0	0
22	6073976	.	C	T	3	2	5	0	0	5	0	0
22	6074074	.	T	C	2	4	6	0	0	6	0	0
22	6074106	.	A	G	1	3	4	0	0	4	0	0
22	6456068	.	C	T	1	2	3	0	0	3	0	0
22	6456073	.	A	T	1	2	3	0	0	3	0	0
22	6528134	.	A	G	9	4	13	0	0	13	0	0
22	6528313	.	T	C	7	0	7	0	3	10	0	0
22	6528632	.	C	T	5	4	9	0	0	9	0	0
22	6562428	.	A	T	1	1	2	0	1	3	0	0
22	7556580	.	A	G	4	2	6	0	0	6	0	0
22	7558337	.	T	C	1	3	4	0	1	5	0	0
22	7558973	.	C	T	0	3	3	0	1	4	0	0
22	7558980	.	C	T	2	3	5	0	0	5	0	0
22	7642705	.	C	T	1	2	3	0	0	3	0	0
22	7642713	.	G	A	1	1	2	0	1	3	0	0
22	7677356	.	C	T	2	6	8	2	1	11	0	0
22	7677423	.	T	A	7	4	11	3	0	14	0	0
22	7677460	.	T	C	4	0	4	5	3	12	0	0
22	7683065	.	G	C	5	1	6	1	2	9	0	0
22	7683828	.	T	G	4	9	13	0	0	13	0	0
22	7683892	.	T	A	6	3	9	0	0	9	0	0
22	7693774	.	T	C	2	2	4	2	1	7	0	0
22	7972538	.	C	T	1	2	3	5	3	11	0	0
22	7972544	.	G	A	1	4	5	5	1	11	0	0
22	7974164	.	C	A	6	7	13	1	0	14	0	0
22	7974277	.	A	C	2	2	4	0	0	4	0	0
22	7974302	.	C	G	1	4	5	0	0	5	0	0
22	8074075	.	A	G	3	3	6	2	0	8	0	0
22	8074091	.	T	A	2	2	4	4	0	8	0	0
22	8161183	.	A	C	4	3	7	0	2	9	0	0
22	8162059	.	C	T	1	6	7	0	3	10	0	0
22	8163917	.	G	A	1	4	5	0	2	7	0	0
22	8163993	.	G	T	2	8	10	0	0	10	0	0
22	8296684	.	T	A	3	2	5	0	0	5	0	0
22	8296714	.	C	T	4	2	6	0	1	7	0	0
22	8324735	.	G	C	2	5	7	0	0	7	0	0
22	8340703	.	T	A	17	5	22	0	0	22	0	0
22	8341167	.	A	G	1	2	3	0	0	3	0	0
22	8341173	.	T	C	2	1	3	0	0	3	0	0
22	8341436	.	A	G	5	2	7	0	0	7	0	0
22	8342158	.	T	C	4	2	6	0	2	8	0	0
22	8342165	.	C	A	7	2	9	0	0	9	0	0
22	8347393	.	C	T	1	2	3	0	0	3	0	0
22	8715641	.	C	T	1	2	3	1	0	4	0	0
22	8715670	.	C	T	1	3	4	0	5	9	0	0
22	8715692	.	C	T	0	2	2	0	6	8	0	0
22	8769121	.	T	A	3	4	7	1	0	8	0	0
22	8769431	.	A	G	3	2	5	0	2	7	0	0
22	8769518	.	G	C	1	6	7	0	1	8	0	0
22	8769579	.	T	G	4	5	9	0	1	10	0	0
22	8769809	.	G	A	4	2	6	1	0	7	0	0
22	8769816	.	G	A	5	2	7	1	0	8	0	0
22	8769952	.	A	T	7	8	15	0	0	15	0	0
22	8769954	.	G	A	7	6	13	0	2	15	0	0
22	8770013	.	G	A	0	7	7	0	4	11	0	0
22	8770221	.	T	A	1	2	3	0	0	3	0	0
22	8770302	.	T	C	3	6	9	0	0	9	0	0
22	8784437	.	A	G	1	1	2	0	2	4	0	0
22	8784438	.	G	T	2	2	4	0	0	4	0	0
22	8784482	.	G	A	0	2	2	0	1	3	0	0
22	8784483	.	C	A	1	2	3	0	0	3	0	0
22	8785063	.	G	C	0	2	2	0	1	3	0	0
22	8785982	.	T	G	3	2	5	0	0	5	0	0
22	8786112	.	G	A	0	2	2	0	1	3	0	0
22	8786445	.	G	A	0	3	3	0	5	8	0	0
22	8787704	.	A	C	3	3	6	0	0	6	0	0
22	8994946	.	A	C	9	6	15	0	3	18	0	0
22	8995453	.	G	T	11	3	14	0	0	14	0	0
22	9006620	.	G	A	0	3	3	0	1	4	0	0
22	9006944	.	T	C	2	2	4	0	0	4	0	0
22	9057022	.	A	G	2	3	5	0	0	5	0	0
22	9057025	.	A	G	2	3	5	0	0	5	0	0
22	9070639	.	G	A	1	2	3	0	0	3	0	0
22	9383161	.	G	A	1	2	3	2	0	5	0	0
22	9496453	.	C	T	3	2	5	0	0	5	0	0
22	9496936	.	G	A	3	5	8	0	0	8	0	0
22	9499555	.	C	G	6	10	16	0	0	16	0	0
22	9499579	.	C	G	7	0	7	0	9	16	0	0
22	9504689	.	C	T	3	7	10	0	0	10	0	0
22	9504749	.	T	C	2	4	6	0	0	6	0	0
22	9508114	.	G	A	7	4	11	0	0	11	0	0
22	9508704	.	T	G	8	15	23	0	4	28	1	0
22	9513048	.	T	C	7	9	16	0	0	16	0	0
22	9530562	.	G	A	6	7	13	0	0	13	0	0
22	9530571	.	T	C	6	8	14	0	0	14	0	0
22	9532339	.	C	T	5	3	8	0	2	10	0	0
22	9535191	.	T	C	8	12	20	0	1	21	0	0
22	9535290	.	C	T	5	7	12	0	1	13	0	0
22	9535890	.	T	C	5	8	13	0	0	13	0	0
22	9535932	.	C	A	9	4	13	0	1	14	0	0
22	9536984	.	C	T	10	19	29	0	2	31	0	0
22	9537583	.	T	C	16	17	33	0	20	53	0	0
22	9537637	.	T	C	22	19	41	0	16	57	0	0
22	9537779	.	A	G	10	5	15	0	13	28	0	0
22	9835096	.	A	G	2	3	5	0	0	5	0	0
22	9835108	.	C	T	2	3	5	0	1	6	0	0
22	9835189	.	T	C	1	6	7	0	0	7	0	0
22	9835622	.	A	G	1	3	4	0	0	4	0	0
22	9835639	.	T	C	1	2	3	0	0	3	0	0
22	9868095	.	C	G	1	0	1	0	4	5	0	0
22	9868134	.	A	G	6	5	11	0	0	11	0	0
22	9868136	.	A	T	6	5	11	0	0	11	0	0
22	9877026	.	C	G	7	7	14	0	0	14	0	0
22	9877095	.	A	G	12	5	17	0	1	18	0	0
22	9877115	.	G	A	14	9	23	0	0	23	0	0
22	9877345	.	G	A	1	3	4	0	6	10	0	0
22	9877565	.	C	A	9	5	14	0	0	14	0	0
22	9877667	.	C	G	5	3	8	0	0	8	0	0
22	9877902	.	C	T	9	6	15	0	0	15	0	0
22	9877956	.	C	T	12	9	21	0	0	21	0	0
22	9878045	.	T	C	3	7	10	0	2	12	0	0
22	9878047	.	A	T	4	8	12	0	0	12	0	0
22	9878218	.	G	C	11	2	13	0	0	13	0	0
22	9878366	.	T	A	9	3	12	0	0	12	0	0
22	9887054	.	A	T	5	3	8	0	0	8	0	0
22	9887293	.	A	G	4	3	7	0	0	7	0	0
22	9887803	.	C	T	0	2	2	0	1	3	0	0
22	9898094	.	A	G	1	2	3	0	0	3	0	0
22	9898898	.	T	C	2	4	6	0	1	7	0	0
22	9899174	.	G	A	1	2	3	1	0	4	0	0
22	9899279	.	A	G	2	3	5	1	0	6	0	0
22	9899645	.	G	T	2	2	4	0	0	4	0	0
22	9899657	.	T	C	2	2	4	0	0	4	0	0
22	10049478	.	T	C	2	2	4	0	0	4	0	0
22	10184031	.	G	T	2	2	4	0	0	4	0	0
22	10184079	.	T	A	2	4	6	0	0	6	0	0
22	10189781	.	G	A	2	4	6	0	2	8	0	0
22	10190801	.	T	C	14	3	17	0	2	19	0	0
22	10196055	.	A	T	3	5	8	0	0	8	0	0
22	10196058	.	T	A	3	5	8	0	0	8	0	0
22	10196291	.	T	C	9	6	15	0	0	15	0	0
22	10196394	.	G	A	1	9	10	0	10	20	0	0
22	10196508	.	T	A	9	4	13	0	0	13	0	0
22	10196621	.	C	A	10	10	20	0	0	20	0	0
22	10197146	.	C	T	14	8	22	2	0	24	0	0
22	10197180	.	T	A	21	8	29	0	0	29	0	0
22	10197195	.	T	C	15	7	22	0	0	22	0	0
22	10197796	.	G	C	0	9	9	0	8	17	0	0
22	10197972	.	C	G	8	14	22	0	2	24	0	0
22	10198018	.	A	C	15	13	28	0	2	30	0	0
22	10198178	.	A	T	11	10	21	0	3	24	0	0
22	10198283	.	T	C	14	10	24	0	1	25	0	0
22	10198359	.	G	A	19	18	37	0	1	38	0	0
22	10198737	.	G	A	12	23	35	0	0	35	0	0
22	10198779	.	G	C	10	12	22	1	1	24	0	0
22	10201858	.	G	C	1	4	5	0	5	10	0	0
22	10201888	.	G	A	17	15	32	0	0	32	0	0
22	10201906	.	G	A	0	22	22	0	19	41	0	0
22	10207978	.	A	T	13	18	31	0	3	34	0	0
22	10208011	.	T	C	14	23	37	0	3	40	0	0
22	10208032	.	A	C	13	18	31	0	1	32	0	0
22	10208089	.	C	T	12	13	25	0	3	28	0	0
22	10208101	.	T	G	18	18	36	0	3	39	0	0
22	10208134	.	G	A	17	20	37	0	2	39	0	0
22	10208182	.	C	T	21	19	40	0	0	40	0	0
22	10208212	.	C	T	23	17	40	0	1	41	0	0
22	10208296	.	G	C	1	4	5	0	0	5	0	0
22	10208404	.	C	T	17	19	36	0	1	37	0	0
22	10211754	.	C	T	31	13	44	0	2	46	0	0
22	10212230	.	C	G	19	29	48	0	3	51	0	0
22	10212307	.	C	T	32	22	54	0	1	55	0	0
22	10212416	.	T	A	14	8	22	0	1	23	0	0
22	10212417	.	T	A	9	11	20	0	1	21	0	0
22	10218538	.	T	C	2	2	4	0	0	4	0	0
22	10218682	.	A	T	2	4	6	0	0	6	0	0
22	10218916	.	T	A	3	2	5	0	0	5	0	0
22	10219030	.	T	C	2	5	7	0	1	8	0	0
22	10260078	.	A	G	3	2	5	0	0	5	0	0
22	10260258	.	G	A	0	3	3	0	8	11	0	0
22	10260774	.	C	T	7	8	15	0	0	15	0	0
22	10261723	.	A	G	6	5	11	0	1	12	0	0
22	10261840	.	T	C	14	15	29	0	1	30	0	0
22	10261853	.	G	A	17	13	30	0	0	30	0	0
22	10261888	.	C	T	10	11	21	0	2	23	0	0
22	10261905	.	T	C	17	9	26	0	0	26	0	0
22	10261949	.	G	A	9	16	25	0	0	25	0	0
22	10261963	.	T	A	9	19	28	0	2	30	0	0
22	10262216	.	A	T	11	12	23	0	1	24	0	0
22	10262236	.	T	G	14	10	24	0	0	24	0	0
22	10262296	.	C	T	7	3	10	0	1	11	0	0
22	10282344	.	G	A	1	2	3	0	1	4	0	0
22	10361324	.	T	C	6	8	14	0	1	15	0	0
22	10361478	.	A	G	8	2	10	0	3	13	0	0
22	10361787	.	C	G	12	11	23	0	1	24	0	0
22	10361889	.	A	G	11	14	25	0	0	25	0	0
22	10361892	.	A	G	11	13	24	0	0	24	0	0
22	10361964	.	T	C	9	0	9	0	14	23	0	0
22	10362003	.	T	G	15	8	23	0	0	24	1	0
22	10362072	.	G	A	6	10	16	0	3	19	0	0
22	10362174	.	C	T	1	12	13	0	17	30	0	0
22	10362229	.	A	T	14	10	24	0	1	25	0	0
22	10364681	.	A	G	7	9	16	0	0	16	0	0
22	10368054	.	A	T	13	6	19	0	2	21	0	0
22	10372847	.	C	T	1	10	11	0	7	18	0	0
22	10373081	.	T	C	8	0	8	0	6	14	0	0
22	10373099	.	C	T	0	8	8	0	5	13	0	0
22	10373617	.	G	A	2	2	4	0	0	4	0	0
22	10373915	.	T	C	0	3	3	0	0	3	0	0
22	10373920	.	C	G	2	2	4	0	0	4	0	0
22	10375637	.	A	T	4	5	9	0	1	10	0	0
22	10375864	.	C	T	3	3	6	0	0	6	0	0
22	10427265	.	T	A	2	3	5	0	0	5	0	0
22	10427283	.	C	T	0	4	4	0	3	7	0	0
22	10430189	.	A	G	6	4	10	0	1	11	0	0
22	10430252	.	A	G	3	6	9	0	0	9	0	0
22	10430292	.	G	C	1	3	4	0	0	4	0	0
22	10430369	.	A	T	5	5	10	0	0	10	0	0
22	10430709	.	T	C	4	2	6	0	0	6	0	0
22	10435233	.	A	T	1	2	3	0	0	3	0	0
22	10435508	.	A	G	3	2	5	0	0	5	0	0
22	10491303	.	G	A	1	2	3	0	0	3	0	0
22	10513731	.	G	A	0	4	4	0	2	6	0	0
22	10513783	.	T	C	1	5	6	0	0	6	0	0
22	10514154	.	T	A	2	4	6	0	1	7	0	0
22	10516377	.	G	A	1	2	3	0	0	3	0	0
22	10516496	.	C	A	2	2	4	0	1	5	0	0
22	10516808	.	C	T	8	3	11	0	0	11	0	0
22	10516864	.	T	A	2	2	4	0	0	4	0	0
22	10519951	.	T	C	2	2	4	0	0	4	0	0
22	10519955	.	A	C	2	3	5	0	0	5	0	0
22	10540812	.	G	T	6	10	16	0	0	16	0	0
22	10545267	.	C	T	1	2	3	0	0	3	0	0
22	10547986	.	C	T	2	2	4	0	1	5	0	0
22	10548171	.	G	A	4	2	6	0	0	6	0	0
22	10550095	.	A	G	3	2	5	0	0	5	0	0
22	10553526	.	G	A	1	4	5	0	0	5	0	0
22	10553532	.	C	T	3	2	5	0	0	5	0	0
22	10553620	.	G	T	4	5	9	0	1	10	0	0
22	10553626	.	G	A	3	5	8	0	1	9	0	0
22	10557870	.	T	G	8	8	16	0	0	16	0	0
22	10557898	.	C	T	5	11	16	0	0	16	0	0
22	10558913	.	G	A	0	3	3	0	4	7	0	0
22	10560944	.	C	G	5	3	8	0	0	8	0	0
22	10561514	.	A	G	11	6	17	0	2	19	0	0
22	10561758	.	A	G	17	13	30	0	0	30	0	0
22	10564220	.	T	C	13	0	13	0	9	22	0	0
22	10564247	.	A	C	14	9	23	0	0	23	0	0
22	10567550	.	T	A	2	3	5	0	2	7	0	0
22	10570575	.	T	C	5	4	9	0	1	10	0	0
22	10592056	.	A	G	4	4	8	0	0	8	0	0
22	10592059	.	A	G	4	3	7	0	0	7	0	0
22	10592426	.	C	A	10	6	16	0	0	16	0	0
22	10592719	.	T	C	16	7	23	0	1	24	0	0
22	10593310	.	A	G	13	11	24	0	0	24	0	0
22	10593527	.	A	G	5	13	18	0	3	21	0	0
22	10593531	.	G	A	5	13	18	0	1	19	0	0
22	10593831	.	T	C	11	6	17	0	2	19	0	0
22	10593990	.	A	G	6	4	10	0	0	10	0	0
22	10594008	.	G	T	4	5	9	0	1	10	0	0
22	10594074	.	C	T	6	2	8	0	2	10	0	0
22	10594098	.	G	A	8	5	13	0	0	13	0	0
22	10594170	.	A	G	4	8	12	0	0	12	0	0
22	10597385	.	T	C	6	4	10	0	0	10	0	0
22	10597470	.	A	T	4	3	7	0	9	16	0	0
22	10597715	.	T	C	3	0	3	1	3	7	0	0
22	10599510	.	A	G	3	5	8	0	1	9	0	0
22	10600265	.	C	T	0	6	6	0	6	12	0	0
22	10602243	.	A	G	5	4	9	0	0	9	0	0
22	10604423	.	C	T	4	3	7	1	0	8	0	0
22	10626747	.	T	C	3	3	6	0	0	6	0	0
22	10631669	.	G	A	0	3	3	0	1	4	0	0
22	10634437	.	G	A	5	3	8	0	0	8	0	0
22	10634810	.	T	C	7	5	12	0	0	12	0	0
22	10634822	.	G	A	5	5	10	0	0	10	0	0
22	10635402	.	G	A	2	4	6	0	0	6	0	0
22	10636581	.	T	C	7	6	13	0	1	14	0	0
22	10636762	.	A	T	8	7	15	0	1	16	0	0
22	10636974	.	G	C	12	9	21	0	0	21	0	0
22	10637232	.	A	G	10	13	23	0	2	25	0	0
22	10637253	.	T	C	10	12	22	0	4	26	0	0
22	10637298	.	C	A	11	12	23	0	3	26	0	0
22	10637669	.	G	T	11	3	14	0	1	15	0	0
22	10638536	.	A	T	7	7	14	0	0	14	0	0
22	10638700	.	T	C	9	6	15	0	0	15	0	0
22	10638887	.	T	C	12	4	16	0	1	17	0	0
22	10638932	.	G	A	0	5	5	0	7	12	0	0
22	10638974	.	G	A	3	5	8	0	0	8	0	0
22	10654549	.	C	T	3	5	8	0	0	8	0	0
22	10654777	.	T	C	3	3	6	0	1	7	0	0
22	10654783	.	T	C	4	3	7	0	0	7	0	0
22	10657947	.	T	C	1	3	4	0	0	4	0	0
22	10657980	.	A	G	4	2	6	0	1	7	0	0
22	10658007	.	T	A	5	4	9	0	0	9	0	0
22	10658042	.	A	C	7	5	12	0	1	13	0	0
22	10658090	.	G	A	1	4	5	0	6	11	0	0
22	10658102	.	A	C	5	3	8	0	1	9	0	0
22	10660261	.	A	T	11	16	27	0	1	28	0	0
22	10662886	.	C	T	10	9	19	0	1	20	0	0
22	10662952	.	C	T	11	12	23	0	2	25	0	0
22	10663090	.	G	T	2	12	14	0	14	28	0	0
22	10663390	.	T	G	10	6	16	0	2	18	0	0
22	10663433	.	A	T	4	11	15	0	3	18	0	0
22	10663469	.	T	A	7	14	21	0	0	21	0	0
22	10663504	.	T	A	14	16	30	0	2	32	0	0
22	10663567	.	A	T	18	13	31	0	0	31	0	0
22	10678954	.	A	G	1	3	4	0	0	4	0	0
22	10687899	.	A	G	3	0	3	0	3	6	0	0
22	10689412	.	C	A	3	2	5	0	0	5	0	0
22	10689488	.	C	T	2	4	6	0	0	6	0	0
22	10689506	.	T	G	1	2	3	0	1	4	0	0
22	10690497	.	T	A	2	3	5	1	0	6	0	0
22	10690669	.	C	A	2	3	5	0	0	5	0	0
22	10690674	.	C	A	2	3	5	0	0	5	0	0
22	10699054	.	C	G	2	3	5	0	0	5	0	0
22	10704081	.	T	G	6	0	6	0	5	11	0	0
22	10704255	.	A	C	7	10	17	0	0	17	0	0
22	10704279	.	T	C	8	8	16	0	0	16	0	0
22	10706462	.	G	A	1	10	11	0	9	20	0	0
22	10706603	.	G	A	0	3	3	0	15	18	0	0
22	10706726	.	A	T	3	2	5	0	0	5	0	0
22	10706732	.	A	G	3	2	5	0	0	5	0	0
22	10706855	.	T	A	3	4	7	0	0	7	0	0
22	10720122	.	G	A	2	1	3	0	1	4	0	0
22	10726968	.	T	C	4	7	11	0	0	11	0	0
22	10729626	.	C	T	3	11	14	0	0	14	0	0
22	10729675	.	C	A	9	16	25	0	0	25	0	0
22	10733284	.	C	G	9	2	11	1	22	34	0	0
22	10733360	.	A	G	13	0	13	0	9	22	0	0
22	10733512	.	C	T	6	10	16	0	1	17	0	0
22	10733554	.	G	A	6	7	13	0	2	15	0	0
22	10734916	.	G	A	12	6	18	0	2	20	0	0
22	10734967	.	A	T	5	8	13	0	3	17	1	0
22	10735015	.	C	A	4	5	9	0	0	9	0	0
22	10755600	.	A	G	15	11	26	0	0	26	0	0
22	10755652	.	T	A	10	6	16	0	1	17	0	0
22	10755746	.	G	T	18	24	42	0	3	45	0	0
22	10755888	.	T	C	19	10	29	0	2	31	0	0
22	10769877	.	A	T	1	2	3	0	0	3	0	0
22	10769910	.	A	T	1	2	3	0	0	3	0	0
22	10771195	.	C	T	1	3	4	0	9	13	0	0
22	10771284	.	T	C	14	10	24	0	0	24	0	0
22	10771369	.	G	A	12	14	26	0	1	27	0	0
22	10771415	.	A	T	9	10	19	0	3	22	0	0
22	10771628	.	T	C	7	7	14	0	1	15	0	0
22	10771743	.	C	G	5	7	12	0	0	12	0	0
22	10771752	.	G	A	5	6	11	0	0	11	0	0
22	10771919	.	T	C	8	0	8	0	13	21	0	0
22	10774628	.	G	A	9	5	14	0	1	15	0	0
22	10774632	.	T	C	8	5	13	0	0	13	0	0
22	10795290	.	A	C	2	3	5	0	0	5	0	0
22	10795696	.	C	G	2	2	4	0	0	4	0	0
22	10795745	.	T	C	2	4	6	0	0	6	0	0
22	10816880	.	T	C	2	0	2	0	3	5	0	0
22	10835049	.	C	T	1	2	3	0	0	3	0	0
22	10835064	.	T	C	1	0	1	0	2	3	0	0
22	10928084	.	A	G	1	4	5	0	0	5	0	0
22	11071011	.	G	C	1	0	1	0	5	6	0	0
22	11071053	.	A	G	1	3	4	0	2	6	0	0
22	11071059	.	C	T	1	3	4	0	1	5	0	0
22	11071416	.	G	C	1	2	3	0	0	3	0	0
22	11071568	.	C	A	2	4	6	0	0	6	0	0
22	11071698	.	T	G	2	10	12	0	0	12	0	0
22	11075978	.	A	G	4	3	7	0	0	7	0	0
22	11078902	.	T	C	5	4	9	0	0	9	0	0
22	11078944	.	C	A	0	9	9	0	6	15	0	0
22	11123770	.	C	T	37	19	56	0	1	57	0	0
22	11123889	.	T	C	23	18	41	1	4	46	0	0
22	11124524	.	T	C	33	19	52	0	3	55	0	0
22	11126857	.	A	G	31	19	50	0	4	54	0	0
22	11126866	.	G	A	28	19	47	0	4	51	0	0
22	11129995	.	G	A	16	14	30	0	0	30	0	0
22	11130058	.	T	C	11	0	11	2	12	25	0	0
22	11135408	.	G	A	23	7	30	0	0	30	0	0
22	11135446	.	G	A	25	6	31	0	4	35	0	0
22	11156275	.	C	T	2	2	4	0	0	4	0	0
22	11156578	.	A	G	2	0	2	0	3	5	0	0
22	11161201	.	T	C	9	4	13	0	2	15	0	0
22	11170855	.	T	C	7	4	11	1	2	14	0	0
22	11170954	.	T	C	10	8	18	0	0	18	0	0
22	11170966	.	T	G	7	0	7	0	10	17	0	0
22	11171086	.	G	A	13	12	25	0	1	26	0	0
22	11188598	.	C	T	8	6	14	0	0	14	0	0
22	11199942	.	T	A	18	20	38	0	2	40	0	0
22	11200160	.	C	T	1	2	3	0	0	3	0	0
22	11200242	.	T	G	4	10	14	0	2	16	0	0
22	11200401	.	G	A	1	7	8	0	20	28	0	0
22	13459294	.	A	G	10	9	19	0	2	21	0	0
22	13459472	.	T	A	5	5	10	0	1	11	0	0
22	13459596	.	T	C	8	0	8	0	3	11	0	0
22	13459611	.	A	G	7	4	11	0	1	12	0	0
22	13459636	.	G	T	8	8	16	0	0	16	0	0
22	13459718	.	A	G	7	8	15	0	0	15	0	0
22	13459865	.	G	C	5	1	6	0	7	13	0	0
22	13460191	.	T	C	16	7	23	0	2	25	0	0
22	13460406	.	T	C	19	10	29	0	1	30	0	0
22	13460441	.	C	T	2	8	10	0	10	20	0	0
22	13460483	.	A	G	5	12	17	0	0	17	0	0
22	13460509	.	T	G	6	13	19	0	1	20	0	0
22	13461012	.	A	G	4	9	13	0	1	14	0	0
22	13461073	.	C	G	3	10	13	0	0	13	0	0
22	13461084	.	C	T	3	11	14	0	0	14	0	0
22	13461622	.	T	C	2	5	7	0	0	7	0	0
22	13461993	.	A	G	1	3	4	0	0	4	0	0
22	13461996	.	A	G	1	3	4	0	0	4	0	0
22	13463071	.	A	G	9	12	21	0	2	23	0	0
22	13472514	.	G	A	5	5	10	0	2	12	0	0
22	13472568	.	G	C	5	0	5	0	5	10	0	0
22	13479802	.	G	A	6	3	9	0	0	9	0	0
22	13479990	.	A	G	3	5	8	0	0	8	0	0
22	13481352	.	A	G	1	5	6	0	0	6	0	0
22	13481363	.	A	C	1	4	5	0	0	5	0	0
22	13978920	.	A	G	14	5	19	0	0	19	0	0
22	15252084	.	G	T	2	4	6	0	1	7	0	0
22	15344144	.	T	A	3	4	7	0	1	8	0	0
22	15345339	.	T	A	11	5	16	0	0	16	0	0
22	15345580	.	G	A	6	4	10	0	0	10	0	0
22	15345592	.	T	C	5	4	9	0	0	9	0	0
22	15350053	.	T	C	7	7	14	0	2	16	0	0
22	15350240	.	G	A	13	9	22	0	0	22	0	0
22	15351505	.	A	G	11	10	21	0	1	22	0	0
22	15352257	.	T	C	9	8	17	0	0	17	0	0
22	15352373	.	A	G	3	4	7	0	0	7	0	0
22	15352382	.	T	C	3	3	6	0	1	7	0	0
22	15352508	.	G	T	2	2	4	0	0	4	0	0
22	15352512	.	A	C	2	2	4	0	0	4	0	0
22	15384612	.	G	T	3	9	12	0	1	13	0	0
22	15384696	.	C	G	1	5	6	0	0	6	0	0
22	15385389	.	G	A	2	2	4	0	0	4	0	0
22	15437173	.	C	A	4	6	10	0	2	12	0	0
22	15540229	.	C	T	4	2	6	0	0	6	0	0
22	15541031	.	T	A	2	2	4	0	0	4	0	0
22	15541046	.	G	A	1	2	3	0	0	3	0	0
22	15541352	.	T	C	1	2	3	0	0	3	0	0
22	15543490	.	C	T	4	3	7	0	1	8	0	0
22	15544595	.	C	A	3	4	7	0	1	8	0	0
22	15545930	.	T	A	5	5	10	0	0	10	0	0
22	15552046	.	G	T	8	5	13	0	0	13	0	0
22	15552081	.	C	T	3	3	6	0	1	7	0	0
22	15552082	.	T	C	3	3	6	0	1	7	0	0
22	15552139	.	C	A	0	3	3	0	6	9	0	0
22	15585893	.	A	G	6	3	9	0	0	9	0	0
22	15629094	.	A	T	3	2	5	0	0	5	0	0
22	15629190	.	T	A	3	2	5	0	0	5	0	0
22	15629224	.	C	T	2	2	4	0	0	4	0	0
22	15629667	.	G	A	3	2	5	0	0	5	0	0
22	15629686	.	T	C	4	4	8	0	0	8	0	0
22	15697354	.	G	A	26	26	52	0	2	54	0	0
22	15701545	.	A	T	22	11	33	0	2	35	0	0
22	15719547	.	C	A	10	3	13	0	0	13	0	0
22	15719821	.	A	C	14	15	29	0	1	30	0	0
22	15719891	.	T	C	14	24	38	0	0	38	0	0
22	15720199	.	A	G	9	7	16	0	2	18	0	0
22	15720200	.	C	A	0	8	8	0	10	18	0	0
22	15720608	.	T	C	11	16	27	0	1	28	0	0
22	15720666	.	G	A	27	27	54	0	8	62	0	0
22	15720925	.	T	A	31	19	50	0	1	51	0	0
22	15721408	.	G	A	0	13	13	0	20	33	0	0
22	15721436	.	C	T	20	7	27	0	2	29	0	0
22	15721534	.	C	T	15	7	22	0	0	22	0	0
22	15721558	.	C	G	8	6	14	0	1	15	0	0
22	15721584	.	T	G	15	9	24	0	0	24	0	0
22	15721696	.	A	T	13	12	25	0	0	25	0	0
22	15721730	.	C	A	9	12	21	0	1	22	0	0
22	15912259	.	A	G	3	2	5	0	1	6	0	0
22	15912298	.	C	T	2	5	7	0	2	9	0	0
22	15912316	.	T	C	4	6	10	0	2	12	0	0
22	15932440	.	T	C	3	3	6	0	1	7	0	0
22	15943833	.	G	A	0	2	2	0	1	3	0	0
22	15950504	.	A	G	2	2	4	0	0	4	0	0
22	16002161	.	T	C	4	3	7	0	0	7	0	0
22	16002283	.	A	T	1	2	3	0	1	4	0	0
22	16032205	.	G	A	1	3	4	0	2	6	0	0
22	16033259	.	T	C	3	2	5	0	0	5	0	0
22	16038660	.	G	A	9	12	21	0	1	22	0	0
22	16038749	.	A	G	18	16	34	0	0	34	0	0
22	16038858	.	T	G	8	9	17	0	1	18	0	0
22	16039194	.	C	A	15	13	28	0	4	32	0	0
22	16039398	.	A	C	5	9	14	0	0	14	0	0
22	16039806	.	T	C	8	0	8	0	3	11	0	0
22	16040007	.	T	C	4	6	10	0	0	10	0	0
22	16103558	.	G	C	3	2	5	0	0	5	0	0
22	16103563	.	G	C	0	2	2	0	2	4	0	0
22	16112012	.	T	A	2	2	4	0	0	4	0	0
22	16120766	.	T	C	6	6	12	0	0	12	0	0
22	16121035	.	T	A	3	12	15	0	0	15	0	0
22	16121157	.	C	A	3	4	7	0	1	8	0	0
22	16121281	.	C	A	3	4	7	0	0	7	0	0
22	16123437	.	T	G	10	5	15	0	1	16	0	0
22	16123931	.	A	G	3	6	9	0	1	10	0	0
22	16144846	.	G	T	3	4	7	0	3	10	0	0
22	16150462	.	A	G	1	2	3	0	0	3	0	0
22	16170914	.	C	G	1	3	4	0	1	5	0	0
22	16170926	.	T	C	1	4	5	0	0	5	0	0
22	16171715	.	A	C	2	2	4	0	1	5	0	0
22	16171869	.	G	A	10	7	17	0	3	20	0	0
22	16171871	.	A	G	12	9	21	0	0	21	0	0
22	16173329	.	A	G	7	3	10	0	0	10	0	0
22	16173380	.	T	G	2	6	8	0	1	9	0	0
22	16173921	.	A	G	2	3	5	0	1	6	0	0
22	16174191	.	A	G	1	6	7	0	3	10	0	0
22	16175977	.	C	T	4	1	5	0	1	6	0	0
22	16177749	.	C	T	1	2	3	0	0	3	0	0
22	16177849	.	A	G	1	2	3	0	0	3	0	0
22	16177855	.	C	A	1	2	3	0	0	3	0	0
22	16179913	.	C	T	2	3	5	0	0	5	0	0
22	16191456	.	T	A	2	2	4	0	0	4	0	0
22	16191463	.	C	T	2	2	4	0	0	4	0	0
22	16191841	.	T	C	3	0	3	0	7	10	0	0
22	16191845	.	T	G	1	5	6	0	2	8	0	0
22	16191912	.	C	A	0	3	3	0	1	4	0	0
22	16191920	.	T	A	1	2	3	0	0	3	0	0
22	16193024	.	T	C	2	0	2	0	7	9	0	0
22	16201599	.	C	T	1	4	5	0	3	8	0	0
22	16201632	.	G	A	2	4	6	0	1	7	0	0
22	16282323	.	A	T	3	2	5	0	0	5	0	0
22	16282335	.	A	G	4	3	7	0	0	7	0	0
22	16282571	.	T	A	10	9	19	0	0	19	0	0
22	16282636	.	T	G	7	8	15	0	1	16	0	0
22	16282757	.	C	G	1	10	11	0	6	17	0	0
22	16287499	.	T	G	1	3	4	0	0	4	0	0
22	16290698	.	G	A	1	2	3	0	0	3	0	0
22	16298535	.	G	T	1	2	3	0	1	4	0	0
22	16298666	.	T	C	3	2	5	0	0	5	0	0
22	16298720	.	A	C	2	4	6	0	0	6	0	0
22	16298756	.	C	T	3	3	6	0	1	7	0	0
22	16302465	.	C	T	3	1	4	0	2	6	0	0
22	16302468	.	C	T	1	3	4	0	1	5	0	0
22	16302877	.	A	T	7	5	12	0	2	14	0	0
22	16305164	.	A	C	8	10	18	0	1	19	0	0
22	16305673	.	G	A	4	7	11	0	0	11	0	0
22	16311748	.	C	T	0	2	2	0	1	3	0	0
22	16312222	.	T	G	7	5	12	0	0	12	0	0
22	16312228	.	A	G	8	4	12	0	0	12	0	0
22	16312755	.	T	C	2	3	5	0	0	5	0	0
22	16312783	.	C	T	0	4	4	0	4	8	0	0
22	16313005	.	T	A	5	3	8	0	0	8	0	0
22	16317797	.	A	T	2	2	4	0	0	4	0	0
22	16324766	.	G	A	1	2	3	0	0	3	0	0
22	16340761	.	A	G	3	2	5	0	0	5	0	0
22	16340960	.	A	G	1	0	1	0	3	4	0	0
22	16345485	.	A	G	1	2	3	0	0	3	0	0
22	16350811	.	T	G	18	19	37	0	5	42	0	0
22	16351199	.	C	G	12	20	32	0	2	34	0	0
22	16351204	.	C	T	0	18	18	0	13	31	0	0
22	16351317	.	G	A	7	8	15	1	1	17	0	0
22	16351353	.	G	A	3	4	7	0	0	7	0	0
22	16351404	.	C	T	4	4	8	0	1	9	0	0
22	16351490	.	T	G	8	10	18	1	2	21	0	0
22	16351552	.	A	T	10	5	15	0	0	15	0	0
22	16352215	.	A	G	7	7	14	0	0	14	0	0
22	16352349	.	A	G	20	5	25	0	0	25	0	0
22	16352463	.	C	A	1	13	14	0	9	23	0	0
22	16352469	.	A	G	8	14	22	0	0	22	0	0
22	16352528	.	G	A	10	9	19	0	0	19	0	0
22	16352668	.	T	C	19	0	19	0	12	31	0	0
22	16352739	.	C	T	0	10	10	0	17	27	0	0
22	16355013	.	A	C	13	11	24	0	1	25	0	0
22	16355042	.	C	A	14	15	29	0	2	31	0	0
22	16355555	.	A	G	8	9	17	0	0	17	0	0
22	16357818	.	A	G	13	10	23	0	2	25	0	0
22	16357831	.	A	G	13	10	23	0	1	24	0	0
22	16357867	.	G	A	12	12	24	0	0	24	0	0
22	16367007	.	T	C	2	0	2	0	5	7	0	0
22	16367055	.	A	G	4	5	9	0	0	9	0	0
22	16368886	.	G	A	4	8	12	0	0	12	0	0
22	16377364	.	A	G	6	5	11	0	0	11	0	0
22	16408228	.	C	T	0	3	3	0	2	5	0	0
22	16412091	.	A	G	2	5	7	0	0	7	0	0
22	16422166	.	A	G	5	0	5	0	7	12	0	0
22	16424576	.	T	C	8	6	14	0	0	14	0	0
22	16430672	.	C	T	15	9	24	0	1	25	0	0
22	16430843	.	C	T	2	1	3	0	2	5	0	0
22	16432627	.	C	T	23	18	41	0	2	43	0	0
22	16432628	.	A	T	23	18	41	0	2	43	0	0
22	16433078	.	G	A	12	20	32	0	1	33	0	0
22	16433096	.	A	G	15	16	31	0	2	33	0	0
22	16433131	.	T	G	13	14	27	0	2	29	0	0
22	16433250	.	G	A	8	8	16	0	1	17	0	0
22	16433394	.	G	A	8	5	13	0	4	17	0	0
22	16433422	.	A	G	11	5	16	0	0	16	0	0
22	16433912	.	T	A	5	8	13	0	1	14	0	0
22	16433940	.	C	T	8	9	17	0	0	17	0	0
22	16434056	.	G	A	7	17	24	0	1	25	0	0
22	16438112	.	A	C	9	17	26	0	1	28	1	0
22	16440086	.	T	C	3	0	3	0	12	15	0	0
22	16477548	.	C	T	1	2	3	0	0	3	0	0
22	16484277	.	T	A	12	11	23	2	2	27	0	0
22	16484621	.	G	A	12	13	25	0	0	25	0	0
22	16484877	.	A	T	9	10	19	0	2	21	0	0
22	16484938	.	A	G	14	11	25	0	0	25	0	0
22	16484944	.	T	C	13	11	24	0	0	24	0	0
22	16485035	.	A	G	6	17	23	0	2	25	0	0
22	16485538	.	T	C	7	1	8	0	8	16	0	0
22	16485563	.	A	T	5	4	9	0	0	9	0	0
22	16485625	.	A	G	3	3	6	0	0	6	0	0
22	16485688	.	G	A	8	3	11	0	0	11	0	0
22	16485920	.	G	A	6	7	13	0	0	13	0	0
22	16485954	.	C	T	5	7	12	0	3	15	0	0
22	16485962	.	C	G	7	5	12	0	3	15	0	0
22	16485994	.	C	A	3	5	8	0	3	11	0	0
22	16486004	.	C	A	1	9	10	0	3	13	0	0
22	16486112	.	T	C	6	13	19	0	1	20	0	0
22	16491693	.	G	A	11	10	21	0	4	25	0	0
22	16491720	.	T	C	17	0	17	0	7	24	0	0
22	16491942	.	G	A	16	9	25	0	2	27	0	0
22	16492000	.	T	A	7	13	20	0	3	23	0	0
22	16497953	.	G	A	16	8	24	0	0	24	0	0
22	16498155	.	G	C	2	13	15	0	8	23	0	0
22	16498317	.	A	G	23	16	39	0	0	39	0	0
22	16498661	.	A	G	12	0	12	0	16	28	0	0
22	16537701	.	C	T	3	2	5	0	0	5	0	0
22	16543627	.	C	T	14	13	27	0	1	28	0	0
22	16543714	.	T	C	16	9	25	0	0	25	0	0
22	16544243	.	C	T	12	10	22	0	0	22	0	0
22	16544260	.	C	T	11	7	18	1	1	20	0	0
22	16544308	.	A	G	6	3	9	4	0	13	0	0
22	16544384	.	G	A	10	11	21	0	1	22	0	0
22	16544400	.	T	G	13	12	25	0	2	27	0	0
22	16544599	.	A	G	22	0	22	0	10	32	0	0
22	16544674	.	T	G	26	14	40	0	0	40	0	0
22	16544780	.	A	T	19	17	36	0	3	39	0	0
22	16544800	.	G	A	16	16	32	0	0	32	0	0
22	16569862	.	C	T	2	7	9	0	0	9	0	0
22	16584241	.	C	G	12	4	16	0	0	16	0	0
22	16592011	.	A	G	10	9	19	0	0	19	0	0
22	16592029	.	C	G	1	10	11	0	9	20	0	0
22	16594870	.	T	A	5	6	11	0	0	11	0	0
22	16594981	.	C	A	7	4	11	0	0	11	0	0
22	16595022	.	A	G	7	4	11	0	0	11	0	0
22	16601400	.	C	T	3	6	9	0	1	10	0	0
22	16609449	.	T	C	7	6	13	0	0	13	0	0
22	16609494	.	G	A	6	7	13	0	0	13	0	0
22	16759111	.	G	A	5	3	8	0	2	10	0	0
22	16775306	.	C	T	14	11	25	0	1	26	0	0
22	18231256	.	T	A	12	4	16	0	1	17	0	0
22	18233234	.	T	C	2	3	5	0	0	5	0	0
22	18971667	.	T	C	3	4	7	0	0	7	0	0
22	18971697	.	T	C	1	4	5	0	0	5	0	0
22	18971725	.	T	C	2	2	4	0	0	4	0	0
22	20954086	.	T	A	9	2	11	0	2	13	0	0
22	21547331	.	A	G	4	2	6	0	0	6	0	0
22	21676233	.	G	A	6	9	15	0	0	15	0	0
22	21676296	.	G	A	2	6	8	1	2	11	0	0
22	24358392	.	T	A	4	0	4	0	2	6	0	0
22	24358397	.	T	A	3	0	3	0	3	6	0	0
22	24358504	.	A	T	3	2	5	0	0	5	0	0
22	24359566	.	A	T	5	2	7	0	0	7	0	0
22	24360581	.	A	T	2	2	4	0	0	4	0	0
22	24361095	.	A	G	12	8	20	0	1	21	0	0
22	24975369	.	A	G	8	5	13	0	1	14	0	0
22	24975398	.	C	A	2	8	10	0	8	18	0	0
22	24975457	.	G	A	7	6	13	0	1	14	0	0
22	24975668	.	C	T	1	8	9	0	1	10	0	0
22	24984053	.	A	C	2	3	5	0	0	5	0	0
22	25025208	.	G	A	31	19	50	0	2	52	0	0
22	25028424	.	G	A	13	21	34	0	4	38	0	0
22	25028751	.	A	G	9	7	16	0	0	16	0	0
22	25028838	.	A	G	3	5	8	0	0	8	0	0
22	25029136	.	T	A	6	12	18	0	0	18	0	0
22	25029193	.	C	G	0	5	5	0	8	13	0	0
22	25032293	.	T	C	5	14	19	0	1	20	0	0
22	25032532	.	C	G	13	8	21	0	2	23	0	0
22	25032572	.	G	A	9	8	17	0	2	19	0	0
22	25032620	.	A	C	19	1	20	0	6	26	0	0
22	25032665	.	T	C	14	2	16	0	5	21	0	0
22	25032693	.	T	C	9	5	14	0	0	14	0	0
22	25032921	.	A	T	7	3	10	0	0	10	0	0
22	25032986	.	T	A	8	5	13	0	0	13	0	0
22	25033004	.	T	C	6	10	16	0	1	17	0	0
22	25038315	.	C	T	5	5	10	0	1	11	0	0
22	25038360	.	T	C	4	5	9	0	1	10	0	0
22	25038387	.	A	G	5	6	11	0	0	11	0	0
22	25038432	.	T	C	4	7	11	0	0	11	0	0
22	25040814	.	G	A	6	4	10	0	0	10	0	0
22	25040867	.	G	A	6	5	11	0	0	11	0	0
22	25040898	.	T	C	4	0	4	0	6	10	0	0
22	25041985	.	G	A	1	4	5	0	0	5	0	0
22	25042166	.	A	G	1	2	3	0	0	3	0	0
22	25042814	.	T	C	3	0	3	0	2	5	0	0
22	25042879	.	G	A	2	5	7	0	0	7	0	0
22	25054478	.	A	T	1	2	3	0	0	3	0	0
22	25055704	.	G	T	0	2	2	0	1	3	0	0
22	25063474	.	C	T	5	5	10	0	1	11	0	0
22	25066583	.	A	G	11	6	17	0	0	17	0	0
22	25066585	.	G	A	9	6	15	0	1	16	0	0
22	25069884	.	C	A	2	5	7	0	0	7	0	0
22	25076701	.	G	A	7	2	9	0	1	10	0	0
22	25101582	.	T	C	3	3	6	0	0	6	0	0
22	25107296	.	T	C	1	2	3	0	1	4	0	0
22	25107298	.	G	A	2	2	4	0	0	4	0	0
22	25579961	.	A	T	1	1	2	0	2	4	0	0
22	25580014	.	T	A	3	2	5	0	0	5	0	0
22	25843625	.	T	C	1	2	3	0	0	3	0	0
22	25845010	.	C	T	2	2	4	0	0	4	0	0
22	25845419	.	G	A	4	2	6	0	0	6	0	0
22	25845719	.	A	T	1	3	4	0	0	4	0	0
22	25845831	.	C	G	3	2	5	0	1	6	0	0
22	25845849	.	C	T	2	2	4	0	0	4	0	0
22	25934061	.	A	G	3	2	5	0	0	5	0	0
22	25934659	.	G	A	0	10	10	0	3	13	0	0
22	25934662	.	A	G	3	9	12	0	1	13	0	0
22	25938882	.	T	C	2	3	5	0	0	5	0	0
22	25939066	.	A	G	5	12	17	0	0	17	0	0
22	25940965	.	A	T	8	9	17	0	1	18	0	0
22	25942349	.	A	G	14	8	22	0	4	26	0	0
22	25942390	.	A	C	11	9	20	0	1	21	0	0
22	25942659	.	A	G	2	3	5	0	1	6	0	0
22	25942660	.	A	G	3	3	6	0	0	6	0	0
22	25942728	.	A	G	4	0	4	0	8	12	0	0
22	25942769	.	T	C	5	6	11	0	0	11	0	0
22	25942822	.	A	G	5	6	11	0	0	11	0	0
22	25942829	.	A	C	5	5	10	0	0	10	0	0
22	25942884	.	C	T	1	3	4	0	1	5	0	0
22	25942940	.	A	G	1	5	6	0	1	7	0	0
22	25942985	.	G	T	2	7	9	0	0	9	0	0
22	25942997	.	T	G	3	4	7	0	0	7	0	0
22	26239473	.	T	A	1	3	4	0	0	4	0	0
22	26239602	.	T	C	3	4	7	1	0	8	0	0
22	26239610	.	G	A	3	4	7	1	0	8	0	0
22	26239681	.	C	T	0	14	14	0	7	21	0	0
22	26239774	.	T	A	5	15	20	0	1	21	0	0
22	26243236	.	A	C	3	0	3	0	7	10	0	0
22	26243242	.	C	T	4	6	10	0	1	11	0	0
22	26244704	.	C	T	3	8	11	0	0	11	0	0
22	26245683	.	G	A	2	9	11	0	0	11	0	0
22	26264805	.	T	A	5	3	8	0	0	8	0	0
22	26264807	.	A	G	5	3	8	0	1	9	0	0
22	26265477	.	C	T	1	4	5	0	4	9	0	0
22	26265498	.	A	T	4	5	9	0	1	10	0	0
22	26266765	.	C	T	4	8	12	0	0	12	0	0
22	26266798	.	C	A	5	5	10	0	0	10	0	0
22	26266956	.	C	A	7	3	10	0	1	11	0	0
22	26278017	.	T	A	4	2	6	0	0	7	1	0
22	26278273	.	G	A	3	5	8	0	1	9	0	0
22	26289243	.	T	G	1	2	3	0	1	4	0	0
22	26290324	.	C	T	8	10	18	0	1	19	0	0
22	26290762	.	A	G	2	6	8	0	1	9	0	0
22	26290771	.	A	C	1	3	4	0	1	5	0	0
22	26304186	.	T	C	6	3	9	0	0	9	0	0
22	26307671	.	A	G	1	3	4	0	1	5	0	0
22	26311254	.	A	G	1	3	4	0	0	4	0	0
22	26524910	.	A	T	5	3	8	0	0	8	0	0
22	26525112	.	T	C	9	5	14	0	1	15	0	0
22	26525118	.	C	T	1	5	6	0	10	16	0	0
22	26525935	.	T	G	2	3	5	0	1	6	0	0
22	26525960	.	A	G	4	3	7	0	0	7	0	0
22	26525979	.	C	T	6	3	9	0	1	10	0	0
22	26526004	.	A	T	7	4	11	0	0	11	0	0
22	26526119	.	C	T	5	7	12	0	0	12	0	0
22	26526178	.	T	C	7	6	13	0	0	13	0	0
22	26526249	.	A	T	4	8	12	0	0	12	0	0
22	26526293	.	A	C	3	3	6	0	0	6	0	0
22	26526296	.	A	G	3	3	6	0	0	6	0	0
22	26526412	.	G	A	5	3	8	0	0	8	0	0
22	26526471	.	A	G	2	3	5	0	0	5	0	0
22	26526522	.	G	A	4	3	7	0	0	7	0	0
22	26526564	.	T	C	7	3	10	0	0	10	0	0
22	26526611	.	G	C	5	0	5	0	3	8	0	0
22	26526732	.	G	A	3	2	5	0	0	5	0	0
22	26526864	.	C	A	5	5	10	0	0	10	0	0
22	26527416	.	C	G	1	3	4	0	0	4	0	0
22	26527792	.	A	G	3	5	8	0	1	9	0	0
22	26528070	.	C	G	2	1	3	0	1	4	0	0
22	26528078	.	G	C	2	0	2	0	1	3	0	0
22	26528690	.	T	C	2	0	2	0	2	4	0	0
22	26528808	.	A	G	2	2	4	0	0	4	0	0
22	26529278	.	T	C	1	0	1	0	4	5	0	0
22	26529429	.	A	G	2	1	3	0	0	3	0	0
22	26529438	.	C	A	1	2	3	0	1	4	0	0
22	26768020	.	C	G	3	2	5	0	0	5	0	0
22	26768023	.	T	C	3	2	5	0	0	5	0	0
22	26771067	.	G	T	3	6	9	0	0	9	0	0
22	26774079	.	G	A	0	2	2	0	1	3	0	0
22	26774660	.	C	T	3	5	8	0	0	8	0	0
22	26776678	.	C	T	6	4	10	0	1	11	0	0
22	26776681	.	G	A	6	4	10	0	1	11	0	0
22	26785290	.	C	T	2	4	6	0	0	6	0	0
22	26786013	.	A	G	3	3	6	0	1	7	0	0
22	26786559	.	C	A	3	5	8	0	2	10	0	0
22	26787710	.	G	T	10	4	14	0	0	14	0	0
22	26787911	.	C	T	18	15	33	0	2	35	0	0
22	26788340	.	G	A	9	15	24	0	0	24	0	0
22	26788449	.	T	C	10	11	21	0	1	22	0	0
22	26788565	.	T	C	14	17	31	0	0	31	0	0
22	26788885	.	C	A	14	9	23	0	4	27	0	0
22	26789228	.	G	A	0	16	16	0	23	39	0	0
22	26789465	.	A	G	17	0	17	0	12	30	1	0
22	26789667	.	C	G	13	0	13	0	8	21	0	0
22	26789742	.	G	A	7	5	12	0	0	12	0	0
22	26789813	.	A	T	17	14	31	0	2	33	0	0
22	26790074	.	C	T	10	16	26	0	0	26	0	0
22	26790436	.	A	T	16	8	24	0	1	25	0	0
22	26799927	.	G	A	0	1	1	0	3	4	0	0
22	26799960	.	A	G	1	4	5	0	0	5	0	0
22	26811854	.	G	A	2	2	4	0	0	4	0	0
22	26811877	.	G	A	2	2	4	0	0	4	0	0
22	26812016	.	A	G	4	4	8	0	1	9	0	0
22	26812031	.	G	A	3	4	7	0	1	8	0	0
22	26812058	.	G	A	6	2	8	0	0	8	0	0
22	26812153	.	A	G	3	0	3	0	2	5	0	0
22	26812336	.	A	G	1	0	1	0	2	3	0	0
22	26812506	.	C	T	6	7	13	0	0	13	0	0
22	26812825	.	G	A	4	3	7	0	0	7	0	0
22	26813028	.	T	A	5	2	7	0	0	7	0	0
22	26813046	.	G	A	0	3	3	0	4	7	0	0
22	26813179	.	G	A	2	3	5	0	0	5	0	0
22	26813185	.	C	T	3	3	6	0	0	6	0	0
22	26813224	.	T	C	4	2	6	0	0	6	0	0
22	26813412	.	C	T	3	4	7	0	0	7	0	0
22	26813620	.	A	T	5	3	8	0	1	9	0	0
22	26813851	.	T	G	10	3	13	0	0	13	0	0
22	26813963	.	A	G	5	2	7	0	0	7	0	0
22	26813970	.	T	C	4	2	6	0	1	7	0	0
22	26814309	.	A	G	8	0	8	0	3	11	0	0
22	26814320	.	C	T	6	3	9	0	1	10	0	0
22	26818086	.	G	A	0	5	5	0	13	18	0	0
22	26818700	.	T	C	8	9	17	0	0	17	0	0
22	26818851	.	T	A	14	8	22	0	1	23	0	0
22	26818907	.	A	G	8	0	8	0	6	14	0	0
22	26819277	.	T	C	1	3	4	0	0	4	0	0
22	26832125	.	G	A	12	10	22	0	3	25	0	0
22	26839502	.	T	A	10	8	18	0	4	22	0	0
22	26839505	.	G	A	12	9	21	0	0	21	0	0
22	26839538	.	T	G	9	5	14	0	1	15	0	0
22	26844260	.	G	A	15	10	25	0	0	25	0	0
22	26844345	.	A	C	9	9	18	0	0	18	0	0
22	26851904	.	A	C	2	0	2	0	4	6	0	0
22	26852243	.	C	T	0	2	2	0	1	3	0	0
22	26854626	.	C	A	3	1	4	0	2	6	0	0
22	26854965	.	A	G	4	4	8	0	1	9	0	0
22	26855037	.	C	G	4	4	8	0	0	8	0	0
22	26855314	.	T	C	3	3	6	0	0	6	0	0
22	26855694	.	C	T	1	2	3	0	0	3	0	0
22	26855766	.	A	G	4	2	6	0	0	6	0	0
22	26855844	.	T	C	1	3	4	0	0	4	0	0
22	26856023	.	A	G	2	10	12	0	0	12	0	0
22	26856059	.	A	T	5	8	13	1	1	15	0	0
22	26858216	.	T	C	14	7	21	0	0	21	0	0
22	26860639	.	C	T	1	15	16	0	15	31	0	0
22	26860753	.	T	C	13	9	22	0	2	24	0	0
22	26861264	.	T	C	7	0	7	0	11	18	0	0
22	26865182	.	C	A	4	1	5	0	1	6	0	0
22	26929689	.	G	A	8	11	19	1	0	20	0	0
22	26929826	.	C	A	21	14	35	1	3	39	0	0
22	26929931	.	A	T	22	23	45	0	6	51	0	0
22	26929969	.	A	G	30	24	54	0	1	55	0	0
22	26930076	.	A	G	15	25	40	0	1	41	0	0
22	26930079	.	G	T	14	25	39	0	2	41	0	0
22	26930133	.	G	C	28	23	51	0	1	52	0	0
22	26930313	.	C	T	23	12	35	0	2	37	0	0
22	26930335	.	A	T	24	15	39	0	2	41	0	0
22	26930390	.	C	T	15	20	35	0	2	37	0	0
22	26930489	.	C	G	16	19	35	0	1	36	0	0
22	26930527	.	T	A	14	21	35	0	0	35	0	0
22	26930601	.	T	C	18	10	28	0	1	29	0	0
22	26930735	.	G	C	12	0	12	0	10	22	0	0
22	26930894	.	C	T	0	20	20	0	16	36	0	0
22	26931467	.	C	T	3	2	5	0	0	5	0	0
22	26931661	.	A	G	4	2	6	0	0	6	0	0
22	26931761	.	T	C	9	2	11	0	0	11	0	0
22	26931906	.	C	T	8	7	15	0	0	15	0	0
22	26931967	.	G	A	15	11	26	0	0	26	0	0
22	26940409	.	G	A	5	5	10	0	1	11	0	0
22	27091989	.	C	T	4	5	9	0	0	9	0	0
22	27092147	.	G	A	2	3	5	0	0	5	0	0
22	27092155	.	T	C	2	2	4	0	0	4	0	0
22	27092183	.	A	C	1	3	4	0	1	5	0	0
22	27098736	.	G	A	3	7	10	0	0	10	0	0
22	27098899	.	T	C	4	5	9	0	1	10	0	0
22	27104159	.	C	G	2	2	4	0	1	5	0	0
22	28236839	.	A	T	2	5	7	0	3	10	0	0
22	28240544	.	A	G	2	10	12	0	0	12	0	0
22	28240555	.	T	A	2	6	8	0	2	10	0	0
22	28241719	.	A	T	4	2	6	0	0	6	0	0
22	28241831	.	T	A	4	5	9	0	0	9	0	0
22	28244972	.	A	G	4	3	7	0	0	7	0	0
22	28255399	.	G	T	1	4	5	0	0	5	0	0
22	28255495	.	T	C	2	6	8	0	0	8	0	0
22	28255514	.	C	G	3	0	3	0	5	8	0	0
22	28265596	.	T	G	2	2	4	0	0	4	0	0
22	28265621	.	T	C	3	2	5	0	2	7	0	0
22	28265636	.	G	T	3	2	5	0	0	5	0	0
22	28284646	.	A	C	2	4	6	0	0	6	0	0
22	28284659	.	C	T	4	4	8	0	0	8	0	0
22	28287669	.	T	C	4	5	9	0	1	10	0	0
22	28290817	.	C	T	2	5	7	0	1	8	0	0
22	28303025	.	C	T	5	12	17	0	0	17	0	0
22	28303091	.	C	A	13	9	22	0	1	23	0	0
22	28481589	.	C	T	2	4	6	0	0	6	0	0
22	28481616	.	A	C	2	2	4	0	1	5	0	0
22	28481641	.	G	A	0	2	2	0	4	6	0	0
22	28481742	.	C	T	2	2	4	0	0	4	0	0
22	28642555	.	G	A	7	3	10	0	0	10	0	0
22	28642695	.	A	C	4	2	6	0	0	6	0	0
22	28642715	.	C	A	0	3	3	0	5	8	0	0
22	28642777	.	G	A	2	3	5	0	1	6	0	0
22	28642997	.	C	A	6	2	8	0	2	10	0	0
22	28643048	.	C	T	1	4	5	0	1	6	0	0
22	28769149	.	G	A	2	2	4	0	0	4	0	0
22	28769339	.	T	G	1	4	5	0	0	5	0	0
22	28804013	.	G	A	1	2	3	0	1	4	0	0
22	28832823	.	G	C	5	3	8	0	0	8	0	0
22	28836346	.	G	A	4	2	6	0	0	6	0	0
22	28837231	.	A	G	10	8	18	0	3	21	0	0
22	28837546	.	G	C	1	4	5	0	1	6	0	0
22	28839917	.	A	C	6	4	10	0	1	11	0	0
22	28840101	.	C	A	13	4	17	0	0	17	0	0
22	28840154	.	A	G	10	6	16	0	0	16	0	0
22	28847988	.	G	A	10	9	19	0	0	19	0	0
22	28848724	.	A	T	14	8	22	1	2	25	0	0
22	28848735	.	T	C	14	7	21	1	1	23	0	0
22	28848920	.	A	G	6	6	12	0	0	12	0	0
22	28858314	.	A	G	17	6	23	0	1	24	0	0
22	28859346	.	G	A	16	11	27	0	1	28	0	0
22	28859409	.	A	G	18	8	26	0	1	27	0	0
22	28859618	.	A	G	8	13	21	0	1	22	0	0
22	28859683	.	G	T	9	5	14	0	2	16	0	0
22	28862336	.	C	T	7	6	13	0	0	13	0	0
22	28862534	.	A	G	5	6	11	0	0	11	0	0
22	28863137	.	G	A	8	7	15	0	1	16	0	0
22	28863140	.	G	A	7	7	14	0	1	15	0	0
22	28865752	.	G	A	9	4	13	0	1	14	0	0
22	28865970	.	A	G	2	2	4	0	1	5	0	0
22	28871698	.	G	C	9	0	9	0	8	17	0	0
22	29075278	.	C	T	5	6	11	0	1	12	0	0
22	29076058	.	T	G	5	5	10	0	1	11	0	0
22	29076126	.	A	G	7	6	13	0	2	15	0	0
22	29076172	.	G	A	12	7	19	0	0	19	0	0
22	29076236	.	T	C	11	12	23	0	1	24	0	0
22	29076381	.	G	C	8	12	20	0	2	22	0	0
22	29076389	.	A	G	8	11	19	0	4	23	0	0
22	29076444	.	G	C	6	6	12	0	2	14	0	0
22	29076755	.	G	A	6	2	8	0	1	9	0	0
22	29077023	.	T	A	4	6	10	0	1	11	0	0
22	29077380	.	G	A	6	5	11	0	1	12	0	0
22	29077432	.	A	G	7	4	11	0	0	11	0	0
22	29077515	.	G	A	5	2	7	0	0	7	0	0
22	29077665	.	T	A	4	3	7	0	1	8	0	0
22	29078255	.	T	A	3	2	5	0	0	5	0	0
22	29078715	.	C	T	2	2	4	0	1	5	0	0
22	29079722	.	G	T	5	2	7	0	0	7	0	0
22	29080205	.	G	A	5	5	10	0	0	10	0	0
22	29080233	.	G	A	4	3	7	0	1	8	0	0
22	29080427	.	G	A	3	3	6	0	1	7	0	0
22	29080477	.	T	G	4	5	9	0	0	9	0	0
22	29080864	.	C	T	3	5	8	0	0	8	0	0
22	29091732	.	G	C	2	2	4	0	1	5	0	0
22	29092222	.	C	A	4	2	6	0	0	6	0	0
22	29097303	.	A	G	3	0	3	0	3	6	0	0
22	29097354	.	T	A	3	2	5	0	0	5	0	0
22	29103453	.	A	G	4	3	7	0	1	8	0	0
22	29113803	.	G	A	0	2	2	0	1	3	0	0
22	29113882	.	A	G	3	2	5	0	1	6	0	0
22	29114351	.	G	A	4	3	7	0	1	8	0	0
22	29118736	.	G	A	0	5	5	0	8	13	0	0
22	29119326	.	T	A	2	1	3	0	1	4	0	0
22	29121740	.	G	A	1	2	3	0	4	7	0	0
22	29121765	.	C	T	4	5	9	0	0	9	0	0
22	29121789	.	G	A	0	8	8	0	2	10	0	0
22	29125660	.	C	T	7	3	10	0	0	10	0	0
22	29125699	.	T	A	5	3	8	0	0	8	0	0
22	29126556	.	G	C	4	2	6	0	0	6	0	0
22	29126682	.	A	G	2	4	6	0	0	6	0	0
22	29127891	.	G	A	1	2	3	1	0	4	0	0
22	29127904	.	C	G	1	2	3	1	0	4	0	0
22	29168879	.	G	A	29	27	56	0	7	63	0	0
22	29168940	.	T	A	33	31	64	0	9	73	0	0
22	29242280	.	A	G	18	6	24	0	4	28	0	0
22	29242296	.	G	C	14	6	20	0	1	21	0	0
22	29242317	.	G	A	8	3	11	0	0	11	0	0
22	29312274	.	G	C	1	0	1	0	2	3	0	0
22	29312851	.	A	C	1	2	3	0	0	3	0	0
22	29316091	.	T	A	4	2	6	0	0	6	0	0
22	29316139	.	A	T	1	2	3	0	0	3	0	0
22	29316153	.	A	C	1	0	1	0	1	2	0	0
22	29316302	.	T	A	2	2	4	0	1	5	0	0
22	30359955	.	G	T	11	2	13	1	1	15	0	0
22	31440806	.	C	T	4	2	6	0	0	6	0	0
22	31513575	.	C	T	0	3	3	0	2	5	0	0
22	32238393	.	A	T	1	6	7	0	2	9	0	0
22	32239218	.	A	G	6	0	6	0	5	11	0	0
22	32239223	.	A	G	1	7	8	0	2	10	0	0
22	32291832	.	T	C	19	0	19	1	8	28	0	0
22	32291834	.	T	C	12	0	12	1	15	28	0	0
22	33190241	.	C	T	1	4	5	0	1	6	0	0
22	33190835	.	C	T	5	3	8	0	1	9	0	0
22	33190994	.	C	T	4	8	12	0	0	12	0	0
22	33191033	.	C	A	7	7	14	0	1	15	0	0
22	33191039	.	C	T	8	8	16	0	2	18	0	0
22	33191097	.	A	G	11	5	16	0	0	16	0	0
22	33191426	.	G	T	1	4	5	0	1	6	0	0
22	33191831	.	C	A	3	7	10	1	0	11	0	0
22	33191852	.	G	T	1	6	7	0	5	12	0	0
22	33192392	.	T	G	7	1	8	0	14	22	0	0
22	33192496	.	G	A	6	9	15	0	0	15	0	0
22	33193821	.	G	T	6	3	9	0	1	10	0	0
22	33194419	.	T	A	7	11	18	0	0	18	0	0
22	33194475	.	C	T	7	7	14	0	1	15	0	0
22	33194507	.	G	A	1	9	10	0	3	13	0	0
22	33194627	.	A	T	5	4	9	0	1	10	0	0
22	33364271	.	A	T	1	4	5	0	0	5	0	0
22	33364536	.	C	T	2	2	4	0	3	7	0	0
22	33364558	.	G	A	0	3	3	0	2	5	0	0
22	33373896	.	A	G	2	3	5	0	0	5	0	0
22	33377969	.	C	T	3	2	5	0	1	6	0	0
22	33378098	.	G	A	2	4	6	0	1	7	0	0
22	33378108	.	C	T	0	5	5	0	0	5	0	0
22	33378432	.	A	T	4	2	6	0	0	6	0	0
22	33378445	.	G	T	4	5	9	0	1	10	0	0
22	33378479	.	G	A	0	4	4	0	6	10	0	0
22	33535881	.	C	T	2	15	17	0	12	29	0	0
22	33535884	.	C	T	1	13	14	0	12	26	0	0
22	33591895	.	C	T	3	7	10	0	14	24	0	0
22	33592530	.	G	T	4	11	15	0	1	16	0	0
22	33592708	.	T	C	7	0	7	0	12	19	0	0
22	33639382	.	C	T	0	5	5	0	8	13	0	0
22	33639388	.	G	A	6	9	15	0	0	15	0	0
22	33639418	.	G	A	3	9	12	0	1	13	0	0
22	33915644	.	A	T	4	2	6	0	1	7	0	0
22	33915896	.	T	G	2	6	8	0	0	8	0	0
22	34431166	.	T	C	8	6	14	0	0	14	0	0
22	34431702	.	C	T	9	6	15	0	0	15	0	0
22	35182097	.	C	A	10	3	13	0	6	19	0	0
22	36530032	.	A	T	3	2	5	0	0	5	0	0
22	36530034	.	A	G	3	2	5	0	0	5	0	0
22	36530155	.	T	C	2	2	4	0	0	4	0	0
22	36592638	.	T	C	2	2	4	0	0	4	0	0
22	36594827	.	A	G	3	2	5	0	0	5	0	0
22	36596763	.	T	C	3	3	6	0	0	6	0	0
22	36596817	.	A	G	5	2	7	0	0	7	0	0
22	36598444	.	C	T	4	2	6	0	0	6	0	0
22	36598459	.	G	C	6	3	9	0	0	9	0	0
22	36622717	.	A	G	3	7	10	1	0	11	0	0
22	36634111	.	T	C	2	5	7	0	0	7	0	0
22	36634167	.	G	C	0	3	3	0	3	6	0	0
22	36634210	.	G	C	2	5	7	0	0	7	0	0
22	36661047	.	A	C	2	3	5	0	0	5	0	0
22	36674186	.	G	A	35	17	52	0	3	55	0	0
22	36674646	.	A	G	7	13	20	0	0	20	0	0
22	36674658	.	G	A	10	16	26	0	1	27	0	0
22	36676056	.	G	C	24	21	45	0	2	47	0	0
22	36681357	.	T	G	18	16	34	0	2	36	0	0
22	36681359	.	A	G	20	16	36	0	2	38	0	0
22	36683803	.	C	A	21	10	31	0	1	33	1	0
22	36684170	.	A	G	8	11	19	5	1	25	0	0
22	36685768	.	T	C	26	0	26	0	17	43	0	0
22	36687328	.	G	A	6	7	13	0	1	14	0	0
22	36687403	.	G	A	19	5	24	0	0	24	0	0
22	36687418	.	C	T	1	12	13	0	10	23	0	0
22	36687616	.	C	T	1	11	12	0	11	23	0	0
22	36742674	.	T	A	3	3	6	1	0	7	0	0
22	36750518	.	G	A	1	3	4	1	0	5	0	0
22	36750547	.	G	A	1	1	2	1	1	4	0	0
22	36755369	.	G	A	6	2	8	0	1	9	0	0
22	36755458	.	A	T	2	2	4	0	0	4	0	0
22	36755554	.	A	C	2	4	6	0	0	6	0	0
22	36755732	.	G	T	4	4	8	0	0	8	0	0
22	36755963	.	G	C	2	0	2	0	10	12	0	0
22	36755973	.	T	G	3	9	12	0	1	13	0	0
22	36756005	.	T	C	5	9	14	0	1	15	0	0
22	36756112	.	A	G	2	10	12	0	0	12	0	0
22	36756154	.	A	T	9	3	12	0	0	12	0	0
22	36756325	.	G	A	6	6	12	1	2	15	0	0
22	36756400	.	C	T	3	6	9	0	1	10	0	0
22	36756404	.	G	C	3	8	11	0	0	11	0	0
22	36756464	.	T	A	8	7	15	0	0	15	0	0
22	36757140	.	C	G	11	5	16	0	0	16	0	0
22	36757170	.	C	T	8	8	16	1	0	17	0	0
22	36768102	.	G	A	3	2	5	1	0	6	0	0
22	36795279	.	C	T	10	3	13	0	0	13	0	0
22	36795755	.	G	C	5	11	16	0	2	18	0	0
22	36795803	.	T	C	3	0	3	0	12	15	0	0
22	36800480	.	C	G	1	4	5	0	2	7	0	0
22	36800685	.	T	A	4	7	11	0	0	11	0	0
22	36801429	.	C	T	2	4	6	0	1	7	0	0
22	36801500	.	A	G	2	3	5	0	0	5	0	0
22	36801515	.	T	C	1	3	4	0	0	4	0	0
22	36801551	.	A	T	1	3	4	0	0	4	0	0
22	36842224	.	A	T	1	2	3	0	0	3	0	0
22	36877344	.	T	C	4	4	8	0	0	8	0	0
22	36877531	.	G	A	0	3	3	0	2	5	0	0
22	36877534	.	G	T	0	3	3	0	2	5	0	0
22	36878044	.	T	A	1	2	3	0	0	3	0	0
22	36882150	.	G	A	1	7	8	0	0	8	0	0
22	36882388	.	T	C	5	3	8	0	0	8	0	0
22	36882409	.	T	A	5	5	10	0	1	11	0	0
22	36885065	.	T	G	9	1	10	0	3	13	0	0
22	36888572	.	A	G	8	0	8	0	10	18	0	0
22	36888623	.	A	G	13	12	25	0	0	25	0	0
22	36893357	.	G	A	4	12	16	0	1	17	0	0
22	36893411	.	A	C	12	7	19	0	0	19	0	0
22	36894283	.	T	A	9	10	19	0	2	21	0	0
22	36894410	.	A	C	9	7	16	0	0	16	0	0
22	36896641	.	G	A	2	5	7	0	6	13	0	0
22	36896681	.	C	T	11	11	22	0	0	22	0	0
22	36896705	.	C	T	13	8	21	0	1	22	0	0
22	36898727	.	T	C	11	11	22	0	2	24	0	0
22	36899149	.	G	A	1	14	15	0	17	32	0	0
22	36899269	.	C	T	17	22	39	0	0	39	0	0
22	36899574	.	A	G	3	9	12	0	1	13	0	0
22	36899621	.	A	T	3	6	9	0	0	9	0	0
22	36947793	.	T	A	14	9	23	0	0	23	0	0
22	36947797	.	G	T	10	12	22	0	0	22	0	0
22	36947963	.	T	C	11	1	12	0	16	28	0	0
22	36948177	.	C	A	7	8	15	0	2	17	0	0
22	36948237	.	A	T	7	6	13	0	0	13	0	0
22	36948242	.	A	G	7	5	12	0	0	12	0	0
22	36948410	.	G	A	5	8	13	0	3	16	0	0
22	36948530	.	A	G	13	10	23	1	1	25	0	0
22	36970997	.	A	G	2	3	5	0	0	5	0	0
22	36978378	.	C	T	1	2	3	0	0	3	0	0
22	37276310	.	C	T	0	1	1	0	1	2	0	0
22	37276329	.	G	T	2	2	4	0	0	4	0	0
22	37276606	.	C	A	7	12	19	0	1	20	0	0
22	37276709	.	C	T	0	4	4	0	12	16	0	0
22	37276717	.	A	G	4	12	16	0	0	16	0	0
22	37277941	.	A	C	2	3	5	0	1	6	0	0
22	37277963	.	A	G	1	4	5	0	2	7	0	0
22	37277996	.	A	G	2	5	7	0	0	7	0	0
22	37278045	.	C	T	1	5	6	0	0	6	0	0
22	37278260	.	G	T	2	7	9	0	1	10	0	0
22	37278385	.	G	A	8	4	12	0	1	13	0	0
22	37834111	.	G	T	5	5	10	0	1	11	0	0
22	37874723	.	C	T	6	2	8	0	1	9	0	0
22	37874897	.	C	T	1	2	3	0	0	3	0	0
22	37875270	.	T	C	2	4	6	0	1	7	0	0
22	37875454	.	C	G	4	5	9	0	0	9	0	0
22	37875482	.	T	G	3	4	7	0	1	8	0	0
22	37881023	.	G	A	8	8	16	0	0	16	0	0
22	37881090	.	A	G	9	9	18	0	1	19	0	0
22	37881126	.	C	T	14	6	20	0	1	21	0	0
22	37881134	.	G	A	14	5	19	0	1	20	0	0
22	37881433	.	G	T	14	10	24	0	1	25	0	0
22	38001504	.	G	A	1	4	5	0	2	7	0	0
22	38037578	.	A	T	4	5	9	0	0	9	0	0
22	38040050	.	G	A	1	6	7	0	5	12	0	0
22	38041860	.	T	A	9	11	20	0	1	21	0	0
22	38041893	.	C	T	10	10	20	0	0	20	0	0
22	38045009	.	T	A	10	19	29	0	3	32	0	0
22	38174040	.	C	T	2	2	4	0	0	4	0	0
22	38176577	.	C	T	1	2	3	0	0	3	0	0
22	38178703	.	G	A	0	2	2	0	7	9	0	0
22	38178747	.	G	A	1	2	3	0	0	3	0	0
22	38181037	.	G	A	2	2	4	0	0	4	0	0
22	38183762	.	C	T	5	2	7	0	0	7	0	0
22	38186385	.	C	A	3	4	7	0	0	7	0	0
22	38186409	.	A	G	4	5	9	0	1	10	0	0
22	38191029	.	C	G	2	3	5	0	1	6	0	0
22	38191168	.	C	G	7	5	12	0	1	13	0	0
22	38191181	.	G	A	4	4	8	0	3	11	0	0
22	38191715	.	A	G	14	11	25	0	0	25	0	0
22	38191718	.	T	A	11	11	22	0	2	24	0	0
22	38194106	.	C	T	21	10	31	0	1	32	0	0
22	38194124	.	T	G	11	17	28	0	0	28	0	0
22	38195217	.	G	A	15	24	39	3	3	45	0	0
22	38195229	.	C	T	23	16	39	6	5	50	0	0
22	38197900	.	C	T	26	41	67	0	6	73	0	0
22	38199965	.	G	T	2	1	3	0	1	4	0	0
22	38202898	.	T	C	2	1	3	0	1	4	0	0
22	38202904	.	C	T	2	2	4	0	0	4	0	0
22	38209295	.	A	G	2	2	4	0	0	4	0	0
22	38284020	.	A	C	3	2	5	0	0	5	0	0
22	38286993	.	C	A	2	2	4	0	0	4	0	0
22	38290097	.	A	G	3	2	5	0	0	5	0	0
22	38290307	.	G	A	3	5	8	0	0	8	0	0
22	38293746	.	G	A	1	5	6	0	4	10	0	0
22	38293854	.	T	C	3	4	7	0	0	7	0	0
22	38293890	.	C	T	2	4	6	0	0	6	0	0
22	38343178	.	G	A	1	3	4	0	1	5	0	0
22	38343265	.	G	T	3	3	6	0	0	6	0	0
22	38400375	.	G	C	5	2	7	0	0	7	0	0
22	38468163	.	A	G	5	4	9	0	1	10	0	0
22	38468562	.	C	T	0	16	16	0	13	29	0	0
22	38468595	.	C	T	17	18	35	0	0	35	0	0
22	38468644	.	C	T	13	18	31	0	0	31	0	0
22	38469848	.	C	A	1	19	20	0	10	30	0	0
22	38475593	.	A	G	22	10	32	0	0	32	0	0
22	38475664	.	A	T	18	6	24	0	0	24	0	0
22	38492116	.	G	A	18	11	29	0	2	31	0	0
22	38496335	.	A	G	4	13	17	1	0	18	0	0
22	38499727	.	C	T	0	15	15	3	6	24	0	0
22	38501815	.	G	C	7	9	16	0	0	16	0	0
22	38507937	.	C	T	2	4	6	0	0	6	0	0
22	38508006	.	C	A	8	5	13	0	1	14	0	0
22	38508018	.	C	A	7	4	11	0	3	14	0	0
22	38508100	.	C	T	4	7	11	0	0	11	0	0
22	38508102	.	C	T	3	7	10	0	0	10	0	0
22	38516814	.	A	T	4	7	11	0	0	11	0	0
22	38516816	.	C	T	4	7	11	0	0	11	0	0
22	38516899	.	G	A	1	2	3	0	0	3	0	0
22	38520250	.	G	C	6	0	6	0	3	9	0	0
22	38520336	.	A	C	17	0	17	0	9	26	0	0
22	38520360	.	A	C	13	12	25	0	1	26	0	0
22	38520867	.	A	T	17	12	29	0	0	29	0	0
22	38521353	.	G	C	15	9	24	0	2	26	0	0
22	38521596	.	C	G	2	9	11	0	1	12	0	0
22	38521683	.	A	T	24	17	41	0	0	41	0	0
22	38521883	.	C	A	6	6	12	0	0	12	0	0
22	38522271	.	G	T	12	5	17	0	0	17	0	0
22	38522468	.	C	T	5	5	10	0	0	10	0	0
22	38522471	.	T	A	5	5	10	0	0	10	0	0
22	38522622	.	G	C	11	10	21	0	1	22	0	0
22	38523540	.	T	A	8	12	20	0	0	20	0	0
22	38523917	.	C	A	1	8	9	0	8	17	0	0
22	38523941	.	T	C	11	10	21	0	0	21	0	0
22	38524033	.	T	C	6	5	11	0	1	12	0	0
22	38524099	.	C	T	1	4	5	0	1	6	0	0
22	38524107	.	C	T	4	2	6	0	0	6	0	0
22	38524304	.	T	A	6	6	12	0	0	12	0	0
22	38524322	.	G	A	3	5	8	0	0	8	0	0
22	38524544	.	A	G	9	7	16	0	0	16	0	0
22	38524621	.	G	C	7	6	13	0	0	13	0	0
22	38525003	.	C	T	1	4	5	0	3	8	0	0
22	38525326	.	T	G	5	4	9	0	0	9	0	0
22	38525996	.	G	T	4	7	11	0	1	12	0	0
22	38526033	.	A	G	2	3	5	0	0	5	0	0
22	38543597	.	C	G	2	5	7	0	0	7	0	0
22	38549152	.	G	A	1	5	6	0	1	7	0	0
22	38550922	.	T	C	1	2	3	0	1	4	0	0
22	38559907	.	A	G	2	3	5	0	0	5	0	0
22	38615220	.	T	G	9	4	13	1	2	16	0	0
22	38617884	.	G	A	3	2	5	0	3	8	0	0
22	38621256	.	A	T	5	3	8	0	0	8	0	0
22	38796656	.	T	A	0	7	7	0	1	8	0	0
22	38796811	.	T	C	9	0	9	2	5	16	0	0
22	38798816	.	T	C	7	0	7	0	8	15	0	0
22	38800038	.	T	A	3	2	5	0	0	5	0	0
22	38909087	.	T	C	2	2	4	0	0	4	0	0
22	38911467	.	G	A	0	3	3	0	3	6	0	0
22	38911481	.	G	A	0	4	4	0	3	7	0	0
22	38911514	.	C	T	2	2	4	0	0	4	0	0
22	38911553	.	T	G	1	0	1	0	3	4	0	0
22	38911575	.	C	T	1	4	5	0	0	5	0	0
22	38912384	.	T	G	6	0	6	0	3	9	0	0
22	38912445	.	A	G	2	3	5	0	0	5	0	0
22	38912649	.	G	T	2	2	4	0	0	4	0	0
22	38912723	.	G	A	1	2	3	0	0	3	0	0
22	38913524	.	C	G	3	4	7	0	0	7	0	0
22	38915071	.	T	A	1	4	5	0	0	5	0	0
22	38919010	.	A	C	2	3	5	0	0	5	0	0
22	38919354	.	G	C	3	2	5	0	1	6	0	0
22	38925404	.	A	G	3	0	3	0	3	6	0	0
22	38928275	.	T	A	3	6	9	0	0	9	0	0
22	38928367	.	G	C	0	7	7	0	4	11	0	0
22	38928450	.	A	T	9	3	12	0	0	12	0	0
22	38928517	.	T	A	6	7	13	0	1	14	0	0
22	38928586	.	G	A	6	8	14	0	0	14	0	0
22	38928593	.	G	T	6	8	14	0	1	15	0	0
22	38928738	.	G	A	3	4	7	0	0	7	0	0
22	38928979	.	T	G	5	2	7	0	0	7	0	0
22	38929002	.	T	C	4	5	9	0	0	9	0	0
22	38929112	.	T	C	7	6	13	0	0	13	0	0
22	38932288	.	G	A	14	10	24	0	1	25	0	0
22	38934663	.	C	T	3	12	15	0	0	15	0	0
22	38934759	.	T	C	5	0	5	0	5	10	0	0
22	38937336	.	A	G	3	0	3	0	2	5	0	0
22	38942981	.	A	T	7	2	9	0	0	9	0	0
22	38945312	.	C	T	6	4	10	0	0	10	0	0
22	38945316	.	A	C	6	2	8	0	2	10	0	0
22	38945420	.	T	C	6	4	10	0	0	10	0	0
22	38946148	.	G	C	3	5	8	0	0	8	0	0
22	38946246	.	T	A	3	2	5	0	1	6	0	0
22	38946287	.	A	G	1	7	8	0	2	10	0	0
22	38946369	.	G	C	1	6	7	0	2	9	0	0
22	38946403	.	T	C	1	6	7	0	0	7	0	0
22	38946553	.	T	C	4	12	16	0	1	17	0	0
22	38946576	.	T	C	7	12	19	0	1	20	0	0
22	38946608	.	A	C	9	16	25	0	2	27	0	0
22	38946953	.	T	A	13	11	24	0	2	26	0	0
22	38947381	.	G	A	3	2	5	0	3	8	0	0
22	38951084	.	T	C	7	5	12	0	2	14	0	0
22	38951130	.	A	T	10	5	15	0	0	15	0	0
22	38951137	.	C	A	10	5	15	0	0	15	0	0
22	39015203	.	A	T	1	3	4	0	1	5	0	0
22	39017130	.	G	A	0	3	3	0	1	4	0	0
22	39023318	.	G	C	0	2	2	0	3	5	0	0
22	39023680	.	C	A	9	4	13	0	0	13	0	0
22	39028350	.	G	A	0	2	2	0	7	9	0	0
22	39028700	.	T	G	7	0	7	0	14	21	0	0
22	39032738	.	C	A	6	4	10	0	0	10	0	0
22	39032814	.	A	G	3	6	9	0	0	9	0	0
22	39033134	.	C	T	5	19	24	0	0	24	0	0
22	39033332	.	A	G	9	0	9	0	5	14	0	0
22	39033637	.	C	G	8	10	18	0	0	18	0	0
22	39033644	.	T	C	9	9	18	0	0	18	0	0
22	39054209	.	A	G	1	2	3	0	0	3	0	0
22	39076602	.	C	T	8	3	11	0	2	13	0	0
22	39077407	.	C	G	10	1	11	0	4	15	0	0
22	39079335	.	G	A	1	7	8	0	4	12	0	0
22	39079356	.	A	C	8	5	13	0	1	14	0	0
22	39079379	.	C	A	10	5	15	1	1	17	0	0
22	39079428	.	C	G	10	10	20	1	1	22	0	0
22	39079470	.	G	A	0	12	12	0	8	20	0	0
22	39079528	.	T	A	9	11	20	0	0	20	0	0
22	39079950	.	C	A	12	10	22	0	3	25	0	0
22	39080035	.	C	G	15	12	27	0	1	28	0	0
22	39080043	.	G	C	17	13	30	0	2	32	0	0
22	39080290	.	C	T	13	7	20	0	1	21	0	0
22	39080402	.	A	C	13	9	22	0	0	22	0	0
22	39080547	.	A	C	7	10	17	0	0	17	0	0
22	39080679	.	C	G	12	10	22	0	1	23	0	0
22	39080701	.	C	A	14	8	22	0	3	25	0	0
22	39081126	.	A	T	14	17	31	0	1	32	0	0
22	39084966	.	A	T	9	4	13	0	0	13	0	0
22	39095748	.	G	A	7	8	15	0	0	15	0	0
22	39095966	.	T	C	10	3	13	0	0	13	0	0
22	39096080	.	C	A	5	4	9	0	0	9	0	0
22	39096117	.	A	C	3	7	10	0	2	12	0	0
22	39104849	.	G	A	5	4	9	0	0	9	0	0
22	39105022	.	T	C	3	4	7	0	1	8	0	0
22	39107877	.	G	A	2	3	5	0	0	5	0	0
23	33338	.	G	A	1	3	4	0	0	4	0	0
23	252305	.	T	C	4	3	7	0	0	7	0	0
23	458254	.	T	C	14	8	22	0	1	23	0	0
23	458890	.	T	C	2	2	4	0	0	4	0	0
23	564952	.	A	G	1	0	1	0	2	3	0	0
23	585624	.	A	G	4	4	8	1	0	9	0	0
23	585825	.	A	G	5	8	13	0	0	13	0	0
23	585848	.	A	G	9	0	9	0	9	18	0	0
23	587021	.	A	G	15	6	21	0	0	21	0	0
23	587031	.	A	G	4	18	22	0	0	22	0	0
23	587161	.	A	G	13	7	20	0	0	20	0	0
23	587398	.	A	G	15	0	15	0	11	26	0	0
23	863395	.	T	C	13	4	17	0	2	19	0	0
23	863405	.	T	C	12	0	12	0	7	19	0	0
23	863668	.	A	T	10	6	16	0	3	21	2	0
23	863918	.	T	C	3	3	6	0	0	6	0	0
23	863922	.	T	C	1	6	7	0	0	7	0	0
23	864366	.	T	C	3	3	6	0	1	7	0	0
23	864376	.	T	C	0	4	4	0	0	4	0	0
23	1719384	.	A	G	8	4	12	0	5	17	0	0
23	1723720	.	A	G	9	0	9	0	8	17	0	0
23	1723748	.	G	A	5	6	11	0	0	11	0	0
23	1723992	.	C	T	9	6	15	0	0	15	0	0
23	1725456	.	T	C	8	8	16	0	3	19	0	0
23	1725634	.	A	G	3	0	3	0	2	5	0	0
23	1725664	.	G	A	4	2	6	0	1	7	0	0
23	1725785	.	G	C	3	8	11	0	1	12	0	0
23	1725803	.	G	C	3	6	9	0	0	9	0	0
23	1725959	.	C	T	22	4	26	0	0	26	0	0
23	1725974	.	T	A	25	5	30	0	1	31	0	0
23	1726080	.	T	C	12	13	25	0	1	26	0	0
23	1726106	.	G	T	16	6	22	0	3	25	0	0
23	1726467	.	T	A	6	6	12	0	0	12	0	0
23	2053221	.	G	A	4	2	6	0	1	7	0	0
23	2053305	.	A	G	2	2	4	0	0	4	0	0
23	2053414	.	A	G	5	2	7	0	0	7	0	0
23	2053418	.	C	A	3	3	6	0	1	7	0	0
23	2054010	.	C	T	4	8	12	0	1	13	0	0
23	2054175	.	G	A	4	2	6	0	0	6	0	0
23	2054316	.	C	G	2	1	3	0	1	4	0	0
23	2054584	.	G	C	1	3	4	0	0	4	0	0
23	2054952	.	T	G	2	2	4	0	0	4	0	0
23	2055219	.	T	C	1	2	3	0	0	3	0	0
23	2055240	.	T	A	1	2	3	0	0	3	0	0
23	2136417	.	T	C	4	2	6	0	0	6	0	0
23	2155134	.	T	C	3	4	7	0	0	7	0	0
23	2158054	.	T	C	2	3	5	0	0	5	0	0
23	2160242	.	T	C	6	3	9	0	0	9	0	0
23	2232040	.	T	C	1	4	5	0	0	5	0	0
23	2246536	.	G	A	3	3	6	0	0	6	0	0
23	2246855	.	C	G	3	0	3	0	4	7	0	0
23	2249537	.	A	G	2	0	2	0	3	5	0	0
23	2249589	.	G	A	0	3	3	0	1	4	0	0
23	2249633	.	T	C	2	5	7	0	0	7	0	0
23	2252812	.	G	A	4	8	12	0	0	12	0	0
23	2256142	.	G	C	4	5	9	0	1	10	0	0
23	2256348	.	C	T	2	6	8	0	2	10	0	0
23	2256349	.	A	T	3	7	10	0	0	10	0	0
23	2435776	.	G	A	12	30	42	0	0	42	0	0
23	2438388	.	G	A	11	24	35	0	0	35	0	0
23	2438463	.	G	T	4	16	20	0	15	35	0	0
23	2438641	.	A	T	22	19	41	0	1	42	0	0
23	2440698	.	G	A	17	16	33	0	0	33	0	0
23	2443160	.	C	T	13	21	34	0	2	36	0	0
23	2443613	.	C	T	15	21	36	0	1	37	0	0
23	2443772	.	T	C	16	2	18	1	3	22	0	0
23	2443782	.	T	C	14	3	17	1	4	22	0	0
23	2542247	.	T	A	3	2	5	0	0	5	0	0
23	2547556	.	A	C	3	4	7	0	0	7	0	0
23	2564339	.	T	A	7	4	11	2	0	13	0	0
23	2564420	.	T	C	5	4	9	0	1	10	0	0
23	2679634	.	G	A	0	7	7	15	5	27	0	0
23	2689807	.	T	C	9	13	22	0	3	25	0	0
23	2690659	.	C	T	17	9	26	0	1	27	0	0
23	2717852	.	A	C	14	17	31	0	0	31	0	0
23	2717867	.	T	G	10	15	25	0	5	30	0	0
23	2718009	.	C	G	14	15	29	0	2	31	0	0
23	2721348	.	T	C	2	2	4	1	0	5	0	0
23	2721539	.	A	G	19	15	34	0	2	36	0	0
23	2725095	.	A	C	8	11	19	0	0	19	0	0
23	2757876	.	T	A	1	4	5	0	0	5	0	0
23	2762007	.	A	G	2	2	4	0	1	5	0	0
23	2767194	.	G	A	0	6	6	0	2	8	0	0
23	2767227	.	C	T	1	4	5	0	0	5	0	0
23	2770169	.	G	A	7	4	11	0	0	11	0	0
23	2770171	.	A	C	7	4	11	0	0	11	0	0
23	2773310	.	C	T	2	2	4	0	1	5	0	0
23	2774812	.	G	A	8	6	14	0	0	14	0	0
23	2775033	.	G	A	3	5	8	0	0	8	0	0
23	2777534	.	G	A	5	3	8	0	0	8	0	0
23	2778827	.	A	G	2	3	5	0	0	5	0	0
23	2837155	.	T	C	1	4	5	0	0	5	0	0
23	2837188	.	C	T	2	4	6	0	0	6	0	0
23	2837218	.	T	C	4	3	7	0	0	7	0	0
23	2849307	.	G	A	0	2	2	0	6	8	0	0
23	2860937	.	T	G	4	1	5	0	2	7	0	0
23	2861990	.	C	T	9	8	17	0	0	17	0	0
23	2864186	.	A	T	8	7	15	0	0	15	0	0
23	2870732	.	T	A	8	9	17	0	1	18	0	0
23	2871264	.	C	T	6	4	10	0	0	10	0	0
23	2871699	.	G	A	8	9	17	0	0	17	0	0
23	2871908	.	A	G	10	10	20	0	0	20	0	0
23	2871994	.	T	C	7	11	18	0	2	20	0	0
23	2872206	.	T	C	11	11	22	0	2	24	0	0
23	2872338	.	T	G	21	0	21	1	10	32	0	0
23	2872517	.	G	T	18	28	46	0	3	49	0	0
23	2872924	.	A	C	3	3	6	0	0	6	0	0
23	2873327	.	A	T	5	10	15	0	1	16	0	0
23	2877144	.	C	T	0	13	13	0	7	20	0	0
23	2877519	.	T	C	4	0	4	0	9	13	0	0
23	2877603	.	A	C	3	5	8	0	0	8	0	0
23	2877792	.	C	A	0	4	4	0	3	7	0	0
23	2877930	.	T	C	7	4	11	0	0	11	0	0
23	2878041	.	C	A	0	5	5	0	5	10	0	0
23	2879040	.	A	G	1	3	4	0	0	4	0	0
23	2879618	.	A	G	2	4	6	0	0	6	0	0
23	2880143	.	T	C	2	2	4	0	0	4	0	0
23	2906312	.	A	G	10	10	20	0	0	20	0	0
23	2917463	.	T	C	3	2	5	0	1	6	0	0
23	2919264	.	A	G	1	0	1	0	2	3	0	0
23	2919276	.	T	C	1	1	2	0	1	3	0	0
23	2923068	.	G	A	0	3	3	0	2	5	0	0
23	2925086	.	T	C	4	4	8	0	0	8	0	0
23	2925137	.	C	T	3	3	6	0	1	7	0	0
23	2925238	.	A	T	2	2	4	0	0	4	0	0
23	2925357	.	T	C	3	3	6	0	0	6	0	0
23	2927117	.	A	G	6	5	11	0	1	12	0	0
23	2927144	.	A	G	8	5	13	0	0	13	0	0
23	2927175	.	C	T	3	5	8	0	0	8	0	0
23	2929180	.	A	G	5	6	11	0	0	11	0	0
23	2931288	.	T	A	6	8	14	0	0	14	0	0
23	2931321	.	G	A	7	6	13	0	2	15	0	0
23	2931329	.	C	A	6	10	16	0	1	17	0	0
23	2931358	.	C	T	10	7	17	0	0	17	0	0
23	2931409	.	C	T	10	12	22	0	1	23	0	0
23	2931461	.	A	G	10	0	10	0	4	14	0	0
23	2931732	.	C	A	7	9	16	0	0	16	0	0
23	2931836	.	C	A	7	3	10	0	1	11	0	0
23	2931970	.	T	A	9	13	22	0	0	22	0	0
23	2932241	.	A	T	10	8	18	0	1	19	0	0
23	3406094	.	C	A	11	4	15	0	4	19	0	0
23	3406708	.	T	C	9	13	22	0	4	26	0	0
23	3406729	.	A	G	10	15	25	0	2	27	0	0
23	3406811	.	T	C	17	10	27	0	2	29	0	0
23	3406950	.	T	G	1	4	5	0	1	6	0	0
23	3407285	.	T	A	11	18	29	0	3	32	0	0
23	3407305	.	C	A	14	17	31	0	0	31	0	0
23	3517582	.	T	A	4	2	6	0	1	7	0	0
23	3517621	.	T	G	3	5	8	0	1	9	0	0
23	3517734	.	T	G	9	0	9	0	4	13	0	0
23	3520120	.	C	T	13	6	19	0	0	19	0	0
23	3653478	.	G	T	16	17	33	0	2	36	1	0
23	3653846	.	T	C	15	12	27	0	0	27	0	0
23	3653859	.	G	A	14	10	24	0	1	25	0	0
23	3653953	.	T	A	7	6	13	0	0	13	0	0
23	3654034	.	A	G	12	9	21	0	1	22	0	0
23	3654106	.	C	T	1	6	7	0	1	8	0	0
23	3654134	.	A	G	2	3	5	0	0	5	0	0
23	3654356	.	C	T	5	3	8	0	0	8	0	0
23	3654490	.	A	C	10	7	17	0	1	18	0	0
23	3654747	.	C	T	0	20	20	0	17	37	0	0
23	3654774	.	G	A	11	16	27	0	0	27	0	0
23	3654989	.	A	G	15	13	28	0	2	30	0	0
23	3655082	.	C	T	0	11	11	0	12	24	1	0
23	3655139	.	T	A	8	15	23	0	2	25	0	0
23	3655207	.	T	G	19	20	39	0	1	40	0	0
23	3655220	.	A	G	18	18	36	0	2	38	0	0
23	3657557	.	T	C	17	24	41	0	2	43	0	0
23	3657602	.	T	C	18	0	18	0	24	42	0	0
23	3660060	.	C	A	0	18	18	0	10	28	0	0
23	3660674	.	A	G	12	14	26	0	0	27	1	0
23	3660713	.	G	A	13	9	22	0	1	23	0	0
23	3662210	.	G	A	19	10	29	0	0	29	0	0
23	3662246	.	C	T	3	8	11	0	11	22	0	0
23	3664306	.	A	G	7	9	16	0	0	16	0	0
23	3667257	.	T	C	6	10	16	0	0	16	0	0
23	3710965	.	A	G	3	2	5	0	0	5	0	0
23	3711178	.	T	C	6	2	8	0	0	8	0	0
23	3712002	.	G	A	5	4	9	0	0	9	0	0
23	3712511	.	C	T	5	2	7	0	0	7	0	0
23	3712884	.	C	T	2	4	6	0	0	6	0	0
23	3712905	.	A	C	1	3	4	0	0	4	0	0
23	3713045	.	T	G	3	2	5	0	0	5	0	0
23	3713321	.	A	G	5	4	9	0	0	9	0	0
23	3713363	.	A	G	9	3	12	0	1	13	0	0
23	3713388	.	C	T	8	3	11	0	0	11	0	0
23	3713491	.	G	A	8	5	13	0	1	14	0	0
23	3713622	.	A	G	5	1	6	0	1	7	0	0
23	3713643	.	G	A	4	4	8	0	1	9	0	0
23	3713692	.	T	A	5	3	8	0	0	8	0	0
23	3713928	.	A	G	3	5	8	0	0	8	0	0
23	3721131	.	T	C	6	6	12	0	0	12	0	0
23	3740379	.	T	A	13	20	33	1	0	35	1	0
23	3744621	.	C	T	10	15	25	0	1	26	0	0
23	3744654	.	A	C	4	8	12	0	1	13	0	0
23	3751965	.	A	G	17	23	40	0	3	43	0	0
23	3751990	.	A	G	18	24	42	0	0	42	0	0
23	3752305	.	C	G	15	23	38	0	3	41	0	0
23	3752394	.	C	T	3	19	22	0	20	42	0	0
23	3752992	.	T	A	14	12	26	1	2	29	0	0
23	3951804	.	T	C	5	3	8	0	0	8	0	0
23	3951948	.	G	T	13	4	17	0	1	18	0	0
23	3962692	.	A	G	1	1	2	0	1	3	0	0
23	3982588	.	G	A	1	4	5	0	0	5	0	0
23	3982936	.	G	C	1	0	1	0	3	4	0	0
23	4019600	.	T	C	3	3	6	0	0	6	0	0
23	4086772	.	G	A	0	2	2	0	1	3	0	0
23	4086817	.	T	G	1	3	4	0	0	4	0	0
23	4087020	.	T	A	4	2	6	0	0	6	0	0
23	4087064	.	C	A	1	2	3	0	0	3	0	0
23	4087213	.	T	C	1	2	3	0	0	3	0	0
23	4087644	.	G	A	1	2	3	0	0	3	0	0
23	4087665	.	A	T	1	2	3	0	0	3	0	0
23	4088188	.	T	C	1	2	3	0	0	3	0	0
23	4216363	.	T	C	5	0	5	0	5	10	0	0
23	4222119	.	A	G	3	2	5	0	0	5	0	0
23	4222437	.	C	G	1	2	3	0	0	3	0	0
23	4254105	.	G	T	1	25	26	0	20	46	0	0
23	4254192	.	A	C	12	15	27	0	2	29	0	0
23	4255566	.	C	G	20	0	20	0	25	45	0	0
23	4259194	.	A	G	21	19	40	0	0	40	0	0
23	4259369	.	T	G	26	16	42	0	3	45	0	0
23	4259626	.	G	A	24	15	39	0	2	41	0	0
23	4259635	.	G	C	4	12	16	0	23	39	0	0
23	4259674	.	G	T	9	10	19	0	0	19	0	0
23	4260629	.	G	A	3	7	10	0	1	11	0	0
23	4269780	.	C	G	22	10	32	0	0	32	0	0
23	4270928	.	T	C	19	14	33	0	3	36	0	0
23	4271333	.	A	G	23	26	49	0	1	50	0	0
23	4271730	.	G	C	21	14	35	0	1	36	0	0
23	4274411	.	G	T	1	2	3	0	0	3	0	0
23	4274423	.	C	T	1	2	3	0	0	3	0	0
23	4280602	.	A	G	1	0	1	0	2	3	0	0
23	4280747	.	C	T	2	3	5	0	1	6	0	0
23	4280877	.	A	C	3	3	6	0	0	6	0	0
23	4280888	.	G	A	3	4	7	0	0	7	0	0
23	4289066	.	C	G	5	4	9	0	1	10	0	0
23	4292251	.	C	T	4	6	10	0	0	10	0	0
23	4307737	.	C	T	6	13	19	0	2	21	0	0
23	4307740	.	T	C	6	12	18	0	2	20	0	0
23	4312033	.	T	G	10	18	28	0	1	29	0	0
23	4314691	.	G	A	10	8	18	0	0	18	0	0
23	4350905	.	A	C	1	2	3	0	0	3	0	0
23	4356999	.	C	T	2	2	4	0	0	4	0	0
23	4357040	.	T	C	2	2	4	0	0	4	0	0
23	4357124	.	T	C	2	3	5	0	1	6	0	0
23	4362847	.	C	G	2	4	6	0	0	6	0	0
23	4362874	.	T	C	2	2	4	0	0	4	0	0
23	4367071	.	G	A	4	5	9	0	0	9	0	0
23	4367390	.	T	A	4	3	7	2	0	9	0	0
23	4390121	.	A	G	3	2	5	0	0	5	0	0
23	4392598	.	T	G	1	2	3	0	0	3	0	0
23	4553255	.	T	C	3	3	6	0	0	6	0	0
23	4554745	.	A	G	2	0	2	0	2	4	0	0
23	4554764	.	C	T	2	2	4	0	1	5	0	0
23	4557069	.	C	G	2	2	4	0	1	5	0	0
23	5010722	.	C	T	3	3	6	0	0	6	0	0
23	5583185	.	A	G	1	0	1	0	2	3	0	0
23	5585483	.	T	C	3	3	6	0	0	6	0	0
23	5585528	.	G	T	1	2	3	0	0	3	0	0
23	5756600	.	G	A	3	3	6	0	1	7	0	0
23	5756781	.	G	T	6	2	8	0	2	10	0	0
23	5756847	.	C	T	4	2	6	0	0	6	0	0
23	5757010	.	G	A	7	3	10	0	1	11	0	0
23	5757047	.	A	T	4	4	8	0	0	8	0	0
23	5757193	.	G	T	2	3	5	0	3	8	0	0
23	5757202	.	C	T	0	4	4	0	4	8	0	0
23	5759102	.	C	T	0	4	4	0	1	5	0	0
23	6011958	.	A	G	1	2	3	0	0	3	0	0
23	6027578	.	C	T	1	2	3	0	0	3	0	0
23	6421776	.	T	C	13	4	17	0	0	17	0	0
23	6421954	.	G	A	4	3	7	0	0	7	0	0
23	6432235	.	T	C	5	3	8	0	0	8	0	0
23	6707102	.	C	T	1	5	6	0	0	6	0	0
23	6783757	.	A	C	2	1	3	0	16	19	0	0
23	6951037	.	T	G	1	3	4	1	0	5	0	0
23	6951157	.	C	T	3	11	14	0	3	17	0	0
23	6955860	.	G	A	7	4	11	0	0	11	0	0
23	7003744	.	C	T	8	9	17	0	3	21	1	0
23	7007480	.	C	T	7	9	16	0	1	17	0	0
23	7027534	.	C	T	0	5	5	0	17	22	0	0
23	7029600	.	G	A	8	7	15	0	1	16	0	0
23	7029741	.	G	A	9	4	13	0	0	13	0	0
23	7029777	.	A	T	4	8	12	0	0	12	0	0
23	7029916	.	A	T	5	2	7	0	1	8	0	0
23	7029964	.	A	C	4	0	4	0	4	8	0	0
23	7032435	.	C	A	9	5	14	0	0	14	0	0
23	7040708	.	T	A	5	5	10	0	0	10	0	0
23	7067257	.	T	C	3	3	6	0	0	6	0	0
23	7172051	.	T	C	1	2	3	0	1	4	0	0
23	7567446	.	C	T	4	3	7	0	0	7	0	0
23	7578710	.	T	C	8	13	21	0	4	25	0	0
23	7708839	.	G	A	2	4	6	0	0	6	0	0
23	7708882	.	T	A	2	4	6	0	0	6	0	0
23	7708929	.	T	C	2	4	6	0	0	6	0	0
23	7709095	.	A	C	1	2	3	0	0	3	0	0
23	7714912	.	G	T	0	2	2	0	2	4	0	0
23	7715651	.	C	T	1	3	4	0	0	4	0	0
23	7715747	.	A	G	3	2	5	0	0	5	0	0
23	7715801	.	G	A	0	3	3	0	2	5	0	0
23	7715909	.	T	C	1	2	3	0	0	3	0	0
23	7715945	.	G	C	1	2	3	0	0	3	0	0
23	7716281	.	T	C	5	2	7	0	1	8	0	0
23	7718380	.	G	A	7	4	11	0	0	11	0	0
23	7718972	.	G	A	0	5	5	0	3	8	0	0
23	7721342	.	A	G	2	3	5	0	0	5	0	0
23	7732578	.	T	C	4	4	8	0	0	8	0	0
23	7732760	.	C	G	5	3	8	0	0	8	0	0
23	7732820	.	G	A	2	2	4	0	0	4	0	0
23	7733088	.	C	G	4	5	9	0	0	9	0	0
23	7733603	.	T	C	1	6	7	0	0	7	0	0
23	7733614	.	G	T	2	6	8	0	0	8	0	0
23	7733732	.	T	C	4	5	9	0	1	10	0	0
23	7733770	.	T	A	4	6	10	0	0	10	0	0
23	7733826	.	T	A	4	2	6	0	0	6	0	0
23	7733836	.	T	C	2	1	3	0	3	6	0	0
23	7734213	.	A	T	2	3	5	0	0	5	0	0
23	7734321	.	C	T	1	3	4	0	2	6	0	0
23	7735423	.	G	A	5	3	8	0	1	9	0	0
23	7735497	.	T	C	6	8	14	0	0	14	0	0
23	7735649	.	C	T	8	6	14	0	0	14	0	0
23	7735809	.	A	T	6	3	9	0	0	9	0	0
23	7736024	.	A	G	1	4	5	0	0	5	0	0
23	7736089	.	T	G	3	0	3	0	6	9	0	0
23	7743670	.	T	C	2	4	6	0	0	6	0	0
23	7743691	.	T	C	3	5	8	0	0	8	0	0
23	7746797	.	T	G	2	2	4	0	0	4	0	0
23	7755189	.	T	G	1	3	4	0	0	4	0	0
23	7762045	.	A	G	6	5	11	0	0	11	0	0
23	7765955	.	G	A	7	7	14	0	1	15	0	0
23	7765961	.	C	T	7	7	14	0	0	14	0	0
23	7768416	.	T	C	6	0	6	0	8	14	0	0
23	7778670	.	G	A	6	5	11	0	3	14	0	0
23	7778715	.	A	G	5	7	12	0	2	14	0	0
23	7789930	.	C	T	2	5	7	0	4	11	0	0
23	8285094	.	G	T	9	4	13	0	1	14	0	0
23	8285236	.	G	T	12	18	30	0	1	31	0	0
23	8285297	.	C	T	0	26	26	0	11	38	1	0
23	8285365	.	G	A	4	22	26	0	2	28	0	0
23	8285468	.	T	C	7	3	10	1	1	12	0	0
23	8285585	.	A	T	12	13	25	0	3	28	0	0
23	8285640	.	C	T	9	11	20	0	0	20	0	0
23	8286192	.	T	C	5	0	5	0	8	13	0	0
23	8286237	.	G	A	4	12	16	0	1	17	0	0
23	8286342	.	C	T	0	6	6	0	5	11	0	0
23	8286384	.	G	T	4	2	6	0	0	6	0	0
23	8372159	.	T	C	2	0	2	0	3	5	0	0
23	8373535	.	T	G	1	5	6	0	0	6	0	0
23	8373641	.	A	G	4	2	6	0	1	7	0	0
23	8719074	.	T	C	12	6	18	0	1	19	0	0
23	8719491	.	G	C	0	3	3	0	4	7	0	0
23	8721202	.	G	A	12	4	16	1	2	19	0	0
23	8724467	.	G	A	18	14	32	0	1	33	0	0
23	8993280	.	G	A	1	4	5	0	1	6	0	0
23	9013597	.	T	C	7	4	11	0	0	11	0	0
23	9013843	.	G	A	7	9	16	0	1	17	0	0
23	9013876	.	T	A	8	11	19	0	0	19	0	0
23	9014122	.	G	A	0	10	10	0	9	19	0	0
23	9014259	.	G	A	14	11	25	0	2	27	0	0
23	9067121	.	G	A	0	3	3	0	2	5	0	0
23	9069900	.	A	G	5	5	10	0	0	10	0	0
23	9081490	.	T	G	3	3	6	0	2	8	0	0
23	9081625	.	T	C	2	2	4	0	0	4	0	0
23	9272674	.	C	T	5	2	7	0	0	7	0	0
23	9272984	.	T	C	6	2	8	0	0	8	0	0
23	9287619	.	G	A	4	5	9	0	0	9	0	0
23	9287629	.	C	A	2	6	8	0	2	11	1	0
23	9287666	.	C	T	2	6	8	0	1	9	0	0
23	9287689	.	T	C	4	8	12	0	1	13	0	0
23	9288047	.	T	A	11	4	15	0	1	16	0	0
23	9288200	.	G	T	8	6	14	0	2	16	0	0
23	9288294	.	T	C	4	2	6	0	0	6	0	0
23	9288395	.	C	A	2	2	4	0	0	4	0	0
23	9288408	.	C	T	2	2	4	0	0	4	0	0
23	9400848	.	G	C	5	9	14	0	0	14	0	0
23	9400902	.	G	A	3	6	9	0	1	10	0	0
23	9401006	.	A	T	1	2	3	0	1	4	0	0
23	9401107	.	C	T	2	5	7	0	0	7	0	0
23	9401210	.	T	C	3	0	3	0	3	6	0	0
23	9401344	.	G	A	2	3	5	0	0	5	0	0
23	9401439	.	T	C	4	4	8	0	0	8	0	0
23	9401954	.	G	A	3	2	5	0	0	5	0	0
23	9403223	.	G	A	1	2	3	0	0	3	0	0
23	9413159	.	G	A	1	3	4	0	0	4	0	0
23	9413456	.	C	T	4	2	6	0	0	6	0	0
23	9794733	.	T	C	8	4	12	3	2	17	0	0
23	9794959	.	T	A	14	18	32	0	2	34	0	0
23	9795057	.	A	G	18	25	43	0	1	44	0	0
23	9795097	.	C	T	1	23	24	0	16	40	0	0
23	9795663	.	A	C	20	12	32	1	1	34	0	0
23	9795908	.	C	T	12	15	27	0	2	29	0	0
23	9800761	.	T	G	13	14	27	0	2	29	0	0
23	9800872	.	T	C	12	8	20	0	1	21	0	0
23	9800993	.	G	T	12	8	20	0	0	20	0	0
23	9809863	.	A	G	15	14	29	0	1	30	0	0
23	9809977	.	C	T	1	8	9	0	11	20	0	0
23	9810491	.	C	G	21	26	47	2	2	51	0	0
23	9818153	.	C	T	12	5	17	0	2	19	0	0
23	9837018	.	G	A	1	4	5	0	0	5	0	0
23	9840151	.	A	G	2	6	8	0	0	8	0	0
23	9840154	.	A	C	2	6	8	0	0	8	0	0
23	9842935	.	G	A	3	5	8	0	0	8	0	0
23	9842980	.	C	T	2	3	5	0	0	5	0	0
23	9938315	.	A	C	1	0	1	0	3	4	0	0
23	9938349	.	T	C	1	4	5	0	1	6	0	0
23	9938714	.	G	T	3	7	10	0	0	10	0	0
23	9938765	.	A	G	5	9	14	0	1	15	0	0
23	9938812	.	A	T	9	9	18	0	1	19	0	0
23	9938824	.	T	C	10	0	10	0	10	20	0	0
23	9938869	.	C	T	5	11	16	0	0	16	0	0
23	9938905	.	T	C	5	1	6	0	8	14	0	0
23	9939602	.	T	C	8	7	15	0	0	15	0	0
23	9939817	.	A	G	9	6	15	1	0	16	0	0
23	9950087	.	A	C	2	3	5	0	1	6	0	0
23	9952460	.	C	T	1	5	6	0	0	6	0	0
23	9959766	.	A	G	1	3	4	0	0	4	0	0
23	9959772	.	G	A	0	3	3	0	0	3	0	0
23	9965037	.	A	G	1	1	2	0	1	3	0	0
23	9973621	.	G	A	2	2	4	0	0	4	0	0
23	10174773	.	G	A	5	2	7	0	0	7	0	0
23	10174904	.	C	T	2	2	4	0	0	4	0	0
23	10250357	.	G	A	22	12	34	0	3	37	0	0
23	10251750	.	T	C	13	9	22	0	0	22	0	0
23	10252499	.	A	G	9	5	14	0	0	14	0	0
23	10252526	.	G	A	7	4	11	0	1	12	0	0
23	10252625	.	T	A	5	8	13	0	0	13	0	0
23	10254018	.	A	G	10	5	15	0	0	15	0	0
23	10254075	.	G	A	8	11	19	0	0	19	0	0
23	10254081	.	A	G	6	12	18	0	0	18	0	0
23	10348049	.	T	C	1	2	3	0	0	3	0	0
23	10348052	.	C	T	1	2	3	0	0	3	0	0
23	10350591	.	G	A	2	4	6	0	0	6	0	0
23	10405707	.	A	G	9	0	9	0	5	14	0	0
23	10405742	.	G	C	4	8	12	0	5	17	0	0
23	10411562	.	A	C	6	7	13	0	0	13	0	0
23	10419933	.	A	C	8	5	13	0	0	13	0	0
23	10421216	.	A	C	7	16	23	0	0	23	0	0
23	10423909	.	C	G	18	5	23	0	0	24	1	0
23	10426291	.	C	T	12	7	19	0	1	20	0	0
23	10448936	.	C	T	9	8	17	0	0	17	0	0
23	10449063	.	T	C	10	11	21	0	2	23	0	0
23	10449136	.	A	G	14	0	14	0	9	23	0	0
23	10449185	.	C	T	14	7	21	0	0	21	0	0
23	10638101	.	T	G	5	2	7	0	0	7	0	0
23	10638386	.	A	G	3	3	6	0	0	6	0	0
23	10639121	.	G	A	7	4	11	0	0	11	0	0
23	10650348	.	G	A	2	2	4	0	0	4	0	0
23	10696523	.	A	G	2	2	4	0	0	4	0	0
23	10725272	.	A	T	4	3	7	0	0	7	0	0
23	10725320	.	T	C	7	7	14	0	0	14	0	0
23	10725334	.	T	C	5	9	14	0	1	15	0	0
23	10725638	.	A	T	6	6	12	0	0	12	0	0
23	10725919	.	C	A	12	11	23	0	0	23	0	0
23	10727563	.	G	A	7	6	13	0	1	14	0	0
23	10727614	.	C	T	9	4	13	0	0	13	0	0
23	10727644	.	C	T	2	8	10	0	0	10	0	0
23	10762922	.	G	A	7	9	16	0	0	17	1	0
23	10762972	.	T	A	10	3	13	0	2	15	0	0
23	10763070	.	G	A	10	3	13	0	3	16	0	0
23	10771991	.	C	A	1	8	9	0	7	16	0	0
23	10817179	.	G	A	6	8	14	0	0	14	0	0
23	10826427	.	C	T	9	5	14	0	2	16	0	0
23	10826718	.	C	A	13	6	19	0	0	19	0	0
23	10826754	.	C	T	6	10	16	0	0	16	0	0
23	10826917	.	C	T	4	2	6	0	0	6	0	0
23	11848645	.	C	T	3	2	5	0	0	5	0	0
23	11851545	.	T	C	5	3	8	0	0	8	0	0
23	11851603	.	C	T	3	3	6	0	0	6	0	0
23	11855160	.	A	G	5	4	9	0	0	9	0	0
23	11855169	.	G	A	6	3	9	0	0	9	0	0
23	11859294	.	C	T	5	3	8	0	1	9	0	0
23	11865055	.	T	A	14	8	22	0	1	23	0	0
23	11865934	.	C	T	17	14	31	0	0	31	0	0
23	11866086	.	G	A	14	21	35	0	2	37	0	0
23	11866183	.	G	A	20	14	34	0	0	35	1	0
23	11866259	.	T	C	22	21	43	0	3	46	0	0
23	11870203	.	A	T	13	16	29	0	1	30	0	0
23	11870893	.	G	A	15	25	40	0	0	40	0	0
23	12150623	.	T	C	2	3	5	0	1	6	0	0
23	12155166	.	G	A	1	3	4	0	0	4	0	0
23	12155298	.	G	A	4	4	8	0	3	11	0	0
23	12155319	.	G	A	4	5	9	0	0	9	0	0
23	12155364	.	A	G	6	3	9	0	1	10	0	0
23	12155391	.	G	A	4	5	9	0	0	9	0	0
23	12158643	.	A	G	2	2	4	0	0	4	0	0
23	12161399	.	T	C	1	2	3	0	1	4	0	0
23	12161794	.	T	C	1	4	5	0	0	5	0	0
23	12162034	.	G	A	4	2	6	0	0	6	0	0
23	12162073	.	T	G	4	0	4	0	3	7	0	0
23	12162099	.	G	C	4	2	6	0	0	6	0	0
23	12162163	.	C	T	5	4	9	0	1	10	0	0
23	12162386	.	A	C	3	7	10	0	1	11	0	0
23	12232873	.	G	A	4	5	9	1	2	12	0	0
23	12233117	.	G	A	12	15	27	0	1	28	0	0
23	12233121	.	C	T	0	13	13	0	15	28	0	0
23	12245729	.	A	C	2	2	4	0	0	4	0	0
23	12259026	.	C	T	1	18	19	0	12	31	0	0
23	12345695	.	G	A	9	6	15	0	0	15	0	0
23	12486063	.	T	C	2	2	4	0	1	5	0	0
23	12546823	.	C	T	1	2	3	0	0	3	0	0
23	13313801	.	G	A	1	2	3	0	0	3	0	0
23	13332325	.	A	C	2	2	4	0	0	4	0	0
23	13567194	.	C	T	1	2	3	0	0	3	0	0
23	13598094	.	C	T	3	4	7	0	0	7	0	0
23	13598632	.	T	C	6	9	15	0	1	16	0	0
23	13598679	.	C	T	3	10	13	0	0	13	0	0
23	13599008	.	G	A	4	3	7	0	0	7	0	0
23	13722416	.	C	A	2	2	4	0	1	5	0	0
23	13806408	.	C	T	10	6	16	0	2	18	0	0
23	13833376	.	T	A	15	18	33	0	3	36	0	0
23	13835932	.	C	A	5	11	16	0	1	17	0	0
23	13840297	.	G	A	3	5	8	0	0	8	0	0
23	13840362	.	C	T	1	7	8	0	7	15	0	0
23	13845114	.	A	C	7	8	15	0	0	15	0	0
23	13845131	.	G	A	9	8	17	0	0	17	0	0
23	13845149	.	T	G	11	11	22	0	0	22	0	0
23	13845201	.	A	G	4	12	16	0	1	17	0	0
23	13845247	.	G	T	5	5	10	0	0	10	0	0
23	13845258	.	A	T	5	5	10	0	0	10	0	0
23	13845389	.	C	A	3	3	6	0	0	6	0	0
23	13845411	.	G	T	5	4	9	0	0	9	0	0
23	13845447	.	T	C	10	8	18	0	1	19	0	0
23	13845901	.	G	T	8	5	13	0	0	13	0	0
23	13846482	.	G	T	5	3	8	0	0	8	0	0
23	13846627	.	G	T	3	6	9	0	0	9	0	0
23	13846664	.	T	C	5	4	9	0	0	9	0	0
23	13847142	.	G	A	3	6	9	1	0	10	0	0
23	13847220	.	T	C	5	4	9	0	0	9	0	0
23	13848537	.	G	A	4	8	12	0	0	12	0	0
23	13941275	.	C	T	7	8	15	0	1	16	0	0
23	13946174	.	C	T	2	7	9	0	9	18	0	0
23	13948993	.	G	A	6	3	9	0	0	9	0	0
23	13949110	.	C	T	1	6	7	0	6	13	0	0
23	14056306	.	C	T	0	2	2	0	1	3	0	0
23	14056679	.	G	A	2	2	4	0	0	4	0	0
23	14193676	.	A	G	13	8	21	0	2	23	0	0
23	14193777	.	C	T	10	10	20	0	3	23	0	0
23	14193923	.	A	C	7	11	18	0	2	20	0	0
23	14193940	.	C	T	9	14	23	0	2	25	0	0
23	14194035	.	C	G	10	13	23	0	2	25	0	0
23	14194058	.	G	A	15	14	29	1	1	31	0	0
23	14198137	.	G	A	22	8	30	0	0	30	0	0
23	14201512	.	T	C	11	5	16	0	0	16	0	0
23	14201521	.	T	C	11	4	15	0	0	15	0	0
23	14203829	.	T	G	4	6	10	0	1	11	0	0
23	14208718	.	A	G	6	6	12	0	0	12	0	0
23	14208817	.	A	T	11	10	21	0	2	23	0	0
23	14209024	.	T	G	8	12	20	0	0	20	0	0
23	14211707	.	C	T	11	9	20	0	0	20	0	0
23	14217799	.	G	A	1	2	3	0	0	3	0	0
23	14784150	.	G	A	2	3	5	0	0	5	0	0
23	14784192	.	C	T	1	3	4	0	0	4	0	0
23	14784198	.	T	A	0	2	2	0	0	2	0	0
23	14786429	.	A	T	5	6	11	0	2	13	0	0
23	14787318	.	T	A	6	5	11	0	0	11	0	0
23	14787426	.	G	A	1	2	3	0	0	3	0	0
23	14788082	.	A	G	4	0	4	0	5	9	0	0
23	14790611	.	C	T	3	4	7	0	0	7	0	0
23	14803409	.	C	T	4	4	8	0	0	8	0	0
23	14808490	.	G	A	7	8	15	0	0	15	0	0
23	14808537	.	G	T	5	3	8	0	0	8	0	0
23	14808545	.	A	G	3	4	7	0	0	7	0	0
23	14809613	.	C	A	5	5	10	0	0	10	0	0
23	14819874	.	G	A	3	4	7	0	0	7	0	0
23	14832677	.	G	A	28	16	44	0	1	45	0	0
23	14832774	.	G	A	34	15	49	0	2	51	0	0
23	14832835	.	C	T	31	28	59	0	5	64	0	0
23	14832866	.	C	T	31	29	60	0	5	65	0	0
23	14832926	.	A	T	35	18	53	0	3	56	0	0
23	14833032	.	C	T	35	29	64	0	1	65	0	0
23	14833142	.	A	T	30	22	52	0	3	55	0	0
23	14833143	.	A	T	30	21	51	0	4	55	0	0
23	14833189	.	A	C	25	17	42	0	5	47	0	0
23	14833552	.	T	C	25	30	55	0	2	57	0	0
23	14833581	.	T	C	18	2	20	0	34	54	0	0
23	14833664	.	G	A	30	20	50	0	3	54	1	0
23	14833765	.	G	A	29	32	61	1	2	64	0	0
23	14851621	.	A	G	27	15	42	0	1	43	0	0
23	14853221	.	G	A	21	16	37	0	0	37	0	0
23	14853342	.	G	A	21	19	40	0	3	43	0	0
23	14853411	.	C	T	28	10	38	0	3	41	0	0
23	14853414	.	C	T	5	12	17	0	24	41	0	0
23	14853833	.	C	T	23	15	38	0	2	40	0	0
23	14861941	.	T	C	14	11	25	0	3	28	0	0
23	14993089	.	G	A	18	12	30	0	0	30	0	0
23	14993140	.	T	C	11	2	13	0	13	26	0	0
23	14993200	.	A	T	14	18	32	0	1	33	0	0
23	14993393	.	C	A	11	10	21	0	0	21	0	0
23	14993936	.	A	T	7	7	14	0	0	14	0	0
23	14999053	.	C	T	20	12	32	0	0	32	0	0
23	14999095	.	C	T	3	10	13	0	18	31	0	0
23	15006653	.	C	T	0	9	9	0	6	15	0	0
23	15021985	.	A	T	6	4	10	0	0	10	0	0
23	15036698	.	G	A	6	3	9	0	0	9	0	0
23	15047745	.	C	T	0	4	4	0	1	5	0	0
23	15048070	.	A	G	2	2	4	0	0	4	0	0
23	15204222	.	C	T	1	16	17	0	28	45	0	0
23	15204321	.	T	A	26	11	37	0	2	39	0	0
23	15204324	.	T	A	24	12	36	0	1	37	0	0
23	15204417	.	A	G	19	19	38	0	1	39	0	0
23	15204936	.	G	T	15	7	22	0	3	25	0	0
23	15205428	.	A	T	16	23	39	0	4	43	0	0
23	15205487	.	C	G	25	12	37	0	4	41	0	0
23	15205994	.	G	A	31	21	52	0	1	53	0	0
23	15206057	.	A	G	25	22	47	0	2	49	0	0
23	15206061	.	G	C	26	20	46	0	2	48	0	0
23	15211253	.	G	C	11	18	29	0	4	33	0	0
23	15216314	.	G	A	10	13	23	0	0	23	0	0
23	15216644	.	T	C	11	0	11	0	8	19	0	0
23	15216664	.	G	T	10	9	19	0	2	21	0	0
23	15222572	.	G	A	11	10	21	0	2	23	0	0
23	15232380	.	T	G	3	3	6	0	1	7	0	0
23	15259821	.	G	A	4	4	8	0	1	9	0	0
23	15270775	.	G	A	2	7	9	0	0	9	0	0
23	15284590	.	C	T	6	2	8	0	1	9	0	0
23	16640925	.	A	G	2	5	7	0	1	8	0	0
23	16641127	.	A	G	3	2	5	0	1	6	0	0
23	16648950	.	T	A	19	17	36	0	1	37	0	0
23	16649008	.	T	C	21	8	29	0	0	29	0	0
23	16649012	.	C	T	15	9	24	0	1	25	0	0
23	16649054	.	C	T	20	9	29	1	5	35	0	0
23	16649330	.	T	G	1	1	2	0	2	4	0	0
23	16649331	.	T	G	3	2	5	0	0	5	0	0
23	16649599	.	G	T	17	17	34	0	6	40	0	0
23	16649855	.	T	C	19	1	20	4	24	48	0	0
23	16650074	.	G	A	22	27	49	0	3	52	0	0
23	16654424	.	A	G	18	15	33	0	2	35	0	0
23	16688448	.	G	A	14	10	24	0	1	25	0	0
23	16688565	.	A	G	25	11	36	0	0	37	1	0
23	16748903	.	A	T	4	2	6	0	0	6	0	0
23	16748915	.	T	A	5	2	7	0	0	7	0	0
23	16753735	.	T	C	5	4	9	0	2	11	0	0
23	16757528	.	G	T	7	4	11	0	1	12	0	0
23	16757633	.	G	A	0	2	2	0	1	3	0	0
23	16810343	.	A	G	1	4	5	0	1	6	0	0
23	16821752	.	T	G	3	4	7	0	0	7	0	0
23	16822464	.	G	A	2	6	8	0	5	13	0	0
23	16822469	.	T	C	6	6	12	0	0	12	0	0
23	16831386	.	G	A	6	2	8	0	0	8	0	0
23	16831755	.	A	G	3	4	7	1	1	9	0	0
23	16831822	.	G	A	1	2	3	0	5	8	0	0
23	16833875	.	C	A	2	4	6	0	0	6	0	0
23	16834080	.	G	A	3	5	8	0	0	8	0	0
23	16849183	.	A	G	2	2	4	0	0	4	0	0
23	16849341	.	C	T	2	4	6	0	0	6	0	0
23	16883535	.	C	T	2	5	7	0	0	7	0	0
23	16883822	.	G	T	4	5	9	0	0	9	0	0
23	16883836	.	C	A	6	2	8	0	0	8	0	0
23	16883860	.	C	T	4	2	6	0	1	7	0	0
23	16961404	.	G	A	1	2	3	0	0	3	0	0
23	16961626	.	T	C	1	2	3	0	0	3	0	0
23	16964089	.	C	A	1	5	6	0	4	10	0	0
23	16964113	.	C	A	3	3	6	0	0	6	0	0
23	17105324	.	C	T	6	3	9	0	0	9	0	0
23	17113831	.	G	A	1	3	4	0	4	8	0	0
23	17113842	.	A	G	2	3	5	0	0	5	0	0
23	17340346	.	G	A	0	2	2	0	2	4	0	0
23	17354693	.	G	T	4	3	7	0	0	7	0	0
23	17354718	.	A	T	5	6	11	0	0	11	0	0
23	17354853	.	G	A	5	3	8	0	1	9	0	0
23	17354868	.	C	A	2	4	6	0	0	6	0	0
23	17355063	.	C	T	4	8	12	0	0	12	0	0
23	17355109	.	C	T	5	7	12	0	0	12	0	0
23	17355174	.	C	T	7	4	11	0	0	11	0	0
23	17355498	.	G	T	1	2	3	0	1	4	0	0
23	17362473	.	G	A	4	2	6	0	1	7	0	0
23	17370877	.	C	A	3	4	7	0	0	7	0	0
23	17384981	.	A	G	4	4	8	0	0	8	0	0
23	17428153	.	C	T	46	40	86	0	6	92	0	0
23	17429632	.	C	T	6	28	34	0	37	71	0	0
23	17431644	.	A	T	23	26	49	0	0	49	0	0
23	17431707	.	T	A	26	11	37	0	2	39	0	0
23	17431734	.	C	T	21	12	33	0	0	33	0	0
23	17432036	.	T	C	19	14	33	0	3	36	0	0
23	17432133	.	A	C	17	9	26	0	1	27	0	0
23	17432169	.	T	A	9	14	23	0	2	25	0	0
23	17432412	.	T	C	21	9	30	0	1	31	0	0
23	17447240	.	A	G	7	4	11	0	0	11	0	0
23	17450623	.	T	G	11	5	16	0	2	18	0	0
23	17450650	.	G	T	6	12	18	0	1	19	0	0
23	17450661	.	A	T	10	7	17	0	1	18	0	0
23	17450779	.	A	T	1	4	5	0	1	6	0	0
23	17473187	.	C	T	13	17	30	0	0	30	0	0
23	17473309	.	G	A	13	14	27	0	1	28	0	0
23	17473365	.	T	C	12	14	26	0	5	31	0	0
23	17473398	.	G	T	11	13	24	0	1	25	0	0
23	17473611	.	C	G	9	18	27	0	1	28	0	0
23	17473649	.	T	A	12	6	18	0	0	18	0	0
23	17473795	.	A	C	25	26	51	0	2	53	0	0
23	17473857	.	A	G	27	23	50	0	0	50	0	0
23	17473981	.	G	A	18	9	27	0	2	29	0	0
23	17474167	.	G	A	6	4	10	0	0	10	0	0
23	17474206	.	A	T	4	7	11	0	0	11	0	0
23	17474532	.	T	C	10	8	18	0	0	18	0	0
23	17474801	.	T	G	17	10	27	0	2	29	0	0
23	17474862	.	C	T	19	9	28	0	5	33	0	0
23	17474928	.	C	G	17	10	27	0	1	28	0	0
23	17475043	.	C	A	13	11	24	0	4	28	0	0
23	17475074	.	A	C	15	8	23	0	2	25	0	0
23	17475094	.	C	A	0	15	15	0	1	16	0	0
23	17475329	.	G	C	10	0	10	0	0	14	4	0
23	17475349	.	A	T	8	7	15	0	0	15	0	0
23	17475378	.	C	A	9	6	15	0	0	15	0	0
23	17475389	.	T	A	7	8	15	0	0	15	0	0
23	17475552	.	G	A	9	6	15	0	1	16	0	0
23	17475553	.	T	C	7	1	8	0	8	16	0	0
23	17475662	.	A	T	6	3	9	0	1	10	0	0
23	17475702	.	C	T	7	5	12	0	4	16	0	0
23	17475808	.	G	T	8	16	24	0	5	29	0	0
23	17475830	.	G	A	15	12	27	0	2	29	0	0
23	17475857	.	A	T	16	12	28	0	2	30	0	0
23	17476145	.	T	A	6	3	9	0	0	9	0	0
23	17476164	.	C	T	5	5	10	0	2	12	0	0
23	17476213	.	C	T	1	10	11	0	10	21	0	0
23	17476453	.	T	C	5	7	12	0	1	13	0	0
23	17476459	.	G	T	4	7	11	0	0	11	0	0
23	17476491	.	A	G	5	4	9	0	0	9	0	0
23	17481905	.	C	T	0	3	3	0	4	7	0	0
23	17484395	.	C	T	3	5	8	0	0	8	0	0
23	17509537	.	A	G	3	7	10	0	0	10	0	0
23	17516889	.	C	T	13	7	20	0	2	22	0	0
23	17516897	.	C	T	15	7	22	0	1	23	0	0
23	17520025	.	C	G	15	16	31	0	2	33	0	0
23	17520245	.	T	C	15	12	27	0	1	28	0	0
23	17520311	.	T	G	13	14	27	0	3	30	0	0
23	17520338	.	G	A	10	15	25	0	4	29	0	0
23	17520632	.	A	T	6	6	12	0	1	13	0	0
23	17520870	.	T	C	2	6	8	0	1	9	0	0
23	17656654	.	G	A	10	9	19	0	2	21	0	0
23	17657265	.	G	C	1	7	8	0	0	8	0	0
23	17782767	.	G	A	1	3	4	0	0	4	0	0
23	17812711	.	C	T	20	19	39	0	5	44	0	0
23	17812720	.	T	A	21	20	41	0	3	44	0	0
23	17812755	.	G	T	17	17	34	0	3	37	0	0
23	17813057	.	G	A	24	11	35	2	1	38	0	0
23	17813161	.	T	A	5	3	8	6	2	16	0	0
23	17813717	.	G	A	25	19	44	0	2	46	0	0
23	17813924	.	A	G	8	4	12	0	1	13	0	0
23	17813952	.	G	T	16	5	21	0	2	23	0	0
23	17814056	.	G	A	29	21	50	0	0	50	0	0
23	17814223	.	C	T	19	23	42	0	9	51	0	0
23	17814281	.	G	T	27	16	43	0	1	44	0	0
23	17814299	.	A	C	22	16	38	0	3	41	0	0
23	17814408	.	A	C	17	12	29	0	1	30	0	0
23	17848981	.	A	G	2	2	4	0	0	4	0	0
23	17849044	.	T	A	4	2	6	0	0	6	0	0
23	17849275	.	T	G	10	14	24	0	2	26	0	0
23	17849296	.	C	G	2	14	16	0	14	30	0	0
23	17849627	.	C	T	8	10	18	0	2	20	0	0
23	17849699	.	C	G	6	11	17	0	0	17	0	0
23	17851768	.	C	T	0	6	6	0	5	11	0	0
23	17853145	.	T	G	3	5	8	0	0	8	0	0
23	17855427	.	C	A	6	3	9	0	0	9	0	0
23	17871935	.	A	G	1	2	3	0	1	4	0	0
23	17872443	.	G	A	2	2	4	0	0	4	0	0
23	17873750	.	C	A	46	24	70	0	5	75	0	0
23	17879066	.	C	A	3	3	6	0	0	7	1	0
23	17879107	.	C	T	4	2	6	0	0	6	0	0
23	17879152	.	A	T	3	3	6	0	2	8	0	0
23	17879153	.	A	C	3	5	8	0	0	8	0	0
23	17880800	.	C	T	4	10	14	0	1	15	0	0
23	17994274	.	C	G	11	3	14	0	0	14	0	0
23	17994354	.	T	C	3	12	15	0	0	15	0	0
23	17994359	.	C	T	12	3	15	0	0	15	0	0
23	17994615	.	T	C	6	3	9	1	1	11	0	0
23	17994897	.	C	T	2	4	6	0	0	6	0	0
23	17995469	.	G	T	7	3	10	0	1	11	0	0
23	17995521	.	C	A	2	5	7	0	0	7	0	0
23	17997033	.	A	G	4	2	6	0	0	6	0	0
23	17997043	.	T	C	3	0	3	0	3	6	0	0
23	18004297	.	A	G	2	2	4	0	0	4	0	0
23	18014942	.	A	G	1	2	3	0	1	4	0	0
23	18032772	.	G	A	5	5	10	0	0	10	0	0
23	18032799	.	A	C	3	4	7	0	0	7	0	0
23	18032912	.	A	C	3	8	11	0	0	11	0	0
23	18032924	.	T	A	9	3	12	0	0	12	0	0
23	18036006	.	C	A	2	2	4	0	1	5	0	0
23	18118653	.	A	T	6	3	9	0	0	9	0	0
23	18118922	.	G	A	23	26	49	0	3	52	0	0
23	18119166	.	C	T	24	16	40	0	1	41	0	0
23	18119192	.	T	C	20	0	20	0	12	32	0	0
23	18119399	.	A	G	13	16	29	0	2	31	0	0
23	18286781	.	G	A	5	6	11	0	0	11	0	0
23	18286782	.	C	T	4	5	9	0	2	11	0	0
23	18375847	.	G	A	7	11	18	0	2	20	0	0
23	18375853	.	T	C	10	0	10	0	10	20	0	0
23	18387709	.	T	A	29	26	55	0	2	57	0	0
23	18388004	.	G	A	19	14	33	0	0	33	0	0
23	18388166	.	T	A	10	17	27	0	0	27	0	0
23	18388476	.	G	A	15	12	27	0	2	29	0	0
23	18388555	.	A	G	14	12	26	0	0	26	0	0
23	18388620	.	A	C	11	11	22	0	0	22	0	0
23	18388685	.	G	A	13	7	20	0	0	20	0	0
23	18388764	.	G	A	9	11	20	0	2	22	0	0
23	18388858	.	T	G	8	6	14	2	0	16	0	0
23	18388954	.	G	A	12	7	19	0	2	21	0	0
23	18389594	.	G	T	15	10	25	0	0	25	0	0
23	18390402	.	G	A	8	5	13	0	0	13	0	0
23	18390635	.	G	A	9	10	19	0	1	20	0	0
23	18390758	.	T	C	8	0	8	0	5	13	0	0
23	18390780	.	C	T	7	6	13	0	0	13	0	0
23	18391490	.	G	A	7	4	11	0	0	11	0	0
23	18394401	.	T	G	10	5	15	0	1	16	0	0
23	18405812	.	C	T	2	2	4	0	0	4	0	0
23	18406573	.	C	A	2	3	5	0	0	5	0	0
23	18409242	.	C	T	1	4	5	0	0	5	0	0
23	18561289	.	T	A	23	14	37	0	1	38	0	0
23	18561434	.	C	T	0	17	17	0	14	31	0	0
23	18562299	.	A	T	1	2	3	0	1	4	0	0
23	18562358	.	T	G	7	4	11	0	0	11	0	0
23	18562427	.	C	T	7	8	15	0	0	15	0	0
23	18562484	.	G	A	8	4	12	0	0	12	0	0
23	18562522	.	A	C	9	7	16	1	0	17	0	0
23	18562623	.	C	T	11	9	20	0	1	21	0	0
23	18562911	.	C	A	1	12	13	0	11	24	0	0
23	18563951	.	G	T	6	9	15	0	0	15	0	0
23	18563952	.	T	C	5	0	5	0	9	14	0	0
23	18568144	.	G	A	2	5	7	0	1	8	0	0
23	18568206	.	G	A	7	7	14	0	0	14	0	0
23	18568468	.	G	A	5	5	10	0	0	10	0	0
23	18569380	.	T	A	11	10	21	0	0	21	0	0
23	18569399	.	C	A	2	11	13	0	9	22	0	0
23	18569543	.	T	C	10	19	29	0	1	30	0	0
23	18569625	.	A	G	23	16	39	0	2	41	0	0
23	18570887	.	C	T	15	12	27	0	1	28	0	0
23	18570941	.	A	T	14	16	30	0	1	31	0	0
23	18572547	.	T	A	11	10	21	0	1	22	0	0
23	18572605	.	T	A	8	9	17	0	0	17	0	0
23	18572618	.	G	A	7	6	13	0	1	14	0	0
23	18574353	.	G	A	12	11	23	0	1	24	0	0
23	18574720	.	T	C	16	19	35	0	2	37	0	0
23	18574800	.	C	T	3	17	20	0	13	33	0	0
23	18580933	.	C	A	20	7	27	0	0	27	0	0
23	18580939	.	C	A	1	19	20	0	7	27	0	0
23	18581065	.	A	G	23	12	35	0	3	38	0	0
23	18581835	.	G	A	14	15	29	0	2	31	0	0
23	18581933	.	T	G	20	12	32	0	1	33	0	0
23	18584225	.	G	A	13	14	27	0	1	28	0	0
23	18586793	.	C	T	2	6	8	1	11	20	0	0
23	18588969	.	C	T	9	5	14	0	2	16	0	0
23	18597667	.	G	A	4	9	13	0	1	14	0	0
23	18616517	.	A	T	9	5	14	0	2	16	0	0
23	18616880	.	T	A	15	9	24	0	2	26	0	0
23	18616980	.	C	G	7	7	14	0	1	15	0	0
23	18617300	.	G	A	12	6	18	0	0	18	0	0
23	18619766	.	C	T	11	8	19	0	1	20	0	0
23	18622541	.	T	G	10	10	20	0	0	20	0	0
23	18628460	.	T	G	10	6	16	0	2	18	0	0
23	18628746	.	C	T	6	10	16	0	1	17	0	0
23	18651918	.	C	A	4	7	11	0	0	11	0	0
23	18652067	.	T	C	4	3	7	0	1	8	0	0
23	18668440	.	T	C	2	2	4	0	0	4	0	0
23	18703204	.	T	A	2	6	8	0	0	8	0	0
23	18759802	.	C	A	12	3	15	0	0	15	0	0
23	18759827	.	T	C	3	9	12	0	1	13	0	0
23	18759973	.	T	G	9	3	12	0	1	13	0	0
23	18760004	.	G	C	9	0	9	0	5	14	0	0
23	18760049	.	T	A	8	6	14	0	0	14	0	0
23	18760223	.	T	A	8	6	14	0	1	15	0	0
23	18760256	.	C	T	6	6	12	0	0	12	0	0
23	18760519	.	T	A	5	10	15	0	0	15	0	0
23	18774122	.	T	C	2	2	4	0	1	5	0	0
23	18777816	.	C	T	2	4	6	0	0	6	0	0
23	18795055	.	T	C	5	5	10	0	1	11	0	0
23	18795620	.	A	G	17	21	38	0	1	39	0	0
23	18795721	.	C	T	21	18	39	0	3	42	0	0
23	18801275	.	G	A	12	24	36	0	1	37	0	0
23	18869550	.	C	A	0	5	5	0	2	7	0	0
23	18870235	.	A	T	3	7	10	0	0	10	0	0
23	18944489	.	A	G	8	3	11	0	1	12	0	0
23	18944543	.	G	A	0	13	13	0	15	28	0	0
23	18947344	.	C	A	15	24	39	0	0	39	0	0
23	18947385	.	G	C	18	18	36	0	1	37	0	0
23	18950968	.	T	C	13	18	31	0	1	32	0	0
23	18950970	.	T	A	11	18	29	0	2	31	0	0
23	18951010	.	G	A	8	11	19	0	2	22	1	0
23	18954023	.	A	G	6	9	15	0	0	15	0	0
23	18954100	.	A	G	6	10	16	0	1	17	0	0
23	18954151	.	G	A	4	4	8	0	0	8	0	0
23	18954542	.	G	C	2	2	4	0	0	4	0	0
23	18954759	.	T	G	9	10	19	0	0	19	0	0
23	18979342	.	C	T	16	8	24	0	2	26	0	0
23	18979561	.	G	A	12	4	16	0	5	21	0	0
23	18979756	.	T	C	6	2	8	0	2	10	0	0
23	18982375	.	G	A	5	7	12	0	0	12	0	0
23	18986338	.	G	A	13	9	22	0	0	22	0	0
23	18986344	.	G	A	9	13	22	0	0	22	0	0
23	18990914	.	C	T	0	12	12	0	5	17	0	0
23	18993525	.	T	C	9	7	16	0	0	16	0	0
23	18993827	.	C	T	0	3	3	0	6	9	0	0
23	18996030	.	C	T	5	5	10	0	2	12	0	0
23	19003263	.	A	G	4	3	7	0	0	7	0	0
23	19005486	.	T	C	6	4	10	0	0	10	0	0
23	19005758	.	C	T	7	2	9	0	0	9	0	0
23	19005761	.	C	G	6	2	8	0	1	9	0	0
23	19007389	.	G	T	4	4	8	0	0	8	0	0
23	19008149	.	C	T	2	3	5	0	0	5	0	0
23	19012845	.	C	G	2	2	4	0	0	4	0	0
23	19017466	.	G	T	1	3	4	0	0	4	0	0
23	19022254	.	A	G	3	4	7	0	0	7	0	0
23	19106781	.	G	A	2	3	5	0	0	5	0	0
23	19118372	.	G	T	3	5	8	0	1	9	0	0
23	19148453	.	A	T	4	3	7	0	0	7	0	0
23	19153221	.	A	T	1	3	4	0	0	4	0	0
23	19198348	.	A	T	5	4	9	0	0	9	0	0
23	19198588	.	A	T	8	8	16	0	0	16	0	0
23	19200168	.	G	A	11	7	18	0	1	19	0	0
23	19201103	.	C	A	12	6	18	0	0	18	0	0
23	19201148	.	G	T	1	5	6	0	1	7	0	0
23	19204232	.	G	A	0	3	3	0	0	3	0	0
23	19221073	.	G	T	6	5	11	0	3	14	0	0
23	19474823	.	G	T	11	12	23	0	2	25	0	0
23	19483260	.	A	G	1	2	3	0	0	3	0	0
23	19575044	.	G	A	0	6	6	0	9	15	0	0
23	19575134	.	C	T	10	9	19	0	1	20	0	0
23	19577464	.	G	A	0	8	8	0	18	26	0	0
23	19582481	.	T	C	15	15	30	0	1	31	0	0
23	19582668	.	T	C	14	15	29	0	1	30	0	0
23	19582678	.	C	T	16	15	31	0	3	34	0	0
23	19583208	.	G	A	1	9	10	0	12	22	0	0
23	19583252	.	C	T	17	14	31	0	1	32	0	0
23	19603630	.	T	C	31	28	59	0	1	60	0	0
23	19603753	.	T	C	24	28	52	0	1	53	0	0
23	19603803	.	T	C	19	23	42	0	2	44	0	0
23	19603880	.	A	T	28	20	48	0	4	52	0	0
23	19603994	.	G	A	23	23	46	0	1	47	0	0
23	19604263	.	A	G	21	1	22	0	16	38	0	0
23	19604351	.	G	T	8	16	24	0	0	24	0	0
23	19670139	.	G	C	4	2	6	0	1	7	0	0
23	19670185	.	A	T	6	9	15	0	2	17	0	0
23	19672720	.	T	C	6	10	16	0	0	16	0	0
23	19673170	.	C	T	13	11	24	0	0	24	0	0
23	19673376	.	C	T	13	6	19	0	0	19	0	0
23	19712898	.	G	A	28	34	62	0	6	68	0	0
23	19713291	.	A	G	35	34	69	0	3	72	0	0
23	19713324	.	A	G	37	26	63	0	10	73	0	0
23	19790712	.	C	T	1	3	4	0	0	4	0	0
23	19798700	.	T	A	2	4	6	0	0	6	0	0
23	19798876	.	C	T	0	2	2	0	1	3	0	0
23	19804543	.	C	A	3	7	10	0	0	10	0	0
23	19804743	.	A	C	2	2	4	0	0	4	0	0
23	19804744	.	T	C	2	2	4	0	0	4	0	0
23	19805577	.	A	T	6	5	11	0	0	11	0	0
23	19808022	.	C	T	11	13	24	1	1	26	0	0
23	19808078	.	T	C	8	11	19	0	3	22	0	0
23	19808691	.	G	A	3	13	16	0	17	33	0	0
23	19815467	.	G	A	6	4	10	0	0	10	0	0
23	19816699	.	A	T	6	5	11	0	0	11	0	0
23	19821136	.	A	G	5	0	5	0	13	18	0	0
23	19821150	.	C	T	6	11	17	0	0	17	0	0
23	19821277	.	A	C	6	9	15	0	1	16	0	0
23	19821408	.	C	T	5	10	15	0	0	15	0	0
23	19821447	.	G	C	4	4	8	0	0	8	0	0
23	19821470	.	G	A	0	2	2	0	5	7	0	0
23	19821549	.	C	A	4	4	8	0	0	8	0	0
23	19827611	.	T	C	3	0	3	0	2	5	0	0
23	19835308	.	T	C	47	15	62	0	0	62	0	0
23	19836260	.	C	T	32	19	51	0	1	52	0	0
23	19837080	.	T	C	25	26	51	0	3	54	0	0
23	19837503	.	G	A	24	16	40	0	1	41	0	0
23	19837939	.	A	G	7	6	13	0	4	17	0	0
23	19837974	.	G	A	8	8	16	0	0	16	0	0
23	19838100	.	C	A	26	15	41	0	2	43	0	0
23	19838295	.	T	G	4	4	8	0	0	8	0	0
23	19838312	.	A	T	3	5	8	0	1	9	0	0
23	19838387	.	A	T	11	4	15	0	2	17	0	0
23	19838388	.	T	A	10	4	14	0	3	17	0	0
23	19838458	.	A	T	11	8	19	0	1	20	0	0
23	19838459	.	A	C	11	9	20	0	0	20	0	0
23	19869132	.	G	A	6	11	17	0	0	17	0	0
23	19871615	.	A	G	16	13	29	0	0	29	0	0
23	19879576	.	C	T	1	6	7	0	15	22	0	0
23	19883318	.	T	C	6	7	13	0	0	13	0	0
23	19893409	.	A	T	10	3	13	0	0	13	0	0
23	19933578	.	G	A	1	5	6	0	0	6	0	0
23	19933850	.	A	G	1	2	3	0	0	3	0	0
23	19933896	.	A	G	2	2	4	0	0	4	0	0
23	19952869	.	T	A	5	2	7	0	0	7	0	0
23	19969109	.	A	T	3	2	5	0	0	5	0	0
23	19969136	.	C	A	2	2	4	0	1	5	0	0
23	19969420	.	A	T	1	5	6	0	0	6	0	0
23	19969552	.	A	T	2	2	4	0	0	4	0	0
23	19969557	.	T	A	2	3	5	0	0	5	0	0
23	19969710	.	G	A	7	5	12	0	0	12	0	0
23	19974092	.	G	A	6	3	9	0	0	9	0	0
23	19981191	.	A	T	2	2	4	0	0	4	0	0
23	19981510	.	G	T	8	9	17	0	1	18	0	0
23	19981554	.	T	C	4	9	13	0	0	13	0	0
23	19981608	.	A	T	7	7	14	0	1	15	0	0
23	19985054	.	A	G	2	4	6	0	0	6	0	0
23	19985201	.	A	G	4	1	5	0	2	7	0	0
23	19985210	.	G	T	4	3	7	0	0	7	0	0
23	19985403	.	T	C	4	8	12	0	1	13	0	0
23	20000716	.	A	G	2	4	6	0	4	10	0	0
23	20002339	.	G	C	1	4	5	0	0	5	0	0
23	20002439	.	G	C	1	0	1	0	4	5	0	0
23	20014285	.	A	T	9	3	12	0	0	12	0	0
23	20014390	.	C	T	0	2	2	0	5	7	0	0
23	20014407	.	A	T	5	2	7	0	1	8	0	0
23	20014528	.	G	A	2	2	4	0	0	4	0	0
23	20113599	.	T	C	20	9	29	0	0	29	0	0
23	20113848	.	G	T	22	18	40	0	1	41	0	0
23	20114327	.	C	A	29	18	47	0	1	48	0	0
23	20117625	.	C	G	0	6	6	0	10	16	0	0
23	20117830	.	A	G	13	16	29	0	1	30	0	0
23	20117938	.	A	C	11	0	11	0	14	25	0	0
23	20118597	.	T	G	11	8	19	0	1	20	0	0
23	20118730	.	T	A	5	5	10	0	2	12	0	0
23	20121265	.	T	A	15	5	20	0	0	20	0	0
23	20121270	.	G	T	15	5	20	0	0	20	0	0
23	20121326	.	G	A	10	7	17	0	1	18	0	0
23	20122190	.	A	G	9	6	15	0	0	15	0	0
23	20123375	.	G	A	3	4	7	0	0	7	0	0
23	20123386	.	G	T	3	3	6	0	0	6	0	0
23	20123575	.	C	A	4	3	7	0	0	7	0	0
23	20123576	.	C	T	4	3	7	0	0	7	0	0
23	20123629	.	A	G	2	11	13	0	1	14	0	0
23	20137931	.	C	T	1	2	3	0	1	4	0	0
23	20139248	.	T	C	3	3	6	0	0	6	0	0
23	20139362	.	T	C	1	4	5	0	1	6	0	0
23	20143177	.	G	A	3	3	6	0	0	6	0	0
23	20145420	.	T	A	17	12	29	0	1	30	0	0
23	20145823	.	T	C	4	6	10	0	1	11	0	0
23	20146080	.	A	G	13	6	19	0	0	19	0	0
23	20152477	.	T	C	8	7	15	0	0	15	0	0
23	20152640	.	G	A	12	11	23	0	0	23	0	0
23	20154486	.	A	G	4	2	6	0	0	6	0	0
23	20157790	.	G	A	4	4	8	0	0	8	0	0
23	20157923	.	G	C	2	1	3	0	5	8	0	0
23	20157930	.	T	C	3	0	3	0	7	10	0	0
23	20162522	.	C	T	0	2	2	0	1	3	0	0
23	20167944	.	T	C	1	3	4	0	0	4	0	0
23	20167966	.	G	A	1	4	5	0	0	5	0	0
23	20168404	.	C	G	2	6	8	0	0	8	0	0
23	20168642	.	G	A	1	5	6	0	0	6	0	0
23	20168739	.	T	C	2	2	4	0	1	5	0	0
23	20169105	.	C	G	0	3	3	0	2	5	0	0
23	20183551	.	A	G	4	2	6	0	1	7	0	0
23	20261773	.	G	A	1	2	3	0	0	3	0	0
23	20262604	.	T	G	1	2	3	0	0	3	0	0
23	20636325	.	A	C	6	4	10	0	11	21	0	0
23	20636328	.	T	A	6	0	6	0	14	21	1	0
23	21111170	.	A	G	4	0	4	0	4	8	0	0
23	21456791	.	T	A	1	4	5	0	0	5	0	0
23	21489572	.	A	G	6	4	10	0	1	11	0	0
23	22060088	.	T	A	2	14	16	0	4	20	0	0
23	22888817	.	G	A	1	6	7	0	0	7	0	0
23	22918609	.	A	T	5	6	11	0	0	11	0	0
23	22919817	.	C	T	5	13	18	0	0	18	0	0
23	22919883	.	T	C	3	6	9	0	4	13	0	0
23	22920221	.	T	A	8	4	12	0	5	17	0	0
23	22920594	.	C	T	11	11	22	0	4	26	0	0
23	22923021	.	A	C	14	12	26	0	2	28	0	0
23	22923057	.	A	G	9	0	9	0	14	23	0	0
23	22923093	.	C	T	16	17	33	0	0	33	0	0
23	22923147	.	C	T	16	9	25	0	0	25	0	0
23	22923198	.	C	T	10	9	19	0	1	20	0	0
23	22923537	.	C	T	13	14	27	0	1	28	0	0
23	23118653	.	A	T	2	5	7	0	0	7	0	0
23	23118815	.	C	T	2	3	5	0	0	5	0	0
23	23122178	.	G	A	0	10	10	1	5	16	0	0
23	23122381	.	C	T	4	10	14	0	1	15	0	0
23	23122412	.	G	A	0	3	3	0	6	9	0	0
23	23122528	.	C	T	5	5	10	0	0	10	0	0
23	23122898	.	A	G	9	8	17	0	0	17	0	0
23	23123146	.	G	T	7	5	12	0	0	12	0	0
23	23123420	.	G	T	6	7	13	0	0	13	0	0
23	23123715	.	C	T	3	3	6	0	0	6	0	0
23	23126447	.	G	A	3	2	5	0	2	7	0	0
23	23126621	.	T	C	5	4	9	0	1	10	0	0
23	23136745	.	G	A	4	4	8	0	0	8	0	0
23	23190151	.	T	A	1	6	7	0	0	7	0	0
23	23205469	.	A	G	2	0	2	0	9	11	0	0
23	23212257	.	C	T	4	17	21	0	0	21	0	0
23	23213068	.	A	C	2	10	12	0	0	12	0	0
23	23213069	.	A	C	2	10	12	0	0	12	0	0
23	23213219	.	T	C	6	16	22	0	1	23	0	0
23	23213582	.	C	A	4	17	21	0	1	22	0	0
23	23213864	.	T	A	2	19	21	0	1	22	0	0
23	23213880	.	G	A	1	15	16	0	3	19	0	0
23	23399987	.	T	C	12	5	17	0	1	18	0	0
23	23400032	.	A	G	13	10	23	0	0	23	0	0
23	23658506	.	T	A	1	2	3	0	0	3	0	0
23	23860113	.	T	A	6	10	16	0	0	16	0	0
23	23860117	.	G	A	6	10	16	0	0	16	0	0
23	23863569	.	G	A	11	8	19	0	0	19	0	0
23	23869182	.	T	C	10	10	20	0	0	20	0	0
23	23877088	.	A	G	13	0	13	0	11	24	0	0
23	23888136	.	G	A	2	6	8	0	13	21	0	0
23	23890928	.	T	C	12	14	26	0	2	28	0	0
23	23891535	.	C	T	16	14	30	0	3	33	0	0
23	23891551	.	G	A	3	15	18	0	18	36	0	0
23	23903278	.	G	A	1	13	14	0	11	25	0	0
23	23903308	.	C	T	13	7	20	0	0	20	0	0
23	23912720	.	G	T	21	12	33	0	1	34	0	0
23	23912723	.	C	A	20	13	33	0	2	35	0	0
23	23912881	.	C	T	22	18	40	0	3	43	0	0
23	23913240	.	G	T	13	22	35	0	3	38	0	0
23	23913417	.	T	C	23	28	51	0	5	56	0	0
23	23913818	.	A	T	22	9	31	0	1	32	0	0
23	23913832	.	G	A	15	19	34	0	3	37	0	0
23	23913858	.	A	C	25	16	41	0	4	45	0	0
23	23914176	.	A	T	22	20	42	0	2	44	0	0
23	23973724	.	T	A	3	2	5	0	0	5	0	0
23	23973781	.	C	A	5	2	7	0	0	7	0	0
23	23994537	.	T	C	5	4	9	0	0	9	0	0
23	23994646	.	C	A	10	2	12	0	1	13	0	0
23	23995278	.	T	A	3	2	5	0	1	6	0	0
23	23995349	.	A	T	7	2	9	0	0	9	0	0
23	23995375	.	C	T	6	4	10	0	0	10	0	0
23	24113193	.	G	A	1	3	4	0	0	4	0	0
23	24176425	.	C	T	2	14	16	0	19	35	0	0
23	24176474	.	A	G	16	17	33	0	1	34	0	0
23	24178789	.	C	T	2	11	13	0	4	17	0	0
23	24183523	.	A	C	10	6	16	0	1	17	0	0
23	24190677	.	C	T	4	6	10	0	0	10	0	0
23	24202583	.	A	T	3	5	8	0	0	8	0	0
23	24202734	.	C	A	1	3	4	0	4	8	0	0
23	24202754	.	A	C	4	0	4	0	4	8	0	0
23	24202833	.	G	A	6	4	10	1	0	11	0	0
23	24202859	.	A	T	6	4	10	1	0	11	0	0
23	24202985	.	T	C	6	4	10	0	1	11	0	0
23	24208208	.	G	C	4	4	8	0	0	8	0	0
23	24227400	.	G	A	10	7	17	0	2	19	0	0
23	24227696	.	C	T	24	9	33	0	2	35	0	0
23	24227702	.	T	A	24	11	35	0	2	37	0	0
23	24229110	.	G	A	7	10	17	0	2	19	0	0
23	24231596	.	T	C	11	6	17	0	1	18	0	0
23	24233831	.	A	G	5	6	11	0	1	12	0	0
23	24234232	.	T	C	4	5	9	0	1	10	0	0
23	24239009	.	C	T	11	6	17	0	3	20	0	0
23	24241090	.	C	G	2	5	7	0	8	15	0	0
23	24243168	.	G	A	4	10	14	0	0	14	0	0
23	24244694	.	C	T	1	6	7	0	5	12	0	0
23	24246864	.	A	G	5	3	8	0	0	8	0	0
23	24249074	.	G	T	6	3	9	0	1	10	0	0
23	24249227	.	C	T	9	4	13	0	0	13	0	0
23	24251531	.	C	A	8	2	10	0	1	11	0	0
23	24253171	.	T	G	1	2	3	0	0	3	0	0
23	24439480	.	G	T	24	10	34	0	4	39	1	0
23	24439580	.	T	C	19	0	19	0	27	46	0	0
23	24439780	.	G	A	13	20	33	0	0	33	0	0
23	24440273	.	G	A	8	4	12	0	1	13	0	0
23	24440414	.	C	A	17	9	26	1	1	28	0	0
23	24443161	.	G	T	9	8	17	0	0	17	0	0
23	24444279	.	C	T	10	14	24	0	1	25	0	0
23	24444803	.	T	G	8	8	16	0	1	17	0	0
23	24444861	.	G	A	11	7	18	0	0	18	0	0
23	24445112	.	G	T	10	7	17	0	2	19	0	0
23	24445584	.	A	G	12	6	18	0	0	18	0	0
23	24445906	.	G	C	8	10	18	0	0	18	0	0
23	24446040	.	T	A	4	5	9	0	0	9	0	0
23	24446411	.	C	T	6	3	9	0	2	11	0	0
23	24447113	.	C	T	4	5	9	0	0	9	0	0
23	24447534	.	C	T	0	2	2	0	2	4	0	0
23	24448621	.	G	C	1	4	5	0	0	5	0	0
23	24448630	.	G	T	1	4	5	0	0	5	0	0
23	24450618	.	G	A	2	2	4	0	0	4	0	0
23	24451283	.	A	G	2	1	3	0	1	4	0	0
23	24485932	.	C	A	2	2	4	0	0	4	0	0
23	24492872	.	G	A	4	2	6	0	0	6	0	0
23	24507550	.	A	G	12	12	24	0	0	24	0	0
23	24507555	.	T	C	12	12	24	0	0	24	0	0
23	24507668	.	A	G	6	0	6	0	7	13	0	0
23	24508422	.	T	G	9	7	16	1	0	17	0	0
23	24508500	.	C	T	10	9	19	0	0	19	0	0
23	24508630	.	T	C	14	12	26	0	3	29	0	0
23	24513096	.	C	T	0	3	3	0	4	7	0	0
23	24581809	.	G	A	5	5	10	0	0	10	0	0
23	24582165	.	G	A	4	2	6	0	1	7	0	0
23	24582185	.	C	T	3	3	6	0	0	6	0	0
23	24590068	.	G	A	0	2	2	0	1	3	0	0
23	24590093	.	A	C	1	3	4	0	0	4	0	0
23	24591799	.	G	A	1	4	5	0	0	5	0	0
23	24591808	.	G	A	1	4	5	0	0	5	0	0
23	24595782	.	T	A	1	2	3	0	0	3	0	0
23	24600513	.	C	T	6	9	15	0	1	16	0	0
23	24600947	.	T	C	8	6	14	0	1	15	0	0
23	24604323	.	C	T	12	8	20	0	0	20	0	0
23	24604461	.	A	G	8	1	9	0	9	18	0	0
23	24605243	.	T	A	8	13	21	0	1	22	0	0
23	24608805	.	G	A	15	11	26	0	2	28	0	0
23	24608847	.	G	A	1	10	11	0	9	20	0	0
23	24654287	.	G	T	3	2	5	0	1	6	0	0
23	24655227	.	T	C	2	4	6	0	0	6	0	0
23	24655478	.	C	T	6	4	10	0	0	10	0	0
23	24655761	.	T	G	1	0	1	0	5	6	0	0
23	24659630	.	A	G	1	0	1	0	6	7	0	0
23	24659777	.	C	T	2	4	6	0	0	6	0	0
23	24661851	.	C	T	7	6	13	0	1	14	0	0
23	24669319	.	A	T	15	14	29	0	1	30	0	0
23	24669381	.	C	T	3	7	10	0	12	22	0	0
23	24669561	.	A	G	15	13	28	0	1	29	0	0
23	24669633	.	T	C	22	1	23	0	15	38	0	0
23	24676192	.	G	C	6	9	15	0	3	18	0	0
23	24694096	.	C	T	15	15	30	0	1	31	0	0
23	24694184	.	G	C	20	10	30	0	1	31	0	0
23	24694242	.	C	A	15	10	25	0	1	26	0	0
23	24694387	.	A	G	24	28	52	0	2	54	0	0
23	24694756	.	C	T	19	18	37	0	1	38	0	0
23	24696943	.	A	G	8	14	22	0	1	23	0	0
23	24697036	.	G	A	12	12	24	0	0	24	0	0
23	24697287	.	A	C	11	8	19	0	1	20	0	0
23	24699281	.	T	A	10	9	19	0	2	21	0	0
23	24749528	.	A	T	0	3	3	0	1	4	0	0
23	24750285	.	T	C	2	2	4	0	0	4	0	0
23	24819831	.	C	G	2	4	6	0	0	6	0	0
23	24819936	.	G	A	6	7	13	0	0	13	0	0
23	24823899	.	T	C	2	2	4	0	0	4	0	0
23	24824048	.	C	T	3	2	5	0	0	5	0	0
23	24824056	.	G	A	3	2	5	0	0	5	0	0
23	24926470	.	G	A	5	2	7	0	1	8	0	0
23	24932979	.	G	A	1	2	3	0	0	3	0	0
23	24933121	.	C	T	3	3	6	0	1	7	0	0
23	24934567	.	T	C	6	7	13	0	0	13	0	0
23	24934597	.	C	G	3	4	7	0	1	8	0	0
23	24934646	.	G	A	7	3	10	0	0	10	0	0
23	24937143	.	T	C	14	13	27	0	3	30	0	0
23	24937357	.	T	C	11	8	19	0	3	22	0	0
23	24937676	.	T	C	7	9	16	0	1	17	0	0
23	24938172	.	A	T	2	11	13	0	0	13	0	0
23	24938173	.	C	T	2	11	13	0	0	13	0	0
23	24938401	.	G	A	17	13	30	0	3	33	0	0
23	24938446	.	T	C	11	8	19	0	1	20	0	0
23	24938559	.	T	C	12	5	17	0	0	17	0	0
23	24938627	.	G	A	5	6	11	0	0	11	0	0
23	24938642	.	C	T	6	6	12	0	0	12	0	0
23	24938791	.	A	G	7	1	8	0	9	17	0	0
23	24938901	.	G	A	5	7	12	0	2	14	0	0
23	24941366	.	T	A	2	2	4	0	0	4	0	0
23	24941449	.	T	C	1	2	3	0	0	3	0	0
23	24941479	.	C	A	1	3	4	0	0	4	0	0
23	24941524	.	T	C	2	5	7	0	1	8	0	0
23	24941714	.	T	C	3	8	11	0	1	12	0	0
23	24944247	.	G	A	2	4	6	0	0	6	0	0
23	24957184	.	A	G	3	0	3	0	2	5	0	0
23	24968676	.	C	A	5	6	11	1	0	12	0	0
23	24969026	.	G	T	7	12	19	0	0	19	0	0
23	24970331	.	A	G	3	1	4	0	2	6	0	0
23	24973857	.	C	T	3	5	8	0	1	9	0	0
23	24973871	.	T	C	3	6	9	0	0	9	0	0
23	24980093	.	A	G	2	0	2	0	3	5	0	0
23	24983469	.	C	G	5	3	8	0	0	8	0	0
23	24983479	.	G	C	4	3	7	0	0	7	0	0
23	24983536	.	A	G	4	0	4	0	4	8	0	0
23	24984588	.	T	A	2	4	6	0	0	6	0	0
23	24984969	.	A	C	6	5	11	0	0	11	0	0
23	25009575	.	T	A	3	3	6	0	0	6	0	0
23	25012510	.	G	T	2	6	8	0	0	8	0	0
23	25012584	.	T	C	4	5	9	0	1	10	0	0
23	25014445	.	G	C	6	5	11	0	0	11	0	0
23	25122283	.	T	A	2	9	11	0	2	13	0	0
23	25132264	.	G	A	6	8	14	0	2	16	0	0
23	25135944	.	T	A	2	5	7	0	1	8	0	0
23	25135945	.	T	A	3	4	7	0	1	8	0	0
23	25149777	.	C	T	18	11	29	0	1	30	0	0
23	25149921	.	A	G	9	9	18	0	1	19	0	0
23	25211392	.	T	G	5	4	9	0	0	9	0	0
23	25211419	.	C	A	4	2	6	0	1	7	0	0
23	25217774	.	C	T	6	5	11	0	0	11	0	0
23	25218647	.	C	G	1	4	5	0	0	5	0	0
23	25218728	.	G	A	4	4	8	0	0	8	0	0
23	25218850	.	A	G	9	3	12	0	0	12	0	0
23	25218854	.	A	G	8	4	12	0	0	12	0	0
23	25220160	.	A	G	8	5	13	0	0	13	0	0
23	25220217	.	T	C	7	5	12	0	0	12	0	0
23	25220226	.	G	T	7	5	12	0	0	12	0	0
23	25221198	.	G	A	7	7	14	0	0	14	0	0
23	25221264	.	G	A	10	7	17	0	1	18	0	0
23	25222196	.	C	T	11	11	22	0	0	22	0	0
23	25222214	.	G	A	0	5	5	0	11	16	0	0
23	25222578	.	G	T	8	6	14	0	1	15	0	0
23	25222585	.	A	T	5	8	13	0	0	13	0	0
23	25280208	.	A	G	1	2	3	0	0	3	0	0
23	25280235	.	G	A	2	2	4	0	0	4	0	0
23	25282883	.	T	A	3	3	6	0	0	6	0	0
23	25287292	.	A	C	1	4	5	0	0	5	0	0
23	25287308	.	G	A	1	5	6	0	3	9	0	0
23	25292000	.	G	A	6	7	13	1	0	14	0	0
23	25293908	.	A	C	6	4	10	0	0	10	0	0
23	25335425	.	C	T	4	2	6	0	0	6	0	0
23	25448554	.	T	C	3	3	6	0	0	6	0	0
23	25448582	.	T	C	1	4	5	0	0	5	0	0
23	25458584	.	G	A	12	14	26	0	1	27	0	0
23	25458615	.	G	A	9	12	21	0	2	23	0	0
23	25464156	.	A	G	14	11	25	0	0	25	0	0
23	25471197	.	G	A	3	3	6	0	0	6	0	0
23	25484859	.	G	A	2	4	6	0	2	8	0	0
23	25484886	.	G	A	6	5	11	0	0	11	0	0
23	25515733	.	G	A	1	2	3	0	0	3	0	0
23	25756641	.	A	G	4	4	8	0	0	8	0	0
23	25768079	.	G	A	0	2	2	0	3	5	0	0
23	25770804	.	T	A	2	3	5	1	1	7	0	0
23	25771107	.	G	A	11	6	17	0	0	17	0	0
23	25772648	.	A	G	8	9	17	0	0	17	0	0
23	25774855	.	A	G	1	4	5	0	2	7	0	0
23	25775017	.	C	T	0	5	5	0	4	9	0	0
23	25776811	.	G	T	6	3	9	0	0	9	0	0
23	25777286	.	A	G	2	2	4	0	1	5	0	0
23	25789308	.	G	C	3	2	5	0	0	5	0	0
23	25789387	.	C	T	3	4	7	0	0	7	0	0
23	25792923	.	A	T	12	8	20	0	0	20	0	0
23	25792952	.	A	T	12	5	17	0	1	18	0	0
23	25796484	.	G	C	2	0	2	0	4	6	0	0
23	25796899	.	G	A	4	5	9	0	2	11	0	0
23	25796975	.	G	A	4	2	6	0	2	8	0	0
23	25869424	.	A	G	4	0	4	0	10	14	0	0
23	25869571	.	G	A	4	2	6	0	0	6	0	0
23	25869658	.	C	T	3	3	6	0	0	6	0	0
23	25869706	.	A	G	3	3	6	0	1	7	0	0
23	25871493	.	A	G	2	5	7	0	0	7	0	0
23	25871764	.	C	A	8	6	14	0	1	15	0	0
23	25873365	.	T	A	2	5	7	0	1	8	0	0
23	25873670	.	A	G	3	2	5	0	1	6	0	0
23	25874089	.	A	C	12	16	28	0	1	29	0	0
23	25874100	.	A	T	11	15	26	0	1	27	0	0
23	25874135	.	G	A	2	14	16	0	10	26	0	0
23	25874154	.	T	G	10	11	21	0	3	24	0	0
23	25874249	.	A	G	10	1	11	0	10	21	0	0
23	25874261	.	T	A	7	13	20	0	0	20	0	0
23	25874334	.	C	G	12	8	20	0	2	22	0	0
23	25874355	.	A	T	11	11	22	0	1	23	0	0
23	25874385	.	T	C	14	9	23	0	1	24	0	0
23	25874452	.	A	T	14	10	24	0	1	25	0	0
23	25874570	.	T	C	10	7	17	0	0	17	0	0
23	25930689	.	C	T	7	20	27	0	3	30	0	0
23	25942399	.	T	G	8	1	9	0	20	29	0	0
23	25942559	.	T	A	4	4	8	0	0	8	0	0
23	25942708	.	G	A	0	8	8	0	4	12	0	0
23	25946732	.	A	G	2	4	6	0	0	6	0	0
23	25946766	.	C	T	2	2	4	0	0	4	0	0
23	25946882	.	T	C	2	0	2	0	2	4	0	0
23	25946981	.	C	T	2	2	4	0	0	4	0	0
23	25946985	.	C	G	1	2	3	0	0	3	0	0
23	25947416	.	T	G	5	3	8	0	0	8	0	0
23	25947599	.	T	C	3	0	3	0	3	6	0	0
23	25956818	.	C	T	2	2	4	0	0	4	0	0
23	26063264	.	T	C	4	9	13	0	0	13	0	0
23	26063560	.	A	T	26	31	57	0	3	60	0	0
23	26063581	.	T	C	30	0	30	0	26	57	1	0
23	26063614	.	A	C	30	29	59	0	3	62	0	0
23	26064050	.	T	A	30	26	56	0	2	58	0	0
23	26064122	.	T	A	17	24	41	1	1	43	0	0
23	26064124	.	T	A	31	11	42	1	2	45	0	0
23	26064186	.	C	G	15	22	37	0	2	39	0	0
23	26064192	.	T	A	11	26	37	0	1	38	0	0
23	26064234	.	G	T	19	25	44	0	2	46	0	0
23	26064266	.	T	A	19	20	39	0	0	39	0	0
23	26074123	.	G	A	12	13	25	0	2	27	0	0
23	26074252	.	T	A	9	6	15	0	1	16	0	0
23	26074288	.	T	C	3	9	12	0	0	12	0	0
23	26074312	.	C	T	7	7	14	0	1	15	0	0
23	26083603	.	A	G	4	2	6	0	0	6	0	0
23	26088857	.	T	C	2	3	5	0	1	6	0	0
23	26094671	.	C	T	10	8	18	0	0	18	0	0
23	26184132	.	T	C	6	6	12	0	1	13	0	0
23	26184225	.	G	A	10	5	15	0	0	15	0	0
23	26187657	.	A	G	1	2	3	0	1	4	0	0
23	26187912	.	G	A	2	2	4	0	1	5	0	0
23	26225871	.	G	A	4	3	7	0	0	7	0	0
23	26225907	.	A	T	1	4	5	0	0	5	0	0
23	26226066	.	G	T	1	3	4	0	0	4	0	0
23	26227697	.	C	T	0	4	4	0	1	5	0	0
23	26232509	.	C	A	7	7	14	0	1	15	0	0
23	26240897	.	C	T	4	2	6	0	2	8	0	0
23	26241224	.	T	A	7	4	11	0	0	11	0	0
23	26249884	.	G	A	2	4	6	0	0	6	0	0
23	26251973	.	C	T	2	2	4	0	2	6	0	0
23	26251979	.	A	T	2	3	5	0	0	5	0	0
23	26252012	.	A	G	3	3	6	0	0	6	0	0
23	26273212	.	C	T	0	2	2	0	1	3	0	0
23	26504151	.	A	C	34	0	34	0	22	56	0	0
23	26504202	.	A	T	51	9	60	1	5	66	0	0
23	26504254	.	G	A	41	13	54	1	3	58	0	0
23	26504264	.	C	T	42	15	57	1	0	58	0	0
23	26507741	.	G	A	25	25	50	0	4	54	0	0
23	26509764	.	G	A	33	22	55	0	5	60	0	0
23	26514677	.	G	A	25	20	45	0	0	45	0	0
23	26514797	.	T	C	20	18	38	0	2	40	0	0
23	26517183	.	G	A	21	20	41	0	1	42	0	0
23	26519635	.	T	G	4	6	10	0	0	10	0	0
23	26522647	.	A	G	8	8	16	0	0	16	0	0
23	26543878	.	A	T	1	3	4	0	0	4	0	0
23	26763798	.	A	T	6	6	12	0	0	12	0	0
23	26764269	.	G	A	2	4	6	0	0	6	0	0
23	26764324	.	C	A	1	3	4	0	1	5	0	0
23	26764351	.	A	C	2	2	4	0	3	7	0	0
23	26797108	.	T	A	2	4	6	0	0	6	0	0
23	26946805	.	A	G	2	3	5	0	0	5	0	0
23	26955401	.	A	G	4	2	6	0	0	6	0	0
23	26979212	.	C	A	5	3	8	0	0	8	0	0
23	27003720	.	G	A	18	19	37	0	3	40	0	0
23	27003925	.	T	C	18	18	36	0	6	42	0	0
23	27003983	.	A	T	15	20	35	0	1	36	0	0
23	27005195	.	G	A	19	14	33	0	5	38	0	0
23	27041461	.	A	T	3	2	5	0	1	6	0	0
23	27042357	.	G	A	2	1	3	0	1	4	0	0
23	27044136	.	G	A	3	3	6	0	0	6	0	0
23	27044526	.	A	G	5	3	8	0	0	8	0	0
23	27052058	.	C	T	21	23	44	0	2	46	0	0
23	27054361	.	C	T	8	6	14	0	1	15	0	0
23	27056877	.	G	A	12	18	30	0	2	32	0	0
23	27059120	.	G	A	2	15	17	0	16	34	1	0
23	27059376	.	T	A	17	16	33	0	0	33	0	0
23	27059422	.	C	T	16	17	33	0	3	36	0	0
23	27059526	.	G	A	3	25	28	0	14	42	0	0
23	27059591	.	C	A	19	9	28	0	0	28	0	0
23	27059782	.	A	G	17	16	33	0	1	34	0	0
23	27251764	.	T	G	32	9	41	0	1	42	0	0
23	27251789	.	G	C	21	17	38	0	1	39	0	0
23	27252024	.	G	A	19	20	39	0	1	40	0	0
23	27252425	.	G	A	20	25	45	0	0	45	0	0
23	27252587	.	A	G	19	11	30	0	1	32	1	0
23	27252833	.	A	G	17	10	27	0	0	27	0	0
23	27274110	.	G	A	2	4	6	0	1	7	0	0
23	27279320	.	A	G	5	8	13	0	1	14	0	0
23	27279533	.	C	T	2	8	10	0	1	11	0	0
23	27283466	.	T	C	1	2	3	0	0	3	0	0
23	27283475	.	A	G	1	3	4	0	0	4	0	0
23	27293293	.	C	T	0	2	2	0	3	5	0	0
23	27293335	.	G	A	2	3	5	0	0	5	0	0
23	27359176	.	A	G	10	21	31	0	2	33	0	0
23	27359526	.	T	C	9	6	15	0	0	15	0	0
23	27359528	.	C	G	9	6	15	0	0	15	0	0
23	27359825	.	C	A	6	11	17	0	1	19	1	0
23	27361210	.	A	T	4	4	8	0	0	8	0	0
23	27361216	.	G	A	2	6	8	0	1	9	0	0
23	27366669	.	C	T	5	6	11	0	0	11	0	0
23	27448010	.	C	A	2	2	4	0	1	5	0	0
23	27498040	.	C	G	6	12	18	0	3	21	0	0
23	27498111	.	C	A	9	10	19	0	2	21	0	0
23	27498177	.	T	C	13	7	20	0	2	22	0	0
23	27498195	.	A	T	15	13	28	0	0	28	0	0
23	27498359	.	T	A	6	11	17	0	0	17	0	0
23	27498564	.	T	A	4	2	6	0	1	7	0	0
23	27498798	.	C	T	2	12	14	0	23	37	0	0
23	27498865	.	G	A	19	24	43	0	0	43	0	0
23	27499096	.	G	A	8	15	23	0	0	23	0	0
23	27499135	.	G	A	15	6	21	0	1	22	0	0
23	27499195	.	A	T	10	16	26	0	0	26	0	0
23	27499246	.	G	A	8	16	24	0	1	25	0	0
23	27521608	.	A	T	2	2	4	0	0	4	0	0
23	27547568	.	G	A	2	2	4	0	1	5	0	0
23	27576708	.	G	A	1	2	3	0	0	3	0	0
23	27591378	.	G	T	13	15	28	0	2	30	0	0
23	27593230	.	C	T	6	11	17	0	0	17	0	0
23	27595823	.	C	A	0	5	5	0	7	12	0	0
23	27595868	.	T	C	10	7	17	0	0	17	0	0
23	27596059	.	G	A	6	7	13	0	1	14	0	0
23	27597141	.	C	A	1	6	7	0	4	11	0	0
23	27605903	.	C	T	1	3	4	0	0	4	0	0
23	27622036	.	T	A	26	16	42	0	2	44	0	0
23	27622094	.	C	A	11	27	38	0	0	38	0	0
23	27622324	.	T	C	14	13	27	0	2	29	0	0
23	27622452	.	C	A	1	5	6	0	0	6	0	0
23	27622531	.	A	T	22	11	33	0	1	34	0	0
23	27622706	.	T	C	14	0	14	0	14	28	0	0
23	27629713	.	G	A	15	10	25	0	2	27	0	0
23	27629923	.	A	T	15	10	25	0	0	25	0	0
23	27641530	.	G	A	3	2	5	0	0	5	0	0
23	27641607	.	C	T	1	2	3	0	0	3	0	0
23	27657498	.	C	A	0	2	2	0	1	3	0	0
23	27676223	.	G	T	30	37	67	0	1	68	0	0
23	27677278	.	G	A	32	23	55	0	5	60	0	0
23	27677457	.	G	A	15	17	32	1	2	35	0	0
23	27683143	.	G	T	2	4	6	0	0	6	0	0
23	27683248	.	C	A	0	4	4	0	2	6	0	0
23	27683371	.	C	T	0	3	3	0	5	8	0	0
23	27683497	.	C	T	6	6	12	0	0	12	0	0
23	27683629	.	C	T	1	3	4	0	4	8	0	0
23	27683710	.	G	A	2	2	4	0	0	4	0	0
23	27788665	.	C	T	7	6	13	0	1	14	0	0
23	27800681	.	G	T	7	8	15	0	0	15	0	0
23	27801104	.	T	C	20	5	25	0	1	26	0	0
23	27807523	.	A	G	6	3	9	0	0	9	0	0
23	27807664	.	G	A	3	4	7	0	0	7	0	0
23	27809601	.	A	C	1	3	4	0	1	5	0	0
23	27822743	.	T	C	3	2	5	0	0	5	0	0
23	27836003	.	C	G	7	4	11	0	3	14	0	0
23	27836235	.	C	T	0	6	6	0	4	10	0	0
23	27842530	.	A	T	2	4	6	0	0	6	0	0
23	28374570	.	G	A	11	15	26	0	0	26	0	0
23	28374711	.	C	A	11	17	28	0	2	30	0	0
23	28374722	.	C	T	19	9	28	0	4	32	0	0
23	28377447	.	C	T	6	3	9	0	1	10	0	0
23	28378254	.	G	A	13	15	28	0	0	28	0	0
23	28382953	.	C	T	26	23	49	0	0	49	0	0
23	28388013	.	C	A	33	21	54	1	3	58	0	0
23	28388318	.	C	T	25	10	35	0	1	36	0	0
23	28388325	.	T	C	21	12	33	0	1	34	0	0
23	28486698	.	G	A	1	3	4	0	0	4	0	0
23	28541633	.	A	G	3	3	6	0	0	6	0	0
23	28541683	.	G	T	4	5	9	0	1	10	0	0
23	28546870	.	G	A	0	3	3	0	7	10	0	0
23	28547207	.	C	G	7	8	15	0	0	15	0	0
23	28547242	.	A	G	5	0	5	0	10	15	0	0
23	28547261	.	A	G	5	12	17	0	0	17	0	0
23	28548883	.	A	G	9	1	10	0	4	14	0	0
23	28551306	.	A	T	5	10	15	0	0	15	0	0
23	28551671	.	A	G	7	0	7	0	3	10	0	0
23	28551764	.	A	G	8	0	8	0	4	12	0	0
23	28551770	.	G	A	4	8	12	0	0	12	0	0
23	28554784	.	A	T	8	11	19	0	2	21	0	0
23	28557296	.	G	C	2	0	2	0	21	23	0	0
23	28557337	.	T	C	12	9	21	0	2	23	0	0
23	28561502	.	C	A	17	18	35	0	0	35	0	0
23	28564191	.	C	A	20	13	33	0	2	35	0	0
23	28669550	.	C	T	3	3	6	0	0	6	0	0
23	28672063	.	G	A	1	2	3	0	1	4	0	0
23	28674046	.	C	T	1	2	3	0	0	3	0	0
23	28674252	.	G	A	6	5	11	0	1	12	0	0
23	28679693	.	A	G	8	6	14	0	1	15	0	0
23	28679696	.	C	T	7	6	13	0	1	14	0	0
23	28679753	.	C	T	10	11	21	0	2	23	0	0
23	28680239	.	A	G	15	11	26	0	0	26	0	0
23	28687446	.	C	T	1	3	4	0	0	4	0	0
23	28687448	.	C	G	0	0	0	0	4	4	0	0
23	28687561	.	C	T	3	3	6	0	0	6	0	0
23	28687591	.	T	C	2	3	5	0	0	5	0	0
23	28687656	.	G	A	1	6	7	0	0	7	0	0
23	28691851	.	G	A	1	2	3	0	0	3	0	0
23	28704635	.	C	T	3	5	8	0	0	8	0	0
23	28705908	.	C	T	1	2	3	0	1	4	0	0
23	28707051	.	C	T	3	2	5	0	2	7	0	0
23	28707195	.	T	A	4	2	6	0	0	6	0	0
23	28713648	.	C	T	6	2	8	0	0	8	0	0
23	28722917	.	C	T	1	2	3	0	0	3	0	0
23	28724964	.	A	G	3	4	7	0	0	7	0	0
23	28725425	.	C	T	6	3	9	0	0	9	0	0
23	28725804	.	G	A	5	4	9	0	0	9	0	0
23	28725872	.	C	T	4	2	6	0	0	6	0	0
23	28725899	.	T	A	2	2	4	0	0	4	0	0
23	28725916	.	A	C	3	3	6	0	0	6	0	0
23	28726100	.	G	T	5	2	7	0	0	7	0	0
23	28726278	.	A	G	0	4	4	0	0	4	0	0
23	28726486	.	A	T	3	2	5	0	0	5	0	0
23	28726521	.	A	G	7	7	14	0	0	14	0	0
23	28726617	.	G	C	0	4	4	0	11	15	0	0
23	28726738	.	A	G	11	8	19	0	1	20	0	0
23	28726852	.	T	C	11	8	19	0	1	20	0	0
23	28726937	.	C	A	5	2	7	0	1	8	0	0
23	28731499	.	C	T	19	30	49	0	1	50	0	0
23	28803302	.	T	C	5	4	9	0	1	10	0	0
23	28803343	.	T	C	1	4	5	0	0	5	0	0
23	28922716	.	C	T	1	7	8	0	0	8	0	0
23	28922778	.	T	A	2	3	5	0	0	5	0	0
23	28923151	.	C	T	1	2	3	0	0	3	0	0
23	28923660	.	A	T	2	4	6	0	0	6	0	0
23	28923760	.	T	A	6	5	11	0	0	11	0	0
23	28923797	.	G	A	5	5	10	0	1	11	0	0
23	28923959	.	T	A	7	5	12	0	0	12	0	0
23	28923962	.	A	G	5	7	12	0	0	12	0	0
23	28924079	.	A	C	2	7	9	2	0	11	0	0
23	28924687	.	G	A	0	9	9	0	3	12	0	0
23	28924873	.	G	A	2	3	5	0	0	5	0	0
23	28924961	.	G	A	1	5	6	0	2	8	0	0
23	28925156	.	A	T	7	11	18	0	0	18	0	0
23	28925159	.	G	A	2	10	12	0	8	20	0	0
23	28925272	.	A	G	14	3	17	0	1	18	0	0
23	28925275	.	T	C	3	14	17	0	1	18	0	0
23	28925441	.	G	A	7	5	12	0	0	12	0	0
23	28925451	.	A	T	6	4	10	0	1	11	0	0
23	28925589	.	G	A	0	4	4	0	3	7	0	0
23	28979387	.	G	A	1	2	3	0	0	3	0	0
23	29358241	.	G	A	3	14	17	0	20	37	0	0
23	29358253	.	C	T	22	18	40	0	0	40	0	0
23	29360044	.	T	C	12	10	22	0	1	23	0	0
23	29360687	.	G	T	3	4	7	0	0	7	0	0
23	29360707	.	G	T	2	2	4	0	1	5	0	0
23	29360757	.	T	G	1	3	4	0	0	4	0	0
23	29361357	.	C	A	10	21	31	1	2	34	0	0
23	29361365	.	A	C	16	15	31	1	3	35	0	0
23	29361557	.	A	T	7	11	18	0	2	20	0	0
23	29376111	.	T	C	7	13	20	0	2	22	0	0
23	29376480	.	A	G	7	4	11	0	0	11	0	0
23	29376485	.	T	C	5	4	9	0	1	10	0	0
23	29381816	.	G	A	14	9	23	0	2	25	0	0
23	29381819	.	T	G	16	9	25	0	0	25	0	0
23	29381855	.	T	G	20	13	33	0	0	33	0	0
23	29383693	.	C	A	10	13	23	0	3	26	0	0
23	29386735	.	C	T	4	3	7	0	0	7	0	0
23	29386973	.	G	T	5	3	8	0	0	8	0	0
23	29392421	.	G	A	5	6	11	0	1	12	0	0
23	29393643	.	A	T	2	5	7	0	0	7	0	0
23	29396452	.	C	T	3	30	33	0	23	56	0	0
23	29396482	.	C	T	29	27	56	0	0	56	0	0
23	29396588	.	T	C	31	2	33	1	27	61	0	0
23	29397230	.	T	A	23	24	47	0	3	50	0	0
23	29397451	.	T	G	20	21	41	0	1	42	0	0
23	29397537	.	G	A	30	24	54	0	2	56	0	0
23	29397816	.	G	A	26	19	45	0	3	48	0	0
23	29397907	.	T	C	33	24	57	0	1	58	0	0
23	29398015	.	C	A	1	23	24	0	25	49	0	0
23	29398025	.	G	A	25	20	45	0	3	48	0	0
23	29398288	.	T	G	31	10	41	0	0	41	0	0
23	29398310	.	C	T	28	13	41	0	1	42	0	0
23	29398343	.	A	G	22	25	47	0	1	48	0	0
23	29398390	.	C	T	22	23	45	0	3	48	0	0
23	29398718	.	A	T	22	17	39	0	4	43	0	0
23	29402103	.	A	G	23	19	42	0	1	43	0	0
23	29403243	.	G	A	21	21	42	0	0	42	0	0
23	29403297	.	G	A	15	22	37	0	0	37	0	0
23	29403306	.	T	G	23	15	38	0	1	39	0	0
23	29408929	.	G	A	12	16	28	0	2	30	0	0
23	29421959	.	C	G	13	5	18	0	2	20	0	0
23	29422007	.	G	C	13	0	13	0	12	25	0	0
23	29423410	.	G	A	10	11	21	0	0	21	0	0
23	29433670	.	G	A	7	4	11	0	0	11	0	0
23	29433715	.	C	A	5	5	10	0	1	11	0	0
23	29435330	.	C	T	3	2	5	0	0	5	0	0
23	29435381	.	G	A	4	5	9	0	0	9	0	0
23	29582416	.	T	C	21	33	54	0	3	57	0	0
23	29582420	.	T	C	15	42	57	0	1	58	0	0
23	29582496	.	T	C	25	28	53	0	2	55	0	0
23	29712670	.	G	A	10	10	20	3	2	25	0	0
23	30061604	.	A	C	23	15	38	0	5	43	0	0
23	30061605	.	A	C	21	17	38	0	5	43	0	0
23	30712041	.	T	A	1	1	2	0	3	5	0	0
23	30715397	.	G	A	0	3	3	0	3	6	0	0
23	30716096	.	C	T	2	4	6	0	0	6	0	0
23	30718514	.	T	A	5	5	10	0	0	10	0	0
23	30723747	.	A	T	7	7	14	0	1	15	0	0
23	30724362	.	T	G	8	3	11	0	0	11	0	0
23	30724440	.	T	C	6	11	17	0	0	17	0	0
23	30724793	.	G	T	3	3	6	0	0	6	0	0
23	30727052	.	T	C	1	2	3	0	0	3	0	0
23	30730374	.	C	T	3	2	5	0	0	5	0	0
23	30747357	.	G	C	3	7	10	0	1	11	0	0
23	30747953	.	G	A	4	5	9	0	1	10	0	0
23	30748097	.	G	A	6	3	9	0	0	9	0	0
23	30748743	.	C	T	1	3	4	0	0	4	0	0
23	30750402	.	C	A	10	10	20	0	1	21	0	0
23	30750694	.	C	A	14	12	26	0	2	28	0	0
23	30750751	.	G	A	1	14	15	0	21	36	0	0
23	30750932	.	A	C	14	15	29	0	0	29	0	0
23	30751008	.	T	C	5	16	21	0	1	22	0	0
23	30751027	.	A	T	5	14	19	0	3	22	0	0
23	30751061	.	A	G	5	0	5	0	16	21	0	0
23	30751117	.	T	C	11	8	19	0	1	20	0	0
23	30751132	.	T	G	13	1	14	0	11	26	1	0
23	30751252	.	A	G	18	14	32	0	1	33	0	0
23	30751570	.	C	T	16	16	32	0	0	32	0	0
23	30751633	.	T	C	12	17	29	0	2	31	0	0
23	30755989	.	C	T	9	16	25	0	0	25	0	0
23	30758493	.	G	T	8	14	22	0	1	23	0	0
23	30764058	.	T	A	1	7	8	0	0	8	0	0
23	30764235	.	A	G	5	4	9	0	0	9	0	0
23	30767575	.	T	A	13	14	27	0	1	28	0	0
23	30770193	.	A	G	6	13	19	0	0	19	0	0
23	30772610	.	C	T	0	13	13	0	11	24	0	0
23	30772902	.	C	T	11	6	17	0	1	18	0	0
23	30775315	.	T	C	11	0	11	0	15	26	0	0
23	30776329	.	T	A	7	13	20	0	0	20	0	0
23	30776380	.	T	C	3	0	3	0	9	12	0	0
23	30776574	.	A	T	3	3	6	0	0	6	0	0
23	30778358	.	T	C	3	4	7	0	0	7	0	0
23	30778499	.	G	A	8	7	15	0	1	16	0	0
23	30778864	.	C	G	0	6	6	0	12	18	0	0
23	30781226	.	T	A	2	4	6	0	2	8	0	0
23	30781319	.	A	G	9	4	13	0	0	13	0	0
23	30781367	.	T	C	4	7	11	0	0	11	0	0
23	30890191	.	T	G	2	2	4	0	1	5	0	0
23	30890701	.	T	A	4	2	6	0	0	6	0	0
23	30898297	.	T	C	1	3	4	0	1	5	0	0
23	30898355	.	A	C	2	2	4	0	0	4	0	0
23	30898387	.	C	T	1	3	4	0	0	4	0	0
23	30898503	.	A	T	2	2	4	0	0	4	0	0
23	30919027	.	T	G	3	2	5	0	0	5	0	0
23	31245593	.	A	T	2	4	6	0	0	6	0	0
23	31248605	.	A	T	5	2	7	0	1	8	0	0
23	31248779	.	T	C	3	3	6	0	0	6	0	0
23	31276453	.	G	A	2	2	4	0	0	4	0	0
23	31276509	.	C	T	1	4	5	0	0	5	0	0
23	31276657	.	T	C	6	4	10	0	0	10	0	0
23	31278183	.	G	T	3	2	5	0	0	5	0	0
23	31278322	.	A	G	3	4	7	0	2	9	0	0
23	31278375	.	A	G	7	4	11	0	1	12	0	0
23	31278417	.	G	T	5	3	8	0	2	10	0	0
23	31278450	.	T	A	4	5	9	0	1	10	0	0
23	31278732	.	C	T	2	3	5	0	2	7	0	0
23	31279122	.	G	T	2	2	4	0	0	4	0	0
23	31280198	.	G	A	2	2	4	0	0	4	0	0
23	31281768	.	T	G	2	2	4	0	0	4	0	0
23	31358342	.	A	T	32	24	56	0	1	57	0	0
23	31358344	.	A	T	26	24	50	0	1	51	0	0
23	31358489	.	T	G	25	29	54	0	1	55	0	0
23	31358631	.	G	A	24	35	59	1	2	62	0	0
23	31381389	.	T	C	3	2	5	0	0	5	0	0
23	31381392	.	C	T	3	2	5	0	0	5	0	0
23	31381425	.	C	T	2	3	5	0	0	5	0	0
23	31405519	.	C	T	8	4	12	0	0	12	0	0
23	31405570	.	A	C	9	6	15	0	1	16	0	0
23	31419064	.	C	T	3	6	9	0	1	10	0	0
23	31419172	.	A	T	4	5	9	0	0	9	0	0
23	31422369	.	A	T	4	4	8	0	1	9	0	0
23	31422429	.	C	T	1	5	6	0	0	6	0	0
23	31422768	.	A	G	2	8	10	1	1	12	0	0
23	31423091	.	T	C	8	3	11	0	1	12	0	0
23	31423145	.	G	A	1	6	7	0	9	16	0	0
23	31423392	.	C	A	12	9	21	0	4	25	0	0
23	31423427	.	A	G	18	0	18	0	14	32	0	0
23	31423432	.	C	A	20	12	32	0	2	34	0	0
23	31432102	.	A	G	11	1	12	0	18	30	0	0
23	31435916	.	G	A	6	3	9	0	1	10	0	0
23	31440119	.	T	A	2	4	6	0	0	6	0	0
23	31597571	.	T	C	4	6	10	0	0	10	0	0
23	31604900	.	C	T	4	6	10	0	1	11	0	0
23	31604912	.	G	T	3	5	8	0	1	9	0	0
23	31640363	.	A	G	2	2	4	0	0	4	0	0
23	31641153	.	C	A	19	24	43	0	4	47	0	0
23	31641197	.	A	G	20	23	43	0	3	46	0	0
23	31641270	.	G	A	13	24	37	0	3	40	0	0
23	31643818	.	A	G	16	5	21	0	0	21	0	0
23	31644368	.	A	G	12	8	20	0	0	20	0	0
23	31644419	.	A	G	4	9	13	0	0	13	0	0
23	31644602	.	T	G	9	5	14	0	2	16	0	0
23	31684244	.	A	G	7	5	12	0	1	13	0	0
23	31684352	.	G	A	5	5	10	0	1	11	0	0
23	31768596	.	T	C	8	13	21	0	0	21	0	0
23	31771282	.	T	C	9	5	14	0	0	14	0	0
23	31774194	.	G	A	10	3	13	0	0	13	0	0
23	31778174	.	A	G	6	3	9	0	2	11	0	0
23	31778183	.	C	T	7	3	10	0	0	10	0	0
23	31782969	.	T	C	7	0	7	0	5	12	0	0
23	31785175	.	G	A	4	4	8	0	1	9	0	0
23	31785183	.	T	G	3	4	7	0	0	7	0	0
23	31804162	.	A	G	5	5	10	0	0	10	0	0
23	31933739	.	T	G	2	2	4	0	0	4	0	0
23	31940681	.	C	A	6	4	10	0	0	10	0	0
23	31940775	.	T	A	4	3	7	0	0	7	0	0
23	31940776	.	A	G	4	3	7	0	0	7	0	0
23	31940818	.	C	T	2	3	5	0	2	7	0	0
23	31953228	.	A	T	1	3	4	0	0	4	0	0
23	31962971	.	T	C	10	5	15	0	0	15	0	0
23	31963226	.	C	T	5	6	11	0	0	11	0	0
23	31964680	.	C	T	10	9	19	0	0	19	0	0
23	31992690	.	C	T	1	2	3	0	0	3	0	0
23	31997582	.	G	A	5	2	7	0	0	7	0	0
23	31997953	.	C	T	3	4	7	0	0	7	0	0
23	31998162	.	T	C	3	5	8	0	0	8	0	0
23	31998741	.	A	G	2	0	2	0	3	5	0	0
23	32000336	.	G	C	2	7	9	0	1	10	0	0
23	32001190	.	C	T	1	7	8	0	2	10	0	0
23	32003354	.	T	A	9	7	16	0	0	16	0	0
23	32003808	.	T	C	3	7	10	0	1	11	0	0
23	32003820	.	G	T	6	8	14	0	0	14	0	0
23	32007376	.	T	G	8	9	17	0	2	19	0	0
23	32007445	.	T	A	10	10	20	0	5	25	0	0
23	32007520	.	T	C	8	6	14	0	0	14	0	0
23	32007526	.	C	G	7	6	13	0	0	13	0	0
23	32026927	.	T	C	11	19	30	0	3	33	0	0
23	32026978	.	C	T	5	8	13	0	0	13	0	0
23	32026996	.	G	A	1	4	5	0	2	8	1	0
23	32081708	.	C	T	9	6	15	0	1	16	0	0
23	32081717	.	T	C	9	6	15	0	1	16	0	0
23	32085908	.	G	T	4	2	6	0	0	6	0	0
23	32128848	.	A	T	2	3	5	0	0	5	0	0
23	32128893	.	T	C	2	4	6	0	0	6	0	0
23	32129326	.	C	A	4	3	7	0	1	8	0	0
23	32129476	.	G	T	1	4	5	0	0	5	0	0
23	32129514	.	G	T	2	2	4	0	0	4	0	0
23	32151669	.	A	C	20	13	33	0	1	34	0	0
23	32152022	.	C	T	16	16	32	0	1	33	0	0
23	32154021	.	G	T	4	7	11	0	0	11	0	0
23	32155719	.	C	T	5	6	11	0	0	11	0	0
23	32155720	.	C	T	2	6	8	0	3	11	0	0
23	32155975	.	C	T	2	2	4	0	0	4	0	0
23	32200114	.	A	C	2	4	6	0	0	6	0	0
23	32200517	.	C	A	3	3	6	0	0	6	0	0
23	32200979	.	A	G	3	4	7	0	1	8	0	0
23	32239335	.	G	C	4	1	5	0	1	6	0	0
23	32239474	.	A	G	3	2	5	0	1	6	0	0
23	32239672	.	G	A	12	4	16	0	1	17	0	0
23	32239688	.	C	A	15	2	17	0	1	18	0	0
23	32239708	.	G	A	16	7	23	0	1	24	0	0
23	32239824	.	G	A	10	11	21	2	0	23	0	0
23	32240258	.	C	T	10	4	14	0	0	14	0	0
23	32240290	.	A	G	10	6	16	0	1	17	0	0
23	32242086	.	C	A	8	11	19	0	1	20	0	0
23	32242251	.	T	C	8	6	14	0	0	14	0	0
23	32246169	.	A	G	4	5	9	0	0	9	0	0
23	32246190	.	A	G	4	3	7	0	0	7	0	0
23	32251473	.	T	G	3	2	5	0	0	5	0	0
23	32309187	.	T	C	18	16	34	0	1	35	0	0
23	32309193	.	G	A	16	14	30	0	4	34	0	0
23	32309323	.	G	A	20	18	38	0	0	38	0	0
23	32309533	.	A	G	12	14	26	0	0	26	0	0
23	32309659	.	C	A	0	8	8	0	14	22	0	0
23	32309709	.	G	A	8	8	16	0	3	19	0	0
23	32309787	.	A	C	9	14	23	0	1	25	1	0
23	32309943	.	A	G	5	2	7	0	1	8	0	0
23	32310148	.	G	T	4	2	6	0	2	8	0	0
23	32310151	.	G	A	4	3	7	0	1	8	0	0
23	32310209	.	C	T	6	6	12	0	0	12	0	0
23	32310349	.	A	G	4	3	7	0	0	7	0	0
23	32310359	.	C	T	0	3	3	0	4	7	0	0
23	32310782	.	T	G	6	3	9	0	0	9	0	0
23	32310808	.	C	T	7	6	13	0	0	13	0	0
23	32310864	.	G	A	6	9	15	0	0	15	0	0
23	32311418	.	T	C	5	8	13	0	2	15	0	0
23	32311555	.	G	C	11	13	24	0	1	25	0	0
23	32311612	.	G	A	10	8	18	0	1	19	0	0
23	32318047	.	A	G	12	15	27	0	0	27	0	0
23	32326532	.	A	G	9	9	18	1	0	19	0	0
23	32362317	.	A	G	1	2	3	0	0	3	0	0
23	32589398	.	C	T	2	2	4	0	0	4	0	0
23	32621780	.	C	T	0	2	2	0	1	3	0	0
23	33361310	.	C	T	2	6	8	0	0	8	0	0
23	33657205	.	A	G	12	18	30	0	2	32	0	0
23	33657451	.	A	G	22	16	38	0	1	39	0	0
23	33658013	.	T	G	9	9	18	0	1	20	1	0
23	33658031	.	A	C	8	13	21	0	1	23	1	0
23	33658052	.	G	A	7	9	16	0	1	17	0	0
23	33663285	.	C	T	7	6	13	0	1	14	0	0
23	33664546	.	C	T	13	6	19	1	0	20	0	0
23	33961814	.	A	G	9	3	12	0	1	13	0	0
23	34678957	.	G	T	2	2	4	0	0	4	0	0
23	34726438	.	T	C	4	4	8	0	0	8	0	0
23	34726444	.	G	T	4	3	7	0	1	8	0	0
23	34748833	.	G	A	1	3	4	0	1	5	0	0
23	34753803	.	A	G	5	11	16	0	1	17	0	0
23	35027189	.	T	C	4	2	6	0	0	6	0	0
23	35027248	.	A	G	4	2	6	0	1	7	0	0
23	35027480	.	T	G	4	6	10	0	0	10	0	0
23	35027541	.	A	G	1	4	5	0	0	5	0	0
23	35027736	.	C	G	4	2	6	0	0	6	0	0
23	35039803	.	C	T	3	3	6	0	0	6	0	0
23	35052494	.	G	A	2	2	4	0	0	4	0	0
23	35188562	.	G	A	2	4	6	0	0	6	0	0
23	35256186	.	G	A	1	2	3	0	1	4	0	0
23	35362951	.	C	T	4	8	12	0	3	16	1	0
23	35362973	.	G	T	5	10	15	0	1	16	0	0
23	35363024	.	A	T	5	9	14	0	3	17	0	0
23	35363067	.	A	T	9	7	16	0	4	20	0	0
23	35363106	.	G	A	22	9	31	0	0	31	0	0
23	35363111	.	C	G	24	8	32	0	1	33	0	0
23	35363226	.	T	C	16	2	18	0	14	32	0	0
23	35363341	.	A	G	12	10	22	0	1	23	0	0
23	35369733	.	G	A	5	4	9	0	0	9	0	0
23	35383037	.	C	T	1	3	4	0	0	4	0	0
23	35469006	.	T	A	3	3	6	0	0	6	0	0
23	35469135	.	T	C	3	5	8	0	0	8	0	0
23	35469136	.	G	A	3	5	8	0	0	8	0	0
23	35469479	.	A	G	11	7	18	0	2	20	0	0
23	35469668	.	G	T	15	13	28	0	0	28	0	0
23	35473640	.	A	G	5	4	9	0	1	10	0	0
23	35537599	.	G	A	12	6	18	0	1	19	0	0
23	35537617	.	G	A	10	5	15	0	0	15	0	0
23	35642195	.	C	T	3	8	11	0	0	11	0	0
23	35642327	.	T	G	5	12	17	0	1	18	0	0
23	35644234	.	C	T	6	6	12	0	1	13	0	0
23	35661530	.	T	C	2	3	5	0	0	5	0	0
23	35661549	.	A	C	2	3	5	0	0	5	0	0
23	35691968	.	T	G	35	12	47	0	1	48	0	0
23	35709839	.	T	C	28	16	44	15	0	59	0	0
23	35710179	.	A	C	45	20	65	2	2	69	0	0
23	35710620	.	A	C	28	25	53	0	4	57	0	0
23	35714883	.	T	C	4	4	8	22	0	30	0	0
23	35755562	.	G	A	1	1	2	0	1	3	0	0
23	35771483	.	T	C	2	6	8	0	0	8	0	0
23	35771486	.	T	C	2	6	8	0	0	8	0	0
23	35787331	.	T	G	4	2	6	0	0	6	0	0
23	35787449	.	A	G	3	4	7	0	2	9	0	0
23	35787841	.	G	T	1	4	5	0	0	5	0	0
23	35788256	.	G	A	4	3	7	0	0	7	0	0
23	35788328	.	G	A	7	4	11	0	0	12	1	0
23	35788505	.	C	T	4	1	5	0	2	7	0	0
23	35788513	.	G	A	2	4	6	0	1	7	0	0
23	35798545	.	G	A	3	2	5	0	0	5	0	0
23	35800378	.	T	C	6	0	6	0	3	9	0	0
23	35800550	.	C	T	1	2	3	0	4	7	0	0
23	35800591	.	C	T	6	3	9	0	0	9	0	0
23	35918697	.	A	T	2	4	6	0	1	7	0	0
23	35918795	.	G	A	2	3	5	0	0	5	0	0
23	35960683	.	G	A	13	9	22	0	0	22	0	0
23	35963176	.	T	G	10	6	16	0	1	17	0	0
23	35963316	.	C	T	5	5	10	0	0	10	0	0
23	35963322	.	T	G	3	5	8	0	1	9	0	0
23	35982441	.	A	G	5	14	19	0	0	19	0	0
23	35982533	.	G	A	5	11	16	0	1	17	0	0
23	35982637	.	G	A	5	12	17	0	0	17	0	0
23	35982726	.	C	G	2	4	6	1	1	8	0	0
23	35982755	.	T	C	1	6	7	1	2	10	0	0
23	35983029	.	A	G	6	14	20	0	1	21	0	0
23	35993540	.	T	A	4	5	9	0	1	10	0	0
23	35993793	.	T	C	6	4	10	0	1	11	0	0
23	36000704	.	T	C	5	0	5	0	3	8	0	0
23	36132338	.	C	A	5	8	13	0	0	13	0	0
23	36148017	.	A	G	1	0	1	0	2	3	0	0
23	36297367	.	C	T	5	8	13	0	4	17	0	0
23	36297471	.	C	T	7	11	18	0	1	19	0	0
23	36297916	.	C	T	8	7	15	0	3	18	0	0
23	36298320	.	T	A	17	16	33	0	1	34	0	0
23	36298327	.	A	T	15	16	31	0	1	33	1	0
23	36298375	.	T	C	15	19	34	0	2	36	0	0
23	36298719	.	G	A	21	13	34	0	3	37	0	0
23	36301544	.	G	A	18	16	34	0	0	34	0	0
23	36301679	.	A	G	13	17	30	0	4	34	0	0
23	36303266	.	G	C	16	14	30	0	0	30	0	0
23	36306566	.	G	T	0	4	4	0	10	14	0	0
23	36307656	.	A	T	23	15	38	0	1	39	0	0
23	36307779	.	C	T	15	11	26	0	4	30	0	0
23	36307906	.	C	G	8	12	20	3	3	26	0	0
23	36343467	.	T	C	15	15	30	0	2	32	0	0
23	36353698	.	A	G	25	18	43	0	1	44	0	0
23	36353869	.	C	G	13	12	25	0	1	26	0	0
23	36353876	.	G	T	0	11	11	0	12	23	0	0
23	36401844	.	A	G	8	7	15	0	0	15	0	0
23	36401926	.	T	C	4	3	7	0	0	7	0	0
23	36401930	.	A	G	5	2	7	0	0	7	0	0
23	36401986	.	G	C	3	5	8	0	0	8	0	0
23	36402184	.	A	G	4	3	7	0	1	8	0	0
23	36404898	.	C	G	3	3	6	0	0	6	0	0
23	36404967	.	A	G	8	5	13	0	1	14	0	0
23	36405429	.	A	G	1	2	3	0	3	6	0	0
23	36443511	.	A	T	9	8	17	0	0	17	0	0
23	36443813	.	C	T	4	3	7	0	0	7	0	0
23	36443865	.	C	A	7	4	11	0	0	11	0	0
23	36444201	.	G	C	8	0	8	0	5	13	0	0
23	36445967	.	C	G	9	8	17	0	1	18	0	0
23	36446023	.	G	A	10	4	14	0	0	14	0	0
23	36446132	.	A	G	3	3	6	0	1	7	0	0
23	36446190	.	A	T	6	5	11	0	1	12	0	0
23	36446258	.	T	C	3	0	3	0	6	9	0	0
23	36446271	.	C	T	5	3	8	0	1	9	0	0
23	36477749	.	A	G	4	1	5	0	1	6	0	0
23	36491169	.	C	G	0	9	9	0	8	17	0	0
23	36604488	.	G	A	6	2	8	0	0	8	0	0
23	36616998	.	C	T	6	5	11	0	1	12	0	0
23	36627793	.	C	T	5	10	15	0	0	15	0	0
23	36627859	.	G	C	9	11	20	0	1	21	0	0
23	36638542	.	G	A	7	8	15	0	0	15	0	0
23	36644423	.	T	G	22	18	40	0	4	44	0	0
23	36644907	.	C	T	17	20	37	0	2	39	0	0
23	36662097	.	A	G	6	3	9	0	0	9	0	0
23	36662098	.	C	G	0	3	3	0	6	9	0	0
23	36662174	.	T	G	4	2	6	0	1	7	0	0
23	36662175	.	T	G	5	2	7	0	0	7	0	0
23	36662273	.	G	A	5	4	9	0	0	9	0	0
23	36662327	.	T	A	5	2	7	0	0	7	0	0
23	36662400	.	A	G	2	2	4	0	1	5	0	0
23	36662449	.	A	C	5	5	10	0	0	10	0	0
23	36663506	.	C	A	0	4	4	0	4	8	0	0
23	36663512	.	C	T	0	6	6	0	3	9	0	0
23	36679751	.	C	T	20	18	38	0	1	39	0	0
23	36679829	.	G	C	30	0	30	0	19	49	0	0
23	36679874	.	T	C	18	1	19	0	20	39	0	0
23	36681545	.	C	T	1	15	16	0	24	40	0	0
23	36681557	.	A	G	20	19	39	0	1	40	0	0
23	36681927	.	T	C	21	16	37	0	0	37	0	0
23	36683801	.	G	A	16	16	32	1	2	35	0	0
23	36688236	.	T	C	12	0	12	0	19	31	0	0
23	36689677	.	C	T	13	13	26	0	0	26	0	0
23	36690595	.	G	A	9	11	20	0	3	23	0	0
23	36690641	.	T	A	11	15	26	0	2	28	0	0
23	36700836	.	T	G	17	9	26	0	1	27	0	0
23	36700891	.	G	A	15	16	31	0	0	31	0	0
23	36700896	.	T	A	15	15	30	0	2	32	0	0
23	36730854	.	A	T	4	4	8	0	0	8	0	0
23	36738776	.	C	T	7	3	10	0	1	11	0	0
23	36749380	.	G	A	4	17	21	0	18	39	0	0
23	36750005	.	C	G	18	14	32	0	1	33	0	0
23	36750440	.	A	T	1	6	7	0	1	8	0	0
23	36772018	.	G	A	1	10	11	0	15	26	0	0
23	36798184	.	C	T	16	8	24	0	1	25	0	0
23	36798220	.	G	A	13	17	30	0	0	30	0	0
23	36798612	.	G	A	1	17	18	0	11	29	0	0
23	36845672	.	G	A	1	1	2	0	1	3	0	0
23	36845687	.	G	A	1	2	3	0	0	3	0	0
23	36907624	.	G	A	3	4	7	0	0	7	0	0
23	36914223	.	A	G	1	4	5	0	1	6	0	0
23	37068571	.	T	C	10	4	14	0	1	15	0	0
23	37075407	.	C	T	5	6	11	0	0	11	0	0
23	37083054	.	G	T	1	2	3	0	0	3	0	0
23	37086288	.	A	C	4	4	8	0	0	8	0	0
23	37086317	.	G	T	2	5	7	0	0	7	0	0
23	37086368	.	G	A	4	3	7	0	0	7	0	0
23	37089102	.	G	A	10	3	13	0	0	13	0	0
23	37089162	.	C	T	7	5	12	0	0	12	0	0
23	37089192	.	C	T	4	6	10	0	3	13	0	0
23	37089333	.	C	T	4	6	10	0	1	11	0	0
23	37089568	.	C	T	6	3	9	0	0	9	0	0
23	37089609	.	T	G	10	9	19	0	0	19	0	0
23	37089852	.	A	T	12	9	21	0	1	22	0	0
23	37090003	.	T	C	5	8	13	0	2	15	0	0
23	37093047	.	G	A	7	2	9	0	0	9	0	0
23	37093411	.	C	T	5	2	7	0	0	7	0	0
23	37277157	.	A	G	16	8	24	0	0	24	0	0
23	37277289	.	G	A	13	10	23	0	0	23	0	0
23	37280658	.	C	T	19	13	32	0	0	32	0	0
23	37288130	.	T	C	1	0	1	0	3	4	0	0
23	37324009	.	A	G	8	1	9	1	10	20	0	0
23	37324638	.	A	C	16	15	31	0	0	31	0	0
23	37324848	.	G	A	16	9	25	0	1	26	0	0
23	37324868	.	G	C	14	6	20	0	4	24	0	0
23	37324990	.	A	G	23	20	43	0	1	44	0	0
23	37325026	.	C	T	22	23	45	0	1	46	0	0
23	37325138	.	T	G	22	0	22	0	19	41	0	0
23	37325570	.	A	C	26	22	48	0	3	51	0	0
23	37325817	.	T	G	13	12	25	0	1	26	0	0
23	37415381	.	T	A	1	2	3	0	0	3	0	0
23	37458748	.	G	A	6	13	19	0	0	19	0	0
23	37458791	.	A	T	6	8	14	0	1	15	0	0
23	37461642	.	T	C	6	10	16	0	0	16	0	0
23	37464452	.	A	G	6	9	15	0	0	15	0	0
23	37464661	.	T	A	2	3	5	0	1	7	1	0
23	37464760	.	G	C	1	2	3	0	3	6	0	0
23	37464804	.	C	A	8	3	11	0	0	11	0	0
23	37465007	.	T	C	6	6	12	0	0	12	0	0
23	37465257	.	A	G	4	0	4	0	3	7	0	0
23	37465276	.	A	T	5	2	7	0	0	7	0	0
23	37465332	.	A	T	6	5	11	0	0	11	0	0
23	37465584	.	T	C	4	2	6	0	0	6	0	0
23	37465887	.	G	A	0	5	5	0	4	9	0	0
23	37468267	.	C	T	1	4	5	0	0	5	0	0
23	37468393	.	A	G	1	3	4	0	0	4	0	0
23	37476475	.	T	C	13	6	19	0	1	20	0	0
23	37476675	.	G	A	0	8	8	0	6	14	0	0
23	37478227	.	G	T	7	7	14	0	1	15	0	0
23	37478506	.	C	G	3	2	5	0	1	6	0	0
23	37479992	.	G	T	33	9	42	0	0	42	0	0
23	37503288	.	A	G	2	2	4	0	1	5	0	0
23	37707464	.	A	T	1	2	3	0	0	3	0	0
23	37769534	.	G	T	1	4	5	0	0	5	0	0
23	37769540	.	G	A	0	3	3	0	1	4	0	0
23	37815706	.	C	T	2	2	4	0	0	4	0	0
23	37816261	.	G	A	1	2	3	0	0	3	0	0
23	37823651	.	T	A	5	2	7	0	0	7	0	0
23	37823704	.	A	G	5	1	6	0	1	7	0	0
23	37823710	.	T	C	4	2	6	0	0	6	0	0
23	37823782	.	T	C	3	2	5	0	0	5	0	0
23	37823795	.	T	C	3	4	7	0	0	7	0	0
23	37973729	.	C	T	1	4	5	0	2	7	0	0
23	38151520	.	C	T	9	10	19	0	1	20	0	0
23	38379786	.	C	T	1	16	17	0	14	31	0	0
23	38380005	.	C	T	21	11	32	0	0	32	0	0
23	38380047	.	G	A	14	19	33	0	0	33	0	0
23	38381217	.	C	T	0	7	7	0	10	17	0	0
23	38381281	.	T	C	6	5	11	0	0	11	0	0
23	38810913	.	A	G	1	3	4	0	0	4	0	0
23	38816824	.	T	C	1	4	5	0	1	6	0	0
23	38816827	.	T	C	1	3	4	0	0	4	0	0
23	38817922	.	T	A	4	3	7	0	0	7	0	0
23	38818001	.	G	A	3	4	7	0	1	8	0	0
23	38818004	.	G	A	4	4	8	0	0	8	0	0
23	38818067	.	A	T	3	4	7	0	0	7	0	0
23	38818094	.	G	A	3	2	5	0	0	5	0	0
23	38818234	.	A	G	2	0	2	0	4	6	0	0
23	38818249	.	G	T	3	3	6	0	0	6	0	0
23	38818351	.	A	G	1	4	5	0	0	5	0	0
23	38818395	.	G	A	0	4	4	0	2	6	0	0
23	38947320	.	C	T	3	3	6	0	0	6	0	0
23	38947372	.	A	C	2	3	5	0	0	5	0	0
23	39322043	.	T	C	1	2	3	0	0	3	0	0
23	39413341	.	A	C	2	4	6	0	0	6	0	0
23	39440432	.	A	C	3	2	5	0	0	5	0	0
23	39442965	.	C	T	5	3	8	0	0	8	0	0
23	39516572	.	C	A	1	3	4	0	0	4	0	0
23	39516879	.	C	T	4	2	6	0	0	6	0	0
23	39593793	.	T	C	5	2	7	0	0	7	0	0
23	39594141	.	C	T	1	3	4	0	0	4	0	0
23	39594211	.	A	G	3	1	4	0	4	8	0	0
23	39594962	.	C	T	1	4	5	0	0	5	0	0
23	39594993	.	A	G	2	0	2	0	3	5	0	0
23	39595026	.	A	G	1	6	7	0	0	7	0	0
23	39595044	.	C	T	1	4	5	0	0	5	0	0
23	39595248	.	T	G	3	2	5	0	0	6	1	0
23	39595297	.	G	T	1	2	3	0	1	4	0	0
23	39595974	.	C	T	7	7	14	0	0	14	0	0
23	39596028	.	C	T	3	5	8	0	0	8	0	0
23	39596776	.	T	C	5	9	14	0	2	16	0	0
23	39596919	.	G	A	0	4	4	0	5	9	0	0
23	39597119	.	G	T	7	11	18	0	2	20	0	0
23	39597309	.	G	A	0	9	9	0	9	18	0	0
23	39597566	.	T	C	4	5	9	2	0	11	0	0
23	39597657	.	A	T	3	5	8	0	0	8	0	0
23	39611787	.	G	T	0	3	3	0	3	6	0	0
23	39615660	.	C	T	3	3	6	0	1	7	0	0
23	39615689	.	G	C	7	4	11	0	1	12	0	0
23	39615706	.	C	A	6	3	9	0	0	9	0	0
23	39623042	.	G	A	1	11	12	0	5	17	0	0
23	39626230	.	G	C	6	5	11	0	2	13	0	0
23	39626311	.	C	T	12	8	20	0	0	20	0	0
23	39626395	.	C	T	10	4	14	0	1	15	0	0
23	39626525	.	G	A	2	6	8	0	0	8	0	0
23	39626554	.	G	A	6	3	9	0	0	9	0	0
23	39632901	.	A	G	5	12	17	0	0	17	0	0
23	39633114	.	C	T	3	8	11	0	7	18	0	0
23	39633254	.	T	C	1	2	3	0	0	3	0	0
23	39635930	.	T	C	1	2	3	0	0	3	0	0
23	39635959	.	C	T	3	6	9	0	8	17	0	0
23	39636079	.	G	T	8	5	13	0	1	14	0	0
23	39636181	.	C	T	6	7	13	0	2	15	0	0
23	39638480	.	A	G	1	5	6	0	0	6	0	0
23	39737744	.	G	A	0	2	2	0	1	3	0	0
23	39744501	.	A	G	6	8	14	0	1	15	0	0
23	39744788	.	T	A	16	0	16	0	0	16	0	0
23	39744943	.	A	T	16	13	29	0	6	35	0	0
23	39756650	.	G	A	4	4	8	0	1	9	0	0
23	39756666	.	A	G	4	6	10	0	2	12	0	0
23	39756775	.	T	G	15	7	22	0	0	22	0	0
23	39756864	.	T	C	18	10	28	2	2	32	0	0
23	39756893	.	T	A	14	9	23	2	0	25	0	0
23	39756917	.	C	A	14	10	24	2	1	27	0	0
23	39756958	.	A	G	9	13	22	0	2	24	0	0
23	39757017	.	A	G	9	6	15	0	0	15	0	0
23	39757349	.	T	C	6	5	11	0	1	12	0	0
23	39757357	.	T	C	5	5	10	0	0	10	0	0
23	39758527	.	C	A	4	5	9	0	0	9	0	0
23	39758587	.	G	A	2	3	5	0	0	5	0	0
23	39759290	.	A	C	2	5	7	0	0	7	0	0
23	39759344	.	A	C	3	0	3	0	7	10	0	0
23	39759355	.	T	C	5	0	5	0	4	9	0	0
23	39759400	.	T	C	2	0	2	0	11	13	0	0
23	39764804	.	G	A	5	8	13	0	0	13	0	0
23	39764906	.	C	T	8	5	13	0	1	14	0	0
23	39765105	.	G	A	5	7	12	0	1	13	0	0
23	39767894	.	A	G	3	11	14	0	2	16	0	0
23	39768001	.	T	G	5	4	9	1	0	10	0	0
23	39771935	.	C	T	2	4	6	0	0	6	0	0
23	39771972	.	A	T	4	4	8	0	0	8	0	0
23	39772002	.	C	T	5	3	8	0	0	8	0	0
23	39808332	.	G	A	19	12	31	0	0	32	1	0
23	39808337	.	G	C	19	14	33	0	0	33	0	0
23	39808439	.	A	G	28	14	42	0	1	43	0	0
23	39808644	.	A	C	23	15	38	0	0	38	0	0
23	39808705	.	A	G	11	16	27	0	1	28	0	0
23	39808818	.	T	G	14	8	22	6	2	30	0	0
23	39808824	.	G	A	15	1	16	0	1	17	0	0
23	39809437	.	A	G	14	11	25	0	2	27	0	0
23	39809454	.	T	G	15	8	23	0	1	24	0	0
23	39809876	.	C	T	1	6	7	4	19	30	0	0
23	39810685	.	A	G	10	14	24	1	0	25	0	0
23	39810696	.	C	G	9	14	23	0	2	25	0	0
23	39811187	.	C	T	1	3	4	0	15	19	0	0
23	39811191	.	C	A	13	5	18	0	1	19	0	0
23	39811242	.	T	C	12	10	22	0	1	23	0	0
23	39811324	.	A	G	10	5	15	0	0	15	0	0
23	39811401	.	T	C	7	7	14	0	0	14	0	0
23	39811548	.	A	G	5	5	10	1	0	11	0	0
23	39811587	.	G	A	4	3	7	0	0	7	0	0
23	39811612	.	T	C	3	8	11	0	0	11	0	0
23	39811647	.	C	G	3	7	10	0	1	11	0	0
23	39811741	.	G	A	3	9	12	0	1	13	0	0
23	39811956	.	T	A	9	6	15	0	0	15	0	0
23	39812003	.	A	G	5	12	17	0	0	17	0	0
23	39812131	.	T	C	6	15	21	0	1	22	0	0
23	39812142	.	C	G	5	17	22	0	0	22	0	0
23	39812482	.	G	A	3	5	8	0	0	8	0	0
23	39812535	.	T	C	8	4	12	0	1	13	0	0
23	39812608	.	C	T	1	8	9	0	12	21	0	0
23	39812633	.	A	T	11	10	21	0	0	21	0	0
23	39812643	.	C	T	1	11	12	0	10	22	0	0
23	39919571	.	T	C	3	2	5	0	0	5	0	0
23	39924005	.	G	C	4	2	6	0	0	6	0	0
23	39940362	.	A	G	1	3	4	0	0	4	0	0
23	39940371	.	T	C	1	4	5	0	1	6	0	0
23	39940421	.	G	T	1	3	4	0	0	4	0	0
23	39940504	.	T	G	1	2	3	0	0	3	0	0
23	39940519	.	G	T	1	1	2	0	0	2	0	0
23	39940575	.	G	C	1	2	3	0	0	3	0	0
23	39940577	.	G	A	1	2	3	0	0	3	0	0
23	39940783	.	T	C	5	2	7	0	2	9	0	0
23	40285717	.	A	G	4	4	8	0	1	9	0	0
23	40285727	.	A	G	6	3	9	0	0	9	0	0
23	40285775	.	T	A	1	7	8	0	1	9	0	0
23	40285845	.	A	T	1	5	6	0	0	6	0	0
23	40526760	.	G	A	4	5	9	0	1	10	0	0
23	40527632	.	G	A	5	6	11	10	0	21	0	0
23	40527809	.	T	C	5	3	8	1	1	10	0	0
23	41930998	.	C	A	1	2	3	1	0	4	0	0
23	42272677	.	C	T	2	3	5	0	1	6	0	0
23	42275411	.	A	T	1	3	4	0	0	4	0	0
23	42289260	.	C	A	8	3	11	0	2	13	0	0
23	42328097	.	G	T	0	2	2	0	2	4	0	0
23	42328105	.	C	T	2	2	4	0	0	4	0	0
23	42330063	.	C	T	4	4	8	0	0	8	0	0
23	42330090	.	C	G	3	2	5	0	1	6	0	0
23	42330148	.	A	G	3	0	3	0	2	5	0	0
23	42330150	.	A	G	3	2	5	0	0	5	0	0
23	42330213	.	A	T	7	3	10	0	0	10	0	0
23	42330254	.	A	G	4	4	8	0	0	8	0	0
23	42330268	.	T	G	3	4	7	0	0	7	0	0
23	42330330	.	T	A	6	2	8	0	0	8	0	0
23	42330334	.	G	T	6	2	8	0	0	8	0	0
23	42340161	.	G	A	0	2	2	0	1	3	0	0
23	42640138	.	T	G	5	6	11	0	1	12	0	0
23	42640282	.	C	T	4	2	6	3	0	9	0	0
23	42641879	.	T	C	5	4	9	0	0	9	0	0
23	42641921	.	T	C	8	3	11	1	0	12	0	0
23	42642044	.	G	A	10	3	13	0	0	13	0	0
23	42642253	.	C	T	9	7	16	0	2	18	0	0
23	42642361	.	G	A	13	5	18	0	3	21	0	0
23	42642593	.	T	G	8	7	15	0	0	15	0	0
23	42642623	.	C	A	7	5	12	0	0	12	0	0
23	42642629	.	T	G	4	4	8	0	2	10	0	0
23	42642672	.	T	C	5	5	10	0	1	11	0	0
23	42642673	.	G	A	6	5	11	0	0	11	0	0
23	42642780	.	G	T	2	6	8	0	1	9	0	0
23	42767453	.	C	T	0	2	2	0	3	5	0	0
23	43513159	.	T	G	4	0	4	0	4	8	0	0
23	43643265	.	T	C	1	1	2	0	1	3	0	0
23	43649431	.	T	C	2	2	4	0	0	4	0	0
23	43652261	.	A	G	4	2	6	0	0	6	0	0
23	43652819	.	T	C	5	2	7	0	0	7	0	0
23	43652912	.	G	T	1	2	3	1	2	6	0	0
23	43689621	.	C	G	2	0	2	0	5	7	0	0
23	43690506	.	C	A	5	3	8	0	0	8	0	0
23	43690629	.	C	G	5	1	6	0	4	10	0	0
23	43690715	.	T	C	7	8	15	0	1	16	0	0
23	43690762	.	C	A	5	5	10	0	0	10	0	0
23	43690808	.	A	T	1	2	3	0	0	3	0	0
23	43690913	.	T	G	1	2	3	0	0	3	0	0
23	43691045	.	T	C	3	2	5	0	0	5	0	0
23	43691069	.	G	A	2	3	5	0	0	5	0	0
23	43691117	.	T	G	3	3	6	0	0	6	0	0
23	43691750	.	T	C	1	3	4	0	0	4	0	0
23	43691770	.	T	C	2	3	5	0	0	5	0	0
23	43691915	.	A	G	1	1	2	0	1	3	0	0
23	43691992	.	T	C	5	2	7	0	0	7	0	0
23	43695927	.	C	A	1	10	11	0	8	19	0	0
23	43696095	.	G	A	19	20	39	0	0	39	0	0
23	43696211	.	G	T	16	25	41	0	1	42	0	0
23	43696355	.	G	A	28	8	36	0	1	37	0	0
23	43699846	.	A	G	16	18	34	0	4	38	0	0
23	43700064	.	T	C	16	0	16	0	13	29	0	0
23	43700114	.	G	A	9	10	19	0	1	20	0	0
23	43700121	.	G	A	8	12	20	0	2	22	0	0
23	43705961	.	G	T	19	22	41	0	0	41	0	0
23	43706003	.	A	G	13	26	39	0	0	39	0	0
23	43706102	.	T	G	13	16	29	0	0	29	0	0
23	43713602	.	A	G	4	9	13	0	0	13	0	0
23	43713692	.	T	A	2	7	9	0	0	9	0	0
23	43718169	.	T	A	2	3	5	0	1	6	0	0
23	43718185	.	T	A	4	4	8	0	0	8	0	0
23	43718225	.	G	A	1	2	3	0	2	5	0	0
23	43723615	.	G	A	18	7	25	0	1	26	0	0
23	43723633	.	C	T	18	8	26	0	0	26	0	0
23	43723765	.	C	T	3	5	8	0	1	9	0	0
23	43770210	.	C	T	4	3	7	0	0	7	0	0
23	43770279	.	A	T	3	3	6	0	0	6	0	0
23	43770319	.	T	G	3	0	3	0	3	6	0	0
23	43770433	.	T	C	4	2	6	0	0	6	0	0
23	43770467	.	T	C	3	5	8	0	1	9	0	0
23	43770583	.	C	A	5	7	12	0	0	12	0	0
23	43770634	.	G	C	5	2	7	0	0	7	0	0
23	43770832	.	T	C	7	3	10	0	0	10	0	0
23	43778396	.	T	G	6	6	12	0	2	14	0	0
23	43780214	.	C	T	10	7	17	0	0	17	0	0
23	43781781	.	C	T	5	4	9	0	1	10	0	0
23	43784587	.	T	C	11	4	15	0	0	15	0	0
23	43784985	.	C	T	8	9	17	0	5	22	0	0
23	43800621	.	G	C	0	3	3	0	1	4	0	0
23	43800684	.	G	A	0	4	4	0	7	11	0	0
23	43800701	.	T	C	7	3	10	0	0	10	0	0
23	43800723	.	G	A	0	4	4	0	4	8	0	0
23	43800747	.	A	C	2	2	4	0	1	5	0	0
23	43800983	.	G	A	2	2	4	0	0	4	0	0
23	43801018	.	A	G	2	0	2	0	2	4	0	0
23	43801284	.	C	G	3	3	6	0	0	6	0	0
23	43801536	.	A	G	1	0	1	0	3	4	0	0
23	43801687	.	C	T	1	5	6	0	0	6	0	0
23	43802158	.	A	T	3	3	6	0	0	6	0	0
23	43830185	.	T	C	4	3	7	0	0	7	0	0
23	43830408	.	C	T	3	2	5	0	1	6	0	0
23	43830412	.	T	C	4	2	6	0	0	6	0	0
23	43889641	.	T	C	2	2	4	0	0	4	0	0
23	43898075	.	C	T	3	3	6	0	0	6	0	0
23	43898097	.	A	C	3	3	6	0	0	6	0	0
23	44521330	.	A	G	9	6	15	0	0	15	0	0
23	45244364	.	C	T	3	2	5	0	0	5	0	0
23	45244386	.	T	C	3	1	4	0	0	4	0	0
23	45254318	.	T	C	3	2	5	0	0	5	0	0
23	45254321	.	T	C	3	2	5	0	0	5	0	0
23	45287609	.	C	A	1	3	4	0	0	4	0	0
23	45295434	.	G	A	1	3	4	0	3	7	0	0
23	45423068	.	C	T	1	4	5	0	5	10	0	0
23	45423167	.	T	C	2	3	5	0	1	6	0	0
23	45423268	.	A	G	4	2	6	0	0	6	0	0
23	45424249	.	A	C	1	2	3	0	0	3	0	0
23	45425030	.	A	C	1	3	4	0	0	4	0	0
23	45434314	.	A	G	1	2	3	0	0	3	0	0
23	45515555	.	C	G	3	3	6	0	1	7	0	0
23	45515570	.	C	G	2	0	2	0	4	6	0	0
23	45516336	.	C	T	3	5	8	0	1	9	0	0
23	45516804	.	T	A	5	4	9	0	0	9	0	0
23	45516867	.	C	G	6	3	9	0	1	10	0	0
23	45521246	.	G	C	11	7	18	0	0	18	0	0
23	45521285	.	G	C	10	6	16	0	0	16	0	0
23	45521293	.	C	A	9	5	14	0	0	14	0	0
23	45521328	.	G	A	2	3	5	0	0	5	0	0
23	45521331	.	A	T	2	3	5	0	0	5	0	0
23	45521385	.	T	G	5	4	9	0	0	9	0	0
23	45521492	.	G	A	13	4	17	0	0	17	0	0
23	45521622	.	C	T	8	3	11	0	1	12	0	0
23	45521775	.	C	T	8	4	12	0	0	12	0	0
23	45521811	.	A	G	10	9	19	0	0	19	0	0
23	45521816	.	T	A	9	8	17	0	1	18	0	0
23	45521853	.	G	A	11	10	21	0	1	22	0	0
23	45521857	.	G	A	10	11	21	0	1	22	0	0
23	45521942	.	A	G	11	13	24	0	0	24	0	0
23	45522046	.	G	A	8	11	19	0	3	22	0	0
23	45522166	.	T	G	7	11	18	0	1	19	0	0
23	45522170	.	T	G	7	11	18	0	1	19	0	0
23	45522238	.	A	G	9	20	29	0	1	30	0	0
23	45522434	.	G	A	7	14	21	0	2	23	0	0
23	45523409	.	T	C	16	8	24	0	4	28	0	0
23	45523562	.	A	G	12	0	12	1	9	22	0	0
23	45523619	.	C	T	12	4	16	0	4	20	0	0
23	45523669	.	A	T	10	6	16	0	0	16	0	0
23	45547600	.	A	C	5	9	14	0	0	14	0	0
23	45547807	.	A	G	8	0	8	0	12	20	0	0
23	45547902	.	C	T	4	4	8	0	0	8	0	0
23	45548034	.	G	C	0	3	3	0	1	4	0	0
23	45548140	.	G	A	5	5	10	0	1	11	0	0
23	45548355	.	A	G	4	2	6	0	0	6	0	0
23	45548641	.	A	C	5	3	8	0	0	8	0	0
23	45579547	.	A	G	22	13	35	0	0	35	0	0
23	45579629	.	A	C	28	16	44	0	0	44	0	0
23	45580052	.	C	T	16	16	32	0	3	35	0	0
23	45580442	.	C	T	23	29	52	0	0	52	0	0
23	45580508	.	C	T	35	26	61	0	5	66	0	0
23	45580562	.	C	T	33	34	67	0	3	70	0	0
23	45581181	.	C	T	24	23	47	0	2	49	0	0
23	45586744	.	C	A	3	2	5	0	0	5	0	0
23	45586979	.	G	A	2	2	4	0	2	6	0	0
23	45587030	.	G	C	1	2	3	0	0	3	0	0
23	45591606	.	A	G	2	0	2	0	2	4	0	0
23	45591639	.	A	G	4	4	8	0	0	8	0	0
23	45595151	.	C	T	6	5	11	0	0	11	0	0
23	45595178	.	C	T	5	6	11	0	0	11	0	0
23	45596217	.	C	T	5	2	7	0	2	9	0	0
23	45600575	.	A	G	2	4	6	0	0	6	0	0
23	45600773	.	G	C	1	5	6	0	5	11	0	0
23	46208578	.	T	G	17	21	38	0	0	38	0	0
23	46208611	.	T	G	17	21	38	0	1	39	0	0
23	46208718	.	G	A	25	18	43	0	1	44	0	0
23	46217045	.	C	A	17	18	35	0	2	37	0	0
24	20740	.	C	G	2	0	2	0	2	4	0	0
24	24470	.	T	C	2	3	5	0	0	5	0	0
24	24473	.	C	T	1	3	4	0	1	5	0	0
24	24765	.	A	T	1	2	3	0	0	3	0	0
24	26103	.	C	T	2	3	5	0	0	5	0	0
24	33562	.	C	G	1	2	3	0	0	4	1	0
24	44306	.	C	T	8	5	13	0	0	13	0	0
24	86768	.	T	C	1	3	4	0	0	4	0	0
24	166969	.	T	G	3	5	8	0	0	8	0	0
24	167149	.	A	T	10	5	15	0	0	15	0	0
24	167177	.	A	G	9	6	15	0	1	16	0	0
24	174353	.	A	G	5	0	5	0	11	16	0	0
24	178693	.	G	A	4	16	20	0	0	20	0	0
24	184800	.	A	G	14	1	15	0	20	35	0	0
24	184818	.	C	T	12	20	32	0	1	33	0	0
24	187371	.	T	A	5	18	23	0	4	27	0	0
24	187414	.	T	A	4	15	19	0	0	19	0	0
24	187497	.	G	T	6	8	14	0	0	14	0	0
24	187516	.	T	C	7	6	13	0	4	17	0	0
24	187686	.	T	A	11	7	18	2	0	20	0	0
24	187811	.	A	T	7	14	21	0	0	21	0	0
24	187971	.	A	G	7	6	13	0	0	13	0	0
24	188050	.	A	G	4	2	6	0	1	7	0	0
24	188071	.	A	G	3	3	6	0	1	7	0	0
24	188155	.	C	G	9	4	13	0	1	14	0	0
24	188191	.	T	A	11	7	18	0	0	19	1	0
24	188423	.	T	C	12	17	29	0	0	29	0	0
24	188425	.	A	T	12	17	29	0	0	29	0	0
24	188464	.	T	C	13	22	35	0	0	35	0	0
24	196679	.	G	A	10	7	17	1	0	18	0	0
24	197062	.	C	T	3	7	10	0	0	10	0	0
24	197072	.	C	T	0	7	7	0	4	11	0	0
24	788327	.	A	G	2	6	8	0	0	8	0	0
24	788343	.	A	G	5	6	11	0	0	11	0	0
24	945270	.	G	C	1	2	3	0	0	3	0	0
24	945271	.	C	T	1	2	3	0	0	3	0	0
24	945526	.	C	T	0	15	15	0	5	20	0	0
24	945537	.	G	A	4	16	20	0	0	20	0	0
24	947729	.	G	C	12	9	21	0	0	21	0	0
24	948056	.	T	C	9	1	10	0	7	17	0	0
24	948351	.	T	A	14	12	26	0	2	28	0	0
24	948360	.	A	G	14	6	20	0	6	26	0	0
24	948571	.	G	A	9	12	21	0	2	23	0	0
24	948609	.	G	T	8	13	21	0	5	26	0	0
24	948729	.	G	A	11	9	20	0	1	21	0	0
24	948848	.	C	T	0	5	5	0	9	14	0	0
24	948868	.	T	C	7	7	14	0	2	16	0	0
24	948931	.	C	T	0	2	2	0	3	5	0	0
24	975123	.	G	A	1	5	6	0	0	6	0	0
24	977655	.	G	A	4	4	8	0	1	9	0	0
24	984888	.	C	A	4	5	9	0	1	10	0	0
24	985438	.	A	C	15	12	27	0	0	27	0	0
24	985740	.	C	G	9	10	19	0	1	20	0	0
24	985748	.	G	A	9	9	18	0	2	20	0	0
24	988274	.	G	A	3	8	11	0	1	12	0	0
24	988810	.	G	A	4	9	13	0	0	13	0	0
24	992228	.	T	G	4	7	11	0	0	11	0	0
24	1000040	.	A	G	6	6	12	0	1	13	0	0
24	1000112	.	G	A	8	6	14	0	1	15	0	0
24	1003494	.	C	T	0	4	4	0	4	8	0	0
24	1003551	.	C	A	0	6	6	0	7	13	0	0
24	1003596	.	G	A	6	7	13	0	0	13	0	0
24	1010205	.	A	T	1	3	4	0	0	4	0	0
24	1010347	.	G	T	3	4	7	0	1	8	0	0
24	1011786	.	A	G	3	1	4	0	2	6	0	0
24	1011823	.	A	G	4	4	8	0	0	8	0	0
24	1012034	.	A	C	1	3	4	0	0	4	0	0
24	1012511	.	C	T	0	2	2	0	1	3	0	0
24	1015029	.	C	T	2	3	5	0	5	10	0	0
24	1022962	.	G	A	4	3	7	1	0	9	1	0
24	1110150	.	T	C	5	10	15	1	1	17	0	0
24	1110152	.	T	A	7	10	17	1	0	18	0	0
24	1110227	.	G	A	8	6	14	0	0	14	0	0
24	1110325	.	C	A	3	6	9	0	0	9	0	0
24	1111055	.	C	A	5	4	9	0	1	10	0	0
24	1111076	.	G	A	4	6	10	0	0	10	0	0
24	1112087	.	T	G	2	2	4	0	0	4	0	0
24	1112337	.	A	G	2	3	5	0	0	5	0	0
24	1112547	.	C	G	0	2	2	0	3	5	0	0
24	1112950	.	G	T	2	3	5	0	0	5	0	0
24	1112972	.	T	G	2	2	4	0	0	4	0	0
24	1162622	.	T	A	7	13	20	1	0	21	0	0
24	1163061	.	G	A	12	12	24	0	1	25	0	0
24	1163184	.	A	G	13	15	28	0	1	29	0	0
24	1165088	.	G	C	13	11	24	0	0	24	0	0
24	1166957	.	G	A	7	10	17	0	0	17	0	0
24	1166975	.	T	C	8	10	18	0	3	21	0	0
24	1167263	.	G	A	10	9	19	0	1	20	0	0
24	1167338	.	C	T	4	8	12	0	10	22	0	0
24	1167413	.	A	G	7	10	17	0	2	19	0	0
24	1167496	.	G	A	12	8	20	0	3	23	0	0
24	1169291	.	C	T	0	17	17	0	8	26	1	0
24	1177074	.	T	A	10	11	21	1	3	25	0	0
24	1185142	.	G	A	9	6	15	0	1	16	0	0
24	1185225	.	G	T	5	9	14	0	1	15	0	0
24	1185271	.	G	A	6	9	15	0	0	15	0	0
24	1185374	.	G	C	7	7	14	0	1	15	0	0
24	1203471	.	A	T	1	3	4	0	0	4	0	0
24	1221280	.	C	T	0	2	2	0	3	5	0	0
24	1303892	.	A	G	4	4	8	0	1	9	0	0
24	2284197	.	G	C	17	15	32	0	1	33	0	0
24	2284279	.	C	T	1	20	21	0	19	40	0	0
24	2284456	.	A	T	15	11	26	0	5	31	0	0
24	2284458	.	G	A	13	15	28	0	2	30	0	0
24	2284526	.	T	C	22	1	23	0	16	39	0	0
24	2284647	.	C	T	0	10	10	0	18	28	0	0
24	2287254	.	C	G	15	12	27	0	1	28	0	0
24	2289991	.	C	T	1	3	4	0	12	16	0	0
24	2293360	.	G	A	9	5	14	0	0	14	0	0
24	2297093	.	T	A	4	7	11	0	2	13	0	0
24	2297117	.	A	G	2	5	7	0	0	7	0	0
24	2298000	.	A	G	5	5	10	0	0	10	0	0
24	2303778	.	G	A	2	5	7	0	1	8	0	0
24	2333811	.	C	T	2	2	4	0	0	4	0	0
24	2334066	.	G	A	4	3	7	0	0	7	0	0
24	2334069	.	C	G	4	3	7	0	0	7	0	0
24	2336243	.	G	A	1	2	3	0	0	3	0	0
24	2340671	.	A	T	3	2	5	0	0	5	0	0
24	2347002	.	A	G	2	3	5	0	1	6	0	0
24	2524848	.	C	A	30	28	58	0	0	58	0	0
24	2524868	.	C	T	31	24	55	0	8	63	0	0
24	2524903	.	A	T	32	21	53	0	5	58	0	0
24	2558323	.	G	A	2	3	5	0	0	5	0	0
24	2558354	.	G	A	2	4	6	0	0	6	0	0
24	2642517	.	G	A	3	2	5	0	0	5	0	0
24	2684178	.	C	A	2	3	5	0	0	5	0	0
24	2684265	.	T	C	1	2	3	0	0	3	0	0
24	2684417	.	C	T	1	1	2	0	1	3	0	0
24	2762780	.	C	A	4	11	15	0	1	16	0	0
24	2762782	.	G	A	3	11	14	0	3	17	0	0
24	2821435	.	G	A	6	8	14	1	1	16	0	0
24	2821494	.	A	T	0	12	12	0	1	13	0	0
24	2827887	.	C	T	1	4	5	0	0	5	0	0
24	2836405	.	T	C	5	6	11	0	0	11	0	0
24	2836653	.	C	A	1	3	4	0	0	4	0	0
24	2836673	.	A	T	5	2	7	0	1	8	0	0
24	2836708	.	T	G	4	2	6	0	1	7	0	0
24	2836709	.	G	T	4	2	6	0	1	7	0	0
24	2842910	.	A	G	1	2	3	0	0	4	1	0
24	2891081	.	T	C	1	0	1	0	3	4	0	0
24	2891101	.	T	C	1	2	3	0	0	3	0	0
24	2891187	.	T	G	5	1	6	0	3	9	0	0
24	2891188	.	A	T	6	2	8	0	0	8	0	0
24	2891258	.	A	G	2	2	4	0	0	4	0	0
24	2891263	.	T	C	2	2	4	0	0	4	0	0
24	2891366	.	C	T	2	3	5	0	0	5	0	0
24	2891497	.	A	G	2	3	5	0	0	5	0	0
24	2892328	.	A	T	2	2	4	0	0	4	0	0
24	2892435	.	A	G	3	2	5	0	0	5	0	0
24	2892474	.	G	A	1	2	3	0	0	3	0	0
24	2892587	.	C	A	3	5	8	0	0	8	0	0
24	2892688	.	G	T	7	13	20	0	2	22	0	0
24	2892951	.	T	C	6	13	19	0	2	21	0	0
24	2893003	.	A	T	8	6	14	0	1	15	0	0
24	2893056	.	T	G	4	5	9	0	2	11	0	0
24	2893342	.	T	C	5	6	11	0	1	12	0	0
24	2894076	.	G	A	2	6	8	0	0	8	0	0
24	2917174	.	A	T	2	2	4	0	0	4	0	0
24	2961142	.	C	G	4	7	11	0	0	11	0	0
24	2963066	.	C	G	5	2	7	0	0	7	0	0
24	2964809	.	C	T	5	5	10	0	0	10	0	0
24	2966557	.	C	T	5	6	11	0	1	12	0	0
24	2971595	.	T	C	19	10	29	0	1	30	0	0
24	2971684	.	A	G	17	12	29	0	0	29	0	0
24	2971747	.	G	T	16	14	30	0	0	30	0	0
24	2971890	.	A	G	6	9	15	0	3	18	0	0
24	3060871	.	C	T	3	3	6	0	0	6	0	0
24	3061408	.	A	G	6	0	6	0	5	11	0	0
24	3061629	.	G	A	1	3	4	0	0	4	0	0
24	3325645	.	C	G	2	3	5	0	0	5	0	0
24	3326166	.	G	T	1	2	3	0	0	3	0	0
24	3328397	.	C	G	4	2	6	0	1	7	0	0
24	3328473	.	A	T	2	4	6	0	0	6	0	0
24	3328532	.	T	C	3	2	5	0	0	5	0	0
24	3333940	.	G	A	2	4	6	0	0	6	0	0
24	3335963	.	G	A	0	5	5	0	12	17	0	0
24	3336199	.	C	T	7	10	17	0	0	17	0	0
24	3336236	.	G	A	0	4	4	0	8	12	0	0
24	3348012	.	G	T	9	5	14	0	0	14	0	0
24	3348503	.	C	T	0	13	13	0	14	27	0	0
24	3348530	.	C	T	11	12	23	0	0	23	0	0
24	3350081	.	T	C	9	0	9	0	12	21	0	0
24	3350408	.	T	G	5	9	14	0	0	14	0	0
24	3350426	.	T	C	5	5	10	0	1	11	0	0
24	3350639	.	A	G	6	7	13	0	0	13	0	0
24	3374783	.	G	A	5	4	9	0	0	9	0	0
24	3470108	.	T	C	12	8	20	0	0	20	0	0
24	3470169	.	T	C	12	5	17	1	8	26	0	0
24	3470188	.	T	C	14	7	21	1	2	24	0	0
24	3470608	.	T	C	4	3	7	0	0	7	0	0
24	3471342	.	T	C	8	3	11	0	1	12	0	0
24	3471477	.	T	C	2	3	5	0	0	5	0	0
24	3963803	.	G	A	4	4	8	0	1	9	0	0
24	3972295	.	C	T	9	17	26	0	1	27	0	0
24	3983324	.	G	A	15	15	30	0	3	33	0	0
24	3990337	.	G	A	3	16	19	0	22	42	1	0
24	4000242	.	C	T	21	29	50	0	1	51	0	0
24	4000308	.	T	C	19	27	46	0	2	48	0	0
24	4000323	.	C	T	22	16	38	0	3	41	0	0
24	4002905	.	C	G	24	23	47	0	1	48	0	0
24	4002966	.	A	G	23	19	42	0	1	43	0	0
24	4002997	.	C	T	21	25	46	0	1	47	0	0
24	4003172	.	C	T	28	17	45	0	0	45	0	0
24	4003533	.	C	T	36	32	68	0	6	74	0	0
24	4003559	.	G	A	31	38	69	0	6	75	0	0
24	4003693	.	A	C	37	28	65	0	5	70	0	0
24	4003782	.	C	A	39	25	64	0	2	66	0	0
24	4003800	.	T	C	34	23	57	0	4	61	0	0
24	4003842	.	G	A	33	23	56	5	2	63	0	0
24	4003947	.	G	A	3	27	30	0	20	50	0	0
24	4003978	.	G	A	19	22	41	0	9	50	0	0
24	4004284	.	C	A	3	2	5	0	0	5	0	0
24	4004295	.	T	A	1	2	3	0	1	4	0	0
24	4142777	.	C	T	0	7	7	0	4	11	0	0
24	4142856	.	C	T	8	4	12	0	0	12	0	0
24	4142898	.	T	C	5	5	10	0	1	11	0	0
24	4143517	.	T	A	10	5	15	0	0	15	0	0
24	4417793	.	G	A	1	3	4	0	0	4	0	0
24	4448608	.	T	C	3	4	7	0	0	7	0	0
24	4449787	.	G	A	3	3	6	0	1	7	0	0
24	4449939	.	C	A	4	3	7	0	0	7	0	0
24	4450161	.	C	T	1	2	3	0	1	4	0	0
24	4970956	.	T	C	33	22	55	0	2	57	0	0
24	4971126	.	G	T	39	22	61	0	11	72	0	0
24	4972735	.	G	A	16	25	41	0	0	41	0	0
24	4981740	.	G	A	16	19	35	0	2	37	0	0
24	4982070	.	A	T	7	3	10	0	0	10	0	0
24	5213008	.	G	T	3	2	5	0	0	5	0	0
24	5213029	.	C	T	3	2	5	0	0	5	0	0
24	5214786	.	A	C	9	4	13	0	0	13	0	0
24	5314253	.	C	A	1	2	3	0	0	3	0	0
24	5314257	.	A	T	1	2	3	0	0	3	0	0
24	5653468	.	C	T	1	4	5	0	0	5	0	0
24	5851665	.	T	G	6	2	8	0	0	8	0	0
24	5851666	.	T	C	5	2	7	0	1	8	0	0
24	5996942	.	A	T	6	8	14	0	0	14	0	0
24	5996996	.	G	A	8	8	16	0	1	17	0	0
24	6002538	.	C	G	10	0	10	0	10	20	0	0
24	6002628	.	T	C	14	9	23	0	0	23	0	0
24	6008674	.	G	A	7	8	15	0	1	16	0	0
24	6010450	.	C	T	9	5	14	0	0	14	0	0
24	6010690	.	G	A	7	8	15	0	0	15	0	0
24	6010700	.	A	T	8	7	15	0	0	15	0	0
24	6010770	.	C	T	9	8	17	0	2	19	0	0
24	6010801	.	G	A	9	17	26	0	0	26	0	0
24	6010830	.	A	T	5	12	17	0	1	18	0	0
24	6011063	.	G	T	2	2	4	0	0	4	0	0
24	6011271	.	T	G	7	5	12	0	0	12	0	0
24	6011364	.	A	G	2	2	4	0	4	8	0	0
24	6011705	.	A	G	2	8	10	0	0	10	0	0
24	6011729	.	A	G	12	4	16	0	0	16	0	0
24	6012374	.	T	C	14	10	24	0	1	25	0	0
24	6012381	.	T	C	12	12	24	0	1	25	0	0
24	6012499	.	T	A	13	14	27	0	0	27	0	0
24	6012535	.	T	A	12	13	25	0	0	25	0	0
24	6012540	.	A	T	10	13	23	0	2	25	0	0
24	6012662	.	G	A	3	8	11	0	1	12	0	0
24	6016749	.	A	C	11	7	18	0	2	20	0	0
24	6018908	.	C	T	3	4	7	0	0	7	0	0
24	6021001	.	G	A	2	5	7	0	0	7	0	0
24	6021022	.	G	C	2	0	2	0	6	8	0	0
24	6021277	.	T	C	6	0	6	0	11	17	0	0
24	6024355	.	C	T	4	4	8	0	1	9	0	0
24	6024366	.	T	C	4	5	9	0	0	9	0	0
24	6024401	.	A	T	4	6	10	0	0	10	0	0
24	6024411	.	C	A	1	3	4	0	3	7	0	0
24	6134324	.	T	G	35	32	67	0	1	68	0	0
24	6134456	.	C	T	4	44	48	0	24	72	0	0
24	6134881	.	C	T	29	18	47	1	0	48	0	0
24	6134888	.	C	G	1	18	19	1	33	53	0	0
24	6134946	.	A	T	28	21	49	0	0	49	0	0
24	6135002	.	A	G	25	34	59	0	1	60	0	0
24	6135100	.	A	T	26	20	46	0	0	46	0	0
24	6135118	.	A	G	29	19	48	0	4	52	0	0
24	6135375	.	A	C	22	29	51	0	1	52	0	0
24	6135701	.	G	A	22	24	46	0	2	48	0	0
24	6136089	.	T	G	8	1	9	1	2	12	0	0
24	6136243	.	T	G	6	8	14	0	1	15	0	0
24	6136414	.	A	T	21	6	27	0	2	29	0	0
24	6136415	.	A	T	22	5	27	0	2	29	0	0
24	6136714	.	T	A	17	17	34	0	0	34	0	0
24	6137061	.	C	T	1	13	14	0	7	21	0	0
24	6137622	.	C	T	2	24	26	0	27	53	0	0
24	6153202	.	C	T	4	16	20	0	15	35	0	0
24	6153515	.	A	G	21	18	39	0	2	41	0	0
24	6155751	.	T	C	19	0	19	0	16	35	0	0
24	6157154	.	G	A	14	15	29	0	0	29	0	0
24	6157832	.	A	G	19	15	34	0	1	35	0	0
24	6158835	.	C	A	7	8	15	0	0	15	0	0
24	6158868	.	C	T	3	4	7	0	1	8	0	0
24	6339714	.	G	T	5	4	9	0	0	9	0	0
24	6342644	.	T	C	3	2	5	0	0	5	0	0
24	6344909	.	G	A	2	3	5	0	0	5	0	0
24	6361523	.	C	G	3	5	8	0	0	8	0	0
24	6361525	.	A	G	3	5	8	0	0	8	0	0
24	6362079	.	G	C	14	1	15	0	10	25	0	0
24	6362116	.	T	C	18	11	29	3	4	36	0	0
24	6362123	.	A	C	13	17	30	3	0	33	0	0
24	6362609	.	A	T	24	20	44	0	0	44	0	0
24	6362688	.	T	C	17	13	30	0	2	32	0	0
24	6362730	.	T	C	11	7	18	0	3	21	0	0
24	6362791	.	C	A	5	9	14	0	0	14	0	0
24	6362801	.	G	A	4	11	15	0	0	15	0	0
24	6363502	.	G	A	21	18	39	0	2	41	0	0
24	6368235	.	G	A	12	15	27	0	1	28	0	0
24	6395655	.	G	A	6	3	9	0	0	9	0	0
24	6395838	.	G	T	1	2	3	0	0	3	0	0
24	6396137	.	C	G	6	4	10	0	1	11	0	0
24	6396558	.	T	C	5	3	8	0	1	9	0	0
24	6513857	.	A	T	7	9	16	0	0	16	0	0
24	6513996	.	G	A	5	8	13	0	1	14	0	0
24	6514012	.	C	T	3	7	10	0	1	11	0	0
24	6514117	.	T	C	8	7	15	0	0	15	0	0
24	6514263	.	T	G	7	12	19	0	0	19	0	0
24	6514882	.	A	T	10	9	19	0	0	19	0	0
24	6515019	.	C	T	1	12	13	0	10	23	0	0
24	6515245	.	G	A	6	7	13	0	1	14	0	0
24	6515327	.	G	A	10	6	16	0	2	18	0	0
24	6515364	.	A	T	9	13	22	0	0	22	0	0
24	6515499	.	A	G	7	7	14	0	0	14	0	0
24	6515519	.	T	C	6	0	6	0	9	15	0	0
24	6538447	.	T	C	7	0	7	0	8	15	0	0
24	6538504	.	C	T	0	6	6	0	4	10	0	0
24	6543068	.	A	G	1	3	4	0	0	4	0	0
24	6543443	.	G	A	3	3	6	0	2	8	0	0
24	6546364	.	A	C	5	5	10	0	0	10	0	0
24	6546749	.	C	T	0	5	5	0	1	6	0	0
24	6546841	.	G	A	1	2	3	0	0	3	0	0
24	6546909	.	T	C	3	0	3	0	5	8	0	0
24	6547278	.	A	G	1	3	4	0	0	4	0	0
24	6547890	.	C	G	1	2	3	0	0	3	0	0
24	7942790	.	T	C	8	3	11	0	0	11	0	0
24	8861380	.	T	C	1	5	6	0	1	7	0	0
24	8861521	.	G	C	7	4	11	0	0	11	0	0
24	8861555	.	T	C	4	2	6	0	0	6	0	0
24	8904718	.	C	T	2	2	4	0	0	4	0	0
24	8906130	.	A	T	2	4	6	0	0	6	0	0
24	8968808	.	G	A	1	4	5	0	3	8	0	0
24	8979615	.	C	G	5	10	15	0	0	15	0	0
24	8979618	.	G	A	6	12	18	0	1	19	0	0
24	8979708	.	C	T	1	10	11	0	10	21	0	0
24	8979917	.	G	A	14	4	18	0	0	18	0	0
24	8979937	.	G	A	9	4	13	0	0	13	0	0
24	8980122	.	G	A	4	3	7	0	1	8	0	0
24	8988945	.	G	C	3	0	3	0	6	9	0	0
24	8999699	.	T	A	2	6	8	0	0	8	0	0
24	9001888	.	T	C	3	0	3	0	2	5	0	0
24	9270074	.	G	A	1	3	4	0	0	4	0	0
24	9288889	.	G	T	11	12	23	0	4	27	0	0
24	9293831	.	A	G	5	6	11	0	0	11	0	0
24	9299466	.	T	C	2	3	5	0	0	5	0	0
24	9543120	.	A	G	1	0	1	0	2	3	0	0
24	9558527	.	C	T	1	2	3	0	0	3	0	0
24	9572907	.	A	G	2	2	4	0	0	4	0	0
24	9594999	.	T	C	4	3	7	0	1	8	0	0
24	9595831	.	A	T	1	1	2	0	1	3	0	0
24	9596241	.	C	T	5	7	12	0	1	13	0	0
24	9596350	.	G	A	3	4	7	0	0	7	0	0
24	9596366	.	T	A	7	4	11	0	0	11	0	0
24	9676147	.	T	A	9	13	22	0	0	22	0	0
24	9676204	.	C	A	19	9	28	0	1	29	0	0
24	9678514	.	A	T	13	18	31	0	4	35	0	0
24	9683072	.	G	A	10	6	16	0	0	16	0	0
24	9689709	.	G	T	4	6	10	0	0	10	0	0
24	9689758	.	T	C	3	0	3	0	4	7	0	0
24	9707007	.	G	C	2	2	4	0	0	4	0	0
24	9708634	.	T	G	1	0	1	0	2	3	0	0
24	9714294	.	T	C	1	2	3	0	0	3	0	0
24	9723677	.	G	C	3	4	7	0	0	7	0	0
24	9724925	.	A	G	7	5	12	0	1	13	0	0
24	9725084	.	C	G	4	3	7	0	0	7	0	0
24	9729966	.	A	T	2	6	8	0	1	9	0	0
24	9730134	.	G	A	5	5	10	0	1	11	0	0
24	9737068	.	C	T	1	2	3	0	0	3	0	0
24	9746329	.	G	A	0	2	2	0	2	4	0	0
24	9746370	.	T	A	2	3	5	0	0	5	0	0
24	9865836	.	G	A	1	2	3	0	6	9	0	0
24	9866192	.	A	T	5	7	12	0	0	12	0	0
24	9866562	.	A	T	7	3	10	0	0	10	0	0
24	9866623	.	G	T	13	4	17	0	1	18	0	0
24	9866721	.	C	T	7	7	14	0	1	15	0	0
24	9867105	.	T	A	11	9	20	0	0	20	0	0
24	10270447	.	T	C	1	3	4	0	0	4	0	0
24	10270544	.	A	C	1	2	3	0	0	3	0	0
24	10270546	.	C	G	1	2	3	0	0	3	0	0
24	10303168	.	C	T	5	5	10	0	0	10	0	0
24	10309119	.	G	C	0	6	6	0	1	7	0	0
24	10309244	.	G	A	5	3	8	0	0	8	0	0
24	10309382	.	T	C	6	3	9	0	0	9	0	0
24	10309454	.	C	T	4	4	8	0	0	8	0	0
24	10309611	.	G	T	5	2	7	0	0	7	0	0
24	10349671	.	C	T	1	4	5	0	0	5	0	0
24	10349818	.	G	A	3	2	5	0	0	5	0	0
24	10349865	.	T	G	4	6	10	0	0	10	0	0
24	10349898	.	T	C	5	5	10	0	0	10	0	0
24	10350089	.	T	A	2	4	6	0	0	6	0	0
24	10356563	.	G	A	2	2	4	0	0	4	0	0
24	10356592	.	T	C	1	2	3	0	0	3	0	0
24	10376984	.	G	A	1	1	2	0	1	3	0	0
24	10376990	.	T	C	2	2	4	0	0	4	0	0
24	10414439	.	G	T	1	7	8	0	7	15	0	0
24	10415193	.	A	G	7	12	19	0	2	21	0	0
24	10415424	.	A	C	8	12	20	0	1	21	0	0
24	10415487	.	G	A	2	14	16	0	9	25	0	0
24	10415827	.	T	G	2	2	4	0	0	4	0	0
24	10828512	.	A	G	7	5	12	0	1	13	0	0
24	10897340	.	C	A	3	3	6	0	1	7	0	0
24	10901467	.	A	C	7	6	13	0	1	14	0	0
24	10901696	.	C	G	23	33	56	1	1	58	0	0
24	10901759	.	G	T	24	22	46	0	5	51	0	0
24	10901946	.	C	T	15	15	30	0	3	33	0	0
24	10902065	.	T	G	17	9	26	0	6	32	0	0
24	10902192	.	T	A	11	8	19	0	0	19	0	0
24	10902268	.	G	A	12	11	23	0	1	24	0	0
24	10902688	.	G	A	15	26	41	0	4	45	0	0
24	10907000	.	T	C	14	15	29	0	3	32	0	0
24	10907473	.	C	T	20	11	31	0	4	35	0	0
24	10907587	.	G	T	16	14	30	0	0	30	0	0
24	10915813	.	A	G	16	11	27	0	2	29	0	0
24	10917040	.	C	T	8	19	27	0	0	27	0	0
24	10917046	.	C	T	1	16	17	0	9	26	0	0
24	10917238	.	C	T	10	6	16	0	0	16	0	0
24	10919519	.	A	G	4	10	14	0	0	14	0	0
24	10919563	.	G	T	2	9	11	0	0	11	0	0
24	10924880	.	C	T	5	3	8	0	1	9	0	0
24	10924912	.	C	T	7	5	12	0	1	13	0	0
24	10924930	.	T	A	6	4	10	0	0	10	0	0
24	10961510	.	T	C	3	4	7	0	0	7	0	0
24	10971127	.	C	T	2	3	5	0	0	5	0	0
24	11049421	.	G	A	1	5	6	0	1	7	0	0
24	11059944	.	T	A	1	3	4	0	0	4	0	0
24	11083860	.	C	T	1	6	7	0	0	7	0	0
24	11084035	.	G	A	6	5	11	0	1	12	0	0
24	11086465	.	T	A	3	5	8	0	0	8	0	0
24	11086752	.	A	G	8	10	18	0	1	19	0	0
24	11087015	.	G	A	4	6	10	0	0	10	0	0
24	11113110	.	C	T	13	12	25	0	1	26	0	0
24	11113251	.	T	C	9	3	12	7	2	21	0	0
24	11113281	.	T	C	3	6	9	2	3	14	0	0
24	11113286	.	T	C	5	7	12	2	1	15	0	0
24	11113493	.	T	C	8	1	9	0	6	15	0	0
24	11113624	.	C	G	4	3	7	0	1	8	0	0
24	11114040	.	A	C	2	4	6	0	0	6	0	0
24	11114048	.	C	A	3	4	7	0	1	8	0	0
24	11114094	.	T	C	5	3	8	0	1	9	0	0
24	11114236	.	A	T	7	9	16	0	2	18	0	0
24	11114288	.	T	C	5	7	12	0	1	14	1	0
24	11114290	.	A	G	7	7	14	0	0	14	0	0
24	11114356	.	C	T	4	3	7	0	0	7	0	0
24	11114583	.	A	T	14	7	21	0	1	22	0	0
24	11114670	.	C	T	1	5	6	0	6	12	0	0
24	11114688	.	T	G	6	6	12	0	0	12	0	0
24	11114709	.	T	A	8	7	15	0	0	15	0	0
24	11114953	.	A	T	3	2	5	0	1	6	0	0
24	11115048	.	T	A	3	4	7	0	0	7	0	0
24	11115078	.	A	G	5	5	10	0	0	10	0	0
24	11115114	.	G	A	6	5	11	0	0	11	0	0
24	11115269	.	C	A	7	5	12	0	0	12	0	0
24	11115280	.	C	G	7	9	16	0	0	16	0	0
24	11115338	.	A	T	5	6	11	0	1	12	0	0
24	11115339	.	C	T	0	7	7	0	5	12	0	0
24	11115513	.	G	A	3	2	5	0	0	5	0	0
24	11115532	.	G	A	3	5	8	0	0	8	0	0
24	11115719	.	T	A	5	4	9	0	0	9	0	0
24	11115720	.	A	G	5	4	9	0	0	9	0	0
24	11115806	.	A	G	4	3	7	0	0	7	0	0
24	11116025	.	G	C	6	0	6	0	11	17	0	0
24	11116032	.	C	T	5	12	17	0	0	17	0	0
24	11124199	.	C	T	1	2	3	0	1	4	0	0
24	11141253	.	A	C	3	7	10	0	0	10	0	0
24	11141654	.	A	G	6	5	11	0	0	11	0	0
24	11141757	.	T	C	5	6	11	0	0	11	0	0
24	11141849	.	G	A	7	5	12	0	0	12	0	0
24	11145148	.	C	T	1	3	4	0	0	4	0	0
24	11145445	.	G	A	4	6	10	0	0	10	0	0
24	11145460	.	A	G	6	4	10	0	0	10	0	0
24	11388347	.	C	T	1	2	3	0	0	3	0	0
24	11389429	.	G	A	0	4	4	0	3	7	0	0
24	11389711	.	C	T	1	3	4	0	0	4	0	0
24	11389716	.	C	T	0	3	3	0	1	4	0	0
24	11390514	.	G	A	4	2	6	0	0	6	0	0
24	11451535	.	G	A	2	2	4	0	0	4	0	0
24	11451686	.	T	A	3	2	5	0	0	5	0	0
24	11473788	.	T	A	4	4	8	0	1	9	0	0
24	11473857	.	C	A	5	4	9	0	3	12	0	0
24	11473891	.	G	A	6	5	11	0	0	11	0	0
24	11474103	.	C	G	11	12	23	0	1	24	0	0
24	11474110	.	G	A	12	9	21	0	1	22	0	0
24	11474167	.	T	C	11	10	21	0	2	23	0	0
24	11474730	.	A	G	14	4	18	0	1	19	0	0
24	11483833	.	C	T	8	3	11	0	1	12	0	0
24	11487067	.	G	C	9	9	18	0	1	19	0	0
24	11490280	.	A	C	2	3	5	0	0	5	0	0
24	11497201	.	T	A	4	6	10	0	0	10	0	0
24	11528490	.	A	G	2	4	6	0	2	8	0	0
24	11529090	.	C	T	1	2	3	0	0	3	0	0
24	11530137	.	G	T	2	2	4	0	0	4	0	0
24	11530529	.	G	A	4	2	6	0	0	6	0	0
24	11531180	.	T	C	0	2	2	0	1	3	0	0
24	11531184	.	G	A	1	2	3	0	0	3	0	0
24	11531261	.	G	A	2	2	4	0	0	4	0	0
24	11888694	.	G	A	8	4	12	0	2	14	0	0
24	11888788	.	G	A	11	11	22	0	1	23	0	0
24	11888799	.	T	C	8	9	17	0	4	21	0	0
24	11888854	.	T	C	10	15	25	0	2	27	0	0
24	11889100	.	T	C	11	4	15	0	1	16	0	0
24	11889107	.	T	C	7	5	12	0	2	14	0	0
24	11889353	.	C	T	1	3	4	0	0	4	0	0
24	11889879	.	A	T	2	3	5	0	0	5	0	0
24	11893428	.	G	A	1	2	3	0	0	3	0	0
24	11894968	.	C	T	0	3	3	0	3	6	0	0
24	11908852	.	T	C	2	3	5	0	1	6	0	0
24	11918846	.	G	A	12	9	21	0	0	21	0	0
24	11919170	.	A	G	4	4	8	0	0	8	0	0
24	11919202	.	A	T	2	2	4	0	0	4	0	0
24	12133963	.	C	A	5	7	12	0	2	14	0	0
24	12133998	.	A	C	6	2	8	0	0	8	0	0
24	12252675	.	G	T	16	13	29	0	0	29	0	0
24	12253067	.	G	A	13	7	20	0	1	21	0	0
24	12253154	.	T	G	11	5	16	0	1	17	0	0
24	12630352	.	A	G	17	11	28	1	1	30	0	0
24	12634439	.	C	T	10	6	16	0	0	16	0	0
24	12638007	.	C	T	1	7	8	0	8	16	0	0
24	12686316	.	A	T	9	5	14	1	3	18	0	0
24	12743992	.	G	A	4	2	6	0	0	6	0	0
24	12744274	.	A	G	3	3	6	0	0	6	0	0
24	12744535	.	A	G	5	2	7	0	0	7	0	0
24	12744829	.	T	C	3	0	3	0	3	6	0	0
24	12746597	.	A	G	3	4	7	0	1	8	0	0
24	12748468	.	A	G	1	7	8	0	0	8	0	0
24	12749046	.	G	A	8	6	14	0	0	14	0	0
24	12764550	.	A	T	3	3	6	0	1	7	0	0
24	12963161	.	T	A	2	5	7	0	1	8	0	0
24	12966730	.	C	T	21	16	37	0	3	40	0	0
24	12966981	.	G	A	11	10	21	0	0	21	0	0
24	12967041	.	C	T	9	6	15	0	0	15	0	0
24	12967214	.	T	C	9	0	9	0	7	16	0	0
24	12970814	.	A	T	11	7	18	0	0	18	0	0
24	12975210	.	A	G	6	4	10	0	3	13	0	0
24	12977735	.	A	T	1	6	7	0	1	8	0	0
24	12983478	.	A	T	6	8	14	0	1	15	0	0
24	12988745	.	T	G	2	2	4	0	0	4	0	0
24	12988764	.	T	C	3	2	5	0	0	5	0	0
24	13013596	.	T	C	3	2	5	0	1	6	0	0
24	13014280	.	C	T	6	2	8	0	2	10	0	0
24	13014423	.	A	T	4	4	8	0	0	8	0	0
24	13015293	.	A	T	2	2	4	0	0	4	0	0
24	13015572	.	C	T	8	2	10	0	1	11	0	0
24	13015582	.	A	T	9	4	13	0	0	13	0	0
24	13023054	.	C	T	35	10	45	0	0	45	0	0
24	13026060	.	G	A	25	16	41	1	5	47	0	0
24	13026449	.	T	C	31	12	43	0	1	44	0	0
24	13101128	.	A	G	29	22	51	0	4	55	0	0
24	13101143	.	C	A	32	22	54	0	2	56	0	0
24	13101185	.	A	G	36	1	37	0	22	59	0	0
24	13239045	.	A	T	20	6	26	0	2	28	0	0
24	13239124	.	T	A	25	17	42	0	4	47	1	0
24	13239248	.	A	G	18	14	32	0	13	45	0	0
24	13239985	.	G	C	32	11	43	0	1	44	0	0
24	13251801	.	A	C	13	8	21	0	0	21	0	0
24	13252065	.	G	A	9	5	14	0	1	15	0	0
24	13252122	.	A	C	5	0	5	0	4	9	0	0
24	13252448	.	A	G	8	9	17	0	0	17	0	0
24	13255400	.	C	T	9	4	13	0	0	13	0	0
24	13262409	.	G	C	2	0	2	0	3	5	0	0
24	13271628	.	A	G	2	2	4	0	0	4	0	0
24	14014707	.	G	T	1	2	3	0	0	3	0	0
24	14233716	.	C	A	4	2	6	0	0	6	0	0
24	14233798	.	G	C	5	5	10	0	2	12	0	0
24	14233840	.	T	G	5	3	8	0	0	8	0	0
24	14233841	.	G	A	5	3	8	0	0	8	0	0
24	14234355	.	A	G	2	4	6	0	0	6	0	0
24	14234412	.	T	G	2	3	5	0	0	5	0	0
24	14385405	.	G	A	0	2	2	0	2	4	0	0
24	14385999	.	T	C	4	2	6	0	0	6	0	0
24	14386024	.	C	T	4	2	6	0	0	6	0	0
24	14386050	.	C	T	2	3	5	0	0	5	0	0
24	14416018	.	G	C	1	2	3	0	3	6	0	0
24	14420990	.	T	G	2	0	2	0	4	6	0	0
24	14432194	.	T	C	8	8	16	0	1	17	0	0
24	14442409	.	A	T	3	3	6	0	1	7	0	0
24	14442861	.	G	A	2	7	9	0	0	9	0	0
24	14443212	.	G	T	9	6	15	0	1	16	0	0
24	14443291	.	C	T	6	8	14	1	3	18	0	0
24	14443578	.	A	G	13	8	21	0	1	22	0	0
24	14549344	.	T	A	6	3	9	0	1	10	0	0
24	14550545	.	C	T	8	8	16	0	1	17	0	0
24	14550554	.	G	A	7	9	16	0	0	16	0	0
24	14550596	.	T	C	11	9	20	0	0	20	0	0
24	14559391	.	A	G	13	11	24	0	3	27	0	0
24	14559778	.	A	T	38	25	63	0	4	68	1	0
24	14559828	.	T	A	40	26	66	0	8	74	0	0
24	14568300	.	G	T	31	29	60	0	8	68	0	0
24	14575607	.	G	A	24	31	55	0	2	57	0	0
24	14576693	.	A	G	15	17	32	0	3	35	0	0
24	14576782	.	A	G	6	9	15	0	0	15	0	0
24	14713789	.	G	A	1	2	3	0	0	3	0	0
24	14713796	.	T	C	2	3	5	0	1	6	0	0
24	14713927	.	T	C	14	9	23	0	3	26	0	0
24	14718163	.	T	C	26	20	46	0	2	48	0	0
24	14725164	.	A	G	21	18	39	0	0	39	0	0
24	14725417	.	G	A	10	25	35	0	2	37	0	0
24	14725551	.	G	A	10	16	26	0	0	26	0	0
24	15061397	.	T	C	2	3	5	0	0	5	0	0
24	15061434	.	T	C	1	5	6	0	0	6	0	0
24	15061758	.	C	T	1	2	3	0	1	4	0	0
24	15061866	.	G	A	2	5	7	0	1	8	0	0
24	15124785	.	A	T	9	6	15	0	2	17	0	0
24	15124880	.	T	C	6	0	6	0	7	13	0	0
24	15124890	.	A	G	7	6	13	0	1	14	0	0
24	15127487	.	A	T	3	6	9	0	2	11	0	0
24	15127639	.	T	C	7	4	11	0	0	11	0	0
24	15137487	.	T	C	1	0	1	0	3	4	0	0
24	15137524	.	A	G	1	4	5	0	0	5	0	0
24	15278187	.	A	G	3	2	5	0	0	5	0	0
24	15278217	.	C	T	3	2	5	0	1	6	0	0
24	15644587	.	G	C	1	2	3	0	1	4	0	0
24	15645617	.	G	T	7	10	17	1	11	29	0	0
24	15645669	.	G	T	19	11	30	0	0	30	0	0
24	15648504	.	T	C	5	7	12	0	0	12	0	0
24	16111914	.	T	C	5	11	16	0	0	16	0	0
24	16121362	.	G	A	1	10	11	0	7	18	0	0
24	16121462	.	G	A	8	7	15	0	0	15	0	0
24	16147599	.	G	T	1	2	3	0	0	3	0	0
24	16162185	.	T	G	1	6	7	0	0	7	0	0
24	16162344	.	A	T	4	4	8	0	1	9	0	0
24	16162422	.	A	T	3	4	7	0	0	7	0	0
24	16572266	.	G	A	1	3	4	0	0	4	0	0
24	16574732	.	A	G	1	3	4	0	1	5	0	0
24	16693526	.	T	C	10	12	22	0	4	26	0	0
24	16696713	.	G	C	24	26	50	0	3	53	0	0
24	16702886	.	G	T	0	9	9	0	13	22	0	0
24	16705878	.	C	T	21	10	31	1	2	34	0	0
24	16705948	.	C	T	19	21	40	0	0	40	0	0
24	16705949	.	A	G	19	21	40	0	1	41	0	0
24	16706108	.	A	G	14	16	30	0	2	32	0	0
24	16706709	.	A	C	2	3	5	0	0	5	0	0
24	16706834	.	A	G	10	6	16	0	0	16	0	0
24	16852046	.	G	A	1	2	3	0	0	3	0	0
24	16855489	.	G	A	3	2	5	0	0	5	0	0
24	16855491	.	A	C	3	2	5	0	0	5	0	0
24	16855976	.	C	T	0	4	4	0	2	6	0	0
24	16908827	.	G	A	10	16	26	0	0	26	0	0
24	16908908	.	C	T	13	15	28	0	1	29	0	0
24	16909052	.	T	C	13	11	24	0	4	28	0	0
24	16911600	.	A	C	15	22	37	0	4	41	0	0
24	16911898	.	C	T	14	22	36	0	1	37	0	0
24	16912191	.	G	A	24	25	49	0	2	51	0	0
24	16964239	.	A	C	3	3	6	0	0	6	0	0
24	16964353	.	C	A	6	8	14	0	0	14	0	0
24	16964452	.	G	A	7	5	12	0	0	12	0	0
24	16964500	.	C	T	10	3	13	0	0	13	0	0
24	16964753	.	C	T	2	5	7	0	0	7	0	0
24	16964787	.	T	A	0	2	2	0	1	3	0	0
24	16964819	.	T	C	3	4	7	0	0	7	0	0
24	16964839	.	A	C	4	5	9	0	0	9	0	0
24	16964854	.	T	C	4	4	8	0	0	8	0	0
24	16964881	.	G	C	4	2	6	0	1	7	0	0
24	16964889	.	A	G	3	3	6	0	1	7	0	0
24	16964943	.	A	T	8	4	12	0	0	12	0	0
24	16965020	.	C	T	7	4	11	0	0	11	0	0
24	16965032	.	G	A	3	5	8	0	1	9	0	0
24	16965545	.	C	A	2	5	7	0	0	7	0	0
24	16965648	.	C	G	6	4	10	0	0	10	0	0
24	16965729	.	A	C	5	8	13	0	0	13	0	0
24	16965765	.	T	C	7	5	12	0	0	12	0	0
24	16965770	.	T	C	7	7	14	0	1	15	0	0
24	16965900	.	A	C	6	0	6	0	5	11	0	0
24	16965972	.	A	G	6	2	8	0	0	8	0	0
24	16966176	.	G	A	7	6	13	0	0	13	0	0
24	16966185	.	T	C	7	0	7	0	5	12	0	0
24	16966389	.	A	G	3	4	7	0	0	7	0	0
24	16966479	.	T	C	3	3	6	0	0	6	0	0
24	16979653	.	C	A	0	2	2	0	1	3	0	0
24	16985547	.	C	T	12	12	24	0	2	26	0	0
24	16992605	.	G	A	1	13	14	0	21	35	0	0
24	16992915	.	C	T	22	17	39	0	2	41	0	0
24	16998976	.	A	T	34	23	57	0	2	59	0	0
24	17002611	.	C	T	28	30	58	0	3	61	0	0
24	17002666	.	A	T	21	24	45	1	1	47	0	0
24	17007501	.	C	G	3	6	9	0	0	9	0	0
24	17011082	.	C	A	1	3	4	0	0	4	0	0
24	17016658	.	T	C	2	4	6	0	0	6	0	0
24	17017060	.	T	C	4	4	8	0	1	9	0	0
24	17019252	.	A	G	2	0	2	0	7	9	0	0
24	17019483	.	T	G	6	0	6	0	4	10	0	0
24	17019669	.	A	G	9	4	13	0	0	13	0	0
24	17019843	.	A	G	3	0	3	0	5	8	0	0
24	17020128	.	C	T	3	5	8	0	1	9	0	0
24	17021848	.	G	A	28	23	51	0	3	54	0	0
24	17021894	.	T	C	32	0	32	0	22	54	0	0
24	17022028	.	A	G	25	11	36	4	1	41	0	0
24	17022029	.	T	A	22	11	33	4	4	41	0	0
24	17023063	.	G	A	19	16	35	0	2	37	0	0
24	17028690	.	T	A	11	13	24	0	0	24	0	0
24	17040803	.	A	T	4	3	7	0	0	7	0	0
24	17041159	.	G	C	8	4	12	0	1	13	0	0
24	17041208	.	T	G	9	3	12	0	0	12	0	0
24	17041267	.	T	A	7	9	16	0	0	16	0	0
24	17041354	.	A	G	4	7	11	0	0	11	0	0
24	17041968	.	A	G	1	2	3	0	0	3	0	0
24	17041978	.	T	G	1	2	3	0	0	3	0	0
24	17042598	.	C	A	4	3	7	0	1	8	0	0
24	17042763	.	C	T	15	4	19	0	1	20	0	0
24	17049546	.	T	C	1	2	3	0	0	3	0	0
24	17068942	.	C	T	4	3	7	0	1	8	0	0
24	17068949	.	A	G	4	0	4	0	4	8	0	0
24	17069249	.	C	A	1	5	6	0	2	8	0	0
24	17069297	.	A	G	2	2	4	0	0	4	0	0
24	17124124	.	C	T	6	8	14	0	0	14	0	0
24	17124476	.	G	A	2	9	11	0	10	21	0	0
24	17124567	.	T	C	10	14	24	0	3	27	0	0
24	17124591	.	T	A	13	14	27	0	1	28	0	0
24	17126069	.	G	A	16	15	31	0	0	31	0	0
24	17126341	.	C	T	23	17	40	0	2	42	0	0
24	17177262	.	G	A	0	2	2	0	4	6	0	0
24	17189815	.	T	A	6	6	12	0	3	15	0	0
24	17214493	.	A	T	16	10	26	0	0	26	0	0
24	17214746	.	C	T	6	5	11	0	1	12	0	0
24	17215186	.	T	C	12	5	17	0	1	18	0	0
24	17215894	.	A	G	5	3	8	0	2	10	0	0
24	17258426	.	G	A	8	13	21	0	3	24	0	0
24	17258451	.	G	T	14	15	29	0	1	30	0	0
24	17258562	.	T	A	2	1	3	0	0	3	0	0
24	17258572	.	C	A	1	2	3	0	0	3	0	0
24	17258636	.	T	G	1	3	4	0	0	4	0	0
24	17259535	.	G	T	9	5	14	0	2	16	0	0
24	17266382	.	G	A	8	6	14	0	2	16	0	0
24	17266564	.	G	T	4	5	9	0	0	9	0	0
24	17266886	.	T	A	8	11	19	0	2	21	0	0
24	17266909	.	T	A	11	7	18	0	3	21	0	0
24	17276447	.	T	C	2	5	7	0	0	7	0	0
24	17363811	.	T	C	5	3	8	0	2	10	0	0
24	17364010	.	G	A	0	5	5	0	8	13	0	0
24	17364076	.	A	T	6	5	11	0	0	11	0	0
24	17364411	.	A	G	1	3	4	0	0	4	0	0
24	17364985	.	G	A	14	15	29	0	0	29	0	0
24	17365081	.	A	G	16	8	24	0	0	24	0	0
24	17366374	.	G	A	19	13	32	0	2	34	0	0
24	17367882	.	G	A	20	7	27	0	0	27	0	0
24	17368343	.	T	A	17	5	22	0	2	24	0	0
24	17368816	.	G	A	9	7	16	0	1	17	0	0
24	17372074	.	G	A	7	7	14	0	0	14	0	0
24	17374611	.	T	C	10	3	13	0	1	14	0	0
24	17377871	.	G	A	3	7	10	0	1	11	0	0
24	17377874	.	G	A	3	6	9	0	1	10	0	0
24	17378123	.	T	C	3	1	4	0	6	10	0	0
24	17378475	.	A	G	4	3	7	0	1	8	0	0
24	17404219	.	G	A	6	10	16	0	1	17	0	0
24	17409892	.	T	G	7	4	11	0	0	11	0	0
24	17410039	.	G	C	5	2	7	0	1	8	0	0
24	17417535	.	T	G	21	17	38	0	1	39	0	0
24	17417855	.	G	C	13	12	25	0	2	27	0	0
24	17417899	.	G	C	12	9	21	0	0	22	1	0
24	17417947	.	A	G	9	8	17	0	0	17	0	0
24	17418024	.	C	A	12	15	27	0	2	29	0	0
24	17418180	.	G	T	22	5	27	0	0	27	0	0
24	17418752	.	T	A	3	6	9	0	1	10	0	0
24	17419118	.	T	G	5	6	11	0	1	12	0	0
24	17419140	.	A	G	4	3	7	0	1	8	0	0
24	17419185	.	C	T	2	3	5	0	0	5	0	0
24	17419604	.	C	A	6	10	16	1	1	18	0	0
24	17419607	.	A	T	7	10	17	1	1	19	0	0
24	17420388	.	T	G	2	2	4	0	0	4	0	0
24	17420516	.	G	A	10	7	17	0	0	17	0	0
24	17420519	.	T	C	10	0	10	0	7	17	0	0
24	17420761	.	G	T	4	5	9	0	1	10	0	0
24	17420876	.	C	T	4	2	6	0	2	8	0	0
24	17420893	.	G	T	5	3	8	0	0	8	0	0
24	17421216	.	G	T	10	13	23	0	2	25	0	0
24	17421270	.	C	T	2	11	13	0	12	25	0	0
24	17421311	.	G	C	11	7	18	0	1	19	0	0
24	17421338	.	A	T	14	9	23	0	2	25	0	0
24	17421396	.	C	A	11	20	31	0	2	33	0	0
24	17421655	.	G	A	10	15	25	0	2	27	0	0
24	17465715	.	C	T	7	5	12	0	3	15	0	0
24	17465722	.	A	T	8	5	13	0	0	13	0	0
24	17505209	.	G	A	2	2	4	0	0	4	0	0
24	18376840	.	G	A	0	5	5	0	6	11	0	0
24	18376848	.	A	C	5	8	13	0	0	13	0	0
24	18444153	.	G	C	5	3	8	0	0	8	0	0
24	18444267	.	T	C	25	4	29	0	13	42	0	0
24	18444334	.	G	T	43	24	67	0	1	68	0	0
24	18444373	.	C	T	5	2	7	0	0	7	0	0
24	18445784	.	A	G	23	35	58	0	1	59	0	0
24	18446545	.	G	A	24	14	38	0	1	39	0	0
24	18448348	.	G	A	2	2	4	0	0	4	0	0
24	18453298	.	T	C	3	0	3	0	4	7	0	0
24	18461772	.	G	C	1	2	3	0	0	3	0	0
24	18486030	.	A	G	1	2	3	0	0	3	0	0
24	18486345	.	T	C	2	6	8	0	0	8	0	0
24	18486349	.	A	T	0	7	7	0	0	7	0	0
24	18486407	.	C	T	1	2	3	0	0	3	0	0
24	18486705	.	C	T	2	6	8	0	0	8	0	0
24	18521384	.	T	A	3	4	7	0	1	8	0	0
24	18521467	.	C	A	8	7	15	0	1	16	0	0
24	18542551	.	G	A	3	1	4	0	1	5	0	0
24	18549400	.	G	A	6	9	15	0	0	15	0	0
24	18553898	.	C	T	6	5	11	0	2	13	0	0
24	18563695	.	G	A	4	4	8	0	0	8	0	0
24	18563714	.	A	G	3	3	6	0	0	6	0	0
24	18565564	.	A	G	4	4	8	0	1	9	0	0
24	18565591	.	C	T	4	3	7	0	1	8	0	0
24	18598654	.	C	T	1	3	4	0	1	5	0	0
24	18709025	.	C	T	1	4	5	0	0	5	0	0
24	18731867	.	T	C	2	4	6	0	0	6	0	0
24	18731951	.	T	C	3	3	6	0	0	6	0	0
24	18732060	.	C	T	2	2	4	0	0	4	0	0
24	18737472	.	G	T	9	11	20	0	0	20	0	0
24	18737876	.	C	T	9	7	16	0	0	16	0	0
24	18746161	.	C	T	11	13	24	0	0	24	0	0
24	18749985	.	A	G	10	14	24	0	3	27	0	0
24	18750012	.	G	C	14	12	26	0	1	27	0	0
24	18751734	.	T	A	13	2	15	0	2	17	0	0
24	18751740	.	C	T	3	3	6	0	13	19	0	0
24	18751833	.	A	G	8	8	16	0	2	18	0	0
24	18754752	.	G	A	4	3	7	0	0	7	0	0
24	18757399	.	G	A	6	3	9	0	1	10	0	0
24	18783090	.	A	G	4	2	6	0	0	6	0	0
24	18783404	.	C	T	0	3	3	0	3	6	0	0
24	18783638	.	G	A	2	4	6	0	0	6	0	0
24	18784241	.	C	T	2	2	4	0	0	4	0	0
24	18784259	.	C	T	0	2	2	0	1	3	0	0
24	18784288	.	G	A	2	5	7	0	0	7	0	0
24	19115072	.	C	A	0	2	2	0	1	3	0	0
24	19190953	.	G	A	1	6	7	0	3	10	0	0
24	19260876	.	G	A	0	3	3	0	3	6	0	0
24	19342704	.	C	G	5	2	7	0	0	7	0	0
24	19342705	.	A	T	5	2	7	0	0	7	0	0
24	19373816	.	A	T	1	8	9	0	0	9	0	0
24	19402064	.	T	C	3	4	7	0	1	8	0	0
24	19402231	.	G	A	1	5	6	0	8	14	0	0
24	19567821	.	G	C	0	2	2	0	1	3	0	0
24	19692059	.	G	A	0	3	3	0	3	6	0	0
24	19696794	.	C	G	1	2	3	0	0	3	0	0
24	19697048	.	G	A	3	2	5	0	0	5	0	0
24	19697075	.	C	T	1	2	3	0	0	3	0	0
24	19697211	.	G	A	1	4	5	0	0	5	0	0
24	19708085	.	A	G	16	13	29	0	0	29	0	0
24	19708448	.	G	T	8	7	15	0	0	15	0	0
24	19708846	.	T	C	6	7	13	0	1	14	0	0
24	19711576	.	G	T	6	5	11	0	0	11	0	0
24	19719132	.	C	A	0	4	4	0	11	15	0	0
24	20064128	.	C	T	3	5	8	0	0	8	0	0
24	20064130	.	G	T	3	5	8	0	0	8	0	0
24	20064232	.	G	A	9	8	17	0	0	17	0	0
24	20064341	.	C	T	6	4	10	0	1	11	0	0
24	20064368	.	T	C	5	0	5	0	4	9	0	0
24	20064844	.	A	G	11	4	15	0	0	15	0	0
24	20064924	.	A	G	8	5	13	0	1	14	0	0
24	20064988	.	A	C	6	3	9	0	0	9	0	0
24	20065115	.	C	T	0	2	2	0	1	3	0	0
24	20065236	.	T	C	1	5	6	0	1	7	0	0
24	20065366	.	T	G	3	3	6	0	0	6	0	0
24	20065375	.	T	A	3	2	5	0	0	5	0	0
24	20065733	.	T	C	3	4	7	0	0	7	0	0
24	20066002	.	G	T	2	4	6	0	0	6	0	0
24	20066021	.	T	C	1	5	6	0	1	7	0	0
24	20194372	.	T	C	4	2	6	0	0	6	0	0
24	20196172	.	A	G	3	5	8	0	0	8	0	0
24	20197755	.	C	A	4	5	9	0	1	10	0	0
24	20199122	.	A	C	3	2	5	0	0	5	0	0
24	20202041	.	C	T	4	2	6	0	1	7	0	0
24	20208353	.	A	G	1	2	3	0	0	3	0	0
24	20325589	.	G	A	5	3	8	0	0	8	0	0
24	20328349	.	A	G	5	4	9	0	0	9	0	0
24	20328370	.	G	T	0	6	6	0	7	13	0	0
24	20328567	.	G	C	2	8	10	0	0	10	0	0
24	20328609	.	G	A	3	4	7	0	0	7	0	0
24	20328821	.	C	A	3	7	10	0	0	10	0	0
24	20328999	.	T	A	4	9	13	0	0	13	0	0
24	20329493	.	G	A	11	11	22	0	0	22	0	0
24	20329589	.	G	C	10	11	21	0	1	22	0	0
24	20332145	.	A	G	1	3	4	0	1	5	0	0
24	20332187	.	A	T	1	5	6	0	0	6	0	0
24	20336686	.	T	C	3	2	5	0	0	5	0	0
24	20336694	.	A	G	3	2	5	0	0	5	0	0
24	20418167	.	G	A	1	2	3	0	0	3	0	0
24	20418179	.	T	C	1	2	3	0	0	3	0	0
24	20450191	.	A	G	7	14	21	0	1	22	0	0
24	20450424	.	A	T	9	7	16	0	2	18	0	0
24	20450475	.	G	A	3	8	11	0	0	11	0	0
24	20450536	.	C	T	8	5	13	1	1	15	0	0
24	20450672	.	C	G	13	10	23	0	1	24	0	0
24	20450766	.	G	A	13	17	30	0	0	30	0	0
24	20470788	.	A	G	7	5	12	0	3	15	0	0
24	20501116	.	A	G	11	7	18	0	0	18	0	0
24	20536110	.	G	C	6	3	9	0	1	10	0	0
24	20537515	.	A	T	4	2	6	0	0	6	0	0
24	20552578	.	A	C	27	11	38	0	0	38	0	0
24	20554732	.	A	G	19	15	34	0	1	35	0	0
24	20554812	.	T	A	13	14	27	0	0	27	0	0
24	20589592	.	C	T	1	2	3	0	1	4	0	0
24	20600788	.	A	T	1	3	4	0	0	4	0	0
24	20600794	.	G	A	1	3	4	0	0	4	0	0
24	20643825	.	C	A	3	2	5	0	0	5	0	0
24	20644548	.	A	G	23	22	45	0	2	47	0	0
24	20645101	.	T	C	18	16	34	0	2	36	0	0
24	20645273	.	T	C	23	15	38	0	2	40	0	0
24	20645858	.	A	T	16	10	26	0	1	27	0	0
24	20646289	.	T	A	6	11	17	0	1	18	0	0
24	20646694	.	G	A	13	7	20	0	0	20	0	0
24	20648945	.	T	C	11	10	21	0	3	24	0	0
24	20649013	.	T	C	9	15	24	0	0	24	0	0
24	20649039	.	T	G	10	13	23	0	1	24	0	0
24	20708288	.	C	T	1	2	3	0	0	3	0	0
24	20708388	.	A	G	1	3	4	0	0	4	0	0
24	20893161	.	C	T	3	2	5	0	0	5	0	0
24	20893203	.	G	C	3	2	5	1	0	6	0	0
24	20895293	.	T	A	6	2	8	0	0	8	0	0
24	20897011	.	T	A	2	2	4	0	0	4	0	0
24	20897514	.	A	C	1	2	3	0	0	3	0	0
24	20897560	.	T	C	2	2	4	0	0	4	0	0
24	20897561	.	G	T	0	2	2	0	1	4	1	0
24	20898218	.	A	T	1	2	3	0	0	3	0	0
24	20898392	.	A	G	1	4	5	0	0	5	0	0
24	20898402	.	A	G	1	3	4	0	0	4	0	0
24	20898439	.	G	T	2	2	4	0	0	4	0	0
24	20900032	.	G	T	1	2	3	0	0	3	0	0
24	20912070	.	A	T	1	2	3	0	1	4	0	0
24	20912076	.	G	A	1	3	4	0	0	4	0	0
24	20916788	.	A	G	2	2	4	0	0	4	0	0
24	20916841	.	C	A	2	8	10	0	0	10	0	0
24	20916874	.	A	T	2	5	7	0	0	7	0	0
24	20917017	.	T	C	4	4	8	1	1	10	0	0
24	20917029	.	T	C	4	6	10	2	1	13	0	0
24	20917075	.	G	C	7	4	11	1	1	13	0	0
24	20917080	.	T	C	7	2	9	1	1	11	0	0
24	20920648	.	G	C	0	20	20	0	21	41	0	0
24	20920910	.	C	G	10	4	14	8	1	23	0	0
24	20921431	.	C	T	14	4	18	16	0	34	0	0
24	20921530	.	A	G	9	15	24	0	0	24	0	0
24	20921537	.	G	T	11	15	26	0	1	27	0	0
24	20921565	.	C	A	6	14	20	0	0	20	0	0
24	20921594	.	C	T	8	12	20	0	0	20	0	0
24	20921615	.	A	G	7	6	13	0	0	13	0	0
24	20922656	.	G	C	9	0	9	0	2	11	0	0
24	20922660	.	A	G	8	2	10	0	0	10	0	0
24	20922708	.	T	G	3	4	7	0	0	7	0	0
24	20922721	.	G	A	2	5	7	0	0	7	0	0
24	20922783	.	G	A	1	2	3	0	2	5	0	0
24	20924996	.	C	T	6	2	8	0	0	8	0	0
24	20931626	.	G	A	10	9	19	0	1	20	0	0
24	20934223	.	C	T	17	22	39	0	3	42	0	0
24	20934528	.	G	A	12	11	23	0	0	23	0	0
24	20934616	.	T	C	4	7	11	0	0	11	0	0
24	20934619	.	A	T	3	7	10	0	0	10	0	0
24	20934657	.	G	A	1	3	4	0	0	4	0	0
24	20941540	.	G	A	8	9	17	0	0	18	1	0
24	20946263	.	G	A	7	14	21	0	0	21	0	0
24	20948122	.	C	T	13	10	23	0	1	24	0	0
24	20949494	.	A	G	6	7	13	0	0	13	0	0
24	20952215	.	T	A	5	2	7	0	0	7	0	0
24	20952306	.	C	T	0	2	2	0	3	5	0	0
24	20953415	.	C	T	5	8	13	0	0	13	0	0
24	20962342	.	G	A	0	3	3	0	1	4	0	0
24	20962473	.	C	A	0	3	3	0	1	4	0	0
24	20962477	.	G	C	1	3	4	0	0	4	0	0
24	20980141	.	A	G	4	5	9	0	0	9	0	0
24	20987798	.	T	C	2	5	7	0	0	7	0	0
24	20987865	.	A	G	2	2	4	0	0	4	0	0
24	21005908	.	A	T	6	5	11	0	0	11	0	0
24	21006053	.	A	G	12	7	19	0	0	19	0	0
24	21006082	.	G	A	8	6	14	0	0	14	0	0
24	21006188	.	T	G	10	5	15	0	0	15	0	0
24	21060253	.	A	T	4	2	6	0	0	6	0	0
24	21060332	.	A	G	3	2	5	0	0	5	0	0
24	21060365	.	G	A	6	2	8	0	0	8	0	0
24	21154165	.	G	A	15	8	23	0	0	23	0	0
24	21154203	.	C	T	17	16	33	1	1	35	0	0
24	21154421	.	A	T	19	24	43	0	2	45	0	0
24	21154496	.	C	A	4	20	24	0	22	46	0	0
24	21154707	.	A	G	24	25	49	0	4	53	0	0
24	21157712	.	G	A	11	24	35	0	7	42	0	0
24	21159814	.	A	G	15	13	28	0	1	29	0	0
24	21161459	.	C	T	0	11	11	0	12	23	0	0
24	21177180	.	T	C	2	6	8	0	1	9	0	0
24	21182444	.	A	G	4	6	10	0	0	10	0	0
24	21182783	.	C	T	9	15	24	1	3	28	0	0
24	21182834	.	G	A	3	18	21	1	9	31	0	0
24	21182911	.	G	A	1	6	7	0	13	20	0	0
24	21183181	.	C	T	17	7	24	0	1	25	0	0
24	21183228	.	C	G	19	13	32	0	3	35	0	0
24	21183467	.	T	C	6	5	11	0	1	12	0	0
24	21202203	.	A	G	2	5	7	0	0	7	0	0
24	21202225	.	C	T	3	6	9	0	0	9	0	0
24	21206347	.	T	A	3	6	9	0	0	9	0	0
24	21206352	.	G	T	3	7	10	0	0	10	0	0
24	21206401	.	T	C	2	4	6	0	0	6	0	0
24	21206903	.	T	A	5	6	11	0	1	12	0	0
24	21210608	.	T	G	4	4	8	0	0	8	0	0
24	21210704	.	A	G	3	4	7	0	0	7	0	0
24	21212594	.	A	C	1	0	1	0	3	4	0	0
24	21212684	.	G	A	2	2	4	0	0	4	0	0
24	21214898	.	G	A	6	4	10	0	0	10	0	0
24	21226923	.	G	C	1	2	3	0	0	3	0	0
24	21371282	.	A	C	2	3	5	0	0	5	0	0
24	21371801	.	T	G	21	29	50	0	3	53	0	0
24	21371919	.	G	A	13	25	38	1	3	42	0	0
24	21372389	.	T	A	20	22	42	0	0	42	0	0
24	21372417	.	A	G	16	25	41	0	1	42	0	0
24	21392168	.	T	C	24	12	36	0	0	36	0	0
24	21392258	.	T	C	17	7	24	0	0	24	0	0
24	21442815	.	A	G	11	11	22	0	0	22	0	0
24	21447668	.	C	T	0	6	6	0	4	10	0	0
24	21462810	.	A	G	2	2	4	0	0	4	0	0
24	21469067	.	T	G	3	2	5	0	0	5	0	0
24	21502007	.	A	G	5	11	16	0	0	16	0	0
24	21502069	.	G	A	9	20	29	0	0	29	0	0
24	21502133	.	T	C	8	0	8	0	15	23	0	0
24	21502305	.	A	G	7	14	21	0	0	21	0	0
24	21502762	.	T	A	6	5	11	0	0	11	0	0
24	21502817	.	C	A	7	8	15	0	0	15	0	0
24	21502999	.	G	A	2	10	12	1	2	15	0	0
24	21503438	.	G	A	4	3	7	0	0	7	0	0
24	21503748	.	T	C	5	4	9	0	0	9	0	0
24	21503828	.	T	C	2	3	5	0	0	5	0	0
24	21503830	.	T	C	1	4	5	0	0	5	0	0
24	21503985	.	T	G	4	2	6	0	0	6	0	0
24	21504169	.	T	G	3	2	5	0	0	5	0	0
24	21504467	.	A	G	5	3	8	0	0	8	0	0
24	21504725	.	C	T	0	2	2	0	5	7	0	0
24	21504785	.	A	G	5	5	10	0	0	10	0	0
24	21504860	.	G	T	6	2	8	0	1	9	0	0
24	21505895	.	A	G	1	2	3	0	0	3	0	0
24	21538430	.	C	T	13	10	23	0	3	26	0	0
24	21538441	.	T	G	12	0	12	0	10	22	0	0
24	21538568	.	A	C	14	8	22	0	0	22	0	0
24	21538628	.	C	T	6	3	9	0	0	9	0	0
24	21561074	.	C	T	3	7	10	0	0	10	0	0
24	21575273	.	T	A	14	14	28	0	2	30	0	0
24	21575311	.	G	C	13	12	25	1	2	28	0	0
24	21577239	.	G	A	11	10	21	0	1	22	0	0
24	21577488	.	T	C	14	7	21	0	0	21	0	0
24	21577620	.	T	G	7	10	17	0	1	18	0	0
24	21584189	.	G	A	2	4	6	0	1	7	0	0
24	21584323	.	A	T	1	2	3	0	0	3	0	0
24	21584355	.	C	T	2	3	5	0	0	5	0	0
24	21584367	.	C	G	2	2	4	0	0	4	0	0
24	21585802	.	G	A	1	2	3	0	0	3	0	0
24	21585806	.	A	G	1	2	3	0	0	3	0	0
24	21586135	.	T	A	1	4	5	0	0	5	0	0
24	21586190	.	C	G	2	4	6	0	0	6	0	0
24	21600873	.	T	G	6	8	14	0	2	16	0	0
24	21600984	.	C	A	20	12	32	1	1	34	0	0
24	21606035	.	G	A	11	7	18	0	3	21	0	0
24	21606325	.	C	T	1	14	15	1	14	30	0	0
24	21610064	.	G	A	16	10	26	0	1	27	0	0
24	21621730	.	G	T	17	10	27	0	2	29	0	0
24	21646375	.	G	A	6	12	18	0	2	20	0	0
24	21646704	.	G	T	23	23	46	0	2	48	0	0
24	21646847	.	A	C	22	17	39	0	1	40	0	0
24	21650034	.	T	A	23	15	38	0	4	42	0	0
24	21657567	.	C	G	15	12	27	0	3	30	0	0
24	21657606	.	T	C	11	11	22	0	1	23	0	0
24	21657639	.	G	A	12	14	26	0	1	27	0	0
24	21657642	.	G	A	13	13	26	0	1	27	0	0
24	21657738	.	T	C	13	0	13	0	13	26	0	0
24	21659864	.	A	T	15	14	29	0	0	29	0	0
24	21659873	.	A	G	16	11	27	0	1	28	0	0
24	21662298	.	T	G	12	6	18	0	1	19	0	0
24	21671114	.	G	A	18	7	25	0	1	26	0	0
24	21679971	.	G	A	5	7	12	0	0	12	0	0
24	21680010	.	G	A	1	9	10	0	7	17	0	0
24	21680143	.	T	C	7	7	14	0	0	14	0	0
24	21680268	.	A	T	3	3	6	0	1	7	0	0
24	21680331	.	A	T	3	2	5	0	0	5	0	0
24	21680646	.	G	T	4	3	7	0	0	7	0	0
24	21680661	.	T	G	7	3	10	0	0	10	0	0
24	21680747	.	C	G	10	10	20	0	2	22	0	0
24	21681074	.	G	T	5	5	10	0	1	11	0	0
24	21681112	.	T	A	5	3	8	0	2	10	0	0
24	21681162	.	C	T	5	6	11	0	1	12	0	0
24	21744266	.	A	G	8	6	14	0	2	16	0	0
24	21747705	.	T	C	8	5	13	0	0	13	0	0
24	21748175	.	A	G	9	13	22	0	4	26	0	0
24	21748249	.	T	C	16	21	37	0	0	37	0	0
24	21748279	.	C	T	14	20	34	0	0	34	0	0
24	21748374	.	T	C	9	5	14	0	3	17	0	0
24	21781146	.	A	G	5	6	11	0	0	11	0	0
24	21781451	.	T	G	5	6	11	0	0	11	0	0
24	21781452	.	T	A	5	6	11	0	0	11	0	0
24	21865043	.	G	T	1	2	3	0	0	3	0	0
24	21867319	.	T	A	1	6	7	0	0	7	0	0
24	21917502	.	T	C	3	4	7	0	0	7	0	0
24	21917518	.	G	A	3	4	7	0	0	7	0	0
24	21917745	.	T	G	2	6	8	0	0	8	0	0
24	21917777	.	C	A	4	4	8	0	0	8	0	0
24	21917863	.	T	C	5	2	7	0	0	7	0	0
24	21917955	.	G	A	2	4	6	0	0	6	0	0
24	21926974	.	G	A	1	2	3	0	0	3	0	0
24	21927438	.	G	A	4	5	9	0	0	9	0	0
24	21927456	.	C	T	2	8	10	0	0	10	0	0
24	21927506	.	A	G	1	11	12	0	1	13	0	0
24	22122826	.	A	C	12	6	18	2	3	23	0	0
24	22737485	.	G	T	2	2	4	0	0	4	0	0
24	22737486	.	A	C	2	2	4	0	0	4	0	0
24	22740589	.	T	C	6	7	13	0	0	13	0	0
24	22740897	.	A	T	13	11	24	0	0	25	1	0
24	22740949	.	A	G	7	18	25	0	2	27	0	0
24	22740996	.	C	T	13	14	27	0	1	28	0	0
24	22741051	.	G	A	9	8	17	0	2	19	0	0
24	22741088	.	C	T	9	9	18	0	2	20	0	0
24	22741403	.	T	A	11	9	20	0	4	24	0	0
24	22741453	.	C	T	15	13	28	0	1	29	0	0
24	22744502	.	A	G	8	12	20	0	1	21	0	0
24	22746843	.	T	G	11	12	23	0	1	24	0	0
24	22748633	.	C	T	14	8	22	0	2	24	0	0
24	22769225	.	A	T	13	8	21	0	5	26	0	0
24	22769333	.	A	G	7	0	7	0	11	18	0	0
24	22769447	.	G	A	11	8	19	0	0	19	0	0
24	22769484	.	C	T	12	5	17	0	1	18	0	0
24	22769593	.	C	A	9	9	18	0	0	18	0	0
24	22769595	.	T	A	9	8	17	0	0	17	0	0
24	23213419	.	A	C	2	1	3	0	1	4	0	0
24	23214125	.	G	A	1	2	3	0	1	4	0	0
24	23214154	.	G	A	0	2	2	0	2	4	0	0
24	23243257	.	A	G	1	2	3	0	2	5	0	0
24	23248103	.	G	A	5	2	7	0	0	7	0	0
24	23250116	.	T	A	2	2	4	0	0	4	0	0
24	23250140	.	C	T	0	3	3	0	2	5	0	0
24	23691270	.	G	A	1	1	2	0	1	3	0	0
24	23716987	.	T	A	3	4	7	0	0	7	0	0
24	23716991	.	A	G	3	5	8	0	0	8	0	0
24	23717079	.	T	G	9	4	13	0	0	13	0	0
24	23747297	.	G	A	4	2	6	0	2	8	0	0
24	23747302	.	T	C	5	4	9	0	0	9	0	0
24	23759505	.	A	G	6	3	9	0	0	9	0	0
24	23759787	.	T	G	4	5	9	0	1	10	0	0
24	23760291	.	A	G	4	2	6	0	3	9	0	0
24	23766841	.	G	A	4	2	6	0	0	6	0	0
24	23838823	.	C	T	7	2	9	0	0	9	0	0
24	23839024	.	T	C	4	6	10	0	0	10	0	0
24	23839303	.	A	G	1	3	4	0	0	4	0	0
24	23839342	.	T	C	2	3	5	0	1	6	0	0
24	23884522	.	G	A	0	3	3	0	1	4	0	0
24	24020314	.	C	T	10	13	23	0	0	23	0	0
24	24027914	.	T	A	12	6	18	0	1	19	0	0
24	24027939	.	A	G	6	10	16	0	0	16	0	0
24	24028016	.	C	T	10	10	20	0	3	23	0	0
24	24028032	.	G	C	11	12	23	0	0	23	0	0
24	24028059	.	T	A	12	14	26	0	0	26	0	0
24	24038505	.	A	C	1	0	1	0	2	3	0	0
24	24038511	.	C	A	1	2	3	0	0	3	0	0
24	24102091	.	T	C	22	1	23	0	24	47	0	0
24	24110789	.	A	T	24	24	48	0	2	50	0	0
24	24110935	.	C	T	18	20	38	0	1	39	0	0
24	24111470	.	G	A	9	14	23	0	1	24	0	0
24	24114272	.	G	C	10	10	20	0	1	21	0	0
24	24114321	.	C	T	10	10	20	0	0	20	0	0
24	24114417	.	C	T	14	5	19	0	1	20	0	0
24	24114744	.	G	A	2	10	12	0	2	14	0	0
24	24114810	.	A	C	6	6	12	0	2	14	0	0
24	24118213	.	A	C	9	6	15	0	0	15	0	0
24	24118272	.	A	G	5	3	8	0	0	8	0	0
24	24118362	.	C	T	7	3	10	0	0	10	0	0
24	24118366	.	A	T	5	2	7	0	1	8	0	0
24	24119757	.	G	A	3	2	5	0	0	5	0	0
24	24121130	.	C	T	24	23	47	0	4	51	0	0
24	24121282	.	C	G	4	20	24	0	28	52	0	0
24	24121366	.	A	G	27	25	52	1	3	56	0	0
24	24121375	.	G	C	21	1	22	1	28	51	0	0
24	24121502	.	T	A	12	6	18	0	0	18	0	0
24	24121826	.	G	T	27	16	43	0	2	45	0	0
24	24121851	.	A	T	30	22	52	0	4	56	0	0
24	24124517	.	G	A	24	21	45	0	2	47	0	0
24	24127078	.	A	T	23	21	44	0	1	45	0	0
24	24130794	.	A	G	29	24	53	0	6	59	0	0
24	24130824	.	T	C	28	30	58	0	3	61	0	0
24	24135906	.	G	A	25	22	47	0	1	48	0	0
24	24136047	.	T	G	27	13	40	0	2	42	0	0
24	24146669	.	T	C	17	0	17	0	20	37	0	0
24	24155586	.	T	C	9	11	20	0	2	22	0	0
24	24155607	.	G	A	12	10	22	0	0	22	0	0
24	24155655	.	A	G	12	8	20	0	0	20	0	0
24	24155664	.	C	A	14	9	23	0	0	23	0	0
24	24155718	.	A	T	8	6	14	0	1	15	0	0
24	24163114	.	C	T	7	5	12	0	1	13	0	0
24	24164812	.	A	T	18	14	32	0	1	33	0	0
24	24164935	.	A	C	8	16	24	0	2	26	0	0
24	24165131	.	T	C	1	2	3	0	1	4	0	0
24	24168359	.	G	C	31	25	56	0	1	57	0	0
24	24174889	.	T	C	2	3	5	0	0	5	0	0
24	24176993	.	A	G	2	2	4	0	0	4	0	0
24	24177137	.	A	G	1	7	8	0	2	10	0	0
24	24177158	.	T	C	2	6	8	0	1	9	0	0
24	24177288	.	G	A	6	3	9	0	0	9	0	0
24	24177367	.	C	T	3	2	5	0	1	6	0	0
24	24184394	.	T	C	5	1	6	0	3	9	0	0
24	24187454	.	T	G	7	4	11	0	1	12	0	0
24	24189357	.	A	G	2	2	4	0	0	4	0	0
24	24189543	.	T	C	1	3	4	0	0	4	0	0
24	24189561	.	G	A	3	2	5	0	0	5	0	0
24	24273914	.	A	G	1	2	3	0	0	3	0	0
24	24299597	.	T	C	6	4	10	0	1	11	0	0
24	24299991	.	T	G	2	2	4	0	1	5	0	0
24	24300008	.	T	A	2	2	4	0	1	5	0	0
24	24300125	.	C	T	4	6	10	0	1	11	0	0
24	24461710	.	T	A	3	11	14	0	0	14	0	0
24	24462021	.	C	T	9	7	16	0	1	17	0	0
24	24463030	.	T	A	26	6	32	2	3	37	0	0
24	24463060	.	A	G	21	16	37	2	4	43	0	0
24	24701885	.	C	G	12	10	22	0	1	23	0	0
24	24701938	.	T	C	10	8	18	0	0	18	0	0
24	24702119	.	A	C	4	0	4	0	6	10	0	0
24	24702674	.	C	T	7	8	15	0	1	16	0	0
24	24702930	.	C	T	1	5	6	0	5	11	0	0
24	24702936	.	T	C	5	4	9	0	1	10	0	0
24	24720991	.	G	A	3	4	7	0	0	7	0	0
24	24745966	.	T	C	4	0	4	0	5	9	0	0
24	24796567	.	C	G	0	3	3	0	1	4	0	0
24	24796811	.	T	C	2	0	2	0	2	4	0	0
24	24796901	.	T	C	2	3	5	0	0	5	0	0
24	24848118	.	C	T	2	22	24	0	24	48	0	0
24	24931465	.	T	C	5	4	9	0	0	9	0	0
24	24934236	.	A	G	2	1	3	0	1	4	0	0
24	24934347	.	T	C	6	4	10	0	0	10	0	0
24	24935527	.	G	A	8	7	15	0	1	16	0	0
24	24935560	.	A	G	13	0	13	0	6	19	0	0
24	24935791	.	G	C	4	2	6	0	0	6	0	0
24	24935810	.	T	C	7	2	9	0	0	9	0	0
24	24944387	.	A	C	5	6	11	0	3	14	0	0
24	24948089	.	T	A	8	6	14	0	0	14	0	0
24	24948101	.	T	A	6	6	12	0	1	13	0	0
24	24950569	.	T	C	2	4	6	0	0	6	0	0
24	24954478	.	T	C	2	2	4	0	0	4	0	0
24	24989368	.	C	T	1	8	9	0	12	21	0	0
24	24992522	.	G	A	7	7	14	0	0	14	0	0
24	25008884	.	G	A	13	12	25	0	1	26	0	0
24	25008887	.	G	A	12	12	24	0	1	25	0	0
24	25020054	.	T	G	6	6	12	0	0	12	0	0
24	25029860	.	T	A	2	7	9	0	0	9	0	0
24	25032485	.	G	A	1	3	4	0	0	4	0	0
24	25047572	.	C	G	7	0	7	0	3	10	0	0
24	25049209	.	C	T	5	4	9	0	0	9	0	0
24	25049436	.	T	C	4	2	6	0	0	6	0	0
24	25049484	.	T	G	2	3	5	0	0	5	0	0
24	25049658	.	T	C	3	4	7	0	0	7	0	0
24	25052078	.	C	T	7	4	11	0	0	11	0	0
24	25052723	.	T	A	10	6	16	0	2	18	0	0
24	25052774	.	C	T	6	5	11	0	0	11	0	0
24	25053032	.	C	A	10	14	24	0	0	24	0	0
24	25059127	.	C	T	8	8	16	0	0	16	0	0
24	25059129	.	T	C	9	8	17	0	0	17	0	0
24	25069670	.	G	A	4	6	10	0	0	10	0	0
24	25069926	.	A	G	8	0	8	0	8	16	0	0
24	25069928	.	T	A	8	7	15	0	0	15	0	0
24	25070515	.	C	T	3	3	6	0	1	7	0	0
24	25070745	.	G	A	0	5	5	0	2	7	0	0
24	25070921	.	C	T	5	3	8	0	1	9	0	0
24	25070922	.	T	G	5	3	8	0	1	9	0	0
24	25071270	.	T	A	7	7	14	0	3	17	0	0
24	25071474	.	T	C	16	19	35	0	0	35	0	0
24	25071486	.	A	T	20	14	34	0	1	35	0	0
24	25071726	.	G	A	8	7	15	0	0	15	0	0
24	25071742	.	T	C	7	6	13	0	0	13	0	0
24	25072088	.	T	C	11	6	17	0	0	17	0	0
24	25072102	.	T	C	10	11	21	0	0	21	0	0
24	25072311	.	C	T	10	9	19	0	1	20	0	0
24	25072358	.	C	A	8	6	14	0	1	15	0	0
24	25072487	.	A	G	17	13	30	0	1	31	0	0
24	25072511	.	T	G	15	12	27	0	2	29	0	0
24	25072711	.	G	A	17	20	37	0	0	37	0	0
24	25093587	.	A	T	3	3	6	0	0	6	0	0
24	25093601	.	C	G	0	3	3	0	1	4	0	0
24	25094289	.	G	C	2	0	2	0	2	4	0	0
24	25347794	.	G	T	4	4	8	0	2	10	0	0
24	25348354	.	C	T	6	9	15	0	3	18	0	0
24	25350710	.	G	A	1	2	3	0	0	3	0	0
24	25350712	.	G	A	1	2	3	0	0	3	0	0
24	25351091	.	A	G	3	2	5	0	0	5	0	0
24	25351121	.	T	C	3	2	5	0	0	5	0	0
24	25351455	.	T	G	4	3	7	0	0	7	0	0
24	25351911	.	C	T	1	2	3	0	4	7	0	0
24	25351955	.	C	T	2	3	5	0	0	5	0	0
24	25352109	.	G	A	1	1	2	0	1	3	0	0
24	25448155	.	G	A	5	13	18	0	0	18	0	0
24	25448185	.	C	A	1	11	12	0	4	16	0	0
24	25449319	.	G	A	5	5	10	0	0	10	0	0
24	25449340	.	C	T	0	4	4	0	3	7	0	0
24	25452620	.	G	A	3	2	5	0	0	5	0	0
24	25496133	.	T	C	6	4	10	0	1	11	0	0
24	25496194	.	A	C	2	3	5	0	0	5	0	0
24	25496215	.	T	G	1	3	4	0	0	4	0	0
24	25496435	.	T	C	7	5	12	0	0	12	0	0
24	25496590	.	T	C	8	9	17	0	1	18	0	0
24	25496789	.	T	C	8	2	10	0	1	11	0	0
24	25497327	.	T	C	1	6	7	0	0	7	0	0
24	25497353	.	G	A	1	4	5	0	3	8	0	0
24	25497677	.	G	A	10	8	18	0	0	18	0	0
24	25497704	.	A	G	10	3	13	0	1	14	0	0
24	25497800	.	T	G	3	2	5	0	2	8	1	0
24	25497979	.	T	A	3	2	5	0	0	5	0	0
24	25499906	.	A	T	2	2	4	0	0	4	0	0
24	25526192	.	C	A	1	4	5	0	1	6	0	0
24	25693003	.	G	A	17	17	34	0	0	34	0	0
24	25693026	.	C	T	17	18	35	0	5	40	0	0
24	25693948	.	A	G	17	24	41	0	2	43	0	0
24	25693992	.	T	A	23	20	43	0	6	49	0	0
24	25694537	.	A	C	12	22	34	0	5	40	1	0
24	25694858	.	G	A	2	3	5	0	2	7	0	0
24	25761637	.	T	C	2	2	4	0	1	5	0	0
24	25762009	.	A	C	11	2	13	0	0	13	0	0
24	25762272	.	G	A	2	6	8	0	0	8	0	0
24	25762491	.	A	G	5	2	7	0	0	7	0	0
24	25762506	.	C	T	4	3	7	0	0	7	0	0
24	25762600	.	T	C	1	4	5	0	0	5	0	0
24	25762635	.	A	T	5	2	7	0	0	7	0	0
24	25762648	.	C	A	5	1	6	0	0	6	0	0
24	25762884	.	C	T	4	6	10	0	1	11	0	0
24	25762930	.	C	A	3	5	8	0	1	9	0	0
24	25763513	.	A	G	2	2	4	0	0	4	0	0
24	25794522	.	C	A	3	4	7	0	0	7	0	0
24	25794530	.	G	A	1	6	7	0	0	7	0	0
24	25872390	.	C	T	5	6	11	0	1	12	0	0
24	25988246	.	A	C	1	2	3	0	0	3	0	0
24	26025151	.	T	C	1	2	3	0	0	3	0	0
24	26026179	.	A	T	2	5	7	0	0	7	0	0
24	26030340	.	T	G	7	8	15	0	2	17	0	0
24	26030571	.	C	T	10	7	17	0	0	17	0	0
24	26030663	.	T	C	9	7	16	0	0	16	0	0
24	26030827	.	A	C	8	19	27	0	0	27	0	0
24	26030849	.	T	A	9	18	27	0	0	27	0	0
24	26030893	.	G	A	10	10	20	0	3	23	0	0
24	26030985	.	A	T	5	6	11	0	0	11	0	0
24	26045910	.	A	G	1	2	3	0	0	3	0	0
24	26045916	.	T	C	2	2	4	0	0	4	0	0
24	26046618	.	G	A	4	5	9	0	0	9	0	0
24	26049825	.	T	C	4	5	9	0	1	10	0	0
24	26049946	.	A	C	2	6	8	0	0	8	0	0
24	26050066	.	A	T	9	6	15	0	1	16	0	0
24	26052082	.	T	C	4	8	12	0	0	12	0	0
24	26196594	.	A	G	2	2	4	0	1	5	0	0
24	26196647	.	A	G	0	3	3	0	1	4	0	0
24	26196655	.	A	G	2	3	5	0	0	5	0	0
24	26196843	.	G	T	0	2	2	0	1	3	0	0
24	26197291	.	A	G	2	3	5	0	0	5	0	0
24	26197313	.	G	T	3	2	5	0	0	5	0	0
24	26280058	.	G	A	8	6	14	0	0	14	0	0
24	26280163	.	A	G	10	8	18	0	0	18	0	0
24	26280505	.	G	A	2	7	9	0	0	9	0	0
24	26280668	.	A	C	4	2	6	0	1	7	0	0
24	26281672	.	T	A	1	0	1	0	1	2	0	0
24	26281680	.	G	T	2	2	4	0	0	4	0	0
24	26284612	.	G	T	16	5	21	0	0	21	0	0
24	26331279	.	G	A	3	3	6	0	1	7	0	0
24	26331307	.	C	T	3	2	5	0	0	5	0	0
24	26333597	.	C	T	4	5	9	0	0	9	0	0
24	26333801	.	C	T	2	3	5	0	0	5	0	0
24	26334257	.	G	A	4	5	9	0	0	9	0	0
24	26334299	.	A	G	6	0	6	0	3	9	0	0
24	26342519	.	G	C	0	3	3	0	4	7	0	0
24	26373354	.	G	A	1	2	3	0	1	4	0	0
24	26373473	.	G	A	3	11	14	0	0	14	0	0
24	26373498	.	G	A	9	7	16	0	0	16	0	0
24	26376380	.	A	G	6	11	17	0	4	21	0	0
24	26383604	.	T	A	2	3	5	0	0	5	0	0
24	26383670	.	A	G	2	2	4	0	0	4	0	0
24	26383700	.	C	T	0	2	2	0	1	3	0	0
24	26383829	.	C	T	1	4	5	0	3	8	0	0
24	26383840	.	C	T	6	3	9	0	2	11	0	0
24	26383907	.	T	C	3	3	6	0	0	6	0	0
24	26383971	.	A	C	3	1	4	0	1	5	0	0
24	26406895	.	C	A	1	2	3	0	0	3	0	0
24	26406898	.	A	G	1	0	1	0	2	3	0	0
24	26415190	.	T	C	4	6	10	0	0	10	0	0
24	26420141	.	T	C	9	8	17	0	1	18	0	0
24	26429443	.	T	C	12	9	21	0	0	21	0	0
24	26429456	.	C	T	15	8	23	0	1	24	0	0
24	26439492	.	C	T	2	2	4	0	0	4	0	0
24	26475434	.	C	T	16	19	35	0	1	36	0	0
24	26478889	.	C	T	2	14	16	0	27	43	0	0
24	26482337	.	T	C	42	28	70	0	3	73	0	0
24	26492113	.	C	T	1	8	9	0	13	22	0	0
24	26492505	.	G	T	6	15	21	1	1	23	0	0
24	26492905	.	G	T	5	8	13	0	1	14	0	0
24	26493029	.	T	G	4	8	12	0	1	13	0	0
24	26493158	.	A	C	9	0	9	0	5	14	0	0
24	26493542	.	C	A	13	12	25	0	2	27	0	0
24	26494077	.	C	A	6	8	14	0	2	16	0	0
24	26494477	.	C	T	0	7	7	0	7	14	0	0
24	26508886	.	C	T	2	2	4	0	5	9	0	0
24	26511001	.	C	T	3	5	8	0	0	8	0	0
24	26513205	.	T	C	4	4	8	0	0	8	0	0
24	26518811	.	A	G	1	5	6	0	0	6	0	0
24	26527472	.	G	A	2	3	5	0	0	5	0	0
24	26529715	.	G	A	2	3	5	0	0	5	0	0
24	26662895	.	A	G	3	5	8	0	0	8	0	0
24	26663944	.	A	G	3	3	6	0	2	8	0	0
24	26666778	.	G	A	5	4	9	0	0	9	0	0
24	26688607	.	C	T	1	3	4	0	1	5	0	0
24	26901727	.	G	A	1	4	5	0	1	6	0	0
24	26902337	.	T	C	1	2	3	0	0	3	0	0
24	26936794	.	G	A	0	4	4	0	2	6	0	0
24	26941493	.	T	G	11	7	18	0	0	18	0	0
24	26941713	.	C	T	6	13	19	0	1	20	0	0
24	26941996	.	A	G	13	10	23	0	0	23	0	0
24	26942242	.	C	G	10	6	16	0	1	17	0	0
24	26942711	.	T	C	8	8	16	0	1	17	0	0
24	26942880	.	A	T	6	9	15	0	0	15	0	0
24	26942989	.	G	A	7	4	11	0	0	11	0	0
24	26943103	.	C	G	6	5	11	0	1	12	0	0
24	26943148	.	C	T	5	5	10	0	0	10	0	0
24	26945274	.	T	A	8	3	11	0	0	11	0	0
24	26948820	.	G	A	1	3	4	0	0	4	0	0
24	26948823	.	A	C	1	2	3	0	0	3	0	0
24	26948933	.	A	T	7	2	9	0	1	10	0	0
24	26949426	.	A	C	6	9	15	0	0	15	0	0
24	26949555	.	T	G	3	4	7	0	0	7	0	0
24	26959891	.	T	C	3	0	3	0	5	8	0	0
24	26962107	.	G	A	4	5	9	0	0	9	0	0
24	26962277	.	C	T	4	8	12	0	1	13	0	0
24	26967521	.	C	T	1	2	3	0	0	3	0	0
24	26997920	.	G	A	2	4	6	0	0	6	0	0
24	27011189	.	T	A	5	6	11	0	2	13	0	0
24	27168939	.	C	T	3	4	7	0	1	8	0	0
24	27185574	.	A	G	3	3	6	0	1	7	0	0
24	27203410	.	C	T	2	4	6	2	0	8	0	0
24	27207238	.	G	T	2	6	8	0	1	9	0	0
24	27216987	.	G	A	0	5	5	0	4	9	0	0
24	27222574	.	G	A	11	12	23	0	0	23	0	0
24	27222731	.	A	G	10	0	10	0	8	18	0	0
24	27222937	.	G	A	2	11	13	0	12	25	0	0
24	27223018	.	C	T	9	8	17	0	0	17	0	0
24	27224064	.	T	A	24	19	43	0	2	45	0	0
24	27224598	.	G	A	5	8	13	0	1	14	0	0
24	27224863	.	C	A	10	11	21	0	1	22	0	0
24	27225096	.	T	C	10	18	28	0	5	33	0	0
24	27225423	.	C	A	18	10	28	0	1	29	0	0
24	27226044	.	A	G	4	18	22	0	3	25	0	0
24	27226057	.	C	T	8	12	20	0	1	21	0	0
24	27238808	.	C	T	0	12	12	0	8	20	0	0
24	27238826	.	G	A	9	9	18	0	0	18	0	0
24	27244691	.	C	A	1	4	5	0	4	9	0	0
24	27244927	.	T	G	4	2	6	0	2	8	0	0
24	27251249	.	C	T	4	5	9	0	1	10	0	0
24	27399969	.	T	C	3	10	13	0	0	13	0	0
24	28137429	.	G	A	2	5	7	0	0	7	0	0
24	28252608	.	C	T	8	7	15	0	1	16	0	0
24	28252699	.	G	A	11	7	18	0	0	18	0	0
24	28252898	.	C	A	13	11	24	0	1	25	0	0
24	28253740	.	A	T	19	12	31	0	1	32	0	0
24	28253802	.	T	C	19	0	19	1	17	37	0	0
24	28259134	.	T	C	11	12	23	0	0	23	0	0
24	28263856	.	G	C	6	14	20	2	0	22	0	0
24	28263964	.	G	A	9	11	20	0	0	20	0	0
24	28276193	.	C	T	0	4	4	0	2	6	0	0
24	28354675	.	T	G	5	4	9	0	0	9	0	0
24	28365152	.	G	A	3	2	5	0	1	6	0	0
24	28392421	.	T	C	1	3	4	0	0	4	0	0
24	28394482	.	C	T	6	4	10	0	1	11	0	0
24	28426082	.	T	A	14	6	20	0	3	23	0	0
24	28426244	.	G	C	16	7	23	0	3	26	0	0
24	28426597	.	G	A	19	22	41	0	1	42	0	0
24	28432465	.	C	T	19	12	31	0	1	32	0	0
24	28437375	.	A	G	21	18	39	0	2	41	0	0
24	28437562	.	G	C	12	12	24	0	0	24	0	0
24	28557186	.	T	A	1	2	3	0	0	3	0	0
24	28687424	.	C	T	1	8	9	0	16	25	0	0
24	28687576	.	A	G	3	8	11	0	1	12	0	0
24	28688104	.	G	A	7	8	15	0	3	18	0	0
24	28688137	.	G	A	5	10	15	0	0	15	0	0
24	28688416	.	G	A	6	8	14	0	0	14	0	0
24	28691457	.	C	T	0	6	6	0	4	10	0	0
24	28710825	.	A	G	6	3	9	0	0	9	0	0
24	28764251	.	A	C	4	2	6	0	0	6	0	0
24	28936771	.	C	T	10	7	17	0	0	17	0	0
24	28936801	.	A	T	12	8	20	0	3	23	0	0
24	28953040	.	C	A	12	4	16	0	3	19	0	0
24	28960786	.	T	G	16	18	34	0	3	37	0	0
24	28960808	.	A	C	16	17	33	0	5	39	1	0
24	28964652	.	G	A	1	3	4	0	0	4	0	0
24	28964708	.	T	A	1	3	4	0	0	4	0	0
24	28964845	.	T	C	1	2	3	0	0	3	0	0
24	28965738	.	G	T	1	2	3	0	0	3	0	0
24	28966006	.	G	T	3	3	6	0	0	6	0	0
24	28966873	.	C	A	8	7	15	0	0	15	0	0
24	28966892	.	T	C	10	8	18	0	0	18	0	0
24	28967461	.	T	A	2	3	5	0	0	5	0	0
24	28967826	.	T	C	3	5	8	0	0	8	0	0
24	28967982	.	T	C	2	6	8	0	0	8	0	0
24	28968098	.	C	T	3	4	7	0	0	7	0	0
24	28968118	.	T	G	0	0	0	0	4	4	0	0
24	29353048	.	C	T	3	3	6	0	2	8	0	0
24	29353340	.	T	A	4	6	10	0	0	10	0	0
24	29382153	.	T	A	2	5	7	0	1	8	0	0
24	29449847	.	C	T	3	2	5	0	1	6	0	0
24	29450222	.	C	T	10	6	16	0	1	17	0	0
24	29525169	.	T	A	10	12	22	0	9	31	0	0
24	29525262	.	T	C	15	13	28	0	1	29	0	0
24	29965446	.	T	C	3	0	3	0	5	8	0	0
24	30053987	.	C	T	0	4	4	0	2	6	0	0
24	30054404	.	G	A	3	2	5	0	1	6	0	0
24	30054947	.	C	T	2	2	4	0	0	4	0	0
24	30054980	.	T	G	2	4	6	0	1	7	0	0
24	30055046	.	G	A	3	2	5	0	1	6	0	0
24	30350077	.	T	G	2	3	5	0	0	5	0	0
24	30352234	.	C	T	12	7	19	0	0	19	0	0
24	30352276	.	T	C	9	3	12	0	2	14	0	0
24	30352907	.	T	C	16	17	33	0	1	34	0	0
24	30352940	.	T	A	19	10	29	0	0	29	0	0
24	30353036	.	T	A	14	12	26	0	3	29	0	0
24	30353065	.	G	A	18	16	34	0	1	35	0	0
24	30353083	.	G	A	18	16	34	0	3	37	0	0
24	30353298	.	A	G	17	11	28	0	2	30	0	0
24	30353447	.	T	C	12	14	26	0	3	29	0	0
24	30353683	.	A	G	14	7	21	0	1	22	0	0
24	30353825	.	A	G	12	0	12	0	4	16	0	0
24	30353893	.	C	A	15	13	28	0	1	29	0	0
24	30353918	.	C	T	18	13	31	0	0	31	0	0
24	30835934	.	T	C	10	6	16	0	0	16	0	0
24	30835936	.	A	G	9	6	15	0	1	16	0	0
24	30835992	.	G	T	10	5	15	0	3	18	0	0
24	30836132	.	A	G	4	3	7	0	1	8	0	0
24	30837512	.	A	G	6	4	10	0	0	10	0	0
24	30837682	.	G	C	10	6	16	0	0	16	0	0
24	30845845	.	G	A	2	5	7	0	0	7	0	0
24	30845875	.	G	C	4	0	4	0	6	10	0	0
24	30845893	.	C	T	4	4	8	0	0	8	0	0
24	30862080	.	A	T	1	2	3	0	0	3	0	0
24	31082078	.	A	G	7	6	13	0	0	13	0	0
24	31082432	.	G	T	11	9	20	0	1	21	0	0
24	31082758	.	A	T	8	9	17	0	0	17	0	0
24	31082774	.	C	A	5	8	13	0	0	13	0	0
24	31092530	.	T	G	2	7	9	0	0	9	0	0
24	31098655	.	C	A	7	7	14	0	1	15	0	0
24	31170701	.	C	T	1	5	6	0	4	10	0	0
24	31170921	.	A	G	2	4	6	0	0	6	0	0
24	31176087	.	A	G	2	2	4	0	0	4	0	0
24	31223097	.	A	G	1	3	4	0	0	4	0	0
24	31311080	.	A	C	17	11	28	0	1	29	0	0
24	31313234	.	G	A	15	7	22	0	1	23	0	0
24	31319044	.	A	G	6	8	14	0	0	14	0	0
24	31319592	.	C	T	1	3	4	0	7	11	0	0
24	31320049	.	G	A	6	6	12	0	0	12	0	0
24	31323142	.	C	T	9	3	12	0	1	13	0	0
24	31325202	.	T	C	1	3	4	0	1	5	0	0
24	31329983	.	C	G	0	3	3	0	2	5	0	0
24	31334313	.	A	G	11	14	25	0	0	25	0	0
24	31340673	.	T	C	29	23	52	0	2	54	0	0
24	31340819	.	A	T	27	17	44	0	1	45	0	0
24	31342846	.	G	C	2	3	5	0	0	5	0	0
24	31342855	.	G	A	2	3	5	0	0	5	0	0
24	31342883	.	T	A	1	2	3	0	0	3	0	0
24	31346647	.	G	T	21	20	41	0	3	44	0	0
24	31364567	.	G	A	3	5	8	0	0	8	0	0
24	31364622	.	C	T	4	2	6	0	1	7	0	0
24	31367491	.	A	G	3	3	6	0	0	6	0	0
24	31367841	.	C	A	3	4	7	0	0	7	0	0
24	31367851	.	G	A	3	3	6	0	0	6	0	0
24	31367891	.	C	T	6	3	9	0	0	9	0	0
24	31367999	.	A	G	6	4	10	0	0	10	0	0
24	31393945	.	T	C	4	5	9	0	0	9	0	0
24	31393957	.	A	T	4	5	9	0	0	9	0	0
24	31397840	.	G	A	3	8	11	0	0	11	0	0
24	31832549	.	G	A	6	9	15	0	3	18	0	0
24	31832615	.	T	G	7	7	14	0	0	14	0	0
24	31832657	.	G	A	9	7	16	0	0	16	0	0
24	31832761	.	G	A	6	3	9	0	0	9	0	0
24	31832970	.	C	T	4	8	12	0	0	12	0	0
24	31833114	.	A	T	6	13	19	0	0	19	0	0
24	31833991	.	G	A	4	5	9	0	0	9	0	0
24	31834396	.	G	A	6	6	12	0	1	13	0	0
24	31834681	.	A	T	8	2	10	0	1	11	0	0
24	31836483	.	A	T	3	5	8	0	0	8	0	0
24	31838995	.	C	A	2	3	5	0	0	5	0	0
24	31839067	.	G	A	1	3	4	0	0	4	0	0
24	31846257	.	C	T	3	4	7	0	0	7	0	0
24	31846270	.	C	T	3	2	5	0	1	6	0	0
24	31850591	.	G	C	1	2	3	0	0	3	0	0
24	31942105	.	T	G	4	3	7	0	0	7	0	0
24	32152862	.	A	G	3	5	8	0	2	10	0	0
24	32163896	.	C	A	0	2	2	0	2	4	0	0
24	32164054	.	A	G	1	3	4	0	1	5	0	0
24	32176448	.	C	T	14	4	18	0	0	18	0	0
24	32176716	.	G	C	9	17	26	0	0	26	0	0
24	32184363	.	C	T	8	13	21	0	3	24	0	0
24	32184379	.	C	A	17	10	27	0	5	32	0	0
24	32187534	.	G	A	21	18	39	0	2	41	0	0
24	32192622	.	T	C	15	8	23	0	4	27	0	0
24	32406971	.	C	T	5	2	7	0	0	7	0	0
24	32415367	.	C	G	4	2	6	0	0	6	0	0
24	32418818	.	G	A	1	2	3	0	0	3	0	0
24	32472919	.	T	C	2	4	6	0	2	8	0	0
24	32473291	.	C	T	7	9	16	0	1	17	0	0
24	32473326	.	C	G	8	0	8	0	9	17	0	0
24	32473386	.	C	T	15	9	24	0	2	26	0	0
24	32473464	.	T	C	7	9	16	0	2	18	0	0
24	32473597	.	G	A	0	7	7	0	5	12	0	0
24	32473726	.	G	A	6	2	8	0	0	8	0	0
24	32473750	.	G	A	3	4	7	0	1	8	0	0
24	32473829	.	A	G	1	6	7	0	1	8	0	0
24	32474070	.	G	C	3	4	7	0	0	7	0	0
24	32474198	.	T	G	3	4	7	0	0	7	0	0
24	32474229	.	T	A	2	3	5	0	0	5	0	0
24	32474439	.	A	T	3	5	8	0	1	9	0	0
24	32474442	.	A	T	3	6	9	0	2	11	0	0
24	32474546	.	A	C	11	12	23	0	0	23	0	0
24	32517984	.	G	A	6	15	21	1	3	25	0	0
24	32519471	.	G	A	28	27	55	0	1	56	0	0
24	32519528	.	C	T	2	18	20	0	24	44	0	0
24	32522462	.	T	A	22	13	35	0	4	39	0	0
24	32522577	.	A	T	9	7	16	0	0	17	1	0
24	32547959	.	A	T	7	4	11	0	0	11	0	0
24	32650263	.	T	G	4	9	13	0	1	14	0	0
24	32658577	.	C	T	5	9	14	0	1	15	0	0
24	32664790	.	A	T	5	5	10	0	0	10	0	0
24	32664823	.	T	G	1	5	6	0	1	7	0	0
24	32668834	.	G	A	8	4	12	0	1	13	0	0
24	32668880	.	T	A	11	6	17	0	2	19	0	0
24	32674708	.	C	T	12	5	17	0	0	17	0	0
24	32674960	.	T	A	4	3	7	0	1	8	0	0
24	33228611	.	A	G	5	8	13	0	0	13	0	0
24	33228620	.	C	T	3	7	10	0	0	10	0	0
24	33234934	.	T	C	2	0	2	0	5	7	0	0
24	33280061	.	C	T	2	5	7	0	0	7	0	0
24	33284689	.	G	A	3	5	8	0	0	8	0	0
24	33290618	.	T	G	3	4	7	0	0	7	0	0
24	33401158	.	C	T	2	3	5	0	0	5	0	0
24	33402901	.	G	A	1	2	3	0	0	3	0	0
24	33403328	.	G	A	0	1	1	0	2	3	0	0
24	33673670	.	C	T	1	2	3	0	0	3	0	0
24	33684483	.	T	G	1	0	1	0	2	3	0	0
24	33684727	.	C	T	1	4	5	0	0	5	0	0
24	33685278	.	A	T	2	3	5	0	0	5	0	0
24	33687600	.	C	T	3	4	7	0	0	7	0	0
24	33687636	.	C	T	1	2	3	0	0	3	0	0
24	33709247	.	C	G	28	30	58	1	2	61	0	0
24	33714797	.	A	G	14	19	33	0	0	33	0	0
24	33714854	.	G	A	11	19	30	0	3	33	0	0
24	33723289	.	C	A	4	10	14	0	18	32	0	0
24	33755683	.	C	T	17	17	34	0	4	38	0	0
24	33767992	.	T	C	3	5	8	0	1	9	0	0
24	33768346	.	T	A	10	8	18	0	1	19	0	0
24	33768509	.	C	T	3	4	7	0	2	9	0	0
24	33768530	.	G	T	5	5	10	0	0	10	0	0
24	33768705	.	A	G	10	10	20	0	0	20	0	0
24	33774457	.	G	A	1	2	3	0	2	5	0	0
24	33785746	.	G	C	3	6	9	0	2	11	0	0
24	33785898	.	G	A	1	8	9	0	2	11	0	0
24	33788330	.	G	A	1	5	6	0	0	6	0	0
24	33813891	.	G	C	1	3	4	0	0	4	0	0
24	33824554	.	G	A	1	5	6	0	3	9	0	0
24	33832513	.	G	A	5	2	7	3	0	10	0	0
24	33835143	.	T	A	1	3	4	0	0	4	0	0
24	33836490	.	T	A	7	3	10	0	0	10	0	0
24	33836491	.	A	G	3	7	10	0	0	10	0	0
24	33836574	.	A	G	7	3	10	0	0	10	0	0
24	33836581	.	C	T	6	5	11	0	0	11	0	0
24	33837774	.	A	G	10	3	13	1	1	15	0	0
24	33837790	.	A	G	4	7	11	1	0	12	0	0
24	33837916	.	A	G	3	3	6	0	0	6	0	0
24	33837980	.	A	G	2	2	4	0	0	4	0	0
24	33838012	.	A	C	2	2	4	0	0	5	1	0
24	33838293	.	A	G	7	8	15	0	2	17	0	0
24	33838422	.	G	A	0	3	3	0	3	6	0	0
24	33838486	.	G	A	0	6	6	0	5	11	0	0
24	33838533	.	T	G	6	0	6	0	3	9	0	0
24	33838753	.	G	A	5	3	8	0	1	9	0	0
24	33838876	.	A	G	11	0	11	0	13	24	0	0
24	33838954	.	A	C	10	3	13	0	0	13	0	0
24	33839031	.	G	A	15	11	26	0	1	27	0	0
24	33839211	.	T	C	4	2	6	0	1	7	0	0
24	33839221	.	A	C	3	4	7	0	0	7	0	0
24	34115661	.	G	C	1	4	5	0	0	5	0	0
24	34115830	.	G	A	6	9	15	0	0	15	0	0
24	34115850	.	G	A	1	3	4	0	7	11	0	0
24	34116386	.	G	C	3	7	10	0	0	10	0	0
24	34116399	.	C	T	3	5	8	0	0	8	0	0
24	34139278	.	G	A	5	5	10	0	1	11	0	0
24	34139317	.	C	T	5	6	11	0	1	12	0	0
24	34139323	.	T	C	3	0	3	0	7	10	0	0
24	34284596	.	G	T	12	11	23	0	0	23	0	0
24	35196166	.	C	T	14	7	21	0	1	22	0	0
24	35213755	.	T	C	19	6	25	0	1	26	0	0
24	35213764	.	G	A	2	9	11	0	17	28	0	0
24	35216439	.	A	T	14	17	31	0	0	32	1	0
24	35216835	.	A	G	9	15	24	2	3	29	0	0
24	35216973	.	C	T	10	12	22	0	2	24	0	0
24	35217222	.	A	T	20	7	27	0	0	27	0	0
24	35217255	.	G	A	18	7	25	0	0	25	0	0
24	35217258	.	C	G	18	7	25	0	1	26	0	0
24	35217311	.	T	A	17	2	19	0	2	21	0	0
24	35217390	.	C	A	9	0	9	1	12	25	3	0
24	35217426	.	C	T	10	9	19	0	4	23	0	0
24	35218227	.	C	T	3	7	10	0	0	10	0	0
24	35218256	.	C	T	5	2	7	0	1	8	0	0
24	35218817	.	T	A	1	3	4	0	0	4	0	0
24	35218874	.	A	G	1	4	5	0	1	6	0	0
24	35269876	.	T	C	1	2	3	0	0	3	0	0
24	35522379	.	A	T	17	5	22	0	1	24	1	0
24	35522417	.	C	A	11	20	31	0	2	33	0	0
24	35522568	.	C	T	22	19	41	0	4	45	0	0
24	35522962	.	A	G	22	23	45	0	2	47	0	0
24	35523088	.	A	T	26	24	50	1	9	60	0	0
24	35523134	.	T	A	34	17	51	1	3	55	0	0
24	35523385	.	T	C	14	18	32	1	2	35	0	0
24	35523405	.	C	A	22	8	30	1	1	32	0	0
24	35530249	.	T	G	18	21	39	1	0	40	0	0
24	35537156	.	G	A	3	4	7	0	0	7	0	0
24	35544514	.	C	A	2	4	6	0	0	6	0	0
24	35546042	.	G	A	2	2	4	0	0	4	0	0
24	35546660	.	G	A	1	2	3	0	0	3	0	0
24	35565350	.	C	G	16	0	16	0	7	23	0	0
24	35681625	.	G	A	21	15	36	0	7	43	0	0
24	35681753	.	G	A	31	19	50	0	1	51	0	0
24	35683349	.	T	C	20	20	40	0	2	42	0	0
24	35683883	.	A	G	21	14	35	0	1	37	1	0
24	35686180	.	A	G	13	13	26	0	1	27	0	0
24	35692741	.	C	T	0	12	12	0	9	21	0	0
24	35713710	.	T	C	1	3	4	0	0	4	0	0
24	35713835	.	G	A	3	1	4	0	2	6	0	0
24	35720498	.	C	T	1	5	6	0	5	11	0	0
24	35735837	.	C	T	2	1	3	0	2	5	0	0
24	35847510	.	C	T	2	3	5	0	0	5	0	0
24	35899358	.	A	G	3	0	3	0	2	5	0	0
24	35906191	.	G	A	0	8	8	0	6	14	0	0
24	35923708	.	T	C	3	5	8	0	0	8	0	0
24	35925145	.	T	C	3	4	7	0	0	7	0	0
24	35925163	.	C	A	5	3	8	0	0	8	0	0
24	35925499	.	T	C	5	5	10	0	0	10	0	0
24	35925529	.	T	C	3	4	7	0	0	7	0	0
24	35926460	.	C	T	3	6	9	0	0	9	0	0
24	35929814	.	A	C	4	4	8	0	0	8	0	0
24	35930005	.	A	C	7	2	9	0	0	9	0	0
24	35930056	.	T	G	3	6	9	0	0	9	0	0
24	36027212	.	T	C	10	13	23	0	0	23	0	0
24	36166121	.	T	G	4	2	6	0	0	6	0	0
24	36166196	.	A	G	6	3	9	0	0	9	0	0
24	36175205	.	G	A	3	5	8	0	1	9	0	0
24	36175208	.	C	T	4	4	8	0	3	11	0	0
24	36177597	.	A	C	3	10	13	0	0	13	0	0
24	36177609	.	T	C	4	10	14	0	1	15	0	0
24	36177713	.	T	C	8	0	8	0	5	13	0	0
24	36178063	.	C	G	2	4	6	0	0	6	0	0
24	36180824	.	C	T	4	3	7	0	1	8	0	0
24	36182443	.	A	G	3	3	6	0	1	7	0	0
24	36182455	.	G	A	5	4	9	0	0	9	0	0
24	36182503	.	G	C	3	6	9	0	2	11	0	0
24	36186986	.	G	A	3	2	5	0	1	6	0	0
24	36186987	.	T	A	3	2	5	0	1	6	0	0
24	36187933	.	A	T	3	3	6	0	1	7	0	0
24	36187963	.	C	T	4	5	9	0	3	12	0	0
24	36193431	.	C	T	0	2	2	0	2	4	0	0
24	36193557	.	C	A	6	3	9	0	0	9	0	0
24	36193629	.	T	A	6	4	10	0	1	11	0	0
24	36193635	.	A	C	6	4	10	0	0	10	0	0
24	36193803	.	T	C	2	2	4	0	1	5	0	0
24	36194330	.	T	C	1	3	4	0	0	4	0	0
24	36195168	.	A	G	3	3	6	0	0	6	0	0
24	36220106	.	A	T	2	3	5	0	0	5	0	0
24	36223627	.	T	C	4	4	8	0	2	10	0	0
24	36230021	.	A	G	2	2	4	0	0	4	0	0
24	36244407	.	C	T	6	3	9	0	0	9	0	0
24	36247261	.	A	T	4	3	7	0	1	8	0	0
24	36247537	.	C	T	10	5	15	0	0	15	0	0
24	36248705	.	C	T	4	5	9	0	1	10	0	0
24	36249910	.	G	T	6	6	12	0	1	13	0	0
24	36250403	.	T	C	10	6	16	0	1	17	0	0
24	36253324	.	C	T	31	21	52	0	2	54	0	0
24	36261666	.	T	C	4	2	6	0	0	6	0	0
24	36261730	.	C	T	1	4	5	0	6	11	0	0
24	36266484	.	A	G	3	3	6	0	0	6	0	0
24	36271269	.	T	A	4	3	7	0	0	7	0	0
24	36271274	.	T	A	3	4	7	0	0	7	0	0
24	36275987	.	C	T	4	2	6	0	0	6	0	0
24	36276035	.	A	C	3	1	4	0	1	5	0	0
24	36276059	.	G	T	2	2	4	0	2	6	0	0
24	36276087	.	A	G	2	6	8	0	1	9	0	0
24	36276363	.	A	G	6	11	17	0	0	17	0	0
24	36276364	.	G	T	6	11	17	0	0	17	0	0
24	36280272	.	A	G	7	4	11	0	0	11	0	0
24	36280296	.	T	G	9	7	16	0	0	16	0	0
24	36284470	.	G	A	5	6	11	0	0	11	0	0
24	36287396	.	G	T	3	3	6	0	0	6	0	0
24	36295445	.	C	T	0	3	3	0	4	7	0	0
24	36295448	.	C	T	4	3	7	0	0	7	0	0
24	36301035	.	T	G	2	4	6	0	1	8	1	0
24	36325256	.	C	G	3	2	5	0	1	6	0	0
24	36325262	.	C	G	3	5	8	0	0	8	0	0
24	36331180	.	G	C	2	3	5	0	0	5	0	0
24	36331207	.	G	T	4	3	7	0	1	8	0	0
24	36331220	.	G	T	4	4	8	0	0	8	0	0
24	36331247	.	G	A	6	2	8	0	0	8	0	0
24	36334589	.	G	A	3	6	9	0	0	9	0	0
24	36334677	.	T	C	2	6	8	0	0	8	0	0
24	36334724	.	A	G	3	4	7	0	0	7	0	0
24	36334848	.	A	G	5	4	9	0	0	9	0	0
24	36334857	.	G	A	3	3	6	0	2	8	0	0
24	36335024	.	C	G	4	5	9	0	2	11	0	0
24	36335106	.	A	T	7	4	11	0	0	11	0	0
24	36335139	.	T	C	5	0	5	0	6	11	0	0
24	36335196	.	C	G	3	2	5	0	0	5	0	0
24	36335228	.	T	C	4	0	4	0	3	7	0	0
24	36352446	.	G	A	1	2	3	0	2	5	0	0
24	36352450	.	G	A	3	2	5	0	0	5	0	0
24	36357149	.	A	C	3	2	5	0	0	5	0	0
24	36362141	.	T	C	8	5	13	0	0	13	0	0
24	36364417	.	A	T	3	5	8	0	1	9	0	0
24	36364454	.	A	G	6	1	7	0	3	10	0	0
24	37631701	.	G	A	3	2	5	0	0	5	0	0
24	37631702	.	A	C	3	2	5	0	0	5	0	0
24	37634889	.	G	T	1	3	4	0	0	4	0	0
24	37647015	.	A	G	2	2	4	0	0	4	0	0
24	37650107	.	C	T	2	2	4	0	0	4	0	0
24	37650143	.	A	G	2	0	2	0	3	5	0	0
24	37650146	.	T	C	2	2	4	0	1	5	0	0
24	37657767	.	G	A	0	3	3	0	1	4	0	0
24	37657773	.	G	A	0	4	4	0	2	6	0	0
24	37657884	.	T	C	3	2	5	0	0	5	0	0
24	37661443	.	T	A	1	3	4	0	0	4	0	0
24	37664505	.	G	A	3	3	6	0	0	6	0	0
24	37664506	.	T	C	4	3	7	0	0	7	0	0
24	37681556	.	G	T	5	2	7	0	0	7	0	0
24	37685925	.	C	T	2	7	9	0	0	9	0	0
24	37689919	.	T	C	35	27	62	0	1	63	0	0
24	37692529	.	G	A	29	31	60	0	2	62	0	0
24	37695870	.	C	T	1	2	3	0	3	6	0	0
24	37696508	.	T	C	7	7	14	0	1	15	0	0
24	37704287	.	G	C	3	7	10	0	0	10	0	0
24	37708017	.	T	C	4	8	12	0	0	12	0	0
24	37708207	.	T	A	2	10	12	0	0	12	0	0
24	37708288	.	A	C	1	4	5	0	0	5	0	0
24	37725260	.	T	G	0	2	2	0	1	3	0	0
24	37726377	.	A	G	1	2	3	0	0	3	0	0
24	37726991	.	C	T	3	7	10	0	0	10	0	0
24	37746094	.	G	A	0	4	4	0	2	6	0	0
24	37781428	.	G	A	4	3	7	0	0	7	0	0
24	37781446	.	C	T	2	3	5	0	0	5	0	0
24	37791099	.	C	T	3	4	7	0	1	8	0	0
24	37793276	.	C	A	9	7	16	0	1	17	0	0
24	37793282	.	C	T	8	8	16	0	4	20	0	0
24	37793315	.	C	T	4	8	12	0	0	12	0	0
24	37793725	.	C	T	4	8	12	1	0	13	0	0
24	37794032	.	A	G	3	1	4	0	3	7	0	0
24	37816845	.	G	A	3	3	6	0	1	7	0	0
24	37816851	.	T	C	3	4	7	0	0	7	0	0
24	37836280	.	C	G	1	3	4	0	0	4	0	0
24	37888518	.	C	T	1	2	3	0	0	3	0	0
24	37893391	.	A	T	4	3	7	0	2	9	0	0
24	37893466	.	G	A	3	2	5	0	0	5	0	0
24	37895022	.	C	T	2	4	6	0	2	8	0	0
24	37896875	.	C	T	2	6	8	0	0	8	0	0
24	37897208	.	G	C	9	4	13	0	0	13	0	0
24	37900945	.	G	A	1	10	11	0	1	12	0	0
24	37901148	.	A	G	7	4	11	0	1	12	0	0
24	37901178	.	C	T	7	5	12	0	0	12	0	0
24	37941922	.	A	C	13	6	19	0	1	20	0	0
24	37942032	.	C	T	9	6	15	0	1	16	0	0
24	37942183	.	A	T	8	8	16	0	1	17	0	0
24	37942559	.	C	T	5	5	10	0	0	10	0	0
24	37943052	.	A	G	2	3	5	0	0	5	0	0
24	37943725	.	A	C	2	3	5	0	0	5	0	0
24	38073247	.	A	G	9	8	17	0	1	18	0	0
24	38073271	.	G	A	12	15	27	0	1	28	0	0
24	38073625	.	A	G	4	6	10	0	2	12	0	0
24	38073712	.	C	T	7	4	11	0	0	11	0	0
24	38073754	.	A	C	5	8	13	0	0	13	0	0
24	38189702	.	A	C	1	5	6	0	0	6	0	0
24	38190199	.	A	G	2	3	5	1	2	8	0	0
24	38190201	.	C	T	3	4	7	1	0	8	0	0
24	38190387	.	T	C	4	2	6	1	0	7	0	0
24	38190396	.	A	C	4	3	7	1	0	8	0	0
24	38190594	.	G	T	1	5	6	0	3	9	0	0
24	38190606	.	A	T	3	5	8	0	0	8	0	0
24	38190654	.	T	C	2	3	5	0	0	5	0	0
24	38190868	.	A	G	4	4	8	0	0	8	0	0
24	38190894	.	G	A	3	4	7	0	0	7	0	0
24	38191164	.	G	T	4	2	6	0	1	7	0	0
24	38191202	.	T	C	3	2	5	0	1	6	0	0
24	38191227	.	A	T	1	2	3	0	0	3	0	0
24	38191525	.	A	C	1	4	5	0	0	5	0	0
24	38191537	.	C	T	1	5	6	0	0	6	0	0
24	38191590	.	T	C	2	7	9	0	2	11	0	0
24	38191643	.	A	G	8	4	12	0	0	13	1	0
24	38191652	.	A	T	8	4	12	0	1	13	0	0
24	38191841	.	C	T	1	3	4	0	1	5	0	0
24	38369559	.	T	A	14	17	31	0	0	31	0	0
24	38369873	.	G	A	21	13	34	0	0	34	0	0
24	38370188	.	A	G	6	8	14	0	1	15	0	0
24	38370245	.	C	G	1	8	9	0	12	21	0	0
24	38370443	.	C	T	1	10	11	0	11	22	0	0
24	38370998	.	A	G	1	6	7	0	2	9	0	0
24	38371178	.	A	G	4	4	8	0	0	8	0	0
24	38815105	.	T	A	8	6	14	0	1	15	0	0
24	38815524	.	G	A	6	3	9	0	1	10	0	0
24	38816010	.	G	T	8	6	14	0	2	16	0	0
24	38816340	.	T	G	3	4	7	0	0	7	0	0
24	39051126	.	C	T	4	5	9	0	0	9	0	0
24	39051210	.	C	T	3	2	5	0	0	5	0	0
24	39051803	.	A	C	3	2	5	0	1	6	0	0
24	39052117	.	T	C	4	2	6	0	0	6	0	0
24	39052125	.	A	G	1	4	5	0	0	5	0	0
24	39052200	.	C	T	6	3	9	0	0	9	0	0
24	39052236	.	G	T	1	7	8	0	4	12	0	0
24	39052302	.	G	A	8	6	14	0	0	14	0	0
24	39052311	.	C	T	7	6	13	0	1	14	0	0
24	39052410	.	C	T	6	3	9	0	0	9	0	0
24	39073885	.	G	A	2	6	8	0	6	14	0	0
24	39075534	.	T	C	5	7	12	0	1	13	0	0
24	39078597	.	A	G	7	0	7	0	10	17	0	0
24	39081150	.	C	T	2	4	6	0	1	7	0	0
24	39137777	.	G	A	0	5	5	0	2	7	0	0
24	39137785	.	G	T	1	5	6	0	1	7	0	0
24	39152001	.	A	G	17	8	25	0	1	26	0	0
24	39152504	.	A	G	3	3	6	0	0	6	0	0
24	39152523	.	A	G	4	2	6	0	1	7	0	0
24	39153010	.	C	G	14	6	20	0	0	20	0	0
24	39268891	.	A	G	9	4	13	0	0	13	0	0
24	39272041	.	A	G	2	4	6	0	0	6	0	0
24	39287210	.	A	G	5	3	8	0	0	8	0	0
24	39295664	.	T	C	2	3	5	0	0	5	0	0
24	39298214	.	C	T	3	4	7	0	0	7	0	0
24	39309684	.	A	G	9	0	9	0	10	19	0	0
24	39309889	.	A	T	7	5	12	0	0	12	0	0
24	39310129	.	G	A	1	3	4	0	0	4	0	0
24	39310163	.	G	T	5	3	8	0	0	8	0	0
24	39310253	.	C	T	5	5	10	0	0	10	0	0
24	39321017	.	T	C	23	12	35	0	1	36	0	0
24	39322945	.	G	T	0	26	26	0	20	46	0	0
24	39323791	.	C	T	28	21	49	0	1	50	0	0
24	39333916	.	C	T	17	23	40	0	3	43	0	0
24	39334153	.	T	G	24	16	40	0	2	42	0	0
24	39334388	.	A	G	17	25	42	0	0	42	0	0
24	39334681	.	G	T	17	38	55	0	2	57	0	0
24	39334796	.	G	A	0	11	11	0	23	34	0	0
24	39511016	.	T	C	2	7	9	0	0	9	0	0
24	39511034	.	G	A	2	7	9	0	1	10	0	0
24	39511157	.	G	A	10	4	14	0	0	14	0	0
24	39514075	.	A	C	6	10	16	0	0	16	0	0
24	39514296	.	C	G	6	5	11	0	0	11	0	0
24	39518554	.	C	G	0	10	10	0	5	15	0	0
24	39530034	.	G	A	1	4	5	0	8	13	0	0
24	39533337	.	A	G	2	5	7	0	1	8	0	0
24	39533836	.	C	T	1	2	3	0	1	4	0	0
24	39533987	.	T	A	9	4	13	0	0	13	0	0
24	39534532	.	A	G	3	0	3	0	8	11	0	0
24	39549379	.	C	T	3	2	5	0	0	5	0	0
24	39556276	.	G	T	0	2	2	0	2	4	0	0
24	39556324	.	G	A	4	2	6	0	0	6	0	0
24	39559356	.	C	T	5	3	8	0	0	8	0	0
24	39559386	.	G	A	3	4	7	0	4	11	0	0
24	39576247	.	C	T	1	2	3	0	0	3	0	0
24	39579569	.	G	A	5	4	9	0	0	9	0	0
24	39579730	.	A	G	2	6	8	0	2	10	0	0
24	39579989	.	G	A	0	7	7	0	3	10	0	0
24	39587369	.	C	G	14	4	18	0	0	18	0	0
24	39593009	.	T	C	5	6	11	0	1	12	0	0
24	39595866	.	A	C	6	6	12	0	0	12	0	0
24	39606237	.	G	A	16	20	36	3	0	39	0	0
24	39610535	.	G	T	13	10	23	0	2	25	0	0
24	39615628	.	T	G	7	2	9	1	0	10	0	0
24	39615640	.	G	A	11	2	13	3	1	17	0	0
24	39616016	.	A	G	5	2	7	1	1	9	0	0
24	39616170	.	C	A	7	6	13	0	1	14	0	0
24	39638642	.	G	A	17	16	33	0	1	34	0	0
24	39642072	.	A	T	13	7	20	1	2	23	0	0
24	39642220	.	A	G	10	11	21	0	0	21	0	0
24	39642229	.	A	G	10	10	20	0	1	21	0	0
24	39642336	.	C	A	7	10	17	1	0	18	0	0
24	39642361	.	G	T	7	10	17	0	3	20	0	0
24	39644259	.	T	C	17	17	34	0	0	34	0	0
24	39646762	.	C	T	18	22	40	0	2	42	0	0
24	39647021	.	C	T	18	30	48	0	0	48	0	0
24	39647042	.	G	C	28	15	43	0	1	44	0	0
24	39648806	.	C	T	25	23	48	0	2	50	0	0
24	39651567	.	T	G	29	22	51	0	3	54	0	0
24	39651612	.	A	T	22	20	42	0	6	48	0	0
24	39653626	.	G	A	24	17	41	17	0	58	0	0
24	39660219	.	C	T	16	5	21	0	0	21	0	0
24	39661890	.	T	A	6	15	21	0	0	22	1	0
24	39661905	.	C	T	7	14	21	0	1	22	0	0
24	39662074	.	T	C	11	15	26	0	0	26	0	0
24	39663197	.	A	G	9	12	21	0	0	21	0	0
24	39667154	.	A	T	17	19	36	2	4	42	0	0
24	39667348	.	T	C	10	14	24	1	2	27	0	0
24	39742273	.	G	A	6	5	11	0	0	11	0	0
24	39742396	.	G	A	1	4	5	0	0	5	0	0
24	39742786	.	T	A	2	3	5	0	0	5	0	0
24	39771864	.	T	C	1	2	3	0	0	3	0	0
24	39778970	.	C	T	2	3	5	0	0	5	0	0
24	39778982	.	C	G	1	4	5	0	0	5	0	0
24	39779020	.	C	T	2	4	6	0	0	6	0	0
24	39779108	.	G	T	6	2	8	0	0	8	0	0
24	39779637	.	A	G	2	4	6	0	1	7	0	0
24	39789609	.	G	A	2	2	4	0	0	4	0	0
24	40608706	.	T	C	0	2	2	0	1	3	0	0
24	40608723	.	A	T	3	3	6	0	0	6	0	0
24	40608954	.	C	T	1	2	3	0	1	4	0	0
24	40608962	.	G	T	1	3	4	0	0	4	0	0
24	40624408	.	T	C	6	3	9	0	0	9	0	0
24	40648270	.	C	T	9	17	26	0	2	28	0	0
24	40648284	.	T	A	20	10	30	2	1	33	0	0
24	40876839	.	G	A	1	2	3	5	0	8	0	0
24	40876873	.	G	T	2	3	5	0	0	5	0	0
24	40892759	.	C	T	0	5	5	0	2	7	0	0
24	41246800	.	G	A	2	4	6	0	0	6	0	0
24	41246965	.	G	C	3	2	5	0	0	5	0	0
24	41246969	.	T	C	3	2	5	0	0	5	0	0
24	41290602	.	G	A	1	3	4	0	2	6	0	0
24	41290604	.	G	A	2	3	5	0	0	5	0	0
24	41290712	.	C	T	4	4	8	0	1	9	0	0
24	41291588	.	C	T	7	6	13	0	0	13	0	0
24	41317090	.	A	T	32	4	36	1	6	43	0	0
24	41317132	.	G	A	15	11	26	3	0	29	0	0
24	41317350	.	G	C	7	0	7	0	16	23	0	0
24	41473576	.	T	C	11	0	11	0	7	18	0	0
24	41473618	.	G	A	15	6	21	0	1	22	0	0
24	41473627	.	G	A	12	5	17	0	3	20	0	0
24	41478831	.	C	T	11	6	17	0	0	17	0	0
24	41773216	.	G	C	0	6	6	0	1	7	0	0
24	41773287	.	A	T	1	5	6	0	0	6	0	0
24	41775490	.	C	A	3	3	6	0	0	6	0	0
24	41781968	.	C	T	3	6	9	0	1	10	0	0
24	41783906	.	G	A	0	7	7	0	9	16	0	0
24	41783999	.	C	T	6	6	12	0	0	12	0	0
24	41916584	.	G	A	3	4	7	0	1	8	0	0
24	41916813	.	A	G	1	0	1	0	3	4	0	0
24	41916814	.	C	G	1	3	4	0	0	4	0	0
24	41916887	.	G	A	5	6	11	0	0	11	0	0
24	41917543	.	T	C	8	3	11	0	0	11	0	0
24	41964610	.	G	A	1	8	9	0	7	16	0	0
24	41965111	.	G	A	9	8	17	0	3	20	0	0
24	41965147	.	T	C	14	8	22	0	1	23	0	0
24	41974704	.	G	A	21	12	33	0	2	35	0	0
24	41974736	.	C	T	18	14	32	0	0	32	0	0
24	41974769	.	C	T	13	16	29	0	1	30	0	0
24	41986273	.	C	T	22	25	47	2	1	50	0	0
24	41986311	.	C	A	21	23	44	0	1	45	0	0
24	41986704	.	C	T	20	18	38	0	2	40	0	0
24	41989416	.	C	G	2	3	5	0	0	5	0	0
24	41989453	.	T	C	2	3	5	0	0	5	0	0
24	41989455	.	C	T	3	2	5	0	0	5	0	0
24	41991010	.	A	G	12	6	18	0	2	20	0	0
24	41994096	.	G	A	5	9	14	0	2	16	0	0
24	41994147	.	G	T	10	14	24	0	0	24	0	0
24	41994610	.	G	T	4	2	6	0	0	6	0	0
24	42061316	.	T	A	6	3	9	0	0	9	0	0
24	42061364	.	G	T	10	3	13	0	0	13	0	0
24	42061369	.	C	T	4	9	13	0	0	13	0	0
24	42061423	.	G	T	5	5	10	0	0	10	0	0
24	42061426	.	G	A	6	4	10	0	0	10	0	0
24	42061460	.	A	G	5	3	8	0	0	8	0	0
24	42083840	.	G	A	9	9	18	0	1	19	0	0
24	42083876	.	A	G	8	11	19	0	1	20	0	0
24	42083906	.	G	A	7	7	14	0	1	15	0	0
24	42090574	.	A	T	6	12	18	0	5	23	0	0
24	42094925	.	G	A	7	6	13	1	0	14	0	0
24	42102647	.	G	A	4	2	6	0	0	6	0	0
24	42105278	.	C	A	2	2	4	0	0	4	0	0
24	42117761	.	A	G	4	8	12	0	0	12	0	0
24	42118145	.	C	T	8	5	13	0	0	13	0	0
24	42120459	.	G	C	5	13	18	0	0	18	0	0
24	42132148	.	C	T	6	4	10	13	1	24	0	0
24	42133270	.	G	A	3	11	14	4	5	23	0	0
24	42139889	.	C	T	21	10	31	0	0	31	0	0
24	42141381	.	A	G	2	7	9	0	1	10	0	0
24	42141460	.	C	T	5	14	19	0	0	19	0	0
24	42141793	.	A	G	14	17	31	0	0	31	0	0
24	42142938	.	C	T	9	19	28	0	0	28	0	0
24	42148189	.	G	A	7	10	17	0	1	18	0	0
24	42153199	.	C	T	8	11	19	0	1	20	0	0
24	42153205	.	C	T	6	11	17	0	2	19	0	0
24	42153476	.	G	A	1	17	18	0	9	27	0	0
24	42153503	.	G	A	8	15	23	0	1	24	0	0
24	42157498	.	C	T	12	13	25	0	0	25	0	0
24	42157571	.	A	G	12	21	33	0	1	34	0	0
24	42157602	.	C	T	11	13	24	0	1	25	0	0
24	42157817	.	C	T	6	7	13	0	1	14	0	0
25	14101	.	C	T	1	2	3	0	1	4	0	0
25	15467	.	C	T	7	7	14	0	1	15	0	0
25	15524	.	C	T	3	8	11	0	5	16	0	0
25	15542	.	T	C	6	11	17	0	0	17	0	0
25	15704	.	C	T	4	8	12	0	1	13	0	0
25	15764	.	A	G	8	1	9	0	7	16	0	0
25	127786	.	A	G	1	0	1	0	2	3	0	0
25	136857	.	C	T	24	9	33	0	1	34	0	0
25	136986	.	C	T	20	14	34	0	3	37	0	0
25	146198	.	C	T	20	18	38	0	0	38	0	0
25	146237	.	G	A	19	16	35	0	2	37	0	0
25	146282	.	C	T	14	18	32	0	1	33	0	0
25	146778	.	C	T	15	20	35	0	2	37	0	0
25	146918	.	G	A	13	26	39	0	1	40	0	0
25	154392	.	T	C	5	6	11	0	0	11	0	0
25	156522	.	C	T	3	3	6	0	0	6	0	0
25	156608	.	C	T	3	4	7	0	0	7	0	0
25	157151	.	T	C	3	3	6	0	0	6	0	0
25	157996	.	C	A	4	5	9	0	1	10	0	0
25	158641	.	T	C	4	4	8	0	1	9	0	0
25	158770	.	C	T	9	9	18	0	0	18	0	0
25	158958	.	C	T	8	7	15	0	2	17	0	0
25	159543	.	T	C	10	5	15	0	0	15	0	0
25	160490	.	C	T	7	11	18	0	0	18	0	0
25	187121	.	G	A	0	10	10	0	8	18	0	0
25	187241	.	T	G	7	5	12	0	1	13	0	0
25	236835	.	G	A	5	4	9	0	0	9	0	0
25	241694	.	C	T	4	5	9	0	0	9	0	0
25	241695	.	A	G	4	5	9	0	0	9	0	0
25	244115	.	C	T	1	4	5	0	0	5	0	0
25	244305	.	G	C	2	5	7	0	0	7	0	0
25	265570	.	A	G	3	2	5	0	0	5	0	0
25	265617	.	G	A	2	4	6	0	1	7	0	0
25	315124	.	G	C	2	3	5	0	0	5	0	0
25	315157	.	C	T	2	2	4	0	0	4	0	0
25	401810	.	T	C	3	3	6	0	0	6	0	0
25	402053	.	C	T	2	5	7	0	1	8	0	0
25	402152	.	T	C	7	2	9	0	1	10	0	0
25	402186	.	C	A	2	8	10	0	1	11	0	0
25	402224	.	A	T	7	2	9	0	1	10	0	0
25	402348	.	G	A	1	3	4	0	6	10	0	0
25	402359	.	T	G	5	0	5	0	3	8	0	0
25	403935	.	T	G	5	5	10	0	2	12	0	0
25	450354	.	C	T	12	12	24	0	0	24	0	0
25	469932	.	G	T	30	26	56	0	6	62	0	0
25	469983	.	C	T	44	17	61	0	4	65	0	0
25	472843	.	A	T	43	29	72	0	1	73	0	0
25	474766	.	G	C	33	21	54	0	2	56	0	0
25	474938	.	T	A	20	15	35	0	2	37	0	0
25	474981	.	A	C	26	17	43	0	3	46	0	0
25	474983	.	A	C	19	26	45	0	0	45	0	0
25	485418	.	T	A	4	4	8	0	0	8	0	0
25	485437	.	C	T	6	9	15	0	0	15	0	0
25	485653	.	A	G	15	31	46	0	1	47	0	0
25	485772	.	C	A	19	19	38	0	1	39	0	0
25	485802	.	T	C	22	21	43	0	0	43	0	0
25	485863	.	A	T	12	21	33	0	4	37	0	0
25	486276	.	A	T	23	7	30	0	0	30	0	0
25	486284	.	G	A	17	7	24	0	7	31	0	0
25	486363	.	T	G	21	12	33	0	0	33	0	0
25	487045	.	C	T	19	12	31	0	4	35	0	0
25	487360	.	C	T	0	14	14	0	8	22	0	0
25	488701	.	G	C	15	0	15	0	12	27	0	0
25	488817	.	G	T	8	14	22	0	0	22	0	0
25	489557	.	C	G	1	11	12	0	6	18	0	0
25	489904	.	G	T	12	10	22	0	1	23	0	0
25	494685	.	A	G	7	10	17	0	1	18	0	0
25	495366	.	G	A	9	8	17	0	1	18	0	0
25	498814	.	T	C	9	7	16	0	0	16	0	0
25	502593	.	C	G	1	5	6	0	8	14	0	0
25	502608	.	G	A	9	4	13	0	0	13	0	0
25	504816	.	C	T	5	3	8	0	0	8	0	0
25	505214	.	C	T	5	4	9	0	0	9	0	0
25	509625	.	G	A	3	3	6	0	0	6	0	0
25	509899	.	C	T	3	3	6	1	1	8	0	0
25	510468	.	C	T	1	2	3	0	2	5	0	0
25	510645	.	G	A	1	2	3	0	1	4	0	0
25	513362	.	C	T	2	4	6	0	0	6	0	0
25	525220	.	T	C	1	2	3	0	0	3	0	0
25	527694	.	A	G	3	2	5	0	0	5	0	0
25	582432	.	G	T	11	5	16	0	0	16	0	0
25	582437	.	T	C	10	5	15	0	1	16	0	0
25	582484	.	C	A	12	10	22	0	0	22	0	0
25	615178	.	G	A	8	4	12	0	2	14	0	0
25	617774	.	C	T	9	7	16	0	1	17	0	0
25	617859	.	T	C	10	6	16	0	0	16	0	0
25	626817	.	C	T	15	9	24	0	1	25	0	0
25	640440	.	G	A	1	10	11	0	14	25	0	0
25	663178	.	C	T	22	20	42	0	0	42	0	0
25	663214	.	C	T	22	20	42	0	2	44	0	0
25	663284	.	G	A	1	15	16	0	26	42	0	0
25	763197	.	C	T	8	9	17	0	1	18	0	0
25	763774	.	T	C	10	12	22	0	1	23	0	0
25	764745	.	G	A	18	17	35	0	2	37	0	0
25	769484	.	A	G	1	4	5	0	0	5	0	0
25	771140	.	T	G	3	3	6	0	0	6	0	0
25	824750	.	C	T	0	6	6	0	5	11	0	0
25	824774	.	C	T	6	7	13	0	0	13	0	0
25	825323	.	A	G	5	2	7	0	0	7	0	0
25	825335	.	C	G	5	2	7	0	0	7	0	0
25	825656	.	G	A	3	3	6	0	1	7	0	0
25	825695	.	T	C	2	2	4	0	1	5	0	0
25	825704	.	A	C	2	0	2	0	3	5	0	0
25	825805	.	G	T	1	2	3	0	0	3	0	0
25	825902	.	G	T	1	5	6	0	0	6	0	0
25	825968	.	A	C	4	5	9	0	0	9	0	0
25	826722	.	C	T	2	2	4	0	0	4	0	0
25	826745	.	G	A	2	2	4	0	0	4	0	0
25	1048572	.	A	T	2	2	4	0	0	4	0	0
25	1048575	.	C	T	0	2	2	0	2	4	0	0
25	1048747	.	C	T	0	3	3	0	2	5	0	0
25	1049179	.	G	C	1	4	5	0	0	5	0	0
25	1049194	.	T	C	2	3	5	0	0	5	0	0
25	1049544	.	T	C	1	2	3	0	0	3	0	0
25	1088800	.	A	G	3	3	6	0	1	7	0	0
25	1091760	.	A	G	12	11	23	0	1	24	0	0
25	1091806	.	G	A	14	13	27	0	3	30	0	0
25	1092442	.	C	A	0	7	7	0	10	17	0	0
25	1093526	.	A	G	12	13	25	0	0	25	0	0
25	1094460	.	T	G	12	15	27	0	0	27	0	0
25	1101659	.	A	G	2	9	11	0	0	11	0	0
25	1101704	.	C	G	2	7	9	0	1	10	0	0
25	1101707	.	G	A	2	8	10	0	0	10	0	0
25	1103369	.	G	T	1	5	6	0	0	6	0	0
25	1103486	.	C	T	5	7	12	0	0	12	0	0
25	1107992	.	G	A	2	2	4	0	0	4	0	0
25	1124405	.	C	T	0	2	2	0	3	5	0	0
25	1132496	.	C	G	9	4	13	2	1	16	0	0
25	1132611	.	A	T	13	10	23	0	0	23	0	0
25	1133793	.	G	A	0	15	15	0	6	21	0	0
25	1220400	.	G	T	6	5	11	0	0	11	0	0
25	1276296	.	G	A	1	2	3	0	0	3	0	0
25	1305338	.	T	G	7	7	14	0	0	14	0	0
25	1335681	.	G	A	2	3	5	0	0	5	0	0
25	1335805	.	T	C	1	2	3	0	0	3	0	0
25	1335814	.	T	C	2	2	4	0	0	4	0	0
25	1338263	.	C	T	4	3	7	0	0	7	0	0
25	1338272	.	G	T	3	3	6	0	1	7	0	0
25	1338860	.	T	A	3	5	8	0	1	9	0	0
25	1339403	.	C	T	10	9	19	0	1	20	0	0
25	1339601	.	G	T	1	3	4	0	4	8	0	0
25	1339760	.	C	T	5	4	9	0	0	9	0	0
25	1339991	.	A	G	2	3	5	0	0	5	0	0
25	1340021	.	A	G	1	0	1	0	2	3	0	0
25	1340088	.	T	C	2	4	6	0	0	6	0	0
25	1340215	.	G	A	9	3	12	0	1	13	0	0
25	1592111	.	G	A	12	11	23	0	1	24	0	0
25	1603727	.	G	A	0	6	6	0	4	10	0	0
25	1603772	.	C	A	3	8	11	0	0	11	0	0
25	1603787	.	G	T	9	4	13	0	0	13	0	0
25	1604543	.	T	G	6	0	6	0	6	12	0	0
25	1605150	.	T	C	3	10	13	0	0	13	0	0
25	1608836	.	C	G	4	6	10	0	0	10	0	0
25	1608857	.	C	G	8	3	11	0	1	12	0	0
25	1624547	.	C	A	11	16	27	0	2	29	0	0
25	1624777	.	G	A	16	20	36	0	1	37	0	0
25	1635419	.	G	A	11	14	25	0	2	27	0	0
25	1635783	.	G	A	20	9	29	0	4	33	0	0
25	1635786	.	C	T	1	9	10	0	21	31	0	0
25	1635879	.	G	A	17	16	33	0	0	33	0	0
25	1639932	.	G	T	9	15	24	0	1	25	0	0
25	1642066	.	C	T	17	4	21	0	1	22	0	0
25	1642319	.	C	A	10	12	22	0	2	24	0	0
25	1644857	.	C	T	7	4	11	0	0	11	0	0
25	1652294	.	G	A	4	6	10	0	0	10	0	0
25	1652450	.	A	G	4	2	6	0	1	7	0	0
25	1652513	.	G	A	7	4	11	0	0	11	0	0
25	1652543	.	C	T	0	4	4	0	6	10	0	0
25	1652766	.	C	A	6	2	8	0	0	8	0	0
25	1652793	.	C	T	1	3	4	0	3	7	0	0
25	1654432	.	G	T	7	6	13	0	0	13	0	0
25	1655502	.	G	A	3	2	5	0	1	6	0	0
25	1672911	.	C	T	3	3	6	0	1	7	0	0
25	1672920	.	G	T	3	3	6	0	0	6	0	0
25	2264091	.	C	A	4	2	6	0	1	7	0	0
25	2264112	.	T	C	4	2	6	0	3	9	0	0
25	2273945	.	C	T	2	2	4	0	2	6	0	0
25	2276704	.	C	T	5	3	8	0	1	9	0	0
25	2276770	.	T	C	6	3	9	0	2	11	0	0
25	2276781	.	A	G	6	5	11	0	0	11	0	0
25	2276828	.	T	A	3	5	8	0	0	8	0	0
25	2282566	.	A	G	12	0	12	0	12	24	0	0
25	2282846	.	A	C	20	13	33	0	2	35	0	0
25	2286066	.	C	T	17	17	34	0	4	38	0	0
25	2286120	.	G	A	15	6	21	0	0	21	0	0
25	2286328	.	T	G	12	7	19	0	1	20	0	0
25	2286376	.	T	C	6	4	10	0	2	12	0	0
25	2286502	.	T	C	9	10	19	0	1	20	0	0
25	2286600	.	A	T	13	11	24	0	0	24	0	0
25	2286762	.	A	C	14	7	21	0	4	25	0	0
25	2286798	.	A	C	21	8	29	0	4	33	0	0
25	2286837	.	C	T	18	9	27	0	2	29	0	0
25	2286841	.	C	A	17	9	26	0	3	29	0	0
25	2702880	.	A	T	3	3	6	0	0	6	0	0
25	2706818	.	C	A	6	2	8	0	1	9	0	0
25	2707114	.	T	C	2	5	7	0	1	8	0	0
25	2707123	.	T	C	3	0	3	0	7	10	0	0
25	2707178	.	T	C	1	4	5	0	0	5	0	0
25	3245895	.	A	G	10	5	15	0	1	16	0	0
25	3369119	.	T	G	2	2	4	0	0	4	0	0
25	3451196	.	T	A	7	6	13	0	0	13	0	0
25	3451250	.	A	C	14	11	25	0	2	27	0	0
25	3451760	.	A	C	8	4	12	0	1	14	1	0
25	3451779	.	A	G	8	5	13	0	1	14	0	0
25	3453651	.	G	A	9	6	15	0	0	15	0	0
25	3454644	.	G	A	9	4	13	0	2	15	0	0
25	3454719	.	G	A	4	11	15	0	0	15	0	0
25	3457756	.	G	A	6	3	9	0	0	9	0	0
25	3461097	.	C	G	1	9	10	0	3	13	0	0
25	3465854	.	G	A	4	3	7	0	2	9	0	0
25	3478467	.	G	T	9	5	14	0	0	14	0	0
25	3478617	.	C	T	8	7	15	0	1	16	0	0
25	3481088	.	G	T	11	7	18	0	0	18	0	0
25	3483727	.	G	A	1	5	6	0	1	7	0	0
25	3513274	.	G	A	7	7	14	0	0	14	0	0
25	3528738	.	T	C	1	2	3	1	0	4	0	0
25	3529701	.	G	A	1	2	3	0	3	6	0	0
25	3539530	.	C	T	0	2	2	0	3	5	0	0
25	3542072	.	G	T	2	2	4	0	0	4	0	0
25	3546488	.	A	C	4	2	6	0	0	6	0	0
25	3557470	.	G	A	0	5	5	0	3	8	0	0
25	3560066	.	G	A	1	4	5	0	5	10	0	0
25	3562517	.	A	C	6	2	8	0	0	8	0	0
25	3573235	.	T	C	3	3	6	0	0	6	0	0
25	3573237	.	A	G	3	3	6	0	0	6	0	0
25	3573283	.	A	G	5	5	10	1	0	11	0	0
25	3573350	.	G	A	2	8	10	0	1	11	0	0
25	3573447	.	T	C	3	0	3	0	7	10	0	0
25	3573624	.	G	C	10	8	18	0	0	18	0	0
25	3573635	.	A	T	11	8	19	0	1	20	0	0
25	3573796	.	C	A	1	4	5	0	15	20	0	0
25	3573815	.	G	A	14	4	18	0	2	20	0	0
25	3579429	.	A	C	9	13	22	0	0	22	0	0
25	3579459	.	C	A	13	12	25	0	1	26	0	0
25	3582443	.	A	G	6	7	13	0	3	16	0	0
25	3583975	.	C	T	3	11	14	0	0	14	0	0
25	3583983	.	G	T	3	9	12	0	1	13	0	0
25	3584053	.	G	A	3	7	10	0	1	11	0	0
25	3584156	.	T	C	6	0	6	0	14	20	0	0
25	3584803	.	C	T	0	4	4	0	7	11	0	0
25	3590931	.	G	A	3	4	7	0	0	7	0	0
25	3594911	.	T	C	5	3	8	0	1	9	0	0
25	3595118	.	G	A	3	3	6	0	0	6	0	0
25	3595120	.	C	T	0	3	3	0	3	6	0	0
25	3596361	.	T	G	2	6	8	0	0	8	0	0
25	3596405	.	T	C	1	0	1	0	6	7	0	0
25	3596481	.	G	A	4	3	7	0	0	7	0	0
25	3599390	.	A	G	2	5	7	0	0	7	0	0
25	3606970	.	C	T	6	5	11	0	0	11	0	0
25	3607015	.	A	G	2	5	7	0	0	7	0	0
25	3607033	.	G	C	1	1	2	0	3	5	0	0
25	3623403	.	T	C	1	2	3	0	0	3	0	0
25	3623872	.	G	C	4	1	5	0	1	6	0	0
25	3623921	.	C	T	1	3	4	0	1	5	0	0
25	3641123	.	C	T	0	1	1	0	2	3	0	0
25	3641160	.	G	A	2	2	4	0	0	4	0	0
25	3677703	.	G	A	1	4	5	0	9	14	0	0
25	3682253	.	C	T	11	8	19	0	0	19	0	0
25	3682610	.	G	A	0	5	5	0	10	15	0	0
25	3682789	.	G	A	17	11	28	0	4	32	0	0
25	3682795	.	A	C	20	14	34	0	1	35	0	0
25	3683247	.	G	A	21	23	44	0	1	45	0	0
25	3683297	.	C	T	25	26	51	0	3	54	0	0
25	3683386	.	C	T	19	25	44	0	2	46	0	0
25	3683527	.	G	A	3	23	26	0	15	41	0	0
25	3683796	.	A	T	13	4	17	0	0	17	0	0
25	3683887	.	C	T	18	13	31	0	0	31	0	0
25	3684141	.	C	A	31	22	53	0	3	56	0	0
25	3684148	.	A	G	35	23	58	0	2	60	0	0
25	3684195	.	G	A	3	13	16	10	24	50	0	0
25	3684409	.	G	T	7	16	23	1	38	62	0	0
25	3684741	.	A	G	18	25	43	0	4	47	0	0
25	3708287	.	G	A	6	2	8	0	0	8	0	0
25	3708429	.	G	T	4	5	9	0	2	11	0	0
25	3713652	.	T	C	7	0	7	0	11	18	0	0
25	3713724	.	T	C	13	10	23	0	0	23	0	0
25	3719768	.	T	C	2	4	6	0	3	9	0	0
25	3719888	.	G	T	10	13	23	0	2	25	0	0
25	3721726	.	G	C	9	0	9	0	7	16	0	0
25	3724275	.	T	C	2	0	2	0	5	7	0	0
25	3724598	.	G	A	6	3	9	0	0	9	0	0
25	3725000	.	G	A	8	5	13	0	0	13	0	0
25	3750079	.	C	T	7	3	10	1	1	12	0	0
25	3750509	.	T	A	7	2	9	0	1	10	0	0
25	3750545	.	A	T	11	6	17	0	1	18	0	0
25	3750559	.	T	C	14	8	22	0	1	23	0	0
25	3750655	.	C	T	14	11	25	0	2	27	0	0
25	3754606	.	G	A	9	8	17	0	1	18	0	0
25	3755271	.	G	A	14	9	23	0	0	23	0	0
25	3755303	.	A	G	13	9	22	0	1	23	0	0
25	3757584	.	G	A	6	11	17	0	1	18	0	0
25	3757606	.	G	A	2	7	9	0	2	11	0	0
25	3758022	.	T	C	1	4	5	0	0	5	0	0
25	3761443	.	G	A	5	2	7	0	1	8	0	0
25	3761475	.	C	T	3	2	5	0	0	5	0	0
25	3765659	.	G	A	1	7	8	0	1	9	0	0
25	3772165	.	T	C	1	2	3	0	0	3	0	0
25	3774637	.	A	C	2	3	5	0	0	5	0	0
25	3774681	.	G	A	3	5	8	0	0	8	0	0
25	3774705	.	A	T	4	6	10	0	0	10	0	0
25	3777625	.	T	G	4	2	6	0	0	6	0	0
25	3777774	.	A	G	4	0	4	0	3	7	0	0
25	3777795	.	G	C	0	4	4	0	5	9	0	0
25	3779091	.	T	C	2	3	5	0	0	5	0	0
25	3782576	.	T	C	3	5	8	0	2	10	0	0
25	3784679	.	C	T	4	5	9	0	0	9	0	0
25	3788564	.	T	C	3	2	5	0	0	5	0	0
25	3789004	.	G	A	1	4	5	0	4	9	0	0
25	3790279	.	G	A	2	4	6	0	8	14	0	0
25	3792945	.	A	G	11	7	18	0	3	21	0	0
25	3793096	.	T	C	17	5	22	0	0	22	0	0
25	3793141	.	T	A	12	5	17	0	1	18	0	0
25	3794786	.	A	G	14	0	14	0	12	26	0	0
25	3800590	.	C	T	12	7	19	0	0	19	0	0
25	3800851	.	T	A	3	2	5	0	0	5	0	0
25	3801505	.	T	G	6	5	11	0	0	11	0	0
25	3801612	.	T	C	4	0	4	1	3	8	0	0
25	3801726	.	A	G	16	9	25	0	0	25	0	0
25	3801737	.	T	C	18	12	30	0	0	30	0	0
25	3804410	.	A	G	15	19	34	0	0	34	0	0
25	3807526	.	C	T	1	8	9	0	11	20	0	0
25	3808572	.	T	A	9	4	13	0	2	15	0	0
25	3810273	.	C	T	1	2	3	0	0	3	0	0
25	3887287	.	C	T	2	8	10	0	2	12	0	0
25	3891940	.	A	T	20	26	46	0	2	48	0	0
25	3898332	.	A	G	3	5	8	0	1	9	0	0
25	3898449	.	T	C	2	0	2	0	4	6	0	0
25	3898483	.	C	T	2	4	6	0	1	7	0	0
25	3898566	.	G	T	1	2	3	0	0	3	0	0
25	3898572	.	C	A	0	2	2	0	1	3	0	0
25	3898937	.	T	A	2	7	9	1	0	10	0	0
25	3898976	.	C	T	0	4	4	0	2	6	0	0
25	3903316	.	A	T	1	2	3	0	0	3	0	0
25	3903317	.	C	G	2	2	4	0	0	4	0	0
25	3906840	.	A	C	3	0	3	0	2	5	0	0
25	4113930	.	T	C	2	1	3	0	1	4	0	0
25	4117899	.	C	T	3	5	8	0	0	8	0	0
25	4129075	.	G	T	5	2	7	0	0	7	0	0
25	4129165	.	C	A	4	2	6	0	0	6	0	0
25	4133498	.	T	C	17	8	25	0	2	27	0	0
25	4133647	.	C	A	19	12	31	0	2	33	0	0
25	4133648	.	T	C	20	2	22	0	12	34	0	0
25	4133708	.	T	G	32	15	47	0	1	48	0	0
25	4133720	.	C	A	32	18	50	0	3	53	0	0
25	4136001	.	C	A	27	15	42	0	2	44	0	0
25	4136292	.	A	G	19	15	34	1	1	36	0	0
25	4141629	.	G	A	11	16	27	0	1	28	0	0
25	4143837	.	T	C	5	0	5	0	6	11	0	0
25	4460441	.	G	A	12	4	16	0	0	16	0	0
25	4465382	.	T	C	6	0	6	0	9	15	0	0
25	4479442	.	A	G	3	4	7	0	1	8	0	0
25	4479613	.	G	C	3	4	7	0	0	7	0	0
25	4677100	.	A	C	2	2	4	0	0	4	0	0
25	4686548	.	T	C	3	3	6	0	0	6	0	0
25	4686575	.	T	C	4	4	8	0	0	8	0	0
25	4689362	.	A	G	1	5	6	0	1	7	0	0
25	4689513	.	A	G	3	0	3	0	3	6	0	0
25	4689578	.	A	G	1	3	4	0	0	4	0	0
25	4837937	.	G	C	3	6	9	0	1	10	0	0
25	4838118	.	A	G	6	6	12	0	2	14	0	0
25	4841406	.	T	C	6	5	11	0	1	12	0	0
25	4843398	.	A	G	8	13	21	0	0	21	0	0
25	4843685	.	A	C	13	10	23	0	1	24	0	0
25	4846836	.	T	C	19	13	32	0	4	36	0	0
25	4848808	.	C	T	12	12	24	0	1	25	0	0
25	4849326	.	A	G	11	0	11	0	14	25	0	0
25	4849422	.	T	A	25	7	32	0	4	36	0	0
25	4849453	.	C	T	22	7	29	0	2	31	0	0
25	4850969	.	C	G	10	0	10	0	11	21	0	0
25	4850989	.	G	A	11	12	23	0	1	24	0	0
25	4867781	.	C	G	2	2	4	0	0	4	0	0
25	4873979	.	T	C	1	2	3	0	1	4	0	0
25	4874000	.	G	T	1	3	4	0	0	4	0	0
25	4876366	.	A	G	3	0	3	0	5	8	0	0
25	4877685	.	A	G	1	3	4	0	0	4	0	0
25	4877781	.	C	A	5	5	10	0	0	10	0	0
25	4879937	.	T	A	7	6	13	0	0	13	0	0
25	4879964	.	C	T	6	6	12	0	3	15	0	0
25	4879973	.	A	C	6	7	13	0	0	13	0	0
25	4880030	.	G	A	5	6	11	0	2	13	0	0
25	4880138	.	A	C	5	5	10	0	0	10	0	0
25	4880144	.	A	G	5	0	5	0	5	10	0	0
25	4880363	.	C	T	2	4	6	0	0	6	0	0
25	4880372	.	T	A	2	3	5	0	1	6	0	0
25	4883338	.	A	G	10	0	10	0	4	14	0	0
25	4890782	.	A	C	2	1	3	0	11	14	0	0
25	4890802	.	G	T	4	9	13	0	0	13	0	0
25	4891272	.	G	A	34	28	62	0	3	65	0	0
25	4891286	.	A	T	30	27	57	0	10	67	0	0
25	4891350	.	C	T	24	43	67	0	2	69	0	0
25	4891538	.	A	G	20	33	53	1	3	57	0	0
25	4891597	.	G	A	14	31	45	0	1	46	0	0
25	4891762	.	C	G	18	25	43	0	2	45	0	0
25	4891867	.	T	C	10	1	11	0	15	26	0	0
25	4891882	.	C	T	9	11	20	0	1	21	0	0
25	4892010	.	A	C	11	21	32	0	0	32	0	0
25	4892172	.	G	T	22	34	56	0	1	57	0	0
25	4892203	.	T	A	20	31	51	0	0	51	0	0
25	4892291	.	T	C	23	28	51	0	0	51	0	0
25	4892537	.	A	G	14	20	34	0	4	38	0	0
25	4892830	.	C	T	14	25	39	0	1	40	0	0
25	4892982	.	T	C	10	18	28	0	0	28	0	0
25	4892985	.	T	C	9	16	25	0	1	26	0	0
25	4893024	.	A	C	10	11	21	0	0	21	0	0
25	4893049	.	T	C	8	7	15	2	0	17	0	0
25	4893059	.	G	A	9	6	15	2	2	19	0	0
25	4893176	.	C	T	1	5	6	0	7	13	0	0
25	4893193	.	A	C	10	9	19	0	1	20	0	0
25	4893214	.	T	G	11	14	25	0	2	27	0	0
25	4893238	.	A	G	6	21	27	0	0	27	0	0
25	4893304	.	G	T	7	23	30	0	1	31	0	0
25	4893398	.	T	C	24	23	47	0	2	49	0	0
25	4893435	.	C	T	26	21	47	0	5	52	0	0
25	4896182	.	A	G	14	10	24	0	2	26	0	0
25	4896281	.	A	C	7	0	7	0	18	25	0	0
25	4896290	.	A	G	5	21	26	0	0	26	0	0
25	4897187	.	T	A	4	17	21	0	1	22	0	0
25	4899071	.	G	A	7	14	21	0	1	22	0	0
25	4902538	.	A	T	9	10	19	0	1	20	0	0
25	4902586	.	T	C	11	1	12	0	16	28	0	0
25	4904387	.	A	G	8	13	21	0	1	22	0	0
25	5022275	.	C	T	1	2	3	0	0	3	0	0
25	5025286	.	T	C	3	3	6	0	0	6	0	0
25	5025342	.	A	G	2	1	3	0	1	4	0	0
25	5666904	.	C	T	3	2	5	0	0	5	0	0
25	5666925	.	A	G	2	2	4	0	0	4	0	0
25	5679314	.	A	T	2	3	5	0	0	5	0	0
25	5702160	.	G	T	6	16	22	0	1	23	0	0
25	5709328	.	T	G	10	11	21	0	1	22	0	0
25	5710949	.	C	G	8	9	17	0	0	17	0	0
25	5713704	.	G	C	9	2	11	0	7	18	0	0
25	5722072	.	A	G	8	10	18	0	0	18	0	0
25	5724887	.	C	T	0	9	9	0	2	11	0	0
25	5730936	.	A	T	3	2	5	0	0	5	0	0
25	5774984	.	C	G	1	6	7	0	0	7	0	0
25	5774990	.	T	A	1	6	7	0	0	7	0	0
25	5775124	.	C	T	0	1	1	0	2	3	0	0
25	5775139	.	T	A	1	2	3	0	0	3	0	0
25	5775497	.	T	C	1	3	4	0	0	4	0	0
25	5775498	.	C	T	1	3	4	0	0	4	0	0
25	5775536	.	T	A	1	5	6	0	0	6	0	0
25	5775552	.	C	T	1	5	6	0	1	7	0	0
25	5775605	.	G	C	2	4	6	0	0	6	0	0
25	5775638	.	G	C	2	2	4	0	0	4	0	0
25	5776920	.	T	A	2	4	6	0	0	6	0	0
25	5776966	.	G	C	1	4	5	0	0	5	0	0
25	5777032	.	T	A	6	3	9	0	0	9	0	0
25	5777674	.	G	A	3	10	13	0	0	13	0	0
25	5778797	.	C	T	7	3	10	0	1	11	0	0
25	5779557	.	G	A	12	4	16	0	0	17	1	0
25	5780633	.	T	C	7	8	15	0	0	15	0	0
25	5783309	.	T	C	8	12	20	0	1	21	0	0
25	5783523	.	C	T	13	8	21	0	0	21	0	0
25	5783598	.	T	A	3	3	6	0	1	7	0	0
25	5786668	.	T	C	3	3	6	0	1	7	0	0
25	5787684	.	C	T	10	14	24	0	0	24	0	0
25	5787966	.	C	A	8	19	27	0	1	28	0	0
25	5788212	.	A	G	1	2	3	0	1	4	0	0
25	5788244	.	T	G	1	2	3	0	0	3	0	0
25	5788310	.	T	C	2	8	10	0	3	13	0	0
25	5788321	.	C	T	3	12	15	0	1	16	0	0
25	5788384	.	C	T	12	9	21	0	1	22	0	0
25	5788432	.	A	G	7	14	21	0	1	22	0	0
25	5788519	.	G	T	12	9	21	0	1	22	0	0
25	5788670	.	C	T	2	10	12	0	18	30	0	0
25	5788783	.	G	C	14	14	28	0	3	31	0	0
25	5788838	.	A	G	9	10	19	0	1	20	0	0
25	5788842	.	C	T	1	9	10	0	9	19	0	0
25	5788968	.	C	T	2	3	5	0	9	14	0	0
25	5789625	.	T	A	9	6	15	0	1	16	0	0
25	5789626	.	T	C	9	0	9	0	7	16	0	0
25	5789660	.	A	T	9	6	15	1	1	17	0	0
25	5789721	.	G	A	9	6	15	0	1	16	0	0
25	5789734	.	G	C	6	4	10	0	1	11	0	0
25	5789937	.	A	C	9	5	14	0	0	14	0	0
25	5790050	.	T	G	5	4	9	0	1	10	0	0
25	5790341	.	C	G	9	5	14	0	0	14	0	0
25	5790414	.	A	T	8	3	11	0	0	11	0	0
25	5790498	.	T	C	9	3	12	0	0	12	0	0
25	5790742	.	G	A	8	4	12	0	3	15	0	0
25	5803529	.	A	G	2	3	5	0	0	5	0	0
25	5805328	.	G	A	6	2	8	0	0	8	0	0
25	5805346	.	G	T	6	4	10	0	1	11	0	0
25	5835564	.	T	C	16	10	26	0	1	27	0	0
25	5936080	.	C	T	7	8	15	0	0	15	0	0
25	5936556	.	A	T	9	22	31	0	0	31	0	0
25	5936725	.	T	A	19	20	39	0	1	40	0	0
25	5936764	.	C	A	20	19	39	0	1	40	0	0
25	5936886	.	C	T	0	8	8	0	9	17	0	0
25	5937012	.	C	T	15	5	20	0	1	21	0	0
25	5937092	.	C	T	0	4	4	0	10	15	1	0
25	5937113	.	G	A	10	2	12	0	1	13	0	0
25	5937424	.	T	G	9	11	20	0	1	21	0	0
25	5937516	.	C	T	1	16	17	0	17	34	0	0
25	5937686	.	G	C	12	0	12	0	26	38	0	0
25	5938065	.	A	T	5	8	13	0	0	13	0	0
25	5938694	.	G	A	3	2	5	0	0	5	0	0
25	5938858	.	A	C	3	5	8	0	2	10	0	0
25	5938881	.	G	T	6	2	8	0	1	9	0	0
25	5938895	.	C	T	7	2	9	0	0	9	0	0
25	5939023	.	A	G	8	1	9	1	1	11	0	0
25	5939484	.	C	T	9	8	17	0	0	17	0	0
25	5939569	.	T	C	6	6	12	0	0	12	0	0
25	5947539	.	G	A	3	4	7	0	0	7	0	0
25	5986994	.	A	G	35	2	37	0	29	66	0	0
25	5990107	.	A	C	12	17	29	0	3	32	0	0
25	6016708	.	G	A	6	6	12	1	0	13	0	0
25	6016752	.	T	C	5	0	5	1	7	13	0	0
25	6016829	.	C	T	9	11	20	0	1	21	0	0
25	6017382	.	A	T	16	9	25	0	0	25	0	0
25	6017623	.	C	T	0	7	7	0	12	19	0	0
25	6025278	.	C	A	9	4	13	0	0	13	0	0
25	6025326	.	G	T	7	8	15	0	1	16	0	0
25	6026106	.	G	A	8	9	17	0	1	18	0	0
25	6028947	.	G	A	8	3	11	0	1	12	0	0
25	6042871	.	G	A	4	4	8	0	1	9	0	0
25	6049177	.	G	A	5	5	10	0	1	11	0	0
25	6051833	.	C	T	1	2	3	0	1	4	0	0
25	6060657	.	T	G	1	4	5	0	0	5	0	0
25	6067712	.	A	C	3	0	3	0	5	8	0	0
25	6074309	.	C	T	2	2	4	0	0	4	0	0
25	6074342	.	T	C	1	0	1	0	3	4	0	0
25	6152324	.	G	A	2	2	4	0	1	5	0	0
25	6152347	.	T	A	4	3	7	0	0	7	0	0
25	6186933	.	A	G	5	3	8	0	1	9	0	0
25	6202870	.	T	A	7	5	12	0	1	13	0	0
25	6203292	.	A	G	3	7	10	0	1	11	0	0
25	6205703	.	C	T	17	16	33	0	1	34	0	0
25	6206264	.	G	T	2	1	3	0	1	4	0	0
25	6206304	.	A	G	3	0	3	0	4	8	1	0
25	6216349	.	A	C	18	17	35	0	1	36	0	0
25	6222555	.	G	A	15	9	24	0	2	26	0	0
25	6228616	.	G	A	11	11	22	0	0	22	0	0
25	6228651	.	A	G	12	13	25	0	0	25	0	0
25	6230616	.	G	A	10	17	27	0	1	28	0	0
25	6230721	.	T	C	9	12	21	0	2	23	0	0
25	6230736	.	T	G	11	9	20	0	0	20	0	0
25	6230935	.	T	C	10	8	18	0	0	18	0	0
25	6233485	.	C	T	12	11	23	0	2	25	0	0
25	6237656	.	G	A	3	3	6	0	0	6	0	0
25	6237674	.	T	C	1	0	1	0	2	3	0	0
25	6237993	.	A	G	5	4	9	0	0	9	0	0
25	6239911	.	T	C	4	3	7	0	1	8	0	0
25	6242742	.	C	T	6	5	11	0	0	11	0	0
25	6245099	.	A	G	3	3	6	0	0	6	0	0
25	6288353	.	G	C	9	4	13	0	0	13	0	0
25	6292481	.	C	T	0	4	4	0	2	6	0	0
25	6312955	.	A	C	39	27	66	0	1	67	0	0
25	6313069	.	G	A	4	28	32	0	31	63	0	0
25	6313075	.	T	C	34	28	62	0	3	65	0	0
25	6337111	.	G	A	5	38	43	1	28	72	0	0
25	6337253	.	A	T	20	12	32	0	3	35	0	0
25	6337271	.	C	A	22	15	37	0	1	38	0	0
25	6351282	.	A	G	16	16	32	1	0	33	0	0
25	6351283	.	C	G	14	16	30	1	3	34	0	0
25	6357227	.	C	T	3	9	12	0	0	12	0	0
25	6357245	.	C	T	2	10	12	0	1	13	0	0
25	6357451	.	T	C	3	5	8	0	0	8	0	0
25	6357503	.	G	A	5	2	7	0	0	7	0	0
25	6359728	.	G	C	4	8	12	0	0	12	0	0
25	6360049	.	T	A	4	7	11	0	0	11	0	0
25	6360225	.	T	C	9	10	19	0	0	19	0	0
25	6365322	.	T	C	3	4	7	0	2	9	0	0
25	6365361	.	C	A	2	4	6	0	0	6	0	0
25	6365394	.	G	T	0	7	7	0	1	8	0	0
25	6365415	.	T	C	1	6	7	0	0	7	0	0
25	6366800	.	T	G	1	5	6	0	0	6	0	0
25	6366888	.	G	A	2	2	4	0	1	5	0	0
25	6370171	.	C	T	0	1	1	0	1	2	0	0
25	6370184	.	T	C	1	1	2	0	1	3	0	0
25	6411935	.	A	G	1	3	4	0	0	4	0	0
25	6431914	.	C	A	3	3	6	0	0	6	0	0
25	6435955	.	A	G	6	2	8	0	0	8	0	0
25	6436199	.	G	C	13	7	20	0	0	20	0	0
25	6437716	.	A	G	11	9	20	0	1	21	0	0
25	6437735	.	A	G	12	8	20	0	0	20	0	0
25	6437945	.	C	T	3	9	12	0	0	12	0	0
25	7230239	.	T	C	2	3	5	0	0	5	0	0
25	7324580	.	C	T	14	6	20	0	2	22	0	0
25	7334900	.	A	G	17	0	17	0	20	37	0	0
25	7334915	.	T	C	20	20	40	0	1	41	0	0
25	7334957	.	G	A	3	16	19	1	22	42	0	0
25	7334987	.	G	C	19	15	34	1	4	39	0	0
25	7413144	.	C	T	3	3	6	0	0	6	0	0
25	7428932	.	A	C	6	14	20	0	2	22	0	0
25	7428944	.	T	C	7	13	20	0	2	22	0	0
25	7428971	.	A	T	2	9	11	0	1	12	0	0
25	7431430	.	A	G	3	0	3	0	9	12	0	0
25	7431611	.	G	A	7	4	11	0	2	13	0	0
25	7433573	.	C	T	1	2	3	0	0	3	0	0
25	7454578	.	T	C	11	3	14	0	0	14	0	0
25	7456535	.	C	A	3	8	11	0	1	12	0	0
25	7480949	.	G	C	10	16	26	0	1	27	0	0
25	7481063	.	C	A	16	17	33	0	1	34	0	0
25	7481123	.	G	A	2	22	24	0	14	38	0	0
25	7481159	.	C	T	17	16	33	0	2	35	0	0
25	7485040	.	A	G	24	0	24	0	12	36	0	0
25	7485073	.	G	A	22	15	37	0	0	37	0	0
25	7485527	.	C	T	16	24	40	0	1	41	0	0
25	7485588	.	A	G	20	27	47	0	1	48	0	0
25	7487809	.	T	C	31	20	51	0	3	54	0	0
25	7488310	.	T	A	0	29	29	0	2	31	0	0
25	7488749	.	T	G	13	33	46	0	2	48	0	0
25	7488753	.	C	T	13	35	48	0	1	49	0	0
25	7488812	.	G	A	40	20	60	0	3	63	0	0
25	7488813	.	G	T	41	21	62	0	2	64	0	0
25	7489034	.	G	A	5	30	35	0	25	60	0	0
25	7489082	.	A	G	28	14	42	0	3	45	0	0
25	7489085	.	G	C	31	13	44	0	3	47	0	0
25	7494306	.	T	C	1	4	5	0	1	6	0	0
25	7496021	.	C	T	2	2	4	1	0	5	0	0
25	7496039	.	C	T	2	2	4	0	0	4	0	0
25	7502022	.	G	C	11	14	25	0	0	25	0	0
25	7502201	.	G	A	10	9	19	0	1	20	0	0
25	7502204	.	T	G	10	8	18	0	0	18	0	0
25	7502241	.	G	A	3	9	12	2	1	15	0	0
25	7502271	.	T	G	8	0	8	3	12	23	0	0
25	7533437	.	C	T	1	2	3	0	0	3	0	0
25	7533476	.	C	T	1	3	4	0	0	4	0	0
25	7551182	.	C	T	5	5	10	0	0	10	0	0
25	7553064	.	G	T	2	1	3	0	1	4	0	0
25	7556313	.	A	G	6	3	9	0	1	10	0	0
25	7556410	.	T	C	2	8	10	0	0	10	0	0
25	7556427	.	C	T	4	6	10	0	0	10	0	0
25	7556454	.	C	T	5	4	9	0	2	11	0	0
25	7562272	.	C	A	5	8	13	0	0	13	0	0
25	7562301	.	T	A	9	9	18	0	0	18	0	0
25	7562418	.	G	A	1	8	9	0	3	12	0	0
25	7562921	.	C	T	14	10	24	0	1	25	0	0
25	7562925	.	A	T	13	10	23	0	2	25	0	0
25	7562975	.	A	G	14	21	35	0	4	39	0	0
25	7578184	.	C	T	5	2	7	0	0	7	0	0
25	7578333	.	T	C	4	2	6	0	0	6	0	0
25	7578335	.	A	C	2	3	5	0	0	5	0	0
25	7580798	.	T	C	4	5	9	0	0	9	0	0
25	7580840	.	G	A	1	5	6	0	1	7	0	0
25	7583147	.	T	C	5	3	8	0	0	8	0	0
25	7586915	.	A	G	2	6	8	0	0	8	0	0
25	7587748	.	A	T	5	7	12	0	1	13	0	0
25	7589915	.	A	G	8	0	8	0	9	17	0	0
25	7589951	.	C	T	7	8	15	0	0	15	0	0
25	7590679	.	C	T	8	5	13	0	0	13	0	0
25	7590702	.	C	T	6	6	12	0	2	14	0	0
25	7590731	.	A	G	7	8	15	0	0	15	0	0
25	7667870	.	T	C	8	4	12	0	0	12	0	0
25	7667923	.	G	A	9	5	14	0	0	14	0	0
25	7667943	.	T	C	7	6	13	0	0	13	0	0
25	7668161	.	A	G	6	9	15	0	1	16	0	0
25	7668166	.	C	T	0	5	5	0	10	15	0	0
25	7672067	.	C	T	2	7	9	0	0	9	0	0
25	7672382	.	G	A	1	4	5	0	2	7	0	0
25	7672385	.	C	T	2	4	6	0	1	7	0	0
25	7673040	.	T	C	10	6	16	0	2	18	0	0
25	7673052	.	C	T	10	7	17	0	0	17	0	0
25	7673139	.	T	A	13	11	24	0	0	24	0	0
25	7673140	.	C	T	12	11	23	0	1	24	0	0
25	7673897	.	T	G	8	9	17	0	2	19	0	0
25	7673930	.	G	A	11	13	24	0	0	24	0	0
25	7673951	.	C	T	9	10	19	0	1	20	0	0
25	7674098	.	G	A	8	11	19	0	3	22	0	0
25	7678180	.	A	T	22	14	36	0	1	37	0	0
25	7692826	.	T	C	2	3	5	0	0	5	0	0
25	7692881	.	A	G	2	4	6	0	0	6	0	0
25	7693323	.	C	A	2	3	5	0	0	5	0	0
25	7693339	.	A	C	4	7	11	0	0	11	0	0
25	7693889	.	C	T	5	5	10	3	0	13	0	0
25	7694471	.	C	G	2	3	5	0	0	5	0	0
25	7694577	.	A	T	3	5	8	0	1	9	0	0
25	7694855	.	T	G	2	3	5	1	0	6	0	0
25	7695070	.	G	A	1	2	3	0	0	3	0	0
25	7696755	.	G	T	1	2	3	0	1	4	0	0
25	7891965	.	T	C	1	2	3	1	0	4	0	0
25	8478814	.	T	C	5	7	12	0	0	12	0	0
25	8478869	.	T	C	7	1	8	0	3	11	0	0
25	8482771	.	G	A	3	11	14	0	0	14	0	0
25	8482837	.	C	T	1	7	8	0	0	8	0	0
25	8486622	.	C	T	0	14	14	0	3	17	0	0
25	8486631	.	A	C	2	1	3	0	15	18	0	0
25	8486705	.	A	G	2	10	12	0	1	13	0	0
25	8486884	.	T	A	5	10	15	0	0	15	0	0
25	8492339	.	A	G	4	2	6	0	2	8	0	0
25	8495246	.	A	G	2	10	12	0	0	12	0	0
25	8497786	.	G	A	4	6	10	0	0	10	0	0
25	8500663	.	T	G	5	2	7	0	0	7	0	0
25	8505325	.	T	A	1	2	3	0	1	4	0	0
25	8506991	.	C	T	0	2	2	0	4	6	0	0
25	8551230	.	T	C	7	4	11	0	1	12	0	0
25	8581619	.	C	T	6	2	8	0	0	8	0	0
25	8581620	.	A	G	6	2	8	0	0	8	0	0
25	8585178	.	A	C	0	2	2	0	1	3	0	0
25	8585199	.	G	A	1	3	4	0	1	5	0	0
25	8624335	.	G	A	2	2	4	0	1	5	0	0
25	8624914	.	T	C	1	2	3	0	0	3	0	0
25	8627940	.	G	A	5	6	11	0	1	12	0	0
25	8627943	.	T	C	5	8	13	0	0	13	0	0
25	8628139	.	G	C	7	4	11	0	0	11	0	0
25	8630910	.	A	G	4	9	13	0	0	13	0	0
25	8631015	.	A	T	9	4	13	0	1	14	0	0
25	8631017	.	C	T	0	10	10	0	4	14	0	0
25	8642211	.	A	G	6	5	11	0	0	11	0	0
25	8642262	.	C	T	6	8	14	0	0	14	0	0
25	8646583	.	A	T	1	2	3	0	1	4	0	0
25	8646670	.	A	G	1	3	4	0	0	4	0	0
25	8649626	.	A	G	5	2	7	0	0	7	0	0
25	8700603	.	G	A	0	2	2	0	2	4	0	0
25	8736254	.	C	T	2	2	4	0	1	5	0	0
25	8739444	.	T	A	4	3	7	0	0	7	0	0
25	8739881	.	A	T	4	4	8	0	0	8	0	0
25	8740013	.	G	C	4	3	7	0	0	7	0	0
25	8740236	.	G	T	1	3	4	0	7	11	0	0
25	8740545	.	G	A	1	5	6	1	13	20	0	0
25	8740550	.	G	C	13	5	18	1	0	19	0	0
25	8741303	.	C	T	10	6	16	0	0	16	0	0
25	8741469	.	T	A	4	3	7	1	0	8	0	0
25	8741471	.	C	T	3	2	5	0	2	7	0	0
25	8741549	.	A	G	3	1	4	0	5	9	0	0
25	8741624	.	C	T	7	5	12	0	0	12	0	0
25	8741758	.	C	T	8	5	13	0	1	14	0	0
25	8741759	.	G	T	1	6	7	0	8	15	0	0
25	8741877	.	G	C	8	10	18	0	2	20	0	0
25	8741968	.	G	C	11	6	17	2	2	21	0	0
25	8742126	.	T	C	18	15	33	0	4	37	0	0
25	8742148	.	T	A	15	12	27	0	3	30	0	0
25	8756099	.	T	C	2	8	10	0	1	11	0	0
25	8756492	.	A	G	1	5	6	0	0	6	0	0
25	8756573	.	C	A	1	11	12	0	1	13	0	0
25	8757038	.	A	C	7	0	7	0	24	31	0	0
25	8767925	.	A	G	9	26	35	0	0	35	0	0
25	8773257	.	A	G	4	23	27	0	0	27	0	0
25	8773867	.	T	G	2	10	12	0	0	13	1	0
25	8773897	.	C	T	5	13	18	0	1	19	0	0
25	8791174	.	A	G	4	19	23	0	1	24	0	0
25	8834967	.	T	G	3	14	17	0	0	17	0	0
25	8834968	.	G	C	3	0	3	0	14	17	0	0
25	8852072	.	A	T	4	4	8	1	0	9	0	0
25	8916632	.	G	A	2	2	4	0	0	4	0	0
25	8916635	.	C	G	2	2	4	0	0	4	0	0
25	8922331	.	C	T	1	3	4	0	0	4	0	0
25	8925678	.	C	A	3	1	4	0	1	5	0	0
25	8925778	.	G	A	1	2	3	0	0	3	0	0
25	8925928	.	T	C	2	2	4	0	0	4	0	0
25	8940231	.	G	A	0	6	6	0	2	8	0	0
25	8940242	.	T	C	1	3	4	0	0	4	0	0
25	8940269	.	G	T	3	2	5	0	1	6	0	0
25	8946942	.	T	C	5	6	11	0	0	11	0	0
25	8948700	.	G	A	0	5	5	0	4	9	0	0
25	8948978	.	C	A	5	8	13	0	0	13	0	0
25	8949062	.	A	T	7	8	15	0	1	16	0	0
25	8949124	.	C	T	6	6	12	0	0	12	0	0
25	8949518	.	C	A	5	2	7	0	0	8	1	0
25	9010856	.	T	C	1	2	3	0	0	3	0	0
25	9011600	.	G	A	1	3	4	0	0	4	0	0
25	9040553	.	A	G	2	2	4	0	0	4	0	0
25	9040572	.	A	G	1	2	3	0	0	3	0	0
25	9678666	.	G	A	5	6	11	0	2	13	0	0
25	9679242	.	G	A	11	11	22	0	0	22	0	0
25	9679389	.	G	A	8	6	14	0	0	14	0	0
25	9679413	.	C	T	0	4	4	0	7	11	0	0
25	9679539	.	T	C	6	4	10	0	0	10	0	0
25	9805253	.	G	C	3	2	5	0	0	5	0	0
25	9805257	.	G	C	3	2	5	0	0	5	0	0
25	11796531	.	T	C	12	0	12	0	12	24	0	0
25	11796579	.	T	A	20	15	35	0	1	36	0	0
25	11796728	.	A	T	16	18	34	0	2	36	0	0
25	11796860	.	T	C	12	18	30	0	2	32	0	0
25	11796973	.	T	C	15	0	15	0	10	25	0	0
25	11796987	.	A	G	15	5	20	0	0	20	0	0
25	11797056	.	G	C	9	5	14	0	1	15	0	0
25	11797515	.	A	G	11	14	25	0	1	26	0	0
25	11797550	.	G	T	11	11	22	0	0	22	0	0
25	11797789	.	A	T	7	7	14	0	0	14	0	0
25	11797912	.	T	A	7	3	10	0	0	10	0	0
25	11797979	.	A	G	2	3	5	0	0	5	0	0
25	11797990	.	A	G	2	2	4	0	0	4	0	0
25	11798043	.	G	A	7	5	12	0	0	12	0	0
25	11798081	.	T	C	10	1	11	0	5	16	0	0
25	11798215	.	A	C	12	3	15	0	1	16	0	0
25	11798227	.	T	A	9	2	11	0	2	13	0	0
25	11798333	.	A	T	2	6	8	0	0	8	0	0
25	11798381	.	T	A	6	9	15	0	0	15	0	0
25	11798509	.	A	T	2	13	15	0	2	17	0	0
25	11798511	.	C	A	0	13	13	0	4	17	0	0
25	11798598	.	C	T	5	6	11	0	1	12	0	0
25	11798863	.	G	C	1	4	5	0	1	6	0	0
25	11799527	.	A	T	9	6	15	2	0	17	0	0
25	11799577	.	G	A	7	5	12	2	1	15	0	0
25	11799625	.	A	T	9	6	15	0	2	17	0	0
25	11799670	.	G	T	8	4	12	0	2	14	0	0
25	11799685	.	A	G	7	2	9	0	2	11	0	0
25	11800098	.	G	C	3	6	9	0	0	9	0	0
25	11800140	.	A	G	3	4	7	0	0	7	0	0
25	11800319	.	T	G	1	3	4	0	0	4	0	0
25	11800522	.	G	A	5	3	8	0	0	8	0	0
25	11800652	.	C	T	0	5	5	0	4	9	0	0
25	11800883	.	C	T	5	3	8	0	0	8	0	0
25	11801642	.	C	G	3	4	7	0	0	7	0	0
25	11801731	.	C	G	1	2	3	0	0	3	0	0
25	11802066	.	C	G	1	2	3	0	1	4	0	0
25	11802115	.	C	A	4	3	7	0	1	8	0	0
25	11802192	.	T	A	3	5	8	0	0	8	0	0
25	11802306	.	C	A	0	4	4	0	6	10	0	0
25	11802485	.	C	T	1	4	5	0	6	11	0	0
25	11804688	.	T	G	5	3	8	0	0	8	0	0
25	11833526	.	G	A	1	1	2	0	1	3	0	0
25	12656712	.	C	G	4	5	9	0	0	9	0	0
25	12657193	.	C	T	4	4	8	0	0	8	0	0
25	12688845	.	C	T	5	2	7	0	0	7	0	0
25	12689250	.	G	A	4	10	14	0	1	15	0	0
25	12689537	.	T	C	5	4	9	0	1	10	0	0
25	12689546	.	A	G	5	0	5	0	4	9	0	0
25	12689649	.	C	T	4	6	10	0	0	10	0	0
25	12695051	.	T	C	3	6	9	0	0	9	0	0
25	12695205	.	C	G	7	0	7	0	12	19	0	0
25	12695449	.	A	T	11	9	20	0	0	20	0	0
25	12695658	.	C	T	8	10	18	0	0	18	0	0
25	12717574	.	C	T	8	4	12	1	0	13	0	0
25	12723890	.	G	A	2	3	5	0	0	5	0	0
25	12729928	.	A	G	3	2	5	0	0	5	0	0
25	12800949	.	C	T	4	2	6	0	0	6	0	0
25	12804003	.	A	G	3	2	5	0	0	5	0	0
25	12804006	.	A	G	2	2	4	0	1	5	0	0
25	12804458	.	T	C	3	3	6	0	0	6	0	0
25	12808851	.	A	G	2	3	5	0	0	5	0	0
25	12816683	.	G	A	6	8	14	0	3	17	0	0
25	12816913	.	G	A	5	8	13	0	0	13	0	0
25	12818948	.	T	G	6	3	9	0	1	10	0	0
25	12823185	.	G	A	5	5	10	0	0	10	0	0
25	12853243	.	C	T	2	2	4	0	3	7	0	0
25	12853407	.	A	T	29	26	55	0	0	55	0	0
25	12853519	.	A	G	21	28	49	0	4	53	0	0
25	12853602	.	T	C	18	34	52	0	2	54	0	0
25	12853611	.	T	A	19	34	53	0	1	54	0	0
25	12853691	.	C	T	23	25	48	1	1	50	0	0
25	12853762	.	T	C	21	0	21	0	31	52	0	0
25	12853850	.	A	C	21	13	34	0	4	38	0	0
25	12853971	.	T	A	42	16	58	0	2	60	0	0
25	12854016	.	G	A	35	22	57	0	1	58	0	0
25	12854021	.	T	A	32	18	50	1	5	56	0	0
25	12854099	.	C	A	30	29	59	0	0	59	0	0
25	12854266	.	A	T	35	15	50	3	4	58	1	0
25	12854279	.	T	G	22	33	55	1	2	58	0	0
25	12854393	.	T	C	16	30	46	0	1	47	0	0
25	12856663	.	G	A	20	17	37	0	2	39	0	0
25	12901551	.	G	A	9	12	21	0	1	22	0	0
25	12906814	.	G	A	13	9	22	0	0	22	0	0
25	12936876	.	T	C	1	4	5	1	1	7	0	0
25	12936883	.	C	A	1	4	5	1	0	6	0	0
25	13048593	.	C	T	2	4	6	0	0	6	0	0
25	13069954	.	C	T	4	5	9	0	0	9	0	0
25	13069960	.	T	G	4	3	7	0	2	9	0	0
25	13104393	.	T	C	3	5	8	0	1	9	0	0
25	13332406	.	A	T	35	35	70	0	1	71	0	0
25	13332531	.	C	T	32	30	62	0	5	67	0	0
25	13332693	.	G	A	38	36	74	0	3	77	0	0
25	13333191	.	G	T	45	32	77	0	1	78	0	0
25	13333463	.	G	A	40	31	71	0	16	87	0	0
25	13333508	.	A	T	48	27	75	0	7	82	0	0
25	13333665	.	C	T	33	32	65	3	1	69	0	0
25	13333839	.	A	T	40	16	56	0	6	62	0	0
25	13333986	.	T	A	32	47	79	0	1	81	1	0
25	13334229	.	A	G	29	33	62	0	1	63	0	0
25	13334236	.	T	C	30	32	62	0	3	65	0	0
25	13334269	.	G	A	29	31	60	0	1	61	0	0
25	13334275	.	A	T	30	28	58	0	2	60	0	0
25	13334304	.	T	C	25	0	25	0	26	51	0	0
25	13334487	.	A	T	26	20	46	0	0	46	0	0
25	13334729	.	C	T	46	26	72	0	5	77	0	0
25	13334977	.	A	T	31	33	64	0	6	70	0	0
25	13335012	.	A	G	32	38	70	0	0	70	0	0
25	13335021	.	G	T	36	28	64	0	2	66	0	0
25	13335185	.	A	G	29	31	60	0	2	62	0	0
25	13335225	.	T	C	33	29	62	0	2	64	0	0
25	13335378	.	T	C	28	33	61	0	4	65	0	0
25	13335432	.	T	A	31	23	54	0	4	58	0	0
25	13335441	.	G	A	29	28	57	0	1	58	0	0
25	13335469	.	T	G	26	25	51	0	8	59	0	0
25	13335505	.	C	A	23	22	45	0	2	47	0	0
25	13335558	.	G	T	22	35	57	0	3	60	0	0
25	13335562	.	G	A	22	37	59	0	3	62	0	0
25	13335762	.	C	T	21	7	28	1	0	29	0	0
25	13335765	.	C	T	4	8	12	1	19	32	0	0
25	13336277	.	G	A	18	21	39	0	2	41	0	0
25	13336323	.	T	G	26	28	54	0	4	58	0	0
25	13336343	.	T	C	31	29	60	0	1	61	0	0
25	13336493	.	A	G	30	31	61	0	1	62	0	0
25	13336545	.	T	C	25	23	48	0	6	54	0	0
25	13336598	.	C	G	29	29	58	0	3	61	0	0
25	13336815	.	T	A	24	32	56	0	3	59	0	0
25	13336846	.	T	C	34	21	55	1	7	63	0	0
25	13336861	.	A	G	42	17	59	1	1	61	0	0
25	13336967	.	T	A	21	29	50	0	4	54	0	0
25	13337272	.	G	A	25	40	65	0	3	68	0	0
25	13337338	.	G	A	31	32	63	1	2	66	0	0
25	13340180	.	C	T	32	22	54	0	3	57	0	0
25	13340198	.	T	C	19	1	20	0	31	51	0	0
25	13346723	.	G	A	27	24	51	0	1	52	0	0
25	13352304	.	T	A	19	8	27	0	2	29	0	0
25	13353663	.	A	T	16	13	29	0	1	30	0	0
25	13363206	.	C	T	0	6	6	0	8	14	0	0
25	13363248	.	G	T	9	13	22	0	1	23	0	0
25	13363258	.	G	A	9	12	21	0	1	22	0	0
25	13469844	.	A	G	6	2	8	0	17	25	0	0
25	13470123	.	T	C	21	20	41	0	1	42	0	0
25	13470424	.	C	T	20	11	31	0	2	33	0	0
25	13471079	.	A	C	14	22	36	0	1	38	1	0
25	13474362	.	C	G	6	8	14	0	1	15	0	0
25	13478185	.	G	T	9	7	16	0	0	16	0	0
25	13478217	.	T	G	7	4	11	0	1	12	0	0
25	13479710	.	G	A	6	4	10	0	0	10	0	0
25	13484787	.	A	G	5	5	10	0	1	11	0	0
25	13484791	.	T	C	4	4	8	0	2	10	0	0
25	13485370	.	A	T	4	6	10	0	0	10	0	0
25	13525848	.	A	T	4	9	13	0	0	13	0	0
25	13525864	.	G	A	4	8	12	0	0	12	0	0
25	13526171	.	A	C	10	12	22	1	2	25	0	0
25	13528361	.	G	A	3	2	5	0	0	5	0	0
25	13528732	.	G	A	8	4	12	0	0	12	0	0
25	13529294	.	A	G	4	7	11	0	0	11	0	0
25	13531933	.	G	A	3	2	5	0	0	5	0	0
25	13559168	.	T	G	8	4	12	0	0	12	0	0
25	13559194	.	G	A	15	8	23	0	0	23	0	0
25	13559548	.	T	A	8	9	17	0	5	22	0	0
25	13559633	.	T	C	9	0	9	0	8	17	0	0
25	13559950	.	G	A	12	4	16	0	0	16	0	0
25	13559953	.	A	T	5	12	17	0	0	17	0	0
25	13560080	.	C	T	4	4	8	0	0	8	0	0
25	13560518	.	G	A	14	4	18	0	2	20	0	0
25	13560638	.	C	A	2	3	5	0	0	5	0	0
25	13561133	.	T	C	1	7	8	0	0	8	0	0
25	13561149	.	T	C	1	6	7	0	0	7	0	0
25	13562044	.	T	A	1	2	3	0	0	3	0	0
25	13614475	.	G	C	1	1	2	0	2	4	0	0
25	13643476	.	G	A	14	16	30	0	2	32	0	0
25	13645911	.	C	T	13	16	29	0	3	32	0	0
25	13646153	.	G	A	18	9	27	0	1	28	0	0
25	13649206	.	C	T	0	7	7	1	6	14	0	0
25	13658450	.	G	A	4	3	7	0	0	7	0	0
25	13658468	.	C	T	2	3	5	0	3	8	0	0
25	13658681	.	G	A	6	6	12	0	1	13	0	0
25	13658940	.	G	A	4	2	6	0	2	8	0	0
25	13664035	.	C	A	1	2	3	0	0	3	0	0
25	13672111	.	A	T	3	6	9	0	0	9	0	0
25	13673455	.	C	T	3	4	7	0	0	7	0	0
25	13677396	.	A	G	2	2	4	0	0	4	0	0
25	13677726	.	G	C	1	5	6	0	1	7	0	0
25	13689612	.	A	G	2	4	6	0	0	6	0	0
25	13689617	.	C	A	2	4	6	0	0	6	0	0
25	13689972	.	G	A	3	5	8	0	0	8	0	0
25	13690001	.	G	T	5	6	11	0	0	11	0	0
25	13737735	.	A	C	3	2	5	0	0	5	0	0
25	13744587	.	T	C	1	4	5	0	0	5	0	0
25	13745665	.	A	G	34	28	62	0	0	62	0	0
25	13745776	.	A	G	31	29	60	0	2	62	0	0
25	13750695	.	G	A	20	15	35	0	3	38	0	0
25	13750734	.	T	A	15	10	25	0	2	27	0	0
25	13762759	.	G	C	13	11	24	0	1	25	0	0
25	13762889	.	T	C	3	7	10	0	1	11	0	0
25	13763641	.	C	T	5	4	9	0	1	10	0	0
25	13766021	.	G	T	7	5	12	0	0	12	0	0
25	13766062	.	G	A	4	4	8	0	1	9	0	0
25	13767612	.	G	A	1	7	8	0	0	8	0	0
25	13773970	.	G	A	3	5	8	0	0	8	0	0
25	13774036	.	C	T	4	5	9	0	1	10	0	0
25	13775158	.	A	G	2	7	9	0	0	9	0	0
25	13776838	.	C	T	4	4	8	0	0	8	0	0
25	13780322	.	C	G	5	3	8	0	0	8	0	0
25	13790004	.	T	A	1	3	4	0	0	4	0	0
25	13799158	.	A	C	1	5	6	0	0	6	0	0
25	13799172	.	G	A	4	7	11	0	0	11	0	0
25	13799226	.	C	T	4	3	7	0	0	7	0	0
25	13799359	.	A	C	18	15	33	0	1	34	0	0
25	13799434	.	T	C	15	25	40	0	3	43	0	0
25	13799458	.	T	C	15	29	44	0	2	46	0	0
25	13799689	.	C	T	16	18	34	0	2	36	0	0
25	13799830	.	A	G	9	27	36	0	2	38	0	0
25	13801768	.	C	A	11	12	23	0	0	23	0	0
25	13801895	.	G	C	17	19	36	0	2	38	0	0
25	13801933	.	C	T	21	14	35	0	2	37	0	0
25	13802100	.	C	T	30	14	44	0	3	47	0	0
25	13802451	.	A	G	18	14	32	0	5	37	0	0
25	13802673	.	C	T	3	12	15	0	15	30	0	0
25	13802688	.	C	A	17	12	29	0	3	32	0	0
25	13802710	.	C	T	13	19	32	0	0	32	0	0
25	13802876	.	G	A	13	26	39	0	1	40	0	0
25	13802901	.	G	A	13	20	33	0	2	35	0	0
25	13802918	.	A	G	15	18	33	0	0	33	0	0
25	13802940	.	A	T	17	15	32	0	2	35	1	0
25	13803710	.	A	G	21	8	29	0	0	29	0	0
25	13803712	.	T	G	20	8	28	0	0	29	1	0
25	13803895	.	A	G	11	11	22	0	1	23	0	0
25	13804000	.	A	C	12	0	12	0	12	24	0	0
25	13804056	.	C	T	13	16	29	0	2	31	0	0
25	13804093	.	A	G	15	18	33	0	2	35	0	0
25	13804169	.	G	T	16	15	31	0	2	33	0	0
25	13804216	.	C	T	16	11	27	0	1	28	0	0
25	13808756	.	A	G	20	5	25	0	5	30	0	0
25	13813824	.	G	T	14	13	27	0	0	27	0	0
25	13813827	.	A	G	13	14	27	0	1	28	0	0
25	13815325	.	G	A	12	10	22	0	0	22	0	0
25	13816724	.	G	A	9	3	12	0	0	12	0	0
25	13816840	.	C	T	0	6	6	0	6	12	0	0
25	13817135	.	C	G	6	8	14	0	1	15	0	0
25	13817168	.	T	A	5	8	13	0	2	15	0	0
25	13817243	.	C	T	0	7	7	0	6	13	0	0
25	13821187	.	C	T	7	6	13	0	1	14	0	0
25	13846984	.	A	G	2	9	11	0	0	11	0	0
25	13846990	.	A	G	1	10	11	0	0	11	0	0
25	13847301	.	C	T	3	11	14	0	17	31	0	0
25	13847533	.	A	G	14	5	19	0	3	22	0	0
25	13850757	.	A	C	14	21	35	0	2	37	0	0
25	13854838	.	G	A	11	5	16	0	0	16	0	0
25	13855707	.	T	A	8	9	17	0	0	17	0	0
25	13862188	.	G	A	6	3	9	0	0	9	0	0
25	13862233	.	T	G	2	3	5	0	0	5	0	0
25	13869025	.	T	C	3	2	5	0	0	5	0	0
25	13871100	.	A	G	3	2	5	0	0	5	0	0
25	14017834	.	G	A	1	3	4	0	10	14	0	0
25	14018043	.	T	C	5	4	9	0	0	9	0	0
25	14019501	.	G	T	8	9	17	0	0	17	0	0
25	14019879	.	A	T	8	18	26	0	2	28	0	0
25	14019921	.	G	A	1	6	7	0	14	21	0	0
25	14020279	.	G	A	21	8	29	0	1	30	0	0
25	14020780	.	G	A	9	3	12	0	1	13	0	0
25	14020806	.	T	A	8	4	12	0	0	12	0	0
25	14020828	.	A	G	9	0	9	0	3	12	0	0
25	14020973	.	C	T	4	4	8	0	2	10	0	0
25	14021000	.	A	C	6	4	10	0	0	10	0	0
25	14021062	.	A	G	2	2	4	0	0	4	0	0
25	14021070	.	T	C	2	1	3	0	1	4	0	0
25	14033268	.	T	C	23	14	37	0	2	39	0	0
25	14033657	.	T	C	6	12	18	0	3	21	0	0
25	14033867	.	A	G	11	7	18	0	2	20	0	0
25	14033914	.	G	A	8	7	15	0	0	15	0	0
25	14034033	.	T	C	3	5	8	0	0	8	0	0
25	14034240	.	G	C	18	16	34	0	0	34	0	0
25	14034354	.	T	G	10	13	23	0	1	24	0	0
25	14034620	.	A	G	6	9	15	0	0	15	0	0
25	14034637	.	G	A	10	7	17	0	2	19	0	0
25	14034805	.	C	G	0	9	9	0	8	17	0	0
25	14034824	.	C	T	8	12	20	0	0	20	0	0
25	14034929	.	G	A	9	6	15	0	2	17	0	0
25	14035505	.	T	C	3	7	10	1	0	11	0	0
25	14035567	.	C	A	7	3	10	0	0	10	0	0
25	14035908	.	A	C	5	2	7	0	0	7	0	0
25	14036172	.	C	A	10	5	15	0	2	17	0	0
25	14036187	.	A	T	11	3	14	0	2	16	0	0
25	14036535	.	G	T	3	7	10	0	0	10	0	0
25	14086393	.	A	T	2	5	7	0	1	8	0	0
25	14309785	.	G	A	3	2	5	0	0	5	0	0
25	14361812	.	C	T	9	4	13	0	0	13	0	0
25	14361815	.	T	C	10	4	14	0	0	14	0	0
25	14362292	.	T	A	4	4	8	0	2	10	0	0
25	14362340	.	C	T	6	6	12	0	0	12	0	0
25	14362355	.	A	G	5	5	10	0	0	10	0	0
25	14365618	.	C	T	17	18	35	0	2	37	0	0
25	14369506	.	A	G	6	3	9	0	0	9	0	0
25	14369587	.	G	T	10	7	17	0	2	19	0	0
25	14369883	.	T	C	12	4	16	0	10	26	0	0
25	14374076	.	G	A	5	5	10	0	1	11	0	0
25	14381564	.	A	G	8	19	27	0	2	29	0	0
25	14381583	.	A	G	8	21	29	0	0	29	0	0
25	14387391	.	G	A	18	13	31	1	0	32	0	0
25	14388955	.	A	T	14	5	19	0	1	20	0	0
25	14392871	.	T	C	10	4	14	0	0	14	0	0
25	14393438	.	T	C	8	1	9	0	11	20	0	0
25	14398193	.	A	T	13	4	17	0	0	17	0	0
25	14398741	.	T	C	8	5	13	0	0	13	0	0
25	14398744	.	A	T	5	8	13	0	0	13	0	0
25	14401150	.	C	T	6	3	9	0	0	9	0	0
25	14401219	.	C	A	11	5	16	0	0	16	0	0
25	14401432	.	G	A	2	12	14	0	10	24	0	0
25	14403297	.	C	T	16	14	30	0	1	31	0	0
25	14403961	.	C	T	11	5	16	0	1	17	0	0
25	14406494	.	G	A	16	19	35	0	2	37	0	0
25	14406530	.	T	A	19	17	36	0	1	37	0	0
25	14406608	.	A	C	7	4	11	0	1	12	0	0
25	14409123	.	C	T	3	3	6	0	0	6	0	0
25	14409140	.	C	T	0	3	3	0	5	8	0	0
25	14409179	.	C	G	1	4	5	0	0	5	0	0
25	14415893	.	A	G	2	2	4	0	0	4	0	0
25	14415904	.	T	C	2	2	4	0	0	4	0	0
25	14511951	.	C	A	1	1	2	0	0	2	0	0
25	14511958	.	A	G	1	2	3	0	0	3	0	0
25	14695092	.	C	T	7	3	10	0	1	11	0	0
25	14700609	.	T	C	5	3	8	0	0	8	0	0
25	14702794	.	G	C	3	2	5	0	0	5	0	0
25	14702821	.	C	T	4	2	6	0	0	6	0	0
25	14733824	.	C	T	5	8	13	0	3	16	0	0
25	14738132	.	C	T	8	5	13	0	0	13	0	0
25	14738499	.	T	G	4	6	10	0	0	10	0	0
25	14738716	.	T	C	9	3	12	0	2	14	0	0
25	14897926	.	A	T	1	2	3	0	0	3	0	0
25	15029575	.	C	T	11	12	23	0	1	24	0	0
25	15034012	.	C	T	0	7	7	0	8	15	0	0
25	15045221	.	T	A	3	2	5	0	0	5	0	0
25	15278014	.	G	A	0	2	2	0	3	5	0	0
25	15281889	.	C	T	7	7	14	0	2	16	0	0
25	15281891	.	A	G	8	8	16	0	0	16	0	0
25	15284440	.	T	C	11	4	15	0	0	15	0	0
25	15284611	.	T	C	8	8	16	0	1	17	0	0
25	15284734	.	G	T	16	14	30	0	0	30	0	0
25	15284799	.	C	T	17	12	29	0	2	31	0	0
25	15284862	.	T	C	12	13	25	0	0	25	0	0
25	15284979	.	T	A	17	14	31	0	0	31	0	0
25	15285092	.	T	C	9	12	21	0	1	22	0	0
25	15285105	.	C	A	11	11	22	0	0	22	0	0
25	15285202	.	A	C	9	12	21	0	2	23	0	0
25	15285213	.	G	C	16	11	27	0	0	27	0	0
25	15285255	.	C	A	12	15	27	0	0	27	0	0
25	15285256	.	T	A	14	11	25	0	1	26	0	0
25	15285374	.	A	G	18	12	30	0	2	32	0	0
25	15285384	.	G	A	19	13	32	0	1	33	0	0
25	15285470	.	C	T	5	10	15	0	1	16	0	0
25	15285471	.	C	A	5	10	15	0	1	16	0	0
25	15343016	.	C	A	2	2	4	0	0	4	0	0
25	15345474	.	C	A	3	2	5	0	0	5	0	0
25	15345518	.	C	T	3	2	5	0	0	5	0	0
25	15347688	.	G	A	1	2	3	0	2	5	0	0
25	15347852	.	G	A	0	3	3	0	1	4	0	0
25	15348042	.	T	A	2	2	4	0	0	4	0	0
25	15350012	.	A	G	3	9	12	0	0	12	0	0
25	15350058	.	A	G	4	8	12	0	2	14	0	0
25	15351088	.	A	G	15	5	20	0	0	20	0	0
25	15404898	.	G	A	4	5	9	0	0	9	0	0
25	15408816	.	G	A	0	3	3	0	10	13	0	0
25	15408820	.	G	A	0	9	9	0	4	13	0	0
25	15408883	.	G	A	11	6	17	0	2	19	0	0
25	15408918	.	C	T	10	7	17	0	1	18	0	0
25	15408939	.	C	T	8	10	18	0	0	18	0	0
25	15432769	.	G	A	8	11	19	0	1	20	0	0
25	15434479	.	T	A	8	12	20	0	1	21	0	0
25	15434579	.	C	T	8	10	18	0	3	21	0	0
25	15438789	.	C	A	12	7	19	0	5	24	0	0
25	15472103	.	C	T	19	23	42	0	3	45	0	0
25	15472286	.	C	A	17	27	44	0	7	51	0	0
25	15477186	.	G	A	3	12	15	0	28	43	0	0
25	15478092	.	A	G	20	37	57	0	0	57	0	0
25	15478474	.	T	C	32	19	51	0	3	54	0	0
25	15480676	.	G	A	5	22	27	0	32	59	0	0
25	15480712	.	T	C	24	32	56	0	1	57	0	0
25	15481040	.	C	T	21	16	37	4	11	52	0	0
25	15481481	.	T	G	24	14	38	0	0	38	0	0
25	15482014	.	A	T	31	14	45	2	2	49	0	0
25	15482138	.	A	G	18	0	18	0	26	44	0	0
25	15648237	.	T	A	2	4	6	0	0	6	0	0
25	15648243	.	C	A	2	4	6	0	0	6	0	0
25	17920837	.	T	C	1	5	6	0	0	6	0	0
25	18885963	.	A	G	4	2	6	0	1	7	0	0
25	18907424	.	A	G	3	1	4	1	0	5	0	0
25	18907433	.	A	G	3	2	5	1	0	6	0	0
25	18907515	.	A	G	2	2	4	0	0	4	0	0
25	18907847	.	A	G	1	2	3	0	0	3	0	0
25	18961792	.	A	T	4	2	6	0	1	7	0	0
25	18963193	.	A	G	9	3	12	0	1	13	0	0
25	18963200	.	A	G	9	2	11	0	0	11	0	0
25	18977066	.	A	G	4	5	9	0	1	10	0	0
25	18977092	.	A	G	7	6	13	0	0	13	0	0
25	18977346	.	A	G	5	0	5	0	4	9	0	0
25	18977347	.	A	G	4	4	8	0	0	8	0	0
25	19133191	.	A	G	1	2	3	0	0	3	0	0
25	19134470	.	C	T	4	2	6	0	0	6	0	0
25	19178206	.	T	C	1	2	3	0	0	3	0	0
25	19179081	.	C	A	1	2	3	0	0	3	0	0
25	19180159	.	C	T	1	2	3	0	0	3	0	0
25	19180222	.	G	T	1	4	5	0	0	5	0	0
25	19188895	.	A	G	2	0	2	0	1	3	0	0
25	19205783	.	G	C	3	2	5	0	0	5	0	0
25	19315543	.	A	G	2	0	2	0	3	5	0	0
25	19357346	.	A	C	35	31	66	0	2	68	0	0
25	19357359	.	T	G	32	28	60	0	2	62	0	0
25	19357782	.	G	C	25	24	49	0	0	49	0	0
25	19357800	.	T	C	22	22	44	0	1	45	0	0
25	19357934	.	G	A	34	12	46	0	3	49	0	0
25	19358924	.	T	A	19	7	26	0	2	28	0	0
25	19359191	.	T	C	16	11	27	0	1	28	0	0
25	19359205	.	G	A	15	15	30	0	0	30	0	0
25	19359314	.	G	A	22	12	34	0	1	35	0	0
25	19359402	.	A	G	16	19	35	0	1	36	0	0
25	19359640	.	C	T	1	19	20	0	17	37	0	0
25	19359734	.	A	G	26	18	44	0	4	48	0	0
25	19363994	.	G	C	11	0	11	0	18	29	0	0
25	19367753	.	A	T	7	4	11	0	0	11	0	0
25	19373330	.	G	A	3	3	6	0	0	6	0	0
25	19373597	.	C	T	3	3	6	0	0	6	0	0
25	19442955	.	G	A	22	26	48	0	5	53	0	0
25	19443356	.	C	T	19	31	50	0	3	53	0	0
25	19485884	.	C	T	0	7	7	0	11	18	0	0
25	19486270	.	C	T	1	10	11	0	7	18	0	0
25	19486287	.	G	T	10	8	18	0	1	19	0	0
25	19512981	.	G	A	2	2	4	0	1	5	0	0
25	19520520	.	C	T	3	5	8	0	1	9	0	0
25	19531931	.	C	A	3	4	7	0	0	7	0	0
25	19535338	.	C	T	3	3	6	0	0	6	0	0
25	19535374	.	G	A	3	6	9	0	1	10	0	0
25	19535639	.	T	A	2	2	4	0	0	4	0	0
25	19535727	.	G	T	4	2	6	0	0	6	0	0
25	19535746	.	C	T	4	2	6	0	0	6	0	0
25	19535782	.	G	T	4	3	7	0	0	7	0	0
25	19552150	.	A	G	1	0	1	0	3	4	0	0
25	19556755	.	A	G	1	5	6	0	1	7	0	0
25	19560372	.	A	G	1	0	1	0	2	3	0	0
25	19560578	.	G	A	1	3	4	0	2	6	0	0
25	19560744	.	C	T	5	4	9	0	0	9	0	0
25	19562558	.	G	A	9	4	13	0	0	13	0	0
25	19562756	.	C	T	7	5	12	0	1	13	0	0
25	19570725	.	T	A	1	4	5	0	1	6	0	0
25	19570995	.	T	G	4	2	6	0	0	6	0	0
25	19585916	.	C	A	9	13	22	0	2	24	0	0
25	19586249	.	A	T	11	11	22	0	0	22	0	0
25	19591844	.	T	C	5	6	11	1	0	12	0	0
25	19593972	.	T	C	4	0	4	0	4	8	0	0
25	19594008	.	T	C	7	4	11	0	1	12	0	0
25	19594011	.	A	C	8	4	12	0	0	12	0	0
25	19610569	.	C	T	0	3	3	0	4	7	0	0
25	19610645	.	G	A	4	2	6	0	0	6	0	0
25	19667602	.	G	C	0	5	5	0	4	9	0	0
25	19667653	.	T	C	1	4	5	0	1	6	0	0
25	19667669	.	C	T	2	1	3	0	0	3	0	0
25	19670365	.	A	G	3	3	6	0	0	6	0	0
25	19670378	.	C	T	2	3	5	0	0	5	0	0
25	19676240	.	C	T	2	2	4	0	0	4	0	0
25	19676241	.	G	A	0	2	2	0	2	4	0	0
25	19676276	.	C	A	2	2	4	0	0	4	0	0
25	19676426	.	C	A	2	2	4	0	0	4	0	0
25	20669202	.	T	G	10	2	12	0	1	13	0	0
25	20716627	.	G	A	5	4	9	0	0	9	0	0
25	20718204	.	C	T	7	4	11	0	0	11	0	0
25	20721482	.	A	C	5	5	10	0	2	12	0	0
25	20721502	.	C	T	6	6	12	0	0	12	0	0
25	20724822	.	G	A	2	7	9	0	14	23	0	0
25	20724879	.	G	A	5	8	13	0	0	13	0	0
25	20726609	.	C	T	7	7	14	1	0	15	0	0
25	20726626	.	G	A	2	7	9	0	5	14	0	0
25	20726981	.	A	G	4	0	4	0	5	9	0	0
25	20730091	.	G	A	4	4	8	0	0	8	0	0
25	20730499	.	C	T	1	3	4	0	6	10	0	0
25	20730660	.	T	A	3	8	11	0	0	11	0	0
25	20730663	.	A	G	3	9	12	0	0	12	0	0
25	20997721	.	A	G	1	2	3	0	0	3	0	0
25	20997876	.	T	G	7	3	10	0	0	10	0	0
25	20998037	.	A	G	9	7	16	0	0	16	0	0
25	20998245	.	T	C	9	6	15	0	0	15	0	0
25	20998250	.	G	T	10	3	13	0	2	15	0	0
25	20998829	.	T	C	2	3	5	0	0	5	0	0
25	20999104	.	G	A	6	3	9	0	0	9	0	0
25	20999140	.	T	A	3	2	5	0	0	5	0	0
25	20999203	.	A	G	6	3	9	0	0	9	0	0
25	21064154	.	C	T	3	4	7	0	0	7	0	0
25	21064337	.	A	T	9	3	12	0	1	13	0	0
25	21064361	.	C	G	4	3	7	0	2	9	0	0
25	21064519	.	T	A	8	4	12	0	1	13	0	0
25	21065071	.	G	A	5	8	13	0	1	14	0	0
25	21065237	.	T	C	5	5	10	0	0	10	0	0
25	21075383	.	C	T	3	2	5	0	1	6	0	0
25	21075410	.	G	T	3	2	5	0	1	6	0	0
25	21075710	.	C	T	0	2	2	0	1	3	0	0
25	21114926	.	T	C	1	2	3	0	1	4	0	0
25	21115672	.	T	C	18	12	30	0	0	30	0	0
25	21115761	.	A	G	17	18	35	0	2	37	0	0
25	21115784	.	C	A	19	19	38	0	1	39	0	0
25	21117001	.	A	T	12	15	27	0	2	30	1	0
25	21119687	.	G	A	14	10	24	0	3	28	1	0
25	21119843	.	T	A	18	9	27	0	2	29	0	0
25	21121788	.	A	G	15	16	31	0	2	33	0	0
25	21121964	.	C	T	10	8	18	0	2	20	0	0
25	21122011	.	A	G	16	11	27	0	1	28	0	0
25	21122194	.	T	C	19	15	34	0	5	39	0	0
25	21122266	.	T	A	9	16	25	0	1	26	0	0
25	21122490	.	C	T	12	11	23	0	3	26	0	0
25	21122535	.	A	T	6	13	19	0	2	21	0	0
25	21122540	.	C	A	6	14	20	0	0	20	0	0
25	21124889	.	A	T	15	11	26	0	0	26	0	0
25	21125108	.	A	G	5	10	15	0	1	16	0	0
25	21125289	.	C	G	12	16	28	0	0	28	0	0
25	21125391	.	T	C	11	8	19	0	0	19	0	0
25	21125583	.	C	T	2	12	14	0	8	22	0	0
25	21125676	.	T	A	8	5	13	0	0	13	0	0
25	21129836	.	A	T	1	6	7	0	1	8	0	0
25	21132534	.	C	A	1	5	6	0	2	8	0	0
25	21153664	.	T	A	1	2	3	0	0	3	0	0
25	21153759	.	T	A	2	3	5	0	0	5	0	0
25	21194387	.	C	T	8	5	13	2	1	16	0	0
25	21194552	.	C	T	5	7	12	0	1	13	0	0
25	21194663	.	A	T	9	10	19	0	0	19	0	0
25	21194672	.	T	C	8	11	19	0	1	20	0	0
25	21202349	.	C	T	9	8	17	0	0	17	0	0
25	21208597	.	G	A	20	15	35	0	0	35	0	0
25	21213122	.	G	T	7	10	17	0	2	19	0	0
25	21222077	.	T	C	10	20	30	0	4	34	0	0
25	21222128	.	G	A	12	17	29	0	1	30	0	0
25	21229668	.	G	C	12	17	29	0	3	32	0	0
25	21229677	.	G	A	14	14	28	0	1	29	0	0
25	21239861	.	A	G	22	18	40	0	1	41	0	0
25	21239870	.	G	A	20	18	38	0	3	41	0	0
25	21240198	.	G	A	3	21	24	0	13	37	0	0
25	21240258	.	G	A	2	19	21	0	20	41	0	0
25	21253106	.	C	T	19	19	38	1	2	41	0	0
25	21276550	.	A	G	0	2	2	0	2	4	0	0
25	21277839	.	T	C	2	5	7	0	0	7	0	0
25	21277858	.	T	C	5	0	5	0	2	7	0	0
25	21277892	.	C	A	0	10	10	0	3	13	0	0
25	21278235	.	G	A	3	6	9	0	0	9	0	0
25	21278244	.	A	G	4	6	10	0	0	10	0	0
25	21280449	.	T	C	3	0	3	0	3	6	0	0
25	21280506	.	T	G	3	3	6	0	1	7	0	0
25	21298540	.	C	T	3	3	6	0	0	6	0	0
25	21341712	.	T	A	5	3	8	0	0	8	0	0
25	21343250	.	A	C	7	4	11	0	3	15	1	0
25	21343340	.	G	C	12	10	22	0	1	23	0	0
25	21343358	.	C	T	12	10	22	0	0	22	0	0
25	21343476	.	G	A	4	3	7	0	1	8	0	0
25	21343843	.	C	T	17	12	29	0	3	32	0	0
25	21344201	.	T	G	23	14	37	0	2	39	0	0
25	21344417	.	A	G	9	6	15	0	1	16	0	0
25	21518033	.	G	T	4	2	6	0	0	6	0	0
25	21521360	.	C	T	0	3	3	0	1	4	0	0
25	21521365	.	T	G	1	3	4	0	1	5	0	0
25	21521428	.	A	G	1	3	4	0	0	4	0	0
25	21521442	.	T	C	1	1	2	0	2	4	0	0
25	21522690	.	A	T	2	3	5	0	0	5	0	0
25	21538973	.	T	C	1	0	1	0	3	4	0	0
25	21737010	.	T	C	4	5	9	0	0	9	0	0
25	21738460	.	G	A	5	8	13	0	1	14	0	0
25	21739116	.	T	C	6	3	9	0	1	10	0	0
25	21741480	.	G	A	1	4	5	0	6	11	0	0
25	21743630	.	G	A	5	2	7	0	1	8	0	0
25	21743739	.	C	T	3	2	5	0	0	5	0	0
25	21782389	.	G	A	6	5	11	0	0	11	0	0
25	21833163	.	A	G	3	12	15	0	0	15	0	0
25	21833307	.	C	T	21	19	40	1	3	44	0	0
25	21833308	.	G	T	2	17	19	1	24	44	0	0
25	21834976	.	G	A	1	20	21	0	23	44	0	0
25	21835093	.	T	C	21	20	41	0	1	42	0	0
25	21835126	.	A	T	22	20	42	0	0	42	0	0
25	21838627	.	A	T	23	18	41	0	1	42	0	0
25	21838951	.	G	A	23	19	42	0	4	46	0	0
25	21838963	.	A	G	27	18	45	1	2	48	0	0
25	21838993	.	T	C	26	22	48	1	2	51	0	0
25	21841487	.	G	A	24	25	49	0	4	53	0	0
25	21847233	.	C	T	37	38	75	0	3	78	0	0
25	21860999	.	C	A	4	3	7	0	0	7	0	0
25	21861041	.	G	A	5	4	9	0	0	9	0	0
25	21863600	.	G	T	2	2	4	0	0	4	0	0
25	21865988	.	C	T	0	4	4	0	2	6	0	0
25	21866386	.	G	A	4	2	6	0	0	6	0	0
25	21866431	.	C	T	1	4	5	0	3	8	0	0
25	21893897	.	G	C	2	5	7	0	0	7	0	0
25	21893958	.	T	G	3	4	7	0	0	7	0	0
25	23448868	.	C	T	5	3	8	0	5	13	0	0
25	23555815	.	C	T	2	7	9	0	10	19	0	0
25	23555852	.	T	C	12	0	12	0	10	22	0	0
25	23555998	.	A	T	4	9	13	0	0	13	0	0
25	23556047	.	G	A	4	7	11	0	1	12	0	0
25	23556240	.	A	T	7	5	12	0	1	13	0	0
25	23556254	.	C	T	13	6	19	0	1	20	0	0
25	23556378	.	C	G	9	5	14	0	2	16	0	0
25	23560111	.	A	T	6	6	12	0	2	14	0	0
25	23562487	.	C	T	1	7	8	0	10	18	0	0
25	23570933	.	G	A	7	7	14	0	3	17	0	0
25	23571614	.	A	G	5	3	8	0	1	9	0	0
25	24593493	.	G	A	0	2	2	0	2	4	0	0
25	24594153	.	T	C	0	2	2	0	1	3	0	0
25	24594163	.	C	T	1	1	2	0	1	3	0	0
25	24594276	.	T	C	2	4	6	0	0	6	0	0
25	24594339	.	C	T	2	3	5	0	0	5	0	0
25	24598826	.	C	A	3	2	5	0	1	6	0	0
25	24598869	.	T	C	2	2	4	0	0	4	0	0
25	24605595	.	G	T	0	4	4	0	2	6	0	0
25	24605598	.	A	C	1	5	6	0	0	6	0	0
25	24609463	.	T	A	2	4	6	0	0	6	0	0
25	24610020	.	G	A	5	4	9	0	0	9	0	0
25	24610030	.	T	C	5	4	9	0	0	9	0	0
25	24610543	.	A	T	2	2	4	0	0	4	0	0
25	24610544	.	A	G	2	2	4	0	0	4	0	0
25	24714928	.	T	C	1	2	3	0	0	3	0	0
25	24736314	.	T	G	6	2	8	0	0	8	0	0
25	24736579	.	A	T	10	12	22	0	1	23	0	0
25	24736669	.	A	C	3	5	8	0	0	8	0	0
25	24736828	.	A	T	5	6	11	0	0	11	0	0
25	24736921	.	G	A	2	4	6	0	1	7	0	0
25	24737080	.	G	A	3	5	8	0	1	9	0	0
25	24737081	.	A	G	4	5	9	0	0	9	0	0
25	24737154	.	C	T	0	4	4	0	6	10	0	0
25	24737259	.	T	A	10	2	12	0	1	13	0	0
25	24737276	.	T	C	3	0	3	0	5	8	0	0
25	24737335	.	C	A	0	3	3	0	5	8	0	0
25	24738084	.	T	C	11	1	12	0	18	30	0	0
25	24738155	.	T	A	6	7	13	0	0	13	0	0
25	24738810	.	C	A	5	4	9	0	0	9	0	0
25	24738826	.	G	A	5	4	9	0	0	9	0	0
25	24738892	.	G	A	5	6	11	0	2	13	0	0
25	24739029	.	A	G	8	18	26	0	1	27	0	0
25	24752103	.	T	C	5	6	11	0	0	11	0	0
25	24752175	.	G	A	5	13	18	0	0	18	0	0
25	24752181	.	A	G	4	12	16	0	0	16	0	0
25	24752211	.	C	T	1	11	12	0	5	17	0	0
25	24763746	.	A	G	5	5	10	0	0	10	0	0
25	24763755	.	G	T	5	5	10	0	2	12	0	0
25	24763914	.	C	T	2	10	12	0	1	13	0	0
25	24770089	.	G	A	5	9	14	0	1	15	0	0
25	25123444	.	G	T	5	13	18	0	0	18	0	0
25	25123445	.	T	C	5	13	18	0	0	18	0	0
25	25124779	.	A	T	9	10	19	0	1	20	0	0
25	25127673	.	G	A	1	25	26	0	17	43	0	0
25	25130749	.	G	C	19	19	38	0	3	41	0	0
25	25130782	.	G	A	22	25	47	0	1	48	0	0
25	25130908	.	C	T	22	30	52	0	0	52	0	0
25	25130968	.	C	T	20	29	49	0	1	50	0	0
25	25131165	.	G	A	8	6	14	0	2	16	0	0
25	25131298	.	A	T	16	27	43	0	0	43	0	0
25	25131427	.	G	A	20	36	56	1	4	61	0	0
25	25132985	.	C	T	12	8	20	0	2	22	0	0
25	25133030	.	G	A	9	13	22	0	1	23	0	0
25	25133104	.	G	A	13	9	22	0	2	24	0	0
25	25133123	.	T	G	16	12	28	0	1	29	0	0
25	25133171	.	A	G	22	18	40	0	3	43	0	0
25	25133353	.	G	A	15	15	30	0	1	31	0	0
25	25133365	.	T	A	12	12	24	0	2	26	0	0
25	25133509	.	A	G	11	6	17	0	0	17	0	0
25	25133721	.	G	A	13	9	22	0	0	22	0	0
25	25142127	.	G	A	2	1	3	0	1	5	1	0
25	25142171	.	T	C	3	3	6	0	0	6	0	0
25	25142202	.	T	A	2	4	6	0	1	7	0	0
25	25396237	.	T	C	11	15	26	0	2	28	0	0
25	25396295	.	T	C	5	13	18	0	1	19	0	0
25	25536394	.	C	A	1	3	4	0	0	4	0	0
25	25538354	.	T	A	2	2	4	0	0	4	0	0
25	25538624	.	C	A	2	2	4	0	1	5	0	0
25	25538786	.	T	G	1	0	1	0	5	6	0	0
25	25539434	.	G	A	0	4	4	0	2	6	0	0
25	25539518	.	A	G	0	3	3	0	0	3	0	0
25	25539539	.	C	A	2	3	5	0	0	5	0	0
25	25539723	.	C	A	10	10	20	0	0	20	0	0
25	25540058	.	T	A	3	3	6	0	0	6	0	0
25	25540060	.	G	A	3	2	5	0	1	6	0	0
25	25540181	.	A	T	8	4	12	0	0	12	0	0
25	25540245	.	A	G	8	3	11	0	0	11	0	0
25	25540312	.	C	A	3	9	12	0	1	13	0	0
25	25540954	.	G	A	4	7	11	0	0	11	0	0
25	25542708	.	C	T	8	11	19	0	0	19	0	0
25	25544468	.	C	T	18	7	25	0	5	31	1	0
25	25545007	.	G	A	13	10	23	0	0	23	0	0
25	25545654	.	T	C	3	7	10	0	0	10	0	0
25	25546053	.	G	A	1	4	5	0	0	5	0	0
25	25547043	.	C	A	3	4	7	0	0	7	0	0
25	25547137	.	C	A	5	4	9	0	0	9	0	0
25	25547228	.	G	A	8	5	13	0	0	13	0	0
25	25548032	.	G	T	2	3	5	0	0	5	0	0
25	25548076	.	T	A	1	2	3	0	0	3	0	0
25	25566006	.	A	G	1	2	3	0	0	3	0	0
25	25566063	.	A	T	1	2	3	0	0	3	0	0
25	25566069	.	C	A	1	2	3	0	0	3	0	0
25	25594104	.	A	G	3	2	5	0	0	5	0	0
25	25595684	.	A	C	2	2	4	0	0	4	0	0
25	25806264	.	C	T	20	8	28	0	2	30	0	0
25	25823529	.	T	C	15	17	32	0	2	34	0	0
25	26739161	.	G	T	4	9	13	0	1	14	0	0
25	26739184	.	T	C	5	6	11	0	0	11	0	0
25	26739579	.	C	T	7	6	13	0	0	13	0	0
25	26821795	.	T	C	2	2	4	0	0	4	0	0
25	26821844	.	A	T	1	2	3	0	1	4	0	0
25	26823244	.	C	T	1	2	3	0	0	3	0	0
25	26823888	.	G	A	1	2	3	0	0	3	0	0
25	26824155	.	G	A	1	5	6	0	0	6	0	0
25	26827274	.	T	C	4	5	9	0	0	9	0	0
25	26827435	.	T	C	4	4	8	0	0	8	0	0
25	26827440	.	A	G	4	6	10	0	0	10	0	0
25	26829261	.	C	T	11	5	16	0	0	16	0	0
25	26829266	.	G	T	10	6	16	0	0	16	0	0
25	26829918	.	A	G	3	7	10	0	0	10	0	0
25	26840452	.	G	T	7	5	12	0	2	14	0	0
25	26842444	.	G	A	5	8	13	0	0	13	0	0
25	26843027	.	A	C	3	0	3	0	4	7	0	0
25	26877783	.	A	T	11	12	23	0	1	24	0	0
25	26877865	.	A	T	15	11	26	0	1	28	1	0
25	26879592	.	T	C	17	22	39	0	1	40	0	0
25	26884286	.	G	A	7	12	19	0	0	19	0	0
25	26884407	.	C	T	6	13	19	0	0	19	0	0
25	26888170	.	A	G	9	3	12	0	4	16	0	0
25	26890845	.	A	G	9	11	20	0	0	20	0	0
25	26908396	.	T	G	3	2	5	0	0	5	0	0
25	26909101	.	C	T	5	5	10	0	0	10	0	0
25	26909197	.	G	A	3	2	5	0	0	5	0	0
25	26909269	.	A	G	7	9	16	0	1	17	0	0
25	26909392	.	A	T	6	9	15	0	1	16	0	0
25	26909618	.	A	C	10	10	20	0	0	20	0	0
25	26911216	.	C	T	4	4	8	0	0	8	0	0
25	26911554	.	T	A	6	8	14	0	1	15	0	0
25	26911605	.	C	A	11	5	16	0	0	16	0	0
25	26911768	.	A	G	4	9	13	0	1	14	0	0
25	26911792	.	G	A	11	6	17	0	0	17	0	0
25	26912037	.	C	T	7	5	12	0	0	12	0	0
25	27089335	.	G	A	1	3	4	0	0	4	0	0
25	27089349	.	G	A	1	3	4	0	0	4	0	0
25	27092669	.	C	G	5	7	12	0	0	12	0	0
25	27173849	.	G	A	3	4	7	0	1	8	0	0
25	27173979	.	G	A	2	4	6	0	1	7	0	0
25	27174323	.	C	T	4	4	8	0	0	8	0	0
25	27174500	.	G	A	8	8	16	0	2	18	0	0
25	27491669	.	C	T	1	3	4	0	0	4	0	0
25	27491679	.	A	G	1	0	1	0	1	2	0	0
25	27500055	.	A	G	2	2	4	0	1	5	0	0
25	27715164	.	T	G	2	17	19	0	0	19	0	0
25	27715423	.	A	T	12	7	19	0	0	19	0	0
25	27715468	.	G	A	6	14	20	0	0	20	0	0
25	27715499	.	T	A	13	7	20	0	0	20	0	0
25	27715535	.	C	G	16	8	24	0	1	25	0	0
25	27716110	.	C	A	0	4	4	0	11	15	0	0
25	27716160	.	C	T	1	5	6	0	7	13	0	0
25	27716204	.	C	A	14	9	23	0	0	23	0	0
25	27716265	.	T	C	12	9	21	0	0	21	0	0
25	27716270	.	A	T	13	8	21	0	1	22	0	0
25	27716374	.	G	A	9	7	16	0	2	18	0	0
25	27763514	.	A	T	4	5	9	0	0	9	0	0
25	27788094	.	T	C	9	8	17	0	2	19	0	0
25	27788109	.	C	T	6	8	14	0	2	16	0	0
25	27795086	.	G	A	9	9	18	0	1	19	0	0
25	27801783	.	A	T	11	8	19	0	7	26	0	0
25	27802005	.	C	T	7	8	15	0	1	16	0	0
25	27802122	.	C	A	20	15	35	0	2	37	0	0
25	27802149	.	G	A	16	15	31	0	2	33	0	0
25	27806800	.	C	T	21	15	36	0	0	36	0	0
25	27811761	.	C	T	13	16	29	0	3	32	0	0
25	28222152	.	T	C	8	8	16	0	0	16	0	0
25	28229540	.	C	T	4	3	7	0	0	7	0	0
25	28240151	.	T	C	2	5	7	0	0	7	0	0
25	28244242	.	A	T	3	2	5	0	0	5	0	0
25	28254059	.	C	T	4	7	11	0	1	12	0	0
25	28269651	.	G	T	8	1	9	0	2	11	0	0
25	28269735	.	T	C	5	4	9	0	1	10	0	0
25	28273576	.	T	C	1	4	5	0	0	5	0	0
25	28317616	.	C	T	1	2	3	0	0	3	0	0
25	28317697	.	C	T	1	1	2	0	1	3	0	0
25	28320907	.	G	C	1	2	3	0	0	3	0	0
25	28322663	.	T	C	2	5	7	0	1	8	0	0
25	28322671	.	T	A	3	4	7	0	1	8	0	0
25	28322704	.	G	A	3	5	8	0	0	8	0	0
25	28322939	.	G	A	0	3	3	0	2	5	0	0
25	28323048	.	C	T	2	2	4	0	0	4	0	0
25	28323054	.	A	C	2	2	4	0	0	4	0	0
25	28332778	.	A	G	3	2	5	0	0	5	0	0
25	28335163	.	C	A	2	2	4	0	1	5	0	0
25	28335569	.	C	T	1	2	3	0	0	3	0	0
25	28335632	.	C	A	4	4	8	0	1	9	0	0
25	28335744	.	G	A	2	6	8	0	4	12	0	0
25	28357358	.	G	C	4	4	8	0	0	8	0	0
25	28357581	.	T	C	4	0	4	0	6	10	0	0
25	28367153	.	C	T	0	2	2	0	2	4	0	0
25	28376926	.	A	G	2	3	5	0	1	6	0	0
25	28379710	.	G	A	2	2	4	0	2	6	0	0
25	28379767	.	C	T	2	2	4	0	2	6	0	0
25	28383715	.	T	G	3	2	5	0	0	5	0	0
25	28640526	.	G	A	10	13	23	0	0	23	0	0
25	28640599	.	G	A	14	17	31	0	0	31	0	0
25	28640662	.	G	A	22	20	42	0	0	42	0	0
25	28640724	.	T	G	22	28	50	0	3	53	0	0
25	28640890	.	T	G	19	21	40	0	1	41	0	0
25	28641005	.	A	C	26	9	35	0	2	37	0	0
25	28641207	.	A	T	9	13	22	0	11	33	0	0
25	28641215	.	A	T	25	5	30	0	1	31	0	0
25	28641261	.	T	A	12	20	32	0	1	34	1	0
25	28641321	.	T	G	12	19	31	0	2	33	0	0
25	28648067	.	T	C	15	13	28	0	2	30	0	0
25	28648078	.	A	G	12	17	29	0	1	30	0	0
25	28648166	.	G	A	19	17	36	0	2	38	0	0
25	28650812	.	G	A	13	14	27	0	3	30	0	0
25	28652511	.	G	A	11	23	34	0	0	34	0	0
25	28655056	.	G	A	13	13	26	0	2	28	0	0
25	28656024	.	G	C	9	11	20	0	0	20	0	0
25	28656078	.	G	T	5	13	18	0	1	19	0	0
25	28661185	.	C	T	6	7	13	0	0	13	0	0
25	28661227	.	T	C	8	5	13	0	0	13	0	0
25	28661279	.	T	C	12	9	21	0	1	22	0	0
25	28661626	.	G	A	8	14	22	0	1	23	0	0
25	28665386	.	T	A	8	3	11	0	0	11	0	0
25	28665464	.	A	C	9	8	17	0	2	19	0	0
25	28668046	.	G	T	6	7	13	0	0	13	0	0
25	28668614	.	T	C	5	6	11	0	3	14	0	0
25	28668627	.	G	A	8	8	16	0	0	16	0	0
25	28714616	.	A	G	7	3	10	0	0	10	0	0
25	28715206	.	A	T	10	3	13	0	0	13	0	0
25	28715221	.	G	A	13	3	16	0	0	16	0	0
25	28715414	.	T	C	5	3	8	0	0	8	0	0
25	28715421	.	T	C	2	5	7	0	0	7	0	0
25	28716206	.	G	A	4	4	8	0	0	8	0	0
25	28719957	.	T	G	8	8	16	0	1	17	0	0
25	28720044	.	T	C	5	1	6	0	6	12	0	0
25	28726537	.	C	A	1	11	12	0	6	18	0	0
25	28726758	.	A	G	4	5	9	0	1	10	0	0
25	28736679	.	C	T	6	2	8	0	1	9	0	0
25	28736893	.	A	G	4	6	10	0	0	10	0	0
25	28737007	.	A	T	5	3	8	0	1	9	0	0
25	28745070	.	T	G	1	2	3	0	1	4	0	0
25	28745260	.	G	A	1	2	3	0	0	3	0	0
25	28745266	.	C	T	1	2	3	0	0	3	0	0
25	28753499	.	A	C	3	3	6	0	0	6	0	0
25	28768464	.	C	T	1	2	3	0	0	3	0	0
25	28825652	.	G	C	6	8	14	0	0	14	0	0
25	28826630	.	A	G	13	0	13	0	7	20	0	0
25	28827752	.	A	G	8	0	8	0	9	17	0	0
25	28846383	.	G	T	1	14	15	0	11	26	0	0
25	28893665	.	T	A	2	5	7	0	1	8	0	0
25	28893713	.	C	A	5	9	14	0	1	15	0	0
25	28893956	.	C	T	6	5	11	0	0	11	0	0
25	28903105	.	A	C	9	20	29	0	0	29	0	0
25	28903253	.	A	G	9	0	9	0	12	21	0	0
25	28907971	.	T	C	3	0	3	0	3	6	0	0
25	28907997	.	A	G	4	5	9	0	0	9	0	0
25	29076852	.	T	A	31	29	60	3	2	65	0	0
25	29080112	.	G	A	1	2	3	0	1	4	0	0
25	29084154	.	G	A	4	4	8	0	0	8	0	0
25	29087845	.	T	C	5	0	5	0	3	8	0	0
25	29087859	.	T	C	2	0	2	0	3	5	0	0
25	29103743	.	A	T	2	2	4	0	0	4	0	0
25	29109251	.	G	A	4	7	11	0	0	11	0	0
25	29110052	.	A	G	6	9	15	0	0	15	0	0
25	29114835	.	G	A	6	4	10	0	0	10	0	0
25	29117835	.	A	G	3	2	5	0	1	6	0	0
25	29128870	.	G	C	3	2	5	0	0	5	0	0
25	29129593	.	A	G	1	5	6	0	2	8	0	0
25	29212167	.	G	T	4	5	9	0	0	9	0	0
25	29212302	.	C	T	1	2	3	0	3	6	0	0
25	29212780	.	A	T	2	3	5	0	0	5	0	0
25	29212781	.	C	G	1	3	4	0	1	5	0	0
25	29212835	.	A	T	2	4	6	0	0	6	0	0
25	29212851	.	G	T	1	3	4	0	0	4	0	0
25	29319097	.	A	G	30	36	66	0	3	69	0	0
25	29319239	.	A	T	25	16	41	0	3	44	0	0
25	29319706	.	T	C	34	1	35	0	38	73	0	0
25	29319712	.	A	G	35	36	71	0	1	72	0	0
25	29319831	.	A	G	31	36	67	0	3	70	0	0
25	29319849	.	G	A	32	33	65	0	5	70	0	0
25	29329949	.	A	G	34	37	71	0	4	75	0	0
25	29427951	.	A	C	13	6	19	1	0	20	0	0
25	29427955	.	A	C	13	4	17	1	2	20	0	0
25	29428094	.	A	G	25	14	39	0	1	40	0	0
25	29428300	.	C	A	12	23	35	0	1	36	0	0
25	29428638	.	A	G	19	14	33	0	2	35	0	0
25	29428806	.	T	A	7	14	21	0	2	23	0	0
25	29428963	.	G	A	19	20	39	0	3	42	0	0
25	29429187	.	A	G	11	13	24	0	5	29	0	0
25	29429420	.	G	A	17	15	32	0	4	36	0	0
25	29429569	.	T	C	19	0	19	0	11	30	0	0
25	29429589	.	G	T	14	8	22	0	0	22	0	0
25	29429984	.	T	C	15	0	15	3	6	24	0	0
25	29444782	.	A	G	3	4	7	0	1	8	0	0
25	29662739	.	C	T	6	3	9	0	0	9	0	0
25	29663116	.	T	G	3	5	8	0	0	8	0	0
25	29664955	.	T	C	10	13	23	0	0	23	0	0
25	29665705	.	G	A	1	9	10	0	19	29	0	0
25	29666170	.	T	G	15	0	15	0	11	26	0	0
25	29666640	.	T	A	8	6	14	0	1	15	0	0
25	29666797	.	T	A	13	7	20	0	3	23	0	0
25	29694487	.	A	C	2	2	4	0	0	4	0	0
25	29696881	.	A	G	2	4	6	0	0	6	0	0
25	29696896	.	A	G	3	0	3	0	5	8	0	0
25	29697015	.	G	A	5	5	10	0	0	10	0	0
25	29697064	.	C	T	3	3	6	0	0	6	0	0
25	29697575	.	C	A	6	2	8	0	0	8	0	0
25	29698784	.	C	T	2	9	11	0	1	12	0	0
25	29698922	.	A	T	3	3	6	0	0	6	0	0
25	29699018	.	G	A	5	6	11	0	0	11	0	0
25	29699227	.	T	C	7	9	16	0	0	16	0	0
25	29699236	.	A	T	8	9	17	0	0	17	0	0
25	29701710	.	G	A	7	11	18	0	0	18	0	0
25	29711597	.	A	T	11	5	16	0	0	16	0	0
25	29711754	.	C	A	10	6	16	0	2	18	0	0
25	32216389	.	A	G	2	0	2	0	4	6	0	0
25	32739551	.	C	T	2	3	5	0	0	6	1	0
25	34908713	.	G	A	0	6	6	0	2	8	0	0
25	34911316	.	A	G	1	4	5	0	0	5	0	0
25	34911317	.	A	G	2	3	5	0	0	5	0	0
25	35713260	.	G	A	4	7	11	0	2	13	0	0
25	35713263	.	G	C	4	9	13	0	0	13	0	0
25	35717196	.	C	G	4	2	6	0	0	6	0	0
25	35765206	.	A	G	16	7	23	0	4	27	0	0
25	36067477	.	T	G	1	7	8	0	0	8	0	0
25	37333222	.	T	C	0	0	0	0	11	11	0	0
25	37336710	.	A	G	4	4	8	0	0	8	0	0
25	37365168	.	A	G	1	2	3	0	0	3	0	0
25	37466766	.	G	C	0	0	0	0	4	4	0	0
25	37466771	.	T	A	1	0	1	0	3	4	0	0
3	13937	.	C	T	4	4	8	7	0	15	0	0
3	41001	.	T	A	1	3	4	0	0	4	0	0
3	249413	.	A	T	3	4	7	0	0	7	0	0
3	441342	.	A	G	2	8	10	0	0	10	0	0
3	441352	.	A	G	3	6	9	3	0	12	0	0
3	1323776	.	A	C	1	2	3	0	0	3	0	0
3	1323879	.	T	A	6	5	11	0	0	11	0	0
3	1324064	.	C	A	17	9	26	0	1	27	0	0
3	1324281	.	G	T	7	5	12	0	0	12	0	0
3	1324300	.	T	C	6	9	15	0	0	15	0	0
3	1324383	.	G	C	2	0	2	0	5	9	2	0
3	1324509	.	C	A	6	8	14	0	0	14	0	0
3	1324515	.	C	T	8	8	16	0	0	16	0	0
3	1324688	.	T	C	10	10	20	0	0	20	0	0
3	1337593	.	A	G	3	2	5	0	0	5	0	0
3	1337674	.	T	C	3	0	3	0	4	7	0	0
3	1339147	.	T	A	9	6	15	0	0	15	0	0
3	3610224	.	C	T	1	2	3	0	0	3	0	0
3	3630587	.	T	C	1	9	10	0	1	11	0	0
3	3631407	.	T	C	10	4	14	0	0	14	0	0
3	3634408	.	G	A	7	4	11	0	1	12	0	0
3	3634528	.	G	T	1	2	3	0	1	4	0	0
3	4459394	.	A	G	2	4	6	0	0	6	0	0
3	4465966	.	T	C	1	5	6	0	0	6	0	0
3	4502158	.	C	A	7	8	15	0	0	15	0	0
3	4506897	.	A	G	4	5	9	0	1	10	0	0
3	4506961	.	G	A	0	7	7	0	3	10	0	0
3	4507825	.	T	C	2	4	6	0	1	7	0	0
3	4508042	.	A	C	12	10	22	0	0	22	0	0
3	4508093	.	C	A	9	11	20	0	3	23	0	0
3	4508120	.	C	T	7	11	18	0	3	21	0	0
3	4511020	.	C	T	10	7	17	0	1	18	0	0
3	4511052	.	T	C	7	10	17	0	0	17	0	0
3	4511163	.	A	G	5	0	5	0	4	9	0	0
3	4530061	.	G	A	9	9	18	0	2	20	0	0
3	4530118	.	T	A	3	5	8	0	1	9	0	0
3	5009112	.	G	C	9	0	9	0	5	14	0	0
3	5012832	.	C	G	0	8	8	0	10	18	0	0
3	5021432	.	G	A	11	11	22	0	0	22	0	0
3	5021453	.	C	T	1	6	7	0	11	18	0	0
3	5040591	.	A	G	3	2	5	0	0	5	0	0
3	5052823	.	T	G	10	7	17	0	0	18	1	0
3	5052868	.	G	A	9	12	21	5	0	26	0	0
3	5053060	.	C	T	3	16	19	0	18	37	0	0
3	5053454	.	T	A	19	16	35	0	0	35	0	0
3	5053934	.	G	A	24	13	37	0	1	38	0	0
3	5053988	.	C	G	13	23	36	0	0	36	0	0
3	5056247	.	G	A	10	14	24	0	2	26	0	0
3	5056390	.	A	T	16	16	32	1	2	35	0	0
3	5062827	.	C	T	13	14	27	0	1	28	0	0
3	5063125	.	G	A	4	14	18	0	1	19	0	0
3	5063176	.	G	A	17	8	25	0	0	25	0	0
3	5067581	.	T	A	5	6	11	0	1	12	0	0
3	5130851	.	T	C	3	7	10	0	0	10	0	0
3	5134122	.	G	A	2	10	12	0	2	14	0	0
3	5134669	.	T	C	7	3	10	0	0	10	0	0
3	5136617	.	G	A	2	3	5	0	0	5	0	0
3	5140851	.	A	G	8	9	17	0	0	17	0	0
3	5141035	.	C	T	6	1	7	0	4	11	0	0
3	5143522	.	C	T	5	5	10	0	0	10	0	0
3	5145139	.	C	A	1	4	5	0	2	7	0	0
3	5145797	.	C	T	0	3	3	0	5	8	0	0
3	5150391	.	G	A	1	3	4	0	1	5	0	0
3	5163352	.	C	T	3	2	5	0	0	5	0	0
3	5228084	.	A	G	2	0	2	0	3	5	0	0
3	5265679	.	A	G	3	8	11	0	0	11	0	0
3	5265741	.	G	A	6	20	26	0	0	26	0	0
3	5265754	.	C	T	8	18	26	0	1	27	0	0
3	5267221	.	G	A	6	17	23	1	0	24	0	0
3	5267251	.	C	T	9	13	22	1	2	25	0	0
3	5270274	.	C	T	3	12	15	0	14	29	0	0
3	5624487	.	C	T	2	18	20	0	23	43	0	0
3	5633056	.	A	G	14	18	32	0	2	34	0	0
3	5633089	.	G	A	13	17	30	0	0	30	0	0
3	5633122	.	A	G	8	11	19	0	0	19	0	0
3	5634976	.	A	G	14	9	23	0	2	25	0	0
3	5637213	.	A	C	10	7	17	0	0	17	0	0
3	5637222	.	A	G	13	10	23	0	0	23	0	0
3	5648087	.	A	T	2	2	4	0	0	4	0	0
3	5778981	.	G	A	13	11	24	0	2	26	0	0
3	5779044	.	T	A	15	12	27	0	1	28	0	0
3	5779093	.	G	T	13	14	27	0	1	28	0	0
3	5782501	.	A	G	12	12	24	0	0	24	0	0
3	5782715	.	A	G	11	17	28	0	0	28	0	0
3	5792569	.	T	A	21	6	27	0	1	28	0	0
3	5812205	.	C	T	5	8	13	0	1	14	0	0
3	5812802	.	C	T	1	9	10	0	13	23	0	0
3	5812813	.	G	A	9	3	12	0	9	21	0	0
3	5814475	.	C	T	3	7	10	0	0	10	0	0
3	5814478	.	C	T	3	7	10	0	0	10	0	0
3	5824826	.	T	C	5	4	9	0	0	9	0	0
3	5824858	.	C	T	3	2	5	0	1	6	0	0
3	5824870	.	C	T	2	4	6	0	0	6	0	0
3	5829262	.	G	A	7	2	9	0	1	10	0	0
3	5829319	.	G	A	2	8	10	0	0	10	0	0
3	5829415	.	A	G	2	2	4	0	0	4	0	0
3	5882439	.	A	G	0	2	2	0	1	3	0	0
3	5886917	.	C	T	2	17	19	0	29	48	0	0
3	5887223	.	T	C	15	13	28	0	4	32	0	0
3	5887463	.	T	G	20	12	32	0	1	33	0	0
3	5887661	.	A	T	15	16	31	0	2	33	0	0
3	5887673	.	G	C	15	3	18	0	16	34	0	0
3	5887715	.	T	C	26	14	40	0	0	40	0	0
3	5887841	.	T	A	17	17	34	0	1	35	0	0
3	5887931	.	A	T	25	11	36	1	1	38	0	0
3	5888245	.	C	T	13	15	28	0	0	28	0	0
3	5888664	.	G	A	6	12	18	0	0	18	0	0
3	5888868	.	G	A	5	10	15	0	0	15	0	0
3	5889077	.	G	T	5	8	13	0	0	13	0	0
3	5889302	.	T	C	3	4	7	0	2	9	0	0
3	5889642	.	A	T	5	3	8	0	1	9	0	0
3	5890274	.	T	A	6	5	11	0	0	11	0	0
3	5890287	.	A	G	7	4	11	0	0	11	0	0
3	5890698	.	C	T	0	6	6	0	5	11	0	0
3	5908452	.	T	C	3	0	3	0	8	11	0	0
3	5994984	.	C	T	3	2	5	0	0	5	0	0
3	5995038	.	A	G	3	2	5	0	0	5	0	0
3	6380368	.	T	C	34	20	54	2	4	60	0	0
3	6417172	.	G	A	19	27	46	0	1	47	0	0
3	6457308	.	T	G	3	2	5	0	1	6	0	0
3	6460039	.	G	T	2	3	5	0	0	5	0	0
3	6466036	.	C	T	3	6	9	0	0	9	0	0
3	6474593	.	A	G	9	7	16	0	0	16	0	0
3	6491011	.	T	G	2	3	5	0	0	5	0	0
3	6491820	.	A	T	2	3	5	0	0	5	0	0
3	6491833	.	A	G	2	3	5	0	0	5	0	0
3	6491881	.	G	T	4	5	9	0	0	9	0	0
3	6491906	.	T	C	2	3	5	0	0	5	0	0
3	6498049	.	C	G	0	3	3	0	6	9	0	0
3	6502039	.	G	A	6	3	9	0	0	9	0	0
3	6504814	.	T	A	2	3	5	0	0	5	0	0
3	6608024	.	C	A	2	4	6	0	0	6	0	0
3	6608276	.	T	A	2	3	5	0	0	5	0	0
3	6608296	.	G	A	1	2	3	0	0	3	0	0
3	6659843	.	C	T	2	3	5	0	0	5	0	0
3	6664603	.	A	G	0	7	7	0	1	8	0	0
3	6664609	.	T	C	7	3	10	0	1	11	0	0
3	6665245	.	C	T	3	3	6	0	1	7	0	0
3	6665874	.	C	G	4	0	4	0	9	13	0	0
3	6665902	.	G	T	5	9	14	0	0	14	0	0
3	6665951	.	C	A	9	3	12	0	0	12	0	0
3	6665985	.	A	T	8	7	15	0	2	17	0	0
3	6666027	.	C	T	8	9	17	0	0	17	0	0
3	6666080	.	A	G	9	9	18	0	0	18	0	0
3	6666092	.	T	C	9	9	18	0	0	18	0	0
3	6666194	.	G	C	11	17	28	0	0	28	0	0
3	6666283	.	A	T	7	13	20	0	1	21	0	0
3	6666342	.	A	G	14	2	16	1	0	17	0	0
3	6666362	.	G	A	8	11	19	0	0	19	0	0
3	6666689	.	T	C	3	10	13	0	0	13	0	0
3	6666691	.	T	C	9	3	12	0	1	13	0	0
3	6666730	.	C	T	1	5	6	0	0	6	0	0
3	6666846	.	T	C	3	9	12	0	0	12	0	0
3	6667060	.	G	C	25	12	37	0	2	39	0	0
3	6667209	.	C	T	13	13	26	0	0	26	0	0
3	6667383	.	T	C	3	2	5	6	2	13	0	0
3	6667959	.	A	C	1	4	5	4	0	9	0	0
3	6667983	.	C	G	4	1	5	1	2	8	0	0
3	6669034	.	C	T	1	5	6	0	0	6	0	0
3	6669511	.	C	T	3	2	5	0	0	5	0	0
3	6721278	.	A	G	4	4	8	0	1	9	0	0
3	6721286	.	G	C	4	5	9	0	0	9	0	0
3	6721421	.	T	G	12	12	24	0	0	24	0	0
3	6721456	.	A	T	11	5	16	0	2	18	0	0
3	6721497	.	T	A	4	10	14	0	0	14	0	0
3	6721504	.	A	T	1	10	11	0	3	14	0	0
3	6721763	.	T	C	4	6	10	0	1	11	0	0
3	6721773	.	T	G	6	8	14	0	0	14	0	0
3	6721851	.	C	T	9	6	15	0	0	15	0	0
3	6722021	.	T	A	7	6	13	0	0	13	0	0
3	6722070	.	C	G	8	10	18	0	0	18	0	0
3	6722333	.	C	A	7	4	11	0	0	12	1	0
3	6722341	.	G	A	7	7	14	0	0	14	0	0
3	6722401	.	T	C	5	8	13	0	1	14	0	0
3	6722438	.	C	T	4	5	9	0	0	9	0	0
3	6725246	.	G	T	5	2	7	3	1	11	0	0
3	6725378	.	A	T	5	2	7	0	2	9	0	0
3	6726020	.	C	T	1	4	5	0	1	6	0	0
3	6726053	.	T	C	2	4	6	0	0	6	0	0
3	6726359	.	G	A	2	3	5	0	1	6	0	0
3	6895560	.	C	T	0	2	2	0	1	3	0	0
3	6895566	.	A	G	1	2	3	0	0	3	0	0
3	7008220	.	G	T	3	2	5	0	0	5	0	0
3	7008234	.	G	A	3	2	5	0	0	5	0	0
3	7008290	.	C	T	2	5	7	0	0	7	0	0
3	7008690	.	C	A	1	5	6	0	1	7	0	0
3	7081435	.	G	T	1	2	3	0	0	3	0	0
3	7081675	.	G	A	2	1	3	0	0	3	0	0
3	7081699	.	T	C	2	0	2	0	2	4	0	0
3	7099049	.	C	T	2	5	7	1	0	8	0	0
3	7099160	.	A	G	3	12	15	0	1	16	0	0
3	7099210	.	T	C	3	8	11	0	0	11	0	0
3	7099285	.	G	T	1	6	7	0	1	8	0	0
3	7099344	.	A	G	2	4	6	1	0	7	0	0
3	7099380	.	C	T	1	2	3	0	0	3	0	0
3	7099600	.	T	C	1	4	5	0	0	5	0	0
3	7112990	.	C	T	1	7	8	0	9	17	0	0
3	7113036	.	G	T	6	11	17	0	0	17	0	0
3	7113075	.	T	G	3	8	11	0	0	11	0	0
3	7113126	.	A	G	7	5	12	0	0	12	0	0
3	7113424	.	G	C	4	5	9	0	1	10	0	0
3	7113433	.	T	C	4	5	9	0	1	10	0	0
3	7113465	.	A	G	3	5	8	0	0	8	0	0
3	7113720	.	G	A	6	6	12	0	1	13	0	0
3	7113821	.	A	T	5	3	8	3	0	11	0	0
3	7113822	.	A	G	5	3	8	3	0	11	0	0
3	7113934	.	A	G	4	3	7	0	0	7	0	0
3	7114043	.	T	G	4	3	7	0	0	7	0	0
3	7124140	.	G	A	3	4	7	0	1	8	0	0
3	7124437	.	A	G	1	2	3	0	0	3	0	0
3	7124659	.	C	T	1	4	5	0	1	6	0	0
3	7124705	.	C	T	1	3	4	0	1	5	0	0
3	7133435	.	T	G	3	4	7	0	1	8	0	0
3	7133743	.	A	G	2	6	8	0	1	9	0	0
3	7133751	.	A	G	2	5	7	0	0	7	0	0
3	7133925	.	T	C	2	5	7	1	0	8	0	0
3	7133967	.	G	A	1	2	3	1	1	5	0	0
3	7141369	.	T	C	4	3	7	0	0	7	0	0
3	7141562	.	A	T	2	6	8	0	0	8	0	0
3	7141846	.	G	A	3	2	5	1	0	6	0	0
3	7141981	.	C	T	2	3	5	0	0	5	0	0
3	7142011	.	G	A	1	2	3	0	0	3	0	0
3	7142350	.	A	G	5	2	7	1	0	8	0	0
3	7142372	.	C	G	3	2	5	0	1	6	0	0
3	7155012	.	T	C	2	0	2	1	6	9	0	0
3	7155039	.	T	C	3	6	9	0	0	9	0	0
3	7155196	.	T	A	9	4	13	2	1	16	0	0
3	7155198	.	A	G	9	4	13	2	1	16	0	0
3	7155428	.	G	A	6	8	14	0	0	14	0	0
3	7156035	.	C	T	3	2	5	0	1	6	0	0
3	7156141	.	C	T	2	2	4	0	0	4	0	0
3	7276770	.	A	C	1	0	1	0	3	4	0	0
3	7509800	.	T	A	4	3	7	0	1	8	0	0
3	7509845	.	C	G	0	2	2	0	2	4	0	0
3	7509930	.	T	A	1	1	2	0	1	3	0	0
3	7509946	.	G	A	1	2	3	0	0	3	0	0
3	7510596	.	A	G	2	3	5	0	0	5	0	0
3	7510609	.	G	A	1	2	3	0	1	4	0	0
3	7638510	.	A	G	2	4	6	0	0	6	0	0
3	7819499	.	A	G	5	4	9	0	0	9	0	0
3	9607099	.	T	C	6	2	8	0	0	8	0	0
3	10163116	.	G	A	1	3	4	0	4	8	0	0
3	10163153	.	C	A	3	2	5	0	0	5	0	0
3	10163302	.	T	C	2	2	4	0	1	5	0	0
3	10163422	.	G	A	5	3	8	0	0	8	0	0
3	10163785	.	A	G	3	0	3	0	4	7	0	0
3	10163815	.	G	A	6	2	8	0	0	8	0	0
3	10163971	.	G	A	2	5	7	0	0	7	0	0
3	10164025	.	C	T	3	3	6	0	0	6	0	0
3	10164338	.	C	G	2	4	6	0	0	6	0	0
3	10164352	.	A	C	2	2	4	0	0	4	0	0
3	10164531	.	T	G	1	2	3	0	0	3	0	0
3	10310973	.	G	A	1	2	3	0	0	3	0	0
3	10567642	.	A	G	4	2	6	0	0	6	0	0
3	11554135	.	A	G	2	0	2	0	2	4	0	0
3	11554141	.	T	C	2	2	4	0	0	4	0	0
3	11575354	.	G	A	0	7	7	0	4	11	0	0
3	11575591	.	C	A	4	3	7	1	0	8	0	0
3	11575946	.	C	T	2	2	4	0	0	4	0	0
3	11575955	.	T	A	2	2	4	0	0	4	0	0
3	11585488	.	T	A	21	12	33	0	4	37	0	0
3	11585492	.	G	A	23	10	33	0	2	35	0	0
3	11585815	.	A	G	13	7	20	0	0	20	0	0
3	11585852	.	T	A	12	10	22	0	1	23	0	0
3	11585937	.	G	A	13	11	24	0	2	26	0	0
3	11586331	.	C	T	3	7	10	0	26	36	0	0
3	11586346	.	C	T	28	6	34	0	3	37	0	0
3	11586382	.	G	A	25	18	43	0	0	43	0	0
3	11586635	.	A	G	18	12	30	0	4	34	0	0
3	11586679	.	C	T	14	10	24	2	0	26	0	0
3	11586695	.	C	T	1	6	7	4	11	22	0	0
3	11590280	.	A	G	17	12	29	0	5	34	0	0
3	11614970	.	T	C	20	13	33	0	1	34	0	0
3	11615007	.	A	T	20	15	35	0	2	37	0	0
3	11615041	.	T	C	18	0	18	0	15	33	0	0
3	11615109	.	G	A	18	12	30	0	1	31	0	0
3	11615133	.	A	G	22	13	35	0	0	35	0	0
3	11615224	.	A	G	15	11	26	0	2	28	0	0
3	11624298	.	A	G	13	6	19	0	0	19	0	0
3	11781003	.	A	C	9	16	25	3	2	32	2	0
3	11781079	.	T	C	21	14	35	0	1	36	0	0
3	11781113	.	G	A	18	24	42	0	1	43	0	0
3	11784743	.	G	A	14	11	25	0	2	27	0	0
3	11797076	.	C	T	2	7	9	0	5	14	0	0
3	12893455	.	T	C	3	2	5	0	0	5	0	0
3	12893932	.	T	A	2	2	4	0	0	4	0	0
3	13424069	.	C	A	5	4	9	0	1	10	0	0
3	13424392	.	T	G	3	3	6	0	0	6	0	0
3	13424467	.	C	A	1	3	4	0	0	4	0	0
3	13424595	.	A	T	2	5	7	0	1	8	0	0
3	13424601	.	T	G	3	5	8	0	0	8	0	0
3	13424635	.	G	A	1	5	6	0	0	6	0	0
3	13424738	.	A	T	1	1	2	0	1	3	0	0
3	13424739	.	A	T	1	2	3	0	0	3	0	0
3	13424847	.	G	T	6	7	13	0	2	15	0	0
3	13424877	.	T	C	6	7	13	0	1	14	0	0
3	13424919	.	T	C	9	6	15	0	1	16	0	0
3	13424950	.	A	T	12	4	16	0	0	16	0	0
3	13424968	.	C	T	9	4	13	0	0	13	0	0
3	13424989	.	C	A	0	3	3	0	10	13	0	0
3	13426691	.	G	A	6	8	14	0	0	14	0	0
3	13426754	.	C	A	0	11	11	0	7	18	0	0
3	13430606	.	A	G	7	11	18	0	3	21	0	0
3	13431327	.	G	A	11	12	23	0	0	23	0	0
3	13432609	.	C	T	9	8	17	0	3	20	0	0
3	13434860	.	C	T	1	8	9	1	5	15	0	0
3	13434888	.	A	G	6	8	14	0	1	15	0	0
3	13434920	.	C	G	6	6	12	0	2	14	0	0
3	13434930	.	A	T	6	6	12	0	1	13	0	0
3	13437767	.	G	A	6	7	13	0	0	13	0	0
3	13441459	.	G	A	2	14	16	0	9	25	0	0
3	13445758	.	G	A	0	16	16	0	11	27	0	0
3	13445819	.	T	C	6	14	20	0	1	21	0	0
3	13445884	.	T	G	10	13	23	0	0	23	0	0
3	13446019	.	C	T	9	11	20	0	0	20	0	0
3	13447870	.	C	T	13	16	29	0	1	30	0	0
3	13453494	.	C	T	7	6	13	0	1	14	0	0
3	13453500	.	A	G	7	6	13	0	0	13	0	0
3	13455893	.	T	C	1	0	1	0	4	5	0	0
3	13456064	.	C	T	0	2	2	0	3	5	0	0
3	13456393	.	G	A	0	5	5	0	1	6	0	0
3	13456436	.	A	G	2	1	3	0	2	5	0	0
3	13456472	.	C	T	1	3	4	0	4	8	0	0
3	13456492	.	T	C	5	3	8	0	2	10	0	0
3	13487973	.	G	A	3	3	6	0	0	6	0	0
3	13488486	.	T	A	6	4	10	0	1	11	0	0
3	13525775	.	T	A	1	2	3	0	0	3	0	0
3	13525976	.	C	G	10	4	14	0	1	15	0	0
3	13526043	.	A	G	4	6	10	0	0	10	0	0
3	13534291	.	C	T	0	4	4	0	4	8	0	0
3	13534311	.	G	C	3	3	6	0	0	6	0	0
3	13534339	.	C	T	1	4	5	0	1	6	0	0
3	13535786	.	A	T	2	3	5	0	1	6	0	0
3	13535827	.	C	T	1	2	3	0	5	8	0	0
3	13542192	.	T	C	1	2	3	0	0	3	0	0
3	13542201	.	T	C	0	2	2	0	1	3	0	0
3	13582156	.	T	C	14	11	25	0	3	28	0	0
3	13582181	.	G	A	19	11	30	0	2	32	0	0
3	13582217	.	G	T	19	7	26	0	3	29	0	0
3	13582220	.	A	T	23	6	29	0	2	31	0	0
3	13582288	.	A	T	23	7	30	0	3	33	0	0
3	13582295	.	T	A	23	6	29	0	2	31	0	0
3	13582547	.	C	G	2	9	11	0	14	25	0	0
3	13589391	.	G	T	18	10	28	0	5	33	0	0
3	13589412	.	G	A	17	11	28	0	2	30	0	0
3	13589469	.	A	G	11	16	27	0	1	28	0	0
3	13590995	.	G	A	15	9	24	0	0	24	0	0
3	13593605	.	C	T	7	10	17	0	1	18	0	0
3	13595100	.	A	G	5	4	9	0	0	9	0	0
3	13595245	.	G	A	7	8	15	0	0	15	0	0
3	13595686	.	C	T	9	8	17	0	0	17	0	0
3	13599436	.	A	G	5	7	12	0	2	14	0	0
3	13607036	.	G	A	0	3	3	0	1	4	0	0
3	13608153	.	A	G	1	2	3	0	0	3	0	0
3	13609168	.	T	A	2	2	4	0	0	4	0	0
3	13617738	.	T	A	2	5	7	0	0	7	0	0
3	13618203	.	A	T	2	5	7	0	0	7	0	0
3	14099798	.	T	A	3	2	5	0	0	5	0	0
3	14099799	.	G	A	3	1	4	0	1	5	0	0
3	14496729	.	T	C	18	0	18	0	22	40	0	0
3	14497015	.	T	C	25	12	37	0	0	37	0	0
3	14860158	.	C	T	3	6	9	0	0	9	0	0
3	15057191	.	A	T	7	7	14	0	2	16	0	0
3	15057214	.	G	T	9	6	15	0	0	15	0	0
3	15057321	.	T	C	10	3	13	0	0	13	0	0
3	15057549	.	T	G	12	9	21	0	0	21	0	0
3	15057656	.	G	A	0	6	6	0	13	19	0	0
3	15057696	.	T	C	12	6	18	0	0	18	0	0
3	15057928	.	G	A	4	7	11	0	0	11	0	0
3	15058259	.	G	T	5	7	12	0	1	13	0	0
3	15058323	.	A	G	4	4	8	0	1	9	0	0
3	15085422	.	G	A	1	5	6	0	4	10	0	0
3	15085528	.	C	T	6	7	13	0	1	14	0	0
3	15085530	.	G	T	6	7	13	0	1	14	0	0
3	15085673	.	G	A	12	13	25	0	1	26	0	0
3	15085784	.	G	C	11	16	27	0	0	27	0	0
3	15085821	.	C	T	15	8	23	0	1	24	0	0
3	15091183	.	C	T	0	3	3	0	7	10	0	0
3	15098847	.	A	G	2	5	7	0	0	7	0	0
3	15392459	.	A	G	11	0	11	0	8	19	0	0
3	15392460	.	A	G	6	5	11	0	8	19	0	0
3	15489799	.	G	A	0	3	3	0	1	4	0	0
3	15629022	.	T	C	5	6	11	0	0	11	0	0
3	15629279	.	T	A	6	2	8	0	0	8	0	0
3	15647784	.	G	A	1	11	12	0	0	12	0	0
3	15987451	.	A	C	14	1	15	0	41	56	0	0
3	15988337	.	A	G	20	23	43	10	0	54	1	0
3	16284414	.	A	G	11	3	14	0	1	15	0	0
3	16389180	.	G	T	12	6	18	0	1	19	0	0
3	16389230	.	C	T	16	9	25	0	1	26	0	0
3	16389517	.	C	T	18	4	22	0	3	25	0	0
3	16391695	.	G	A	5	3	8	0	2	10	0	0
3	16391719	.	T	C	2	0	2	0	10	12	0	0
3	16394522	.	A	G	3	7	10	0	0	10	0	0
3	16395548	.	A	G	2	4	6	0	0	6	0	0
3	16397627	.	A	T	5	4	9	0	0	9	0	0
3	16644872	.	C	T	2	6	8	0	2	10	0	0
3	16648459	.	G	T	6	6	12	0	1	13	0	0
3	16650129	.	G	A	5	3	8	0	0	8	0	0
3	16664476	.	T	C	3	3	6	0	0	6	0	0
3	16668614	.	G	A	0	9	9	0	4	13	0	0
3	16668671	.	C	T	10	5	15	0	0	15	0	0
3	16671903	.	G	A	0	9	9	0	8	17	0	0
3	16679136	.	C	T	6	8	14	0	1	15	0	0
3	16679248	.	C	T	5	7	12	0	1	13	0	0
3	16679331	.	T	C	6	4	10	0	2	12	0	0
3	16679349	.	G	A	5	4	9	0	1	10	0	0
3	16679387	.	G	A	8	4	12	0	0	12	0	0
3	16679520	.	G	A	10	8	18	0	0	18	0	0
3	16679556	.	G	A	1	6	7	0	8	15	0	0
3	16679561	.	A	G	7	2	9	0	5	14	0	0
3	16692232	.	A	G	4	4	8	0	0	8	0	0
3	16696215	.	G	A	0	2	2	0	1	3	0	0
3	16729101	.	G	A	3	7	10	0	0	10	0	0
3	16731938	.	A	G	2	0	2	0	3	5	0	0
3	16733790	.	C	T	4	5	9	0	0	9	0	0
3	16735507	.	C	T	2	5	7	0	0	7	0	0
3	16741179	.	A	C	9	6	15	0	1	16	0	0
3	16741830	.	A	G	6	4	10	0	0	10	0	0
3	16741851	.	T	C	7	3	10	0	1	11	0	0
3	16746153	.	A	C	23	17	40	0	1	41	0	0
3	16746782	.	A	G	0	5	5	0	0	5	0	0
3	16746796	.	G	A	6	4	10	0	0	10	0	0
3	16746947	.	A	T	14	10	24	0	1	25	0	0
3	16747229	.	A	G	7	1	8	0	4	12	0	0
3	16747233	.	G	T	1	5	6	0	6	12	0	0
3	16972430	.	A	G	1	2	3	0	0	3	0	0
3	16972877	.	T	C	2	2	4	0	0	4	0	0
3	16972878	.	G	T	3	2	5	0	0	5	0	0
3	16972949	.	T	A	5	7	12	0	1	13	0	0
3	16972991	.	T	C	4	7	11	0	0	11	0	0
3	17488995	.	A	G	3	0	3	0	5	8	0	0
3	17489004	.	A	T	3	4	7	0	1	8	0	0
3	17582229	.	C	G	1	2	3	0	0	3	0	0
3	17600108	.	G	T	1	5	6	0	3	9	0	0
3	17600190	.	C	T	2	5	7	0	0	7	0	0
3	17600201	.	C	T	2	4	6	0	0	6	0	0
3	17600702	.	C	T	1	3	4	0	1	5	0	0
3	17600870	.	A	T	1	2	3	0	0	3	0	0
3	17601055	.	C	T	2	3	5	0	0	5	0	0
3	17601239	.	A	C	0	3	3	0	0	3	0	0
3	17601247	.	C	T	1	3	4	0	0	4	0	0
3	17601611	.	A	T	3	2	5	0	0	5	0	0
3	17601636	.	C	A	3	3	6	0	0	6	0	0
3	17602081	.	A	T	5	4	9	1	0	10	0	0
3	17603313	.	A	G	3	3	6	0	0	6	0	0
3	17603558	.	G	A	2	4	6	0	0	6	0	0
3	17603926	.	T	C	2	2	4	0	0	4	0	0
3	17604002	.	T	A	1	2	3	0	0	3	0	0
3	17650983	.	G	A	25	12	37	0	1	38	0	0
3	17651208	.	C	A	31	9	40	0	6	46	0	0
3	17651508	.	G	A	18	16	34	1	1	36	0	0
3	17651718	.	C	T	24	18	42	0	7	49	0	0
3	17651837	.	C	T	13	17	30	0	3	33	0	0
3	17651847	.	C	A	11	12	23	0	0	23	0	0
3	17653924	.	T	C	1	3	4	0	0	4	0	0
3	17660156	.	C	T	1	3	4	0	1	5	0	0
3	17669406	.	G	A	1	6	7	0	0	7	0	0
3	17669427	.	A	G	2	4	6	0	0	6	0	0
3	17669502	.	T	A	3	2	5	0	0	5	0	0
3	17671567	.	C	T	1	3	4	0	1	5	0	0
3	17671843	.	G	A	3	3	6	0	0	6	0	0
3	17671888	.	G	A	4	4	8	0	1	9	0	0
3	17671897	.	T	C	4	3	7	0	0	7	0	0
3	17673250	.	C	T	14	7	21	0	0	21	0	0
3	17673386	.	C	T	9	4	13	0	0	13	0	0
3	17867564	.	T	C	19	6	25	0	1	26	0	0
3	17867716	.	C	A	8	4	12	0	2	14	0	0
3	17867870	.	T	C	8	6	14	0	1	15	0	0
3	17868174	.	T	G	4	6	10	0	1	11	0	0
3	17868216	.	T	C	8	3	11	0	0	11	0	0
3	17868231	.	T	C	3	7	10	0	0	10	0	0
3	17868452	.	T	G	3	0	3	0	2	5	0	0
3	17868669	.	C	A	10	4	14	0	1	15	0	0
3	17868673	.	A	G	10	4	14	0	0	14	0	0
3	17868710	.	T	C	3	5	8	0	0	8	0	0
3	17868776	.	C	T	4	5	9	0	1	10	0	0
3	17868949	.	G	C	3	6	9	0	1	10	0	0
3	17869030	.	G	C	7	6	13	0	1	14	0	0
3	17869300	.	G	A	12	7	19	0	1	20	0	0
3	17878505	.	A	G	12	8	20	0	0	20	0	0
3	17886528	.	G	A	13	10	23	0	2	25	0	0
3	17886996	.	C	T	10	5	15	0	0	15	0	0
3	18686781	.	T	C	2	0	2	0	4	6	0	0
3	18838547	.	C	T	8	3	11	0	2	13	0	0
3	18838559	.	T	A	3	6	9	0	0	9	0	0
3	18838595	.	T	A	8	4	12	0	2	14	0	0
3	18838878	.	C	T	7	6	13	0	2	15	0	0
3	18838900	.	T	A	8	3	11	0	4	15	0	0
3	18839017	.	C	T	8	3	11	0	3	14	0	0
3	18922819	.	C	T	1	2	3	0	0	3	0	0
3	18923209	.	C	A	8	3	11	0	1	12	0	0
3	18923246	.	A	G	4	6	10	0	1	11	0	0
3	18923396	.	C	T	3	1	4	0	1	5	0	0
3	18923536	.	C	T	1	2	3	0	0	3	0	0
3	18923586	.	C	G	5	0	5	0	6	11	0	0
3	18923601	.	T	C	5	3	8	1	1	10	0	0
3	19006010	.	G	A	4	6	10	0	1	11	0	0
3	19006388	.	G	A	7	16	23	0	0	23	0	0
3	19019232	.	A	G	1	2	3	0	0	3	0	0
3	19090695	.	A	G	1	2	3	0	0	3	0	0
3	19090884	.	A	G	1	4	5	0	0	5	0	0
3	19162582	.	A	G	4	9	13	0	0	13	0	0
3	19162654	.	A	G	5	6	11	0	2	13	0	0
3	19162663	.	A	G	6	4	10	0	1	11	0	0
3	19162717	.	A	G	5	6	11	0	0	11	0	0
3	19172284	.	G	T	6	4	10	0	1	11	0	0
3	19180634	.	G	A	5	3	8	0	0	8	0	0
3	19180650	.	C	G	4	3	7	0	1	8	0	0
3	19207219	.	A	G	6	0	6	0	11	17	0	0
3	19210238	.	T	C	11	17	28	0	3	31	0	0
3	19210287	.	A	G	15	2	17	0	26	43	0	0
3	19210352	.	A	G	15	8	23	0	0	23	0	0
3	19210495	.	T	C	2	5	7	0	0	7	0	0
3	19264751	.	A	G	3	5	8	0	0	8	0	0
3	19264760	.	T	A	3	5	8	0	2	10	0	0
3	19264787	.	G	T	4	7	11	0	1	12	0	0
3	19264874	.	T	C	5	9	14	0	2	16	0	0
3	19267564	.	T	C	19	7	26	0	3	29	0	0
3	19267906	.	A	G	9	1	10	0	4	14	0	0
3	19267963	.	A	G	9	11	20	0	0	20	0	0
3	19270732	.	C	T	9	10	19	0	1	20	0	0
3	19271549	.	A	G	13	14	27	1	0	28	0	0
3	19273907	.	A	G	20	22	42	0	1	43	0	0
3	19274532	.	C	G	22	18	40	0	0	40	0	0
3	19274544	.	A	C	22	19	41	0	1	42	0	0
3	19274688	.	T	C	13	14	27	0	2	29	0	0
3	19277027	.	A	G	11	21	32	0	2	34	0	0
3	19277084	.	T	A	20	21	41	0	0	41	0	0
3	19278247	.	T	C	19	23	42	0	1	43	0	0
3	19278796	.	C	T	17	20	37	0	3	40	0	0
3	19281259	.	G	A	0	15	15	0	27	42	0	0
3	19281295	.	A	G	24	15	39	0	1	40	0	0
3	19281310	.	T	A	22	17	39	0	1	40	0	0
3	19336553	.	T	A	3	4	7	0	0	7	0	0
3	19338599	.	C	T	6	4	10	0	0	10	0	0
3	19338875	.	C	T	7	2	9	0	0	9	0	0
3	19346162	.	C	G	1	6	7	0	0	7	0	0
3	19354657	.	G	C	7	8	15	0	0	15	0	0
3	19354902	.	T	C	9	5	14	0	0	14	0	0
3	19609716	.	G	A	9	9	18	0	0	18	0	0
3	19609747	.	G	A	14	8	22	0	0	22	0	0
3	19609897	.	A	C	12	10	22	0	1	23	0	0
3	19610495	.	T	A	5	4	9	0	0	9	0	0
3	19610648	.	A	T	10	14	24	0	1	25	0	0
3	19610655	.	G	T	11	13	24	0	1	25	0	0
3	19610865	.	A	C	29	17	46	0	0	46	0	0
3	19610933	.	A	G	9	6	15	0	1	16	0	0
3	19665429	.	G	A	3	3	6	0	1	7	0	0
3	19676791	.	A	G	3	5	8	0	0	8	0	0
3	19678301	.	A	G	6	5	11	0	0	11	0	0
3	19678310	.	C	T	6	4	10	0	0	10	0	0
3	19686149	.	C	T	5	3	8	0	0	8	0	0
3	19686332	.	G	T	5	2	7	0	1	8	0	0
3	19687393	.	T	C	1	3	4	0	0	4	0	0
3	19702196	.	G	A	4	4	8	0	1	9	0	0
3	19702224	.	T	C	5	8	13	0	0	13	0	0
3	19702551	.	T	C	4	2	6	0	0	6	0	0
3	19706564	.	A	G	6	6	12	0	0	12	0	0
3	19707181	.	G	A	10	4	14	0	0	14	0	0
3	19710389	.	T	C	10	6	16	0	0	16	0	0
3	19717079	.	T	C	7	7	14	0	1	15	0	0
3	19717171	.	T	A	5	9	14	0	1	15	0	0
3	19717459	.	C	T	13	12	25	0	5	30	0	0
3	19717541	.	G	C	9	1	10	1	4	42	27	0
3	19717589	.	T	G	18	0	18	0	22	40	0	0
3	19717656	.	T	C	15	13	28	0	6	34	0	0
3	19717669	.	G	A	12	16	28	0	1	29	0	0
3	19814070	.	A	G	1	2	3	0	0	3	0	0
3	19851120	.	G	C	6	8	14	0	1	15	0	0
3	19851289	.	G	T	18	8	26	0	1	27	0	0
3	19851325	.	T	C	21	12	33	0	1	34	0	0
3	19914453	.	A	G	9	4	13	0	0	13	0	0
3	19914619	.	C	T	9	4	13	0	2	15	0	0
3	19914781	.	G	A	3	4	7	0	6	13	0	0
3	19969409	.	C	T	18	8	26	0	0	26	0	0
3	19969416	.	G	C	19	10	29	0	1	30	0	0
3	19969530	.	G	C	11	18	29	0	1	30	0	0
3	19969560	.	C	T	17	18	35	0	1	36	0	0
3	19969909	.	C	T	18	16	34	0	1	35	0	0
3	19970397	.	C	A	17	14	31	0	4	35	0	0
3	19970589	.	G	A	4	21	25	0	11	36	0	0
3	19971063	.	T	G	28	24	52	0	1	53	0	0
3	19971316	.	A	G	20	21	41	0	2	43	0	0
3	19971719	.	A	C	15	19	34	1	7	42	0	0
3	20015458	.	G	T	6	8	14	0	0	14	0	0
3	20015752	.	T	C	5	6	11	0	1	12	0	0
3	20015785	.	G	C	5	15	20	0	0	20	0	0
3	20021477	.	C	T	4	4	8	0	2	10	0	0
3	20021593	.	C	T	2	6	8	0	1	9	0	0
3	20026042	.	G	T	10	12	22	0	3	25	0	0
3	20026106	.	G	A	20	14	34	0	1	35	0	0
3	20026148	.	G	A	17	12	29	0	2	31	0	0
3	20035849	.	C	T	0	11	11	0	22	33	0	0
3	20036309	.	A	G	9	13	22	0	0	22	0	0
3	20040557	.	C	G	0	8	8	0	13	21	0	0
3	20042325	.	A	T	24	14	38	0	4	42	0	0
3	20042453	.	G	C	27	12	39	0	3	42	0	0
3	20042476	.	C	T	25	15	40	0	1	41	0	0
3	20042679	.	A	G	3	14	17	0	0	17	0	0
3	20042681	.	A	G	3	14	17	0	0	17	0	0
3	20042824	.	A	G	9	22	31	0	1	32	0	0
3	20042965	.	T	C	16	22	38	0	0	38	0	0
3	20043024	.	A	G	19	19	38	0	2	40	0	0
3	20043069	.	C	A	10	23	33	0	2	35	0	0
3	20043121	.	A	T	13	22	35	0	0	35	0	0
3	20043279	.	A	T	3	20	23	0	0	23	0	0
3	20043556	.	C	T	14	7	21	0	0	21	0	0
3	20045679	.	A	G	19	21	40	0	2	42	0	0
3	20049714	.	G	A	9	10	19	0	2	21	0	0
3	20051185	.	G	A	9	8	17	0	0	17	0	0
3	20062718	.	A	G	5	9	14	0	0	14	0	0
3	20063757	.	A	G	11	13	24	0	6	30	0	0
3	20063901	.	C	T	4	7	11	0	0	11	0	0
3	20063917	.	G	A	3	5	8	0	1	9	0	0
3	20063978	.	T	C	3	4	7	0	0	7	0	0
3	20064002	.	C	T	2	6	8	0	1	9	0	0
3	20066145	.	T	A	2	9	11	0	0	11	0	0
3	20066231	.	T	A	5	2	7	0	1	8	0	0
3	20108424	.	A	T	25	22	47	0	2	49	0	0
3	20108636	.	A	T	20	23	43	0	2	45	0	0
3	20108643	.	G	T	15	22	37	0	5	42	0	0
3	20108790	.	T	C	23	15	38	3	5	46	0	0
3	20109247	.	T	C	15	0	15	0	15	30	0	0
3	20109421	.	T	C	18	16	34	0	0	34	0	0
3	20109583	.	A	G	7	13	20	0	0	20	0	0
3	20109861	.	G	A	14	25	39	0	2	41	0	0
3	20109951	.	C	A	14	18	32	0	1	34	1	0
3	20110346	.	A	G	16	17	33	0	4	37	0	0
3	20110359	.	T	A	13	16	29	0	2	31	0	0
3	20110444	.	C	A	13	16	29	0	0	29	0	0
3	20110557	.	A	G	23	22	45	0	3	48	0	0
3	20118281	.	C	G	12	23	35	0	3	38	0	0
3	20192178	.	A	G	1	2	3	0	0	3	0	0
3	20224161	.	A	T	2	2	4	0	0	4	0	0
3	20224548	.	C	A	1	2	3	0	0	3	0	0
3	20224569	.	A	T	1	2	3	0	0	3	0	0
3	20224832	.	T	C	2	2	4	0	0	4	0	0
3	20226236	.	G	A	1	4	5	0	0	5	0	0
3	20226274	.	T	C	0	3	3	0	1	4	0	0
3	20226300	.	T	G	1	2	3	0	0	3	0	0
3	20226515	.	T	C	2	2	4	0	0	4	0	0
3	20226924	.	T	C	6	3	9	0	0	9	0	0
3	20226937	.	A	C	5	3	8	0	0	8	0	0
3	20227443	.	A	G	2	2	4	0	1	5	0	0
3	20227805	.	T	C	1	5	6	0	0	6	0	0
3	20227848	.	A	C	2	2	4	0	2	6	0	0
3	20228052	.	C	T	8	5	13	0	0	13	0	0
3	20228168	.	A	T	4	2	6	0	0	6	0	0
3	20228335	.	T	C	3	3	6	0	1	7	0	0
3	20228616	.	C	G	5	4	9	0	1	10	0	0
3	20228686	.	T	G	3	2	5	1	0	6	0	0
3	20228874	.	C	T	1	3	4	0	1	5	0	0
3	20228961	.	A	G	9	0	9	0	4	13	0	0
3	20229033	.	C	G	4	0	4	0	7	11	0	0
3	20229057	.	A	T	2	4	6	0	0	6	0	0
3	20229235	.	A	G	9	9	18	0	0	18	0	0
3	20229260	.	G	A	9	12	21	0	0	21	0	0
3	20229479	.	A	G	3	6	9	0	0	9	0	0
3	20229503	.	T	A	5	5	10	0	0	10	0	0
3	20229697	.	T	A	3	3	6	0	2	8	0	0
3	20229712	.	T	A	4	3	7	0	1	8	0	0
3	20229746	.	C	T	1	2	3	0	0	3	0	0
3	20230248	.	T	A	1	2	3	0	0	3	0	0
3	20230539	.	T	A	3	4	7	0	0	7	0	0
3	20230598	.	T	C	3	7	10	0	0	10	0	0
3	20230615	.	A	G	1	0	1	1	4	6	0	0
3	20231025	.	T	G	10	5	15	0	0	15	0	0
3	20231060	.	C	T	7	8	15	0	0	15	0	0
3	20231080	.	G	A	3	9	12	0	5	17	0	0
3	20231385	.	C	T	18	12	30	0	3	33	0	0
3	20231483	.	T	A	16	7	23	0	0	24	1	0
3	20231510	.	G	A	17	4	21	0	2	23	0	0
3	20231539	.	C	G	13	7	20	0	1	21	0	0
3	20658235	.	C	T	16	10	26	0	1	27	0	0
3	20658333	.	G	T	19	22	41	0	1	42	0	0
3	20658653	.	C	G	10	17	27	0	1	28	0	0
3	20658809	.	C	T	18	9	27	0	0	27	0	0
3	20658899	.	T	A	10	5	15	0	0	15	0	0
3	20659051	.	T	G	9	15	24	1	5	30	0	0
3	20666937	.	A	G	10	7	17	0	1	18	0	0
3	20666970	.	A	T	8	4	12	0	0	12	0	0
3	20677240	.	A	G	15	8	23	0	2	25	0	0
3	20677261	.	C	A	15	11	26	0	1	27	0	0
3	20720843	.	G	A	2	7	9	0	0	9	0	0
3	20721042	.	C	A	6	5	11	0	0	11	0	0
3	20721049	.	T	A	5	4	9	0	0	9	0	0
3	20948584	.	G	C	1	0	1	0	6	7	0	0
3	20948598	.	G	C	1	4	5	0	1	6	0	0
3	20950366	.	C	T	21	13	34	0	3	37	0	0
3	20950529	.	T	C	27	33	60	2	5	67	0	0
3	20956926	.	C	A	24	23	47	0	2	49	0	0
3	20956957	.	G	A	18	14	32	0	1	33	0	0
3	20973017	.	C	T	1	2	3	0	0	3	0	0
3	20982056	.	G	A	4	3	7	0	1	8	0	0
3	20982061	.	T	C	4	3	7	0	0	7	0	0
3	20985264	.	A	G	2	2	4	0	0	4	0	0
3	21022558	.	C	A	5	6	11	0	1	12	0	0
3	21022993	.	A	G	3	4	7	0	0	7	0	0
3	21022996	.	T	C	3	4	7	0	0	7	0	0
3	21025709	.	A	T	24	23	47	0	2	49	0	0
3	21025986	.	A	T	19	19	38	0	4	42	0	0
3	21026079	.	A	G	23	21	44	0	2	46	0	0
3	21026293	.	A	G	18	16	34	0	0	34	0	0
3	21026370	.	T	C	11	16	27	0	0	27	0	0
3	21026573	.	G	A	2	2	4	0	0	4	0	0
3	21026576	.	C	T	2	2	4	0	1	5	0	0
3	21026729	.	A	G	1	2	3	0	1	4	0	0
3	21026748	.	G	A	0	3	3	0	2	5	0	0
3	21026894	.	A	T	1	3	4	0	0	4	0	0
3	21027101	.	A	T	13	16	29	0	0	29	0	0
3	21027504	.	C	T	12	8	20	0	1	21	0	0
3	21027715	.	C	T	21	12	33	1	1	35	0	0
3	21027749	.	A	T	33	10	43	1	1	45	0	0
3	21029813	.	C	A	24	23	47	0	0	47	0	0
3	21029902	.	T	G	12	27	39	0	1	40	0	0
3	21030101	.	G	A	30	15	45	0	2	47	0	0
3	21030293	.	C	T	27	25	52	0	5	57	0	0
3	21030318	.	A	C	27	28	55	0	4	59	0	0
3	21030730	.	T	C	17	15	32	0	4	37	1	0
3	21044189	.	G	A	17	12	29	0	0	29	0	0
3	21062703	.	T	C	4	0	4	0	4	8	0	0
3	21062721	.	T	A	1	2	3	0	1	4	0	0
3	21066745	.	A	T	8	7	15	0	1	16	0	0
3	21067384	.	A	G	5	12	17	0	5	22	0	0
3	21067565	.	A	G	5	2	7	0	0	7	0	0
3	21067606	.	A	T	6	7	13	0	0	13	0	0
3	21067718	.	T	A	7	10	17	0	0	17	0	0
3	21067911	.	G	T	16	9	25	0	1	26	0	0
3	21068176	.	G	A	10	4	14	1	0	15	0	0
3	21068205	.	G	T	9	3	12	4	0	16	0	0
3	21068378	.	T	G	10	12	22	2	0	24	0	0
3	21074598	.	G	A	13	4	17	0	1	18	0	0
3	21074667	.	G	A	8	3	11	0	1	12	0	0
3	21086092	.	G	A	6	2	8	0	0	8	0	0
3	21087743	.	G	T	2	2	4	0	1	5	0	0
3	21094398	.	C	A	2	3	5	3	0	8	0	0
3	21094462	.	G	A	3	3	6	0	0	6	0	0
3	21096056	.	A	T	2	3	5	0	0	5	0	0
3	21096057	.	T	C	3	2	5	0	0	5	0	0
3	21096176	.	C	T	8	6	14	0	2	16	0	0
3	21096487	.	G	A	18	11	29	0	1	30	0	0
3	21096693	.	T	A	13	17	30	0	1	31	0	0
3	21104470	.	A	G	13	12	25	0	1	26	0	0
3	21111671	.	C	T	1	10	11	0	16	27	0	0
3	21111680	.	T	C	17	8	25	0	0	25	0	0
3	21111916	.	G	C	12	12	24	0	3	27	0	0
3	21111940	.	A	G	12	14	26	0	0	26	0	0
3	21113913	.	C	A	13	14	27	0	3	30	0	0
3	21125687	.	G	T	26	13	39	0	4	43	0	0
3	21126015	.	C	T	40	21	61	0	2	63	0	0
3	21139754	.	T	C	12	5	17	1	1	19	0	0
3	21141184	.	C	T	9	7	16	0	1	17	0	0
3	21142429	.	A	T	7	8	15	0	2	17	0	0
3	21240878	.	A	T	2	4	6	0	0	6	0	0
3	21240971	.	C	G	2	5	7	0	0	7	0	0
3	21241269	.	A	G	4	2	6	0	2	8	0	0
3	21241461	.	G	A	1	3	4	0	1	5	0	0
3	21251642	.	A	T	12	7	19	0	0	19	0	0
3	21251732	.	G	C	10	8	18	0	0	18	0	0
3	21251873	.	A	G	11	8	19	0	1	20	0	0
3	21251924	.	G	A	10	6	16	0	1	17	0	0
3	21252172	.	C	G	16	20	36	0	2	38	0	0
3	21281268	.	T	C	4	2	6	0	1	7	0	0
3	21281483	.	G	C	6	16	22	0	1	23	0	0
3	21281677	.	C	T	2	13	15	0	19	34	0	0
3	21281926	.	A	C	6	6	12	0	0	13	1	0
3	21281927	.	T	A	6	7	13	0	0	13	0	0
3	21282192	.	T	C	8	9	17	0	0	17	0	0
3	21282299	.	T	A	10	5	15	0	3	18	0	0
3	21282340	.	A	G	14	12	26	0	3	29	0	0
3	21282546	.	G	A	11	9	20	0	1	21	0	0
3	21282981	.	A	G	9	9	18	0	0	18	0	0
3	21283365	.	T	C	8	0	8	0	11	19	0	0
3	21283509	.	C	A	6	5	11	0	2	13	0	0
3	21283741	.	T	C	6	6	12	0	0	12	0	0
3	21283759	.	T	C	4	6	10	0	2	12	0	0
3	21283811	.	T	G	13	6	19	0	0	19	0	0
3	21284429	.	A	G	4	2	6	0	0	6	0	0
3	21284430	.	A	G	4	2	6	0	0	6	0	0
3	21284752	.	G	A	2	3	5	0	1	6	0	0
3	21284794	.	G	T	5	3	8	0	1	9	0	0
3	21287697	.	A	G	1	1	2	0	1	3	0	0
3	21287938	.	A	C	3	1	4	0	5	9	0	0
3	21287981	.	C	T	4	4	8	0	0	8	0	0
3	21288007	.	T	C	5	3	8	0	1	9	0	0
3	21288016	.	C	T	5	4	9	0	1	10	0	0
3	21348283	.	T	G	1	2	3	0	0	3	0	0
3	21888195	.	A	G	1	2	3	0	0	3	0	0
3	21888207	.	G	A	1	2	3	0	0	3	0	0
3	21889028	.	T	A	3	6	9	0	1	10	0	0
3	21889268	.	A	G	5	2	7	0	0	7	0	0
3	21889443	.	A	G	2	2	4	0	0	4	0	0
3	22039893	.	C	T	3	2	5	0	0	5	0	0
3	22050000	.	C	A	3	6	9	0	0	9	0	0
3	22050026	.	G	A	1	5	6	0	0	6	0	0
3	22050263	.	G	A	7	6	13	0	0	13	0	0
3	22054324	.	G	A	5	10	15	0	0	15	0	0
3	22054356	.	C	T	7	12	19	0	2	21	0	0
3	22054491	.	C	T	13	10	23	2	1	26	0	0
3	22054724	.	T	C	6	6	12	0	1	13	0	0
3	22054793	.	A	C	9	8	17	0	0	17	0	0
3	22054856	.	G	A	8	4	12	0	3	15	0	0
3	22055128	.	A	G	11	0	11	0	7	18	0	0
3	22055216	.	T	A	7	3	10	0	0	10	0	0
3	22080356	.	T	G	2	3	5	0	0	5	0	0
3	22146900	.	G	C	1	9	10	0	5	16	1	0
3	22146945	.	T	C	4	6	10	0	0	10	0	0
3	22146969	.	C	T	3	5	8	0	1	9	0	0
3	22153178	.	C	T	3	6	9	0	1	10	0	0
3	22153372	.	A	G	9	1	10	0	12	22	0	0
3	22153412	.	A	C	8	7	15	0	1	16	0	0
3	22153849	.	A	G	3	4	7	1	0	8	0	0
3	22153896	.	C	T	6	4	10	1	2	13	0	0
3	22154051	.	A	G	9	5	14	0	2	16	0	0
3	22154174	.	A	G	9	3	12	0	0	12	0	0
3	22154274	.	C	G	3	7	10	0	3	13	0	0
3	22154306	.	G	T	1	10	11	1	6	18	0	0
3	22154429	.	C	T	8	8	16	0	0	16	0	0
3	22154610	.	A	C	15	11	26	0	0	26	0	0
3	22158373	.	G	T	37	16	53	0	6	59	0	0
3	22158416	.	G	C	30	25	55	0	1	56	0	0
3	22158551	.	T	C	29	32	61	0	6	67	0	0
3	22158768	.	T	G	27	27	54	0	3	57	0	0
3	22158904	.	A	T	30	37	67	0	1	68	0	0
3	22159569	.	A	G	25	12	37	5	3	45	0	0
3	22159584	.	C	A	2	7	9	5	24	38	0	0
3	22159697	.	A	G	15	26	41	1	1	43	0	0
3	22159797	.	G	A	11	12	23	0	1	24	0	0
3	22159886	.	C	T	2	2	4	0	0	4	0	0
3	22159892	.	G	T	0	2	2	0	1	3	0	0
3	22160042	.	T	G	13	21	34	0	1	35	0	0
3	22160131	.	C	G	8	20	28	0	0	28	0	0
3	22160421	.	C	T	14	18	32	0	3	35	0	0
3	22160436	.	A	C	16	24	40	0	2	42	0	0
3	22160706	.	T	A	12	8	20	0	0	20	0	0
3	22160767	.	G	T	15	10	25	0	3	33	5	0
3	22160779	.	C	T	17	12	29	0	1	30	0	0
3	22160888	.	A	T	8	6	14	0	5	19	0	0
3	22160947	.	C	A	7	5	12	0	0	15	3	0
3	22161153	.	A	G	14	11	25	0	2	27	0	0
3	22161176	.	G	T	13	10	23	0	1	24	0	0
3	22161317	.	C	T	1	15	16	0	11	27	0	0
3	22161389	.	T	A	11	14	25	0	0	25	0	0
3	22161588	.	C	T	5	9	14	0	0	14	0	0
3	22168615	.	C	T	11	11	22	0	0	22	0	0
3	22172765	.	A	G	9	18	27	0	1	28	0	0
3	22172837	.	G	A	12	11	23	0	2	25	0	0
3	22179835	.	A	C	1	3	4	0	0	4	0	0
3	22179857	.	T	A	1	3	4	0	0	4	0	0
3	22191042	.	T	C	8	16	24	0	0	24	0	0
3	22191044	.	C	A	10	15	25	0	1	26	0	0
3	22213993	.	T	A	5	12	17	0	0	17	0	0
3	22216212	.	T	C	1	0	1	0	3	4	0	0
3	22216358	.	G	A	2	6	8	0	3	11	0	0
3	22216413	.	C	G	1	2	3	0	0	3	0	0
3	22547182	.	A	G	9	4	13	0	1	14	0	0
3	22548052	.	G	A	10	9	19	0	0	19	0	0
3	22548094	.	A	G	9	12	21	0	0	21	0	0
3	22548095	.	G	T	9	12	21	0	0	21	0	0
3	22548263	.	T	A	2	5	7	0	0	7	0	0
3	22548388	.	G	A	8	9	17	0	0	17	0	0
3	22548666	.	C	G	9	11	20	0	2	22	0	0
3	22548677	.	C	T	10	10	20	0	0	20	0	0
3	22548903	.	A	C	10	13	23	0	0	23	0	0
3	22548928	.	T	A	8	12	20	0	0	20	0	0
3	22790318	.	A	G	5	3	8	0	0	8	0	0
3	22792033	.	T	C	1	5	6	0	0	6	0	0
3	22794477	.	A	G	7	5	12	0	2	14	0	0
3	22811835	.	G	A	2	5	7	0	12	19	0	0
3	22812753	.	A	G	9	0	9	0	15	24	0	0
3	22812759	.	C	A	11	10	21	0	3	24	0	0
3	22813052	.	G	A	2	9	11	0	21	33	1	0
3	22813515	.	T	A	8	11	19	0	0	19	0	0
3	22813563	.	G	T	6	7	13	0	2	15	0	0
3	22813569	.	T	G	10	8	18	0	1	19	0	0
3	22813628	.	C	A	12	13	25	0	3	28	0	0
3	22813629	.	T	A	14	14	28	0	0	28	0	0
3	22813778	.	C	T	5	11	16	0	1	17	0	0
3	22813998	.	T	G	8	7	15	0	1	16	0	0
3	22814109	.	G	A	16	15	31	0	1	32	0	0
3	22814147	.	G	A	2	16	18	0	17	35	0	0
3	22814209	.	T	C	23	12	35	0	3	38	0	0
3	22814230	.	A	G	18	0	18	0	15	33	0	0
3	22814453	.	A	G	8	16	24	0	2	26	0	0
3	22814478	.	A	G	8	18	26	0	1	27	0	0
3	22814546	.	G	A	20	15	35	0	1	36	0	0
3	22815296	.	C	A	6	2	8	0	0	8	0	0
3	22815994	.	C	T	1	16	17	0	8	25	0	0
3	22816030	.	A	G	9	7	16	0	1	17	0	0
3	22816166	.	T	C	8	3	11	0	0	11	0	0
3	22816167	.	G	A	8	2	10	0	1	11	0	0
3	22816203	.	T	C	9	0	9	0	4	13	0	0
3	22816204	.	A	G	8	3	11	0	2	13	0	0
3	22816310	.	G	A	2	2	4	0	0	4	0	0
3	22816405	.	G	C	3	3	6	0	0	6	0	0
3	22816586	.	G	A	9	3	12	0	0	12	0	0
3	22816616	.	T	A	7	5	12	0	0	12	0	0
3	22816652	.	A	G	9	4	13	0	0	13	0	0
3	22816676	.	T	C	9	6	15	0	1	16	0	0
3	22816909	.	T	C	12	0	12	0	5	17	0	0
3	22816910	.	A	G	12	4	16	0	1	17	0	0
3	22817004	.	G	T	7	3	10	0	3	13	0	0
3	22817300	.	T	C	8	0	8	0	13	21	0	0
3	22828206	.	C	A	1	2	3	0	0	3	0	0
3	22828257	.	A	G	2	2	4	0	0	4	0	0
3	22967183	.	T	C	5	2	7	0	0	7	0	0
3	22993279	.	A	C	8	7	15	0	0	15	0	0
3	22993542	.	G	A	9	5	14	0	0	14	0	0
3	22993614	.	C	T	9	5	14	0	0	14	0	0
3	22993828	.	C	T	5	3	8	0	1	9	0	0
3	22994078	.	G	T	2	9	11	0	8	19	0	0
3	22994344	.	G	T	0	3	3	0	4	7	0	0
3	23236054	.	C	T	3	7	10	0	0	10	0	0
3	23248840	.	A	G	2	4	6	0	0	6	0	0
3	23250603	.	C	G	1	2	3	0	1	4	0	0
3	23250652	.	G	A	0	3	3	0	5	8	0	0
3	23251018	.	A	G	6	4	10	0	1	11	0	0
3	23251258	.	A	C	3	3	6	0	0	6	0	0
3	23251744	.	G	A	1	5	6	0	5	11	0	0
3	23251822	.	A	G	7	6	13	0	2	15	0	0
3	23302371	.	A	G	8	3	11	0	1	12	0	0
3	23307870	.	G	T	2	7	9	0	9	18	0	0
3	23309155	.	C	A	7	7	14	0	0	14	0	0
3	23309214	.	A	G	7	8	15	0	0	15	0	0
3	23318362	.	G	A	4	6	10	0	1	11	0	0
3	23318368	.	C	T	3	7	10	0	0	10	0	0
3	23323560	.	T	A	9	5	14	0	1	15	0	0
3	23323719	.	T	C	4	2	6	0	1	7	0	0
3	23323788	.	G	A	4	3	7	0	0	7	0	0
3	23323829	.	T	C	1	3	4	0	0	4	0	0
3	23324159	.	T	A	2	7	9	0	1	10	0	0
3	23324235	.	G	A	5	8	13	0	0	13	0	0
3	23324420	.	T	C	2	5	7	0	1	8	0	0
3	23324421	.	T	C	2	6	8	0	0	8	0	0
3	23324536	.	C	T	6	7	13	0	1	14	0	0
3	23324746	.	T	A	11	7	18	0	0	18	0	0
3	23324815	.	T	A	5	9	14	0	2	16	0	0
3	23324829	.	C	T	5	10	15	0	1	16	0	0
3	23325207	.	A	C	8	8	16	0	0	16	0	0
3	23325476	.	G	A	8	6	14	0	2	16	0	0
3	23325559	.	C	T	7	7	14	0	0	14	0	0
3	23326418	.	C	G	5	0	5	0	4	9	0	0
3	23326478	.	G	A	7	6	13	0	0	13	0	0
3	23326711	.	G	A	15	8	23	0	0	23	0	0
3	23327282	.	C	T	15	20	35	0	2	37	0	0
3	23334465	.	A	T	7	4	11	0	0	11	0	0
3	23335024	.	G	A	11	8	19	0	1	20	0	0
3	23348300	.	T	G	6	5	11	0	0	11	0	0
3	23348304	.	C	T	7	6	13	0	0	13	0	0
3	23351944	.	G	A	3	8	11	0	1	12	0	0
3	23363193	.	G	A	2	4	6	0	0	6	0	0
3	23406614	.	G	A	3	3	6	0	0	6	0	0
3	23406637	.	G	C	2	0	2	0	3	5	0	0
3	23406701	.	C	T	6	4	10	0	0	10	0	0
3	23407085	.	G	T	2	3	5	0	0	5	0	0
3	23429169	.	A	C	11	11	22	0	0	22	0	0
3	23429262	.	A	T	17	6	23	0	0	23	0	0
3	23429263	.	T	C	16	6	22	0	1	23	0	0
3	23429696	.	A	G	10	6	16	0	0	16	0	0
3	23429763	.	A	C	15	1	16	0	15	31	0	0
3	23430011	.	G	A	8	9	17	0	1	18	0	0
3	23430067	.	A	G	16	5	21	0	1	22	0	0
3	23430116	.	T	A	14	7	21	0	1	22	0	0
3	23430119	.	C	T	4	7	11	0	12	23	0	0
3	23436305	.	T	A	11	17	28	0	2	30	0	0
3	23442923	.	A	G	4	10	14	0	1	15	0	0
3	23443487	.	G	A	10	3	13	0	2	15	0	0
3	23444539	.	A	T	6	7	13	0	1	14	0	0
3	23444551	.	T	G	3	6	9	0	1	10	0	0
3	23464911	.	C	T	6	5	11	0	1	12	0	0
3	23465292	.	T	C	5	10	15	0	0	15	0	0
3	23466160	.	A	G	8	11	19	0	2	21	0	0
3	23469391	.	C	T	14	5	19	0	0	19	0	0
3	23469438	.	A	G	9	4	13	0	3	16	0	0
3	23469472	.	T	C	5	7	12	0	0	12	0	0
3	23469848	.	T	A	8	5	13	0	0	13	0	0
3	23470037	.	A	C	6	0	6	0	7	13	0	0
3	23470044	.	T	A	8	7	15	0	0	15	0	0
3	23470172	.	G	A	7	6	13	0	0	13	0	0
3	23470173	.	T	A	6	6	12	0	1	13	0	0
3	23488794	.	T	A	5	7	12	0	3	15	0	0
3	23493694	.	T	C	13	23	36	0	2	38	0	0
3	23495767	.	T	C	22	24	46	0	3	49	0	0
3	23495872	.	T	C	21	16	37	0	3	40	0	0
3	23495905	.	G	T	11	11	22	0	0	22	0	0
3	23495908	.	A	G	12	10	22	0	0	22	0	0
3	23499642	.	C	T	0	2	2	0	1	3	0	0
3	23518249	.	G	A	2	2	4	0	0	4	0	0
3	23518281	.	A	T	1	3	4	0	0	4	0	0
3	23583995	.	A	C	3	4	7	0	0	7	0	0
3	23584128	.	G	A	8	8	16	0	0	16	0	0
3	23584577	.	A	C	10	14	24	0	1	25	0	0
3	23584703	.	A	T	18	8	26	0	0	26	0	0
3	23584704	.	T	A	18	8	26	0	0	26	0	0
3	23584748	.	C	A	12	7	19	0	1	20	0	0
3	23591620	.	T	C	11	0	11	0	13	24	0	0
3	23591662	.	G	C	7	0	7	0	9	16	0	0
3	23599844	.	A	C	23	20	43	1	3	47	0	0
3	23696132	.	A	C	1	2	3	0	0	3	0	0
3	23705327	.	T	G	5	0	5	0	3	8	0	0
3	23709399	.	A	G	4	0	4	0	3	7	0	0
3	23709804	.	A	T	3	2	5	1	0	6	0	0
3	23723582	.	C	G	2	2	4	0	0	4	0	0
3	23748628	.	T	A	3	3	6	0	1	7	0	0
3	24071108	.	T	C	13	18	31	0	1	32	0	0
3	24100770	.	C	T	7	11	18	0	0	18	0	0
3	24109865	.	T	A	4	4	8	0	0	8	0	0
3	24111146	.	T	C	9	6	15	0	1	16	0	0
3	24111188	.	G	C	4	3	7	0	0	7	0	0
3	24134600	.	C	T	8	4	12	0	0	12	0	0
3	24134607	.	T	G	9	0	9	0	7	16	0	0
3	24142965	.	C	T	11	3	14	0	0	14	0	0
3	24143559	.	G	A	5	2	7	0	2	9	0	0
3	24144646	.	C	G	7	3	10	0	0	10	0	0
3	24144716	.	C	T	5	6	11	0	4	15	0	0
3	24145191	.	G	A	1	5	6	0	2	8	0	0
3	24196092	.	C	T	2	8	10	1	0	11	0	0
3	24196204	.	T	C	3	2	5	0	0	5	0	0
3	24196365	.	T	G	5	8	13	0	0	13	0	0
3	24196576	.	T	G	4	2	6	0	0	6	0	0
3	24197954	.	G	A	3	2	5	0	0	5	0	0
3	24198970	.	G	A	24	15	39	0	1	40	0	0
3	24200563	.	T	A	22	15	37	0	2	39	0	0
3	24203310	.	A	G	4	4	8	0	1	9	0	0
3	24203504	.	A	G	7	9	16	0	2	18	0	0
3	24203588	.	T	C	5	4	9	0	0	9	0	0
3	24203654	.	G	A	6	4	10	0	0	10	0	0
3	24203676	.	G	T	5	5	10	0	0	10	0	0
3	24203767	.	A	G	4	3	7	0	0	7	0	0
3	24209715	.	T	A	1	2	3	0	1	4	0	0
3	24214534	.	G	T	5	5	10	1	0	11	0	0
3	24216029	.	A	G	5	5	10	0	2	12	0	0
3	24216161	.	T	C	8	11	19	0	2	21	0	0
3	24218282	.	C	T	8	8	16	0	0	16	0	0
3	24218564	.	A	C	3	2	5	0	0	5	0	0
3	24292535	.	C	T	8	4	12	1	1	14	0	0
3	24295067	.	C	A	1	4	5	0	1	6	0	0
3	24295149	.	A	G	2	3	5	0	2	7	0	0
3	24295198	.	C	T	5	3	8	0	1	9	0	0
3	24295292	.	T	C	1	5	6	0	0	6	0	0
3	24361257	.	T	C	24	15	39	0	1	40	0	0
3	24434494	.	T	A	35	26	61	0	9	70	0	0
3	24434512	.	C	G	35	29	64	0	3	67	0	0
3	24434601	.	C	T	39	24	63	0	3	66	0	0
3	24483164	.	A	T	2	7	9	0	0	9	0	0
3	24483259	.	G	A	2	6	8	0	6	14	0	0
3	24487821	.	A	G	9	12	21	0	2	23	0	0
3	24487905	.	A	G	7	10	17	0	2	19	0	0
3	24489838	.	A	G	16	10	26	0	2	28	0	0
3	24501686	.	G	C	19	17	36	0	1	37	0	0
3	24501757	.	G	A	1	13	14	0	16	30	0	0
3	24501772	.	G	A	15	14	29	0	2	31	0	0
3	24690115	.	G	T	1	2	3	0	1	4	0	0
3	24690120	.	A	G	2	2	4	0	0	4	0	0
3	24690213	.	T	C	1	2	3	0	0	3	0	0
3	24691224	.	A	T	1	2	3	0	0	3	0	0
3	24691685	.	C	T	5	2	7	0	0	7	0	0
3	24692005	.	G	T	0	6	6	0	2	8	0	0
3	24692014	.	T	C	2	7	9	0	1	10	0	0
3	24692117	.	T	C	6	6	12	0	0	12	0	0
3	24973667	.	T	A	16	14	30	0	3	33	0	0
3	24973867	.	T	A	16	15	31	0	4	35	0	0
3	24973912	.	T	C	13	0	13	0	15	28	0	0
3	24974298	.	G	A	19	20	39	0	1	40	0	0
3	24990641	.	G	A	3	22	25	0	18	43	0	0
3	24990746	.	A	C	19	21	40	0	2	42	0	0
3	24993657	.	G	C	19	19	38	0	2	40	0	0
3	24993682	.	A	G	13	20	33	0	2	35	0	0
3	24994253	.	T	C	17	22	39	0	6	45	0	0
3	24997055	.	A	T	13	18	31	0	3	34	0	0
3	24997955	.	A	T	13	15	28	0	0	28	0	0
3	24998204	.	C	G	7	8	15	0	0	15	0	0
3	24998533	.	A	G	22	16	38	0	3	41	0	0
3	24998536	.	A	G	21	17	38	0	3	41	0	0
3	24998797	.	C	T	8	19	27	0	1	28	0	0
3	24998833	.	C	T	7	14	21	0	0	21	0	0
3	24998860	.	C	T	10	9	19	1	0	20	0	0
3	24999049	.	T	C	11	4	15	0	2	17	0	0
3	24999601	.	C	T	0	3	3	0	8	11	0	0
3	24999636	.	A	C	6	9	15	0	0	15	0	0
3	24999916	.	A	G	5	13	18	0	1	19	0	0
3	24999955	.	T	G	5	7	12	0	0	12	0	0
3	24999967	.	A	G	6	6	12	0	1	13	0	0
3	25000051	.	G	T	8	4	12	0	0	12	0	0
3	25000114	.	G	A	11	9	20	0	1	21	0	0
3	25000417	.	C	A	0	4	4	0	7	11	0	0
3	25002169	.	A	G	6	3	9	0	1	10	0	0
3	25005814	.	A	C	5	6	11	0	0	11	0	0
3	25007702	.	C	A	2	2	4	0	0	4	0	0
3	25051437	.	A	G	2	2	4	0	0	4	0	0
3	25059771	.	A	G	1	2	3	0	0	3	0	0
3	25060009	.	C	T	2	7	9	0	0	9	0	0
3	25066348	.	A	G	8	6	14	0	0	14	0	0
3	25072445	.	G	C	7	0	7	0	5	12	0	0
3	25081203	.	C	T	4	3	7	0	1	8	0	0
3	25086740	.	T	A	2	2	4	0	0	4	0	0
3	25094590	.	G	A	11	13	24	0	2	26	0	0
3	25094623	.	G	A	0	18	18	0	18	36	0	0
3	25097047	.	C	A	23	18	41	0	4	45	0	0
3	25097218	.	T	A	18	18	36	0	4	40	0	0
3	25097257	.	T	C	18	18	36	0	2	38	0	0
3	25099018	.	A	G	19	26	45	1	2	48	0	0
3	25099883	.	T	C	13	29	42	0	3	45	0	0
3	25099988	.	T	A	22	19	41	0	2	43	0	0
3	25100004	.	A	G	21	20	41	0	2	43	0	0
3	25100182	.	A	T	20	24	44	0	1	45	0	0
3	25100222	.	G	A	1	26	27	0	20	47	0	0
3	25100311	.	C	G	21	23	44	2	3	49	0	0
3	25100379	.	A	T	33	18	51	0	1	52	0	0
3	25100535	.	G	T	9	14	23	0	1	24	0	0
3	25100565	.	T	G	10	0	10	0	9	19	0	0
3	25102030	.	A	T	19	17	36	0	6	42	0	0
3	25102095	.	A	G	26	11	37	0	1	38	0	0
3	25105097	.	A	C	19	1	20	0	27	47	0	0
3	25107705	.	T	C	22	21	43	0	1	44	0	0
3	25107729	.	A	T	15	13	28	0	0	28	0	0
3	25132763	.	T	C	1	1	2	0	0	2	0	0
3	25132781	.	C	T	0	2	2	0	0	2	0	0
3	25132922	.	A	G	1	2	3	0	0	3	0	0
3	25136479	.	C	T	0	13	13	0	6	19	0	0
3	25136571	.	G	A	8	11	19	0	0	19	0	0
3	25136655	.	T	A	10	8	18	0	0	18	0	0
3	25136706	.	C	G	10	6	16	0	1	17	0	0
3	25136819	.	T	G	6	7	13	0	1	14	0	0
3	25136855	.	G	T	9	7	16	0	0	16	0	0
3	25136868	.	A	G	5	6	11	0	2	13	0	0
3	25137144	.	G	T	8	5	13	0	0	13	0	0
3	25137339	.	A	G	1	4	5	0	0	5	0	0
3	25138011	.	G	A	1	5	6	0	0	6	0	0
3	25138264	.	G	T	6	6	12	0	1	13	0	0
3	25138306	.	C	T	7	7	14	0	0	14	0	0
3	25138543	.	C	T	0	2	2	0	1	3	0	0
3	25144211	.	A	G	3	4	7	0	0	7	0	0
3	25167162	.	A	G	4	8	12	0	0	12	0	0
3	25167238	.	C	A	2	6	8	0	1	9	0	0
3	25167332	.	A	C	7	5	12	0	0	12	0	0
3	25167351	.	A	C	6	3	9	0	1	10	0	0
3	25168907	.	A	T	11	10	21	0	0	21	0	0
3	25168994	.	C	T	17	8	25	0	0	25	0	0
3	25169181	.	C	T	4	6	10	0	0	10	0	0
3	25169426	.	C	T	12	6	18	0	0	18	0	0
3	25169483	.	C	T	7	3	10	0	2	12	0	0
3	25169600	.	A	T	6	4	10	0	2	12	0	0
3	25269936	.	A	C	6	19	25	0	0	25	0	0
3	25269960	.	A	G	10	26	36	0	1	37	0	0
3	25270023	.	A	G	12	22	34	0	2	36	0	0
3	25270048	.	G	T	15	24	39	0	0	39	0	0
3	25270058	.	A	C	17	21	38	1	3	42	0	0
3	25270311	.	A	G	42	29	71	0	11	82	0	0
3	25270320	.	A	G	38	28	66	0	15	81	0	0
3	25270602	.	C	G	31	42	73	0	4	77	0	0
3	25270680	.	C	T	31	43	74	0	3	77	0	0
3	25270710	.	A	C	38	35	73	1	2	76	0	0
3	25270752	.	A	G	37	35	72	1	6	79	0	0
3	25271209	.	T	A	24	33	57	0	6	63	0	0
3	25271579	.	C	T	19	24	43	1	1	45	0	0
3	25271653	.	T	C	26	25	51	0	2	53	0	0
3	25272051	.	T	A	33	31	64	0	5	69	0	0
3	25272623	.	C	T	30	28	58	0	5	63	0	0
3	25272859	.	T	A	23	28	51	0	0	51	0	0
3	25273463	.	G	A	23	27	50	0	0	50	0	0
3	25273524	.	G	C	25	21	46	0	2	48	0	0
3	25273648	.	A	G	19	18	37	0	1	38	0	0
3	25286050	.	G	A	13	7	20	0	1	21	0	0
3	25379483	.	C	A	4	18	22	1	17	40	0	0
3	25379546	.	A	G	17	25	42	0	3	45	0	0
3	25381494	.	G	A	17	18	35	0	0	35	0	0
3	25393308	.	A	G	9	18	27	0	2	29	0	0
3	25396677	.	G	T	15	10	25	0	4	29	0	0
3	25400673	.	C	T	1	6	7	0	3	10	0	0
3	25403654	.	G	A	1	2	3	0	0	3	0	0
3	25403685	.	G	A	3	2	5	0	0	5	0	0
3	25403812	.	G	C	5	2	7	0	0	7	0	0
3	25403865	.	G	T	1	2	3	0	1	4	0	0
3	25404591	.	G	A	2	4	6	0	0	6	0	0
3	25404618	.	T	C	3	3	6	0	0	6	0	0
3	25404626	.	G	T	3	4	7	0	0	7	0	0
3	25404699	.	G	A	1	3	4	0	0	4	0	0
3	25436830	.	T	C	8	7	15	0	2	18	1	0
3	25436893	.	T	G	5	6	11	0	5	16	0	0
3	25437284	.	G	T	25	12	37	0	2	39	0	0
3	25491134	.	A	G	4	3	7	0	0	7	0	0
3	25511757	.	A	T	1	2	3	0	0	3	0	0
3	26157626	.	T	C	3	0	3	0	5	8	0	0
3	26157689	.	T	C	1	6	7	0	0	7	0	0
3	26157690	.	T	C	2	0	2	0	5	7	0	0
3	26351448	.	A	G	5	20	25	0	2	27	0	0
3	27695301	.	A	G	2	5	7	0	0	7	0	0
3	27695326	.	A	G	4	0	4	0	3	7	0	0
3	27695434	.	A	G	6	0	6	0	6	12	0	0
3	27767207	.	A	G	9	3	12	0	4	16	0	0
3	27767208	.	A	G	8	2	10	0	6	16	0	0
3	27767284	.	A	G	4	17	21	0	0	21	0	0
3	27767288	.	A	G	11	6	17	0	4	21	0	0
3	27833009	.	T	C	24	8	32	0	4	36	0	0
3	27833093	.	T	C	22	14	36	0	1	37	0	0
3	27834412	.	T	C	17	18	35	0	1	36	0	0
3	27834552	.	T	C	12	8	20	0	1	21	0	0
3	27834563	.	T	C	16	8	24	0	0	24	0	0
3	27836036	.	T	C	5	8	13	0	1	14	0	0
3	28208772	.	C	A	1	4	5	0	0	5	0	0
3	28594831	.	T	C	2	3	5	0	0	5	0	0
3	28619746	.	A	G	3	2	5	0	0	5	0	0
3	28626340	.	A	C	3	4	7	0	0	7	0	0
3	28627044	.	T	A	7	11	18	0	0	18	0	0
3	28627393	.	T	G	2	3	5	0	1	6	0	0
3	28634485	.	T	A	7	4	11	0	0	11	0	0
3	28634549	.	A	G	13	11	24	0	0	24	0	0
3	28634883	.	C	A	12	9	21	0	1	22	0	0
3	28634884	.	A	C	10	10	20	0	2	22	0	0
3	28635106	.	G	A	13	8	21	0	0	21	0	0
3	28640608	.	C	T	2	7	9	0	3	12	0	0
3	28640734	.	G	A	7	7	14	0	0	14	0	0
3	28650721	.	T	C	3	0	3	0	3	6	0	0
3	28665218	.	T	C	3	4	7	0	1	8	0	0
3	28665239	.	G	A	4	3	7	0	0	7	0	0
3	28719103	.	G	A	8	5	13	0	0	13	0	0
3	28719160	.	C	A	2	4	6	0	0	6	0	0
3	28719506	.	C	G	6	8	14	0	1	15	0	0
3	28719592	.	T	G	9	8	17	0	0	17	0	0
3	28719636	.	T	A	9	7	16	0	1	17	0	0
3	28719649	.	C	T	10	7	17	0	0	17	0	0
3	28719730	.	G	T	7	10	17	0	1	19	1	0
3	28719852	.	T	C	4	5	9	0	1	10	0	0
3	28719878	.	G	A	6	9	15	0	0	15	0	0
3	28719905	.	C	A	1	9	10	0	5	15	0	0
3	28719971	.	C	A	0	4	4	0	6	10	0	0
3	28720010	.	G	A	5	4	9	0	0	9	0	0
3	29950927	.	T	C	11	12	23	0	0	23	0	0
3	29951211	.	T	C	7	18	25	0	2	28	1	0
3	29951245	.	T	C	18	16	34	0	1	35	0	0
3	29951246	.	T	C	18	16	34	0	0	35	1	0
3	29951384	.	T	C	18	6	24	0	1	25	0	0
3	30801282	.	G	A	1	2	3	0	0	3	0	0
3	30801297	.	G	T	1	2	3	0	0	3	0	0
3	30868853	.	T	G	6	6	12	0	1	13	0	0
3	30868855	.	T	C	6	6	12	0	1	13	0	0
3	30869205	.	A	G	7	5	12	0	1	13	0	0
3	30869206	.	C	T	9	4	13	0	1	14	0	0
3	30869662	.	C	T	8	5	13	0	1	14	0	0
3	30869728	.	C	T	0	4	4	0	6	10	0	0
3	30869938	.	A	G	2	2	4	0	0	4	0	0
3	30870382	.	T	G	3	5	8	0	0	8	0	0
3	30870409	.	G	A	3	3	6	0	0	6	0	0
3	30870508	.	G	A	4	3	7	0	1	8	0	0
3	30872004	.	C	T	2	2	4	0	0	4	0	0
3	30872264	.	T	G	4	3	7	0	0	7	0	0
3	30888823	.	T	C	39	6	45	0	4	49	0	0
3	30890630	.	T	A	10	10	20	0	0	20	0	0
3	30890869	.	G	A	25	21	46	0	2	48	0	0
3	30891201	.	A	G	20	14	34	0	0	34	0	0
3	30894281	.	A	G	6	4	10	0	2	12	0	0
3	30926689	.	A	G	7	3	10	0	0	10	0	0
3	30926817	.	T	C	3	0	3	0	4	7	0	0
3	30948173	.	G	A	1	4	5	0	0	5	0	0
3	30948206	.	C	A	1	4	5	0	0	5	0	0
3	30962536	.	C	T	0	2	2	0	3	5	0	0
3	31043800	.	T	C	2	3	5	0	1	6	0	0
3	31044205	.	A	G	2	4	6	0	0	6	0	0
3	31044431	.	C	T	5	2	7	0	0	7	0	0
3	31044493	.	A	C	4	4	8	0	0	8	0	0
3	31044579	.	A	G	3	4	7	0	1	8	0	0
3	31044649	.	T	C	3	6	9	0	1	10	0	0
3	31044782	.	A	C	2	0	2	0	8	10	0	0
3	31044916	.	G	C	2	4	6	0	0	6	0	0
3	31044923	.	A	G	2	3	5	0	1	6	0	0
3	31045098	.	G	A	2	2	4	0	0	4	0	0
3	31045407	.	C	A	3	2	5	0	0	5	0	0
3	31045415	.	A	T	3	2	5	0	0	5	0	0
3	31060219	.	A	G	3	0	3	0	6	9	0	0
3	31060366	.	C	T	2	3	5	0	0	5	0	0
3	31063625	.	A	T	7	5	12	0	2	14	0	0
3	31066143	.	C	G	3	3	6	0	0	6	0	0
3	31066637	.	G	A	2	4	6	0	0	6	0	0
3	31069634	.	T	C	16	13	29	0	1	30	0	0
3	31070892	.	A	G	22	14	36	0	1	37	0	0
3	31080994	.	G	A	8	7	15	0	1	16	0	0
3	31081017	.	T	C	6	7	13	0	0	13	0	0
3	31084598	.	C	T	1	4	5	0	1	6	0	0
3	31086366	.	A	G	4	2	6	0	0	6	0	0
3	31090424	.	T	C	2	2	4	0	0	4	0	0
3	31104333	.	A	G	4	4	8	0	0	8	0	0
3	31104943	.	C	T	2	4	6	0	4	10	0	0
3	31104969	.	G	A	10	8	18	0	2	20	0	0
3	31105259	.	A	C	32	23	55	0	2	57	0	0
3	31120249	.	C	T	23	16	39	0	2	41	0	0
3	31122581	.	T	G	13	9	22	0	1	23	0	0
3	31137926	.	T	C	6	3	9	0	0	9	0	0
3	31137957	.	G	A	5	3	8	0	1	9	0	0
3	31138247	.	C	T	5	2	7	0	0	7	0	0
3	31179384	.	G	A	0	2	2	0	2	4	0	0
3	31184034	.	C	T	3	3	6	0	0	6	0	0
3	31187564	.	C	G	5	3	8	0	0	8	0	0
3	31187608	.	C	T	4	5	9	0	1	10	0	0
3	31187719	.	G	A	4	1	5	0	1	6	0	0
3	31187721	.	A	C	4	2	6	0	0	6	0	0
3	31214520	.	G	A	1	4	5	0	0	5	0	0
3	31396474	.	A	G	1	0	1	0	2	3	0	0
3	31396760	.	A	C	6	4	10	0	0	10	0	0
3	31396781	.	C	G	7	0	7	0	3	10	0	0
3	31396826	.	T	C	4	3	7	2	1	10	0	0
3	31430327	.	T	C	4	6	10	0	0	10	0	0
3	31600731	.	T	C	1	3	4	0	0	4	0	0
3	31603766	.	G	A	0	4	4	0	4	8	0	0
3	31603787	.	G	A	5	2	7	0	0	7	0	0
3	31603803	.	T	A	4	2	6	0	0	6	0	0
3	31603925	.	A	G	3	2	5	0	2	7	0	0
3	31603976	.	G	A	3	4	7	0	2	9	0	0
3	31604030	.	T	C	2	8	10	0	0	10	0	0
3	31604053	.	G	A	1	5	6	0	0	6	0	0
3	31604133	.	T	C	5	4	9	0	1	10	0	0
3	31604834	.	A	T	5	2	7	0	2	9	0	0
3	31605033	.	A	G	3	9	12	0	0	12	0	0
3	31605039	.	C	T	3	9	12	0	0	12	0	0
3	31623718	.	G	T	5	3	8	0	0	8	0	0
3	31706607	.	C	A	9	15	24	0	1	25	0	0
3	31706966	.	T	C	5	6	11	0	1	12	0	0
3	31709010	.	C	T	11	23	34	1	0	35	0	0
3	31709079	.	G	A	23	11	34	0	0	34	0	0
3	31711526	.	T	C	6	9	15	0	0	15	0	0
3	31712328	.	G	T	2	2	4	0	0	4	0	0
3	31717595	.	C	T	8	6	14	0	1	15	0	0
3	31722101	.	A	T	18	18	36	0	1	37	0	0
3	31722342	.	A	G	23	26	49	0	1	50	0	0
3	31725824	.	C	T	18	13	31	0	3	34	0	0
3	31726066	.	T	C	23	20	43	1	1	45	0	0
3	31726395	.	G	A	2	7	9	0	12	21	0	0
3	31726541	.	A	T	8	14	22	0	3	25	0	0
3	31726829	.	C	T	11	14	25	3	1	29	0	0
3	31729087	.	T	G	1	2	3	0	0	3	0	0
3	31729177	.	G	C	3	2	5	0	0	5	0	0
3	31729328	.	A	G	1	5	6	0	0	6	0	0
3	31729707	.	C	T	0	5	5	0	4	9	0	0
3	31792600	.	T	A	3	4	7	0	1	8	0	0
3	31792601	.	G	A	4	4	8	0	0	8	0	0
3	31792683	.	G	T	17	5	22	0	3	25	0	0
3	31792856	.	G	A	21	11	32	0	0	32	0	0
3	31793080	.	C	T	10	11	21	0	0	21	0	0
3	31793515	.	T	G	8	5	13	0	0	13	0	0
3	31793518	.	G	A	4	8	12	0	2	14	0	0
3	31793557	.	A	G	2	8	10	0	0	10	0	0
3	31793715	.	G	C	2	12	14	0	1	15	0	0
3	31797508	.	C	G	6	9	15	0	1	16	0	0
3	31797749	.	A	G	7	6	13	0	0	13	0	0
3	31815498	.	G	A	1	2	3	0	0	3	0	0
3	31874969	.	G	T	5	6	11	0	0	11	0	0
3	31879513	.	T	A	4	6	10	0	0	10	0	0
3	31879626	.	G	A	11	3	14	0	1	15	0	0
3	31879725	.	T	A	13	4	17	1	0	18	0	0
3	31879726	.	C	A	13	4	17	1	0	18	0	0
3	31879880	.	G	T	8	21	29	0	0	29	0	0
3	31879911	.	T	C	12	14	26	1	2	29	0	0
3	31880184	.	C	G	1	13	14	0	8	22	0	0
3	31880641	.	C	T	3	13	16	0	15	31	0	0
3	31881082	.	G	T	5	5	10	0	0	10	0	0
3	31884321	.	C	T	2	5	7	0	7	14	0	0
3	31884477	.	C	T	3	4	7	0	2	9	0	0
3	31886783	.	C	T	0	3	3	0	2	5	0	0
3	31914167	.	T	A	4	4	8	0	1	9	0	0
3	31916624	.	T	G	12	2	14	4	15	33	0	0
3	31916701	.	A	T	11	13	24	0	2	26	0	0
3	31916724	.	A	G	8	15	23	0	2	25	0	0
3	31916787	.	G	T	16	23	39	0	0	39	0	0
3	31916863	.	T	C	19	13	32	0	0	32	0	0
3	31917075	.	T	G	14	3	17	0	14	31	0	0
3	31917279	.	G	T	6	6	12	0	0	12	0	0
3	31922838	.	G	C	2	5	7	0	0	7	0	0
3	31926052	.	C	A	12	12	24	0	2	26	0	0
3	31939272	.	A	G	9	10	19	0	3	22	0	0
3	31939473	.	G	T	0	25	25	0	10	35	0	0
3	31939566	.	C	A	14	11	25	0	4	29	0	0
3	31941152	.	C	T	21	17	38	0	1	39	0	0
3	31944357	.	A	T	19	7	26	4	1	31	0	0
3	31951034	.	A	C	4	3	7	0	0	7	0	0
3	31961992	.	G	A	0	5	5	0	3	8	0	0
3	32021628	.	G	A	2	2	4	0	1	5	0	0
3	32049674	.	C	G	1	0	1	1	5	7	0	0
3	32049740	.	C	T	3	9	12	0	2	14	0	0
3	32087455	.	T	G	1	2	3	0	0	3	0	0
3	32098130	.	G	A	0	4	4	0	7	11	0	0
3	32098194	.	C	T	6	3	9	0	0	9	0	0
3	32099841	.	A	G	25	0	25	1	25	51	0	0
3	32100183	.	G	T	16	11	27	23	0	50	0	0
3	32100755	.	T	C	35	11	46	8	2	56	0	0
3	32105746	.	C	A	12	7	19	0	1	20	0	0
3	32106606	.	C	A	1	2	3	0	1	4	0	0
3	32120187	.	A	T	1	3	4	10	0	14	0	0
3	32139671	.	G	A	4	2	6	0	2	8	0	0
3	32139701	.	C	G	5	4	9	0	1	10	0	0
3	32169677	.	C	T	1	3	4	0	0	4	0	0
3	32172636	.	A	T	1	3	4	0	0	4	0	0
3	32175758	.	C	T	0	4	4	0	3	7	0	0
3	32175918	.	C	A	5	4	9	0	0	9	0	0
3	32175945	.	T	C	2	0	2	0	4	6	0	0
3	32294745	.	G	A	20	19	39	0	2	41	0	0
3	32295151	.	C	T	18	12	30	0	3	33	0	0
3	32295294	.	G	A	19	12	31	7	1	39	0	0
3	32295519	.	A	C	16	11	27	0	1	28	0	0
3	32295635	.	T	A	10	5	15	0	2	17	0	0
3	32295733	.	T	A	5	2	7	0	0	7	0	0
3	32296122	.	C	T	13	12	25	0	1	26	0	0
3	32296202	.	G	A	8	8	16	0	0	16	0	0
3	32296253	.	T	A	11	4	15	0	0	15	0	0
3	32296283	.	G	A	10	3	13	0	0	13	0	0
3	32296306	.	G	A	7	7	14	0	0	14	0	0
3	32296379	.	A	G	15	10	25	0	1	26	0	0
3	32296559	.	G	A	13	12	25	0	0	25	0	0
3	32296560	.	C	T	1	12	13	0	12	25	0	0
3	32296673	.	A	G	16	15	31	0	2	33	0	0
3	32296873	.	G	A	12	9	21	0	1	22	0	0
3	32303045	.	G	A	6	5	11	0	1	12	0	0
3	32303698	.	A	G	12	8	20	0	1	21	0	0
3	32314732	.	G	A	3	3	6	0	0	6	0	0
3	32325218	.	A	G	4	5	9	0	0	9	0	0
3	32329167	.	A	T	9	18	27	0	0	27	0	0
3	32357596	.	C	T	21	20	41	4	15	60	0	0
3	32357799	.	A	C	27	25	52	0	3	55	0	0
3	32360978	.	G	A	17	8	25	0	2	27	0	0
3	32361669	.	G	A	12	7	19	0	2	21	0	0
3	32361865	.	A	G	11	6	17	0	0	17	0	0
3	32366131	.	T	C	4	2	6	0	2	8	0	0
3	32366279	.	T	C	2	2	4	0	0	4	0	0
3	32389545	.	C	T	1	16	17	0	0	17	0	0
3	32400967	.	C	T	34	25	59	0	8	67	0	0
3	32401159	.	C	A	33	32	65	0	0	66	1	0
3	32401252	.	C	T	32	28	60	0	3	63	0	0
3	32403959	.	T	G	8	0	8	0	6	14	0	0
3	32405571	.	C	T	15	14	29	0	0	29	0	0
3	32405865	.	G	C	21	12	33	0	4	37	0	0
3	32405910	.	C	T	23	16	39	0	1	40	0	0
3	32406447	.	T	C	29	31	60	0	1	61	0	0
3	32406547	.	T	C	29	21	50	0	5	55	0	0
3	32406618	.	G	A	27	32	59	0	1	60	0	0
3	32406631	.	C	G	27	28	55	0	4	59	0	0
3	32414109	.	T	C	1	3	4	0	0	4	0	0
3	32415781	.	A	C	1	3	4	0	0	4	0	0
3	32435034	.	G	T	1	4	5	0	4	9	0	0
3	32435757	.	G	A	0	6	6	0	4	10	0	0
3	32435874	.	G	A	0	2	2	0	1	3	0	0
3	32436024	.	C	A	4	2	6	0	0	6	0	0
3	32436156	.	T	C	3	3	6	0	0	6	0	0
3	32436426	.	C	T	10	5	15	0	2	17	0	0
3	32436736	.	G	C	7	4	11	0	0	11	0	0
3	32436774	.	G	A	2	4	6	0	2	8	0	0
3	32438425	.	A	C	10	9	19	0	1	20	0	0
3	32440805	.	A	G	15	7	22	0	4	26	0	0
3	32441156	.	T	G	11	0	11	0	19	30	0	0
3	32441297	.	C	A	16	8	24	0	0	24	0	0
3	32441385	.	G	C	18	11	29	0	1	30	0	0
3	32441532	.	G	A	8	10	18	0	10	28	0	0
3	32441779	.	C	T	22	18	40	0	5	45	0	0
3	32441903	.	G	C	2	3	5	0	14	19	0	0
3	32441909	.	A	C	2	4	6	0	9	15	0	0
3	32447386	.	G	A	13	7	20	0	1	21	0	0
3	32447505	.	G	T	22	9	31	0	4	35	0	0
3	32447674	.	C	G	21	16	37	0	0	37	0	0
3	32447800	.	T	C	20	13	33	0	1	34	0	0
3	32450399	.	T	C	19	24	43	0	2	45	0	0
3	32453727	.	G	A	18	18	36	0	2	38	0	0
3	32457325	.	G	A	1	23	24	1	27	52	0	0
3	32457620	.	T	C	17	18	35	0	3	38	0	0
3	32457686	.	T	C	11	23	34	0	2	36	0	0
3	32458627	.	C	T	12	10	22	0	1	23	0	0
3	32477891	.	T	C	2	4	6	0	0	6	0	0
3	32477950	.	T	A	2	4	6	0	1	7	0	0
3	32482222	.	A	T	3	6	9	0	0	9	0	0
3	32482231	.	A	G	3	0	3	0	6	9	0	0
3	32482495	.	G	T	0	5	5	0	6	11	0	0
3	32482834	.	A	G	6	5	11	0	0	11	0	0
3	32483557	.	T	G	9	6	15	0	1	16	0	0
3	32483956	.	T	C	5	2	7	0	0	7	0	0
3	32484034	.	A	G	14	0	14	0	11	25	0	0
3	32484039	.	A	G	13	0	13	0	11	24	0	0
3	32484204	.	T	C	12	7	19	0	0	19	0	0
3	32484472	.	T	C	8	8	16	0	2	18	0	0
3	32484676	.	T	G	17	14	31	0	1	32	0	0
3	32484892	.	A	G	5	4	9	0	1	10	0	0
3	32485306	.	A	G	18	19	37	0	2	39	0	0
3	32485324	.	C	T	19	15	34	0	1	35	0	0
3	32485366	.	A	G	21	12	33	0	0	33	0	0
3	32485519	.	A	C	18	15	33	0	5	38	0	0
3	32485967	.	C	A	32	14	46	1	3	50	0	0
3	32486049	.	A	T	29	17	46	0	5	51	0	0
3	32486069	.	C	G	30	4	34	0	15	49	0	0
3	32489613	.	C	T	29	13	42	0	2	44	0	0
3	32490098	.	C	T	18	9	27	0	5	32	0	0
3	32490251	.	G	T	15	16	31	1	1	33	0	0
3	32490264	.	G	A	14	15	29	0	1	30	0	0
3	32490487	.	G	T	11	12	23	0	2	25	0	0
3	32534263	.	A	G	6	7	13	0	1	14	0	0
3	32534353	.	C	T	13	8	21	0	1	22	0	0
3	32534365	.	T	A	15	6	21	0	0	21	0	0
3	32587304	.	C	T	6	4	10	0	0	10	0	0
3	32641716	.	T	G	4	5	9	0	0	9	0	0
3	32643512	.	G	A	16	8	24	0	0	24	0	0
3	32647124	.	T	C	18	10	28	0	0	28	0	0
3	32647194	.	C	T	10	10	20	0	1	21	0	0
3	32647252	.	G	A	9	9	18	0	3	21	0	0
3	32647308	.	G	C	8	13	21	0	0	22	1	0
3	32647414	.	A	G	14	5	19	0	2	21	0	0
3	32647558	.	A	G	14	0	14	0	16	30	0	0
3	32649846	.	C	T	10	13	23	0	2	25	0	0
3	32649960	.	G	A	9	21	30	0	2	32	0	0
3	32650004	.	A	G	16	12	28	0	0	28	0	0
3	32650199	.	C	A	5	9	14	0	0	14	0	0
3	32657323	.	C	T	1	4	5	0	0	5	0	0
3	32663255	.	T	C	2	3	5	0	0	5	0	0
3	32663335	.	A	G	3	0	3	0	2	5	0	0
3	32663485	.	T	C	7	7	14	0	0	14	0	0
3	32663764	.	T	G	2	4	6	0	0	6	0	0
3	32667118	.	A	C	8	6	14	0	0	14	0	0
3	32668806	.	A	G	11	6	17	0	0	17	0	0
3	32668818	.	A	G	8	6	14	0	1	15	0	0
3	32669040	.	C	G	3	2	5	0	0	5	0	0
3	32675236	.	G	A	12	14	26	0	1	27	0	0
3	32679267	.	T	A	13	14	27	0	1	28	0	0
3	32679289	.	T	A	17	12	29	0	1	30	0	0
3	32679332	.	C	T	26	13	39	0	2	41	0	0
3	32679528	.	C	A	14	10	24	0	1	25	0	0
3	32685708	.	A	G	12	0	12	0	14	26	0	0
3	32686230	.	A	G	10	0	10	0	18	28	0	0
3	32686245	.	T	C	14	15	29	0	0	29	0	0
3	32698500	.	A	G	12	8	20	0	0	20	0	0
3	32700697	.	A	G	5	6	11	0	0	11	0	0
3	32700758	.	A	G	6	9	15	0	1	16	0	0
3	32700988	.	C	T	12	11	23	0	1	24	0	0
3	32701031	.	T	G	13	0	13	0	16	29	0	0
3	32702596	.	T	A	14	6	20	0	0	20	0	0
3	32707219	.	G	A	8	8	16	0	2	18	0	0
3	32707267	.	T	C	7	9	16	0	3	19	0	0
3	32707272	.	C	A	9	9	18	0	0	18	0	0
3	32707480	.	C	T	10	13	23	0	0	23	0	0
3	32707621	.	C	G	14	13	27	0	2	29	0	0
3	32707813	.	C	G	18	17	35	0	0	35	0	0
3	32708077	.	T	C	28	20	48	0	3	51	0	0
3	32710705	.	A	G	29	21	50	0	1	51	0	0
3	32710812	.	G	A	1	40	41	0	15	56	0	0
3	32710999	.	C	A	7	9	16	0	0	16	0	0
3	32711147	.	T	A	3	3	6	0	1	7	0	0
3	32720342	.	T	C	1	2	3	0	0	3	0	0
3	32723033	.	A	G	1	0	1	0	4	5	0	0
3	32723497	.	A	G	1	0	1	0	3	4	0	0
3	32723698	.	C	T	2	2	4	0	1	5	0	0
3	32724010	.	G	A	1	2	3	0	1	4	0	0
3	32724100	.	G	A	2	3	5	0	0	5	0	0
3	32726271	.	A	G	4	4	8	0	1	9	0	0
3	32726357	.	A	G	3	2	5	0	0	5	0	0
3	32728304	.	T	C	1	2	3	0	0	3	0	0
3	32729150	.	T	C	5	3	8	0	0	8	0	0
3	32729232	.	T	C	5	4	9	0	1	10	0	0
3	32729429	.	T	A	3	5	8	0	0	8	0	0
3	32729591	.	C	T	2	8	10	0	1	11	0	0
3	32729663	.	C	T	3	5	8	0	0	8	0	0
3	32729827	.	A	T	4	4	8	0	0	8	0	0
3	32729845	.	G	A	2	3	5	0	0	5	0	0
3	32730011	.	A	G	9	0	9	0	7	16	0	0
3	32730071	.	T	A	6	2	8	0	1	9	0	0
3	32730131	.	A	G	4	4	8	0	0	8	0	0
3	32731255	.	A	G	9	0	9	0	5	14	0	0
3	32731418	.	C	T	7	9	16	0	0	16	0	0
3	32731750	.	A	G	3	0	3	0	4	7	0	0
3	32731804	.	T	C	9	7	16	0	1	17	0	0
3	32731840	.	T	C	6	4	10	0	0	11	1	0
3	32731855	.	T	C	3	4	7	0	0	7	0	0
3	32734926	.	G	A	1	8	9	0	8	17	0	0
3	32741137	.	G	A	1	7	8	0	7	15	0	0
3	32741385	.	G	A	2	9	11	3	11	25	0	0
3	32741809	.	A	G	15	0	15	0	13	28	0	0
3	32777481	.	A	C	7	10	17	0	0	17	0	0
3	32777733	.	G	T	13	17	30	0	1	31	0	0
3	32789985	.	T	C	2	8	10	0	0	10	0	0
3	32794931	.	C	A	1	3	4	0	0	4	0	0
3	32795068	.	C	T	2	2	4	0	1	5	0	0
3	32795425	.	G	A	3	4	7	0	0	7	0	0
3	32795461	.	A	T	3	3	6	0	1	7	0	0
3	32795614	.	C	T	3	4	7	0	1	8	0	0
3	32807667	.	G	A	1	5	6	0	0	6	0	0
3	32808023	.	T	A	6	7	13	0	0	13	0	0
3	32808185	.	T	C	9	14	23	0	3	26	0	0
3	32808214	.	G	A	10	15	25	0	4	29	0	0
3	32808338	.	A	C	17	17	34	0	1	35	0	0
3	32808554	.	T	G	9	11	20	0	0	20	0	0
3	32808771	.	G	A	7	12	19	0	0	19	0	0
3	32808772	.	G	C	6	12	18	0	0	18	0	0
3	32808979	.	T	G	13	9	22	0	1	23	0	0
3	32809154	.	A	T	6	10	16	0	1	17	0	0
3	32809368	.	G	A	14	16	30	0	0	30	0	0
3	32809410	.	G	A	14	7	21	0	0	21	0	0
3	32809432	.	T	A	10	9	19	0	2	21	0	0
3	32809548	.	T	C	5	9	14	0	1	15	0	0
3	32809561	.	G	A	6	13	19	0	0	19	0	0
3	32809836	.	A	G	6	0	6	0	12	18	0	0
3	32809927	.	T	C	11	10	21	0	1	22	0	0
3	32810011	.	T	A	11	5	16	0	2	18	0	0
3	32810580	.	C	T	21	10	31	0	3	34	0	0
3	32810715	.	A	G	25	12	37	0	1	38	0	0
3	32811094	.	A	T	12	10	22	0	0	22	0	0
3	32824056	.	T	C	1	7	8	0	0	8	0	0
3	32824109	.	T	C	3	3	6	0	1	7	0	0
3	32824114	.	T	C	3	2	5	0	0	5	0	0
3	32825564	.	T	A	1	2	3	0	0	3	0	0
3	32825565	.	C	T	1	2	3	0	0	3	0	0
3	32837514	.	G	A	17	15	32	0	5	37	0	0
3	32837643	.	G	A	15	17	32	0	5	37	0	0
3	32837904	.	A	G	24	1	25	0	19	44	0	0
3	32838033	.	G	A	2	16	18	0	16	34	0	0
3	32838039	.	A	G	16	17	33	0	0	33	0	0
3	32842163	.	C	T	14	6	20	1	1	22	0	0
3	32842235	.	G	T	12	10	22	0	1	23	0	0
3	32842318	.	C	T	10	5	15	0	0	15	0	0
3	32847607	.	C	T	1	2	3	0	0	3	0	0
3	32847771	.	G	A	0	2	2	0	4	6	0	0
3	32847923	.	C	A	3	3	6	0	0	6	0	0
3	32847942	.	A	G	2	0	2	0	3	5	0	0
3	32848175	.	T	G	5	3	8	0	1	9	0	0
3	32848418	.	C	T	2	3	5	0	1	6	0	0
3	32848714	.	A	G	4	3	7	0	2	9	0	0
3	32849079	.	C	T	5	6	11	0	1	12	0	0
3	32849679	.	T	A	14	12	26	0	1	27	0	0
3	32850029	.	A	T	14	7	21	0	0	21	0	0
3	32850265	.	A	G	7	0	7	0	11	18	0	0
3	32850499	.	T	C	10	6	16	0	0	16	0	0
3	32854276	.	T	C	10	4	14	0	0	14	0	0
3	32854533	.	T	C	12	7	19	0	1	20	0	0
3	32854743	.	C	G	17	0	17	0	11	28	0	0
3	32854744	.	A	G	18	10	28	0	0	28	0	0
3	32855066	.	G	A	9	5	14	0	0	14	0	0
3	32863016	.	A	G	2	7	9	0	0	9	0	0
3	32863128	.	C	A	4	3	7	0	1	8	0	0
3	32865030	.	T	A	2	4	6	0	1	7	0	0
3	32865309	.	A	C	1	4	5	0	0	5	0	0
3	32866068	.	A	T	1	1	2	0	1	3	0	0
3	32866135	.	C	T	2	2	4	0	0	4	0	0
3	32866175	.	C	G	2	3	5	0	0	5	0	0
3	32867711	.	C	A	1	3	4	0	1	5	0	0
3	32867865	.	A	G	2	9	11	0	0	11	0	0
3	32868114	.	G	T	2	5	7	0	0	7	0	0
3	32868143	.	C	T	2	4	6	0	0	6	0	0
3	32868519	.	G	T	5	4	9	0	0	9	0	0
3	32869770	.	C	T	5	2	7	0	1	8	0	0
3	32869773	.	G	A	5	3	8	0	0	8	0	0
3	32869913	.	C	T	1	4	5	0	0	5	0	0
3	32869930	.	C	T	1	4	5	0	0	5	0	0
3	32870000	.	A	G	2	2	4	0	0	4	0	0
3	32870947	.	A	G	2	7	9	0	0	9	0	0
3	32871023	.	G	C	3	3	6	0	0	6	0	0
3	32871247	.	A	G	3	0	3	0	3	6	0	0
3	32871350	.	T	C	1	3	4	0	1	5	0	0
3	32871413	.	G	A	1	3	4	0	0	4	0	0
3	32871414	.	A	C	1	2	3	0	1	4	0	0
3	32889849	.	T	C	7	0	7	0	16	23	0	0
3	32890002	.	G	T	15	19	34	0	1	35	0	0
3	32890058	.	A	G	16	19	35	1	1	37	0	0
3	32892061	.	G	A	11	16	27	0	0	27	0	0
3	32892422	.	A	G	9	18	27	0	1	28	0	0
3	32900428	.	A	G	7	8	15	0	1	16	0	0
3	32924386	.	G	A	3	5	8	0	0	8	0	0
3	32924643	.	G	A	6	4	10	0	4	14	0	0
3	32924836	.	T	A	16	6	22	0	0	22	0	0
3	32924989	.	G	A	9	5	14	0	0	14	0	0
3	32925248	.	C	T	3	8	11	0	0	11	0	0
3	32925264	.	G	T	6	7	13	0	1	14	0	0
3	32925400	.	C	T	2	2	4	0	0	4	0	0
3	32926016	.	C	T	0	3	3	0	5	8	0	0
3	32926025	.	G	A	7	2	9	0	0	9	0	0
3	32933849	.	A	T	4	2	6	0	1	7	0	0
3	32937628	.	A	G	5	5	10	0	0	10	0	0
3	32941242	.	G	A	5	7	12	0	0	12	0	0
3	32941661	.	A	G	6	10	16	0	0	16	0	0
3	32944203	.	C	A	15	13	28	0	0	28	0	0
3	32944569	.	C	T	13	21	34	0	0	34	0	0
3	32944668	.	C	A	12	12	24	0	1	25	0	0
3	32944854	.	C	T	15	12	27	0	2	29	0	0
3	32947971	.	T	C	25	13	38	0	3	41	0	0
3	32950959	.	G	A	10	16	26	0	1	27	0	0
3	32950977	.	G	A	1	19	20	0	8	28	0	0
3	32951001	.	G	T	0	18	18	0	6	24	0	0
3	32951394	.	G	A	16	24	40	0	0	40	0	0
3	32951564	.	A	C	12	12	24	0	0	24	0	0
3	32951637	.	G	A	7	18	25	0	2	27	0	0
3	32951778	.	C	T	21	18	39	0	3	42	0	0
3	32951891	.	T	C	18	12	30	0	3	33	0	0
3	33065643	.	T	A	8	4	12	1	0	13	0	0
3	33065985	.	A	G	8	4	12	1	1	14	0	0
3	33066155	.	C	T	1	6	7	0	7	14	0	0
3	33066241	.	C	T	0	4	4	2	7	13	0	0
3	33066292	.	C	T	5	8	13	0	2	15	0	0
3	33066714	.	A	T	3	7	10	0	0	10	0	0
3	33066804	.	T	C	2	0	2	0	4	6	0	0
3	33066809	.	C	G	3	3	6	0	0	6	0	0
3	33067092	.	A	T	7	2	9	0	0	9	0	0
3	33067337	.	A	G	2	3	5	0	1	6	0	0
3	33067340	.	A	G	2	2	4	0	1	5	0	0
3	33067376	.	G	A	5	6	11	0	1	12	0	0
3	33067438	.	G	A	7	3	10	0	0	10	0	0
3	33069274	.	A	C	4	9	13	0	1	14	0	0
3	33341072	.	T	A	24	12	36	0	0	36	0	0
3	33344470	.	T	A	18	20	38	0	0	38	0	0
3	33344636	.	A	T	4	5	9	0	0	9	0	0
3	33360480	.	A	G	1	0	1	0	5	6	0	0
3	33368134	.	T	C	2	4	6	0	1	7	0	0
3	33372555	.	G	C	0	4	4	0	3	7	0	0
3	33373443	.	T	C	7	4	11	0	0	11	0	0
3	33373540	.	A	C	6	5	11	0	0	11	0	0
3	33379440	.	A	C	0	2	2	0	1	3	0	0
3	33424010	.	C	T	3	13	16	0	7	23	0	0
3	33424420	.	G	A	29	36	65	0	7	72	0	0
3	33426513	.	G	A	28	41	69	0	5	74	0	0
3	33432379	.	A	C	6	0	6	0	3	9	0	0
3	33433319	.	T	C	1	0	1	0	3	4	0	0
3	33433621	.	G	A	2	2	4	0	0	4	0	0
3	33440693	.	C	T	3	2	5	0	0	5	0	0
3	33445039	.	A	T	4	2	6	0	0	6	0	0
3	33449405	.	C	T	10	9	19	0	0	19	0	0
3	33449554	.	G	A	0	9	9	0	6	15	0	0
3	33452168	.	C	T	16	18	34	0	1	35	0	0
3	33455809	.	G	A	2	16	18	0	16	34	0	0
3	33458803	.	C	T	22	15	37	0	3	40	0	0
3	33458911	.	A	T	21	11	32	0	1	33	0	0
3	33459394	.	T	A	11	7	18	0	0	18	0	0
3	33459489	.	C	T	11	8	19	0	1	20	0	0
3	33459517	.	C	T	13	7	20	0	0	20	0	0
3	33459532	.	G	A	10	6	16	0	1	17	0	0
3	33461366	.	C	T	1	11	12	1	14	27	0	0
3	33461646	.	C	T	2	12	14	0	6	20	0	0
3	33461796	.	A	T	17	13	30	0	0	30	0	0
3	33469413	.	A	G	10	13	23	0	0	23	0	0
3	33469614	.	T	A	8	11	19	0	1	20	0	0
3	33473131	.	C	T	0	5	5	0	4	9	0	0
3	33476589	.	T	C	3	5	8	0	0	8	0	0
3	33494089	.	A	T	3	7	10	0	1	11	0	0
3	33494091	.	G	C	2	8	10	0	1	11	0	0
3	33761597	.	C	T	14	7	21	0	0	21	0	0
3	33761705	.	G	A	2	15	17	0	18	35	0	0
3	33761834	.	G	A	19	14	33	0	1	34	0	0
3	33761835	.	A	T	17	14	31	0	2	33	0	0
3	33762068	.	A	G	13	13	26	0	0	26	0	0
3	33762278	.	A	G	16	16	32	0	2	34	0	0
3	33762310	.	C	A	13	16	29	0	1	30	0	0
3	33762408	.	T	A	9	16	25	0	1	26	0	0
3	33762480	.	C	T	4	6	10	0	1	11	0	0
3	33773294	.	A	G	14	13	27	0	1	28	0	0
3	33777317	.	T	G	11	17	28	0	7	35	0	0
3	33777425	.	A	G	10	10	20	0	0	20	0	0
3	33777807	.	A	G	14	19	33	0	1	34	0	0
3	33820291	.	T	C	5	5	10	0	1	11	0	0
3	33820568	.	C	T	3	2	5	0	0	5	0	0
3	33820580	.	A	G	3	2	5	0	0	5	0	0
3	33842844	.	A	G	2	3	5	0	0	5	0	0
3	33844761	.	T	C	2	0	2	0	2	4	0	0
3	33918611	.	A	G	2	3	5	0	1	6	0	0
3	33918675	.	T	G	4	6	10	0	0	10	0	0
3	33918775	.	A	G	5	4	9	0	0	9	0	0
3	33921663	.	A	C	3	8	11	0	1	12	0	0
3	33922168	.	T	A	2	3	5	0	0	5	0	0
3	33922198	.	C	T	1	1	2	0	1	3	0	0
3	33922233	.	T	A	6	3	9	0	0	9	0	0
3	33922245	.	T	C	6	2	8	0	1	9	0	0
3	33922269	.	A	G	8	3	11	0	0	11	0	0
3	33922359	.	G	A	6	8	14	0	1	15	0	0
3	33922413	.	T	A	9	7	16	0	0	16	0	0
3	33922415	.	G	A	9	7	16	0	0	16	0	0
3	33922471	.	T	C	11	8	19	0	0	19	0	0
3	33932170	.	C	T	1	8	9	0	10	19	0	0
3	33932430	.	T	A	5	7	12	0	1	13	0	0
3	33932628	.	G	A	9	8	17	0	0	17	0	0
3	33936783	.	G	C	3	3	6	0	0	6	0	0
3	33948686	.	A	T	2	4	6	0	0	6	0	0
3	33948734	.	T	C	1	2	3	0	0	3	0	0
3	34129941	.	C	T	0	17	17	0	12	29	0	0
3	34135868	.	C	T	5	3	8	0	1	9	0	0
3	34144353	.	A	T	1	2	3	0	1	4	0	0
3	34146338	.	C	T	3	4	7	0	0	7	0	0
3	34146882	.	G	T	7	7	14	0	1	15	0	0
3	34146955	.	A	G	6	5	11	0	1	12	0	0
3	34166288	.	C	A	11	8	19	1	0	20	0	0
3	34170913	.	G	A	15	20	35	0	2	37	0	0
3	34180096	.	G	T	9	3	12	0	1	13	0	0
3	34182164	.	C	T	5	6	11	0	0	11	0	0
3	34182306	.	G	C	10	5	15	0	0	15	0	0
3	34182376	.	A	C	5	5	10	0	1	11	0	0
3	34182386	.	G	A	0	6	6	0	5	11	0	0
3	34220359	.	A	T	1	7	8	0	0	8	0	0
3	34244901	.	G	C	7	12	19	0	2	21	0	0
3	34258965	.	G	A	13	10	23	0	2	25	0	0
3	34259013	.	C	G	17	11	28	0	1	29	0	0
3	34259060	.	C	T	22	21	43	0	0	43	0	0
3	34259868	.	A	G	8	7	15	0	12	28	1	0
3	34260325	.	T	C	11	6	17	0	0	17	0	0
3	34260808	.	T	C	10	6	16	0	1	17	0	0
3	34261204	.	T	C	4	11	15	0	0	15	0	0
3	34261354	.	A	G	14	19	33	0	0	33	0	0
3	34261795	.	G	A	8	12	20	0	0	20	0	0
3	34262290	.	C	T	3	9	12	0	2	14	0	0
3	34262421	.	C	A	7	4	11	0	0	11	0	0
3	34262639	.	G	A	8	12	20	0	4	24	0	0
3	34262823	.	A	T	8	12	20	0	0	20	0	0
3	34263007	.	C	T	0	3	3	0	7	12	2	0
3	34263101	.	T	A	8	2	10	0	1	11	0	0
3	34263566	.	C	A	5	2	7	0	0	7	0	0
3	34264140	.	A	T	4	3	7	0	0	7	0	0
3	34264634	.	T	A	3	5	8	0	1	9	0	0
3	34264657	.	A	T	2	3	5	0	1	6	0	0
3	34327103	.	G	A	1	6	7	0	1	8	0	0
3	34455822	.	T	C	1	0	1	0	6	7	0	0
3	34456249	.	C	A	1	3	4	0	0	4	0	0
3	34456327	.	A	G	1	2	3	0	0	3	0	0
3	34456397	.	G	A	2	2	4	0	0	4	0	0
3	34456405	.	A	G	3	2	5	0	0	5	0	0
3	34456538	.	A	G	2	2	4	0	1	5	0	0
3	34588493	.	A	G	2	2	4	0	0	4	0	0
3	34588588	.	T	C	2	0	2	0	3	5	0	0
3	34588663	.	T	G	2	2	4	0	0	4	0	0
3	34588788	.	G	A	2	5	7	0	0	7	0	0
3	34589396	.	A	C	4	2	6	0	0	6	0	0
3	34590350	.	A	C	1	2	3	0	0	3	0	0
3	34697461	.	G	A	6	4	10	0	2	12	0	0
3	34767112	.	G	T	30	25	55	0	4	59	0	0
3	34767662	.	T	G	26	35	61	0	6	67	0	0
3	34767669	.	G	A	26	40	66	0	0	66	0	0
3	34772941	.	T	G	31	38	69	0	1	71	1	0
3	34775942	.	G	A	32	29	61	0	2	63	0	0
3	34776115	.	T	G	19	33	52	0	2	54	0	0
3	34776133	.	G	C	17	31	48	0	3	51	0	0
3	34776151	.	C	A	24	33	57	0	1	58	0	0
3	34781074	.	A	G	20	22	42	0	2	44	0	0
3	34781095	.	C	T	18	25	43	0	4	47	0	0
3	34781448	.	T	C	7	13	20	0	3	23	0	0
3	34781586	.	T	C	10	1	11	0	11	22	0	0
3	34783970	.	G	A	6	6	12	0	1	13	0	0
3	34783982	.	A	G	4	7	11	0	1	12	0	0
3	34801034	.	T	C	5	4	9	0	0	9	0	0
3	34804427	.	A	G	20	12	32	0	3	35	0	0
3	34811099	.	T	C	1	3	4	0	0	4	0	0
3	34814839	.	A	G	5	3	8	0	0	8	0	0
3	34822049	.	C	T	14	9	23	0	1	24	0	0
3	34822169	.	C	T	12	11	23	0	1	24	0	0
3	34822214	.	T	C	11	7	18	1	2	21	0	0
3	34919892	.	C	T	5	9	14	0	1	15	0	0
3	34977497	.	A	G	13	0	13	0	8	21	0	0
3	34977508	.	A	G	11	0	11	0	7	18	0	0
3	34981394	.	T	C	5	4	9	0	1	10	0	0
3	34994140	.	C	T	37	28	65	1	1	67	0	0
3	34994750	.	A	G	17	19	36	0	2	38	0	0
3	35170112	.	T	C	12	9	21	0	2	24	1	0
3	35225160	.	A	G	23	1	24	0	18	42	0	0
3	35225202	.	C	T	20	15	35	0	1	36	0	0
3	35248470	.	T	C	10	17	27	0	1	28	0	0
3	35248492	.	T	A	12	16	28	0	1	29	0	0
3	35249369	.	T	C	24	11	35	0	0	35	0	0
3	35249535	.	T	C	21	21	42	0	2	44	0	0
3	35250145	.	A	T	23	19	42	0	1	43	0	0
3	35250188	.	A	G	13	23	36	0	4	40	0	0
3	35264406	.	T	G	27	20	47	0	2	49	0	0
3	35264460	.	C	T	24	20	44	0	2	46	0	0
3	35264744	.	T	A	15	15	30	0	1	31	0	0
3	35264951	.	G	A	22	11	33	0	2	35	0	0
3	35265350	.	T	C	21	17	38	4	3	45	0	0
3	35265419	.	T	G	22	18	40	0	2	42	0	0
3	35265654	.	G	A	2	31	33	0	22	55	0	0
3	35266006	.	G	A	5	5	10	0	0	10	0	0
3	35298531	.	G	T	4	5	9	0	1	10	0	0
3	35298725	.	T	A	2	3	5	0	0	5	0	0
3	35374719	.	C	T	12	6	18	0	1	19	0	0
3	35375112	.	G	A	15	15	30	0	1	31	0	0
3	35375162	.	T	A	16	14	30	0	1	31	0	0
3	35375279	.	A	T	11	13	24	0	0	24	0	0
3	35375306	.	T	C	10	11	21	0	1	22	0	0
3	35375448	.	T	G	26	0	26	0	11	37	0	0
3	35375638	.	T	A	14	13	27	0	1	28	0	0
3	35406648	.	G	T	0	3	3	0	2	5	0	0
3	35418047	.	A	G	4	7	11	0	0	11	0	0
3	35419683	.	A	T	7	9	16	0	0	17	1	0
3	35420588	.	A	G	9	6	15	0	3	18	0	0
3	35420604	.	C	T	7	7	14	0	3	17	0	0
3	35514786	.	C	T	1	2	3	0	0	3	0	0
3	35514849	.	C	A	2	3	5	0	0	5	0	0
3	35515053	.	G	T	2	2	4	0	1	5	0	0
3	35515074	.	C	T	1	2	3	0	1	4	0	0
3	35515179	.	T	C	1	3	4	0	0	4	0	0
3	35517999	.	A	C	4	7	11	0	0	11	0	0
3	35518036	.	C	G	3	7	10	0	0	10	0	0
3	35518464	.	A	C	2	4	6	0	0	6	0	0
3	35518962	.	C	A	2	4	6	0	0	6	0	0
3	35523824	.	C	G	9	4	13	0	1	14	0	0
3	35527024	.	T	C	6	4	10	0	0	10	0	0
3	35529040	.	T	C	9	8	17	0	1	18	0	0
3	35530787	.	C	T	4	3	7	0	0	7	0	0
3	35531018	.	T	C	11	8	19	0	5	24	0	0
3	35531028	.	T	C	9	8	17	0	6	23	0	0
3	35531328	.	G	A	1	4	5	2	13	20	0	0
3	35531329	.	A	T	12	4	16	2	2	20	0	0
3	35531671	.	A	T	8	11	19	0	2	21	0	0
3	35531791	.	A	G	15	0	15	0	20	35	0	0
3	35531866	.	T	A	21	22	43	0	2	45	0	0
3	35531985	.	G	A	25	21	46	0	3	49	0	0
3	35532074	.	A	T	14	17	31	1	1	33	0	0
3	35532452	.	A	T	17	22	39	0	3	42	0	0
3	35532634	.	A	G	23	0	23	0	19	42	0	0
3	35532665	.	C	T	24	11	35	0	5	40	0	0
3	35532736	.	A	C	18	15	33	0	1	34	0	0
3	35535484	.	G	A	1	2	3	0	0	3	0	0
3	35535695	.	A	C	3	2	5	0	1	6	0	0
3	35535702	.	G	T	3	3	6	0	0	6	0	0
3	35536115	.	C	G	11	20	31	0	3	34	0	0
3	35536269	.	G	A	13	12	25	0	0	25	0	0
3	35541273	.	A	G	30	20	50	0	3	53	0	0
3	35548780	.	T	C	1	5	6	0	0	6	0	0
3	35549002	.	G	A	5	2	7	0	0	7	0	0
3	35551047	.	A	T	19	12	31	0	0	32	1	0
3	35551190	.	C	T	0	13	13	0	14	27	0	0
3	35589548	.	C	T	25	18	43	0	2	45	0	0
3	35589881	.	T	C	24	16	40	0	4	44	0	0
3	35589908	.	A	G	23	25	48	0	2	50	0	0
3	35589918	.	G	A	22	25	47	0	4	51	0	0
3	35590270	.	T	C	28	0	28	0	30	58	0	0
3	35602007	.	A	C	12	2	14	0	30	44	0	0
3	35602047	.	A	G	17	20	37	0	2	39	0	0
3	35602153	.	A	G	13	12	25	0	1	26	0	0
3	35602154	.	T	A	13	12	25	0	1	26	0	0
3	35621473	.	G	A	0	2	2	0	1	3	0	0
3	35634953	.	A	G	7	7	14	0	1	15	0	0
3	35635279	.	A	G	7	0	7	1	3	11	0	0
3	35635323	.	A	G	12	4	16	0	1	17	0	0
3	35636172	.	A	G	9	4	13	0	0	13	0	0
3	35638008	.	T	A	21	8	29	0	2	31	0	0
3	35638119	.	A	C	21	18	39	0	0	39	0	0
3	35638201	.	A	G	21	15	36	1	2	39	0	0
3	35638240	.	C	T	15	15	30	0	0	30	0	0
3	35638366	.	T	C	15	9	24	0	0	24	0	0
3	35638450	.	T	A	13	6	19	0	4	23	0	0
3	35638513	.	G	A	19	8	27	0	3	30	0	0
3	35638908	.	C	T	2	19	21	0	20	41	0	0
3	35638986	.	C	A	22	21	43	0	4	47	0	0
3	35639020	.	A	G	19	27	46	0	0	46	0	0
3	35639021	.	G	A	19	27	46	0	0	46	0	0
3	35639194	.	T	C	10	17	27	0	3	30	0	0
3	35639621	.	A	C	19	15	34	0	1	35	0	0
3	35639817	.	T	A	7	6	13	0	3	16	0	0
3	35639862	.	G	T	10	7	17	0	2	19	0	0
3	35639958	.	T	C	10	5	15	0	0	15	0	0
3	35640042	.	A	G	9	6	15	0	1	16	0	0
3	35640122	.	G	T	7	11	18	0	1	19	0	0
3	35640313	.	A	G	10	5	15	0	0	15	0	0
3	35640441	.	C	A	9	4	13	0	0	13	0	0
3	35640588	.	A	G	4	4	8	0	0	8	0	0
3	35640625	.	C	T	8	8	16	0	0	16	0	0
3	35640784	.	T	C	12	17	29	0	0	29	0	0
3	35641173	.	C	T	5	6	11	0	2	13	0	0
3	35641371	.	C	T	1	16	17	0	13	30	0	0
3	35641382	.	G	A	16	15	31	0	0	31	0	0
3	35641595	.	A	T	9	12	21	0	1	22	0	0
3	35641663	.	T	C	13	4	17	0	1	18	0	0
3	35641785	.	C	T	2	3	5	0	4	9	0	0
3	35642012	.	A	T	11	5	16	0	1	17	0	0
3	35642072	.	A	G	7	8	15	0	0	15	0	0
3	35642242	.	T	C	3	0	3	0	7	10	0	0
3	35642462	.	T	C	4	1	5	0	6	11	0	0
3	35643320	.	G	A	3	4	7	0	2	9	0	0
3	35643540	.	G	A	6	9	15	0	2	17	0	0
3	35643546	.	A	T	5	9	14	0	2	16	0	0
3	35645380	.	T	C	6	1	7	0	16	23	0	0
3	35645411	.	G	A	6	10	16	0	0	16	0	0
3	35645661	.	T	G	1	9	10	0	1	11	0	0
3	35646025	.	G	T	4	6	10	0	1	11	0	0
3	35646160	.	G	T	4	5	9	0	0	9	0	0
3	35646611	.	T	G	1	2	3	0	0	3	0	0
3	35647321	.	G	A	1	5	6	0	1	7	0	0
3	35831029	.	T	C	1	4	5	0	1	6	0	0
3	35831167	.	T	C	1	3	4	0	0	4	0	0
3	35845774	.	T	C	2	2	4	0	0	4	0	0
3	35845805	.	A	G	2	4	6	0	0	6	0	0
3	35846120	.	C	G	6	9	15	0	1	16	0	0
3	35846343	.	C	G	2	8	10	2	0	12	0	0
3	35846410	.	A	T	3	11	14	0	0	14	0	0
3	35846440	.	G	A	2	10	12	0	2	14	0	0
3	35846823	.	A	G	5	5	10	0	1	11	0	0
3	35849855	.	T	C	2	2	4	0	0	4	0	0
3	35850254	.	G	A	4	2	6	0	0	6	0	0
3	35850364	.	A	G	4	5	9	0	0	9	0	0
3	35850380	.	C	T	4	4	8	0	1	9	0	0
3	36023342	.	T	G	7	19	26	0	0	26	0	0
3	36023455	.	A	G	13	12	25	0	0	25	0	0
3	36023465	.	A	G	11	17	28	0	1	29	0	0
3	36026294	.	C	G	3	14	17	0	20	37	0	0
3	36032241	.	G	A	14	17	31	0	2	33	0	0
3	36038631	.	G	A	13	11	24	0	0	24	0	0
3	36040863	.	A	G	7	8	15	0	1	16	0	0
3	36041017	.	A	C	12	9	21	0	2	23	0	0
3	36123546	.	G	A	6	3	9	0	0	9	0	0
3	36125256	.	C	G	1	4	5	0	0	5	0	0
3	36131883	.	T	A	4	7	11	0	0	11	0	0
3	36132099	.	C	T	5	6	11	0	1	12	0	0
3	36132740	.	T	C	9	7	16	0	0	16	0	0
3	36135084	.	A	G	2	3	5	0	0	5	0	0
3	36135211	.	A	T	2	3	5	0	0	5	0	0
3	36135481	.	A	G	3	2	5	0	0	5	0	0
3	36135641	.	T	A	4	4	8	0	0	8	0	0
3	36135867	.	A	C	1	2	3	0	0	3	0	0
3	36136609	.	T	C	6	3	9	0	0	9	0	0
3	36143805	.	C	T	0	3	3	0	1	4	0	0
3	36143844	.	G	A	1	2	3	0	1	4	0	0
3	36173633	.	T	C	19	9	28	1	2	31	0	0
3	36174175	.	C	A	14	19	33	0	3	36	0	0
3	36174248	.	C	G	12	7	19	1	1	21	0	0
3	36174276	.	T	C	8	0	8	0	12	20	0	0
3	36184806	.	A	G	6	12	18	0	1	19	0	0
3	36188400	.	A	G	3	3	6	0	0	6	0	0
3	36210030	.	G	A	2	3	5	0	1	6	0	0
3	36210074	.	C	T	2	3	5	0	1	6	0	0
3	36210307	.	T	A	1	2	3	0	1	4	0	0
3	36228295	.	G	A	2	3	5	0	0	5	0	0
3	36228319	.	T	G	1	4	5	0	1	6	0	0
3	36229823	.	G	A	3	3	6	0	1	7	0	0
3	36229886	.	A	T	1	4	5	0	0	5	0	0
3	36232218	.	A	G	4	5	9	0	0	9	0	0
3	36232331	.	C	T	7	12	19	0	1	20	0	0
3	36232368	.	A	C	3	6	9	0	2	11	0	0
3	36241839	.	T	C	7	5	12	0	0	12	0	0
3	36241938	.	T	C	5	0	5	0	9	14	0	0
3	36242239	.	C	T	1	7	8	0	5	13	0	0
3	36248869	.	T	C	6	21	27	0	1	28	0	0
3	36249172	.	C	T	6	8	14	0	1	15	0	0
3	36249419	.	G	A	24	5	29	1	1	31	0	0
3	36249476	.	T	A	22	15	37	1	0	38	0	0
3	36249516	.	T	A	18	10	28	0	2	30	0	0
3	36249518	.	A	C	16	12	28	0	2	30	0	0
3	36253186	.	G	A	10	15	25	0	4	29	0	0
3	36255436	.	A	G	10	19	29	0	1	30	0	0
3	36259855	.	T	C	11	6	17	0	3	20	0	0
3	36262799	.	A	C	33	1	34	0	12	46	0	0
3	36263099	.	T	C	21	0	21	0	17	38	0	0
3	36263151	.	A	G	24	18	42	0	1	43	0	0
3	36263163	.	C	T	19	21	40	0	2	42	0	0
3	36263464	.	C	A	16	13	29	0	2	31	0	0
3	36263557	.	A	G	18	20	38	0	1	39	0	0
3	36263563	.	T	A	17	22	39	0	0	39	0	0
3	36263596	.	T	C	6	0	6	0	16	22	0	0
3	36263666	.	T	C	13	0	13	0	10	23	0	0
3	36263824	.	T	C	16	25	41	0	1	42	0	0
3	36263895	.	A	T	24	19	43	0	1	44	0	0
3	36264028	.	T	C	17	0	17	0	12	29	0	0
3	36264204	.	T	G	18	12	30	0	1	31	0	0
3	36264217	.	A	C	17	12	29	0	3	32	0	0
3	36264248	.	T	C	15	13	28	1	1	30	0	0
3	36264498	.	G	A	14	10	24	0	1	25	0	0
3	36264582	.	C	G	3	12	15	0	1	16	0	0
3	36264822	.	C	A	3	4	7	0	0	7	0	0
3	36265895	.	C	T	0	13	13	0	12	25	0	0
3	36266137	.	T	A	7	13	20	0	1	21	0	0
3	36266173	.	A	G	8	7	15	0	1	16	0	0
3	36268616	.	A	G	5	4	9	0	0	9	0	0
3	36291213	.	A	G	6	0	6	0	11	17	0	0
3	36293950	.	C	T	6	10	16	0	0	16	0	0
3	36293964	.	C	T	7	8	15	0	0	15	0	0
3	36305854	.	A	G	21	21	42	0	2	44	0	0
3	36305860	.	A	G	22	1	23	0	19	42	0	0
3	36305971	.	T	A	7	20	27	0	0	27	0	0
3	36323001	.	T	C	1	2	3	0	0	3	0	0
3	36323523	.	T	C	3	2	5	0	0	5	0	0
3	36325726	.	C	T	1	4	5	0	0	5	0	0
3	36325802	.	A	G	5	0	5	0	8	13	0	0
3	36326031	.	C	T	3	2	5	0	0	5	0	0
3	36326252	.	A	G	3	4	7	0	0	7	0	0
3	36326270	.	A	G	2	3	5	0	0	5	0	0
3	36326370	.	A	G	7	3	10	0	1	11	0	0
3	36327097	.	C	T	6	3	9	0	0	9	0	0
3	36327129	.	G	A	7	9	16	0	1	17	0	0
3	36327306	.	A	T	3	3	6	0	0	6	0	0
3	36327414	.	T	A	1	3	4	0	0	4	0	0
3	36327553	.	T	C	1	2	3	0	0	3	0	0
3	36327773	.	A	T	3	3	6	0	2	8	0	0
3	36327872	.	G	A	7	5	12	0	0	12	0	0
3	36327961	.	A	G	7	2	9	0	0	9	0	0
3	36327970	.	G	A	5	3	8	0	0	8	0	0
3	36328029	.	T	G	4	4	8	0	1	9	0	0
3	36328083	.	G	T	5	2	7	0	0	7	0	0
3	36328204	.	C	A	6	4	10	0	2	12	0	0
3	36328218	.	G	A	8	7	15	0	0	15	0	0
3	36328390	.	A	T	4	2	6	0	0	6	0	0
3	36328414	.	T	A	4	3	7	0	0	7	0	0
3	36349063	.	G	A	1	1	2	0	1	3	0	0
3	36402930	.	T	C	2	0	2	0	7	9	0	0
3	36407283	.	C	A	4	5	9	0	2	11	0	0
3	36407604	.	A	G	4	3	7	0	0	7	0	0
3	36409656	.	C	T	2	2	4	0	0	4	0	0
3	36409877	.	C	T	2	6	8	0	0	8	0	0
3	36409969	.	T	C	3	2	5	0	0	5	0	0
3	36419512	.	C	T	1	2	3	0	0	3	0	0
3	36428612	.	T	A	20	19	39	0	2	41	0	0
3	36428620	.	T	A	22	16	38	0	2	40	0	0
3	36431380	.	T	C	22	17	39	0	1	40	0	0
3	36441465	.	G	A	6	4	10	0	2	12	0	0
3	36441484	.	T	C	8	6	14	0	0	14	0	0
3	36442021	.	T	C	6	11	17	0	4	21	0	0
3	36442029	.	A	G	7	7	14	0	3	17	0	0
3	36442071	.	A	G	10	7	17	0	0	17	0	0
3	36442551	.	C	T	4	20	24	0	14	38	0	0
3	36442661	.	T	G	11	12	23	0	3	26	0	0
3	36442726	.	A	G	14	13	27	0	1	28	0	0
3	36443189	.	G	A	14	13	27	0	0	27	0	0
3	36446613	.	A	G	6	6	12	0	3	15	0	0
3	37104671	.	A	G	2	2	4	0	0	4	0	0
3	37105409	.	C	T	5	2	7	0	1	8	0	0
3	37558571	.	C	A	5	2	7	0	0	7	0	0
3	37559334	.	A	T	24	30	54	0	1	55	0	0
3	37559905	.	A	C	13	18	31	0	1	32	0	0
3	37564769	.	G	A	17	13	30	0	0	30	0	0
3	37571596	.	C	A	7	2	9	0	2	11	0	0
3	37660307	.	G	A	7	8	15	0	0	15	0	0
3	37664117	.	A	T	10	10	20	0	1	21	0	0
3	37664635	.	A	G	13	16	29	0	0	29	0	0
3	37665855	.	G	A	21	18	39	0	0	39	0	0
3	37666774	.	C	T	0	10	10	0	13	23	0	0
3	37667562	.	C	T	3	5	8	0	20	28	0	0
3	37667608	.	G	C	17	12	29	0	0	29	0	0
3	37667646	.	C	T	7	9	16	0	7	23	0	0
3	37667952	.	C	T	2	7	9	0	15	24	0	0
3	37668319	.	A	G	3	3	6	0	1	7	0	0
3	37668370	.	T	C	6	3	9	0	0	9	0	0
3	37668667	.	C	A	6	3	9	0	0	9	0	0
3	37727784	.	T	C	5	3	8	0	0	8	0	0
3	37727926	.	C	G	3	4	7	0	1	8	0	0
3	37737680	.	C	A	2	9	11	0	0	11	0	0
3	37737735	.	T	G	6	0	6	0	3	9	0	0
3	37737736	.	C	T	6	3	9	0	0	9	0	0
3	37737852	.	A	G	5	7	12	0	2	14	0	0
3	37738024	.	A	G	8	9	17	0	1	18	0	0
3	37738050	.	C	G	6	7	13	0	1	14	0	0
3	37738089	.	G	A	9	8	17	0	1	18	0	0
3	37742116	.	A	C	6	5	11	0	3	14	0	0
3	37742152	.	T	C	6	8	14	0	1	15	0	0
3	37742245	.	C	T	6	4	10	0	0	10	0	0
3	37742247	.	A	G	6	4	10	0	0	10	0	0
3	37742284	.	T	G	2	8	10	0	0	10	0	0
3	37742338	.	C	G	3	7	10	0	1	11	0	0
3	37742363	.	C	T	4	5	9	0	0	9	0	0
3	37742468	.	T	C	3	2	5	0	1	6	0	0
3	37742469	.	A	C	2	3	5	0	1	6	0	0
3	37776713	.	T	C	5	7	12	0	0	12	0	0
3	37777309	.	A	T	7	6	13	0	1	14	0	0
3	37777417	.	G	C	5	6	11	0	0	11	0	0
3	37777590	.	C	T	7	5	12	0	1	13	0	0
3	37777811	.	C	T	1	9	10	0	10	20	0	0
3	37781162	.	A	G	3	7	10	0	0	10	0	0
3	37788401	.	T	C	33	30	63	1	2	66	0	0
3	37789216	.	G	T	6	7	13	0	0	13	0	0
3	37803375	.	A	G	1	0	1	0	2	3	0	0
3	37827822	.	C	T	3	4	7	0	0	7	0	0
3	37827948	.	C	T	2	3	5	0	0	5	0	0
3	38505629	.	A	G	5	12	17	0	1	18	0	0
3	38614366	.	C	T	10	8	18	0	0	18	0	0
3	38614426	.	A	G	8	0	8	0	7	15	0	0
3	38614562	.	C	T	13	10	23	0	3	26	0	0
3	38624737	.	A	G	12	0	12	0	8	20	0	0
3	38624823	.	G	A	17	10	27	0	0	27	0	0
3	38625098	.	A	C	16	9	25	0	1	26	0	0
3	38625497	.	G	T	6	7	13	0	0	13	0	0
3	38625559	.	T	C	10	10	20	0	0	20	0	0
3	38625605	.	G	A	17	10	27	0	1	28	0	0
3	38625751	.	A	C	13	7	20	0	3	23	0	0
3	38625901	.	T	G	14	4	18	0	0	18	0	0
3	38649991	.	A	T	7	11	18	0	1	19	0	0
3	38650348	.	T	C	3	20	23	0	0	23	0	0
3	38650440	.	T	C	6	5	11	0	1	12	0	0
3	38650462	.	T	C	5	7	12	0	3	15	0	0
3	38650477	.	T	C	12	6	18	0	0	18	0	0
3	38763153	.	T	A	12	10	22	0	4	26	0	0
3	38763174	.	G	A	5	6	11	1	15	27	0	0
3	38763391	.	A	G	8	9	17	0	0	17	0	0
3	38763449	.	C	T	3	5	8	0	1	9	0	0
3	38763505	.	G	A	6	6	12	0	0	12	0	0
3	38763527	.	C	T	2	3	5	0	9	14	0	0
3	38763564	.	C	A	4	4	8	0	1	9	0	0
3	38763700	.	G	A	10	5	15	0	0	15	0	0
3	38764227	.	C	T	5	3	8	0	1	9	0	0
3	38764229	.	G	A	5	4	9	0	0	9	0	0
3	38765149	.	A	T	5	3	8	0	0	8	0	0
3	38766207	.	C	T	0	2	2	0	9	11	0	0
3	38766395	.	G	A	3	3	6	0	0	6	0	0
3	38858649	.	A	G	5	2	7	0	0	7	0	0
3	38858673	.	C	A	2	2	4	0	2	6	0	0
3	38858908	.	G	A	0	3	3	0	4	7	0	0
3	38858949	.	G	C	5	5	10	0	1	11	0	0
3	38859126	.	A	T	2	4	6	0	0	6	0	0
3	39181560	.	A	C	7	3	10	0	0	10	0	0
3	39181635	.	C	T	7	8	15	0	0	15	0	0
3	39181823	.	A	G	5	3	8	0	1	9	0	0
3	39181849	.	A	G	6	7	13	0	0	13	0	0
3	39184156	.	A	G	2	5	7	0	0	7	0	0
3	39184180	.	C	T	4	5	9	0	0	9	0	0
3	39184710	.	A	G	7	5	12	0	0	12	0	0
3	39238579	.	C	A	6	9	15	0	0	15	0	0
3	39238580	.	C	A	7	9	16	0	0	16	0	0
3	39239380	.	A	G	12	18	30	0	0	30	0	0
3	39241350	.	G	T	12	18	30	0	2	32	0	0
3	39248863	.	A	G	6	8	14	0	0	14	0	0
3	39251020	.	G	T	5	6	11	0	0	11	0	0
3	39251341	.	T	C	5	3	8	0	1	9	0	0
3	39259624	.	T	C	3	0	3	0	3	6	0	0
3	39260767	.	A	T	1	5	6	0	1	7	0	0
3	39260818	.	A	G	3	4	7	0	0	7	0	0
3	39260934	.	G	A	1	5	6	0	0	6	0	0
3	39261182	.	C	A	0	5	5	0	5	10	0	0
3	39261230	.	C	T	6	3	9	0	0	9	0	0
3	39261270	.	C	T	0	2	2	0	5	7	0	0
3	39261672	.	G	A	0	3	3	0	1	4	0	0
3	39261709	.	T	C	1	0	1	0	2	3	0	0
3	39261718	.	C	T	1	2	3	0	0	3	0	0
3	39262338	.	C	G	4	2	6	0	0	6	0	0
3	39313310	.	A	G	9	8	17	0	3	20	0	0
3	39313625	.	T	C	7	5	12	0	1	13	0	0
3	39314028	.	C	T	11	15	26	0	0	26	0	0
3	39314101	.	T	C	12	14	26	0	2	28	0	0
3	39314146	.	C	G	10	10	20	0	0	20	0	0
3	39314260	.	A	G	3	9	12	0	1	13	0	0
3	39314502	.	G	C	9	12	21	0	0	21	0	0
3	39314677	.	C	T	10	3	13	0	0	13	0	0
3	39314857	.	G	T	1	2	3	0	1	4	0	0
3	39314893	.	C	A	4	3	7	0	0	7	0	0
3	39314899	.	C	T	5	3	8	0	0	8	0	0
3	39315154	.	C	A	4	9	13	0	0	13	0	0
3	39315169	.	C	G	4	8	12	0	2	14	0	0
3	39315191	.	C	G	2	7	9	0	2	11	0	0
3	39315292	.	A	G	2	3	5	0	0	5	0	0
3	39315341	.	G	A	4	2	6	0	0	6	0	0
3	39315342	.	A	G	4	2	6	0	0	6	0	0
3	39315816	.	A	G	1	5	6	0	1	7	0	0
3	39315874	.	C	A	3	10	13	0	0	13	0	0
3	39315876	.	C	T	3	10	13	0	0	13	0	0
3	39315937	.	A	C	1	0	1	0	4	5	0	0
3	39316037	.	T	C	5	3	8	0	0	8	0	0
3	39316062	.	G	A	8	4	12	0	1	13	0	0
3	39316167	.	A	G	5	4	9	0	1	10	0	0
3	39316570	.	G	A	1	7	8	0	0	8	0	0
3	39316846	.	T	C	2	4	6	0	2	8	0	0
3	39316906	.	C	A	6	5	11	0	1	12	0	0
3	39316912	.	G	A	6	7	13	0	0	13	0	0
3	39316996	.	A	G	10	10	20	0	1	21	0	0
3	39317215	.	C	G	2	2	4	0	0	4	0	0
3	39317370	.	C	T	4	3	7	0	0	7	0	0
3	39328095	.	G	C	4	3	7	0	1	8	0	0
3	39348533	.	G	A	1	3	4	0	0	4	0	0
3	39563187	.	T	C	1	2	3	0	0	3	0	0
3	39568368	.	T	G	13	14	27	0	0	27	0	0
3	39568856	.	A	G	15	14	29	0	2	31	0	0
3	39574883	.	C	A	29	32	61	0	8	69	0	0
3	39574961	.	G	A	33	28	61	0	4	65	0	0
3	39576621	.	T	G	38	1	39	0	37	76	0	0
3	39576663	.	A	G	32	47	79	0	2	81	0	0
3	39576866	.	T	C	27	18	45	0	1	46	0	0
3	39579660	.	G	T	1	2	3	0	0	3	0	0
3	39580908	.	T	C	4	2	6	0	0	6	0	0
3	39586473	.	A	T	2	5	7	0	0	7	0	0
3	39592640	.	T	G	9	5	14	0	0	14	0	0
3	39592797	.	C	T	6	13	19	0	1	20	0	0
3	39592800	.	G	C	1	10	11	0	9	20	0	0
3	39612261	.	T	A	13	17	30	0	0	30	0	0
3	39612430	.	T	C	11	14	25	0	1	26	0	0
3	39612579	.	G	C	14	11	25	0	1	26	0	0
3	39612715	.	A	T	13	7	20	0	1	21	0	0
3	39613024	.	T	C	10	12	22	0	3	25	0	0
3	39631505	.	T	C	8	5	13	0	0	13	0	0
3	39683715	.	A	G	1	2	3	0	0	3	0	0
3	39686776	.	T	A	1	2	3	0	0	3	0	0
3	39688558	.	T	G	6	6	12	0	0	12	0	0
3	39688892	.	T	C	8	2	10	0	0	10	0	0
3	39688906	.	C	T	8	3	11	0	1	12	0	0
3	39689234	.	G	T	10	4	14	0	0	14	0	0
3	39689277	.	A	G	3	6	9	0	0	9	0	0
3	39691539	.	T	G	1	2	3	0	1	4	0	0
3	39691676	.	A	G	3	4	7	0	1	8	0	0
3	39691795	.	C	T	1	2	3	0	0	3	0	0
3	39691978	.	C	G	3	4	7	0	0	7	0	0
3	39692008	.	G	T	3	6	9	0	0	9	0	0
3	39692165	.	A	T	4	7	11	0	0	11	0	0
3	39692196	.	C	T	0	8	8	0	7	15	0	0
3	39692206	.	C	T	6	6	12	0	3	15	0	0
3	39692235	.	C	A	6	13	19	0	0	19	0	0
3	39692265	.	G	A	8	5	13	0	1	14	0	0
3	39692307	.	A	G	11	7	18	0	1	19	0	0
3	39695744	.	T	C	4	4	8	0	0	8	0	0
3	39940210	.	T	C	3	1	4	0	2	6	0	0
3	39945696	.	A	G	7	5	12	0	0	12	0	0
3	39949389	.	G	A	3	5	8	0	2	10	0	0
3	39949650	.	G	A	0	6	6	0	11	17	0	0
3	39950276	.	A	C	8	11	19	0	6	25	0	0
3	39950340	.	C	T	13	6	19	0	1	20	0	0
3	39950414	.	T	C	9	11	20	0	0	20	0	0
3	39950954	.	T	C	13	6	19	0	1	20	0	0
3	39951124	.	C	T	5	8	13	0	0	13	0	0
3	39951216	.	T	C	9	6	15	0	0	15	0	0
3	39951703	.	A	T	5	4	9	0	6	15	0	0
3	39952025	.	T	C	8	7	15	0	1	16	0	0
3	39952272	.	A	G	15	8	23	0	0	23	0	0
3	39952273	.	A	T	14	8	22	0	1	23	0	0
3	39958680	.	C	T	3	5	8	0	1	9	0	0
3	39958729	.	T	A	6	6	12	0	0	12	0	0
3	39959679	.	A	C	8	3	11	0	2	13	0	0
3	39960535	.	G	C	0	5	5	0	6	11	0	0
3	39962981	.	T	C	10	14	24	0	0	24	0	0
3	39963053	.	T	C	7	10	17	0	2	19	0	0
3	39963089	.	A	G	5	5	10	0	1	11	0	0
3	39963128	.	G	A	1	5	6	0	1	7	0	0
3	39963131	.	A	G	2	5	7	0	0	7	0	0
3	39967177	.	C	T	3	2	5	0	0	5	0	0
3	39970555	.	G	A	12	8	20	0	0	20	0	0
3	39970641	.	T	G	10	8	18	0	0	18	0	0
3	39971335	.	T	A	3	2	5	0	2	7	0	0
3	39971470	.	T	C	7	7	14	0	0	14	0	0
3	39971499	.	T	C	8	6	14	0	0	14	0	0
3	39971592	.	T	C	4	8	12	0	0	12	0	0
3	39971615	.	T	C	12	6	18	0	0	18	0	0
3	39971894	.	T	C	9	6	15	0	0	15	0	0
3	39971943	.	T	C	5	2	7	0	0	7	0	0
3	39972157	.	T	C	5	3	8	0	0	8	0	0
3	39975467	.	T	C	3	0	3	0	6	9	0	0
3	39982019	.	C	T	8	3	11	0	0	11	0	0
3	39982185	.	T	C	4	0	4	0	1	5	0	0
3	39982198	.	A	T	4	4	8	0	0	8	0	0
3	39982423	.	T	C	2	0	2	0	2	4	0	0
3	40178663	.	G	T	12	3	15	0	2	17	0	0
3	40207086	.	T	C	16	15	31	0	2	33	0	0
3	40207302	.	T	C	1	9	10	0	0	10	0	0
3	40207304	.	T	C	3	0	3	0	7	10	0	0
3	40256334	.	T	C	2	3	5	0	0	5	0	0
3	40256734	.	G	A	2	3	5	0	0	5	0	0
3	40256735	.	C	A	2	3	5	0	0	5	0	0
3	40257357	.	A	G	3	0	3	0	2	5	0	0
3	40258465	.	T	C	6	3	9	0	0	9	0	0
3	40261235	.	T	A	2	3	5	0	0	5	0	0
3	40278023	.	C	T	3	15	18	0	16	34	0	0
3	40278180	.	T	C	18	1	19	0	10	29	0	0
3	40280034	.	T	C	11	10	21	0	2	23	0	0
3	40284375	.	T	C	15	0	15	0	11	26	0	0
3	40284860	.	G	T	14	8	22	0	2	24	0	0
3	40284982	.	T	C	14	17	31	0	1	32	0	0
3	40287185	.	G	C	3	13	16	0	10	26	0	0
3	40287188	.	G	A	14	13	27	0	0	27	0	0
3	40287227	.	C	T	13	16	29	0	0	29	0	0
3	40287538	.	C	T	1	2	3	0	1	4	0	0
3	40287691	.	T	C	3	7	10	0	0	10	0	0
3	40287712	.	T	A	3	5	8	0	2	10	0	0
3	40294179	.	G	A	9	15	24	0	0	24	0	0
3	40294260	.	A	T	7	6	13	0	3	16	0	0
3	40294511	.	G	C	10	7	17	0	0	17	0	0
3	40297428	.	G	A	30	34	64	0	5	69	0	0
3	40297479	.	C	T	40	29	69	0	0	69	0	0
3	40299995	.	G	A	34	37	71	0	3	74	0	0
3	40301233	.	A	G	9	7	16	0	0	16	0	0
3	40318733	.	T	A	1	2	3	0	0	3	0	0
3	40329683	.	T	C	5	3	8	0	0	8	0	0
3	40333577	.	A	G	2	0	2	0	6	8	0	0
3	40333592	.	C	T	4	7	11	0	0	11	0	0
3	40333700	.	A	G	5	0	5	0	3	8	0	0
3	40333793	.	T	C	1	4	5	0	1	6	0	0
3	40346035	.	C	T	13	10	23	0	0	23	0	0
3	40346059	.	T	C	12	15	27	0	0	27	0	0
3	40348839	.	T	C	15	20	35	0	3	38	0	0
3	40349310	.	A	G	10	12	22	0	0	22	0	0
3	40349354	.	T	G	6	5	11	0	0	11	0	0
3	40404688	.	A	T	7	3	10	0	0	10	0	0
3	40444539	.	T	C	1	2	3	0	0	3	0	0
3	40448097	.	A	C	2	2	4	0	0	4	0	0
3	40448130	.	A	G	1	0	1	0	3	4	0	0
3	40449603	.	T	C	5	3	8	0	0	8	0	0
3	40449696	.	C	T	5	3	8	0	0	8	0	0
3	40450743	.	C	T	11	3	14	0	0	14	0	0
3	40451268	.	C	T	7	4	11	0	0	11	0	0
3	40451319	.	T	C	5	3	8	0	0	8	0	0
3	40451352	.	A	T	3	2	5	0	0	5	0	0
3	40452119	.	G	C	2	1	3	0	1	4	0	0
3	40452134	.	A	G	3	0	3	0	2	5	0	0
3	40458531	.	C	A	6	3	9	0	1	10	0	0
3	40458594	.	G	A	2	3	5	0	9	14	0	0
3	40467464	.	C	T	4	3	7	0	1	8	0	0
3	40467486	.	G	A	1	4	5	0	6	11	0	0
3	40467693	.	A	G	5	0	5	0	4	9	0	0
3	40467756	.	C	T	8	3	11	0	1	12	0	0
3	40469891	.	T	C	4	5	9	0	2	11	0	0
3	40480877	.	G	A	2	5	7	0	8	15	0	0
3	40480986	.	G	T	11	12	23	0	1	24	0	0
3	40481346	.	G	A	0	10	10	0	8	18	0	0
3	40481459	.	C	T	11	8	19	0	0	19	0	0
3	40481513	.	A	G	8	5	13	0	0	13	0	0
3	40481649	.	T	G	8	5	13	0	0	13	0	0
3	40481930	.	T	A	5	13	18	0	1	19	0	0
3	40482007	.	T	C	5	15	20	0	1	21	0	0
3	40482027	.	A	G	5	0	5	0	17	22	0	0
3	40482289	.	C	A	17	8	25	0	1	26	0	0
3	40482446	.	A	G	9	11	20	0	4	24	0	0
3	40484376	.	A	T	13	6	19	0	1	20	0	0
3	40485360	.	C	A	14	10	24	0	0	24	0	0
3	40485378	.	T	G	13	10	23	0	2	25	0	0
3	40485422	.	G	T	0	15	15	0	16	31	0	0
3	40485499	.	G	A	12	14	26	0	0	26	0	0
3	40485965	.	G	C	7	5	12	0	4	16	0	0
3	40487095	.	G	T	14	11	25	0	1	26	0	0
3	40487162	.	A	C	14	6	20	1	1	22	0	0
3	40487385	.	T	A	14	13	27	0	2	29	0	0
3	40487704	.	T	C	25	11	36	0	5	41	0	0
3	40487820	.	A	G	13	20	33	0	4	37	0	0
3	40487821	.	G	C	16	18	34	0	3	37	0	0
3	40488212	.	C	T	13	27	40	0	1	41	0	0
3	40488264	.	C	T	4	27	31	0	13	44	0	0
3	40488630	.	T	C	3	9	12	0	1	13	0	0
3	40488640	.	T	C	2	9	11	0	0	11	0	0
3	40527028	.	G	A	35	43	78	0	3	81	0	0
3	40527512	.	G	A	33	34	67	1	2	70	0	0
3	40527575	.	G	A	49	43	92	2	14	108	0	0
3	40527665	.	A	G	9	9	18	0	2	20	0	0
3	40527727	.	G	A	9	9	18	0	0	19	1	0
3	40528241	.	A	T	37	30	67	0	9	76	0	0
3	40576600	.	C	T	12	8	20	0	3	23	0	0
3	40576736	.	C	T	11	11	22	0	1	23	0	0
3	40576972	.	A	G	12	0	12	0	17	29	0	0
3	40577032	.	C	T	12	13	25	0	1	26	0	0
3	40583989	.	C	G	20	14	34	0	5	39	0	0
3	40584318	.	T	A	16	24	40	0	1	41	0	0
3	40587967	.	C	T	30	31	61	0	2	63	0	0
3	40588109	.	A	T	28	33	61	0	1	62	0	0
3	40588195	.	T	C	23	27	50	0	1	51	0	0
3	40588363	.	C	T	27	23	50	0	1	51	0	0
3	40588410	.	C	A	23	24	47	0	2	49	0	0
3	40588467	.	T	C	27	16	43	0	3	46	0	0
3	40588595	.	A	C	18	27	45	0	2	47	0	0
3	40588746	.	C	G	13	22	35	0	3	38	0	0
3	40588845	.	A	G	22	22	44	0	1	45	0	0
3	40589147	.	T	C	35	26	61	0	2	63	0	0
3	40589179	.	C	A	37	25	62	0	3	65	0	0
3	40589191	.	T	G	41	24	65	0	0	65	0	0
3	40589214	.	C	A	35	26	61	0	1	62	0	0
3	40589232	.	A	G	34	21	55	0	0	55	0	0
3	40589266	.	C	T	24	21	45	0	4	49	0	0
3	40589348	.	A	G	15	18	33	0	0	33	0	0
3	40589356	.	A	G	14	18	32	0	2	34	0	0
3	40690704	.	T	C	9	1	10	0	9	19	0	0
3	40690901	.	G	A	3	4	7	0	1	8	0	0
3	40691448	.	A	G	5	4	9	0	1	10	0	0
3	40691473	.	A	T	4	6	10	0	1	11	0	0
3	40691643	.	A	T	5	6	11	0	0	11	0	0
3	40691969	.	C	T	11	13	24	0	0	24	0	0
3	40692064	.	A	T	9	4	13	0	0	13	0	0
3	40698424	.	C	A	5	2	7	0	1	8	0	0
3	40698481	.	A	G	7	3	10	0	0	10	0	0
3	40713085	.	G	T	6	2	8	0	1	9	0	0
3	40804286	.	T	G	39	6	45	1	8	54	0	0
3	40814521	.	T	C	1	3	4	0	0	4	0	0
3	40819959	.	A	C	3	2	5	0	1	6	0	0
3	40820007	.	A	G	2	3	5	0	0	5	0	0
3	40820318	.	A	T	3	3	6	0	0	6	0	0
3	40820325	.	T	C	3	2	5	0	0	5	0	0
3	40821838	.	C	A	11	8	19	1	1	21	0	0
3	40821871	.	A	T	18	9	27	0	1	28	0	0
3	40821953	.	C	A	1	11	12	0	13	25	0	0
3	40828768	.	T	C	9	0	9	0	9	18	0	0
3	40876757	.	G	A	9	5	14	0	0	14	0	0
3	40882964	.	A	T	2	2	4	0	0	4	0	0
3	40883137	.	C	T	1	2	3	0	0	3	0	0
3	40902163	.	C	T	2	11	13	0	7	20	0	0
3	40907953	.	T	C	5	0	5	0	4	9	0	0
3	40913730	.	G	A	4	4	8	0	2	10	0	0
3	40927653	.	C	T	5	4	9	0	1	10	0	0
3	40979281	.	T	C	9	4	13	0	0	13	0	0
3	40980024	.	G	A	11	4	15	0	1	16	0	0
3	40980166	.	T	A	15	9	24	0	0	24	0	0
3	40983062	.	A	G	12	6	18	0	1	19	0	0
3	40983077	.	G	A	12	6	18	0	0	18	0	0
3	40985992	.	T	C	4	2	6	0	0	6	0	0
3	40997589	.	T	A	0	2	2	0	1	3	0	0
3	41003413	.	G	A	2	2	4	0	1	5	0	0
3	41023331	.	G	A	2	2	4	0	0	4	0	0
3	41037795	.	A	C	2	0	2	0	3	5	0	0
3	41084442	.	G	C	2	0	2	0	2	4	0	0
3	41092137	.	A	T	2	2	4	0	0	4	0	0
3	41103034	.	T	C	1	0	1	0	2	3	0	0
3	41705031	.	G	A	1	1	2	0	1	3	0	0
3	41705428	.	C	T	5	3	8	0	0	8	0	0
3	41705468	.	A	T	5	2	7	0	0	7	0	0
3	41705476	.	C	T	4	2	6	0	1	7	0	0
3	41705560	.	A	G	3	2	5	0	0	5	0	0
3	41705597	.	C	T	6	3	9	0	0	9	0	0
3	41719049	.	G	A	13	4	17	0	4	21	0	0
3	41721916	.	G	A	12	12	24	0	3	27	0	0
3	41723437	.	G	A	12	17	29	0	3	32	0	0
3	41724806	.	G	A	17	14	31	0	1	32	0	0
3	41917747	.	T	C	2	2	4	0	0	4	0	0
3	41917830	.	T	C	2	1	3	0	1	4	0	0
3	41922587	.	C	T	1	2	3	0	1	4	0	0
3	41922766	.	A	G	7	0	7	0	4	11	0	0
3	41922799	.	C	T	5	2	7	0	0	7	0	0
3	41923195	.	T	C	4	3	7	0	0	7	0	0
3	41923288	.	C	T	3	2	5	0	0	5	0	0
3	41925154	.	C	T	4	3	7	0	2	9	0	0
3	41925508	.	A	G	1	7	8	0	0	8	0	0
3	41925541	.	C	G	5	6	11	0	0	11	0	0
3	41925823	.	C	T	2	3	5	0	1	6	0	0
3	41925889	.	T	C	4	4	8	0	0	8	0	0
3	41926020	.	T	A	3	6	9	0	0	9	0	0
3	41926557	.	G	A	8	3	11	0	0	11	0	0
3	41926633	.	T	A	5	3	8	0	1	9	0	0
3	41955449	.	A	G	7	5	12	0	0	12	0	0
3	41955526	.	C	T	5	6	11	0	1	12	0	0
3	41955613	.	G	T	21	11	32	0	0	32	0	0
3	41955911	.	C	G	16	18	34	0	1	35	0	0
3	41956040	.	G	T	12	11	23	0	3	26	0	0
3	41956299	.	T	C	13	15	28	0	0	28	0	0
3	41956353	.	T	A	12	15	27	0	0	27	0	0
3	41956467	.	T	A	6	3	9	0	0	9	0	0
3	41956792	.	A	T	12	15	27	0	2	29	0	0
3	41956818	.	T	C	8	15	23	0	0	23	0	0
3	41956837	.	T	G	8	14	22	0	0	22	0	0
3	41956855	.	C	T	9	15	24	0	0	24	0	0
3	41956921	.	T	A	4	9	13	0	0	13	0	0
3	41956941	.	T	C	7	11	18	0	0	18	0	0
3	41956978	.	G	A	6	14	20	0	0	20	0	0
3	41957457	.	T	A	4	2	6	0	2	8	0	0
3	41957580	.	G	T	6	6	12	0	1	13	0	0
3	41958291	.	T	G	3	8	11	0	0	11	0	0
3	41958468	.	T	G	1	2	3	0	0	3	0	0
3	41959370	.	G	T	8	10	18	0	2	20	0	0
3	41959658	.	G	T	9	7	16	0	0	16	0	0
3	41959772	.	A	G	4	8	12	0	0	12	0	0
3	41959906	.	T	A	2	6	8	0	1	9	0	0
3	41959943	.	T	C	3	5	8	0	1	9	0	0
3	41959958	.	A	G	3	5	8	0	0	8	0	0
3	41960005	.	C	A	3	4	7	0	0	7	0	0
3	41960069	.	G	T	3	4	7	0	1	8	0	0
3	41961314	.	G	A	2	5	7	0	0	7	0	0
3	41961341	.	T	G	1	3	4	0	3	9	2	0
3	41961469	.	A	G	3	5	8	0	0	8	0	0
3	41961558	.	A	T	6	6	12	0	0	12	0	0
3	41961587	.	T	G	7	6	13	0	0	13	0	0
3	41961651	.	G	A	2	3	5	0	0	5	0	0
3	41961688	.	T	C	4	0	4	0	7	11	0	0
3	41961993	.	C	G	0	3	3	0	3	6	0	0
3	41962098	.	T	C	7	3	10	0	0	10	0	0
3	41985953	.	C	T	1	3	4	0	0	4	0	0
3	41985959	.	G	A	0	3	3	0	0	3	0	0
3	42121428	.	A	G	1	2	3	0	0	3	0	0
3	42121757	.	A	C	3	4	7	0	0	7	0	0
3	42918924	.	C	A	7	7	14	0	0	14	0	0
3	42919474	.	C	T	10	8	18	0	2	20	0	0
3	42919510	.	C	T	6	5	11	0	7	18	0	0
3	42919664	.	C	T	8	6	14	0	0	14	0	0
3	42919846	.	T	G	6	4	10	0	0	10	0	0
3	42919849	.	C	T	5	4	9	0	0	9	0	0
3	42919881	.	C	T	4	5	9	0	0	9	0	0
3	42919895	.	A	G	3	5	8	0	0	8	0	0
3	42919943	.	G	C	6	6	12	0	0	12	0	0
3	42919959	.	A	T	5	5	10	0	0	10	0	0
3	43018005	.	C	T	1	2	3	0	0	3	0	0
3	43021384	.	C	T	2	2	4	0	0	4	0	0
3	43036193	.	T	C	1	4	5	0	0	5	0	0
3	43039306	.	A	G	1	5	6	0	0	6	0	0
3	43040677	.	G	A	0	10	10	0	6	16	0	0
3	43052230	.	T	C	2	8	10	0	0	10	0	0
3	43059090	.	A	G	5	17	22	0	2	24	0	0
3	43059153	.	A	G	7	12	19	0	1	20	0	0
3	43060866	.	T	C	5	5	10	0	0	10	0	0
3	43376543	.	A	G	3	10	13	0	0	13	0	0
3	43380283	.	C	T	4	7	11	0	1	12	0	0
3	43392755	.	T	A	13	13	26	1	1	28	0	0
3	43392795	.	C	A	13	3	16	0	1	17	0	0
3	43467654	.	T	C	1	3	4	0	0	4	0	0
3	43475265	.	G	A	4	5	9	0	0	9	0	0
3	43475325	.	A	G	8	5	13	0	1	14	0	0
3	43475397	.	C	T	5	2	7	0	0	7	0	0
3	43475592	.	A	C	6	7	13	0	2	15	0	0
3	43475617	.	G	T	0	3	3	0	5	8	0	0
3	43475742	.	G	T	4	7	11	0	0	11	0	0
3	43475772	.	A	G	5	6	11	0	0	11	0	0
3	43476088	.	G	T	4	3	7	0	1	8	0	0
3	43476097	.	C	A	5	3	8	0	0	8	0	0
3	43476394	.	T	C	3	2	5	0	0	5	0	0
3	43476402	.	C	T	4	2	6	0	0	6	0	0
3	43476514	.	A	C	5	4	9	0	3	12	0	0
3	43476698	.	A	G	5	2	7	0	2	9	0	0
3	43476880	.	C	T	4	7	11	0	0	11	0	0
3	43476887	.	T	G	4	7	11	0	0	11	0	0
3	43477975	.	T	G	4	2	6	0	1	7	0	0
3	43478137	.	T	C	9	6	15	0	0	15	0	0
3	43478238	.	C	T	9	4	13	0	1	14	0	0
3	43478310	.	T	G	9	9	18	0	1	19	0	0
3	43478321	.	A	G	9	0	9	0	10	19	0	0
3	43478586	.	C	T	4	3	7	0	0	7	0	0
3	43579820	.	C	T	2	16	18	0	12	30	0	0
3	43580055	.	A	G	13	11	24	0	0	24	0	0
3	43580195	.	A	T	13	8	21	0	0	21	0	0
3	43580583	.	T	C	13	13	26	0	0	26	0	0
3	43581272	.	A	C	12	8	20	0	0	20	0	0
3	43584423	.	T	C	12	1	13	0	13	26	0	0
3	43584453	.	T	C	17	12	29	0	1	30	0	0
3	43594256	.	A	G	15	12	27	0	3	30	0	0
3	43594358	.	C	T	9	3	12	0	2	14	0	0
3	43594376	.	C	T	1	6	7	0	9	16	0	0
3	43594577	.	G	A	15	6	21	0	0	21	0	0
3	43594655	.	C	T	1	6	7	0	5	12	0	0
3	43594658	.	G	A	5	5	10	0	1	11	0	0
3	43594735	.	T	C	7	8	15	0	2	17	0	0
3	43600999	.	C	T	1	5	6	0	5	11	0	0
3	43645900	.	G	C	10	3	13	0	2	15	0	0
3	43646362	.	C	T	1	7	8	0	6	14	0	0
3	43711455	.	A	T	1	2	3	0	0	3	0	0
3	43754860	.	T	A	1	2	3	0	0	3	0	0
3	43785646	.	A	T	2	1	3	0	1	4	0	0
3	43791284	.	T	C	2	6	8	0	0	8	0	0
3	43791317	.	G	A	4	4	8	0	0	8	0	0
3	43797073	.	C	T	6	3	9	0	0	9	0	0
3	43801338	.	C	T	10	13	23	0	2	25	0	0
3	43807512	.	T	C	8	8	16	0	1	17	0	0
3	43807921	.	C	A	7	8	15	0	1	16	0	0
3	43807945	.	T	A	9	6	15	0	1	18	2	0
3	43814607	.	C	T	4	2	6	0	0	6	0	0
3	43828617	.	G	T	2	3	5	0	0	5	0	0
3	43828865	.	C	A	2	2	4	0	1	5	0	0
3	43828902	.	G	A	1	4	5	0	1	6	0	0
3	43829154	.	G	C	3	5	8	0	0	8	0	0
3	43829179	.	G	C	2	4	6	0	1	7	0	0
3	43829370	.	A	C	6	7	13	0	1	14	0	0
3	43829411	.	C	T	5	5	10	0	0	10	0	0
3	43829413	.	C	T	5	5	10	0	0	10	0	0
3	43829712	.	G	A	0	4	4	0	3	7	0	0
3	43942053	.	A	C	2	4	6	0	1	7	0	0
3	43944611	.	A	G	6	5	11	0	1	12	0	0
3	43953805	.	C	T	5	2	7	0	1	8	0	0
3	43953883	.	T	C	5	0	5	0	8	13	0	0
3	43985795	.	T	A	1	2	3	0	1	4	0	0
3	43986937	.	G	A	0	5	5	0	3	8	0	0
3	43986982	.	G	A	3	3	6	0	1	7	0	0
3	44077429	.	A	C	4	3	7	0	0	7	0	0
3	44077508	.	C	T	4	2	6	0	0	6	0	0
3	44077543	.	G	T	4	2	6	0	0	6	0	0
3	44081793	.	G	A	0	3	3	0	1	4	0	0
3	44082200	.	A	G	2	3	5	0	0	5	0	0
3	44082427	.	A	G	1	8	9	0	0	9	0	0
3	44082439	.	A	G	1	9	10	0	0	10	0	0
3	44093896	.	T	G	1	2	3	0	0	3	0	0
3	44541766	.	C	T	0	4	4	0	1	5	0	0
3	44541955	.	C	A	7	2	9	0	0	9	0	0
3	45284631	.	T	C	12	2	14	1	3	18	0	0
3	45715655	.	A	G	1	6	7	0	0	7	0	0
3	45715716	.	C	T	4	5	9	0	0	9	0	0
3	45716082	.	T	C	1	7	8	0	1	9	0	0
3	45716098	.	C	T	1	5	6	0	0	6	0	0
3	45716156	.	A	T	2	4	6	0	0	6	0	0
3	45716562	.	A	G	4	5	9	0	0	9	0	0
3	45716705	.	A	G	6	4	10	0	1	11	0	0
3	45716766	.	A	G	4	2	6	0	5	11	0	0
3	45717180	.	C	T	9	11	20	0	5	25	0	0
3	45776520	.	T	C	19	1	20	0	29	49	0	0
3	45776721	.	T	C	26	36	62	0	3	65	0	0
3	45778103	.	T	A	7	4	11	0	1	12	0	0
3	45790559	.	T	C	1	5	6	0	1	7	0	0
3	45814631	.	A	T	5	4	9	0	0	9	0	0
3	45815894	.	A	C	5	6	11	0	0	11	0	0
3	45815997	.	G	A	0	3	3	0	7	10	0	0
3	45816004	.	C	T	7	2	9	0	0	9	0	0
3	45816549	.	A	G	4	10	14	0	0	14	0	0
3	45816618	.	T	C	6	12	18	0	1	19	0	0
3	45817571	.	G	T	5	7	12	0	3	15	0	0
3	45817572	.	T	G	6	5	11	0	4	15	0	0
3	46044190	.	G	T	1	2	3	0	0	3	0	0
3	46358537	.	A	G	3	0	3	0	4	7	0	0
3	46362514	.	C	T	2	3	5	0	0	5	0	0
3	46362640	.	C	T	3	3	6	0	0	6	0	0
3	46362830	.	G	A	0	2	2	0	3	5	0	0
3	46364162	.	T	A	1	2	3	0	0	3	0	0
3	46364583	.	T	C	0	4	4	0	2	6	0	0
3	46379820	.	A	G	6	3	9	0	0	9	0	0
3	46379849	.	C	G	4	2	6	0	0	6	0	0
3	46380144	.	A	C	2	3	5	0	0	5	0	0
3	46380189	.	A	G	7	6	13	0	3	16	0	0
3	46380194	.	T	A	8	9	17	0	0	17	0	0
3	46388058	.	C	T	5	11	16	1	0	17	0	0
3	46388285	.	G	A	5	4	9	0	0	9	0	0
3	46388439	.	A	T	5	4	9	0	0	9	0	0
3	46388487	.	A	C	8	4	12	0	0	12	0	0
3	46388490	.	T	A	6	3	9	0	2	11	0	0
3	46388636	.	T	C	2	5	7	0	0	7	0	0
3	46388711	.	C	T	2	4	6	0	3	9	0	0
3	46388714	.	G	A	5	3	8	0	1	9	0	0
3	46388854	.	T	C	10	4	14	0	0	14	0	0
3	46388905	.	G	A	5	8	13	0	1	14	0	0
3	46388954	.	A	C	8	3	11	0	0	11	0	0
3	46388968	.	G	C	6	7	13	0	0	13	0	0
3	46389009	.	C	T	5	6	11	0	1	12	0	0
3	46398380	.	G	A	1	4	5	0	1	6	0	0
3	46403743	.	C	T	0	4	4	0	3	7	0	0
3	46410288	.	T	C	3	4	7	0	0	7	0	0
3	46463156	.	C	T	11	5	16	0	0	16	0	0
3	46463213	.	A	C	7	5	12	1	0	13	0	0
3	46463240	.	C	T	6	9	15	1	0	16	0	0
3	46473247	.	G	C	0	13	13	0	9	22	0	0
3	46473292	.	G	A	9	13	22	0	0	22	0	0
3	46550242	.	T	C	2	3	5	0	0	5	0	0
3	46552712	.	G	C	2	8	10	0	0	10	0	0
3	46552832	.	A	C	2	4	6	0	0	6	0	0
3	46553206	.	T	G	2	6	8	0	0	8	0	0
3	46553470	.	A	G	2	0	2	0	4	6	0	0
3	46553480	.	C	A	1	6	7	0	0	7	0	0
3	46553534	.	C	T	3	7	10	0	0	10	0	0
3	46553540	.	C	A	3	4	7	0	2	9	0	0
3	46553720	.	C	A	5	3	8	0	0	8	0	0
3	46553850	.	A	C	11	6	17	1	2	20	0	0
3	46553893	.	T	C	17	2	19	0	2	21	0	0
3	46553986	.	A	T	9	8	17	0	0	17	0	0
3	46554085	.	G	T	3	8	11	0	0	11	0	0
3	46554177	.	C	A	8	8	16	0	2	18	0	0
3	46554181	.	C	A	9	8	17	0	0	17	0	0
3	46554259	.	G	A	6	5	11	0	0	11	0	0
3	46554348	.	G	A	4	4	8	0	0	8	0	0
3	46554360	.	C	G	3	5	8	0	0	9	1	0
3	46554458	.	G	T	6	8	14	0	1	15	0	0
3	46554564	.	A	G	12	5	17	0	1	18	0	0
3	46554648	.	T	A	10	5	15	3	0	18	0	0
3	46554711	.	G	A	9	11	20	0	0	20	0	0
3	46749479	.	A	G	10	6	16	0	0	16	0	0
3	46750272	.	C	T	11	7	18	0	0	18	0	0
3	46750752	.	G	A	6	11	17	0	0	17	0	0
3	46750996	.	C	T	9	5	14	0	0	14	0	0
3	46751630	.	G	A	6	5	11	0	0	11	0	0
3	46752486	.	A	C	9	8	17	0	0	17	0	0
3	46752522	.	T	G	4	7	11	0	0	11	0	0
3	46752558	.	C	T	4	3	7	0	4	11	0	0
3	46753340	.	T	G	9	0	9	0	0	9	0	0
3	46753613	.	T	C	9	4	13	0	1	14	0	0
3	46753619	.	G	A	6	5	11	0	2	13	0	0
3	46753742	.	A	G	19	2	21	0	16	37	0	0
3	46754078	.	T	A	24	19	43	0	1	44	0	0
3	46754296	.	A	T	8	7	15	0	0	15	0	0
3	46764485	.	A	T	1	6	7	0	0	7	0	0
3	46764572	.	A	T	5	1	6	0	1	7	0	0
3	46767646	.	T	C	3	7	10	0	0	10	0	0
3	46778789	.	G	T	16	10	26	0	4	30	0	0
3	46793802	.	T	C	1	2	3	0	0	3	0	0
3	46800490	.	A	T	42	23	65	0	5	70	0	0
3	46800692	.	G	A	28	25	53	0	3	56	0	0
3	46800940	.	C	T	34	27	61	0	2	63	0	0
3	46800946	.	T	G	30	29	59	0	2	61	0	0
3	46802227	.	T	C	31	1	32	0	16	48	0	0
3	46919523	.	C	T	2	3	5	0	0	5	0	0
3	46923471	.	T	C	1	4	5	0	0	5	0	0
3	46923509	.	G	A	4	3	7	0	1	8	0	0
3	46925154	.	G	A	3	3	6	0	0	6	0	0
3	46925227	.	A	G	1	2	3	0	0	3	0	0
3	46942272	.	A	G	1	3	4	0	0	4	0	0
3	47114558	.	G	A	4	3	7	0	0	7	0	0
3	47114573	.	A	G	4	4	8	0	0	8	0	0
3	47119662	.	T	A	7	2	9	0	0	9	0	0
3	47119964	.	C	T	0	3	3	0	4	7	0	0
3	47125636	.	T	A	2	7	9	0	0	9	0	0
3	47125693	.	G	A	4	4	8	0	0	8	0	0
3	47125771	.	T	C	3	3	6	0	0	6	0	0
3	47198805	.	G	A	4	3	7	0	0	7	0	0
3	47201409	.	C	T	2	4	6	0	0	6	0	0
3	47201440	.	A	G	2	5	7	0	0	7	0	0
3	47201479	.	T	C	4	5	9	0	0	9	0	0
3	47201482	.	T	C	5	5	10	0	0	10	0	0
3	47201518	.	C	T	4	6	10	0	0	10	0	0
3	47205408	.	C	T	6	3	9	0	0	9	0	0
3	47205417	.	A	G	3	0	3	0	7	10	0	0
3	47205507	.	G	A	5	6	11	0	0	11	0	0
3	47205534	.	A	G	2	0	2	0	11	13	0	0
3	47205543	.	C	T	10	4	14	0	0	14	0	0
3	47205585	.	A	T	6	10	16	0	0	16	0	0
3	47205597	.	C	T	11	7	18	0	0	18	0	0
3	47209433	.	T	C	5	5	10	0	1	11	0	0
3	47209445	.	A	T	3	7	10	0	1	11	0	0
3	47212662	.	A	G	3	2	5	0	0	5	0	0
3	47212826	.	A	G	3	5	8	0	0	8	0	0
3	47212896	.	A	T	3	2	5	0	0	5	0	0
3	47212914	.	T	C	3	3	6	0	0	6	0	0
3	47213067	.	C	G	6	3	9	0	0	9	0	0
3	47384653	.	T	C	6	6	12	0	0	12	0	0
3	47498493	.	C	T	0	4	4	0	1	5	0	0
3	47498625	.	C	A	6	2	8	0	0	8	0	0
3	47498633	.	G	A	4	1	5	0	2	7	0	0
3	47529406	.	G	A	1	2	3	0	0	3	0	0
3	48229423	.	C	T	2	3	5	0	0	5	0	0
3	48253673	.	C	T	1	2	3	0	0	3	0	0
3	48261791	.	G	C	1	4	5	0	0	5	0	0
3	48261794	.	C	A	1	4	5	0	0	5	0	0
3	48301180	.	A	G	1	4	5	0	0	5	0	0
3	48305837	.	C	G	3	2	5	0	0	5	0	0
3	48305841	.	G	A	0	3	3	0	2	5	0	0
3	48305898	.	C	G	2	4	6	0	0	6	0	0
3	48305908	.	C	A	2	2	4	0	1	5	0	0
3	48320968	.	A	G	4	5	9	0	0	9	0	0
3	48326568	.	G	A	2	4	6	0	0	6	0	0
3	48326631	.	C	T	6	3	9	0	0	9	0	0
3	48326725	.	A	C	5	6	11	0	0	11	0	0
3	48327002	.	G	A	13	7	20	0	0	20	0	0
3	48473565	.	A	G	1	2	3	0	0	3	0	0
3	48480156	.	T	G	5	8	13	0	1	14	0	0
3	48486609	.	C	T	7	7	14	0	0	14	0	0
3	48488909	.	G	T	8	5	13	0	0	13	0	0
3	48488993	.	T	C	2	4	6	0	3	9	0	0
3	48489101	.	C	G	3	1	4	0	7	11	0	0
3	48489154	.	A	G	7	1	8	1	3	12	0	0
3	48550676	.	G	A	17	20	37	0	3	40	0	0
3	48557707	.	T	C	26	1	27	0	26	53	0	0
3	48584800	.	A	T	8	7	15	0	1	16	0	0
3	48585222	.	C	T	3	20	23	0	12	35	0	0
3	48585236	.	C	A	22	10	32	0	2	34	0	0
3	48585271	.	A	C	19	14	33	0	3	36	0	0
3	48585331	.	A	G	24	8	32	0	4	36	0	0
3	48585377	.	G	T	14	18	32	0	3	35	0	0
3	48585411	.	G	T	11	18	29	0	2	31	0	0
3	48586985	.	A	G	14	8	22	0	1	23	0	0
3	48587176	.	C	A	11	8	19	0	2	21	0	0
3	48587191	.	C	T	19	6	25	0	0	25	0	0
3	48588830	.	A	G	10	10	20	0	1	21	0	0
3	48588884	.	A	G	13	5	18	0	0	18	0	0
3	48591769	.	A	G	7	3	10	0	2	12	0	0
3	48593781	.	T	C	10	12	22	0	0	22	0	0
3	48593811	.	G	A	16	7	23	1	0	24	0	0
3	48594098	.	T	C	7	1	8	0	7	15	0	0
3	48596834	.	T	C	2	5	7	0	0	7	0	0
3	48612027	.	T	C	2	0	2	0	9	11	0	0
3	48612038	.	A	G	4	5	9	0	1	10	0	0
3	48645801	.	G	T	2	4	6	0	0	6	0	0
3	48661500	.	A	G	5	3	8	0	0	8	0	0
3	48691411	.	A	G	3	2	5	0	0	5	0	0
3	49154124	.	C	A	5	2	7	0	0	7	0	0
3	49426063	.	G	A	7	6	13	0	3	16	0	0
3	49426184	.	G	A	9	11	20	0	1	21	0	0
3	49439450	.	G	T	12	6	18	2	0	20	0	0
3	49439587	.	A	G	12	13	25	2	0	27	0	0
3	49447514	.	C	A	0	7	7	0	9	16	0	0
3	49478380	.	T	C	2	4	6	0	0	6	0	0
3	49503880	.	A	G	11	3	14	0	0	14	0	0
3	49505527	.	C	T	1	3	4	0	0	4	0	0
3	49559444	.	C	T	29	40	69	0	2	71	0	0
3	49559523	.	C	T	42	32	74	1	4	79	0	0
3	49559527	.	G	T	43	31	74	1	3	78	0	0
3	49559637	.	G	T	39	35	74	0	4	78	0	0
3	49559703	.	G	A	40	33	73	0	4	77	0	0
3	49559904	.	G	A	30	40	70	0	1	71	0	0
3	49559979	.	A	G	22	42	64	0	4	68	0	0
3	49559988	.	T	A	20	41	61	0	5	66	0	0
3	49560084	.	A	G	26	33	59	0	1	60	0	0
3	49560204	.	G	C	28	29	57	0	3	60	0	0
3	49560276	.	T	G	42	22	64	0	1	65	0	0
3	49560420	.	C	T	22	28	50	0	1	51	0	0
3	49560507	.	G	A	23	25	48	0	0	48	0	0
3	49758520	.	T	C	1	2	3	0	0	3	0	0
3	49758568	.	C	T	1	2	3	0	0	3	0	0
3	49758583	.	T	C	1	3	4	0	0	4	0	0
3	49758790	.	C	A	2	2	4	0	0	4	0	0
3	49758799	.	A	G	2	3	5	0	0	5	0	0
3	49760049	.	T	C	1	2	3	0	1	4	0	0
3	49766995	.	C	T	1	2	3	0	0	3	0	0
3	50054578	.	C	G	9	9	18	0	1	19	0	0
3	50054619	.	A	T	12	11	23	0	0	23	0	0
3	50054766	.	G	A	11	11	22	1	3	26	0	0
3	50059143	.	A	T	15	17	32	0	4	36	0	0
3	50063458	.	C	T	12	8	20	0	1	21	0	0
3	50063491	.	C	T	0	16	16	0	9	25	0	0
3	50066373	.	A	G	14	16	30	0	3	33	0	0
3	50066402	.	G	A	11	16	27	0	3	30	0	0
3	50077077	.	G	A	4	9	13	0	1	14	0	0
3	50077311	.	A	G	22	14	36	0	2	38	0	0
3	50077364	.	T	A	18	8	26	3	2	31	0	0
3	50077371	.	G	A	9	17	26	6	0	32	0	0
3	50077428	.	G	C	12	20	32	3	1	36	0	0
3	50081696	.	G	A	19	8	27	0	0	27	0	0
3	50083980	.	C	A	20	15	35	0	0	36	1	0
3	50084011	.	A	G	14	17	31	0	3	34	0	0
3	50087361	.	C	A	1	16	17	0	9	26	0	0
3	50087370	.	G	A	9	15	24	0	0	24	0	0
3	50087433	.	C	A	1	6	7	0	13	20	0	0
3	50089377	.	A	G	13	5	18	0	1	19	0	0
3	50089391	.	G	A	13	6	19	0	0	19	0	0
3	50089470	.	T	C	8	7	15	0	1	16	0	0
3	50091985	.	A	G	3	7	10	0	1	11	0	0
3	50092630	.	T	G	10	8	18	0	0	18	0	0
3	50092633	.	A	G	10	6	16	0	0	16	0	0
3	50095869	.	A	T	5	3	8	0	1	9	0	0
3	50095929	.	C	T	1	4	5	0	2	7	0	0
3	50110202	.	T	C	4	0	4	0	4	8	0	0
3	50110205	.	C	A	4	3	7	0	1	8	0	0
3	50110369	.	T	C	3	3	6	0	0	6	0	0
3	50110399	.	A	G	2	5	7	0	0	7	0	0
3	50123650	.	C	A	1	13	14	0	19	33	0	0
3	50123709	.	A	G	21	16	37	0	2	39	0	0
3	50123758	.	A	G	22	19	41	0	4	45	0	0
3	50123760	.	C	A	18	23	41	0	3	44	0	0
3	50124107	.	A	G	7	5	12	0	2	14	0	0
3	50124108	.	C	G	7	6	13	0	1	14	0	0
3	50159356	.	C	G	4	1	5	0	2	7	0	0
3	50159431	.	C	T	3	4	7	0	0	7	0	0
3	50166550	.	T	C	9	9	18	0	0	18	0	0
3	50170236	.	A	G	9	1	10	0	8	18	0	0
3	50170338	.	T	A	3	10	13	0	1	14	0	0
3	50170354	.	C	T	5	11	16	0	2	18	0	0
3	50171713	.	A	G	4	12	16	0	1	17	0	0
3	50172725	.	G	C	6	7	13	0	0	13	0	0
3	50172735	.	T	A	8	5	13	0	1	14	0	0
3	50172788	.	C	T	4	2	6	0	0	6	0	0
3	50176620	.	G	T	8	11	19	0	1	20	0	0
3	50256938	.	A	C	7	6	13	0	0	13	0	0
3	50265852	.	C	T	5	4	9	1	0	10	0	0
3	50265903	.	A	C	5	6	11	0	1	12	0	0
3	50265906	.	T	C	6	7	13	0	1	14	0	0
3	50265994	.	C	T	3	4	7	0	0	7	0	0
3	50266043	.	C	A	3	5	8	0	0	8	0	0
3	50266063	.	A	G	1	5	6	0	0	6	0	0
3	50266198	.	T	C	1	4	5	0	0	5	0	0
3	50266330	.	T	A	5	4	9	0	0	9	0	0
3	50266384	.	A	G	3	2	5	0	0	5	0	0
3	50266394	.	T	A	2	2	4	0	0	4	0	0
3	50266913	.	T	C	5	4	9	0	0	9	0	0
3	50266945	.	A	G	2	4	6	0	0	6	0	0
3	50267171	.	T	G	2	6	8	0	1	9	0	0
3	50267256	.	T	A	1	2	3	0	0	3	0	0
3	50267471	.	A	T	1	3	4	0	0	4	0	0
3	50267686	.	T	C	7	9	16	1	0	17	0	0
3	50267860	.	A	T	8	6	14	0	0	14	0	0
3	50267981	.	G	C	2	8	10	0	1	11	0	0
3	50267992	.	T	A	5	9	14	0	0	14	0	0
3	50268016	.	T	C	6	7	13	0	0	13	0	0
3	50268052	.	A	T	10	8	18	0	0	18	0	0
3	50268073	.	A	G	8	12	20	0	0	20	0	0
3	50268106	.	G	T	7	10	17	0	4	21	0	0
3	50268146	.	T	A	7	7	14	0	0	14	0	0
3	50268220	.	C	T	7	8	15	0	1	16	0	0
3	50268535	.	A	C	9	9	18	0	4	22	0	0
3	50268715	.	C	T	10	13	23	0	4	27	0	0
3	50268744	.	G	A	8	17	25	0	1	26	0	0
3	50269138	.	A	C	1	2	3	0	0	3	0	0
3	50272168	.	C	T	1	3	4	0	2	6	0	0
3	50272273	.	G	A	5	2	7	0	0	7	0	0
3	50273026	.	G	A	4	8	12	0	1	13	0	0
3	50273031	.	C	T	4	9	13	0	1	14	0	0
3	50273469	.	C	T	1	2	3	0	6	9	0	0
3	50276336	.	A	T	3	6	9	0	0	9	0	0
3	50418826	.	G	C	9	18	27	0	3	30	0	0
3	50419046	.	C	T	6	8	14	0	0	14	0	0
3	50419155	.	C	T	10	6	16	0	0	16	0	0
3	50419626	.	A	T	2	2	4	0	0	4	0	0
3	50419658	.	T	A	3	4	7	0	0	7	0	0
3	50419686	.	A	T	5	3	8	0	0	8	0	0
3	50419722	.	G	C	7	2	9	0	0	9	0	0
3	50419723	.	C	A	6	2	8	0	1	9	0	0
3	50419759	.	C	T	5	3	8	0	1	9	0	0
3	50419791	.	T	C	9	3	12	0	1	13	0	0
3	50419803	.	C	A	5	9	14	0	1	15	0	0
3	50419827	.	T	C	5	11	16	0	1	17	0	0
3	50419866	.	T	A	5	4	9	0	1	13	3	0
3	50419867	.	A	C	6	7	13	0	1	14	0	0
3	50420001	.	A	C	4	2	6	0	1	7	0	0
3	50420087	.	A	G	3	9	12	0	0	12	0	0
3	50420139	.	A	T	7	11	18	0	1	19	0	0
3	50420152	.	G	T	10	9	19	0	0	19	0	0
3	50861448	.	G	T	3	3	6	0	0	6	0	0
3	50951299	.	C	A	8	7	15	0	1	16	0	0
3	50951644	.	C	G	6	7	13	1	1	15	0	0
3	50951770	.	T	G	8	5	13	0	0	13	0	0
3	50951862	.	A	G	3	5	8	0	0	8	0	0
3	50952021	.	T	C	2	4	6	0	0	6	0	0
3	50952404	.	G	T	3	2	5	0	0	5	0	0
3	51034995	.	G	T	5	8	13	0	0	13	0	0
3	51039012	.	C	T	0	3	3	0	2	5	0	0
3	51056308	.	C	G	1	1	2	0	2	4	0	0
3	51056311	.	C	G	2	3	5	0	0	5	0	0
3	51056350	.	A	G	2	2	4	0	0	4	0	0
3	51056368	.	T	A	2	3	5	0	0	5	0	0
3	51065802	.	A	G	1	2	3	0	0	3	0	0
3	51619684	.	A	G	1	2	3	0	0	3	0	0
3	51619708	.	G	A	1	1	2	0	1	3	0	0
3	51645783	.	C	T	3	2	5	0	1	6	0	0
3	51653411	.	G	A	7	4	11	0	0	11	0	0
3	51653435	.	C	T	5	3	8	0	1	9	0	0
3	51656849	.	T	A	12	4	16	0	1	17	0	0
3	51656921	.	T	C	13	5	18	0	1	19	0	0
3	51656931	.	G	A	14	7	21	0	0	21	0	0
3	51656973	.	C	A	11	4	15	0	2	17	0	0
3	51657033	.	T	A	9	10	19	0	0	20	1	0
3	51657082	.	C	T	10	6	16	0	0	16	0	0
3	51657158	.	A	G	11	0	11	0	9	20	0	0
3	51657291	.	G	A	11	8	19	0	1	20	0	0
3	51657314	.	G	A	12	5	17	0	1	18	0	0
3	51657339	.	C	T	10	6	16	0	0	16	0	0
3	51657382	.	G	C	8	5	13	0	2	15	0	0
3	51657439	.	A	G	11	6	17	0	0	17	0	0
3	51657456	.	C	T	9	7	16	0	3	19	0	0
3	51813083	.	G	A	4	4	8	0	0	8	0	0
3	51861767	.	G	A	2	4	6	0	0	6	0	0
3	51871663	.	A	T	4	2	6	0	0	6	0	0
3	51871671	.	C	T	3	2	5	0	0	5	0	0
3	51871704	.	G	C	3	4	7	0	1	8	0	0
3	51871788	.	G	A	2	3	5	0	0	5	0	0
3	51874119	.	C	A	6	6	12	0	0	12	0	0
3	51874163	.	G	A	5	5	10	0	0	10	0	0
3	51874274	.	G	A	6	6	12	0	0	12	0	0
3	51879297	.	G	T	4	3	7	0	0	7	0	0
3	51891785	.	A	G	11	0	11	0	12	24	1	0
3	51891787	.	C	T	12	12	24	0	0	24	0	0
3	51892095	.	T	A	5	5	10	0	0	10	0	0
3	51892136	.	A	T	2	7	9	0	0	9	0	0
3	51892162	.	A	G	2	8	10	0	0	10	0	0
3	51892176	.	T	A	4	6	10	0	0	10	0	0
3	51892212	.	A	G	8	6	14	0	0	14	0	0
3	51892225	.	T	A	9	8	17	0	0	17	0	0
3	51892539	.	A	T	6	2	8	0	4	12	0	0
3	51892573	.	T	C	8	6	14	0	4	18	0	0
3	51899772	.	T	A	11	8	19	0	0	19	0	0
3	51899802	.	C	T	1	8	9	0	9	18	0	0
3	51899872	.	C	T	1	7	8	0	5	13	0	0
3	51900357	.	C	A	3	10	13	0	0	13	0	0
3	51900400	.	A	G	7	6	13	0	0	13	0	0
3	51900415	.	T	C	5	10	15	0	0	15	0	0
3	51900487	.	A	C	8	11	19	0	4	23	0	0
3	51900552	.	A	G	5	7	12	0	1	13	0	0
3	51900587	.	C	T	5	7	12	0	0	12	0	0
3	51900589	.	A	C	4	6	10	0	1	11	0	0
3	51900693	.	C	G	6	12	18	0	1	20	1	0
3	51900702	.	C	A	1	11	12	0	9	21	0	0
3	51900768	.	T	A	5	6	11	1	1	13	0	0
3	51900784	.	T	C	6	0	6	1	5	12	0	0
3	51901018	.	C	T	6	9	15	0	1	16	0	0
3	51901092	.	A	T	8	10	18	0	0	18	0	0
3	51901127	.	A	G	10	11	21	0	2	23	0	0
3	51901178	.	T	A	12	18	30	0	3	33	0	0
3	51901199	.	G	T	14	15	29	0	0	29	0	0
3	51901309	.	G	A	16	13	29	0	2	31	0	0
3	51901344	.	T	C	15	12	27	0	0	27	0	0
3	51901413	.	A	G	11	6	17	0	0	17	0	0
3	51901670	.	C	T	7	6	13	0	0	13	0	0
3	51901799	.	T	C	12	14	26	0	2	28	0	0
3	51901835	.	G	A	14	12	26	0	1	27	0	0
3	51901873	.	A	G	13	9	22	0	0	22	0	0
3	51901885	.	T	C	10	8	18	0	2	20	0	0
3	51902099	.	C	T	9	5	14	0	0	15	1	0
3	51902171	.	T	A	9	7	16	0	1	17	0	0
3	51902454	.	T	A	3	8	11	0	0	11	0	0
3	51902471	.	C	T	3	7	10	0	0	10	0	0
3	51902695	.	C	T	2	2	4	0	3	7	0	0
3	51902834	.	A	G	4	11	15	0	0	15	0	0
3	51902883	.	G	A	5	9	14	0	1	15	0	0
3	51902987	.	A	G	8	3	11	0	1	12	0	0
3	51903080	.	A	G	4	5	9	0	0	9	0	0
3	51903168	.	C	T	4	5	9	0	0	9	0	0
3	51903198	.	A	C	5	1	6	0	3	9	0	0
3	51903211	.	T	G	5	6	11	0	0	11	0	0
3	51903233	.	A	G	4	5	9	0	2	11	0	0
3	51903286	.	G	T	8	9	17	0	1	18	0	0
3	51903495	.	A	G	5	5	10	0	0	10	0	0
3	51903591	.	C	T	2	5	7	0	0	7	0	0
3	51903605	.	G	A	2	4	6	0	0	6	0	0
3	51903742	.	C	G	3	4	7	0	0	7	0	0
3	51904226	.	A	G	1	4	5	0	0	5	0	0
3	51904657	.	T	C	3	2	5	0	0	5	0	0
3	51907077	.	G	T	1	3	4	0	0	4	0	0
3	52539372	.	G	A	0	2	2	0	1	3	0	0
3	52539390	.	G	A	1	3	4	0	0	4	0	0
3	52558384	.	A	G	1	2	3	0	0	3	0	0
3	52558558	.	T	A	4	5	9	0	0	9	0	0
3	52563568	.	C	T	3	2	5	0	0	5	0	0
3	52578008	.	C	T	1	3	4	0	0	4	0	0
3	52584332	.	C	T	8	5	13	0	0	13	0	0
3	52588941	.	C	T	7	4	11	0	1	12	0	0
3	52594760	.	G	A	9	17	26	0	0	26	0	0
3	52594966	.	T	C	8	14	22	0	1	23	0	0
3	52603216	.	A	C	15	11	26	0	4	30	0	0
3	52641819	.	T	C	1	0	1	0	6	7	0	0
3	52641831	.	C	T	0	7	7	0	2	9	0	0
3	52642132	.	T	A	2	4	6	0	0	6	0	0
3	52642488	.	A	G	4	2	6	0	0	6	0	0
3	52642614	.	T	C	2	0	2	0	3	5	0	0
3	52647283	.	A	T	4	0	4	0	4	8	0	0
3	52647825	.	G	A	3	7	10	0	0	10	0	0
3	52647870	.	C	T	5	3	8	0	0	8	0	0
3	52667837	.	C	T	2	2	4	0	0	4	0	0
3	52668150	.	C	T	1	3	4	0	5	9	0	0
3	52668542	.	G	A	9	9	18	0	0	18	0	0
3	52668679	.	C	T	1	5	6	0	9	15	0	0
3	52669995	.	G	A	7	5	12	0	0	12	0	0
3	52673834	.	T	A	6	2	8	0	1	9	0	0
3	52673854	.	A	T	1	5	6	0	1	7	0	0
3	52673936	.	G	A	4	1	5	0	1	6	0	0
3	52677279	.	G	A	1	3	4	0	0	4	0	0
3	52677281	.	C	T	1	3	4	0	0	4	0	0
3	52677492	.	C	G	2	2	4	0	0	4	0	0
3	52677501	.	T	C	3	2	5	0	0	5	0	0
3	52699405	.	G	A	5	4	9	0	0	9	0	0
3	52699441	.	G	A	3	6	9	0	2	11	0	0
3	52699494	.	A	G	6	3	9	0	2	11	0	0
3	52699503	.	T	C	9	3	12	0	1	13	0	0
3	52699775	.	C	T	5	4	9	0	0	9	0	0
3	52699995	.	T	C	6	3	9	0	1	10	0	0
3	52895631	.	G	A	5	7	12	0	3	15	0	0
3	52895667	.	G	A	10	10	20	0	0	20	0	0
3	52895688	.	C	T	9	7	16	0	0	16	0	0
3	52895725	.	C	G	7	6	13	0	0	13	0	0
3	52898520	.	C	T	1	5	6	0	1	7	0	0
3	52908886	.	G	T	2	2	4	0	0	4	0	0
3	52913529	.	A	G	3	2	5	0	0	5	0	0
3	52913559	.	T	A	2	4	6	0	0	6	0	0
3	52921926	.	A	G	2	0	2	0	6	8	0	0
3	52931588	.	T	C	2	3	5	0	0	5	0	0
3	52935355	.	C	A	3	8	11	0	0	11	0	0
3	52937419	.	T	C	4	4	8	0	1	9	0	0
3	52937723	.	G	T	5	4	9	0	1	10	0	0
3	52937747	.	G	A	2	7	9	0	3	12	0	0
3	53000280	.	G	A	0	3	3	0	3	6	0	0
3	53000558	.	A	G	3	0	3	0	3	6	0	0
3	53000673	.	G	T	0	3	3	0	2	5	0	0
3	53001045	.	C	A	3	5	8	0	1	9	0	0
3	53047981	.	A	G	4	0	4	0	3	7	0	0
3	53048032	.	C	T	3	2	5	5	1	11	0	0
3	53074317	.	C	T	19	13	32	0	0	32	0	0
3	53074581	.	C	T	12	13	25	0	1	26	0	0
3	53075050	.	C	A	12	4	16	1	0	17	0	0
3	53075475	.	T	G	10	18	28	1	1	30	0	0
3	53076037	.	A	T	17	14	31	0	2	33	0	0
3	53076160	.	G	T	1	32	33	3	21	58	1	0
3	53140955	.	T	A	1	2	3	0	0	3	0	0
3	53198987	.	T	G	3	3	6	0	1	7	0	0
3	53199113	.	G	A	0	3	3	0	3	6	0	0
3	53199182	.	C	T	0	2	2	0	1	3	0	0
3	53199433	.	A	T	2	4	6	0	0	6	0	0
3	53201554	.	A	G	3	2	5	0	0	5	0	0
3	53203566	.	C	T	6	3	9	0	0	9	0	0
3	53203782	.	A	G	4	3	7	0	1	8	0	0
3	53203823	.	T	G	3	0	3	0	3	6	0	0
3	53206260	.	A	G	2	3	5	0	1	6	0	0
3	53206418	.	G	A	2	9	11	0	2	13	0	0
3	53206427	.	C	T	5	7	12	0	2	14	0	0
3	53206469	.	A	T	6	6	12	0	1	13	0	0
3	53206472	.	C	T	6	5	11	0	0	11	0	0
3	53211032	.	A	G	10	6	16	0	2	18	0	0
3	53211168	.	G	C	13	5	18	0	1	19	0	0
3	53211170	.	T	C	12	6	18	0	2	20	0	0
3	53211206	.	A	T	7	4	11	0	2	13	0	0
3	53211239	.	A	G	7	8	15	0	2	17	0	0
3	53211248	.	T	G	7	0	7	0	9	16	0	0
3	53211356	.	A	T	5	6	11	0	0	11	0	0
3	53211366	.	C	A	5	5	10	0	1	11	0	0
3	53211604	.	C	G	11	11	22	0	0	22	0	0
3	53211605	.	C	T	12	11	23	0	0	23	0	0
3	53214615	.	T	C	10	5	15	0	0	15	0	0
3	53215644	.	C	T	12	5	17	0	0	17	0	0
3	53215711	.	T	A	6	8	14	0	0	14	0	0
3	53215729	.	G	A	4	9	13	0	1	14	0	0
3	53218471	.	C	T	10	9	19	0	2	21	0	0
3	53222943	.	G	T	2	13	15	0	8	23	0	0
3	53223110	.	T	C	9	5	14	0	1	15	0	0
3	53223290	.	G	A	15	6	21	0	0	21	0	0
3	53223415	.	C	T	9	6	15	0	1	16	0	0
3	53223686	.	G	T	20	5	25	0	2	27	0	0
3	53223691	.	G	T	21	4	25	0	2	27	0	0
3	53223783	.	C	T	14	8	22	0	1	23	0	0
3	53223973	.	A	C	8	9	17	0	1	18	0	0
3	53224029	.	G	A	10	10	20	0	1	21	0	0
3	53224181	.	A	G	16	10	26	0	1	27	0	0
3	53224231	.	C	G	16	9	25	0	0	25	0	0
3	53228771	.	T	A	13	12	25	0	1	26	0	0
3	53229021	.	G	A	15	14	29	0	3	32	0	0
3	53229036	.	T	A	15	14	29	0	2	31	0	0
3	53230980	.	T	C	12	8	20	0	0	20	0	0
3	53231102	.	A	T	11	7	18	0	0	18	0	0
3	53231133	.	T	G	9	6	15	0	0	15	0	0
3	53231144	.	G	A	11	6	17	0	0	17	0	0
3	53243754	.	G	C	1	2	3	0	0	3	0	0
3	53253891	.	T	G	1	3	4	0	0	4	0	0
3	53261552	.	C	T	1	2	3	0	0	3	0	0
3	53261588	.	G	T	0	2	2	0	2	4	0	0
3	53264626	.	C	T	3	3	6	0	0	6	0	0
3	53264641	.	T	G	3	3	6	0	1	7	0	0
3	53264689	.	T	C	4	3	7	0	0	7	0	0
3	53267769	.	T	C	1	4	5	0	0	5	0	0
3	53271759	.	A	G	1	0	1	0	3	4	0	0
3	53274090	.	C	G	4	7	11	0	0	11	0	0
3	53327031	.	C	A	1	1	2	0	1	3	0	0
3	53342694	.	G	A	3	2	5	0	1	6	0	0
3	53342706	.	C	A	5	4	9	0	1	10	0	0
3	53343415	.	C	T	4	6	10	0	0	10	0	0
3	53343418	.	C	T	4	5	9	0	1	10	0	0
3	53344842	.	C	T	4	3	7	0	0	7	0	0
3	53344968	.	C	T	5	6	11	0	1	12	0	0
3	53398058	.	T	A	1	2	3	0	0	3	0	0
3	53445378	.	A	T	2	3	5	0	0	5	0	0
3	53445979	.	C	T	2	3	5	0	1	6	0	0
3	53446039	.	A	C	2	4	6	0	0	6	0	0
3	53446126	.	G	A	1	2	3	0	0	3	0	0
3	53446429	.	A	G	4	6	10	0	0	10	0	0
3	53446569	.	C	T	7	8	15	0	0	15	0	0
3	53447714	.	C	T	1	5	6	0	0	6	0	0
3	53447717	.	C	T	1	5	6	0	0	6	0	0
3	53448188	.	T	C	7	3	10	0	1	11	0	0
3	53448920	.	A	G	4	1	5	0	5	10	0	0
3	53449227	.	C	A	5	5	10	0	1	11	0	0
3	53449263	.	A	G	7	7	14	0	1	15	0	0
3	53476654	.	T	C	19	5	24	0	0	24	0	0
3	53527681	.	T	C	4	6	10	0	0	10	0	0
3	53528017	.	T	C	11	8	19	0	1	20	0	0
3	53528039	.	G	A	10	10	20	0	1	21	0	0
3	53528190	.	T	C	5	6	11	0	0	11	0	0
3	53528251	.	C	A	0	5	5	0	9	14	0	0
3	53528750	.	T	A	5	5	10	0	2	12	0	0
3	53528814	.	T	C	4	8	12	0	0	12	0	0
3	53528893	.	A	T	5	2	7	0	0	7	0	0
3	53529027	.	A	G	5	4	9	0	0	9	0	0
3	53530097	.	C	A	4	2	6	0	0	6	0	0
3	53530298	.	G	A	3	7	10	0	0	10	0	0
3	53530334	.	G	A	2	3	5	0	0	5	0	0
3	53687679	.	C	T	2	2	4	0	0	4	0	0
3	53687701	.	G	T	2	2	4	0	0	4	0	0
3	53687796	.	G	A	1	1	2	0	2	4	0	0
3	53688047	.	A	T	4	5	9	0	0	9	0	0
3	53688077	.	C	G	1	3	4	0	4	8	0	0
3	53688276	.	T	C	8	0	8	0	4	12	0	0
3	54047599	.	T	G	3	5	8	0	0	8	0	0
3	54047881	.	T	C	11	6	17	0	0	17	0	0
3	54168046	.	C	T	10	17	27	0	2	29	0	0
3	54168127	.	C	T	4	10	14	0	1	15	0	0
3	54168174	.	T	C	10	4	14	0	0	14	0	0
3	54168192	.	T	C	11	5	16	0	0	16	0	0
3	54168318	.	T	C	6	17	23	0	0	23	0	0
3	54207610	.	C	T	20	18	38	0	3	41	0	0
3	54223504	.	G	A	9	18	27	0	1	28	0	0
3	54236612	.	A	G	28	2	30	0	13	43	0	0
3	54236621	.	T	G	17	24	41	0	2	43	0	0
3	54236657	.	C	A	17	19	36	0	1	37	0	0
3	54236750	.	A	G	25	22	47	0	2	49	0	0
3	54236996	.	G	A	3	24	27	0	32	59	0	0
3	54237347	.	C	T	32	24	56	0	1	57	0	0
3	54237443	.	G	C	13	21	34	0	1	35	0	0
3	54237472	.	T	C	14	20	34	0	0	34	0	0
3	54434322	.	A	G	3	4	7	0	0	7	0	0
3	54435002	.	A	G	4	2	6	0	0	6	0	0
3	54435085	.	G	T	5	5	10	0	0	10	0	0
3	54435088	.	G	A	5	3	8	0	0	8	0	0
3	54435273	.	G	A	4	2	6	0	2	8	0	0
3	54435336	.	C	G	1	7	8	0	9	17	0	0
3	54435453	.	G	A	11	7	18	0	0	18	0	0
3	54438753	.	G	A	4	5	9	0	1	10	0	0
3	54438776	.	T	G	4	8	12	0	1	13	0	0
3	54441347	.	C	T	2	3	5	0	4	9	0	0
3	54455827	.	G	A	1	2	3	0	0	3	0	0
3	54474860	.	G	A	1	2	3	0	0	3	0	0
3	54555866	.	C	T	1	2	3	0	0	3	0	0
3	54555875	.	A	G	1	2	3	0	0	3	0	0
3	54561375	.	A	G	11	4	15	0	0	15	0	0
3	54567303	.	T	A	6	11	17	0	1	18	0	0
3	54567463	.	T	A	8	10	18	0	3	21	0	0
3	54567502	.	G	A	13	6	19	0	1	20	0	0
3	54567715	.	A	C	7	6	13	0	0	13	0	0
3	54567777	.	A	G	4	0	4	0	5	9	0	0
3	54583742	.	C	T	32	19	51	0	1	52	0	0
3	54585281	.	A	G	28	19	47	0	3	50	0	0
3	54585359	.	C	T	30	14	44	0	1	45	0	0
3	54585637	.	T	C	27	24	51	0	1	52	0	0
3	54585685	.	C	T	28	15	43	0	2	45	0	0
3	54586125	.	T	C	13	17	30	0	0	30	0	0
3	54589582	.	T	C	20	24	44	0	4	48	0	0
3	54591385	.	G	A	1	3	4	0	1	5	0	0
3	54591432	.	A	C	4	7	11	0	0	11	0	0
3	54591677	.	G	A	12	11	23	0	2	25	0	0
3	54591701	.	A	G	9	9	18	0	1	19	0	0
3	54591849	.	G	A	15	15	30	0	1	31	0	0
3	54592322	.	G	A	9	11	20	0	0	20	0	0
3	54592376	.	A	T	13	11	24	0	0	24	0	0
3	54592986	.	T	C	10	1	11	0	10	21	0	0
3	54593034	.	A	T	8	7	15	0	0	15	0	0
3	54593046	.	C	T	7	5	12	0	1	13	0	0
3	54594823	.	C	T	6	6	12	0	1	13	0	0
3	54594865	.	T	A	7	5	12	0	0	12	0	0
3	54594880	.	T	C	5	3	8	0	1	9	0	0
3	54595071	.	G	A	4	6	10	0	1	11	0	0
3	54596362	.	A	G	6	5	11	0	2	13	0	0
3	54596385	.	C	T	7	6	13	0	0	13	0	0
3	54596634	.	G	A	6	5	11	0	0	11	0	0
3	54596651	.	G	A	5	6	11	0	1	12	0	0
3	54596892	.	T	C	7	0	7	0	8	15	0	0
3	54596935	.	A	G	8	4	12	0	0	12	0	0
3	54597183	.	G	A	2	5	7	0	0	7	0	0
3	54598196	.	T	G	1	2	3	0	0	3	0	0
3	54602027	.	A	G	2	2	4	0	0	4	0	0
3	54602081	.	C	G	1	2	3	0	1	4	0	0
3	54749083	.	C	T	2	2	4	0	0	4	0	0
3	54749121	.	C	G	1	2	3	0	0	3	0	0
3	54771645	.	C	T	1	2	3	0	0	3	0	0
3	54771659	.	A	T	1	3	4	0	0	4	0	0
3	54771720	.	C	A	1	5	6	0	0	6	0	0
3	54810164	.	G	A	1	4	5	1	0	6	0	0
3	54834625	.	A	G	3	3	6	0	2	8	0	0
3	54834785	.	A	T	3	4	7	0	0	7	0	0
3	54834801	.	A	C	2	2	4	0	1	5	0	0
3	54859022	.	G	A	0	2	2	0	3	5	0	0
3	54859127	.	T	C	3	4	7	0	0	7	0	0
3	54866207	.	A	G	9	7	16	0	2	18	0	0
3	54871515	.	C	A	13	14	27	0	1	28	0	0
3	54871745	.	C	T	8	8	16	0	2	18	0	0
3	54872003	.	C	G	5	6	11	0	0	11	0	0
3	54872172	.	T	A	15	4	19	0	0	19	0	0
3	54872207	.	T	C	19	3	22	0	2	24	0	0
3	54872520	.	C	G	9	4	13	0	2	15	0	0
3	54872619	.	G	A	6	3	9	0	2	11	0	0
3	54872624	.	G	A	9	3	12	0	0	12	0	0
3	54873055	.	C	A	11	12	23	0	1	24	0	0
3	54873844	.	T	C	10	19	29	0	1	30	0	0
3	54874039	.	C	A	15	10	25	6	1	32	0	0
3	54874052	.	T	C	6	11	17	6	2	25	0	0
3	54874245	.	C	T	19	14	33	0	3	36	0	0
3	54874371	.	C	T	19	9	28	1	0	29	0	0
3	54874477	.	A	G	30	9	39	0	1	40	0	0
3	54874631	.	G	A	26	10	36	0	2	38	0	0
3	54874660	.	C	T	20	12	32	0	7	39	0	0
3	54874711	.	G	A	6	23	29	0	3	32	0	0
3	54874757	.	C	T	7	3	10	0	1	11	0	0
3	54896748	.	A	C	3	0	3	0	8	11	0	0
3	54896985	.	A	G	1	5	6	0	0	6	0	0
3	54897039	.	G	A	7	6	13	0	0	13	0	0
3	54897099	.	G	T	9	6	15	0	2	17	0	0
3	54908057	.	C	T	1	4	5	0	0	5	0	0
3	54910359	.	A	G	1	2	3	0	1	4	0	0
3	54911854	.	T	G	1	2	3	0	0	3	0	0
3	54914258	.	A	G	3	2	5	0	0	5	0	0
3	54916497	.	T	C	1	2	3	0	0	3	0	0
3	55039143	.	C	T	5	2	7	0	0	7	0	0
3	55042881	.	C	T	1	3	4	0	0	4	0	0
3	55042968	.	G	T	1	2	3	0	0	3	0	0
3	55042971	.	G	A	1	2	3	0	0	3	0	0
3	55045602	.	T	A	6	4	10	0	1	11	0	0
3	55045709	.	G	T	3	6	9	0	0	9	0	0
3	55045854	.	A	G	6	4	10	0	2	12	0	0
3	55046014	.	C	T	4	2	6	0	0	6	0	0
3	55046016	.	G	T	4	2	6	0	0	6	0	0
3	55046165	.	A	G	4	7	11	0	1	12	0	0
3	55050175	.	A	G	2	5	7	0	0	7	0	0
3	55053879	.	A	G	1	3	4	0	0	4	0	0
3	55063295	.	C	T	1	2	3	0	1	4	0	0
3	55070911	.	C	T	1	1	2	0	1	3	0	0
3	55091710	.	A	G	1	5	6	0	0	6	0	0
3	55093668	.	G	C	7	7	14	0	1	15	0	0
3	55093923	.	T	C	8	8	16	0	0	16	0	0
3	55093980	.	T	C	4	4	8	0	1	9	0	0
3	55094004	.	C	T	2	2	4	0	1	5	0	0
3	55094016	.	A	G	2	2	4	0	0	4	0	0
3	55094200	.	C	G	3	2	5	0	0	5	0	0
3	55098813	.	G	T	29	14	43	32	2	77	0	0
3	55100228	.	T	C	27	8	35	6	1	42	0	0
3	55100413	.	C	A	39	9	48	11	1	60	0	0
3	55100440	.	T	C	1	7	8	11	1	20	0	0
3	55100522	.	A	G	6	12	18	44	3	65	0	0
3	55100590	.	T	G	34	21	55	18	2	75	0	0
3	55100795	.	A	G	30	15	45	26	1	72	0	0
3	55105254	.	T	C	8	9	17	28	2	47	0	0
3	55105470	.	C	T	13	5	18	25	0	43	0	0
3	55105479	.	C	T	25	14	39	27	0	66	0	0
3	55105886	.	A	G	13	11	24	34	2	60	0	0
3	55218724	.	C	T	1	5	6	0	3	9	0	0
3	55218772	.	G	A	2	3	5	0	1	6	0	0
3	55218830	.	T	C	1	0	1	0	2	3	0	0
3	55219205	.	G	A	8	3	11	0	0	11	0	0
3	55222778	.	G	T	5	5	10	0	0	10	0	0
3	55229759	.	G	A	1	5	6	0	0	6	0	0
3	55422011	.	G	A	5	4	9	0	0	9	0	0
3	55422831	.	G	A	7	7	14	0	1	15	0	0
3	55422850	.	G	T	7	9	16	0	1	17	0	0
3	55422926	.	C	A	0	6	6	0	4	10	0	0
3	55422980	.	T	C	4	4	8	0	1	9	0	0
3	55423385	.	T	C	7	7	14	0	0	14	0	0
3	55423611	.	G	A	5	5	10	0	0	10	0	0
3	55423663	.	A	G	4	3	7	0	0	7	0	0
3	55424465	.	C	T	2	2	4	0	0	4	0	0
3	57462953	.	T	C	8	3	11	0	5	16	0	0
3	57462962	.	T	C	1	9	10	0	4	14	0	0
3	58197513	.	G	A	2	4	6	4	2	12	0	0
3	58197600	.	A	G	6	3	9	12	0	21	0	0
3	58197648	.	C	T	15	8	23	8	0	31	0	0
3	58197871	.	G	A	4	7	11	6	0	17	0	0
3	58210564	.	A	G	1	4	5	0	0	5	0	0
3	58210593	.	T	A	1	6	7	0	0	7	0	0
3	58608335	.	G	A	4	5	9	14	0	23	0	0
3	58710350	.	T	C	4	12	16	2	1	19	0	0
3	58710351	.	T	A	13	5	18	2	0	20	0	0
3	59815955	.	C	A	1	4	5	0	2	7	0	0
3	59816007	.	C	T	2	3	5	0	0	5	0	0
3	59868371	.	A	G	12	0	12	0	7	19	0	0
3	59868391	.	T	C	15	10	25	0	0	25	0	0
3	59868427	.	G	A	9	13	22	0	0	22	0	0
3	59870578	.	C	T	13	8	21	0	1	22	0	0
3	59876195	.	C	T	10	14	24	0	1	25	0	0
3	59876233	.	T	C	15	11	26	0	1	27	0	0
3	59876405	.	C	A	6	21	27	0	0	27	0	0
3	59876772	.	G	A	0	6	6	0	5	11	0	0
3	59880349	.	C	T	14	10	24	0	0	24	0	0
3	59880544	.	C	T	11	9	20	0	6	26	0	0
3	59883465	.	T	A	11	3	14	0	1	15	0	0
3	59883489	.	C	A	11	4	15	0	0	15	0	0
3	59887325	.	G	A	3	28	31	0	21	52	0	0
3	59887331	.	A	G	19	29	48	0	4	52	0	0
3	59889663	.	C	A	28	18	46	3	2	51	0	0
3	59941534	.	C	T	16	13	29	0	2	31	0	0
3	59941542	.	C	T	13	17	30	0	1	31	0	0
3	59941572	.	C	T	17	9	26	0	2	28	0	0
3	59942142	.	G	A	14	9	23	0	0	23	0	0
3	59945851	.	T	C	12	38	50	2	3	55	0	0
3	59945922	.	C	G	2	1	3	0	23	26	0	0
3	59946094	.	A	T	17	15	32	1	1	34	0	0
3	59946432	.	C	T	14	18	32	0	0	32	0	0
3	59946642	.	G	T	1	20	21	0	21	42	0	0
3	59946828	.	T	C	19	12	31	2	3	36	0	0
3	59946877	.	C	T	12	13	25	0	1	26	0	0
3	59946901	.	C	T	14	18	32	0	2	34	0	0
3	59947092	.	A	T	18	8	26	0	1	27	0	0
3	59951426	.	C	A	14	13	27	0	0	27	0	0
3	59951767	.	T	C	13	0	13	0	20	33	0	0
3	59951800	.	G	A	16	12	28	0	1	29	0	0
3	59952046	.	T	C	13	0	13	0	15	28	0	0
3	59952268	.	C	G	13	17	30	0	1	31	0	0
3	59961399	.	G	A	15	11	26	1	2	29	0	0
3	59986140	.	G	A	2	3	5	0	0	5	0	0
3	59986172	.	C	T	1	3	4	0	5	9	0	0
3	59986181	.	G	T	4	7	11	0	0	11	0	0
3	59994744	.	G	A	8	10	18	0	2	20	0	0
3	59995122	.	G	T	13	4	17	0	0	17	0	0
3	59997180	.	C	T	0	11	11	0	3	14	0	0
3	59999933	.	T	A	8	3	11	0	0	11	0	0
3	60002951	.	T	C	2	5	7	0	1	8	0	0
3	60003007	.	T	A	11	7	18	0	0	18	0	0
3	60014051	.	C	T	1	2	3	0	0	3	0	0
3	60025587	.	C	T	4	2	6	0	1	7	0	0
3	60054774	.	T	G	2	0	2	0	4	6	0	0
3	60054807	.	G	A	1	3	4	0	1	5	0	0
3	60054822	.	G	C	1	3	4	0	0	4	0	0
3	60055155	.	T	C	2	3	5	0	0	5	0	0
3	60073756	.	A	G	4	3	7	0	0	7	0	0
3	60074536	.	C	G	5	3	8	0	1	9	0	0
3	60074538	.	A	T	4	4	8	0	0	9	1	0
3	60294079	.	A	G	0	2	2	6	1	9	0	0
3	60294089	.	C	G	4	3	7	6	0	13	0	0
3	60526316	.	C	T	0	9	9	0	5	14	0	0
3	60526385	.	G	C	2	2	4	0	2	6	0	0
3	60526426	.	A	G	4	6	10	0	1	11	0	0
3	60526544	.	C	T	0	3	3	0	2	5	0	0
3	60526545	.	G	T	2	3	5	0	0	5	0	0
3	60526620	.	C	A	1	2	3	0	1	4	0	0
3	60575816	.	T	C	3	1	4	0	0	4	0	0
3	60575823	.	T	A	3	2	5	0	0	5	0	0
3	60575958	.	G	A	3	6	9	0	1	10	0	0
3	60575963	.	T	C	6	4	10	0	0	10	0	0
3	60576048	.	T	C	2	4	6	0	1	7	0	0
3	60576049	.	T	C	3	3	6	0	1	7	0	0
3	60576371	.	G	A	4	2	6	0	2	8	0	0
3	60576415	.	C	A	5	2	7	0	0	7	0	0
3	60576572	.	A	G	1	2	3	0	0	3	0	0
3	60578176	.	T	A	3	2	5	0	0	5	0	0
3	60578201	.	C	T	0	2	2	0	3	5	0	0
3	60589244	.	G	T	1	2	3	0	0	3	0	0
3	60590093	.	A	G	1	4	5	0	0	5	0	0
3	60592451	.	C	T	1	2	3	0	0	3	0	0
3	60594762	.	C	A	1	11	12	0	0	12	0	0
3	60596020	.	G	A	7	4	11	0	0	11	0	0
3	60596356	.	T	C	2	1	3	0	0	3	0	0
3	60596369	.	C	T	0	3	3	0	1	4	0	0
3	60596647	.	A	G	6	4	10	0	2	12	0	0
3	60596808	.	A	C	7	6	13	0	0	13	0	0
3	60601958	.	G	A	3	4	7	0	0	7	0	0
3	60710969	.	C	T	1	2	3	0	0	3	0	0
3	60730556	.	G	A	2	2	4	0	0	4	0	0
3	60731330	.	G	A	1	3	4	0	4	8	0	0
3	60731557	.	G	T	1	2	3	0	0	3	0	0
3	60732098	.	A	T	3	5	8	0	1	10	1	0
3	60732306	.	C	A	3	3	6	0	0	6	0	0
3	60732406	.	C	T	1	6	7	0	1	8	0	0
3	60732416	.	G	A	2	4	6	0	0	6	0	0
3	60732551	.	C	T	2	3	5	0	1	6	0	0
3	60732673	.	A	C	1	5	6	0	0	6	0	0
3	60732678	.	T	A	2	5	7	0	1	8	0	0
3	60789730	.	C	A	2	6	8	0	0	8	0	0
3	60841105	.	C	T	2	2	4	0	0	4	0	0
3	60841149	.	C	T	1	3	4	0	0	4	0	0
3	60855800	.	C	T	3	2	5	0	0	5	0	0
3	60862519	.	G	A	9	7	16	0	2	18	0	0
3	60875101	.	C	T	2	4	6	0	0	6	0	0
3	60962589	.	T	C	1	2	3	0	0	3	0	0
3	60971719	.	G	C	3	2	5	0	2	7	0	0
3	60976921	.	C	T	4	4	8	0	0	8	0	0
3	60976985	.	G	A	1	4	5	0	6	11	0	0
3	60977060	.	A	G	2	0	2	0	4	6	0	0
3	60977134	.	T	A	3	5	8	0	0	8	0	0
3	60978344	.	G	A	5	3	8	0	0	8	0	0
3	60982492	.	A	C	5	5	10	0	0	10	0	0
3	60985862	.	C	T	7	3	10	0	0	10	0	0
3	60992134	.	A	G	6	0	6	0	8	14	0	0
3	60994781	.	G	C	7	9	16	0	0	16	0	0
3	60997781	.	C	G	7	10	17	0	0	17	0	0
3	61004295	.	G	A	1	11	12	0	9	21	0	0
3	61004397	.	C	T	6	9	15	0	0	15	0	0
3	61004442	.	G	T	4	9	13	0	0	13	0	0
3	61013397	.	C	T	5	10	15	0	1	16	0	0
3	61026883	.	G	T	15	13	28	0	0	28	0	0
3	61030127	.	G	A	14	11	25	0	5	30	0	0
3	61030181	.	C	T	11	13	24	0	4	28	0	0
3	61030220	.	C	T	13	16	29	0	1	30	0	0
3	61030699	.	G	C	21	11	32	0	1	33	0	0
3	61030800	.	G	A	16	12	28	0	4	32	0	0
3	61030829	.	G	A	17	14	31	0	3	34	0	0
3	61033183	.	C	T	25	19	44	0	5	49	0	0
3	61033859	.	C	A	32	16	48	0	4	52	0	0
3	61033979	.	C	A	24	29	53	0	2	55	0	0
3	61034060	.	T	G	33	0	33	0	28	61	0	0
3	61034096	.	T	C	26	23	49	0	4	53	0	0
3	61078285	.	T	C	2	2	4	0	0	4	0	0
3	61078325	.	T	G	1	3	4	0	0	4	0	0
3	61078337	.	A	C	1	5	6	0	0	6	0	0
3	61108600	.	G	T	22	4	26	0	2	28	0	0
3	61108732	.	A	G	13	17	30	0	6	36	0	0
3	61108734	.	T	C	14	1	15	0	22	37	0	0
3	61108830	.	C	A	4	14	18	0	22	40	0	0
3	61111826	.	G	T	10	4	14	0	3	17	0	0
3	61116160	.	C	T	8	4	12	0	0	12	0	0
3	61157220	.	T	C	3	3	6	0	0	6	0	0
3	61162638	.	A	G	1	3	4	0	0	4	0	0
3	61278992	.	C	T	1	2	3	0	0	3	0	0
3	61279124	.	T	C	1	2	3	0	0	3	0	0
3	61279308	.	T	G	2	2	4	0	0	4	0	0
3	61279585	.	G	A	1	3	4	0	7	11	0	0
3	61279588	.	T	A	4	6	10	0	1	11	0	0
3	61279643	.	T	C	7	5	12	0	0	12	0	0
3	61279781	.	C	T	2	5	7	0	0	7	0	0
3	61279844	.	G	A	0	3	3	0	5	8	0	0
3	61280198	.	G	T	3	4	7	0	0	7	0	0
3	61280579	.	T	G	5	0	5	0	5	10	0	0
3	61285784	.	C	T	9	7	16	0	1	17	0	0
3	61285947	.	A	G	5	0	5	0	6	11	0	0
3	61286007	.	T	G	5	7	12	0	1	13	0	0
3	61286468	.	C	T	7	8	15	0	0	15	0	0
3	61286528	.	A	T	4	5	9	0	2	11	0	0
3	61286564	.	T	C	0	9	9	0	0	9	0	0
3	61286576	.	C	T	5	6	11	0	1	12	0	0
3	61286889	.	T	C	9	7	16	0	1	17	0	0
3	61286998	.	G	A	0	13	13	0	15	28	0	0
3	61287010	.	A	G	13	12	25	0	0	25	0	0
3	61287094	.	A	G	9	0	9	0	5	14	0	0
3	61287214	.	A	T	15	9	24	0	0	24	0	0
3	61287260	.	G	T	11	8	19	0	1	20	0	0
3	61287289	.	C	T	7	8	15	0	1	16	0	0
3	61287343	.	G	T	11	13	24	0	1	25	0	0
3	61287491	.	T	A	13	14	27	0	1	28	0	0
3	61287627	.	C	G	19	15	34	0	1	35	0	0
3	61287893	.	T	G	12	2	14	0	20	34	0	0
3	61288028	.	T	C	12	20	32	0	0	32	0	0
3	61288238	.	A	C	15	19	34	0	0	34	0	0
3	61292963	.	C	A	4	2	6	0	0	6	0	0
3	61303838	.	G	A	1	1	2	0	1	3	0	0
3	61342032	.	C	T	0	4	4	0	5	9	0	0
3	61342341	.	G	T	7	3	10	0	1	11	0	0
3	61342770	.	G	A	17	6	23	0	1	24	0	0
3	61343014	.	T	A	11	3	14	0	0	14	0	0
3	61343019	.	T	A	12	2	14	0	0	14	0	0
3	61343425	.	T	A	3	2	5	0	0	5	0	0
3	61343589	.	T	C	3	6	9	0	0	9	0	0
3	61349556	.	C	G	4	5	9	0	0	9	0	0
3	61349602	.	G	A	5	4	9	0	0	9	0	0
3	61349654	.	C	T	6	8	14	0	0	14	0	0
3	61349734	.	G	A	5	9	14	0	0	14	0	0
3	61350466	.	T	A	2	2	4	0	0	4	0	0
3	61350487	.	T	C	2	2	4	0	0	4	0	0
3	61350673	.	T	G	2	3	5	0	0	5	0	0
3	61351458	.	C	G	1	1	2	0	2	4	0	0
3	61351465	.	C	T	0	2	2	0	2	4	0	0
3	61352062	.	C	T	3	2	5	0	0	5	0	0
3	61354057	.	C	G	4	4	8	0	0	8	0	0
3	61354072	.	A	T	2	5	7	0	0	7	0	0
3	61354221	.	A	G	2	2	4	0	0	4	0	0
3	61358195	.	T	C	4	2	6	0	0	6	0	0
3	61358196	.	T	C	4	2	6	0	0	6	0	0
3	61358265	.	C	T	5	6	11	0	0	11	0	0
3	61358269	.	G	A	6	4	10	0	0	10	0	0
3	61358662	.	C	A	5	2	7	0	0	7	0	0
3	61358682	.	T	C	3	3	6	1	0	7	0	0
3	61359397	.	G	T	1	8	9	2	1	12	0	0
3	61365135	.	G	A	4	2	6	11	1	18	0	0
3	61367528	.	T	A	1	2	3	0	0	3	0	0
3	61367573	.	T	C	1	1	2	0	4	6	0	0
3	61372168	.	T	C	4	2	6	0	0	6	0	0
3	61375539	.	A	T	2	4	6	0	0	6	0	0
3	61382329	.	G	A	3	2	5	0	0	5	0	0
3	61382369	.	C	A	2	2	4	2	0	6	0	0
3	61382640	.	T	A	2	2	4	0	0	4	0	0
3	61382698	.	A	G	2	2	4	6	1	11	0	0
3	61382701	.	A	T	2	2	4	6	0	10	0	0
3	61383279	.	G	A	2	3	5	0	0	5	0	0
3	61383492	.	T	C	2	0	2	0	3	5	0	0
3	61391687	.	T	C	6	4	10	0	1	11	0	0
3	61391797	.	G	A	1	3	4	0	4	9	1	0
3	61396523	.	C	T	8	8	16	0	0	16	0	0
3	61396868	.	A	T	3	7	10	0	2	12	0	0
3	61397093	.	C	T	9	7	16	0	1	17	0	0
3	61397231	.	C	A	7	5	12	0	1	13	0	0
3	61397294	.	C	T	5	4	9	0	0	9	0	0
3	61398395	.	A	G	4	2	6	0	1	7	0	0
3	61398400	.	A	C	0	5	5	0	0	5	0	0
3	61398728	.	A	G	8	11	19	0	1	20	0	0
3	61398809	.	T	C	9	11	20	0	0	20	0	0
3	61398882	.	T	C	2	2	4	0	1	5	0	0
3	61401453	.	A	C	3	3	6	1	0	7	0	0
3	61429183	.	C	T	0	3	3	0	3	6	0	0
3	61430396	.	T	C	2	2	4	0	0	4	0	0
3	61430403	.	C	G	1	1	2	0	1	3	0	0
3	61542631	.	A	C	2	2	4	0	0	4	0	0
3	61542663	.	G	A	0	2	2	0	2	4	0	0
3	61542973	.	T	C	2	4	6	0	1	7	0	0
3	61543658	.	T	C	1	2	3	0	0	3	0	0
3	61566559	.	G	A	3	2	5	0	0	5	0	0
3	61585516	.	G	A	1	2	3	0	0	3	0	0
3	62035030	.	G	A	0	2	2	0	2	4	0	0
3	62035952	.	A	G	2	0	2	0	3	5	0	0
3	62036320	.	A	G	1	2	3	0	0	3	0	0
3	62036323	.	A	G	1	2	3	0	0	3	0	0
3	62037105	.	T	C	3	4	7	0	0	7	0	0
3	62037343	.	G	C	1	4	5	0	0	5	0	0
3	62037430	.	A	G	3	0	3	0	4	7	0	0
3	62038354	.	G	A	0	6	6	0	2	8	0	0
3	62038526	.	T	C	5	7	12	0	0	12	0	0
3	62038739	.	G	C	5	7	12	0	0	12	0	0
3	62038993	.	G	A	3	11	14	0	8	22	0	0
3	62039278	.	A	G	15	1	16	0	12	28	0	0
3	62039657	.	G	A	0	12	12	0	7	19	0	0
3	62039689	.	C	A	7	10	17	0	0	17	0	0
3	62039718	.	G	A	4	9	13	0	1	14	0	0
3	62039813	.	T	A	10	16	26	0	0	26	0	0
3	62040555	.	G	A	18	18	36	0	0	36	0	0
3	62051395	.	A	G	12	9	21	0	1	22	0	0
3	62051660	.	T	A	10	14	24	0	0	24	0	0
3	62051731	.	G	A	11	4	15	0	1	16	0	0
3	62069739	.	G	T	3	2	5	0	0	5	0	0
3	62091398	.	A	G	3	4	7	0	0	7	0	0
3	62091632	.	T	A	10	11	21	0	1	22	0	0
3	62091660	.	T	A	10	11	21	0	1	22	0	0
3	62091880	.	C	T	17	8	25	0	1	26	0	0
3	62091975	.	C	A	20	11	31	0	1	32	0	0
3	62091995	.	G	T	20	14	34	0	1	35	0	0
3	62092025	.	C	T	1	13	14	0	16	30	0	0
3	62092262	.	T	A	11	6	17	0	1	18	0	0
3	62092279	.	A	T	9	6	15	0	0	15	0	0
3	62092666	.	G	A	6	7	13	0	0	13	0	0
3	62092715	.	A	C	12	14	26	0	0	26	0	0
3	62092749	.	G	C	12	15	27	0	0	27	0	0
3	62092801	.	C	T	8	7	15	0	1	16	0	0
3	62092902	.	A	T	8	6	14	0	0	14	0	0
3	62093241	.	T	A	9	11	20	0	0	20	0	0
3	62094327	.	C	T	6	2	8	0	1	9	0	0
3	62094645	.	A	G	2	5	7	0	0	7	0	0
3	62094849	.	A	G	6	4	10	0	0	10	0	0
3	62095051	.	G	A	2	3	5	0	2	7	0	0
3	62095175	.	T	A	7	4	11	0	0	11	0	0
3	62095317	.	A	G	10	4	14	0	0	14	0	0
3	62095572	.	T	A	5	2	7	0	0	7	0	0
3	62095573	.	G	T	5	2	7	0	0	7	0	0
3	62095644	.	G	C	1	2	3	0	0	3	0	0
3	62095646	.	T	A	1	2	3	0	0	3	0	0
3	62095940	.	G	C	3	2	5	0	0	5	0	0
3	62096871	.	G	T	1	2	3	0	0	3	0	0
3	62096912	.	A	G	1	3	4	0	0	4	0	0
3	62096937	.	C	T	1	2	3	0	0	3	0	0
3	62097490	.	A	T	2	2	4	0	1	5	0	0
3	62097548	.	A	T	4	2	6	0	0	6	0	0
3	62114615	.	C	T	0	2	2	0	3	5	0	0
3	62126992	.	T	A	0	2	2	0	1	3	0	0
3	62127168	.	C	T	3	2	5	0	1	6	0	0
3	62127190	.	G	A	4	4	8	0	0	8	0	0
3	62137708	.	C	T	14	7	21	0	1	22	0	0
3	62138746	.	A	G	9	8	17	0	1	18	0	0
3	62147737	.	G	A	3	2	5	0	0	5	0	0
3	62149774	.	C	T	3	6	9	0	0	9	0	0
3	62173443	.	A	T	6	3	9	0	0	9	0	0
3	62173503	.	G	T	6	10	16	0	0	16	0	0
3	62173546	.	C	T	5	11	16	0	0	16	0	0
3	62173593	.	T	C	10	5	15	0	1	16	0	0
3	62173628	.	T	C	12	5	17	0	1	18	0	0
3	62180788	.	G	A	1	4	5	0	1	6	0	0
3	62196977	.	C	T	5	5	10	0	0	10	0	0
3	62203509	.	G	A	9	6	15	0	0	15	0	0
3	62205906	.	C	A	3	3	6	0	0	6	0	0
3	62209024	.	A	G	1	3	4	0	0	4	0	0
3	62209033	.	A	G	2	3	5	0	0	5	0	0
3	62209183	.	A	G	3	1	4	0	5	9	0	0
3	62209216	.	A	G	2	6	8	0	0	8	0	0
3	62209325	.	A	G	2	3	5	0	0	5	0	0
3	62238692	.	G	A	2	2	4	1	0	5	0	0
3	62238721	.	C	T	1	4	5	0	0	5	0	0
3	62240421	.	A	T	2	2	4	0	0	4	0	0
3	62275415	.	T	A	1	2	3	0	1	4	0	0
3	62275507	.	T	A	4	3	7	0	0	7	0	0
3	62275598	.	G	A	5	3	8	0	0	8	0	0
3	62275743	.	T	C	2	2	4	1	0	5	0	0
3	62276101	.	G	A	1	5	6	0	0	6	0	0
3	62276104	.	A	G	1	5	6	0	0	6	0	0
3	62323564	.	C	T	2	7	9	0	0	9	0	0
3	62323908	.	G	C	2	7	9	0	0	9	0	0
3	62324030	.	C	T	3	1	4	0	2	6	0	0
3	62324063	.	A	T	3	4	7	0	0	7	0	0
3	62324312	.	T	C	3	4	7	1	1	9	0	0
3	62328846	.	G	C	3	5	8	1	0	9	0	0
3	62328970	.	A	G	7	3	10	0	0	10	0	0
3	62329097	.	G	C	8	3	11	0	1	12	0	0
3	62329545	.	G	T	5	4	9	0	3	12	0	0
3	62345770	.	A	T	2	6	8	0	1	9	0	0
3	62353679	.	G	T	1	3	4	0	0	4	0	0
3	62353952	.	G	A	8	4	12	0	0	12	0	0
3	62359440	.	G	T	8	15	23	0	1	24	0	0
3	62360484	.	C	T	10	17	27	0	2	29	0	0
3	62360686	.	G	A	2	4	6	0	0	6	0	0
3	62360736	.	C	A	1	8	9	0	0	9	0	0
3	62369864	.	G	A	11	7	18	0	0	18	0	0
3	62370068	.	A	G	3	7	10	0	1	11	0	0
3	62370381	.	A	G	1	5	6	0	0	6	0	0
3	62370476	.	G	A	4	3	7	0	1	8	0	0
3	62379739	.	C	T	2	1	3	0	1	4	0	0
3	62382863	.	A	G	37	29	66	0	5	71	0	0
3	62383438	.	G	A	35	22	57	0	1	58	0	0
3	62383439	.	A	G	33	23	56	0	2	58	0	0
3	62383565	.	T	A	27	22	49	0	4	53	0	0
3	62383589	.	A	C	22	21	43	1	3	47	0	0
3	62383610	.	G	C	15	1	16	1	24	41	0	0
3	62383706	.	C	T	33	19	52	3	1	56	0	0
3	62383992	.	C	G	12	17	29	2	0	31	0	0
3	62384055	.	G	A	13	9	22	7	1	30	0	0
3	62384208	.	C	T	4	35	39	0	21	60	0	0
3	62384219	.	G	A	41	14	55	0	3	58	0	0
3	62384423	.	C	G	26	34	60	0	3	63	0	0
3	62384428	.	T	A	36	20	56	0	4	60	0	0
3	62384565	.	C	G	25	21	46	1	6	53	0	0
3	62386420	.	T	C	24	1	25	0	22	47	0	0
3	62386955	.	G	T	21	12	33	0	7	40	0	0
3	62387141	.	C	T	2	8	10	0	18	28	0	0
3	62387144	.	C	T	8	17	25	0	2	27	0	0
3	62393321	.	G	A	9	4	13	0	0	13	0	0
3	62399218	.	C	T	1	4	5	0	0	5	0	0
3	62433064	.	C	T	8	4	12	1	2	15	0	0
3	62433138	.	T	G	9	7	16	0	0	16	0	0
3	62521137	.	G	A	5	4	9	0	1	10	0	0
3	62521142	.	T	C	6	0	6	0	4	10	0	0
3	62521263	.	T	A	11	14	25	0	2	27	0	0
3	62521956	.	G	A	10	11	21	0	2	23	0	0
3	62522063	.	A	T	7	12	19	0	1	20	0	0
3	62522065	.	G	T	7	11	18	0	2	20	0	0
3	62522238	.	A	G	10	6	16	0	1	17	0	0
3	62522742	.	C	A	3	4	7	0	0	7	0	0
3	62522750	.	G	C	4	2	6	0	1	7	0	0
3	62522804	.	C	T	0	5	5	0	2	7	0	0
3	62522899	.	C	G	13	5	18	0	2	20	0	0
3	62523031	.	A	G	2	12	14	1	2	17	0	0
3	62523032	.	A	T	14	2	16	1	0	17	0	0
3	62523325	.	G	T	4	7	11	0	1	12	0	0
3	62523502	.	G	A	3	4	7	0	0	7	0	0
3	62523550	.	C	T	4	3	7	0	0	7	0	0
3	62527379	.	G	T	3	2	5	0	0	5	0	0
3	62527397	.	G	T	1	1	2	0	2	4	0	0
4	109469	.	T	C	5	2	7	0	0	7	0	0
4	308804	.	T	A	21	14	35	0	5	40	0	0
4	313108	.	A	C	16	21	37	0	3	40	0	0
4	317091	.	A	G	16	21	37	0	3	40	0	0
4	317275	.	G	T	16	16	32	0	0	32	0	0
4	317658	.	C	T	5	3	8	0	2	10	0	0
4	325073	.	C	T	2	3	5	0	0	5	0	0
4	325126	.	G	A	5	9	14	0	0	14	0	0
4	325136	.	G	A	7	12	19	0	0	19	0	0
4	325161	.	A	C	13	1	14	0	13	27	0	0
4	329743	.	G	A	9	14	23	1	1	25	0	0
4	329746	.	A	G	8	13	21	1	0	22	0	0
4	344264	.	T	G	1	2	3	0	0	3	0	0
4	348297	.	T	C	1	2	3	0	0	3	0	0
4	351055	.	G	A	2	3	5	0	0	5	0	0
4	352284	.	A	G	4	0	4	0	3	7	0	0
4	352289	.	T	C	4	3	7	0	1	8	0	0
4	352504	.	T	C	5	9	14	0	0	14	0	0
4	353238	.	T	G	5	0	5	0	5	10	0	0
4	353247	.	T	C	6	4	10	0	0	10	0	0
4	353481	.	A	G	5	1	6	0	4	10	0	0
4	353638	.	C	T	1	3	4	0	0	4	0	0
4	353778	.	T	A	4	3	7	0	0	7	0	0
4	357887	.	T	G	2	2	4	0	0	4	0	0
4	357954	.	G	A	3	2	5	0	0	5	0	0
4	358080	.	T	C	1	3	4	0	0	4	0	0
4	362282	.	C	T	2	2	4	0	1	5	0	0
4	367532	.	T	G	1	0	1	0	3	4	0	0
4	385092	.	C	T	17	10	27	0	3	30	0	0
4	385625	.	A	T	8	2	10	0	2	12	0	0
4	385668	.	G	A	9	8	17	0	2	19	0	0
4	385710	.	T	C	13	13	26	0	0	26	0	0
4	386014	.	A	C	19	9	28	0	3	32	1	0
4	386037	.	T	G	20	10	30	0	3	33	0	0
4	386085	.	G	A	22	8	30	0	0	30	0	0
4	386124	.	C	A	4	5	9	0	6	15	0	0
4	386537	.	T	A	17	22	39	0	6	46	1	0
4	386538	.	T	A	24	22	46	0	4	50	0	0
4	386839	.	A	G	41	0	41	1	3	45	0	0
4	389141	.	G	A	14	10	24	0	2	26	0	0
4	394020	.	T	C	30	37	67	0	4	71	0	0
4	397913	.	A	G	5	4	9	0	1	10	0	0
4	647752	.	G	T	6	2	8	0	0	8	0	0
4	659276	.	C	T	3	3	6	0	0	6	0	0
4	659345	.	T	C	3	7	10	0	1	11	0	0
4	660571	.	G	A	5	3	8	0	3	11	0	0
4	660649	.	T	A	5	6	11	0	0	11	0	0
4	660655	.	G	A	2	6	8	0	4	12	0	0
4	660715	.	T	C	10	11	21	0	1	22	0	0
4	667358	.	T	C	10	8	18	0	1	19	0	0
4	667382	.	A	G	13	0	13	0	9	22	0	0
4	674838	.	T	C	14	16	30	0	1	31	0	0
4	675080	.	T	C	4	4	8	0	2	10	0	0
4	676885	.	A	G	12	13	25	0	0	25	0	0
4	676942	.	A	G	13	13	26	0	3	29	0	0
4	678853	.	C	T	8	15	23	0	3	26	0	0
4	679441	.	C	G	2	12	14	0	18	32	0	0
4	680314	.	G	T	9	6	15	0	1	16	0	0
4	680320	.	C	T	9	6	15	0	0	15	0	0
4	680359	.	C	T	10	7	17	0	0	17	0	0
4	680395	.	T	C	14	1	15	0	10	25	0	0
4	680404	.	G	A	15	9	24	0	1	25	0	0
4	681595	.	G	A	6	6	12	0	1	13	0	0
4	686987	.	G	A	0	3	3	0	3	6	0	0
4	686999	.	C	G	4	2	6	0	1	7	0	0
4	687083	.	A	G	1	0	1	0	3	4	0	0
4	694373	.	C	T	3	4	7	0	0	7	0	0
4	694680	.	A	C	5	7	12	0	0	12	0	0
4	694718	.	G	A	5	3	8	0	0	8	0	0
4	694741	.	T	G	6	3	9	0	0	9	0	0
4	694757	.	A	T	4	2	6	0	0	6	0	0
4	695367	.	C	T	6	3	9	0	0	9	0	0
4	700281	.	A	C	6	9	15	1	5	21	0	0
4	700284	.	G	T	2	9	11	1	10	22	0	0
4	700563	.	G	T	7	6	13	0	0	13	0	0
4	700569	.	G	A	0	5	5	0	5	10	0	0
4	700598	.	A	T	2	5	7	0	2	9	0	0
4	700606	.	T	C	2	5	7	0	0	7	0	0
4	700634	.	A	C	2	5	7	0	0	7	0	0
4	700665	.	G	T	3	3	6	0	0	6	0	0
4	710577	.	T	G	1	2	3	0	0	3	0	0
4	710593	.	G	A	1	2	3	0	0	3	0	0
4	736442	.	A	G	9	14	23	0	3	26	0	0
4	737883	.	T	A	5	4	9	0	0	9	0	0
4	737927	.	T	G	7	6	13	0	0	13	0	0
4	740435	.	A	T	8	6	14	0	1	15	0	0
4	740921	.	T	C	9	7	16	0	1	17	0	0
4	740965	.	T	G	11	8	19	1	0	20	0	0
4	749803	.	G	A	13	5	18	0	1	19	0	0
4	749989	.	G	T	7	5	12	0	0	12	0	0
4	750016	.	T	C	5	0	5	0	5	10	0	0
4	750526	.	C	G	5	7	12	0	1	13	0	0
4	750531	.	C	T	5	6	11	0	2	13	0	0
4	750661	.	C	T	0	7	7	0	8	15	0	0
4	751275	.	A	G	4	3	7	0	1	8	0	0
4	751546	.	G	A	4	7	11	0	1	12	0	0
4	751553	.	C	T	5	7	12	0	1	13	0	0
4	765112	.	A	G	10	12	22	0	2	24	0	0
4	766575	.	G	A	12	9	21	0	1	22	0	0
4	766588	.	G	A	11	10	21	0	0	21	0	0
4	766613	.	A	C	11	10	21	0	0	21	0	0
4	769533	.	A	T	5	7	12	0	0	12	0	0
4	769726	.	G	A	11	8	19	0	1	20	0	0
4	772363	.	C	T	7	7	14	0	1	15	0	0
4	776550	.	G	T	1	3	4	0	1	5	0	0
4	778111	.	G	A	8	9	17	0	0	17	0	0
4	779310	.	G	A	4	6	10	0	0	10	0	0
4	779363	.	T	C	3	0	3	0	7	10	0	0
4	779429	.	A	G	3	4	7	0	1	8	0	0
4	779442	.	G	A	4	7	11	0	0	11	0	0
4	783816	.	G	T	22	19	41	0	3	44	0	0
4	783835	.	A	G	22	21	43	0	5	48	0	0
4	784002	.	T	A	25	19	44	0	1	45	0	0
4	784177	.	T	C	27	25	52	0	5	57	0	0
4	784325	.	A	T	13	15	28	0	1	29	0	0
4	784373	.	T	A	7	4	11	0	0	11	0	0
4	784472	.	T	C	2	3	5	0	0	5	0	0
4	784473	.	A	C	2	3	5	0	0	5	0	0
4	784642	.	G	A	15	6	21	0	0	21	0	0
4	784733	.	T	A	10	5	15	0	0	15	0	0
4	784854	.	C	A	10	6	16	0	2	18	0	0
4	784990	.	T	A	21	17	38	0	3	41	0	0
4	785011	.	T	C	19	10	29	0	5	34	0	0
4	785132	.	G	A	23	17	40	0	2	42	0	0
4	788970	.	G	C	11	0	11	0	17	28	0	0
4	789589	.	A	G	12	9	21	0	1	22	0	0
4	798743	.	G	C	5	5	10	0	1	11	0	0
4	798804	.	G	A	17	12	29	0	4	33	0	0
4	798850	.	A	C	13	16	29	0	3	32	0	0
4	798861	.	G	T	13	19	32	0	2	34	0	0
4	799006	.	G	T	26	14	40	0	1	41	0	0
4	799090	.	T	C	16	12	28	1	1	30	0	0
4	799127	.	T	G	17	13	30	0	2	32	0	0
4	799245	.	G	A	19	14	33	0	0	33	0	0
4	799385	.	C	G	13	8	21	0	0	21	0	0
4	799475	.	A	G	13	16	29	0	5	34	0	0
4	799513	.	G	A	13	19	32	0	3	35	0	0
4	799620	.	C	T	30	10	40	0	1	41	0	0
4	799643	.	T	A	28	13	41	0	5	47	1	0
4	799933	.	C	T	22	23	45	0	0	45	0	0
4	800027	.	C	T	18	14	32	0	0	32	0	0
4	800094	.	A	G	26	16	42	0	1	43	0	0
4	800113	.	A	G	25	17	42	0	1	43	0	0
4	800363	.	C	T	2	19	21	0	25	46	0	0
4	800520	.	T	C	23	20	43	0	0	43	0	0
4	802909	.	T	A	25	19	44	0	3	47	0	0
4	803862	.	T	C	14	0	14	0	14	28	0	0
4	806319	.	G	A	16	5	21	0	0	21	0	0
4	806322	.	T	C	17	4	21	0	0	21	0	0
4	807895	.	C	G	12	8	20	0	3	23	0	0
4	807898	.	A	G	13	9	22	0	1	23	0	0
4	808031	.	C	T	12	14	26	0	0	26	0	0
4	808421	.	A	G	12	9	21	0	0	21	0	0
4	809456	.	A	G	12	4	16	0	3	19	0	0
4	809512	.	T	C	20	0	20	0	7	27	0	0
4	809549	.	A	G	14	8	22	0	0	22	0	0
4	813157	.	G	A	6	5	11	0	0	11	0	0
4	813226	.	A	G	9	8	17	0	0	17	0	0
4	861681	.	G	A	1	3	4	0	0	4	0	0
4	864324	.	T	A	4	4	8	0	2	10	0	0
4	864739	.	G	C	3	2	5	0	0	5	0	0
4	867601	.	G	C	6	6	12	0	1	13	0	0
4	870833	.	C	T	1	2	3	0	3	6	0	0
4	870876	.	C	T	5	3	8	0	1	9	0	0
4	872296	.	T	C	4	1	5	0	3	8	0	0
4	872356	.	A	G	2	3	5	0	0	5	0	0
4	873763	.	C	G	3	6	9	0	0	9	0	0
4	880365	.	G	A	3	3	6	0	0	6	0	0
4	880394	.	A	G	1	2	3	0	1	4	0	0
4	880890	.	C	G	0	3	3	0	1	4	0	0
4	880934	.	A	C	2	0	2	0	2	4	0	0
4	881051	.	A	G	4	2	6	0	0	6	0	0
4	881784	.	G	A	2	2	4	0	0	4	0	0
4	882099	.	G	A	3	3	6	0	0	6	0	0
4	905612	.	G	A	0	2	2	0	1	3	0	0
4	905657	.	A	G	1	4	5	0	0	5	0	0
4	905713	.	C	G	1	3	4	0	0	4	0	0
4	959015	.	T	C	5	5	10	0	0	10	0	0
4	961542	.	G	A	7	7	14	0	1	15	0	0
4	965124	.	C	G	0	3	3	0	2	5	0	0
4	967974	.	C	T	5	3	8	0	1	9	0	0
4	968001	.	G	A	0	3	3	0	4	7	0	0
4	968121	.	T	C	4	7	11	0	0	11	0	0
4	969475	.	A	T	6	3	9	0	0	9	0	0
4	970689	.	A	G	6	0	6	0	5	11	0	0
4	971765	.	A	G	9	4	13	0	1	14	0	0
4	971842	.	G	C	1	5	6	0	8	14	0	0
4	974482	.	C	T	4	8	12	0	0	12	0	0
4	975735	.	G	C	1	8	9	0	21	30	0	0
4	975758	.	C	T	9	17	26	0	1	27	0	0
4	975792	.	G	C	0	7	7	0	9	16	0	0
4	975938	.	T	C	12	7	19	0	0	19	0	0
4	982892	.	G	A	5	13	18	0	1	19	0	0
4	982893	.	T	C	14	5	19	0	0	19	0	0
4	982938	.	C	G	9	4	13	0	0	13	0	0
4	1054775	.	G	A	15	20	35	0	2	37	0	0
4	1055008	.	C	T	31	16	47	0	1	48	0	0
4	1055081	.	C	T	25	7	32	0	3	35	0	0
4	1055095	.	T	A	25	8	33	0	3	36	0	0
4	1055149	.	A	G	18	9	27	0	1	28	0	0
4	1055200	.	A	G	16	7	23	1	5	29	0	0
4	1055454	.	T	G	35	21	56	0	5	61	0	0
4	1055526	.	T	C	23	18	41	4	3	48	0	0
4	1055671	.	G	A	21	21	42	0	1	43	0	0
4	1055724	.	C	T	22	15	37	0	3	40	0	0
4	1055770	.	A	G	23	7	30	0	4	34	0	0
4	1055807	.	G	C	21	10	31	1	4	36	0	0
4	1055831	.	T	A	24	5	29	1	3	33	0	0
4	1055863	.	A	T	23	13	36	1	4	41	0	0
4	1055868	.	G	A	30	8	38	1	4	43	0	0
4	1389028	.	A	G	13	6	19	0	1	20	0	0
4	1392957	.	G	A	6	3	9	0	0	9	0	0
4	1393004	.	T	A	1	4	5	0	1	6	0	0
4	1470672	.	T	C	3	1	4	0	4	8	0	0
4	1639944	.	T	C	6	7	13	1	2	16	0	0
4	1652192	.	C	T	0	13	13	0	5	18	0	0
4	2548965	.	T	C	11	4	15	0	0	15	0	0
4	2548968	.	T	C	7	7	14	0	1	15	0	0
4	3338195	.	A	G	1	3	4	0	1	5	0	0
4	3343611	.	C	A	1	2	3	0	0	3	0	0
4	4526251	.	G	A	1	6	7	0	0	7	0	0
4	4526366	.	T	A	1	2	3	0	0	3	0	0
4	4714437	.	G	A	2	2	4	0	0	4	0	0
4	4758178	.	C	T	1	3	4	0	1	5	0	0
4	5364939	.	T	C	1	2	3	0	0	3	0	0
4	5365307	.	C	T	5	2	7	2	0	9	0	0
4	5421883	.	A	C	1	1	2	1	4	7	0	0
4	5421895	.	T	G	3	3	6	1	0	7	0	0
4	5849754	.	A	G	9	6	15	0	0	15	0	0
4	5910137	.	A	G	1	6	7	0	0	7	0	0
4	6340579	.	T	A	1	2	3	0	1	4	0	0
4	6432112	.	G	A	11	13	24	0	0	25	1	0
4	6436701	.	G	A	13	16	29	0	1	30	0	0
4	6436845	.	G	A	6	12	18	0	0	18	0	0
4	6449366	.	G	A	5	4	9	0	0	9	0	0
4	6455849	.	G	A	4	2	6	0	0	6	0	0
4	6506457	.	G	A	0	3	3	0	3	6	0	0
4	6507418	.	C	T	3	4	7	0	0	7	0	0
4	6508193	.	A	G	4	4	8	1	1	10	0	0
4	6578209	.	A	T	1	3	4	0	0	4	0	0
4	6578272	.	A	C	1	2	3	0	0	3	0	0
4	6578273	.	C	T	1	2	3	0	0	3	0	0
4	6579603	.	A	G	2	2	4	0	0	4	0	0
4	6639440	.	A	G	16	8	24	0	0	24	0	0
4	6639665	.	G	A	11	14	25	0	1	26	0	0
4	6639786	.	C	T	4	12	16	0	0	16	0	0
4	6640145	.	G	C	12	12	24	0	1	25	0	0
4	6640156	.	T	C	12	14	26	0	2	28	0	0
4	6640342	.	C	A	1	2	3	0	1	4	0	0
4	6640350	.	T	G	1	2	3	0	1	4	0	0
4	6645994	.	C	T	16	11	27	0	0	27	0	0
4	6646283	.	A	C	9	7	16	0	2	18	0	0
4	6646851	.	G	A	12	8	20	0	1	21	0	0
4	6749054	.	T	C	4	6	10	0	1	11	0	0
4	6749060	.	C	G	4	6	10	0	0	10	0	0
4	6749222	.	C	T	2	5	7	0	0	7	0	0
4	6799942	.	A	G	31	20	51	0	2	53	0	0
4	6800153	.	T	C	19	22	41	0	0	41	0	0
4	6800162	.	C	T	20	27	47	0	1	48	0	0
4	6800393	.	G	A	24	31	55	0	4	59	0	0
4	6802173	.	T	G	25	24	49	0	2	51	0	0
4	6802506	.	A	C	28	21	49	0	1	50	0	0
4	6802518	.	C	G	2	19	21	0	24	45	0	0
4	6940374	.	C	T	2	3	5	0	0	5	0	0
4	6948909	.	C	T	2	2	4	0	0	4	0	0
4	6948918	.	C	A	2	2	4	0	0	4	0	0
4	6960365	.	G	A	0	3	3	0	3	6	0	0
4	6989731	.	G	A	1	7	8	0	8	16	0	0
4	6990096	.	C	T	15	5	20	0	0	20	0	0
4	6990392	.	G	T	1	5	6	0	0	6	0	0
4	6990421	.	T	C	2	4	6	0	0	6	0	0
4	6990621	.	G	A	0	12	12	0	3	15	0	0
4	6990682	.	G	A	2	5	7	0	0	7	0	0
4	6990882	.	C	T	3	6	9	0	1	10	0	0
4	6990886	.	C	A	5	3	8	0	2	10	0	0
4	6991220	.	T	A	4	9	13	0	0	13	0	0
4	6991272	.	G	A	7	3	10	0	0	10	0	0
4	6991480	.	T	G	10	5	15	0	0	15	0	0
4	6991582	.	C	A	6	11	17	0	0	17	0	0
4	6991764	.	G	T	12	5	17	0	0	17	0	0
4	6991825	.	C	A	10	6	16	0	1	17	0	0
4	6991975	.	T	A	12	7	19	0	3	22	0	0
4	6992348	.	C	A	15	18	33	0	1	34	0	0
4	6992808	.	T	C	12	15	27	0	2	29	0	0
4	6992918	.	G	C	14	15	29	0	2	31	0	0
4	7211013	.	G	A	19	20	39	0	1	40	0	0
4	7211097	.	C	T	18	13	31	1	2	34	0	0
4	7211264	.	A	G	14	19	33	0	0	33	0	0
4	7211364	.	C	T	2	13	15	0	10	25	0	0
4	7212228	.	G	A	6	3	9	0	0	9	0	0
4	7212236	.	G	A	5	3	8	0	0	8	0	0
4	7212342	.	G	A	2	2	4	0	1	5	0	0
4	7212461	.	G	A	6	4	10	0	0	10	0	0
4	7212606	.	A	G	7	5	12	0	2	14	0	0
4	7212624	.	G	A	8	4	12	0	1	13	0	0
4	7471682	.	A	T	1	2	3	0	0	3	0	0
4	7549361	.	G	A	0	9	9	0	4	13	0	0
4	7652726	.	G	A	1	4	5	5	0	10	0	0
4	7659049	.	C	T	2	3	5	0	0	5	0	0
4	7668432	.	G	A	2	3	5	0	0	5	0	0
4	7713041	.	A	G	7	0	7	1	4	12	0	0
4	7713070	.	T	C	3	3	6	0	0	6	0	0
4	7713176	.	C	T	4	2	6	0	0	6	0	0
4	7713309	.	A	G	3	3	6	0	0	6	0	0
4	7713360	.	C	A	2	2	4	0	1	5	0	0
4	7718868	.	C	T	7	7	14	0	1	15	0	0
4	7726665	.	G	A	1	2	3	0	0	3	0	0
4	7729807	.	G	A	1	7	8	0	0	8	0	0
4	7743092	.	C	T	0	2	2	0	2	4	0	0
4	8046099	.	C	T	21	3	24	0	1	25	0	0
4	8609608	.	T	A	1	11	12	0	4	16	0	0
4	9460908	.	C	T	1	7	8	0	0	8	0	0
4	9603488	.	T	C	7	3	10	0	1	11	0	0
4	9618867	.	A	C	16	9	25	0	1	26	0	0
4	9637367	.	C	T	2	2	4	0	0	4	0	0
4	9637368	.	T	G	2	2	4	0	0	4	0	0
4	9785985	.	C	T	1	3	4	0	0	4	0	0
4	9999865	.	T	G	7	3	10	0	1	11	0	0
4	10044556	.	G	A	18	13	31	0	4	35	0	0
4	10044605	.	C	T	17	15	32	0	1	33	0	0
4	10044777	.	A	G	19	16	35	0	1	36	0	0
4	10045599	.	C	T	14	13	27	0	2	29	0	0
4	10045605	.	A	G	15	14	29	0	1	30	0	0
4	10124153	.	A	C	1	2	3	0	0	3	0	0
4	10124237	.	G	A	1	1	2	0	1	3	0	0
4	10128770	.	G	A	1	2	3	0	0	3	0	0
4	10128773	.	T	C	1	3	4	0	0	4	0	0
4	10128809	.	C	T	1	3	4	0	0	4	0	0
4	10128828	.	A	C	1	3	4	0	0	4	0	0
4	10130239	.	C	A	1	5	6	0	0	6	0	0
4	10366710	.	G	A	1	2	3	0	0	3	0	0
4	10367562	.	C	T	3	2	5	0	0	5	0	0
4	10553452	.	C	T	7	6	13	0	0	13	0	0
4	10553515	.	C	A	3	3	6	0	0	6	0	0
4	10553528	.	G	A	2	3	5	0	1	6	0	0
4	10558403	.	G	A	1	3	4	0	3	7	0	0
4	10558510	.	T	C	4	2	6	0	0	6	0	0
4	10559042	.	A	T	6	3	9	0	0	9	0	0
4	10559088	.	C	A	10	4	14	1	0	15	0	0
4	10559621	.	C	A	4	3	7	0	0	7	0	0
4	10560246	.	G	A	12	12	24	0	0	24	0	0
4	10560253	.	A	T	9	12	21	0	2	23	0	0
4	10560284	.	C	T	11	16	27	0	0	27	0	0
4	10560437	.	A	C	12	15	27	0	2	29	0	0
4	10560507	.	C	T	11	9	20	0	1	21	0	0
4	10560607	.	A	G	5	9	14	0	0	14	0	0
4	10560916	.	C	T	12	11	23	0	2	25	0	0
4	10612052	.	T	G	8	0	8	0	11	19	0	0
4	10614856	.	T	C	8	8	16	0	2	18	0	0
4	10614862	.	T	C	9	6	15	0	2	17	0	0
4	10713426	.	C	T	1	3	4	0	0	4	0	0
4	10756943	.	A	G	0	2	2	0	1	3	0	0
4	10761803	.	C	G	1	0	1	0	6	7	0	0
4	10762087	.	G	A	1	6	7	0	1	8	0	0
4	10812042	.	C	G	1	4	5	0	1	6	0	0
4	10813929	.	T	C	5	0	5	0	3	8	0	0
4	10825618	.	G	A	4	2	6	0	0	6	0	0
4	10825629	.	G	A	3	2	5	0	0	5	0	0
4	10896354	.	G	C	2	2	4	0	0	4	0	0
4	10904784	.	C	T	5	5	10	0	0	10	0	0
4	10905246	.	C	T	6	6	12	0	2	14	0	0
4	10906254	.	C	T	9	5	14	0	0	14	0	0
4	10907182	.	C	A	3	2	5	0	2	7	0	0
4	10908001	.	C	T	12	10	22	0	1	23	0	0
4	10908182	.	T	C	8	6	14	0	0	14	0	0
4	10908294	.	C	T	8	6	14	0	1	15	0	0
4	10908726	.	T	C	8	9	17	0	0	17	0	0
4	10974722	.	G	A	7	3	10	0	0	10	0	0
4	10974747	.	A	T	3	4	7	0	0	7	0	0
4	10975629	.	A	G	4	6	10	0	0	10	0	0
4	10975632	.	G	A	4	6	10	0	0	10	0	0
4	10976944	.	G	A	3	8	11	0	0	11	0	0
4	10982291	.	C	T	4	8	12	0	0	12	0	0
4	10982339	.	T	G	4	3	7	0	0	7	0	0
4	10982390	.	C	A	0	5	5	0	7	12	0	0
4	10987895	.	T	A	2	2	4	0	0	4	0	0
4	10988546	.	G	C	2	4	6	0	0	6	0	0
4	10988581	.	C	T	1	5	6	0	3	9	0	0
4	10994841	.	G	A	2	2	4	0	0	4	0	0
4	11053771	.	G	A	1	5	6	0	2	8	0	0
4	11053851	.	G	A	0	5	5	0	6	11	0	0
4	11054484	.	A	C	2	6	8	0	0	8	0	0
4	11054509	.	G	C	7	5	12	0	0	12	0	0
4	11358626	.	C	T	2	3	5	0	0	5	0	0
4	11366360	.	T	C	10	6	16	0	0	16	0	0
4	11366481	.	G	A	8	6	14	0	1	15	0	0
4	11367668	.	T	A	15	5	20	2	2	24	0	0
4	11367952	.	T	C	6	7	13	0	0	13	0	0
4	11368056	.	A	T	17	18	35	0	2	37	0	0
4	11368076	.	G	T	21	21	42	0	0	42	0	0
4	11368171	.	G	A	3	18	21	0	14	35	0	0
4	11368432	.	A	T	4	5	9	0	0	9	0	0
4	11416701	.	C	T	1	2	3	0	0	3	0	0
4	11419062	.	G	A	2	2	4	0	0	4	0	0
4	11419071	.	G	A	0	2	2	0	2	4	0	0
4	11419163	.	C	G	2	2	4	0	0	4	0	0
4	11420005	.	A	T	4	4	8	0	1	9	0	0
4	11421575	.	C	T	3	5	8	0	0	8	0	0
4	11422121	.	C	T	7	5	12	0	0	12	0	0
4	11425839	.	G	T	9	8	17	0	1	18	0	0
4	11439544	.	C	A	6	3	9	0	0	9	0	0
4	11444080	.	C	T	19	14	33	0	0	33	0	0
4	11446078	.	A	G	14	19	33	0	5	38	0	0
4	11446365	.	A	T	21	16	37	0	1	38	0	0
4	11446844	.	A	G	16	7	23	0	0	23	0	0
4	11447135	.	T	C	23	19	42	0	0	42	0	0
4	11447144	.	G	A	16	17	33	0	4	37	0	0
4	11447226	.	T	G	21	1	22	0	15	37	0	0
4	11447251	.	T	C	19	12	31	0	1	32	0	0
4	11447719	.	T	G	20	24	44	0	1	45	0	0
4	11448296	.	A	T	16	20	36	0	2	38	0	0
4	11448403	.	G	A	1	22	23	0	24	47	0	0
4	11458171	.	G	T	1	3	4	0	6	10	0	0
4	11458318	.	T	G	6	5	11	0	0	11	0	0
4	11461181	.	C	G	1	5	6	0	0	6	0	0
4	11464390	.	A	G	13	10	23	0	0	23	0	0
4	11470854	.	A	G	7	5	12	0	3	15	0	0
4	11471203	.	T	C	9	8	17	0	1	18	0	0
4	11472674	.	T	C	17	13	30	0	3	33	0	0
4	11476472	.	G	A	2	29	31	0	25	56	0	0
4	11476487	.	C	T	28	28	56	0	1	57	0	0
4	11476740	.	C	T	20	37	57	0	4	61	0	0
4	11476868	.	C	G	32	22	54	0	2	56	0	0
4	11476945	.	C	T	32	27	59	0	1	60	0	0
4	11477047	.	T	A	37	25	62	0	3	65	0	0
4	11477377	.	C	T	47	14	61	0	3	64	0	0
4	11480649	.	T	C	11	5	16	0	0	16	0	0
4	11480824	.	C	A	12	4	16	0	0	16	0	0
4	11480866	.	C	T	8	13	21	0	1	22	0	0
4	11482235	.	G	A	1	7	8	0	5	13	0	0
4	11482259	.	G	A	9	4	13	0	1	14	0	0
4	11482358	.	T	G	10	9	19	0	1	20	0	0
4	11482367	.	C	G	10	9	19	0	0	19	0	0
4	11482668	.	T	A	17	10	27	0	0	27	0	0
4	11573837	.	C	T	1	2	3	0	2	5	0	0
4	11712653	.	C	T	2	3	5	0	0	5	0	0
4	11712704	.	G	T	0	4	4	0	2	6	0	0
4	11712794	.	T	C	2	2	4	0	0	4	0	0
4	11721731	.	C	T	3	4	7	0	0	7	0	0
4	11726366	.	T	A	3	3	6	0	0	6	0	0
4	11728959	.	G	A	2	9	11	0	6	17	0	0
4	11729719	.	G	A	5	4	9	0	2	11	0	0
4	11730159	.	G	C	8	11	19	0	2	21	0	0
4	11730515	.	C	A	10	9	19	0	1	20	0	0
4	11732213	.	G	A	3	3	6	0	0	6	0	0
4	11732222	.	G	A	3	4	7	0	0	7	0	0
4	11732589	.	T	C	6	9	15	0	0	15	0	0
4	11732590	.	T	C	6	9	15	0	0	15	0	0
4	11732956	.	A	G	8	2	10	0	1	11	0	0
4	11732975	.	G	A	6	2	8	0	2	10	0	0
4	11733201	.	T	A	3	2	5	0	0	5	0	0
4	11733222	.	C	T	3	5	8	0	0	8	0	0
4	11733357	.	C	A	4	3	7	0	0	7	0	0
4	11733545	.	T	C	6	0	6	0	6	12	0	0
4	11733573	.	G	A	6	6	12	0	0	12	0	0
4	11733726	.	A	C	4	4	8	0	0	8	0	0
4	11733778	.	C	A	1	4	5	0	2	7	0	0
4	11733830	.	G	A	3	3	6	0	0	6	0	0
4	11734001	.	A	T	4	2	6	0	1	7	0	0
4	11734196	.	A	T	3	2	5	0	0	5	0	0
4	11734490	.	T	C	1	3	4	0	0	4	0	0
4	11734696	.	C	G	4	3	7	0	0	7	0	0
4	11765871	.	C	T	1	3	4	4	2	10	0	0
4	11804940	.	G	A	7	3	10	0	0	10	0	0
4	11806934	.	G	A	6	7	13	0	2	15	0	0
4	11806965	.	G	C	6	10	16	0	1	17	0	0
4	11814022	.	A	G	23	15	38	0	0	38	0	0
4	11814055	.	C	T	2	24	26	0	19	45	0	0
4	11814074	.	T	A	23	23	46	0	3	49	0	0
4	11814429	.	A	T	5	20	25	0	0	25	0	0
4	11814456	.	A	G	16	7	23	0	0	23	0	0
4	11814471	.	G	A	8	10	18	0	1	19	0	0
4	11814494	.	C	T	8	10	18	0	1	19	0	0
4	11814565	.	A	T	13	7	20	0	1	21	0	0
4	11814684	.	C	T	13	5	18	0	0	18	0	0
4	11814723	.	A	C	15	10	25	0	0	25	0	0
4	11815137	.	G	T	16	10	26	0	1	27	0	0
4	11815143	.	C	G	14	10	24	0	1	25	0	0
4	11815324	.	A	C	14	11	25	0	0	25	0	0
4	11816535	.	T	C	3	0	3	0	4	7	0	0
4	11818347	.	G	A	4	8	12	0	0	12	0	0
4	11818353	.	A	G	6	7	13	0	0	13	0	0
4	11827171	.	C	T	2	3	5	0	0	5	0	0
4	11841949	.	T	A	2	1	3	0	2	5	0	0
4	12006542	.	G	A	1	2	3	0	0	3	0	0
4	12013470	.	T	G	2	5	7	0	1	8	0	0
4	12020936	.	C	T	7	11	18	0	0	18	0	0
4	12021120	.	C	T	11	10	21	0	0	21	0	0
4	12021703	.	C	T	13	7	20	0	1	21	0	0
4	12021748	.	G	T	1	11	12	0	20	32	0	0
4	12022108	.	A	G	13	0	13	0	9	22	0	0
4	12022444	.	T	C	11	19	30	0	1	31	0	0
4	12023445	.	A	C	19	14	33	0	5	38	0	0
4	12025771	.	G	A	40	13	53	1	2	56	0	0
4	12026098	.	G	A	10	4	14	0	0	14	0	0
4	12026286	.	A	T	18	25	43	0	0	43	0	0
4	12026305	.	T	C	16	20	36	0	4	40	0	0
4	12026369	.	G	T	6	15	21	0	1	22	0	0
4	12026429	.	C	A	11	12	23	0	1	24	0	0
4	12026488	.	T	C	1	5	6	0	3	9	0	0
4	12080673	.	C	T	4	4	8	0	0	8	0	0
4	12080911	.	T	G	6	7	13	0	2	15	0	0
4	12087262	.	G	C	1	0	1	0	3	4	0	0
4	12091104	.	G	T	1	3	4	0	0	4	0	0
4	12103535	.	G	A	2	3	5	0	1	6	0	0
4	12103619	.	T	C	6	0	6	0	6	12	0	0
4	12103840	.	G	T	5	4	9	0	0	9	0	0
4	12103846	.	A	T	5	3	8	0	1	9	0	0
4	12103911	.	A	T	5	8	13	0	1	14	0	0
4	12103964	.	T	A	12	13	25	0	0	25	0	0
4	12106000	.	G	C	2	0	2	0	7	9	0	0
4	12111399	.	G	A	1	3	4	0	0	4	0	0
4	12230029	.	C	T	3	3	6	0	3	9	0	0
4	12230509	.	C	A	3	3	6	0	0	6	0	0
4	12230510	.	T	C	3	3	6	0	0	6	0	0
4	12230665	.	C	T	5	4	9	0	0	9	0	0
4	12230698	.	C	T	4	2	6	0	0	6	0	0
4	12230713	.	T	C	4	2	6	0	1	7	0	0
4	12230890	.	T	A	2	3	5	0	0	5	0	0
4	12230909	.	G	A	2	5	7	0	0	7	0	0
4	12231328	.	A	T	3	7	10	0	0	10	0	0
4	12231751	.	A	C	1	3	4	0	0	4	0	0
4	12231789	.	C	A	4	5	9	0	0	9	0	0
4	12232164	.	C	G	3	5	8	0	1	9	0	0
4	12232253	.	G	T	7	6	13	0	0	13	0	0
4	12232254	.	C	T	6	6	12	0	0	12	0	0
4	12232323	.	A	T	4	3	7	0	0	7	0	0
4	12232328	.	A	T	4	3	7	0	0	7	0	0
4	12232415	.	G	T	5	6	11	0	0	11	0	0
4	12232435	.	T	G	4	0	4	0	3	7	0	0
4	12232480	.	G	T	2	1	3	0	1	4	0	0
4	12232509	.	C	T	2	2	4	0	0	4	0	0
4	12232614	.	A	C	4	7	11	0	0	11	0	0
4	12232644	.	A	T	6	5	11	0	0	11	0	0
4	12232737	.	G	A	2	4	6	0	1	7	0	0
4	12232746	.	T	C	1	3	4	0	1	5	0	0
4	12232958	.	T	C	2	3	5	0	1	6	0	0
4	12233125	.	T	A	5	3	8	0	0	8	0	0
4	12233220	.	C	T	3	4	7	0	0	7	0	0
4	12233252	.	A	T	3	5	8	0	1	9	0	0
4	12233450	.	C	A	1	3	4	0	0	4	0	0
4	12233651	.	A	T	2	2	4	1	0	5	0	0
4	12233728	.	G	T	4	5	9	0	0	9	0	0
4	12233908	.	A	C	6	8	14	1	0	15	0	0
4	12234267	.	G	C	2	4	6	1	0	7	0	0
4	12234269	.	T	A	2	4	6	1	0	7	0	0
4	12234398	.	T	G	5	5	10	1	0	11	0	0
4	12234458	.	C	T	2	5	7	0	0	7	0	0
4	12234599	.	A	G	7	4	11	0	0	11	0	0
4	12234670	.	A	G	7	0	7	0	7	14	0	0
4	12234755	.	C	A	7	7	14	0	0	14	0	0
4	12234792	.	A	G	9	7	16	0	1	17	0	0
4	12234828	.	C	T	7	12	19	0	1	20	0	0
4	12234955	.	C	T	6	17	23	0	1	24	0	0
4	12235677	.	T	C	5	11	16	0	2	18	0	0
4	12235722	.	A	G	6	11	17	0	0	17	0	0
4	12235770	.	T	C	5	12	17	0	0	17	0	0
4	12235987	.	T	G	8	5	13	1	0	14	0	0
4	12236171	.	G	A	17	15	32	1	1	34	0	0
4	12236178	.	T	G	18	12	30	1	2	33	0	0
4	12236429	.	T	A	12	11	23	1	1	26	1	0
4	12236495	.	A	G	12	0	12	0	8	20	0	0
4	12236519	.	A	G	15	11	26	0	0	26	0	0
4	12236584	.	C	T	9	4	13	0	2	15	0	0
4	12236641	.	A	G	11	6	17	0	0	17	0	0
4	12236667	.	C	A	8	5	13	0	3	16	0	0
4	12236740	.	A	C	2	2	4	0	0	4	0	0
4	12237030	.	T	A	0	1	1	0	2	3	0	0
4	12237337	.	T	C	4	5	9	0	0	9	0	0
4	12237340	.	G	A	5	5	10	0	0	10	0	0
4	12237490	.	C	A	25	10	35	0	0	35	0	0
4	12237689	.	C	A	13	12	25	0	1	27	1	0
4	12237849	.	C	T	14	10	24	0	2	26	0	0
4	12238161	.	C	T	10	18	28	0	4	32	0	0
4	12238418	.	C	T	32	15	47	0	0	47	0	0
4	12238711	.	G	A	15	15	30	1	0	31	0	0
4	12238800	.	G	A	6	2	8	0	1	9	0	0
4	12238904	.	G	A	9	8	17	0	0	17	0	0
4	12238956	.	G	A	24	13	37	1	7	45	0	0
4	12243754	.	T	G	2	3	5	1	1	7	0	0
4	12243881	.	T	G	7	12	19	0	3	22	0	0
4	12243930	.	T	C	10	4	14	0	0	14	0	0
4	12244071	.	T	C	18	9	27	0	1	28	0	0
4	12244099	.	T	C	24	13	37	0	2	39	0	0
4	12244153	.	T	A	18	17	35	0	1	36	0	0
4	12244258	.	T	C	11	13	24	0	1	25	0	0
4	12244322	.	C	T	16	9	25	0	1	26	0	0
4	12244607	.	C	T	0	6	6	0	5	11	0	0
4	12245058	.	G	A	11	6	17	0	1	18	0	0
4	12245546	.	T	G	5	0	5	0	12	17	0	0
4	12245555	.	T	G	4	1	5	0	15	20	0	0
4	12245584	.	A	G	13	11	24	0	0	24	0	0
4	12265268	.	T	A	5	8	13	0	0	13	0	0
4	12265337	.	T	C	3	0	3	0	7	10	0	0
4	12269050	.	T	C	4	0	4	0	4	8	0	0
4	12312634	.	T	C	2	2	4	0	1	5	0	0
4	12312670	.	C	A	1	5	6	0	0	6	0	0
4	12312712	.	C	T	4	2	6	0	1	7	0	0
4	12312717	.	T	G	4	2	6	0	1	7	0	0
4	12317636	.	T	G	6	3	9	0	3	12	0	0
4	12317674	.	A	T	3	4	7	0	0	7	0	0
4	12381781	.	G	A	4	8	12	0	2	14	0	0
4	12381900	.	T	C	7	7	14	0	0	14	0	0
4	12381930	.	G	A	6	9	15	0	0	15	0	0
4	12382076	.	A	G	15	12	27	0	4	31	0	0
4	12382234	.	C	T	13	8	21	0	0	21	0	0
4	12382336	.	T	G	17	9	26	0	3	29	0	0
4	12382433	.	G	C	6	6	12	0	4	16	0	0
4	12382673	.	A	T	9	6	15	0	1	16	0	0
4	12382871	.	G	A	13	11	24	0	2	26	0	0
4	12382889	.	T	G	15	9	24	0	1	26	1	0
4	12382943	.	T	G	11	13	24	0	2	26	0	0
4	12383030	.	C	T	16	13	29	0	1	30	0	0
4	12383081	.	C	T	18	15	33	0	2	35	0	0
4	12384831	.	A	G	14	14	28	1	1	30	0	0
4	12384840	.	G	A	14	13	27	1	0	28	0	0
4	12384873	.	C	G	1	8	9	1	12	22	0	0
4	12388419	.	T	C	8	6	14	0	1	15	0	0
4	12679190	.	C	T	2	2	4	0	3	7	0	0
4	13755907	.	A	G	28	11	39	0	3	42	0	0
4	14992499	.	T	C	10	3	13	0	0	13	0	0
4	14992553	.	T	C	14	0	14	0	7	21	0	0
4	14992569	.	T	C	10	7	17	0	1	18	0	0
4	16319377	.	C	T	6	4	10	0	0	10	0	0
4	16319839	.	T	A	5	3	8	0	1	9	0	0
4	16319954	.	T	C	1	3	4	0	0	4	0	0
4	16319961	.	T	C	1	1	2	0	2	4	0	0
4	16368805	.	T	C	10	0	10	0	12	22	0	0
4	16368977	.	G	A	4	13	17	0	0	17	0	0
4	16369033	.	T	A	9	5	14	0	1	15	0	0
4	16369335	.	T	C	15	0	15	0	9	24	0	0
4	16369375	.	G	C	10	8	18	0	0	18	0	0
4	16369384	.	T	C	7	9	16	0	2	18	0	0
4	16369440	.	C	T	4	6	10	0	1	11	0	0
4	16369486	.	T	C	3	3	6	0	0	6	0	0
4	16369576	.	T	A	1	2	3	0	0	3	0	0
4	16536946	.	C	A	21	13	34	0	1	35	0	0
4	16537045	.	T	C	27	10	37	0	9	46	0	0
4	16537099	.	A	T	34	15	49	0	3	52	0	0
4	16537575	.	T	G	31	19	50	0	0	50	0	0
4	16537770	.	G	A	24	26	50	0	3	53	0	0
4	16538055	.	T	A	13	11	24	0	2	26	0	0
4	16539253	.	A	G	18	17	35	0	3	38	0	0
4	16615212	.	A	C	2	0	2	0	4	6	0	0
4	16615258	.	C	T	2	4	6	0	0	6	0	0
4	16632415	.	G	A	9	5	14	0	2	16	0	0
4	16632650	.	A	T	16	8	24	0	1	25	0	0
4	16632762	.	A	T	6	13	19	2	0	21	0	0
4	16632907	.	T	A	4	4	8	0	1	9	0	0
4	16633208	.	C	T	8	6	14	0	1	15	0	0
4	16633448	.	T	C	6	5	11	0	2	13	0	0
4	16634916	.	A	G	8	3	11	0	0	11	0	0
4	16634929	.	A	T	4	3	7	0	1	8	0	0
4	16635088	.	G	A	4	3	7	0	1	8	0	0
4	16635162	.	G	A	6	3	9	0	0	9	0	0
4	16635208	.	G	A	7	9	16	0	0	16	0	0
4	16635326	.	T	C	8	0	8	0	7	15	0	0
4	16635426	.	A	G	3	3	6	0	2	8	0	0
4	16635460	.	T	A	2	3	5	0	1	6	0	0
4	16635710	.	T	C	4	6	10	0	0	10	0	0
4	16641677	.	T	C	2	3	5	0	2	7	0	0
4	16649730	.	T	A	16	6	22	0	1	23	0	0
4	16650102	.	T	C	12	9	21	0	1	22	0	0
4	16650142	.	A	T	10	9	19	0	2	21	0	0
4	16650433	.	A	C	13	15	28	0	2	30	0	0
4	16650482	.	T	C	8	15	23	0	0	23	0	0
4	16650611	.	T	G	12	11	23	0	1	24	0	0
4	16650618	.	A	G	9	13	22	0	2	24	0	0
4	16651046	.	G	C	10	3	13	0	1	14	0	0
4	16651121	.	A	G	11	5	16	0	0	16	0	0
4	16651414	.	G	A	11	8	19	0	1	20	0	0
4	16652890	.	A	G	6	12	18	0	0	18	0	0
4	16654337	.	G	C	10	9	19	0	1	20	0	0
4	16654349	.	C	T	1	5	6	0	12	18	0	0
4	16659679	.	G	A	7	4	11	0	0	11	0	0
4	16666267	.	C	T	5	2	7	0	0	7	0	0
4	16671133	.	T	C	4	6	10	0	0	10	0	0
4	16671232	.	C	T	0	4	4	0	2	6	0	0
4	16672481	.	G	T	2	4	6	0	0	6	0	0
4	16672771	.	C	T	4	6	10	0	1	11	0	0
4	16680671	.	T	G	1	2	3	0	0	3	0	0
4	16680674	.	T	G	1	2	3	0	0	3	0	0
4	16720346	.	C	T	1	2	3	0	0	3	0	0
4	16733585	.	G	A	2	3	5	0	0	5	0	0
4	16733984	.	C	T	6	4	10	0	0	10	0	0
4	16741979	.	T	G	7	9	16	0	1	17	0	0
4	16742444	.	G	C	10	15	25	0	0	25	0	0
4	16768990	.	C	T	2	2	4	9	0	13	0	0
4	16784840	.	G	T	19	18	37	0	1	38	0	0
4	16784876	.	C	T	16	18	34	0	2	36	0	0
4	16785393	.	A	G	17	19	36	0	0	36	0	0
4	16785664	.	A	T	23	8	31	0	1	32	0	0
4	16785766	.	T	C	10	7	17	0	2	19	0	0
4	16786002	.	C	A	6	3	9	0	1	10	0	0
4	16786018	.	A	T	6	5	11	0	0	11	0	0
4	16786059	.	T	C	3	8	11	0	0	11	0	0
4	16786077	.	G	A	3	8	11	0	0	11	0	0
4	16786208	.	C	T	2	14	16	0	2	18	0	0
4	16788485	.	C	T	1	2	3	0	0	3	0	0
4	16788500	.	G	A	0	1	1	0	2	3	0	0
4	16791616	.	G	A	7	8	15	0	0	15	0	0
4	16791673	.	C	A	10	4	14	0	0	14	0	0
4	16791780	.	A	G	12	0	12	0	5	17	0	0
4	16791781	.	G	C	10	5	15	0	2	17	0	0
4	16791883	.	T	A	6	3	9	0	2	11	0	0
4	16791934	.	C	T	5	3	8	0	4	12	0	0
4	16797045	.	A	G	1	3	4	0	1	5	0	0
4	16797248	.	C	T	1	2	3	0	0	3	0	0
4	16829355	.	T	C	37	33	70	0	5	75	0	0
4	16829387	.	T	G	33	32	65	0	1	66	0	0
4	16829651	.	G	A	30	33	63	0	8	71	0	0
4	16831399	.	A	T	39	24	63	0	4	67	0	0
4	16832124	.	C	A	3	17	20	0	17	37	0	0
4	16832894	.	G	A	16	24	40	0	5	45	0	0
4	16858074	.	A	T	3	4	7	0	0	7	0	0
4	16858075	.	A	G	3	4	7	0	0	7	0	0
4	16858289	.	G	C	7	0	7	0	12	19	0	0
4	16858414	.	A	T	5	3	8	0	0	8	0	0
4	16858442	.	C	G	0	3	3	0	3	6	0	0
4	16876153	.	T	C	2	4	6	0	0	6	0	0
4	16877387	.	C	T	1	15	16	0	22	38	0	0
4	16879505	.	T	C	16	0	16	0	20	36	0	0
4	16881865	.	T	G	17	12	29	0	1	30	0	0
4	16885898	.	A	T	7	2	9	0	0	9	0	0
4	16889709	.	C	T	1	5	6	0	1	7	0	0
4	16893062	.	T	C	1	2	3	0	0	3	0	0
4	16898904	.	A	T	3	10	13	0	1	14	0	0
4	16899273	.	T	C	11	13	24	0	2	26	0	0
4	16904521	.	C	G	11	23	34	0	3	37	0	0
4	16904527	.	A	G	14	4	18	0	21	39	0	0
4	16905090	.	T	C	13	14	27	0	2	29	0	0
4	16905119	.	T	C	10	21	31	0	1	32	0	0
4	16905184	.	T	C	12	18	30	0	2	32	0	0
4	16905224	.	A	G	10	15	25	0	2	27	0	0
4	16905318	.	G	A	12	16	28	4	0	32	0	0
4	16905370	.	G	A	12	8	20	0	0	20	0	0
4	16905410	.	C	A	7	4	11	0	0	11	0	0
4	16905511	.	C	T	12	4	16	0	3	19	0	0
4	16905684	.	T	G	12	16	28	0	2	30	0	0
4	16905708	.	T	A	14	19	33	0	1	34	0	0
4	16905723	.	C	A	13	18	31	0	4	35	0	0
4	16905853	.	T	A	20	14	34	0	1	35	0	0
4	16906173	.	C	A	21	19	40	0	4	44	0	0
4	16906198	.	C	A	22	19	41	0	3	44	0	0
4	16906244	.	A	T	16	26	42	0	3	45	0	0
4	16906562	.	G	A	27	21	48	0	3	51	0	0
4	16982269	.	G	A	20	18	38	0	1	39	0	0
4	16982682	.	C	A	12	14	26	0	1	27	0	0
4	16983131	.	A	G	7	4	11	0	0	11	0	0
4	16983183	.	G	A	5	5	10	0	0	10	0	0
4	16983434	.	T	C	18	1	19	0	16	36	1	0
4	16984252	.	C	G	8	6	14	0	1	15	0	0
4	16984542	.	A	G	10	3	13	2	4	19	0	0
4	16985045	.	C	T	3	3	6	0	2	8	0	0
4	16988139	.	A	G	6	8	14	0	0	14	0	0
4	17008995	.	A	G	2	3	5	0	0	5	0	0
4	17253737	.	A	G	6	7	13	0	0	13	0	0
4	17253758	.	C	T	7	6	13	0	0	13	0	0
4	17253813	.	A	C	6	4	10	0	1	11	0	0
4	17253818	.	A	G	6	3	9	0	1	10	0	0
4	17253925	.	T	A	16	7	23	0	1	24	0	0
4	17253927	.	T	A	17	7	24	0	0	24	0	0
4	17254046	.	A	G	13	18	31	0	0	31	0	0
4	17256855	.	C	T	9	8	17	0	0	17	0	0
4	17257386	.	G	A	7	10	17	0	1	18	0	0
4	17257458	.	C	T	7	9	16	0	0	16	0	0
4	17260535	.	G	A	7	3	10	0	0	10	0	0
4	17287446	.	T	G	5	8	13	0	0	13	0	0
4	17288964	.	T	C	11	22	33	0	1	34	0	0
4	17291024	.	A	G	7	12	19	0	1	20	0	0
4	17292575	.	C	A	20	14	34	0	1	35	0	0
4	17292770	.	G	A	29	14	43	0	2	45	0	0
4	17292789	.	A	C	31	17	48	0	3	51	0	0
4	17292837	.	A	G	21	21	42	0	6	48	0	0
4	17294947	.	T	C	17	27	44	0	1	45	0	0
4	17296974	.	A	G	9	10	19	0	7	26	0	0
4	17297086	.	C	A	14	19	33	0	1	34	0	0
4	17297338	.	T	G	14	9	23	0	0	23	0	0
4	17336624	.	C	T	1	2	3	0	1	4	0	0
4	17336693	.	G	A	6	2	8	0	0	8	0	0
4	17337593	.	A	T	4	4	8	0	0	8	0	0
4	17353770	.	G	C	2	1	3	0	1	4	0	0
4	17353776	.	A	C	2	2	4	0	0	4	0	0
4	17369451	.	T	C	1	3	4	0	2	6	0	0
4	17370354	.	G	A	1	2	3	0	5	8	0	0
4	17370355	.	A	T	6	2	8	0	0	8	0	0
4	17382878	.	G	A	8	6	14	0	0	14	0	0
4	17383774	.	G	C	1	3	4	0	1	5	0	0
4	17384624	.	A	T	2	3	5	0	0	5	0	0
4	17417668	.	T	G	5	0	5	0	4	9	0	0
4	17417692	.	C	T	5	4	9	0	0	9	0	0
4	17418109	.	G	A	5	3	8	0	1	9	0	0
4	17528599	.	G	A	1	3	4	0	0	4	0	0
4	17533769	.	C	T	2	3	5	0	0	5	0	0
4	17534198	.	A	G	3	0	3	0	3	6	0	0
4	17536140	.	T	G	1	3	4	0	0	4	0	0
4	17537639	.	A	G	9	5	14	0	0	14	0	0
4	17537939	.	G	T	2	5	7	0	8	15	0	0
4	17541666	.	A	G	3	3	6	0	0	6	0	0
4	17541730	.	G	A	3	6	9	0	0	9	0	0
4	17545083	.	A	G	11	0	11	0	12	23	0	0
4	17572583	.	C	T	22	8	30	0	3	33	0	0
4	17572589	.	C	A	21	9	30	0	1	31	0	0
4	17572898	.	T	C	15	13	28	1	3	32	0	0
4	17572901	.	A	C	15	14	29	1	1	31	0	0
4	17573071	.	A	T	9	11	20	0	0	20	0	0
4	17573081	.	G	C	9	9	18	0	0	18	0	0
4	17573464	.	A	G	9	8	17	0	0	17	0	0
4	17573465	.	A	G	8	7	15	0	2	17	0	0
4	17573594	.	T	A	11	7	18	0	1	19	0	0
4	17573616	.	A	G	11	4	15	0	1	16	0	0
4	17573697	.	G	A	11	4	15	1	0	16	0	0
4	17573706	.	A	G	10	4	14	1	0	15	0	0
4	17573802	.	T	C	13	13	26	0	3	29	0	0
4	17573841	.	A	G	12	15	27	0	1	28	0	0
4	17573865	.	T	A	9	16	25	0	2	27	0	0
4	17573959	.	T	A	13	7	20	1	0	21	0	0
4	17573982	.	A	T	7	8	15	1	1	17	0	0
4	17574093	.	A	G	14	9	23	0	1	24	0	0
4	17574390	.	C	T	14	6	20	0	0	20	0	0
4	17574608	.	A	C	8	6	14	0	0	14	0	0
4	17580468	.	A	T	10	10	20	0	0	20	0	0
4	17596433	.	T	C	5	1	6	0	16	22	0	0
4	17596490	.	T	C	8	9	17	0	0	17	0	0
4	17629266	.	C	A	5	2	7	0	0	7	0	0
4	17636575	.	C	T	3	2	5	0	0	5	0	0
4	17636616	.	C	T	1	2	3	0	1	4	0	0
4	17643448	.	T	C	1	2	3	0	1	4	0	0
4	17644600	.	T	C	2	3	5	0	1	6	0	0
4	17644913	.	A	G	4	4	8	0	0	8	0	0
4	17645408	.	T	C	3	8	11	0	0	11	0	0
4	17645890	.	A	C	9	6	15	0	3	18	0	0
4	17645962	.	C	T	6	4	10	0	0	10	0	0
4	17653340	.	T	C	4	6	10	0	0	10	0	0
4	17657549	.	A	G	6	0	6	0	9	15	0	0
4	17660859	.	G	A	5	7	12	0	0	12	0	0
4	17660871	.	A	G	4	4	8	0	1	9	0	0
4	17661102	.	T	G	5	4	9	0	0	9	0	0
4	17661132	.	A	C	8	3	11	0	1	12	0	0
4	17661191	.	T	C	9	3	12	0	0	12	0	0
4	17661200	.	C	T	7	4	11	0	2	13	0	0
4	17661349	.	C	T	4	3	7	0	0	7	0	0
4	17661354	.	T	G	4	2	6	0	0	6	0	0
4	17688726	.	G	A	1	2	3	0	0	3	0	0
4	17688795	.	T	C	3	4	7	0	0	7	0	0
4	17688849	.	T	C	3	4	7	0	0	7	0	0
4	17688874	.	T	C	3	3	6	0	1	7	0	0
4	17688897	.	C	T	2	2	4	0	1	5	0	0
4	17689377	.	A	G	4	3	7	0	0	7	0	0
4	17689395	.	C	T	2	4	6	0	0	6	0	0
4	17689464	.	C	A	1	4	5	0	0	5	0	0
4	17689476	.	A	G	1	0	1	0	3	4	0	0
4	17689551	.	G	A	1	5	6	0	0	6	0	0
4	17689561	.	T	C	1	4	5	0	1	6	0	0
4	17693223	.	C	T	1	6	7	0	0	7	0	0
4	17693232	.	C	T	1	3	4	0	1	5	0	0
4	17693286	.	T	C	4	6	10	0	0	10	0	0
4	17693400	.	A	G	4	2	6	0	1	7	0	0
4	17695054	.	A	G	5	7	12	0	1	13	0	0
4	17696254	.	G	A	1	5	6	0	0	6	0	0
4	17696341	.	A	G	3	0	3	0	5	8	0	0
4	17704067	.	G	A	2	8	10	1	1	13	1	0
4	17704123	.	T	C	4	4	8	1	0	9	0	0
4	17704279	.	T	A	8	4	12	0	2	14	0	0
4	17704345	.	C	T	2	8	10	0	0	10	0	0
4	17704393	.	A	T	3	5	8	0	0	8	0	0
4	17704560	.	A	G	7	5	12	0	0	12	0	0
4	17704885	.	T	C	2	6	8	0	1	9	0	0
4	17704915	.	A	T	4	4	8	0	0	8	0	0
4	17704928	.	T	A	3	2	5	0	0	5	0	0
4	17707849	.	A	C	3	8	11	0	0	11	0	0
4	17708230	.	T	C	8	12	20	0	1	21	0	0
4	17821696	.	A	G	2	3	5	0	0	5	0	0
4	17849578	.	T	C	1	2	3	0	0	3	0	0
4	17854396	.	C	T	2	4	6	0	0	6	0	0
4	17873351	.	A	G	8	8	16	0	1	17	0	0
4	17873530	.	T	G	4	7	11	0	0	11	0	0
4	17873615	.	T	C	8	4	12	0	0	12	0	0
4	17873620	.	T	C	7	4	11	0	0	11	0	0
4	17873711	.	A	T	7	3	10	0	1	11	0	0
4	17873743	.	C	T	5	2	7	0	1	8	0	0
4	17873787	.	G	A	0	2	2	0	3	5	0	0
4	17873808	.	G	C	2	2	4	0	1	5	0	0
4	17873930	.	C	T	12	3	15	0	0	15	0	0
4	17886974	.	G	A	23	18	41	0	3	44	0	0
4	17887059	.	T	C	21	18	39	3	1	43	0	0
4	17887388	.	A	T	29	18	47	0	1	48	0	0
4	17887826	.	C	T	26	21	47	0	4	51	0	0
4	17902098	.	A	G	17	18	35	0	0	35	0	0
4	17904325	.	A	C	14	1	15	0	20	35	0	0
4	17915070	.	G	A	18	14	32	0	1	33	0	0
4	17949261	.	C	T	6	5	11	0	3	14	0	0
4	18208005	.	A	G	6	3	9	0	0	9	0	0
4	18208068	.	A	G	11	8	19	0	2	21	0	0
4	18208347	.	C	G	10	5	15	0	0	15	0	0
4	18208519	.	A	G	3	5	8	0	0	8	0	0
4	18208557	.	C	A	3	5	8	0	0	8	0	0
4	18208569	.	T	C	3	4	7	0	0	7	0	0
4	18208635	.	T	A	2	6	8	0	0	8	0	0
4	18208939	.	C	T	4	6	10	0	5	15	0	0
4	18209107	.	G	C	12	5	17	2	1	20	0	0
4	18209185	.	A	T	10	2	12	1	0	13	0	0
4	18213267	.	C	T	8	6	14	0	0	14	0	0
4	18216182	.	A	G	4	13	17	0	0	17	0	0
4	18216251	.	T	C	5	5	10	0	1	11	0	0
4	18216332	.	A	G	13	7	20	0	0	20	0	0
4	18235106	.	T	C	6	4	10	0	0	10	0	0
4	18235397	.	A	T	2	3	5	0	3	8	0	0
4	18237355	.	A	G	2	2	4	0	0	4	0	0
4	18240356	.	A	G	1	3	4	0	0	4	0	0
4	18240451	.	G	A	1	4	5	0	1	6	0	0
4	18240640	.	C	G	4	2	6	0	0	6	0	0
4	18240658	.	T	C	1	2	3	0	1	4	0	0
4	18241030	.	A	G	3	2	5	0	0	5	0	0
4	18241255	.	C	G	4	5	9	0	0	9	0	0
4	18241297	.	C	T	4	2	6	0	1	7	0	0
4	18244632	.	T	A	1	4	5	0	0	5	0	0
4	18244669	.	G	A	2	3	5	0	0	5	0	0
4	18244670	.	G	C	2	0	2	0	3	5	0	0
4	18283111	.	A	G	4	2	6	0	1	7	0	0
4	18287263	.	T	C	8	3	11	0	2	13	0	0
4	18287449	.	T	G	3	3	6	0	0	6	0	0
4	18301353	.	T	C	4	2	6	0	0	6	0	0
4	18313345	.	G	A	1	2	3	0	0	3	0	0
4	18313346	.	C	T	1	2	3	0	0	3	0	0
4	18416371	.	C	G	1	3	4	0	0	4	0	0
4	18416429	.	A	G	1	3	4	0	0	4	0	0
4	18416462	.	T	G	1	3	4	0	0	4	0	0
4	18454352	.	A	G	8	6	14	0	1	15	0	0
4	18454363	.	T	A	7	7	14	0	1	15	0	0
4	18454400	.	C	T	0	4	4	0	7	11	0	0
4	18494878	.	A	G	1	2	3	0	0	3	0	0
4	18502437	.	A	G	3	4	7	0	1	8	0	0
4	18502494	.	C	T	3	3	6	0	0	6	0	0
4	18510675	.	C	T	0	2	2	0	1	3	0	0
4	18592863	.	A	C	5	5	10	0	0	10	0	0
4	18592916	.	T	A	2	4	6	0	0	6	0	0
4	18593839	.	G	A	17	7	24	0	0	24	0	0
4	18594019	.	G	T	12	9	21	0	2	23	0	0
4	18594045	.	T	C	11	7	18	0	1	19	0	0
4	18594125	.	T	A	10	5	15	0	1	16	0	0
4	18594920	.	G	A	10	6	16	0	2	18	0	0
4	18597841	.	C	G	18	12	30	0	2	32	0	0
4	18606501	.	G	T	20	22	42	0	2	44	0	0
4	18606512	.	C	T	17	18	35	0	3	38	0	0
4	18609613	.	T	G	1	6	7	0	0	7	0	0
4	18609759	.	C	G	5	4	9	0	0	9	0	0
4	18609769	.	A	G	4	5	9	0	0	9	0	0
4	18609812	.	A	C	4	6	10	0	1	11	0	0
4	18609855	.	G	C	4	4	8	0	0	8	0	0
4	18614034	.	A	G	3	5	8	0	1	9	0	0
4	18623708	.	A	G	2	3	5	0	0	5	0	0
4	18707376	.	C	T	0	2	2	0	2	4	0	0
4	18720871	.	C	T	5	5	10	0	1	11	0	0
4	18720942	.	C	T	4	4	8	0	2	10	0	0
4	18720947	.	G	T	5	7	12	0	1	13	0	0
4	18738057	.	A	G	1	2	3	0	0	3	0	0
4	18738072	.	T	C	1	2	3	0	0	3	0	0
4	18837898	.	A	T	6	8	14	0	3	17	0	0
4	18850630	.	A	G	1	6	7	0	0	7	0	0
4	18853153	.	C	T	4	6	10	0	1	11	0	0
4	18853972	.	C	G	24	13	37	0	2	39	0	0
4	18854250	.	A	C	14	1	15	0	18	33	0	0
4	18976182	.	A	G	2	3	5	0	0	5	0	0
4	18979820	.	T	A	11	9	20	0	0	20	0	0
4	18985807	.	T	A	10	18	28	0	1	29	0	0
4	18985846	.	A	G	10	19	29	0	2	31	0	0
4	18985995	.	G	A	19	7	26	0	0	26	0	0
4	18986107	.	C	T	8	3	11	0	0	11	0	0
4	18986282	.	T	C	8	0	8	0	7	15	0	0
4	18986293	.	T	G	8	6	14	0	1	15	0	0
4	18986413	.	G	A	5	20	25	0	0	25	0	0
4	18986497	.	C	T	1	19	20	0	12	32	0	0
4	18986771	.	A	T	5	5	10	1	0	11	0	0
4	18986805	.	G	T	6	7	13	1	0	14	0	0
4	18986893	.	C	G	5	5	10	0	1	11	0	0
4	18986897	.	T	A	5	6	11	0	0	11	0	0
4	18987391	.	G	A	12	4	16	0	1	17	0	0
4	18987523	.	T	C	6	8	14	0	1	15	0	0
4	18987835	.	G	C	10	0	10	0	12	22	0	0
4	18988068	.	T	C	3	0	3	0	6	9	0	0
4	18988084	.	G	A	7	5	12	0	0	12	0	0
4	18988150	.	T	G	10	9	19	0	0	19	0	0
4	18988222	.	A	G	4	3	7	0	0	7	0	0
4	18988270	.	T	A	8	5	13	0	0	13	0	0
4	18988426	.	G	C	3	4	7	0	0	7	0	0
4	18989185	.	T	C	4	0	4	0	3	7	0	0
4	18999680	.	C	T	0	6	6	0	5	11	0	0
4	19007486	.	A	C	3	3	6	0	0	6	0	0
4	19007811	.	T	C	1	2	3	0	1	4	0	0
4	19007823	.	A	G	1	2	3	0	1	4	0	0
4	19397641	.	A	T	19	10	29	0	3	32	0	0
4	19414905	.	G	A	10	9	19	0	0	19	0	0
4	19421890	.	G	A	7	7	14	0	1	15	0	0
4	19493773	.	G	T	11	7	18	0	1	19	0	0
4	19493808	.	G	A	8	6	14	0	1	15	0	0
4	19535841	.	T	G	6	9	15	0	0	15	0	0
4	19536422	.	T	C	11	11	22	0	1	23	0	0
4	19536917	.	C	T	18	20	38	0	1	39	0	0
4	19537703	.	A	G	21	30	51	0	2	53	0	0
4	19537937	.	A	G	26	2	28	0	28	56	0	0
4	19539017	.	C	T	11	4	15	0	2	17	0	0
4	19567605	.	A	G	9	8	17	0	1	18	0	0
4	19611694	.	G	A	5	8	13	0	0	13	0	0
4	19611739	.	T	G	3	4	7	0	0	7	0	0
4	19651917	.	G	A	5	4	9	0	0	9	0	0
4	19948312	.	A	G	6	4	10	0	0	10	0	0
4	19948313	.	A	G	6	3	9	0	1	10	0	0
4	19948746	.	T	C	7	4	11	0	0	11	0	0
4	19949148	.	T	C	2	8	10	0	2	12	0	0
4	19949178	.	A	T	2	5	7	0	1	8	0	0
4	19949496	.	A	T	2	2	4	0	0	4	0	0
4	19949498	.	T	C	2	2	4	0	0	4	0	0
4	19949730	.	T	C	4	5	9	0	0	9	0	0
4	19949963	.	T	C	3	4	7	0	0	7	0	0
4	19949966	.	T	C	3	2	5	0	0	5	0	0
4	19950123	.	G	A	3	2	5	0	1	6	0	0
4	19954907	.	G	C	2	0	2	0	2	4	0	0
4	19955017	.	G	T	2	3	5	0	0	5	0	0
4	19981777	.	C	T	1	2	3	0	0	3	0	0
4	20049543	.	C	T	27	26	53	0	1	54	0	0
4	20051021	.	A	G	21	25	46	0	2	48	0	0
4	20051092	.	C	T	0	19	19	0	11	30	0	0
4	20053199	.	T	C	19	16	35	0	1	36	0	0
4	20053211	.	A	G	19	21	40	0	0	40	0	0
4	20053901	.	C	T	24	12	36	0	2	38	0	0
4	20054036	.	C	T	18	14	32	0	1	33	0	0
4	20054135	.	A	G	6	7	13	0	0	13	0	0
4	20054190	.	T	G	3	3	6	0	0	6	0	0
4	20054243	.	A	G	7	6	13	0	0	13	0	0
4	20054516	.	C	T	12	5	17	0	0	17	0	0
4	20060589	.	A	G	1	3	4	0	2	6	0	0
4	20066194	.	T	G	4	4	8	0	0	8	0	0
4	20066208	.	G	A	5	4	9	0	0	9	0	0
4	20066263	.	T	C	5	4	9	0	0	9	0	0
4	20068149	.	T	G	5	3	8	0	0	8	0	0
4	20068185	.	A	G	3	3	6	0	0	6	0	0
4	20068266	.	A	G	1	3	4	0	0	4	0	0
4	20068446	.	G	A	12	4	16	0	0	16	0	0
4	20068470	.	C	G	13	6	19	0	0	19	0	0
4	20068717	.	G	A	3	4	7	0	1	8	0	0
4	20068890	.	G	A	9	8	17	0	0	17	0	0
4	20068903	.	T	C	12	6	18	0	0	18	0	0
4	20069091	.	T	C	5	3	8	0	2	10	0	0
4	20069343	.	C	A	8	11	19	0	0	19	0	0
4	20071344	.	A	T	7	6	13	0	0	13	0	0
4	20071401	.	G	T	5	5	10	0	1	11	0	0
4	20071877	.	C	T	0	2	2	0	4	6	0	0
4	20072035	.	T	C	1	3	4	0	1	5	0	0
4	20072394	.	C	G	14	10	24	0	2	26	0	0
4	20072429	.	T	G	12	8	20	0	0	20	0	0
4	20073790	.	T	C	9	9	18	0	0	18	0	0
4	20073799	.	A	G	12	9	21	0	0	21	0	0
4	20075455	.	T	C	6	6	12	0	0	12	0	0
4	20075473	.	G	A	4	6	10	0	0	10	0	0
4	20078569	.	G	A	2	2	4	0	0	4	0	0
4	20080778	.	T	A	2	3	5	0	0	5	0	0
4	20091055	.	G	C	1	2	3	0	2	5	0	0
4	20098793	.	C	G	4	3	7	0	0	7	0	0
4	20099022	.	G	A	6	3	9	0	0	9	0	0
4	20099261	.	C	T	6	2	8	0	2	10	0	0
4	20099516	.	G	A	0	7	7	0	4	11	0	0
4	20099564	.	C	T	2	3	5	0	1	6	0	0
4	20101105	.	G	T	14	4	18	0	0	18	0	0
4	20102901	.	C	A	2	2	4	0	1	5	0	0
4	20103813	.	T	A	4	3	7	0	0	7	0	0
4	20103864	.	G	A	4	3	7	0	0	7	0	0
4	20103873	.	T	C	3	3	6	0	0	6	0	0
4	20105455	.	T	A	2	2	4	0	0	4	0	0
4	20111672	.	C	A	1	5	6	0	0	6	0	0
4	20125767	.	A	G	4	3	7	0	1	8	0	0
4	20128082	.	C	T	5	2	7	0	0	7	0	0
4	20128083	.	C	T	5	2	7	0	0	7	0	0
4	20130015	.	G	T	1	2	3	0	0	3	0	0
4	20135088	.	A	C	1	0	1	1	4	6	0	0
4	20226677	.	A	G	5	8	13	0	1	14	0	0
4	20226826	.	T	C	6	7	13	0	0	13	0	0
4	20226916	.	A	C	12	9	21	0	1	22	0	0
4	20229626	.	C	T	5	7	12	0	0	12	0	0
4	20229920	.	C	A	1	9	10	0	5	15	0	0
4	20230213	.	G	A	8	3	11	0	1	12	0	0
4	20235766	.	G	A	10	8	18	0	0	18	0	0
4	20265309	.	C	T	2	2	4	0	0	4	0	0
4	20303381	.	C	T	0	5	5	0	3	8	0	0
4	20303423	.	T	C	3	3	6	0	0	6	0	0
4	20303545	.	T	C	1	5	6	0	0	6	0	0
4	20303604	.	T	C	3	6	9	0	0	9	0	0
4	20305520	.	G	T	3	2	5	0	0	5	0	0
4	20305777	.	T	G	5	2	7	0	0	7	0	0
4	20464937	.	C	T	3	2	5	0	0	5	0	0
4	20465899	.	C	T	1	2	3	0	0	3	0	0
4	20470061	.	G	A	3	3	6	0	1	7	0	0
4	20470205	.	C	T	11	5	16	0	1	17	0	0
4	20470316	.	C	T	6	3	9	0	1	10	0	0
4	20473032	.	G	A	6	6	12	0	0	12	0	0
4	20473127	.	G	A	0	9	9	0	4	14	1	0
4	20473142	.	C	T	5	7	12	0	1	13	0	0
4	20473175	.	C	T	4	5	9	0	1	10	0	0
4	20474363	.	A	T	3	7	10	0	0	10	0	0
4	20474728	.	A	T	5	5	10	0	2	12	0	0
4	20480734	.	G	A	5	7	12	0	0	12	0	0
4	20482150	.	T	C	3	5	8	0	0	8	0	0
4	20482425	.	A	G	11	12	23	0	0	23	0	0
4	20482506	.	C	T	6	5	11	0	1	12	0	0
4	20482615	.	G	T	3	2	5	0	0	5	0	0
4	20482726	.	A	G	6	2	8	0	0	8	0	0
4	20483785	.	G	A	8	3	11	0	0	11	0	0
4	20490031	.	C	T	1	4	5	0	0	5	0	0
4	20490043	.	T	C	1	4	5	0	0	5	0	0
4	20494332	.	C	T	8	7	15	0	0	15	0	0
4	20496653	.	A	G	3	3	6	0	3	9	0	0
4	20496655	.	C	T	6	3	9	0	0	9	0	0
4	20498240	.	A	G	10	5	15	0	2	17	0	0
4	20499421	.	G	C	8	5	13	0	0	13	0	0
4	20499440	.	A	G	7	6	13	0	0	13	0	0
4	20499493	.	T	G	6	3	9	0	0	9	0	0
4	20507121	.	T	A	8	6	14	1	2	17	0	0
4	20507155	.	A	C	12	12	24	1	2	27	0	0
4	20507473	.	T	A	6	6	12	0	2	14	0	0
4	20507546	.	T	A	6	5	11	1	2	14	0	0
4	20508691	.	G	A	1	10	11	0	1	12	0	0
4	20508913	.	A	G	5	12	17	0	2	19	0	0
4	20508928	.	A	G	5	15	20	0	0	20	0	0
4	20508992	.	C	T	5	12	17	0	2	19	0	0
4	20951390	.	C	T	1	2	3	0	0	3	0	0
4	20965426	.	A	T	2	3	5	0	0	5	0	0
4	20971490	.	C	T	7	2	9	0	1	10	0	0
4	20974250	.	C	T	2	5	7	1	0	8	0	0
4	20974343	.	C	A	2	3	5	0	0	5	0	0
4	20976062	.	A	T	3	2	5	1	0	6	0	0
4	20976085	.	G	A	1	2	3	0	0	3	0	0
4	20976252	.	G	A	2	4	6	0	0	6	0	0
4	20980971	.	A	G	4	7	11	0	0	11	0	0
4	20981198	.	G	A	0	10	10	0	5	15	0	0
4	20981273	.	A	C	2	2	4	0	0	4	0	0
4	21290798	.	G	A	14	10	24	0	2	26	0	0
4	21295949	.	T	C	16	19	35	0	2	37	0	0
4	21297417	.	A	C	20	16	36	0	2	38	0	0
4	21312642	.	T	C	23	19	42	0	3	45	0	0
4	21312981	.	C	T	27	21	48	0	8	56	0	0
4	21313120	.	A	G	33	3	36	0	28	64	0	0
4	21313136	.	T	C	25	28	53	0	7	60	0	0
4	21313779	.	T	G	36	26	62	0	5	67	0	0
4	21313805	.	G	A	6	30	36	0	38	74	0	0
4	21314120	.	T	C	23	28	51	2	2	55	0	0
4	21314204	.	G	T	23	15	38	0	2	40	0	0
4	21314338	.	G	T	40	24	64	0	2	66	0	0
4	21314583	.	T	C	30	30	60	0	2	62	0	0
4	21323174	.	T	A	3	2	5	0	1	6	0	0
4	21323215	.	T	C	2	0	2	0	3	5	0	0
4	21323216	.	T	G	2	3	5	0	0	5	0	0
4	21323363	.	G	C	4	6	10	0	0	10	0	0
4	21323454	.	A	G	5	5	10	0	0	10	0	0
4	21323467	.	G	C	4	3	7	0	1	8	0	0
4	21323532	.	C	T	0	7	7	0	2	9	0	0
4	21323536	.	T	C	1	8	9	0	0	9	0	0
4	21489550	.	A	G	15	0	15	0	5	20	0	0
4	21489629	.	G	T	12	16	28	0	1	29	0	0
4	21490320	.	T	C	23	11	34	0	1	35	0	0
4	21490344	.	A	G	25	10	35	0	0	35	0	0
4	21499521	.	G	A	11	6	17	0	1	18	0	0
4	21507026	.	G	A	4	11	15	0	1	16	0	0
4	21508353	.	C	T	10	9	19	0	0	19	0	0
4	21512191	.	C	T	10	11	21	1	1	23	0	0
4	21517970	.	A	G	4	3	7	0	0	7	0	0
4	21523541	.	A	T	9	4	13	1	1	15	0	0
4	21523789	.	T	G	4	4	8	0	1	9	0	0
4	21525430	.	G	T	4	5	9	0	0	9	0	0
4	21526300	.	A	G	3	2	5	0	1	6	0	0
4	21649505	.	G	A	36	30	66	2	10	78	0	0
4	21651486	.	G	A	41	28	69	0	1	70	0	0
4	21652609	.	A	T	11	7	18	0	0	18	0	0
4	21752284	.	G	A	18	6	24	0	1	25	0	0
4	21752291	.	C	T	15	6	21	0	1	22	0	0
4	21752372	.	T	A	8	8	16	1	1	18	0	0
4	21752493	.	T	C	3	4	7	0	0	7	0	0
4	21752495	.	C	G	3	4	7	0	0	7	0	0
4	21752688	.	G	C	10	0	10	0	13	23	0	0
4	21752736	.	T	C	12	15	27	0	3	30	0	0
4	21752941	.	T	A	8	6	14	0	3	17	0	0
4	21752969	.	C	T	11	10	21	0	1	22	0	0
4	21752984	.	C	A	8	11	19	0	2	21	0	0
4	21753139	.	C	T	13	14	27	0	0	27	0	0
4	21753185	.	T	C	16	13	29	0	1	30	0	0
4	21753316	.	T	C	10	14	24	1	0	25	0	0
4	21753344	.	G	A	13	10	23	0	0	23	0	0
4	21761688	.	A	T	13	7	20	0	0	20	0	0
4	21975679	.	T	C	17	7	24	0	1	25	0	0
4	22419707	.	T	A	5	2	7	0	0	7	0	0
4	22756239	.	T	C	9	6	15	0	3	18	0	0
4	25479803	.	A	G	6	2	8	0	0	8	0	0
4	26303655	.	C	T	3	2	5	0	0	5	0	0
4	26762518	.	G	T	4	2	6	0	1	7	0	0
4	26763482	.	G	T	5	2	7	0	2	9	0	0
4	27112663	.	T	A	1	3	4	0	3	7	0	0
4	29286951	.	T	G	1	1	2	3	0	5	0	0
4	29719096	.	A	G	1	2	3	0	0	3	0	0
4	45195979	.	C	A	1	2	3	0	0	3	0	0
4	68552416	.	C	T	1	2	3	0	0	3	0	0
4	69899771	.	C	T	1	2	3	1	0	4	0	0
4	70850756	.	C	T	2	2	4	0	0	4	0	0
4	70850966	.	G	T	11	5	16	0	0	16	0	0
4	70851069	.	G	A	7	5	12	8	0	20	0	0
4	70851105	.	A	G	6	7	13	4	0	17	0	0
4	70855931	.	T	C	2	1	3	0	2	5	0	0
4	70860034	.	A	C	9	0	9	0	6	15	0	0
4	70860166	.	A	G	11	5	16	0	0	16	0	0
4	70866787	.	A	T	7	3	10	0	0	10	0	0
4	70866791	.	A	T	8	3	11	0	0	11	0	0
4	73500405	.	T	C	3	0	3	0	2	5	0	0
4	73500476	.	T	C	2	0	2	0	3	5	0	0
4	73500492	.	T	C	3	2	5	0	0	5	0	0
4	73638591	.	T	C	2	3	5	0	0	5	0	0
4	73758321	.	T	C	6	4	10	3	1	14	0	0
4	73758375	.	T	C	2	2	4	3	1	8	0	0
4	74564352	.	A	G	17	8	25	0	1	26	0	0
4	74943202	.	A	T	8	8	16	0	2	18	0	0
4	74952477	.	G	A	13	10	23	0	1	24	0	0
4	74952525	.	A	G	13	1	14	0	6	20	0	0
4	74952660	.	G	T	1	11	12	0	10	22	0	0
4	74960826	.	C	T	14	13	27	0	1	28	0	0
4	74961011	.	C	T	14	13	27	0	3	30	0	0
4	74961075	.	G	A	17	15	32	0	2	34	0	0
4	74961520	.	T	A	5	11	16	0	1	17	0	0
4	74961814	.	T	C	1	1	2	0	1	3	0	0
4	76322771	.	T	C	1	5	6	0	1	7	0	0
4	76334633	.	A	G	1	1	2	1	3	6	0	0
4	76346188	.	T	A	5	3	8	0	0	8	0	0
4	76346238	.	C	A	6	5	11	2	0	13	0	0
4	76347126	.	T	C	4	4	8	1	0	9	0	0
4	76347508	.	T	G	8	3	11	1	1	13	0	0
4	76347722	.	C	T	7	4	11	0	0	11	0	0
4	76347850	.	T	C	6	3	9	0	0	9	0	0
4	76348088	.	T	A	7	5	12	0	0	12	0	0
4	76360500	.	T	A	1	3	4	0	0	4	0	0
4	76362977	.	T	G	2	2	4	0	0	4	0	0
4	76363011	.	C	T	1	3	4	0	0	4	0	0
4	76363060	.	A	C	2	2	4	0	1	5	0	0
4	76363195	.	C	T	0	3	3	0	3	6	0	0
4	76363204	.	A	C	3	4	7	0	0	7	0	0
4	76408988	.	G	A	1	7	8	0	0	8	0	0
4	76409422	.	C	T	1	5	6	0	2	8	0	0
4	76409461	.	A	G	1	0	1	0	4	5	0	0
4	76411759	.	A	T	2	6	8	0	0	8	0	0
4	76411925	.	T	G	6	3	9	0	1	10	0	0
4	76412432	.	G	T	2	10	12	0	1	13	0	0
4	76420809	.	A	G	3	4	7	0	0	7	0	0
4	76421602	.	A	C	4	3	7	0	0	7	0	0
4	76421898	.	A	G	3	2	5	0	0	5	0	0
4	76422084	.	A	G	3	2	5	0	0	5	0	0
4	76422231	.	G	A	0	6	6	0	6	12	0	0
4	76422357	.	T	C	2	3	5	0	1	6	0	0
4	76422424	.	A	G	2	5	7	0	0	7	0	0
4	76422432	.	G	A	5	3	8	0	1	9	0	0
4	76422500	.	T	C	4	2	6	0	0	6	0	0
4	76423234	.	G	A	2	5	7	0	1	8	0	0
4	76423418	.	A	G	6	3	9	0	0	9	0	0
4	76423537	.	C	T	2	6	8	0	1	9	0	0
4	76423732	.	C	T	1	3	4	0	0	4	0	0
4	76429202	.	A	C	2	7	9	0	0	9	0	0
4	76429234	.	A	C	8	0	8	0	2	10	0	0
4	76429237	.	G	C	7	2	9	0	0	9	0	0
4	76429719	.	G	T	2	4	6	0	0	6	0	0
4	76429878	.	G	T	3	2	5	0	0	5	0	0
4	76429944	.	G	C	7	3	10	0	1	11	0	0
4	76429969	.	G	A	3	11	14	0	0	14	0	0
4	76430256	.	G	A	4	3	7	0	0	7	0	0
4	76430257	.	A	G	4	3	7	0	0	7	0	0
4	76437999	.	A	T	1	4	5	0	1	6	0	0
4	76438019	.	A	T	4	3	7	0	0	7	0	0
4	76439095	.	T	A	5	3	8	0	0	8	0	0
4	76439101	.	C	T	3	4	7	0	0	7	0	0
4	76465087	.	C	T	6	6	12	0	1	13	0	0
4	76465329	.	T	C	2	5	7	0	1	8	0	0
4	76473451	.	A	T	1	3	4	0	0	4	0	0
4	76474078	.	G	A	1	2	3	0	0	3	0	0
4	76474844	.	G	C	0	3	3	0	1	4	0	0
4	76481137	.	A	T	8	2	10	0	0	10	0	0
4	76481140	.	C	A	7	2	9	0	1	10	0	0
4	76481216	.	G	C	6	1	7	0	5	12	0	0
4	76481403	.	T	A	5	12	17	0	2	19	0	0
4	76481572	.	G	A	4	10	14	0	0	14	0	0
4	76481665	.	A	T	4	3	7	0	0	7	0	0
4	76482207	.	A	G	3	9	12	0	0	12	0	0
4	76482249	.	C	T	2	3	5	0	1	6	0	0
4	76482673	.	T	C	1	4	5	0	0	5	0	0
4	76482756	.	G	T	2	4	6	0	0	6	0	0
4	76484343	.	G	A	1	7	8	0	1	9	0	0
4	76484531	.	T	C	1	2	3	0	0	3	0	0
4	76488617	.	G	A	1	3	4	0	1	5	0	0
4	76488624	.	A	G	2	3	5	0	0	5	0	0
4	76504289	.	A	T	1	2	3	0	0	3	0	0
4	76866993	.	A	G	10	5	15	0	1	16	0	0
4	77103671	.	A	G	1	3	4	0	0	4	0	0
4	77103672	.	A	G	1	3	4	0	0	4	0	0
4	77250926	.	T	C	8	3	11	0	1	12	0	0
4	77250931	.	T	C	7	3	10	0	1	11	0	0
4	77255062	.	A	T	4	2	6	0	0	6	0	0
4	77389832	.	G	C	7	3	10	0	0	10	0	0
4	77390083	.	A	T	10	4	14	0	2	16	0	0
4	77390628	.	A	T	7	3	10	0	0	10	0	0
5	318077	.	G	A	7	10	17	0	0	17	0	0
5	318125	.	C	T	7	7	14	0	0	14	0	0
5	340614	.	A	G	12	11	23	0	2	25	0	0
5	340667	.	T	C	7	9	16	0	1	17	0	0
5	341288	.	T	C	6	9	15	0	1	16	0	0
5	341331	.	C	T	8	10	18	0	0	18	0	0
5	341659	.	T	C	11	9	20	0	6	26	0	0
5	342001	.	T	C	7	5	12	1	3	16	0	0
5	342134	.	A	G	7	4	11	2	1	14	0	0
5	342228	.	C	T	4	2	6	0	0	6	0	0
5	393858	.	G	A	4	6	10	0	1	11	0	0
5	393979	.	T	C	5	6	11	0	0	11	0	0
5	394181	.	G	A	11	15	26	0	1	27	0	0
5	394184	.	T	C	12	15	27	0	1	28	0	0
5	394238	.	A	G	13	16	29	0	2	31	0	0
5	394239	.	T	G	13	16	29	0	2	31	0	0
5	394360	.	C	G	6	9	15	0	0	15	0	0
5	394417	.	G	A	0	9	9	0	7	16	0	0
5	394484	.	A	G	2	0	2	0	6	9	1	0
5	395404	.	T	A	4	7	11	0	2	13	0	0
5	395405	.	T	C	4	8	12	0	1	13	0	0
5	440032	.	A	G	9	0	9	0	7	16	0	0
5	440033	.	A	C	8	7	15	0	1	16	0	0
5	440106	.	T	C	12	3	15	0	1	16	0	0
5	457736	.	C	G	22	8	30	0	0	30	0	0
5	486649	.	T	G	2	0	2	0	3	5	0	0
5	489764	.	T	C	1	3	4	0	0	4	0	0
5	491375	.	C	T	3	2	5	0	0	5	0	0
5	491376	.	A	C	3	2	5	0	0	5	0	0
5	491832	.	T	C	5	3	8	0	2	10	0	0
5	491982	.	T	C	5	4	9	0	0	9	0	0
5	496604	.	G	T	1	5	6	0	11	17	0	0
5	894613	.	C	T	2	3	5	0	0	5	0	0
5	894882	.	T	A	2	3	5	0	0	5	0	0
5	895581	.	T	C	7	6	13	0	2	15	0	0
5	896908	.	C	A	6	2	8	0	1	9	0	0
5	905258	.	C	T	4	2	6	0	1	7	0	0
5	905263	.	C	A	4	3	7	0	1	8	0	0
5	917336	.	C	T	5	14	19	0	2	21	0	0
5	1055103	.	C	T	16	18	34	0	1	35	0	0
5	1059697	.	T	C	16	15	31	0	1	32	0	0
5	1064013	.	A	G	18	17	35	0	0	35	0	0
5	1068116	.	T	A	21	15	36	0	3	39	0	0
5	1079480	.	C	T	15	7	22	0	0	22	0	0
5	1079558	.	G	T	11	10	21	0	1	22	0	0
5	1083073	.	A	G	1	0	1	0	2	3	0	0
5	1083203	.	G	C	8	9	17	1	1	19	0	0
5	1083237	.	T	A	3	8	11	1	0	12	0	0
5	1083242	.	T	C	3	8	11	1	0	12	0	0
5	1083679	.	G	A	0	3	3	2	3	8	0	0
5	1083894	.	T	G	13	0	13	0	9	22	0	0
5	1149832	.	C	T	1	2	3	0	0	3	0	0
5	1150143	.	T	C	2	2	4	0	0	4	0	0
5	1155594	.	G	A	3	6	9	0	0	9	0	0
5	1187950	.	G	A	2	5	7	0	0	7	0	0
5	1205869	.	C	G	3	2	5	0	1	6	0	0
5	1207835	.	C	T	11	11	22	0	2	24	0	0
5	1216494	.	A	G	9	6	15	0	1	16	0	0
5	1216536	.	C	T	2	6	8	0	11	19	0	0
5	1218781	.	G	A	1	2	3	0	0	3	0	0
5	1219263	.	C	T	17	9	26	0	0	26	0	0
5	1219342	.	G	T	17	5	22	0	2	24	0	0
5	1219381	.	G	A	19	11	30	0	1	31	0	0
5	1223368	.	A	T	11	12	23	2	2	27	0	0
5	1223369	.	C	T	13	11	24	2	2	28	0	0
5	1223460	.	G	A	12	5	17	0	0	17	0	0
5	1223487	.	G	T	8	10	18	0	0	18	0	0
5	1299350	.	C	G	2	0	2	0	7	9	0	0
5	1311041	.	G	A	8	5	13	0	0	13	0	0
5	1317871	.	T	C	3	5	8	0	0	8	0	0
5	1317883	.	G	A	4	6	10	0	0	10	0	0
5	1346838	.	T	C	9	9	18	0	1	19	0	0
5	1420926	.	C	A	9	2	11	0	0	11	0	0
5	1420949	.	A	C	6	3	9	1	0	10	0	0
5	1438628	.	G	A	5	7	12	0	0	12	0	0
5	1445964	.	G	A	3	3	6	0	0	6	0	0
5	1445989	.	A	G	0	6	6	0	0	6	0	0
5	1456393	.	G	A	3	3	6	0	0	6	0	0
5	1467806	.	C	T	0	4	4	0	2	6	0	0
5	1519571	.	G	C	6	10	16	0	0	16	0	0
5	1519574	.	T	A	6	7	13	0	3	16	0	0
5	2068959	.	A	T	10	7	17	1	10	28	0	0
5	2242346	.	G	A	2	2	4	0	0	4	0	0
5	2248728	.	T	A	1	2	3	0	0	3	0	0
5	2248736	.	C	T	1	1	2	0	0	2	0	0
5	2571365	.	T	G	2	0	2	0	3	5	0	0
5	2571381	.	T	G	3	0	3	0	4	7	0	0
5	2658348	.	G	A	5	2	7	0	0	7	0	0
5	2686225	.	G	C	5	3	8	0	0	8	0	0
5	2689283	.	G	A	2	7	9	0	0	9	0	0
5	2693660	.	G	A	4	5	9	0	0	9	0	0
5	2693740	.	C	G	2	2	4	0	0	4	0	0
5	2709533	.	A	G	2	7	9	0	2	11	0	0
5	2709561	.	T	C	3	6	9	0	0	9	0	0
5	2713967	.	A	G	24	14	38	0	3	41	0	0
5	2714042	.	C	T	32	18	50	0	3	53	0	0
5	2714135	.	C	T	25	18	43	0	7	50	0	0
5	2714237	.	G	A	29	22	51	1	1	53	0	0
5	2714495	.	G	A	23	28	51	0	2	53	0	0
5	2714507	.	A	G	26	26	52	0	3	55	0	0
5	2714531	.	T	C	33	0	33	0	19	52	0	0
5	2716930	.	G	A	12	9	21	2	3	26	0	0
5	2716963	.	G	A	11	7	18	0	3	21	0	0
5	2717014	.	G	A	14	10	24	0	1	25	0	0
5	2717022	.	G	A	13	9	22	0	2	24	0	0
5	2717260	.	T	C	8	9	17	0	0	17	0	0
5	2717350	.	G	C	14	0	14	0	10	24	0	0
5	2717611	.	C	T	15	7	22	0	0	22	0	0
5	2717623	.	A	G	15	8	23	0	0	23	0	0
5	2717960	.	A	G	6	7	13	0	0	13	0	0
5	2718696	.	A	G	5	2	7	0	0	7	0	0
5	2718834	.	G	A	6	3	9	0	0	9	0	0
5	2720119	.	A	G	5	6	11	0	0	11	0	0
5	2721588	.	C	T	5	4	9	0	2	11	0	0
5	2742784	.	A	G	6	3	9	0	0	9	0	0
5	2744938	.	C	T	3	2	5	0	0	5	0	0
5	2744962	.	C	G	2	2	4	0	1	5	0	0
5	2744998	.	C	T	2	2	4	0	0	4	0	0
5	2745220	.	G	T	8	7	15	0	1	16	0	0
5	2750087	.	G	A	2	4	6	0	1	7	0	0
5	2750127	.	G	A	3	2	5	0	1	6	0	0
5	2751319	.	G	A	5	2	7	0	0	7	0	0
5	3362996	.	G	A	2	3	5	0	1	6	0	0
5	3363014	.	C	T	1	4	5	0	0	5	0	0
5	3363050	.	C	T	3	4	7	0	0	7	0	0
5	3502001	.	A	G	9	16	25	0	3	28	0	0
5	3544098	.	C	T	17	22	39	0	3	42	0	0
5	3544380	.	C	T	21	23	44	0	2	46	0	0
5	3544955	.	T	C	17	25	42	0	1	43	0	0
5	3545011	.	T	A	21	20	41	0	4	45	0	0
5	3545205	.	A	T	32	0	32	1	0	33	0	0
5	3568494	.	C	T	6	16	22	0	0	22	0	0
5	3568518	.	G	T	3	16	19	0	0	19	0	0
5	3568530	.	C	T	18	5	23	0	1	24	0	0
5	3573946	.	A	C	3	4	7	0	1	8	0	0
5	3612254	.	A	G	3	5	8	0	0	8	0	0
5	3670231	.	G	A	1	3	4	0	0	4	0	0
5	3891528	.	C	T	6	2	8	0	0	8	0	0
5	3891532	.	G	C	6	2	8	0	0	8	0	0
5	6717757	.	C	A	3	3	6	0	0	6	0	0
5	6717804	.	T	C	2	4	6	0	1	7	0	0
5	6717809	.	G	A	3	4	7	0	0	7	0	0
5	6726416	.	T	C	5	3	8	0	0	8	0	0
5	6726548	.	T	A	2	2	4	0	0	4	0	0
5	6726866	.	A	C	3	1	4	1	0	5	0	0
5	6727099	.	C	A	2	2	4	0	0	4	0	0
5	6728119	.	C	T	2	2	4	0	0	4	0	0
5	6728128	.	G	T	2	2	4	0	0	4	0	0
5	6820663	.	G	A	1	2	3	0	0	3	0	0
5	6832646	.	C	T	2	2	4	0	1	5	0	0
5	6839136	.	A	C	3	2	5	0	0	5	0	0
5	6858380	.	C	A	4	12	16	0	0	16	0	0
5	6858389	.	T	A	6	10	16	0	0	16	0	0
5	6858779	.	G	T	0	8	8	0	13	21	0	0
5	6863577	.	C	T	20	5	25	0	0	25	0	0
5	6863647	.	C	T	14	8	22	0	1	23	0	0
5	6863768	.	G	C	11	10	21	0	1	22	0	0
5	6863793	.	G	A	18	7	25	0	1	26	0	0
5	6863855	.	G	A	11	5	16	0	1	17	0	0
5	6864010	.	C	T	4	4	8	0	0	8	0	0
5	6864061	.	A	G	2	3	5	0	1	6	0	0
5	6881773	.	C	T	2	4	6	0	0	6	0	0
5	6956547	.	C	G	2	3	5	0	0	5	0	0
5	6958910	.	T	C	1	3	4	0	0	4	0	0
5	6958965	.	G	C	2	3	5	0	0	5	0	0
5	6959148	.	C	A	5	3	8	0	0	8	0	0
5	6959834	.	T	A	7	4	11	0	0	11	0	0
5	6959839	.	C	T	7	5	12	0	0	12	0	0
5	7498844	.	C	A	2	3	5	0	0	5	0	0
5	7499034	.	G	A	4	3	7	0	0	7	0	0
5	7499037	.	G	A	3	4	7	0	0	7	0	0
5	7504448	.	C	T	5	2	7	0	0	7	0	0
5	8006206	.	A	G	3	7	10	0	0	10	0	0
5	8006474	.	A	G	14	3	17	0	2	19	0	0
5	8006503	.	A	G	9	8	17	0	1	18	0	0
5	8006977	.	A	G	14	12	26	0	0	26	0	0
5	8015099	.	C	T	0	5	5	0	8	13	0	0
5	8015165	.	G	A	4	6	10	0	0	10	0	0
5	8015192	.	C	T	0	5	5	0	7	12	0	0
5	8015252	.	C	T	7	3	10	0	0	10	0	0
5	8015361	.	G	T	13	7	20	0	4	24	0	0
5	8019962	.	A	G	6	10	16	0	0	16	0	0
5	8020001	.	C	T	6	8	14	0	0	14	0	0
5	8033036	.	A	G	4	6	10	0	0	10	0	0
5	8043891	.	C	T	3	4	7	0	0	7	0	0
5	10046718	.	G	A	1	2	3	0	3	6	0	0
5	10051017	.	G	A	0	4	4	0	1	5	0	0
5	10084310	.	C	T	5	3	8	0	0	8	0	0
5	10766286	.	G	A	4	12	16	0	3	19	0	0
5	10766505	.	A	G	17	20	37	4	3	44	0	0
5	10766529	.	G	A	18	13	31	8	4	43	0	0
5	10766879	.	A	G	19	12	31	0	2	33	0	0
5	10767113	.	C	T	15	10	25	0	1	26	0	0
5	10767259	.	A	G	16	21	37	0	0	37	0	0
5	10767456	.	G	A	5	3	8	0	0	8	0	0
5	10767588	.	C	T	3	3	6	0	0	6	0	0
5	10767622	.	T	C	0	0	0	0	4	4	0	0
5	10768089	.	G	A	4	3	7	0	0	7	0	0
5	10768182	.	G	A	2	4	6	0	0	6	0	0
5	10946038	.	G	A	3	3	6	0	0	6	0	0
5	10946085	.	G	T	6	3	9	0	0	9	0	0
5	11244675	.	A	G	3	2	5	0	0	5	0	0
5	11250049	.	C	T	2	2	4	0	0	4	0	0
5	11507602	.	A	G	5	3	8	0	0	8	0	0
5	11812278	.	C	T	3	3	6	0	1	7	0	0
5	11824059	.	G	A	0	5	5	0	3	8	0	0
5	11824188	.	T	C	2	4	6	0	1	7	0	0
5	11826347	.	T	C	2	6	8	0	1	9	0	0
5	11836437	.	T	C	6	13	19	0	0	19	0	0
5	11863501	.	G	A	2	2	4	0	0	4	0	0
5	11864022	.	A	G	1	6	7	0	0	7	0	0
5	11864572	.	C	G	2	2	4	0	0	4	0	0
5	11864774	.	T	G	13	7	20	0	1	21	0	0
5	11869576	.	C	A	0	7	7	0	9	16	0	0
5	11905661	.	T	C	1	0	1	0	3	4	0	0
5	11905725	.	C	T	1	2	3	0	0	3	0	0
5	11905890	.	A	G	4	10	14	0	1	15	0	0
5	11905903	.	T	G	6	4	10	0	0	10	0	0
5	11917125	.	C	T	8	8	16	0	1	17	0	0
5	11917405	.	G	A	12	7	19	0	1	20	0	0
5	11917436	.	G	A	5	15	20	0	1	21	0	0
5	11917485	.	G	A	13	11	24	0	0	24	0	0
5	11917596	.	C	A	0	14	14	0	14	28	0	0
5	11933155	.	A	G	9	5	14	0	1	15	0	0
5	11935444	.	G	A	3	3	6	0	1	7	0	0
5	11937486	.	G	A	5	4	9	0	0	9	0	0
5	11937564	.	A	T	5	3	8	0	1	9	0	0
5	11941903	.	T	C	3	1	4	0	4	8	0	0
5	11943868	.	G	A	7	8	15	0	1	16	0	0
5	11943934	.	C	A	3	5	8	0	1	9	0	0
5	11943948	.	T	A	4	6	10	0	0	10	0	0
5	11943989	.	G	A	2	4	6	0	1	7	0	0
5	11944060	.	T	G	4	3	7	0	0	7	0	0
5	11949244	.	G	T	11	7	18	0	0	18	0	0
5	11959776	.	G	T	1	22	23	0	9	32	0	0
5	11959777	.	C	T	22	10	32	0	1	33	0	0
5	11959818	.	C	T	12	23	35	0	3	38	0	0
5	11959966	.	C	G	12	4	16	0	2	18	0	0
5	11959988	.	G	A	1	12	13	0	6	19	0	0
5	11982950	.	C	A	5	6	11	0	0	11	0	0
5	11983017	.	T	C	9	7	16	0	0	16	0	0
5	11983085	.	C	T	0	3	3	0	3	6	0	0
5	11983395	.	T	A	6	6	12	1	0	13	0	0
5	11983548	.	C	G	5	12	17	0	0	17	0	0
5	11984086	.	T	C	3	4	7	0	0	7	0	0
5	11984133	.	C	T	2	3	5	0	1	6	0	0
5	11984354	.	C	T	3	4	7	0	0	7	0	0
5	11984419	.	C	A	1	2	3	0	1	4	0	0
5	11984808	.	C	T	2	2	4	0	0	4	0	0
5	11985133	.	A	T	1	5	6	0	0	6	0	0
5	11985546	.	A	T	4	5	9	0	1	10	0	0
5	11985626	.	A	T	3	2	5	0	0	5	0	0
5	11986597	.	A	G	1	2	3	0	0	3	0	0
5	12000924	.	A	G	3	3	6	0	0	6	0	0
5	12044753	.	T	C	2	0	2	0	4	6	0	0
5	12100335	.	G	A	2	2	4	0	0	4	0	0
5	12284075	.	C	T	14	21	35	0	2	37	0	0
5	12285172	.	T	C	9	0	9	0	10	19	0	0
5	12285316	.	C	T	2	3	5	0	0	5	0	0
5	12285504	.	C	A	3	3	6	0	1	7	0	0
5	12285601	.	C	G	3	4	7	0	0	7	0	0
5	12288511	.	T	C	6	6	12	0	4	16	0	0
5	12288541	.	A	G	9	7	16	0	1	17	0	0
5	12297084	.	C	T	11	5	16	0	2	18	0	0
5	12322321	.	G	A	3	2	5	0	1	6	0	0
5	12357538	.	G	A	7	5	12	0	2	14	0	0
5	12357554	.	C	T	11	4	15	0	1	16	0	0
5	12503554	.	G	A	3	2	5	0	0	5	0	0
5	12524938	.	A	G	3	4	7	0	0	7	0	0
5	12530423	.	G	T	1	3	4	0	0	4	0	0
5	12530425	.	C	A	2	3	5	0	0	5	0	0
5	12533197	.	C	T	2	3	5	0	1	6	0	0
5	12549258	.	C	T	13	5	18	0	0	18	0	0
5	12549326	.	C	T	5	8	13	0	0	13	0	0
5	12549776	.	G	T	1	3	4	0	0	4	0	0
5	12549807	.	A	G	3	5	8	0	0	8	0	0
5	12549981	.	G	T	3	3	6	0	0	6	0	0
5	12553935	.	C	T	0	3	3	0	1	4	0	0
5	12615809	.	C	T	1	2	3	0	0	3	0	0
5	12645971	.	G	A	1	2	3	0	0	3	0	0
5	12664278	.	G	A	3	5	8	0	0	8	0	0
5	12724121	.	C	T	11	6	17	0	1	18	0	0
5	12724224	.	G	A	14	10	24	0	0	24	0	0
5	12724249	.	A	C	11	8	19	0	0	19	0	0
5	12724292	.	C	A	11	6	17	1	1	19	0	0
5	12724307	.	A	G	6	9	15	1	2	18	0	0
5	12724412	.	A	G	6	5	11	0	0	11	0	0
5	12724450	.	C	T	2	9	11	0	7	18	0	0
5	12724505	.	C	A	13	20	33	0	3	36	0	0
5	12724518	.	G	C	15	2	17	0	21	38	0	0
5	12724567	.	A	G	13	16	29	0	3	32	0	0
5	12724694	.	C	T	2	10	12	0	19	31	0	0
5	12725930	.	G	A	16	27	43	0	2	45	0	0
5	12726842	.	A	G	17	19	36	1	0	37	0	0
5	12729397	.	C	T	7	5	12	0	1	13	0	0
5	12732247	.	C	T	8	7	15	0	0	15	0	0
5	12734883	.	G	T	9	7	16	0	2	18	0	0
5	12734910	.	T	C	7	11	18	0	0	18	0	0
5	12743159	.	A	T	1	2	3	0	0	3	0	0
5	12837064	.	G	A	1	2	3	0	1	4	0	0
5	12859258	.	T	C	21	13	34	0	1	35	0	0
5	12906014	.	C	T	3	3	6	0	0	6	0	0
5	12906273	.	C	T	4	3	7	0	1	8	0	0
5	12908828	.	C	A	2	3	5	0	0	5	0	0
5	12926507	.	C	A	3	3	6	0	0	6	0	0
5	12956918	.	T	C	3	2	5	0	1	6	0	0
5	12956960	.	C	T	4	5	9	0	0	9	0	0
5	12975297	.	G	A	1	8	9	0	9	18	0	0
5	12975532	.	C	T	9	7	16	0	2	18	0	0
5	12979889	.	C	T	4	7	11	0	0	11	0	0
5	13037199	.	C	T	0	5	5	0	6	11	0	0
5	13037203	.	C	T	1	7	8	0	5	13	0	0
5	13037939	.	T	G	5	3	8	0	3	11	0	0
5	13037967	.	G	A	7	8	15	0	1	16	0	0
5	13037998	.	A	G	10	9	19	0	0	19	0	0
5	13105020	.	C	T	15	16	31	1	7	39	0	0
5	13105070	.	C	A	2	20	22	0	14	36	0	0
5	13167048	.	A	T	3	6	9	0	0	9	0	0
5	13214637	.	C	G	3	5	8	0	2	10	0	0
5	13223062	.	G	A	1	5	6	0	0	6	0	0
5	13227057	.	C	T	0	3	3	0	1	4	0	0
5	13229024	.	C	A	2	5	7	0	0	7	0	0
5	13239172	.	A	G	1	3	4	0	0	4	0	0
5	13308738	.	G	A	4	2	6	0	0	6	0	0
5	13308778	.	A	C	0	5	5	0	1	6	0	0
5	13308959	.	G	A	6	7	13	0	0	13	0	0
5	13308985	.	T	C	3	4	7	0	1	8	0	0
5	13308997	.	G	T	5	6	11	0	1	12	0	0
5	13309174	.	T	C	11	0	11	0	23	34	0	0
5	13309215	.	C	T	12	9	21	0	1	22	0	0
5	13309273	.	C	T	8	14	22	0	2	24	0	0
5	13309309	.	G	A	11	15	26	0	0	26	0	0
5	13309402	.	A	G	12	11	23	0	1	24	0	0
5	13309435	.	A	T	16	16	32	0	1	33	0	0
5	13309522	.	G	A	11	15	26	1	0	27	0	0
5	13312671	.	A	T	17	13	30	0	1	31	0	0
5	13312746	.	G	A	13	11	24	0	0	25	1	0
5	13315490	.	G	C	6	12	18	0	3	21	0	0
5	13315526	.	T	C	5	9	14	0	1	15	0	0
5	13315603	.	A	C	11	10	21	0	1	22	0	0
5	13326911	.	G	A	0	5	5	0	4	9	0	0
5	13326920	.	G	A	5	4	9	0	0	9	0	0
5	13329785	.	G	C	5	5	10	0	0	10	0	0
5	13332930	.	A	G	3	2	5	0	0	5	0	0
5	13335291	.	C	T	5	2	7	0	1	8	0	0
5	13335333	.	G	A	5	8	13	0	0	13	0	0
5	13335373	.	G	T	0	3	3	0	6	9	0	0
5	13335423	.	C	T	6	6	12	0	0	12	0	0
5	13337803	.	C	T	9	15	24	0	0	24	0	0
5	13337883	.	T	A	12	17	29	1	3	33	0	0
5	13338441	.	C	T	1	11	12	0	24	36	0	0
5	13338762	.	A	T	6	9	15	0	2	17	0	0
5	13339038	.	G	C	15	13	28	2	12	42	0	0
5	13385916	.	T	A	3	3	6	0	0	6	0	0
5	13419418	.	T	C	4	3	7	0	0	7	0	0
5	13465095	.	T	C	2	3	5	0	0	5	0	0
5	13468108	.	G	T	1	3	4	0	2	6	0	0
5	13468172	.	C	T	4	6	10	0	0	10	0	0
5	13468574	.	G	A	2	5	7	0	1	8	0	0
5	13468655	.	G	A	4	4	8	0	0	8	0	0
5	13468656	.	A	T	4	4	8	0	0	8	0	0
5	13469105	.	T	A	3	4	7	0	0	7	0	0
5	13469137	.	C	A	3	4	7	0	0	7	0	0
5	13539493	.	A	G	1	0	1	0	3	4	0	0
5	13540689	.	C	T	4	5	9	0	0	9	0	0
5	13540738	.	C	T	4	4	8	0	0	8	0	0
5	13540846	.	T	A	2	3	5	0	0	5	0	0
5	13615482	.	C	T	2	3	5	0	0	5	0	0
5	13643325	.	G	A	18	17	35	0	1	36	0	0
5	13643411	.	C	T	1	30	31	0	21	52	0	0
5	13643824	.	G	A	19	18	37	0	0	37	0	0
5	13644126	.	A	T	24	20	44	0	1	45	0	0
5	13644185	.	T	G	17	16	33	0	1	34	0	0
5	13644189	.	T	G	18	18	36	0	0	36	0	0
5	13644227	.	A	G	14	19	33	3	0	36	0	0
5	13644256	.	A	T	16	16	32	5	2	39	0	0
5	13644581	.	T	G	15	21	36	0	4	40	0	0
5	13644602	.	T	A	18	18	36	0	1	38	1	0
5	13644781	.	C	T	12	10	22	0	1	23	0	0
5	13644797	.	A	G	6	13	19	0	0	19	0	0
5	13645047	.	C	G	17	9	26	0	2	28	0	0
5	13645746	.	A	G	14	13	27	0	2	29	0	0
5	13645885	.	T	C	13	13	26	0	0	27	1	0
5	13645948	.	G	A	3	3	6	1	0	7	0	0
5	13649518	.	C	T	20	19	39	0	2	41	0	0
5	13652410	.	T	C	19	13	32	0	4	36	0	0
5	13671624	.	G	T	4	4	8	0	2	10	0	0
5	13671631	.	A	C	4	6	10	0	1	11	0	0
5	13671899	.	C	G	14	9	23	0	1	24	0	0
5	13672004	.	C	T	2	21	23	0	6	29	0	0
5	13672211	.	C	T	15	22	37	0	2	39	0	0
5	13672232	.	C	T	18	16	34	0	2	36	0	0
5	13673016	.	C	G	1	18	19	0	14	33	0	0
5	13684132	.	A	G	8	14	22	0	0	22	0	0
5	13684502	.	C	A	6	10	16	0	7	23	0	0
5	13684983	.	G	T	5	2	7	0	0	7	0	0
5	14322433	.	A	T	1	3	4	0	0	4	0	0
5	15357517	.	A	G	12	8	20	0	2	22	0	0
5	15360868	.	G	A	2	1	3	0	2	5	0	0
5	15812779	.	G	A	1	6	7	0	0	7	0	0
5	17726347	.	A	C	0	0	0	0	8	8	0	0
5	18827341	.	T	C	2	2	4	0	0	4	0	0
5	18827368	.	T	C	1	2	3	0	0	3	0	0
5	18935161	.	A	G	8	5	13	1	1	15	0	0
5	18935168	.	A	G	6	5	11	1	2	14	0	0
5	19008334	.	A	G	27	3	30	3	13	46	0	0
5	19437865	.	G	A	4	3	7	0	0	7	0	0
5	19932234	.	A	G	4	2	6	0	0	6	0	0
5	19949286	.	C	T	7	2	9	0	0	9	0	0
5	20417308	.	A	G	3	0	3	0	3	6	0	0
5	20419351	.	C	G	8	4	12	0	3	15	0	0
5	20787190	.	T	C	5	6	11	0	0	11	0	0
5	20787786	.	A	C	1	6	7	0	2	9	0	0
5	20933321	.	C	A	3	40	43	0	2	45	0	0
5	20933332	.	T	C	4	2	6	4	40	50	0	0
5	22012345	.	T	C	7	2	9	0	1	10	0	0
5	22012459	.	T	C	5	8	13	0	0	13	0	0
5	22012895	.	T	C	6	5	11	0	0	11	0	0
5	23147127	.	T	C	2	15	17	0	4	21	0	0
5	23397221	.	T	C	10	7	17	0	0	17	0	0
5	23489207	.	T	A	8	2	10	0	0	11	1	0
5	23489208	.	C	A	9	2	11	0	0	11	0	0
5	23574742	.	T	C	2	6	8	0	0	8	0	0
5	23574752	.	T	C	3	5	8	0	0	8	0	0
5	23575646	.	T	C	3	2	5	0	0	5	0	0
5	24163098	.	A	G	3	3	6	0	1	7	0	0
5	24163099	.	A	G	2	4	6	0	1	7	0	0
5	24532661	.	T	C	1	0	1	0	6	7	0	0
5	24756844	.	G	A	13	17	30	4	4	38	0	0
5	24818488	.	T	C	7	7	14	0	0	14	0	0
5	24818512	.	T	C	7	0	7	0	8	15	0	0
5	24818523	.	T	C	5	8	13	0	0	13	0	0
5	24818564	.	T	C	4	5	9	0	2	11	0	0
5	26062514	.	A	G	4	2	6	0	0	6	0	0
5	26062582	.	A	G	6	2	8	0	1	9	0	0
5	26263194	.	C	T	13	5	18	0	1	19	0	0
5	26722583	.	A	C	1	4	5	0	0	5	0	0
5	28486981	.	G	T	6	2	8	0	0	8	0	0
5	30055414	.	T	C	1	4	5	0	0	5	0	0
5	30208505	.	C	T	1	2	3	0	0	3	0	0
5	30605934	.	A	G	1	3	4	0	2	6	0	0
5	30606225	.	A	G	6	3	9	0	0	9	0	0
5	30606287	.	A	G	2	0	2	0	2	4	0	0
5	31108096	.	A	T	4	3	7	0	0	7	0	0
5	33329786	.	A	G	6	6	12	0	1	13	0	0
5	35124435	.	T	C	12	0	12	0	12	24	0	0
5	35124479	.	C	T	2	9	11	0	12	23	0	0
5	35124859	.	C	T	4	3	7	0	0	7	0	0
5	35124939	.	G	A	5	7	12	0	0	12	0	0
5	35125414	.	C	T	0	3	3	0	1	4	0	0
5	35125423	.	C	T	1	4	5	0	0	5	0	0
5	35125882	.	G	A	3	3	6	0	0	6	0	0
5	35125883	.	A	T	4	3	7	0	0	7	0	0
5	35135687	.	G	A	2	4	6	0	3	9	0	0
5	35137621	.	C	T	0	3	3	0	7	10	0	0
5	35202876	.	A	T	7	10	17	0	3	20	0	0
5	35202958	.	G	A	9	12	21	0	4	30	5	0
5	35202959	.	A	T	17	11	28	0	3	31	0	0
5	35203092	.	G	A	5	11	16	0	3	19	0	0
5	35203486	.	C	A	6	7	13	0	1	14	0	0
5	35203629	.	C	T	2	15	17	0	2	19	0	0
5	35204077	.	T	G	7	7	14	0	0	14	0	0
5	35204159	.	C	T	8	11	19	0	1	20	0	0
5	35204322	.	A	G	1	5	6	0	0	6	0	0
5	35204353	.	C	T	2	7	9	0	1	10	0	0
5	35204390	.	G	A	2	9	11	0	1	12	0	0
5	35204681	.	A	C	5	11	16	0	1	17	0	0
5	35204689	.	A	C	5	0	5	0	11	16	0	0
5	35204754	.	C	T	4	7	11	0	0	11	0	0
5	35205005	.	G	A	7	9	16	0	0	16	0	0
5	35207914	.	T	G	7	7	14	0	0	14	0	0
5	35220402	.	T	A	2	2	4	0	0	4	0	0
5	35271001	.	C	T	18	25	43	0	3	46	0	0
5	35271154	.	A	T	29	15	44	0	0	44	0	0
5	35271181	.	A	G	33	20	53	0	3	56	0	0
5	35271194	.	G	A	39	25	64	0	2	66	0	0
5	35271309	.	T	A	31	26	57	0	3	60	0	0
5	35271465	.	T	C	27	24	51	0	0	51	0	0
5	35271824	.	C	A	19	18	37	0	1	38	0	0
5	35272032	.	G	A	10	19	29	0	0	29	0	0
5	35272438	.	C	T	1	16	17	0	23	40	0	0
5	35272497	.	G	A	15	16	31	0	0	31	0	0
5	35272560	.	T	G	17	13	30	0	0	30	0	0
5	35273062	.	G	A	27	17	44	0	2	46	0	0
5	35273225	.	T	C	15	19	34	0	2	36	0	0
5	35273447	.	A	G	16	8	24	0	2	26	0	0
5	35273509	.	A	T	17	7	24	0	1	25	0	0
5	35273546	.	A	T	13	6	19	0	1	20	0	0
5	35273564	.	G	A	12	8	20	0	0	20	0	0
5	35273708	.	T	C	11	9	20	0	0	20	0	0
5	35273793	.	A	T	16	14	30	0	0	30	0	0
5	35273838	.	A	C	20	14	34	0	3	37	0	0
5	35273992	.	A	G	16	9	25	0	0	25	0	0
5	35274398	.	G	A	12	12	24	0	0	24	0	0
5	35275103	.	C	T	11	9	20	0	1	21	0	0
5	35275859	.	G	T	11	5	16	0	0	16	0	0
5	35276154	.	A	G	15	6	21	0	2	23	0	0
5	35276303	.	G	C	9	8	17	0	1	18	0	0
5	35276386	.	G	A	5	7	12	0	0	12	0	0
5	35276580	.	A	G	6	5	11	0	0	11	0	0
5	35276811	.	C	G	3	3	6	0	1	7	0	0
5	35276911	.	C	T	1	3	4	0	3	7	0	0
5	35277184	.	T	A	4	3	7	0	0	7	0	0
5	35277280	.	T	C	1	2	3	0	0	3	0	0
5	35277459	.	T	C	6	5	11	0	0	11	0	0
5	35278237	.	A	T	1	3	4	0	0	4	0	0
5	35278933	.	T	C	4	0	4	0	3	7	0	0
5	35279065	.	A	G	1	3	4	0	0	4	0	0
5	35279230	.	T	G	2	3	5	0	0	5	0	0
5	35279275	.	T	G	2	4	6	0	2	8	0	0
5	35279884	.	G	A	1	1	2	0	1	3	0	0
5	35422324	.	T	C	3	4	7	0	1	8	0	0
5	35422402	.	A	G	6	3	9	0	0	9	0	0
5	35422530	.	C	T	6	2	8	0	0	8	0	0
5	35431641	.	A	G	6	7	13	0	3	16	0	0
5	35431703	.	T	G	3	7	10	0	3	13	0	0
5	35454464	.	C	T	12	11	23	0	3	26	0	0
5	35475907	.	A	T	3	3	6	0	0	6	0	0
5	35478593	.	G	C	0	4	4	0	1	5	0	0
5	35486822	.	C	T	2	2	4	0	0	4	0	0
5	35486827	.	G	A	2	1	3	0	1	4	0	0
5	35486917	.	C	A	3	2	5	0	0	5	0	0
5	35486955	.	T	C	7	2	9	0	2	11	0	0
5	35487030	.	A	G	4	7	11	0	1	12	0	0
5	35487332	.	T	A	6	4	10	0	0	10	0	0
5	35487407	.	A	T	5	4	9	0	1	10	0	0
5	35487416	.	G	C	7	3	10	0	0	10	0	0
5	35487767	.	T	G	4	0	4	0	6	10	0	0
5	35487781	.	C	G	3	4	7	0	0	7	0	0
5	35683116	.	G	A	4	4	8	0	0	8	0	0
5	35683134	.	C	A	4	4	8	0	0	8	0	0
5	35683185	.	G	A	1	3	4	0	0	4	0	0
5	35683225	.	C	A	1	3	4	0	1	5	0	0
5	35712859	.	A	G	0	2	2	0	1	3	0	0
5	35748938	.	T	C	3	6	9	0	0	9	0	0
5	35749470	.	A	G	6	3	9	0	0	9	0	0
5	35751883	.	G	T	4	6	10	0	0	10	0	0
5	35751977	.	A	G	8	9	17	0	2	19	0	0
5	35754284	.	A	G	9	0	9	0	19	28	0	0
5	35754424	.	T	C	13	17	30	0	3	33	0	0
5	35754431	.	A	G	13	2	15	0	17	32	0	0
5	35754503	.	A	C	11	14	25	0	2	27	0	0
5	35754599	.	T	A	16	14	30	0	0	30	0	0
5	35754663	.	A	G	16	7	23	0	1	24	0	0
5	35955514	.	T	C	8	14	22	0	1	23	0	0
5	35967234	.	C	T	9	8	17	0	1	18	0	0
5	35967270	.	T	A	6	4	10	0	0	10	0	0
5	35967500	.	A	G	1	0	1	0	6	7	0	0
5	36271160	.	T	G	2	4	6	0	0	6	0	0
5	36274750	.	C	A	3	4	7	0	0	7	0	0
5	36416204	.	A	G	9	6	15	0	2	17	0	0
5	36416307	.	C	G	11	0	11	0	17	28	0	0
5	36416367	.	G	A	2	6	8	0	10	18	0	0
5	36416478	.	G	T	12	19	31	0	1	32	0	0
5	36416583	.	C	T	11	20	31	0	0	31	0	0
5	36421991	.	G	A	3	13	16	0	9	25	0	0
5	36530959	.	A	T	6	6	12	0	0	12	0	0
5	36536665	.	T	C	11	11	22	0	0	22	0	0
5	36536742	.	C	T	20	13	33	0	3	36	0	0
5	36536859	.	A	G	4	1	5	0	9	14	0	0
5	36536910	.	G	A	8	4	12	0	2	14	0	0
5	36537020	.	A	G	11	4	15	0	2	17	0	0
5	36537021	.	T	A	12	4	16	0	1	17	0	0
5	36537057	.	G	A	10	4	14	0	0	14	0	0
5	36537073	.	A	C	14	4	18	0	0	18	0	0
5	36537126	.	G	A	11	12	23	0	0	23	0	0
5	36537231	.	A	T	10	8	18	0	1	19	0	0
5	36537246	.	A	G	14	0	14	0	6	20	0	0
5	36537334	.	A	T	8	8	16	2	0	18	0	0
5	36537352	.	G	A	10	4	14	2	0	16	0	0
5	36537611	.	C	A	7	12	19	0	3	22	0	0
5	36537672	.	C	A	12	11	23	0	0	23	0	0
5	36537927	.	T	C	5	3	8	0	0	8	0	0
5	36558059	.	G	A	13	24	37	0	1	38	0	0
5	36558348	.	A	G	23	11	34	0	0	34	0	0
5	36558369	.	G	A	21	9	30	0	2	32	0	0
5	36558441	.	C	T	23	13	36	0	0	36	0	0
5	36563257	.	T	C	8	11	19	0	0	19	0	0
5	36564205	.	A	G	8	18	26	0	0	26	0	0
5	36564206	.	A	T	8	18	26	0	0	26	0	0
5	36567750	.	C	A	1	6	7	0	2	9	0	0
5	36570280	.	G	A	5	10	15	0	0	15	0	0
5	36583271	.	A	G	6	3	9	0	1	10	0	0
5	36583575	.	C	T	1	6	7	0	1	8	0	0
5	36584985	.	C	T	2	4	6	0	0	6	0	0
5	36585662	.	G	A	2	5	7	0	0	7	0	0
5	36586190	.	G	A	1	2	3	0	0	3	0	0
5	36586192	.	C	G	1	2	3	0	0	3	0	0
5	36586906	.	C	G	0	2	2	0	3	5	0	0
5	36595772	.	A	T	4	6	10	0	0	10	0	0
5	36595912	.	G	A	5	5	10	0	2	12	0	0
5	36596106	.	A	G	0	3	3	0	1	4	0	0
5	36596278	.	G	A	4	2	6	0	1	7	0	0
5	36596294	.	G	A	3	2	5	0	0	5	0	0
5	36596378	.	G	A	3	3	6	0	0	6	0	0
5	36596397	.	T	A	3	3	6	0	0	6	0	0
5	36596517	.	C	A	0	2	2	0	2	5	1	0
5	36609286	.	G	A	2	2	4	0	0	4	0	0
5	36609412	.	G	A	3	6	9	0	0	9	0	0
5	36609442	.	G	A	0	4	4	0	1	5	0	0
5	36609469	.	T	C	1	2	3	0	0	3	0	0
5	36624620	.	G	A	0	8	8	0	4	12	0	0
5	36650153	.	C	A	6	2	8	0	0	8	0	0
5	36650176	.	A	T	5	2	7	0	0	7	0	0
5	36653522	.	G	A	4	4	8	0	0	8	0	0
5	36653876	.	T	G	4	0	4	0	8	12	0	0
5	36654147	.	G	A	2	10	12	0	8	20	0	0
5	36654334	.	A	T	4	2	6	0	0	6	0	0
5	36654344	.	G	A	3	2	5	0	0	5	0	0
5	36665351	.	C	T	11	12	23	0	2	25	0	0
5	36668321	.	C	T	5	4	9	0	1	10	0	0
5	36673347	.	C	T	4	5	9	0	0	9	0	0
5	36673470	.	C	A	4	4	8	0	2	10	0	0
5	36673609	.	A	G	8	7	15	0	0	15	0	0
5	36673687	.	A	T	4	5	9	0	0	9	0	0
5	36674005	.	A	T	6	2	8	0	0	8	0	0
5	36674796	.	G	C	8	4	12	0	0	12	0	0
5	36674831	.	C	T	10	4	14	0	0	14	0	0
5	36698222	.	A	G	1	2	3	0	0	3	0	0
5	36732199	.	G	C	19	15	34	0	0	34	0	0
5	36732217	.	A	G	17	10	27	0	4	31	0	0
5	36739134	.	T	C	14	12	26	0	3	29	0	0
5	36739310	.	T	A	14	11	25	0	3	28	0	0
5	36739316	.	T	C	17	11	28	0	0	28	0	0
5	36739352	.	T	A	20	10	30	0	2	32	0	0
5	36739361	.	T	C	19	12	31	0	1	32	0	0
5	36786641	.	G	A	0	2	2	0	2	4	0	0
5	36802395	.	A	C	1	4	5	0	0	5	0	0
5	36851191	.	C	T	4	5	9	0	0	9	0	0
5	36852564	.	A	G	5	0	5	0	6	11	0	0
5	36852848	.	G	A	0	7	7	0	2	9	0	0
5	36853849	.	C	G	10	12	22	0	1	23	0	0
5	36895627	.	G	A	1	2	3	0	1	4	0	0
5	36897958	.	A	T	2	1	3	0	1	4	0	0
5	36898476	.	C	T	22	26	48	0	3	51	0	0
5	36898668	.	A	G	34	1	35	0	26	61	0	0
5	36901003	.	T	G	9	4	13	0	1	14	0	0
5	36902610	.	A	G	12	0	12	0	9	21	0	0
5	36902628	.	T	C	13	8	21	0	1	22	0	0
5	36908034	.	T	C	24	18	42	0	0	42	0	0
5	36913445	.	T	C	1	2	3	0	0	3	0	0
5	36913570	.	A	G	1	1	2	0	1	3	0	0
5	36913916	.	A	T	3	5	8	0	0	8	0	0
5	36914002	.	C	T	4	6	10	0	3	13	0	0
5	36914018	.	A	C	3	0	3	0	5	8	0	0
5	36916370	.	A	T	5	2	7	0	0	7	0	0
5	36922399	.	A	G	2	3	5	0	0	5	0	0
5	36945378	.	T	A	24	19	43	6	1	50	0	0
5	36945383	.	A	T	25	20	45	6	1	52	0	0
5	36945463	.	T	A	45	17	62	0	1	63	0	0
5	36945518	.	T	G	32	19	51	1	6	58	0	0
5	36945719	.	G	T	30	36	66	1	17	84	0	0
5	36945747	.	T	A	27	38	65	1	14	80	0	0
5	36945927	.	A	C	30	39	69	0	4	73	0	0
5	36945937	.	C	T	32	37	69	0	1	70	0	0
5	36946244	.	A	G	34	32	66	0	8	74	0	0
5	36946261	.	T	C	40	8	48	0	27	75	0	0
5	36946341	.	C	T	4	31	35	0	35	70	0	0
5	36996458	.	A	G	8	6	14	0	0	14	0	0
5	36996638	.	A	G	9	0	9	0	19	28	0	0
5	36997133	.	A	G	21	11	32	0	1	33	0	0
5	37032095	.	A	G	6	10	16	0	1	17	0	0
5	37032191	.	T	C	4	6	10	0	2	12	0	0
5	37032280	.	C	G	5	13	18	0	1	19	0	0
5	37032339	.	A	G	12	0	12	0	10	22	0	0
5	37032611	.	T	C	9	6	15	0	0	15	0	0
5	37032782	.	G	A	10	10	20	0	2	22	0	0
5	37032799	.	A	T	10	13	23	0	0	23	0	0
5	37032959	.	A	G	10	9	19	0	2	21	0	0
5	37034111	.	T	C	10	10	20	0	3	23	0	0
5	37036404	.	T	C	12	7	19	0	0	19	0	0
5	37036648	.	A	G	13	0	13	0	6	19	0	0
5	37036662	.	T	A	12	4	16	0	1	17	0	0
5	37036856	.	T	C	6	8	14	0	1	15	0	0
5	37036975	.	A	T	5	6	11	0	1	12	0	0
5	37037079	.	C	T	20	10	30	0	1	31	0	0
5	37037152	.	T	C	8	22	30	0	1	31	0	0
5	37037308	.	C	A	5	6	11	0	5	16	0	0
5	37037436	.	G	T	2	8	10	0	4	14	0	0
5	37037583	.	T	C	13	15	28	0	1	29	0	0
5	37037617	.	A	T	15	15	30	0	0	30	0	0
5	37037669	.	T	G	16	17	33	0	2	35	0	0
5	37037742	.	A	T	24	21	45	0	1	46	0	0
5	37038017	.	T	C	4	7	11	0	4	15	0	0
5	37061485	.	G	A	18	11	29	0	1	30	0	0
5	37061487	.	C	T	18	11	29	0	1	30	0	0
5	37065416	.	T	C	27	11	38	0	0	38	0	0
5	37065729	.	C	T	16	7	23	0	0	28	5	0
5	37095066	.	A	C	5	2	7	0	0	7	0	0
5	37280125	.	A	G	1	4	5	0	0	5	0	0
5	37286325	.	A	G	3	0	3	0	6	9	0	0
5	37293768	.	G	A	1	6	7	0	1	8	0	0
5	37293815	.	T	C	1	8	9	0	0	9	0	0
5	37293841	.	G	A	1	8	9	0	0	9	0	0
5	37294077	.	G	A	1	3	4	0	0	4	0	0
5	37295646	.	C	T	4	8	12	0	1	13	0	0
5	37296298	.	C	T	2	4	6	0	0	6	0	0
5	37301236	.	G	A	10	6	16	0	3	19	0	0
5	37301249	.	C	T	10	8	18	0	1	19	0	0
5	37301282	.	C	T	7	8	15	0	1	16	0	0
5	37301505	.	A	G	10	5	15	0	1	16	0	0
5	37301783	.	A	G	10	14	24	0	1	25	0	0
5	37304028	.	T	C	11	9	20	0	0	20	0	0
5	37304070	.	G	T	9	8	17	0	1	18	0	0
5	37307921	.	C	G	20	15	35	0	3	38	0	0
5	37309734	.	A	G	22	18	40	0	0	40	0	0
5	37309881	.	C	T	26	24	50	0	0	50	0	0
5	37331854	.	C	T	3	1	4	0	1	5	0	0
5	37333870	.	G	A	12	8	20	0	0	20	0	0
5	37413762	.	G	A	2	3	5	0	0	5	0	0
5	37422999	.	A	T	5	4	9	0	1	10	0	0
5	37423193	.	G	A	3	2	5	0	0	5	0	0
5	37439388	.	C	T	8	5	13	0	0	13	0	0
5	37439418	.	C	T	7	6	13	0	1	14	0	0
5	37439505	.	T	C	6	11	17	0	0	17	0	0
5	37439517	.	A	C	6	9	15	0	1	16	0	0
5	37439891	.	T	C	17	16	33	0	1	34	0	0
5	37505245	.	G	A	4	4	8	0	0	8	0	0
5	37507823	.	T	C	2	3	5	0	1	6	0	0
5	37507901	.	C	T	3	2	5	0	1	6	0	0
5	37508979	.	A	C	2	2	4	0	0	4	0	0
5	37509093	.	A	T	1	2	3	0	0	3	0	0
5	37509102	.	T	C	1	5	6	0	0	6	0	0
5	37509296	.	G	C	8	13	21	0	0	21	0	0
5	37509428	.	T	G	3	5	8	0	1	9	0	0
5	37509703	.	C	T	15	10	25	0	2	27	0	0
5	37509766	.	G	A	1	12	13	0	9	22	0	0
5	37509857	.	A	G	7	8	15	0	0	15	0	0
5	37509916	.	A	G	4	8	12	0	0	12	0	0
5	37510028	.	G	T	8	2	10	0	0	10	0	0
5	37510046	.	A	G	9	4	13	0	0	13	0	0
5	37510208	.	A	G	2	4	6	0	0	7	1	0
5	37510292	.	C	T	2	12	14	0	1	15	0	0
5	37510293	.	T	C	3	12	15	0	0	15	0	0
5	37510574	.	C	G	12	4	16	0	0	16	0	0
5	37568285	.	G	A	1	2	3	0	0	3	0	0
5	37578979	.	G	A	0	3	3	0	2	5	0	0
5	37584160	.	A	G	4	3	7	0	0	7	0	0
5	37584870	.	T	C	1	3	4	0	0	4	0	0
5	37584953	.	A	T	1	3	4	0	1	5	0	0
5	37680403	.	G	A	0	2	2	0	1	3	0	0
5	37688422	.	A	G	2	4	6	0	1	7	0	0
5	37688878	.	A	C	2	8	10	0	0	10	0	0
5	37691223	.	A	G	2	6	8	0	1	9	0	0
5	37692620	.	T	C	2	3	5	0	0	5	0	0
5	37694283	.	G	A	3	5	8	0	1	9	0	0
5	37694568	.	A	C	5	4	9	0	0	9	0	0
5	37695528	.	A	G	2	2	4	0	1	5	0	0
5	37697134	.	C	T	9	8	17	0	1	18	0	0
5	37699115	.	A	G	8	4	12	0	3	15	0	0
5	37700687	.	C	A	9	6	15	0	0	15	0	0
5	37700908	.	T	C	6	7	13	0	3	16	0	0
5	37701262	.	T	A	3	10	13	0	0	13	0	0
5	37702934	.	C	T	14	3	17	0	3	20	0	0
5	37703176	.	G	A	0	10	10	0	7	17	0	0
5	37706798	.	C	T	21	19	40	1	1	42	0	0
5	37707190	.	G	A	16	14	30	0	1	31	0	0
5	37708995	.	A	T	13	22	35	0	3	38	0	0
5	37709057	.	T	A	13	21	34	0	1	35	0	0
5	37757505	.	C	T	7	4	11	0	0	11	0	0
5	37757677	.	C	T	11	3	14	0	1	15	0	0
5	37757690	.	T	C	8	3	11	0	1	12	0	0
5	37838415	.	T	C	33	36	69	0	15	84	0	0
5	37839029	.	G	T	52	49	101	0	7	108	0	0
5	37851082	.	T	A	2	4	6	0	0	6	0	0
5	37851351	.	C	T	1	2	3	0	0	3	0	0
5	37851528	.	T	C	7	3	10	0	1	11	0	0
5	37851542	.	G	A	9	3	12	0	0	12	0	0
5	37851742	.	G	A	5	6	11	0	0	11	0	0
5	37851758	.	T	A	7	9	16	0	0	16	0	0
5	37851830	.	C	A	4	8	12	0	0	12	0	0
5	37851876	.	C	T	9	5	14	0	0	14	0	0
5	37851923	.	G	A	4	4	8	0	0	8	0	0
5	37851962	.	C	T	4	4	8	0	2	10	0	0
5	37851970	.	A	C	5	5	10	0	1	11	0	0
5	37864845	.	A	G	12	5	17	0	1	18	0	0
5	37865628	.	T	C	4	3	7	0	0	7	0	0
5	37865677	.	G	T	4	3	7	0	0	7	0	0
5	37865744	.	C	G	4	3	7	0	0	7	0	0
5	37865830	.	A	G	5	2	7	0	0	7	0	0
5	37866310	.	C	T	7	2	9	0	3	12	0	0
5	37867491	.	C	T	5	3	8	0	0	8	0	0
5	37872801	.	C	T	2	2	4	0	0	4	0	0
5	37912292	.	T	A	22	18	40	0	0	40	0	0
5	37912442	.	A	G	13	12	25	0	1	26	0	0
5	37912489	.	T	A	14	11	25	0	1	26	0	0
5	37912748	.	A	T	16	14	30	0	0	30	0	0
5	37912859	.	A	C	18	14	32	0	1	33	0	0
5	37912970	.	A	C	14	9	23	0	1	24	0	0
5	37913041	.	C	G	11	12	23	0	0	23	0	0
5	37913064	.	T	C	10	12	22	0	1	24	1	0
5	37918855	.	G	A	4	5	9	0	0	9	0	0
5	37918894	.	A	T	4	6	10	0	1	11	0	0
5	37918932	.	A	T	4	3	7	0	0	7	0	0
5	37918994	.	C	T	4	2	6	0	0	6	0	0
5	37963259	.	C	T	6	5	11	0	0	11	0	0
5	37963262	.	G	T	5	6	11	0	0	11	0	0
5	37963316	.	C	A	5	4	9	0	4	13	0	0
5	37963326	.	C	A	7	5	12	0	0	12	0	0
5	37968912	.	T	G	2	7	9	0	0	9	0	0
5	37968951	.	G	A	8	4	12	0	0	12	0	0
5	37970764	.	C	T	8	7	15	0	1	16	0	0
5	37970773	.	A	T	5	8	13	0	1	14	0	0
5	37970818	.	T	G	6	0	6	0	5	11	0	0
5	37981906	.	T	G	3	5	8	0	1	9	0	0
5	37981972	.	C	T	3	3	6	0	0	6	0	0
5	37981997	.	T	C	2	0	2	0	4	6	0	0
5	37982156	.	G	C	6	0	6	0	7	13	0	0
5	37987325	.	C	T	0	4	4	0	8	12	0	0
5	37989090	.	G	A	5	5	10	0	1	11	0	0
5	37989135	.	A	G	10	8	18	0	0	18	0	0
5	37989325	.	G	A	5	11	16	0	1	17	0	0
5	37989379	.	G	T	10	5	15	0	1	16	0	0
5	37989443	.	A	C	8	5	13	0	1	14	0	0
5	37989447	.	A	G	7	5	12	0	0	12	0	0
5	37991350	.	T	A	4	3	7	0	0	7	0	0
5	37991566	.	C	A	0	3	3	0	5	8	0	0
5	38089537	.	T	C	2	3	5	0	0	5	0	0
5	38089578	.	T	G	4	3	7	0	1	8	0	0
5	38089651	.	G	A	5	2	7	0	0	7	0	0
5	38089930	.	G	T	1	3	4	0	0	4	0	0
5	38090070	.	A	G	2	2	4	0	0	4	0	0
5	38090542	.	G	A	2	3	5	0	0	5	0	0
5	38100992	.	T	C	3	2	5	0	0	5	0	0
5	38106815	.	C	T	4	2	6	0	0	6	0	0
5	38110826	.	G	T	12	12	24	0	0	24	0	0
5	38110908	.	A	T	10	7	17	0	0	17	0	0
5	38111060	.	T	C	11	0	11	0	10	21	0	0
5	38115349	.	T	C	9	5	14	0	1	15	0	0
5	38115361	.	T	C	11	4	15	0	0	15	0	0
5	38115395	.	A	G	6	6	12	0	0	12	0	0
5	38115502	.	C	T	7	8	15	0	0	15	0	0
5	38115582	.	C	T	10	7	17	0	0	17	0	0
5	38115685	.	A	T	10	7	17	0	2	19	0	0
5	38115940	.	T	C	3	0	3	0	4	7	0	0
5	38120116	.	A	G	5	2	7	0	0	7	0	0
5	38120117	.	C	A	5	2	7	0	0	7	0	0
5	38121914	.	T	A	5	5	10	0	0	10	0	0
5	38121942	.	A	G	4	6	10	0	1	11	0	0
5	38122100	.	C	A	2	4	6	0	1	7	0	0
5	38122112	.	T	A	3	3	6	0	0	6	0	0
5	38210371	.	T	C	1	2	3	0	0	3	0	0
5	38213052	.	A	G	1	0	1	0	2	3	0	0
5	38213310	.	C	A	1	2	3	0	0	3	0	0
5	38216140	.	C	T	5	6	11	0	0	11	0	0
5	38216175	.	T	G	4	2	6	0	0	6	0	0
5	38216469	.	C	A	4	4	8	0	1	9	0	0
5	38216471	.	C	T	0	4	4	0	5	9	0	0
5	38217224	.	G	A	2	2	4	0	0	4	0	0
5	38217376	.	T	C	4	2	6	0	0	6	0	0
5	38217422	.	G	T	2	3	5	0	0	5	0	0
5	38218105	.	A	T	3	4	7	0	0	7	0	0
5	38251120	.	A	C	4	4	8	0	0	8	0	0
5	38251244	.	T	G	3	2	5	0	0	5	0	0
5	38251506	.	C	T	1	6	7	0	6	13	0	0
5	38251968	.	T	G	4	4	8	0	0	8	0	0
5	38254734	.	A	G	1	3	4	0	1	5	0	0
5	38254919	.	A	G	2	2	4	0	0	4	0	0
5	38255108	.	G	T	2	2	4	0	0	4	0	0
5	38255132	.	G	A	1	4	5	0	0	5	0	0
5	38263384	.	G	A	12	10	22	0	2	24	0	0
5	38263611	.	G	A	10	11	21	0	1	22	0	0
5	38263870	.	C	T	7	8	15	0	1	16	0	0
5	38281540	.	G	C	0	15	15	0	11	26	0	0
5	38287103	.	C	T	15	19	34	0	0	34	0	0
5	38288313	.	T	A	12	15	27	0	1	28	0	0
5	38288346	.	T	A	14	14	28	0	2	30	0	0
5	38289358	.	A	C	16	14	30	0	6	36	0	0
5	38296192	.	C	T	15	21	36	0	1	37	0	0
5	38296193	.	A	G	17	21	38	0	0	38	0	0
5	38296475	.	G	A	23	20	43	0	2	45	0	0
5	38296765	.	A	C	19	22	41	0	1	42	0	0
5	38296799	.	A	C	16	23	39	0	1	40	0	0
5	38297305	.	A	G	23	1	24	0	17	41	0	0
5	38301916	.	C	T	3	3	6	0	0	6	0	0
5	38302085	.	G	A	16	12	28	0	1	29	0	0
5	38302158	.	C	A	20	21	41	0	5	46	0	0
5	38302159	.	A	C	29	15	44	0	1	45	0	0
5	38302490	.	A	G	22	20	42	0	2	44	0	0
5	38302589	.	T	A	18	19	37	0	0	37	0	0
5	38302753	.	G	T	30	18	48	0	3	52	1	0
5	38302859	.	C	T	19	22	41	0	3	45	1	0
5	38302911	.	A	T	21	9	30	0	2	32	0	0
5	38303028	.	G	T	17	29	46	0	4	50	0	0
5	38303301	.	T	C	19	0	19	2	13	34	0	0
5	38303895	.	A	T	32	12	44	0	1	45	0	0
5	38303896	.	G	A	30	12	42	0	3	45	0	0
5	38304578	.	C	T	17	19	36	0	1	37	0	0
5	38304633	.	T	G	14	15	29	0	3	32	0	0
5	38304768	.	G	A	17	19	36	0	2	38	0	0
5	38305068	.	G	A	22	22	44	0	1	45	0	0
5	38305127	.	T	C	18	9	27	0	4	33	2	0
5	38305493	.	C	T	12	10	22	0	0	22	0	0
5	38305698	.	G	A	7	10	17	0	0	17	0	0
5	38308378	.	C	A	14	11	25	1	3	29	0	0
5	38314069	.	C	T	5	4	9	0	2	11	0	0
5	38320825	.	A	G	3	8	11	0	0	11	0	0
5	38369850	.	C	T	2	3	5	0	0	5	0	0
5	38388741	.	C	A	2	3	5	0	0	5	0	0
5	38388786	.	G	A	2	2	4	0	0	4	0	0
5	38389087	.	C	G	2	8	10	0	0	10	0	0
5	38389089	.	G	A	2	8	10	0	0	10	0	0
5	38389147	.	T	C	2	4	6	0	3	9	0	0
5	38389165	.	G	T	6	4	10	0	0	10	0	0
5	38389538	.	G	A	4	5	9	0	1	10	0	0
5	38389811	.	C	T	1	4	5	0	0	5	0	0
5	38390114	.	A	T	1	2	3	0	0	3	0	0
5	38390158	.	T	C	2	2	4	0	0	4	0	0
5	38390162	.	C	T	0	2	2	0	2	4	0	0
5	38390323	.	C	A	2	4	6	0	0	6	0	0
5	38399358	.	C	A	1	2	3	0	0	3	0	0
5	38401395	.	A	G	1	2	3	0	0	3	0	0
5	38476185	.	C	T	3	4	7	0	0	7	0	0
5	38476750	.	C	A	6	5	11	0	0	11	0	0
5	38531848	.	T	A	3	7	10	0	1	11	0	0
5	38532216	.	A	T	2	4	6	0	0	6	0	0
5	38532462	.	T	C	4	0	4	0	4	8	0	0
5	38532535	.	A	G	2	6	8	0	0	8	0	0
5	38533170	.	A	G	4	3	7	0	1	8	0	0
5	38533296	.	T	G	2	6	8	0	0	8	0	0
5	38533392	.	G	T	2	2	4	0	0	4	0	0
5	38602562	.	C	T	1	2	3	0	0	3	0	0
5	38604332	.	C	T	1	2	3	0	0	3	0	0
5	38605094	.	C	T	15	10	25	0	1	26	0	0
5	38605106	.	A	T	18	10	28	0	2	30	0	0
5	38605164	.	C	T	11	10	21	0	0	21	0	0
5	38605201	.	A	C	10	9	19	0	0	19	0	0
5	38605291	.	G	C	17	7	24	0	1	25	0	0
5	38605347	.	G	T	20	10	30	0	0	30	0	0
5	38611096	.	G	T	12	7	19	0	0	19	0	0
5	38611108	.	T	C	10	0	10	0	8	18	0	0
5	38721044	.	G	C	3	5	8	0	0	8	0	0
5	38736093	.	G	A	2	2	4	0	0	4	0	0
5	38749767	.	C	T	4	3	7	0	0	7	0	0
5	38749892	.	C	T	1	2	3	0	0	3	0	0
5	38749893	.	C	T	1	2	3	0	0	3	0	0
5	38749939	.	C	A	1	3	4	0	0	4	0	0
5	38786808	.	C	T	5	2	7	0	1	8	0	0
5	38786823	.	G	A	5	3	8	0	0	8	0	0
5	38786922	.	T	C	7	3	10	0	0	10	0	0
5	38827340	.	T	A	7	2	9	0	0	9	0	0
5	38831573	.	A	G	5	3	8	0	1	9	0	0
5	39081359	.	C	G	3	0	3	0	3	6	0	0
5	39082830	.	T	C	0	2	2	0	1	3	0	0
5	39082833	.	C	T	1	2	3	0	0	3	0	0
5	39083116	.	T	C	1	5	6	0	2	8	0	0
5	39083125	.	G	A	2	6	8	0	0	8	0	0
5	39084712	.	T	G	2	2	4	0	0	4	0	0
5	39085271	.	T	C	3	4	7	0	1	8	0	0
5	39085302	.	T	A	2	2	4	0	2	6	0	0
5	39085328	.	C	T	2	3	5	0	1	6	0	0
5	39085976	.	C	T	6	5	11	0	2	13	0	0
5	39086628	.	T	A	4	2	6	0	1	7	0	0
5	39099642	.	T	C	1	3	4	0	0	4	0	0
5	39136032	.	G	A	5	4	9	0	0	9	0	0
5	39143447	.	C	T	3	6	9	0	0	9	0	0
5	39151045	.	A	T	2	3	5	0	0	5	0	0
5	39151379	.	G	A	0	2	2	0	6	8	0	0
5	39151610	.	T	A	4	4	8	0	0	8	0	0
5	39152411	.	C	T	5	8	13	0	1	14	0	0
5	39152582	.	A	G	1	4	5	0	0	5	0	0
5	39152613	.	T	A	2	6	8	0	1	9	0	0
5	39154819	.	C	G	10	6	16	0	1	17	0	0
5	39154829	.	G	T	10	9	19	0	2	21	0	0
5	39154919	.	A	G	11	15	26	0	0	26	0	0
5	39154958	.	C	G	16	18	34	0	0	34	0	0
5	39154979	.	C	T	1	16	17	0	15	32	0	0
5	39155006	.	T	A	9	11	20	0	2	23	1	0
5	39155044	.	A	G	10	7	17	0	2	19	0	0
5	39155146	.	T	A	9	3	12	0	0	12	0	0
5	39155419	.	C	T	6	4	10	0	0	10	0	0
5	39155473	.	T	A	8	11	19	0	0	19	0	0
5	39155474	.	G	T	7	10	17	0	2	19	0	0
5	39155511	.	A	G	5	9	14	0	1	15	0	0
5	39386667	.	A	G	3	5	8	0	0	8	0	0
5	39386685	.	A	G	3	3	6	0	0	6	0	0
5	39386709	.	T	A	2	2	4	0	0	4	0	0
5	39504271	.	G	C	5	4	9	0	1	10	0	0
5	39504307	.	C	A	3	3	6	0	1	7	0	0
5	39508009	.	C	T	22	15	37	0	2	39	0	0
5	39508059	.	T	A	15	14	29	0	1	30	0	0
5	39508540	.	G	A	4	11	15	1	16	32	0	0
5	39707665	.	A	T	4	3	7	0	0	7	0	0
5	39707758	.	A	C	7	12	19	0	0	19	0	0
5	39707825	.	G	A	10	14	24	0	1	25	0	0
5	39708046	.	A	G	11	9	20	0	0	20	0	0
5	39712557	.	T	C	14	9	23	0	2	25	0	0
5	39714917	.	T	C	10	13	23	0	3	26	0	0
5	39715249	.	G	A	8	7	15	0	3	18	0	0
5	39730511	.	A	G	8	6	14	0	1	15	0	0
5	39730575	.	C	T	5	2	7	0	1	8	0	0
5	39736279	.	C	T	1	2	3	0	0	3	0	0
5	40003053	.	G	A	0	3	3	0	1	4	0	0
5	40003650	.	C	T	4	2	6	0	0	6	0	0
5	40024831	.	C	T	0	3	3	0	2	5	0	0
5	40052933	.	A	G	4	24	28	0	0	28	0	0
5	40054407	.	C	G	15	7	22	0	0	22	0	0
5	40059722	.	C	G	12	17	29	0	0	29	0	0
5	40059761	.	T	C	9	11	20	0	2	22	0	0
5	40062351	.	A	G	5	7	12	0	1	13	0	0
5	40062390	.	G	A	5	3	8	0	0	8	0	0
5	40071745	.	C	T	4	2	6	0	0	6	0	0
5	40080885	.	G	A	2	3	5	0	1	6	0	0
5	40203540	.	G	A	6	5	11	0	1	12	0	0
5	40206117	.	G	A	9	5	14	0	0	14	0	0
5	40206358	.	A	C	5	2	7	0	0	7	0	0
5	40273166	.	C	A	1	3	4	0	0	4	0	0
5	40273444	.	A	C	2	5	7	0	0	7	0	0
5	40273468	.	T	C	2	5	7	0	0	7	0	0
5	40273510	.	G	T	1	4	5	0	0	5	0	0
5	40273606	.	C	T	0	7	7	0	4	11	0	0
5	40273727	.	T	A	6	7	13	0	1	14	0	0
5	40273864	.	G	A	4	2	6	0	1	7	0	0
5	40291442	.	C	G	0	2	2	0	2	4	0	0
5	40505124	.	C	T	1	5	6	0	3	9	0	0
5	40506670	.	G	A	1	4	5	0	0	5	0	0
5	40506837	.	A	G	4	2	6	0	0	6	0	0
5	40729081	.	A	C	5	7	12	0	0	12	0	0
5	40729147	.	T	C	3	5	8	0	0	8	0	0
5	40729270	.	G	C	8	3	11	0	1	12	0	0
5	40729408	.	G	A	11	10	21	0	0	21	0	0
5	40729618	.	A	G	11	7	18	0	0	18	0	0
5	40732293	.	A	G	3	3	6	0	0	6	0	0
5	40835797	.	A	G	1	2	3	0	0	3	0	0
5	40845312	.	A	G	10	7	17	0	0	17	0	0
5	40845344	.	G	C	8	7	15	0	2	17	0	0
5	40845387	.	A	G	6	11	17	0	1	18	0	0
5	40845389	.	A	T	6	11	17	0	1	18	0	0
5	40845433	.	A	G	6	6	12	0	0	12	0	0
5	40845434	.	G	A	4	6	10	0	2	12	0	0
5	40845505	.	G	C	6	0	6	0	7	13	0	0
5	40845556	.	C	A	5	12	17	0	1	18	0	0
5	40845893	.	A	G	7	6	13	0	3	16	0	0
5	40846122	.	G	A	6	7	13	0	0	13	0	0
5	40856738	.	T	G	4	2	6	0	0	6	0	0
5	40857564	.	C	T	5	4	9	0	0	9	0	0
5	40877058	.	T	C	2	2	4	0	0	4	0	0
5	40935003	.	C	T	3	1	4	0	1	5	0	0
5	40951612	.	C	G	1	2	3	0	0	3	0	0
5	41082921	.	C	G	14	14	28	0	1	29	0	0
5	41082951	.	A	C	10	0	10	0	14	24	0	0
5	41083000	.	C	A	12	6	18	0	0	18	0	0
5	41083001	.	T	C	12	0	12	0	6	18	0	0
5	41083118	.	C	T	1	3	4	0	8	12	0	0
5	41083227	.	A	G	13	5	18	0	0	18	0	0
5	41083763	.	A	G	11	18	29	0	1	30	0	0
5	41083854	.	T	C	21	16	37	2	2	41	0	0
5	41083874	.	G	T	19	21	40	1	3	45	1	0
5	41084063	.	G	C	8	9	17	0	0	17	0	0
5	41084116	.	A	T	12	4	16	1	0	17	0	0
5	41084274	.	A	G	12	16	28	0	2	30	0	0
5	41084367	.	C	A	0	7	7	0	11	18	0	0
5	41085118	.	A	G	3	5	8	0	0	8	0	0
5	41085414	.	T	A	2	4	6	0	0	6	0	0
5	41085511	.	C	T	0	4	4	0	6	10	0	0
5	41085571	.	T	C	14	2	16	0	3	19	0	0
5	41085582	.	C	T	10	5	15	0	1	16	0	0
5	41086082	.	T	G	6	4	10	0	2	12	0	0
5	41086195	.	A	T	4	4	8	0	3	11	0	0
5	41103286	.	T	C	3	9	12	0	2	14	0	0
5	41103462	.	A	G	5	7	12	0	0	12	0	0
5	41103469	.	G	A	7	5	12	0	0	12	0	0
5	41125097	.	C	T	7	4	11	0	1	12	0	0
5	41125140	.	G	A	2	2	4	0	2	6	0	0
5	41125229	.	G	T	12	5	17	0	3	20	0	0
5	41125310	.	A	C	26	23	49	0	3	52	0	0
5	41125311	.	A	C	29	24	53	0	0	53	0	0
5	41125354	.	C	A	34	17	51	0	3	54	0	0
5	41125996	.	T	C	26	18	44	0	0	44	0	0
5	41126059	.	G	A	23	27	50	0	1	51	0	0
5	41127078	.	A	G	17	19	36	0	2	38	0	0
5	41127111	.	T	C	17	21	38	0	1	39	0	0
5	41127132	.	C	T	17	17	34	0	4	38	0	0
5	41128808	.	T	G	22	12	34	0	0	34	0	0
5	41133401	.	A	T	13	14	27	0	0	27	0	0
5	41134921	.	A	T	3	7	10	0	1	11	0	0
5	41134942	.	A	G	4	7	11	0	0	11	0	0
5	41135002	.	A	G	11	9	20	0	0	20	0	0
5	41137311	.	G	A	8	4	12	0	1	13	0	0
5	41137341	.	G	A	11	4	15	0	0	15	0	0
5	41138377	.	C	T	8	7	15	0	1	16	0	0
5	41138720	.	T	C	10	4	14	0	0	14	0	0
5	41138738	.	A	G	9	3	12	0	1	13	0	0
5	41138756	.	C	A	9	2	11	0	2	13	0	0
5	41138807	.	T	C	5	0	5	0	7	12	0	0
5	41146801	.	G	A	21	20	41	0	2	43	0	0
5	41150615	.	C	T	18	15	33	0	2	35	0	0
5	41150898	.	T	A	20	19	39	0	1	40	0	0
5	41150979	.	A	C	18	31	49	0	1	50	0	0
5	41151265	.	G	A	11	8	19	0	2	21	0	0
5	41260717	.	G	T	2	3	5	0	0	5	0	0
5	41260937	.	C	T	5	12	17	0	1	18	0	0
5	41261032	.	A	G	5	3	8	0	0	8	0	0
5	41261680	.	A	G	7	4	11	0	1	12	0	0
5	41261684	.	G	A	5	5	10	0	1	11	0	0
5	41261901	.	G	C	4	3	7	0	0	7	0	0
5	41261907	.	G	A	4	3	7	0	0	7	0	0
5	41271673	.	A	G	3	3	6	0	0	6	0	0
5	41286892	.	G	A	3	2	5	0	0	5	0	0
5	41478237	.	G	A	1	3	4	0	0	4	0	0
5	41478264	.	A	G	2	0	2	0	3	5	0	0
5	41478382	.	T	C	3	3	6	0	0	6	0	0
5	41481405	.	A	G	4	4	8	0	0	8	0	0
5	41484391	.	A	C	16	12	28	0	0	28	0	0
5	41484460	.	T	C	11	18	29	0	1	30	0	0
5	41484496	.	T	C	9	15	24	0	3	27	0	0
5	41484680	.	C	T	11	11	22	0	3	25	0	0
5	41484797	.	C	A	14	10	24	0	1	25	0	0
5	41485363	.	C	G	17	16	33	0	4	37	0	0
5	41485365	.	A	G	19	18	37	0	0	37	0	0
5	41485497	.	C	G	25	21	46	0	1	47	0	0
5	41485533	.	C	T	7	22	29	0	27	56	0	0
5	41485709	.	A	T	26	34	60	0	5	65	0	0
5	41485814	.	A	T	24	35	59	0	3	62	0	0
5	41486025	.	A	G	27	36	63	0	6	69	0	0
5	41486031	.	T	G	26	38	64	0	2	66	0	0
5	41486803	.	G	A	27	28	55	0	2	57	0	0
5	41486890	.	C	T	17	29	46	1	6	53	0	0
5	41488903	.	A	G	17	20	37	0	1	38	0	0
5	41489487	.	G	T	21	13	34	0	3	37	0	0
5	41489493	.	C	T	22	14	36	0	2	38	0	0
5	41489748	.	T	C	25	18	43	0	1	44	0	0
5	41492135	.	C	T	21	10	31	1	0	32	0	0
5	41492183	.	C	T	2	12	14	1	20	35	0	0
5	41492234	.	G	A	24	16	40	0	2	42	0	0
5	41492279	.	G	A	24	19	43	0	1	44	0	0
5	41492901	.	G	A	13	18	31	0	3	34	0	0
5	41492934	.	A	G	12	18	30	0	0	30	0	0
5	41503549	.	C	T	1	4	5	0	0	5	0	0
5	41508900	.	C	G	2	2	4	0	0	4	0	0
5	41513013	.	T	C	4	6	10	0	0	10	0	0
5	41514127	.	A	G	2	6	8	0	0	8	0	0
5	41516322	.	A	C	10	6	16	1	1	18	0	0
5	41518836	.	T	C	17	16	33	0	1	34	0	0
5	41519423	.	A	C	21	23	44	1	2	47	0	0
5	41519459	.	T	C	22	24	46	1	4	51	0	0
5	41520822	.	A	T	25	17	42	0	3	45	0	0
5	41520823	.	T	C	27	17	44	0	1	45	0	0
5	41523272	.	G	C	2	2	4	0	0	4	0	0
5	41559351	.	G	T	1	3	4	0	0	4	0	0
5	41582736	.	G	A	4	3	7	0	0	7	0	0
5	41585126	.	C	T	6	4	10	0	0	10	0	0
5	41585186	.	G	A	4	2	6	0	0	6	0	0
5	41594919	.	G	T	3	2	5	0	0	5	0	0
5	41639787	.	A	T	2	3	5	0	0	5	0	0
5	41639814	.	A	G	3	2	5	0	1	6	0	0
5	41639874	.	G	T	2	4	6	0	0	6	0	0
5	41641750	.	G	A	8	9	17	0	1	18	0	0
5	41641835	.	G	C	9	11	20	0	2	22	0	0
5	41641887	.	A	G	7	12	19	0	2	21	0	0
5	41642167	.	A	G	4	2	6	0	0	6	0	0
5	41642348	.	G	A	1	3	4	0	1	5	0	0
5	41643084	.	A	G	1	6	7	0	0	7	0	0
5	41643095	.	A	G	1	5	6	0	0	6	0	0
5	41645652	.	A	G	18	16	34	0	1	35	0	0
5	41645815	.	C	G	15	11	26	1	2	29	0	0
5	41645827	.	T	A	15	13	28	1	1	30	0	0
5	41645982	.	A	G	30	11	41	0	1	42	0	0
5	41650451	.	T	C	13	1	14	0	17	31	0	0
5	41655134	.	G	A	12	10	22	0	0	22	0	0
5	41655155	.	T	A	12	8	20	0	4	24	0	0
5	41670193	.	G	A	2	6	8	0	0	8	0	0
5	41676855	.	T	C	3	2	5	0	2	7	0	0
5	41684885	.	A	T	1	3	4	0	0	4	0	0
5	41691606	.	A	G	4	3	7	0	0	7	0	0
5	41705757	.	A	G	1	2	3	0	0	3	0	0
5	41878612	.	A	C	14	11	25	0	0	25	0	0
5	41878660	.	A	G	12	10	22	0	0	22	0	0
5	41878711	.	C	T	1	14	15	0	12	27	0	0
5	41878965	.	G	C	6	7	13	0	1	14	0	0
5	41879465	.	C	G	9	7	16	0	2	18	0	0
5	41879497	.	T	C	11	9	20	0	0	20	0	0
5	41879848	.	C	A	4	4	8	0	0	8	0	0
5	41880240	.	T	C	11	0	11	0	15	26	0	0
5	41880243	.	T	C	9	0	9	0	16	25	0	0
5	41880280	.	C	G	10	16	26	0	1	27	0	0
5	41880288	.	G	A	9	14	23	0	0	23	0	0
5	41882364	.	T	C	6	10	16	0	4	20	0	0
5	41888132	.	T	C	4	0	4	0	10	14	0	0
5	41890054	.	G	A	9	10	19	0	0	19	0	0
5	41890092	.	A	G	7	7	14	0	1	15	0	0
5	41890277	.	T	G	5	3	8	0	1	9	0	0
5	41891324	.	T	C	5	0	5	0	4	9	0	0
5	41898424	.	A	G	2	7	9	0	1	10	0	0
5	41900012	.	A	C	3	2	5	0	0	5	0	0
5	41900020	.	A	G	3	2	5	0	0	5	0	0
5	41901020	.	A	G	3	2	5	0	1	6	0	0
5	41997446	.	C	A	3	2	5	0	0	5	0	0
5	42053465	.	G	C	4	5	9	0	0	9	0	0
5	42053985	.	C	A	2	3	5	0	1	6	0	0
5	42064204	.	T	G	2	3	5	0	0	5	0	0
5	42066958	.	C	T	13	6	19	7	0	26	0	0
5	42067486	.	T	C	12	13	25	2	2	29	0	0
5	42067588	.	G	A	11	7	18	26	0	44	0	0
5	42068736	.	T	C	1	2	3	0	0	3	0	0
5	42122907	.	C	T	8	6	14	0	1	15	0	0
5	42122914	.	C	T	8	9	17	0	1	18	0	0
5	42123023	.	C	T	22	14	36	0	1	37	0	0
5	42123125	.	C	T	28	11	39	0	4	43	0	0
5	42123375	.	C	A	23	6	29	0	3	32	0	0
5	42123664	.	A	G	13	10	23	0	1	24	0	0
5	42123697	.	G	C	17	11	28	0	0	28	0	0
5	42123766	.	G	T	12	7	19	0	0	19	0	0
5	45204971	.	A	G	1	4	5	0	0	5	0	0
5	45224048	.	C	T	6	4	10	0	0	10	0	0
5	45224396	.	A	G	2	4	6	0	1	7	0	0
5	45230659	.	C	A	3	5	8	0	0	8	0	0
5	45261926	.	C	T	10	5	15	0	3	18	0	0
5	45269380	.	A	G	14	6	20	0	0	20	0	0
5	45269386	.	A	G	15	7	22	0	0	22	0	0
5	45272009	.	A	G	16	0	16	0	10	26	0	0
5	45272056	.	C	T	20	14	34	0	0	34	0	0
5	45272068	.	G	A	17	14	31	0	1	32	0	0
5	45274486	.	C	T	18	10	28	0	0	28	0	0
5	45282910	.	G	A	6	7	13	0	0	13	0	0
5	45283046	.	G	T	6	8	14	0	0	14	0	0
5	45283074	.	G	A	1	9	10	0	4	14	0	0
5	45283117	.	A	C	3	10	13	0	0	13	0	0
5	45283274	.	T	C	7	9	16	0	0	16	0	0
5	45283284	.	T	C	10	9	19	0	0	19	0	0
5	45283645	.	C	T	5	3	8	0	3	11	0	0
5	45613465	.	G	T	1	3	4	0	0	4	0	0
5	45747455	.	C	T	17	21	38	0	3	41	0	0
5	45747475	.	C	T	2	21	23	0	9	32	0	0
5	45747647	.	A	G	17	17	34	0	0	34	0	0
5	45747799	.	A	G	1	5	6	0	1	7	0	0
5	45747845	.	C	A	9	7	16	0	1	17	0	0
5	45747924	.	A	T	13	5	18	0	1	19	0	0
5	45748160	.	T	A	5	2	7	0	1	8	0	0
5	45748172	.	T	A	2	4	6	0	0	6	0	0
5	45748726	.	A	C	9	0	9	0	10	19	0	0
5	45751208	.	C	T	0	8	8	0	11	19	0	0
5	45754818	.	C	T	6	11	17	1	0	18	0	0
5	45754851	.	A	G	5	13	18	0	1	19	0	0
5	45754899	.	G	A	9	15	24	0	0	24	0	0
5	45757617	.	A	G	2	6	8	1	0	9	0	0
5	45757731	.	A	G	2	5	7	0	1	8	0	0
5	45762709	.	A	G	0	5	5	0	2	7	0	0
5	45762892	.	A	G	3	3	6	0	0	6	0	0
5	45771930	.	G	A	1	2	3	0	0	3	0	0
5	45890036	.	A	T	8	8	16	0	0	16	0	0
5	45890086	.	A	T	11	10	21	0	0	21	0	0
5	45890087	.	A	T	13	7	20	0	2	22	0	0
5	45890159	.	A	G	4	7	11	0	1	12	0	0
5	45890195	.	A	G	3	7	10	0	0	10	0	0
5	45890219	.	A	T	5	8	13	0	0	13	0	0
5	45890625	.	C	T	19	8	27	0	1	28	0	0
5	45890908	.	C	T	1	9	10	0	9	19	0	0
5	45890915	.	C	T	9	9	18	0	1	19	0	0
5	45891074	.	A	G	6	7	13	0	0	13	0	0
5	45891090	.	A	G	6	7	13	0	0	13	0	0
5	45891147	.	T	A	8	8	16	0	1	18	1	0
5	45891226	.	T	A	13	6	19	0	0	19	0	0
5	45891327	.	G	T	14	8	22	0	0	22	0	0
5	45892671	.	C	A	6	7	13	0	2	15	0	0
5	45894699	.	C	T	7	5	12	0	0	12	0	0
5	45894720	.	T	C	5	7	12	0	1	13	0	0
5	45894737	.	T	C	6	6	12	0	1	13	0	0
5	46066228	.	A	G	1	0	1	0	3	4	0	0
5	46147125	.	A	T	1	3	4	0	0	4	0	0
5	46185572	.	G	A	2	2	4	0	1	5	0	0
5	46327798	.	G	T	7	10	17	0	0	17	0	0
5	46328476	.	T	C	6	0	6	0	6	12	0	0
5	46329750	.	C	G	1	2	3	0	8	11	0	0
5	46490873	.	C	T	0	3	3	0	2	5	0	0
5	46490948	.	A	G	2	4	6	0	0	6	0	0
5	46490949	.	T	C	4	0	4	0	2	6	0	0
5	46491059	.	C	G	2	4	6	0	0	6	0	0
5	46491074	.	G	A	2	2	4	0	0	4	0	0
5	46659285	.	T	G	23	16	39	1	5	46	1	0
5	46659401	.	A	G	13	28	41	0	4	45	0	0
5	46659666	.	T	A	29	18	47	0	1	48	0	0
5	46659707	.	C	A	28	28	56	0	3	59	0	0
5	46659861	.	G	A	16	15	31	0	6	37	0	0
5	46659950	.	C	T	26	21	47	0	2	49	0	0
5	46659985	.	A	G	29	23	52	0	4	56	0	0
5	46660068	.	C	T	28	10	38	0	2	40	0	0
5	46660116	.	C	T	15	23	38	0	2	40	0	0
5	46660120	.	A	G	23	13	36	0	4	40	0	0
5	46660162	.	C	G	15	14	29	0	3	32	0	0
5	46660600	.	T	A	21	15	36	4	0	40	0	0
5	46660672	.	G	A	20	19	39	0	3	42	0	0
5	46660940	.	G	A	17	14	31	0	1	32	0	0
5	46660941	.	A	T	12	17	29	0	3	32	0	0
5	46661073	.	G	A	17	11	28	0	2	30	0	0
5	46661168	.	T	A	7	8	15	0	0	15	0	0
5	46661213	.	A	G	14	12	26	0	0	26	0	0
5	46661240	.	A	G	14	10	24	0	1	25	0	0
5	46661423	.	T	C	26	0	26	0	20	46	0	0
5	46661519	.	C	T	14	11	25	0	1	26	0	0
5	46661678	.	T	A	1	6	7	0	2	9	0	0
5	46662271	.	A	G	8	9	17	0	1	18	0	0
5	46662316	.	A	G	13	10	23	0	0	23	0	0
5	46685872	.	A	G	6	8	14	0	0	14	0	0
5	46724854	.	G	A	8	5	13	0	2	15	0	0
5	46724893	.	G	T	12	6	18	1	1	20	0	0
5	47727760	.	C	T	1	19	20	0	21	41	0	0
5	47949989	.	A	G	3	0	3	0	4	7	0	0
5	47949992	.	G	A	4	3	7	0	0	7	0	0
5	47950082	.	A	C	3	4	7	0	1	8	0	0
5	47950862	.	C	T	8	3	11	0	1	12	0	0
5	47953562	.	G	A	0	5	5	0	1	6	0	0
5	47953721	.	A	G	1	0	1	0	4	5	0	0
5	47955833	.	C	A	3	4	7	0	0	7	0	0
5	47960283	.	T	A	1	4	5	0	0	5	0	0
5	47960284	.	G	A	1	4	5	0	0	5	0	0
5	47968970	.	C	T	6	4	10	0	0	10	0	0
5	47973386	.	T	G	4	3	7	0	0	7	0	0
5	47976728	.	C	G	9	3	12	0	0	12	0	0
5	47976747	.	C	A	9	5	14	0	1	15	0	0
5	47976827	.	A	G	4	7	11	0	4	15	0	0
5	48023044	.	C	T	2	4	6	0	0	6	0	0
5	48028228	.	A	G	3	1	4	0	0	4	0	0
5	48028338	.	C	A	7	4	11	0	0	11	0	0
5	48028406	.	A	C	14	8	22	0	1	23	0	0
5	48028435	.	G	T	9	9	18	0	1	19	0	0
5	48028508	.	T	C	13	8	21	0	0	21	0	0
5	48028696	.	C	A	5	2	7	0	2	9	0	0
5	48028720	.	G	A	2	3	5	1	1	7	0	0
5	48029489	.	A	C	8	5	13	0	0	13	0	0
5	48029510	.	C	A	4	4	8	0	0	8	0	0
5	48029633	.	C	A	5	5	10	0	0	10	0	0
5	48029667	.	G	A	4	4	8	0	0	8	0	0
5	48029720	.	T	G	3	4	7	0	0	7	0	0
5	48029732	.	C	T	0	3	3	0	4	7	0	0
5	48033995	.	T	C	3	2	5	0	0	5	0	0
5	48036243	.	C	T	2	3	5	0	0	5	0	0
5	48036246	.	G	C	2	3	5	0	0	5	0	0
5	48110331	.	G	A	10	14	24	0	0	24	0	0
5	48154436	.	G	A	20	22	42	0	0	42	0	0
5	48154456	.	T	A	19	30	49	0	2	51	0	0
5	48172446	.	C	A	1	7	8	0	6	14	0	0
5	48182088	.	A	G	13	5	18	0	4	22	0	0
5	48182550	.	A	T	5	5	10	0	1	11	0	0
5	48182725	.	T	C	5	13	18	0	3	21	0	0
5	48183577	.	C	T	0	12	12	0	10	22	0	0
5	48183579	.	A	G	8	13	21	0	1	22	0	0
5	48183628	.	T	C	9	0	9	0	6	15	0	0
5	48208539	.	G	A	2	2	4	0	0	4	0	0
5	48242529	.	T	G	1	3	4	0	0	4	0	0
5	48242610	.	G	A	2	3	5	0	0	5	0	0
5	48664229	.	T	C	2	2	4	0	0	4	0	0
5	48664289	.	T	C	3	0	3	0	5	8	0	0
5	48672641	.	A	G	2	3	5	0	0	5	0	0
5	48672740	.	G	A	5	3	8	0	0	8	0	0
5	48672970	.	G	A	2	4	6	0	0	6	0	0
5	48673084	.	C	T	1	3	4	0	0	4	0	0
5	48673501	.	A	G	9	11	20	0	1	21	0	0
5	48673639	.	C	A	1	4	5	0	7	12	0	0
5	48673720	.	A	G	3	3	6	0	0	6	0	0
5	48679320	.	A	G	11	3	14	0	1	15	0	0
5	48679428	.	A	T	1	4	5	0	2	7	0	0
5	48679482	.	A	T	8	4	12	0	0	12	0	0
5	48680486	.	T	C	1	2	3	0	0	3	0	0
5	48835792	.	C	T	2	2	4	0	0	4	0	0
5	48893880	.	G	A	4	2	6	0	0	6	0	0
5	48935915	.	C	T	4	2	6	0	1	7	0	0
5	48935981	.	C	T	6	4	10	0	0	10	0	0
5	48936032	.	C	T	4	8	12	0	0	12	0	0
5	48986109	.	G	A	6	12	18	0	1	19	0	0
5	48986405	.	T	A	22	7	29	3	1	33	0	0
5	48986410	.	G	T	23	8	31	3	0	34	0	0
5	48986565	.	A	G	11	18	29	0	2	31	0	0
5	48986626	.	A	T	7	22	29	0	2	31	0	0
5	48986939	.	C	T	15	7	22	1	1	24	0	0
5	48987007	.	A	T	11	11	22	0	2	24	0	0
5	48987199	.	C	T	15	15	30	0	2	32	0	0
5	48987356	.	G	T	11	11	22	0	0	22	0	0
5	48987920	.	T	C	8	12	20	0	0	20	0	0
5	48988051	.	C	T	1	6	7	0	15	22	0	0
5	48992401	.	T	C	12	0	12	0	9	21	0	0
5	48992972	.	C	T	1	4	5	0	7	12	0	0
5	48993268	.	A	T	1	2	3	0	0	3	0	0
5	48993345	.	T	C	4	8	12	0	1	13	0	0
5	48995559	.	A	T	4	5	9	0	2	11	0	0
5	48995613	.	A	G	5	8	13	0	0	13	0	0
5	48995637	.	A	T	6	6	12	0	1	13	0	0
5	48995884	.	G	A	5	7	12	0	0	12	0	0
5	48995945	.	G	A	3	7	10	0	0	10	0	0
5	49019451	.	G	A	3	3	6	0	0	6	0	0
5	49019456	.	G	A	1	3	4	0	1	5	0	0
5	49019528	.	T	C	4	3	7	0	0	7	0	0
5	49019744	.	A	T	3	2	5	1	1	7	0	0
5	49019746	.	C	A	4	2	6	1	0	7	0	0
5	49019798	.	A	T	1	3	4	0	1	5	0	0
5	49019880	.	G	T	1	2	3	0	1	4	0	0
5	49021535	.	G	T	3	2	5	0	0	5	0	0
5	49734581	.	C	T	9	11	20	0	1	21	0	0
5	49734751	.	T	G	3	7	10	0	5	15	0	0
5	49734889	.	C	T	8	1	9	0	1	10	0	0
5	49735022	.	G	T	6	7	13	0	0	13	0	0
5	49735169	.	A	T	9	3	12	0	0	12	0	0
5	49735700	.	C	A	6	8	14	0	0	14	0	0
5	49735942	.	T	G	9	5	14	1	0	15	0	0
5	49743020	.	A	T	5	6	11	0	0	11	0	0
5	49745130	.	T	A	2	3	5	0	0	5	0	0
5	49747271	.	G	T	0	10	10	1	12	23	0	0
5	49750765	.	C	T	15	20	35	0	4	39	0	0
5	49750796	.	A	C	24	14	38	0	2	41	1	0
5	49768429	.	A	T	4	1	5	0	1	6	0	0
5	49768774	.	C	G	2	4	6	0	1	7	0	0
5	49769217	.	A	G	4	2	6	0	0	6	0	0
5	49769277	.	G	T	1	4	5	0	0	5	0	0
5	49769485	.	A	G	3	6	9	0	0	9	0	0
5	49769711	.	C	G	3	5	8	0	0	8	0	0
5	49769812	.	A	T	2	3	5	0	1	6	0	0
5	49773801	.	A	T	1	3	4	0	0	4	0	0
5	49919762	.	G	A	2	2	4	0	0	4	0	0
5	49919774	.	T	A	3	3	6	0	0	6	0	0
5	50085622	.	T	A	1	2	3	0	0	3	0	0
5	50436028	.	C	T	2	5	7	0	0	7	0	0
5	50436069	.	C	T	4	2	6	0	0	6	0	0
5	50436127	.	C	T	5	3	8	0	0	8	0	0
5	50436354	.	G	A	3	3	6	0	0	6	0	0
5	50436359	.	G	T	3	3	6	0	0	6	0	0
5	50443077	.	T	C	19	9	28	0	5	33	0	0
5	50443184	.	A	G	13	17	30	0	2	32	0	0
5	50443211	.	C	A	13	12	25	0	1	26	0	0
5	50443399	.	G	C	21	4	25	0	2	27	0	0
5	50443418	.	T	A	20	19	39	0	4	43	0	0
5	50443466	.	A	G	16	15	31	0	1	32	0	0
5	50444394	.	T	C	3	2	5	0	1	6	0	0
5	50444395	.	G	A	4	2	6	0	0	6	0	0
5	50465188	.	C	T	0	3	3	0	5	8	0	0
5	50465649	.	G	A	2	2	4	0	0	4	0	0
5	50520009	.	G	A	2	5	7	0	0	7	0	0
5	50544281	.	T	C	3	3	6	0	1	7	0	0
5	50576699	.	G	A	3	3	6	0	1	7	0	0
5	50576705	.	A	G	3	3	6	0	0	6	0	0
5	50582271	.	G	A	2	2	4	0	0	4	0	0
5	50582482	.	T	G	2	3	5	0	0	5	0	0
5	50817403	.	C	T	4	5	9	0	1	10	0	0
5	50817414	.	C	T	4	6	10	0	0	10	0	0
5	50819775	.	C	T	8	3	11	0	1	12	0	0
5	50819811	.	G	A	9	3	12	0	1	13	0	0
5	50820988	.	A	G	3	6	9	0	3	12	0	0
5	50828304	.	G	T	2	3	5	0	0	5	0	0
5	50837467	.	C	T	4	1	5	0	1	6	0	0
5	50843442	.	G	A	1	5	6	0	0	6	0	0
5	50846094	.	G	A	3	2	5	0	0	5	0	0
5	50869899	.	T	C	1	2	3	0	0	3	0	0
5	50874881	.	G	T	1	2	3	0	0	3	0	0
5	50879164	.	G	A	1	2	3	0	1	4	0	0
5	50886309	.	C	T	1	3	4	0	0	4	0	0
5	50889675	.	T	G	1	5	6	0	1	7	0	0
5	50889714	.	G	A	5	4	9	0	1	10	0	0
5	50895544	.	C	T	6	4	10	0	0	10	0	0
5	50895606	.	C	T	3	3	6	0	0	6	0	0
5	50897465	.	G	T	0	10	10	0	3	13	0	0
5	50897528	.	C	A	2	5	7	0	0	7	0	0
5	50897585	.	C	T	2	5	7	0	0	7	0	0
5	50949694	.	A	G	3	0	3	0	2	5	0	0
5	50949712	.	A	T	2	2	4	0	0	4	0	0
5	50960402	.	C	A	3	2	5	0	1	6	0	0
5	50963250	.	C	G	6	3	9	0	0	9	0	0
5	50967003	.	C	A	1	2	3	0	0	3	0	0
5	50967242	.	C	G	1	3	4	0	0	4	0	0
5	50969971	.	G	T	0	2	2	0	2	4	0	0
5	50969974	.	C	G	2	3	5	0	0	5	0	0
5	50973014	.	C	T	3	6	9	0	0	9	0	0
5	50973039	.	C	T	4	7	11	0	0	11	0	0
5	50973357	.	T	A	3	6	9	0	1	10	0	0
5	50973518	.	A	C	10	6	16	0	0	16	0	0
5	50973625	.	A	T	6	6	12	1	0	13	0	0
5	50973669	.	C	T	0	4	4	0	7	11	0	0
5	50973748	.	C	T	4	3	7	0	0	7	0	0
5	50978920	.	G	C	3	3	6	0	0	6	0	0
5	51029352	.	T	C	0	1	1	0	1	2	0	0
5	51102044	.	T	C	4	3	7	0	0	7	0	0
5	51102602	.	T	G	2	2	4	0	0	4	0	0
5	51102828	.	G	A	5	3	8	0	0	8	0	0
5	51103006	.	T	C	2	2	4	0	1	5	0	0
5	51103007	.	T	C	2	2	4	0	1	5	0	0
5	51103043	.	T	C	2	2	4	0	1	5	0	0
5	51103411	.	G	A	4	3	7	0	0	7	0	0
5	51103550	.	G	A	1	5	6	0	0	6	0	0
5	51103689	.	A	C	1	3	4	0	0	4	0	0
5	51103944	.	A	T	1	2	3	0	0	3	0	0
5	51104458	.	G	T	2	3	5	0	0	5	0	0
5	51111786	.	G	A	1	2	3	0	0	3	0	0
5	51121295	.	G	A	3	8	11	0	0	11	0	0
5	51124758	.	C	T	3	3	6	0	0	6	0	0
5	51169354	.	A	T	6	3	9	0	0	11	2	0
5	51169376	.	T	C	6	0	6	0	3	9	0	0
5	51169859	.	T	A	3	4	7	0	0	7	0	0
5	51170048	.	C	T	1	3	4	0	0	4	0	0
5	51170113	.	G	A	2	2	4	0	0	4	0	0
5	51170264	.	A	G	3	4	7	0	0	7	0	0
5	51170577	.	G	A	1	1	2	0	1	3	0	0
5	51170595	.	A	G	2	2	4	0	0	4	0	0
5	51200506	.	A	G	7	6	13	0	0	13	0	0
5	51202374	.	T	A	1	6	7	0	1	8	0	0
5	51202938	.	G	A	4	5	9	0	0	9	0	0
5	51203146	.	C	T	2	2	4	0	0	4	0	0
5	51205439	.	G	T	5	5	10	0	0	10	0	0
5	51205473	.	T	A	5	3	8	0	0	8	0	0
5	51205593	.	G	A	3	2	5	0	0	5	0	0
5	51208839	.	A	G	2	2	4	0	0	4	0	0
5	51227011	.	T	A	3	5	8	0	0	8	0	0
5	51227197	.	C	T	4	3	7	0	1	8	0	0
5	51228935	.	G	A	3	4	7	0	0	7	0	0
5	51230665	.	C	G	4	3	7	0	0	7	0	0
5	51230901	.	T	C	5	3	8	0	1	9	0	0
5	51236528	.	A	G	1	5	6	0	2	8	0	0
5	51240588	.	T	C	7	4	11	0	1	12	0	0
5	51240679	.	A	G	2	7	9	0	1	10	0	0
5	51240830	.	T	C	5	5	10	0	0	10	0	0
5	51240936	.	A	G	3	2	5	0	0	5	0	0
5	51241023	.	A	G	2	3	5	0	0	5	0	0
5	51241095	.	C	T	6	2	8	0	0	8	0	0
5	51242020	.	C	T	2	4	6	0	0	6	0	0
5	51242572	.	C	T	6	3	9	1	1	11	0	0
5	51242684	.	A	G	5	2	7	0	0	7	0	0
5	51242882	.	A	G	9	12	21	0	0	21	0	0
5	51242904	.	C	T	9	2	11	0	2	13	0	0
5	51243006	.	T	A	5	7	12	0	2	14	0	0
5	51243068	.	A	G	15	15	30	0	2	32	0	0
5	51243085	.	C	A	16	13	29	0	3	32	0	0
5	51243157	.	T	A	11	7	18	0	0	18	0	0
5	51243243	.	C	T	6	8	14	0	0	14	0	0
5	51243287	.	G	A	7	7	14	0	0	14	0	0
5	51243341	.	G	A	10	6	16	0	1	17	0	0
5	51243635	.	C	T	6	9	15	0	1	16	0	0
5	51243645	.	A	T	8	10	18	0	1	19	0	0
5	51243680	.	T	G	13	12	25	0	1	26	0	0
5	51243706	.	C	T	14	13	27	0	3	30	0	0
5	51439600	.	G	C	1	3	4	0	0	4	0	0
5	51439602	.	G	A	1	3	4	0	0	4	0	0
5	51548092	.	C	T	3	2	5	0	0	5	0	0
5	51548107	.	A	G	2	0	2	0	3	5	0	0
5	51579025	.	G	A	0	3	3	0	5	8	0	0
5	51616474	.	A	T	4	3	7	0	0	7	0	0
5	51616580	.	A	T	3	12	15	0	0	15	0	0
5	51616704	.	C	G	12	8	20	0	0	20	0	0
5	51616959	.	G	A	7	8	15	0	2	17	0	0
5	51775190	.	C	T	10	7	17	0	0	17	0	0
5	51775291	.	A	T	10	19	29	0	2	31	0	0
5	51775364	.	A	T	18	22	40	0	1	42	1	0
5	51775458	.	A	C	20	18	38	0	3	41	0	0
5	51775501	.	T	G	20	19	39	0	3	42	0	0
5	51775642	.	T	A	16	16	32	0	2	34	0	0
5	51775962	.	G	T	15	16	31	0	0	31	0	0
5	51776150	.	C	A	18	13	31	0	1	32	0	0
5	51779513	.	C	T	24	13	37	0	1	38	0	0
5	51789180	.	C	T	0	8	8	0	3	11	0	0
5	51792974	.	G	A	12	15	27	0	0	27	0	0
5	51834217	.	C	A	1	2	3	0	1	4	0	0
5	51835634	.	C	T	1	3	4	0	0	4	0	0
5	51836004	.	A	G	2	0	2	0	4	6	0	0
5	51840420	.	C	T	4	4	8	0	1	9	0	0
5	51840942	.	C	T	3	4	7	0	1	8	0	0
5	51846285	.	C	A	10	7	17	0	0	17	0	0
5	51847274	.	T	C	8	4	12	0	0	12	0	0
5	51847429	.	T	C	6	2	8	0	0	8	0	0
5	51847675	.	C	G	4	4	8	0	0	8	0	0
5	51886188	.	A	C	14	12	26	0	1	27	0	0
5	51894040	.	T	C	7	10	17	0	3	20	0	0
5	51898933	.	C	G	1	4	5	0	0	5	0	0
5	51902067	.	T	G	4	2	6	0	0	6	0	0
5	51938432	.	G	A	1	2	3	0	0	3	0	0
5	51947370	.	G	T	8	4	12	0	1	13	0	0
5	51947398	.	C	T	0	12	12	0	9	21	0	0
5	51947497	.	C	T	19	8	27	0	0	27	0	0
5	51947650	.	T	C	5	9	14	0	0	14	0	0
5	51947696	.	A	T	8	13	21	0	1	22	0	0
5	51947852	.	A	T	6	12	18	0	1	19	0	0
5	51947927	.	T	C	6	1	7	0	3	10	0	0
5	51947976	.	C	G	4	3	7	0	1	8	0	0
5	51948017	.	G	T	5	6	11	0	0	11	0	0
5	51948146	.	G	A	8	14	22	1	0	23	0	0
5	51948207	.	T	C	6	6	12	0	1	13	0	0
5	51948489	.	C	T	2	2	4	0	2	6	0	0
5	51948708	.	A	T	4	6	10	0	2	12	0	0
5	51948737	.	C	T	0	7	7	0	9	16	0	0
5	51948755	.	C	A	8	11	19	0	0	19	0	0
5	51948825	.	T	C	6	10	16	0	1	17	0	0
5	51948827	.	C	G	9	7	16	0	1	17	0	0
5	51948870	.	A	G	5	13	18	0	0	18	0	0
5	51949069	.	T	A	14	11	25	0	0	25	0	0
5	51949115	.	G	T	6	5	11	0	1	12	0	0
5	51950032	.	G	C	4	7	11	0	3	14	0	0
5	51950357	.	C	T	0	4	4	0	3	7	0	0
5	51958296	.	T	A	1	4	5	0	0	5	0	0
5	51960989	.	G	A	1	2	3	0	0	3	0	0
5	52002660	.	T	G	7	9	16	0	0	16	0	0
5	52002708	.	T	C	5	10	15	0	3	18	0	0
5	52002743	.	T	G	6	11	17	0	0	17	0	0
5	52005851	.	G	T	6	9	15	0	2	17	0	0
5	52005893	.	C	T	3	6	9	0	1	10	0	0
5	52007700	.	C	T	8	3	11	0	1	12	0	0
5	52123640	.	G	T	1	3	4	0	0	4	0	0
5	52124734	.	A	G	2	5	7	0	0	7	0	0
5	52132498	.	A	T	1	2	3	0	0	3	0	0
5	52132561	.	C	T	3	5	8	0	1	9	0	0
5	52132966	.	A	G	4	4	8	0	2	10	0	0
5	52190833	.	C	A	5	2	7	0	1	8	0	0
5	52191039	.	C	T	0	5	5	0	2	7	0	0
5	52191630	.	T	C	2	4	6	0	0	6	0	0
5	52192545	.	T	A	2	3	5	0	0	5	0	0
5	52192557	.	C	T	3	2	5	0	0	5	0	0
5	52192704	.	T	C	2	0	2	0	3	5	0	0
5	52193066	.	C	T	2	3	5	0	2	7	0	0
5	52197793	.	C	T	3	4	7	0	1	8	0	0
5	52198066	.	G	A	5	2	7	0	0	7	0	0
5	52226964	.	T	C	5	0	5	0	4	9	0	0
5	52227030	.	A	C	7	6	13	0	1	14	0	0
5	52227090	.	T	A	7	7	14	0	1	15	0	0
5	52227190	.	T	A	8	6	14	0	1	15	0	0
5	52227393	.	T	C	13	7	20	0	1	21	0	0
5	52227404	.	T	C	10	0	10	0	9	19	0	0
5	52234708	.	A	G	3	2	5	0	0	5	0	0
5	52235385	.	C	T	1	2	3	0	0	3	0	0
5	52237039	.	G	A	3	2	5	0	0	5	0	0
5	52237449	.	G	C	1	0	1	0	2	3	0	0
5	52257106	.	A	C	9	0	9	0	9	18	0	0
5	52257299	.	G	A	6	12	18	0	1	19	0	0
5	52257976	.	G	T	11	5	16	0	1	17	0	0
5	52258036	.	G	A	8	7	15	0	0	15	0	0
5	52258234	.	G	A	12	12	24	1	1	26	0	0
5	52258268	.	C	G	15	11	26	0	2	28	0	0
5	52258518	.	C	T	13	11	24	0	0	24	0	0
5	52258614	.	C	A	2	5	7	0	0	7	0	0
5	52258721	.	C	G	10	4	14	0	0	14	0	0
5	52258921	.	T	G	5	3	8	0	0	8	0	0
5	52259221	.	T	A	7	6	13	1	1	15	0	0
5	52259542	.	G	C	5	0	5	0	5	10	0	0
5	52259579	.	A	T	7	6	13	0	0	13	0	0
5	52259825	.	C	A	5	2	7	0	2	9	0	0
5	52264456	.	C	G	1	4	5	0	6	11	0	0
5	52264512	.	G	A	2	3	5	0	1	6	0	0
5	52264549	.	C	T	6	3	9	0	1	10	0	0
5	52264654	.	C	G	0	8	8	0	3	11	0	0
5	52264663	.	G	A	8	5	13	0	0	13	0	0
5	52277282	.	G	A	4	6	10	0	0	10	0	0
5	52277390	.	G	A	3	2	5	0	0	5	0	0
5	52277448	.	A	T	6	6	12	0	0	12	0	0
5	52277487	.	T	A	4	4	8	0	0	8	0	0
5	52512768	.	A	G	1	2	3	0	0	3	0	0
5	52598546	.	A	T	3	5	8	0	0	8	0	0
5	52598563	.	G	A	3	4	7	0	1	8	0	0
5	52617922	.	A	G	1	5	6	0	1	7	0	0
5	52696865	.	T	A	1	2	3	0	0	3	0	0
5	52698067	.	G	A	4	3	7	0	0	7	0	0
5	52710951	.	A	G	4	4	8	0	0	8	0	0
5	52710957	.	G	A	5	3	8	0	0	8	0	0
5	52725675	.	C	T	3	3	6	0	0	6	0	0
5	52726081	.	C	T	2	4	6	0	1	7	0	0
5	52726099	.	G	C	1	3	4	0	1	5	0	0
5	52730540	.	C	T	10	2	12	0	2	14	0	0
5	52730846	.	C	A	5	2	7	0	1	8	0	0
5	52731647	.	G	A	0	8	8	0	7	15	0	0
5	52731678	.	A	T	6	10	16	0	0	16	0	0
5	52731758	.	G	C	6	8	14	0	1	15	0	0
5	52731787	.	G	A	5	9	14	0	0	14	0	0
5	52731919	.	C	A	5	2	7	0	0	7	0	0
5	52732146	.	C	T	6	6	12	0	1	13	0	0
5	52732147	.	G	A	6	7	13	0	0	13	0	0
5	52732383	.	C	T	15	10	25	0	1	26	0	0
5	52732727	.	G	A	12	15	27	1	2	30	0	0
5	52732931	.	C	T	15	17	32	0	3	35	0	0
5	52732991	.	A	G	8	0	8	0	19	27	0	0
5	52733022	.	G	T	21	8	29	0	1	30	0	0
5	52733259	.	T	G	22	10	32	0	0	32	0	0
5	52733266	.	T	G	21	10	31	0	1	32	0	0
5	52733370	.	A	T	20	10	30	0	3	33	0	0
5	52733411	.	G	A	11	10	21	0	0	21	0	0
5	52745571	.	T	G	4	6	10	0	0	10	0	0
5	52748724	.	T	C	2	5	7	0	0	7	0	0
5	52751586	.	C	T	5	2	7	0	2	9	0	0
5	52752441	.	T	A	5	3	8	0	0	8	0	0
5	52752479	.	A	G	2	3	5	1	0	6	0	0
5	52855974	.	A	T	1	2	3	0	0	3	0	0
5	52858847	.	C	T	3	5	8	0	0	8	0	0
5	52858898	.	A	G	4	1	5	0	3	8	0	0
5	52859422	.	T	G	5	3	8	0	0	8	0	0
5	52859751	.	G	T	3	3	6	0	0	6	0	0
5	52860310	.	T	A	3	4	7	0	0	7	0	0
5	52860413	.	G	A	0	5	5	0	5	10	0	0
5	52860503	.	A	T	4	9	13	0	0	13	0	0
5	52860701	.	G	T	7	6	13	0	0	13	0	0
5	52860718	.	G	C	5	6	11	0	1	12	0	0
5	52860863	.	G	T	5	11	16	0	0	16	0	0
5	52860957	.	T	C	4	2	6	0	2	8	0	0
5	52861182	.	A	T	2	1	3	0	0	3	0	0
5	52861213	.	T	C	1	5	6	0	5	11	0	0
5	52861239	.	G	T	0	7	7	0	7	14	0	0
5	52861266	.	A	C	6	6	12	0	0	12	0	0
5	52861818	.	G	A	9	11	20	0	3	23	0	0
5	52937798	.	A	G	2	5	7	0	0	7	0	0
5	52937956	.	A	T	5	9	14	0	0	14	0	0
5	52937988	.	T	A	13	8	21	0	0	21	0	0
5	52938528	.	A	G	1	2	3	0	0	3	0	0
5	52938532	.	T	C	1	2	3	0	1	4	0	0
5	52938742	.	C	T	4	4	8	0	1	9	0	0
5	52938787	.	C	A	2	4	6	0	0	6	0	0
5	52962667	.	T	C	4	0	4	0	4	8	0	0
5	52972260	.	A	G	7	8	15	0	0	15	0	0
5	52972323	.	C	A	10	3	13	0	1	14	0	0
5	52988108	.	C	T	7	6	13	0	4	17	0	0
5	52988147	.	C	T	7	2	9	0	1	10	0	0
5	53003463	.	C	G	0	2	2	0	6	8	0	0
5	53003640	.	C	G	2	6	8	0	1	9	0	0
5	53003896	.	G	A	6	5	11	0	0	11	0	0
5	53009239	.	T	A	7	9	16	0	0	16	0	0
5	53041702	.	T	C	11	7	18	0	0	18	0	0
5	53734556	.	C	T	2	2	4	0	0	4	0	0
5	53759491	.	A	T	7	8	15	0	2	18	1	0
5	53865322	.	T	C	1	3	4	0	0	4	0	0
5	53876236	.	A	T	16	11	27	1	0	28	0	0
5	53876244	.	G	A	15	14	29	1	3	33	0	0
5	53899585	.	G	T	13	9	22	0	1	23	0	0
5	53908770	.	A	C	7	3	10	0	0	10	0	0
5	53908892	.	A	G	5	3	8	0	0	8	0	0
5	53908893	.	G	A	5	3	8	0	0	8	0	0
5	53908957	.	A	T	2	9	11	0	0	11	0	0
5	53909185	.	C	T	3	3	6	0	0	6	0	0
5	53909321	.	C	T	1	2	3	0	0	3	0	0
5	53909509	.	G	A	0	6	6	0	1	7	0	0
5	53909914	.	C	T	7	4	11	0	1	12	0	0
5	53910004	.	G	A	4	5	9	0	0	9	0	0
5	54280198	.	A	T	1	2	3	0	0	3	0	0
5	54280223	.	C	T	1	2	3	0	0	3	0	0
5	54280436	.	A	T	5	4	9	0	0	9	0	0
5	54280678	.	T	C	2	2	4	0	0	4	0	0
5	54280801	.	G	A	4	4	8	0	0	8	0	0
5	54280889	.	G	A	6	2	8	1	0	9	0	0
5	54290289	.	C	A	7	5	12	0	0	12	0	0
5	54304666	.	C	G	6	2	8	0	0	8	0	0
5	54304731	.	T	A	7	9	16	0	2	18	0	0
5	54304736	.	G	T	7	11	18	0	0	18	0	0
5	54305209	.	G	A	7	8	15	0	0	15	0	0
5	54309452	.	G	T	4	8	12	0	0	12	0	0
5	54337079	.	T	C	2	0	2	0	3	5	0	0
5	54337575	.	G	A	7	7	14	0	1	15	0	0
5	54337831	.	T	A	8	10	18	0	3	21	0	0
5	54337880	.	T	C	9	0	9	0	12	21	0	0
5	54337902	.	C	T	11	6	17	0	0	17	0	0
5	54337934	.	C	A	10	4	14	0	2	16	0	0
5	54339740	.	C	T	5	5	10	0	0	10	0	0
5	54340047	.	G	A	7	4	11	0	0	11	0	0
5	54342519	.	T	A	4	2	6	0	1	7	0	0
5	54395339	.	T	A	3	6	9	0	0	9	0	0
5	54416392	.	G	C	1	3	4	0	0	4	0	0
5	54416411	.	T	C	2	3	5	0	0	5	0	0
5	54416429	.	T	A	2	2	4	0	0	4	0	0
5	54416527	.	C	G	4	3	7	0	0	7	0	0
5	54416709	.	C	T	1	3	4	0	0	4	0	0
5	54416743	.	A	T	2	4	6	0	0	6	0	0
5	54416810	.	C	T	4	7	11	0	0	11	0	0
5	54416820	.	A	G	5	7	12	0	0	12	0	0
5	54457983	.	G	A	9	4	13	0	3	16	0	0
5	54458053	.	A	C	6	6	12	0	0	12	0	0
5	54458326	.	G	A	14	5	19	0	1	20	0	0
5	54458345	.	T	A	10	8	18	0	1	19	0	0
5	54458437	.	C	T	15	7	22	0	1	23	0	0
5	54458668	.	C	A	12	7	19	0	1	20	0	0
5	54458791	.	C	G	2	9	11	0	11	22	0	0
5	54458974	.	C	G	5	10	15	0	0	15	0	0
5	54459086	.	G	T	4	7	11	0	0	11	0	0
5	54459334	.	T	C	12	8	20	0	0	20	0	0
5	54459337	.	T	C	10	10	20	0	1	21	0	0
5	54459467	.	T	C	5	0	5	0	12	17	0	0
5	54459628	.	G	T	6	8	14	0	1	15	0	0
5	54459647	.	A	C	7	11	18	0	1	19	0	0
5	54459682	.	C	T	4	6	10	0	3	13	0	0
5	54459772	.	T	C	1	3	4	0	1	5	0	0
5	54460218	.	A	C	3	2	5	0	2	7	0	0
5	54460237	.	T	A	4	3	7	0	0	7	0	0
5	54460259	.	G	A	3	4	7	0	1	8	0	0
5	54460322	.	T	A	4	8	12	0	0	12	0	0
5	54460371	.	T	A	6	6	12	0	1	13	0	0
5	54460460	.	A	G	3	8	11	0	0	11	0	0
5	54460481	.	C	T	0	5	5	0	8	13	0	0
5	54460555	.	G	A	10	7	17	0	5	22	0	0
5	54460558	.	A	T	6	5	11	0	10	21	0	0
5	54470845	.	C	G	0	4	4	0	5	9	0	0
5	54470912	.	C	G	2	10	12	0	0	12	0	0
5	54471091	.	T	C	5	4	9	0	0	9	0	0
5	54473134	.	G	A	3	3	6	0	0	6	0	0
5	54482550	.	G	A	13	6	19	0	0	19	0	0
5	54482561	.	A	C	6	9	15	0	1	16	0	0
5	54482795	.	C	A	9	3	12	0	0	12	0	0
5	54482806	.	C	T	9	3	12	0	2	14	0	0
5	54482997	.	T	G	3	7	10	0	0	10	0	0
5	54492797	.	C	T	0	5	5	0	2	7	0	0
5	54492839	.	C	T	0	3	3	0	2	5	0	0
5	54497628	.	C	T	2	2	4	0	0	4	0	0
5	54498226	.	G	C	5	2	7	0	1	8	0	0
5	54498255	.	A	C	3	2	5	0	0	5	0	0
5	54498272	.	G	A	3	2	5	0	0	5	0	0
5	54498292	.	C	T	3	4	7	0	0	7	0	0
5	54498363	.	C	T	4	10	14	0	1	15	0	0
5	54498452	.	C	T	8	14	22	0	0	22	0	0
5	54501179	.	C	T	0	4	4	0	2	6	0	0
5	54501485	.	C	T	4	2	6	0	0	6	0	0
5	54502264	.	G	A	3	3	6	0	0	6	0	0
5	54502307	.	G	A	1	3	4	0	2	6	0	0
5	54541975	.	C	A	5	3	8	0	1	9	0	0
5	54554463	.	T	C	2	2	4	0	0	4	0	0
5	54554464	.	A	C	2	2	4	0	0	4	0	0
5	54558684	.	G	A	1	2	3	0	4	7	0	0
5	54558738	.	A	C	2	5	7	0	0	7	0	0
5	54564835	.	C	T	2	3	5	0	0	5	0	0
5	54572808	.	C	T	2	2	4	0	0	4	0	0
5	54572859	.	T	A	2	2	4	0	0	4	0	0
5	54576127	.	C	T	5	2	7	0	2	9	0	0
5	54576142	.	C	T	5	5	10	0	0	10	0	0
5	54576223	.	C	T	5	6	11	0	0	11	0	0
5	54576238	.	G	A	4	5	9	0	0	9	0	0
5	54576562	.	G	T	0	2	2	0	4	6	0	0
5	54579900	.	A	C	6	6	12	0	1	13	0	0
5	54579955	.	C	T	5	9	14	0	0	14	0	0
5	54580125	.	G	A	5	4	9	0	1	10	0	0
5	54602360	.	C	A	2	2	4	0	0	4	0	0
5	54610737	.	G	A	0	3	3	0	1	4	0	0
5	54624856	.	T	C	1	3	4	0	0	4	0	0
5	54652941	.	T	A	10	8	18	0	1	19	0	0
5	54652947	.	C	A	9	6	15	0	3	18	0	0
5	54656583	.	A	G	10	0	10	0	8	18	0	0
5	54656613	.	T	C	10	8	18	0	1	19	0	0
5	54685371	.	A	T	16	11	27	0	1	28	0	0
5	54685445	.	C	A	13	18	31	0	0	31	0	0
5	54719503	.	A	G	5	9	14	0	1	15	0	0
5	54719844	.	G	A	8	9	17	0	1	18	0	0
5	54720249	.	C	T	6	4	10	0	1	11	0	0
5	54726445	.	A	T	1	3	4	0	0	4	0	0
5	54767361	.	C	A	10	11	21	0	2	23	0	0
5	54767688	.	C	T	28	18	46	0	1	47	0	0
5	54767734	.	T	A	18	16	34	0	4	38	0	0
5	54768993	.	G	T	17	13	30	0	0	30	0	0
5	54769091	.	A	G	15	6	21	0	0	21	0	0
5	54769133	.	A	G	12	7	19	0	2	21	0	0
5	54769896	.	A	G	15	12	27	0	2	29	0	0
5	54769914	.	C	T	13	14	27	0	2	29	0	0
5	54770121	.	T	C	17	15	32	0	3	35	0	0
5	54770370	.	G	A	16	17	33	0	0	33	0	0
5	54770889	.	C	T	17	19	36	0	1	37	0	0
5	54772955	.	T	C	2	6	8	0	0	8	0	0
5	54773182	.	C	A	0	6	6	0	8	14	0	0
5	54776413	.	G	C	1	5	6	0	0	6	0	0
5	54790426	.	A	C	2	3	5	0	0	5	0	0
5	54790751	.	A	C	2	3	5	0	0	5	0	0
5	54955898	.	G	T	2	2	4	0	0	4	0	0
5	54961109	.	A	G	4	3	7	0	0	7	0	0
5	54971774	.	G	C	2	2	4	0	0	4	0	0
5	54982520	.	G	A	1	3	4	0	0	4	0	0
5	55165175	.	A	T	6	16	22	0	0	22	0	0
5	55168177	.	G	T	15	18	33	1	0	34	0	0
5	55371908	.	C	T	11	8	19	0	3	22	0	0
5	55372218	.	A	G	13	14	27	0	3	30	0	0
5	55372425	.	A	C	16	13	29	0	0	29	0	0
5	55372761	.	G	T	11	8	19	0	1	20	0	0
5	55372773	.	A	T	8	11	19	0	0	19	0	0
5	55373299	.	G	A	16	21	37	0	2	39	0	0
5	55373869	.	G	T	6	7	13	0	0	13	0	0
5	55374343	.	T	A	3	9	12	0	3	15	0	0
5	55374560	.	T	C	2	5	7	0	0	7	0	0
5	55588458	.	T	C	4	8	12	0	0	12	0	0
5	55588562	.	T	C	9	7	16	0	0	16	0	0
5	55599950	.	G	C	7	3	10	0	0	10	0	0
5	55600108	.	A	C	2	8	10	0	0	10	0	0
5	55600149	.	T	C	3	3	6	0	1	7	0	0
5	55600154	.	A	G	4	2	6	0	0	6	0	0
5	55604037	.	G	C	12	7	19	0	3	22	0	0
5	55604162	.	G	C	15	12	27	0	3	30	0	0
5	55604211	.	A	T	26	8	34	0	3	37	0	0
5	55604228	.	G	T	23	11	34	0	3	37	0	0
5	55604302	.	A	T	36	2	38	1	0	39	0	0
5	55604438	.	A	G	18	17	35	1	1	37	0	0
5	55609426	.	T	G	21	22	43	0	3	46	0	0
5	55613789	.	G	A	16	18	34	0	1	35	0	0
5	55613813	.	A	C	14	12	26	0	2	28	0	0
5	55613864	.	A	G	13	11	24	0	2	26	0	0
5	55613999	.	G	A	15	6	21	0	0	21	0	0
5	55626700	.	T	A	2	2	4	0	0	4	0	0
5	55720177	.	A	G	20	2	22	1	2	25	0	0
5	55720486	.	C	T	1	7	8	0	7	15	0	0
5	55723534	.	A	G	6	4	10	0	0	10	0	0
5	55763649	.	A	G	28	23	51	0	5	56	0	0
5	55763752	.	G	T	26	19	45	0	1	46	0	0
5	55763884	.	G	A	20	28	48	0	3	51	0	0
5	55764173	.	T	C	12	1	13	0	19	32	0	0
5	55764509	.	G	A	26	20	46	0	4	50	0	0
5	55773856	.	A	G	8	13	21	0	1	22	0	0
5	55866925	.	C	T	0	2	2	0	5	7	0	0
5	55873688	.	G	T	6	3	9	0	0	9	0	0
5	55873712	.	C	A	6	4	10	0	0	10	0	0
5	55876311	.	C	G	1	3	4	0	0	4	0	0
5	55876508	.	C	G	5	5	10	0	0	10	0	0
5	55876698	.	T	A	2	3	5	0	0	5	0	0
5	55920930	.	A	C	2	2	4	0	0	4	0	0
5	55920943	.	A	T	3	2	5	0	0	5	0	0
5	55921076	.	A	T	8	8	16	0	3	19	0	0
5	55921335	.	G	A	18	15	33	0	0	33	0	0
5	55921628	.	T	C	7	4	11	0	0	11	0	0
5	55921931	.	A	G	5	9	14	0	0	14	0	0
5	55928142	.	G	A	5	3	8	0	1	9	0	0
5	55928367	.	A	G	2	3	5	0	1	6	0	0
5	55933055	.	G	A	3	5	8	0	0	8	0	0
5	55933243	.	T	C	4	4	8	0	0	8	0	0
5	55951471	.	T	G	2	4	6	0	1	7	0	0
5	56091095	.	C	T	2	5	7	0	0	7	0	0
5	56100260	.	T	A	12	5	17	1	0	18	0	0
5	56102224	.	A	C	6	4	10	0	1	11	0	0
5	56102462	.	A	G	2	4	6	0	0	6	0	0
5	56110137	.	C	T	5	2	7	0	0	7	0	0
5	56113870	.	C	T	2	2	4	0	0	4	0	0
5	56271365	.	T	C	4	3	7	0	0	7	0	0
5	56274002	.	A	G	5	4	9	0	0	9	0	0
5	56289800	.	G	A	0	3	3	0	4	7	0	0
5	56289818	.	C	A	3	3	6	0	0	6	0	0
5	56289884	.	A	G	1	3	4	0	0	4	0	0
5	56289904	.	T	C	2	3	5	0	0	5	0	0
5	56289925	.	G	A	1	3	4	0	1	5	0	0
5	56308816	.	C	T	3	10	13	0	17	30	0	0
5	56309013	.	G	C	20	8	28	1	1	30	0	0
5	56309109	.	C	T	1	27	28	0	14	42	0	0
5	56309115	.	A	T	12	28	40	0	1	41	0	0
5	56309244	.	A	G	8	4	12	0	2	14	0	0
5	56309246	.	A	C	9	5	14	0	1	15	0	0
5	56309454	.	A	G	22	8	30	0	2	32	0	0
5	56309517	.	T	C	11	10	21	0	3	24	0	0
5	56309672	.	C	A	1	12	13	0	12	25	0	0
5	56309677	.	C	A	11	13	24	0	0	24	0	0
5	56309761	.	G	C	13	11	24	0	2	26	0	0
5	56309844	.	G	A	26	11	37	0	0	37	0	0
5	56313189	.	A	G	12	24	36	0	5	41	0	0
5	56313207	.	G	A	18	25	43	0	1	44	0	0
5	56317153	.	T	A	13	12	25	0	0	25	0	0
5	56317170	.	C	T	11	16	27	0	1	28	0	0
5	56317377	.	G	A	19	15	34	0	5	39	0	0
5	56322148	.	A	G	8	9	17	0	1	18	0	0
5	56322205	.	C	T	16	7	23	0	3	26	0	0
5	56322404	.	A	G	16	11	27	0	0	27	0	0
5	56322449	.	T	C	12	8	20	0	1	21	0	0
5	56322467	.	G	A	10	5	15	0	0	15	0	0
5	56322680	.	A	G	12	5	17	0	0	17	0	0
5	56326485	.	C	T	8	3	11	0	1	12	0	0
5	56340613	.	A	G	4	5	9	0	0	9	0	0
5	56343032	.	C	T	0	3	3	0	10	13	0	0
5	56343095	.	C	T	3	3	6	0	0	6	0	0
5	56345109	.	A	G	2	2	4	0	2	6	0	0
5	56345138	.	T	G	2	4	6	0	0	6	0	0
5	56355401	.	A	G	3	3	6	0	0	6	0	0
5	56364898	.	G	A	4	2	6	0	0	6	0	0
5	56364907	.	A	G	4	2	6	0	0	6	0	0
5	56364979	.	A	G	1	3	4	0	0	4	0	0
5	56364982	.	G	T	1	3	4	0	0	4	0	0
5	56375289	.	G	T	2	2	4	0	0	4	0	0
5	56376648	.	A	G	2	2	4	0	0	4	0	0
5	56915023	.	G	A	4	3	7	0	0	7	0	0
5	56918932	.	G	A	7	3	10	0	0	10	0	0
5	56918974	.	A	G	5	3	8	0	0	8	0	0
5	56921765	.	T	C	4	0	4	0	6	10	0	0
5	56927749	.	G	T	1	5	6	0	0	6	0	0
5	56927772	.	C	T	2	3	5	0	0	5	0	0
5	56927784	.	G	A	2	2	4	0	0	4	0	0
5	56927898	.	G	A	2	7	9	0	0	9	0	0
5	56935240	.	A	G	4	2	6	0	0	6	0	0
5	56939449	.	C	T	0	3	3	0	1	4	0	0
5	56951015	.	A	C	8	0	8	0	15	23	0	0
5	56951081	.	T	C	12	21	33	1	6	40	0	0
5	56951144	.	A	T	11	17	28	0	1	29	0	0
5	56951156	.	C	T	23	12	35	0	1	36	0	0
5	56951220	.	C	T	20	20	40	0	2	42	0	0
5	56951258	.	A	C	9	10	19	0	1	20	0	0
5	56951686	.	G	A	9	10	19	0	3	22	0	0
5	56958513	.	C	T	5	7	12	0	1	13	0	0
5	56964475	.	G	A	3	3	6	0	0	6	0	0
5	57217343	.	T	G	4	3	7	0	0	7	0	0
5	57219429	.	T	C	2	4	6	0	0	6	0	0
5	57219430	.	T	A	0	4	4	0	2	6	0	0
5	57219496	.	G	A	1	2	3	0	0	3	0	0
5	57219643	.	T	C	4	2	6	0	0	6	0	0
5	57219789	.	C	T	3	3	6	0	0	6	0	0
5	57219938	.	G	C	1	4	5	0	9	14	0	0
5	57219990	.	C	A	1	5	6	0	0	6	0	0
5	57220108	.	G	A	1	6	7	0	6	13	0	0
5	57220262	.	A	T	2	3	5	0	0	5	0	0
5	57220324	.	T	C	4	2	6	0	0	6	0	0
5	57225332	.	C	T	5	5	10	0	1	11	0	0
5	57225343	.	C	T	6	7	13	0	0	13	0	0
5	57225496	.	C	G	7	0	7	0	8	15	0	0
5	57226522	.	T	C	11	9	20	0	0	20	0	0
5	57234053	.	A	C	1	5	6	0	1	7	0	0
5	57320235	.	C	T	32	24	56	1	3	60	0	0
5	57320274	.	G	A	33	27	60	0	5	65	0	0
5	57324956	.	A	C	32	27	59	0	4	63	0	0
5	57325158	.	T	G	29	29	58	1	1	60	0	0
5	57325204	.	T	G	37	3	40	0	30	70	0	0
5	57325210	.	G	A	35	33	68	0	4	72	0	0
5	57325359	.	G	A	29	23	52	0	9	61	0	0
5	57325537	.	C	T	7	6	13	0	5	18	0	0
5	57340478	.	T	A	1	2	3	0	0	3	0	0
5	57347737	.	T	C	1	2	3	0	0	3	0	0
5	57350958	.	C	T	3	2	5	0	0	5	0	0
5	57352495	.	A	G	2	3	5	0	0	5	0	0
5	57353387	.	T	C	2	6	8	0	1	9	0	0
5	57353959	.	C	A	2	7	9	2	3	14	0	0
5	57353981	.	C	T	4	10	14	0	2	16	0	0
5	57354046	.	G	A	9	8	17	0	0	17	0	0
5	57354096	.	A	G	4	4	8	0	0	8	0	0
5	57354166	.	T	C	3	11	14	0	0	14	0	0
5	57354552	.	C	T	5	10	15	0	2	17	0	0
5	57354596	.	C	T	6	6	12	0	1	14	1	0
5	57354656	.	A	G	7	6	13	0	0	13	0	0
5	57354680	.	G	A	1	13	14	0	8	22	0	0
5	57354719	.	T	G	11	16	27	0	1	28	0	0
5	57354786	.	G	T	7	10	17	0	1	18	0	0
5	57354839	.	A	G	5	0	5	0	6	11	0	0
5	57359740	.	G	A	6	16	22	0	0	22	0	0
5	57359811	.	A	G	6	13	19	0	0	19	0	0
5	57361541	.	T	C	5	16	21	0	2	23	0	0
5	57442382	.	G	A	0	2	2	0	3	5	0	0
5	57442389	.	T	G	2	2	4	0	1	5	0	0
5	57446925	.	G	A	2	5	7	0	0	7	0	0
5	57447301	.	C	T	2	3	5	0	0	5	0	0
5	57450440	.	C	A	4	6	10	0	0	10	0	0
5	57450973	.	A	G	7	1	8	0	6	14	0	0
5	57453587	.	T	C	3	2	5	0	2	7	0	0
5	57453635	.	T	C	4	2	6	0	0	6	0	0
5	57489777	.	T	C	9	0	9	0	17	26	0	0
5	57490099	.	G	A	12	9	21	0	0	21	0	0
5	57490153	.	T	C	9	14	23	0	1	24	0	0
5	57500086	.	T	C	10	14	24	0	0	24	0	0
5	57506568	.	A	C	15	13	28	0	2	30	0	0
5	57506622	.	A	G	14	7	21	0	0	21	0	0
5	57506646	.	C	T	0	7	7	0	10	17	0	0
5	57514332	.	G	A	8	8	16	0	1	17	0	0
5	57514428	.	G	A	12	16	28	0	0	28	0	0
5	57641751	.	C	T	1	3	4	0	0	4	0	0
5	57641808	.	T	C	1	7	8	0	0	8	0	0
5	57641895	.	T	C	1	4	5	0	0	5	0	0
5	57643949	.	T	C	2	7	9	0	0	9	0	0
5	57644184	.	T	G	4	6	10	0	0	10	0	0
5	57644495	.	A	T	1	2	3	0	0	3	0	0
5	57644519	.	A	T	2	2	4	0	0	4	0	0
5	57644555	.	C	T	1	5	6	0	0	6	0	0
5	57644563	.	A	G	1	5	6	0	0	6	0	0
5	57645325	.	T	C	0	4	4	0	1	5	0	0
5	57645466	.	G	A	2	2	4	1	0	5	0	0
5	57650592	.	G	T	2	4	6	0	0	6	0	0
5	57704805	.	T	C	2	0	2	0	2	4	0	0
5	57715904	.	T	C	15	12	27	0	1	28	0	0
5	57716169	.	T	C	11	14	25	0	0	25	0	0
5	57718488	.	A	C	10	6	16	0	3	21	2	0
5	57718554	.	T	G	5	8	13	0	1	15	1	0
5	57718558	.	G	T	6	7	13	0	1	14	0	0
5	57718649	.	A	G	25	0	25	0	0	26	1	0
5	57718659	.	C	T	12	17	29	0	1	30	0	0
5	57718716	.	T	C	9	13	22	0	2	24	0	0
5	57718739	.	T	C	6	10	16	0	2	18	0	0
5	57726573	.	T	A	3	2	5	0	0	5	0	0
5	57735420	.	A	G	4	3	7	0	1	8	0	0
5	57737337	.	A	G	6	3	9	0	0	9	0	0
5	57737389	.	C	T	4	3	7	0	0	7	0	0
5	57737395	.	T	C	5	3	8	0	0	8	0	0
5	57737504	.	C	A	3	6	9	0	0	9	0	0
5	57737727	.	A	T	5	3	8	0	0	8	0	0
5	57737862	.	T	A	4	5	9	0	0	9	0	0
5	57737863	.	A	C	4	5	9	0	0	9	0	0
5	57738078	.	C	T	8	8	16	0	0	16	0	0
5	57738233	.	C	T	5	5	10	0	0	10	0	0
5	57738321	.	G	A	2	3	5	0	0	5	0	0
5	57743868	.	G	A	1	2	3	0	1	4	0	0
5	57743907	.	A	G	1	4	5	0	0	5	0	0
5	57744681	.	C	T	1	2	3	0	0	3	0	0
5	57744731	.	T	C	1	2	3	0	0	3	0	0
5	57751167	.	A	G	3	5	8	0	0	8	0	0
5	57751676	.	T	A	3	5	8	0	2	10	0	0
5	57753821	.	C	T	10	7	17	0	0	17	0	0
5	57753827	.	A	G	11	0	11	0	5	16	0	0
5	57755422	.	T	C	7	5	12	0	0	12	0	0
5	57755844	.	C	T	8	13	21	0	1	22	0	0
5	57762423	.	A	T	11	28	39	0	0	39	0	0
5	57762656	.	T	G	14	26	40	0	0	40	0	0
5	57762849	.	A	T	9	19	28	0	1	29	0	0
5	57762868	.	A	G	11	16	27	0	1	28	0	0
5	57762900	.	T	C	15	16	31	0	1	32	0	0
5	57762938	.	A	T	15	17	32	0	2	34	0	0
5	57762986	.	C	G	11	11	22	0	2	24	0	0
5	57777906	.	C	G	5	0	5	0	11	16	0	0
5	57787630	.	C	T	22	19	41	0	1	42	0	0
5	57790313	.	G	A	22	23	45	0	4	49	0	0
5	57790583	.	G	A	30	20	50	0	4	54	0	0
5	57797085	.	A	C	20	30	50	0	8	58	0	0
5	57797152	.	G	A	1	36	37	0	24	61	0	0
5	57797844	.	C	T	22	33	55	0	7	62	0	0
5	57797887	.	A	T	27	33	60	0	4	64	0	0
5	57797914	.	A	G	28	1	29	0	23	52	0	0
5	57797954	.	T	C	23	17	40	0	0	40	0	0
5	57814360	.	G	A	1	2	3	0	0	3	0	0
5	57814454	.	C	A	3	2	5	0	0	5	0	0
5	57814523	.	A	G	3	2	5	0	1	6	0	0
5	57814627	.	G	A	6	10	16	0	0	16	0	0
5	57814726	.	A	G	2	2	4	0	0	4	0	0
5	57815018	.	G	A	3	4	7	0	0	7	0	0
5	57819001	.	A	G	1	2	3	0	0	3	0	0
5	58075599	.	C	T	2	4	6	0	0	6	0	0
5	58075815	.	T	G	4	3	7	0	1	8	0	0
5	58075863	.	G	A	4	2	6	0	1	7	0	0
5	58081110	.	C	T	2	3	5	0	0	5	0	0
5	58372217	.	G	A	21	4	25	0	3	29	1	0
5	58372226	.	C	T	26	13	39	0	2	41	0	0
5	58372268	.	T	C	36	21	57	0	3	60	0	0
5	58382159	.	A	G	33	1	34	0	33	67	0	0
5	58382358	.	C	T	29	24	53	0	6	59	0	0
5	58382440	.	T	A	29	13	42	0	3	63	18	0
5	58382457	.	C	G	39	4	43	0	17	60	0	0
5	58412403	.	T	C	6	2	8	0	0	8	0	0
5	58450380	.	A	T	1	2	3	0	0	3	0	0
5	58455514	.	T	A	1	3	4	0	0	4	0	0
5	58455545	.	G	T	1	2	3	0	0	3	0	0
5	58457014	.	T	C	2	4	6	0	0	6	0	0
5	58459461	.	T	C	7	7	14	0	0	14	0	0
5	58459476	.	A	C	6	4	10	0	1	11	0	0
5	58462891	.	A	G	8	0	8	0	6	14	0	0
5	58468137	.	T	C	6	10	16	0	1	17	0	0
5	58468173	.	A	G	5	0	5	0	7	12	0	0
5	58470952	.	C	G	11	7	18	0	1	19	0	0
5	58477239	.	C	A	21	9	30	0	1	31	0	0
5	58477248	.	T	A	17	9	26	0	0	26	0	0
5	58477449	.	A	T	13	10	23	0	1	24	0	0
5	58478136	.	T	C	10	18	28	0	3	31	0	0
5	58478188	.	C	T	16	10	26	0	3	29	0	0
5	58481826	.	T	C	8	6	14	0	1	15	0	0
5	58500489	.	G	A	2	2	4	0	0	4	0	0
5	58504447	.	G	T	4	10	14	0	1	15	0	0
5	58504562	.	G	T	4	8	12	0	0	12	0	0
5	58511553	.	T	C	31	7	38	0	2	41	1	0
5	58687623	.	A	T	6	9	15	0	1	16	0	0
5	58687649	.	C	A	6	10	16	0	0	16	0	0
5	58687673	.	T	C	4	5	9	0	1	10	0	0
5	58687690	.	T	A	4	5	9	0	1	10	0	0
5	58687739	.	G	A	0	4	4	0	6	10	0	0
5	58688621	.	T	A	6	4	10	0	1	11	0	0
5	58688687	.	G	A	0	2	2	0	12	14	0	0
5	58691748	.	A	G	12	20	32	0	1	33	0	0
5	58691763	.	T	G	12	26	38	0	2	40	0	0
5	58695746	.	A	T	7	10	17	0	2	19	0	0
5	58695764	.	G	A	2	11	13	0	4	17	0	0
5	58696063	.	G	A	10	6	16	0	0	16	0	0
5	58696236	.	G	A	2	3	5	0	0	5	0	0
5	58696412	.	A	C	8	11	19	0	2	21	0	0
5	58696670	.	T	C	11	3	14	0	15	29	0	0
5	58696840	.	G	A	9	8	17	0	1	18	0	0
5	58696997	.	T	G	7	8	15	0	4	19	0	0
5	58697007	.	A	C	8	13	21	0	0	21	0	0
5	58697050	.	C	T	7	9	16	0	0	16	0	0
5	58699888	.	C	T	8	6	14	0	2	16	0	0
5	58704284	.	G	C	3	8	11	0	0	11	0	0
5	58707265	.	A	G	10	6	16	0	0	16	0	0
5	58708812	.	T	G	4	11	15	0	0	15	0	0
5	58708832	.	T	G	2	11	13	0	1	14	0	0
5	58708996	.	G	T	4	6	10	0	1	11	0	0
5	58711159	.	G	T	6	9	15	0	1	16	0	0
5	58713579	.	C	T	2	8	10	0	0	10	0	0
5	58717412	.	C	T	6	3	9	0	1	10	0	0
5	58717535	.	C	G	1	3	4	0	6	10	0	0
5	58717618	.	A	T	4	5	9	0	0	10	1	0
5	58719628	.	C	T	3	7	10	0	0	10	0	0
5	58721406	.	C	T	0	4	4	0	3	7	0	0
5	58722507	.	T	C	2	5	7	0	0	7	0	0
5	58726558	.	C	T	6	4	10	0	0	10	0	0
5	58726575	.	C	T	3	4	7	0	0	7	0	0
5	58730739	.	G	A	1	2	3	0	0	3	0	0
5	58751855	.	T	A	2	4	6	0	1	7	0	0
5	58850883	.	A	T	22	16	38	0	0	38	0	0
5	58850923	.	A	C	21	15	36	0	1	37	0	0
5	58850958	.	T	C	17	1	18	0	14	32	0	0
5	58850981	.	A	T	22	15	37	0	0	37	0	0
5	58851041	.	G	T	20	14	34	0	2	37	1	0
5	58852256	.	G	A	10	11	21	0	0	21	0	0
5	58852582	.	G	A	2	8	10	2	0	12	0	0
5	58852687	.	A	G	13	13	26	0	3	29	0	0
5	58852758	.	C	A	16	7	23	0	1	24	0	0
5	58852784	.	A	G	13	6	19	0	2	21	0	0
5	58852825	.	A	C	11	15	26	0	1	27	0	0
5	58852873	.	T	A	5	5	10	0	1	12	1	0
5	58853407	.	C	T	1	3	4	0	1	5	0	0
5	59060824	.	C	T	6	4	10	0	0	10	0	0
5	59063090	.	C	A	2	5	7	0	0	7	0	0
5	59063102	.	C	T	3	4	7	0	0	7	0	0
5	59079594	.	A	G	5	11	16	0	1	17	0	0
5	59079726	.	C	A	7	12	19	0	1	20	0	0
5	59079732	.	A	C	9	10	19	0	2	21	0	0
5	59079806	.	C	A	7	13	20	0	1	21	0	0
5	59080392	.	C	A	5	2	7	0	2	9	0	0
5	59080874	.	A	G	5	3	8	0	0	8	0	0
5	59081816	.	T	G	2	3	5	0	0	5	0	0
5	59081830	.	A	G	1	3	4	0	0	4	0	0
5	59082395	.	C	T	7	9	16	1	0	17	0	0
5	59082540	.	C	T	12	6	18	0	1	19	0	0
5	59082581	.	T	A	12	10	22	0	0	22	0	0
5	59082685	.	G	A	16	9	25	0	0	25	0	0
5	59082703	.	T	C	16	6	22	0	0	22	0	0
5	59082882	.	C	T	10	18	28	0	1	29	0	0
5	59083136	.	T	G	10	8	18	0	3	21	0	0
5	59083180	.	G	T	0	9	9	0	5	14	0	0
5	59083201	.	T	A	3	7	10	0	0	10	0	0
5	59092513	.	A	G	8	13	21	0	2	23	0	0
5	59092644	.	G	A	12	14	26	0	0	26	0	0
5	59100577	.	G	A	7	4	11	0	1	12	0	0
5	59101602	.	A	G	4	4	8	0	1	9	0	0
5	59101813	.	G	A	5	4	9	0	0	9	0	0
5	59107979	.	T	A	2	2	4	0	1	5	0	0
5	59147690	.	C	T	1	4	5	0	0	5	0	0
5	59147711	.	T	C	1	5	6	0	0	6	0	0
5	59198679	.	C	T	3	5	8	0	0	8	0	0
5	59200206	.	G	T	5	2	7	0	0	7	0	0
5	59200369	.	T	C	4	2	6	0	0	6	0	0
5	59200372	.	T	A	4	2	6	0	0	6	0	0
5	59200435	.	T	G	2	2	4	0	0	4	0	0
5	59200444	.	G	A	2	3	5	0	0	5	0	0
5	59200523	.	C	G	2	6	8	0	0	8	0	0
5	59200640	.	C	T	1	3	4	0	1	5	0	0
5	59200649	.	A	G	1	4	5	0	0	5	0	0
5	59200687	.	C	A	4	6	10	0	0	10	0	0
5	59200721	.	G	A	0	2	2	0	7	9	0	0
5	59200733	.	G	A	6	2	8	0	1	9	0	0
5	59201066	.	T	G	2	2	4	0	0	4	0	0
5	59201099	.	T	C	1	2	3	0	1	4	0	0
5	59201199	.	C	T	2	3	5	0	0	5	0	0
5	59201211	.	A	T	2	4	6	0	0	7	1	0
5	59201259	.	G	A	1	5	6	0	0	6	0	0
5	59201263	.	G	A	1	3	4	0	1	5	0	0
5	59201364	.	C	T	5	3	8	0	0	8	0	0
5	59201420	.	A	G	1	1	2	0	0	2	0	0
5	59201427	.	C	G	1	2	3	0	0	3	0	0
5	59201474	.	C	T	3	2	5	0	0	5	0	0
5	59201609	.	A	T	5	5	10	0	2	12	0	0
5	59201624	.	C	T	4	5	9	0	1	10	0	0
5	59201883	.	T	G	11	4	15	0	0	15	0	0
5	59239773	.	C	G	8	7	15	0	0	15	0	0
5	59303988	.	C	T	2	2	4	0	0	4	0	0
5	59328502	.	G	A	1	2	3	0	0	3	0	0
5	59367819	.	C	G	3	9	12	0	0	12	0	0
5	59368510	.	C	T	6	4	10	0	0	10	0	0
5	59380488	.	C	T	4	2	6	0	0	6	0	0
5	59384206	.	A	G	1	3	4	0	0	4	0	0
5	59386337	.	G	T	0	4	4	0	2	6	0	0
5	59386456	.	T	C	3	7	10	0	0	10	0	0
5	59386512	.	C	G	2	5	7	0	0	7	0	0
5	59386964	.	G	T	2	3	5	0	0	5	0	0
5	59387094	.	A	T	4	3	7	0	0	7	0	0
5	59387184	.	A	T	6	4	10	0	1	11	0	0
5	59387298	.	C	T	14	5	19	0	0	19	0	0
5	59387306	.	A	G	15	5	20	0	1	21	0	0
5	59387415	.	G	A	10	3	13	0	1	14	0	0
5	59387476	.	C	A	10	5	15	0	0	15	0	0
5	59387478	.	C	A	10	5	15	0	0	15	0	0
5	59388251	.	T	A	3	4	7	0	1	8	0	0
5	59388343	.	T	C	4	3	7	0	0	7	0	0
5	59388586	.	T	A	11	7	18	0	1	19	0	0
5	59388604	.	T	C	13	10	23	0	3	26	0	0
5	59388951	.	T	A	10	8	18	0	1	19	0	0
5	59389243	.	G	A	3	4	7	0	0	7	0	0
5	59389440	.	T	A	8	8	16	0	0	16	0	0
5	59389444	.	T	A	8	8	16	0	0	16	0	0
5	59389688	.	G	A	11	8	19	0	1	20	0	0
5	59389786	.	T	G	6	7	13	0	1	14	0	0
5	59397689	.	A	C	1	2	3	0	1	4	0	0
5	59398522	.	A	G	1	3	4	0	1	5	0	0
5	59419988	.	T	C	2	2	4	0	0	4	0	0
5	59420096	.	T	C	1	3	4	0	0	4	0	0
5	59420111	.	G	A	1	3	4	0	0	4	0	0
5	59420291	.	A	G	2	0	2	0	7	9	0	0
5	59420321	.	A	C	2	3	5	0	1	6	0	0
5	59420414	.	G	T	1	2	3	0	0	3	0	0
5	59449767	.	C	T	4	5	9	0	0	9	0	0
5	59462424	.	G	T	3	3	6	0	1	7	0	0
5	59462457	.	G	A	3	5	8	0	0	8	0	0
5	59462595	.	C	T	7	3	10	0	1	11	0	0
5	59462679	.	C	T	3	3	6	0	1	7	0	0
5	59462881	.	G	A	3	5	8	0	1	9	0	0
5	59462991	.	T	C	2	3	5	0	0	5	0	0
5	59462994	.	A	T	2	3	5	0	0	5	0	0
5	59463183	.	G	T	2	9	11	0	1	12	0	0
5	59463261	.	C	A	4	5	9	0	1	10	0	0
5	59463327	.	A	C	5	4	9	0	1	10	0	0
5	59466867	.	T	G	3	0	3	0	6	9	0	0
5	59466882	.	G	A	0	7	7	0	3	10	0	0
5	59466930	.	A	G	4	9	13	0	1	14	0	0
5	59472724	.	T	C	8	7	15	0	0	15	0	0
5	59473728	.	T	C	4	4	8	0	1	9	0	0
5	59479541	.	C	A	5	10	15	1	2	18	0	0
5	59479546	.	A	C	8	12	20	1	0	21	0	0
5	59479973	.	C	T	9	6	15	0	0	15	0	0
5	59515419	.	A	T	4	5	9	0	0	9	0	0
5	59537024	.	G	A	0	6	6	0	1	7	0	0
5	59537176	.	G	A	2	3	5	0	0	5	0	0
5	59544291	.	T	C	10	3	13	0	0	13	0	0
5	59544327	.	C	T	4	5	9	0	1	10	0	0
5	59544645	.	G	T	6	3	9	0	0	9	0	0
5	59548976	.	C	G	3	2	5	0	1	6	0	0
5	59549006	.	G	A	1	5	6	0	7	13	0	0
5	59549038	.	A	C	5	4	9	0	2	11	0	0
5	59549143	.	A	G	10	1	11	0	8	19	0	0
5	59549148	.	G	A	12	6	18	0	1	19	0	0
5	59549182	.	G	A	10	5	15	0	0	15	0	0
5	59549236	.	C	T	5	2	7	0	0	7	0	0
5	59550260	.	A	T	6	10	16	0	0	16	0	0
5	59550529	.	T	G	5	5	10	0	1	11	0	0
5	59550581	.	T	C	6	4	10	0	1	11	0	0
5	59550713	.	T	C	9	5	14	0	0	14	0	0
5	59550725	.	G	T	5	3	8	0	0	8	0	0
5	59550762	.	A	C	6	2	8	0	0	8	0	0
5	59553797	.	A	G	1	0	1	0	4	5	0	0
5	59559950	.	T	C	5	3	8	0	0	8	0	0
5	59560110	.	T	C	6	7	13	0	0	13	0	0
5	59560131	.	A	G	3	0	3	0	8	11	0	0
5	59593297	.	G	C	0	13	13	0	8	21	0	0
5	59593408	.	G	T	3	7	10	0	0	10	0	0
5	59593523	.	C	T	4	5	9	0	0	9	0	0
5	59593685	.	A	T	4	3	7	1	0	8	0	0
5	59593773	.	G	C	7	9	16	0	4	20	0	0
5	59593822	.	G	T	7	5	12	0	1	13	0	0
5	59593884	.	T	G	2	3	5	0	0	5	0	0
5	59594328	.	T	C	6	5	11	0	1	12	0	0
5	59594485	.	G	T	18	8	26	0	1	27	0	0
5	59594551	.	A	G	23	0	23	0	7	30	0	0
5	59594648	.	A	T	7	6	13	0	0	13	0	0
5	59595127	.	T	C	8	4	12	0	2	14	0	0
5	59595241	.	T	C	7	10	17	0	1	18	0	0
5	59595252	.	C	T	10	10	20	0	0	20	0	0
5	59595502	.	T	C	5	11	16	0	0	16	0	0
5	59595503	.	G	C	5	10	15	0	1	16	0	0
5	60673572	.	C	G	2	2	4	0	0	4	0	0
5	60684257	.	C	T	2	4	6	0	0	6	0	0
5	60684494	.	T	C	2	3	5	0	1	6	0	0
5	60684866	.	C	T	1	5	6	0	1	7	0	0
5	60685209	.	A	T	3	7	10	0	1	12	1	0
5	60685481	.	G	A	8	13	21	0	1	22	0	0
5	60685513	.	A	G	14	8	22	0	2	24	0	0
5	60685758	.	T	C	3	8	11	0	0	11	0	0
5	60685773	.	C	T	4	7	11	0	0	11	0	0
5	60685822	.	C	T	6	10	16	0	1	17	0	0
5	60685851	.	G	A	8	4	12	0	3	15	0	0
5	60686374	.	A	T	7	11	18	0	1	19	0	0
5	60686380	.	C	A	9	11	20	0	1	21	0	0
5	60686686	.	C	G	9	10	19	0	1	20	0	0
5	60686910	.	G	T	15	23	38	0	0	38	0	0
5	60687327	.	T	C	4	9	13	0	2	15	0	0
5	60687344	.	A	T	11	4	15	0	0	15	0	0
5	60853645	.	G	A	0	3	3	0	1	4	0	0
5	60863107	.	C	T	2	3	5	0	1	6	0	0
5	60866063	.	G	T	5	5	10	0	0	10	0	0
5	60868173	.	G	A	1	3	4	0	6	10	0	0
5	60868216	.	G	A	10	5	15	0	1	16	0	0
5	60868958	.	T	C	5	8	13	0	0	13	0	0
5	60868960	.	G	A	0	8	8	0	5	13	0	0
5	60869015	.	C	A	8	7	15	0	0	15	0	0
5	60871999	.	A	T	7	14	21	0	0	21	0	0
5	60872126	.	G	A	11	8	19	0	0	19	0	0
5	60872258	.	C	T	2	4	6	0	1	7	0	0
5	60872299	.	T	G	5	4	9	0	1	10	0	0
5	60872320	.	T	C	8	4	12	0	0	12	0	0
5	60872472	.	G	A	9	11	20	0	0	20	0	0
5	60872708	.	T	C	3	5	8	0	0	8	0	0
5	61270901	.	G	A	5	11	16	0	0	16	0	0
5	61270905	.	C	T	5	9	14	0	1	15	0	0
5	61329486	.	G	A	10	5	15	0	1	16	0	0
5	61329604	.	C	T	8	13	21	0	0	21	0	0
5	61349991	.	C	T	5	3	8	0	0	8	0	0
5	61351582	.	C	A	7	13	20	0	0	20	0	0
5	61351600	.	C	A	8	9	17	0	0	17	0	0
5	61351851	.	C	T	8	11	19	0	1	20	0	0
5	61353710	.	G	C	6	3	9	0	7	16	0	0
5	61354112	.	G	T	11	6	17	0	1	18	0	0
5	61380103	.	T	A	6	10	16	0	1	17	0	0
5	61380130	.	C	T	9	11	20	0	0	20	0	0
5	61392719	.	C	T	16	12	28	0	0	28	0	0
5	61396054	.	G	A	11	8	19	1	2	22	0	0
5	61402030	.	G	A	8	13	21	0	0	21	0	0
5	61402317	.	A	C	11	0	11	0	14	25	0	0
5	61402455	.	A	T	14	11	25	0	0	25	0	0
5	61402479	.	G	A	15	15	30	0	2	32	0	0
5	61402570	.	T	C	13	17	30	0	1	31	0	0
5	61402584	.	A	G	16	0	16	0	11	27	0	0
5	61402761	.	T	A	23	20	43	0	0	43	0	0
5	61402999	.	T	A	20	17	37	0	2	39	0	0
5	61404643	.	T	C	4	3	7	0	0	7	0	0
5	61404702	.	A	T	5	5	10	0	0	10	0	0
5	61405203	.	C	T	6	6	12	0	1	13	0	0
5	61405245	.	C	A	8	11	19	0	0	19	0	0
5	61405885	.	A	G	3	6	9	0	0	9	0	0
5	61405954	.	A	G	13	5	18	0	0	18	0	0
5	61414619	.	C	T	2	8	10	0	0	10	0	0
5	61416963	.	C	A	4	7	11	0	1	12	0	0
5	61425708	.	C	T	5	5	10	1	0	11	0	0
5	61425723	.	C	T	6	5	11	1	0	12	0	0
5	61425795	.	G	C	1	5	6	0	1	7	0	0
5	61425800	.	A	G	1	7	8	0	0	8	0	0
5	61428878	.	A	G	2	9	11	0	0	11	0	0
5	61428915	.	C	G	1	5	6	0	0	6	0	0
5	61428984	.	C	T	3	4	7	0	1	8	0	0
5	61429058	.	G	T	2	5	7	0	0	7	0	0
5	61429149	.	C	T	0	3	3	0	5	8	0	0
5	61433044	.	C	T	1	2	3	0	1	4	0	0
5	61433102	.	G	T	1	6	7	0	0	7	0	0
5	61433196	.	A	T	7	3	10	1	1	12	0	0
5	61433329	.	A	G	7	2	9	0	0	9	0	0
5	61459502	.	T	C	14	13	27	1	3	31	0	0
5	61464874	.	G	T	4	12	16	0	3	19	0	0
5	61464900	.	G	T	12	7	19	0	1	20	0	0
5	61472429	.	G	A	7	10	17	0	0	17	0	0
5	61472457	.	C	T	6	8	14	0	0	14	0	0
5	61472598	.	C	G	2	2	4	0	0	4	0	0
5	61508451	.	A	G	5	4	9	0	2	11	0	0
5	61508648	.	G	T	14	8	22	0	0	22	0	0
5	61548819	.	T	G	10	3	13	0	11	24	0	0
5	61552787	.	T	A	7	8	15	0	4	20	1	0
5	61553022	.	G	A	15	10	25	0	1	26	0	0
5	61553119	.	A	G	8	4	12	0	2	14	0	0
5	61553207	.	C	T	4	15	19	0	0	19	0	0
5	61553309	.	A	G	6	0	6	0	11	17	0	0
5	61553409	.	A	T	12	13	25	0	0	25	0	0
5	61553418	.	G	A	13	12	25	0	2	27	0	0
5	61553452	.	C	T	16	10	26	0	1	27	0	0
5	61553556	.	A	T	9	16	25	1	1	27	0	0
5	61553611	.	T	G	20	10	30	1	0	31	0	0
5	61553614	.	C	T	19	10	29	1	0	30	0	0
5	61553699	.	G	T	13	15	28	0	0	28	0	0
5	61566651	.	C	T	2	2	4	0	0	4	0	0
5	61566819	.	T	C	1	2	3	0	0	3	0	0
5	61584144	.	G	C	3	4	7	0	0	7	0	0
5	61658315	.	A	C	4	3	7	0	0	7	0	0
5	61660310	.	C	T	3	3	6	0	0	6	0	0
5	61660526	.	C	T	4	9	13	0	0	13	0	0
5	61665215	.	G	A	7	3	10	0	1	11	0	0
5	61668302	.	G	A	1	2	3	0	7	10	0	0
5	61676676	.	T	G	8	0	8	0	6	14	0	0
5	61676700	.	T	G	9	4	13	0	0	13	0	0
5	61676739	.	A	C	9	3	12	0	1	13	0	0
5	61682577	.	C	T	9	9	18	0	1	19	0	0
5	61682715	.	A	C	10	9	19	0	1	20	0	0
5	61682721	.	C	T	12	8	20	0	1	21	0	0
5	61696396	.	C	T	9	11	20	0	3	23	0	0
5	61698770	.	C	T	16	9	25	0	5	30	0	0
5	61701969	.	C	A	25	22	47	0	3	50	0	0
5	61706220	.	T	C	27	15	42	0	3	45	0	0
5	61723061	.	G	A	36	26	62	0	5	67	0	0
5	61723481	.	G	T	6	29	35	0	19	54	0	0
5	61723584	.	A	T	19	26	45	0	2	47	0	0
5	61723637	.	A	G	22	23	45	0	3	48	0	0
5	61723674	.	G	A	33	16	49	0	3	52	0	0
5	61723694	.	T	G	14	27	41	0	4	45	0	0
5	61723914	.	T	C	29	29	58	0	3	61	0	0
5	61723979	.	C	T	15	9	24	0	2	26	0	0
5	61724055	.	G	A	1	2	3	0	6	9	0	0
5	61790154	.	C	T	2	4	6	0	0	6	0	0
5	61790157	.	T	C	2	4	6	0	0	6	0	0
5	61790442	.	C	G	1	2	3	0	1	4	0	0
5	61793019	.	T	A	3	4	7	0	0	7	0	0
5	61793756	.	T	C	2	2	4	0	0	4	0	0
5	61793811	.	T	C	3	0	3	0	4	7	0	0
5	61797009	.	T	C	1	0	1	0	1	2	0	0
5	61951038	.	A	G	14	9	23	0	0	23	0	0
5	62025541	.	C	T	1	3	4	0	0	4	0	0
5	62290448	.	A	T	10	9	19	0	2	21	0	0
5	62639596	.	G	A	17	25	42	0	4	46	0	0
5	62642989	.	A	G	12	5	17	2	0	19	0	0
5	62806599	.	T	A	8	4	12	0	2	14	0	0
5	62806675	.	A	G	9	6	15	0	0	15	0	0
5	62806701	.	A	G	8	7	15	0	0	15	0	0
5	62806867	.	C	T	1	6	7	0	13	20	0	0
5	62806951	.	A	G	5	6	11	0	0	11	0	0
5	62807044	.	T	A	2	4	6	0	1	7	0	0
5	62807056	.	T	C	3	3	6	0	1	7	0	0
5	62807258	.	T	A	1	8	9	0	1	10	0	0
5	62807263	.	G	A	1	8	9	0	1	10	0	0
5	62807357	.	G	A	4	2	6	0	0	6	0	0
5	62860901	.	A	G	6	3	9	0	0	9	0	0
5	62860902	.	G	T	6	3	9	0	0	9	0	0
5	62860943	.	T	C	10	4	14	0	1	15	0	0
5	62860969	.	T	A	10	4	14	0	2	16	0	0
5	62865289	.	G	A	5	7	12	0	0	12	0	0
5	62884052	.	T	C	8	4	12	0	2	14	0	0
5	62889651	.	C	T	11	2	13	0	1	14	0	0
5	62889957	.	G	A	4	8	12	0	2	14	0	0
5	62889966	.	C	G	2	8	10	0	0	10	0	0
5	62890011	.	T	G	1	5	6	0	1	7	0	0
5	62890026	.	G	A	2	2	4	0	0	4	0	0
5	62890642	.	G	A	3	2	5	0	0	5	0	0
5	62994131	.	G	T	3	3	6	0	0	6	0	0
5	63248665	.	A	C	0	3	3	0	1	4	0	0
5	63248668	.	T	C	1	4	5	0	0	5	0	0
5	63285995	.	T	G	2	2	4	0	0	4	0	0
5	63319045	.	C	T	2	3	5	2	0	7	0	0
5	63322568	.	A	T	5	3	8	2	1	11	0	0
5	63322584	.	G	T	5	6	11	0	0	11	0	0
5	63329526	.	G	A	3	5	8	0	0	8	0	0
5	63331691	.	A	G	2	2	4	0	0	4	0	0
5	63335216	.	C	A	2	3	5	6	0	11	0	0
5	63338422	.	C	T	3	3	6	0	0	6	0	0
5	63338518	.	A	T	3	4	7	0	1	8	0	0
5	63338557	.	C	T	3	2	5	0	0	5	0	0
5	63338563	.	A	G	2	1	3	0	1	4	0	0
5	63362964	.	A	G	4	0	4	0	3	7	0	0
5	63363010	.	G	A	4	3	7	0	0	7	0	0
5	63363058	.	C	T	2	3	5	0	0	5	0	0
5	63382081	.	G	A	4	3	7	1	0	8	0	0
5	63394174	.	C	A	12	21	33	0	2	35	0	0
5	63395057	.	A	T	18	19	37	0	0	37	0	0
5	63398847	.	T	C	11	17	28	0	2	30	0	0
5	63398973	.	G	A	22	11	33	0	7	40	0	0
5	63399066	.	G	C	27	22	49	0	0	49	0	0
5	63399111	.	T	A	25	26	51	0	1	52	0	0
5	63399683	.	T	A	15	20	35	0	0	35	0	0
5	63400524	.	T	G	6	3	9	0	0	9	0	0
5	63407424	.	A	G	2	2	4	0	0	4	0	0
5	63410281	.	T	C	1	2	3	0	0	3	0	0
5	63411031	.	A	G	4	3	7	0	1	8	0	0
5	63411033	.	A	G	5	3	8	0	0	8	0	0
5	63430732	.	A	G	1	2	3	0	0	3	0	0
5	63434314	.	T	C	2	0	2	0	2	4	0	0
5	63510713	.	C	G	0	2	2	0	3	5	0	0
5	63510908	.	G	T	10	8	18	0	2	20	0	0
5	63511045	.	A	G	6	6	12	0	0	12	0	0
5	63511110	.	T	C	5	0	5	0	8	13	0	0
5	63511264	.	A	G	5	10	15	0	1	16	0	0
5	63511315	.	A	G	5	3	8	0	0	8	0	0
5	63511788	.	A	T	9	6	15	0	0	15	0	0
5	63511791	.	A	G	7	6	13	0	0	13	0	0
5	63629121	.	C	A	4	2	6	0	0	6	0	0
5	63629136	.	G	A	5	3	8	0	0	8	0	0
5	63629299	.	A	T	9	3	12	0	0	12	0	0
5	63648324	.	C	T	3	2	5	0	0	5	0	0
5	63648376	.	T	C	2	1	3	0	4	7	0	0
5	63648811	.	A	G	6	3	9	0	0	9	0	0
5	63653276	.	A	G	1	2	3	0	0	3	0	0
5	63655829	.	T	C	1	2	3	0	0	3	0	0
5	63657590	.	G	C	1	2	3	0	0	3	0	0
5	63680655	.	A	G	1	0	1	0	3	4	0	0
5	63680661	.	C	G	0	3	3	0	1	4	0	0
5	63680709	.	T	G	3	3	6	0	0	6	0	0
5	63680718	.	A	G	2	0	2	0	4	6	0	0
5	63695760	.	C	T	3	11	14	0	0	14	0	0
5	63698549	.	T	C	7	10	17	0	0	17	0	0
5	63699468	.	T	C	3	13	16	0	1	17	0	0
5	63720639	.	A	G	12	12	24	0	3	27	0	0
5	63723807	.	G	A	0	7	7	1	6	14	0	0
5	63730115	.	G	A	2	18	20	1	24	45	0	0
5	63739912	.	A	G	21	15	36	0	2	38	0	0
5	63740093	.	C	T	14	16	30	0	1	31	0	0
5	63740097	.	T	A	14	15	29	0	1	30	0	0
5	63740305	.	A	G	19	7	26	1	1	28	0	0
5	63740438	.	A	G	23	16	39	1	3	43	0	0
5	63740465	.	C	A	22	9	31	1	4	38	2	0
5	63740565	.	A	G	34	11	45	0	4	49	0	0
5	63740815	.	A	C	24	28	52	0	2	54	0	0
5	63740874	.	A	C	32	23	55	0	1	56	0	0
5	63740895	.	A	C	30	18	48	0	3	51	0	0
5	63740910	.	A	G	30	19	49	0	0	49	0	0
5	63741023	.	T	A	12	15	27	0	1	28	0	0
5	63741077	.	A	T	8	11	19	0	2	21	0	0
5	63848662	.	C	T	1	2	3	0	0	3	0	0
5	63848668	.	G	T	1	2	3	0	0	3	0	0
5	63858951	.	C	A	3	3	6	0	0	6	0	0
5	63860815	.	C	T	3	3	6	0	0	6	0	0
5	63860936	.	A	G	2	6	8	0	0	8	0	0
5	63860943	.	A	G	2	0	2	0	7	9	0	0
5	63863651	.	C	G	5	0	5	0	5	10	0	0
5	63863656	.	G	A	3	5	8	0	0	8	0	0
5	63863945	.	G	C	3	6	9	0	0	9	0	0
5	63864117	.	C	T	12	9	21	0	0	21	0	0
5	63864150	.	T	C	8	4	12	0	1	13	0	0
5	64205287	.	T	C	8	0	8	0	4	12	0	0
5	64205459	.	T	C	5	3	8	0	1	9	0	0
5	65067548	.	T	C	3	2	5	0	0	5	0	0
5	65112731	.	T	C	1	2	3	0	1	4	0	0
5	66250917	.	C	T	3	4	7	0	0	7	0	0
5	66252054	.	G	A	0	2	2	0	3	5	0	0
5	66252127	.	A	T	2	3	5	0	0	5	0	0
5	66266997	.	A	G	3	5	8	0	0	8	0	0
5	66268964	.	A	G	5	0	5	1	6	12	0	0
5	66271189	.	G	A	3	4	7	0	1	8	0	0
5	66271214	.	C	T	4	3	7	0	0	7	0	0
5	66271446	.	A	T	3	2	5	0	0	5	0	0
5	66388196	.	G	A	3	2	5	0	0	5	0	0
5	66389652	.	C	T	3	3	6	0	0	6	0	0
5	66397643	.	C	A	1	2	3	0	1	4	0	0
5	66404663	.	T	C	1	0	1	0	3	4	0	0
5	66404761	.	G	T	2	2	4	0	0	4	0	0
5	66676766	.	C	G	13	8	21	0	0	21	0	0
5	66676768	.	G	A	13	7	20	0	1	21	0	0
5	66699135	.	G	T	9	14	23	0	0	23	0	0
5	66699138	.	C	G	9	15	24	0	0	24	0	0
5	66699564	.	G	T	6	10	16	0	0	16	0	0
5	66700602	.	T	A	4	2	6	0	0	6	0	0
5	66700608	.	T	C	4	2	6	0	0	6	0	0
5	66700833	.	T	C	4	1	5	0	4	9	0	0
5	66701266	.	T	C	1	2	3	0	0	3	0	0
5	66733482	.	C	G	6	6	12	0	2	14	0	0
5	66733572	.	C	T	2	7	9	0	8	17	0	0
5	66733682	.	T	C	12	14	26	0	0	26	0	0
5	66733694	.	T	C	9	2	11	0	18	29	0	0
5	66733891	.	G	C	13	7	20	0	1	21	0	0
5	66736211	.	T	C	4	8	12	0	1	13	0	0
5	66736280	.	A	G	2	4	6	0	0	6	0	0
5	66740183	.	A	T	5	9	14	0	1	15	0	0
5	66740239	.	T	G	4	6	10	0	0	10	0	0
5	66740273	.	A	T	3	3	6	0	0	6	0	0
5	66807482	.	C	T	17	15	32	0	2	34	0	0
5	66807543	.	C	T	0	30	30	0	17	47	0	0
5	66807735	.	A	G	9	9	18	0	1	19	0	0
5	66807771	.	T	G	15	9	24	0	4	28	0	0
5	66807788	.	C	T	2	12	14	0	14	28	0	0
5	66807830	.	G	A	16	11	27	1	2	30	0	0
5	66807831	.	A	G	16	12	28	1	2	31	0	0
5	66807881	.	A	G	17	18	35	0	1	36	0	0
5	66807916	.	T	C	20	15	35	0	2	37	0	0
5	66813647	.	T	C	9	1	10	0	5	15	0	0
5	66813674	.	G	A	6	8	14	0	2	16	0	0
5	66813722	.	A	G	11	12	23	0	0	23	0	0
5	66814504	.	T	C	13	7	20	0	1	21	0	0
5	66814522	.	A	G	13	7	20	1	1	22	0	0
5	66818699	.	C	T	10	14	24	0	2	26	0	0
5	66819515	.	T	C	8	13	21	0	1	22	0	0
5	66820859	.	A	T	5	9	14	0	1	15	0	0
5	67273308	.	A	G	4	5	9	0	2	11	0	0
5	68767342	.	T	C	6	5	11	0	0	11	0	0
5	68767712	.	A	C	3	5	8	0	2	10	0	0
5	68767722	.	A	C	7	3	10	0	1	11	0	0
5	68891782	.	A	G	0	3	3	1	0	4	0	0
5	68891791	.	G	T	4	3	7	3	2	13	1	0
5	68892801	.	G	A	5	7	12	1	0	13	0	0
5	68892872	.	T	C	10	13	23	2	1	26	0	0
5	69014276	.	T	C	1	2	3	0	0	3	0	0
5	69140658	.	T	C	7	4	11	0	0	11	0	0
5	69141147	.	A	G	3	1	4	0	2	6	0	0
5	69581937	.	G	A	1	4	5	2	1	8	0	0
5	69588720	.	A	T	4	7	11	0	0	11	0	0
5	69595361	.	G	A	5	12	17	0	0	17	0	0
5	69599798	.	G	T	4	13	17	2	1	20	0	0
5	69607398	.	T	C	1	3	4	2	0	6	0	0
5	69608211	.	G	A	2	10	12	4	2	18	0	0
5	69608223	.	G	A	1	12	13	3	0	16	0	0
5	69616625	.	A	T	1	4	5	3	1	9	0	0
5	70182082	.	A	G	22	34	56	0	2	58	0	0
5	70182599	.	T	G	30	3	33	0	18	51	0	0
5	70318311	.	T	C	1	2	3	0	1	4	0	0
5	70318320	.	G	A	2	3	5	0	0	5	0	0
5	70318950	.	A	G	1	3	4	0	0	4	0	0
5	70319984	.	T	A	3	3	6	0	0	6	0	0
5	71748357	.	T	C	2	2	4	0	0	4	0	0
5	71765768	.	C	T	6	7	13	0	1	14	0	0
5	71927625	.	A	T	1	2	3	0	0	3	0	0
5	71946540	.	A	G	4	3	7	0	0	7	0	0
5	72000295	.	C	T	2	2	4	0	0	4	0	0
5	72002655	.	A	C	1	3	4	0	1	5	0	0
5	72023857	.	C	T	22	30	52	0	12	64	0	0
5	72024336	.	C	T	1	19	20	0	36	56	0	0
5	72027464	.	C	T	2	22	24	0	20	44	0	0
5	72028042	.	G	C	24	0	24	0	15	39	0	0
5	72031809	.	G	A	20	9	29	0	2	31	0	0
5	72031846	.	A	G	23	7	30	0	1	31	0	0
5	72033527	.	C	T	0	12	12	0	13	25	0	0
5	72034108	.	C	T	1	10	11	0	13	24	0	0
5	72034177	.	A	G	12	9	21	0	0	21	0	0
5	72038586	.	C	T	14	15	29	0	2	31	0	0
5	72038727	.	G	A	10	9	19	0	2	21	0	0
5	72038909	.	C	T	0	8	8	0	6	14	0	0
5	72039105	.	G	A	5	8	13	0	0	13	0	0
5	72043751	.	A	G	9	9	18	0	0	18	0	0
5	72043778	.	G	A	8	11	19	0	1	20	0	0
5	72043791	.	G	T	14	8	22	0	2	24	0	0
5	72044324	.	G	A	3	7	10	0	0	10	0	0
5	72045010	.	C	T	0	4	4	0	7	11	0	0
5	72046888	.	C	T	4	7	11	0	0	11	0	0
5	72047047	.	C	G	2	3	5	0	7	12	0	0
5	72047127	.	T	A	9	9	18	0	0	18	0	0
5	72047136	.	T	C	8	0	8	0	6	14	0	0
5	72047881	.	G	A	5	6	11	0	0	11	0	0
5	72049688	.	C	A	1	4	5	0	7	12	0	0
5	72050192	.	A	G	4	10	14	0	1	15	0	0
5	72050257	.	C	T	0	10	10	0	9	19	0	0
5	72050314	.	T	C	5	0	5	0	7	12	0	0
5	72053139	.	C	T	0	6	6	0	4	10	0	0
5	72066904	.	C	T	1	3	4	0	0	4	0	0
5	72066993	.	G	A	3	4	7	0	0	7	0	0
5	72067803	.	A	G	3	3	6	0	0	6	0	0
5	72092483	.	C	T	44	15	59	0	1	60	0	0
5	72092958	.	G	A	5	36	41	0	27	68	0	0
5	72130139	.	C	A	8	3	11	0	2	13	0	0
5	72130357	.	C	G	2	2	4	1	0	5	0	0
5	72130362	.	A	G	2	2	4	1	0	5	0	0
5	72130656	.	A	G	5	3	8	0	0	8	0	0
5	72131482	.	C	T	1	4	5	0	1	6	0	0
5	72131558	.	A	T	6	3	9	0	0	9	0	0
5	72131618	.	C	T	4	2	6	0	0	6	0	0
5	72134329	.	A	G	1	4	5	0	0	5	0	0
5	72139978	.	G	A	4	2	6	0	0	6	0	0
5	72142077	.	T	C	8	4	12	0	0	12	0	0
5	72166708	.	A	G	2	4	6	0	0	6	0	0
5	72167277	.	G	A	3	3	6	0	0	6	0	0
5	72167289	.	A	G	4	3	7	0	0	7	0	0
5	72167379	.	C	T	2	3	5	0	0	5	0	0
5	72168552	.	C	T	4	5	9	0	1	10	0	0
5	72172350	.	T	A	31	23	54	0	1	55	0	0
5	72172446	.	G	T	20	13	33	0	1	35	1	0
5	72172456	.	G	T	14	21	35	0	3	39	1	0
5	72172600	.	T	C	22	8	30	0	0	30	0	0
5	72172752	.	G	A	18	28	46	0	1	47	0	0
5	72173169	.	C	A	5	4	9	0	0	9	0	0
5	72173476	.	T	C	7	13	20	0	1	21	0	0
5	72173483	.	T	G	8	11	19	0	3	22	0	0
5	72173894	.	G	A	5	10	15	0	1	16	0	0
5	72173943	.	C	T	5	4	9	0	1	10	0	0
5	72201999	.	C	T	3	5	8	0	2	10	0	0
5	72202402	.	G	A	0	3	3	0	6	9	0	0
5	72202467	.	G	A	1	4	5	0	1	6	0	0
5	72205483	.	A	C	6	8	14	0	3	17	0	0
5	72205583	.	T	G	11	1	12	0	13	25	0	0
5	72205701	.	G	A	2	2	4	0	0	4	0	0
5	72205867	.	T	G	2	7	9	0	0	9	0	0
5	72205905	.	T	C	9	4	13	0	0	13	0	0
5	72206009	.	T	C	9	4	13	0	0	13	0	0
5	72206090	.	T	C	8	4	12	0	1	13	0	0
5	72206155	.	G	T	13	6	19	0	0	19	0	0
5	72206235	.	T	G	3	0	3	0	3	6	0	0
5	72316977	.	T	G	1	2	3	0	0	3	0	0
5	72317218	.	T	C	0	3	3	0	0	3	0	0
5	72317234	.	G	A	1	2	3	0	0	3	0	0
5	72317254	.	G	T	1	2	3	0	0	3	0	0
5	72317534	.	T	C	1	3	4	0	0	4	0	0
5	72317589	.	T	G	4	3	7	0	0	7	0	0
5	72317622	.	C	T	2	2	4	0	0	4	0	0
5	72317643	.	A	G	1	4	5	0	0	5	0	0
5	72320040	.	A	G	1	2	3	0	0	3	0	0
5	72320211	.	G	A	2	2	4	0	0	4	0	0
5	72320213	.	G	A	2	2	4	0	0	4	0	0
5	72376119	.	C	G	18	28	46	0	1	47	0	0
5	72376227	.	A	G	15	18	33	0	4	37	0	0
5	72376959	.	A	G	9	8	17	0	0	17	0	0
5	72382995	.	C	T	17	18	35	0	3	38	0	0
5	72383263	.	C	T	17	18	35	0	2	37	0	0
5	72383964	.	A	G	8	2	10	0	2	12	0	0
5	72384544	.	A	G	12	5	17	0	1	18	0	0
5	72384546	.	A	G	10	7	17	0	0	17	0	0
5	72384642	.	T	C	6	7	13	0	2	15	0	0
5	72384679	.	A	G	9	4	13	0	0	13	0	0
5	72384807	.	T	C	11	0	11	1	11	23	0	0
5	72384978	.	G	A	13	9	22	0	1	23	0	0
5	72385001	.	C	T	16	15	31	0	0	31	0	0
5	72385034	.	A	G	15	14	29	0	3	32	0	0
5	72385075	.	C	T	13	12	25	0	0	25	0	0
5	72386870	.	T	C	6	11	17	0	2	19	0	0
5	72389156	.	C	A	0	12	12	0	16	28	0	0
5	72390189	.	G	A	8	12	20	0	2	22	0	0
6	42301	.	A	T	3	21	24	2	5	31	0	0
6	267588	.	A	G	14	5	19	0	0	19	0	0
6	267634	.	A	G	12	4	16	0	1	17	0	0
6	272194	.	A	G	27	1	28	0	20	48	0	0
6	340480	.	A	C	17	15	32	0	1	33	0	0
6	842581	.	T	C	12	0	12	0	9	21	0	0
6	1555694	.	A	G	1	1	2	0	0	2	0	0
6	1798713	.	T	A	3	9	12	0	0	12	0	0
6	3143609	.	G	A	2	2	4	0	0	4	0	0
6	3197028	.	C	T	5	3	8	0	0	8	0	0
6	3223245	.	C	T	4	3	7	0	0	7	0	0
6	3223341	.	C	G	2	6	8	0	0	8	0	0
6	3249490	.	C	T	10	6	16	0	0	16	0	0
6	3256066	.	C	A	16	17	33	0	4	37	0	0
6	3268327	.	T	C	11	15	26	0	1	27	0	0
6	3269864	.	A	G	10	0	10	0	18	28	0	0
6	3270011	.	G	A	15	12	27	0	1	28	0	0
6	3273272	.	A	T	16	19	35	0	0	35	0	0
6	3273341	.	T	A	10	7	17	0	1	18	0	0
6	3273379	.	A	G	15	9	24	0	0	24	0	0
6	3273901	.	T	G	14	0	14	0	22	36	0	0
6	3274114	.	G	C	4	20	24	0	23	47	0	0
6	3274191	.	G	C	20	16	36	3	1	40	0	0
6	3295796	.	G	A	4	6	10	0	1	11	0	0
6	3312627	.	C	T	3	3	6	0	1	7	0	0
6	3312750	.	A	T	1	4	5	0	1	6	0	0
6	3318673	.	T	C	5	3	8	0	0	8	0	0
6	3318721	.	G	A	0	3	3	0	6	9	0	0
6	3319037	.	A	G	4	2	6	0	0	6	0	0
6	3319047	.	A	G	1	5	6	0	0	6	0	0
6	3395649	.	C	T	5	6	11	0	1	12	0	0
6	3398906	.	A	G	7	3	10	0	0	10	0	0
6	3404913	.	A	C	6	2	8	0	0	9	1	0
6	3404956	.	G	A	1	2	3	0	7	10	0	0
6	3404974	.	C	T	5	4	9	0	1	10	0	0
6	3405052	.	G	A	5	8	13	0	0	13	0	0
6	3405060	.	G	A	0	9	9	0	5	14	0	0
6	3405143	.	T	C	9	6	15	0	0	15	0	0
6	3405191	.	G	C	8	7	15	0	0	15	0	0
6	3405244	.	A	G	2	9	11	0	1	12	0	0
6	3405245	.	C	A	4	9	13	0	0	13	0	0
6	3514481	.	A	C	23	31	54	2	4	60	0	0
6	3698558	.	C	T	1	2	3	0	0	3	0	0
6	3704391	.	G	A	1	5	6	0	8	14	0	0
6	3707095	.	A	G	11	8	19	0	1	20	0	0
6	3707116	.	G	A	13	8	21	0	1	22	0	0
6	3707371	.	G	A	1	5	6	0	9	15	0	0
6	3707372	.	A	G	10	5	15	0	0	15	0	0
6	3707407	.	T	C	12	9	21	0	0	21	0	0
6	3708061	.	A	G	4	9	13	0	3	16	0	0
6	3708149	.	T	C	8	4	12	0	2	14	0	0
6	3711221	.	A	G	6	3	9	0	2	11	0	0
6	3711282	.	T	G	10	1	11	0	7	18	0	0
6	3711386	.	T	C	6	3	9	0	0	9	0	0
6	3711419	.	A	G	5	4	9	0	0	9	0	0
6	3711665	.	A	T	2	2	4	0	0	4	0	0
6	3711703	.	G	A	0	2	2	0	1	3	0	0
6	3711971	.	G	A	2	3	5	0	0	5	0	0
6	3712045	.	T	A	2	4	6	0	0	6	0	0
6	3712069	.	A	T	3	4	7	0	0	7	0	0
6	3712136	.	G	A	5	6	11	0	0	11	0	0
6	3712198	.	G	T	3	2	5	0	0	5	0	0
6	3712199	.	A	C	2	2	4	0	0	4	0	0
6	3712238	.	A	T	4	2	6	0	0	6	0	0
6	3712264	.	A	C	5	2	7	0	0	7	0	0
6	3712335	.	T	G	4	0	4	0	5	9	0	0
6	3712389	.	C	T	2	7	9	0	0	9	0	0
6	3712433	.	A	T	2	2	4	0	0	4	0	0
6	3712713	.	C	G	10	5	15	0	2	17	0	0
6	3713014	.	C	A	1	2	3	0	1	4	0	0
6	3717110	.	A	T	8	7	15	0	0	15	0	0
6	3717843	.	C	T	5	2	7	0	0	7	0	0
6	3724870	.	A	C	9	7	16	0	0	16	0	0
6	3725767	.	C	A	19	13	32	0	0	32	0	0
6	3727891	.	C	T	6	13	19	0	0	19	0	0
6	3728295	.	A	T	6	10	16	0	0	16	0	0
6	3728559	.	G	C	8	4	12	0	2	14	0	0
6	3821241	.	G	A	1	3	4	0	0	4	0	0
6	3827894	.	C	A	1	6	7	0	3	10	0	0
6	3834630	.	G	C	19	11	30	0	0	30	0	0
6	3853120	.	T	G	30	1	31	0	21	52	0	0
6	3853165	.	T	C	34	21	55	0	1	56	0	0
6	3862018	.	A	G	18	16	34	0	0	34	0	0
6	3867542	.	A	T	3	8	11	0	0	11	0	0
6	3869454	.	G	A	0	12	12	0	6	18	0	0
6	3869891	.	C	T	17	9	26	0	1	27	0	0
6	3871982	.	T	A	17	15	32	1	1	34	0	0
6	3874504	.	G	A	2	20	22	0	23	45	0	0
6	3874533	.	C	T	17	25	42	0	2	44	0	0
6	3874686	.	A	G	15	13	28	0	1	29	0	0
6	3878513	.	T	A	10	4	14	0	1	15	0	0
6	3878593	.	A	G	11	11	22	0	1	23	0	0
6	3878831	.	G	C	6	5	11	0	1	12	0	0
6	3878983	.	A	T	13	10	23	0	7	30	0	0
6	3879158	.	A	G	16	6	22	0	0	22	0	0
6	3879247	.	C	A	1	14	15	0	11	26	0	0
6	3879314	.	C	G	1	9	10	0	10	20	0	0
6	3879335	.	C	T	5	13	18	0	1	19	0	0
6	3879367	.	G	A	7	13	20	0	1	21	0	0
6	3881078	.	G	A	11	7	18	0	1	19	0	0
6	3885451	.	C	T	14	10	24	0	1	25	0	0
6	3895442	.	A	T	3	6	9	0	0	9	0	0
6	3895460	.	C	T	1	6	7	0	4	11	0	0
6	3901120	.	C	T	0	3	3	0	7	10	0	0
6	3907796	.	A	T	1	3	4	0	1	5	0	0
6	3944518	.	G	T	2	3	5	0	0	5	0	0
6	3945773	.	C	A	1	3	4	0	0	4	0	0
6	3945792	.	C	A	0	3	3	0	1	4	0	0
6	3950267	.	C	T	2	3	5	0	1	6	0	0
6	3950270	.	C	T	2	3	5	0	0	5	0	0
6	3950309	.	C	T	1	2	3	0	0	3	0	0
6	3953280	.	T	C	7	3	10	0	0	10	0	0
6	3953302	.	A	C	8	3	11	0	0	11	0	0
6	3962132	.	G	A	25	20	45	0	2	47	0	0
6	3962192	.	A	T	20	20	40	0	1	41	0	0
6	3965389	.	G	T	10	4	14	0	0	14	0	0
6	3965461	.	A	G	10	8	18	0	1	19	0	0
6	3973572	.	G	A	3	8	11	0	0	11	0	0
6	3973638	.	T	G	6	3	9	0	0	9	0	0
6	3974047	.	G	A	2	4	6	0	0	6	0	0
6	3984909	.	T	A	2	2	4	0	0	4	0	0
6	3985083	.	G	A	7	13	20	0	0	20	0	0
6	3985137	.	G	A	6	10	16	0	0	16	0	0
6	3987131	.	A	G	3	3	6	0	0	6	0	0
6	3987145	.	T	C	3	2	5	0	0	5	0	0
6	4144415	.	C	T	1	2	3	0	0	3	0	0
6	4185678	.	G	A	6	12	18	0	0	18	0	0
6	4191449	.	C	T	4	3	7	0	0	7	0	0
6	4191554	.	A	T	3	3	6	0	0	6	0	0
6	4192025	.	G	A	6	4	10	0	0	10	0	0
6	4192031	.	A	G	4	6	10	0	0	10	0	0
6	4192171	.	G	A	4	2	6	0	0	6	0	0
6	4199494	.	T	C	1	3	4	0	0	4	0	0
6	4204072	.	G	T	2	2	4	0	0	4	0	0
6	4204117	.	G	T	3	2	5	0	0	5	0	0
6	4241945	.	C	T	1	0	1	0	2	3	0	0
6	4241954	.	A	G	3	3	6	0	1	7	0	0
6	4245276	.	C	T	3	3	6	0	1	7	0	0
6	4246496	.	G	A	0	2	2	0	3	5	0	0
6	4247442	.	C	G	2	4	6	0	1	7	0	0
6	4247755	.	C	T	2	2	4	2	2	8	0	0
6	4247928	.	C	T	6	4	10	0	0	10	0	0
6	4247942	.	T	C	2	2	4	0	3	7	0	0
6	4248160	.	A	G	1	1	2	0	0	2	0	0
6	4248195	.	G	C	2	6	8	0	0	8	0	0
6	4248307	.	G	A	0	3	3	0	1	4	0	0
6	4248399	.	A	T	5	2	7	0	0	7	0	0
6	4248412	.	T	A	4	2	6	0	1	7	0	0
6	4249420	.	C	T	2	3	5	0	0	5	0	0
6	4249437	.	A	G	4	3	7	0	0	7	0	0
6	4249684	.	A	G	4	4	8	0	0	8	0	0
6	4249821	.	G	A	2	3	5	0	2	7	0	0
6	4400803	.	T	A	2	15	17	0	2	19	0	0
6	6258240	.	A	G	1	4	5	0	0	5	0	0
6	6666313	.	T	C	2	4	6	0	0	6	0	0
6	6669495	.	G	A	4	2	6	0	0	6	0	0
6	6967350	.	A	G	1	3	4	0	0	4	0	0
6	6990063	.	G	A	1	5	6	8	0	14	0	0
6	7542491	.	G	T	0	9	9	0	8	17	0	0
6	7545794	.	C	T	9	9	18	0	0	18	0	0
6	7545824	.	T	C	10	10	20	0	0	20	0	0
6	7547451	.	C	T	7	9	16	0	0	16	0	0
6	7549967	.	G	A	26	21	47	0	1	48	0	0
6	7550210	.	A	C	10	9	19	0	1	20	0	0
6	7550405	.	C	T	13	15	28	0	3	31	0	0
6	7551087	.	C	A	7	8	15	0	0	15	0	0
6	7608307	.	C	T	2	4	6	0	0	6	0	0
6	7624012	.	T	C	4	4	8	0	1	9	0	0
6	7626457	.	C	T	5	3	8	0	1	9	0	0
6	7633452	.	G	C	0	4	4	0	10	14	0	0
6	7636811	.	A	T	6	10	16	0	1	17	0	0
6	7637195	.	C	T	13	11	24	0	0	24	0	0
6	7638717	.	G	A	6	9	15	0	0	15	0	0
6	7645319	.	T	C	14	10	24	0	1	25	0	0
6	7646039	.	A	G	15	8	23	0	1	24	0	0
6	7646102	.	G	A	12	19	31	0	1	32	0	0
6	7646111	.	G	C	10	17	27	0	2	29	0	0
6	7648224	.	A	G	8	0	8	1	8	17	0	0
6	7652458	.	C	T	17	16	33	0	2	35	0	0
6	7652470	.	A	C	17	16	33	0	1	34	0	0
6	7652896	.	G	A	1	15	16	0	23	39	0	0
6	7652959	.	C	T	17	23	40	0	4	44	0	0
6	7652989	.	C	T	22	23	45	0	1	46	0	0
6	7656920	.	A	G	22	0	22	1	21	44	0	0
6	7656932	.	A	G	23	22	45	1	1	47	0	0
6	7657077	.	A	C	33	9	42	0	1	43	0	0
6	7657177	.	C	T	18	11	29	0	1	30	0	0
6	7657793	.	A	C	23	13	36	0	1	37	0	0
6	7657886	.	T	A	26	20	46	0	3	49	0	0
6	7657887	.	G	T	28	20	48	0	1	49	0	0
6	7657972	.	T	G	21	10	31	0	1	32	0	0
6	7658076	.	G	A	17	15	32	0	4	36	0	0
6	7659915	.	G	A	6	5	11	0	1	12	0	0
6	7660063	.	C	A	8	4	12	0	0	12	0	0
6	7660119	.	A	G	11	16	27	0	0	27	0	0
6	7660300	.	T	C	3	0	3	0	4	7	0	0
6	7660369	.	T	C	1	7	8	0	0	8	0	0
6	7660458	.	A	C	6	0	6	0	6	12	0	0
6	7660594	.	C	T	6	9	15	0	0	15	0	0
6	7660659	.	C	A	0	4	4	0	5	9	0	0
6	7660707	.	C	T	0	8	8	0	3	11	0	0
6	7688757	.	A	C	4	0	4	0	6	10	0	0
6	7697573	.	G	A	6	4	10	0	1	11	0	0
6	7699948	.	C	T	5	3	8	1	0	9	0	0
6	7702770	.	G	T	9	4	13	0	0	13	0	0
6	7713350	.	A	T	2	4	6	0	2	8	0	0
6	7713433	.	G	A	22	33	55	0	7	62	0	0
6	7721530	.	T	A	10	6	16	0	1	17	0	0
6	7721860	.	G	A	9	6	15	0	0	15	0	0
6	7721906	.	G	A	9	16	25	0	0	25	0	0
6	7721958	.	C	A	12	12	24	0	1	25	0	0
6	7722143	.	G	T	15	21	36	0	0	36	0	0
6	7722159	.	A	T	15	16	31	0	5	36	0	0
6	7722195	.	G	T	19	9	28	0	1	29	0	0
6	7722205	.	G	A	15	9	24	0	0	24	0	0
6	7722333	.	G	A	11	3	14	1	0	15	0	0
6	7722387	.	T	C	18	9	27	1	0	28	0	0
6	7722402	.	T	C	16	13	29	1	2	32	0	0
6	7722467	.	T	A	7	5	12	1	1	14	0	0
6	7722577	.	C	T	1	13	14	0	11	25	0	0
6	7723008	.	G	T	6	6	12	0	0	12	0	0
6	7723155	.	A	C	10	6	16	0	1	17	0	0
6	7723232	.	A	T	7	3	10	0	0	10	0	0
6	7723850	.	C	T	1	10	11	0	13	24	0	0
6	7723961	.	G	A	8	8	16	0	3	19	0	0
6	7726824	.	G	A	8	4	12	0	1	13	0	0
6	7734250	.	A	C	2	3	5	0	0	5	0	0
6	7734271	.	C	A	1	4	5	0	0	5	0	0
6	7795698	.	C	T	18	10	28	0	2	30	0	0
6	7842013	.	C	T	1	2	3	0	2	5	0	0
6	7842034	.	C	A	3	5	8	0	1	9	0	0
6	8176101	.	A	G	6	2	8	0	0	8	0	0
6	8176575	.	C	T	3	4	7	0	0	7	0	0
6	8177030	.	T	C	4	8	12	0	1	13	0	0
6	8177399	.	T	C	6	4	10	0	2	12	0	0
6	8177600	.	T	C	7	4	11	0	2	13	0	0
6	8177678	.	C	T	5	7	12	0	2	14	0	0
6	8178002	.	T	C	10	7	17	0	0	17	0	0
6	8178053	.	G	A	1	6	7	0	8	15	0	0
6	8178113	.	T	C	9	13	22	0	1	23	0	0
6	8178351	.	G	A	9	7	16	0	1	17	0	0
6	8179022	.	G	T	3	13	16	0	22	38	0	0
6	8179205	.	A	T	13	17	30	0	2	32	0	0
6	8179373	.	G	A	21	13	34	0	3	37	0	0
6	8179683	.	A	T	5	9	14	0	1	15	0	0
6	8210334	.	A	G	1	3	4	0	0	4	0	0
6	8211106	.	T	C	4	3	7	0	0	7	0	0
6	8211143	.	A	T	3	4	7	0	0	7	0	0
6	8211154	.	T	C	2	4	6	0	0	6	0	0
6	8211253	.	G	A	6	4	10	0	0	10	0	0
6	8214044	.	G	A	4	5	9	0	0	9	0	0
6	8214045	.	T	G	4	5	9	0	0	9	0	0
6	8214118	.	T	C	5	2	7	0	0	7	0	0
6	8217870	.	G	A	4	4	8	0	0	8	0	0
6	8265214	.	G	A	4	2	6	0	0	6	0	0
6	8265282	.	G	A	4	7	11	0	0	11	0	0
6	8267111	.	C	T	15	19	34	0	4	38	0	0
6	8267266	.	A	G	12	23	35	0	3	38	0	0
6	8267284	.	G	A	11	17	28	0	3	31	0	0
6	8267307	.	G	C	17	11	28	0	0	28	0	0
6	8267352	.	A	T	15	15	30	0	2	32	0	0
6	8267519	.	G	A	18	20	38	0	2	40	0	0
6	8267563	.	G	T	25	16	41	0	0	41	0	0
6	8267635	.	T	C	19	16	35	0	1	36	0	0
6	8267795	.	T	A	10	11	21	0	1	22	0	0
6	8267880	.	G	A	10	11	21	0	0	21	0	0
6	8268529	.	A	G	7	6	13	0	0	13	0	0
6	8273066	.	G	A	4	5	9	0	0	9	0	0
6	8277141	.	C	A	2	2	4	0	1	5	0	0
6	8282275	.	A	G	1	2	3	0	0	3	0	0
6	8315076	.	A	G	8	4	12	0	1	13	0	0
6	8315078	.	A	G	9	4	13	0	0	13	0	0
6	8318001	.	T	C	2	4	6	0	0	6	0	0
6	8318037	.	G	A	0	6	6	0	4	10	0	0
6	8328181	.	G	T	9	19	28	1	1	30	0	0
6	8328342	.	C	T	6	2	8	0	0	8	0	0
6	8365753	.	T	C	2	2	4	0	3	7	0	0
6	8366006	.	A	T	10	6	16	0	1	17	0	0
6	8366167	.	C	T	16	12	28	0	2	30	0	0
6	8370489	.	T	C	12	11	23	0	5	28	0	0
6	8374716	.	G	A	3	8	11	0	0	11	0	0
6	8375089	.	C	T	16	17	33	0	0	33	0	0
6	8380345	.	G	A	2	3	5	0	0	5	0	0
6	8380433	.	G	C	4	3	7	0	0	7	0	0
6	8391629	.	C	T	0	4	4	0	2	6	0	0
6	8392005	.	G	A	5	8	13	0	1	14	0	0
6	8460493	.	G	T	2	2	4	0	0	4	0	0
6	8500557	.	G	T	1	2	3	0	0	3	0	0
6	9165115	.	T	C	4	2	6	0	0	6	0	0
6	10522498	.	T	C	1	2	3	0	0	3	0	0
6	10741853	.	T	G	1	4	5	0	0	5	0	0
6	10982877	.	C	T	2	3	5	0	0	5	0	0
6	10983066	.	T	C	6	3	9	0	1	10	0	0
6	10983193	.	T	A	2	4	6	0	0	6	0	0
6	10983203	.	C	T	2	4	6	0	0	6	0	0
6	10983274	.	C	A	2	6	8	0	0	8	0	0
6	10983356	.	G	A	2	6	8	0	0	8	0	0
6	10983409	.	A	T	2	3	5	0	0	5	0	0
6	10983465	.	A	T	4	10	14	0	1	15	0	0
6	10985878	.	C	T	7	8	15	1	0	16	0	0
6	10986131	.	C	T	0	7	7	0	10	17	0	0
6	10986652	.	A	G	4	14	18	0	2	20	0	0
6	11056811	.	T	C	1	1	2	0	1	3	0	0
6	11067436	.	A	C	3	2	5	0	0	5	0	0
6	11067480	.	A	G	2	2	4	0	1	5	0	0
6	11070411	.	G	C	23	13	36	0	2	38	0	0
6	11070563	.	A	C	31	31	62	0	6	68	0	0
6	11070806	.	G	A	33	21	54	0	3	57	0	0
6	11071056	.	T	A	20	33	53	0	6	59	0	0
6	11071222	.	A	G	23	26	49	1	5	55	0	0
6	11071345	.	G	A	24	33	57	1	3	61	0	0
6	11071357	.	A	G	26	35	61	0	2	63	0	0
6	11101852	.	G	A	2	2	4	0	0	4	0	0
6	11250077	.	G	T	4	3	7	0	0	7	0	0
6	11250973	.	T	C	1	2	3	0	0	3	0	0
6	11253881	.	T	C	3	2	5	0	0	5	0	0
6	11253890	.	C	T	2	2	4	0	0	4	0	0
6	11254196	.	C	T	6	5	11	0	0	11	0	0
6	11254358	.	A	G	3	0	3	0	7	10	0	0
6	11254430	.	C	T	4	7	11	0	2	13	0	0
6	11254610	.	C	T	5	7	12	0	0	12	0	0
6	11257788	.	C	T	9	13	22	0	1	23	0	0
6	11261308	.	C	A	23	10	33	0	2	35	0	0
6	11262080	.	C	T	12	15	27	0	2	29	0	0
6	11264258	.	G	A	18	11	29	1	2	32	0	0
6	11265321	.	G	T	13	16	29	0	1	30	0	0
6	11265424	.	T	C	9	13	22	0	3	25	0	0
6	11265505	.	A	T	17	10	27	0	1	28	0	0
6	11265562	.	T	A	15	15	30	0	0	30	0	0
6	11265761	.	A	T	21	24	45	0	2	48	1	0
6	11265833	.	A	G	25	1	26	0	26	52	0	0
6	11265972	.	A	G	1	1	2	0	1	3	0	0
6	11266104	.	A	G	9	26	35	0	1	36	0	0
6	11266111	.	A	G	11	1	12	0	23	35	0	0
6	11266164	.	T	C	27	16	43	0	0	43	0	0
6	11266176	.	C	T	24	18	42	0	1	43	0	0
6	11266360	.	T	G	17	14	31	0	1	32	0	0
6	11266490	.	A	T	6	6	12	0	0	12	0	0
6	11266496	.	T	C	5	5	10	0	0	10	0	0
6	11276827	.	T	A	8	6	14	0	0	14	0	0
6	11276912	.	A	G	13	5	18	0	0	18	0	0
6	11279686	.	T	C	5	8	13	0	4	17	0	0
6	11279815	.	T	C	3	5	8	0	1	9	0	0
6	11281923	.	A	G	6	3	9	0	0	9	0	0
6	11281973	.	G	A	7	6	13	0	2	15	0	0
6	11282741	.	C	T	5	3	8	0	2	10	0	0
6	11285310	.	C	T	2	6	8	0	0	8	0	0
6	11285362	.	T	C	4	0	4	0	8	12	0	0
6	11285374	.	C	T	5	7	12	0	1	13	0	0
6	11285453	.	T	C	1	4	5	0	0	5	0	0
6	11285459	.	C	G	2	3	5	0	1	7	1	0
6	11285583	.	C	T	5	3	8	0	3	11	0	0
6	11285772	.	C	T	4	6	10	0	0	10	0	0
6	11285835	.	G	A	1	2	3	0	1	4	0	0
6	11285903	.	A	G	5	2	7	0	0	7	0	0
6	11288179	.	T	A	2	4	6	0	0	6	0	0
6	11288558	.	T	C	3	0	3	0	2	5	0	0
6	11295352	.	C	T	0	2	2	0	6	8	0	0
6	11295553	.	A	G	4	5	9	0	1	10	0	0
6	11295616	.	T	G	2	8	10	0	0	10	0	0
6	11298514	.	A	G	4	3	7	0	0	7	0	0
6	11298557	.	G	A	1	4	5	0	0	5	0	0
6	11299643	.	C	T	2	2	4	0	0	4	0	0
6	11299680	.	A	T	1	4	5	0	1	6	0	0
6	11299682	.	C	T	1	4	5	0	1	6	0	0
6	11299718	.	G	A	1	6	7	0	0	7	0	0
6	11299909	.	C	T	1	3	4	0	0	4	0	0
6	11299961	.	C	A	3	2	5	0	0	5	0	0
6	11299963	.	C	T	2	2	4	0	0	4	0	0
6	11303424	.	T	G	1	2	3	0	0	3	0	0
6	11316705	.	T	C	1	2	3	0	0	3	0	0
6	11316726	.	G	A	1	2	3	0	0	3	0	0
6	11322792	.	T	C	1	3	4	0	0	4	0	0
6	11398324	.	G	T	6	5	11	0	0	11	0	0
6	11407918	.	G	A	6	2	8	0	1	9	0	0
6	11407944	.	A	G	9	5	14	0	0	14	0	0
6	11407954	.	A	G	8	5	13	0	1	14	0	0
6	11414431	.	A	G	15	0	15	0	13	28	0	0
6	11414448	.	T	C	17	16	33	0	0	33	0	0
6	11414748	.	G	A	8	5	13	0	0	13	0	0
6	11414777	.	A	T	8	7	15	0	1	16	0	0
6	11414822	.	T	G	10	0	10	0	9	19	0	0
6	11415089	.	G	A	4	5	9	0	0	9	0	0
6	11415104	.	C	T	5	5	10	0	1	11	0	0
6	11508125	.	T	C	1	5	6	0	1	7	0	0
6	11522921	.	C	T	2	2	4	0	0	4	0	0
6	11765364	.	A	G	17	18	35	0	5	40	0	0
6	11765506	.	A	G	29	25	54	0	1	55	0	0
6	11765913	.	G	A	20	20	40	0	5	45	0	0
6	11766267	.	G	A	26	17	43	0	2	45	0	0
6	11766276	.	A	G	26	19	45	0	0	45	0	0
6	11766765	.	T	C	18	17	35	0	2	37	0	0
6	11767623	.	T	C	19	23	42	0	1	43	0	0
6	11768196	.	G	C	15	19	34	0	2	36	0	0
6	11771118	.	G	A	17	15	32	0	4	36	0	0
6	11773266	.	C	T	21	18	39	0	2	41	0	0
6	11779940	.	C	A	9	13	22	0	1	23	0	0
6	11780001	.	A	C	4	8	12	0	0	12	0	0
6	11780004	.	A	T	4	7	11	0	1	12	0	0
6	11781476	.	T	A	2	6	8	0	0	8	0	0
6	11781567	.	A	C	5	0	5	0	6	11	0	0
6	11791106	.	T	C	11	0	11	0	6	17	0	0
6	11791371	.	A	G	5	5	10	0	1	11	0	0
6	11791572	.	A	G	6	7	13	0	1	14	0	0
6	11791644	.	A	G	9	8	17	0	0	17	0	0
6	11791646	.	T	C	9	8	17	0	0	17	0	0
6	11791686	.	A	C	6	0	6	0	8	14	0	0
6	11791770	.	G	A	5	6	11	0	1	12	0	0
6	11791806	.	T	G	6	3	9	0	0	9	0	0
6	11791947	.	A	G	12	11	23	0	0	23	0	0
6	11796238	.	A	T	2	1	3	0	1	4	0	0
6	11943997	.	G	A	1	1	2	0	2	4	0	0
6	11950504	.	A	C	2	5	7	0	2	9	0	0
6	11950543	.	T	A	4	2	6	0	2	8	0	0
6	11950582	.	C	A	1	3	4	0	0	4	0	0
6	11950583	.	A	G	1	3	4	0	0	4	0	0
6	11952477	.	A	C	1	3	4	0	1	5	0	0
6	11960667	.	C	T	2	3	5	0	1	6	0	0
6	11975763	.	G	A	4	2	6	0	0	6	0	0
6	11976566	.	A	T	4	5	9	0	0	9	0	0
6	11976614	.	A	G	3	2	5	0	0	5	0	0
6	11976617	.	G	A	2	2	4	0	3	7	0	0
6	11979035	.	G	C	4	6	10	0	2	12	0	0
6	11981831	.	C	G	10	0	10	0	5	15	0	0
6	11982213	.	A	C	14	13	27	0	0	27	0	0
6	11982319	.	A	T	11	10	21	0	0	21	0	0
6	11986615	.	C	T	4	8	12	0	0	12	0	0
6	11986656	.	C	G	1	5	6	0	2	8	0	0
6	11994733	.	C	T	13	12	25	0	1	26	0	0
6	11994790	.	T	C	14	15	29	0	3	32	0	0
6	12001212	.	T	C	15	18	33	0	2	35	0	0
6	12002933	.	C	T	4	5	9	0	1	10	0	0
6	12006904	.	C	T	3	4	7	0	0	7	0	0
6	12006923	.	T	C	3	3	6	0	0	6	0	0
6	12016450	.	G	A	8	6	14	0	2	16	0	0
6	12029570	.	T	C	25	17	42	0	1	43	0	0
6	12036984	.	C	T	14	6	20	0	7	27	0	0
6	12037141	.	G	A	20	10	30	0	2	32	0	0
6	12037196	.	C	T	18	9	27	0	1	28	0	0
6	12037197	.	T	G	16	8	24	0	4	28	0	0
6	12037293	.	G	T	10	4	14	0	2	16	0	0
6	12037401	.	G	A	11	9	20	0	0	20	0	0
6	12044204	.	C	T	5	6	11	0	2	13	0	0
6	12044225	.	A	G	7	6	13	0	0	13	0	0
6	12052869	.	T	C	12	10	22	0	0	22	0	0
6	12052917	.	A	T	8	5	13	0	0	13	0	0
6	12059524	.	T	C	5	0	5	0	4	9	0	0
6	12073008	.	T	C	3	3	6	0	0	6	0	0
6	12104537	.	G	A	2	2	4	0	0	4	0	0
6	12200472	.	G	T	8	12	20	0	0	20	0	0
6	12200654	.	T	A	13	2	15	0	0	15	0	0
6	12200808	.	T	A	6	6	12	0	0	12	0	0
6	12200972	.	G	T	14	9	23	0	0	23	0	0
6	12201030	.	G	A	9	19	28	1	2	31	0	0
6	12201132	.	G	A	12	16	28	0	2	30	0	0
6	12212817	.	C	T	1	9	10	0	17	27	0	0
6	12213162	.	A	G	12	8	20	0	1	21	0	0
6	12214149	.	T	C	9	9	18	0	1	19	0	0
6	12217851	.	A	G	9	4	13	1	3	17	0	0
6	12220638	.	A	G	9	8	17	0	0	17	0	0
6	12224325	.	G	C	8	6	14	0	0	14	0	0
6	12275783	.	C	T	1	3	4	0	3	7	0	0
6	12299421	.	A	G	32	27	59	0	2	61	0	0
6	12299422	.	T	C	31	27	58	0	4	62	0	0
6	12299751	.	A	G	25	37	62	1	5	68	0	0
6	12303882	.	A	G	25	20	45	0	3	48	0	0
6	12303897	.	A	G	28	14	42	0	1	43	0	0
6	12313925	.	A	T	19	17	36	2	1	39	0	0
6	12379730	.	G	A	2	5	7	0	1	8	0	0
6	12466041	.	A	C	2	3	5	0	0	5	0	0
6	12503989	.	T	G	2	3	5	0	0	5	0	0
6	12504230	.	T	C	2	2	4	0	0	4	0	0
6	12504362	.	C	T	2	4	6	0	0	6	0	0
6	12504392	.	G	C	4	4	8	1	0	9	0	0
6	12516517	.	T	C	3	5	8	0	0	8	0	0
6	12594492	.	C	T	1	2	3	0	0	3	0	0
6	12595255	.	T	C	5	5	10	0	0	10	0	0
6	12595340	.	C	G	5	7	12	0	0	12	0	0
6	12595518	.	A	G	6	5	11	0	0	11	0	0
6	12600430	.	A	T	4	4	8	0	1	9	0	0
6	12603263	.	T	G	8	4	12	0	0	12	0	0
6	12603389	.	G	T	1	3	4	0	1	5	0	0
6	12606904	.	C	A	4	5	9	0	0	9	0	0
6	12620093	.	T	A	3	6	9	0	0	10	1	0
6	12797677	.	C	T	3	2	5	0	1	6	0	0
6	12797755	.	G	A	11	5	16	0	0	16	0	0
6	12797815	.	A	G	9	6	15	0	3	18	0	0
6	12798083	.	G	T	2	5	7	0	0	7	0	0
6	12798124	.	T	C	1	4	5	0	0	5	0	0
6	12798345	.	T	C	4	3	7	0	0	7	0	0
6	12803325	.	A	G	2	3	5	0	0	5	0	0
6	12803568	.	A	G	4	2	6	0	0	6	0	0
6	12803598	.	T	C	4	2	6	0	0	6	0	0
6	12803664	.	G	A	4	3	7	0	0	7	0	0
6	12803790	.	A	G	2	3	5	0	0	5	0	0
6	12804024	.	A	T	2	3	5	0	1	6	0	0
6	12804132	.	G	A	6	2	8	0	1	9	0	0
6	12853748	.	G	A	5	6	11	0	0	11	0	0
6	16045900	.	T	C	18	8	26	0	3	29	0	0
6	16045912	.	T	C	4	0	4	0	21	25	0	0
6	17726078	.	G	A	7	3	10	0	2	12	0	0
6	18531296	.	T	G	1	4	5	0	0	5	0	0
6	18531976	.	T	C	4	2	6	0	0	6	0	0
6	20766102	.	A	T	4	2	6	0	0	6	0	0
6	21514188	.	C	A	1	1	2	0	0	2	0	0
6	21876182	.	T	C	7	5	12	0	0	12	0	0
6	21876183	.	T	C	6	6	12	0	0	12	0	0
6	21876234	.	T	C	2	3	5	3	0	8	0	0
6	22683228	.	C	T	1	6	7	4	1	12	0	0
6	22683362	.	A	G	9	5	14	0	0	14	0	0
6	23053572	.	A	G	13	5	18	0	2	20	0	0
6	23054267	.	A	G	16	0	16	0	14	30	0	0
6	23054361	.	A	G	15	14	29	0	2	31	0	0
6	24818048	.	G	T	6	2	8	0	1	9	0	0
6	25169385	.	T	A	3	2	5	0	1	6	0	0
6	27088476	.	C	T	2	1	3	0	1	4	0	0
6	27271208	.	A	G	17	0	17	0	33	50	0	0
6	27271214	.	A	G	26	21	47	0	1	48	0	0
6	27271312	.	A	G	10	24	34	0	1	35	0	0
6	27816260	.	T	C	14	16	30	0	1	31	0	0
6	27874309	.	T	C	14	10	24	0	6	30	0	0
6	27874487	.	G	A	26	22	48	0	4	52	0	0
6	27874529	.	G	A	2	19	21	0	27	48	0	0
6	27874591	.	T	A	15	24	39	0	5	44	0	0
6	27874674	.	T	C	15	14	29	0	1	30	0	0
6	27874680	.	C	G	11	18	29	0	2	31	0	0
6	27874753	.	G	C	1	15	16	0	3	19	0	0
6	27874769	.	T	A	3	8	11	0	1	12	0	0
6	27874896	.	T	A	20	18	38	0	2	40	0	0
6	27875309	.	T	C	31	22	53	0	0	53	0	0
6	27875555	.	C	T	35	28	63	2	7	72	0	0
6	27875598	.	T	C	0	45	45	2	3	50	0	0
6	27875873	.	A	G	24	20	44	0	6	50	0	0
6	27875876	.	T	G	27	20	47	0	1	49	1	0
6	27875941	.	C	G	24	27	51	0	0	51	0	0
6	27875944	.	G	A	3	27	30	0	21	51	0	0
6	27876051	.	T	A	33	27	60	0	4	64	0	0
6	27876134	.	C	T	30	25	55	0	3	58	0	0
6	27925037	.	C	T	2	3	5	0	0	5	0	0
6	27993569	.	T	C	2	3	5	0	0	5	0	0
6	27997510	.	A	T	3	3	6	0	0	6	0	0
6	27997662	.	C	A	0	4	4	0	1	5	0	0
6	27999287	.	C	A	1	3	4	0	0	4	0	0
6	27999373	.	T	C	4	1	5	0	1	6	0	0
6	27999744	.	A	C	4	2	6	0	0	6	0	0
6	28000242	.	T	A	3	8	11	0	1	12	0	0
6	28025129	.	A	C	1	3	4	1	0	5	0	0
6	28033036	.	C	T	6	2	8	0	0	8	0	0
6	28036311	.	C	T	4	3	7	0	0	7	0	0
6	28038882	.	C	G	4	4	8	0	0	8	0	0
6	28039034	.	C	T	7	4	11	0	0	11	0	0
6	28039175	.	T	A	4	4	8	0	1	9	0	0
6	28041161	.	G	A	0	6	6	0	7	13	0	0
6	28044308	.	C	T	4	6	10	0	0	10	0	0
6	28044398	.	C	T	11	8	19	0	0	19	0	0
6	28049173	.	A	C	6	6	12	0	0	12	0	0
6	28049185	.	G	A	0	5	5	0	7	12	0	0
6	28206112	.	C	T	16	9	25	0	0	25	0	0
6	28206442	.	G	A	9	14	23	1	0	24	0	0
6	28207340	.	C	T	14	14	28	0	0	28	0	0
6	28207418	.	C	G	11	11	22	0	1	23	0	0
6	28207593	.	A	G	6	5	11	1	0	12	0	0
6	28207913	.	A	T	1	2	3	1	0	4	0	0
6	28209354	.	A	C	2	2	4	0	0	4	0	0
6	28216496	.	G	A	6	8	14	0	0	14	0	0
6	28216535	.	C	T	20	13	33	0	0	33	0	0
6	28217058	.	C	G	7	9	16	0	1	17	0	0
6	28217103	.	T	C	9	1	10	0	6	16	0	0
6	28217596	.	C	T	1	7	8	0	11	19	0	0
6	28217674	.	T	C	12	0	12	0	6	18	0	0
6	28218367	.	G	A	6	10	16	0	0	16	0	0
6	28223764	.	T	C	2	3	5	0	0	5	0	0
6	28223781	.	C	A	2	2	4	0	0	4	0	0
6	28224044	.	T	A	1	4	5	0	0	5	0	0
6	28224157	.	C	A	2	4	6	0	0	6	0	0
6	28224158	.	A	T	2	4	6	0	0	6	0	0
6	28688726	.	C	T	3	2	5	0	0	5	0	0
6	28913682	.	C	A	1	5	6	0	1	7	0	0
6	28913719	.	T	G	2	4	6	0	2	8	0	0
6	28913811	.	G	T	2	3	5	0	0	5	0	0
6	28913844	.	G	T	1	2	3	0	0	3	0	0
6	28914418	.	A	G	15	13	28	0	1	29	0	0
6	28914523	.	G	A	18	12	30	0	2	33	1	0
6	28914571	.	T	A	23	13	36	0	0	36	0	0
6	28914790	.	G	A	22	8	30	0	2	32	0	0
6	28914886	.	G	A	9	6	15	1	1	17	0	0
6	28915342	.	T	G	8	10	18	0	0	18	0	0
6	28923667	.	G	A	3	4	7	0	0	7	0	0
6	28926540	.	C	T	5	7	12	0	0	12	0	0
6	28926567	.	T	A	5	7	12	0	1	13	0	0
6	28929960	.	A	G	1	3	4	0	0	4	0	0
6	28932634	.	G	A	3	2	5	0	1	6	0	0
6	28934498	.	A	G	5	2	7	0	0	7	0	0
6	28946048	.	A	T	18	17	35	0	5	40	0	0
6	28946199	.	T	G	7	22	29	0	3	32	0	0
6	28956323	.	A	G	14	8	22	0	4	26	0	0
6	28956350	.	T	A	17	11	28	0	1	29	0	0
6	28957089	.	G	A	12	5	17	0	1	18	0	0
6	28957814	.	C	G	7	4	11	0	0	11	0	0
6	28957820	.	G	T	7	4	11	0	0	11	0	0
6	29039981	.	A	C	5	0	5	0	14	19	0	0
6	29040066	.	A	C	9	10	19	0	0	19	0	0
6	29040870	.	C	T	3	10	13	0	6	19	0	0
6	29043673	.	G	A	3	3	6	0	0	6	0	0
6	29086676	.	A	T	27	19	46	0	3	49	0	0
6	29089480	.	T	A	28	32	60	0	4	64	0	0
6	29096659	.	A	C	32	28	60	0	13	73	0	0
6	29103005	.	G	A	5	4	9	0	1	10	0	0
6	29103722	.	T	C	1	0	1	0	3	4	0	0
6	29143365	.	A	T	1	2	3	0	0	3	0	0
6	29147764	.	C	T	5	5	10	0	1	11	0	0
6	29152208	.	C	T	6	6	12	0	1	13	0	0
6	29152334	.	G	A	3	3	6	0	1	7	0	0
6	29152669	.	A	G	2	7	9	0	0	9	0	0
6	29154280	.	T	A	6	2	8	0	0	8	0	0
6	29154496	.	A	G	7	6	13	0	1	14	0	0
6	29154520	.	C	T	7	5	12	0	1	13	0	0
6	29154889	.	C	A	3	2	5	0	2	7	0	0
6	29158227	.	T	C	2	2	4	0	0	4	0	0
6	29221040	.	C	T	3	5	8	0	0	8	0	0
6	29223513	.	G	A	0	5	5	0	4	9	0	0
6	29226070	.	G	C	7	7	14	0	0	14	0	0
6	29226077	.	A	C	8	7	15	0	0	15	0	0
6	29226186	.	A	G	7	17	24	0	3	27	0	0
6	29226189	.	C	T	20	8	28	0	0	28	0	0
6	29226767	.	A	T	18	13	31	0	1	32	0	0
6	29226790	.	G	A	9	21	30	0	1	31	0	0
6	29226823	.	A	C	9	17	26	0	1	27	0	0
6	29227149	.	A	G	25	15	40	0	5	48	3	0
6	29227555	.	T	C	4	4	8	0	1	9	0	0
6	29258214	.	T	A	12	7	19	0	0	19	0	0
6	29278868	.	T	G	7	6	13	0	1	14	0	0
6	29278874	.	G	A	9	5	14	0	0	14	0	0
6	29288121	.	A	G	3	2	5	0	0	5	0	0
6	29291606	.	C	T	1	6	7	0	0	7	0	0
6	29291614	.	T	C	1	5	6	0	0	6	0	0
6	29291666	.	G	A	2	6	8	0	1	9	0	0
6	29295492	.	T	A	10	12	22	0	0	22	0	0
6	29295517	.	G	C	14	12	26	0	0	26	0	0
6	29295535	.	T	A	10	10	20	0	5	25	0	0
6	29295714	.	G	A	4	9	13	0	0	13	0	0
6	29295851	.	G	A	3	9	12	0	0	12	0	0
6	29295860	.	C	T	4	11	15	0	0	15	0	0
6	29297379	.	G	T	3	6	9	1	1	11	0	0
6	29303630	.	G	A	4	6	10	0	0	10	0	0
6	29303778	.	C	T	0	5	5	0	1	6	0	0
6	29303863	.	T	A	3	5	8	0	0	8	0	0
6	29303925	.	C	T	2	2	4	0	0	4	0	0
6	29303958	.	C	T	0	6	6	0	4	10	0	0
6	29305073	.	G	A	3	4	7	0	1	8	0	0
6	29313312	.	C	A	7	8	15	0	1	16	0	0
6	29313607	.	A	T	10	11	21	0	4	25	0	0
6	29313679	.	A	G	14	10	24	0	0	24	0	0
6	29322029	.	T	C	10	1	11	0	8	19	0	0
6	29322595	.	C	G	7	7	14	0	1	15	0	0
6	29335675	.	G	A	2	4	6	0	0	6	0	0
6	29343892	.	G	A	3	2	5	0	1	6	0	0
6	29387493	.	G	A	7	2	9	0	0	9	0	0
6	29390565	.	A	G	3	3	6	0	1	7	0	0
6	29391718	.	T	C	4	7	11	0	0	11	0	0
6	29393533	.	T	A	5	7	12	0	1	13	0	0
6	29393714	.	C	T	8	8	16	0	2	18	0	0
6	29395297	.	C	T	14	15	29	0	2	31	0	0
6	29395424	.	G	A	16	13	29	0	0	29	0	0
6	29395497	.	T	A	15	7	22	0	0	22	0	0
6	29397697	.	G	A	5	5	10	0	0	10	0	0
6	29402220	.	C	T	9	7	16	0	0	16	0	0
6	29403052	.	G	T	0	13	13	0	12	25	0	0
6	29403550	.	G	A	19	16	35	0	0	35	0	0
6	29404094	.	T	C	34	22	56	0	4	60	0	0
6	29410040	.	C	T	6	2	8	0	0	8	0	0
6	29414769	.	A	T	1	2	3	0	0	3	0	0
6	29414775	.	T	A	1	2	3	0	0	3	0	0
6	29459034	.	T	C	2	6	8	0	1	9	0	0
6	29459054	.	A	G	3	0	3	0	5	8	0	0
6	29466478	.	T	G	2	0	2	0	3	5	0	0
6	29466588	.	T	A	4	4	8	0	0	8	0	0
6	29466993	.	T	A	1	2	3	0	0	3	0	0
6	29467159	.	G	C	2	5	7	0	0	7	0	0
6	29467475	.	A	G	4	2	6	0	0	6	0	0
6	29468740	.	C	T	4	2	6	0	0	6	0	0
6	29476983	.	C	A	2	2	4	0	1	5	0	0
6	29477093	.	T	A	4	6	10	0	0	10	0	0
6	29477094	.	T	C	5	5	10	0	0	10	0	0
6	29488695	.	A	G	3	2	5	0	1	6	0	0
6	29703526	.	C	T	8	2	10	0	0	10	0	0
6	29703846	.	A	C	10	4	14	0	0	14	0	0
6	29703865	.	A	T	10	9	19	0	0	19	0	0
6	29705561	.	A	T	12	10	22	0	1	23	0	0
6	29705614	.	G	A	4	6	10	0	7	17	0	0
6	29705767	.	A	G	8	9	17	0	1	18	0	0
6	29705901	.	T	C	2	7	9	1	1	11	0	0
6	29708010	.	T	C	9	7	16	0	0	16	0	0
6	29708073	.	A	C	7	7	14	0	2	16	0	0
6	29710111	.	C	T	6	5	11	0	0	11	0	0
6	29710157	.	A	G	4	0	4	0	6	10	0	0
6	29710216	.	C	T	5	7	12	0	0	12	0	0
6	29712470	.	T	C	10	5	15	0	1	16	0	0
6	29712651	.	G	A	14	9	23	0	1	24	0	0
6	29713920	.	G	T	5	6	11	0	1	12	0	0
6	29713926	.	T	C	8	9	17	0	1	18	0	0
6	29714017	.	A	G	1	10	11	0	3	14	0	0
6	29714054	.	A	C	4	7	11	0	0	11	0	0
6	29714064	.	C	T	4	6	10	0	1	11	0	0
6	29714123	.	C	T	1	4	5	0	0	5	0	0
6	29714128	.	C	T	0	5	5	0	0	5	0	0
6	29791206	.	C	G	6	12	18	0	1	19	0	0
6	29791310	.	A	C	24	39	63	0	3	66	0	0
6	29793798	.	C	A	34	38	72	0	5	77	0	0
6	29794003	.	T	G	48	32	80	0	1	81	0	0
6	29794639	.	T	C	38	32	70	1	1	72	0	0
6	30019954	.	C	T	6	10	16	0	2	18	0	0
6	30027896	.	C	A	12	11	23	0	1	24	0	0
6	30048421	.	G	A	0	5	5	0	7	12	0	0
6	30052061	.	C	A	21	15	36	0	2	38	0	0
6	30052085	.	A	G	23	14	37	0	1	38	0	0
6	30066414	.	A	T	4	2	6	0	0	6	0	0
6	30082255	.	G	A	8	12	20	0	2	22	0	0
6	30082752	.	T	G	22	23	45	0	1	46	0	0
6	30117495	.	G	A	6	4	10	0	0	10	0	0
6	30121872	.	G	T	10	6	16	0	1	18	1	0
6	30122248	.	A	T	11	4	15	0	0	15	0	0
6	30122255	.	C	A	4	3	7	0	1	8	0	0
6	30124575	.	C	T	18	15	33	0	3	36	0	0
6	30147219	.	G	A	14	12	26	0	1	27	0	0
6	30147249	.	T	C	15	2	17	0	13	30	0	0
6	30147831	.	C	T	5	10	15	0	0	15	0	0
6	30148056	.	A	T	5	9	14	0	2	16	0	0
6	30148143	.	G	A	2	5	7	0	1	8	0	0
6	30148422	.	C	T	11	5	16	0	0	16	0	0
6	30151537	.	G	A	13	4	17	0	1	18	0	0
6	30160956	.	C	T	4	6	10	0	0	10	0	0
6	30177742	.	T	C	2	4	6	0	0	6	0	0
6	30433389	.	C	G	1	2	3	0	1	4	0	0
6	30440099	.	A	C	5	3	8	0	0	8	0	0
6	30440258	.	G	A	0	1	1	0	8	9	0	0
6	30441333	.	G	A	3	2	5	0	0	5	0	0
6	30441762	.	G	A	5	5	10	0	0	10	0	0
6	30450458	.	T	C	4	4	8	0	2	10	0	0
6	30450464	.	G	A	4	6	10	0	0	10	0	0
6	30452316	.	T	C	6	6	12	0	1	13	0	0
6	30452562	.	A	T	3	5	8	0	4	12	0	0
6	30452669	.	A	T	1	2	3	0	0	3	0	0
6	30452811	.	C	T	3	2	5	0	0	5	0	0
6	30452843	.	G	T	3	3	6	0	0	6	0	0
6	30452867	.	T	A	3	0	3	0	1	5	1	0
6	30576901	.	C	T	1	2	3	0	0	3	0	0
6	30579371	.	A	T	4	3	7	0	0	7	0	0
6	30579379	.	C	T	3	4	7	0	0	7	0	0
6	30592593	.	A	T	4	5	9	0	0	9	0	0
6	30592637	.	A	G	3	0	3	0	3	6	0	0
6	30592804	.	T	A	3	2	5	0	0	5	0	0
6	30626227	.	A	G	14	8	22	0	0	22	0	0
6	30626240	.	A	T	14	11	25	0	0	25	0	0
6	30626276	.	T	C	15	15	30	0	5	35	0	0
6	30626715	.	T	G	11	15	26	0	3	29	0	0
6	30626765	.	C	T	9	14	23	0	1	24	0	0
6	30626908	.	G	A	17	7	24	0	0	24	0	0
6	30626931	.	T	C	13	7	20	0	1	21	0	0
6	30627292	.	T	C	25	12	37	0	1	38	0	0
6	30627549	.	G	A	14	8	22	0	1	23	0	0
6	30627605	.	G	C	17	10	27	0	1	28	0	0
6	30627606	.	A	C	18	0	18	0	10	28	0	0
6	30627660	.	A	C	8	11	19	0	3	22	0	0
6	30627714	.	C	T	1	13	14	1	13	28	0	0
6	30627724	.	A	T	13	11	24	1	3	29	1	0
6	30627807	.	G	T	13	9	22	0	1	24	1	0
6	30627914	.	T	C	15	6	21	0	0	21	0	0
6	30627921	.	G	T	13	7	20	0	2	22	0	0
6	30627996	.	A	C	6	0	6	0	4	10	0	0
6	30627998	.	T	C	5	0	5	0	4	9	0	0
6	30628066	.	T	C	8	5	13	0	1	14	0	0
6	30628170	.	T	C	6	9	15	0	2	17	0	0
6	30628185	.	G	A	8	10	18	0	0	18	0	0
6	30628228	.	A	G	3	4	7	0	2	9	0	0
6	30628447	.	G	A	9	8	17	0	0	17	0	0
6	30628459	.	A	G	10	4	14	0	2	16	0	0
6	30628540	.	T	C	6	0	6	0	5	11	0	0
6	30628651	.	G	A	9	3	12	0	0	12	0	0
6	30628684	.	C	A	9	4	13	0	1	14	0	0
6	30628922	.	T	C	7	6	13	0	0	13	0	0
6	30628978	.	C	T	9	6	15	0	0	15	0	0
6	30629142	.	G	A	6	4	10	0	0	10	0	0
6	30629278	.	A	G	4	5	9	0	0	9	0	0
6	30629285	.	G	A	4	3	7	0	0	7	0	0
6	30629373	.	A	T	5	3	8	0	0	8	0	0
6	30629656	.	T	G	2	5	7	0	0	7	0	0
6	30629695	.	C	G	3	5	8	0	1	9	0	0
6	30629850	.	G	C	3	2	5	0	1	6	0	0
6	30629935	.	T	C	7	3	10	0	0	10	0	0
6	30629936	.	G	A	7	3	10	0	0	10	0	0
6	30629988	.	C	A	6	3	9	0	1	10	0	0
6	30630438	.	G	A	3	8	11	0	0	11	0	0
6	30630454	.	T	G	2	5	7	0	0	7	0	0
6	30631021	.	T	C	2	4	6	0	0	6	0	0
6	30658524	.	T	C	4	2	6	0	0	6	0	0
6	30677093	.	C	T	2	2	4	0	0	4	0	0
6	30677110	.	G	A	2	2	4	0	0	4	0	0
6	30677347	.	G	T	5	8	13	1	1	15	0	0
6	30677445	.	G	C	10	3	13	0	0	13	0	0
6	30678086	.	T	C	3	0	3	0	4	7	0	0
6	30678279	.	T	G	1	2	3	0	1	4	0	0
6	30681291	.	C	A	1	4	5	0	0	5	0	0
6	30682141	.	A	G	2	2	4	0	0	5	1	0
6	30683382	.	G	A	3	2	5	0	0	5	0	0
6	30685044	.	A	G	5	5	10	0	2	12	0	0
6	30685311	.	A	G	4	2	6	0	0	6	0	0
6	30685391	.	G	T	4	4	8	0	0	8	0	0
6	30685563	.	G	A	3	2	5	0	0	5	0	0
6	30685644	.	A	T	1	3	4	0	0	4	0	0
6	30688021	.	A	G	1	3	4	0	0	4	0	0
6	30688997	.	T	C	3	2	5	0	0	5	0	0
6	30689009	.	A	G	2	2	4	0	0	4	0	0
6	30710270	.	A	G	26	20	46	0	4	50	0	0
6	30710342	.	T	G	20	32	52	0	1	53	0	0
6	30710351	.	G	T	19	30	49	0	1	50	0	0
6	30710591	.	G	A	7	8	15	0	0	15	0	0
6	30710886	.	A	G	3	4	7	0	1	8	0	0
6	30711485	.	A	T	19	14	33	0	0	33	0	0
6	30711511	.	C	T	17	18	35	0	1	36	0	0
6	30711586	.	A	C	24	0	24	0	14	38	0	0
6	30711612	.	G	A	21	16	37	0	4	41	0	0
6	30711851	.	T	C	20	16	36	0	2	38	0	0
6	30711852	.	A	T	17	18	35	0	2	37	0	0
6	30711948	.	A	G	15	12	27	0	1	28	0	0
6	30711957	.	T	C	20	13	33	0	2	35	0	0
6	30712121	.	G	T	21	15	36	0	2	38	0	0
6	30712265	.	T	C	8	12	20	0	1	21	0	0
6	30712455	.	A	T	10	7	17	0	0	17	0	0
6	30712458	.	A	G	9	7	16	0	0	16	0	0
6	30712508	.	G	A	7	9	16	0	0	16	0	0
6	30712582	.	T	C	7	0	7	0	8	15	0	0
6	30713184	.	T	A	8	7	15	2	0	17	0	0
6	30713296	.	C	T	5	11	16	0	1	17	0	0
6	30713341	.	G	A	7	10	17	0	0	17	0	0
6	30713666	.	T	C	5	2	7	0	0	7	0	0
6	30713724	.	C	T	7	10	17	0	0	17	0	0
6	30713725	.	A	T	8	10	18	0	0	18	0	0
6	30713761	.	G	C	8	11	19	0	1	20	0	0
6	30713869	.	C	T	0	12	12	0	9	21	0	0
6	30713929	.	C	G	14	16	30	0	4	34	0	0
6	30714218	.	T	A	10	11	21	0	0	21	0	0
6	30715446	.	T	C	8	0	8	0	8	16	0	0
6	30715647	.	A	T	7	6	13	0	0	13	0	0
6	30715865	.	A	T	7	7	14	0	1	16	1	0
6	30717579	.	T	C	11	15	26	0	2	28	0	0
6	30717636	.	T	C	8	0	8	0	16	24	0	0
6	30719319	.	G	A	7	8	15	0	1	16	0	0
6	30719348	.	G	C	7	8	15	0	1	16	0	0
6	30719391	.	A	T	9	7	16	0	1	17	0	0
6	30721397	.	G	A	12	8	20	0	1	21	0	0
6	30742651	.	A	G	5	6	11	0	0	11	0	0
6	30761742	.	G	A	3	4	7	0	0	7	0	0
6	30853053	.	T	A	32	27	59	0	1	60	0	0
6	30859381	.	T	A	13	8	21	0	1	22	0	0
6	30868450	.	A	G	2	2	4	0	1	5	0	0
6	30931362	.	C	T	0	2	2	0	3	5	0	0
6	30931476	.	A	T	2	3	5	0	0	5	0	0
6	30931479	.	T	C	0	0	0	0	4	4	0	0
6	31069556	.	G	A	1	3	4	0	0	4	0	0
6	31069748	.	A	G	2	3	5	0	0	5	0	0
6	31146776	.	T	A	2	3	5	0	1	6	0	0
6	31146868	.	A	C	1	1	2	0	3	5	0	0
6	31146921	.	T	C	1	3	4	0	0	4	0	0
6	31184600	.	T	G	2	2	4	0	1	5	0	0
6	31184651	.	T	C	3	4	7	0	0	7	0	0
6	31185133	.	G	A	6	5	11	0	1	12	0	0
6	31185247	.	C	G	7	5	12	0	0	12	0	0
6	31185515	.	A	T	1	2	3	0	0	3	0	0
6	31185523	.	C	T	3	3	6	0	0	6	0	0
6	31185760	.	T	A	1	6	7	0	0	7	0	0
6	31186737	.	A	C	2	2	4	0	1	5	0	0
6	31186794	.	G	A	3	3	6	0	0	6	0	0
6	31280164	.	T	C	26	18	44	0	1	45	0	0
6	31280238	.	T	C	18	11	29	0	2	31	0	0
6	31280253	.	T	A	16	14	30	0	0	30	0	0
6	31280495	.	C	T	17	13	30	0	0	30	0	0
6	31280586	.	A	G	17	17	34	0	1	35	0	0
6	31280635	.	A	T	21	8	29	0	2	31	0	0
6	31280945	.	A	T	13	13	26	0	3	29	0	0
6	31281006	.	C	T	3	13	16	0	14	30	0	0
6	31281130	.	A	G	26	22	48	0	0	48	0	0
6	31281249	.	G	A	12	20	32	0	3	35	0	0
6	31281262	.	T	C	16	0	16	0	21	37	0	0
6	31281674	.	T	C	5	6	11	0	0	11	0	0
6	31281732	.	T	A	6	6	12	0	1	13	0	0
6	31281994	.	T	A	12	13	25	0	1	26	0	0
6	31282028	.	T	G	7	6	13	0	1	14	0	0
6	31282118	.	T	G	4	2	6	0	0	6	0	0
6	31282170	.	T	C	7	0	7	0	6	13	0	0
6	31282399	.	T	A	9	8	17	0	0	17	0	0
6	31282494	.	C	T	7	10	17	0	1	18	0	0
6	31283167	.	G	T	11	9	20	0	0	20	0	0
6	31283210	.	T	G	7	13	20	0	1	21	0	0
6	31283299	.	G	A	5	9	14	1	0	15	0	0
6	31285874	.	G	A	11	9	20	0	1	21	0	0
6	31288637	.	C	G	9	15	24	0	1	25	0	0
6	31288642	.	C	G	1	14	15	0	10	25	0	0
6	31288742	.	T	C	7	0	7	0	11	18	0	0
6	31288894	.	T	A	15	9	24	0	0	24	0	0
6	31291030	.	G	A	10	8	18	0	0	18	0	0
6	31291033	.	C	A	9	5	14	0	2	16	0	0
6	31336156	.	G	A	4	5	9	0	0	9	0	0
6	31352334	.	T	A	16	8	24	0	3	27	0	0
6	31352664	.	C	T	3	7	10	0	0	10	0	0
6	31352907	.	T	C	8	5	13	0	1	14	0	0
6	31352963	.	A	G	11	11	22	0	0	22	0	0
6	31353073	.	T	C	17	9	26	0	0	26	0	0
6	31353613	.	G	A	16	9	25	0	0	25	0	0
6	31395943	.	C	T	1	2	3	0	0	3	0	0
6	31426246	.	A	G	11	1	12	0	6	18	0	0
6	31426287	.	G	T	9	8	17	0	0	17	0	0
6	31426465	.	T	C	10	11	21	0	3	24	0	0
6	31426546	.	C	A	5	5	10	0	0	10	0	0
6	31426551	.	C	A	5	2	7	0	1	8	0	0
6	31426881	.	C	T	8	8	16	0	1	17	0	0
6	31426955	.	G	A	10	12	22	0	0	22	0	0
6	31427240	.	A	G	2	5	7	0	0	7	0	0
6	31427261	.	T	C	3	7	10	0	0	10	0	0
6	31427437	.	C	A	6	7	13	0	0	13	0	0
6	31427646	.	A	T	4	5	9	0	1	10	0	0
6	31427905	.	A	G	13	7	20	0	1	21	0	0
6	31427926	.	A	G	9	16	25	0	1	26	0	0
6	31428155	.	A	G	14	10	24	1	0	25	0	0
6	31428204	.	T	C	15	9	24	4	0	28	0	0
6	31428283	.	C	A	15	11	26	1	0	27	0	0
6	31428448	.	T	A	4	2	6	0	0	6	0	0
6	31428770	.	G	A	18	14	32	0	2	34	0	0
6	31428780	.	T	G	16	16	32	0	1	33	0	0
6	31430900	.	T	C	3	2	5	0	2	7	0	0
6	31430950	.	T	C	3	0	3	0	4	7	0	0
6	31431145	.	T	G	6	3	9	0	0	9	0	0
6	31431422	.	A	G	18	19	37	0	1	38	0	0
6	31431646	.	A	T	15	13	28	0	0	28	0	0
6	31431870	.	G	A	26	11	37	0	1	38	0	0
6	31432213	.	G	A	9	9	18	0	1	19	0	0
6	31432214	.	C	A	9	10	19	0	0	19	0	0
6	31432302	.	G	A	4	7	11	0	1	12	0	0
6	31432315	.	T	C	5	4	9	0	0	9	0	0
6	31432563	.	T	C	5	4	9	0	0	9	0	0
6	31432684	.	T	C	4	3	7	0	0	7	0	0
6	31432746	.	A	C	12	6	18	0	2	20	0	0
6	31432761	.	A	G	14	7	21	0	1	22	0	0
6	31432991	.	T	C	12	7	19	1	0	20	0	0
6	31433020	.	A	C	13	7	20	0	2	22	0	0
6	31433033	.	T	G	14	8	22	0	1	23	0	0
6	31433060	.	T	C	13	3	16	0	0	16	0	0
6	31433692	.	A	T	6	3	9	0	1	10	0	0
6	31433756	.	C	A	4	5	9	0	0	9	0	0
6	31433846	.	G	A	3	4	7	0	1	8	0	0
6	31434050	.	C	A	3	2	5	0	1	6	0	0
6	31434245	.	A	T	3	4	7	0	1	8	0	0
6	31434470	.	G	T	8	4	12	0	0	12	0	0
6	31434555	.	A	G	4	2	6	0	0	6	0	0
6	31434773	.	T	G	10	7	17	0	0	17	0	0
6	31435005	.	T	C	4	3	7	0	0	7	0	0
6	31435017	.	C	T	0	3	3	0	5	8	0	0
6	31438395	.	T	C	10	11	21	0	0	21	0	0
6	31438404	.	T	G	10	12	22	0	0	22	0	0
6	31462606	.	G	A	3	6	9	0	1	10	0	0
6	31463147	.	A	T	3	3	6	0	0	6	0	0
6	31469966	.	T	G	1	3	4	0	0	4	0	0
6	31483364	.	A	C	2	2	4	0	0	4	0	0
6	31591123	.	C	T	2	9	11	0	6	17	0	0
6	31591619	.	G	A	11	10	21	0	1	22	0	0
6	31591841	.	G	A	12	16	28	0	4	32	0	0
6	31591884	.	A	G	7	11	18	0	18	36	0	0
6	31607768	.	T	G	9	6	15	0	0	15	0	0
6	31611647	.	T	A	4	5	9	0	0	9	0	0
6	31617167	.	C	G	0	7	7	0	8	15	0	0
6	31624107	.	T	C	2	3	5	0	1	6	0	0
6	32010215	.	C	T	3	4	7	0	0	7	0	0
6	32010259	.	G	A	11	6	17	0	0	17	0	0
6	32010341	.	C	T	2	16	18	0	20	38	0	0
6	32010475	.	A	G	23	28	51	1	2	54	0	0
6	32014771	.	T	G	21	20	41	0	2	43	0	0
6	32016492	.	T	C	10	11	21	0	1	22	0	0
6	32021615	.	T	A	4	4	8	0	0	8	0	0
6	32024960	.	C	T	3	5	8	0	0	8	0	0
6	32025005	.	C	T	0	5	5	0	3	8	0	0
6	32025109	.	C	A	5	4	9	0	2	11	0	0
6	32029432	.	A	T	2	5	7	0	0	7	0	0
6	32032371	.	A	C	9	7	16	0	1	17	0	0
6	32032374	.	A	C	12	7	19	0	0	19	0	0
6	32032479	.	C	T	9	9	18	0	1	19	0	0
6	32035921	.	G	A	1	3	4	0	0	4	0	0
6	32037710	.	T	C	3	4	7	0	0	7	0	0
6	32042381	.	G	A	3	2	5	0	0	5	0	0
6	32068411	.	G	C	2	2	4	0	0	4	0	0
6	32068488	.	G	A	1	2	3	0	0	3	0	0
6	32071935	.	G	A	1	3	4	0	0	4	0	0
6	32347346	.	C	T	0	3	3	0	2	5	0	0
6	32378097	.	G	A	0	3	3	0	1	4	0	0
6	32378689	.	T	C	11	3	14	0	0	14	0	0
6	32382629	.	C	T	5	7	12	0	0	12	0	0
6	32385091	.	A	G	8	7	15	0	0	15	0	0
6	32386908	.	T	C	9	5	14	0	0	14	0	0
6	32396755	.	T	C	13	6	19	0	2	21	0	0
6	32397588	.	C	T	21	11	32	0	1	33	0	0
6	32397659	.	T	C	10	16	26	0	2	28	0	0
6	32404206	.	C	G	16	13	29	0	1	30	0	0
6	32404863	.	C	T	0	9	9	0	7	16	0	0
6	32405054	.	A	T	10	12	22	0	0	22	0	0
6	32405266	.	G	A	7	10	17	0	0	17	0	0
6	32405741	.	A	T	5	3	8	0	0	8	0	0
6	32405952	.	C	T	2	4	6	0	2	8	0	0
6	32406216	.	G	A	5	8	13	0	2	15	0	0
6	32408182	.	A	G	8	3	11	0	1	12	0	0
6	32408299	.	G	A	1	2	3	0	2	5	0	0
6	32408437	.	C	T	2	4	6	0	2	8	0	0
6	32409135	.	C	T	2	2	4	0	0	4	0	0
6	32409258	.	T	C	2	0	2	0	3	5	0	0
6	32483869	.	C	T	1	2	3	0	0	3	0	0
6	32487220	.	A	T	1	4	5	0	0	5	0	0
6	32506349	.	T	A	7	8	15	0	1	16	0	0
6	32506350	.	G	A	8	8	16	0	0	16	0	0
6	32506386	.	C	T	7	7	14	0	0	14	0	0
6	32506526	.	A	G	1	5	6	0	0	6	0	0
6	32700069	.	G	C	2	0	2	0	5	8	1	0
6	33548919	.	A	G	5	6	11	0	0	11	0	0
6	33550455	.	C	T	4	6	10	0	1	11	0	0
6	33550691	.	C	A	7	5	12	0	0	12	0	0
6	33550947	.	G	A	8	9	17	0	0	17	0	0
6	33552574	.	T	C	5	9	14	0	0	14	0	0
6	33552601	.	A	T	6	6	12	0	1	13	0	0
6	33554009	.	T	A	7	6	13	1	0	14	0	0
6	33554231	.	T	C	5	7	12	0	0	12	0	0
6	33554356	.	T	C	4	8	12	0	1	13	0	0
6	33554433	.	A	T	4	5	9	0	0	9	0	0
6	33554435	.	C	T	2	4	6	0	3	9	0	0
6	33554576	.	T	C	5	4	9	0	0	9	0	0
6	33554620	.	A	G	5	0	5	0	3	8	0	0
6	33554786	.	T	C	3	4	7	0	0	7	0	0
6	33554809	.	G	C	5	3	8	0	0	8	0	0
6	33555107	.	A	C	6	4	10	0	0	10	0	0
6	33555235	.	G	T	3	3	6	0	0	6	0	0
6	33555241	.	T	C	3	4	7	0	0	7	0	0
6	33555808	.	C	G	10	13	23	0	3	26	0	0
6	33556036	.	T	A	11	10	21	0	2	23	0	0
6	33556316	.	C	T	4	9	13	0	5	18	0	0
6	33556325	.	A	T	10	11	21	0	0	21	0	0
6	33556424	.	A	G	4	12	16	0	1	17	0	0
6	33556497	.	A	T	2	16	18	0	3	21	0	0
6	33556706	.	G	C	14	10	24	0	1	25	0	0
6	33556730	.	A	G	12	10	22	0	1	23	0	0
6	33556772	.	A	T	9	13	22	0	2	24	0	0
6	33556819	.	G	A	9	14	23	0	3	26	0	0
6	33556835	.	T	C	13	13	26	0	1	27	0	0
6	33556877	.	G	A	1	12	13	0	23	36	0	0
6	33557227	.	A	G	18	13	31	0	0	31	0	0
6	33557377	.	A	C	9	12	21	0	1	22	0	0
6	33557562	.	T	G	21	17	38	0	1	39	0	0
6	33557625	.	C	T	22	20	42	0	2	44	0	0
6	33558437	.	G	A	25	19	44	0	5	49	0	0
6	33663690	.	T	C	9	14	23	0	0	23	0	0
6	33663701	.	T	C	14	7	21	0	2	23	0	0
6	33663776	.	A	T	9	13	22	0	0	22	0	0
6	33663839	.	C	T	0	19	19	0	13	32	0	0
6	33663842	.	T	A	11	18	29	0	3	32	0	0
6	33664137	.	C	G	0	6	6	0	6	12	0	0
6	33664556	.	C	T	7	2	9	0	0	9	0	0
6	33664612	.	T	C	11	0	11	0	11	22	0	0
6	33664852	.	T	C	6	4	10	0	0	10	0	0
6	33664917	.	C	T	0	2	2	0	5	7	0	0
6	33664937	.	G	C	5	6	11	0	0	11	0	0
6	33665062	.	A	G	10	4	14	0	0	14	0	0
6	33665097	.	A	G	9	4	13	0	0	13	0	0
6	33665578	.	A	T	5	7	12	0	0	12	0	0
6	33665734	.	C	T	7	8	15	0	1	16	0	0
6	33665968	.	C	T	5	13	18	0	1	19	0	0
6	33666302	.	C	A	4	5	9	0	2	11	0	0
6	33666308	.	G	A	3	7	10	0	2	12	0	0
6	33666472	.	G	T	8	11	19	0	0	19	0	0
6	33666499	.	A	G	7	8	15	0	0	15	0	0
6	33666511	.	C	T	2	9	11	0	8	19	0	0
6	33666578	.	G	T	8	8	16	0	1	17	0	0
6	33666631	.	C	T	7	8	15	0	0	15	0	0
6	33666660	.	A	T	7	8	15	0	0	15	0	0
6	33666777	.	C	T	10	7	17	0	1	18	0	0
6	33666910	.	G	T	2	13	15	0	0	15	0	0
6	33666964	.	G	C	1	0	1	0	6	7	0	0
6	33667162	.	A	G	1	2	3	0	0	3	0	0
6	33667435	.	G	A	3	6	9	0	0	9	0	0
6	33667483	.	T	G	4	8	12	0	5	17	0	0
6	33667492	.	G	T	8	4	12	0	9	21	0	0
6	33667546	.	G	A	10	6	16	0	0	16	0	0
6	33668228	.	A	T	4	6	10	0	0	10	0	0
6	33668729	.	A	T	5	3	8	0	0	8	0	0
6	33875138	.	T	G	2	2	4	0	0	4	0	0
6	33875746	.	T	A	1	4	5	0	0	5	0	0
6	33875833	.	G	A	2	2	4	0	0	4	0	0
6	33875839	.	G	A	2	2	4	0	0	4	0	0
6	33875954	.	A	G	2	2	4	0	1	5	0	0
6	33883916	.	T	A	6	3	9	0	0	9	0	0
6	33884447	.	G	A	0	14	14	0	6	20	0	0
6	33896406	.	T	G	20	0	20	0	22	42	0	0
6	33896457	.	A	G	19	23	42	0	4	46	0	0
6	33896538	.	T	C	29	17	46	0	2	48	0	0
6	33896562	.	A	G	24	18	42	0	2	44	0	0
6	33896615	.	G	A	2	17	19	0	17	36	0	0
6	33896858	.	T	C	22	12	34	0	3	37	0	0
6	33896975	.	A	C	20	19	39	0	1	40	0	0
6	33897472	.	T	A	16	15	31	0	1	32	0	0
6	33897505	.	G	A	14	17	31	0	0	31	0	0
6	33897766	.	A	T	7	12	19	0	2	21	0	0
6	33905862	.	G	A	1	2	3	0	0	3	0	0
6	33912228	.	G	T	10	12	22	0	0	22	0	0
6	33912240	.	G	A	8	12	20	0	1	21	0	0
6	33912708	.	A	C	5	0	5	0	7	12	0	0
6	33916648	.	T	C	3	0	3	0	4	7	0	0
6	33918916	.	A	G	5	2	7	0	1	8	0	0
6	33921304	.	T	C	8	11	19	0	3	22	0	0
6	33921559	.	G	A	5	2	7	0	1	8	0	0
6	33924622	.	A	T	4	3	7	0	0	7	0	0
6	33924693	.	A	G	8	3	11	0	0	11	0	0
6	33926956	.	T	G	2	3	5	0	0	5	0	0
6	33927271	.	G	T	10	11	21	0	1	22	0	0
6	33929724	.	G	C	8	5	13	0	0	13	0	0
6	33982539	.	A	G	1	2	3	0	0	3	0	0
6	33983007	.	T	C	7	2	9	0	0	9	0	0
6	33983405	.	G	T	5	3	8	0	0	8	0	0
6	34072026	.	C	A	1	3	4	0	0	4	0	0
6	34072052	.	T	A	1	3	4	0	0	4	0	0
6	34072514	.	A	C	2	1	3	0	0	3	0	0
6	34072517	.	A	T	2	2	4	0	0	4	0	0
6	34787632	.	C	T	2	2	4	0	0	4	0	0
6	34806450	.	G	T	5	2	7	0	1	8	0	0
6	34806494	.	C	T	3	3	6	0	1	7	0	0
6	34807534	.	C	A	2	4	6	0	0	6	0	0
6	34807906	.	C	A	3	3	6	0	0	6	0	0
6	34807999	.	G	T	6	4	10	0	0	10	0	0
6	34808835	.	C	A	10	4	14	0	1	15	0	0
6	34808914	.	C	T	3	11	14	0	2	16	0	0
6	34808996	.	A	G	6	0	6	0	3	9	0	0
6	34809040	.	G	A	8	8	16	0	0	16	0	0
6	34809564	.	A	T	8	7	15	0	0	15	0	0
6	34809697	.	C	G	11	1	12	0	8	20	0	0
6	34809826	.	C	A	7	6	13	0	0	13	0	0
6	34809850	.	G	T	6	12	18	0	0	18	0	0
6	34810313	.	C	T	13	15	28	0	3	31	0	0
6	34810415	.	A	G	11	1	12	0	14	26	0	0
6	34810490	.	G	A	1	13	14	0	12	26	0	0
6	34810748	.	A	G	8	7	15	0	0	15	0	0
6	34810763	.	T	A	8	11	19	0	1	20	0	0
6	34810890	.	T	C	11	9	20	0	0	20	0	0
6	34810896	.	G	A	11	9	20	0	1	21	0	0
6	34811150	.	A	C	14	8	22	0	0	22	0	0
6	34811175	.	T	C	9	8	17	0	3	20	0	0
6	34825910	.	A	C	2	4	6	0	0	6	0	0
6	34825955	.	C	T	0	6	6	0	4	10	0	0
6	34826002	.	T	C	8	4	12	0	0	12	0	0
6	34826214	.	G	A	4	4	8	0	0	8	0	0
6	34826711	.	A	T	3	3	6	0	0	6	0	0
6	34826736	.	A	T	5	6	11	0	0	11	0	0
6	34826750	.	C	G	2	4	6	0	8	14	0	0
6	34826850	.	G	C	6	14	20	0	0	20	0	0
6	34826882	.	T	G	7	7	14	0	0	14	0	0
6	34831124	.	A	C	5	0	5	0	4	9	0	0
6	34848320	.	C	T	2	4	6	0	0	6	0	0
6	34851921	.	G	A	4	3	7	0	0	7	0	0
6	34854397	.	G	A	1	2	3	0	0	3	0	0
6	34932657	.	G	A	26	25	51	0	1	52	0	0
6	34932927	.	A	T	34	25	59	0	2	61	0	0
6	34933574	.	C	T	23	30	53	0	3	56	0	0
6	34934870	.	C	T	7	22	29	0	27	56	0	0
6	34934903	.	G	T	22	26	48	0	4	52	0	0
6	34943451	.	G	T	2	2	4	0	0	4	0	0
6	34943683	.	A	T	4	4	8	0	0	8	0	0
6	34943760	.	A	G	4	2	6	0	1	7	0	0
6	34943900	.	A	T	2	3	5	0	0	5	0	0
6	34944523	.	G	A	3	2	5	0	0	5	0	0
6	34960950	.	A	T	3	2	5	0	0	5	0	0
6	35036275	.	A	C	3	3	6	0	1	7	0	0
6	35036303	.	C	T	5	3	8	0	0	8	0	0
6	35036320	.	C	T	5	2	7	0	1	8	0	0
6	35036459	.	A	T	5	3	8	0	0	8	0	0
6	35036463	.	T	C	5	0	5	0	3	8	0	0
6	35036525	.	T	G	5	4	9	0	0	9	0	0
6	35039966	.	C	T	3	4	7	0	0	7	0	0
6	35042176	.	C	T	5	4	9	0	0	9	0	0
6	35042201	.	A	G	2	3	5	0	0	5	0	0
6	35051403	.	T	G	2	3	5	0	0	5	0	0
6	35053243	.	G	A	2	2	4	0	0	4	0	0
6	35053250	.	A	G	2	2	4	0	0	4	0	0
6	35058456	.	C	T	1	1	2	0	2	4	0	0
6	35061237	.	C	T	1	2	3	0	0	3	0	0
6	35099980	.	T	C	6	5	11	0	0	11	0	0
6	35100084	.	G	A	9	9	18	0	1	19	0	0
6	35100230	.	T	A	10	3	13	0	0	13	0	0
6	35100423	.	C	T	5	5	10	0	0	10	0	0
6	35100442	.	T	C	3	5	8	0	1	9	0	0
6	35100461	.	T	A	7	6	13	0	0	14	1	0
6	35100528	.	A	G	10	6	16	0	0	16	0	0
6	35100795	.	C	G	1	6	7	0	7	14	0	0
6	35100801	.	T	G	9	6	15	0	1	16	0	0
6	35100857	.	A	G	10	7	17	0	0	17	0	0
6	35100868	.	T	A	8	7	15	0	1	16	0	0
6	35100894	.	C	T	0	4	4	0	8	12	0	0
6	35100933	.	A	G	5	5	10	0	0	10	0	0
6	35101184	.	A	T	8	11	19	0	0	19	0	0
6	35101336	.	A	T	3	2	5	0	0	5	0	0
6	35101464	.	T	C	2	1	3	0	0	3	0	0
6	35101473	.	A	G	0	1	1	0	1	2	0	0
6	35101503	.	G	A	1	2	3	0	0	3	0	0
6	35101641	.	A	T	1	2	3	0	0	3	0	0
6	35101645	.	T	C	3	3	6	0	0	6	0	0
6	35101696	.	C	T	5	3	8	0	2	10	0	0
6	35101703	.	T	G	5	4	9	0	2	11	0	0
6	35102089	.	C	G	1	2	3	0	3	6	0	0
6	35102136	.	C	A	3	2	5	0	1	6	0	0
6	35102535	.	C	T	3	2	5	0	0	5	0	0
6	35102923	.	C	T	0	4	4	0	2	6	0	0
6	35136451	.	T	C	3	7	10	0	1	11	0	0
6	35136505	.	T	A	4	6	10	0	1	11	0	0
6	35136693	.	A	T	3	6	9	0	0	9	0	0
6	35136778	.	G	T	2	2	4	0	0	4	0	0
6	35136983	.	A	G	3	4	7	0	0	7	0	0
6	35137587	.	A	G	2	2	4	0	0	4	0	0
6	35139248	.	T	C	4	4	8	0	1	9	0	0
6	35309798	.	T	G	1	2	3	0	0	3	0	0
6	35364869	.	G	A	5	5	10	0	0	10	0	0
6	35365179	.	T	C	7	4	11	0	0	11	0	0
6	35365185	.	T	A	6	3	9	0	1	10	0	0
6	35365573	.	G	A	1	2	3	0	1	4	0	0
6	35365714	.	T	C	6	3	9	0	0	9	0	0
6	35365730	.	C	T	5	2	7	0	0	7	0	0
6	35366140	.	G	T	0	6	6	0	9	15	0	0
6	35366141	.	A	G	8	5	13	0	2	15	0	0
6	35366253	.	C	T	4	4	8	0	1	9	0	0
6	35366640	.	C	G	5	6	11	0	2	13	0	0
6	35388025	.	G	C	7	0	7	0	6	13	0	0
6	35389116	.	T	A	1	1	2	0	1	3	0	0
6	35389181	.	C	A	1	3	4	0	0	4	0	0
6	35389493	.	C	T	2	2	4	0	1	5	0	0
6	35389517	.	C	G	0	3	3	0	4	7	0	0
6	35389736	.	A	T	4	3	7	0	0	7	0	0
6	35389773	.	G	A	5	8	13	0	0	13	0	0
6	35389826	.	A	G	6	2	8	0	1	9	0	0
6	35389915	.	C	T	0	2	2	0	2	4	0	0
6	35443819	.	G	T	19	14	33	0	1	34	0	0
6	35443822	.	C	T	22	12	34	0	1	35	0	0
6	35443951	.	T	C	27	29	56	0	1	57	0	0
6	35443960	.	C	T	5	20	25	0	32	57	0	0
6	35444467	.	G	A	28	29	57	0	2	59	0	0
6	35487433	.	C	T	0	2	2	0	1	3	0	0
6	35676724	.	C	T	12	5	17	2	0	19	0	0
6	35676799	.	C	T	15	13	28	0	0	28	0	0
6	35677534	.	T	A	6	10	16	0	0	16	0	0
6	35688231	.	G	A	2	5	7	0	0	7	0	0
6	35693656	.	C	T	4	4	8	0	0	8	0	0
6	35737289	.	A	G	3	2	5	0	1	6	0	0
6	35737387	.	C	G	1	2	3	0	0	3	0	0
6	36129115	.	C	G	3	3	6	0	0	6	0	0
6	36129164	.	T	C	1	3	4	0	0	4	0	0
6	36130721	.	G	A	1	2	3	0	0	3	0	0
6	36131538	.	C	T	1	8	9	0	7	16	0	0
6	36132072	.	C	T	1	3	4	0	4	8	0	0
6	36137010	.	G	A	1	3	4	0	1	5	0	0
6	36469300	.	C	T	1	3	4	0	0	4	0	0
6	36470986	.	G	T	3	2	5	0	0	5	0	0
6	36471058	.	A	C	1	2	3	0	0	3	0	0
6	36720006	.	G	A	3	3	6	0	0	6	0	0
6	36720083	.	C	T	3	5	8	1	0	9	0	0
6	36720457	.	C	T	8	7	15	0	1	16	0	0
6	36720563	.	G	T	6	6	12	0	0	12	0	0
6	36720936	.	C	T	7	9	16	0	1	17	0	0
6	36721061	.	T	A	17	14	31	0	0	31	0	0
6	36721066	.	G	T	19	16	35	0	1	36	0	0
6	36721125	.	A	T	21	18	39	0	1	40	0	0
6	36721159	.	A	T	15	21	36	0	1	37	0	0
6	36721339	.	G	T	23	21	44	0	0	44	0	0
6	36721366	.	G	A	16	27	43	0	1	44	0	0
6	36721380	.	C	G	30	15	45	0	0	45	0	0
6	36724345	.	A	G	23	17	40	1	3	44	0	0
6	36724375	.	G	A	25	18	43	1	2	46	0	0
6	36758758	.	A	G	8	17	25	0	2	27	0	0
6	36760065	.	A	C	14	1	15	0	13	28	0	0
6	36760080	.	T	A	14	9	23	0	1	24	0	0
6	36760140	.	C	T	8	10	18	0	0	18	0	0
6	36762535	.	A	G	8	8	16	0	0	16	0	0
6	36773184	.	T	C	4	5	9	0	0	9	0	0
6	36783178	.	T	C	5	2	7	0	0	7	0	0
6	36789072	.	A	G	5	3	8	0	1	9	0	0
6	36792112	.	A	G	4	6	10	0	0	10	0	0
6	36792130	.	A	T	4	3	7	0	1	8	0	0
6	36792163	.	C	G	5	6	11	0	0	11	0	0
6	36792294	.	A	G	6	6	12	0	3	15	0	0
6	36818551	.	G	A	0	2	2	0	6	8	0	0
6	36819202	.	C	G	1	2	3	0	0	3	0	0
6	36865756	.	C	T	1	2	3	0	0	3	0	0
6	36876939	.	A	G	8	1	9	0	0	9	0	0
6	36876949	.	A	G	8	3	11	0	1	12	0	0
6	36877037	.	G	C	6	4	10	0	0	10	0	0
6	36877053	.	A	G	3	3	6	0	2	8	0	0
6	36877078	.	G	A	3	3	6	0	0	6	0	0
6	36877097	.	A	T	3	3	6	0	1	7	0	0
6	36877313	.	A	G	3	0	3	0	4	7	0	0
6	36896765	.	A	G	1	5	6	0	0	6	0	0
6	36896798	.	T	C	1	9	10	0	0	10	0	0
6	37071353	.	G	A	7	8	15	0	0	15	0	0
6	37071374	.	A	G	8	9	17	0	1	18	0	0
6	37163366	.	A	T	10	5	15	0	2	17	0	0
6	37163449	.	G	A	3	6	9	0	19	28	0	0
6	37163488	.	G	A	17	8	25	0	0	25	0	0
6	37163588	.	G	T	0	11	11	0	16	27	0	0
6	37514941	.	T	A	6	2	8	0	1	9	0	0
6	38785821	.	T	C	1	7	8	0	0	8	0	0
6	38859938	.	A	G	19	8	27	0	1	28	0	0
6	39125748	.	T	C	4	2	6	0	1	7	0	0
6	39208979	.	C	T	13	3	16	0	0	16	0	0
6	39249034	.	G	A	5	2	7	0	1	8	0	0
6	39636040	.	G	T	2	0	2	1	2	5	0	0
6	39636064	.	A	C	0	3	3	1	1	5	0	0
6	40708607	.	T	A	8	3	11	0	3	14	0	0
6	40762024	.	T	C	5	2	7	0	0	7	0	0
6	41435866	.	A	G	27	11	38	0	6	44	0	0
6	41461131	.	T	G	0	2	2	0	0	2	0	0
6	42657682	.	A	C	5	2	7	0	0	7	0	0
6	46454816	.	T	A	4	4	8	0	0	8	0	0
6	47460906	.	G	A	3	4	7	0	0	7	0	0
6	47531079	.	G	A	2	2	4	0	0	4	0	0
6	48163738	.	G	T	3	3	6	0	0	6	0	0
6	48172890	.	C	T	4	8	12	0	0	12	0	0
6	48181994	.	A	C	6	11	17	0	0	17	0	0
6	48182033	.	A	G	6	0	6	0	10	16	0	0
6	48182090	.	T	A	12	6	18	0	2	20	0	0
6	48182720	.	A	G	10	0	10	0	5	15	0	0
6	48193191	.	T	C	8	7	15	0	0	15	0	0
6	48193426	.	T	C	7	9	16	0	3	19	0	0
6	48195610	.	G	C	1	3	4	0	3	7	0	0
6	48198255	.	T	A	9	10	19	0	2	21	0	0
6	48198431	.	T	C	12	14	26	0	2	28	0	0
6	48198533	.	C	G	12	12	24	0	0	24	0	0
6	48198718	.	C	A	7	8	15	0	1	16	0	0
6	48198883	.	G	A	11	3	14	0	0	14	0	0
6	48198892	.	A	T	9	6	15	0	0	15	0	0
6	48199068	.	G	A	12	12	24	0	0	24	0	0
6	49107668	.	T	C	41	13	54	0	7	61	0	0
6	49108078	.	T	C	25	9	34	0	0	34	0	0
6	49109063	.	T	C	1	0	1	0	5	6	0	0
6	49534100	.	A	G	1	3	4	0	0	4	0	0
6	49576544	.	C	T	3	2	5	0	0	5	0	0
6	49636508	.	T	A	0	19	19	0	1	20	0	0
6	50581320	.	C	G	1	8	9	0	18	27	0	0
6	50581579	.	C	T	11	3	14	0	0	14	0	0
6	50581589	.	G	A	13	5	18	0	0	18	0	0
6	50590597	.	C	T	1	11	12	0	3	15	0	0
6	50594126	.	C	T	0	3	3	0	3	6	0	0
6	50596189	.	T	C	2	0	2	0	2	4	0	0
6	50695455	.	T	C	5	0	5	0	4	9	0	0
6	50695470	.	C	T	5	4	9	0	0	9	0	0
6	50695625	.	A	G	1	4	5	0	0	5	0	0
6	50695857	.	G	A	8	6	14	0	0	14	0	0
6	50695890	.	T	C	5	0	5	0	6	11	0	0
6	50696328	.	C	T	3	3	6	0	0	6	0	0
6	50696376	.	A	G	3	2	5	0	1	6	0	0
6	50696532	.	A	T	1	2	3	0	0	3	0	0
6	50698791	.	T	C	1	4	5	0	0	5	0	0
6	50701168	.	C	T	1	2	3	0	1	4	0	0
6	50714196	.	T	G	2	2	4	0	1	5	0	0
6	50714358	.	G	C	4	5	9	0	0	9	0	0
6	50721807	.	C	T	1	2	3	0	0	3	0	0
6	50722206	.	G	A	3	2	5	0	0	5	0	0
6	51010098	.	T	A	9	3	12	0	0	12	0	0
6	51010126	.	G	A	8	6	14	0	2	16	0	0
6	51010143	.	T	A	6	9	15	0	0	15	0	0
6	51021107	.	C	T	1	8	9	0	7	16	0	0
6	51045352	.	G	C	2	4	6	1	0	7	0	0
6	51054620	.	C	T	3	3	6	0	1	7	0	0
6	51064869	.	C	T	2	3	5	0	0	5	0	0
6	51529305	.	G	C	3	3	6	0	1	7	0	0
6	51529336	.	A	G	3	6	9	0	1	10	0	0
6	51529393	.	C	T	8	8	16	0	1	17	0	0
6	51529725	.	G	A	5	6	11	0	1	12	0	0
6	51529747	.	A	C	6	4	10	0	1	11	0	0
6	51529827	.	T	C	3	2	5	0	0	5	0	0
6	51529838	.	C	T	3	2	5	0	0	5	0	0
6	51531046	.	C	A	6	3	9	0	0	9	0	0
6	51532015	.	C	T	2	6	8	0	2	10	0	0
6	51541166	.	A	C	2	3	5	0	1	6	0	0
6	51541255	.	A	T	5	2	7	0	0	7	0	0
6	51541258	.	G	A	2	5	7	0	0	7	0	0
6	51576055	.	A	T	12	6	18	0	0	18	0	0
6	51576177	.	T	G	18	18	36	0	2	38	0	0
6	51577365	.	A	T	7	7	14	0	2	16	0	0
6	51577580	.	G	T	5	2	7	0	0	7	0	0
6	51577601	.	A	T	2	2	4	0	0	4	0	0
6	51577938	.	T	A	1	6	7	0	0	7	0	0
6	51578224	.	A	G	12	9	21	0	2	23	0	0
6	51578436	.	A	C	5	6	11	0	0	11	0	0
6	51578442	.	T	G	6	4	10	0	0	11	1	0
6	51578684	.	C	T	0	7	7	0	2	9	0	0
6	51578911	.	G	A	4	2	6	3	0	9	0	0
6	51579133	.	G	A	4	8	12	0	1	13	0	0
6	51579196	.	C	A	5	3	8	0	1	9	0	0
6	51579271	.	G	A	4	2	6	0	0	6	0	0
6	51579298	.	T	C	3	2	5	0	2	7	0	0
6	51579840	.	C	T	2	4	6	0	1	7	0	0
6	51579901	.	G	A	4	2	6	0	2	8	0	0
6	51580373	.	G	A	6	5	11	0	0	11	0	0
6	51580457	.	G	A	1	7	8	0	1	9	0	0
6	51583877	.	T	C	2	2	4	0	0	4	0	0
6	51586559	.	C	T	1	4	5	0	3	8	0	0
6	51594323	.	T	C	3	1	4	0	1	5	0	0
6	51594542	.	C	T	1	4	5	0	0	5	0	0
6	51796672	.	T	C	13	3	16	0	22	38	0	0
6	51796714	.	T	A	16	22	38	0	1	39	0	0
6	51797732	.	A	G	17	19	36	0	2	38	0	0
6	51797741	.	C	T	1	21	22	0	15	37	0	0
6	51806186	.	T	A	15	12	27	0	2	29	0	0
6	51806238	.	T	G	10	15	25	0	1	26	0	0
6	51808819	.	C	T	16	10	26	0	1	27	0	0
6	51808983	.	T	G	13	12	25	0	1	26	0	0
6	51809065	.	T	A	5	13	18	0	1	19	0	0
6	51810855	.	T	G	5	2	7	0	0	7	0	0
6	51810987	.	T	G	4	7	11	0	0	11	0	0
6	51811024	.	T	C	12	5	17	0	0	17	0	0
6	51811051	.	A	T	2	7	9	0	0	9	0	0
6	52030418	.	T	A	1	2	3	0	0	3	0	0
6	52030447	.	A	G	1	2	3	0	0	3	0	0
6	52081983	.	C	A	3	2	5	0	0	5	0	0
6	52082034	.	G	A	2	4	6	0	0	6	0	0
6	52082324	.	G	A	2	1	3	0	1	4	0	0
6	52082328	.	A	T	3	2	5	0	0	5	0	0
6	52082361	.	A	T	6	2	8	0	0	8	0	0
6	52082832	.	A	G	4	2	6	0	0	6	0	0
6	52082880	.	G	A	3	2	5	0	0	5	0	0
6	52089379	.	T	C	2	0	2	0	3	5	0	0
6	52119079	.	T	C	3	0	3	0	4	7	0	0
6	52220316	.	G	A	1	25	26	0	32	58	0	0
6	52222481	.	G	T	36	38	74	0	1	75	0	0
6	52222564	.	C	T	38	34	72	0	5	77	0	0
6	52222654	.	G	A	3	41	44	0	23	67	0	0
6	52223247	.	G	A	3	27	30	0	36	66	0	0
6	52223369	.	T	C	24	30	54	0	4	58	0	0
6	52223517	.	A	C	25	11	36	0	2	38	0	0
6	52223623	.	A	G	33	14	47	0	3	50	0	0
6	52223639	.	A	G	24	17	41	0	1	42	0	0
6	52223936	.	A	G	35	6	41	0	2	44	1	0
6	52224220	.	A	G	33	13	46	0	2	48	0	0
6	52224225	.	A	G	26	20	46	0	1	47	0	0
6	52224525	.	T	C	26	27	53	0	1	54	0	0
6	52224539	.	A	T	23	26	49	0	4	55	2	0
6	52224590	.	A	G	25	24	49	1	5	55	0	0
6	52227301	.	G	A	5	6	11	0	1	12	0	0
6	52248478	.	G	A	1	5	6	0	7	13	0	0
6	52249075	.	C	A	6	5	11	0	0	11	0	0
6	52253763	.	T	A	3	3	6	0	0	6	0	0
6	52253894	.	G	A	1	5	6	0	1	7	0	0
6	52326528	.	C	A	1	2	3	0	0	3	0	0
6	52326955	.	A	G	2	2	4	0	0	4	0	0
6	52339847	.	T	C	19	0	19	0	11	30	0	0
6	52341721	.	G	A	16	9	25	0	2	27	0	0
6	52341742	.	A	G	13	6	19	0	1	20	0	0
6	52352296	.	T	C	3	3	6	0	0	6	0	0
6	52352301	.	G	C	3	3	6	0	0	6	0	0
6	52352544	.	A	T	2	2	4	0	0	4	0	0
6	52352570	.	T	C	2	4	6	0	0	6	0	0
6	52352743	.	A	G	3	4	7	0	1	8	0	0
6	52352758	.	G	A	5	4	9	0	1	10	0	0
6	52352788	.	C	G	2	4	6	0	1	7	0	0
6	52352802	.	T	C	3	3	6	0	1	7	0	0
6	52353064	.	G	A	8	5	13	0	0	13	0	0
6	52353074	.	T	A	9	5	14	0	0	14	0	0
6	52353105	.	G	C	0	3	3	0	4	7	0	0
6	52353112	.	C	T	3	3	6	0	1	7	0	0
6	52353345	.	T	C	4	4	8	0	0	8	0	0
6	52353357	.	C	G	3	3	6	0	1	7	0	0
6	52353497	.	T	C	5	2	7	0	0	7	0	0
6	52353505	.	A	G	4	2	6	0	0	6	0	0
6	52353826	.	G	A	3	3	6	0	0	6	0	0
6	52353827	.	T	G	3	3	6	0	0	6	0	0
6	52354259	.	A	T	8	7	15	0	0	15	0	0
6	52354307	.	A	G	9	0	9	0	3	12	0	0
6	52354783	.	T	C	6	11	17	1	1	19	0	0
6	52354830	.	G	A	10	9	19	0	0	19	0	0
6	52354892	.	A	T	6	5	11	0	0	11	0	0
6	52354909	.	A	G	4	3	7	0	1	8	0	0
6	52354939	.	G	A	1	5	6	0	0	6	0	0
6	52354953	.	T	C	0	5	5	0	0	5	0	0
6	52355025	.	G	C	1	2	3	0	0	3	0	0
6	52362498	.	C	T	0	3	3	2	2	7	0	0
6	52362623	.	A	C	7	0	7	0	6	13	0	0
6	52372698	.	C	T	1	4	5	0	0	5	0	0
6	52521891	.	T	G	18	15	33	0	1	34	0	0
6	52533195	.	G	A	10	15	25	0	0	25	0	0
6	52533228	.	G	A	19	8	27	0	0	27	0	0
6	52536386	.	C	T	0	11	11	0	10	21	0	0
6	52552993	.	G	A	12	10	22	0	0	22	0	0
6	52563953	.	A	C	5	5	10	0	0	10	0	0
6	52566456	.	C	G	2	2	4	0	0	4	0	0
6	52663447	.	A	C	10	4	14	0	3	17	0	0
6	52663586	.	C	A	2	2	4	0	0	4	0	0
6	52715746	.	C	A	2	2	4	0	0	4	0	0
6	52715879	.	G	T	13	6	19	0	2	21	0	0
6	52715946	.	C	T	9	8	17	0	0	17	0	0
6	52715957	.	G	A	7	7	14	0	0	14	0	0
6	52716053	.	T	C	8	6	14	0	0	14	0	0
6	52716311	.	C	T	10	12	22	0	3	25	0	0
6	52716325	.	G	A	14	11	25	0	0	25	0	0
6	52716630	.	G	A	13	10	23	0	1	24	0	0
6	52716714	.	G	T	12	13	25	0	3	28	0	0
6	52716795	.	G	T	16	13	29	0	1	30	0	0
6	52720695	.	G	A	11	9	20	0	0	20	0	0
6	52720727	.	T	G	8	12	20	0	0	20	0	0
6	52830485	.	T	C	2	4	6	0	0	6	0	0
6	52840313	.	G	A	2	7	9	0	6	15	0	0
6	52845491	.	G	A	8	7	15	0	0	15	0	0
6	52845670	.	T	G	4	5	9	2	0	11	0	0
6	52845936	.	A	G	8	3	11	0	0	11	0	0
6	53050515	.	T	A	19	32	51	0	2	53	0	0
6	53050761	.	C	T	20	16	36	0	1	37	0	0
6	53050805	.	C	T	24	15	39	0	1	40	0	0
6	53055338	.	T	C	21	0	21	0	27	48	0	0
6	53065954	.	G	A	12	4	16	0	0	16	0	0
6	53143647	.	C	A	1	11	12	0	12	24	0	0
6	53264365	.	T	A	26	27	53	0	9	62	0	0
6	53264383	.	C	T	33	31	64	0	1	65	0	0
6	53271887	.	T	C	36	27	63	0	0	63	0	0
6	53272169	.	G	A	33	20	53	0	3	56	0	0
6	53272637	.	G	C	18	19	37	0	3	40	0	0
6	53273943	.	A	G	19	22	41	1	5	47	0	0
6	53273979	.	A	G	24	28	52	0	3	55	0	0
6	53305633	.	T	C	26	24	50	0	4	54	0	0
6	53305888	.	T	C	24	23	47	2	5	54	0	0
6	53305968	.	C	G	4	13	17	5	2	24	0	0
6	53306034	.	A	T	11	18	29	2	4	35	0	0
6	53306806	.	G	T	24	6	30	1	3	34	0	0
6	53306847	.	G	T	18	9	27	0	4	31	0	0
6	53306886	.	C	A	16	12	28	0	1	29	0	0
6	53326383	.	G	C	12	13	25	0	4	29	0	0
6	53334014	.	A	G	10	10	20	0	0	20	0	0
6	53334082	.	T	G	8	11	19	0	3	22	0	0
6	54078834	.	C	T	5	4	9	0	1	10	0	0
6	54079171	.	T	G	5	3	8	0	0	8	0	0
6	54079342	.	A	T	1	2	3	0	0	3	0	0
6	54079437	.	C	A	1	2	3	0	0	4	1	0
6	54079807	.	G	A	6	3	9	0	1	10	0	0
6	54079816	.	A	C	6	3	9	0	2	11	0	0
6	54120966	.	G	C	7	13	20	0	1	21	0	0
6	54142313	.	G	A	5	3	8	0	1	9	0	0
6	54150332	.	C	T	4	3	7	0	0	7	0	0
6	54150488	.	T	C	7	9	16	0	0	16	0	0
6	54150730	.	G	A	2	14	16	0	4	21	1	0
6	54150826	.	A	T	9	16	25	0	1	26	0	0
6	54151027	.	A	G	23	1	24	0	9	33	0	0
6	54151132	.	A	G	18	14	32	0	2	34	0	0
6	54151210	.	C	T	19	14	33	0	1	34	0	0
6	54151318	.	G	C	9	10	19	0	3	22	0	0
6	54151408	.	T	G	22	10	32	0	2	34	0	0
6	54151554	.	G	A	1	7	8	1	10	19	0	0
6	54151615	.	C	G	13	8	21	1	0	22	0	0
6	54151674	.	G	T	19	10	29	0	0	29	0	0
6	54151798	.	A	C	27	12	39	1	0	40	0	0
6	54151951	.	T	C	16	12	28	0	0	28	0	0
6	54151963	.	T	C	18	10	28	0	1	29	0	0
6	54152151	.	T	A	25	8	33	6	1	40	0	0
6	54164974	.	A	T	1	4	5	0	0	5	0	0
6	54177352	.	A	T	40	26	66	0	3	69	0	0
6	54177478	.	A	G	38	30	68	2	5	75	0	0
6	54179724	.	C	G	35	32	67	0	4	71	0	0
6	54179733	.	G	A	34	32	66	0	1	67	0	0
6	54262298	.	C	T	1	6	7	0	0	7	0	0
6	54266317	.	T	C	13	7	20	0	1	21	0	0
6	54270266	.	C	T	5	12	17	0	2	19	0	0
6	54270296	.	G	A	13	8	21	0	0	21	0	0
6	54270561	.	T	A	9	10	19	0	2	21	0	0
6	54270680	.	G	T	15	10	25	0	0	25	0	0
6	54270760	.	C	T	12	10	22	0	2	24	0	0
6	54270951	.	T	G	4	10	14	0	0	14	0	0
6	54271007	.	C	T	1	4	5	0	1	6	0	0
6	54271196	.	A	T	3	5	8	0	1	9	0	0
6	54325368	.	A	G	3	4	7	0	0	7	0	0
6	54325487	.	A	G	3	5	8	0	0	8	0	0
6	54325658	.	C	A	8	5	13	0	1	14	0	0
6	54326008	.	T	C	5	4	9	0	0	9	0	0
6	54337547	.	G	A	9	9	18	0	1	19	0	0
6	54337568	.	G	A	8	6	14	0	0	14	0	0
6	54703322	.	T	A	1	3	4	0	1	5	0	0
6	55217796	.	A	G	7	5	12	0	1	13	0	0
6	55217884	.	A	G	4	3	7	0	0	7	0	0
6	55217891	.	A	G	3	5	8	0	1	9	0	0
6	55218047	.	A	G	5	9	14	0	0	14	0	0
6	55218127	.	A	G	6	8	14	0	1	15	0	0
6	57480488	.	A	G	2	2	4	0	1	5	0	0
6	57630950	.	T	C	9	1	10	0	1	11	0	0
6	58562407	.	T	A	2	17	19	4	2	25	0	0
6	58562436	.	T	A	7	8	15	11	2	28	0	0
6	58828036	.	A	G	1	7	8	0	0	8	0	0
6	58867240	.	A	G	15	8	23	0	0	23	0	0
6	59350762	.	T	C	9	0	9	0	5	14	0	0
6	59350764	.	T	C	4	0	4	0	8	12	0	0
6	59883365	.	A	C	6	2	8	0	12	20	0	0
6	59971580	.	A	G	42	11	53	0	0	53	0	0
6	59971598	.	A	G	39	15	54	0	0	54	0	0
7	622641	.	A	C	7	0	7	0	15	22	0	0
7	622648	.	A	C	4	0	4	0	13	17	0	0
7	742828	.	T	C	8	24	32	0	4	36	0	0
7	762326	.	G	A	4	3	7	0	0	7	0	0
7	847189	.	A	T	6	5	11	0	0	11	0	0
7	1521882	.	C	T	2	7	9	4	1	14	0	0
7	1526439	.	A	G	1	12	13	0	2	15	0	0
7	1527081	.	A	G	22	8	30	0	1	31	0	0
7	1541117	.	G	T	1	3	4	1	1	6	0	0
7	1588610	.	C	T	4	4	8	1	0	9	0	0
7	1594408	.	C	T	1	5	6	0	1	7	0	0
7	1594606	.	C	A	7	12	19	0	0	19	0	0
7	1600153	.	C	T	12	7	19	0	0	19	0	0
7	1600263	.	A	T	11	6	17	0	0	17	0	0
7	1603053	.	G	T	0	7	7	0	5	12	0	0
7	1606334	.	C	T	16	9	25	0	1	26	0	0
7	1609555	.	C	T	13	8	21	0	0	21	0	0
7	1613117	.	T	C	18	14	32	0	1	33	0	0
7	1613131	.	A	G	16	10	26	0	4	30	0	0
7	1613230	.	T	G	15	15	30	0	3	33	0	0
7	1615439	.	C	T	19	21	40	0	4	44	0	0
7	1617209	.	T	A	39	13	52	0	2	54	0	0
7	1617218	.	T	C	37	7	44	0	4	48	0	0
7	1617433	.	A	C	34	22	56	0	2	58	0	0
7	1618863	.	T	C	22	12	34	0	3	37	0	0
7	1618865	.	G	A	16	17	33	0	4	37	0	0
7	1619124	.	A	T	8	4	12	0	2	14	0	0
7	1620108	.	A	C	1	4	5	0	0	5	0	0
7	1620135	.	G	A	0	4	4	0	1	5	0	0
7	3931029	.	A	G	31	21	52	0	3	55	0	0
7	3931264	.	C	T	24	30	54	1	4	59	0	0
7	3931396	.	A	T	27	28	55	0	3	58	0	0
7	3931543	.	A	T	29	32	61	0	0	61	0	0
7	3931598	.	G	T	37	20	57	0	1	58	0	0
7	3932209	.	A	T	22	23	45	0	0	46	1	0
7	3932402	.	T	C	9	18	27	0	2	29	0	0
7	3932405	.	A	T	11	18	29	0	1	30	0	0
7	3932463	.	T	G	9	9	18	1	5	24	0	0
7	3932523	.	T	C	10	3	13	1	0	14	0	0
7	3932546	.	C	A	5	2	7	0	1	8	0	0
7	3932694	.	G	A	27	9	36	0	1	37	0	0
7	3932698	.	T	C	28	10	38	0	2	40	0	0
7	3932731	.	C	A	30	12	42	0	2	44	0	0
7	3932870	.	T	C	4	10	14	0	4	18	0	0
7	3932935	.	C	A	19	11	30	0	3	33	0	0
7	3933121	.	G	A	24	24	48	0	1	49	0	0
7	3933243	.	C	A	22	14	36	0	1	37	0	0
7	3933271	.	C	T	28	16	44	0	0	44	0	0
7	3933383	.	A	C	12	0	12	0	17	29	0	0
7	3933481	.	T	C	21	0	21	0	13	34	0	0
7	3933483	.	C	T	1	12	13	0	21	34	0	0
7	3933998	.	C	T	18	10	28	0	1	29	0	0
7	3934038	.	A	T	10	15	25	0	0	25	0	0
7	3934208	.	T	C	21	3	24	0	4	28	0	0
7	3934387	.	C	T	16	11	27	0	0	27	0	0
7	3934428	.	G	T	15	17	32	0	1	33	0	0
7	3934551	.	A	T	10	7	17	1	1	19	0	0
7	3934645	.	A	C	7	8	15	0	1	16	0	0
7	3934818	.	G	A	15	4	19	0	0	19	0	0
7	3934970	.	A	G	6	5	11	0	1	12	0	0
7	3935055	.	T	C	11	9	20	0	1	21	0	0
7	3935123	.	A	G	10	11	21	0	1	22	0	0
7	3935171	.	G	C	11	7	18	0	3	21	0	0
7	3935283	.	G	A	10	8	18	0	2	20	0	0
7	3935737	.	C	T	1	18	19	0	11	30	0	0
7	3935788	.	C	A	14	4	18	0	0	18	0	0
7	3936127	.	C	T	0	16	16	1	9	26	0	0
7	3936155	.	A	T	0	13	13	1	1	16	1	0
7	3936702	.	A	G	1	2	3	0	0	3	0	0
7	3936764	.	G	A	3	8	11	0	1	12	0	0
7	3936946	.	C	T	0	5	5	0	9	14	0	0
7	3951010	.	C	T	0	9	9	0	4	13	0	0
7	3951115	.	G	A	9	4	13	0	0	13	0	0
7	3952993	.	A	G	1	5	6	0	1	7	0	0
7	4088334	.	C	T	16	20	36	0	1	37	0	0
7	4088545	.	C	T	1	23	24	0	10	34	0	0
7	4088680	.	G	A	10	19	29	0	0	29	0	0
7	4088727	.	A	T	24	21	45	0	1	46	0	0
7	4088832	.	A	G	11	31	42	0	2	44	0	0
7	4089042	.	A	G	21	14	35	0	1	36	0	0
7	4089090	.	G	A	14	7	21	0	2	23	0	0
7	4095265	.	C	T	2	25	27	0	20	47	0	0
7	4100931	.	C	T	12	17	29	0	3	32	0	0
7	4100967	.	G	A	13	19	32	1	1	34	0	0
7	4110441	.	T	C	6	0	6	0	6	12	0	0
7	4181192	.	G	A	1	3	4	0	0	4	0	0
7	4181728	.	G	A	1	6	7	1	0	8	0	0
7	4183159	.	G	T	1	2	3	0	0	3	0	0
7	4183572	.	C	T	2	1	3	0	1	4	0	0
7	4183575	.	G	A	2	2	4	0	0	4	0	0
7	4184897	.	G	T	5	6	11	0	2	13	0	0
7	4185439	.	C	T	4	8	12	1	0	13	0	0
7	4185569	.	A	G	3	4	7	0	1	8	0	0
7	4186499	.	A	G	4	6	10	2	0	12	0	0
7	4186532	.	G	A	2	4	6	2	3	11	0	0
7	4186553	.	T	C	5	4	9	1	0	10	0	0
7	4186611	.	A	G	8	7	15	0	1	16	0	0
7	4186629	.	C	T	7	8	15	0	1	16	0	0
7	5448431	.	C	T	0	5	5	0	1	6	0	0
7	5448443	.	C	T	0	4	4	0	0	4	0	0
7	5520617	.	A	G	4	2	6	0	0	6	0	0
7	7002248	.	C	T	1	2	3	0	1	4	0	0
7	7011428	.	A	C	4	3	7	0	0	7	0	0
7	7035949	.	G	A	0	3	3	6	1	10	0	0
7	7036270	.	G	A	0	2	2	0	1	3	0	0
7	7038426	.	C	T	4	4	8	1	0	9	0	0
7	7038541	.	G	A	8	4	12	1	1	14	0	0
7	7039051	.	A	G	1	1	2	0	0	2	0	0
7	7039056	.	A	G	1	2	3	0	0	3	0	0
7	7039207	.	A	G	3	2	5	3	1	9	0	0
7	7039446	.	T	A	6	10	16	5	1	22	0	0
7	7039475	.	C	G	10	11	21	0	1	22	0	0
7	7040932	.	A	G	9	4	13	0	0	13	0	0
7	7042160	.	A	G	14	9	23	6	2	31	0	0
7	7042506	.	C	T	5	4	9	24	0	33	0	0
7	7042604	.	C	T	25	23	48	1	4	53	0	0
7	7042626	.	T	G	29	17	46	5	2	53	0	0
7	7248193	.	C	T	10	9	19	0	3	22	0	0
7	7248212	.	A	T	5	5	10	0	7	17	0	0
7	7248292	.	T	C	6	12	18	0	1	19	0	0
7	7248293	.	A	G	10	0	10	0	11	21	0	0
7	7248813	.	G	C	3	2	5	0	0	5	0	0
7	7248819	.	C	A	2	2	4	0	0	4	0	0
7	7248862	.	A	G	3	3	6	0	0	6	0	0
7	7249515	.	T	A	10	10	20	0	0	20	0	0
7	7279927	.	A	T	1	2	3	0	0	3	0	0
7	7279940	.	G	C	2	3	5	0	0	5	0	0
7	7361863	.	G	A	3	2	5	0	1	6	0	0
7	7364417	.	T	C	4	2	6	0	0	6	0	0
7	7365433	.	A	G	1	0	1	0	6	7	0	0
7	7367315	.	T	A	3	4	7	1	0	8	0	0
7	7367690	.	A	G	1	0	1	0	8	9	0	0
7	7368148	.	T	C	2	12	14	0	1	15	0	0
7	7368187	.	A	G	4	7	11	0	3	14	0	0
7	7368199	.	C	T	3	8	11	0	0	11	0	0
7	7368744	.	A	G	1	6	7	0	0	7	0	0
7	7368834	.	G	T	6	5	11	0	0	11	0	0
7	7368869	.	T	C	4	4	8	0	1	9	0	0
7	7368972	.	T	A	2	11	13	0	2	15	0	0
7	7369000	.	G	T	1	7	8	0	3	11	0	0
7	7369040	.	G	A	0	6	6	0	5	11	0	0
7	7369404	.	C	T	6	4	10	0	0	10	0	0
7	7369729	.	T	A	5	9	14	0	0	14	0	0
7	7369768	.	G	A	1	6	7	0	14	21	0	0
7	7370412	.	C	A	6	3	9	0	0	9	0	0
7	7371062	.	C	T	3	4	7	0	0	7	0	0
7	7371088	.	A	G	3	3	6	0	0	6	0	0
7	7371116	.	G	C	5	3	8	0	0	8	0	0
7	7371137	.	A	G	2	0	2	0	7	9	0	0
7	7372404	.	A	G	20	11	31	5	2	38	0	0
7	7372694	.	A	G	14	18	32	0	1	33	0	0
7	7372772	.	A	G	10	0	10	0	16	26	0	0
7	7372892	.	A	G	14	13	27	0	0	27	0	0
7	7466164	.	T	A	2	2	4	0	2	6	0	0
7	7466227	.	A	T	5	4	9	0	0	9	0	0
7	7466495	.	A	G	12	7	19	0	0	19	0	0
7	7466603	.	C	T	2	8	10	0	10	20	0	0
7	7466706	.	A	G	10	10	20	0	1	21	0	0
7	7466827	.	A	T	3	6	9	0	0	9	0	0
7	7466910	.	A	G	2	2	4	0	0	4	0	0
7	7467303	.	A	T	8	5	13	0	0	13	0	0
7	7467308	.	C	T	7	6	13	0	1	14	0	0
7	7467376	.	A	G	9	14	23	0	0	23	0	0
7	7467386	.	G	A	8	12	20	0	1	21	0	0
7	7467413	.	G	A	8	7	15	0	0	15	0	0
7	7467424	.	G	A	7	3	10	0	1	11	0	0
7	7467476	.	T	C	5	2	7	0	0	7	0	0
7	7467509	.	C	A	6	3	9	0	0	9	0	0
7	7467568	.	T	A	2	2	4	0	0	4	0	0
7	7467906	.	T	A	7	7	14	0	0	14	0	0
7	7468719	.	C	T	1	3	4	0	0	4	0	0
7	7468721	.	T	C	1	0	1	0	3	4	0	0
7	7468854	.	T	C	1	0	1	0	3	4	0	0
7	7473408	.	A	G	1	3	4	0	0	4	0	0
7	7473427	.	A	C	1	0	1	0	3	4	0	0
7	7473634	.	G	T	2	2	4	0	0	4	0	0
7	7474069	.	A	G	3	2	5	0	0	5	0	0
7	7474078	.	C	A	2	2	4	0	1	5	0	0
7	7477411	.	T	C	4	2	6	0	1	7	0	0
7	7477594	.	A	T	11	8	19	0	2	21	0	0
7	7478105	.	A	G	9	11	20	0	0	20	0	0
7	7478137	.	A	G	10	5	15	0	0	15	0	0
7	7478308	.	G	T	6	4	10	0	2	12	0	0
7	7478370	.	C	G	1	7	8	1	8	17	0	0
7	7478393	.	A	T	8	3	11	1	0	12	0	0
7	7478506	.	G	T	8	5	13	0	2	15	0	0
7	7478654	.	T	C	11	8	19	0	0	19	0	0
7	7478717	.	T	G	14	11	25	0	1	26	0	0
7	7478806	.	G	A	8	17	25	0	0	25	0	0
7	7482475	.	G	A	8	13	21	0	1	22	0	0
7	7552113	.	G	A	1	7	8	0	0	8	0	0
7	7597059	.	A	G	3	0	3	0	6	9	0	0
7	7608920	.	G	A	0	5	5	0	5	10	0	0
7	7608965	.	C	T	4	6	10	0	0	10	0	0
7	7611758	.	C	T	8	6	14	0	3	17	0	0
7	7611830	.	C	A	3	2	5	0	2	7	0	0
7	7617861	.	G	A	1	13	14	0	21	35	0	0
7	7624082	.	A	G	14	16	30	0	7	37	0	0
7	7634813	.	C	T	2	4	6	0	0	6	0	0
7	7641230	.	A	T	14	22	36	0	3	39	0	0
7	7641240	.	T	G	19	20	39	0	2	41	0	0
7	7641351	.	G	A	17	20	37	0	0	37	0	0
7	7641353	.	G	A	16	21	37	0	1	38	0	0
7	7641481	.	C	T	17	16	33	0	0	33	0	0
7	7641504	.	G	A	2	14	16	0	16	32	0	0
7	7641678	.	T	A	4	17	21	0	3	24	0	0
7	7641765	.	T	C	11	9	20	0	2	22	0	0
7	7641856	.	C	A	7	10	17	1	0	18	0	0
7	7641876	.	T	C	17	5	22	2	2	26	0	0
7	7642019	.	C	T	2	4	6	0	1	7	0	0
7	7642554	.	T	A	23	19	42	0	0	42	0	0
7	7642578	.	A	G	17	0	17	0	20	37	0	0
7	7642787	.	A	T	14	14	28	0	4	32	0	0
7	7643277	.	T	C	21	20	41	0	4	45	0	0
7	7643313	.	T	C	20	30	50	0	2	52	0	0
7	7643488	.	A	G	24	29	53	0	1	54	0	0
7	7643676	.	G	A	2	23	25	0	29	54	0	0
7	7643711	.	C	A	18	19	37	0	3	40	0	0
7	7643712	.	T	C	18	21	39	0	1	40	0	0
7	7643867	.	C	T	7	4	11	0	0	11	0	0
7	7662467	.	C	G	12	9	21	0	1	22	0	0
7	7662825	.	A	C	11	0	11	0	11	22	0	0
7	7663132	.	A	G	14	14	28	1	1	30	0	0
7	7663453	.	A	T	13	10	23	0	0	23	0	0
7	7663682	.	C	T	1	11	12	0	7	19	0	0
7	7663902	.	G	T	4	7	11	0	0	11	0	0
7	7664473	.	C	T	1	4	5	0	2	7	0	0
7	7664535	.	T	A	4	6	10	1	0	11	0	0
7	7664708	.	T	A	14	11	25	0	0	25	0	0
7	7664760	.	G	T	20	11	31	0	1	32	0	0
7	7664815	.	C	A	6	12	18	0	1	19	0	0
7	7664838	.	G	T	11	4	15	0	0	15	0	0
7	7664870	.	G	T	5	2	7	0	0	7	0	0
7	7664882	.	G	C	3	2	5	0	2	7	0	0
7	7664912	.	A	C	3	2	5	0	1	6	0	0
7	7665480	.	A	C	11	4	15	0	0	15	0	0
7	7665559	.	T	A	7	7	14	0	0	14	0	0
7	7666388	.	G	A	6	9	15	0	1	16	0	0
7	7674220	.	C	G	2	1	3	0	0	3	0	0
7	7674230	.	G	A	3	2	5	0	0	5	0	0
7	7674378	.	T	C	4	0	4	0	5	9	0	0
7	7674462	.	C	G	8	6	14	0	0	14	0	0
7	7674474	.	T	A	6	5	11	0	2	13	0	0
7	7676112	.	C	T	1	2	3	0	0	3	0	0
7	7696726	.	G	C	1	4	5	0	1	6	0	0
7	7696742	.	A	G	1	6	7	0	0	7	0	0
7	7696785	.	T	A	2	3	5	0	0	5	0	0
7	7696794	.	G	T	0	2	2	0	1	3	0	0
7	7696875	.	C	A	6	2	8	0	1	9	0	0
7	7700965	.	T	G	5	0	5	0	6	11	0	0
7	7705993	.	C	G	6	0	6	0	10	16	0	0
7	7706005	.	C	T	9	10	19	0	0	19	0	0
7	7706950	.	A	G	8	5	13	0	1	14	0	0
7	7707029	.	T	G	4	7	11	0	1	12	0	0
7	7707191	.	A	C	4	5	9	0	0	9	0	0
7	7708572	.	T	C	6	6	12	0	2	14	0	0
7	7708666	.	A	C	3	4	7	0	3	10	0	0
7	7708826	.	T	G	4	6	10	0	0	10	0	0
7	7708872	.	T	C	3	3	6	0	0	6	0	0
7	7708873	.	A	G	3	0	3	0	3	6	0	0
7	7708944	.	T	A	1	6	7	0	1	8	0	0
7	7708972	.	A	C	2	6	8	0	2	10	0	0
7	7709053	.	C	T	4	3	7	0	0	7	0	0
7	7709236	.	C	T	1	4	5	0	1	6	0	0
7	7709243	.	A	T	2	3	5	0	0	5	0	0
7	7709446	.	T	G	5	4	9	0	0	9	0	0
7	7709835	.	T	C	1	2	3	0	0	3	0	0
7	7797397	.	T	G	1	3	4	0	1	5	0	0
7	8890460	.	T	A	4	4	8	0	0	8	0	0
7	8890495	.	C	T	1	7	8	0	6	14	0	0
7	8890884	.	A	G	23	20	43	0	1	44	0	0
7	8890903	.	G	A	23	18	41	0	4	45	0	0
7	8890983	.	C	A	2	16	18	0	11	29	0	0
7	8891057	.	A	T	16	16	32	0	0	32	0	0
7	8891062	.	G	T	15	15	30	0	0	30	0	0
7	8891236	.	C	G	13	7	20	0	1	21	0	0
7	8891710	.	A	G	7	10	17	0	1	18	0	0
7	8891717	.	A	G	9	8	17	0	3	20	0	0
7	8891755	.	T	G	13	5	18	0	1	19	0	0
7	8891980	.	C	T	4	3	7	0	0	7	0	0
7	8894919	.	C	T	0	2	2	0	1	3	0	0
7	9229327	.	A	C	2	4	6	0	0	6	0	0
7	9302796	.	A	G	11	9	20	0	1	21	0	0
7	9302841	.	A	G	14	13	27	0	1	28	0	0
7	9322216	.	A	G	17	9	26	0	1	27	0	0
7	10551629	.	A	G	2	2	4	0	1	5	0	0
7	10551638	.	G	A	2	3	5	0	0	5	0	0
7	10560861	.	G	A	2	2	4	0	1	5	0	0
7	10578316	.	G	T	6	3	9	0	0	9	0	0
7	10582510	.	T	C	4	7	11	0	1	12	0	0
7	10582851	.	T	C	1	7	8	0	0	8	0	0
7	10701814	.	C	A	2	4	6	0	0	6	0	0
7	10701966	.	A	T	6	7	13	0	0	13	0	0
7	10725106	.	A	T	2	3	5	0	0	5	0	0
7	10800689	.	G	A	4	6	10	0	1	11	0	0
7	10820643	.	T	C	2	4	6	0	0	6	0	0
7	10845526	.	T	C	3	7	10	1	1	12	0	0
7	10845567	.	G	C	4	6	10	1	1	12	0	0
7	10854748	.	G	A	10	9	19	0	3	22	0	0
7	10873382	.	G	T	8	9	17	0	0	17	0	0
7	10873415	.	G	A	8	5	13	0	0	13	0	0
7	10873567	.	C	T	10	7	17	0	0	17	0	0
7	10874008	.	G	A	6	4	10	1	1	12	0	0
7	10874010	.	T	C	6	4	10	1	1	12	0	0
7	10874141	.	A	T	5	8	13	0	0	13	0	0
7	10874231	.	T	C	11	10	21	0	1	22	0	0
7	10874252	.	A	C	14	12	26	0	0	26	0	0
7	10874377	.	A	T	8	11	19	0	0	19	0	0
7	10874424	.	T	C	11	12	23	0	0	23	0	0
7	10874548	.	T	A	5	5	10	0	0	10	0	0
7	10874753	.	T	C	10	9	19	0	1	20	0	0
7	10874761	.	A	T	9	7	16	0	1	17	0	0
7	10874837	.	T	A	11	11	22	0	0	22	0	0
7	10874857	.	G	C	10	12	22	0	1	23	0	0
7	10874878	.	A	G	11	16	27	0	1	28	0	0
7	10874949	.	A	G	4	1	5	0	26	31	0	0
7	10875246	.	A	T	14	13	27	0	0	27	0	0
7	10875386	.	A	G	14	10	24	0	2	26	0	0
7	10875489	.	C	T	6	8	14	0	3	17	0	0
7	10875539	.	A	G	7	15	22	0	2	24	0	0
7	10875552	.	A	G	14	5	19	0	4	23	0	0
7	10875626	.	A	G	19	0	19	0	21	40	0	0
7	10875627	.	T	C	16	23	39	0	0	39	0	0
7	10875661	.	A	G	33	7	40	0	0	40	0	0
7	10875692	.	G	C	2	25	27	0	22	49	0	0
7	10875761	.	A	G	27	6	33	0	1	34	0	0
7	10875816	.	T	G	17	1	18	0	14	32	0	0
7	10875870	.	G	A	1	9	10	0	13	23	0	0
7	10875898	.	C	T	13	10	23	0	2	25	0	0
7	10875937	.	A	G	13	7	20	0	2	22	0	0
7	10875959	.	T	A	12	13	25	0	3	29	1	0
7	10875992	.	G	A	14	18	32	0	1	33	0	0
7	10876464	.	A	G	21	12	33	0	1	34	0	0
7	10876503	.	C	A	23	22	45	0	0	45	0	0
7	10876643	.	A	G	46	21	67	0	5	72	0	0
7	10876719	.	T	C	20	23	43	0	5	48	0	0
7	10876726	.	T	C	22	26	48	0	1	49	0	0
7	10876870	.	A	G	52	0	52	1	1	54	0	0
7	10876890	.	A	T	29	17	46	0	4	50	0	0
7	10876997	.	A	G	22	1	23	0	31	54	0	0
7	10877036	.	A	C	27	10	37	0	0	37	0	0
7	10877229	.	A	G	34	18	52	0	1	53	0	0
7	10877337	.	C	T	16	13	29	0	3	32	0	0
7	10911431	.	A	G	3	5	8	0	1	9	0	0
7	10911934	.	C	G	2	5	7	0	1	8	0	0
7	10912108	.	T	C	2	3	5	0	0	5	0	0
7	11004175	.	T	C	14	13	27	0	1	28	0	0
7	11004374	.	G	T	3	5	8	0	1	9	0	0
7	11004405	.	C	T	3	4	7	0	2	9	0	0
7	11004820	.	A	G	9	7	16	0	0	16	0	0
7	11004869	.	C	G	0	9	9	0	1	10	0	0
7	11004885	.	T	C	6	12	18	0	1	19	0	0
7	11005098	.	A	C	3	9	12	0	4	16	0	0
7	11005270	.	G	A	3	9	12	0	5	17	0	0
7	11005603	.	G	A	5	7	12	0	0	12	0	0
7	11318875	.	G	A	4	4	8	0	0	8	0	0
7	11323296	.	C	G	3	1	4	0	6	10	0	0
7	11332095	.	T	G	3	0	3	0	5	8	0	0
7	11339674	.	G	A	10	8	18	0	1	19	0	0
7	11340098	.	G	A	3	4	7	0	1	8	0	0
7	11340720	.	T	C	5	6	11	0	0	11	0	0
7	11341012	.	A	G	6	0	6	0	5	11	0	0
7	11341038	.	A	G	7	4	11	0	0	11	0	0
7	11341472	.	T	G	7	7	14	0	0	14	0	0
7	11341521	.	T	C	10	9	19	0	1	20	0	0
7	11341809	.	T	C	8	5	13	0	2	15	0	0
7	11341815	.	T	A	8	7	15	0	0	15	0	0
7	11341951	.	A	C	2	4	6	0	0	6	0	0
7	11341952	.	T	A	2	4	6	0	0	6	0	0
7	11342252	.	G	T	16	6	22	1	0	23	0	0
7	11378794	.	T	C	1	3	4	0	0	4	0	0
7	11378961	.	A	T	16	12	28	0	0	28	0	0
7	11379135	.	T	C	11	5	16	0	1	17	0	0
7	11384178	.	A	G	12	7	19	0	0	19	0	0
7	11581860	.	A	T	2	3	5	0	0	5	0	0
7	11582869	.	G	C	0	2	2	0	1	3	0	0
7	11582897	.	T	C	2	2	4	0	0	4	0	0
7	11587724	.	A	T	3	2	5	0	0	5	0	0
7	12062314	.	C	T	10	18	28	0	0	28	0	0
7	12062340	.	A	G	14	21	35	0	1	36	0	0
7	12063789	.	G	A	4	7	11	0	0	11	0	0
7	12064002	.	A	G	16	14	30	0	3	33	0	0
7	12065319	.	A	T	9	10	19	0	1	20	0	0
7	12141093	.	A	C	1	2	3	0	0	3	0	0
7	12141188	.	T	C	2	4	6	0	1	7	0	0
7	12141254	.	C	A	2	3	5	0	0	5	0	0
7	12141333	.	G	A	3	3	6	0	0	6	0	0
7	12141334	.	G	A	3	3	6	0	0	6	0	0
7	12141390	.	T	C	1	0	1	0	3	4	0	0
7	12141420	.	T	C	5	3	8	0	0	8	0	0
7	12141496	.	C	A	3	5	8	0	1	9	0	0
7	12141743	.	T	C	2	2	4	0	0	4	0	0
7	12142025	.	C	T	2	2	4	0	0	4	0	0
7	12142037	.	T	C	1	0	1	0	3	4	0	0
7	12142205	.	T	G	1	2	3	0	0	3	0	0
7	12143385	.	A	G	2	2	4	0	0	4	0	0
7	12143391	.	T	C	2	0	2	0	2	4	0	0
7	12390138	.	T	G	2	2	4	0	0	4	0	0
7	12390365	.	A	T	4	3	7	0	0	7	0	0
7	12844513	.	T	C	3	3	6	0	0	6	0	0
7	13571157	.	C	T	2	2	4	7	0	11	0	0
7	13616859	.	A	C	3	4	7	0	1	8	0	0
7	13616860	.	C	T	5	3	8	0	0	8	0	0
7	13618289	.	A	G	3	3	6	0	0	6	0	0
7	13618290	.	A	G	2	4	6	0	0	6	0	0
7	13678433	.	T	A	4	12	16	0	1	17	0	0
7	13868327	.	A	G	1	2	3	0	0	3	0	0
7	13897395	.	T	C	1	2	3	0	0	3	0	0
7	13897711	.	T	C	1	5	6	0	0	6	0	0
7	13897765	.	A	C	8	8	16	0	1	17	0	0
7	13897768	.	A	C	8	0	8	0	9	17	0	0
7	13897822	.	G	A	5	4	9	0	0	9	0	0
7	13900898	.	A	G	1	3	4	0	0	4	0	0
7	14204447	.	T	A	2	3	5	0	1	6	0	0
7	14205503	.	G	A	5	5	10	0	1	11	0	0
7	14205527	.	G	C	5	8	13	0	1	14	0	0
7	14205559	.	T	C	5	8	13	0	0	13	0	0
7	14205781	.	T	G	3	3	6	0	0	6	0	0
7	14205857	.	C	A	3	5	8	0	0	8	0	0
7	14205881	.	A	G	3	5	8	0	0	8	0	0
7	14206499	.	T	A	3	6	9	1	0	10	0	0
7	14206790	.	T	G	5	7	12	0	1	13	0	0
7	14206847	.	C	A	3	6	9	0	0	9	0	0
7	14262108	.	A	T	6	4	10	0	0	10	0	0
7	14262111	.	G	T	0	4	4	0	6	10	0	0
7	14350822	.	G	A	2	2	4	0	1	5	0	0
7	14354038	.	T	C	1	4	5	0	1	6	0	0
7	14381282	.	C	G	4	2	6	0	0	6	0	0
7	14394120	.	G	T	2	2	4	1	0	5	0	0
7	14394194	.	G	A	1	2	3	0	0	3	0	0
7	14394824	.	G	T	4	5	9	0	0	9	0	0
7	14394839	.	G	C	5	8	13	0	0	13	0	0
7	14394860	.	A	C	5	8	13	0	0	13	0	0
7	14394891	.	G	A	3	7	10	0	0	10	0	0
7	14394925	.	A	G	4	6	10	0	0	10	0	0
7	14394991	.	G	A	6	7	13	0	2	15	0	0
7	14395029	.	A	G	4	3	7	0	1	8	0	0
7	14395336	.	G	A	0	3	3	0	3	6	0	0
7	14397850	.	A	G	1	4	5	0	0	5	0	0
7	14400446	.	G	A	3	3	6	0	0	6	0	0
7	14400512	.	C	T	6	2	8	0	1	9	0	0
7	14411862	.	G	A	2	1	3	0	1	4	0	0
7	14430880	.	C	T	1	2	3	0	0	3	0	0
7	14512064	.	G	A	7	3	10	0	0	10	0	0
7	14534326	.	T	C	12	0	12	0	13	25	0	0
7	14534789	.	T	C	12	11	23	0	2	25	0	0
7	14535719	.	T	C	9	9	18	0	0	18	0	0
7	14535749	.	T	A	12	11	23	0	0	23	0	0
7	14535782	.	G	T	17	9	26	0	1	27	0	0
7	14535834	.	A	C	4	4	8	0	1	9	0	0
7	14536163	.	A	G	3	8	11	0	0	11	0	0
7	14539470	.	T	C	7	7	14	0	2	16	0	0
7	14542854	.	C	T	8	7	15	0	0	15	0	0
7	14542893	.	C	T	5	4	9	0	2	11	0	0
7	14543002	.	T	C	4	12	16	0	0	16	0	0
7	14543031	.	G	A	4	11	15	0	2	17	0	0
7	14543128	.	A	T	2	3	5	0	0	5	0	0
7	14543156	.	T	G	1	3	4	0	0	4	0	0
7	14543454	.	G	T	3	2	5	0	1	6	0	0
7	14543463	.	T	C	3	4	7	0	0	7	0	0
7	14860521	.	C	T	8	2	10	0	2	12	0	0
7	14860524	.	A	C	9	2	11	0	1	12	0	0
7	14900869	.	G	A	6	3	9	0	0	9	0	0
7	14934738	.	G	A	8	8	16	0	1	17	0	0
7	14938134	.	C	T	13	15	28	0	0	28	0	0
7	14938404	.	C	T	6	2	8	0	1	9	0	0
7	15087435	.	G	C	1	2	3	0	0	3	0	0
7	15087643	.	G	A	2	5	7	0	1	8	0	0
7	15605180	.	A	T	1	3	4	0	1	5	0	0
7	15605844	.	C	T	4	5	9	0	0	9	0	0
7	15605846	.	T	C	4	5	9	0	0	9	0	0
7	15605950	.	T	C	3	2	5	0	0	5	0	0
7	15605968	.	T	A	3	2	5	0	0	5	0	0
7	15607650	.	C	T	5	10	15	0	1	16	0	0
7	15607757	.	G	A	0	8	8	0	5	13	0	0
7	15607867	.	C	T	5	3	8	0	0	8	0	0
7	15608108	.	A	C	2	3	5	0	0	5	0	0
7	15608113	.	T	C	2	3	5	0	0	5	0	0
7	15608183	.	T	C	3	5	8	0	0	8	0	0
7	15608471	.	C	T	8	8	16	0	0	16	0	0
7	15608520	.	G	A	7	5	12	0	0	12	0	0
7	15608620	.	G	A	3	4	7	0	1	8	0	0
7	15608707	.	T	G	3	4	7	0	0	7	0	0
7	15608730	.	A	C	2	6	8	0	0	8	0	0
7	15609137	.	A	C	12	8	20	0	0	20	0	0
7	15609156	.	G	A	9	2	11	0	3	14	0	0
7	15609387	.	T	A	8	7	15	0	0	15	0	0
7	15609469	.	C	T	11	17	28	0	0	28	0	0
7	15609520	.	G	A	9	7	16	0	0	16	0	0
7	15609826	.	C	T	6	11	17	0	3	20	0	0
7	15609961	.	C	T	15	14	29	0	0	29	0	0
7	15629291	.	A	G	3	3	6	0	0	6	0	0
7	15629298	.	C	T	2	3	5	0	1	6	0	0
7	15634379	.	A	G	4	3	7	0	0	7	0	0
7	15634391	.	G	A	1	3	4	0	5	9	0	0
7	15648755	.	C	T	1	6	7	0	0	7	0	0
7	15653514	.	G	A	7	5	12	0	0	12	0	0
7	15653537	.	G	A	4	2	6	0	0	6	0	0
7	15819692	.	C	T	4	6	10	0	1	11	0	0
7	15825888	.	T	C	6	1	7	0	4	11	0	0
7	15825932	.	T	C	4	1	5	0	5	10	0	0
7	15826026	.	G	A	5	3	8	0	0	8	0	0
7	15830007	.	T	C	2	3	5	0	0	5	0	0
7	15830026	.	A	G	4	2	6	0	0	6	0	0
7	15830095	.	C	T	2	2	4	0	0	4	0	0
7	15891623	.	C	A	1	2	3	0	1	4	0	0
7	15896959	.	G	C	3	7	10	0	0	10	0	0
7	15896998	.	G	A	0	10	10	0	3	13	0	0
7	15897024	.	G	A	3	7	10	0	0	10	0	0
7	15897530	.	T	G	1	2	3	0	0	3	0	0
7	15897671	.	G	T	3	3	6	0	0	6	0	0
7	15897676	.	T	C	3	4	7	0	0	7	0	0
7	15898112	.	G	T	2	2	4	0	1	5	0	0
7	15898280	.	T	C	4	5	9	0	0	9	0	0
7	15898400	.	T	C	0	3	3	0	3	6	0	0
7	15898954	.	T	C	3	7	10	0	0	10	0	0
7	15899189	.	T	C	6	3	9	0	0	9	0	0
7	15899191	.	A	G	6	3	9	0	0	9	0	0
7	15899286	.	A	G	3	2	5	0	0	5	0	0
7	15899468	.	A	T	6	7	13	0	1	14	0	0
7	15899532	.	T	A	11	11	22	0	1	23	0	0
7	16051826	.	A	T	2	2	4	0	0	4	0	0
7	16348898	.	A	G	8	5	13	0	2	15	0	0
7	16388262	.	C	T	9	6	15	0	0	15	0	0
7	16388307	.	C	T	8	8	16	0	2	18	0	0
7	16388310	.	G	C	9	9	18	0	0	18	0	0
7	16388358	.	T	C	4	9	13	0	0	13	0	0
7	16456854	.	C	T	12	11	23	0	0	23	0	0
7	16460093	.	C	T	12	8	20	0	3	23	0	0
7	16460252	.	G	A	5	9	14	0	1	15	0	0
7	16514265	.	C	T	1	2	3	0	0	3	0	0
7	16534940	.	A	G	2	4	6	0	0	6	0	0
7	16534946	.	A	G	2	4	6	0	0	6	0	0
7	16545638	.	C	T	9	8	17	0	1	18	0	0
7	16545790	.	A	G	3	10	13	0	0	13	0	0
7	16987317	.	G	C	2	2	4	0	0	4	0	0
7	16987332	.	T	C	0	4	4	0	1	5	0	0
7	16994639	.	G	A	0	3	3	0	2	5	0	0
7	17000956	.	G	A	0	2	2	0	1	3	0	0
7	17008217	.	C	A	1	2	3	0	0	3	0	0
7	17008305	.	C	T	1	3	4	0	0	4	0	0
7	17009538	.	C	T	2	2	4	0	0	4	0	0
7	17011427	.	T	C	4	3	7	0	0	7	0	0
7	17012573	.	G	C	2	2	4	0	0	4	0	0
7	17012682	.	C	T	3	5	8	0	0	8	0	0
7	17013000	.	G	A	0	2	2	0	2	4	0	0
7	17013825	.	T	C	5	3	8	0	0	8	0	0
7	17013827	.	T	A	4	3	7	0	1	8	0	0
7	17013899	.	C	T	3	5	8	0	1	9	0	0
7	17014017	.	G	C	1	4	5	0	0	5	0	0
7	17014219	.	A	G	4	3	7	0	0	7	0	0
7	17014301	.	T	C	3	6	9	0	1	10	0	0
7	17014338	.	T	G	3	0	3	0	4	7	0	0
7	17014453	.	A	C	7	3	10	0	0	10	0	0
7	17014531	.	C	A	11	11	22	0	0	22	0	0
7	17014548	.	G	T	12	13	25	0	1	26	0	0
7	17014621	.	T	A	16	10	26	0	0	26	0	0
7	17014653	.	C	T	15	7	22	0	1	23	0	0
7	17014748	.	T	C	12	4	16	0	1	17	0	0
7	17014914	.	A	G	7	6	13	0	1	14	0	0
7	17096318	.	G	A	1	2	3	0	0	3	0	0
7	17097176	.	G	A	10	3	13	0	0	13	0	0
7	17100076	.	T	C	10	5	15	0	1	16	0	0
7	17100259	.	T	C	11	5	16	0	2	18	0	0
7	17100271	.	G	A	11	6	17	0	2	19	0	0
7	17103021	.	A	G	0	5	5	0	2	7	0	0
7	17248865	.	T	A	1	4	5	0	0	5	0	0
7	17249293	.	A	T	2	3	5	0	1	6	0	0
7	17249599	.	A	G	1	6	7	0	0	7	0	0
7	17249642	.	C	T	2	4	6	0	0	6	0	0
7	17249829	.	A	T	1	7	8	0	1	9	0	0
7	17249908	.	C	T	7	3	10	2	0	12	0	0
7	17250249	.	G	A	0	13	13	0	3	16	0	0
7	17250298	.	C	T	2	4	6	0	1	7	0	0
7	17250832	.	C	T	1	14	15	0	0	15	0	0
7	17250861	.	A	G	5	16	21	0	0	22	1	0
7	17251098	.	C	A	18	12	30	0	0	30	0	0
7	17251222	.	G	A	2	17	19	0	17	36	0	0
7	17251234	.	A	G	21	18	39	0	2	41	0	0
7	17650751	.	G	C	4	2	6	0	0	6	0	0
7	17650899	.	T	C	2	4	6	1	0	7	0	0
7	17657860	.	G	C	1	2	3	0	0	3	0	0
7	17663134	.	C	T	3	3	6	0	0	6	0	0
7	17663289	.	T	C	3	2	5	0	0	5	0	0
7	17692797	.	G	A	2	9	11	0	0	11	0	0
7	17692857	.	T	C	5	3	8	0	0	8	0	0
7	17695039	.	C	T	7	8	15	0	2	17	0	0
7	17695051	.	A	G	10	6	16	0	0	16	0	0
7	17708643	.	C	T	1	2	3	0	2	5	0	0
7	17708783	.	C	T	1	2	3	0	0	3	0	0
7	17708968	.	G	A	2	2	4	0	0	4	0	0
7	17754299	.	G	A	15	16	31	5	1	37	0	0
7	17755699	.	C	T	6	4	10	0	4	14	0	0
7	17757019	.	A	G	27	31	58	0	8	66	0	0
7	17757024	.	C	T	34	27	61	0	7	68	0	0
7	17757078	.	A	G	27	35	62	0	4	66	0	0
7	17757371	.	T	C	29	33	62	1	5	68	0	0
7	17757408	.	G	A	33	30	63	0	4	67	0	0
7	17761117	.	T	G	3	3	6	0	1	7	0	0
7	17761303	.	C	T	0	3	3	0	3	6	0	0
7	17762455	.	C	G	0	2	2	0	6	8	0	0
7	17762480	.	G	C	2	5	7	0	0	7	0	0
7	17762896	.	G	A	1	2	3	0	0	3	0	0
7	17762911	.	G	A	1	4	5	0	0	5	0	0
7	17762931	.	A	T	3	2	5	0	0	5	0	0
7	17765993	.	T	C	1	2	3	0	0	3	0	0
7	17765994	.	T	C	1	2	3	0	0	3	0	0
7	17766963	.	T	A	1	2	3	0	2	5	0	0
7	17792032	.	A	C	1	2	3	0	0	3	0	0
7	17800956	.	A	G	3	3	6	0	0	6	0	0
7	17800993	.	C	T	3	2	5	0	1	6	0	0
7	17801064	.	A	C	3	3	6	0	0	6	0	0
7	17801896	.	T	G	1	2	3	0	0	3	0	0
7	17801900	.	A	G	1	0	1	0	2	3	0	0
7	17801938	.	A	G	2	0	2	5	3	10	0	0
7	17802645	.	G	A	4	3	7	0	0	7	0	0
7	17802648	.	C	T	4	3	7	0	0	7	0	0
7	17803330	.	A	T	4	2	6	0	0	6	0	0
7	17805706	.	C	G	4	9	13	0	2	15	0	0
7	17809860	.	C	T	7	6	13	0	1	14	0	0
7	17810581	.	C	T	7	5	12	0	0	12	0	0
7	17810611	.	G	A	5	7	12	0	1	13	0	0
7	17810624	.	C	T	5	5	10	0	0	10	0	0
7	17811052	.	T	C	6	0	6	0	9	15	0	0
7	17812892	.	T	A	6	9	15	0	1	16	0	0
7	17813283	.	A	G	4	6	10	0	0	10	0	0
7	17813987	.	T	C	3	0	3	0	6	9	0	0
7	17933350	.	G	A	1	3	4	0	8	12	0	0
7	17933362	.	A	G	8	0	8	0	6	14	0	0
7	17933413	.	T	A	5	9	14	0	1	15	0	0
7	17933777	.	G	A	1	10	11	0	7	18	0	0
7	17936753	.	C	G	12	6	18	0	0	18	0	0
7	17936795	.	G	A	1	8	9	0	13	22	0	0
7	17938069	.	C	A	8	12	20	0	0	20	0	0
7	17941936	.	C	T	10	9	19	0	2	21	0	0
7	17942370	.	G	A	6	10	16	0	1	17	0	0
7	17942451	.	A	C	3	5	8	0	0	8	0	0
7	17942883	.	T	G	19	11	30	0	2	32	0	0
7	17943078	.	A	G	10	10	20	0	2	22	0	0
7	17943133	.	C	T	19	16	35	0	1	36	0	0
7	17943170	.	G	A	2	25	27	0	13	40	0	0
7	17943376	.	C	G	17	13	30	0	2	32	0	0
7	17943509	.	A	G	22	2	24	1	28	53	0	0
7	17957770	.	C	A	2	2	4	0	0	4	0	0
7	17969145	.	C	T	10	7	17	0	1	18	0	0
7	17969461	.	T	A	6	4	10	0	0	10	0	0
7	17969720	.	C	T	5	5	10	0	0	10	0	0
7	17969792	.	A	G	3	8	11	0	1	12	0	0
7	17969851	.	A	G	3	8	11	0	0	11	0	0
7	17969883	.	G	C	0	3	3	0	4	7	0	0
7	17969949	.	A	G	1	5	6	0	2	8	0	0
7	17970016	.	C	T	3	6	9	0	0	9	0	0
7	17970124	.	T	A	12	7	19	0	0	19	0	0
7	17970186	.	G	A	3	7	10	0	3	13	0	0
7	17970337	.	A	G	14	0	14	0	6	20	0	0
7	17970338	.	C	T	16	5	21	0	0	21	0	0
7	17970654	.	G	A	4	6	10	0	0	10	0	0
7	18071595	.	A	G	1	2	3	0	0	3	0	0
7	18072797	.	T	G	2	2	4	0	0	4	0	0
7	18072800	.	C	T	2	2	4	0	0	4	0	0
7	18114316	.	G	A	7	24	31	0	30	61	0	0
7	18114495	.	C	T	17	20	37	0	3	40	0	0
7	18114518	.	A	T	7	8	15	0	17	32	0	0
7	18115220	.	T	A	22	26	48	0	1	49	0	0
7	18115261	.	G	T	21	19	40	0	1	41	0	0
7	18115302	.	G	A	3	13	16	0	17	33	0	0
7	18115470	.	C	T	24	15	39	0	1	40	0	0
7	18115584	.	T	G	17	14	31	0	2	33	0	0
7	18115721	.	G	A	1	22	23	0	24	47	0	0
7	18116037	.	C	T	18	7	25	0	2	27	0	0
7	18116204	.	G	A	28	26	54	0	3	57	0	0
7	18122445	.	C	G	8	10	18	0	1	19	0	0
7	18122541	.	G	C	19	1	20	0	27	47	0	0
7	18124218	.	C	T	15	25	40	0	3	43	0	0
7	18124314	.	C	T	20	11	31	0	2	33	0	0
7	18124329	.	T	A	12	11	23	0	3	26	0	0
7	18137325	.	C	T	1	16	17	0	24	41	0	0
7	18146699	.	T	G	13	8	21	0	0	21	0	0
7	18168253	.	T	A	13	13	26	0	1	27	0	0
7	18366583	.	T	A	2	2	4	1	0	5	0	0
7	18366865	.	T	A	2	3	5	0	0	5	0	0
7	18366932	.	T	C	3	3	6	0	0	6	0	0
7	18366936	.	A	T	3	4	7	0	0	7	0	0
7	18367075	.	A	C	3	4	7	0	0	7	0	0
7	18367165	.	A	T	2	3	5	0	0	5	0	0
7	18412779	.	A	G	4	3	7	0	0	7	0	0
7	18413054	.	G	T	4	7	11	0	0	11	0	0
7	18413086	.	G	T	5	2	7	0	1	8	0	0
7	18413585	.	A	C	2	6	8	0	0	8	0	0
7	18415530	.	C	T	1	3	4	0	0	4	0	0
7	18415905	.	C	T	1	1	2	0	1	3	0	0
7	18462466	.	T	C	0	3	3	0	1	4	0	0
7	18462498	.	A	G	3	2	5	0	0	5	0	0
7	18462531	.	A	T	0	4	4	0	0	4	0	0
7	18462543	.	C	G	2	3	5	0	0	5	0	0
7	18462733	.	G	A	8	7	15	0	0	15	0	0
7	18463132	.	T	A	8	3	11	0	0	11	0	0
7	18463259	.	T	C	4	6	10	0	0	10	0	0
7	18463488	.	A	T	4	2	6	0	0	6	0	0
7	18463589	.	A	T	3	3	6	0	0	6	0	0
7	18464352	.	G	A	1	5	6	0	0	6	0	0
7	18464593	.	A	T	4	2	6	0	0	6	0	0
7	18464618	.	C	G	1	4	5	0	1	6	0	0
7	18464700	.	A	C	3	2	5	0	2	7	0	0
7	18464919	.	C	T	4	6	10	0	1	11	0	0
7	18465000	.	G	A	13	6	19	0	0	19	0	0
7	18465096	.	A	G	1	12	13	0	0	13	0	0
7	18465435	.	T	G	4	3	7	0	1	8	0	0
7	18470314	.	C	T	1	4	5	0	0	5	0	0
7	18470573	.	C	A	1	2	3	0	0	3	0	0
7	18470813	.	C	A	4	3	7	0	0	7	0	0
7	18474994	.	C	T	3	2	5	0	0	5	0	0
7	18475150	.	C	G	0	3	3	1	1	5	0	0
7	18484268	.	C	T	2	2	4	0	0	4	0	0
7	18550499	.	C	T	3	3	6	0	0	6	0	0
7	18558504	.	C	T	12	7	19	0	4	23	0	0
7	18558586	.	T	C	4	0	4	0	5	9	0	0
7	18558806	.	A	T	12	13	25	0	0	25	0	0
7	18558871	.	G	A	15	10	25	0	0	25	0	0
7	18558906	.	T	G	14	11	25	0	3	28	0	0
7	18559197	.	G	T	7	9	16	0	1	17	0	0
7	18559212	.	C	A	6	13	19	0	1	20	0	0
7	18559258	.	A	G	10	13	23	0	1	24	0	0
7	18559548	.	C	T	4	12	16	0	0	16	0	0
7	18560013	.	C	A	12	9	21	0	0	21	0	0
7	18560047	.	G	A	8	7	15	0	0	15	0	0
7	18560397	.	C	T	2	10	12	0	4	16	0	0
7	18560474	.	C	T	0	7	7	0	7	14	0	0
7	18560478	.	T	A	4	7	11	0	2	13	0	0
7	18560952	.	C	T	1	4	5	0	7	12	0	0
7	18564318	.	G	A	4	5	9	0	1	10	0	0
7	18594557	.	T	C	2	0	2	0	7	9	0	0
7	18598610	.	C	T	2	2	4	0	0	4	0	0
7	18607074	.	C	A	4	2	6	0	1	7	0	0
7	18607380	.	C	A	0	2	2	0	1	3	0	0
7	18607620	.	A	T	1	4	5	0	0	5	0	0
7	18607852	.	T	A	3	5	8	0	2	10	0	0
7	18607928	.	A	T	3	6	9	0	0	9	0	0
7	18607932	.	A	G	3	5	8	0	0	8	0	0
7	18608190	.	A	G	3	4	7	0	0	7	0	0
7	18608221	.	C	G	2	4	6	0	0	6	0	0
7	18618113	.	T	A	13	11	24	0	0	24	0	0
7	18618776	.	T	C	11	11	22	0	0	22	0	0
7	18618859	.	A	G	9	2	11	0	0	11	0	0
7	18618860	.	T	C	7	0	7	0	8	15	0	0
7	18618927	.	T	C	22	11	33	0	0	33	0	0
7	18619426	.	C	G	5	4	9	0	0	9	0	0
7	18619466	.	C	T	2	8	10	0	1	11	0	0
7	18619661	.	G	A	8	6	14	0	1	15	0	0
7	18619990	.	C	T	1	7	8	0	0	8	0	0
7	18620027	.	A	T	8	3	11	0	1	12	0	0
7	18620049	.	A	C	6	2	8	0	1	9	0	0
7	18620223	.	C	T	0	7	7	0	5	12	0	0
7	18620273	.	T	C	6	4	10	0	0	10	0	0
7	18645360	.	G	A	4	3	7	0	0	7	0	0
7	18655772	.	A	C	2	2	4	0	0	4	0	0
7	18655798	.	T	G	1	1	2	0	1	3	0	0
7	18656025	.	G	A	3	2	5	0	0	5	0	0
7	18705665	.	G	A	1	7	8	0	1	9	0	0
7	18705728	.	G	A	5	4	9	0	1	10	0	0
7	18710367	.	T	G	2	4	6	0	0	6	0	0
7	18711374	.	G	C	5	8	13	0	0	13	0	0
7	18711378	.	G	C	7	7	14	0	0	14	0	0
7	18712511	.	C	T	9	5	14	0	0	14	0	0
7	18779690	.	G	T	1	3	4	0	0	4	0	0
7	18780119	.	A	G	5	3	8	0	1	9	0	0
7	18780196	.	A	G	6	5	11	0	2	13	0	0
7	18810675	.	A	G	5	9	14	0	1	15	0	0
7	18810692	.	T	C	6	8	14	0	1	15	0	0
7	18810710	.	C	T	8	8	16	0	2	18	0	0
7	18810768	.	C	A	1	5	6	0	8	14	0	0
7	18810971	.	C	T	1	2	3	0	1	4	0	0
7	18810990	.	C	A	3	4	7	0	0	7	0	0
7	18811128	.	A	G	4	6	10	0	0	10	0	0
7	18958517	.	T	C	1	2	3	0	0	3	0	0
7	18976568	.	T	C	1	3	4	0	0	4	0	0
7	18980754	.	G	T	0	3	3	0	1	4	0	0
7	18980787	.	G	T	2	5	7	0	0	7	0	0
7	18980857	.	T	C	2	4	6	0	0	6	0	0
7	18983123	.	G	A	1	2	3	0	2	5	0	0
7	19028850	.	G	A	6	6	12	0	0	12	0	0
7	19028857	.	A	T	6	5	11	0	1	12	0	0
7	19055605	.	C	T	15	9	24	0	0	24	0	0
7	19065861	.	A	G	7	14	21	0	1	22	0	0
7	19070994	.	C	T	2	26	28	0	12	40	0	0
7	19071420	.	T	C	11	0	11	0	11	22	0	0
7	19071639	.	C	A	9	9	18	0	3	21	0	0
7	19073202	.	T	C	5	0	5	0	5	10	0	0
7	19073481	.	T	C	11	9	20	0	0	20	0	0
7	19073495	.	G	A	8	10	18	0	0	18	0	0
7	19073563	.	A	T	8	9	17	0	0	17	0	0
7	19073576	.	T	A	7	9	16	0	2	18	0	0
7	19073788	.	T	C	4	12	16	1	0	17	0	0
7	19073818	.	T	C	3	4	7	1	1	9	0	0
7	19073833	.	G	A	6	4	10	1	2	13	0	0
7	19073918	.	G	A	7	9	16	0	0	16	0	0
7	19073984	.	G	A	2	3	5	0	1	6	0	0
7	19073985	.	C	T	1	3	4	0	2	6	0	0
7	19074041	.	G	A	5	4	9	0	1	10	0	0
7	19074056	.	T	C	8	6	14	0	0	14	0	0
7	19074173	.	C	T	9	13	22	0	1	23	0	0
7	19074194	.	A	T	11	7	18	0	1	19	0	0
7	19074270	.	G	A	9	5	14	1	0	15	0	0
7	19074363	.	T	C	6	4	10	0	0	10	0	0
7	19075025	.	C	T	0	6	6	0	6	12	0	0
7	19075058	.	T	C	2	0	2	0	6	8	0	0
7	19075849	.	G	A	1	2	3	0	0	3	0	0
7	19076154	.	A	G	1	3	4	0	0	4	0	0
7	19076354	.	C	G	1	3	4	0	0	4	0	0
7	19076536	.	A	G	4	2	6	0	1	7	0	0
7	19076550	.	G	A	2	4	6	0	1	7	0	0
7	19179977	.	C	T	1	6	7	0	2	9	0	0
7	19180024	.	T	C	4	0	4	0	6	10	0	0
7	19180029	.	A	G	4	6	10	0	1	11	0	0
7	19180152	.	T	A	3	3	6	0	0	6	0	0
7	19180589	.	C	T	7	3	10	0	0	10	0	0
7	20524757	.	A	G	3	2	5	1	0	6	0	0
7	20529043	.	A	C	3	2	5	0	0	5	0	0
7	20529155	.	A	G	4	6	10	0	0	10	0	0
7	20529578	.	A	C	3	5	8	0	0	8	0	0
7	20529725	.	C	T	12	6	18	0	0	18	0	0
7	20529728	.	G	A	13	5	18	0	1	19	0	0
7	20529760	.	C	T	13	7	20	0	2	22	0	0
7	20529773	.	T	C	13	10	23	0	1	24	0	0
7	20530284	.	A	T	8	7	15	0	2	17	0	0
7	20530314	.	G	A	8	8	16	0	0	16	0	0
7	20530338	.	C	T	7	8	15	0	0	15	0	0
7	20530373	.	T	A	4	7	11	0	1	12	0	0
7	20537117	.	A	G	2	2	4	0	0	4	0	0
7	20537118	.	T	C	2	2	4	0	0	4	0	0
7	20539326	.	C	A	3	2	5	0	0	5	0	0
7	20539345	.	A	G	4	2	6	0	0	6	0	0
7	20540284	.	C	T	6	4	10	0	0	10	0	0
7	20540299	.	T	C	6	4	10	0	0	10	0	0
7	20542251	.	G	A	12	5	17	0	1	18	0	0
7	20542262	.	C	A	11	4	15	0	1	16	0	0
7	20587681	.	G	T	5	11	16	0	0	16	0	0
7	20587685	.	T	G	5	10	15	0	1	16	0	0
7	20587812	.	T	C	3	3	6	0	0	6	0	0
7	20588280	.	C	G	5	8	13	0	0	13	0	0
7	20593682	.	G	A	1	11	12	0	6	18	0	0
7	20593809	.	G	A	13	3	16	0	2	18	0	0
7	20597033	.	G	A	8	6	14	0	2	16	0	0
7	20597132	.	C	T	15	8	23	0	0	23	0	0
7	20600211	.	T	A	6	10	16	0	0	16	0	0
7	20600398	.	C	T	7	10	17	0	3	20	0	0
7	20600447	.	A	G	10	0	10	0	13	23	0	0
7	20601052	.	G	A	13	6	19	0	0	19	0	0
7	20601072	.	T	C	10	5	15	0	0	15	0	0
7	20601192	.	C	T	8	5	13	0	1	14	0	0
7	20601250	.	A	G	6	6	12	0	0	12	0	0
7	20601325	.	A	G	11	7	18	0	1	19	0	0
7	20601410	.	T	A	5	6	11	0	1	12	0	0
7	20601524	.	G	A	7	4	11	0	0	11	0	0
7	20601539	.	T	C	6	7	13	0	0	13	0	0
7	20601578	.	T	C	2	8	10	0	0	10	0	0
7	20601583	.	T	C	2	7	9	0	1	10	0	0
7	20601713	.	A	T	3	6	9	0	0	9	0	0
7	20601835	.	G	T	5	5	10	0	0	11	1	0
7	20601925	.	T	C	9	4	13	0	0	13	0	0
7	20602053	.	T	C	3	3	6	0	2	8	0	0
7	20602205	.	A	G	5	2	7	0	0	7	0	0
7	20610565	.	C	A	2	2	4	0	1	5	0	0
7	20629684	.	T	C	1	4	5	0	1	6	0	0
7	20629792	.	G	A	3	10	13	0	0	13	0	0
7	20629801	.	A	G	3	9	12	0	0	12	0	0
7	20634202	.	C	G	1	3	4	0	0	4	0	0
7	20634444	.	A	T	3	5	8	0	0	8	0	0
7	20634498	.	T	A	7	6	13	0	1	15	1	0
7	20634577	.	T	G	9	13	22	0	0	22	0	0
7	20635475	.	A	G	5	11	16	0	2	18	0	0
7	20635495	.	T	A	4	11	15	0	0	15	0	0
7	20635519	.	A	G	6	7	13	0	0	13	0	0
7	20635616	.	T	C	2	10	12	0	0	12	0	0
7	20635760	.	A	G	2	3	5	0	1	6	0	0
7	20636344	.	A	G	7	13	20	0	1	21	0	0
7	20636379	.	A	T	6	16	22	0	1	23	0	0
7	20636410	.	C	T	6	17	23	0	0	23	0	0
7	20636414	.	T	G	6	17	23	0	1	24	0	0
7	20636464	.	G	A	9	12	21	0	2	23	0	0
7	20636465	.	A	G	9	13	22	0	1	23	0	0
7	20636802	.	T	G	7	16	23	0	2	25	0	0
7	20636833	.	A	G	13	14	27	0	0	27	0	0
7	20636844	.	T	A	13	14	27	0	2	29	0	0
7	20664621	.	A	T	2	3	5	0	1	6	0	0
7	20664672	.	A	G	1	0	1	0	2	3	0	0
7	20693673	.	G	T	23	19	42	0	2	44	0	0
7	20695949	.	G	T	15	9	24	0	7	31	0	0
7	20698208	.	T	A	15	7	22	0	0	22	0	0
7	20712555	.	C	T	5	9	14	0	0	14	0	0
7	20715178	.	G	A	6	11	17	0	1	18	0	0
7	20715434	.	C	T	9	4	13	0	0	13	0	0
7	20731052	.	C	T	8	5	13	0	1	14	0	0
7	20731166	.	A	G	3	7	10	0	0	10	0	0
7	20735155	.	G	A	3	2	5	0	0	5	0	0
7	20738148	.	A	G	2	7	9	0	1	10	0	0
7	20743583	.	G	A	2	4	6	0	1	7	0	0
7	20754669	.	G	A	1	2	3	0	0	3	0	0
7	20780285	.	G	A	9	3	12	0	0	12	0	0
7	20780317	.	C	T	10	5	15	0	0	15	0	0
7	20780337	.	A	C	11	8	19	0	2	21	0	0
7	20780356	.	A	G	12	9	21	0	0	21	0	0
7	20780424	.	A	T	5	9	14	0	1	15	0	0
7	20780453	.	C	A	6	8	14	0	1	15	0	0
7	20780500	.	A	C	6	0	6	0	6	12	0	0
7	20780732	.	A	C	8	5	13	0	0	13	0	0
7	20780797	.	T	C	11	4	15	0	2	17	0	0
7	20780918	.	C	T	0	9	9	0	11	20	0	0
7	20780987	.	G	A	5	6	11	0	0	11	0	0
7	20781110	.	C	T	9	9	18	0	0	18	0	0
7	20781327	.	A	G	4	2	6	0	0	6	0	0
7	20781996	.	T	G	4	3	7	0	0	7	0	0
7	20784496	.	C	T	3	4	7	0	0	7	0	0
7	20787233	.	C	T	3	2	5	0	0	5	0	0
7	20859843	.	T	G	5	2	7	0	0	7	0	0
7	20859975	.	G	A	13	6	19	0	0	19	0	0
7	20860011	.	T	C	11	5	16	0	0	16	0	0
7	20864097	.	A	G	17	6	23	0	0	23	0	0
7	20864256	.	T	C	8	11	19	0	0	19	0	0
7	20905507	.	C	T	5	5	10	0	0	10	0	0
7	20923330	.	A	G	4	2	6	0	0	6	0	0
7	20924115	.	C	T	3	2	5	0	1	6	0	0
7	20935058	.	T	C	1	5	6	0	1	7	0	0
7	20935547	.	G	A	5	7	12	0	0	12	0	0
7	20935684	.	C	T	2	6	8	0	2	10	0	0
7	20935737	.	T	A	2	6	8	0	1	9	0	0
7	20938812	.	C	T	4	3	7	0	0	7	0	0
7	20938928	.	C	T	2	2	4	0	0	4	0	0
7	21608029	.	G	A	2	2	4	0	0	4	0	0
7	21626312	.	G	A	1	2	3	0	0	3	0	0
7	21765702	.	T	A	3	5	8	0	1	9	0	0
7	21766937	.	C	A	1	3	4	0	0	4	0	0
7	21767423	.	A	G	1	2	3	0	1	4	0	0
7	21767907	.	T	C	3	2	5	0	1	6	0	0
7	21768002	.	T	C	3	2	5	0	2	7	0	0
7	21768060	.	A	G	2	4	6	0	0	6	0	0
7	21768334	.	C	A	5	4	9	0	0	9	0	0
7	21768540	.	T	A	4	2	6	0	1	7	0	0
7	21769286	.	T	G	5	2	7	0	0	7	0	0
7	21769318	.	A	G	1	4	5	0	0	5	0	0
7	21769733	.	G	A	8	3	11	0	0	11	0	0
7	21770141	.	A	G	5	0	5	0	3	8	0	0
7	21770567	.	C	T	8	8	16	0	1	17	0	0
7	21772869	.	A	T	6	7	13	0	0	13	0	0
7	21773542	.	C	T	14	10	24	0	1	25	0	0
7	21773626	.	C	T	11	6	17	0	0	17	0	0
7	21774127	.	G	A	13	9	22	0	1	23	0	0
7	21776426	.	C	T	14	13	27	0	2	29	0	0
7	21776683	.	G	A	14	7	21	0	1	22	0	0
7	21776693	.	T	C	13	5	18	0	0	18	0	0
7	21777110	.	G	A	15	3	18	0	1	19	0	0
7	21777111	.	C	T	16	3	19	0	0	19	0	0
7	21777203	.	G	T	13	6	19	0	0	19	0	0
7	21777340	.	A	T	3	3	6	0	0	6	0	0
7	21777720	.	G	A	17	8	25	0	6	31	0	0
7	21777978	.	T	G	17	13	30	1	1	32	0	0
7	21778055	.	G	A	10	8	18	0	2	20	0	0
7	21778070	.	T	C	6	9	15	0	0	15	0	0
7	21778131	.	T	A	2	2	4	0	0	4	0	0
7	21859485	.	A	T	1	2	3	0	0	3	0	0
7	21872364	.	G	A	1	3	4	0	4	8	0	0
7	21872716	.	G	A	3	2	5	0	0	5	0	0
7	21872759	.	T	A	7	3	10	0	0	10	0	0
7	21872969	.	G	C	3	3	6	0	0	6	0	0
7	21873246	.	C	G	7	3	10	0	0	10	0	0
7	21873266	.	G	A	1	5	6	0	1	7	0	0
7	21873342	.	A	C	3	4	7	0	0	7	0	0
7	21873350	.	G	A	3	2	5	0	0	5	0	0
7	21873878	.	T	G	1	5	6	0	0	6	0	0
7	21873885	.	T	A	1	4	5	0	1	6	0	0
7	21874075	.	T	C	3	5	8	0	3	11	0	0
7	21874092	.	A	G	1	1	2	0	4	6	0	0
7	21874117	.	G	A	2	3	5	0	0	5	0	0
7	21876652	.	T	C	1	2	3	0	0	3	0	0
7	21879728	.	A	G	3	2	5	0	0	5	0	0
7	21881863	.	C	T	3	3	6	0	0	6	0	0
7	21884578	.	A	G	2	3	5	0	0	5	0	0
7	21887797	.	A	T	19	21	40	0	0	40	0	0
7	21887967	.	C	T	19	16	35	0	1	36	0	0
7	21888084	.	T	A	21	24	45	0	1	46	0	0
7	21888274	.	T	A	18	9	27	0	2	29	0	0
7	21890998	.	C	T	2	7	9	0	3	12	0	0
7	21891031	.	G	A	3	2	5	0	2	7	0	0
7	21891510	.	T	G	2	5	7	0	0	7	0	0
7	21917927	.	C	A	1	6	7	0	0	7	0	0
7	21917972	.	C	G	1	4	5	0	0	5	0	0
7	21918410	.	G	A	0	2	2	0	2	4	0	0
7	21918412	.	T	A	2	2	4	0	0	4	0	0
7	21940965	.	T	G	13	9	22	0	8	30	0	0
7	21940992	.	A	G	17	18	35	0	2	37	0	0
7	21941016	.	T	G	20	23	43	0	0	43	0	0
7	21941460	.	G	A	14	8	22	0	1	23	0	0
7	21941477	.	C	A	12	9	21	0	2	23	0	0
7	21941568	.	C	T	17	16	33	0	0	33	0	0
7	21941579	.	A	C	10	14	24	0	4	28	0	0
7	21942378	.	C	T	11	16	27	0	1	28	0	0
7	21942513	.	A	T	9	18	27	0	1	28	0	0
7	21942644	.	T	A	16	6	22	0	1	23	0	0
7	21942672	.	C	T	15	11	26	0	0	26	0	0
7	21943553	.	A	G	14	6	20	0	0	20	0	0
7	21943625	.	G	A	11	6	17	0	0	17	0	0
7	21943716	.	T	G	8	7	15	0	1	16	0	0
7	21943772	.	T	C	13	8	21	0	0	21	0	0
7	21943886	.	C	A	3	5	8	0	0	8	0	0
7	21944495	.	T	C	5	5	10	0	0	10	0	0
7	21944753	.	G	A	8	3	11	0	1	12	0	0
7	21945257	.	C	T	1	5	6	0	8	14	0	0
7	21945347	.	C	T	0	7	7	0	10	17	0	0
7	21951353	.	G	A	3	2	5	0	0	5	0	0
7	22295624	.	G	A	0	7	7	0	12	19	0	0
7	22295636	.	T	G	12	0	12	0	7	19	0	0
7	22322131	.	C	T	2	2	4	0	0	4	0	0
7	22322143	.	T	C	1	1	2	0	0	2	0	0
7	22322616	.	C	G	4	3	7	0	0	7	0	0
7	22323373	.	A	G	1	0	1	0	3	4	0	0
7	22323884	.	T	G	5	4	9	0	0	9	0	0
7	22323934	.	C	T	3	4	7	0	0	7	0	0
7	22324029	.	G	A	0	7	7	0	2	9	0	0
7	22324261	.	C	T	6	6	12	0	0	12	0	0
7	22626223	.	T	A	3	5	8	0	1	9	0	0
7	22626525	.	A	T	1	3	4	0	1	5	0	0
7	22626669	.	A	G	1	3	4	0	0	4	0	0
7	22630003	.	T	A	22	18	40	0	2	42	0	0
7	22630087	.	A	G	11	16	27	0	3	30	0	0
7	22630096	.	T	C	11	1	12	0	15	27	0	0
7	22630189	.	C	T	23	21	44	0	1	45	0	0
7	22630297	.	A	G	14	23	37	0	0	37	0	0
7	22630581	.	C	T	3	26	29	0	23	52	0	0
7	22630655	.	T	C	23	1	24	0	27	51	0	0
7	22630670	.	A	G	27	22	49	0	0	49	0	0
7	22632253	.	T	A	22	20	42	0	1	43	0	0
7	22632850	.	C	A	0	4	4	0	3	7	0	0
7	22632873	.	G	A	1	2	3	0	1	4	0	0
7	22718516	.	C	T	3	6	9	0	0	9	0	0
7	22723701	.	G	A	0	2	2	0	5	7	0	0
7	22732755	.	T	C	9	5	14	0	0	14	0	0
7	22735394	.	C	A	4	5	9	0	2	11	0	0
7	22735421	.	A	T	9	5	14	0	1	15	0	0
7	22751600	.	G	A	7	11	18	0	3	21	0	0
7	22760761	.	G	T	12	15	27	0	1	28	0	0
7	22793530	.	T	G	4	0	4	0	23	27	0	0
7	22795566	.	G	A	2	4	6	0	0	6	0	0
7	22796784	.	A	G	2	4	6	0	0	6	0	0
7	22806668	.	G	A	1	13	14	0	15	29	0	0
7	22810208	.	C	T	7	4	11	0	0	11	0	0
7	22816078	.	G	A	2	9	11	1	10	22	0	0
7	22816487	.	T	C	12	5	17	0	1	18	0	0
7	22818915	.	T	C	2	2	4	0	0	4	0	0
7	22818920	.	T	G	2	2	4	0	0	4	0	0
7	22819933	.	T	A	25	14	39	0	10	49	0	0
7	22819975	.	A	T	10	15	25	0	15	41	1	0
7	22824278	.	A	G	2	7	9	0	0	9	0	0
7	22830405	.	G	A	10	3	13	0	0	13	0	0
7	22833512	.	T	C	1	2	3	0	1	4	0	0
7	22833739	.	C	T	1	4	5	0	2	7	0	0
7	22834021	.	G	A	12	6	18	0	2	20	0	0
7	22838359	.	T	C	17	12	29	0	2	31	0	0
7	22843256	.	A	G	12	12	24	0	2	26	0	0
7	22843310	.	A	T	12	16	28	0	3	32	1	0
7	22849948	.	A	T	16	16	32	0	3	35	0	0
7	22849949	.	C	T	18	14	32	0	2	34	0	0
7	22850098	.	T	C	21	26	47	0	2	49	0	0
7	22850137	.	T	A	15	19	34	0	4	39	1	0
7	22850231	.	T	G	16	15	31	1	1	33	0	0
7	22850234	.	C	T	13	16	29	1	1	31	0	0
7	22850277	.	A	T	16	14	30	0	1	31	0	0
7	22850340	.	T	A	24	12	36	0	5	41	0	0
7	22850365	.	C	T	22	17	39	0	0	39	0	0
7	22850446	.	C	A	23	9	32	0	2	34	0	0
7	22851036	.	C	T	12	17	29	1	3	33	0	0
7	22851133	.	C	T	26	24	50	0	3	53	0	0
7	22851739	.	A	C	35	25	60	0	1	61	0	0
7	22898231	.	C	T	5	2	7	0	0	7	0	0
7	22911938	.	T	C	7	6	13	0	0	13	0	0
7	22911984	.	G	T	6	7	13	0	0	13	0	0
7	22912315	.	C	T	2	5	7	0	1	8	0	0
7	22912755	.	A	T	2	5	7	0	1	8	0	0
7	22912762	.	T	G	5	3	8	0	0	8	0	0
7	22912919	.	C	T	3	3	6	0	0	6	0	0
7	22912928	.	G	A	2	2	4	0	1	5	0	0
7	23000316	.	C	T	4	2	6	0	1	7	0	0
7	23000352	.	A	G	3	0	3	0	3	6	0	0
7	23492311	.	C	T	3	3	6	0	0	6	0	0
7	23492312	.	A	G	2	3	5	0	1	6	0	0
7	23492644	.	T	C	5	3	8	0	1	9	0	0
7	23493140	.	G	A	4	4	8	0	0	8	0	0
7	23493268	.	C	T	4	4	8	0	0	8	0	0
7	23493485	.	T	G	2	2	4	0	0	4	0	0
7	23494082	.	T	G	5	2	7	0	1	8	0	0
7	23494107	.	A	T	5	5	10	0	0	10	0	0
7	23496152	.	G	A	4	3	7	0	0	7	0	0
7	23526889	.	A	G	4	2	6	0	0	6	0	0
7	23533467	.	T	C	5	2	7	0	0	7	0	0
7	23536981	.	T	A	6	12	18	0	1	19	0	0
7	23539695	.	C	A	9	12	21	0	0	21	0	0
7	23539824	.	G	A	7	6	13	0	1	14	0	0
7	23539951	.	G	A	1	9	10	0	12	22	0	0
7	23540270	.	T	A	5	6	11	0	0	11	0	0
7	23540323	.	G	A	8	7	15	0	0	15	0	0
7	23540328	.	C	T	8	6	14	0	0	14	0	0
7	23540414	.	T	C	5	9	14	0	1	15	0	0
7	23540505	.	A	C	11	8	19	0	3	22	0	0
7	23540540	.	A	G	14	0	14	0	10	24	0	0
7	23540629	.	T	C	6	11	17	0	1	18	0	0
7	23540643	.	A	G	7	11	18	0	1	19	0	0
7	23540887	.	G	A	20	8	28	0	5	33	0	0
7	23541083	.	C	T	10	12	22	0	2	24	0	0
7	23541230	.	A	C	10	16	26	0	1	27	0	0
7	23541508	.	T	G	9	8	17	0	0	17	0	0
7	23541696	.	G	T	20	13	33	0	2	35	0	0
7	23541847	.	G	C	23	13	36	0	3	39	0	0
7	23541852	.	T	C	23	16	39	0	0	39	0	0
7	23542151	.	T	G	8	14	22	0	1	23	0	0
7	23542543	.	C	T	19	18	37	0	2	39	0	0
7	23542586	.	G	T	19	11	30	0	0	30	0	0
7	23542678	.	C	A	18	20	38	0	2	40	0	0
7	23542785	.	T	G	10	1	11	0	20	31	0	0
7	23542794	.	T	C	10	23	33	0	1	34	0	0
7	23561158	.	C	T	1	4	5	0	3	8	0	0
7	23561431	.	G	A	3	4	7	0	0	7	0	0
7	23563034	.	C	T	3	4	7	0	0	7	0	0
7	23691846	.	G	A	2	3	5	0	0	5	0	0
7	23696140	.	C	T	4	5	9	0	2	11	0	0
7	23704869	.	G	A	8	5	13	0	4	17	0	0
7	23707079	.	G	A	8	9	17	0	0	17	0	0
7	23710275	.	T	A	19	15	34	0	1	35	0	0
7	23710311	.	C	T	16	20	36	0	0	36	0	0
7	23713828	.	G	T	10	3	13	0	0	13	0	0
7	23713855	.	T	G	3	0	3	0	7	10	0	0
7	23718778	.	C	G	12	9	21	0	1	22	0	0
7	23718924	.	A	G	14	14	28	0	0	28	0	0
7	23724311	.	T	A	14	11	25	0	2	27	0	0
7	23724418	.	C	T	16	12	28	0	3	31	0	0
7	23724556	.	C	A	8	14	22	2	1	25	0	0
7	23724607	.	C	T	16	12	28	2	0	30	0	0
7	23725087	.	A	G	10	14	24	0	1	25	0	0
7	23725239	.	C	T	16	11	27	0	2	29	0	0
7	23725276	.	T	C	18	6	24	0	0	24	0	0
7	23725285	.	A	T	14	6	20	0	5	25	0	0
7	23725366	.	T	A	11	16	27	0	1	28	0	0
7	23725426	.	C	A	15	10	25	0	1	27	1	0
7	23728297	.	C	G	4	3	7	0	0	7	0	0
7	23728312	.	A	G	1	5	6	0	0	6	0	0
7	23728504	.	T	C	4	2	6	0	0	6	0	0
7	23731275	.	A	C	4	3	7	0	0	7	0	0
7	23731278	.	A	G	3	3	6	0	1	7	0	0
7	23749277	.	G	A	19	12	31	0	2	33	0	0
7	23749490	.	G	A	23	18	41	0	3	44	0	0
7	23749513	.	A	T	15	25	40	0	0	40	0	0
7	23749679	.	A	G	17	11	28	0	0	28	0	0
7	23749831	.	C	A	11	9	20	0	0	20	0	0
7	23749954	.	A	T	12	23	35	0	2	37	0	0
7	23750080	.	T	C	14	10	24	0	1	25	0	0
7	23750379	.	T	C	16	2	18	0	0	18	0	0
7	23750665	.	C	T	6	8	14	0	1	15	0	0
7	23750955	.	C	T	11	6	17	0	0	17	0	0
7	23750962	.	A	T	12	4	16	0	1	17	0	0
7	23750992	.	T	A	14	3	17	0	0	17	0	0
7	23751043	.	C	T	13	10	23	0	0	23	0	0
7	23751106	.	A	C	13	0	13	0	11	24	0	0
7	23751188	.	T	G	5	4	9	0	1	10	0	0
7	23751197	.	A	T	3	6	9	0	0	9	0	0
7	23751291	.	A	G	1	3	4	0	1	5	0	0
7	23751348	.	A	C	4	6	10	0	0	10	0	0
7	23751363	.	A	T	4	6	10	0	0	10	0	0
7	23751866	.	C	G	11	13	24	0	1	25	0	0
7	23752249	.	T	C	8	2	10	0	0	10	0	0
7	23752254	.	T	C	5	2	7	0	2	9	0	0
7	23752519	.	C	T	6	4	10	0	0	10	0	0
7	23753061	.	A	G	1	6	7	0	1	8	0	0
7	23753070	.	T	C	4	5	9	0	0	9	0	0
7	23753341	.	T	A	6	6	12	0	1	13	0	0
7	23753450	.	A	T	4	6	10	0	0	10	0	0
7	23753713	.	T	C	3	0	3	0	5	8	0	0
7	23753873	.	T	C	4	3	7	0	0	7	0	0
7	23753999	.	A	G	3	3	6	0	0	6	0	0
7	23754338	.	C	T	4	3	7	0	0	7	0	0
7	23754467	.	T	A	3	8	11	0	1	12	0	0
7	23754498	.	G	A	8	4	12	0	0	12	0	0
7	23754927	.	T	C	4	3	7	0	0	7	0	0
7	23755668	.	G	C	3	2	5	0	0	5	0	0
7	23756545	.	C	T	2	3	5	0	0	5	0	0
7	23756639	.	A	T	1	2	3	0	0	3	0	0
7	23756644	.	A	C	3	2	5	0	0	5	0	0
7	23768153	.	G	A	1	3	4	0	1	5	0	0
7	23768222	.	C	A	4	7	11	0	0	11	0	0
7	23857608	.	A	G	4	2	6	0	0	6	0	0
7	23857647	.	G	C	3	3	6	0	0	6	0	0
7	23857939	.	C	A	5	2	7	0	0	7	0	0
7	23883399	.	G	A	9	8	17	0	0	17	0	0
7	23883548	.	A	C	15	17	32	0	4	36	0	0
7	23883970	.	C	T	10	12	22	0	1	23	0	0
7	23884004	.	G	A	12	16	28	0	2	30	0	0
7	23884058	.	T	C	13	17	30	0	3	33	0	0
7	23884061	.	C	G	14	19	33	0	2	35	0	0
7	23884445	.	C	T	25	26	51	0	5	56	0	0
7	23884641	.	A	G	24	0	24	0	15	39	0	0
7	23884667	.	C	A	20	13	33	0	4	37	0	0
7	23887177	.	A	C	1	2	3	0	0	3	0	0
7	23887218	.	G	A	1	2	3	0	0	3	0	0
7	23887604	.	C	G	7	9	16	0	0	16	0	0
7	23887738	.	T	G	5	5	10	0	0	10	0	0
7	23887784	.	C	T	6	10	16	0	0	16	0	0
7	23887865	.	T	C	10	18	28	0	0	28	0	0
7	23888099	.	A	G	8	9	17	0	2	19	0	0
7	23888155	.	T	G	14	13	27	0	1	28	0	0
7	23889947	.	C	T	17	14	31	0	2	33	0	0
7	23892884	.	G	A	9	6	15	0	1	16	0	0
7	23894605	.	G	A	15	14	29	0	3	32	0	0
7	23907784	.	G	T	11	13	24	0	0	24	0	0
7	23907785	.	C	A	14	11	25	0	1	26	0	0
7	23909699	.	C	G	22	0	22	0	11	33	0	0
7	23909735	.	T	C	19	12	31	0	1	32	0	0
7	23909757	.	C	T	22	7	29	0	2	31	0	0
7	23909975	.	A	G	16	18	34	0	3	37	0	0
7	23915203	.	C	T	37	18	55	0	4	59	0	0
7	23915359	.	G	A	2	23	25	0	32	57	0	0
7	23915485	.	A	T	34	19	53	0	5	59	1	0
7	23915700	.	G	T	22	7	29	0	6	35	0	0
7	23915916	.	T	A	33	30	63	1	1	65	0	0
7	23967878	.	G	A	18	18	36	0	1	37	0	0
7	23968108	.	G	A	13	14	27	0	0	27	0	0
7	23968267	.	A	C	11	8	19	0	0	19	0	0
7	23968292	.	T	G	12	8	20	0	5	25	0	0
7	23968330	.	C	G	11	10	21	0	1	22	0	0
7	23968344	.	C	T	12	8	20	0	0	20	0	0
7	23969163	.	G	A	7	4	11	0	0	11	0	0
7	23969191	.	C	T	0	5	5	0	8	13	0	0
7	23969226	.	G	A	6	5	11	0	1	12	0	0
7	23969361	.	G	A	8	6	14	0	0	14	0	0
7	23969535	.	G	A	14	10	24	0	0	24	0	0
7	23970320	.	G	T	12	10	22	0	0	22	0	0
7	23970331	.	G	A	14	10	24	0	2	26	0	0
7	23970559	.	T	G	3	7	10	0	0	10	0	0
7	23970588	.	A	T	4	1	5	0	1	6	0	0
7	23970972	.	T	C	1	3	4	0	0	4	0	0
7	23970978	.	T	C	1	3	4	0	0	4	0	0
7	23971209	.	C	A	4	4	8	0	0	8	0	0
7	23971418	.	T	C	7	8	15	0	2	17	0	0
7	23971627	.	G	A	2	11	13	0	3	16	0	0
7	23971636	.	C	A	11	5	16	0	0	17	1	0
7	23971682	.	T	A	12	4	16	0	1	17	0	0
7	23974326	.	T	A	5	3	8	0	0	8	0	0
7	23977711	.	T	C	4	5	9	0	0	9	0	0
7	23977905	.	A	C	2	2	4	0	0	4	0	0
7	23977915	.	C	T	2	1	3	0	0	3	0	0
7	24007097	.	A	G	1	2	3	0	0	3	0	0
7	24007222	.	T	C	1	3	4	0	0	4	0	0
7	24011474	.	C	A	2	3	5	0	0	5	0	0
7	24012239	.	G	A	5	2	7	0	1	8	0	0
7	24012794	.	T	C	7	8	15	0	0	15	0	0
7	24013044	.	A	G	6	0	6	0	6	12	0	0
7	24013269	.	G	A	5	6	11	0	0	11	0	0
7	24013274	.	A	C	6	4	10	0	0	10	0	0
7	24013489	.	G	A	0	8	8	0	7	15	0	0
7	24013560	.	T	C	8	5	13	0	0	13	0	0
7	24013662	.	C	A	7	9	16	0	0	16	0	0
7	24031838	.	G	A	0	3	3	0	5	8	0	0
7	24033572	.	T	A	1	2	3	0	0	3	0	0
7	24036340	.	G	A	2	2	4	0	0	4	0	0
7	24039773	.	T	C	5	3	8	0	0	8	0	0
7	24039800	.	C	A	2	2	4	0	1	5	0	0
7	24067056	.	G	T	2	3	5	0	1	6	0	0
7	24067359	.	C	T	1	6	7	0	0	7	0	0
7	24067403	.	A	T	6	8	14	0	0	14	0	0
7	24067571	.	C	T	8	8	16	0	1	17	0	0
7	24067611	.	C	T	6	10	16	0	1	17	0	0
7	24067906	.	C	A	5	10	15	0	0	15	0	0
7	24067907	.	T	A	5	10	15	0	0	15	0	0
7	24068224	.	A	T	6	5	11	0	1	12	0	0
7	24068230	.	C	T	8	5	13	0	1	14	0	0
7	24068491	.	C	T	11	7	18	0	2	20	0	0
7	24068523	.	C	A	13	8	21	0	2	23	0	0
7	24068586	.	C	T	6	6	12	0	0	12	0	0
7	24068722	.	T	C	2	3	5	0	0	5	0	0
7	24068904	.	T	A	2	5	7	0	0	7	0	0
7	24084879	.	C	T	7	6	13	0	0	13	0	0
7	24084887	.	G	A	0	5	5	0	9	14	0	0
7	24087622	.	T	A	4	2	6	0	0	6	0	0
7	24090128	.	A	G	12	0	12	0	13	25	0	0
7	24091054	.	G	A	12	16	28	0	0	28	0	0
7	24091249	.	A	G	9	13	22	0	1	23	0	0
7	24093102	.	C	T	20	18	38	0	0	38	0	0
7	24093105	.	C	T	22	18	40	0	1	41	0	0
7	24093165	.	C	G	22	13	35	0	0	35	0	0
7	24093372	.	A	G	14	15	29	0	3	32	0	0
7	24095515	.	C	G	24	18	42	0	3	45	0	0
7	24095776	.	G	A	16	19	35	0	4	39	0	0
7	24095926	.	A	C	8	20	28	0	0	28	0	0
7	24096015	.	C	T	20	18	38	0	1	39	0	0
7	24096165	.	T	C	22	16	38	1	0	39	0	0
7	24096195	.	C	G	19	17	36	0	1	37	0	0
7	24096399	.	C	A	18	18	36	2	3	41	0	0
7	24096447	.	T	G	16	24	40	0	3	43	0	0
7	24096505	.	G	A	1	13	14	1	22	37	0	0
7	24096767	.	A	C	16	20	36	0	7	43	0	0
7	24100511	.	G	A	2	4	6	0	0	6	0	0
7	24100743	.	A	C	4	0	4	0	3	7	0	0
7	24100761	.	C	T	3	3	6	0	0	6	0	0
7	24115186	.	G	A	19	11	30	0	1	31	0	0
7	24124438	.	A	G	1	2	3	0	0	3	0	0
7	24125476	.	G	A	5	5	10	0	0	10	0	0
7	24161648	.	G	A	1	16	17	0	4	21	0	0
7	24161776	.	C	G	9	8	17	0	0	17	0	0
7	24161786	.	G	C	11	6	17	0	2	19	0	0
7	24162047	.	T	A	5	8	13	0	0	13	0	0
7	24162267	.	G	T	10	15	25	0	0	25	0	0
7	24162457	.	T	C	10	8	18	0	0	18	0	0
7	24162485	.	C	T	8	13	21	0	2	23	0	0
7	24162782	.	G	A	5	3	8	0	1	9	0	0
7	24197622	.	G	T	4	7	11	0	0	11	0	0
7	24197656	.	C	A	1	4	5	0	1	6	0	0
7	24197762	.	A	G	6	6	12	0	1	13	0	0
7	24197793	.	C	T	1	10	11	0	6	17	0	0
7	24197841	.	G	A	9	4	13	0	0	13	0	0
7	24197916	.	A	G	9	4	13	0	1	14	0	0
7	24198281	.	T	C	3	4	7	0	1	8	0	0
7	24198282	.	T	C	5	3	8	0	1	9	0	0
7	24198334	.	C	T	9	3	12	0	0	12	0	0
7	24198335	.	C	T	0	3	3	0	9	12	0	0
7	24200112	.	A	G	6	7	13	0	0	13	0	0
7	24201447	.	A	T	6	6	12	0	0	12	0	0
7	24201453	.	G	A	6	6	12	0	0	12	0	0
7	24201686	.	A	G	4	8	12	0	0	12	0	0
7	24204166	.	T	A	2	4	6	0	0	6	0	0
7	24205077	.	C	A	9	12	21	0	2	23	0	0
7	24207520	.	A	C	16	18	34	0	1	36	1	0
7	24207552	.	A	G	15	0	15	0	25	41	1	0
7	24207590	.	A	T	25	17	42	0	3	45	0	0
7	24207632	.	G	C	16	16	32	0	1	33	0	0
7	24210121	.	T	C	3	2	5	0	1	6	0	0
7	24210422	.	T	C	15	18	33	0	3	36	0	0
7	24210913	.	T	C	12	0	12	0	18	30	0	0
7	24211015	.	A	T	14	14	28	1	0	29	0	0
7	24211027	.	G	T	14	10	24	1	0	25	0	0
7	24211054	.	G	A	6	20	26	0	1	27	0	0
7	24211081	.	T	A	9	18	27	0	1	28	0	0
7	24211104	.	C	T	1	12	13	0	13	26	0	0
7	24211542	.	G	T	5	2	7	0	1	8	0	0
7	24211646	.	C	T	1	4	5	0	8	13	0	0
7	24211672	.	A	T	4	4	8	0	1	9	0	0
7	24211778	.	T	A	2	2	4	0	0	4	0	0
7	24211779	.	T	A	2	2	4	0	0	4	0	0
7	24211978	.	G	A	11	10	21	2	0	23	0	0
7	24212159	.	G	C	6	3	9	0	10	19	0	0
7	24213387	.	A	T	4	5	9	0	0	9	0	0
7	24213401	.	G	A	6	5	11	0	1	12	0	0
7	24213426	.	G	A	10	6	16	0	0	16	0	0
7	24357396	.	C	T	0	1	1	0	5	6	0	0
7	24357403	.	C	T	4	4	8	0	1	9	0	0
7	24382122	.	T	C	6	3	9	0	2	11	0	0
7	24457647	.	A	T	37	29	66	0	1	67	0	0
7	24457845	.	T	C	35	7	42	0	1	43	0	0
7	24458128	.	G	C	30	20	50	0	0	50	0	0
7	24458282	.	C	T	32	13	45	0	0	45	0	0
7	24458345	.	C	A	24	25	49	0	1	50	0	0
7	24458349	.	A	C	26	25	51	0	1	52	0	0
7	24458513	.	T	C	21	16	37	1	4	42	0	0
7	24458713	.	T	C	12	1	13	0	19	32	0	0
7	24458717	.	G	A	13	14	27	0	2	29	0	0
7	24458866	.	T	C	15	16	31	0	4	35	0	0
7	24458894	.	T	A	17	21	38	0	1	39	0	0
7	24459667	.	T	A	19	14	33	0	1	34	0	0
7	24459847	.	A	G	21	14	35	0	2	37	0	0
7	24459932	.	T	C	17	24	41	0	1	42	0	0
7	24460443	.	G	A	16	20	36	0	1	37	0	0
7	24460461	.	G	A	17	18	35	0	1	36	0	0
7	24461115	.	A	C	12	13	25	0	4	29	0	0
7	24461298	.	G	A	10	8	18	0	1	19	0	0
7	24461601	.	A	G	10	8	18	0	0	18	0	0
7	24462394	.	A	G	7	6	13	1	1	15	0	0
7	24485201	.	A	G	1	2	3	0	0	3	0	0
7	24485214	.	A	T	1	2	3	0	0	3	0	0
7	24485558	.	G	T	8	3	11	0	2	13	0	0
7	24486345	.	A	G	21	22	43	0	0	43	0	0
7	24486515	.	A	C	36	29	65	0	2	67	0	0
7	24486721	.	G	A	34	34	68	0	6	74	0	0
7	24491382	.	G	A	35	27	62	0	4	66	0	0
7	24497012	.	G	A	3	2	5	0	0	5	0	0
7	24498912	.	C	T	6	5	11	0	1	12	0	0
7	24501133	.	G	A	1	2	3	0	9	12	0	0
7	24501156	.	T	C	5	3	8	0	1	9	0	0
7	24501168	.	T	C	3	5	8	0	1	9	0	0
7	24502016	.	C	T	6	3	9	0	3	12	0	0
7	24502858	.	G	A	2	10	12	0	18	30	0	0
7	24502867	.	C	T	14	11	25	0	0	25	0	0
7	24502948	.	C	T	4	7	11	0	2	13	0	0
7	24504508	.	C	T	7	10	17	0	2	19	0	0
7	24504875	.	C	T	13	5	18	0	1	19	0	0
7	24505063	.	A	G	4	6	10	0	0	10	0	0
7	24505321	.	T	C	4	2	6	0	0	6	0	0
7	24570380	.	A	G	5	2	7	0	0	7	0	0
7	24672766	.	A	G	4	2	6	0	0	6	0	0
7	25293646	.	C	T	5	2	7	0	1	8	0	0
7	25843605	.	A	C	2	4	6	0	0	6	0	0
7	25843643	.	A	G	1	0	1	0	3	4	0	0
7	25843661	.	G	A	1	2	3	0	0	3	0	0
7	25846430	.	G	A	0	2	2	0	1	3	0	0
7	25852549	.	A	G	5	0	5	0	3	8	0	0
7	25854380	.	C	T	5	3	8	0	0	8	0	0
7	25858611	.	C	A	4	3	7	0	0	7	0	0
7	25863631	.	C	T	7	6	13	0	1	14	0	0
7	25863708	.	C	T	11	6	17	0	0	17	0	0
7	25869617	.	C	T	5	8	13	0	1	14	0	0
7	25869960	.	C	T	2	3	5	0	3	8	0	0
7	25870003	.	C	T	8	5	13	0	0	13	0	0
7	25870065	.	C	T	10	8	18	0	1	19	0	0
7	25870068	.	T	C	10	7	17	0	1	18	0	0
7	25876947	.	A	C	7	10	17	0	2	19	0	0
7	25877215	.	C	A	4	8	12	0	2	14	0	0
7	25877254	.	A	C	3	2	5	0	1	6	0	0
7	25877541	.	T	A	5	8	13	1	0	14	0	0
7	25877553	.	G	A	1	7	8	1	4	13	0	0
7	25878282	.	G	A	18	26	44	0	0	44	0	0
7	25878901	.	G	A	17	27	44	0	2	46	0	0
7	25878977	.	A	G	27	19	46	0	4	50	0	0
7	25879116	.	T	G	19	29	48	0	5	53	0	0
7	25879130	.	G	C	17	34	51	0	4	55	0	0
7	25879534	.	C	T	21	24	45	0	4	49	0	0
7	25879637	.	A	G	19	19	38	5	3	46	0	0
7	25879787	.	C	G	16	23	39	0	2	41	0	0
7	25879936	.	G	T	16	22	38	0	0	38	0	0
7	25880046	.	C	A	14	18	32	0	1	33	0	0
7	25880207	.	T	A	11	10	21	0	1	22	0	0
7	25880313	.	T	A	13	24	37	0	4	41	0	0
7	25880413	.	G	A	22	24	46	0	3	49	0	0
7	25880730	.	G	T	16	10	26	0	5	31	0	0
7	25880737	.	C	T	0	8	8	0	23	31	0	0
7	25880979	.	C	G	11	21	32	0	3	35	0	0
7	25881103	.	T	G	12	10	22	0	2	24	0	0
7	25881215	.	C	T	13	17	30	0	3	33	0	0
7	25881303	.	C	T	19	13	32	0	0	32	0	0
7	25881589	.	C	T	24	6	30	0	10	40	0	0
7	25881605	.	A	C	12	21	33	1	1	35	0	0
7	25884148	.	A	G	11	12	23	0	0	23	0	0
7	25895150	.	A	G	6	3	9	0	0	9	0	0
7	25895154	.	G	T	6	3	9	0	0	9	0	0
7	25917046	.	A	G	39	27	66	0	4	70	0	0
7	25917473	.	G	A	4	26	30	2	33	65	0	0
7	25917634	.	A	T	43	25	68	0	3	71	0	0
7	25918101	.	T	G	29	2	31	0	27	58	0	0
7	25918112	.	A	T	29	26	55	0	2	57	0	0
7	25920966	.	A	G	12	0	12	0	12	24	0	0
7	25979372	.	C	T	5	7	12	0	0	12	0	0
7	25979417	.	C	T	5	10	15	0	1	16	0	0
7	25979468	.	C	T	17	9	26	0	2	28	0	0
7	25986069	.	G	T	1	13	14	0	12	26	0	0
7	25986099	.	C	T	12	14	26	0	0	26	0	0
7	25986186	.	A	G	14	1	15	0	11	26	0	0
7	25988324	.	C	A	12	12	24	0	2	26	0	0
7	25998602	.	C	T	19	24	43	0	3	46	0	0
7	26002812	.	T	C	17	20	37	0	4	41	0	0
7	26003424	.	G	A	15	20	35	0	4	39	0	0
7	26003853	.	C	T	6	7	13	0	0	13	0	0
7	26004014	.	G	T	6	4	10	0	0	10	0	0
7	26004391	.	C	A	14	11	25	0	2	27	0	0
7	26004519	.	G	A	7	8	15	0	2	17	0	0
7	26005574	.	A	T	3	2	5	0	0	5	0	0
7	26020078	.	T	C	11	9	20	0	0	20	0	0
7	26020174	.	A	T	11	7	18	0	0	18	0	0
7	26020273	.	G	A	0	6	6	0	12	18	0	0
7	26020370	.	T	C	6	10	16	0	1	17	0	0
7	26020408	.	A	C	6	11	17	0	0	17	0	0
7	26026220	.	A	T	10	14	24	0	2	26	0	0
7	26026298	.	T	G	9	0	9	0	9	18	0	0
7	26026330	.	A	T	10	11	21	0	0	21	0	0
7	26026358	.	A	C	7	7	14	0	0	14	0	0
7	26026375	.	G	A	5	8	13	0	0	13	0	0
7	26026491	.	T	G	3	6	9	0	1	10	0	0
7	26048375	.	G	A	1	2	3	0	0	3	0	0
7	26073519	.	A	T	10	7	17	0	0	17	0	0
7	26074160	.	C	A	4	11	15	0	2	17	0	0
7	26076458	.	A	T	3	2	5	0	0	5	0	0
7	26078243	.	A	C	22	17	39	0	2	41	0	0
7	26078284	.	C	T	20	23	43	0	1	44	0	0
7	26078435	.	G	T	10	15	25	0	4	29	0	0
7	26078967	.	A	G	26	20	46	0	6	52	0	0
7	26078983	.	G	A	22	19	41	0	0	41	0	0
7	26079370	.	T	G	21	21	42	0	2	44	0	0
7	26081171	.	C	T	17	11	28	0	1	29	0	0
7	26081546	.	T	G	4	9	13	0	2	15	0	0
7	26081951	.	T	C	6	8	14	0	0	14	0	0
7	26116554	.	A	G	1	2	3	0	0	3	0	0
7	26116586	.	G	A	1	2	3	0	0	3	0	0
7	26116600	.	C	A	1	1	2	0	1	3	0	0
7	26116876	.	A	G	1	7	8	0	0	8	0	0
7	26118564	.	T	C	1	2	3	0	0	3	0	0
7	26118734	.	T	C	3	0	3	0	3	6	0	0
7	26118856	.	C	T	4	2	6	0	1	7	0	0
7	26118930	.	T	G	2	3	5	0	0	5	0	0
7	26140767	.	A	G	7	10	17	0	0	17	0	0
7	26141022	.	C	T	13	9	22	0	0	22	0	0
7	26141310	.	C	T	11	7	18	0	2	20	0	0
7	26141519	.	T	A	10	9	19	0	0	19	0	0
7	26141853	.	C	T	8	6	14	0	0	14	0	0
7	26142315	.	T	A	5	4	9	0	1	11	1	0
7	26142339	.	T	C	7	4	11	0	0	11	0	0
7	26142489	.	G	A	15	7	22	0	0	22	0	0
7	26142525	.	T	G	15	0	15	0	9	24	0	0
7	26142606	.	G	A	3	9	12	0	20	32	0	0
7	26143022	.	G	A	11	7	18	0	3	21	0	0
7	26143501	.	T	C	8	13	21	0	2	23	0	0
7	26143668	.	G	T	3	11	14	0	9	23	0	0
7	26144271	.	A	G	16	0	16	0	15	31	0	0
7	26144305	.	T	A	17	14	31	0	2	33	0	0
7	26144440	.	C	T	2	2	4	0	0	4	0	0
7	26144628	.	C	T	1	7	8	0	1	9	0	0
7	26144684	.	A	G	2	5	7	0	1	8	0	0
7	26144882	.	A	G	10	1	11	0	21	32	0	0
7	26144944	.	A	G	20	2	22	0	10	32	0	0
7	26145252	.	A	C	21	14	35	0	0	36	1	0
7	26145267	.	T	A	24	14	38	0	0	38	0	0
7	26145329	.	T	A	27	16	43	0	2	45	0	0
7	26145441	.	C	G	17	13	30	0	2	33	1	0
7	26145451	.	A	G	21	11	32	0	1	33	0	0
7	26145491	.	G	A	28	10	38	0	0	38	0	0
7	26145492	.	G	A	27	8	35	0	3	38	0	0
7	26145605	.	T	C	26	22	48	0	0	48	0	0
7	26145703	.	C	T	4	3	7	0	0	7	0	0
7	26146176	.	A	C	33	13	46	0	4	50	0	0
7	26146188	.	T	C	29	17	46	0	3	49	0	0
7	26146411	.	T	C	31	26	57	1	2	60	0	0
7	26146952	.	A	G	35	30	65	0	1	66	0	0
7	26146998	.	G	A	3	32	35	0	33	68	0	0
7	26147167	.	T	C	29	29	58	0	1	59	0	0
7	26147756	.	C	T	34	34	68	0	2	70	0	0
7	26148169	.	C	T	39	26	65	1	3	69	0	0
7	26148181	.	A	C	35	25	60	1	8	69	0	0
7	26148312	.	T	G	23	25	48	0	1	49	0	0
7	26148567	.	T	C	34	24	58	0	2	60	0	0
7	26148796	.	C	T	12	4	16	0	2	18	0	0
7	26149067	.	C	T	15	21	36	0	4	40	0	0
7	26149069	.	A	T	17	22	39	0	2	41	0	0
7	26224320	.	A	G	7	9	16	0	0	16	0	0
7	26224365	.	A	T	7	7	14	0	0	14	0	0
7	26226772	.	G	C	9	10	19	0	1	20	0	0
7	26226977	.	C	T	13	10	23	0	0	23	0	0
7	26227149	.	C	T	6	10	16	0	3	19	0	0
7	26227242	.	T	C	9	14	23	0	1	24	0	0
7	26227527	.	T	C	16	9	25	0	2	27	0	0
7	26227539	.	T	C	13	12	25	0	1	26	0	0
7	26228639	.	T	C	17	27	44	0	0	44	0	0
7	26229449	.	G	A	17	18	35	0	4	39	0	0
7	26229551	.	T	A	27	22	49	0	5	54	0	0
7	26229584	.	G	A	2	21	23	3	37	63	0	0
7	26229640	.	T	C	33	18	51	0	6	57	0	0
7	26229935	.	C	T	29	9	38	0	2	40	0	0
7	26229979	.	A	G	13	5	18	0	5	23	0	0
7	26245318	.	T	A	24	16	40	0	0	40	0	0
7	26245668	.	T	C	13	17	30	0	1	31	0	0
7	26245714	.	A	T	16	17	33	0	1	34	0	0
7	26246528	.	T	C	14	0	14	0	7	21	0	0
7	26263174	.	T	C	4	0	4	0	4	8	0	0
7	26265832	.	C	A	0	3	3	0	1	4	0	0
7	26266069	.	G	C	1	8	9	0	1	10	0	0
7	26266096	.	A	G	2	7	9	0	0	9	0	0
7	26266126	.	T	C	4	1	5	0	13	18	0	0
7	26300359	.	A	G	5	3	8	1	0	9	0	0
7	26300506	.	C	T	6	3	9	0	0	9	0	0
7	26303299	.	G	C	1	0	1	0	2	3	0	0
7	26366778	.	G	A	6	7	13	0	0	13	0	0
7	26366846	.	C	T	1	11	12	0	15	27	0	0
7	26366897	.	A	C	10	6	16	0	1	17	0	0
7	26366919	.	G	A	7	7	14	0	3	17	0	0
7	26366991	.	C	T	2	14	16	0	12	28	0	0
7	26367111	.	T	C	11	6	17	0	1	18	0	0
7	26367218	.	G	C	11	12	23	0	3	26	0	0
7	26367260	.	A	T	12	12	24	0	0	24	0	0
7	26367328	.	T	A	9	2	11	0	0	11	0	0
7	26367486	.	A	C	4	3	7	0	0	7	0	0
7	26367525	.	A	G	6	6	12	0	0	12	0	0
7	26367595	.	A	C	7	0	7	0	8	15	0	0
7	26367628	.	A	G	6	8	14	0	1	15	0	0
7	26367764	.	C	T	4	7	11	0	0	11	0	0
7	26367797	.	T	C	7	4	11	0	0	11	0	0
7	26367944	.	G	A	8	3	11	0	0	11	0	0
7	26368087	.	G	C	5	7	12	0	0	12	0	0
7	26368240	.	C	A	8	6	14	0	1	15	0	0
7	26368291	.	A	C	7	3	10	0	0	10	0	0
7	26368483	.	T	A	5	4	9	0	0	9	0	0
7	26368531	.	C	T	1	3	4	0	0	4	0	0
7	26368719	.	C	A	4	3	7	0	0	7	0	0
7	26368881	.	T	C	12	1	13	0	2	15	0	0
7	26368897	.	C	A	10	5	15	0	2	17	0	0
7	26369061	.	T	A	3	4	7	1	0	8	0	0
7	26369230	.	A	C	4	1	5	0	1	6	0	0
7	26369240	.	G	A	4	2	6	0	0	6	0	0
7	26369394	.	T	C	3	7	10	0	1	11	0	0
7	26369439	.	T	C	4	0	4	0	3	7	0	0
7	26369583	.	A	C	6	0	6	0	10	16	0	0
7	26371702	.	G	A	9	3	12	0	0	12	0	0
7	26378455	.	A	G	5	4	9	0	0	9	0	0
7	26394208	.	A	T	15	16	31	0	3	34	0	0
7	26394285	.	A	T	14	13	27	1	3	31	0	0
7	26394382	.	C	T	3	22	25	0	10	35	0	0
7	26394476	.	G	A	16	18	34	0	2	36	0	0
7	26394848	.	G	A	16	16	32	0	1	33	0	0
7	26395215	.	C	G	1	3	4	0	1	5	0	0
7	26395359	.	G	A	10	8	18	0	0	18	0	0
7	26395380	.	A	C	9	8	17	0	1	18	0	0
7	26395538	.	T	C	15	6	21	0	2	23	0	0
7	26395625	.	T	A	7	8	15	0	0	15	0	0
7	26395778	.	T	G	9	4	13	0	1	14	0	0
7	26395816	.	T	C	7	7	14	0	0	14	0	0
7	26396013	.	T	A	18	12	30	0	0	30	0	0
7	26396418	.	A	T	7	9	16	0	0	16	0	0
7	26396506	.	T	A	4	8	12	0	0	12	0	0
7	26396560	.	C	G	5	6	11	0	0	11	0	0
7	26396783	.	C	G	1	7	8	1	14	23	0	0
7	26396886	.	G	A	5	11	16	0	0	16	0	0
7	26396915	.	A	C	8	8	16	0	2	18	0	0
7	26397129	.	A	G	5	8	13	0	0	13	0	0
7	26397289	.	G	A	3	2	5	0	1	6	0	0
7	26397336	.	C	T	0	11	11	0	9	20	0	0
7	26397365	.	A	T	9	11	20	0	1	21	0	0
7	26397475	.	T	A	8	4	12	0	2	14	0	0
7	26397760	.	C	T	7	6	13	0	1	14	0	0
7	26397838	.	T	C	2	4	6	0	0	6	0	0
7	26398189	.	C	T	6	9	15	0	0	15	0	0
7	26398360	.	G	A	8	6	14	0	2	16	0	0
7	26398867	.	G	A	9	6	15	0	0	15	0	0
7	26402680	.	C	A	3	8	11	0	1	12	0	0
7	26402788	.	T	G	4	3	7	0	0	7	0	0
7	26432001	.	A	T	1	2	3	0	0	3	0	0
7	26432002	.	A	C	1	2	3	0	0	3	0	0
7	26432073	.	G	C	5	4	9	0	0	9	0	0
7	26432306	.	T	C	5	2	7	0	0	7	0	0
7	26432403	.	A	G	5	5	10	0	0	10	0	0
7	26432464	.	A	T	3	1	4	0	2	6	0	0
7	26432553	.	C	T	0	5	5	0	7	12	0	0
7	26432649	.	G	A	4	2	6	0	0	6	0	0
7	26472244	.	G	A	10	3	13	0	0	13	0	0
7	26472258	.	A	G	8	0	8	0	5	13	0	0
7	26472290	.	C	T	7	9	16	0	0	16	0	0
7	26472333	.	T	A	10	6	16	0	0	16	0	0
7	26472413	.	A	G	7	3	10	0	1	11	0	0
7	26472489	.	T	C	6	3	9	0	0	9	0	0
7	26472522	.	C	T	2	3	5	0	1	6	0	0
7	26472663	.	T	G	4	4	8	0	0	8	0	0
7	26472676	.	A	G	3	6	9	0	0	9	0	0
7	26472971	.	C	G	4	3	7	0	3	10	0	0
7	26473040	.	A	G	5	0	5	0	8	13	0	0
7	26473408	.	T	C	6	2	8	0	0	8	0	0
7	26473435	.	G	A	4	2	6	0	1	7	0	0
7	26511439	.	A	T	27	14	41	0	3	44	0	0
7	26511691	.	G	A	16	21	37	0	7	44	0	0
7	26511760	.	A	G	24	17	41	0	1	42	0	0
7	26511801	.	T	G	12	19	31	0	3	34	0	0
7	26519052	.	A	G	5	6	11	0	1	12	0	0
7	26519150	.	A	T	16	15	31	0	0	31	0	0
7	26522358	.	T	C	14	5	19	0	2	21	0	0
7	26522364	.	C	T	14	5	19	0	1	20	0	0
7	26523169	.	A	G	7	7	14	0	1	15	0	0
7	26525463	.	C	T	6	9	15	0	0	15	0	0
7	27013123	.	T	G	4	0	4	0	6	10	0	0
7	27449597	.	A	T	2	1	3	0	0	3	0	0
7	28042060	.	G	A	6	8	14	0	1	15	0	0
7	28042070	.	A	C	8	5	13	0	0	13	0	0
7	28044339	.	A	G	4	5	9	0	0	9	0	0
7	28044640	.	A	G	6	5	11	0	0	11	0	0
7	29109604	.	A	G	11	5	16	0	0	16	0	0
7	29177427	.	T	C	4	7	11	0	0	11	0	0
7	29182296	.	T	G	8	0	8	0	4	12	0	0
7	29182733	.	A	G	3	12	15	0	0	15	0	0
7	29185910	.	C	G	11	0	11	0	4	15	0	0
7	29186433	.	T	C	10	15	25	0	2	27	0	0
7	29186453	.	A	C	13	18	31	0	0	31	0	0
7	29186483	.	C	T	10	14	24	0	2	26	0	0
7	29186504	.	T	C	11	13	24	0	2	26	0	0
7	29186549	.	T	C	7	12	19	0	1	20	0	0
7	29186589	.	C	G	6	0	6	0	8	14	0	0
7	29186605	.	T	C	7	6	13	0	1	14	0	0
7	29186640	.	G	A	8	3	11	0	0	11	0	0
7	29186677	.	C	T	2	6	8	0	0	8	0	0
7	29189503	.	C	A	12	21	33	0	1	34	0	0
7	29192331	.	C	T	2	13	15	0	21	36	0	0
7	29199576	.	A	T	7	15	22	0	1	23	0	0
7	29204945	.	T	C	4	4	8	0	0	8	0	0
7	29205418	.	T	G	6	11	17	0	0	17	0	0
7	29207187	.	A	G	4	6	10	0	0	10	0	0
7	29207208	.	T	A	6	4	10	0	0	10	0	0
7	29210014	.	G	A	3	2	5	0	0	5	0	0
7	29210755	.	G	A	1	5	6	0	3	9	0	0
7	29220161	.	G	A	1	2	3	0	0	3	0	0
7	29223536	.	G	T	3	2	5	0	0	5	0	0
7	29227361	.	A	G	2	3	5	0	0	5	0	0
7	29227602	.	G	A	5	2	7	0	1	8	0	0
7	29234155	.	C	T	0	2	2	0	2	4	0	0
7	29235738	.	C	G	1	3	4	0	0	4	0	0
7	29301751	.	C	T	6	2	8	0	1	9	0	0
7	29309315	.	A	C	7	5	12	0	0	12	0	0
7	29309454	.	C	T	4	4	8	0	0	8	0	0
7	29309726	.	G	A	7	4	11	0	1	12	0	0
7	29309897	.	T	C	1	6	7	0	1	8	0	0
7	29309946	.	T	C	5	6	11	0	1	12	0	0
7	29310537	.	C	T	9	9	18	0	1	19	0	0
7	29310543	.	G	A	1	9	10	0	11	21	0	0
7	29310618	.	G	A	6	13	19	0	0	19	0	0
7	29310654	.	C	T	4	8	12	0	2	14	0	0
7	29310700	.	G	A	3	5	8	0	0	8	0	0
7	29355244	.	G	C	17	0	17	0	9	26	0	0
7	29356006	.	A	C	12	0	12	0	19	31	0	0
7	29539862	.	T	C	11	6	17	0	0	17	0	0
7	29540207	.	A	G	6	6	12	0	1	13	0	0
7	29540311	.	A	C	17	5	22	0	1	23	0	0
7	29540536	.	A	T	9	12	21	1	1	23	0	0
7	29540537	.	C	T	2	12	14	1	9	24	0	0
7	29540885	.	T	A	13	14	27	0	3	30	0	0
7	29540999	.	A	G	21	15	36	0	2	38	0	0
7	29542909	.	T	G	8	5	13	0	0	13	0	0
7	29542916	.	T	C	9	5	14	0	0	14	0	0
7	29553338	.	G	A	2	10	12	0	0	12	0	0
7	29553446	.	G	A	6	7	13	0	0	13	0	0
7	29553473	.	G	A	6	5	11	0	0	11	0	0
7	29625326	.	C	T	1	2	3	0	0	3	0	0
7	29633693	.	T	C	3	6	9	0	0	9	0	0
7	29651413	.	C	T	0	3	3	0	2	5	0	0
7	29653500	.	C	T	0	3	3	0	3	6	0	0
7	29674982	.	A	G	1	2	3	0	0	3	0	0
7	29674985	.	C	T	0	2	2	0	1	3	0	0
7	29911385	.	G	C	1	2	3	0	0	3	0	0
7	29923340	.	A	G	1	2	3	0	0	3	0	0
7	29930351	.	G	A	2	3	5	0	0	5	0	0
7	29930445	.	C	T	1	2	3	0	0	3	0	0
7	29930576	.	G	A	0	3	3	0	1	4	0	0
7	29936168	.	C	T	4	1	5	0	1	6	0	0
7	29942050	.	A	T	11	5	16	0	1	17	0	0
7	29944366	.	G	C	1	13	14	0	10	24	0	0
7	29944461	.	T	C	7	6	13	0	0	13	0	0
7	29944676	.	C	A	7	7	14	0	0	14	0	0
7	29944881	.	G	C	0	3	3	0	9	12	0	0
7	29944935	.	A	T	5	2	7	0	0	7	0	0
7	29945050	.	A	T	8	6	14	0	1	15	0	0
7	29945136	.	G	A	4	2	6	0	0	6	0	0
7	29945482	.	A	G	8	7	15	0	3	18	0	0
7	29945513	.	A	G	9	5	14	0	2	16	0	0
7	29945609	.	C	A	13	5	18	0	2	20	0	0
7	29945659	.	A	G	7	0	7	0	7	14	0	0
7	29945732	.	C	G	17	7	24	0	1	25	0	0
7	29945758	.	G	A	15	4	19	0	1	20	0	0
7	29945881	.	A	T	13	16	29	0	5	34	0	0
7	29961038	.	G	A	7	5	12	0	0	12	0	0
7	29961106	.	C	T	9	4	13	0	2	15	0	0
7	29961455	.	G	C	13	5	18	0	3	21	0	0
7	29961479	.	A	T	15	5	20	0	0	20	0	0
7	29961567	.	C	T	15	10	25	0	1	26	0	0
7	29961649	.	G	A	5	2	7	0	0	7	0	0
7	29961876	.	T	C	8	6	14	0	1	15	0	0
7	29964289	.	A	G	4	6	10	0	0	10	0	0
7	29964713	.	G	A	2	4	6	0	1	7	0	0
7	29966892	.	A	G	3	3	6	0	1	7	0	0
7	29968144	.	T	C	1	8	9	0	0	9	0	0
7	29968298	.	G	A	4	3	7	0	2	9	0	0
7	29968454	.	T	A	5	4	9	0	1	10	0	0
7	29968505	.	G	A	3	6	9	0	1	10	0	0
7	29969008	.	A	G	1	6	7	0	0	7	0	0
7	29969280	.	A	G	7	5	12	0	1	13	0	0
7	29969281	.	A	G	7	5	12	0	1	13	0	0
7	29969555	.	A	G	4	5	9	0	2	11	0	0
7	29969566	.	A	G	7	3	10	0	0	10	0	0
7	29969996	.	A	T	3	3	6	0	0	6	0	0
7	29970194	.	T	G	4	3	7	0	0	7	0	0
7	29970195	.	C	T	4	3	7	0	0	7	0	0
7	29970240	.	G	A	2	6	8	0	1	9	0	0
7	30075430	.	G	A	8	11	19	0	1	20	0	0
7	30075631	.	C	A	11	11	22	0	4	26	0	0
7	30075823	.	C	T	10	16	26	0	2	28	0	0
7	30075845	.	T	C	11	21	32	0	0	32	0	0
7	30075974	.	A	G	15	21	36	0	4	40	0	0
7	30075983	.	G	A	16	23	39	0	1	40	0	0
7	30076036	.	A	C	14	23	37	0	2	39	0	0
7	30076083	.	A	T	10	19	29	0	1	30	0	0
7	30076141	.	T	G	10	10	20	0	8	28	0	0
7	30076217	.	T	C	8	6	14	1	3	18	0	0
7	30076241	.	G	T	14	6	20	0	0	20	0	0
7	30076591	.	G	A	24	7	31	1	0	32	0	0
7	30076608	.	T	G	19	6	25	0	1	26	0	0
7	30076653	.	C	A	14	13	27	1	0	28	0	0
7	30076692	.	C	T	18	22	40	0	2	42	0	0
7	30076744	.	G	A	14	22	36	0	2	38	0	0
7	30076852	.	A	T	13	18	31	0	1	32	0	0
7	30076872	.	T	C	8	0	8	0	15	23	0	0
7	30076962	.	A	T	7	11	18	0	0	18	0	0
7	30076966	.	A	G	7	8	15	0	1	16	0	0
7	30077288	.	C	T	2	4	6	0	1	7	0	0
7	30077328	.	A	G	4	3	7	1	1	9	0	0
7	30080032	.	G	A	13	11	24	0	1	25	0	0
7	30080166	.	A	G	17	17	34	0	0	34	0	0
7	30080468	.	C	G	11	9	20	0	0	20	0	0
7	30080603	.	T	C	6	3	9	0	0	9	0	0
7	30080872	.	G	A	6	5	11	0	0	11	0	0
7	30082857	.	C	A	17	5	22	0	0	22	0	0
7	30082871	.	T	A	15	4	19	0	0	20	1	0
7	30082894	.	G	C	8	3	11	0	0	11	0	0
7	30086732	.	T	C	1	3	4	0	2	6	0	0
7	30136304	.	C	G	8	11	19	0	0	19	0	0
7	30136604	.	C	T	6	4	10	0	0	10	0	0
7	30136689	.	G	A	3	2	5	0	0	5	0	0
7	30137667	.	C	T	5	7	12	0	0	12	0	0
7	30139129	.	C	A	3	3	6	0	1	7	0	0
7	30139247	.	G	A	4	3	7	0	0	7	0	0
7	30139952	.	G	A	2	4	6	0	0	6	0	0
7	30139991	.	T	A	2	2	4	0	0	4	0	0
7	30178839	.	G	A	3	2	5	0	1	6	0	0
7	30179577	.	C	G	1	2	3	0	0	3	0	0
7	30183672	.	C	A	1	4	5	0	0	5	0	0
7	30187318	.	C	T	2	4	6	0	1	7	0	0
7	30187381	.	A	G	3	4	7	0	0	7	0	0
7	30188324	.	T	C	2	4	6	0	0	6	0	0
7	30188459	.	C	T	1	5	6	0	0	6	0	0
7	30210151	.	T	A	12	11	23	0	1	24	0	0
7	30210359	.	C	T	14	11	25	0	0	25	0	0
7	30210362	.	T	C	14	9	23	0	2	25	0	0
7	30210445	.	C	G	1	13	14	0	7	21	0	0
7	30210579	.	G	T	7	11	18	0	1	19	0	0
7	30210659	.	T	C	11	5	16	0	2	18	0	0
7	30210741	.	G	A	8	11	19	0	0	19	0	0
7	30210785	.	A	G	7	6	13	0	1	14	0	0
7	30211482	.	C	T	7	12	19	0	0	19	0	0
7	30211530	.	T	A	4	10	14	0	1	15	0	0
7	30213948	.	A	G	8	10	18	0	1	19	0	0
7	30216972	.	T	G	1	4	5	0	2	7	0	0
7	30263870	.	C	T	2	2	4	0	0	4	0	0
7	30263889	.	G	A	1	3	4	0	1	5	0	0
7	30275522	.	T	C	4	4	8	0	0	8	0	0
7	30275668	.	A	T	3	7	10	0	2	12	0	0
7	30275676	.	A	T	8	4	12	0	1	13	0	0
7	30280856	.	C	G	30	27	57	0	3	60	0	0
7	30283700	.	C	T	2	3	5	0	0	5	0	0
7	30285610	.	T	C	2	2	4	0	0	4	0	0
7	30327330	.	A	T	7	3	10	0	0	10	0	0
7	30327887	.	G	T	3	2	5	0	0	5	0	0
7	30330368	.	G	A	3	3	6	0	0	6	0	0
7	30409234	.	G	A	2	2	4	0	0	4	0	0
7	30410687	.	T	A	5	2	7	0	2	9	0	0
7	30411052	.	C	T	6	6	12	0	3	15	0	0
7	30411187	.	T	C	4	9	13	0	0	13	0	0
7	30412857	.	C	T	7	9	16	0	0	16	0	0
7	30412884	.	C	T	10	5	15	0	2	17	0	0
7	30416824	.	A	T	3	5	8	0	0	8	0	0
7	30421505	.	G	A	4	2	6	0	0	6	0	0
7	30421664	.	T	G	1	2	3	0	0	3	0	0
7	30494139	.	T	C	1	1	2	0	1	3	0	0
7	30518843	.	C	T	3	2	5	0	1	6	0	0
7	30534433	.	G	T	3	2	5	0	0	5	0	0
7	30534678	.	G	A	0	2	2	0	5	7	0	0
7	30534930	.	T	A	3	2	5	0	1	6	0	0
7	30535162	.	T	G	9	4	13	0	0	13	0	0
7	30535163	.	G	T	9	4	13	0	0	13	0	0
7	30536377	.	T	A	4	6	10	0	1	11	0	0
7	30536396	.	C	G	7	7	14	0	0	14	0	0
7	30536958	.	T	A	7	5	12	0	1	13	0	0
7	30537014	.	G	A	6	11	17	0	3	20	0	0
7	30537114	.	T	C	8	7	15	0	0	15	0	0
7	30537365	.	G	T	6	11	17	2	1	20	0	0
7	30537370	.	T	A	13	6	19	2	0	21	0	0
7	30537783	.	A	T	10	8	18	0	0	18	0	0
7	30537804	.	C	T	10	8	18	0	1	19	0	0
7	30537858	.	G	A	10	12	22	0	1	23	0	0
7	30538280	.	G	A	12	7	19	0	0	19	0	0
7	30541693	.	G	A	27	19	46	0	0	46	0	0
7	30542295	.	C	T	25	14	39	0	4	43	0	0
7	30543682	.	T	C	26	21	47	0	2	49	0	0
7	30552992	.	G	A	7	7	14	0	0	14	0	0
7	30562290	.	C	T	0	11	11	0	7	18	0	0
7	30562552	.	T	A	7	11	18	0	1	19	0	0
7	30563116	.	G	A	5	4	9	0	0	9	0	0
7	30566157	.	C	T	5	4	9	0	1	10	0	0
7	30578818	.	C	T	0	4	4	0	5	9	0	0
7	30578916	.	G	A	3	5	8	0	1	9	0	0
7	30583147	.	G	A	6	3	9	0	0	9	0	0
7	30604922	.	C	T	1	2	3	0	0	3	0	0
7	30632673	.	A	C	5	2	7	0	0	7	0	0
7	30632737	.	G	T	5	6	11	0	0	11	0	0
7	30638970	.	G	A	6	6	12	0	0	12	0	0
7	30641118	.	T	C	3	3	6	0	0	6	0	0
7	30641151	.	G	T	1	4	5	0	0	5	0	0
7	30641187	.	G	T	3	2	5	0	0	5	0	0
7	30641217	.	C	T	3	3	6	0	0	6	0	0
7	30644307	.	C	T	3	3	6	0	0	6	0	0
7	30653976	.	T	C	2	2	4	0	0	4	0	0
7	30763671	.	G	A	1	2	3	0	0	3	0	0
7	30763683	.	G	A	0	2	2	0	1	3	0	0
7	30768073	.	C	T	4	2	6	0	0	6	0	0
7	30770041	.	A	G	3	1	4	0	1	5	0	0
7	30770629	.	T	G	0	5	5	0	0	5	0	0
7	30770971	.	T	A	3	9	12	0	0	12	0	0
7	30775626	.	C	T	2	3	5	0	1	6	0	0
7	30777337	.	A	G	9	3	12	0	0	12	0	0
7	30777549	.	C	T	2	4	6	0	0	6	0	0
7	30777617	.	G	A	4	4	8	0	2	10	0	0
7	30778363	.	A	G	5	7	12	0	2	14	0	0
7	30778486	.	C	T	4	3	7	0	0	7	0	0
7	30778657	.	T	C	5	3	8	0	0	8	0	0
7	30778703	.	C	G	1	3	4	0	0	4	0	0
7	30778714	.	G	A	0	2	2	0	0	2	0	0
7	30778840	.	A	T	6	4	10	0	0	10	0	0
7	30778859	.	G	A	7	5	12	0	0	12	0	0
7	30779006	.	A	G	4	3	7	0	0	7	0	0
7	30780272	.	G	A	3	3	6	0	2	8	0	0
7	30782104	.	C	T	7	3	10	0	0	10	0	0
7	30782476	.	T	A	3	6	9	0	0	9	0	0
7	30782478	.	A	G	3	6	9	0	0	9	0	0
7	30782559	.	G	A	5	2	7	0	1	8	0	0
7	30782669	.	A	G	6	5	11	0	1	12	0	0
7	30867006	.	C	T	12	8	20	0	2	22	0	0
7	30867658	.	T	A	11	8	19	0	1	20	0	0
7	30867670	.	A	G	12	1	13	0	10	23	0	0
7	30867731	.	A	G	12	14	26	0	2	28	0	0
7	30867775	.	T	G	12	6	18	0	3	21	0	0
7	30868009	.	C	T	20	18	38	0	2	40	0	0
7	30875257	.	G	A	10	10	20	0	0	20	0	0
7	30911937	.	C	T	24	21	45	0	3	48	0	0
7	30914622	.	C	T	26	21	47	0	2	49	0	0
7	30914706	.	C	T	18	20	38	0	3	41	0	0
7	30915040	.	A	G	18	11	29	1	3	33	0	0
7	30915306	.	G	A	40	26	66	0	1	67	0	0
7	30915388	.	A	G	32	26	58	0	1	59	0	0
7	30915823	.	G	A	2	29	31	0	20	51	0	0
7	30923638	.	C	T	0	7	7	0	4	11	0	0
7	30923658	.	C	A	4	7	11	0	0	11	0	0
7	30923842	.	T	C	6	3	9	0	2	11	0	0
7	30925623	.	A	T	1	4	5	0	0	5	0	0
7	30929571	.	C	T	1	2	3	0	0	3	0	0
7	31093055	.	A	G	2	0	2	0	3	5	0	0
7	31107735	.	G	A	0	3	3	0	8	11	0	0
7	31108139	.	A	T	5	3	8	0	1	9	0	0
7	31112120	.	C	T	2	3	5	0	0	5	0	0
7	31112204	.	G	A	5	2	7	0	0	7	0	0
7	31112264	.	G	T	6	4	10	0	1	11	0	0
7	31120825	.	G	A	2	8	10	0	13	23	0	0
7	31120906	.	C	A	13	8	21	0	3	24	0	0
7	31121005	.	C	T	13	6	19	0	0	19	0	0
7	31125653	.	C	T	8	6	14	0	0	14	0	0
7	31125776	.	G	A	2	9	11	0	13	24	0	0
7	31125860	.	T	C	7	15	22	0	1	23	0	0
7	31125980	.	C	A	14	8	22	0	1	23	0	0
7	31126127	.	C	A	7	8	15	0	0	15	0	0
7	31128396	.	T	C	13	17	30	0	3	33	0	0
7	31128475	.	A	C	7	18	25	0	1	26	0	0
7	31130267	.	A	G	12	0	12	1	19	32	0	0
7	31130285	.	T	C	9	15	24	1	6	31	0	0
7	31132771	.	A	C	7	3	10	0	1	11	0	0
7	31140479	.	C	A	20	18	38	0	2	40	0	0
7	31140594	.	G	A	10	10	20	0	1	21	0	0
7	31140634	.	A	C	14	8	22	0	0	22	0	0
7	31140976	.	A	C	8	13	21	0	2	23	0	0
7	31141044	.	C	T	7	7	14	0	0	14	0	0
7	31141086	.	G	A	1	9	10	0	3	13	0	0
7	31141372	.	T	C	11	19	30	0	0	30	0	0
7	31141747	.	T	A	14	24	38	0	2	40	0	0
7	31142030	.	C	T	11	16	27	0	1	28	0	0
7	31326689	.	G	A	4	3	7	0	0	7	0	0
7	31326759	.	G	A	0	2	2	0	4	6	0	0
7	31326795	.	G	A	5	4	9	0	1	10	0	0
7	31326862	.	T	C	6	5	11	0	0	11	0	0
7	31332206	.	T	C	8	8	16	0	0	16	0	0
7	31335951	.	A	C	3	2	5	0	0	5	0	0
7	31336149	.	G	C	3	3	6	0	0	6	0	0
7	31336153	.	T	A	3	3	6	0	0	6	0	0
7	31339177	.	T	A	4	5	9	0	3	12	0	0
7	31339344	.	T	C	9	10	19	0	1	20	0	0
7	31359003	.	T	C	19	11	30	0	0	31	1	0
7	31364072	.	C	T	8	11	19	0	0	19	0	0
7	31366684	.	C	T	8	6	14	0	0	14	0	0
7	31367057	.	A	G	9	7	16	0	1	17	0	0
7	31367667	.	A	T	21	15	36	1	0	37	0	0
7	31367668	.	C	T	21	15	36	1	0	37	0	0
7	31367777	.	C	G	15	13	28	0	2	30	0	0
7	31367850	.	C	T	7	13	20	0	2	22	0	0
7	31381100	.	A	T	6	5	11	0	0	11	0	0
7	31381129	.	G	T	5	5	10	0	2	12	0	0
7	31381713	.	C	T	6	7	13	0	1	14	0	0
7	31388206	.	C	T	4	3	7	0	1	8	0	0
7	31390492	.	T	A	6	3	9	0	0	9	0	0
7	31390637	.	A	T	4	3	7	0	0	7	0	0
7	31390995	.	T	G	3	2	5	0	1	6	0	0
7	31391020	.	T	C	3	5	8	0	0	8	0	0
7	31391429	.	C	T	13	5	18	0	1	19	0	0
7	31391784	.	G	A	9	4	13	0	1	14	0	0
7	31391799	.	C	G	8	3	11	0	2	13	0	0
7	31392315	.	T	A	16	11	27	1	3	31	0	0
7	31392485	.	A	G	11	13	24	0	1	25	0	0
7	31392492	.	G	A	13	13	26	0	0	26	0	0
7	31393266	.	T	C	10	3	13	0	0	13	0	0
7	31393386	.	G	A	0	6	6	0	5	11	0	0
7	31393497	.	G	A	9	4	13	0	1	14	0	0
7	31426008	.	A	G	1	0	1	0	4	5	0	0
7	31427812	.	T	C	5	7	12	0	3	15	0	0
7	31427842	.	A	C	6	4	10	0	1	11	0	0
7	31431507	.	T	C	4	2	6	0	0	6	0	0
7	31431548	.	T	A	7	5	12	0	0	12	0	0
7	31431745	.	C	G	6	9	15	0	0	15	0	0
7	31431898	.	T	C	6	8	14	0	0	14	0	0
7	31431930	.	C	T	8	5	13	0	0	13	0	0
7	31494838	.	A	G	1	2	3	0	0	3	0	0
7	31495021	.	T	A	7	3	10	0	2	12	0	0
7	31495208	.	A	G	7	9	16	0	1	17	0	0
7	31495329	.	C	T	5	10	15	0	1	16	0	0
7	31495353	.	C	T	9	5	14	0	1	15	0	0
7	31495377	.	C	T	6	7	13	0	1	14	0	0
7	31495801	.	G	A	2	3	5	0	2	7	0	0
7	31496402	.	A	G	1	4	5	0	1	6	0	0
7	31496405	.	A	T	1	3	4	0	1	5	0	0
7	31496524	.	T	C	4	0	4	0	6	10	0	0
7	31496544	.	C	T	4	7	11	0	0	11	0	0
7	31496601	.	T	A	3	2	5	0	1	6	0	0
7	31496625	.	T	A	0	6	6	0	0	6	0	0
7	31496641	.	T	A	3	5	8	0	0	8	0	0
7	31496911	.	T	C	1	3	4	0	2	6	0	0
7	31496948	.	A	G	3	2	5	0	0	5	0	0
7	31497462	.	G	A	1	2	3	0	0	3	0	0
7	31497590	.	C	A	4	2	6	0	0	6	0	0
7	31497627	.	A	G	1	2	3	0	0	3	0	0
7	31497662	.	T	C	1	2	3	0	1	4	0	0
7	31497837	.	T	C	4	2	6	0	0	6	0	0
7	31497843	.	T	C	3	2	5	0	0	5	0	0
7	31498150	.	T	C	3	0	3	0	1	4	0	0
7	31498249	.	A	G	3	6	9	0	0	9	0	0
7	31498394	.	A	T	3	3	6	0	0	6	0	0
7	31498395	.	G	A	3	3	6	0	0	6	0	0
7	31498469	.	G	A	8	3	11	0	0	11	0	0
7	31499485	.	A	G	2	2	4	0	0	4	0	0
7	31626335	.	T	C	1	4	5	0	0	5	0	0
7	31628372	.	T	A	1	2	3	0	0	3	0	0
7	31776224	.	G	A	21	17	38	0	3	41	0	0
7	31776645	.	T	A	14	8	22	0	1	24	1	0
7	31776706	.	G	A	11	14	25	0	0	25	0	0
7	31776735	.	T	C	13	9	22	0	1	23	0	0
7	31776877	.	C	T	7	12	19	0	1	20	0	0
7	31777061	.	T	C	19	4	23	0	0	23	0	0
7	31777227	.	T	C	8	9	17	0	1	18	0	0
7	31777528	.	C	T	11	8	19	0	3	22	0	0
7	31777569	.	G	C	14	0	14	0	11	25	0	0
7	31782235	.	A	G	7	4	11	0	1	12	0	0
7	31784631	.	G	T	2	2	4	0	1	5	0	0
7	31784661	.	A	G	1	7	8	0	0	8	0	0
7	31784996	.	T	C	2	7	9	0	2	11	0	0
7	31796725	.	T	C	8	0	8	0	11	19	0	0
7	31796845	.	A	G	5	12	17	0	1	18	0	0
7	31796861	.	T	G	5	10	15	0	0	15	0	0
7	31796888	.	T	C	7	0	7	0	11	18	0	0
7	31796990	.	C	T	2	14	16	0	12	28	0	0
7	31802890	.	C	T	14	10	24	0	1	25	0	0
7	31802938	.	A	T	7	16	23	0	0	23	0	0
7	31803408	.	G	A	6	11	17	0	0	17	0	0
7	31817903	.	C	T	4	4	8	0	0	8	0	0
7	31902535	.	G	T	15	10	25	0	1	26	0	0
7	31902536	.	A	T	15	11	26	0	0	26	0	0
7	31902633	.	T	A	11	12	23	0	2	25	0	0
7	31902757	.	T	A	27	18	45	0	1	46	0	0
7	31903205	.	T	A	9	13	22	0	0	22	0	0
7	31903256	.	C	A	4	10	14	0	0	14	0	0
7	31903276	.	G	A	4	10	14	0	0	14	0	0
7	31903516	.	T	G	9	3	12	0	0	12	0	0
7	31903554	.	A	T	10	9	19	0	1	20	0	0
7	31903823	.	G	T	1	7	8	0	0	8	0	0
7	31903993	.	A	T	7	5	12	0	2	14	0	0
7	31904146	.	G	A	8	5	13	0	1	14	0	0
7	31904180	.	G	A	12	4	16	0	0	16	0	0
7	31904192	.	G	T	13	4	17	0	1	18	0	0
7	31904381	.	C	A	16	10	26	0	4	30	0	0
7	31904442	.	T	G	9	13	22	0	0	22	0	0
7	31905126	.	C	T	3	5	8	1	0	9	0	0
7	31905190	.	A	T	3	6	9	0	0	9	0	0
7	31905217	.	T	A	5	4	9	0	0	9	0	0
7	31905392	.	G	A	7	6	13	0	0	13	0	0
7	31907970	.	C	A	6	7	13	0	1	14	0	0
7	31925975	.	C	T	15	21	36	0	1	37	0	0
7	31941475	.	T	A	5	2	7	0	0	7	0	0
7	32142302	.	A	C	2	8	10	0	0	10	0	0
7	32457300	.	C	T	1	2	3	0	0	3	0	0
7	32458136	.	C	A	4	3	7	0	0	7	0	0
7	32458154	.	G	A	0	3	3	0	3	6	0	0
7	32458227	.	A	T	1	4	5	0	1	6	0	0
7	32458270	.	C	A	7	3	10	0	1	11	0	0
7	32458467	.	G	C	2	3	5	0	0	5	0	0
7	32458471	.	G	T	2	3	5	0	0	5	0	0
7	32458846	.	A	T	5	6	11	0	0	11	0	0
7	32459107	.	C	A	1	10	11	0	0	11	0	0
7	32459220	.	C	T	4	4	8	0	0	8	0	0
7	32459256	.	G	T	4	3	7	0	0	7	0	0
7	32459592	.	G	T	3	2	5	0	0	5	0	0
7	32624814	.	T	A	6	22	28	0	2	30	0	0
7	32624823	.	G	A	9	22	31	0	1	32	0	0
7	32624892	.	C	T	13	13	26	0	3	29	0	0
7	32628387	.	T	C	8	11	19	0	1	20	0	0
7	32629349	.	G	T	7	6	13	0	1	14	0	0
7	32637565	.	C	T	1	4	5	0	0	5	0	0
7	32644881	.	G	A	1	3	4	0	0	4	0	0
7	32644953	.	C	T	2	4	6	0	0	6	0	0
7	32645754	.	T	G	4	4	8	0	0	8	0	0
7	32645764	.	A	T	4	2	6	0	1	7	0	0
7	32700594	.	C	T	3	3	6	0	0	6	0	0
7	32714730	.	T	C	5	4	9	0	2	11	0	0
7	32714833	.	C	T	6	4	10	0	1	11	0	0
7	32722694	.	G	T	4	2	6	0	0	6	0	0
7	32742572	.	G	A	10	6	16	0	2	18	0	0
7	32742962	.	T	C	6	4	10	0	2	12	0	0
7	32742967	.	G	A	6	4	10	0	0	10	0	0
7	32743091	.	A	T	3	7	10	0	1	11	0	0
7	32743110	.	A	T	5	5	10	0	0	10	0	0
7	32743370	.	C	A	2	2	4	0	0	4	0	0
7	32743512	.	T	C	6	2	8	0	0	8	0	0
7	32743653	.	A	G	1	3	4	0	0	4	0	0
7	32743654	.	T	C	1	3	4	0	0	4	0	0
7	32743728	.	C	G	2	2	4	0	1	5	0	0
7	32743751	.	C	A	3	4	7	0	0	7	0	0
7	32743811	.	T	A	7	2	9	0	0	9	0	0
7	32743818	.	T	A	8	2	10	0	0	10	0	0
7	32743918	.	G	C	5	7	12	0	0	12	0	0
7	32743959	.	A	C	4	12	16	0	0	16	0	0
7	32743961	.	A	G	4	11	15	0	1	16	0	0
7	32744027	.	T	C	4	7	11	0	0	11	0	0
7	32744459	.	T	A	13	4	17	0	0	17	0	0
7	32744485	.	A	G	9	4	13	0	1	14	0	0
7	32744540	.	T	C	9	6	15	0	0	15	0	0
7	32744542	.	A	G	9	0	9	0	6	15	0	0
7	32744648	.	A	G	7	12	19	0	0	19	0	0
7	32744663	.	T	A	8	8	16	0	0	16	0	0
7	32744856	.	G	A	11	7	18	0	1	19	0	0
7	32744906	.	T	C	9	10	19	0	2	21	0	0
7	32744919	.	T	G	10	9	19	0	1	20	0	0
7	32744958	.	T	A	3	10	13	0	1	14	0	0
7	32744974	.	G	C	3	11	14	0	0	14	0	0
7	32745025	.	T	C	7	4	11	0	2	13	0	0
7	32745170	.	A	G	2	6	8	0	0	8	0	0
7	32745190	.	T	C	4	8	12	0	0	12	0	0
7	32745461	.	C	T	8	7	15	0	1	16	0	0
7	32746026	.	T	C	9	8	17	0	0	17	0	0
7	32746152	.	A	C	8	5	13	1	4	18	0	0
7	32746213	.	A	G	14	6	20	0	0	20	0	0
7	32746324	.	G	A	16	8	24	1	6	31	0	0
7	32746327	.	A	C	15	12	27	1	2	30	0	0
7	32746370	.	C	T	16	12	28	0	0	28	0	0
7	32746457	.	A	C	18	11	29	0	0	29	0	0
7	32746584	.	C	T	10	10	20	0	1	21	0	0
7	32746614	.	C	T	13	11	24	0	1	25	0	0
7	32746676	.	T	C	19	12	31	0	1	32	0	0
7	32746838	.	A	G	22	0	22	0	8	30	0	0
7	32746839	.	A	T	22	7	29	0	0	29	0	0
7	32747135	.	T	C	15	5	20	0	1	21	0	0
7	32747482	.	A	C	2	2	4	0	1	5	0	0
7	32747973	.	A	G	17	15	32	0	2	34	0	0
7	32748006	.	T	C	12	19	31	0	3	34	0	0
7	32748319	.	C	A	12	27	39	0	2	41	0	0
7	32748486	.	A	T	16	13	29	0	1	30	0	0
7	32748725	.	G	A	15	21	36	0	1	37	0	0
7	32748914	.	G	A	20	19	39	0	1	40	0	0
7	32749048	.	T	A	20	22	42	0	2	44	0	0
7	32749144	.	T	C	22	22	44	0	3	47	0	0
7	32749146	.	A	G	24	23	47	0	1	48	0	0
7	32812361	.	A	G	26	27	53	0	1	54	0	0
7	32812472	.	G	A	20	14	34	1	1	36	0	0
7	32812804	.	G	A	10	16	26	0	17	43	0	0
7	32813004	.	T	C	27	16	43	0	2	45	0	0
7	32813366	.	A	G	16	20	36	0	5	41	0	0
7	32813605	.	T	G	7	15	22	0	2	24	0	0
7	32813689	.	C	T	11	15	26	0	1	27	0	0
7	32814139	.	C	G	12	9	21	0	1	22	0	0
7	32814141	.	G	C	12	9	21	0	1	22	0	0
7	32814451	.	C	T	2	13	15	2	18	35	0	0
7	32814502	.	T	C	20	0	20	0	7	27	0	0
7	32814542	.	C	T	17	9	26	0	0	26	0	0
7	32814600	.	C	G	14	14	28	0	0	28	0	0
7	32814636	.	A	G	13	15	28	0	0	28	0	0
7	32814830	.	A	G	16	12	28	0	0	28	0	0
7	32815485	.	A	T	10	9	19	0	0	19	0	0
7	32815506	.	A	G	13	14	27	0	1	28	0	0
7	32815573	.	T	C	8	7	15	1	2	18	0	0
7	32815666	.	T	C	19	7	26	0	1	27	0	0
7	32815910	.	C	T	0	15	15	0	19	34	0	0
7	32818809	.	G	T	10	12	22	0	1	23	0	0
7	32818848	.	A	T	13	10	23	0	0	23	0	0
7	32831592	.	G	A	3	7	10	0	1	11	0	0
7	32833155	.	T	G	6	7	13	1	0	14	0	0
7	32834412	.	A	G	3	3	6	0	1	7	0	0
7	32834445	.	G	T	2	3	5	0	4	9	0	0
7	32834650	.	C	A	5	7	12	0	0	12	0	0
7	32834674	.	G	A	7	8	15	0	1	16	0	0
7	32834835	.	G	A	5	7	12	0	0	12	0	0
7	32835042	.	T	G	6	8	14	0	2	16	0	0
7	32835053	.	T	C	6	7	13	0	3	16	0	0
7	32835182	.	G	A	7	7	14	0	0	14	0	0
7	32835349	.	A	G	6	8	14	0	0	14	0	0
7	32836032	.	T	C	4	4	8	0	1	9	0	0
7	32836100	.	G	A	5	8	13	0	0	13	0	0
7	32836163	.	A	G	6	7	13	0	1	14	0	0
7	32836203	.	A	T	3	7	10	0	0	10	0	0
7	32836227	.	A	G	5	6	11	0	2	13	0	0
7	32836334	.	T	C	4	0	4	0	6	10	0	0
7	32843511	.	T	C	2	0	2	0	7	9	0	0
7	32855050	.	A	G	2	3	5	0	0	5	0	0
7	32895388	.	A	C	1	6	7	0	0	7	0	0
7	32895595	.	A	C	1	3	4	0	0	4	0	0
7	32898148	.	T	G	19	1	20	0	12	32	0	0
7	32898640	.	A	T	13	8	21	0	0	21	0	0
7	32898696	.	C	T	6	18	24	0	0	24	0	0
7	32898744	.	C	T	11	12	23	0	0	23	0	0
7	32898747	.	T	A	11	10	21	0	1	22	0	0
7	32898827	.	C	A	13	11	24	0	1	25	0	0
7	32899602	.	A	T	11	11	22	0	1	23	0	0
7	32899744	.	A	G	9	9	18	0	0	18	0	0
7	32928369	.	G	A	4	2	6	0	0	6	0	0
7	32983726	.	T	A	34	20	54	1	5	60	0	0
7	32983948	.	A	C	32	8	40	0	32	72	0	0
7	32984127	.	T	A	32	31	63	0	4	67	0	0
7	32984604	.	C	T	26	30	56	0	2	58	0	0
7	32984625	.	T	A	27	26	53	0	1	54	0	0
7	32984804	.	T	A	34	25	59	0	2	61	0	0
7	32984812	.	C	A	38	22	60	0	2	62	0	0
7	32985013	.	A	T	18	17	35	1	1	37	0	0
7	32985128	.	T	C	27	23	50	0	1	51	0	0
7	32985274	.	A	T	10	7	17	0	0	17	0	0
7	32985282	.	T	A	8	7	15	0	1	16	0	0
7	32985401	.	A	C	5	2	7	0	0	7	0	0
7	32985405	.	T	G	4	1	5	0	1	6	0	0
7	32985518	.	A	T	21	3	24	0	1	25	0	0
7	32985519	.	C	T	22	3	25	0	0	25	0	0
7	32985602	.	G	A	21	19	40	0	1	41	0	0
7	32985616	.	A	T	17	25	42	0	1	43	0	0
7	32985716	.	A	G	24	19	43	0	1	44	0	0
7	32985847	.	A	G	25	18	43	0	4	48	1	0
7	32986043	.	T	A	17	25	42	0	1	43	0	0
7	32986311	.	T	G	18	13	31	0	1	32	0	0
7	32986422	.	G	T	14	9	23	0	3	26	0	0
7	32988848	.	T	C	10	0	10	0	10	20	0	0
7	32992111	.	G	A	8	6	14	0	0	14	0	0
7	33014041	.	T	C	2	0	2	0	3	6	1	0
7	33028462	.	G	A	3	13	16	0	6	22	0	0
7	33028564	.	T	G	5	8	13	0	2	15	0	0
7	33028738	.	T	C	7	14	21	0	0	21	0	0
7	33068415	.	C	T	7	7	14	0	0	14	0	0
7	33068436	.	T	C	8	8	16	0	1	17	0	0
7	33068457	.	G	A	8	10	18	0	0	18	0	0
7	33068640	.	T	C	13	8	21	0	0	21	0	0
7	33068718	.	A	G	8	12	20	0	4	24	0	0
7	33083616	.	A	C	7	5	12	0	2	14	0	0
7	33083665	.	A	G	9	4	13	0	1	14	0	0
7	33083699	.	C	T	6	4	10	0	2	12	0	0
7	33084411	.	A	G	4	4	8	0	0	8	0	0
7	33084487	.	T	G	3	3	6	0	0	6	0	0
7	33084644	.	C	T	10	6	16	0	4	20	0	0
7	33084659	.	A	G	8	7	15	0	3	18	0	0
7	33084693	.	C	A	4	3	7	0	2	9	0	0
7	33084697	.	T	A	6	3	9	0	0	9	0	0
7	33084768	.	G	A	2	8	10	0	4	14	0	0
7	33084769	.	G	A	5	8	13	0	0	13	0	0
7	33084835	.	A	C	4	3	7	0	0	7	0	0
7	33084837	.	A	C	3	3	6	0	0	6	0	0
7	33085039	.	G	A	5	4	9	0	1	10	0	0
7	33085082	.	C	A	5	4	9	0	2	11	0	0
7	33085212	.	C	T	11	9	20	0	3	23	0	0
7	33085359	.	G	C	9	4	13	0	2	15	0	0
7	33085667	.	T	A	4	8	12	0	0	12	0	0
7	33086384	.	C	T	16	16	32	0	0	32	0	0
7	33086491	.	T	C	12	16	28	0	1	29	0	0
7	33086564	.	G	C	10	20	30	0	3	33	0	0
7	33086569	.	T	A	10	22	32	0	3	35	0	0
7	33086865	.	G	T	2	14	16	0	22	38	0	0
7	33087209	.	T	G	21	28	49	0	2	51	0	0
7	33087334	.	A	T	20	10	30	0	1	31	0	0
7	33087472	.	A	G	25	13	38	0	4	42	0	0
7	33087841	.	T	G	28	23	51	0	3	54	0	0
7	33088052	.	G	A	20	6	26	0	3	29	0	0
7	33318298	.	A	T	2	2	4	0	0	4	0	0
7	33318322	.	A	C	2	3	5	0	0	5	0	0
7	33331303	.	G	A	1	3	4	1	0	5	0	0
7	33332472	.	T	C	3	2	5	0	0	5	0	0
7	33340607	.	C	T	6	4	10	0	0	10	0	0
7	33340645	.	C	T	5	6	11	0	0	11	0	0
7	33340747	.	C	T	7	7	14	0	1	15	0	0
7	33341082	.	A	C	6	7	13	0	1	14	0	0
7	33341124	.	T	A	4	8	12	0	1	13	0	0
7	33341143	.	T	G	5	8	13	0	0	13	0	0
7	33341174	.	A	G	3	5	8	0	0	8	0	0
7	33341316	.	A	G	2	0	2	0	2	4	0	0
7	33341347	.	G	T	1	2	3	0	0	3	0	0
7	33341590	.	T	G	3	6	9	0	0	9	0	0
7	33341593	.	A	G	6	4	10	0	0	10	0	0
7	33341853	.	G	T	5	3	8	0	0	8	0	0
7	33346451	.	C	T	19	20	39	0	2	41	0	0
7	33347436	.	T	C	26	21	47	0	2	49	0	0
7	33351362	.	A	C	3	9	12	0	0	12	0	0
7	33440463	.	C	T	2	4	6	0	0	6	0	0
7	33441266	.	G	T	2	2	4	0	0	4	0	0
7	33441270	.	C	T	2	2	4	0	0	4	0	0
7	33441689	.	G	A	5	7	12	0	0	12	0	0
7	33441762	.	A	G	6	0	6	0	5	11	0	0
7	33442138	.	A	G	5	3	8	0	0	8	0	0
7	33442639	.	C	A	7	9	16	2	2	20	0	0
7	33442680	.	T	C	5	7	12	0	1	13	0	0
7	33442795	.	G	A	4	2	6	0	0	6	0	0
7	33443587	.	T	A	2	6	8	0	1	9	0	0
7	33443684	.	A	G	2	6	8	0	0	8	0	0
7	33443748	.	C	G	8	8	16	0	1	17	0	0
7	33443808	.	T	C	6	6	12	0	1	13	0	0
7	33645876	.	A	T	7	11	18	0	0	18	0	0
7	33645932	.	C	A	1	9	10	0	17	27	0	0
7	33646044	.	G	C	13	15	28	0	1	29	0	0
7	33646409	.	C	T	15	15	30	0	0	30	0	0
7	33646459	.	G	A	13	13	26	0	2	28	0	0
7	33649963	.	G	A	13	10	23	0	0	23	0	0
7	33653910	.	G	T	2	3	5	0	1	6	0	0
7	33653982	.	T	C	4	1	5	0	6	11	0	0
7	33801012	.	A	G	7	4	11	0	0	11	0	0
7	33801112	.	T	A	2	7	9	0	0	9	0	0
7	33801322	.	T	C	6	5	11	0	1	12	0	0
7	33802258	.	C	T	3	3	6	0	0	6	0	0
7	33804748	.	G	T	1	4	5	0	0	5	0	0
7	33804829	.	C	T	0	4	4	0	6	10	0	0
7	33804985	.	C	T	0	4	4	0	1	5	0	0
7	33805382	.	T	C	2	0	2	0	4	6	0	0
7	33880379	.	G	A	3	3	6	0	0	6	0	0
7	33883436	.	A	T	3	6	9	0	0	9	0	0
7	33883830	.	A	C	8	5	13	1	2	16	0	0
7	33884325	.	A	C	3	6	9	0	0	9	0	0
7	33885107	.	C	T	4	3	7	0	1	8	0	0
7	33970882	.	T	A	1	6	7	0	0	7	0	0
7	33971021	.	A	T	7	6	13	0	0	13	0	0
7	33971304	.	A	C	10	14	24	0	1	25	0	0
7	33971429	.	C	T	8	5	13	0	1	14	0	0
7	33971549	.	T	G	2	3	5	0	0	5	0	0
7	33972407	.	C	T	3	2	5	0	1	6	0	0
7	34102974	.	G	A	5	2	7	0	0	7	0	0
7	34104755	.	G	T	2	3	5	0	0	5	0	0
7	34104786	.	G	T	5	3	8	0	0	8	0	0
7	34104982	.	G	A	7	2	9	0	0	9	0	0
7	34105791	.	T	C	3	3	6	0	1	7	0	0
7	34105793	.	T	C	2	4	6	0	1	7	0	0
7	34107029	.	T	C	1	2	3	0	0	3	0	0
7	34124478	.	G	C	1	0	1	0	2	3	0	0
7	34183237	.	T	A	8	4	12	0	0	12	0	0
7	34183285	.	A	T	5	7	12	0	0	12	0	0
7	34183767	.	T	C	3	0	3	0	2	5	0	0
7	34191534	.	G	A	3	4	7	0	1	8	0	0
7	34192415	.	T	C	2	0	2	0	3	5	0	0
7	34241474	.	T	C	3	0	3	0	5	8	0	0
7	34241477	.	C	A	5	3	8	0	0	8	0	0
7	34241707	.	C	T	4	2	6	0	0	6	0	0
7	34241719	.	T	C	4	3	7	0	0	7	0	0
7	34241815	.	G	A	6	2	8	0	0	8	0	0
7	34242438	.	T	C	5	5	10	0	0	10	0	0
7	34290319	.	C	T	2	3	5	0	1	6	0	0
7	34290420	.	G	A	1	4	5	0	1	6	0	0
7	34292207	.	T	A	5	2	7	0	0	7	0	0
7	34292306	.	T	C	6	6	12	0	0	12	0	0
7	34292354	.	C	A	5	2	7	0	0	7	0	0
7	34292434	.	C	A	4	2	6	0	1	7	0	0
7	34292617	.	G	A	6	5	11	0	0	11	0	0
7	34292848	.	G	A	2	2	4	0	0	4	0	0
7	34314811	.	T	C	1	2	3	0	0	3	0	0
7	34314826	.	A	G	3	2	5	1	0	6	0	0
7	34318079	.	T	C	26	24	50	0	1	51	0	0
7	34318619	.	C	T	4	24	28	0	32	60	0	0
7	34318750	.	A	G	32	24	56	0	2	58	0	0
7	34321638	.	C	T	10	10	20	0	0	20	0	0
7	34321698	.	C	T	6	4	10	0	0	10	0	0
7	34321887	.	T	G	7	7	14	0	0	14	0	0
7	34324215	.	T	C	5	10	15	0	1	16	0	0
7	34329845	.	A	G	14	17	31	0	0	31	0	0
7	34341457	.	A	G	13	21	34	0	0	34	0	0
7	34341538	.	A	G	18	8	26	0	0	26	0	0
7	34342185	.	T	C	9	9	18	0	3	21	0	0
7	34342251	.	C	T	7	8	15	1	0	16	0	0
7	34351132	.	A	G	8	5	13	0	4	17	0	0
7	34352928	.	G	A	10	10	20	0	0	20	0	0
7	34352941	.	T	A	8	11	19	0	4	23	0	0
7	34353164	.	T	C	12	0	12	0	9	21	0	0
7	34360337	.	A	G	7	3	10	0	1	11	0	0
7	34360380	.	T	C	8	5	13	0	1	14	0	0
7	34361708	.	A	G	4	3	7	0	0	7	0	0
7	34361781	.	G	T	2	2	4	0	0	4	0	0
7	34385248	.	G	A	4	4	8	0	0	8	0	0
7	34413123	.	T	A	1	2	3	0	0	3	0	0
7	34416106	.	G	A	9	11	20	0	0	20	0	0
7	34416511	.	A	C	7	6	13	0	1	14	0	0
7	34417729	.	C	A	3	4	7	0	0	7	0	0
7	34417846	.	T	C	1	5	6	0	1	7	0	0
7	34418240	.	G	A	6	6	12	0	1	13	0	0
7	34418365	.	G	A	4	7	11	0	2	13	0	0
7	34418457	.	G	T	2	5	7	0	0	7	0	0
7	34418546	.	A	T	2	7	9	0	0	9	0	0
7	34418547	.	C	T	2	7	9	0	0	9	0	0
7	34421271	.	C	T	6	10	16	0	0	16	0	0
7	34426954	.	T	C	3	3	6	0	1	7	0	0
7	34427727	.	T	C	2	0	2	0	3	5	0	0
7	34431708	.	T	C	2	7	9	0	0	9	0	0
7	34487882	.	A	G	1	3	4	0	0	4	0	0
7	34489245	.	C	T	2	2	4	0	0	4	0	0
7	34491872	.	C	T	4	7	11	0	0	11	0	0
7	34491878	.	T	A	6	4	10	0	1	11	0	0
7	34491935	.	G	C	5	2	7	0	1	8	0	0
7	34501480	.	G	A	4	2	6	0	1	7	0	0
7	34501680	.	G	T	2	4	6	0	0	6	0	0
7	34540380	.	C	T	1	2	3	0	0	3	0	0
7	34541955	.	A	G	4	2	6	0	0	6	0	0
7	34542156	.	T	C	1	4	5	0	0	5	0	0
7	34543434	.	A	G	4	1	5	0	2	7	0	0
7	34544751	.	T	A	10	5	15	0	0	15	0	0
7	34545068	.	C	T	15	11	26	0	0	26	0	0
7	34545268	.	A	G	6	6	12	0	2	14	0	0
7	34546677	.	C	T	1	2	3	0	1	4	0	0
7	34617815	.	A	G	1	2	3	0	0	3	0	0
7	34651419	.	G	A	0	2	2	0	7	9	0	0
7	34652081	.	C	G	8	9	17	0	0	17	0	0
7	34765980	.	A	G	2	0	2	0	3	5	0	0
7	34773935	.	G	A	0	2	2	0	1	3	0	0
7	34776487	.	T	C	8	6	14	0	0	14	0	0
7	34823861	.	A	G	3	4	7	0	0	7	0	0
7	34823909	.	A	T	5	2	7	0	0	7	0	0
7	34824131	.	A	T	6	4	10	0	1	11	0	0
7	34824322	.	G	A	1	6	7	0	0	7	0	0
7	34824695	.	C	A	3	4	7	0	0	7	0	0
7	34825400	.	C	T	1	3	4	0	0	4	0	0
7	34828169	.	T	C	1	2	3	0	0	3	0	0
7	34963887	.	C	T	3	2	5	0	0	5	0	0
7	34964833	.	G	T	5	5	10	0	0	10	0	0
7	34965022	.	A	G	5	0	5	0	5	10	0	0
7	34965049	.	G	A	5	5	10	0	0	10	0	0
7	34965064	.	T	C	5	7	12	0	0	12	0	0
7	34965445	.	G	A	3	3	6	0	0	6	0	0
7	34979351	.	T	A	3	3	6	0	0	6	0	0
7	34979813	.	T	C	3	0	3	0	2	5	0	0
7	35083112	.	G	A	2	2	4	0	0	4	0	0
7	35086461	.	C	T	2	9	11	0	0	11	0	0
7	35088435	.	T	C	12	7	19	0	2	21	0	0
7	35091113	.	A	T	18	10	28	0	3	31	0	0
7	35091118	.	A	G	21	10	31	0	2	33	0	0
7	35091293	.	G	A	15	11	26	0	0	26	0	0
7	35091365	.	T	A	21	13	34	0	0	34	0	0
7	35093784	.	C	T	23	16	39	0	1	40	0	0
7	35093968	.	A	C	23	31	54	1	4	59	0	0
7	35094025	.	T	A	26	25	51	1	3	55	0	0
7	35094218	.	T	C	28	25	53	0	2	55	0	0
7	35094292	.	T	G	33	0	33	1	24	58	0	0
7	35094604	.	T	G	17	28	45	0	0	45	0	0
7	35094647	.	T	C	18	18	36	0	5	41	0	0
7	35094682	.	T	C	46	1	47	0	3	50	0	0
7	35094859	.	C	T	11	12	23	0	0	23	0	0
7	35112572	.	C	G	4	3	7	0	0	7	0	0
7	35112615	.	A	G	4	4	8	0	0	8	0	0
7	35112864	.	C	T	0	2	2	0	6	8	0	0
7	35112919	.	T	C	2	5	7	0	1	8	0	0
7	35112994	.	G	T	4	2	6	0	0	6	0	0
7	35113143	.	A	G	3	2	5	0	0	5	0	0
7	35113404	.	G	A	6	2	8	0	0	8	0	0
7	35113419	.	G	A	6	2	8	0	0	8	0	0
7	35118432	.	T	C	1	4	5	0	0	5	0	0
7	35208379	.	G	A	9	3	12	0	0	12	0	0
7	35208381	.	C	T	8	2	10	0	1	11	0	0
7	35210921	.	C	G	12	5	17	0	1	18	0	0
7	35210924	.	C	A	12	6	18	0	0	18	0	0
7	35211010	.	T	G	9	5	14	0	2	16	0	0
7	35211073	.	A	C	10	6	16	0	0	16	0	0
7	35211608	.	A	G	4	2	6	0	0	6	0	0
7	35212252	.	G	A	3	6	9	0	0	9	0	0
7	35212255	.	C	T	3	7	10	0	0	10	0	0
7	35241563	.	C	T	5	1	6	0	0	6	0	0
7	35241571	.	G	T	5	2	7	0	0	7	0	0
7	35241706	.	T	C	7	3	10	0	0	10	0	0
7	35283238	.	T	A	7	2	9	0	1	10	0	0
7	36314372	.	G	A	4	2	6	0	0	6	0	0
7	37861725	.	T	A	15	4	19	0	1	20	0	0
7	38704201	.	T	C	4	4	8	0	0	8	0	0
7	38775075	.	A	G	9	11	20	0	0	20	0	0
7	38775078	.	C	T	8	11	19	0	1	20	0	0
7	38777330	.	T	C	8	15	23	0	2	25	0	0
7	38779297	.	T	A	6	11	17	0	1	18	0	0
7	38779695	.	T	A	14	11	25	0	2	27	0	0
7	38779696	.	T	C	16	12	28	0	0	28	0	0
7	38779759	.	A	G	16	1	17	1	20	38	0	0
7	38783439	.	C	T	20	15	35	0	0	35	0	0
7	38783644	.	A	G	27	12	39	0	2	41	0	0
7	38783718	.	A	G	22	13	35	0	2	37	0	0
7	38783799	.	A	T	18	21	39	0	0	39	0	0
7	38783881	.	T	A	10	12	22	0	2	24	0	0
7	38783984	.	G	T	0	13	13	3	12	28	0	0
7	38784486	.	T	C	15	17	32	0	2	34	0	0
7	38784494	.	A	G	11	0	11	0	20	31	0	0
7	38784681	.	G	A	22	27	49	0	1	50	0	0
7	38784786	.	T	A	19	36	55	0	0	55	0	0
7	38784976	.	T	A	16	26	42	0	2	44	0	0
7	38784985	.	T	G	19	5	24	0	12	44	8	0
7	38785069	.	C	T	17	16	33	0	0	33	0	0
7	38785224	.	G	A	2	8	10	0	31	41	0	0
7	38785311	.	T	A	25	13	38	0	1	40	1	0
7	38794090	.	T	G	19	19	38	0	0	38	0	0
7	38794233	.	C	T	0	21	21	0	11	32	0	0
7	38794411	.	A	G	19	15	34	0	5	39	0	0
7	38794562	.	A	G	17	18	35	0	0	35	0	0
7	38798630	.	A	G	16	15	31	0	1	32	0	0
7	38799622	.	T	C	12	0	12	1	18	31	0	0
7	38807677	.	T	G	3	6	9	0	0	9	0	0
7	38807750	.	C	T	8	13	21	0	0	21	0	0
7	38809556	.	T	C	4	3	7	0	0	7	0	0
7	38821790	.	G	C	4	3	7	0	0	7	0	0
7	38822327	.	C	T	10	4	14	0	0	14	0	0
7	38822365	.	T	A	7	5	12	0	2	14	0	0
7	38822523	.	G	A	4	6	10	0	0	10	0	0
7	38822528	.	C	A	0	5	5	0	2	8	1	0
7	38822559	.	C	T	0	2	2	0	3	5	0	0
7	38822801	.	A	G	2	5	7	0	0	7	0	0
7	38824259	.	G	A	2	2	4	0	2	6	0	0
7	38824972	.	G	A	5	6	11	0	2	13	0	0
7	38827635	.	T	A	7	3	10	0	2	12	0	0
7	38953149	.	T	G	1	3	4	0	1	5	0	0
7	38953154	.	A	G	1	6	7	0	0	7	0	0
7	38954102	.	T	C	1	4	5	0	0	5	0	0
7	38954130	.	T	C	1	3	4	0	0	4	0	0
7	38954657	.	T	C	2	3	5	0	0	5	0	0
7	39097193	.	T	C	6	3	9	0	0	9	0	0
7	39123095	.	G	A	2	3	5	0	6	11	0	0
7	39140281	.	A	G	4	8	12	0	1	13	0	0
7	39142946	.	G	T	5	7	12	0	1	13	0	0
7	39142961	.	C	T	6	6	12	0	1	13	0	0
7	39153769	.	C	A	2	9	11	0	0	11	0	0
7	39154119	.	C	T	1	7	8	0	1	9	0	0
7	39154984	.	T	G	5	6	11	0	0	11	0	0
7	39155099	.	C	T	2	4	6	0	0	6	0	0
7	39155115	.	T	C	2	8	10	0	0	10	0	0
7	39155163	.	C	A	4	5	9	0	1	12	2	0
7	39155344	.	G	A	5	3	8	0	0	8	0	0
7	39155508	.	A	T	4	7	11	0	1	12	0	0
7	39155943	.	T	C	8	5	13	0	1	14	0	0
7	39156101	.	T	G	9	4	13	0	2	15	0	0
7	39156161	.	C	T	6	8	14	0	0	14	0	0
7	39156376	.	A	G	10	13	23	0	3	26	0	0
7	39156474	.	T	C	16	14	30	0	2	32	0	0
7	39156567	.	G	C	20	15	35	0	0	35	0	0
7	39156698	.	G	A	0	9	9	0	3	12	0	0
7	39156846	.	T	C	13	13	26	0	1	27	0	0
7	39156969	.	T	C	8	12	20	0	1	21	0	0
7	39157175	.	A	T	14	8	22	0	1	23	0	0
7	39157239	.	C	A	17	5	22	0	0	22	0	0
7	39174145	.	T	C	22	20	42	0	1	43	0	0
7	39176261	.	G	A	2	28	30	1	26	58	1	0
7	39176444	.	G	A	1	8	9	0	32	41	0	0
7	39176447	.	A	C	30	11	41	0	0	41	0	0
7	39176790	.	T	G	20	21	41	0	4	45	0	0
7	39176863	.	G	A	28	25	53	0	0	53	0	0
7	39176922	.	T	A	21	14	35	1	2	38	0	0
7	39177132	.	A	T	4	3	7	0	1	8	0	0
7	39177524	.	T	A	25	17	42	0	1	43	0	0
7	39177527	.	G	A	25	17	42	0	2	44	0	0
7	39177601	.	C	A	22	13	35	0	2	37	0	0
7	39177643	.	A	G	23	12	35	0	2	37	0	0
7	39177679	.	C	T	25	12	37	0	0	37	0	0
7	39177717	.	A	G	26	16	42	0	1	43	0	0
7	39177729	.	A	G	24	15	39	0	4	43	0	0
7	39177962	.	T	C	5	10	15	0	0	15	0	0
7	39178065	.	A	G	5	5	10	0	2	12	0	0
7	39178123	.	A	G	2	2	4	0	1	5	0	0
7	39181264	.	T	C	17	0	17	0	12	29	0	0
7	39181275	.	A	G	15	13	28	0	1	29	0	0
7	39181318	.	C	T	17	12	29	0	2	31	0	0
7	39181347	.	G	A	9	11	20	0	1	21	0	0
7	39181597	.	C	A	13	14	27	0	1	28	0	0
7	39182127	.	T	C	9	8	17	0	1	18	0	0
7	39182265	.	T	C	7	12	19	0	0	19	0	0
7	39203411	.	G	A	8	4	12	0	0	12	0	0
7	39280835	.	T	A	1	2	3	0	1	4	0	0
7	39366672	.	C	A	3	2	5	0	1	6	0	0
7	39367765	.	G	A	1	3	4	0	0	4	0	0
7	39371295	.	T	C	7	2	9	0	0	9	0	0
7	39373263	.	T	C	1	3	4	0	0	4	0	0
7	39373331	.	A	G	1	2	3	0	0	3	0	0
7	39424683	.	A	G	1	1	2	0	2	4	0	0
7	39538001	.	T	C	5	4	9	0	1	10	0	0
7	39538153	.	T	C	1	5	6	0	0	6	0	0
7	39552270	.	G	T	2	3	5	0	0	5	0	0
7	39552310	.	A	C	1	2	3	0	0	3	0	0
7	39640249	.	C	T	1	3	4	0	0	4	0	0
7	39643046	.	A	G	1	2	3	0	2	5	0	0
7	39655524	.	T	A	2	2	4	0	0	4	0	0
7	39656372	.	C	T	2	4	6	0	0	6	0	0
7	39656974	.	G	A	5	2	7	1	1	9	0	0
7	39657389	.	C	A	6	6	12	0	0	12	0	0
7	39657467	.	T	A	7	6	13	0	0	13	0	0
7	39658224	.	A	C	15	5	20	0	0	20	0	0
7	39658356	.	T	C	3	13	16	0	1	17	0	0
7	39658441	.	T	C	8	8	16	0	1	17	0	0
7	39658831	.	T	G	14	10	24	0	1	25	0	0
7	39659400	.	T	A	4	5	9	1	0	10	0	0
7	39659711	.	A	C	6	4	10	0	1	11	0	0
7	39659758	.	C	A	9	4	13	0	1	14	0	0
7	39659792	.	T	C	6	4	10	0	3	13	0	0
7	39659806	.	G	A	6	4	10	0	2	12	0	0
7	39660054	.	A	C	8	5	13	0	4	17	0	0
7	39660201	.	G	A	21	18	39	0	3	42	0	0
7	39660239	.	A	T	19	16	35	0	5	40	0	0
7	39660240	.	A	T	28	15	43	0	1	44	0	0
7	39660304	.	A	G	30	15	45	0	8	53	0	0
7	39660624	.	C	A	11	20	31	0	1	32	0	0
7	39670892	.	G	C	6	6	12	0	1	13	0	0
7	39671118	.	T	A	3	2	5	0	2	7	0	0
7	39671281	.	G	A	10	2	12	0	1	13	0	0
7	39671647	.	C	T	3	8	11	0	0	11	0	0
7	39671715	.	A	C	5	2	7	0	1	8	0	0
7	39672741	.	A	G	13	7	20	0	1	21	0	0
7	39673773	.	G	C	4	7	11	0	14	25	0	0
7	39675838	.	A	G	8	3	11	0	2	13	0	0
7	39675961	.	T	A	9	4	13	0	1	14	0	0
7	39675991	.	C	T	6	3	9	0	0	9	0	0
7	39676183	.	T	A	3	9	12	0	0	12	0	0
7	39676301	.	G	T	5	7	12	0	0	12	0	0
7	39676303	.	A	T	5	7	12	0	0	12	0	0
7	39676364	.	T	G	5	3	8	0	1	9	0	0
7	39676365	.	C	T	6	3	9	0	0	9	0	0
7	39676446	.	A	T	15	5	20	0	0	20	0	0
7	39676518	.	A	G	10	8	18	0	0	18	0	0
7	39676776	.	C	G	11	7	18	0	2	20	0	0
7	39676947	.	T	G	13	7	20	0	2	22	0	0
7	39677257	.	A	T	4	4	8	0	3	11	0	0
7	39677347	.	G	A	16	13	29	0	0	29	0	0
7	39677549	.	T	C	17	9	26	0	4	30	0	0
7	39677625	.	G	T	18	9	27	0	0	27	0	0
7	39677755	.	C	T	7	15	22	0	3	25	0	0
7	39677878	.	G	C	5	19	24	0	2	26	0	0
7	39677924	.	A	G	14	16	30	0	4	34	0	0
7	39677948	.	G	T	20	13	33	0	0	33	0	0
7	39677998	.	C	G	15	14	29	0	2	31	0	0
7	39691143	.	T	C	7	4	11	0	0	11	0	0
7	39691328	.	A	T	1	3	4	0	0	4	0	0
7	39695483	.	C	T	1	3	4	0	0	4	0	0
7	39695527	.	A	G	2	0	2	0	4	6	0	0
7	39695535	.	T	C	2	3	5	0	0	5	0	0
7	39698691	.	G	A	0	3	3	0	4	7	0	0
7	39698963	.	T	C	8	12	20	0	0	20	0	0
7	39701913	.	A	C	8	9	17	0	2	19	0	0
7	39702022	.	C	G	5	2	7	0	0	7	0	0
7	39702827	.	C	T	2	5	7	0	0	7	0	0
7	39703760	.	A	G	1	2	3	0	1	4	0	0
7	39703898	.	G	C	3	2	5	0	0	5	0	0
7	39704015	.	A	G	5	0	5	0	6	11	0	0
7	39704229	.	C	T	6	10	16	0	0	16	0	0
7	39704340	.	T	A	4	6	10	0	0	10	0	0
7	39704345	.	C	T	4	4	8	0	0	8	0	0
7	39704599	.	G	T	4	7	11	0	1	12	0	0
7	39704632	.	C	T	4	5	9	0	0	9	0	0
7	39704928	.	G	A	0	12	12	0	9	21	0	0
7	39704955	.	T	A	12	11	23	0	1	24	0	0
7	39705178	.	C	T	17	13	30	0	0	30	0	0
7	39705187	.	T	G	15	10	25	0	2	27	0	0
7	39705245	.	G	A	4	8	12	0	4	16	0	0
7	39705337	.	A	C	9	10	19	0	3	22	0	0
7	39742334	.	G	A	0	3	3	0	2	5	0	0
7	39742784	.	A	G	5	9	14	1	3	18	0	0
7	39742841	.	A	T	6	7	13	0	2	15	0	0
7	39742954	.	G	T	3	5	8	0	0	8	0	0
7	39743126	.	G	A	5	6	11	0	0	11	0	0
7	39743177	.	C	A	4	3	7	0	0	7	0	0
7	39744494	.	G	A	8	13	21	0	0	21	0	0
7	39745110	.	A	T	6	14	20	0	0	20	0	0
7	39745580	.	A	G	7	11	18	0	0	18	0	0
7	39748847	.	T	C	6	9	15	0	0	15	0	0
7	39748934	.	A	C	9	12	21	0	2	23	0	0
7	40091010	.	A	T	6	3	9	0	2	11	0	0
7	40492740	.	T	A	43	24	67	0	4	71	0	0
7	40492764	.	G	C	6	32	38	0	34	72	0	0
7	40492789	.	T	C	42	24	66	0	1	67	0	0
7	40492800	.	G	T	41	18	59	0	3	62	0	0
7	40644991	.	A	T	5	2	7	0	0	7	0	0
7	40905131	.	A	G	3	2	5	0	0	5	0	0
7	41331043	.	T	C	3	0	3	0	1	4	0	0
7	41331048	.	T	C	2	3	5	0	0	5	0	0
7	41416266	.	G	A	5	2	7	0	0	7	0	0
7	41900402	.	G	C	3	3	6	0	1	7	0	0
7	41901217	.	A	G	8	4	12	0	0	12	0	0
7	41901226	.	T	A	1	11	12	0	0	12	0	0
7	45403831	.	A	C	1	9	10	0	0	10	0	0
7	46487662	.	C	A	2	3	5	0	0	5	0	0
7	47265729	.	T	C	5	9	14	0	0	14	0	0
7	47265810	.	G	A	6	7	13	0	1	14	0	0
7	47265859	.	A	T	6	10	16	0	0	16	0	0
7	47265934	.	G	A	0	2	2	0	7	9	0	0
7	47324109	.	G	A	1	4	5	0	0	5	0	0
7	47411071	.	G	A	0	6	6	0	1	7	0	0
7	47411434	.	C	T	1	2	3	0	0	3	0	0
7	47411934	.	C	T	4	8	12	0	0	12	0	0
7	47411977	.	C	T	7	8	15	0	1	16	0	0
7	47412373	.	C	T	3	6	9	0	0	9	0	0
7	47412418	.	C	T	3	3	6	0	0	6	0	0
7	47412495	.	A	G	5	1	6	0	3	9	0	0
7	47413615	.	T	C	3	4	7	0	0	7	0	0
7	47413948	.	A	T	7	10	17	0	1	18	0	0
7	47414348	.	C	T	13	8	21	0	1	22	0	0
7	47414865	.	T	C	8	4	12	0	0	12	0	0
7	47415139	.	A	T	7	5	12	0	0	12	0	0
7	47416061	.	C	T	16	9	25	0	1	26	0	0
7	47416496	.	T	A	10	9	19	0	3	22	0	0
7	47417195	.	T	A	4	9	13	0	0	13	0	0
7	47417821	.	C	T	12	9	21	0	1	22	0	0
7	47417934	.	T	A	18	14	32	0	2	34	0	0
7	47418320	.	C	T	13	12	25	0	2	27	0	0
7	47418526	.	T	C	13	8	21	0	2	23	0	0
7	47418575	.	G	T	7	14	21	0	0	21	0	0
7	47418657	.	G	A	16	19	35	0	0	35	0	0
7	47419070	.	T	A	7	10	17	0	1	18	0	0
7	47419177	.	A	C	13	1	14	0	8	22	0	0
7	47419250	.	T	G	11	6	17	0	0	17	0	0
7	47419653	.	G	A	11	12	23	0	1	24	0	0
7	47420019	.	A	G	11	10	21	0	1	22	0	0
7	47420208	.	A	G	16	16	32	0	3	35	0	0
7	47421313	.	C	T	4	8	12	0	2	14	0	0
7	47462909	.	G	A	1	4	5	0	0	5	0	0
7	47488246	.	C	T	5	3	8	0	0	8	0	0
7	47507136	.	G	A	3	4	7	0	0	7	0	0
7	47524444	.	T	C	1	5	6	0	0	6	0	0
7	47563381	.	A	T	2	2	4	0	1	5	0	0
7	47564703	.	A	G	3	4	7	0	0	7	0	0
7	48041808	.	A	T	4	4	8	0	0	8	0	0
7	48042390	.	G	A	4	2	6	0	0	6	0	0
7	48291166	.	G	A	22	6	28	0	1	29	0	0
7	48295850	.	A	T	13	13	26	0	0	26	0	0
7	48296075	.	A	G	6	5	11	0	0	11	0	0
7	48300607	.	G	A	0	3	3	0	2	5	0	0
7	48300795	.	C	T	4	5	9	0	0	10	1	0
7	48302159	.	A	C	6	6	12	0	1	13	0	0
7	48302925	.	A	G	9	4	13	0	0	13	0	0
7	48303273	.	A	T	2	10	12	0	0	12	0	0
7	48303274	.	A	C	2	10	12	0	0	12	0	0
7	48303497	.	A	G	1	3	4	0	1	5	0	0
7	48303814	.	G	A	0	4	4	0	7	11	0	0
7	48303838	.	C	T	11	8	19	0	0	19	0	0
7	48303954	.	T	C	15	4	19	0	0	19	0	0
7	48304060	.	C	G	5	5	10	0	0	10	0	0
7	48304088	.	A	C	6	5	11	0	1	12	0	0
7	48304103	.	G	A	0	5	5	0	4	9	0	0
7	48304263	.	C	T	2	2	4	0	0	4	0	0
7	48304274	.	G	A	1	2	3	0	0	3	0	0
7	48304396	.	G	A	4	2	6	0	1	7	0	0
7	48304419	.	A	G	7	3	10	0	1	11	0	0
7	48304457	.	T	G	11	4	15	0	0	15	0	0
7	48304554	.	G	A	5	6	11	0	1	12	0	0
7	48327801	.	A	G	2	3	5	0	0	5	0	0
7	48327867	.	C	A	7	5	12	0	1	13	0	0
7	48327906	.	T	C	3	10	13	0	3	16	0	0
7	48327912	.	C	T	3	12	15	0	1	16	0	0
7	48334796	.	C	T	3	5	8	0	0	8	0	0
7	48347478	.	T	G	14	14	28	0	1	29	0	0
7	48347562	.	G	T	7	10	17	0	0	17	0	0
7	48348006	.	A	G	9	14	23	0	1	24	0	0
7	48348062	.	C	T	9	6	15	0	0	15	0	0
7	48348148	.	T	A	8	9	17	0	0	17	0	0
7	48348149	.	C	A	8	9	17	0	0	17	0	0
7	48348335	.	G	A	5	8	13	0	1	14	0	0
7	48348485	.	A	G	8	7	15	0	1	16	0	0
7	48348486	.	A	C	8	6	14	0	2	16	0	0
7	48353844	.	G	A	10	4	14	0	0	14	0	0
7	48361334	.	C	A	7	9	16	0	1	17	0	0
7	48363752	.	G	A	3	5	8	0	0	9	1	0
7	48368758	.	C	T	1	6	7	0	5	12	0	0
7	48368821	.	G	A	5	3	8	0	0	8	0	0
7	48368977	.	T	G	3	5	8	0	0	8	0	0
7	48368995	.	G	A	4	4	8	0	0	8	0	0
7	48369043	.	C	G	1	5	6	0	6	12	0	0
7	48370014	.	T	G	3	4	7	0	1	8	0	0
7	48370398	.	C	T	0	3	3	0	1	4	0	0
7	48375665	.	G	C	1	0	1	0	2	3	0	0
7	48377997	.	G	A	1	3	4	0	0	4	0	0
7	48460497	.	G	A	0	2	2	0	3	5	0	0
7	48483513	.	T	A	16	16	32	0	0	32	0	0
7	48484621	.	C	T	11	14	25	0	1	26	0	0
7	48484736	.	A	G	16	11	27	0	2	29	0	0
7	48663980	.	T	A	2	5	7	0	0	7	0	0
7	48664032	.	A	G	2	2	4	0	1	5	0	0
7	48664850	.	T	C	2	0	2	0	2	4	0	0
7	48720160	.	G	A	2	2	4	0	0	4	0	0
7	48720187	.	G	T	1	3	4	0	0	4	0	0
7	48721252	.	A	G	3	2	5	0	0	5	0	0
7	48721561	.	G	T	1	2	3	0	0	3	0	0
7	48721832	.	A	C	2	2	4	0	0	4	0	0
7	48788256	.	G	A	3	5	8	0	0	8	0	0
7	48788369	.	T	C	11	14	25	0	1	26	0	0
7	48788498	.	T	A	15	14	29	1	1	31	0	0
7	48788622	.	G	A	7	7	14	0	0	14	0	0
7	48788873	.	G	A	6	9	15	0	0	15	0	0
7	48788966	.	C	T	8	5	13	0	1	14	0	0
7	48789579	.	T	C	2	0	2	0	10	12	0	0
7	48790641	.	G	A	3	3	6	0	1	7	0	0
7	48793253	.	C	T	1	2	3	0	1	4	0	0
7	48805939	.	A	G	1	2	3	0	0	3	0	0
7	48806533	.	C	T	3	3	6	0	1	7	0	0
7	48809031	.	T	C	1	3	4	0	0	4	0	0
7	48809280	.	A	G	1	2	3	0	0	3	0	0
7	48809290	.	A	G	2	0	2	0	2	4	0	0
7	48818286	.	C	G	4	0	4	0	7	11	0	0
7	48819684	.	A	G	12	12	24	0	0	24	0	0
7	48820740	.	T	A	3	6	9	0	0	9	0	0
7	48820773	.	C	T	6	5	11	0	0	11	0	0
7	48821065	.	T	C	10	6	16	0	0	16	0	0
7	48821331	.	T	C	8	6	14	2	2	18	0	0
7	48823809	.	A	T	13	13	26	0	1	27	0	0
7	48829569	.	G	C	18	14	32	0	0	32	0	0
7	48829926	.	A	T	4	4	8	0	2	10	0	0
7	48830107	.	A	T	2	2	4	0	0	4	0	0
7	48875953	.	G	A	2	6	8	0	1	9	0	0
7	49033267	.	G	A	1	2	3	0	1	4	0	0
7	49036549	.	A	G	2	0	2	0	2	4	0	0
7	49049686	.	G	C	3	4	7	0	0	7	0	0
7	49051660	.	C	T	4	10	14	0	0	14	0	0
7	49051870	.	G	A	2	6	8	0	0	8	0	0
7	49051922	.	G	A	2	4	6	0	1	7	0	0
7	49051927	.	G	A	3	4	7	0	0	7	0	0
7	49052333	.	C	T	4	11	15	0	0	15	0	0
7	49052377	.	A	T	4	12	16	0	0	16	0	0
7	49052402	.	T	A	7	6	13	0	2	15	0	0
7	49052414	.	A	T	6	7	13	0	2	15	0	0
7	49052777	.	C	T	9	9	18	0	1	19	0	0
7	49052840	.	T	G	10	0	10	0	10	20	0	0
7	49052957	.	C	G	14	6	20	0	0	20	0	0
7	49053092	.	G	A	3	4	7	0	0	7	0	0
7	49053113	.	A	C	2	5	7	0	0	7	0	0
7	49053143	.	T	C	2	3	5	0	0	5	0	0
7	49053260	.	C	T	2	4	6	0	1	7	0	0
7	49053445	.	A	G	8	10	18	0	1	19	0	0
7	49053454	.	T	A	9	12	21	0	0	21	0	0
7	49053492	.	G	A	8	14	22	0	0	22	0	0
7	49053531	.	C	T	7	9	16	0	0	16	0	0
7	49053566	.	G	A	1	8	9	0	8	17	0	0
7	49053627	.	C	T	11	11	22	0	0	22	0	0
7	49053677	.	G	A	1	10	11	0	14	25	0	0
7	49053785	.	G	C	9	15	24	0	6	30	0	0
7	49053817	.	C	T	12	13	25	0	1	26	0	0
7	49053835	.	A	T	13	11	24	0	0	24	0	0
7	49053858	.	A	G	12	10	22	0	0	22	0	0
7	49053991	.	A	G	6	0	6	0	6	12	0	0
7	49054076	.	T	G	5	0	5	0	3	8	0	0
7	49054161	.	G	A	4	6	10	0	0	10	0	0
7	49054243	.	G	A	2	5	7	0	2	9	0	0
7	49054268	.	T	C	2	7	9	0	0	9	0	0
7	49054899	.	C	T	10	7	17	0	2	19	0	0
7	49054981	.	T	A	8	6	14	0	2	16	0	0
7	49055197	.	C	T	7	11	18	0	1	19	0	0
7	49055254	.	T	A	11	14	25	0	5	30	0	0
7	49055256	.	T	C	13	17	30	0	0	30	0	0
7	49055371	.	A	C	11	22	33	0	1	34	0	0
7	49055411	.	T	C	8	14	22	0	3	25	0	0
7	49055812	.	T	G	3	0	3	0	8	11	0	0
7	49055880	.	C	T	7	6	13	0	0	13	0	0
7	49055930	.	A	C	4	3	7	0	0	7	0	0
7	49079824	.	T	G	2	2	4	0	0	4	0	0
7	49147537	.	C	T	1	3	4	0	0	4	0	0
7	49170028	.	G	A	0	3	3	0	7	10	0	0
7	49170029	.	G	T	7	3	10	0	0	10	0	0
7	49257384	.	T	C	4	6	10	0	1	11	0	0
7	49257686	.	G	T	11	5	16	0	1	17	0	0
7	49257774	.	C	T	7	2	9	0	0	9	0	0
7	49257841	.	C	T	10	9	19	0	1	20	0	0
7	49258132	.	G	C	10	3	13	0	2	15	0	0
7	49258279	.	C	T	17	5	22	0	0	22	0	0
7	49266497	.	G	A	8	8	16	0	0	16	0	0
7	49266802	.	G	C	18	6	24	0	2	26	0	0
7	49269896	.	A	G	12	0	12	0	8	20	0	0
7	49269913	.	A	G	9	0	9	0	8	17	0	0
7	49270932	.	T	C	9	14	23	0	0	23	0	0
7	49271067	.	C	A	13	9	22	0	2	24	0	0
7	49271105	.	G	T	10	16	26	0	0	26	0	0
7	49313688	.	T	C	3	2	5	0	0	5	0	0
7	49320778	.	C	A	3	4	7	0	0	7	0	0
7	49320779	.	A	C	3	2	5	0	2	7	0	0
7	49325319	.	T	C	9	7	16	0	1	17	0	0
7	49325346	.	A	G	12	7	19	0	0	19	0	0
7	49338309	.	G	A	10	13	23	0	1	24	0	0
7	49338336	.	G	A	9	14	23	0	3	26	0	0
7	49342391	.	G	A	11	14	25	0	1	26	0	0
7	49355496	.	T	C	6	0	6	0	6	12	0	0
7	49358228	.	A	C	6	4	10	0	0	10	0	0
7	49594967	.	C	T	1	3	4	0	2	6	0	0
7	49620059	.	T	C	1	4	5	0	0	5	0	0
7	49620089	.	T	G	1	4	5	0	0	5	0	0
7	49620241	.	T	C	2	0	2	0	10	12	0	0
7	49620298	.	C	T	1	3	4	0	0	4	0	0
7	49620536	.	C	A	2	2	4	0	0	4	0	0
7	49620558	.	T	C	3	1	4	0	0	4	0	0
7	49638742	.	G	A	11	3	14	0	1	15	0	0
7	49638748	.	T	A	12	4	16	0	0	16	0	0
7	49638880	.	T	G	5	6	11	0	1	12	0	0
7	49639272	.	G	T	8	5	13	0	1	14	0	0
7	49639520	.	C	A	5	3	8	0	0	8	0	0
7	49639583	.	T	A	4	4	8	1	0	9	0	0
7	49639609	.	C	T	5	4	9	1	1	11	0	0
7	49639701	.	T	C	5	4	9	0	1	10	0	0
7	49639876	.	A	T	13	9	22	0	0	22	0	0
7	49639926	.	A	C	6	6	12	0	0	12	0	0
7	49640040	.	G	A	14	12	26	0	0	26	0	0
7	49715779	.	C	G	2	3	5	0	0	5	0	0
7	49716731	.	C	G	4	4	8	0	0	8	0	0
7	49716898	.	T	C	4	3	7	0	0	7	0	0
7	49716935	.	T	A	5	2	7	0	0	7	0	0
7	49799470	.	A	T	13	5	18	0	1	19	0	0
7	49799526	.	T	A	12	9	21	0	0	21	0	0
7	49799584	.	G	A	9	4	13	0	2	15	0	0
7	49799805	.	A	T	7	8	15	0	0	15	0	0
7	49799890	.	T	C	6	6	12	0	0	12	0	0
7	49841123	.	G	A	0	3	3	0	1	4	0	0
7	49844053	.	A	G	1	2	3	0	0	3	0	0
7	49844446	.	C	G	2	4	6	0	0	6	0	0
7	50109317	.	T	C	3	2	5	0	0	5	0	0
7	50110585	.	C	T	9	7	16	0	2	18	0	0
7	50111330	.	C	T	8	9	17	0	2	19	0	0
7	50112025	.	C	T	11	12	23	0	0	23	0	0
7	50112039	.	T	G	11	10	21	0	1	22	0	0
7	50112063	.	G	A	7	11	18	0	1	19	0	0
7	50112196	.	A	G	6	0	6	0	0	11	5	0
7	50112286	.	T	C	5	7	12	0	0	12	0	0
7	50112383	.	G	A	12	12	24	0	1	25	0	0
7	50112460	.	C	T	13	17	30	0	1	31	0	0
7	50112825	.	A	T	18	13	31	0	1	32	0	0
7	50112922	.	C	A	8	9	17	0	2	19	0	0
7	50228314	.	C	A	10	10	20	0	2	22	0	0
7	50228326	.	T	C	10	1	11	0	12	23	0	0
7	50228355	.	C	T	11	15	26	0	2	28	0	0
7	50228463	.	G	A	8	7	15	0	1	16	0	0
7	50228517	.	G	T	11	5	16	0	1	17	0	0
7	50228548	.	T	C	8	5	13	0	1	14	0	0
7	50228660	.	T	C	5	2	7	0	0	7	0	0
7	50228702	.	A	T	3	5	8	0	0	8	0	0
7	50228785	.	C	G	3	6	9	0	1	10	0	0
7	50228872	.	A	C	6	7	13	0	1	14	0	0
7	50229223	.	T	C	12	11	23	0	1	24	0	0
7	50272707	.	G	A	1	3	4	0	0	4	0	0
7	50277799	.	A	G	2	2	4	0	0	4	0	0
7	50295823	.	G	A	6	4	10	1	1	12	0	0
7	50295974	.	G	T	5	11	16	0	0	16	0	0
7	50295997	.	T	A	3	6	9	0	1	10	0	0
7	50296016	.	A	G	1	6	7	0	0	7	0	0
7	50296545	.	T	G	4	5	9	0	2	11	0	0
7	50296981	.	A	G	12	6	18	0	0	18	0	0
7	50299379	.	G	A	6	8	14	0	3	17	0	0
7	50323793	.	A	G	1	5	6	0	0	6	0	0
7	50323934	.	G	A	2	2	4	0	0	4	0	0
7	50323967	.	C	T	0	2	2	0	1	3	0	0
7	50324984	.	C	T	1	3	4	0	0	4	0	0
7	50325006	.	G	C	1	3	4	0	0	4	0	0
7	50333581	.	T	C	5	2	7	0	1	8	0	0
7	50333629	.	T	C	1	3	4	0	1	5	0	0
7	50338221	.	A	T	1	2	3	0	0	3	0	0
7	50376101	.	T	A	3	2	5	0	0	5	0	0
7	50376214	.	T	C	8	4	12	0	0	12	0	0
7	50376243	.	G	A	4	3	7	0	0	7	0	0
7	50376255	.	A	G	4	3	7	0	0	7	0	0
7	50376285	.	A	G	1	4	5	0	0	5	0	0
7	50376395	.	G	A	9	9	18	0	0	18	0	0
7	50376518	.	C	A	4	3	7	0	0	7	0	0
7	50376720	.	A	T	3	8	11	0	0	12	1	0
7	50376751	.	G	A	3	10	13	0	0	13	0	0
7	50377025	.	A	G	11	8	19	0	1	20	0	0
7	50377045	.	C	T	0	7	7	0	9	16	0	0
7	50388859	.	C	T	5	3	8	0	0	8	0	0
7	50388889	.	G	A	3	1	4	0	1	5	0	0
7	50395016	.	T	C	1	2	3	0	0	3	0	0
7	50395043	.	A	T	1	2	3	0	0	3	0	0
7	50396019	.	C	T	2	2	4	0	1	5	0	0
7	50399759	.	A	G	4	2	6	0	8	14	0	0
7	50399782	.	T	C	3	4	7	0	1	8	0	0
7	50400267	.	A	G	2	5	7	0	0	7	0	0
7	50407469	.	A	G	12	8	20	1	1	22	0	0
7	50407532	.	T	C	9	14	23	0	3	26	0	0
7	50407587	.	T	C	14	10	24	0	2	26	0	0
7	50407588	.	C	A	14	10	24	0	1	25	0	0
7	50407724	.	C	T	12	10	22	0	1	23	0	0
7	50410394	.	T	A	29	23	52	0	1	53	0	0
7	50410475	.	T	C	6	9	15	0	2	17	0	0
7	50474702	.	T	G	2	2	4	0	0	4	0	0
7	50476306	.	A	T	5	3	8	0	0	8	0	0
7	50476320	.	G	A	3	2	5	0	0	5	0	0
7	50476757	.	A	T	4	3	7	0	0	7	0	0
7	50476769	.	T	C	1	3	4	0	0	4	0	0
7	50548086	.	A	G	2	2	4	0	0	4	0	0
7	50650147	.	C	G	1	2	3	0	0	3	0	0
7	50829360	.	G	C	1	2	3	0	1	4	0	0
7	50830997	.	C	T	2	3	5	0	0	5	0	0
7	50833143	.	T	C	3	2	5	0	0	5	0	0
7	50836382	.	C	T	2	5	7	0	0	7	0	0
7	50836424	.	C	T	6	3	9	0	0	9	0	0
7	50837949	.	G	A	4	3	7	0	1	8	0	0
7	50838135	.	G	C	0	6	6	0	10	16	0	0
7	50838194	.	C	A	2	4	6	0	0	6	0	0
7	50840008	.	C	T	4	4	8	0	0	8	0	0
7	50840428	.	G	A	3	5	8	1	0	9	0	0
7	50840512	.	C	T	6	7	13	0	0	13	0	0
7	50841237	.	C	T	11	10	21	0	2	23	0	0
7	50841690	.	G	A	1	6	7	0	8	15	0	0
7	50841693	.	A	T	9	6	15	0	0	15	0	0
7	50843813	.	C	A	13	7	20	0	0	20	0	0
7	50843827	.	A	G	12	7	19	0	0	19	0	0
7	50844117	.	G	A	3	14	17	0	10	27	0	0
7	50844142	.	G	A	11	14	25	0	0	25	0	0
7	50844165	.	C	T	18	10	28	0	0	28	0	0
7	50844830	.	G	T	11	15	26	0	1	27	0	0
7	50844834	.	G	A	1	11	12	0	16	28	0	0
7	50844895	.	A	T	13	10	23	0	0	23	0	0
7	50844936	.	A	T	12	8	20	0	1	22	1	0
7	50845000	.	G	A	15	19	34	0	0	34	0	0
7	50845105	.	A	T	15	16	31	0	3	34	0	0
7	50845158	.	A	G	6	12	18	0	0	18	0	0
7	50845210	.	A	G	9	19	28	0	0	28	0	0
7	50845331	.	G	A	2	5	7	0	9	16	0	0
7	50845486	.	A	T	12	3	15	0	1	16	0	0
7	50845646	.	C	T	10	10	20	0	0	20	0	0
7	50845892	.	C	A	9	20	29	0	3	32	0	0
7	50846055	.	T	C	14	17	31	1	2	34	0	0
7	50846081	.	T	A	18	16	34	1	1	36	0	0
7	50877064	.	T	C	2	14	16	0	1	17	0	0
7	50878385	.	T	C	4	2	6	0	0	6	0	0
7	50878838	.	G	A	2	2	4	0	0	4	0	0
7	50878864	.	A	T	1	2	3	0	0	3	0	0
7	50879591	.	T	C	6	2	8	0	0	8	0	0
7	50879595	.	C	T	6	2	8	0	0	8	0	0
7	50880436	.	A	G	1	2	3	0	0	3	0	0
7	50880527	.	G	T	1	3	4	0	0	4	0	0
7	50881641	.	G	T	3	2	5	0	0	5	0	0
7	50911223	.	T	A	13	6	19	0	3	22	0	0
7	50911278	.	C	T	16	18	34	0	4	38	0	0
7	50912212	.	C	T	17	12	29	0	0	29	0	0
7	50912227	.	C	G	15	14	29	0	3	32	0	0
7	50917219	.	C	T	9	5	14	0	0	14	0	0
7	51219420	.	C	G	9	5	14	0	2	16	0	0
7	51219436	.	A	C	8	9	17	0	0	17	0	0
7	51221418	.	T	A	4	4	8	0	0	8	0	0
7	51221475	.	C	T	5	5	10	0	1	11	0	0
7	51221784	.	A	G	2	2	4	0	2	6	0	0
7	51222115	.	G	A	6	3	9	0	0	9	0	0
7	51222297	.	G	A	3	4	7	0	0	7	0	0
7	51246426	.	G	A	4	7	11	0	0	11	0	0
7	51246457	.	G	T	4	5	9	0	1	10	0	0
7	51246573	.	T	C	5	6	11	0	0	11	0	0
7	51247467	.	C	T	0	3	3	0	1	4	0	0
7	51315177	.	G	T	2	2	4	0	0	4	0	0
7	51353191	.	G	A	4	3	7	0	1	8	0	0
7	51353447	.	G	T	3	3	6	0	0	6	0	0
7	51353989	.	G	T	2	2	4	0	0	4	0	0
7	51354296	.	A	G	2	7	9	0	0	9	0	0
7	51355265	.	A	T	3	6	9	0	0	9	0	0
7	51355437	.	A	G	4	2	6	0	1	7	0	0
7	51355515	.	A	T	5	4	9	0	0	9	0	0
7	51356059	.	A	G	3	4	7	0	0	7	0	0
7	51356100	.	A	T	12	4	16	0	0	16	0	0
7	51356389	.	T	C	5	2	7	0	0	8	1	0
7	51356542	.	C	G	10	10	20	0	0	20	0	0
7	51356625	.	C	A	17	13	30	0	0	30	0	0
7	51356733	.	G	T	10	5	15	0	1	16	0	0
7	51356767	.	C	A	6	3	9	0	0	9	0	0
7	51365935	.	G	A	4	2	6	0	0	6	0	0
7	51368654	.	T	G	1	2	3	0	1	4	0	0
7	51468119	.	C	T	24	15	39	1	3	43	0	0
7	51468241	.	C	T	20	20	40	0	2	42	0	0
7	51468389	.	C	T	2	13	15	0	13	28	0	0
7	51468411	.	A	T	16	13	29	0	0	29	0	0
7	51468577	.	C	A	20	19	39	0	1	40	0	0
7	51469048	.	T	G	14	25	39	0	1	40	0	0
7	51469166	.	A	T	15	18	33	0	0	33	0	0
7	51469267	.	G	C	12	13	25	0	1	26	0	0
7	51469304	.	T	A	6	19	25	0	1	26	0	0
7	51469518	.	T	A	8	13	21	0	2	23	0	0
7	51469578	.	T	G	11	6	17	0	1	18	0	0
7	51469814	.	C	T	1	13	14	0	10	24	0	0
7	51469897	.	A	G	6	6	12	0	0	12	0	0
7	51470070	.	T	C	7	0	7	1	11	19	0	0
7	51470286	.	T	C	2	5	7	0	1	8	0	0
7	51470569	.	G	T	7	8	15	0	1	16	0	0
7	51471195	.	T	C	7	7	14	0	0	14	0	0
7	51471201	.	G	A	8	5	13	0	0	13	0	0
7	51471379	.	G	A	6	6	12	0	0	12	0	0
7	51471547	.	T	C	8	3	11	0	0	11	0	0
7	51471554	.	T	C	2	0	2	0	7	9	0	0
7	51471591	.	T	C	6	3	9	0	2	11	0	0
7	51471714	.	A	G	2	5	7	0	1	8	0	0
7	51472456	.	C	T	3	7	10	0	0	10	0	0
7	51472534	.	T	A	4	2	6	0	0	6	0	0
7	51472536	.	T	A	4	2	6	0	0	6	0	0
7	51472853	.	G	A	6	4	10	0	0	10	0	0
7	51473000	.	C	T	3	6	9	0	1	10	0	0
7	51473021	.	C	T	4	3	7	0	0	7	0	0
7	51473585	.	T	C	1	0	1	0	3	4	0	0
7	51473814	.	C	T	7	5	12	0	0	12	0	0
7	51473831	.	T	G	5	5	10	0	0	10	0	0
7	51474279	.	C	A	5	2	7	0	0	7	0	0
7	51474300	.	G	T	5	2	7	0	0	7	0	0
7	51474832	.	T	G	3	2	5	0	0	5	0	0
7	51476108	.	G	A	1	2	3	0	0	3	0	0
7	51634285	.	C	T	41	28	69	0	4	73	0	0
7	51634480	.	G	A	33	36	69	0	4	73	0	0
7	51635615	.	A	G	31	41	72	0	2	74	0	0
7	51643163	.	A	G	2	10	12	0	0	12	0	0
7	51643212	.	G	A	4	4	8	0	2	10	0	0
7	51643409	.	C	A	6	2	8	0	0	8	0	0
7	51643639	.	A	C	4	6	10	0	1	11	0	0
7	51656256	.	G	A	2	4	6	0	0	6	0	0
7	51698403	.	T	A	5	2	7	0	0	7	0	0
7	51705806	.	C	G	3	2	5	0	0	5	0	0
7	51713087	.	A	T	2	5	7	0	0	7	0	0
7	51713257	.	G	A	4	8	12	0	0	12	0	0
7	51713267	.	G	A	4	8	12	0	1	13	0	0
7	51779628	.	G	A	10	9	19	0	0	19	0	0
7	51779636	.	T	C	10	9	19	0	2	21	0	0
7	51785901	.	T	C	13	12	25	0	3	28	0	0
7	51788227	.	T	G	18	17	35	0	1	36	0	0
7	51788756	.	A	C	15	20	35	2	2	39	0	0
7	51806570	.	T	C	1	2	3	0	0	3	0	0
7	51814287	.	C	G	9	3	12	0	0	12	0	0
7	51814445	.	T	A	6	2	8	0	1	9	0	0
7	51814512	.	C	T	5	3	8	0	0	8	0	0
7	51824244	.	T	C	1	2	3	0	0	3	0	0
7	51826045	.	A	G	2	1	3	0	7	10	0	0
7	52151265	.	T	G	1	3	4	0	0	4	0	0
7	52152016	.	C	T	3	3	6	0	0	6	0	0
7	52152101	.	C	T	2	3	5	0	0	5	0	0
7	52152791	.	C	A	0	2	2	0	2	4	0	0
7	52156095	.	G	A	0	3	3	0	2	5	0	0
7	52156137	.	T	A	3	2	5	0	0	5	0	0
7	52157845	.	A	T	5	11	16	0	0	16	0	0
7	52161931	.	C	G	2	4	6	0	0	6	0	0
7	52165601	.	C	T	2	3	5	0	0	5	0	0
7	52173207	.	G	A	9	6	15	0	0	15	0	0
7	52173228	.	A	G	10	6	16	0	1	17	0	0
7	52285027	.	T	C	11	10	21	1	0	22	0	0
7	52285035	.	C	T	12	6	18	1	1	20	0	0
7	52285113	.	C	G	8	6	14	0	1	15	0	0
7	52294009	.	G	T	11	7	18	0	1	19	0	0
7	52294540	.	A	T	15	7	22	0	2	24	0	0
7	52294579	.	C	T	12	8	20	0	0	20	0	0
7	52294756	.	A	T	11	8	19	0	2	21	0	0
7	52295016	.	C	T	1	13	14	0	14	28	0	0
7	52295183	.	G	A	18	15	33	0	1	34	0	0
7	52295795	.	C	T	3	9	12	0	13	25	0	0
7	52296064	.	A	C	9	0	9	0	13	22	0	0
7	52296221	.	G	A	12	8	20	0	1	21	0	0
7	52296791	.	G	A	12	5	17	0	1	18	0	0
7	52309924	.	G	A	5	9	14	0	0	14	0	0
7	52315418	.	A	G	1	1	2	0	0	2	0	0
7	52328569	.	C	T	1	4	5	0	0	5	0	0
7	52432249	.	G	A	5	5	10	0	0	10	0	0
7	52432317	.	T	G	1	2	3	0	0	3	0	0
7	52432459	.	G	A	2	5	7	0	2	9	0	0
7	52432502	.	G	A	3	3	6	0	1	7	0	0
7	52517325	.	G	A	2	5	7	0	0	7	0	0
7	52517759	.	G	A	11	5	16	0	0	16	0	0
7	52518529	.	T	G	5	7	12	0	0	12	0	0
7	52518813	.	C	T	3	8	11	0	0	11	0	0
7	52519015	.	T	C	6	6	12	0	2	14	0	0
7	52521352	.	G	A	3	3	6	0	1	7	0	0
7	52531152	.	C	T	1	3	4	0	4	8	0	0
7	52533621	.	C	T	1	2	3	1	1	5	0	0
7	52716777	.	T	A	4	3	7	0	0	7	0	0
7	52716875	.	C	A	2	5	7	0	0	7	0	0
7	52717095	.	T	C	3	3	6	0	0	6	0	0
7	52750565	.	C	T	13	19	32	0	2	34	0	0
7	52750656	.	G	A	12	15	27	0	0	27	0	0
7	52750776	.	G	T	11	11	22	0	0	22	0	0
7	52750847	.	C	T	11	7	18	0	3	21	0	0
7	52751016	.	C	T	15	10	25	0	2	27	0	0
7	52751306	.	T	C	3	8	11	0	0	11	0	0
7	52753582	.	C	T	2	3	5	0	1	6	0	0
7	52761496	.	G	T	1	2	3	0	2	5	0	0
7	52765985	.	G	T	0	2	2	0	1	3	0	0
7	52765999	.	T	A	1	2	3	0	0	3	0	0
7	52789065	.	C	T	3	2	5	0	0	5	0	0
7	52793313	.	C	T	1	6	7	0	0	7	0	0
7	52820092	.	G	C	6	5	11	0	0	11	0	0
7	52820221	.	G	A	1	3	4	0	7	11	0	0
7	52820320	.	C	T	10	9	19	0	0	19	0	0
7	52821658	.	C	A	4	4	8	0	0	8	0	0
7	52821691	.	A	C	4	5	9	0	0	9	0	0
7	52821904	.	G	A	9	7	16	0	0	16	0	0
7	52822136	.	G	A	9	8	17	0	1	18	0	0
7	52822351	.	A	T	17	9	26	0	1	27	0	0
7	52822493	.	A	C	3	11	14	1	1	16	0	0
7	52822773	.	C	T	4	9	13	0	0	13	0	0
7	52822791	.	T	G	8	0	8	0	9	17	0	0
7	52822860	.	A	G	3	8	11	0	1	12	0	0
7	52823161	.	G	A	6	8	14	0	2	16	0	0
7	52823210	.	C	G	5	11	16	0	0	16	0	0
7	52823377	.	T	A	5	4	9	0	0	9	0	0
7	52823388	.	C	T	7	5	12	0	0	12	0	0
7	52823429	.	A	T	12	10	22	0	1	23	0	0
7	52830591	.	A	T	12	25	37	0	2	39	0	0
7	52830601	.	T	G	28	13	41	0	1	42	0	0
7	52830639	.	C	T	34	15	49	0	3	52	0	0
7	52831053	.	G	T	29	25	54	0	2	56	0	0
7	52831198	.	T	A	10	20	30	0	3	33	0	0
7	52831236	.	A	G	12	16	28	0	5	33	0	0
7	52831430	.	C	T	15	13	28	0	1	29	0	0
7	52833126	.	C	G	6	5	11	0	1	12	0	0
7	52833248	.	A	T	9	5	14	0	2	16	0	0
7	52833329	.	G	T	17	13	30	0	0	30	0	0
7	52833682	.	T	A	14	11	25	5	1	31	0	0
7	52833792	.	G	A	13	18	31	0	0	31	0	0
7	52834334	.	T	G	10	5	15	0	0	15	0	0
7	52836325	.	C	T	10	18	28	0	4	32	0	0
7	52836403	.	A	G	17	12	29	0	3	32	0	0
7	52836451	.	C	T	15	22	37	0	3	40	0	0
7	52837644	.	G	A	7	5	12	0	0	12	0	0
7	52837686	.	C	A	6	5	11	0	0	11	0	0
7	52837687	.	T	A	6	5	11	0	0	11	0	0
7	52839062	.	C	T	5	3	8	0	0	8	0	0
7	52840871	.	T	A	16	13	29	0	5	34	0	0
7	52841276	.	A	G	8	3	11	1	1	13	0	0
7	52900987	.	C	T	8	5	13	0	0	13	0	0
7	52921521	.	C	A	8	9	17	0	1	18	0	0
7	52924873	.	T	A	9	17	26	0	0	26	0	0
7	52929182	.	G	A	17	30	47	0	2	49	0	0
7	52933088	.	C	A	19	23	42	0	1	43	0	0
7	52933191	.	C	T	2	9	11	0	0	11	0	0
7	52937334	.	G	A	5	12	17	0	1	18	0	0
7	52942312	.	G	T	9	6	15	0	1	16	0	0
7	52942472	.	C	T	7	7	14	0	0	14	0	0
7	52944199	.	G	A	4	8	12	0	0	12	0	0
7	52959391	.	C	A	1	2	3	0	0	3	0	0
7	52962765	.	T	C	3	0	3	0	6	9	0	0
7	53010382	.	C	G	3	0	3	2	3	8	0	0
7	53010419	.	G	T	2	2	4	0	2	6	0	0
7	53162425	.	T	C	2	4	6	0	1	7	0	0
7	53162537	.	A	G	1	2	3	0	0	3	0	0
7	53529634	.	C	T	6	2	8	0	0	8	0	0
7	55532234	.	C	T	1	2	3	1	1	5	0	0
7	55532316	.	A	G	4	4	8	0	0	8	0	0
7	55635355	.	G	A	0	3	3	0	8	11	0	0
7	55637122	.	C	A	5	6	11	0	0	11	0	0
7	55637360	.	G	A	1	4	5	0	0	5	0	0
7	55660269	.	G	A	7	11	18	0	0	18	0	0
7	55671547	.	T	C	3	2	5	0	1	6	0	0
7	55675544	.	T	C	3	0	3	0	7	10	0	0
7	55675577	.	G	A	5	3	8	0	1	9	0	0
7	55953298	.	G	C	1	2	3	0	0	3	0	0
7	56020062	.	C	T	1	3	4	0	0	4	0	0
7	56152686	.	G	C	12	9	21	0	0	21	0	0
7	56158111	.	G	A	11	11	22	0	1	23	0	0
7	56158197	.	G	A	8	7	15	0	2	17	0	0
7	56158823	.	A	G	12	7	19	0	0	19	0	0
7	56158874	.	C	T	6	7	13	0	2	15	0	0
7	56172458	.	T	C	4	6	10	0	1	11	0	0
7	56174222	.	T	C	3	3	6	0	1	7	0	0
7	56177177	.	C	T	1	6	7	0	1	8	0	0
7	56177188	.	T	G	1	5	6	0	0	6	0	0
7	56180482	.	G	A	2	2	4	0	0	4	0	0
7	56398522	.	A	T	3	2	5	0	0	5	0	0
7	56398651	.	C	T	2	3	5	0	0	5	0	0
7	56401049	.	A	G	8	4	12	0	0	12	0	0
7	56401173	.	T	C	3	4	7	0	0	7	0	0
7	56405508	.	T	C	6	10	16	0	0	16	0	0
7	56483078	.	T	C	1	2	3	0	0	3	0	0
7	56484426	.	G	A	14	11	25	0	2	27	0	0
7	56528494	.	C	T	4	7	11	0	1	12	0	0
7	56529301	.	T	A	2	2	4	0	0	4	0	0
7	56529352	.	T	C	4	5	9	0	0	9	0	0
7	56830948	.	C	T	1	3	4	0	0	4	0	0
7	57049578	.	C	T	3	2	5	0	0	5	0	0
7	57049715	.	T	C	3	2	5	0	0	5	0	0
7	57050003	.	A	G	2	2	4	0	0	4	0	0
7	57050007	.	G	A	2	2	4	0	0	4	0	0
7	57065184	.	T	C	4	2	6	0	0	6	0	0
7	57065256	.	G	T	2	3	5	0	0	5	0	0
7	57071707	.	C	T	3	3	6	0	1	7	0	0
7	57081146	.	T	C	5	4	9	0	0	9	0	0
7	57083156	.	A	T	3	5	8	0	0	8	0	0
7	57086153	.	C	T	4	8	12	0	0	12	0	0
7	57115563	.	C	G	1	2	3	0	0	3	0	0
7	57119399	.	A	C	1	2	3	0	0	3	0	0
7	57129590	.	G	T	0	3	3	0	4	7	0	0
7	57342608	.	A	G	6	0	6	0	4	10	0	0
7	57342623	.	A	G	4	5	9	0	0	9	0	0
7	57468893	.	G	T	1	3	4	0	0	4	0	0
7	57485461	.	T	C	7	6	13	0	2	15	0	0
7	57485484	.	T	C	6	8	14	0	3	17	0	0
7	57485710	.	T	C	8	10	18	0	0	18	0	0
7	57485736	.	A	G	6	7	13	0	0	13	0	0
7	57485766	.	A	G	8	5	13	0	1	14	0	0
7	57494115	.	C	T	12	10	22	1	1	24	0	0
7	57497456	.	T	C	5	0	5	0	5	10	0	0
7	57504905	.	C	G	7	7	14	0	1	15	0	0
7	57509353	.	C	T	2	4	6	0	0	6	0	0
7	60243042	.	A	G	2	3	5	0	1	6	0	0
7	60395020	.	C	T	0	6	6	0	1	7	0	0
7	61953293	.	C	T	1	7	8	0	0	8	0	0
7	65473814	.	T	C	29	16	45	0	1	47	1	0
7	65923044	.	T	A	2	5	7	0	0	7	0	0
7	66112702	.	T	C	6	13	19	0	0	19	0	0
7	67744341	.	A	G	10	4	14	0	2	16	0	0
7	69146070	.	T	C	2	2	4	0	0	4	0	0
7	69146176	.	T	C	2	3	5	0	2	7	0	0
7	69146362	.	T	C	4	6	10	0	0	10	0	0
7	69146421	.	T	C	3	5	8	0	0	8	0	0
7	69437422	.	A	C	3	3	6	0	0	6	0	0
7	69437472	.	T	C	3	3	6	0	0	6	0	0
7	69437495	.	C	A	2	4	6	0	0	6	0	0
7	69439094	.	T	A	6	2	8	0	0	8	0	0
7	69439580	.	A	G	2	2	4	0	0	4	0	0
7	69439587	.	A	G	2	0	2	0	2	4	0	0
7	69442374	.	C	T	3	5	8	0	0	8	0	0
7	69447324	.	G	A	5	4	9	0	1	10	0	0
7	69447352	.	T	C	6	5	11	0	1	12	0	0
7	69447469	.	C	G	10	5	15	0	1	16	0	0
7	69447516	.	A	G	11	7	18	0	0	18	0	0
7	69447520	.	G	A	9	8	17	0	1	18	0	0
7	69458368	.	G	A	0	4	4	0	1	5	0	0
7	69458611	.	T	C	2	3	5	0	1	6	0	0
7	69467145	.	A	G	5	2	7	0	0	7	0	0
7	69467228	.	G	A	2	4	6	0	1	7	0	0
7	69467267	.	A	G	3	10	13	0	1	14	0	0
7	69467383	.	T	G	3	0	3	0	3	6	0	0
7	69477283	.	T	G	32	18	50	1	6	60	3	0
7	69477303	.	A	G	21	2	23	0	30	53	0	0
7	69477361	.	T	C	22	32	54	0	4	58	0	0
7	69477437	.	A	G	26	24	50	0	5	55	0	0
7	69477464	.	T	C	31	20	51	0	3	54	0	0
7	69496521	.	C	A	17	12	29	0	0	29	0	0
7	69496537	.	A	T	16	12	28	0	1	29	0	0
7	69496572	.	A	G	13	18	31	0	1	32	0	0
7	69497048	.	A	T	12	11	23	0	0	23	0	0
7	69497493	.	G	T	13	19	32	0	0	32	0	0
7	69497637	.	G	A	14	12	26	0	2	28	0	0
7	69501040	.	A	G	13	12	25	0	1	26	0	0
7	69501148	.	A	G	9	9	18	0	3	21	0	0
7	69501300	.	A	G	6	9	15	0	1	16	0	0
7	69501345	.	G	T	3	8	11	0	1	12	0	0
7	69518021	.	T	A	4	5	9	0	0	9	0	0
7	69518077	.	T	A	4	7	11	0	1	12	0	0
7	69566908	.	G	A	1	4	5	0	4	9	0	0
7	69641293	.	G	A	0	2	2	0	1	3	0	0
7	69943002	.	C	T	2	2	4	0	0	4	0	0
7	69950304	.	A	G	5	3	8	0	1	9	0	0
7	69950644	.	G	T	4	2	6	0	2	8	0	0
7	69950666	.	T	C	5	5	10	0	0	10	0	0
7	69962366	.	C	T	1	3	4	0	0	4	0	0
7	69967043	.	A	T	4	2	6	0	0	6	0	0
7	70267233	.	T	C	3	0	3	0	5	8	0	0
7	70267329	.	T	A	2	4	6	0	0	6	0	0
7	70267426	.	T	C	3	2	5	0	2	7	0	0
7	70267453	.	A	G	4	6	10	0	1	11	0	0
7	70267622	.	G	T	1	2	3	0	1	4	0	0
7	70267680	.	T	C	4	3	7	0	0	7	0	0
7	70267954	.	C	G	1	2	3	0	1	4	0	0
7	70588306	.	G	A	2	3	5	0	0	5	0	0
7	70601377	.	C	T	4	2	6	0	0	6	0	0
7	70611159	.	C	T	1	7	8	0	0	8	0	0
7	70611567	.	T	C	3	2	5	0	1	6	0	0
7	70611606	.	G	A	4	2	6	0	0	6	0	0
7	70619253	.	G	A	2	2	4	0	0	4	0	0
7	72028746	.	A	G	5	0	5	0	13	18	0	0
7	72103333	.	T	A	10	4	14	17	4	35	0	0
7	72567240	.	A	G	1	7	8	0	0	8	0	0
7	72583540	.	G	T	8	8	16	0	1	17	0	0
7	72585106	.	A	C	0	3	3	0	1	4	0	0
7	73012582	.	C	T	1	1	2	0	0	2	0	0
7	73012597	.	G	A	1	2	3	0	0	3	0	0
7	73048746	.	C	G	1	4	5	0	0	5	0	0
7	73084736	.	G	A	1	5	6	0	8	14	0	0
7	73084738	.	C	G	8	0	8	0	5	13	0	0
7	73084873	.	T	G	6	0	6	0	5	11	0	0
7	73084948	.	T	C	2	5	7	0	0	7	0	0
7	73085083	.	G	A	8	4	12	0	1	13	0	0
7	73085188	.	A	T	8	4	12	0	0	12	0	0
7	73085190	.	A	C	8	4	12	0	0	12	0	0
7	73085416	.	G	A	0	5	5	0	2	7	0	0
7	73085432	.	T	C	2	4	6	0	0	6	0	0
7	73085730	.	C	T	1	2	3	0	0	3	0	0
7	73085777	.	T	C	1	4	5	0	0	5	0	0
7	73085837	.	T	C	1	1	2	0	0	2	0	0
7	73085868	.	A	G	1	3	4	0	0	4	0	0
7	73085889	.	T	C	2	3	5	0	0	5	0	0
7	73085914	.	A	G	1	2	3	0	1	4	0	0
7	73086051	.	T	G	7	5	12	0	1	13	0	0
7	73086061	.	A	T	8	7	15	0	0	15	0	0
7	73086217	.	A	G	3	3	6	0	0	6	0	0
7	73086326	.	T	C	3	4	7	0	0	7	0	0
7	73086486	.	A	G	2	7	9	0	0	9	0	0
7	73086580	.	G	A	12	3	15	0	2	17	0	0
7	73086949	.	T	A	5	2	7	0	0	7	0	0
7	73086952	.	G	A	5	2	7	0	0	7	0	0
7	73087208	.	A	G	15	6	21	0	0	21	0	0
7	73087209	.	T	C	16	6	22	0	0	22	0	0
7	73087250	.	A	C	9	9	18	0	0	18	0	0
7	73087266	.	G	A	9	12	21	0	0	21	0	0
7	73087329	.	T	G	7	12	19	0	4	23	0	0
7	73087344	.	T	C	10	14	24	0	1	25	0	0
7	73087374	.	A	T	10	13	23	0	2	25	0	0
7	73087479	.	A	C	13	8	21	0	0	21	0	0
7	73087491	.	G	A	13	7	20	0	1	21	0	0
7	73087528	.	T	C	10	7	17	0	0	17	0	0
7	73087600	.	A	G	7	0	7	0	10	17	0	0
7	73087702	.	A	G	10	0	10	1	6	17	0	0
7	73087741	.	G	C	2	11	13	1	11	25	0	0
7	73087895	.	A	C	14	21	35	0	1	36	0	0
7	73088489	.	C	T	4	18	22	0	0	22	0	0
7	73316676	.	G	A	5	2	7	0	0	7	0	0
7	73337684	.	G	A	3	3	6	0	0	6	0	0
7	73338005	.	G	A	0	2	2	0	4	6	0	0
7	73338051	.	C	G	1	3	4	0	0	4	0	0
7	73397528	.	G	A	2	3	5	0	5	10	0	0
7	73397531	.	C	T	7	3	10	0	0	10	0	0
7	73397568	.	T	C	4	4	8	0	0	8	0	0
7	73401946	.	C	T	11	10	21	0	1	22	0	0
7	73612138	.	T	A	1	2	3	0	0	3	0	0
7	73612683	.	G	A	2	2	4	0	0	4	0	0
7	73613555	.	G	T	4	4	8	0	0	8	0	0
7	73615798	.	C	T	5	3	8	0	0	8	0	0
7	73615889	.	G	A	3	4	7	0	0	7	0	0
7	73616027	.	A	G	2	2	4	0	0	4	0	0
7	73616547	.	T	A	9	7	16	0	0	16	0	0
7	73616711	.	T	C	2	4	6	0	0	6	0	0
7	73617759	.	G	A	0	6	6	0	6	12	0	0
7	73617792	.	A	G	1	10	11	0	1	12	0	0
7	73617817	.	A	G	8	4	12	1	1	14	0	0
7	73617978	.	C	T	10	6	16	0	1	17	0	0
7	73617995	.	C	T	12	7	19	0	0	19	0	0
7	73618030	.	C	T	27	4	31	0	2	33	0	0
7	73618220	.	C	A	3	5	8	0	0	8	0	0
7	73618549	.	G	A	8	4	12	0	0	12	0	0
7	73618841	.	A	G	6	3	9	0	1	10	0	0
7	73618866	.	A	G	9	0	9	0	3	12	0	0
7	73619153	.	T	A	12	7	19	0	1	20	0	0
7	73619587	.	A	C	11	4	15	0	1	16	0	0
7	73620129	.	C	T	18	21	39	0	2	41	0	0
7	73630951	.	G	C	17	23	40	0	1	41	0	0
7	73630955	.	G	A	3	22	25	0	19	44	0	0
7	73651959	.	C	A	23	21	44	0	2	46	0	0
7	73652321	.	T	A	16	22	38	0	3	41	0	0
7	73652715	.	A	T	19	14	33	0	2	35	0	0
7	73652819	.	C	T	12	16	28	0	1	29	0	0
7	73652873	.	G	T	11	15	26	0	2	28	0	0
7	73652892	.	A	G	14	0	14	0	17	31	0	0
7	73653241	.	T	C	18	22	40	0	3	43	0	0
7	73653373	.	C	A	17	28	45	0	2	47	0	0
7	73653994	.	G	A	19	13	32	0	2	35	1	0
7	73654065	.	T	C	9	17	26	0	0	26	0	0
7	73654505	.	C	T	27	15	42	0	4	46	0	0
7	73654647	.	C	G	32	0	32	0	34	66	0	0
7	73654652	.	G	A	33	25	58	0	8	66	0	0
7	73654693	.	A	C	34	33	67	0	0	67	0	0
7	73654742	.	C	A	31	39	70	0	1	71	0	0
7	73654827	.	A	G	23	33	56	0	5	61	0	0
7	73654878	.	C	T	20	33	53	0	3	56	0	0
7	73654896	.	G	A	31	20	51	0	5	56	0	0
7	73655474	.	T	G	46	21	67	0	1	68	0	0
7	73655580	.	G	A	39	26	65	0	2	67	0	0
7	73655698	.	A	G	20	31	51	0	1	52	0	0
7	73655775	.	T	C	14	10	24	0	3	27	0	0
7	73655997	.	C	T	33	37	70	0	2	72	0	0
7	73655998	.	T	C	34	33	67	0	5	72	0	0
7	73656075	.	T	C	38	35	73	0	4	77	0	0
7	73656136	.	G	A	27	33	60	0	4	64	0	0
7	73927852	.	A	G	3	0	3	0	2	5	0	0
7	74084370	.	G	A	3	5	8	1	0	9	0	0
7	74084768	.	G	A	4	2	6	0	1	7	0	0
7	74085487	.	C	T	0	4	4	0	3	7	0	0
7	74086382	.	T	C	2	0	2	0	2	4	0	0
7	74134988	.	T	C	19	17	36	0	0	36	0	0
7	74135136	.	G	A	2	27	29	0	25	54	0	0
7	74135375	.	C	T	19	24	43	0	4	47	0	0
7	74135462	.	A	G	20	15	35	0	4	39	0	0
7	74141299	.	T	C	5	3	8	0	0	8	0	0
7	74143628	.	C	T	3	2	5	0	1	6	0	0
7	74144167	.	A	G	11	0	11	0	6	17	0	0
7	74154066	.	C	T	31	23	54	0	2	56	0	0
8	41751	.	G	C	10	16	26	0	2	28	0	0
8	41754	.	C	T	11	17	28	0	2	30	0	0
8	41925	.	T	C	17	1	18	0	14	32	0	0
8	41948	.	A	G	14	17	31	0	3	34	0	0
8	43740	.	T	C	9	0	9	0	21	30	0	0
8	43800	.	A	G	15	9	24	0	1	25	0	0
8	44337	.	G	A	5	10	15	0	2	17	0	0
8	52280	.	C	T	6	9	15	1	2	18	0	0
8	56225	.	T	G	5	7	12	0	1	13	0	0
8	56285	.	A	G	1	7	8	0	0	8	0	0
8	56884	.	C	T	5	5	10	0	0	10	0	0
8	58399	.	C	G	4	7	11	0	0	11	0	0
8	61833	.	G	A	4	8	12	0	1	13	0	0
8	75188	.	C	A	6	5	11	0	0	11	0	0
8	75446	.	G	T	1	5	6	0	8	14	0	0
8	75646	.	G	C	0	3	3	0	4	7	0	0
8	75669	.	C	G	3	5	8	0	0	8	0	0
8	109321	.	G	A	0	3	3	0	3	6	0	0
8	109375	.	C	A	1	2	3	0	0	3	0	0
8	109378	.	T	C	1	2	3	0	0	3	0	0
8	115080	.	T	C	2	2	4	0	0	4	0	0
8	120282	.	G	A	2	3	5	0	1	6	0	0
8	120839	.	G	A	0	6	6	0	4	10	0	0
8	120896	.	T	C	7	9	16	0	0	16	0	0
8	121145	.	A	C	2	2	4	0	0	4	0	0
8	121149	.	A	C	2	2	4	0	0	4	0	0
8	158431	.	C	T	3	9	12	0	0	12	0	0
8	173841	.	A	G	17	9	26	0	0	26	0	0
8	174020	.	G	A	19	12	31	0	1	32	0	0
8	261498	.	T	C	2	2	4	0	0	4	0	0
8	262012	.	C	T	3	2	5	0	0	5	0	0
8	262858	.	G	T	0	6	6	0	4	10	0	0
8	268215	.	G	A	6	4	10	0	1	11	0	0
8	269360	.	G	T	6	2	8	0	0	8	0	0
8	276277	.	C	T	4	6	10	1	1	12	0	0
8	276334	.	A	G	5	8	13	0	3	16	0	0
8	286192	.	A	G	12	8	20	0	1	21	0	0
8	286251	.	C	T	16	12	28	0	2	30	0	0
8	286302	.	G	A	13	13	26	0	3	29	0	0
8	387853	.	A	T	6	3	9	0	0	9	0	0
8	388020	.	G	C	6	9	15	0	0	15	0	0
8	388885	.	C	T	13	12	25	0	4	29	0	0
8	389114	.	T	A	6	14	20	0	0	20	0	0
8	391931	.	A	C	4	3	7	0	4	11	0	0
8	391988	.	C	A	16	6	22	0	5	27	0	0
8	392047	.	G	T	12	12	24	1	2	27	0	0
8	395281	.	C	A	1	12	13	0	5	18	0	0
8	395287	.	C	T	5	14	19	0	0	19	0	0
8	397341	.	C	T	1	12	13	0	8	21	0	0
8	400185	.	C	G	3	3	6	0	0	6	0	0
8	412303	.	G	A	8	4	12	1	3	16	0	0
8	412504	.	T	C	13	1	14	1	14	29	0	0
8	423533	.	T	C	6	10	16	0	1	17	0	0
8	423723	.	C	T	11	8	19	0	5	24	0	0
8	423815	.	C	A	21	14	35	0	0	35	0	0
8	424123	.	G	A	9	9	18	0	0	18	0	0
8	424969	.	G	A	5	14	19	0	1	20	0	0
8	471390	.	A	C	6	3	9	0	0	9	0	0
8	473773	.	G	A	1	4	5	0	1	6	0	0
8	478707	.	C	T	2	4	6	0	1	7	0	0
8	478844	.	T	C	4	4	8	0	0	8	0	0
8	478889	.	G	T	5	2	7	0	0	7	0	0
8	481970	.	C	T	4	2	6	0	0	6	0	0
8	481976	.	G	C	4	2	6	0	0	6	0	0
8	482033	.	A	G	6	3	9	0	0	9	0	0
8	487208	.	G	A	3	6	9	0	0	9	0	0
8	487241	.	T	C	2	11	13	0	0	13	0	0
8	489169	.	C	T	7	4	11	0	0	11	0	0
8	489194	.	T	A	7	6	13	0	0	13	0	0
8	534418	.	C	T	0	2	2	0	3	5	0	0
8	540214	.	G	A	1	13	14	0	8	22	0	0
8	541376	.	C	A	8	9	17	0	2	19	0	0
8	595166	.	C	T	0	3	3	1	6	10	0	0
8	660467	.	T	C	3	3	6	0	0	6	0	0
8	926824	.	T	C	2	3	5	0	0	5	0	0
8	927337	.	G	A	12	14	26	0	2	28	0	0
8	1012018	.	A	G	1	2	3	0	1	4	0	0
8	1094910	.	T	A	10	5	15	0	0	15	0	0
8	1094973	.	G	T	0	3	3	0	3	6	0	0
8	1100463	.	C	T	4	12	16	0	3	19	0	0
8	1102404	.	T	C	4	8	12	0	4	16	0	0
8	1102533	.	G	T	12	11	23	0	0	23	0	0
8	1102551	.	C	T	10	7	17	0	0	17	0	0
8	1106494	.	C	A	9	5	14	0	1	15	0	0
8	1129821	.	A	G	2	3	5	0	0	5	0	0
8	1129971	.	T	G	3	3	6	0	1	7	0	0
8	1130331	.	C	T	2	3	5	0	0	5	0	0
8	1130450	.	C	G	4	0	4	0	5	9	0	0
8	1130526	.	C	A	5	5	10	0	1	11	0	0
8	1130544	.	T	C	7	3	10	0	0	10	0	0
8	1130574	.	G	A	6	8	14	0	1	15	0	0
8	1130590	.	A	T	5	8	13	0	2	15	0	0
8	1133753	.	C	G	2	3	5	0	1	6	0	0
8	1151416	.	T	C	9	15	24	0	1	25	0	0
8	1222417	.	T	C	8	1	9	0	13	22	0	0
8	1222504	.	T	C	11	1	12	0	17	29	0	0
8	1255292	.	C	G	3	14	17	0	9	26	0	0
8	1255304	.	G	A	12	10	22	0	0	22	0	0
8	1259023	.	G	A	14	15	29	0	2	31	0	0
8	1264645	.	A	G	9	6	15	0	1	16	0	0
8	1265705	.	T	G	3	10	13	0	1	14	0	0
8	1267074	.	T	A	5	13	18	0	3	21	0	0
8	1267153	.	G	A	10	11	21	0	1	22	0	0
8	1267157	.	G	A	12	9	21	0	0	21	0	0
8	1291993	.	G	A	1	3	4	0	0	4	0	0
8	1852056	.	A	G	2	4	6	0	0	6	0	0
8	1852078	.	A	G	4	3	7	0	0	7	0	0
8	1852552	.	A	G	7	3	10	0	0	10	0	0
8	1852995	.	A	G	3	2	5	0	1	6	0	0
8	1853005	.	A	G	3	3	6	0	0	6	0	0
8	1853400	.	A	G	7	7	14	0	0	14	0	0
8	1855312	.	A	G	10	5	15	0	5	20	0	0
8	1856254	.	A	G	13	9	22	1	7	30	0	0
8	1856265	.	A	G	10	20	30	1	1	32	0	0
8	3085565	.	A	G	1	2	3	0	0	3	0	0
8	3099585	.	G	A	1	5	6	0	7	13	0	0
8	3099890	.	A	T	1	2	3	0	0	3	0	0
8	3099922	.	T	C	1	2	3	0	0	3	0	0
8	3100184	.	G	C	1	4	5	0	0	5	0	0
8	3101081	.	T	A	1	3	4	0	1	5	0	0
8	3101086	.	C	A	1	3	4	0	1	5	0	0
8	3101241	.	G	T	7	6	13	0	2	15	0	0
8	3101277	.	T	C	6	7	13	0	1	14	0	0
8	3427385	.	A	G	2	2	4	0	0	4	0	0
8	3589375	.	T	G	2	2	4	0	0	4	0	0
8	3591154	.	T	C	2	2	4	0	0	4	0	0
8	3595161	.	G	A	0	2	2	0	1	3	0	0
8	3595359	.	C	T	7	4	11	0	0	11	0	0
8	3597233	.	T	C	3	2	5	0	0	5	0	0
8	3605050	.	A	G	2	0	2	0	4	6	0	0
8	3612263	.	T	A	7	5	12	0	0	13	1	0
8	3612308	.	A	T	11	7	18	0	2	20	0	0
8	3624208	.	G	C	12	10	22	0	0	22	0	0
8	3628683	.	C	T	6	9	15	0	1	16	0	0
8	3628747	.	C	A	4	4	8	0	2	10	0	0
8	3628758	.	T	A	5	5	10	0	1	11	0	0
8	3628782	.	G	A	0	8	8	0	8	16	0	0
8	3631371	.	T	C	7	10	17	0	1	18	0	0
8	3631932	.	C	T	23	23	46	0	1	47	0	0
8	3641218	.	G	C	23	17	40	1	2	43	0	0
8	3643299	.	T	C	26	20	46	1	0	47	0	0
8	3659979	.	T	C	2	6	8	0	0	8	0	0
8	3691097	.	C	T	2	1	3	0	2	5	0	0
8	3691113	.	T	C	4	0	4	0	2	6	0	0
8	3865233	.	T	C	2	3	5	0	0	5	0	0
8	3883831	.	C	G	2	5	7	0	0	7	0	0
8	3889662	.	G	A	0	4	4	0	1	5	0	0
8	3890837	.	T	C	2	4	6	0	0	6	0	0
8	3904963	.	C	T	3	3	6	0	0	6	0	0
8	3915909	.	G	A	5	5	10	0	0	10	0	0
8	3923371	.	C	T	12	9	21	0	2	23	0	0
8	3932889	.	A	T	6	3	9	0	0	9	0	0
8	3932974	.	A	G	3	4	7	1	0	8	0	0
8	3932990	.	A	G	2	5	7	1	1	9	0	0
8	3933498	.	T	A	6	15	21	0	0	22	1	0
8	3949558	.	G	T	6	2	8	0	1	9	0	0
8	3950317	.	G	A	5	5	10	0	0	10	0	0
8	3950341	.	A	G	4	3	7	0	0	7	0	0
8	3952495	.	G	T	3	2	5	0	0	5	0	0
8	4044846	.	G	A	2	5	7	0	0	7	0	0
8	4368714	.	C	G	1	8	9	0	0	9	0	0
8	4369021	.	A	C	4	5	9	0	1	10	0	0
8	4381510	.	A	G	2	0	2	0	3	5	0	0
8	4381624	.	G	A	3	3	6	0	1	7	0	0
8	4386198	.	A	G	1	3	4	0	0	4	0	0
8	4393910	.	C	G	3	2	5	0	1	6	0	0
8	4398425	.	A	T	4	3	7	0	0	7	0	0
8	4398531	.	T	C	2	4	6	0	0	6	0	0
8	4398737	.	C	T	14	6	20	0	0	20	0	0
8	4398762	.	A	G	9	4	13	0	1	14	0	0
8	4398981	.	G	A	1	4	5	0	8	13	0	0
8	4399093	.	A	G	5	5	10	0	0	10	0	0
8	4399268	.	G	A	3	4	7	0	0	7	0	0
8	4399288	.	C	T	2	7	9	0	0	9	0	0
8	4399334	.	T	C	3	5	8	0	0	8	0	0
8	4399366	.	G	A	0	3	3	0	5	8	0	0
8	4399394	.	C	G	5	2	7	0	0	7	0	0
8	4399754	.	T	A	1	6	7	0	0	8	1	0
8	4400699	.	C	A	2	8	10	0	1	11	0	0
8	4400861	.	T	C	3	15	18	0	2	20	0	0
8	4400872	.	G	A	0	11	11	0	4	15	0	0
8	4401053	.	T	G	7	12	19	0	1	20	0	0
8	4401068	.	C	T	6	13	19	0	1	20	0	0
8	4401374	.	G	A	3	9	12	0	8	20	0	0
8	4401514	.	A	T	9	9	18	0	1	19	0	0
8	4401687	.	G	A	15	15	30	1	1	32	0	0
8	4401708	.	C	T	17	18	35	0	0	35	0	0
8	4401813	.	G	T	27	15	42	0	2	44	0	0
8	4401913	.	T	G	11	7	18	0	2	20	0	0
8	4401931	.	T	C	10	10	20	0	0	20	0	0
8	4442655	.	G	A	2	3	5	0	3	8	0	0
8	4444201	.	A	G	6	3	9	0	0	9	0	0
8	4446247	.	A	C	6	0	6	0	5	11	0	0
8	4446266	.	C	T	1	3	4	0	3	7	0	0
8	4446303	.	T	C	4	4	8	0	0	8	0	0
8	4446407	.	T	C	3	0	3	0	3	6	0	0
8	4452979	.	C	T	1	2	3	0	0	3	0	0
8	4452982	.	C	G	0	2	2	0	1	3	0	0
8	4453655	.	G	T	1	2	3	0	0	3	0	0
8	4461859	.	A	G	0	2	2	0	1	3	0	0
8	4516962	.	G	A	2	4	6	1	1	8	0	0
8	4519116	.	C	T	0	4	4	0	2	6	0	0
8	4519161	.	C	T	0	7	7	0	2	9	0	0
8	4522035	.	T	A	2	2	4	0	0	4	0	0
8	4525072	.	G	A	4	2	6	0	0	6	0	0
8	4529598	.	A	G	2	3	5	0	0	5	0	0
8	4530635	.	C	A	4	3	7	0	0	7	0	0
8	4541242	.	C	G	5	3	8	0	0	8	0	0
8	4589148	.	A	G	25	23	48	0	2	50	0	0
8	4589169	.	T	G	31	21	52	0	2	54	0	0
8	4589216	.	A	T	31	11	42	0	5	47	0	0
8	4589402	.	C	T	25	25	50	0	4	54	0	0
8	4596649	.	T	A	20	21	41	0	3	44	0	0
8	4609822	.	T	C	30	1	31	1	12	44	0	0
8	4618536	.	G	A	19	8	27	1	0	28	0	0
8	4618562	.	C	T	1	6	7	1	13	21	0	0
8	4618616	.	C	T	1	2	3	0	0	3	0	0
8	4621454	.	A	G	9	6	15	0	0	15	0	0
8	4621614	.	A	T	2	2	4	0	0	4	0	0
8	4621672	.	G	T	3	2	5	0	0	5	0	0
8	4621742	.	A	G	3	4	7	0	0	7	0	0
8	4621744	.	C	T	4	3	7	0	0	7	0	0
8	4621817	.	G	T	4	7	11	0	0	11	0	0
8	4622023	.	T	A	6	2	8	0	0	8	0	0
8	4776243	.	A	T	18	15	33	0	3	36	0	0
8	4779926	.	G	A	0	2	2	0	1	3	0	0
8	4780127	.	A	T	2	6	8	0	0	8	0	0
8	4780238	.	T	A	4	13	17	0	1	18	0	0
8	4780368	.	T	A	7	3	10	0	0	10	0	0
8	4780552	.	C	T	2	7	9	0	9	18	0	0
8	4780637	.	G	T	9	17	26	0	0	26	0	0
8	4782879	.	C	T	1	6	7	0	8	15	0	0
8	4788942	.	T	C	12	0	12	0	6	18	0	0
8	4799942	.	T	C	1	2	3	9	0	12	0	0
8	4799945	.	T	C	0	2	2	9	1	12	0	0
8	4800185	.	C	T	4	3	7	4	0	11	0	0
8	4800407	.	C	T	4	2	6	1	0	7	0	0
8	4800683	.	G	A	0	3	3	0	7	10	0	0
8	4803950	.	C	T	2	4	6	0	0	6	0	0
8	4803956	.	C	T	2	5	7	0	0	7	0	0
8	4807033	.	G	C	0	3	3	0	2	5	0	0
8	4809221	.	C	T	3	2	5	0	0	5	0	0
8	4809230	.	C	T	3	1	4	0	1	5	0	0
8	4813592	.	C	T	8	6	14	0	1	15	0	0
8	4813635	.	G	A	8	6	14	0	0	14	0	0
8	4845101	.	T	C	1	4	5	0	0	5	0	0
8	4848815	.	A	G	1	2	3	0	0	3	0	0
8	4848818	.	G	T	0	2	2	0	1	3	0	0
8	4964228	.	A	G	5	5	10	0	1	11	0	0
8	4964236	.	T	C	6	9	15	0	2	17	0	0
8	5119396	.	A	G	3	7	10	0	0	10	0	0
8	5122568	.	G	A	8	4	12	0	1	13	0	0
8	5142508	.	G	C	1	3	4	0	0	4	0	0
8	5144347	.	T	G	4	4	8	0	0	8	0	0
8	6863678	.	A	G	6	1	7	0	5	12	0	0
8	6863822	.	G	A	7	6	13	0	0	13	0	0
8	6864062	.	C	G	5	6	11	0	1	12	0	0
8	6864077	.	T	C	4	8	12	0	0	12	0	0
8	6864416	.	C	A	14	8	22	0	0	22	0	0
8	6865247	.	T	A	18	23	41	0	2	43	0	0
8	6865357	.	C	T	22	22	44	0	2	46	0	0
8	6865542	.	C	T	20	16	36	0	0	36	0	0
8	6865834	.	A	G	15	18	33	0	7	40	0	0
8	6866083	.	G	A	24	16	40	0	2	42	0	0
8	6866592	.	G	T	27	20	47	0	3	50	0	0
8	6866835	.	T	G	14	9	23	0	1	24	0	0
8	6874937	.	C	T	12	11	23	0	2	25	0	0
8	6874968	.	A	G	12	14	26	0	2	28	0	0
8	6875061	.	G	T	13	13	26	0	0	26	0	0
8	6875300	.	C	T	21	14	35	0	2	37	0	0
8	6875354	.	T	C	9	11	20	0	3	23	0	0
8	6875562	.	C	T	7	4	11	0	0	11	0	0
8	6875563	.	C	T	6	5	11	0	0	11	0	0
8	6875722	.	A	G	12	11	23	0	3	26	0	0
8	6876297	.	T	C	6	6	12	0	0	12	0	0
8	6876381	.	A	G	6	10	16	0	3	19	0	0
8	6876705	.	A	C	14	4	18	0	0	18	0	0
8	6876941	.	G	T	7	9	16	0	0	16	0	0
8	6876999	.	T	C	9	9	18	0	1	19	0	0
8	6877248	.	T	C	4	0	4	0	3	7	0	0
8	6877268	.	T	C	4	2	6	0	0	6	0	0
8	6877375	.	A	G	2	3	5	0	0	5	0	0
8	6903595	.	G	C	1	0	1	0	2	3	0	0
8	6904092	.	C	T	2	3	5	0	0	5	0	0
8	6920909	.	A	G	16	5	21	0	6	27	0	0
8	6921117	.	C	G	3	23	26	0	25	51	0	0
8	6921344	.	A	C	21	17	38	0	2	40	0	0
8	6921421	.	T	A	17	18	35	0	1	36	0	0
8	6921581	.	A	C	28	21	49	0	2	51	0	0
8	6921671	.	G	A	23	13	36	0	4	41	1	0
8	6927428	.	T	C	16	21	37	0	4	41	0	0
8	6935642	.	A	T	11	8	19	0	1	20	0	0
8	6943167	.	A	T	5	6	11	0	0	11	0	0
8	6970040	.	G	A	3	6	9	0	0	9	0	0
8	7014341	.	A	G	4	6	10	0	1	11	0	0
8	7018017	.	G	A	7	6	13	0	0	13	0	0
8	7022216	.	T	A	6	9	15	0	1	16	0	0
8	7022227	.	A	G	4	10	14	0	1	15	0	0
8	7022305	.	C	T	15	11	26	0	1	27	0	0
8	7023091	.	T	G	20	0	20	0	4	24	0	0
8	7023098	.	T	C	17	4	21	0	3	24	0	0
8	7108624	.	C	T	3	2	5	0	0	5	0	0
8	7118497	.	T	C	2	4	6	1	0	7	0	0
8	7118520	.	T	G	4	0	4	0	3	7	0	0
8	7119013	.	G	A	1	4	5	0	3	8	0	0
8	7119189	.	A	G	3	3	6	0	0	6	0	0
8	7119718	.	C	G	3	0	3	0	5	8	0	0
8	7120395	.	G	A	0	2	2	0	1	3	0	0
8	7120498	.	A	G	4	3	7	0	0	7	0	0
8	7120546	.	A	G	4	3	7	0	0	7	0	0
8	7121011	.	T	A	7	10	17	0	0	17	0	0
8	7121067	.	G	A	5	3	8	0	0	8	0	0
8	7121312	.	C	T	4	4	8	0	0	8	0	0
8	7121347	.	A	T	8	2	10	0	0	10	0	0
8	7121593	.	T	A	4	3	7	0	1	8	0	0
8	7121649	.	T	C	2	7	9	0	1	10	0	0
8	7121681	.	A	G	7	7	14	0	1	15	0	0
8	7121868	.	C	T	4	4	8	0	0	8	0	0
8	7121877	.	A	G	4	3	7	0	1	8	0	0
8	7121939	.	A	C	2	2	4	0	0	4	0	0
8	7122171	.	A	T	3	8	11	0	0	11	0	0
8	7122186	.	T	C	2	6	8	0	0	8	0	0
8	7122248	.	C	A	1	4	5	0	2	7	0	0
8	7122403	.	A	G	10	0	10	0	8	18	0	0
8	7122404	.	A	G	10	5	15	0	3	18	0	0
8	7122459	.	A	G	13	4	17	0	0	17	0	0
8	7122460	.	A	T	12	4	16	0	1	17	0	0
8	7122698	.	C	T	1	2	3	0	0	3	0	0
8	7122931	.	G	A	0	11	11	0	11	22	0	0
8	7123171	.	G	C	2	9	11	0	9	20	0	0
8	7123233	.	A	T	10	15	25	0	0	25	0	0
8	7123257	.	T	C	9	14	23	0	5	28	0	0
8	7123323	.	C	A	16	10	26	0	2	28	0	0
8	7123326	.	A	G	15	10	25	0	3	28	0	0
8	7123360	.	A	T	12	6	18	0	1	19	0	0
8	7123414	.	G	A	1	5	6	0	9	15	0	0
8	7123415	.	G	C	8	5	13	0	2	15	0	0
8	7123452	.	G	A	11	9	20	0	2	22	0	0
8	7123472	.	A	G	16	11	27	0	0	27	0	0
8	7123491	.	T	C	18	12	30	0	0	30	0	0
8	7123538	.	G	A	15	8	23	0	0	23	0	0
8	7745898	.	G	A	3	4	7	0	0	7	0	0
8	7745907	.	T	C	4	7	11	0	0	11	0	0
8	7746030	.	C	T	7	6	13	0	0	13	0	0
8	7747613	.	A	G	5	0	5	0	4	9	0	0
8	7747616	.	C	T	6	4	10	0	1	11	0	0
8	7754289	.	C	T	2	3	5	0	1	6	0	0
8	7765230	.	G	A	1	7	8	0	8	16	0	0
8	7772097	.	C	T	4	4	8	0	1	9	0	0
8	7854167	.	G	C	3	2	5	0	0	5	0	0
8	7854194	.	C	G	4	2	6	0	0	6	0	0
8	7855697	.	G	T	1	2	3	0	5	8	0	0
8	7857369	.	A	G	4	0	4	0	3	7	0	0
8	7857378	.	T	C	4	3	7	0	1	8	0	0
8	7860547	.	A	C	7	3	10	0	0	10	0	0
8	7863603	.	C	T	4	6	10	0	1	11	0	0
8	7863747	.	T	C	5	6	11	0	0	11	0	0
8	7872053	.	A	T	7	4	11	0	2	13	0	0
8	7872056	.	C	T	8	4	12	0	1	13	0	0
8	7872971	.	A	G	8	0	8	0	6	14	0	0
8	7880869	.	G	A	1	2	3	0	0	3	0	0
8	7881471	.	A	G	1	0	1	0	2	3	0	0
8	7892241	.	C	T	3	2	5	0	0	5	0	0
8	7902138	.	C	T	3	5	8	0	0	8	0	0
8	7907837	.	G	C	2	5	7	0	0	7	0	0
8	7908142	.	A	T	2	3	5	0	1	6	0	0
8	7908221	.	T	C	1	8	9	0	0	9	0	0
8	7908308	.	T	C	1	3	4	0	0	4	0	0
8	7908309	.	T	C	1	3	4	0	0	4	0	0
8	7908461	.	T	G	1	0	1	0	5	6	0	0
8	7908875	.	A	G	1	2	3	0	0	3	0	0
8	7909000	.	C	T	1	2	3	0	0	3	0	0
8	7909017	.	A	G	1	0	1	0	2	3	0	0
8	7912216	.	A	C	8	13	21	0	1	22	0	0
8	7912267	.	C	G	6	0	6	0	9	15	0	0
8	7912394	.	G	A	9	5	14	1	2	17	0	0
8	8032507	.	A	G	1	2	3	0	0	3	0	0
8	8033290	.	A	G	1	3	4	0	0	4	0	0
8	8034876	.	A	G	1	0	1	0	3	4	0	0
8	8034912	.	A	G	2	0	2	0	3	5	0	0
8	8298291	.	A	G	7	6	13	0	2	15	0	0
8	8298343	.	A	C	0	0	0	0	8	8	0	0
8	8298348	.	T	A	0	0	0	0	5	5	0	0
8	8298472	.	C	T	8	12	20	0	3	23	0	0
8	8301910	.	A	G	3	4	7	0	1	8	0	0
8	8301913	.	T	A	3	5	8	0	1	9	0	0
8	8325553	.	T	A	8	8	16	0	1	17	0	0
8	8331823	.	A	T	8	6	14	0	1	15	0	0
8	8334428	.	C	T	7	12	19	0	0	19	0	0
8	8338969	.	C	T	10	12	22	0	1	23	0	0
8	8341313	.	T	C	8	8	16	0	3	19	0	0
8	8341340	.	A	C	13	10	23	0	2	25	0	0
8	8341383	.	T	C	9	9	18	0	1	19	0	0
8	8341486	.	A	C	4	5	9	0	1	10	0	0
8	8341617	.	A	C	9	6	15	0	0	15	0	0
8	8341619	.	T	C	10	0	10	0	6	16	0	0
8	8343217	.	T	G	8	11	19	0	3	22	0	0
8	8362684	.	G	A	1	6	7	0	0	7	0	0
8	8446343	.	T	A	2	2	4	0	1	5	0	0
8	8475010	.	T	C	2	2	4	0	1	5	0	0
8	8478367	.	T	G	1	3	4	0	0	4	0	0
8	8478819	.	A	G	3	1	4	0	4	8	0	0
8	8478861	.	C	T	7	4	11	0	0	11	0	0
8	8478862	.	T	C	7	4	11	0	0	11	0	0
8	8484032	.	G	A	1	3	4	0	1	5	0	0
8	8484269	.	A	G	5	4	9	0	0	9	0	0
8	8484275	.	A	G	4	6	10	0	0	10	0	0
8	8486783	.	G	A	4	2	6	0	2	8	0	0
8	8489175	.	G	A	2	4	6	0	2	8	0	0
8	8489342	.	C	G	2	2	4	0	2	6	0	0
8	8686398	.	T	C	4	0	4	0	5	9	0	0
8	8686875	.	T	C	3	2	5	0	0	5	0	0
8	8846877	.	C	T	2	3	5	0	0	5	0	0
8	8847341	.	T	A	4	2	6	0	0	6	0	0
8	8847434	.	A	C	6	3	9	0	0	9	0	0
8	8847461	.	A	G	3	0	3	0	5	8	0	0
8	8847476	.	C	T	5	4	9	0	0	9	0	0
8	8847593	.	T	C	8	7	15	0	0	15	0	0
8	8847648	.	T	A	6	5	11	0	0	11	0	0
8	8847676	.	G	C	4	6	10	0	1	11	0	0
8	8847788	.	A	C	12	8	20	0	0	20	0	0
8	8847857	.	T	C	6	5	11	0	0	11	0	0
8	8847860	.	T	C	5	5	10	0	0	10	0	0
8	8848122	.	C	A	3	3	6	0	1	7	0	0
8	8905416	.	T	C	10	6	16	0	2	18	0	0
8	8914899	.	T	C	7	14	21	0	0	21	0	0
8	8914911	.	C	T	6	14	20	0	0	20	0	0
8	8919045	.	G	A	3	10	13	0	18	31	0	0
8	8922367	.	T	A	18	14	32	0	0	32	0	0
8	8933413	.	G	A	1	1	2	0	1	3	0	0
8	8975926	.	T	C	1	5	6	0	1	7	0	0
8	8977919	.	G	A	4	3	7	0	1	8	0	0
8	9011843	.	G	A	5	7	12	0	0	12	0	0
8	9029047	.	C	A	6	2	8	0	0	8	0	0
8	9052123	.	C	T	4	6	10	0	0	10	0	0
8	9052184	.	A	T	6	9	15	0	0	15	0	0
8	9059491	.	C	T	4	2	6	0	0	6	0	0
8	9092466	.	A	G	1	3	4	0	0	4	0	0
8	9222862	.	C	T	2	5	7	0	9	16	0	0
8	9222867	.	T	A	8	7	15	0	2	17	0	0
8	9222988	.	G	C	10	10	20	0	2	22	0	0
8	9223044	.	A	G	13	5	18	0	2	20	0	0
8	9231039	.	T	C	4	0	4	0	9	13	0	0
8	9231054	.	C	T	3	6	9	0	0	9	0	0
8	9262024	.	G	A	2	4	6	0	0	6	0	0
8	9270373	.	G	A	3	3	6	0	0	6	0	0
8	9275165	.	C	T	0	2	2	0	1	3	0	0
8	9369304	.	A	G	2	3	5	0	0	5	0	0
8	9542541	.	G	A	1	2	3	0	0	3	0	0
8	9716229	.	A	G	4	5	9	0	1	10	0	0
8	9731233	.	A	G	1	1	2	0	1	3	0	0
8	9733153	.	G	A	0	5	5	0	5	10	0	0
8	9733174	.	G	A	3	4	7	0	0	7	0	0
8	9743078	.	T	C	5	7	12	0	0	12	0	0
8	9743081	.	A	T	5	5	10	0	2	12	0	0
8	9748783	.	A	G	2	7	9	0	0	9	0	0
8	9755411	.	A	G	6	1	7	1	3	11	0	0
8	9761116	.	A	C	4	6	10	0	0	10	0	0
8	9791976	.	T	C	4	5	9	0	0	9	0	0
8	9791977	.	G	A	4	5	9	0	0	9	0	0
8	9866518	.	G	C	1	2	3	0	0	3	0	0
8	9961673	.	T	C	3	5	8	0	1	9	0	0
8	9985326	.	C	T	7	7	14	0	1	15	0	0
8	9985458	.	T	C	13	8	21	0	0	21	0	0
8	10306283	.	T	C	13	14	27	0	1	28	0	0
8	10307170	.	C	T	21	15	36	0	3	39	0	0
8	10307686	.	G	T	12	17	29	1	3	33	0	0
8	10307730	.	C	G	15	0	15	0	23	38	0	0
8	10308684	.	T	G	5	0	5	0	3	8	0	0
8	10562400	.	A	C	9	4	13	0	1	15	1	0
8	10823100	.	G	C	1	3	4	0	0	4	0	0
8	10848266	.	T	G	3	0	3	0	5	8	0	0
8	10852169	.	T	A	3	4	7	0	1	8	0	0
8	10856107	.	A	G	1	4	5	0	0	5	0	0
8	10856883	.	A	C	5	2	7	0	0	7	0	0
8	10856915	.	T	C	7	3	10	0	0	10	0	0
8	10870142	.	C	T	2	2	4	0	0	4	0	0
8	10879223	.	C	A	4	3	7	0	0	7	0	0
8	10882708	.	T	C	5	2	7	0	0	7	0	0
8	10884489	.	T	C	5	6	11	0	0	11	0	0
8	10890013	.	C	T	2	4	6	0	0	6	0	0
8	10890318	.	T	C	3	6	9	0	0	9	0	0
8	10890325	.	C	G	3	0	3	0	6	9	0	0
8	10894887	.	C	T	2	11	13	0	0	13	0	0
8	10895162	.	G	A	3	3	6	0	0	6	0	0
8	10937661	.	A	G	2	4	6	0	0	6	0	0
8	10937696	.	A	T	5	2	7	0	0	7	0	0
8	10938418	.	T	C	3	1	4	0	3	7	0	0
8	10956747	.	G	A	5	8	13	0	1	14	0	0
8	10956824	.	A	G	10	9	19	0	1	20	0	0
8	10957045	.	G	T	8	14	22	1	1	24	0	0
8	10957168	.	A	C	19	0	19	0	15	34	0	0
8	10967342	.	T	C	14	0	14	0	13	27	0	0
8	10969651	.	T	A	8	7	15	0	0	15	0	0
8	10972414	.	G	A	13	11	24	0	0	24	0	0
8	10978101	.	A	G	4	7	11	0	3	14	0	0
8	10987348	.	A	G	1	5	6	0	0	6	0	0
8	10988903	.	C	T	3	2	5	0	0	5	0	0
8	10988963	.	A	G	2	3	5	0	0	5	0	0
8	10991498	.	C	T	0	2	2	0	3	5	0	0
8	11010146	.	C	T	15	10	25	0	2	27	0	0
8	11016720	.	A	C	4	5	9	0	2	11	0	0
8	11019273	.	A	T	3	2	5	0	0	5	0	0
8	11028031	.	T	C	1	3	4	1	1	6	0	0
8	11115117	.	A	T	1	2	3	0	1	4	0	0
8	11115578	.	A	T	1	1	2	0	1	3	0	0
8	11115818	.	A	T	0	4	4	0	1	5	0	0
8	11115853	.	T	C	2	2	4	0	0	4	0	0
8	11115873	.	G	A	2	2	4	0	0	4	0	0
8	11146856	.	T	C	4	2	6	0	0	6	0	0
8	11146883	.	T	G	3	4	7	0	0	7	0	0
8	11179228	.	T	A	7	5	12	0	0	12	0	0
8	11180061	.	C	T	4	8	12	0	0	12	0	0
8	11180063	.	T	G	4	8	12	0	0	12	0	0
8	11180115	.	G	C	5	8	13	0	0	13	0	0
8	11182273	.	G	A	3	10	13	0	1	14	0	0
8	11182825	.	G	A	5	2	7	0	0	7	0	0
8	11182905	.	A	C	4	4	8	0	0	8	0	0
8	11183508	.	T	A	2	4	6	0	0	6	0	0
8	11183555	.	G	T	3	2	5	0	0	5	0	0
8	11183670	.	G	T	2	2	4	0	0	4	0	0
8	11183690	.	T	C	3	2	5	0	1	6	0	0
8	11183708	.	G	A	4	3	7	0	0	7	0	0
8	11183733	.	C	T	3	3	6	0	1	7	0	0
8	11183773	.	T	G	2	3	5	0	0	5	0	0
8	11183787	.	G	A	1	5	6	0	0	6	0	0
8	11185286	.	C	T	2	4	6	0	0	6	0	0
8	11185289	.	C	G	1	4	5	0	0	5	0	0
8	11185453	.	T	A	1	2	3	0	0	3	0	0
8	14441524	.	A	G	5	9	14	0	1	15	0	0
8	14983093	.	A	G	3	6	9	0	0	9	0	0
8	17192389	.	A	G	4	2	6	0	0	6	0	0
8	17781721	.	A	G	1	3	4	0	1	5	0	0
8	18562570	.	C	T	12	10	22	0	0	22	0	0
8	18562576	.	G	A	13	10	23	0	0	23	0	0
8	21131813	.	G	T	4	2	6	0	0	6	0	0
8	21672802	.	A	G	7	0	7	0	4	12	1	0
8	21674297	.	A	G	13	7	20	0	0	20	0	0
8	22635807	.	C	T	0	4	4	0	1	5	0	0
8	23380919	.	T	C	1	4	5	0	0	5	0	0
8	23415096	.	A	C	9	3	12	0	0	12	0	0
8	23733638	.	T	A	1	1	2	0	1	3	0	0
8	23868598	.	T	C	1	8	9	0	0	9	0	0
8	25043069	.	T	C	10	5	15	0	0	15	0	0
8	25291597	.	A	G	8	3	11	0	2	13	0	0
8	25293008	.	A	G	14	18	32	0	3	35	0	0
8	25709259	.	G	A	7	2	9	0	2	11	0	0
8	25821105	.	T	A	4	8	12	0	0	12	0	0
8	25969833	.	A	G	12	0	12	0	6	18	0	0
8	25970772	.	A	G	17	6	23	0	2	25	0	0
8	26210955	.	T	C	3	0	3	0	4	7	0	0
8	27623973	.	A	G	11	2	13	0	26	39	0	0
8	28329865	.	T	G	1	8	9	0	0	9	0	0
8	29718850	.	G	A	5	2	7	0	0	7	0	0
8	29718974	.	G	T	3	7	10	0	0	10	0	0
8	29719073	.	G	T	12	11	23	0	1	24	0	0
8	29719074	.	C	T	1	12	13	0	10	23	0	0
8	29734401	.	T	C	3	2	5	0	0	5	0	0
8	29734525	.	T	A	4	6	10	0	1	11	0	0
8	29734615	.	T	A	4	2	6	0	0	6	0	0
8	29742477	.	C	T	3	3	6	0	0	6	0	0
8	29742483	.	C	T	4	2	6	0	0	6	0	0
8	29760924	.	C	A	3	2	5	0	0	5	0	0
8	29760980	.	G	A	0	3	3	0	4	7	0	0
8	29763383	.	A	G	2	0	2	0	4	6	0	0
8	29763621	.	G	T	2	8	10	0	0	10	0	0
8	29763822	.	A	G	5	0	5	0	3	8	0	0
8	29763954	.	A	G	4	4	8	0	0	8	0	0
8	29764103	.	G	A	6	6	12	0	0	12	0	0
8	29764150	.	A	T	8	4	12	0	0	12	0	0
8	29764789	.	A	G	3	2	5	0	0	5	0	0
8	29764926	.	T	C	5	5	10	0	1	11	0	0
8	29765010	.	G	C	0	3	3	1	5	9	0	0
8	29765016	.	C	T	3	5	8	1	0	9	0	0
8	29765219	.	G	C	2	2	4	0	1	5	0	0
8	29765293	.	C	T	0	2	2	0	1	3	0	0
8	29765802	.	G	T	1	2	3	0	0	3	0	0
8	29765872	.	A	C	2	3	5	0	0	5	0	0
8	29768807	.	A	C	1	1	2	0	1	3	0	0
8	29768812	.	T	A	1	2	3	0	0	3	0	0
8	29770511	.	C	T	27	30	57	0	2	59	0	0
8	29770644	.	T	A	18	33	51	0	5	56	0	0
8	29770650	.	T	A	20	32	52	0	5	57	0	0
8	29770734	.	T	A	24	33	57	0	2	59	0	0
8	29770771	.	A	C	22	28	50	0	1	51	0	0
8	29771032	.	T	A	17	27	44	0	2	46	0	0
8	29771053	.	A	G	28	18	46	0	2	48	0	0
8	29771516	.	C	A	6	5	11	0	2	13	0	0
8	29771566	.	C	T	3	2	5	0	0	5	0	0
8	29771578	.	C	G	2	2	4	0	0	4	0	0
8	29772253	.	G	A	7	9	16	0	0	16	0	0
8	29772268	.	T	C	8	7	15	0	1	16	0	0
8	29772309	.	A	G	13	12	25	1	3	29	0	0
8	29772363	.	C	A	3	7	10	0	0	10	0	0
8	29772652	.	G	A	1	2	3	0	1	4	0	0
8	29772910	.	G	T	7	6	13	0	0	13	0	0
8	29773164	.	G	A	5	10	15	0	3	18	0	0
8	29773263	.	G	A	17	10	27	0	1	28	0	0
8	29773444	.	A	G	21	13	34	0	1	35	0	0
8	29774268	.	C	T	13	10	23	0	2	25	0	0
8	29774387	.	T	A	5	4	9	0	0	9	0	0
8	29774528	.	C	T	2	9	11	0	8	19	0	0
8	29774570	.	C	T	4	8	12	0	0	12	0	0
8	29787265	.	C	T	2	4	6	0	5	11	0	0
8	29787292	.	C	T	0	5	5	0	5	10	0	0
8	29793782	.	A	G	2	6	8	0	0	8	0	0
8	29799045	.	C	T	7	5	12	0	0	12	0	0
8	29801150	.	C	G	8	6	14	0	0	14	0	0
8	29819419	.	T	C	2	0	2	0	2	4	0	0
8	29898947	.	T	C	10	3	13	0	1	14	0	0
8	29899027	.	G	A	4	5	9	0	0	9	0	0
8	29899082	.	C	T	0	9	9	0	3	12	0	0
8	29899204	.	C	T	4	2	6	0	0	6	0	0
8	29899209	.	T	C	2	4	6	0	0	6	0	0
8	29899477	.	C	G	4	16	20	0	0	20	0	0
8	29899543	.	A	G	2	7	9	0	0	9	0	0
8	29904949	.	G	A	4	6	10	0	0	10	0	0
8	29904952	.	C	A	2	5	7	0	2	9	0	0
8	29911381	.	G	T	1	5	6	0	0	6	0	0
8	29914361	.	C	T	1	2	3	0	0	3	0	0
8	29921692	.	C	T	0	4	4	0	2	6	0	0
8	29926856	.	G	A	1	2	3	0	0	3	0	0
8	29926972	.	A	T	1	5	6	0	0	6	0	0
8	29930754	.	T	A	3	2	5	0	0	5	0	0
8	30065903	.	G	A	1	2	3	0	0	3	0	0
8	30159560	.	A	C	9	0	9	0	9	18	0	0
8	30326228	.	G	A	5	2	7	0	1	8	0	0
8	30326441	.	C	T	2	5	7	0	1	8	0	0
8	30330667	.	C	T	2	4	6	0	0	6	0	0
8	30338857	.	G	A	3	4	7	0	0	7	0	0
8	30338875	.	C	G	4	4	8	0	0	8	0	0
8	30338926	.	C	T	4	3	7	0	0	7	0	0
8	30358354	.	G	A	3	3	6	0	0	6	0	0
8	30358397	.	T	G	3	4	7	0	0	7	0	0
8	30425782	.	G	T	5	5	10	0	0	10	0	0
8	30437510	.	C	T	3	5	8	0	1	9	0	0
8	30546140	.	C	T	2	2	4	0	0	4	0	0
8	30560867	.	C	T	1	4	5	0	0	5	0	0
8	30570674	.	T	C	2	5	7	0	0	7	0	0
8	30585283	.	C	T	1	4	5	0	0	5	0	0
8	30591955	.	T	C	2	4	6	0	2	8	0	0
8	30591991	.	G	T	2	6	8	0	0	8	0	0
8	30593538	.	A	G	8	0	8	0	5	13	0	0
8	30600606	.	T	A	3	4	7	0	0	7	0	0
8	30600668	.	G	C	1	2	3	0	1	4	0	0
8	30652064	.	T	G	1	0	1	0	9	10	0	0
8	30657865	.	T	C	5	11	16	0	0	16	0	0
8	30661568	.	G	A	1	9	10	0	8	18	0	0
8	30661645	.	G	A	10	6	16	0	0	16	0	0
8	30662343	.	G	C	6	6	12	0	0	12	0	0
8	30662417	.	C	T	4	4	8	0	2	10	0	0
8	30662627	.	A	T	1	7	8	1	0	9	0	0
8	30662649	.	T	C	3	6	9	3	0	12	0	0
8	30730803	.	C	A	1	5	6	0	1	7	0	0
8	30730974	.	A	G	3	9	12	0	1	13	0	0
8	30730983	.	A	C	2	6	8	0	0	8	0	0
8	30731362	.	C	T	1	6	7	0	0	7	0	0
8	30734941	.	A	G	6	8	14	0	0	14	0	0
8	30735085	.	A	G	6	7	13	0	2	15	0	0
8	30741991	.	C	G	3	2	5	0	1	6	0	0
8	30742075	.	C	T	6	5	11	0	0	11	0	0
8	30743321	.	T	C	8	7	15	0	0	15	0	0
8	30778415	.	C	A	0	2	2	4	1	7	0	0
8	30921457	.	C	G	2	3	5	0	0	5	0	0
8	30925834	.	C	T	2	3	5	0	0	5	0	0
8	30928987	.	C	T	9	12	21	0	0	21	0	0
8	30929006	.	T	A	8	12	20	0	0	20	0	0
8	30929143	.	T	A	8	4	12	0	0	12	0	0
8	30929261	.	C	T	6	6	12	0	0	12	0	0
8	30929313	.	C	T	6	7	13	0	0	13	0	0
8	30929886	.	A	G	6	14	20	0	1	21	0	0
8	30929958	.	T	A	19	20	39	0	0	39	0	0
8	30930764	.	C	A	23	22	45	0	2	47	0	0
8	30938396	.	T	C	12	6	18	0	4	22	0	0
8	30938408	.	T	A	15	10	25	0	2	27	0	0
8	30940027	.	T	A	12	8	20	0	5	25	0	0
8	30950057	.	G	A	4	5	9	0	0	9	0	0
8	30951562	.	G	A	2	2	4	0	0	4	0	0
8	30951623	.	G	A	3	3	6	0	0	6	0	0
8	30953292	.	T	C	4	0	4	0	3	7	0	0
8	31008514	.	G	C	7	2	9	0	0	9	0	0
8	31008525	.	A	T	6	2	8	0	0	8	0	0
8	31010623	.	A	C	6	6	12	0	0	12	0	0
8	31010648	.	T	C	7	9	16	0	0	16	0	0
8	31010988	.	T	A	5	13	18	0	1	19	0	0
8	31012993	.	C	T	13	13	26	0	1	27	0	0
8	31013027	.	C	T	11	10	21	0	4	25	0	0
8	31013318	.	C	T	6	3	9	0	0	9	0	0
8	31013319	.	G	A	0	3	3	0	6	9	0	0
8	31013525	.	A	T	4	2	6	0	0	6	0	0
8	31013547	.	A	G	3	4	7	0	1	8	0	0
8	31028989	.	C	T	3	2	5	0	0	5	0	0
8	31029319	.	G	A	2	3	5	0	0	5	0	0
8	31030717	.	A	C	8	6	14	0	0	14	0	0
8	31030838	.	G	C	3	9	12	1	1	14	0	0
8	31030914	.	A	T	24	18	42	0	0	42	0	0
8	31031069	.	A	T	18	4	22	0	1	23	0	0
8	31031180	.	T	G	14	9	23	0	3	26	0	0
8	31031269	.	T	G	7	7	14	0	0	14	0	0
8	31031272	.	T	C	7	7	14	0	0	14	0	0
8	31031535	.	G	A	5	7	12	0	0	12	0	0
8	31031603	.	A	T	11	10	21	0	2	23	0	0
8	31031639	.	C	T	1	14	15	0	9	24	0	0
8	31031993	.	G	A	18	16	34	0	2	36	0	0
8	31032379	.	C	T	12	19	31	0	0	31	0	0
8	31032510	.	G	A	17	16	33	0	0	33	0	0
8	31036126	.	G	A	16	14	30	0	1	31	0	0
8	31037403	.	C	T	6	5	11	0	0	11	0	0
8	31037647	.	A	G	3	2	5	0	0	5	0	0
8	31040157	.	G	A	2	3	5	0	0	5	0	0
8	31040988	.	C	A	2	5	7	0	0	7	0	0
8	31041221	.	A	G	4	3	7	0	0	7	0	0
8	31041287	.	C	T	0	4	4	0	3	7	0	0
8	31041913	.	G	A	1	2	3	0	0	3	0	0
8	31119865	.	T	C	2	2	4	0	1	5	0	0
8	31131079	.	G	A	9	5	14	0	2	16	0	0
8	31131277	.	A	G	8	14	22	0	0	22	0	0
8	31131394	.	A	C	8	7	15	0	1	16	0	0
8	31135892	.	A	G	11	18	29	0	0	29	0	0
8	31135934	.	C	T	10	13	23	0	2	25	0	0
8	31139439	.	C	T	15	13	28	0	1	29	0	0
8	31142311	.	C	T	24	21	45	0	1	46	0	0
8	31145897	.	C	T	19	36	55	0	1	56	0	0
8	31145940	.	G	C	28	28	56	0	2	58	0	0
8	31145948	.	G	A	31	27	58	0	4	62	0	0
8	31146748	.	G	A	19	29	48	0	3	51	0	0
8	31146805	.	T	C	30	25	55	0	3	58	0	0
8	31146862	.	T	A	25	26	51	0	3	54	0	0
8	31146913	.	G	A	27	28	55	0	0	55	0	0
8	31147159	.	C	T	20	45	65	0	1	66	0	0
8	31147208	.	C	A	23	43	66	0	1	67	0	0
8	31147241	.	A	T	25	35	60	0	1	61	0	0
8	31147315	.	C	T	31	15	46	0	0	46	0	0
8	31147380	.	T	G	21	26	47	0	2	49	0	0
8	31147651	.	C	T	26	25	51	0	2	53	0	0
8	31147898	.	G	A	27	23	50	0	2	52	0	0
8	31249080	.	A	C	2	2	4	0	0	4	0	0
8	31249365	.	G	A	2	7	9	0	2	11	0	0
8	31250032	.	A	G	8	0	8	0	7	15	0	0
8	31250823	.	G	A	13	14	27	0	1	28	0	0
8	31251091	.	A	G	15	12	27	0	0	27	0	0
8	31251222	.	T	C	22	12	34	0	1	35	0	0
8	31251282	.	A	C	16	16	32	0	1	33	0	0
8	31251873	.	T	C	13	12	25	0	2	27	0	0
8	31367705	.	C	A	2	2	4	0	0	4	0	0
8	31367747	.	T	C	4	4	8	0	0	8	0	0
8	31368279	.	T	G	10	14	24	0	1	25	0	0
8	31368865	.	T	A	6	11	17	0	4	21	0	0
8	31375195	.	A	G	2	10	12	0	2	14	0	0
8	31375434	.	T	A	8	10	18	0	1	19	0	0
8	31375457	.	A	G	13	9	22	0	0	22	0	0
8	31376117	.	T	G	11	8	19	0	1	20	0	0
8	31376125	.	A	T	13	9	22	0	1	23	0	0
8	31387695	.	A	G	6	7	13	0	0	13	0	0
8	31387833	.	C	T	3	5	8	0	8	16	0	0
8	31388280	.	C	T	3	6	9	0	0	9	0	0
8	31393220	.	G	A	6	4	10	0	1	11	0	0
8	31393235	.	G	A	6	4	10	0	1	11	0	0
8	31393424	.	C	T	0	2	2	0	1	3	0	0
8	31393451	.	G	T	2	4	6	0	1	7	0	0
8	31395485	.	T	C	1	4	5	0	0	5	0	0
8	31395532	.	T	G	1	3	4	0	0	4	0	0
8	31395795	.	G	A	3	3	6	0	0	6	0	0
8	31407126	.	A	T	15	7	22	0	0	22	0	0
8	31407168	.	C	A	8	12	20	0	1	21	0	0
8	31410872	.	C	T	11	9	20	0	1	21	0	0
8	31410887	.	G	A	10	9	19	0	1	20	0	0
8	31411089	.	C	T	0	8	8	0	4	12	0	0
8	31411176	.	T	G	8	7	15	0	0	15	0	0
8	31411858	.	A	G	3	5	8	0	0	8	0	0
8	31437497	.	G	C	19	35	54	0	1	55	0	0
8	31437626	.	C	T	28	18	46	0	3	49	0	0
8	31437671	.	T	C	18	33	51	0	4	55	0	0
8	31437679	.	T	G	0	2	2	0	0	2	0	0
8	31441870	.	T	C	31	25	56	0	3	59	0	0
8	31442523	.	C	G	27	12	39	0	4	43	0	0
8	31442595	.	G	A	30	19	49	0	4	53	0	0
8	31442794	.	G	T	32	19	51	0	3	54	0	0
8	31442835	.	T	A	0	51	51	0	2	53	0	0
8	31711411	.	T	C	3	0	3	0	13	16	0	0
8	31716001	.	G	T	11	10	21	0	0	21	0	0
8	31716221	.	C	G	0	2	2	0	3	5	0	0
8	31719077	.	T	C	1	6	7	0	0	7	0	0
8	31730419	.	G	T	9	9	18	0	1	19	0	0
8	31733870	.	C	T	9	11	20	0	0	20	0	0
8	31735854	.	C	A	8	7	15	0	2	17	0	0
8	31756865	.	T	C	14	12	26	0	0	26	0	0
8	31756940	.	T	C	13	11	24	0	0	24	0	0
8	31756946	.	T	C	12	10	22	0	1	23	0	0
8	31818022	.	G	A	4	17	21	0	15	36	0	0
8	31818083	.	A	T	18	20	38	0	4	42	0	0
8	31818371	.	A	G	17	12	29	0	1	30	0	0
8	31818425	.	A	C	13	11	24	0	0	24	0	0
8	31818456	.	A	G	11	11	22	0	1	23	0	0
8	31818745	.	C	T	19	9	28	0	2	30	0	0
8	31850955	.	A	T	15	8	23	0	1	24	0	0
8	31851150	.	A	C	5	6	11	0	0	11	0	0
8	31851594	.	T	C	25	16	41	0	1	42	0	0
8	31861425	.	A	G	20	13	33	0	1	34	0	0
8	31861479	.	C	T	31	9	40	0	1	41	0	0
8	31861580	.	G	C	20	13	33	0	2	35	0	0
8	31861615	.	A	C	18	13	31	0	3	34	0	0
8	31861742	.	G	A	15	23	38	0	3	42	1	0
8	31862165	.	C	T	23	13	36	0	0	36	0	0
8	31862384	.	A	G	15	20	35	0	2	37	0	0
8	31862407	.	G	A	15	19	34	0	0	34	0	0
8	31862584	.	G	T	23	5	28	0	3	31	0	0
8	31862670	.	T	A	11	11	22	0	2	24	0	0
8	31887859	.	G	T	2	3	5	0	0	5	0	0
8	31893808	.	T	C	1	2	3	0	0	3	0	0
8	31898706	.	C	T	2	3	5	0	1	6	0	0
8	31899124	.	A	T	2	4	6	0	0	6	0	0
8	31901659	.	A	G	12	16	28	0	2	30	0	0
8	31914427	.	A	T	16	16	32	0	1	33	0	0
8	31919101	.	G	C	13	10	23	0	2	25	0	0
8	31919451	.	G	T	11	5	16	0	1	17	0	0
8	31919548	.	C	T	10	6	16	0	2	18	0	0
8	31941904	.	T	A	6	5	11	0	0	11	0	0
8	31942099	.	C	T	10	7	17	0	1	18	0	0
8	31942174	.	G	A	3	9	12	0	9	21	0	0
8	31942723	.	G	A	11	11	22	0	1	23	0	0
8	32029217	.	C	T	2	4	6	0	0	6	0	0
8	32029267	.	G	A	5	7	12	0	0	12	0	0
8	32029573	.	T	C	3	0	3	0	9	12	0	0
8	32030144	.	A	G	1	3	4	0	0	4	0	0
8	32030177	.	T	C	2	4	6	0	1	7	0	0
8	32030180	.	T	C	2	0	2	0	5	7	0	0
8	32030538	.	G	A	6	6	12	0	0	12	0	0
8	32030771	.	T	G	4	3	7	0	0	7	0	0
8	32030837	.	T	A	4	5	9	0	0	9	0	0
8	32482851	.	C	T	13	14	27	0	1	28	0	0
8	32483536	.	C	T	13	11	24	0	3	27	0	0
8	32483905	.	G	C	10	14	24	0	2	26	0	0
8	32486956	.	C	T	1	12	13	0	10	23	0	0
8	32497629	.	G	T	9	10	19	0	1	20	0	0
8	32501429	.	T	G	1	4	5	0	0	5	0	0
8	32501541	.	A	G	8	5	13	0	0	13	0	0
8	32502932	.	C	T	4	5	9	0	0	9	0	0
8	32503968	.	C	T	3	3	6	0	0	6	0	0
8	32596634	.	A	T	13	5	18	0	0	18	0	0
8	32599363	.	T	C	8	9	17	0	1	18	0	0
8	32599421	.	T	C	16	9	25	0	0	25	0	0
8	32599432	.	T	G	16	10	26	0	1	27	0	0
8	32599743	.	A	G	7	3	10	0	0	10	0	0
8	32877094	.	T	G	3	2	5	0	0	5	0	0
8	32877095	.	A	G	3	2	5	0	0	5	0	0
8	32914694	.	C	T	18	12	30	0	1	31	0	0
8	32914748	.	G	T	19	13	32	0	0	32	0	0
8	32914782	.	T	A	8	12	20	0	1	21	0	0
8	32914813	.	A	T	7	8	15	0	1	16	0	0
8	32916957	.	T	A	10	9	19	0	2	21	0	0
8	32925670	.	T	G	6	6	12	0	1	13	0	0
8	32930789	.	A	G	3	4	7	0	0	7	0	0
8	32930837	.	C	T	4	4	8	0	0	8	0	0
8	32939561	.	T	C	9	5	14	0	3	17	0	0
8	32939573	.	T	C	11	0	11	0	5	16	0	0
8	33084515	.	A	G	3	8	11	0	1	12	0	0
8	33896326	.	A	T	14	20	34	1	4	39	0	0
8	33896698	.	A	G	17	19	36	0	0	36	0	0
8	33896922	.	G	A	21	23	44	0	1	45	0	0
8	33897274	.	C	T	3	22	25	0	27	52	0	0
8	33918631	.	C	T	19	17	36	1	1	38	0	0
8	33924432	.	C	T	0	16	16	0	12	28	0	0
8	34051719	.	G	A	7	11	18	0	1	19	0	0
8	34051795	.	T	C	9	12	21	0	0	21	0	0
8	34051930	.	T	G	10	6	16	0	0	16	0	0
8	34342123	.	G	C	12	0	12	0	10	22	0	0
8	34342376	.	G	A	11	13	24	0	0	24	0	0
8	34342409	.	A	G	15	7	22	0	0	22	0	0
8	34345285	.	G	A	18	9	27	0	3	30	0	0
8	34345556	.	A	G	7	11	18	0	1	19	0	0
8	34348958	.	A	C	3	2	5	0	0	5	0	0
8	34376728	.	G	A	1	2	3	0	0	3	0	0
8	35357568	.	G	A	1	3	4	0	0	4	0	0
8	35759276	.	G	A	1	8	9	0	5	14	0	0
8	35759444	.	C	T	1	3	4	0	0	4	0	0
8	35759524	.	A	G	3	4	7	0	0	7	0	0
8	35759726	.	C	T	6	2	8	0	0	8	0	0
8	35759999	.	C	T	9	7	16	0	0	16	0	0
8	35760328	.	C	T	8	3	11	0	0	11	0	0
8	35760338	.	T	C	3	6	9	0	1	10	0	0
8	35760423	.	C	T	3	2	5	0	1	6	0	0
8	36058504	.	G	T	3	4	7	0	0	7	0	0
8	36058588	.	C	A	3	2	5	0	0	5	0	0
8	36059047	.	G	A	1	2	3	0	0	3	0	0
8	36059070	.	T	C	2	2	4	0	0	4	0	0
8	36059333	.	T	C	1	2	3	0	0	3	0	0
8	36061292	.	G	T	3	2	5	0	0	5	0	0
8	36061619	.	G	A	2	2	4	0	0	4	0	0
8	36062618	.	G	C	1	3	4	0	0	4	0	0
8	36062629	.	C	T	1	3	4	0	0	4	0	0
8	36325320	.	A	G	2	1	3	0	0	3	0	0
8	36325345	.	A	G	0	2	2	0	0	2	0	0
8	36473141	.	G	T	3	3	6	0	0	6	0	0
8	36473144	.	A	G	2	4	6	0	0	6	0	0
8	36473183	.	G	A	1	5	6	0	0	6	0	0
8	36473189	.	G	A	1	4	5	0	1	6	0	0
8	36473313	.	G	A	1	4	5	0	0	5	0	0
8	36473319	.	T	C	2	4	6	0	0	6	0	0
8	36515721	.	A	G	1	1	2	0	1	3	0	0
8	36543677	.	C	A	0	2	2	0	1	3	0	0
8	36543707	.	C	T	2	1	3	0	1	4	0	0
8	36561939	.	C	T	15	4	19	0	1	20	0	0
8	36561942	.	A	T	16	3	19	0	2	21	0	0
8	36562451	.	A	G	20	0	20	0	7	27	0	0
8	36563192	.	G	A	20	11	31	0	2	33	0	0
8	36564746	.	C	T	3	4	7	0	5	12	0	0
8	36566182	.	T	C	23	13	36	0	1	37	0	0
8	36566353	.	T	C	16	9	25	0	1	26	0	0
8	36567193	.	T	A	27	15	42	0	3	45	0	0
8	36567208	.	A	T	28	13	41	0	4	45	0	0
8	36567316	.	T	C	25	20	45	0	2	47	0	0
8	36567349	.	A	C	24	13	37	0	6	43	0	0
8	36568304	.	C	T	19	16	35	0	0	35	0	0
8	36568492	.	T	C	15	12	27	0	0	27	0	0
8	36568561	.	A	G	17	10	27	0	2	29	0	0
8	36573418	.	T	C	4	2	6	0	0	6	0	0
8	36573429	.	A	C	6	2	8	0	0	8	0	0
8	36573472	.	T	C	5	2	7	0	0	7	0	0
8	36577083	.	T	C	5	2	7	0	0	7	0	0
8	36582989	.	T	C	8	10	18	0	1	19	0	0
8	36583834	.	T	C	3	6	9	0	0	9	0	0
8	36583877	.	C	A	5	8	13	0	0	13	0	0
8	36587934	.	A	G	13	14	27	0	0	27	0	0
8	36587936	.	A	G	11	1	12	0	14	26	0	0
8	36587970	.	C	A	7	17	24	0	0	24	0	0
8	36587981	.	G	T	7	17	24	0	0	24	0	0
8	36588600	.	G	T	2	16	18	0	17	35	0	0
8	36589226	.	T	C	6	11	17	0	2	19	0	0
8	36592011	.	A	G	5	2	7	0	0	7	0	0
8	36592018	.	A	G	7	4	11	0	0	11	0	0
8	36592101	.	T	C	5	0	5	0	11	16	0	0
8	36592237	.	T	C	7	6	13	0	1	14	0	0
8	36592374	.	A	G	13	18	31	1	0	32	0	0
8	36600801	.	C	G	14	9	23	0	1	24	0	0
8	36600803	.	T	G	15	8	23	0	1	24	0	0
8	36602459	.	C	T	6	12	18	0	1	19	0	0
8	36613882	.	G	T	2	4	6	0	1	7	0	0
8	36617635	.	C	G	2	7	9	0	1	10	0	0
8	36617669	.	A	G	6	6	12	0	0	12	0	0
8	36781596	.	A	G	1	0	1	0	2	3	0	0
8	36803574	.	C	A	6	8	14	0	2	16	0	0
8	36803850	.	T	C	7	5	12	0	1	13	0	0
8	36951346	.	C	T	6	8	14	0	0	14	0	0
8	36951610	.	T	C	3	5	8	0	0	8	0	0
8	36952015	.	A	G	10	2	12	0	7	19	0	0
8	36953884	.	A	G	6	7	13	0	0	13	0	0
8	36953947	.	C	T	4	5	9	0	0	9	0	0
8	36953950	.	G	C	4	5	9	0	1	10	0	0
8	36956254	.	C	T	9	7	16	0	1	17	0	0
8	36956269	.	T	C	9	7	16	0	1	17	0	0
8	36956516	.	G	A	4	5	9	0	0	9	0	0
8	36956540	.	C	A	3	6	9	0	1	10	0	0
8	36964126	.	G	A	6	12	18	0	1	19	0	0
8	36974076	.	C	A	16	18	34	0	2	36	0	0
8	36974703	.	T	G	10	0	10	0	12	22	0	0
8	36974834	.	A	C	5	0	5	0	28	33	0	0
8	36976089	.	T	C	10	15	25	0	0	25	0	0
8	36976200	.	A	G	3	1	4	0	2	6	0	0
8	36976255	.	T	A	4	3	7	0	0	7	0	0
8	36976288	.	T	A	5	5	10	0	0	10	0	0
8	36976557	.	G	A	23	15	38	0	4	42	0	0
8	36976966	.	C	T	30	20	50	0	0	50	0	0
8	36977170	.	C	T	25	20	45	0	4	49	0	0
8	37007527	.	T	C	7	8	15	0	0	15	0	0
8	37010662	.	T	C	3	8	11	0	0	11	0	0
8	37010668	.	C	T	3	4	7	0	2	9	0	0
8	37012762	.	T	A	1	4	5	0	0	5	0	0
8	37012825	.	C	T	6	4	10	0	0	10	0	0
8	37012872	.	C	G	6	6	12	0	0	12	0	0
8	37013093	.	A	G	5	10	15	0	2	17	0	0
8	37013210	.	G	A	7	7	14	0	0	14	0	0
8	37013255	.	T	C	4	5	9	0	1	10	0	0
8	37013282	.	T	C	2	2	4	0	2	6	0	0
8	37013833	.	C	T	12	8	20	0	1	21	0	0
8	37013877	.	A	T	9	7	16	0	2	18	0	0
8	37014535	.	G	C	10	7	17	0	1	18	0	0
8	37014582	.	T	C	11	5	16	0	0	16	0	0
8	37016584	.	G	T	1	15	16	0	11	27	0	0
8	37016658	.	C	A	9	12	21	0	6	27	0	0
8	37016752	.	A	G	10	14	24	0	1	25	0	0
8	37016790	.	T	C	9	16	25	0	1	26	0	0
8	37017149	.	G	A	10	15	25	0	1	26	0	0
8	37017159	.	C	T	9	13	22	0	4	26	0	0
8	37018877	.	A	G	13	9	22	0	1	23	0	0
8	37018901	.	T	C	14	11	25	0	2	27	0	0
8	37019059	.	G	A	13	17	30	0	0	30	0	0
8	37019113	.	G	A	16	16	32	0	2	34	0	0
8	37025566	.	C	T	16	18	34	0	1	35	0	0
8	37025576	.	A	T	18	16	34	0	0	34	0	0
8	37025614	.	T	A	25	13	38	0	1	39	0	0
8	37025633	.	A	G	24	0	24	0	13	37	0	0
8	37025896	.	T	C	10	10	20	0	2	22	0	0
8	37060149	.	G	T	3	4	7	0	0	7	0	0
8	37060234	.	T	A	5	9	14	0	0	14	0	0
8	37060305	.	C	T	0	6	6	0	6	12	0	0
8	37060412	.	C	T	1	3	4	0	3	7	0	0
8	37060434	.	C	A	4	3	7	0	0	7	0	0
8	37060580	.	G	A	8	15	23	0	1	24	0	0
8	37060595	.	A	T	8	15	23	0	5	28	0	0
8	37060702	.	C	T	6	9	15	0	3	18	0	0
8	37075742	.	T	A	2	2	4	0	2	6	0	0
8	37101319	.	C	T	3	2	5	0	0	5	0	0
8	37101346	.	T	C	4	2	6	0	0	6	0	0
8	37101370	.	G	C	3	1	4	0	0	4	0	0
8	37230736	.	C	T	0	1	1	0	1	2	0	0
8	37232135	.	G	C	5	2	7	0	6	13	0	0
8	37232289	.	T	A	13	17	30	0	0	30	0	0
8	37232312	.	G	C	12	17	29	0	0	29	0	0
8	37232419	.	G	A	10	15	25	0	4	29	0	0
8	37232487	.	A	C	17	30	47	0	2	49	0	0
8	37238801	.	C	G	13	12	25	0	0	25	0	0
8	37242374	.	A	T	3	6	9	0	1	10	0	0
8	37242438	.	T	C	3	2	5	0	0	5	0	0
8	37280748	.	T	C	9	5	14	0	1	15	0	0
8	37280752	.	C	T	10	5	15	0	0	15	0	0
8	37280809	.	G	T	10	7	17	0	2	19	0	0
8	37280845	.	G	A	10	4	14	0	0	14	0	0
8	37280865	.	C	T	9	6	15	0	0	15	0	0
8	37280923	.	T	A	9	8	17	0	1	18	0	0
8	37281109	.	T	C	10	7	17	0	3	20	0	0
8	37281382	.	A	T	2	3	5	1	0	6	0	0
8	37281440	.	T	A	10	9	19	0	1	20	0	0
8	37281444	.	T	A	9	10	19	0	4	23	0	0
8	37281547	.	G	A	11	9	20	0	2	22	0	0
8	37282088	.	C	T	10	10	20	0	0	20	0	0
8	37282110	.	A	T	10	6	16	0	0	16	0	0
8	37282126	.	G	T	9	9	18	0	0	18	0	0
8	37282407	.	G	A	13	7	20	0	0	20	0	0
8	37282848	.	C	T	7	16	23	0	1	24	0	0
8	37282888	.	G	A	4	15	19	0	2	21	0	0
8	37282986	.	G	A	7	4	11	0	0	11	0	0
8	37283016	.	T	A	4	9	13	0	1	14	0	0
8	37283486	.	A	G	2	3	5	0	2	7	0	0
8	37283487	.	A	C	3	4	7	0	0	7	0	0
8	37283663	.	C	T	9	6	15	0	1	16	0	0
8	37283743	.	A	G	5	3	8	0	0	8	0	0
8	37283748	.	G	T	4	1	5	0	1	6	0	0
8	37283836	.	A	G	4	3	7	0	0	7	0	0
8	37284018	.	A	T	2	2	4	0	0	4	0	0
8	37284386	.	A	G	12	16	28	0	0	28	0	0
8	37284428	.	T	G	18	12	30	0	4	34	0	0
8	37284478	.	A	G	19	10	29	0	2	31	0	0
8	37294894	.	A	T	4	6	10	0	1	11	0	0
8	37294930	.	A	G	2	4	6	0	6	12	0	0
8	37295395	.	C	T	1	11	12	0	5	17	0	0
8	37303244	.	G	A	9	4	13	0	0	13	0	0
8	37303271	.	A	C	6	1	7	0	2	9	0	0
8	37303891	.	G	A	4	3	7	0	0	7	0	0
8	37447696	.	C	T	1	3	4	0	1	5	0	0
8	37447751	.	C	T	5	6	11	0	1	12	0	0
8	37453646	.	T	A	4	5	9	0	1	10	0	0
8	37453683	.	G	A	6	5	11	0	0	11	0	0
8	37456522	.	A	T	2	5	7	0	0	7	0	0
8	37456801	.	T	A	5	7	12	0	0	12	0	0
8	37460616	.	A	T	3	8	11	0	0	11	0	0
8	37460942	.	G	A	2	2	4	0	1	5	0	0
8	37460998	.	T	C	2	2	4	0	1	5	0	0
8	37771682	.	C	G	2	2	4	0	0	4	0	0
8	37949056	.	G	T	2	2	4	0	0	4	0	0
8	38190775	.	T	C	3	5	8	0	0	8	0	0
8	38190785	.	T	C	3	4	7	0	0	7	0	0
8	38191659	.	T	G	3	2	5	0	0	5	0	0
8	38319615	.	T	C	1	2	3	0	0	3	0	0
8	38321566	.	A	T	1	2	3	0	0	3	0	0
8	38421515	.	C	A	1	6	7	0	0	7	0	0
8	38421535	.	A	C	3	7	10	0	0	10	0	0
8	38421627	.	T	A	3	4	7	0	0	7	0	0
8	38421640	.	A	T	3	5	8	0	0	8	0	0
8	38421820	.	C	T	11	14	25	0	0	25	0	0
8	38422058	.	G	A	9	5	14	0	2	16	0	0
8	38422439	.	G	A	5	5	10	0	0	10	0	0
8	38422624	.	C	T	8	2	10	0	1	11	0	0
8	38422748	.	C	G	6	4	10	0	0	10	0	0
8	38423250	.	G	A	12	6	18	0	0	18	0	0
8	38423297	.	A	G	9	6	15	0	1	16	0	0
8	38423462	.	A	G	8	11	19	0	0	19	0	0
8	38423529	.	C	G	0	11	11	0	6	17	0	0
8	38423617	.	C	T	6	13	19	0	2	21	0	0
8	38423641	.	A	G	5	10	15	0	2	17	0	0
8	38427977	.	T	C	1	5	6	0	1	7	0	0
8	38430297	.	G	A	4	3	7	0	0	7	0	0
8	38436657	.	G	A	2	2	4	0	0	4	0	0
8	38565008	.	A	G	6	4	10	0	0	10	0	0
8	38565040	.	C	T	7	4	11	0	0	11	0	0
8	38571116	.	A	T	2	3	5	0	0	5	0	0
8	38651053	.	A	C	3	7	10	0	0	10	0	0
8	39574982	.	G	A	2	2	4	0	0	4	0	0
8	39643546	.	T	G	4	0	4	0	4	8	0	0
8	39646024	.	A	T	1	6	7	0	1	8	0	0
8	39646768	.	G	A	4	11	15	1	3	19	0	0
8	39646781	.	T	C	5	10	15	1	5	21	0	0
8	39647008	.	A	C	5	4	9	0	1	10	0	0
8	39676552	.	C	T	7	4	11	0	0	11	0	0
8	39693130	.	C	T	14	5	19	1	1	21	0	0
8	39702807	.	T	C	23	10	33	0	1	34	0	0
8	39703277	.	T	C	7	7	14	0	1	15	0	0
8	39703321	.	G	A	4	1	5	0	2	7	0	0
8	39703342	.	T	C	3	3	6	0	0	6	0	0
8	39760860	.	C	T	34	37	71	0	3	74	0	0
8	39765798	.	A	G	35	31	66	0	5	71	0	0
8	39765993	.	T	A	1	3	4	0	0	4	0	0
8	39781479	.	C	G	4	2	6	0	0	6	0	0
8	39781517	.	G	C	3	2	5	0	0	5	0	0
8	39816621	.	T	G	1	3	4	0	1	5	0	0
8	39816887	.	C	G	5	3	8	0	0	8	0	0
8	39816893	.	G	A	2	4	6	0	1	7	0	0
8	39816992	.	C	T	4	6	10	0	0	10	0	0
8	39817011	.	A	G	3	6	9	0	0	9	0	0
8	39817031	.	T	G	6	3	9	0	1	10	0	0
8	39817054	.	A	T	5	5	10	0	1	11	0	0
8	39821560	.	A	G	6	3	9	0	0	9	0	0
8	39822634	.	G	A	1	2	3	0	1	4	0	0
8	39822643	.	T	C	2	0	2	0	2	4	0	0
8	39848745	.	G	C	10	4	14	0	0	14	0	0
8	39849336	.	A	G	3	4	7	0	0	7	0	0
8	39849354	.	C	T	3	3	6	0	0	6	0	0
8	39849373	.	A	T	3	7	10	0	2	12	0	0
8	39849394	.	C	G	7	8	15	0	1	16	0	0
8	39849422	.	T	G	6	7	13	0	1	14	0	0
8	39849439	.	G	T	7	3	10	0	0	10	0	0
8	39849466	.	A	C	1	5	6	0	0	6	0	0
8	39849524	.	C	T	7	8	15	0	0	15	0	0
8	39849617	.	A	G	2	6	8	0	1	9	0	0
8	39849688	.	T	C	6	6	12	0	0	12	0	0
8	39849728	.	A	T	7	8	15	0	0	15	0	0
8	39849767	.	A	T	4	8	12	0	1	13	0	0
8	39849791	.	A	G	1	7	8	0	0	8	0	0
8	39850149	.	C	T	5	3	8	0	1	9	0	0
8	39850157	.	A	G	5	4	9	0	1	10	0	0
8	39850251	.	C	T	3	7	10	0	0	10	0	0
8	39850455	.	G	A	5	3	8	0	0	8	0	0
8	39850500	.	C	G	3	3	6	0	1	7	0	0
8	39850625	.	T	A	2	3	5	0	0	5	0	0
8	39850759	.	C	T	4	2	6	0	0	6	0	0
8	39850776	.	A	T	3	2	5	0	0	5	0	0
8	39851514	.	A	G	3	4	7	0	0	7	0	0
8	39851699	.	T	G	1	3	4	0	0	4	0	0
8	39851709	.	G	T	2	4	6	0	0	6	0	0
8	39851966	.	T	G	1	4	5	0	2	7	0	0
8	39852036	.	G	T	3	3	6	0	0	6	0	0
8	39852514	.	C	T	3	2	5	0	0	5	0	0
8	39870752	.	G	T	6	3	9	0	0	9	0	0
8	39870857	.	C	T	2	3	5	0	0	5	0	0
8	39870975	.	C	T	1	2	3	0	0	3	0	0
8	39890197	.	T	C	4	3	7	0	0	7	0	0
8	39951571	.	G	A	7	3	10	0	0	10	0	0
8	39976817	.	C	T	9	12	21	0	2	23	0	0
8	39976850	.	G	C	11	0	11	0	14	25	0	0
8	39977153	.	C	G	16	10	26	0	2	28	0	0
8	39977333	.	G	A	12	9	21	0	1	22	0	0
8	39978559	.	A	G	6	9	15	0	2	17	0	0
8	40025733	.	C	T	1	3	4	0	0	4	0	0
8	40163223	.	C	T	17	12	29	0	0	29	0	0
8	40178267	.	T	C	2	2	4	0	0	4	0	0
8	40186747	.	A	G	3	6	9	0	0	9	0	0
8	40186982	.	A	T	4	6	10	0	0	10	0	0
8	40189693	.	T	C	4	0	4	0	5	9	0	0
8	40192696	.	T	A	3	2	5	0	0	5	0	0
8	40192708	.	G	A	3	2	5	0	0	5	0	0
8	40196220	.	T	C	2	5	7	0	1	8	0	0
8	40217948	.	G	A	5	5	10	0	0	10	0	0
8	40234640	.	C	T	4	7	11	0	1	12	0	0
8	40234764	.	C	T	6	6	12	0	1	13	0	0
8	40234830	.	A	G	11	5	16	0	1	17	0	0
8	40234831	.	T	A	12	5	17	0	0	17	0	0
8	40235184	.	A	T	7	8	15	0	1	16	0	0
8	40235281	.	G	A	8	4	12	0	0	12	0	0
8	40235348	.	G	C	8	5	13	0	0	13	0	0
8	40236448	.	C	A	7	4	11	0	0	11	0	0
8	40236453	.	A	T	6	4	10	0	0	10	0	0
8	40237105	.	C	G	4	2	6	0	0	6	0	0
8	40238057	.	G	A	2	4	6	0	1	7	0	0
8	40238079	.	A	G	3	2	5	0	0	5	0	0
8	40240922	.	C	G	7	9	16	0	0	16	0	0
8	40241161	.	A	G	21	19	40	0	5	45	0	0
8	40241304	.	C	T	3	22	25	0	19	44	0	0
8	40241364	.	T	G	20	22	42	0	1	43	0	0
8	40241441	.	A	G	22	17	39	9	3	51	0	0
8	40241446	.	A	G	21	19	40	9	1	50	0	0
8	40241640	.	A	T	19	10	29	4	1	34	0	0
8	40241681	.	A	G	26	10	36	0	4	40	0	0
8	40241695	.	T	A	29	6	35	0	1	36	0	0
8	40241748	.	G	A	17	12	29	4	1	34	0	0
8	40241976	.	C	A	32	20	52	0	5	57	0	0
8	40242005	.	T	G	29	23	52	0	1	53	0	0
8	40242107	.	A	T	23	11	34	0	2	36	0	0
8	40242131	.	A	C	13	14	27	0	2	29	0	0
8	40242243	.	A	C	19	17	36	0	4	40	0	0
8	40242424	.	T	A	14	10	24	0	1	25	0	0
8	40242453	.	G	A	13	16	29	0	0	29	0	0
8	40242613	.	T	A	9	7	16	0	1	17	0	0
8	40242653	.	C	T	7	5	12	0	2	14	0	0
8	40242683	.	A	C	7	12	19	0	0	19	0	0
8	40243052	.	G	C	18	16	34	0	1	35	0	0
8	40243148	.	T	C	19	10	29	0	0	29	0	0
8	40248373	.	T	G	4	19	23	0	0	23	0	0
8	40248673	.	T	C	9	11	20	0	2	22	0	0
8	40248976	.	G	T	8	14	22	0	1	23	0	0
8	40250747	.	C	A	2	12	14	0	8	22	0	0
8	40250798	.	G	A	8	13	21	0	0	21	0	0
8	40251045	.	A	T	10	6	16	0	1	17	0	0
8	40251380	.	G	T	7	11	18	0	1	19	0	0
8	40251700	.	C	G	7	6	13	0	0	13	0	0
8	40254366	.	A	G	2	8	10	0	0	10	0	0
8	40254375	.	T	G	0	8	8	0	2	10	0	0
8	40254499	.	T	C	7	0	7	0	7	14	0	0
8	40270856	.	G	A	4	4	8	0	0	8	0	0
8	40270905	.	A	G	9	3	12	0	1	13	0	0
8	40325798	.	C	T	10	6	16	0	2	18	0	0
8	40325945	.	T	G	12	7	19	0	1	20	0	0
8	40326072	.	A	T	22	12	34	0	5	39	0	0
8	40326087	.	A	T	24	12	36	0	3	39	0	0
8	40326128	.	C	T	16	18	34	0	0	34	0	0
8	40326736	.	A	G	6	3	9	0	1	10	0	0
8	40427500	.	T	C	8	6	14	0	3	17	0	0
8	40427547	.	T	C	5	6	11	0	0	11	0	0
8	40427737	.	T	A	4	2	6	0	0	6	0	0
8	40427912	.	T	C	1	2	3	0	0	3	0	0
8	40427932	.	T	C	2	3	5	0	0	5	0	0
8	40428196	.	T	C	3	2	5	0	0	5	0	0
8	40428202	.	T	C	3	2	5	0	0	5	0	0
8	40428287	.	C	A	2	2	4	0	0	4	0	0
8	40428628	.	C	T	1	2	3	0	0	3	0	0
8	40428717	.	A	T	2	2	4	0	1	5	0	0
8	40429088	.	C	A	2	2	4	0	0	4	0	0
8	40429089	.	A	C	2	2	4	0	0	4	0	0
8	40522402	.	T	G	1	2	3	0	1	4	0	0
8	40631823	.	C	T	2	7	9	0	0	9	0	0
8	40631862	.	C	T	2	3	5	0	1	6	0	0
8	40632014	.	T	C	3	10	13	0	0	13	0	0
8	40632065	.	T	C	4	8	12	0	0	12	0	0
8	40632313	.	C	G	3	2	5	0	1	6	0	0
8	40632411	.	A	T	5	6	11	0	0	11	0	0
8	40632758	.	A	C	9	7	16	0	2	18	0	0
8	40632793	.	A	T	5	7	12	0	0	12	0	0
8	40633172	.	G	C	4	5	9	0	1	10	0	0
8	40644876	.	T	G	2	7	9	0	0	9	0	0
8	40645890	.	A	G	3	3	6	0	0	6	0	0
8	40646154	.	C	T	8	5	13	0	1	14	0	0
8	41186455	.	A	C	2	3	5	0	0	5	0	0
8	41194542	.	C	G	1	2	3	0	0	3	0	0
8	41201716	.	G	A	2	5	7	0	0	7	0	0
8	41201863	.	C	T	0	2	2	0	3	5	0	0
8	41206801	.	C	G	3	5	8	0	0	8	0	0
8	41238110	.	G	A	1	1	2	0	1	3	0	0
8	41239494	.	G	A	3	7	10	0	2	12	0	0
8	41239500	.	T	C	2	8	10	0	0	10	0	0
8	41240949	.	T	C	2	5	7	0	0	7	0	0
8	41249879	.	A	G	8	9	17	0	3	20	0	0
8	41249882	.	T	C	9	10	19	0	1	20	0	0
8	41249942	.	T	C	5	8	13	0	1	14	0	0
8	41255346	.	C	T	7	8	15	0	0	15	0	0
8	41255439	.	G	A	8	19	27	0	0	27	0	0
8	41255554	.	C	T	9	14	23	0	1	24	0	0
8	41255573	.	T	C	10	10	20	0	0	20	0	0
8	41255750	.	G	A	4	5	9	0	0	9	0	0
8	41260534	.	C	T	19	15	34	0	9	43	0	0
8	41260634	.	A	G	30	23	53	0	4	57	0	0
8	41260668	.	A	G	33	25	58	0	0	58	0	0
8	41260823	.	G	C	22	16	38	0	1	39	0	0
8	41260877	.	A	G	23	22	45	0	2	47	0	0
8	41260880	.	T	C	26	2	28	0	22	50	0	0
8	41260923	.	T	A	28	22	50	0	0	50	0	0
8	41260985	.	G	A	32	19	51	0	0	51	0	0
8	41261178	.	T	C	21	18	39	0	3	42	0	0
8	41261190	.	A	G	23	19	42	0	3	45	0	0
8	41261294	.	A	G	19	20	39	0	5	44	0	0
8	41263005	.	A	G	27	26	53	0	1	54	0	0
8	41263085	.	G	A	20	29	49	0	2	51	0	0
8	41263206	.	A	G	22	16	38	0	1	39	0	0
8	41263220	.	T	C	18	19	37	0	1	38	0	0
8	41264447	.	A	T	20	18	38	0	4	42	0	0
8	41264549	.	C	G	24	24	48	0	2	50	0	0
8	41264786	.	A	C	26	24	50	0	2	52	0	0
8	41264788	.	T	A	28	23	51	0	2	53	0	0
8	41265180	.	T	C	20	17	37	0	3	41	1	0
8	41265264	.	G	A	25	17	42	0	1	43	0	0
8	41265549	.	T	C	9	23	32	0	1	33	0	0
8	41266567	.	T	C	21	13	34	0	0	34	0	0
8	41266573	.	A	T	21	13	34	0	1	35	0	0
8	41267976	.	C	T	11	18	29	0	1	30	0	0
8	41273680	.	C	T	7	6	13	0	1	14	0	0
8	41274617	.	G	A	10	4	14	0	0	14	0	0
8	41462515	.	A	G	18	6	24	0	1	25	0	0
8	41468868	.	C	T	5	6	11	0	1	12	0	0
8	41474547	.	T	C	9	4	13	0	0	13	0	0
8	41474556	.	G	A	8	5	13	0	0	13	0	0
8	41475236	.	T	C	4	6	10	0	1	11	0	0
8	41482466	.	C	T	3	3	6	0	1	7	0	0
8	41485204	.	T	A	1	2	3	0	0	3	0	0
8	41485993	.	A	G	2	4	6	0	0	6	0	0
8	41488641	.	C	G	1	3	4	0	1	6	1	0
8	41502731	.	T	C	1	0	1	0	4	5	0	0
8	41533605	.	T	C	3	4	7	0	1	8	0	0
8	42834091	.	C	G	7	3	10	0	0	10	0	0
8	42834146	.	T	C	6	3	9	0	0	9	0	0
8	44211831	.	G	A	2	2	4	0	0	4	0	0
8	44213470	.	T	G	3	4	7	0	0	7	0	0
8	44213729	.	C	T	3	3	6	0	0	6	0	0
8	44296292	.	C	T	0	6	6	0	6	12	0	0
8	44296595	.	A	C	4	0	4	0	8	12	0	0
8	44296672	.	G	A	4	10	14	0	0	14	0	0
8	44297174	.	A	C	4	4	8	0	0	8	0	0
8	44297822	.	T	C	1	3	4	0	0	4	0	0
8	44446256	.	G	A	1	3	4	0	0	4	0	0
8	44448358	.	T	G	2	2	4	0	0	4	0	0
8	44599527	.	C	T	2	2	4	0	0	4	0	0
8	44599938	.	C	T	4	4	8	0	1	9	0	0
8	44602132	.	G	A	6	5	11	0	1	12	0	0
8	44602264	.	A	G	4	4	8	0	2	10	0	0
8	44602353	.	G	C	0	1	1	0	4	5	0	0
8	44602357	.	T	C	1	5	6	0	1	7	0	0
8	44617902	.	G	A	10	3	13	0	1	14	0	0
8	44617903	.	A	T	10	4	14	0	0	14	0	0
8	44618024	.	C	T	6	2	8	0	0	8	0	0
8	44618065	.	G	A	0	5	5	0	1	6	0	0
8	44669550	.	T	C	7	5	12	0	0	12	0	0
8	44671767	.	T	C	4	3	7	0	0	7	0	0
8	44677544	.	C	T	4	4	8	0	0	8	0	0
8	44677613	.	T	C	7	6	13	0	0	13	0	0
8	44695043	.	A	C	6	6	12	0	1	13	0	0
8	44695140	.	A	C	12	7	19	0	0	19	0	0
8	44695230	.	A	T	13	14	27	0	0	27	0	0
8	44714384	.	C	T	2	2	4	0	0	4	0	0
8	44730536	.	G	A	1	3	4	0	1	5	0	0
8	44894337	.	G	T	4	3	7	0	1	8	0	0
8	44894575	.	T	A	6	9	15	0	0	15	0	0
8	44894604	.	C	T	6	14	20	0	0	20	0	0
8	44894631	.	G	C	4	11	15	0	0	15	0	0
8	44897853	.	C	A	0	12	12	0	8	20	0	0
8	44921346	.	G	A	3	2	5	0	0	5	0	0
8	44923622	.	T	G	1	2	3	0	0	3	0	0
8	44923700	.	T	C	4	0	4	0	3	7	0	0
8	44976047	.	G	T	2	6	8	0	1	9	0	0
8	44976120	.	G	A	1	3	4	0	0	4	0	0
8	44976144	.	G	A	1	3	4	0	0	4	0	0
8	45293782	.	A	G	5	0	5	0	3	8	0	0
8	45298603	.	G	A	4	6	10	0	0	10	0	0
8	45298943	.	G	C	5	5	10	0	0	10	0	0
8	45304210	.	T	C	5	4	9	0	1	10	0	0
8	45308963	.	A	C	5	9	14	0	2	16	0	0
8	45311761	.	T	G	8	15	23	0	2	25	0	0
8	45312231	.	G	C	2	5	7	0	10	17	0	0
8	45312285	.	C	A	9	7	16	0	5	21	0	0
8	45313023	.	A	C	6	12	18	0	3	21	0	0
8	45315444	.	T	C	11	13	24	0	0	24	0	0
8	45317898	.	A	T	7	10	17	0	4	21	0	0
8	45317976	.	G	A	1	16	17	0	14	31	0	0
8	45318124	.	C	T	13	14	27	0	1	28	0	0
8	45319659	.	A	G	11	0	11	0	21	32	0	0
8	45325269	.	G	C	24	19	43	0	1	44	0	0
8	45328278	.	T	A	6	12	18	0	3	21	0	0
8	45361816	.	A	G	11	6	17	0	0	17	0	0
8	45365789	.	T	C	6	11	17	0	1	18	0	0
8	45374151	.	A	T	23	15	38	0	0	38	0	0
8	45374477	.	A	G	10	6	16	0	0	16	0	0
8	45374665	.	T	A	12	19	31	0	0	31	0	0
8	45374828	.	A	C	15	8	23	0	2	25	0	0
8	45374884	.	T	G	11	15	26	0	1	27	0	0
8	45374966	.	G	T	13	5	18	0	1	19	0	0
8	45374970	.	A	G	9	4	13	0	2	15	0	0
8	45381555	.	T	C	4	4	8	0	0	8	0	0
8	45381570	.	C	T	4	4	8	0	0	8	0	0
8	45381862	.	G	A	1	3	4	0	7	11	0	0
8	45381919	.	G	A	0	2	2	0	6	8	0	0
8	45385546	.	T	A	3	2	5	0	0	5	0	0
8	45392034	.	G	A	1	4	5	0	3	8	0	0
8	45394968	.	A	T	1	3	4	0	0	4	0	0
8	45395114	.	T	A	9	4	13	0	0	13	0	0
8	45395127	.	C	T	10	4	14	0	0	14	0	0
8	45395201	.	A	T	2	1	3	0	2	5	0	0
8	45395207	.	G	A	4	0	4	0	1	5	0	0
8	45395318	.	A	G	1	2	3	0	0	4	1	0
8	45395357	.	C	T	2	5	7	0	0	7	0	0
8	45395463	.	A	C	4	8	12	0	0	12	0	0
8	45396028	.	T	C	8	1	9	0	3	12	0	0
8	45427189	.	C	A	19	17	36	0	2	38	0	0
8	45428039	.	C	T	8	12	20	0	1	21	0	0
8	45430757	.	G	A	19	16	35	0	2	37	0	0
8	45608699	.	C	T	1	2	3	0	0	3	0	0
8	45754937	.	G	T	1	2	3	0	0	3	0	0
8	45755117	.	G	A	3	4	7	0	2	9	0	0
8	45755185	.	T	C	4	7	11	0	1	12	0	0
8	45755212	.	G	T	3	5	8	0	1	9	0	0
8	45755502	.	C	T	3	2	5	0	1	6	0	0
8	45755513	.	G	A	2	4	6	0	0	6	0	0
8	45755577	.	G	A	3	7	10	0	0	10	0	0
8	45755816	.	T	C	43	23	66	0	5	71	0	0
8	45755973	.	C	G	34	32	66	0	4	70	0	0
8	45756191	.	A	G	29	36	65	0	5	70	0	0
8	45756206	.	G	A	21	38	59	0	7	66	0	0
8	45760071	.	A	C	10	1	11	0	5	16	0	0
8	45762987	.	A	G	2	2	4	0	0	4	0	0
8	45763562	.	G	A	14	18	32	0	4	36	0	0
8	45763991	.	A	G	19	20	39	0	0	39	0	0
8	45764006	.	G	C	22	19	41	0	2	43	0	0
8	45764118	.	C	T	5	20	25	0	16	41	0	0
8	45764569	.	T	C	9	4	13	0	1	14	0	0
8	45764697	.	T	C	11	5	16	0	1	17	0	0
8	45764939	.	G	A	25	15	40	0	3	43	0	0
8	45764988	.	A	T	25	17	42	0	2	44	0	0
8	45765023	.	T	A	32	17	49	4	5	58	0	0
8	45765024	.	T	A	33	16	49	4	4	57	0	0
8	45765305	.	G	A	21	19	40	0	3	43	0	0
8	45772915	.	C	A	11	19	30	0	2	32	0	0
8	45774471	.	C	T	1	12	13	0	8	21	0	0
8	45775047	.	C	T	6	3	9	0	0	9	0	0
8	45775068	.	A	T	5	4	9	0	1	10	0	0
8	45775304	.	G	A	11	5	16	0	0	16	0	0
8	45775319	.	G	T	10	5	15	0	0	15	0	0
8	45779729	.	A	C	4	5	9	0	0	9	0	0
8	45786186	.	C	T	1	3	4	0	1	5	0	0
8	45786528	.	A	G	1	3	4	0	0	4	0	0
8	45786615	.	A	G	2	3	5	0	0	5	0	0
8	45787137	.	A	G	8	3	11	0	1	12	0	0
8	45788941	.	T	G	2	5	7	0	0	7	0	0
8	45797305	.	G	A	5	2	7	0	1	8	0	0
8	45853101	.	T	C	1	3	4	0	1	5	0	0
8	45853288	.	A	C	5	4	9	0	0	9	0	0
8	45853344	.	T	A	1	6	7	0	2	9	0	0
8	45853626	.	G	A	3	3	6	0	0	6	0	0
8	45864652	.	G	C	4	9	13	0	0	13	0	0
8	45867282	.	C	T	3	9	12	0	2	14	0	0
8	45871782	.	A	G	4	5	9	0	0	9	0	0
8	45875627	.	A	G	1	3	4	0	0	4	0	0
8	45944896	.	T	A	8	2	10	0	2	12	0	0
8	45944983	.	G	A	5	7	12	0	0	12	0	0
8	45945024	.	C	T	6	2	8	0	1	9	0	0
8	45951974	.	G	A	0	6	6	0	4	10	0	0
8	45952152	.	A	T	2	3	5	0	0	5	0	0
8	45952281	.	C	T	13	12	25	0	0	25	0	0
8	45952352	.	G	C	3	9	12	0	1	13	0	0
8	45952437	.	G	A	0	6	6	0	6	12	0	0
8	45952461	.	G	A	0	3	3	0	6	9	0	0
8	45952547	.	G	T	6	2	8	0	0	8	0	0
8	45961914	.	T	A	3	3	6	0	0	6	0	0
8	45965528	.	G	T	2	4	6	0	0	6	0	0
8	45965749	.	G	A	3	5	8	0	1	9	0	0
8	45976176	.	G	A	2	2	4	0	0	4	0	0
8	45976911	.	G	A	2	2	4	0	0	4	0	0
8	46013996	.	A	G	1	3	4	0	0	4	0	0
8	46014147	.	T	C	1	2	3	0	0	3	0	0
8	46077879	.	C	A	3	7	10	0	1	11	0	0
8	46078168	.	C	A	6	4	10	0	0	10	0	0
8	46078241	.	A	T	14	7	21	0	3	24	0	0
8	46078264	.	A	T	15	7	22	0	1	23	0	0
8	46078287	.	A	G	15	6	21	0	0	21	0	0
8	46089052	.	T	C	15	21	36	0	2	38	0	0
8	46094790	.	G	A	9	11	20	0	0	20	0	0
8	46123717	.	G	A	7	5	12	0	0	12	0	0
8	46123731	.	G	A	4	7	11	0	0	11	0	0
8	46125509	.	G	A	2	3	5	0	1	6	0	0
8	46132662	.	G	C	1	0	1	0	3	4	0	0
8	46160929	.	A	G	3	4	7	0	1	8	0	0
8	46258216	.	A	G	1	2	3	0	1	4	0	0
8	46310717	.	G	A	1	2	3	0	0	3	0	0
8	46340777	.	A	G	3	0	3	0	2	5	0	0
8	46346713	.	C	T	3	3	6	0	0	6	0	0
8	46346837	.	T	C	2	3	5	0	0	5	0	0
8	46347099	.	A	T	4	3	7	0	0	7	0	0
8	46347147	.	C	T	2	3	5	0	0	5	0	0
8	46348145	.	G	T	6	8	14	0	0	14	0	0
8	46356282	.	G	A	4	8	12	0	1	13	0	0
8	46359860	.	C	T	2	9	11	0	10	21	0	0
8	46362082	.	G	A	2	2	4	0	1	5	0	0
8	46362083	.	G	T	2	3	5	0	0	5	0	0
8	46367300	.	C	T	5	4	9	0	1	10	0	0
8	46367312	.	G	A	5	4	9	0	0	9	0	0
8	46382884	.	C	T	0	2	2	0	3	5	0	0
8	46385621	.	C	A	0	2	2	0	3	5	0	0
8	46406145	.	C	A	1	4	5	0	0	5	0	0
8	46431134	.	A	G	3	5	8	0	0	8	0	0
8	46431240	.	A	C	4	2	6	0	0	6	0	0
8	46431247	.	A	T	4	3	7	0	0	7	0	0
8	46431453	.	A	T	6	3	9	0	1	10	0	0
8	46431620	.	C	T	2	4	6	0	0	6	0	0
8	46431631	.	G	C	2	3	5	0	0	5	0	0
8	46431680	.	G	C	1	6	7	0	0	7	0	0
8	46431684	.	C	T	1	6	7	0	0	7	0	0
8	46433538	.	T	C	3	2	5	0	0	5	0	0
8	46433554	.	G	C	3	2	5	0	0	5	0	0
8	46499645	.	T	C	2	3	5	0	0	5	0	0
8	46853005	.	A	T	3	15	18	0	1	19	0	0
8	46853015	.	A	T	5	12	17	0	3	20	0	0
8	46855313	.	G	A	6	5	11	0	0	11	0	0
8	46881326	.	G	T	6	4	10	0	0	10	0	0
8	47145008	.	A	G	38	48	86	0	5	91	0	0
8	47147333	.	A	T	35	31	66	1	5	72	0	0
8	47149394	.	A	G	39	28	67	0	1	68	0	0
8	47159100	.	G	T	2	2	4	0	0	4	0	0
8	47163244	.	G	A	7	2	9	0	0	9	0	0
8	47178393	.	T	A	2	3	5	0	2	7	0	0
8	47834998	.	G	A	6	3	9	0	1	10	0	0
8	47835146	.	T	C	8	2	10	0	1	11	0	0
8	47835148	.	C	T	8	3	11	0	0	11	0	0
8	47844022	.	A	G	1	2	3	0	0	3	0	0
8	47917304	.	C	T	4	3	7	0	0	7	0	0
8	47928187	.	T	A	1	6	7	0	0	7	0	0
8	47932409	.	C	T	6	3	9	0	1	10	0	0
8	47932442	.	G	A	4	4	8	0	1	9	0	0
8	47937152	.	T	C	11	4	15	0	0	15	0	0
8	47937156	.	A	G	10	0	10	0	5	15	0	0
8	47937263	.	T	C	12	8	20	0	2	22	0	0
8	47946517	.	T	C	12	17	29	0	0	29	0	0
8	47946674	.	G	A	6	9	15	0	0	15	0	0
8	47946753	.	C	T	14	5	19	0	1	20	0	0
8	47946776	.	T	C	18	6	24	0	0	24	0	0
8	47946833	.	A	G	14	12	26	0	1	27	0	0
8	47946846	.	A	G	13	16	29	0	2	31	0	0
8	47947052	.	A	C	11	7	18	0	2	20	0	0
8	47947297	.	C	T	8	10	18	0	1	19	0	0
8	47947341	.	C	A	14	7	21	0	1	23	1	0
8	47947649	.	T	A	13	18	31	1	2	34	0	0
8	47947772	.	A	G	15	0	15	0	14	29	0	0
8	47947996	.	T	G	14	6	20	1	1	22	0	0
8	47948102	.	T	A	18	12	30	0	1	31	0	0
8	47948602	.	G	A	5	13	18	0	21	39	0	0
8	47948755	.	C	T	11	18	29	0	1	30	0	0
8	47948820	.	A	C	3	10	13	0	3	16	0	0
8	47948866	.	C	A	2	7	9	0	0	9	0	0
8	48093139	.	T	C	7	4	11	0	0	11	0	0
8	48603552	.	T	C	5	4	9	0	1	10	0	0
8	48603788	.	G	C	0	8	8	0	8	16	0	0
8	48603978	.	T	A	6	9	15	0	0	15	0	0
8	48604114	.	T	A	5	7	12	0	0	12	0	0
8	48629640	.	T	A	3	4	7	0	0	7	0	0
8	48629668	.	G	A	9	3	12	0	0	12	0	0
8	48629797	.	C	A	7	5	12	0	0	12	0	0
8	48629946	.	A	T	14	4	18	0	0	18	0	0
8	48629969	.	T	C	11	0	11	0	6	17	0	0
8	48630017	.	A	G	6	9	15	0	0	15	0	0
8	48642433	.	G	A	1	3	4	0	0	4	0	0
8	48642496	.	A	G	3	3	6	0	1	7	0	0
8	48801678	.	C	T	3	3	6	0	0	6	0	0
8	48809531	.	C	G	4	2	6	0	0	6	0	0
8	48809570	.	G	A	3	2	5	0	0	5	0	0
8	48809678	.	A	C	2	5	7	0	0	7	0	0
8	48958189	.	T	C	6	0	6	0	2	8	0	0
8	48958468	.	C	T	7	4	11	0	0	11	0	0
8	48958637	.	A	G	9	11	20	0	1	21	0	0
8	48958822	.	C	T	18	7	25	0	3	28	0	0
8	48959047	.	G	A	3	9	12	0	2	14	0	0
8	49038025	.	C	T	1	2	3	0	1	4	0	0
8	49038026	.	A	G	2	2	4	0	0	4	0	0
8	49071247	.	T	A	2	2	4	0	0	4	0	0
8	49075512	.	G	A	6	2	8	0	0	8	0	0
8	49078792	.	G	A	0	5	5	0	7	12	0	0
8	49078817	.	C	T	6	6	12	0	1	13	0	0
8	49078827	.	A	C	4	6	10	0	2	13	1	0
8	49082598	.	C	A	7	6	13	0	0	13	0	0
8	49086105	.	G	T	4	8	12	0	0	12	0	0
8	49092108	.	C	T	9	3	12	0	1	13	0	0
8	49092129	.	C	T	11	5	16	0	0	16	0	0
8	49096541	.	G	T	5	3	8	1	0	9	0	0
8	49108347	.	A	T	17	13	30	0	2	32	0	0
8	49170190	.	T	A	6	5	11	0	1	12	0	0
8	49170366	.	T	A	33	36	69	0	7	76	0	0
8	49172338	.	A	G	33	29	62	0	4	66	0	0
8	49310830	.	C	T	8	7	15	0	0	15	0	0
8	49310928	.	T	C	2	5	7	0	0	7	0	0
8	49311090	.	C	T	6	9	15	0	1	16	0	0
8	49311355	.	T	C	12	18	30	1	0	31	0	0
8	49311396	.	C	A	15	16	31	1	0	32	0	0
8	49311398	.	G	C	15	15	30	1	1	32	0	0
8	49345116	.	C	T	8	3	11	0	0	11	0	0
8	49345191	.	T	C	5	10	15	0	0	15	0	0
8	49345272	.	A	G	4	3	7	0	0	7	0	0
8	49404152	.	G	T	18	22	40	2	3	47	2	0
8	49404262	.	C	T	23	32	55	2	5	62	0	0
8	49404502	.	C	T	38	28	66	3	3	72	0	0
8	49404928	.	C	T	35	34	69	0	7	76	0	0
8	49413417	.	G	T	46	18	64	0	5	69	0	0
8	49413444	.	G	A	27	36	63	0	2	65	0	0
8	49413459	.	G	A	32	30	62	0	2	64	0	0
8	49415718	.	G	C	17	25	42	0	2	44	0	0
8	49435964	.	C	G	9	3	12	0	0	12	0	0
8	49443191	.	A	G	13	1	14	0	14	28	0	0
8	49447330	.	A	G	2	0	2	0	2	4	0	0
8	49447428	.	A	G	6	4	10	0	0	10	0	0
8	49447458	.	A	T	7	5	12	0	3	15	0	0
8	49447519	.	G	A	6	6	12	0	0	12	0	0
8	49447657	.	C	A	7	5	12	0	1	13	0	0
8	49706428	.	T	C	2	2	4	0	0	4	0	0
8	49710686	.	G	A	14	7	21	0	0	21	0	0
8	49722313	.	T	C	7	5	12	0	2	14	0	0
8	49728659	.	T	A	5	8	13	0	2	15	0	0
8	49732151	.	T	C	1	0	1	0	3	4	0	0
8	49745727	.	T	G	4	2	6	0	0	6	0	0
8	49746224	.	T	C	5	18	23	1	0	24	0	0
8	49746256	.	G	A	5	15	20	0	0	20	0	0
8	49746440	.	T	C	19	24	43	0	7	50	0	0
8	49746456	.	T	G	20	28	48	1	2	51	0	0
8	49755801	.	A	C	19	14	33	0	3	36	0	0
8	49755867	.	A	T	14	18	32	0	1	33	0	0
8	49756121	.	A	T	7	11	18	0	3	21	0	0
8	49759453	.	A	G	12	11	23	0	1	24	0	0
8	49769496	.	G	A	8	4	12	0	0	12	0	0
8	49845392	.	A	G	3	2	5	0	1	6	0	0
8	49850230	.	C	T	1	4	5	0	0	5	0	0
8	49851155	.	C	G	1	4	5	0	0	5	0	0
8	49851230	.	T	A	2	4	6	0	0	6	0	0
8	49860718	.	C	T	1	3	4	0	0	4	0	0
8	49864212	.	C	T	3	5	8	0	0	8	0	0
8	49864892	.	G	T	4	9	13	0	0	13	0	0
8	49885882	.	A	G	1	5	6	0	0	6	0	0
8	49899474	.	G	A	2	5	7	0	1	8	0	0
8	49901127	.	T	C	1	0	1	0	3	4	0	0
8	49908789	.	G	T	1	3	4	0	0	4	0	0
8	49911143	.	G	A	4	1	5	0	1	6	0	0
8	49941098	.	A	T	1	2	3	0	0	3	0	0
8	49949798	.	C	T	3	4	7	0	0	7	0	0
8	49952260	.	C	T	4	3	7	0	1	8	0	0
8	49969037	.	C	T	3	6	9	0	0	9	0	0
8	49969135	.	G	C	2	2	4	1	4	9	0	0
8	50156805	.	G	A	4	3	7	0	0	7	0	0
8	50159515	.	A	G	4	4	8	0	0	8	0	0
8	50163398	.	A	G	3	0	3	0	3	6	0	0
8	50170889	.	T	C	3	6	9	0	0	9	0	0
8	50493190	.	T	C	2	2	4	0	0	4	0	0
8	50501513	.	C	G	1	0	1	0	2	3	0	0
8	50812321	.	G	A	4	2	6	0	0	6	0	0
8	50818102	.	G	T	7	6	13	0	0	13	0	0
8	50818180	.	C	T	4	7	11	0	1	12	0	0
8	50838854	.	G	A	2	5	7	0	0	7	0	0
8	50845104	.	T	C	4	4	8	0	2	10	0	0
8	50851915	.	A	T	1	2	3	0	0	3	0	0
8	50889992	.	C	T	2	3	5	0	0	5	0	0
8	50890003	.	T	A	3	2	5	0	0	5	0	0
8	50890053	.	G	A	3	2	5	0	0	5	0	0
8	50890057	.	A	T	2	2	4	0	0	4	0	0
8	50890422	.	A	T	7	8	15	0	0	15	0	0
8	50898126	.	C	T	1	7	8	0	10	18	0	0
8	50942296	.	T	G	5	2	7	0	1	8	0	0
8	50947386	.	G	C	19	22	41	0	4	45	0	0
8	50947648	.	T	A	10	20	30	0	2	32	0	0
8	50948620	.	A	G	7	0	7	0	19	26	0	0
8	50948623	.	T	C	9	21	30	0	0	30	0	0
8	50949040	.	T	A	15	20	35	2	0	37	0	0
8	50949086	.	T	A	6	15	21	4	0	25	0	0
8	50949128	.	T	C	22	12	34	2	1	37	0	0
8	50949160	.	A	T	16	21	37	0	0	37	0	0
8	50949188	.	C	T	13	24	37	0	0	37	0	0
8	50949430	.	T	A	32	15	47	0	1	48	0	0
8	50949479	.	A	G	12	31	43	0	5	48	0	0
8	50949501	.	A	T	33	21	54	0	1	55	0	0
8	50949570	.	G	A	30	29	59	1	1	61	0	0
8	50949573	.	G	A	30	27	57	1	1	59	0	0
8	50949639	.	C	T	20	26	46	7	4	57	0	0
8	50949766	.	C	T	8	8	16	0	1	17	0	0
8	50949903	.	A	G	26	0	26	0	26	52	0	0
8	50960443	.	C	A	12	9	21	0	1	22	0	0
8	50960542	.	T	C	16	10	26	0	1	27	0	0
8	50962536	.	T	C	15	20	35	0	2	37	0	0
8	50962623	.	T	G	15	0	15	0	17	32	0	0
8	50967774	.	C	G	5	6	11	0	1	12	0	0
8	50967890	.	C	T	6	8	14	0	0	14	0	0
8	50969141	.	T	C	3	2	5	0	2	7	0	0
8	50969150	.	A	G	3	3	6	0	0	6	0	0
8	50969367	.	G	A	7	3	10	0	0	10	0	0
8	50969493	.	T	A	5	3	8	0	0	8	0	0
8	50971524	.	G	A	7	4	11	0	0	11	0	0
8	50972267	.	C	T	4	6	10	0	2	12	0	0
8	50981034	.	A	G	1	2	3	0	0	3	0	0
8	51008419	.	T	C	1	4	5	0	0	5	0	0
8	51008524	.	T	G	1	3	4	0	0	4	0	0
8	51026996	.	A	G	2	4	6	0	0	6	0	0
8	51027069	.	C	T	2	2	4	0	0	4	0	0
8	51027123	.	C	A	3	3	6	1	0	7	0	0
8	51027845	.	G	C	2	3	5	0	0	5	0	0
8	51165572	.	T	C	7	7	14	0	1	15	0	0
8	51165786	.	C	A	1	15	16	0	7	23	0	0
8	51173843	.	A	G	7	5	12	0	0	12	0	0
8	51189364	.	C	T	0	2	2	0	4	6	0	0
8	51189373	.	G	C	4	2	6	0	0	6	0	0
8	51247891	.	G	C	1	3	4	0	0	4	0	0
8	51309145	.	T	G	14	14	28	0	3	31	0	0
8	51309311	.	A	G	8	21	29	0	1	30	0	0
8	51314087	.	G	A	19	13	32	0	0	32	0	0
8	51320547	.	C	T	9	11	20	0	3	23	0	0
8	51320652	.	C	T	10	9	19	0	1	20	0	0
8	51325510	.	T	G	7	8	15	0	1	16	0	0
8	51330776	.	T	C	4	3	7	0	1	8	0	0
8	51351121	.	C	T	15	9	24	0	2	27	1	0
8	51351155	.	T	A	10	3	13	0	3	16	0	0
8	51351200	.	A	T	14	9	23	0	1	24	0	0
8	51352480	.	A	G	12	17	29	0	1	30	0	0
8	51352525	.	A	T	14	17	31	1	0	32	0	0
8	51364515	.	T	C	6	7	13	0	0	13	0	0
8	51364644	.	C	A	1	6	7	0	15	22	0	0
8	51364665	.	T	C	14	7	21	0	0	21	0	0
8	51364696	.	C	G	12	5	17	0	0	17	0	0
8	51364713	.	C	A	1	4	5	0	9	14	0	0
8	51367178	.	A	T	11	5	16	0	0	16	0	0
8	51367206	.	C	T	10	3	13	0	1	14	0	0
8	51367217	.	C	T	9	6	15	0	1	16	0	0
8	51367267	.	A	T	7	8	15	0	0	15	0	0
8	51375405	.	T	G	8	13	21	0	0	21	0	0
8	51379609	.	G	A	2	3	5	0	0	5	0	0
8	51431321	.	T	A	17	7	24	0	0	24	0	0
8	51431396	.	C	T	1	4	5	0	4	9	0	0
8	51431477	.	G	A	3	10	13	0	0	13	0	0
8	51431526	.	A	T	5	7	12	0	1	13	0	0
8	51431561	.	A	G	3	8	11	0	0	11	0	0
8	51431573	.	A	T	2	7	9	0	1	10	0	0
8	51431604	.	A	C	2	5	7	0	0	8	1	0
8	51431628	.	C	T	5	2	7	0	1	8	0	0
8	51431805	.	T	A	5	8	13	2	2	18	1	0
8	51433088	.	C	T	5	2	7	0	1	8	0	0
8	51433141	.	G	T	1	2	3	0	2	5	0	0
8	51433175	.	T	C	4	3	7	0	0	7	0	0
8	51433238	.	A	G	1	2	3	0	0	3	0	0
8	51433569	.	G	A	2	2	4	0	1	5	0	0
8	51434020	.	T	A	1	2	3	0	0	3	0	0
8	51434081	.	A	G	1	6	7	1	0	8	0	0
8	51434224	.	G	C	1	4	5	0	0	5	0	0
8	51434289	.	C	T	1	2	3	0	1	4	0	0
8	51434330	.	C	A	1	3	4	0	1	5	0	0
8	51434538	.	C	A	1	2	3	0	0	3	0	0
8	51573385	.	C	T	1	1	2	0	1	3	0	0
8	51576925	.	C	T	0	2	2	0	2	4	0	0
8	51579224	.	C	G	1	2	3	0	2	5	0	0
8	51579225	.	G	A	3	2	5	0	0	5	0	0
8	51635631	.	C	T	1	2	3	0	0	3	0	0
8	51723164	.	C	T	3	3	6	0	0	6	0	0
8	51723206	.	G	A	0	1	1	0	2	3	0	0
8	51723220	.	G	C	1	2	3	0	0	3	0	0
8	51723285	.	G	A	0	7	7	5	3	15	0	0
8	51723320	.	A	G	2	4	6	3	2	11	0	0
8	51723713	.	C	A	5	3	8	0	0	8	0	0
8	51723957	.	T	C	4	2	6	0	0	6	0	0
8	51724067	.	C	T	6	2	8	0	0	8	0	0
8	51724928	.	G	T	1	3	4	0	0	4	0	0
8	51724974	.	G	A	4	4	8	0	0	8	0	0
8	51725058	.	G	T	1	3	4	0	0	4	0	0
8	51725237	.	C	G	5	5	10	1	0	11	0	0
8	51725241	.	G	T	6	5	11	1	0	12	0	0
8	51726166	.	C	T	3	6	9	0	0	9	0	0
8	51726299	.	T	A	4	3	7	0	1	8	0	0
8	52109292	.	T	C	1	2	3	0	1	4	0	0
8	52314637	.	G	T	0	2	2	0	2	4	0	0
8	52324918	.	A	G	1	2	3	0	0	3	0	0
8	52325649	.	A	G	2	1	3	0	1	4	0	0
8	52336870	.	T	C	2	2	4	0	0	4	0	0
8	52342586	.	A	C	3	3	6	0	1	7	0	0
8	52345733	.	T	C	2	2	4	0	0	4	0	0
8	52345751	.	T	C	4	4	8	0	2	10	0	0
8	52345915	.	T	C	9	7	16	0	0	16	0	0
8	52346035	.	T	C	4	3	7	0	0	7	0	0
8	52347460	.	C	T	5	3	8	0	2	10	0	0
8	52348242	.	A	G	7	4	11	0	0	11	0	0
8	52348584	.	A	G	5	4	9	0	0	9	0	0
8	52348685	.	T	C	9	3	12	0	0	12	0	0
8	52349080	.	T	G	7	5	12	0	0	12	0	0
8	52350101	.	A	G	12	0	12	0	9	22	1	0
8	52350146	.	A	G	13	0	13	0	17	30	0	0
8	52350251	.	A	G	10	19	29	0	0	29	0	0
8	52350322	.	T	G	4	7	11	0	0	11	0	0
8	52408619	.	G	A	28	19	47	0	2	49	0	0
8	52411451	.	T	C	17	15	32	0	1	33	0	0
8	52412982	.	A	G	18	14	32	1	1	34	0	0
8	52412985	.	C	G	16	14	30	1	1	32	0	0
8	52453432	.	A	C	2	3	5	0	0	5	0	0
8	52453862	.	T	A	3	3	6	0	0	6	0	0
8	52491586	.	G	A	3	3	6	0	0	6	0	0
8	52509624	.	G	A	1	3	4	0	0	4	0	0
8	52509859	.	C	T	2	3	5	0	0	5	0	0
8	52521648	.	T	C	5	4	9	0	1	10	0	0
8	52521802	.	A	T	4	5	9	0	0	9	0	0
8	52521832	.	T	G	5	0	5	0	5	10	0	0
8	52524436	.	A	T	8	7	15	0	0	15	0	0
8	52527359	.	C	G	3	4	7	0	1	8	0	0
8	52527391	.	A	T	3	4	7	0	0	7	0	0
8	52527547	.	A	C	2	6	8	0	1	9	0	0
8	52528717	.	A	G	9	14	23	0	1	24	0	0
8	52528856	.	C	G	8	3	11	0	0	11	0	0
8	52529169	.	A	G	9	6	15	0	1	16	0	0
8	52529206	.	T	C	11	10	21	0	1	22	0	0
8	52529397	.	A	G	9	12	21	0	0	21	0	0
8	52533968	.	C	G	1	2	3	0	0	3	0	0
8	52537984	.	A	G	5	0	5	0	5	10	0	0
8	52538042	.	A	T	3	6	9	0	1	10	0	0
8	52543717	.	C	A	4	7	11	0	0	12	1	0
8	52547038	.	T	G	7	8	15	1	0	16	0	0
8	52547091	.	T	C	10	9	19	0	1	20	0	0
8	52547356	.	A	G	7	8	15	0	0	15	0	0
8	52547522	.	C	T	2	2	4	0	0	4	0	0
8	52547523	.	G	A	0	2	2	0	2	4	0	0
8	52547569	.	T	A	2	4	6	0	0	6	0	0
8	52547664	.	A	C	2	5	7	0	0	7	0	0
8	52547677	.	C	T	3	4	7	0	0	7	0	0
8	52547706	.	A	T	3	4	7	0	0	7	0	0
8	52547727	.	G	C	3	3	6	0	0	6	0	0
8	52547787	.	T	A	3	4	7	0	1	8	0	0
8	52547829	.	T	G	4	3	7	0	0	7	0	0
8	52547902	.	T	A	4	2	6	0	0	6	0	0
8	52547924	.	A	T	2	2	4	0	2	6	0	0
8	52550373	.	T	C	4	0	4	0	4	8	0	0
8	52550462	.	A	G	4	3	7	0	0	7	0	0
8	52550502	.	T	A	7	5	12	0	0	12	0	0
8	52553193	.	A	T	9	5	14	0	5	19	0	0
8	52553197	.	A	G	10	8	18	0	1	19	0	0
8	52554679	.	T	C	8	1	9	0	12	22	1	0
8	52554937	.	T	G	5	9	14	0	0	14	0	0
8	52554983	.	C	T	3	10	13	0	2	15	0	0
8	52555018	.	T	G	3	12	15	0	4	19	0	0
8	52555050	.	G	A	5	15	20	0	0	20	0	0
8	52555077	.	C	G	9	10	19	0	1	21	1	0
8	52555112	.	G	T	13	5	18	0	2	20	0	0
8	52555137	.	G	A	12	5	17	0	0	17	0	0
8	52562746	.	C	T	3	2	5	0	0	5	0	0
8	52564816	.	T	C	4	6	10	0	0	10	0	0
8	52564922	.	C	T	3	9	12	0	0	12	0	0
8	52565319	.	T	C	4	2	6	0	0	6	0	0
8	52571198	.	T	C	2	6	8	0	0	8	0	0
8	52580169	.	A	G	2	3	5	0	0	5	0	0
8	52580196	.	A	T	2	2	4	0	0	4	0	0
8	52630431	.	C	A	1	2	3	0	0	3	0	0
8	52630433	.	T	A	1	2	3	0	0	3	0	0
8	53082186	.	G	C	3	3	6	0	0	7	1	0
8	53089843	.	G	A	0	3	3	0	3	6	0	0
8	53095146	.	G	A	10	10	20	0	1	21	0	0
8	53095179	.	A	G	11	11	22	0	0	22	0	0
8	53148951	.	T	C	9	3	12	0	1	13	0	0
8	53148976	.	T	C	8	3	11	0	0	11	0	0
8	53152039	.	C	G	2	2	4	0	0	4	0	0
8	53260532	.	A	G	1	2	3	0	1	4	0	0
8	53398564	.	A	G	4	6	10	0	0	10	0	0
8	53399188	.	A	G	10	6	16	0	0	16	0	0
8	53399192	.	A	G	2	14	16	0	0	16	0	0
8	53752762	.	C	T	0	4	4	0	2	6	0	0
8	53765095	.	C	T	0	2	2	0	1	3	0	0
8	53772380	.	C	A	0	3	3	0	1	4	0	0
8	53794943	.	T	G	1	3	4	0	0	4	0	0
8	53795006	.	C	T	2	5	7	0	0	7	0	0
8	53795684	.	T	C	2	0	2	0	2	4	0	0
8	53795692	.	G	A	2	2	4	0	0	4	0	0
8	53795892	.	G	T	1	3	4	0	1	5	0	0
8	53798130	.	A	G	1	3	4	0	1	5	0	0
8	53918281	.	T	G	2	3	5	0	0	5	0	0
8	53918323	.	A	T	8	6	14	0	0	14	0	0
8	53918472	.	T	C	8	12	20	0	0	20	0	0
8	53918600	.	T	A	7	4	11	2	3	16	0	0
8	53918664	.	C	T	10	10	20	0	1	21	0	0
8	53918730	.	T	C	7	9	16	0	1	17	0	0
8	53918790	.	G	T	10	13	23	0	0	23	0	0
8	53918899	.	C	T	3	2	5	0	0	5	0	0
8	53919124	.	C	A	5	6	11	0	1	12	0	0
8	53921722	.	A	G	4	8	12	0	2	14	0	0
8	53921779	.	G	A	4	9	13	0	0	13	0	0
8	53921797	.	A	G	5	9	14	0	1	15	0	0
8	53921815	.	A	G	8	8	16	0	1	17	0	0
8	53922034	.	A	G	7	4	11	0	0	11	0	0
8	53940977	.	T	C	4	6	10	0	1	11	0	0
8	53942440	.	T	C	4	5	9	0	0	9	0	0
8	53948434	.	G	A	12	4	16	0	2	18	0	0
8	53948501	.	T	C	15	7	22	0	0	22	0	0
8	53949706	.	G	A	10	16	26	0	1	27	0	0
8	53950181	.	T	C	8	0	8	0	16	24	0	0
8	53953420	.	C	G	8	14	22	0	0	22	0	0
8	53954966	.	T	G	5	4	9	0	0	9	0	0
8	53956476	.	T	G	8	10	18	0	1	20	1	0
8	53956530	.	T	G	9	8	17	0	0	17	0	0
8	53959378	.	T	C	7	4	11	0	4	15	0	0
8	54013594	.	G	T	1	7	8	0	0	8	0	0
8	54128964	.	A	G	12	0	12	0	6	18	0	0
8	54129735	.	G	A	1	9	10	0	16	26	0	0
8	54129767	.	G	A	13	9	22	0	0	22	0	0
8	54129774	.	T	C	13	10	23	0	0	23	0	0
8	54129867	.	A	C	8	8	16	0	2	18	0	0
8	54130103	.	T	G	9	3	12	0	0	12	0	0
8	54130249	.	T	C	8	4	12	1	1	14	0	0
8	54130253	.	G	A	7	4	11	1	1	13	0	0
8	54130346	.	A	G	2	1	3	0	4	8	1	0
8	54131889	.	T	G	7	3	10	0	0	10	0	0
8	54132024	.	C	G	4	7	11	0	2	13	0	0
8	54132044	.	C	T	7	9	16	0	1	17	0	0
8	54132084	.	C	G	9	11	20	0	0	20	0	0
8	54132248	.	T	A	6	4	10	0	0	10	0	0
8	54133376	.	A	G	18	18	36	0	0	36	0	0
8	54133403	.	A	T	21	13	34	0	0	34	0	0
8	54133450	.	G	A	18	9	27	0	2	29	0	0
8	54133522	.	G	A	9	16	25	0	2	27	0	0
8	54137658	.	T	C	3	4	7	0	0	7	0	0
8	54145198	.	A	G	4	3	7	0	0	7	0	0
8	54151403	.	C	T	3	6	9	0	0	9	0	0
8	54155012	.	C	A	9	11	20	0	3	23	0	0
8	54202655	.	C	T	7	7	14	0	0	14	0	0
8	54203198	.	A	G	5	5	10	0	0	10	0	0
8	54208231	.	A	G	11	6	17	0	1	18	0	0
8	54208282	.	C	T	11	7	18	0	1	19	0	0
8	54208572	.	C	T	18	16	34	0	1	35	0	0
8	54210066	.	G	A	14	11	25	0	0	25	0	0
8	54210081	.	C	T	15	13	28	0	1	29	0	0
8	54211989	.	G	A	2	2	4	0	0	4	0	0
8	54211991	.	G	A	2	2	4	0	0	4	0	0
8	54213461	.	A	G	6	7	13	0	2	15	0	0
8	54213462	.	C	T	6	8	14	0	1	15	0	0
8	54220876	.	T	A	18	17	35	0	1	36	0	0
8	54221243	.	T	C	21	1	22	0	25	47	0	0
8	54221390	.	T	C	23	12	35	0	10	45	0	0
8	54221573	.	T	C	19	2	21	0	19	40	0	0
8	54221812	.	G	C	21	25	46	0	1	47	0	0
8	54221927	.	C	T	19	26	45	0	6	51	0	0
8	54221966	.	G	A	14	27	41	0	2	43	0	0
9	11776	.	G	A	1	3	4	0	0	4	0	0
9	24528	.	C	T	14	18	32	0	2	34	0	0
9	37058	.	G	A	12	9	21	0	2	23	0	0
9	37199	.	G	A	17	11	28	0	0	28	0	0
9	37830	.	C	T	0	8	8	0	11	19	0	0
9	54479	.	C	T	11	10	21	0	3	24	0	0
9	62205	.	C	G	22	0	22	2	2	29	3	0
9	62336	.	T	C	19	15	34	0	4	38	0	0
9	62351	.	A	G	22	11	33	0	5	38	0	0
9	62528	.	T	G	11	20	31	0	3	34	0	0
9	63313	.	G	A	15	14	29	0	0	29	0	0
9	63418	.	G	A	13	10	23	0	1	24	0	0
9	63532	.	G	A	11	8	19	0	0	19	0	0
9	63604	.	G	A	7	2	9	0	1	10	0	0
9	64739	.	C	A	0	9	9	0	6	15	0	0
9	80243	.	G	A	0	1	1	0	0	1	0	0
9	80263	.	T	C	1	2	3	0	0	3	0	0
9	84247	.	A	G	2	0	2	0	2	4	0	0
9	84293	.	A	G	2	2	4	0	0	4	0	0
9	84487	.	A	G	1	2	3	0	0	3	0	0
9	84515	.	G	A	0	2	2	0	2	4	0	0
9	85318	.	T	C	2	2	4	0	0	4	0	0
9	85846	.	A	G	3	2	5	0	0	5	0	0
9	86089	.	A	G	5	2	7	0	2	9	0	0
9	86107	.	C	G	6	4	10	0	0	10	0	0
9	86439	.	T	C	6	3	9	0	0	9	0	0
9	86462	.	G	T	9	4	13	0	0	13	0	0
9	86719	.	T	C	6	3	9	0	1	10	0	0
9	86767	.	T	C	6	5	11	0	0	11	0	0
9	86830	.	T	C	8	4	12	2	0	14	0	0
9	89407	.	C	T	8	6	14	0	3	17	0	0
9	90189	.	A	G	8	6	14	0	2	16	0	0
9	90507	.	G	C	0	7	7	0	8	15	0	0
9	94276	.	T	C	17	18	35	0	0	35	0	0
9	94480	.	A	T	8	4	12	0	0	12	0	0
9	94482	.	A	C	8	4	12	0	0	12	0	0
9	97312	.	G	A	3	3	6	0	0	6	0	0
9	98451	.	G	A	1	3	4	0	0	4	0	0
9	103432	.	T	C	14	11	25	0	0	25	0	0
9	104840	.	G	A	9	6	15	0	1	16	0	0
9	104862	.	T	G	7	4	11	0	0	11	0	0
9	105091	.	C	T	2	10	12	0	7	19	0	0
9	134614	.	C	T	1	4	5	0	3	8	0	0
9	134835	.	C	T	0	5	5	0	1	6	0	0
9	134945	.	C	T	1	7	8	0	4	12	0	0
9	134949	.	C	T	1	7	8	0	4	12	0	0
9	134999	.	C	T	0	4	4	0	2	6	0	0
9	135149	.	C	T	0	3	3	0	3	6	0	0
9	135151	.	G	T	2	4	6	0	0	6	0	0
9	145209	.	A	G	1	4	5	0	0	5	0	0
9	145214	.	C	T	1	4	5	0	0	5	0	0
9	147357	.	A	G	4	8	12	0	0	12	0	0
9	148333	.	G	A	1	12	13	1	7	21	0	0
9	148339	.	A	G	6	12	18	1	0	19	0	0
9	149078	.	G	A	1	20	21	0	11	32	0	0
9	149215	.	C	A	16	7	23	0	4	27	0	0
9	149251	.	A	T	13	16	29	0	2	31	0	0
9	153001	.	C	T	9	10	19	0	0	19	0	0
9	168848	.	T	C	9	5	14	0	3	17	0	0
9	168974	.	T	C	3	7	10	0	0	10	0	0
9	169015	.	T	C	3	3	6	0	3	9	0	0
9	169020	.	T	C	3	0	3	0	7	10	0	0
9	169187	.	T	C	11	4	15	0	0	15	0	0
9	169806	.	G	C	24	0	24	0	11	35	0	0
9	170845	.	G	T	9	12	21	0	1	22	0	0
9	170945	.	G	A	4	14	18	0	2	20	0	0
9	172661	.	C	T	19	13	32	0	0	32	0	0
9	180245	.	G	A	17	5	22	0	0	22	0	0
9	209444	.	T	A	2	3	5	0	0	5	0	0
9	225257	.	C	T	1	3	4	0	0	4	0	0
9	225362	.	T	C	3	2	5	0	0	5	0	0
9	225371	.	T	C	0	2	2	0	1	3	0	0
9	226168	.	C	T	3	4	7	0	0	7	0	0
9	227072	.	C	T	4	4	8	0	0	8	0	0
9	233295	.	A	G	5	0	5	0	5	10	0	0
9	233922	.	C	T	6	6	12	0	0	12	0	0
9	234328	.	G	A	8	4	12	0	0	12	0	0
9	235262	.	G	T	0	7	7	0	6	13	0	0
9	235365	.	T	A	9	6	15	0	1	16	0	0
9	235567	.	C	G	8	4	12	0	1	13	0	0
9	253264	.	T	C	23	1	24	0	17	41	0	0
9	254484	.	A	G	32	24	56	0	11	67	0	0
9	257890	.	A	T	26	17	43	2	8	53	0	0
9	257926	.	G	C	22	1	23	3	24	50	0	0
9	262487	.	A	G	23	27	50	0	3	53	0	0
9	262511	.	C	T	2	21	23	0	30	53	0	0
9	266053	.	T	C	17	20	37	0	0	37	0	0
9	266227	.	T	C	31	23	54	0	1	55	0	0
9	266255	.	C	T	31	30	61	0	2	63	0	0
9	266445	.	G	C	32	20	52	0	3	55	0	0
9	266572	.	T	C	27	1	28	0	29	57	0	0
9	266721	.	A	G	25	11	36	0	1	37	0	0
9	266802	.	A	C	27	18	45	0	0	45	0	0
9	266910	.	G	A	21	26	47	0	5	52	0	0
9	267081	.	A	G	30	28	58	0	1	59	0	0
9	267290	.	G	A	36	32	68	0	0	68	0	0
9	275474	.	G	A	16	22	38	0	4	42	0	0
9	276059	.	A	G	21	16	37	0	1	38	0	0
9	278150	.	A	G	12	20	32	0	0	32	0	0
9	278174	.	G	A	18	21	39	0	1	40	0	0
9	282686	.	C	T	19	9	28	0	0	28	0	0
9	282737	.	T	C	15	0	15	0	13	28	0	0
9	296052	.	G	A	16	9	25	0	1	26	0	0
9	296177	.	T	A	15	12	27	0	0	27	0	0
9	296181	.	T	C	13	1	14	0	9	23	0	0
9	298930	.	A	G	3	2	5	0	0	5	0	0
9	298970	.	A	G	3	2	5	0	1	6	0	0
9	299247	.	C	T	4	5	9	0	1	10	0	0
9	302720	.	T	C	5	11	16	0	0	16	0	0
9	303032	.	C	G	6	6	12	0	0	12	0	0
9	303061	.	T	C	7	0	7	0	4	11	0	0
9	303070	.	T	C	5	5	10	0	1	11	0	0
9	303288	.	C	T	1	2	3	0	6	9	0	0
9	323588	.	A	G	7	10	17	0	0	17	0	0
9	323762	.	T	C	4	2	6	0	1	7	0	0
9	323861	.	C	T	5	8	13	0	1	14	0	0
9	323893	.	C	T	6	6	12	0	0	12	0	0
9	323904	.	G	T	5	3	8	0	0	8	0	0
9	332710	.	T	C	2	2	4	0	0	4	0	0
9	332777	.	A	T	1	4	5	0	0	5	0	0
9	332779	.	A	T	1	4	5	0	0	5	0	0
9	336102	.	C	G	5	3	8	0	0	8	0	0
9	336852	.	A	T	3	4	7	0	0	7	0	0
9	336863	.	A	G	3	1	4	0	3	7	0	0
9	339332	.	T	C	7	6	13	0	0	13	0	0
9	340075	.	T	C	9	5	14	0	1	15	0	0
9	340076	.	A	T	9	5	14	0	2	16	0	0
9	340170	.	T	C	5	5	10	0	0	10	0	0
9	353690	.	A	G	1	3	4	1	0	5	0	0
9	355324	.	A	G	3	9	12	0	1	13	0	0
9	355348	.	G	A	4	6	10	0	0	10	0	0
9	355411	.	A	C	4	7	11	0	0	11	0	0
9	358679	.	C	G	1	5	6	0	8	14	0	0
9	360894	.	A	G	2	2	4	0	0	4	0	0
9	428788	.	T	C	1	4	5	0	0	5	0	0
9	429277	.	A	T	4	6	10	0	0	10	0	0
9	430071	.	T	C	10	7	17	0	0	17	0	0
9	430125	.	G	T	0	9	9	0	6	15	0	0
9	431089	.	C	T	4	3	7	0	0	7	0	0
9	431137	.	C	T	3	6	9	0	0	9	0	0
9	433764	.	C	T	4	2	6	1	1	8	0	0
9	448665	.	A	G	4	2	6	0	0	6	0	0
9	448668	.	C	G	4	2	6	0	0	6	0	0
9	458995	.	T	A	7	11	18	0	1	19	0	0
9	459042	.	A	T	10	11	21	0	0	21	0	0
9	459754	.	C	T	8	9	17	0	3	20	0	0
9	459755	.	T	C	7	0	7	0	12	19	0	0
9	462959	.	T	G	8	3	11	0	5	16	0	0
9	463005	.	A	C	6	4	10	0	1	11	0	0
9	463010	.	T	C	6	0	6	0	7	13	0	0
9	525826	.	C	T	3	2	5	0	0	5	0	0
9	527969	.	G	A	0	3	3	0	5	8	0	0
9	528192	.	T	C	1	3	4	0	0	4	0	0
9	528441	.	T	G	2	4	6	0	0	6	0	0
9	528905	.	T	C	1	3	4	1	0	5	0	0
9	529012	.	G	T	3	4	7	0	0	7	0	0
9	529036	.	G	A	1	3	4	0	2	6	0	0
9	529059	.	A	G	2	0	2	0	3	5	0	0
9	529121	.	A	C	4	1	5	0	2	7	0	0
9	529147	.	C	T	3	4	7	0	0	7	0	0
9	529156	.	G	A	4	2	6	0	0	6	0	0
9	529824	.	C	A	2	1	3	0	0	3	0	0
9	529849	.	G	A	0	4	4	0	3	7	0	0
9	529957	.	C	T	1	3	4	0	0	4	0	0
9	588454	.	A	G	5	10	15	0	0	15	0	0
9	588456	.	C	T	5	10	15	0	0	15	0	0
9	595354	.	G	A	6	3	9	0	0	9	0	0
9	597342	.	C	T	3	7	10	0	1	11	0	0
9	598720	.	A	G	4	3	7	0	1	8	0	0
9	598795	.	A	G	6	6	12	0	0	12	0	0
9	598819	.	G	A	6	5	11	0	0	11	0	0
9	600609	.	G	A	1	4	5	0	0	5	0	0
9	627648	.	C	A	0	4	4	0	2	6	0	0
9	701575	.	A	T	2	4	6	0	0	6	0	0
9	707424	.	A	G	2	3	5	0	1	6	0	0
9	707558	.	T	C	1	2	3	0	0	3	0	0
9	707996	.	C	T	7	23	30	0	26	56	0	0
9	708075	.	T	C	27	1	28	0	26	54	0	0
9	712883	.	C	T	7	3	10	2	0	12	0	0
9	712898	.	T	C	9	5	14	1	0	15	0	0
9	716225	.	A	G	10	8	18	0	1	19	0	0
9	719729	.	G	A	8	6	14	0	2	16	0	0
9	719825	.	A	G	4	6	10	0	2	12	0	0
9	721472	.	C	T	0	8	8	0	7	15	0	0
9	721822	.	T	A	2	6	8	0	0	8	0	0
9	721829	.	A	G	2	6	8	0	0	8	0	0
9	722965	.	A	G	5	4	9	0	1	10	0	0
9	723004	.	G	A	4	6	10	0	2	12	0	0
9	724532	.	G	A	2	3	5	0	0	5	0	0
9	724592	.	G	A	4	7	11	0	0	11	0	0
9	724616	.	G	A	7	3	10	1	1	12	0	0
9	724664	.	G	C	5	5	10	1	1	12	0	0
9	726870	.	A	G	5	5	10	0	1	11	0	0
9	729672	.	A	G	1	2	3	0	0	3	0	0
9	746040	.	A	G	2	2	4	0	0	4	0	0
9	784508	.	G	A	3	4	7	0	0	7	0	0
9	848614	.	A	G	1	4	5	0	0	5	0	0
9	849013	.	T	C	1	0	1	0	2	3	0	0
9	881678	.	A	T	4	3	7	0	2	9	0	0
9	881773	.	T	A	3	2	5	0	0	5	0	0
9	881999	.	C	T	13	8	21	0	2	23	0	0
9	882143	.	T	C	13	0	13	0	9	22	0	0
9	884904	.	C	T	7	7	14	0	0	14	0	0
9	887854	.	A	G	4	2	6	0	3	9	0	0
9	889433	.	G	A	2	2	4	0	0	4	0	0
9	901137	.	A	G	12	4	16	0	0	16	0	0
9	902265	.	T	C	10	0	10	0	6	16	0	0
9	902877	.	A	G	8	9	17	0	0	17	0	0
9	904118	.	A	T	6	7	13	0	1	14	0	0
9	907564	.	A	G	18	23	41	0	3	44	0	0
9	910882	.	C	T	26	24	50	0	3	53	0	0
9	913874	.	T	C	34	21	55	0	2	57	0	0
9	913882	.	C	T	33	25	58	0	1	59	0	0
9	913909	.	G	A	6	18	24	0	32	56	0	0
9	914097	.	G	T	10	4	14	0	0	14	0	0
9	914190	.	C	T	5	4	9	0	0	9	0	0
9	914506	.	C	A	11	3	14	0	0	14	0	0
9	921549	.	C	T	4	2	6	0	1	7	0	0
9	922788	.	T	A	6	3	9	0	0	9	0	0
9	922819	.	T	G	2	3	5	0	0	5	0	0
9	963731	.	C	T	2	3	5	0	1	6	0	0
9	1133096	.	C	T	2	2	4	0	0	4	0	0
9	1133159	.	C	T	2	5	7	1	0	8	0	0
9	1188029	.	T	C	1	2	3	0	0	3	0	0
9	1235841	.	A	G	1	3	4	0	0	4	0	0
9	1366691	.	A	T	2	2	4	0	1	5	0	0
9	1371190	.	C	G	3	2	5	0	0	5	0	0
9	1371362	.	C	T	5	2	7	0	2	9	0	0
9	1371363	.	A	G	6	2	8	0	1	9	0	0
9	1373000	.	A	G	2	6	8	0	0	8	0	0
9	1373075	.	T	G	6	9	15	0	0	15	0	0
9	1373144	.	C	A	3	10	13	0	0	13	0	0
9	1376201	.	A	G	1	0	1	0	5	6	0	0
9	1463287	.	T	C	2	3	5	0	0	5	0	0
9	1469002	.	T	C	2	3	5	0	1	6	0	0
9	1479215	.	G	A	3	2	5	0	0	5	0	0
9	1479254	.	C	T	0	2	2	0	2	4	0	0
9	1479290	.	G	T	3	3	6	0	0	6	0	0
9	1574234	.	A	G	1	4	5	0	1	6	0	0
9	1576444	.	A	G	3	2	5	0	0	5	0	0
9	1577542	.	C	A	9	11	20	1	0	21	0	0
9	1579792	.	T	C	7	10	17	0	1	18	0	0
9	1644349	.	T	C	4	2	6	0	0	6	0	0
9	1680126	.	A	C	0	2	2	0	1	3	0	0
9	1680375	.	C	T	2	4	6	0	0	6	0	0
9	1682489	.	G	A	5	2	7	2	1	10	0	0
9	1682619	.	T	C	3	2	5	4	0	9	0	0
9	1682647	.	A	T	3	4	7	1	0	8	0	0
9	1682740	.	G	C	1	13	14	0	11	25	0	0
9	1693082	.	A	C	15	6	21	0	1	22	0	0
9	1693092	.	G	A	15	8	23	0	0	23	0	0
9	1693443	.	G	A	12	8	20	0	0	20	0	0
9	1693494	.	T	G	13	12	25	0	0	25	0	0
9	1693574	.	G	A	13	2	15	0	0	15	0	0
9	1693577	.	A	T	12	2	14	0	0	14	0	0
9	1694277	.	A	G	9	5	14	0	2	16	0	0
9	1937049	.	T	A	1	3	4	0	0	4	0	0
9	2005336	.	A	G	3	0	3	0	4	7	0	0
9	2005428	.	A	C	1	2	3	0	1	4	0	0
9	2005462	.	G	T	2	2	4	0	0	4	0	0
9	2045125	.	T	G	3	4	7	0	0	7	0	0
9	2045265	.	G	A	8	5	13	0	0	13	0	0
9	2334164	.	C	T	16	17	33	2	0	35	0	0
9	2336682	.	A	G	18	0	18	0	23	41	0	0
9	2337291	.	C	T	19	23	42	0	4	46	0	0
9	2340561	.	G	A	25	15	40	1	8	49	0	0
9	2340564	.	G	A	29	15	44	1	2	47	0	0
9	2340618	.	C	T	24	31	55	0	1	56	0	0
9	2340776	.	C	T	40	29	69	0	9	78	0	0
9	2340964	.	G	A	29	15	44	0	2	46	0	0
9	2341035	.	T	C	15	20	35	0	0	35	0	0
9	2341053	.	T	C	10	16	26	0	1	27	0	0
9	2423047	.	C	T	6	3	9	0	0	9	0	0
9	2423119	.	C	T	8	2	10	0	0	10	0	0
9	2452697	.	T	C	11	17	28	0	0	28	0	0
9	2483623	.	A	G	1	15	16	1	1	18	0	0
9	2511344	.	C	A	1	2	3	0	1	4	0	0
9	2529551	.	G	C	1	2	3	0	0	3	0	0
9	2555975	.	T	G	1	2	3	0	0	3	0	0
9	2556339	.	T	C	2	2	4	0	0	4	0	0
9	2556683	.	C	T	2	2	4	0	0	4	0	0
9	2557722	.	A	G	1	1	2	0	1	3	0	0
9	2558649	.	G	A	2	4	6	0	0	6	0	0
9	2559047	.	G	A	1	3	4	0	0	4	0	0
9	2559080	.	A	T	3	2	5	0	0	5	0	0
9	2559138	.	C	T	4	4	8	0	0	8	0	0
9	2559177	.	C	T	7	3	10	0	1	11	0	0
9	2559204	.	C	T	5	13	18	0	0	18	0	0
9	2559566	.	C	A	4	1	5	0	0	5	0	0
9	2559587	.	G	C	0	0	0	0	5	5	0	0
9	2559640	.	A	T	1	2	3	0	0	3	0	0
9	2559792	.	G	A	1	4	5	0	0	5	0	0
9	2559856	.	A	C	1	7	8	0	2	10	0	0
9	2559912	.	A	C	3	8	11	0	0	11	0	0
9	2560765	.	C	T	2	5	7	0	0	7	0	0
9	2561135	.	C	T	2	4	6	0	0	6	0	0
9	2561182	.	A	G	3	7	10	0	0	10	0	0
9	2561205	.	G	T	5	7	12	0	0	12	0	0
9	2561225	.	T	A	7	7	14	0	0	14	0	0
9	2561254	.	C	T	0	12	12	0	4	16	0	0
9	2561322	.	T	A	1	4	5	0	1	6	0	0
9	2561604	.	C	T	12	17	29	0	0	29	0	0
9	2561632	.	A	T	15	19	34	0	1	35	0	0
9	2564111	.	G	A	25	16	41	0	1	42	0	0
9	2564656	.	G	T	20	13	33	0	1	34	0	0
9	2564788	.	A	T	13	8	21	0	0	21	0	0
9	2564790	.	A	T	13	8	21	0	1	22	0	0
9	2568777	.	C	T	11	13	24	0	1	25	0	0
9	2569372	.	T	G	8	6	14	0	1	15	0	0
9	2572235	.	A	T	9	6	15	0	3	18	0	0
9	2572756	.	A	T	9	6	15	0	0	15	0	0
9	2572809	.	C	T	0	5	5	0	2	7	0	0
9	2576099	.	T	C	4	4	8	0	0	8	0	0
9	2586206	.	A	G	9	0	9	0	9	18	0	0
9	2586259	.	A	G	12	5	17	0	1	18	0	0
9	2592246	.	C	T	15	14	29	0	0	29	0	0
9	2592518	.	A	T	5	7	12	0	2	14	0	0
9	2592519	.	T	A	8	5	13	0	1	14	0	0
9	2592675	.	G	A	12	9	21	0	1	22	0	0
9	2592960	.	A	G	8	6	14	0	1	15	0	0
9	2592984	.	C	A	1	7	8	0	8	16	0	0
9	2593059	.	C	T	1	4	5	0	8	13	0	0
9	2949273	.	G	A	5	2	7	0	0	7	0	0
9	2949291	.	C	A	0	2	2	0	3	6	1	0
9	2949374	.	T	A	4	6	10	0	0	10	0	0
9	2953640	.	G	A	1	5	6	0	0	6	0	0
9	2954118	.	G	A	0	3	3	0	1	4	0	0
9	4721500	.	G	T	8	7	15	0	0	15	0	0
9	5041842	.	A	T	7	4	11	0	1	12	0	0
9	5042724	.	G	T	1	2	3	0	1	4	0	0
9	5042772	.	C	T	4	4	8	0	0	8	0	0
9	5042784	.	A	G	4	4	8	0	1	9	0	0
9	5044371	.	A	T	3	3	6	0	0	6	0	0
9	5904817	.	G	A	2	3	5	0	0	5	0	0
9	5911943	.	G	A	1	2	3	0	0	3	0	0
9	6009282	.	C	T	4	2	6	0	0	6	0	0
9	6083012	.	G	A	0	5	5	0	8	13	0	0
9	6083113	.	C	T	5	10	15	0	0	15	0	0
9	6083169	.	C	T	6	3	9	0	0	9	0	0
9	6083401	.	G	A	7	10	17	0	2	19	0	0
9	6109544	.	A	G	8	7	15	0	0	15	0	0
9	6118842	.	G	A	1	2	3	0	0	3	0	0
9	6123441	.	G	A	15	7	22	1	1	24	0	0
9	6123490	.	G	T	9	10	19	0	0	19	0	0
9	6123742	.	A	C	10	14	24	0	0	24	0	0
9	6123857	.	C	T	4	3	7	0	1	8	0	0
9	6124057	.	G	A	0	4	4	0	12	16	0	0
9	6124100	.	T	C	9	7	16	0	2	18	0	0
9	6124201	.	G	A	0	6	6	0	6	12	0	0
9	6124393	.	C	T	9	8	17	0	0	17	0	0
9	6124478	.	G	A	16	8	24	0	2	26	0	0
9	6124759	.	T	A	13	13	26	0	1	27	0	0
9	6124761	.	T	G	14	13	27	0	1	28	0	0
9	6124884	.	T	C	8	10	18	0	0	18	0	0
9	6125346	.	T	A	5	6	11	0	0	11	0	0
9	6125427	.	G	C	3	6	9	0	0	9	0	0
9	6125501	.	A	C	4	5	9	0	1	10	0	0
9	6125588	.	A	C	6	7	13	0	0	13	0	0
9	6125707	.	T	C	2	4	6	1	1	8	0	0
9	6125732	.	C	T	6	2	8	0	1	9	0	0
9	6125761	.	G	T	10	4	14	0	0	14	0	0
9	6125859	.	T	A	4	11	15	2	1	18	0	0
9	6126074	.	T	A	13	17	30	0	2	32	0	0
9	6126288	.	A	C	23	14	37	0	2	39	0	0
9	6126410	.	G	A	20	15	35	2	8	45	0	0
9	6126469	.	G	A	20	17	37	0	2	39	0	0
9	6126781	.	T	G	9	21	30	0	3	33	0	0
9	6126900	.	C	T	9	12	21	0	1	22	0	0
9	6126911	.	C	A	12	9	21	0	1	22	0	0
9	6127075	.	G	A	2	31	33	0	23	56	0	0
9	6127346	.	C	A	24	7	31	0	1	32	0	0
9	6127357	.	C	T	19	16	35	0	0	35	0	0
9	6615871	.	G	A	5	2	7	0	0	7	0	0
9	6660314	.	G	A	10	8	18	0	1	19	0	0
9	6660611	.	G	A	6	5	11	0	1	12	0	0
9	6660953	.	C	T	0	4	4	0	6	10	0	0
9	6661361	.	A	T	1	2	3	1	3	7	0	0
9	7031683	.	C	T	1	2	3	0	1	4	0	0
9	7039659	.	C	T	2	4	6	0	0	6	0	0
9	7042639	.	C	T	5	3	8	0	2	10	0	0
9	7042659	.	G	A	3	4	7	0	1	8	0	0
9	7042674	.	A	G	4	0	4	0	5	9	0	0
9	7046383	.	A	G	5	3	8	0	0	8	0	0
9	7049484	.	C	G	2	6	8	0	0	8	0	0
9	7056563	.	T	C	9	4	13	0	0	13	0	0
9	7056713	.	A	C	9	10	19	0	1	20	0	0
9	7056968	.	C	T	4	9	13	0	3	16	0	0
9	7094898	.	T	C	16	9	25	0	0	25	0	0
9	7213050	.	A	G	5	4	9	0	0	9	0	0
9	7213607	.	T	C	1	2	3	0	1	4	0	0
9	7228272	.	C	A	18	13	31	0	2	33	0	0
9	7228487	.	C	A	15	8	23	0	1	24	0	0
9	7228741	.	C	T	2	10	12	0	11	23	0	0
9	7228745	.	C	T	0	17	17	0	8	25	0	0
9	7229288	.	G	T	12	13	25	0	2	27	0	0
9	7229343	.	T	G	13	12	25	0	3	28	0	0
9	7229347	.	G	A	13	14	27	0	2	29	0	0
9	7229512	.	C	T	18	6	24	0	2	26	0	0
9	7234590	.	G	A	8	8	16	0	2	18	0	0
9	7234618	.	A	C	11	0	11	0	9	20	0	0
9	7234642	.	G	A	9	12	21	0	1	22	0	0
9	7234681	.	A	C	11	9	20	0	0	20	0	0
9	7238498	.	C	T	11	9	20	0	0	20	0	0
9	7238502	.	C	A	12	9	21	0	0	21	0	0
9	7241409	.	G	T	8	6	14	0	1	15	0	0
9	7241494	.	T	C	1	3	4	0	0	4	0	0
9	7241855	.	C	T	4	2	6	0	1	7	0	0
9	7241922	.	T	C	1	3	4	0	0	4	0	0
9	7242056	.	C	T	1	2	3	0	3	6	0	0
9	7244985	.	C	T	3	4	7	0	2	9	0	0
9	7245004	.	C	T	6	2	8	0	0	8	0	0
9	7245023	.	T	C	3	4	7	0	1	8	0	0
9	7245075	.	T	G	2	2	4	0	0	4	0	0
9	7245377	.	C	T	3	2	5	0	0	5	0	0
9	7245528	.	T	A	1	2	3	0	0	3	0	0
9	7245681	.	C	G	3	2	5	0	0	5	0	0
9	7249063	.	G	C	2	2	4	0	0	4	0	0
9	7249072	.	T	A	1	2	3	0	0	3	0	0
9	7249439	.	T	C	0	0	0	0	5	5	0	0
9	7249443	.	G	T	2	3	5	0	0	5	0	0
9	7275317	.	A	T	2	3	5	0	0	5	0	0
9	7279994	.	C	T	0	2	2	0	2	4	0	0
9	7516034	.	G	T	4	2	6	0	0	6	0	0
9	7570857	.	A	G	9	0	9	0	18	27	0	0
9	7570891	.	T	A	12	14	26	0	1	27	0	0
9	7574042	.	T	A	12	8	20	0	1	21	0	0
9	7574126	.	C	T	12	7	19	0	2	21	0	0
9	7574135	.	A	T	12	8	20	0	1	21	0	0
9	7575309	.	G	A	10	11	21	0	0	21	0	0
9	7575545	.	A	C	9	11	20	0	0	20	0	0
9	7578595	.	G	C	7	14	21	0	0	21	0	0
9	7604524	.	G	A	31	17	48	0	1	49	0	0
9	7612711	.	G	A	3	28	31	1	28	63	3	0
9	7612826	.	C	T	28	31	59	1	1	61	0	0
9	7618903	.	A	C	31	26	57	0	8	65	0	0
9	7618906	.	T	C	32	33	65	0	3	68	0	0
9	7621780	.	T	A	4	2	6	0	0	6	0	0
9	7635316	.	G	A	2	2	4	0	0	4	0	0
9	7635730	.	C	T	0	2	2	0	1	3	0	0
9	7759994	.	A	G	1	2	3	0	0	3	0	0
9	7767130	.	C	A	4	3	7	0	0	7	0	0
9	7767133	.	G	A	0	3	3	0	4	7	0	0
9	7909543	.	G	A	1	2	3	0	0	3	0	0
9	8064308	.	C	T	1	1	2	0	1	3	0	0
9	8090240	.	C	T	3	2	5	0	0	5	0	0
9	8114242	.	T	C	2	5	7	0	0	7	0	0
9	8121093	.	A	G	4	5	9	0	1	10	0	0
9	8121113	.	A	G	7	6	13	0	0	13	0	0
9	8122429	.	C	T	8	5	13	0	2	15	0	0
9	8128576	.	G	A	11	8	19	0	1	20	0	0
9	8429899	.	A	G	19	9	28	1	6	35	0	0
9	8430558	.	A	C	5	7	12	0	0	12	0	0
9	8430729	.	T	A	4	2	6	0	2	8	0	0
9	8430787	.	A	G	4	7	11	0	2	13	0	0
9	8430831	.	C	T	0	11	11	0	5	16	0	0
9	8431031	.	A	G	17	22	39	0	0	39	0	0
9	8431214	.	C	T	1	11	12	0	9	21	0	0
9	8431256	.	G	A	11	9	20	0	1	21	0	0
9	8431345	.	A	C	10	0	10	0	5	15	0	0
9	8431450	.	A	G	9	11	20	0	0	20	0	0
9	8431541	.	A	T	12	10	22	0	1	23	0	0
9	8431714	.	G	T	2	6	8	0	0	8	0	0
9	8431772	.	C	T	8	10	18	0	0	18	0	0
9	8431814	.	A	G	10	11	21	0	0	21	0	0
9	8431837	.	T	C	6	10	16	0	1	17	0	0
9	8431854	.	T	C	5	7	12	0	0	12	0	0
9	8431894	.	A	G	7	6	13	0	0	13	0	0
9	8432695	.	C	T	9	4	13	0	3	16	0	0
9	8432768	.	A	T	13	8	21	0	0	21	0	0
9	8432996	.	G	A	11	5	16	0	2	18	0	0
9	8433189	.	C	T	6	6	12	0	1	13	0	0
9	8450740	.	G	A	7	7	14	0	0	14	0	0
9	8450788	.	G	A	4	5	9	0	2	11	0	0
9	8451386	.	C	T	2	3	5	0	4	9	0	0
9	8451540	.	C	T	5	2	7	0	0	7	0	0
9	8452546	.	A	G	1	3	4	0	1	5	0	0
9	8452627	.	G	A	3	2	5	0	1	6	0	0
9	8452695	.	C	T	2	4	6	0	1	7	0	0
9	8452705	.	G	A	3	5	8	0	0	8	0	0
9	8453035	.	G	A	1	2	3	0	0	3	0	0
9	8887703	.	C	A	3	2	5	0	0	5	0	0
9	8894918	.	G	A	2	2	4	0	0	4	0	0
9	8898196	.	G	A	0	2	2	0	2	4	0	0
9	8898903	.	C	A	1	4	5	0	0	5	0	0
9	8899665	.	C	T	5	6	11	0	0	11	0	0
9	8899704	.	C	T	5	4	9	0	2	11	0	0
9	8914657	.	G	C	8	12	20	0	1	21	0	0
9	8923188	.	A	T	9	13	22	0	0	22	0	0
9	8929848	.	G	T	6	6	12	0	1	13	0	0
9	8929905	.	G	A	3	4	7	0	6	13	0	0
9	8964977	.	C	T	3	2	5	0	1	6	0	0
9	8964997	.	C	T	7	3	10	0	1	11	0	0
9	8965027	.	A	G	8	3	11	0	3	14	0	0
9	8967442	.	G	A	13	23	36	0	0	36	0	0
9	8967459	.	C	T	25	12	37	0	3	40	0	0
9	8971713	.	G	A	19	21	40	0	1	41	0	0
9	8971984	.	T	G	16	0	16	0	13	29	0	0
9	8971995	.	A	C	10	10	20	0	5	25	0	0
9	8972429	.	T	A	18	12	30	0	3	33	0	0
9	8973379	.	T	G	4	9	13	0	1	14	0	0
9	8973581	.	G	A	3	2	5	0	1	6	0	0
9	8973627	.	C	A	3	6	9	0	1	10	0	0
9	8973629	.	G	A	4	6	10	0	0	10	0	0
9	8974152	.	G	A	4	10	14	0	0	14	0	0
9	9113008	.	A	G	2	3	5	0	0	5	0	0
9	9116101	.	C	T	3	4	7	0	1	8	0	0
9	9118363	.	A	C	7	11	18	0	3	21	0	0
9	9118602	.	G	A	8	2	10	0	1	11	0	0
9	9118695	.	C	T	3	2	5	0	0	5	0	0
9	9118991	.	C	T	12	11	23	0	1	24	0	0
9	9118994	.	C	T	13	11	24	0	1	25	0	0
9	9119546	.	A	G	3	2	5	0	0	5	0	0
9	9119671	.	G	C	10	5	15	0	0	15	0	0
9	9119755	.	G	T	7	11	18	0	1	19	0	0
9	9119771	.	T	A	9	6	15	0	0	15	0	0
9	9119830	.	A	T	8	3	11	1	0	12	0	0
9	9119877	.	G	A	5	4	9	1	0	10	0	0
9	9119937	.	G	A	4	3	7	0	1	8	0	0
9	9120271	.	T	C	7	9	16	0	1	17	0	0
9	9120847	.	G	A	13	8	21	0	1	22	0	0
9	9121242	.	T	C	18	8	26	0	1	27	0	0
9	9121382	.	G	A	9	11	20	0	3	23	0	0
9	9183874	.	C	T	7	8	15	0	1	16	0	0
9	9183969	.	T	A	23	12	35	0	2	37	0	0
9	9184092	.	G	A	15	17	32	0	2	34	0	0
9	9184177	.	G	A	23	21	44	0	4	48	0	0
9	9184397	.	G	A	13	16	29	0	1	30	0	0
9	9184494	.	T	A	15	9	24	0	1	25	0	0
9	9184496	.	C	A	15	10	25	0	0	25	0	0
9	9184536	.	T	C	14	21	35	0	2	37	0	0
9	9184566	.	G	A	11	15	26	0	2	28	0	0
9	9184593	.	T	C	13	13	26	0	3	29	0	0
9	9193044	.	A	C	24	12	36	0	2	38	0	0
9	9195964	.	C	T	25	16	41	2	2	45	0	0
9	9198139	.	A	G	12	12	24	0	1	25	0	0
9	9198202	.	A	C	7	15	22	0	2	24	0	0
9	9198208	.	G	A	7	12	19	0	5	24	0	0
9	9206612	.	C	G	7	7	14	0	0	14	0	0
9	9208714	.	C	A	10	4	14	0	1	15	0	0
9	9208759	.	A	T	4	5	9	0	0	9	0	0
9	9225717	.	C	T	5	4	9	0	0	9	0	0
9	9238577	.	G	A	14	12	26	0	1	27	0	0
9	9238583	.	G	A	12	13	25	0	1	26	0	0
9	9322733	.	G	A	6	10	16	0	0	16	0	0
9	9322782	.	C	G	2	6	8	0	10	18	0	0
9	9322795	.	A	G	11	7	18	0	0	18	0	0
9	9327588	.	G	A	5	8	13	0	0	13	0	0
9	9327705	.	C	T	2	8	10	0	1	11	0	0
9	9342835	.	T	A	4	8	12	0	1	13	0	0
9	9342892	.	C	T	8	7	15	0	0	15	0	0
9	9342994	.	A	G	3	3	6	0	0	6	0	0
9	9345748	.	G	T	2	5	7	0	0	7	0	0
9	9345751	.	C	T	2	4	6	0	1	7	0	0
9	9476237	.	C	T	1	2	3	0	0	3	0	0
9	9542938	.	T	G	1	2	3	0	0	3	0	0
9	9578598	.	G	T	22	22	44	0	3	47	0	0
9	9578936	.	T	G	28	26	54	2	1	57	0	0
9	9579027	.	C	A	25	21	46	0	6	52	0	0
9	9579033	.	T	C	24	1	25	0	25	50	0	0
9	9579076	.	G	C	11	22	33	0	2	35	0	0
9	9579165	.	C	T	23	18	41	0	1	42	0	0
9	9579297	.	G	C	14	14	28	0	0	28	0	0
9	9579551	.	T	A	2	8	10	0	0	10	0	0
9	9580103	.	G	A	18	14	32	0	4	36	0	0
9	9592779	.	C	A	9	9	18	0	0	18	0	0
9	9671208	.	G	A	4	6	10	0	0	10	0	0
9	9719349	.	G	A	1	3	4	0	0	4	0	0
9	9736317	.	G	T	10	18	28	0	1	29	0	0
9	9736406	.	C	A	13	17	30	0	0	30	0	0
9	9736436	.	G	T	16	15	31	0	1	32	0	0
9	9736631	.	T	C	6	4	10	0	0	10	0	0
9	9736684	.	C	T	0	5	5	0	7	12	0	0
9	9736689	.	A	C	6	5	11	0	1	12	0	0
9	9736727	.	A	G	5	6	11	0	1	12	0	0
9	9736815	.	T	A	11	6	17	0	1	18	0	0
9	9736870	.	T	G	5	10	15	0	1	16	0	0
9	9736918	.	G	C	10	14	24	0	1	25	0	0
9	9737060	.	T	G	8	12	20	0	0	21	1	0
9	9737219	.	C	G	5	5	10	0	3	13	0	0
9	9737248	.	G	A	6	7	13	0	1	14	0	0
9	9737432	.	A	T	4	8	12	0	0	12	0	0
9	9737437	.	T	C	4	0	4	0	8	12	0	0
9	9738078	.	G	C	3	2	5	0	1	6	0	0
9	9738158	.	T	G	6	4	10	0	0	10	0	0
9	9738174	.	G	A	3	4	7	0	0	7	0	0
9	9738304	.	C	T	0	5	5	0	2	7	0	0
9	9738325	.	A	T	3	4	7	0	1	8	0	0
9	9738357	.	T	C	5	0	5	0	8	13	0	0
9	9738449	.	C	T	4	2	6	0	0	6	0	0
9	9738450	.	T	A	4	2	6	0	0	6	0	0
9	9738629	.	C	T	0	5	5	0	3	8	0	0
9	9738671	.	C	A	6	9	15	0	0	15	0	0
9	9738707	.	G	A	6	8	14	0	0	14	0	0
9	9738739	.	A	G	5	3	8	0	1	9	0	0
9	9738758	.	T	A	3	1	4	0	2	6	0	0
9	9738863	.	C	A	4	3	7	0	0	7	0	0
9	9739059	.	C	G	1	4	5	0	0	5	0	0
9	9739135	.	T	C	3	2	5	0	1	6	0	0
9	9937808	.	T	C	1	1	2	0	2	4	0	0
9	9941440	.	G	A	1	3	4	0	0	4	0	0
9	9945569	.	G	C	3	2	5	0	0	5	0	0
9	9947425	.	G	A	2	4	6	0	0	6	0	0
9	9948145	.	C	T	2	2	4	0	1	5	0	0
9	9950013	.	C	T	1	2	3	0	0	3	0	0
9	10014875	.	C	A	1	2	3	0	0	3	0	0
9	10043201	.	C	G	4	3	7	0	1	8	0	0
9	10043217	.	T	A	2	4	6	0	1	7	0	0
9	10043343	.	C	G	2	1	3	0	4	7	0	0
9	10043415	.	C	T	4	5	9	0	3	12	0	0
9	10051935	.	T	A	8	7	15	0	0	15	0	0
9	10138338	.	G	A	6	5	11	0	0	11	0	0
9	10138433	.	A	C	2	3	5	0	1	6	0	0
9	10138441	.	T	C	3	0	3	0	3	6	0	0
9	10138486	.	G	A	7	3	10	0	0	10	0	0
9	10153091	.	C	T	3	4	7	1	1	9	0	0
9	10153342	.	T	A	10	12	22	0	0	22	0	0
9	10153590	.	A	C	10	10	20	0	1	21	0	0
9	10153606	.	A	G	12	7	19	0	0	19	0	0
9	10153689	.	G	C	10	10	20	0	2	23	1	0
9	10153705	.	A	T	6	10	16	0	3	19	0	0
9	10154013	.	G	T	11	14	25	0	4	29	0	0
9	10154014	.	C	T	12	16	28	0	1	29	0	0
9	10154138	.	T	C	8	9	17	0	0	17	0	0
9	10154195	.	A	T	4	4	8	0	0	8	0	0
9	10154461	.	C	T	4	11	15	0	0	15	0	0
9	10154565	.	G	A	1	3	4	0	0	4	0	0
9	10156145	.	C	A	5	8	13	0	1	14	0	0
9	10157193	.	C	G	4	5	9	0	1	10	0	0
9	10168945	.	C	T	1	4	5	0	2	7	0	0
9	10175785	.	A	G	3	2	5	0	0	5	0	0
9	10175812	.	G	A	3	3	6	0	0	6	0	0
9	10195384	.	C	G	1	2	3	0	0	3	0	0
9	11532306	.	A	G	6	7	13	0	0	13	0	0
9	11532307	.	C	A	5	7	12	0	1	13	0	0
9	11532682	.	T	C	10	9	19	0	3	22	0	0
9	11532775	.	A	G	8	5	13	0	0	13	0	0
9	11906956	.	A	G	12	10	22	0	1	23	0	0
9	11907424	.	C	T	2	7	9	0	7	16	0	0
9	11907445	.	C	T	4	8	12	0	0	12	0	0
9	11907469	.	T	A	7	10	17	0	1	19	1	0
9	11907497	.	G	A	5	9	14	0	2	16	0	0
9	11907603	.	T	C	7	0	7	0	6	13	0	0
9	11908200	.	A	T	3	6	9	0	1	10	0	0
9	11908453	.	T	C	1	4	5	0	0	5	0	0
9	11908548	.	A	C	5	3	8	0	0	8	0	0
9	11908900	.	T	C	4	5	9	0	0	9	0	0
9	11909176	.	T	A	2	2	4	0	1	5	0	0
9	12263245	.	T	A	1	5	6	0	0	6	0	0
9	12265446	.	G	A	5	6	11	0	0	11	0	0
9	12265917	.	T	C	1	3	4	0	0	4	0	0
9	12268029	.	C	T	3	3	6	0	0	6	0	0
9	12655656	.	A	C	1	2	3	0	1	4	0	0
9	12664466	.	T	G	4	2	6	0	0	6	0	0
9	12864711	.	G	A	1	2	3	0	0	3	0	0
9	12865859	.	C	T	2	5	7	0	0	7	0	0
9	12866399	.	G	A	1	7	8	0	0	8	0	0
9	12868364	.	G	A	6	6	12	0	0	12	0	0
9	12868386	.	T	C	6	0	6	0	3	9	0	0
9	12871640	.	G	A	3	4	7	0	0	7	0	0
9	12874167	.	T	C	4	2	6	0	0	6	0	0
9	12874441	.	C	A	3	4	7	0	0	7	0	0
9	12874960	.	T	C	2	0	2	0	2	4	0	0
9	12875060	.	C	T	1	2	3	0	0	3	0	0
9	12942575	.	A	C	1	3	4	0	0	4	0	0
9	12942653	.	C	A	2	1	3	0	1	4	0	0
9	12944058	.	G	A	2	4	6	0	0	6	0	0
9	12944994	.	A	G	2	4	6	0	0	6	0	0
9	12945253	.	A	G	4	4	8	0	0	8	0	0
9	12945273	.	G	A	4	3	7	0	0	7	0	0
9	12945298	.	G	C	3	2	5	0	0	5	0	0
9	12945384	.	G	T	5	2	7	0	0	7	0	0
9	12945474	.	A	G	1	3	4	0	0	4	0	0
9	12945720	.	T	G	2	5	7	0	1	8	0	0
9	12946468	.	T	A	2	3	5	0	0	5	0	0
9	12946726	.	A	G	2	4	6	0	1	7	0	0
9	12947529	.	A	G	4	5	9	0	1	10	0	0
9	12947649	.	A	T	2	2	4	0	1	5	0	0
9	12948133	.	G	A	2	5	7	0	0	7	0	0
9	12948144	.	A	G	3	3	6	0	2	8	0	0
9	12948410	.	G	C	2	2	4	0	0	4	0	0
9	12948451	.	A	G	4	4	8	0	0	8	0	0
9	12948481	.	T	C	3	4	7	0	1	8	0	0
9	12948656	.	A	G	4	5	9	0	0	9	0	0
9	12948753	.	G	C	7	4	11	0	0	11	0	0
9	12948859	.	A	C	4	3	7	0	0	7	0	0
9	12951236	.	A	C	1	2	3	0	0	3	0	0
9	12951293	.	G	A	1	5	6	0	2	8	0	0
9	12953638	.	G	A	5	4	9	0	0	9	0	0
9	13106541	.	C	T	3	3	6	0	0	6	0	0
9	13107399	.	G	T	1	3	4	0	0	4	0	0
9	13107423	.	A	G	2	4	6	0	0	6	0	0
9	13107633	.	A	G	2	5	7	0	0	7	0	0
9	13110916	.	T	A	2	3	5	0	0	5	0	0
9	13111014	.	T	C	4	2	6	0	0	6	0	0
9	13839737	.	C	T	0	3	3	0	1	4	0	0
9	14023457	.	C	G	3	4	7	0	0	7	0	0
9	14023493	.	T	A	2	6	8	0	2	10	0	0
9	14023856	.	A	G	7	6	13	0	1	14	0	0
9	14024067	.	T	C	4	4	8	0	0	8	0	0
9	14027792	.	G	C	0	7	7	0	6	13	0	0
9	14027874	.	T	A	8	3	11	0	0	11	0	0
9	14028114	.	T	C	9	6	15	0	2	17	0	0
9	14037508	.	C	G	10	8	18	0	1	19	0	0
9	14037569	.	T	C	13	8	21	0	0	21	0	0
9	14038110	.	C	T	6	4	10	1	0	11	0	0
9	14038118	.	A	T	6	3	9	1	0	10	0	0
9	14038176	.	C	A	2	2	4	0	0	4	0	0
9	14040972	.	T	C	1	4	5	0	0	5	0	0
9	14112784	.	T	A	6	4	10	0	0	10	0	0
9	14113289	.	A	G	3	4	7	0	0	7	0	0
9	14113290	.	T	C	3	4	7	0	0	7	0	0
9	14133997	.	C	T	2	2	4	0	0	4	0	0
9	14136979	.	C	T	4	2	6	0	0	6	0	0
9	14137278	.	G	A	1	3	4	0	0	4	0	0
9	14195700	.	A	G	7	0	7	0	4	11	0	0
9	14196150	.	A	G	1	3	4	0	0	4	0	0
9	14196329	.	A	G	3	2	5	0	0	5	0	0
9	14196513	.	G	A	2	4	6	0	1	7	0	0
9	14196763	.	A	C	3	6	9	0	0	9	0	0
9	14196866	.	G	A	7	5	12	0	1	13	0	0
9	14197063	.	A	G	13	12	25	0	0	25	0	0
9	14367775	.	C	T	8	7	15	0	0	15	0	0
9	14367837	.	T	G	8	7	15	0	2	17	0	0
9	14367878	.	C	T	17	14	31	0	2	33	0	0
9	14368350	.	T	C	15	8	23	0	0	23	0	0
9	14368378	.	A	T	15	7	22	0	1	23	0	0
9	14368432	.	T	C	12	0	12	0	8	20	0	0
9	14368527	.	A	G	6	6	12	0	1	13	0	0
9	14368590	.	G	A	7	5	12	0	0	12	0	0
9	14368676	.	A	G	6	5	11	0	3	14	0	0
9	14368788	.	T	C	14	6	20	2	2	24	0	0
9	14368892	.	C	T	10	17	27	0	0	27	0	0
9	14368988	.	G	A	18	5	23	0	1	24	0	0
9	14369084	.	G	A	10	9	19	0	0	19	0	0
9	14369150	.	T	A	14	11	25	0	3	28	0	0
9	14381060	.	G	A	6	6	12	0	0	12	0	0
9	14381116	.	G	A	6	5	11	0	1	12	0	0
9	14381240	.	A	C	3	7	10	0	0	10	0	0
9	14411677	.	C	A	5	8	13	0	0	13	0	0
9	14433931	.	A	T	3	2	5	0	0	5	0	0
9	14442341	.	A	G	1	4	5	0	0	5	0	0
9	14443133	.	G	T	1	5	6	0	0	6	0	0
9	14443178	.	T	C	2	2	4	0	1	5	0	0
9	14443184	.	A	C	2	2	4	0	0	4	0	0
9	14446405	.	A	T	3	2	5	0	0	5	0	0
9	14446421	.	T	C	2	0	2	0	4	6	0	0
9	15363293	.	T	G	2	4	6	0	0	6	0	0
9	15363558	.	A	C	1	2	3	0	0	3	0	0
9	15367262	.	G	A	1	2	3	0	0	3	0	0
9	15367267	.	G	C	1	1	2	0	1	3	0	0
9	16127776	.	T	C	1	0	1	0	2	3	0	0
9	16128102	.	C	T	2	2	4	0	0	4	0	0
9	16128472	.	G	A	2	4	6	1	0	7	0	0
9	16128736	.	C	T	1	2	3	0	1	4	0	0
9	16128742	.	T	A	1	3	4	0	0	4	0	0
9	18005806	.	A	G	15	7	22	0	4	26	0	0
9	18005968	.	A	G	37	7	44	0	1	45	0	0
9	19352322	.	C	T	3	2	5	0	0	5	0	0
9	19407483	.	G	T	4	2	6	0	0	6	0	0
9	19407614	.	G	T	4	3	7	0	1	8	0	0
9	19510887	.	T	C	1	7	8	0	0	8	0	0
9	20501589	.	C	T	2	1	3	0	1	4	0	0
9	23915067	.	A	G	5	2	7	0	0	7	0	0
9	24189407	.	A	G	24	7	31	0	1	32	0	0
9	25219037	.	T	G	2	2	4	0	0	4	0	0
9	25219042	.	G	A	2	2	4	0	0	4	0	0
9	25837206	.	A	T	2	2	4	0	1	5	0	0
9	27763078	.	G	T	7	3	10	1	2	13	0	0
9	29034996	.	T	C	3	2	5	0	0	5	0	0
9	30105956	.	G	A	3	2	5	3	0	8	0	0
9	30106009	.	G	A	6	3	9	0	1	10	0	0
9	30107428	.	C	T	5	4	9	0	0	9	0	0
9	30107439	.	T	A	4	5	9	0	0	9	0	0
9	30559418	.	C	T	6	2	8	0	0	8	0	0
9	30806101	.	C	T	1	3	4	0	2	6	0	0
9	30806428	.	G	A	4	3	7	0	2	9	0	0
9	31042584	.	T	C	20	16	36	1	3	40	0	0
9	31062301	.	A	G	21	20	41	0	2	43	0	0
9	31214307	.	T	G	4	2	6	0	0	6	0	0
9	31214442	.	A	C	1	4	5	0	0	5	0	0
9	31248923	.	C	T	5	9	14	0	3	17	0	0
9	31258832	.	G	A	10	15	25	0	0	25	0	0
9	31268856	.	G	T	1	4	5	0	0	5	0	0
9	31274993	.	T	C	12	0	12	3	9	24	0	0
9	31276912	.	C	T	17	19	36	0	1	37	0	0
9	31286938	.	T	A	1	2	3	0	0	3	0	0
9	31510724	.	T	A	7	4	11	0	1	12	0	0
9	31518804	.	C	T	1	2	3	0	0	3	0	0
9	31524405	.	G	A	1	2	3	0	0	3	0	0
9	31524406	.	T	C	1	2	3	0	0	3	0	0
9	31524633	.	G	T	1	3	4	0	0	4	0	0
9	31595634	.	C	T	16	17	33	0	1	34	0	0
9	31604943	.	G	A	5	5	10	0	0	10	0	0
9	31605235	.	A	G	11	4	15	0	0	15	0	0
9	31605260	.	T	C	9	0	9	0	5	14	0	0
9	31605281	.	C	A	0	6	6	0	9	15	0	0
9	31606333	.	C	T	2	9	11	1	0	12	0	0
9	31612184	.	C	T	4	7	11	0	1	12	0	0
9	31619998	.	A	G	2	2	4	0	1	5	0	0
9	31795397	.	G	A	1	3	4	0	0	4	0	0
9	33055417	.	G	T	4	1	5	0	1	6	0	0
9	33411227	.	C	A	6	5	11	0	0	11	0	0
9	33411228	.	A	G	6	5	11	0	0	11	0	0
9	33861805	.	C	T	8	2	10	0	1	11	0	0
9	34112981	.	T	C	3	2	5	0	0	5	0	0
9	34113008	.	A	T	1	2	3	0	0	3	0	0
9	34113140	.	G	A	6	4	10	0	0	10	0	0
9	34116933	.	A	G	2	2	4	0	1	5	0	0
9	34117293	.	A	C	7	3	10	0	2	12	0	0
9	34120207	.	T	A	3	2	5	0	1	6	0	0
9	34141311	.	A	G	1	0	1	0	2	3	0	0
9	34154428	.	A	C	2	3	5	0	1	6	0	0
9	34154515	.	T	C	2	1	3	0	1	4	0	0
9	34161833	.	C	T	4	4	8	0	0	8	0	0
9	34162264	.	A	T	2	3	5	0	0	5	0	0
9	34174561	.	C	T	9	8	17	0	0	17	0	0
9	34174682	.	G	A	7	5	12	0	0	12	0	0
9	34179700	.	G	T	3	3	6	0	0	6	0	0
9	34179782	.	C	T	0	3	3	0	5	8	0	0
9	34189270	.	C	T	3	3	6	0	1	7	0	0
9	34189378	.	C	T	1	7	8	0	0	8	0	0
9	34189435	.	C	A	4	5	9	0	0	9	0	0
9	34189571	.	C	A	1	6	7	0	1	8	0	0
9	34191603	.	G	A	4	4	8	0	0	8	0	0
9	34200253	.	T	C	5	1	6	0	1	7	0	0
9	34201249	.	C	T	2	5	7	0	0	7	0	0
9	34204487	.	G	A	7	2	9	0	0	9	0	0
9	34204490	.	A	G	6	2	8	0	1	9	0	0
9	34212456	.	G	A	1	2	3	0	0	3	0	0
9	34225055	.	A	G	12	21	33	0	2	35	0	0
9	34225250	.	T	C	25	19	44	0	3	47	0	0
9	34225316	.	G	C	18	21	39	0	4	43	0	0
9	34226955	.	C	A	23	19	42	0	3	45	0	0
9	34226960	.	A	C	25	21	46	0	1	47	0	0
9	34227195	.	G	T	10	12	22	0	0	22	0	0
9	34238825	.	T	A	3	4	7	0	1	9	1	0
9	34242935	.	T	G	5	0	5	0	2	7	0	0
9	34242953	.	G	T	3	2	5	0	0	5	0	0
9	34243122	.	G	C	1	5	6	0	0	6	0	0
9	34243196	.	C	G	2	2	4	0	2	6	0	0
9	34243352	.	C	T	3	4	7	0	1	8	0	0
9	34243549	.	A	G	3	0	3	0	3	6	0	0
9	34243681	.	C	T	8	10	18	0	0	18	0	0
9	34243701	.	C	G	6	7	13	0	3	16	0	0
9	34243775	.	T	C	2	3	5	0	1	6	0	0
9	34246415	.	A	G	4	2	6	0	1	7	0	0
9	34246564	.	A	G	11	9	20	0	0	20	0	0
9	34247035	.	A	T	21	0	21	0	1	34	12	0
9	34247042	.	G	A	24	11	35	0	4	39	0	0
9	34247145	.	A	T	19	11	30	0	1	31	0	0
9	34247356	.	G	A	8	8	16	0	0	16	0	0
9	34251632	.	G	A	12	11	23	0	0	23	0	0
9	34251635	.	C	A	0	10	10	0	13	23	0	0
9	34251707	.	C	G	12	8	20	0	0	20	0	0
9	34254325	.	C	T	5	5	10	0	0	10	0	0
9	34254678	.	A	G	4	4	8	0	0	8	0	0
9	34254685	.	G	A	4	3	7	0	0	7	0	0
9	34254875	.	T	C	4	2	6	0	1	7	0	0
9	34256016	.	A	C	3	4	7	0	0	7	0	0
9	34257954	.	T	A	3	2	5	0	0	5	0	0
9	34258106	.	C	T	1	5	6	0	0	6	0	0
9	34258642	.	G	A	1	2	3	0	0	3	0	0
9	34259406	.	T	A	2	2	4	0	0	4	0	0
9	34259418	.	T	A	3	2	5	0	0	5	0	0
9	34260164	.	C	T	1	1	2	0	1	3	0	0
9	34274897	.	G	C	2	2	4	0	0	4	0	0
9	34334323	.	C	T	1	3	4	0	0	4	0	0
9	34342238	.	C	T	3	3	6	0	0	6	0	0
9	34343983	.	A	G	2	4	6	0	0	6	0	0
9	34349889	.	G	A	1	3	4	0	0	4	0	0
9	34349967	.	C	T	1	2	3	0	0	3	0	0
9	34351273	.	T	G	3	2	5	0	0	5	0	0
9	34351277	.	T	C	3	2	5	0	0	5	0	0
9	34351416	.	A	C	4	3	7	0	0	7	0	0
9	34351811	.	A	G	3	5	8	0	0	8	0	0
9	34351845	.	T	A	6	4	10	0	0	10	0	0
9	34351916	.	C	T	6	5	11	0	1	12	0	0
9	34380457	.	A	G	5	8	13	0	0	13	0	0
9	34382946	.	A	C	4	9	13	0	0	13	0	0
9	34383041	.	C	A	2	10	12	0	1	13	0	0
9	34385012	.	C	T	3	2	5	0	1	6	0	0
9	34385364	.	G	T	8	11	19	0	2	21	0	0
9	34385421	.	A	C	10	15	25	0	1	26	0	0
9	34388784	.	T	G	20	10	30	1	4	36	1	0
9	34388798	.	T	G	26	0	26	1	10	37	0	0
9	34388882	.	G	A	14	13	27	0	1	28	0	0
9	34388969	.	A	G	11	4	15	0	3	18	0	0
9	34389317	.	T	A	17	14	31	0	1	32	0	0
9	34389379	.	C	T	19	16	35	0	3	39	1	0
9	34389457	.	C	A	10	21	31	0	1	32	0	0
9	34389602	.	A	G	23	0	23	0	22	45	0	0
9	34389734	.	G	C	3	13	16	1	16	33	0	0
9	34404830	.	T	G	2	4	6	0	0	6	0	0
9	34409431	.	A	G	3	4	7	0	0	7	0	0
9	34410237	.	T	C	2	2	4	0	0	4	0	0
9	34415308	.	T	C	6	4	10	0	0	10	0	0
9	34419094	.	T	C	7	15	22	0	0	22	0	0
9	34425996	.	G	A	5	5	10	0	1	11	0	0
9	34426783	.	T	G	1	2	3	0	0	3	0	0
9	34426897	.	A	G	1	0	1	0	3	4	0	0
9	34427840	.	C	T	2	3	5	0	0	5	0	0
9	34427846	.	C	T	3	2	5	0	0	5	0	0
9	34435063	.	A	T	2	2	4	0	0	4	0	0
9	34442987	.	C	T	3	4	7	0	0	7	0	0
9	34449246	.	C	A	1	2	3	0	0	3	0	0
9	34452052	.	C	A	2	3	5	0	0	5	0	0
9	34452057	.	G	A	0	3	3	0	2	5	0	0
9	34461340	.	A	G	9	0	9	0	5	14	0	0
9	34466229	.	G	A	0	3	3	0	14	17	0	0
9	34470776	.	T	C	6	6	12	0	1	13	0	0
9	34472180	.	C	T	10	10	20	0	3	23	0	0
9	34474434	.	G	T	18	8	26	0	0	26	0	0
9	34474529	.	A	G	7	0	7	0	8	15	0	0
9	34484859	.	T	A	5	4	9	0	0	9	0	0
9	34484949	.	T	C	7	4	11	0	0	11	0	0
9	34484959	.	T	C	2	3	5	0	2	7	0	0
9	34484997	.	A	T	5	4	9	0	0	9	0	0
9	34485105	.	G	T	5	6	11	0	1	12	0	0
9	34485123	.	T	C	6	7	13	0	1	14	0	0
9	34485168	.	C	T	0	5	5	0	8	13	0	0
9	34490692	.	A	G	4	5	9	0	0	9	0	0
9	34493942	.	C	T	0	3	3	0	1	4	0	0
9	34647415	.	A	G	15	0	15	0	16	31	0	0
9	34647427	.	A	C	17	11	28	0	0	28	0	0
9	34866579	.	T	G	11	6	17	0	1	18	0	0
9	34866888	.	C	T	10	9	19	0	0	19	0	0
9	34867007	.	C	A	1	13	14	0	6	20	0	0
9	34867015	.	T	C	4	0	4	0	12	16	0	0
9	34869699	.	A	G	6	11	17	0	2	19	0	0
9	34869813	.	G	A	5	3	8	0	1	9	0	0
9	34869945	.	G	A	4	7	11	0	0	11	0	0
9	34877074	.	C	T	6	2	8	0	0	8	0	0
9	34877315	.	G	A	1	3	4	0	1	5	0	0
9	34878251	.	G	A	2	3	5	0	0	5	0	0
9	34878259	.	G	A	2	3	5	0	0	5	0	0
9	34878371	.	T	C	0	2	2	0	1	3	0	0
9	34903218	.	T	G	29	23	52	0	1	53	0	0
9	34906337	.	C	G	25	33	58	0	2	60	0	0
9	34912626	.	A	T	26	20	46	0	2	48	0	0
9	34912695	.	T	C	14	0	14	0	23	37	0	0
9	34912895	.	T	A	17	16	33	0	2	35	0	0
9	34920149	.	A	G	4	5	9	0	0	9	0	0
9	34920395	.	G	A	6	4	10	0	1	11	0	0
9	34922670	.	C	T	1	2	3	0	7	10	0	0
9	34922898	.	A	G	4	7	11	0	3	14	0	0
9	34937145	.	C	G	1	2	3	0	0	4	1	0
9	34937154	.	A	T	1	2	3	0	0	3	0	0
9	34938795	.	C	T	15	8	23	0	1	24	0	0
9	34939336	.	A	G	8	12	20	0	1	21	0	0
9	34939800	.	T	C	3	6	9	0	0	9	0	0
9	34967565	.	A	G	9	6	15	0	1	16	0	0
9	34967647	.	C	T	4	3	7	0	2	9	0	0
9	34967649	.	C	T	4	4	8	0	1	9	0	0
9	34967733	.	A	G	8	3	11	0	0	11	0	0
9	34967743	.	A	C	7	2	9	0	1	10	0	0
9	34968005	.	A	G	3	3	6	0	0	6	0	0
9	35014847	.	C	G	1	2	3	0	0	3	0	0
9	35024459	.	G	C	0	3	3	0	7	10	0	0
9	35025183	.	C	T	8	5	13	0	1	14	0	0
9	35025243	.	A	T	9	8	17	0	0	17	0	0
9	35025430	.	C	T	3	4	7	0	0	7	0	0
9	35026736	.	T	A	32	28	60	0	2	62	0	0
9	35026941	.	T	C	37	23	60	0	8	68	0	0
9	35027262	.	A	G	29	29	58	0	5	63	0	0
9	35027309	.	T	C	28	1	29	0	30	59	0	0
9	35027333	.	A	G	28	24	52	0	3	55	0	0
9	35027365	.	G	T	31	31	62	0	2	64	0	0
9	35027371	.	G	T	30	34	64	0	3	67	0	0
9	35027402	.	G	A	30	37	67	0	4	71	0	0
9	35027549	.	T	G	28	31	59	0	2	61	0	0
9	35027705	.	G	A	21	5	26	0	2	38	10	0
9	35028086	.	T	C	32	5	37	0	45	82	0	0
9	35028282	.	T	C	39	3	42	0	33	75	0	0
9	35030977	.	G	A	30	28	58	0	2	60	0	0
9	35032640	.	A	G	31	19	50	0	1	51	0	0
9	35032643	.	A	G	30	21	51	0	1	52	0	0
9	35033347	.	C	T	22	14	36	0	5	41	0	0
9	35039175	.	T	C	16	15	31	0	3	34	0	0
9	35048839	.	G	C	17	14	31	0	3	34	0	0
9	35048840	.	A	C	18	14	32	0	1	33	0	0
9	35170671	.	G	A	10	11	21	0	1	22	0	0
9	35176030	.	A	G	15	16	31	0	2	33	0	0
9	35228165	.	G	A	3	5	8	0	0	8	0	0
9	35230740	.	G	A	5	4	9	0	1	10	0	0
9	35296835	.	C	T	3	4	7	0	0	7	0	0
9	35836674	.	T	G	1	2	3	0	0	3	0	0
9	35836721	.	T	A	2	3	5	0	0	5	0	0
9	35837404	.	C	A	4	5	9	0	0	9	0	0
9	35838477	.	T	A	10	8	18	0	0	18	0	0
9	35840713	.	G	A	5	8	13	0	0	13	0	0
9	35840782	.	T	C	6	8	14	0	0	14	0	0
9	35840900	.	T	A	20	4	24	1	10	35	0	0
9	35841279	.	G	T	7	5	12	0	0	12	0	0
9	35841282	.	A	G	7	4	11	0	0	11	0	0
9	35841663	.	G	T	11	9	20	0	0	20	0	0
9	35841879	.	T	A	17	9	26	0	1	27	0	0
9	35841994	.	A	G	7	8	15	0	0	15	0	0
9	35842164	.	T	A	16	10	26	0	1	27	0	0
9	35842209	.	G	T	13	6	19	0	0	19	0	0
9	35862184	.	A	T	7	10	17	0	1	18	0	0
9	35862299	.	G	A	11	17	28	0	0	28	0	0
9	35863132	.	C	T	13	21	34	0	0	34	0	0
9	35863555	.	T	C	13	18	31	0	1	32	0	0
9	35863603	.	T	C	12	18	30	0	1	31	0	0
9	35863798	.	C	T	18	13	31	0	1	32	0	0
9	35863968	.	A	T	9	15	24	0	1	25	0	0
9	35864210	.	C	T	8	7	15	0	0	15	0	0
9	35864266	.	C	A	5	10	15	0	1	16	0	0
9	35864277	.	C	T	5	12	17	0	0	17	0	0
9	35864356	.	A	G	2	5	7	0	0	7	0	0
9	35864486	.	C	T	3	4	7	0	0	7	0	0
9	35864565	.	A	G	8	5	13	0	0	13	0	0
9	35864598	.	C	T	9	9	18	0	2	20	0	0
9	35865073	.	C	T	21	9	30	0	5	35	0	0
9	35865162	.	G	T	15	11	26	0	1	27	0	0
9	35865270	.	C	G	16	14	30	0	0	30	0	0
9	35872927	.	G	A	2	6	8	0	0	8	0	0
9	35872942	.	G	A	3	7	10	0	0	10	0	0
9	35872993	.	A	T	3	7	10	0	0	10	0	0
9	35873884	.	A	G	2	2	4	0	1	5	0	0
9	35901654	.	T	A	2	7	9	0	1	10	0	0
9	35909794	.	T	C	8	3	11	0	0	11	0	0
9	35909842	.	A	G	7	4	11	0	0	11	0	0
9	35910390	.	C	G	6	11	17	0	0	17	0	0
9	35910672	.	T	C	4	2	6	0	1	7	0	0
9	35912447	.	A	T	1	8	9	0	0	9	0	0
9	35912459	.	G	A	1	7	8	0	0	8	0	0
9	35912661	.	G	C	2	2	4	0	0	4	0	0
9	35915327	.	C	A	4	13	17	0	1	18	0	0
9	35915548	.	C	T	10	6	16	0	1	17	0	0
9	35915557	.	G	A	2	9	11	0	10	21	0	0
9	35916518	.	T	G	11	13	24	0	3	27	0	0
9	35916786	.	G	A	7	18	25	0	1	26	0	0
9	35922046	.	T	G	22	24	46	4	1	51	0	0
9	35922115	.	T	C	11	22	33	0	2	35	0	0
9	36580205	.	A	G	4	2	6	0	0	6	0	0
9	36610163	.	T	C	1	2	3	0	0	3	0	0
9	36610202	.	C	T	1	3	4	0	1	5	0	0
9	36656011	.	A	G	3	4	7	0	1	8	0	0
9	36659702	.	T	G	5	5	10	0	1	11	0	0
9	36898724	.	C	T	8	3	11	0	0	11	0	0
9	36899065	.	C	T	2	5	7	0	8	15	0	0
9	36973841	.	C	G	1	4	5	0	0	5	0	0
9	36974233	.	A	T	2	3	5	0	0	5	0	0
9	37296192	.	G	A	1	3	4	0	1	5	0	0
9	37296235	.	G	T	1	1	2	0	1	3	0	0
9	37341614	.	T	C	1	2	3	0	0	3	0	0
9	37431935	.	G	A	1	5	6	0	5	11	0	0
9	37451809	.	A	G	9	6	15	0	2	17	0	0
9	37452012	.	A	T	14	7	21	0	1	22	0	0
9	37452223	.	C	T	8	7	15	0	2	17	0	0
9	37452432	.	G	A	11	9	20	0	1	21	0	0
9	37452499	.	T	G	14	8	22	0	1	23	0	0
9	37452515	.	G	T	10	11	21	0	1	22	0	0
9	37452616	.	T	G	21	8	29	0	0	29	0	0
9	37452819	.	G	C	13	8	21	0	3	24	0	0
9	37452862	.	T	C	12	6	18	0	0	18	0	0
9	37452924	.	C	G	7	8	15	0	3	18	0	0
9	37492798	.	G	A	2	3	5	0	0	5	0	0
9	37492807	.	A	G	2	2	4	0	1	5	0	0
9	37771849	.	A	G	1	2	3	0	1	4	0	0
9	37815520	.	A	T	2	3	5	0	0	5	0	0
9	37815548	.	A	G	2	0	2	0	2	4	0	0
9	37840024	.	G	T	1	2	3	0	0	3	0	0
9	37850479	.	G	C	4	4	8	0	0	8	0	0
9	37853970	.	A	C	4	3	7	0	1	8	0	0
9	37856541	.	C	T	8	12	20	0	0	20	0	0
9	37856895	.	T	A	6	5	11	0	0	11	0	0
9	37859807	.	G	T	14	15	29	0	0	29	0	0
9	37859881	.	T	G	17	14	31	0	0	31	0	0
9	37860116	.	T	C	3	9	12	1	1	14	0	0
9	37860712	.	C	T	7	3	10	0	0	10	0	0
9	37861490	.	A	T	4	8	12	0	0	12	0	0
9	37861834	.	G	A	3	5	8	0	1	9	0	0
9	37861844	.	G	A	7	4	11	0	0	11	0	0
9	37862065	.	T	G	4	0	4	0	8	12	0	0
9	37862333	.	C	A	3	3	6	0	0	6	0	0
9	38030131	.	A	T	22	16	38	0	0	38	0	0
9	38030366	.	A	T	6	11	17	0	2	19	0	0
9	38030485	.	A	T	10	3	13	0	2	15	0	0
9	38030503	.	C	T	2	4	6	0	11	17	0	0
9	38030574	.	G	A	10	7	17	0	1	18	0	0
9	38033363	.	T	C	8	0	8	0	14	22	0	0
9	38033578	.	A	G	11	11	22	0	1	23	0	0
9	38061525	.	G	T	0	3	3	0	5	8	0	0
9	38061699	.	T	C	6	7	13	0	0	13	0	0
9	38061788	.	T	C	13	6	19	0	1	20	0	0
9	38063688	.	C	A	8	8	16	0	0	16	0	0
9	38063689	.	C	A	8	8	16	0	0	16	0	0
9	38064268	.	T	C	6	10	16	0	1	17	0	0
9	38064420	.	T	G	11	6	17	0	0	17	0	0
9	38064421	.	C	A	10	6	16	0	1	17	0	0
9	38064672	.	A	C	12	4	16	0	0	16	0	0
9	38140963	.	C	A	1	3	4	0	2	6	0	0
9	38142493	.	A	G	7	4	11	0	1	12	0	0
9	38161177	.	A	G	4	0	4	0	6	10	0	0
9	38161842	.	C	T	6	4	10	0	1	11	0	0
9	38161905	.	G	A	2	3	5	0	0	5	0	0
9	38168005	.	A	G	1	0	1	0	2	3	0	0
9	38238917	.	G	A	0	3	3	0	3	6	0	0
9	38251409	.	T	C	4	4	8	0	0	8	0	0
9	38273171	.	G	A	13	12	25	0	1	26	0	0
9	38273264	.	T	A	17	12	29	0	1	30	0	0
9	38276558	.	T	G	9	0	9	0	6	15	0	0
9	38278121	.	A	G	11	11	22	0	0	22	0	0
9	38278289	.	C	T	14	7	21	0	2	23	0	0
9	38278301	.	T	C	17	6	23	0	0	23	0	0
9	38278337	.	T	C	10	7	17	0	2	19	0	0
9	38283647	.	G	A	14	9	23	0	1	24	0	0
9	38283659	.	C	T	10	10	20	0	1	21	0	0
9	38284317	.	A	G	16	0	16	0	10	26	0	0
9	38285598	.	A	G	12	10	22	0	2	24	0	0
9	38286823	.	G	A	14	11	25	0	1	26	0	0
9	38290165	.	C	T	12	18	30	0	0	30	0	0
9	38290210	.	A	G	13	10	23	0	3	26	0	0
9	38290220	.	T	G	14	1	15	0	11	27	1	0
9	38290245	.	C	T	18	8	26	0	0	26	0	0
9	38290414	.	A	G	12	11	23	0	0	23	0	0
9	38290517	.	A	C	12	6	18	0	1	19	0	0
9	38290530	.	A	T	10	5	15	1	4	20	0	0
9	38290777	.	G	T	1	9	10	0	19	29	0	0
9	38290959	.	A	C	21	20	41	0	5	46	0	0
9	38291439	.	G	T	20	15	35	0	1	36	0	0
9	38291616	.	C	T	16	13	29	0	1	30	0	0
9	38291688	.	G	T	18	4	22	1	4	27	0	0
9	38291691	.	A	T	17	3	20	1	5	26	0	0
9	38291737	.	C	A	4	5	9	1	9	19	0	0
9	38315128	.	T	G	4	4	8	0	0	8	0	0
9	38348458	.	G	A	1	4	5	0	0	5	0	0
9	38351016	.	T	C	6	3	9	0	2	11	0	0
9	38353794	.	T	C	14	7	21	0	2	23	0	0
9	38354000	.	T	C	11	8	19	0	1	20	0	0
9	38354224	.	A	G	13	6	19	0	3	22	0	0
9	38354689	.	G	A	9	11	20	0	2	22	0	0
9	38359027	.	A	C	6	0	6	0	12	18	0	0
9	38359737	.	G	A	5	4	9	0	1	10	0	0
9	38362354	.	G	A	3	6	9	0	0	9	0	0
9	38362380	.	C	T	3	6	9	0	1	10	0	0
9	38365213	.	T	C	2	0	2	0	2	4	0	0
9	38366826	.	A	G	3	2	5	0	0	5	0	0
9	38368055	.	A	G	2	3	5	0	0	5	0	0
9	38375890	.	T	G	4	3	7	0	0	7	0	0
9	38376129	.	A	T	2	2	4	0	0	4	0	0
9	38377858	.	G	A	3	3	6	0	0	6	0	0
9	38385734	.	G	A	3	3	6	0	1	7	0	0
9	38386066	.	A	G	5	0	5	0	5	10	0	0
9	38386615	.	C	A	3	2	5	0	0	5	0	0
9	38388017	.	G	A	3	2	5	0	0	5	0	0
9	38388104	.	A	C	1	2	3	0	0	3	0	0
9	38388151	.	T	A	1	1	2	0	1	3	0	0
9	38388492	.	C	T	15	7	22	0	1	23	0	0
9	38388493	.	C	T	6	7	13	0	10	23	0	0
9	38388703	.	T	C	10	2	12	0	3	16	1	0
9	38389026	.	T	A	6	4	10	0	0	10	0	0
9	38389194	.	C	T	13	5	18	0	1	19	0	0
9	38389263	.	T	A	6	4	10	0	2	12	0	0
9	38389426	.	G	A	15	13	28	0	1	29	0	0
9	38389603	.	A	G	14	1	15	0	8	23	0	0
9	38389616	.	C	T	15	12	27	0	1	28	0	0
9	38389644	.	A	T	15	13	28	0	1	29	0	0
9	38389722	.	G	T	13	4	17	1	3	21	0	0
9	38389746	.	T	C	14	8	22	1	1	24	0	0
9	38389886	.	C	T	10	13	23	0	0	23	0	0
9	38405238	.	A	G	4	6	10	0	0	10	0	0
9	38405271	.	G	C	3	2	5	0	0	5	0	0
9	38413298	.	C	T	2	4	6	0	0	6	0	0
9	38418623	.	C	T	1	4	5	0	0	5	0	0
9	38418864	.	T	C	5	8	13	0	1	14	0	0
9	38429624	.	G	T	5	2	7	0	0	7	0	0
9	38456782	.	C	T	1	2	3	0	1	4	0	0
9	38470376	.	C	T	1	3	4	0	1	5	0	0
9	38475598	.	T	C	2	2	4	0	1	5	0	0
9	38476748	.	G	A	2	4	6	0	0	6	0	0
9	38476780	.	G	C	1	3	4	0	1	5	0	0
9	38476842	.	G	T	0	2	2	0	2	4	0	0
9	38478252	.	A	G	4	4	8	0	0	8	0	0
9	38479579	.	A	G	6	0	6	0	6	12	0	0
9	38481034	.	G	A	1	2	3	0	0	3	0	0
9	38494774	.	G	A	2	3	5	0	0	5	0	0
9	38497393	.	C	T	2	3	5	0	0	5	0	0
9	38499847	.	C	T	2	3	5	0	0	5	0	0
9	38550889	.	T	C	2	2	4	0	0	4	0	0
9	38550910	.	T	C	1	3	4	0	0	4	0	0
9	38603338	.	A	T	12	6	18	0	0	18	0	0
9	38603742	.	T	C	8	6	14	0	0	14	0	0
9	38620058	.	C	T	10	12	22	0	0	22	0	0
9	38620308	.	C	A	10	6	16	0	0	16	0	0
9	38620673	.	A	G	29	11	40	0	1	41	0	0
9	38636722	.	T	C	4	2	6	0	1	7	0	0
9	38636797	.	T	C	4	3	7	0	0	7	0	0
9	38637872	.	T	C	1	2	3	0	0	3	0	0
9	38637879	.	A	C	1	2	3	0	0	3	0	0
9	38638197	.	C	T	1	1	2	0	1	3	0	0
9	38638452	.	A	T	3	8	11	0	0	11	0	0
9	38638461	.	C	G	1	8	9	0	0	9	0	0
9	38638492	.	A	G	2	0	2	0	7	9	0	0
9	38638518	.	T	C	6	6	12	0	0	12	0	0
9	38638743	.	T	C	5	6	11	1	0	12	0	0
9	38638862	.	C	T	2	5	7	0	0	7	0	0
9	38638863	.	C	A	3	5	8	0	0	8	0	0
9	38638970	.	G	A	6	2	8	0	0	8	0	0
9	38639799	.	T	C	4	2	6	0	0	6	0	0
9	38639846	.	C	T	6	3	9	0	0	9	0	0
9	38639907	.	A	C	5	6	11	0	0	11	0	0
9	38639999	.	C	T	6	6	12	0	0	12	0	0
9	38640114	.	T	A	9	12	21	0	0	21	0	0
9	38640186	.	T	C	6	7	13	0	0	13	0	0
9	38640193	.	T	C	5	7	12	0	0	12	0	0
9	38640598	.	A	G	1	0	1	0	4	5	0	0
9	38640773	.	A	T	1	5	6	0	1	7	0	0
9	38641111	.	C	T	5	4	9	0	1	10	0	0
9	38706615	.	C	A	1	2	3	0	0	3	0	0
9	38706621	.	C	G	1	2	3	0	0	3	0	0
9	38761700	.	G	A	0	4	4	0	1	5	0	0
9	38761708	.	A	G	2	3	5	0	0	5	0	0
9	38765158	.	C	T	1	2	3	0	0	3	0	0
9	38765179	.	A	G	1	0	1	0	3	4	0	0
9	38948420	.	C	T	3	6	9	0	1	10	0	0
9	38962017	.	A	C	8	13	21	0	2	24	1	0
9	38962081	.	T	G	5	8	13	0	1	14	0	0
9	40928199	.	T	C	5	2	7	0	1	8	0	0
9	40928245	.	T	C	11	6	17	0	1	18	0	0
9	40928284	.	T	C	8	0	8	0	8	16	0	0
9	40930316	.	T	C	3	5	8	0	0	8	0	0
9	40930319	.	T	C	3	6	9	0	0	9	0	0
9	40930354	.	T	C	4	3	7	0	0	7	0	0
9	41479871	.	A	G	2	2	4	0	0	4	0	0
9	41481079	.	A	G	4	3	7	0	0	7	0	0
9	41659337	.	T	A	7	2	9	0	0	9	0	0
9	41679615	.	A	T	3	2	5	0	0	5	0	0
9	42360743	.	C	G	5	5	10	0	0	10	0	0
9	42421357	.	G	A	1	2	3	1	0	4	0	0
9	42421390	.	G	T	1	2	3	0	0	3	0	0
9	42421404	.	A	G	1	2	3	0	0	3	0	0
9	42430358	.	A	G	1	3	4	0	0	4	0	0
9	42430359	.	T	C	1	3	4	0	0	4	0	0
9	42644892	.	A	G	11	0	11	0	10	21	0	0
9	42649583	.	A	G	2	6	8	1	2	11	0	0
9	42649636	.	T	A	4	2	6	0	0	6	0	0
9	42649653	.	T	C	5	4	9	0	0	9	0	0
9	42649739	.	C	T	13	5	18	0	0	18	0	0
9	42649743	.	A	G	13	5	18	0	1	19	0	0
9	42658401	.	G	C	1	4	5	0	0	5	0	0
9	42660036	.	T	C	3	3	6	0	1	7	0	0
9	42728603	.	T	C	1	2	3	0	0	3	0	0
9	42728866	.	C	A	1	2	3	0	0	3	0	0
9	42730451	.	A	C	2	2	4	0	0	4	0	0
9	42735896	.	A	G	1	2	3	0	0	3	0	0
9	43082319	.	T	A	3	2	5	0	0	5	0	0
9	43082373	.	A	T	5	3	8	0	0	8	0	0
9	43082398	.	A	G	6	2	8	0	0	8	0	0
9	43082519	.	C	A	0	2	2	0	6	8	0	0
9	43082541	.	A	C	6	2	8	0	0	8	0	0
9	43085471	.	G	C	6	4	10	0	0	10	0	0
9	43085728	.	A	C	6	4	10	0	0	10	0	0
9	43088884	.	G	A	3	4	7	0	0	7	0	0
9	43088910	.	A	T	3	3	6	0	1	7	0	0
9	43089038	.	C	G	5	3	8	0	0	8	0	0
9	43107351	.	T	C	3	2	5	0	0	5	0	0
9	43150018	.	T	A	8	9	17	0	0	17	0	0
9	43150278	.	T	G	10	11	21	0	1	22	0	0
9	43150604	.	A	G	18	17	35	6	0	41	0	0
9	43150817	.	C	T	1	20	21	0	13	34	0	0
9	43153287	.	C	T	17	14	31	0	1	32	0	0
9	43154841	.	C	T	6	15	21	0	0	21	0	0
9	43175527	.	C	T	2	11	13	0	13	26	0	0
9	43207727	.	G	A	3	9	12	0	0	12	0	0
9	43243224	.	T	G	1	3	4	0	0	4	0	0
9	43375122	.	G	A	1	2	3	0	0	3	0	0
9	43552604	.	C	A	6	7	13	0	1	14	0	0
9	43552687	.	A	C	14	7	21	4	1	26	0	0
9	43553036	.	G	T	15	18	33	0	0	33	0	0
9	43612482	.	T	G	3	5	8	0	0	8	0	0
9	43617899	.	A	G	3	7	10	0	0	10	0	0
9	44080301	.	C	T	2	3	5	0	0	5	0	0
9	44080411	.	C	T	2	2	4	0	0	4	0	0
9	44097854	.	C	T	1	8	9	0	6	15	0	0
9	44109260	.	A	G	2	3	5	0	1	6	0	0
9	44109589	.	T	C	1	0	1	0	4	5	0	0
9	44109595	.	T	C	1	0	1	0	4	5	0	0
9	44192300	.	G	A	2	3	5	0	1	6	0	0
9	44207771	.	G	A	1	6	7	0	0	7	0	0
9	44292285	.	A	C	31	0	31	0	25	56	0	0
9	44292737	.	T	C	28	28	56	0	2	58	0	0
9	44292909	.	C	T	1	35	36	0	20	56	0	0
9	44293488	.	C	T	25	16	41	0	1	42	0	0
9	44294792	.	A	G	10	8	18	0	0	18	0	0
9	44391780	.	G	A	0	2	2	0	2	4	0	0
9	44391831	.	A	G	1	3	4	0	0	4	0	0
9	44400580	.	G	A	7	7	14	0	2	16	0	0
9	44400706	.	C	A	3	4	7	0	0	7	0	0
9	44411647	.	A	G	6	7	13	0	2	15	0	0
9	44411652	.	C	A	6	10	16	0	0	16	0	0
9	44411828	.	A	C	4	12	16	0	1	17	0	0
9	44419652	.	T	A	7	10	17	0	0	17	0	0
9	44419793	.	C	A	7	6	13	0	1	14	0	0
9	44443998	.	T	C	22	12	34	0	1	35	0	0
9	44469318	.	A	G	21	1	22	0	16	38	0	0
9	44488578	.	T	A	9	8	17	0	0	17	0	0
9	44488620	.	G	A	9	4	13	0	3	16	0	0
9	44489843	.	G	A	1	8	9	0	5	14	0	0
9	44489844	.	T	A	6	8	14	0	0	14	0	0
9	44498332	.	T	C	4	9	13	0	1	14	0	0
9	44511218	.	C	T	4	3	7	0	0	7	0	0
9	44515937	.	G	A	1	3	4	0	1	5	0	0
9	44641974	.	A	T	1	3	4	0	0	4	0	0
9	44642017	.	G	A	1	6	7	0	0	7	0	0
9	44642057	.	T	C	1	0	1	0	6	7	0	0
9	44961397	.	T	C	1	2	3	1	0	4	0	0
9	45504485	.	A	G	1	2	3	0	0	3	0	0
9	45541239	.	G	A	1	2	3	0	0	3	0	0
9	45551078	.	A	T	20	18	38	0	0	38	0	0
9	45551273	.	T	C	13	14	27	2	3	32	0	0
9	45551368	.	T	A	6	9	15	0	0	15	0	0
9	45552338	.	T	G	9	16	25	0	1	26	0	0
9	45552364	.	G	A	1	14	15	0	9	24	0	0
9	45552386	.	C	G	12	17	29	0	0	29	0	0
9	45552567	.	G	A	1	10	11	0	26	37	0	0
9	45552806	.	G	A	2	16	18	0	16	34	0	0
9	45552881	.	T	C	23	11	34	0	1	35	0	0
9	45552924	.	C	A	17	12	29	0	3	32	0	0
9	45552957	.	C	T	19	11	30	0	4	34	0	0
9	45623446	.	A	G	1	2	3	0	0	3	0	0
9	46409442	.	A	G	1	2	3	0	1	4	0	0
9	46598134	.	T	C	1	3	4	0	0	4	0	0
9	46604068	.	A	G	1	0	1	0	2	3	0	0
9	46676385	.	C	T	1	3	4	0	0	4	0	0
9	46676393	.	C	G	0	3	3	0	1	4	0	0
9	46683760	.	C	A	1	2	3	0	0	3	0	0
9	46683861	.	A	C	3	5	8	0	0	8	0	0
9	46684356	.	A	C	1	3	4	0	0	4	0	0
9	46692261	.	T	G	16	19	35	0	2	37	0	0
9	46745653	.	A	G	2	2	4	0	0	4	0	0
9	46799102	.	T	C	2	5	7	0	0	7	0	0
9	46821464	.	C	T	13	11	24	0	1	25	0	0
9	46821685	.	A	G	8	4	12	0	1	13	0	0
9	46821741	.	A	G	3	4	7	0	1	8	0	0
9	46821746	.	T	C	1	4	5	0	1	6	0	0
9	46821853	.	G	A	1	7	8	0	0	8	0	0
9	46821855	.	G	T	1	6	7	0	1	8	0	0
9	46821905	.	A	G	5	8	13	0	0	13	0	0
9	46821916	.	A	T	5	6	11	0	3	14	0	0
9	46822002	.	T	C	6	7	13	1	0	14	0	0
9	46822079	.	C	T	8	4	12	0	0	12	0	0
9	46822120	.	C	T	0	6	6	0	6	12	0	0
9	46822144	.	T	C	7	6	13	0	1	14	0	0
9	46822417	.	C	T	0	5	5	0	9	14	0	0
9	46823198	.	C	T	11	15	26	0	0	26	0	0
9	46823325	.	G	A	6	14	20	0	0	20	0	0
9	46823366	.	T	C	2	16	18	0	1	19	0	0
9	46823524	.	A	G	9	15	24	0	0	24	0	0
9	46824110	.	A	G	8	8	16	0	1	17	0	0
9	46824160	.	T	A	10	11	21	0	1	22	0	0
9	46825094	.	A	T	3	4	7	0	0	7	0	0
9	47436078	.	C	T	1	4	5	0	1	6	0	0
9	47465670	.	G	C	1	2	3	0	1	4	0	0
9	48054753	.	G	A	30	22	52	0	3	55	0	0
9	48060592	.	G	C	19	20	39	0	1	40	0	0
9	48060631	.	G	A	17	20	37	0	0	37	0	0
9	48076978	.	T	C	13	12	25	0	3	28	0	0
9	48123595	.	C	T	7	4	11	0	1	12	0	0
9	48127200	.	G	A	3	5	8	0	0	8	0	0
9	48127889	.	G	T	2	6	8	0	0	8	0	0
9	48129019	.	G	C	7	5	12	0	0	12	0	0
9	48129157	.	T	C	4	6	10	0	0	10	0	0
9	48131637	.	T	A	7	5	12	0	0	12	0	0
9	48131814	.	A	T	3	4	7	1	0	8	0	0
9	48131824	.	T	G	2	2	4	1	1	6	0	0
9	48131997	.	C	T	1	5	6	0	2	8	0	0
9	48132029	.	T	C	4	1	5	0	7	12	0	0
9	48132037	.	T	A	4	8	12	0	0	12	0	0
9	48132127	.	C	T	9	7	16	0	0	16	0	0
9	48132245	.	A	T	7	4	11	0	0	11	0	0
9	48132336	.	C	T	0	4	4	0	5	9	0	0
9	48132363	.	C	T	2	8	10	0	2	12	0	0
9	48132381	.	T	G	4	6	10	0	1	11	0	0
9	48132406	.	G	A	4	5	9	0	3	12	0	0
9	48132439	.	G	A	6	5	11	0	0	11	0	0
9	48132531	.	G	A	5	4	9	0	0	9	0	0
9	48132592	.	G	T	2	6	8	0	0	8	0	0
9	48132966	.	T	G	1	2	3	0	0	3	0	0
9	48133056	.	C	T	1	6	7	0	7	14	0	0
9	48133105	.	G	T	7	6	13	0	0	13	0	0
9	48133443	.	T	A	2	3	5	0	0	5	0	0
9	48133644	.	C	T	2	2	4	0	1	5	0	0
9	48133731	.	A	T	2	4	6	0	0	6	0	0
9	48133868	.	C	A	6	2	8	0	0	8	0	0
9	48134174	.	A	G	3	5	8	0	0	8	0	0
9	48134499	.	C	A	3	18	21	0	1	22	0	0
9	48134568	.	G	A	1	10	11	0	7	18	0	0
9	48189403	.	C	G	0	2	2	0	2	4	0	0
9	48189411	.	T	C	2	3	5	0	0	5	0	0
9	48214112	.	G	A	1	2	3	0	0	3	0	0
9	48219223	.	T	A	3	2	5	0	0	5	0	0
9	48222745	.	C	T	1	2	3	0	0	3	0	0
9	48222751	.	G	A	1	2	3	0	1	4	0	0
9	48225782	.	C	T	1	2	3	0	0	3	0	0
9	48226002	.	C	A	2	5	7	0	2	9	0	0
9	48229002	.	G	A	0	5	5	0	5	10	0	0
9	48230669	.	C	T	4	6	10	0	1	11	0	0
9	48230714	.	C	A	1	5	6	0	0	6	0	0
9	48230723	.	C	T	2	4	6	0	0	6	0	0
9	48230792	.	G	A	4	2	6	0	2	8	0	0
9	48230795	.	A	C	3	4	7	0	0	7	0	0
9	48261089	.	T	C	3	3	6	0	1	7	0	0
9	48262228	.	A	G	1	0	1	0	4	5	0	0
9	48266149	.	A	C	2	3	5	0	1	6	0	0
9	48267147	.	T	G	1	4	5	0	0	5	0	0
9	48267159	.	C	T	3	2	5	0	1	6	0	0
9	48270816	.	C	T	2	2	4	0	0	4	0	0
9	48270830	.	G	A	2	3	5	0	0	5	0	0
9	48284901	.	T	C	13	10	23	0	1	24	0	0
9	48284917	.	C	A	2	10	12	0	13	25	0	0
9	48284972	.	T	C	11	7	18	0	1	19	0	0
9	48285019	.	G	A	10	7	17	0	0	17	0	0
9	48286702	.	G	A	5	5	10	0	2	12	0	0
9	48287441	.	G	A	7	2	9	0	2	11	0	0
9	48296337	.	G	T	6	2	8	0	0	8	0	0
9	48387299	.	T	C	1	2	3	0	0	3	0	0
9	48389871	.	C	T	0	5	5	0	1	6	0	0
9	48390855	.	G	A	2	2	4	0	0	4	0	0
9	48392077	.	G	A	2	2	4	0	0	4	0	0
9	48397340	.	A	G	3	3	6	0	0	6	0	0
9	48397350	.	T	C	3	0	3	0	3	6	0	0
9	48650859	.	C	T	2	2	4	0	0	4	0	0
9	48653675	.	A	G	3	4	7	0	0	7	0	0
9	48653759	.	T	C	1	2	3	0	1	4	0	0
9	48665654	.	G	A	2	7	9	0	0	9	0	0
9	48666890	.	A	G	1	4	5	0	1	6	0	0
9	48668834	.	C	G	6	5	11	0	0	11	0	0
9	48669326	.	G	T	1	1	2	0	1	3	0	0
9	48670316	.	C	T	5	3	8	0	0	8	0	0
9	48670395	.	A	C	2	5	7	0	0	7	0	0
9	48670454	.	T	G	3	3	6	0	0	6	0	0
9	48670747	.	T	G	4	0	4	0	6	10	0	0
9	48670748	.	T	C	4	3	7	0	3	10	0	0
9	48706302	.	C	T	1	6	7	0	0	7	0	0
9	48706305	.	C	T	1	6	7	0	0	7	0	0
9	48815862	.	A	T	2	2	4	0	0	4	0	0
9	48831028	.	A	T	1	3	4	0	0	4	0	0
9	48870578	.	T	C	12	1	13	0	16	29	0	0
9	48870593	.	A	T	16	13	29	0	0	29	0	0
9	48870627	.	T	A	9	10	19	0	1	20	0	0
9	48870680	.	A	G	9	8	17	0	0	17	0	0
9	48870886	.	C	T	7	8	15	0	1	16	0	0
9	48871080	.	G	C	6	6	12	0	0	12	0	0
9	48871973	.	A	C	7	9	16	3	0	19	0	0
9	48871996	.	A	T	15	4	19	4	0	23	0	0
9	48872039	.	C	G	0	7	7	4	4	15	0	0
9	48872050	.	C	T	6	5	11	2	0	13	0	0
9	48872688	.	A	T	4	4	8	0	0	8	0	0
9	48872694	.	A	G	4	3	7	0	0	7	0	0
9	48872890	.	C	A	7	4	11	0	1	12	0	0
9	48872924	.	A	G	10	5	15	0	2	17	0	0
9	48872926	.	C	T	0	5	5	0	12	17	0	0
9	48873371	.	A	G	4	4	8	0	1	9	0	0
9	48873522	.	C	G	6	3	9	0	0	9	0	0
9	48873758	.	G	C	4	3	7	0	0	7	0	0
9	48874562	.	G	A	4	7	11	0	0	11	0	0
9	48874577	.	G	A	4	6	10	0	3	13	0	0
9	48874728	.	T	C	4	2	6	0	1	7	0	0
9	48874908	.	A	T	0	2	2	0	0	2	0	0
9	48875094	.	C	A	1	3	4	0	0	4	0	0
9	48875171	.	C	T	1	2	3	0	0	3	0	0
9	48875218	.	G	T	2	2	4	0	0	4	0	0
9	48875510	.	T	C	1	3	4	0	0	4	0	0
9	48875595	.	A	C	1	1	2	0	0	2	0	0
9	48876538	.	A	G	0	4	4	0	1	5	0	0
9	48876544	.	C	T	2	3	5	0	1	6	0	0
9	48876587	.	A	G	1	2	3	0	1	4	0	0
9	50195968	.	C	T	4	3	7	0	1	8	0	0
9	50205318	.	C	T	2	2	4	0	0	4	0	0
9	50751505	.	T	C	1	4	5	0	0	5	0	0
9	51302422	.	A	G	12	12	24	0	3	27	0	0
9	51345386	.	C	A	1	2	3	0	0	3	0	0
9	51430606	.	C	G	2	4	6	0	0	6	0	0
9	51430737	.	C	T	0	3	3	0	1	4	0	0
9	51430767	.	T	A	4	2	6	0	0	6	0	0
9	51430826	.	A	T	3	5	8	0	0	8	0	0
9	51431179	.	C	G	13	15	28	0	1	29	0	0
9	51431642	.	A	C	7	0	7	0	4	11	0	0
9	51431791	.	G	A	2	2	4	0	0	4	0	0
9	51431831	.	G	A	2	2	4	0	1	5	0	0
9	51431843	.	C	G	0	3	3	0	2	5	0	0
9	51432279	.	T	G	5	7	12	0	3	15	0	0
9	51432381	.	C	T	1	6	7	0	6	13	0	0
9	51433816	.	C	T	0	4	4	0	2	6	0	0
9	51996212	.	A	T	7	7	14	0	1	15	0	0
9	51996246	.	C	T	3	4	7	0	7	14	0	0
9	51996280	.	T	A	10	10	20	0	0	20	0	0
9	51996281	.	G	A	10	8	18	0	2	20	0	0
9	51996444	.	T	G	18	9	27	0	0	27	0	0
9	51996469	.	C	T	1	15	16	0	13	29	0	0
9	51996788	.	A	G	2	4	6	0	0	6	0	0
9	51996876	.	A	G	3	6	9	0	1	10	0	0
9	51998648	.	C	T	6	4	10	0	1	11	0	0
9	51998761	.	C	G	1	8	9	0	0	9	0	0
9	51998887	.	T	G	4	3	7	0	0	7	0	0
9	51999842	.	C	G	6	2	8	0	0	8	0	0
9	51999855	.	T	G	7	4	11	0	0	11	0	0
9	51999991	.	A	G	2	3	5	0	0	5	0	0
9	52000032	.	C	T	1	2	3	0	2	5	0	0
9	52000088	.	G	A	2	5	7	0	0	7	0	0
9	52000293	.	T	C	2	0	2	0	2	4	0	0
9	52000335	.	A	T	5	2	7	0	0	7	0	0
9	52000623	.	C	T	3	2	5	0	2	7	0	0
9	52000665	.	A	G	2	4	6	0	0	6	0	0
9	52000861	.	A	C	2	3	5	0	0	5	0	0
9	52000869	.	G	C	2	1	3	0	1	4	0	0
9	52001016	.	C	T	0	1	1	0	3	4	0	0
9	52001241	.	C	T	0	2	2	0	2	4	0	0
9	52057356	.	T	C	1	0	1	0	2	3	0	0
9	52057378	.	C	A	0	2	2	0	1	3	0	0
9	52378682	.	C	T	20	10	30	1	3	34	0	0
9	52378697	.	A	G	19	17	36	1	1	38	0	0
9	52378832	.	T	A	35	21	56	1	1	58	0	0
9	52431349	.	G	A	0	3	3	0	1	4	0	0
9	52433132	.	T	C	1	5	6	0	0	6	0	0
9	52433174	.	A	C	1	3	4	0	0	4	0	0
9	52439166	.	G	A	2	2	4	0	0	4	0	0
9	52479199	.	T	C	1	3	4	0	1	5	0	0
9	52479739	.	T	C	1	3	4	0	0	4	0	0
9	52479901	.	C	T	1	3	4	0	0	4	0	0
9	52489838	.	C	A	1	2	3	0	0	3	0	0
9	52492641	.	A	C	1	2	3	0	0	3	0	0
9	52492705	.	A	G	1	7	8	0	0	8	0	0
9	52493231	.	A	T	3	4	7	0	1	8	0	0
9	52493406	.	C	T	5	4	9	0	0	9	0	0
9	52539290	.	G	A	0	5	5	0	11	16	0	0
9	52539453	.	C	T	10	13	23	0	0	23	0	0
9	52564578	.	T	C	5	0	5	0	7	12	0	0
9	52564622	.	T	C	5	3	8	0	0	8	0	0
9	52572573	.	G	A	6	4	10	0	1	11	0	0
9	52572609	.	C	G	7	3	10	0	0	10	0	0
9	52574737	.	C	G	3	3	6	0	1	7	0	0
9	52609157	.	C	T	1	2	3	0	0	3	0	0
9	52628984	.	A	G	2	1	3	0	1	4	0	0
9	52628985	.	G	A	2	2	4	0	0	4	0	0
9	52629113	.	C	T	5	9	14	0	3	17	0	0
9	52629119	.	C	T	11	3	14	0	2	16	0	0
9	52629155	.	T	C	3	9	12	0	2	14	0	0
9	52635271	.	C	A	6	3	9	0	0	9	0	0
9	52651985	.	T	C	1	3	4	0	0	4	0	0
9	53276550	.	A	C	9	3	12	0	0	12	0	0
9	53276681	.	G	A	0	8	8	0	6	14	0	0
9	53276976	.	C	T	6	7	13	0	1	14	0	0
9	53276978	.	A	G	8	5	13	0	1	14	0	0
9	53277068	.	C	G	5	1	6	0	6	12	0	0
9	53277131	.	A	T	8	12	20	0	0	20	0	0
9	53277453	.	G	A	0	9	9	0	10	19	0	0
9	53277493	.	A	T	13	6	19	0	3	22	0	0
9	53843404	.	C	T	3	18	21	0	2	23	0	0
9	54255362	.	C	G	3	2	5	0	1	6	0	0
9	54260901	.	C	T	1	2	3	0	0	3	0	0
9	54263996	.	C	T	4	4	8	0	0	8	0	0
9	54264236	.	T	C	3	4	7	0	0	7	0	0
9	54264245	.	T	C	3	4	7	0	0	7	0	0
9	54264272	.	C	T	2	5	7	0	0	7	0	0
9	54264299	.	C	A	2	5	7	0	0	7	0	0
9	54267524	.	A	T	3	2	5	0	0	5	0	0
9	54270324	.	C	T	3	1	4	0	1	5	0	0
9	54273514	.	G	T	3	2	5	0	1	6	0	0
9	54273797	.	C	T	1	3	4	0	0	4	0	0
9	54329593	.	C	A	2	3	5	0	3	8	0	0
9	54329644	.	T	C	2	3	5	0	0	5	0	0
9	54331562	.	G	A	2	2	4	0	0	4	0	0
9	54331768	.	G	A	5	2	7	0	0	7	0	0
9	54335139	.	A	G	4	3	7	0	0	7	0	0
9	54340248	.	G	A	1	4	5	0	0	5	0	0
9	54347521	.	T	C	2	3	5	0	1	6	0	0
9	54711496	.	C	A	3	4	7	1	0	8	0	0
9	54712342	.	C	T	1	8	9	0	0	9	0	0
9	56225617	.	A	G	4	4	8	0	0	8	0	0
