contig	position	variantID	refAllele	altAllele	refCount	altCount	totalCount	lowMAPQDepth	lowBaseQDepth	rawDepth	otherBases	improperPairs
1	208564	.	T	C	9	8	17	0	1	18	0	0
1	209063	.	T	C	4	8	12	0	1	13	0	0
1	209113	.	T	C	6	9	15	0	2	17	0	0
1	423111	.	A	T	3	2	5	0	0	5	0	0
1	442456	.	T	C	6	5	11	2	0	13	0	0
1	443155	.	G	T	0	3	3	0	0	3	0	0
1	504696	.	A	G	10	0	10	0	17	27	0	0
1	504977	.	A	G	10	9	19	0	1	20	0	0
1	505230	.	T	C	0	5	5	0	0	5	0	0
1	620063	.	G	T	9	11	20	1	2	23	0	0
1	4150679	.	T	C	2	2	4	0	0	4	0	0
1	4151098	.	C	T	1	5	6	0	0	6	0	0
1	4151954	.	C	T	3	3	6	0	0	6	0	0
1	4152309	.	T	G	3	6	9	0	0	9	0	0
1	4152562	.	C	T	9	11	20	0	0	20	0	0
1	4152724	.	T	C	3	9	12	0	0	12	0	0
1	4152967	.	A	G	3	0	3	0	6	9	0	0
1	4153840	.	C	T	3	8	11	0	0	11	0	0
1	4153903	.	G	A	0	8	8	0	6	14	0	0
1	4154070	.	C	T	4	7	11	0	0	11	0	0
1	5273808	.	A	G	4	6	10	0	0	10	0	0
1	5273826	.	G	A	3	7	10	0	0	10	0	0
1	5273889	.	C	A	2	6	8	0	0	8	0	0
1	5276257	.	T	C	5	13	18	0	0	18	0	0
1	5276343	.	G	A	10	10	20	0	2	22	0	0
1	5276982	.	A	G	9	0	9	0	8	17	0	0
1	5277218	.	G	A	20	8	28	0	1	29	0	0
1	5354765	.	C	A	18	23	41	0	1	42	0	0
1	5354768	.	A	G	17	21	38	0	2	40	0	0
1	5354970	.	C	T	22	24	46	0	0	46	0	0
1	5355024	.	G	T	18	22	40	0	0	40	0	0
1	5355154	.	A	T	14	13	27	0	0	27	0	0
1	5355262	.	T	A	27	33	60	0	1	61	0	0
1	5355334	.	G	A	23	34	57	0	6	63	0	0
1	5355435	.	C	T	4	12	16	1	41	58	0	0
1	5355514	.	G	A	33	33	66	0	2	68	0	0
1	5355804	.	C	T	4	26	30	1	25	56	0	0
1	5357405	.	T	C	6	17	23	0	1	24	0	0
1	5358792	.	C	A	17	12	29	0	1	30	0	0
1	5365762	.	A	G	2	1	3	0	0	3	0	0
1	5369394	.	A	G	0	2	2	0	0	2	0	0
1	5375285	.	C	T	3	3	6	0	1	7	0	0
1	5375351	.	A	T	5	6	11	0	0	11	0	0
1	5375352	.	C	T	0	6	6	0	5	11	0	0
1	5394687	.	T	A	12	13	25	0	1	26	0	0
1	5402567	.	A	G	5	6	11	0	0	11	0	0
1	5415859	.	T	C	6	1	7	0	0	7	0	0
1	5418305	.	T	C	24	14	38	1	2	41	0	0
1	5418332	.	T	C	16	15	31	1	2	34	0	0
1	5418506	.	T	C	11	19	30	0	1	31	0	0
1	5418530	.	C	G	19	16	35	0	2	37	0	0
1	5418731	.	A	G	18	23	41	0	4	45	0	0
1	5418815	.	A	G	16	17	33	0	1	34	0	0
1	5431337	.	A	G	4	0	4	0	3	7	0	0
1	5433709	.	C	T	15	5	20	0	0	20	0	0
1	5433712	.	T	C	13	4	17	0	3	20	0	0
1	5433836	.	G	T	4	13	17	0	0	17	0	0
1	5500848	.	C	T	3	2	5	0	0	5	0	0
1	5500852	.	G	A	1	2	3	0	2	5	0	0
1	5500892	.	T	A	2	0	2	0	0	2	0	0
1	5502069	.	T	C	2	3	5	0	1	6	0	0
1	5503528	.	T	G	12	4	16	0	0	16	0	0
1	5503574	.	C	A	11	3	14	0	0	14	0	0
1	5503587	.	C	T	9	1	10	0	1	11	0	0
1	5503641	.	A	T	2	3	5	0	1	6	0	0
1	5503642	.	C	T	3	3	6	0	0	6	0	0
1	5503751	.	G	T	3	5	8	0	0	8	0	0
1	5503778	.	T	G	5	5	10	0	0	10	0	0
1	5503809	.	T	C	6	5	11	0	0	11	0	0
1	5503961	.	A	T	5	5	10	0	0	10	0	0
1	5503969	.	A	T	4	5	9	0	2	11	0	0
1	5504002	.	T	G	3	5	8	0	0	8	0	0
1	5504032	.	C	G	2	2	4	0	0	4	0	0
1	5607276	.	C	T	3	3	6	0	0	6	0	0
1	5607349	.	T	A	5	8	13	0	0	13	0	0
1	5607351	.	C	T	5	7	12	0	1	13	0	0
1	5607496	.	G	A	12	3	15	0	1	16	0	0
1	5607755	.	T	G	8	9	17	0	0	17	0	0
1	5607929	.	C	A	4	7	11	0	2	13	0	0
1	5607970	.	T	C	5	5	10	0	0	10	0	0
1	5608215	.	G	T	3	10	13	0	1	14	0	0
1	5608491	.	A	G	7	6	13	0	1	14	0	0
1	5631374	.	A	G	2	0	2	0	0	2	0	0
1	5631389	.	T	A	2	0	2	0	0	2	0	0
1	5632031	.	A	G	0	3	3	0	0	3	0	0
1	5641049	.	G	A	0	2	2	0	0	2	0	0
1	5653026	.	A	G	4	3	7	0	0	7	0	0
1	5653046	.	T	C	5	2	7	0	0	7	0	0
1	5653117	.	A	G	1	3	4	0	0	4	0	0
1	5745396	.	C	G	2	1	3	0	0	3	0	0
1	6153451	.	G	A	1	1	2	0	0	2	0	0
1	6158360	.	G	T	0	7	7	0	4	11	0	0
1	6165150	.	A	G	3	1	4	0	0	4	0	0
1	6165213	.	C	T	2	1	3	0	0	3	0	0
1	6165318	.	A	C	3	0	3	0	0	3	0	0
1	6166479	.	G	T	0	3	3	0	5	8	0	0
1	6167421	.	A	G	1	0	1	0	2	3	0	0
1	6168264	.	G	A	2	3	5	0	0	5	0	0
1	6168346	.	T	A	14	6	20	0	0	20	0	0
1	6168411	.	G	C	6	7	13	0	0	13	0	0
1	6168417	.	G	T	0	7	7	0	9	16	0	0
1	6168568	.	C	G	9	4	13	0	1	14	0	0
1	6168858	.	A	G	8	0	8	0	16	24	0	0
1	6168875	.	G	A	9	15	24	0	0	24	0	0
1	6168925	.	T	C	14	6	20	0	2	22	0	0
1	6169155	.	C	T	9	8	17	0	1	18	0	0
1	6169208	.	C	T	8	10	18	0	0	18	0	0
1	6169232	.	T	C	4	9	13	0	1	14	0	0
1	6169279	.	G	A	10	5	15	0	1	16	0	0
1	6169317	.	C	T	9	7	16	0	0	16	0	0
1	6169378	.	C	T	18	7	25	0	0	25	0	0
1	6169387	.	G	C	20	8	28	0	1	29	0	0
1	6169462	.	T	C	18	11	29	0	2	31	0	0
1	6169494	.	A	G	7	2	9	0	9	18	0	0
1	6169542	.	T	C	1	6	7	0	0	7	0	0
1	6169765	.	C	T	7	5	12	0	0	12	0	0
1	6173631	.	T	C	1	0	1	0	0	1	0	0
1	6185218	.	A	G	4	5	9	0	0	9	0	0
1	6185236	.	T	G	3	7	10	0	0	10	0	0
1	6185259	.	T	G	6	10	16	0	0	16	0	0
1	6185280	.	T	A	7	9	16	0	1	17	0	0
1	6185320	.	T	A	11	10	21	0	2	23	0	0
1	6185326	.	A	C	12	8	20	0	0	20	0	0
1	6185411	.	C	T	10	3	13	0	0	13	0	0
1	6185461	.	C	T	2	2	4	0	0	4	0	0
1	6190003	.	A	G	1	2	3	0	0	3	0	0
1	6199003	.	T	C	3	1	4	0	0	4	0	0
1	6201976	.	C	T	2	0	2	0	0	2	0	0
1	6206978	.	C	T	6	5	11	0	1	12	0	0
1	6207041	.	A	G	0	1	1	0	0	1	0	0
1	6209632	.	G	A	0	4	4	0	6	10	0	0
1	6209662	.	T	G	6	3	9	0	0	9	0	0
1	6209743	.	A	T	3	7	10	0	0	10	0	0
1	6209746	.	G	A	0	8	8	0	3	11	0	0
1	6210190	.	T	G	6	0	6	0	7	13	0	0
1	6210243	.	T	C	12	8	20	0	1	21	0	0
1	6210471	.	T	C	5	8	13	0	0	13	0	0
1	6210567	.	C	T	7	5	12	0	1	13	0	0
1	6226345	.	T	G	1	5	6	0	1	7	0	0
1	6226347	.	T	A	1	6	7	0	0	7	0	0
1	6226388	.	A	G	1	0	1	0	4	5	0	0
1	6236899	.	T	C	0	2	2	0	1	3	0	0
1	6241427	.	T	G	2	2	4	0	0	4	0	0
1	6243620	.	T	C	4	2	6	0	0	6	0	0
1	6243626	.	A	C	1	1	2	0	2	4	0	0
1	6247104	.	C	T	1	2	3	0	0	3	0	0
1	6261467	.	A	T	2	3	5	0	0	5	0	0
1	6271712	.	T	C	2	6	8	0	0	8	0	0
1	7662167	.	C	T	12	13	25	0	0	25	0	0
1	7662169	.	G	A	11	12	23	0	2	25	0	0
1	7662305	.	A	G	18	16	34	0	2	36	0	0
1	7662383	.	G	A	18	16	34	0	1	35	0	0
1	7662840	.	A	C	23	17	40	0	1	42	1	0
1	7668211	.	A	G	18	12	30	0	0	30	0	0
1	7673206	.	C	T	12	12	24	0	0	24	0	0
1	7851259	.	A	T	4	0	4	0	0	4	0	0
1	7853375	.	T	G	7	6	13	0	0	13	0	0
1	7853399	.	G	A	6	6	12	0	0	12	0	0
1	7853465	.	C	A	4	1	5	0	0	5	0	0
1	7867596	.	T	C	0	1	1	0	0	1	0	0
1	7889546	.	C	T	2	3	5	0	0	5	0	0
1	8022503	.	T	A	13	13	26	0	1	27	0	0
1	8022505	.	T	C	13	14	27	0	0	27	0	0
1	8022817	.	T	A	14	22	36	0	2	38	0	0
1	8023245	.	G	A	14	22	36	0	0	36	0	0
1	8023433	.	C	T	12	14	26	0	2	28	0	0
1	8023471	.	A	T	12	11	23	0	2	25	0	0
1	8023490	.	A	C	9	10	19	0	1	20	0	0
1	8023559	.	A	T	7	19	26	0	4	30	0	0
1	8023639	.	C	A	13	16	29	0	3	32	0	0
1	8025986	.	G	A	7	26	33	0	1	34	0	0
1	8026148	.	T	G	5	22	27	0	3	30	0	0
1	8026478	.	T	C	21	0	21	0	12	33	0	0
1	8026521	.	C	A	0	5	5	0	9	14	0	0
1	8026565	.	C	T	2	0	2	0	0	2	0	0
1	8026898	.	C	A	6	16	22	0	1	23	0	0
1	8027245	.	T	G	5	8	13	0	1	14	0	0
1	8028177	.	T	A	4	8	12	0	1	13	0	0
1	8028696	.	G	T	12	12	24	0	1	25	0	0
1	8028727	.	G	A	10	16	26	0	1	27	0	0
1	8028912	.	G	C	7	11	18	0	0	18	0	0
1	8028925	.	C	A	7	7	14	0	0	14	0	0
1	8028979	.	G	A	3	4	7	0	1	8	0	0
1	8029002	.	T	A	5	2	7	0	0	7	0	0
1	8032848	.	C	T	5	6	11	0	0	11	0	0
1	8032950	.	T	A	5	8	13	0	0	13	0	0
1	8032956	.	G	C	7	5	12	0	0	12	0	0
1	8051513	.	G	A	1	4	5	0	0	5	0	0
1	8051528	.	C	T	0	1	1	0	4	5	0	0
1	8058041	.	G	A	3	1	4	0	0	4	0	0
1	8165484	.	C	T	6	3	9	0	1	10	0	0
1	8165486	.	T	A	7	3	10	0	0	10	0	0
1	8165769	.	T	A	2	4	6	0	2	8	0	0
1	8165802	.	C	T	4	6	10	0	0	10	0	0
1	8165937	.	G	A	4	6	10	0	0	10	0	0
1	8165947	.	C	T	3	5	8	0	0	8	0	0
1	8166788	.	A	T	8	14	22	0	2	24	0	0
1	8167383	.	G	A	9	9	18	0	0	18	0	0
1	8167801	.	G	C	4	0	4	0	0	4	0	0
1	8185072	.	G	A	3	3	6	0	0	6	0	0
1	8192102	.	G	A	3	2	5	0	0	5	0	0
1	8403331	.	C	T	4	3	7	0	0	7	0	0
1	8415994	.	C	G	1	6	7	0	0	7	0	0
1	8416165	.	T	C	27	0	27	0	16	43	0	0
1	8416340	.	A	T	27	27	54	0	4	58	0	0
1	8416534	.	A	T	32	21	53	0	0	53	0	0
1	8416565	.	T	A	26	25	51	0	2	53	0	0
1	8416770	.	G	C	10	8	18	0	0	18	0	0
1	8416820	.	C	T	8	0	8	0	0	8	0	0
1	8416967	.	C	T	1	16	17	0	10	27	0	0
1	8417064	.	T	C	12	14	26	0	1	27	0	0
1	8417106	.	G	T	8	18	26	0	1	27	0	0
1	8417109	.	T	G	10	18	28	0	1	29	0	0
1	8417191	.	T	A	31	23	54	0	1	56	1	0
1	8417336	.	A	T	4	5	9	0	3	12	0	0
1	8417340	.	A	T	5	3	8	0	2	10	0	0
1	8417901	.	T	C	10	25	35	0	1	36	0	0
1	8417983	.	G	T	12	10	22	0	2	24	0	0
1	8418058	.	T	A	6	5	11	0	1	12	0	0
1	8418118	.	C	G	7	6	13	0	1	14	0	0
1	8418373	.	C	T	1	14	15	0	21	36	0	0
1	8418503	.	G	T	22	21	43	0	2	45	0	0
1	8418514	.	G	A	24	23	47	0	0	47	0	0
1	8418571	.	A	T	27	18	45	0	3	48	0	0
1	8424705	.	G	A	17	11	28	0	1	29	0	0
1	8424725	.	C	T	1	13	14	0	17	31	0	0
1	8424804	.	C	T	16	15	31	0	4	35	0	0
1	8424813	.	A	G	13	13	26	0	3	29	0	0
1	8428730	.	T	C	6	0	6	0	6	12	0	0
1	8428739	.	C	G	4	3	7	0	0	7	0	0
1	8508755	.	G	A	0	6	6	0	4	10	0	0
1	8508809	.	G	T	4	9	13	0	1	14	0	0
1	8509463	.	C	T	9	7	16	0	1	17	0	0
1	8509571	.	G	A	6	7	13	0	0	13	0	0
1	8511602	.	C	T	1	0	1	0	0	1	0	0
1	8511778	.	G	T	0	5	5	0	1	6	0	0
1	8516587	.	C	T	10	9	19	0	2	21	0	0
1	8527007	.	G	A	1	5	6	0	0	6	0	0
1	8527148	.	C	T	5	3	8	0	0	8	0	0
1	8530144	.	G	A	1	3	4	0	0	4	0	0
1	8530788	.	A	G	9	4	13	0	1	14	0	0
1	8531577	.	C	T	5	5	10	0	0	10	0	0
1	8531824	.	G	A	2	2	4	0	0	4	0	0
1	8531843	.	T	C	2	2	4	0	0	4	0	0
1	8532003	.	G	C	1	2	3	0	0	3	0	0
1	8543769	.	G	C	2	3	5	0	0	5	0	0
1	8546673	.	A	G	1	2	3	0	0	3	0	0
1	8550062	.	A	G	2	3	5	0	0	5	0	0
1	8550116	.	C	T	0	2	2	0	0	2	0	0
1	8557075	.	G	A	9	5	14	0	0	14	0	0
1	8557156	.	C	T	0	2	2	0	2	4	0	0
1	8557159	.	T	A	2	1	3	0	0	3	0	0
1	8559295	.	C	T	4	1	5	0	1	6	0	0
1	8559337	.	G	A	1	3	4	0	0	4	0	0
1	8559750	.	C	T	3	3	6	0	0	6	0	0
1	8560007	.	C	T	3	3	6	0	0	6	0	0
1	8560072	.	A	G	3	3	6	0	0	6	0	0
1	8560208	.	G	A	2	2	4	0	0	4	0	0
1	8560266	.	C	T	5	4	9	0	0	9	0	0
1	8560289	.	C	T	3	5	8	0	1	9	0	0
1	8562005	.	G	C	1	2	3	0	0	3	0	0
1	8563755	.	A	G	1	3	4	0	0	4	0	0
1	8601971	.	A	T	9	5	14	0	1	15	0	0
1	8601990	.	A	T	9	4	13	0	2	15	0	0
1	8603905	.	C	T	0	3	3	0	0	3	0	0
1	8606632	.	C	T	3	5	8	0	1	9	0	0
1	8606644	.	G	A	6	6	12	0	0	12	0	0
1	8606677	.	C	G	10	5	15	0	0	15	0	0
1	8608300	.	C	T	6	2	8	0	0	8	0	0
1	8639847	.	C	T	0	2	2	0	0	2	0	0
1	8639883	.	G	A	0	2	2	0	0	2	0	0
1	8642688	.	C	G	1	0	1	0	0	1	0	0
1	8642800	.	C	T	1	2	3	0	1	4	0	0
1	8642824	.	A	T	1	4	5	0	1	6	0	0
1	8643272	.	C	T	4	2	6	0	0	6	0	0
1	8643442	.	G	A	2	2	4	0	0	4	0	0
1	8643446	.	C	A	0	3	3	0	2	5	0	0
1	8643534	.	C	A	1	3	4	0	0	4	0	0
1	8643574	.	G	A	1	2	3	0	0	3	0	0
1	8646843	.	C	T	3	2	5	0	0	5	0	0
1	8646855	.	A	T	3	2	5	0	0	5	0	0
1	8649726	.	A	G	13	13	26	0	2	28	0	0
1	8649865	.	C	T	19	18	37	0	1	38	0	0
1	8649994	.	A	T	12	8	20	0	2	22	0	0
1	8650149	.	A	G	24	19	43	0	3	46	0	0
1	8650203	.	G	A	20	32	52	0	1	53	0	0
1	8650245	.	G	A	23	31	54	0	4	58	0	0
1	8650290	.	C	T	1	29	30	0	30	60	0	0
1	8650317	.	G	A	28	27	55	0	2	57	0	0
1	8650371	.	C	T	16	38	54	0	6	60	0	0
1	8650660	.	G	A	3	1	4	0	0	4	0	0
1	8650670	.	T	A	4	3	7	0	0	7	0	0
1	8650979	.	A	G	31	27	58	1	2	61	0	0
1	8651060	.	T	C	16	11	27	0	0	27	0	0
1	8663018	.	G	A	10	21	31	0	2	33	0	0
1	8663048	.	G	A	1	19	20	0	10	30	0	0
1	8663087	.	C	A	20	8	28	0	4	32	0	0
1	8663165	.	C	T	22	8	30	0	1	31	0	0
1	8663295	.	T	C	16	21	37	0	2	39	0	0
1	8667377	.	G	A	7	6	13	0	2	15	0	0
1	8667606	.	C	T	10	23	33	0	0	33	0	0
1	8668166	.	T	C	19	31	50	0	0	50	0	0
1	8668238	.	G	T	27	18	45	0	4	49	0	0
1	8668532	.	C	A	1	4	5	1	0	6	0	0
1	8668886	.	T	C	0	3	3	0	0	4	1	0
1	8668930	.	A	T	2	3	5	0	0	5	0	0
1	8669543	.	A	G	5	4	9	0	3	12	0	0
1	8669669	.	A	G	19	9	28	0	0	28	0	0
1	8669673	.	A	G	21	6	27	0	1	28	0	0
1	8669717	.	T	G	19	16	35	0	0	35	0	0
1	8669718	.	T	C	20	14	34	0	1	35	0	0
1	8669847	.	G	T	27	18	45	0	0	45	0	0
1	8670031	.	T	C	28	26	54	0	2	56	0	0
1	8670032	.	G	T	1	28	29	0	27	56	0	0
1	8670402	.	G	A	21	19	40	0	1	41	0	0
1	8698799	.	C	T	17	19	36	0	1	37	0	0
1	8701623	.	C	T	18	28	46	0	1	47	0	0
1	8701747	.	G	A	26	17	43	0	0	43	0	0
1	8702400	.	T	C	26	28	54	0	0	54	0	0
1	8763824	.	A	G	7	7	14	0	0	14	0	0
1	8763832	.	A	C	7	0	7	0	6	13	0	0
1	8764482	.	C	T	2	2	4	0	0	4	0	0
1	8764612	.	T	C	6	0	6	0	11	17	0	0
1	8764661	.	T	A	10	11	21	0	1	22	0	0
1	8764729	.	C	T	13	16	29	0	1	30	0	0
1	8764734	.	C	T	13	12	25	0	2	27	0	0
1	8764811	.	C	T	0	10	10	0	17	27	0	0
1	8765028	.	G	A	17	15	32	0	3	35	0	0
1	8765315	.	A	G	21	17	38	0	1	39	0	0
1	8765422	.	G	A	21	12	33	0	1	34	0	0
1	8765491	.	T	A	14	12	26	0	1	27	0	0
1	8765493	.	G	T	14	10	24	0	3	27	0	0
1	8765713	.	A	C	17	24	41	0	1	42	0	0
1	8765724	.	A	G	18	26	44	0	0	44	0	0
1	8766023	.	C	T	12	13	25	1	4	30	0	0
1	8766267	.	T	C	11	1	12	0	12	24	0	0
1	8766903	.	G	C	11	8	19	0	0	19	0	0
1	8767002	.	C	T	7	11	18	0	0	18	0	0
1	8767080	.	G	A	9	10	19	0	0	19	0	0
1	8767155	.	C	T	11	7	18	0	0	18	0	0
1	8767464	.	G	T	8	5	13	0	1	14	0	0
1	8767518	.	G	A	6	8	14	0	0	14	0	0
1	8767536	.	T	C	5	0	5	0	9	14	0	0
1	8767725	.	T	C	4	7	11	0	0	11	0	0
1	8768307	.	A	G	2	4	6	0	0	6	0	0
1	8773383	.	A	G	1	1	2	0	0	2	0	0
1	8776497	.	A	G	3	3	6	0	1	7	0	0
1	8810701	.	T	G	2	4	6	0	0	6	0	0
1	8810917	.	A	C	1	1	2	0	2	4	0	0
1	8810986	.	T	C	1	1	2	0	2	4	0	0
1	8974576	.	C	T	3	3	6	0	0	6	0	0
1	8974620	.	A	G	1	8	9	0	0	9	0	0
1	8974695	.	A	T	3	11	14	0	0	14	0	0
1	8975415	.	T	C	0	5	5	0	0	5	0	0
1	8977721	.	T	G	1	1	2	0	0	2	0	0
1	9004942	.	T	C	5	7	12	0	0	12	0	0
1	9044526	.	C	T	5	3	8	0	1	9	0	0
1	9056045	.	T	G	1	4	5	0	0	5	0	0
1	9056886	.	T	C	11	11	22	0	1	23	0	0
1	9064611	.	T	C	9	3	12	0	0	12	0	0
1	9064781	.	T	G	6	7	13	0	2	15	0	0
1	9064864	.	T	C	3	5	8	0	0	8	0	0
1	9074335	.	C	T	2	3	5	0	0	5	0	0
1	9074440	.	T	C	9	15	24	0	2	26	0	0
1	9123262	.	A	G	2	8	10	0	1	11	0	0
1	9123289	.	C	G	5	14	19	0	2	21	0	0
1	9145049	.	G	C	1	3	4	0	0	4	0	0
1	9145260	.	C	T	2	2	4	0	0	4	0	0
1	9261903	.	A	C	14	0	14	0	14	28	0	0
1	9261930	.	G	A	15	12	27	0	0	27	0	0
1	9262173	.	G	A	9	14	23	0	1	24	0	0
1	9262221	.	A	G	3	5	8	0	0	8	0	0
1	9270198	.	T	C	2	0	2	0	0	2	0	0
1	9273011	.	C	T	8	11	19	0	0	19	0	0
1	9273037	.	A	G	12	11	23	0	0	23	0	0
1	9273173	.	G	A	4	6	10	0	0	10	0	0
1	9273206	.	T	A	3	7	10	0	0	10	0	0
1	9273211	.	C	T	0	5	5	0	4	9	0	0
1	9276360	.	T	C	3	0	3	0	1	4	0	0
1	9276420	.	C	T	2	1	3	0	0	3	0	0
1	9277858	.	T	C	9	5	14	0	0	14	0	0
1	9290319	.	A	G	6	3	9	0	1	10	0	0
1	9290432	.	T	A	6	3	9	0	1	10	0	0
1	9292975	.	A	T	5	3	8	0	1	9	0	0
1	9293002	.	T	C	8	6	14	0	0	14	0	0
1	9293041	.	C	T	7	7	14	0	3	17	0	0
1	9293117	.	G	A	1	4	5	0	11	16	0	0
1	9293156	.	G	A	12	4	16	0	0	16	0	0
1	9293185	.	T	C	9	6	15	0	2	17	0	0
1	9293215	.	G	A	9	9	18	0	3	21	0	0
1	9293580	.	C	T	8	12	20	0	0	20	0	0
1	9293740	.	T	C	9	8	17	0	0	17	0	0
1	9293889	.	C	A	3	8	11	0	0	11	0	0
1	9500373	.	T	C	1	2	3	0	0	3	0	0
1	10646917	.	T	C	1	2	3	0	1	4	0	0
1	10738177	.	A	G	20	6	26	0	0	26	0	0
1	11695068	.	C	A	1	0	1	0	0	1	0	0
1	11783388	.	T	C	14	20	34	0	3	37	0	0
1	11783410	.	T	C	21	15	36	0	1	37	0	0
1	11783504	.	T	C	21	21	42	0	0	42	0	0
1	11783650	.	T	C	22	20	42	0	0	42	0	0
1	11784522	.	T	C	33	13	46	0	2	48	0	0
1	11784609	.	T	C	23	10	33	0	4	37	0	0
1	11784668	.	T	C	36	8	44	0	1	45	0	0
1	11784679	.	T	C	19	27	46	0	1	47	0	0
1	12325123	.	A	G	0	3	3	0	0	3	0	0
1	15138708	.	A	C	3	6	9	0	0	9	0	0
1	15140407	.	C	T	6	4	10	0	0	10	0	0
1	15142631	.	T	C	7	13	20	0	0	20	0	0
1	15200277	.	T	C	5	4	9	0	0	9	0	0
1	15200440	.	A	G	14	3	17	0	17	34	0	0
1	15200517	.	A	T	11	19	30	0	1	31	0	0
1	15200595	.	A	G	17	23	40	0	1	41	0	0
1	15200730	.	G	C	0	21	21	0	14	35	0	0
1	15200777	.	T	C	10	16	26	0	0	26	0	0
1	15201264	.	A	C	12	11	23	0	0	23	0	0
1	15201491	.	A	G	22	9	31	0	0	31	0	0
1	15201732	.	T	G	12	17	29	0	1	30	0	0
1	15201889	.	G	T	2	15	17	0	19	36	0	0
1	15201931	.	A	T	14	18	32	0	1	33	0	0
1	15202287	.	G	A	11	18	29	0	7	36	0	0
1	15202716	.	G	T	17	16	33	0	2	35	0	0
1	15203038	.	T	C	13	21	34	0	4	38	0	0
1	15203056	.	T	C	14	22	36	0	3	39	0	0
1	15242916	.	C	T	1	0	1	0	1	2	0	0
1	15253337	.	T	A	1	3	4	1	1	6	0	0
1	15253705	.	A	G	7	6	13	0	0	13	0	0
1	15253732	.	T	G	8	11	19	0	1	20	0	0
1	15253863	.	A	T	1	2	3	0	0	3	0	0
1	15254077	.	A	G	2	2	4	0	1	5	0	0
1	15254249	.	A	G	10	0	10	0	10	20	0	0
1	15254351	.	T	G	5	8	13	0	0	13	0	0
1	15254468	.	T	C	6	7	13	0	3	16	0	0
1	15254866	.	G	A	0	5	5	0	12	17	0	0
1	15254973	.	A	T	3	5	8	0	0	8	0	0
1	15255281	.	C	T	5	8	13	0	0	13	0	0
1	15255411	.	T	C	8	10	18	0	0	18	0	0
1	15255424	.	A	G	6	0	6	0	13	19	0	0
1	15255468	.	G	A	5	11	16	0	0	16	0	0
1	15255597	.	A	T	16	12	28	0	0	28	0	0
1	15255699	.	T	A	6	4	10	0	0	10	0	0
1	15255703	.	T	C	6	4	10	0	0	10	0	0
1	15255877	.	A	C	3	6	9	0	1	10	0	0
1	15256142	.	A	C	4	3	7	0	0	7	0	0
1	15259036	.	G	A	3	9	12	0	1	13	0	0
1	15284984	.	T	C	6	8	14	0	1	15	0	0
1	15293547	.	G	T	5	4	9	0	0	9	0	0
1	15294701	.	C	T	0	1	1	0	2	3	0	0
1	15297504	.	C	T	0	6	6	0	2	8	0	0
1	15306233	.	G	A	3	2	5	0	0	5	0	0
1	15313205	.	C	T	0	2	2	0	2	4	0	0
1	15764411	.	C	A	0	0	0	0	1	1	0	0
1	16127926	.	C	T	14	10	24	0	1	25	0	0
1	16127962	.	G	A	6	4	10	0	0	10	0	0
1	16152840	.	G	A	0	9	9	0	10	19	0	0
1	16153607	.	G	A	5	0	5	0	0	5	0	0
1	16574059	.	G	T	0	6	6	0	10	16	0	0
1	16574214	.	G	T	2	1	3	0	0	3	0	0
1	16574417	.	G	A	5	1	6	0	0	6	0	0
1	16609231	.	C	T	3	10	13	0	0	13	0	0
1	16614590	.	T	C	4	7	11	0	0	11	0	0
1	16616881	.	A	T	20	17	37	0	1	38	0	0
1	16617296	.	T	C	5	6	11	0	1	12	0	0
1	16629853	.	T	C	2	1	3	0	0	3	0	0
1	16633665	.	T	C	0	2	2	0	0	2	0	0
1	16634129	.	C	T	3	5	8	0	0	8	0	0
1	16635013	.	C	T	3	4	7	0	0	7	0	0
1	16635039	.	G	A	0	2	2	0	5	7	0	0
1	16635341	.	T	C	1	3	4	0	0	4	0	0
1	16637955	.	T	C	4	4	8	0	0	8	0	0
1	16638189	.	G	A	0	3	3	0	1	4	0	0
1	16638464	.	T	C	2	3	5	0	0	5	0	0
1	16638575	.	C	T	1	3	4	0	0	4	0	0
1	16639501	.	T	C	5	10	15	0	0	15	0	0
1	16639732	.	C	T	1	7	8	0	0	8	0	0
1	16640081	.	G	T	8	11	19	0	1	20	0	0
1	16640138	.	A	G	11	0	11	0	9	20	0	0
1	16640277	.	T	C	5	3	8	0	0	8	0	0
1	16642684	.	T	C	8	6	14	0	0	14	0	0
1	16642770	.	G	A	2	4	6	0	0	6	0	0
1	16646372	.	G	A	0	1	1	0	0	1	0	0
1	16646405	.	C	T	3	2	5	0	0	5	0	0
1	16646499	.	C	T	1	1	2	0	0	2	0	0
1	16646833	.	C	G	7	1	8	0	4	12	0	0
1	16646848	.	T	A	5	4	9	0	0	9	0	0
1	16647928	.	G	T	6	5	11	0	0	11	0	0
1	16649950	.	C	A	1	3	4	0	0	4	0	0
1	16650067	.	T	A	0	6	6	0	1	7	0	0
1	16650350	.	T	A	1	2	3	0	0	3	0	0
1	16650433	.	G	A	11	17	28	0	0	28	0	0
1	16650463	.	C	T	12	13	25	0	1	26	0	0
1	16653552	.	A	T	8	12	20	0	1	21	0	0
1	16653655	.	C	T	12	7	19	0	1	20	0	0
1	16653923	.	T	C	18	8	26	0	0	26	0	0
1	16654145	.	C	G	1	2	3	0	0	3	0	0
1	16654487	.	T	A	8	8	16	0	0	16	0	0
1	16654572	.	A	G	6	4	10	0	0	10	0	0
1	16654657	.	T	G	3	9	12	0	1	13	0	0
1	16655077	.	C	T	7	7	14	0	0	14	0	0
1	16655134	.	G	A	2	0	2	0	0	2	0	0
1	16656828	.	C	T	2	1	3	0	0	3	0	0
1	16675255	.	G	T	9	5	14	0	0	14	0	0
1	16675263	.	A	T	10	3	13	0	1	14	0	0
1	16675293	.	A	G	13	4	17	0	0	17	0	0
1	16675380	.	A	T	6	9	15	0	0	15	0	0
1	16675407	.	T	C	5	0	5	0	2	7	0	0
1	16675493	.	C	T	9	0	9	0	0	9	0	0
1	16675564	.	T	A	8	5	13	0	0	13	0	0
1	16675615	.	T	C	8	0	8	0	8	16	0	0
1	16679950	.	G	T	8	5	13	0	0	13	0	0
1	16679956	.	A	T	8	5	13	0	0	13	0	0
1	16688911	.	G	T	6	8	14	0	0	14	0	0
1	16688943	.	T	C	1	5	6	0	0	6	0	0
1	16688950	.	C	A	1	3	4	0	0	4	0	0
1	17484209	.	T	C	0	2	2	0	0	2	0	0
1	17484724	.	A	G	1	2	3	0	0	3	0	0
1	17487029	.	T	C	1	0	1	0	0	1	0	0
1	17491536	.	C	T	4	2	6	0	0	6	0	0
1	17496245	.	T	C	1	1	2	0	0	2	0	0
1	17496394	.	C	T	2	5	7	0	1	8	0	0
1	17496506	.	A	G	8	5	13	0	1	14	0	0
1	17497479	.	C	T	4	2	6	0	0	6	0	0
1	17500257	.	T	C	3	6	9	0	1	10	0	0
1	17500275	.	A	G	3	0	3	0	4	7	0	0
1	17505138	.	T	C	8	8	16	0	0	16	0	0
1	17505676	.	A	G	5	5	10	0	2	12	0	0
1	17505759	.	T	C	3	1	4	0	0	4	0	0
1	17509715	.	C	T	6	2	8	0	1	9	0	0
1	17509754	.	T	C	7	7	14	0	0	14	0	0
1	17509861	.	A	G	5	9	14	0	0	14	0	0
1	17510038	.	T	C	0	2	2	0	1	3	0	0
1	17513463	.	C	T	13	14	27	0	0	27	0	0
1	17513496	.	T	C	15	16	31	0	1	32	0	0
1	17513562	.	A	G	15	1	16	0	17	33	0	0
1	17513574	.	T	A	14	16	30	0	1	31	0	0
1	17515145	.	G	C	10	6	16	0	1	17	0	0
1	17522001	.	C	A	15	19	34	0	4	38	0	0
1	17522031	.	T	C	13	25	38	0	1	39	0	0
1	17522098	.	T	A	15	25	40	0	2	42	0	0
1	17522107	.	T	C	15	26	41	0	4	45	0	0
1	17522249	.	G	T	13	21	34	0	6	40	0	0
1	17522313	.	C	T	9	18	27	0	2	29	0	0
1	17522647	.	C	T	10	18	28	0	1	29	0	0
1	17522755	.	C	T	15	10	25	0	6	31	0	0
1	17522868	.	A	G	18	0	18	0	17	35	0	0
1	17522923	.	C	T	18	19	37	0	0	37	0	0
1	17523030	.	A	G	19	1	20	0	10	30	0	0
1	17523054	.	T	C	13	10	23	0	0	23	0	0
1	17523080	.	T	C	15	11	26	0	0	26	0	0
1	17523119	.	T	A	20	15	35	0	0	35	0	0
1	17523170	.	A	G	15	17	32	0	1	33	0	0
1	17523562	.	T	C	4	5	9	0	1	10	0	0
1	17523891	.	G	A	24	16	40	0	1	41	0	0
1	17523934	.	A	G	20	1	21	0	6	27	0	0
1	17523971	.	G	C	12	11	23	0	1	24	0	0
1	17523976	.	A	G	8	14	22	0	1	23	0	0
1	17524150	.	A	T	12	24	36	0	1	37	0	0
1	17524401	.	T	A	3	5	8	0	0	8	0	0
1	17524452	.	G	A	1	6	7	0	6	13	0	0
1	17524508	.	G	C	9	7	16	0	2	18	0	0
1	17524562	.	T	C	10	21	31	0	1	32	0	0
1	17531762	.	T	A	2	2	4	0	0	4	0	0
1	17534533	.	T	A	3	6	9	0	0	9	0	0
1	17534599	.	G	A	3	6	9	0	0	9	0	0
1	17534734	.	C	T	3	10	13	0	1	14	0	0
1	17534764	.	T	C	4	7	11	0	1	12	0	0
1	17534870	.	G	A	0	7	7	0	7	14	0	0
1	17534892	.	A	T	8	6	14	0	1	15	0	0
1	17534952	.	T	G	4	3	7	0	0	7	0	0
1	17534962	.	G	A	4	3	7	0	0	7	0	0
1	17535015	.	G	A	6	4	10	0	2	12	0	0
1	17535021	.	G	A	6	7	13	0	0	13	0	0
1	17535150	.	G	T	4	6	10	0	0	10	0	0
1	17535214	.	C	T	7	5	12	0	2	14	0	0
1	17535245	.	T	C	4	6	10	0	1	11	0	0
1	17535281	.	A	G	4	8	12	0	0	12	0	0
1	17535334	.	G	A	0	12	12	0	5	17	0	0
1	17535349	.	C	T	5	9	14	0	1	15	0	0
1	17535442	.	G	A	7	8	15	0	1	16	0	0
1	17535461	.	T	G	5	12	17	0	1	18	0	0
1	17535493	.	G	A	0	9	9	0	6	15	0	0
1	17535766	.	A	G	1	5	6	0	0	6	0	0
1	17535858	.	A	G	4	0	4	0	5	9	0	0
1	17535859	.	A	G	4	3	7	0	2	9	0	0
1	17537709	.	A	G	9	15	24	0	1	25	0	0
1	17537731	.	T	C	9	13	22	0	0	22	0	0
1	17538164	.	A	G	8	3	11	0	1	12	0	0
1	17538751	.	T	C	13	0	13	0	7	20	0	0
1	17538823	.	A	G	4	6	10	1	1	12	0	0
1	17538852	.	A	G	2	11	13	0	0	13	0	0
1	17539011	.	T	G	6	6	12	0	1	13	0	0
1	17539171	.	T	A	1	6	7	0	1	8	0	0
1	17539212	.	G	A	7	5	12	0	0	12	0	0
1	17542951	.	A	G	2	2	4	0	0	4	0	0
1	17546586	.	A	T	1	1	2	0	0	2	0	0
1	17546655	.	A	C	0	2	2	1	0	3	0	0
1	17546827	.	C	T	0	1	1	0	0	1	0	0
1	17555209	.	T	C	1	0	1	0	1	2	0	0
1	17555218	.	C	T	1	1	2	0	0	2	0	0
1	17565727	.	G	A	1	1	2	0	0	2	0	0
1	17565736	.	A	G	1	2	3	0	0	3	0	0
1	17565893	.	G	A	1	0	1	0	0	1	0	0
1	17681203	.	G	A	1	5	6	0	0	6	0	0
1	17681508	.	T	C	5	6	11	0	0	11	0	0
1	17683203	.	A	T	3	6	9	0	0	9	0	0
1	17688762	.	A	G	4	10	14	0	0	14	0	0
1	17688868	.	A	C	7	6	13	0	0	13	0	0
1	17689083	.	C	G	0	14	14	0	4	18	0	0
1	17689173	.	T	C	3	14	17	0	0	17	0	0
1	17689182	.	T	C	3	0	3	0	14	17	0	0
1	17693156	.	A	T	7	3	10	0	0	10	0	0
1	17693218	.	C	T	3	4	7	0	0	7	0	0
1	17698210	.	G	A	3	2	5	0	0	5	0	0
1	17698646	.	A	T	4	3	7	0	0	7	0	0
1	17699650	.	A	G	13	4	17	0	1	18	0	0
1	17701890	.	T	G	2	0	2	0	0	2	0	0
1	17702512	.	T	A	7	5	12	0	1	13	0	0
1	17704125	.	C	T	2	1	3	0	0	3	0	0
1	17704155	.	A	G	5	6	11	0	0	11	0	0
1	17708635	.	G	A	12	8	20	0	0	20	0	0
1	17711097	.	G	T	2	5	7	0	0	7	0	0
1	17711346	.	G	A	0	2	2	0	0	2	0	0
1	17711596	.	T	A	0	2	2	0	0	2	0	0
1	17711623	.	C	T	1	2	3	0	0	3	0	0
1	17747841	.	G	C	1	2	3	0	0	3	0	0
1	17747849	.	T	A	1	2	3	0	0	3	0	0
1	17761911	.	A	G	2	3	5	0	0	5	0	0
1	18375662	.	T	A	2	1	3	0	0	3	0	0
1	18581127	.	T	C	2	2	4	0	0	4	0	0
1	18587333	.	A	T	1	2	3	0	0	3	0	0
1	19742745	.	C	T	1	2	3	0	0	3	0	0
1	19756024	.	C	T	1	2	3	0	1	4	0	0
1	19759915	.	A	G	1	0	1	0	1	2	0	0
1	19866347	.	C	T	1	0	1	0	0	1	0	0
1	19868209	.	G	A	0	1	1	0	1	2	0	0
1	19872320	.	G	A	0	0	0	0	1	1	0	0
1	19885849	.	A	C	1	0	1	0	0	1	0	0
1	19886159	.	A	C	3	3	6	0	0	6	0	0
1	19886292	.	T	A	5	5	10	0	0	10	0	0
1	19886323	.	G	A	2	4	6	0	0	6	0	0
1	19886333	.	A	T	3	2	5	0	0	5	0	0
1	19936191	.	A	G	0	0	0	0	2	2	0	0
1	19936211	.	A	C	1	2	3	0	0	3	0	0
1	19936358	.	T	C	3	5	8	0	0	8	0	0
1	19936418	.	T	A	1	7	8	0	0	8	0	0
1	19936511	.	T	C	4	2	6	0	1	7	0	0
1	19936625	.	T	C	3	3	6	0	0	6	0	0
1	19936673	.	A	G	4	3	7	0	0	7	0	0
1	19936682	.	C	T	3	2	5	0	0	5	0	0
1	19937090	.	A	G	3	0	3	0	3	6	0	0
1	19950737	.	C	A	2	4	6	0	1	7	0	0
1	19978118	.	T	C	1	1	2	0	0	2	0	0
1	19978445	.	A	C	3	1	4	0	0	4	0	0
1	19988952	.	C	G	11	7	18	0	0	18	0	0
1	19989008	.	T	G	14	14	28	0	1	29	0	0
1	19989023	.	G	A	0	16	16	0	15	31	0	0
1	19989323	.	A	C	10	7	17	0	1	18	0	0
1	19989355	.	G	A	1	8	9	0	6	15	0	0
1	20065156	.	A	G	3	3	6	0	1	7	0	0
1	20069667	.	T	G	1	0	1	0	2	3	0	0
1	20084537	.	A	G	0	3	3	0	0	3	0	0
1	20095257	.	T	C	0	3	3	0	1	4	0	0
1	20117629	.	T	C	2	0	2	0	0	2	0	0
1	20129516	.	G	A	4	5	9	0	2	11	0	0
1	20129562	.	C	T	1	2	3	0	0	3	0	0
1	20138674	.	C	A	2	2	4	0	0	4	0	0
1	20138901	.	A	G	4	4	8	0	1	9	0	0
1	20139168	.	T	C	4	2	6	0	0	6	0	0
1	20139187	.	A	C	3	2	5	0	0	5	0	0
1	20139551	.	G	A	4	2	6	0	0	6	0	0
1	20139566	.	A	G	2	3	5	0	0	5	0	0
1	20139636	.	A	C	8	3	11	0	0	11	0	0
1	20139658	.	T	A	10	5	15	0	0	15	0	0
1	20139962	.	A	T	11	7	18	0	1	19	0	0
1	20140042	.	G	T	0	4	4	0	11	15	0	0
1	20140048	.	A	T	10	5	15	0	1	16	0	0
1	20140120	.	C	T	7	8	15	0	1	16	0	0
1	20140133	.	T	C	5	7	12	0	1	13	0	0
1	20140200	.	C	T	13	2	15	0	0	15	0	0
1	20140363	.	T	G	10	4	14	0	0	14	0	0
1	20140419	.	G	A	6	4	10	0	0	10	0	0
1	20140445	.	T	C	3	5	8	0	0	8	0	0
1	20140608	.	A	G	6	0	6	0	1	7	0	0
1	20140610	.	A	T	6	0	6	0	1	7	0	0
1	20140951	.	G	A	0	11	11	0	18	29	0	0
1	20140952	.	G	A	17	11	28	0	1	29	0	0
1	20141070	.	C	A	9	12	21	0	0	22	1	0
1	20141106	.	A	G	5	10	15	0	2	17	0	0
1	20141232	.	T	A	14	4	18	0	0	18	0	0
1	20141253	.	G	A	13	12	25	0	0	25	0	0
1	20141310	.	G	A	19	15	34	0	3	37	0	0
1	20141378	.	C	G	14	0	14	0	17	31	0	0
1	20141411	.	A	T	22	12	34	0	0	34	0	0
1	20141611	.	T	C	10	8	18	0	0	18	0	0
1	20166600	.	A	G	8	6	14	0	0	14	0	0
1	20173954	.	A	G	5	5	10	0	0	10	0	0
1	20212239	.	G	A	6	6	12	0	0	12	0	0
1	20212362	.	G	A	1	2	3	0	0	3	0	0
1	20221498	.	G	A	1	7	8	0	0	8	0	0
1	20270252	.	G	A	4	2	6	0	0	6	0	0
1	20272915	.	T	A	0	1	1	0	0	1	0	0
1	20273088	.	G	A	2	4	6	0	1	7	0	0
1	20273110	.	G	A	3	5	8	0	0	8	0	0
1	20273198	.	C	A	0	4	4	0	3	7	0	0
1	20557467	.	G	A	17	12	29	0	0	29	0	0
1	20557662	.	G	T	8	7	15	0	0	15	0	0
1	20557751	.	C	T	2	4	6	0	0	6	0	0
1	20558143	.	T	C	11	5	16	0	0	16	0	0
1	20558888	.	C	A	1	3	4	0	0	4	0	0
1	20559093	.	A	G	3	2	5	0	0	5	0	0
1	20559324	.	T	A	4	2	6	0	0	6	0	0
1	20559427	.	C	T	1	3	4	0	0	4	0	0
1	20559442	.	C	T	3	2	5	0	1	6	0	0
1	20635419	.	C	T	10	14	24	0	0	24	0	0
1	20678674	.	G	C	8	6	14	0	1	15	0	0
1	20694916	.	G	A	0	7	7	0	8	15	0	0
1	20695073	.	G	A	0	15	15	0	12	27	0	0
1	20700473	.	T	C	23	24	47	0	2	49	0	0
1	20700524	.	G	A	0	20	20	0	9	29	0	0
1	20704896	.	T	C	19	14	33	0	3	36	0	0
1	20705863	.	A	G	13	21	34	0	0	34	0	0
1	20734095	.	A	G	1	1	2	0	1	3	0	0
1	20866886	.	C	T	10	13	23	0	1	24	0	0
1	20866958	.	A	G	24	34	58	0	1	59	0	0
1	20866996	.	T	G	25	38	63	0	2	65	0	0
1	20867092	.	C	T	32	19	51	0	4	55	0	0
1	20867185	.	A	T	23	28	51	0	2	53	0	0
1	20867186	.	G	T	22	28	50	0	2	53	1	0
1	20867478	.	T	C	33	34	67	0	4	71	0	0
1	20867611	.	T	C	34	37	71	0	2	73	0	0
1	20867650	.	G	A	34	30	64	0	5	69	0	0
1	20867887	.	T	C	38	28	66	0	3	69	0	0
1	20867901	.	C	G	3	36	39	0	29	68	0	0
1	20867933	.	T	C	29	3	32	0	25	57	0	0
1	20867968	.	T	G	21	28	49	0	2	51	0	0
1	20868051	.	G	T	36	21	57	0	3	60	0	0
1	20868064	.	T	C	24	35	59	0	4	63	0	0
1	20868165	.	C	G	27	39	66	0	1	67	0	0
1	20868309	.	C	G	30	43	73	0	6	79	0	0
1	20868467	.	C	T	21	27	48	0	2	50	0	0
1	20868762	.	C	A	4	15	19	2	2	23	0	0
1	20868765	.	C	G	0	15	15	2	5	22	0	0
1	20868801	.	C	T	14	21	35	0	0	35	0	0
1	20868802	.	T	G	12	21	33	0	2	35	0	0
1	20868850	.	G	A	24	37	61	0	1	62	0	0
1	20868963	.	A	T	37	17	54	0	2	56	0	0
1	20868997	.	C	T	1	28	29	0	26	55	0	0
1	20869064	.	T	A	2	7	9	0	2	11	0	0
1	20870219	.	T	G	11	22	33	0	1	34	0	0
1	20870632	.	T	C	6	20	26	2	2	30	0	0
1	20870774	.	G	A	25	35	60	0	1	61	0	0
1	20870808	.	C	T	1	28	29	0	26	55	0	0
1	20870876	.	C	T	23	30	53	0	3	56	0	0
1	20871144	.	C	G	23	15	38	0	3	41	0	0
1	20871210	.	G	A	7	6	13	0	0	13	0	0
1	20878946	.	C	T	32	17	49	0	0	49	0	0
1	20878994	.	G	A	25	15	40	0	1	41	0	0
1	20911156	.	T	G	31	22	53	0	5	58	0	0
1	20911171	.	G	T	27	29	56	0	2	58	0	0
1	20916928	.	T	A	7	5	12	0	0	12	0	0
1	20917091	.	G	C	4	3	7	0	0	7	0	0
1	20917114	.	T	A	7	5	12	0	1	13	0	0
1	20932137	.	T	A	5	4	9	0	1	10	0	0
1	20932138	.	C	T	5	4	9	0	1	10	0	0
1	20941573	.	G	A	5	2	7	0	0	7	0	0
1	20941806	.	T	A	1	3	4	0	0	4	0	0
1	20966059	.	T	C	1	3	4	0	0	4	0	0
1	20970202	.	G	A	1	3	4	0	0	4	0	0
1	21139142	.	G	A	7	3	10	0	0	10	0	0
1	21139401	.	C	T	4	4	8	0	0	8	0	0
1	21141869	.	T	G	5	9	14	0	1	15	0	0
1	21141930	.	T	G	3	4	7	0	0	7	0	0
1	21142029	.	A	G	4	11	15	0	0	15	0	0
1	21146729	.	C	G	0	2	2	0	1	3	0	0
1	21148609	.	A	T	4	4	8	0	0	8	0	0
1	21154156	.	C	T	1	2	3	0	0	3	0	0
1	21309423	.	G	A	1	5	6	0	0	6	0	0
1	21312067	.	A	G	1	3	4	0	0	4	0	0
1	21312085	.	G	A	2	6	8	0	0	8	0	0
1	21312145	.	A	G	9	10	19	0	1	20	0	0
1	21312283	.	T	C	4	4	8	0	0	8	0	0
1	21313828	.	T	A	3	2	5	0	1	6	0	0
1	21333223	.	A	T	23	20	43	0	1	44	0	0
1	21333337	.	G	C	14	18	32	0	0	32	0	0
1	21341577	.	T	C	0	3	3	0	0	3	0	0
1	21344500	.	G	A	18	20	38	0	1	39	0	0
1	21344518	.	C	G	0	18	18	0	19	37	0	0
1	21346015	.	T	C	7	11	18	0	0	18	0	0
1	21352529	.	A	G	2	0	2	0	0	2	0	0
1	21409358	.	G	T	6	3	9	0	0	9	0	0
1	21423307	.	C	T	12	8	20	0	0	20	0	0
1	21423765	.	C	A	2	6	8	0	0	8	0	0
1	21439453	.	G	A	6	2	8	0	0	8	0	0
1	21447843	.	C	T	12	10	22	0	0	22	0	0
1	21449804	.	A	G	9	4	13	0	0	13	0	0
1	21473134	.	G	A	1	3	4	0	1	5	0	0
1	21473155	.	G	A	4	4	8	0	0	8	0	0
1	21483684	.	G	A	2	2	4	0	0	4	0	0
1	21500451	.	G	A	3	0	3	0	0	3	0	0
1	21505670	.	G	A	2	1	3	0	0	3	0	0
1	21505702	.	G	T	0	1	1	0	0	1	0	0
1	21514069	.	G	A	1	3	4	0	1	5	0	0
1	21515880	.	G	A	0	2	2	0	1	3	0	0
1	21516249	.	C	G	2	0	2	0	0	2	0	0
1	21522253	.	G	A	0	1	1	0	0	1	0	0
1	21522358	.	G	A	0	2	2	0	0	2	0	0
1	21525823	.	C	T	0	3	3	0	1	4	0	0
1	21526876	.	G	A	0	1	1	0	0	1	0	0
1	21527348	.	C	A	2	2	4	0	0	4	0	0
1	21610564	.	T	C	2	4	6	0	0	6	0	0
1	21611043	.	T	C	6	5	11	0	1	12	0	0
1	21612268	.	A	C	4	3	7	0	0	8	1	0
1	21648641	.	G	A	0	6	6	0	0	6	0	0
1	21941031	.	C	A	1	2	3	0	0	3	0	0
1	21947233	.	A	T	1	3	4	0	0	4	0	0
1	21949996	.	C	T	3	8	11	0	0	11	0	0
1	21950179	.	C	T	5	6	11	0	0	11	0	0
1	21950621	.	G	A	0	7	7	0	2	9	0	0
1	21950650	.	T	C	3	5	8	0	0	8	0	0
1	21950896	.	G	A	0	2	2	0	8	10	0	0
1	21951119	.	G	A	0	6	6	0	3	9	0	0
1	21951309	.	T	G	5	4	9	0	0	9	0	0
1	21951411	.	G	A	4	5	9	0	1	10	0	0
1	21951431	.	T	C	7	5	12	0	0	12	0	0
1	21954946	.	G	A	0	4	4	0	9	13	0	0
1	21957122	.	T	G	1	0	1	0	0	1	0	0
1	21957124	.	T	C	1	0	1	0	0	1	0	0
1	21961430	.	T	C	7	8	15	0	0	15	0	0
1	22411760	.	A	G	3	2	5	0	0	5	0	0
1	22412005	.	G	A	4	9	13	0	1	14	0	0
1	22482490	.	C	T	7	11	18	0	1	19	0	0
1	22482494	.	A	T	10	9	19	0	0	19	0	0
1	22482560	.	G	T	7	7	14	0	0	14	0	0
1	22482575	.	A	G	5	4	9	0	1	10	0	0
1	22482810	.	T	C	3	3	6	0	1	7	0	0
1	22483076	.	T	C	2	3	5	0	0	5	0	0
1	22483594	.	C	A	1	2	3	0	0	3	0	0
1	22483700	.	A	G	5	2	7	0	0	7	0	0
1	22483747	.	C	T	2	2	4	0	0	4	0	0
1	22483750	.	T	C	2	0	2	0	2	4	0	0
1	22483821	.	C	G	2	5	7	0	0	7	0	0
1	22483835	.	C	A	5	4	9	0	1	10	0	0
1	22483955	.	A	G	3	2	5	0	1	6	0	0
1	22484152	.	A	T	3	4	7	0	0	7	0	0
1	22484156	.	T	G	3	4	7	0	0	7	0	0
1	22490234	.	C	A	6	8	14	0	0	14	0	0
1	22490402	.	C	T	5	7	12	0	0	12	0	0
1	22490444	.	G	T	2	3	5	0	0	5	0	0
1	22490660	.	G	A	4	8	12	0	0	12	0	0
1	22511963	.	T	A	2	2	4	0	0	4	0	0
1	22542770	.	C	A	1	5	6	0	0	6	0	0
1	22542771	.	T	C	1	0	1	0	5	6	0	0
1	22543084	.	A	G	3	2	5	0	0	5	0	0
1	22543373	.	T	C	1	2	3	0	0	3	0	0
1	22543902	.	G	A	1	2	3	0	0	3	0	0
1	22544634	.	C	G	1	3	4	0	0	4	0	0
1	22648037	.	T	A	31	30	61	0	1	62	0	0
1	22648038	.	A	C	29	29	58	0	4	62	0	0
1	22651348	.	C	A	1	1	2	0	1	3	0	0
1	22651934	.	T	A	3	1	4	0	0	4	0	0
1	22713000	.	A	T	3	2	5	0	0	5	0	0
1	22713010	.	A	T	3	2	5	0	0	5	0	0
1	22713058	.	C	T	0	2	2	0	3	5	0	0
1	22713095	.	A	C	4	0	4	0	2	6	0	0
1	22713141	.	A	G	1	2	3	0	0	3	0	0
1	22713674	.	C	T	3	2	5	0	0	5	0	0
1	22713974	.	G	A	0	3	3	0	0	3	0	0
1	22770608	.	A	T	14	13	27	0	3	30	0	0
1	22770723	.	C	T	8	12	20	0	1	21	0	0
1	22770810	.	C	T	8	9	17	0	0	17	0	0
1	22771305	.	T	G	15	14	29	0	0	29	0	0
1	22771437	.	G	A	14	7	21	0	0	21	0	0
1	22771677	.	C	T	0	5	5	0	8	13	0	0
1	22771911	.	A	T	7	9	16	0	3	19	0	0
1	22771936	.	C	T	8	13	21	0	0	21	0	0
1	22772213	.	C	A	11	10	21	0	1	22	0	0
1	22772308	.	C	T	8	14	22	0	0	22	0	0
1	22772545	.	A	T	8	13	21	0	2	23	0	0
1	22772711	.	G	A	11	15	26	0	1	27	0	0
1	22777201	.	G	A	1	1	2	0	0	2	0	0
1	22803001	.	A	T	1	3	4	0	0	4	0	0
1	22805615	.	C	T	14	15	29	0	0	29	0	0
1	22805630	.	G	C	12	14	26	0	0	26	0	0
1	22805750	.	T	A	3	7	10	0	0	10	0	0
1	22805766	.	C	T	3	3	6	0	0	6	0	0
1	22805880	.	G	T	5	3	8	0	0	8	0	0
1	22805906	.	A	C	7	5	12	0	0	12	0	0
1	22805927	.	C	A	6	4	10	0	0	10	0	0
1	22806089	.	C	T	16	19	35	0	1	36	0	0
1	22806108	.	A	G	20	15	35	0	3	38	0	0
1	22806156	.	T	C	9	8	17	0	1	19	1	0
1	22806254	.	T	C	6	10	16	0	0	16	0	0
1	22806643	.	C	A	12	19	31	0	1	32	0	0
1	22806825	.	C	T	0	8	8	0	9	17	0	0
1	22806845	.	C	A	5	5	10	0	0	10	0	0
1	22806936	.	C	T	0	12	12	0	5	17	0	0
1	22806980	.	G	A	13	6	19	0	1	20	0	0
1	22807043	.	G	A	7	4	11	0	2	13	0	0
1	22807110	.	T	C	16	0	16	0	8	24	0	0
1	22807169	.	A	G	10	7	17	0	0	17	0	0
1	22807238	.	G	A	9	10	19	0	1	20	0	0
1	22807275	.	C	G	7	11	18	0	0	18	0	0
1	22807304	.	C	G	14	9	23	0	0	23	0	0
1	22807321	.	G	A	16	10	26	0	0	26	0	0
1	22807632	.	C	T	9	7	16	0	2	18	0	0
1	22807639	.	G	A	9	7	16	0	2	18	0	0
1	22807744	.	G	T	11	5	16	0	1	17	0	0
1	22808009	.	G	T	3	11	14	0	0	14	0	0
1	22808149	.	T	A	8	17	25	0	3	28	0	0
1	22808181	.	T	C	17	0	17	0	7	24	0	0
1	22808264	.	T	G	9	7	16	0	1	17	0	0
1	22808296	.	A	T	0	1	1	0	0	5	4	0
1	22808301	.	C	G	0	1	1	0	0	1	0	0
1	22808384	.	C	T	0	6	6	0	5	11	0	0
1	22808444	.	G	A	4	5	9	0	0	9	0	0
1	22808479	.	G	T	8	3	11	0	0	11	0	0
1	22808514	.	A	T	7	4	11	0	2	13	0	0
1	22808665	.	C	T	10	13	23	0	1	24	0	0
1	22814910	.	A	G	17	11	28	0	0	28	0	0
1	22845919	.	A	G	1	0	1	0	0	1	0	0
1	22851065	.	G	T	3	1	4	0	0	4	0	0
1	22851380	.	T	C	8	2	10	0	1	11	0	0
1	22851422	.	T	A	1	5	6	0	0	6	0	0
1	22851828	.	A	T	9	5	14	0	0	14	0	0
1	22856087	.	C	T	4	4	8	0	0	8	0	0
1	22857979	.	C	T	9	11	20	0	0	20	0	0
1	22857995	.	A	G	10	11	21	0	0	21	0	0
1	22858194	.	G	A	21	19	40	0	1	41	0	0
1	22858275	.	T	C	22	19	41	0	3	44	0	0
1	22858397	.	G	A	21	17	38	0	6	44	0	0
1	22858478	.	G	A	21	19	40	0	1	41	0	0
1	22861253	.	G	A	1	1	2	0	0	2	0	0
1	22861267	.	G	A	2	5	7	0	1	8	0	0
1	22864011	.	C	T	3	0	3	0	0	3	0	0
1	22943748	.	G	A	10	11	21	0	1	22	0	0
1	22944056	.	C	T	1	30	31	0	18	49	0	0
1	22944068	.	C	T	35	18	53	0	3	56	0	0
1	22944386	.	A	C	22	22	44	0	2	46	0	0
1	22945054	.	T	C	23	21	44	0	1	45	0	0
1	22945173	.	T	G	21	26	47	0	0	47	0	0
1	22945190	.	G	T	21	21	42	0	1	43	0	0
1	22945444	.	G	A	26	20	46	0	0	46	0	0
1	22945519	.	C	T	21	18	39	0	2	41	0	0
1	22945888	.	G	C	23	1	24	0	14	38	0	0
1	22945903	.	T	C	20	18	38	0	1	39	0	0
1	22946108	.	C	T	12	15	27	0	1	28	0	0
1	22956429	.	C	T	0	6	6	0	3	9	0	0
1	22966877	.	C	A	2	3	5	0	0	5	0	0
1	22987960	.	A	G	1	0	1	0	0	1	0	0
1	22992058	.	G	A	6	11	17	0	0	17	0	0
1	22996606	.	G	A	10	4	14	0	0	14	0	0
1	23072224	.	G	A	8	3	11	0	0	11	0	0
1	23072278	.	G	A	4	8	12	0	0	12	0	0
1	23072304	.	G	T	5	4	9	0	0	9	0	0
1	23072461	.	G	A	4	4	8	0	1	9	0	0
1	23072533	.	G	A	2	4	6	0	2	8	0	0
1	23072683	.	T	C	7	0	7	0	7	14	0	0
1	23072746	.	T	A	0	3	3	0	0	3	0	0
1	23094638	.	C	T	1	2	3	0	0	3	0	0
1	23094677	.	G	A	3	2	5	0	1	6	0	0
1	23110816	.	T	C	1	1	2	0	0	2	0	0
1	23188986	.	G	A	0	3	3	0	0	3	0	0
1	23243179	.	C	T	1	3	4	0	3	7	0	0
1	23243733	.	C	T	2	4	6	0	0	6	0	0
1	23254712	.	G	A	1	3	4	0	0	4	0	0
1	23261829	.	C	T	0	2	2	0	1	3	0	0
1	23261838	.	A	G	1	1	2	0	0	2	0	0
1	23265710	.	C	A	2	2	4	0	0	4	0	0
1	23265711	.	C	T	0	2	2	0	2	4	0	0
1	23271345	.	G	A	5	5	10	0	1	11	0	0
1	23271500	.	G	A	12	9	21	0	1	22	0	0
1	23271608	.	G	A	3	0	3	0	0	3	0	0
1	23271770	.	T	G	5	16	21	0	0	21	0	0
1	23274820	.	G	A	5	5	10	0	0	10	0	0
1	23275228	.	C	G	5	9	14	0	0	14	0	0
1	23277619	.	A	G	0	0	0	0	2	2	0	0
1	23283388	.	A	T	1	2	3	0	0	3	0	0
1	23283864	.	G	A	1	3	4	0	0	4	0	0
1	23283878	.	C	T	1	3	4	0	0	4	0	0
1	23284094	.	T	A	0	2	2	0	1	3	0	0
1	23284240	.	A	G	1	1	2	0	0	2	0	0
1	23291117	.	C	A	0	1	1	0	1	2	0	0
1	23297789	.	T	C	4	0	4	0	5	9	0	0
1	23298384	.	C	A	2	3	5	0	0	5	0	0
1	23298494	.	T	C	7	4	11	0	0	11	0	0
1	23298920	.	A	G	2	5	7	0	0	7	0	0
1	23308208	.	A	C	2	5	7	0	0	7	0	0
1	23321770	.	G	T	13	11	24	0	0	24	0	0
1	23322076	.	T	C	1	9	10	0	2	12	0	0
1	23322077	.	C	T	11	1	12	0	0	12	0	0
1	23322442	.	C	T	19	15	34	0	1	35	0	0
1	23322473	.	T	C	23	13	36	0	1	37	0	0
1	23322501	.	C	T	23	11	34	0	0	34	0	0
1	23322602	.	T	A	14	10	24	0	0	24	0	0
1	23322659	.	T	A	11	21	32	0	1	33	0	0
1	23322937	.	G	A	0	10	10	0	12	22	0	0
1	23323611	.	T	C	9	0	9	0	0	9	0	0
1	23330118	.	A	G	9	24	33	0	0	33	0	0
1	23332456	.	T	C	5	3	8	0	0	8	0	0
1	23332462	.	C	T	5	3	8	0	0	8	0	0
1	23337716	.	A	G	0	3	3	0	0	3	0	0
1	23506674	.	C	T	6	12	18	0	0	18	0	0
1	23506787	.	A	T	16	13	29	0	2	31	0	0
1	23508009	.	G	T	14	22	36	0	5	41	0	0
1	23515748	.	T	G	10	14	24	0	1	25	0	0
1	23521634	.	G	T	0	1	1	0	0	1	0	0
1	23522528	.	C	T	6	10	16	0	1	17	0	0
1	23526644	.	T	C	2	8	10	0	0	10	0	0
1	23528066	.	C	T	7	9	16	0	1	17	0	0
1	23530438	.	C	T	4	2	6	0	0	6	0	0
1	23535880	.	C	T	0	14	14	0	7	21	0	0
1	23536012	.	T	C	8	4	12	0	0	12	0	0
1	23536222	.	T	A	5	2	7	0	0	7	0	0
1	23569075	.	T	G	1	1	2	0	0	2	0	0
1	23573582	.	C	T	3	4	7	0	1	8	0	0
1	23573921	.	G	A	3	7	10	0	0	10	0	0
1	23574003	.	C	A	1	3	4	0	1	5	0	0
1	23574811	.	G	T	1	3	4	0	0	4	0	0
1	23574931	.	C	T	1	3	4	0	0	4	0	0
1	23578159	.	T	G	2	4	6	0	0	6	0	0
1	23578196	.	A	T	4	5	9	0	0	9	0	0
1	23578362	.	C	G	0	4	4	0	3	7	0	0
1	23578368	.	T	G	1	6	7	0	0	7	0	0
1	23578651	.	C	T	1	2	3	0	0	3	0	0
1	23579365	.	C	T	5	2	7	0	0	7	0	0
1	23579819	.	C	G	1	3	4	0	0	4	0	0
1	23580196	.	G	A	2	2	4	0	0	4	0	0
1	23580554	.	T	C	2	3	5	0	0	5	0	0
1	23581060	.	T	A	1	2	3	0	0	3	0	0
1	23581062	.	T	C	1	2	3	0	0	3	0	0
1	23581097	.	T	A	4	2	6	0	0	6	0	0
1	23581198	.	C	T	0	2	2	0	0	2	0	0
1	23585190	.	C	A	2	6	8	0	0	8	0	0
1	23585411	.	C	T	3	2	5	0	0	5	0	0
1	23586025	.	C	T	0	2	2	0	2	4	0	0
1	23589017	.	C	T	3	4	7	0	0	7	0	0
1	23902973	.	G	A	3	2	5	0	0	5	0	0
1	23909289	.	A	T	3	9	12	0	2	14	0	0
1	23909748	.	A	T	14	4	18	0	0	18	0	0
1	23920983	.	C	T	0	12	12	0	8	20	0	0
1	23921166	.	C	A	9	11	20	0	1	21	0	0
1	23921171	.	G	A	9	11	20	0	1	21	0	0
1	23921302	.	C	A	6	5	11	0	0	11	0	0
1	23921793	.	A	C	4	4	8	0	0	8	0	0
1	23943726	.	G	A	4	2	6	0	0	6	0	0
1	23945132	.	T	A	3	2	5	0	0	5	0	0
1	23947833	.	A	C	2	1	3	0	2	5	0	0
1	23947881	.	T	A	2	1	3	0	3	6	0	0
1	23975366	.	A	G	3	2	5	0	0	5	0	0
1	24076445	.	T	C	6	4	10	0	0	10	0	0
1	24077517	.	C	T	20	14	34	0	2	36	0	0
1	24077902	.	A	G	7	10	17	0	1	18	0	0
1	24197364	.	G	A	5	4	9	0	0	9	0	0
1	24197417	.	C	T	0	3	3	0	2	5	0	0
1	24356734	.	T	C	16	9	25	0	0	25	0	0
1	24513682	.	G	T	1	0	1	0	0	1	0	0
1	24513955	.	T	C	1	2	3	0	0	3	0	0
1	24520592	.	A	G	1	4	5	0	0	5	0	0
1	24520614	.	T	G	0	4	4	0	0	4	0	0
1	24520635	.	A	G	0	3	3	0	0	3	0	0
1	24520679	.	T	C	1	7	8	0	0	8	0	0
1	24520759	.	T	C	3	5	8	0	0	8	0	0
1	24520823	.	T	C	2	4	6	0	0	6	0	0
1	24521032	.	C	T	0	2	2	0	0	2	0	0
1	24523410	.	C	T	0	1	1	0	0	1	0	0
1	24523415	.	T	C	0	1	1	0	0	1	0	0
1	24540619	.	C	T	0	2	2	0	0	2	0	0
1	24540785	.	A	G	1	1	2	0	0	2	0	0
1	24540959	.	A	G	0	1	1	0	0	1	0	0
1	24552293	.	A	G	0	2	2	0	0	2	0	0
1	24557474	.	A	G	3	1	4	0	4	8	0	0
1	24557510	.	G	A	3	3	6	0	1	7	0	0
1	24557605	.	A	G	3	2	5	0	0	5	0	0
1	24557865	.	A	G	3	13	16	0	1	17	0	0
1	24558375	.	G	A	1	3	4	0	0	4	0	0
1	24871075	.	A	G	9	11	20	0	0	20	0	0
1	24871079	.	A	G	8	11	19	0	2	21	0	0
1	24879994	.	C	T	4	8	12	0	0	12	0	0
1	24902745	.	T	C	7	0	7	0	3	10	0	0
1	24902778	.	T	C	3	0	3	0	3	6	0	0
1	24908001	.	T	C	5	0	5	0	4	9	0	0
1	25024435	.	G	A	2	4	6	0	0	6	0	0
1	25144229	.	C	T	1	2	3	0	0	3	0	0
1	25313482	.	T	A	14	17	31	0	1	32	0	0
1	25322572	.	T	A	2	4	6	0	0	6	0	0
1	25322892	.	G	A	3	3	6	0	0	6	0	0
1	25322961	.	A	G	2	9	11	0	0	11	0	0
1	25322982	.	G	A	1	7	8	0	0	8	0	0
1	25327222	.	G	A	2	4	6	0	1	7	0	0
1	25327231	.	A	G	2	4	6	0	0	6	0	0
1	25331494	.	C	T	1	2	3	0	0	3	0	0
1	25399528	.	A	C	5	9	14	0	0	14	0	0
1	25399556	.	G	A	4	8	12	0	0	12	0	0
1	25399574	.	G	A	5	3	8	0	1	9	0	0
1	25400017	.	A	G	9	6	15	0	0	15	0	0
1	25400032	.	C	T	0	6	6	0	10	16	0	0
1	25400342	.	G	T	4	2	6	0	0	6	0	0
1	25401158	.	T	C	3	1	4	0	4	8	0	0
1	25401290	.	T	A	2	4	6	0	0	6	0	0
1	25401756	.	A	G	7	3	10	0	1	11	0	0
1	25401819	.	A	G	8	5	13	0	0	13	0	0
1	25401984	.	T	C	6	6	12	0	0	12	0	0
1	25402044	.	T	A	4	3	7	0	0	7	0	0
1	25402695	.	C	T	2	2	4	0	1	5	0	0
1	25403244	.	G	C	2	2	4	0	0	4	0	0
1	25403289	.	T	C	2	2	4	0	0	4	0	0
1	25419936	.	A	G	3	4	7	0	0	7	0	0
1	25443085	.	G	A	1	3	4	0	0	4	0	0
1	25491522	.	G	A	2	2	4	0	0	4	0	0
1	25666109	.	C	T	1	1	2	0	1	3	0	0
1	25666368	.	T	C	3	2	5	0	0	5	0	0
1	25666412	.	A	C	2	2	4	0	0	4	0	0
1	25741901	.	A	G	0	6	6	0	0	6	0	0
1	25742951	.	C	T	1	4	5	0	0	5	0	0
1	25863511	.	G	A	8	11	19	0	1	20	0	0
1	25863530	.	G	A	11	9	20	0	0	20	0	0
1	25911654	.	T	A	2	2	4	0	0	4	0	0
1	25918405	.	C	T	3	3	6	0	0	6	0	0
1	26044934	.	G	T	5	2	7	0	1	8	0	0
1	26046323	.	A	G	5	4	9	0	0	9	0	0
1	26046996	.	A	T	13	13	26	0	0	26	0	0
1	26063007	.	G	T	1	3	4	0	0	4	0	0
1	26063030	.	G	A	2	4	6	0	1	7	0	0
1	26095431	.	G	T	3	5	8	0	0	8	0	0
1	26096270	.	C	T	3	5	8	0	0	8	0	0
1	26096318	.	A	T	7	4	11	1	0	12	0	0
1	26096488	.	G	C	11	6	17	0	0	17	0	0
1	26096522	.	G	T	9	10	19	0	0	19	0	0
1	26106888	.	G	A	2	2	4	0	0	4	0	0
1	26127339	.	A	G	3	3	6	0	1	7	0	0
1	26252033	.	C	T	0	6	6	0	12	18	0	0
1	26252153	.	A	T	6	3	9	0	0	10	1	0
1	26252323	.	A	T	2	3	5	0	2	7	0	0
1	26252371	.	G	A	5	2	7	0	1	8	0	0
1	26252477	.	G	A	5	9	14	0	0	14	0	0
1	26252598	.	T	C	2	2	4	0	0	4	0	0
1	26252798	.	G	C	7	0	7	0	6	13	0	0
1	26252814	.	C	T	10	5	15	0	0	15	0	0
1	26293167	.	C	T	0	3	3	0	3	6	0	0
1	26374612	.	A	T	1	2	3	0	0	3	0	0
1	26374638	.	A	G	3	0	3	0	3	6	0	0
1	26375218	.	C	T	3	5	8	0	0	8	0	0
1	26375404	.	C	A	1	4	5	0	1	6	0	0
1	26375497	.	G	T	6	4	10	0	0	10	0	0
1	26375733	.	G	A	0	5	5	0	3	8	0	0
1	26376176	.	G	A	7	3	10	0	0	10	0	0
1	26376327	.	C	T	3	2	5	0	0	5	0	0
1	26376816	.	A	T	5	5	10	0	0	10	0	0
1	26377593	.	G	A	3	5	8	0	0	8	0	0
1	26382809	.	A	T	11	14	25	0	2	27	0	0
1	26382852	.	C	T	9	8	17	0	2	19	0	0
1	26382853	.	C	T	8	8	16	0	3	19	0	0
1	26383466	.	G	A	4	9	13	0	0	13	0	0
1	26384629	.	C	T	5	2	7	0	0	7	0	0
1	26384638	.	G	A	5	3	8	0	0	8	0	0
1	26384682	.	G	A	4	4	8	0	0	8	0	0
1	26384774	.	C	T	3	8	11	0	0	11	0	0
1	26385006	.	G	T	4	4	8	0	2	10	0	0
1	26385225	.	A	G	14	5	19	0	2	21	0	0
1	26391649	.	C	T	0	9	9	0	4	13	0	0
1	26438684	.	C	T	2	2	4	0	0	4	0	0
1	26438749	.	G	T	3	2	5	0	0	5	0	0
1	26438894	.	C	T	0	11	11	0	6	17	0	0
1	26438909	.	A	G	5	12	17	0	0	17	0	0
1	26439131	.	T	C	10	0	10	0	8	18	0	0
1	26439176	.	T	C	8	7	15	0	0	15	0	0
1	26443115	.	T	C	4	0	4	0	4	8	0	0
1	26453698	.	C	G	6	4	10	0	1	11	0	0
1	26454576	.	G	C	1	3	4	0	0	4	0	0
1	26463208	.	C	G	15	7	22	0	2	24	0	0
1	26463263	.	G	A	0	11	11	0	11	22	0	0
1	26463552	.	A	G	2	0	2	0	15	17	0	0
1	26463671	.	T	A	10	10	20	0	0	20	0	0
1	26463779	.	T	A	7	3	10	0	0	10	0	0
1	26463931	.	A	T	7	9	16	0	2	18	0	0
1	26464353	.	A	G	14	17	31	0	0	31	0	0
1	26464758	.	T	A	12	14	26	0	0	26	0	0
1	26465041	.	G	T	13	10	23	0	0	23	0	0
1	26465218	.	G	T	1	8	9	0	13	22	0	0
1	26465224	.	T	A	12	8	20	0	2	22	0	0
1	26467953	.	A	C	0	1	1	0	0	1	0	0
1	26504998	.	G	A	7	4	11	0	0	11	0	0
1	26505282	.	T	C	15	8	23	0	1	24	0	0
1	26505291	.	C	T	17	7	24	0	0	24	0	0
1	26507270	.	A	C	9	16	25	0	1	26	0	0
1	26507392	.	T	A	10	9	19	0	0	19	0	0
1	26507764	.	A	G	9	1	10	0	15	25	0	0
1	26638053	.	G	C	1	2	3	0	0	3	0	0
1	26654154	.	A	T	2	1	3	0	1	4	0	0
1	26654167	.	T	A	1	2	3	0	0	3	0	0
1	26660660	.	C	T	0	21	21	0	13	34	0	0
1	26661084	.	G	A	0	2	2	0	0	2	0	0
1	26661516	.	G	A	20	12	32	0	0	32	0	0
1	26663204	.	C	T	0	4	4	0	0	4	0	0
1	26671025	.	T	C	3	2	5	0	0	5	0	0
1	26671875	.	G	A	2	2	4	0	0	4	0	0
1	26671894	.	T	A	2	2	4	0	0	4	0	0
1	26673433	.	C	T	1	2	3	0	1	4	0	0
1	26740966	.	T	C	29	22	51	0	0	51	0	0
1	26741410	.	C	T	28	24	52	0	0	52	0	0
1	26827449	.	T	C	3	3	6	0	0	6	0	0
1	26827464	.	G	A	3	3	6	0	0	6	0	0
1	27208553	.	T	A	5	5	10	0	1	11	0	0
1	27210231	.	C	T	8	6	14	0	0	14	0	0
1	27211573	.	G	A	2	2	4	0	0	4	0	0
1	27809198	.	T	A	5	5	10	0	0	10	0	0
1	27809381	.	C	T	1	3	4	0	0	4	0	0
1	27826090	.	C	A	5	2	7	0	0	7	0	0
1	27826198	.	C	T	7	7	14	0	0	14	0	0
1	27826651	.	T	C	14	12	26	0	1	27	0	0
1	27868306	.	T	C	1	2	3	0	0	3	0	0
1	27893139	.	C	A	4	8	12	0	0	12	0	0
1	27893237	.	C	A	3	2	5	0	0	5	0	0
1	27995605	.	C	T	1	5	6	0	1	7	0	0
1	28018806	.	C	T	16	16	32	0	1	33	0	0
1	28018821	.	C	T	13	13	26	0	0	26	0	0
1	28036159	.	A	C	4	3	7	0	0	7	0	0
1	28067976	.	T	A	7	3	10	0	1	11	0	0
1	28081318	.	C	T	5	2	7	0	0	7	0	0
1	28089545	.	G	A	3	3	6	0	1	7	0	0
1	28428603	.	A	G	3	5	8	0	0	8	0	0
1	28788272	.	G	A	3	1	4	0	0	4	0	0
1	28834052	.	T	A	4	2	6	0	0	6	0	0
1	28834209	.	A	T	3	6	9	0	0	9	0	0
1	28834898	.	C	A	1	2	3	0	0	3	0	0
1	28860619	.	G	A	9	12	21	0	1	22	0	0
1	28929621	.	C	T	1	3	4	0	0	4	0	0
1	28961846	.	C	T	46	16	62	0	3	65	0	0
1	28962501	.	C	T	2	18	20	0	32	52	0	0
1	28962545	.	A	G	27	12	39	0	2	41	0	0
1	28962598	.	C	T	21	26	47	0	0	47	0	0
1	28962966	.	G	A	12	5	17	0	0	17	0	0
1	28965095	.	G	A	2	7	9	0	0	9	0	0
1	28979080	.	A	C	0	1	1	0	0	1	0	0
1	28979161	.	G	C	9	0	9	0	18	27	0	0
1	28986532	.	G	A	11	10	21	0	0	21	0	0
1	29058823	.	G	A	3	2	5	0	0	5	0	0
1	29162589	.	A	G	10	8	18	0	0	18	0	0
1	29162674	.	G	A	0	2	2	0	4	6	0	0
1	29163687	.	G	A	4	5	9	0	0	9	0	0
1	29163737	.	C	T	3	5	8	0	0	8	0	0
1	29163941	.	G	T	3	6	9	0	0	9	0	0
1	29184190	.	A	G	2	2	4	0	0	4	0	0
1	29184205	.	A	G	1	2	3	0	0	3	0	0
1	29184298	.	C	T	1	3	4	0	0	4	0	0
1	29211895	.	T	A	3	3	6	0	0	6	0	0
1	29212165	.	T	C	1	3	4	0	0	4	0	0
1	29212341	.	G	A	4	6	10	0	1	11	0	0
1	29213107	.	A	G	7	0	7	0	6	13	0	0
1	29213227	.	G	A	0	3	3	0	9	12	0	0
1	29213902	.	C	T	5	3	8	0	0	8	0	0
1	29227770	.	C	T	6	8	14	0	0	14	0	0
1	29227880	.	G	T	2	4	6	0	0	6	0	0
1	29228261	.	A	G	4	2	6	0	7	13	0	0
1	29281974	.	C	G	3	2	5	0	0	5	0	0
1	29389601	.	C	T	3	1	4	0	0	4	0	0
1	29389987	.	C	T	6	7	13	0	0	13	0	0
1	29390999	.	G	T	4	3	7	0	0	7	0	0
1	29608585	.	T	C	1	4	5	0	0	5	0	0
1	29608704	.	G	T	2	2	4	0	0	4	0	0
1	29732217	.	C	T	2	4	6	0	0	6	0	0
1	29737972	.	A	C	1	2	3	0	0	3	0	0
1	29738496	.	T	C	2	5	7	0	0	7	0	0
1	29739670	.	T	A	5	6	11	0	0	11	0	0
1	29740954	.	G	C	8	7	15	0	3	18	0	0
1	29741054	.	C	T	7	11	18	0	0	18	0	0
1	29741193	.	T	A	15	7	22	0	1	23	0	0
1	29741407	.	A	C	9	8	17	0	3	20	0	0
1	29741447	.	C	T	9	9	18	0	4	22	0	0
1	29741952	.	C	T	12	11	23	0	1	24	0	0
1	29741967	.	A	G	12	12	24	0	3	27	0	0
1	29742036	.	C	T	14	14	28	0	2	30	0	0
1	29742368	.	T	C	8	4	12	0	0	12	0	0
1	29742487	.	T	C	4	5	9	0	0	9	0	0
1	29742644	.	T	A	3	2	5	0	0	5	0	0
1	29742697	.	T	C	5	3	8	0	0	8	0	0
1	29742791	.	A	T	6	10	16	0	1	17	0	0
1	29742796	.	A	G	8	0	8	0	11	19	0	0
1	29743087	.	G	A	17	7	24	0	1	25	0	0
1	29743165	.	A	G	8	12	20	0	0	20	0	0
1	29743178	.	T	C	6	11	17	0	2	19	0	0
1	29743281	.	T	C	13	16	29	0	0	29	0	0
1	29743423	.	T	G	17	11	28	0	1	29	0	0
1	29743505	.	A	G	6	6	12	0	0	12	0	0
1	29743878	.	G	A	1	3	4	0	0	4	0	0
1	29754963	.	G	A	4	2	6	0	0	6	0	0
1	29754981	.	A	G	3	2	5	0	0	5	0	0
1	29770748	.	A	C	1	3	4	0	0	4	0	0
1	29772391	.	A	G	3	2	5	0	0	5	0	0
1	29772615	.	T	C	1	0	1	0	0	1	0	0
1	29772741	.	C	T	2	1	3	0	0	3	0	0
1	29772751	.	G	T	0	1	1	0	0	1	0	0
1	29781597	.	A	T	4	4	8	0	0	8	0	0
1	29786407	.	G	C	0	6	6	0	3	9	0	0
1	29786570	.	G	A	5	11	16	0	0	16	0	0
1	29786659	.	T	G	6	0	6	0	6	12	0	0
1	29786704	.	A	G	8	3	11	0	1	12	0	0
1	29787262	.	T	C	13	15	28	0	0	28	0	0
1	29787397	.	G	A	5	6	11	0	1	12	0	0
1	29789889	.	C	T	9	9	18	0	1	19	0	0
1	29797344	.	G	T	10	13	23	0	0	23	0	0
1	29797345	.	A	T	10	12	22	0	1	23	0	0
1	29797674	.	G	A	8	4	12	0	0	12	0	0
1	29797699	.	T	G	2	6	8	0	0	8	0	0
1	29798262	.	T	C	5	5	10	0	0	10	0	0
1	29798324	.	G	T	1	4	5	0	0	5	0	0
1	29798340	.	G	A	0	4	4	0	1	5	0	0
1	29806547	.	C	T	2	4	6	0	0	6	0	0
1	29823604	.	G	A	0	19	19	0	11	30	0	0
1	29823690	.	T	A	24	19	43	0	1	45	1	0
1	29860326	.	T	A	6	2	8	0	0	8	0	0
1	29891937	.	C	T	0	1	1	0	0	1	0	0
1	29896769	.	A	C	0	2	2	0	0	2	0	0
1	29916178	.	G	A	4	4	8	0	1	9	0	0
1	29952918	.	A	T	6	4	10	0	0	10	0	0
1	29953069	.	G	A	7	7	14	0	1	15	0	0
1	29953239	.	G	T	0	7	7	0	8	16	1	0
1	29953253	.	A	G	8	0	8	0	11	19	0	0
1	29954795	.	A	C	4	7	11	0	0	11	0	0
1	29954844	.	T	C	7	11	18	0	0	19	1	0
1	29954972	.	C	T	6	12	18	0	0	18	0	0
1	29955006	.	G	A	8	13	21	0	1	22	0	0
1	29955171	.	G	A	13	10	23	0	0	23	0	0
1	29955179	.	A	G	11	10	21	0	2	23	0	0
1	29955228	.	C	T	3	8	11	0	0	11	0	0
1	29955249	.	A	G	2	1	3	0	0	3	0	0
1	30038844	.	A	C	3	4	7	0	0	7	0	0
1	30039302	.	T	A	5	2	7	0	0	7	0	0
1	30103483	.	C	A	1	0	1	0	0	1	0	0
1	30183309	.	C	G	2	2	4	0	0	4	0	0
1	30212461	.	G	A	5	2	7	0	0	7	0	0
1	30212793	.	G	A	1	2	3	0	0	3	0	0
1	30250557	.	T	C	4	5	9	0	0	9	0	0
1	30255365	.	G	A	9	8	17	0	0	17	0	0
1	30255458	.	A	C	3	4	7	0	0	7	0	0
1	30282841	.	G	T	3	0	3	0	0	3	0	0
1	30343802	.	A	T	1	2	3	0	0	3	0	0
1	30343967	.	T	G	16	13	29	0	0	29	0	0
1	30344842	.	A	G	12	5	17	0	0	17	0	0
1	30345026	.	T	C	3	3	6	0	2	8	0	0
1	30345029	.	C	T	6	3	9	0	0	9	0	0
1	30345075	.	G	T	10	4	14	0	0	14	0	0
1	30345131	.	C	T	0	5	5	0	8	13	0	0
1	30345239	.	G	C	11	9	20	0	0	20	0	0
1	30345243	.	T	C	10	10	20	0	0	20	0	0
1	30345485	.	A	C	0	2	2	0	0	2	0	0
1	30345531	.	A	G	6	7	13	0	1	14	0	0
1	30345635	.	T	G	5	10	15	0	2	17	0	0
1	30345669	.	T	G	13	4	17	0	0	17	0	0
1	30346042	.	G	A	8	7	15	0	0	15	0	0
1	30346112	.	T	C	12	5	17	0	0	17	0	0
1	30346233	.	G	A	6	4	10	0	0	10	0	0
1	30346377	.	G	A	2	4	6	0	0	6	0	0
1	30346385	.	G	A	4	2	6	0	0	6	0	0
1	30346432	.	T	G	3	4	7	0	0	7	0	0
1	30346456	.	G	A	3	3	6	0	0	6	0	0
1	30346624	.	G	T	3	5	8	0	0	8	0	0
1	30346845	.	G	T	9	6	15	0	0	15	0	0
1	30346906	.	C	A	5	9	14	0	0	14	0	0
1	30346977	.	C	A	7	5	12	0	2	15	1	0
1	30347027	.	C	A	10	8	18	0	0	18	0	0
1	30347043	.	T	C	10	0	10	0	10	20	0	0
1	30347586	.	C	T	8	4	12	0	0	12	0	0
1	30366732	.	G	A	3	4	7	0	0	7	0	0
1	30366754	.	G	A	2	2	4	0	2	6	0	0
1	30366800	.	T	A	6	3	9	0	0	9	0	0
1	30441057	.	G	A	5	2	7	0	0	7	0	0
1	30453617	.	A	G	0	1	1	0	0	1	0	0
1	30540535	.	C	T	4	6	10	0	0	10	0	0
1	30641038	.	T	C	0	3	3	0	0	3	0	0
1	30688453	.	G	A	3	6	9	0	0	9	0	0
1	30688802	.	G	A	2	2	4	0	0	4	0	0
1	30688901	.	G	A	2	2	4	0	0	4	0	0
1	30688924	.	G	T	2	2	4	0	0	4	0	0
1	30718394	.	T	C	1	0	1	0	2	3	0	0
1	30718463	.	T	A	1	3	4	0	0	4	0	0
1	30718538	.	C	G	8	10	18	0	0	18	0	0
1	30718567	.	A	C	2	0	2	0	7	9	0	0
1	30736716	.	G	T	1	3	4	0	0	4	0	0
1	30955972	.	C	A	2	5	7	0	0	7	0	0
1	31061337	.	G	T	1	1	2	0	0	2	0	0
1	31063836	.	T	C	1	2	3	0	1	4	0	0
1	31064519	.	G	A	1	2	3	0	0	3	0	0
1	31072098	.	T	C	2	2	4	0	1	5	0	0
1	31072348	.	A	C	7	8	15	0	0	15	0	0
1	31072589	.	C	T	0	4	4	0	0	4	0	0
1	31072843	.	C	T	4	3	7	0	0	7	0	0
1	31072863	.	A	G	2	4	6	0	0	6	0	0
1	31075158	.	C	T	0	1	1	0	2	3	0	0
1	31083169	.	C	T	0	0	0	0	1	1	0	0
1	31083271	.	G	A	5	3	8	0	0	8	0	0
1	31088744	.	C	T	1	1	2	0	0	2	0	0
1	31103376	.	G	A	1	2	3	0	0	3	0	0
1	31103427	.	C	A	0	2	2	0	1	3	0	0
1	31103584	.	A	T	1	3	4	0	0	4	0	0
1	31112466	.	G	C	4	4	8	0	0	8	0	0
1	31112468	.	G	A	4	4	8	0	0	8	0	0
1	31117686	.	G	A	24	10	34	0	6	40	0	0
1	31117695	.	T	C	23	11	34	0	2	36	0	0
1	31119296	.	C	T	15	23	38	0	2	40	0	0
1	31122596	.	G	A	28	23	51	0	2	53	0	0
1	31130005	.	T	C	26	18	44	0	1	45	0	0
1	31130028	.	T	C	21	21	42	0	2	44	0	0
1	31130094	.	G	A	4	21	25	0	19	44	0	0
1	31130176	.	T	C	2	8	10	0	2	12	0	0
1	31136018	.	G	A	6	3	9	0	1	10	0	0
1	31136477	.	A	G	7	8	15	0	0	15	0	0
1	31374780	.	A	T	12	7	19	0	1	20	0	0
1	31386255	.	T	C	8	6	14	0	0	14	0	0
1	31423014	.	C	T	1	5	6	0	10	16	0	0
1	31423099	.	G	T	0	1	1	0	0	1	0	0
1	31428150	.	G	A	4	6	10	0	1	11	0	0
1	31430665	.	A	G	2	0	2	0	0	2	0	0
1	31445770	.	A	G	2	6	8	0	0	8	0	0
1	31445874	.	T	A	2	4	6	0	1	7	0	0
1	31472033	.	A	G	5	4	9	0	1	10	0	0
1	31515684	.	G	T	1	3	4	0	0	4	0	0
1	31657604	.	T	C	1	1	2	0	0	2	0	0
1	31660952	.	A	G	1	0	1	0	2	3	0	0
1	31661165	.	T	C	3	5	8	0	1	9	0	0
1	31664892	.	C	T	1	2	3	0	0	3	0	0
1	31671721	.	C	T	4	2	6	0	0	6	0	0
1	31671746	.	C	A	4	5	9	0	0	9	0	0
1	31671958	.	G	A	1	4	5	0	6	11	0	0
1	31672078	.	G	A	2	2	4	0	0	4	0	0
1	31793920	.	A	G	3	0	3	0	2	5	0	0
1	31793998	.	A	G	1	1	2	0	1	3	0	0
1	31797386	.	A	G	1	5	6	0	0	6	0	0
1	31797459	.	G	A	2	4	6	0	2	8	0	0
1	31797503	.	G	A	0	6	6	0	1	7	0	0
1	31797533	.	C	T	6	2	8	0	0	8	0	0
1	31797597	.	G	A	2	4	6	0	1	7	0	0
1	31797955	.	T	C	1	2	3	0	0	3	0	0
1	31798507	.	C	A	1	5	6	0	0	6	0	0
1	31798755	.	A	T	1	1	2	0	0	2	0	0
1	31798794	.	T	C	1	1	2	0	0	2	0	0
1	31798821	.	C	T	3	3	6	0	0	6	0	0
1	31798974	.	G	C	3	6	9	0	2	11	0	0
1	31798980	.	C	T	4	5	9	0	2	11	0	0
1	31799112	.	C	A	2	4	6	0	0	6	0	0
1	31799313	.	A	G	1	2	3	0	0	3	0	0
1	31809184	.	A	T	2	4	6	0	0	6	0	0
1	31809302	.	G	A	5	11	16	0	0	16	0	0
1	31809332	.	G	A	6	9	15	0	0	15	0	0
1	31809496	.	G	A	7	10	17	0	1	18	0	0
1	31813229	.	A	G	2	3	5	0	0	5	0	0
1	31813283	.	A	G	7	11	18	0	0	18	0	0
1	31813355	.	T	C	1	3	4	0	0	4	0	0
1	31818237	.	G	A	3	4	7	0	0	7	0	0
1	31865172	.	G	A	4	7	11	0	1	12	0	0
1	31865387	.	G	A	11	6	17	0	0	17	0	0
1	31866684	.	G	A	3	3	6	0	1	7	0	0
1	31867264	.	T	A	16	11	27	0	0	27	0	0
1	31867314	.	C	T	18	8	26	0	0	26	0	0
1	31867449	.	C	T	6	12	18	0	2	20	0	0
1	31867589	.	G	A	6	3	9	0	2	11	0	0
1	31943042	.	T	G	2	0	2	0	3	5	0	0
1	33332101	.	G	A	0	2	2	0	0	2	0	0
1	33355834	.	T	G	1	2	3	0	0	3	0	0
1	33355989	.	C	T	2	3	5	0	0	5	0	0
1	33356289	.	A	T	1	2	3	0	0	3	0	0
1	33356398	.	T	C	2	2	4	0	0	4	0	0
1	33356430	.	A	G	3	2	5	0	1	6	0	0
1	33384062	.	G	A	3	6	9	0	0	9	0	0
1	33449334	.	C	A	0	3	3	0	0	3	0	0
1	33457733	.	C	T	6	10	16	0	0	16	0	0
1	33484129	.	C	G	8	12	20	0	0	20	0	0
1	33484288	.	T	C	17	6	23	0	0	23	0	0
1	33484293	.	C	A	15	6	21	0	1	22	0	0
1	33484404	.	C	T	12	9	21	0	0	21	0	0
1	33484652	.	T	C	12	15	27	0	0	27	0	0
1	33485692	.	A	G	7	0	7	0	10	17	0	0
1	33548262	.	A	T	2	2	4	0	1	5	0	0
1	33556056	.	G	A	3	6	9	0	2	12	1	0
1	33561520	.	A	G	3	0	3	0	2	5	0	0
1	33561544	.	C	T	8	4	12	0	0	12	0	0
1	33568153	.	A	T	5	16	21	0	0	22	1	0
1	33568211	.	A	G	8	0	8	0	9	17	0	0
1	33568260	.	A	C	8	5	13	0	1	14	0	0
1	33568266	.	G	A	5	7	12	0	0	12	0	0
1	33568303	.	G	A	0	3	3	0	4	7	0	0
1	33568454	.	G	T	9	9	18	0	0	18	0	0
1	33568520	.	G	A	11	8	19	0	0	19	0	0
1	33568836	.	T	G	0	23	23	0	3	26	0	0
1	33568976	.	G	T	0	15	15	0	14	30	1	0
1	33634380	.	G	T	1	2	3	0	0	3	0	0
1	33656317	.	A	T	3	3	6	0	0	6	0	0
1	33656831	.	G	A	7	4	11	0	0	11	0	0
1	33656900	.	T	G	4	3	7	0	0	7	0	0
1	33657793	.	A	G	3	3	6	0	0	6	0	0
1	33658065	.	T	G	2	4	6	0	0	6	0	0
1	33658945	.	C	T	4	5	9	0	1	10	0	0
1	33658971	.	C	T	7	3	10	0	0	10	0	0
1	33659374	.	C	T	2	0	2	0	0	2	0	0
1	33686477	.	G	A	5	4	9	0	0	9	0	0
1	33686513	.	G	T	11	6	17	0	2	19	0	0
1	33687177	.	A	T	12	4	16	0	0	16	0	0
1	33694327	.	C	T	9	13	22	0	0	22	0	0
1	33694357	.	T	A	11	12	23	0	0	23	0	0
1	33694517	.	T	A	4	9	13	0	0	13	0	0
1	33694573	.	T	C	3	5	8	0	2	10	0	0
1	33701368	.	C	T	0	2	2	0	0	2	0	0
1	33701445	.	C	T	2	2	4	0	0	4	0	0
1	33969170	.	C	G	6	3	9	0	0	9	0	0
1	33969389	.	A	T	3	2	5	0	0	5	0	0
1	34134691	.	G	A	0	7	7	0	5	12	0	0
1	34137711	.	T	C	11	4	15	0	0	15	0	0
1	34137741	.	T	C	4	2	6	0	0	6	0	0
1	34137768	.	A	C	0	1	1	0	0	1	0	0
1	34176504	.	C	T	5	7	12	0	0	12	0	0
1	34176808	.	A	T	2	1	3	0	0	3	0	0
1	34182333	.	C	T	2	2	4	0	0	4	0	0
1	34199906	.	G	T	18	12	30	0	5	35	0	0
1	34199913	.	C	T	21	19	40	0	1	41	0	0
1	34232407	.	A	G	5	9	14	0	0	14	0	0
1	34232744	.	T	A	8	18	26	0	1	27	0	0
1	34232761	.	A	G	6	17	23	0	2	25	0	0
1	34232879	.	T	C	9	12	21	0	0	21	0	0
1	34232929	.	C	T	12	6	18	0	2	20	0	0
1	34232931	.	G	A	12	6	18	0	2	20	0	0
1	34233096	.	C	A	16	10	26	0	0	26	0	0
1	34233145	.	G	T	8	10	18	0	0	18	0	0
1	34233198	.	C	A	7	6	13	0	0	13	0	0
1	34233238	.	A	G	12	5	17	0	0	17	0	0
1	34233301	.	A	G	16	0	16	0	14	30	0	0
1	34233312	.	A	G	19	9	28	0	2	30	0	0
1	34233548	.	T	G	5	3	8	0	0	8	0	0
1	34258971	.	C	T	6	3	9	0	0	9	0	0
1	34259098	.	C	A	4	3	7	0	1	8	0	0
1	34259452	.	T	A	7	3	10	0	0	10	0	0
1	34259863	.	T	G	4	7	11	0	2	13	0	0
1	34260012	.	G	C	5	3	8	0	1	9	0	0
1	34260887	.	A	T	5	7	12	0	0	12	0	0
1	34260914	.	C	T	5	5	10	0	0	10	0	0
1	34261230	.	A	T	12	12	24	0	0	24	0	0
1	34261358	.	A	G	19	0	19	0	16	35	0	0
1	34261393	.	G	A	0	11	11	0	10	21	0	0
1	34261654	.	T	C	6	5	11	0	0	11	0	0
1	34296606	.	A	T	9	8	17	0	1	18	0	0
1	34297112	.	C	A	6	10	16	0	1	17	0	0
1	34297135	.	C	T	12	10	22	0	0	22	0	0
1	34540552	.	C	G	3	0	3	0	3	6	0	0
1	34540564	.	G	A	0	2	2	0	5	7	0	0
1	34540606	.	G	A	1	3	4	0	0	4	0	0
1	34540714	.	G	A	1	4	5	0	4	9	0	0
1	34540750	.	G	T	2	4	6	0	0	6	0	0
1	34555559	.	C	T	4	5	9	0	1	10	0	0
1	34556241	.	A	C	2	5	7	0	2	9	0	0
1	34556298	.	G	A	0	6	6	0	3	9	0	0
1	34556301	.	G	T	0	7	7	0	3	10	0	0
1	34597348	.	T	G	2	2	4	0	0	4	0	0
1	34617680	.	C	A	2	1	3	0	0	3	0	0
1	34685529	.	C	G	6	3	9	0	0	9	0	0
1	34685603	.	A	G	2	1	3	0	0	3	0	0
1	34688988	.	C	T	10	4	14	0	0	14	0	0
1	34689001	.	T	C	10	5	15	0	0	15	0	0
1	34693831	.	C	T	9	2	11	0	0	11	0	0
1	34694026	.	G	A	3	2	5	0	0	5	0	0
1	34694266	.	G	A	2	2	4	0	0	4	0	0
1	34695423	.	G	A	7	12	19	0	0	19	0	0
1	34695476	.	G	A	9	13	22	0	0	22	0	0
1	34696017	.	G	A	2	1	3	0	1	4	0	0
1	34703048	.	T	A	3	1	4	0	1	5	0	0
1	34703272	.	A	G	4	3	7	0	1	8	0	0
1	34706526	.	G	A	11	5	16	0	1	17	0	0
1	34707958	.	T	C	12	10	22	0	4	26	0	0
1	34708145	.	C	T	4	22	26	0	27	53	0	0
1	34712097	.	A	G	3	2	5	0	0	5	0	0
1	35232521	.	A	C	2	7	9	0	0	9	0	0
1	35232834	.	C	A	4	3	7	0	1	8	0	0
1	35476118	.	G	T	1	2	3	0	0	3	0	0
1	35484358	.	C	T	5	6	11	0	0	11	0	0
1	35484931	.	T	C	5	4	9	0	0	9	0	0
1	35484977	.	A	T	4	3	7	0	0	7	0	0
1	35485056	.	G	A	6	5	11	0	0	11	0	0
1	35485105	.	G	A	0	6	6	0	4	10	0	0
1	35485175	.	A	C	9	3	12	0	1	13	0	0
1	35485263	.	C	A	4	4	8	0	1	9	0	0
1	35485289	.	C	T	6	2	8	0	0	8	0	0
1	35485378	.	C	T	6	5	11	0	0	11	0	0
1	35488211	.	A	T	7	8	15	0	0	15	0	0
1	35488332	.	G	A	2	3	5	0	0	5	0	0
1	35586563	.	C	T	0	1	1	0	0	1	0	0
1	35586579	.	C	A	0	1	1	0	0	1	0	0
1	35597542	.	A	G	1	1	2	0	0	2	0	0
1	35608041	.	G	A	1	5	6	0	5	11	0	0
1	35608405	.	G	A	0	3	3	0	4	7	0	0
1	35608619	.	T	C	1	4	5	0	0	5	0	0
1	35608821	.	G	A	1	4	5	0	0	5	0	0
1	35608826	.	G	T	1	3	4	0	0	4	0	0
1	35608941	.	A	C	3	4	7	0	0	7	0	0
1	35609192	.	A	G	5	9	14	0	1	15	0	0
1	35609431	.	T	C	3	5	8	0	2	10	0	0
1	35609474	.	G	A	5	2	7	0	1	8	0	0
1	35810172	.	C	A	1	4	5	0	0	5	0	0
1	35811854	.	C	T	1	5	6	0	0	6	0	0
1	35812128	.	T	C	4	6	10	0	0	10	0	0
1	35812155	.	T	C	2	3	5	0	0	5	0	0
1	35815706	.	A	C	1	2	3	0	0	3	0	0
1	35834307	.	T	A	2	5	7	0	0	7	0	0
1	35834554	.	G	T	6	4	10	0	0	10	0	0
1	35835125	.	T	G	5	0	5	0	5	10	0	0
1	35835237	.	G	A	0	13	13	0	8	21	0	0
1	35835371	.	A	C	10	19	29	0	1	30	0	0
1	35835502	.	C	T	11	13	24	0	2	26	0	0
1	35897407	.	G	C	2	3	5	0	0	5	0	0
1	35897408	.	C	T	2	3	5	0	0	5	0	0
1	35897622	.	T	A	5	2	7	0	0	7	0	0
1	35897623	.	G	A	5	2	7	0	0	7	0	0
1	35898075	.	G	A	3	3	6	0	0	6	0	0
1	35949965	.	T	C	1	6	7	0	0	7	0	0
1	35949969	.	C	A	1	6	7	0	0	7	0	0
1	35950082	.	T	G	2	8	10	0	0	10	0	0
1	35950100	.	T	G	3	7	10	0	0	10	0	0
1	35956508	.	C	G	3	3	6	0	0	6	0	0
1	35956549	.	C	T	4	4	8	0	1	9	0	0
1	35959826	.	T	C	3	1	4	0	0	4	0	0
1	35963306	.	G	A	0	1	1	0	3	4	0	0
1	35963822	.	C	T	6	4	10	0	2	12	0	0
1	35969836	.	G	C	11	13	24	0	0	24	0	0
1	35969878	.	C	T	18	11	29	0	0	29	0	0
1	35970118	.	C	G	1	3	4	0	0	4	0	0
1	36018610	.	T	A	7	9	16	0	1	17	0	0
1	36018817	.	T	C	12	1	13	0	9	22	0	0
1	36019227	.	C	T	10	9	19	0	1	20	0	0
1	36019361	.	T	C	17	1	18	0	13	31	0	0
1	36019416	.	G	T	13	12	25	0	1	26	0	0
1	36020092	.	A	T	7	5	12	0	1	13	0	0
1	36020097	.	A	C	6	5	11	0	0	11	0	0
1	36020154	.	T	C	3	5	8	0	0	8	0	0
1	36020492	.	T	G	7	8	15	0	3	18	0	0
1	36020642	.	T	A	8	7	15	0	0	15	0	0
1	36021110	.	G	A	7	6	13	0	0	13	0	0
1	36021158	.	C	G	5	3	8	0	1	9	0	0
1	36021399	.	A	G	15	13	28	0	1	29	0	0
1	36036829	.	G	A	6	4	10	0	0	10	0	0
1	36057303	.	A	G	2	3	5	0	0	5	0	0
1	36057306	.	C	T	2	3	5	0	0	5	0	0
1	36078513	.	G	A	3	5	8	0	0	8	0	0
1	36104830	.	C	T	0	2	2	0	1	3	0	0
1	36105018	.	A	C	3	0	3	0	3	6	0	0
1	36105117	.	C	T	1	5	6	0	3	9	0	0
1	36194799	.	G	T	0	1	1	0	0	1	0	0
1	36200014	.	C	T	2	1	3	0	0	3	0	0
1	36438671	.	T	A	20	16	36	0	1	37	0	0
1	36438882	.	T	A	13	17	30	0	3	34	1	0
1	36439186	.	T	A	15	13	28	0	0	28	0	0
1	36439204	.	G	T	8	16	24	0	1	25	0	0
1	36439248	.	G	A	9	19	28	0	1	29	0	0
1	36439380	.	G	T	19	12	31	0	2	33	0	0
1	36735123	.	C	T	1	2	3	0	0	3	0	0
1	36735144	.	G	A	2	2	4	0	0	4	0	0
1	36738747	.	T	A	3	2	5	0	0	5	0	0
1	36738810	.	C	T	7	1	8	0	0	8	0	0
1	36739086	.	A	T	1	3	4	0	0	4	0	0
1	36739104	.	C	T	2	2	4	0	0	4	0	0
1	36739579	.	A	G	2	4	6	0	1	7	0	0
1	36740359	.	C	A	5	4	9	0	0	9	0	0
1	36740365	.	T	G	4	3	7	0	0	7	0	0
1	36740961	.	G	T	0	6	6	0	4	10	0	0
1	36740995	.	G	C	4	7	11	0	0	11	0	0
1	36741087	.	T	A	9	8	17	0	1	18	0	0
1	36741110	.	G	T	4	5	9	0	1	10	0	0
1	36741149	.	A	C	4	0	4	0	0	4	0	0
1	36741396	.	T	G	5	5	10	0	1	11	0	0
1	36741422	.	A	C	4	3	7	0	0	7	0	0
1	36741581	.	C	T	4	7	11	0	1	12	0	0
1	36741602	.	A	C	5	6	11	0	1	12	0	0
1	36741642	.	T	C	4	2	6	0	0	6	0	0
1	36741796	.	T	G	3	3	6	0	0	6	0	0
1	36755165	.	G	T	6	1	7	0	0	7	0	0
1	36763718	.	T	G	1	0	1	0	0	1	0	0
1	36771622	.	A	C	1	2	3	0	0	3	0	0
1	36887811	.	C	A	1	2	3	0	0	3	0	0
1	36887880	.	C	A	4	3	7	0	0	7	0	0
1	36903175	.	T	A	1	3	4	0	0	4	0	0
1	36911491	.	A	C	4	1	5	0	0	5	0	0
1	36911932	.	C	G	2	3	5	0	0	5	0	0
1	36912176	.	G	A	6	5	11	0	0	11	0	0
1	36935559	.	T	C	1	4	5	0	0	5	0	0
1	36969133	.	C	T	2	4	6	0	0	6	0	0
1	37212301	.	T	A	1	4	5	0	0	5	0	0
1	37212331	.	C	T	0	2	2	0	1	3	0	0
1	37284382	.	C	T	0	1	1	0	0	1	0	0
1	37287291	.	A	T	1	4	5	0	0	5	0	0
1	37287294	.	G	A	1	4	5	0	0	5	0	0
1	37291884	.	A	C	2	3	5	0	0	5	0	0
1	37304354	.	C	A	15	11	26	0	1	27	0	0
1	37304439	.	C	T	15	7	22	0	0	22	0	0
1	37304494	.	T	A	10	7	17	0	0	17	0	0
1	37304510	.	T	G	7	9	16	0	1	17	0	0
1	37304536	.	G	A	7	6	13	0	0	13	0	0
1	37304870	.	T	A	2	2	4	0	0	4	0	0
1	37304929	.	G	A	8	3	11	0	1	12	0	0
1	37305148	.	C	T	5	6	11	0	0	11	0	0
1	37305225	.	A	G	4	2	6	0	0	6	0	0
1	37306726	.	G	T	0	19	19	0	10	29	0	0
1	37306913	.	T	A	15	18	33	0	0	33	0	0
1	37306942	.	A	C	11	17	28	0	1	29	0	0
1	37339689	.	T	C	1	2	3	0	0	3	0	0
1	37344832	.	T	C	3	7	10	0	1	11	0	0
1	37344971	.	C	T	5	1	6	0	0	6	0	0
1	37353355	.	C	T	0	3	3	0	0	3	0	0
1	37355591	.	G	A	3	5	8	0	0	8	0	0
1	37359221	.	G	C	5	3	8	0	0	8	0	0
1	37359352	.	A	G	9	5	14	0	1	15	0	0
1	37361554	.	A	G	5	3	8	0	1	9	0	0
1	37361759	.	C	T	14	7	21	0	0	21	0	0
1	37361879	.	T	A	8	7	15	0	1	16	0	0
1	37361919	.	T	C	6	3	9	0	0	9	0	0
1	37361960	.	C	T	3	3	6	0	1	7	0	0
1	37752392	.	A	G	3	0	3	0	5	8	0	0
1	38125431	.	C	A	6	7	13	0	3	16	0	0
1	38125684	.	T	C	9	5	14	0	0	14	0	0
1	38131058	.	C	T	15	15	30	0	0	30	0	0
1	38131073	.	T	C	15	15	30	0	0	30	0	0
1	38131094	.	G	A	15	14	29	0	0	29	0	0
1	38131288	.	G	A	19	10	29	0	2	31	0	0
1	38131360	.	G	A	18	26	44	0	1	45	0	0
1	38131486	.	G	A	15	15	30	0	1	31	0	0
1	38132245	.	A	C	1	3	4	0	0	4	0	0
1	38132254	.	A	C	1	3	4	0	0	4	0	0
1	38142998	.	G	T	3	2	5	0	0	5	0	0
1	38146192	.	G	T	2	0	2	0	0	2	0	0
1	38150605	.	A	C	7	3	10	0	0	10	0	0
1	38163017	.	C	T	3	4	7	0	1	8	0	0
1	38163132	.	G	A	2	3	5	0	1	6	0	0
1	38166009	.	G	C	13	10	23	0	0	23	0	0
1	38166268	.	A	C	20	16	36	0	1	37	0	0
1	38166429	.	T	C	22	11	33	0	3	36	0	0
1	38166431	.	T	G	20	13	33	0	3	36	0	0
1	38166520	.	A	G	15	15	30	0	2	32	0	0
1	38169972	.	T	G	16	21	37	0	1	38	0	0
1	38170553	.	G	A	2	3	5	0	0	5	0	0
1	38346162	.	C	T	0	5	5	0	1	6	0	0
1	38346475	.	C	T	0	3	3	0	2	5	0	0
1	38346578	.	G	T	4	5	9	0	1	10	0	0
1	38346649	.	C	T	0	6	6	0	4	10	0	0
1	38346739	.	G	A	8	6	14	0	0	14	0	0
1	38354049	.	G	A	2	1	3	0	0	3	0	0
1	38372904	.	C	T	0	0	0	0	1	1	0	0
1	38372922	.	A	C	0	0	0	0	1	1	0	0
1	38374317	.	G	A	3	5	8	0	1	9	0	0
1	38416352	.	G	C	4	4	8	0	0	8	0	0
1	38416477	.	G	A	9	6	15	0	0	15	0	0
1	38416536	.	A	G	5	6	11	0	0	11	0	0
1	38417229	.	G	A	6	3	9	0	1	10	0	0
1	38417268	.	A	T	7	9	16	0	0	16	0	0
1	38417332	.	A	G	10	6	16	0	0	16	0	0
1	38417370	.	G	A	5	6	11	0	0	11	0	0
1	38417531	.	G	T	6	7	13	0	0	13	0	0
1	38417571	.	G	T	5	3	8	0	0	8	0	0
1	38417588	.	T	G	3	2	5	0	1	6	0	0
1	38417617	.	A	T	4	3	7	0	0	7	0	0
1	38417625	.	A	T	2	6	8	0	0	8	0	0
1	38417680	.	T	A	2	4	6	0	0	6	0	0
1	38417757	.	G	A	2	5	7	0	0	7	0	0
1	38417758	.	T	C	2	5	7	0	0	7	0	0
1	38418087	.	C	T	5	4	9	0	0	9	0	0
1	38418243	.	A	G	5	4	9	0	0	9	0	0
1	38418294	.	G	T	5	2	7	0	2	9	0	0
1	38466714	.	G	A	3	5	8	0	0	8	0	0
1	38649340	.	A	G	39	29	68	0	1	69	0	0
1	38649947	.	G	A	30	34	64	0	5	69	0	0
1	38650132	.	G	T	44	21	65	0	2	67	0	0
1	38650298	.	G	A	32	29	61	0	0	61	0	0
1	38650382	.	G	C	22	42	64	0	7	71	0	0
1	38650467	.	A	G	29	32	61	0	2	63	0	0
1	38650510	.	G	C	32	29	61	0	2	63	0	0
1	38650516	.	T	C	33	31	64	0	2	66	0	0
1	38650545	.	T	C	35	32	67	0	2	70	1	0
1	38651063	.	G	T	49	16	65	0	2	67	0	0
1	38651065	.	T	A	49	16	65	0	2	67	0	0
1	38651361	.	C	T	14	16	30	0	1	31	0	0
1	38651370	.	G	A	16	14	30	0	1	31	0	0
1	38651469	.	C	A	23	18	41	0	0	41	0	0
1	38651822	.	G	A	8	3	11	0	0	11	0	0
1	38655522	.	C	T	0	0	0	0	2	2	0	0
1	38657689	.	G	A	5	3	8	0	0	8	0	0
1	38660240	.	T	C	15	2	17	0	17	34	0	0
1	38660252	.	A	G	17	22	39	0	2	41	0	0
1	38660369	.	G	A	2	1	3	0	0	3	0	0
1	38665751	.	C	T	1	2	3	0	0	3	0	0
1	38709351	.	A	C	6	0	6	0	5	11	0	0
1	38709381	.	G	C	6	4	10	0	0	10	0	0
1	38709480	.	G	A	8	5	13	0	1	14	0	0
1	38784551	.	A	T	3	3	6	0	0	6	0	0
1	38787039	.	C	T	2	3	5	0	1	6	0	0
1	38791569	.	C	T	1	1	2	0	0	2	0	0
1	38793983	.	G	A	0	2	2	0	0	2	0	0
1	38797663	.	A	C	9	9	18	0	0	18	0	0
1	38799513	.	G	A	2	1	3	0	0	3	0	0
1	38799585	.	A	G	3	3	6	0	0	6	0	0
1	38799588	.	T	A	3	2	5	0	0	5	0	0
1	38802537	.	G	A	10	10	20	0	0	20	0	0
1	38802703	.	A	G	12	14	26	0	2	28	0	0
1	38802718	.	G	A	14	14	28	0	1	29	0	0
1	38802747	.	A	G	12	0	12	0	10	22	0	0
1	38802855	.	C	A	10	7	17	0	0	17	0	0
1	38803092	.	C	T	5	5	10	0	2	12	0	0
1	38803127	.	C	T	9	3	12	0	1	13	0	0
1	38803205	.	A	T	12	8	20	0	1	21	0	0
1	38803404	.	A	G	12	11	23	0	1	24	0	0
1	38804963	.	A	G	1	0	1	0	2	3	0	0
1	38805128	.	G	T	7	5	12	0	1	13	0	0
1	38805135	.	C	T	10	5	15	0	0	15	0	0
1	38805439	.	G	A	6	17	23	0	1	24	0	0
1	38805450	.	A	G	6	16	22	0	1	23	0	0
1	38805506	.	G	A	15	15	30	0	0	30	0	0
1	38807255	.	G	C	1	3	4	0	1	5	0	0
1	38808379	.	C	T	0	1	1	0	2	3	0	0
1	38808723	.	T	A	5	6	11	0	0	11	0	0
1	38810061	.	T	G	3	0	3	0	0	3	0	0
1	38820219	.	G	A	1	3	4	0	10	14	0	0
1	38822092	.	A	T	9	7	16	0	0	16	0	0
1	38851111	.	C	T	0	3	3	0	4	7	0	0
1	39680794	.	C	A	1	2	3	0	0	3	0	0
1	39732544	.	C	T	3	2	5	0	0	5	0	0
1	39735491	.	T	C	1	1	2	0	0	2	0	0
1	39770416	.	C	T	6	5	11	0	0	11	0	0
1	39771429	.	T	A	7	11	18	0	2	20	0	0
1	39772010	.	T	C	4	8	12	0	0	12	0	0
1	39772042	.	A	G	10	11	21	0	0	21	0	0
1	39772135	.	C	A	6	7	13	0	1	14	0	0
1	39772225	.	C	T	3	3	6	0	0	6	0	0
1	39774096	.	C	T	5	8	13	0	0	13	0	0
1	39774225	.	C	T	8	10	18	0	2	20	0	0
1	39774363	.	G	A	6	9	15	0	0	15	0	0
1	39774618	.	A	G	7	8	15	0	0	15	0	0
1	39774690	.	A	G	9	9	18	0	0	18	0	0
1	39774727	.	C	A	8	10	18	0	0	18	0	0
1	39774891	.	C	T	16	16	32	0	1	33	0	0
1	39774915	.	G	A	17	13	30	0	2	32	0	0
1	39775089	.	C	T	10	8	18	0	1	19	0	0
1	39775131	.	C	T	8	9	17	0	1	18	0	0
1	39775227	.	C	T	11	9	20	0	0	20	0	0
1	39776356	.	A	C	22	21	43	0	1	44	0	0
1	39777089	.	G	A	20	10	30	0	0	30	0	0
1	39777836	.	G	A	1	14	15	0	13	28	0	0
1	39777975	.	A	T	19	8	27	0	1	28	0	0
1	39778047	.	A	G	15	1	16	0	11	27	0	0
1	39778075	.	T	G	20	10	30	0	1	31	0	0
1	39778332	.	G	C	23	23	46	0	4	50	0	0
1	39778452	.	G	A	8	5	13	0	0	13	0	0
1	39778661	.	G	A	11	10	21	0	0	21	0	0
1	39778663	.	G	A	11	10	21	0	0	21	0	0
1	39778949	.	G	C	19	20	39	0	0	39	0	0
1	39779225	.	G	C	13	17	30	0	1	31	0	0
1	39779468	.	A	T	7	4	11	0	0	11	0	0
1	39869917	.	T	A	3	2	5	0	1	6	0	0
1	39869974	.	G	A	7	6	13	0	0	13	0	0
1	39870008	.	T	C	3	5	8	0	1	9	0	0
1	39879557	.	G	T	0	5	5	0	0	5	0	0
1	39879560	.	T	C	2	3	5	0	0	5	0	0
1	39880877	.	A	G	1	3	4	0	0	4	0	0
1	39882764	.	A	T	1	7	8	0	0	8	0	0
1	39882899	.	A	G	3	6	9	0	0	9	0	0
1	39882906	.	T	A	6	6	12	0	0	12	0	0
1	39899477	.	G	C	24	16	40	0	0	40	0	0
1	39899494	.	A	G	21	23	44	0	1	45	0	0
1	39899663	.	G	A	28	19	47	0	2	49	0	0
1	39900056	.	G	A	21	26	47	0	1	48	0	0
1	39900129	.	G	A	28	16	44	0	0	44	0	0
1	39900137	.	G	T	28	15	43	0	0	43	0	0
1	39900360	.	G	A	10	11	21	0	1	22	0	0
1	39900432	.	C	T	1	21	22	0	6	28	0	0
1	39900750	.	C	T	0	17	17	0	13	30	0	0
1	39901269	.	G	A	4	7	11	0	0	11	0	0
1	39901378	.	T	A	15	9	24	0	1	25	0	0
1	39901500	.	T	C	12	7	19	0	0	19	0	0
1	39901501	.	G	A	12	7	19	0	0	19	0	0
1	39901729	.	T	C	17	1	18	0	19	38	1	0
1	39907291	.	A	C	7	8	15	0	0	15	0	0
1	39907492	.	T	C	16	1	17	0	20	37	0	0
1	39907611	.	C	T	0	5	5	0	3	8	0	0
1	39908047	.	G	A	13	10	23	0	1	24	0	0
1	39908680	.	C	T	10	9	19	0	1	20	0	0
1	39908854	.	A	G	5	8	13	0	0	13	0	0
1	39908881	.	C	T	5	8	13	0	2	15	0	0
1	39908926	.	A	G	8	8	16	0	0	16	0	0
1	39909003	.	A	T	5	11	16	0	0	16	0	0
1	39909247	.	A	T	21	11	32	0	2	34	0	0
1	39909274	.	A	T	11	6	17	0	2	19	0	0
1	39981794	.	A	G	6	4	10	0	0	10	0	0
1	39995100	.	C	T	3	7	10	0	0	10	0	0
1	39998875	.	G	A	9	8	17	0	0	17	0	0
1	40001873	.	C	A	7	1	8	0	0	8	0	0
1	40002113	.	G	A	7	11	18	0	1	19	0	0
1	40002148	.	C	G	10	5	15	0	1	16	0	0
1	40008905	.	T	C	27	11	38	0	2	40	0	0
1	40008906	.	G	A	28	10	38	0	2	40	0	0
1	40009227	.	T	A	11	22	33	0	1	34	0	0
1	40009258	.	C	T	21	12	33	0	2	35	0	0
1	40009291	.	A	G	20	12	32	0	0	32	0	0
1	40009382	.	G	A	19	18	37	0	0	37	0	0
1	40009526	.	T	C	2	10	12	0	1	13	0	0
1	40009625	.	T	C	9	4	13	0	1	14	0	0
1	40009671	.	C	A	10	8	18	0	0	18	0	0
1	40009697	.	C	T	6	6	12	0	1	13	0	0
1	40015189	.	A	G	4	8	12	0	1	13	0	0
1	40015219	.	C	T	1	10	11	0	0	11	0	0
1	40015265	.	C	T	0	0	0	0	2	2	0	0
1	40015553	.	A	G	0	1	1	0	0	1	0	0
1	40015697	.	A	G	8	6	14	0	1	15	0	0
1	40028208	.	C	A	1	1	2	0	1	3	0	0
1	40028424	.	C	T	3	5	8	0	0	8	0	0
1	40028508	.	C	T	3	9	12	0	1	13	0	0
1	40028568	.	G	T	3	2	5	0	0	5	0	0
1	40028613	.	G	A	3	4	7	0	0	7	0	0
1	40028637	.	C	T	4	5	9	0	0	9	0	0
1	40028680	.	G	A	5	6	11	0	0	11	0	0
1	40041528	.	C	T	3	2	5	0	0	5	0	0
1	40042241	.	G	A	0	1	1	0	0	1	0	0
1	40044562	.	G	A	7	3	10	0	1	11	0	0
1	40044578	.	C	T	3	7	10	0	0	10	0	0
1	40046859	.	G	A	1	2	3	0	0	3	0	0
1	40047070	.	T	A	0	2	2	0	0	2	0	0
1	40051918	.	T	C	9	6	15	0	0	15	0	0
1	40051923	.	G	C	8	7	15	0	0	15	0	0
1	40051988	.	G	C	0	7	7	0	8	15	0	0
1	40052033	.	A	G	5	13	18	0	1	19	0	0
1	40052066	.	G	C	13	4	17	0	0	17	0	0
1	40052083	.	G	A	11	3	14	0	1	15	0	0
1	40052481	.	A	C	7	10	17	0	2	19	0	0
1	40052550	.	A	C	5	14	19	0	0	19	0	0
1	40052562	.	A	G	5	11	16	0	0	16	0	0
1	40052965	.	T	A	2	5	7	0	1	8	0	0
1	40057483	.	C	T	2	4	6	0	1	7	0	0
1	40057604	.	A	G	4	6	10	0	0	10	0	0
1	40057655	.	C	T	4	6	10	0	0	10	0	0
1	40057805	.	C	T	4	10	14	1	0	15	0	0
1	40060836	.	T	A	3	5	8	0	0	8	0	0
1	40060860	.	T	C	1	5	6	0	0	6	0	0
1	40060968	.	A	C	3	3	6	0	0	6	0	0
1	40060992	.	C	T	0	3	3	0	3	6	0	0
1	40061061	.	C	T	0	6	6	0	2	8	0	0
1	40061169	.	G	A	6	6	12	0	0	12	0	0
1	40061285	.	C	T	8	5	13	0	0	13	0	0
1	40062593	.	T	G	4	2	6	0	0	6	0	0
1	40066299	.	G	A	1	6	7	0	0	7	0	0
1	40107874	.	T	G	8	8	16	0	1	17	0	0
1	40107961	.	C	T	1	3	4	0	0	4	0	0
1	40111679	.	C	G	7	16	23	0	0	23	0	0
1	40111702	.	T	G	13	14	27	0	0	27	0	0
1	40111737	.	A	C	15	8	23	0	0	23	0	0
1	40111738	.	G	A	15	8	23	0	0	23	0	0
1	40111776	.	C	T	10	15	25	0	1	26	0	0
1	40111918	.	C	T	13	13	26	0	3	29	0	0
1	40112206	.	T	C	11	3	14	0	4	18	0	0
1	40112347	.	C	T	8	5	13	0	1	14	0	0
1	40112410	.	C	T	7	5	12	0	6	18	0	0
1	40112713	.	A	G	5	1	6	0	5	11	0	0
1	40112760	.	T	A	7	10	17	0	0	17	0	0
1	40112822	.	A	T	7	11	18	0	1	19	0	0
1	40112837	.	C	T	9	9	18	0	1	19	0	0
1	40112869	.	C	T	12	5	17	0	0	17	0	0
1	40112879	.	A	G	10	3	13	0	3	16	0	0
1	40112938	.	G	C	7	6	13	0	1	14	0	0
1	40113008	.	A	T	2	3	5	0	0	5	0	0
1	40113149	.	A	G	1	4	5	0	0	5	0	0
1	40113188	.	A	G	1	4	5	0	0	5	0	0
1	40113206	.	A	G	1	6	7	0	0	7	0	0
1	40113314	.	A	G	1	1	2	0	1	3	0	0
1	40113374	.	T	A	1	4	5	0	0	5	0	0
1	40114155	.	T	A	1	3	4	0	0	4	0	0
1	40114466	.	T	G	1	2	3	0	0	3	0	0
1	40115018	.	A	T	3	2	5	0	1	6	0	0
1	40116747	.	G	A	14	4	18	0	0	18	0	0
1	40116823	.	C	T	0	3	3	0	2	5	0	0
1	40116889	.	G	A	1	1	2	0	1	3	0	0
1	40116915	.	T	G	6	4	10	0	0	10	0	0
1	40116946	.	C	T	0	5	5	0	12	17	0	0
1	40117345	.	G	A	11	15	26	0	1	27	0	0
1	40123964	.	C	T	0	2	2	0	0	2	0	0
1	40126279	.	T	C	3	1	4	0	0	4	0	0
1	40126281	.	T	G	3	1	4	0	0	4	0	0
1	40132692	.	G	C	2	2	4	0	0	4	0	0
1	40210865	.	G	T	16	11	27	0	0	27	0	0
1	40211048	.	C	T	1	7	8	0	4	12	0	0
1	40211065	.	T	C	4	5	9	0	0	9	0	0
1	40211217	.	A	C	7	12	19	0	0	19	0	0
1	40211465	.	T	C	7	0	7	0	11	18	0	0
1	40211645	.	C	G	0	5	5	0	13	18	0	0
1	40212065	.	C	T	6	15	21	0	0	21	0	0
1	40212084	.	C	A	1	13	14	0	11	25	0	0
1	40212305	.	C	T	11	17	28	0	1	29	0	0
1	40221458	.	A	T	2	1	3	0	0	3	0	0
1	40226292	.	G	C	3	6	9	0	0	9	0	0
1	40227029	.	T	G	6	2	8	0	0	8	0	0
1	40242922	.	C	A	0	2	2	0	0	2	0	0
1	40248173	.	C	T	2	2	4	0	0	5	1	0
1	40248383	.	C	T	2	3	5	0	0	5	0	0
1	40252219	.	T	A	1	2	3	0	0	3	0	0
1	40257631	.	C	T	10	9	19	0	1	20	0	0
1	40257751	.	C	T	12	6	18	0	0	18	0	0
1	40257834	.	T	G	9	0	9	0	8	17	0	0
1	40266618	.	C	T	7	4	11	0	0	11	0	0
1	40270054	.	C	T	1	4	5	0	1	6	0	0
1	40270094	.	G	A	0	0	0	0	2	2	0	0
1	40270095	.	G	A	2	0	2	0	0	2	0	0
1	40336234	.	C	G	7	4	11	0	0	11	0	0
1	40336372	.	T	A	2	6	8	0	0	8	0	0
1	40336396	.	A	C	4	0	4	0	6	10	0	0
1	40337314	.	C	T	7	11	18	0	0	18	0	0
1	40337464	.	C	A	1	5	6	0	6	12	0	0
1	40340571	.	C	T	5	5	10	0	1	11	0	0
1	40340598	.	C	T	2	5	7	0	0	7	0	0
1	40410608	.	C	T	1	3	4	0	4	8	0	0
1	40410839	.	A	T	5	6	11	0	0	11	0	0
1	40410908	.	C	T	3	3	6	0	2	8	0	0
1	40411091	.	T	A	3	4	7	0	1	8	0	0
1	40567094	.	G	A	8	8	16	0	0	16	0	0
1	40568601	.	G	A	7	10	17	0	0	17	0	0
1	40568707	.	A	G	10	0	10	0	7	17	0	0
1	40568883	.	G	A	0	14	14	0	11	25	0	0
1	40568990	.	A	G	14	17	31	0	0	31	0	0
1	40569153	.	C	T	10	4	14	0	0	14	0	0
1	40569168	.	C	T	9	7	16	0	0	16	0	0
1	40569231	.	G	A	11	9	20	0	1	21	0	0
1	40569295	.	A	T	7	7	14	0	0	14	0	0
1	40569386	.	T	A	16	8	24	0	1	25	0	0
1	40569466	.	A	T	19	18	37	0	1	38	0	0
1	40569538	.	G	A	15	12	27	0	0	27	0	0
1	40569548	.	T	C	12	11	23	0	2	25	0	0
1	40573703	.	G	T	4	7	11	0	0	11	0	0
1	40590967	.	T	G	3	8	11	0	0	11	0	0
1	40591262	.	T	C	22	21	43	0	2	45	0	0
1	40591272	.	T	C	20	17	37	0	0	37	0	0
1	40594373	.	C	T	1	3	4	0	1	5	0	0
1	40594415	.	C	T	0	15	15	0	4	19	0	0
1	40594517	.	T	C	14	0	14	0	12	26	0	0
1	40594526	.	G	A	13	11	24	0	0	24	0	0
1	40597332	.	A	C	8	0	8	0	16	24	0	0
1	40600992	.	A	T	1	5	6	0	0	6	0	0
1	40601547	.	G	A	11	6	17	0	0	17	0	0
1	40601595	.	G	C	3	0	3	0	1	4	0	0
1	40638246	.	A	T	1	6	7	0	0	7	0	0
1	40794437	.	T	C	1	2	3	0	0	3	0	0
1	40795213	.	C	A	2	1	3	0	0	3	0	0
1	40795231	.	A	T	2	2	4	0	0	4	0	0
1	40796779	.	G	T	0	1	1	0	0	1	0	0
1	40796791	.	G	A	1	0	1	0	0	1	0	0
1	40796942	.	C	T	1	7	8	0	0	8	0	0
1	40796977	.	C	T	1	4	5	0	0	5	0	0
1	40796985	.	A	T	1	4	5	0	0	5	0	0
1	40910379	.	T	C	2	3	5	0	0	5	0	0
1	40992716	.	T	A	5	5	10	0	2	12	0	0
1	40992823	.	A	G	6	11	17	0	1	18	0	0
1	40992878	.	C	G	10	2	12	0	0	12	0	0
1	40993349	.	C	T	0	12	12	0	8	20	0	0
1	40993714	.	G	A	7	4	11	0	0	11	0	0
1	40994068	.	T	A	2	3	5	0	0	5	0	0
1	40994250	.	A	T	5	2	7	0	0	7	0	0
1	41131608	.	C	T	8	14	22	0	1	23	0	0
1	41133944	.	G	A	3	5	8	0	0	8	0	0
1	41136245	.	T	C	2	0	2	0	0	2	0	0
1	41138638	.	A	G	1	0	1	0	0	1	0	0
1	41138641	.	C	T	1	1	2	0	0	2	0	0
1	41140465	.	T	C	3	2	5	0	0	5	0	0
1	41140640	.	C	T	17	12	29	0	0	29	0	0
1	41215289	.	T	A	9	14	23	0	2	25	0	0
1	41215312	.	T	G	11	14	25	0	0	25	0	0
1	41215547	.	G	A	7	10	17	0	1	18	0	0
1	41215746	.	T	A	9	8	17	0	1	18	0	0
1	41215868	.	T	G	10	12	22	0	1	23	0	0
1	41215869	.	G	T	13	10	23	0	0	23	0	0
1	41215949	.	T	C	12	5	17	0	2	19	0	0
1	41215998	.	T	C	9	3	12	0	0	12	0	0
1	41222341	.	T	C	2	2	4	0	0	4	0	0
1	41230927	.	C	T	1	1	2	0	0	2	0	0
1	41294719	.	A	G	11	13	24	0	0	24	0	0
1	41294760	.	T	C	9	11	20	0	1	21	0	0
1	41294790	.	G	T	9	10	19	0	0	19	0	0
1	41297453	.	C	T	0	3	3	0	6	9	0	0
1	41297495	.	G	A	8	16	24	0	0	24	0	0
1	41297561	.	C	T	3	3	6	0	0	6	0	0
1	41297564	.	A	T	2	2	4	0	1	5	0	0
1	41300133	.	C	T	3	3	6	0	0	6	0	0
1	41309208	.	C	G	1	5	6	0	0	6	0	0
1	41310074	.	A	G	4	1	5	0	0	5	0	0
1	41312210	.	G	A	2	3	5	0	0	5	0	0
1	41318203	.	T	G	4	1	5	0	0	5	0	0
1	41320781	.	A	G	1	0	1	0	0	1	0	0
1	41335270	.	G	A	1	2	3	0	0	3	0	0
1	41470524	.	T	C	25	27	52	0	1	53	0	0
1	41471529	.	T	C	27	20	47	0	4	51	0	0
1	41487459	.	C	A	2	4	6	0	0	6	0	0
1	41487474	.	C	T	4	2	6	0	0	6	0	0
1	41487811	.	C	T	1	1	2	0	0	2	0	0
1	41487960	.	A	T	0	1	1	0	0	1	0	0
1	41487973	.	T	C	1	1	2	0	0	2	0	0
1	41488643	.	A	C	4	1	5	0	0	5	0	0
1	41489068	.	C	T	3	4	7	0	0	7	0	0
1	41489343	.	G	A	2	2	4	0	0	4	0	0
1	41491990	.	G	T	5	3	8	0	0	8	0	0
1	41492367	.	A	T	3	4	7	0	0	7	0	0
1	41498219	.	A	G	8	3	11	0	0	11	0	0
1	41512895	.	C	T	1	4	5	0	0	5	0	0
1	41513497	.	G	A	1	4	5	0	0	5	0	0
1	41596182	.	A	G	1	2	3	0	0	3	0	0
1	41596199	.	A	G	2	4	6	0	0	6	0	0
1	41596220	.	A	G	2	0	2	0	3	5	0	0
1	41596291	.	C	T	2	3	5	0	0	5	0	0
1	41596311	.	C	T	3	1	4	0	0	4	0	0
1	41596420	.	A	C	1	0	1	0	0	1	0	0
1	41600279	.	T	G	1	3	4	0	0	4	0	0
1	41600314	.	C	T	1	3	4	0	0	4	0	0
1	41604931	.	C	G	2	0	2	0	3	5	0	0
1	41604934	.	C	G	2	0	2	0	3	5	0	0
1	41604985	.	G	A	1	3	4	0	3	7	0	0
1	41605011	.	T	C	5	3	8	0	0	8	0	0
1	41605149	.	T	C	1	3	4	0	0	4	0	0
1	41605203	.	C	T	4	3	7	0	0	7	0	0
1	41605675	.	G	A	2	3	5	0	1	6	0	0
1	41605715	.	T	C	4	6	10	0	0	10	0	0
1	41610394	.	A	G	0	1	1	0	0	1	0	0
1	41615547	.	T	A	1	2	3	0	1	4	0	0
1	41615559	.	A	G	1	3	4	0	0	4	0	0
1	41615874	.	C	T	3	7	10	0	1	11	0	0
1	41615904	.	T	C	5	11	16	0	0	16	0	0
1	41615949	.	T	C	6	9	15	0	0	15	0	0
1	41616081	.	T	G	4	2	6	0	1	7	0	0
1	41616109	.	G	A	2	4	6	0	0	6	0	0
1	41616186	.	A	C	3	3	6	0	0	6	0	0
1	41616867	.	T	A	3	3	6	0	0	6	0	0
1	41690266	.	C	T	3	4	7	0	0	7	0	0
1	41730591	.	C	T	4	12	16	0	0	16	0	0
1	41730609	.	C	T	7	12	19	0	0	19	0	0
1	41730669	.	G	A	11	4	15	0	1	16	0	0
1	41730834	.	T	G	4	0	4	0	2	6	0	0
1	41744007	.	G	A	1	0	1	0	1	2	0	0
1	41744046	.	C	T	2	5	7	0	0	7	0	0
1	41744103	.	C	T	0	2	2	0	0	2	0	0
1	41755157	.	C	T	13	8	21	0	0	21	0	0
1	41755158	.	A	T	13	8	21	0	0	21	0	0
1	41755263	.	G	A	0	5	5	0	6	11	0	0
1	41770872	.	T	C	5	11	16	0	3	19	0	0
1	41770959	.	T	C	6	6	12	0	0	12	0	0
1	41859746	.	C	T	16	16	32	0	0	32	0	0
1	41860298	.	A	C	6	13	19	0	0	19	0	0
1	41862446	.	C	G	11	0	11	0	15	26	0	0
1	41958330	.	T	C	6	2	8	0	0	8	0	0
1	41958356	.	C	T	3	2	5	0	0	5	0	0
1	41959067	.	T	C	1	1	2	0	4	6	0	0
1	41959410	.	T	A	1	8	9	0	0	9	0	0
1	41959749	.	G	A	6	3	9	0	0	9	0	0
1	41959904	.	C	T	0	2	2	1	0	3	0	0
1	41960553	.	A	C	2	2	4	0	0	4	0	0
1	41960581	.	T	C	4	3	7	0	0	7	0	0
1	41960607	.	T	C	3	0	3	0	4	7	0	0
1	41982355	.	C	A	0	2	2	0	1	3	0	0
1	41982356	.	G	A	1	2	3	0	0	3	0	0
1	41982414	.	T	A	1	4	5	0	0	5	0	0
1	42375005	.	C	A	2	5	7	0	1	8	0	0
1	42375071	.	C	T	2	2	4	0	0	4	0	0
1	42386349	.	T	C	5	3	8	0	0	8	0	0
1	42386364	.	C	A	4	2	6	0	2	8	0	0
1	42391194	.	T	C	4	2	6	0	0	6	0	0
1	42391214	.	G	A	1	1	2	0	0	2	0	0
1	42776652	.	T	C	23	22	45	0	2	47	0	0
1	42776787	.	C	T	2	24	26	0	17	43	0	0
1	42776806	.	A	T	19	21	40	0	1	41	0	0
1	42776853	.	T	C	25	14	39	0	2	41	0	0
1	42776906	.	A	G	20	16	36	0	2	38	0	0
1	42777116	.	G	A	17	14	31	0	0	31	0	0
1	42777146	.	C	G	0	9	9	0	20	29	0	0
1	42777383	.	A	G	20	19	39	0	0	39	0	0
1	42777593	.	T	G	14	18	32	0	2	34	0	0
1	42777674	.	G	A	11	15	26	0	0	27	1	0
1	42882955	.	C	T	9	5	14	0	0	14	0	0
1	43034869	.	T	C	20	13	33	0	0	33	0	0
1	43035178	.	T	C	16	22	38	0	1	39	0	0
1	43035444	.	A	T	12	9	21	0	1	22	0	0
1	43035546	.	T	A	12	6	18	0	0	18	0	0
1	43652740	.	C	G	0	14	14	0	27	41	0	0
1	43659248	.	C	T	1	6	7	0	8	15	0	0
1	43670083	.	A	G	4	2	6	0	0	6	0	0
1	43670378	.	C	T	1	2	3	0	3	6	0	0
1	43675337	.	A	G	4	4	8	0	0	8	0	0
1	43688131	.	A	G	3	3	6	0	0	6	0	0
1	43688164	.	G	A	1	4	5	0	0	5	0	0
1	43714454	.	C	T	2	1	3	0	0	3	0	0
1	43720168	.	A	G	2	3	5	0	0	5	0	0
1	43994777	.	G	T	3	6	9	0	1	10	0	0
1	43994796	.	T	G	5	2	7	0	0	7	0	0
1	43994840	.	T	A	4	2	6	0	0	6	0	0
1	43997679	.	C	T	2	2	4	0	0	4	0	0
1	43998272	.	C	T	2	3	5	0	0	5	0	0
1	44021800	.	G	T	3	3	6	0	1	7	0	0
1	44021837	.	A	C	6	0	6	0	8	14	0	0
1	44024995	.	T	A	3	2	5	0	0	5	0	0
1	44027653	.	G	T	2	4	6	0	0	6	0	0
1	44027709	.	T	G	2	4	6	0	0	6	0	0
1	44027801	.	C	T	1	3	4	0	7	11	0	0
1	44027813	.	T	G	7	3	10	0	0	10	0	0
1	44027908	.	A	G	5	5	10	0	1	11	0	0
1	44028054	.	G	T	7	4	11	0	0	11	0	0
1	44028288	.	C	G	2	2	4	0	0	4	0	0
1	44028567	.	C	T	2	2	4	0	0	4	0	0
1	44028920	.	G	A	2	2	4	0	0	4	0	0
1	44028932	.	A	C	2	2	4	0	0	4	0	0
1	44029441	.	G	C	1	3	4	0	0	4	0	0
1	44030590	.	C	A	4	3	7	0	0	7	0	0
1	44030591	.	C	A	4	3	7	0	0	7	0	0
1	44030852	.	T	C	1	1	2	0	0	2	0	0
1	44030856	.	T	C	0	2	2	0	0	2	0	0
1	44031555	.	T	A	1	3	4	0	0	4	0	0
1	44032066	.	G	A	3	2	5	0	0	5	0	0
1	44032460	.	G	T	1	2	3	0	0	3	0	0
1	44037301	.	A	C	2	2	4	0	0	4	0	0
1	44037302	.	G	A	2	2	4	0	0	4	0	0
1	44037336	.	A	T	2	2	4	0	0	4	0	0
1	44040513	.	A	T	4	3	7	0	0	7	0	0
1	44040606	.	G	A	7	4	11	0	0	11	0	0
1	44040854	.	T	C	4	11	15	0	0	15	0	0
1	44041376	.	A	G	10	4	14	0	0	14	0	0
1	44041385	.	T	A	11	5	16	0	0	16	0	0
1	44041450	.	T	A	6	8	14	0	1	15	0	0
1	44046126	.	G	A	1	2	3	0	0	3	0	0
1	44048263	.	C	T	5	5	10	0	0	10	0	0
1	44048482	.	A	T	2	2	4	0	0	4	0	0
1	44205523	.	C	A	1	1	2	0	0	2	0	0
1	44205679	.	G	A	0	5	5	0	1	6	0	0
1	44207519	.	C	A	5	3	8	0	0	8	0	0
1	44210620	.	C	T	3	3	6	0	1	7	0	0
1	44216756	.	T	C	1	3	4	0	1	5	0	0
1	44227298	.	T	G	7	6	13	0	0	13	0	0
1	44227346	.	C	T	6	5	11	0	1	12	0	0
1	44227740	.	A	G	3	10	13	0	0	13	0	0
1	44227764	.	G	T	4	9	13	0	0	13	0	0
1	44227812	.	T	C	10	14	24	0	1	25	0	0
1	44228081	.	A	G	5	5	10	0	0	10	0	0
1	44228243	.	T	G	9	8	17	0	0	17	0	0
1	44228255	.	C	T	8	9	17	0	1	18	0	0
1	44228705	.	C	T	6	3	9	0	2	11	0	0
1	44390558	.	A	G	13	21	34	0	0	34	0	0
1	44390643	.	G	A	1	14	15	0	22	37	0	0
1	44393977	.	T	C	14	22	36	0	0	36	0	0
1	44394276	.	A	T	9	4	13	0	0	13	0	0
1	44394329	.	T	G	6	3	9	0	0	9	0	0
1	44492030	.	C	A	17	13	30	0	1	31	0	0
1	44492413	.	C	T	10	14	24	0	0	24	0	0
1	44492429	.	T	C	13	16	29	0	1	30	0	0
1	44492626	.	A	C	16	22	38	0	4	42	0	0
1	44492842	.	G	T	23	20	43	0	2	45	0	0
1	44492875	.	A	T	20	20	40	0	0	40	0	0
1	44493022	.	T	G	25	30	55	0	3	58	0	0
1	44493382	.	G	T	1	22	23	0	32	55	0	0
1	44493485	.	T	C	21	30	51	0	1	52	0	0
1	44493554	.	T	C	20	19	39	0	1	40	0	0
1	44493952	.	G	A	0	22	22	0	21	43	0	0
1	44493971	.	G	A	21	24	45	0	1	46	0	0
1	44494027	.	A	T	31	24	55	0	2	57	0	0
1	44494153	.	C	T	34	32	66	0	3	69	0	0
1	44494337	.	C	G	25	14	39	0	3	42	0	0
1	44494506	.	G	T	15	10	25	0	0	25	0	0
1	44494695	.	C	T	30	11	41	1	1	43	0	0
1	44494818	.	G	A	1	30	31	0	28	59	0	0
1	44494834	.	A	G	23	33	56	0	4	60	0	0
1	44494913	.	G	A	24	20	44	0	3	47	0	0
1	44494924	.	C	T	28	19	47	0	1	48	0	0
1	44495258	.	C	T	25	27	52	0	2	54	0	0
1	44495269	.	T	A	21	28	49	0	3	52	0	0
1	44540607	.	G	A	5	2	7	0	0	7	0	0
1	44540711	.	A	C	3	7	10	0	1	11	0	0
1	44547139	.	A	G	4	0	4	0	4	8	0	0
1	44548800	.	T	C	0	3	3	0	0	3	0	0
1	44549252	.	A	G	1	0	1	0	0	1	0	0
1	44554101	.	G	A	0	5	5	0	12	17	0	0
1	44554143	.	A	G	8	3	11	0	0	11	0	0
1	44558999	.	C	T	8	4	12	0	0	12	0	0
1	44559103	.	C	T	5	15	20	0	0	20	0	0
1	44559352	.	G	A	15	8	23	0	1	24	0	0
1	44559395	.	A	C	13	11	24	0	4	28	0	0
1	44564869	.	T	C	5	2	7	0	0	7	0	0
1	44564935	.	C	T	12	7	19	0	4	23	0	0
1	44565025	.	C	T	10	12	22	0	1	23	0	0
1	44565111	.	T	C	12	9	21	0	0	21	0	0
1	44565407	.	A	C	4	6	10	0	0	10	0	0
1	44565479	.	C	T	8	6	14	0	1	15	0	0
1	44566133	.	C	A	15	13	28	0	3	31	0	0
1	44569458	.	G	A	14	15	29	0	1	30	0	0
1	44569717	.	C	T	0	12	12	0	13	25	0	0
1	44569822	.	G	A	7	8	15	0	0	15	0	0
1	44570716	.	A	G	13	20	33	0	2	35	0	0
1	44570740	.	C	T	11	20	31	0	0	31	0	0
1	44571114	.	T	A	6	4	10	0	1	11	0	0
1	44571352	.	T	C	11	4	15	0	1	16	0	0
1	44571370	.	C	T	1	8	9	0	9	18	0	0
1	44571520	.	C	T	8	11	19	0	1	20	0	0
1	44571522	.	G	A	8	11	19	0	1	20	0	0
1	44571583	.	A	G	5	7	12	0	0	12	0	0
1	44571672	.	C	T	0	10	10	0	12	22	0	0
1	44571708	.	A	T	11	6	17	0	1	18	0	0
1	44575448	.	T	C	11	6	17	0	2	19	0	0
1	44581710	.	C	T	0	6	6	0	2	8	0	0
1	44582513	.	C	T	11	7	18	0	0	18	0	0
1	44582576	.	G	A	3	11	14	0	15	29	0	0
1	44582657	.	G	A	1	0	1	0	0	1	0	0
1	44591232	.	C	A	7	9	16	0	1	17	0	0
1	44651929	.	G	C	3	2	5	0	20	25	0	0
1	44652498	.	A	G	28	21	49	0	0	49	0	0
1	44652511	.	A	C	21	18	39	0	2	41	0	0
1	44652599	.	T	C	24	2	26	0	14	40	0	0
1	44652916	.	T	A	17	19	36	0	2	39	1	0
1	44653014	.	C	T	22	28	50	0	3	53	0	0
1	44653076	.	A	T	19	28	47	0	1	48	0	0
1	44653135	.	T	A	14	16	30	0	2	32	0	0
1	44653150	.	T	A	16	15	31	0	1	32	0	0
1	44653171	.	A	G	17	12	29	0	0	29	0	0
1	44658849	.	T	C	14	0	14	0	11	25	0	0
1	44664964	.	T	A	0	4	4	0	1	5	0	0
1	44669970	.	G	T	10	7	17	0	3	20	0	0
1	44672271	.	G	A	3	0	3	0	0	3	0	0
1	44672571	.	G	A	6	2	8	0	2	10	0	0
1	44678037	.	A	G	5	4	9	0	0	9	0	0
1	44683393	.	G	A	4	3	7	0	0	7	0	0
1	44703761	.	G	T	5	5	10	0	0	10	0	0
1	44729449	.	G	C	11	8	19	0	1	20	0	0
1	44729479	.	C	G	8	5	13	0	2	15	0	0
1	44737473	.	G	A	0	2	2	0	4	6	0	0
1	44737588	.	A	T	8	3	11	0	0	11	0	0
1	44737598	.	T	A	9	3	12	0	0	12	0	0
1	44737653	.	A	T	5	7	12	0	0	12	0	0
1	44737750	.	T	A	9	2	11	0	0	11	0	0
1	44800889	.	T	C	1	5	6	0	0	6	0	0
1	44818992	.	A	G	20	1	21	0	18	39	0	0
1	44846997	.	G	A	4	2	6	0	0	6	0	0
1	44849126	.	C	T	3	2	5	0	0	5	0	0
1	44852817	.	G	A	10	5	15	0	1	16	0	0
1	44855409	.	T	C	1	1	2	0	1	3	0	0
1	44861744	.	C	T	12	8	20	0	2	22	0	0
1	44861954	.	A	T	13	14	27	0	0	27	0	0
1	44862092	.	C	G	13	13	26	0	3	29	0	0
1	44862707	.	C	T	9	5	14	0	1	15	0	0
1	44862725	.	G	A	13	7	20	0	0	20	0	0
1	44869173	.	A	T	12	7	19	0	3	22	0	0
1	44869174	.	C	T	15	7	22	0	0	22	0	0
1	44869216	.	G	A	7	8	15	0	2	17	0	0
1	44869621	.	G	A	10	11	21	0	0	21	0	0
1	44869638	.	A	G	8	10	18	0	1	19	0	0
1	44869666	.	C	A	14	9	23	0	1	24	0	0
1	44869810	.	T	C	8	7	15	0	1	16	0	0
1	44869892	.	T	C	5	2	7	0	0	7	0	0
1	44872586	.	A	G	10	3	13	0	2	15	0	0
1	44872817	.	A	G	2	3	5	0	0	5	0	0
1	44886423	.	A	G	1	2	3	0	0	3	0	0
1	44889081	.	T	C	4	1	5	0	3	8	0	0
1	44893894	.	G	T	3	4	7	0	0	7	0	0
1	44893921	.	T	A	2	3	5	0	0	5	0	0
1	44897173	.	T	C	0	1	1	0	0	1	0	0
1	44897248	.	G	A	3	2	5	0	1	6	0	0
1	44925956	.	C	T	2	4	6	0	0	6	0	0
1	44946030	.	C	T	2	2	4	0	0	4	0	0
1	44949921	.	T	A	1	2	3	0	1	4	0	0
1	44950178	.	T	G	3	4	7	0	0	7	0	0
1	44959408	.	C	A	9	9	18	0	1	19	0	0
1	44959538	.	C	T	7	9	16	0	2	18	0	0
1	44959825	.	C	T	4	5	9	0	0	9	0	0
1	44959876	.	T	C	6	7	13	0	0	13	0	0
1	44959916	.	C	A	7	3	10	0	1	11	0	0
1	44959984	.	A	G	4	1	5	1	8	14	0	0
1	44959990	.	G	A	0	9	9	1	4	14	0	0
1	44960175	.	T	C	2	6	8	0	2	10	0	0
1	44960660	.	G	A	1	5	6	0	0	6	0	0
1	44960706	.	A	T	6	10	16	0	0	16	0	0
1	44961037	.	C	T	2	4	6	0	1	7	0	0
1	44961055	.	A	C	3	2	5	0	0	5	0	0
1	44961092	.	T	A	0	5	5	0	0	5	0	0
1	44961269	.	C	A	6	3	9	0	0	9	0	0
1	44961563	.	G	A	8	5	13	0	0	13	0	0
1	44961684	.	T	G	7	8	15	0	2	17	0	0
1	44961869	.	C	A	13	6	19	0	1	20	0	0
1	44961899	.	G	A	4	19	23	0	0	23	0	0
1	44961992	.	G	A	7	15	22	0	0	22	0	0
1	44962036	.	T	A	14	9	23	0	0	23	0	0
1	44962358	.	G	A	9	5	14	0	0	14	0	0
1	45003074	.	T	A	0	1	1	0	0	1	0	0
1	45004836	.	C	T	3	6	9	0	0	9	0	0
1	45007424	.	C	T	2	2	4	0	0	4	0	0
1	45011601	.	C	T	3	3	6	0	0	6	0	0
1	45011637	.	A	G	3	3	6	0	0	6	0	0
1	45013760	.	A	G	4	1	5	0	3	8	0	0
1	45013775	.	T	C	5	5	10	0	0	10	0	0
1	45013845	.	G	T	2	3	5	0	1	6	0	0
1	45013850	.	C	T	2	3	5	0	1	6	0	0
1	45013894	.	G	A	4	5	9	0	1	10	0	0
1	45013904	.	G	A	2	6	8	0	0	8	0	0
1	45013965	.	T	C	6	6	12	0	0	12	0	0
1	45014176	.	G	A	12	8	20	0	0	20	0	0
1	45014263	.	A	G	4	14	18	0	1	19	0	0
1	45014361	.	C	A	9	2	11	0	1	12	0	0
1	45014651	.	T	C	8	12	20	0	1	21	0	0
1	45014668	.	A	C	12	7	19	2	0	21	0	0
1	45014692	.	G	C	10	13	23	2	1	26	0	0
1	45014880	.	C	T	11	3	14	0	1	15	0	0
1	45014961	.	G	A	13	15	28	0	2	30	0	0
1	45015693	.	C	T	9	9	18	1	1	20	0	0
1	45015809	.	A	G	5	8	13	0	0	13	0	0
1	45015827	.	G	C	2	6	8	0	0	8	0	0
1	45016070	.	C	T	12	7	19	0	1	20	0	0
1	45016216	.	G	A	5	4	9	0	0	9	0	0
1	45016502	.	T	A	16	15	31	0	0	31	0	0
1	45016691	.	T	A	20	16	36	0	0	36	0	0
1	45016905	.	G	A	29	14	43	0	2	45	0	0
1	45022114	.	G	A	17	14	31	1	1	33	0	0
1	45028423	.	G	T	1	3	4	0	0	4	0	0
1	45038727	.	C	T	2	2	4	0	0	4	0	0
1	45038733	.	G	A	2	2	4	0	0	4	0	0
1	45038963	.	A	C	2	4	6	0	1	7	0	0
1	45038966	.	T	C	5	1	6	0	1	7	0	0
1	45039608	.	T	C	11	4	15	0	0	15	0	0
1	45041152	.	C	T	0	5	5	0	3	8	0	0
1	45047052	.	G	A	34	24	58	0	5	63	0	0
1	45048948	.	G	A	13	17	30	0	0	31	1	0
1	45085212	.	C	T	7	6	13	0	0	13	0	0
1	45086309	.	T	C	13	8	21	0	0	21	0	0
1	45093732	.	A	C	24	20	44	0	3	47	0	0
1	45093762	.	A	G	20	28	48	0	0	48	0	0
1	45093769	.	A	T	21	28	49	0	1	50	0	0
1	45093857	.	A	G	26	14	40	0	1	41	0	0
1	45094987	.	G	A	0	0	0	0	0	0	0	0
1	45095010	.	T	C	0	2	2	1	0	3	0	0
1	45096499	.	T	A	3	1	4	0	1	5	0	0
1	45096651	.	C	T	6	2	8	0	1	9	0	0
1	45208168	.	G	A	13	10	23	0	0	23	0	0
1	45208357	.	A	G	6	9	15	0	0	15	0	0
1	45208360	.	A	T	6	7	13	0	2	16	1	0
1	45208407	.	G	A	4	9	13	0	2	15	0	0
1	45211196	.	C	T	0	4	4	0	1	5	0	0
1	45211220	.	A	T	5	6	11	0	0	11	0	0
1	45211431	.	G	A	10	7	17	0	0	17	0	0
1	45211602	.	G	A	4	6	10	0	1	11	0	0
1	45213290	.	G	A	0	1	1	0	0	1	0	0
1	45243527	.	C	T	1	2	3	0	0	3	0	0
1	45261383	.	G	A	0	1	1	0	0	1	0	0
1	45323214	.	G	A	16	17	33	0	0	33	0	0
1	45324264	.	T	A	2	1	3	0	0	3	0	0
1	45324275	.	G	C	2	2	4	0	0	4	0	0
1	45327405	.	T	C	6	6	12	0	1	13	0	0
1	45330165	.	A	C	22	17	39	0	4	43	0	0
1	45330174	.	C	T	27	16	43	0	3	46	0	0
1	45330207	.	C	T	16	18	34	0	3	37	0	0
1	45330235	.	A	C	16	18	34	0	2	36	0	0
1	45330285	.	C	T	18	19	37	0	0	37	0	0
1	45330386	.	T	G	15	1	16	0	13	29	0	0
1	45332721	.	C	T	4	2	6	0	0	6	0	0
1	45332833	.	A	T	10	9	19	0	2	21	0	0
1	45335160	.	G	A	1	4	5	0	0	5	0	0
1	45337322	.	T	A	2	2	4	0	0	4	0	0
1	45366137	.	A	T	6	5	11	0	0	11	0	0
1	45373795	.	A	G	19	16	35	0	1	36	0	0
1	45373912	.	A	G	14	14	28	0	1	29	0	0
1	45374309	.	C	G	6	10	16	0	0	16	0	0
1	45374847	.	A	T	24	16	40	0	0	40	0	0
1	45375271	.	C	T	6	6	12	0	0	14	2	0
1	45375666	.	G	A	10	8	18	0	1	19	0	0
1	45375790	.	C	A	11	5	16	0	0	16	0	0
1	45376413	.	G	A	17	14	31	0	1	32	0	0
1	45377427	.	C	T	0	15	15	0	11	26	0	0
1	45377883	.	G	A	3	4	7	0	0	7	0	0
1	45383598	.	C	T	5	4	9	0	0	9	0	0
1	45387818	.	T	A	6	4	10	0	1	11	0	0
1	45393404	.	C	T	2	3	5	0	0	5	0	0
1	45393491	.	C	T	0	5	5	0	6	11	0	0
1	45526247	.	C	G	0	3	3	0	2	5	0	0
1	45526337	.	C	A	0	3	3	0	4	7	0	0
1	45526439	.	G	A	4	9	13	0	0	13	0	0
1	45553602	.	G	T	2	3	5	0	2	7	0	0
1	45570225	.	T	A	13	16	29	0	3	32	0	0
1	45570384	.	T	A	9	26	35	0	1	36	0	0
1	45570439	.	A	C	17	0	17	0	13	31	1	0
1	45570523	.	T	C	18	13	31	0	0	31	0	0
1	45574320	.	C	T	1	15	16	0	14	30	0	0
1	45574347	.	T	C	7	1	8	0	16	24	0	0
1	45574650	.	G	A	9	10	19	0	1	20	0	0
1	45575852	.	C	T	0	1	1	0	2	3	0	0
1	45576188	.	C	T	3	5	8	0	0	8	0	0
1	45576800	.	A	C	7	3	10	0	1	11	0	0
1	45577774	.	G	T	7	11	18	0	0	18	0	0
1	45616925	.	G	A	24	18	42	0	0	42	0	0
1	45617226	.	C	A	19	22	41	0	2	43	0	0
1	45617239	.	A	G	21	25	46	0	0	46	0	0
1	45617478	.	T	A	26	28	54	0	3	57	0	0
1	45617577	.	T	A	24	22	46	0	1	47	0	0
1	45617657	.	A	T	22	21	43	0	1	44	0	0
1	45617743	.	C	T	21	19	40	0	2	42	0	0
1	45622431	.	T	C	3	15	18	0	2	20	0	0
1	45624171	.	A	G	13	14	27	0	1	28	0	0
1	45631275	.	T	C	5	1	6	0	6	12	0	0
1	45631469	.	G	A	6	12	18	0	2	20	0	0
1	45661876	.	T	A	2	2	4	0	0	4	0	0
1	45663813	.	C	T	3	7	10	0	0	10	0	0
1	45663869	.	C	T	4	7	11	0	0	11	0	0
1	45663883	.	T	G	3	6	9	0	0	9	0	0
1	45663906	.	C	G	1	7	8	0	0	8	0	0
1	45663968	.	A	G	0	0	0	0	2	2	0	0
1	45664158	.	A	G	14	1	15	0	9	24	0	0
1	45664224	.	C	T	17	23	40	0	2	42	0	0
1	45668727	.	T	A	14	12	26	0	1	27	0	0
1	45668754	.	C	T	11	12	23	0	0	23	0	0
1	45668943	.	G	A	8	7	15	0	0	15	0	0
1	45668944	.	A	G	8	7	15	0	0	15	0	0
1	45668988	.	T	C	0	5	5	0	0	5	0	0
1	45669066	.	A	T	7	6	13	0	1	14	0	0
1	45669157	.	A	T	9	10	19	0	4	23	0	0
1	45696262	.	G	A	0	2	2	0	2	4	0	0
1	45697194	.	G	A	2	2	4	0	0	4	0	0
1	45697449	.	T	A	6	3	9	0	0	9	0	0
1	45699930	.	C	T	4	4	8	0	0	8	0	0
1	45699993	.	C	T	4	4	8	0	0	8	0	0
1	45736412	.	A	C	3	6	9	0	0	9	0	0
1	45736686	.	C	A	1	2	3	0	1	4	0	0
1	45736743	.	C	T	6	4	10	0	1	11	0	0
1	45737493	.	T	C	8	9	17	0	0	17	0	0
1	45738289	.	A	G	5	6	11	0	0	11	0	0
1	45738354	.	A	T	6	9	15	0	1	16	0	0
1	45738417	.	G	A	0	7	7	0	8	15	0	0
1	45738528	.	C	T	6	3	9	0	0	9	0	0
1	45741220	.	A	G	2	0	2	0	7	9	0	0
1	45742093	.	C	T	3	2	5	0	0	5	0	0
1	45742640	.	T	C	5	4	9	0	0	9	0	0
1	45742715	.	T	G	3	2	5	0	0	5	0	0
1	45742777	.	C	G	1	6	7	0	0	7	0	0
1	45742865	.	G	C	1	2	3	0	0	3	0	0
1	45742866	.	G	T	1	2	3	0	0	3	0	0
1	45743379	.	A	G	0	1	1	0	2	3	0	0
1	45743415	.	A	C	1	3	4	0	0	4	0	0
1	45743584	.	C	T	3	6	9	0	0	9	0	0
1	45744091	.	C	T	7	5	12	0	0	12	0	0
1	45744278	.	A	T	11	8	19	0	0	19	0	0
1	45833011	.	T	A	3	6	9	0	0	9	0	0
1	45833698	.	G	T	0	2	2	0	1	3	0	0
1	45834990	.	A	T	1	5	6	0	0	6	0	0
1	45835389	.	G	A	1	6	7	0	0	7	0	0
1	45835483	.	C	G	4	2	6	0	0	6	0	0
1	45835486	.	G	A	3	4	7	0	0	7	0	0
1	45867362	.	T	C	9	13	22	0	3	25	0	0
1	45867594	.	T	A	4	3	7	0	0	7	0	0
1	45867618	.	A	T	4	12	16	0	1	17	0	0
1	45867759	.	C	T	17	18	35	0	1	36	0	0
1	45867834	.	C	T	20	11	31	0	1	32	0	0
1	45867979	.	C	T	25	5	30	0	2	32	0	0
1	45868737	.	C	T	9	14	23	0	5	28	0	0
1	45869275	.	T	C	12	11	23	0	1	24	0	0
1	45869588	.	A	C	7	15	22	0	1	23	0	0
1	45870133	.	C	A	0	5	5	0	2	7	0	0
1	45870147	.	G	T	1	4	5	0	2	7	0	0
1	45870168	.	G	T	5	3	8	0	0	8	0	0
1	45870223	.	A	G	4	4	8	0	0	8	0	0
1	45870438	.	C	T	7	5	12	0	1	13	0	0
1	45870483	.	C	T	5	2	7	0	0	7	0	0
1	45870644	.	A	G	3	3	6	0	0	6	0	0
1	45871331	.	T	C	7	6	13	0	0	13	0	0
1	45871721	.	A	G	2	1	3	0	0	3	0	0
1	45879827	.	G	A	1	3	4	0	1	5	0	0
1	45892097	.	G	A	4	2	6	0	0	6	0	0
1	45892556	.	G	A	0	1	1	0	0	1	0	0
1	45894743	.	A	G	3	5	8	0	0	8	0	0
1	45895273	.	G	A	1	0	1	0	0	1	0	0
1	45897970	.	G	A	0	1	1	0	0	1	0	0
1	45901828	.	G	A	1	0	1	0	0	1	0	0
1	45901870	.	A	G	1	2	3	0	0	3	0	0
1	45902020	.	G	C	1	0	1	0	0	1	0	0
1	45913760	.	G	C	1	0	1	0	0	1	0	0
1	45923230	.	C	T	3	2	5	0	0	5	0	0
1	45923905	.	A	G	1	0	1	0	2	3	0	0
1	45935510	.	G	A	10	4	14	0	0	14	0	0
1	45935642	.	T	C	4	4	8	0	1	9	0	0
1	45935729	.	C	T	6	8	14	0	1	15	0	0
1	45935816	.	G	A	0	8	8	0	5	13	0	0
1	45935849	.	G	A	2	6	8	0	1	9	0	0
1	45937624	.	T	C	1	1	2	0	0	2	0	0
1	45937639	.	A	G	2	1	3	0	0	3	0	0
1	45939802	.	G	A	0	2	2	0	3	5	0	0
1	45939811	.	A	G	2	0	2	0	3	5	0	0
1	45941557	.	G	A	5	4	9	0	0	9	0	0
1	45944040	.	C	A	2	2	4	0	0	4	0	0
1	45944239	.	A	G	3	2	5	0	0	5	0	0
1	45944281	.	A	G	2	0	2	0	0	2	0	0
1	45946462	.	T	C	4	3	7	0	0	7	0	0
1	45947868	.	C	T	3	3	6	0	0	6	0	0
1	45947875	.	G	T	3	3	6	0	0	6	0	0
1	45948157	.	G	A	5	5	10	0	0	10	0	0
1	45952797	.	C	T	2	1	3	0	1	4	0	0
1	45953009	.	C	T	6	5	11	0	0	11	0	0
1	45955464	.	C	G	1	0	1	0	6	7	0	0
1	45956166	.	G	T	15	5	20	0	0	20	0	0
1	45956241	.	T	C	11	6	17	0	0	17	0	0
1	46001390	.	T	G	0	0	0	0	1	1	0	0
1	46002208	.	G	A	2	5	7	0	1	8	0	0
1	46004859	.	C	A	1	3	4	0	0	4	0	0
1	46004865	.	A	G	1	0	1	0	4	5	0	0
1	46006657	.	T	A	1	2	3	0	0	3	0	0
1	46010519	.	G	A	8	7	15	0	0	15	0	0
1	46010561	.	T	C	0	2	2	0	0	2	0	0
1	46010564	.	G	C	0	2	2	0	0	2	0	0
1	46019850	.	C	T	4	5	9	0	0	9	0	0
1	46019889	.	G	C	6	7	13	0	2	15	0	0
1	46020530	.	T	C	3	7	10	0	0	10	0	0
1	46020602	.	A	G	1	3	4	0	0	4	0	0
1	46195107	.	A	G	8	0	8	0	17	25	0	0
1	46195284	.	C	T	7	2	9	0	0	9	0	0
1	46195858	.	A	T	4	5	9	0	0	9	0	0
1	46195888	.	T	C	3	5	8	0	0	8	0	0
1	46196056	.	G	A	1	3	4	0	0	4	0	0
1	46263895	.	T	C	13	6	19	0	3	22	0	0
1	46263949	.	T	G	11	7	18	0	2	20	0	0
1	46264213	.	G	A	24	13	37	0	3	40	0	0
1	46264335	.	A	T	9	18	27	0	0	27	0	0
1	46265082	.	G	A	5	6	11	0	1	12	0	0
1	46265108	.	T	C	6	1	7	0	3	10	0	0
1	46265245	.	C	T	8	10	18	0	2	20	0	0
1	46265583	.	C	A	4	2	6	0	0	6	0	0
1	46266020	.	G	A	12	7	19	0	0	19	0	0
1	46266069	.	A	T	8	11	19	0	2	21	0	0
1	46266070	.	T	G	8	13	21	0	0	21	0	0
1	46266232	.	A	G	6	8	14	0	1	15	0	0
1	46266283	.	G	A	3	9	12	0	0	12	0	0
1	46266372	.	A	G	5	4	9	0	0	9	0	0
1	46266413	.	C	A	2	4	6	0	0	6	0	0
1	46266489	.	C	G	3	0	3	0	0	5	2	0
1	46266519	.	C	T	4	5	9	0	1	10	0	0
1	46267845	.	T	A	5	3	8	0	0	8	0	0
1	46267907	.	T	A	6	5	11	0	1	12	0	0
1	46267926	.	G	A	8	4	12	0	1	13	0	0
1	46267998	.	G	C	5	3	8	0	0	8	0	0
1	46268037	.	C	T	1	5	6	0	4	10	0	0
1	46268094	.	G	A	3	5	8	0	0	8	0	0
1	46268221	.	T	G	3	2	5	0	0	5	0	0
1	46268309	.	C	A	2	5	7	0	0	7	0	0
1	46268333	.	G	A	4	3	7	0	0	7	0	0
1	46268771	.	A	T	1	7	8	0	0	8	0	0
1	46268796	.	A	G	5	2	7	0	0	7	0	0
1	46268833	.	C	T	3	2	5	0	0	5	0	0
1	46268901	.	A	G	1	5	6	0	0	6	0	0
1	46268915	.	C	T	1	4	5	0	0	5	0	0
1	46269103	.	C	T	0	3	3	0	1	4	0	0
1	46269115	.	G	T	3	1	4	0	0	4	0	0
1	46269299	.	C	T	0	5	5	0	4	9	0	0
1	46269643	.	T	C	3	3	6	0	0	6	0	0
1	46329501	.	G	A	1	1	2	0	0	2	0	0
1	46407882	.	A	G	1	0	1	0	0	1	0	0
1	46412256	.	A	G	0	1	1	0	0	1	0	0
1	46444433	.	T	C	0	3	3	0	0	3	0	0
1	46446613	.	C	T	8	5	13	0	0	13	0	0
1	46449433	.	T	A	1	3	4	0	0	4	0	0
1	46449647	.	A	T	7	3	10	0	0	10	0	0
1	46449800	.	C	G	12	5	17	0	0	17	0	0
1	46450177	.	A	T	4	8	12	0	0	12	0	0
1	46557467	.	C	T	1	0	1	0	1	2	0	0
1	46582562	.	T	C	5	5	10	0	2	12	0	0
1	46590147	.	C	T	6	3	9	0	0	9	0	0
1	46593987	.	T	G	13	11	24	0	0	24	0	0
1	46598819	.	C	T	6	11	17	0	0	17	0	0
1	46611975	.	C	T	15	13	28	0	1	29	0	0
1	46611999	.	C	T	18	11	29	0	0	29	0	0
1	46613489	.	C	T	4	3	7	0	0	7	0	0
1	46615881	.	G	A	15	11	26	0	2	28	0	0
1	46616015	.	G	A	22	11	33	0	2	35	0	0
1	46616152	.	T	C	19	14	33	0	3	36	0	0
1	46616343	.	A	T	19	24	43	0	1	44	0	0
1	46616736	.	T	C	6	7	13	0	1	14	0	0
1	46616863	.	C	T	14	21	35	0	1	36	0	0
1	46617141	.	G	A	2	7	9	0	12	21	0	0
1	46617203	.	A	T	2	5	7	0	0	7	0	0
1	46617346	.	G	A	4	7	11	0	0	11	0	0
1	46617591	.	A	G	3	6	9	0	0	9	0	0
1	46619720	.	C	T	3	4	7	0	0	7	0	0
1	46624268	.	C	G	3	4	7	0	0	7	0	0
1	46624295	.	C	T	4	6	10	0	0	10	0	0
1	46624693	.	A	G	2	3	5	0	0	5	0	0
1	46624696	.	T	C	2	3	5	0	0	5	0	0
1	46629186	.	G	A	2	4	6	0	0	6	0	0
1	46632794	.	G	A	2	1	3	0	0	3	0	0
1	46632796	.	C	G	0	1	1	0	2	3	0	0
1	46636184	.	G	A	6	7	13	0	1	14	0	0
1	46639366	.	A	G	0	1	1	0	0	1	0	0
1	46639464	.	A	G	0	1	1	0	0	1	0	0
1	46640041	.	G	A	2	2	4	0	0	4	0	0
1	46666782	.	A	G	5	5	10	0	1	11	0	0
1	46667668	.	A	G	13	18	31	0	0	31	0	0
1	46668740	.	G	A	7	15	22	0	3	25	0	0
1	46668747	.	T	A	12	14	26	0	1	27	0	0
1	46668901	.	C	T	1	24	25	0	18	43	0	0
1	46669151	.	G	A	8	4	12	0	1	13	0	0
1	46675798	.	G	A	4	10	14	0	0	14	0	0
1	46710699	.	A	G	11	8	19	0	2	21	0	0
1	46710960	.	A	G	10	11	21	0	0	21	0	0
1	46711002	.	C	T	16	13	29	0	0	29	0	0
1	46711043	.	C	A	0	11	11	0	13	24	0	0
1	46711175	.	A	G	2	1	3	0	0	3	0	0
1	46715534	.	A	T	6	6	12	0	0	12	0	0
1	46718259	.	C	T	12	11	23	0	0	23	0	0
1	46718281	.	C	T	13	7	20	0	1	21	0	0
1	46725909	.	C	T	7	19	26	0	0	26	0	0
1	46830855	.	G	T	1	2	3	0	0	3	0	0
1	46830911	.	A	G	1	2	3	0	0	3	0	0
1	46831057	.	C	A	5	8	13	0	0	13	0	0
1	46831091	.	G	A	9	5	14	0	2	16	0	0
1	46831168	.	C	T	8	7	15	0	1	16	0	0
1	46831258	.	T	C	6	7	13	0	0	13	0	0
1	46831357	.	G	A	14	8	22	0	0	22	0	0
1	46831481	.	C	T	0	8	8	0	9	17	0	0
1	46831516	.	C	T	0	10	10	0	2	12	0	0
1	46837955	.	T	A	26	17	43	0	0	43	0	0
1	46838048	.	T	A	21	17	38	0	1	39	0	0
1	46838050	.	A	G	17	20	37	0	2	39	0	0
1	46838194	.	C	G	1	15	16	0	18	34	0	0
1	46838219	.	T	C	18	17	35	0	0	35	0	0
1	46838432	.	A	C	22	25	47	0	1	48	0	0
1	46838768	.	G	C	6	1	7	0	11	18	0	0
1	46841702	.	A	C	5	0	5	0	9	14	0	0
1	46841783	.	G	A	14	8	22	0	1	23	0	0
1	46857049	.	G	A	0	1	1	0	0	1	0	0
1	46857229	.	C	A	6	4	10	0	1	11	0	0
1	46875315	.	G	A	3	5	8	0	0	8	0	0
1	46875336	.	A	G	4	7	11	0	0	11	0	0
1	46875477	.	A	G	4	2	6	0	1	7	0	0
1	46964105	.	A	G	3	8	11	0	0	11	0	0
1	46967055	.	T	C	3	0	3	0	10	13	0	0
1	46971205	.	A	G	5	1	6	0	0	6	0	0
1	46973771	.	T	C	2	1	3	0	0	3	0	0
1	46973819	.	T	C	2	0	2	0	2	4	0	0
1	46974494	.	A	T	2	2	4	0	0	4	0	0
1	46986915	.	C	T	0	1	1	0	2	3	0	0
1	46986949	.	C	T	0	1	1	0	0	1	0	0
1	46989218	.	C	T	2	2	4	0	0	4	0	0
1	46989351	.	G	A	2	1	3	0	1	4	0	0
1	46989471	.	G	A	2	3	5	0	0	5	0	0
1	46999673	.	G	A	10	8	18	0	1	19	0	0
1	46999750	.	G	A	12	15	27	0	0	27	0	0
1	46999838	.	C	G	0	4	4	0	15	19	0	0
1	47002506	.	C	T	0	3	3	0	0	3	0	0
1	47004889	.	C	T	0	2	2	0	4	6	0	0
1	47005189	.	G	A	1	1	2	0	0	2	0	0
1	47007121	.	C	T	0	1	1	0	3	4	0	0
1	47019042	.	A	T	6	3	9	0	2	11	0	0
1	47019906	.	C	T	0	8	8	0	9	17	0	0
1	47022573	.	G	A	7	9	16	0	0	16	0	0
1	47022576	.	C	T	9	9	18	0	0	18	0	0
1	47025282	.	C	A	2	0	2	0	0	2	0	0
1	47025442	.	T	C	2	2	4	0	0	4	0	0
1	47025457	.	G	T	2	3	5	0	0	5	0	0
1	47025487	.	T	C	5	4	9	0	0	9	0	0
1	47031372	.	T	C	0	0	0	0	2	2	0	0
1	47047232	.	G	A	4	4	8	0	0	8	0	0
1	47047289	.	C	T	0	6	6	0	5	11	0	0
1	47051640	.	A	G	4	3	7	0	0	7	0	0
1	47056998	.	G	A	1	0	1	0	1	2	0	0
1	47091632	.	T	G	0	3	3	0	0	3	0	0
1	47091796	.	T	A	1	3	4	0	0	4	0	0
1	47091801	.	G	T	0	3	3	0	1	4	0	0
1	47095736	.	G	A	0	1	1	0	0	1	0	0
1	47095772	.	G	A	0	4	4	0	4	8	0	0
1	47095814	.	G	A	1	6	7	0	5	12	0	0
1	47098897	.	C	T	3	4	7	0	0	7	0	0
1	47099548	.	G	A	2	4	6	0	0	6	0	0
1	47104622	.	G	A	0	3	3	0	8	11	0	0
1	47104637	.	G	A	9	3	12	0	0	12	0	0
1	47104660	.	T	C	6	3	9	0	0	9	0	0
1	47104807	.	A	G	3	3	6	0	0	6	0	0
1	47104812	.	T	G	2	1	3	0	2	5	0	0
1	47105163	.	A	T	3	2	5	0	0	5	0	0
1	47106407	.	A	T	0	3	3	0	0	3	0	0
1	47106522	.	C	T	6	6	12	0	4	16	0	0
1	47106551	.	G	C	11	5	16	0	0	16	0	0
1	47106614	.	A	C	12	11	23	0	0	23	0	0
1	47106668	.	G	C	13	7	20	0	0	20	0	0
1	47106677	.	T	C	13	6	19	0	0	19	0	0
1	47108653	.	T	C	0	1	1	0	0	1	0	0
1	47111469	.	A	T	7	4	11	0	1	12	0	0
1	47113442	.	G	A	0	1	1	0	0	1	0	0
1	47116758	.	T	C	5	10	15	0	0	15	0	0
1	47116910	.	T	C	6	0	6	0	4	10	0	0
1	47120353	.	G	T	0	8	8	0	0	8	0	0
1	47120379	.	T	A	2	11	13	0	0	13	0	0
1	47120514	.	A	T	1	1	2	0	0	2	0	0
1	47120516	.	C	T	2	0	2	0	0	2	0	0
1	47120622	.	G	C	0	0	0	1	0	1	0	0
1	47129497	.	C	A	4	2	6	0	0	6	0	0
1	47129498	.	C	A	4	2	6	0	0	6	0	0
1	47130068	.	A	T	4	29	33	0	1	34	0	0
1	47132160	.	A	G	8	9	17	1	0	18	0	0
1	47134498	.	G	T	1	2	3	0	0	3	0	0
1	47135165	.	G	A	1	10	11	0	1	12	0	0
1	47135166	.	G	A	0	11	11	0	1	12	0	0
1	47159025	.	G	C	3	3	6	0	0	6	0	0
1	47160689	.	C	T	1	1	2	0	1	3	0	0
1	47166076	.	G	A	5	3	8	0	0	8	0	0
1	47166256	.	G	A	3	4	7	0	0	7	0	0
1	47168422	.	T	C	4	2	6	0	0	6	0	0
1	47169895	.	C	T	2	5	7	0	1	8	0	0
1	47169932	.	G	A	6	4	10	0	0	10	0	0
1	47170006	.	C	T	5	3	8	0	0	8	0	0
1	47170378	.	A	C	7	3	10	0	0	10	0	0
1	47170406	.	C	T	5	4	9	0	0	9	0	0
1	47170431	.	T	C	4	5	9	0	1	10	0	0
1	47170514	.	G	T	0	7	7	0	3	10	0	0
1	47170515	.	G	A	3	7	10	0	0	10	0	0
1	47170549	.	G	T	2	4	6	0	1	7	0	0
1	47170640	.	G	A	1	2	3	0	1	4	0	0
1	47170695	.	C	T	3	4	7	0	0	7	0	0
1	47171266	.	C	T	5	4	9	0	0	9	0	0
1	47171298	.	A	C	4	7	11	0	0	11	0	0
1	47171658	.	T	C	5	3	8	1	0	9	0	0
1	47171673	.	T	A	6	3	9	0	0	9	0	0
1	47172103	.	G	A	0	10	10	0	9	19	0	0
1	47172236	.	T	A	3	5	8	0	1	9	0	0
1	47172250	.	G	A	6	2	8	0	0	8	0	0
1	47172358	.	G	A	5	2	7	0	1	8	0	0
1	47172426	.	G	A	6	5	11	0	1	12	0	0
1	47172465	.	G	A	5	8	13	0	0	13	0	0
1	47172470	.	T	A	4	7	11	0	0	11	0	0
1	47172573	.	C	T	10	6	16	0	0	16	0	0
1	47172873	.	A	C	7	8	15	0	0	15	0	0
1	47172909	.	G	T	3	5	8	0	1	9	0	0
1	47335109	.	G	C	5	4	9	0	0	9	0	0
1	47398117	.	G	A	0	0	0	0	1	1	0	0
1	47405202	.	A	C	2	3	5	0	0	5	0	0
1	47406177	.	A	T	3	3	6	0	0	6	0	0
1	47406936	.	G	A	13	9	22	0	2	24	0	0
1	47407541	.	C	T	12	6	18	0	0	18	0	0
1	47407601	.	C	T	10	8	18	0	0	18	0	0
1	47407607	.	T	C	10	8	18	0	0	18	0	0
1	47408802	.	C	T	3	12	15	0	3	18	0	0
1	47409873	.	C	A	14	12	26	0	0	26	0	0
1	47410043	.	G	A	0	11	11	0	7	18	0	0
1	47505064	.	T	A	0	1	1	0	0	1	0	0
1	47506986	.	C	T	10	1	11	0	0	11	0	0
1	47510820	.	G	A	5	8	13	0	1	14	0	0
1	47679785	.	T	C	0	2	2	0	0	2	0	0
1	47679833	.	C	T	0	2	2	0	0	2	0	0
1	47684279	.	G	A	0	2	2	0	1	3	0	0
1	47686089	.	G	A	3	4	7	0	0	7	0	0
1	47686101	.	T	A	2	3	5	0	0	5	0	0
1	47686428	.	T	A	2	2	4	0	0	4	0	0
1	47686593	.	A	G	2	2	4	0	1	5	0	0
1	47686681	.	A	C	5	3	8	0	0	8	0	0
1	47703654	.	C	T	3	5	8	0	0	8	0	0
1	47716051	.	G	A	0	1	1	0	0	1	0	0
1	47840654	.	G	T	1	2	3	0	0	3	0	0
1	48583000	.	T	C	11	9	20	0	0	20	0	0
1	48583115	.	T	C	2	4	6	0	0	6	0	0
1	48583117	.	T	C	4	2	6	0	0	6	0	0
1	49482081	.	T	C	8	2	10	0	1	11	0	0
1	49483560	.	T	C	10	4	14	0	1	15	0	0
1	49902847	.	C	T	12	4	16	0	2	18	0	0
1	51230106	.	T	C	3	6	9	0	0	9	0	0
1	51449548	.	T	A	5	2	7	0	0	7	0	0
1	52073807	.	C	G	0	1	1	0	0	1	0	0
1	52111494	.	C	T	8	13	21	0	0	21	0	0
1	52113225	.	T	C	2	1	3	0	4	7	0	0
1	52115880	.	G	C	5	2	7	0	1	8	0	0
1	52117007	.	T	C	1	0	1	0	1	2	0	0
1	52117112	.	C	G	0	1	1	0	0	1	0	0
1	52121275	.	G	T	1	2	3	0	0	3	0	0
1	52121311	.	A	G	4	5	9	0	0	9	0	0
1	52121404	.	C	T	6	11	17	0	0	17	0	0
1	52121405	.	T	G	6	11	17	0	0	17	0	0
1	52128305	.	T	G	2	8	10	0	0	10	0	0
1	52130225	.	A	T	14	12	26	0	2	28	0	0
1	52130268	.	G	A	1	9	10	0	12	22	0	0
1	52130328	.	T	C	7	7	14	0	4	18	0	0
1	52130347	.	T	A	9	7	16	0	2	18	0	0
1	52130372	.	C	G	11	6	17	0	1	18	0	0
1	52134992	.	G	A	2	4	6	0	0	6	0	0
1	52135185	.	T	C	16	17	33	0	1	34	0	0
1	52135254	.	T	C	17	9	26	0	1	27	0	0
1	52135303	.	T	C	7	13	20	0	0	20	0	0
1	52135384	.	T	C	9	10	19	0	0	19	0	0
1	52135572	.	G	T	5	7	12	0	0	12	0	0
1	52135690	.	A	G	3	2	5	0	0	5	0	0
1	52135862	.	A	G	14	9	23	0	0	23	0	0
1	52135928	.	G	C	12	9	21	0	1	22	0	0
1	52135971	.	T	A	13	9	22	0	0	22	0	0
1	52135997	.	G	A	14	7	21	0	1	22	0	0
1	52136190	.	G	A	15	9	24	0	1	25	0	0
1	52136323	.	G	A	10	9	19	0	2	21	0	0
1	52136379	.	T	A	5	14	19	0	0	19	0	0
1	52136454	.	A	C	11	8	19	0	2	21	0	0
1	52136762	.	A	C	19	19	38	0	1	39	0	0
1	52136917	.	A	C	11	16	27	0	5	32	0	0
1	52136974	.	T	A	12	16	28	0	0	28	0	0
1	52137013	.	T	A	8	15	23	0	0	23	0	0
1	52139909	.	T	A	0	2	2	0	0	2	0	0
1	52146021	.	A	T	10	4	14	0	2	16	0	0
1	52149619	.	A	C	22	12	34	0	2	36	0	0
1	52149952	.	A	G	10	0	10	0	9	19	0	0
1	52150029	.	T	C	8	14	22	0	1	23	0	0
1	52150674	.	A	G	12	3	15	0	0	15	0	0
1	52150680	.	A	G	12	3	15	0	1	16	0	0
1	52150974	.	A	G	10	6	16	0	1	17	0	0
1	52151740	.	G	A	0	13	13	0	16	29	0	0
1	52151882	.	A	G	18	10	28	0	0	28	0	0
1	52152043	.	A	G	2	7	9	0	0	9	0	0
1	52152050	.	A	G	5	5	10	0	0	10	0	0
1	52152398	.	T	C	14	14	28	0	0	28	0	0
1	52152406	.	A	C	14	14	28	0	1	29	0	0
1	52152617	.	C	T	20	23	43	0	2	45	0	0
1	52198239	.	G	A	0	4	4	0	0	4	0	0
1	52198416	.	T	C	2	0	2	0	3	5	0	0
1	52452068	.	C	A	0	2	2	0	1	3	0	0
1	52452116	.	C	G	5	5	10	0	0	10	0	0
1	52452197	.	G	A	5	12	17	0	0	17	0	0
1	52452275	.	G	T	8	6	14	0	3	17	0	0
1	52455885	.	C	G	1	1	2	0	0	2	0	0
1	52455908	.	G	A	6	5	11	0	1	12	0	0
1	52455960	.	C	T	8	9	17	0	0	17	0	0
1	52456002	.	G	A	3	0	3	0	0	3	0	0
1	52460737	.	C	T	9	12	21	0	2	23	0	0
1	52460739	.	T	C	9	13	22	0	1	23	0	0
1	52460906	.	T	C	7	3	10	0	0	10	0	0
1	52460944	.	G	T	11	5	16	0	0	16	0	0
1	52461114	.	A	G	8	8	16	0	0	16	0	0
1	52461183	.	C	T	6	4	10	0	1	11	0	0
1	52461195	.	G	A	7	4	11	0	0	11	0	0
1	52475955	.	C	T	3	2	5	0	0	5	0	0
1	52476011	.	C	T	7	1	8	0	0	8	0	0
1	52478381	.	C	T	6	3	9	0	0	9	0	0
1	52478513	.	C	T	3	4	7	0	0	7	0	0
1	52478600	.	A	T	2	3	5	0	0	5	0	0
1	52489974	.	G	A	0	9	9	0	6	15	0	0
1	52499807	.	A	G	5	4	9	0	0	9	0	0
1	52599557	.	C	T	2	2	4	0	0	4	0	0
1	52611769	.	G	T	0	2	2	0	1	3	0	0
1	52611963	.	A	G	1	2	3	0	0	3	0	0
1	52613759	.	T	C	4	6	10	0	2	12	0	0
1	52615842	.	T	A	1	2	3	0	1	4	0	0
1	52615845	.	T	C	1	3	4	0	0	4	0	0
1	52618138	.	G	A	0	2	2	0	8	10	0	0
1	52618168	.	G	A	0	5	5	0	10	15	0	0
1	52618204	.	T	C	5	1	6	0	1	7	0	0
1	52623681	.	G	A	14	6	20	0	2	22	0	0
1	52623783	.	C	T	10	7	17	0	0	17	0	0
1	52625804	.	T	C	5	6	11	0	0	11	0	0
1	52625807	.	C	T	4	5	9	0	0	9	0	0
1	52626782	.	A	T	10	8	18	0	0	18	0	0
1	52626790	.	C	T	10	8	18	0	1	19	0	0
1	52626922	.	C	T	8	5	13	0	0	13	0	0
1	52626998	.	A	T	13	6	19	0	1	20	0	0
1	52627007	.	T	G	12	6	18	0	2	20	0	0
1	52627568	.	A	T	21	10	31	0	2	34	1	0
1	52627609	.	A	T	29	17	46	0	2	48	0	0
1	52627697	.	T	G	21	21	42	0	2	44	0	0
1	52627984	.	T	C	19	13	32	0	1	33	0	0
1	52628178	.	G	A	0	10	10	0	18	28	0	0
1	52628205	.	T	C	17	7	24	0	1	25	0	0
1	52628305	.	T	C	4	14	18	0	2	20	0	0
1	52656219	.	T	C	0	3	3	0	1	4	0	0
1	52657799	.	T	G	5	4	9	0	1	10	0	0
1	52658972	.	C	A	0	1	1	0	0	1	0	0
1	52659620	.	G	C	0	1	1	0	0	1	0	0
1	52659643	.	T	C	0	2	2	0	0	2	0	0
1	52659680	.	A	C	0	2	2	0	0	2	0	0
1	52679960	.	G	A	4	1	5	0	0	5	0	0
1	52681212	.	T	C	2	2	4	0	0	4	0	0
1	52682895	.	G	A	1	4	5	0	0	5	0	0
1	52688286	.	T	C	1	3	4	0	0	4	0	0
1	52698955	.	C	T	3	4	7	0	1	8	0	0
1	52764873	.	G	T	9	9	18	0	0	18	0	0
1	52764914	.	C	T	15	13	28	0	1	29	0	0
1	52765120	.	T	A	15	12	27	0	0	27	0	0
1	52773239	.	G	A	1	4	5	0	0	5	0	0
1	52775619	.	A	C	7	12	19	0	0	19	0	0
1	52775649	.	A	G	11	20	31	0	0	31	0	0
1	52780566	.	C	T	2	7	9	0	0	9	0	0
1	52782090	.	C	T	5	3	8	0	1	9	0	0
1	52792557	.	A	T	3	3	6	0	0	6	0	0
1	52792564	.	A	T	4	3	7	0	0	7	0	0
1	52792613	.	C	A	7	5	12	0	0	12	0	0
1	52794568	.	T	C	2	1	3	0	0	3	0	0
1	52797110	.	C	T	3	1	4	0	0	4	0	0
1	52797149	.	C	T	4	2	6	0	0	6	0	0
1	52797152	.	T	C	4	2	6	0	0	6	0	0
1	52800088	.	A	C	1	3	4	0	0	4	0	0
1	52811937	.	A	T	4	5	9	0	1	10	0	0
1	52811940	.	C	T	4	5	9	0	1	10	0	0
1	52812219	.	C	G	11	4	15	0	1	16	0	0
1	52813633	.	A	T	13	11	24	0	0	24	0	0
1	52816438	.	C	T	10	7	17	0	0	17	0	0
1	52816740	.	A	T	3	2	5	0	3	8	0	0
1	52816749	.	G	A	0	0	0	0	1	1	0	0
1	52817988	.	C	T	15	10	25	0	4	29	0	0
1	52820489	.	C	T	3	4	7	0	1	8	0	0
1	53007848	.	G	A	0	7	7	0	9	16	0	0
1	53007935	.	A	G	4	9	13	0	0	13	0	0
1	53061153	.	C	G	5	4	9	0	1	10	0	0
1	53099687	.	A	G	5	5	10	0	1	11	0	0
1	53099735	.	C	A	1	0	1	0	0	1	0	0
1	53132842	.	G	C	4	4	8	0	0	8	0	0
1	53132860	.	T	C	0	3	3	0	0	3	0	0
1	53156324	.	A	G	7	7	14	0	1	15	0	0
1	53166056	.	G	T	16	9	25	0	3	28	0	0
1	53168227	.	A	G	8	0	8	0	9	17	0	0
1	53185945	.	T	C	11	15	26	0	2	28	0	0
1	53193288	.	C	T	3	3	6	0	0	6	0	0
1	53198739	.	C	A	1	5	6	0	2	8	0	0
1	53201918	.	G	A	0	2	2	0	4	6	0	0
1	53238395	.	G	A	0	0	0	0	1	1	0	0
1	53238404	.	G	T	0	1	1	0	0	1	0	0
1	53266995	.	G	C	3	2	5	2	1	8	0	0
1	53266998	.	C	A	3	3	6	2	0	8	0	0
1	53267349	.	A	G	7	9	16	0	0	16	0	0
1	53269694	.	A	G	0	3	3	0	0	3	0	0
1	53273488	.	A	G	1	5	6	0	0	6	0	0
1	53277043	.	T	C	6	4	10	0	1	11	0	0
1	53277064	.	C	T	6	4	10	0	1	11	0	0
1	53296732	.	C	T	1	1	2	0	0	2	0	0
1	53338551	.	T	C	0	1	1	0	0	1	0	0
1	53338602	.	T	C	2	2	4	0	0	4	0	0
1	53338623	.	C	T	2	1	3	0	0	3	0	0
1	53341664	.	A	G	1	0	1	0	0	1	0	0
1	53343530	.	T	C	2	5	7	0	0	7	0	0
1	53344200	.	T	C	0	6	6	0	0	6	0	0
1	53344204	.	T	G	1	6	7	0	0	7	0	0
1	53344250	.	T	A	3	5	8	0	0	8	0	0
1	53344259	.	T	A	3	3	6	0	0	6	0	0
1	53348848	.	T	C	1	3	4	0	0	4	0	0
1	53348878	.	A	G	3	4	7	0	1	8	0	0
1	53350703	.	T	C	1	0	1	0	0	1	0	0
1	53352481	.	T	C	1	1	2	0	0	2	0	0
1	53359876	.	A	G	1	0	1	0	2	3	0	0
1	53360153	.	T	C	5	11	16	0	1	17	0	0
1	53360474	.	G	T	16	12	28	0	2	30	0	0
1	53360549	.	T	C	11	16	27	0	1	28	0	0
1	53360821	.	G	A	0	12	12	0	8	20	0	0
1	53364716	.	A	G	22	14	36	0	7	44	1	0
1	53364929	.	A	G	15	19	34	0	2	36	0	0
1	53364948	.	C	A	12	22	34	0	0	34	0	0
1	53381877	.	T	C	2	1	3	0	0	3	0	0
1	53385087	.	A	G	3	0	3	0	1	4	0	0
1	53387431	.	T	A	3	8	11	0	1	12	0	0
1	53387466	.	C	T	1	5	6	0	1	7	0	0
1	53387990	.	T	C	6	7	13	0	1	14	0	0
1	53388005	.	T	C	5	9	14	0	1	15	0	0
1	53388053	.	G	A	0	10	10	0	4	14	0	0
1	53388096	.	T	A	6	11	17	0	0	17	0	0
1	53388097	.	G	T	6	11	17	0	0	17	0	0
1	53388272	.	T	C	6	8	14	0	0	14	0	0
1	53388367	.	T	A	5	10	15	0	3	18	0	0
1	53388476	.	A	C	2	14	16	0	0	16	0	0
1	53388590	.	T	G	9	18	27	0	1	28	0	0
1	53388861	.	A	G	5	8	13	0	0	13	0	0
1	53391729	.	T	C	12	0	12	0	4	16	0	0
1	53391760	.	G	A	13	3	16	0	1	17	0	0
1	53392161	.	T	C	8	5	13	0	1	14	0	0
1	53392220	.	C	A	0	4	4	0	10	14	0	0
1	53394306	.	A	T	2	3	5	0	0	5	0	0
1	53394427	.	T	A	2	2	4	0	0	4	0	0
1	53394746	.	T	A	2	2	4	0	0	4	0	0
1	53395011	.	T	C	1	2	3	0	1	4	0	0
1	53395012	.	G	A	1	3	4	0	0	4	0	0
1	53395124	.	T	G	3	1	4	0	0	4	0	0
1	53395328	.	C	T	1	1	2	0	1	3	0	0
1	53395507	.	C	T	2	2	4	0	0	4	0	0
1	53395710	.	G	C	3	3	6	0	0	6	0	0
1	53403876	.	T	A	3	2	5	0	0	5	0	0
1	53491678	.	A	C	8	4	12	0	3	15	0	0
1	53491799	.	T	G	4	4	8	0	2	10	0	0
1	53491964	.	T	A	11	5	16	0	5	21	0	0
1	53501909	.	C	G	13	13	26	0	2	28	0	0
1	53501918	.	G	A	13	13	26	0	1	27	0	0
1	53568386	.	T	C	5	7	12	0	1	13	0	0
1	53568515	.	G	T	5	12	17	0	1	18	0	0
1	53568846	.	A	T	10	11	21	0	1	22	0	0
1	53570142	.	T	C	1	5	6	0	1	7	0	0
1	53572772	.	T	A	1	0	1	0	0	1	0	0
1	53575478	.	C	A	2	0	2	0	0	2	0	0
1	53578523	.	T	A	2	5	7	0	0	7	0	0
1	53579023	.	A	G	5	12	17	0	1	18	0	0
1	53581312	.	G	A	2	0	2	0	1	3	0	0
1	53581340	.	T	C	5	2	7	0	1	8	0	0
1	53581492	.	G	A	5	5	10	0	0	10	0	0
1	53584411	.	C	A	5	1	6	0	1	7	0	0
1	53594734	.	T	C	1	1	2	0	0	2	0	0
1	53604461	.	A	T	1	3	4	0	0	4	0	0
1	53659267	.	A	C	2	2	4	0	0	4	0	0
1	53663391	.	G	A	4	8	12	0	0	12	0	0
1	53663478	.	G	T	1	1	2	0	0	2	0	0
1	53663487	.	C	T	0	1	1	0	0	1	0	0
1	53664677	.	C	G	2	2	4	0	0	4	0	0
1	53665339	.	C	T	2	2	4	0	0	4	0	0
1	53666888	.	A	G	1	2	3	0	1	4	0	0
1	53667026	.	A	T	4	4	8	0	0	8	0	0
1	53667080	.	T	C	3	3	6	0	0	6	0	0
1	53670917	.	G	T	0	1	1	0	0	1	0	0
1	53671009	.	A	G	1	0	1	0	0	1	0	0
1	53672795	.	G	A	4	3	7	0	0	7	0	0
1	53677131	.	C	T	2	2	4	0	0	4	0	0
1	53684632	.	A	G	3	2	5	0	0	5	0	0
1	53701875	.	A	G	4	13	17	0	1	18	0	0
1	53701907	.	C	T	2	3	5	0	0	5	0	0
1	53703194	.	G	T	17	16	33	0	2	35	0	0
1	53704530	.	A	G	2	3	5	0	0	5	0	0
1	53705221	.	G	A	9	18	27	0	5	32	0	0
1	53705266	.	A	G	14	19	33	0	2	35	0	0
1	53707177	.	G	C	2	0	2	0	4	6	0	0
1	53709732	.	C	A	0	15	15	0	14	29	0	0
1	53709858	.	A	T	6	8	14	0	1	15	0	0
1	53709882	.	G	A	4	5	9	0	0	9	0	0
1	53714592	.	T	G	2	0	2	0	0	2	0	0
1	53714727	.	C	A	14	22	36	0	1	37	0	0
1	53714733	.	C	T	16	20	36	0	0	37	1	0
1	53720360	.	T	G	0	2	2	0	0	2	0	0
1	53724775	.	G	A	0	3	3	0	1	4	0	0
1	53729997	.	C	T	0	4	4	0	0	4	0	0
1	53735648	.	A	G	10	17	27	0	1	28	0	0
1	53735977	.	G	C	3	0	3	0	8	11	0	0
1	53737199	.	G	A	9	9	18	0	0	18	0	0
1	53953068	.	A	C	1	0	1	0	0	1	0	0
1	54244432	.	T	C	2	1	3	0	0	3	0	0
1	54255786	.	A	G	3	9	12	0	1	13	0	0
1	54255804	.	G	C	0	10	10	0	5	15	0	0
1	54255822	.	C	T	6	6	12	0	0	12	0	0
1	54264832	.	G	A	0	3	3	0	1	4	0	0
1	54264835	.	G	T	1	4	5	0	0	5	0	0
1	54271276	.	A	G	6	0	6	0	5	11	0	0
1	54271282	.	C	T	6	5	11	0	0	11	0	0
1	54273753	.	A	G	9	0	9	0	15	24	0	0
1	54273824	.	A	G	6	12	18	0	1	19	0	0
1	54274038	.	G	C	10	20	30	0	2	32	0	0
1	54274049	.	G	A	8	19	27	0	5	32	0	0
1	54274125	.	T	C	17	11	28	0	2	30	0	0
1	54274143	.	T	A	18	8	26	0	1	27	0	0
1	54274509	.	A	T	10	3	13	0	1	14	0	0
1	54274554	.	A	G	8	5	13	0	3	16	0	0
1	54274611	.	T	G	14	6	20	0	1	21	0	0
1	54614504	.	A	G	1	2	3	0	0	3	0	0
1	54614517	.	C	T	1	3	4	0	0	4	0	0
1	54617192	.	T	A	0	1	1	0	0	1	0	0
1	54618763	.	G	A	2	2	4	0	0	4	0	0
1	54674086	.	C	T	1	2	3	0	0	3	0	0
1	54674255	.	A	G	4	3	7	0	2	9	0	0
1	54674384	.	G	T	7	4	11	0	0	11	0	0
1	54674388	.	A	G	7	4	11	0	0	11	0	0
1	54677415	.	C	G	9	4	13	0	0	13	0	0
1	54677616	.	C	T	9	13	22	0	1	23	0	0
1	54677752	.	C	T	11	16	27	0	0	28	1	0
1	54677757	.	A	G	11	18	29	0	0	29	0	0
1	54677805	.	T	C	11	20	31	0	0	31	0	0
1	54677907	.	T	C	8	17	25	0	3	28	0	0
1	54677928	.	T	C	7	16	23	0	2	25	0	0
1	54677958	.	T	C	11	19	30	0	0	30	0	0
1	54677981	.	T	C	12	21	33	0	0	33	0	0
1	54678030	.	C	T	13	16	29	0	1	30	0	0
1	54678036	.	T	C	13	17	30	0	3	33	0	0
1	54678144	.	T	A	16	19	35	0	3	38	0	0
1	54679715	.	T	C	7	10	17	0	2	19	0	0
1	54685500	.	G	A	5	10	15	0	2	17	0	0
1	54687598	.	A	G	11	5	16	0	1	17	0	0
1	54687624	.	T	A	8	6	14	0	0	14	0	0
1	54687639	.	A	G	5	7	12	0	0	12	0	0
1	54687715	.	C	A	9	8	17	0	1	18	0	0
1	54687747	.	T	C	7	6	13	0	1	14	0	0
1	54693613	.	C	T	10	6	16	0	0	16	0	0
1	54693779	.	C	T	3	2	5	0	0	5	0	0
1	54693838	.	A	C	2	2	4	0	0	4	0	0
1	54693968	.	T	G	4	2	6	0	1	7	0	0
1	54701186	.	C	T	2	1	3	0	1	4	0	0
1	54701201	.	C	G	2	0	2	0	2	4	0	0
1	54701338	.	G	A	1	0	1	0	0	1	0	0
1	54703400	.	G	A	1	2	3	0	0	3	0	0
1	54703424	.	A	C	1	3	4	0	0	4	0	0
1	54703469	.	C	T	0	2	2	0	0	2	0	0
1	54707719	.	T	C	16	8	24	0	2	26	0	0
1	54707846	.	A	G	38	19	57	0	2	59	0	0
1	54707885	.	C	G	3	13	16	0	40	56	0	0
1	54707894	.	T	G	42	12	54	0	1	55	0	0
1	54707937	.	A	G	36	11	47	0	1	48	0	0
1	54708057	.	C	G	2	22	24	0	42	66	0	0
1	54708096	.	C	G	1	31	32	0	29	61	0	0
1	54708098	.	G	T	28	28	56	0	5	61	0	0
1	54708191	.	C	A	30	36	66	0	0	66	0	0
1	54708281	.	A	T	24	26	50	0	0	50	0	0
1	54708301	.	A	C	26	22	48	0	2	50	0	0
1	54708317	.	C	T	25	22	47	0	0	47	0	0
1	54708365	.	T	C	23	22	45	0	0	45	0	0
1	54708416	.	T	G	7	24	31	0	0	31	0	0
1	54708636	.	T	C	12	15	27	0	1	28	0	0
1	54708679	.	T	C	5	25	30	0	0	30	0	0
1	54708693	.	T	C	5	20	25	0	1	26	0	0
1	54709000	.	T	C	4	12	16	0	0	16	0	0
1	54709239	.	A	T	15	25	40	0	0	40	0	0
1	54709334	.	G	A	30	35	65	0	0	65	0	0
1	54709456	.	G	A	15	28	43	0	3	46	0	0
1	54711853	.	G	A	25	26	51	0	0	51	0	0
1	54714955	.	G	A	10	15	25	0	0	25	0	0
1	54715009	.	T	C	25	1	26	0	34	60	0	0
1	54715027	.	T	C	29	0	29	0	28	57	0	0
1	54715155	.	G	T	16	13	29	0	0	29	0	0
1	54715183	.	A	G	5	5	10	0	0	10	0	0
1	54721470	.	C	T	1	3	4	0	0	4	0	0
1	54726184	.	G	A	0	4	4	0	0	4	0	0
1	54726221	.	A	G	1	5	6	0	0	6	0	0
1	54726225	.	G	A	1	5	6	0	0	6	0	0
1	54734123	.	G	A	1	0	1	0	0	1	0	0
1	54737747	.	C	T	2	4	6	0	0	6	0	0
1	54737768	.	C	A	2	1	3	0	0	3	0	0
1	54747993	.	T	G	0	1	1	0	0	1	0	0
1	54748062	.	T	G	2	0	2	0	2	4	0	0
1	54753047	.	G	A	1	1	2	0	0	2	0	0
1	54753095	.	T	G	4	0	4	0	7	11	0	0
1	54753101	.	T	C	4	7	11	0	0	11	0	0
1	54753167	.	A	G	6	4	10	0	0	10	0	0
1	54753366	.	A	G	11	15	26	0	0	26	0	0
1	54753401	.	A	T	12	12	24	0	2	26	0	0
1	54753445	.	T	A	7	11	18	0	0	18	0	0
1	54753490	.	C	T	6	5	11	0	1	13	1	0
1	54753623	.	T	G	2	3	5	0	0	5	0	0
1	54753654	.	A	C	1	3	4	0	0	4	0	0
1	54753731	.	A	G	1	3	4	0	0	4	0	0
1	54754479	.	A	C	10	1	11	0	0	11	0	0
1	54754482	.	T	G	6	5	11	0	0	11	0	0
1	54754623	.	A	T	11	7	18	0	0	18	0	0
1	54754626	.	T	A	11	6	17	0	2	19	0	0
1	54754709	.	C	T	5	6	11	0	1	12	0	0
1	54754744	.	C	T	5	8	13	0	2	15	0	0
1	54754754	.	T	C	7	10	17	0	1	18	0	0
1	54754795	.	T	C	8	11	19	0	3	22	0	0
1	54754799	.	G	A	7	13	20	0	2	22	0	0
1	54754834	.	C	T	10	11	21	0	2	23	0	0
1	54754839	.	C	T	10	12	22	0	1	23	0	0
1	54754905	.	G	A	0	3	3	0	10	13	0	0
1	54755054	.	C	T	1	5	6	0	0	6	0	0
1	54758581	.	T	C	3	0	3	0	3	6	0	0
1	54758783	.	T	G	16	15	31	0	2	33	0	0
1	54758877	.	C	A	1	11	12	0	19	31	0	0
1	54758975	.	T	C	19	6	25	0	0	25	0	0
1	54759028	.	A	G	18	6	24	0	0	24	0	0
1	54762997	.	G	T	16	8	24	0	1	25	0	0
1	54763133	.	T	C	3	2	5	0	0	5	0	0
1	54763182	.	A	G	3	16	19	0	0	19	0	0
1	54900783	.	C	T	1	5	6	0	0	6	0	0
1	54906069	.	T	C	2	1	3	0	0	3	0	0
1	54906081	.	A	C	3	1	4	0	0	4	0	0
1	54906452	.	T	C	2	2	4	0	0	4	0	0
1	54906476	.	G	C	0	2	2	0	2	4	0	0
1	54906619	.	T	A	2	3	5	0	0	5	0	0
1	54906662	.	T	C	4	3	7	0	2	9	0	0
1	54906820	.	T	C	9	6	15	0	1	16	0	0
1	54907043	.	G	T	7	4	11	0	0	11	0	0
1	54907534	.	T	C	5	13	18	0	1	19	0	0
1	54907585	.	G	C	8	17	25	0	2	27	0	0
1	54907622	.	T	C	9	17	26	0	2	28	0	0
1	54907693	.	G	T	13	5	18	0	1	19	0	0
1	54907733	.	T	A	9	7	16	0	0	16	0	0
1	54907744	.	G	A	8	5	13	0	0	13	0	0
1	54911551	.	A	T	3	2	5	0	0	5	0	0
1	54911619	.	T	C	1	0	1	0	0	1	0	0
1	54927198	.	T	C	1	3	4	0	1	5	0	0
1	54929078	.	C	T	17	22	39	0	0	39	0	0
1	54929256	.	T	C	14	12	26	0	1	27	0	0
1	54929373	.	C	G	5	3	8	0	0	8	0	0
1	54929450	.	A	G	6	3	9	0	0	9	0	0
1	54929575	.	C	T	6	9	15	0	0	15	0	0
1	54929647	.	A	C	5	11	16	0	0	16	0	0
1	54929681	.	C	A	3	16	19	0	2	21	0	0
1	54929733	.	T	G	7	12	19	0	0	19	0	0
1	54929985	.	C	T	10	10	20	0	0	20	0	0
1	54930229	.	C	T	6	9	15	0	2	17	0	0
1	54930376	.	C	G	3	2	5	0	0	5	0	0
1	54930598	.	A	G	12	3	15	0	0	15	0	0
1	54930607	.	C	A	13	2	15	0	0	15	0	0
1	54930930	.	T	G	14	20	34	0	0	34	0	0
1	54931380	.	A	C	24	8	32	0	0	32	0	0
1	54931487	.	G	T	1	28	29	0	19	48	0	0
1	54931862	.	A	G	4	6	10	0	1	11	0	0
1	54936351	.	G	A	0	1	1	0	1	2	0	0
1	54936471	.	T	C	9	19	28	1	2	31	0	0
1	54936472	.	G	A	9	20	29	1	1	31	0	0
1	54938208	.	C	T	0	15	15	0	9	24	0	0
1	54938261	.	C	T	0	3	3	0	3	6	0	0
1	54939536	.	A	T	2	2	4	0	1	5	0	0
1	54939563	.	C	G	2	3	5	0	0	5	0	0
1	54939709	.	T	G	2	1	3	0	0	3	0	0
1	54941036	.	G	A	4	7	11	0	0	11	0	0
1	54942609	.	C	T	0	2	2	0	2	4	0	0
1	54943082	.	G	T	0	3	3	0	0	3	0	0
1	54944372	.	T	A	1	1	2	0	1	3	0	0
1	54945039	.	A	G	0	1	1	0	0	1	0	0
1	54945066	.	G	T	0	1	1	0	1	2	0	0
1	54950379	.	G	C	7	5	12	0	0	12	0	0
1	54950410	.	T	C	10	11	21	0	0	21	0	0
1	54950534	.	T	C	8	10	18	0	0	18	0	0
1	54950685	.	A	G	15	15	30	0	2	32	0	0
1	54950689	.	C	A	14	17	31	0	1	32	0	0
1	54950747	.	C	T	5	10	15	0	1	16	0	0
1	54950801	.	A	G	2	1	3	0	0	3	0	0
1	54955234	.	A	G	5	3	8	0	1	9	0	0
1	54958146	.	T	A	11	5	16	0	0	16	0	0
1	54958211	.	C	T	5	10	15	0	0	15	0	0
1	54958242	.	T	A	9	11	20	0	0	20	0	0
1	54958249	.	G	A	8	11	19	0	0	19	0	0
1	54958278	.	T	A	8	7	15	0	3	18	0	0
1	54960368	.	T	G	14	18	32	0	2	34	0	0
1	54960431	.	G	T	17	19	36	0	5	41	0	0
1	54960438	.	G	A	17	18	35	0	6	41	0	0
1	54960881	.	A	G	21	8	29	0	2	31	0	0
1	54962466	.	A	G	11	9	20	0	0	20	0	0
1	54963251	.	C	T	5	1	6	0	0	6	0	0
1	54964682	.	C	T	0	5	5	0	19	24	0	0
1	54964685	.	T	C	17	0	17	0	8	25	0	0
1	54964724	.	A	G	14	11	25	0	2	27	0	0
1	54964799	.	C	T	5	9	14	0	0	14	0	0
1	54974403	.	T	G	5	2	7	0	0	7	0	0
1	54974500	.	T	A	10	13	23	0	0	23	0	0
1	54974538	.	A	G	9	11	20	0	1	21	0	0
1	54974558	.	C	T	9	11	20	0	1	21	0	0
1	54974791	.	A	T	8	9	17	0	0	17	0	0
1	54974810	.	G	T	6	10	16	0	0	16	0	0
1	54974876	.	A	G	6	6	12	0	0	12	0	0
1	54975051	.	G	T	11	19	30	0	0	30	0	0
1	54975553	.	T	C	11	0	11	0	17	28	0	0
1	54975658	.	A	G	11	7	18	0	0	18	0	0
1	54975884	.	A	G	4	11	15	0	1	16	0	0
1	54976026	.	T	A	3	14	17	0	0	18	1	0
1	54976035	.	T	A	3	15	18	0	0	18	0	0
1	54976178	.	T	C	14	0	14	0	7	21	0	0
1	54976249	.	T	A	10	10	20	0	0	20	0	0
1	54976256	.	C	T	10	10	20	0	1	21	0	0
1	54976731	.	C	T	5	7	12	0	0	12	0	0
1	54976732	.	A	G	4	7	11	0	1	12	0	0
1	54976784	.	T	A	1	3	4	0	0	4	0	0
1	54976798	.	C	A	2	2	4	0	0	4	0	0
1	54977057	.	A	G	2	8	10	3	1	14	0	0
1	54977308	.	C	A	4	3	7	0	0	7	0	0
1	54977329	.	A	G	4	2	6	0	1	7	0	0
1	54977697	.	G	A	6	2	8	0	0	8	0	0
1	54977719	.	T	A	4	2	6	0	0	6	0	0
1	54977781	.	A	G	2	3	5	0	0	5	0	0
1	54977976	.	A	G	4	2	6	0	0	6	0	0
1	54978010	.	A	C	2	0	2	0	1	3	0	0
1	54978022	.	T	G	2	3	5	0	0	5	0	0
1	54978049	.	A	G	1	7	8	0	0	8	0	0
1	54978058	.	C	A	1	8	9	0	2	11	0	0
1	54978260	.	G	A	8	4	12	0	1	13	0	0
1	54978405	.	C	A	2	5	7	0	0	7	0	0
1	54978408	.	C	T	2	6	8	0	0	8	0	0
1	54981571	.	C	T	0	1	1	0	2	3	0	0
1	54985341	.	T	C	5	0	5	0	10	15	0	0
1	54986910	.	T	C	1	0	1	0	1	2	0	0
1	54997275	.	T	C	7	0	7	0	4	11	0	0
1	54997327	.	T	C	3	2	5	0	2	7	0	0
1	54997382	.	A	T	2	3	5	0	0	5	0	0
1	54997422	.	G	C	0	6	6	0	0	6	0	0
1	54997652	.	T	G	1	3	4	0	0	4	0	0
1	55007759	.	T	C	1	5	6	0	0	6	0	0
1	55007820	.	A	C	3	8	11	0	1	12	0	0
1	55007954	.	A	C	4	2	6	0	0	6	0	0
1	55008286	.	G	A	12	15	27	0	0	27	0	0
1	55008331	.	A	T	14	14	28	0	0	28	0	0
1	55008772	.	T	C	5	9	14	0	0	14	0	0
1	55009513	.	C	A	1	3	4	0	0	4	0	0
1	55009649	.	G	A	6	6	12	0	0	12	0	0
1	55010914	.	A	T	11	4	15	0	2	17	0	0
1	55011112	.	A	T	5	6	11	0	0	11	0	0
1	55011117	.	T	C	4	6	10	0	0	10	0	0
1	55011232	.	A	G	6	3	9	0	0	9	0	0
1	55011473	.	G	A	7	8	15	0	0	15	0	0
1	55011514	.	C	T	7	6	13	0	0	13	0	0
1	55011539	.	A	T	7	10	17	0	0	17	0	0
1	55011603	.	G	A	11	7	18	0	0	18	0	0
1	55013828	.	A	G	1	3	4	0	0	4	0	0
1	55015819	.	A	T	1	0	1	0	0	1	0	0
1	55015846	.	A	G	1	0	1	0	0	1	0	0
1	55018941	.	A	G	0	1	1	0	0	1	0	0
1	55021862	.	A	T	1	1	2	0	0	2	0	0
1	55021886	.	G	A	3	2	5	0	0	5	0	0
1	55021952	.	G	A	3	3	6	0	1	7	0	0
1	55022162	.	T	A	5	2	7	0	0	7	0	0
1	55025467	.	T	C	0	1	1	0	0	1	0	0
1	55046053	.	A	G	1	2	3	0	0	3	0	0
1	55080905	.	A	G	1	1	2	0	0	2	0	0
1	55084656	.	T	G	0	1	1	0	0	1	0	0
1	55085830	.	A	T	1	2	3	0	0	3	0	0
1	55088145	.	C	T	2	0	2	0	0	2	0	0
1	55088155	.	G	A	2	0	2	0	0	2	0	0
1	55089078	.	T	A	2	4	6	0	1	7	0	0
1	55089328	.	G	A	4	5	9	0	0	9	0	0
1	55089378	.	G	T	3	9	12	0	1	13	0	0
1	55089384	.	T	A	2	6	8	0	4	12	0	0
1	55089938	.	C	T	5	2	7	0	0	7	0	0
1	55089974	.	G	A	2	2	4	0	0	4	0	0
1	55099160	.	G	T	0	9	9	0	5	14	0	0
1	55099214	.	A	C	4	9	13	0	1	14	0	0
1	55099316	.	T	C	8	7	15	0	0	15	0	0
1	55099411	.	G	A	5	7	12	0	0	12	0	0
1	55099472	.	T	C	3	12	15	0	2	17	0	0
1	55100018	.	T	C	12	7	19	0	1	20	0	0
1	55100286	.	G	T	18	13	31	0	2	33	0	0
1	55100422	.	T	A	9	11	20	0	2	22	0	0
1	55100456	.	T	C	6	6	12	0	0	12	0	0
1	55101376	.	C	T	9	18	27	0	3	30	0	0
1	55101409	.	C	A	10	9	19	0	0	19	0	0
1	55103160	.	A	G	7	9	16	0	1	17	0	0
1	55108059	.	A	T	2	3	5	0	0	5	0	0
1	55108065	.	T	C	2	3	5	0	0	5	0	0
1	55112943	.	A	G	0	2	2	0	0	2	0	0
1	55113137	.	G	A	1	4	5	0	0	5	0	0
1	55113465	.	A	G	1	2	3	0	0	3	0	0
1	55144417	.	G	A	0	14	14	0	7	21	0	0
1	55144944	.	T	C	1	2	3	0	0	3	0	0
1	55144951	.	T	C	1	2	3	0	0	3	0	0
1	55161431	.	A	G	3	3	6	0	0	6	0	0
1	55162449	.	A	G	0	1	1	0	0	1	0	0
1	55166477	.	G	A	1	4	5	0	0	5	0	0
1	55169384	.	G	T	11	8	19	0	0	19	0	0
1	55169662	.	A	G	13	9	22	0	1	23	0	0
1	55169715	.	A	T	15	4	19	0	0	19	0	0
1	55169756	.	A	G	13	12	25	0	0	25	0	0
1	55169789	.	A	T	11	13	24	0	1	25	0	0
1	55169839	.	G	C	11	7	18	1	0	19	0	0
1	55169961	.	T	C	11	0	11	0	9	20	0	0
1	55169980	.	A	G	10	9	19	0	0	19	0	0
1	55169999	.	C	T	8	8	16	0	0	16	0	0
1	55170042	.	A	C	6	10	16	0	1	17	0	0
1	55170056	.	G	T	7	7	14	0	1	15	0	0
1	55170090	.	C	G	14	3	17	0	1	18	0	0
1	55170161	.	C	A	8	10	18	0	0	18	0	0
1	55170189	.	C	A	9	15	24	0	0	24	0	0
1	55170866	.	T	C	3	0	3	0	6	9	0	0
1	55170972	.	T	C	7	5	12	0	0	12	0	0
1	55171249	.	G	A	7	9	16	0	0	16	0	0
1	55173006	.	T	A	12	7	19	0	2	21	0	0
1	55174744	.	C	T	9	8	17	0	1	18	0	0
1	55176698	.	A	G	5	1	6	0	0	6	0	0
1	55177339	.	C	T	2	1	3	0	0	3	0	0
1	55177447	.	C	T	1	2	3	0	0	3	0	0
1	55178763	.	C	G	1	4	5	0	0	5	0	0
1	55178808	.	A	G	0	4	4	0	0	4	0	0
1	55180229	.	A	G	2	1	3	0	0	3	0	0
1	55180268	.	T	G	2	1	3	0	0	3	0	0
1	55180278	.	G	C	1	0	1	0	1	2	0	0
1	55182617	.	G	T	4	2	6	0	2	8	0	0
1	55182626	.	G	T	4	3	7	0	1	8	0	0
1	55182656	.	T	C	4	4	8	0	0	8	0	0
1	55182685	.	T	C	2	4	6	0	0	6	0	0
1	55182699	.	A	C	3	5	8	0	0	8	0	0
1	55182720	.	T	C	3	3	6	0	1	7	0	0
1	55182743	.	C	T	4	3	7	0	0	7	0	0
1	55182811	.	A	G	4	3	7	0	0	7	0	0
1	55182876	.	A	T	3	3	6	0	0	6	0	0
1	55182964	.	T	C	4	9	13	0	0	13	0	0
1	55183041	.	C	T	4	6	10	0	0	10	0	0
1	55191201	.	G	T	4	5	9	0	3	12	0	0
1	55191219	.	T	A	4	4	8	0	0	8	0	0
1	55191256	.	A	T	2	4	6	0	1	7	0	0
1	55191675	.	A	G	5	8	13	0	0	13	0	0
1	55195273	.	G	A	3	3	6	0	0	6	0	0
1	55195309	.	T	C	7	1	8	0	4	12	0	0
1	55195414	.	G	A	1	0	1	0	0	1	0	0
1	55195952	.	T	G	3	5	8	0	2	10	0	0
1	55195997	.	A	T	8	8	16	0	1	17	0	0
1	55196045	.	T	C	4	0	4	0	5	9	0	0
1	55197685	.	G	A	0	0	0	0	1	1	0	0
1	55198952	.	A	G	1	4	5	0	0	5	0	0
1	55218563	.	G	A	0	1	1	0	0	1	0	0
1	55226931	.	T	C	1	0	1	0	1	2	0	0
1	55233984	.	C	T	0	2	2	0	0	2	0	0
1	55234125	.	C	T	3	2	5	0	0	5	0	0
1	55234147	.	G	A	2	3	5	0	0	5	0	0
1	55234161	.	A	G	1	3	4	0	0	4	0	0
1	55234188	.	A	G	0	2	2	0	0	2	0	0
1	55236266	.	A	G	1	3	4	0	1	5	0	0
1	55264294	.	C	T	0	9	9	0	8	17	0	0
1	55264314	.	C	A	6	9	15	0	0	15	0	0
1	55264366	.	C	T	8	6	14	0	0	14	0	0
1	55264575	.	T	A	12	16	28	0	0	29	1	0
1	55745816	.	C	T	2	3	5	0	0	5	0	0
1	55746054	.	T	A	2	2	4	0	0	4	0	0
1	55748355	.	C	T	0	1	1	0	1	2	0	0
1	55748376	.	C	A	0	1	1	0	1	2	0	0
1	55762664	.	C	A	6	5	11	0	0	11	0	0
1	55772026	.	C	T	1	0	1	0	0	1	0	0
1	55776813	.	G	A	1	24	25	0	23	48	0	0
1	55776858	.	G	A	2	20	22	0	19	41	0	0
1	55776909	.	A	C	14	11	25	0	1	32	6	0
1	55776962	.	T	A	19	20	39	0	2	41	0	0
1	55777008	.	A	T	15	18	33	0	2	35	0	0
1	55783978	.	T	C	4	1	5	0	0	5	0	0
1	55785527	.	C	A	1	23	24	0	29	53	0	0
1	55785577	.	A	G	28	16	44	0	1	45	0	0
1	55785596	.	T	C	23	23	46	0	0	46	0	0
1	55785654	.	C	T	10	16	26	0	3	29	0	0
1	55785697	.	C	T	1	2	3	0	0	3	0	0
1	55787173	.	A	G	2	3	5	0	0	5	0	0
1	55787219	.	A	C	5	3	8	0	0	8	0	0
1	55787236	.	C	T	4	3	7	0	0	7	0	0
1	55787300	.	C	T	0	1	1	0	2	3	0	0
1	55787507	.	A	G	7	3	10	0	0	10	0	0
1	55789456	.	C	T	4	5	9	0	0	9	0	0
1	55789504	.	A	C	5	0	5	0	3	8	0	0
1	55797936	.	A	C	1	0	1	0	1	2	0	0
1	55817728	.	C	T	3	5	8	0	0	8	0	0
1	55817753	.	G	A	6	5	11	0	0	11	0	0
1	55833139	.	G	C	2	7	9	0	0	9	0	0
1	55833276	.	C	T	3	6	9	0	0	9	0	0
1	55833281	.	C	T	3	5	8	0	0	8	0	0
1	55843902	.	C	T	14	24	38	0	0	38	0	0
1	55843968	.	G	A	19	26	45	0	1	46	0	0
1	55844044	.	T	A	20	21	41	0	2	43	0	0
1	55844143	.	T	G	18	22	40	0	1	41	0	0
1	55851968	.	T	C	2	0	2	0	8	10	0	0
1	55853320	.	G	A	5	8	13	0	1	14	0	0
1	55872892	.	C	G	9	15	24	0	0	24	0	0
1	55873073	.	C	T	9	11	20	0	0	20	0	0
1	55878257	.	T	A	5	6	11	0	0	11	0	0
1	55878431	.	T	A	6	3	9	1	2	12	0	0
1	55878457	.	C	T	10	5	15	1	1	17	0	0
1	55878496	.	T	C	11	1	12	0	9	21	0	0
1	55878558	.	G	A	7	8	15	0	0	15	0	0
1	55878624	.	T	A	6	8	14	0	3	17	0	0
1	55878626	.	A	C	8	8	16	0	1	17	0	0
1	55888442	.	A	G	3	1	4	0	0	4	0	0
1	55888654	.	C	T	2	6	8	0	1	9	0	0
1	55888690	.	A	G	1	7	8	0	1	9	0	0
1	55888693	.	T	A	0	7	7	0	3	10	0	0
1	55888810	.	A	C	1	2	3	0	0	3	0	0
1	55888816	.	G	A	1	2	3	0	0	3	0	0
1	55888852	.	A	C	1	4	5	0	0	5	0	0
1	55888857	.	A	C	1	0	1	0	3	4	0	0
1	55888892	.	A	G	3	3	6	0	0	6	0	0
1	56217457	.	G	A	4	11	15	0	0	15	0	0
1	56217510	.	A	G	24	23	47	0	3	50	0	0
1	56217925	.	G	A	32	32	64	0	5	69	0	0
1	56218189	.	C	T	1	32	33	0	34	67	0	0
1	56218258	.	A	C	36	29	65	0	2	67	0	0
1	56220668	.	A	G	11	17	28	0	1	29	0	0
1	56223902	.	T	G	1	4	5	0	0	5	0	0
1	56422781	.	T	A	4	3	7	0	1	8	0	0
1	56422962	.	A	T	5	8	13	0	0	13	0	0
1	56422967	.	T	C	5	8	13	0	0	13	0	0
1	56423002	.	T	G	8	9	17	0	0	17	0	0
1	56423279	.	G	A	2	1	3	0	0	3	0	0
1	56423293	.	C	T	2	3	5	0	1	6	0	0
1	56423426	.	T	C	4	2	6	0	0	6	0	0
1	56423427	.	T	C	2	0	2	0	4	6	0	0
1	56423641	.	T	A	4	3	7	0	0	7	0	0
1	56423664	.	T	C	4	0	4	0	4	8	0	0
1	56425228	.	G	C	2	0	2	0	0	2	0	0
1	56425243	.	A	G	2	0	2	0	0	2	0	0
1	56428320	.	G	A	0	2	2	0	0	2	0	0
1	57170829	.	T	G	1	0	1	0	0	1	0	0
1	57170839	.	G	A	1	0	1	0	0	1	0	0
1	57278215	.	G	C	11	7	18	0	0	18	0	0
1	57278405	.	A	T	6	3	9	0	1	10	0	0
1	57278452	.	C	T	2	2	4	0	0	4	0	0
1	57278525	.	A	G	5	2	7	0	0	7	0	0
1	57278610	.	T	G	9	5	14	0	0	14	0	0
1	57278669	.	A	G	6	4	10	0	0	10	0	0
1	57278690	.	G	A	10	3	13	0	0	13	0	0
1	57278753	.	T	C	4	8	12	0	0	12	0	0
1	57278783	.	T	C	5	3	8	0	1	9	0	0
1	57278915	.	G	A	9	11	20	0	0	20	0	0
1	57278979	.	G	A	6	9	15	0	1	16	0	0
1	57279073	.	T	C	7	0	7	0	9	16	0	0
1	57280108	.	G	A	8	4	12	0	2	14	0	0
1	57280184	.	G	T	8	5	13	0	0	13	0	0
1	57280292	.	T	C	9	4	13	0	1	14	0	0
1	57280454	.	A	T	3	7	10	0	0	10	0	0
1	57280502	.	T	C	5	13	18	0	0	18	0	0
1	57317706	.	C	T	1	3	4	0	0	4	0	0
1	57333094	.	G	A	0	0	0	0	1	1	0	0
1	57336181	.	A	G	3	1	4	0	0	4	0	0
1	57336213	.	T	C	2	1	3	0	1	4	0	0
1	57336216	.	C	G	3	0	3	0	1	4	0	0
1	57337107	.	T	C	1	1	2	0	1	3	0	0
1	57337110	.	C	T	2	1	3	0	0	3	0	0
1	57338143	.	C	T	4	4	8	0	0	8	0	0
1	57338226	.	G	A	0	2	2	0	7	9	0	0
1	57340049	.	T	C	8	7	15	0	0	15	0	0
1	57347974	.	T	C	4	3	7	0	0	7	0	0
1	57347987	.	G	T	3	3	6	0	0	6	0	0
1	57364732	.	A	G	1	2	3	0	1	4	0	0
1	58013096	.	A	G	6	4	10	0	0	10	0	0
1	58013102	.	A	T	5	3	8	0	0	8	0	0
1	58013308	.	C	A	5	4	9	0	0	9	0	0
1	58013309	.	A	G	5	4	9	0	0	9	0	0
1	58013423	.	C	T	0	5	5	0	11	16	0	0
1	58013474	.	T	C	3	0	3	0	5	8	0	0
1	58013486	.	C	T	1	3	4	1	0	5	0	0
1	58014013	.	A	G	8	2	10	0	0	10	0	0
1	58014867	.	T	C	12	4	16	0	0	16	0	0
1	58015053	.	A	G	2	2	4	0	1	5	0	0
1	58015448	.	G	T	1	1	2	0	0	2	0	0
1	58018622	.	G	A	2	0	2	0	0	2	0	0
1	58019888	.	A	T	3	3	6	0	0	6	0	0
1	58049338	.	C	T	2	2	4	0	0	4	0	0
1	58545499	.	A	G	3	3	6	0	1	7	0	0
1	58545547	.	T	G	2	4	6	0	0	6	0	0
1	58545734	.	C	G	11	4	15	0	0	15	0	0
1	58548428	.	T	C	2	1	3	0	0	3	0	0
1	58548491	.	T	C	2	2	4	0	0	4	0	0
1	58593731	.	G	A	4	3	7	0	0	7	0	0
1	58593768	.	T	G	4	3	7	0	0	7	0	0
1	58593833	.	C	A	4	6	10	0	0	10	0	0
1	58593835	.	T	C	4	6	10	0	0	10	0	0
1	58593912	.	C	T	7	6	13	0	0	13	0	0
1	58594066	.	T	C	6	0	6	0	4	10	0	0
1	58594143	.	A	C	1	5	6	0	0	6	0	0
1	58594144	.	G	A	1	5	6	0	0	6	0	0
1	58594269	.	T	C	6	5	11	0	1	12	0	0
1	58594276	.	T	C	6	5	11	0	0	11	0	0
1	58594521	.	T	C	2	7	9	0	0	9	0	0
1	58594541	.	T	C	1	7	8	0	1	9	0	0
1	58594611	.	T	G	6	3	9	0	0	9	0	0
1	58595018	.	C	T	7	7	14	0	1	15	0	0
1	58595198	.	A	G	7	9	16	0	0	16	0	0
1	58595455	.	G	A	4	4	8	0	0	8	0	0
1	58595545	.	T	C	5	3	8	0	1	9	0	0
1	58598802	.	T	C	2	0	2	0	3	5	0	0
1	58598830	.	A	T	0	3	3	0	0	3	0	0
1	58601615	.	G	A	1	0	1	0	0	1	0	0
1	58601620	.	T	C	1	0	1	0	0	1	0	0
1	58605969	.	C	G	5	3	8	0	0	8	0	0
1	58605997	.	A	G	6	4	10	0	0	10	0	0
1	58606051	.	G	A	0	2	2	0	3	5	0	0
1	58610309	.	G	T	4	2	6	0	0	6	0	0
1	58612354	.	G	A	4	2	6	0	0	6	0	0
1	58613091	.	A	C	3	4	7	0	0	7	0	0
1	58617987	.	T	C	3	4	7	0	1	8	0	0
1	58618014	.	C	T	5	1	6	0	1	7	0	0
1	58618035	.	C	T	2	4	6	0	0	6	0	0
1	58618411	.	A	G	2	5	7	0	0	7	0	0
1	58618688	.	T	A	1	2	3	0	0	3	0	0
1	58621002	.	G	A	1	4	5	0	0	5	0	0
1	58631374	.	A	G	3	2	5	0	0	5	0	0
1	58631609	.	C	T	3	3	6	0	0	6	0	0
1	58631695	.	A	T	1	4	5	0	0	5	0	0
1	58631713	.	A	G	1	0	1	0	3	4	0	0
1	58677839	.	T	C	3	8	11	0	0	11	0	0
1	58677856	.	C	T	2	9	11	0	1	12	0	0
1	58677993	.	A	G	3	5	8	0	0	8	0	0
1	58678017	.	T	C	4	4	8	0	1	9	0	0
1	58680499	.	C	A	7	14	21	0	4	25	0	0
1	58680615	.	G	A	13	6	19	0	0	19	0	0
1	58680708	.	T	C	7	10	17	0	0	17	0	0
1	58680718	.	C	G	7	10	17	0	0	17	0	0
1	58680792	.	T	C	4	10	14	0	0	14	0	0
1	58680913	.	T	C	13	7	20	0	2	22	0	0
1	58681068	.	C	T	4	11	15	0	0	15	0	0
1	58681419	.	A	T	7	13	20	0	2	27	5	0
1	58762985	.	T	G	2	2	4	0	0	4	0	0
1	58846938	.	A	G	2	6	8	0	1	9	0	0
1	58850562	.	C	T	4	5	9	0	1	10	0	0
1	58850622	.	T	C	4	3	7	0	0	7	0	0
1	58982147	.	G	A	0	5	5	0	6	11	0	0
1	58982195	.	C	G	5	11	16	0	0	16	0	0
1	58984239	.	G	T	4	3	7	0	0	7	0	0
1	58984478	.	T	C	0	3	3	0	0	3	0	0
1	58984640	.	C	T	2	3	5	0	1	6	0	0
1	58985530	.	G	A	13	13	26	0	0	26	0	0
1	58985579	.	T	G	13	12	25	0	0	25	0	0
1	58985730	.	C	A	11	4	15	0	0	15	0	0
1	59009732	.	A	G	14	0	14	0	17	31	0	0
1	59015569	.	C	T	0	3	3	0	6	9	0	0
1	59015592	.	C	G	8	4	12	0	0	12	0	0
1	59018886	.	C	T	0	8	8	0	4	12	0	0
1	59019006	.	C	G	3	11	14	0	0	14	0	0
1	59019084	.	T	A	3	4	7	0	0	7	0	0
1	59019093	.	A	G	3	5	8	0	0	8	0	0
1	59062665	.	T	C	32	20	52	0	3	55	0	0
1	59065889	.	G	A	1	9	10	0	19	29	0	0
1	59141550	.	T	C	2	0	2	0	0	2	0	0
1	59141556	.	G	C	2	0	2	0	0	2	0	0
1	59142891	.	A	G	1	1	2	0	2	4	0	0
1	59147468	.	C	G	1	0	1	0	6	7	0	0
1	59148341	.	T	C	2	2	4	0	0	4	0	0
1	59149117	.	C	T	5	10	15	0	0	15	0	0
1	59149968	.	T	C	12	11	23	0	1	24	0	0
1	59150450	.	A	G	6	6	12	0	0	12	0	0
1	59150482	.	G	T	6	7	13	0	0	13	0	0
1	59150518	.	T	C	4	12	16	0	1	17	0	0
1	59150559	.	T	G	6	13	19	0	1	20	0	0
1	59150583	.	T	A	7	14	21	0	0	21	0	0
1	59150683	.	T	C	9	16	25	0	0	25	0	0
1	59150737	.	T	C	12	10	22	0	0	22	0	0
1	59150762	.	G	T	13	7	20	0	0	20	0	0
1	59150781	.	T	C	14	10	24	0	0	24	0	0
1	59156827	.	T	G	3	9	12	0	0	12	0	0
1	59157536	.	T	C	2	5	7	0	0	7	0	0
1	59157977	.	A	C	8	12	20	0	5	25	0	0
1	59158035	.	C	A	4	11	15	0	1	16	0	0
1	59158062	.	A	T	7	9	16	0	0	16	0	0
1	59158070	.	G	A	6	6	12	0	1	13	0	0
1	59168141	.	T	A	1	0	1	0	0	1	0	0
1	59172876	.	A	G	10	20	30	0	0	30	0	0
1	59172900	.	A	G	10	21	31	0	0	31	0	0
1	59172969	.	G	A	14	13	27	0	2	29	0	0
1	59173358	.	G	T	8	10	18	0	0	18	0	0
1	59173701	.	G	T	1	1	2	0	1	3	0	0
1	59173758	.	A	G	6	13	19	0	0	19	0	0
1	59173866	.	T	G	13	8	21	0	3	24	0	0
1	59173896	.	T	C	14	0	14	0	14	28	0	0
1	59174387	.	A	G	9	11	20	0	0	20	0	0
1	59174408	.	G	A	6	8	14	0	0	14	0	0
1	59174492	.	T	G	5	17	22	0	0	22	0	0
1	59174525	.	A	C	5	12	17	0	0	17	0	0
1	59174576	.	C	T	4	8	12	0	1	13	0	0
1	59174645	.	G	A	12	12	24	0	1	25	0	0
1	59174797	.	A	C	15	9	24	0	3	27	0	0
1	59174962	.	T	C	10	18	28	0	0	28	0	0
1	59175572	.	A	G	10	7	17	0	0	17	0	0
1	59175626	.	G	A	9	5	14	0	0	14	0	0
1	59175635	.	G	A	8	6	14	0	1	15	0	0
1	59175740	.	G	T	2	4	6	0	1	7	0	0
1	59175983	.	T	C	5	5	10	0	0	10	0	0
1	59175989	.	A	G	5	5	10	0	0	10	0	0
1	59176887	.	G	T	3	1	4	0	0	4	0	0
1	59176935	.	A	C	3	0	3	0	1	4	0	0
1	59218477	.	C	G	0	4	4	0	4	8	0	0
1	59218594	.	A	G	10	13	23	0	0	23	0	0
1	59226049	.	T	C	6	5	11	0	4	15	0	0
1	59226052	.	A	G	10	5	15	0	0	15	0	0
1	59228311	.	G	A	0	1	1	0	0	1	0	0
1	59228322	.	C	T	0	1	1	0	0	1	0	0
1	59228569	.	A	C	6	0	6	0	9	15	0	0
1	59229211	.	G	A	3	3	6	0	0	6	0	0
1	59232206	.	A	G	11	16	27	0	1	28	0	0
1	59232358	.	T	G	1	4	5	0	0	5	0	0
1	59232509	.	G	A	9	7	16	0	0	16	0	0
1	59235016	.	T	G	2	5	7	0	1	8	0	0
1	59238381	.	G	T	4	2	6	0	0	7	1	0
1	59244312	.	A	G	14	5	19	0	1	20	0	0
1	59244635	.	A	T	13	15	28	0	0	28	0	0
1	59244916	.	T	A	40	16	56	0	2	58	0	0
1	59244928	.	C	T	38	20	58	0	1	59	0	0
1	59245142	.	C	G	25	30	55	0	0	55	0	0
1	59245658	.	G	A	5	5	10	0	2	12	0	0
1	59245873	.	T	C	4	2	6	0	0	6	0	0
1	59245900	.	C	T	10	7	17	0	0	17	0	0
1	59246189	.	T	C	13	1	14	0	12	26	0	0
1	59246363	.	A	T	1	4	5	0	0	5	0	0
1	59247893	.	T	G	12	7	19	0	0	19	0	0
1	59247944	.	C	T	7	5	12	0	0	12	0	0
1	59248138	.	T	A	7	7	14	0	1	15	0	0
1	59251658	.	C	G	3	5	8	0	0	8	0	0
1	59251839	.	T	C	12	0	12	0	8	20	0	0
1	59293937	.	T	C	1	2	3	0	0	3	0	0
1	59293966	.	A	G	3	4	7	0	0	7	0	0
1	59298207	.	C	T	1	0	1	0	0	1	0	0
1	59298261	.	T	G	1	0	1	0	0	1	0	0
1	59302210	.	G	A	0	3	3	0	0	3	0	0
1	59302276	.	C	T	12	6	18	0	0	18	0	0
1	59302372	.	T	G	3	8	11	0	1	12	0	0
1	59302523	.	A	T	1	2	3	0	0	3	0	0
1	59302532	.	A	C	0	2	2	0	1	3	0	0
1	59303024	.	C	A	3	8	11	0	0	11	0	0
1	59304427	.	T	C	4	2	6	0	0	6	0	0
1	59304436	.	C	A	5	2	7	0	0	7	0	0
1	59304609	.	T	A	3	3	6	0	0	6	0	0
1	59304719	.	G	C	3	3	6	0	0	6	0	0
1	59305047	.	C	T	0	3	3	0	10	13	0	0
1	59305050	.	G	T	10	2	12	0	0	12	0	0
1	59305116	.	T	C	6	0	6	0	3	9	0	0
1	59305200	.	T	C	2	2	4	0	1	5	0	0
1	59309451	.	C	T	0	3	3	0	2	5	0	0
1	59309452	.	G	T	2	3	5	0	0	5	0	0
1	59309988	.	A	G	1	2	3	0	0	3	0	0
1	59318769	.	A	G	1	1	2	0	0	2	0	0
1	59318771	.	C	A	1	1	2	0	0	2	0	0
1	59318886	.	A	G	3	1	4	0	2	6	0	0
1	59321447	.	A	G	12	1	13	0	15	28	0	0
1	59324067	.	T	C	7	8	15	0	0	15	0	0
1	59328110	.	T	G	4	0	4	0	3	7	0	0
1	59328287	.	C	T	1	2	3	0	0	3	0	0
1	59328486	.	C	T	3	4	7	0	0	7	0	0
1	59330135	.	T	C	6	6	12	0	0	12	0	0
1	59330169	.	C	T	8	7	15	0	0	15	0	0
1	59409266	.	G	A	2	5	7	0	0	7	0	0
1	59414615	.	A	G	2	8	10	0	0	10	0	0
1	59542739	.	A	T	1	0	1	0	1	2	0	0
1	59563781	.	G	T	0	8	8	0	0	8	0	0
10	22672	.	A	T	3	4	7	0	1	8	0	0
10	24014	.	G	A	1	3	4	0	0	4	0	0
10	27705	.	A	G	5	4	9	0	0	9	0	0
10	27787	.	G	T	0	6	6	0	7	14	1	0
10	32998	.	G	T	3	4	7	0	0	7	0	0
10	33427	.	G	A	6	2	8	0	0	8	0	0
10	33634	.	G	T	3	9	12	0	2	14	0	0
10	34028	.	C	T	3	3	6	0	0	6	0	0
10	34401	.	G	A	1	3	4	0	0	4	0	0
10	34432	.	T	C	1	2	3	0	0	3	0	0
10	34799	.	G	C	4	0	4	0	4	8	0	0
10	53815	.	T	C	11	9	20	0	1	21	0	0
10	53816	.	G	A	11	9	20	0	1	21	0	0
10	53930	.	T	G	6	15	21	0	0	21	0	0
10	55594	.	G	A	8	8	16	0	0	16	0	0
10	62468	.	C	G	8	23	31	0	0	31	0	0
10	66886	.	A	G	9	6	15	0	0	15	0	0
10	66967	.	A	G	8	7	15	0	2	17	0	0
10	81276	.	C	T	9	4	13	0	0	13	0	0
10	81285	.	C	T	6	9	15	0	1	16	0	0
10	81348	.	C	T	24	16	40	0	2	42	0	0
10	81444	.	C	T	19	7	26	0	2	28	0	0
10	81508	.	A	G	12	0	12	0	14	26	0	0
10	81579	.	G	T	0	10	10	0	5	15	0	0
10	82336	.	A	G	23	8	31	0	1	32	0	0
10	83401	.	G	A	7	4	11	0	0	11	0	0
10	85404	.	G	A	2	0	2	0	0	2	0	0
10	85419	.	C	T	0	0	0	0	2	2	0	0
10	85571	.	G	C	6	3	9	0	1	10	0	0
10	85585	.	C	T	7	3	10	0	0	10	0	0
10	85927	.	A	G	4	4	8	0	0	8	0	0
10	85948	.	G	C	4	4	8	0	0	8	0	0
10	87353	.	G	A	4	0	4	0	0	4	0	0
10	87592	.	C	T	1	5	6	0	6	12	0	0
10	87606	.	G	A	3	7	10	0	0	10	0	0
10	90320	.	A	C	3	2	5	0	0	5	0	0
10	95022	.	C	T	0	1	1	0	2	3	0	0
10	115088	.	G	A	7	15	22	0	2	24	0	0
10	115493	.	G	T	14	8	22	0	0	22	0	0
10	115506	.	T	G	13	7	20	0	1	21	0	0
10	115615	.	T	C	9	10	19	0	0	19	0	0
10	115626	.	C	A	10	10	20	0	0	20	0	0
10	115679	.	A	T	6	14	20	0	0	20	0	0
10	115773	.	A	G	6	12	18	0	1	19	0	0
10	115820	.	T	C	9	11	20	0	1	21	0	0
10	116619	.	G	C	1	5	6	0	0	6	0	0
10	134661	.	C	T	0	14	14	0	16	30	0	0
10	134749	.	C	T	0	15	15	0	16	31	0	0
10	187823	.	C	T	5	9	14	0	0	14	0	0
10	188357	.	A	C	1	0	1	0	0	1	0	0
10	190039	.	G	A	4	6	10	0	0	10	0	0
10	190917	.	C	T	16	13	29	0	0	29	0	0
10	193853	.	G	A	5	3	8	0	6	14	0	0
10	196307	.	C	T	5	7	12	1	2	16	1	0
10	196426	.	T	A	16	11	27	0	0	27	0	0
10	196429	.	A	T	15	10	25	0	0	25	0	0
10	196563	.	C	G	4	5	9	0	0	9	0	0
10	196670	.	G	A	16	17	33	0	0	33	0	0
10	196782	.	C	A	4	3	7	0	0	7	0	0
10	207078	.	G	T	7	2	9	0	0	9	0	0
10	207128	.	G	A	7	4	11	0	0	11	0	0
10	208034	.	A	T	12	11	23	0	1	24	0	0
10	208104	.	G	A	5	4	9	0	0	9	0	0
10	210568	.	A	G	4	5	9	0	1	10	0	0
10	210598	.	T	C	3	9	12	0	0	12	0	0
10	214013	.	T	A	3	5	8	0	1	9	0	0
10	286788	.	T	C	6	1	7	0	14	21	0	0
10	292655	.	C	T	0	2	2	0	3	5	0	0
10	292667	.	A	G	2	2	4	0	0	4	0	0
10	294113	.	G	A	3	4	7	0	1	8	0	0
10	294653	.	A	G	5	8	13	0	0	13	0	0
10	295070	.	A	G	2	3	5	0	0	5	0	0
10	296617	.	C	T	0	3	3	0	3	6	0	0
10	307976	.	G	T	5	10	15	0	1	16	0	0
10	307985	.	T	C	4	0	4	0	9	13	0	0
10	308288	.	T	C	11	3	14	0	2	16	0	0
10	311901	.	A	G	3	3	6	0	1	7	0	0
10	313332	.	T	C	1	0	1	0	0	1	0	0
10	416741	.	G	A	1	4	5	0	0	5	0	0
10	431607	.	T	A	1	2	3	0	1	4	0	0
10	431608	.	T	C	2	2	4	0	0	4	0	0
10	474834	.	T	C	4	3	7	0	0	7	0	0
10	474896	.	T	C	4	6	10	0	0	10	0	0
10	478304	.	T	G	15	8	23	0	0	23	0	0
10	478388	.	G	A	0	18	18	0	15	33	0	0
10	478508	.	T	C	14	15	29	0	0	29	0	0
10	478661	.	C	T	10	18	28	0	0	28	0	0
10	478724	.	G	A	12	15	27	0	1	28	0	0
10	478742	.	C	T	14	16	30	0	0	30	0	0
10	479063	.	A	G	4	3	7	0	0	7	0	0
10	482335	.	G	A	7	9	16	0	2	19	1	0
10	482371	.	T	G	15	19	34	0	0	34	0	0
10	486146	.	G	A	14	26	40	0	2	42	0	0
10	486153	.	T	C	17	22	39	0	4	43	0	0
10	500114	.	A	G	5	0	5	0	7	12	0	0
10	500168	.	G	A	1	20	21	0	22	43	0	0
10	500423	.	A	G	25	0	25	0	16	41	0	0
10	500473	.	T	C	11	9	20	0	1	21	0	0
10	501833	.	C	T	5	5	10	0	0	10	0	0
10	501899	.	G	C	6	14	20	0	2	22	0	0
10	505282	.	A	G	16	22	38	0	0	38	0	0
10	505316	.	G	A	1	24	25	0	19	44	0	0
10	573770	.	A	G	1	0	1	0	4	5	0	0
10	573789	.	T	A	1	5	6	0	0	6	0	0
10	576060	.	A	G	2	3	5	0	0	5	0	0
10	579989	.	A	G	4	0	4	0	5	9	0	0
10	580088	.	G	T	1	8	9	0	12	21	0	0
10	580092	.	G	A	11	8	19	0	1	20	0	0
10	586563	.	C	A	1	2	3	0	0	3	0	0
10	589487	.	G	A	14	5	19	0	1	20	0	0
10	589655	.	T	C	3	5	8	0	1	9	0	0
10	589789	.	G	A	0	5	5	0	6	11	0	0
10	589810	.	A	T	4	6	10	0	2	12	0	0
10	589875	.	T	C	1	7	8	0	1	9	0	0
10	590067	.	A	C	5	4	9	0	0	9	0	0
10	590087	.	A	G	3	3	6	0	0	6	0	0
10	590273	.	A	C	6	8	14	0	2	16	0	0
10	590314	.	G	A	0	6	6	0	7	13	0	0
10	590997	.	C	T	5	2	7	0	1	8	0	0
10	591017	.	T	C	10	5	15	0	0	15	0	0
10	591219	.	T	G	6	0	6	0	9	15	0	0
10	591220	.	C	T	6	6	12	0	3	15	0	0
10	591386	.	G	T	0	3	3	0	1	4	0	0
10	591434	.	G	A	3	10	13	0	0	13	0	0
10	591476	.	A	G	6	0	6	0	13	19	0	0
10	591567	.	T	A	10	8	18	0	0	18	0	0
10	591634	.	T	G	8	11	19	0	3	22	0	0
10	591716	.	C	G	8	3	11	0	0	11	0	0
10	591720	.	G	A	0	3	3	0	8	11	0	0
10	600448	.	T	C	4	6	10	0	0	10	0	0
10	600450	.	T	C	4	6	10	0	0	10	0	0
10	600584	.	G	A	4	8	12	0	0	12	0	0
10	1052728	.	C	T	5	5	10	0	0	10	0	0
10	1056460	.	T	C	4	7	11	0	1	12	0	0
10	1073519	.	G	C	0	2	2	0	4	6	0	0
10	1076044	.	C	T	6	4	10	0	0	10	0	0
10	1076116	.	C	T	4	3	7	0	1	8	0	0
10	1107441	.	G	A	0	7	7	0	9	16	0	0
10	1107460	.	C	T	9	14	23	0	0	23	0	0
10	1107540	.	C	A	10	10	20	0	0	20	0	0
10	1436596	.	C	G	0	2	2	0	0	2	0	0
10	1479456	.	G	A	3	3	6	0	1	7	0	0
10	1541357	.	G	C	3	0	3	0	3	6	0	0
10	1541359	.	T	C	1	0	1	0	5	6	0	0
10	1543805	.	C	G	0	10	10	0	8	18	0	0
10	1543848	.	G	C	2	0	2	0	4	6	0	0
10	1546089	.	A	C	5	0	5	0	3	8	0	0
10	1549013	.	C	A	0	0	0	0	3	3	0	0
10	1549088	.	C	T	0	5	5	0	9	14	0	0
10	1549494	.	G	A	6	11	17	0	3	20	0	0
10	1549532	.	A	G	5	5	10	0	1	11	0	0
10	1549714	.	G	A	10	5	15	0	0	15	0	0
10	1549769	.	A	G	10	3	13	0	0	13	0	0
10	1711499	.	T	C	14	8	22	2	0	24	0	0
10	1711502	.	T	C	3	18	21	2	0	23	0	0
10	1712100	.	T	A	0	14	14	0	0	14	0	0
10	2837968	.	C	T	1	2	3	0	1	4	0	0
10	2843022	.	G	A	3	1	4	0	1	5	0	0
10	2846887	.	C	T	1	1	2	0	0	2	0	0
10	2850332	.	A	G	1	3	4	0	0	4	0	0
10	2850416	.	G	A	3	1	4	0	1	5	0	0
10	2850608	.	G	C	1	1	2	0	0	2	0	0
10	2850614	.	G	T	0	3	3	0	1	4	0	0
10	2850651	.	T	A	3	4	7	0	0	7	0	0
10	2856584	.	G	T	4	4	8	0	0	8	0	0
10	2860806	.	G	A	2	1	3	0	0	3	0	0
10	2861679	.	T	C	0	0	0	0	4	4	0	0
10	2862538	.	T	A	3	2	5	0	0	5	0	0
10	2869202	.	G	A	1	4	5	0	0	5	0	0
10	2878104	.	G	C	1	2	3	0	0	3	0	0
10	2880537	.	A	G	1	2	3	0	0	3	0	0
10	2882230	.	C	T	1	2	3	0	0	3	0	0
10	2885852	.	C	T	4	1	5	0	0	5	0	0
10	2891893	.	C	T	1	3	4	0	1	5	0	0
10	2891905	.	G	A	3	4	7	0	0	7	0	0
10	2891981	.	A	T	7	3	10	0	0	10	0	0
10	2894193	.	T	G	2	0	2	0	2	4	0	0
10	2894451	.	G	A	0	9	9	0	3	12	0	0
10	2897110	.	A	C	4	12	16	0	0	16	0	0
10	2897720	.	T	A	4	2	6	0	1	7	0	0
10	2897817	.	T	G	5	0	5	0	9	14	0	0
10	2897897	.	A	G	1	7	8	0	0	8	0	0
10	2898160	.	C	T	1	2	3	0	0	3	0	0
10	2898212	.	T	G	1	4	5	0	0	5	0	0
10	2898213	.	C	G	1	4	5	0	0	5	0	0
10	2898260	.	T	G	5	3	8	0	0	8	0	0
10	2898269	.	C	T	1	4	5	0	2	7	0	0
10	2898346	.	T	A	4	9	13	0	1	14	0	0
10	2898390	.	A	T	1	5	6	0	1	7	0	0
10	2904581	.	T	C	2	2	4	0	0	4	0	0
10	2905862	.	G	A	2	3	5	0	0	5	0	0
10	2905868	.	T	C	1	3	4	0	0	4	0	0
10	2915426	.	C	T	3	4	7	0	0	7	0	0
10	2925089	.	A	G	8	4	12	0	1	13	0	0
10	2925196	.	T	A	3	3	6	0	0	6	0	0
10	2925379	.	G	T	3	5	8	0	0	8	0	0
10	2930577	.	C	A	4	1	5	0	0	5	0	0
10	2983370	.	T	C	1	2	3	0	0	3	0	0
10	2984945	.	G	A	0	2	2	0	3	5	0	0
10	3016329	.	C	T	1	4	5	0	0	5	0	0
10	3022076	.	G	T	3	2	5	0	0	5	0	0
10	3024637	.	C	G	2	4	6	0	0	6	0	0
10	3024706	.	C	T	2	3	5	0	0	5	0	0
10	3026264	.	A	C	9	7	16	0	0	16	0	0
10	3026484	.	G	A	0	2	2	0	1	3	0	0
10	3032072	.	C	T	7	7	14	0	1	15	0	0
10	3032353	.	T	A	2	7	9	0	0	9	0	0
10	3032458	.	C	T	0	2	2	0	3	5	0	0
10	3032512	.	T	A	4	3	7	0	0	7	0	0
10	3032743	.	T	C	2	2	4	0	1	5	0	0
10	3033160	.	G	A	3	2	5	0	0	5	0	0
10	3092240	.	T	C	0	2	2	0	0	2	0	0
10	3133204	.	T	A	10	3	13	0	0	13	0	0
10	3133251	.	G	A	5	4	9	0	2	11	0	0
10	3133598	.	A	C	8	12	20	0	0	20	0	0
10	3154684	.	A	G	1	3	4	0	1	5	0	0
10	3154825	.	C	G	1	5	6	0	0	6	0	0
10	3155314	.	T	C	5	5	10	0	0	10	0	0
10	3189081	.	G	A	2	0	2	0	0	2	0	0
10	3192786	.	G	A	5	3	8	0	0	8	0	0
10	3194054	.	T	C	1	2	3	0	0	3	0	0
10	3197593	.	A	G	1	0	1	0	0	1	0	0
10	3201871	.	G	A	7	2	9	0	0	9	0	0
10	3204658	.	A	G	1	3	4	0	0	4	0	0
10	3207591	.	A	G	0	2	2	0	0	2	0	0
10	3207612	.	A	G	1	3	4	0	0	4	0	0
10	3207646	.	C	T	3	5	8	0	1	9	0	0
10	3311737	.	T	G	6	3	9	0	0	9	0	0
10	3311845	.	G	A	2	2	4	0	0	4	0	0
10	3317675	.	C	T	17	3	20	0	2	22	0	0
10	3317800	.	C	A	13	11	24	0	0	24	0	0
10	3317823	.	G	T	16	8	24	0	1	26	1	0
10	3318112	.	G	C	8	10	18	0	0	18	0	0
10	3318322	.	A	T	0	3	3	0	0	3	0	0
10	3318358	.	G	T	3	3	6	0	1	7	0	0
10	3318490	.	G	A	1	6	7	0	4	11	0	0
10	3318502	.	A	G	4	6	10	0	1	11	0	0
10	3319029	.	A	T	11	10	21	0	0	21	0	0
10	3319035	.	C	T	10	8	18	0	0	18	0	0
10	3319352	.	A	G	2	7	9	0	0	9	0	0
10	3319970	.	G	A	10	14	24	0	0	24	0	0
10	3319981	.	A	T	11	14	25	0	1	26	0	0
10	3320072	.	T	G	13	12	25	0	0	25	0	0
10	3320229	.	G	A	10	14	24	0	0	24	0	0
10	3320287	.	T	G	14	8	22	0	1	23	0	0
10	3320355	.	A	T	8	12	20	0	0	20	0	0
10	3320487	.	A	G	12	1	13	0	10	23	0	0
10	3320561	.	A	T	13	14	27	0	1	28	0	0
10	3320705	.	G	A	11	14	25	0	0	25	0	0
10	3320834	.	A	C	18	13	31	0	1	32	0	0
10	3321262	.	A	G	8	28	36	0	1	37	0	0
10	3322004	.	C	G	16	12	28	0	0	28	0	0
10	3322012	.	C	T	17	14	31	0	0	31	0	0
10	3322276	.	G	C	9	5	14	0	0	14	0	0
10	3323879	.	C	T	1	2	3	0	0	3	0	0
10	3323880	.	T	A	1	2	3	0	0	3	0	0
10	3336838	.	C	T	1	2	3	0	0	3	0	0
10	3336846	.	T	A	1	2	3	0	0	3	0	0
10	3341367	.	C	T	2	3	5	0	0	5	0	0
10	3341412	.	C	T	1	1	2	0	0	2	0	0
10	3342716	.	G	T	0	1	1	0	0	1	0	0
10	3342795	.	T	C	3	3	6	0	0	6	0	0
10	3355651	.	T	C	4	3	7	0	0	7	0	0
10	3365312	.	T	C	5	8	13	0	0	13	0	0
10	3366199	.	C	T	1	6	7	0	1	8	0	0
10	3367810	.	C	T	2	1	3	0	0	3	0	0
10	3370209	.	G	A	3	4	7	0	0	7	0	0
10	3371866	.	G	A	2	0	2	0	0	2	0	0
10	3377195	.	G	A	1	3	4	0	0	4	0	0
10	3377222	.	T	C	0	0	0	0	1	1	0	0
10	3379107	.	T	C	1	0	1	0	4	5	0	0
10	3398030	.	G	A	1	4	5	0	0	5	0	0
10	3398215	.	G	T	1	4	5	0	0	5	0	0
10	3400093	.	T	C	0	1	1	0	0	1	0	0
10	3400126	.	A	T	0	6	6	0	0	6	0	0
10	3400216	.	C	T	7	6	13	0	0	13	0	0
10	3400225	.	T	C	8	6	14	0	0	14	0	0
10	3400360	.	G	A	1	0	1	0	0	1	0	0
10	3403764	.	C	T	0	2	2	0	3	5	0	0
10	3403832	.	C	A	1	4	5	0	0	5	0	0
10	3408009	.	G	A	1	0	1	0	0	1	0	0
10	3420148	.	G	A	22	23	45	0	0	45	0	0
10	3420358	.	T	C	10	7	17	0	0	17	0	0
10	3420480	.	C	G	20	16	36	0	4	40	0	0
10	3420487	.	T	C	20	0	20	0	18	38	0	0
10	3436313	.	C	T	3	3	6	0	0	6	0	0
10	3436334	.	C	T	3	2	5	0	0	5	0	0
10	3441753	.	T	A	2	2	4	0	0	4	0	0
10	3441973	.	T	C	4	4	8	0	1	9	0	0
10	3441980	.	T	C	4	4	8	0	0	8	0	0
10	3445818	.	C	T	8	5	13	0	0	13	0	0
10	3450825	.	G	C	4	6	10	0	0	10	0	0
10	3450861	.	A	G	4	6	10	0	1	11	0	0
10	3450863	.	A	T	4	6	10	0	1	11	0	0
10	3451349	.	T	A	10	5	15	0	1	16	0	0
10	3451429	.	G	A	0	7	7	0	13	20	0	0
10	3451688	.	C	T	3	2	5	0	0	5	0	0
10	3451848	.	G	A	0	4	4	0	7	11	0	0
10	3452007	.	A	T	4	5	9	0	0	10	1	0
10	3452045	.	G	A	4	6	10	0	1	11	0	0
10	3452073	.	A	G	3	9	12	0	0	12	0	0
10	3452183	.	G	A	2	4	6	0	1	7	0	0
10	3452185	.	T	A	2	5	7	0	0	7	0	0
10	3452314	.	T	C	10	7	17	0	0	17	0	0
10	3942996	.	T	A	2	2	4	0	1	5	0	0
10	3969326	.	G	A	1	4	5	0	1	6	0	0
10	3969956	.	T	C	1	4	5	0	0	5	0	0
10	3979870	.	G	A	4	5	9	0	1	10	0	0
10	3979876	.	C	A	5	5	10	0	0	10	0	0
10	3980002	.	C	T	7	3	10	0	0	10	0	0
10	3987526	.	A	G	2	1	3	0	0	3	0	0
10	3999676	.	C	T	3	1	4	0	0	4	0	0
10	4010297	.	G	A	1	2	3	0	0	3	0	0
10	4010345	.	G	T	0	2	2	0	2	4	0	0
10	4026443	.	T	G	2	0	2	0	5	7	0	0
10	4029455	.	C	T	2	4	6	0	0	6	0	0
10	4029813	.	C	T	1	3	4	0	0	4	0	0
10	4030349	.	C	T	2	3	5	0	0	5	0	0
10	4030352	.	C	A	2	3	5	0	0	5	0	0
10	4034098	.	T	C	8	8	16	0	0	16	0	0
10	4037287	.	G	A	1	0	1	0	0	1	0	0
10	4037794	.	T	C	6	2	8	0	0	8	0	0
10	4038334	.	G	A	9	6	15	0	2	17	0	0
10	4038697	.	C	T	8	8	16	0	0	16	0	0
10	4038721	.	G	A	1	4	5	0	10	15	0	0
10	4038772	.	G	A	10	10	20	0	0	20	0	0
10	4039094	.	G	A	16	7	23	0	3	26	0	0
10	4039123	.	C	T	13	19	32	0	1	33	0	0
10	4039129	.	C	T	12	16	28	0	2	30	0	0
10	4039315	.	A	T	17	13	30	0	2	32	0	0
10	4039636	.	T	C	9	13	22	0	1	23	0	0
10	4039714	.	T	C	19	9	28	0	2	30	0	0
10	4096159	.	A	G	2	0	2	0	2	4	0	0
10	4096417	.	T	C	2	2	4	0	0	4	0	0
10	4096744	.	C	G	4	2	6	0	0	6	0	0
10	4096885	.	T	C	4	5	9	0	0	9	0	0
10	4097053	.	T	A	2	2	4	0	0	4	0	0
10	4097279	.	C	A	1	2	3	0	0	3	0	0
10	4098235	.	C	T	6	6	12	0	1	13	0	0
10	4098355	.	A	T	3	9	12	0	1	13	0	0
10	4240887	.	T	C	13	11	24	0	0	24	0	0
10	4240899	.	C	T	14	8	22	0	1	23	0	0
10	4253636	.	C	T	15	14	29	0	3	32	0	0
10	4279587	.	C	T	3	2	5	0	0	5	0	0
10	4279716	.	C	T	1	2	3	0	1	4	0	0
10	4279800	.	A	G	5	2	7	0	0	7	0	0
10	4299528	.	A	G	1	2	3	0	0	3	0	0
10	4369729	.	T	G	1	2	3	0	0	3	0	0
10	4369955	.	T	C	2	1	3	0	0	3	0	0
10	4369968	.	A	G	3	1	4	0	0	4	0	0
10	4369993	.	G	A	3	2	5	0	0	5	0	0
10	4500050	.	G	A	10	6	16	0	0	16	0	0
10	4501817	.	A	G	1	1	2	0	0	2	0	0
10	4502929	.	C	T	3	2	5	0	0	5	0	0
10	4503291	.	G	T	9	5	14	0	1	15	0	0
10	4503606	.	A	T	2	0	2	0	0	2	0	0
10	4505948	.	T	C	0	1	1	0	0	1	0	0
10	4508518	.	G	T	0	15	15	0	25	41	1	0
10	4808241	.	A	C	1	2	3	0	0	3	0	0
10	4950854	.	G	A	8	9	17	0	0	17	0	0
10	4950857	.	T	C	9	10	19	0	0	19	0	0
10	4950914	.	T	C	11	0	11	0	10	21	0	0
10	4953443	.	C	T	4	7	11	0	0	11	0	0
10	4953461	.	C	A	5	5	10	0	0	10	0	0
10	4953987	.	A	C	1	0	1	0	2	3	0	0
10	4954125	.	T	C	0	1	1	0	0	1	0	0
10	4956942	.	C	T	0	4	4	0	3	7	0	0
10	4956987	.	C	T	0	3	3	0	4	7	0	0
10	4968900	.	G	C	3	3	6	0	0	6	0	0
10	4969014	.	T	A	9	7	16	0	0	16	0	0
10	4969036	.	T	G	6	0	6	0	6	12	0	0
10	4969069	.	C	A	5	6	11	0	0	11	0	0
10	5000719	.	C	T	1	8	9	0	15	24	0	0
10	5000753	.	C	T	0	13	13	0	15	28	0	0
10	5004215	.	C	T	10	3	13	0	0	13	0	0
10	5010287	.	G	A	13	14	27	0	0	27	0	0
10	5010344	.	T	G	19	16	35	0	2	37	0	0
10	5010407	.	G	A	3	2	5	0	0	5	0	0
10	5016797	.	G	A	22	23	45	0	2	47	0	0
10	5016917	.	C	G	20	23	43	0	1	44	0	0
10	5016922	.	A	G	20	22	42	0	1	43	0	0
10	5020320	.	G	A	26	27	53	0	0	53	0	0
10	5020326	.	T	C	25	23	48	0	0	48	0	0
10	5024410	.	C	T	27	22	49	0	1	50	0	0
10	5025848	.	C	A	5	9	14	0	1	15	0	0
10	5026058	.	C	T	1	1	2	0	0	2	0	0
10	5028877	.	A	G	2	6	8	0	1	9	0	0
10	5031869	.	T	C	3	5	8	0	1	9	0	0
10	5036521	.	G	A	3	10	13	0	8	21	0	0
10	5036522	.	A	G	10	10	20	0	1	21	0	0
10	5036729	.	C	T	10	7	17	0	1	18	0	0
10	5036881	.	A	G	6	2	8	0	2	10	0	0
10	5037119	.	T	A	12	11	23	0	0	23	0	0
10	5037147	.	C	T	8	10	18	0	0	18	0	0
10	5037181	.	T	G	9	3	12	0	1	13	0	0
10	5037260	.	A	C	2	12	14	0	0	14	0	0
10	5037372	.	A	T	14	10	24	0	2	26	0	0
10	5042034	.	A	C	3	5	8	0	0	8	0	0
10	5042113	.	C	T	8	6	14	0	2	16	0	0
10	5042217	.	A	G	2	4	6	0	0	6	0	0
10	5042239	.	G	A	1	2	3	0	1	4	0	0
10	5042469	.	G	A	2	0	2	0	1	3	0	0
10	5047452	.	A	G	5	5	10	0	0	10	0	0
10	5092764	.	T	C	9	7	16	0	0	16	0	0
10	5092772	.	A	G	6	6	12	0	1	13	0	0
10	5093121	.	C	G	1	6	7	0	2	9	0	0
10	5093157	.	T	C	6	12	18	0	5	23	0	0
10	5093222	.	A	G	5	13	18	0	0	18	0	0
10	5093240	.	C	A	2	9	11	0	0	11	0	0
10	5094778	.	G	T	2	5	7	0	0	7	0	0
10	5097478	.	G	A	7	4	11	0	0	11	0	0
10	5097520	.	A	G	3	5	8	0	1	9	0	0
10	5110761	.	A	G	1	1	2	0	0	2	0	0
10	5110777	.	G	A	2	2	4	0	0	4	0	0
10	5135655	.	A	T	1	2	3	0	1	4	0	0
10	5159534	.	C	T	9	3	12	0	0	12	0	0
10	5203569	.	G	A	2	1	3	0	0	3	0	0
10	5216204	.	T	C	1	5	6	0	0	6	0	0
10	5216249	.	A	G	1	5	6	0	0	6	0	0
10	5220608	.	C	T	10	10	20	0	1	21	0	0
10	5220835	.	G	A	0	5	5	0	2	7	0	0
10	5220940	.	T	A	4	8	12	0	1	13	0	0
10	5220992	.	C	T	6	8	14	0	1	15	0	0
10	5220997	.	C	A	7	6	13	0	0	14	1	0
10	5221039	.	G	A	6	10	16	0	0	16	0	0
10	5221199	.	T	A	2	3	5	0	0	5	0	0
10	5221238	.	C	A	6	4	10	0	0	10	0	0
10	5221292	.	C	A	6	7	13	0	0	13	0	0
10	5221297	.	T	G	6	6	12	0	0	12	0	0
10	5221336	.	G	C	4	8	12	0	1	13	0	0
10	5237199	.	C	A	1	1	2	0	0	2	0	0
10	5237213	.	C	T	1	1	2	0	0	2	0	0
10	5245143	.	G	A	0	1	1	0	1	2	0	0
10	5245194	.	C	G	2	0	2	0	1	3	0	0
10	5248247	.	T	C	3	3	6	0	0	6	0	0
10	5258914	.	T	A	4	3	7	0	0	7	0	0
10	5264280	.	A	G	1	0	1	0	0	1	0	0
10	5264458	.	G	A	7	5	12	0	0	12	0	0
10	5264534	.	C	A	3	3	6	0	0	6	0	0
10	5417669	.	T	A	9	3	12	0	0	12	0	0
10	5418509	.	A	G	6	9	15	0	0	15	0	0
10	5418569	.	C	T	7	11	18	0	0	18	0	0
10	5429905	.	G	A	0	0	0	0	2	2	0	0
10	5461988	.	C	A	7	4	11	0	0	11	0	0
10	5461994	.	T	A	7	4	11	0	0	11	0	0
10	5475206	.	G	C	5	12	17	0	1	18	0	0
10	5475214	.	T	G	5	11	16	0	2	18	0	0
10	5475406	.	A	T	2	2	4	0	1	5	0	0
10	5475436	.	A	G	3	3	6	0	1	7	0	0
10	5475526	.	T	C	4	10	14	0	1	15	0	0
10	5534179	.	T	A	3	8	11	0	1	12	0	0
10	5534369	.	T	A	2	5	7	0	0	7	0	0
10	5534483	.	T	C	7	4	11	0	1	12	0	0
10	5534487	.	C	T	0	4	4	0	7	11	0	0
10	5534527	.	G	T	3	7	10	0	0	10	0	0
10	5534539	.	G	A	3	6	9	0	0	9	0	0
10	5534611	.	C	T	4	10	14	2	0	16	0	0
10	5534612	.	A	G	4	10	14	2	0	16	0	0
10	5534646	.	A	G	5	14	19	0	0	19	0	0
10	5534878	.	C	T	13	9	22	0	0	22	0	0
10	5534946	.	A	G	11	8	19	0	2	21	0	0
10	5534950	.	A	T	12	8	20	0	0	20	0	0
10	5535047	.	A	T	13	3	16	0	1	17	0	0
10	5535048	.	C	G	14	3	17	0	0	17	0	0
10	5535359	.	A	T	16	6	22	0	0	22	0	0
10	5535368	.	T	A	14	6	20	0	0	20	0	0
10	5535483	.	A	T	10	5	15	0	1	16	0	0
10	5535540	.	T	G	7	8	15	0	1	16	0	0
10	5535561	.	T	A	7	7	14	0	0	14	0	0
10	5536534	.	T	A	3	3	6	0	0	6	0	0
10	5536831	.	G	T	1	2	3	0	0	3	0	0
10	5537048	.	G	T	4	4	8	0	0	8	0	0
10	5538302	.	T	G	7	3	10	0	0	10	0	0
10	5542152	.	T	C	0	4	4	0	0	4	0	0
10	5545438	.	C	T	5	3	8	0	0	8	0	0
10	5545465	.	T	C	6	6	12	0	0	12	0	0
10	5568128	.	G	T	3	6	9	0	0	9	0	0
10	5568212	.	G	A	7	4	11	0	0	11	0	0
10	5568319	.	A	C	8	5	13	0	0	13	0	0
10	5568329	.	A	G	8	5	13	0	0	13	0	0
10	5667467	.	T	A	3	2	5	0	0	5	0	0
10	5667676	.	C	A	2	2	4	0	0	4	0	0
10	5667687	.	C	G	1	1	2	0	0	2	0	0
10	5667906	.	C	A	2	3	5	0	0	5	0	0
10	5668103	.	C	T	2	3	5	0	1	6	0	0
10	5668135	.	G	A	4	6	10	0	0	10	0	0
10	5668218	.	G	C	6	8	14	0	0	14	0	0
10	5676520	.	T	A	0	2	2	0	0	2	0	0
10	5724095	.	T	C	1	5	6	0	0	6	0	0
10	5737757	.	G	A	4	2	6	0	0	6	0	0
10	5744934	.	C	T	4	0	4	0	0	4	0	0
10	5745015	.	C	A	8	12	20	0	0	20	0	0
10	5760455	.	T	C	14	12	26	0	1	27	0	0
10	5760461	.	A	G	14	14	28	0	0	28	0	0
10	5766958	.	A	G	6	5	11	0	0	11	0	0
10	5769541	.	G	T	4	1	5	0	0	5	0	0
10	5772568	.	A	G	7	7	14	0	0	14	0	0
10	5782337	.	C	T	1	0	1	0	0	1	0	0
10	5788755	.	A	C	8	9	17	0	2	19	0	0
10	5788806	.	G	A	5	7	12	0	0	12	0	0
10	5788877	.	G	A	7	6	13	0	1	14	0	0
10	5789155	.	G	T	8	6	14	0	0	14	0	0
10	5789215	.	T	C	11	0	11	0	3	14	0	0
10	5789218	.	T	C	11	3	14	0	0	14	0	0
10	5789266	.	T	C	4	0	4	0	3	7	0	0
10	5789415	.	A	G	3	3	6	0	1	7	0	0
10	5789417	.	G	C	3	3	6	0	1	7	0	0
10	5789995	.	C	T	3	3	6	0	0	6	0	0
10	5790080	.	A	G	3	13	16	0	0	16	0	0
10	5790097	.	G	A	3	11	14	0	0	14	0	0
10	5790210	.	C	T	12	7	19	1	2	22	0	0
10	5790278	.	G	T	2	6	8	0	0	8	0	0
10	5790570	.	A	C	7	9	16	0	0	16	0	0
10	5790640	.	T	G	6	4	10	0	0	10	0	0
10	5790866	.	A	C	5	3	8	0	0	8	0	0
10	5790913	.	A	C	6	7	13	0	0	13	0	0
10	5790922	.	C	A	5	6	11	0	0	11	0	0
10	5790956	.	C	G	0	10	10	0	5	15	0	0
10	5791030	.	A	G	3	7	10	0	0	10	0	0
10	5791044	.	C	T	1	6	7	0	2	9	0	0
10	5791184	.	G	A	7	5	12	0	1	13	0	0
10	5791224	.	C	G	6	10	16	0	0	16	0	0
10	5791238	.	A	G	6	9	15	0	0	15	0	0
10	5791377	.	A	T	2	10	12	0	2	14	0	0
10	5791387	.	G	A	5	9	14	0	2	16	0	0
10	5791417	.	C	T	0	11	11	0	6	17	0	0
10	5791852	.	A	G	2	2	4	0	0	4	0	0
10	5792007	.	A	G	11	4	15	0	1	16	0	0
10	5792512	.	A	T	6	8	14	0	0	14	0	0
10	5792533	.	A	T	5	3	8	0	1	9	0	0
10	5792722	.	T	C	6	0	6	0	6	12	0	0
10	5792757	.	A	G	6	4	10	0	1	11	0	0
10	5793568	.	T	A	1	4	5	0	0	5	0	0
10	5794423	.	C	G	2	4	6	0	0	6	0	0
10	5794503	.	G	A	6	2	8	0	0	8	0	0
10	5828639	.	C	T	6	3	9	0	0	9	0	0
10	5828645	.	A	G	6	3	9	0	0	9	0	0
10	5828704	.	C	A	1	7	8	0	8	16	0	0
10	5828840	.	A	G	8	6	14	0	0	14	0	0
10	5829041	.	A	G	6	9	15	0	1	16	0	0
10	5837337	.	G	A	2	1	3	0	0	3	0	0
10	6004828	.	A	G	1	0	1	0	2	3	0	0
10	6016242	.	G	A	2	0	2	0	0	2	0	0
10	6016545	.	G	T	2	4	6	0	1	7	0	0
10	6023750	.	A	G	1	1	2	0	0	2	0	0
10	6023958	.	G	A	1	2	3	0	0	3	0	0
10	6032880	.	A	G	5	0	5	0	7	12	0	0
10	6032886	.	G	A	5	7	12	0	0	12	0	0
10	6033452	.	T	C	2	4	6	0	0	6	0	0
10	6033469	.	A	C	3	5	8	0	0	8	0	0
10	6033612	.	G	A	0	7	7	0	8	15	0	0
10	6033627	.	A	T	7	10	17	0	0	17	0	0
10	6034194	.	A	T	9	7	16	0	0	16	0	0
10	6265475	.	A	G	1	1	2	0	0	2	0	0
10	6275517	.	G	A	2	1	3	0	0	3	0	0
10	6275577	.	C	T	3	3	6	0	1	7	0	0
10	6278202	.	A	G	0	1	1	0	0	1	0	0
10	6280939	.	G	A	0	2	2	0	0	2	0	0
10	6280948	.	G	A	0	4	4	0	0	4	0	0
10	6281946	.	A	G	2	0	2	0	3	5	0	0
10	6301930	.	C	T	8	7	15	0	0	15	0	0
10	6312954	.	A	T	4	8	12	0	0	12	0	0
10	6348571	.	C	A	4	5	9	0	0	9	0	0
10	6372501	.	C	T	11	7	18	0	2	20	0	0
10	6372864	.	A	T	8	3	11	0	0	11	0	0
10	6372865	.	T	C	7	3	10	0	1	11	0	0
10	6372915	.	G	A	7	5	12	0	0	12	0	0
10	6372964	.	T	C	6	7	13	0	0	13	0	0
10	6373332	.	A	T	8	6	14	0	0	14	0	0
10	6373336	.	C	G	8	5	13	0	1	14	0	0
10	6373378	.	A	C	5	5	10	0	1	11	0	0
10	6373472	.	T	A	5	4	9	0	0	9	0	0
10	6373522	.	A	T	2	5	7	0	0	9	2	0
10	6373581	.	A	G	7	6	13	0	0	13	0	0
10	6373614	.	A	G	6	7	13	0	0	13	0	0
10	6373758	.	A	C	10	16	26	0	0	26	0	0
10	6374017	.	A	G	6	11	17	0	1	18	0	0
10	6374041	.	A	T	6	9	15	0	0	15	0	0
10	6374068	.	G	T	7	7	14	0	0	14	0	0
10	6374235	.	T	C	14	19	33	0	0	33	0	0
10	6374279	.	G	A	0	22	22	0	13	35	0	0
10	6374352	.	C	T	19	16	35	0	0	35	0	0
10	6374573	.	A	T	8	10	18	0	0	18	0	0
10	6374597	.	A	G	9	12	21	0	0	21	0	0
10	6374615	.	T	C	13	11	24	0	1	25	0	0
10	6374695	.	A	G	7	11	18	0	4	22	0	0
10	6374717	.	A	G	3	15	18	0	1	19	0	0
10	6383521	.	A	T	1	2	3	0	0	3	0	0
10	6400234	.	C	T	1	2	3	0	0	3	0	0
10	6401884	.	T	A	1	2	3	0	0	3	0	0
10	6402593	.	G	A	0	4	4	0	1	5	0	0
10	6402993	.	A	G	1	1	2	0	0	2	0	0
10	6404764	.	G	C	2	4	6	0	0	6	0	0
10	6404899	.	G	T	1	3	4	0	1	5	0	0
10	6404900	.	G	T	1	3	4	0	1	5	0	0
10	6405251	.	G	C	5	3	8	0	0	8	0	0
10	6405275	.	A	T	4	4	8	0	0	8	0	0
10	6405321	.	A	G	1	3	4	0	0	4	0	0
10	6406093	.	A	G	1	0	1	0	3	4	0	0
10	6407408	.	T	C	5	4	9	0	1	10	0	0
10	6407449	.	C	T	4	3	7	0	1	8	0	0
10	6407475	.	G	A	0	4	4	0	5	9	0	0
10	6407559	.	A	T	4	2	6	0	1	7	0	0
10	6407605	.	C	A	1	4	5	0	0	5	0	0
10	6407732	.	A	T	1	2	3	0	0	4	1	0
10	6407764	.	C	A	2	1	3	0	0	3	0	0
10	6407787	.	A	G	8	1	9	0	0	9	0	0
10	6407833	.	T	C	9	2	11	0	0	11	0	0
10	6407904	.	C	T	3	4	7	0	1	8	0	0
10	6408955	.	T	G	8	0	8	0	4	12	0	0
10	6408986	.	A	G	2	6	8	0	1	9	0	0
10	6409095	.	G	A	1	7	8	0	9	17	0	0
10	6409120	.	G	A	6	5	11	0	0	11	0	0
10	6409145	.	G	C	5	3	8	0	1	9	0	0
10	6409267	.	C	A	5	3	8	0	0	8	0	0
10	6409379	.	A	G	4	9	13	0	1	14	0	0
10	6409448	.	C	T	8	8	16	0	1	17	0	0
10	6409455	.	T	A	9	8	17	0	0	17	0	0
10	6409506	.	A	G	7	11	18	0	0	18	0	0
10	6409583	.	C	T	3	3	6	0	0	6	0	0
10	6473544	.	T	C	14	9	23	0	2	25	0	0
10	6473685	.	T	C	11	16	27	0	1	28	0	0
10	6473704	.	C	G	13	17	30	0	2	32	0	0
10	6473851	.	A	G	19	10	29	0	1	30	0	0
10	6473862	.	C	T	0	10	10	0	20	30	0	0
10	6473908	.	A	G	13	10	23	0	0	23	0	0
10	6473996	.	T	C	13	11	24	0	2	26	0	0
10	6474057	.	T	A	9	6	15	0	0	15	0	0
10	6479444	.	T	C	8	1	9	0	13	22	0	0
10	6479471	.	C	T	1	7	8	0	4	12	0	0
10	6510756	.	T	C	10	12	22	0	1	23	0	0
10	6510786	.	T	G	18	25	43	0	0	43	0	0
10	6510825	.	T	C	10	15	25	0	1	26	0	0
10	6517593	.	T	A	31	29	60	0	0	61	1	0
10	6517663	.	A	G	27	1	28	0	17	45	0	0
10	6517726	.	C	T	22	17	39	0	2	41	0	0
10	6517959	.	A	G	25	14	39	0	0	39	0	0
10	6522267	.	A	T	4	8	12	0	0	12	0	0
10	6531002	.	A	G	0	3	3	0	0	3	0	0
10	6531297	.	T	C	6	1	7	0	0	7	0	0
10	6533850	.	T	A	5	3	8	0	1	9	0	0
10	6546851	.	A	G	1	1	2	0	0	2	0	0
10	6546929	.	C	A	0	3	3	0	2	5	0	0
10	6549360	.	C	T	3	2	5	0	0	5	0	0
10	6781239	.	G	A	12	4	16	0	0	16	0	0
10	6781278	.	T	A	10	9	19	0	1	20	0	0
10	6781286	.	G	T	9	10	19	0	0	19	0	0
10	6781362	.	G	A	10	10	20	0	2	22	0	0
10	6781372	.	T	A	12	13	25	0	3	28	0	0
10	6781450	.	T	C	15	18	33	0	3	36	0	0
10	6781506	.	A	T	11	15	26	0	0	26	0	0
10	6781664	.	A	T	12	13	25	0	2	27	0	0
10	6781742	.	G	T	4	6	10	0	1	11	0	0
10	6781786	.	A	T	4	5	9	0	0	9	0	0
10	6781867	.	C	A	9	5	14	0	1	15	0	0
10	6781903	.	T	G	9	8	17	0	1	18	0	0
10	6781918	.	A	T	8	12	20	0	0	20	0	0
10	6782020	.	G	C	10	11	21	0	1	22	0	0
10	6782036	.	T	C	10	1	11	0	6	17	0	0
10	6782220	.	A	G	1	10	11	0	0	11	0	0
10	6782267	.	T	A	1	3	4	1	0	5	0	0
10	6782279	.	A	C	2	5	7	1	0	8	0	0
10	6782454	.	C	G	8	14	22	0	1	23	0	0
10	6782489	.	T	G	9	11	20	0	2	22	0	0
10	6782624	.	A	G	20	17	37	0	0	37	0	0
10	6782636	.	T	A	20	19	39	0	2	41	0	0
10	6782664	.	A	G	20	26	46	0	0	46	0	0
10	6786326	.	C	T	0	2	2	0	3	5	0	0
10	6786564	.	A	G	8	19	27	0	0	27	0	0
10	6804756	.	T	C	4	0	4	0	14	18	0	0
10	6824761	.	A	C	3	2	5	0	0	5	0	0
10	6824845	.	A	T	6	13	19	0	0	19	0	0
10	6824877	.	T	G	3	5	8	0	1	9	0	0
10	6831446	.	T	C	2	1	3	0	1	4	0	0
10	6834065	.	A	T	3	2	5	0	0	5	0	0
10	6834341	.	G	A	5	5	10	0	0	10	0	0
10	6853641	.	A	G	0	1	1	0	0	1	0	0
10	7210001	.	G	A	0	10	10	0	11	21	0	0
10	7221810	.	A	G	8	8	16	0	0	16	0	0
10	7222213	.	T	C	4	13	17	0	1	18	0	0
10	7224964	.	A	G	1	2	3	0	0	3	0	0
10	7231728	.	T	C	19	29	48	0	0	48	0	0
10	7231821	.	T	A	29	21	50	0	0	50	0	0
10	7231964	.	G	C	22	21	43	0	2	45	0	0
10	7232043	.	T	A	18	17	35	0	1	36	0	0
10	7232058	.	G	T	0	17	17	0	16	33	0	0
10	7232104	.	A	T	16	14	30	0	1	31	0	0
10	7232309	.	C	T	5	9	14	0	1	15	0	0
10	7232416	.	T	C	18	13	31	0	1	32	0	0
10	7232420	.	T	C	17	16	33	0	0	33	0	0
10	7233038	.	T	C	12	25	37	0	1	38	0	0
10	7233218	.	A	G	21	25	46	0	1	48	1	0
10	7233440	.	A	T	24	42	66	0	2	68	0	0
10	7233457	.	C	G	24	41	65	0	2	67	0	0
10	7233518	.	T	C	28	19	47	0	2	49	0	0
10	7233854	.	A	T	19	20	39	0	3	42	0	0
10	7284182	.	T	A	10	7	17	0	0	17	0	0
10	7284403	.	C	T	7	5	12	0	0	12	0	0
10	7284520	.	A	G	8	7	15	0	0	15	0	0
10	7284556	.	T	A	9	8	17	0	1	18	0	0
10	7284629	.	T	C	4	14	18	0	0	18	0	0
10	7311997	.	T	G	1	0	1	0	0	1	0	0
10	7312057	.	A	G	1	5	6	0	0	6	0	0
10	7483671	.	A	G	3	2	5	0	0	5	0	0
10	7500099	.	G	A	1	1	2	0	0	2	0	0
10	7500101	.	T	A	1	1	2	0	0	2	0	0
10	7564294	.	C	T	3	6	9	0	1	10	0	0
10	7588723	.	A	T	1	2	3	0	0	3	0	0
10	7593246	.	A	T	11	6	17	0	0	17	0	0
10	7593349	.	C	A	13	13	26	0	1	27	0	0
10	7617113	.	A	T	31	28	59	0	0	59	0	0
10	7617126	.	T	C	31	27	58	0	2	60	0	0
10	7617242	.	G	A	25	28	53	0	3	56	0	0
10	7617327	.	A	C	15	19	34	0	10	44	0	0
10	7617350	.	A	T	22	25	47	0	5	52	0	0
10	7617636	.	A	G	25	4	29	0	18	47	0	0
10	7624140	.	T	C	5	0	5	0	4	9	0	0
10	7624174	.	T	C	2	0	2	0	2	4	0	0
10	7635245	.	C	T	1	0	1	0	0	1	0	0
10	7640501	.	C	T	3	3	6	0	0	6	0	0
10	7640676	.	G	A	21	16	37	0	0	37	0	0
10	7653663	.	C	T	0	3	3	0	1	4	0	0
10	7671368	.	T	C	12	4	16	0	1	17	0	0
10	7671425	.	G	A	10	3	13	0	0	13	0	0
10	7672832	.	A	C	3	5	8	0	1	9	0	0
10	7672853	.	G	A	8	6	14	0	1	15	0	0
10	7673819	.	C	G	3	3	6	0	0	6	0	0
10	7674079	.	T	G	6	5	11	0	0	11	0	0
10	7674136	.	C	T	3	5	8	0	0	8	0	0
10	7674429	.	C	T	1	3	4	0	0	4	0	0
10	7674506	.	A	G	9	9	18	0	1	19	0	0
10	7678121	.	T	C	1	3	4	0	0	4	0	0
10	7678154	.	C	T	0	5	5	0	4	9	0	0
10	7696900	.	G	A	2	0	2	0	0	2	0	0
10	7700564	.	T	G	5	4	9	0	0	9	0	0
10	7700615	.	A	G	5	6	11	0	1	12	0	0
10	7700676	.	G	A	0	3	3	0	0	3	0	0
10	7701852	.	A	C	2	0	2	0	0	2	0	0
10	7704484	.	C	A	2	3	5	0	0	5	0	0
10	7704490	.	G	A	2	3	5	0	0	5	0	0
10	7709761	.	T	C	1	5	6	0	0	6	0	0
10	7709975	.	A	G	4	4	8	0	0	8	0	0
10	7709978	.	T	C	3	3	6	0	1	7	0	0
10	7712180	.	T	A	5	6	11	0	1	12	0	0
10	7712206	.	G	A	3	2	5	0	1	6	0	0
10	7712228	.	C	T	2	0	2	0	0	2	0	0
10	7713924	.	A	G	2	0	2	0	2	4	0	0
10	7721459	.	A	G	8	7	15	0	0	15	0	0
10	7721746	.	G	A	7	7	14	0	0	14	0	0
10	7722595	.	A	G	11	10	21	0	0	21	0	0
10	7723004	.	T	C	6	5	11	0	1	12	0	0
10	7723061	.	C	A	6	11	17	0	0	17	0	0
10	7723074	.	G	A	4	2	6	0	7	13	0	0
10	7723157	.	A	G	9	15	24	0	0	24	0	0
10	7723218	.	T	C	11	15	26	0	1	27	0	0
10	7723275	.	C	A	17	13	30	0	2	32	0	0
10	7723413	.	T	G	2	3	5	0	0	5	0	0
10	7727505	.	T	A	1	2	3	0	0	3	0	0
10	7727598	.	A	T	3	4	7	0	0	7	0	0
10	7727704	.	T	A	0	2	2	0	0	2	0	0
10	7734465	.	C	T	3	9	12	0	0	12	0	0
10	7739208	.	G	A	1	2	3	0	0	3	0	0
10	7770111	.	G	A	1	3	4	0	0	4	0	0
10	7770200	.	A	G	1	3	4	0	0	4	0	0
10	7770201	.	G	A	1	3	4	0	0	4	0	0
10	7771015	.	G	A	1	2	3	0	0	3	0	0
10	7771634	.	T	A	1	2	3	0	1	4	0	0
10	7771735	.	A	C	3	3	6	0	0	6	0	0
10	7771769	.	C	T	4	4	8	0	0	8	0	0
10	7771778	.	G	A	3	2	5	0	1	6	0	0
10	7772012	.	T	G	7	3	10	0	0	10	0	0
10	7772272	.	C	T	3	6	9	0	0	9	0	0
10	7804460	.	T	C	2	2	4	0	0	4	0	0
10	7804461	.	T	C	2	2	4	0	0	4	0	0
10	7810461	.	A	T	19	23	42	0	1	43	0	0
10	7810565	.	G	A	19	22	41	0	0	41	0	0
10	7811062	.	T	A	1	5	6	0	0	6	0	0
10	7811075	.	T	C	1	3	4	0	0	4	0	0
10	7811935	.	A	G	14	4	18	0	2	20	0	0
10	7815118	.	G	A	4	10	14	0	0	14	0	0
10	7815187	.	G	A	4	0	4	0	0	4	0	0
10	7831879	.	C	T	2	5	7	0	1	8	0	0
10	7843465	.	A	G	1	1	2	0	0	2	0	0
10	7850682	.	T	G	0	2	2	0	0	2	0	0
10	7901065	.	T	G	3	2	5	0	0	5	0	0
10	7902045	.	T	G	4	4	8	0	0	8	0	0
10	7916836	.	A	C	8	15	23	0	0	23	0	0
10	7916930	.	C	A	7	15	22	0	0	22	0	0
10	7917036	.	A	T	9	16	25	0	0	25	0	0
10	7917114	.	T	C	17	18	35	0	5	40	0	0
10	7917411	.	C	A	0	10	10	0	18	28	0	0
10	7917483	.	C	A	8	13	21	0	4	25	0	0
10	7917551	.	A	G	19	14	33	0	1	34	0	0
10	7917592	.	T	C	21	19	40	0	2	42	0	0
10	7917686	.	T	C	19	15	34	0	4	38	0	0
10	7917690	.	A	T	20	16	36	0	2	38	0	0
10	7920910	.	T	G	13	19	32	0	0	32	0	0
10	7920913	.	C	T	13	12	25	0	6	31	0	0
10	7922210	.	G	T	6	5	11	0	4	15	0	0
10	7922294	.	C	A	11	14	25	0	1	26	0	0
10	7926899	.	A	G	2	3	5	0	0	5	0	0
10	7929647	.	T	C	6	0	6	0	7	13	0	0
10	7936283	.	T	G	11	14	25	0	0	25	0	0
10	7938629	.	C	T	4	2	6	0	1	7	0	0
10	7938659	.	A	G	6	6	12	0	1	13	0	0
10	7938683	.	T	C	4	8	12	0	1	13	0	0
10	7984677	.	A	T	5	2	7	0	0	7	0	0
10	7986217	.	T	C	12	5	17	0	0	17	0	0
10	7989162	.	T	G	4	10	14	0	0	14	0	0
10	7989237	.	G	A	10	8	18	0	0	18	0	0
10	7989287	.	G	A	11	12	23	0	0	23	0	0
10	7989348	.	C	T	9	20	29	0	1	30	0	0
10	7989576	.	C	T	4	5	9	0	1	10	0	0
10	7992197	.	T	C	11	10	21	0	3	24	0	0
10	7996021	.	G	A	2	2	4	0	0	4	0	0
10	8001365	.	A	G	4	4	8	0	0	8	0	0
10	8005785	.	T	A	6	6	12	0	1	13	0	0
10	8005845	.	C	A	0	1	1	0	0	1	0	0
10	8009996	.	A	C	1	2	3	0	0	3	0	0
10	8010064	.	A	G	1	0	1	0	0	1	0	0
10	8033234	.	T	C	1	1	2	0	0	2	0	0
10	8033259	.	C	T	0	3	3	0	0	3	0	0
10	8035239	.	T	G	2	2	4	0	0	4	0	0
10	8035277	.	A	G	3	2	5	0	0	5	0	0
10	8036409	.	T	C	1	3	4	0	0	4	0	0
10	8036428	.	G	T	2	2	4	0	0	4	0	0
10	8036799	.	T	C	2	0	2	1	2	5	0	0
10	8036884	.	C	T	0	5	5	0	2	7	0	0
10	8037506	.	A	G	4	2	6	0	1	7	0	0
10	8037519	.	G	T	1	2	3	0	0	3	0	0
10	8040536	.	T	C	1	0	1	0	0	1	0	0
10	8041412	.	G	C	1	2	3	0	0	3	0	0
10	8091212	.	G	A	10	14	24	0	0	24	0	0
10	8097929	.	C	G	22	12	34	0	0	34	0	0
10	8160813	.	T	G	5	5	10	0	0	10	0	0
10	8161027	.	A	G	4	4	8	0	0	8	0	0
10	8161028	.	G	A	4	3	7	0	1	8	0	0
10	8163440	.	G	A	2	2	4	0	0	4	0	0
10	8174712	.	A	C	0	0	0	0	2	2	0	0
10	8175164	.	C	A	0	1	1	0	1	2	0	0
10	8177559	.	C	T	0	0	0	0	3	3	0	0
10	8177748	.	A	G	1	3	4	0	0	4	0	0
10	8188485	.	C	T	0	1	1	0	0	1	0	0
10	8194893	.	G	A	2	2	4	0	0	4	0	0
10	8217029	.	T	C	0	1	1	0	0	1	0	0
10	8235946	.	A	G	1	0	1	0	0	1	0	0
10	8236048	.	T	C	1	1	2	0	0	2	0	0
10	8236775	.	T	C	4	4	8	0	0	8	0	0
10	8265917	.	A	T	8	4	12	0	0	12	0	0
10	8265922	.	T	C	7	5	12	0	0	12	0	0
10	8265968	.	C	T	2	1	3	0	2	5	0	0
10	8265970	.	G	A	3	2	5	0	0	5	0	0
10	8266248	.	C	T	0	20	20	0	21	41	0	0
10	8266383	.	A	G	15	18	33	0	2	35	0	0
10	8269224	.	G	A	8	6	14	0	0	14	0	0
10	8269377	.	G	A	3	3	6	0	0	6	0	0
10	8269439	.	C	T	0	2	2	0	3	5	0	0
10	8269515	.	T	C	3	2	5	0	0	5	0	0
10	8278160	.	T	C	5	10	15	0	0	15	0	0
10	8278214	.	A	G	6	8	14	0	0	14	0	0
10	8282705	.	T	A	3	2	5	0	1	6	0	0
10	8295026	.	C	T	1	4	5	0	8	13	0	0
10	8295196	.	T	G	8	3	11	0	0	11	0	0
10	8295295	.	C	A	0	4	4	0	5	9	0	0
10	8299143	.	G	C	1	6	7	0	0	7	0	0
10	8335312	.	C	T	1	1	2	0	0	2	0	0
10	8335315	.	T	C	1	2	3	0	0	3	0	0
10	8335402	.	A	G	5	5	10	0	0	10	0	0
10	8575927	.	A	C	2	2	4	0	0	4	0	0
10	8629373	.	T	C	3	3	6	0	0	6	0	0
10	8630102	.	C	T	17	7	24	0	0	24	0	0
10	8630428	.	A	G	15	12	27	0	0	27	0	0
10	8630527	.	G	A	13	6	19	0	2	21	0	0
10	8630585	.	A	G	3	0	3	0	11	14	0	0
10	8630631	.	T	C	8	7	15	0	0	15	0	0
10	8630690	.	G	A	12	8	20	0	0	20	0	0
10	8630702	.	T	C	12	7	19	0	0	19	0	0
10	8630808	.	G	A	7	5	12	0	1	13	0	0
10	8631103	.	G	A	0	4	4	0	3	7	0	0
10	8631135	.	A	G	5	6	11	0	0	11	0	0
10	8631201	.	A	G	11	7	18	0	1	19	0	0
10	8670121	.	A	C	6	6	12	0	0	12	0	0
10	8670139	.	G	A	5	4	9	0	0	9	0	0
10	8672510	.	A	G	10	14	24	0	0	24	0	0
10	8672519	.	T	C	10	11	21	0	0	21	0	0
10	8672672	.	C	G	13	8	21	0	2	23	0	0
10	8672707	.	A	T	16	11	27	0	1	28	0	0
10	8686965	.	T	A	3	3	6	0	0	6	0	0
10	8687119	.	T	C	3	3	6	0	0	7	1	0
10	8829791	.	T	C	1	0	1	0	0	1	0	0
10	8835269	.	C	T	1	2	3	0	0	3	0	0
10	8835272	.	A	T	1	2	3	0	0	3	0	0
10	8840981	.	T	A	2	4	6	0	0	6	0	0
10	8950022	.	T	C	2	0	2	0	1	3	0	0
10	8952018	.	T	C	6	0	6	0	3	9	0	0
10	8952019	.	A	G	6	3	9	0	0	9	0	0
10	8975972	.	C	A	1	2	3	0	0	3	0	0
10	9006634	.	T	C	8	14	22	0	0	22	0	0
10	9159424	.	T	A	1	5	6	0	0	6	0	0
10	9169479	.	C	T	5	8	13	0	0	13	0	0
10	9169613	.	C	T	1	1	2	0	0	2	0	0
10	9177363	.	T	C	3	3	6	0	0	6	0	0
10	9181508	.	T	A	1	0	1	0	0	1	0	0
10	9184326	.	T	A	9	7	16	0	2	18	0	0
10	9184327	.	A	C	9	9	18	0	0	18	0	0
10	9184533	.	C	T	9	10	19	0	1	20	0	0
10	9234007	.	G	A	0	5	5	0	1	6	0	0
10	9234032	.	G	A	1	7	8	0	1	9	0	0
10	9234056	.	T	A	1	5	6	0	0	6	0	0
10	9234145	.	C	T	2	3	5	0	0	5	0	0
10	9234153	.	T	G	2	3	5	0	0	5	0	0
10	9234279	.	G	C	6	6	12	0	0	12	0	0
10	9234371	.	T	C	2	2	4	0	0	4	0	0
10	9235180	.	G	T	0	4	4	0	2	6	0	0
10	9235184	.	G	A	0	4	4	0	2	6	0	0
10	9235217	.	A	T	1	3	4	0	1	5	0	0
10	9261398	.	A	G	2	0	2	0	0	2	0	0
10	9305219	.	A	G	3	7	10	0	0	10	0	0
10	9305246	.	T	C	3	0	3	0	9	12	0	0
10	9305305	.	C	T	2	5	7	0	0	7	0	0
10	9305433	.	A	G	6	8	14	0	0	14	0	0
10	9305465	.	T	C	5	0	5	0	7	12	0	0
10	9308092	.	G	A	3	2	5	0	2	7	0	0
10	9308133	.	G	A	2	0	2	0	0	2	0	0
10	9334097	.	T	G	1	4	5	0	0	5	0	0
10	9361037	.	C	T	2	2	4	0	0	4	0	0
10	9361891	.	G	A	3	2	5	0	0	5	0	0
10	9361924	.	G	C	3	2	5	0	0	5	0	0
10	9370121	.	A	T	4	6	10	0	2	12	0	0
10	9370210	.	T	A	5	4	9	0	2	11	0	0
10	9370755	.	A	G	12	4	16	0	0	16	0	0
10	9390746	.	T	C	2	4	6	0	0	6	0	0
10	9390767	.	T	C	3	6	9	0	1	10	0	0
10	9394247	.	A	C	1	7	8	0	0	8	0	0
10	9394918	.	G	C	5	7	12	0	0	12	0	0
10	9618313	.	T	G	2	2	4	0	0	4	0	0
10	9618348	.	A	C	0	1	1	0	0	1	0	0
10	9629193	.	G	A	0	4	4	0	4	8	0	0
10	9629301	.	A	G	0	0	0	0	1	1	0	0
10	9629314	.	A	G	0	1	1	0	0	1	0	0
10	9632265	.	G	A	0	0	0	0	2	2	0	0
10	9632336	.	A	G	2	0	2	0	0	2	0	0
10	9642674	.	T	A	0	1	1	0	0	1	0	0
10	9642717	.	T	C	3	2	5	0	0	5	0	0
10	9701905	.	C	T	6	2	8	0	0	8	0	0
10	9704514	.	A	T	1	2	3	0	0	3	0	0
10	9714771	.	T	C	4	3	7	0	0	7	0	0
10	9714819	.	A	G	4	9	13	0	0	13	0	0
10	9781509	.	G	A	7	2	9	0	0	9	0	0
10	9784087	.	C	T	9	7	16	0	1	17	0	0
10	9802771	.	T	C	7	14	21	0	2	23	0	0
10	9806731	.	A	G	15	1	16	0	15	31	0	0
10	9807014	.	T	G	21	15	36	0	2	38	0	0
10	9807203	.	G	A	25	21	46	0	0	46	0	0
10	9837024	.	G	T	2	2	4	0	0	4	0	0
10	9837027	.	T	C	3	2	5	0	0	5	0	0
10	9837100	.	T	C	4	5	9	0	1	10	0	0
10	9846240	.	A	G	5	7	12	0	1	13	0	0
10	9846261	.	G	A	7	7	14	0	0	14	0	0
10	9856390	.	T	C	2	0	2	0	5	7	0	0
10	9856416	.	A	G	3	0	3	0	0	3	0	0
10	9895348	.	G	A	1	7	8	0	0	8	0	0
10	9899302	.	G	A	3	1	4	0	0	4	0	0
10	10210583	.	C	T	4	7	11	0	0	11	0	0
10	10254730	.	C	T	5	5	10	0	1	11	0	0
10	10254751	.	A	C	4	5	9	0	0	9	0	0
10	10254787	.	A	G	3	0	3	0	8	11	0	0
10	10254922	.	A	G	2	1	3	0	0	3	0	0
10	10261887	.	G	C	1	4	5	0	0	5	0	0
10	10261893	.	C	A	2	4	6	0	0	6	0	0
10	10262013	.	T	C	5	3	8	0	0	8	0	0
10	10262157	.	A	G	4	3	7	0	0	7	0	0
10	10269930	.	T	C	0	3	3	0	0	3	0	0
10	10325451	.	T	C	6	6	12	0	0	12	0	0
10	10325493	.	G	A	0	6	6	0	9	15	0	0
10	10379918	.	T	C	1	0	1	0	0	1	0	0
10	10380074	.	G	A	2	2	4	0	0	4	0	0
10	10561657	.	G	T	1	2	3	0	0	3	0	0
10	10567262	.	A	G	0	1	1	0	0	1	0	0
10	10636896	.	G	A	0	6	6	0	1	7	0	0
10	10636946	.	A	G	7	7	14	0	0	14	0	0
10	10729139	.	C	G	2	3	5	0	0	5	0	0
10	10747735	.	C	G	1	1	2	0	0	2	0	0
10	10772092	.	T	C	1	2	3	0	0	3	0	0
10	10775374	.	A	T	2	2	4	0	0	4	0	0
10	10780483	.	T	C	1	1	2	0	0	2	0	0
10	10782513	.	G	A	6	11	17	0	1	18	0	0
10	10860819	.	A	C	2	2	4	0	0	4	0	0
10	10861011	.	A	G	6	3	9	0	0	9	0	0
10	10861504	.	G	A	4	2	6	0	1	7	0	0
10	10862232	.	C	G	1	2	3	0	0	3	0	0
10	10880659	.	C	T	0	3	3	0	0	3	0	0
10	10880847	.	C	G	2	4	6	0	0	6	0	0
10	10930143	.	G	A	1	3	4	0	1	5	0	0
10	10930188	.	G	A	1	0	1	0	1	2	0	0
10	10934756	.	T	A	1	1	2	0	0	2	0	0
10	10987263	.	T	C	1	2	3	0	0	3	0	0
10	10997286	.	A	G	3	7	10	0	2	12	0	0
10	10997404	.	A	G	4	2	6	0	0	6	0	0
10	10997502	.	T	C	2	2	4	0	0	4	0	0
10	10997585	.	C	T	4	4	8	0	0	8	0	0
10	10997618	.	C	T	4	3	7	0	0	7	0	0
10	10997711	.	T	C	5	3	8	0	0	8	0	0
10	10997834	.	G	A	0	2	2	0	3	5	0	0
10	11001608	.	T	C	1	2	3	0	0	3	0	0
10	11001720	.	T	C	3	4	7	0	0	7	0	0
10	11001867	.	A	G	7	7	14	0	1	15	0	0
10	11001883	.	T	A	7	6	13	0	1	14	0	0
10	11001967	.	T	G	2	8	10	0	2	12	0	0
10	11001968	.	A	G	2	10	12	0	0	12	0	0
10	11002005	.	T	A	3	9	12	0	0	12	0	0
10	11003904	.	G	T	1	4	5	0	0	5	0	0
10	11003911	.	G	A	1	6	7	0	0	7	0	0
10	11146361	.	A	T	2	3	5	0	1	6	0	0
10	11146445	.	A	G	3	5	8	0	0	8	0	0
10	11146585	.	A	T	1	5	6	0	1	7	0	0
10	11178600	.	C	A	2	1	3	0	0	3	0	0
10	11267530	.	C	A	1	1	2	0	0	2	0	0
10	11281077	.	G	T	1	2	3	0	0	3	0	0
10	11281148	.	G	A	1	2	3	0	0	3	0	0
10	11281492	.	G	A	4	2	6	0	0	6	0	0
10	11282194	.	A	G	3	5	8	0	0	8	0	0
10	11282335	.	A	G	1	2	3	0	0	3	0	0
10	11282362	.	A	G	1	2	3	0	0	3	0	0
10	11282373	.	C	T	1	2	3	0	0	3	0	0
10	11286830	.	C	T	2	4	6	0	0	6	0	0
10	11287343	.	A	G	5	0	5	0	10	15	0	0
10	11298651	.	G	A	2	2	4	0	0	4	0	0
10	11298652	.	A	C	2	1	3	0	1	4	0	0
10	11298852	.	G	A	2	4	6	0	0	6	0	0
10	11298864	.	A	G	2	4	6	0	1	7	0	0
10	11298955	.	T	C	1	4	5	0	0	5	0	0
10	11298975	.	C	T	1	4	5	0	0	5	0	0
10	11299042	.	G	A	3	1	4	0	0	4	0	0
10	11309859	.	C	G	2	0	2	0	4	6	0	0
10	11310041	.	G	A	4	4	8	0	1	9	0	0
10	11310500	.	G	A	4	8	12	0	0	12	0	0
10	11310501	.	C	A	3	8	11	0	1	12	0	0
10	11311832	.	C	T	3	2	5	0	1	6	0	0
10	11322985	.	T	C	1	2	3	0	1	4	0	0
10	11323032	.	G	A	6	7	13	0	0	13	0	0
10	11325175	.	T	C	1	1	2	0	0	2	0	0
10	11327364	.	A	G	4	3	7	0	0	7	0	0
10	11327406	.	T	A	5	3	8	0	0	8	0	0
10	11327444	.	G	T	5	5	10	0	0	10	0	0
10	11327449	.	A	T	6	4	10	0	0	10	0	0
10	11327604	.	T	C	5	7	12	0	1	13	0	0
10	11327657	.	C	T	5	4	9	0	0	9	0	0
10	11327674	.	G	A	6	4	10	0	0	10	0	0
10	11332206	.	A	G	1	2	3	0	0	3	0	0
10	11334547	.	A	G	1	1	2	0	0	2	0	0
10	11339235	.	G	A	7	6	13	0	2	15	0	0
10	11339319	.	C	T	0	4	4	0	0	4	0	0
10	11347906	.	G	T	6	6	12	0	0	12	0	0
10	11347909	.	A	G	5	6	11	0	1	12	0	0
10	11347961	.	G	T	5	3	8	0	1	9	0	0
10	11362275	.	C	T	18	19	37	0	0	37	0	0
10	11394922	.	C	T	2	2	4	0	0	4	0	0
10	11398168	.	T	G	7	0	7	0	5	12	0	0
10	11399574	.	C	T	0	3	3	0	0	3	0	0
10	11501181	.	C	A	7	7	14	0	0	14	0	0
10	11501283	.	C	T	1	2	3	0	0	3	0	0
10	11773751	.	T	C	5	3	8	0	0	8	0	0
10	11779259	.	G	A	2	2	4	0	0	4	0	0
10	11790947	.	T	C	7	12	19	0	0	19	0	0
10	11805601	.	T	C	7	4	11	0	0	11	0	0
10	11809444	.	A	G	4	2	6	0	0	6	0	0
10	11838927	.	C	T	0	5	5	0	4	9	0	0
10	12659015	.	A	G	2	0	2	0	3	5	0	0
10	12720969	.	C	T	2	2	4	0	0	4	0	0
10	13063542	.	G	T	1	5	6	0	0	6	0	0
10	13063921	.	C	T	3	3	6	0	0	6	0	0
10	13238028	.	A	G	7	10	17	0	0	17	0	0
10	13238055	.	G	T	6	9	15	0	0	15	0	0
10	13283594	.	C	T	2	4	6	0	0	6	0	0
10	13283729	.	C	T	2	2	4	0	1	5	0	0
10	13283741	.	G	A	0	3	3	0	4	7	0	0
10	13283891	.	G	A	1	3	4	0	3	7	0	0
10	13286430	.	C	T	4	8	12	0	0	12	0	0
10	13286472	.	T	C	6	9	15	0	1	16	0	0
10	13287031	.	A	C	0	4	4	0	0	4	0	0
10	13460381	.	A	G	3	2	5	0	4	9	0	0
10	13460494	.	A	C	11	8	19	0	2	21	0	0
10	13460671	.	G	A	14	7	21	0	0	21	0	0
10	13460745	.	C	A	0	24	24	0	18	42	0	0
10	13460940	.	A	T	20	12	32	0	5	37	0	0
10	13461080	.	T	C	17	2	19	0	22	41	0	0
10	13461150	.	G	A	16	14	30	0	1	31	0	0
10	13476010	.	A	G	7	10	17	0	1	18	0	0
10	13529270	.	T	C	8	11	19	0	1	20	0	0
10	13536790	.	T	C	3	0	3	0	9	12	0	0
10	14488177	.	C	A	0	1	1	0	0	1	0	0
10	14488213	.	T	C	0	2	2	0	0	2	0	0
10	14491139	.	C	T	6	1	7	0	0	7	0	0
10	14493798	.	T	C	9	15	24	0	0	24	0	0
10	14493819	.	A	T	8	12	20	0	0	20	0	0
10	14493878	.	G	T	0	13	13	0	10	23	0	0
10	14493967	.	G	C	0	10	10	0	15	25	0	0
10	14494083	.	A	G	2	2	4	0	1	5	0	0
10	14533337	.	G	A	3	6	9	0	0	9	0	0
10	14533352	.	A	G	3	7	10	0	0	10	0	0
10	14542886	.	A	G	10	5	15	0	1	16	0	0
10	14542962	.	G	A	5	7	12	0	1	13	0	0
10	14543044	.	A	T	12	13	25	0	4	29	0	0
10	14543256	.	A	C	15	8	23	0	1	24	0	0
10	14543259	.	G	T	16	6	22	0	3	25	0	0
10	14543307	.	C	T	11	14	25	0	2	27	0	0
10	14545572	.	A	G	13	15	28	0	2	30	0	0
10	14871409	.	T	A	12	11	23	0	0	23	0	0
10	14871412	.	T	A	10	9	19	0	2	21	0	0
10	14871768	.	A	G	16	16	32	0	1	33	0	0
10	14871801	.	A	C	25	16	41	0	0	41	0	0
10	14872258	.	T	G	4	5	9	0	2	11	0	0
10	14872703	.	G	A	13	10	23	0	0	23	0	0
10	14920777	.	G	A	1	2	3	0	0	3	0	0
10	14921086	.	A	C	3	0	3	0	14	17	0	0
10	14929560	.	G	A	8	4	12	0	0	12	0	0
10	15066136	.	C	G	1	0	1	0	2	3	0	0
10	15582228	.	T	C	4	2	6	0	0	6	0	0
10	16307210	.	C	T	2	2	4	0	0	4	0	0
10	17945513	.	A	G	27	9	36	0	3	39	0	0
10	18887819	.	A	G	2	1	3	0	0	3	0	0
10	18906617	.	C	A	8	6	14	0	16	32	2	0
10	18906618	.	A	G	15	8	23	0	8	32	1	0
10	18911166	.	A	G	1	3	4	0	2	6	0	0
10	18927910	.	C	T	1	1	2	0	0	2	0	0
10	18930403	.	T	C	7	10	17	0	1	18	0	0
10	18934215	.	C	A	6	6	12	0	2	14	0	0
10	18934291	.	T	C	6	12	18	0	1	19	0	0
10	18934323	.	A	C	5	13	18	0	1	19	0	0
10	18934499	.	C	T	4	9	13	0	0	13	0	0
10	18934530	.	A	G	7	6	13	0	0	13	0	0
10	18934590	.	A	C	10	19	29	0	0	29	0	0
10	18934634	.	G	T	7	19	26	0	0	26	0	0
10	18934683	.	T	C	9	18	27	0	0	27	0	0
10	18934821	.	A	C	7	11	18	0	1	19	0	0
10	18935246	.	T	C	19	18	37	0	0	37	0	0
10	18935316	.	C	T	14	18	32	0	2	34	0	0
10	18935413	.	C	T	13	18	31	0	1	32	0	0
10	18935430	.	A	T	13	17	30	0	1	31	0	0
10	18935874	.	T	A	4	4	8	0	0	8	0	0
10	18970673	.	C	T	8	4	12	0	0	12	0	0
10	18973079	.	C	T	1	2	3	0	0	3	0	0
10	18973124	.	A	G	1	0	1	0	6	7	0	0
10	18977233	.	G	A	0	4	4	0	0	4	0	0
10	18992413	.	T	C	26	23	49	0	2	51	0	0
10	19005845	.	A	C	0	4	4	0	1	5	0	0
10	19017316	.	C	T	0	3	3	0	0	3	0	0
10	19020475	.	A	G	9	7	16	0	0	16	0	0
10	19021032	.	C	A	3	5	8	0	1	9	0	0
10	19021075	.	G	A	7	7	14	0	0	14	0	0
10	19021192	.	A	G	7	3	10	0	2	12	0	0
10	19021235	.	G	A	0	4	4	0	4	8	0	0
10	19090689	.	A	G	1	2	3	0	0	3	0	0
10	19339859	.	C	G	8	7	15	0	0	15	0	0
10	19428949	.	T	C	1	4	5	0	0	5	0	0
10	19554673	.	A	T	6	14	20	0	0	20	0	0
10	19562120	.	C	T	3	4	7	0	0	7	0	0
10	19564401	.	G	A	14	18	32	0	3	35	0	0
10	19565771	.	T	C	25	29	54	0	0	54	0	0
10	19565988	.	G	C	32	25	57	0	2	59	0	0
10	19566400	.	T	A	12	21	33	0	0	33	0	0
10	19566445	.	T	C	7	10	17	0	2	19	0	0
10	20080671	.	C	T	2	3	5	0	0	5	0	0
10	20082011	.	T	G	3	3	6	0	0	6	0	0
10	20083140	.	A	G	2	3	5	0	0	5	0	0
10	20085200	.	A	C	0	1	1	0	0	1	0	0
10	20093329	.	G	A	0	6	6	0	3	9	0	0
10	20100205	.	C	T	7	8	15	0	0	15	0	0
10	20100234	.	C	T	7	10	17	0	0	17	0	0
10	20100269	.	A	C	9	11	20	0	1	21	0	0
10	20103359	.	C	T	7	8	15	0	0	15	0	0
10	20103392	.	A	G	4	4	8	0	1	9	0	0
10	20103639	.	A	G	8	4	12	0	0	12	0	0
10	20105210	.	T	C	3	8	11	0	0	11	0	0
10	20131937	.	G	A	2	0	2	0	0	2	0	0
10	20137862	.	A	G	0	2	2	0	0	2	0	0
10	20140951	.	T	C	1	4	5	0	0	5	0	0
10	20143850	.	T	A	2	3	5	0	0	5	0	0
10	20146535	.	C	T	31	13	44	0	3	47	0	0
10	20147452	.	A	G	11	0	11	0	15	26	0	0
10	20158976	.	T	A	2	2	4	0	0	4	0	0
10	20215064	.	G	T	4	1	5	0	0	5	0	0
10	20218342	.	C	G	7	3	10	0	0	10	0	0
10	20233964	.	A	G	18	0	18	0	22	40	0	0
10	20234074	.	C	T	15	24	39	0	5	44	0	0
10	20256905	.	A	G	0	2	2	0	1	3	0	0
10	20276868	.	T	G	0	1	1	0	1	2	0	0
10	20276898	.	A	G	0	2	2	0	0	2	0	0
10	20276904	.	G	A	0	2	2	0	0	2	0	0
10	20287251	.	C	A	0	4	4	0	2	6	0	0
10	20338998	.	G	C	1	0	1	0	0	1	0	0
10	20351579	.	G	T	3	5	8	0	0	8	0	0
10	20351930	.	T	C	1	3	4	0	0	4	0	0
10	20351975	.	C	T	1	3	4	0	0	4	0	0
10	20368862	.	T	A	8	3	11	0	1	12	0	0
10	20368883	.	C	T	6	4	10	0	2	12	0	0
10	20371402	.	A	T	9	13	22	0	3	25	0	0
10	20371419	.	A	C	14	12	26	0	2	28	0	0
10	20371478	.	C	A	19	13	32	0	1	34	1	0
10	20371675	.	A	T	17	14	31	0	0	31	0	0
10	20398930	.	T	C	2	1	3	0	0	3	0	0
10	20401360	.	C	A	2	2	4	0	0	4	0	0
10	20401418	.	T	C	1	6	7	0	0	7	0	0
10	20401699	.	A	C	1	6	7	0	0	7	0	0
10	20401702	.	C	G	1	7	8	0	0	8	0	0
10	20401984	.	G	T	0	2	2	0	0	2	0	0
10	20468843	.	T	A	2	5	7	0	0	7	0	0
10	20468952	.	G	A	4	2	6	0	1	7	0	0
10	20472926	.	T	C	7	6	13	0	1	14	0	0
10	20473147	.	C	G	0	4	4	0	3	7	0	0
10	20473409	.	G	A	4	2	6	0	0	6	0	0
10	20473517	.	G	T	5	5	10	0	0	10	0	0
10	20481653	.	C	T	0	4	4	0	5	9	0	0
10	20481656	.	G	A	5	4	9	0	0	9	0	0
10	20505467	.	T	C	1	0	1	0	1	2	0	0
10	20505679	.	T	G	1	1	2	0	0	2	0	0
10	20508791	.	T	A	4	1	5	0	1	6	0	0
10	20521939	.	C	T	1	1	2	0	0	2	0	0
10	20527639	.	G	A	6	3	9	0	1	10	0	0
10	20527736	.	C	T	0	11	11	0	9	20	0	0
10	20527837	.	C	A	0	7	7	0	8	15	0	0
10	20529450	.	T	C	10	0	10	0	3	13	0	0
10	20532762	.	C	T	0	1	1	0	0	1	0	0
10	20543294	.	T	C	5	0	5	0	6	11	0	0
10	20543336	.	G	A	7	8	15	0	0	15	0	0
10	20546530	.	G	A	8	4	12	0	0	12	0	0
10	20546548	.	C	T	1	2	3	0	1	4	0	0
10	20558156	.	G	C	1	0	1	0	0	1	0	0
10	20558270	.	G	A	1	2	3	0	1	4	0	0
10	20558300	.	G	C	2	0	2	0	5	7	0	0
10	20562894	.	C	T	0	2	2	0	0	2	0	0
10	20565260	.	C	T	1	2	3	0	7	10	0	0
10	20586604	.	A	G	1	5	6	0	0	6	0	0
10	20586613	.	A	T	1	5	6	0	1	7	0	0
10	20590317	.	T	C	8	4	12	0	0	12	0	0
10	20590372	.	T	A	2	7	9	0	3	12	0	0
10	20590436	.	A	C	9	8	17	0	0	17	0	0
10	20590461	.	G	T	11	6	17	0	1	18	0	0
10	20590547	.	T	C	8	3	11	0	0	11	0	0
10	20590569	.	C	T	3	1	4	0	0	4	0	0
10	20592420	.	C	T	7	5	12	0	1	13	0	0
10	20592598	.	G	T	7	3	10	0	0	10	0	0
10	20598177	.	C	A	1	3	4	0	0	4	0	0
10	20598267	.	A	G	2	6	8	0	0	8	0	0
10	20598270	.	G	A	2	5	7	0	0	7	0	0
10	20604548	.	A	G	18	16	34	0	1	35	0	0
10	20604555	.	T	C	18	18	36	0	2	38	0	0
10	20604703	.	G	T	11	14	25	0	0	25	0	0
10	20605171	.	A	T	13	16	29	0	3	32	0	0
10	20636027	.	C	T	11	22	33	0	0	33	0	0
10	20636168	.	A	T	14	13	27	0	2	29	0	0
10	20636177	.	G	T	15	12	27	0	1	28	0	0
10	20636273	.	T	C	8	0	8	0	15	23	0	0
10	20636346	.	T	C	7	8	15	0	1	16	0	0
10	20636444	.	T	C	1	2	3	0	0	3	0	0
10	20636479	.	T	C	3	5	8	0	3	11	0	0
10	20636542	.	G	A	5	5	10	0	0	10	0	0
10	20920664	.	A	G	11	8	19	0	0	19	0	0
10	20971685	.	A	G	6	8	14	0	1	15	0	0
10	21043902	.	G	A	11	6	17	0	1	18	0	0
10	21044064	.	G	A	4	7	11	0	0	11	0	0
10	21044286	.	A	G	4	4	8	0	1	9	0	0
10	21044316	.	A	G	4	7	11	0	0	11	0	0
10	21044337	.	T	C	3	1	4	0	7	11	0	0
10	21044361	.	A	T	1	5	6	0	0	6	0	0
10	21044385	.	G	T	1	5	6	0	0	6	0	0
10	21045123	.	A	T	4	2	6	0	0	6	0	0
10	21045126	.	T	C	4	0	4	0	2	6	0	0
10	21046442	.	G	A	3	3	6	0	0	6	0	0
10	21046493	.	T	C	5	2	7	0	0	7	0	0
10	21053520	.	G	C	4	2	6	0	0	6	0	0
10	21437255	.	A	G	3	0	3	0	2	5	0	0
10	21443135	.	G	A	1	15	16	0	13	29	0	0
10	21443193	.	T	G	19	16	35	0	0	35	0	0
10	21443347	.	T	A	10	4	14	0	2	16	0	0
10	21452340	.	T	C	2	4	6	0	0	6	0	0
10	21452376	.	G	A	0	8	8	0	12	20	0	0
10	21452403	.	G	A	12	10	22	0	0	22	0	0
10	21459017	.	G	A	0	5	5	0	8	13	0	0
10	21459439	.	G	A	12	13	25	0	1	26	0	0
10	21462612	.	T	C	8	12	20	0	0	20	0	0
10	21470192	.	G	A	2	11	13	0	13	26	0	0
10	21471663	.	T	C	1	2	3	0	0	3	0	0
10	21524679	.	G	A	6	5	11	0	0	11	0	0
10	21524682	.	G	A	5	5	10	0	1	11	0	0
10	21524919	.	C	G	6	0	6	0	4	10	0	0
10	21525243	.	A	G	7	5	12	0	0	12	0	0
10	21525276	.	T	A	6	4	10	0	0	10	0	0
10	21579312	.	C	A	0	0	0	1	0	1	0	0
10	21646033	.	C	T	27	20	47	0	1	48	0	0
10	21646621	.	C	T	31	26	57	0	4	61	0	0
10	21646668	.	T	A	40	19	59	0	3	62	0	0
10	21646797	.	C	T	20	26	46	0	0	46	0	0
10	21646802	.	A	G	19	28	47	0	0	47	0	0
10	21646844	.	A	G	28	18	46	0	0	46	0	0
10	21647241	.	T	G	32	26	58	0	0	58	0	0
10	21647291	.	G	A	1	33	34	0	22	56	0	0
10	21647691	.	G	A	33	24	57	0	1	58	0	0
10	21651889	.	G	T	1	2	3	0	1	4	0	0
10	21658567	.	G	A	2	2	4	0	0	4	0	0
10	21679442	.	T	C	1	3	4	0	1	5	0	0
10	21679497	.	C	A	1	1	2	0	0	2	0	0
10	21701576	.	T	C	2	2	4	0	0	4	0	0
10	21702390	.	C	T	2	1	3	0	0	3	0	0
10	21702397	.	C	T	3	1	4	0	0	4	0	0
10	21702544	.	T	C	1	2	3	0	0	3	0	0
10	21720798	.	T	C	4	2	6	0	0	6	0	0
10	21720833	.	A	G	3	3	6	0	0	6	0	0
10	21720867	.	G	A	0	2	2	0	1	3	0	0
10	21723611	.	G	T	0	3	3	0	0	3	0	0
10	21723620	.	C	T	1	3	4	0	0	4	0	0
10	21723656	.	C	T	2	4	6	0	0	6	0	0
10	21723674	.	G	A	2	3	5	0	0	5	0	0
10	21723779	.	T	A	2	2	4	0	0	4	0	0
10	21723801	.	T	A	3	2	5	0	0	5	0	0
10	21729191	.	T	C	0	3	3	1	0	4	0	0
10	21729232	.	G	A	2	1	3	0	0	3	0	0
10	21776931	.	G	T	0	3	3	0	3	6	0	0
10	21778980	.	C	T	6	6	12	3	0	15	0	0
10	21780258	.	T	C	8	5	13	0	0	13	0	0
10	21780288	.	G	T	5	5	10	0	0	10	0	0
10	21780612	.	A	G	3	6	9	0	0	10	1	0
10	21780615	.	A	C	3	7	10	0	1	11	0	0
10	21781308	.	A	G	6	0	6	0	5	11	0	0
10	21781313	.	C	T	7	2	9	0	2	11	0	0
10	21781524	.	C	G	12	7	19	0	0	19	0	0
10	21781677	.	G	A	0	9	9	0	5	14	0	0
10	21781710	.	T	C	12	6	18	0	1	19	0	0
10	21781722	.	G	C	6	5	11	0	1	17	5	0
10	21783252	.	C	T	7	10	17	0	0	17	0	0
10	21783484	.	A	G	5	3	8	2	0	10	0	0
10	21783596	.	G	C	6	12	18	0	0	18	0	0
10	21783727	.	C	A	3	8	11	0	1	12	0	0
10	21783733	.	T	C	4	10	14	0	0	14	0	0
10	21784071	.	T	C	7	6	13	0	0	13	0	0
10	21784130	.	G	T	1	4	5	0	7	12	0	0
10	21784132	.	C	T	7	3	10	0	2	12	0	0
10	21784186	.	A	G	10	11	21	0	0	21	0	0
10	21786705	.	G	A	6	3	9	0	0	9	0	0
10	21786713	.	G	A	6	3	9	0	1	10	0	0
10	21786792	.	C	A	7	5	12	0	1	13	0	0
10	21786817	.	G	A	8	4	12	0	0	12	0	0
10	21786832	.	C	T	7	6	13	0	0	13	0	0
10	21786934	.	G	T	4	6	10	0	0	10	0	0
10	21787255	.	A	T	3	2	5	0	0	5	0	0
10	21787943	.	T	A	7	4	11	0	1	12	0	0
10	21788022	.	A	G	9	4	13	0	1	14	0	0
10	21788038	.	T	C	9	4	13	0	0	13	0	0
10	21788695	.	C	A	3	3	6	0	0	6	0	0
10	21790076	.	A	C	7	10	17	0	1	18	0	0
10	21790121	.	C	A	11	12	23	0	0	23	0	0
10	21790137	.	G	A	11	11	22	0	0	22	0	0
10	21790295	.	A	T	4	2	6	0	1	7	0	0
10	21790648	.	T	C	6	4	10	0	1	11	0	0
10	21790769	.	A	G	7	0	7	0	7	14	0	0
10	21790775	.	A	C	7	9	16	0	0	16	0	0
10	21790934	.	T	C	6	11	17	0	1	18	0	0
10	21791090	.	G	A	6	7	13	0	0	13	0	0
10	21791375	.	G	A	7	11	18	0	0	18	0	0
10	21794302	.	G	A	0	2	2	0	6	8	0	0
10	21794410	.	T	A	2	3	5	0	0	5	0	0
10	21794797	.	A	C	3	3	6	0	0	6	0	0
10	21794800	.	A	T	3	2	5	0	0	5	0	0
10	21795337	.	C	T	1	2	3	0	0	3	0	0
10	21795412	.	A	T	9	3	12	0	0	12	0	0
10	21795533	.	A	G	5	5	10	0	1	11	0	0
10	21795655	.	A	T	3	5	8	0	0	8	0	0
10	21795664	.	C	A	6	1	7	0	0	7	0	0
10	21795805	.	G	A	1	3	4	0	0	4	0	0
10	21797164	.	G	A	0	2	2	0	4	6	0	0
10	21797207	.	G	C	9	5	14	0	0	14	0	0
10	21797247	.	C	A	8	5	13	0	0	13	0	0
10	21797266	.	C	T	6	2	8	0	0	8	0	0
10	21797282	.	A	G	5	2	7	0	0	7	0	0
10	21797704	.	A	G	3	1	4	0	0	4	0	0
10	21797710	.	A	G	3	2	5	0	0	5	0	0
10	21797769	.	T	G	5	2	7	0	0	7	0	0
10	21798029	.	T	C	1	2	3	0	1	4	0	0
10	21798215	.	C	A	3	8	11	0	1	12	0	0
10	21798571	.	C	A	3	3	6	0	0	6	0	0
10	21798975	.	C	T	5	2	7	1	0	8	0	0
10	21799343	.	T	A	5	3	8	0	0	8	0	0
10	21799374	.	T	A	11	5	16	1	0	17	0	0
10	21801256	.	C	G	3	3	6	0	0	6	0	0
10	21801267	.	C	T	2	5	7	0	1	8	0	0
10	21801339	.	T	G	13	0	13	0	9	22	0	0
10	21801352	.	T	C	12	8	20	0	1	21	0	0
10	21801573	.	C	T	6	3	9	0	0	9	0	0
10	21801611	.	G	T	7	4	11	0	0	11	0	0
10	21801718	.	G	A	0	12	12	0	5	17	0	0
10	21801856	.	C	T	11	12	23	0	0	23	0	0
10	21802057	.	A	G	3	3	6	0	2	8	0	0
10	21802086	.	A	G	8	3	11	0	0	11	0	0
10	21802291	.	C	T	9	7	16	0	4	20	0	0
10	21802326	.	C	A	8	8	16	0	2	18	0	0
10	21802355	.	C	A	5	8	13	0	0	13	0	0
10	21802380	.	G	A	0	7	7	0	5	12	0	0
10	21802530	.	A	T	3	6	9	0	0	9	0	0
10	21802539	.	C	T	6	6	12	0	0	12	0	0
10	21802566	.	T	C	10	5	15	0	2	17	0	0
10	21802661	.	C	T	5	12	17	0	0	17	0	0
10	21802701	.	A	T	9	6	15	0	1	16	0	0
10	21802959	.	T	C	13	8	21	0	0	21	0	0
10	21802989	.	T	C	12	8	20	0	1	21	0	0
10	21803031	.	G	A	10	8	18	0	0	18	0	0
10	21804785	.	G	T	0	2	2	0	3	5	0	0
10	21804786	.	G	T	3	2	5	0	0	5	0	0
10	21805019	.	A	T	2	4	6	0	0	6	0	0
10	21805020	.	A	C	2	4	6	0	0	6	0	0
10	21805085	.	A	C	1	3	4	0	0	4	0	0
10	21805090	.	G	A	1	2	3	0	1	4	0	0
10	21805447	.	G	A	5	3	8	0	0	8	0	0
10	21805762	.	C	T	4	5	9	0	0	9	0	0
10	21805942	.	G	T	0	2	2	0	2	4	0	0
10	21806060	.	G	A	1	6	7	0	1	8	0	0
10	21806789	.	G	A	11	6	17	0	0	17	0	0
10	21818522	.	C	T	53	36	89	0	2	91	0	0
10	21818595	.	T	G	40	28	68	0	3	71	0	0
10	21818762	.	A	C	33	22	55	0	3	58	0	0
10	21818916	.	C	T	29	30	59	0	2	61	0	0
10	21819019	.	G	A	3	34	37	0	29	66	0	0
10	21819038	.	C	A	30	37	67	0	1	68	0	0
10	21819105	.	G	T	24	28	52	0	2	55	1	0
10	21819214	.	G	C	39	30	69	0	3	72	0	0
10	21819523	.	T	A	25	32	57	0	1	58	0	0
10	21819577	.	C	T	25	41	66	0	7	73	0	0
10	21819653	.	T	C	30	44	74	0	2	76	0	0
10	21819772	.	T	C	29	43	72	0	1	73	0	0
10	21819966	.	A	T	9	4	13	0	1	14	0	0
10	21872639	.	A	G	2	2	4	0	0	4	0	0
10	21944029	.	G	T	1	2	3	0	0	3	0	0
10	21944067	.	T	C	1	1	2	0	0	2	0	0
10	21944199	.	T	G	1	1	2	0	0	2	0	0
10	21944214	.	G	A	1	1	2	0	0	2	0	0
10	21944238	.	T	C	1	1	2	0	1	3	0	0
10	21944728	.	A	G	1	2	3	0	0	3	0	0
10	21944774	.	C	T	1	2	3	0	0	3	0	0
10	21944789	.	C	T	1	3	4	0	0	4	0	0
10	21944950	.	C	T	2	2	4	0	0	4	0	0
10	22012534	.	G	A	8	7	15	0	0	15	0	0
10	22030798	.	C	T	10	16	26	0	1	27	0	0
10	22030881	.	A	T	16	30	46	0	0	46	0	0
10	22031375	.	A	C	23	18	41	0	1	42	0	0
10	22031493	.	G	A	26	25	51	0	1	52	0	0
10	22031572	.	A	G	18	24	42	0	3	45	0	0
10	22031635	.	A	G	16	22	38	0	1	39	0	0
10	22031666	.	A	G	14	29	43	0	0	43	0	0
10	22031755	.	T	C	10	22	32	0	1	33	0	0
10	22031759	.	T	C	11	22	33	0	2	35	0	0
10	22031854	.	G	A	11	12	23	0	1	24	0	0
10	22035638	.	A	G	0	2	2	0	0	2	0	0
10	22036235	.	T	A	3	2	5	0	0	5	0	0
10	22041529	.	G	A	3	5	8	0	1	9	0	0
10	22041717	.	T	C	1	1	2	0	0	2	0	0
10	22044699	.	G	A	8	6	14	0	1	15	0	0
10	22044921	.	T	G	4	4	8	0	1	9	0	0
10	22044982	.	C	T	4	5	9	0	0	9	0	0
10	22045014	.	G	T	4	4	8	0	0	8	0	0
10	22051195	.	A	T	2	2	4	0	0	4	0	0
10	22051474	.	A	C	4	2	6	0	0	6	0	0
10	22137254	.	T	C	4	2	6	0	3	9	0	0
10	22163002	.	G	T	6	3	9	0	1	10	0	0
10	22248334	.	C	T	0	2	2	0	2	4	0	0
10	22382167	.	G	A	0	2	2	0	8	10	0	0
10	22382427	.	T	C	5	4	9	0	1	10	0	0
10	22471425	.	C	A	5	3	8	0	0	8	0	0
10	22475679	.	C	A	5	7	12	0	0	12	0	0
10	22475799	.	G	A	0	10	10	0	9	19	0	0
10	22476535	.	C	T	1	5	6	0	1	7	0	0
10	22477229	.	A	G	5	4	9	0	1	10	0	0
10	22477610	.	A	G	10	0	10	0	4	14	0	0
10	22477661	.	C	T	12	9	21	0	0	21	0	0
10	22477880	.	A	G	17	0	17	0	15	32	0	0
10	22510577	.	C	A	4	2	6	0	0	6	0	0
10	22516643	.	C	G	9	3	12	0	0	12	0	0
10	22516903	.	A	G	3	3	6	0	0	6	0	0
10	22516957	.	T	C	2	5	7	0	1	8	0	0
10	22518237	.	G	A	0	7	7	0	7	14	0	0
10	22518267	.	T	A	5	11	16	0	1	17	0	0
10	22519465	.	A	G	3	2	5	0	0	5	0	0
10	22525652	.	G	A	2	6	8	0	1	9	0	0
10	22528077	.	C	T	4	6	10	0	0	10	0	0
10	22530043	.	C	T	4	6	10	0	0	10	0	0
10	22530058	.	A	C	4	7	11	0	0	11	0	0
10	22530136	.	A	G	6	0	6	0	3	9	0	0
10	22530812	.	T	C	4	6	10	0	0	10	0	0
10	22531003	.	T	A	9	5	14	0	0	14	0	0
10	22531179	.	A	G	5	5	10	0	2	12	0	0
10	22531472	.	T	C	12	7	19	0	1	20	0	0
10	22531801	.	A	C	5	1	6	0	7	13	0	0
10	22531906	.	A	C	14	9	23	0	0	23	0	0
10	22531912	.	G	A	13	8	21	0	0	21	0	0
10	22532133	.	G	T	11	10	21	0	1	22	0	0
10	22532316	.	G	A	13	16	29	0	1	30	0	0
10	22532347	.	C	T	5	13	18	0	0	18	0	0
10	22532547	.	T	A	13	12	25	0	2	27	0	0
10	22532610	.	A	T	19	14	33	0	1	34	0	0
10	22532817	.	C	G	17	14	31	0	2	33	0	0
10	22745285	.	T	C	2	2	4	0	0	4	0	0
10	22745661	.	C	T	6	3	9	0	0	9	0	0
10	22747289	.	G	C	0	6	6	0	4	10	0	0
10	22747913	.	T	C	3	4	7	0	1	8	0	0
10	22748834	.	A	G	4	3	7	0	0	7	0	0
10	22748964	.	G	C	2	2	4	0	0	4	0	0
10	22749623	.	C	T	3	4	7	0	0	7	0	0
10	22749681	.	G	A	1	3	4	0	0	4	0	0
10	22749824	.	A	C	3	2	5	0	0	5	0	0
10	22751095	.	G	A	3	3	6	0	0	6	0	0
10	22753455	.	G	A	1	3	4	0	1	5	0	0
10	22753883	.	A	C	1	2	3	0	0	3	0	0
10	22755164	.	C	T	8	6	14	0	0	14	0	0
10	22758016	.	G	A	3	7	10	0	0	10	0	0
10	22758094	.	A	G	0	0	0	0	3	3	0	0
10	22758303	.	A	G	2	2	4	0	1	5	0	0
10	22758481	.	A	G	5	0	5	0	5	10	0	0
10	22760658	.	A	C	6	6	12	0	1	13	0	0
10	22786128	.	T	A	8	14	22	0	0	22	0	0
10	22791951	.	G	T	3	2	5	0	0	5	0	0
10	22791991	.	G	T	3	4	7	0	0	7	0	0
10	22792038	.	G	A	0	3	3	0	1	4	0	0
10	22811149	.	C	A	10	3	13	0	0	13	0	0
10	22811358	.	C	A	1	4	5	0	1	6	0	0
10	22811621	.	A	C	7	0	7	0	9	16	0	0
10	22812500	.	A	T	4	7	11	0	0	11	0	0
10	22813273	.	T	C	0	1	1	0	0	1	0	0
10	22814750	.	G	A	3	4	7	0	1	8	0	0
10	22838530	.	C	T	2	23	25	0	31	56	0	0
10	22841955	.	G	T	14	7	21	0	2	23	0	0
10	22845293	.	C	T	0	8	8	0	16	24	0	0
10	22856192	.	G	C	1	2	3	0	1	4	0	0
10	22856201	.	T	C	2	2	4	0	0	4	0	0
10	22858361	.	T	C	3	1	4	0	0	4	0	0
10	22861945	.	T	G	3	4	7	0	0	7	0	0
10	22861947	.	A	G	3	4	7	0	0	7	0	0
10	22893992	.	A	G	3	6	9	0	0	9	0	0
10	22895312	.	T	C	1	3	4	0	0	4	0	0
10	22895327	.	T	C	2	4	6	0	0	6	0	0
10	22896782	.	C	A	3	3	6	0	0	6	0	0
10	22896950	.	C	T	1	0	1	0	0	1	0	0
10	22896959	.	G	A	0	0	0	0	1	1	0	0
10	22897187	.	C	T	4	5	9	0	0	9	0	0
10	22906434	.	C	T	2	4	6	0	0	6	0	0
10	22906844	.	C	T	8	11	19	0	1	20	0	0
10	22906916	.	A	T	7	16	23	0	0	23	0	0
10	22912547	.	C	T	1	1	2	0	0	2	0	0
10	22915875	.	A	G	4	6	10	0	0	10	0	0
10	22915897	.	G	A	4	4	8	0	0	8	0	0
10	22915914	.	C	A	5	2	7	0	0	7	0	0
10	22916324	.	A	G	21	17	38	0	3	41	0	0
10	22916339	.	A	G	21	9	30	0	3	33	0	0
10	22916422	.	A	C	22	27	49	0	6	55	0	0
10	22916426	.	T	A	23	28	51	0	1	52	0	0
10	22916664	.	C	T	31	31	62	0	5	67	0	0
10	22916730	.	A	G	22	23	45	0	3	48	0	0
10	22918164	.	T	C	30	13	43	0	3	46	0	0
10	22918190	.	C	T	14	10	24	0	0	24	0	0
10	22918214	.	T	G	5	4	9	0	0	9	0	0
10	22922089	.	A	G	1	0	1	0	3	4	0	0
10	22924978	.	A	C	1	13	14	0	0	14	0	0
10	22925049	.	G	A	0	10	10	0	8	18	0	0
10	22925983	.	A	C	2	4	6	0	1	7	0	0
10	22955718	.	A	G	1	4	5	0	0	5	0	0
10	23024405	.	T	C	17	16	33	0	1	34	0	0
10	23024660	.	A	G	24	15	39	0	3	42	0	0
10	23024708	.	T	C	21	24	45	0	0	45	0	0
10	23024762	.	A	G	24	15	39	0	1	40	0	0
10	23060740	.	G	A	0	2	2	0	0	2	0	0
10	23061326	.	G	A	1	6	7	0	3	10	0	0
10	23065777	.	T	C	2	6	8	0	0	8	0	0
10	23068553	.	G	T	9	4	13	0	0	13	0	0
10	23068630	.	A	G	16	9	25	0	1	26	0	0
10	23068907	.	T	G	7	11	18	0	2	20	0	0
10	23068962	.	A	G	5	11	16	0	0	16	0	0
10	23068963	.	C	T	5	11	16	0	0	16	0	0
10	23069120	.	T	C	7	5	12	0	1	13	0	0
10	23069253	.	T	C	4	2	6	0	0	6	0	0
10	23070978	.	A	G	2	2	4	0	1	5	0	0
10	23071322	.	G	A	5	3	8	0	0	8	0	0
10	23071524	.	G	T	6	5	11	0	0	11	0	0
10	23071619	.	A	G	7	3	10	0	2	12	0	0
10	23071697	.	G	A	2	2	4	0	0	4	0	0
10	23071705	.	G	C	1	2	3	0	0	3	0	0
10	23076290	.	A	G	3	2	5	0	0	5	0	0
10	23076306	.	T	C	2	4	6	0	0	6	0	0
10	23076327	.	G	A	3	4	7	0	1	8	0	0
10	23118829	.	G	A	2	0	2	0	0	2	0	0
10	23126558	.	T	C	1	2	3	0	0	3	0	0
10	23129422	.	G	A	0	0	0	0	2	2	0	0
10	23138428	.	G	A	1	4	5	0	3	8	0	0
10	23138486	.	A	G	3	4	7	0	0	7	0	0
10	23138691	.	C	A	1	2	3	0	0	3	0	0
10	23139076	.	G	C	1	2	3	0	0	3	0	0
10	23139296	.	C	T	3	2	5	0	0	5	0	0
10	23139411	.	A	G	1	3	4	0	0	4	0	0
10	23139480	.	A	G	3	3	6	0	1	7	0	0
10	23140990	.	A	G	1	0	1	0	2	3	0	0
10	23220533	.	A	G	6	2	8	0	0	8	0	0
10	23358248	.	C	T	0	3	3	0	0	3	0	0
10	24325590	.	C	T	2	3	5	0	2	7	0	0
10	24334999	.	T	G	3	2	5	0	0	5	0	0
10	24373429	.	T	A	3	3	6	0	0	6	0	0
10	24373647	.	C	T	6	2	8	0	0	8	0	0
10	24373657	.	A	C	5	2	7	0	0	7	0	0
10	24373963	.	C	T	3	2	5	0	0	5	0	0
10	24422052	.	C	T	14	7	21	0	0	21	0	0
10	24422070	.	T	A	12	10	22	0	0	22	0	0
10	24422236	.	C	T	9	6	15	0	1	16	0	0
10	24425257	.	A	G	9	8	17	0	0	17	0	0
10	24426924	.	A	G	5	1	6	0	0	6	0	0
10	24427010	.	G	C	7	4	11	0	0	11	0	0
10	24429262	.	C	T	1	4	5	0	0	5	0	0
10	24429282	.	A	C	2	4	6	0	1	7	0	0
10	24429342	.	T	C	8	4	12	0	0	12	0	0
10	24429386	.	C	T	5	5	10	0	0	10	0	0
10	24431719	.	A	T	14	9	23	0	0	23	0	0
10	24431795	.	T	C	0	3	3	0	0	3	0	0
10	24431807	.	C	T	0	2	2	0	0	2	0	0
10	24437128	.	A	G	3	1	4	0	0	4	0	0
10	24441916	.	C	T	9	11	20	0	1	21	0	0
10	24442466	.	C	T	5	9	14	0	0	14	0	0
10	24442490	.	A	G	2	0	2	0	5	7	0	0
10	24563892	.	T	G	7	3	10	0	0	10	0	0
10	24564935	.	C	A	9	7	16	0	1	17	0	0
10	24565137	.	G	A	0	7	7	0	8	15	0	0
10	24565139	.	A	T	7	7	14	0	1	15	0	0
10	24566124	.	T	C	8	10	18	0	0	18	0	0
10	24600128	.	A	G	5	11	16	0	1	17	0	0
10	24609175	.	G	A	0	2	2	0	0	2	0	0
10	24614636	.	A	G	0	0	0	0	2	2	0	0
10	24614707	.	A	G	3	6	9	0	0	9	0	0
10	24614709	.	T	G	3	5	8	0	1	9	0	0
10	24616839	.	C	A	3	6	9	0	0	9	0	0
10	24617156	.	G	A	5	5	10	0	0	10	0	0
10	24617621	.	G	C	0	1	1	0	0	1	0	0
10	24617624	.	G	A	0	4	4	0	0	4	0	0
10	24621354	.	A	G	12	11	23	0	0	23	0	0
10	24621534	.	T	A	10	19	29	0	0	29	0	0
10	24621722	.	C	G	2	6	8	0	0	8	0	0
10	24621730	.	A	T	3	4	7	0	0	7	0	0
10	24621757	.	T	A	2	4	6	0	0	6	0	0
10	24650192	.	A	G	5	9	14	0	0	14	0	0
10	24652174	.	A	T	2	2	4	0	0	4	0	0
10	24654142	.	A	C	10	0	10	0	7	18	1	0
10	24654319	.	A	C	8	7	15	0	1	16	0	0
10	24654376	.	G	T	6	4	10	0	1	11	0	0
10	24654906	.	T	C	6	0	6	0	6	12	0	0
10	24662393	.	G	A	3	1	4	0	0	4	0	0
10	24677136	.	T	G	4	2	6	0	1	7	0	0
10	24677253	.	T	A	4	3	7	0	1	8	0	0
10	24686302	.	C	T	2	3	5	0	0	5	0	0
10	24710534	.	T	C	5	2	7	0	0	7	0	0
10	24710548	.	T	C	3	2	5	0	0	5	0	0
10	24725244	.	G	A	1	3	4	0	0	4	0	0
10	24725357	.	G	A	4	2	6	0	0	6	0	0
10	24725358	.	A	C	4	2	6	0	0	6	0	0
10	24725452	.	G	A	2	3	5	0	1	6	0	0
10	24725871	.	C	A	5	7	12	0	0	12	0	0
10	24726211	.	T	A	4	5	9	0	0	9	0	0
10	24726264	.	G	A	7	2	9	0	1	10	0	0
10	24726302	.	A	G	4	4	8	0	0	8	0	0
10	24726440	.	A	G	3	2	5	0	0	5	0	0
10	24726809	.	A	G	5	6	11	0	0	11	0	0
10	24762377	.	G	A	3	2	5	0	0	5	0	0
10	24762543	.	G	A	6	3	9	0	0	9	0	0
10	24762553	.	G	A	6	3	9	0	0	9	0	0
10	24762707	.	T	C	8	0	8	0	6	14	0	0
10	24762723	.	A	G	8	4	12	0	1	13	0	0
10	24762774	.	T	G	8	4	12	0	0	12	0	0
10	25205354	.	A	C	4	8	12	0	0	12	0	0
10	25209612	.	G	A	2	5	7	0	1	8	0	0
10	25210125	.	C	A	9	6	15	0	0	15	0	0
10	25214387	.	C	T	0	2	2	0	0	2	0	0
10	25214397	.	C	T	2	1	3	0	0	3	0	0
10	25214627	.	C	T	2	3	5	0	0	5	0	0
10	25252474	.	C	T	2	4	6	0	0	6	0	0
10	25262150	.	T	A	6	5	11	0	0	11	0	0
10	25262279	.	C	T	6	16	22	0	1	23	0	0
10	25262336	.	C	T	2	1	3	0	0	3	0	0
10	25268882	.	T	A	7	4	11	0	0	11	0	0
10	25269245	.	C	T	18	5	23	0	1	24	0	0
10	25269310	.	G	T	11	8	19	0	0	19	0	0
10	25269325	.	T	G	15	6	21	0	1	22	0	0
10	25269492	.	A	G	10	0	10	0	16	26	0	0
10	25269599	.	C	T	23	16	39	0	0	39	0	0
10	25269742	.	C	T	4	17	21	0	0	21	0	0
10	25269747	.	T	A	16	3	19	0	0	19	0	0
10	25269946	.	G	A	1	22	23	2	13	38	0	0
10	25269952	.	C	T	5	23	28	2	6	36	0	0
10	25270096	.	T	C	19	10	29	0	1	30	0	0
10	25270166	.	A	G	33	11	44	0	0	44	0	0
10	25270803	.	A	T	22	21	43	0	1	44	0	0
10	25270958	.	C	T	18	15	33	0	0	33	0	0
10	25271323	.	A	G	18	15	33	0	1	34	0	0
10	25312733	.	T	G	5	9	14	0	0	14	0	0
10	25312879	.	T	A	2	9	11	0	2	13	0	0
10	25312889	.	T	A	0	6	6	0	0	8	2	0
10	25329811	.	C	A	1	7	8	0	5	13	0	0
10	25330646	.	G	A	19	14	33	0	1	34	0	0
10	25338762	.	G	A	10	18	28	0	0	28	0	0
10	25381742	.	G	T	0	2	2	0	2	4	0	0
10	25381825	.	T	A	1	2	3	0	0	3	0	0
10	25381835	.	A	G	2	2	4	0	0	4	0	0
10	25381873	.	G	T	2	1	3	0	0	3	0	0
10	25382690	.	C	T	1	2	3	0	0	3	0	0
10	25383750	.	C	T	0	1	1	0	1	2	0	0
10	25383821	.	A	G	2	2	4	0	0	4	0	0
10	25403139	.	G	A	2	5	7	0	0	7	0	0
10	25403280	.	C	G	0	6	6	0	2	8	0	0
10	25403402	.	C	T	0	5	5	0	4	9	0	0
10	25410276	.	T	C	7	0	7	0	6	13	0	0
10	25410288	.	A	G	5	6	11	0	0	11	0	0
10	25410389	.	A	G	5	8	13	0	1	14	0	0
10	25435194	.	A	G	1	6	7	0	1	8	0	0
10	25436452	.	A	G	3	3	6	0	1	7	0	0
10	25436557	.	C	T	0	0	0	0	1	1	0	0
10	25461335	.	C	T	0	2	2	0	1	3	0	0
10	25573218	.	A	G	13	14	27	0	0	27	0	0
10	25573333	.	G	A	8	12	20	0	0	20	0	0
10	25573365	.	C	A	12	11	23	0	1	24	0	0
10	25574159	.	T	C	2	10	12	0	0	12	0	0
10	25574181	.	C	T	0	10	10	0	2	12	0	0
10	25574316	.	A	G	6	7	13	0	0	13	0	0
10	25580119	.	A	T	0	1	1	0	0	1	0	0
10	25580370	.	T	C	3	2	5	0	0	5	0	0
10	25582029	.	A	G	4	7	11	0	0	11	0	0
10	25582074	.	G	T	3	6	9	0	0	9	0	0
10	25582656	.	C	T	2	3	5	0	0	5	0	0
10	25582920	.	T	C	3	2	5	0	0	5	0	0
10	25585179	.	A	G	2	3	5	0	0	5	0	0
10	25600712	.	A	G	1	3	4	0	0	4	0	0
10	25608132	.	T	C	1	1	2	0	1	3	0	0
10	25608133	.	C	T	2	1	3	0	0	3	0	0
10	25694920	.	G	A	1	1	2	0	0	2	0	0
10	25697655	.	A	G	11	6	17	0	0	17	0	0
10	25697715	.	G	C	8	3	11	0	0	11	0	0
10	25700984	.	G	A	2	3	5	0	0	5	0	0
10	25701036	.	G	A	2	5	7	0	1	8	0	0
10	25701659	.	G	C	12	12	24	0	1	25	0	0
10	25701673	.	T	A	12	10	22	0	0	22	0	0
10	25704345	.	C	T	2	2	4	0	1	5	0	0
10	25709379	.	A	G	1	2	3	0	0	3	0	0
10	25709764	.	T	A	0	1	1	0	0	1	0	0
10	25829536	.	T	A	2	2	4	0	1	5	0	0
10	25829724	.	C	T	0	3	3	0	1	4	0	0
10	25830373	.	A	G	5	10	15	0	1	16	0	0
10	25830544	.	T	G	10	8	18	0	0	18	0	0
10	25830687	.	A	G	6	11	17	0	0	17	0	0
10	25830723	.	T	G	4	7	11	0	2	13	0	0
10	25837613	.	A	G	1	6	7	0	0	7	0	0
10	25840993	.	C	T	1	3	4	0	0	4	0	0
10	25960676	.	A	C	7	17	24	0	2	26	0	0
10	25960718	.	T	C	15	11	26	0	1	27	0	0
10	25960728	.	G	T	16	9	25	0	3	28	0	0
10	25961061	.	T	C	1	1	2	0	1	3	0	0
10	25961307	.	A	T	1	4	5	0	0	5	0	0
10	25961396	.	T	C	3	10	13	0	0	13	0	0
10	25961397	.	T	A	3	10	13	0	0	13	0	0
10	25961454	.	G	C	5	19	24	0	2	26	0	0
10	25961510	.	A	C	5	19	24	0	0	24	0	0
10	25961778	.	A	G	11	9	20	0	0	20	0	0
10	26084177	.	C	T	0	2	2	0	0	2	0	0
10	26107729	.	G	A	1	1	2	0	0	2	0	0
10	26107881	.	A	G	0	0	0	0	1	1	0	0
10	26107888	.	G	A	0	1	1	0	0	1	0	0
10	26111451	.	T	C	2	3	5	0	0	5	0	0
10	26111487	.	T	C	2	7	9	0	0	9	0	0
10	26111631	.	T	C	2	4	6	0	0	6	0	0
10	26113095	.	C	G	3	2	5	0	0	5	0	0
10	26113370	.	G	A	2	4	6	0	0	6	0	0
10	26113542	.	A	C	3	3	6	0	0	6	0	0
10	26113581	.	A	T	3	3	6	0	0	6	0	0
10	26113931	.	C	T	5	5	10	0	2	12	0	0
10	26114207	.	T	A	3	2	5	0	0	5	0	0
10	26114242	.	A	T	4	2	6	0	0	6	0	0
10	26114508	.	A	T	4	2	6	0	0	6	0	0
10	26114509	.	C	T	3	2	5	0	1	6	0	0
10	26114562	.	C	G	3	4	7	0	1	8	0	0
10	26114668	.	C	A	1	5	6	0	0	6	0	0
10	26114894	.	A	T	6	7	13	0	1	14	0	0
10	26114922	.	A	C	4	9	13	0	0	13	0	0
10	26114952	.	A	T	2	9	11	0	1	12	0	0
10	26118717	.	G	C	3	4	7	0	0	7	0	0
10	26123649	.	A	T	5	2	7	0	0	7	0	0
10	26123667	.	A	C	2	2	4	0	0	4	0	0
10	26126639	.	C	G	6	10	16	0	0	16	0	0
10	26126643	.	T	C	6	9	15	0	0	15	0	0
10	26126903	.	C	T	3	2	5	0	1	6	0	0
10	26126995	.	A	T	4	12	16	0	2	18	0	0
10	26127054	.	G	A	9	10	19	0	0	19	0	0
10	26127075	.	T	C	4	13	17	0	0	17	0	0
10	26127291	.	T	C	17	15	32	0	1	33	0	0
10	26127479	.	C	A	7	12	19	0	0	19	0	0
10	26127484	.	C	T	5	12	17	0	1	18	0	0
10	26127643	.	G	A	10	7	17	0	0	17	0	0
10	26127731	.	C	T	8	10	18	0	1	19	0	0
10	26127968	.	G	T	8	7	15	0	0	15	0	0
10	26128067	.	A	T	5	4	9	0	0	9	0	0
10	26128107	.	C	T	2	3	5	0	0	5	0	0
10	26131166	.	G	A	13	10	23	0	0	23	0	0
10	26131195	.	C	T	0	14	14	0	12	26	0	0
10	26131551	.	C	G	19	22	41	0	0	41	0	0
10	26131622	.	T	C	18	0	18	0	14	32	0	0
10	26131653	.	C	T	22	13	35	0	1	36	0	0
10	26131717	.	A	T	16	10	26	0	0	26	0	0
10	26131719	.	T	C	16	10	26	0	0	26	0	0
10	26131806	.	A	T	7	5	12	0	1	13	0	0
10	26131989	.	C	T	17	9	26	0	2	28	0	0
10	26132084	.	G	T	7	8	15	0	0	15	0	0
10	26132159	.	T	A	1	2	3	0	0	3	0	0
10	26132356	.	A	G	7	8	15	0	0	15	0	0
10	26132437	.	A	T	13	22	35	0	0	35	0	0
10	26132553	.	A	G	13	21	34	0	2	36	0	0
10	26132630	.	C	A	0	5	5	0	3	8	0	0
10	26139304	.	G	A	21	19	40	0	0	40	0	0
10	26139352	.	A	T	4	13	17	0	0	17	0	0
10	26141198	.	C	T	2	1	3	0	0	3	0	0
10	26144153	.	T	G	15	16	31	0	1	32	0	0
10	26144180	.	A	G	12	11	23	0	1	24	0	0
10	26144243	.	A	G	13	12	25	0	1	26	0	0
10	26144249	.	C	A	13	12	25	0	1	26	0	0
10	26150862	.	A	G	5	6	11	0	2	13	0	0
10	26155871	.	T	G	3	5	8	0	0	8	0	0
10	26203499	.	T	G	4	2	6	0	0	6	0	0
10	26204834	.	C	A	4	3	7	0	0	8	1	0
10	26204886	.	A	T	10	8	18	0	0	18	0	0
10	26204897	.	G	C	9	7	16	0	1	17	0	0
10	26205057	.	A	T	6	5	11	0	0	11	0	0
10	26205169	.	G	A	3	2	5	0	3	8	0	0
10	26205176	.	A	T	6	1	7	0	0	7	0	0
10	26205602	.	T	G	2	2	4	0	0	4	0	0
10	26205805	.	A	T	4	11	15	0	0	15	0	0
10	26205909	.	C	A	9	3	12	0	0	12	0	0
10	26206101	.	T	C	8	0	8	0	6	14	0	0
10	26206371	.	A	G	2	1	3	0	0	3	0	0
10	26206509	.	C	T	0	0	0	0	2	2	0	0
10	26209385	.	C	T	6	4	10	0	1	11	0	0
10	26209400	.	C	T	5	4	9	0	0	9	0	0
10	26269571	.	G	A	6	2	8	0	1	9	0	0
10	26269728	.	G	A	4	4	8	0	0	8	0	0
10	26270388	.	C	A	2	4	6	0	0	6	0	0
10	26271018	.	G	C	6	0	6	0	9	15	0	0
10	26271159	.	G	T	2	3	5	0	0	5	0	0
10	26271168	.	G	A	2	4	6	0	0	6	0	0
10	26271357	.	C	A	2	3	5	0	0	5	0	0
10	26271855	.	T	C	2	3	5	0	1	6	0	0
10	26271867	.	G	A	3	4	7	0	0	7	0	0
10	26272155	.	C	T	2	3	5	0	0	5	0	0
10	26273076	.	T	A	2	3	5	0	0	5	0	0
10	26273094	.	G	A	3	2	5	0	0	5	0	0
10	26273139	.	C	T	1	0	1	0	0	1	0	0
10	26279417	.	C	T	3	2	5	0	0	5	0	0
10	26279519	.	T	C	2	3	5	0	0	5	0	0
10	26409728	.	A	G	1	2	3	0	0	3	0	0
10	26504840	.	G	A	0	3	3	0	1	4	0	0
10	26536177	.	C	T	3	5	8	0	0	8	0	0
10	26543567	.	A	G	4	4	8	0	0	8	0	0
10	26544599	.	G	A	1	3	4	0	0	4	0	0
10	26544626	.	C	A	0	1	1	0	0	1	0	0
10	26547356	.	C	T	6	6	12	0	0	12	0	0
10	26551197	.	T	C	8	6	14	0	0	14	0	0
10	26551242	.	A	G	6	4	10	0	1	11	0	0
10	26553007	.	T	A	14	6	20	0	12	32	0	0
10	26560166	.	T	C	2	1	3	0	0	3	0	0
10	26560260	.	C	T	19	32	51	0	2	53	0	0
10	26565704	.	T	C	28	30	58	0	3	61	0	0
10	26565760	.	G	A	2	27	29	0	32	61	0	0
10	26566054	.	G	C	3	18	21	0	17	38	0	0
10	26566267	.	T	C	18	28	46	0	0	46	0	0
10	26566354	.	A	T	16	19	35	0	0	35	0	0
10	26566369	.	A	T	14	14	28	0	0	28	0	0
10	26566715	.	T	A	10	9	19	0	1	20	0	0
10	26566749	.	G	A	12	10	22	0	0	22	0	0
10	26566785	.	T	A	14	10	24	0	0	24	0	0
10	26566787	.	A	T	14	10	24	0	0	24	0	0
10	26566855	.	A	G	18	0	18	0	11	29	0	0
10	26566970	.	T	G	20	1	21	0	14	35	0	0
10	26567238	.	A	G	17	18	35	0	0	35	0	0
10	26567337	.	C	T	13	34	47	0	1	48	0	0
10	26567376	.	C	G	13	27	40	0	1	41	0	0
10	26567500	.	C	T	15	20	35	0	1	36	0	0
10	26567656	.	G	C	18	11	29	0	2	31	0	0
10	26567810	.	C	T	13	20	33	0	3	36	0	0
10	26567889	.	T	A	15	10	25	0	2	27	0	0
10	26567958	.	T	A	15	8	23	0	1	24	0	0
10	26568154	.	A	T	13	20	33	0	1	34	0	0
10	26568166	.	C	T	10	16	26	0	1	27	0	0
10	26568201	.	A	G	3	9	12	0	1	13	0	0
10	26568239	.	C	T	5	5	10	0	0	10	0	0
10	26568429	.	A	C	21	26	47	0	2	49	0	0
10	26568498	.	T	C	20	26	46	0	1	47	0	0
10	26568523	.	G	T	19	28	47	0	1	48	0	0
10	26568726	.	A	G	24	25	49	1	3	53	0	0
10	26569098	.	A	G	18	2	20	0	17	37	0	0
10	26569099	.	A	C	19	17	36	0	1	37	0	0
10	26569248	.	C	A	15	20	35	0	6	41	0	0
10	26574004	.	T	C	4	5	9	0	0	9	0	0
10	26578528	.	T	C	2	1	3	0	0	3	0	0
10	26583978	.	C	G	2	1	3	0	0	3	0	0
10	26596020	.	T	A	24	23	47	0	3	50	0	0
10	26596075	.	C	T	18	22	40	0	2	42	0	0
10	26596080	.	T	C	18	20	38	0	1	39	0	0
10	26656135	.	A	C	1	3	4	0	0	4	0	0
10	26924095	.	G	T	5	2	7	0	0	7	0	0
10	26933176	.	G	T	14	4	18	0	0	18	0	0
10	26950644	.	T	C	1	6	7	0	0	7	0	0
10	26950662	.	A	G	2	6	8	0	1	9	0	0
10	26950702	.	T	C	6	8	14	0	0	14	0	0
10	26958093	.	A	G	3	4	7	0	0	7	0	0
10	26958150	.	G	C	3	5	8	0	1	9	0	0
10	26958457	.	A	G	8	5	13	0	0	13	0	0
10	26958491	.	C	A	8	3	11	0	0	11	0	0
10	26958587	.	T	A	1	3	4	0	0	4	0	0
10	26958609	.	G	A	1	3	4	0	0	4	0	0
10	26959424	.	T	C	1	3	4	0	0	4	0	0
10	26959894	.	C	A	3	3	6	0	0	6	0	0
10	26960281	.	A	G	5	3	8	0	1	9	0	0
10	26960333	.	T	A	0	2	2	0	0	2	0	0
10	26965971	.	G	A	3	7	10	0	0	10	0	0
10	26972152	.	T	C	16	9	25	0	3	28	0	0
10	26972392	.	A	T	5	7	12	0	0	12	0	0
10	26972429	.	A	T	4	4	8	0	0	8	0	0
10	26972877	.	C	G	0	1	1	0	0	1	0	0
10	26973454	.	T	G	1	0	1	0	3	4	0	0
10	26974498	.	T	C	3	2	5	0	0	5	0	0
10	26977154	.	G	A	1	1	2	0	0	2	0	0
10	26978169	.	C	G	9	13	22	0	1	23	0	0
10	26982455	.	C	T	5	4	9	0	0	9	0	0
10	26982495	.	T	C	6	4	10	0	0	10	0	0
10	26982565	.	G	A	2	2	4	0	0	4	0	0
10	26982572	.	C	G	3	3	6	0	1	7	0	0
10	26982670	.	G	A	4	5	9	0	0	9	0	0
10	26982828	.	G	A	1	3	4	0	0	4	0	0
10	26983012	.	A	T	3	2	5	0	1	6	0	0
10	26983020	.	T	C	4	2	6	0	0	6	0	0
10	26983539	.	G	A	1	5	6	0	1	7	0	0
10	26983671	.	C	A	1	3	4	0	1	5	0	0
10	26987399	.	T	C	8	0	8	0	13	21	0	0
10	26989543	.	T	C	2	2	4	0	0	4	0	0
10	26989828	.	A	T	11	15	26	0	0	26	0	0
10	26989843	.	A	T	10	13	23	0	1	24	0	0
10	26990140	.	C	G	2	2	4	0	1	5	0	0
10	26991487	.	T	C	2	2	4	0	0	4	0	0
10	26991875	.	A	T	5	5	10	0	0	10	0	0
10	26991876	.	C	G	5	5	10	0	0	10	0	0
10	26991914	.	A	T	5	4	9	0	0	9	0	0
10	26991984	.	G	C	6	3	9	0	0	9	0	0
10	26991990	.	T	C	5	1	6	0	2	8	0	0
10	26997077	.	C	A	12	13	25	0	0	25	0	0
10	26997139	.	G	T	17	10	27	0	1	28	0	0
10	26997294	.	T	A	3	3	6	0	0	7	1	0
10	26999165	.	T	C	14	1	15	0	16	31	0	0
10	26999341	.	C	T	16	20	36	0	0	36	0	0
10	26999407	.	A	T	7	9	16	0	1	17	0	0
10	26999414	.	A	G	7	8	15	0	0	15	0	0
10	27006512	.	T	A	13	19	32	0	1	33	0	0
10	27006721	.	T	C	8	6	14	0	1	15	0	0
10	27037831	.	G	A	1	0	1	0	0	1	0	0
10	27046400	.	T	A	14	17	31	0	2	33	0	0
10	27052736	.	T	C	2	2	4	0	1	5	0	0
10	27054861	.	T	A	1	3	4	0	0	4	0	0
10	27092323	.	T	G	1	3	4	0	0	4	0	0
10	27092509	.	G	T	3	3	6	0	0	6	0	0
10	27155961	.	C	T	0	2	2	0	0	2	0	0
10	27183328	.	T	G	11	15	26	0	1	27	0	0
10	27183418	.	C	T	11	13	24	0	0	24	0	0
10	27183735	.	C	T	0	10	10	0	17	27	0	0
10	27184069	.	G	A	15	29	44	0	1	45	0	0
10	27184237	.	A	G	17	22	39	0	1	40	0	0
10	27184456	.	A	G	11	13	24	0	0	24	0	0
10	27184600	.	G	A	9	14	23	0	1	24	0	0
10	27184678	.	C	T	0	9	9	1	7	17	0	0
10	27184729	.	C	T	12	11	23	0	2	25	0	0
10	27184843	.	G	A	9	13	22	0	0	22	0	0
10	27184864	.	T	C	14	0	14	0	14	28	0	0
10	27184891	.	T	A	15	15	30	0	0	31	1	0
10	27184905	.	C	T	0	15	15	0	14	29	0	0
10	27185134	.	A	G	5	6	11	0	0	11	0	0
10	27190002	.	C	T	1	0	1	0	0	1	0	0
10	27196623	.	C	T	0	2	2	0	3	5	0	0
10	27196699	.	G	T	9	7	16	0	3	19	0	0
10	27196704	.	C	T	0	6	6	0	11	17	0	0
10	27977673	.	C	T	7	5	12	0	0	12	0	0
10	27977678	.	C	T	7	6	13	0	0	13	0	0
10	27978002	.	A	T	7	3	10	0	0	10	0	0
10	27980508	.	C	T	0	3	3	0	2	5	0	0
10	27988440	.	A	G	2	1	3	0	0	3	0	0
10	28030710	.	C	T	0	13	13	0	6	19	0	0
10	28030729	.	T	C	5	0	5	0	13	18	0	0
10	28030753	.	A	G	8	12	20	0	1	21	0	0
10	28030843	.	C	T	10	6	16	0	0	16	0	0
10	28036119	.	G	A	4	7	11	0	0	11	0	0
10	28037735	.	C	T	5	8	13	0	2	15	0	0
10	28037759	.	C	T	6	6	12	0	0	12	0	0
10	28038167	.	G	A	3	2	5	0	0	5	0	0
10	28039040	.	C	T	4	4	8	0	2	10	0	0
10	28040705	.	G	T	8	5	13	0	1	14	0	0
10	28041152	.	T	A	2	9	11	0	2	13	0	0
10	28041218	.	G	C	11	11	22	0	0	22	0	0
10	28043421	.	T	C	3	2	5	0	0	5	0	0
10	28043490	.	G	A	2	3	5	0	0	5	0	0
10	28057010	.	A	G	6	3	9	0	0	9	0	0
10	28057364	.	T	C	0	0	0	0	1	1	0	0
10	28165150	.	T	A	2	1	3	0	1	4	0	0
10	28168295	.	C	G	4	3	7	0	0	7	0	0
10	28168968	.	G	A	3	4	7	0	0	7	0	0
10	28169061	.	G	A	4	2	6	0	0	6	0	0
10	28172354	.	C	T	1	4	5	0	0	5	0	0
10	28172501	.	T	G	1	3	4	0	0	4	0	0
10	28308418	.	G	T	0	1	1	0	1	2	0	0
10	28308419	.	T	G	1	1	2	0	0	2	0	0
10	28308522	.	G	A	6	2	8	0	0	8	0	0
10	28308710	.	A	T	2	4	6	0	0	6	0	0
10	28311161	.	A	G	22	24	46	0	1	47	0	0
10	28315096	.	A	G	17	18	35	0	0	35	0	0
10	28315396	.	A	G	19	17	36	0	0	36	0	0
10	28315421	.	C	G	10	14	24	0	0	24	0	0
10	28319441	.	A	G	18	13	31	0	2	33	0	0
10	28320654	.	G	C	4	0	4	0	3	7	0	0
10	28321051	.	G	A	15	8	23	0	3	26	0	0
10	28323325	.	A	T	6	5	11	0	0	11	0	0
10	28328174	.	T	C	3	6	9	0	1	10	0	0
10	28328219	.	A	G	1	2	3	0	0	3	0	0
10	28328231	.	A	G	1	0	1	0	0	1	0	0
10	28332868	.	T	C	1	3	4	0	1	5	0	0
10	28334806	.	G	A	1	0	1	0	0	1	0	0
10	28339621	.	C	T	1	2	3	0	0	3	0	0
10	28349266	.	G	A	1	0	1	0	0	1	0	0
10	28350959	.	T	A	4	2	6	0	0	6	0	0
10	28355728	.	A	G	2	3	5	0	0	5	0	0
10	28370974	.	T	G	2	4	6	0	0	6	0	0
10	28371198	.	G	A	7	6	13	0	2	15	0	0
10	28371284	.	G	A	13	15	28	0	0	28	0	0
10	28371407	.	C	T	0	5	5	0	10	15	0	0
10	28376814	.	T	C	4	0	4	0	7	11	0	0
10	28376895	.	C	T	6	4	10	0	0	10	0	0
10	28443365	.	C	G	0	1	1	0	0	1	0	0
10	28470322	.	A	G	1	2	3	0	0	3	0	0
10	28483319	.	C	T	3	2	5	0	0	5	0	0
10	28672479	.	T	C	1	1	2	0	0	2	0	0
10	28672488	.	G	A	0	1	1	0	0	1	0	0
10	28679049	.	G	A	0	0	0	0	2	2	0	0
10	28690910	.	G	A	0	5	5	0	1	6	0	0
10	28690959	.	A	T	3	3	6	0	0	6	0	0
10	28691007	.	C	T	2	0	2	0	0	2	0	0
10	28691024	.	C	T	0	2	2	0	0	2	0	0
10	28695869	.	T	A	1	2	3	0	4	7	0	0
10	28723769	.	A	T	1	3	4	0	0	4	0	0
10	28723805	.	G	A	0	2	2	0	5	7	0	0
10	28724220	.	G	A	1	5	6	0	0	6	0	0
10	28730249	.	C	T	4	5	9	0	0	9	0	0
10	28730437	.	G	T	4	9	13	0	2	15	0	0
10	28730446	.	A	C	11	4	15	0	0	15	0	0
10	28730503	.	G	A	3	3	6	0	0	6	0	0
10	28730738	.	C	T	5	4	9	0	0	9	0	0
10	28730800	.	A	T	1	0	1	0	1	8	6	0
10	28730869	.	C	T	9	9	18	0	1	19	0	0
10	28730880	.	T	A	8	11	19	0	1	20	0	0
10	28730913	.	G	A	18	11	29	0	0	29	0	0
10	28731001	.	C	T	9	10	19	0	2	21	0	0
10	28731072	.	C	T	12	6	18	0	2	20	0	0
10	28731155	.	A	T	7	7	14	0	1	15	0	0
10	28731289	.	T	C	10	7	17	0	1	18	0	0
10	28731372	.	G	A	0	11	11	0	10	21	0	0
10	28732003	.	C	A	21	20	41	0	0	41	0	0
10	28732366	.	A	G	12	18	30	0	1	31	0	0
10	28732601	.	C	T	0	22	22	0	11	33	0	0
10	28732785	.	T	C	23	11	34	0	2	36	0	0
10	28733067	.	G	T	20	16	36	0	3	39	0	0
10	28733132	.	T	A	14	18	32	0	0	32	0	0
10	28737345	.	C	T	5	3	8	0	2	10	0	0
10	28743800	.	T	A	13	9	22	0	0	22	0	0
10	28745583	.	G	A	9	6	15	0	0	15	0	0
10	28748996	.	G	A	2	0	2	0	0	2	0	0
10	28835635	.	C	G	3	3	6	0	0	6	0	0
10	28835655	.	G	A	4	2	6	0	0	6	0	0
10	28835701	.	A	T	3	4	7	0	0	7	0	0
10	29166502	.	A	G	6	6	12	0	0	12	0	0
10	29185863	.	T	A	4	2	6	0	0	6	0	0
10	29187908	.	C	T	4	3	7	0	0	7	0	0
10	29201671	.	C	T	3	4	7	0	0	7	0	0
10	29205655	.	A	T	3	7	10	0	0	10	0	0
10	29224364	.	C	T	1	7	8	0	3	11	0	0
10	29224484	.	G	A	12	11	23	0	5	28	0	0
10	29224598	.	A	T	13	24	37	0	1	38	0	0
10	29224651	.	C	A	19	13	32	0	1	33	0	0
10	29225032	.	A	G	9	0	9	0	8	17	0	0
10	29265596	.	A	G	4	0	4	0	12	16	0	0
10	29265599	.	T	A	6	10	16	0	0	16	0	0
10	29266279	.	C	A	2	2	4	0	0	4	0	0
10	29266376	.	C	T	21	18	39	0	3	42	0	0
10	29270225	.	C	T	7	8	15	0	1	16	0	0
10	29271915	.	C	T	2	3	5	0	0	5	0	0
10	29572857	.	C	T	5	7	12	0	0	12	0	0
10	29578478	.	C	T	4	4	8	0	1	9	0	0
10	29578756	.	G	T	6	4	10	0	0	10	0	0
10	29661410	.	C	T	3	3	6	0	0	6	0	0
10	29661419	.	C	G	2	0	2	0	3	5	0	0
10	29678256	.	A	G	17	0	17	0	6	23	0	0
10	29678313	.	G	A	4	1	5	0	0	5	0	0
10	29705444	.	G	T	5	4	9	0	1	10	0	0
10	29736736	.	T	C	2	0	2	0	8	10	0	0
10	29736746	.	C	T	0	6	6	0	3	9	0	0
10	29742625	.	C	T	0	0	0	0	1	1	0	0
10	29742656	.	C	T	0	1	1	0	0	1	0	0
10	29742795	.	T	C	2	5	7	0	0	7	0	0
10	29751328	.	G	A	13	6	19	0	0	19	0	0
10	29751407	.	T	C	13	4	17	0	0	17	0	0
10	29761405	.	C	T	3	5	8	0	0	8	0	0
10	29761761	.	A	T	6	3	9	0	0	9	0	0
10	29761767	.	G	A	6	3	9	0	0	9	0	0
10	29762935	.	G	A	1	1	2	0	0	2	0	0
10	29763146	.	A	G	6	2	8	0	0	8	0	0
10	29766072	.	C	G	1	1	2	0	0	2	0	0
10	29766841	.	C	T	1	2	3	0	0	3	0	0
10	29778433	.	T	C	1	1	2	0	0	2	0	0
10	29788229	.	G	T	1	0	1	0	0	1	0	0
10	29815697	.	A	C	3	5	8	0	8	16	0	0
10	29815802	.	A	G	27	21	48	0	0	48	0	0
10	29816113	.	T	C	33	19	52	0	0	52	0	0
10	29816290	.	T	A	22	32	54	0	1	55	0	0
10	29816439	.	A	T	16	22	38	0	0	38	0	0
10	29816904	.	C	T	36	31	67	0	4	71	0	0
10	29817111	.	C	T	34	43	77	0	1	78	0	0
10	29817207	.	C	T	33	37	70	0	1	71	0	0
10	29817416	.	A	T	28	21	49	0	3	52	0	0
10	29820495	.	G	A	7	5	12	0	0	12	0	0
10	29823484	.	G	A	0	1	1	0	0	1	0	0
10	29824248	.	C	T	1	2	3	0	1	4	0	0
10	29824262	.	C	T	2	3	5	0	0	5	0	0
10	29828443	.	A	G	4	1	5	0	0	5	0	0
10	29851722	.	C	T	29	27	56	0	1	57	0	0
10	29852317	.	G	A	4	4	8	0	0	8	0	0
10	29852476	.	A	G	20	3	23	0	15	38	0	0
10	29852485	.	A	G	17	2	19	0	12	31	0	0
10	29892382	.	C	T	2	5	7	0	0	7	0	0
10	29892478	.	C	T	3	2	5	0	0	5	0	0
10	30576004	.	T	C	5	5	10	0	1	11	0	0
10	30576061	.	G	A	1	2	3	0	0	3	0	0
10	30618313	.	T	A	5	8	13	0	0	13	0	0
10	30618429	.	A	T	3	2	5	0	0	5	0	0
10	30623408	.	G	A	4	4	8	0	0	8	0	0
10	30624615	.	C	T	0	1	1	0	0	1	0	0
10	31020810	.	A	G	9	7	16	0	0	16	0	0
10	31021505	.	T	C	8	12	20	0	0	20	0	0
10	31021550	.	G	A	11	8	19	0	3	22	0	0
10	31021553	.	G	A	8	13	21	0	1	22	0	0
10	31021611	.	C	T	14	14	28	0	0	28	0	0
10	31021676	.	G	A	11	14	25	0	1	26	0	0
10	31023520	.	A	G	11	8	19	0	1	20	0	0
10	31032043	.	T	C	7	4	11	0	1	12	0	0
10	31034999	.	C	T	0	0	0	0	2	2	0	0
10	31035129	.	C	T	6	3	9	0	1	10	0	0
10	31035147	.	C	T	2	4	6	0	0	6	0	0
10	31066888	.	C	T	0	2	2	0	6	8	0	0
10	31280293	.	G	A	1	4	5	0	0	5	0	0
10	31628397	.	C	T	6	6	12	0	0	12	0	0
10	31628406	.	C	T	5	8	13	0	0	13	0	0
10	31628481	.	T	C	2	3	5	0	0	5	0	0
10	31632313	.	G	C	4	5	9	0	0	9	0	0
10	31632643	.	C	T	6	3	9	0	0	9	0	0
10	31632758	.	A	T	10	3	13	0	0	13	0	0
10	31632829	.	A	G	3	5	8	0	0	8	0	0
10	31632945	.	C	T	9	4	13	0	1	14	0	0
10	31633077	.	A	C	5	5	10	0	0	10	0	0
10	31633424	.	A	G	1	3	4	0	0	4	0	0
10	31633438	.	T	A	1	1	2	0	1	3	0	0
10	31633640	.	G	A	5	5	10	0	0	10	0	0
10	31633669	.	C	T	5	5	10	0	0	10	0	0
10	31725697	.	C	T	5	2	7	0	1	8	0	0
10	31725736	.	T	C	3	4	7	0	1	8	0	0
10	31738616	.	A	G	11	7	18	0	0	18	0	0
10	31739181	.	G	T	33	22	55	0	2	57	0	0
10	31739346	.	G	T	23	20	43	0	3	46	0	0
10	31751941	.	C	T	2	4	6	0	0	6	0	0
10	31757307	.	C	T	31	20	51	0	0	51	0	0
10	31772041	.	G	A	15	22	37	0	2	39	0	0
10	31782605	.	C	T	1	2	3	0	0	3	0	0
10	31800313	.	A	G	6	4	10	0	0	10	0	0
10	32036978	.	G	A	1	2	3	0	0	3	0	0
10	32037355	.	C	T	2	4	6	0	2	8	0	0
10	32037373	.	T	C	5	3	8	0	1	9	0	0
10	32037951	.	C	T	3	2	5	0	0	5	0	0
10	32062738	.	C	T	1	2	3	0	1	4	0	0
10	32063605	.	C	T	2	4	6	0	0	6	0	0
10	32063752	.	G	A	4	6	10	0	1	11	0	0
10	32064222	.	A	T	3	8	11	0	0	11	0	0
10	32122727	.	T	C	5	2	7	0	0	7	0	0
10	32122738	.	T	C	5	2	7	0	1	8	0	0
10	32122840	.	T	A	2	3	5	0	0	5	0	0
10	32122952	.	T	A	4	6	10	0	0	10	0	0
10	32265331	.	A	C	1	2	3	0	0	3	0	0
10	32383514	.	G	A	1	1	2	0	0	2	0	0
10	32391423	.	T	C	1	0	1	0	0	1	0	0
10	32398296	.	T	A	2	0	2	0	0	2	0	0
10	32561338	.	G	A	3	7	10	0	1	11	0	0
10	32561427	.	A	C	6	9	15	0	0	15	0	0
10	32561437	.	T	A	5	10	15	0	0	15	0	0
10	32561817	.	G	A	0	5	5	0	9	14	0	0
10	32561820	.	G	T	9	5	14	0	0	14	0	0
10	32562267	.	C	T	4	8	12	0	1	13	0	0
10	32577486	.	G	A	5	6	11	0	0	11	0	0
10	32577489	.	A	G	5	5	10	0	1	11	0	0
10	32577522	.	C	T	12	9	21	0	1	22	0	0
10	32577549	.	T	C	9	11	20	0	1	21	0	0
10	32577621	.	G	A	2	6	8	0	1	9	0	0
10	32857386	.	C	T	6	28	34	0	3	37	0	0
10	32857419	.	T	C	31	0	31	0	11	42	0	0
10	34402897	.	A	G	6	2	8	0	1	9	0	0
10	34661821	.	T	C	0	2	2	0	0	2	0	0
10	34661857	.	A	G	3	2	5	0	0	5	0	0
10	34662349	.	C	T	2	5	7	0	0	7	0	0
10	34673597	.	C	T	2	2	4	0	0	4	0	0
10	34676094	.	A	G	3	0	3	0	1	4	0	0
10	34676266	.	G	T	4	4	8	0	0	8	0	0
10	34677539	.	T	C	2	2	4	0	0	4	0	0
10	34677569	.	C	T	3	2	5	0	0	5	0	0
10	34677673	.	T	C	1	2	3	0	3	6	0	0
10	34699238	.	C	T	1	0	1	0	0	1	0	0
10	34701434	.	A	C	4	9	13	0	1	14	0	0
10	34703742	.	G	A	0	1	1	0	0	1	0	0
10	34703802	.	A	G	5	1	6	0	5	11	0	0
10	34707546	.	A	T	3	1	4	0	0	4	0	0
10	34709708	.	G	C	1	2	3	0	0	3	0	0
10	34709940	.	C	T	4	6	10	0	0	10	0	0
10	34724906	.	C	T	4	6	10	0	0	10	0	0
10	34729552	.	G	A	15	14	29	0	0	29	0	0
10	34729693	.	C	T	5	2	7	0	0	7	0	0
10	34733566	.	A	G	30	15	45	0	1	46	0	0
10	34733578	.	A	G	30	1	31	0	18	49	0	0
10	34733661	.	C	T	14	18	32	0	8	40	0	0
10	34733883	.	A	T	19	19	38	0	1	39	0	0
10	34734568	.	G	T	0	17	17	0	16	33	0	0
10	34734590	.	A	G	17	25	42	0	2	44	0	0
10	34734785	.	G	T	14	12	26	0	1	27	0	0
10	34737686	.	A	G	18	20	38	0	2	40	0	0
10	34738125	.	T	C	28	23	51	0	2	53	0	0
10	34741649	.	T	A	9	5	14	0	0	14	0	0
10	34743910	.	G	A	0	2	2	0	0	2	0	0
10	34754660	.	C	T	9	22	31	0	3	34	0	0
10	34756936	.	A	C	3	1	4	0	0	4	0	0
10	34768327	.	C	A	5	2	7	0	0	7	0	0
10	34813299	.	T	C	4	5	9	0	1	10	0	0
10	34867259	.	T	C	5	0	5	0	6	11	0	0
10	34958760	.	A	T	15	12	27	0	0	27	0	0
10	34961149	.	C	A	18	12	30	0	3	33	0	0
10	34984675	.	T	A	1	3	4	0	0	4	0	0
10	34984836	.	A	G	8	19	27	0	0	27	0	0
10	34984923	.	T	C	5	7	12	0	0	12	0	0
10	34984931	.	C	A	0	6	6	0	5	11	0	0
10	34989149	.	T	C	9	0	9	0	15	24	0	0
10	34998281	.	G	C	6	3	9	0	0	9	0	0
10	35006358	.	T	C	2	4	6	0	0	6	0	0
10	35008963	.	C	T	1	2	3	0	0	3	0	0
10	35011325	.	C	T	5	2	7	0	0	7	0	0
10	35011337	.	A	G	3	5	8	0	1	9	0	0
10	35011482	.	G	A	1	5	6	0	2	8	0	0
10	35012184	.	C	T	1	8	9	0	7	16	0	0
10	35029172	.	G	A	5	5	10	0	0	10	0	0
10	35032814	.	T	C	1	2	3	0	0	3	0	0
10	35046093	.	C	T	1	0	1	0	0	1	0	0
10	35220214	.	C	T	1	1	2	0	0	2	0	0
10	35236801	.	T	G	4	1	5	0	0	5	0	0
10	35241646	.	A	T	9	8	17	0	0	17	0	0
10	35242113	.	C	G	5	6	11	0	0	11	0	0
10	35245939	.	T	A	3	4	7	0	0	7	0	0
10	35245951	.	C	T	1	4	5	0	0	5	0	0
10	35247905	.	G	A	2	3	5	0	0	5	0	0
10	35247980	.	G	C	3	0	3	0	3	6	0	0
10	35248047	.	C	G	2	4	6	0	0	6	0	0
10	35248280	.	T	C	1	0	1	0	4	5	0	0
10	35265234	.	C	T	1	0	1	0	1	2	0	0
10	35272418	.	T	C	1	0	1	0	0	1	0	0
10	35281335	.	C	T	2	3	5	0	0	5	0	0
10	35298732	.	A	G	2	2	4	0	0	4	0	0
10	35300764	.	C	T	3	3	6	0	0	6	0	0
10	35302425	.	T	C	3	2	5	0	0	5	0	0
10	35304002	.	G	A	4	7	11	0	2	13	0	0
10	35307579	.	C	T	0	1	1	0	0	1	0	0
10	35312021	.	A	C	7	14	21	1	3	25	0	0
10	35312143	.	A	G	2	0	2	0	3	5	0	0
10	35314709	.	G	C	2	0	2	0	4	6	0	0
10	35315060	.	A	C	0	0	0	0	1	1	0	0
10	35538879	.	T	A	14	19	33	0	3	37	1	0
10	35539607	.	A	G	11	13	24	0	2	26	0	0
10	35539631	.	G	A	14	11	25	0	0	25	0	0
10	35540422	.	T	A	11	15	26	0	2	28	0	0
10	35540603	.	C	T	18	12	30	0	1	31	0	0
10	35540675	.	T	G	16	16	32	0	2	34	0	0
10	35540705	.	T	A	13	19	32	0	2	34	0	0
10	35540732	.	T	G	10	21	31	0	2	33	0	0
10	35540847	.	T	G	12	8	20	0	1	21	0	0
10	35541245	.	T	C	6	7	13	0	1	14	0	0
10	35541290	.	A	G	6	6	12	0	1	13	0	0
10	35541735	.	C	T	2	4	6	0	0	6	0	0
10	35541760	.	C	T	2	2	4	0	1	5	0	0
10	35554345	.	G	T	0	0	0	0	1	1	0	0
10	35573836	.	C	T	1	2	3	0	0	3	0	0
10	35584806	.	T	G	20	8	28	0	0	28	0	0
10	35584815	.	A	G	19	4	23	0	1	24	0	0
10	35584855	.	T	A	12	3	15	0	1	16	0	0
10	35585057	.	A	T	6	6	12	0	0	12	0	0
10	35585195	.	G	A	7	8	15	0	2	17	0	0
10	35585197	.	A	G	9	7	16	0	1	17	0	0
10	35585257	.	C	T	4	10	14	0	3	17	0	0
10	35585284	.	C	T	1	14	15	0	5	20	0	0
10	35592817	.	A	G	7	8	15	0	1	16	0	0
10	35592830	.	G	A	8	11	19	0	0	19	0	0
10	35595335	.	C	T	1	1	2	0	0	2	0	0
10	35595669	.	T	A	4	2	6	0	0	6	0	0
10	35602535	.	G	T	1	2	3	0	0	3	0	0
10	35602678	.	G	A	0	1	1	0	0	1	0	0
10	35602756	.	T	C	5	0	5	0	0	5	0	0
10	35609808	.	G	A	3	2	5	0	0	5	0	0
10	35611227	.	G	T	1	2	3	0	0	3	0	0
10	35654268	.	C	T	7	21	28	0	0	28	0	0
10	35654290	.	A	C	5	22	27	0	3	30	0	0
10	35654305	.	T	C	5	24	29	0	2	31	0	0
10	35664290	.	C	T	2	2	4	0	3	7	0	0
10	35664527	.	T	C	5	2	7	0	0	7	0	0
10	36443018	.	T	C	9	9	18	0	0	18	0	0
10	36443541	.	T	C	12	10	22	0	0	22	0	0
10	36443676	.	G	A	1	7	8	0	4	12	0	0
10	36443714	.	G	A	5	8	13	0	2	15	0	0
10	36443818	.	T	G	1	0	1	0	1	2	0	0
10	36446799	.	A	T	3	1	4	0	0	4	0	0
10	36451615	.	T	C	5	2	7	0	0	7	0	0
10	36451661	.	G	A	14	9	23	0	0	23	0	0
10	36454567	.	C	A	15	6	21	0	4	25	0	0
10	36454649	.	A	G	11	0	11	0	20	31	0	0
10	36454650	.	C	A	12	17	29	0	1	31	1	0
10	36454902	.	G	T	11	18	29	0	2	31	0	0
10	36455146	.	C	T	15	12	27	0	1	28	0	0
10	36455215	.	T	C	12	14	26	0	1	27	0	0
10	36455229	.	C	G	14	15	29	0	0	29	0	0
10	36455344	.	A	G	12	11	23	0	2	25	0	0
10	36476481	.	C	T	0	17	17	0	13	30	0	0
10	36476529	.	C	T	14	10	24	0	0	24	0	0
10	36476639	.	C	T	0	14	14	0	8	22	0	0
10	36476717	.	A	G	16	20	36	0	0	36	0	0
10	36476834	.	G	A	12	17	29	0	2	31	0	0
10	36476852	.	A	G	14	18	32	0	1	33	0	0
10	36476922	.	C	T	2	1	3	0	0	3	0	0
10	36481915	.	A	C	13	8	21	0	2	23	0	0
10	36482588	.	G	A	11	12	23	0	0	23	0	0
10	36487530	.	G	A	9	11	20	0	2	22	0	0
10	36489882	.	A	G	1	4	5	0	0	5	0	0
10	36489893	.	A	G	1	4	5	0	1	6	0	0
10	36492091	.	C	T	0	2	2	0	0	2	0	0
10	36494336	.	G	A	3	2	5	0	0	5	0	0
10	36494590	.	C	G	0	4	4	0	0	4	0	0
10	36495580	.	T	G	1	2	3	1	0	4	0	0
10	36496544	.	A	G	5	3	8	0	0	8	0	0
10	36496595	.	G	A	2	1	3	0	0	3	0	0
10	36498379	.	C	T	0	1	1	0	3	4	0	0
10	36498397	.	G	A	1	3	4	0	0	4	0	0
10	36500581	.	C	T	2	3	5	0	0	5	0	0
10	36500674	.	G	A	3	2	5	0	0	5	0	0
10	36506290	.	C	T	0	2	2	0	1	3	0	0
10	36506630	.	T	A	1	1	2	0	0	2	0	0
10	36518643	.	C	T	1	0	1	0	0	1	0	0
10	36519788	.	T	C	1	3	4	0	1	5	0	0
10	36520003	.	C	T	0	1	1	0	0	1	0	0
10	36520024	.	C	A	0	2	2	0	0	2	0	0
10	36520711	.	G	A	2	5	7	0	0	7	0	0
10	36522713	.	A	C	1	0	1	0	2	3	0	0
10	36523826	.	G	A	0	2	2	0	0	2	0	0
10	36558839	.	A	G	10	9	19	0	0	19	0	0
10	36558895	.	G	A	9	11	20	0	1	21	0	0
10	36570469	.	A	G	5	7	12	0	0	12	0	0
10	36572622	.	G	A	2	1	3	0	0	3	0	0
10	36572640	.	C	A	0	4	4	0	2	6	0	0
10	36572757	.	G	A	3	3	6	0	0	6	0	0
10	36575980	.	G	A	1	2	3	0	0	3	0	0
10	36613095	.	T	C	11	7	18	0	0	18	0	0
10	36613145	.	G	T	9	10	19	0	1	20	0	0
10	36613164	.	C	T	1	7	8	0	6	14	0	0
10	36613276	.	C	T	7	7	14	0	0	14	0	0
10	36615367	.	G	A	0	1	1	0	0	1	0	0
10	36615907	.	C	A	6	5	11	0	1	12	0	0
10	36618435	.	C	T	1	10	11	0	13	24	0	0
10	36618787	.	C	T	0	2	2	0	0	2	0	0
10	36625258	.	C	A	2	4	6	0	9	15	0	0
10	36625534	.	G	A	4	3	7	0	2	9	0	0
10	36625602	.	C	G	8	4	12	0	0	12	0	0
10	36625761	.	T	A	7	5	12	0	2	14	0	0
10	36626201	.	C	T	3	5	8	0	0	8	0	0
10	36627314	.	C	T	3	3	6	0	1	7	0	0
10	36627326	.	C	T	4	3	7	0	2	9	0	0
10	36627390	.	A	G	2	2	4	0	0	4	0	0
10	36627517	.	C	T	1	4	5	0	0	5	0	0
10	36627820	.	C	T	2	3	5	0	0	5	0	0
10	36627942	.	A	T	5	3	8	0	0	8	0	0
10	36628009	.	C	A	1	2	3	0	0	3	0	0
10	36628012	.	G	A	1	2	3	0	0	3	0	0
10	36628569	.	C	T	0	3	3	0	1	4	0	0
10	36628626	.	G	A	3	3	6	0	0	6	0	0
10	36665829	.	C	T	2	3	5	0	0	5	0	0
10	36670106	.	T	C	0	2	2	0	0	2	0	0
10	36673237	.	G	T	1	2	3	0	0	3	0	0
10	36688455	.	C	T	2	3	5	0	0	5	0	0
10	36695781	.	G	C	9	9	18	0	1	19	0	0
10	36695785	.	C	T	9	9	18	0	0	18	0	0
10	36704842	.	A	G	6	12	18	0	0	18	0	0
10	36706217	.	T	A	0	1	1	0	0	1	0	0
10	36708401	.	A	G	6	0	6	0	8	14	0	0
10	36708453	.	C	T	8	5	13	0	0	13	0	0
10	36710559	.	A	C	11	15	26	0	4	30	0	0
10	36710599	.	C	T	23	11	34	0	0	34	0	0
10	36710871	.	G	A	1	20	21	0	14	35	0	0
10	36710893	.	G	T	0	15	15	0	21	36	0	0
10	36711260	.	T	A	3	8	11	0	0	11	0	0
10	36711329	.	T	A	8	9	17	0	1	18	0	0
10	36711613	.	C	T	15	9	24	0	0	24	0	0
10	36774339	.	A	C	1	2	3	0	0	3	0	0
10	36796083	.	A	G	2	2	4	0	0	4	0	0
10	36796131	.	T	A	4	6	10	0	0	10	0	0
10	36800465	.	G	A	7	9	16	0	0	16	0	0
10	36800518	.	C	T	12	8	20	0	1	21	0	0
10	36800600	.	G	A	6	3	9	0	0	9	0	0
10	36800642	.	A	G	5	4	9	0	0	9	0	0
10	36807986	.	G	A	3	3	6	0	0	6	0	0
10	36808032	.	G	A	1	2	3	0	0	3	0	0
10	36808096	.	A	G	1	2	3	0	0	3	0	0
10	36811815	.	A	G	12	3	15	0	1	16	0	0
10	36812214	.	A	C	5	5	10	0	0	10	0	0
10	36814912	.	G	A	3	4	7	0	1	8	0	0
10	36815330	.	T	C	1	0	1	0	2	3	0	0
10	36815360	.	A	G	0	1	1	0	0	1	0	0
10	36817197	.	A	C	1	0	1	0	0	1	0	0
10	36817355	.	C	T	0	6	6	0	6	12	0	0
10	36817530	.	C	T	8	7	15	0	1	16	0	0
10	36817940	.	T	C	5	8	13	0	1	14	0	0
10	36817979	.	T	G	1	1	2	0	0	2	0	0
10	36819664	.	G	T	4	4	8	0	0	8	0	0
10	36819671	.	C	T	4	4	8	0	0	8	0	0
10	36820601	.	C	T	0	4	4	0	4	8	0	0
10	36820611	.	A	G	3	4	7	0	0	7	0	0
10	36820664	.	C	T	3	4	7	0	0	7	0	0
10	36820688	.	C	G	0	5	5	0	4	9	0	0
10	36820726	.	T	G	2	0	2	0	7	9	0	0
10	36820736	.	G	A	6	4	10	0	0	10	0	0
10	36820769	.	T	A	11	6	17	0	0	17	0	0
10	36820892	.	G	A	2	0	2	0	0	2	0	0
10	36825650	.	C	T	0	3	3	0	1	4	0	0
10	36825880	.	G	A	2	4	6	0	1	7	0	0
10	36828227	.	T	C	9	10	19	0	1	20	0	0
10	36828265	.	G	A	12	7	19	0	0	19	0	0
10	36828295	.	G	T	8	10	18	0	1	19	0	0
10	36828469	.	T	C	3	0	3	0	9	12	0	0
10	36828475	.	C	T	8	5	13	0	0	13	0	0
10	36835641	.	A	T	1	3	4	0	1	5	0	0
10	36835740	.	G	A	6	3	9	0	0	9	0	0
10	36838768	.	C	T	1	1	2	0	0	2	0	0
10	36841230	.	G	T	2	8	10	0	2	12	0	0
10	36843114	.	C	G	2	1	3	0	0	3	0	0
10	36848872	.	G	A	1	3	4	0	2	6	0	0
10	36848938	.	A	G	4	1	5	0	0	5	0	0
10	36850752	.	A	G	3	3	6	0	0	6	0	0
10	36876162	.	A	C	2	0	2	0	1	3	0	0
10	36878568	.	C	T	2	1	3	0	1	4	0	0
10	36950935	.	A	T	5	5	10	0	0	10	0	0
10	36951044	.	A	T	5	6	11	0	0	11	0	0
10	36951076	.	G	C	3	7	10	0	1	11	0	0
10	36951223	.	A	C	7	13	20	0	0	20	0	0
10	36951378	.	A	G	0	4	4	0	1	5	0	0
10	36951582	.	C	G	7	13	20	0	1	21	0	0
10	36951660	.	T	A	7	15	22	0	0	22	0	0
10	36963456	.	G	A	2	6	8	0	0	8	0	0
10	36967206	.	T	C	2	5	7	0	0	8	1	0
10	36969510	.	T	C	0	1	1	0	0	1	0	0
10	36969519	.	A	G	0	1	1	0	0	1	0	0
10	36974901	.	G	A	3	3	6	0	0	6	0	0
10	36976271	.	C	T	0	0	0	0	1	1	0	0
10	36976318	.	G	A	7	2	9	0	0	9	0	0
10	36987831	.	T	G	3	1	4	0	0	4	0	0
10	37007508	.	G	C	5	0	5	0	0	5	0	0
10	37016252	.	T	G	3	2	5	0	0	5	0	0
10	37137549	.	G	A	0	0	0	0	7	7	0	0
10	37145178	.	G	A	7	10	17	0	1	18	0	0
10	37152081	.	G	A	1	1	2	0	0	2	0	0
10	37152105	.	A	G	7	0	7	0	4	11	0	0
10	37167151	.	G	C	15	9	24	0	0	24	0	0
10	37227524	.	C	T	3	6	9	0	0	9	0	0
10	37239229	.	G	A	3	3	6	0	1	7	0	0
10	37252054	.	G	A	0	5	5	0	0	5	0	0
10	37253986	.	A	G	3	3	6	0	1	7	0	0
10	37334291	.	G	T	2	3	5	0	0	5	0	0
10	37385317	.	T	C	1	1	2	0	0	2	0	0
10	37394478	.	G	A	1	1	2	0	0	2	0	0
10	37394486	.	G	A	1	1	2	0	0	2	0	0
10	37394535	.	C	T	1	2	3	0	0	3	0	0
10	37764473	.	C	T	13	4	17	0	2	19	0	0
10	37779765	.	A	C	1	1	2	0	0	2	0	0
10	37779778	.	T	A	1	1	2	0	0	2	0	0
10	37783114	.	A	G	9	13	22	0	1	23	0	0
10	37783179	.	A	G	10	0	10	0	16	26	0	0
10	37783323	.	A	G	11	5	16	0	1	17	0	0
10	37783575	.	C	A	1	2	3	0	0	3	0	0
10	37783669	.	C	A	6	6	12	0	1	13	0	0
10	37992653	.	C	T	2	2	4	0	0	4	0	0
10	37992679	.	G	A	0	2	2	0	2	4	0	0
10	37992839	.	A	T	3	3	6	0	0	6	0	0
10	37994630	.	C	T	3	2	5	0	0	5	0	0
10	38003011	.	A	G	10	8	18	0	0	18	0	0
10	38007640	.	A	G	1	2	3	0	0	3	0	0
10	38007662	.	C	A	1	2	3	0	0	3	0	0
10	38170573	.	G	A	5	3	8	0	0	8	0	0
10	38170574	.	A	G	4	4	8	0	0	8	0	0
10	38170737	.	G	A	7	8	15	0	0	15	0	0
10	38171149	.	G	C	8	0	8	0	9	17	0	0
10	38171196	.	G	A	10	7	17	0	0	17	0	0
10	38171207	.	C	A	6	11	17	0	2	19	0	0
10	38171356	.	A	T	11	18	29	0	0	29	0	0
10	38171490	.	T	A	13	8	21	0	2	23	0	0
10	38173383	.	C	A	0	3	3	0	7	10	0	0
10	38177999	.	C	T	0	8	8	0	6	14	0	0
10	38180732	.	A	T	0	1	1	0	0	1	0	0
10	38199097	.	G	A	4	2	6	0	0	6	0	0
10	38199169	.	T	C	0	3	3	0	0	3	0	0
10	38211810	.	C	G	2	0	2	0	0	2	0	0
10	38231165	.	C	T	0	1	1	0	2	3	0	0
10	38235957	.	G	C	1	1	2	0	0	2	0	0
10	38243449	.	G	A	2	3	5	0	0	5	0	0
10	38257295	.	G	A	4	9	13	0	1	15	1	0
10	38257509	.	C	G	0	10	10	0	3	13	0	0
10	38257558	.	C	T	4	6	10	0	1	11	0	0
10	38257870	.	T	C	17	13	30	0	1	31	0	0
10	38258729	.	C	G	13	12	25	0	1	27	1	0
10	38259033	.	C	T	6	8	14	0	0	14	0	0
10	38259034	.	A	G	6	8	14	0	0	14	0	0
10	38259204	.	G	A	2	8	10	0	0	10	0	0
10	38259217	.	A	G	4	6	10	0	0	10	0	0
10	38259339	.	A	T	8	3	11	0	0	11	0	0
10	38259449	.	A	C	5	0	5	0	7	12	0	0
10	38259451	.	A	G	5	6	11	0	1	12	0	0
10	38259900	.	T	C	5	0	5	0	7	12	0	0
10	38260002	.	G	A	2	4	6	0	1	7	0	0
10	38260210	.	T	A	6	6	12	0	2	14	0	0
10	38260626	.	A	T	6	4	10	0	1	11	0	0
10	38261085	.	T	G	3	2	5	0	0	5	0	0
10	38261696	.	C	T	1	4	5	0	0	5	0	0
10	38665994	.	C	T	0	1	1	0	0	1	0	0
10	38666063	.	T	C	7	5	12	0	0	12	0	0
10	38686126	.	T	C	5	3	8	0	1	9	0	0
10	38695152	.	A	C	17	9	26	0	0	26	0	0
10	38695510	.	A	G	22	9	31	0	0	31	0	0
10	38695656	.	A	G	17	5	22	0	1	23	0	0
10	38695877	.	C	T	13	10	23	0	0	23	0	0
10	38695888	.	C	T	11	7	18	0	0	18	0	0
10	38712431	.	C	T	1	7	8	0	0	8	0	0
10	38723491	.	T	C	0	3	3	0	0	3	0	0
10	38891454	.	C	A	4	5	9	0	0	9	0	0
10	38922043	.	G	A	0	4	4	0	0	4	0	0
10	38924557	.	C	T	3	3	6	0	0	6	0	0
10	38924560	.	T	C	2	3	5	0	0	5	0	0
10	38934391	.	A	G	3	2	5	0	0	5	0	0
10	38940232	.	A	G	1	10	11	0	0	11	0	0
10	38943265	.	C	G	11	4	15	0	0	15	0	0
10	38950115	.	T	C	3	1	4	0	0	4	0	0
10	38950430	.	G	A	1	10	11	0	5	16	0	0
10	38950484	.	A	G	7	15	22	0	0	22	0	0
10	38950538	.	T	C	4	5	9	0	0	9	0	0
10	38954126	.	C	T	15	4	19	0	4	23	0	0
10	38954141	.	T	C	17	5	22	0	1	23	0	0
10	38954798	.	T	C	6	8	14	0	0	14	0	0
10	38954801	.	C	T	7	8	15	0	0	15	0	0
10	38957061	.	T	C	12	18	30	0	1	31	0	0
10	38957127	.	G	A	0	12	12	0	11	23	0	0
10	38957193	.	C	T	6	5	11	0	0	11	0	0
10	38957748	.	A	C	5	15	20	0	2	22	0	0
10	38957754	.	A	C	6	15	21	0	1	22	0	0
10	38969552	.	A	C	29	19	48	0	4	52	0	0
10	38969598	.	A	C	21	29	50	0	2	52	0	0
10	38969629	.	C	T	18	35	53	0	1	54	0	0
10	38969685	.	A	G	22	22	44	0	6	50	0	0
10	38969778	.	C	T	18	30	48	0	1	49	0	0
10	39011484	.	C	T	17	16	33	0	0	33	0	0
10	39086981	.	G	A	22	17	39	0	1	40	0	0
10	39087391	.	A	G	32	1	33	1	27	61	0	0
10	39087625	.	T	A	31	25	56	0	2	58	0	0
10	39087659	.	T	A	30	26	56	0	1	57	0	0
10	39091684	.	C	A	0	2	2	0	0	2	0	0
10	39091792	.	A	G	0	0	0	0	4	4	0	0
10	39102672	.	G	C	1	1	2	0	0	2	0	0
10	39102776	.	T	C	4	5	9	0	0	9	0	0
10	39110452	.	G	C	2	2	4	0	0	4	0	0
10	39115595	.	G	T	0	4	4	0	0	4	0	0
10	39115596	.	T	C	0	4	4	0	0	4	0	0
10	39120132	.	T	C	7	13	20	0	0	20	0	0
10	39130460	.	C	T	16	13	29	0	1	30	0	0
10	39140465	.	A	G	1	1	2	0	0	2	0	0
10	39140741	.	T	C	2	2	4	0	0	4	0	0
10	39175139	.	T	C	5	4	9	0	0	9	0	0
10	39179439	.	G	A	2	2	4	0	0	4	0	0
10	39179565	.	C	T	3	4	7	0	0	7	0	0
10	39179696	.	C	T	3	4	7	0	0	7	0	0
10	39179808	.	A	T	4	1	5	0	0	5	0	0
10	39179813	.	C	T	4	2	6	0	0	6	0	0
10	39179925	.	T	A	2	2	4	0	1	5	0	0
10	39179992	.	G	C	2	5	7	0	0	7	0	0
10	39180864	.	C	T	1	2	3	0	0	3	0	0
10	39180884	.	A	G	3	0	3	0	3	6	0	0
10	39180912	.	T	C	9	3	12	0	0	12	0	0
10	39181040	.	G	T	4	3	7	0	2	9	0	0
10	39182173	.	A	G	6	7	13	0	1	14	0	0
10	39182310	.	C	A	11	8	19	0	1	20	0	0
10	39182342	.	A	T	13	7	20	0	0	20	0	0
10	39182401	.	C	A	9	8	17	0	1	18	0	0
10	39182497	.	C	T	5	6	11	0	0	11	0	0
10	39182602	.	G	A	0	3	3	0	6	9	0	0
10	39182640	.	T	A	3	2	5	0	0	5	0	0
10	39182703	.	T	G	2	0	2	0	5	7	0	0
10	39182877	.	G	A	2	6	8	0	1	9	0	0
10	39199639	.	G	A	0	5	5	0	0	5	0	0
10	39205021	.	C	T	2	2	4	0	0	4	0	0
10	39205256	.	C	G	0	2	2	0	0	2	0	0
10	39206945	.	A	G	7	7	14	0	1	15	0	0
10	39216625	.	C	T	5	3	8	0	0	8	0	0
10	39219390	.	T	C	2	1	3	0	0	3	0	0
10	39219540	.	T	A	5	6	11	0	0	11	0	0
10	39222134	.	A	C	3	2	5	0	0	5	0	0
10	39222182	.	A	G	13	10	23	0	0	23	0	0
10	39225504	.	A	C	11	9	20	0	1	21	0	0
10	39225555	.	T	C	9	12	21	0	0	21	0	0
10	39231387	.	G	A	8	3	11	0	0	11	0	0
10	39265766	.	G	A	1	1	2	0	0	2	0	0
10	39266350	.	G	T	0	3	3	0	2	5	0	0
10	39266669	.	A	C	2	5	7	0	2	9	0	0
10	39266702	.	A	G	3	0	3	0	6	9	0	0
10	39266862	.	T	C	1	2	3	0	0	3	0	0
10	39267045	.	G	C	0	2	2	0	0	2	0	0
10	39270672	.	G	A	0	1	1	0	0	1	0	0
10	39270674	.	A	G	0	1	1	0	0	1	0	0
10	39277087	.	C	G	2	1	3	0	0	3	0	0
10	39284032	.	A	G	1	3	4	0	0	4	0	0
10	39285288	.	T	C	1	1	2	0	0	2	0	0
10	39286967	.	C	T	1	0	1	0	0	1	0	0
10	39289006	.	A	G	0	0	0	0	2	2	0	0
10	39289036	.	A	C	0	1	1	0	0	1	0	0
10	39306709	.	G	A	2	3	5	0	1	6	0	0
10	39307378	.	T	C	4	2	6	0	0	6	0	0
10	39476639	.	A	G	3	3	6	0	0	6	0	0
10	39904851	.	A	T	3	11	14	0	0	14	0	0
10	39904915	.	A	G	8	13	21	0	1	22	0	0
10	39904966	.	T	C	1	9	10	0	1	11	0	0
10	39905085	.	A	T	3	7	10	0	0	10	0	0
10	39905089	.	T	G	3	7	10	0	0	10	0	0
10	40109439	.	G	A	0	2	2	0	3	5	0	0
10	40110599	.	G	A	0	2	2	0	2	4	0	0
10	40110616	.	G	T	2	2	4	0	0	4	0	0
10	40110714	.	C	T	1	2	3	0	1	4	0	0
10	40110726	.	C	A	1	2	3	0	0	3	0	0
10	40111412	.	G	A	3	3	6	0	0	6	0	0
10	40111437	.	T	A	3	2	5	0	0	5	0	0
10	40111610	.	C	T	3	2	5	0	1	6	0	0
10	40111706	.	A	G	2	2	4	0	0	4	0	0
10	40111732	.	C	T	1	2	3	0	0	3	0	0
10	40111964	.	C	A	1	2	3	0	1	4	0	0
10	40112157	.	G	A	3	4	7	0	0	7	0	0
10	40112159	.	T	A	2	3	5	0	2	7	0	0
10	40112347	.	A	T	5	3	8	0	1	9	0	0
10	40112476	.	T	A	5	3	8	0	0	8	0	0
10	40112638	.	C	T	6	7	13	0	0	13	0	0
10	40112834	.	G	A	2	4	6	0	1	7	0	0
10	40113082	.	T	C	2	3	5	0	1	6	0	0
10	40113113	.	C	G	3	5	8	0	1	9	0	0
10	40113197	.	G	A	0	2	2	0	4	6	0	0
10	40113408	.	A	G	3	5	8	0	0	8	0	0
10	40113446	.	T	C	2	6	8	0	0	8	0	0
10	40113592	.	G	A	2	3	5	0	0	5	0	0
10	40204788	.	A	G	1	2	3	0	0	3	0	0
10	40262052	.	T	C	2	3	5	0	0	5	0	0
10	40262338	.	T	C	3	4	7	0	0	7	0	0
10	40262347	.	A	G	3	0	3	0	4	7	0	0
10	40266160	.	A	G	3	1	4	0	0	4	0	0
10	40266259	.	A	C	2	2	4	0	0	4	0	0
10	40274411	.	G	A	1	1	2	0	0	2	0	0
10	40274541	.	G	A	0	7	7	0	6	13	0	0
10	40274626	.	C	T	2	3	5	0	0	5	0	0
10	40275055	.	G	C	0	2	2	0	2	4	0	0
10	40275070	.	T	G	1	2	3	0	0	3	0	0
10	40296841	.	G	A	0	3	3	0	0	3	0	0
10	40303924	.	G	C	2	1	3	0	0	3	0	0
10	40303980	.	A	G	2	1	3	0	0	3	0	0
10	40311286	.	G	T	0	0	0	0	1	1	0	0
10	40314126	.	C	T	5	3	8	0	0	8	0	0
10	40314175	.	A	C	6	3	9	0	0	9	0	0
10	40314177	.	A	C	6	3	9	0	0	9	0	0
10	40316519	.	A	C	2	10	12	0	0	12	0	0
10	40316825	.	T	C	4	2	6	0	0	6	0	0
10	40316924	.	T	G	6	4	10	0	0	10	0	0
10	40317095	.	G	T	8	4	12	0	0	12	0	0
10	40317190	.	T	G	7	3	10	0	0	10	0	0
10	40317192	.	G	T	7	3	10	0	0	10	0	0
10	40317285	.	A	T	6	7	13	0	0	13	0	0
10	40317323	.	A	G	3	1	4	0	3	7	0	0
10	40317341	.	A	G	2	4	6	0	0	6	0	0
10	40822252	.	C	T	0	4	4	0	12	16	0	0
10	40825192	.	T	C	1	0	1	0	0	1	0	0
10	40826516	.	A	G	5	2	7	0	0	7	0	0
10	40826589	.	C	T	15	5	20	0	0	20	0	0
10	40826590	.	A	G	15	5	20	0	0	20	0	0
10	40859503	.	G	A	1	2	3	0	0	3	0	0
10	40859512	.	C	T	2	1	3	0	0	3	0	0
10	40859601	.	T	C	1	1	2	0	2	4	0	0
10	40859633	.	C	T	1	6	7	0	0	7	0	0
10	40859647	.	A	C	3	5	8	0	0	8	0	0
10	40859722	.	A	G	3	2	5	0	0	5	0	0
10	40859885	.	A	G	5	6	11	0	1	12	0	0
10	40859968	.	T	C	10	4	14	0	0	14	0	0
10	40861563	.	C	A	3	3	6	0	0	6	0	0
10	40861650	.	G	A	5	5	10	0	0	10	0	0
10	40861701	.	G	T	3	4	7	0	0	7	0	0
10	40866244	.	T	C	4	0	4	0	6	10	0	0
10	41089380	.	A	G	2	4	6	0	0	6	0	0
10	41099458	.	A	G	2	4	6	0	0	6	0	0
10	41112076	.	T	C	1	0	1	0	1	2	0	0
10	41115360	.	C	A	0	1	1	0	0	1	0	0
10	41136356	.	G	A	0	0	0	0	1	1	0	0
10	41181597	.	C	T	1	1	2	0	0	2	0	0
10	41190192	.	G	C	1	0	1	0	0	1	0	0
10	41192701	.	T	C	1	5	6	0	0	6	0	0
10	41192704	.	T	A	1	4	5	0	1	6	0	0
10	41252554	.	A	G	0	1	1	0	0	1	0	0
10	41362430	.	A	G	3	3	6	0	0	6	0	0
10	41362665	.	G	A	9	19	28	0	1	29	0	0
10	41362763	.	C	G	16	13	29	0	2	31	0	0
10	41362771	.	C	T	2	14	16	0	12	28	0	0
10	41362839	.	A	G	20	15	35	0	0	35	0	0
10	41362986	.	T	A	1	1	2	0	0	2	0	0
10	41379918	.	G	C	9	4	13	0	4	17	0	0
10	41397380	.	G	T	5	5	10	0	0	10	0	0
10	41397404	.	G	A	7	7	14	0	0	14	0	0
10	41397443	.	G	A	5	8	13	0	0	13	0	0
10	41397533	.	A	G	9	3	12	0	1	13	0	0
10	41397712	.	A	G	5	2	7	0	1	8	0	0
10	41399919	.	G	A	3	4	7	0	0	7	0	0
10	41399968	.	G	T	10	6	16	0	0	16	0	0
10	41409578	.	T	A	2	4	6	0	0	6	0	0
10	41409684	.	T	A	2	2	4	0	0	5	1	0
10	41409781	.	C	T	4	6	10	0	0	10	0	0
10	41607449	.	A	G	0	0	0	0	2	2	0	0
10	41607455	.	C	A	2	0	2	0	0	2	0	0
10	41607787	.	A	C	2	2	4	0	0	4	0	0
10	41607903	.	C	A	2	1	3	0	1	4	0	0
10	41607966	.	T	C	3	3	6	0	0	6	0	0
10	41608373	.	T	A	1	3	4	0	0	4	0	0
10	41608374	.	T	A	1	3	4	0	0	4	0	0
10	41608513	.	A	G	3	0	3	0	6	9	0	0
10	41608561	.	A	T	1	7	8	0	0	8	0	0
10	41608600	.	C	A	1	4	5	0	0	5	0	0
10	41765973	.	C	T	0	6	6	0	1	7	0	0
10	41766022	.	A	G	1	0	1	0	3	4	0	0
10	41801475	.	C	T	1	0	1	0	0	1	0	0
10	41801721	.	G	A	0	2	2	0	0	2	0	0
10	41816988	.	C	T	0	2	2	0	0	2	0	0
10	41816991	.	G	A	0	2	2	0	0	2	0	0
10	41817054	.	T	C	1	2	3	0	0	3	0	0
10	41817094	.	C	A	2	3	5	0	0	5	0	0
10	41830403	.	G	A	10	14	24	0	3	27	0	0
10	41830435	.	C	T	13	13	26	0	2	28	0	0
10	41832092	.	C	A	13	8	21	0	0	21	0	0
10	41834276	.	G	T	5	4	9	0	1	11	1	0
10	41834300	.	C	T	1	2	3	0	0	3	0	0
10	41835199	.	C	T	2	9	11	0	0	11	0	0
10	41835283	.	G	T	2	5	7	0	0	7	0	0
10	41841119	.	G	A	6	5	11	0	1	12	0	0
10	41841178	.	G	T	10	13	23	0	0	23	0	0
10	41841214	.	G	C	9	9	18	0	0	18	0	0
10	41846770	.	A	G	4	4	8	0	0	8	0	0
10	41865722	.	G	A	2	4	6	0	0	6	0	0
10	41902778	.	A	C	0	1	1	0	1	2	0	0
10	41920720	.	A	G	1	2	3	0	0	3	0	0
10	41933320	.	T	A	3	2	5	0	0	5	0	0
10	41959448	.	A	G	1	4	5	0	0	5	0	0
10	41969538	.	C	T	1	2	3	0	0	3	0	0
10	41983482	.	A	C	2	3	5	0	1	6	0	0
10	41984251	.	G	A	3	1	4	0	1	5	0	0
10	41984544	.	C	G	2	2	4	0	0	4	0	0
10	41984966	.	G	A	2	2	4	0	0	4	0	0
10	41995506	.	G	C	1	2	3	0	0	3	0	0
10	41995555	.	C	T	2	2	4	0	0	4	0	0
10	41995678	.	A	G	1	2	3	0	1	4	0	0
10	41996086	.	G	A	1	2	3	0	0	3	0	0
10	42002429	.	G	A	0	3	3	0	1	4	0	0
10	42007836	.	G	T	1	0	1	0	0	1	0	0
10	42010915	.	C	G	2	2	4	0	0	4	0	0
10	42011054	.	T	C	3	2	5	0	0	5	0	0
10	42011060	.	G	T	3	4	7	0	0	7	0	0
10	42011128	.	T	C	3	3	6	0	0	6	0	0
10	42017620	.	C	T	1	4	5	0	1	6	0	0
10	42017854	.	C	T	7	6	13	0	0	13	0	0
10	42019966	.	A	C	4	3	7	0	2	9	0	0
10	42020451	.	C	T	4	2	6	0	0	6	0	0
10	42020565	.	C	T	7	8	15	0	0	15	0	0
10	42020592	.	G	T	9	7	16	0	0	16	0	0
10	42021273	.	A	C	3	3	6	0	0	6	0	0
10	42021292	.	A	T	3	5	8	0	0	8	0	0
10	42021321	.	G	A	3	2	5	0	1	6	0	0
10	42021384	.	T	C	3	11	14	0	0	14	0	0
10	42021485	.	A	T	4	6	10	0	2	12	0	0
10	42021515	.	T	A	6	3	9	0	0	9	0	0
10	42021543	.	T	C	5	3	8	0	0	8	0	0
10	42021611	.	C	A	4	6	10	0	0	10	0	0
10	42022425	.	A	G	4	0	4	0	3	7	0	0
10	42030956	.	C	T	4	3	7	0	0	7	0	0
10	42044409	.	A	G	14	17	31	0	1	32	0	0
10	42044480	.	G	A	20	15	35	0	1	36	0	0
10	42044859	.	G	A	13	16	29	0	0	29	0	0
10	42045041	.	G	C	17	14	31	0	2	33	0	0
10	42045254	.	C	T	1	6	7	0	13	20	0	0
10	42045300	.	G	C	13	6	19	0	0	19	0	0
10	42045370	.	G	A	7	13	20	0	0	20	0	0
10	42045578	.	C	T	2	6	8	0	1	9	0	0
10	42045922	.	T	C	2	5	7	0	0	7	0	0
10	42089945	.	T	C	2	0	2	0	3	5	0	0
10	42090214	.	A	G	9	12	21	0	4	25	0	0
10	42090222	.	A	G	12	13	25	0	3	28	0	0
10	42090315	.	T	C	11	17	28	0	0	28	0	0
10	42093928	.	A	G	2	2	4	0	0	4	0	0
10	42101122	.	A	G	1	5	6	0	0	6	0	0
10	42104371	.	C	T	0	6	6	0	7	13	0	0
10	42105921	.	C	T	3	5	8	0	0	8	0	0
10	42107884	.	C	T	0	2	2	0	1	3	0	0
10	42108077	.	T	A	2	7	9	0	0	9	0	0
10	42111601	.	G	A	8	7	15	0	0	15	0	0
10	42111610	.	A	T	7	7	14	0	0	14	0	0
10	42111669	.	C	A	14	3	17	0	1	18	0	0
10	42111673	.	G	A	14	4	18	0	0	18	0	0
10	42111883	.	C	T	0	2	2	0	8	10	0	0
10	42111895	.	G	A	2	7	9	0	1	10	0	0
10	42111955	.	G	A	1	3	4	0	0	4	0	0
10	42112227	.	G	T	11	6	17	0	2	19	0	0
10	42114366	.	G	A	3	1	4	0	0	4	0	0
10	42119810	.	C	T	4	3	7	0	0	7	0	0
10	42119816	.	A	G	2	4	6	0	0	6	0	0
10	42123334	.	T	C	0	0	0	0	2	2	0	0
10	42123388	.	A	G	1	4	5	0	0	5	0	0
10	42125549	.	C	T	3	2	5	0	0	5	0	0
10	42131297	.	A	T	5	4	9	0	1	10	0	0
10	42134447	.	C	G	4	3	7	0	1	8	0	0
10	42134574	.	A	G	7	4	11	0	0	11	0	0
10	42134962	.	C	T	1	2	3	0	1	4	0	0
10	42136374	.	T	C	3	2	5	0	0	5	0	0
10	42136526	.	A	C	1	0	1	0	4	5	0	0
10	42136645	.	C	T	0	3	3	0	1	4	0	0
10	42136663	.	T	C	1	0	1	0	3	4	0	0
10	42137050	.	G	C	1	2	3	0	1	4	0	0
10	42137161	.	G	T	5	2	7	0	0	7	0	0
10	42137895	.	A	G	3	2	5	0	0	5	0	0
10	42138221	.	C	T	0	2	2	0	1	3	0	0
10	42140199	.	G	A	1	2	3	0	0	3	0	0
10	42196374	.	C	T	0	3	3	0	6	9	0	0
10	42196404	.	T	C	9	0	9	0	6	15	0	0
10	42196524	.	A	G	5	7	12	0	1	13	0	0
10	42378334	.	A	T	42	30	72	0	1	74	1	0
10	42501067	.	A	G	10	8	18	0	1	19	0	0
10	42501175	.	T	A	3	9	12	0	0	12	0	0
10	42501365	.	A	G	16	14	30	0	0	30	0	0
10	42505845	.	T	C	6	4	10	0	0	10	0	0
10	42507081	.	T	C	1	4	5	0	0	5	0	0
10	42507120	.	T	C	9	7	16	0	0	16	0	0
10	42507141	.	A	G	10	7	17	0	0	17	0	0
10	42519641	.	C	T	6	2	8	0	0	8	0	0
10	42522016	.	T	C	5	8	13	0	0	13	0	0
10	42526213	.	C	T	7	6	13	0	0	13	0	0
10	42531713	.	C	T	6	11	17	0	1	18	0	0
10	42539630	.	C	T	31	27	58	0	1	59	0	0
10	42539849	.	C	T	26	21	47	0	1	48	0	0
10	42539955	.	T	C	23	12	35	0	1	36	0	0
10	42540132	.	A	T	15	16	31	0	3	34	0	0
10	42540172	.	A	C	16	13	29	0	1	30	0	0
10	42540726	.	A	G	10	3	13	0	0	13	0	0
10	42542568	.	A	C	3	3	6	0	0	6	0	0
10	42542660	.	A	C	1	0	1	0	1	2	0	0
10	42548171	.	T	G	3	0	3	0	2	5	0	0
10	42548210	.	A	T	2	2	4	0	1	5	0	0
10	42548213	.	A	G	2	0	2	0	2	4	0	0
10	42549515	.	A	G	1	0	1	0	5	6	0	0
10	42550828	.	C	T	3	2	5	0	0	5	0	0
10	42555728	.	G	A	0	5	5	0	7	12	0	0
10	42555732	.	G	T	5	8	13	0	1	14	0	0
10	42555764	.	C	A	5	5	10	0	2	12	0	0
10	42700932	.	C	T	6	5	11	0	0	11	0	0
10	42701129	.	A	G	3	0	3	0	9	12	0	0
10	42701216	.	C	T	4	2	6	0	0	6	0	0
10	42704848	.	T	C	4	7	11	0	0	11	0	0
10	42704929	.	C	T	7	4	11	0	0	11	0	0
10	42708132	.	C	T	2	2	4	0	0	4	0	0
10	42709634	.	T	C	5	1	6	0	0	6	0	0
10	42716271	.	T	C	5	3	8	0	0	8	0	0
10	42716278	.	T	G	5	0	5	0	3	8	0	0
10	42738132	.	T	A	3	6	9	0	0	9	0	0
10	42738324	.	G	A	1	4	5	0	0	5	0	0
10	42739938	.	C	T	2	9	11	0	0	11	0	0
10	42740302	.	T	A	14	9	23	0	2	25	0	0
10	42741347	.	T	G	15	19	34	0	10	44	0	0
10	42741417	.	T	A	27	14	41	0	1	42	0	0
10	42741519	.	G	T	29	21	50	0	0	50	0	0
10	42741528	.	G	T	20	24	44	0	4	48	0	0
10	42741661	.	C	A	13	12	25	0	6	31	0	0
10	42741662	.	G	A	13	13	26	0	4	31	1	0
10	42741840	.	T	A	18	21	39	0	4	43	0	0
10	42741872	.	A	G	11	23	34	0	2	36	0	0
10	42741918	.	C	T	29	5	34	0	1	35	0	0
10	42741938	.	A	C	10	0	10	0	28	38	0	0
10	42742318	.	T	A	7	3	10	0	1	11	0	0
10	42742319	.	A	T	4	6	10	0	1	11	0	0
10	42742472	.	C	G	13	12	25	0	2	27	0	0
10	42742511	.	G	A	12	8	20	0	0	20	0	0
10	42742544	.	T	C	9	14	23	0	1	24	0	0
10	42742560	.	T	C	21	11	32	0	0	32	0	0
10	42742744	.	C	A	3	6	9	0	0	9	0	0
10	42742760	.	T	C	3	3	6	0	0	6	0	0
10	42742835	.	C	T	7	2	9	0	0	9	0	0
10	42742851	.	G	A	6	0	6	0	0	6	0	0
10	42743337	.	C	T	0	3	3	0	0	3	0	0
10	42743666	.	G	T	6	3	9	0	0	9	0	0
10	42744720	.	G	C	5	7	12	0	0	12	0	0
10	42744923	.	T	C	7	5	12	0	0	12	0	0
10	42745003	.	A	G	8	3	11	0	0	11	0	0
10	42745018	.	T	A	3	6	9	0	0	9	0	0
10	42745151	.	C	T	9	9	18	0	0	18	0	0
10	42748084	.	A	T	14	5	19	0	0	19	0	0
10	42748096	.	A	G	14	5	19	0	0	19	0	0
10	42748120	.	A	G	12	5	17	0	0	17	0	0
10	42775877	.	A	C	1	0	1	0	0	1	0	0
10	42775891	.	C	A	1	0	1	0	0	1	0	0
10	42880688	.	C	T	1	1	2	0	0	2	0	0
10	42880694	.	T	A	1	1	2	0	0	2	0	0
10	42903629	.	G	A	1	2	3	0	0	3	0	0
10	42930776	.	T	C	11	1	12	0	3	15	0	0
10	42930781	.	T	C	7	0	7	0	9	16	0	0
10	42930828	.	T	C	8	7	15	0	0	15	0	0
10	42930933	.	T	C	3	5	8	0	0	8	0	0
10	42931315	.	T	A	1	10	11	0	2	13	0	0
10	42935346	.	C	T	0	1	1	0	0	1	0	0
10	42992877	.	T	C	1	0	1	0	0	1	0	0
10	43044188	.	G	T	3	1	4	0	0	4	0	0
10	43044206	.	T	C	3	2	5	0	0	5	0	0
10	43047740	.	T	G	0	1	1	0	1	2	0	0
10	43057697	.	C	T	2	0	2	0	0	2	0	0
10	43073044	.	C	T	1	6	7	0	0	7	0	0
10	43126994	.	T	C	4	2	6	0	0	6	0	0
10	43157401	.	C	G	1	4	5	0	0	5	0	0
10	43157426	.	C	A	1	0	1	0	0	1	0	0
10	43183798	.	A	T	4	3	7	0	0	7	0	0
10	43183818	.	T	C	2	2	4	0	0	4	0	0
10	43231139	.	G	A	0	3	3	0	0	3	0	0
10	43231279	.	A	G	1	0	1	0	3	4	0	0
10	43231317	.	C	A	1	1	2	0	1	3	0	0
10	43231345	.	T	C	1	2	3	0	0	3	0	0
10	43231887	.	C	T	1	3	4	0	0	4	0	0
10	43231919	.	G	A	1	4	5	0	1	6	0	0
10	43232272	.	C	T	4	3	7	0	0	7	0	0
10	43270445	.	G	A	2	7	9	0	1	10	0	0
10	43372493	.	G	A	2	4	6	0	2	8	0	0
10	43375407	.	T	A	3	1	4	0	0	4	0	0
10	43375468	.	G	A	2	4	6	0	0	6	0	0
10	43450100	.	C	T	1	3	4	0	0	4	0	0
10	43450110	.	A	G	1	3	4	0	0	4	0	0
10	43450144	.	C	T	1	4	5	0	0	6	1	0
10	43450145	.	T	C	2	4	6	0	0	6	0	0
10	43499917	.	G	T	1	2	3	0	0	3	0	0
10	43545434	.	G	C	5	12	17	0	0	17	0	0
10	43545446	.	T	A	13	4	17	0	1	18	0	0
10	43545577	.	C	A	0	7	7	0	4	11	0	0
10	43546715	.	G	A	2	2	4	0	0	4	0	0
10	43547190	.	A	G	2	4	6	0	0	6	0	0
10	43547820	.	A	T	0	2	2	0	2	4	0	0
10	43547905	.	G	A	1	3	4	0	1	5	0	0
10	43547937	.	A	G	3	2	5	0	0	5	0	0
10	43548087	.	T	A	4	0	4	0	1	5	0	0
10	43548088	.	T	C	5	0	5	0	0	5	0	0
10	43548194	.	C	A	2	5	7	0	1	8	0	0
10	43548195	.	C	A	2	5	7	0	1	8	0	0
10	43548344	.	T	C	2	3	5	0	0	5	0	0
10	43548352	.	C	T	2	3	5	0	0	5	0	0
10	43548488	.	A	T	1	4	5	0	1	6	0	0
10	43548745	.	T	C	2	3	5	0	0	5	0	0
10	43558079	.	G	T	1	0	1	0	0	1	0	0
10	43999448	.	G	A	5	3	8	0	0	8	0	0
10	43999511	.	T	C	4	5	9	0	1	10	0	0
10	43999628	.	T	C	3	5	8	0	0	8	0	0
10	43999640	.	G	T	5	2	7	0	0	7	0	0
10	43999718	.	T	A	1	1	2	0	0	2	0	0
10	44002836	.	G	A	1	4	5	0	1	6	0	0
10	44047141	.	T	C	1	2	3	0	0	3	0	0
10	44146313	.	C	T	1	1	2	0	0	2	0	0
10	44180299	.	C	T	11	11	22	0	2	24	0	0
10	44189322	.	G	A	5	7	12	0	2	14	0	0
10	44303571	.	T	G	6	9	15	0	2	17	0	0
10	44314569	.	C	T	0	1	1	0	0	1	0	0
10	44314579	.	A	G	1	0	1	0	0	1	0	0
10	44320823	.	G	C	3	4	7	0	1	8	0	0
10	44337652	.	G	T	1	3	4	0	0	4	0	0
10	44345005	.	C	T	0	0	0	0	6	6	0	0
10	44348351	.	G	A	2	2	4	0	0	4	0	0
10	44354053	.	G	C	1	3	4	0	1	5	0	0
10	44363242	.	G	T	10	8	18	0	1	19	0	0
10	44364604	.	A	T	0	1	1	0	0	1	0	0
10	44371710	.	G	T	0	11	11	0	7	18	0	0
10	44375785	.	G	A	0	4	4	0	1	5	0	0
10	44377942	.	G	C	2	15	17	0	0	17	0	0
10	44377991	.	C	T	0	6	6	0	0	6	0	0
10	44410082	.	C	T	9	3	12	0	0	12	0	0
10	44410088	.	G	A	4	9	13	0	0	13	0	0
10	44437145	.	T	C	2	9	11	0	1	12	0	0
10	44465477	.	C	T	0	0	0	0	1	1	0	0
10	44466844	.	G	A	4	4	8	0	0	8	0	0
10	44503882	.	G	A	8	8	16	0	0	16	0	0
10	44513232	.	T	C	1	8	9	0	0	9	0	0
10	44513307	.	T	C	1	5	6	0	0	6	0	0
10	44513402	.	T	C	7	1	8	0	10	18	0	0
10	44513421	.	C	T	0	13	13	0	5	18	0	0
10	44515911	.	G	C	5	4	9	0	1	10	0	0
10	44515927	.	T	C	3	3	6	0	2	8	0	0
10	44516001	.	C	T	0	3	3	0	3	6	0	0
10	44516535	.	A	T	1	3	4	0	0	4	0	0
10	44516559	.	T	C	2	0	2	0	4	6	0	0
10	44517170	.	C	T	0	0	0	0	2	2	0	0
10	44581983	.	C	G	2	0	2	0	0	2	0	0
10	44640688	.	A	C	2	7	9	0	0	9	0	0
10	44640700	.	C	T	2	8	10	0	0	10	0	0
10	44640725	.	C	A	9	4	13	0	0	13	0	0
10	44640742	.	G	A	1	5	6	0	9	15	0	0
10	44640832	.	G	A	4	2	6	0	0	6	0	0
10	44640873	.	G	A	1	2	3	0	0	3	0	0
10	44648115	.	G	T	0	2	2	0	0	2	0	0
10	44648627	.	C	T	1	0	1	0	0	1	0	0
10	44650913	.	G	A	0	3	3	0	8	11	0	0
10	44652561	.	G	A	0	0	0	0	1	1	0	0
10	44656821	.	C	G	4	1	5	0	0	5	0	0
10	44656863	.	C	T	8	7	15	0	0	15	0	0
10	44656926	.	C	T	1	0	1	0	1	2	0	0
10	44659668	.	A	G	4	4	8	0	0	8	0	0
10	44663082	.	A	G	12	6	18	0	1	19	0	0
10	44665345	.	G	T	0	2	2	0	8	10	0	0
10	44665536	.	A	T	10	8	18	0	1	19	0	0
10	44665620	.	C	T	4	4	8	0	0	8	0	0
10	44667125	.	T	C	2	3	5	0	1	6	0	0
10	44669263	.	G	A	3	2	5	1	1	7	0	0
10	44669497	.	A	G	8	5	13	0	2	15	0	0
10	44670437	.	A	G	13	8	21	1	1	23	0	0
10	44671484	.	A	G	2	0	2	4	18	24	0	0
10	44671799	.	G	A	0	14	14	0	23	37	0	0
10	44671818	.	A	C	14	15	29	0	3	32	0	0
10	44672036	.	T	A	26	19	45	0	2	47	0	0
10	44672228	.	G	A	10	7	17	0	3	20	0	0
10	44693523	.	T	G	29	0	29	0	16	45	0	0
10	44693556	.	C	T	14	12	26	0	6	32	0	0
10	44693769	.	C	T	14	11	25	0	4	29	0	0
10	44693799	.	T	C	13	8	21	0	3	24	0	0
10	44694162	.	T	C	0	1	1	1	0	2	0	0
10	44694354	.	G	A	0	16	16	0	2	18	0	0
10	44718644	.	T	C	0	2	2	0	0	2	0	0
10	44718649	.	A	T	0	2	2	0	0	2	0	0
10	44738221	.	G	A	0	4	4	0	1	5	0	0
10	44738290	.	C	T	3	3	6	0	0	6	0	0
10	44745648	.	T	G	2	1	3	0	0	3	0	0
10	44745730	.	A	G	5	0	5	0	3	8	0	0
10	44745774	.	A	T	3	3	6	0	0	6	0	0
10	44900254	.	G	A	1	3	4	0	0	4	0	0
10	44900856	.	C	T	3	2	5	0	0	5	0	0
10	44900901	.	T	G	5	2	7	0	0	7	0	0
10	44905224	.	A	G	1	1	2	0	0	2	0	0
10	44914623	.	A	G	13	0	13	0	13	26	0	0
10	44914685	.	G	T	5	9	14	0	0	14	0	0
10	44914761	.	T	A	6	10	16	0	0	16	0	0
10	44979593	.	A	T	2	4	6	0	0	6	0	0
10	44979767	.	A	G	4	5	9	0	0	9	0	0
10	44979792	.	T	C	6	3	9	0	0	9	0	0
10	44980379	.	T	C	3	3	6	0	0	6	0	0
10	44980391	.	C	T	3	6	9	0	0	9	0	0
10	44980913	.	C	T	1	2	3	0	2	5	0	0
10	44989378	.	C	T	5	0	5	0	0	5	0	0
10	44989384	.	T	C	6	3	9	0	0	9	0	0
10	44990917	.	C	T	6	10	16	0	1	17	0	0
10	45055879	.	G	A	3	10	13	0	1	14	0	0
10	45055948	.	G	A	1	0	1	0	0	1	0	0
10	45059822	.	C	T	3	3	6	0	0	6	0	0
10	45064957	.	C	T	17	9	26	0	0	26	0	0
10	45069978	.	A	C	12	6	18	0	0	18	0	0
10	45099498	.	T	C	2	3	5	0	0	5	0	0
10	45099522	.	T	C	2	2	4	0	0	4	0	0
10	45101543	.	G	A	0	1	1	0	0	1	0	0
10	45105244	.	T	C	0	2	2	0	0	2	0	0
10	45187450	.	T	C	2	3	5	0	0	5	0	0
10	45190629	.	C	T	1	1	2	0	0	2	0	0
10	45203109	.	T	C	2	4	6	0	0	6	0	0
10	45203154	.	A	G	7	6	13	0	2	15	0	0
10	45203271	.	T	A	2	6	8	0	0	8	0	0
10	45203419	.	A	T	2	2	4	0	1	5	0	0
10	45203434	.	A	G	5	0	5	0	2	7	0	0
10	45203513	.	A	G	1	3	4	0	1	5	0	0
10	45203700	.	A	C	2	2	4	0	1	5	0	0
10	45203704	.	T	G	3	2	5	0	0	5	0	0
10	45203793	.	G	A	0	2	2	0	4	6	0	0
10	45203856	.	G	A	8	6	14	0	0	14	0	0
10	45203882	.	A	G	11	3	14	0	0	14	0	0
10	45204151	.	A	G	2	2	4	0	0	4	0	0
10	45204185	.	T	C	4	2	6	0	0	6	0	0
10	45204218	.	A	G	2	0	2	0	3	5	0	0
10	45204527	.	A	G	1	5	6	0	0	6	0	0
10	45204568	.	G	T	4	3	7	0	0	7	0	0
10	45204611	.	A	G	5	1	6	0	0	6	0	0
10	45204621	.	T	C	4	3	7	0	0	7	0	0
10	45205059	.	A	G	2	5	7	0	1	8	0	0
10	45205166	.	A	C	6	5	11	1	1	13	0	0
10	45205175	.	A	G	5	1	6	1	5	12	0	0
10	45205226	.	A	G	8	0	8	0	5	13	0	0
10	45205237	.	C	G	8	0	8	0	8	16	0	0
10	45205284	.	A	C	8	8	16	0	0	16	0	0
10	45205295	.	A	G	8	0	8	0	10	18	0	0
10	45205400	.	C	A	3	8	11	0	0	11	0	0
10	45205506	.	A	C	3	7	10	0	0	10	0	0
10	45205518	.	T	G	3	8	11	0	1	12	0	0
10	45205757	.	C	A	3	7	10	0	0	10	0	0
10	45205758	.	A	G	3	7	10	0	0	10	0	0
10	45206103	.	C	G	5	6	11	0	0	14	3	0
10	45206289	.	G	C	9	0	9	0	8	17	0	0
10	45206326	.	G	T	9	5	14	0	0	14	0	0
10	45206450	.	T	C	12	0	12	0	19	31	0	0
10	45206478	.	G	T	23	5	28	0	0	28	0	0
10	45208153	.	A	G	4	5	9	0	0	9	0	0
10	45208667	.	C	T	0	1	1	0	3	4	0	0
10	45208875	.	G	A	4	8	12	0	0	12	0	0
10	45208899	.	C	A	3	5	8	0	0	8	0	0
10	45213798	.	C	T	0	3	3	0	1	4	0	0
10	45215720	.	C	T	0	1	1	0	0	1	0	0
10	45222613	.	T	C	1	0	1	0	1	2	0	0
10	45248527	.	A	C	3	2	5	0	0	5	0	0
10	45248548	.	T	A	2	4	6	0	0	6	0	0
10	45248638	.	G	A	1	3	4	0	0	4	0	0
10	45322668	.	A	G	5	0	5	0	5	10	0	0
10	45325302	.	G	A	0	3	3	0	3	6	0	0
10	45334688	.	C	T	5	1	6	0	0	6	0	0
10	45336565	.	T	C	6	13	19	0	0	19	0	0
10	45340105	.	G	T	0	8	8	0	6	14	0	0
10	45340835	.	G	C	4	7	11	0	0	11	0	0
10	45340930	.	G	T	5	4	9	0	0	9	0	0
10	45341210	.	T	A	3	4	7	0	0	7	0	0
10	45341403	.	A	G	1	5	6	0	0	6	0	0
10	45341410	.	A	G	1	0	1	0	6	7	0	0
10	45341452	.	T	G	1	4	5	0	0	5	0	0
10	45341537	.	A	C	6	9	15	0	0	16	1	0
10	45341546	.	A	C	6	10	16	0	0	16	0	0
10	45341572	.	G	C	0	8	8	0	11	19	0	0
10	45341596	.	C	T	9	6	15	0	2	17	0	0
10	45341762	.	A	T	4	6	10	0	0	10	0	0
10	45349924	.	G	A	6	14	20	0	0	20	0	0
10	45351037	.	C	T	9	7	16	0	0	16	0	0
10	45352231	.	C	T	22	20	42	0	2	44	0	0
10	45375714	.	G	T	5	0	5	0	0	5	0	0
10	45375732	.	C	T	1	0	1	0	0	1	0	0
11	126334	.	G	A	5	6	11	0	0	11	0	0
11	126595	.	A	T	6	7	13	0	0	13	0	0
11	127139	.	G	A	0	5	5	0	0	5	0	0
11	185396	.	C	T	0	5	5	0	6	11	0	0
11	185624	.	T	A	6	25	31	0	3	34	0	0
11	185678	.	G	A	6	22	28	0	0	28	0	0
11	185775	.	C	T	0	18	18	0	18	36	0	0
11	185890	.	A	G	17	21	38	0	1	39	0	0
11	185902	.	A	G	17	19	36	0	0	36	0	0
11	186235	.	G	A	11	9	20	0	0	20	0	0
11	186526	.	A	T	3	6	9	0	0	9	0	0
11	186745	.	G	T	12	15	27	0	0	27	0	0
11	186798	.	T	G	5	16	21	0	0	21	0	0
11	186939	.	A	G	11	25	36	0	0	36	0	0
11	187022	.	C	A	12	18	30	0	2	32	0	0
11	187104	.	T	A	14	23	37	0	1	38	0	0
11	187399	.	A	C	3	6	9	0	0	9	0	0
11	221929	.	T	C	20	0	20	0	17	37	0	0
11	222488	.	C	G	11	7	18	0	0	18	0	0
11	222722	.	C	T	0	5	5	0	12	17	0	0
11	222729	.	C	T	0	5	5	0	11	16	0	0
11	222776	.	C	T	10	10	20	0	1	21	0	0
11	222787	.	A	G	10	10	20	0	0	20	0	0
11	223101	.	G	A	8	8	16	0	0	16	0	0
11	223319	.	G	A	10	4	14	0	2	16	0	0
11	223806	.	A	G	12	12	24	0	0	24	0	0
11	233672	.	A	T	17	6	23	0	2	26	1	0
11	233674	.	G	A	18	6	24	0	2	26	0	0
11	236437	.	C	T	5	7	12	0	1	13	0	0
11	236515	.	T	C	4	6	10	0	1	11	0	0
11	236551	.	G	A	3	7	10	0	0	10	0	0
11	236602	.	A	C	4	1	5	0	6	11	0	0
11	260909	.	G	A	12	3	15	0	1	16	0	0
11	265097	.	T	G	4	2	6	0	0	6	0	0
11	265404	.	G	A	12	8	20	0	0	20	0	0
11	265497	.	C	T	0	12	12	0	13	25	0	0
11	265506	.	G	C	13	11	24	0	1	25	0	0
11	268887	.	G	A	2	2	4	0	0	4	0	0
11	270090	.	A	G	8	7	15	0	2	17	0	0
11	281887	.	A	T	3	2	5	0	0	5	0	0
11	281961	.	A	G	3	3	6	0	0	6	0	0
11	282193	.	T	G	9	7	16	0	1	17	0	0
11	282279	.	A	T	9	9	18	0	0	18	0	0
11	282546	.	G	T	10	6	16	0	0	16	0	0
11	282553	.	A	G	10	6	16	0	1	17	0	0
11	282602	.	T	G	10	7	17	0	1	18	0	0
11	283164	.	G	C	2	2	4	0	0	4	0	0
11	284424	.	G	T	3	2	5	0	1	6	0	0
11	296453	.	T	A	5	3	8	0	0	8	0	0
11	304015	.	C	T	3	4	7	0	0	7	0	0
11	322076	.	G	A	0	5	5	0	3	8	0	0
11	339669	.	A	T	1	1	2	0	0	3	1	0
11	339678	.	G	T	1	3	4	0	0	4	0	0
11	360062	.	A	G	0	2	2	0	1	3	0	0
11	539573	.	A	C	3	11	14	0	1	15	0	0
11	675382	.	G	C	39	15	54	0	3	57	0	0
11	676856	.	T	C	26	10	36	0	3	39	0	0
11	677100	.	A	G	12	11	23	0	2	25	0	0
11	677264	.	T	C	22	30	52	0	5	57	0	0
11	677341	.	T	C	15	20	35	0	2	37	0	0
11	682905	.	C	T	9	7	16	0	2	18	0	0
11	682926	.	A	G	15	15	30	0	0	30	0	0
11	682943	.	G	A	16	20	36	0	0	36	0	0
11	687501	.	G	A	10	2	12	0	0	12	0	0
11	718214	.	G	A	10	5	15	0	0	15	0	0
11	718404	.	A	C	4	6	10	0	0	10	0	0
11	718454	.	A	G	2	5	7	0	0	7	0	0
11	762445	.	A	G	11	7	18	0	1	19	0	0
11	779785	.	C	A	5	6	11	0	0	11	0	0
11	779863	.	T	A	2	3	5	0	0	5	0	0
11	781714	.	G	A	0	1	1	0	0	1	0	0
11	813851	.	T	C	5	1	6	0	8	14	0	0
11	997885	.	T	G	17	5	22	1	33	56	0	0
11	1083008	.	G	A	0	3	3	0	0	3	0	0
11	1083017	.	T	A	0	3	3	0	0	3	0	0
11	1148869	.	G	A	18	19	37	0	3	40	0	0
11	1148889	.	G	A	15	21	36	0	2	38	0	0
11	1149105	.	C	T	24	22	46	0	1	47	0	0
11	1149593	.	A	G	34	16	50	1	1	52	0	0
11	1149812	.	C	T	3	26	29	0	34	63	0	0
11	1163295	.	C	T	33	19	52	0	1	53	0	0
11	1165993	.	G	A	5	4	9	0	1	10	0	0
11	1166326	.	G	C	27	0	27	0	17	44	0	0
11	1177389	.	C	A	0	2	2	0	1	3	0	0
11	1183007	.	G	A	4	3	7	0	0	7	0	0
11	1183602	.	C	T	0	5	5	0	9	14	0	0
11	1183739	.	G	T	10	15	25	0	1	26	0	0
11	1198390	.	G	C	7	8	15	0	0	15	0	0
11	1198419	.	G	A	17	7	24	0	4	28	0	0
11	1198450	.	G	A	13	21	34	0	3	37	0	0
11	1198507	.	G	T	25	17	42	0	2	44	0	0
11	1203619	.	G	A	7	11	18	0	0	18	0	0
11	1221865	.	A	G	12	9	21	0	1	22	0	0
11	1222025	.	T	G	7	9	16	0	1	17	0	0
11	1339419	.	C	T	0	1	1	0	1	2	0	0
11	1341402	.	C	T	0	2	2	0	1	3	0	0
11	1342778	.	G	A	1	4	5	0	0	5	0	0
11	1342826	.	A	G	5	10	15	0	0	15	0	0
11	1348596	.	A	G	1	1	2	0	1	3	0	0
11	1348821	.	A	C	4	2	6	0	0	6	0	0
11	1351542	.	C	T	0	3	3	0	7	10	0	0
11	1351563	.	T	G	9	3	12	0	1	13	0	0
11	1365078	.	T	C	0	3	3	0	0	3	0	0
11	1396343	.	T	C	18	16	34	0	0	34	0	0
11	1403797	.	T	C	7	1	8	0	6	14	0	0
11	1403821	.	A	C	6	5	11	0	0	11	0	0
11	1403921	.	A	C	3	2	5	0	0	5	0	0
11	1403969	.	G	A	2	3	5	0	0	5	0	0
11	1404031	.	A	C	4	5	9	0	0	9	0	0
11	1404165	.	C	T	1	6	7	0	0	7	0	0
11	1404481	.	C	A	4	2	6	0	1	7	0	0
11	1404640	.	T	C	2	0	2	0	5	7	0	0
11	1404642	.	A	G	2	5	7	0	0	7	0	0
11	1406012	.	T	C	2	3	5	0	0	5	0	0
11	1427981	.	T	C	3	0	3	0	0	3	0	0
11	1435736	.	A	G	5	4	9	0	1	10	0	0
11	1467114	.	T	C	7	0	7	0	5	12	0	0
11	1467130	.	C	A	0	5	5	0	6	11	0	0
11	1469842	.	C	T	5	11	16	0	1	17	0	0
11	1469859	.	A	G	4	14	18	0	1	19	0	0
11	1469895	.	A	G	7	11	18	0	2	20	0	0
11	1470503	.	G	A	6	13	19	0	1	20	0	0
11	1470535	.	G	C	2	6	8	0	1	9	0	0
11	1470574	.	T	C	1	0	1	0	0	1	0	0
11	1474629	.	C	T	3	3	6	0	0	6	0	0
11	1512626	.	A	G	1	3	4	0	0	4	0	0
11	1512660	.	A	T	2	4	6	0	0	6	0	0
11	1512684	.	A	T	1	2	3	0	0	3	0	0
11	1514825	.	C	T	3	1	4	0	0	4	0	0
11	1514868	.	T	C	2	5	7	0	1	8	0	0
11	1516755	.	T	G	1	0	1	0	0	1	0	0
11	1517289	.	C	A	4	3	7	0	0	7	0	0
11	1520512	.	A	G	1	2	3	0	0	3	0	0
11	1520797	.	A	G	1	4	5	0	0	5	0	0
11	1520815	.	T	C	2	2	4	0	1	5	0	0
11	1522194	.	C	G	14	0	14	0	21	35	0	0
11	1522205	.	G	T	15	22	37	0	0	37	0	0
11	1522291	.	T	C	9	6	15	0	0	15	0	0
11	1523846	.	T	C	2	1	3	0	0	3	0	0
11	1524043	.	G	A	7	3	10	0	2	12	0	0
11	1524108	.	C	T	7	4	11	0	0	11	0	0
11	1525081	.	G	C	9	7	16	0	0	16	0	0
11	1525389	.	G	T	4	6	10	0	1	11	0	0
11	1525416	.	T	A	1	1	2	0	0	2	0	0
11	1526749	.	A	G	1	1	2	0	0	2	0	0
11	1529260	.	A	G	16	12	28	0	1	29	0	0
11	1529526	.	G	A	20	8	28	0	0	28	0	0
11	1529743	.	G	A	12	7	19	0	1	20	0	0
11	1529789	.	A	C	18	8	26	0	0	26	0	0
11	1529796	.	A	T	16	8	24	0	3	27	0	0
11	1529838	.	A	G	8	14	22	0	1	23	0	0
11	1529852	.	A	G	10	12	22	0	2	24	0	0
11	1530027	.	G	A	10	9	19	0	0	19	0	0
11	1530295	.	A	C	12	18	30	0	1	31	0	0
11	1530363	.	A	G	17	16	33	0	0	33	0	0
11	1530489	.	A	G	16	0	16	0	14	30	0	0
11	1530541	.	A	G	14	11	25	0	2	27	0	0
11	1530584	.	G	A	0	12	12	0	17	29	0	0
11	1530593	.	G	T	16	14	30	0	0	30	0	0
11	1530642	.	G	A	6	14	20	0	2	22	0	0
11	1535427	.	C	A	1	1	2	0	0	2	0	0
11	1535877	.	G	A	0	1	1	0	0	1	0	0
11	1542605	.	A	G	4	0	4	0	1	5	0	0
11	1543974	.	A	G	0	6	6	0	0	6	0	0
11	1545883	.	A	C	3	2	5	0	1	6	0	0
11	1720581	.	G	A	1	3	4	0	0	4	0	0
11	1764291	.	C	T	4	2	6	0	0	6	0	0
11	1771294	.	T	C	1	1	2	0	0	2	0	0
11	1776672	.	G	A	1	2	3	0	0	3	0	0
11	1796835	.	C	T	1	1	2	0	0	2	0	0
11	1799778	.	C	T	2	0	2	0	0	2	0	0
11	1799838	.	C	T	1	2	3	0	1	4	0	0
11	1810104	.	C	T	6	6	12	0	0	12	0	0
11	1812288	.	A	G	2	0	2	0	4	6	0	0
11	1812951	.	T	A	1	1	2	0	0	2	0	0
11	1812961	.	C	T	0	1	1	0	0	1	0	0
11	1813240	.	A	G	4	4	8	0	0	8	0	0
11	1818005	.	C	T	1	2	3	0	0	3	0	0
11	1823329	.	T	G	4	0	4	0	3	7	0	0
11	1829952	.	C	T	4	2	6	0	0	7	1	0
11	1830621	.	T	C	2	3	5	0	0	5	0	0
11	1836100	.	C	A	0	1	1	0	0	1	0	0
11	1836995	.	C	G	8	0	8	0	12	20	0	0
11	1838725	.	G	C	0	1	1	0	6	7	0	0
11	1841961	.	G	C	3	1	4	0	0	4	0	0
11	1843339	.	G	T	0	4	4	0	0	4	0	0
11	1843771	.	C	A	6	11	17	0	2	19	0	0
11	1843812	.	A	G	4	0	4	0	7	11	0	0
11	1843818	.	G	A	5	3	8	0	2	10	0	0
11	1863846	.	T	G	14	26	40	0	1	41	0	0
11	1864095	.	C	A	23	22	45	0	0	45	0	0
11	1864216	.	C	T	16	16	32	0	1	33	0	0
11	1917752	.	A	T	0	3	3	0	0	3	0	0
11	1917820	.	G	A	1	1	2	0	0	2	0	0
11	1919054	.	T	G	5	0	5	0	3	8	0	0
11	1919876	.	C	T	6	2	8	0	0	8	0	0
11	1920069	.	A	T	1	4	5	0	0	5	0	0
11	1945034	.	T	A	11	15	26	0	1	27	0	0
11	1945036	.	C	T	11	16	27	0	0	27	0	0
11	1945229	.	C	T	3	4	7	0	1	8	0	0
11	1948373	.	A	T	5	3	8	0	0	8	0	0
11	1967111	.	T	A	5	4	9	0	0	9	0	0
11	1967187	.	T	C	4	3	7	0	0	7	0	0
11	2240120	.	A	C	9	4	13	0	1	14	0	0
11	2249884	.	A	G	20	17	37	0	3	40	0	0
11	2249920	.	C	T	5	5	10	0	1	11	0	0
11	2254326	.	T	C	6	4	10	0	0	10	0	0
11	2254438	.	C	T	0	4	4	0	1	5	0	0
11	2254486	.	A	G	0	2	2	0	0	2	0	0
11	2263484	.	T	G	0	1	1	0	0	1	0	0
11	2292997	.	G	A	2	3	5	0	0	5	0	0
11	2458371	.	T	G	5	3	8	0	0	8	0	0
11	2462791	.	A	G	5	6	11	0	0	11	0	0
11	2506878	.	C	T	2	2	4	0	0	4	0	0
11	2507001	.	G	A	0	2	2	0	4	6	0	0
11	2507529	.	C	G	1	0	1	0	0	1	0	0
11	2507539	.	C	T	1	1	2	0	0	2	0	0
11	2541430	.	T	C	1	0	1	0	4	5	0	0
11	2542391	.	C	T	4	9	13	0	0	13	0	0
11	2543188	.	A	C	2	1	3	0	3	6	0	0
11	2545018	.	A	G	1	3	4	0	0	4	0	0
11	2545487	.	G	A	1	3	4	0	1	5	0	0
11	2566191	.	C	T	0	2	2	0	0	2	0	0
11	2571562	.	T	A	3	4	7	0	0	7	0	0
11	2571635	.	A	G	8	3	11	0	0	11	0	0
11	2571685	.	C	A	2	4	6	0	0	6	0	0
11	2571686	.	A	T	3	3	6	0	0	6	0	0
11	2576843	.	T	C	1	0	1	0	4	5	0	0
11	2576876	.	C	T	0	1	1	0	0	1	0	0
11	2584328	.	C	T	0	1	1	0	0	1	0	0
11	2587664	.	T	C	5	0	5	0	3	8	0	0
11	2593620	.	T	A	1	3	4	0	0	4	0	0
11	2600746	.	A	G	1	4	5	0	0	5	0	0
11	2601198	.	C	A	2	0	2	0	1	3	0	0
11	2601202	.	T	A	1	2	3	0	0	3	0	0
11	2605981	.	A	G	1	1	2	0	0	2	0	0
11	2616881	.	T	A	2	5	7	0	0	7	0	0
11	2616956	.	T	C	11	10	21	0	2	23	0	0
11	2617031	.	T	A	11	14	25	0	0	25	0	0
11	2617072	.	A	G	5	9	14	0	1	15	0	0
11	2618036	.	A	G	8	3	11	0	0	11	0	0
11	2618653	.	C	A	7	8	15	0	0	15	0	0
11	2619089	.	G	A	6	8	14	0	2	16	0	0
11	2619129	.	C	A	7	10	17	0	1	18	0	0
11	2619515	.	T	A	13	10	23	0	0	23	0	0
11	2619538	.	T	A	10	11	21	0	0	21	0	0
11	2619588	.	G	C	10	0	10	0	5	15	0	0
11	2621839	.	G	A	5	7	12	0	1	13	0	0
11	2625224	.	T	A	7	2	9	0	1	10	0	0
11	2625247	.	T	C	5	3	8	0	0	8	0	0
11	2628038	.	T	G	9	3	12	0	0	12	0	0
11	2650018	.	T	G	1	2	3	0	0	3	0	0
11	2655957	.	G	C	0	3	3	0	3	6	0	0
11	2656062	.	C	G	6	4	10	0	1	11	0	0
11	2656830	.	T	C	3	2	5	0	0	5	0	0
11	2660602	.	T	C	3	0	3	0	0	3	0	0
11	2660809	.	G	A	0	2	2	0	2	4	0	0
11	2664585	.	A	C	1	2	3	0	1	4	0	0
11	2665236	.	T	A	5	2	7	0	0	7	0	0
11	2673624	.	T	C	4	3	7	0	0	7	0	0
11	2675447	.	C	A	10	6	16	0	2	18	0	0
11	2675454	.	A	C	6	12	18	0	0	18	0	0
11	2677377	.	G	C	3	1	4	0	0	4	0	0
11	2677404	.	G	A	1	4	5	0	3	8	0	0
11	2677428	.	A	G	4	4	8	0	0	8	0	0
11	2677440	.	C	T	5	3	8	0	1	9	0	0
11	2677538	.	C	T	4	2	6	0	1	7	0	0
11	2678064	.	G	A	5	2	7	0	0	7	0	0
11	2678088	.	G	A	3	8	11	0	0	11	0	0
11	2680570	.	G	A	1	5	6	0	3	9	0	0
11	2680747	.	C	T	7	6	13	0	1	14	0	0
11	2680797	.	G	C	4	5	9	0	2	11	0	0
11	2681133	.	T	A	2	1	3	0	0	3	0	0
11	2681381	.	A	G	3	1	4	0	0	4	0	0
11	2681432	.	A	G	7	3	10	0	0	10	0	0
11	2681799	.	T	C	3	2	5	0	0	5	0	0
11	2682042	.	A	G	2	2	4	0	0	4	0	0
11	2682045	.	C	A	2	2	4	0	0	4	0	0
11	2682361	.	T	C	4	6	10	0	0	10	0	0
11	2682414	.	A	G	5	3	8	0	0	8	0	0
11	2682441	.	A	T	6	3	9	0	0	9	0	0
11	2682470	.	A	T	5	3	8	0	0	8	0	0
11	2682483	.	T	C	3	6	9	0	0	9	0	0
11	2682551	.	C	T	3	6	9	0	1	10	0	0
11	2682555	.	A	T	7	3	10	0	0	10	0	0
11	2682644	.	A	T	3	2	5	0	2	7	0	0
11	2682693	.	A	C	4	4	8	0	0	8	0	0
11	2682866	.	T	C	5	4	9	0	0	9	0	0
11	2683038	.	G	T	5	2	7	0	0	7	0	0
11	2683509	.	T	C	4	19	23	0	3	26	0	0
11	2687421	.	C	T	2	2	4	0	0	4	0	0
11	2687472	.	C	T	2	4	6	0	0	6	0	0
11	2687526	.	G	A	2	9	11	0	0	11	0	0
11	2687550	.	A	C	3	9	12	0	2	14	0	0
11	2688119	.	G	A	2	6	8	0	1	9	0	0
11	2688582	.	A	C	4	2	6	0	1	7	0	0
11	2688916	.	G	C	4	7	11	0	1	12	0	0
11	2689336	.	G	A	2	6	8	0	0	8	0	0
11	2689337	.	G	A	2	6	8	0	0	8	0	0
11	2689880	.	A	G	4	0	4	0	8	12	0	0
11	2690080	.	A	G	8	3	11	0	0	11	0	0
11	2690233	.	G	T	7	8	15	0	0	15	0	0
11	2690303	.	G	C	7	6	13	0	2	15	0	0
11	2690445	.	G	T	8	7	15	0	0	15	0	0
11	2690499	.	C	T	7	6	13	0	0	13	0	0
11	2690564	.	G	T	12	5	17	0	0	17	0	0
11	2690612	.	A	C	10	4	14	0	0	14	0	0
11	2690869	.	C	A	4	4	8	0	0	8	0	0
11	2690873	.	G	A	0	3	3	0	4	7	0	0
11	2690925	.	G	A	0	3	3	0	2	5	0	0
11	2691642	.	C	T	2	3	5	0	0	5	0	0
11	2692109	.	A	C	2	5	7	0	0	7	0	0
11	2692180	.	C	T	2	4	6	0	0	6	0	0
11	2692325	.	G	A	4	3	7	0	0	7	0	0
11	2692579	.	T	G	2	0	2	0	2	4	0	0
11	2702718	.	T	C	2	6	8	0	0	8	0	0
11	2702766	.	C	T	5	3	8	0	0	8	0	0
11	2702808	.	T	C	2	0	2	0	0	2	0	0
11	2705206	.	C	T	4	5	9	0	0	9	0	0
11	2705215	.	G	T	0	5	5	0	6	11	0	0
11	2705273	.	A	G	8	0	8	0	5	13	0	0
11	2705325	.	G	A	8	3	11	0	0	11	0	0
11	2705355	.	T	A	6	8	14	0	0	14	0	0
11	2706517	.	T	G	9	13	22	0	0	22	0	0
11	2706734	.	T	C	13	13	26	0	0	26	0	0
11	2706838	.	A	G	9	8	17	0	1	18	0	0
11	2706988	.	C	A	7	3	10	0	0	10	0	0
11	2710611	.	A	T	4	4	8	0	1	9	0	0
11	2710642	.	G	A	4	4	8	0	0	8	0	0
11	2710770	.	A	T	1	4	5	0	0	5	0	0
11	2730177	.	C	T	0	1	1	0	0	1	0	0
11	2743661	.	C	T	3	2	5	0	1	6	0	0
11	2755120	.	A	T	2	1	3	0	0	3	0	0
11	2756250	.	C	T	4	7	11	0	0	11	0	0
11	2757582	.	T	C	8	5	13	0	0	13	0	0
11	2758204	.	C	T	11	13	24	0	0	24	0	0
11	2759003	.	C	A	2	2	4	0	1	5	0	0
11	2759007	.	C	T	3	2	5	0	0	5	0	0
11	2759043	.	A	T	4	6	10	0	0	10	0	0
11	2759425	.	A	G	5	2	7	0	0	7	0	0
11	2759461	.	T	C	7	2	9	0	1	10	0	0
11	2759475	.	G	T	9	6	15	3	0	18	0	0
11	2759498	.	G	A	8	7	15	4	0	19	0	0
11	2759541	.	C	A	2	9	11	5	0	16	0	0
11	2759833	.	G	A	0	15	15	0	15	30	0	0
11	2759843	.	G	A	0	14	14	0	16	30	0	0
11	2759901	.	T	G	7	17	24	0	2	26	0	0
11	2759903	.	A	T	18	8	26	0	0	26	0	0
11	2759938	.	A	G	12	16	28	0	0	28	0	0
11	2760240	.	C	T	6	4	10	0	0	10	0	0
11	2805410	.	C	A	6	6	12	0	2	14	0	0
11	2809744	.	C	T	6	8	14	0	0	14	0	0
11	2809777	.	A	G	10	0	10	0	13	23	0	0
11	2809804	.	A	G	10	13	23	0	1	24	0	0
11	2813856	.	G	C	14	11	25	0	0	25	0	0
11	2815790	.	C	G	7	7	14	0	2	16	0	0
11	2815845	.	C	T	24	18	42	0	1	43	0	0
11	2820876	.	T	G	5	6	11	0	1	12	0	0
11	2820900	.	A	C	2	3	5	0	0	5	0	0
11	2826184	.	T	C	19	15	34	0	1	35	0	0
11	2826338	.	G	T	22	12	34	0	1	35	0	0
11	2826485	.	C	A	13	11	24	0	1	25	0	0
11	2828174	.	A	G	10	20	30	0	1	31	0	0
11	2828276	.	C	A	18	13	31	0	0	31	0	0
11	2828388	.	G	A	16	16	32	0	0	32	0	0
11	2922443	.	A	G	1	3	4	0	0	4	0	0
11	3170359	.	A	G	1	0	1	0	3	4	0	0
11	3221014	.	C	T	1	2	3	0	0	3	0	0
11	3227302	.	A	T	5	1	6	0	0	6	0	0
11	3230820	.	G	A	0	1	1	0	0	1	0	0
11	3235543	.	C	T	1	2	3	0	0	3	0	0
11	3238484	.	A	G	2	1	3	0	0	3	0	0
11	3238651	.	C	T	0	1	1	0	0	1	0	0
11	3238720	.	T	C	7	4	11	0	1	12	0	0
11	3240457	.	G	A	0	6	6	0	3	9	0	0
11	3243124	.	A	G	1	0	1	0	0	1	0	0
11	3246120	.	A	G	6	9	15	0	1	16	0	0
11	3246133	.	A	G	6	10	16	0	1	17	0	0
11	3246590	.	A	C	2	1	3	0	0	3	0	0
11	3249253	.	C	T	6	7	13	0	0	13	0	0
11	3249346	.	C	T	7	3	10	0	0	10	0	0
11	3249370	.	A	G	4	0	4	0	3	7	0	0
11	3317389	.	A	T	3	3	6	0	1	7	0	0
11	3320963	.	C	G	3	2	5	0	0	5	0	0
11	3320972	.	A	G	4	2	6	0	0	6	0	0
11	3321115	.	A	G	9	6	15	0	0	15	0	0
11	3321141	.	A	T	13	4	17	0	0	17	0	0
11	3321152	.	C	T	0	4	4	0	13	17	0	0
11	3323377	.	G	T	5	5	10	0	0	10	0	0
11	3327451	.	G	A	5	3	8	0	1	9	0	0
11	3333841	.	T	C	2	4	6	0	0	6	0	0
11	3333854	.	A	G	2	3	5	0	0	5	0	0
11	3336700	.	T	G	19	32	51	0	1	52	0	0
11	3336793	.	C	T	31	40	71	0	2	73	0	0
11	3337038	.	A	G	35	31	66	0	7	73	0	0
11	3337253	.	A	G	37	28	65	0	4	69	0	0
11	3337256	.	T	C	38	2	40	0	28	68	0	0
11	3337481	.	T	G	22	34	56	0	2	58	0	0
11	3337482	.	A	T	22	33	55	0	3	58	0	0
11	3337718	.	G	C	26	21	47	0	1	48	0	0
11	3338060	.	C	G	23	19	42	0	3	45	0	0
11	3338144	.	T	C	28	22	50	0	6	56	0	0
11	3338236	.	T	C	31	0	31	1	23	55	0	0
11	3338288	.	T	A	28	25	53	1	0	54	0	0
11	3338299	.	T	G	26	21	47	1	2	50	0	0
11	3338420	.	A	T	23	31	54	0	5	59	0	0
11	3338431	.	C	T	2	31	33	0	25	58	0	0
11	3338491	.	G	A	20	32	52	0	1	53	0	0
11	3338514	.	C	A	27	30	57	0	0	57	0	0
11	3338618	.	T	C	39	21	60	0	1	61	0	0
11	3338638	.	A	G	35	24	59	0	1	60	0	0
11	3338933	.	A	G	26	18	44	0	0	44	0	0
11	3339098	.	T	C	8	1	9	0	26	35	0	0
11	3339152	.	C	T	11	20	31	0	1	32	0	0
11	3341296	.	G	A	13	11	24	0	0	24	0	0
11	3345676	.	A	G	5	2	7	0	0	7	0	0
11	3345779	.	T	C	1	3	4	0	0	4	0	0
11	3345794	.	C	T	2	1	3	0	1	4	0	0
11	3345952	.	T	C	9	4	13	0	0	13	0	0
11	3345980	.	A	G	9	2	11	0	0	11	0	0
11	3346128	.	T	G	8	3	11	0	1	12	0	0
11	3346456	.	C	T	1	3	4	0	0	4	0	0
11	3347156	.	C	A	3	3	6	0	0	6	0	0
11	3347351	.	T	C	5	3	8	0	0	8	0	0
11	3347484	.	T	G	1	2	3	0	0	3	0	0
11	3347485	.	T	G	1	2	3	0	0	3	0	0
11	3367789	.	T	C	5	1	6	0	8	14	0	0
11	3367924	.	G	C	7	13	20	0	0	20	0	0
11	3367937	.	T	C	5	15	20	0	0	20	0	0
11	3369843	.	G	A	3	3	6	0	2	8	0	0
11	3373996	.	C	T	0	1	1	0	1	2	0	0
11	3377127	.	T	C	0	0	0	0	1	1	0	0
11	3379999	.	G	T	0	1	1	0	0	1	0	0
11	3380012	.	C	G	0	1	1	0	0	1	0	0
11	3380135	.	A	G	0	1	1	0	0	1	0	0
11	3381261	.	C	A	4	3	7	0	0	7	0	0
11	3395069	.	G	A	1	1	2	0	0	2	0	0
11	3395070	.	A	T	1	1	2	0	0	2	0	0
11	3395324	.	C	T	8	3	11	0	1	12	0	0
11	3395501	.	A	G	3	2	5	0	0	5	0	0
11	3423390	.	G	A	1	1	2	0	0	2	0	0
11	3423411	.	A	G	1	1	2	0	0	2	0	0
11	3425133	.	G	A	0	2	2	0	0	2	0	0
11	3425175	.	G	A	3	2	5	0	0	5	0	0
11	3494891	.	A	G	4	4	8	0	0	8	0	0
11	3514154	.	T	C	5	3	8	0	0	8	0	0
11	3520670	.	T	C	2	3	5	0	0	5	0	0
11	3520694	.	C	A	1	2	3	0	0	3	0	0
11	3523724	.	A	G	9	11	20	0	0	20	0	0
11	3523826	.	G	A	8	9	17	0	1	18	0	0
11	3523976	.	A	C	5	0	5	0	11	16	0	0
11	3523991	.	C	T	7	6	13	0	2	15	0	0
11	3524064	.	G	T	7	9	16	0	0	16	0	0
11	3524111	.	G	A	7	13	20	0	1	22	1	0
11	3524121	.	A	G	8	14	22	0	0	22	0	0
11	3524236	.	C	T	21	8	29	0	1	30	0	0
11	3524397	.	T	C	9	9	18	0	0	18	0	0
11	3524462	.	C	T	7	8	15	0	0	15	0	0
11	3524541	.	A	T	8	14	22	0	1	23	0	0
11	3524724	.	T	A	3	4	7	0	0	8	1	0
11	3524849	.	G	A	13	9	22	0	1	23	0	0
11	3526521	.	A	G	7	12	19	0	1	20	0	0
11	3526605	.	C	G	2	7	9	0	0	9	0	0
11	3528320	.	A	T	9	7	16	0	1	17	0	0
11	3530791	.	C	G	2	1	3	0	0	3	0	0
11	3530991	.	T	C	3	0	3	0	2	5	0	0
11	3535326	.	A	G	0	1	1	0	0	1	0	0
11	3550448	.	A	G	6	4	10	0	1	12	1	0
11	3550454	.	T	A	8	7	15	0	0	15	0	0
11	3550588	.	T	C	24	1	25	0	14	40	1	0
11	3551309	.	A	G	6	10	16	0	1	17	0	0
11	3551944	.	G	A	26	31	57	0	0	57	0	0
11	3563569	.	T	C	2	0	2	0	0	2	0	0
11	3593309	.	T	C	5	6	11	0	0	11	0	0
11	3593490	.	A	C	4	21	25	0	1	26	0	0
11	3593748	.	A	G	16	11	27	0	0	27	0	0
11	3593778	.	T	C	9	8	17	0	1	18	0	0
11	3593835	.	T	C	10	5	15	1	0	16	0	0
11	3593896	.	A	C	4	11	15	0	1	16	0	0
11	3593988	.	G	T	7	19	26	0	2	28	0	0
11	3594029	.	T	C	13	15	28	0	0	28	0	0
11	3594217	.	G	T	8	13	21	0	1	22	0	0
11	3594277	.	T	G	5	10	15	0	1	16	0	0
11	3594321	.	T	C	7	1	8	0	9	17	0	0
11	3594327	.	T	A	7	12	19	0	0	19	0	0
11	3594366	.	A	G	5	12	17	0	1	18	0	0
11	3594419	.	A	G	5	13	18	0	0	18	0	0
11	3594452	.	T	G	5	1	6	0	11	17	0	0
11	3594828	.	T	C	10	0	10	0	5	15	0	0
11	3595140	.	A	C	2	1	3	0	4	7	0	0
11	3595308	.	G	A	8	4	12	0	0	12	0	0
11	3595579	.	A	G	7	5	12	0	0	12	0	0
11	3602382	.	T	C	4	3	7	0	0	7	0	0
11	3603392	.	A	G	1	1	2	0	0	2	0	0
11	3604825	.	G	A	1	0	1	0	0	1	0	0
11	3606957	.	C	T	3	5	8	0	0	8	0	0
11	3609504	.	G	A	1	2	3	0	1	4	0	0
11	3609511	.	C	T	0	2	2	0	1	3	0	0
11	3630676	.	C	A	1	2	3	0	0	3	0	0
11	3630697	.	A	T	1	2	3	0	0	3	0	0
11	3630875	.	G	A	1	3	4	0	0	4	0	0
11	3631100	.	A	G	1	3	4	0	0	4	0	0
11	3632643	.	C	T	1	2	3	0	0	3	0	0
11	3848283	.	G	A	15	17	32	0	1	33	0	0
11	3848323	.	C	T	0	13	13	0	20	33	0	0
11	3848656	.	C	T	7	16	23	0	1	24	0	0
11	3893635	.	C	T	17	20	37	0	0	37	0	0
11	3893636	.	T	G	16	19	35	0	2	37	0	0
11	3893918	.	G	A	16	16	32	0	0	32	0	0
11	3893928	.	G	C	17	11	28	0	0	28	0	0
11	3894023	.	T	C	12	13	25	0	1	26	0	0
11	3898730	.	C	A	0	1	1	0	1	2	0	0
11	3898736	.	A	G	3	3	6	0	0	6	0	0
11	3899066	.	C	A	1	8	9	0	8	17	0	0
11	3899117	.	G	A	7	3	10	0	0	10	0	0
11	3901733	.	C	G	0	14	14	0	10	24	0	0
11	3904469	.	A	G	9	11	20	0	1	21	0	0
11	3904517	.	C	G	1	14	15	0	13	28	0	0
11	3904564	.	C	T	14	12	26	0	0	26	0	0
11	3904666	.	A	G	5	6	11	0	0	11	0	0
11	3904674	.	T	G	4	4	8	0	0	8	0	0
11	3921491	.	A	G	3	5	8	0	1	9	0	0
11	3921563	.	T	A	24	13	37	0	0	37	0	0
11	3922983	.	G	A	7	4	11	0	2	13	0	0
11	3925822	.	T	C	3	1	4	0	4	8	0	0
11	3925906	.	A	G	8	4	12	0	0	12	0	0
11	3925939	.	T	C	4	1	5	0	0	5	0	0
11	3928044	.	A	T	2	3	5	0	0	5	0	0
11	3931773	.	C	T	12	8	20	0	0	20	0	0
11	3933807	.	G	A	7	5	12	0	0	12	0	0
11	3933956	.	A	G	3	4	7	0	0	7	0	0
11	3934190	.	A	G	3	7	10	0	0	10	0	0
11	3934319	.	T	G	1	0	1	0	0	1	0	0
11	3936378	.	T	A	6	3	9	0	1	10	0	0
11	3938816	.	G	A	1	1	2	0	0	2	0	0
11	3939291	.	C	G	0	3	3	0	3	6	0	0
11	3941180	.	C	T	2	1	3	0	0	3	0	0
11	3963388	.	C	T	1	0	1	0	0	1	0	0
11	3963581	.	C	T	1	2	3	0	0	3	0	0
11	3963608	.	G	T	3	3	6	0	0	6	0	0
11	3964193	.	T	A	3	0	3	0	0	3	0	0
11	3965837	.	G	A	1	2	3	0	0	3	0	0
11	3965984	.	T	A	0	2	2	0	0	2	0	0
11	3966360	.	G	C	0	3	3	0	4	7	0	0
11	3967408	.	A	G	2	0	2	0	7	9	0	0
11	3967445	.	A	G	1	4	5	0	2	7	0	0
11	3968866	.	T	C	7	10	17	0	0	17	0	0
11	3968877	.	G	A	6	8	14	0	1	15	0	0
11	3968915	.	T	G	2	5	7	0	0	7	0	0
11	3968930	.	A	G	0	0	0	0	2	2	0	0
11	3970703	.	T	A	0	3	3	0	0	3	0	0
11	3970713	.	T	A	0	3	3	0	0	3	0	0
11	3970887	.	C	T	6	2	8	0	0	8	0	0
11	3971943	.	T	A	6	3	9	0	0	9	0	0
11	3972248	.	C	T	4	4	8	0	0	8	0	0
11	3993452	.	G	A	2	11	13	0	7	20	0	0
11	3993470	.	A	T	5	6	11	0	3	14	0	0
11	3994901	.	C	A	6	2	8	0	1	9	0	0
11	3995459	.	G	A	4	1	5	0	0	5	0	0
11	3995479	.	G	T	5	4	9	0	0	9	0	0
11	3997023	.	T	C	3	0	3	0	4	7	0	0
11	3997029	.	C	A	0	3	3	0	4	7	0	0
11	4006924	.	C	T	0	0	0	0	1	1	0	0
11	4006956	.	C	T	2	2	4	0	0	4	0	0
11	4010601	.	G	T	0	3	3	0	0	3	0	0
11	4010696	.	G	T	3	2	5	0	0	5	0	0
11	4011001	.	T	C	4	0	4	0	3	7	0	0
11	4014458	.	A	G	0	5	5	0	0	5	0	0
11	4014634	.	A	G	1	0	1	0	0	1	0	0
11	4026308	.	C	T	0	1	1	0	0	1	0	0
11	4113825	.	G	A	0	1	1	0	0	1	0	0
11	4128836	.	A	T	13	14	27	0	2	29	0	0
11	4130165	.	A	T	2	2	4	0	0	4	0	0
11	4131002	.	C	T	2	2	4	0	0	4	0	0
11	4131009	.	G	A	2	1	3	0	0	3	0	0
11	4131300	.	A	T	13	5	18	0	0	18	0	0
11	4131423	.	T	A	14	16	30	0	1	31	0	0
11	4132110	.	G	T	14	10	24	0	0	24	0	0
11	4132296	.	A	C	32	19	51	0	1	52	0	0
11	4132378	.	G	C	20	7	27	0	2	29	0	0
11	4132440	.	A	G	15	12	27	0	3	30	0	0
11	4132599	.	T	C	7	3	10	0	0	10	0	0
11	4187248	.	A	G	3	5	8	0	1	9	0	0
11	5479489	.	A	G	2	0	2	0	3	5	0	0
11	5479555	.	T	C	2	0	2	0	0	2	0	0
11	5484288	.	G	C	0	2	2	0	1	3	0	0
11	5484294	.	T	C	1	2	3	0	0	3	0	0
11	5489221	.	A	G	4	3	7	0	0	7	0	0
11	5489356	.	C	T	16	8	24	0	0	24	0	0
11	5489634	.	A	T	14	13	27	0	1	28	0	0
11	5489688	.	T	C	12	7	19	0	2	23	2	0
11	5489689	.	T	C	15	7	22	0	1	23	0	0
11	5489769	.	C	G	8	3	11	0	0	11	0	0
11	5489781	.	G	A	9	8	17	0	1	18	0	0
11	5489835	.	A	C	4	18	22	0	1	23	0	0
11	5489973	.	A	G	2	0	2	0	5	7	0	0
11	5489974	.	A	G	1	5	6	0	1	7	0	0
11	5509526	.	C	T	2	5	7	0	0	7	0	0
11	5512436	.	A	T	3	7	10	0	1	11	0	0
11	5512468	.	C	T	2	5	7	0	2	9	0	0
11	5512520	.	C	T	7	4	11	0	0	11	0	0
11	5512921	.	A	G	9	0	9	1	10	20	0	0
11	5512947	.	T	G	5	9	14	1	0	15	0	0
11	5513181	.	A	C	9	4	13	0	0	13	0	0
11	5513352	.	C	T	5	4	9	0	0	9	0	0
11	5513381	.	T	A	1	6	7	0	1	8	0	0
11	5514254	.	G	A	0	7	7	0	10	17	0	0
11	5514259	.	C	T	9	8	17	0	0	17	0	0
11	5514677	.	C	T	18	6	24	0	1	25	0	0
11	5515016	.	G	C	2	10	12	0	0	12	0	0
11	5582731	.	T	C	0	2	2	0	1	3	0	0
11	5642980	.	G	A	2	0	2	0	0	2	0	0
11	5646331	.	C	T	1	0	1	0	0	1	0	0
11	5654226	.	T	C	0	1	1	0	0	1	0	0
11	5658587	.	T	A	9	4	13	0	0	13	0	0
11	5658889	.	A	G	3	2	5	0	1	6	0	0
11	5658941	.	A	G	6	2	8	0	0	8	0	0
11	5659054	.	C	G	1	2	3	0	2	5	0	0
11	5659097	.	G	A	6	3	9	0	2	11	0	0
11	5659266	.	T	C	2	2	4	0	0	4	0	0
11	5659300	.	C	A	3	3	6	0	0	6	0	0
11	5669917	.	A	T	4	1	5	0	0	5	0	0
11	5669950	.	T	C	3	0	3	0	0	3	0	0
11	5817307	.	G	C	2	5	7	0	0	7	0	0
11	5817472	.	C	A	5	1	6	0	1	7	0	0
11	5821084	.	G	T	6	6	12	0	0	12	0	0
11	5825415	.	C	T	5	5	10	0	1	11	0	0
11	5825477	.	T	C	0	1	1	0	0	1	0	0
11	5825620	.	A	G	9	6	15	0	0	15	0	0
11	5836012	.	G	A	6	13	19	0	1	20	0	0
11	5836049	.	A	C	14	4	18	0	2	20	0	0
11	5852424	.	G	T	0	16	16	0	13	29	0	0
11	5888504	.	C	T	1	1	2	0	0	2	0	0
11	5965674	.	T	C	1	2	3	0	0	3	0	0
11	6013892	.	C	T	2	0	2	0	0	2	0	0
11	6046870	.	C	G	1	2	3	0	0	3	0	0
11	6048447	.	G	A	2	2	4	0	0	4	0	0
11	6051362	.	C	G	3	2	5	0	0	5	0	0
11	6051477	.	G	A	12	5	17	0	1	18	0	0
11	6051481	.	T	C	13	6	19	0	1	20	0	0
11	6051557	.	A	T	8	6	14	0	1	15	0	0
11	6051717	.	G	A	11	11	22	0	1	23	0	0
11	6051839	.	A	C	10	8	18	0	2	20	0	0
11	6052011	.	T	A	7	11	18	0	0	18	0	0
11	6057335	.	G	A	4	2	6	0	0	6	0	0
11	6062107	.	T	A	2	0	2	0	0	2	0	0
11	6064144	.	C	T	0	1	1	0	0	1	0	0
11	6064147	.	C	T	1	0	1	0	0	1	0	0
11	6065129	.	C	G	0	6	6	0	15	21	0	0
11	6065150	.	C	T	0	9	9	0	11	20	0	0
11	6072856	.	A	T	1	0	1	0	0	1	0	0
11	6073059	.	C	A	2	3	5	0	0	5	0	0
11	6073085	.	G	T	3	3	6	0	0	6	0	0
11	6073161	.	A	T	1	2	3	0	0	3	0	0
11	6073165	.	A	G	0	0	0	0	2	2	0	0
11	6073710	.	A	T	2	5	7	0	0	7	0	0
11	6073736	.	C	T	3	3	6	0	0	6	0	0
11	6073759	.	G	T	4	4	8	0	0	8	0	0
11	6073925	.	T	C	1	3	4	0	0	4	0	0
11	6074110	.	T	G	2	4	6	0	0	6	0	0
11	6115824	.	T	C	1	2	3	0	0	3	0	0
11	6132985	.	T	G	5	2	7	0	0	7	0	0
11	6133293	.	G	C	3	5	8	0	0	8	0	0
11	6133335	.	G	A	3	4	7	0	0	7	0	0
11	6144450	.	T	C	2	2	4	0	0	4	0	0
11	6144604	.	A	T	3	3	6	0	0	6	0	0
11	6144607	.	T	G	3	3	6	0	0	6	0	0
11	6144776	.	T	C	3	3	6	0	0	6	0	0
11	6144800	.	G	A	3	3	6	0	0	6	0	0
11	6144872	.	C	T	4	2	6	0	0	6	0	0
11	6168007	.	C	T	2	2	4	0	0	4	0	0
11	6168047	.	C	T	2	1	3	0	0	3	0	0
11	6172366	.	T	G	0	2	2	0	0	2	0	0
11	6183030	.	T	C	7	12	19	0	0	19	0	0
11	6187412	.	C	G	0	7	7	0	7	14	0	0
11	6197446	.	A	T	6	4	10	0	2	12	0	0
11	6197495	.	C	T	0	2	2	0	6	8	0	0
11	6307055	.	A	G	1	0	1	0	0	1	0	0
11	6307059	.	A	T	1	0	1	0	0	1	0	0
11	6443561	.	A	G	5	0	5	0	4	9	0	0
11	6443580	.	A	G	3	6	9	0	1	10	0	0
11	6443607	.	A	G	7	4	11	0	0	11	0	0
11	6446950	.	G	A	0	7	7	0	0	7	0	0
11	6447394	.	G	A	1	2	3	0	0	3	0	0
11	6456400	.	A	C	2	1	3	0	3	6	0	0
11	6456408	.	G	A	2	3	5	0	0	5	0	0
11	6850576	.	A	G	26	20	46	0	0	46	0	0
11	6859934	.	A	G	2	3	5	0	3	8	0	0
11	6859935	.	T	C	2	1	3	0	5	8	0	0
11	6860020	.	A	G	8	15	23	0	0	23	0	0
11	6860050	.	T	C	9	19	28	0	1	29	0	0
11	6862333	.	T	G	1	2	3	0	0	3	0	0
11	6865051	.	C	T	15	15	30	0	2	32	0	0
11	6868156	.	G	T	13	10	23	0	1	24	0	0
11	6869685	.	A	G	1	0	1	0	1	2	0	0
11	6870794	.	C	T	0	2	2	0	3	5	0	0
11	6874110	.	T	C	2	3	5	0	0	5	0	0
11	6877906	.	G	A	0	2	2	0	0	2	0	0
11	6877927	.	C	T	0	3	3	0	1	4	0	0
11	6877970	.	A	G	2	2	4	0	0	4	0	0
11	6889344	.	A	G	1	3	4	0	0	4	0	0
11	6889957	.	G	C	1	3	4	0	0	4	0	0
11	6890283	.	A	G	2	6	8	0	0	8	0	0
11	6890863	.	A	C	1	1	2	0	1	3	0	0
11	6921995	.	C	A	1	0	1	0	0	1	0	0
11	6925032	.	C	G	1	0	1	0	0	1	0	0
11	6925125	.	C	T	5	3	8	0	0	8	0	0
11	6925146	.	C	A	4	5	9	0	0	9	0	0
11	6925365	.	T	G	0	2	2	0	0	2	0	0
11	6928892	.	A	G	3	4	7	0	0	7	0	0
11	6934453	.	G	A	0	5	5	0	1	6	0	0
11	6934486	.	C	T	2	3	5	0	0	5	0	0
11	6941654	.	T	G	10	6	16	0	0	16	0	0
11	6941987	.	C	T	6	13	19	0	2	21	0	0
11	6942040	.	G	A	9	8	17	0	1	18	0	0
11	6942501	.	A	G	7	7	14	0	0	14	0	0
11	6942797	.	T	C	9	11	20	0	0	20	0	0
11	6942977	.	A	G	7	5	12	0	4	16	0	0
11	6943013	.	C	T	11	12	23	0	0	23	0	0
11	6943048	.	A	G	6	0	6	0	18	24	0	0
11	6943055	.	T	G	5	14	19	0	3	23	1	0
11	6943214	.	G	T	3	2	5	0	0	5	0	0
11	6943361	.	A	G	2	0	2	0	2	4	0	0
11	6943372	.	T	A	3	4	7	0	0	7	0	0
11	6943462	.	T	A	7	11	18	0	2	20	0	0
11	6943715	.	G	A	1	17	18	0	10	28	0	0
11	6944143	.	T	A	15	3	18	0	2	20	0	0
11	6977811	.	A	G	1	3	4	0	0	4	0	0
11	6980913	.	C	T	5	3	8	0	1	9	0	0
11	6981032	.	G	C	2	1	3	0	0	3	0	0
11	6983723	.	T	A	6	2	8	0	0	8	0	0
11	6983784	.	G	A	1	2	3	0	0	3	0	0
11	6983788	.	T	G	1	2	3	0	0	3	0	0
11	6985134	.	T	A	0	1	1	0	0	1	0	0
11	6987558	.	C	T	1	1	2	0	0	2	0	0
11	7040973	.	T	A	1	4	5	0	0	5	0	0
11	7041002	.	A	G	2	5	7	0	0	7	0	0
11	7041291	.	T	C	8	8	16	0	0	16	0	0
11	7041300	.	A	G	7	7	14	0	1	15	0	0
11	7041475	.	C	G	10	5	15	0	1	16	0	0
11	7041476	.	T	C	11	0	11	0	5	16	0	0
11	7041527	.	T	C	4	10	14	0	0	14	0	0
11	7041528	.	G	C	4	10	14	0	0	14	0	0
11	7041580	.	T	C	4	8	12	0	0	12	0	0
11	7041598	.	A	C	4	6	10	0	0	10	0	0
11	7041621	.	T	G	3	3	6	0	0	6	0	0
11	7041915	.	T	A	8	5	13	0	1	14	0	0
11	7041940	.	A	C	7	5	12	0	1	13	0	0
11	7042019	.	C	T	0	2	2	0	5	7	0	0
11	7042042	.	G	A	6	3	9	0	0	9	0	0
11	7042149	.	C	T	2	3	5	0	0	5	0	0
11	7042513	.	T	A	7	4	11	0	2	13	0	0
11	7042956	.	A	G	4	6	10	0	0	10	0	0
11	7043003	.	C	T	0	2	2	0	0	2	0	0
11	7043023	.	C	A	1	4	5	0	0	5	0	0
11	7100589	.	T	C	3	2	5	0	0	5	0	0
11	7100599	.	T	C	2	1	3	0	2	5	0	0
11	7101067	.	G	A	1	3	4	0	0	4	0	0
11	7101280	.	G	A	1	3	4	0	0	4	0	0
11	7102978	.	G	A	0	5	5	0	4	9	0	0
11	7103010	.	A	T	2	2	4	0	1	5	0	0
11	7103054	.	A	C	3	3	6	0	0	6	0	0
11	7103064	.	C	T	3	1	4	0	0	4	0	0
11	7103099	.	G	A	0	1	1	0	1	2	0	0
11	7103135	.	T	A	0	2	2	0	1	3	0	0
11	7103154	.	A	G	1	2	3	0	0	3	0	0
11	7149937	.	T	G	6	0	6	0	0	6	0	0
11	7150189	.	T	C	0	1	1	0	1	2	0	0
11	7150716	.	A	G	7	0	7	0	0	7	0	0
11	7151773	.	G	T	17	22	39	0	2	41	0	0
11	7151806	.	C	A	0	24	24	0	18	42	0	0
11	7151842	.	G	T	15	15	30	0	1	31	0	0
11	7151860	.	A	T	15	8	23	0	1	24	0	0
11	7151910	.	G	A	9	11	20	1	3	24	0	0
11	7152102	.	G	A	11	18	29	0	1	30	0	0
11	7152274	.	G	A	20	6	26	0	1	27	0	0
11	7152426	.	A	T	9	9	18	2	0	20	0	0
11	7152428	.	A	G	9	9	18	2	0	20	0	0
11	7152594	.	C	T	9	15	24	0	1	25	0	0
11	7152609	.	C	T	5	15	20	0	1	21	0	0
11	7152639	.	C	A	2	14	16	0	9	25	0	0
11	7172051	.	T	C	1	0	1	0	1	2	0	0
11	7175215	.	G	C	0	5	5	0	9	14	0	0
11	7178941	.	G	C	0	13	13	0	8	21	0	0
11	7179018	.	C	T	4	8	12	0	2	14	0	0
11	7179259	.	T	C	4	5	9	0	0	9	0	0
11	7179376	.	G	A	5	6	11	0	0	11	0	0
11	7179378	.	A	G	5	6	11	0	0	11	0	0
11	7192840	.	T	G	1	0	1	0	2	3	0	0
11	7194867	.	T	C	1	0	1	0	0	1	0	0
11	7198484	.	G	A	3	2	5	0	0	5	0	0
11	7198517	.	A	G	4	5	9	0	0	9	0	0
11	7198607	.	G	A	5	6	11	0	0	11	0	0
11	7198724	.	G	A	5	3	8	0	0	8	0	0
11	7201648	.	T	C	1	0	1	0	0	1	0	0
11	7201654	.	C	T	0	0	0	0	1	1	0	0
11	7202315	.	C	T	7	8	15	0	0	15	0	0
11	7202321	.	G	A	0	10	10	0	7	17	0	0
11	7211908	.	A	G	13	10	23	0	3	26	0	0
11	7212029	.	A	G	5	3	8	0	1	9	0	0
11	7277061	.	A	G	7	5	12	0	0	13	1	0
11	7277310	.	T	C	7	7	14	0	0	14	0	0
11	7277315	.	T	C	5	4	9	0	1	10	0	0
11	7279587	.	G	A	7	5	12	0	1	13	0	0
11	7279730	.	G	T	6	4	10	0	0	10	0	0
11	7279904	.	G	A	4	5	9	0	1	10	0	0
11	7279913	.	G	T	5	6	11	0	0	11	0	0
11	7282391	.	T	C	2	5	7	0	1	8	0	0
11	7282499	.	C	T	3	8	11	0	0	11	0	0
11	7283033	.	G	T	6	8	14	0	1	15	0	0
11	7283138	.	A	T	7	9	16	0	0	16	0	0
11	7283444	.	C	T	0	3	3	0	5	8	0	0
11	7283525	.	A	G	5	3	8	0	1	9	0	0
11	7283888	.	G	T	1	4	5	0	0	5	0	0
11	7283900	.	G	A	3	4	7	0	0	7	0	0
11	7284488	.	G	A	2	4	6	0	0	6	0	0
11	7284520	.	A	T	1	3	4	0	1	5	0	0
11	7284603	.	G	T	6	2	8	0	0	8	0	0
11	7284692	.	T	C	2	0	2	0	4	6	0	0
11	7284697	.	T	G	2	3	5	0	0	5	0	0
11	7285028	.	C	T	3	2	5	0	0	5	0	0
11	7285109	.	C	T	4	4	8	0	0	8	0	0
11	7285163	.	T	A	1	4	5	0	0	5	0	0
11	7285487	.	T	C	2	2	4	0	0	4	0	0
11	7285801	.	G	A	1	2	3	0	0	3	0	0
11	7298890	.	C	T	2	2	4	0	1	5	0	0
11	7305923	.	G	A	4	2	6	0	0	6	0	0
11	7340143	.	A	G	32	31	63	0	2	65	0	0
11	7341031	.	G	A	26	34	60	0	4	64	0	0
11	7580158	.	C	T	2	2	4	0	0	4	0	0
11	7652612	.	C	T	5	7	12	0	0	12	0	0
11	7652642	.	T	C	6	8	14	0	0	14	0	0
11	7652648	.	G	C	7	8	15	0	0	15	0	0
11	7670739	.	G	T	4	3	7	0	0	7	0	0
11	7686796	.	T	C	3	1	4	0	0	4	0	0
11	7696584	.	G	T	3	3	6	0	1	7	0	0
11	7734898	.	A	G	13	0	13	0	20	33	0	0
11	7735869	.	C	G	13	15	28	0	1	29	0	0
11	7735905	.	T	A	15	18	33	0	1	34	0	0
11	7735937	.	T	A	12	15	27	0	0	27	0	0
11	7736482	.	T	G	10	0	10	0	9	19	0	0
11	7736576	.	G	A	24	23	47	0	0	47	0	0
11	7736589	.	G	T	24	21	45	0	3	48	0	0
11	7981303	.	A	C	6	3	9	0	1	10	0	0
11	7981427	.	C	T	3	5	8	0	0	8	0	0
11	7981613	.	T	C	19	20	39	0	1	40	0	0
11	7981912	.	T	C	14	1	15	0	18	33	0	0
11	7981915	.	T	A	14	17	31	0	1	32	0	0
11	7982114	.	C	T	6	10	16	0	2	18	0	0
11	7982122	.	T	A	7	9	16	0	2	18	0	0
11	7982205	.	T	C	8	0	8	0	8	16	0	0
11	7982263	.	T	G	12	4	16	0	0	16	0	0
11	7982321	.	T	A	2	10	12	0	0	12	0	0
11	7982566	.	T	A	8	4	12	0	4	16	0	0
11	7982774	.	T	A	9	8	17	0	1	18	0	0
11	7982791	.	C	T	9	10	19	0	1	20	0	0
11	7982835	.	C	T	9	9	18	0	0	18	0	0
11	7982869	.	C	T	13	5	18	0	0	18	0	0
11	7983236	.	T	A	10	11	21	0	0	21	0	0
11	7983270	.	T	G	13	14	27	0	0	27	0	0
11	7983348	.	C	A	12	11	23	0	1	24	0	0
11	7983631	.	C	T	0	12	12	0	14	26	0	0
11	7983709	.	T	A	6	14	20	0	1	21	0	0
11	7983734	.	A	G	5	13	18	0	0	18	0	0
11	7983757	.	A	T	6	7	13	0	0	13	0	0
11	7983877	.	C	A	2	2	4	0	0	4	0	0
11	7984165	.	T	C	4	4	8	0	0	8	0	0
11	7984264	.	A	T	7	7	14	0	0	14	0	0
11	7984350	.	A	T	4	6	10	0	0	10	0	0
11	7984666	.	T	A	8	9	17	0	0	17	0	0
11	8003638	.	A	G	0	1	1	0	0	1	0	0
11	8012466	.	T	A	9	8	17	0	4	21	0	0
11	8012535	.	A	G	7	8	15	0	0	15	0	0
11	8115252	.	A	G	1	2	3	0	0	3	0	0
11	8115263	.	T	C	1	0	1	0	3	4	0	0
11	8153771	.	C	T	8	6	14	0	1	15	0	0
11	8156967	.	C	T	7	8	15	0	0	15	0	0
11	8156972	.	C	T	6	8	14	0	1	15	0	0
11	8157002	.	C	G	5	8	13	0	0	13	0	0
11	8305367	.	A	G	2	2	4	0	0	4	0	0
11	8305395	.	A	C	3	2	5	0	0	5	0	0
11	8305425	.	A	G	3	2	5	0	0	5	0	0
11	8305435	.	G	T	2	1	3	0	0	3	0	0
11	8565961	.	T	C	4	3	7	0	0	7	0	0
11	8662864	.	G	A	0	8	8	0	5	13	0	0
11	8672749	.	A	C	1	0	1	0	0	1	0	0
11	8672992	.	G	T	0	1	1	0	0	1	0	0
11	8673002	.	T	C	0	1	1	0	0	1	0	0
11	8674225	.	A	T	2	4	6	0	0	6	0	0
11	8674259	.	G	A	2	2	4	0	0	4	0	0
11	8681619	.	G	T	17	22	39	0	0	39	0	0
11	8681714	.	T	C	12	19	31	0	0	31	0	0
11	8681750	.	G	A	11	7	18	0	1	19	0	0
11	8682248	.	T	A	5	7	12	0	1	13	0	0
11	8682273	.	G	A	3	6	9	0	1	10	0	0
11	9521168	.	T	G	1	0	1	0	0	1	0	0
11	9521169	.	A	G	1	0	1	0	0	1	0	0
11	9564328	.	T	G	2	4	6	0	3	9	0	0
11	9564746	.	G	A	6	3	9	0	1	10	0	0
11	10389284	.	A	G	8	4	12	0	1	13	0	0
11	10402081	.	G	A	1	4	5	0	0	5	0	0
11	10468079	.	G	T	3	1	4	0	0	4	0	0
11	10468756	.	T	C	1	5	6	1	0	7	0	0
11	10468772	.	T	A	2	2	4	1	0	5	0	0
11	10483198	.	A	C	1	2	3	0	0	3	0	0
11	10669933	.	G	T	24	36	60	0	2	62	0	0
11	10670112	.	T	A	17	19	36	0	2	38	0	0
11	10670394	.	C	T	24	21	45	0	0	45	0	0
11	10670439	.	T	C	30	14	44	0	6	51	1	0
11	10671525	.	A	G	22	23	45	0	2	47	0	0
11	10671546	.	A	G	20	21	41	0	2	43	0	0
11	10671578	.	A	T	11	21	32	0	1	33	0	0
11	10671636	.	C	T	0	12	12	0	14	26	0	0
11	10672136	.	C	T	9	3	12	0	1	14	1	0
11	10672250	.	T	C	5	0	5	0	9	14	0	0
11	10672707	.	T	G	8	14	22	0	2	24	0	0
11	10672726	.	T	A	7	7	14	0	0	14	0	0
11	10672750	.	T	C	0	4	4	0	1	5	0	0
11	10713757	.	G	A	3	2	5	0	1	6	0	0
11	10713796	.	C	T	3	3	6	0	0	6	0	0
11	10720232	.	G	C	4	8	12	0	0	12	0	0
11	10720271	.	C	T	0	7	7	0	1	8	0	0
11	10720295	.	A	G	0	2	2	0	0	2	0	0
11	10725775	.	G	A	2	4	6	0	1	7	0	0
11	10835571	.	T	C	1	0	1	0	4	5	0	0
11	10842537	.	T	C	11	1	12	0	6	18	0	0
11	10842714	.	A	C	0	0	0	0	1	1	0	0
11	10909461	.	G	A	0	1	1	0	0	1	0	0
11	10958321	.	A	G	11	0	11	0	7	18	0	0
11	10958507	.	A	G	6	0	6	0	6	12	0	0
11	10959499	.	T	A	9	6	15	0	1	16	0	0
11	11177406	.	C	T	3	2	5	0	0	5	0	0
11	11177436	.	T	C	5	3	8	0	0	8	0	0
11	11181978	.	C	T	4	3	7	0	0	7	0	0
11	11184707	.	C	T	4	4	8	0	0	8	0	0
11	11184743	.	A	C	8	5	13	0	0	13	0	0
11	11184818	.	T	C	5	5	10	0	1	11	0	0
11	11185053	.	G	A	6	5	11	0	0	11	0	0
11	11185074	.	G	C	8	7	15	0	0	15	0	0
11	11185175	.	G	C	1	0	1	0	0	1	0	0
11	11186248	.	G	C	3	5	8	0	0	8	0	0
11	11191840	.	C	T	6	8	14	0	1	15	0	0
11	11191845	.	C	T	6	11	17	0	0	17	0	0
11	11191995	.	T	C	15	25	40	0	0	40	0	0
11	11192053	.	C	T	6	18	24	0	0	24	0	0
11	11192170	.	T	A	9	8	17	0	0	17	0	0
11	11192276	.	G	A	13	20	33	0	0	33	0	0
11	11192342	.	T	G	8	11	19	0	1	20	0	0
11	11192724	.	T	C	16	9	25	0	0	25	0	0
11	11193030	.	C	T	6	4	10	0	0	10	0	0
11	11274615	.	A	T	20	22	42	0	0	43	1	0
11	11275268	.	A	T	3	2	5	0	0	5	0	0
11	11319041	.	C	A	1	2	3	0	2	5	0	0
11	11319180	.	A	G	3	3	6	0	0	6	0	0
11	11325486	.	G	A	1	3	4	0	2	6	0	0
11	11325570	.	T	A	0	4	4	0	0	4	0	0
11	11326502	.	A	G	4	7	11	0	0	11	0	0
11	11326968	.	C	A	0	2	2	0	1	3	0	0
11	11330971	.	G	C	6	6	12	0	0	12	0	0
11	11332856	.	T	C	4	2	6	0	0	6	0	0
11	11332986	.	A	G	2	3	5	0	0	5	0	0
11	11332990	.	T	A	3	3	6	0	0	6	0	0
11	11333116	.	C	A	5	5	10	0	0	10	0	0
11	11333135	.	C	T	4	4	8	0	0	8	0	0
11	11333661	.	T	G	3	2	5	0	0	5	0	0
11	11333670	.	T	G	2	2	4	0	0	4	0	0
11	11468756	.	T	G	11	10	21	0	1	22	0	0
11	11469128	.	C	T	15	8	23	0	1	24	0	0
11	11469143	.	C	T	15	6	21	0	2	23	0	0
11	11469203	.	G	A	6	7	13	0	0	13	0	0
11	11469215	.	C	T	4	6	10	0	1	11	0	0
11	11469632	.	G	A	1	1	2	0	0	2	0	0
11	11470678	.	A	C	3	0	3	0	0	3	0	0
11	11470994	.	T	C	2	1	3	0	0	3	0	0
11	11471147	.	C	A	4	6	10	0	0	10	0	0
11	11471372	.	A	C	3	0	3	0	3	6	0	0
11	11471434	.	T	A	4	5	9	0	0	9	0	0
11	11516245	.	T	G	2	4	6	0	1	7	0	0
11	11597401	.	C	A	13	11	24	0	0	24	0	0
11	11597523	.	A	G	14	14	28	0	1	29	0	0
11	11597679	.	G	C	12	13	25	0	0	25	0	0
11	11597798	.	A	T	13	7	20	0	2	22	0	0
11	11598334	.	G	C	11	14	25	0	2	27	0	0
11	11605172	.	T	C	1	0	1	0	9	10	0	0
11	11605744	.	C	T	0	2	2	0	0	2	0	0
11	11607579	.	A	C	5	0	5	0	10	15	0	0
11	11607594	.	G	A	6	10	16	0	0	16	0	0
11	11612715	.	G	A	3	6	9	0	1	10	0	0
11	11612758	.	A	G	2	5	7	0	0	7	0	0
11	11612773	.	C	T	2	3	5	0	0	5	0	0
11	11614681	.	T	G	4	3	7	0	0	7	0	0
11	11614914	.	A	T	0	2	2	0	0	2	0	0
11	11616542	.	G	A	0	1	1	0	0	1	0	0
11	11619931	.	A	G	4	4	8	0	0	8	0	0
11	11624939	.	T	C	2	1	3	0	0	3	0	0
11	11625153	.	T	C	6	0	6	0	7	13	0	0
11	11625169	.	C	G	7	6	13	0	0	13	0	0
11	11780496	.	A	G	1	3	4	0	0	4	0	0
11	11780737	.	A	T	2	3	5	0	0	5	0	0
11	11780790	.	A	C	1	4	5	0	1	6	0	0
11	11780863	.	A	G	4	1	5	0	5	10	0	0
11	11780935	.	T	C	2	4	6	0	0	6	0	0
11	11781172	.	C	T	2	2	4	0	0	4	0	0
11	11871042	.	A	C	5	2	7	0	0	7	0	0
11	11875610	.	T	C	1	2	3	0	0	3	0	0
11	11911622	.	T	C	2	0	2	0	2	4	0	0
11	11918439	.	T	C	1	0	1	0	2	3	0	0
11	11918607	.	A	C	2	2	4	0	0	4	0	0
11	11928205	.	C	T	1	3	4	0	0	4	0	0
11	11932998	.	A	G	0	2	2	0	1	3	0	0
11	11951636	.	A	T	1	2	3	0	0	3	0	0
11	11979578	.	A	G	2	3	5	0	0	5	0	0
11	11979585	.	T	C	2	3	5	0	0	5	0	0
11	11984043	.	T	A	6	2	8	0	0	8	0	0
11	11984120	.	A	G	0	4	4	0	1	5	0	0
11	11984227	.	G	A	3	8	11	0	1	12	0	0
11	11984408	.	A	C	10	10	20	0	1	21	0	0
11	11984409	.	G	C	11	10	21	0	0	21	0	0
11	11984480	.	T	C	5	0	5	0	10	15	0	0
11	11984501	.	A	T	4	8	12	0	0	12	0	0
11	11984548	.	C	T	7	8	15	0	0	15	0	0
11	12004070	.	A	G	5	4	9	0	0	9	0	0
11	12004652	.	A	G	5	4	9	0	0	9	0	0
11	12011325	.	G	A	3	7	10	0	0	10	0	0
11	12016638	.	A	G	7	5	12	0	0	12	0	0
11	12016650	.	G	A	9	8	17	0	0	17	0	0
11	12720049	.	T	A	2	1	3	0	0	3	0	0
11	12727225	.	A	G	7	8	15	0	1	16	0	0
11	12727446	.	C	T	23	28	51	0	1	52	0	0
11	12727685	.	T	C	17	22	39	0	0	39	0	0
11	12727708	.	C	A	14	17	31	0	0	31	0	0
11	12727879	.	A	C	10	4	14	0	0	14	0	0
11	12727990	.	T	A	11	13	24	0	2	26	0	0
11	12727999	.	C	T	12	10	22	0	0	22	0	0
11	12728195	.	T	G	8	12	20	0	2	22	0	0
11	12728249	.	C	T	8	7	15	0	2	17	0	0
11	12732431	.	A	C	4	3	7	0	0	7	0	0
11	12732521	.	T	C	7	0	7	0	10	17	0	0
11	12732696	.	T	A	0	6	6	0	0	6	0	0
11	12732699	.	A	T	0	6	6	0	0	6	0	0
11	12732980	.	T	C	1	3	4	0	0	4	0	0
11	12733104	.	G	A	3	5	8	0	0	8	0	0
11	12733362	.	A	G	1	7	8	0	0	8	0	0
11	12733815	.	C	T	5	3	8	0	0	8	0	0
11	12734007	.	C	T	3	3	6	0	0	6	0	0
11	12744740	.	T	C	2	8	10	0	0	10	0	0
11	12751500	.	G	A	5	3	8	0	0	8	0	0
11	12751831	.	T	C	3	0	3	0	0	3	0	0
11	12767964	.	A	G	1	0	1	0	1	2	0	0
11	12767982	.	T	C	4	5	9	0	0	9	0	0
11	12768214	.	G	A	0	13	13	0	14	27	0	0
11	12768221	.	C	T	15	12	27	0	2	29	0	0
11	12768351	.	A	G	13	7	20	0	0	20	0	0
11	12768394	.	A	C	10	7	17	0	0	17	0	0
11	12768480	.	C	T	5	3	8	0	0	8	0	0
11	12783139	.	T	A	5	4	9	0	2	11	0	0
11	12783579	.	T	G	2	4	6	0	1	7	0	0
11	12792707	.	C	T	1	1	2	0	0	2	0	0
11	12792803	.	C	T	1	0	1	0	0	1	0	0
11	12800822	.	G	A	2	3	5	0	0	5	0	0
11	12800823	.	C	G	2	3	5	0	0	5	0	0
11	12800927	.	A	C	0	1	1	0	0	1	0	0
11	12829985	.	C	T	0	1	1	0	0	1	0	0
11	12829994	.	G	T	0	1	1	0	0	1	0	0
11	12835833	.	C	A	1	4	5	0	1	6	0	0
11	12835848	.	T	C	1	5	6	0	0	6	0	0
11	12845066	.	A	G	2	1	3	0	0	3	0	0
11	12848345	.	A	G	2	4	6	0	0	6	0	0
11	12860525	.	T	C	1	3	4	0	0	4	0	0
11	12860552	.	G	A	0	3	3	0	1	4	0	0
11	12860924	.	A	G	4	4	8	0	0	8	0	0
11	12860931	.	C	G	3	4	7	0	0	7	0	0
11	12861196	.	A	G	6	6	12	0	0	12	0	0
11	12864070	.	C	T	3	5	8	0	1	9	0	0
11	12864361	.	A	G	0	0	0	0	3	3	0	0
11	12869192	.	G	T	0	11	11	0	9	20	0	0
11	12869309	.	T	C	4	10	14	0	0	14	0	0
11	12869409	.	C	A	10	11	21	0	0	21	0	0
11	12869414	.	C	T	10	10	20	0	1	21	0	0
11	12872304	.	C	G	1	3	4	0	0	4	0	0
11	12872549	.	A	T	2	3	5	0	0	5	0	0
11	13055470	.	G	A	10	14	24	0	2	26	0	0
11	13055694	.	C	A	10	10	20	0	1	21	0	0
11	13062000	.	T	C	2	2	4	0	0	4	0	0
11	13071920	.	A	G	3	2	5	0	0	5	0	0
11	13074127	.	T	C	1	0	1	0	0	1	0	0
11	13079183	.	C	A	6	4	10	0	0	10	0	0
11	13088062	.	G	T	1	2	3	0	7	10	0	0
11	13094199	.	C	T	12	12	24	0	0	24	0	0
11	13094203	.	C	T	9	12	21	0	3	24	0	0
11	13094368	.	T	A	9	8	17	0	0	17	0	0
11	13094473	.	A	T	28	15	43	0	2	45	0	0
11	13094581	.	C	T	2	22	24	0	27	51	0	0
11	13094668	.	C	A	18	13	31	0	2	33	0	0
11	13094678	.	T	C	15	15	30	0	4	34	0	0
11	13094778	.	T	C	12	22	34	0	1	35	0	0
11	13095049	.	G	A	18	19	37	0	3	40	0	0
11	13176674	.	C	A	0	1	1	0	0	1	0	0
11	13181415	.	G	A	3	2	5	0	0	5	0	0
11	13185928	.	C	T	1	4	5	0	0	5	0	0
11	13185931	.	G	T	1	4	5	0	0	5	0	0
11	13188425	.	G	C	2	3	5	0	0	5	0	0
11	13188527	.	A	G	3	0	3	0	2	5	0	0
11	13188669	.	C	T	1	6	7	0	0	7	0	0
11	13188753	.	G	A	0	3	3	0	3	6	0	0
11	13188768	.	C	A	2	2	4	0	0	4	0	0
11	13189339	.	G	T	2	3	5	0	0	5	0	0
11	13189461	.	A	G	4	1	5	0	0	5	0	0
11	13189469	.	A	G	3	2	5	0	1	6	0	0
11	13189592	.	G	A	1	5	6	0	0	6	0	0
11	13189623	.	T	A	1	2	3	0	0	3	0	0
11	13189627	.	T	G	1	1	2	0	0	2	0	0
11	13208755	.	T	A	9	11	20	0	3	23	0	0
11	13209037	.	T	G	27	24	51	0	1	52	0	0
11	13209391	.	C	T	8	8	16	0	1	17	0	0
11	13210604	.	G	A	24	19	43	0	3	46	0	0
11	13210650	.	A	C	29	29	58	0	2	60	0	0
11	13210897	.	A	T	39	18	57	0	2	59	0	0
11	13212234	.	T	C	36	40	76	0	1	77	0	0
11	13212306	.	C	T	27	25	52	0	2	54	0	0
11	13212333	.	T	C	15	10	25	0	4	29	0	0
11	13212357	.	T	C	3	5	8	0	0	8	0	0
11	13212567	.	T	C	36	24	60	0	3	63	0	0
11	13212908	.	T	A	18	36	54	0	1	55	0	0
11	13280565	.	T	C	14	6	20	0	8	28	0	0
11	13281122	.	T	C	20	14	34	0	0	34	0	0
11	13281158	.	A	T	12	5	17	0	0	17	0	0
11	13281238	.	A	G	7	2	9	0	0	9	0	0
11	13281243	.	C	A	7	1	8	0	0	8	0	0
11	13281331	.	A	T	14	4	18	0	2	20	0	0
11	13281594	.	T	C	12	15	27	0	2	29	0	0
11	13281734	.	G	A	6	20	26	0	0	26	0	0
11	13281794	.	G	T	8	9	17	0	1	18	0	0
11	13281864	.	C	T	3	3	6	0	2	8	0	0
11	13282099	.	T	C	5	6	11	1	0	13	1	0
11	13282201	.	G	T	9	5	14	0	0	15	1	0
11	13282210	.	T	A	6	6	12	0	1	13	0	0
11	13282240	.	T	C	2	10	12	0	1	13	0	0
11	13282267	.	T	C	1	0	1	0	5	6	0	0
11	13283335	.	A	G	11	10	21	0	0	21	0	0
11	13283368	.	C	A	7	7	14	0	1	15	0	0
11	13283398	.	G	C	9	6	15	0	0	15	0	0
11	13283403	.	T	G	9	6	15	0	1	16	0	0
11	13283447	.	G	A	11	8	19	0	0	19	0	0
11	13283476	.	C	T	6	10	16	0	1	17	0	0
11	13283569	.	G	A	10	4	14	0	1	15	0	0
11	13283634	.	C	T	7	3	10	0	0	10	0	0
11	13283713	.	G	A	7	5	12	0	1	13	0	0
11	13292084	.	A	G	7	8	15	0	1	16	0	0
11	13292105	.	C	T	0	9	9	0	9	18	0	0
11	13292462	.	C	T	5	2	7	0	0	7	0	0
11	13292576	.	C	T	0	3	3	0	6	9	0	0
11	13306186	.	C	T	2	2	4	0	0	4	0	0
11	13313524	.	G	A	1	0	1	0	0	1	0	0
11	13424244	.	G	A	1	2	3	0	0	3	0	0
11	13445981	.	T	C	3	1	4	0	0	4	0	0
11	13480221	.	G	A	0	2	2	0	0	2	0	0
11	13494666	.	T	A	2	1	3	0	0	3	0	0
11	13503351	.	A	G	3	2	5	0	0	5	0	0
11	13503718	.	T	G	0	1	1	0	1	2	0	0
11	13503765	.	G	T	2	3	5	0	0	5	0	0
11	13504343	.	A	C	8	10	18	0	0	18	0	0
11	13504403	.	C	T	1	4	5	0	0	5	0	0
11	13504473	.	A	T	8	3	11	0	0	11	0	0
11	13505186	.	C	A	8	7	15	0	0	15	0	0
11	13505247	.	A	T	9	4	13	0	0	13	0	0
11	13532024	.	G	T	5	6	11	0	0	11	0	0
11	13532034	.	G	A	0	5	5	0	5	10	0	0
11	13532070	.	T	G	0	0	0	0	3	3	0	0
11	13532071	.	T	C	0	3	3	0	0	3	0	0
11	13532567	.	T	C	1	2	3	0	0	3	0	0
11	13532763	.	C	T	5	4	9	0	0	9	0	0
11	13532922	.	C	T	2	6	8	0	0	8	0	0
11	13533094	.	T	G	8	4	12	0	0	12	0	0
11	13533124	.	G	A	8	7	15	0	0	15	0	0
11	13533214	.	A	G	4	0	4	0	6	10	0	0
11	13533388	.	T	A	8	3	11	0	1	12	0	0
11	13533429	.	G	T	5	8	13	0	0	13	0	0
11	13639185	.	C	G	4	3	7	0	0	7	0	0
11	13697910	.	T	C	0	2	2	0	0	2	0	0
11	14061966	.	A	C	0	1	1	0	0	1	0	0
11	14061976	.	G	A	0	1	1	0	1	2	0	0
11	14062662	.	A	G	1	4	5	0	0	5	0	0
11	14062667	.	A	G	1	4	5	0	0	5	0	0
11	14064487	.	G	C	4	6	10	0	0	10	0	0
11	14064523	.	C	T	5	3	8	0	0	8	0	0
11	14073049	.	T	A	3	3	6	0	0	6	0	0
11	14073444	.	C	T	12	9	21	0	1	22	0	0
11	14073503	.	G	A	7	8	15	0	1	16	0	0
11	14073560	.	T	A	6	11	17	0	0	17	0	0
11	14073730	.	G	T	7	15	22	0	1	23	0	0
11	14073857	.	C	A	8	8	16	0	1	17	0	0
11	14073858	.	A	T	9	8	17	0	0	17	0	0
11	14074125	.	T	C	3	9	12	0	1	13	0	0
11	14074245	.	T	C	5	5	10	0	0	10	0	0
11	14074584	.	T	G	2	4	6	0	1	7	0	0
11	14074628	.	T	A	1	2	3	0	0	3	0	0
11	14074649	.	A	G	0	2	2	0	0	2	0	0
11	14074738	.	G	A	4	7	11	0	0	11	0	0
11	14074951	.	C	T	5	5	10	0	1	11	0	0
11	14074952	.	A	T	6	5	11	0	0	11	0	0
11	14075147	.	G	A	5	8	13	0	0	13	0	0
11	14075302	.	A	G	4	8	12	0	0	12	0	0
11	14101295	.	C	A	0	2	2	0	2	4	0	0
11	14137563	.	C	T	2	3	5	0	0	5	0	0
11	14137901	.	C	A	4	2	6	0	0	6	0	0
11	14137988	.	C	T	2	2	4	0	0	4	0	0
11	14143452	.	C	A	5	4	9	0	0	9	0	0
11	14143499	.	G	A	0	2	2	0	2	4	0	0
11	14199913	.	G	C	0	8	8	0	7	15	0	0
11	14266826	.	G	T	0	11	11	0	12	23	0	0
11	14267075	.	T	C	9	15	24	0	0	24	0	0
11	14267076	.	G	A	9	14	23	0	1	24	0	0
11	14267239	.	C	G	8	8	16	0	0	16	0	0
11	14291203	.	G	A	3	2	5	0	0	5	0	0
11	14318207	.	T	A	2	3	5	0	0	5	0	0
11	14318637	.	A	G	3	5	8	0	0	8	0	0
11	14332997	.	A	G	1	0	1	0	1	2	0	0
11	14333489	.	T	C	0	1	1	0	0	1	0	0
11	14338397	.	C	G	4	2	6	0	1	7	0	0
11	14338454	.	C	G	4	5	9	0	0	9	0	0
11	14338460	.	G	A	5	4	9	0	0	9	0	0
11	14341498	.	T	A	1	2	3	0	0	3	0	0
11	14341510	.	A	C	1	3	4	0	0	4	0	0
11	14341557	.	G	A	3	3	6	0	1	7	0	0
11	14341610	.	C	A	0	1	1	0	0	1	0	0
11	14341669	.	C	A	4	5	9	0	0	9	0	0
11	14343567	.	A	C	5	2	7	0	0	7	0	0
11	14343612	.	T	G	3	4	7	0	1	8	0	0
11	14344976	.	G	T	2	3	5	0	0	5	0	0
11	14344989	.	G	A	0	4	4	0	2	6	0	0
11	14345062	.	T	A	2	7	9	0	0	9	0	0
11	14345064	.	C	T	2	7	9	0	0	9	0	0
11	14345156	.	C	A	3	2	5	0	0	5	0	0
11	14345562	.	T	G	6	6	12	0	0	12	0	0
11	14345638	.	C	T	5	11	16	0	0	16	0	0
11	14345753	.	A	G	8	8	16	0	0	16	0	0
11	14345830	.	T	C	4	7	11	0	0	11	0	0
11	14345884	.	T	G	3	8	11	0	0	11	0	0
11	14639030	.	T	C	3	8	11	0	0	11	0	0
11	14640002	.	G	T	0	3	3	0	2	5	0	0
11	14640155	.	A	G	3	2	5	0	0	5	0	0
11	14676500	.	G	T	1	3	4	0	0	4	0	0
11	14749156	.	G	A	4	4	8	0	0	8	0	0
11	14751068	.	T	C	5	10	15	0	0	15	0	0
11	14955592	.	A	G	9	5	14	0	0	14	0	0
11	14956519	.	G	A	2	11	13	0	1	14	0	0
11	15250544	.	T	C	9	4	13	0	0	13	0	0
11	15586740	.	C	A	2	1	3	0	0	3	0	0
11	15586792	.	T	G	2	5	7	0	0	7	0	0
11	15833846	.	T	C	6	4	10	0	1	11	0	0
11	15834110	.	T	G	3	4	7	0	0	7	0	0
11	15834265	.	T	C	3	5	8	0	1	9	0	0
11	15834436	.	T	A	2	6	8	0	0	8	0	0
11	15850735	.	C	T	0	5	5	0	0	5	0	0
11	15874809	.	C	A	0	2	2	0	1	3	0	0
11	15874820	.	A	G	1	2	3	0	0	3	0	0
11	15874882	.	C	T	3	2	5	0	0	5	0	0
11	15888117	.	G	C	0	1	1	0	2	3	0	0
11	15894885	.	G	A	1	2	3	0	2	5	0	0
11	15910604	.	G	C	2	3	5	0	1	6	0	0
11	15975556	.	C	T	1	1	2	0	0	2	0	0
11	16005711	.	C	T	2	8	10	0	0	10	0	0
11	16005862	.	G	A	2	4	6	0	0	6	0	0
11	16005883	.	G	T	2	3	5	0	0	5	0	0
11	16006030	.	C	T	1	3	4	0	0	4	0	0
11	16006149	.	C	T	1	4	5	0	0	5	0	0
11	16006154	.	T	A	1	4	5	0	0	5	0	0
11	16006318	.	T	G	1	3	4	0	0	4	0	0
11	16007461	.	A	G	4	2	6	1	0	7	0	0
11	16010468	.	A	G	5	0	5	0	4	9	0	0
11	16010502	.	A	G	3	0	3	0	4	7	0	0
11	16010656	.	T	C	12	0	12	0	0	12	0	0
11	16010788	.	C	A	6	6	12	0	0	12	0	0
11	16010799	.	G	C	7	6	13	0	0	13	0	0
11	16010842	.	C	T	5	6	11	0	0	11	0	0
11	16010849	.	A	G	5	0	5	0	6	11	0	0
11	16010978	.	G	A	6	2	8	0	0	8	0	0
11	16010986	.	A	T	6	2	8	0	0	8	0	0
11	16011185	.	C	A	6	5	11	0	0	11	0	0
11	16011622	.	T	C	8	6	14	0	0	14	0	0
11	16011632	.	T	G	8	0	8	0	6	14	0	0
11	16011705	.	T	C	7	9	16	0	0	16	0	0
11	16011745	.	C	G	8	11	19	0	0	19	0	0
11	16011770	.	T	C	14	16	30	0	0	30	0	0
11	16011807	.	T	C	12	16	28	0	1	29	0	0
11	16012021	.	G	A	11	7	18	0	0	18	0	0
11	16012117	.	G	T	0	10	10	0	14	24	0	0
11	16012140	.	G	A	0	11	11	0	17	28	0	0
11	16012152	.	A	G	11	0	11	0	16	27	0	0
11	16012191	.	C	T	10	19	29	0	2	31	0	0
11	16012201	.	C	T	9	18	27	0	1	28	0	0
11	16012251	.	T	A	10	11	21	0	1	22	0	0
11	16012256	.	C	T	11	11	22	0	0	22	0	0
11	16012316	.	T	G	6	7	13	0	1	14	0	0
11	16012364	.	G	T	0	9	9	0	2	11	0	0
11	16012414	.	T	C	3	8	11	0	0	11	0	0
11	16012654	.	A	G	7	1	8	0	9	17	0	0
11	16012785	.	T	G	10	10	20	0	2	22	0	0
11	16012786	.	A	G	10	12	22	0	0	22	0	0
11	16012829	.	G	T	11	15	26	0	1	27	0	0
11	16012882	.	G	A	16	8	24	0	0	24	0	0
11	16013018	.	T	C	6	8	14	0	1	15	0	0
11	16013036	.	T	A	2	5	7	0	0	7	0	0
11	16099700	.	G	A	1	0	1	0	0	1	0	0
11	16104175	.	T	C	6	8	14	0	0	14	0	0
11	16115692	.	C	T	2	10	12	0	0	12	0	0
11	16143781	.	T	C	16	22	38	0	1	39	0	0
11	16143829	.	T	C	23	17	40	0	0	40	0	0
11	16153290	.	C	T	10	5	15	0	0	15	0	0
11	16158555	.	G	A	10	9	19	0	0	19	0	0
11	16159056	.	A	G	5	0	5	0	0	5	0	0
11	16159316	.	C	T	4	4	8	0	2	10	0	0
11	16159875	.	T	C	1	3	4	0	0	4	0	0
11	16159903	.	C	T	6	7	13	0	0	13	0	0
11	16160137	.	A	G	4	0	4	0	6	10	0	0
11	16165293	.	T	C	7	9	16	0	2	18	0	0
11	16165298	.	G	A	1	8	9	0	7	16	0	0
11	16165605	.	T	A	13	10	23	0	2	25	0	0
11	16165665	.	A	G	17	17	34	0	0	34	0	0
11	16165710	.	T	A	18	8	26	0	1	27	0	0
11	16165839	.	G	T	3	3	6	0	0	6	0	0
11	16166177	.	C	A	2	0	2	0	0	2	0	0
11	16166187	.	T	C	2	0	2	0	0	2	0	0
11	16168391	.	G	A	2	2	4	0	0	4	0	0
11	16169352	.	T	C	1	2	3	0	0	3	0	0
11	16180033	.	G	A	30	25	55	0	4	59	0	0
11	16184739	.	A	G	9	16	25	0	2	27	0	0
11	16184865	.	A	T	5	13	18	0	1	19	0	0
11	16237915	.	C	G	0	2	2	0	0	2	0	0
11	16585755	.	T	A	1	2	3	0	1	4	0	0
11	16585775	.	C	G	1	2	3	0	0	3	0	0
11	16586747	.	A	G	4	6	10	0	1	11	0	0
11	16587715	.	A	G	7	7	14	0	1	15	0	0
11	16587873	.	A	T	1	3	4	0	0	4	0	0
11	16587901	.	C	T	1	3	4	0	0	4	0	0
11	16738331	.	G	A	1	2	3	0	1	4	0	0
11	16738655	.	C	T	1	2	3	0	0	3	0	0
11	16738663	.	A	G	3	1	4	0	0	4	0	0
11	16738755	.	T	A	1	2	3	0	0	3	0	0
11	16739039	.	C	T	0	10	10	0	5	15	0	0
11	16849887	.	T	G	1	6	7	0	0	7	0	0
11	16849896	.	G	A	1	7	8	0	0	8	0	0
11	17511788	.	T	C	7	11	18	0	0	18	0	0
11	17511902	.	C	A	8	4	12	0	0	12	0	0
11	17511964	.	C	G	7	0	7	0	6	13	0	0
11	17512139	.	T	C	9	13	22	0	0	22	0	0
11	17512289	.	T	C	9	10	19	0	6	25	0	0
11	17512831	.	T	A	2	2	4	0	0	4	0	0
11	17513174	.	A	G	3	2	5	0	0	5	0	0
11	17513328	.	A	G	2	0	2	0	2	4	0	0
11	17513405	.	C	T	3	4	7	0	1	8	0	0
11	17513424	.	T	A	3	5	8	0	0	8	0	0
11	17513440	.	A	G	1	6	7	0	0	7	0	0
11	17513526	.	G	A	0	2	2	0	4	6	0	0
11	17513554	.	T	A	4	2	6	0	0	6	0	0
11	17713672	.	T	C	4	3	7	0	0	7	0	0
11	17757767	.	T	C	9	6	15	0	0	15	0	0
11	17757859	.	T	C	7	4	11	0	0	11	0	0
11	17763137	.	A	G	8	13	21	0	0	21	0	0
11	17763160	.	T	C	7	13	20	0	1	21	0	0
11	17763173	.	C	A	5	11	16	0	1	17	0	0
11	17763393	.	C	T	7	12	19	0	0	19	0	0
11	17765170	.	C	T	3	1	4	0	1	5	0	0
11	17765618	.	T	C	1	0	1	0	0	1	0	0
11	17769238	.	C	T	2	3	5	0	0	5	0	0
11	17769801	.	A	T	10	6	16	0	0	16	0	0
11	17770594	.	C	T	4	7	11	0	0	11	0	0
11	17770627	.	T	C	5	10	15	0	0	15	0	0
11	17771185	.	T	C	0	3	3	0	0	3	0	0
11	17771248	.	T	C	0	2	2	0	0	2	0	0
11	17771478	.	C	T	0	1	1	0	0	1	0	0
11	17774893	.	G	A	0	0	0	0	1	1	0	0
11	17774917	.	T	C	1	1	2	0	1	3	0	0
11	17774970	.	G	T	1	1	2	0	0	2	0	0
11	17778492	.	T	A	2	6	8	0	1	9	0	0
11	17778528	.	T	C	5	0	5	0	4	9	0	0
11	17778597	.	A	G	2	5	7	0	0	7	0	0
11	17778618	.	T	G	2	5	7	0	0	7	0	0
11	17778690	.	G	T	8	4	12	0	0	12	0	0
11	17778978	.	A	T	0	2	2	0	0	2	0	0
11	17779023	.	T	C	0	3	3	0	0	3	0	0
11	17779159	.	A	G	2	6	8	0	0	8	0	0
11	17779197	.	A	T	1	1	2	0	1	3	0	0
11	17779254	.	T	C	2	0	2	0	2	4	0	0
11	17779279	.	C	A	5	3	8	0	0	8	0	0
11	17779599	.	A	T	5	4	9	0	1	10	0	0
11	17779630	.	G	A	2	4	6	0	0	6	0	0
11	17779656	.	C	T	0	1	1	0	0	1	0	0
11	17782529	.	A	C	6	0	6	0	6	12	0	0
11	17785402	.	T	G	12	6	18	0	0	18	0	0
11	17785412	.	C	A	11	5	16	0	0	16	0	0
11	17785591	.	A	G	14	11	25	0	0	25	0	0
11	17789069	.	G	T	5	9	14	0	0	14	0	0
11	17789210	.	T	C	2	3	5	0	0	5	0	0
11	17792991	.	C	T	0	3	3	0	3	6	0	0
11	17793676	.	G	A	1	1	2	0	0	2	0	0
11	17796869	.	C	T	0	1	1	0	2	3	0	0
11	17797072	.	T	C	1	0	1	0	1	2	0	0
11	17797280	.	G	A	0	1	1	0	0	1	0	0
11	17984308	.	T	C	4	6	10	0	1	11	0	0
11	17984405	.	G	A	0	4	4	0	3	7	0	0
11	17984426	.	G	C	0	5	5	0	1	6	0	0
11	17984459	.	G	T	1	4	5	0	0	5	0	0
11	17987289	.	C	A	1	3	4	0	0	4	0	0
11	18223383	.	C	T	7	7	14	0	1	15	0	0
11	18238076	.	C	T	7	6	13	0	0	13	0	0
11	18244388	.	T	C	12	11	23	0	0	23	0	0
11	18277370	.	C	T	0	2	2	0	2	4	0	0
11	18277388	.	G	A	2	0	2	0	0	2	0	0
11	18283013	.	G	A	5	3	8	0	0	8	0	0
11	18283268	.	T	C	2	6	8	0	0	8	0	0
11	18283440	.	A	G	2	2	4	0	0	4	0	0
11	18287280	.	A	G	4	5	9	0	0	9	0	0
11	18287283	.	A	T	4	5	9	0	0	9	0	0
11	18287693	.	A	G	6	10	16	0	0	16	0	0
11	18287895	.	T	G	6	7	13	0	1	14	0	0
11	18287940	.	A	T	12	5	17	0	0	17	0	0
11	18288018	.	T	C	10	7	17	0	0	17	0	0
11	18289425	.	T	G	4	1	5	0	0	5	0	0
11	18290095	.	G	A	2	3	5	0	1	6	0	0
11	18291865	.	A	G	3	0	3	0	0	3	0	0
11	18291961	.	C	T	0	5	5	0	3	8	0	0
11	18292595	.	C	T	0	1	1	0	3	4	0	0
11	18292633	.	A	G	5	5	10	0	0	10	0	0
11	18292699	.	T	A	2	2	4	0	0	4	0	0
11	18293166	.	A	G	3	1	4	0	0	4	0	0
11	18294857	.	A	G	3	3	6	0	0	6	0	0
11	18305756	.	G	A	0	3	3	0	0	3	0	0
11	18309570	.	T	C	2	2	4	0	0	4	0	0
11	18315955	.	C	T	2	2	4	0	0	4	0	0
11	18345272	.	C	A	0	2	2	0	1	3	0	0
11	18345539	.	C	A	1	2	3	0	0	3	0	0
11	18345580	.	T	C	5	3	8	0	0	8	0	0
11	18345719	.	T	G	6	6	12	0	0	12	0	0
11	18345825	.	A	T	2	3	5	0	0	5	0	0
11	18346827	.	C	T	0	1	1	0	3	4	0	0
11	18347094	.	C	T	4	2	6	0	0	6	0	0
11	18347895	.	T	A	2	2	4	0	0	4	0	0
11	18348039	.	C	A	1	2	3	0	0	3	0	0
11	18396932	.	G	A	3	3	6	0	0	6	0	0
11	18398033	.	A	T	0	2	2	0	0	2	0	0
11	18398101	.	C	T	1	2	3	0	0	3	0	0
11	18535666	.	C	T	11	18	29	0	2	31	0	0
11	18535761	.	G	C	18	23	41	0	0	41	0	0
11	18537180	.	A	G	4	10	14	0	1	15	0	0
11	18537244	.	G	A	6	9	15	0	1	16	0	0
11	18537447	.	T	C	5	7	12	0	3	15	0	0
11	18537561	.	T	A	10	3	13	0	1	14	0	0
11	18537636	.	T	A	9	5	14	0	0	14	0	0
11	18538219	.	A	T	14	8	22	0	1	23	0	0
11	18538259	.	G	T	13	7	20	0	1	21	0	0
11	18538336	.	A	C	10	0	10	0	11	21	0	0
11	18538362	.	T	C	10	0	10	0	11	21	0	0
11	18542168	.	T	C	1	2	3	0	1	4	0	0
11	18542585	.	A	G	1	5	6	0	0	6	0	0
11	18543520	.	T	A	1	2	3	0	1	4	0	0
11	18543543	.	T	A	2	2	4	0	1	5	0	0
11	18543828	.	T	C	4	5	9	0	0	9	0	0
11	18543870	.	A	G	4	3	7	0	0	7	0	0
11	18546276	.	T	A	2	4	6	0	1	7	0	0
11	18546378	.	T	A	8	3	11	0	0	11	0	0
11	18547125	.	A	G	14	7	21	0	1	22	0	0
11	18551011	.	C	A	0	1	1	0	1	2	0	0
11	18551605	.	C	T	0	2	2	0	4	6	0	0
11	18552231	.	A	T	0	1	1	0	0	1	0	0
11	18561418	.	T	A	3	2	5	0	0	5	0	0
11	18572364	.	T	C	6	0	6	0	7	13	0	0
11	18572574	.	G	A	7	9	16	0	0	16	0	0
11	18572586	.	C	T	7	8	15	0	1	16	0	0
11	18572640	.	T	G	8	5	13	0	1	14	0	0
11	18572648	.	G	A	8	7	15	0	0	15	0	0
11	18572751	.	G	A	3	8	11	0	1	12	0	0
11	18575095	.	C	A	8	4	12	0	1	13	0	0
11	18575161	.	C	G	7	6	13	0	0	13	0	0
11	18575173	.	G	T	7	6	13	0	0	13	0	0
11	18575258	.	T	G	4	2	6	0	0	6	0	0
11	18575326	.	G	T	4	3	7	0	0	7	0	0
11	18577787	.	A	G	0	1	1	0	0	1	0	0
11	18579921	.	C	T	0	7	7	0	3	10	0	0
11	18580191	.	T	A	3	2	5	0	0	5	0	0
11	18580293	.	T	C	4	0	4	0	2	6	0	0
11	18592065	.	A	G	5	2	7	0	0	7	0	0
11	18678027	.	G	A	0	2	2	0	1	3	0	0
11	18681078	.	C	G	1	2	3	0	0	3	0	0
11	18681382	.	A	G	3	0	3	0	3	6	0	0
11	18681607	.	G	A	2	0	2	0	0	2	0	0
11	18682826	.	T	C	0	1	1	0	1	2	0	0
11	18697720	.	A	G	8	3	11	0	0	11	0	0
11	18697817	.	T	G	11	9	20	0	0	20	0	0
11	18697822	.	A	G	11	0	11	0	9	20	0	0
11	18698138	.	A	G	5	2	7	0	5	12	0	0
11	18698184	.	G	A	0	8	8	0	7	15	0	0
11	18698221	.	A	C	5	5	10	0	0	10	0	0
11	18698526	.	G	A	10	7	17	0	0	17	0	0
11	18698767	.	A	T	3	2	5	0	0	5	0	0
11	18699104	.	T	C	4	12	16	0	0	16	0	0
11	18704378	.	G	C	3	0	3	0	11	14	0	0
11	18704500	.	G	A	10	13	23	0	1	24	0	0
11	18704620	.	C	T	1	21	22	0	15	37	0	0
11	18705108	.	A	G	11	15	26	0	0	26	0	0
11	18784949	.	A	T	3	14	17	0	0	17	0	0
11	18785130	.	A	G	15	16	31	0	2	33	0	0
11	18785250	.	C	T	0	22	22	0	16	38	0	0
11	18785294	.	T	G	15	15	30	0	0	30	0	0
11	18785296	.	C	T	15	15	30	0	0	30	0	0
11	18785346	.	A	T	16	13	29	0	1	30	0	0
11	18785410	.	G	A	11	16	27	0	0	27	0	0
11	18785421	.	A	G	12	16	28	0	0	28	0	0
11	18785570	.	T	A	9	11	20	0	0	20	0	0
11	18785600	.	A	T	8	9	17	0	0	17	0	0
11	18785623	.	A	T	8	5	13	0	0	13	0	0
11	18785749	.	C	G	3	3	6	0	1	7	0	0
11	18785921	.	G	A	7	20	27	0	2	29	0	0
11	18785975	.	T	C	15	12	27	0	0	27	0	0
11	18785997	.	T	A	14	11	25	0	2	27	0	0
11	18786085	.	A	T	8	13	21	0	0	21	0	0
11	18786250	.	A	C	15	20	35	0	1	36	0	0
11	18786329	.	C	A	0	7	7	0	9	16	0	0
11	18794157	.	C	A	0	4	4	0	2	6	0	0
11	18799800	.	C	T	4	6	10	0	0	10	0	0
11	18799873	.	G	A	0	1	1	0	0	1	0	0
11	18802570	.	T	C	3	4	7	0	0	7	0	0
11	18802815	.	G	C	5	4	9	0	0	9	0	0
11	18802865	.	C	G	3	4	7	0	0	7	0	0
11	18802879	.	A	G	3	3	6	0	0	6	0	0
11	18803621	.	A	G	2	1	3	0	0	3	0	0
11	18805988	.	A	T	2	0	2	0	0	2	0	0
11	18809354	.	G	A	0	0	0	0	1	1	0	0
11	18810393	.	A	G	1	1	2	0	0	2	0	0
11	19041518	.	G	A	3	1	4	0	1	5	0	0
11	19041647	.	T	G	1	1	2	0	0	2	0	0
11	19042020	.	T	C	5	6	11	0	1	12	0	0
11	19042026	.	A	G	5	5	10	0	0	10	0	0
11	19068394	.	C	T	2	3	5	0	0	5	0	0
11	19072608	.	T	A	24	15	39	0	3	42	0	0
11	19072746	.	A	T	1	1	2	0	0	2	0	0
11	19085099	.	G	A	14	7	21	0	0	21	0	0
11	19089286	.	A	G	27	22	49	0	0	49	0	0
11	19089362	.	A	G	28	32	60	0	1	61	0	0
11	19089368	.	C	T	30	31	61	0	3	64	0	0
11	19089608	.	G	A	2	23	25	0	30	55	0	0
11	19089839	.	G	A	0	19	19	0	18	37	0	0
11	19090203	.	G	A	2	16	18	0	15	33	0	0
11	19370862	.	G	C	1	2	3	0	1	4	0	0
11	19434043	.	G	C	6	7	13	0	0	13	0	0
11	19434095	.	A	C	2	5	7	0	1	8	0	0
11	19434239	.	T	C	5	2	7	0	0	7	0	0
11	19434279	.	T	C	1	1	2	0	0	2	0	0
11	19462920	.	C	T	3	3	6	0	0	6	0	0
11	19462971	.	A	G	5	0	5	0	8	13	0	0
11	19464759	.	C	G	6	9	15	0	0	15	0	0
11	19464813	.	A	G	6	9	15	0	0	15	0	0
11	19464957	.	C	G	4	0	4	0	8	12	0	0
11	19465029	.	T	C	10	8	18	0	0	18	0	0
11	19465080	.	T	C	5	13	18	0	0	18	0	0
11	19465428	.	C	T	7	4	11	0	0	11	0	0
11	19467792	.	G	A	1	24	25	0	16	41	0	0
11	19467838	.	C	T	16	21	37	0	3	40	0	0
11	19468104	.	C	T	13	24	37	0	1	38	0	0
11	19468123	.	T	C	18	23	41	0	0	41	0	0
11	19468301	.	A	G	17	1	18	0	17	35	0	0
11	19468547	.	C	A	15	16	31	0	0	31	0	0
11	19468697	.	G	T	13	17	30	0	1	31	0	0
11	19468718	.	A	G	11	17	28	0	0	28	0	0
11	19502433	.	C	T	12	23	35	0	2	37	0	0
11	19502479	.	T	C	15	13	28	0	1	29	0	0
11	19503920	.	T	A	10	13	23	0	1	24	0	0
11	19506155	.	A	G	1	3	4	0	0	4	0	0
11	19506260	.	C	T	14	11	25	0	0	25	0	0
11	19509643	.	T	C	4	2	6	0	0	6	0	0
11	19511392	.	G	A	6	10	16	0	0	16	0	0
11	19511922	.	A	C	2	6	8	0	0	8	0	0
11	19511983	.	G	A	4	7	11	0	0	11	0	0
11	19512285	.	T	C	2	2	4	0	1	5	0	0
11	19512430	.	C	T	0	6	6	1	4	11	0	0
11	19512947	.	A	T	6	2	8	0	0	8	0	0
11	19513031	.	C	T	3	2	5	0	0	5	0	0
11	19513033	.	T	A	3	2	5	0	0	5	0	0
11	19513358	.	T	C	3	3	6	0	0	6	0	0
11	19513364	.	T	C	4	0	4	0	3	7	0	0
11	19513395	.	A	G	1	2	3	0	0	3	0	0
11	19513639	.	C	T	1	3	4	0	0	4	0	0
11	19513722	.	C	A	0	5	5	0	5	10	0	0
11	19513725	.	A	G	4	5	9	0	1	10	0	0
11	19514511	.	A	C	1	5	6	0	0	6	0	0
11	19515126	.	C	T	1	2	3	0	1	4	0	0
11	19515190	.	G	T	4	2	6	0	0	6	0	0
11	19604223	.	A	C	8	7	15	0	1	16	0	0
11	19626479	.	C	A	3	2	5	0	0	5	0	0
11	19626534	.	A	T	8	5	13	0	0	13	0	0
11	19626556	.	A	G	11	3	14	0	0	14	0	0
11	19632816	.	G	A	3	2	5	0	0	5	0	0
11	19733160	.	A	G	7	2	9	0	0	9	0	0
11	19733388	.	A	G	3	4	7	0	0	7	0	0
11	19876948	.	A	G	1	2	3	0	0	3	0	0
11	19951119	.	G	A	1	2	3	0	0	3	0	0
11	19999131	.	T	C	1	2	3	0	0	3	0	0
11	20017802	.	A	G	2	3	5	0	1	6	0	0
11	20058882	.	C	A	1	2	3	0	0	3	0	0
11	20092194	.	C	T	1	2	3	0	0	3	0	0
11	20657517	.	A	C	1	2	3	0	0	3	0	0
11	20657661	.	T	C	1	2	3	0	0	3	0	0
11	21158792	.	G	A	0	1	1	0	0	1	0	0
11	21173971	.	T	C	2	2	4	0	1	5	0	0
11	21217518	.	T	C	1	1	2	0	0	2	0	0
11	21217542	.	T	C	2	2	4	0	0	4	0	0
11	21259435	.	A	C	2	6	8	0	1	9	0	0
11	21259773	.	G	C	5	5	10	0	0	10	0	0
11	21260009	.	T	C	1	5	6	0	0	6	0	0
11	21260018	.	A	T	1	5	6	0	0	6	0	0
11	21260213	.	G	A	2	3	5	0	0	5	0	0
11	21260676	.	C	T	10	6	16	0	0	16	0	0
11	21261031	.	T	C	4	2	6	0	0	6	0	0
11	21278950	.	T	A	17	12	29	0	3	32	0	0
11	21279194	.	G	T	20	11	31	0	2	34	1	0
11	21280202	.	A	T	12	8	20	0	1	21	0	0
11	21280504	.	A	C	7	7	14	0	0	14	0	0
11	21280555	.	A	T	1	6	7	0	0	7	0	0
11	21280575	.	G	C	1	8	9	0	0	9	0	0
11	21280689	.	T	A	9	7	16	0	1	17	0	0
11	21280801	.	T	A	8	11	19	0	3	22	0	0
11	21280974	.	G	A	11	10	21	0	0	21	0	0
11	21281087	.	C	T	12	14	26	0	1	27	0	0
11	21281110	.	G	A	13	24	37	0	0	37	0	0
11	21281219	.	G	A	12	13	25	0	3	28	0	0
11	21281269	.	T	C	8	12	20	0	1	21	0	0
11	21281273	.	A	G	8	11	19	0	1	21	1	0
11	21281516	.	G	A	5	13	18	0	4	22	0	0
11	21281657	.	T	C	15	6	21	0	1	22	0	0
11	21281798	.	T	C	8	7	15	0	0	15	0	0
11	21281821	.	A	T	5	6	11	0	1	12	0	0
11	21281951	.	A	G	1	1	2	0	0	2	0	0
11	21282068	.	G	A	10	3	13	0	1	14	0	0
11	21282072	.	G	A	9	3	12	0	1	13	0	0
11	21282302	.	A	C	3	2	5	0	2	7	0	0
11	21282414	.	G	A	5	6	11	0	1	12	0	0
11	21282424	.	C	G	4	8	12	0	2	14	0	0
11	21282500	.	C	A	5	8	13	0	0	13	0	0
11	21282571	.	G	A	3	6	9	0	1	10	0	0
11	21282673	.	G	T	10	8	18	0	0	18	0	0
11	21282747	.	T	C	6	6	12	0	1	13	0	0
11	21282809	.	A	T	1	7	8	0	0	8	0	0
11	21282957	.	T	C	5	0	5	0	8	13	0	0
11	21283211	.	G	A	1	3	4	0	0	4	0	0
11	21284382	.	G	A	2	2	4	0	0	4	0	0
11	21284588	.	A	G	3	3	6	0	2	8	0	0
11	21284701	.	A	C	11	0	11	0	6	17	0	0
11	21284733	.	C	T	10	9	19	0	0	19	0	0
11	21323564	.	A	G	1	4	5	0	0	5	0	0
11	21352744	.	G	C	2	9	11	0	0	11	0	0
11	21352773	.	A	T	2	8	10	0	0	10	0	0
11	21363479	.	A	G	1	2	3	0	0	3	0	0
11	21363480	.	A	C	1	0	1	0	2	3	0	0
11	21407500	.	G	A	10	13	23	0	1	24	0	0
11	21407692	.	C	G	14	7	21	0	3	24	0	0
11	21407782	.	G	T	7	12	19	0	0	19	0	0
11	21408328	.	T	C	9	4	13	0	0	13	0	0
11	21409415	.	A	T	8	10	18	0	2	20	0	0
11	21409417	.	T	C	9	11	20	0	0	20	0	0
11	21436140	.	C	T	0	2	2	0	0	2	0	0
11	21594393	.	G	A	1	3	4	0	0	4	0	0
11	21594510	.	C	T	1	2	3	0	0	3	0	0
11	21594552	.	G	A	2	3	5	0	1	6	0	0
11	21594995	.	G	A	2	2	4	0	0	4	0	0
11	21595189	.	G	A	3	2	5	0	0	5	0	0
11	21595191	.	G	A	0	2	2	0	3	5	0	0
11	21595615	.	G	A	2	2	4	0	0	4	0	0
11	21595971	.	T	A	2	5	7	0	0	7	0	0
11	21595981	.	A	T	2	3	5	0	1	6	0	0
11	21596133	.	A	C	3	6	9	0	0	9	0	0
11	21596134	.	G	A	3	6	9	0	0	9	0	0
11	21596459	.	T	C	3	6	9	0	0	9	0	0
11	21596492	.	A	G	3	1	4	0	9	13	0	0
11	21596865	.	A	T	5	2	7	0	0	7	0	0
11	21596926	.	T	A	6	2	8	0	0	8	0	0
11	21596931	.	C	T	6	1	7	0	0	7	0	0
11	21597055	.	T	G	6	11	17	0	0	17	0	0
11	21597166	.	A	G	7	0	7	0	5	12	0	0
11	21597256	.	A	C	6	3	9	0	0	9	0	0
11	21597584	.	T	C	4	7	11	0	1	12	0	0
11	21597659	.	T	C	4	4	8	0	2	10	0	0
11	21597676	.	C	A	5	4	9	0	0	9	0	0
11	21597702	.	A	G	4	5	9	0	0	9	0	0
11	21597754	.	T	G	2	4	6	0	0	6	0	0
11	21597988	.	C	T	8	9	17	0	0	17	0	0
11	21598002	.	T	C	8	5	13	0	0	13	0	0
11	21598036	.	T	C	7	3	10	0	2	12	0	0
11	21598121	.	G	A	0	3	3	0	1	4	0	0
11	22091956	.	C	A	16	12	28	0	0	28	0	0
11	22092158	.	G	A	17	22	39	0	2	41	0	0
11	22092244	.	A	T	12	7	19	0	2	21	0	0
11	22092689	.	T	A	12	7	19	0	2	21	0	0
11	22093634	.	G	A	25	10	35	0	3	38	0	0
11	22093848	.	A	C	12	12	24	0	5	29	0	0
11	22094072	.	T	C	8	12	20	0	2	22	0	0
11	22363756	.	A	T	9	8	17	0	1	18	0	0
11	22363768	.	A	T	8	9	17	0	1	18	0	0
11	22363994	.	T	G	10	11	21	0	1	22	0	0
11	22364128	.	A	T	6	7	13	0	0	13	0	0
11	22364140	.	T	A	3	7	10	0	1	11	0	0
11	22364228	.	G	A	8	7	15	0	0	15	0	0
11	22364359	.	A	G	4	5	9	0	1	10	0	0
11	22364416	.	A	G	5	5	10	0	0	10	0	0
11	22364502	.	C	A	0	10	10	0	8	18	0	0
11	22364558	.	T	C	9	13	22	0	0	22	0	0
11	22366841	.	T	C	1	1	2	0	0	2	0	0
11	22367200	.	A	T	15	7	22	0	0	22	0	0
11	22367251	.	A	G	8	6	14	0	0	14	0	0
11	22369932	.	G	A	4	3	7	0	0	7	0	0
11	22369981	.	A	G	10	10	20	0	0	20	0	0
11	22369991	.	C	A	8	10	18	0	1	19	0	0
11	22371944	.	T	G	6	5	11	0	1	12	0	0
11	22371990	.	T	G	4	4	8	0	2	10	0	0
11	22374626	.	T	C	6	4	10	0	0	10	0	0
11	22374890	.	G	A	0	4	4	0	3	7	0	0
11	22495182	.	T	C	4	3	7	0	1	8	0	0
11	22505058	.	T	C	1	1	2	0	0	2	0	0
11	22582243	.	G	C	12	3	15	0	0	15	0	0
11	22582706	.	T	C	8	4	12	0	0	12	0	0
11	22582830	.	T	C	7	7	14	0	0	14	0	0
11	22582878	.	A	G	6	6	12	0	0	12	0	0
11	22582923	.	C	T	6	4	10	0	2	12	0	0
11	22583023	.	A	T	7	4	11	0	0	11	0	0
11	22583139	.	G	T	7	2	9	0	1	10	0	0
11	22583547	.	G	T	11	6	17	0	1	18	0	0
11	22583759	.	T	C	8	4	12	0	0	12	0	0
11	22583807	.	T	C	10	8	18	0	0	18	0	0
11	22583858	.	C	A	14	5	19	0	0	19	0	0
11	22583974	.	T	C	12	6	18	0	0	18	0	0
11	22583984	.	T	C	11	7	18	0	0	18	0	0
11	22584173	.	G	A	5	4	9	0	2	11	0	0
11	22584229	.	T	C	5	5	10	0	1	11	0	0
11	22584365	.	G	A	8	3	11	0	0	11	0	0
11	22623421	.	C	G	2	0	2	0	5	7	0	0
11	22623502	.	T	G	1	3	4	0	0	4	0	0
11	22624550	.	A	G	4	1	5	0	0	5	0	0
11	22629325	.	A	C	2	3	5	0	0	5	0	0
11	22629675	.	G	C	2	3	5	0	0	5	0	0
11	22629891	.	A	T	1	2	3	0	1	4	0	0
11	22630020	.	A	T	4	3	7	0	0	7	0	0
11	22630034	.	T	C	4	2	6	0	0	6	0	0
11	22630190	.	T	A	4	6	10	0	0	10	0	0
11	22630252	.	G	T	1	2	3	0	0	3	0	0
11	22630264	.	T	G	0	3	3	0	0	3	0	0
11	22630328	.	T	C	1	2	3	0	0	3	0	0
11	22891305	.	C	G	15	10	25	0	0	25	0	0
11	22891574	.	G	A	21	8	29	0	1	30	0	0
11	22891575	.	T	C	17	0	17	0	13	30	0	0
11	22891624	.	C	T	10	13	23	0	2	25	0	0
11	22891683	.	G	A	18	16	34	0	1	35	0	0
11	22891692	.	C	T	1	16	17	0	20	37	0	0
11	22892028	.	C	T	21	15	36	0	1	37	0	0
11	22892205	.	A	G	23	21	44	0	0	44	0	0
11	22892345	.	C	A	2	10	12	0	12	24	0	0
11	22892395	.	G	A	10	16	26	0	1	27	0	0
11	22892432	.	C	T	10	15	25	0	0	25	0	0
11	22892534	.	G	A	16	12	28	0	1	29	0	0
11	22892573	.	G	A	15	13	28	0	1	29	0	0
11	22892859	.	A	T	18	12	30	0	2	32	0	0
11	22906133	.	T	G	13	7	20	0	0	20	0	0
11	22906383	.	T	C	2	0	2	0	0	2	0	0
11	22911841	.	C	G	8	6	14	0	0	14	0	0
11	22915952	.	T	A	0	2	2	0	0	2	0	0
11	22920796	.	T	A	13	6	19	0	0	19	0	0
11	22921124	.	G	T	34	21	55	0	4	59	0	0
11	22921168	.	C	T	25	28	53	0	6	59	0	0
11	22921326	.	G	A	23	24	47	0	2	49	0	0
11	22921568	.	G	C	24	31	55	0	4	59	0	0
11	22921800	.	T	G	26	21	47	0	3	50	0	0
11	22921865	.	T	C	20	0	20	0	29	49	0	0
11	22921953	.	C	T	26	23	49	0	2	51	0	0
11	22922075	.	A	G	24	29	53	0	0	53	0	0
11	22922114	.	A	T	25	21	46	0	5	51	0	0
11	22922115	.	A	T	25	22	47	0	4	51	0	0
11	22922251	.	C	T	19	27	46	0	1	47	0	0
11	22922266	.	A	G	19	24	43	0	2	45	0	0
11	22922290	.	A	G	22	20	42	0	2	44	0	0
11	22922309	.	T	A	23	23	46	0	0	46	0	0
11	22922333	.	A	T	19	21	40	0	4	44	0	0
11	22922355	.	A	T	20	19	39	0	5	44	0	0
11	22922405	.	G	A	25	26	51	0	3	54	0	0
11	22922668	.	T	C	24	26	50	0	2	52	0	0
11	22922762	.	T	A	27	17	44	0	3	47	0	0
11	22922841	.	C	A	23	25	48	0	0	48	0	0
11	22922909	.	A	T	21	23	44	0	0	44	0	0
11	22923397	.	A	T	19	15	34	0	1	35	0	0
11	22923429	.	T	A	16	11	27	0	2	37	8	0
11	22923441	.	T	G	36	10	46	0	0	46	0	0
11	22923485	.	G	T	26	25	51	0	3	54	0	0
11	22923613	.	T	C	31	0	31	0	18	49	0	0
11	22924449	.	C	T	10	8	18	0	0	18	0	0
11	22924505	.	A	C	5	6	11	0	0	11	0	0
11	22924650	.	A	C	10	16	26	0	1	27	0	0
11	22924746	.	C	T	0	14	14	0	8	22	0	0
11	22925048	.	G	A	12	11	23	0	0	23	0	0
11	22925266	.	G	A	19	15	34	0	0	34	0	0
11	22925370	.	A	G	21	23	44	0	0	44	0	0
11	22926213	.	A	C	16	0	16	1	12	29	0	0
11	22950984	.	C	T	14	18	32	0	1	33	0	0
11	22964006	.	G	T	4	5	9	0	1	11	1	0
11	22969056	.	T	C	7	0	7	0	10	17	0	0
11	22969098	.	C	G	10	9	19	0	0	19	0	0
11	22983958	.	A	T	3	4	7	0	0	7	0	0
11	22983965	.	C	G	0	4	4	0	3	7	0	0
11	22984008	.	G	A	2	1	3	0	0	3	0	0
11	22995813	.	A	G	2	0	2	0	0	2	0	0
11	23312376	.	A	C	1	1	2	0	2	5	1	0
11	23312451	.	T	A	3	6	9	0	0	10	1	0
11	23312543	.	G	A	4	4	8	0	0	8	0	0
11	23312583	.	G	T	3	4	7	0	1	8	0	0
11	23313911	.	G	A	4	4	8	0	0	8	0	0
11	23313928	.	T	C	4	4	8	0	0	8	0	0
11	23343154	.	A	G	4	10	14	0	1	15	0	0
11	23343231	.	G	A	6	12	18	0	1	19	0	0
11	23343594	.	T	A	12	11	23	0	0	23	0	0
11	23343775	.	A	G	8	13	21	0	1	22	0	0
11	23343929	.	G	A	4	6	10	0	3	13	0	0
11	23344143	.	C	A	9	10	19	0	1	20	0	0
11	23344421	.	G	C	9	7	16	0	2	18	0	0
11	23344790	.	T	A	10	11	21	0	1	22	0	0
11	23352194	.	C	T	1	0	1	0	0	1	0	0
11	23353706	.	C	T	2	0	2	0	0	2	0	0
11	23377379	.	A	G	4	1	5	0	1	6	0	0
11	23377418	.	A	C	4	0	4	0	4	8	0	0
11	23595538	.	G	T	3	3	6	0	0	6	0	0
11	23595627	.	C	T	5	4	9	0	0	9	0	0
11	23595766	.	C	A	5	12	17	0	0	17	0	0
11	23596240	.	A	G	20	5	25	0	0	25	0	0
11	23596264	.	G	T	20	8	28	0	2	30	0	0
11	23596333	.	T	C	8	10	18	0	1	19	0	0
11	23596725	.	T	C	10	7	17	0	1	18	0	0
11	23596732	.	A	T	8	8	16	0	1	17	0	0
11	23597047	.	G	A	4	4	8	0	0	8	0	0
11	23597310	.	A	G	4	7	11	0	0	11	0	0
11	23597589	.	C	T	0	3	3	0	4	7	0	0
11	23604954	.	A	G	2	2	4	0	0	4	0	0
11	23659051	.	G	A	1	3	4	0	0	4	0	0
11	23828197	.	G	C	0	3	3	0	0	3	0	0
11	23828245	.	A	G	1	4	5	0	0	5	0	0
11	23839022	.	C	T	3	2	5	0	0	5	0	0
11	23839770	.	T	C	2	1	3	0	0	3	0	0
11	23842789	.	A	G	1	0	1	0	0	1	0	0
11	23843072	.	T	A	3	3	6	0	1	7	0	0
11	23843117	.	A	T	7	5	12	0	0	12	0	0
11	23843180	.	G	A	1	1	2	0	0	2	0	0
11	23843362	.	A	G	0	0	0	0	1	1	0	0
11	23845323	.	C	T	0	2	2	0	0	2	0	0
11	23845329	.	C	A	1	0	1	0	0	1	0	0
11	23856440	.	A	G	3	5	8	0	0	8	0	0
11	23879654	.	C	A	16	13	29	0	1	30	0	0
11	23879825	.	A	T	11	14	25	0	0	25	0	0
11	23879938	.	C	T	10	7	17	0	3	20	0	0
11	23880084	.	T	C	8	5	13	0	0	13	0	0
11	23880476	.	T	G	3	4	7	0	1	8	0	0
11	23880486	.	G	T	6	4	10	0	1	11	0	0
11	23880607	.	C	T	3	10	13	0	0	13	0	0
11	23880631	.	G	T	2	8	10	0	1	11	0	0
11	23881038	.	C	A	6	2	8	0	0	8	0	0
11	23881070	.	C	T	7	5	12	0	0	12	0	0
11	23881101	.	G	A	6	4	10	0	1	11	0	0
11	23881131	.	G	C	8	4	12	0	0	12	0	0
11	23881152	.	G	A	0	6	6	0	5	11	0	0
11	23881238	.	A	T	4	3	7	0	0	7	0	0
11	23881247	.	A	T	3	3	6	0	0	6	0	0
11	23881866	.	A	G	3	6	9	0	0	9	0	0
11	23882438	.	A	G	7	11	18	0	1	19	0	0
11	23882525	.	T	C	13	4	17	0	1	18	0	0
11	23882572	.	A	T	11	10	21	0	1	22	0	0
11	23882646	.	A	T	12	18	30	0	2	32	0	0
11	23882655	.	C	T	16	12	28	0	3	31	0	0
11	23882747	.	C	T	23	10	33	0	1	34	0	0
11	23882748	.	C	T	24	10	34	0	0	34	0	0
11	23882836	.	A	G	7	15	22	0	3	25	0	0
11	23883235	.	A	T	3	2	5	0	0	5	0	0
11	23883302	.	G	A	9	8	17	0	1	18	0	0
11	23883699	.	A	T	11	9	20	0	0	20	0	0
11	23884416	.	G	A	27	18	45	0	0	45	0	0
11	23884419	.	T	A	19	26	45	0	1	47	1	0
11	23884742	.	G	A	11	14	25	0	1	26	0	0
11	23976169	.	C	T	5	6	11	0	2	13	0	0
11	24035841	.	G	T	0	3	3	0	3	6	0	0
11	24036035	.	C	T	1	5	6	0	0	6	0	0
11	24038115	.	A	G	0	2	2	0	0	2	0	0
11	24038795	.	T	G	4	2	6	0	0	6	0	0
11	24039086	.	A	G	14	13	27	0	0	27	0	0
11	24039241	.	A	G	13	0	13	0	16	29	0	0
11	24039246	.	T	G	16	12	28	0	1	29	0	0
11	24039728	.	G	A	9	15	24	0	1	25	0	0
11	24039732	.	C	T	10	16	26	0	2	28	0	0
11	24039773	.	A	C	14	19	33	0	1	34	0	0
11	24039791	.	A	C	16	18	34	0	1	35	0	0
11	24039912	.	T	C	14	16	30	0	0	30	0	0
11	24039949	.	C	A	15	16	31	0	1	32	0	0
11	24043500	.	C	T	5	5	10	0	0	10	0	0
11	24044318	.	G	T	14	9	23	0	1	24	0	0
11	24044351	.	C	T	11	10	21	0	1	22	0	0
11	24044413	.	T	A	6	15	21	0	0	21	0	0
11	24046235	.	C	T	6	9	15	0	0	15	0	0
11	24050607	.	G	A	2	7	9	0	2	11	0	0
11	24054359	.	G	T	2	3	5	0	0	5	0	0
11	24055417	.	A	G	4	2	6	0	0	6	0	0
11	24055699	.	A	T	8	9	17	0	0	17	0	0
11	24055884	.	A	G	10	1	11	0	15	26	0	0
11	24056205	.	C	T	13	19	32	0	0	32	0	0
11	24056377	.	G	C	19	13	32	0	3	35	0	0
11	24058749	.	G	A	10	7	17	0	0	17	0	0
11	24058963	.	G	A	5	7	12	0	0	12	0	0
11	24059236	.	T	A	2	9	11	0	1	12	0	0
11	24059268	.	G	A	6	3	9	0	1	10	0	0
11	24059476	.	A	T	6	6	12	0	0	12	0	0
11	24059630	.	C	A	2	7	9	0	0	9	0	0
11	24059873	.	A	T	6	6	12	0	0	12	0	0
11	24059933	.	G	A	5	4	9	0	0	9	0	0
11	24059963	.	G	A	7	4	11	0	0	11	0	0
11	24187748	.	A	G	4	5	9	0	0	9	0	0
11	24188088	.	G	T	6	12	18	0	1	19	0	0
11	24188221	.	C	T	0	5	5	0	4	9	0	0
11	24188227	.	G	T	5	4	9	0	0	9	0	0
11	24188385	.	T	A	11	8	19	0	0	19	0	0
11	24188436	.	T	A	9	5	14	0	1	15	0	0
11	24188437	.	G	T	8	6	14	0	1	15	0	0
11	24188884	.	C	T	0	3	3	0	2	5	0	0
11	24189765	.	G	A	3	7	10	0	0	10	0	0
11	24189786	.	C	T	0	8	8	0	6	14	0	0
11	24189811	.	G	C	4	4	8	0	0	8	0	0
11	24190606	.	C	T	3	4	7	0	1	8	0	0
11	24190821	.	G	A	1	1	2	0	1	3	0	0
11	24190912	.	T	C	3	2	5	0	0	5	0	0
11	24190989	.	A	T	4	2	6	0	0	6	0	0
11	24191019	.	G	A	3	2	5	0	0	5	0	0
11	24340745	.	T	A	5	6	11	0	1	12	0	0
11	24340931	.	G	A	4	6	10	0	0	10	0	0
11	24343537	.	T	C	2	2	4	0	0	4	0	0
11	24344983	.	T	G	20	12	32	0	1	33	0	0
11	24348553	.	C	G	3	5	8	0	0	8	0	0
11	24360891	.	C	G	7	4	11	0	0	11	0	0
11	24360924	.	A	G	11	6	17	0	0	17	0	0
11	24361207	.	T	G	6	4	10	0	0	10	0	0
11	24369586	.	A	G	4	6	10	0	1	11	0	0
11	24369652	.	G	A	2	0	2	0	0	2	0	0
11	24379360	.	C	T	2	3	5	0	0	5	0	0
11	24379384	.	G	A	2	5	7	0	0	7	0	0
11	24382547	.	C	T	0	2	2	0	2	4	0	0
11	24465598	.	A	C	5	3	8	0	0	8	0	0
11	24471518	.	C	T	0	5	5	0	8	13	0	0
11	24472065	.	A	G	3	6	9	0	0	9	0	0
11	24472145	.	T	A	1	3	4	0	0	4	0	0
11	24472176	.	A	G	1	3	4	0	0	4	0	0
11	24474181	.	G	A	3	3	6	0	0	6	0	0
11	24474384	.	G	A	1	2	3	0	0	3	0	0
11	24474483	.	A	C	1	2	3	0	2	5	0	0
11	24476587	.	C	T	2	3	5	0	1	6	0	0
11	24481382	.	G	A	2	4	6	0	0	6	0	0
11	24620848	.	G	C	2	2	4	0	0	4	0	0
11	24643337	.	T	G	1	3	4	0	0	4	0	0
11	24645757	.	T	C	2	0	2	0	0	2	0	0
11	24658335	.	T	C	3	0	3	0	1	4	0	0
11	24658606	.	G	A	0	5	5	0	5	10	0	0
11	24658696	.	C	T	0	2	2	0	0	2	0	0
11	24662830	.	T	A	4	7	11	0	1	12	0	0
11	24662898	.	C	A	6	6	12	0	0	12	0	0
11	24663808	.	T	C	3	6	9	0	0	9	0	0
11	24671876	.	A	T	2	3	5	0	0	5	0	0
11	24672292	.	C	T	7	2	9	0	2	11	0	0
11	24672412	.	A	G	1	2	3	0	0	3	0	0
11	24672571	.	C	T	0	4	4	0	1	5	0	0
11	24672607	.	A	G	1	4	5	0	0	5	0	0
11	24672703	.	C	T	1	2	3	0	0	3	0	0
11	24786415	.	G	A	0	2	2	0	2	4	0	0
11	24786466	.	T	A	1	2	3	0	0	3	0	0
11	24792102	.	T	A	2	3	5	0	1	6	0	0
11	24792201	.	G	A	1	1	2	0	0	2	0	0
11	24796820	.	T	G	2	0	2	0	1	3	0	0
11	24799378	.	G	A	10	5	15	0	1	16	0	0
11	24799408	.	G	A	1	4	5	0	6	11	0	0
11	24799433	.	T	G	2	4	6	0	1	7	0	0
11	24799495	.	T	A	3	2	5	0	0	5	0	0
11	24804565	.	A	T	0	4	4	0	0	4	0	0
11	24805106	.	A	C	4	5	9	0	0	9	0	0
11	24809738	.	C	T	18	19	37	0	1	38	0	0
11	24810510	.	C	A	4	4	8	0	2	10	0	0
11	24813651	.	G	A	17	5	22	0	0	22	0	0
11	24813810	.	A	G	16	17	33	0	0	33	0	0
11	24814014	.	A	G	12	17	29	0	0	29	0	0
11	24814110	.	G	T	21	22	43	0	2	45	0	0
11	24816326	.	A	T	5	1	6	0	1	7	0	0
11	24816471	.	C	T	1	0	1	0	0	1	0	0
11	24816472	.	C	T	1	0	1	0	0	1	0	0
11	24816648	.	G	A	4	1	5	0	0	5	0	0
11	24817054	.	T	A	6	9	15	0	0	15	0	0
11	24817198	.	G	A	7	4	11	0	0	11	0	0
11	24817207	.	C	T	6	3	9	0	0	9	0	0
11	24817304	.	C	A	1	2	3	0	0	3	0	0
11	24817352	.	G	T	5	3	8	0	0	8	0	0
11	24819457	.	G	T	2	3	5	0	0	5	0	0
11	24819467	.	A	G	3	2	5	0	0	5	0	0
11	24819667	.	C	T	3	11	14	0	0	14	0	0
11	24823323	.	G	A	0	4	4	0	4	8	0	0
11	24825549	.	C	T	1	0	1	0	0	1	0	0
11	24825583	.	G	A	1	0	1	0	0	1	0	0
11	24825598	.	C	T	0	1	1	0	0	1	0	0
11	24835762	.	A	C	2	3	5	0	0	5	0	0
11	24835764	.	A	G	2	3	5	0	0	5	0	0
11	24836409	.	C	T	5	2	7	0	0	7	0	0
11	24843031	.	C	A	7	10	17	0	1	18	0	0
11	24843058	.	G	A	0	6	6	0	8	14	0	0
11	24843079	.	A	G	6	0	6	0	7	13	0	0
11	24843154	.	G	A	0	4	4	0	5	9	0	0
11	24843219	.	C	T	5	7	12	0	0	12	0	0
11	24848221	.	T	A	5	5	10	0	1	11	0	0
11	24848409	.	G	T	2	3	5	0	0	5	0	0
11	24850428	.	A	G	2	2	4	0	1	5	0	0
11	24851182	.	A	T	6	6	12	0	1	13	0	0
11	24851804	.	T	C	2	2	4	0	1	5	0	0
11	24856191	.	T	C	0	1	1	0	0	1	0	0
11	24862737	.	C	T	3	3	6	0	0	6	0	0
11	24874841	.	A	G	9	6	15	0	2	17	0	0
11	24875331	.	T	C	12	10	22	0	0	22	0	0
11	24876335	.	T	C	1	2	3	0	0	3	0	0
11	24876425	.	T	A	2	0	2	0	0	2	0	0
11	24878011	.	C	T	4	3	7	0	0	7	0	0
11	24880785	.	T	C	5	5	10	0	0	10	0	0
11	24884840	.	G	C	11	13	24	0	0	24	0	0
11	24884967	.	C	T	16	11	27	0	1	28	0	0
11	24885282	.	T	C	9	6	15	0	1	16	0	0
11	24885332	.	C	T	4	2	6	0	0	6	0	0
11	24885357	.	A	T	4	4	8	0	0	8	0	0
11	24885810	.	A	C	5	4	9	0	0	9	0	0
11	24885839	.	A	G	9	0	9	0	3	12	0	0
11	24885901	.	A	T	6	5	11	0	0	11	0	0
11	24885928	.	C	T	5	6	11	0	1	12	0	0
11	24885937	.	C	T	6	7	13	0	0	13	0	0
11	24885983	.	A	G	11	1	12	0	4	16	0	0
11	24886152	.	C	A	20	17	37	0	0	37	0	0
11	24886602	.	G	T	0	7	7	0	5	12	0	0
11	24886672	.	T	C	4	8	12	0	0	12	0	0
11	24886686	.	G	T	9	7	16	0	1	17	0	0
11	24886739	.	G	T	17	11	28	0	0	28	0	0
11	24886754	.	G	A	20	8	28	0	1	29	0	0
11	24887321	.	T	C	19	14	33	0	0	33	0	0
11	24887501	.	C	T	19	12	31	0	1	32	0	0
11	24887652	.	G	A	17	9	26	0	0	26	0	0
11	24887703	.	C	T	7	5	12	0	3	15	0	0
11	24888272	.	C	T	10	6	16	0	1	17	0	0
11	24888379	.	C	A	14	12	26	0	1	27	0	0
11	24901897	.	C	T	11	3	14	0	0	14	0	0
11	24903143	.	G	T	9	10	19	0	0	19	0	0
11	24905477	.	C	T	25	17	42	0	2	44	0	0
11	24905526	.	G	T	22	18	40	0	1	41	0	0
11	24905541	.	C	T	24	20	44	0	0	44	0	0
11	24905574	.	G	A	25	14	39	0	2	41	0	0
11	24905576	.	C	A	27	14	41	0	0	41	0	0
11	24905632	.	T	G	10	27	37	0	3	40	0	0
11	24905692	.	G	A	0	14	14	0	26	40	0	0
11	24905742	.	C	T	23	16	39	0	0	39	0	0
11	24905748	.	A	G	19	18	37	0	2	39	0	0
11	24906177	.	G	T	11	10	21	0	0	21	0	0
11	24906178	.	G	A	11	10	21	0	0	21	0	0
11	24966841	.	G	A	0	5	5	0	3	8	0	0
11	24972320	.	A	T	4	3	7	0	0	7	0	0
11	24972324	.	T	C	4	3	7	0	0	7	0	0
11	24972396	.	G	A	0	3	3	0	3	6	0	0
11	24973616	.	A	G	1	2	3	0	0	3	0	0
11	24975714	.	C	T	1	2	3	0	0	3	0	0
11	24975911	.	A	C	0	4	4	0	0	4	0	0
11	24975936	.	C	T	0	4	4	0	0	4	0	0
11	24980631	.	C	A	4	7	11	0	0	11	0	0
11	24980684	.	C	T	4	1	5	0	0	5	0	0
11	24980714	.	A	C	3	2	5	0	0	5	0	0
11	24981190	.	A	T	0	2	2	0	0	2	0	0
11	24987085	.	T	C	5	2	7	0	1	8	0	0
11	24987226	.	C	T	1	1	2	0	0	2	0	0
11	24992298	.	A	G	7	4	11	0	1	12	0	0
11	24992445	.	T	A	15	15	30	0	0	30	0	0
11	24992522	.	T	G	6	1	7	0	5	12	0	0
11	24992539	.	G	C	7	7	14	0	2	16	0	0
11	24992899	.	C	A	7	6	13	0	0	13	0	0
11	24992928	.	G	A	8	7	15	0	0	15	0	0
11	24994833	.	A	C	4	5	9	0	0	9	0	0
11	25010619	.	A	C	0	4	4	0	1	5	0	0
11	25025783	.	T	G	4	7	11	0	2	13	0	0
11	25026437	.	A	G	4	8	12	0	2	14	0	0
11	25026450	.	A	T	5	6	11	0	0	11	0	0
11	25031272	.	A	C	10	16	26	0	0	26	0	0
11	25031362	.	C	T	12	9	21	0	0	21	0	0
11	25031497	.	A	T	11	7	18	0	0	18	0	0
11	25031527	.	G	A	9	12	21	0	0	21	0	0
11	25035439	.	C	T	0	1	1	0	0	1	0	0
11	25036942	.	C	T	9	12	21	0	1	22	0	0
11	25037017	.	C	T	8	9	17	0	1	18	0	0
11	25038572	.	T	C	2	2	4	0	0	4	0	0
11	25038625	.	G	C	11	13	24	0	0	24	0	0
11	25038652	.	G	A	0	11	11	0	11	22	0	0
11	25040808	.	A	T	13	11	24	0	0	24	0	0
11	25041204	.	C	T	11	11	22	0	1	23	0	0
11	25041607	.	G	C	1	20	21	0	15	36	0	0
11	25041775	.	T	G	0	2	2	0	1	3	0	0
11	25053236	.	C	T	1	1	2	0	0	2	0	0
11	25053952	.	G	A	2	1	3	0	0	3	0	0
11	25054095	.	G	A	1	0	1	0	0	1	0	0
11	25061104	.	G	A	2	2	4	0	1	5	0	0
11	25062455	.	G	T	3	2	5	0	0	5	0	0
11	25062499	.	T	C	4	2	6	0	1	7	0	0
11	25063054	.	A	C	2	2	4	0	0	4	0	0
11	25063080	.	G	A	2	2	4	0	0	4	0	0
11	25063103	.	G	A	3	3	6	0	0	6	0	0
11	25063120	.	T	G	3	3	6	0	0	6	0	0
11	25063291	.	A	T	4	3	7	0	0	7	0	0
11	25063293	.	T	C	4	3	7	0	0	7	0	0
11	25064623	.	C	G	6	4	10	0	2	12	0	0
11	25129232	.	C	G	8	1	9	0	13	22	0	0
11	25138485	.	A	C	33	31	64	0	1	65	0	0
11	25138656	.	T	C	18	34	52	0	3	55	0	0
11	25138673	.	T	A	11	33	44	0	0	44	0	0
11	25138845	.	C	T	31	36	67	0	1	68	0	0
11	25139000	.	G	C	21	25	46	0	1	47	0	0
11	25163387	.	C	A	1	3	4	0	1	5	0	0
11	25163414	.	G	A	1	2	3	0	0	3	0	0
11	25169680	.	G	A	2	1	3	0	0	3	0	0
11	25169704	.	T	C	1	2	3	0	0	3	0	0
11	25169749	.	G	A	0	3	3	0	0	3	0	0
11	25173328	.	T	C	2	1	3	0	0	3	0	0
11	25173348	.	G	A	1	1	2	0	0	2	0	0
11	25178862	.	C	T	9	7	16	0	1	17	0	0
11	25178865	.	T	A	11	5	16	0	1	17	0	0
11	25179014	.	C	T	6	8	14	0	0	14	0	0
11	25179057	.	A	C	5	6	11	0	1	12	0	0
11	25179069	.	A	G	8	4	12	0	0	12	0	0
11	25179099	.	C	T	8	6	14	0	1	15	0	0
11	25179365	.	G	T	1	3	4	0	7	11	0	0
11	25179383	.	C	T	6	2	8	0	1	9	0	0
11	25179430	.	T	A	4	4	8	0	1	9	0	0
11	25179641	.	C	T	8	8	16	0	0	16	0	0
11	25179659	.	A	T	6	8	14	0	0	15	1	0
11	25180225	.	C	T	4	10	14	0	0	14	0	0
11	25180243	.	A	G	2	6	8	0	1	9	0	0
11	25260187	.	C	T	9	7	16	0	1	17	0	0
11	25261660	.	T	A	4	10	14	0	0	14	0	0
11	25265777	.	G	A	0	2	2	0	0	2	0	0
11	25265950	.	T	C	2	17	19	0	3	22	0	0
11	25302183	.	C	T	0	1	1	0	0	1	0	0
11	25303803	.	C	T	4	6	10	0	0	10	0	0
11	25303887	.	T	C	2	6	8	0	2	10	0	0
11	25307345	.	T	C	0	5	5	0	0	5	0	0
11	25310329	.	G	C	13	4	17	0	0	17	0	0
11	25310777	.	T	G	12	8	20	0	0	20	0	0
11	25310859	.	A	T	13	13	26	0	0	26	0	0
11	25311099	.	T	A	7	13	20	0	4	24	0	0
11	25313916	.	C	T	0	4	4	0	5	9	0	0
11	25314910	.	C	T	5	5	10	0	1	11	0	0
11	25317875	.	G	A	5	2	7	0	0	7	0	0
11	25336643	.	G	T	1	2	3	0	0	3	0	0
11	25403825	.	A	G	1	4	5	0	0	5	0	0
11	25403830	.	A	T	1	2	3	0	1	4	0	0
11	25405772	.	C	T	2	3	5	0	0	5	0	0
11	25405901	.	C	T	4	3	7	0	0	7	0	0
11	25405910	.	C	T	5	4	9	0	0	9	0	0
11	25406186	.	T	C	2	4	6	0	1	7	0	0
11	25406343	.	A	G	4	3	7	0	0	7	0	0
11	25406366	.	T	G	2	0	2	0	8	10	0	0
11	25406381	.	C	T	4	6	10	0	0	10	0	0
11	25406534	.	C	T	5	4	9	0	0	9	0	0
11	25407014	.	G	A	5	4	9	0	0	9	0	0
11	25407380	.	C	T	9	7	16	0	0	16	0	0
11	25407626	.	T	C	8	6	14	0	0	14	0	0
11	25407987	.	A	T	6	6	12	0	1	13	0	0
11	25408139	.	C	T	21	13	34	0	0	34	0	0
11	25408283	.	C	G	10	8	18	0	0	18	0	0
11	25408352	.	T	C	11	6	17	0	0	17	0	0
11	25436813	.	G	C	7	3	10	0	0	10	0	0
11	25436961	.	T	A	13	8	21	0	0	21	0	0
11	25437080	.	C	T	18	9	27	0	3	30	0	0
11	25437299	.	C	T	18	17	35	0	1	36	0	0
11	25437417	.	C	T	15	13	28	0	1	29	0	0
11	25437684	.	G	A	5	9	14	0	0	14	0	0
11	25437866	.	T	G	10	12	22	0	1	23	0	0
11	25437901	.	G	A	6	9	15	0	2	17	0	0
11	25439860	.	G	T	8	6	14	0	1	15	0	0
11	25440511	.	G	A	2	4	6	0	1	7	0	0
11	25440649	.	G	C	0	0	0	0	1	1	0	0
11	25441979	.	T	A	6	1	7	0	1	8	0	0
11	25442057	.	A	C	8	1	9	0	10	19	0	0
11	25442096	.	C	T	7	5	12	0	1	13	0	0
11	25442147	.	G	T	2	5	7	0	0	7	0	0
11	25442313	.	A	G	5	8	13	0	0	13	0	0
11	25442457	.	G	T	5	0	5	0	0	5	0	0
11	25447276	.	A	G	4	5	9	0	0	9	0	0
11	25447279	.	T	C	3	0	3	0	6	9	0	0
11	25449437	.	T	A	2	8	10	0	0	10	0	0
11	25449899	.	C	T	0	2	2	0	4	6	0	0
11	25453188	.	C	A	0	1	1	0	0	1	0	0
11	25453201	.	C	T	0	1	1	0	0	1	0	0
11	25519638	.	G	A	0	2	2	0	1	3	0	0
11	25539857	.	T	G	1	4	5	0	0	5	0	0
11	25539891	.	C	T	2	0	2	0	0	2	0	0
11	25540580	.	G	C	1	2	3	0	0	3	0	0
11	25540583	.	G	A	0	2	2	0	1	3	0	0
11	25542320	.	A	T	3	4	7	0	1	8	0	0
11	25542906	.	A	G	2	3	5	0	0	5	0	0
11	25548043	.	G	T	0	11	11	0	7	18	0	0
11	25565778	.	A	T	2	4	6	0	1	7	0	0
11	25565892	.	T	C	0	1	1	0	0	1	0	0
11	25570711	.	A	C	2	2	4	0	0	4	0	0
11	25573888	.	T	A	1	0	1	0	0	1	0	0
11	25573921	.	T	A	2	2	4	0	0	4	0	0
11	25575139	.	A	G	4	10	14	0	0	14	0	0
11	25575365	.	C	T	9	4	13	0	0	13	0	0
11	25575725	.	A	T	9	6	15	0	0	15	0	0
11	25575872	.	A	G	16	0	16	0	10	26	0	0
11	25615943	.	T	G	3	5	8	0	0	8	0	0
11	25615946	.	A	T	3	5	8	0	0	8	0	0
11	25616095	.	G	A	4	3	7	0	2	9	0	0
11	25617944	.	A	G	9	6	15	0	3	18	0	0
11	25618218	.	C	T	6	7	13	0	1	14	0	0
11	25618353	.	T	A	3	12	15	0	0	15	0	0
11	25618408	.	C	T	5	4	9	0	0	9	0	0
11	25630660	.	C	T	3	6	9	0	0	9	0	0
11	25668431	.	G	A	0	2	2	0	2	4	0	0
11	25668729	.	C	A	1	3	4	0	0	4	0	0
11	25668776	.	T	C	2	4	6	0	0	6	0	0
11	25668782	.	G	A	1	2	3	0	3	6	0	0
11	25668923	.	G	A	0	4	4	0	2	6	0	0
11	25675520	.	T	C	3	2	5	0	0	5	0	0
11	25678671	.	C	T	2	5	7	0	0	7	0	0
11	25679010	.	A	T	3	4	7	0	0	7	0	0
11	25681439	.	T	C	5	7	12	0	0	12	0	0
11	25681594	.	C	T	3	7	10	0	0	10	0	0
11	25681602	.	C	A	3	8	11	0	0	11	0	0
11	25681659	.	G	A	1	2	3	0	12	15	0	0
11	25681677	.	G	A	0	3	3	0	8	11	0	0
11	25681809	.	C	G	4	2	6	0	0	6	0	0
11	25686079	.	T	A	6	7	13	0	1	14	0	0
11	25689209	.	T	C	3	7	10	0	0	10	0	0
11	25689233	.	G	C	3	7	10	0	0	10	0	0
11	25689551	.	T	C	6	3	9	0	0	9	0	0
11	25689561	.	T	A	4	5	9	0	0	9	0	0
11	25693862	.	T	A	2	3	5	0	0	5	0	0
11	25693911	.	T	C	3	2	5	0	0	5	0	0
11	25695436	.	G	A	1	0	1	0	1	2	0	0
11	25695509	.	G	A	0	2	2	0	4	6	0	0
11	25695625	.	A	G	3	4	7	0	0	7	0	0
11	25695643	.	T	C	5	3	8	0	0	8	0	0
11	25695733	.	C	T	3	4	7	0	0	7	0	0
11	25695817	.	G	C	4	6	10	0	0	10	0	0
11	25698776	.	G	C	2	2	4	0	0	4	0	0
11	25698866	.	T	C	1	2	3	0	0	3	0	0
11	25698869	.	G	C	0	3	3	0	1	4	0	0
11	25698917	.	C	T	3	4	7	0	0	7	0	0
11	25698951	.	C	T	4	4	8	0	0	8	0	0
11	25699406	.	G	A	0	8	8	0	5	13	0	0
11	25699505	.	C	A	3	2	5	0	0	5	0	0
11	25702397	.	C	T	5	4	9	0	0	9	0	0
11	25705225	.	C	T	9	8	17	0	0	17	0	0
11	25708374	.	C	T	1	2	3	0	0	3	0	0
11	25713028	.	A	G	3	10	13	0	1	14	0	0
11	25713361	.	T	A	5	8	13	0	0	13	0	0
11	25713362	.	T	A	5	8	13	0	0	13	0	0
11	25713526	.	A	G	5	8	13	0	0	13	0	0
11	25713683	.	G	A	6	16	22	0	2	24	0	0
11	25713768	.	T	C	8	5	13	0	1	14	0	0
11	25713820	.	T	C	6	11	17	0	1	18	0	0
11	25713913	.	T	C	4	12	16	0	0	16	0	0
11	25714148	.	G	A	5	7	12	0	0	12	0	0
11	25718194	.	C	T	4	9	13	0	0	13	0	0
11	25718438	.	T	G	7	8	15	0	0	15	0	0
11	25721865	.	C	T	2	3	5	0	0	5	0	0
11	25729190	.	G	T	1	4	5	0	0	5	0	0
11	25730281	.	G	A	2	6	8	0	0	8	0	0
11	25730282	.	A	T	2	5	7	0	1	8	0	0
11	25748876	.	A	G	1	1	2	0	0	2	0	0
11	25749579	.	T	A	4	4	8	0	0	8	0	0
11	25749826	.	A	C	13	16	29	0	3	32	0	0
11	25749873	.	T	A	18	16	34	0	0	34	0	0
11	25750003	.	G	A	7	6	13	0	0	13	0	0
11	25750008	.	A	G	7	4	11	0	0	11	0	0
11	25783118	.	C	T	0	6	6	0	6	12	0	0
11	25783432	.	G	A	5	13	18	0	0	18	0	0
11	25783704	.	C	T	12	7	19	0	0	19	0	0
11	25789211	.	C	G	4	4	8	0	0	8	0	0
11	25791044	.	C	A	0	1	1	0	3	4	0	0
11	25791065	.	A	T	3	0	3	0	0	3	0	0
11	25893627	.	C	T	7	9	16	0	0	16	0	0
11	25893943	.	A	G	3	9	12	0	0	12	0	0
11	25894003	.	T	C	9	7	16	0	1	17	0	0
11	25944661	.	A	C	6	6	12	0	0	12	0	0
11	26180292	.	C	T	0	1	1	0	3	4	0	0
11	26180460	.	G	A	1	0	1	0	0	1	0	0
11	26190562	.	A	T	8	3	11	0	0	11	0	0
11	26190763	.	C	T	9	7	16	0	0	16	0	0
11	26191478	.	T	A	5	8	13	0	0	13	0	0
11	26191901	.	A	T	5	9	14	0	0	14	0	0
11	26192852	.	C	T	1	8	9	0	0	9	0	0
11	26193377	.	C	T	0	3	3	0	4	7	0	0
11	26193721	.	T	G	4	3	7	0	1	8	0	0
11	26194061	.	T	G	6	5	11	0	1	12	0	0
11	26194237	.	G	T	3	5	8	0	0	8	0	0
11	26194289	.	C	A	2	2	4	0	0	4	0	0
11	26229093	.	G	A	20	16	36	0	0	36	0	0
11	26229801	.	G	A	11	9	20	0	1	21	0	0
11	26229809	.	T	C	12	12	24	0	0	24	0	0
11	26229900	.	C	T	0	14	14	0	17	31	0	0
11	26230425	.	G	C	9	13	22	0	2	24	0	0
11	26230644	.	G	A	4	4	8	0	0	8	0	0
11	26230774	.	T	A	8	6	14	0	0	14	0	0
11	26230972	.	A	G	3	9	12	0	1	13	0	0
11	26231537	.	T	A	0	2	2	0	1	3	0	0
11	26231804	.	T	C	13	13	26	0	1	27	0	0
11	26231890	.	G	A	13	11	24	0	1	25	0	0
11	26231971	.	T	C	6	7	13	0	0	13	0	0
11	26232038	.	A	T	7	6	13	0	1	14	0	0
11	26232311	.	C	T	5	2	7	0	0	7	0	0
11	26232658	.	C	G	0	3	3	0	4	7	0	0
11	26367130	.	T	C	1	2	3	0	1	4	0	0
11	26367131	.	G	A	1	3	4	0	0	4	0	0
11	26369416	.	A	G	2	2	4	0	0	4	0	0
11	26369464	.	G	C	4	2	6	0	0	6	0	0
11	26369465	.	C	A	3	2	5	0	1	6	0	0
11	26370780	.	A	G	3	1	4	0	1	5	0	0
11	26372296	.	C	T	1	6	7	0	10	17	0	0
11	26373798	.	T	C	0	1	1	0	0	1	0	0
11	26374063	.	G	A	0	3	3	0	0	3	0	0
11	26374108	.	A	G	2	4	6	0	0	6	0	0
11	26380197	.	C	A	1	2	3	0	0	3	0	0
11	26380938	.	G	A	3	4	7	0	1	8	0	0
11	26380977	.	G	A	3	5	8	0	1	9	0	0
11	26381100	.	C	T	3	2	5	0	0	5	0	0
11	26381145	.	C	T	5	3	8	0	0	8	0	0
11	26381908	.	G	A	8	3	11	0	0	11	0	0
11	26382551	.	A	G	9	0	9	0	6	15	0	0
11	26382756	.	T	C	13	15	28	0	0	28	0	0
11	26383068	.	C	T	6	6	12	0	1	13	0	0
11	26383120	.	T	C	7	5	12	0	1	13	0	0
11	26383338	.	G	T	0	3	3	0	2	5	0	0
11	26398012	.	T	C	6	8	14	0	0	14	0	0
11	26398081	.	A	T	3	0	3	0	0	3	0	0
11	26400503	.	G	A	8	14	22	0	0	22	0	0
11	26400796	.	C	T	3	8	11	0	0	11	0	0
11	26400841	.	T	C	11	3	14	0	1	15	0	0
11	26400916	.	C	T	16	15	31	0	0	31	0	0
11	26401116	.	G	A	1	2	3	0	2	5	0	0
11	26401248	.	G	T	6	4	10	0	0	10	0	0
11	26401407	.	C	T	7	17	24	0	0	24	0	0
11	26401413	.	C	T	16	9	25	0	1	26	0	0
11	26532452	.	G	T	0	0	0	0	1	1	0	0
11	26540484	.	C	T	2	0	2	0	0	2	0	0
11	26540496	.	T	C	2	0	2	0	0	2	0	0
11	26545709	.	G	A	1	1	2	0	0	2	0	0
11	26561119	.	G	A	2	2	4	0	0	4	0	0
11	26561301	.	T	G	3	3	6	0	1	7	0	0
11	26561560	.	A	T	1	2	3	0	0	3	0	0
11	26562132	.	C	A	1	3	4	0	0	4	0	0
11	26562253	.	G	A	2	2	4	0	0	4	0	0
11	26562292	.	T	A	2	2	4	0	0	4	0	0
11	26562306	.	C	G	2	2	4	0	0	4	0	0
11	26562327	.	G	T	0	3	3	0	2	5	0	0
11	26614389	.	T	C	3	4	7	0	1	8	0	0
11	26614487	.	G	T	35	22	57	0	5	62	0	0
11	26614552	.	G	C	2	31	33	0	25	58	0	0
11	26614615	.	T	A	19	34	53	0	1	54	0	0
11	26614649	.	A	G	19	1	20	0	37	57	0	0
11	26615112	.	T	G	25	12	37	0	4	42	1	0
11	26615294	.	G	A	19	14	33	0	1	34	0	0
11	26615525	.	A	C	1	2	3	0	0	3	0	0
11	26683200	.	C	A	6	4	10	0	0	10	0	0
11	26683692	.	A	T	6	4	10	0	0	10	0	0
11	26686150	.	T	C	3	2	5	0	0	5	0	0
11	26698136	.	G	T	2	1	3	0	0	3	0	0
11	26704347	.	C	A	0	24	24	0	17	41	0	0
11	26704960	.	A	T	10	8	18	0	3	21	0	0
11	26705196	.	C	T	14	17	31	0	0	31	0	0
11	26705239	.	C	A	10	16	26	0	1	27	0	0
11	26705738	.	G	T	15	12	27	0	1	28	0	0
11	26705995	.	C	A	13	10	23	0	0	23	0	0
11	26706015	.	G	A	12	9	21	0	0	21	0	0
11	26706572	.	C	T	0	14	14	1	12	27	0	0
11	26706862	.	A	C	11	17	28	0	1	29	0	0
11	26707325	.	T	C	15	1	16	0	17	33	0	0
11	26707634	.	A	G	9	19	28	0	4	32	0	0
11	26707679	.	G	A	11	19	30	0	0	30	0	0
11	26707733	.	A	G	15	16	31	0	2	33	0	0
11	26715590	.	C	T	4	3	7	0	1	8	0	0
11	26722188	.	G	A	3	4	7	0	0	7	0	0
11	26722247	.	A	G	1	0	1	0	0	1	0	0
11	26739994	.	T	G	3	5	8	0	0	8	0	0
11	26740393	.	T	C	4	2	6	0	0	6	0	0
11	26740697	.	T	A	2	3	5	0	0	5	0	0
11	26740751	.	T	C	2	0	2	0	2	4	0	0
11	26740784	.	A	G	3	2	5	0	0	5	0	0
11	27136614	.	C	T	1	1	2	0	0	2	0	0
11	27143590	.	A	G	1	0	1	0	0	1	0	0
11	27195745	.	A	T	2	0	2	0	0	2	0	0
11	27197299	.	T	C	1	2	3	0	1	4	0	0
11	27383237	.	C	T	1	3	4	0	0	4	0	0
11	27486825	.	C	T	5	7	12	0	0	12	0	0
11	27487296	.	T	C	4	3	7	0	0	7	0	0
11	27487368	.	T	A	3	3	6	0	1	7	0	0
11	27487411	.	A	G	8	8	16	0	0	16	0	0
11	27487557	.	G	T	2	11	13	0	0	13	0	0
11	27487689	.	T	C	6	8	14	0	1	15	0	0
11	27487862	.	T	C	3	3	6	0	0	6	0	0
11	27487904	.	T	A	2	2	4	0	1	5	0	0
11	27488158	.	C	T	2	4	6	0	0	6	0	0
11	27488300	.	A	G	5	2	7	0	0	7	0	0
11	27488369	.	G	C	6	11	17	0	0	17	0	0
11	27488669	.	G	A	2	4	6	0	0	6	0	0
11	27495632	.	C	T	1	3	4	0	1	5	0	0
11	27512047	.	T	A	3	2	5	0	0	5	0	0
11	27512112	.	A	G	1	4	5	0	0	5	0	0
11	27512114	.	G	A	1	4	5	0	0	5	0	0
11	27516630	.	T	G	3	2	5	0	0	5	0	0
11	27516662	.	G	A	2	1	3	0	0	3	0	0
11	27516891	.	C	T	0	3	3	0	3	6	0	0
11	27517115	.	G	A	3	6	9	0	1	10	0	0
11	27517122	.	T	G	5	6	11	0	0	11	0	0
11	27517238	.	C	T	1	7	8	0	2	10	0	0
11	27517296	.	T	C	2	5	7	0	0	7	0	0
11	27517653	.	C	T	3	3	6	0	0	6	0	0
11	27517728	.	C	T	8	2	10	0	0	10	0	0
11	27517734	.	G	C	9	0	9	0	3	12	0	0
11	27517776	.	G	T	7	6	13	0	0	13	0	0
11	27526278	.	A	G	1	2	3	0	0	3	0	0
11	27537552	.	C	T	0	1	1	0	1	2	0	0
11	27636522	.	A	G	0	0	0	0	1	1	0	0
11	27644826	.	A	G	4	7	11	0	2	13	0	0
11	27644922	.	G	A	8	11	19	0	0	19	0	0
11	27645742	.	T	A	3	9	12	0	0	12	0	0
11	27645871	.	G	A	0	2	2	0	0	2	0	0
11	27646063	.	T	A	3	4	7	0	0	7	0	0
11	27646172	.	T	C	9	3	12	0	1	13	0	0
11	27646298	.	A	G	10	15	25	0	1	26	0	0
11	27649527	.	G	A	9	15	24	0	0	24	0	0
11	27655732	.	A	G	17	12	29	0	1	30	0	0
11	27655774	.	C	T	3	8	11	0	11	22	0	0
11	27661241	.	C	T	0	5	5	0	2	7	0	0
11	27668314	.	A	G	2	2	4	0	2	6	0	0
11	27671163	.	C	T	8	7	15	0	0	15	0	0
11	27671251	.	G	A	4	11	15	0	0	15	0	0
11	27673289	.	C	T	3	3	6	0	1	7	0	0
11	27677815	.	C	T	0	2	2	0	0	2	0	0
11	27677939	.	T	G	5	3	8	0	0	8	0	0
11	27677948	.	G	A	5	2	7	0	0	7	0	0
11	27705165	.	G	A	12	8	20	0	0	20	0	0
11	27705215	.	T	A	7	12	19	0	1	20	0	0
11	27705219	.	G	T	7	12	19	0	2	21	0	0
11	27705308	.	G	A	19	9	28	0	0	28	0	0
11	27705960	.	G	A	10	12	22	0	0	22	0	0
11	27706308	.	G	A	4	5	9	0	0	9	0	0
11	27706434	.	T	A	4	4	8	0	1	9	0	0
11	27706441	.	T	C	4	0	4	0	5	9	0	0
11	27706741	.	T	A	6	4	10	0	0	10	0	0
11	27706742	.	A	C	5	4	9	0	1	10	0	0
11	27708665	.	A	C	1	1	2	0	0	2	0	0
11	27713556	.	G	T	2	5	7	0	0	7	0	0
11	27719203	.	A	G	0	1	1	0	0	1	0	0
11	27719350	.	G	T	4	6	10	0	1	11	0	0
11	27725145	.	T	G	0	2	2	0	0	2	0	0
11	27727592	.	G	A	2	5	7	0	0	7	0	0
11	27738118	.	A	G	2	2	4	0	0	4	0	0
11	27738569	.	G	C	2	3	5	0	0	5	0	0
11	27744261	.	A	T	2	3	5	0	1	6	0	0
11	27744269	.	A	G	2	1	3	0	2	5	0	0
11	27817597	.	T	G	2	3	5	0	0	5	0	0
11	27817632	.	C	T	2	1	3	0	0	3	0	0
11	27817639	.	T	G	2	0	2	0	0	2	0	0
11	27817706	.	T	A	4	9	13	0	0	13	0	0
11	27817767	.	G	A	1	2	3	0	1	4	0	0
11	27817856	.	C	A	0	2	2	0	1	3	0	0
11	27817948	.	C	T	0	3	3	0	3	6	0	0
11	27817986	.	C	T	2	6	8	0	0	8	0	0
11	27818117	.	A	G	2	3	5	0	0	5	0	0
11	27818236	.	A	C	9	7	16	0	0	16	0	0
11	27818239	.	T	C	9	8	17	0	0	17	0	0
11	27818343	.	G	C	10	5	15	0	0	15	0	0
11	27818393	.	C	G	6	5	11	0	0	11	0	0
11	27820431	.	T	G	6	5	11	0	0	11	0	0
11	27828919	.	A	T	11	10	21	0	2	23	0	0
11	27829402	.	A	G	8	3	11	1	0	12	0	0
11	27829592	.	A	G	9	9	18	0	0	18	0	0
11	27829702	.	T	C	15	16	31	0	2	33	0	0
11	27829772	.	G	A	4	3	7	0	0	7	0	0
11	27829928	.	G	A	7	15	22	0	1	23	0	0
11	27835073	.	T	C	4	4	8	0	0	8	0	0
11	27835372	.	C	A	0	1	1	0	0	1	0	0
11	27836045	.	T	C	6	8	14	0	1	15	0	0
11	27840160	.	A	G	2	1	3	0	0	3	0	0
11	27845701	.	A	G	1	0	1	0	0	1	0	0
11	27857373	.	C	T	6	8	14	0	0	14	0	0
11	27867140	.	T	G	0	3	3	0	0	3	0	0
11	27874042	.	T	C	4	0	4	0	8	12	0	0
11	27994100	.	C	T	1	2	3	0	0	3	0	0
11	28005245	.	C	T	1	3	4	0	0	4	0	0
11	28005535	.	C	T	1	1	2	0	0	2	0	0
11	28110342	.	A	G	0	2	2	0	0	2	0	0
11	28123088	.	T	G	4	0	4	0	5	9	0	0
11	28123139	.	T	G	1	6	7	0	0	7	0	0
11	28123141	.	C	T	1	6	7	0	0	7	0	0
11	28123186	.	T	C	3	5	8	0	0	8	0	0
11	28123402	.	T	C	2	3	5	0	0	5	0	0
11	28123448	.	C	G	4	3	7	0	0	7	0	0
11	28124010	.	C	G	1	2	3	0	0	3	0	0
11	28124052	.	T	A	0	3	3	0	0	3	0	0
11	28124061	.	A	T	0	4	4	0	0	4	0	0
11	28124132	.	C	A	1	6	7	0	0	7	0	0
11	28124217	.	G	A	0	5	5	0	2	7	0	0
11	28124598	.	G	C	4	3	7	0	1	8	0	0
11	28310987	.	C	T	1	3	4	0	0	4	0	0
11	28311053	.	T	C	0	2	2	0	0	2	0	0
11	28311056	.	G	A	0	2	2	0	0	2	0	0
11	28362294	.	A	C	1	3	4	0	0	4	0	0
11	28409862	.	T	C	2	4	6	0	0	6	0	0
11	28409976	.	G	A	0	3	3	0	2	5	0	0
11	28410154	.	C	T	2	2	4	0	1	5	0	0
11	28410157	.	T	C	2	3	5	0	0	5	0	0
11	28412858	.	C	T	7	5	12	0	0	12	0	0
11	28412868	.	A	C	7	4	11	0	1	12	0	0
11	28419753	.	C	T	4	4	8	0	0	8	0	0
11	28419948	.	C	T	6	5	11	0	0	11	0	0
11	28420051	.	A	G	5	0	5	0	4	9	0	0
11	28420264	.	T	G	4	0	4	0	4	8	0	0
11	28420600	.	G	A	0	3	3	0	4	7	0	0
11	28420602	.	T	C	4	3	7	0	0	7	0	0
11	28420880	.	T	C	5	4	9	0	0	9	0	0
11	28421115	.	T	G	3	9	12	0	0	12	0	0
11	28421234	.	A	G	6	0	6	0	5	11	0	0
11	28422009	.	G	A	1	2	3	0	0	3	0	0
11	28422071	.	G	A	4	3	7	0	0	7	0	0
11	28422273	.	C	T	8	12	20	0	0	20	0	0
11	28422542	.	A	G	7	8	15	0	0	15	0	0
11	28422892	.	C	A	13	8	21	0	1	23	1	0
11	28423137	.	A	G	11	0	11	0	4	15	0	0
11	28423147	.	T	A	8	8	16	0	1	17	0	0
11	28423325	.	C	T	15	4	19	0	0	19	0	0
11	28423457	.	T	C	6	9	15	0	0	15	0	0
11	28423497	.	G	T	9	9	18	0	1	19	0	0
11	28423628	.	A	T	9	11	20	0	1	21	0	0
11	28477137	.	C	T	1	2	3	0	1	4	0	0
11	28477338	.	T	C	4	10	14	0	0	14	0	0
11	28477697	.	T	C	5	3	8	0	0	8	0	0
11	28477720	.	T	A	4	4	8	0	0	8	0	0
11	28478026	.	T	C	1	5	6	0	1	7	0	0
11	28513792	.	A	G	2	3	5	0	1	6	0	0
11	28513960	.	T	C	5	5	10	0	0	10	0	0
11	28514053	.	G	A	5	3	8	0	0	8	0	0
11	28514089	.	T	C	5	5	10	0	0	10	0	0
11	28514307	.	T	G	3	10	13	0	0	13	0	0
11	28514916	.	C	A	7	0	7	0	0	7	0	0
11	28514919	.	T	C	6	0	6	0	1	7	0	0
11	28514963	.	C	T	1	2	3	0	0	3	0	0
11	28643141	.	G	A	25	22	47	0	0	47	0	0
11	28643281	.	A	T	24	21	45	0	1	46	0	0
11	28643890	.	G	C	17	23	40	0	1	41	0	0
11	28644087	.	A	C	21	25	46	0	4	50	0	0
11	28644110	.	T	C	18	1	19	0	32	51	0	0
11	28661028	.	A	G	11	13	24	0	1	25	0	0
11	28789260	.	C	T	2	3	5	0	0	5	0	0
11	28808965	.	G	A	7	4	11	0	0	11	0	0
11	29331413	.	A	G	3	2	5	0	0	5	0	0
11	29331532	.	A	G	2	6	8	0	0	8	0	0
11	29331609	.	T	C	8	6	14	0	1	15	0	0
11	29331695	.	A	G	7	7	14	0	0	14	0	0
11	29331854	.	T	C	5	7	12	0	1	13	0	0
11	29332113	.	T	G	11	6	17	0	1	18	0	0
11	29332255	.	T	C	9	0	9	0	8	17	0	0
11	29332357	.	A	G	5	4	9	0	0	9	0	0
11	29332454	.	C	A	7	4	11	0	2	13	0	0
11	29332591	.	G	A	4	7	11	0	0	11	0	0
11	29332652	.	A	T	2	3	5	0	1	6	0	0
11	29332662	.	T	G	2	3	5	0	0	5	0	0
11	29332761	.	C	A	4	3	7	0	0	7	0	0
11	29575390	.	G	A	20	17	37	0	0	37	0	0
11	29575429	.	G	T	22	13	35	0	1	36	0	0
11	29575527	.	C	T	29	19	48	0	1	49	0	0
11	29575897	.	C	T	16	15	31	0	0	31	0	0
11	29577107	.	G	A	12	9	21	0	0	21	0	0
11	29577163	.	C	T	7	6	13	0	2	15	0	0
11	29577431	.	T	C	4	9	13	0	0	13	0	0
11	29577481	.	T	A	5	9	14	0	1	15	0	0
11	29577566	.	C	T	9	12	21	0	0	21	0	0
11	29577598	.	T	C	7	0	7	0	14	21	0	0
11	29577970	.	T	C	6	7	13	0	0	13	0	0
11	29577979	.	T	A	7	8	15	0	0	15	0	0
11	29578070	.	C	T	0	8	8	0	14	22	0	0
11	29578133	.	T	C	5	0	5	0	13	18	0	0
11	29578139	.	A	G	5	11	16	0	0	16	0	0
11	29578265	.	G	A	0	2	2	0	0	2	0	0
11	29581774	.	T	C	18	1	19	0	7	26	0	0
11	29581828	.	A	G	8	4	12	0	0	12	0	0
11	29587885	.	A	G	3	4	7	0	0	7	0	0
11	29587927	.	T	C	8	9	17	0	1	18	0	0
11	29588525	.	G	A	3	0	3	0	0	3	0	0
11	29589199	.	T	C	9	10	19	0	2	21	0	0
11	29589370	.	C	T	1	1	2	0	0	2	0	0
11	29589512	.	T	G	1	2	3	0	1	4	0	0
11	29589578	.	T	C	5	0	5	0	12	17	0	0
11	29589602	.	T	A	3	12	15	0	0	15	0	0
11	29593372	.	T	C	1	3	4	0	0	4	0	0
11	29596227	.	A	G	8	4	12	0	0	12	0	0
11	29601936	.	T	C	1	1	2	0	0	2	0	0
11	29609844	.	G	A	1	0	1	0	0	1	0	0
11	29614074	.	T	C	4	0	4	0	6	10	0	0
11	29614086	.	T	C	4	7	11	0	1	12	0	0
11	29623647	.	T	C	2	1	3	0	1	4	0	0
11	29685445	.	T	C	5	3	8	0	0	8	0	0
11	29685616	.	T	G	1	5	6	0	0	6	0	0
11	29685664	.	G	A	1	2	3	0	1	4	0	0
11	29757258	.	T	C	5	4	9	0	0	9	0	0
11	29757636	.	A	C	11	12	23	0	0	23	0	0
11	29760548	.	C	T	0	1	1	0	0	1	0	0
11	29762946	.	G	A	12	15	27	0	1	28	0	0
11	29764554	.	A	G	1	2	3	0	0	3	0	0
11	29771557	.	C	T	1	1	2	0	0	2	0	0
11	29771602	.	A	G	1	1	2	0	0	2	0	0
11	29771632	.	A	G	0	1	1	0	0	1	0	0
11	29781528	.	T	C	1	1	2	0	0	2	0	0
11	29781864	.	T	G	1	0	1	0	0	1	0	0
11	29784951	.	A	C	3	2	5	0	0	5	0	0
11	29785586	.	T	A	2	2	4	0	0	4	0	0
11	29785844	.	C	G	2	4	6	0	0	6	0	0
11	29786061	.	G	A	1	3	4	0	0	4	0	0
11	29786459	.	C	T	3	2	5	0	0	5	0	0
11	29788042	.	G	A	4	8	12	0	1	13	0	0
11	29789405	.	A	C	1	1	2	0	0	2	0	0
11	29789776	.	T	A	5	5	10	0	0	10	0	0
11	29790631	.	A	G	2	0	2	0	2	4	0	0
11	29791911	.	C	A	1	2	3	0	0	3	0	0
11	29793547	.	T	C	6	13	19	0	0	19	0	0
11	29793553	.	T	C	7	16	23	0	0	23	0	0
11	29793694	.	A	C	13	5	18	0	2	20	0	0
11	29793726	.	C	A	10	12	22	0	0	22	0	0
11	29794009	.	A	G	18	17	35	0	0	35	0	0
11	29795353	.	C	A	1	3	4	0	0	4	0	0
11	29795601	.	C	T	2	3	5	0	1	6	0	0
11	29795893	.	A	C	0	3	3	0	0	3	0	0
11	29796270	.	A	C	2	0	2	0	10	12	0	0
11	29803049	.	C	G	1	0	1	0	0	1	0	0
11	29815351	.	A	G	1	0	1	0	0	1	0	0
11	29818491	.	C	A	2	2	4	0	0	4	0	0
11	29876865	.	C	T	7	5	12	0	0	12	0	0
11	29876974	.	C	A	3	5	8	0	1	9	0	0
11	29917814	.	G	T	3	2	5	0	0	5	0	0
11	29917966	.	G	T	6	3	9	0	0	9	0	0
11	29918069	.	T	C	2	8	10	2	0	12	0	0
11	29918070	.	T	C	2	7	9	2	1	12	0	0
11	29918294	.	G	T	8	6	14	0	1	15	0	0
11	29918306	.	A	G	9	8	17	0	0	17	0	0
11	29936156	.	G	A	1	1	2	0	0	2	0	0
11	29936168	.	T	C	1	1	2	0	0	2	0	0
11	29936562	.	G	T	2	4	6	0	0	6	0	0
11	29936569	.	T	A	2	3	5	0	0	5	0	0
11	30082218	.	A	G	0	0	0	0	3	3	0	0
11	30083525	.	A	G	3	4	7	0	0	7	0	0
11	30083603	.	C	A	2	2	4	0	0	4	0	0
11	30083795	.	C	T	5	7	12	0	0	12	0	0
11	30087007	.	C	T	5	6	11	0	0	11	0	0
11	30087147	.	T	G	8	0	8	0	5	13	0	0
11	30087271	.	A	G	4	2	6	0	0	6	0	0
11	30087274	.	T	C	4	2	6	0	0	6	0	0
11	30087312	.	A	T	2	4	6	0	1	7	0	0
11	30087429	.	G	A	10	11	21	0	1	22	0	0
11	30087756	.	A	T	7	5	12	0	0	12	0	0
11	30087885	.	C	T	2	9	11	0	0	11	0	0
11	30088392	.	A	T	6	13	19	0	1	20	0	0
11	30088427	.	G	A	9	7	16	0	0	16	0	0
11	30088560	.	G	T	9	13	22	0	0	23	1	0
11	30089649	.	A	G	17	7	24	0	0	24	0	0
11	30089671	.	G	A	17	1	18	0	0	18	0	0
11	30106429	.	C	T	4	4	8	0	0	8	0	0
11	30106641	.	C	T	12	3	15	0	1	16	0	0
11	30106651	.	T	C	10	0	10	0	3	14	1	0
11	30106790	.	A	C	2	3	5	0	1	6	0	0
11	30107224	.	G	T	3	6	9	0	1	10	0	0
11	30107299	.	T	G	5	10	15	0	2	17	0	0
11	30107366	.	A	G	6	3	9	0	1	10	0	0
11	30107405	.	T	C	9	6	15	0	0	15	0	0
11	30107417	.	C	T	7	5	12	0	1	13	0	0
11	30113047	.	C	T	0	1	1	0	2	3	0	0
11	30118871	.	T	C	2	0	2	0	1	3	0	0
11	30118970	.	A	G	4	3	7	0	1	8	0	0
11	30123439	.	G	A	1	1	2	0	0	2	0	0
11	30147877	.	G	A	3	2	5	0	0	5	0	0
11	30148024	.	G	A	4	3	7	0	0	7	0	0
11	30205713	.	C	T	2	1	3	0	0	3	0	0
11	30222912	.	T	C	3	5	8	0	0	8	0	0
11	30222963	.	G	A	0	11	11	0	12	23	0	0
11	30231104	.	C	T	7	2	9	0	2	11	0	0
11	30231269	.	A	G	27	17	44	0	0	44	0	0
11	30231416	.	T	A	12	12	24	0	6	30	0	0
11	30251529	.	A	T	1	4	5	0	1	6	0	0
11	30251551	.	T	C	1	3	4	0	0	4	0	0
11	30366816	.	T	A	4	2	6	0	1	7	0	0
11	30367029	.	C	A	5	2	7	0	0	7	0	0
11	30367071	.	C	A	1	2	3	0	0	3	0	0
11	30640954	.	A	G	2	3	5	0	0	5	0	0
11	30642164	.	A	G	2	7	9	0	1	10	0	0
11	31024887	.	A	G	5	4	9	0	0	9	0	0
11	31467373	.	G	A	5	1	6	0	1	7	0	0
11	31558251	.	G	A	0	6	6	0	4	10	0	0
11	31558634	.	C	A	11	6	17	0	0	17	0	0
11	31558782	.	C	T	9	6	15	0	0	15	0	0
11	31602828	.	G	T	13	10	23	0	0	23	0	0
11	31603346	.	G	A	0	4	4	0	10	14	0	0
11	31621001	.	C	G	1	3	4	0	0	4	0	0
11	31621074	.	G	A	0	3	3	0	1	4	0	0
11	31647283	.	A	C	4	4	8	0	0	8	0	0
11	31649781	.	G	A	0	2	2	0	0	2	0	0
11	31653670	.	T	G	2	0	2	0	3	5	0	0
11	31653700	.	T	C	3	4	7	0	0	7	0	0
11	31664070	.	T	C	4	6	10	0	1	11	0	0
11	31664108	.	T	C	1	1	2	0	0	2	0	0
11	31667490	.	C	A	1	2	3	0	0	3	0	0
11	31667592	.	C	T	11	16	27	0	0	27	0	0
11	31667658	.	C	T	20	17	37	0	1	38	0	0
11	31667946	.	G	A	9	10	19	0	1	20	0	0
11	31668186	.	A	G	6	4	10	0	0	12	2	0
11	31668191	.	A	T	6	4	10	0	0	13	3	0
11	31668330	.	C	A	7	9	16	0	1	17	0	0
11	31668394	.	T	G	3	14	17	0	0	17	0	0
11	31668824	.	T	A	3	13	16	0	0	16	0	0
11	31668849	.	A	T	5	8	13	0	1	14	0	0
11	31670216	.	A	T	5	9	14	0	0	14	0	0
11	31670534	.	T	C	2	2	4	0	0	4	0	0
11	31670605	.	T	A	1	1	2	0	1	3	0	0
11	31670610	.	A	T	1	2	3	0	0	3	0	0
11	31670686	.	A	G	4	3	7	0	0	7	0	0
11	31670724	.	A	G	4	0	4	0	7	11	0	0
11	31670749	.	C	A	3	5	8	0	0	8	0	0
11	31670789	.	C	T	4	6	10	0	0	10	0	0
11	31670808	.	C	A	5	8	13	0	2	15	0	0
11	31670830	.	T	C	7	10	17	0	1	18	0	0
11	31670868	.	T	C	7	4	11	0	2	13	0	0
11	31670881	.	T	A	10	4	14	0	1	15	0	0
11	31670920	.	G	A	0	3	3	0	14	17	0	0
11	31670935	.	G	A	9	3	12	0	1	13	0	0
11	31671060	.	A	G	0	0	0	1	2	3	0	0
11	31671072	.	T	C	0	2	2	1	0	3	0	0
11	31671165	.	G	C	2	6	8	0	2	10	0	0
11	31671189	.	A	G	1	7	8	0	0	8	0	0
11	31671326	.	G	T	0	5	5	0	4	9	0	0
11	31671328	.	T	G	4	5	9	0	0	9	0	0
11	32576695	.	C	T	10	8	18	0	4	22	0	0
11	32577076	.	T	A	2	6	8	0	0	8	0	0
11	32577258	.	C	T	2	12	14	0	10	24	0	0
11	32577404	.	A	G	15	14	29	0	2	31	0	0
11	32577439	.	G	A	11	15	26	0	1	27	0	0
11	32577800	.	G	A	19	13	32	0	1	33	0	0
11	32577830	.	G	A	19	18	37	0	1	38	0	0
11	32578082	.	C	T	16	21	37	0	1	38	0	0
11	32578172	.	G	A	13	12	25	0	1	26	0	0
11	32720124	.	C	T	12	16	28	0	1	29	0	0
11	32720427	.	A	T	12	8	20	0	4	24	0	0
11	32720505	.	C	T	7	10	17	0	1	18	0	0
11	32720730	.	C	G	11	8	19	0	0	19	0	0
11	32720856	.	A	G	6	11	17	0	0	17	0	0
11	32721057	.	T	A	8	6	14	0	0	14	0	0
11	32721144	.	A	G	4	11	15	0	0	15	0	0
11	32721168	.	A	G	4	8	12	0	1	13	0	0
11	32721333	.	A	G	6	6	12	0	0	12	0	0
11	32721492	.	A	C	3	0	3	0	3	6	0	0
11	32721498	.	T	G	4	3	7	0	0	7	0	0
11	32721765	.	A	G	3	5	8	0	0	8	0	0
11	32721843	.	G	A	6	5	11	0	0	11	0	0
11	32723691	.	C	T	3	3	6	0	0	6	0	0
11	33530220	.	A	G	1	2	3	0	0	3	0	0
11	33532289	.	A	G	2	2	4	0	0	4	0	0
11	33532600	.	C	T	3	5	8	0	0	8	0	0
11	33537435	.	C	T	0	2	2	0	0	2	0	0
11	33539693	.	T	C	3	4	7	0	0	7	0	0
11	33545056	.	A	T	3	5	8	0	0	8	0	0
11	33551200	.	T	C	2	1	3	0	0	3	0	0
11	33553873	.	T	C	7	9	16	0	3	19	0	0
11	33554087	.	G	A	6	13	19	0	0	19	0	0
11	33554116	.	G	A	4	15	19	0	1	20	0	0
11	33554535	.	T	C	6	8	14	0	1	15	0	0
11	33598663	.	T	A	3	3	6	0	0	6	0	0
11	33598894	.	G	C	4	3	7	0	0	7	0	0
11	33598972	.	A	G	7	3	10	0	0	10	0	0
11	33599038	.	T	C	6	5	11	0	4	15	0	0
11	33599148	.	T	C	17	12	29	0	1	30	0	0
11	33599187	.	T	C	19	1	20	0	7	27	0	0
11	33599223	.	A	G	14	11	25	0	2	27	0	0
11	33599240	.	A	T	12	14	26	0	0	26	0	0
11	33599464	.	C	T	0	8	8	0	11	19	0	0
11	33599535	.	T	G	0	2	2	0	0	2	0	0
11	33599900	.	C	T	0	3	3	0	6	9	0	0
11	33600015	.	G	A	4	3	7	0	1	8	0	0
11	33600174	.	G	A	15	4	19	0	0	19	0	0
11	33600441	.	G	A	1	2	3	0	0	3	0	0
11	33600572	.	T	A	1	2	3	0	0	3	0	0
11	33763007	.	C	T	0	2	2	0	0	2	0	0
11	33772552	.	C	T	2	2	4	0	0	4	0	0
11	33827023	.	G	A	2	3	5	0	0	5	0	0
11	33829443	.	A	G	1	0	1	0	0	1	0	0
11	33829515	.	A	G	4	5	9	0	1	10	0	0
11	33832679	.	C	T	2	8	10	0	0	10	0	0
11	33834700	.	A	G	1	3	4	0	0	4	0	0
11	33835385	.	C	A	5	4	9	0	0	9	0	0
11	33835542	.	T	C	3	10	13	0	0	13	0	0
11	33841788	.	C	T	6	10	16	0	0	16	0	0
11	33841984	.	C	T	8	15	23	0	0	23	0	0
11	33842542	.	C	T	7	8	15	0	0	15	0	0
11	33842676	.	G	A	2	4	6	0	0	6	0	0
11	33846497	.	T	C	10	5	15	0	1	16	0	0
11	33846519	.	T	C	5	6	11	0	1	12	0	0
11	33846566	.	T	C	1	5	6	0	0	6	0	0
11	33846657	.	G	A	7	6	13	0	1	14	0	0
11	33846729	.	T	C	6	0	6	0	6	12	0	0
11	33847080	.	T	G	3	6	9	0	0	9	0	0
11	33847123	.	C	T	5	7	12	0	1	13	0	0
11	33847293	.	G	A	6	3	9	0	0	9	0	0
11	33857576	.	A	C	1	7	8	0	0	8	0	0
11	33857580	.	G	A	1	6	7	0	1	8	0	0
11	33857833	.	T	C	9	6	15	0	2	17	0	0
11	33870464	.	A	T	3	3	6	0	1	7	0	0
11	33871099	.	G	A	4	2	6	0	0	6	0	0
11	33871343	.	G	T	4	5	9	0	0	9	0	0
11	33871358	.	G	T	5	5	10	0	0	10	0	0
11	33871378	.	G	T	6	9	15	0	0	15	0	0
11	33871466	.	A	G	7	10	17	0	0	17	0	0
11	33871575	.	A	G	17	20	37	0	2	39	0	0
11	33871897	.	C	T	11	9	20	0	5	25	0	0
11	33871931	.	G	C	12	6	18	0	1	19	0	0
11	33871932	.	C	A	12	7	19	0	0	19	0	0
11	33872029	.	C	T	0	5	5	0	14	19	0	0
11	33872038	.	G	C	9	0	9	0	10	19	0	0
11	33872289	.	T	C	14	0	14	0	8	22	0	0
11	33872411	.	A	C	7	6	13	0	1	14	0	0
11	33872564	.	G	T	15	9	24	0	0	24	0	0
11	33872661	.	A	G	2	4	6	0	0	6	0	0
11	33872684	.	C	T	4	6	10	0	0	10	0	0
11	33872699	.	A	G	4	2	6	0	1	7	0	0
11	33872759	.	A	G	2	7	9	0	0	9	0	0
11	33872763	.	A	C	1	6	7	0	1	8	0	0
11	33872829	.	C	T	1	8	9	0	11	20	0	0
11	33873408	.	T	C	1	4	5	0	0	5	0	0
11	33873539	.	C	T	0	5	5	0	10	15	0	0
11	33873578	.	A	C	8	9	17	0	2	19	0	0
11	33880086	.	A	G	0	1	1	0	0	1	0	0
11	33880089	.	C	T	0	1	1	0	0	1	0	0
11	33900231	.	G	C	1	2	3	0	0	3	0	0
11	33900436	.	G	C	2	2	4	0	0	4	0	0
11	33921533	.	A	T	3	3	6	0	0	6	0	0
11	33921537	.	A	T	2	3	5	0	1	6	0	0
11	33921598	.	T	A	1	2	3	0	0	3	0	0
11	33998282	.	G	A	1	2	3	0	0	3	0	0
11	33998656	.	A	T	1	3	4	0	0	4	0	0
11	33998681	.	G	T	1	2	3	0	0	3	0	0
11	34220083	.	G	A	3	4	7	0	0	7	0	0
11	34220129	.	C	T	5	2	7	0	0	7	0	0
11	34220436	.	T	C	1	0	1	0	0	1	0	0
11	34231302	.	G	A	4	2	6	0	0	6	0	0
11	34232662	.	A	G	5	7	12	0	0	12	0	0
11	34232681	.	A	G	2	3	5	0	0	5	0	0
11	34235427	.	C	A	11	8	19	0	0	19	0	0
11	34235498	.	C	G	9	4	13	0	0	13	0	0
11	34235528	.	T	C	7	7	14	0	0	14	0	0
11	34235825	.	A	T	14	13	27	0	2	29	0	0
11	34235858	.	A	C	10	13	23	0	3	26	0	0
11	34235918	.	A	G	9	0	9	0	10	19	0	0
11	34236092	.	G	T	9	6	15	0	2	17	0	0
11	34237150	.	C	T	10	6	16	0	0	16	0	0
11	34237217	.	A	G	8	5	13	0	0	13	0	0
11	34249644	.	G	A	1	2	3	0	1	4	0	0
11	34911094	.	A	G	4	10	14	0	0	14	0	0
11	34911229	.	G	A	6	13	19	0	0	19	0	0
11	34912907	.	A	C	0	4	4	2	1	7	0	0
11	35438612	.	A	C	0	6	6	0	2	8	0	0
11	35440173	.	T	A	6	3	9	0	0	9	0	0
11	36046521	.	T	A	2	1	3	0	0	3	0	0
11	36046523	.	A	C	1	1	2	0	1	3	0	0
11	36158379	.	A	C	4	3	7	0	0	7	0	0
11	36158839	.	G	T	1	1	2	0	0	2	0	0
11	36180612	.	C	T	3	3	6	0	0	6	0	0
11	36180666	.	C	T	1	1	2	0	1	3	0	0
11	36180774	.	A	G	4	3	7	0	0	7	0	0
11	36180775	.	T	C	4	3	7	0	0	7	0	0
11	36180876	.	C	A	5	2	7	0	0	7	0	0
11	36205992	.	C	T	3	3	6	0	0	6	0	0
11	36206090	.	C	T	5	5	10	0	1	11	0	0
11	36208199	.	G	A	7	8	15	0	0	15	0	0
11	36208328	.	G	A	0	3	3	0	7	10	0	0
11	36214517	.	C	T	23	16	39	0	2	41	0	0
11	36214815	.	G	A	1	16	17	0	13	30	0	0
11	36214859	.	C	T	14	11	25	0	3	28	0	0
11	36214955	.	A	T	8	10	18	0	0	18	0	0
11	36215346	.	G	A	13	11	24	0	3	27	0	0
11	36215399	.	A	G	14	12	26	0	2	28	0	0
11	36218548	.	G	C	4	1	5	0	0	5	0	0
11	36219658	.	C	T	0	2	2	0	4	6	0	0
11	36237094	.	C	T	4	2	6	0	0	6	0	0
11	36237421	.	T	C	3	2	5	0	0	5	0	0
11	36237601	.	A	C	1	2	3	0	0	3	0	0
11	36254334	.	C	T	1	2	3	0	0	3	0	0
11	36254653	.	C	A	0	4	4	0	5	9	0	0
11	36254992	.	T	C	7	4	11	0	1	12	0	0
11	36269682	.	G	A	4	2	6	0	0	6	0	0
11	36269768	.	A	G	4	1	5	0	0	5	0	0
11	36269788	.	A	G	2	0	2	0	0	2	0	0
11	36281939	.	T	G	6	9	15	0	1	16	0	0
11	36281943	.	G	A	7	9	16	0	1	17	0	0
11	36282259	.	A	T	9	5	14	0	1	15	0	0
11	36282417	.	G	T	5	4	9	0	1	10	0	0
11	36282450	.	G	T	6	8	14	0	0	14	0	0
11	36282494	.	G	T	3	3	6	0	1	7	0	0
11	36282501	.	C	T	4	4	8	0	0	8	0	0
11	36282612	.	G	A	9	3	12	0	0	12	0	0
11	36282621	.	T	C	7	0	7	0	4	11	0	0
11	36282792	.	G	C	1	2	3	0	0	3	0	0
11	36282809	.	T	C	1	2	3	0	0	3	0	0
11	36283050	.	T	C	1	3	4	0	0	4	0	0
11	36283061	.	A	G	1	3	4	0	0	4	0	0
11	36291207	.	G	A	0	1	1	0	0	1	0	0
11	36291208	.	T	C	0	1	1	0	0	1	0	0
11	36343066	.	G	T	7	4	11	0	2	13	0	0
11	36343167	.	G	C	13	18	31	0	0	31	0	0
11	36343339	.	A	T	3	3	6	0	0	6	0	0
11	36372690	.	G	A	2	4	6	0	0	6	0	0
11	36372937	.	A	G	1	2	3	0	0	3	0	0
11	36372961	.	G	A	1	2	3	0	0	3	0	0
11	36373738	.	T	C	2	6	8	0	0	8	0	0
11	36373746	.	T	C	3	4	7	0	1	8	0	0
11	36374083	.	G	A	3	3	6	0	0	6	0	0
11	36374944	.	T	G	4	5	9	2	0	11	0	0
11	36374958	.	T	C	2	5	7	2	0	9	0	0
11	36375120	.	T	G	3	2	5	3	1	9	0	0
11	36375184	.	A	T	3	2	5	0	0	5	0	0
11	36375367	.	T	C	3	6	9	0	1	10	0	0
11	36375671	.	C	T	10	10	20	0	0	20	0	0
11	36375708	.	A	G	13	6	19	0	2	21	0	0
11	36375774	.	A	T	8	5	13	0	0	13	0	0
11	36375852	.	T	G	6	11	17	0	0	17	0	0
11	36393111	.	A	G	4	0	4	0	5	9	0	0
11	36393150	.	T	A	3	4	7	0	1	8	0	0
11	36395728	.	T	C	0	3	3	0	0	3	0	0
11	36398192	.	G	A	1	4	5	0	5	10	0	0
11	36398318	.	A	G	3	9	12	0	0	12	0	0
11	36398531	.	A	G	6	1	7	0	6	13	0	0
11	36398558	.	T	A	6	5	11	0	0	11	0	0
11	36398624	.	C	T	6	5	11	0	1	12	0	0
11	36452372	.	G	A	3	2	5	0	0	5	0	0
11	36452453	.	C	A	5	3	8	0	0	8	0	0
11	36452534	.	C	A	3	4	7	0	0	8	1	0
11	36452688	.	A	G	4	7	11	0	1	12	0	0
11	36456011	.	C	T	0	4	4	0	2	6	0	0
11	36456056	.	T	C	8	4	12	0	1	13	0	0
11	36456058	.	T	G	8	5	13	0	0	13	0	0
11	36456101	.	T	A	5	7	12	0	1	13	0	0
11	36456125	.	A	C	3	0	3	0	6	9	0	0
11	36460829	.	G	A	10	5	15	0	0	15	0	0
11	36463965	.	T	C	6	2	8	0	0	8	0	0
11	36464541	.	T	A	1	1	2	0	0	2	0	0
11	36464565	.	G	C	1	0	1	0	0	1	0	0
11	36468047	.	G	A	1	3	4	0	0	4	0	0
11	36471901	.	C	T	1	1	2	0	0	2	0	0
11	36472383	.	G	A	3	1	4	0	0	4	0	0
11	36472395	.	C	T	2	0	2	0	0	2	0	0
11	36477626	.	G	A	6	3	9	0	0	9	0	0
11	36477777	.	C	T	2	2	4	0	0	4	0	0
11	36482269	.	A	G	3	2	5	0	0	5	0	0
11	36482311	.	C	T	3	3	6	0	0	6	0	0
11	36484836	.	G	A	3	5	8	0	0	8	0	0
11	36485042	.	A	G	10	1	11	0	5	16	0	0
11	36489169	.	G	C	1	2	3	0	0	3	0	0
11	36489205	.	T	C	5	5	10	0	0	10	0	0
11	36489428	.	A	T	3	5	8	0	0	8	0	0
11	36489706	.	T	C	6	2	8	0	0	8	0	0
11	36793859	.	G	A	2	1	3	0	0	3	0	0
11	36795564	.	G	T	6	5	11	0	0	11	0	0
11	36797149	.	C	T	0	2	2	0	1	3	0	0
11	36801796	.	G	A	2	1	3	0	1	4	0	0
11	36806296	.	A	G	7	1	8	0	0	8	0	0
11	36816163	.	T	C	1	7	8	0	0	8	0	0
11	36819529	.	C	T	2	4	6	0	0	6	0	0
11	36819859	.	A	T	1	2	3	0	1	4	0	0
11	36847092	.	A	G	2	3	5	0	0	5	0	0
11	36847101	.	T	G	1	2	3	0	1	4	0	0
11	36864000	.	C	T	1	1	2	0	0	2	0	0
11	36995494	.	A	G	1	0	1	0	0	1	0	0
11	37002607	.	C	T	3	0	3	0	0	3	0	0
11	37002616	.	G	A	1	0	1	0	0	1	0	0
11	37004670	.	C	T	1	0	1	0	0	1	0	0
11	37015956	.	C	T	3	2	5	0	0	5	0	0
11	37015968	.	T	C	0	1	1	0	0	1	0	0
11	37020723	.	C	T	0	1	1	0	0	1	0	0
11	37031950	.	C	T	2	6	8	0	0	8	0	0
11	37032055	.	G	A	10	11	21	0	0	21	0	0
11	37032610	.	A	T	1	5	6	0	0	6	0	0
11	37032626	.	T	C	1	7	8	0	1	9	0	0
11	37032739	.	C	T	5	3	8	0	0	8	0	0
11	37032740	.	A	T	5	3	8	0	0	8	0	0
11	37032854	.	C	A	8	3	11	0	0	11	0	0
11	37033333	.	A	C	6	7	13	0	0	13	0	0
11	37033348	.	C	A	7	8	15	0	0	15	0	0
11	37033373	.	C	T	3	4	7	0	0	7	0	0
11	37033603	.	T	A	6	2	8	1	0	9	0	0
11	37033676	.	C	T	9	6	15	0	0	15	0	0
11	37033813	.	C	G	8	6	14	0	0	14	0	0
11	37033846	.	G	C	11	6	17	0	0	17	0	0
11	37033855	.	T	A	10	7	17	0	0	17	0	0
11	37034359	.	G	A	0	2	2	0	3	5	0	0
11	37034475	.	T	C	2	2	4	0	0	4	0	0
11	37035240	.	T	A	7	5	12	0	6	18	0	0
11	37035454	.	A	G	13	0	13	0	17	30	0	0
11	37080880	.	C	G	1	2	3	0	0	3	0	0
11	37080971	.	G	T	5	3	8	0	0	8	0	0
11	37088847	.	A	T	5	3	8	0	0	8	0	0
11	37144633	.	C	A	1	5	6	0	0	6	0	0
11	37144704	.	C	T	2	3	5	0	0	5	0	0
11	37144864	.	C	T	1	2	3	0	0	3	0	0
11	37152069	.	G	A	1	2	3	0	0	3	0	0
11	37153439	.	A	T	0	1	1	0	0	1	0	0
11	37155247	.	A	T	4	5	9	0	0	9	0	0
11	37155353	.	A	G	7	0	7	0	4	11	0	0
11	37155394	.	A	G	7	5	12	0	0	12	0	0
11	37155400	.	T	A	4	8	12	0	0	12	0	0
11	37159490	.	C	T	8	7	15	0	0	15	0	0
11	37159902	.	G	A	0	1	1	0	0	1	0	0
11	37159994	.	T	A	6	0	6	0	0	6	0	0
11	37161822	.	G	A	0	1	1	0	0	1	0	0
11	37162529	.	G	A	9	3	12	0	0	12	0	0
11	37163874	.	A	G	5	5	10	0	0	10	0	0
11	37164191	.	G	C	7	7	14	0	0	14	0	0
11	37164510	.	T	C	1	6	7	0	0	7	0	0
11	37167289	.	A	G	4	1	5	0	0	5	0	0
11	37167402	.	A	G	6	0	6	0	7	13	0	0
11	37167669	.	C	T	12	10	22	0	0	22	0	0
11	37167955	.	G	A	3	2	5	0	0	5	0	0
11	37167991	.	T	C	4	4	8	0	1	9	0	0
11	37168162	.	T	A	2	1	3	0	0	3	0	0
11	37169108	.	A	G	5	4	9	0	0	9	0	0
11	37169144	.	G	A	10	13	23	0	0	23	0	0
11	37169269	.	G	A	2	2	4	0	0	4	0	0
11	37170409	.	A	G	5	0	5	0	3	8	0	0
11	37273526	.	T	G	1	2	3	0	0	3	0	0
11	37297811	.	A	T	27	18	45	0	0	45	0	0
11	37297951	.	T	C	23	18	41	0	3	45	1	0
11	37298028	.	T	A	14	13	27	0	2	29	0	0
11	37298718	.	G	A	16	13	29	0	1	30	0	0
11	37298796	.	G	A	19	9	28	0	1	29	0	0
11	37359387	.	C	T	1	2	3	0	2	5	0	0
11	37373093	.	G	A	0	0	0	0	1	1	0	0
11	37431722	.	C	T	1	5	6	0	1	7	0	0
11	37431953	.	C	T	30	23	53	0	3	56	0	0
11	37434255	.	T	G	9	9	18	0	0	18	0	0
11	37434259	.	T	G	10	10	20	0	0	20	0	0
11	37434618	.	C	T	4	11	15	0	1	16	0	0
11	37441257	.	T	G	23	20	43	0	2	45	0	0
11	37442557	.	G	A	7	7	14	0	0	14	0	0
11	37442772	.	G	T	12	10	22	0	2	24	0	0
11	37445084	.	G	A	12	6	18	0	0	18	0	0
11	37445680	.	C	T	9	6	15	0	0	15	0	0
11	37445825	.	G	A	8	8	16	0	1	17	0	0
11	37446107	.	G	A	5	4	9	0	0	9	0	0
11	37446173	.	T	A	1	2	3	0	0	3	0	0
11	37446700	.	C	T	7	5	12	0	1	13	0	0
11	37446736	.	C	G	9	6	15	0	0	15	0	0
11	37447754	.	C	T	0	5	5	0	5	10	0	0
11	37448396	.	T	C	2	4	6	0	0	6	0	0
11	37449098	.	G	T	1	2	3	0	0	3	0	0
11	37451040	.	C	T	0	2	2	0	2	4	0	0
11	37548381	.	C	T	0	2	2	0	0	2	0	0
11	37613577	.	G	A	10	18	28	0	3	31	0	0
11	37628230	.	C	T	32	31	63	0	1	64	0	0
11	37628595	.	T	C	17	22	39	0	0	39	0	0
11	37628816	.	T	C	11	28	39	0	0	39	0	0
11	37628831	.	C	T	13	25	38	0	2	40	0	0
11	37628863	.	T	A	14	27	41	0	0	41	0	0
11	37629046	.	G	A	22	26	48	0	0	48	0	0
11	37708992	.	A	C	6	3	9	0	0	9	0	0
11	37708997	.	T	A	6	4	10	0	0	10	0	0
11	37709031	.	A	C	7	4	11	0	0	11	0	0
11	37709033	.	A	G	7	4	11	0	0	11	0	0
11	37709133	.	G	A	8	11	19	0	0	19	0	0
11	37709303	.	C	A	18	8	26	0	0	27	1	0
11	37709334	.	T	C	11	9	20	0	0	20	0	0
11	37709450	.	T	C	12	0	12	0	10	22	0	0
11	37709475	.	C	A	8	8	16	0	1	17	0	0
11	37709542	.	T	C	5	7	12	0	0	12	0	0
11	37709545	.	G	A	5	7	12	0	1	13	0	0
11	37709677	.	A	G	4	8	12	0	0	12	0	0
11	37710026	.	T	A	3	4	7	0	0	7	0	0
11	37710089	.	C	T	4	3	7	0	0	7	0	0
11	37710328	.	T	A	4	3	7	0	0	7	0	0
11	37710333	.	T	C	4	3	7	0	0	7	0	0
11	37710680	.	A	G	4	5	9	0	0	9	0	0
11	37710709	.	T	C	2	0	2	0	4	6	0	0
11	37710790	.	G	A	3	7	10	0	0	10	0	0
11	37710960	.	A	G	6	3	9	0	1	10	0	0
11	37710962	.	A	G	7	3	10	0	0	10	0	0
11	37711005	.	G	A	8	2	10	0	1	11	0	0
11	37711498	.	G	A	4	4	8	0	0	8	0	0
11	37711507	.	A	G	4	3	7	0	0	7	0	0
11	37711540	.	T	C	4	2	6	0	1	7	0	0
11	37717543	.	C	T	0	3	3	0	3	6	0	0
11	37720622	.	C	A	12	13	25	0	2	27	0	0
11	37720658	.	G	A	17	16	33	0	1	34	0	0
11	37720671	.	A	G	12	14	26	0	2	28	0	0
11	37725854	.	C	T	1	1	2	0	0	2	0	0
11	37829168	.	A	C	3	2	5	0	0	5	0	0
11	37829505	.	C	A	2	2	4	0	0	4	0	0
11	37830045	.	G	A	0	5	5	0	3	8	0	0
11	37830436	.	C	G	2	2	4	0	0	4	0	0
11	37830531	.	G	A	0	2	2	0	2	4	0	0
11	37830890	.	A	T	2	2	4	0	1	5	0	0
11	37831082	.	T	G	1	4	5	0	0	5	0	0
11	37831111	.	A	C	1	3	4	0	1	5	0	0
11	37848872	.	C	T	1	3	4	0	1	5	0	0
11	37848961	.	G	A	1	3	4	0	0	4	0	0
11	38508182	.	A	G	1	8	9	0	0	9	0	0
11	38540251	.	T	A	10	4	14	0	3	17	0	0
11	38540288	.	C	A	12	4	16	0	0	16	0	0
11	38807987	.	C	T	7	8	15	0	0	15	0	0
11	38844445	.	G	C	8	8	16	0	0	16	0	0
11	38844481	.	T	C	16	8	24	0	1	25	0	0
11	38846017	.	G	A	0	4	4	0	5	9	0	0
11	38846152	.	G	A	1	3	4	0	0	4	0	0
11	38846316	.	T	A	8	11	19	0	2	21	0	0
11	38846361	.	G	A	7	9	16	0	0	16	0	0
11	38850244	.	G	A	0	9	9	0	6	15	0	0
11	38865710	.	A	G	16	18	34	0	0	34	0	0
11	38875221	.	A	G	16	14	30	0	1	31	0	0
11	38875283	.	A	T	15	26	41	0	0	41	0	0
11	38875352	.	G	A	19	18	37	0	0	37	0	0
11	38875397	.	T	G	19	7	26	0	0	26	0	0
11	38875484	.	A	C	17	11	28	0	1	29	0	0
11	38875660	.	T	C	20	21	41	0	0	41	0	0
11	38875867	.	T	C	9	8	17	0	1	18	0	0
11	39044412	.	T	C	1	2	3	0	0	3	0	0
11	39044541	.	G	C	6	5	11	0	0	11	0	0
11	39076002	.	T	A	1	6	7	0	0	7	0	0
11	39077749	.	T	C	1	0	1	0	1	2	0	0
11	39109555	.	C	T	2	1	3	0	0	3	0	0
11	39109968	.	C	T	6	2	8	0	0	8	0	0
11	39110046	.	C	T	0	1	1	0	0	1	0	0
11	39112035	.	A	G	6	12	18	0	1	19	0	0
11	39113067	.	G	T	2	4	6	0	0	6	0	0
11	39113410	.	C	T	1	4	5	0	1	6	0	0
11	39113423	.	C	G	2	2	4	0	0	4	0	0
11	39113449	.	G	T	2	2	4	0	0	4	0	0
11	39113906	.	C	T	0	2	2	0	2	4	0	0
11	39113986	.	C	T	1	3	4	0	1	5	0	0
11	39114037	.	G	A	3	3	6	0	0	6	0	0
11	39114195	.	C	A	1	2	3	0	0	3	0	0
11	39135160	.	T	A	10	9	19	0	0	19	0	0
11	39135834	.	C	G	18	9	27	0	0	27	0	0
11	39141536	.	A	C	25	27	52	0	0	53	1	0
11	39141732	.	T	G	9	13	22	0	0	22	0	0
11	39877711	.	C	T	5	3	8	0	2	11	1	0
11	39878200	.	A	G	1	0	1	0	3	4	0	0
11	39878442	.	A	C	8	9	17	0	0	17	0	0
11	39878503	.	C	A	10	3	13	0	0	13	0	0
11	39878515	.	G	T	1	5	6	0	7	13	0	0
11	39878558	.	A	C	8	6	14	0	1	15	0	0
11	39878740	.	G	A	6	11	17	0	0	17	0	0
11	39878788	.	T	A	7	10	17	0	1	18	0	0
11	39878980	.	C	T	6	4	10	0	0	10	0	0
11	39879316	.	A	G	4	6	10	0	0	10	0	0
11	39905164	.	C	T	7	10	17	0	1	18	0	0
11	39906110	.	C	T	2	10	12	0	0	12	0	0
11	39907021	.	C	G	23	9	32	0	1	33	0	0
11	39907585	.	G	A	5	4	9	0	0	9	0	0
11	39907618	.	C	G	9	6	15	0	0	15	0	0
11	39908020	.	T	G	9	4	13	0	0	13	0	0
11	39916450	.	G	A	1	0	1	0	1	2	0	0
11	39922402	.	G	A	0	18	18	0	14	32	0	0
11	39922407	.	G	A	14	15	29	0	1	30	0	0
11	39922714	.	A	C	8	11	19	0	0	19	0	0
11	39923292	.	A	T	6	3	9	0	2	11	0	0
11	39923551	.	T	A	20	17	37	0	2	39	0	0
11	39923653	.	C	T	13	21	34	0	5	39	0	0
11	39924083	.	A	T	22	15	37	0	0	38	1	0
11	39924235	.	G	C	12	4	16	0	1	17	0	0
11	39924243	.	G	T	14	3	17	0	2	19	0	0
11	39924341	.	C	G	14	23	37	0	0	37	0	0
11	39924358	.	T	C	9	21	30	0	3	33	0	0
11	39924413	.	G	A	20	15	35	0	1	36	0	0
11	39924639	.	C	T	21	17	38	0	0	38	0	0
11	39924652	.	C	T	15	19	34	0	5	39	0	0
11	39924711	.	A	T	17	21	38	0	1	39	0	0
11	39924736	.	A	G	15	18	33	0	2	35	0	0
11	39924783	.	T	A	12	22	34	0	2	37	1	0
11	39924784	.	A	T	11	23	34	0	3	37	0	0
11	39924929	.	G	A	13	5	18	0	0	18	0	0
11	39924946	.	C	T	14	5	19	0	0	19	0	0
11	39924989	.	G	T	14	17	31	0	0	31	0	0
11	39924999	.	C	T	16	13	29	0	2	31	0	0
11	39925225	.	C	A	16	26	42	0	1	43	0	0
11	39925458	.	G	A	23	13	36	0	7	43	0	0
11	39925529	.	C	T	12	24	36	0	3	39	0	0
11	39926041	.	C	T	26	22	48	0	1	49	0	0
11	39926216	.	A	G	7	21	28	0	1	29	0	0
11	39941661	.	A	G	2	0	2	0	1	3	0	0
11	39949703	.	C	T	8	4	12	0	2	14	0	0
11	39954026	.	T	G	11	10	21	0	1	22	0	0
11	39954319	.	G	A	0	7	7	0	14	21	0	0
11	39969260	.	A	C	2	3	5	0	1	6	0	0
11	39986402	.	T	C	1	0	1	0	0	1	0	0
11	40009040	.	T	C	3	2	5	0	0	5	0	0
11	40014079	.	A	G	2	4	6	0	0	6	0	0
11	40014346	.	G	A	3	4	7	0	0	7	0	0
11	40015113	.	G	A	5	3	8	0	0	8	0	0
11	40015380	.	C	G	2	4	6	0	0	6	0	0
11	40015529	.	T	C	2	6	8	0	0	8	0	0
11	40015537	.	G	A	1	5	6	0	0	6	0	0
11	40015696	.	C	T	1	3	4	0	0	4	0	0
11	40015849	.	A	C	1	3	4	0	0	4	0	0
11	40016253	.	C	T	1	3	4	0	0	4	0	0
11	40016261	.	A	T	1	4	5	0	0	5	0	0
11	40016524	.	G	A	0	2	2	0	1	3	0	0
11	40016528	.	T	C	1	2	3	0	0	3	0	0
11	40016649	.	A	C	6	5	11	0	0	11	0	0
11	40017290	.	G	C	5	4	9	0	0	9	0	0
11	40017333	.	A	T	7	4	11	0	0	11	0	0
11	40017501	.	A	T	5	3	8	0	0	8	0	0
11	40017504	.	T	A	4	3	7	0	1	8	0	0
11	40017604	.	T	C	9	5	14	0	0	14	0	0
11	40017815	.	A	C	7	5	12	2	0	14	0	0
11	40017829	.	A	G	6	6	12	0	2	14	0	0
11	40017865	.	T	A	6	3	9	3	0	12	0	0
11	40017885	.	G	A	5	4	9	3	0	12	0	0
11	40017949	.	A	T	4	8	12	0	1	13	0	0
11	40017994	.	T	C	8	7	15	0	0	15	0	0
11	40018042	.	T	C	15	9	24	0	0	24	0	0
11	40018633	.	G	A	5	7	12	0	0	12	0	0
11	40018668	.	A	T	6	10	16	0	1	17	0	0
11	40018799	.	G	T	0	7	7	0	5	12	0	0
11	40019004	.	G	A	1	2	3	1	0	4	0	0
11	40019076	.	G	A	4	1	5	0	2	7	0	0
11	40019078	.	A	G	4	0	4	0	3	7	0	0
11	40019276	.	A	C	4	6	10	0	1	11	0	0
11	40019278	.	T	A	5	5	10	0	1	11	0	0
11	40019411	.	C	T	12	0	12	0	0	12	0	0
11	40020303	.	A	G	10	4	14	0	0	14	0	0
11	40020304	.	G	C	10	4	14	0	0	14	0	0
11	40020354	.	T	C	11	7	18	0	1	19	0	0
11	40020375	.	A	G	5	5	10	0	0	10	0	0
11	40020389	.	A	G	3	5	8	0	0	8	0	0
11	40020683	.	G	T	6	11	17	0	3	20	0	0
11	40020928	.	G	A	15	6	21	0	0	21	0	0
11	40020950	.	A	G	8	4	12	0	2	14	0	0
11	40644440	.	G	T	2	1	3	0	0	3	0	0
11	40644458	.	A	G	2	3	5	0	0	5	0	0
11	40647099	.	T	C	4	0	4	0	5	9	0	0
11	40647123	.	A	C	3	6	9	0	0	9	0	0
11	40655819	.	T	C	12	9	21	0	0	21	0	0
11	40658079	.	A	C	15	18	33	0	0	33	0	0
11	40658091	.	A	T	11	15	26	0	5	31	0	0
11	40658154	.	C	G	9	1	10	0	8	18	0	0
11	40658232	.	C	T	8	10	18	0	0	18	0	0
11	40658455	.	T	C	4	5	9	0	0	9	0	0
11	40661378	.	T	C	2	4	6	0	0	6	0	0
11	40665545	.	T	C	18	14	32	0	1	33	0	0
11	40673797	.	C	T	19	14	33	0	0	33	0	0
11	40673877	.	A	G	14	9	23	0	0	23	0	0
11	40677891	.	A	T	16	28	44	0	5	49	0	0
11	40677967	.	T	C	47	18	65	0	2	67	0	0
11	40678385	.	T	G	30	32	62	0	2	64	0	0
11	40678445	.	A	C	19	0	19	0	32	51	0	0
11	40680890	.	A	G	4	8	12	0	1	13	0	0
11	40713994	.	T	C	1	2	3	0	0	3	0	0
11	40840407	.	T	C	2	1	3	0	0	3	0	0
11	40843208	.	T	C	4	8	12	0	0	12	0	0
11	40843814	.	T	C	11	9	20	0	1	21	0	0
11	40844085	.	T	G	5	1	6	0	0	6	0	0
11	40844094	.	C	T	5	2	7	0	0	7	0	0
11	40844162	.	T	C	4	5	9	0	0	9	0	0
11	40844195	.	A	T	5	6	11	0	2	13	0	0
11	40845117	.	T	C	2	8	10	0	1	11	0	0
11	40845515	.	T	C	7	7	14	1	1	16	0	0
11	41066765	.	T	G	16	16	32	0	0	32	0	0
11	41066871	.	C	T	15	14	29	0	0	29	0	0
11	41066888	.	C	T	14	15	29	0	0	29	0	0
11	41066950	.	A	G	11	27	38	0	0	38	0	0
11	41067275	.	G	A	6	20	26	0	0	26	0	0
11	41067430	.	A	T	6	7	13	0	0	13	0	0
11	41067442	.	C	T	5	10	15	0	0	15	0	0
11	41067488	.	A	C	6	8	14	0	2	16	0	0
11	41067502	.	G	A	6	9	15	0	2	17	0	0
11	41067613	.	A	G	1	7	8	0	0	8	0	0
11	41078522	.	C	A	2	4	6	0	0	6	0	0
11	41078578	.	A	T	6	5	11	0	0	11	0	0
11	41078762	.	A	T	4	2	6	0	0	6	0	0
11	41082558	.	G	C	2	3	5	0	0	5	0	0
11	41089631	.	G	T	5	2	7	0	1	8	0	0
11	41089641	.	T	C	5	2	7	0	1	8	0	0
11	41101666	.	A	G	10	4	14	0	0	14	0	0
11	41101760	.	A	T	3	3	6	0	0	6	0	0
11	41101800	.	T	A	3	3	6	0	0	6	0	0
11	41101866	.	C	T	2	3	5	0	0	5	0	0
11	41101910	.	G	A	0	5	5	0	2	7	0	0
11	41101918	.	C	T	2	6	8	0	0	8	0	0
11	41101948	.	A	G	4	1	5	0	3	8	0	0
11	41102013	.	A	G	3	0	3	0	4	7	0	0
11	41102026	.	T	C	3	3	6	0	1	7	0	0
11	41102205	.	A	G	1	1	2	0	2	4	0	0
11	41104549	.	A	G	7	3	10	0	0	10	0	0
11	41104934	.	G	A	6	4	10	0	0	10	0	0
11	41104954	.	C	T	7	7	14	0	0	14	0	0
11	41105030	.	G	A	0	8	8	0	5	13	0	0
11	41111301	.	A	G	10	7	17	0	0	18	1	0
11	41111334	.	T	C	10	9	19	0	1	20	0	0
11	41111370	.	C	T	6	8	14	0	0	14	0	0
11	41111422	.	A	G	2	12	14	0	0	14	0	0
11	41111431	.	A	C	2	11	13	0	0	13	0	0
11	41111561	.	T	A	4	5	9	0	0	9	0	0
11	41111603	.	T	A	3	5	8	0	1	9	0	0
11	41111735	.	G	A	3	4	7	0	0	7	0	0
11	41113231	.	T	C	4	0	4	0	5	9	0	0
11	41113239	.	T	C	4	3	7	0	0	7	0	0
11	41113398	.	T	C	3	2	5	0	0	5	0	0
11	41113412	.	C	T	4	2	6	0	0	6	0	0
11	41114055	.	C	T	0	3	3	0	2	5	0	0
11	41114090	.	G	T	2	3	5	0	0	5	0	0
11	41125040	.	A	G	2	1	3	0	0	3	0	0
11	41132195	.	A	G	1	1	2	0	0	2	0	0
11	41216254	.	C	G	0	2	2	0	3	5	0	0
11	41216395	.	A	G	1	9	10	0	0	10	0	0
11	41216413	.	C	A	1	9	10	0	0	10	0	0
11	41216455	.	T	C	1	1	2	0	11	13	0	0
11	41216505	.	G	C	1	13	14	0	1	15	0	0
11	41220596	.	G	A	11	13	24	0	0	24	0	0
11	41220613	.	C	T	0	12	12	0	10	22	0	0
11	41220683	.	T	A	11	7	18	0	0	18	0	0
11	41222940	.	A	G	13	9	22	0	1	23	0	0
11	41284921	.	C	T	0	1	1	0	1	2	0	0
11	41306035	.	G	A	0	2	2	0	5	7	0	0
11	41307691	.	T	C	1	3	4	0	0	4	0	0
11	41307733	.	A	G	2	7	9	0	0	9	0	0
11	41307844	.	T	C	4	1	5	0	0	5	0	0
11	41308482	.	G	A	1	2	3	0	0	3	0	0
11	41308483	.	A	G	1	2	3	0	0	3	0	0
11	41372906	.	G	T	0	3	3	0	8	11	0	0
11	41375027	.	C	G	3	2	5	2	1	8	0	0
11	41459981	.	G	C	0	2	2	0	2	4	0	0
11	41461417	.	C	G	8	13	21	0	0	21	0	0
11	41468791	.	C	T	2	9	11	0	0	11	0	0
11	41473980	.	G	T	10	15	25	0	0	25	0	0
11	41474041	.	T	A	9	11	20	0	0	20	0	0
11	41474042	.	G	T	9	11	20	0	0	20	0	0
11	41669291	.	C	T	0	1	1	0	0	1	0	0
11	41672337	.	T	C	3	3	6	0	0	6	0	0
11	41686121	.	A	G	2	0	2	0	2	4	0	0
11	41686133	.	A	G	2	3	5	0	0	5	0	0
11	41699744	.	A	C	2	3	5	0	0	5	0	0
11	41838930	.	T	A	3	5	8	0	2	10	0	0
11	41838933	.	C	A	3	5	8	0	2	10	0	0
11	41838991	.	T	G	2	1	3	0	5	8	0	0
11	41838999	.	G	T	2	4	6	0	0	6	0	0
11	41840493	.	T	C	3	2	5	0	0	5	0	0
11	41844192	.	C	A	0	1	1	0	0	1	0	0
11	41844342	.	T	C	5	3	8	0	0	8	0	0
11	41844396	.	A	G	2	0	2	0	7	9	0	0
11	41845916	.	C	T	3	3	6	0	0	6	0	0
11	41849977	.	C	T	0	3	3	0	3	6	0	0
11	41850559	.	G	A	0	1	1	0	0	1	0	0
11	41850565	.	G	A	0	1	1	0	0	1	0	0
11	41942440	.	T	C	2	3	5	0	0	5	0	0
11	41958013	.	C	T	3	4	7	0	0	7	0	0
11	41958058	.	C	T	3	1	4	0	0	4	0	0
11	41958278	.	A	T	0	2	2	0	0	2	0	0
11	41958317	.	T	C	3	6	9	0	1	10	0	0
11	41960058	.	A	C	14	9	23	0	0	23	0	0
11	41960059	.	C	T	14	8	22	0	1	23	0	0
11	41960101	.	A	G	10	12	22	0	1	23	0	0
11	41960111	.	C	T	10	13	23	0	1	24	0	0
11	41982546	.	G	A	0	1	1	0	5	6	0	0
11	42128555	.	T	A	2	7	9	0	0	9	0	0
11	42128615	.	A	C	7	9	16	0	0	16	0	0
11	42131413	.	T	C	1	0	1	0	3	4	0	0
11	42305868	.	C	A	0	6	6	0	6	12	0	0
11	42306017	.	G	A	5	7	12	0	4	16	0	0
11	42306049	.	T	C	2	0	2	0	11	13	0	0
11	42306627	.	C	T	0	15	15	0	4	19	0	0
11	42306928	.	A	T	12	22	34	0	0	34	0	0
11	42307147	.	T	A	17	20	37	0	1	38	0	0
11	42307400	.	A	T	9	12	21	0	0	21	0	0
11	42307671	.	G	A	10	11	21	0	1	22	0	0
11	42315414	.	A	C	3	0	3	0	0	3	0	0
11	42319340	.	C	T	9	5	14	0	0	14	0	0
11	42325535	.	C	T	6	2	8	0	0	8	0	0
11	42350847	.	C	T	6	5	11	0	0	11	0	0
11	42355806	.	C	T	2	2	4	0	0	4	0	0
11	42417409	.	T	C	5	4	9	0	0	9	0	0
11	42417479	.	T	G	2	7	9	0	0	9	0	0
11	42417628	.	A	C	0	6	6	0	0	6	0	0
11	42417691	.	G	A	1	4	5	0	0	5	0	0
11	42418042	.	G	A	3	3	6	0	0	6	0	0
11	42418246	.	C	T	3	5	8	0	1	9	0	0
11	42418268	.	A	G	2	7	9	0	0	9	0	0
11	42418310	.	A	T	3	4	7	0	0	7	0	0
11	42457249	.	G	A	0	2	2	0	2	4	0	0
11	42457328	.	A	C	3	6	9	0	0	10	1	0
11	42458330	.	A	G	1	3	4	0	0	4	0	0
11	42458419	.	T	C	2	3	5	0	0	5	0	0
11	42458446	.	A	G	2	2	4	0	0	4	0	0
11	42458475	.	A	T	2	3	5	0	0	5	0	0
11	42458482	.	A	G	0	3	3	0	2	5	0	0
11	42500584	.	C	G	1	3	4	0	0	4	0	0
11	42500643	.	A	T	4	2	6	0	0	6	0	0
11	42502108	.	T	A	5	2	7	0	0	7	0	0
11	42502164	.	C	T	5	4	9	0	0	9	0	0
11	42502203	.	T	C	1	5	6	0	1	7	0	0
11	42502261	.	T	C	2	3	5	0	0	5	0	0
11	42502308	.	T	A	2	2	4	0	0	4	0	0
11	42506093	.	C	T	1	2	3	0	0	3	0	0
11	42506576	.	T	A	3	6	9	0	0	9	0	0
11	42525232	.	T	A	2	2	4	0	0	4	0	0
11	42532465	.	C	T	0	6	6	0	7	13	0	0
11	42532660	.	T	G	5	6	11	0	0	11	0	0
11	42532703	.	T	A	5	2	7	0	0	7	0	0
11	42533125	.	C	T	9	8	17	0	1	18	0	0
11	42533318	.	G	A	4	4	8	0	0	8	0	0
11	42533321	.	T	G	4	4	8	0	0	8	0	0
11	42539476	.	G	A	5	3	8	0	0	8	0	0
11	42557693	.	A	G	13	3	16	0	0	16	0	0
11	42560439	.	G	A	26	26	52	0	2	54	0	0
11	42560475	.	C	T	12	13	25	0	3	28	0	0
11	42561212	.	C	A	2	4	6	0	1	7	0	0
11	42604033	.	C	T	2	0	2	0	0	2	0	0
11	42615275	.	A	C	3	4	7	0	0	7	0	0
11	42618675	.	A	G	2	0	2	0	2	4	0	0
11	42618720	.	A	G	3	3	6	0	0	6	0	0
11	42730657	.	A	G	8	15	23	0	0	23	0	0
11	42730931	.	C	T	15	17	32	0	0	32	0	0
11	42731172	.	G	C	3	3	6	0	0	6	0	0
11	42731173	.	G	T	3	3	6	0	0	6	0	0
11	42766088	.	T	C	2	1	3	0	1	4	0	0
11	42771442	.	G	A	0	1	1	0	0	1	0	0
11	42783955	.	G	C	2	1	3	0	0	3	0	0
11	42783985	.	G	A	2	2	4	0	0	4	0	0
11	42793640	.	T	A	3	5	8	0	1	9	0	0
11	42801451	.	A	T	2	4	6	0	0	6	0	0
11	42801508	.	T	A	2	6	8	0	0	8	0	0
11	42801547	.	C	T	0	1	1	0	0	1	0	0
11	42808988	.	C	T	4	1	5	0	1	6	0	0
11	42809233	.	A	G	4	5	9	0	1	10	0	0
11	42809345	.	T	C	8	4	12	0	1	13	0	0
11	42809558	.	A	G	2	6	8	0	0	8	0	0
11	42811938	.	G	A	0	6	6	0	2	8	0	0
11	42815207	.	C	A	6	3	9	0	1	10	0	0
11	42815649	.	T	A	0	1	1	0	0	1	0	0
11	42815653	.	T	A	0	2	2	0	0	2	0	0
11	42815695	.	T	A	1	2	3	0	0	3	0	0
11	42815824	.	A	G	3	0	3	0	2	5	0	0
11	42815846	.	G	A	4	0	4	0	0	5	1	0
11	42815911	.	A	G	1	2	3	0	0	3	0	0
11	42816044	.	A	T	3	2	5	0	0	5	0	0
11	42816152	.	G	A	0	4	4	0	4	8	0	0
11	42816189	.	G	A	8	3	11	0	1	12	0	0
11	42816208	.	A	T	9	4	13	0	1	14	0	0
11	42816263	.	G	C	0	4	4	0	10	14	0	0
11	42816765	.	C	A	3	2	5	0	0	5	0	0
11	42816811	.	A	C	9	3	12	0	1	13	0	0
11	42817067	.	A	G	5	3	8	0	0	8	0	0
11	42817075	.	T	G	5	0	5	0	3	8	0	0
11	42817459	.	A	T	12	6	18	0	1	19	0	0
11	42817476	.	G	C	0	7	7	0	12	19	0	0
11	42817598	.	A	G	4	1	5	0	9	14	0	0
11	42912098	.	T	C	1	4	5	0	0	5	0	0
11	42912126	.	A	G	1	3	4	0	0	4	0	0
11	42912594	.	A	T	3	4	7	0	0	7	0	0
11	42912784	.	A	G	6	5	11	0	1	12	0	0
11	42912791	.	G	A	6	5	11	0	1	12	0	0
11	42912837	.	T	A	2	4	6	0	0	6	0	0
11	42913020	.	A	G	2	2	4	0	0	4	0	0
11	42913021	.	C	T	0	1	1	0	3	4	0	0
11	42915022	.	T	A	2	2	4	0	0	4	0	0
11	42915665	.	G	A	1	5	6	0	0	6	0	0
11	42915887	.	G	A	4	2	6	0	0	6	0	0
11	42916577	.	A	T	1	2	3	0	0	3	0	0
11	42916595	.	G	A	0	2	2	0	0	2	0	0
11	42933019	.	A	G	1	2	3	0	0	3	0	0
11	42933432	.	C	T	1	2	3	0	1	4	0	0
11	42933696	.	A	G	10	7	17	0	1	18	0	0
11	42933703	.	T	C	10	7	17	0	0	17	0	0
11	42933780	.	G	A	8	4	12	0	0	12	0	0
11	42939803	.	T	C	2	4	6	0	0	6	0	0
11	42940748	.	C	T	1	0	1	0	0	1	0	0
11	43470332	.	T	C	4	4	8	0	0	8	0	0
11	44328905	.	A	G	12	20	32	0	2	34	0	0
11	44328956	.	T	C	23	20	43	0	1	44	0	0
11	44329050	.	A	G	10	23	33	0	2	35	0	0
11	44329172	.	C	T	8	15	23	0	2	25	0	0
11	44334935	.	T	A	15	22	37	0	0	37	0	0
11	44337494	.	T	A	1	5	6	0	0	6	0	0
11	44337497	.	A	G	1	5	6	0	0	6	0	0
11	44340354	.	C	T	0	5	5	0	3	8	0	0
11	44358817	.	G	T	1	3	4	0	2	6	0	0
11	44361689	.	C	G	10	2	12	0	0	12	0	0
11	44361701	.	C	T	11	4	15	0	0	15	0	0
11	44400918	.	G	A	5	4	9	0	1	10	0	0
11	44400960	.	G	T	6	6	12	0	1	13	0	0
11	44401057	.	C	A	6	9	15	0	1	16	0	0
11	44401275	.	G	A	7	8	15	0	1	16	0	0
11	44401437	.	G	A	9	6	15	0	1	16	0	0
11	44403378	.	C	G	3	3	6	0	0	6	0	0
11	44522995	.	A	G	5	2	7	0	1	8	0	0
11	44606844	.	G	T	9	5	14	0	0	14	0	0
11	44607019	.	T	A	14	3	17	0	0	17	0	0
11	44607052	.	G	A	18	2	20	0	1	21	0	0
11	44619132	.	A	T	4	1	5	0	0	5	0	0
11	44622594	.	C	T	0	2	2	0	0	2	0	0
11	44624723	.	A	C	2	4	6	0	0	6	0	0
11	44633294	.	T	C	2	2	4	0	0	4	0	0
11	44637569	.	T	A	5	3	8	0	1	9	0	0
11	44637950	.	A	G	23	27	50	0	4	54	0	0
11	44643882	.	C	T	3	4	7	0	2	9	0	0
11	44647227	.	A	C	23	0	23	0	28	51	0	0
11	44647269	.	T	G	14	13	27	0	4	31	0	0
11	44723130	.	C	G	2	14	16	0	0	16	0	0
11	44723353	.	G	A	1	16	17	0	12	29	0	0
11	44723374	.	T	C	12	15	27	0	1	28	0	0
11	44723416	.	T	G	11	2	13	0	22	35	0	0
11	44723653	.	T	G	11	17	28	0	2	30	0	0
11	44723746	.	A	G	23	20	43	0	6	49	0	0
11	44725596	.	C	T	30	17	47	0	0	47	0	0
11	44725926	.	G	A	0	26	26	0	27	53	0	0
11	44805701	.	G	A	0	1	1	0	0	1	0	0
11	44834268	.	G	A	0	1	1	0	1	2	0	0
11	44838743	.	G	A	0	4	4	0	0	4	0	0
11	44843706	.	A	G	2	0	2	0	2	4	0	0
11	44852248	.	A	G	6	0	6	0	7	13	0	0
11	44852285	.	C	A	7	6	13	0	0	13	0	0
11	44852771	.	T	A	1	2	3	0	0	3	0	0
11	44852988	.	T	A	3	2	5	0	0	5	0	0
11	44853021	.	G	C	5	3	8	0	0	8	0	0
11	44853325	.	T	C	3	4	7	0	1	8	0	0
11	44853908	.	A	T	3	9	12	0	2	14	0	0
11	44854894	.	T	G	5	9	14	0	0	14	0	0
11	44854918	.	G	A	0	10	10	0	8	18	0	0
11	44854996	.	T	C	11	11	22	0	1	23	0	0
11	44855027	.	G	A	0	19	19	0	12	32	1	0
11	44880288	.	A	G	12	14	26	0	3	29	0	0
11	44880291	.	T	A	11	16	27	0	2	29	0	0
11	44880332	.	G	A	13	13	26	0	1	27	0	0
11	44880345	.	C	G	12	12	24	0	0	24	0	0
11	44887200	.	G	A	15	12	27	0	2	29	0	0
11	44887224	.	T	C	8	1	9	0	13	22	0	0
11	44887612	.	G	T	18	12	30	0	1	31	0	0
11	44891507	.	G	A	6	1	7	0	0	7	0	0
11	44892859	.	T	A	1	0	1	0	0	1	0	0
11	44892883	.	G	A	7	1	8	0	0	8	0	0
11	44892943	.	G	A	11	8	19	0	0	19	0	0
11	44892979	.	T	A	1	4	5	0	1	6	0	0
11	44897584	.	C	T	8	15	23	0	0	23	0	0
11	44897647	.	A	C	9	10	19	0	1	20	0	0
11	44901315	.	C	T	0	8	8	0	12	20	0	0
11	44901373	.	C	A	28	34	62	0	3	65	0	0
11	44910758	.	T	G	2	1	3	0	0	3	0	0
11	44912485	.	C	A	0	2	2	0	3	5	0	0
11	44913176	.	C	A	0	9	9	0	4	13	0	0
11	44914943	.	G	C	8	10	18	0	0	18	0	0
11	44921573	.	T	C	1	0	1	0	3	4	0	0
11	44927159	.	C	A	2	3	5	0	0	5	0	0
11	44927833	.	G	T	0	1	1	0	0	1	0	0
11	44935375	.	A	G	2	2	4	0	1	5	0	0
11	44936276	.	A	G	1	2	3	0	0	3	0	0
11	44960620	.	G	A	1	0	1	0	0	1	0	0
11	45097342	.	C	A	1	2	3	0	0	3	0	0
11	45097357	.	A	G	1	0	1	0	2	3	0	0
11	45125627	.	T	C	1	2	3	0	0	3	0	0
11	45126730	.	C	A	2	6	8	0	1	9	0	0
11	45126772	.	G	A	4	2	6	0	0	6	0	0
11	45126985	.	A	G	4	2	6	0	1	7	0	0
11	45127029	.	C	T	5	4	9	0	0	9	0	0
11	45127191	.	G	A	6	8	14	0	1	15	0	0
11	45127335	.	C	T	0	8	8	0	9	17	0	0
11	45127374	.	G	A	5	7	12	0	0	12	0	0
11	45130676	.	A	G	2	5	7	0	1	8	0	0
11	45130874	.	C	A	0	2	2	0	4	6	0	0
11	45138758	.	G	T	7	5	12	0	0	12	0	0
11	45139844	.	A	G	2	6	8	0	0	8	0	0
11	45140116	.	C	G	8	6	14	0	0	14	0	0
11	45141286	.	T	C	4	2	6	0	0	6	0	0
11	45147865	.	G	C	0	1	1	0	0	1	0	0
11	45161950	.	T	C	10	0	10	0	9	19	0	0
11	45162241	.	A	T	9	6	15	0	1	16	0	0
11	45162416	.	T	C	11	0	11	0	20	31	0	0
11	45167709	.	G	A	4	3	7	0	0	7	0	0
11	45171160	.	C	T	2	2	4	0	2	6	0	0
11	45171162	.	T	C	1	4	5	0	1	6	0	0
11	45223968	.	G	A	0	2	2	0	0	2	0	0
11	45233971	.	G	A	0	3	3	0	2	5	0	0
11	45240568	.	C	T	1	4	5	0	0	5	0	0
11	45242912	.	T	C	2	1	3	0	0	3	0	0
11	45245862	.	G	A	2	6	8	0	0	8	0	0
11	45245964	.	C	T	0	3	3	0	4	7	0	0
11	45257659	.	C	T	1	3	4	0	0	4	0	0
11	45262079	.	C	T	7	8	15	0	1	16	0	0
11	45262138	.	C	G	7	0	7	0	9	16	0	0
11	45262155	.	T	C	10	6	16	0	1	17	0	0
11	45262186	.	G	A	0	9	9	0	8	17	0	0
11	45262379	.	G	T	5	7	12	0	1	13	0	0
11	45287575	.	G	A	1	6	7	0	0	7	0	0
11	45290884	.	C	T	10	4	14	0	0	14	0	0
11	45291926	.	G	A	3	0	3	0	0	3	0	0
11	45292918	.	G	A	0	6	6	0	7	13	0	0
11	45294493	.	C	T	12	6	18	0	2	20	0	0
11	45294553	.	C	A	12	11	23	0	1	24	0	0
11	45294807	.	T	C	11	0	11	0	1	12	0	0
11	45294942	.	T	C	1	0	1	0	0	1	0	0
11	45294943	.	G	A	1	0	1	0	0	1	0	0
11	45327456	.	C	T	2	3	5	0	0	5	0	0
11	45327609	.	T	C	2	5	7	0	0	7	0	0
11	45327922	.	C	G	0	5	5	0	0	5	0	0
11	45328046	.	C	T	1	4	5	0	1	6	0	0
11	45342468	.	T	G	3	2	5	0	0	5	0	0
11	45342625	.	C	T	2	2	4	0	0	4	0	0
11	45342676	.	A	T	5	3	8	0	0	8	0	0
11	45342757	.	A	G	4	6	10	0	0	10	0	0
11	45342823	.	G	A	4	2	6	0	3	9	0	0
11	45342861	.	A	C	4	5	9	0	1	10	0	0
11	45343033	.	A	G	3	3	6	0	0	6	0	0
11	45343045	.	C	G	2	3	5	0	0	5	0	0
11	45343231	.	T	A	6	4	10	0	1	11	0	0
11	45343264	.	A	T	3	7	10	0	0	10	0	0
11	45344090	.	C	T	1	1	2	0	0	2	0	0
11	45350673	.	C	A	2	3	5	0	0	5	0	0
11	45351794	.	T	C	2	2	4	0	0	4	0	0
11	45351801	.	C	T	2	1	3	0	1	4	0	0
11	45355022	.	C	G	17	13	30	0	1	31	0	0
11	45355473	.	C	T	0	19	19	0	17	36	0	0
11	45355717	.	A	G	12	5	17	0	2	19	0	0
11	45356041	.	T	A	4	4	8	0	0	8	0	0
11	45356042	.	G	A	4	4	8	0	0	8	0	0
11	45356114	.	G	A	8	11	19	0	2	21	0	0
11	45356660	.	C	T	0	8	8	0	6	14	0	0
11	45359878	.	C	T	1	1	2	0	0	2	0	0
11	45362172	.	A	T	6	7	13	0	0	13	0	0
11	45363073	.	G	A	5	6	11	0	1	12	0	0
11	45366754	.	T	C	4	0	4	0	5	9	0	0
11	45371868	.	A	G	2	3	5	0	0	5	0	0
11	45389922	.	G	A	1	4	5	0	0	5	0	0
11	45391727	.	T	C	6	7	13	0	0	13	0	0
11	45393520	.	A	C	1	8	9	0	12	21	0	0
11	45393522	.	A	C	1	2	3	0	18	21	0	0
11	45395572	.	G	A	0	12	12	0	11	23	0	0
11	45397372	.	C	T	18	15	33	0	1	34	0	0
11	45398744	.	A	G	5	5	10	0	0	10	0	0
11	45398804	.	T	C	10	7	17	0	0	17	0	0
11	45399389	.	A	G	6	11	17	0	1	18	0	0
11	45399491	.	C	T	22	23	45	1	2	48	0	0
11	45399799	.	G	T	13	16	29	0	1	30	0	0
11	45399925	.	C	T	17	13	30	0	0	30	0	0
11	45399985	.	G	T	1	16	17	0	24	41	0	0
11	45402945	.	G	A	17	16	33	0	0	33	0	0
11	45403525	.	G	A	15	9	24	0	0	24	0	0
11	45403733	.	G	A	22	12	34	0	1	35	0	0
11	45403800	.	T	A	19	12	31	0	1	32	0	0
11	45403854	.	G	A	19	14	33	0	1	34	0	0
11	45407215	.	G	A	2	3	5	0	0	5	0	0
11	45419948	.	C	G	0	1	1	0	3	4	0	0
11	45430139	.	C	T	1	2	3	0	0	3	0	0
11	45439842	.	G	A	0	1	1	0	1	2	0	0
11	45452445	.	A	G	1	6	7	0	0	7	0	0
11	45452786	.	G	A	0	1	1	0	1	2	0	0
11	45460271	.	G	A	0	1	1	0	2	3	0	0
11	45461498	.	G	A	0	4	4	0	5	9	0	0
11	45463352	.	T	C	4	5	9	0	0	9	0	0
11	45463661	.	G	A	0	3	3	0	26	30	1	0
11	45463730	.	G	A	0	12	12	0	11	23	0	0
11	45463835	.	G	T	11	11	22	0	0	22	0	0
11	45463979	.	T	A	14	3	17	0	4	21	0	0
11	45464041	.	T	C	5	4	9	0	0	9	0	0
11	45464762	.	A	T	11	6	17	0	0	17	0	0
11	45464835	.	G	A	10	7	17	0	0	17	0	0
11	45465080	.	T	A	10	16	26	0	1	27	0	0
11	45468906	.	T	A	0	5	5	0	0	5	0	0
11	45468956	.	C	A	1	4	5	0	0	5	0	0
11	45468959	.	G	A	1	4	5	0	0	5	0	0
11	45469273	.	A	G	8	8	16	0	0	16	0	0
11	45469636	.	T	C	5	2	7	0	1	8	0	0
11	45469829	.	C	T	2	2	4	0	0	4	0	0
11	45469839	.	T	C	2	0	2	0	2	4	0	0
11	45469882	.	T	C	3	3	6	0	1	7	0	0
11	45469914	.	G	T	1	4	5	0	0	5	0	0
11	45470277	.	C	T	2	10	12	0	8	20	0	0
12	465732	.	G	A	0	3	3	0	6	9	0	0
12	466174	.	T	A	5	6	11	0	1	12	0	0
12	497201	.	C	T	15	8	23	0	0	23	0	0
12	499855	.	C	T	2	4	6	0	0	6	0	0
12	499865	.	C	T	2	3	5	0	1	6	0	0
12	502221	.	C	T	6	6	12	0	0	12	0	0
12	503308	.	G	A	16	14	30	0	0	30	0	0
12	516845	.	C	T	3	3	6	0	1	7	0	0
12	518107	.	T	C	2	1	3	0	0	3	0	0
12	527402	.	A	C	22	15	37	0	0	37	0	0
12	527693	.	T	G	16	19	35	0	1	36	0	0
12	527712	.	T	C	14	19	33	0	0	33	0	0
12	534927	.	T	C	2	2	4	0	0	4	0	0
12	549605	.	T	C	6	0	6	0	6	12	0	0
12	550387	.	G	T	12	8	20	0	1	21	0	0
12	550513	.	T	A	11	9	20	0	1	21	0	0
12	550516	.	C	T	0	9	9	0	12	21	0	0
12	550973	.	T	C	11	10	21	0	0	21	0	0
12	550985	.	T	C	11	0	11	0	8	19	0	0
12	551098	.	A	G	13	9	22	0	1	23	0	0
12	551192	.	A	G	7	9	16	0	0	16	0	0
12	551372	.	C	T	11	11	22	0	3	25	0	0
12	551398	.	C	T	11	9	20	0	2	22	0	0
12	551549	.	T	C	0	0	0	0	1	1	0	0
12	551892	.	T	C	10	0	10	0	15	25	0	0
12	551927	.	A	G	7	11	18	0	2	20	0	0
12	554210	.	T	C	9	0	9	0	13	22	0	0
12	558142	.	A	C	9	9	18	0	0	18	0	0
12	560561	.	T	A	1	2	3	0	0	3	0	0
12	560609	.	G	A	2	2	4	0	0	4	0	0
12	560797	.	T	C	2	2	4	0	0	4	0	0
12	560814	.	T	C	1	2	3	0	0	3	0	0
12	561131	.	G	T	3	5	8	0	0	8	0	0
12	561350	.	G	T	5	2	7	0	0	7	0	0
12	562200	.	C	T	4	4	8	0	0	8	0	0
12	562203	.	C	T	0	4	4	0	4	8	0	0
12	564552	.	C	T	3	2	5	0	5	10	0	0
12	564553	.	G	A	2	4	6	0	4	10	0	0
12	564650	.	G	T	6	5	11	0	0	11	0	0
12	565571	.	C	G	6	3	9	0	1	10	0	0
12	566983	.	A	G	3	3	6	0	0	6	0	0
12	567012	.	T	C	3	0	3	0	2	5	0	0
12	568872	.	G	A	0	2	2	0	0	2	0	0
12	571873	.	T	C	2	3	5	0	0	5	0	0
12	571933	.	T	C	1	0	1	0	1	2	0	0
12	598520	.	A	G	0	2	2	0	0	2	0	0
12	600798	.	A	G	0	1	1	0	0	1	0	0
12	630495	.	G	A	2	2	4	0	0	4	0	0
12	634292	.	C	T	0	4	4	0	0	4	0	0
12	847787	.	T	C	8	17	25	0	2	27	0	0
12	847932	.	G	T	21	14	35	0	1	36	0	0
12	848846	.	T	C	18	0	18	0	16	34	0	0
12	850303	.	T	C	5	4	9	0	0	9	0	0
12	906722	.	A	G	2	5	7	0	1	8	0	0
12	911042	.	C	T	0	2	2	0	4	6	0	0
12	911162	.	G	C	10	5	15	0	1	16	0	0
12	911180	.	A	C	6	5	11	0	0	11	0	0
12	912274	.	G	C	4	3	7	0	0	7	0	0
12	931371	.	G	A	1	1	2	0	0	2	0	0
12	931410	.	C	A	0	1	1	0	1	2	0	0
12	931437	.	A	G	0	1	1	0	0	1	0	0
12	932092	.	G	T	4	5	9	0	1	10	0	0
12	964877	.	T	C	19	1	20	0	26	46	0	0
12	964888	.	T	G	19	21	40	0	0	40	0	0
12	972975	.	C	T	1	4	5	0	6	11	0	0
12	979718	.	G	A	6	1	7	0	0	7	0	0
12	982870	.	A	T	1	2	3	0	0	3	0	0
12	982979	.	T	A	5	11	16	0	2	18	0	0
12	983074	.	C	T	9	7	16	0	1	17	0	0
12	983222	.	G	A	5	6	11	0	1	12	0	0
12	983340	.	C	T	10	13	23	0	1	24	0	0
12	986792	.	T	G	4	4	8	0	0	8	0	0
12	986834	.	A	G	2	2	4	0	0	4	0	0
12	989974	.	G	C	4	3	7	0	0	7	0	0
12	992615	.	C	T	2	2	4	0	0	4	0	0
12	992698	.	A	G	2	2	4	0	0	4	0	0
12	993176	.	T	C	5	5	10	0	0	10	0	0
12	993237	.	C	G	8	3	11	0	0	11	0	0
12	997834	.	T	C	4	10	14	0	0	14	0	0
12	997849	.	T	C	4	6	10	0	1	11	0	0
12	997909	.	A	G	0	1	1	0	0	1	0	0
12	1014495	.	C	G	2	2	4	0	0	4	0	0
12	1014553	.	C	T	0	14	14	0	4	18	0	0
12	1014668	.	A	G	4	14	18	0	3	21	0	0
12	1015197	.	C	T	0	9	9	0	5	14	0	0
12	1015845	.	G	A	4	11	15	0	0	15	0	0
12	1019123	.	C	T	0	3	3	0	5	8	0	0
12	1019243	.	G	T	1	4	5	0	0	5	0	0
12	1019311	.	C	G	1	5	6	0	1	7	0	0
12	1019503	.	G	A	1	1	2	0	0	2	0	0
12	1021152	.	G	A	4	4	8	0	0	8	0	0
12	1030048	.	A	G	2	3	5	0	0	5	0	0
12	1387913	.	A	G	7	2	9	0	0	9	0	0
12	1947596	.	T	C	1	0	1	0	6	7	0	0
12	1947645	.	G	A	6	3	9	0	1	10	0	0
12	1947656	.	A	T	7	3	10	0	1	11	0	0
12	1947822	.	A	G	3	5	8	0	0	8	0	0
12	1947999	.	G	A	3	5	8	0	0	8	0	0
12	1950141	.	C	A	0	3	3	0	1	4	0	0
12	2743795	.	A	G	4	3	7	0	0	7	0	0
12	2744279	.	G	T	1	2	3	0	0	3	0	0
12	2744291	.	A	T	1	2	3	0	0	3	0	0
12	2744495	.	T	G	0	2	2	0	0	2	0	0
12	2744549	.	A	G	4	2	6	0	0	6	0	0
12	2744580	.	G	A	1	4	5	0	0	5	0	0
12	2781010	.	G	C	0	0	0	0	2	2	0	0
12	2849970	.	A	G	1	6	7	0	0	7	0	0
12	2849974	.	A	G	3	3	6	0	1	7	0	0
12	3271244	.	T	A	2	10	12	0	0	12	0	0
12	3271250	.	A	G	2	9	11	0	0	11	0	0
12	3271553	.	G	A	8	6	14	0	0	14	0	0
12	3271714	.	A	G	3	1	4	0	0	4	0	0
12	3271717	.	A	G	1	2	3	0	2	5	0	0
12	3272402	.	A	G	8	4	12	0	0	12	0	0
12	3272421	.	A	G	6	6	12	0	5	17	0	0
12	3287912	.	G	A	7	4	11	0	0	11	0	0
12	3571986	.	C	T	4	11	15	0	1	16	0	0
12	3574398	.	C	G	7	13	20	0	2	22	0	0
12	3714149	.	G	T	3	6	9	0	3	12	0	0
12	3714183	.	G	A	6	7	13	0	0	13	0	0
12	3714213	.	T	A	8	11	19	0	0	19	0	0
12	3714315	.	C	T	11	10	21	0	0	21	0	0
12	3714330	.	A	T	11	8	19	0	1	20	0	0
12	3714425	.	C	A	11	6	17	0	0	17	0	0
12	3714578	.	T	C	2	0	2	0	6	8	0	0
12	3714602	.	T	C	1	6	7	0	0	7	0	0
12	3714650	.	T	C	1	4	5	0	0	5	0	0
12	3715016	.	A	G	3	7	10	0	1	11	0	0
12	3715086	.	T	C	2	4	6	0	0	6	0	0
12	3715134	.	G	A	4	4	8	0	1	9	0	0
12	3715201	.	T	C	5	6	11	0	0	11	0	0
12	3715426	.	T	C	2	4	6	0	0	6	0	0
12	3715429	.	T	C	1	3	4	0	2	6	0	0
12	3715474	.	T	C	7	2	9	0	0	9	0	0
12	3715489	.	G	T	2	3	5	0	1	6	0	0
12	3715544	.	T	C	7	8	15	0	0	15	0	0
12	3715585	.	T	C	6	3	9	0	0	9	0	0
12	3715730	.	T	C	1	0	1	0	6	7	0	0
12	3715904	.	G	A	8	4	12	0	0	12	0	0
12	3719297	.	T	G	1	0	1	0	0	1	0	0
12	3726646	.	T	A	11	7	18	0	2	20	0	0
12	3731590	.	G	A	0	3	3	0	3	6	0	0
12	3731602	.	C	A	5	3	8	0	0	8	0	0
12	3740940	.	G	A	8	11	19	0	1	20	0	0
12	3740958	.	C	A	7	7	14	0	0	14	0	0
12	3747640	.	G	A	1	1	2	0	0	2	0	0
12	3749502	.	A	G	1	2	3	0	0	3	0	0
12	3756203	.	G	C	6	8	14	0	0	14	0	0
12	3756215	.	G	A	7	6	13	0	1	14	0	0
12	3756297	.	G	T	3	7	10	0	1	11	0	0
12	3756303	.	C	T	0	3	3	0	9	12	0	0
12	3789171	.	A	G	1	4	5	0	0	5	0	0
12	3789409	.	T	C	1	0	1	0	4	5	0	0
12	3789489	.	T	A	2	4	6	0	2	8	0	0
12	3805979	.	G	A	5	3	8	0	0	8	0	0
12	3806732	.	C	T	2	6	8	0	1	9	0	0
12	3806810	.	C	T	1	3	4	0	0	4	0	0
12	3806825	.	T	G	2	1	3	0	0	3	0	0
12	3808704	.	A	G	1	2	3	0	0	3	0	0
12	3808728	.	C	T	2	3	5	0	0	5	0	0
12	3811570	.	C	G	0	1	1	0	0	1	0	0
12	3855125	.	G	A	1	0	1	0	0	1	0	0
12	3860624	.	G	A	0	3	3	0	0	3	0	0
12	3860696	.	C	T	1	1	2	0	0	2	0	0
12	3861246	.	A	G	2	3	5	0	0	5	0	0
12	3861279	.	A	G	5	0	5	0	3	8	0	0
12	3875596	.	A	G	1	2	3	0	0	3	0	0
12	3875727	.	T	C	1	2	3	0	0	3	0	0
12	3877941	.	G	A	3	1	4	0	2	6	0	0
12	3880610	.	A	G	3	4	7	0	0	7	0	0
12	3880612	.	G	T	3	4	7	0	0	7	0	0
12	3880646	.	C	A	3	5	8	0	0	8	0	0
12	3885358	.	C	T	1	0	1	0	0	1	0	0
12	3889974	.	A	G	3	0	3	0	4	7	0	0
12	3921924	.	T	A	3	2	5	0	1	6	0	0
12	3922047	.	A	G	1	3	4	0	0	4	0	0
12	3922068	.	A	T	1	3	4	0	0	4	0	0
12	3922086	.	A	C	1	3	4	0	0	4	0	0
12	3922503	.	C	T	6	3	9	0	0	9	0	0
12	3922536	.	A	G	6	5	11	0	0	11	0	0
12	3922549	.	G	A	0	5	5	0	7	12	0	0
12	3944265	.	T	C	4	4	8	0	2	10	0	0
12	3946833	.	G	A	12	10	22	0	0	22	0	0
12	3948593	.	C	T	2	0	2	0	0	2	0	0
12	3949212	.	G	A	23	21	44	0	0	44	0	0
12	3951117	.	C	T	4	7	11	0	1	12	0	0
12	3953155	.	T	A	10	8	18	0	1	19	0	0
12	3954003	.	T	G	6	7	13	0	0	13	0	0
12	3954072	.	C	T	7	3	10	0	0	10	0	0
12	3955573	.	A	C	4	0	4	0	3	7	0	0
12	3956864	.	A	G	1	2	3	0	1	4	0	0
12	3964936	.	C	A	0	10	10	0	18	28	0	0
12	3965002	.	G	T	7	10	17	0	6	23	0	0
12	3965168	.	T	C	17	21	38	0	0	38	0	0
12	3965237	.	G	A	3	1	4	0	0	4	0	0
12	3974755	.	C	T	0	8	8	0	2	10	0	0
12	3998961	.	A	T	3	8	11	0	0	11	0	0
12	4002687	.	C	A	4	6	10	0	0	10	0	0
12	4002709	.	A	G	4	7	11	0	0	11	0	0
12	4004448	.	C	T	0	3	3	0	3	6	0	0
12	4004466	.	C	T	0	2	2	0	0	2	0	0
12	4009150	.	G	A	2	2	4	0	0	4	0	0
12	4009194	.	C	T	4	5	9	0	0	9	0	0
12	4009337	.	G	A	4	7	11	0	0	11	0	0
12	4009392	.	C	A	1	4	5	0	0	5	0	0
12	4009393	.	G	C	4	1	5	0	0	5	0	0
12	4020204	.	T	C	0	2	2	0	0	2	0	0
12	4020257	.	T	C	1	0	1	0	3	4	0	0
12	4020275	.	C	G	1	2	3	0	0	3	0	0
12	4143674	.	C	G	3	2	5	0	0	5	0	0
12	4143690	.	A	T	1	2	3	0	0	3	0	0
12	4144291	.	T	C	2	6	8	0	0	8	0	0
12	4144321	.	G	A	5	2	7	0	0	7	0	0
12	4144811	.	A	G	3	4	7	0	0	7	0	0
12	4144869	.	G	T	1	2	3	0	0	3	0	0
12	4144874	.	G	A	1	0	1	0	2	3	0	0
12	4220453	.	A	G	1	1	2	0	0	2	0	0
12	4220656	.	T	C	6	3	9	0	0	9	0	0
12	4225361	.	A	T	1	3	4	0	0	4	0	0
12	4226155	.	A	G	0	0	0	0	1	1	0	0
12	4226846	.	T	A	3	2	5	0	0	5	0	0
12	4227308	.	C	G	5	4	9	0	0	9	0	0
12	4231548	.	C	T	3	6	9	0	0	9	0	0
12	4231775	.	A	G	3	6	9	0	1	10	0	0
12	4231776	.	G	A	3	6	9	0	1	10	0	0
12	4232028	.	G	A	0	3	3	0	4	7	0	0
12	4232055	.	G	C	4	6	10	0	0	10	0	0
12	4232208	.	C	G	5	5	10	0	1	11	0	0
12	4232210	.	T	A	5	5	10	0	1	11	0	0
12	4232320	.	C	T	4	3	7	0	1	8	0	0
12	4232369	.	G	T	5	6	11	0	0	11	0	0
12	4232434	.	C	A	7	3	10	0	0	10	0	0
12	4234489	.	G	C	2	4	6	0	0	6	0	0
12	4238122	.	T	C	4	3	7	0	0	7	0	0
12	4238464	.	A	G	8	0	8	0	15	23	0	0
12	4238519	.	C	A	9	10	19	0	4	23	0	0
12	4238720	.	T	C	2	3	5	0	0	5	0	0
12	4601361	.	G	A	1	3	4	0	3	7	0	0
12	4602047	.	T	A	10	13	23	0	1	24	0	0
12	4602245	.	G	A	19	19	38	0	3	41	0	0
12	4602322	.	G	A	23	17	40	0	3	43	0	0
12	4602399	.	A	T	18	16	34	0	0	34	0	0
12	4602464	.	G	C	19	0	19	0	12	31	0	0
12	4602503	.	C	A	14	19	33	0	0	33	0	0
12	4606669	.	C	T	11	8	19	0	0	19	0	0
12	4606693	.	G	A	3	6	9	0	0	9	0	0
12	4609143	.	C	T	9	5	14	0	0	14	0	0
12	4609172	.	T	G	5	8	13	0	1	14	0	0
12	4609364	.	A	G	8	13	21	0	0	21	0	0
12	4609391	.	T	C	4	11	15	0	0	15	0	0
12	4609409	.	C	T	3	3	6	0	0	6	0	0
12	4611128	.	C	T	16	15	31	0	0	31	0	0
12	4615329	.	G	A	13	12	25	0	1	26	0	0
12	4616967	.	C	G	13	3	16	0	0	16	0	0
12	4617243	.	G	A	15	19	34	0	2	36	0	0
12	4618033	.	C	T	7	3	10	0	1	11	0	0
12	4618087	.	T	G	12	12	24	0	1	25	0	0
12	4618588	.	G	A	2	5	7	0	0	7	0	0
12	4619230	.	G	T	7	8	15	0	0	15	0	0
12	4619553	.	C	T	2	8	10	0	0	10	0	0
12	4619718	.	C	T	4	5	9	0	1	10	0	0
12	4619895	.	G	A	9	5	14	0	0	14	0	0
12	4620211	.	T	A	4	6	10	0	1	12	1	0
12	4620483	.	C	T	0	3	3	0	10	13	0	0
12	4621108	.	A	T	6	4	10	0	0	10	0	0
12	4621363	.	C	G	0	3	3	0	2	5	0	0
12	4621480	.	G	A	6	2	8	0	1	9	0	0
12	4621782	.	A	G	3	3	6	0	1	7	0	0
12	4622344	.	G	A	3	2	5	0	1	6	0	0
12	4631531	.	A	G	1	2	3	0	0	3	0	0
12	4644090	.	C	T	8	5	13	0	0	13	0	0
12	4645262	.	C	G	3	2	5	0	0	5	0	0
12	4645291	.	G	T	3	3	6	0	0	6	0	0
12	4653986	.	C	T	0	2	2	0	3	5	0	0
12	4661410	.	C	T	1	2	3	0	0	3	0	0
12	4686524	.	G	A	3	2	5	0	2	7	0	0
12	4690311	.	A	G	1	2	3	0	0	3	0	0
12	4690425	.	G	A	0	2	2	0	3	5	0	0
12	4690668	.	G	C	3	3	6	0	0	6	0	0
12	4690785	.	T	C	2	2	4	0	0	4	0	0
12	4691043	.	G	A	1	4	5	0	3	8	0	0
12	4691146	.	A	G	3	2	5	0	0	5	0	0
12	4712234	.	T	C	2	1	3	0	0	3	0	0
12	4713010	.	C	A	3	3	6	0	0	6	0	0
12	4715953	.	A	G	1	0	1	0	0	1	0	0
12	4715968	.	G	A	2	3	5	0	0	5	0	0
12	4716061	.	A	C	6	3	9	0	1	10	0	0
12	4716064	.	T	G	6	0	6	0	4	10	0	0
12	4716361	.	A	G	1	1	2	0	0	2	0	0
12	4716375	.	T	C	1	3	4	0	0	4	0	0
12	4720264	.	T	C	8	2	10	0	0	10	0	0
12	4722415	.	C	T	7	3	10	0	2	12	0	0
12	4724553	.	G	A	8	9	17	0	1	18	0	0
12	4724765	.	G	A	0	4	4	0	5	9	0	0
12	4725114	.	A	C	7	7	14	0	0	14	0	0
12	4725170	.	A	T	12	10	22	0	1	23	0	0
12	4733968	.	C	T	17	13	30	0	0	30	0	0
12	4734008	.	G	T	11	19	30	0	0	30	0	0
12	4734068	.	G	T	17	17	34	0	0	34	0	0
12	4734306	.	A	T	11	16	27	0	2	29	0	0
12	4734312	.	A	G	12	19	31	0	0	31	0	0
12	4734418	.	T	G	20	20	40	0	3	43	0	0
12	4734476	.	T	C	12	0	12	0	18	30	0	0
12	4734925	.	C	T	20	27	47	0	1	48	0	0
12	4734967	.	G	A	12	19	31	0	2	33	0	0
12	4734979	.	C	T	0	11	11	0	16	27	0	0
12	4751860	.	C	T	2	2	4	0	0	4	0	0
12	4752981	.	G	A	5	9	14	0	0	14	0	0
12	4753014	.	A	G	7	17	24	0	1	25	0	0
12	4753020	.	A	G	10	16	26	0	1	27	0	0
12	4753095	.	C	T	9	26	35	0	0	35	0	0
12	4753104	.	C	T	0	26	26	0	13	39	0	0
12	4957095	.	A	G	4	3	7	0	0	7	0	0
12	4960974	.	A	G	2	0	2	0	2	4	0	0
12	4961162	.	C	T	2	3	5	0	1	6	0	0
12	4961930	.	A	G	2	3	5	0	0	5	0	0
12	4961955	.	A	C	3	3	6	0	0	6	0	0
12	4962195	.	A	G	3	0	3	0	4	7	0	0
12	4962640	.	C	A	3	2	5	0	1	6	0	0
12	4962643	.	G	T	0	3	3	0	3	6	0	0
12	5044221	.	A	C	1	2	3	0	0	3	0	0
12	5044228	.	T	G	1	2	3	0	0	3	0	0
12	5044396	.	T	C	2	3	5	0	0	5	0	0
12	5044545	.	A	G	0	0	0	0	2	2	0	0
12	5044737	.	A	G	4	0	4	0	5	9	0	0
12	5054809	.	A	C	1	1	2	0	0	2	0	0
12	5059785	.	T	C	3	2	5	0	0	5	0	0
12	5059829	.	A	G	2	0	2	0	4	6	0	0
12	5059868	.	C	G	1	3	4	0	0	4	0	0
12	5070229	.	A	C	2	3	5	0	0	5	0	0
12	5070290	.	G	A	1	4	5	0	0	5	0	0
12	5071104	.	T	A	1	0	1	0	0	1	0	0
12	5084514	.	C	T	9	9	18	0	1	19	0	0
12	5090591	.	T	C	2	5	7	0	0	7	0	0
12	5091368	.	A	T	4	8	12	0	0	12	0	0
12	5116192	.	A	G	15	7	22	0	0	22	0	0
12	5116587	.	G	A	1	2	3	0	0	3	0	0
12	5119802	.	T	C	12	11	23	0	1	24	0	0
12	5156507	.	G	A	2	4	6	0	0	6	0	0
12	5156617	.	A	T	1	3	4	0	1	5	0	0
12	5156634	.	A	T	2	2	4	0	0	4	0	0
12	5156671	.	A	G	2	2	4	0	0	4	0	0
12	5180489	.	G	A	1	4	5	0	0	5	0	0
12	5180626	.	G	A	0	1	1	0	0	1	0	0
12	5182460	.	T	C	2	0	2	0	0	2	0	0
12	5190063	.	A	G	2	2	4	0	0	4	0	0
12	5223875	.	A	G	1	2	3	0	0	3	0	0
12	5389940	.	T	C	1	4	5	0	0	5	0	0
12	5398183	.	T	G	1	4	5	0	0	5	0	0
12	5398514	.	T	G	2	4	6	0	0	6	0	0
12	5399803	.	G	A	1	4	5	0	0	5	0	0
12	5399832	.	G	C	1	1	2	0	0	2	0	0
12	5404160	.	T	C	0	0	0	0	1	1	0	0
12	5404181	.	G	C	0	0	0	0	1	1	0	0
12	5404403	.	C	T	0	2	2	0	0	2	0	0
12	5412179	.	C	T	0	1	1	0	1	2	0	0
12	5414913	.	T	C	1	0	1	0	0	1	0	0
12	5424326	.	A	T	4	2	6	0	0	6	0	0
12	5424785	.	A	T	3	0	3	0	1	4	0	0
12	5427456	.	T	A	5	8	13	0	0	13	0	0
12	5427491	.	T	G	2	5	7	0	0	7	0	0
12	5451926	.	G	A	2	2	4	0	1	5	0	0
12	5452362	.	A	T	1	2	3	0	0	3	0	0
12	5452367	.	T	C	1	2	3	0	0	3	0	0
12	5452625	.	A	G	2	0	2	0	1	3	0	0
12	5458512	.	G	A	1	2	3	0	2	5	0	0
12	5581617	.	G	C	1	1	2	0	1	3	0	0
12	6105069	.	A	G	1	1	2	0	0	2	0	0
12	6445359	.	T	C	1	0	1	0	0	1	0	0
12	6449243	.	T	C	1	0	1	0	0	1	0	0
12	6467294	.	A	G	1	0	1	0	2	3	0	0
12	6543458	.	C	G	3	6	9	0	0	9	0	0
12	6543906	.	G	C	7	13	20	0	2	22	0	0
12	6547214	.	A	G	4	2	6	0	0	6	0	0
12	6576130	.	A	T	2	1	3	0	1	4	0	0
12	6584481	.	C	T	0	0	0	0	2	2	0	0
12	6587222	.	T	C	3	0	3	0	4	7	0	0
12	6600355	.	T	C	1	0	1	0	0	1	0	0
12	6606982	.	G	A	3	3	6	0	0	6	0	0
12	6756277	.	A	G	0	1	1	0	0	1	0	0
12	7193865	.	C	T	7	4	11	0	1	12	0	0
12	7193874	.	A	G	6	4	10	0	2	12	0	0
12	7194410	.	A	G	7	16	23	0	1	24	0	0
12	7194423	.	T	C	11	1	12	0	18	30	0	0
12	7194505	.	T	C	10	11	21	0	0	21	0	0
12	7194522	.	T	C	11	10	21	0	0	21	0	0
12	7194587	.	G	A	2	6	8	0	0	8	0	0
12	7194843	.	C	A	3	7	10	0	2	12	0	0
12	7194932	.	G	A	8	14	22	0	0	22	0	0
12	7195024	.	T	C	9	8	17	0	0	17	0	0
12	7195081	.	G	T	11	9	20	0	2	22	0	0
12	7195192	.	G	T	14	11	25	0	0	25	0	0
12	7195518	.	A	T	14	6	20	0	0	20	0	0
12	7195588	.	G	A	8	7	15	0	0	15	0	0
12	7195816	.	C	A	3	5	8	0	0	8	0	0
12	7195942	.	C	T	3	5	8	0	1	9	0	0
12	7195951	.	T	C	5	0	5	0	4	9	0	0
12	7196125	.	A	G	12	9	21	0	0	21	0	0
12	7196230	.	A	T	4	7	11	0	2	13	0	0
12	7196249	.	G	T	3	12	15	0	1	16	0	0
12	7196346	.	G	A	3	5	8	0	0	8	0	0
12	7196416	.	T	A	1	7	8	0	1	9	0	0
12	7196425	.	A	C	1	0	1	0	8	9	0	0
12	7196619	.	T	C	9	3	12	0	0	12	0	0
12	7197041	.	T	A	1	0	1	0	0	1	0	0
12	7197152	.	G	A	1	3	4	0	0	4	0	0
12	7197264	.	G	T	8	4	12	0	0	12	0	0
12	7197278	.	A	G	9	5	14	0	0	14	0	0
12	7197590	.	G	T	3	4	7	0	0	7	0	0
12	7198135	.	T	A	6	5	11	0	0	11	0	0
12	7198215	.	C	A	3	2	5	0	0	5	0	0
12	7198317	.	T	A	5	3	8	0	0	8	0	0
12	7198335	.	C	T	1	3	4	0	6	10	0	0
12	7199229	.	C	A	5	3	8	0	0	8	0	0
12	7199447	.	C	T	2	5	7	0	1	8	0	0
12	7199738	.	A	G	3	0	3	0	0	3	0	0
12	7199759	.	T	C	1	0	1	0	0	1	0	0
12	7223665	.	C	T	1	0	1	0	0	1	0	0
12	7234692	.	G	A	7	3	10	0	0	10	0	0
12	7234790	.	G	A	4	3	7	0	0	7	0	0
12	7235030	.	G	A	7	5	12	0	0	12	0	0
12	7254324	.	A	T	0	4	4	0	0	4	0	0
12	7263657	.	G	T	0	5	5	0	5	10	0	0
12	7263665	.	G	T	0	5	5	0	3	8	0	0
12	7269266	.	G	A	4	2	6	0	0	6	0	0
12	7269673	.	G	A	6	2	8	0	0	8	0	0
12	7271895	.	A	G	2	8	10	0	0	10	0	0
12	7275695	.	T	C	2	1	3	0	0	3	0	0
12	7280160	.	G	T	0	2	2	0	0	2	0	0
12	7507047	.	C	T	2	3	5	0	0	5	0	0
12	7512637	.	T	C	13	9	22	0	0	22	0	0
12	7512641	.	T	A	9	14	23	0	0	23	0	0
12	7512675	.	G	A	10	13	23	0	0	23	0	0
12	7512682	.	A	G	10	13	23	0	0	23	0	0
12	7512921	.	A	G	9	4	13	0	0	13	0	0
12	7512965	.	C	A	9	8	17	0	0	17	0	0
12	7513106	.	C	A	8	4	12	0	0	12	0	0
12	7513446	.	T	A	12	6	18	0	1	19	0	0
12	7513480	.	C	T	14	6	20	0	2	22	0	0
12	7513555	.	G	A	9	2	11	0	0	11	0	0
12	7513637	.	G	A	6	10	16	0	1	17	0	0
12	7513658	.	C	T	7	12	19	0	1	20	0	0
12	7513685	.	C	A	7	13	20	0	2	22	0	0
12	7610969	.	T	C	9	6	15	0	0	15	0	0
12	7611189	.	T	C	8	0	8	0	4	12	0	0
12	7611201	.	T	C	9	2	11	0	1	12	0	0
12	7611286	.	T	C	4	4	8	0	0	8	0	0
12	7611526	.	T	C	6	4	10	0	0	10	0	0
12	7611527	.	T	C	6	0	6	0	4	10	0	0
12	7612106	.	T	C	1	10	11	0	0	11	0	0
12	10125546	.	A	G	6	4	10	0	0	10	0	0
12	10125573	.	A	G	1	7	8	0	0	8	0	0
12	11390365	.	T	C	1	4	5	0	1	6	0	0
12	13473687	.	A	G	9	3	12	0	0	12	0	0
12	13474461	.	A	G	18	6	24	0	0	24	0	0
12	13475225	.	A	G	15	10	25	0	1	26	0	0
12	13475229	.	A	G	18	6	24	0	1	25	0	0
12	18529360	.	A	T	4	2	6	0	0	6	0	0
12	18713926	.	C	T	6	7	13	0	0	13	0	0
12	18714000	.	C	T	13	13	26	0	1	27	0	0
12	18716985	.	C	T	8	10	18	0	0	18	0	0
12	18717085	.	A	G	9	7	16	0	0	16	0	0
12	18717471	.	T	C	2	4	6	0	0	6	0	0
12	18717477	.	T	A	2	5	7	0	0	7	0	0
12	18779450	.	T	A	0	1	1	0	0	1	0	0
12	18779648	.	T	C	1	0	1	0	0	1	0	0
12	18782541	.	G	A	8	3	11	0	1	12	0	0
12	18782763	.	G	A	2	1	3	0	1	4	0	0
12	18786773	.	T	C	8	15	23	0	0	23	0	0
12	18786917	.	T	C	5	11	16	0	0	16	0	0
12	18787009	.	G	A	9	10	19	0	0	19	0	0
12	18787205	.	C	T	8	6	14	0	0	14	0	0
12	18913503	.	A	G	6	5	11	0	0	11	0	0
12	18913906	.	A	G	14	8	22	0	0	22	0	0
12	18913938	.	A	G	11	9	20	0	0	20	0	0
12	19062233	.	A	G	15	6	21	0	0	21	0	0
12	19317745	.	G	A	17	5	22	0	1	23	0	0
12	19317791	.	G	A	21	27	48	0	5	53	0	0
12	19317875	.	G	A	23	19	42	0	1	43	0	0
12	19317930	.	G	T	3	15	18	0	21	39	0	0
12	19318157	.	T	C	23	12	35	0	2	37	0	0
12	19318158	.	G	A	23	12	35	0	2	37	0	0
12	19318194	.	G	C	17	12	29	0	1	30	0	0
12	19318210	.	T	C	15	19	34	0	0	34	0	0
12	19318441	.	A	T	2	8	10	0	0	10	0	0
12	19318539	.	G	A	8	9	17	0	0	17	0	0
12	19318615	.	A	T	9	11	20	0	1	21	0	0
12	19318823	.	A	G	8	1	9	1	18	28	0	0
12	19318855	.	C	T	12	19	31	0	1	32	0	0
12	19319085	.	T	G	1	3	4	0	0	4	0	0
12	19319105	.	C	T	2	4	6	0	1	7	0	0
12	19337850	.	G	A	2	7	9	0	0	9	0	0
12	19338003	.	G	T	3	7	10	0	0	10	0	0
12	19338032	.	T	A	3	3	6	0	0	6	0	0
12	19338127	.	G	C	1	1	2	0	1	3	0	0
12	19338280	.	G	A	6	7	13	1	0	14	0	0
12	19338387	.	T	G	5	9	14	0	0	14	0	0
12	19339065	.	G	T	3	6	9	0	0	9	0	0
12	19339403	.	C	A	4	5	9	0	0	9	0	0
12	19339490	.	T	A	8	4	12	0	3	15	0	0
12	19339492	.	C	T	11	4	15	0	0	15	0	0
12	19341869	.	G	A	27	10	37	0	1	38	0	0
12	19348622	.	A	G	11	25	36	0	1	37	0	0
12	19348678	.	T	C	11	18	29	0	3	32	0	0
12	19353091	.	C	T	29	16	45	0	2	47	0	0
12	19353174	.	C	T	10	19	29	0	3	32	0	0
12	19353203	.	A	C	10	19	29	0	1	30	0	0
12	19353513	.	A	G	8	11	19	0	2	21	0	0
12	19353622	.	A	T	25	8	33	0	1	34	0	0
12	19362426	.	T	C	5	9	14	0	0	14	0	0
12	19362500	.	C	T	3	3	6	0	1	7	0	0
12	19362624	.	A	G	5	3	8	0	0	8	0	0
12	19369292	.	G	A	10	9	19	0	1	20	0	0
12	19369414	.	A	G	3	6	9	0	0	9	0	0
12	19371801	.	A	G	6	1	7	0	5	12	0	0
12	19373175	.	G	A	3	2	5	0	0	5	0	0
12	19375729	.	T	C	2	2	4	0	0	4	0	0
12	19375741	.	C	T	2	2	4	0	0	4	0	0
12	19379564	.	G	C	0	5	5	0	11	16	0	0
12	19379642	.	C	T	5	7	12	0	1	13	0	0
12	19380120	.	A	G	1	1	2	0	0	2	0	0
12	19383137	.	A	G	14	10	24	0	1	25	0	0
12	19383139	.	T	C	13	10	23	0	2	25	0	0
12	19383217	.	T	C	9	6	15	0	0	15	0	0
12	19383242	.	T	A	8	6	14	0	0	14	0	0
12	19383260	.	A	T	3	4	7	0	0	8	1	0
12	19383417	.	T	C	9	13	22	0	0	22	0	0
12	19383539	.	C	T	5	14	19	0	1	20	0	0
12	19383843	.	G	A	7	3	10	0	0	10	0	0
12	19385072	.	G	A	2	4	6	0	0	6	0	0
12	19385287	.	T	C	7	2	9	0	0	9	0	0
12	19385664	.	C	T	3	0	3	0	1	4	0	0
12	19393795	.	A	G	5	3	8	0	1	9	0	0
12	19412850	.	C	T	1	2	3	0	0	3	0	0
12	19422271	.	T	C	0	2	2	0	0	2	0	0
12	19422319	.	T	C	1	3	4	0	0	4	0	0
12	19422410	.	G	A	0	6	6	0	3	9	0	0
12	19430068	.	G	A	0	2	2	0	2	4	0	0
12	19430150	.	A	G	4	6	10	0	1	11	0	0
12	19430154	.	A	G	5	6	11	0	0	11	0	0
12	19433542	.	C	G	1	0	1	0	0	1	0	0
12	19433953	.	T	C	0	1	1	0	0	1	0	0
12	19447036	.	C	T	1	3	4	0	0	4	0	0
12	19637039	.	T	G	10	7	17	0	1	18	0	0
12	19658505	.	T	C	2	6	8	0	1	9	0	0
12	19658587	.	A	G	2	7	9	0	0	9	0	0
12	19658626	.	C	T	2	6	8	0	1	9	0	0
12	19658691	.	A	G	8	0	8	0	9	17	0	0
12	19658735	.	A	T	7	9	16	0	1	17	0	0
12	19658836	.	G	A	12	9	21	0	1	22	0	0
12	19792566	.	T	C	7	10	17	0	4	21	0	0
12	19792945	.	C	G	13	11	24	0	0	24	0	0
12	19792970	.	G	A	17	8	25	0	0	25	0	0
12	19793001	.	G	A	21	11	32	0	0	32	0	0
12	19793039	.	T	A	16	10	26	0	0	26	0	0
12	19793470	.	C	G	12	20	32	0	1	33	0	0
12	19793534	.	T	A	10	14	24	0	4	28	0	0
12	19793657	.	G	A	14	10	24	0	0	24	0	0
12	19793693	.	A	G	3	3	6	0	0	6	0	0
12	19865090	.	T	C	19	0	19	0	10	29	0	0
12	19865347	.	C	T	8	11	19	0	0	19	0	0
12	19865567	.	G	A	8	5	13	0	0	13	0	0
12	19866983	.	A	G	3	2	5	0	0	5	0	0
12	19907100	.	A	T	1	2	3	0	0	3	0	0
12	19932072	.	T	C	3	5	8	0	0	8	0	0
12	19932122	.	C	A	3	4	7	0	0	7	0	0
12	19932195	.	A	T	1	3	4	0	1	5	0	0
12	19967552	.	A	G	0	0	0	0	1	1	0	0
12	19967554	.	A	G	0	0	0	0	1	1	0	0
12	19970187	.	T	C	2	1	3	0	0	3	0	0
12	19973531	.	A	G	2	0	2	0	6	8	0	0
12	19973564	.	T	C	2	7	9	0	0	9	0	0
12	19973939	.	A	G	1	1	2	0	6	8	0	0
12	19973942	.	A	G	1	5	6	0	0	6	0	0
12	19974092	.	G	A	0	5	5	0	9	14	0	0
12	19974196	.	G	A	1	5	6	0	0	6	0	0
12	19974421	.	T	G	4	2	6	0	0	6	0	0
12	20026573	.	T	G	2	2	4	0	0	4	0	0
12	20034735	.	T	C	3	3	6	0	1	7	0	0
12	20034744	.	T	C	2	3	5	0	1	6	0	0
12	20036100	.	C	T	0	2	2	0	0	2	0	0
12	20036106	.	A	G	0	2	2	0	0	2	0	0
12	20043897	.	G	C	1	2	3	0	0	3	0	0
12	20099085	.	A	G	16	13	29	0	0	29	0	0
12	20099478	.	A	G	13	10	23	0	0	23	0	0
12	20099657	.	T	C	9	7	16	1	2	19	0	0
12	20099708	.	T	A	12	11	23	0	0	23	0	0
12	20100109	.	A	G	16	18	34	0	1	35	0	0
12	20100169	.	A	G	13	20	33	0	1	34	0	0
12	20100190	.	T	C	6	0	6	0	18	24	0	0
12	20100391	.	G	A	14	13	27	0	0	27	0	0
12	20122785	.	T	C	7	3	10	0	0	10	0	0
12	20123881	.	A	C	2	2	4	0	0	4	0	0
12	20125561	.	A	G	2	0	2	0	5	7	0	0
12	20147218	.	G	C	16	6	22	0	2	24	0	0
12	20147229	.	A	G	16	1	17	0	0	17	0	0
12	20147260	.	G	A	18	6	24	0	1	25	0	0
12	20147428	.	G	A	19	17	36	0	2	38	0	0
12	20147486	.	A	G	14	0	14	0	11	25	0	0
12	20147504	.	T	C	14	10	24	0	2	26	0	0
12	20147564	.	A	T	12	12	24	0	4	28	0	0
12	20155907	.	G	C	0	2	2	0	2	4	0	0
12	20156045	.	T	C	3	2	5	0	0	5	0	0
12	20156168	.	G	A	0	5	5	0	3	8	0	0
12	20156177	.	G	A	4	4	8	0	0	8	0	0
12	20156546	.	A	G	1	2	3	0	0	3	0	0
12	20227724	.	A	G	2	2	4	0	1	5	0	0
12	20227766	.	C	T	0	3	3	0	2	5	0	0
12	20367728	.	A	T	0	0	0	0	1	1	0	0
12	20379586	.	G	C	12	4	16	0	0	16	0	0
12	20380050	.	C	G	2	0	2	0	0	2	0	0
12	20396459	.	T	A	9	6	15	0	0	15	0	0
12	20406815	.	T	C	1	0	1	0	1	2	0	0
12	20406818	.	G	A	1	1	2	0	0	2	0	0
12	20407789	.	A	G	0	3	3	0	0	3	0	0
12	20409495	.	G	T	5	3	8	0	1	9	0	0
12	20409523	.	A	G	8	4	12	0	1	13	0	0
12	20409585	.	G	C	3	0	3	0	3	6	0	0
12	20409600	.	A	G	2	3	5	0	0	5	0	0
12	20409680	.	T	A	5	3	8	0	0	8	0	0
12	20607308	.	C	T	6	6	12	0	0	12	0	0
12	20607417	.	C	T	3	4	7	0	0	7	0	0
12	20607711	.	G	C	5	4	9	0	1	10	0	0
12	20608370	.	T	A	4	8	12	0	0	12	0	0
12	20608397	.	G	A	3	7	10	0	0	10	0	0
12	20608518	.	C	T	4	5	9	0	0	9	0	0
12	20651212	.	G	A	1	3	4	0	0	4	0	0
12	20651401	.	G	T	2	2	4	0	0	4	0	0
12	20651414	.	T	G	1	4	5	0	0	5	0	0
12	20651441	.	G	A	1	4	5	0	0	5	0	0
12	20651602	.	G	A	3	2	5	0	0	5	0	0
12	20651623	.	C	A	2	1	3	0	0	3	0	0
12	20652701	.	C	T	0	3	3	0	1	4	0	0
12	20652771	.	G	T	3	3	6	0	0	6	0	0
12	20653104	.	C	T	0	5	5	0	0	12	7	0
12	20653128	.	C	T	7	8	15	0	1	16	0	0
12	20653159	.	G	A	5	4	9	0	0	9	0	0
12	20653244	.	A	T	5	4	9	0	0	9	0	0
12	20653301	.	T	C	1	0	1	0	3	4	0	0
12	20658037	.	T	C	3	7	10	0	0	10	0	0
12	20676252	.	C	T	4	3	7	0	0	7	0	0
12	20676345	.	C	T	2	3	5	0	0	5	0	0
12	20677706	.	T	A	1	2	3	0	0	3	0	0
12	20677874	.	A	G	4	6	10	0	0	10	0	0
12	20777733	.	C	T	0	2	2	0	0	2	0	0
12	21539855	.	T	C	1	1	2	0	0	2	0	0
12	21549172	.	G	A	13	15	28	0	9	37	0	0
12	21687757	.	T	C	7	3	10	0	0	10	0	0
12	22237404	.	C	T	0	2	2	0	1	3	0	0
12	22310722	.	T	C	3	4	7	0	0	7	0	0
12	22311500	.	G	A	1	0	1	0	0	1	0	0
12	22410077	.	G	T	3	3	6	0	0	6	0	0
12	22412290	.	T	C	2	2	4	0	0	4	0	0
12	22412630	.	A	G	4	2	6	0	0	6	0	0
12	22415825	.	A	G	2	1	3	0	1	4	0	0
12	22415849	.	T	C	3	4	7	0	0	7	0	0
12	22415880	.	T	C	4	3	7	0	0	7	0	0
12	22418297	.	T	C	1	2	3	0	0	3	0	0
12	22420645	.	A	G	4	5	9	0	0	9	0	0
12	22420669	.	T	C	0	1	1	0	0	1	0	0
12	22431304	.	G	A	5	10	15	0	1	16	0	0
12	22433246	.	G	A	0	2	2	0	3	5	0	0
12	22435203	.	T	C	3	3	6	0	0	6	0	0
12	22437160	.	T	C	0	1	1	0	0	1	0	0
12	22444470	.	C	T	8	8	16	0	1	17	0	0
12	22444613	.	A	T	11	13	24	0	2	26	0	0
12	22451304	.	T	C	10	4	14	0	1	15	0	0
12	22451793	.	A	C	3	12	15	0	1	16	0	0
12	22451811	.	A	G	6	14	20	0	0	20	0	0
12	22456934	.	A	G	1	2	3	0	0	3	0	0
12	22460316	.	G	T	2	2	4	0	1	5	0	0
12	22462021	.	C	G	0	6	6	0	3	9	0	0
12	22467995	.	C	T	2	5	7	0	0	7	0	0
12	22468286	.	C	G	5	4	9	0	0	9	0	0
12	22480599	.	A	G	2	1	3	0	0	3	0	0
12	22480610	.	A	G	2	1	3	0	0	3	0	0
12	22480862	.	T	C	1	2	3	0	0	3	0	0
12	22480955	.	C	A	1	2	3	0	0	3	0	0
12	22487415	.	T	C	1	2	3	0	0	3	0	0
12	22528869	.	G	A	13	23	36	0	2	38	0	0
12	22529407	.	C	T	19	12	31	0	0	31	0	0
12	22529456	.	T	G	15	21	36	0	4	41	1	0
12	22529457	.	A	C	15	26	41	0	0	41	0	0
12	22529560	.	T	A	30	16	46	0	6	52	0	0
12	22529655	.	C	G	19	16	35	0	0	35	0	0
12	22530053	.	A	G	15	16	31	0	3	34	0	0
12	22530056	.	G	A	15	19	34	0	0	34	0	0
12	22530352	.	G	A	21	22	43	0	4	47	0	0
12	22530362	.	C	T	2	24	26	0	27	53	0	0
12	22530849	.	C	G	8	12	20	0	1	21	0	0
12	22531212	.	T	A	20	19	39	0	0	40	1	0
12	22531505	.	A	T	15	17	32	0	0	32	0	0
12	22531929	.	T	A	17	17	34	0	3	37	0	0
12	22532594	.	C	T	15	15	30	0	5	35	0	0
12	22532595	.	G	A	19	16	35	0	0	35	0	0
12	22533054	.	G	A	18	10	28	0	1	29	0	0
12	22533806	.	C	T	1	11	12	0	14	26	0	0
12	22533908	.	G	A	11	10	21	0	1	22	0	0
12	22534383	.	A	G	12	12	24	0	1	25	0	0
12	22534389	.	T	C	12	0	12	0	14	26	0	0
12	22535197	.	A	G	9	10	19	0	1	20	0	0
12	22535380	.	C	T	0	7	7	0	9	16	0	0
12	22535498	.	T	C	5	3	8	0	0	8	0	0
12	22535546	.	A	T	15	5	20	0	0	20	0	0
12	22535567	.	T	C	15	6	21	0	0	21	0	0
12	22535631	.	T	G	8	7	15	0	0	15	0	0
12	22536188	.	C	T	0	6	6	0	2	8	0	0
12	22536609	.	T	G	7	8	15	0	1	16	0	0
12	22536621	.	G	C	10	10	20	0	1	21	0	0
12	22536969	.	C	T	4	3	7	0	1	8	0	0
12	22563882	.	T	C	2	2	4	0	0	4	0	0
12	22565015	.	T	C	2	2	4	0	0	4	0	0
12	22566413	.	A	G	1	0	1	0	0	1	0	0
12	22566434	.	A	T	1	2	3	0	0	3	0	0
12	22570814	.	T	C	13	16	29	0	1	30	0	0
12	22571368	.	G	C	4	6	10	0	0	10	0	0
12	22571628	.	G	A	11	7	18	0	0	18	0	0
12	22572199	.	C	G	13	16	29	0	1	30	0	0
12	22572287	.	A	C	16	16	32	0	0	32	0	0
12	22572367	.	C	T	25	9	34	0	0	34	0	0
12	22572585	.	G	A	18	14	32	0	1	33	0	0
12	22572650	.	T	C	10	14	24	0	0	24	0	0
12	22572660	.	G	A	10	14	24	0	0	24	0	0
12	22572756	.	C	T	14	14	28	0	0	28	0	0
12	22572814	.	A	G	15	0	15	0	7	22	0	0
12	22572937	.	C	T	24	8	32	0	2	34	0	0
12	22573080	.	T	A	19	17	36	0	1	37	0	0
12	22573185	.	G	A	5	7	12	0	0	12	0	0
12	22573239	.	A	C	2	6	8	0	0	8	0	0
12	22628775	.	A	C	1	2	3	0	0	3	0	0
12	22628983	.	G	A	0	1	1	0	0	1	0	0
12	22634834	.	C	T	3	0	3	0	0	3	0	0
12	22640923	.	T	C	1	3	4	0	0	4	0	0
12	22643876	.	T	C	3	3	6	0	0	6	0	0
12	22644406	.	C	T	3	2	5	0	0	5	0	0
12	22644429	.	T	C	3	3	6	0	0	6	0	0
12	22644687	.	T	G	4	14	18	0	0	18	0	0
12	22644800	.	G	A	4	6	10	0	0	10	0	0
12	22645174	.	G	A	1	4	5	0	0	5	0	0
12	22648423	.	A	T	0	1	1	0	0	1	0	0
12	22652631	.	C	T	0	1	1	0	0	1	0	0
12	22670217	.	A	T	1	2	3	0	0	3	0	0
12	22774439	.	A	G	1	1	2	0	0	2	0	0
12	22800097	.	A	G	0	2	2	0	0	2	0	0
12	22803813	.	C	T	1	0	1	0	0	1	0	0
12	22814990	.	T	C	5	5	10	0	0	10	0	0
12	22815203	.	G	A	5	6	11	0	0	11	0	0
12	22815365	.	C	T	11	4	15	0	1	16	0	0
12	22815672	.	G	A	2	2	4	0	0	4	0	0
12	22815724	.	G	T	4	3	7	0	1	8	0	0
12	22815767	.	A	T	7	2	9	0	1	10	0	0
12	22932087	.	C	T	8	13	21	0	0	21	0	0
12	22932090	.	G	C	7	10	17	0	2	19	0	0
12	22932674	.	T	A	6	11	17	0	3	20	0	0
12	22932675	.	A	T	7	12	19	0	1	20	0	0
12	22932852	.	G	T	0	9	9	0	10	19	0	0
12	22932875	.	G	T	13	16	29	0	1	30	0	0
12	22962211	.	A	T	8	4	12	0	0	12	0	0
12	22962555	.	C	A	4	3	7	0	0	7	0	0
12	22962781	.	G	A	4	7	11	0	2	13	0	0
12	22962864	.	G	A	3	7	10	0	0	10	0	0
12	23001466	.	G	A	2	1	3	0	0	3	0	0
12	23009215	.	G	A	2	1	3	0	0	3	0	0
12	23027142	.	G	A	1	0	1	0	0	1	0	0
12	23385168	.	G	A	3	2	5	0	1	6	0	0
12	23389675	.	G	A	3	3	6	0	0	6	0	0
12	23400392	.	C	T	15	13	28	0	2	30	0	0
12	23411287	.	C	T	5	13	18	0	0	18	0	0
12	23415347	.	C	T	10	12	22	0	1	23	0	0
12	23415370	.	C	T	18	14	32	0	1	33	0	0
12	23415662	.	G	A	20	18	38	0	0	38	0	0
12	23415672	.	C	A	21	16	37	0	1	38	0	0
12	23415897	.	A	T	11	0	11	0	2	13	0	0
12	23429685	.	C	T	5	8	13	0	1	14	0	0
12	23430003	.	C	A	2	2	4	0	0	4	0	0
12	23430091	.	G	A	4	4	8	0	0	8	0	0
12	23430092	.	T	A	4	4	8	0	0	8	0	0
12	23674469	.	A	G	2	4	6	0	0	6	0	0
12	23787358	.	T	G	1	3	4	0	0	4	0	0
12	23789838	.	A	C	6	3	9	0	0	9	0	0
12	23790148	.	A	T	9	6	15	0	0	15	0	0
12	23793990	.	A	T	4	2	6	0	1	7	0	0
12	23794148	.	A	T	3	2	5	0	0	5	0	0
12	23794547	.	G	A	0	7	7	0	3	10	0	0
12	23795418	.	T	C	2	2	4	0	0	4	0	0
12	23925093	.	A	G	3	1	4	0	0	4	0	0
12	24023704	.	T	A	2	2	4	0	0	4	0	0
12	24041253	.	G	T	2	3	5	0	0	5	0	0
12	24041254	.	T	A	2	3	5	0	0	5	0	0
12	24041367	.	A	T	7	3	10	0	0	10	0	0
12	24041600	.	A	G	3	0	3	0	1	4	0	0
12	24043909	.	C	T	6	5	11	0	0	11	0	0
12	24043942	.	C	T	9	8	17	0	1	18	0	0
12	24051894	.	G	T	5	5	10	0	0	10	0	0
12	24051944	.	T	G	4	4	8	0	2	10	0	0
12	24052196	.	A	G	1	5	6	0	0	6	0	0
12	24052303	.	T	A	5	7	12	0	0	12	0	0
12	24052578	.	C	T	10	7	17	0	0	17	0	0
12	24052684	.	G	A	11	11	22	0	2	24	0	0
12	24056484	.	A	T	3	4	7	0	0	7	0	0
12	24056500	.	G	T	3	4	7	0	1	8	0	0
12	24056539	.	G	A	2	3	5	0	0	5	0	0
12	24057167	.	C	G	1	2	3	0	0	3	0	0
12	24057198	.	G	T	2	3	5	0	0	5	0	0
12	24057368	.	G	A	1	2	3	0	0	3	0	0
12	24060008	.	A	G	5	7	12	0	0	12	0	0
12	24061312	.	G	T	0	1	1	0	0	1	0	0
12	24067592	.	T	A	2	3	5	0	0	5	0	0
12	24067610	.	C	T	2	3	5	0	0	5	0	0
12	24342518	.	T	A	1	1	2	0	0	2	0	0
12	24342556	.	T	C	0	3	3	0	2	5	0	0
12	24345427	.	C	A	4	2	6	0	0	6	0	0
12	24345832	.	G	A	0	8	8	0	8	16	0	0
12	24447515	.	G	A	0	7	7	0	3	10	0	0
12	24465454	.	C	T	3	0	3	0	0	3	0	0
12	24465466	.	T	C	4	3	7	0	0	7	0	0
12	24465565	.	T	C	12	7	19	0	0	19	0	0
12	24465712	.	T	C	14	6	20	0	0	20	0	0
12	24465875	.	A	C	1	1	2	0	0	2	0	0
12	24484083	.	A	C	5	6	11	0	0	11	0	0
12	24484084	.	C	T	5	6	11	0	0	11	0	0
12	24484131	.	G	T	15	8	23	0	0	23	0	0
12	24484134	.	C	T	15	8	23	0	0	23	0	0
12	24484215	.	T	C	4	13	17	0	2	19	0	0
12	24562338	.	C	T	2	2	4	0	0	4	0	0
12	24562365	.	A	G	1	0	1	0	3	4	0	0
12	24562511	.	G	C	0	3	3	0	1	4	0	0
12	24562683	.	C	T	3	1	4	0	0	4	0	0
12	24562686	.	T	C	3	1	4	0	0	4	0	0
12	24562725	.	T	C	1	2	3	0	0	3	0	0
12	24562726	.	G	A	1	2	3	0	0	3	0	0
12	24606963	.	C	T	18	12	30	0	1	31	0	0
12	24607140	.	G	A	1	31	32	0	32	64	0	0
12	24607215	.	G	A	5	9	14	0	1	15	0	0
12	24635925	.	A	G	39	3	42	0	22	64	0	0
12	24636261	.	C	A	27	24	51	0	5	56	0	0
12	24636596	.	C	A	15	0	15	0	34	53	4	0
12	24636746	.	A	G	25	29	54	0	2	56	0	0
12	24636997	.	T	G	25	18	43	0	2	45	0	0
12	24637148	.	G	T	4	2	6	0	0	6	0	0
12	24796653	.	G	A	5	4	9	0	0	9	0	0
12	24796734	.	C	A	2	9	11	0	2	13	0	0
12	24797128	.	A	T	15	5	20	0	1	21	0	0
12	24797351	.	C	T	9	8	17	0	1	18	0	0
12	24797541	.	G	A	13	12	25	0	2	27	0	0
12	24797603	.	T	C	14	12	26	0	4	30	0	0
12	24797908	.	C	T	9	8	17	0	0	17	0	0
12	24797999	.	G	C	6	9	15	0	0	15	0	0
12	24798235	.	A	G	4	7	11	0	1	12	0	0
12	24798237	.	T	G	4	7	11	0	1	12	0	0
12	24798358	.	A	G	10	6	16	0	0	16	0	0
12	24811369	.	G	A	2	7	9	0	0	9	0	0
12	24811423	.	G	A	4	5	9	0	1	10	0	0
12	24811489	.	A	G	8	4	12	0	1	13	0	0
12	24811558	.	T	C	3	0	3	0	13	16	0	0
12	24832098	.	G	A	2	1	3	0	0	3	0	0
12	24841945	.	A	G	15	2	17	0	4	21	0	0
12	24842119	.	A	G	16	13	29	0	4	33	0	0
12	24842267	.	T	G	12	16	28	0	1	30	1	0
12	24842597	.	C	T	0	4	4	0	5	9	0	0
12	24843292	.	C	T	1	17	18	0	15	33	0	0
12	24848651	.	C	T	2	0	2	0	0	2	0	0
12	24848678	.	A	G	3	2	5	0	1	6	0	0
12	24848687	.	A	G	3	3	6	0	1	7	0	0
12	24848765	.	T	C	3	1	4	0	1	5	0	0
12	24910116	.	C	G	5	4	9	0	0	9	0	0
12	24910206	.	A	G	2	0	2	0	1	3	0	0
12	24910492	.	A	C	3	2	5	0	0	5	0	0
12	24910546	.	T	A	7	4	11	0	0	11	0	0
12	24913442	.	C	G	1	1	2	0	0	2	0	0
12	24913535	.	G	C	1	4	5	0	0	5	0	0
12	25094201	.	T	C	8	9	17	0	4	21	0	0
12	25094359	.	T	C	3	8	11	0	0	11	0	0
12	25094522	.	T	C	9	4	13	0	1	14	0	0
12	25768836	.	T	C	1	8	9	0	3	12	0	0
12	28072821	.	C	G	18	13	31	0	1	32	0	0
12	28949067	.	A	G	9	10	19	0	0	19	0	0
12	28949112	.	C	A	4	4	8	0	1	9	0	0
12	28950009	.	T	C	6	0	6	0	6	12	0	0
12	28950678	.	G	T	3	3	6	0	0	6	0	0
12	28952139	.	T	C	3	2	5	0	1	6	0	0
12	28960284	.	T	C	4	9	13	0	0	13	0	0
12	28960321	.	G	A	7	9	16	0	0	16	0	0
12	28960357	.	G	A	0	4	4	0	6	10	0	0
12	29063312	.	C	T	0	1	1	0	0	1	0	0
12	29063346	.	G	A	1	3	4	0	0	4	0	0
12	29084032	.	T	C	3	1	4	0	0	4	0	0
12	29102585	.	T	C	13	7	20	0	0	20	0	0
12	29103004	.	T	C	4	4	8	0	0	8	0	0
12	29103041	.	T	A	5	2	7	0	0	7	0	0
12	29105508	.	A	T	2	3	5	0	1	6	0	0
12	29105510	.	A	T	2	3	5	0	1	6	0	0
12	29207473	.	G	A	0	2	2	0	5	7	0	0
12	29207533	.	T	C	5	5	10	0	0	10	0	0
12	29207590	.	G	A	1	4	5	0	3	8	0	0
12	29207683	.	G	T	5	7	12	0	0	12	0	0
12	29208099	.	T	G	5	6	11	0	0	11	0	0
12	29210371	.	C	A	15	10	25	0	2	27	0	0
12	29210435	.	C	G	8	7	15	0	2	17	0	0
12	29210600	.	C	T	9	11	20	0	1	21	0	0
12	29210719	.	T	A	17	10	27	0	2	29	0	0
12	29210873	.	T	A	7	4	11	0	1	12	0	0
12	29210917	.	T	C	6	10	16	0	0	16	0	0
12	29211017	.	C	T	4	5	9	0	0	9	0	0
12	29211082	.	G	A	6	4	10	0	1	11	0	0
12	29211195	.	T	A	8	13	21	0	0	21	0	0
12	29211232	.	G	A	0	11	11	0	13	24	0	0
12	29211289	.	T	A	19	18	37	0	0	37	0	0
12	29211292	.	A	G	16	17	33	0	4	37	0	0
12	29223498	.	A	G	6	5	11	0	1	12	0	0
12	29223612	.	T	G	3	4	7	0	0	7	0	0
12	29223811	.	C	A	1	2	3	0	0	3	0	0
12	29223847	.	C	T	1	2	3	0	0	3	0	0
12	29223921	.	G	A	2	4	6	0	0	6	0	0
12	29223969	.	A	T	2	4	6	0	0	6	0	0
12	29224250	.	T	G	4	4	8	0	0	8	0	0
12	29224521	.	A	T	6	3	9	0	1	10	0	0
12	29226876	.	C	A	0	2	2	0	1	3	0	0
12	29227014	.	T	G	3	2	5	0	0	5	0	0
12	29227044	.	G	A	1	2	3	0	0	3	0	0
12	29258629	.	G	T	1	2	3	0	0	3	0	0
12	29262564	.	A	G	1	0	1	0	2	3	0	0
12	29266917	.	T	C	2	4	6	0	0	6	0	0
12	29269576	.	C	A	3	4	7	0	0	7	0	0
12	29269689	.	G	A	3	3	6	0	0	6	0	0
12	29269695	.	A	G	3	0	3	0	2	5	0	0
12	29269726	.	C	G	2	4	6	0	0	6	0	0
12	29269770	.	G	T	0	5	5	0	5	10	0	0
12	29269774	.	T	G	5	4	9	0	0	9	0	0
12	29269830	.	T	A	4	2	6	0	0	6	0	0
12	29350773	.	C	A	0	2	2	0	1	3	0	0
12	29351320	.	A	G	17	20	37	0	0	37	0	0
12	29351810	.	A	G	16	14	30	0	3	33	0	0
12	29358277	.	T	C	3	3	6	0	0	6	0	0
12	29358370	.	G	C	9	1	10	0	7	17	0	0
12	29358384	.	A	G	9	7	16	0	0	16	0	0
12	29358418	.	A	G	1	4	5	0	0	5	0	0
12	29624017	.	G	A	10	13	23	0	0	23	0	0
12	29624272	.	C	A	2	6	8	0	1	9	0	0
12	29624611	.	T	C	3	0	3	0	3	6	0	0
12	29811009	.	A	G	3	0	3	0	1	4	0	0
12	29843460	.	A	G	17	13	30	0	0	30	0	0
12	29844434	.	T	C	6	9	15	0	0	15	0	0
12	29873273	.	C	G	1	1	2	0	0	2	0	0
12	29921114	.	T	G	4	4	8	0	1	9	0	0
12	29947132	.	A	G	4	6	10	0	0	10	0	0
12	29947147	.	C	A	2	3	5	0	0	5	0	0
12	29957074	.	C	T	4	5	9	0	0	9	0	0
12	29957164	.	C	T	4	8	12	0	0	12	0	0
12	29965928	.	C	T	3	1	4	0	0	4	0	0
12	29965967	.	G	A	1	6	7	0	1	8	0	0
12	29966039	.	T	C	2	1	3	0	0	3	0	0
12	29966048	.	T	C	1	0	1	0	1	2	0	0
12	29968087	.	T	C	1	0	1	0	1	2	0	0
12	29973800	.	G	A	2	3	5	0	0	5	0	0
12	29976936	.	G	A	1	2	3	0	0	3	0	0
12	30036873	.	G	A	3	3	6	0	0	6	0	0
12	30192526	.	A	T	2	7	9	0	0	9	0	0
12	30200741	.	C	T	3	2	5	0	0	5	0	0
12	30207912	.	G	A	0	1	1	0	0	1	0	0
12	30208905	.	T	C	2	0	2	0	0	2	0	0
12	30216034	.	C	A	1	2	3	0	0	3	0	0
12	30216090	.	G	T	3	2	5	0	0	5	0	0
12	30216248	.	C	T	6	4	10	0	0	10	0	0
12	30216436	.	T	C	5	5	10	0	0	10	0	0
12	30216490	.	T	C	3	5	8	0	0	8	0	0
12	30216693	.	C	T	4	2	6	0	0	6	0	0
12	30216697	.	G	A	0	2	2	0	4	6	0	0
12	30217569	.	A	G	2	4	6	0	0	6	0	0
12	30217589	.	A	T	2	5	7	0	1	8	0	0
12	30217705	.	G	A	0	5	5	0	3	8	0	0
12	30217747	.	C	T	4	5	9	0	0	9	0	0
12	30217782	.	T	G	3	5	8	0	1	9	0	0
12	30217783	.	C	A	6	3	9	0	0	9	0	0
12	30217893	.	C	A	4	3	7	0	1	8	0	0
12	30217898	.	T	A	4	3	7	0	0	7	0	0
12	30217966	.	G	A	4	5	9	0	0	9	0	0
12	30217986	.	C	T	4	3	7	0	0	7	0	0
12	30218135	.	C	A	5	6	11	0	1	12	0	0
12	30218150	.	G	A	8	7	15	0	0	15	0	0
12	30218173	.	C	T	10	9	19	0	0	19	0	0
12	30219306	.	A	T	21	9	30	0	0	30	0	0
12	30219739	.	G	A	5	4	9	0	1	10	0	0
12	30219804	.	C	T	12	5	17	0	0	17	0	0
12	30299073	.	C	T	1	2	3	0	0	3	0	0
12	30303081	.	C	A	3	5	8	0	1	9	0	0
12	30305983	.	T	C	0	1	1	0	0	1	0	0
12	30307010	.	C	T	4	14	18	0	0	18	0	0
12	30307788	.	G	T	3	2	5	0	0	5	0	0
12	30307913	.	G	T	3	13	16	0	0	16	0	0
12	30382341	.	C	T	1	2	3	0	1	4	0	0
12	30382705	.	G	A	0	1	1	0	1	2	0	0
12	30383960	.	G	A	0	2	2	0	1	3	0	0
12	30385562	.	C	T	3	0	3	0	0	3	0	0
12	30391136	.	G	A	4	1	5	0	0	5	0	0
12	30418108	.	T	C	7	5	12	0	0	12	0	0
12	30418143	.	T	C	5	2	7	0	1	8	0	0
12	30418513	.	C	G	10	7	17	0	1	18	0	0
12	30419123	.	A	T	5	6	11	0	2	13	0	0
12	30419134	.	C	A	9	5	14	0	1	15	0	0
12	30419260	.	T	G	19	6	25	0	2	27	0	0
12	30419646	.	T	C	9	12	21	0	0	21	0	0
12	30419655	.	T	C	9	10	19	0	0	19	0	0
12	30419695	.	T	C	4	9	13	0	0	13	0	0
12	30419727	.	A	G	3	6	9	0	1	10	0	0
12	30442406	.	C	A	6	3	9	0	0	9	0	0
12	30442783	.	G	A	15	4	19	0	1	20	0	0
12	30443462	.	T	C	4	9	13	0	0	13	0	0
12	30458945	.	A	T	1	2	3	0	0	3	0	0
12	30459404	.	G	A	2	2	4	0	1	5	0	0
12	30459474	.	G	T	3	3	6	0	0	6	0	0
12	30460333	.	C	A	1	3	4	0	0	4	0	0
12	30461332	.	G	A	4	4	8	0	0	8	0	0
12	30461485	.	T	A	2	1	3	0	0	3	0	0
12	30467666	.	G	T	1	3	4	0	0	4	0	0
12	30504067	.	C	T	2	2	4	0	0	4	0	0
12	30504077	.	A	C	2	2	4	0	0	4	0	0
12	30508533	.	C	A	0	2	2	0	0	2	0	0
12	30706173	.	T	A	1	1	2	0	0	2	0	0
12	30706176	.	T	C	1	1	2	0	0	2	0	0
12	30741328	.	T	G	2	4	6	0	0	6	0	0
12	30793107	.	C	T	3	2	5	0	0	5	0	0
12	30796306	.	C	T	1	2	3	0	0	3	0	0
12	30796322	.	C	A	2	2	4	0	0	4	0	0
12	30796345	.	C	T	3	2	5	0	0	5	0	0
12	30798079	.	G	A	6	1	7	0	0	7	0	0
12	30798085	.	A	T	1	6	7	0	0	7	0	0
12	30800128	.	G	A	1	2	3	0	0	3	0	0
12	30803166	.	G	A	0	2	2	0	3	5	0	0
12	30803629	.	A	G	1	0	1	0	1	2	0	0
12	30805335	.	T	C	2	5	7	0	0	7	0	0
12	30805359	.	T	C	2	5	7	0	0	7	0	0
12	30805455	.	C	T	2	1	3	0	0	3	0	0
12	30806928	.	G	T	0	9	9	0	3	12	0	0
12	30807038	.	A	G	6	8	14	0	1	15	0	0
12	30807245	.	A	G	1	7	8	0	1	9	0	0
12	30807330	.	T	A	3	6	9	0	1	10	0	0
12	30807458	.	C	T	5	2	7	0	0	7	0	0
12	30807494	.	G	A	2	6	8	0	0	8	0	0
12	30807504	.	A	C	2	8	10	0	1	11	0	0
12	30807714	.	A	G	10	5	15	0	0	15	0	0
12	30807880	.	A	G	6	3	9	0	1	10	0	0
12	30808094	.	C	T	8	7	15	0	0	15	0	0
12	30808150	.	T	A	7	7	14	0	1	15	0	0
12	30808342	.	A	T	5	4	9	0	0	9	0	0
12	30808531	.	G	C	3	10	13	0	1	14	0	0
12	30808766	.	C	T	6	5	11	0	0	11	0	0
12	30808812	.	A	G	5	0	5	0	6	11	0	0
12	30808817	.	T	G	6	6	12	0	0	12	0	0
12	30979815	.	A	C	15	16	31	0	3	34	0	0
12	30980566	.	G	A	35	18	53	0	2	55	0	0
12	30980906	.	C	A	5	2	7	0	0	7	0	0
12	30981795	.	G	A	23	25	48	0	3	51	0	0
12	30986452	.	G	A	3	2	5	0	1	6	0	0
12	31012667	.	C	T	2	1	3	0	1	4	0	0
12	31102981	.	A	G	6	7	13	0	1	14	0	0
12	31435977	.	T	A	3	1	4	0	0	4	0	0
12	31438056	.	G	T	8	10	18	0	0	18	0	0
12	31438352	.	A	T	3	2	5	0	1	6	0	0
12	31438440	.	C	A	2	3	5	0	0	5	0	0
12	31479242	.	C	A	1	3	4	0	0	4	0	0
12	31479251	.	T	A	1	4	5	0	0	5	0	0
12	31523203	.	T	C	1	1	2	0	0	2	0	0
12	31531950	.	T	G	5	7	12	0	2	14	0	0
12	31532342	.	A	C	3	6	9	0	0	9	0	0
12	31532371	.	G	A	0	3	3	0	4	7	0	0
12	31532577	.	T	C	8	4	12	0	0	12	0	0
12	31532638	.	A	C	9	4	13	0	0	13	0	0
12	31532715	.	T	C	2	4	6	0	0	6	0	0
12	31532792	.	T	A	6	4	10	0	0	10	0	0
12	31532805	.	A	G	2	5	7	0	0	7	0	0
12	31533849	.	G	A	0	4	4	0	4	8	0	0
12	31533935	.	A	G	1	6	7	0	0	7	0	0
12	31629611	.	C	T	2	4	6	0	0	6	0	0
12	31630829	.	G	A	0	3	3	0	3	6	0	0
12	31631116	.	A	T	2	1	3	0	0	3	0	0
12	31631124	.	A	T	2	1	3	0	0	3	0	0
12	31664770	.	T	A	2	3	5	0	0	5	0	0
12	31704077	.	A	C	3	3	6	0	0	6	0	0
12	31708020	.	C	T	7	5	12	0	0	12	0	0
12	31708025	.	G	A	7	6	13	0	0	13	0	0
12	31708082	.	G	A	3	3	6	0	0	6	0	0
12	31708125	.	C	A	2	2	4	0	0	4	0	0
12	31709418	.	G	A	1	2	3	0	0	3	0	0
12	31709902	.	G	A	3	4	7	0	0	7	0	0
12	31709964	.	G	T	4	2	6	0	0	6	0	0
12	31720799	.	C	T	19	19	38	0	1	39	0	0
12	31721486	.	G	A	3	4	7	0	1	8	0	0
12	31722593	.	G	T	10	9	19	0	1	20	0	0
12	31722811	.	G	T	11	7	18	0	1	19	0	0
12	31722875	.	A	C	13	0	13	0	6	20	1	0
12	31724245	.	A	C	15	13	28	0	1	29	0	0
12	31724252	.	C	T	12	16	28	0	1	29	0	0
12	31729236	.	G	A	10	5	15	0	2	17	0	0
12	31729441	.	A	C	3	5	8	0	0	8	0	0
12	31729455	.	G	T	2	4	6	0	0	6	0	0
12	31740822	.	C	T	3	2	5	0	0	5	0	0
12	31746732	.	G	A	3	3	6	0	1	7	0	0
12	31753752	.	C	T	5	5	10	0	0	10	0	0
12	31753755	.	C	T	4	4	8	0	2	10	0	0
12	31764523	.	T	C	9	8	17	0	1	18	0	0
12	31764526	.	C	A	7	9	16	0	1	17	0	0
12	31765407	.	G	A	10	15	25	0	0	25	0	0
12	31765485	.	G	A	6	8	14	0	0	14	0	0
12	31765517	.	T	C	6	5	11	0	0	11	0	0
12	31765540	.	T	G	7	4	11	0	1	12	0	0
12	31785545	.	G	A	1	1	2	0	0	2	0	0
12	31787394	.	G	C	5	5	10	0	1	11	0	0
12	31787752	.	T	C	2	2	4	0	0	4	0	0
12	31787760	.	A	G	2	2	4	0	0	4	0	0
12	31789799	.	C	T	17	12	29	0	1	30	0	0
12	31794655	.	G	A	4	1	5	0	0	5	0	0
12	31911406	.	A	G	6	2	8	0	0	8	0	0
12	32039443	.	C	T	0	6	6	0	11	17	0	0
12	32039527	.	A	G	15	12	27	0	0	27	0	0
12	32039546	.	G	A	20	13	33	0	0	33	0	0
12	32039635	.	A	C	18	19	37	0	1	38	0	0
12	32039678	.	C	T	22	22	44	0	0	44	0	0
12	32039937	.	G	A	16	20	36	0	0	36	0	0
12	32039958	.	T	C	14	0	14	0	21	35	0	0
12	32040093	.	G	A	26	14	40	0	1	41	0	0
12	32045155	.	G	A	17	11	28	0	3	31	0	0
12	32045212	.	T	C	12	0	12	0	11	23	0	0
12	32066061	.	C	A	10	8	18	0	0	18	0	0
12	32068470	.	C	A	2	2	4	0	0	4	0	0
12	32068700	.	A	T	4	3	7	0	0	7	0	0
12	32125405	.	G	A	1	0	1	0	0	1	0	0
12	32159335	.	A	G	4	4	8	0	0	8	0	0
12	32159384	.	A	T	2	3	5	0	0	5	0	0
12	32160773	.	A	G	4	0	4	0	10	14	0	0
12	32160839	.	A	G	5	8	13	0	1	14	0	0
12	32160971	.	T	C	7	9	16	0	0	16	0	0
12	32161043	.	T	C	1	4	5	0	0	5	0	0
12	32162360	.	T	C	4	7	11	0	1	12	0	0
12	32162411	.	T	A	6	10	16	0	0	16	0	0
12	32188729	.	C	T	0	1	1	0	0	1	0	0
12	32360201	.	C	A	0	1	1	0	0	1	0	0
12	32369172	.	G	A	0	3	3	0	2	5	0	0
12	32373637	.	G	A	0	3	3	0	1	4	0	0
12	32373844	.	T	C	5	3	8	0	0	8	0	0
12	32374048	.	G	A	0	2	2	0	2	4	0	0
12	32976148	.	T	C	2	1	3	0	1	4	0	0
12	33151402	.	G	A	0	10	10	0	11	21	0	0
12	33151453	.	C	T	6	5	11	0	1	12	0	0
12	33245427	.	G	A	8	7	15	0	4	19	0	0
12	33245677	.	G	A	9	3	12	0	0	12	0	0
12	33245688	.	G	T	3	9	12	0	0	12	0	0
12	33246010	.	A	T	8	6	14	0	0	14	0	0
12	33247295	.	T	C	15	21	36	0	0	36	0	0
12	33247611	.	T	A	17	11	28	0	3	31	0	0
12	33248025	.	G	A	1	18	19	0	27	46	0	0
12	33248193	.	C	A	27	11	38	0	3	41	0	0
12	33248343	.	G	A	0	21	21	0	16	37	0	0
12	33299211	.	C	T	1	2	3	0	0	3	0	0
12	33320944	.	C	T	3	4	7	0	1	8	0	0
12	33329791	.	C	G	0	1	1	0	1	2	0	0
12	33331496	.	C	A	15	17	32	0	2	34	0	0
12	33331523	.	T	C	10	14	24	0	0	24	0	0
12	33331541	.	A	C	2	3	5	0	6	11	0	0
12	33331691	.	T	G	13	8	21	0	0	21	0	0
12	33331724	.	C	T	11	17	28	0	0	28	0	0
12	33335714	.	A	C	21	16	37	0	1	38	0	0
12	33335739	.	C	T	15	12	27	0	0	27	0	0
12	33335770	.	G	A	1	13	14	0	14	28	0	0
12	33335904	.	T	G	17	18	35	0	0	35	0	0
12	33335949	.	C	T	16	14	30	0	2	32	0	0
12	33336044	.	T	G	18	0	18	0	31	50	1	0
12	33336073	.	G	A	0	18	18	0	20	38	0	0
12	33336203	.	G	A	13	21	34	0	0	34	0	0
12	33336271	.	G	A	0	14	14	0	21	35	0	0
12	33351045	.	T	C	0	5	5	0	1	6	0	0
12	33351061	.	T	C	1	2	3	0	0	3	0	0
12	33351441	.	T	A	3	3	6	0	0	6	0	0
12	33352595	.	C	T	4	3	7	0	1	8	0	0
12	33352601	.	C	T	6	2	8	0	0	8	0	0
12	33354286	.	G	A	1	3	4	0	0	4	0	0
12	33359588	.	T	C	0	0	0	0	1	1	0	0
12	33384524	.	C	T	4	2	6	0	0	6	0	0
12	33384545	.	C	T	4	2	6	0	0	6	0	0
12	33420482	.	T	C	1	4	5	0	0	5	0	0
12	33422446	.	T	C	2	1	3	0	0	3	0	0
12	33428209	.	A	G	0	2	2	0	0	2	0	0
12	33428636	.	T	C	2	4	6	0	0	6	0	0
12	33431014	.	G	A	1	3	4	0	0	4	0	0
12	33434946	.	G	A	1	4	5	0	0	5	0	0
12	33434970	.	C	G	6	1	7	0	0	7	0	0
12	33435834	.	A	G	2	2	4	0	0	4	0	0
12	33435840	.	G	A	0	3	3	0	0	3	0	0
12	33437562	.	A	G	4	1	5	0	0	5	0	0
12	33437882	.	G	A	0	8	8	0	8	16	0	0
12	33438250	.	G	A	0	2	2	0	0	2	0	0
12	33439860	.	C	A	3	11	14	0	0	14	0	0
12	33440022	.	C	T	8	9	17	0	0	17	0	0
12	33440025	.	T	C	8	9	17	0	0	17	0	0
12	33440135	.	A	G	5	15	20	0	0	20	0	0
12	33440146	.	A	G	3	0	3	0	14	17	0	0
12	33440200	.	C	T	0	1	1	0	0	1	0	0
12	33442578	.	C	T	7	5	12	0	0	12	0	0
12	33442675	.	G	A	1	2	3	0	0	3	0	0
12	33442924	.	G	A	10	6	16	0	0	16	0	0
12	33444839	.	T	C	13	17	30	0	1	31	0	0
12	33448124	.	T	A	17	20	37	0	0	37	0	0
12	33448253	.	C	T	20	5	25	0	0	25	0	0
12	33448528	.	C	G	1	4	5	0	1	6	0	0
12	33449047	.	G	A	16	7	23	0	1	24	0	0
12	33449229	.	T	A	21	16	37	0	1	38	0	0
12	33449902	.	T	A	7	6	13	0	0	13	0	0
12	33449924	.	A	G	12	0	12	0	8	20	0	0
12	33450194	.	G	A	2	16	18	0	22	40	0	0
12	33450332	.	T	C	11	12	23	0	2	25	0	0
12	33450368	.	T	A	6	15	21	0	0	21	0	0
12	33450429	.	G	A	5	5	10	0	0	10	0	0
12	33450435	.	A	G	4	0	4	0	5	9	0	0
12	33453699	.	G	C	2	2	4	0	0	4	0	0
12	33453734	.	T	A	2	2	4	0	0	4	0	0
12	33456652	.	T	A	1	2	3	0	0	3	0	0
12	33460859	.	A	G	4	5	9	0	0	9	0	0
12	33467556	.	A	C	0	1	1	0	0	1	0	0
12	33469083	.	T	C	4	2	6	0	0	6	0	0
12	33472148	.	A	T	3	3	6	0	0	6	0	0
12	33473481	.	G	A	1	11	12	0	16	28	0	0
12	33473486	.	C	T	16	12	28	0	1	29	0	0
12	33473678	.	A	C	7	9	16	0	0	16	0	0
12	33473806	.	C	A	8	5	13	0	1	14	0	0
12	33473844	.	C	T	3	12	15	0	0	15	0	0
12	33473874	.	A	T	4	9	13	0	0	13	0	0
12	33536717	.	C	T	3	3	6	0	0	6	0	0
12	33536722	.	A	C	3	3	6	0	0	6	0	0
12	33536754	.	A	G	5	2	7	0	0	7	0	0
12	33536881	.	A	G	4	5	9	0	0	9	0	0
12	33553959	.	C	G	1	2	3	0	0	3	0	0
12	33561661	.	C	A	5	5	10	0	0	10	0	0
12	33561662	.	C	T	5	5	10	0	0	10	0	0
12	33568017	.	A	G	7	7	14	0	1	15	0	0
12	33570318	.	G	A	1	4	5	0	1	6	0	0
12	33572799	.	C	T	1	0	1	0	0	1	0	0
12	33574748	.	G	A	1	3	4	0	0	4	0	0
12	33574787	.	C	T	1	2	3	0	0	3	0	0
12	33579159	.	C	T	0	0	0	0	1	1	0	0
12	33602776	.	C	T	9	19	28	0	1	29	0	0
12	33603386	.	G	T	7	6	13	0	0	13	0	0
12	33603611	.	C	T	16	10	26	0	0	26	0	0
12	33604298	.	A	G	10	6	16	0	0	16	0	0
12	33604364	.	C	A	3	5	8	0	1	9	0	0
12	33604445	.	G	A	5	4	9	0	0	9	0	0
12	33605727	.	C	G	2	4	6	0	0	6	0	0
12	33605732	.	T	C	2	4	6	0	0	6	0	0
12	33605948	.	C	T	2	6	8	0	0	8	0	0
12	33606114	.	A	G	1	3	4	0	0	4	0	0
12	33606148	.	A	G	3	3	6	0	0	6	0	0
12	33606158	.	C	T	3	4	7	0	0	7	0	0
12	33609377	.	C	G	4	2	6	0	0	6	0	0
12	33618002	.	C	T	0	3	3	0	2	5	0	0
12	33629704	.	G	T	4	2	6	0	1	7	0	0
12	33629797	.	G	A	2	3	5	0	0	5	0	0
12	33738927	.	T	G	2	6	8	0	0	8	0	0
12	33738956	.	A	C	4	5	9	0	0	9	0	0
12	33744549	.	G	A	2	0	2	0	0	2	0	0
12	33748625	.	T	C	0	0	0	0	2	2	0	0
12	33748709	.	C	T	1	1	2	0	0	2	0	0
12	33754068	.	G	A	1	0	1	0	1	2	0	0
12	33763334	.	T	C	1	0	1	0	2	3	0	0
12	33788935	.	A	T	4	2	6	0	0	6	0	0
12	33806487	.	T	C	1	2	3	0	0	3	0	0
12	33806756	.	C	T	1	2	3	0	0	3	0	0
12	33806766	.	T	C	2	2	4	0	0	4	0	0
12	33806819	.	T	A	5	2	7	0	0	7	0	0
12	33807078	.	G	A	1	2	3	0	0	3	0	0
12	33807357	.	C	T	2	1	3	0	0	3	0	0
12	33813260	.	A	T	2	2	4	0	0	4	0	0
12	33813323	.	G	T	1	1	2	0	0	2	0	0
12	33817399	.	A	T	10	11	21	0	0	21	0	0
12	33818654	.	A	G	14	7	21	0	0	21	0	0
12	33818925	.	C	T	3	3	6	0	0	6	0	0
12	33818950	.	T	C	0	4	4	0	0	4	0	0
12	33818973	.	C	G	2	2	4	0	0	4	0	0
12	33832148	.	A	G	1	4	5	0	0	5	0	0
12	33832501	.	G	A	3	2	5	0	0	5	0	0
12	33832529	.	G	A	5	2	7	0	0	7	0	0
12	33832747	.	A	T	2	4	6	0	0	6	0	0
12	33832952	.	T	G	1	2	3	0	0	3	0	0
12	33912518	.	G	C	0	3	3	0	5	8	0	0
12	33912635	.	T	C	1	7	8	0	0	8	0	0
12	33912656	.	C	T	3	7	10	0	0	10	0	0
12	33912758	.	C	A	5	4	9	0	0	9	0	0
12	33912946	.	C	A	5	4	9	0	0	9	0	0
12	33912982	.	G	T	6	6	12	0	0	12	0	0
12	33913000	.	G	A	6	5	11	0	0	11	0	0
12	33913154	.	G	A	4	6	10	0	1	11	0	0
12	33913698	.	T	A	7	4	11	0	0	11	0	0
12	33913705	.	T	C	5	4	9	0	0	9	0	0
12	33913759	.	G	A	8	6	14	0	0	14	0	0
12	33913853	.	T	C	1	2	3	1	0	4	0	0
12	33913856	.	T	C	1	3	4	1	0	5	0	0
12	33913964	.	T	G	8	14	22	0	0	22	0	0
12	33914967	.	A	C	4	5	9	0	1	10	0	0
12	33914985	.	G	T	4	2	6	0	0	6	0	0
12	33919640	.	T	A	8	4	12	0	0	12	0	0
12	33919851	.	C	T	10	4	14	0	0	14	0	0
12	33919964	.	C	A	1	3	4	0	0	4	0	0
12	33920483	.	G	A	4	2	6	0	0	6	0	0
12	33920627	.	T	C	4	4	8	0	0	8	0	0
12	33920693	.	G	T	7	7	14	0	1	15	0	0
12	33920826	.	T	C	9	10	19	0	0	19	0	0
12	33933495	.	A	G	4	0	4	0	6	10	0	0
12	33933979	.	C	T	16	17	33	0	2	35	0	0
12	33934082	.	G	A	0	24	24	0	15	39	0	0
12	33934099	.	G	A	1	23	24	0	16	40	0	0
12	33934768	.	G	T	21	19	40	0	2	43	1	0
12	33935010	.	C	A	17	11	28	0	0	28	0	0
12	33935019	.	G	T	1	13	14	0	14	28	0	0
12	33966470	.	G	A	10	8	18	0	2	20	0	0
12	33966499	.	C	T	0	13	13	0	12	25	0	0
12	33966886	.	A	G	26	16	42	0	4	46	0	0
12	33967028	.	T	C	17	15	32	0	1	33	0	0
12	33967029	.	T	C	10	22	32	0	1	33	0	0
12	33967918	.	A	G	2	3	5	0	0	5	0	0
12	33967968	.	T	G	5	11	16	0	0	16	0	0
12	33968027	.	T	A	19	16	35	0	0	35	0	0
12	33968073	.	T	A	9	24	33	0	3	36	0	0
12	33968145	.	C	T	18	13	31	0	1	32	0	0
12	33968419	.	C	A	0	18	18	0	24	42	0	0
12	33971461	.	T	C	3	1	4	0	0	4	0	0
12	33972294	.	G	T	6	4	10	0	0	10	0	0
12	33975228	.	A	T	3	1	4	0	0	4	0	0
12	33988077	.	G	T	2	7	9	0	0	9	0	0
12	33988094	.	T	A	6	3	9	0	0	9	0	0
12	33988140	.	T	G	1	2	3	0	0	3	0	0
12	33988374	.	T	C	4	5	9	0	0	9	0	0
12	33988623	.	G	C	11	4	15	0	0	15	0	0
12	33991622	.	T	C	19	19	38	1	3	42	0	0
12	33992208	.	A	C	13	9	22	0	7	29	0	0
12	33992376	.	A	G	14	16	30	0	2	32	0	0
12	33992418	.	G	T	17	30	47	0	1	48	0	0
12	33992813	.	C	A	15	26	41	0	2	43	0	0
12	33993008	.	T	A	20	17	37	0	0	37	0	0
12	33997285	.	C	T	7	8	15	0	1	16	0	0
12	33997303	.	T	A	5	4	9	0	0	10	1	0
12	34179962	.	C	T	3	2	5	0	1	6	0	0
12	34180771	.	C	T	2	2	4	0	0	4	0	0
12	34187335	.	C	T	3	6	9	0	0	9	0	0
12	34187341	.	G	T	0	8	8	0	3	11	0	0
12	34192762	.	C	T	4	7	11	0	2	13	0	0
12	34192816	.	T	G	1	1	2	0	8	10	0	0
12	34219622	.	G	A	4	4	8	0	0	8	0	0
12	34276004	.	T	C	1	2	3	0	0	3	0	0
12	34276956	.	G	A	0	3	3	0	1	4	0	0
12	34435143	.	T	A	1	1	2	0	0	2	0	0
12	34563459	.	G	T	7	3	10	0	0	11	1	0
12	34563469	.	T	C	10	3	13	0	0	13	0	0
12	34564123	.	A	G	2	10	12	0	0	12	0	0
12	34564322	.	T	G	6	5	11	0	0	11	0	0
12	34564343	.	C	T	7	6	13	0	0	13	0	0
12	34564416	.	A	G	5	3	8	0	0	8	0	0
12	34564904	.	A	T	4	6	10	0	1	12	1	0
12	34565200	.	A	C	4	2	6	0	0	6	0	0
12	34565223	.	T	C	2	2	4	0	1	5	0	0
12	34565441	.	A	G	5	5	10	0	0	10	0	0
12	34565504	.	A	G	1	0	1	0	0	1	0	0
12	34566022	.	C	T	3	5	8	0	1	9	0	0
12	34568320	.	A	C	1	1	2	0	0	2	0	0
12	34568321	.	C	A	1	1	2	0	0	2	0	0
12	34568383	.	T	C	1	3	4	0	0	4	0	0
12	34574380	.	T	C	2	4	6	0	0	6	0	0
12	34574416	.	T	A	2	5	7	0	0	7	0	0
12	34580552	.	A	G	3	2	5	0	1	6	0	0
12	34581049	.	C	T	3	2	5	0	0	5	0	0
12	34581051	.	C	T	3	2	5	0	0	5	0	0
12	34597779	.	C	T	0	3	3	0	2	5	0	0
12	34732841	.	C	A	3	3	6	0	0	6	0	0
12	34732862	.	A	T	4	2	6	0	0	6	0	0
12	34810681	.	G	A	0	3	3	0	1	4	0	0
12	34810833	.	A	G	1	1	2	0	0	2	0	0
12	34820046	.	A	G	0	2	2	0	0	2	0	0
12	34820065	.	C	T	0	2	2	0	0	2	0	0
12	34820521	.	G	C	3	3	6	0	0	6	0	0
12	34820760	.	C	T	3	3	6	0	0	6	0	0
12	34821135	.	T	C	1	3	4	0	0	4	0	0
12	34821394	.	G	T	3	3	6	0	0	6	0	0
12	34821513	.	G	T	2	2	4	0	0	4	0	0
12	34821557	.	T	C	4	2	6	0	0	6	0	0
12	34821785	.	G	T	1	4	5	0	1	6	0	0
12	34821996	.	A	C	3	4	7	0	0	7	0	0
12	34825187	.	T	C	1	1	2	0	0	2	0	0
12	34837395	.	G	A	0	2	2	0	2	4	0	0
12	34841852	.	C	T	2	6	8	0	0	8	0	0
12	34841897	.	C	G	1	6	7	0	0	7	0	0
12	34841996	.	A	G	1	0	1	0	3	4	0	0
12	34845615	.	C	A	6	4	10	0	0	10	0	0
12	34845669	.	T	G	8	7	15	0	0	15	0	0
12	34845942	.	A	G	6	3	9	0	0	9	0	0
12	34846091	.	G	A	2	7	9	0	1	10	0	0
12	34847077	.	T	G	5	3	8	0	1	9	0	0
12	34847091	.	T	A	4	4	8	0	0	8	0	0
12	34847211	.	G	A	2	3	5	0	1	6	0	0
12	34847234	.	A	T	4	2	6	0	2	8	0	0
12	34847247	.	T	C	3	3	6	0	0	6	0	0
12	34847977	.	A	G	10	7	17	0	0	17	0	0
12	34869453	.	G	C	1	1	2	0	0	2	0	0
12	34876420	.	G	A	5	4	9	0	0	9	0	0
12	34876827	.	A	G	1	5	6	0	0	6	0	0
12	34876837	.	G	A	6	2	8	0	0	8	0	0
12	34877064	.	G	A	6	3	9	0	1	10	0	0
12	34883556	.	A	C	6	4	10	0	1	11	0	0
12	34883557	.	G	A	6	5	11	0	0	11	0	0
12	34884018	.	T	C	2	5	7	0	0	7	0	0
12	34884062	.	T	A	2	3	5	0	1	6	0	0
12	34884577	.	A	G	6	2	8	0	0	8	0	0
12	34891681	.	C	T	8	9	17	0	0	17	0	0
12	34891780	.	G	A	0	12	12	0	7	19	0	0
12	34892087	.	C	A	7	5	12	0	2	14	0	0
12	34892089	.	C	T	8	6	14	0	0	14	0	0
12	34892590	.	T	A	4	7	11	0	1	13	1	0
12	35008681	.	A	G	4	4	8	0	0	8	0	0
12	35012040	.	C	T	12	5	17	0	3	20	0	0
12	35012127	.	T	C	2	3	5	0	1	6	0	0
12	35018127	.	C	T	23	15	38	0	3	41	0	0
12	35046821	.	A	G	16	11	27	0	0	27	0	0
12	35046875	.	C	T	10	11	21	0	0	21	0	0
12	35046900	.	G	A	10	10	20	0	3	23	0	0
12	35046928	.	T	C	7	10	17	0	0	17	0	0
12	35046956	.	T	G	10	12	22	0	0	22	0	0
12	35046965	.	G	T	9	13	22	0	1	23	0	0
12	35047014	.	A	G	5	9	14	0	4	18	0	0
12	35051250	.	A	G	15	10	25	0	0	25	0	0
12	35099805	.	G	A	5	3	8	0	0	8	0	0
12	35103405	.	A	G	2	2	4	0	1	5	0	0
12	35103606	.	T	C	5	0	5	0	5	10	0	0
12	35103665	.	C	T	2	2	4	0	0	4	0	0
12	35103710	.	G	C	1	0	1	0	0	1	0	0
12	35105596	.	G	C	1	1	2	0	0	2	0	0
12	35146537	.	G	A	0	3	3	0	1	4	0	0
12	35149868	.	G	A	2	1	3	0	0	3	0	0
12	35167333	.	A	G	1	0	1	0	0	1	0	0
12	35178914	.	G	A	4	6	10	0	0	10	0	0
12	35189264	.	G	T	3	4	7	0	2	10	1	0
12	35189295	.	C	T	6	8	14	0	1	15	0	0
12	35189306	.	A	G	7	6	13	0	1	14	0	0
12	35189402	.	A	G	10	0	10	0	7	17	0	0
12	35189471	.	T	A	1	1	2	0	0	2	0	0
12	35191080	.	A	T	7	9	16	0	1	17	0	0
12	35191856	.	C	T	6	11	17	0	0	17	0	0
12	35203251	.	G	T	0	1	1	0	1	2	0	0
12	35317147	.	G	A	2	3	5	0	0	5	0	0
12	35317222	.	A	G	4	3	7	0	0	7	0	0
12	35317294	.	A	G	1	0	1	0	2	3	0	0
12	35317520	.	C	A	3	4	7	0	1	8	0	0
12	35317609	.	C	T	4	2	6	0	0	6	0	0
12	35325591	.	G	T	3	1	4	0	0	4	0	0
12	35325618	.	C	A	3	1	4	0	0	4	0	0
12	35328139	.	C	T	1	3	4	0	0	4	0	0
12	35332283	.	T	A	3	3	6	0	0	6	0	0
12	35334652	.	C	G	2	4	6	0	0	6	0	0
12	35339212	.	A	G	5	5	10	0	0	10	0	0
12	35339263	.	A	T	5	8	13	0	0	13	0	0
12	35339395	.	C	T	5	3	8	0	0	8	0	0
12	35346498	.	G	A	5	28	33	0	2	35	0	0
12	35346597	.	A	T	25	33	58	0	1	59	0	0
12	35346842	.	T	C	15	22	37	0	2	39	0	0
12	35346873	.	C	T	20	28	48	0	2	50	0	0
12	35347002	.	A	T	24	22	46	0	1	47	0	0
12	35347078	.	G	A	33	22	55	0	2	57	0	0
12	35347084	.	C	T	2	29	31	0	25	56	0	0
12	35347318	.	C	T	32	20	52	0	5	57	0	0
12	35347485	.	T	G	22	27	49	0	4	53	0	0
12	35347795	.	C	T	1	12	13	0	11	24	0	0
12	35347951	.	A	G	13	31	44	0	2	46	0	0
12	35350686	.	G	A	15	26	41	0	1	42	0	0
12	35351392	.	G	T	1	1	2	0	0	2	0	0
12	35386919	.	A	G	9	3	12	0	2	14	0	0
12	35543971	.	T	G	9	15	24	0	0	24	0	0
12	35544320	.	T	G	5	11	16	0	0	16	0	0
12	35544460	.	A	G	5	9	14	0	0	14	0	0
12	35544596	.	C	A	11	6	17	0	0	17	0	0
12	35544968	.	A	G	11	20	31	0	1	32	0	0
12	35551120	.	G	A	0	3	3	0	0	3	0	0
12	35556821	.	G	C	1	3	4	0	0	4	0	0
12	35568231	.	G	A	1	7	8	0	0	8	0	0
12	35568249	.	C	T	0	4	4	0	6	10	0	0
12	35568270	.	T	A	4	4	8	0	0	8	0	0
12	35568303	.	C	G	6	2	8	0	1	9	0	0
12	35568691	.	A	G	1	0	1	0	1	2	0	0
12	35593188	.	C	T	22	18	40	0	3	43	0	0
12	35593469	.	T	A	5	8	13	0	0	13	0	0
12	35593729	.	A	G	9	0	9	0	11	20	0	0
12	35594069	.	T	A	19	17	36	0	1	37	0	0
12	35594154	.	C	T	13	13	26	0	1	27	0	0
12	35594169	.	C	T	15	12	27	0	2	29	0	0
12	35594436	.	C	T	19	10	29	0	0	29	0	0
12	35594474	.	A	G	15	15	30	0	1	31	0	0
12	35594495	.	G	A	0	16	16	0	14	30	0	0
12	35594512	.	T	C	14	15	29	0	0	29	0	0
12	35594541	.	C	A	15	11	26	0	0	26	0	0
12	35594605	.	C	T	13	20	33	0	1	34	0	0
12	35594623	.	T	A	14	14	28	0	2	30	0	0
12	35674952	.	G	A	4	11	15	0	3	18	0	0
12	35689209	.	C	T	3	3	6	0	0	6	0	0
12	35689210	.	A	G	3	3	6	0	0	6	0	0
12	35704426	.	G	T	19	21	40	0	3	43	0	0
12	35704435	.	G	T	17	26	43	0	1	44	0	0
12	35704735	.	A	G	2	3	5	0	0	5	0	0
12	35704852	.	G	A	1	0	1	0	0	1	0	0
12	35704921	.	A	C	17	15	32	0	1	33	0	0
12	35704996	.	T	G	23	8	31	0	2	33	0	0
12	35705131	.	C	T	15	20	35	0	3	38	0	0
12	35705140	.	A	C	15	0	15	0	20	35	0	0
12	35705224	.	A	G	13	19	32	0	0	32	0	0
12	35705252	.	T	G	13	22	35	0	0	35	0	0
12	35705323	.	G	A	10	19	29	0	2	31	0	0
12	35705367	.	C	T	1	17	18	0	14	32	0	0
12	35705565	.	C	T	0	12	12	0	9	21	0	0
12	35705606	.	A	T	6	10	16	0	0	16	0	0
12	35705661	.	T	C	9	11	20	0	0	20	0	0
12	35705926	.	C	T	14	20	34	0	0	34	0	0
12	35706091	.	C	T	10	13	23	0	0	23	0	0
12	35706124	.	A	G	10	9	19	0	0	19	0	0
12	35706253	.	A	T	9	13	22	0	1	23	0	0
12	35706304	.	A	G	4	14	18	0	0	18	0	0
12	35706524	.	G	A	14	14	28	0	1	29	0	0
12	35706568	.	C	T	7	19	26	0	2	28	0	0
12	35706859	.	C	T	0	9	9	0	9	18	0	0
12	35706970	.	G	T	10	8	18	0	0	18	0	0
12	35707155	.	C	T	3	12	15	0	0	15	0	0
12	35707171	.	T	C	4	12	16	0	0	16	0	0
12	35707225	.	G	A	4	7	11	0	2	13	0	0
12	35707636	.	G	A	2	4	6	0	1	7	0	0
12	35707660	.	A	C	3	3	6	0	1	7	0	0
12	35707747	.	A	G	4	5	9	0	0	9	0	0
12	35707963	.	T	C	3	0	3	0	11	14	0	0
12	35707987	.	G	A	5	7	12	0	1	13	0	0
12	35708139	.	T	G	4	10	14	0	0	14	0	0
12	35708235	.	A	G	7	8	15	0	0	15	0	0
12	35708272	.	C	T	0	4	4	0	0	4	0	0
12	35708950	.	G	A	2	8	10	0	1	11	0	0
12	35709007	.	G	A	2	3	5	0	0	5	0	0
12	35709028	.	A	G	1	0	1	0	0	1	0	0
12	35710837	.	T	C	2	2	4	0	0	4	0	0
12	35715339	.	A	G	2	1	3	0	0	3	0	0
12	35813784	.	C	T	0	2	2	0	1	3	0	0
12	35837354	.	C	T	0	4	4	0	5	9	0	0
12	35837425	.	T	A	3	7	10	0	1	11	0	0
12	35837468	.	C	A	6	7	13	0	0	13	0	0
12	35837499	.	G	C	8	4	12	0	0	12	0	0
12	35837503	.	T	G	8	3	11	0	1	12	0	0
12	35837629	.	T	A	5	3	8	0	0	8	0	0
12	35837751	.	G	A	4	5	9	0	0	9	0	0
12	35837828	.	T	A	8	2	10	0	0	10	0	0
12	35837842	.	G	A	8	3	11	0	0	11	0	0
12	35838102	.	A	G	0	2	2	0	0	2	0	0
12	35838683	.	A	G	5	4	9	0	1	10	0	0
12	35839063	.	A	T	3	2	5	0	2	7	0	0
12	35839090	.	C	T	0	3	3	0	4	7	0	0
12	35839159	.	C	T	4	3	7	0	0	7	0	0
12	35839165	.	C	G	5	2	7	0	0	7	0	0
12	35839261	.	C	A	5	8	13	0	1	14	0	0
12	35839680	.	G	A	5	6	11	0	1	12	0	0
12	35839879	.	C	A	0	5	5	0	5	10	0	0
12	35839919	.	C	G	0	0	0	0	6	6	0	0
12	35839942	.	C	T	7	2	9	0	0	9	0	0
12	35840003	.	T	C	3	0	3	0	5	8	0	0
12	35840008	.	C	A	2	5	7	0	0	7	0	0
12	35840543	.	A	C	3	4	7	0	0	7	0	0
12	35840717	.	A	G	4	3	7	0	0	7	0	0
12	35841438	.	G	A	4	2	6	0	0	6	0	0
12	35841457	.	G	A	5	3	8	0	0	8	0	0
12	35847493	.	A	T	1	3	4	0	0	4	0	0
12	35847535	.	T	C	2	3	5	0	1	6	0	0
12	35847538	.	C	T	2	4	6	0	0	6	0	0
12	35868203	.	A	G	1	2	3	0	0	3	0	0
12	35870659	.	C	G	1	2	3	0	0	3	0	0
12	35883704	.	T	C	1	1	2	0	1	3	0	0
12	35963575	.	T	C	7	9	16	0	0	16	0	0
12	35967239	.	T	C	0	1	1	0	0	1	0	0
12	35976771	.	C	A	1	1	2	0	0	2	0	0
12	35980632	.	T	C	16	10	26	0	0	26	0	0
12	35980758	.	C	T	22	9	31	0	1	32	0	0
12	35980764	.	T	C	18	10	28	0	4	32	0	0
12	35980817	.	T	A	14	3	17	0	1	18	0	0
12	35981206	.	T	C	13	0	13	0	17	30	0	0
12	35981260	.	T	A	15	11	26	0	2	28	0	0
12	35981303	.	T	G	5	7	12	0	0	12	0	0
12	35981304	.	G	C	5	7	12	0	0	12	0	0
12	35981478	.	A	G	9	9	18	0	0	18	0	0
12	35981627	.	C	T	7	7	14	0	0	14	0	0
12	35981713	.	C	T	0	8	8	0	3	11	0	0
12	35981795	.	T	A	9	9	18	0	0	18	0	0
12	35981832	.	A	G	11	11	22	0	1	23	0	0
12	35988544	.	A	G	1	3	4	0	0	4	0	0
12	35988553	.	G	A	1	4	5	0	0	5	0	0
12	36103336	.	C	T	3	2	5	0	0	5	0	0
12	36103337	.	C	T	3	2	5	0	0	5	0	0
12	36103688	.	C	T	1	2	3	0	0	3	0	0
12	36105341	.	A	G	4	3	7	0	0	7	0	0
12	36105410	.	G	T	3	2	5	0	0	5	0	0
12	36135764	.	C	T	1	0	1	0	0	1	0	0
12	36158056	.	A	C	7	10	17	0	0	17	0	0
12	36158098	.	G	C	16	14	30	0	0	30	0	0
12	36158099	.	T	C	16	13	29	0	1	30	0	0
12	36158225	.	T	C	17	19	36	0	0	36	0	0
12	36158349	.	G	A	0	18	18	0	9	27	0	0
12	36158538	.	C	T	7	6	13	0	1	14	0	0
12	36159597	.	C	G	10	7	17	0	1	18	0	0
12	36413937	.	A	T	1	1	2	0	0	2	0	0
12	36416669	.	T	C	3	0	3	0	0	3	0	0
12	36416675	.	T	C	3	0	3	0	0	3	0	0
12	36416714	.	G	A	0	2	2	0	0	2	0	0
12	36416732	.	G	C	0	1	1	0	0	1	0	0
12	36422537	.	A	G	2	3	5	0	0	5	0	0
12	36422555	.	G	A	3	2	5	0	0	5	0	0
12	36424613	.	G	A	11	5	16	0	0	16	0	0
12	36424618	.	G	A	5	11	16	0	0	16	0	0
12	36468999	.	G	T	2	4	6	0	0	6	0	0
12	36469011	.	T	A	1	2	3	0	1	4	0	0
12	36471122	.	A	T	2	2	4	0	0	4	0	0
12	36670336	.	A	C	3	2	5	0	0	5	0	0
12	36739638	.	A	G	2	2	4	0	0	4	0	0
12	36895067	.	G	A	1	4	5	0	0	5	0	0
12	36952648	.	T	G	1	0	1	0	0	1	0	0
12	36952744	.	C	T	4	6	10	0	0	10	0	0
12	36960197	.	T	C	5	3	8	0	0	8	0	0
12	36960200	.	A	T	5	3	8	0	0	8	0	0
12	37003216	.	C	A	2	3	5	0	0	5	0	0
12	37003332	.	A	G	3	2	5	0	0	5	0	0
12	37003372	.	T	G	1	0	1	0	2	3	0	0
12	37003374	.	A	G	1	2	3	0	0	3	0	0
12	37003460	.	T	C	2	2	4	0	0	4	0	0
12	37003576	.	A	G	1	0	1	0	2	3	0	0
12	37005350	.	T	C	4	3	7	0	0	7	0	0
12	37005586	.	A	G	6	1	7	0	2	9	0	0
12	37275601	.	C	T	4	2	6	0	0	6	0	0
12	37275712	.	A	T	3	3	6	0	1	7	0	0
12	37275719	.	G	T	4	6	10	0	0	10	0	0
12	37275898	.	T	C	3	6	9	0	0	9	0	0
12	37409037	.	C	T	1	2	3	0	1	4	0	0
12	37410816	.	A	G	1	7	8	0	0	8	0	0
12	38556562	.	G	T	1	4	5	0	0	5	0	0
12	38561258	.	C	A	0	2	2	0	0	2	0	0
12	38802875	.	T	C	7	4	11	0	0	11	0	0
12	38803411	.	A	G	6	0	6	0	7	13	0	0
12	38804005	.	G	T	3	10	13	0	0	13	0	0
12	38804027	.	A	G	3	9	12	0	1	13	0	0
12	38804185	.	T	C	1	2	3	0	0	3	0	0
12	38804214	.	G	A	1	2	3	0	0	3	0	0
12	40478325	.	A	C	6	4	10	0	0	10	0	0
12	40502531	.	G	A	4	5	9	0	0	9	0	0
12	40502547	.	C	T	4	7	11	0	0	11	0	0
12	40502610	.	G	A	1	2	3	0	3	6	0	0
12	40518088	.	C	T	9	9	18	0	1	19	0	0
12	40518094	.	T	C	9	8	17	0	0	17	0	0
12	41437046	.	G	A	1	2	3	0	0	3	0	0
12	41455861	.	T	C	1	1	2	0	0	2	0	0
12	41461030	.	C	T	1	1	2	0	0	2	0	0
12	41461051	.	C	T	2	4	6	0	0	6	0	0
12	41467003	.	C	T	9	10	19	0	1	20	0	0
12	41467207	.	C	A	8	6	14	0	2	16	0	0
12	41525833	.	C	T	1	1	2	0	0	2	0	0
12	41528206	.	C	T	0	1	1	0	0	1	0	0
12	41528230	.	A	T	1	2	3	0	0	3	0	0
12	41535830	.	G	A	0	4	4	0	2	6	0	0
12	41535844	.	C	T	3	5	8	0	0	8	0	0
12	41535886	.	A	C	6	5	11	0	1	12	0	0
12	41535898	.	C	T	5	7	12	0	0	12	0	0
12	41535937	.	T	A	5	2	7	0	0	7	0	0
12	41539059	.	G	A	5	1	6	0	0	6	0	0
12	41539161	.	C	T	3	2	5	0	0	5	0	0
12	41539464	.	G	A	9	4	13	0	0	13	0	0
12	41549214	.	G	A	0	4	4	0	3	7	0	0
12	41549386	.	G	A	0	4	4	0	0	4	0	0
12	41549404	.	C	G	6	2	8	0	0	8	0	0
12	41549434	.	C	G	7	11	18	0	0	18	0	0
12	41549443	.	A	G	7	1	8	0	12	20	0	0
12	41580940	.	G	T	5	6	11	0	0	11	0	0
12	41581092	.	A	G	10	7	17	0	1	18	0	0
12	41584666	.	G	A	4	10	14	0	1	15	0	0
12	41584755	.	C	T	4	7	11	0	1	12	0	0
12	41589789	.	T	G	6	14	20	0	1	21	0	0
12	41593093	.	T	A	5	5	10	0	2	12	0	0
12	41606683	.	T	C	2	0	2	0	6	8	0	0
12	41606686	.	G	T	2	6	8	0	0	8	0	0
12	41618820	.	G	A	2	4	6	0	0	6	0	0
12	41618846	.	A	C	2	0	2	0	3	5	0	0
12	41631703	.	A	T	7	5	12	0	1	13	0	0
12	41631964	.	C	G	16	9	25	0	0	25	0	0
12	41632117	.	A	G	5	8	13	0	0	13	0	0
12	41643214	.	C	T	0	10	10	0	0	10	0	0
12	41643217	.	G	A	0	10	10	0	0	10	0	0
12	41647273	.	T	C	3	0	3	0	0	3	0	0
12	41653155	.	C	T	7	4	11	0	1	12	0	0
12	41653678	.	A	G	7	8	15	0	0	15	0	0
12	41656554	.	G	A	5	4	9	0	0	9	0	0
12	41698040	.	A	T	12	9	21	0	12	33	0	0
12	41698070	.	T	A	10	16	26	0	2	28	0	0
12	41702044	.	A	C	5	1	6	0	0	6	0	0
12	41723165	.	A	T	4	5	9	0	1	11	1	0
12	41723482	.	G	A	7	9	16	0	0	16	0	0
12	41723608	.	T	A	10	7	17	0	1	18	0	0
12	41732013	.	C	T	0	5	5	0	1	6	0	0
12	41735790	.	T	C	3	1	4	0	1	5	0	0
12	41739297	.	G	T	4	1	5	0	0	5	0	0
12	42369668	.	G	T	6	9	15	0	1	16	0	0
12	42378970	.	T	C	8	2	10	0	0	10	0	0
12	42396909	.	T	C	3	0	3	0	2	5	0	0
12	42406178	.	C	T	3	5	8	0	0	8	0	0
12	42406210	.	T	C	5	1	6	0	1	7	0	0
12	42406237	.	G	A	0	4	4	0	1	5	0	0
12	42406922	.	C	T	2	2	4	0	0	4	0	0
12	42577252	.	G	T	19	12	31	0	2	38	5	0
12	42577492	.	T	G	12	17	29	0	1	30	0	0
12	42578024	.	G	A	0	11	11	0	14	25	0	0
12	42578127	.	T	A	15	12	27	0	0	27	0	0
12	42578505	.	A	T	31	15	46	0	2	48	0	0
12	42578698	.	A	G	7	1	8	0	13	21	0	0
12	42578996	.	T	A	18	11	29	0	1	30	0	0
12	46608946	.	C	G	2	2	4	0	0	4	0	0
12	46620220	.	T	C	3	4	7	0	1	8	0	0
12	46629155	.	A	T	2	2	4	0	0	4	0	0
12	46629215	.	A	T	2	3	5	0	0	5	0	0
12	46630805	.	C	T	4	6	10	0	1	11	0	0
12	46630927	.	G	T	10	11	21	0	1	22	0	0
12	46630946	.	C	A	12	10	22	0	1	23	0	0
12	46631267	.	G	T	1	7	8	0	0	8	0	0
12	46688078	.	C	T	1	1	2	0	0	2	0	0
12	46688224	.	T	C	1	1	2	0	0	2	0	0
12	46688269	.	T	C	4	2	6	0	0	6	0	0
12	46688281	.	T	C	4	2	6	0	0	6	0	0
12	46693211	.	C	T	8	4	12	0	0	12	0	0
12	46699624	.	C	T	5	2	7	0	0	7	0	0
12	46737278	.	T	C	1	4	5	0	0	5	0	0
12	46738259	.	A	T	17	0	17	0	6	23	0	0
12	46738288	.	C	A	6	8	14	0	2	16	0	0
12	46738325	.	T	G	8	0	8	0	8	16	0	0
12	46738363	.	G	A	4	3	7	0	2	9	0	0
12	46738376	.	G	A	4	2	6	0	1	7	0	0
12	46837904	.	T	G	1	4	5	0	1	6	0	0
12	46852988	.	T	C	6	5	11	0	1	12	0	0
12	46855074	.	C	T	2	4	6	0	0	6	0	0
12	46857326	.	A	C	1	3	4	0	0	4	0	0
12	46857386	.	A	G	6	0	6	0	6	12	0	0
12	46863553	.	C	T	3	5	8	0	0	8	0	0
12	46880887	.	A	T	1	1	2	0	1	3	0	0
12	46915362	.	C	T	4	3	7	0	0	7	0	0
12	46930412	.	G	C	3	3	6	0	0	6	0	0
12	46930676	.	T	C	6	3	9	0	0	9	0	0
12	46937461	.	G	A	14	5	19	0	0	19	0	0
12	46937814	.	A	C	4	3	7	0	0	7	0	0
12	46955943	.	G	A	3	3	6	0	0	6	0	0
12	46956898	.	C	T	0	2	2	0	2	4	0	0
12	46956916	.	G	A	2	4	6	0	0	6	0	0
12	46967967	.	C	T	2	5	7	0	1	8	0	0
12	46969482	.	T	C	10	6	16	0	0	16	0	0
12	46969488	.	G	A	0	5	5	0	12	17	0	0
12	46969602	.	T	C	3	1	4	0	0	4	0	0
12	46975549	.	T	G	9	4	13	0	0	13	0	0
12	46976075	.	A	G	1	1	2	0	0	2	0	0
12	46978207	.	A	G	7	0	7	0	13	20	0	0
12	46978237	.	C	T	3	6	9	0	0	9	0	0
12	46985337	.	A	C	11	9	20	0	0	20	0	0
12	46985461	.	C	T	11	9	20	0	1	21	0	0
12	46985540	.	T	A	12	7	19	0	0	19	0	0
12	46985648	.	G	A	5	8	13	0	0	13	0	0
12	46985691	.	A	T	5	2	7	0	0	7	0	0
12	46985740	.	T	A	9	3	12	0	2	14	0	0
12	46985749	.	T	G	10	5	15	0	1	16	0	0
12	46985818	.	T	G	12	4	16	0	0	16	0	0
12	46985838	.	G	A	8	3	11	0	0	11	0	0
12	47044878	.	A	T	11	16	27	0	1	28	0	0
12	47044890	.	C	A	11	14	25	0	2	27	0	0
12	47044920	.	G	A	1	10	11	0	6	17	0	0
12	47044952	.	G	A	1	6	7	0	0	7	0	0
12	47051363	.	A	G	12	10	22	0	1	23	0	0
12	47051481	.	C	T	17	14	31	0	1	32	0	0
12	47055306	.	A	G	3	9	12	0	1	13	0	0
12	47055396	.	T	A	12	17	29	0	6	35	0	0
12	47055513	.	T	C	12	11	23	0	1	24	0	0
12	47055609	.	A	G	14	0	14	0	15	29	0	0
12	47062513	.	C	A	14	13	27	0	2	29	0	0
12	47063007	.	G	A	11	7	18	0	0	18	0	0
12	47064418	.	T	C	14	19	33	0	4	37	0	0
12	47064466	.	G	A	14	9	23	0	1	24	0	0
12	47064615	.	G	A	0	1	1	0	4	5	0	0
12	47064654	.	C	T	14	10	24	0	1	25	0	0
12	47064657	.	G	C	14	8	22	0	3	25	0	0
12	47064864	.	G	T	13	7	20	0	0	20	0	0
12	47064888	.	G	A	11	4	15	0	2	17	0	0
12	47068657	.	A	G	16	0	16	0	16	32	0	0
12	47068720	.	C	A	15	9	24	0	0	24	0	0
12	47068738	.	C	T	11	15	26	0	2	28	0	0
12	47241585	.	G	C	0	2	2	0	0	2	0	0
12	47247858	.	C	T	2	6	8	0	0	8	0	0
12	47247963	.	G	T	0	2	2	0	2	4	0	0
12	47258993	.	T	G	0	0	0	0	3	3	0	0
12	47263246	.	C	T	0	1	1	0	0	1	0	0
12	47263258	.	G	C	0	2	2	0	1	3	0	0
12	47270288	.	C	T	1	3	4	0	0	4	0	0
12	47275233	.	A	G	1	0	1	0	3	4	0	0
12	47275326	.	C	G	0	1	1	0	0	1	0	0
12	47281118	.	C	A	5	1	6	0	1	7	0	0
12	47282131	.	G	A	0	2	2	0	1	3	0	0
12	47282137	.	G	A	1	2	3	0	0	3	0	0
12	47283544	.	G	C	1	1	2	0	0	2	0	0
12	47291529	.	G	C	0	1	1	0	3	4	0	0
12	47291685	.	G	A	5	5	10	0	0	10	0	0
12	47302786	.	G	A	0	0	0	0	2	2	0	0
12	47302810	.	G	A	0	2	2	0	0	2	0	0
12	47325323	.	G	T	0	3	3	0	2	5	0	0
12	47327631	.	C	T	0	1	1	0	0	1	0	0
12	47331855	.	C	T	4	6	10	0	2	12	0	0
12	47332134	.	A	T	10	5	15	0	0	15	0	0
12	47332185	.	A	G	12	8	20	0	1	21	0	0
12	47332236	.	A	G	11	11	22	0	1	23	0	0
12	47332389	.	G	A	11	11	22	0	1	23	0	0
12	47335472	.	C	T	2	0	2	0	0	2	0	0
12	47338311	.	A	G	15	18	33	0	1	34	0	0
12	47347875	.	C	T	8	5	13	0	0	13	0	0
12	47355211	.	C	T	14	10	24	0	3	27	0	0
12	47448986	.	C	T	15	7	22	0	1	23	0	0
12	47449481	.	C	T	4	5	9	0	0	9	0	0
12	47449793	.	C	A	5	6	11	0	0	11	0	0
12	47449886	.	T	C	7	5	12	0	1	13	0	0
12	47449967	.	G	A	6	4	10	0	0	10	0	0
12	47461261	.	T	C	1	7	8	0	0	8	0	0
12	47461282	.	C	T	4	9	13	0	0	13	0	0
12	47469850	.	G	C	4	1	5	0	0	5	0	0
12	47480299	.	A	C	1	0	1	0	0	1	0	0
12	47480404	.	G	A	13	10	23	0	0	23	0	0
12	47480536	.	A	C	4	10	14	0	1	15	0	0
12	47481229	.	G	C	0	6	6	0	5	11	0	0
12	47481611	.	G	A	9	8	17	0	0	17	0	0
12	47505208	.	G	A	2	2	4	0	0	4	0	0
12	47516762	.	G	A	8	4	12	1	0	13	0	0
12	47536254	.	C	T	4	2	6	0	0	6	0	0
12	47540933	.	T	C	16	26	42	0	6	48	0	0
12	47540934	.	C	T	15	30	45	0	3	48	0	0
12	47544339	.	G	T	4	3	7	0	0	7	0	0
12	47544543	.	A	G	3	1	4	0	0	4	0	0
12	47593325	.	G	C	1	0	1	0	1	2	0	0
12	47780293	.	C	T	0	3	3	0	0	3	0	0
12	47783974	.	G	T	1	0	1	0	0	1	0	0
12	47857113	.	C	T	2	0	2	0	0	2	0	0
12	47857125	.	T	C	1	0	1	0	0	1	0	0
12	47860342	.	T	C	1	2	3	0	0	3	0	0
12	47860351	.	C	T	2	2	4	0	0	4	0	0
12	47909053	.	C	T	1	1	2	0	0	2	0	0
12	47918826	.	C	A	2	0	2	0	0	2	0	0
12	48094293	.	G	T	10	11	21	0	0	21	0	0
12	48094308	.	G	A	9	8	17	0	0	17	0	0
12	48512050	.	G	T	0	1	1	0	0	1	0	0
12	48566635	.	G	T	0	2	2	0	3	5	0	0
12	48607149	.	C	A	1	2	3	0	0	3	0	0
12	48623416	.	A	T	1	4	5	0	0	5	0	0
12	48656241	.	C	T	1	0	1	0	0	1	0	0
12	48677863	.	T	C	0	3	3	0	0	3	0	0
12	48681663	.	G	A	1	4	5	0	9	14	0	0
12	48681708	.	C	T	6	7	13	0	0	13	0	0
12	48681711	.	T	C	6	7	13	0	0	13	0	0
12	48681826	.	A	T	15	6	21	0	0	21	0	0
12	48681827	.	T	A	15	6	21	0	0	21	0	0
12	48681942	.	A	T	3	9	12	0	0	12	0	0
12	48681997	.	A	T	5	5	10	0	1	11	0	0
12	48682002	.	A	G	4	6	10	0	0	10	0	0
12	48682228	.	G	T	0	8	8	0	5	13	0	0
12	48682237	.	C	G	7	6	13	0	1	14	0	0
12	48682266	.	C	T	6	8	14	0	0	14	0	0
12	48682629	.	T	G	11	4	15	0	0	15	0	0
12	48799268	.	G	A	2	5	7	0	0	7	0	0
12	48803225	.	T	C	9	6	15	0	1	16	0	0
12	48807955	.	T	C	4	4	8	0	0	8	0	0
12	48810690	.	C	T	8	5	13	0	2	15	0	0
12	48810879	.	C	T	7	9	16	0	0	16	0	0
12	48826461	.	T	C	8	3	11	0	2	13	0	0
12	48826584	.	T	C	3	6	9	0	0	9	0	0
12	48826626	.	G	A	3	3	6	0	0	6	0	0
12	48828356	.	C	G	2	0	2	0	0	2	0	0
12	48828431	.	G	A	0	2	2	0	6	8	0	0
12	48829379	.	T	C	2	0	2	0	0	2	0	0
12	48836553	.	A	C	10	13	23	0	0	23	0	0
12	48836576	.	A	G	9	1	10	0	8	18	0	0
12	48836627	.	T	C	2	10	12	0	0	12	0	0
12	48836966	.	G	T	11	6	17	0	0	17	0	0
12	48837047	.	T	G	8	10	18	0	0	18	0	0
12	48837219	.	C	G	12	10	22	0	0	22	0	0
12	49158090	.	T	C	7	1	8	0	13	21	0	0
12	49158104	.	T	C	10	7	17	0	2	19	0	0
13	46540	.	T	C	2	9	11	0	0	11	0	0
13	174486	.	G	A	1	4	5	0	0	5	0	0
13	343567	.	G	T	1	8	9	0	0	9	0	0
13	343581	.	C	G	0	5	5	0	1	6	0	0
13	808361	.	A	G	3	3	6	0	0	6	0	0
13	808915	.	C	T	1	0	1	0	0	1	0	0
13	809779	.	A	G	12	6	18	0	0	18	0	0
13	1415598	.	A	C	3	1	4	0	11	15	0	0
13	1415599	.	G	C	4	2	6	0	9	15	0	0
13	2073857	.	T	C	2	2	4	0	0	4	0	0
13	2254668	.	A	C	6	0	6	0	2	8	0	0
13	2262104	.	G	A	3	2	5	0	0	5	0	0
13	2262128	.	C	A	1	2	3	0	0	3	0	0
13	2357775	.	G	C	2	6	8	0	1	9	0	0
13	2358026	.	A	T	4	7	11	0	0	11	0	0
13	2370556	.	G	T	0	9	9	0	7	16	0	0
13	2382376	.	A	G	2	0	2	0	4	6	0	0
13	2385782	.	G	T	1	4	5	0	12	17	0	0
13	2391803	.	A	G	14	0	14	0	15	29	0	0
13	2391818	.	A	G	16	12	28	0	4	32	0	0
13	2391948	.	G	A	0	13	13	0	19	32	0	0
13	2392397	.	G	A	10	10	20	0	0	20	0	0
13	2392434	.	G	A	8	6	14	0	0	14	0	0
13	2417331	.	A	T	2	3	5	0	0	5	0	0
13	2427251	.	T	A	2	3	5	0	0	6	1	0
13	2427255	.	G	T	3	4	7	0	0	7	0	0
13	2427537	.	T	C	18	5	23	0	1	24	0	0
13	2427569	.	T	C	11	0	11	0	23	34	0	0
13	2427702	.	T	C	21	4	25	0	30	55	0	0
13	2429080	.	C	A	28	24	52	0	3	55	0	0
13	2429300	.	A	G	7	6	13	0	1	14	0	0
13	2434335	.	G	T	18	4	22	0	4	26	0	0
13	2439886	.	C	T	0	1	1	0	1	2	0	0
13	2469076	.	A	G	1	0	1	0	1	2	0	0
13	2469091	.	A	T	1	1	2	0	0	2	0	0
13	2746311	.	A	C	4	5	9	0	0	9	0	0
13	2766946	.	A	G	0	0	0	0	1	1	0	0
13	2767003	.	T	C	1	3	4	0	0	4	0	0
13	2807099	.	A	C	2	4	6	0	0	6	0	0
13	2814352	.	G	A	12	6	18	0	0	18	0	0
13	2814421	.	T	C	3	4	7	0	0	7	0	0
13	2819432	.	C	T	1	5	6	0	0	6	0	0
13	2820601	.	C	G	1	0	1	0	2	3	0	0
13	2824513	.	T	C	2	2	4	0	0	4	0	0
13	2826324	.	A	G	24	0	24	0	18	42	0	0
13	2826397	.	T	C	9	16	25	0	1	26	0	0
13	2826473	.	T	A	27	10	37	0	0	37	0	0
13	2826608	.	T	A	31	8	39	0	2	41	0	0
13	2826611	.	C	T	31	7	38	0	1	39	0	0
13	2826790	.	C	T	14	7	21	0	0	21	0	0
13	2827560	.	A	C	13	18	31	0	1	32	0	0
13	2827578	.	C	A	11	21	32	0	1	33	0	0
13	2827605	.	G	T	13	28	41	0	1	42	0	0
13	2827700	.	G	C	12	24	36	0	2	38	0	0
13	2827808	.	A	G	32	5	37	0	1	38	0	0
13	2827867	.	A	G	16	17	33	0	1	34	0	0
13	2827918	.	A	T	6	7	13	0	1	14	0	0
13	2827998	.	G	A	17	14	31	0	0	31	0	0
13	2828028	.	T	C	14	16	30	0	2	32	0	0
13	2897475	.	T	A	1	4	5	0	0	5	0	0
13	2899483	.	G	A	2	3	5	0	0	5	0	0
13	2913844	.	T	C	10	6	16	0	4	20	0	0
13	2927778	.	G	A	3	8	11	0	1	12	0	0
13	2927832	.	T	A	8	10	18	0	4	22	0	0
13	3264323	.	C	A	6	6	12	0	0	12	0	0
13	3264406	.	C	T	3	5	8	0	0	8	0	0
13	3269340	.	G	A	4	6	10	0	0	10	0	0
13	3272706	.	C	A	0	1	1	0	3	4	0	0
13	3279525	.	A	G	1	0	1	0	0	1	0	0
13	3279588	.	C	T	0	2	2	0	2	4	0	0
13	3287268	.	C	A	0	1	1	0	0	1	0	0
13	3299514	.	C	G	0	1	1	0	1	2	0	0
13	3299562	.	G	A	1	2	3	0	0	3	0	0
13	3357683	.	C	T	0	1	1	0	2	3	0	0
13	3369252	.	T	C	1	1	2	0	0	2	0	0
13	3874427	.	A	G	5	5	10	0	0	10	0	0
13	3874618	.	T	C	5	5	10	0	0	10	0	0
13	3874815	.	T	C	2	0	2	0	5	7	0	0
13	3874831	.	T	C	1	3	4	0	3	7	0	0
13	3874983	.	A	G	2	2	4	0	0	4	0	0
13	3881152	.	T	G	2	2	4	0	0	4	0	0
13	3881204	.	T	C	4	7	11	0	1	12	0	0
13	3881208	.	G	T	5	7	12	0	0	12	0	0
13	3881269	.	C	G	3	5	8	0	0	8	0	0
13	3885350	.	A	C	2	0	2	0	0	2	0	0
13	3885359	.	G	T	2	0	2	0	0	2	0	0
13	3915908	.	A	G	3	7	10	0	2	12	0	0
13	3916150	.	A	G	15	15	30	0	6	36	0	0
13	3916198	.	A	G	9	12	21	0	3	24	0	0
13	3916377	.	G	A	2	6	8	0	0	8	0	0
13	3919020	.	T	C	17	0	17	0	17	34	0	0
13	3919057	.	A	C	20	14	34	0	2	36	0	0
13	3919136	.	A	T	14	10	24	0	4	28	0	0
13	3919167	.	A	G	11	13	24	0	1	25	0	0
13	3919555	.	T	C	12	8	20	0	0	20	0	0
13	3919632	.	A	G	13	7	20	0	0	20	0	0
13	3919672	.	T	G	7	9	16	0	0	16	0	0
13	3919686	.	G	A	8	8	16	0	1	17	0	0
13	3922791	.	T	C	0	3	3	0	1	4	0	0
13	3927916	.	T	C	0	1	1	0	0	1	0	0
13	3927931	.	T	C	2	2	4	0	0	4	0	0
13	3936482	.	C	G	8	7	15	0	1	16	0	0
13	3938574	.	C	A	7	4	11	0	0	11	0	0
13	3938619	.	C	A	10	5	15	0	0	15	0	0
13	3942055	.	G	A	0	15	15	0	10	25	0	0
13	3949847	.	G	A	6	7	13	0	1	14	0	0
13	3949978	.	T	G	11	0	11	0	11	22	0	0
13	3950007	.	G	A	9	9	18	0	0	21	3	0
13	3950074	.	A	T	13	11	24	0	2	26	0	0
13	3950181	.	T	C	16	11	27	0	2	29	0	0
13	3950497	.	G	T	5	6	11	0	0	11	0	0
13	3950669	.	T	A	13	6	19	0	0	19	0	0
13	3954611	.	C	T	3	9	12	0	0	12	0	0
13	3962569	.	C	T	1	0	1	0	0	1	0	0
13	3962845	.	C	T	3	4	7	0	1	8	0	0
13	3965966	.	G	A	7	19	26	0	0	26	0	0
13	3982190	.	G	A	5	3	8	0	1	9	0	0
13	3983112	.	G	C	3	3	6	0	1	7	0	0
13	4213291	.	A	C	1	2	3	0	2	5	0	0
13	4213300	.	C	T	3	2	5	0	0	5	0	0
13	4213804	.	G	A	5	10	15	0	0	15	0	0
13	4226664	.	C	A	16	13	29	0	3	32	0	0
13	4231438	.	T	A	20	17	37	0	1	38	0	0
13	4231590	.	A	G	2	4	6	0	0	6	0	0
13	4231819	.	G	A	12	11	23	0	5	28	0	0
13	4231954	.	T	A	7	3	10	0	1	11	0	0
13	4232003	.	A	G	6	2	8	0	1	10	1	0
13	4232051	.	G	A	6	5	11	0	1	12	0	0
13	4232054	.	A	T	7	7	14	0	0	14	0	0
13	4232171	.	C	T	17	11	28	0	0	28	0	0
13	4232280	.	T	C	28	19	47	0	2	49	0	0
13	4232284	.	T	C	29	21	50	0	0	50	0	0
13	4232324	.	T	G	26	12	38	0	2	40	0	0
13	4232358	.	A	T	19	9	28	0	1	29	0	0
13	4232396	.	G	A	7	7	14	0	1	15	0	0
13	4232400	.	A	T	8	5	13	0	0	13	0	0
13	4232718	.	G	A	0	12	12	0	2	14	0	0
13	4233030	.	C	T	0	20	20	0	16	36	0	0
13	4233033	.	G	A	23	12	35	0	1	36	0	0
13	4233167	.	T	A	16	17	33	0	0	33	0	0
13	4233361	.	G	T	16	12	28	0	0	28	0	0
13	4233365	.	G	A	13	15	28	0	1	29	0	0
13	4233625	.	T	A	5	16	21	0	0	21	0	0
13	4233779	.	G	A	15	15	30	0	0	30	0	0
13	4233889	.	G	A	7	9	16	0	2	18	0	0
13	4233911	.	G	C	10	13	23	0	0	23	0	0
13	4233952	.	T	G	16	10	26	0	1	27	0	0
13	4234337	.	G	A	15	9	24	0	2	26	0	0
13	4234349	.	G	T	16	10	26	0	3	29	0	0
13	4234655	.	G	A	23	13	36	0	0	36	0	0
13	4251236	.	G	A	3	3	6	0	0	6	0	0
13	4256617	.	A	G	3	3	6	0	0	6	0	0
13	4307752	.	A	G	10	15	25	0	2	27	0	0
13	4307782	.	C	T	20	8	28	0	1	29	0	0
13	4307934	.	T	C	20	20	40	0	1	41	0	0
13	4308269	.	G	A	11	13	24	0	0	24	0	0
13	4308841	.	T	G	11	14	25	0	2	27	0	0
13	4309166	.	T	G	11	7	18	0	1	19	0	0
13	4310247	.	G	A	8	9	17	0	2	19	0	0
13	4310440	.	G	C	16	0	16	0	14	30	0	0
13	4310511	.	C	T	0	8	8	0	18	26	0	0
13	4310565	.	G	A	9	11	20	0	1	21	0	0
13	4310568	.	A	T	11	10	21	0	2	23	0	0
13	4310610	.	C	T	14	6	20	0	0	20	0	0
13	4311081	.	T	C	5	4	9	0	1	10	0	0
13	4311578	.	T	C	9	1	10	0	9	19	0	0
13	4311699	.	G	T	5	11	16	0	1	17	0	0
13	4311912	.	C	T	2	3	5	0	0	5	0	0
13	4317628	.	C	T	0	2	2	0	1	3	0	0
13	4321153	.	T	C	4	4	8	0	0	8	0	0
13	4321266	.	C	T	0	2	2	0	4	6	0	0
13	4321273	.	G	A	4	2	6	0	0	6	0	0
13	4321507	.	A	C	3	0	3	0	6	9	0	0
13	4339382	.	C	T	11	13	24	0	0	24	0	0
13	4343183	.	C	T	0	6	6	0	10	16	0	0
13	4343216	.	A	T	9	5	14	0	2	16	0	0
13	4343221	.	T	A	8	9	17	0	0	17	0	0
13	4343490	.	G	A	10	5	15	0	0	15	0	0
13	4343931	.	G	A	5	5	10	0	0	10	0	0
13	4344100	.	C	G	4	4	8	0	0	8	0	0
13	4344159	.	C	G	5	2	7	0	0	7	0	0
13	4344800	.	T	C	5	5	10	0	2	12	0	0
13	4361838	.	A	C	1	2	3	0	0	3	0	0
13	4361847	.	A	G	1	2	3	0	0	3	0	0
13	4366538	.	A	G	0	2	2	0	0	2	0	0
13	4366548	.	G	C	0	0	0	0	3	3	0	0
13	4368536	.	T	C	6	2	8	0	0	8	0	0
13	4398802	.	A	G	2	0	2	0	2	4	0	0
13	4400339	.	G	A	2	8	10	0	1	11	0	0
13	4400409	.	G	C	6	8	14	0	0	14	0	0
13	4400462	.	A	C	1	4	5	0	0	5	0	0
13	4400464	.	C	G	1	4	5	0	0	5	0	0
13	4406816	.	T	C	19	12	31	0	0	31	0	0
13	4406937	.	T	A	3	12	15	0	0	16	1	0
13	4602243	.	G	A	2	2	4	0	0	4	0	0
13	4608140	.	C	T	1	2	3	0	2	5	0	0
13	4613672	.	T	C	1	0	1	0	0	1	0	0
13	4615169	.	T	C	1	3	4	0	0	4	0	0
13	4657403	.	C	T	1	2	3	0	0	3	0	0
13	4657721	.	G	C	8	11	19	0	0	19	0	0
13	4663375	.	G	A	2	1	3	0	0	3	0	0
13	4663402	.	C	T	3	3	6	0	0	6	0	0
13	4663444	.	A	G	5	3	8	0	0	8	0	0
13	4712660	.	C	G	3	3	6	0	0	6	0	0
13	4712874	.	G	A	16	6	22	0	0	22	0	0
13	4713193	.	C	G	11	8	19	0	0	19	0	0
13	4713254	.	G	A	7	7	14	0	0	14	0	0
13	4713373	.	T	A	11	9	20	0	2	22	0	0
13	4713478	.	G	A	10	6	16	0	0	16	0	0
13	4713702	.	A	T	7	6	13	0	0	14	1	0
13	4714011	.	T	A	6	2	8	0	0	8	0	0
13	4872089	.	G	T	4	0	4	0	2	6	0	0
13	4872121	.	C	T	3	0	3	0	1	4	0	0
13	4899623	.	A	G	5	10	15	0	0	15	0	0
13	4945774	.	T	A	3	6	9	0	0	9	0	0
13	4956118	.	G	A	10	6	16	0	1	17	0	0
13	4968819	.	T	A	14	9	23	0	2	25	0	0
13	4968849	.	A	G	11	16	27	0	1	28	0	0
13	4968931	.	T	A	15	14	29	0	0	29	0	0
13	4973556	.	T	A	3	5	8	0	0	8	0	0
13	4973701	.	T	A	7	10	17	0	1	18	0	0
13	4973856	.	C	T	0	6	6	0	6	12	0	0
13	4978785	.	C	T	0	11	11	0	10	21	0	0
13	4978821	.	T	C	13	0	13	0	9	22	0	0
13	4978885	.	T	C	12	8	20	0	2	22	0	0
13	4978887	.	C	A	14	8	22	0	0	22	0	0
13	4979150	.	C	T	7	4	11	0	1	12	0	0
13	4979163	.	A	T	5	4	9	0	0	9	0	0
13	4979339	.	C	T	5	5	10	0	0	10	0	0
13	4979420	.	T	C	4	10	14	0	2	16	0	0
13	4979550	.	A	G	10	8	18	0	2	20	0	0
13	4979607	.	G	T	10	11	21	0	0	21	0	0
13	4979799	.	T	C	0	0	0	0	1	1	0	0
13	4982091	.	C	T	0	3	3	0	6	9	0	0
13	4982112	.	C	T	0	2	2	0	7	9	0	0
13	4984402	.	A	T	2	2	4	0	0	4	0	0
13	4992360	.	A	C	3	4	7	0	0	7	0	0
13	4995574	.	T	C	17	15	32	0	1	33	0	0
13	4995638	.	G	T	1	9	10	0	16	26	0	0
13	4995788	.	C	T	15	13	28	0	2	30	0	0
13	5016758	.	G	C	3	3	6	0	0	6	0	0
13	5017657	.	A	G	9	7	16	0	1	17	0	0
13	5017699	.	G	A	16	12	28	0	4	32	0	0
13	5025842	.	G	T	0	14	14	0	17	31	0	0
13	5025938	.	A	G	12	0	12	0	6	18	0	0
13	5026062	.	A	G	2	0	2	0	1	3	0	0
13	5028407	.	G	A	24	16	40	0	2	42	0	0
13	5028414	.	T	C	24	14	38	0	2	40	0	0
13	5028471	.	T	G	25	29	54	0	0	54	0	0
13	5028538	.	T	G	29	23	52	0	7	59	0	0
13	5028751	.	T	C	38	26	64	0	1	65	0	0
13	5028802	.	T	C	28	25	53	0	2	55	0	0
13	5243743	.	T	C	3	2	5	0	0	5	0	0
13	5245715	.	T	C	1	3	4	0	0	4	0	0
13	5245719	.	T	C	0	0	0	0	4	4	0	0
13	5491234	.	G	A	26	25	51	0	0	51	0	0
13	5531709	.	A	G	9	10	19	0	3	22	0	0
13	5568993	.	G	A	7	8	15	0	0	15	0	0
13	5569344	.	C	T	4	7	11	0	0	11	0	0
13	5572922	.	C	T	2	1	3	0	0	3	0	0
13	5871445	.	G	A	3	6	9	0	1	10	0	0
13	5871834	.	C	T	0	2	2	0	2	4	0	0
13	5871928	.	G	A	3	3	6	0	0	6	0	0
13	5871967	.	A	G	1	2	3	0	0	3	0	0
13	5872201	.	G	A	3	2	5	0	0	5	0	0
13	5872717	.	A	G	0	1	1	0	0	1	0	0
13	5936945	.	T	G	3	7	10	0	1	11	0	0
13	5959654	.	T	C	3	5	8	0	1	9	0	0
13	5978865	.	T	C	0	2	2	0	0	2	0	0
13	6075915	.	T	G	1	3	4	0	0	4	0	0
13	6091985	.	T	C	2	0	2	0	0	2	0	0
13	6092064	.	G	A	2	3	5	0	0	5	0	0
13	6092065	.	A	C	2	3	5	0	0	5	0	0
13	6119843	.	A	G	1	2	3	0	0	3	0	0
13	6119865	.	C	T	2	4	6	0	0	6	0	0
13	6191523	.	C	A	1	0	1	0	0	1	0	0
13	6192433	.	C	A	4	3	7	0	0	7	0	0
13	6194867	.	T	A	10	7	17	0	0	17	0	0
13	6195043	.	T	G	5	0	5	0	13	18	0	0
13	6195055	.	A	T	9	6	15	0	2	17	0	0
13	6199336	.	G	A	0	5	5	0	8	13	0	0
13	6199375	.	T	C	5	3	8	0	0	8	0	0
13	6204583	.	G	A	12	12	24	0	0	24	0	0
13	6204957	.	T	C	16	5	21	0	1	22	0	0
13	6205311	.	G	A	4	8	12	0	0	12	0	0
13	6226012	.	G	C	1	1	2	0	0	2	0	0
13	6233482	.	A	C	1	4	5	0	0	5	0	0
13	6233514	.	T	C	2	1	3	0	0	3	0	0
13	6236772	.	G	A	4	3	7	0	2	9	0	0
13	6236796	.	C	T	3	7	10	0	0	10	0	0
13	6236901	.	G	A	2	3	5	0	0	5	0	0
13	6238204	.	G	A	8	8	16	0	1	17	0	0
13	6238466	.	T	C	11	18	29	0	1	30	0	0
13	6238658	.	G	T	0	13	13	0	10	23	0	0
13	6238883	.	A	G	11	5	16	0	0	16	0	0
13	6238972	.	G	A	7	14	21	0	1	22	0	0
13	6239031	.	C	T	5	7	12	0	1	13	0	0
13	6239091	.	A	T	6	8	14	0	0	14	0	0
13	6239112	.	A	G	5	7	12	0	0	12	0	0
13	6259409	.	T	G	3	2	5	0	0	5	0	0
13	6271263	.	C	T	0	2	2	0	0	2	0	0
13	6279412	.	C	A	0	1	1	0	1	2	0	0
13	6961186	.	A	G	2	2	4	0	0	4	0	0
13	7061380	.	C	T	1	1	2	0	0	2	0	0
13	7129881	.	C	T	1	0	1	0	1	2	0	0
13	7156984	.	A	G	1	0	1	0	1	2	0	0
13	7156987	.	A	G	2	0	2	0	1	3	0	0
13	7170009	.	A	T	0	4	4	0	0	4	0	0
13	7243397	.	T	C	1	1	2	0	0	2	0	0
13	7243431	.	A	G	1	3	4	0	0	4	0	0
13	7243484	.	C	T	0	2	2	0	0	2	0	0
13	7255659	.	T	C	8	5	13	0	0	13	0	0
13	7255664	.	G	A	7	5	12	0	1	13	0	0
13	7305601	.	G	A	0	4	4	0	2	6	0	0
13	7305625	.	T	A	2	3	5	0	1	6	0	0
13	7305637	.	T	A	3	2	5	0	1	6	0	0
13	7306606	.	A	T	3	3	6	0	0	6	0	0
13	7309392	.	C	T	3	3	6	0	0	6	0	0
13	7310386	.	C	A	4	3	7	0	0	7	0	0
13	7310428	.	G	A	4	3	7	0	0	7	0	0
13	7310628	.	A	C	3	3	6	0	0	6	0	0
13	7311089	.	C	T	3	2	5	0	1	6	0	0
13	7311154	.	T	G	0	0	0	0	3	3	0	0
13	7311218	.	A	G	2	4	6	0	0	6	0	0
13	7311324	.	T	G	2	3	5	0	0	5	0	0
13	7311420	.	C	A	4	3	7	0	0	7	0	0
13	7311476	.	C	T	4	5	9	0	0	9	0	0
13	7311849	.	C	T	5	4	9	0	0	9	0	0
13	7311986	.	A	C	3	8	11	0	0	11	0	0
13	7312015	.	T	A	6	10	16	0	1	17	0	0
13	7312170	.	C	T	9	3	12	0	0	12	0	0
13	7312201	.	T	A	7	4	11	0	0	11	0	0
13	7312225	.	G	C	4	3	7	0	1	8	0	0
13	7312323	.	A	T	3	2	5	0	0	5	0	0
13	7312325	.	G	A	3	2	5	0	0	5	0	0
13	7312527	.	G	A	0	7	7	0	7	14	0	0
13	7312585	.	T	C	4	6	10	0	1	11	0	0
13	7312675	.	C	T	6	2	8	0	0	8	0	0
13	7312713	.	T	A	6	3	9	0	0	9	0	0
13	7313020	.	G	A	0	3	3	0	11	14	0	0
13	7313066	.	T	G	5	4	9	0	0	9	0	0
13	7313185	.	T	C	16	7	23	0	0	23	0	0
13	7313304	.	A	G	6	7	13	0	0	13	0	0
13	7313324	.	T	A	10	6	16	0	0	16	0	0
13	7313546	.	A	G	2	3	5	0	0	5	0	0
13	7313613	.	C	T	6	3	9	0	1	10	0	0
13	7313641	.	C	A	5	7	12	0	0	12	0	0
13	7313703	.	C	T	7	9	16	0	1	17	0	0
13	7313827	.	C	T	8	11	19	0	0	19	0	0
13	7314049	.	T	C	7	10	17	0	0	17	0	0
13	7314222	.	A	T	6	9	15	0	0	15	0	0
13	7314300	.	T	C	9	9	18	0	0	18	0	0
13	7314567	.	C	A	8	13	21	0	0	21	0	0
13	7314568	.	T	G	8	11	19	0	2	21	0	0
13	7314736	.	A	C	13	13	26	0	0	26	0	0
13	7315123	.	C	T	13	23	36	0	0	36	0	0
13	7315174	.	C	A	13	13	26	0	1	27	0	0
13	7315197	.	A	G	12	0	12	0	13	25	0	0
13	7315234	.	A	G	16	11	27	0	2	29	0	0
13	7315597	.	A	G	17	0	17	0	7	24	0	0
13	7316042	.	C	A	14	13	27	0	2	29	0	0
13	7316157	.	G	T	23	13	36	0	1	37	0	0
13	7316207	.	C	T	9	12	21	0	2	23	0	0
13	7316463	.	G	A	11	10	21	0	0	21	0	0
13	7316484	.	A	T	11	10	21	0	1	22	0	0
13	7316532	.	C	A	13	10	23	0	0	23	0	0
13	7316537	.	A	C	13	13	26	0	1	27	0	0
13	7316784	.	G	A	10	7	17	0	0	17	0	0
13	7316830	.	C	G	8	7	15	0	0	15	0	0
13	7316903	.	G	A	2	4	6	0	0	6	0	0
13	7322524	.	C	T	7	6	13	0	0	13	0	0
13	7340136	.	A	G	2	0	2	0	1	3	0	0
13	7340151	.	T	A	3	1	4	0	0	4	0	0
13	7346655	.	C	A	9	4	13	0	0	13	0	0
13	7346683	.	A	G	19	5	24	0	0	24	0	0
13	7346928	.	A	C	22	7	29	0	1	30	0	0
13	7347026	.	A	G	8	19	27	0	2	29	0	0
13	7347060	.	G	T	11	17	28	0	0	28	0	0
13	7347061	.	A	T	11	17	28	0	0	28	0	0
13	7690060	.	G	A	1	1	2	0	0	2	0	0
13	7690124	.	G	A	2	2	4	0	0	4	0	0
13	7693681	.	C	T	2	2	4	0	0	4	0	0
13	7725965	.	C	T	4	6	10	0	0	10	0	0
13	7728958	.	C	T	4	2	6	0	0	6	0	0
13	7737020	.	G	A	0	2	2	0	0	2	0	0
13	7744319	.	A	G	2	5	7	0	0	7	0	0
13	7744443	.	G	A	2	0	2	0	0	2	0	0
13	7745463	.	C	G	3	7	10	0	1	11	0	0
13	7745544	.	C	T	10	10	20	0	0	20	0	0
13	7745705	.	G	A	10	10	20	0	0	20	0	0
13	7745814	.	C	A	3	7	10	0	1	11	0	0
13	7745962	.	A	G	2	4	6	0	0	6	0	0
13	7745979	.	T	C	1	5	6	0	0	6	0	0
13	7747299	.	A	G	4	3	7	0	1	8	0	0
13	7747513	.	C	G	6	7	13	0	1	14	0	0
13	7747738	.	T	C	6	12	18	0	0	18	0	0
13	7747760	.	T	C	8	14	22	0	1	23	0	0
13	7748021	.	G	T	7	13	20	0	1	21	0	0
13	7748424	.	T	C	11	6	17	0	0	17	0	0
13	7748497	.	T	G	6	6	12	0	0	12	0	0
13	7748533	.	T	G	4	9	13	0	1	14	0	0
13	7748794	.	G	A	0	12	12	0	13	25	0	0
13	7748882	.	A	T	13	16	29	0	0	29	0	0
13	7748995	.	T	A	12	12	24	0	3	27	0	0
13	7749000	.	G	C	11	14	25	0	3	28	0	0
13	7753123	.	T	C	4	1	5	0	3	8	0	0
13	7755764	.	A	C	2	1	3	0	2	5	0	0
13	7755875	.	T	C	19	1	20	0	21	41	0	0
13	7759403	.	T	C	11	8	19	0	0	19	0	0
13	7763810	.	A	G	16	5	21	0	1	22	0	0
13	7766936	.	C	T	0	15	15	0	14	29	0	0
13	8169045	.	C	A	1	2	3	0	0	3	0	0
13	8169620	.	T	C	1	2	3	0	0	3	0	0
13	8270551	.	C	T	2	2	4	0	0	4	0	0
13	8270554	.	T	C	2	1	3	0	0	3	0	0
13	8277667	.	A	G	2	2	4	0	0	4	0	0
13	8281433	.	C	T	0	5	5	0	1	6	0	0
13	8281655	.	A	C	7	5	12	0	1	13	0	0
13	8281669	.	C	A	9	5	14	0	0	14	0	0
13	8281717	.	C	G	8	4	12	0	0	12	0	0
13	8281828	.	G	A	2	2	4	0	1	5	0	0
13	8281876	.	G	T	2	2	4	0	0	4	0	0
13	8281882	.	T	G	2	2	4	0	0	4	0	0
13	8285163	.	C	G	1	0	1	0	0	1	0	0
13	8285256	.	T	A	4	6	10	0	2	12	0	0
13	8290860	.	A	C	2	4	6	0	0	6	0	0
13	8320743	.	A	G	4	6	10	0	0	10	0	0
13	8320852	.	C	G	6	2	8	0	0	8	0	0
13	8320855	.	C	G	6	2	8	0	0	8	0	0
13	8326274	.	T	C	2	4	6	0	0	6	0	0
13	8330296	.	G	C	1	3	4	0	0	4	0	0
13	8330568	.	G	A	4	7	11	0	0	11	0	0
13	8375857	.	T	C	4	0	4	0	5	9	0	0
13	8375932	.	A	T	10	18	28	0	1	29	0	0
13	8375935	.	C	A	10	18	28	0	0	28	0	0
13	8375981	.	A	G	18	25	43	0	2	45	0	0
13	8376064	.	A	G	13	13	26	0	0	26	0	0
13	8376077	.	C	G	10	14	24	0	0	24	0	0
13	8376184	.	C	T	7	7	14	0	0	14	0	0
13	8376187	.	G	A	7	7	14	0	0	14	0	0
13	8376301	.	A	T	6	5	11	0	0	11	0	0
13	8376317	.	T	A	8	5	13	0	0	13	0	0
13	8376355	.	C	T	7	5	12	0	0	12	0	0
13	8376613	.	T	G	7	7	14	0	0	14	0	0
13	8376845	.	A	G	5	10	15	0	1	16	0	0
13	8376882	.	C	T	0	7	7	0	4	11	0	0
13	8376896	.	T	C	4	8	12	0	0	12	0	0
13	8377056	.	A	T	1	2	3	0	0	3	0	0
13	8377058	.	A	G	1	2	3	0	0	3	0	0
13	8377327	.	A	G	5	2	7	0	0	7	0	0
13	8377334	.	A	G	7	2	9	0	0	9	0	0
13	8377606	.	A	G	1	2	3	0	0	3	0	0
13	8377624	.	C	T	2	1	3	0	1	4	0	0
13	8377767	.	C	G	2	3	5	0	0	5	0	0
13	8378280	.	C	T	0	2	2	0	1	3	0	0
13	8378354	.	A	G	1	2	3	0	0	3	0	0
13	8378391	.	G	C	2	2	4	0	0	4	0	0
13	8378400	.	T	C	2	2	4	0	0	4	0	0
13	8378511	.	A	T	1	3	4	0	0	4	0	0
13	8378601	.	T	C	1	2	3	0	0	3	0	0
13	8378635	.	T	G	0	3	3	0	0	3	0	0
13	8378698	.	C	A	1	2	3	0	0	3	0	0
13	8379079	.	A	C	2	0	2	0	7	9	0	0
13	8379096	.	T	G	2	5	7	0	0	7	0	0
13	8379119	.	C	T	2	3	5	0	0	5	0	0
13	8380477	.	T	C	2	2	4	0	0	4	0	0
13	8452785	.	G	A	1	2	3	0	0	3	0	0
13	8452799	.	G	C	1	1	2	0	0	2	0	0
13	8453068	.	T	G	4	3	7	0	0	7	0	0
13	8622003	.	A	C	1	2	3	0	0	3	0	0
13	8622084	.	A	G	2	2	4	0	0	4	0	0
13	8622801	.	T	C	4	3	7	0	0	7	0	0
13	8623517	.	A	C	3	4	7	0	0	7	0	0
13	8624658	.	T	C	1	3	4	0	0	4	0	0
13	8624659	.	G	T	1	3	4	0	0	4	0	0
13	8625050	.	A	G	2	0	2	0	3	5	0	0
13	8625102	.	T	C	1	6	7	0	1	8	0	0
13	8625106	.	T	A	1	6	7	0	1	8	0	0
13	8626252	.	C	G	1	3	4	0	0	4	0	0
13	8626329	.	T	G	2	3	5	0	0	5	0	0
13	8626330	.	G	T	2	3	5	0	0	5	0	0
13	8626645	.	T	A	6	1	7	0	0	7	0	0
13	8626699	.	C	T	4	7	11	0	1	12	0	0
13	8626841	.	C	T	6	1	7	0	0	7	0	0
13	8626957	.	C	T	1	2	3	0	0	3	0	0
13	8627056	.	T	C	3	2	5	0	0	5	0	0
13	8627178	.	T	A	2	5	7	0	2	9	0	0
13	8627179	.	A	T	3	6	9	0	0	9	0	0
13	8627222	.	C	T	4	2	6	0	1	7	0	0
13	8627302	.	C	A	2	8	10	0	0	10	0	0
13	8627445	.	A	G	3	5	8	0	2	10	0	0
13	8627586	.	G	T	1	2	3	0	0	3	0	0
13	8627634	.	T	A	5	6	11	0	0	12	1	0
13	8627748	.	T	C	2	3	5	0	0	5	0	0
13	8627819	.	T	C	1	3	4	0	0	4	0	0
13	8627921	.	A	T	1	2	3	0	0	3	0	0
13	8627947	.	C	T	1	4	5	0	0	5	0	0
13	8683879	.	A	T	2	3	5	0	0	5	0	0
13	8684134	.	A	G	9	7	16	0	0	16	0	0
13	8684175	.	C	T	3	3	6	0	0	6	0	0
13	8684499	.	C	T	3	4	7	0	0	7	0	0
13	8684513	.	T	C	4	5	9	0	1	10	0	0
13	8684608	.	G	A	5	6	11	0	0	11	0	0
13	8684705	.	A	G	5	9	14	0	1	15	0	0
13	8685051	.	C	T	0	6	6	0	3	9	0	0
13	8685176	.	C	T	4	5	9	0	0	9	0	0
13	8685217	.	A	T	3	9	12	0	0	12	0	0
13	8685228	.	G	C	2	9	11	0	0	11	0	0
13	8685278	.	C	A	2	5	7	0	0	7	0	0
13	8685417	.	G	A	2	8	10	0	1	11	0	0
13	8685496	.	A	T	6	7	13	0	0	13	0	0
13	8685542	.	G	A	7	8	15	0	0	15	0	0
13	8692306	.	C	T	5	3	8	0	1	9	0	0
13	8692395	.	A	G	5	6	11	0	2	13	0	0
13	8692776	.	T	G	5	1	6	0	2	8	0	0
13	8777701	.	G	A	17	12	29	0	1	30	0	0
13	8777724	.	T	C	14	14	28	0	0	28	0	0
13	8777845	.	T	A	9	9	18	0	0	18	0	0
13	8778490	.	G	A	28	39	67	0	4	71	0	0
13	8778501	.	G	T	28	37	65	0	3	68	0	0
13	8778548	.	G	A	24	26	50	0	2	52	0	0
13	8781159	.	G	C	2	0	2	0	4	6	0	0
13	8781222	.	T	C	3	6	9	0	0	9	0	0
13	8781577	.	A	G	14	19	33	0	4	37	0	0
13	8781786	.	C	T	30	18	48	0	2	50	0	0
13	8781789	.	A	C	30	21	51	0	1	52	0	0
13	8785294	.	C	G	4	9	13	0	1	14	0	0
13	8785327	.	T	C	5	5	10	0	1	11	0	0
13	8937231	.	T	G	1	0	1	0	2	3	0	0
13	8937412	.	A	G	2	3	5	0	0	5	0	0
13	8937472	.	T	G	2	2	4	0	0	4	0	0
13	8945642	.	C	G	2	2	4	0	1	5	0	0
13	8945646	.	T	G	2	2	4	0	0	4	0	0
13	8947046	.	G	A	1	2	3	0	0	3	0	0
13	8950686	.	G	A	6	3	9	0	2	11	0	0
13	8950783	.	C	G	3	3	6	0	0	6	0	0
13	8950795	.	C	A	2	2	4	0	0	4	0	0
13	8951345	.	A	T	2	2	4	0	0	4	0	0
13	8951356	.	G	A	2	1	3	0	0	3	0	0
13	8951492	.	G	T	3	2	5	0	0	5	0	0
13	9300177	.	A	G	3	5	8	0	0	8	0	0
13	9300224	.	C	T	0	4	4	0	1	5	0	0
13	9300239	.	G	T	1	2	3	0	0	3	0	0
13	9307202	.	C	T	0	12	12	0	11	23	0	0
13	9307646	.	T	C	5	6	11	0	0	11	0	0
13	9311011	.	G	T	9	12	21	0	2	23	0	0
13	9314040	.	T	A	28	40	68	0	0	68	0	0
13	9314104	.	C	T	0	33	33	0	26	59	0	0
13	9314322	.	G	A	31	32	63	0	0	63	0	0
13	9314340	.	C	T	36	32	68	0	1	70	1	0
13	9314532	.	T	C	36	5	41	0	33	74	0	0
13	9314657	.	C	T	29	42	71	0	0	71	0	0
13	9314680	.	G	A	31	40	71	0	1	72	0	0
13	9314800	.	T	C	37	44	81	0	1	83	1	0
13	9314935	.	G	A	35	37	72	0	6	78	0	0
13	9315004	.	C	T	36	33	69	0	2	71	0	0
13	9315019	.	T	C	31	31	62	0	7	69	0	0
13	9315321	.	G	T	39	49	88	0	0	88	0	0
13	9317915	.	T	C	36	44	80	0	3	83	0	0
13	9318491	.	G	C	37	51	88	1	1	90	0	0
13	9318638	.	G	C	20	2	22	0	44	66	0	0
13	9318644	.	T	C	21	44	65	0	2	67	0	0
13	9318682	.	T	C	16	2	18	0	48	66	0	0
13	9318699	.	A	T	27	37	64	0	3	67	0	0
13	9340093	.	C	T	0	8	8	0	4	12	0	0
13	9340199	.	T	C	5	4	9	0	2	11	0	0
13	9340527	.	C	T	14	7	21	0	0	21	0	0
13	9340609	.	C	A	0	9	9	0	12	21	0	0
13	9340671	.	G	A	8	14	22	0	0	22	0	0
13	9343329	.	T	C	7	5	12	0	0	12	0	0
13	9344878	.	A	T	8	5	13	0	0	13	0	0
13	9351194	.	T	C	1	2	3	0	0	3	0	0
13	9358449	.	C	T	10	5	15	0	2	17	0	0
13	9367537	.	A	G	12	7	19	0	1	20	0	0
13	9367562	.	T	A	10	7	17	0	3	20	0	0
13	9367600	.	G	T	5	5	10	0	0	10	0	0
13	9374827	.	C	G	1	2	3	0	0	3	0	0
13	9655947	.	C	A	5	3	8	0	0	8	0	0
13	9655952	.	C	G	4	3	7	0	1	8	0	0
13	9656223	.	A	C	1	2	3	0	0	3	0	0
13	9656237	.	C	T	1	4	5	0	0	5	0	0
13	9759974	.	A	G	1	2	3	0	0	3	0	0
13	9760378	.	A	G	1	4	5	0	0	5	0	0
13	9760400	.	G	C	1	3	4	0	0	4	0	0
13	9760413	.	C	A	1	2	3	0	0	3	0	0
13	9760690	.	T	C	1	2	3	0	0	3	0	0
13	9760713	.	A	C	1	2	3	0	0	3	0	0
13	9828568	.	A	T	3	3	6	0	1	7	0	0
13	9828572	.	G	A	0	3	3	0	4	7	0	0
13	9828933	.	G	T	5	6	11	0	0	11	0	0
13	9829007	.	A	G	3	3	6	0	1	7	0	0
13	9829013	.	C	T	4	3	7	0	0	7	0	0
13	9829232	.	T	C	2	2	4	0	0	4	0	0
13	9829252	.	T	A	3	1	4	0	0	4	0	0
13	9829274	.	C	A	3	2	5	0	0	5	0	0
13	9829289	.	T	C	4	2	6	0	0	6	0	0
13	9829722	.	T	G	2	0	2	0	3	5	0	0
13	9829855	.	C	T	6	12	18	0	0	18	0	0
13	9830089	.	T	C	6	7	13	0	1	14	0	0
13	9830147	.	A	T	2	3	5	0	1	6	0	0
13	9830148	.	C	G	2	4	6	0	0	6	0	0
13	9830371	.	T	C	2	2	4	0	0	4	0	0
13	9830399	.	C	T	2	2	4	0	0	4	0	0
13	9830417	.	C	A	2	1	3	0	0	3	0	0
13	9830518	.	A	T	3	9	12	0	1	13	0	0
13	9830521	.	A	C	4	10	14	0	0	14	0	0
13	9830554	.	A	G	3	10	13	0	0	13	0	0
13	9830597	.	C	A	4	4	8	0	0	8	0	0
13	9831116	.	A	G	7	8	15	0	0	15	0	0
13	9836485	.	A	T	0	1	1	0	0	1	0	0
13	9841702	.	T	A	2	14	16	0	3	19	0	0
13	9844527	.	A	G	2	1	3	0	0	3	0	0
13	9844746	.	T	C	7	3	10	0	0	10	0	0
13	9855508	.	G	T	13	13	26	0	2	28	0	0
13	9855874	.	G	A	11	16	27	0	1	28	0	0
13	9856143	.	G	A	7	11	18	0	3	21	0	0
13	9856192	.	A	G	12	8	20	0	0	20	0	0
13	9856493	.	A	T	22	20	42	0	1	43	0	0
13	9856816	.	G	A	12	20	32	0	0	32	0	0
13	9857005	.	G	A	13	7	20	0	0	20	0	0
13	9857008	.	A	G	14	7	21	0	0	21	0	0
13	9866857	.	G	A	1	6	7	0	0	7	0	0
13	9952641	.	T	C	0	2	2	0	0	2	0	0
13	10895731	.	T	G	1	0	1	0	0	1	0	0
13	10906719	.	G	A	0	3	3	0	1	4	0	0
13	10906817	.	T	C	0	3	3	0	0	3	0	0
13	10910423	.	G	T	0	1	1	0	1	2	0	0
13	10922497	.	T	G	5	3	8	0	0	8	0	0
13	10922536	.	C	T	1	5	6	0	0	6	0	0
13	10922613	.	A	T	4	9	13	0	1	14	0	0
13	10970732	.	G	T	2	1	3	0	0	3	0	0
13	10978512	.	A	T	1	2	3	0	0	3	0	0
13	10978526	.	C	T	1	2	3	0	0	3	0	0
13	10981896	.	T	A	5	2	7	0	0	7	0	0
13	10982404	.	C	T	12	17	29	0	1	30	0	0
13	10982444	.	G	A	15	17	32	0	0	32	0	0
13	10982472	.	T	G	11	12	23	0	2	25	0	0
13	10982966	.	A	T	17	14	31	0	2	33	0	0
13	10983231	.	G	A	10	4	14	0	0	14	0	0
13	10983421	.	C	A	8	8	16	0	0	16	0	0
13	10983482	.	T	A	11	7	18	0	0	18	0	0
13	10983788	.	T	C	7	14	21	0	0	21	0	0
13	10984205	.	G	A	13	17	30	0	1	31	0	0
13	10990959	.	G	A	4	3	7	0	0	7	0	0
13	10990973	.	T	C	7	0	7	0	5	12	0	0
13	10994107	.	A	G	8	4	12	0	0	12	0	0
13	10997566	.	A	G	6	5	11	0	0	11	0	0
13	11001998	.	A	G	6	7	13	0	0	13	0	0
13	11002013	.	A	C	6	0	6	0	7	13	0	0
13	11002052	.	A	G	8	6	14	0	0	14	0	0
13	11002234	.	C	T	0	7	7	0	7	14	0	0
13	11002247	.	G	A	6	5	11	0	2	13	0	0
13	11002541	.	A	G	2	4	6	0	0	6	0	0
13	11002697	.	A	G	4	6	10	0	1	11	0	0
13	11002778	.	T	C	6	6	12	0	0	12	0	0
13	11002922	.	C	T	5	6	11	0	0	11	0	0
13	11002970	.	T	C	3	4	7	0	0	7	0	0
13	11003297	.	C	T	0	1	1	0	1	2	0	0
13	11007087	.	G	A	0	1	1	0	0	1	0	0
13	11012349	.	C	T	1	2	3	0	0	3	0	0
13	11012469	.	T	C	3	5	8	0	1	9	0	0
13	11029585	.	G	T	1	0	1	0	0	1	0	0
13	11035253	.	C	G	0	1	1	0	0	1	0	0
13	11035307	.	G	A	3	1	4	0	0	4	0	0
13	11035313	.	C	T	0	1	1	0	3	4	0	0
13	11083167	.	A	G	2	0	2	0	0	2	0	0
13	11086319	.	C	G	1	0	1	0	1	2	0	0
13	11166435	.	G	A	4	4	8	0	0	8	0	0
13	11166467	.	A	G	3	2	5	0	0	5	0	0
13	11166613	.	C	G	1	3	4	0	1	5	0	0
13	11175605	.	G	A	1	4	5	0	1	6	0	0
13	11184784	.	G	A	2	0	2	0	1	3	0	0
13	11233520	.	G	C	0	4	4	0	0	4	0	0
13	11441080	.	T	A	6	10	16	0	1	17	0	0
13	11442090	.	A	T	23	13	36	0	0	36	0	0
13	11443457	.	T	A	31	18	49	0	0	49	0	0
13	11443881	.	C	T	20	23	43	0	2	45	0	0
13	11444022	.	A	T	17	21	38	0	0	38	0	0
13	11444263	.	G	A	0	22	22	0	20	42	0	0
13	11444295	.	C	T	24	25	49	0	1	50	0	0
13	11444801	.	T	A	15	8	23	0	2	25	0	0
13	11489965	.	T	C	9	6	15	0	0	15	0	0
13	11489999	.	C	A	13	8	21	0	1	22	0	0
13	11490035	.	A	G	10	8	18	0	0	18	0	0
13	11490065	.	G	A	5	7	12	0	1	13	0	0
13	11490084	.	G	A	7	6	13	0	0	13	0	0
13	11490214	.	A	C	2	3	5	0	0	5	0	0
13	11490300	.	G	T	2	5	7	0	1	8	0	0
13	11490626	.	G	A	8	4	12	0	0	12	0	0
13	11500299	.	T	C	3	0	3	0	8	11	0	0
13	11503682	.	G	A	2	2	4	0	0	4	0	0
13	11536901	.	T	A	9	4	13	0	0	13	0	0
13	11550734	.	G	T	0	6	6	0	5	11	0	0
13	11550741	.	T	C	7	4	11	0	1	12	0	0
13	11675148	.	G	A	9	3	12	0	0	12	0	0
13	11675185	.	A	G	12	4	16	0	1	17	0	0
13	11675343	.	C	G	5	6	11	0	0	11	0	0
13	11675378	.	T	C	3	6	9	0	2	11	0	0
13	11675464	.	A	G	5	2	7	0	0	7	0	0
13	11675584	.	C	T	3	6	9	0	0	9	0	0
13	11675758	.	G	T	4	3	7	0	0	7	0	0
13	11675855	.	T	G	7	5	12	0	0	12	0	0
13	11675912	.	A	T	6	4	10	0	0	10	0	0
13	11675951	.	G	A	3	5	8	0	0	8	0	0
13	11676403	.	C	T	1	2	3	0	0	3	0	0
13	11677524	.	G	A	2	2	4	0	0	4	0	0
13	11736469	.	C	T	0	0	0	0	1	1	0	0
13	11746459	.	C	A	20	17	37	0	0	37	0	0
13	11751402	.	G	A	1	2	3	0	1	4	0	0
13	11767651	.	T	C	7	7	14	0	1	15	0	0
13	11767768	.	A	G	5	3	8	0	0	8	0	0
13	11775095	.	G	A	3	4	7	0	0	7	0	0
13	11781751	.	C	T	0	4	4	0	4	8	0	0
13	11781769	.	A	G	2	2	4	0	1	5	0	0
13	11797431	.	C	T	1	1	2	0	1	3	0	0
13	11829109	.	C	A	2	2	4	0	0	4	0	0
13	11829112	.	T	A	2	2	4	0	0	4	0	0
13	11829158	.	T	A	2	2	4	0	0	4	0	0
13	11836187	.	C	T	0	1	1	0	0	1	0	0
13	11852302	.	C	T	1	1	2	0	0	2	0	0
13	11860525	.	T	C	3	2	5	0	0	5	0	0
13	11868812	.	A	G	3	4	7	0	0	7	0	0
13	11869049	.	G	T	7	5	12	0	1	13	0	0
13	11869127	.	C	T	8	4	12	0	0	12	0	0
13	11869143	.	T	C	6	2	8	0	2	10	0	0
13	11869219	.	G	T	2	3	5	0	0	5	0	0
13	11869220	.	G	T	2	3	5	0	0	5	0	0
13	11869357	.	G	T	9	6	15	0	0	15	0	0
13	11869539	.	T	C	4	3	7	0	0	7	0	0
13	11876698	.	T	G	3	7	10	0	0	10	0	0
13	11876841	.	G	A	8	8	16	0	1	17	0	0
13	11876850	.	G	A	7	6	13	0	3	16	0	0
13	11911904	.	A	G	2	2	4	0	0	4	0	0
13	11921405	.	A	G	5	1	6	0	0	6	0	0
13	11921417	.	C	T	5	0	5	0	1	6	0	0
13	11923834	.	G	C	4	3	7	0	1	8	0	0
13	11926692	.	C	G	7	8	15	0	0	15	0	0
13	11927341	.	C	G	5	7	12	0	0	12	0	0
13	11927347	.	T	A	4	5	9	0	1	10	0	0
13	11927491	.	T	C	6	8	14	0	2	16	0	0
13	11927603	.	A	G	7	3	10	0	0	10	0	0
13	11927735	.	T	C	4	5	9	0	0	9	0	0
13	11927829	.	A	T	2	6	8	0	2	10	0	0
13	11927830	.	T	G	5	5	10	0	0	10	0	0
13	11966316	.	A	G	0	2	2	0	0	2	0	0
13	11977394	.	A	T	3	3	6	0	1	7	0	0
13	11984768	.	A	C	1	2	3	0	0	3	0	0
13	11984857	.	T	A	3	2	5	0	0	5	0	0
13	11989171	.	G	C	2	4	6	0	9	17	2	0
13	11989357	.	T	C	19	17	36	0	0	36	0	0
13	11989468	.	A	C	17	15	32	0	2	34	0	0
13	11989554	.	A	G	28	18	46	0	0	46	0	0
13	11989629	.	C	T	24	19	43	0	0	43	0	0
13	11989633	.	T	C	23	18	41	0	1	42	0	0
13	11989698	.	C	T	16	16	32	0	1	33	0	0
13	11990118	.	G	A	24	19	43	0	0	43	0	0
13	11990175	.	T	C	16	0	16	0	16	32	0	0
13	11990294	.	A	G	22	8	30	0	1	31	0	0
13	11990329	.	T	G	17	11	28	0	2	30	0	0
13	11990389	.	G	T	19	16	35	0	2	37	0	0
13	11993451	.	A	T	15	11	26	0	0	26	0	0
13	12001254	.	A	G	7	8	15	0	0	15	0	0
13	12003905	.	T	C	2	0	2	0	0	2	0	0
13	12005588	.	C	T	0	4	4	0	3	7	0	0
13	12005656	.	T	A	1	2	3	0	2	5	0	0
13	12005859	.	T	A	2	3	5	0	0	5	0	0
13	12087528	.	G	A	0	9	9	0	9	18	0	0
13	12088223	.	C	G	18	18	36	0	0	36	0	0
13	12088255	.	A	G	12	15	27	0	2	29	0	0
13	12088327	.	A	G	8	19	27	0	2	29	0	0
13	12088406	.	T	C	16	10	26	0	1	27	0	0
13	12142001	.	G	A	1	2	3	0	0	3	0	0
13	12142007	.	T	C	1	1	2	0	0	2	0	0
13	12150892	.	C	T	4	3	7	0	0	7	0	0
13	12201923	.	C	G	3	3	6	0	0	6	0	0
13	12207170	.	A	T	4	9	13	0	1	14	0	0
13	12207583	.	G	T	5	3	8	0	0	8	0	0
13	12207591	.	A	T	5	4	9	0	0	9	0	0
13	12207656	.	C	T	10	4	14	0	0	14	0	0
13	12329553	.	C	T	0	0	0	0	1	1	0	0
13	12370737	.	T	A	4	2	6	0	0	6	0	0
13	12370839	.	A	G	2	5	7	0	0	7	0	0
13	12370952	.	T	A	2	3	5	0	0	5	0	0
13	12371541	.	T	C	2	2	4	0	0	4	0	0
13	12371559	.	A	G	3	0	3	0	4	7	0	0
13	12371928	.	T	A	3	2	5	0	0	5	0	0
13	12371953	.	A	T	2	2	4	0	0	4	0	0
13	12372247	.	T	C	2	3	5	0	0	5	0	0
13	12372387	.	C	T	7	3	10	0	0	10	0	0
13	12372552	.	C	A	4	3	7	0	2	9	0	0
13	12372596	.	C	G	2	10	12	0	1	13	0	0
13	12372609	.	C	G	4	9	13	0	0	13	0	0
13	12372777	.	A	G	6	5	11	0	1	12	0	0
13	12373033	.	A	G	6	0	6	0	8	14	0	0
13	12373059	.	T	C	5	7	12	0	0	12	0	0
13	12373093	.	A	T	4	5	9	0	0	9	0	0
13	12373153	.	T	C	2	2	4	0	0	4	0	0
13	12373262	.	C	T	6	5	11	0	0	11	0	0
13	12373274	.	A	T	5	5	10	0	0	10	0	0
13	12373430	.	T	A	7	5	12	1	0	13	0	0
13	12373460	.	A	G	7	4	11	0	1	12	0	0
13	12373514	.	A	G	1	6	7	0	3	10	0	0
13	12373572	.	C	T	1	4	5	0	0	5	0	0
13	12373679	.	T	C	4	4	8	0	0	8	0	0
13	12374414	.	A	G	8	11	19	0	0	19	0	0
13	12374710	.	A	G	13	0	13	0	7	20	0	0
13	12374771	.	A	G	4	12	16	0	1	17	0	0
13	12374775	.	T	G	4	13	17	0	0	17	0	0
13	12374901	.	C	A	6	3	9	0	0	9	0	0
13	12374910	.	G	A	0	2	2	0	8	10	0	0
13	12374954	.	A	C	7	6	13	0	1	14	0	0
13	12375198	.	A	G	12	12	24	0	0	24	0	0
13	12375348	.	C	A	4	5	9	0	1	10	0	0
13	12375389	.	A	G	6	13	19	0	2	21	0	0
13	12378142	.	G	T	2	5	7	0	1	8	0	0
13	12378315	.	T	A	9	11	20	0	0	20	0	0
13	12378356	.	T	G	10	11	21	0	0	21	0	0
13	12378407	.	T	C	5	4	9	0	1	10	0	0
13	12385182	.	A	G	8	9	17	0	0	17	0	0
13	12385538	.	G	T	5	6	11	0	2	13	0	0
13	12387658	.	G	A	6	8	14	0	0	14	0	0
13	12443656	.	C	T	1	1	2	0	0	2	0	0
13	12443951	.	C	T	2	5	7	0	0	7	0	0
13	12444014	.	T	C	0	2	2	0	0	2	0	0
13	12444218	.	A	T	0	0	0	0	1	1	0	0
13	12447952	.	T	C	1	5	6	0	0	6	0	0
13	12447961	.	A	C	1	4	5	0	0	5	0	0
13	12450980	.	G	T	8	6	14	0	1	15	0	0
13	12451397	.	T	C	4	3	7	0	0	7	0	0
13	12479382	.	C	A	3	5	8	0	0	8	0	0
13	12479490	.	G	A	11	12	23	0	2	25	0	0
13	12489232	.	G	A	2	3	5	0	1	6	0	0
13	12489360	.	A	G	3	3	6	0	0	6	0	0
13	12489553	.	T	A	0	2	2	0	0	2	0	0
13	12632260	.	A	G	0	0	0	0	2	2	0	0
13	12632946	.	T	A	5	9	14	0	1	15	0	0
13	12632967	.	T	C	3	9	12	0	0	12	0	0
13	12633014	.	C	G	4	9	13	0	1	14	0	0
13	12665126	.	A	G	2	6	8	4	0	12	0	0
13	12665189	.	T	C	1	0	1	0	5	6	0	0
13	12665328	.	C	A	2	4	6	0	0	6	0	0
13	12665411	.	T	A	3	4	7	0	0	7	0	0
13	12665546	.	T	C	6	6	12	0	0	12	0	0
13	12665587	.	C	T	0	11	11	0	5	16	0	0
13	12665595	.	T	C	6	5	11	0	1	12	0	0
13	12665704	.	T	C	5	5	10	0	1	11	0	0
13	12665859	.	A	T	1	1	2	0	1	3	0	0
13	12665863	.	C	T	1	2	3	0	1	4	0	0
13	12665963	.	A	G	5	3	8	0	0	8	0	0
13	12665990	.	C	A	8	7	15	0	2	17	0	0
13	12666017	.	T	C	10	1	11	0	11	22	0	0
13	12681150	.	T	C	1	4	5	0	0	5	0	0
13	12681188	.	C	A	1	5	6	0	0	6	0	0
13	12681315	.	A	G	2	3	5	0	1	6	0	0
13	12681716	.	T	C	2	3	5	0	0	5	0	0
13	12739444	.	G	T	4	5	9	0	0	9	0	0
13	12739555	.	A	G	4	4	8	0	0	8	0	0
13	12739630	.	C	G	8	0	8	0	4	12	0	0
13	12739894	.	T	A	4	5	9	0	0	9	0	0
13	12740113	.	A	T	4	6	10	0	0	10	0	0
13	12740263	.	T	G	9	0	9	0	8	17	0	0
13	12740566	.	A	G	6	11	17	0	1	18	0	0
13	12740599	.	C	T	6	9	15	0	3	18	0	0
13	12740674	.	G	A	4	13	17	0	0	17	0	0
13	12740782	.	C	T	6	12	18	0	2	20	0	0
13	12740794	.	G	A	2	14	16	0	10	26	0	0
13	12740971	.	T	G	15	12	27	0	0	27	0	0
13	12762350	.	G	A	2	3	5	0	0	5	0	0
13	12762978	.	C	T	2	2	4	0	0	4	0	0
13	12765738	.	T	G	2	1	3	0	0	3	0	0
13	12769359	.	A	G	1	0	1	0	5	6	0	0
13	12778091	.	C	T	5	3	8	0	0	8	0	0
13	12778840	.	T	C	2	2	4	0	0	4	0	0
13	12899383	.	C	T	1	3	4	0	0	4	0	0
13	12902958	.	C	T	3	2	5	0	0	5	0	0
13	12904726	.	G	A	1	4	5	0	0	5	0	0
13	12904744	.	G	T	1	5	6	0	0	6	0	0
13	12904840	.	C	A	1	3	4	0	0	4	0	0
13	12911146	.	A	C	4	7	11	0	0	11	0	0
13	12917382	.	C	T	1	3	4	0	0	4	0	0
13	12918191	.	T	C	3	3	6	0	0	6	0	0
13	12918194	.	T	C	3	3	6	0	0	6	0	0
13	12919196	.	C	T	4	3	7	0	0	7	0	0
13	12940138	.	C	T	4	3	7	0	0	7	0	0
13	12943630	.	G	A	1	2	3	0	0	3	0	0
13	12949644	.	A	G	1	0	1	0	2	3	0	0
13	12955278	.	T	C	6	4	10	0	0	10	0	0
13	12955413	.	C	T	2	0	2	0	0	2	0	0
13	12955615	.	T	C	6	7	13	0	0	13	0	0
13	12957817	.	G	A	3	7	10	0	2	12	0	0
13	12961126	.	T	A	9	10	19	0	0	19	0	0
13	12961141	.	C	T	6	9	15	0	0	15	0	0
13	12962979	.	G	A	0	1	1	0	2	3	0	0
13	12967432	.	G	C	9	14	23	0	0	23	0	0
13	12967438	.	C	T	8	12	20	0	0	20	0	0
13	12970797	.	C	T	10	10	20	0	1	21	0	0
13	12971757	.	A	C	11	16	27	0	2	29	0	0
13	12971763	.	A	G	10	1	11	0	22	33	0	0
13	12971856	.	G	A	1	3	4	0	0	4	0	0
13	12974602	.	A	G	2	2	4	0	1	5	0	0
13	12985114	.	C	T	17	20	37	0	2	39	0	0
13	12985193	.	T	A	21	15	36	1	0	37	0	0
13	12985376	.	G	A	1	15	16	0	19	35	0	0
13	12985822	.	T	G	12	5	17	1	0	18	0	0
13	12993928	.	C	T	7	3	10	0	0	10	0	0
13	12994364	.	A	G	7	9	16	0	1	17	0	0
13	12994395	.	A	G	4	7	11	0	2	13	0	0
13	12994738	.	A	T	12	7	19	0	2	21	0	0
13	12994801	.	A	G	9	6	15	0	0	15	0	0
13	12994802	.	G	T	9	5	14	0	1	15	0	0
13	12997845	.	C	T	4	5	9	0	1	10	0	0
13	12997966	.	A	G	3	2	5	0	0	5	0	0
13	12999701	.	G	T	2	2	4	0	0	4	0	0
13	13008910	.	C	T	0	1	1	0	0	1	0	0
13	13008939	.	C	T	0	2	2	0	0	2	0	0
13	13011804	.	A	G	1	1	2	0	0	2	0	0
13	13019277	.	C	G	2	3	5	0	0	5	0	0
13	13052481	.	A	C	2	2	4	0	0	4	0	0
13	13074974	.	T	G	3	0	3	0	2	5	0	0
13	13075034	.	T	C	1	0	1	0	0	1	0	0
13	13091046	.	C	A	1	4	5	0	0	5	0	0
13	13091079	.	T	C	4	10	14	0	0	14	0	0
13	13094050	.	T	A	2	2	4	0	1	5	0	0
13	13213678	.	A	G	7	10	17	0	0	17	0	0
13	13214412	.	G	A	12	13	25	0	3	28	0	0
13	13214462	.	T	A	8	19	27	0	0	27	0	0
13	13215426	.	T	G	3	2	5	0	0	5	0	0
13	13215474	.	C	T	1	3	4	0	0	4	0	0
13	13216092	.	G	A	5	3	8	0	0	8	0	0
13	13216251	.	G	A	5	5	10	0	1	11	0	0
13	13216964	.	A	G	5	2	7	0	0	7	0	0
13	13216968	.	T	G	7	2	9	0	0	9	0	0
13	13294762	.	A	C	1	5	6	0	0	6	0	0
13	13693781	.	A	T	7	5	12	0	0	12	0	0
13	13697957	.	G	A	0	1	1	0	1	2	0	0
13	13698411	.	T	C	2	1	3	0	0	3	0	0
13	13698433	.	T	C	5	2	7	0	0	7	0	0
13	13700335	.	A	C	1	0	1	0	0	1	0	0
13	13704011	.	T	G	3	0	3	0	0	3	0	0
13	13713106	.	C	G	3	3	6	0	0	6	0	0
13	13724919	.	T	A	2	1	3	0	0	3	0	0
13	13737474	.	G	C	18	10	28	0	3	31	0	0
13	13737514	.	A	G	27	1	28	0	17	45	0	0
13	13737524	.	G	A	27	21	48	0	1	49	0	0
13	13737612	.	G	C	2	10	12	0	30	43	1	0
13	13771020	.	G	A	2	2	4	0	0	4	0	0
13	13882367	.	A	C	1	1	2	0	0	2	0	0
13	13913140	.	G	C	1	1	2	0	0	2	0	0
13	13917991	.	C	T	8	4	12	0	1	13	0	0
13	13930343	.	C	T	0	2	2	0	0	2	0	0
13	13930392	.	G	A	0	2	2	0	0	2	0	0
13	13938461	.	G	A	0	1	1	0	2	3	0	0
13	13942151	.	T	C	4	3	7	0	0	7	0	0
13	13943234	.	A	T	4	2	6	0	0	6	0	0
13	13943238	.	C	A	4	2	6	0	0	6	0	0
13	13943372	.	C	A	4	3	7	0	0	7	0	0
13	13943959	.	T	C	11	10	21	0	0	21	0	0
13	13943983	.	A	G	11	9	20	0	0	20	0	0
13	13983073	.	G	A	0	3	3	0	0	3	0	0
13	13988647	.	G	A	2	1	3	0	0	3	0	0
13	13997101	.	C	T	6	3	9	0	0	9	0	0
13	13997299	.	C	T	8	7	15	0	0	15	0	0
13	13997446	.	G	T	0	4	4	0	1	5	0	0
13	13997481	.	T	C	1	3	4	0	0	4	0	0
13	13997545	.	G	A	1	2	3	0	0	3	0	0
13	13997829	.	G	A	1	3	4	0	0	4	0	0
13	13999082	.	G	A	1	0	1	0	0	1	0	0
13	14003099	.	A	G	3	6	9	0	0	9	0	0
13	14004161	.	T	C	5	8	13	0	1	14	0	0
13	14004209	.	C	T	5	8	13	0	0	13	0	0
13	14004276	.	C	T	7	8	15	0	0	15	0	0
13	14092489	.	C	T	1	0	1	0	0	1	0	0
13	14092573	.	G	A	3	3	6	0	0	6	0	0
13	14094441	.	G	A	3	3	6	0	0	6	0	0
13	14104076	.	T	C	1	1	2	0	0	2	0	0
13	14137061	.	C	T	2	0	2	0	1	3	0	0
13	14181750	.	C	T	11	7	18	0	0	18	0	0
13	14181952	.	T	C	9	8	17	0	1	18	0	0
13	14190780	.	C	T	0	13	13	0	21	34	0	0
13	14191033	.	T	C	17	9	26	0	1	27	0	0
13	14191045	.	G	C	15	7	22	0	0	22	0	0
13	14191528	.	A	G	17	13	30	0	0	30	0	0
13	14191553	.	A	G	25	3	28	0	2	30	0	0
13	14191724	.	G	A	14	12	26	0	4	30	0	0
13	14191769	.	T	C	22	15	37	0	3	40	0	0
13	14191797	.	A	G	22	9	31	0	1	32	0	0
13	14192110	.	T	C	7	11	18	0	1	19	0	0
13	14192131	.	G	A	6	14	20	0	0	20	0	0
13	14192178	.	A	T	6	15	21	0	0	21	0	0
13	14192414	.	A	G	10	5	15	0	0	15	0	0
13	14192448	.	A	C	8	8	16	0	0	16	0	0
13	14192506	.	G	A	4	5	9	0	1	10	0	0
13	14192511	.	A	T	5	6	11	0	0	11	0	0
13	14192561	.	G	T	6	7	13	0	0	13	0	0
13	14194055	.	C	G	5	3	8	0	1	9	0	0
13	14194109	.	C	G	6	3	9	0	0	9	0	0
13	14194110	.	C	A	6	3	9	0	0	9	0	0
13	14194484	.	C	T	10	11	21	0	1	22	0	0
13	14194571	.	G	A	8	6	14	0	0	14	0	0
13	14194573	.	C	A	8	5	13	0	1	14	0	0
13	14194611	.	T	G	8	10	18	0	0	18	0	0
13	14194660	.	G	A	11	13	24	0	0	24	0	0
13	14194904	.	T	C	11	7	18	0	1	19	0	0
13	14199190	.	A	G	3	9	12	0	2	14	0	0
13	14220900	.	G	A	4	5	9	0	1	10	0	0
13	14251280	.	C	T	0	3	3	0	4	7	0	0
13	14902500	.	C	A	3	11	14	0	1	15	0	0
13	14902507	.	T	C	2	11	13	0	0	13	0	0
13	14902546	.	C	T	3	11	14	0	0	14	0	0
13	14902702	.	G	A	2	1	3	0	0	3	0	0
13	14906587	.	G	C	6	10	16	0	1	17	0	0
13	14906614	.	G	A	5	9	14	0	0	14	0	0
13	14906754	.	A	G	2	3	5	0	0	6	1	0
13	14908880	.	A	G	4	5	9	0	0	9	0	0
13	14908903	.	T	C	4	3	7	0	0	7	0	0
13	14919111	.	C	T	2	4	6	0	0	6	0	0
13	15109657	.	T	G	2	2	4	0	1	5	0	0
13	15194555	.	C	T	3	2	5	0	0	5	0	0
13	15211952	.	T	C	1	4	5	0	0	5	0	0
13	15212395	.	G	T	2	5	7	0	0	7	0	0
13	15212460	.	G	C	0	2	2	0	3	5	0	0
13	15212611	.	A	G	1	5	6	0	0	6	0	0
13	15212962	.	T	A	5	3	8	0	0	8	0	0
13	15213130	.	A	T	5	5	10	0	1	11	0	0
13	15213237	.	C	A	3	3	6	0	0	6	0	0
13	15215789	.	A	T	8	18	26	0	2	28	0	0
13	15580864	.	T	A	9	12	21	0	2	23	0	0
13	15580879	.	T	G	8	0	8	0	14	22	0	0
13	15580948	.	G	T	8	7	15	0	1	16	0	0
13	15647444	.	A	G	7	8	15	0	1	16	0	0
13	15657987	.	A	G	24	24	48	0	1	49	0	0
13	15668124	.	A	T	8	7	15	0	0	15	0	0
13	15725311	.	A	T	3	1	4	0	1	5	0	0
13	15762306	.	T	C	1	0	1	0	3	4	0	0
13	15762515	.	T	C	3	5	8	0	1	9	0	0
13	15762639	.	C	T	3	2	5	0	0	5	0	0
13	15763061	.	G	T	3	7	10	0	0	10	0	0
13	15763233	.	T	C	1	0	1	0	6	7	0	0
13	15763273	.	T	C	3	5	8	0	0	8	0	0
13	15763733	.	T	C	1	5	6	0	1	7	0	0
13	15800977	.	T	G	1	6	7	0	0	7	0	0
13	15801705	.	T	A	2	1	3	0	0	3	0	0
13	15801726	.	T	C	6	2	8	0	0	8	0	0
13	15814429	.	A	G	8	8	16	0	0	16	0	0
13	15814724	.	T	A	4	5	9	0	0	9	0	0
13	15816637	.	G	A	14	8	22	0	0	22	0	0
13	15848817	.	A	G	8	16	24	0	0	24	0	0
13	15848895	.	C	T	9	6	15	0	0	15	0	0
13	15849541	.	T	C	3	3	6	0	0	6	0	0
13	15869322	.	A	G	5	2	7	0	0	7	0	0
13	15872256	.	A	G	10	14	24	0	2	26	0	0
13	15882860	.	A	C	17	17	34	0	3	37	0	0
13	15897090	.	C	T	1	4	5	0	0	5	0	0
13	15897108	.	A	G	1	4	5	0	0	5	0	0
13	15897141	.	A	G	1	4	5	0	0	5	0	0
13	15928805	.	T	C	0	2	2	0	0	2	0	0
13	15929049	.	A	G	0	3	3	0	0	3	0	0
13	15929121	.	C	A	0	2	2	0	3	5	0	0
13	15929308	.	C	A	1	2	3	0	0	3	0	0
13	16186182	.	G	A	6	8	14	0	2	16	0	0
13	16186209	.	T	C	6	0	6	0	10	16	0	0
13	16186744	.	T	A	3	1	4	0	0	4	0	0
13	16186746	.	G	T	3	1	4	0	0	4	0	0
13	16191517	.	A	T	3	2	5	0	4	9	0	0
13	16191580	.	A	G	5	6	11	0	0	11	0	0
13	16191635	.	A	T	4	3	7	0	1	8	0	0
13	16300653	.	G	A	2	4	6	0	0	6	0	0
13	16300670	.	T	C	2	5	7	0	0	7	0	0
13	16311465	.	A	G	1	1	2	0	0	2	0	0
13	16313525	.	G	C	1	2	3	0	0	3	0	0
13	16326333	.	G	T	1	2	3	0	0	3	0	0
13	16326494	.	C	T	1	2	3	0	0	3	0	0
13	16413293	.	C	T	2	3	5	0	0	5	0	0
13	16420480	.	T	A	0	3	3	0	0	3	0	0
13	16425241	.	C	T	2	2	4	0	0	4	0	0
13	16425350	.	T	C	0	1	1	0	0	1	0	0
13	16436353	.	C	T	3	3	6	0	0	6	0	0
13	16436524	.	A	G	2	4	6	0	1	7	0	0
13	16436786	.	T	C	4	5	9	0	0	9	0	0
13	16474382	.	A	G	4	0	4	0	2	6	0	0
13	16479914	.	T	A	5	5	10	0	0	10	0	0
13	16496254	.	T	C	9	7	16	0	0	16	0	0
13	16496770	.	T	A	11	12	23	0	0	23	0	0
13	16522533	.	C	G	2	2	4	0	0	4	0	0
13	16809610	.	T	C	2	1	3	0	0	3	0	0
13	16855387	.	C	A	4	2	6	0	1	7	0	0
13	16856045	.	T	A	12	5	17	0	0	17	0	0
13	16871830	.	A	C	5	6	11	0	0	11	0	0
13	16876825	.	C	T	1	0	1	0	0	1	0	0
13	16878895	.	A	C	13	10	23	0	2	25	0	0
13	16886040	.	C	T	8	15	23	0	2	25	0	0
13	16886068	.	C	T	10	7	17	0	0	17	0	0
13	17702657	.	C	T	3	3	6	0	0	6	0	0
13	17702802	.	C	T	5	5	10	0	1	11	0	0
13	17703097	.	A	G	6	0	6	0	4	10	0	0
13	17703453	.	T	A	7	3	10	0	1	11	0	0
13	17703454	.	C	A	8	3	11	0	0	11	0	0
13	17703548	.	C	T	1	4	5	0	1	6	0	0
13	17703557	.	G	C	0	4	4	0	2	6	0	0
13	17705633	.	C	T	1	5	6	0	0	6	0	0
13	17705669	.	C	T	5	3	8	0	0	8	0	0
13	17705681	.	C	T	2	2	4	0	2	6	0	0
13	17714510	.	G	T	13	32	45	0	3	49	1	0
13	17714530	.	C	A	28	16	44	0	6	50	0	0
13	17714881	.	C	T	21	17	38	0	2	40	0	0
13	17714905	.	T	C	20	17	37	0	1	38	0	0
13	17752932	.	A	T	5	9	14	0	0	14	0	0
13	17752993	.	C	A	6	6	12	0	0	12	0	0
13	17754275	.	G	T	9	3	12	0	0	12	0	0
13	17754315	.	C	T	5	2	7	0	0	7	0	0
13	17754571	.	C	G	3	4	7	0	0	7	0	0
13	17754897	.	C	T	0	4	4	0	9	13	0	0
13	17755618	.	T	C	6	6	12	0	0	12	0	0
13	17755743	.	G	A	7	3	10	0	1	11	0	0
13	17755898	.	G	A	5	14	19	0	0	19	0	0
13	17755980	.	G	A	6	1	7	0	0	7	0	0
13	17756043	.	G	A	5	7	12	0	0	12	0	0
13	17943175	.	G	T	3	2	5	0	0	5	0	0
13	18019724	.	T	C	1	7	8	0	0	8	0	0
13	18019758	.	C	T	0	9	9	0	1	10	0	0
13	18032872	.	C	T	0	9	9	0	6	15	0	0
13	18032941	.	A	G	4	4	8	0	0	8	0	0
13	18032960	.	G	A	3	4	7	0	1	8	0	0
13	18033053	.	A	G	3	6	9	0	0	9	0	0
13	18033405	.	T	C	4	7	11	0	0	11	0	0
13	18038643	.	G	A	1	1	2	0	0	2	0	0
13	18046258	.	G	A	1	2	3	0	0	3	0	0
13	18064397	.	G	A	1	2	3	0	0	3	0	0
13	18073433	.	A	G	15	15	30	0	0	30	0	0
13	18073460	.	C	T	12	13	25	0	0	25	0	0
13	18073557	.	C	A	4	7	11	0	1	12	0	0
13	18073706	.	G	A	7	10	17	0	1	18	0	0
13	18076710	.	T	G	4	4	8	0	0	8	0	0
13	18076722	.	G	T	4	7	11	0	0	11	0	0
13	18076818	.	G	A	8	12	20	0	0	20	0	0
13	18077056	.	G	T	14	10	24	0	2	26	0	0
13	18077116	.	G	A	15	12	27	0	0	27	0	0
13	18077206	.	C	T	10	11	21	0	1	22	0	0
13	18083415	.	G	A	2	4	6	0	1	7	0	0
13	18087918	.	G	A	2	0	2	0	0	2	0	0
13	18088276	.	T	G	4	8	12	0	0	12	0	0
13	18088283	.	C	T	0	3	3	0	7	10	0	0
13	18092062	.	G	T	1	0	1	0	0	1	0	0
13	18102984	.	A	G	1	1	2	0	0	2	0	0
13	18104890	.	C	T	2	0	2	0	0	2	0	0
13	18105007	.	A	G	1	1	2	0	0	2	0	0
13	18105136	.	C	A	0	0	0	0	3	3	0	0
13	18105175	.	G	A	2	3	5	0	0	5	0	0
13	18105382	.	A	G	1	1	2	0	0	2	0	0
13	18109897	.	T	C	0	0	0	0	1	1	0	0
13	18110003	.	T	C	0	0	0	0	1	1	0	0
13	18113387	.	G	T	0	2	2	0	0	2	0	0
13	18114994	.	A	G	1	2	3	0	0	3	0	0
13	18179500	.	G	C	7	3	10	0	0	10	0	0
13	18179733	.	T	A	13	16	29	0	0	29	0	0
13	18179859	.	C	A	8	23	31	0	3	34	0	0
13	18195926	.	G	A	2	2	4	0	1	5	0	0
13	18274914	.	A	C	2	2	4	0	0	4	0	0
13	18276338	.	G	T	0	2	2	0	1	3	0	0
13	18295212	.	C	T	1	3	4	0	0	4	0	0
13	18295468	.	C	T	2	3	5	0	0	5	0	0
13	18321156	.	T	C	2	5	7	0	0	7	0	0
13	18323464	.	A	G	7	4	11	0	4	15	0	0
13	18323595	.	G	A	0	11	11	0	9	20	0	0
13	18323653	.	A	G	11	0	11	0	11	22	0	0
13	18323787	.	T	A	14	10	24	0	4	28	0	0
13	18358680	.	G	A	4	5	9	0	0	9	0	0
13	18358890	.	G	C	17	14	31	0	0	31	0	0
13	18359112	.	G	C	14	15	29	0	1	30	0	0
13	18359176	.	C	A	22	13	35	0	1	36	0	0
13	18359202	.	C	T	19	11	30	0	0	30	0	0
13	18359304	.	A	T	1	19	20	0	1	21	0	0
13	18359507	.	A	T	12	13	25	0	1	26	0	0
13	18359551	.	T	C	10	5	15	0	0	15	0	0
13	18359554	.	A	G	10	5	15	0	0	15	0	0
13	18371294	.	C	G	1	2	3	0	0	3	0	0
13	18375465	.	C	A	1	4	5	0	0	5	0	0
13	18375512	.	T	A	1	1	2	0	0	2	0	0
13	18382192	.	T	C	6	5	11	0	0	11	0	0
13	18394755	.	T	A	3	7	10	0	0	10	0	0
13	18397416	.	G	C	2	3	5	0	0	5	0	0
13	18409776	.	T	A	10	4	14	0	0	14	0	0
13	18410799	.	G	C	0	3	3	0	1	4	0	0
13	18418390	.	C	T	0	2	2	0	0	2	0	0
13	18418528	.	G	A	1	2	3	0	0	3	0	0
13	18428103	.	A	G	6	7	13	0	0	13	0	0
13	18431301	.	C	T	6	7	13	0	0	13	0	0
13	18431430	.	C	T	4	3	7	0	1	8	0	0
13	18434085	.	C	T	0	1	1	0	0	1	0	0
13	18434150	.	T	C	2	2	4	0	1	5	0	0
13	18434427	.	C	T	6	7	13	0	0	13	0	0
13	18434519	.	C	A	7	7	14	0	0	14	0	0
13	18434520	.	G	C	0	7	7	0	7	14	0	0
13	18434570	.	C	G	10	8	18	0	1	19	0	0
13	18434615	.	A	G	14	0	14	0	10	24	0	0
13	18434794	.	C	A	9	10	19	0	1	20	0	0
13	18434902	.	C	T	5	12	17	0	2	19	0	0
13	18434957	.	G	A	9	5	14	0	0	14	0	0
13	18434962	.	A	G	8	3	11	0	0	11	0	0
13	18499590	.	A	C	1	2	3	0	0	3	0	0
13	18499660	.	C	T	0	2	2	0	0	2	0	0
13	18499747	.	C	T	3	4	7	0	0	7	0	0
13	18499773	.	A	T	3	4	7	0	1	8	0	0
13	18503647	.	C	T	3	3	6	0	0	6	0	0
13	18507715	.	A	C	2	4	6	0	0	6	0	0
13	18509592	.	G	A	1	11	12	0	7	19	0	0
13	18510033	.	C	G	13	0	13	0	8	21	0	0
13	18510204	.	T	C	12	11	23	0	0	23	0	0
13	18510324	.	A	G	11	7	18	0	0	18	0	0
13	18511023	.	C	T	10	11	21	0	1	22	0	0
13	18511140	.	A	G	18	0	18	0	14	32	0	0
13	18511637	.	A	C	6	12	18	0	4	22	0	0
13	18512082	.	C	G	19	11	30	0	2	32	0	0
13	18663156	.	G	A	0	3	3	0	3	6	0	0
13	18669200	.	G	T	15	16	31	0	2	34	1	0
13	18669571	.	T	A	6	2	8	0	0	8	0	0
13	18680027	.	G	A	7	6	13	0	0	13	0	0
13	18685673	.	G	A	2	2	4	0	0	4	0	0
13	18689043	.	C	T	8	7	15	0	1	16	0	0
13	18801566	.	G	A	8	6	14	0	0	14	0	0
13	18801615	.	G	A	3	4	7	0	0	8	1	0
13	19304688	.	A	G	15	11	26	0	1	27	0	0
13	19316930	.	G	C	13	16	29	0	1	30	0	0
13	19317016	.	T	A	8	9	17	0	0	17	0	0
13	19317018	.	C	G	7	8	15	0	2	17	0	0
13	19317051	.	T	G	10	7	17	0	0	17	0	0
13	19317499	.	G	C	9	5	14	0	0	14	0	0
13	19610625	.	C	T	0	4	4	0	1	5	0	0
13	19610772	.	C	T	0	0	0	0	2	2	0	0
13	19627150	.	A	G	3	9	12	0	0	12	0	0
13	19629032	.	G	T	0	1	1	0	0	1	0	0
13	19629266	.	C	G	2	4	6	0	0	6	0	0
13	19639198	.	A	G	1	3	4	0	0	4	0	0
13	19639205	.	G	A	1	3	4	0	1	5	0	0
13	19639238	.	T	C	3	2	5	0	0	5	0	0
13	19639256	.	T	C	2	0	2	0	4	6	0	0
13	19768396	.	G	T	7	8	15	0	3	18	0	0
13	19799192	.	A	G	2	2	4	0	0	4	0	0
13	19799467	.	G	A	10	7	17	0	1	18	0	0
13	19799611	.	C	A	0	14	14	0	10	24	0	0
13	19799623	.	T	C	11	8	19	0	2	21	0	0
13	19799646	.	C	A	0	9	9	0	9	18	0	0
13	20392670	.	G	C	12	1	13	0	12	25	0	0
13	20392704	.	G	A	10	10	20	0	1	21	0	0
13	20392714	.	G	T	9	7	16	0	1	17	0	0
13	20392752	.	G	A	5	2	7	0	1	8	0	0
13	20392788	.	A	G	2	0	2	0	0	2	0	0
13	20401263	.	C	A	0	5	5	0	14	19	0	0
13	20401267	.	T	C	5	13	18	0	3	21	0	0
13	20401392	.	C	T	16	13	29	0	1	30	0	0
13	20425191	.	A	G	6	5	11	0	1	12	0	0
13	20425396	.	C	T	0	7	7	0	5	12	0	0
13	20518608	.	A	T	1	1	2	0	1	3	0	0
13	20518620	.	C	T	0	1	1	0	2	3	0	0
13	20518757	.	G	A	3	3	6	0	0	6	0	0
13	21638955	.	C	A	2	4	6	0	1	7	0	0
13	21639011	.	G	C	3	1	4	0	0	4	0	0
13	21677961	.	G	A	1	0	1	0	0	1	0	0
13	21680844	.	A	T	1	1	2	0	0	2	0	0
13	21683057	.	A	C	4	6	10	0	0	10	0	0
13	21683546	.	C	T	12	18	30	0	2	32	0	0
13	21683636	.	G	A	13	19	32	0	1	33	0	0
13	21683762	.	C	T	0	14	14	0	18	32	0	0
13	21683928	.	G	A	18	18	36	0	2	38	0	0
13	21689373	.	G	A	2	2	4	0	0	4	0	0
13	21689530	.	A	T	10	7	17	0	0	17	0	0
13	21689883	.	T	G	6	13	19	0	1	20	0	0
13	21689982	.	G	A	2	5	7	0	0	7	0	0
13	21690053	.	T	A	5	2	7	0	0	7	0	0
13	21690055	.	A	G	2	5	7	0	0	7	0	0
13	21690104	.	C	T	0	8	8	0	9	17	0	0
13	21690229	.	A	C	2	10	12	1	0	13	0	0
13	21690507	.	T	A	9	14	23	0	2	25	0	0
13	21690877	.	A	C	8	0	8	0	6	14	0	0
13	21691324	.	G	A	2	4	6	1	0	7	0	0
13	21691386	.	G	A	4	4	8	0	0	8	0	0
13	21691671	.	G	A	5	5	10	0	0	10	0	0
13	21691695	.	T	A	9	5	14	0	0	14	0	0
13	21691787	.	C	G	7	11	18	0	1	19	0	0
13	21691843	.	G	A	10	4	14	0	1	15	0	0
13	21691935	.	A	G	8	8	16	0	0	16	0	0
13	21692084	.	T	A	6	5	11	0	1	12	0	0
13	21692085	.	C	A	7	5	12	0	0	12	0	0
13	21692328	.	C	A	4	5	9	0	1	10	0	0
13	21692338	.	C	T	6	6	12	0	1	13	0	0
13	21712507	.	G	A	10	17	27	0	2	29	0	0
13	21712526	.	G	A	7	13	20	0	1	21	0	0
13	21712755	.	G	C	4	3	7	0	0	7	0	0
13	21716581	.	T	C	1	1	2	0	0	2	0	0
13	21723323	.	G	A	4	7	11	0	0	11	0	0
13	21727796	.	T	A	1	2	3	0	0	3	0	0
13	21735278	.	C	T	0	2	2	0	0	2	0	0
13	21818812	.	C	T	1	2	3	0	0	3	0	0
13	21819997	.	G	A	4	2	6	0	0	6	0	0
13	21821299	.	G	T	1	3	4	0	0	4	0	0
13	21821393	.	A	C	2	2	4	0	0	4	0	0
13	21852008	.	G	A	0	4	4	0	3	7	0	0
13	21855829	.	G	A	2	3	5	0	1	6	0	0
13	21856576	.	A	T	5	4	9	0	0	9	0	0
13	21856741	.	G	A	4	2	6	0	0	6	0	0
13	21856849	.	G	A	0	2	2	0	2	4	0	0
13	21860027	.	T	A	0	1	1	0	0	1	0	0
13	21860111	.	G	A	1	2	3	0	0	3	0	0
13	21861775	.	A	C	1	4	5	0	0	5	0	0
13	21861777	.	G	A	1	4	5	0	0	5	0	0
13	21862288	.	T	A	1	1	2	0	0	2	0	0
13	21866052	.	C	T	7	9	16	0	0	16	0	0
13	21866324	.	C	T	0	1	1	0	0	1	0	0
13	21866357	.	A	C	3	2	5	0	0	5	0	0
13	21870319	.	G	C	12	5	17	0	0	17	0	0
13	21870323	.	T	C	12	4	16	0	0	16	0	0
13	21870374	.	G	A	0	11	11	0	13	24	0	0
13	21870467	.	G	C	0	13	13	0	14	27	0	0
13	21870575	.	A	G	11	2	13	0	18	31	0	0
13	21870608	.	A	T	10	13	23	0	1	24	0	0
13	21870629	.	C	T	7	8	15	0	2	17	0	0
13	21874107	.	C	T	7	3	10	0	0	10	0	0
13	21874128	.	G	T	6	13	19	0	0	19	0	0
13	21874149	.	G	T	0	6	6	0	18	24	0	0
13	21884298	.	C	T	17	14	31	0	0	31	0	0
13	21884407	.	T	C	11	11	22	0	0	22	0	0
13	21884408	.	C	T	11	11	22	0	0	22	0	0
13	21884467	.	C	T	14	10	24	0	0	24	0	0
13	21884979	.	T	C	8	9	17	0	1	18	0	0
13	21884980	.	C	T	8	9	17	0	1	18	0	0
13	21885250	.	C	T	17	23	40	0	3	43	0	0
13	22065089	.	G	A	4	1	5	0	1	6	0	0
13	22065148	.	G	A	1	3	4	0	2	6	0	0
13	22065631	.	A	G	1	7	8	0	0	8	0	0
13	22065904	.	T	G	3	2	5	0	0	5	0	0
13	22084034	.	C	T	3	4	7	0	1	8	0	0
13	22087988	.	C	T	10	6	16	0	1	17	0	0
13	22088061	.	T	G	3	0	3	0	9	12	0	0
13	22094800	.	T	C	6	11	17	0	1	18	0	0
13	22094871	.	T	G	6	20	26	0	1	27	0	0
13	22095340	.	C	T	15	10	25	0	0	25	0	0
13	22095589	.	G	A	1	7	8	0	0	8	0	0
13	22095594	.	T	A	1	6	7	0	0	7	0	0
13	22119935	.	T	C	2	0	2	0	0	2	0	0
13	22206667	.	A	T	6	1	7	0	0	7	0	0
13	22238209	.	T	C	16	18	34	0	0	34	0	0
13	22238233	.	G	A	17	17	34	0	0	34	0	0
13	22241027	.	G	A	20	25	45	0	1	46	0	0
13	22241123	.	G	T	0	9	9	0	19	29	1	0
13	22241374	.	A	C	22	16	38	0	2	40	0	0
13	22241482	.	G	C	10	12	22	0	1	23	0	0
13	22241648	.	T	G	25	17	42	0	3	45	0	0
13	22241821	.	T	C	22	11	33	0	1	34	0	0
13	22242394	.	C	G	25	19	44	0	1	45	0	0
13	22242837	.	T	G	31	19	50	0	2	52	0	0
13	22317347	.	A	G	1	0	1	0	0	1	0	0
13	22357105	.	C	A	2	0	2	0	0	2	0	0
13	22357823	.	C	T	3	3	6	0	1	7	0	0
13	22357850	.	A	G	1	0	1	0	2	3	0	0
13	22358021	.	A	G	2	5	7	0	1	8	0	0
13	22358174	.	G	A	0	0	0	0	1	1	0	0
13	22361332	.	G	A	5	6	11	0	0	11	0	0
13	22361718	.	A	C	3	1	4	0	0	4	0	0
13	22364908	.	T	C	6	12	18	0	0	18	0	0
13	22365016	.	C	T	17	9	26	0	1	27	0	0
13	22365404	.	C	T	7	10	17	0	1	18	0	0
13	22365461	.	A	G	4	10	14	0	1	15	0	0
13	22367600	.	C	A	0	7	7	0	0	7	0	0
13	22369295	.	T	C	4	11	15	0	0	15	0	0
13	22372075	.	T	C	14	18	32	0	0	32	0	0
13	22372154	.	T	C	15	17	32	0	1	33	0	0
13	22372175	.	A	G	14	16	30	0	1	31	0	0
13	22372205	.	A	G	17	13	30	0	2	32	0	0
13	22372737	.	C	T	5	9	14	0	0	14	0	0
13	22372932	.	G	T	8	5	13	0	0	13	0	0
13	22373241	.	G	A	1	11	12	0	12	24	0	0
13	22373336	.	C	A	13	15	28	0	1	29	0	0
13	22373931	.	C	T	12	4	16	0	2	18	0	0
13	22373940	.	A	G	13	3	16	0	1	17	0	0
13	22555865	.	C	A	2	2	4	0	0	4	0	0
13	22617941	.	G	A	2	4	6	0	0	6	0	0
13	22618393	.	T	A	5	2	7	0	0	7	0	0
13	22618689	.	G	A	3	2	5	0	0	6	1	0
13	22659195	.	C	G	12	1	13	0	18	31	0	0
13	22672354	.	A	T	7	4	11	0	0	11	0	0
13	22672791	.	C	G	16	7	23	0	0	23	0	0
13	22672825	.	T	C	20	0	20	0	1	21	0	0
13	22672833	.	T	A	19	0	19	0	0	19	0	0
13	22672952	.	G	A	4	11	15	0	1	16	0	0
13	22673006	.	A	C	3	7	10	0	2	12	0	0
13	22673068	.	A	T	3	11	14	0	1	15	0	0
13	22677464	.	A	T	0	2	2	0	0	2	0	0
13	22679537	.	C	G	4	3	7	0	0	7	0	0
13	22679837	.	G	A	0	5	5	0	0	5	0	0
13	22705172	.	G	C	1	2	3	0	0	3	0	0
13	22705687	.	G	A	1	2	3	0	0	3	0	0
13	22712466	.	C	T	1	3	4	0	0	4	0	0
13	22735063	.	T	C	5	8	13	0	0	13	0	0
13	22735139	.	A	G	8	9	17	0	1	18	0	0
13	22742791	.	G	A	6	2	8	0	1	9	0	0
13	22744359	.	A	G	8	9	17	0	0	17	0	0
13	22867888	.	G	A	0	2	2	0	4	6	0	0
13	22867910	.	A	G	6	3	9	0	0	9	0	0
13	22867953	.	G	T	9	3	12	0	0	12	0	0
13	22868017	.	G	A	1	0	1	0	0	1	0	0
13	22871900	.	C	A	3	3	6	0	0	6	0	0
13	22871989	.	A	G	2	3	5	0	0	5	0	0
13	22872256	.	T	A	2	2	4	0	0	4	0	0
13	22872266	.	A	C	3	1	4	0	0	4	0	0
13	22872862	.	A	G	1	2	3	0	0	3	0	0
13	22872960	.	A	T	4	2	6	0	0	6	0	0
13	22873022	.	C	T	2	2	4	0	1	5	0	0
13	22873030	.	G	T	2	3	5	0	0	5	0	0
13	22876576	.	T	C	7	0	7	0	9	16	0	0
13	22876623	.	G	A	6	8	14	0	0	14	0	0
13	22876678	.	A	T	4	8	12	0	1	13	0	0
13	22877076	.	C	T	7	14	21	0	2	23	0	0
13	22877130	.	G	T	13	26	39	0	0	39	0	0
13	22878754	.	G	A	2	2	4	0	0	4	0	0
13	22879149	.	A	T	4	6	10	0	0	10	0	0
13	22890835	.	A	C	17	0	17	0	6	23	0	0
13	22898042	.	A	G	1	5	6	0	1	7	0	0
13	22900733	.	G	A	3	10	13	0	0	13	0	0
13	22900742	.	A	T	2	8	10	0	0	10	0	0
13	22902882	.	A	C	3	4	7	0	0	7	0	0
13	22902987	.	G	A	8	14	22	0	0	22	0	0
13	22965088	.	C	T	1	3	4	0	0	4	0	0
13	22970688	.	T	C	2	5	7	0	0	7	0	0
13	22970750	.	T	C	2	5	7	0	0	7	0	0
13	22973314	.	A	G	27	32	59	0	0	59	0	0
13	22973348	.	A	G	29	20	49	0	2	51	0	0
13	22973531	.	T	C	27	0	27	0	26	53	0	0
13	22973895	.	A	G	27	19	46	0	8	54	0	0
13	22974033	.	A	G	25	21	46	0	1	47	0	0
13	22974108	.	C	T	12	7	19	0	1	20	0	0
13	22976067	.	C	A	19	16	35	0	2	37	0	0
13	22976070	.	G	A	20	16	36	0	1	37	0	0
13	22976383	.	T	C	3	0	3	0	11	14	0	0
13	22977283	.	G	A	6	13	19	0	0	19	0	0
13	22977319	.	A	G	15	19	34	0	1	35	0	0
13	22977343	.	A	G	13	17	30	0	0	30	0	0
13	22978059	.	T	C	7	0	7	0	7	14	0	0
13	22978062	.	G	A	6	7	13	0	1	14	0	0
13	22983106	.	A	G	3	3	6	0	0	6	0	0
13	22983109	.	A	G	3	3	6	0	0	6	0	0
13	23002697	.	G	A	0	2	2	0	0	2	0	0
13	23037831	.	C	A	5	6	11	0	1	12	0	0
13	23042321	.	A	G	0	1	1	0	0	1	0	0
13	23042387	.	C	G	5	4	9	0	0	9	0	0
13	23042676	.	A	G	7	4	11	0	0	11	0	0
13	23042745	.	G	A	9	6	15	0	0	15	0	0
13	23042929	.	G	T	2	0	2	0	0	2	0	0
13	23043112	.	T	C	2	3	5	0	0	5	0	0
13	23043117	.	A	G	2	3	5	0	0	5	0	0
13	23045229	.	G	A	7	4	11	0	0	11	0	0
13	23058975	.	G	A	4	2	6	0	5	11	0	0
13	23064735	.	T	C	0	0	0	0	1	1	0	0
13	23070787	.	C	T	3	4	7	0	0	7	0	0
13	23070895	.	T	C	9	10	19	0	0	19	0	0
13	23070994	.	A	G	4	2	6	0	0	6	0	0
13	23084177	.	C	G	15	11	26	1	0	27	0	0
13	23084841	.	G	C	8	12	20	0	0	20	0	0
13	23090190	.	A	C	11	8	19	0	1	20	0	0
13	23094356	.	T	C	3	0	3	0	6	9	0	0
13	23094895	.	G	T	13	6	19	0	1	20	0	0
13	23117009	.	A	G	2	1	3	0	0	3	0	0
13	23128675	.	A	G	1	0	1	0	4	5	0	0
13	23128685	.	A	G	1	4	5	0	0	5	0	0
13	23169172	.	G	T	1	2	3	0	0	3	0	0
13	23204849	.	A	C	1	5	6	0	0	6	0	0
13	23212821	.	A	G	0	2	2	0	0	2	0	0
13	23222899	.	A	T	1	3	4	0	0	4	0	0
13	23223122	.	A	G	2	5	7	0	0	7	0	0
13	23223422	.	G	A	5	3	8	0	0	8	0	0
13	23223428	.	C	T	6	4	10	0	0	10	0	0
13	23223469	.	T	A	5	5	10	0	1	11	0	0
13	23223486	.	C	T	4	5	9	0	1	10	0	0
13	23223675	.	C	A	3	6	9	0	1	10	0	0
13	23223699	.	A	G	2	0	2	0	5	7	0	0
13	23223875	.	C	A	2	6	8	0	0	8	0	0
13	23224087	.	G	A	4	10	14	0	0	14	0	0
13	23224113	.	A	T	5	7	12	0	0	12	0	0
13	23224360	.	A	G	8	5	13	0	0	13	0	0
13	23224363	.	T	G	8	5	13	0	0	13	0	0
13	23224470	.	G	A	12	5	17	0	1	18	0	0
13	23224605	.	G	T	13	6	19	0	3	22	0	0
13	23224727	.	C	T	6	12	18	0	1	19	0	0
13	23224735	.	A	G	7	11	18	0	1	19	0	0
13	23224821	.	T	A	7	14	21	0	1	22	0	0
13	23224860	.	T	A	13	13	26	0	1	27	0	0
13	23225541	.	T	C	17	11	28	0	1	29	0	0
13	23225776	.	T	A	15	6	21	0	2	23	0	0
13	23226114	.	G	A	0	13	13	0	14	27	0	0
13	23226213	.	A	C	12	8	20	0	0	20	0	0
13	23234398	.	C	T	2	3	5	0	0	5	0	0
13	23234499	.	A	G	2	1	3	0	1	4	0	0
13	23314904	.	T	G	6	5	11	0	1	12	0	0
13	23382393	.	G	A	5	3	8	0	0	8	0	0
13	23387252	.	T	C	7	9	16	0	0	16	0	0
13	23669773	.	C	T	3	2	5	0	0	5	0	0
13	23669870	.	T	G	1	2	3	0	0	3	0	0
13	23675183	.	C	T	7	9	16	0	0	16	0	0
13	23675351	.	T	G	3	0	3	0	3	6	0	0
13	23675354	.	A	T	3	2	5	0	0	5	0	0
13	23675510	.	T	C	5	2	7	0	0	7	0	0
13	23675892	.	G	C	0	6	6	0	6	12	0	0
13	23676856	.	G	A	0	2	2	0	1	3	0	0
13	23676913	.	C	A	5	6	11	0	0	11	0	0
13	23678001	.	G	A	0	3	3	0	4	7	0	0
13	23679888	.	G	A	3	5	8	0	1	9	0	0
13	23685075	.	G	A	4	1	5	0	0	5	0	0
13	23692515	.	C	T	10	11	21	0	1	22	0	0
13	23692572	.	C	T	3	4	7	0	0	7	0	0
13	23703048	.	G	C	10	10	20	0	0	20	0	0
13	23703053	.	T	C	10	10	20	0	1	21	0	0
13	23709532	.	C	T	4	5	9	0	1	10	0	0
13	23709562	.	T	C	9	16	25	0	0	25	0	0
13	23709592	.	A	G	14	17	31	0	2	33	0	0
13	23711937	.	G	A	10	10	20	0	1	21	0	0
13	23728490	.	T	A	4	5	9	0	0	9	0	0
13	23731501	.	T	A	1	1	2	0	0	2	0	0
13	23731944	.	C	A	1	2	3	0	1	4	0	0
13	23843742	.	C	T	1	2	3	0	0	3	0	0
13	23876610	.	A	G	0	0	0	0	3	3	0	0
13	23876697	.	T	C	2	4	6	0	0	6	0	0
13	23876865	.	C	T	1	3	4	0	0	4	0	0
13	23882629	.	T	C	2	2	4	0	0	4	0	0
13	23882686	.	C	T	4	3	7	0	0	7	0	0
13	23882946	.	A	G	3	1	4	0	0	4	0	0
13	23898045	.	T	G	6	8	14	0	0	14	0	0
13	23901334	.	C	T	9	15	24	0	1	25	0	0
13	23901349	.	T	C	10	15	25	0	0	25	0	0
13	23901502	.	A	G	14	15	29	0	0	29	0	0
13	23901555	.	A	G	9	0	9	0	9	18	0	0
13	23901570	.	T	C	10	11	21	0	1	22	0	0
13	23920791	.	A	G	1	0	1	0	0	1	0	0
13	23931192	.	T	C	8	0	8	0	7	15	0	0
13	23940708	.	T	C	2	1	3	0	6	9	0	0
13	23940754	.	C	A	2	9	11	0	0	11	0	0
13	23990189	.	C	A	1	3	4	0	0	4	0	0
13	23999129	.	G	A	2	4	6	0	0	6	0	0
13	23999264	.	G	C	1	1	2	0	0	2	0	0
13	23999274	.	T	A	1	3	4	0	0	4	0	0
13	24010630	.	C	T	2	2	4	0	0	4	0	0
13	24010663	.	A	G	1	2	3	0	0	3	0	0
13	24034092	.	T	G	3	2	5	0	0	5	0	0
13	24034158	.	A	G	7	5	12	0	0	12	0	0
13	24034206	.	A	G	3	3	6	0	0	6	0	0
13	24034215	.	G	A	4	2	6	0	0	6	0	0
13	24045342	.	C	T	2	2	4	0	0	4	0	0
13	24046953	.	G	A	0	2	2	0	3	5	0	0
13	24056221	.	C	T	3	15	18	0	1	19	0	0
13	24068790	.	C	T	0	15	15	0	12	27	0	0
13	24069624	.	C	A	13	12	25	0	3	28	0	0
13	24069902	.	A	T	7	11	18	0	1	19	0	0
13	24070242	.	C	T	0	11	11	0	14	25	0	0
13	24070578	.	G	A	5	3	8	0	2	10	0	0
13	24070730	.	C	T	7	7	14	0	1	15	0	0
13	24234815	.	C	A	4	3	7	0	1	8	0	0
13	24241436	.	A	G	0	1	1	0	0	1	0	0
13	24275663	.	G	A	0	1	1	0	1	2	0	0
13	24292398	.	G	A	7	4	11	0	1	12	0	0
13	24292419	.	G	A	2	5	7	0	1	8	0	0
13	24292796	.	T	A	13	22	35	0	0	35	0	0
13	24292800	.	A	T	12	22	34	0	0	34	0	0
13	24292866	.	C	A	2	19	21	0	10	31	0	0
13	24293162	.	C	A	15	16	31	0	0	31	0	0
13	24293218	.	T	A	24	9	33	0	1	34	0	0
13	24293220	.	G	C	25	9	34	0	0	34	0	0
13	24293448	.	A	G	16	15	31	0	2	33	0	0
13	24293465	.	C	T	4	15	19	0	14	33	0	0
13	24293615	.	G	A	8	30	38	0	10	48	0	0
13	24293691	.	G	A	15	21	36	0	0	36	0	0
13	24293698	.	C	T	21	14	35	0	0	35	0	0
13	24293940	.	G	A	13	20	33	0	1	34	0	0
13	24294046	.	A	G	12	18	30	0	2	32	0	0
13	24296013	.	C	T	6	4	10	0	1	11	0	0
13	24296215	.	C	T	0	5	5	0	4	9	0	0
13	24296430	.	C	A	6	5	11	0	1	12	0	0
13	24303667	.	C	A	2	2	4	0	0	4	0	0
13	24305975	.	T	G	9	7	16	0	0	16	0	0
13	24309321	.	A	T	3	2	5	0	0	5	0	0
13	24311510	.	G	A	0	1	1	0	0	1	0	0
13	24372095	.	G	T	3	4	7	0	0	7	0	0
13	24372477	.	A	T	3	1	4	0	0	4	0	0
13	24372874	.	T	A	1	4	5	0	0	5	0	0
13	24372900	.	A	C	1	0	1	0	2	3	0	0
13	24372943	.	C	T	2	4	6	0	0	6	0	0
13	24373081	.	A	G	3	2	5	0	0	5	0	0
13	24378978	.	A	T	1	2	3	0	0	3	0	0
13	24380376	.	T	A	2	2	4	0	0	4	0	0
13	24381336	.	A	T	1	2	3	0	0	3	0	0
13	24382539	.	T	C	1	1	2	0	0	2	0	0
13	24382578	.	G	A	0	0	0	0	1	1	0	0
13	24384282	.	G	C	8	6	14	0	0	14	0	0
13	24384364	.	T	A	9	8	17	0	0	17	0	0
13	24384371	.	T	A	9	8	17	0	0	17	0	0
13	24384425	.	A	T	6	13	19	0	1	20	0	0
13	24384807	.	G	A	9	5	14	0	2	16	0	0
13	24387484	.	G	T	4	4	8	0	0	8	0	0
13	24395371	.	A	G	4	3	7	0	0	7	0	0
13	24395373	.	G	A	3	4	7	0	0	7	0	0
13	24401087	.	C	G	0	2	2	0	0	2	0	0
13	24401618	.	A	G	4	6	10	0	0	10	0	0
13	24401626	.	G	C	0	4	4	0	7	11	0	0
13	24401663	.	C	A	2	5	7	0	0	7	0	0
13	24401824	.	T	G	2	2	4	0	1	5	0	0
13	24402490	.	G	A	0	17	17	0	7	24	0	0
13	24402560	.	T	C	2	3	5	0	0	5	0	0
13	24411553	.	T	C	17	14	31	0	0	31	0	0
13	24424014	.	C	T	7	3	10	0	0	10	0	0
13	24424216	.	A	T	0	7	7	0	0	7	0	0
13	24424217	.	A	C	0	6	6	0	1	7	0	0
13	24424260	.	A	T	6	1	7	0	0	7	0	0
13	24424511	.	A	C	3	0	3	0	3	6	0	0
13	24424724	.	T	C	1	8	9	0	2	11	0	0
13	24425112	.	T	C	1	0	1	0	2	3	0	0
13	24425133	.	G	A	1	0	1	0	0	1	0	0
13	24425812	.	C	T	1	1	2	0	0	2	0	0
13	24425833	.	C	T	1	2	3	0	0	3	0	0
13	24431365	.	T	G	1	7	8	0	0	8	0	0
13	24431651	.	C	G	11	3	14	0	0	14	0	0
13	24431784	.	T	G	19	18	37	0	0	37	0	0
13	24432162	.	G	C	11	8	19	0	0	19	0	0
13	24432212	.	T	C	12	1	13	0	5	18	0	0
13	24432350	.	C	T	1	10	11	0	15	26	0	0
13	24436054	.	G	A	8	8	16	0	1	17	0	0
13	24437225	.	G	A	2	4	6	0	0	6	0	0
13	24521405	.	A	G	1	2	3	0	0	3	0	0
13	24521880	.	A	T	2	4	6	0	0	6	0	0
13	24521927	.	G	A	8	2	10	0	1	11	0	0
13	24522570	.	G	T	4	2	6	0	0	6	0	0
13	24523321	.	G	A	5	6	11	0	1	13	1	0
13	24523425	.	A	G	4	4	8	0	1	9	0	0
13	24523637	.	T	G	1	3	4	0	0	4	0	0
13	24523731	.	A	G	4	2	6	0	0	6	0	0
13	24579187	.	A	T	2	4	6	0	1	7	0	0
13	24580372	.	G	A	0	3	3	0	0	3	0	0
13	24580411	.	G	A	6	14	20	0	0	20	0	0
13	24580441	.	A	G	12	0	12	0	15	27	0	0
13	24580705	.	C	T	13	8	21	0	2	23	0	0
13	24580869	.	T	C	5	2	7	0	0	7	0	0
13	24580941	.	T	C	3	0	3	0	0	3	0	0
13	24581274	.	G	A	5	6	11	0	1	12	0	0
13	24581316	.	C	A	8	12	20	0	1	21	0	0
13	24581334	.	G	C	10	4	14	0	1	15	0	0
13	24581358	.	T	C	5	0	5	0	0	5	0	0
13	24581748	.	A	C	12	12	24	0	2	27	1	0
13	24581798	.	T	A	10	10	20	0	2	22	0	0
13	24581840	.	T	G	17	13	30	0	0	30	0	0
13	24581854	.	C	T	17	13	30	0	0	30	0	0
13	24581982	.	G	A	0	9	9	0	21	30	0	0
13	24582047	.	A	G	12	11	23	0	0	23	0	0
13	24582110	.	C	T	7	10	17	0	2	19	0	0
13	24582122	.	T	C	8	10	18	0	0	18	0	0
13	24582211	.	C	T	2	8	10	0	0	10	0	0
13	24662313	.	G	C	1	2	3	0	0	3	0	0
13	24665869	.	C	T	0	0	0	0	1	1	0	0
13	24702092	.	C	T	7	6	13	0	2	15	0	0
13	24702114	.	T	C	11	5	16	0	1	17	0	0
13	24702275	.	C	T	5	6	11	0	0	11	0	0
13	24702383	.	G	A	12	7	19	0	0	19	0	0
13	24702415	.	T	C	6	10	16	0	0	16	0	0
13	24702743	.	C	T	2	4	6	0	0	6	0	0
13	24702822	.	A	C	14	9	23	0	1	24	0	0
13	24702883	.	A	T	10	10	20	0	0	20	0	0
13	24702974	.	T	C	6	8	14	0	0	14	0	0
13	24702996	.	G	A	6	12	18	0	1	19	0	0
13	24703319	.	C	T	2	3	5	0	0	5	0	0
13	24703325	.	A	T	2	3	5	0	0	5	0	0
13	24703354	.	C	A	3	4	7	0	0	7	0	0
13	24703362	.	C	A	3	3	6	0	2	8	0	0
13	24704102	.	C	A	9	8	17	0	0	18	1	0
13	24704191	.	A	T	5	12	17	0	0	17	0	0
13	24716363	.	T	C	2	5	7	0	0	7	0	0
13	24716375	.	A	T	1	5	6	0	1	7	0	0
13	24740703	.	C	A	2	4	6	0	0	6	0	0
13	24740758	.	A	G	1	1	2	0	0	2	0	0
13	24742835	.	G	A	1	3	4	0	0	4	0	0
13	24742836	.	T	A	1	2	3	0	1	4	0	0
13	24781605	.	T	C	19	11	30	0	0	30	0	0
13	24785591	.	C	A	3	6	9	0	0	9	0	0
13	24791020	.	A	G	2	2	4	0	1	5	0	0
13	24804321	.	T	C	8	3	11	0	1	12	0	0
13	24804436	.	A	G	4	3	7	0	0	7	0	0
13	24804765	.	C	T	2	4	6	0	0	6	0	0
13	24804804	.	A	G	3	3	6	0	0	6	0	0
13	24805068	.	A	C	2	2	4	0	1	5	0	0
13	24805148	.	A	C	3	4	7	0	1	8	0	0
13	24805257	.	T	C	1	0	1	0	0	1	0	0
13	24826382	.	G	A	1	1	2	0	1	3	0	0
13	24826389	.	T	C	1	0	1	0	1	2	0	0
13	24834358	.	A	G	13	6	19	0	0	19	0	0
13	24836958	.	C	T	11	6	17	0	0	17	0	0
13	24837246	.	T	C	2	3	5	0	0	5	0	0
13	24837253	.	T	A	3	4	7	0	0	7	0	0
13	24837392	.	A	G	19	10	29	0	1	30	0	0
13	24837407	.	T	A	23	11	34	0	0	35	1	0
13	24871485	.	C	T	7	10	17	0	7	24	0	0
13	24872733	.	G	A	5	5	10	0	1	11	0	0
13	24873141	.	C	A	0	7	7	0	9	17	1	0
13	24873267	.	G	A	8	13	21	0	0	21	0	0
13	24873480	.	A	G	5	11	16	0	0	16	0	0
13	24873579	.	C	T	5	9	14	0	0	14	0	0
13	24873597	.	G	T	6	5	11	0	1	12	0	0
13	24873990	.	A	G	4	4	8	0	0	8	0	0
13	24873995	.	T	G	4	4	8	0	0	8	0	0
13	24874837	.	A	G	6	6	12	0	0	12	0	0
13	24874894	.	T	A	7	5	12	0	0	13	1	0
13	24874934	.	A	G	9	4	13	0	0	13	0	0
13	24877934	.	C	A	1	3	4	0	0	4	0	0
13	24919317	.	C	T	5	6	11	0	0	11	0	0
13	24919518	.	T	C	4	7	11	0	0	11	0	0
13	24919969	.	A	T	5	2	7	0	0	7	0	0
13	24920098	.	C	T	8	2	10	0	1	11	0	0
13	24986203	.	G	A	0	2	2	0	0	2	0	0
13	24986238	.	G	T	3	6	9	0	0	9	0	0
13	24986272	.	T	C	6	0	6	0	6	12	0	0
13	25199240	.	T	C	1	0	1	0	2	3	0	0
13	25207064	.	G	C	3	1	4	0	0	4	0	0
13	25207068	.	C	T	3	1	4	0	0	4	0	0
13	25207368	.	A	G	0	1	1	0	0	1	0	0
13	25208321	.	G	T	2	2	4	0	0	4	0	0
13	25208484	.	T	G	1	3	4	0	0	4	0	0
13	25212657	.	A	G	1	2	3	0	0	3	0	0
13	25229573	.	G	A	0	1	1	0	0	1	0	0
13	25364915	.	A	T	4	5	9	0	0	9	0	0
13	25369165	.	C	T	2	3	5	0	0	5	0	0
13	25369449	.	C	T	2	5	7	0	1	8	0	0
13	25371436	.	A	G	9	7	16	0	1	17	0	0
13	25378590	.	G	A	0	3	3	0	3	6	0	0
13	25378924	.	T	G	10	10	20	1	0	21	0	0
13	25379263	.	A	T	15	13	28	0	4	32	0	0
13	25379304	.	A	G	13	2	15	0	11	26	0	0
13	25379352	.	A	C	11	11	22	0	0	22	0	0
13	25383915	.	C	T	1	11	12	0	0	12	0	0
13	25384145	.	A	G	0	5	5	0	0	5	0	0
13	25384223	.	A	G	4	4	8	0	0	8	0	0
13	25386904	.	C	T	4	5	9	0	0	9	0	0
13	25388389	.	G	A	10	3	13	0	1	14	0	0
13	25388644	.	T	C	5	8	13	0	1	14	0	0
13	25388658	.	T	A	4	8	12	0	1	13	0	0
13	25388708	.	G	T	5	8	13	0	0	13	0	0
13	25403606	.	G	A	2	3	5	0	0	5	0	0
13	25403985	.	G	A	1	2	3	0	0	3	0	0
13	25428952	.	C	G	7	10	17	0	2	19	0	0
13	25429048	.	T	A	8	4	12	0	0	12	0	0
13	25429079	.	C	T	6	8	14	0	2	16	0	0
13	25436336	.	A	T	13	13	26	0	1	27	0	0
13	25436360	.	A	T	10	7	17	0	1	18	0	0
13	25436381	.	G	A	11	8	19	0	0	19	0	0
13	25472735	.	G	A	9	17	26	0	1	27	0	0
13	25472756	.	T	C	14	11	25	0	3	28	0	0
13	25472859	.	G	A	14	16	30	0	0	30	0	0
13	25473039	.	C	T	15	25	40	0	3	43	0	0
13	25473325	.	G	A	5	3	8	0	0	8	0	0
13	25475889	.	C	T	6	8	14	0	1	15	0	0
13	25475904	.	A	G	6	8	14	0	1	15	0	0
13	25477249	.	G	A	8	5	13	0	0	13	0	0
13	25484638	.	G	T	4	9	13	0	0	13	0	0
13	25492923	.	A	T	3	12	15	0	1	16	0	0
13	25492992	.	C	G	2	1	3	0	0	3	0	0
13	25497320	.	A	G	3	0	3	0	6	9	0	0
13	25497575	.	T	C	7	8	15	0	2	17	0	0
13	25497581	.	C	T	7	11	18	0	1	19	0	0
13	25497700	.	G	C	10	9	19	0	0	19	0	0
13	25497880	.	T	C	6	13	19	0	1	20	0	0
13	25516204	.	T	C	1	0	1	0	0	1	0	0
13	25519063	.	G	A	0	3	3	0	3	6	0	0
13	25523608	.	C	T	4	1	5	0	0	5	0	0
13	25523629	.	T	C	5	5	10	0	0	10	0	0
13	25523677	.	G	A	0	2	2	0	4	6	0	0
13	25530063	.	C	T	1	3	4	0	0	4	0	0
13	25532352	.	C	T	10	11	21	0	0	21	0	0
13	25532509	.	T	A	15	8	23	0	0	23	0	0
13	25532574	.	C	A	19	11	30	0	1	31	0	0
13	25532706	.	T	C	5	5	10	0	1	11	0	0
13	25533175	.	T	C	9	17	26	0	0	26	0	0
13	25533233	.	G	A	15	8	23	0	2	25	0	0
13	25533258	.	T	A	13	9	22	0	1	23	0	0
13	25533657	.	C	G	11	0	11	0	10	21	0	0
13	25534165	.	T	C	8	9	17	0	2	19	0	0
13	25534407	.	C	T	13	17	30	0	1	31	0	0
13	25535405	.	G	A	2	2	4	0	0	4	0	0
13	25549516	.	A	G	4	0	4	0	5	9	0	0
13	25551865	.	T	C	5	4	9	0	0	9	0	0
13	25552219	.	T	C	2	0	2	0	0	2	0	0
13	25554547	.	T	C	0	1	1	0	1	2	0	0
13	25554553	.	T	G	1	0	1	0	1	2	0	0
13	25557295	.	G	A	2	1	3	0	0	3	0	0
13	25559610	.	G	A	3	4	7	0	0	7	0	0
13	25560416	.	C	T	1	0	1	0	0	1	0	0
13	25563221	.	C	A	2	0	2	0	0	2	0	0
13	25565379	.	T	C	10	12	22	0	0	22	0	0
13	25565844	.	A	C	1	5	6	0	0	6	0	0
13	25566057	.	G	A	0	5	5	0	4	9	0	0
13	25566205	.	A	T	7	5	12	0	0	12	0	0
13	25566222	.	C	T	7	3	10	0	0	10	0	0
13	25569865	.	A	G	13	6	19	0	0	19	0	0
13	25569874	.	A	G	12	6	18	0	0	18	0	0
13	25569940	.	A	C	10	6	16	0	0	16	0	0
13	25570008	.	T	C	3	4	7	0	0	7	0	0
13	25570013	.	C	T	2	2	4	0	1	5	0	0
13	25570104	.	C	T	8	6	14	0	0	14	0	0
13	25570108	.	T	A	7	5	12	0	1	13	0	0
13	25570341	.	T	C	6	0	6	0	3	9	0	0
13	25570427	.	T	A	9	10	19	0	0	19	0	0
13	25570561	.	A	C	8	7	15	0	1	16	0	0
13	25570715	.	C	T	2	6	8	0	0	8	0	0
13	25571113	.	A	T	5	3	8	0	0	8	0	0
13	25571274	.	C	T	10	13	23	0	0	23	0	0
13	25573397	.	C	T	0	1	1	0	0	1	0	0
13	25575396	.	C	T	2	0	2	0	0	2	0	0
13	25575411	.	A	C	2	1	3	0	1	4	0	0
13	25575453	.	G	A	1	2	3	0	1	4	0	0
13	25581121	.	T	C	7	7	14	0	0	14	0	0
13	25584993	.	A	T	4	4	8	0	0	8	0	0
13	25585757	.	G	A	4	3	7	0	0	7	0	0
13	25585762	.	C	T	3	4	7	0	0	7	0	0
13	25586289	.	G	A	1	2	3	0	0	3	0	0
13	25586448	.	G	A	1	4	5	0	2	7	0	0
13	25589241	.	G	A	1	1	2	0	0	2	0	0
13	25724747	.	G	A	1	1	2	0	0	2	0	0
13	25726378	.	C	G	6	7	13	0	0	13	0	0
13	25726504	.	T	G	2	2	4	0	0	4	0	0
13	25728037	.	G	A	2	4	6	0	0	6	0	0
13	25728453	.	A	C	8	9	17	0	1	18	0	0
13	25728606	.	A	T	5	5	10	0	1	11	0	0
13	25728738	.	A	C	1	3	4	0	0	4	0	0
13	25728747	.	A	G	1	3	4	0	0	4	0	0
13	25728836	.	T	C	3	4	7	0	0	7	0	0
13	25729108	.	G	A	1	4	5	0	0	5	0	0
13	25729440	.	G	A	1	5	6	0	1	7	0	0
13	25730774	.	C	T	2	0	2	0	0	2	0	0
13	25750868	.	A	T	1	2	3	0	0	3	0	0
13	25824616	.	T	A	16	9	25	0	3	28	0	0
13	25824718	.	C	T	17	13	30	0	1	31	0	0
13	25825016	.	G	A	21	10	31	0	1	32	0	0
13	25825263	.	A	T	4	4	8	0	0	8	0	0
13	25826362	.	T	C	0	0	0	0	2	2	0	0
13	25827129	.	T	G	6	5	11	0	2	13	0	0
13	25827421	.	G	A	7	6	13	0	1	14	0	0
13	25846994	.	C	A	11	10	21	0	0	21	0	0
13	25847136	.	T	A	6	9	15	0	0	15	0	0
13	25847144	.	G	T	5	9	14	0	0	14	0	0
13	25847176	.	G	A	2	10	12	0	0	12	0	0
13	25847226	.	T	G	8	6	14	0	0	14	0	0
13	25847295	.	T	G	7	0	7	0	1	9	1	0
13	25847973	.	G	T	6	3	9	0	0	9	0	0
13	25848093	.	T	C	2	6	8	0	2	10	0	0
13	25849234	.	T	G	3	4	7	0	0	7	0	0
13	25849294	.	T	G	2	2	4	0	0	4	0	0
13	25849992	.	A	T	1	2	3	0	1	4	0	0
13	25850874	.	G	A	4	9	13	0	0	13	0	0
13	25851412	.	C	G	1	3	4	0	0	4	0	0
13	25851753	.	C	T	4	4	8	0	0	8	0	0
13	25851832	.	C	T	0	2	2	0	0	2	0	0
13	25851883	.	G	A	4	1	5	0	0	5	0	0
13	25852558	.	T	A	3	3	6	0	0	6	0	0
13	26186175	.	T	A	2	1	3	0	0	3	0	0
13	26210284	.	A	G	1	1	2	0	0	2	0	0
13	27000394	.	C	T	0	7	7	0	5	12	0	0
13	27036582	.	T	C	7	0	7	0	3	10	0	0
13	27036660	.	T	C	6	8	14	0	0	14	0	0
13	27036766	.	G	A	7	4	11	0	0	11	0	0
13	27036847	.	C	T	3	7	10	0	0	10	0	0
13	27036898	.	T	C	6	11	17	0	0	17	0	0
13	27037942	.	A	G	7	7	14	0	0	14	0	0
13	27107520	.	C	T	5	4	9	0	0	9	0	0
13	27189877	.	A	T	0	1	1	0	0	1	0	0
13	27189898	.	C	T	1	0	1	0	0	1	0	0
13	27201552	.	G	A	1	4	5	0	0	5	0	0
13	27201606	.	T	C	2	3	5	0	0	5	0	0
13	27204440	.	T	A	12	7	19	0	0	19	0	0
13	27207707	.	G	T	3	4	7	0	0	7	0	0
13	27209754	.	T	C	0	1	1	0	0	1	0	0
13	27209852	.	T	C	1	3	4	0	0	4	0	0
13	27227407	.	C	A	1	3	4	0	0	4	0	0
13	27227449	.	A	G	1	5	6	0	0	6	0	0
13	27293812	.	C	T	1	2	3	0	0	3	0	0
13	27293813	.	A	G	1	2	3	0	0	3	0	0
13	27294735	.	G	A	2	2	4	0	1	5	0	0
13	27296415	.	T	A	4	5	9	0	0	9	0	0
13	27309080	.	C	T	2	3	5	0	0	5	0	0
13	27309128	.	T	G	4	0	4	0	6	10	0	0
13	27309143	.	C	T	5	7	12	0	1	13	0	0
13	27312938	.	C	T	5	2	7	0	0	7	0	0
13	27313025	.	T	A	1	2	3	0	0	3	0	0
13	27313066	.	G	T	1	3	4	0	0	4	0	0
13	27313236	.	A	G	5	6	11	0	0	11	0	0
13	27313258	.	G	T	3	10	13	0	1	14	0	0
13	27313310	.	T	A	4	11	15	0	0	15	0	0
13	27316874	.	G	T	1	3	4	0	0	4	0	0
13	27317026	.	C	T	15	13	28	0	2	30	0	0
13	27317499	.	C	T	16	24	40	0	1	41	0	0
13	27320574	.	T	C	14	21	35	0	3	38	0	0
13	27320583	.	C	T	20	21	41	0	2	43	0	0
13	27320628	.	T	A	21	19	40	0	2	42	0	0
13	27320849	.	T	C	18	25	43	0	1	44	0	0
13	27320996	.	G	A	0	13	13	0	13	26	0	0
13	27321271	.	G	A	1	30	31	0	26	57	0	0
13	27323970	.	G	A	0	16	16	0	10	26	0	0
13	27632915	.	C	T	0	17	17	0	14	31	0	0
13	27633628	.	G	A	20	15	35	0	2	37	0	0
13	27633833	.	A	G	17	17	34	0	0	34	0	0
13	27633906	.	A	G	21	20	41	0	0	41	0	0
13	27634324	.	T	C	20	16	36	0	2	38	0	0
13	27634634	.	A	G	12	14	26	0	3	29	0	0
13	27634670	.	G	T	11	20	31	0	0	31	0	0
13	27634678	.	G	T	15	21	36	0	0	36	0	0
13	27634726	.	T	C	15	0	15	0	22	38	1	0
13	27634903	.	A	G	5	6	11	0	0	11	0	0
13	27641472	.	T	C	3	9	12	0	0	12	0	0
13	27650537	.	G	A	17	6	23	0	2	25	0	0
13	27653458	.	C	A	0	1	1	0	1	2	0	0
13	27668056	.	G	T	7	14	21	0	0	21	0	0
13	27674408	.	C	T	6	5	11	0	0	11	0	0
13	27677945	.	C	T	0	2	2	0	0	2	0	0
13	27685233	.	G	A	8	3	11	0	2	13	0	0
13	27686259	.	C	T	7	12	19	0	2	21	0	0
13	27686405	.	G	A	18	7	25	0	0	25	0	0
13	27771607	.	T	G	8	0	8	0	4	12	0	0
13	27782086	.	C	A	3	9	12	0	0	12	0	0
13	27782192	.	A	T	2	5	7	0	0	7	0	0
13	27782193	.	G	A	2	5	7	0	0	7	0	0
13	27782260	.	C	T	1	4	5	0	0	5	0	0
13	27782297	.	A	G	3	4	7	0	0	7	0	0
13	27782402	.	A	T	7	6	13	0	0	13	0	0
13	27782449	.	T	G	5	4	9	0	0	9	0	0
13	27782480	.	G	A	6	4	10	0	0	10	0	0
13	27914491	.	A	G	1	0	1	0	0	1	0	0
13	27951883	.	A	G	9	0	9	0	5	14	0	0
13	27951989	.	A	C	6	8	14	0	2	16	0	0
13	27952156	.	C	T	15	10	25	0	0	25	0	0
13	27952207	.	G	A	12	18	30	0	0	30	0	0
13	27952330	.	G	T	15	11	26	0	1	27	0	0
13	27952414	.	A	G	14	15	29	0	1	30	0	0
13	27952441	.	G	T	14	16	30	0	0	30	0	0
13	27963912	.	T	C	9	6	15	0	0	15	0	0
13	28009302	.	G	A	0	18	18	0	19	37	0	0
13	28010183	.	G	A	26	28	54	0	3	57	0	0
13	28010572	.	C	A	25	22	47	0	1	48	0	0
13	28062552	.	T	G	4	2	6	0	0	6	0	0
13	28176651	.	T	C	0	0	0	0	2	2	0	0
13	28501360	.	C	T	3	7	10	0	0	10	0	0
13	28513036	.	T	C	4	4	8	0	1	9	0	0
13	28513240	.	G	A	3	2	5	0	0	5	0	0
13	28561304	.	T	A	6	8	14	0	0	14	0	0
13	28596162	.	C	A	3	3	6	0	0	6	0	0
13	28642816	.	A	C	3	3	6	0	2	8	0	0
13	28642825	.	C	A	3	4	7	0	2	9	0	0
13	28643087	.	C	T	5	5	10	0	0	10	0	0
13	28649848	.	A	C	10	11	21	0	1	22	0	0
13	28650239	.	A	T	15	15	30	0	0	30	0	0
13	28650349	.	A	T	6	15	21	0	1	22	0	0
13	28650731	.	A	C	6	1	7	0	8	15	0	0
13	28651214	.	C	A	1	19	20	0	22	42	0	0
13	28651365	.	A	G	26	16	42	0	0	42	0	0
13	28676034	.	G	A	9	8	17	0	1	18	0	0
13	28676083	.	A	C	6	5	11	0	0	11	0	0
13	28676134	.	G	C	7	13	20	0	0	20	0	0
13	28676241	.	A	G	8	4	12	0	0	12	0	0
13	28676358	.	G	A	7	5	12	0	0	12	0	0
13	28678176	.	C	G	9	2	11	0	1	12	0	0
13	28680634	.	T	A	10	9	19	0	0	19	0	0
13	28680681	.	G	A	7	2	9	0	0	9	0	0
13	28680847	.	T	A	3	11	14	0	1	15	0	0
13	28680879	.	T	C	7	13	20	0	0	20	0	0
13	28694384	.	C	A	4	5	9	0	0	9	0	0
13	28694390	.	C	T	4	5	9	0	0	9	0	0
13	28694447	.	G	A	3	3	6	0	0	6	0	0
13	28694664	.	T	C	6	4	10	0	1	11	0	0
13	28741042	.	A	T	2	1	3	0	0	3	0	0
13	28743835	.	C	T	14	15	29	0	0	29	0	0
13	28744061	.	C	A	6	7	13	0	0	13	0	0
13	28744159	.	G	A	5	8	13	0	1	14	0	0
13	28744495	.	G	A	1	18	19	0	11	30	0	0
13	28744690	.	C	T	15	16	31	1	4	36	0	0
13	28744775	.	C	T	10	12	22	0	0	22	0	0
13	28745188	.	G	A	16	18	34	0	1	35	0	0
13	28745899	.	A	G	11	14	25	0	0	25	0	0
13	28745934	.	C	A	9	9	18	0	1	19	0	0
13	28745963	.	C	T	14	6	20	0	0	20	0	0
13	28746033	.	G	A	13	13	26	0	0	26	0	0
13	28746083	.	T	C	6	5	11	0	0	11	0	0
13	28746349	.	A	G	2	3	5	0	0	5	0	0
13	28786555	.	G	A	1	2	3	0	0	3	0	0
13	28786583	.	A	G	0	1	1	0	0	1	0	0
13	28827315	.	T	A	0	1	1	0	0	1	0	0
13	28848220	.	G	A	3	0	3	0	1	4	0	0
13	28848473	.	C	T	2	0	2	0	0	2	0	0
13	28865700	.	T	C	12	16	28	0	3	31	0	0
13	28866413	.	A	T	19	18	37	0	1	38	0	0
13	28866485	.	A	G	8	14	22	0	0	22	0	0
13	28866553	.	A	G	14	28	42	0	0	42	0	0
13	28866810	.	G	A	21	9	30	0	1	31	0	0
13	28867071	.	G	T	23	20	43	0	0	43	0	0
13	28867159	.	G	A	0	15	15	0	23	38	0	0
13	28867367	.	C	T	19	19	38	0	2	40	0	0
13	28870698	.	A	T	0	1	1	0	0	1	0	0
13	28870917	.	T	C	18	32	50	0	2	52	0	0
13	28871055	.	T	C	6	3	9	0	0	9	0	0
13	28901463	.	T	A	20	37	57	0	1	58	0	0
13	28901957	.	A	G	11	17	28	0	2	30	0	0
13	28901996	.	T	C	21	16	37	0	0	37	0	0
13	28902169	.	C	T	14	12	26	0	3	29	0	0
13	28902170	.	C	G	16	12	28	0	1	29	0	0
13	28902215	.	T	C	18	18	36	0	0	36	0	0
13	29224279	.	A	T	4	1	5	0	1	6	0	0
13	29226205	.	G	A	5	1	6	0	1	7	0	0
13	29226207	.	G	A	5	2	7	0	0	7	0	0
13	29292193	.	C	T	3	3	6	0	1	7	0	0
13	29295742	.	G	A	0	2	2	0	0	2	0	0
13	29341522	.	C	T	2	0	2	0	0	2	0	0
13	29347034	.	A	G	3	7	10	0	0	10	0	0
13	29347156	.	G	A	0	3	3	0	4	7	0	0
13	29347170	.	G	A	4	1	5	0	0	5	0	0
13	29347258	.	C	G	5	5	10	0	1	11	0	0
13	29347265	.	T	A	6	6	12	0	0	12	0	0
13	29347745	.	A	C	5	13	18	0	1	19	0	0
13	29374153	.	G	A	0	2	2	0	0	2	0	0
13	29374165	.	G	A	1	2	3	0	0	3	0	0
13	29381011	.	C	T	1	0	1	0	0	1	0	0
13	29385831	.	G	A	6	6	12	0	0	12	0	0
13	29392261	.	G	A	3	1	4	0	0	4	0	0
13	29395207	.	C	A	4	3	7	0	0	7	0	0
13	29395236	.	C	T	2	0	2	0	0	2	0	0
13	29402681	.	A	C	4	1	5	0	0	5	0	0
13	29403953	.	A	C	7	7	14	0	1	15	0	0
13	29404003	.	G	A	5	17	22	0	0	22	0	0
13	29404323	.	G	T	27	13	40	0	1	41	0	0
13	29404576	.	A	G	14	14	28	0	2	30	0	0
13	29404633	.	C	T	22	15	37	0	1	38	0	0
13	29404660	.	T	G	20	2	22	0	16	38	0	0
13	29405079	.	G	T	1	2	3	0	0	3	0	0
13	29407196	.	C	T	8	7	15	0	0	15	0	0
13	29407397	.	C	A	0	6	6	0	7	13	0	0
13	29407802	.	T	G	17	15	32	0	2	34	0	0
13	29407896	.	A	G	2	4	6	0	2	8	0	0
13	29408052	.	G	T	5	3	8	0	1	9	0	0
13	29408192	.	T	A	8	10	18	0	1	19	0	0
13	29408226	.	T	C	13	6	19	0	0	19	0	0
13	29408499	.	G	A	3	9	12	0	1	13	0	0
13	29408530	.	C	T	6	4	10	0	1	11	0	0
13	29408677	.	T	A	19	13	32	0	0	32	0	0
13	29409265	.	C	T	0	5	5	0	4	9	0	0
13	29409530	.	G	A	13	10	23	0	0	23	0	0
13	29409558	.	G	A	12	7	19	0	0	19	0	0
13	29411895	.	T	G	2	3	5	0	0	5	0	0
13	29412299	.	G	A	2	1	3	0	1	4	0	0
13	29412379	.	G	T	5	5	10	0	2	12	0	0
13	29414482	.	A	T	2	2	4	0	2	6	0	0
13	29414509	.	G	A	4	4	8	0	0	8	0	0
13	29414546	.	A	G	3	1	4	0	1	5	0	0
13	29415184	.	A	T	1	2	3	0	0	3	0	0
13	29416798	.	A	T	2	5	7	0	0	7	0	0
13	29417091	.	G	A	1	7	8	0	0	8	0	0
13	29417792	.	T	C	0	1	1	0	0	1	0	0
13	29417814	.	G	A	1	2	3	0	0	3	0	0
13	29419508	.	G	A	0	3	3	0	0	3	0	0
13	29422112	.	G	A	2	3	5	0	0	5	0	0
13	29422499	.	C	G	0	10	10	0	3	13	0	0
13	29455199	.	C	T	2	3	5	0	0	5	0	0
13	29455573	.	A	G	2	2	4	0	0	4	0	0
13	29466288	.	C	T	1	3	4	0	0	4	0	0
13	29466303	.	C	T	1	3	4	0	1	5	0	0
13	29467222	.	A	T	1	2	3	0	0	3	0	0
13	29467230	.	A	G	1	2	3	0	0	3	0	0
13	29802607	.	C	A	13	8	21	0	1	22	0	0
13	29802633	.	A	G	9	7	16	0	2	18	0	0
13	29803253	.	C	T	6	5	11	0	0	11	0	0
13	29803801	.	G	A	5	5	10	0	0	10	0	0
13	29804075	.	T	C	7	5	12	0	0	12	0	0
13	29992513	.	T	C	2	2	4	0	0	4	0	0
13	29992519	.	T	C	1	2	3	0	0	3	0	0
13	30817279	.	A	T	7	4	11	0	0	11	0	0
13	31925599	.	C	T	1	2	3	0	0	3	0	0
13	31925651	.	G	A	4	2	6	0	0	6	0	0
13	31925701	.	A	G	6	6	12	0	0	12	0	0
13	31933666	.	A	G	6	6	12	0	0	12	0	0
13	31933684	.	G	A	6	8	14	0	0	14	0	0
13	31935288	.	C	T	1	2	3	0	0	3	0	0
13	31936053	.	C	G	1	2	3	0	0	3	0	0
13	31936074	.	A	T	1	1	2	0	0	2	0	0
13	31936700	.	G	T	1	3	4	0	0	4	0	0
13	31936707	.	T	A	1	3	4	0	0	4	0	0
13	32150021	.	T	C	5	7	12	0	0	12	0	0
13	32150038	.	G	A	0	6	6	0	5	11	0	0
13	32150193	.	A	C	1	2	3	0	1	4	0	0
13	32446278	.	G	A	2	8	10	0	0	10	0	0
13	32452658	.	C	T	2	4	6	0	0	6	0	0
13	32452775	.	C	T	4	5	9	0	0	9	0	0
13	32452924	.	G	T	4	5	9	0	0	9	0	0
13	32452949	.	T	G	1	4	5	0	0	5	0	0
13	32453227	.	G	T	2	4	6	0	0	6	0	0
13	32453281	.	C	T	2	3	5	0	0	5	0	0
13	32453582	.	A	G	1	2	3	0	0	3	0	0
13	32454381	.	A	T	9	11	20	0	0	20	0	0
13	32454565	.	T	A	2	6	8	0	2	10	0	0
13	32455739	.	C	A	9	5	14	0	0	14	0	0
13	32455943	.	A	G	8	6	14	0	0	14	0	0
13	32456312	.	C	G	11	4	15	0	0	15	0	0
13	32456350	.	G	A	7	4	11	0	2	13	0	0
13	32456624	.	C	T	8	4	12	0	0	12	0	0
13	32456736	.	G	T	3	3	6	0	0	6	0	0
13	32575859	.	T	G	3	4	7	0	0	7	0	0
13	32576154	.	G	A	1	6	7	0	0	7	0	0
13	32576178	.	T	C	2	0	2	0	4	6	0	0
13	32580556	.	T	G	5	3	8	0	0	8	0	0
13	32583915	.	G	A	16	4	20	0	0	20	0	0
13	32583930	.	A	G	13	4	17	0	0	17	0	0
13	32588892	.	A	G	12	6	18	0	0	18	0	0
13	32591702	.	C	T	3	1	4	0	0	4	0	0
13	32595257	.	C	T	2	7	9	0	0	9	0	0
13	32620662	.	A	G	1	2	3	0	0	3	0	0
13	32638668	.	C	T	3	10	13	0	0	13	0	0
13	32638670	.	T	C	3	10	13	0	0	13	0	0
13	32638991	.	T	C	1	2	3	0	0	3	0	0
13	32640975	.	C	A	7	6	13	0	0	13	0	0
13	32641165	.	G	A	3	5	8	0	0	8	0	0
13	32641215	.	A	G	5	3	8	0	0	8	0	0
13	32641480	.	T	C	5	3	8	0	2	10	0	0
13	32641926	.	C	A	1	2	3	0	1	4	0	0
13	32641929	.	G	C	2	1	3	0	1	4	0	0
13	32642185	.	A	G	4	5	9	0	0	9	0	0
13	32642215	.	A	G	2	8	10	0	0	10	0	0
13	32642238	.	A	G	1	13	14	0	0	14	0	0
13	32642251	.	G	A	2	14	16	0	1	17	0	0
13	32642284	.	C	A	2	11	13	0	0	13	0	0
13	32642369	.	T	C	0	11	11	0	1	12	0	0
13	32642410	.	G	T	4	8	12	0	0	12	0	0
13	32642488	.	A	G	5	11	16	0	0	16	0	0
13	32642528	.	A	T	11	11	22	0	0	22	0	0
13	32642568	.	A	T	15	6	21	0	0	21	0	0
13	32642618	.	T	A	4	3	7	0	0	7	0	0
13	32643073	.	A	G	1	2	3	0	0	3	0	0
13	32643143	.	G	A	5	5	10	0	0	10	0	0
13	32643326	.	G	A	3	4	7	0	0	7	0	0
13	32643414	.	A	T	5	2	7	0	0	7	0	0
13	32643696	.	T	G	2	6	8	0	0	8	0	0
13	32660774	.	T	C	2	2	4	0	0	4	0	0
13	32665008	.	A	C	3	3	6	0	0	6	0	0
13	32665035	.	G	A	2	2	4	0	0	4	0	0
13	32726095	.	G	T	3	2	5	0	0	5	0	0
13	32726099	.	G	A	3	1	4	0	1	5	0	0
13	32726152	.	G	C	2	3	5	0	0	5	0	0
13	32794925	.	T	C	4	2	6	0	1	7	0	0
13	32795072	.	A	G	2	0	2	0	5	7	0	0
13	32795387	.	T	C	3	4	7	0	0	7	0	0
13	32795882	.	A	C	1	3	4	0	0	4	0	0
13	32807491	.	C	T	2	5	7	0	0	7	0	0
13	32812168	.	G	A	1	1	2	0	0	2	0	0
13	32812265	.	G	T	2	2	4	0	0	4	0	0
13	32812521	.	C	G	1	2	3	0	0	3	0	0
13	32815765	.	C	T	8	4	12	0	0	12	0	0
13	32825086	.	C	T	2	5	7	0	0	7	0	0
13	32825143	.	A	C	7	1	8	0	9	17	0	0
13	32825149	.	T	C	7	1	8	0	9	17	0	0
13	32827410	.	T	C	0	1	1	0	0	1	0	0
13	32827754	.	A	G	1	0	1	0	0	1	0	0
13	32838241	.	C	A	0	3	3	0	0	3	0	0
13	32838254	.	C	T	0	1	1	0	0	1	0	0
13	32838276	.	T	A	0	1	1	0	0	1	0	0
13	32838468	.	A	G	4	8	12	0	2	14	0	0
13	32838507	.	T	A	5	7	12	0	0	12	0	0
13	32844487	.	C	G	0	1	1	0	0	1	0	0
13	32902537	.	T	G	1	3	4	0	0	4	0	0
13	32902545	.	G	A	0	3	3	0	1	4	0	0
13	32993962	.	C	T	0	17	17	0	10	27	0	0
13	32994526	.	T	C	7	9	16	0	0	16	0	0
13	32994565	.	T	A	8	6	14	0	1	15	0	0
13	32994697	.	G	T	6	5	11	0	2	14	1	0
13	32994736	.	A	G	6	12	18	0	0	18	0	0
13	32994841	.	A	G	4	6	10	0	0	10	0	0
13	32997196	.	A	T	5	8	13	0	0	13	0	0
13	32997224	.	C	A	5	16	21	0	0	21	0	0
13	32997260	.	T	C	7	13	20	0	0	20	0	0
13	32997424	.	G	T	5	11	16	0	0	16	0	0
13	32997517	.	T	A	8	17	25	0	2	27	0	0
13	33000574	.	C	T	0	7	7	0	3	10	0	0
13	33000586	.	T	C	3	9	12	0	1	13	0	0
13	33005284	.	T	C	8	21	29	0	3	32	0	0
13	33005346	.	G	A	3	6	9	0	0	9	0	0
13	33007766	.	C	T	1	6	7	0	0	7	0	0
13	33020054	.	T	C	0	0	0	0	1	1	0	0
13	33021814	.	G	T	1	4	5	0	0	5	0	0
13	33024743	.	A	C	3	5	8	0	0	8	0	0
13	33024789	.	G	C	15	11	26	0	0	26	0	0
13	33029576	.	A	T	7	12	19	0	0	19	0	0
13	33029594	.	G	A	1	16	17	0	10	27	0	0
13	33029624	.	G	T	0	9	9	0	12	21	0	0
13	33031915	.	A	G	4	2	6	0	0	6	0	0
13	33033330	.	C	T	11	15	26	0	0	26	0	0
13	33033354	.	A	G	21	19	40	0	0	40	0	0
13	33033688	.	T	C	19	29	48	0	2	50	0	0
13	33041354	.	A	C	3	2	5	0	2	7	0	0
13	33048095	.	T	C	9	5	14	0	0	14	0	0
13	33048096	.	G	A	9	5	14	0	0	14	0	0
13	33054598	.	T	C	1	1	2	0	0	2	0	0
13	33054706	.	G	A	2	3	5	0	0	5	0	0
13	33059179	.	C	T	0	2	2	0	0	2	0	0
13	33059257	.	T	C	5	6	11	0	1	12	0	0
13	33059260	.	A	G	6	6	12	0	0	12	0	0
13	33062352	.	G	C	11	8	19	0	0	19	0	0
13	33062367	.	C	T	14	8	22	0	0	22	0	0
13	33065614	.	A	C	10	11	21	0	0	21	0	0
13	33066691	.	C	A	0	2	2	0	7	9	0	0
13	33066778	.	T	C	1	1	2	0	0	2	0	0
13	33066782	.	G	T	1	1	2	0	0	2	0	0
13	33066882	.	A	C	1	3	4	0	0	4	0	0
13	33066893	.	A	T	2	2	4	0	0	4	0	0
13	33067406	.	A	C	4	0	4	0	2	6	0	0
13	33067413	.	A	G	4	2	6	0	0	6	0	0
13	33067506	.	A	T	3	3	6	0	0	6	0	0
13	33067622	.	T	C	2	3	5	0	1	6	0	0
13	33077094	.	C	T	3	2	5	0	0	5	0	0
13	33078885	.	C	A	0	3	3	0	0	3	0	0
13	33079270	.	A	G	1	3	4	0	0	4	0	0
13	33083495	.	A	G	1	3	4	0	0	4	0	0
13	33122141	.	T	C	2	6	8	0	1	9	0	0
13	33122276	.	T	A	13	7	20	0	1	21	0	0
13	33122312	.	C	A	11	9	20	0	0	20	0	0
13	33122429	.	C	G	10	10	20	0	0	20	0	0
13	33122519	.	T	C	7	9	16	0	2	18	0	0
13	33122541	.	G	T	6	7	13	0	1	15	1	0
13	33122554	.	A	T	5	8	13	0	1	14	0	0
13	33122626	.	A	T	14	8	22	0	2	24	0	0
13	33122642	.	G	A	17	10	27	0	0	27	0	0
13	33122847	.	T	G	9	0	9	0	15	24	0	0
13	33122853	.	C	A	9	15	24	0	1	25	0	0
13	33122986	.	A	G	12	1	13	0	10	23	0	0
13	33174533	.	G	A	7	2	9	0	0	9	0	0
13	33174645	.	G	A	8	7	15	0	0	15	0	0
13	33174681	.	G	A	9	5	14	0	0	14	0	0
13	33174732	.	A	G	7	5	12	0	0	12	0	0
13	33174759	.	G	A	9	5	14	0	1	15	0	0
13	33175097	.	A	C	4	7	11	0	0	11	0	0
13	33175126	.	C	A	5	3	8	0	0	8	0	0
13	33177425	.	G	T	2	2	4	0	1	5	0	0
13	33177682	.	C	G	0	4	4	0	5	9	0	0
13	33190239	.	G	C	1	0	1	0	1	2	0	0
13	33192619	.	C	A	1	4	5	0	0	5	0	0
13	33194490	.	A	C	5	3	8	0	0	8	0	0
13	33194527	.	G	C	4	3	7	0	0	7	0	0
13	33197897	.	C	T	0	1	1	0	0	1	0	0
13	33211397	.	T	A	8	6	14	0	0	14	0	0
13	33211445	.	A	T	4	7	11	0	2	13	0	0
13	33214664	.	C	T	0	5	5	0	2	7	0	0
13	33214706	.	C	T	7	11	18	0	0	18	0	0
13	33214709	.	T	C	7	10	17	0	2	19	0	0
13	33216341	.	G	A	11	10	21	0	0	21	0	0
13	33218214	.	C	T	6	2	8	0	0	8	0	0
13	33219988	.	C	A	0	2	2	0	5	7	0	0
13	33220164	.	A	G	4	3	7	0	0	7	0	0
13	33222342	.	C	A	0	1	1	0	1	2	0	0
13	33222396	.	G	A	2	3	5	0	0	5	0	0
13	33224742	.	G	T	9	8	17	0	1	18	0	0
13	33224932	.	C	T	0	7	7	0	4	11	0	0
13	33225029	.	G	A	4	2	6	0	0	6	0	0
13	33229502	.	T	G	8	5	13	0	0	13	0	0
13	33229739	.	T	C	15	14	29	0	0	29	0	0
13	33229753	.	C	T	13	13	26	0	2	28	0	0
13	33230024	.	A	T	20	15	35	0	3	39	1	0
13	33230163	.	G	C	12	17	29	0	1	30	0	0
13	33230177	.	G	A	10	16	26	0	1	27	0	0
13	33230518	.	T	C	7	0	7	0	14	21	0	0
13	33234522	.	C	T	1	13	14	0	1	15	0	0
13	33236111	.	T	C	2	3	5	0	1	6	0	0
13	33236482	.	G	T	3	3	6	0	0	6	0	0
13	33236691	.	A	G	2	5	7	0	0	7	0	0
13	33239219	.	G	A	6	6	12	0	0	12	0	0
13	33242878	.	C	T	4	1	5	0	1	6	0	0
13	33246227	.	T	A	3	9	12	0	0	12	0	0
13	33246249	.	T	A	3	12	15	0	1	16	0	0
13	33248351	.	C	T	4	6	10	0	0	10	0	0
13	33248677	.	T	A	7	7	14	0	2	16	0	0
13	33250992	.	T	A	8	12	20	0	0	20	0	0
13	33251058	.	C	G	3	0	3	0	3	6	0	0
13	33252236	.	C	T	1	1	2	0	0	2	0	0
13	33261198	.	A	G	22	15	37	0	1	38	0	0
13	33261228	.	C	T	26	26	52	0	1	53	0	0
13	33261303	.	A	T	16	26	42	0	3	46	1	0
13	33261326	.	A	T	14	38	52	0	2	54	0	0
13	33261340	.	C	T	13	30	43	0	2	45	0	0
13	33261389	.	T	G	23	13	36	0	3	39	0	0
13	33261577	.	C	G	27	23	50	0	3	53	0	0
13	33261620	.	T	C	26	15	41	0	1	42	0	0
13	33261637	.	G	T	22	10	32	0	2	38	4	0
13	33262044	.	C	A	29	27	56	0	1	57	0	0
13	33262721	.	A	T	13	14	27	0	0	27	0	0
13	33262749	.	A	C	15	15	30	0	2	32	0	0
13	33262909	.	G	T	14	18	32	0	1	33	0	0
13	33262944	.	C	G	15	18	33	0	1	34	0	0
13	33263503	.	G	T	15	21	36	0	3	39	0	0
13	33263985	.	C	A	8	16	24	0	1	25	0	0
13	33264001	.	G	A	13	15	28	0	0	28	0	0
13	33264315	.	T	C	22	20	42	0	5	48	1	0
13	33264318	.	C	T	26	20	46	0	3	49	0	0
13	33264470	.	A	G	13	17	30	0	1	31	0	0
13	33264483	.	T	A	13	13	26	0	2	28	0	0
13	33264635	.	A	T	11	9	20	0	1	21	0	0
13	33264772	.	A	T	8	16	24	0	0	24	0	0
13	33265061	.	G	T	14	16	30	0	1	31	0	0
13	33265062	.	G	T	14	17	31	0	0	31	0	0
13	33265128	.	T	C	13	1	14	0	11	25	0	0
13	33265210	.	T	G	17	16	33	0	0	33	0	0
13	33265323	.	A	C	14	13	27	0	0	27	0	0
13	33265364	.	G	T	17	15	32	0	1	33	0	0
13	33268757	.	A	T	2	5	7	0	1	8	0	0
13	33268791	.	T	C	1	2	3	0	0	3	0	0
13	33276048	.	T	C	2	4	6	0	0	6	0	0
13	33276106	.	T	C	1	2	3	0	0	3	0	0
13	33276192	.	C	G	1	0	1	0	4	5	0	0
13	33280769	.	C	A	1	0	1	0	0	1	0	0
13	33281138	.	G	T	0	3	3	0	6	9	0	0
13	33281218	.	G	A	1	3	4	0	2	6	0	0
13	33282227	.	G	A	3	2	5	0	0	5	0	0
13	33282236	.	A	G	3	2	5	0	0	5	0	0
13	33293608	.	C	A	2	4	6	0	0	6	0	0
13	33293639	.	G	A	0	2	2	0	3	5	0	0
13	33294207	.	C	T	2	4	6	0	0	6	0	0
13	33295894	.	T	A	5	4	9	0	0	9	0	0
13	33300594	.	A	T	1	0	1	0	0	1	0	0
13	33310614	.	C	T	1	1	2	0	0	2	0	0
13	33313037	.	T	C	3	1	4	0	0	4	0	0
13	33314840	.	A	T	2	3	5	0	0	5	0	0
13	33314863	.	T	C	3	3	6	0	0	6	0	0
13	33314946	.	T	C	3	5	8	0	0	8	0	0
13	33315112	.	C	G	1	2	3	0	0	3	0	0
13	33316844	.	C	T	0	1	1	0	0	1	0	0
13	33317022	.	T	C	4	3	7	0	0	7	0	0
13	33381160	.	C	T	0	3	3	0	0	3	0	0
13	33394476	.	A	C	21	21	42	0	1	43	0	0
13	33394887	.	G	A	18	24	42	0	2	45	1	0
13	33394976	.	T	C	18	19	37	0	1	38	0	0
13	33395174	.	C	G	16	17	33	0	1	34	0	0
13	33395256	.	T	G	9	12	21	0	0	21	0	0
13	33396026	.	A	C	3	0	3	0	4	7	0	0
13	33398365	.	C	T	14	16	30	0	0	30	0	0
13	33398498	.	G	A	12	9	21	0	1	22	0	0
13	33411068	.	C	T	2	2	4	0	0	4	0	0
13	33411082	.	G	A	2	2	4	0	0	4	0	0
13	33445279	.	G	A	1	1	2	0	0	2	0	0
13	33447321	.	T	C	1	2	3	0	0	3	0	0
13	33448010	.	G	A	2	2	4	0	0	4	0	0
13	33609129	.	T	C	3	5	8	0	0	8	0	0
13	33612347	.	C	T	5	8	13	0	1	14	0	0
13	33619849	.	A	G	5	1	6	0	0	6	0	0
13	33633271	.	T	A	1	2	3	0	0	3	0	0
13	33636548	.	T	C	3	0	3	0	1	4	0	0
13	33636597	.	G	A	3	2	5	0	0	5	0	0
13	33645567	.	C	T	4	3	7	0	1	8	0	0
13	33645649	.	A	T	3	5	8	0	1	9	0	0
13	33645892	.	C	T	5	4	9	0	0	9	0	0
13	33645931	.	C	T	1	4	5	0	0	5	0	0
13	33646059	.	A	G	3	5	8	0	0	8	0	0
13	33646123	.	T	A	7	4	11	0	0	11	0	0
13	33646132	.	A	T	7	5	12	0	0	12	0	0
13	33646285	.	G	A	5	3	8	0	0	8	0	0
13	33646333	.	T	C	4	0	4	0	3	7	0	0
13	33646401	.	G	A	3	3	6	0	0	6	0	0
13	33646436	.	A	G	4	5	9	0	0	9	0	0
13	33646445	.	A	T	5	5	10	0	0	10	0	0
13	33649184	.	T	G	4	6	10	0	1	11	0	0
13	33655957	.	A	T	1	4	5	0	0	5	0	0
13	33656297	.	A	C	1	4	5	0	0	5	0	0
13	33656334	.	T	A	2	3	5	0	0	5	0	0
13	33656357	.	T	C	2	3	5	0	0	5	0	0
13	33665483	.	G	T	0	2	2	0	0	2	0	0
13	33682023	.	C	T	9	22	31	0	3	34	0	0
13	33682052	.	T	C	17	24	41	0	1	42	0	0
13	33682068	.	A	C	22	31	53	0	1	54	0	0
13	33682216	.	C	T	14	23	37	0	1	38	0	0
13	33682217	.	A	T	13	24	37	0	1	38	0	0
13	33682379	.	C	A	13	3	16	0	2	18	0	0
13	33682731	.	G	A	13	18	31	0	1	32	0	0
13	33683824	.	A	C	19	32	51	0	3	54	0	0
13	33683829	.	A	T	17	29	46	0	3	50	1	0
13	33695031	.	G	A	0	2	2	0	2	4	0	0
13	33813428	.	A	C	10	14	24	0	0	24	0	0
13	33813452	.	T	G	10	15	25	0	0	25	0	0
13	33813792	.	C	T	12	12	24	0	1	25	0	0
13	33814644	.	A	C	5	6	11	0	1	12	0	0
13	33814647	.	T	A	5	7	12	0	0	12	0	0
13	33814773	.	C	T	12	13	25	0	0	25	0	0
13	33815863	.	C	A	4	1	5	0	0	5	0	0
13	33815992	.	C	T	5	4	9	0	1	10	0	0
13	33816200	.	C	T	2	3	5	0	1	6	0	0
13	33816442	.	C	T	2	6	8	0	0	8	0	0
13	33816509	.	A	G	1	2	3	0	0	3	0	0
13	33816518	.	T	C	1	1	2	0	0	2	0	0
13	33968506	.	T	C	3	5	8	0	0	8	0	0
13	34488737	.	T	G	0	3	3	0	1	4	0	0
13	34519607	.	T	A	1	2	3	0	0	3	0	0
13	34697636	.	T	G	0	1	1	0	0	1	0	0
13	34703994	.	T	C	1	1	2	0	0	2	0	0
13	34746145	.	A	T	1	2	3	0	0	3	0	0
13	34746480	.	A	G	1	4	5	0	0	5	0	0
13	34746847	.	A	G	3	2	5	0	2	7	0	0
13	34746941	.	A	G	1	0	1	0	3	4	0	0
13	34747137	.	G	A	0	3	3	0	1	4	0	0
13	34747473	.	T	C	2	2	4	0	0	4	0	0
13	34747501	.	T	C	2	2	4	0	0	4	0	0
13	34747734	.	A	G	3	0	3	0	7	10	0	0
13	34747916	.	A	C	2	2	4	0	0	4	0	0
13	34748086	.	G	T	2	7	9	0	0	9	0	0
13	34748199	.	C	A	6	3	9	0	0	9	0	0
13	34748362	.	C	T	1	4	5	0	1	6	0	0
13	34748479	.	A	G	5	2	7	0	1	8	0	0
13	34748516	.	C	T	4	8	12	0	0	12	0	0
13	34748791	.	G	T	4	2	6	0	1	7	0	0
13	34748959	.	A	T	5	3	8	0	1	9	0	0
13	34748990	.	T	A	8	4	12	0	0	12	0	0
13	34749079	.	G	T	5	3	8	0	0	8	0	0
13	34749142	.	G	T	0	3	3	0	0	3	0	0
13	34749530	.	G	T	0	4	4	0	7	11	0	0
13	34749542	.	A	G	6	5	11	0	0	11	0	0
13	34749616	.	C	T	5	6	11	0	1	12	0	0
13	34749743	.	G	T	7	7	14	0	0	14	0	0
13	34749751	.	C	T	6	7	13	0	0	13	0	0
13	34749819	.	C	T	9	9	18	0	1	19	0	0
13	34749833	.	A	G	10	12	22	0	0	22	0	0
13	34749936	.	T	A	12	5	17	0	0	17	0	0
13	34765346	.	T	G	5	2	7	0	0	7	0	0
13	34765383	.	G	A	3	2	5	0	1	6	0	0
13	34765556	.	C	T	2	3	5	0	0	5	0	0
13	34765639	.	G	A	2	3	5	0	0	5	0	0
13	34765690	.	A	G	3	3	6	0	0	6	0	0
13	34793343	.	T	C	2	2	4	0	0	4	0	0
13	35042138	.	C	T	20	19	39	0	1	40	0	0
13	35042237	.	G	A	16	21	37	0	1	38	0	0
13	35042279	.	G	A	20	21	41	0	1	42	0	0
13	35042354	.	G	T	16	17	33	0	0	33	0	0
13	35049461	.	A	G	1	4	5	0	0	5	0	0
13	35051624	.	C	T	0	7	7	0	10	17	0	0
13	35051786	.	T	C	13	9	22	0	1	23	0	0
13	35051880	.	G	A	2	9	11	0	0	11	0	0
13	35474933	.	A	G	1	2	3	0	0	3	0	0
13	35474939	.	G	T	1	2	3	0	0	3	0	0
13	35481419	.	C	T	0	2	2	0	0	2	0	0
13	35481452	.	T	C	1	3	4	0	0	4	0	0
13	35527647	.	G	T	3	3	6	0	0	6	0	0
13	35672184	.	T	G	0	2	2	0	0	2	0	0
13	35672208	.	G	A	0	1	1	0	0	1	0	0
13	35720956	.	A	G	0	0	0	0	1	1	0	0
13	35722421	.	A	G	1	2	3	0	0	3	0	0
13	35722703	.	G	A	1	0	1	0	0	1	0	0
13	35726735	.	G	C	1	2	3	0	0	3	0	0
13	35728714	.	A	G	1	1	2	0	0	2	0	0
13	35744431	.	T	A	1	3	4	0	0	4	0	0
13	35744584	.	C	T	0	5	5	0	1	6	0	0
13	35745657	.	T	C	3	3	6	0	0	6	0	0
13	35746343	.	A	G	2	0	2	0	3	5	0	0
13	35746637	.	C	T	10	7	17	0	1	18	0	0
13	35746838	.	T	C	9	7	16	0	1	17	0	0
13	35747177	.	T	G	11	9	20	0	0	21	1	0
13	35747690	.	A	G	13	2	15	0	16	31	0	0
13	35747918	.	T	C	21	25	46	0	0	46	0	0
13	35747954	.	T	C	20	26	46	0	1	47	0	0
13	35748096	.	C	G	17	1	18	0	23	41	0	0
13	35748249	.	G	A	13	21	34	0	3	37	0	0
13	35748319	.	T	C	11	12	23	0	1	24	0	0
13	35751047	.	T	C	7	8	15	0	3	18	0	0
13	35751211	.	T	C	9	9	18	0	0	18	0	0
13	35752964	.	T	C	2	0	2	0	0	2	0	0
13	35756029	.	G	T	6	5	11	0	0	11	0	0
13	35757338	.	T	G	4	6	10	0	0	10	0	0
13	35758111	.	G	T	0	1	1	0	0	1	0	0
13	35759904	.	G	A	0	1	1	0	1	2	0	0
13	35788222	.	G	A	4	9	13	0	0	13	0	0
13	35788302	.	A	C	13	12	25	0	0	25	0	0
13	35788313	.	T	C	13	13	26	0	0	26	0	0
13	35788507	.	G	A	17	12	29	0	0	29	0	0
13	35788562	.	C	G	4	11	15	0	19	34	0	0
13	35791419	.	C	G	10	9	19	0	0	19	0	0
13	35791539	.	G	A	4	6	10	0	1	11	0	0
13	35796882	.	C	T	11	6	17	0	1	18	0	0
13	35796894	.	G	A	11	7	18	0	0	18	0	0
13	35796924	.	C	T	0	5	5	0	6	11	0	0
13	35798915	.	A	G	4	3	7	0	0	7	0	0
13	35798960	.	T	C	6	6	12	0	1	13	0	0
13	35798966	.	G	C	4	7	11	0	0	11	0	0
13	35799146	.	G	A	4	0	4	0	0	4	0	0
13	35799194	.	C	T	9	2	11	0	1	12	0	0
13	35799230	.	A	G	2	1	3	0	1	4	0	0
13	35801452	.	A	G	13	8	21	0	0	21	0	0
13	35801473	.	A	G	14	8	22	0	0	22	0	0
13	35801501	.	T	C	7	0	7	0	2	9	0	0
13	35808949	.	T	C	5	3	8	0	0	8	0	0
13	35811400	.	A	G	2	2	4	0	0	4	0	0
13	35811852	.	C	G	3	3	6	0	0	6	0	0
13	35811907	.	A	G	5	1	6	0	0	6	0	0
13	35813549	.	A	G	1	4	5	0	1	6	0	0
13	35813666	.	C	T	0	2	2	0	3	5	0	0
13	35820971	.	G	A	2	3	5	0	0	5	0	0
13	35824806	.	A	G	4	3	7	0	0	7	0	0
13	35872207	.	C	T	5	7	12	0	0	12	0	0
13	35872493	.	T	A	3	3	6	0	0	6	0	0
13	35872495	.	C	A	3	3	6	0	0	6	0	0
13	35883450	.	T	C	5	0	5	0	0	5	0	0
13	35904477	.	T	C	1	0	1	0	3	4	0	0
13	35904650	.	A	G	3	3	6	0	0	6	0	0
13	35904738	.	C	T	0	2	2	0	3	5	0	0
13	35905265	.	A	G	5	3	8	0	0	8	0	0
13	35907171	.	A	C	3	2	5	0	0	5	0	0
13	35950431	.	A	G	3	1	4	0	0	4	0	0
13	35950440	.	C	T	2	0	2	0	0	2	0	0
13	35950720	.	G	A	4	2	6	0	0	6	0	0
13	35953558	.	G	A	8	5	13	0	0	13	0	0
13	35961166	.	C	A	0	2	2	0	0	2	0	0
13	36039938	.	G	A	19	28	47	0	2	49	0	0
13	36040061	.	G	T	19	20	39	0	2	41	0	0
13	36040127	.	A	T	24	25	49	0	2	52	1	0
13	36040278	.	T	C	17	0	17	0	19	36	0	0
13	36040473	.	A	C	6	10	16	0	0	16	0	0
13	36040611	.	C	T	0	12	12	0	11	23	0	0
13	36040635	.	C	A	9	7	16	0	1	17	0	0
13	36042020	.	T	A	11	10	21	0	0	21	0	0
13	36042057	.	C	T	13	16	29	0	1	30	0	0
13	36042091	.	G	C	14	9	23	0	2	25	0	0
13	36043781	.	T	A	8	11	19	0	0	19	0	0
13	36043796	.	T	C	4	0	4	0	7	11	0	0
13	36043820	.	T	C	1	0	1	0	0	1	0	0
13	36048931	.	A	G	7	5	12	0	1	13	0	0
13	36048981	.	C	T	2	2	4	0	1	5	0	0
13	36054962	.	T	C	16	14	30	0	1	31	0	0
13	36057124	.	C	T	2	5	7	0	1	8	0	0
13	36060640	.	G	A	18	9	27	0	4	31	0	0
13	36060679	.	T	G	17	15	32	0	1	33	0	0
13	36062661	.	T	A	1	3	4	0	1	5	0	0
13	36067938	.	A	G	2	2	4	0	0	4	0	0
13	36072451	.	C	T	0	3	3	0	1	4	0	0
13	36074085	.	T	C	0	0	0	0	3	3	0	0
13	36074176	.	G	A	6	2	8	0	0	8	0	0
13	36083861	.	G	A	2	1	3	0	0	3	0	0
13	36086313	.	G	T	1	5	6	0	0	6	0	0
13	36086415	.	G	A	2	6	8	0	0	8	0	0
13	36102706	.	C	T	0	1	1	0	1	2	0	0
13	36103049	.	G	C	2	3	5	0	1	6	0	0
13	36135287	.	T	A	4	4	8	0	0	8	0	0
13	36135416	.	A	G	2	5	7	0	0	7	0	0
13	36136585	.	A	G	3	5	8	0	0	8	0	0
13	36136669	.	C	G	0	3	3	0	3	6	0	0
13	36146596	.	G	A	17	7	24	0	0	24	0	0
13	36151407	.	G	C	3	4	7	0	1	8	0	0
13	36151462	.	G	A	4	7	11	0	1	12	0	0
13	36151635	.	T	C	12	8	20	0	0	20	0	0
13	36151636	.	C	T	11	8	19	0	1	20	0	0
13	36151894	.	G	C	14	13	27	0	1	28	0	0
13	36151929	.	C	T	14	9	23	0	0	23	0	0
13	36152364	.	T	C	21	29	50	0	0	50	0	0
13	36152402	.	C	T	25	27	52	0	0	52	0	0
13	36152415	.	A	G	24	24	48	0	2	50	0	0
13	36152440	.	T	G	23	1	24	0	22	46	0	0
13	36152700	.	T	A	22	11	33	0	1	34	0	0
13	36152733	.	A	G	18	9	27	0	0	27	0	0
13	36152778	.	A	G	12	15	27	0	0	27	0	0
13	36152795	.	A	C	10	12	22	0	0	23	1	0
13	36152838	.	A	G	7	0	7	0	8	15	0	0
13	36152874	.	C	T	5	8	13	0	1	14	0	0
13	36153063	.	T	A	1	5	6	0	1	7	0	0
13	36153098	.	G	A	3	4	7	0	0	7	0	0
13	36153112	.	G	T	3	3	6	0	0	6	0	0
13	36153313	.	T	C	11	11	22	0	0	22	0	0
13	36153382	.	C	T	13	10	23	0	1	24	0	0
13	36168770	.	C	T	1	1	2	0	0	2	0	0
13	36168861	.	G	T	0	2	2	0	0	2	0	0
13	36179661	.	G	C	2	2	4	0	0	4	0	0
13	36179697	.	C	T	1	5	6	0	1	7	0	0
13	36179838	.	C	T	3	4	7	0	0	7	0	0
13	36179844	.	A	T	3	3	6	0	0	6	0	0
13	36263596	.	T	C	1	2	3	0	0	3	0	0
13	36312193	.	G	T	12	8	20	0	0	20	0	0
13	36312361	.	C	A	6	3	9	0	0	9	0	0
13	36312447	.	A	G	5	3	8	0	1	9	0	0
13	36312469	.	T	G	6	4	10	0	0	10	0	0
13	36312497	.	C	T	0	4	4	0	6	10	0	0
13	36312682	.	G	A	1	3	4	0	1	5	0	0
13	36321256	.	C	T	3	2	5	0	0	5	0	0
13	36322099	.	C	T	0	11	11	0	12	23	0	0
13	36322133	.	A	G	11	12	23	0	2	25	0	0
13	36330642	.	G	A	4	4	8	0	0	8	0	0
13	36335033	.	G	A	3	2	5	0	0	5	0	0
13	36335057	.	A	G	1	1	2	0	0	2	0	0
13	36335206	.	A	G	0	1	1	0	0	1	0	0
13	36337349	.	T	C	0	0	0	0	1	1	0	0
13	36338262	.	A	G	1	1	2	0	1	3	0	0
13	36349674	.	G	A	1	0	1	0	0	1	0	0
13	36409233	.	A	T	2	6	8	0	0	8	0	0
13	36409246	.	C	T	1	4	5	0	2	7	0	0
13	36409522	.	T	C	7	0	7	0	9	16	0	0
13	36409691	.	A	G	10	13	23	0	0	23	0	0
13	36410339	.	T	C	6	4	10	0	3	13	0	0
13	36410671	.	T	C	3	2	5	0	0	5	0	0
13	36418735	.	A	T	0	1	1	0	1	2	0	0
13	36424414	.	G	A	5	2	7	0	1	8	0	0
13	36438831	.	C	T	3	2	5	0	0	5	0	0
13	36450109	.	C	T	2	1	3	0	0	3	0	0
13	36452977	.	A	G	2	1	3	0	1	4	0	0
13	36467504	.	G	A	2	1	3	0	0	3	0	0
13	37076328	.	T	C	22	6	28	0	0	28	0	0
13	37658840	.	T	C	2	2	4	0	0	4	0	0
13	38304824	.	A	G	3	3	6	0	0	6	0	0
13	38446709	.	A	G	8	0	8	0	1	9	0	0
13	38466196	.	G	A	1	1	2	0	0	2	0	0
13	38466247	.	C	T	5	6	11	0	1	12	0	0
13	38466343	.	T	C	5	2	7	0	0	7	0	0
13	38566611	.	A	G	3	0	3	0	1	4	0	0
13	38583699	.	C	A	18	23	41	0	3	44	0	0
13	38583714	.	A	G	20	20	40	0	2	42	0	0
13	38593559	.	A	G	29	23	52	0	2	54	0	0
13	38593574	.	A	T	31	21	52	0	1	53	0	0
13	38621607	.	G	T	1	4	5	0	0	5	0	0
13	38622184	.	C	T	0	5	5	0	10	15	0	0
13	38666128	.	G	A	9	3	12	0	0	12	0	0
13	39111051	.	G	A	1	3	4	0	0	4	0	0
13	39111894	.	G	C	0	3	3	0	1	4	0	0
13	39112434	.	C	T	1	4	5	0	0	5	0	0
13	39112550	.	A	G	1	2	3	0	0	3	0	0
13	39112664	.	T	C	1	3	4	0	0	4	0	0
13	39113101	.	G	T	4	5	9	0	0	9	0	0
13	39114444	.	C	A	2	2	4	0	0	4	0	0
13	39114474	.	G	T	4	2	6	0	0	6	0	0
13	39115018	.	G	T	0	2	2	0	1	3	0	0
13	39115087	.	T	A	2	2	4	0	0	4	0	0
13	39115092	.	A	T	2	2	4	0	0	4	0	0
13	39115274	.	A	T	1	1	2	0	0	2	0	0
13	39115534	.	A	G	4	0	4	0	5	9	0	0
13	39119589	.	C	T	1	2	3	0	0	3	0	0
13	39214557	.	G	A	0	1	1	0	0	1	0	0
13	39217377	.	C	T	3	5	8	0	0	8	0	0
13	39217506	.	C	T	4	5	9	0	1	10	0	0
13	39217657	.	C	T	5	6	11	0	0	11	0	0
13	39217887	.	T	G	4	0	4	0	4	8	0	0
13	39218060	.	T	C	4	3	7	0	0	7	0	0
13	39218097	.	A	G	5	3	8	0	0	8	0	0
13	39218292	.	C	T	3	6	9	0	0	9	0	0
13	39218602	.	A	G	8	1	9	0	6	15	0	0
13	39218706	.	T	C	10	7	17	0	0	17	0	0
13	39218843	.	G	A	0	5	5	0	11	16	0	0
13	39221960	.	T	C	1	2	3	0	0	3	0	0
13	39223774	.	A	G	3	2	5	0	0	5	0	0
13	39224003	.	C	T	0	1	1	0	0	1	0	0
13	39226666	.	T	C	6	7	13	0	0	13	0	0
13	39227275	.	G	A	1	6	7	0	12	19	0	0
13	39228272	.	G	A	6	4	10	0	1	11	0	0
13	39268161	.	T	C	1	1	2	0	0	2	0	0
13	39292392	.	T	C	1	1	2	0	0	2	0	0
13	39293300	.	T	A	1	2	3	0	0	3	0	0
13	39293304	.	A	C	1	1	2	0	0	2	0	0
13	39302521	.	A	G	3	0	3	0	1	4	0	0
13	39302539	.	C	T	4	1	5	0	0	5	0	0
13	39303122	.	T	C	3	2	5	0	0	5	0	0
13	39303161	.	A	C	1	0	1	0	0	1	0	0
13	39533216	.	A	G	1	2	3	0	0	3	0	0
13	39533223	.	C	T	1	2	3	0	0	3	0	0
13	39657068	.	A	G	8	7	15	0	1	16	0	0
13	39657140	.	C	T	0	8	8	0	11	19	0	0
13	39657285	.	T	C	3	2	5	0	0	5	0	0
13	39657625	.	A	C	4	6	10	0	0	10	0	0
13	39657652	.	A	G	5	6	11	0	0	11	0	0
13	39830658	.	C	G	1	3	4	0	0	4	0	0
13	40335087	.	T	G	12	4	16	0	1	17	0	0
13	40344258	.	C	T	3	2	5	0	0	5	0	0
13	40344303	.	G	A	0	7	7	0	8	15	0	0
13	40351869	.	G	A	14	8	22	0	3	25	0	0
13	40351914	.	G	A	0	11	11	0	13	24	0	0
13	40351953	.	C	T	12	12	24	0	0	24	0	0
13	40352345	.	C	T	13	11	24	0	1	25	0	0
13	40352349	.	C	G	12	11	23	0	2	25	0	0
13	40352415	.	T	G	7	14	21	0	0	21	0	0
13	40352476	.	A	G	6	7	13	0	0	13	0	0
13	40352837	.	A	G	15	0	15	0	5	20	0	0
13	40353512	.	G	T	14	10	24	0	0	24	0	0
13	40353736	.	A	C	7	10	17	0	1	18	0	0
13	40354235	.	C	T	6	5	11	0	0	11	0	0
13	40445253	.	C	T	3	2	5	0	0	5	0	0
13	40463048	.	T	A	6	5	11	0	0	11	0	0
13	40463310	.	C	A	1	5	6	0	0	6	0	0
13	40463732	.	C	T	0	8	8	0	10	18	0	0
13	40463784	.	G	C	7	0	7	0	8	15	0	0
13	40481324	.	A	T	1	0	1	0	1	2	0	0
13	40482568	.	T	A	4	5	9	0	0	9	0	0
13	40486656	.	G	A	1	1	2	0	0	2	0	0
13	40497631	.	G	A	1	0	1	0	0	1	0	0
13	40497802	.	A	G	5	2	7	0	0	7	0	0
13	40497928	.	C	T	3	5	8	0	0	8	0	0
13	40498129	.	C	G	0	4	4	0	6	10	0	0
13	40498267	.	A	G	3	3	6	0	0	6	0	0
13	40498630	.	G	A	3	2	5	0	0	5	0	0
13	40498759	.	G	A	2	3	5	0	0	5	0	0
13	40700183	.	G	A	1	1	2	0	0	2	0	0
13	40714287	.	C	T	1	2	3	0	0	3	0	0
13	40716262	.	T	C	1	2	3	0	0	3	0	0
13	40746319	.	G	C	1	3	4	0	1	5	0	0
13	40746548	.	G	A	3	5	8	0	0	8	0	0
13	40746930	.	C	A	0	1	1	0	4	5	0	0
13	40746971	.	G	T	4	4	8	0	0	8	0	0
13	40747151	.	T	C	1	4	5	0	1	6	0	0
13	40747256	.	T	A	10	6	16	0	0	16	0	0
13	40747274	.	T	C	11	0	11	0	5	16	0	0
13	40747337	.	T	A	6	6	12	0	0	12	0	0
13	40747397	.	C	A	7	6	13	0	1	14	0	0
13	40747398	.	C	A	7	6	13	0	1	14	0	0
13	40747467	.	C	T	1	5	6	0	5	11	0	0
13	40747607	.	G	T	5	7	12	0	0	12	0	0
13	40747839	.	T	C	2	3	5	0	1	6	0	0
13	40747841	.	T	C	2	0	2	0	4	6	0	0
13	40748074	.	A	G	3	2	5	1	2	8	0	0
13	40748246	.	A	C	4	6	10	0	0	10	0	0
13	40748248	.	C	A	4	6	10	0	0	10	0	0
13	40748356	.	G	T	4	5	9	0	0	9	0	0
13	40748408	.	C	T	2	2	4	0	1	5	0	0
13	40748431	.	G	A	5	2	7	0	0	7	0	0
13	40748537	.	C	G	1	4	5	0	1	6	0	0
13	40748582	.	G	A	5	5	10	0	0	10	0	0
13	40748620	.	C	T	6	3	9	0	1	10	0	0
13	40748621	.	T	A	5	4	9	0	1	10	0	0
13	40749082	.	T	C	3	2	5	0	0	5	0	0
13	40749104	.	T	C	2	2	4	0	0	4	0	0
13	40749138	.	A	C	1	1	2	0	0	2	0	0
13	40749142	.	C	T	0	2	2	0	0	2	0	0
13	40749191	.	A	G	1	4	5	0	0	5	0	0
13	40749577	.	G	A	7	2	9	0	1	10	0	0
13	40754367	.	T	G	1	0	1	0	0	1	0	0
13	40919804	.	G	T	0	1	1	0	0	1	0	0
13	41125475	.	C	T	7	8	15	0	1	16	0	0
13	41125652	.	C	T	7	4	11	0	0	11	0	0
13	41125766	.	A	G	4	8	12	0	1	13	0	0
13	41128286	.	G	A	0	3	3	0	0	3	0	0
13	41208028	.	T	C	2	2	4	0	1	5	0	0
13	41214782	.	A	G	2	0	2	0	0	2	0	0
13	41214863	.	G	A	3	7	10	0	0	10	0	0
13	41222908	.	G	A	0	1	1	0	0	1	0	0
13	41222971	.	A	G	3	4	7	0	0	7	0	0
13	41249277	.	T	C	1	1	2	0	0	2	0	0
13	41320070	.	G	C	1	2	3	0	1	4	0	0
13	41388480	.	A	G	0	1	1	0	0	1	0	0
13	41910428	.	G	A	7	5	12	0	0	12	0	0
13	41911090	.	G	A	26	14	40	0	0	40	0	0
13	41911092	.	C	A	14	26	40	0	0	40	0	0
13	41911265	.	G	A	6	15	21	0	0	21	0	0
13	41911276	.	T	C	5	18	23	0	0	23	0	0
13	41911402	.	T	A	23	11	34	0	0	34	0	0
13	41911475	.	G	T	18	7	25	0	1	26	0	0
13	41911491	.	T	C	10	0	10	0	14	24	0	0
13	41911932	.	A	G	6	5	11	0	0	11	0	0
13	41915604	.	A	G	13	8	21	0	0	21	0	0
13	41917003	.	C	A	6	3	9	0	0	9	0	0
13	41936597	.	G	A	0	2	2	0	0	2	0	0
13	41936615	.	A	G	0	3	3	0	0	3	0	0
13	41940198	.	G	A	0	2	2	0	2	4	0	0
13	41944269	.	T	A	2	3	5	0	0	5	0	0
13	41944479	.	G	A	3	3	6	0	0	6	0	0
13	41944815	.	C	A	0	6	6	0	9	15	0	0
13	41945455	.	C	T	5	2	7	0	1	8	0	0
13	41945464	.	C	T	0	5	5	0	2	7	0	0
13	41945632	.	C	T	0	8	8	0	4	12	0	0
13	41945737	.	A	G	3	5	8	0	0	8	0	0
13	41945762	.	T	A	5	2	7	0	1	8	0	0
13	41947874	.	C	T	3	3	6	0	0	6	0	0
13	41947882	.	C	T	1	3	4	0	3	7	0	0
13	42018338	.	G	A	0	3	3	0	4	7	0	0
13	42049465	.	A	C	2	1	3	0	0	3	0	0
13	42142194	.	C	A	7	9	16	0	1	17	0	0
13	42142296	.	T	C	7	5	12	0	0	12	0	0
13	42142854	.	G	A	11	12	23	0	1	24	0	0
13	42143118	.	G	A	0	6	6	0	10	16	0	0
13	42143285	.	A	T	9	12	21	0	0	21	0	0
13	42143294	.	T	G	13	8	21	0	1	22	0	0
13	42143572	.	T	A	5	2	7	0	0	7	0	0
13	42143581	.	T	A	3	1	4	0	0	4	0	0
13	42349499	.	C	T	5	5	10	0	1	11	0	0
13	42349683	.	C	T	7	9	16	0	0	16	0	0
13	42361795	.	A	G	13	9	22	0	0	22	0	0
13	42365043	.	A	G	0	2	2	0	0	2	0	0
13	42365121	.	T	C	7	10	17	0	0	17	0	0
13	42365139	.	T	C	7	0	7	0	7	14	0	0
13	42365374	.	C	T	6	4	10	0	0	10	0	0
13	42400391	.	T	A	3	8	11	0	0	11	0	0
13	42400473	.	C	T	13	10	23	0	1	24	0	0
13	42407519	.	C	T	3	6	9	0	0	9	0	0
13	42407526	.	A	G	2	6	8	0	0	8	0	0
13	42407618	.	A	C	2	5	7	0	0	7	0	0
13	42431007	.	A	G	0	1	1	0	0	1	0	0
13	42443487	.	T	C	0	2	2	0	0	2	0	0
13	42443517	.	T	C	0	2	2	0	0	2	0	0
13	42481169	.	T	C	4	9	13	0	1	14	0	0
13	42481256	.	A	G	13	8	21	0	3	24	0	0
13	42481267	.	G	A	13	8	21	0	2	23	0	0
13	42481306	.	T	C	11	6	17	0	1	18	0	0
13	42481512	.	A	G	17	17	34	0	1	35	0	0
13	42481538	.	A	G	13	20	33	0	3	36	0	0
13	42481575	.	T	C	8	15	23	0	0	23	0	0
13	42481599	.	A	G	6	6	12	0	1	13	0	0
13	42483050	.	A	G	6	17	23	0	0	23	0	0
13	42483082	.	A	G	3	11	14	0	1	15	0	0
13	42483089	.	T	C	3	9	12	0	0	12	0	0
13	42488440	.	C	T	5	6	11	0	0	11	0	0
13	42490778	.	T	C	1	4	5	0	0	5	0	0
13	42500513	.	A	T	1	2	3	0	0	3	0	0
13	42516915	.	C	G	0	2	2	0	2	4	0	0
13	42523723	.	A	T	0	1	1	0	0	1	0	0
13	42526316	.	C	T	0	2	2	0	4	6	0	0
13	42607276	.	C	G	0	2	2	0	0	2	0	0
13	42610961	.	A	T	2	4	6	0	0	6	0	0
13	42611019	.	T	C	1	3	4	0	0	4	0	0
13	42611078	.	A	G	2	1	3	0	0	3	0	0
13	42611086	.	T	C	2	0	2	0	0	2	0	0
13	42611117	.	G	C	1	0	1	0	0	1	0	0
13	42615073	.	T	G	2	7	9	0	0	9	0	0
13	42615094	.	G	A	2	4	6	0	1	7	0	0
13	42616527	.	C	A	0	7	7	0	1	8	0	0
13	42616563	.	T	C	0	1	1	0	0	1	0	0
13	42617552	.	C	T	2	3	5	0	0	5	0	0
13	42622006	.	C	T	5	6	11	0	1	12	0	0
13	42622013	.	C	T	4	7	11	0	1	12	0	0
13	42632966	.	A	G	6	6	12	0	0	12	0	0
13	42672885	.	T	G	0	1	1	0	0	1	0	0
13	42680950	.	T	A	0	2	2	0	1	3	0	0
13	42681759	.	G	T	15	11	26	0	1	27	0	0
13	42681856	.	T	G	10	17	27	0	1	28	0	0
13	42682033	.	T	A	10	9	19	1	0	20	0	0
13	42686420	.	G	T	1	0	1	0	0	1	0	0
13	42691482	.	G	T	1	3	4	0	0	4	0	0
13	42693030	.	G	A	3	3	6	0	0	6	0	0
13	42698930	.	A	T	0	1	1	0	0	1	0	0
13	42721011	.	G	A	2	5	7	0	1	8	0	0
13	42726708	.	A	T	1	3	4	0	1	5	0	0
13	42726753	.	A	G	1	3	4	0	0	4	0	0
13	42726773	.	C	T	1	3	4	0	0	4	0	0
13	43131054	.	G	T	2	2	4	0	0	4	0	0
13	43131829	.	A	G	1	1	2	0	1	3	0	0
13	43212772	.	T	A	1	2	3	0	0	3	0	0
13	43223655	.	C	A	14	7	21	0	1	23	1	0
13	43223679	.	G	A	16	14	30	0	0	30	0	0
13	43223722	.	T	G	8	9	17	0	0	17	0	0
13	43225093	.	C	T	0	7	7	0	1	8	0	0
13	43225201	.	T	C	17	0	17	0	11	28	0	0
13	43226423	.	T	A	18	18	36	0	1	37	0	0
13	43226429	.	C	T	0	14	14	0	19	33	0	0
13	43229872	.	A	C	11	16	27	0	0	27	0	0
13	43229923	.	G	A	13	11	24	0	0	24	0	0
13	43237237	.	T	C	14	7	21	0	0	21	0	0
13	43237255	.	A	C	11	0	11	0	6	17	0	0
13	43238513	.	C	A	10	7	17	0	0	17	0	0
13	43307280	.	T	C	1	0	1	0	0	1	0	0
13	43406851	.	T	C	1	2	3	0	0	3	0	0
13	43406858	.	T	C	0	3	3	0	1	4	0	0
13	43507520	.	A	G	5	6	11	0	0	11	0	0
13	43507541	.	A	G	6	14	20	0	1	21	0	0
13	43507711	.	A	T	2	3	5	0	0	5	0	0
13	43507747	.	A	G	3	9	12	0	0	12	0	0
13	43507797	.	A	C	2	13	15	0	1	16	0	0
13	43507889	.	G	A	14	19	33	0	2	35	0	0
13	43508696	.	A	G	13	13	26	0	2	28	0	0
13	43508868	.	G	A	14	14	28	0	0	28	0	0
13	43508986	.	A	G	7	8	15	0	0	15	0	0
13	43508987	.	T	A	5	7	12	0	3	15	0	0
13	43509386	.	G	A	16	11	27	0	1	28	0	0
13	43509443	.	A	T	13	15	28	0	0	28	0	0
13	43509537	.	A	G	9	13	22	0	0	22	0	0
13	43509600	.	T	A	15	16	31	0	1	32	0	0
13	43509609	.	G	A	15	14	29	0	1	31	1	0
13	45468451	.	G	T	13	5	18	0	3	21	0	0
13	45468567	.	A	T	11	34	45	0	3	48	0	0
13	45468827	.	G	C	6	1	7	0	10	17	0	0
13	45470601	.	A	G	35	23	58	0	2	60	0	0
13	45470764	.	T	C	34	20	54	0	1	55	0	0
13	45470831	.	G	T	17	19	36	0	2	38	0	0
13	45470865	.	G	A	24	14	38	0	0	38	0	0
13	45470867	.	C	A	24	14	38	0	0	38	0	0
13	45471048	.	A	G	7	10	17	0	0	17	0	0
13	45471052	.	A	G	7	12	19	0	0	19	0	0
13	45471201	.	T	C	29	0	29	0	17	46	0	0
13	45471243	.	G	A	26	15	41	0	1	42	0	0
13	45471367	.	A	T	23	15	38	0	4	43	1	0
13	45471615	.	A	G	30	13	43	0	3	46	0	0
13	45471624	.	T	C	30	17	47	0	1	48	0	0
13	45471888	.	C	T	1	15	16	0	16	32	0	0
13	45472124	.	T	G	5	11	16	0	0	16	0	0
13	45472793	.	T	C	35	3	38	0	29	67	0	0
13	45473011	.	G	A	33	28	61	0	2	63	0	0
13	45475145	.	G	A	22	11	33	0	2	35	0	0
13	45475204	.	T	C	30	8	38	0	0	38	0	0
13	45475208	.	A	C	27	8	35	0	1	36	0	0
13	45475241	.	A	G	16	7	23	0	2	25	0	0
13	45476400	.	C	T	16	8	24	0	1	25	0	0
13	45476731	.	A	T	4	3	7	0	0	7	0	0
13	45481475	.	G	A	15	17	32	0	1	33	0	0
13	45481618	.	A	G	14	10	24	0	0	24	0	0
13	45481622	.	A	G	14	8	22	0	2	24	0	0
13	45481792	.	A	G	2	8	10	0	0	10	0	0
13	45481836	.	C	T	3	2	5	0	0	5	0	0
13	45488209	.	A	G	1	8	9	0	0	9	0	0
13	45494573	.	C	T	22	21	43	0	3	46	0	0
13	45494757	.	G	A	19	27	46	0	2	48	0	0
13	45494769	.	C	A	18	24	42	0	1	43	0	0
13	45495189	.	G	T	0	16	16	0	21	37	0	0
13	45504210	.	A	T	1	1	2	0	0	2	0	0
13	45524500	.	T	C	5	7	12	0	1	13	0	0
13	45557259	.	G	A	0	6	6	0	4	10	0	0
13	45565646	.	G	A	0	1	1	0	6	8	1	0
13	45570300	.	A	C	9	9	18	0	0	18	0	0
13	45786228	.	T	C	3	0	3	0	5	8	0	0
13	45786231	.	T	C	3	5	8	0	0	8	0	0
13	45794407	.	C	T	0	3	3	0	1	4	0	0
13	45794488	.	G	A	1	2	3	0	0	3	0	0
13	45991772	.	T	C	21	24	45	0	0	45	0	0
13	45991801	.	C	T	13	12	25	0	0	26	1	0
13	45999530	.	G	A	0	15	15	0	16	31	0	0
13	45999723	.	C	T	22	18	40	0	3	43	0	0
13	46000060	.	G	A	0	3	3	0	5	8	0	0
13	46179682	.	C	T	27	18	45	0	3	48	0	0
13	46179689	.	G	A	29	20	49	0	1	50	0	0
13	46179722	.	A	T	21	17	38	0	3	41	0	0
13	46179806	.	T	A	29	26	55	0	5	61	1	0
13	46179814	.	A	G	27	30	57	0	4	61	0	0
13	46298616	.	C	T	4	3	7	0	1	8	0	0
13	46298763	.	C	T	9	5	14	0	1	16	1	0
13	46298775	.	T	G	9	5	14	0	1	15	0	0
13	46298973	.	T	C	4	3	7	0	0	7	0	0
13	46299016	.	C	G	4	4	8	0	0	8	0	0
13	46299503	.	C	T	1	3	4	0	1	5	0	0
13	46299669	.	T	A	4	5	9	0	0	9	0	0
13	46299909	.	C	T	0	5	5	0	7	12	0	0
13	46300247	.	A	T	1	8	9	0	0	9	0	0
13	46520845	.	T	C	2	2	4	0	0	4	0	0
13	46520899	.	T	G	9	5	14	0	0	14	0	0
13	46520985	.	G	A	4	7	11	0	1	12	0	0
13	46521542	.	C	T	1	3	4	0	5	9	0	0
13	46521633	.	G	A	8	6	14	0	3	17	0	0
13	46521664	.	C	A	14	7	21	0	0	21	0	0
13	46521974	.	A	T	0	0	0	1	0	1	0	0
13	46552414	.	G	T	4	2	6	0	0	6	0	0
13	46552429	.	G	A	4	3	7	0	0	7	0	0
13	46833909	.	T	C	6	2	8	0	0	8	0	0
13	46833924	.	T	C	4	1	5	0	1	6	0	0
13	46834020	.	T	C	4	3	7	0	1	8	0	0
13	46834054	.	T	C	4	3	7	0	0	7	0	0
13	46988414	.	C	T	7	13	20	0	1	21	0	0
13	46988445	.	C	T	5	3	8	0	1	9	0	0
13	46988457	.	C	A	0	1	1	0	2	3	0	0
13	46990974	.	C	A	0	5	5	0	8	13	0	0
13	47834276	.	C	A	1	2	3	0	1	4	0	0
13	47835598	.	A	C	4	3	7	0	0	7	0	0
13	47838024	.	G	A	3	6	9	0	0	9	0	0
13	47838650	.	G	C	1	3	4	0	0	4	0	0
13	47839071	.	C	T	3	3	6	0	0	6	0	0
13	47839119	.	A	T	5	4	9	0	0	10	1	0
13	48067195	.	G	T	0	2	2	0	0	2	0	0
13	48100564	.	C	T	0	0	0	0	1	1	0	0
13	48104890	.	A	G	2	4	6	0	0	6	0	0
13	48105447	.	C	T	2	4	6	0	0	6	0	0
13	48105520	.	C	T	2	5	7	0	1	8	0	0
13	48105627	.	T	C	4	3	7	0	0	7	0	0
13	48105669	.	C	T	0	2	2	0	6	8	0	0
13	48105953	.	T	A	4	2	6	0	0	6	0	0
13	48106535	.	G	A	2	4	6	0	0	6	0	0
13	48106943	.	A	G	2	2	4	0	0	4	0	0
13	48107224	.	A	C	1	3	4	0	0	4	0	0
13	48107292	.	C	T	2	2	4	0	1	5	0	0
13	48107293	.	C	A	3	2	5	0	0	5	0	0
13	48107355	.	G	C	1	2	3	0	0	3	0	0
13	48107359	.	A	G	1	2	3	0	0	3	0	0
13	48107404	.	A	G	1	2	3	0	0	3	0	0
13	48107413	.	T	C	0	2	2	0	0	2	0	0
13	48107818	.	T	C	2	2	4	0	0	4	0	0
13	48107890	.	A	G	2	3	5	0	0	5	0	0
13	48107927	.	A	T	2	2	4	0	0	4	0	0
13	48107947	.	C	G	3	1	4	0	0	4	0	0
13	48108541	.	C	T	0	3	3	0	1	4	0	0
13	48112752	.	G	T	1	2	3	0	0	3	0	0
13	48112756	.	T	C	1	2	3	0	0	3	0	0
13	48748637	.	A	G	1	4	5	0	0	5	0	0
13	48748689	.	A	G	1	2	3	0	0	3	0	0
13	48748722	.	A	G	2	6	8	0	1	9	0	0
13	48755035	.	A	G	4	2	6	0	0	6	0	0
13	48759105	.	A	T	2	3	5	0	0	5	0	0
13	48760071	.	G	T	2	3	5	0	0	5	0	0
13	48760177	.	C	A	1	3	4	0	0	4	0	0
13	48760180	.	T	C	1	3	4	0	0	4	0	0
13	48760742	.	T	G	1	2	3	0	1	4	0	0
13	48760743	.	C	T	0	2	2	0	2	4	0	0
13	48766270	.	C	T	1	3	4	0	0	4	0	0
13	49153904	.	T	C	4	6	10	0	0	10	0	0
13	49443868	.	T	C	21	0	21	0	22	43	0	0
13	49444210	.	C	G	19	21	40	0	0	40	0	0
13	49444446	.	C	A	15	19	34	0	2	36	0	0
13	49444517	.	G	A	23	7	30	0	0	30	0	0
13	49543316	.	T	C	0	0	0	0	5	5	0	0
13	49544833	.	C	T	12	18	30	0	2	32	0	0
13	49544873	.	T	A	13	26	39	0	0	39	0	0
13	49545039	.	A	G	4	8	12	1	0	13	0	0
13	49575322	.	A	G	3	4	7	0	0	7	0	0
13	49585301	.	T	C	19	27	46	0	1	47	0	0
13	49585341	.	T	A	18	18	36	0	0	36	0	0
13	49585344	.	A	T	18	15	33	0	1	34	0	0
13	49585384	.	T	G	6	4	10	0	0	10	0	0
13	49597294	.	T	C	7	0	7	0	10	17	0	0
13	49597306	.	T	C	7	0	7	0	8	15	0	0
13	49608858	.	G	A	2	3	5	0	0	5	0	0
13	49608981	.	C	T	1	3	4	0	1	5	0	0
13	49608990	.	C	T	1	3	4	0	1	5	0	0
13	49609241	.	C	T	7	2	9	0	0	9	0	0
13	49636194	.	C	T	3	4	7	0	0	7	0	0
13	49636198	.	C	T	0	5	5	0	3	8	0	0
13	49636240	.	C	T	4	2	6	0	0	6	0	0
13	49948760	.	A	G	2	3	5	0	0	5	0	0
13	49952023	.	C	T	1	3	4	0	0	4	0	0
13	50070274	.	C	T	0	1	1	0	0	1	0	0
13	50166759	.	T	A	2	3	5	0	0	5	0	0
13	50166768	.	C	T	3	2	5	0	0	5	0	0
13	50168735	.	C	T	2	3	5	0	1	6	0	0
13	50168744	.	T	A	2	4	6	0	0	6	0	0
13	50168991	.	T	A	10	5	15	0	0	15	0	0
13	50169193	.	G	T	5	9	14	0	1	15	0	0
13	50169618	.	A	G	7	6	13	0	0	13	0	0
13	50169649	.	C	T	2	4	6	0	0	6	0	0
13	50170092	.	G	A	1	3	4	0	0	4	0	0
13	50236437	.	C	T	1	2	3	0	0	3	0	0
13	50236475	.	C	T	0	1	1	0	0	1	0	0
13	50243381	.	C	A	1	2	3	0	0	3	0	0
13	50243387	.	A	C	1	1	2	0	0	2	0	0
13	50349099	.	G	A	5	4	9	0	0	9	0	0
13	50349475	.	A	C	12	11	23	0	0	23	0	0
13	50349532	.	G	A	15	10	25	0	0	25	0	0
13	50349586	.	C	T	12	9	21	0	1	22	0	0
13	50352780	.	G	C	9	8	17	0	0	17	0	0
13	50352965	.	A	G	6	2	8	0	0	8	0	0
13	50353171	.	A	G	7	6	13	0	1	14	0	0
13	50353192	.	A	G	5	6	11	0	1	12	0	0
13	50359690	.	G	A	3	5	8	0	1	9	0	0
13	50361983	.	G	A	3	3	6	0	0	6	0	0
13	50366708	.	C	T	5	3	8	0	1	9	0	0
13	50371951	.	A	G	2	9	11	0	0	11	0	0
13	50372903	.	C	T	4	2	6	0	0	6	0	0
13	50372985	.	G	A	0	2	2	0	6	8	0	0
13	50670911	.	G	C	2	11	13	0	0	13	0	0
13	50712066	.	G	T	3	2	5	0	1	6	0	0
13	51147038	.	G	A	2	4	6	0	1	7	0	0
13	51147152	.	G	A	3	6	9	0	0	9	0	0
13	51147164	.	A	G	2	3	5	0	0	5	0	0
13	51169874	.	C	G	2	5	7	0	0	7	0	0
13	51719661	.	G	C	0	5	5	0	0	5	0	0
13	51719871	.	T	C	8	6	14	0	0	14	0	0
13	51720057	.	T	C	1	4	5	0	0	5	0	0
13	51720142	.	A	G	5	10	15	0	3	18	0	0
13	51720240	.	T	C	10	9	19	0	1	20	0	0
13	51720704	.	G	A	6	6	12	0	0	12	0	0
13	51728165	.	G	C	5	2	7	0	1	8	0	0
13	51728227	.	G	A	10	10	20	0	1	21	0	0
13	51728902	.	A	C	13	9	22	0	1	23	0	0
13	51853950	.	A	T	3	2	5	0	0	5	0	0
13	51893754	.	A	T	6	8	14	0	2	16	0	0
13	51893777	.	A	T	12	12	24	0	1	25	0	0
13	51893891	.	G	A	5	21	26	0	2	28	0	0
13	51893902	.	T	G	7	25	32	0	4	36	0	0
13	51894152	.	A	T	22	0	22	0	0	22	0	0
13	51894215	.	A	T	15	11	26	0	6	32	0	0
13	51898991	.	C	G	2	2	4	0	0	4	0	0
13	51899138	.	C	A	1	16	17	0	19	36	0	0
13	51899707	.	C	T	5	8	13	0	0	13	0	0
13	51899727	.	G	A	4	4	8	0	0	8	0	0
13	51903034	.	A	G	1	3	4	0	1	5	0	0
13	51903040	.	A	G	1	3	4	0	1	5	0	0
13	51909851	.	G	T	0	3	3	0	0	3	0	0
13	51916213	.	C	G	0	2	2	0	1	3	0	0
13	51951038	.	T	C	1	0	1	0	3	4	0	0
13	51962752	.	G	A	0	15	15	0	9	24	0	0
13	51962754	.	G	A	0	15	15	0	9	24	0	0
13	51962802	.	G	A	6	10	16	0	0	16	0	0
13	51962892	.	C	A	14	10	24	0	0	24	0	0
13	51962961	.	C	G	10	10	20	0	1	21	0	0
13	51963383	.	C	T	9	8	17	0	1	18	0	0
13	51969313	.	C	T	1	2	3	0	0	3	0	0
13	51982730	.	A	G	2	0	2	0	5	7	0	0
13	51982742	.	A	G	5	1	6	0	9	15	0	0
13	51982853	.	C	A	7	8	15	0	0	15	0	0
13	52010822	.	C	T	1	1	2	0	0	2	0	0
13	52011349	.	T	C	1	7	8	0	0	8	0	0
13	52011379	.	A	G	1	0	1	0	12	13	0	0
13	52011926	.	G	C	0	5	5	0	2	7	0	0
13	52012027	.	G	A	0	6	6	0	5	11	0	0
13	52012029	.	A	G	3	0	3	0	8	11	0	0
13	52012675	.	T	A	3	3	6	0	0	6	0	0
13	52012902	.	G	T	3	2	5	0	0	5	0	0
13	52013166	.	A	C	4	6	10	0	0	10	0	0
13	52013625	.	A	G	6	4	10	0	0	10	0	0
13	52014032	.	G	C	9	5	14	0	0	14	0	0
13	52014050	.	C	T	11	6	17	0	0	17	0	0
13	52014156	.	A	C	10	5	15	0	0	15	0	0
13	52014359	.	A	G	7	0	7	0	4	11	0	0
13	52014364	.	T	A	7	4	11	0	0	11	0	0
13	52108464	.	C	G	0	4	4	0	2	6	0	0
13	52108748	.	T	A	2	3	5	0	0	5	0	0
14	543346	.	C	A	1	5	6	0	0	6	0	0
14	557740	.	C	T	1	1	2	0	1	3	0	0
14	565260	.	A	T	2	3	5	0	0	5	0	0
14	565350	.	G	C	4	4	8	0	0	8	0	0
14	565354	.	T	A	4	3	7	0	0	7	0	0
14	606255	.	A	G	4	1	5	0	0	5	0	0
14	616648	.	G	A	1	0	1	0	0	1	0	0
14	684179	.	G	A	20	13	33	0	1	34	0	0
14	715123	.	G	C	4	0	4	0	0	4	0	0
14	715126	.	T	C	4	0	4	0	0	4	0	0
14	717927	.	G	A	2	1	3	0	0	3	0	0
14	718194	.	A	C	3	2	5	0	1	6	0	0
14	719447	.	A	G	2	3	5	0	0	5	0	0
14	723539	.	T	C	6	6	12	0	0	12	0	0
14	723542	.	T	C	7	6	13	0	0	13	0	0
14	729870	.	G	T	0	6	6	0	1	7	0	0
14	757514	.	C	T	1	2	3	0	0	3	0	0
14	757534	.	G	T	3	2	5	0	1	6	0	0
14	790989	.	C	T	3	2	5	0	0	5	0	0
14	791067	.	C	G	4	1	5	0	7	12	0	0
14	791696	.	T	A	2	4	6	0	0	6	0	0
14	791707	.	T	A	2	4	6	0	0	6	0	0
14	791989	.	G	T	1	4	5	0	0	5	0	0
14	792133	.	C	A	6	1	7	0	1	8	0	0
14	792142	.	T	C	8	1	9	0	0	9	0	0
14	792173	.	C	A	5	2	7	0	0	7	0	0
14	792686	.	G	A	5	3	8	0	0	8	0	0
14	863048	.	A	G	1	2	3	0	1	4	0	0
14	863418	.	T	A	2	3	5	0	0	5	0	0
14	863767	.	A	G	10	7	17	0	1	18	0	0
14	863807	.	A	T	14	14	28	0	2	30	0	0
14	863868	.	G	T	16	12	28	0	0	28	0	0
14	863949	.	T	C	4	11	15	0	0	15	0	0
14	868838	.	G	A	3	5	8	0	0	8	0	0
14	868855	.	A	G	6	6	12	0	1	13	0	0
14	914602	.	G	C	3	2	5	0	1	6	0	0
14	916908	.	A	T	2	2	4	0	0	4	0	0
14	916944	.	T	A	1	1	2	0	2	4	0	0
14	919604	.	C	G	1	3	4	0	0	4	0	0
14	937345	.	G	A	2	2	4	0	0	4	0	0
14	937399	.	A	T	2	3	5	0	1	6	0	0
14	937672	.	C	T	2	1	3	0	1	4	0	0
14	937749	.	G	C	1	2	3	0	0	3	0	0
14	937937	.	C	T	0	3	3	0	5	8	0	0
14	938290	.	C	A	0	3	3	0	0	3	0	0
14	938292	.	A	G	0	3	3	0	0	3	0	0
14	938683	.	C	T	0	2	2	0	2	4	0	0
14	938688	.	T	C	2	2	4	0	0	4	0	0
14	938803	.	C	T	1	3	4	0	0	4	0	0
14	938978	.	T	C	1	3	4	0	0	4	0	0
14	939618	.	A	C	2	3	5	0	0	5	0	0
14	939620	.	T	A	2	3	5	0	0	5	0	0
14	939805	.	C	T	0	2	2	0	1	3	0	0
14	941678	.	A	T	1	3	4	0	0	4	0	0
14	942065	.	C	T	1	2	3	0	0	3	0	0
14	942066	.	C	T	1	2	3	0	0	3	0	0
14	942312	.	A	G	2	2	4	0	1	5	0	0
14	942337	.	T	C	2	0	2	0	3	5	0	0
14	989848	.	G	T	2	4	6	0	0	6	0	0
14	994353	.	G	T	0	0	0	0	1	1	0	0
14	997012	.	C	A	5	4	9	0	0	9	0	0
14	997484	.	A	G	2	0	2	0	3	5	0	0
14	997603	.	T	C	3	2	5	0	1	6	0	0
14	997651	.	A	C	1	5	6	0	0	6	0	0
14	997705	.	C	A	2	6	8	0	0	8	0	0
14	997765	.	T	C	4	6	10	0	1	11	0	0
14	997783	.	A	G	3	5	8	0	1	9	0	0
14	997853	.	C	T	5	4	9	0	0	9	0	0
14	1119141	.	C	T	2	4	6	0	1	7	0	0
14	1119423	.	A	G	2	5	7	0	1	8	0	0
14	1119432	.	T	C	2	1	3	0	5	8	0	0
14	1119993	.	T	C	2	4	6	0	0	6	0	0
14	1120017	.	T	C	2	5	7	0	0	7	0	0
14	1120072	.	C	A	6	6	12	0	0	12	0	0
14	1120154	.	T	C	10	7	17	0	0	17	0	0
14	1120178	.	C	T	5	6	11	0	0	11	0	0
14	1120196	.	T	G	6	0	6	0	3	9	0	0
14	1120236	.	C	T	3	6	9	0	0	9	0	0
14	1120452	.	G	T	0	4	4	0	1	5	0	0
14	1120598	.	T	C	4	3	7	0	0	7	0	0
14	1121029	.	A	G	3	7	10	0	0	10	0	0
14	1121068	.	C	T	5	4	9	0	0	9	0	0
14	1121297	.	T	G	6	5	11	0	0	11	0	0
14	1121303	.	G	C	6	6	12	0	0	12	0	0
14	1124602	.	C	G	3	6	9	0	0	9	0	0
14	1127693	.	G	A	5	3	8	0	1	9	0	0
14	1128800	.	C	G	3	0	3	0	0	3	0	0
14	1128836	.	A	C	1	0	1	0	0	1	0	0
14	1138611	.	C	A	3	1	4	0	0	4	0	0
14	1138626	.	G	A	0	4	4	0	3	7	0	0
14	1139509	.	C	T	0	5	5	0	1	6	0	0
14	1142796	.	G	A	0	3	3	0	0	3	0	0
14	1150594	.	A	G	0	2	2	0	0	2	0	0
14	1152544	.	C	A	3	3	6	0	0	6	0	0
14	1153665	.	T	C	0	3	3	0	0	3	0	0
14	1153830	.	T	A	5	5	10	0	0	10	0	0
14	1159869	.	A	G	15	0	15	0	10	25	0	0
14	1160333	.	C	T	14	7	21	0	0	21	0	0
14	1160427	.	T	G	9	5	14	0	0	14	0	0
14	1171023	.	T	C	4	7	11	0	0	11	0	0
14	1171052	.	T	A	6	7	13	0	0	13	0	0
14	1171081	.	T	A	5	5	10	0	1	11	0	0
14	1177827	.	A	G	10	7	17	0	5	22	0	0
14	1177865	.	A	G	13	6	19	0	3	22	0	0
14	1192448	.	G	A	8	12	20	0	0	20	0	0
14	1192681	.	C	T	3	9	12	0	0	12	0	0
14	1194090	.	C	T	0	3	3	0	2	5	0	0
14	1194133	.	G	A	4	6	10	0	1	11	0	0
14	1194154	.	C	T	0	4	4	0	8	12	0	0
14	1196658	.	T	G	3	4	7	0	0	7	0	0
14	1200545	.	G	T	9	6	15	0	0	15	0	0
14	1200615	.	A	G	4	2	6	0	0	6	0	0
14	1200842	.	A	C	3	2	5	0	0	5	0	0
14	1203713	.	A	G	19	18	37	0	1	38	0	0
14	1203770	.	G	T	4	5	9	0	0	9	0	0
14	1204197	.	A	T	0	1	1	0	1	2	0	0
14	1204299	.	G	A	9	11	20	0	1	21	0	0
14	1225227	.	C	T	0	0	0	0	1	1	0	0
14	1888624	.	T	C	0	3	3	0	51	54	0	0
14	2351565	.	A	T	2	5	7	0	0	7	0	0
14	2351566	.	G	T	2	5	7	0	0	7	0	0
14	2351762	.	G	A	1	4	5	0	0	5	0	0
14	2352280	.	T	G	1	3	4	0	0	4	0	0
14	2352329	.	A	T	3	2	5	0	0	5	0	0
14	2360116	.	T	A	2	4	6	0	1	7	0	0
14	3576236	.	C	T	1	4	5	0	0	5	0	0
14	4183038	.	A	G	3	2	5	0	0	5	0	0
14	4183711	.	A	G	2	0	2	0	3	5	0	0
14	4183886	.	G	A	0	8	8	0	0	8	0	0
14	4192875	.	T	C	6	2	8	0	0	8	0	0
14	4193501	.	T	C	3	4	7	0	0	7	0	0
14	4292143	.	A	G	5	4	9	0	1	10	0	0
14	4292357	.	T	C	0	2	2	0	1	3	0	0
14	4813124	.	A	G	3	3	6	0	0	6	0	0
14	5999922	.	C	T	1	2	3	0	0	3	0	0
14	6332869	.	A	C	4	3	7	0	0	7	0	0
14	6332872	.	T	C	4	3	7	0	0	7	0	0
14	6333022	.	T	C	3	7	10	0	1	11	0	0
14	6624558	.	A	G	16	3	19	0	4	23	0	0
14	6624621	.	A	G	10	21	31	0	0	31	0	0
14	6625521	.	G	C	25	36	61	0	3	64	0	0
14	6625794	.	A	G	1	15	16	0	0	16	0	0
14	6625805	.	A	G	5	5	10	0	0	10	0	0
14	7169854	.	C	T	0	2	2	0	2	4	0	0
14	7170558	.	T	C	7	13	20	0	0	20	0	0
14	7170559	.	T	C	5	15	20	0	0	20	0	0
14	7916066	.	A	G	2	4	6	0	0	6	0	0
14	8496257	.	A	G	1	3	4	0	1	5	0	0
14	8568388	.	T	C	4	2	6	0	0	6	0	0
14	8571999	.	A	G	8	4	12	0	1	13	0	0
14	9002269	.	G	A	11	4	15	0	1	16	0	0
14	9588896	.	A	G	3	2	5	0	0	6	1	0
14	9595314	.	T	C	16	9	25	0	3	28	0	0
14	9595330	.	T	C	13	14	27	0	1	28	0	0
14	9595450	.	T	C	2	8	10	0	0	10	0	0
14	9595524	.	T	C	5	5	10	0	2	12	0	0
14	12486226	.	A	T	2	2	4	0	0	4	0	0
14	12554812	.	T	C	0	1	1	0	0	1	0	0
14	14723282	.	T	C	10	7	17	0	0	17	0	0
14	14723302	.	T	C	5	5	10	0	0	10	0	0
14	14739137	.	T	A	9	3	12	0	1	13	0	0
14	14838402	.	A	G	0	4	4	0	0	4	0	0
14	15663175	.	T	C	3	4	7	0	0	7	0	0
14	15663547	.	T	G	3	2	5	0	10	15	0	0
14	15972242	.	T	C	1	3	4	0	0	4	0	0
14	15972303	.	G	A	2	3	5	0	0	5	0	0
14	15972419	.	A	G	5	4	9	0	0	11	2	0
14	15972435	.	C	A	4	5	9	0	1	10	0	0
14	15972526	.	G	T	3	2	5	0	0	5	0	0
14	15972549	.	T	C	6	2	8	0	0	8	0	0
14	15972596	.	T	C	6	0	6	0	3	9	0	0
14	15972660	.	C	G	7	4	11	0	0	11	0	0
14	15972666	.	G	A	5	4	9	0	1	10	0	0
14	15973819	.	A	T	4	3	7	0	0	7	0	0
14	15973845	.	C	A	3	2	5	0	0	5	0	0
14	15973919	.	A	G	6	3	9	0	0	9	0	0
14	15974065	.	C	A	2	4	6	0	0	6	0	0
14	15974069	.	A	T	2	4	6	0	0	6	0	0
14	15974370	.	T	C	4	2	6	0	0	6	0	0
14	15974448	.	A	G	4	2	6	0	0	6	0	0
14	15974580	.	A	G	2	3	5	0	0	5	0	0
14	15974613	.	G	A	2	4	6	0	0	6	0	0
14	15983585	.	T	C	1	2	3	0	0	3	0	0
14	15983590	.	T	C	1	2	3	0	0	3	0	0
14	16042530	.	C	A	2	5	7	0	0	7	0	0
14	16044274	.	A	C	6	6	12	0	0	12	0	0
14	16044638	.	G	A	0	6	6	0	9	15	0	0
14	16068929	.	C	T	4	3	7	0	0	7	0	0
14	16069264	.	A	C	5	3	8	0	0	8	0	0
14	16069354	.	C	T	6	5	11	0	0	11	0	0
14	16069404	.	G	A	4	3	7	0	0	7	0	0
14	16069405	.	A	G	4	3	7	0	0	7	0	0
14	16072889	.	G	C	1	0	1	0	0	1	0	0
14	16084339	.	C	T	3	5	8	0	0	8	0	0
14	16090764	.	T	C	9	6	15	0	1	16	0	0
14	16090800	.	T	A	8	6	14	0	0	14	0	0
14	16090828	.	A	T	9	10	19	0	0	19	0	0
14	16090897	.	C	T	5	14	19	0	0	19	0	0
14	16090939	.	A	C	5	13	18	0	2	20	0	0
14	16091563	.	C	T	12	7	19	0	5	24	0	0
14	16091586	.	T	A	11	8	19	0	2	21	0	0
14	16091709	.	T	G	8	5	13	0	1	14	0	0
14	16093983	.	G	A	13	8	21	0	0	21	0	0
14	16095683	.	A	G	7	6	13	0	0	13	0	0
14	16097204	.	T	A	1	1	2	0	0	2	0	0
14	16115278	.	G	A	13	6	19	0	1	20	0	0
14	16122866	.	T	C	17	18	35	0	0	35	0	0
14	16122962	.	G	A	19	18	37	0	4	41	0	0
14	16123055	.	G	C	0	23	23	0	25	48	0	0
14	16127308	.	C	T	0	1	1	0	0	1	0	0
14	16130167	.	C	G	1	1	2	0	0	2	0	0
14	16132423	.	T	G	2	2	4	0	0	4	0	0
14	16145112	.	T	A	1	0	1	0	0	1	0	0
14	16203904	.	A	T	3	4	7	0	1	8	0	0
14	16208059	.	T	G	4	3	7	0	0	7	0	0
14	16288166	.	A	C	4	13	17	0	0	17	0	0
14	16288236	.	T	G	1	0	1	0	0	1	0	0
14	16296383	.	A	G	2	0	2	0	4	6	0	0
14	16432788	.	C	T	3	4	7	0	0	7	0	0
14	16433098	.	A	T	21	14	35	0	5	40	0	0
14	16433473	.	C	A	1	16	17	0	17	34	0	0
14	16433496	.	A	G	16	17	33	0	0	33	0	0
14	16433623	.	T	G	8	2	10	1	1	12	0	0
14	16433943	.	C	T	0	13	13	0	14	27	0	0
14	16434131	.	G	C	18	23	41	0	1	42	0	0
14	16434179	.	T	C	19	22	41	0	1	42	0	0
14	16434474	.	T	C	7	0	7	0	8	15	0	0
14	16434791	.	A	G	13	27	40	0	1	41	0	0
14	16434981	.	T	C	26	3	29	0	28	57	0	0
14	16434990	.	T	A	28	16	44	0	11	55	0	0
14	16448208	.	A	T	14	10	24	0	0	24	0	0
14	16456712	.	C	T	3	3	6	0	0	6	0	0
14	16484069	.	C	T	9	7	16	0	1	17	0	0
14	16484429	.	C	T	8	7	15	0	2	17	0	0
14	16484558	.	A	T	6	3	9	0	0	9	0	0
14	16484633	.	G	T	3	4	7	0	1	8	0	0
14	16484713	.	A	G	4	5	9	0	1	10	0	0
14	16485222	.	C	T	0	3	3	0	8	11	0	0
14	16606655	.	C	T	0	6	6	0	3	9	0	0
14	16618118	.	G	A	5	2	7	0	1	8	0	0
14	16754120	.	C	A	3	3	6	0	1	7	0	0
14	16754192	.	A	C	5	5	10	0	1	11	0	0
14	16754243	.	G	A	2	2	4	0	0	4	0	0
14	16766053	.	C	T	3	6	9	0	0	9	0	0
14	16769067	.	A	G	11	12	23	0	0	23	0	0
14	16769109	.	T	C	12	14	26	0	0	26	0	0
14	16769189	.	C	T	14	11	25	0	1	26	0	0
14	16769246	.	C	T	14	8	22	0	1	23	0	0
14	16769478	.	A	G	13	1	14	0	2	16	0	0
14	16769481	.	T	C	14	1	15	0	1	16	0	0
14	16769515	.	G	A	11	3	14	0	1	15	0	0
14	16769550	.	A	G	2	0	2	0	1	3	0	0
14	16770260	.	C	T	9	8	17	0	0	17	0	0
14	16770338	.	T	A	10	10	20	0	0	20	0	0
14	16770646	.	C	A	12	9	21	0	0	21	0	0
14	16770847	.	C	T	17	14	31	0	0	31	0	0
14	16771137	.	G	T	3	5	8	0	0	8	0	0
14	16771194	.	A	T	2	4	6	0	0	6	0	0
14	16771265	.	A	T	8	10	18	0	2	20	0	0
14	16777673	.	T	C	3	0	3	0	6	9	0	0
14	16777677	.	A	C	3	7	10	0	0	10	0	0
14	16777708	.	T	C	3	5	8	0	0	8	0	0
14	16777944	.	C	T	1	2	3	0	0	3	0	0
14	16778080	.	C	T	0	2	2	0	6	8	0	0
14	16801708	.	G	T	1	2	3	0	0	3	0	0
14	16801732	.	C	A	0	3	3	0	1	4	0	0
14	16813863	.	G	A	3	3	6	0	0	6	0	0
14	16949354	.	A	G	3	0	3	0	1	4	0	0
14	16949357	.	C	T	3	1	4	0	0	4	0	0
14	16996916	.	G	A	7	4	11	0	0	11	0	0
14	16997008	.	G	A	3	0	3	0	0	3	0	0
14	17003640	.	G	A	0	1	1	0	0	1	0	0
14	17003771	.	C	A	0	1	1	0	0	1	0	0
14	17025080	.	A	G	6	0	6	0	4	10	0	0
14	17025109	.	A	T	10	7	17	0	1	18	0	0
14	17025151	.	T	A	11	7	18	0	1	19	0	0
14	17025200	.	G	A	7	3	10	0	0	10	0	0
14	17025215	.	T	C	4	2	6	0	0	6	0	0
14	17025262	.	G	A	5	3	8	0	2	10	0	0
14	17025574	.	A	G	6	4	10	0	0	10	0	0
14	17025751	.	T	A	2	4	6	0	0	6	0	0
14	17025752	.	T	C	2	4	6	0	0	6	0	0
14	17025807	.	T	C	8	7	15	0	0	15	0	0
14	17025819	.	C	T	9	8	17	0	1	18	0	0
14	17025849	.	A	G	9	8	17	0	0	17	0	0
14	17026488	.	G	A	10	5	15	0	0	15	0	0
14	17026572	.	T	G	4	14	18	0	2	20	0	0
14	17026724	.	T	C	9	15	24	0	0	24	0	0
14	17026840	.	T	C	6	3	9	0	1	10	0	0
14	17026881	.	G	T	7	6	13	0	0	13	0	0
14	17027207	.	G	A	6	3	9	0	1	10	0	0
14	17087493	.	C	A	1	2	3	0	0	3	0	0
14	17152640	.	G	A	2	1	3	0	0	3	0	0
14	17157691	.	C	G	1	0	1	0	0	1	0	0
14	17161950	.	A	G	2	3	5	0	0	5	0	0
14	17161969	.	C	T	1	2	3	0	1	4	0	0
14	17197240	.	A	C	1	1	2	0	0	2	0	0
14	17199990	.	A	G	15	30	45	0	1	46	0	0
14	17200351	.	A	T	9	7	16	0	0	16	0	0
14	17200407	.	C	A	8	14	22	0	0	22	0	0
14	17200653	.	A	C	15	13	28	0	3	32	1	0
14	17230601	.	A	G	7	4	11	0	1	12	0	0
14	17233598	.	C	A	12	13	25	0	0	25	0	0
14	17240587	.	A	G	2	2	4	0	0	4	0	0
14	17266010	.	C	T	0	6	6	0	12	18	0	0
14	17275648	.	G	A	4	5	9	0	0	9	0	0
14	17275708	.	C	G	5	4	9	0	0	9	0	0
14	17278972	.	C	T	8	4	12	0	1	13	0	0
14	17279005	.	T	C	3	1	4	0	0	4	0	0
14	17279197	.	G	A	2	1	3	0	0	3	0	0
14	17279212	.	C	T	2	3	5	0	1	6	0	0
14	17279305	.	T	C	2	6	8	0	0	8	0	0
14	17281761	.	A	G	8	5	13	0	1	14	0	0
14	17282061	.	C	T	1	3	4	0	2	6	0	0
14	17282095	.	C	G	2	7	9	0	0	9	0	0
14	17282100	.	C	T	0	7	7	0	2	9	0	0
14	17282139	.	C	T	1	3	4	0	0	4	0	0
14	17305587	.	G	A	5	3	8	0	0	8	0	0
14	17305604	.	G	A	8	3	11	0	1	12	0	0
14	17349306	.	C	T	2	5	7	0	0	7	0	0
14	17349307	.	C	T	2	5	7	0	0	7	0	0
14	17349444	.	T	G	7	3	10	0	0	10	0	0
14	17349931	.	T	C	5	3	8	0	0	8	0	0
14	17443377	.	C	T	3	4	7	0	0	7	0	0
14	17444047	.	A	C	1	2	3	0	0	3	0	0
14	17567851	.	C	T	5	2	7	0	1	8	0	0
14	17572743	.	T	C	4	1	5	0	0	5	0	0
14	17575548	.	A	G	0	2	2	0	0	2	0	0
14	17575607	.	G	T	2	7	9	0	0	9	0	0
14	17575868	.	G	A	4	3	7	0	1	8	0	0
14	17580685	.	G	A	13	8	21	0	1	22	0	0
14	17580922	.	C	A	27	29	56	0	2	58	0	0
14	17581084	.	A	T	28	20	48	0	2	50	0	0
14	17581214	.	A	T	29	19	48	0	6	54	0	0
14	17586693	.	G	A	1	2	3	0	0	3	0	0
14	17588131	.	G	T	13	9	22	0	1	23	0	0
14	17593429	.	T	C	4	6	10	0	0	10	0	0
14	17593444	.	G	T	5	5	10	0	0	10	0	0
14	17593490	.	A	G	4	4	8	0	1	9	0	0
14	17593554	.	A	T	3	3	6	0	0	6	0	0
14	17593610	.	A	G	2	6	8	0	0	8	0	0
14	17593720	.	C	T	13	17	30	0	2	32	0	0
14	17593767	.	A	T	11	13	24	0	0	24	0	0
14	17593783	.	T	A	8	11	19	0	1	20	0	0
14	17593823	.	A	T	9	16	25	0	0	25	0	0
14	17593992	.	T	A	9	9	18	0	6	24	0	0
14	17594137	.	G	A	6	6	12	0	1	13	0	0
14	17594527	.	A	G	6	7	13	0	2	15	0	0
14	17594734	.	A	T	4	6	10	0	0	10	0	0
14	17595121	.	G	A	10	4	14	0	0	14	0	0
14	17595192	.	A	T	3	3	6	0	1	7	0	0
14	17595460	.	T	A	10	3	13	0	0	13	0	0
14	17595539	.	T	C	7	8	15	0	0	15	0	0
14	17596597	.	G	A	6	6	12	0	0	12	0	0
14	18667852	.	T	C	13	19	32	0	3	35	0	0
14	18668731	.	A	G	6	3	9	0	0	9	0	0
14	18669481	.	C	A	16	18	34	0	1	35	0	0
14	18670446	.	C	T	11	10	21	1	0	22	0	0
14	18670582	.	T	A	12	7	19	0	2	21	0	0
14	18670665	.	A	G	9	9	18	1	0	19	0	0
14	18671011	.	A	T	6	5	11	0	2	13	0	0
14	18672491	.	C	T	7	10	17	0	1	18	0	0
14	21750970	.	C	T	0	4	4	0	0	4	0	0
14	21757206	.	C	T	2	2	4	0	0	4	0	0
14	21768233	.	A	G	2	3	5	0	1	6	0	0
14	21768244	.	G	A	0	2	2	0	5	7	0	0
14	21770666	.	C	G	4	4	8	0	0	8	0	0
14	21770708	.	A	G	2	0	2	0	6	8	0	0
14	21772267	.	T	C	1	8	9	0	2	11	0	0
14	21772385	.	T	C	5	7	12	0	1	13	0	0
14	21772412	.	C	T	3	5	8	0	1	9	0	0
14	21772459	.	T	C	6	6	12	0	0	12	0	0
14	21772466	.	T	C	6	5	11	0	0	11	0	0
14	21772553	.	C	T	11	12	23	0	0	23	0	0
14	21772663	.	G	C	5	7	12	0	0	12	0	0
14	21779102	.	C	T	7	13	20	0	1	21	0	0
14	21779241	.	G	A	16	11	27	0	0	27	0	0
14	21779300	.	T	G	10	9	19	0	0	19	0	0
14	21779518	.	C	T	3	6	9	0	0	9	0	0
14	21779582	.	T	C	4	3	7	0	0	7	0	0
14	21779617	.	T	C	3	3	6	0	0	6	0	0
14	21779633	.	T	C	1	3	4	0	1	5	0	0
14	21779977	.	G	A	3	6	9	0	0	9	0	0
14	21780125	.	A	G	8	3	11	0	0	11	0	0
14	21780128	.	A	G	2	5	7	0	2	9	0	0
14	21780206	.	A	G	12	11	23	0	2	25	0	0
14	21780274	.	A	C	8	6	14	0	1	15	0	0
14	21780321	.	T	C	6	4	10	0	3	13	0	0
14	21783361	.	T	G	5	6	11	0	0	11	0	0
14	21797819	.	T	C	1	3	4	0	0	4	0	0
14	21816373	.	C	T	12	17	29	0	1	30	0	0
14	21816388	.	T	C	11	16	27	0	2	29	0	0
14	21816467	.	G	A	12	12	24	0	0	24	0	0
14	21834912	.	C	T	7	5	12	0	0	12	0	0
14	21840858	.	A	G	3	0	3	0	0	3	0	0
14	21842735	.	A	C	13	14	27	0	6	33	0	0
14	21843297	.	G	C	8	11	19	0	1	20	0	0
14	21844187	.	T	A	16	13	29	0	3	32	0	0
14	21844486	.	C	T	9	4	13	0	0	13	0	0
14	21844668	.	A	C	12	10	22	0	1	23	0	0
14	21844679	.	T	A	12	10	22	0	0	22	0	0
14	21845129	.	T	A	16	15	31	0	2	33	0	0
14	21845363	.	A	G	19	0	19	0	17	36	0	0
14	21845822	.	A	C	15	5	20	0	2	22	0	0
14	21924501	.	T	C	0	0	0	0	1	1	0	0
14	21924547	.	G	A	0	2	2	0	0	2	0	0
14	21980762	.	G	A	2	3	5	0	1	6	0	0
14	21980769	.	C	T	0	2	2	0	2	4	0	0
14	21987518	.	C	T	3	2	5	0	0	5	0	0
14	21987611	.	G	A	1	2	3	0	0	3	0	0
14	21999213	.	A	G	1	2	3	0	0	3	0	0
14	22102371	.	A	G	16	8	24	0	1	25	0	0
14	22102381	.	A	G	12	13	25	0	2	27	0	0
14	22104906	.	T	C	1	4	5	0	0	5	0	0
14	22104948	.	G	A	0	1	1	0	0	1	0	0
14	22106125	.	G	A	1	4	5	0	0	5	0	0
14	22106126	.	T	C	1	0	1	0	4	5	0	0
14	22108215	.	C	T	8	13	21	0	0	21	0	0
14	22108368	.	A	T	2	4	6	0	0	6	0	0
14	22108373	.	G	A	2	5	7	0	0	7	0	0
14	22109640	.	A	T	1	4	5	0	1	6	0	0
14	22109663	.	C	T	4	2	6	0	0	6	0	0
14	22132473	.	T	C	21	18	39	0	0	39	0	0
14	22132536	.	A	T	3	4	7	0	0	7	0	0
14	22139254	.	G	A	31	25	56	0	0	56	0	0
14	22139358	.	G	A	21	25	46	0	1	47	0	0
14	22139398	.	T	A	21	24	45	0	1	46	0	0
14	22139668	.	G	A	2	21	23	0	34	57	0	0
14	22140150	.	G	A	5	4	9	0	0	9	0	0
14	22140158	.	T	C	2	2	4	0	1	5	0	0
14	22140417	.	T	C	5	5	10	0	1	11	0	0
14	22151875	.	G	A	11	11	22	0	1	23	0	0
14	22151879	.	C	T	0	12	12	0	11	23	0	0
14	22151913	.	C	T	16	17	33	0	1	34	0	0
14	22172138	.	C	T	11	11	22	0	1	23	0	0
14	22249344	.	G	A	6	3	9	0	0	9	0	0
14	22254184	.	T	C	10	9	19	0	0	19	0	0
14	22272120	.	A	G	23	2	25	0	19	44	0	0
14	22272340	.	G	A	27	20	47	0	0	47	0	0
14	22272351	.	G	A	27	20	47	0	0	47	0	0
14	22272749	.	A	G	27	1	28	0	11	39	0	0
14	22367485	.	A	G	0	1	1	0	0	2	1	0
14	22369268	.	A	T	2	3	5	0	0	5	0	0
14	22369278	.	G	A	2	3	5	0	0	5	0	0
14	22370333	.	C	A	0	2	2	0	2	4	0	0
14	22431765	.	G	A	2	2	4	0	0	4	0	0
14	22434336	.	G	C	0	2	2	0	4	6	0	0
14	22439065	.	A	G	4	0	4	0	4	8	0	0
14	22439593	.	T	C	1	2	3	0	0	3	0	0
14	22439620	.	T	A	1	2	3	0	0	3	0	0
14	22440004	.	G	T	0	5	5	0	2	7	0	0
14	22440824	.	A	T	1	2	3	0	0	3	0	0
14	22441179	.	C	A	2	2	4	0	0	4	0	0
14	22441634	.	G	A	0	3	3	0	6	9	0	0
14	22441650	.	C	T	6	2	8	0	3	11	0	0
14	22441730	.	A	G	3	9	12	0	0	12	0	0
14	22441929	.	C	T	6	5	11	0	1	12	0	0
14	22452886	.	A	C	0	3	3	2	0	5	0	0
14	22467723	.	T	C	0	2	2	0	0	2	0	0
14	22469954	.	C	A	1	7	8	0	0	8	0	0
14	22469978	.	A	G	1	5	6	0	1	7	0	0
14	22478282	.	G	A	4	4	8	0	0	8	0	0
14	22478294	.	T	C	4	2	6	0	0	6	0	0
14	22478348	.	C	T	2	6	8	0	0	8	0	0
14	22478380	.	C	T	6	6	12	0	0	12	0	0
14	22478426	.	T	C	6	4	10	0	0	10	0	0
14	22499368	.	A	G	0	1	1	0	0	1	0	0
14	22523524	.	C	G	5	3	8	0	0	8	0	0
14	22523584	.	A	G	5	9	14	0	0	14	0	0
14	22523633	.	T	C	3	7	10	0	1	11	0	0
14	22523644	.	C	T	3	4	7	0	1	8	0	0
14	22699771	.	C	A	2	5	7	0	1	8	0	0
14	22708389	.	C	T	3	9	12	0	1	13	0	0
14	22708401	.	C	A	4	8	12	0	0	12	0	0
14	23187210	.	C	T	0	2	2	0	0	2	0	0
14	23348762	.	G	C	0	1	1	0	0	1	0	0
14	23409971	.	A	G	5	3	8	0	0	8	0	0
14	23455989	.	G	A	7	10	17	0	0	17	0	0
14	23463681	.	G	A	0	1	1	0	2	3	0	0
14	23463708	.	A	G	2	2	4	0	1	5	0	0
14	23463717	.	A	G	3	0	3	0	2	5	0	0
14	23463760	.	C	A	1	1	2	0	0	2	0	0
14	23621903	.	C	T	0	3	3	0	0	3	0	0
14	23622190	.	C	T	3	3	6	0	1	7	0	0
14	23628158	.	C	T	1	1	2	0	0	2	0	0
14	23653096	.	T	C	5	1	6	0	1	7	0	0
14	23657531	.	G	A	0	4	4	0	2	6	0	0
14	23665987	.	G	A	1	8	9	0	1	10	0	0
14	23666203	.	T	C	9	7	16	0	0	16	0	0
14	23666266	.	C	A	13	13	26	0	0	26	0	0
14	23666326	.	C	T	11	8	19	0	1	20	0	0
14	23666431	.	G	A	7	7	14	0	0	14	0	0
14	23666451	.	A	G	6	6	12	0	0	12	0	0
14	23666625	.	C	T	6	6	12	0	0	12	0	0
14	23668714	.	T	C	4	6	10	0	0	10	0	0
14	23668724	.	C	A	6	6	12	0	1	13	0	0
14	23671197	.	A	G	5	0	5	0	7	12	0	0
14	23671248	.	T	C	16	13	29	0	1	30	0	0
14	23671361	.	C	G	7	5	12	0	0	12	0	0
14	23679393	.	T	A	7	6	13	0	0	13	0	0
14	23679394	.	C	A	7	6	13	0	0	13	0	0
14	23693720	.	G	T	3	2	5	0	0	5	0	0
14	23696893	.	A	T	3	1	4	0	0	4	0	0
14	23702323	.	G	A	0	2	2	0	5	7	0	0
14	23702703	.	G	A	1	2	3	0	0	3	0	0
14	23702730	.	G	A	6	7	13	0	0	13	0	0
14	23704771	.	G	C	0	9	9	0	8	17	0	0
14	23710471	.	T	A	0	1	1	0	1	2	0	0
14	23710474	.	G	A	0	1	1	0	0	1	0	0
14	23722030	.	C	T	4	3	7	0	0	7	0	0
14	23725824	.	T	A	12	15	27	0	0	27	0	0
14	23726124	.	G	T	25	22	47	0	2	49	0	0
14	23726393	.	C	A	22	29	51	0	4	55	0	0
14	23732299	.	C	T	0	7	7	0	16	23	0	0
14	23732324	.	T	C	17	0	17	0	10	27	0	0
14	23732508	.	C	T	14	12	26	0	1	27	0	0
14	23732691	.	G	T	5	6	11	0	0	11	0	0
14	23732734	.	G	A	1	7	8	0	1	9	0	0
14	23737569	.	A	T	15	7	22	0	4	26	0	0
14	23747360	.	T	A	20	20	40	0	0	40	0	0
14	23748436	.	G	A	12	10	22	0	0	22	0	0
14	23752335	.	C	T	5	2	7	0	1	8	0	0
14	23756410	.	G	A	5	5	10	0	0	10	0	0
14	23756716	.	T	A	14	6	20	0	0	20	0	0
14	23765748	.	T	C	1	1	2	0	0	2	0	0
14	23798649	.	C	G	8	7	15	0	1	16	0	0
14	23798675	.	G	C	7	8	15	0	1	16	0	0
14	23798699	.	A	C	7	7	14	0	2	16	0	0
14	23798963	.	G	A	1	3	4	0	0	4	0	0
14	23799076	.	G	T	2	9	11	0	0	11	0	0
14	23799095	.	G	T	2	7	9	0	0	9	0	0
14	23799271	.	G	T	2	6	8	0	0	8	0	0
14	23799293	.	T	C	2	5	7	0	0	7	0	0
14	23801145	.	C	A	0	5	5	0	7	12	0	0
14	23801159	.	C	A	0	5	5	0	5	10	0	0
14	23801249	.	G	A	6	4	10	0	0	10	0	0
14	23811978	.	C	T	2	2	4	0	0	4	0	0
14	23812444	.	C	A	3	4	7	0	0	7	0	0
14	23963876	.	C	T	1	2	3	0	0	3	0	0
14	23967619	.	C	T	1	6	7	0	0	7	0	0
14	23968517	.	G	C	3	3	6	0	1	7	0	0
14	23968564	.	T	A	3	5	8	0	0	8	0	0
14	23968612	.	A	T	2	6	8	0	0	8	0	0
14	23968619	.	T	A	3	6	9	0	0	9	0	0
14	23968657	.	C	A	4	4	8	0	0	8	0	0
14	23968678	.	T	G	5	7	12	0	0	12	0	0
14	23968720	.	G	A	8	7	15	0	0	15	0	0
14	23968743	.	C	T	4	7	11	0	1	12	0	0
14	23968774	.	T	C	2	7	9	0	1	10	0	0
14	23968781	.	C	A	1	5	6	0	1	7	0	0
14	23968815	.	A	G	3	5	8	0	0	8	0	0
14	23968843	.	A	T	3	3	6	0	0	6	0	0
14	23969152	.	G	A	5	2	7	0	0	7	0	0
14	23969485	.	G	A	2	3	5	0	0	5	0	0
14	23969568	.	G	A	9	6	15	0	0	15	0	0
14	23969796	.	T	C	1	1	2	0	1	3	0	0
14	23970887	.	T	C	9	10	19	0	1	20	0	0
14	23972351	.	C	T	3	3	6	0	0	6	0	0
14	23976245	.	C	T	1	3	4	0	0	4	0	0
14	23981999	.	T	C	6	8	14	0	0	14	0	0
14	23991588	.	G	A	12	18	30	0	0	30	0	0
14	23993958	.	G	A	11	14	25	0	2	27	0	0
14	23998961	.	C	A	16	14	30	0	1	31	0	0
14	23999002	.	G	C	13	21	34	0	1	35	0	0
14	23999021	.	C	T	23	16	39	0	2	41	0	0
14	23999086	.	G	A	22	17	39	0	0	39	0	0
14	23999225	.	A	G	15	21	36	0	1	37	0	0
14	23999239	.	G	C	0	18	18	0	15	33	0	0
14	23999315	.	A	G	23	13	36	0	0	36	0	0
14	23999459	.	A	C	9	13	22	0	1	23	0	0
14	23999466	.	C	A	11	8	19	0	0	19	0	0
14	24097523	.	C	T	15	17	32	0	1	34	1	0
14	24098191	.	T	C	6	2	8	0	4	12	0	0
14	24098408	.	C	G	9	5	14	0	0	14	0	0
14	24098470	.	C	G	3	6	9	0	2	11	0	0
14	24098648	.	G	A	16	11	27	0	0	27	0	0
14	24098694	.	G	T	17	14	31	0	0	31	0	0
14	24098912	.	C	T	1	10	11	0	7	18	0	0
14	24099059	.	A	T	6	9	15	0	0	15	0	0
14	24099240	.	C	A	8	7	15	0	0	15	0	0
14	24108731	.	G	A	3	6	9	0	0	9	0	0
14	24108983	.	G	A	7	9	16	0	0	16	0	0
14	24109031	.	A	G	8	7	15	0	0	15	0	0
14	24109067	.	G	C	10	1	11	0	12	23	0	0
14	24109184	.	G	A	4	10	14	0	1	15	0	0
14	24109355	.	C	G	3	6	9	0	0	9	0	0
14	24215187	.	C	G	4	4	8	0	0	8	0	0
14	24215231	.	G	A	2	3	5	0	0	5	0	0
14	24217550	.	C	T	4	5	9	0	1	10	0	0
14	24220659	.	A	C	4	6	10	0	1	11	0	0
14	24220959	.	A	T	11	6	17	0	0	17	0	0
14	24221053	.	G	A	8	6	14	0	1	15	0	0
14	24221194	.	T	A	15	15	30	0	0	30	0	0
14	24221356	.	G	A	0	10	10	0	11	21	0	0
14	24241329	.	T	C	2	2	4	0	0	4	0	0
14	24242844	.	C	G	1	2	3	0	0	3	0	0
14	24248398	.	C	A	1	2	3	0	0	3	0	0
14	24248495	.	T	G	2	4	6	0	0	6	0	0
14	24248575	.	C	T	5	2	7	0	0	7	0	0
14	24250583	.	G	A	1	1	2	0	0	2	0	0
14	24268222	.	G	T	6	4	10	0	0	10	0	0
14	24268262	.	A	G	11	11	22	0	1	23	0	0
14	24268374	.	G	A	4	4	8	0	1	9	0	0
14	24268403	.	G	A	2	4	6	0	1	7	0	0
14	24268505	.	G	A	11	7	18	0	1	19	0	0
14	24268676	.	A	T	15	15	30	0	0	30	0	0
14	24268712	.	C	T	0	12	12	0	17	29	0	0
14	24268781	.	G	A	13	7	20	0	1	21	0	0
14	24274521	.	T	G	3	1	4	0	0	4	0	0
14	24274783	.	G	A	7	9	16	0	0	16	0	0
14	24276634	.	C	T	8	10	18	0	0	18	0	0
14	24278234	.	A	G	14	8	22	0	2	24	0	0
14	24278882	.	C	A	11	22	33	0	1	34	0	0
14	24278917	.	G	A	14	23	37	0	2	39	0	0
14	24279011	.	A	C	26	11	37	0	0	37	0	0
14	24279126	.	A	G	13	23	36	0	1	38	1	0
14	24279148	.	G	A	12	17	29	0	7	36	0	0
14	24279367	.	A	T	9	10	19	0	0	19	0	0
14	24279551	.	A	G	21	1	22	0	21	43	0	0
14	24279701	.	C	G	11	16	27	0	0	27	0	0
14	24280842	.	T	C	22	18	40	0	2	42	0	0
14	24280918	.	T	G	16	19	35	0	0	35	0	0
14	24288525	.	T	A	0	2	2	0	0	2	0	0
14	24301658	.	G	A	1	4	5	0	7	12	0	0
14	24301779	.	T	G	5	4	9	0	0	9	0	0
14	24302089	.	A	T	4	2	6	0	0	6	0	0
14	24302137	.	C	T	4	2	6	0	0	6	0	0
14	24302157	.	G	T	2	3	5	0	0	5	0	0
14	24302214	.	T	C	5	2	7	0	0	7	0	0
14	24302280	.	G	T	2	3	5	0	0	5	0	0
14	24302770	.	G	T	0	2	2	0	4	6	0	0
14	24302920	.	C	T	3	4	7	0	0	7	0	0
14	24303104	.	G	C	3	3	6	0	0	6	0	0
14	24303308	.	G	A	12	7	19	0	0	19	0	0
14	24303504	.	C	T	11	15	26	0	0	26	0	0
14	24303735	.	G	C	2	1	3	0	0	3	0	0
14	24303786	.	A	T	0	2	2	0	0	2	0	0
14	24303851	.	C	A	6	4	10	1	0	11	0	0
14	24304480	.	A	C	6	3	9	0	1	10	0	0
14	24304591	.	T	A	14	7	21	0	0	21	0	0
14	24304753	.	T	C	5	6	11	0	0	11	0	0
14	24304823	.	A	G	3	12	15	0	0	15	0	0
14	24316809	.	A	T	8	6	14	0	1	15	0	0
14	24317266	.	A	T	18	40	58	0	2	60	0	0
14	24317272	.	G	A	16	41	57	0	3	60	0	0
14	24317314	.	T	C	37	21	58	0	0	58	0	0
14	24317316	.	C	T	21	36	57	0	1	58	0	0
14	24317576	.	A	G	31	26	57	0	2	59	0	0
14	24317685	.	T	A	25	22	47	0	5	52	0	0
14	24317717	.	T	A	23	25	48	0	1	49	0	0
14	24317804	.	C	T	17	25	42	0	3	45	0	0
14	24317830	.	T	A	11	25	36	0	0	37	1	0
14	24318685	.	G	A	12	14	26	0	0	26	0	0
14	24318723	.	T	C	17	19	36	0	1	37	0	0
14	24318726	.	T	C	17	2	19	0	17	36	0	0
14	24326139	.	A	T	1	2	3	0	0	3	0	0
14	24326168	.	T	C	2	3	5	0	0	5	0	0
14	24326937	.	G	A	4	1	5	0	1	6	0	0
14	24327917	.	G	A	8	11	19	0	2	21	0	0
14	24328142	.	T	C	13	5	18	0	0	18	0	0
14	24369557	.	G	A	2	6	8	0	0	8	0	0
14	24369578	.	A	G	3	2	5	0	0	5	0	0
14	24376787	.	G	A	21	14	35	0	2	37	0	0
14	24401077	.	C	T	0	15	15	0	11	26	0	0
14	24401209	.	T	G	11	8	19	0	1	20	0	0
14	24401393	.	A	G	9	9	18	0	0	18	0	0
14	24401700	.	C	A	0	23	23	0	18	41	0	0
14	24401844	.	T	A	9	18	27	0	2	29	0	0
14	24409293	.	C	A	0	5	5	0	5	10	0	0
14	24492154	.	C	T	8	8	16	0	0	16	0	0
14	24492226	.	C	A	0	9	9	0	10	19	0	0
14	24492666	.	C	A	1	9	10	0	0	10	0	0
14	24492667	.	T	A	1	9	10	0	0	10	0	0
14	24497904	.	T	C	0	1	1	0	0	1	0	0
14	24512802	.	T	A	1	3	4	0	0	4	0	0
14	24855042	.	A	G	0	1	1	0	0	1	0	0
14	24867270	.	T	C	4	3	7	0	0	7	0	0
14	24873327	.	A	G	3	0	3	0	4	7	0	0
14	24978975	.	T	C	2	1	3	0	0	3	0	0
14	24984967	.	A	T	3	6	9	0	0	9	0	0
14	24984979	.	T	C	3	7	10	0	0	10	0	0
14	24990720	.	G	A	3	5	8	0	0	8	0	0
14	24990795	.	A	G	9	4	13	0	0	13	0	0
14	24997248	.	T	C	3	5	8	0	0	8	0	0
14	24997930	.	T	C	6	5	11	0	0	11	0	0
14	24998002	.	T	C	5	6	11	0	0	11	0	0
14	24998076	.	A	G	7	0	7	0	12	19	0	0
14	24998093	.	T	C	9	13	22	0	0	22	0	0
14	24998121	.	C	T	6	12	18	0	1	19	0	0
14	24998203	.	C	T	11	7	18	0	1	19	0	0
14	24998260	.	G	A	9	6	15	0	1	16	0	0
14	24998272	.	C	A	10	5	15	0	2	17	0	0
14	24998395	.	C	T	3	4	7	0	0	7	0	0
14	24998565	.	T	C	14	9	23	0	2	25	0	0
14	24998656	.	T	A	10	13	23	0	2	25	0	0
14	24998804	.	A	G	9	0	9	0	1	10	0	0
14	24998930	.	C	G	9	10	19	0	0	19	0	0
14	25000109	.	A	G	15	12	27	0	0	27	0	0
14	25000621	.	A	G	6	18	24	0	0	24	0	0
14	25000623	.	A	C	6	17	23	0	1	24	0	0
14	25000686	.	T	A	4	13	17	0	0	17	0	0
14	25000803	.	T	G	7	11	18	0	2	20	0	0
14	25035579	.	T	C	1	1	2	0	0	2	0	0
14	25066010	.	T	A	0	1	1	0	0	1	0	0
14	25067463	.	G	T	5	8	13	0	0	13	0	0
14	25067905	.	C	T	12	14	26	0	1	27	0	0
14	25072447	.	A	G	16	19	35	0	3	38	0	0
14	25072468	.	C	T	15	17	32	0	4	36	0	0
14	25072489	.	T	G	16	15	31	0	2	33	0	0
14	25072662	.	T	C	12	0	12	0	10	22	0	0
14	25072737	.	C	T	9	10	19	0	0	19	0	0
14	25072843	.	A	T	11	10	21	0	1	22	0	0
14	25073178	.	C	G	0	1	1	0	1	2	0	0
14	25073412	.	G	A	0	1	1	0	0	1	0	0
14	25076418	.	T	G	3	3	6	0	0	6	0	0
14	25077642	.	G	A	7	6	13	0	0	13	0	0
14	25078505	.	A	T	2	3	5	0	0	5	0	0
14	25084872	.	A	G	16	22	38	0	1	39	0	0
14	25090031	.	C	T	5	1	6	0	0	6	0	0
14	25090999	.	T	G	22	12	34	0	0	34	0	0
14	25091043	.	C	G	21	16	37	0	0	37	0	0
14	25091453	.	C	T	7	6	13	0	1	14	0	0
14	25091840	.	C	T	3	9	12	0	0	12	0	0
14	25092940	.	A	C	5	1	6	0	0	6	0	0
14	25093710	.	G	A	5	2	7	0	1	8	0	0
14	25095719	.	G	A	2	2	4	0	1	5	0	0
14	25102078	.	G	A	1	2	3	0	0	3	0	0
14	25104762	.	G	T	2	2	4	0	0	4	0	0
14	25480138	.	A	G	1	0	1	0	3	4	0	0
14	25480153	.	T	C	1	3	4	0	0	4	0	0
14	25483989	.	T	C	1	0	1	0	0	1	0	0
14	25495021	.	T	A	0	1	1	0	0	1	0	0
14	25495423	.	A	G	1	2	3	0	1	4	0	0
14	25496045	.	A	T	3	3	6	0	0	6	0	0
14	25496076	.	G	T	0	1	1	0	1	2	0	0
14	25498423	.	T	C	0	2	2	0	0	2	0	0
14	25498805	.	G	A	3	3	6	0	1	7	0	0
14	25498821	.	C	G	3	3	6	0	0	6	0	0
14	25499602	.	A	G	1	6	7	0	0	7	0	0
14	25499651	.	G	A	1	2	3	0	0	3	0	0
14	25499695	.	G	A	0	3	3	0	1	4	0	0
14	25500093	.	A	T	7	3	10	0	0	10	0	0
14	25500110	.	G	A	0	4	4	0	7	11	0	0
14	25500594	.	T	A	7	5	12	0	1	13	0	0
14	25500779	.	T	A	2	5	7	0	0	7	0	0
14	25500793	.	A	G	1	4	5	0	1	6	0	0
14	25500814	.	C	A	1	3	4	0	0	4	0	0
14	25501405	.	C	T	5	4	9	0	0	9	0	0
14	25501581	.	T	C	7	8	15	0	0	15	0	0
14	25501740	.	T	G	6	8	14	0	0	14	0	0
14	25501772	.	C	T	5	8	13	0	3	16	0	0
14	25501851	.	T	G	14	12	26	0	0	26	0	0
14	25501870	.	C	A	15	13	28	0	1	29	0	0
14	25502142	.	T	C	13	13	26	0	0	26	0	0
14	25538355	.	A	T	12	15	27	0	1	28	0	0
14	25538364	.	A	C	8	16	24	0	1	25	0	0
14	25538402	.	G	A	5	12	17	0	0	17	0	0
14	25538490	.	T	C	2	2	4	0	0	4	0	0
14	25538497	.	C	A	2	2	4	0	0	4	0	0
14	25538546	.	C	T	1	4	5	0	0	5	0	0
14	25591134	.	A	G	4	8	12	0	0	12	0	0
14	25591176	.	T	G	2	6	8	0	0	8	0	0
14	25817573	.	T	C	1	1	2	0	1	3	0	0
14	25904733	.	C	T	2	3	5	0	0	5	0	0
14	25904739	.	C	T	2	3	5	0	1	6	0	0
14	25904811	.	C	T	2	2	4	0	0	4	0	0
14	25906079	.	G	A	5	3	8	0	0	8	0	0
14	25906135	.	G	A	1	3	4	0	0	4	0	0
14	25906315	.	T	G	2	2	4	0	0	4	0	0
14	25906344	.	T	A	2	2	4	0	0	4	0	0
14	25906350	.	T	A	2	2	4	0	0	4	0	0
14	25906727	.	A	G	6	4	10	0	0	10	0	0
14	25907143	.	A	G	4	0	4	0	6	10	0	0
14	25907170	.	G	C	6	8	14	0	0	14	0	0
14	25907194	.	A	G	6	0	6	0	5	11	0	0
14	25907233	.	T	C	7	5	12	0	0	12	0	0
14	25907335	.	A	G	4	2	6	0	0	6	0	0
14	25907399	.	G	A	0	5	5	0	7	12	0	0
14	25907578	.	T	A	4	2	6	0	0	6	0	0
14	25907610	.	A	G	2	3	5	0	0	5	0	0
14	25907704	.	T	C	3	2	5	0	0	5	0	0
14	25908021	.	T	A	3	5	8	0	1	9	0	0
14	25908030	.	A	G	2	7	9	0	1	10	0	0
14	25908802	.	A	C	9	12	21	0	2	23	0	0
14	25908843	.	A	T	8	14	22	1	0	23	0	0
14	25908984	.	T	G	11	8	19	0	1	20	0	0
14	25909038	.	A	C	7	7	14	0	1	15	0	0
14	25909567	.	T	C	1	6	7	0	1	8	0	0
14	25909582	.	T	C	2	8	10	0	0	10	0	0
14	25909729	.	G	A	1	5	6	0	1	7	0	0
14	25909736	.	G	A	1	10	11	0	0	11	0	0
14	25910037	.	T	A	16	5	21	0	3	24	0	0
14	25910249	.	G	A	13	6	19	0	1	20	0	0
14	25910276	.	C	T	13	6	19	0	0	19	0	0
14	25910373	.	T	C	8	12	20	0	0	20	0	0
14	25910407	.	A	G	8	9	17	0	1	18	0	0
14	25910542	.	C	T	23	13	36	0	0	36	0	0
14	25910636	.	G	C	16	5	21	0	0	21	0	0
14	25910825	.	A	C	13	20	33	0	1	34	0	0
14	25911098	.	G	A	0	15	15	0	11	26	0	0
14	25923458	.	T	A	1	2	3	0	0	3	0	0
14	25923510	.	C	G	5	5	10	0	0	10	0	0
14	25923729	.	T	A	4	8	12	0	1	13	0	0
14	25923745	.	G	A	6	8	14	0	0	14	0	0
14	25923771	.	A	G	7	7	14	0	0	14	0	0
14	25923809	.	G	A	3	5	8	0	2	10	0	0
14	25923829	.	C	T	0	4	4	0	5	9	0	0
14	25923844	.	T	G	5	4	9	0	0	9	0	0
14	25923971	.	T	A	1	4	5	0	0	5	0	0
14	25924318	.	T	A	5	6	11	0	0	11	0	0
14	25924326	.	A	T	5	7	12	0	0	12	0	0
14	25924384	.	A	G	3	7	10	0	1	11	0	0
14	25924495	.	A	C	3	2	5	0	0	5	0	0
14	25924625	.	A	T	3	3	6	0	0	6	0	0
14	25924661	.	T	C	2	6	8	0	0	8	0	0
14	25924685	.	A	G	3	8	11	0	0	11	0	0
14	25924700	.	A	C	3	4	7	0	3	10	0	0
14	25924764	.	A	T	4	7	11	0	0	11	0	0
14	25924852	.	G	A	4	2	6	0	0	6	0	0
14	25924868	.	A	T	4	3	7	0	0	7	0	0
14	25924928	.	T	A	1	5	6	0	0	6	0	0
14	25925028	.	G	A	7	2	9	0	0	9	0	0
14	25925973	.	T	A	6	8	14	0	0	14	0	0
14	25926041	.	G	A	11	8	19	0	1	21	1	0
14	25926134	.	G	A	13	8	21	0	1	22	0	0
14	25926276	.	G	A	17	8	25	0	0	25	0	0
14	25926351	.	G	A	4	3	7	0	0	7	0	0
14	25935090	.	G	T	3	5	8	0	0	8	0	0
14	25938947	.	T	C	4	2	6	0	0	6	0	0
14	25939189	.	G	A	1	3	4	0	0	4	0	0
14	25939231	.	T	G	1	3	4	0	0	4	0	0
14	25939493	.	T	C	9	19	28	0	1	29	0	0
14	25983160	.	G	A	7	10	17	0	0	17	0	0
14	25983210	.	T	A	11	10	21	0	1	22	0	0
14	25985004	.	A	C	2	3	5	0	0	5	0	0
14	25985005	.	G	A	2	3	5	0	0	5	0	0
14	25985733	.	T	A	3	6	9	0	0	9	0	0
14	25987017	.	A	T	0	2	2	0	0	2	0	0
14	26002310	.	T	C	0	1	1	0	0	1	0	0
14	26011975	.	C	T	2	2	4	0	0	4	0	0
14	26064953	.	T	C	0	1	1	0	0	1	0	0
14	26064971	.	G	C	1	2	3	0	0	3	0	0
14	26065321	.	T	C	4	4	8	0	0	8	0	0
14	26065391	.	G	A	1	6	7	0	0	7	0	0
14	26065490	.	G	A	4	7	11	0	1	12	0	0
14	26065498	.	G	A	4	7	11	0	0	11	0	0
14	26066204	.	C	T	2	4	6	0	0	6	0	0
14	26066617	.	A	G	7	8	15	0	0	15	0	0
14	26066799	.	G	T	4	3	7	0	0	7	0	0
14	26066938	.	G	T	2	2	4	0	0	4	0	0
14	26067366	.	G	A	1	2	3	0	0	3	0	0
14	26067378	.	T	G	1	2	3	0	0	3	0	0
14	26067435	.	A	G	2	2	4	0	0	4	0	0
14	26067563	.	A	G	0	6	6	0	1	7	0	0
14	26067657	.	A	G	3	6	9	0	0	9	0	0
14	26067674	.	T	C	2	7	9	0	0	9	0	0
14	26075995	.	A	G	1	2	3	0	0	3	0	0
14	26103439	.	A	T	4	2	6	0	0	6	0	0
14	26104293	.	G	A	18	16	34	0	0	34	0	0
14	26104299	.	A	G	16	15	31	0	1	32	0	0
14	26104614	.	A	C	10	8	18	0	0	18	0	0
14	26104762	.	G	A	10	5	15	0	0	15	0	0
14	26104775	.	T	A	8	3	11	0	0	11	0	0
14	26105221	.	A	G	8	2	10	0	0	10	0	0
14	26105301	.	T	A	3	4	7	0	1	8	0	0
14	26105768	.	C	T	10	4	14	0	0	14	0	0
14	26106155	.	T	C	4	20	24	0	0	24	0	0
14	26106170	.	C	T	0	20	20	0	5	25	0	0
14	26106231	.	G	T	4	12	16	0	1	17	0	0
14	26106493	.	C	T	12	13	25	0	2	27	0	0
14	26106500	.	C	A	13	16	29	0	1	30	0	0
14	26106697	.	C	T	0	13	13	0	13	26	0	0
14	26106892	.	A	G	8	5	13	0	0	13	0	0
14	26109430	.	A	G	2	2	4	0	0	4	0	0
14	26111237	.	T	C	3	5	8	0	0	8	0	0
14	26114200	.	G	A	2	5	7	0	0	7	0	0
14	26114286	.	T	C	9	0	9	0	5	14	0	0
14	26127375	.	T	A	1	1	2	0	0	2	0	0
14	26135489	.	A	G	1	1	2	0	0	2	0	0
14	26135846	.	T	A	1	3	4	0	0	4	0	0
14	26147418	.	A	G	6	3	9	0	0	9	0	0
14	26152543	.	A	C	1	1	2	0	1	3	0	0
14	26152550	.	T	C	2	3	5	0	0	5	0	0
14	26152751	.	C	T	2	2	4	0	0	4	0	0
14	26224807	.	T	G	3	4	7	0	0	7	0	0
14	26227791	.	A	C	4	2	6	0	0	6	0	0
14	26227843	.	G	C	3	3	6	0	0	6	0	0
14	26376804	.	A	G	2	1	3	0	2	5	0	0
14	26376816	.	C	G	2	2	4	0	0	4	0	0
14	26376936	.	A	G	1	2	3	0	0	3	0	0
14	26381275	.	G	T	2	2	4	0	0	4	0	0
14	26381396	.	T	C	2	2	4	0	0	4	0	0
14	26385496	.	G	A	0	7	7	0	0	7	0	0
14	26385978	.	A	G	0	2	2	0	2	4	0	0
14	26386005	.	A	G	1	2	3	0	1	4	0	0
14	26386109	.	A	G	2	8	10	0	0	10	0	0
14	26391692	.	G	C	1	2	3	0	0	3	0	0
14	26404641	.	T	G	1	2	3	0	0	3	0	0
14	26404803	.	C	T	12	11	23	0	1	24	0	0
14	26404830	.	C	A	10	9	19	0	1	20	0	0
14	26405062	.	G	A	14	4	18	0	1	19	0	0
14	26405063	.	G	A	14	4	18	0	1	19	0	0
14	26405228	.	G	A	8	3	11	0	0	11	0	0
14	26405284	.	C	T	2	3	5	0	0	5	0	0
14	26405323	.	G	A	3	3	6	0	0	6	0	0
14	26405330	.	C	T	2	4	6	0	0	6	0	0
14	26405686	.	A	C	20	10	30	0	2	32	0	0
14	26405861	.	C	T	10	6	16	0	1	17	0	0
14	26411104	.	T	C	8	2	10	0	0	10	0	0
14	26411688	.	G	A	1	2	3	0	0	3	0	0
14	26413681	.	A	C	20	5	25	1	1	27	0	0
14	26413800	.	G	T	19	14	33	0	2	35	0	0
14	26414205	.	G	T	9	13	22	0	0	22	0	0
14	26414226	.	C	G	8	12	20	0	0	20	0	0
14	26415876	.	G	C	2	7	9	0	1	10	0	0
14	26427161	.	C	T	1	3	4	0	0	4	0	0
14	26427363	.	C	A	3	2	5	0	0	5	0	0
14	26427836	.	T	A	1	2	3	0	0	3	0	0
14	26427848	.	T	C	1	1	2	0	1	3	0	0
14	26427976	.	T	A	0	1	1	0	0	1	0	0
14	26428078	.	T	C	4	4	8	0	0	8	0	0
14	26428125	.	G	C	1	1	2	0	0	2	0	0
14	26435288	.	A	G	2	2	4	0	0	4	0	0
14	26439320	.	T	G	1	0	1	0	2	3	0	0
14	26450421	.	T	A	4	3	7	0	1	8	0	0
14	26453167	.	G	C	5	6	11	0	1	12	0	0
14	26453375	.	C	T	8	5	13	0	1	14	0	0
14	26456225	.	A	G	3	0	3	0	0	3	0	0
14	26456274	.	T	C	9	7	16	0	0	16	0	0
14	26456379	.	G	A	4	4	8	0	0	8	0	0
14	26458019	.	C	T	6	3	9	0	1	10	0	0
14	26458040	.	A	G	4	2	6	0	0	6	0	0
14	26460891	.	A	G	1	2	3	0	0	3	0	0
14	26464346	.	A	G	1	2	3	0	0	3	0	0
14	26464550	.	A	G	0	2	2	0	0	2	0	0
14	26467621	.	C	A	6	4	10	0	0	10	0	0
14	26511605	.	G	A	6	8	14	0	2	16	0	0
14	26511798	.	G	A	4	6	10	0	0	10	0	0
14	26716118	.	T	A	8	4	12	0	0	12	0	0
14	26716139	.	T	C	11	5	16	0	0	16	0	0
14	26718313	.	T	C	4	3	7	0	0	7	0	0
14	26718737	.	A	G	17	0	17	0	8	25	0	0
14	26718753	.	T	G	17	5	22	0	1	23	0	0
14	26729141	.	C	A	20	25	45	0	3	48	0	0
14	26794685	.	G	A	0	3	3	0	1	4	0	0
14	26794997	.	T	C	1	3	4	0	1	5	0	0
14	26795013	.	C	A	2	2	4	0	1	5	0	0
14	26796049	.	G	T	7	8	15	0	0	15	0	0
14	26805963	.	C	A	5	5	10	0	0	10	0	0
14	26836144	.	T	G	5	0	5	0	3	8	0	0
14	26995454	.	T	C	11	12	23	0	1	24	0	0
14	26995551	.	T	A	10	11	21	0	0	21	0	0
14	26995773	.	G	A	10	15	25	0	1	26	0	0
14	26996037	.	G	T	7	2	9	0	0	9	0	0
14	26996096	.	T	G	11	5	16	0	0	16	0	0
14	26996299	.	C	A	8	8	16	0	2	18	0	0
14	26996301	.	A	T	8	9	17	0	1	18	0	0
14	26996543	.	A	C	7	8	15	0	0	15	0	0
14	26996661	.	C	A	3	2	5	0	0	5	0	0
14	26996709	.	C	T	6	2	8	0	0	8	0	0
14	26996738	.	C	T	8	5	13	0	0	13	0	0
14	26996851	.	A	T	12	3	15	0	0	16	1	0
14	26996926	.	T	A	5	7	12	0	1	13	0	0
14	26996954	.	G	C	3	8	11	0	0	11	0	0
14	26996974	.	A	C	4	5	9	0	1	10	0	0
14	26997003	.	G	A	6	9	15	0	0	15	0	0
14	26997143	.	C	A	2	4	6	0	0	6	0	0
14	26997192	.	A	T	4	9	13	0	1	14	0	0
14	26997208	.	A	G	4	9	13	0	1	14	0	0
14	26997387	.	C	T	4	2	6	0	0	6	0	0
14	26997660	.	C	A	3	2	5	0	0	5	0	0
14	26998140	.	G	A	1	3	4	0	1	5	0	0
14	26998507	.	G	A	5	5	10	0	0	10	0	0
14	26998520	.	G	A	5	6	11	0	0	11	0	0
14	26998605	.	C	T	0	9	9	0	6	15	0	0
14	26998828	.	A	T	3	4	7	0	0	7	0	0
14	26998961	.	T	G	2	5	7	0	1	8	0	0
14	26999437	.	G	A	4	3	7	0	0	7	0	0
14	27000158	.	T	C	6	1	7	0	7	14	0	0
14	27000602	.	A	G	6	1	7	0	0	7	0	0
14	27121690	.	C	T	2	1	3	0	0	3	0	0
14	27121711	.	G	T	3	3	6	0	0	6	0	0
14	27281038	.	C	G	11	17	28	0	1	29	0	0
14	27281182	.	T	C	11	12	23	0	2	25	0	0
14	27281407	.	T	C	4	1	5	0	3	8	0	0
14	27281529	.	A	G	2	4	6	0	1	7	0	0
14	27281665	.	G	A	5	4	9	0	0	9	0	0
14	27282913	.	A	G	7	6	13	0	0	13	0	0
14	27282961	.	G	A	3	6	9	0	0	9	0	0
14	27283114	.	G	A	7	2	9	0	1	10	0	0
14	27283150	.	C	T	2	2	4	0	0	4	0	0
14	27288737	.	T	G	3	2	5	0	0	5	0	0
14	27999228	.	C	A	14	21	35	0	0	35	0	0
14	27999252	.	C	T	19	22	41	0	5	46	0	0
14	27999422	.	G	T	23	20	43	0	4	47	0	0
14	27999471	.	C	T	22	13	35	0	4	39	0	0
14	27999591	.	G	A	18	27	45	0	0	45	0	0
14	28001490	.	G	A	0	1	1	0	0	1	0	0
14	28001696	.	G	A	3	4	7	0	0	7	0	0
14	28052187	.	G	A	2	3	5	0	0	5	0	0
14	28282192	.	A	G	1	0	1	0	4	5	0	0
14	28351745	.	G	A	7	3	10	0	0	10	0	0
14	28366021	.	A	G	2	5	7	0	0	7	0	0
14	28385289	.	C	T	3	7	10	0	2	12	0	0
14	28385564	.	G	A	7	10	17	0	0	17	0	0
14	28433011	.	T	C	1	1	2	0	0	2	0	0
14	28443175	.	C	T	4	6	10	0	2	12	0	0
14	28448811	.	A	T	1	2	3	0	0	3	0	0
14	28448925	.	T	C	2	2	4	0	0	4	0	0
14	28449193	.	A	C	2	1	3	0	0	3	0	0
14	28452247	.	C	T	0	1	1	0	0	1	0	0
14	28452270	.	T	C	0	0	0	0	1	1	0	0
14	28453158	.	T	C	11	8	19	0	0	19	0	0
14	28453257	.	A	C	4	3	7	0	0	7	0	0
14	28453269	.	C	T	2	3	5	0	0	5	0	0
14	28457968	.	G	A	2	15	17	0	24	41	0	0
14	28458110	.	T	C	12	12	24	0	2	26	0	0
14	28458199	.	T	C	9	11	20	0	0	20	0	0
14	28458270	.	T	C	18	12	30	0	1	31	0	0
14	28458456	.	C	A	6	7	13	0	2	15	0	0
14	28458533	.	G	A	6	17	23	0	0	23	0	0
14	28458656	.	A	T	11	25	36	0	2	38	0	0
14	28458974	.	A	G	3	6	9	0	0	9	0	0
14	28458980	.	C	G	4	6	10	0	0	10	0	0
14	28459275	.	A	C	24	15	39	0	3	43	1	0
14	28459613	.	T	A	2	5	7	0	0	7	0	0
14	28463466	.	G	A	1	1	2	0	1	3	0	0
14	28464821	.	C	T	6	5	11	0	0	11	0	0
14	28464889	.	A	G	0	2	2	0	0	2	0	0
14	28476731	.	C	A	0	5	5	0	0	5	0	0
14	28476860	.	G	A	1	3	4	0	8	12	0	0
14	28480476	.	A	G	3	1	4	0	0	4	0	0
14	28481362	.	C	T	1	1	2	0	0	2	0	0
14	28482808	.	C	T	14	11	25	0	1	26	0	0
14	28482883	.	G	A	6	7	13	0	3	16	0	0
14	28482920	.	G	A	7	8	15	0	0	15	0	0
14	28486356	.	T	G	0	5	5	0	1	6	0	0
14	28486357	.	C	T	1	5	6	0	0	6	0	0
14	28497472	.	A	G	2	0	2	0	3	5	0	0
14	28504579	.	A	G	3	3	6	0	0	6	0	0
14	28507764	.	C	T	6	5	11	0	0	11	0	0
14	28514094	.	T	C	2	1	3	0	0	3	0	0
14	28514142	.	T	C	2	2	4	0	0	4	0	0
14	28514289	.	G	C	2	3	5	0	0	5	0	0
14	28514295	.	C	T	2	4	6	0	0	6	0	0
14	28515941	.	C	T	13	11	24	0	1	25	0	0
14	28518305	.	G	A	0	12	12	0	14	26	0	0
14	28520068	.	C	T	11	7	18	0	0	18	0	0
14	28520213	.	T	C	1	3	4	0	0	4	0	0
14	28525353	.	C	T	6	13	19	0	1	20	0	0
14	28525948	.	C	T	7	4	11	0	0	11	0	0
14	28525969	.	A	G	6	5	11	0	0	11	0	0
14	28526046	.	C	T	12	11	23	0	1	24	0	0
14	28526081	.	G	A	13	13	26	0	1	27	0	0
14	28526281	.	A	G	18	1	19	0	11	30	0	0
14	28526797	.	C	T	15	12	27	0	0	27	0	0
14	28526950	.	T	C	10	15	25	0	1	26	0	0
14	29729347	.	A	G	1	2	3	0	0	3	0	0
14	29729948	.	C	T	4	3	7	0	0	7	0	0
14	29746362	.	T	C	2	3	5	0	0	5	0	0
14	29746419	.	T	C	4	3	7	0	0	7	0	0
14	29746533	.	A	G	5	3	8	0	0	8	0	0
14	29746609	.	T	C	4	4	8	0	0	8	0	0
14	29746621	.	A	G	4	5	9	0	0	9	0	0
14	29746716	.	T	C	3	3	6	0	0	6	0	0
14	29746740	.	G	A	0	2	2	0	2	4	0	0
14	29746987	.	A	C	4	2	6	0	0	6	0	0
14	29750758	.	C	T	6	3	9	0	0	9	0	0
14	29754762	.	C	A	6	3	9	0	0	9	0	0
14	29757958	.	A	T	11	11	22	0	0	22	0	0
14	29758103	.	C	T	14	13	27	0	1	28	0	0
14	29758333	.	G	A	0	13	13	0	11	24	0	0
14	29758526	.	T	C	13	9	22	0	2	24	0	0
14	29759439	.	A	T	3	2	5	0	0	5	0	0
14	29759570	.	A	T	5	3	8	0	1	9	0	0
14	29780544	.	G	T	1	2	3	0	0	3	0	0
14	29780782	.	T	C	1	3	4	0	0	4	0	0
14	29782745	.	T	A	1	3	4	0	0	4	0	0
14	29782804	.	C	T	1	1	2	0	2	4	0	0
14	29807562	.	T	C	9	5	14	0	0	14	0	0
14	29808086	.	C	T	4	5	9	0	0	9	0	0
14	29808109	.	C	A	5	5	10	0	0	10	0	0
14	29808195	.	G	A	12	3	15	0	0	15	0	0
14	29808222	.	G	A	12	5	17	0	0	17	0	0
14	29808436	.	T	C	2	5	7	0	1	8	0	0
14	29808473	.	C	T	5	2	7	0	1	8	0	0
14	29808743	.	C	T	0	7	7	0	13	20	0	0
14	29808785	.	C	A	0	5	5	0	4	9	0	0
14	29808812	.	T	C	2	1	3	0	0	3	0	0
14	29810430	.	C	T	3	5	8	0	0	8	0	0
14	29821164	.	G	A	4	2	6	0	0	6	0	0
14	29822513	.	T	A	4	5	9	0	1	10	0	0
14	29823375	.	G	T	2	1	3	0	0	3	0	0
14	29825100	.	A	G	4	4	8	0	0	8	0	0
14	29825136	.	C	T	0	5	5	0	4	9	0	0
14	29825412	.	C	T	4	2	6	0	0	6	0	0
14	29825421	.	T	A	4	2	6	0	0	6	0	0
14	29825694	.	G	C	4	3	7	0	0	7	0	0
14	29825706	.	T	G	4	3	7	0	0	7	0	0
14	29825810	.	A	G	4	3	7	1	0	8	0	0
14	29826029	.	C	T	4	2	6	0	0	6	0	0
14	29826552	.	G	T	0	2	2	0	0	2	0	0
14	29836412	.	G	C	1	0	1	0	4	5	0	0
14	29841085	.	T	C	1	0	1	0	3	4	0	0
14	29841103	.	T	C	0	3	3	0	0	3	0	0
14	29843189	.	C	G	0	2	2	0	2	4	0	0
14	29883272	.	A	T	0	2	2	0	0	2	0	0
14	29883289	.	T	C	0	1	1	0	0	1	0	0
14	29989016	.	C	T	0	2	2	0	0	2	0	0
14	30107642	.	C	T	1	2	3	0	0	3	0	0
14	30108394	.	G	T	1	2	3	0	0	3	0	0
14	30157004	.	T	G	3	7	10	0	0	10	0	0
14	30158168	.	C	T	0	3	3	0	6	9	0	0
14	30158174	.	C	T	5	4	9	0	1	10	0	0
14	30158323	.	G	A	3	3	6	0	0	6	0	0
14	30158352	.	G	A	1	3	4	0	0	4	0	0
14	30158809	.	A	G	3	3	6	0	0	6	0	0
14	30158851	.	G	A	3	2	5	0	0	5	0	0
14	30159024	.	G	A	1	2	3	0	0	3	0	0
14	30159210	.	T	C	2	2	4	0	0	4	0	0
14	30159535	.	G	A	6	2	8	0	0	8	0	0
14	30159590	.	G	T	6	3	9	0	0	9	0	0
14	30159625	.	C	G	2	5	7	0	0	7	0	0
14	30174493	.	A	G	1	3	4	0	0	4	0	0
14	30274548	.	G	T	0	1	1	0	2	3	0	0
14	30274620	.	G	A	0	2	2	0	0	2	0	0
14	30274656	.	A	T	0	1	1	0	0	1	0	0
14	30277652	.	G	A	0	3	3	0	2	5	0	0
14	30350564	.	C	G	1	0	1	0	0	1	0	0
14	30356063	.	C	T	3	2	5	0	0	5	0	0
14	30357099	.	C	T	2	3	5	0	0	5	0	0
14	30357204	.	C	T	1	4	5	0	0	5	0	0
14	30359276	.	C	T	3	6	9	0	0	9	0	0
14	30361275	.	G	A	1	0	1	0	0	1	0	0
14	30398618	.	G	A	5	1	6	0	3	9	0	0
14	30399386	.	G	T	1	1	2	0	0	2	0	0
14	30403613	.	T	C	0	4	4	0	0	4	0	0
14	30403716	.	T	C	0	1	1	0	0	1	0	0
14	30403830	.	G	A	1	1	2	0	0	2	0	0
14	30407577	.	G	C	0	3	3	0	2	5	0	0
14	30411143	.	C	T	6	5	11	0	0	11	0	0
14	30411825	.	G	A	6	6	12	0	0	12	0	0
14	30411895	.	T	A	1	2	3	0	1	4	0	0
14	30412056	.	T	C	2	4	6	0	0	6	0	0
14	30428193	.	G	T	6	9	15	0	0	15	0	0
14	30428225	.	C	T	0	6	6	0	7	13	0	0
14	30428272	.	T	A	3	8	11	0	0	11	0	0
14	30428319	.	A	G	2	3	5	0	0	5	0	0
14	30428322	.	A	G	2	2	4	0	0	4	0	0
14	30435578	.	G	A	3	2	5	0	0	5	0	0
14	30452156	.	C	T	2	2	4	0	0	4	0	0
14	30454527	.	C	T	0	7	7	0	2	9	0	0
14	30454552	.	C	T	2	5	7	0	1	8	0	0
14	30454583	.	T	A	0	6	6	0	0	6	0	0
14	30454599	.	T	A	1	4	5	0	0	5	0	0
14	30454651	.	T	A	3	4	7	0	0	7	0	0
14	30454917	.	C	T	0	5	5	0	8	13	0	0
14	30455121	.	C	T	2	7	9	0	0	9	0	0
14	30455134	.	T	A	5	8	13	0	0	13	0	0
14	30455842	.	T	A	4	4	8	0	0	8	0	0
14	30456139	.	C	T	1	3	4	0	0	4	0	0
14	30456201	.	A	T	3	5	8	0	0	8	0	0
14	30456373	.	T	G	6	8	14	0	1	15	0	0
14	30456463	.	C	T	0	2	2	0	0	2	0	0
14	30460630	.	G	A	10	12	22	0	0	22	0	0
14	30493275	.	G	A	0	5	5	0	1	6	0	0
14	30493285	.	A	C	0	5	5	0	0	5	0	0
14	30551712	.	G	T	3	3	6	0	2	8	0	0
14	30569108	.	G	A	0	2	2	0	4	6	0	0
14	30580844	.	C	T	2	3	5	0	0	5	0	0
14	30581000	.	A	C	3	0	3	0	6	9	0	0
14	30581152	.	G	A	7	5	12	0	0	12	0	0
14	30581245	.	A	T	7	5	12	0	1	13	0	0
14	30581308	.	C	T	0	9	9	0	6	15	0	0
14	30581329	.	C	A	8	10	18	0	0	18	0	0
14	30581910	.	A	G	4	7	11	0	0	11	0	0
14	30587436	.	C	T	1	3	4	0	0	4	0	0
14	30620229	.	G	C	13	9	22	0	2	24	0	0
14	30637866	.	T	C	22	0	22	0	28	50	0	0
14	30637907	.	G	A	24	26	50	0	1	51	0	0
14	30638016	.	G	A	21	18	39	0	3	42	0	0
14	30638018	.	G	A	23	17	40	0	2	42	0	0
14	30638336	.	C	T	16	18	34	0	0	34	0	0
14	30638599	.	G	A	8	7	15	0	0	15	0	0
14	30639165	.	A	G	22	24	46	0	1	47	0	0
14	30641256	.	G	A	9	18	27	0	1	28	0	0
14	30641872	.	A	G	9	7	16	0	0	16	0	0
14	30642513	.	A	G	5	7	12	0	1	13	0	0
14	30642529	.	A	T	5	7	12	0	1	13	0	0
14	30642594	.	T	G	13	10	23	0	0	23	0	0
14	30642616	.	T	A	11	13	24	0	1	25	0	0
14	30642757	.	T	G	15	21	36	0	0	36	0	0
14	30720073	.	T	C	4	0	4	0	2	6	0	0
14	30720372	.	T	G	4	4	8	0	0	8	0	0
14	30731046	.	T	C	8	9	17	0	1	18	0	0
14	30731174	.	C	T	10	10	20	0	1	21	0	0
14	30731175	.	G	T	0	10	10	0	11	21	0	0
14	30731565	.	T	C	3	3	6	0	0	6	0	0
14	30731577	.	A	G	2	5	7	0	1	8	0	0
14	30731747	.	A	T	5	2	7	0	1	8	0	0
14	30731849	.	A	C	8	6	14	0	0	14	0	0
14	30731987	.	C	A	9	7	16	0	0	16	0	0
14	30732064	.	C	G	13	6	19	0	2	21	0	0
14	30732229	.	T	C	15	14	29	0	1	30	0	0
14	30732828	.	T	G	14	6	20	0	0	20	0	0
14	30733008	.	C	T	15	12	27	0	1	28	0	0
14	30733164	.	G	A	12	15	27	0	4	31	0	0
14	30733237	.	T	G	22	1	23	0	15	38	0	0
14	30733685	.	G	A	18	9	27	0	3	30	0	0
14	30733689	.	G	A	19	11	30	0	0	30	0	0
14	30733783	.	C	A	8	15	23	0	0	23	0	0
14	30733964	.	C	T	13	10	23	0	2	25	0	0
14	30733990	.	T	C	16	16	32	0	0	32	0	0
14	30734183	.	C	T	16	18	34	0	2	36	0	0
14	30734900	.	G	A	5	5	10	0	0	10	0	0
14	30740364	.	T	A	3	3	6	0	0	6	0	0
14	30740539	.	A	G	2	2	4	0	0	4	0	0
14	30741019	.	G	T	1	2	3	0	0	3	0	0
14	30741091	.	A	T	2	3	5	0	0	5	0	0
14	30741464	.	C	G	1	2	3	0	0	3	0	0
14	30742260	.	G	A	3	5	8	0	0	8	0	0
14	30742265	.	T	G	4	4	8	0	0	8	0	0
14	30745662	.	A	G	1	0	1	0	0	1	0	0
14	30745764	.	C	T	0	5	5	0	1	6	0	0
14	30754639	.	T	G	0	0	0	0	1	1	0	0
14	30758891	.	T	C	4	1	5	0	0	5	0	0
14	30759357	.	A	G	8	3	11	0	0	11	0	0
14	30759358	.	C	A	8	3	11	0	0	11	0	0
14	30791109	.	C	T	2	4	6	0	0	6	0	0
14	30791127	.	C	T	2	3	5	0	0	5	0	0
14	30793046	.	G	A	1	2	3	0	1	4	0	0
14	30793048	.	A	C	1	3	4	0	0	4	0	0
14	30793161	.	C	T	5	3	8	0	0	8	0	0
14	30793397	.	G	A	2	2	4	0	0	4	0	0
14	30793398	.	C	T	2	2	4	0	0	4	0	0
14	30793465	.	G	T	2	7	9	0	0	9	0	0
14	30793472	.	C	T	2	9	11	0	0	11	0	0
14	30793907	.	C	T	4	4	8	0	0	8	0	0
14	30793925	.	C	G	2	3	5	0	0	5	0	0
14	30795633	.	T	C	12	7	19	0	0	19	0	0
14	30799000	.	T	C	33	28	61	0	0	61	0	0
14	30800528	.	T	C	14	10	24	0	0	24	0	0
14	30801043	.	C	A	37	28	65	0	1	66	0	0
14	30801329	.	G	A	20	20	40	0	0	40	0	0
14	30801379	.	G	A	15	17	32	0	1	33	0	0
14	30801389	.	A	G	15	15	30	0	1	31	0	0
14	30801451	.	G	C	16	15	31	0	1	32	0	0
14	30801552	.	C	A	1	3	4	0	0	4	0	0
14	30803026	.	G	A	4	3	7	0	1	8	0	0
14	30803247	.	T	G	7	2	9	0	0	9	0	0
14	30803469	.	T	A	1	7	8	0	0	8	0	0
14	30803472	.	T	G	1	7	8	0	0	8	0	0
14	30803537	.	G	A	2	3	5	0	0	5	0	0
14	30803902	.	T	C	2	5	7	0	0	7	0	0
14	30803904	.	G	C	1	0	1	0	6	7	0	0
14	30803950	.	G	A	2	2	4	0	0	4	0	0
14	30804832	.	T	C	3	2	5	0	0	5	0	0
14	30804844	.	T	A	4	2	6	0	0	6	0	0
14	30854742	.	A	C	24	14	38	0	0	38	0	0
14	30855117	.	A	C	21	30	51	0	1	52	0	0
14	30855649	.	C	A	23	21	44	0	2	46	0	0
14	30855668	.	A	T	26	19	45	0	2	47	0	0
14	30855767	.	G	T	18	16	34	0	2	37	1	0
14	30855824	.	T	A	16	25	41	0	3	44	0	0
14	30855973	.	T	G	13	15	28	0	1	29	0	0
14	30876422	.	A	C	0	2	2	0	0	2	0	0
14	30876425	.	A	G	0	2	2	0	0	2	0	0
14	30876670	.	A	T	7	8	15	0	0	15	0	0
14	30878707	.	C	A	5	4	9	0	0	9	0	0
14	30878800	.	A	C	7	5	12	0	0	12	0	0
14	30879257	.	T	C	5	0	5	0	10	15	0	0
14	30879274	.	T	G	3	10	13	0	0	13	0	0
14	30879324	.	G	A	2	7	9	0	0	9	0	0
14	30879384	.	T	G	3	3	6	0	0	6	0	0
14	30879573	.	C	T	2	3	5	0	1	6	0	0
14	30879619	.	A	G	5	5	10	0	0	10	0	0
14	30879620	.	A	C	4	5	9	0	1	10	0	0
14	30879698	.	T	A	5	7	12	0	1	13	0	0
14	30879736	.	T	C	7	7	14	0	0	14	0	0
14	30879985	.	A	G	1	3	4	0	0	4	0	0
14	30880091	.	A	C	2	2	4	0	0	4	0	0
14	30880248	.	T	G	6	11	17	0	1	18	0	0
14	30880361	.	A	G	6	10	16	0	1	17	0	0
14	30880477	.	C	T	1	8	9	0	4	13	0	0
14	30880497	.	C	T	3	10	13	0	0	13	0	0
14	30880532	.	A	G	4	4	8	0	0	8	0	0
14	30880980	.	T	C	6	1	7	0	6	13	0	0
14	30881219	.	C	T	3	2	5	0	0	5	0	0
14	30881327	.	A	G	1	3	4	0	0	4	0	0
14	30881337	.	C	T	0	2	2	0	0	2	0	0
14	30883321	.	G	A	1	2	3	0	0	3	0	0
14	30885146	.	A	G	1	2	3	0	0	3	0	0
14	30915103	.	A	G	4	2	6	0	1	7	0	0
14	30915417	.	A	T	3	3	6	0	0	6	0	0
14	30915627	.	G	T	0	5	5	0	3	8	0	0
14	30915909	.	T	G	2	0	2	0	5	7	0	0
14	30916033	.	A	T	1	3	4	0	0	4	0	0
14	30916113	.	A	G	4	0	4	0	7	11	0	0
14	30916902	.	G	A	10	5	15	0	0	15	0	0
14	30922349	.	T	C	9	4	13	0	0	13	0	0
14	30925570	.	A	C	5	0	5	0	4	9	0	0
14	30927355	.	C	G	1	1	2	0	0	2	0	0
14	30929861	.	C	T	2	5	7	0	0	7	0	0
14	30970827	.	G	C	6	3	9	0	1	10	0	0
14	30970895	.	C	T	1	2	3	0	0	3	0	0
14	30975479	.	G	T	28	20	48	0	2	50	0	0
14	30978589	.	G	T	13	16	29	0	0	29	0	0
14	30978661	.	T	C	13	16	29	0	1	30	0	0
14	30978700	.	T	C	8	11	19	0	2	21	0	0
14	30978706	.	G	A	8	8	16	0	1	17	0	0
14	30982248	.	T	C	22	0	22	0	16	38	0	0
14	30982468	.	A	G	9	17	26	0	2	28	0	0
14	30987167	.	G	T	16	16	32	0	1	33	0	0
14	30988280	.	T	C	16	0	16	0	14	30	0	0
14	30988494	.	G	A	16	6	22	0	0	22	0	0
14	30988627	.	A	G	11	11	22	0	1	23	0	0
14	30988644	.	G	A	11	2	13	0	0	13	0	0
14	30988664	.	C	T	12	6	18	0	0	18	0	0
14	30989292	.	C	G	0	10	10	0	5	15	0	0
14	30989535	.	A	G	4	5	9	1	1	11	0	0
14	30989908	.	A	G	9	5	14	0	0	14	0	0
14	30990321	.	T	A	13	12	25	0	3	28	0	0
14	30990436	.	C	A	7	11	18	0	0	18	0	0
14	30991060	.	C	T	6	3	9	0	1	10	0	0
14	30991311	.	A	G	8	5	13	0	3	16	0	0
14	31024014	.	G	A	1	6	7	0	1	8	0	0
14	31024053	.	A	G	3	6	9	0	0	9	0	0
14	31026727	.	A	G	0	1	1	0	0	1	0	0
14	31081921	.	G	C	1	2	3	0	1	4	0	0
14	31082400	.	T	C	11	10	21	0	1	22	0	0
14	31082474	.	G	T	4	7	11	0	0	11	0	0
14	31082519	.	C	T	0	4	4	0	4	8	0	0
14	31082537	.	C	T	3	5	8	0	1	9	0	0
14	31082717	.	G	A	9	6	15	0	2	17	0	0
14	31082745	.	A	T	8	10	18	0	3	21	0	0
14	31082975	.	A	G	5	8	13	0	0	13	0	0
14	31083110	.	C	A	5	14	19	0	1	20	0	0
14	31083206	.	C	A	8	7	15	0	2	17	0	0
14	31087245	.	T	A	4	6	10	0	0	10	0	0
14	31090259	.	C	T	4	3	7	0	0	7	0	0
14	31090339	.	C	T	3	8	11	0	0	11	0	0
14	31090935	.	C	T	5	3	8	0	0	8	0	0
14	31091264	.	C	T	0	8	8	0	7	15	0	0
14	31091589	.	T	A	7	6	13	0	1	14	0	0
14	31177140	.	G	C	4	0	4	0	4	8	0	0
14	31177220	.	T	C	1	2	3	0	1	4	0	0
14	31177704	.	A	G	3	5	8	0	0	8	0	0
14	31177744	.	T	C	5	0	5	0	5	10	0	0
14	31263527	.	T	A	2	2	4	0	0	4	0	0
14	31325256	.	C	T	3	3	6	0	0	6	0	0
14	31474374	.	T	G	1	3	4	0	1	5	0	0
14	31474700	.	G	T	1	4	5	0	1	6	0	0
14	31477482	.	A	G	7	3	10	0	1	11	0	0
14	31478234	.	C	T	0	3	3	0	0	3	0	0
14	31478280	.	A	T	0	1	1	0	2	3	0	0
14	31478444	.	A	T	0	4	4	0	1	5	0	0
14	31478767	.	G	A	5	7	12	0	0	12	0	0
14	31479176	.	T	A	2	2	4	0	0	4	0	0
14	31479230	.	A	G	1	2	3	0	0	3	0	0
14	31498368	.	C	G	3	0	3	0	5	8	0	0
14	31498392	.	G	A	0	6	6	0	7	13	0	0
14	31498413	.	T	C	8	9	17	0	1	18	0	0
14	31507476	.	A	G	4	1	5	0	7	12	0	0
14	31514373	.	T	C	5	3	8	0	0	8	0	0
14	31514394	.	G	A	0	3	3	0	5	8	0	0
14	31516506	.	A	G	1	0	1	0	1	2	0	0
14	31516509	.	G	A	0	0	0	0	2	2	0	0
14	31519051	.	A	G	14	6	20	0	0	20	0	0
14	31519213	.	C	T	9	9	18	0	0	18	0	0
14	31519241	.	A	G	9	7	16	0	2	18	0	0
14	31519340	.	G	A	6	6	12	0	0	12	0	0
14	31519611	.	T	A	1	2	3	0	1	4	0	0
14	31519730	.	T	A	5	4	9	0	0	9	0	0
14	31519948	.	T	C	10	10	20	0	0	20	0	0
14	31520077	.	C	A	10	2	12	2	0	14	0	0
14	31520080	.	G	C	9	3	12	2	0	14	0	0
14	31520119	.	T	C	7	11	18	0	1	19	0	0
14	31520336	.	A	G	3	0	3	0	2	5	0	0
14	31520483	.	T	C	6	17	23	0	0	23	0	0
14	31520555	.	T	C	2	7	9	0	0	9	0	0
14	31520590	.	A	G	3	1	4	0	4	8	0	0
14	31520750	.	T	C	6	5	11	0	0	11	0	0
14	31521442	.	G	A	2	2	4	0	0	4	0	0
14	31521446	.	T	C	2	2	4	0	0	4	0	0
14	31530046	.	C	T	6	2	8	0	0	8	0	0
14	31530171	.	G	T	10	6	16	0	1	17	0	0
14	31530350	.	A	G	6	10	16	0	1	17	0	0
14	31530388	.	T	C	10	14	24	0	0	24	0	0
14	31530439	.	G	A	7	3	10	0	0	10	0	0
14	31541122	.	A	T	0	1	1	0	0	1	0	0
14	31544842	.	C	T	12	15	27	0	0	27	0	0
14	31545181	.	A	T	17	9	26	0	3	29	0	0
14	31545272	.	C	T	4	13	17	0	1	18	0	0
14	31545433	.	A	T	9	8	17	0	0	17	0	0
14	31545794	.	A	G	7	9	16	0	1	17	0	0
14	31545795	.	G	A	7	10	17	0	0	17	0	0
14	31545902	.	T	A	17	7	24	0	3	27	0	0
14	31545919	.	A	T	12	9	21	0	1	22	0	0
14	31546107	.	T	G	9	1	10	0	10	20	0	0
14	31546137	.	T	A	12	13	25	0	0	25	0	0
14	31546320	.	C	T	13	6	19	0	0	19	0	0
14	31546470	.	A	T	8	11	19	0	0	19	0	0
14	31546493	.	A	G	7	0	7	0	12	19	0	0
14	31551477	.	G	A	8	12	20	0	2	22	0	0
14	31556263	.	T	C	6	8	14	0	1	15	0	0
14	31556308	.	G	A	7	9	16	0	1	17	0	0
14	31556326	.	T	C	8	0	8	0	14	22	0	0
14	31556344	.	A	G	7	11	18	0	1	19	0	0
14	31556371	.	A	G	12	15	27	0	0	27	0	0
14	31558943	.	A	G	9	11	20	0	1	21	0	0
14	31559000	.	T	G	6	15	21	0	2	23	0	0
14	31603318	.	A	C	1	1	2	0	0	2	0	0
14	31607859	.	A	T	4	5	9	0	0	9	0	0
14	31607860	.	G	A	4	5	9	0	0	9	0	0
14	31607897	.	A	G	3	3	6	0	0	6	0	0
14	31608037	.	G	T	1	2	3	0	0	3	0	0
14	31615629	.	G	A	7	3	10	0	1	11	0	0
14	31615658	.	C	T	7	8	15	0	3	18	0	0
14	31616139	.	G	T	14	16	30	0	2	32	0	0
14	31616151	.	C	T	13	13	26	0	1	27	0	0
14	31616186	.	C	T	13	4	17	0	0	17	0	0
14	31641769	.	C	T	5	8	13	0	0	13	0	0
14	31641799	.	G	A	0	7	7	0	6	13	0	0
14	31641847	.	A	G	3	5	8	0	2	10	0	0
14	31641886	.	G	A	0	4	4	0	4	8	0	0
14	31641962	.	A	G	6	4	10	0	0	10	0	0
14	31642476	.	T	G	5	2	7	0	1	8	0	0
14	31642965	.	A	T	5	3	8	0	0	8	0	0
14	31643177	.	G	A	2	6	8	0	0	8	0	0
14	31643257	.	T	C	4	2	6	0	0	6	0	0
14	31643411	.	A	T	4	4	8	0	0	8	0	0
14	31643437	.	C	T	4	3	7	0	0	7	0	0
14	31643749	.	C	A	5	8	13	0	1	14	0	0
14	31643781	.	A	G	4	11	15	0	1	16	0	0
14	31644229	.	C	G	16	1	17	0	14	31	0	0
14	31644239	.	G	C	14	14	28	0	0	28	0	0
14	31644291	.	C	T	18	10	28	0	0	28	0	0
14	31644488	.	T	C	6	9	15	0	0	15	0	0
14	31644520	.	T	G	8	6	14	0	1	15	0	0
14	31644542	.	C	T	5	3	8	0	1	9	0	0
14	31644561	.	A	G	4	2	6	0	0	6	0	0
14	31644583	.	G	T	0	2	2	0	2	4	0	0
14	31644638	.	A	G	2	9	11	0	1	12	0	0
14	31644646	.	A	G	6	5	11	0	1	12	0	0
14	31644805	.	C	T	10	7	17	0	0	17	0	0
14	31644813	.	G	C	10	8	18	0	1	19	0	0
14	31644859	.	T	A	7	4	11	0	0	11	0	0
14	31644972	.	T	C	5	9	14	0	4	18	0	0
14	31644994	.	T	C	4	5	9	0	1	10	0	0
14	31645082	.	A	G	15	4	19	0	4	23	0	0
14	31645450	.	C	T	2	3	5	0	0	5	0	0
14	31645683	.	A	T	7	5	12	0	2	14	0	0
14	31645962	.	A	G	3	9	12	0	0	12	0	0
14	31645989	.	T	A	4	7	11	0	0	11	0	0
14	31646016	.	T	A	4	8	12	0	1	13	0	0
14	31646039	.	C	A	7	7	14	0	0	14	0	0
14	31646217	.	C	A	9	9	18	0	1	19	0	0
14	31646275	.	C	A	10	9	19	0	0	19	0	0
14	31646307	.	G	T	4	3	7	0	0	7	0	0
14	31646443	.	A	C	3	4	7	0	0	7	0	0
14	31646486	.	A	T	4	4	8	0	1	9	0	0
14	31646655	.	T	C	10	9	19	0	0	19	0	0
14	31646793	.	C	T	4	2	6	0	0	6	0	0
14	31646830	.	G	T	6	5	11	0	1	12	0	0
14	31646831	.	A	G	6	5	11	0	1	12	0	0
14	31647135	.	A	T	11	15	26	0	0	26	0	0
14	31647217	.	A	G	13	7	20	0	1	21	0	0
14	31647291	.	G	A	8	1	9	0	2	16	5	0
14	31647335	.	G	T	13	1	14	0	1	15	0	0
14	31647553	.	G	T	8	11	19	0	1	20	0	0
14	31647682	.	A	G	6	8	14	0	1	15	0	0
14	31668646	.	G	A	11	8	19	0	1	20	0	0
14	31668719	.	C	T	0	11	11	0	14	25	0	0
14	31668758	.	G	A	13	10	23	0	0	23	0	0
14	31668859	.	T	A	11	11	22	0	1	23	0	0
14	31669103	.	A	T	8	10	18	0	1	19	0	0
14	31669304	.	C	A	6	9	15	0	1	16	0	0
14	31669376	.	T	G	4	4	8	0	0	8	0	0
14	31669377	.	G	T	4	4	8	0	0	8	0	0
14	31669466	.	C	G	8	12	20	0	2	22	0	0
14	31669488	.	A	G	8	15	23	0	2	25	0	0
14	31669646	.	G	A	11	6	17	0	1	18	0	0
14	31669907	.	A	T	5	5	10	0	0	10	0	0
14	31670800	.	T	A	2	2	4	0	1	5	0	0
14	31670831	.	T	G	0	1	1	0	0	1	0	0
14	31673775	.	A	G	1	3	4	0	1	5	0	0
14	31673856	.	A	C	1	0	1	0	2	3	0	0
14	31675852	.	G	T	6	3	9	0	2	11	0	0
14	31675891	.	T	C	5	7	12	0	0	12	0	0
14	31675925	.	G	A	2	3	5	0	0	5	0	0
14	31677655	.	C	T	1	0	1	0	1	2	0	0
14	31681840	.	T	G	0	0	0	0	7	7	0	0
14	31682168	.	T	C	0	5	5	0	0	5	0	0
14	31779690	.	G	A	0	0	0	0	1	1	0	0
14	31780163	.	G	A	2	0	2	0	0	2	0	0
14	31780174	.	T	C	3	0	3	0	0	3	0	0
14	31780273	.	G	T	0	6	6	0	1	7	0	0
14	31780311	.	A	G	3	0	3	0	8	11	0	0
14	31780353	.	C	A	5	1	6	0	0	6	0	0
14	31780355	.	T	G	4	1	5	0	1	6	0	0
14	31780398	.	T	A	3	1	4	0	0	4	0	0
14	31799878	.	G	A	2	2	4	0	1	5	0	0
14	31799879	.	A	T	3	2	5	0	0	5	0	0
14	31800090	.	T	C	7	8	15	0	0	15	0	0
14	31800175	.	G	T	9	11	20	0	1	22	1	0
14	31800206	.	T	A	10	6	16	0	0	16	0	0
14	31800378	.	T	C	4	6	10	0	1	11	0	0
14	31800589	.	G	A	7	9	16	0	0	16	0	0
14	31800870	.	C	G	7	6	13	0	0	13	0	0
14	31800875	.	G	A	6	6	12	0	1	13	0	0
14	31801428	.	C	G	11	5	16	0	2	18	0	0
14	31801483	.	A	G	6	3	9	0	0	9	0	0
14	31801715	.	A	G	9	4	13	0	0	13	0	0
14	31801904	.	A	G	9	8	17	0	1	18	0	0
14	31801979	.	T	C	7	7	14	0	1	15	0	0
14	31802443	.	A	G	1	6	7	0	0	7	0	0
14	31802739	.	G	C	6	3	9	0	0	9	0	0
14	31803044	.	C	A	6	4	10	0	1	11	0	0
14	31803148	.	A	G	2	4	6	0	1	7	0	0
14	31803150	.	T	C	2	5	7	0	0	7	0	0
14	31803191	.	T	C	3	0	3	0	2	5	0	0
14	31806317	.	C	T	3	2	5	0	0	5	0	0
14	31814000	.	C	G	0	3	3	0	0	3	0	0
14	31814089	.	T	C	4	0	4	0	5	9	0	0
14	31822694	.	C	T	2	2	4	0	0	4	0	0
14	31856891	.	G	T	12	11	23	0	1	24	0	0
14	31857773	.	T	A	17	12	29	0	0	29	0	0
14	31858123	.	G	A	18	20	38	0	3	41	0	0
14	31858492	.	T	G	8	11	19	0	0	19	0	0
14	31881728	.	A	G	6	4	10	0	0	10	0	0
14	31881791	.	G	T	5	3	8	0	0	8	0	0
14	31882101	.	G	T	3	2	5	0	0	5	0	0
14	31882507	.	T	C	1	3	4	0	0	4	0	0
14	31882672	.	G	T	3	5	8	0	0	8	0	0
14	31882802	.	C	T	2	3	5	0	0	5	0	0
14	31882817	.	T	A	2	2	4	0	1	5	0	0
14	31882840	.	A	G	1	0	1	0	3	4	0	0
14	31882888	.	A	T	5	2	7	0	0	7	0	0
14	31883231	.	G	C	4	3	7	0	0	7	0	0
14	31883472	.	A	C	4	3	7	0	2	9	0	0
14	31883519	.	G	C	0	9	9	0	7	16	0	0
14	31890334	.	G	A	2	2	4	0	0	4	0	0
14	31890757	.	C	G	0	8	8	0	4	12	0	0
14	31890874	.	G	A	2	4	6	0	0	6	0	0
14	31936927	.	G	A	0	5	5	0	0	5	0	0
14	31936928	.	A	G	0	5	5	0	0	5	0	0
14	32011834	.	C	A	11	14	25	0	1	26	0	0
14	32011993	.	T	C	9	19	28	0	4	32	0	0
14	32025140	.	A	T	2	3	5	0	1	6	0	0
14	32025466	.	T	G	4	6	10	0	0	10	0	0
14	32057378	.	T	C	1	10	11	0	1	12	0	0
14	32147932	.	G	A	1	2	3	0	0	3	0	0
14	32184469	.	C	T	13	20	33	0	1	34	0	0
14	32184927	.	C	A	20	13	33	0	1	34	0	0
14	32185036	.	C	A	0	23	23	0	19	42	0	0
14	32185199	.	A	G	11	9	20	0	1	21	0	0
14	32254558	.	C	T	0	0	0	0	1	1	0	0
14	32255068	.	G	T	7	4	11	0	0	11	0	0
14	32403594	.	G	C	10	8	18	0	0	19	1	0
14	32443474	.	T	G	2	2	4	0	0	4	0	0
14	32443696	.	A	G	14	8	22	0	1	23	0	0
14	32443734	.	A	T	11	9	20	0	0	20	0	0
14	32443811	.	A	C	11	7	18	0	0	18	0	0
14	32443841	.	A	T	12	9	21	0	0	21	0	0
14	32444121	.	C	T	13	12	25	0	1	26	0	0
14	32444168	.	T	G	8	7	15	0	1	16	0	0
14	32444379	.	T	C	5	5	10	0	0	10	0	0
14	32444496	.	G	T	9	6	15	0	0	15	0	0
14	32444608	.	G	C	13	12	25	0	0	25	0	0
14	32444854	.	G	T	3	5	8	0	1	9	0	0
14	32447838	.	G	A	2	0	2	0	0	2	0	0
14	32447872	.	C	A	6	2	8	0	1	9	0	0
14	32447915	.	T	C	4	0	4	0	1	5	0	0
14	32448068	.	T	C	5	2	7	0	0	7	0	0
14	32475280	.	G	A	0	3	3	0	0	3	0	0
14	32475417	.	T	C	0	2	2	0	0	2	0	0
14	32507833	.	T	C	6	1	7	0	9	16	0	0
14	32518852	.	G	A	3	4	7	0	0	7	0	0
14	32526563	.	A	G	0	1	1	0	0	1	0	0
14	32526677	.	A	G	2	5	7	0	1	8	0	0
14	32665206	.	T	C	1	3	4	0	0	4	0	0
14	32742955	.	A	T	2	2	4	0	0	4	0	0
14	32743736	.	G	A	4	9	13	0	1	14	0	0
14	32857002	.	C	T	5	4	9	0	0	9	0	0
14	32857704	.	G	A	0	5	5	0	2	7	0	0
14	32857812	.	A	C	10	5	15	0	1	16	0	0
14	32858004	.	G	C	0	11	11	0	12	23	0	0
14	32858012	.	C	T	12	12	24	0	0	24	0	0
14	32858080	.	C	A	9	10	19	0	1	20	0	0
14	32858244	.	T	C	24	11	35	0	0	35	0	0
14	32858301	.	C	T	13	16	29	0	0	29	0	0
14	32858364	.	C	T	6	18	24	0	0	24	0	0
14	32858570	.	C	T	10	11	21	0	1	22	0	0
14	32858578	.	C	G	12	10	22	0	2	24	0	0
14	32858638	.	G	A	5	7	12	0	0	12	0	0
14	32858701	.	C	T	5	16	21	0	1	22	0	0
14	32859554	.	C	T	9	14	23	0	1	24	0	0
14	32859908	.	G	T	10	11	21	0	2	23	0	0
14	32860345	.	A	G	11	3	14	0	1	15	0	0
14	32860374	.	T	C	7	0	7	0	16	23	0	0
14	32860434	.	C	T	14	13	27	0	1	28	0	0
14	32860692	.	T	A	4	3	7	0	1	8	0	0
14	32860704	.	G	A	4	3	7	0	1	8	0	0
14	32865916	.	G	A	2	3	5	0	0	5	0	0
14	32866234	.	C	T	8	4	12	0	0	12	0	0
14	32884065	.	C	T	0	12	12	0	14	26	0	0
14	32884876	.	T	C	3	0	3	0	3	6	0	0
14	32885453	.	G	T	4	2	6	0	0	6	0	0
14	32938217	.	C	A	2	2	4	0	0	4	0	0
14	32938218	.	A	T	2	2	4	0	0	4	0	0
14	32945327	.	C	T	1	2	3	0	0	3	0	0
14	32952043	.	C	T	0	3	3	0	0	3	0	0
14	32952467	.	C	T	12	6	18	0	0	18	0	0
14	32952493	.	G	A	6	5	11	0	3	14	0	0
14	32952576	.	C	T	8	7	15	0	2	17	0	0
14	32952825	.	C	T	0	5	5	0	11	16	0	0
14	32953035	.	T	C	3	3	6	0	0	6	0	0
14	32959812	.	G	C	1	2	3	0	0	3	0	0
14	32984084	.	G	A	5	7	12	0	1	13	0	0
14	32984139	.	A	C	12	7	19	0	1	20	0	0
14	32984414	.	G	T	6	4	10	0	0	10	0	0
14	32984574	.	T	C	1	3	4	0	0	4	0	0
14	32984675	.	A	T	2	5	7	0	1	8	0	0
14	32985012	.	T	C	4	3	7	0	1	8	0	0
14	32985067	.	A	T	5	3	8	0	0	8	0	0
14	33120875	.	A	G	2	1	3	0	0	3	0	0
14	33220216	.	A	G	3	2	5	0	0	5	0	0
14	33220247	.	T	C	4	2	6	0	1	7	0	0
14	33267946	.	T	C	11	9	20	0	1	21	0	0
14	33268115	.	T	G	3	6	9	0	0	9	0	0
14	33268219	.	A	G	5	10	15	0	1	16	0	0
14	33268254	.	C	A	7	11	18	0	2	20	0	0
14	33268297	.	T	C	2	21	23	0	0	23	0	0
14	33268388	.	A	G	10	0	10	0	6	16	0	0
14	33280738	.	C	T	4	2	6	0	0	6	0	0
14	33280818	.	C	T	26	11	37	0	1	38	0	0
14	33281690	.	A	G	23	11	34	0	0	34	0	0
14	33281816	.	C	T	4	14	18	0	34	52	0	0
14	33281856	.	T	A	34	17	51	0	0	51	0	0
14	33281892	.	C	A	29	18	47	0	2	49	0	0
14	33281907	.	T	A	30	19	49	0	2	51	0	0
14	33281964	.	T	C	30	15	45	0	0	45	0	0
14	33282119	.	A	G	34	23	57	0	1	58	0	0
14	33282245	.	A	T	26	22	48	0	1	49	0	0
14	33282246	.	A	C	27	21	48	0	1	49	0	0
14	33282347	.	C	T	2	22	24	0	27	51	0	0
14	33288448	.	A	G	14	13	27	0	0	27	0	0
14	33297882	.	A	T	7	11	18	0	1	19	0	0
14	33298098	.	C	A	5	10	15	1	3	19	0	0
14	33298397	.	T	C	9	7	16	0	1	17	0	0
14	33298436	.	C	T	11	12	23	0	2	25	0	0
14	33299087	.	T	C	20	15	35	0	3	38	0	0
14	33302468	.	C	G	1	3	4	0	0	4	0	0
14	33306583	.	T	C	13	9	22	0	0	22	0	0
14	33308039	.	A	G	26	20	46	0	1	47	0	0
14	33308120	.	G	A	3	13	16	0	3	19	0	0
14	33314102	.	G	A	4	12	16	0	1	17	0	0
14	33316828	.	A	G	6	11	17	0	1	18	0	0
14	33333741	.	A	G	19	19	38	0	1	39	0	0
14	33339530	.	G	A	4	3	7	0	0	7	0	0
14	33339617	.	C	T	8	9	17	0	0	17	0	0
14	33339791	.	G	T	5	4	9	0	0	9	0	0
14	33339895	.	G	A	2	5	7	0	1	8	0	0
14	33344463	.	A	G	2	4	6	0	2	8	0	0
14	33344536	.	T	G	8	4	12	0	0	12	0	0
14	33414060	.	G	C	0	4	4	0	3	7	0	0
14	33414105	.	T	A	16	13	29	0	1	30	0	0
14	33414168	.	C	T	19	27	46	0	0	46	0	0
14	33414590	.	G	A	4	3	7	0	1	8	0	0
14	33414596	.	C	T	4	3	7	0	1	8	0	0
14	33418766	.	A	G	16	13	29	0	0	29	0	0
14	33419714	.	G	A	4	1	5	1	0	6	0	0
14	33424626	.	T	C	7	11	18	0	0	18	0	0
14	33424854	.	A	C	27	2	29	0	17	46	0	0
14	33424931	.	T	C	20	19	39	0	2	41	0	0
14	33425008	.	A	T	19	12	31	0	3	34	0	0
14	33432132	.	A	G	4	0	4	0	2	6	0	0
14	33432594	.	T	G	3	0	3	0	7	10	0	0
14	33433669	.	G	A	3	3	6	0	0	6	0	0
14	33434018	.	A	T	3	4	7	0	0	7	0	0
14	33434076	.	A	T	4	5	9	0	0	9	0	0
14	33434207	.	T	C	4	2	6	0	0	6	0	0
14	33434208	.	G	A	3	2	5	0	1	6	0	0
14	33434536	.	C	T	2	2	4	0	0	4	0	0
14	33435231	.	G	A	6	5	11	0	0	11	0	0
14	33435415	.	A	G	4	2	6	0	9	15	0	0
14	33435540	.	T	A	13	9	22	0	0	22	0	0
14	33435686	.	T	C	8	4	12	0	0	12	0	0
14	33435714	.	G	A	8	4	12	0	0	12	0	0
14	33435768	.	C	A	6	3	9	0	0	9	0	0
14	33435893	.	C	T	0	5	5	0	2	7	0	0
14	33435916	.	T	G	4	7	11	0	1	12	0	0
14	33435948	.	G	A	9	8	17	0	0	17	0	0
14	33435967	.	C	T	13	6	19	0	1	20	0	0
14	33436091	.	A	T	13	18	31	0	1	32	0	0
14	33436311	.	A	G	18	16	34	0	0	34	0	0
14	33436514	.	G	A	12	20	32	0	1	33	0	0
14	33436650	.	A	T	11	22	33	0	2	35	0	0
14	33437009	.	G	T	12	17	29	0	1	30	0	0
14	33437056	.	C	A	11	17	28	0	0	28	0	0
14	33437252	.	A	G	11	21	32	0	1	33	0	0
14	33437262	.	T	G	12	22	34	0	1	35	0	0
14	33437294	.	C	G	15	28	43	0	0	43	0	0
14	33437305	.	A	G	15	25	40	0	2	42	0	0
14	33442066	.	T	C	5	7	12	0	1	13	0	0
14	33442069	.	C	T	5	7	12	0	0	12	0	0
14	33465057	.	A	G	1	6	7	0	0	7	0	0
14	33465603	.	C	T	1	1	2	0	0	2	0	0
14	33469268	.	A	G	11	11	22	0	0	22	0	0
14	33469281	.	G	A	11	11	22	0	1	23	0	0
14	33469370	.	C	T	6	4	10	0	0	10	0	0
14	33469609	.	C	T	5	4	9	0	0	9	0	0
14	33469636	.	A	G	10	3	13	0	0	13	0	0
14	33474222	.	G	T	5	4	9	0	0	9	0	0
14	33474230	.	T	C	5	5	10	0	0	10	0	0
14	33474809	.	T	C	4	0	4	0	5	9	0	0
14	33475445	.	A	C	6	5	11	0	2	13	0	0
14	33497008	.	C	T	2	0	2	0	0	2	0	0
14	33498960	.	G	A	1	2	3	0	0	3	0	0
14	33501922	.	A	G	5	7	12	0	0	12	0	0
14	33504572	.	A	G	8	14	22	0	0	22	0	0
14	33504633	.	C	A	12	14	26	0	0	26	0	0
14	33504657	.	A	G	14	13	27	0	1	28	0	0
14	33504669	.	T	A	16	16	32	0	1	33	0	0
14	33505055	.	G	C	13	13	26	0	4	30	0	0
14	33505058	.	A	G	11	0	11	0	20	31	0	0
14	33505500	.	A	C	12	13	25	0	2	27	0	0
14	33515983	.	C	T	4	9	13	0	0	13	0	0
14	33516015	.	G	A	7	10	17	0	0	17	0	0
14	33516131	.	A	G	9	10	19	0	0	19	0	0
14	33516218	.	G	C	3	0	3	0	11	14	0	0
14	33516237	.	C	T	6	10	16	0	0	16	0	0
14	33516314	.	A	G	7	7	14	0	1	15	0	0
14	33516371	.	T	G	10	3	13	0	0	13	0	0
14	33516374	.	T	C	9	0	9	0	3	12	0	0
14	33516603	.	T	C	4	0	4	0	6	10	0	0
14	33516619	.	A	G	3	4	7	0	0	7	0	0
14	33516706	.	T	C	12	0	12	0	4	16	0	0
14	33517203	.	A	C	7	4	11	0	0	11	0	0
14	33517333	.	T	C	2	6	8	0	0	8	0	0
14	33517334	.	T	A	2	6	8	0	0	8	0	0
14	33517654	.	C	A	5	5	10	0	0	10	0	0
14	33517746	.	C	T	3	5	8	0	1	9	0	0
14	33518128	.	C	T	2	2	4	0	0	4	0	0
14	33518254	.	G	A	4	4	8	0	0	8	0	0
14	33518323	.	G	A	4	4	8	0	0	8	0	0
14	33518341	.	G	A	5	5	10	0	0	10	0	0
14	33518461	.	A	G	2	2	4	0	1	5	0	0
14	33518494	.	A	G	4	2	6	0	0	6	0	0
14	33518551	.	T	G	1	2	3	0	0	3	0	0
14	33518679	.	A	G	0	2	2	0	0	2	0	0
14	33525236	.	C	T	3	6	9	0	0	9	0	0
14	33525250	.	A	T	4	6	10	0	0	10	0	0
14	33549834	.	T	C	1	1	2	0	0	2	0	0
14	33557503	.	C	A	3	2	5	0	0	5	0	0
14	33557521	.	C	T	3	2	5	0	0	5	0	0
14	33562482	.	C	T	12	6	18	0	0	18	0	0
14	33562504	.	G	C	11	5	16	0	1	17	0	0
14	33564916	.	C	T	4	5	9	0	0	9	0	0
14	33564955	.	C	T	16	13	29	0	0	29	0	0
14	33564956	.	T	G	15	13	28	0	1	29	0	0
14	33565275	.	C	A	13	13	26	0	0	26	0	0
14	33565296	.	C	A	13	14	27	0	0	27	0	0
14	33565477	.	G	T	5	10	15	0	1	16	0	0
14	33565665	.	T	C	5	9	14	0	0	14	0	0
14	33565675	.	T	G	4	3	7	0	0	7	0	0
14	33565797	.	T	G	6	0	6	0	9	15	0	0
14	33566058	.	A	C	15	4	19	0	0	19	0	0
14	33566542	.	A	T	17	14	31	0	2	33	0	0
14	33566578	.	G	C	18	13	31	0	1	32	0	0
14	33566613	.	G	A	13	6	19	0	1	20	0	0
14	33566945	.	C	T	18	18	36	0	0	36	0	0
14	33567085	.	A	G	7	13	20	0	1	21	0	0
14	33591862	.	T	A	1	3	4	0	1	5	0	0
14	33744608	.	T	C	8	1	9	0	1	10	0	0
14	33754000	.	C	T	9	8	17	0	0	17	0	0
14	33754476	.	G	A	0	13	13	0	8	21	0	0
14	33754549	.	G	A	9	14	23	0	1	24	0	0
14	33755394	.	A	C	11	7	18	0	1	19	0	0
14	33755590	.	T	C	17	18	35	0	1	36	0	0
14	33755677	.	C	A	18	18	36	0	1	37	0	0
14	33755810	.	A	C	25	7	32	0	2	34	0	0
14	33755813	.	C	A	16	16	32	0	3	35	0	0
14	33755847	.	T	C	24	16	40	0	0	40	0	0
14	33756950	.	G	A	27	20	47	0	0	47	0	0
14	33757152	.	A	C	30	23	53	0	1	54	0	0
14	33757169	.	A	C	31	26	57	0	2	59	0	0
14	33791257	.	A	G	1	2	3	0	0	3	0	0
14	33791262	.	C	T	0	2	2	0	1	3	0	0
14	33826371	.	T	C	11	19	30	0	0	30	0	0
14	33826385	.	A	G	11	20	31	0	1	32	0	0
14	33826453	.	G	A	12	10	22	0	1	23	0	0
14	33826491	.	T	G	13	6	19	0	1	20	0	0
14	33826827	.	C	T	4	4	8	0	0	8	0	0
14	33827170	.	T	C	2	9	11	0	2	13	0	0
14	33827426	.	T	C	4	4	8	0	0	8	0	0
14	33827532	.	T	C	3	10	13	0	0	14	1	0
14	33827584	.	C	G	3	15	18	0	2	20	0	0
14	33827771	.	G	A	7	10	17	0	0	17	0	0
14	33827791	.	A	T	12	5	17	0	0	17	0	0
14	33827869	.	C	A	8	6	14	0	0	14	0	0
14	33827903	.	C	T	0	6	6	0	8	14	0	0
14	33827940	.	C	A	9	4	13	0	0	13	0	0
14	33827966	.	T	A	2	7	9	0	1	10	0	0
14	33828007	.	A	T	2	1	3	0	0	3	0	0
14	33828008	.	C	A	1	2	3	0	0	3	0	0
14	33828422	.	C	T	6	2	8	0	0	8	0	0
14	33828707	.	C	T	5	9	14	0	0	14	0	0
14	33828777	.	C	A	9	5	14	0	0	14	0	0
14	33829143	.	C	T	0	4	4	0	10	14	0	0
14	33830689	.	G	A	1	1	2	0	0	2	0	0
14	33835798	.	A	C	2	3	5	0	1	6	0	0
14	33835840	.	G	A	6	3	9	0	1	10	0	0
14	33835891	.	C	T	3	6	9	0	0	9	0	0
14	33835936	.	A	G	5	1	6	0	1	7	0	0
14	33838587	.	T	C	1	1	2	0	0	2	0	0
14	33842685	.	A	T	1	1	2	0	0	2	0	0
14	33848540	.	C	A	1	4	5	0	0	5	0	0
14	33850298	.	C	T	0	1	1	0	2	3	0	0
14	33860372	.	T	C	24	15	39	0	0	39	0	0
14	33860468	.	G	A	14	24	38	0	4	42	0	0
14	33860477	.	G	A	16	21	37	0	3	41	1	0
14	33864388	.	G	A	18	18	36	0	0	36	0	0
14	33865704	.	A	G	9	13	22	0	0	22	0	0
14	33865954	.	C	T	5	8	13	0	4	17	0	0
14	33866024	.	T	C	3	3	6	0	0	6	0	0
14	33868606	.	G	A	1	1	2	0	0	2	0	0
14	33868723	.	G	A	20	13	33	0	1	34	0	0
14	33883167	.	A	C	3	3	6	0	0	6	0	0
14	33891229	.	G	A	1	1	2	0	0	2	0	0
14	33891711	.	G	A	0	17	17	0	17	34	0	0
14	33892044	.	A	T	3	1	4	0	1	5	0	0
14	33892153	.	T	C	13	9	22	0	3	25	0	0
14	33892388	.	A	G	2	0	2	0	3	5	0	0
14	33892441	.	C	G	8	4	12	0	0	12	0	0
14	33892490	.	G	A	6	8	14	0	3	17	0	0
14	33892501	.	C	T	7	8	15	0	1	16	0	0
14	33899178	.	T	G	1	2	3	0	0	3	0	0
14	33899629	.	C	T	19	23	42	0	4	46	0	0
14	33899674	.	T	C	16	0	16	0	14	30	0	0
14	33900150	.	A	C	12	21	33	0	1	35	1	0
14	33900552	.	A	T	16	20	36	0	1	37	0	0
14	33900561	.	T	A	19	12	31	0	4	35	0	0
14	33901267	.	C	A	9	8	17	0	0	17	0	0
14	33901591	.	T	C	5	4	9	0	0	9	0	0
14	33903006	.	C	A	2	7	9	0	0	9	0	0
14	33910014	.	T	A	14	8	22	0	0	22	0	0
14	33916671	.	C	T	0	4	4	0	0	4	0	0
14	33936366	.	A	T	9	7	16	0	1	17	0	0
14	33936378	.	T	A	10	8	18	0	1	19	0	0
14	33936502	.	A	G	8	4	12	0	0	12	0	0
14	33940934	.	A	T	1	0	1	0	1	2	0	0
14	33941087	.	A	C	2	3	5	0	1	6	0	0
14	33941169	.	G	A	1	4	5	0	0	5	0	0
14	33941266	.	G	A	5	10	15	0	1	16	0	0
14	33945261	.	T	A	1	3	4	0	1	5	0	0
14	33983904	.	T	C	31	23	54	0	3	57	0	0
14	33984300	.	A	G	18	8	26	0	1	27	0	0
14	33984308	.	A	T	16	7	23	0	5	29	1	0
14	33984402	.	G	A	7	5	12	0	1	13	0	0
14	33987455	.	T	A	7	12	19	0	0	19	0	0
14	33998090	.	A	G	15	9	24	0	0	24	0	0
14	33998156	.	A	G	5	3	8	0	0	8	0	0
14	34000502	.	G	A	1	1	2	0	0	2	0	0
14	34002547	.	A	G	4	3	7	0	1	8	0	0
14	34013059	.	G	A	1	3	4	0	0	4	0	0
14	34044318	.	C	T	0	5	5	0	3	8	0	0
14	34064313	.	C	T	2	3	5	0	0	5	0	0
14	34064371	.	A	T	3	5	8	0	0	8	0	0
14	34064401	.	G	A	1	1	2	0	0	2	0	0
14	34065178	.	G	A	9	7	16	0	4	20	0	0
14	34065290	.	T	C	10	11	21	0	1	22	0	0
14	34065442	.	A	G	13	8	21	0	3	24	0	0
14	34065454	.	G	A	15	11	26	0	0	26	0	0
14	34065568	.	C	G	6	0	6	0	13	19	0	0
14	34065596	.	T	A	5	9	14	0	1	15	0	0
14	34065879	.	G	A	3	1	4	0	1	5	0	0
14	34068110	.	A	G	4	9	13	0	1	14	0	0
14	34068760	.	G	A	4	7	11	0	1	12	0	0
14	34068889	.	C	A	1	2	3	0	0	3	0	0
14	34077406	.	A	T	10	9	19	0	0	19	0	0
14	34079322	.	C	T	0	2	2	0	0	2	0	0
14	34079362	.	G	A	7	8	15	0	0	15	0	0
14	34082287	.	G	A	1	2	3	0	0	3	0	0
14	34082311	.	G	A	6	6	12	0	0	12	0	0
14	34082628	.	C	A	3	1	4	0	0	4	0	0
14	34089508	.	A	G	17	0	17	0	13	30	0	0
14	34089559	.	C	A	10	7	17	0	2	19	0	0
14	34089597	.	T	C	8	6	14	0	1	15	0	0
14	34089636	.	A	G	10	0	10	0	16	26	0	0
14	34089864	.	C	T	11	10	21	0	0	21	0	0
14	34089900	.	G	A	11	10	21	0	0	21	0	0
14	34089941	.	A	G	10	14	24	0	0	24	0	0
14	34090001	.	G	T	1	11	12	0	9	21	0	0
14	34090034	.	A	T	6	6	12	0	1	13	0	0
14	34090093	.	A	C	8	9	17	0	1	18	0	0
14	34090228	.	G	A	10	9	19	0	4	23	0	0
14	34090315	.	T	G	10	19	29	0	1	30	0	0
14	34090647	.	G	A	0	11	11	0	14	25	0	0
14	34090784	.	A	T	4	3	7	0	0	7	0	0
14	34091134	.	A	C	4	6	10	0	0	10	0	0
14	34091717	.	T	G	7	9	16	0	1	17	0	0
14	34091805	.	C	A	19	10	29	0	2	31	0	0
14	34091851	.	C	T	17	14	31	0	0	31	0	0
14	34091971	.	G	A	12	15	27	0	0	27	0	0
14	34125983	.	T	A	0	3	3	0	0	3	0	0
14	34127017	.	A	G	10	13	23	0	1	24	0	0
14	34127403	.	A	G	1	3	4	0	1	5	0	0
14	34127445	.	A	G	5	16	21	0	2	23	0	0
14	34127457	.	C	T	9	19	28	0	0	28	0	0
14	34127492	.	G	T	15	15	30	0	2	32	0	0
14	34127507	.	T	G	13	11	24	0	3	27	0	0
14	34127967	.	C	T	12	10	22	0	0	22	0	0
14	34128063	.	A	G	1	4	5	0	0	5	0	0
14	34128066	.	T	A	1	4	5	0	0	5	0	0
14	34128314	.	A	T	6	6	12	0	1	13	0	0
14	34128399	.	A	C	11	7	18	0	1	19	0	0
14	34128516	.	C	T	10	19	29	0	2	31	0	0
14	34128528	.	C	T	10	19	29	0	1	30	0	0
14	34128565	.	T	G	13	21	34	0	0	34	0	0
14	34128744	.	G	A	9	13	22	0	0	22	0	0
14	34128799	.	C	T	0	16	16	0	9	25	0	0
14	34128901	.	G	A	14	6	20	0	0	20	0	0
14	34128902	.	T	G	13	6	19	0	1	20	0	0
14	34129092	.	C	T	0	10	10	0	16	26	0	0
14	34129103	.	A	G	18	9	27	0	0	27	0	0
14	34129159	.	T	C	13	12	25	0	1	26	0	0
14	34129433	.	T	G	5	9	14	0	3	17	0	0
14	34129502	.	G	T	11	7	18	0	0	18	0	0
14	34129545	.	G	A	9	11	20	0	1	21	0	0
14	34129578	.	G	A	7	13	20	0	1	22	1	0
14	34129644	.	T	A	8	7	15	0	0	15	0	0
14	34129724	.	C	T	10	9	19	0	1	20	0	0
14	34129780	.	T	C	8	7	15	0	2	17	0	0
14	34129848	.	G	A	6	4	10	0	1	11	0	0
14	34129878	.	A	G	5	6	11	0	1	12	0	0
14	34129937	.	G	A	4	7	11	0	0	11	0	0
14	34129946	.	G	A	6	6	12	0	0	12	0	0
14	34129992	.	T	C	4	0	4	0	2	6	0	0
14	34130042	.	A	G	0	2	2	2	1	5	0	0
14	34130123	.	T	A	6	2	8	0	0	8	0	0
14	34130132	.	T	A	6	5	11	0	0	11	0	0
14	34130397	.	C	T	6	3	9	0	0	9	0	0
14	34139713	.	G	A	5	2	7	0	0	7	0	0
14	34153728	.	A	G	1	1	2	0	0	2	0	0
14	34153801	.	A	G	6	4	10	0	0	10	0	0
14	34154815	.	A	G	2	5	7	0	0	7	0	0
14	34486720	.	A	G	9	1	10	0	12	22	0	0
14	34487972	.	C	T	5	3	8	0	0	8	0	0
14	34488456	.	T	C	7	15	22	0	5	27	0	0
14	34488655	.	A	G	17	13	30	0	2	32	0	0
14	34488687	.	C	A	21	12	33	0	3	36	0	0
14	34547661	.	G	A	1	2	3	0	1	4	0	0
14	34553016	.	C	T	4	2	6	0	0	6	0	0
14	34553502	.	A	G	1	2	3	0	0	3	0	0
14	34553535	.	G	A	0	1	1	0	0	1	0	0
14	34556534	.	T	C	3	6	9	0	0	9	0	0
14	34556758	.	C	T	2	4	6	0	0	6	0	0
14	34556826	.	C	G	9	8	17	0	2	19	0	0
14	34556986	.	C	T	8	5	13	0	0	13	0	0
14	34566932	.	C	T	1	1	2	0	0	2	0	0
14	34634281	.	T	C	2	3	5	0	0	5	0	0
14	34634415	.	T	A	2	2	4	0	0	4	0	0
14	34634584	.	C	A	6	4	10	0	0	10	0	0
14	34635144	.	C	T	3	5	8	0	1	9	0	0
14	34635565	.	G	A	5	3	8	0	0	8	0	0
14	34670750	.	C	G	0	2	2	0	0	2	0	0
14	34792398	.	G	T	0	3	3	0	0	3	0	0
14	34792627	.	T	C	3	2	5	0	0	5	0	0
14	34794940	.	A	T	5	2	7	0	0	7	0	0
14	34797681	.	G	T	7	7	14	0	1	15	0	0
14	34797711	.	T	C	9	9	18	0	0	18	0	0
14	34797734	.	C	A	7	10	17	0	0	17	0	0
14	34797810	.	C	A	3	10	13	1	1	15	0	0
14	34797908	.	T	C	7	8	15	0	2	17	0	0
14	34797972	.	C	T	7	6	13	0	0	13	0	0
14	34798017	.	C	T	9	3	12	0	1	13	0	0
14	34798031	.	C	T	7	4	11	0	0	11	0	0
14	34798095	.	T	A	3	2	5	0	0	5	0	0
14	34825745	.	T	C	3	9	12	0	0	12	0	0
14	34825761	.	A	G	2	9	11	0	0	11	0	0
14	34826502	.	T	A	3	4	7	0	0	7	0	0
14	34826823	.	T	A	1	2	3	0	0	3	0	0
14	34826842	.	A	C	2	2	4	0	0	4	0	0
14	34826860	.	T	A	3	1	4	0	0	4	0	0
14	34826951	.	T	A	5	4	9	0	0	9	0	0
14	34828113	.	G	T	5	4	9	0	1	10	0	0
14	35003880	.	C	T	6	5	11	0	0	11	0	0
14	35008665	.	C	T	10	7	17	0	1	18	0	0
14	35008780	.	T	A	3	5	8	0	1	10	1	0
14	35008804	.	T	C	6	5	11	0	0	11	0	0
14	35008885	.	G	A	6	4	10	0	0	10	0	0
14	35008887	.	C	A	6	4	10	0	0	10	0	0
14	35009326	.	C	T	1	2	3	0	0	3	0	0
14	35009651	.	T	C	20	17	37	0	2	39	0	0
14	35009652	.	G	T	19	17	36	0	2	39	1	0
14	35009736	.	A	T	9	14	23	0	1	24	0	0
14	35009739	.	A	G	9	12	21	0	2	23	0	0
14	35009989	.	G	A	0	3	3	0	5	8	0	0
14	35010026	.	A	T	6	10	16	0	2	18	0	0
14	35010230	.	C	T	7	6	13	0	3	16	0	0
14	35010236	.	A	T	10	9	19	0	0	19	0	0
14	35010936	.	T	A	6	6	12	0	2	14	0	0
14	35011140	.	G	A	8	7	15	0	1	16	0	0
14	35011174	.	C	T	5	4	9	0	1	10	0	0
14	35011301	.	C	T	7	10	17	0	0	17	0	0
14	35011398	.	G	T	4	6	10	0	0	10	0	0
14	35011445	.	C	A	10	3	13	0	0	13	0	0
14	35011570	.	C	T	11	17	28	0	2	30	0	0
14	35011857	.	G	A	14	7	21	0	0	21	0	0
14	35011944	.	G	A	21	14	35	0	0	35	0	0
14	35387393	.	C	T	7	2	9	0	0	9	0	0
14	35804833	.	A	G	3	1	4	0	0	4	0	0
14	35813121	.	T	A	1	25	26	0	1	28	1	0
14	36229415	.	C	T	1	4	5	0	0	5	0	0
14	36268424	.	T	C	0	3	3	0	0	3	0	0
14	36268426	.	T	C	0	3	3	0	0	3	0	0
14	36351100	.	T	C	54	17	71	0	1	72	0	0
14	36720985	.	A	G	8	9	17	0	0	17	0	0
14	38659002	.	G	A	1	0	1	0	0	1	0	0
14	38668543	.	G	C	0	3	3	0	0	3	0	0
14	38668546	.	T	C	0	2	2	0	0	2	0	0
14	38668782	.	C	A	0	2	2	0	0	2	0	0
14	38668815	.	C	T	0	3	3	0	0	3	0	0
14	38669562	.	G	T	0	3	3	0	2	5	0	0
14	38670016	.	C	T	0	1	1	0	0	1	0	0
14	38672310	.	A	G	5	0	5	0	4	9	0	0
14	38672521	.	G	T	5	3	8	0	1	9	0	0
14	38688730	.	G	A	2	6	8	0	0	8	0	0
14	38688794	.	A	T	1	3	4	0	0	4	0	0
14	38688829	.	G	C	1	6	7	0	3	10	0	0
14	38689174	.	G	A	6	8	14	0	1	15	0	0
14	38689332	.	A	G	6	7	13	0	0	13	0	0
14	38689428	.	G	C	8	5	13	0	0	13	0	0
14	38763334	.	A	C	13	7	20	0	2	22	0	0
14	38763381	.	G	A	13	18	31	0	1	32	0	0
14	38763394	.	G	A	18	14	32	0	2	34	0	0
14	38783272	.	T	C	8	4	12	0	3	15	0	0
14	38802662	.	G	T	2	4	6	0	1	7	0	0
14	38802884	.	C	T	1	2	3	0	0	3	0	0
14	38802960	.	G	A	1	4	5	0	0	5	0	0
14	38802967	.	T	G	1	4	5	0	0	5	0	0
14	38803085	.	G	A	1	2	3	0	0	3	0	0
14	38803088	.	C	T	0	1	1	0	2	3	0	0
14	38806916	.	G	T	0	1	1	0	0	1	0	0
14	38809356	.	G	A	2	2	4	0	0	4	0	0
14	38809512	.	C	T	2	4	6	0	0	6	0	0
14	38809528	.	T	C	2	2	4	0	0	4	0	0
14	38845762	.	T	C	9	12	21	0	1	22	0	0
14	38845912	.	A	G	37	14	51	0	3	55	1	0
14	38846587	.	A	T	41	21	62	0	0	62	0	0
14	38847235	.	A	G	21	8	29	0	2	31	0	0
14	38847497	.	A	G	3	0	3	0	3	6	0	0
14	38849729	.	C	T	28	15	43	0	1	44	0	0
14	38849946	.	A	C	33	22	55	0	1	56	0	0
14	38853381	.	C	G	8	2	10	0	0	10	0	0
14	38853397	.	A	G	4	7	11	0	0	11	0	0
14	38853821	.	C	T	1	5	6	0	0	6	0	0
14	38862589	.	A	G	3	4	7	0	0	7	0	0
14	38862598	.	A	G	5	4	9	0	0	9	0	0
14	38865589	.	C	T	2	2	4	0	0	4	0	0
14	38872410	.	C	T	1	0	1	0	0	1	0	0
14	38872454	.	T	C	1	2	3	0	0	3	0	0
14	38872541	.	A	G	4	1	5	0	2	7	0	0
14	38872552	.	A	G	4	1	5	0	1	6	0	0
14	38872579	.	T	C	2	2	4	0	0	4	0	0
14	38875488	.	T	C	1	2	3	0	0	3	0	0
14	38875512	.	A	G	1	3	4	0	0	4	0	0
14	38875532	.	A	T	1	3	4	0	0	4	0	0
14	38878552	.	T	C	6	8	14	0	1	15	0	0
14	38881363	.	G	A	0	6	6	0	5	11	0	0
14	38881711	.	G	A	2	1	3	0	1	4	0	0
14	38881729	.	T	C	1	1	2	0	0	2	0	0
14	38937085	.	T	C	5	0	5	0	4	9	0	0
14	38937099	.	T	C	4	2	6	0	0	6	0	0
14	38937305	.	C	T	3	4	7	0	0	7	0	0
14	38941498	.	A	G	2	2	4	0	0	4	0	0
14	38946708	.	A	G	4	2	6	0	1	7	0	0
14	38946732	.	G	A	3	2	5	0	0	5	0	0
14	39002205	.	A	T	3	2	5	0	0	5	0	0
14	39002433	.	G	C	7	10	17	0	1	18	0	0
14	39002555	.	C	T	6	5	11	0	0	11	0	0
14	39002562	.	C	T	4	4	8	0	3	11	0	0
14	39002698	.	C	A	7	8	15	0	0	15	0	0
14	39002739	.	G	C	13	0	13	0	7	20	0	0
14	39002752	.	A	G	12	4	16	0	0	16	0	0
14	39002820	.	A	T	13	6	19	0	1	20	0	0
14	39002883	.	A	G	6	12	18	0	1	19	0	0
14	39003039	.	T	G	0	4	4	0	1	5	0	0
14	39458519	.	C	T	1	1	2	0	1	3	0	0
14	39608615	.	A	G	0	0	0	0	1	1	0	0
14	40746451	.	A	T	2	2	4	0	0	4	0	0
14	40746452	.	A	G	2	2	4	0	0	4	0	0
14	40852670	.	A	T	4	4	8	0	0	8	0	0
14	40852732	.	T	C	6	7	13	0	1	14	0	0
14	40853268	.	C	G	1	2	3	0	0	3	0	0
14	40857654	.	T	G	2	1	3	0	0	3	0	0
14	40857711	.	G	A	4	0	4	0	0	4	0	0
14	40857881	.	T	C	3	6	9	0	0	9	0	0
14	40857977	.	C	T	2	2	4	0	0	4	0	0
14	40859179	.	A	G	12	0	12	0	7	19	0	0
14	40860291	.	T	A	4	5	9	0	1	10	0	0
14	40860354	.	C	T	10	13	23	0	1	24	0	0
14	40863062	.	A	G	19	13	32	0	1	33	0	0
14	40863161	.	T	C	5	13	18	0	1	19	0	0
14	40863176	.	A	G	3	10	13	0	0	13	0	0
14	40869331	.	C	A	10	12	22	0	2	24	0	0
14	40874026	.	G	T	7	5	12	0	0	12	0	0
14	41276516	.	T	A	6	11	17	0	2	19	0	0
14	41276608	.	G	A	6	11	17	0	0	17	0	0
14	41277391	.	A	T	8	16	24	0	0	24	0	0
14	41277556	.	A	G	28	30	58	0	1	59	0	0
14	41277624	.	A	T	21	30	51	0	1	52	0	0
14	41278238	.	T	A	25	13	38	0	0	38	0	0
14	41278255	.	A	G	13	21	34	0	0	34	0	0
14	41278386	.	C	T	25	16	41	0	1	42	0	0
14	41278658	.	T	G	13	12	25	0	0	25	0	0
14	41278754	.	C	G	8	5	13	0	0	13	0	0
14	41279133	.	C	T	10	13	23	0	1	24	0	0
14	41279214	.	C	T	18	17	35	1	2	38	0	0
14	41279277	.	G	C	26	13	39	0	3	42	0	0
14	41279479	.	T	A	6	8	14	0	1	15	0	0
14	41279527	.	C	T	0	13	13	0	7	20	0	0
14	41279542	.	C	A	1	8	9	0	15	24	0	0
14	41279974	.	T	G	18	13	31	0	1	32	0	0
14	41279977	.	G	T	18	13	31	0	0	31	0	0
14	41280013	.	G	A	14	16	30	0	2	32	0	0
14	41280149	.	G	A	24	20	44	0	2	46	0	0
14	41280228	.	A	G	24	26	50	0	1	51	0	0
14	41280517	.	G	C	4	0	4	0	0	4	0	0
14	41318507	.	C	T	2	2	4	0	0	4	0	0
14	41318672	.	G	C	1	4	5	0	3	8	0	0
14	41333519	.	A	G	2	0	2	0	0	2	0	0
14	41339309	.	T	C	4	2	6	0	0	6	0	0
14	41340042	.	A	C	6	2	8	0	0	8	0	0
14	41340054	.	T	A	5	2	7	0	0	7	0	0
14	41340081	.	A	T	4	6	10	0	0	10	0	0
14	41340172	.	A	C	5	6	11	0	1	12	0	0
14	41340231	.	G	A	4	5	9	0	0	9	0	0
14	41340284	.	C	T	0	3	3	0	0	3	0	0
14	41340570	.	G	A	2	2	4	0	0	4	0	0
14	41362007	.	G	A	11	6	17	0	0	17	0	0
14	41362060	.	C	T	12	3	15	0	0	15	0	0
14	41366823	.	G	A	18	16	34	0	1	35	0	0
14	41366889	.	C	A	2	2	4	0	0	4	0	0
14	41385823	.	G	A	6	3	9	0	0	9	0	0
14	41385895	.	C	T	0	9	9	0	7	16	0	0
14	41388120	.	G	A	7	7	14	0	1	15	0	0
14	41414192	.	C	T	0	1	1	0	1	2	0	0
14	41414194	.	T	C	0	2	2	0	0	2	0	0
14	41414756	.	C	G	2	0	2	0	3	5	0	0
14	41414857	.	C	T	1	3	4	0	0	4	0	0
14	41428500	.	C	T	5	5	10	0	0	10	0	0
14	41435662	.	C	T	6	6	12	0	0	12	0	0
14	41436773	.	T	A	6	3	9	0	1	10	0	0
14	41436943	.	C	T	6	8	14	0	2	16	0	0
14	41438005	.	G	A	6	8	14	0	0	14	0	0
14	41466483	.	T	A	3	3	6	0	1	7	0	0
14	41466522	.	G	A	9	6	15	0	0	15	0	0
14	41466922	.	T	A	16	14	30	0	0	30	0	0
14	41467152	.	T	C	17	16	33	0	0	33	0	0
14	41467155	.	C	T	16	16	32	0	3	35	0	0
14	41467356	.	C	G	16	12	28	0	0	28	0	0
14	41469662	.	C	A	6	5	11	0	0	11	0	0
14	41469761	.	G	T	3	7	10	0	0	10	0	0
14	41469827	.	T	C	7	5	12	0	0	12	0	0
14	41469829	.	T	C	7	5	12	0	0	12	0	0
14	41469925	.	T	A	3	5	8	0	0	8	0	0
14	41469935	.	C	T	2	5	7	0	0	7	0	0
14	41470032	.	C	T	0	5	5	0	5	10	0	0
14	41470037	.	A	T	5	6	11	0	0	11	0	0
14	41514767	.	C	T	3	4	7	0	0	7	0	0
14	41514842	.	C	T	3	5	8	0	0	8	0	0
14	41514923	.	C	T	1	3	4	0	0	4	0	0
14	41529931	.	C	T	2	2	4	0	0	4	0	0
14	41601375	.	A	G	3	2	5	0	0	5	0	0
14	41601423	.	G	C	4	2	6	0	0	6	0	0
14	42172389	.	A	C	1	3	4	0	0	4	0	0
14	42172457	.	T	A	3	3	6	0	3	9	0	0
14	42172459	.	G	C	0	6	6	0	3	9	0	0
14	42172527	.	G	A	0	3	3	0	7	10	0	0
14	42172732	.	G	A	0	2	2	0	1	3	0	0
14	42172745	.	C	T	3	2	5	0	0	5	0	0
14	42172951	.	G	A	0	2	2	0	4	6	0	0
14	42173803	.	C	T	5	4	9	0	0	9	0	0
14	42174247	.	G	A	0	7	7	0	10	17	0	0
14	42174401	.	C	T	6	8	14	0	0	14	0	0
14	42174645	.	A	T	8	11	19	0	2	21	0	0
14	42178503	.	C	T	11	14	25	0	0	25	0	0
14	42178728	.	G	A	11	13	24	0	0	24	0	0
14	42178974	.	G	A	16	16	32	0	1	33	0	0
14	42179697	.	G	A	1	3	4	0	0	4	0	0
14	42978975	.	A	G	10	16	26	0	3	29	0	0
14	42978980	.	A	C	10	19	29	0	0	29	0	0
14	42979030	.	T	C	11	1	12	0	12	24	0	0
14	42979087	.	A	T	8	13	21	0	3	24	0	0
14	42979090	.	T	A	7	15	22	0	2	24	0	0
14	42979655	.	A	G	12	24	36	0	5	41	0	0
14	42997943	.	G	A	13	10	23	0	0	23	0	0
14	42998353	.	G	A	11	9	20	0	0	20	0	0
14	42998879	.	G	A	5	8	13	0	1	14	0	0
14	42999314	.	C	T	7	7	14	0	0	14	0	0
14	42999524	.	C	T	5	8	13	0	0	13	0	0
14	43000785	.	A	T	3	8	11	0	0	11	0	0
14	43577346	.	C	T	1	11	12	0	9	21	0	0
14	43577704	.	G	A	7	8	15	0	0	15	0	0
14	43580985	.	G	T	4	4	8	0	0	8	0	0
14	43582551	.	C	G	2	2	4	0	0	4	0	0
14	43582567	.	G	A	2	2	4	0	0	4	0	0
14	43582602	.	C	T	0	1	1	0	0	1	0	0
14	43591152	.	G	T	4	6	10	0	0	10	0	0
14	43591188	.	G	A	11	10	21	0	2	23	0	0
14	43605214	.	T	C	2	2	4	0	1	5	0	0
14	43605462	.	C	T	8	5	13	0	0	13	0	0
14	43605498	.	T	C	9	0	9	0	8	17	0	0
14	43605510	.	G	A	6	9	15	0	0	15	0	0
14	44013794	.	C	A	2	4	6	0	0	6	0	0
14	44589624	.	C	T	7	12	19	0	1	21	1	0
14	44589834	.	A	G	14	5	19	0	1	20	0	0
14	44589972	.	T	A	10	7	17	0	0	17	0	0
14	44589978	.	G	A	9	6	15	0	0	15	0	0
14	44590297	.	G	C	7	12	19	0	1	20	0	0
14	44590301	.	A	G	7	0	7	0	14	21	0	0
14	44590644	.	C	T	16	17	33	0	1	34	0	0
14	44590838	.	T	A	7	13	20	0	0	20	0	0
14	44590935	.	G	A	0	15	15	0	8	23	0	0
14	44590992	.	A	G	7	12	19	0	1	20	0	0
14	45071319	.	G	T	0	2	2	0	0	2	0	0
14	45294104	.	A	G	8	0	8	0	6	14	0	0
14	45294109	.	A	G	10	0	10	0	3	13	0	0
14	45294148	.	A	G	4	2	6	0	0	6	0	0
14	45435592	.	T	C	1	3	4	0	0	4	0	0
14	45925917	.	G	C	0	3	3	0	1	4	0	0
14	45927130	.	T	G	1	0	1	0	3	4	0	0
14	45927849	.	C	T	3	4	7	0	0	7	0	0
14	45927861	.	T	C	3	3	6	0	0	6	0	0
14	45928383	.	A	G	3	0	3	0	2	5	0	0
14	45928398	.	T	C	2	3	5	0	0	5	0	0
14	45928432	.	T	C	1	3	4	0	0	4	0	0
14	45928603	.	T	A	3	4	7	0	0	7	0	0
14	45928853	.	T	G	1	5	6	0	0	6	0	0
14	45929024	.	G	T	1	3	4	0	0	4	0	0
14	45929137	.	T	G	3	2	5	0	0	5	0	0
14	45929140	.	T	A	3	2	5	0	0	5	0	0
14	45929242	.	A	G	3	0	3	0	2	5	0	0
14	45929280	.	C	T	5	5	10	0	0	10	0	0
14	45929591	.	T	A	2	1	3	0	0	3	0	0
14	45929748	.	A	G	5	3	8	0	1	9	0	0
14	45929837	.	T	A	6	4	10	0	0	10	0	0
14	45929974	.	T	C	5	5	10	0	1	11	0	0
14	45930135	.	T	C	5	2	7	0	1	8	0	0
14	45930196	.	A	C	6	3	9	0	0	9	0	0
14	45930399	.	C	T	4	8	12	1	0	13	0	0
14	45930515	.	G	A	9	3	12	0	0	12	0	0
14	45930572	.	A	G	6	3	9	0	0	9	0	0
14	45930573	.	T	G	6	3	9	0	0	9	0	0
14	45930735	.	T	A	4	3	7	0	1	9	1	0
14	45930794	.	G	A	4	5	9	0	1	10	0	0
14	45931079	.	C	G	6	7	13	0	0	13	0	0
14	45931194	.	G	T	6	5	11	0	1	13	1	0
14	45931504	.	C	G	6	13	19	0	1	20	0	0
14	45931637	.	C	T	12	7	19	0	3	22	0	0
14	45931899	.	C	T	7	11	18	0	0	18	0	0
14	45932128	.	T	G	10	4	14	0	0	14	0	0
14	45994354	.	T	C	1	3	4	0	0	4	0	0
14	46007306	.	A	G	5	4	9	0	0	9	0	0
14	46007321	.	G	A	4	4	8	0	0	8	0	0
14	46009611	.	G	A	3	5	8	0	1	9	0	0
14	46009683	.	A	T	0	1	1	0	1	2	0	0
14	46010711	.	C	T	2	0	2	0	1	3	0	0
14	46010909	.	T	C	2	4	6	0	0	6	0	0
14	46013121	.	A	T	4	6	10	0	0	10	0	0
14	46013402	.	C	T	15	14	29	0	1	30	0	0
14	46015888	.	C	A	0	1	1	0	0	1	0	0
14	46016107	.	A	G	3	6	9	0	1	10	0	0
14	46017969	.	G	A	14	18	32	0	0	32	0	0
14	46018029	.	C	T	14	20	34	0	2	36	0	0
14	46018548	.	A	G	6	21	27	0	0	27	0	0
14	46018560	.	A	G	14	7	21	0	0	21	0	0
14	46028329	.	G	T	4	7	11	0	0	11	0	0
14	46028330	.	T	A	4	7	11	0	0	11	0	0
14	46028376	.	G	A	3	3	6	0	0	6	0	0
14	46028548	.	G	C	1	1	2	0	0	2	0	0
14	46037489	.	T	C	6	4	10	0	0	10	0	0
14	46039751	.	T	C	5	6	11	0	1	12	0	0
14	46039904	.	C	G	6	0	6	0	3	9	0	0
14	46040318	.	T	C	9	8	17	0	0	17	0	0
14	46041763	.	T	G	2	2	4	0	0	4	0	0
14	46041800	.	C	T	5	3	8	0	0	8	0	0
14	46041861	.	A	T	11	7	18	0	0	18	0	0
14	46048396	.	A	G	6	8	14	0	0	14	0	0
14	46048644	.	C	T	2	7	9	0	11	20	0	0
14	46048704	.	C	G	1	11	12	0	11	23	0	0
14	46048875	.	T	C	19	14	33	0	1	34	0	0
14	46052172	.	T	A	6	4	10	0	0	10	0	0
14	46052244	.	G	T	7	11	18	0	0	18	0	0
14	46067317	.	A	T	2	2	4	0	0	4	0	0
14	46074473	.	T	A	8	4	12	0	1	13	0	0
14	46074489	.	A	G	5	4	9	0	0	9	0	0
14	46075027	.	T	C	2	3	5	0	0	5	0	0
14	46075640	.	A	C	1	3	4	0	0	4	0	0
14	46075749	.	A	G	2	4	6	0	1	7	0	0
14	46076407	.	T	C	2	2	4	0	0	4	0	0
14	46076846	.	C	A	4	2	6	0	0	6	0	0
14	46076858	.	T	C	4	2	6	0	0	6	0	0
14	46088665	.	T	C	4	2	6	0	0	6	0	0
14	46088921	.	A	G	6	6	12	0	1	13	0	0
14	46089176	.	C	T	6	5	11	0	0	11	0	0
14	46089433	.	T	G	4	5	9	0	0	9	0	0
14	46089515	.	T	C	3	8	11	0	0	11	0	0
14	46089667	.	T	C	1	0	1	0	4	5	0	0
14	46090027	.	T	C	3	1	4	0	5	9	0	0
14	46090508	.	T	A	1	2	3	0	1	4	0	0
14	46091627	.	T	C	1	3	4	0	0	4	0	0
14	46094922	.	C	T	4	12	16	0	3	19	0	0
14	46095043	.	A	G	21	12	33	0	1	34	0	0
14	46095058	.	A	G	18	8	26	0	0	26	0	0
14	46095108	.	A	G	19	21	40	0	2	42	0	0
14	46104150	.	C	T	7	7	14	0	3	17	0	0
14	46104222	.	C	T	0	5	5	0	3	8	0	0
14	46104935	.	G	A	4	3	7	0	0	7	0	0
14	46113296	.	T	G	24	19	43	0	0	43	0	0
14	46113309	.	C	G	0	14	14	0	20	34	0	0
14	46113359	.	T	G	2	2	4	0	0	4	0	0
14	46114929	.	G	A	2	1	3	0	0	3	0	0
14	46116576	.	A	G	3	7	10	0	0	10	0	0
14	46117279	.	G	T	7	6	13	0	1	15	1	0
14	46117300	.	C	T	2	2	4	0	0	4	0	0
14	46128948	.	A	C	0	2	2	0	1	3	0	0
14	46129955	.	C	A	4	2	6	0	0	6	0	0
14	46140812	.	C	A	5	3	8	0	0	8	0	0
14	46146715	.	G	A	2	9	11	0	1	12	0	0
14	46146730	.	G	A	1	9	10	0	1	11	0	0
14	46154358	.	C	A	11	8	19	0	0	19	0	0
14	46154713	.	A	G	6	8	14	0	1	15	0	0
14	46154899	.	A	C	5	7	12	0	0	12	0	0
14	46154966	.	T	A	6	3	9	0	1	10	0	0
14	46154969	.	T	A	6	4	10	0	0	10	0	0
14	46184738	.	A	G	2	3	5	0	0	5	0	0
14	46187317	.	A	G	2	4	6	0	0	6	0	0
14	46188063	.	A	G	9	4	13	0	0	13	0	0
14	46679356	.	T	C	11	5	16	0	0	16	0	0
14	46680689	.	T	C	7	4	11	0	0	11	0	0
14	46681867	.	T	C	0	3	3	0	0	3	0	0
14	46684372	.	T	C	3	2	5	0	0	5	0	0
14	47003023	.	T	G	11	11	22	0	0	22	0	0
14	47003330	.	A	C	26	16	42	0	1	43	0	0
14	47003696	.	G	T	14	20	34	1	0	35	0	0
14	47003908	.	C	T	2	19	21	0	24	45	0	0
14	47003958	.	T	A	23	18	41	0	2	43	0	0
14	47004090	.	T	G	16	19	35	0	0	35	0	0
14	47004187	.	C	A	15	13	28	0	0	28	0	0
14	47004365	.	G	A	15	8	23	0	4	27	0	0
14	47004734	.	G	A	20	14	34	0	0	34	0	0
14	47004959	.	T	G	9	12	21	0	2	23	0	0
14	47027767	.	G	A	10	4	14	0	0	14	0	0
14	47066764	.	G	A	5	4	9	0	0	9	0	0
14	47074234	.	A	G	8	5	13	0	0	13	0	0
14	47085624	.	A	G	7	7	14	0	1	15	0	0
14	47096209	.	T	C	7	0	7	1	3	11	0	0
14	47131242	.	T	G	2	2	4	0	0	4	0	0
14	47131260	.	G	A	3	3	6	0	0	6	0	0
14	47142032	.	C	T	2	1	3	0	0	3	0	0
14	47264962	.	T	C	0	0	0	0	1	1	0	0
14	47265031	.	A	G	0	2	2	0	0	2	0	0
14	47882878	.	T	A	2	2	4	0	0	4	0	0
14	48737799	.	G	A	1	2	3	0	0	3	0	0
14	48738994	.	C	T	1	2	3	0	0	3	0	0
14	48739018	.	A	T	1	2	3	0	0	3	0	0
14	48767585	.	G	C	3	3	6	0	1	7	0	0
14	48767628	.	G	A	2	3	5	0	0	5	0	0
14	48773479	.	A	G	3	7	10	0	0	10	0	0
14	48779657	.	A	G	2	3	5	0	0	5	0	0
14	48781534	.	A	G	2	3	5	0	0	5	0	0
14	48781694	.	C	G	1	3	4	0	0	4	0	0
14	48932470	.	T	A	22	22	44	0	0	44	0	0
14	48932712	.	G	A	7	17	24	0	2	26	0	0
14	48932880	.	A	T	30	13	43	0	0	43	0	0
14	48932970	.	T	A	15	26	41	0	1	42	0	0
14	48933224	.	A	G	24	22	46	0	0	46	0	0
14	48933273	.	C	A	21	22	43	1	0	44	0	0
14	48933361	.	T	A	26	9	35	0	0	35	0	0
14	48933513	.	T	C	17	6	23	0	4	27	0	0
14	48933575	.	A	G	23	6	29	0	1	30	0	0
14	48934025	.	G	A	21	23	44	0	1	45	0	0
14	48934052	.	G	A	19	20	39	0	2	41	0	0
14	48934253	.	G	A	18	8	26	0	3	29	0	0
14	48934276	.	G	A	17	4	21	0	0	21	0	0
14	48934299	.	C	A	17	1	18	0	0	18	0	0
14	48934577	.	G	T	20	23	43	0	3	46	0	0
14	48934630	.	C	G	27	14	41	0	0	41	0	0
14	48934639	.	T	C	31	0	31	0	8	39	0	0
14	48934701	.	T	C	16	24	40	0	3	43	0	0
14	48934719	.	T	G	20	25	45	0	0	45	0	0
14	48934829	.	T	A	19	24	43	0	1	44	0	0
14	48944594	.	C	T	1	3	4	0	0	4	0	0
14	48944595	.	T	C	1	0	1	0	3	4	0	0
14	48945321	.	G	C	0	0	0	0	2	2	0	0
14	48960979	.	T	G	1	2	3	0	0	3	0	0
14	48964697	.	T	C	8	8	16	0	2	18	0	0
14	48995473	.	C	T	1	2	3	0	0	3	0	0
14	48995551	.	C	G	1	3	4	0	0	4	0	0
14	48995894	.	C	A	3	3	6	0	0	6	0	0
14	48997620	.	G	C	2	4	6	0	0	6	0	0
14	48997773	.	A	G	1	5	6	0	0	6	0	0
14	48997811	.	A	G	4	5	9	0	0	9	0	0
14	48998026	.	A	C	4	7	11	0	1	12	0	0
14	49007729	.	G	A	0	1	1	0	0	1	0	0
14	49007756	.	G	A	0	2	2	0	0	2	0	0
14	49015393	.	C	T	2	1	3	0	0	3	0	0
14	49022002	.	C	T	5	2	7	0	0	7	0	0
14	49022071	.	A	G	5	0	5	0	5	10	0	0
14	49022145	.	A	G	2	0	2	0	5	7	0	0
14	49022191	.	G	T	4	3	7	0	1	8	0	0
14	49022238	.	G	A	0	7	7	0	5	12	0	0
14	49022290	.	G	T	0	8	8	0	4	12	0	0
14	49029025	.	C	T	4	5	9	0	1	10	0	0
14	49029026	.	A	G	5	5	10	0	0	10	0	0
14	49029159	.	C	A	2	6	8	0	0	8	0	0
14	49029169	.	A	G	3	5	8	0	1	9	0	0
14	49030476	.	C	A	1	3	4	0	0	4	0	0
14	49030480	.	A	T	1	3	4	0	0	4	0	0
14	49031569	.	A	G	5	13	18	0	2	20	0	0
14	49031848	.	A	G	5	4	9	0	1	10	0	0
14	49040574	.	G	A	8	10	18	0	0	18	0	0
14	49040673	.	C	A	1	3	4	0	0	6	2	0
14	49040773	.	G	A	8	3	11	0	0	11	0	0
14	49047525	.	T	G	14	21	35	0	1	36	0	0
14	49050397	.	T	G	8	1	9	0	0	9	0	0
14	49053391	.	G	A	3	6	9	0	0	9	0	0
14	49053402	.	C	G	4	6	10	0	0	10	0	0
14	49054446	.	T	C	5	0	5	0	5	10	0	0
14	49054449	.	G	A	5	4	9	0	1	10	0	0
14	49057246	.	G	A	1	3	4	0	1	5	0	0
14	49057273	.	C	G	0	4	4	0	0	4	0	0
14	49078766	.	A	C	3	3	6	0	0	6	0	0
14	49119017	.	G	A	2	3	5	0	1	6	0	0
14	49119048	.	G	T	12	16	28	0	0	28	0	0
14	49119062	.	G	A	18	17	35	0	4	39	0	0
14	49119192	.	T	A	26	11	37	0	2	39	0	0
14	49119218	.	C	A	6	16	22	0	0	22	0	0
14	49119321	.	A	C	26	20	46	0	1	47	0	0
14	49119484	.	T	A	24	18	42	0	2	44	0	0
14	49126924	.	G	A	9	7	16	0	0	16	0	0
14	49133139	.	A	G	6	7	13	0	1	14	0	0
14	49136065	.	G	A	2	12	14	0	15	29	0	0
14	49136245	.	G	A	1	12	13	0	11	24	0	0
14	49136483	.	C	T	18	15	33	0	1	34	0	0
14	49136551	.	T	G	9	1	10	0	11	21	0	0
14	49136838	.	A	T	6	13	19	0	1	20	0	0
14	49136909	.	C	T	10	8	18	0	0	18	0	0
14	49161148	.	T	C	0	1	1	0	0	1	0	0
14	49172331	.	C	T	1	2	3	0	0	3	0	0
14	49172886	.	G	C	1	3	4	0	1	5	0	0
14	49172961	.	G	A	0	3	3	0	3	6	0	0
14	49174995	.	G	T	2	0	2	0	0	2	0	0
14	49175303	.	T	C	1	3	4	0	0	4	0	0
14	49175579	.	T	C	0	1	1	0	0	1	0	0
14	49175591	.	C	T	1	0	1	0	0	1	0	0
14	49196784	.	C	T	3	3	6	0	0	6	0	0
14	49199004	.	A	T	2	2	4	0	0	4	0	0
14	49204136	.	G	A	1	1	2	0	4	6	0	0
14	49206876	.	G	C	3	2	5	0	1	6	0	0
14	49206879	.	C	T	3	2	5	0	0	5	0	0
14	49206948	.	G	A	2	2	4	0	0	4	0	0
14	49209983	.	C	T	4	8	12	0	0	12	0	0
14	49210055	.	T	C	3	5	8	0	0	8	0	0
14	49210075	.	C	A	4	4	8	0	0	8	0	0
14	49210231	.	A	G	3	6	9	0	0	9	0	0
14	49210349	.	G	A	1	6	7	0	0	7	0	0
14	49210391	.	C	A	4	3	7	0	0	7	0	0
14	49210569	.	G	C	1	2	3	0	0	3	0	0
14	49210779	.	C	T	3	2	5	0	0	5	0	0
14	49210867	.	G	T	4	5	9	0	1	10	0	0
14	49210955	.	A	G	8	4	12	0	0	12	0	0
14	49211001	.	A	G	2	11	13	0	0	13	0	0
14	49211045	.	T	C	5	5	10	0	0	10	0	0
14	49211172	.	A	G	2	8	10	0	0	10	0	0
14	49211269	.	A	G	6	3	9	0	0	9	0	0
14	49211285	.	G	T	3	6	9	0	0	9	0	0
14	49211501	.	A	G	3	2	5	0	0	5	0	0
14	49211539	.	A	G	4	0	4	0	10	14	0	0
14	49211975	.	A	G	1	2	3	0	0	3	0	0
14	49212314	.	G	A	4	0	4	0	1	5	0	0
14	49212350	.	C	T	5	5	10	0	0	10	0	0
14	49212395	.	T	C	4	5	9	0	1	10	0	0
14	49212537	.	A	G	4	0	4	0	3	7	0	0
14	49212547	.	A	G	2	0	2	0	4	6	0	0
14	49212612	.	T	C	4	7	11	0	1	12	0	0
14	49212716	.	A	G	5	5	10	0	0	10	0	0
14	49212838	.	C	T	4	3	7	0	0	7	0	0
14	49212867	.	A	C	3	8	11	0	0	11	0	0
14	49213140	.	T	G	8	9	17	0	0	18	1	0
14	49213178	.	C	T	7	3	10	0	0	10	0	0
14	49213250	.	C	T	2	7	9	0	1	10	0	0
14	49213711	.	A	G	2	2	4	0	0	4	0	0
14	49213770	.	G	A	3	5	8	0	1	9	0	0
14	49213821	.	C	T	10	0	10	0	0	11	1	0
14	49213836	.	G	A	10	4	14	0	3	17	0	0
14	49214024	.	G	T	5	4	9	0	1	10	0	0
14	49214087	.	G	A	2	2	4	0	1	5	0	0
14	49214158	.	G	A	9	4	13	0	1	14	0	0
14	49214168	.	T	C	9	2	11	0	1	12	0	0
14	49214347	.	T	G	6	0	6	0	3	9	0	0
14	49214392	.	G	A	8	4	12	0	0	12	0	0
14	49214494	.	T	C	2	7	9	0	2	11	0	0
14	49224844	.	G	A	0	4	4	0	6	10	0	0
14	49224886	.	C	T	2	5	7	0	2	9	0	0
14	49231804	.	A	G	7	2	9	0	0	9	0	0
14	49231813	.	C	T	7	5	12	0	0	12	0	0
14	49231903	.	C	G	0	2	2	0	0	2	0	0
14	49236476	.	A	G	2	3	5	0	2	7	0	0
14	49237917	.	A	G	4	6	10	0	0	10	0	0
14	49244425	.	A	G	23	1	24	0	10	34	0	0
14	49244728	.	A	G	6	15	21	0	2	23	0	0
14	49244740	.	A	T	20	5	25	0	0	25	0	0
14	49245190	.	C	G	10	12	22	0	1	23	0	0
14	49430817	.	A	G	16	11	27	0	1	28	0	0
14	49430844	.	A	G	27	8	35	0	3	38	0	0
14	49489002	.	A	G	2	20	22	0	8	30	0	0
14	49738310	.	G	A	0	1	1	0	0	1	0	0
14	49750311	.	C	T	0	1	1	0	0	1	0	0
14	49757069	.	G	T	3	3	6	0	0	6	0	0
14	49757320	.	A	G	4	2	6	0	0	6	0	0
14	49757330	.	A	G	1	0	1	0	3	4	0	0
14	49761799	.	G	A	2	6	8	0	0	8	0	0
14	52518002	.	A	G	6	19	25	0	3	28	0	0
14	52525207	.	T	C	7	3	10	0	0	10	0	0
14	52525376	.	T	C	12	6	18	0	2	20	0	0
14	52574497	.	C	A	0	5	5	0	0	5	0	0
15	688269	.	G	C	1	3	4	0	0	4	0	0
15	784368	.	G	C	3	3	6	0	0	6	0	0
15	870085	.	A	G	1	0	1	0	2	3	0	0
15	893426	.	A	G	1	0	1	0	4	5	0	0
15	894804	.	G	A	1	2	3	0	2	5	0	0
15	895560	.	T	A	1	2	3	0	0	3	0	0
15	895601	.	T	A	1	2	3	0	0	3	0	0
15	905167	.	A	T	1	2	3	0	0	3	0	0
15	1029484	.	C	T	0	1	1	0	0	1	0	0
15	1033435	.	A	T	6	4	10	0	0	10	0	0
15	1033479	.	T	G	4	2	6	0	0	6	0	0
15	1033564	.	G	T	2	4	6	0	0	6	0	0
15	1033853	.	A	G	7	3	10	0	0	10	0	0
15	1033955	.	C	T	0	4	4	0	4	8	0	0
15	1036677	.	C	T	0	4	4	0	4	8	0	0
15	1036825	.	T	C	3	5	8	0	0	8	0	0
15	1162040	.	A	G	2	2	4	0	0	4	0	0
15	1162048	.	T	C	2	1	3	0	0	3	0	0
15	1173542	.	C	T	3	3	6	0	0	6	0	0
15	1176447	.	G	A	0	1	1	0	6	7	0	0
15	1178927	.	C	A	8	6	14	0	2	16	0	0
15	1181477	.	G	T	2	3	5	0	0	5	0	0
15	1181480	.	C	T	0	3	3	0	2	5	0	0
15	1183930	.	G	T	3	1	4	0	0	4	0	0
15	1183984	.	C	T	0	11	11	0	9	20	0	0
15	1186181	.	A	G	7	6	13	0	3	16	0	0
15	1186202	.	C	T	1	5	6	0	10	16	0	0
15	1189664	.	C	T	16	4	20	0	2	22	0	0
15	1191750	.	A	G	3	0	3	0	0	3	0	0
15	1191822	.	A	G	7	0	7	0	5	12	0	0
15	1194590	.	A	G	12	7	19	0	1	20	0	0
15	1194619	.	G	A	0	7	7	0	12	19	0	0
15	1194633	.	A	G	10	6	16	0	1	17	0	0
15	1194670	.	G	A	10	6	16	0	0	16	0	0
15	1194739	.	G	T	12	3	15	0	1	16	0	0
15	1194754	.	T	C	11	4	15	0	0	15	0	0
15	1682103	.	T	C	1	2	3	0	0	3	0	0
15	1730619	.	G	A	5	2	7	0	0	7	0	0
15	1730643	.	A	G	5	1	6	0	0	6	0	0
15	1733125	.	G	C	2	2	4	0	0	4	0	0
15	1749973	.	G	C	3	7	10	0	0	10	0	0
15	1749984	.	A	T	5	7	12	0	1	13	0	0
15	1753501	.	A	G	0	1	1	0	0	1	0	0
15	1758675	.	T	C	1	0	1	0	1	2	0	0
15	1766675	.	C	T	5	2	7	0	0	7	0	0
15	1774489	.	G	A	0	3	3	0	3	6	0	0
15	1782156	.	T	C	10	4	14	0	0	14	0	0
15	1828401	.	C	T	5	5	10	0	0	10	0	0
15	1830323	.	A	G	2	0	2	0	0	2	0	0
15	1847246	.	C	G	6	9	15	0	0	15	0	0
15	1847358	.	A	G	6	8	14	0	1	15	0	0
15	1847432	.	A	C	9	5	14	0	1	15	0	0
15	1847588	.	A	T	11	5	16	0	2	18	0	0
15	1847693	.	A	G	9	10	19	0	1	20	0	0
15	1847908	.	A	C	6	10	16	0	0	16	0	0
15	1848188	.	T	C	5	0	5	0	8	13	0	0
15	1848202	.	G	T	4	5	9	0	0	9	0	0
15	1848265	.	T	A	2	5	7	0	0	7	0	0
15	1848308	.	G	A	3	4	7	0	0	7	0	0
15	1853010	.	A	C	3	3	6	0	2	8	0	0
15	1869712	.	C	T	4	2	6	0	0	6	0	0
15	1893276	.	C	T	2	3	5	0	0	5	0	0
15	1893293	.	C	G	4	3	7	0	0	7	0	0
15	1893323	.	G	A	0	4	4	0	5	9	0	0
15	1893356	.	A	G	3	0	3	0	1	4	0	0
15	1894694	.	A	G	9	4	13	0	1	14	0	0
15	1895469	.	G	A	5	3	8	0	1	9	0	0
15	1895505	.	G	C	12	8	20	0	0	21	1	0
15	1897576	.	T	C	4	4	8	0	0	8	0	0
15	1897928	.	T	A	3	2	5	0	1	6	0	0
15	1898384	.	T	C	3	2	5	0	0	5	0	0
15	1899304	.	A	C	7	5	12	0	0	12	0	0
15	1899331	.	T	G	1	3	4	0	1	5	0	0
15	1899395	.	G	A	0	3	3	0	4	7	0	0
15	1899878	.	T	C	9	14	23	0	0	23	0	0
15	1902259	.	A	G	4	3	7	0	0	7	0	0
15	1905364	.	T	G	4	5	9	0	1	10	0	0
15	2182569	.	G	A	16	6	22	0	0	22	0	0
15	2182752	.	G	C	14	11	25	0	1	26	0	0
15	2182848	.	C	T	5	2	7	0	0	7	0	0
15	2413923	.	T	G	2	2	4	0	0	4	0	0
15	2413970	.	T	G	1	0	1	0	5	6	0	0
15	2414140	.	T	A	3	3	6	0	0	6	0	0
15	2414160	.	C	T	2	3	5	0	0	5	0	0
15	2414177	.	G	A	4	5	9	0	0	9	0	0
15	2414276	.	A	G	5	4	9	0	0	9	0	0
15	2415279	.	A	G	1	5	6	0	0	6	0	0
15	2444539	.	C	G	0	0	0	0	1	1	0	0
15	2451348	.	G	A	1	2	3	0	0	3	0	0
15	2451358	.	C	G	1	0	1	0	2	3	0	0
15	2458640	.	A	G	2	0	2	0	1	3	0	0
15	2458641	.	G	T	1	1	2	0	1	3	0	0
15	2459656	.	A	G	1	0	1	0	0	1	0	0
15	2459903	.	A	G	2	1	3	0	0	3	0	0
15	2459963	.	C	T	2	2	4	0	2	6	0	0
15	2463308	.	T	C	6	3	9	0	0	9	0	0
15	2463309	.	G	C	6	3	9	0	0	9	0	0
15	2485111	.	T	C	4	3	7	0	0	7	0	0
15	2515421	.	C	T	2	1	3	0	0	3	0	0
15	2524684	.	T	C	3	7	10	0	0	10	0	0
15	2527072	.	T	C	3	3	6	0	0	6	0	0
15	2527105	.	G	A	2	2	4	0	1	5	0	0
15	2530457	.	A	G	0	0	0	0	1	1	0	0
15	2533340	.	A	G	5	1	6	0	0	6	0	0
15	2537852	.	G	A	0	3	3	0	0	3	0	0
15	2538060	.	A	G	2	2	4	0	0	4	0	0
15	2539821	.	G	A	1	2	3	0	0	3	0	0
15	2543388	.	G	T	6	6	12	0	0	12	0	0
15	2543418	.	G	C	1	10	11	0	7	18	0	0
15	2543548	.	T	G	2	2	4	0	0	4	0	0
15	2543675	.	A	G	3	3	6	0	0	6	0	0
15	2560484	.	C	T	2	3	5	0	0	5	0	0
15	2560694	.	G	A	2	5	7	0	0	7	0	0
15	2572910	.	G	A	0	3	3	0	3	6	0	0
15	2578043	.	C	A	5	10	15	0	2	17	0	0
15	2590559	.	A	T	2	5	7	0	0	7	0	0
15	2590856	.	C	T	0	7	7	0	6	13	0	0
15	2593089	.	C	T	5	2	7	0	0	7	0	0
15	2593092	.	T	C	5	2	7	0	0	7	0	0
15	2593187	.	T	C	1	2	3	0	0	3	0	0
15	2655968	.	C	G	1	2	3	0	0	3	0	0
15	2656475	.	T	G	4	2	6	0	0	6	0	0
15	2656891	.	T	C	2	3	5	0	0	5	0	0
15	2656894	.	T	C	2	0	2	0	3	5	0	0
15	2674589	.	G	T	0	3	3	0	0	3	0	0
15	2727972	.	T	C	1	1	2	0	1	3	0	0
15	2727995	.	A	G	1	3	4	0	0	4	0	0
15	2728221	.	C	T	1	10	11	0	18	29	0	0
15	2728330	.	A	G	16	20	36	0	1	37	0	0
15	2728573	.	C	T	16	14	30	0	5	35	0	0
15	2728641	.	A	C	12	4	16	0	2	18	0	0
15	2728652	.	C	T	12	6	18	0	0	18	0	0
15	2728678	.	G	A	11	6	17	0	0	17	0	0
15	2728806	.	T	G	12	18	30	0	0	30	0	0
15	2728880	.	C	T	0	17	17	0	15	32	0	0
15	2730358	.	T	C	9	7	16	0	0	16	0	0
15	2730364	.	G	C	6	11	17	0	0	17	0	0
15	2730533	.	T	C	7	6	13	0	0	13	0	0
15	2730536	.	G	C	7	0	7	0	5	12	0	0
15	2730678	.	T	A	2	3	5	0	0	5	0	0
15	2730705	.	G	A	4	2	6	0	0	6	0	0
15	2730744	.	T	C	4	2	6	0	0	6	0	0
15	2730749	.	T	C	4	2	6	0	0	6	0	0
15	2730927	.	C	T	0	15	15	0	10	25	0	0
15	2739915	.	G	C	2	0	2	0	0	2	0	0
15	2742070	.	A	T	0	2	2	0	0	2	0	0
15	2744699	.	G	A	4	5	9	0	0	9	0	0
15	2746309	.	A	G	2	4	6	0	0	6	0	0
15	2746467	.	A	G	0	1	1	0	0	1	0	0
15	2747650	.	C	T	0	3	3	0	0	3	0	0
15	2750638	.	G	T	2	10	12	0	0	12	0	0
15	2750671	.	A	G	6	10	16	0	0	16	0	0
15	2750716	.	G	T	7	6	13	0	0	13	0	0
15	2779464	.	A	T	2	2	4	0	0	4	0	0
15	2851218	.	A	G	1	3	4	0	0	4	0	0
15	2851241	.	A	G	1	4	5	0	0	5	0	0
15	2851448	.	T	A	3	3	6	0	0	6	0	0
15	2851455	.	C	T	0	3	3	0	3	6	0	0
15	2851569	.	A	C	8	3	11	0	1	12	0	0
15	2852074	.	A	G	2	2	4	0	0	4	0	0
15	2852436	.	T	C	4	5	9	0	1	10	0	0
15	2855289	.	T	C	5	2	7	0	0	7	0	0
15	2855303	.	G	A	6	3	9	0	0	9	0	0
15	2855334	.	T	A	5	2	7	0	0	7	0	0
15	2865329	.	G	A	3	2	5	0	0	5	0	0
15	2869241	.	T	C	2	3	5	0	0	5	0	0
15	2876938	.	A	G	5	2	7	0	2	9	0	0
15	2876956	.	G	T	0	4	4	0	3	7	0	0
15	2988126	.	T	A	11	6	17	0	0	17	0	0
15	2988136	.	T	G	12	9	21	0	1	22	0	0
15	2988414	.	C	A	13	8	21	0	0	21	0	0
15	2988420	.	C	T	0	9	9	0	15	24	0	0
15	2989361	.	T	G	8	9	17	0	0	17	0	0
15	2994265	.	C	T	0	4	4	0	10	14	0	0
15	2994309	.	T	G	0	2	2	0	0	2	0	0
15	2995080	.	T	C	14	11	25	0	2	27	0	0
15	2999113	.	C	A	0	8	8	0	9	17	0	0
15	2999209	.	G	A	0	3	3	0	0	3	0	0
15	3000194	.	T	C	9	9	18	0	0	18	0	0
15	3000311	.	C	T	11	10	21	0	1	22	0	0
15	3000347	.	T	C	7	0	7	0	9	16	0	0
15	3000472	.	C	A	1	0	1	0	0	1	0	0
15	3003682	.	T	C	2	0	2	0	3	5	0	0
15	3005511	.	C	T	9	4	13	0	0	13	0	0
15	3005538	.	G	A	6	5	11	0	0	11	0	0
15	3005556	.	C	A	0	4	4	0	6	10	0	0
15	3005578	.	A	G	3	3	6	0	0	6	0	0
15	3011241	.	C	T	0	3	3	0	5	8	0	0
15	3020470	.	G	A	2	3	5	0	0	5	0	0
15	3020475	.	G	A	2	3	5	0	0	5	0	0
15	3020598	.	T	A	3	0	3	0	0	3	0	0
15	3027321	.	T	A	2	4	6	0	0	6	0	0
15	3027378	.	T	C	4	0	4	0	7	11	0	0
15	3134816	.	T	G	1	0	1	0	4	5	0	0
15	3134843	.	C	A	2	3	5	0	1	6	0	0
15	3138744	.	C	T	1	3	4	0	0	4	0	0
15	3144060	.	C	T	2	2	4	0	0	4	0	0
15	3150705	.	T	C	0	1	1	0	0	1	0	0
15	3150717	.	T	G	0	1	1	0	0	1	0	0
15	3154872	.	C	A	0	2	2	0	0	2	0	0
15	3156844	.	T	C	1	0	1	0	0	1	0	0
15	3156847	.	T	A	1	0	1	0	0	1	0	0
15	3191981	.	A	T	2	2	4	0	0	4	0	0
15	3375384	.	C	T	2	0	2	0	1	3	0	0
15	3376685	.	A	C	1	4	5	0	0	5	0	0
15	3376700	.	T	C	1	4	5	0	0	5	0	0
15	3376837	.	T	C	3	3	6	0	0	6	0	0
15	3376850	.	T	G	3	3	6	0	0	6	0	0
15	3377050	.	C	G	5	4	9	0	1	11	1	0
15	3377106	.	C	T	1	7	8	0	1	9	0	0
15	3377205	.	A	C	1	2	3	0	0	3	0	0
15	3377453	.	G	A	0	5	5	0	1	6	0	0
15	3377481	.	T	G	1	3	4	0	0	4	0	0
15	3377539	.	T	G	2	3	5	0	0	5	0	0
15	3377727	.	T	G	7	4	11	0	0	11	0	0
15	3378164	.	A	C	5	5	10	0	0	10	0	0
15	3378189	.	C	T	3	7	10	0	0	10	0	0
15	3456168	.	A	G	6	6	12	0	0	12	0	0
15	3456169	.	C	T	6	6	12	0	0	12	0	0
15	3456223	.	T	C	7	0	7	0	2	9	0	0
15	3456306	.	T	A	11	12	23	0	0	23	0	0
15	3456353	.	G	A	11	10	21	0	1	22	0	0
15	3477016	.	C	T	0	1	1	0	0	1	0	0
15	3494132	.	A	G	0	2	2	0	0	2	0	0
15	3531087	.	T	C	2	1	3	0	0	3	0	0
15	3534556	.	G	A	5	3	8	0	0	8	0	0
15	3534558	.	T	G	4	3	7	0	1	8	0	0
15	3539174	.	G	A	6	5	11	0	0	11	0	0
15	3651359	.	T	C	3	1	4	0	0	4	0	0
15	3674902	.	A	T	2	3	5	0	0	5	0	0
15	3675018	.	T	C	1	2	3	0	0	3	0	0
15	3676818	.	A	G	0	1	1	0	0	1	0	0
15	3680515	.	T	C	0	1	1	0	0	1	0	0
15	3685012	.	T	C	2	4	6	0	0	6	0	0
15	3734944	.	C	A	3	6	9	0	0	9	0	0
15	3734950	.	G	A	4	6	10	0	0	10	0	0
15	3735338	.	T	C	1	0	1	0	3	4	0	0
15	3735446	.	C	T	1	3	4	0	0	4	0	0
15	3781602	.	A	T	3	2	5	0	0	5	0	0
15	3781621	.	G	T	2	2	4	0	0	4	0	0
15	3783208	.	A	C	2	2	4	0	0	4	0	0
15	3921308	.	A	G	3	3	6	0	0	6	0	0
15	3922822	.	C	G	1	4	5	0	1	6	0	0
15	3922835	.	A	C	2	5	7	0	0	7	0	0
15	3923193	.	A	G	1	2	3	0	0	3	0	0
15	3924312	.	A	T	2	4	6	0	0	6	0	0
15	3924349	.	C	G	4	5	9	0	0	9	0	0
15	3924381	.	T	C	5	2	7	0	0	7	0	0
15	3924542	.	G	A	1	4	5	0	0	5	0	0
15	3925403	.	T	G	1	2	3	0	1	4	0	0
15	4104889	.	T	A	5	4	9	0	0	9	0	0
15	4105164	.	C	T	3	3	6	0	3	9	0	0
15	4105168	.	T	G	4	3	7	0	1	8	0	0
15	4105235	.	T	C	5	9	14	0	0	14	0	0
15	4112123	.	A	T	1	3	4	0	0	4	0	0
15	4112132	.	T	C	2	4	6	0	0	6	0	0
15	4119284	.	A	G	2	3	5	0	0	5	0	0
15	4119323	.	G	A	3	2	5	0	0	5	0	0
15	4119329	.	A	G	3	3	6	0	0	6	0	0
15	4119464	.	G	A	1	4	5	0	0	5	0	0
15	4132681	.	C	T	1	2	3	0	0	3	0	0
15	4172470	.	A	G	2	3	5	0	0	5	0	0
15	4182718	.	A	G	1	1	2	0	0	2	0	0
15	4202300	.	T	C	0	3	3	0	0	3	0	0
15	4214109	.	A	G	1	1	2	0	0	2	0	0
15	4214139	.	T	C	2	1	3	0	1	4	0	0
15	4353353	.	C	T	10	31	41	0	4	45	0	0
15	4353858	.	C	T	24	24	48	0	5	53	0	0
15	4354071	.	G	A	37	28	65	0	2	67	0	0
15	4354082	.	G	A	35	29	64	0	1	65	0	0
15	4367594	.	T	C	27	28	55	0	0	55	0	0
15	4376110	.	C	T	0	21	21	0	13	34	0	0
15	4421879	.	A	T	2	2	4	0	0	4	0	0
15	4422128	.	G	T	6	3	9	0	0	9	0	0
15	4422496	.	A	G	1	2	3	0	0	3	0	0
15	4422580	.	A	G	3	0	3	0	0	3	0	0
15	4426474	.	C	T	6	2	8	0	0	8	0	0
15	4429003	.	C	T	0	2	2	0	4	6	0	0
15	4429004	.	G	A	4	2	6	0	0	6	0	0
15	4553776	.	C	T	2	2	4	0	0	4	0	0
15	4585517	.	T	C	14	0	14	0	7	21	0	0
15	4585771	.	T	A	12	11	23	0	1	24	0	0
15	4586190	.	C	G	0	21	21	0	18	39	0	0
15	4586235	.	A	G	14	16	30	0	1	31	0	0
15	4586299	.	G	T	3	7	10	0	2	12	0	0
15	4633700	.	C	G	18	0	18	0	27	45	0	0
15	4634063	.	C	T	24	27	51	0	2	53	0	0
15	4634196	.	T	C	16	20	36	0	2	38	0	0
15	4634354	.	A	G	21	21	42	0	3	45	0	0
15	4634454	.	A	G	29	24	53	0	1	54	0	0
15	4634627	.	A	G	18	14	32	0	4	36	0	0
15	4634698	.	C	A	16	5	21	0	2	23	0	0
15	4635055	.	G	A	1	31	32	0	24	56	0	0
15	4635073	.	T	C	26	25	51	0	3	54	0	0
15	4635179	.	C	A	26	24	50	0	1	51	0	0
15	4635387	.	C	T	22	26	48	0	4	52	0	0
15	4635517	.	G	A	27	12	39	0	2	41	0	0
15	4635573	.	C	T	22	16	38	0	2	40	0	0
15	4969522	.	C	G	1	2	3	0	0	3	0	0
15	4969558	.	C	T	0	1	1	0	0	1	0	0
15	4976106	.	G	A	1	2	3	0	0	3	0	0
15	4981675	.	G	T	4	3	7	0	0	7	0	0
15	4981963	.	C	T	4	2	6	0	0	6	0	0
15	4982424	.	A	T	1	2	3	0	0	3	0	0
15	4982502	.	G	T	2	2	4	0	2	6	0	0
15	4982614	.	T	C	4	6	10	0	1	11	0	0
15	4982744	.	C	A	8	2	10	0	2	12	0	0
15	4982828	.	A	T	3	5	8	0	0	8	0	0
15	4983533	.	A	T	1	2	3	0	1	4	0	0
15	4983598	.	G	A	7	2	9	0	0	9	0	0
15	4983708	.	A	T	2	4	6	0	0	6	0	0
15	4983781	.	T	C	5	2	7	0	1	8	0	0
15	4984740	.	T	C	4	7	11	0	0	11	0	0
15	4984759	.	T	C	7	5	12	0	1	13	0	0
15	4985002	.	A	T	2	2	4	0	1	5	0	0
15	4991716	.	T	C	1	1	2	0	0	2	0	0
15	4991722	.	A	G	1	0	1	0	1	2	0	0
15	4995166	.	A	G	9	10	19	0	1	20	0	0
15	4999347	.	G	C	9	7	16	0	0	16	0	0
15	4999572	.	G	C	13	17	30	0	4	34	0	0
15	5073626	.	T	C	0	2	2	0	0	2	0	0
15	5073641	.	G	A	0	2	2	0	0	2	0	0
15	5073791	.	A	G	4	0	4	0	7	11	0	0
15	5074539	.	G	T	1	3	4	0	0	4	0	0
15	5074663	.	C	T	3	2	5	0	0	5	0	0
15	5074686	.	A	C	2	3	5	0	0	5	0	0
15	5074718	.	A	T	4	2	6	0	0	6	0	0
15	5074793	.	T	G	7	6	13	0	0	13	0	0
15	5074799	.	T	C	6	6	12	0	0	12	0	0
15	5074873	.	A	G	6	4	10	0	0	10	0	0
15	5074947	.	A	G	1	5	6	0	0	6	0	0
15	5140246	.	A	G	0	1	1	0	0	1	0	0
15	5140807	.	G	A	3	1	4	0	0	4	0	0
15	5140867	.	A	T	3	2	5	0	0	5	0	0
15	5140882	.	G	A	3	3	6	0	0	6	0	0
15	5140936	.	C	A	1	2	3	0	0	3	0	0
15	5140939	.	G	A	1	1	2	0	0	2	0	0
15	5142205	.	C	T	1	2	3	0	0	3	0	0
15	5144775	.	T	C	0	4	4	0	0	4	0	0
15	5144805	.	A	C	1	7	8	0	0	8	0	0
15	5147722	.	T	C	7	8	15	0	2	17	0	0
15	5147723	.	A	T	7	10	17	0	0	17	0	0
15	5147843	.	C	T	5	6	11	0	1	12	0	0
15	5147910	.	G	A	3	4	7	0	0	7	0	0
15	5147987	.	T	C	5	6	11	0	0	11	0	0
15	5148562	.	G	A	3	5	8	0	0	8	0	0
15	5403687	.	A	C	1	2	3	0	0	3	0	0
15	5406334	.	A	G	3	0	3	0	0	3	0	0
15	5467178	.	T	G	1	4	5	0	0	5	0	0
15	5467289	.	C	T	0	5	5	0	3	8	0	0
15	5570777	.	C	T	0	2	2	0	1	3	0	0
15	5570807	.	G	A	2	2	4	0	0	4	0	0
15	5632677	.	A	G	3	4	7	0	0	7	0	0
15	5632683	.	C	T	3	4	7	0	0	7	0	0
15	5632736	.	G	A	7	3	10	0	1	11	0	0
15	5641611	.	T	C	2	0	2	0	4	6	0	0
15	5648119	.	G	A	4	2	6	0	0	6	0	0
15	5650755	.	G	A	3	0	3	0	0	3	0	0
15	5650758	.	T	G	2	0	2	0	1	3	0	0
15	5659940	.	T	C	0	2	2	0	0	2	0	0
15	5660030	.	G	A	1	2	3	0	1	4	0	0
15	5723938	.	T	G	13	4	17	0	0	17	0	0
15	5723980	.	C	G	0	4	4	0	10	14	0	0
15	5726178	.	T	A	4	1	5	0	0	5	0	0
15	5738967	.	A	G	1	1	2	0	0	2	0	0
15	5829662	.	A	C	2	0	2	0	6	8	0	0
15	5829881	.	A	C	6	0	6	0	5	11	0	0
15	5829922	.	C	T	6	11	17	0	0	17	0	0
15	5830106	.	G	T	3	5	8	0	0	8	0	0
15	5830218	.	T	C	3	5	8	0	0	8	0	0
15	5830443	.	T	G	4	12	16	0	0	16	0	0
15	5830492	.	C	T	0	7	7	0	7	14	0	0
15	5830513	.	C	T	3	7	10	0	0	10	0	0
15	5830655	.	C	T	0	4	4	0	8	12	0	0
15	5830696	.	C	T	0	8	8	0	2	10	0	0
15	5831004	.	G	A	13	8	21	0	1	22	0	0
15	5831199	.	G	A	2	4	6	0	1	7	0	0
15	5836532	.	C	T	5	3	8	0	0	8	0	0
15	5836542	.	C	T	4	4	8	0	0	8	0	0
15	5836610	.	G	T	4	3	7	0	1	8	0	0
15	5837181	.	T	C	1	1	2	0	5	7	0	0
15	5853041	.	T	C	1	1	2	0	0	2	0	0
15	5853119	.	A	T	3	3	6	0	0	6	0	0
15	5865261	.	A	G	0	3	3	0	1	4	0	0
15	5898511	.	T	A	10	5	15	0	2	17	0	0
15	5898856	.	A	G	17	22	39	0	0	39	0	0
15	5898920	.	A	C	16	15	31	0	0	31	0	0
15	5899083	.	C	T	0	23	23	0	18	41	0	0
15	5899113	.	G	A	1	29	30	0	0	31	1	0
15	5899237	.	C	A	0	17	17	0	14	31	0	0
15	5904761	.	T	C	5	10	15	0	0	15	0	0
15	5914994	.	G	A	0	1	1	0	4	5	0	0
15	5916387	.	C	A	18	20	38	0	0	38	0	0
15	5916389	.	G	C	17	20	37	0	1	38	0	0
15	5916442	.	G	A	11	11	22	0	1	23	0	0
15	5916741	.	G	T	2	2	4	0	0	4	0	0
15	5916772	.	T	G	2	2	4	0	0	4	0	0
15	6139624	.	G	C	7	7	14	0	1	16	1	0
15	6139800	.	G	A	14	14	28	0	9	37	0	0
15	6139803	.	C	T	20	14	34	0	4	38	0	0
15	6154439	.	T	A	16	12	28	0	1	29	0	0
15	6161235	.	A	G	1	1	2	0	0	2	0	0
15	6161789	.	A	G	5	1	6	0	0	6	0	0
15	6161804	.	C	T	0	0	0	0	1	1	0	0
15	6174544	.	T	G	5	7	12	0	1	13	0	0
15	6186503	.	A	G	1	3	4	0	0	4	0	0
15	6948712	.	A	G	3	2	5	0	0	5	0	0
15	6957221	.	C	G	5	5	10	0	0	10	0	0
15	7300837	.	T	C	4	2	6	0	0	6	0	0
15	7300900	.	T	C	9	7	16	0	1	17	0	0
15	7300901	.	T	C	10	0	10	0	7	17	0	0
15	8236317	.	C	T	0	3	3	0	0	3	0	0
15	8485104	.	T	G	4	2	6	0	0	6	0	0
15	8604835	.	A	C	6	9	15	0	0	15	0	0
15	8605259	.	C	A	7	13	20	0	0	20	0	0
15	8605318	.	G	A	13	14	27	0	3	30	0	0
15	8605452	.	C	A	9	9	18	0	1	19	0	0
15	8605838	.	T	A	8	13	21	0	1	22	0	0
15	8605839	.	A	T	9	12	21	0	1	22	0	0
15	8605972	.	T	A	11	18	29	0	0	29	0	0
15	8606207	.	A	T	9	4	13	0	1	14	0	0
15	8606224	.	G	A	3	7	10	0	0	10	0	0
15	8606256	.	A	C	6	11	17	0	0	17	0	0
15	8606464	.	A	G	8	15	23	0	3	26	0	0
15	8606501	.	G	A	6	21	27	0	2	29	0	0
15	8606507	.	G	A	6	19	25	0	3	28	0	0
15	8606555	.	C	T	5	8	13	0	1	14	0	0
15	8606601	.	A	C	9	7	16	0	0	16	0	0
15	8606619	.	A	G	12	9	21	0	0	21	0	0
15	8606733	.	T	C	6	6	12	0	0	12	0	0
15	8606739	.	A	T	7	5	12	0	1	13	0	0
15	8606799	.	T	G	5	5	10	0	0	10	0	0
15	8606872	.	C	A	6	12	18	0	0	18	0	0
15	8606897	.	T	C	6	4	10	0	0	10	0	0
15	8606940	.	T	G	4	10	14	0	0	14	0	0
15	8606943	.	T	G	4	11	15	0	0	15	0	0
15	8607025	.	T	A	9	14	23	0	0	23	0	0
15	8607182	.	T	A	9	9	18	0	0	18	0	0
15	8607365	.	G	T	10	13	23	0	9	32	0	0
15	8607846	.	T	A	3	5	8	0	0	8	0	0
15	8661671	.	C	T	4	3	7	0	1	8	0	0
15	8665414	.	G	A	0	3	3	0	0	3	0	0
15	8665459	.	C	T	0	2	2	0	0	2	0	0
15	8665481	.	G	A	0	1	1	0	0	1	0	0
15	8799065	.	A	G	27	22	49	0	4	53	0	0
15	11722308	.	A	G	0	1	1	0	0	1	0	0
15	11727939	.	T	C	2	1	3	0	0	3	0	0
15	11953123	.	A	C	1	2	3	0	0	3	0	0
15	11953682	.	C	T	3	2	5	0	0	5	0	0
15	12101952	.	G	A	1	2	3	0	0	3	0	0
15	12110755	.	A	C	1	2	3	0	0	3	0	0
15	12111076	.	A	G	3	2	5	0	0	5	0	0
15	12118661	.	C	T	0	2	2	0	1	3	0	0
15	12118838	.	T	C	1	0	1	0	0	1	0	0
15	12121443	.	G	A	1	0	1	0	0	1	0	0
15	12319008	.	C	A	19	17	36	0	0	36	0	0
15	12500814	.	T	C	1	2	3	0	1	4	0	0
15	12521382	.	T	G	8	4	12	0	0	12	0	0
15	12521405	.	T	G	5	9	14	0	0	14	0	0
15	12521472	.	G	A	9	19	28	0	0	28	0	0
15	12521506	.	A	G	15	12	27	0	2	29	0	0
15	12521680	.	A	C	14	26	40	0	0	40	0	0
15	12521745	.	A	G	16	15	31	0	2	33	0	0
15	12521964	.	A	T	4	7	11	0	2	13	0	0
15	12522031	.	A	T	7	12	19	0	0	19	0	0
15	12522094	.	A	T	4	12	16	0	1	17	0	0
15	12522104	.	T	C	5	9	14	0	0	14	0	0
15	12522132	.	T	G	7	11	18	0	0	18	0	0
15	12522179	.	A	G	6	7	13	0	2	15	0	0
15	12522353	.	T	A	19	5	24	0	1	25	0	0
15	12522514	.	G	A	10	9	19	0	0	19	0	0
15	12522673	.	A	G	7	3	10	0	0	10	0	0
15	12522736	.	C	G	7	10	17	0	0	17	0	0
15	12526710	.	G	A	14	6	20	0	4	24	0	0
15	12545614	.	G	T	4	7	11	0	1	12	0	0
15	13107454	.	T	A	4	2	6	0	0	6	0	0
15	13107498	.	C	T	4	6	10	0	0	10	0	0
15	13107561	.	T	C	6	9	15	0	0	15	0	0
15	13107562	.	G	A	6	9	15	0	0	15	0	0
15	13127035	.	A	G	1	5	6	0	0	6	0	0
15	13127248	.	T	C	11	9	20	0	0	20	0	0
15	13129937	.	A	G	8	9	17	0	0	17	0	0
15	13138074	.	A	C	7	6	13	0	0	13	0	0
15	13207561	.	T	G	3	3	6	0	0	6	0	0
15	13207597	.	C	T	0	5	5	0	7	12	0	0
15	13207828	.	T	A	1	4	5	0	0	5	0	0
15	13207858	.	G	C	1	4	5	0	1	6	0	0
15	13207870	.	A	G	3	5	8	0	0	8	0	0
15	13253708	.	T	G	1	1	2	0	0	2	0	0
15	13985123	.	C	A	6	4	10	0	0	10	0	0
15	13985578	.	T	C	9	7	16	0	1	17	0	0
15	13985644	.	C	T	8	12	20	0	0	20	0	0
15	13985827	.	C	G	8	7	15	0	0	15	0	0
15	13986009	.	T	C	6	8	14	0	0	14	0	0
15	13986233	.	G	T	3	8	11	0	1	12	0	0
15	13986279	.	A	T	8	8	16	0	0	16	0	0
15	14076096	.	T	C	1	2	3	0	0	3	0	0
15	14076223	.	A	T	5	6	11	0	0	11	0	0
15	14076329	.	T	G	6	5	11	0	0	11	0	0
15	14076376	.	C	T	4	4	8	0	0	8	0	0
15	14076550	.	G	T	3	2	5	0	0	5	0	0
15	14076710	.	T	A	5	2	7	0	0	7	0	0
15	14079784	.	G	A	1	0	1	0	0	1	0	0
15	14079974	.	G	C	3	0	3	0	0	3	0	0
15	14082347	.	G	T	6	2	8	0	1	9	0	0
15	14083023	.	T	G	1	1	2	0	0	2	0	0
15	14083104	.	C	A	0	2	2	0	3	5	0	0
15	14085276	.	T	G	4	6	10	0	0	10	0	0
15	14085800	.	T	C	4	3	7	0	2	9	0	0
15	14085847	.	G	T	7	5	12	0	0	12	0	0
15	14085914	.	G	A	7	8	15	0	0	15	0	0
15	14088146	.	G	A	8	13	21	0	1	22	0	0
15	14088252	.	G	A	10	6	16	0	0	16	0	0
15	14088270	.	C	T	7	11	18	0	0	18	0	0
15	14092805	.	G	A	3	2	5	0	0	5	0	0
15	14092819	.	C	A	2	3	5	0	0	5	0	0
15	14093020	.	G	A	6	7	13	0	0	13	0	0
15	14093032	.	A	G	7	6	13	0	1	14	0	0
15	14093110	.	T	A	10	9	19	0	2	21	0	0
15	14093197	.	C	T	1	5	6	0	0	6	0	0
15	14098221	.	G	A	1	5	6	0	0	6	0	0
15	14184318	.	A	G	1	0	1	0	0	1	0	0
15	14206430	.	T	C	2	1	3	0	0	3	0	0
15	14206438	.	G	A	2	2	4	0	0	4	0	0
15	14206480	.	A	G	3	2	5	0	0	5	0	0
15	14206505	.	T	C	2	5	7	0	0	7	0	0
15	14207871	.	C	T	2	3	5	0	0	5	0	0
15	14207874	.	C	G	2	3	5	0	0	5	0	0
15	14208388	.	G	A	2	2	4	0	0	4	0	0
15	14208403	.	A	T	3	2	5	0	0	5	0	0
15	14208613	.	T	G	1	2	3	0	0	3	0	0
15	14209890	.	G	T	1	2	3	0	0	3	0	0
15	14303207	.	T	A	2	4	6	0	0	6	0	0
15	14317040	.	G	A	2	4	6	0	0	6	0	0
15	14321321	.	C	G	3	3	6	0	0	6	0	0
15	14321572	.	G	T	4	2	6	0	0	6	0	0
15	14378901	.	C	A	2	2	4	0	0	4	0	0
15	14385092	.	C	T	3	2	5	0	0	5	0	0
15	14385123	.	A	G	1	0	1	0	2	3	0	0
15	14388459	.	C	T	1	1	2	0	1	3	0	0
15	14388464	.	C	T	0	2	2	0	0	2	0	0
15	14388588	.	C	T	1	0	1	0	0	1	0	0
15	14417492	.	T	C	5	3	8	0	0	8	0	0
15	14417729	.	A	T	5	2	7	0	0	7	0	0
15	14419978	.	A	T	3	2	5	0	0	5	0	0
15	14420177	.	C	T	5	9	14	0	0	14	0	0
15	14436553	.	C	T	3	2	5	0	0	5	0	0
15	14436554	.	T	A	2	2	4	0	1	5	0	0
15	14437204	.	A	G	4	3	7	0	0	7	0	0
15	14437239	.	T	A	8	5	13	0	0	13	0	0
15	14443534	.	A	G	1	0	1	0	0	1	0	0
15	14554550	.	T	A	11	4	15	0	2	17	0	0
15	14554568	.	A	C	12	4	16	0	1	17	0	0
15	14554769	.	C	T	0	8	8	0	9	17	0	0
15	14557015	.	G	A	0	2	2	0	0	2	0	0
15	14557047	.	T	G	0	2	2	0	0	2	0	0
15	14561658	.	C	T	0	1	1	0	0	1	0	0
15	14567638	.	G	C	2	1	3	0	0	3	0	0
15	14567641	.	G	T	2	1	3	0	0	3	0	0
15	14570191	.	T	G	0	1	1	0	0	1	0	0
15	14570991	.	A	T	2	2	4	0	1	5	0	0
15	14571139	.	G	A	1	3	4	0	0	4	0	0
15	14597342	.	G	A	2	3	5	0	0	5	0	0
15	14597518	.	A	G	5	3	8	0	0	8	0	0
15	14597670	.	T	A	2	4	6	0	0	6	0	0
15	14597870	.	A	C	7	4	11	0	0	11	0	0
15	14597887	.	G	T	5	2	7	0	0	7	0	0
15	14597991	.	T	C	2	4	6	0	0	6	0	0
15	14598192	.	G	A	6	4	10	0	0	10	0	0
15	14598321	.	G	A	0	4	4	0	6	10	0	0
15	14598327	.	G	A	5	5	10	0	1	11	0	0
15	14598403	.	G	A	1	3	4	0	0	4	0	0
15	14598669	.	G	A	2	2	4	0	0	4	0	0
15	14598672	.	A	G	1	1	2	0	1	3	0	0
15	14598708	.	C	T	2	4	6	0	1	7	0	0
15	14598807	.	T	C	4	6	10	0	1	11	0	0
15	14598823	.	G	A	0	6	6	0	4	10	0	0
15	14598930	.	G	A	0	13	13	0	4	17	0	0
15	14599152	.	T	C	10	12	22	0	1	23	0	0
15	14599167	.	G	A	0	8	8	0	10	18	0	0
15	14599203	.	A	G	6	6	12	0	0	12	0	0
15	14599486	.	G	A	7	4	11	0	0	11	0	0
15	14630941	.	T	C	8	1	9	0	6	15	0	0
15	14631242	.	A	G	10	8	18	0	1	19	0	0
15	14631258	.	C	T	8	6	14	0	0	14	0	0
15	14631289	.	T	C	8	5	13	0	0	13	0	0
15	14631314	.	G	A	8	1	9	0	0	9	0	0
15	14631531	.	T	C	1	0	1	0	4	5	0	0
15	14631535	.	T	C	1	4	5	0	0	5	0	0
15	14631665	.	A	G	3	2	5	0	1	6	0	0
15	14631743	.	T	A	3	2	5	0	0	5	0	0
15	14631772	.	T	C	3	4	7	0	0	7	0	0
15	14631856	.	G	T	6	4	10	0	0	10	0	0
15	14631867	.	G	T	3	3	6	0	2	8	0	0
15	14631930	.	T	C	2	4	6	0	0	6	0	0
15	14631969	.	A	G	11	8	19	0	0	19	0	0
15	14632135	.	C	T	0	16	16	0	12	28	0	0
15	14632160	.	A	T	18	7	25	0	2	27	0	0
15	14632189	.	T	C	10	8	18	0	0	18	0	0
15	14632197	.	G	T	11	7	18	0	0	18	0	0
15	14632244	.	A	T	7	4	11	0	1	12	0	0
15	14632293	.	T	A	8	8	16	0	0	16	0	0
15	14632510	.	G	A	9	9	18	0	0	18	0	0
15	14632543	.	C	T	8	11	19	0	0	19	0	0
15	14632561	.	T	C	8	0	8	0	9	17	0	0
15	14632834	.	G	C	3	0	3	0	9	12	0	0
15	14632842	.	G	A	3	10	13	0	0	13	0	0
15	14633002	.	A	C	6	3	9	0	0	9	0	0
15	14633011	.	T	C	6	0	6	0	3	9	0	0
15	14633077	.	T	C	5	0	5	0	5	10	0	0
15	14633404	.	C	T	0	10	10	0	12	22	0	0
15	14633722	.	G	A	5	6	11	0	1	12	0	0
15	14633815	.	A	G	2	5	7	0	0	7	0	0
15	14633875	.	C	T	0	5	5	0	1	6	0	0
15	14633905	.	T	G	2	5	7	0	0	7	0	0
15	14634501	.	A	G	5	3	8	0	0	8	0	0
15	14636343	.	G	A	3	5	8	0	1	9	0	0
15	14642904	.	G	C	0	2	2	0	0	2	0	0
15	14659947	.	G	A	2	4	6	0	0	6	0	0
15	14664443	.	A	G	0	0	0	0	2	2	0	0
15	14664450	.	C	A	0	1	1	0	0	1	0	0
15	14665761	.	T	C	1	0	1	0	1	2	0	0
15	14855219	.	C	A	4	2	6	0	0	6	0	0
15	14855291	.	A	G	1	1	2	0	0	2	0	0
15	14856739	.	A	G	0	0	0	0	1	1	0	0
15	14856803	.	A	T	4	2	6	0	0	6	0	0
15	14964146	.	T	A	2	3	5	0	1	6	0	0
15	15297800	.	T	G	2	2	4	0	0	4	0	0
15	15349693	.	C	T	29	31	60	0	4	64	0	0
15	15349780	.	C	T	26	24	50	0	4	54	0	0
15	15349860	.	T	A	27	34	61	0	4	66	1	0
15	15403927	.	G	T	3	3	6	0	0	6	0	0
15	15415839	.	T	C	3	3	6	0	0	6	0	0
15	15415903	.	C	G	3	1	4	0	0	4	0	0
15	15445690	.	G	C	8	0	8	0	9	17	0	0
15	15445733	.	T	C	6	0	6	0	4	10	0	0
15	15445767	.	T	C	1	0	1	0	3	4	0	0
15	15445802	.	T	C	4	1	5	0	0	5	0	0
15	15446104	.	T	C	9	11	20	0	2	22	0	0
15	15446484	.	C	T	0	6	6	0	13	19	0	0
15	15446590	.	G	A	6	12	18	0	0	18	0	0
15	15446609	.	C	A	7	9	16	0	1	17	0	0
15	15447037	.	C	T	0	4	4	0	6	10	0	0
15	15448975	.	A	G	1	1	2	0	0	2	0	0
15	15449395	.	G	C	4	3	7	0	0	7	0	0
15	15460593	.	A	G	1	1	2	0	0	2	0	0
15	15469045	.	T	C	1	2	3	0	0	3	0	0
15	15513569	.	G	A	5	4	9	0	0	9	0	0
15	15513571	.	A	G	3	4	7	0	2	9	0	0
15	15587093	.	C	T	6	7	13	0	0	13	0	0
15	15587117	.	C	T	7	6	13	0	0	13	0	0
15	15589504	.	C	T	6	6	12	0	2	14	0	0
15	15591868	.	T	A	11	10	21	0	0	21	0	0
15	15592318	.	G	A	15	24	39	0	2	41	0	0
15	15592332	.	C	G	18	1	19	0	22	41	0	0
15	15592504	.	C	T	17	12	29	0	0	29	0	0
15	15592537	.	A	T	10	15	25	0	2	27	0	0
15	15592629	.	T	C	14	12	26	0	1	27	0	0
15	15592641	.	C	G	15	0	15	0	11	26	0	0
15	15592784	.	C	A	28	10	38	0	3	41	0	0
15	15592879	.	C	T	8	10	18	0	4	22	0	0
15	15592991	.	G	A	23	15	38	0	2	40	0	0
15	15593128	.	G	A	15	6	21	0	1	22	0	0
15	15786270	.	C	T	2	4	6	0	1	7	0	0
15	15810922	.	G	C	0	5	5	0	3	8	0	0
15	15813810	.	C	T	7	9	16	0	0	16	0	0
15	15856342	.	T	A	1	1	2	0	0	2	0	0
15	15876974	.	T	C	8	15	23	0	3	26	0	0
15	15877019	.	T	C	11	14	25	0	0	25	0	0
15	15877600	.	G	A	12	14	26	0	0	26	0	0
15	15877616	.	G	C	12	13	25	0	2	27	0	0
15	15886202	.	C	A	10	8	18	0	0	18	0	0
15	15886346	.	A	G	7	14	21	0	1	22	0	0
15	15886461	.	A	T	1	12	13	0	0	13	0	0
15	15886491	.	A	C	6	3	9	0	1	10	0	0
15	15886502	.	A	G	5	4	9	0	0	9	0	0
15	15886564	.	A	G	4	4	8	0	1	9	0	0
15	15886697	.	T	C	4	2	6	0	0	6	0	0
15	15886701	.	C	T	1	4	5	0	3	8	0	0
15	15886803	.	C	T	0	9	9	0	14	23	0	0
15	15886806	.	T	C	9	7	16	0	4	20	0	0
15	15906718	.	G	A	4	2	6	0	2	8	0	0
15	15906766	.	C	T	8	5	13	0	1	14	0	0
15	15916216	.	G	A	9	4	13	0	0	13	0	0
15	15923499	.	G	A	8	5	13	0	1	14	0	0
15	15923577	.	G	A	3	14	17	0	0	17	0	0
15	15923616	.	G	A	7	11	18	0	0	18	0	0
15	15923628	.	C	G	1	11	12	0	10	22	0	0
15	15944045	.	C	T	0	9	9	0	6	15	0	0
15	15944102	.	G	A	5	7	12	0	2	14	0	0
15	15944129	.	G	A	6	4	10	0	0	10	0	0
15	15944287	.	G	A	3	4	7	0	0	7	0	0
15	15944435	.	G	A	8	8	16	0	0	16	0	0
15	15944465	.	A	G	4	9	13	0	0	13	0	0
15	15947466	.	G	A	5	5	10	0	0	10	0	0
15	15949872	.	T	C	5	1	6	0	3	9	0	0
15	15950223	.	A	C	4	3	7	0	0	7	0	0
15	16066453	.	A	G	27	26	53	0	0	53	0	0
15	16066459	.	C	T	25	27	52	0	1	53	0	0
15	16066508	.	C	T	3	17	20	0	33	53	0	0
15	16067051	.	G	A	21	37	58	0	2	60	0	0
15	16072281	.	A	C	22	13	35	0	2	37	0	0
15	16072690	.	T	C	21	16	37	0	4	41	0	0
15	16072822	.	T	A	19	14	33	0	1	34	0	0
15	16073046	.	C	A	5	7	12	0	1	13	0	0
15	16073055	.	A	C	5	4	9	0	2	11	0	0
15	16073081	.	A	G	7	8	15	0	7	22	0	0
15	16076221	.	A	C	1	2	3	0	0	3	0	0
15	16079709	.	T	G	15	21	36	0	2	38	0	0
15	16079733	.	G	T	14	25	39	0	0	39	0	0
15	16080258	.	G	A	15	21	36	0	1	37	0	0
15	16086528	.	G	A	1	4	5	0	1	6	0	0
15	16086600	.	G	T	22	23	45	0	1	46	0	0
15	16094383	.	G	A	9	6	15	0	0	15	0	0
15	16094672	.	C	T	0	5	5	0	6	11	0	0
15	16101332	.	G	A	1	4	5	0	0	5	0	0
15	16101492	.	C	T	4	4	8	0	0	8	0	0
15	16123356	.	C	T	2	4	6	0	0	6	0	0
15	16123358	.	A	G	4	1	5	0	1	6	0	0
15	16123735	.	G	C	8	7	15	0	0	15	0	0
15	16123873	.	G	A	3	9	12	0	0	12	0	0
15	16123921	.	T	C	6	11	17	0	0	17	0	0
15	16124008	.	T	A	9	11	20	0	4	24	0	0
15	16124125	.	G	A	7	6	13	0	0	13	0	0
15	16124210	.	C	T	0	4	4	0	4	8	0	0
15	16125799	.	T	C	2	2	4	0	0	4	0	0
15	16127139	.	C	T	3	2	5	0	0	5	0	0
15	16130244	.	G	A	2	9	11	0	0	11	0	0
15	16136073	.	A	G	2	0	2	0	0	2	0	0
15	16139042	.	T	C	2	0	2	0	0	2	0	0
15	16142340	.	T	C	3	0	3	0	3	6	0	0
15	16144013	.	G	A	1	2	3	0	0	3	0	0
15	16144334	.	A	C	0	0	0	0	1	1	0	0
15	16149660	.	C	T	1	2	3	0	0	3	0	0
15	16149709	.	G	A	3	2	5	0	0	5	0	0
15	16183479	.	C	T	7	7	14	0	1	15	0	0
15	16194155	.	A	T	9	12	21	0	1	22	0	0
15	16194208	.	G	A	9	4	13	0	0	13	0	0
15	16194222	.	G	T	13	1	14	0	0	14	0	0
15	16194254	.	G	C	7	10	17	0	1	18	0	0
15	16194369	.	G	A	9	11	20	0	1	21	0	0
15	16194741	.	T	A	9	18	27	0	4	31	0	0
15	16226577	.	A	G	1	0	1	0	0	1	0	0
15	16226598	.	G	A	1	1	2	0	1	3	0	0
15	16323480	.	A	G	3	3	6	0	0	6	0	0
15	16323568	.	T	A	5	9	14	0	0	14	0	0
15	16328623	.	C	T	12	14	26	0	1	27	0	0
15	16332592	.	C	T	3	0	3	0	0	3	0	0
15	16332643	.	T	A	3	0	3	0	0	3	0	0
15	16332844	.	C	A	10	7	17	0	0	17	0	0
15	16377555	.	C	T	6	7	13	0	1	14	0	0
15	16378219	.	T	C	1	2	3	0	0	3	0	0
15	16378885	.	C	T	0	5	5	0	3	8	0	0
15	16379795	.	A	T	1	2	3	0	0	3	0	0
15	16380097	.	A	T	1	2	3	0	0	3	0	0
15	16380377	.	A	G	8	5	13	0	0	13	0	0
15	16380457	.	T	C	3	3	6	0	0	6	0	0
15	16381808	.	G	C	6	3	9	0	1	10	0	0
15	16398241	.	T	G	2	1	3	0	0	3	0	0
15	16398265	.	T	C	6	8	14	0	0	14	0	0
15	16401668	.	A	G	4	0	4	0	0	4	0	0
15	16406279	.	T	C	1	0	1	0	0	1	0	0
15	16407139	.	A	T	1	2	3	0	0	3	0	0
15	16407354	.	A	G	11	12	23	0	0	23	0	0
15	16407575	.	G	T	12	12	24	0	0	24	0	0
15	16407723	.	G	A	24	12	36	0	1	37	0	0
15	16935759	.	G	T	14	13	27	0	0	27	0	0
15	16935806	.	C	T	11	2	13	0	1	14	0	0
15	16935867	.	C	T	8	10	18	0	1	19	0	0
15	16936271	.	C	T	3	4	7	0	0	7	0	0
15	16936495	.	A	T	10	4	14	0	1	15	0	0
15	16936716	.	C	T	8	4	12	0	1	13	0	0
15	16937374	.	T	C	6	2	8	0	0	8	0	0
15	16937375	.	T	C	2	6	8	0	0	8	0	0
15	16937545	.	T	C	2	6	8	0	0	8	0	0
15	16937546	.	T	C	2	1	3	0	5	8	0	0
15	16937653	.	T	C	2	7	9	0	0	9	0	0
15	16937662	.	T	C	2	1	3	0	10	13	0	0
15	16937688	.	T	C	12	6	18	0	1	19	0	0
15	16938166	.	A	G	6	6	12	0	1	13	0	0
15	16939218	.	G	C	3	0	3	0	5	8	0	0
15	16939266	.	C	T	2	3	5	0	0	5	0	0
15	16939271	.	C	A	2	3	5	0	0	5	0	0
15	16944167	.	T	C	1	0	1	0	1	2	0	0
15	16944173	.	T	C	2	0	2	0	0	2	0	0
15	16944350	.	T	C	1	1	2	0	0	2	0	0
15	16946592	.	A	G	0	1	1	0	0	1	0	0
15	16948484	.	T	C	3	1	4	0	0	4	0	0
15	16965453	.	G	A	3	6	9	0	0	9	0	0
15	17085012	.	T	A	11	9	20	0	0	20	0	0
15	17091003	.	C	T	5	2	7	0	0	7	0	0
15	17091030	.	G	A	4	1	5	0	0	5	0	0
15	17091418	.	G	A	0	6	6	0	8	14	0	0
15	17095457	.	C	T	11	17	28	0	2	30	0	0
15	17122535	.	A	C	3	9	12	0	1	13	0	0
15	17122563	.	T	C	5	10	15	0	0	15	0	0
15	17122673	.	C	T	5	6	11	0	0	11	0	0
15	17122935	.	A	G	8	0	8	0	4	12	0	0
15	17123012	.	T	C	8	9	17	0	1	18	0	0
15	17123040	.	G	T	12	5	17	0	0	17	0	0
15	17123063	.	A	G	10	4	14	0	0	14	0	0
15	17123191	.	A	G	6	3	9	0	1	10	0	0
15	17123193	.	A	G	4	4	8	0	2	10	0	0
15	17123290	.	A	G	6	9	15	0	0	15	0	0
15	17123937	.	T	A	12	6	18	0	0	18	0	0
15	17123968	.	C	A	13	7	20	0	0	20	0	0
15	17124011	.	A	G	16	11	27	0	4	31	0	0
15	17124012	.	C	G	20	11	31	0	0	31	0	0
15	17124084	.	A	G	22	8	30	0	1	31	0	0
15	17124124	.	C	A	14	9	23	0	1	24	0	0
15	17124246	.	A	G	12	7	19	0	1	20	0	0
15	17124253	.	G	T	11	7	18	0	0	18	0	0
15	17124283	.	A	G	17	4	21	0	2	23	0	0
15	17124484	.	T	A	4	2	6	0	1	7	0	0
15	17124580	.	A	G	4	13	17	1	0	18	0	0
15	17124654	.	T	G	5	8	13	1	0	14	0	0
15	17124768	.	G	C	12	9	21	0	0	21	0	0
15	17125033	.	A	G	4	4	8	0	0	8	0	0
15	17125102	.	A	T	6	3	9	0	0	9	0	0
15	17125108	.	C	T	8	3	11	0	0	11	0	0
15	17128418	.	T	C	4	0	4	0	9	13	0	0
15	17128468	.	G	A	2	4	6	0	0	6	0	0
15	17131785	.	C	T	11	8	19	0	1	20	0	0
15	17134701	.	C	T	0	18	18	0	12	30	0	0
15	17147012	.	A	G	9	7	16	0	2	18	0	0
15	17147400	.	G	A	10	6	16	0	0	16	0	0
15	17151085	.	T	A	4	1	5	0	0	5	0	0
15	17168668	.	G	A	1	4	5	0	0	5	0	0
15	17266509	.	T	C	0	1	1	0	0	1	0	0
15	17268268	.	A	T	1	2	3	0	0	3	0	0
15	17280064	.	G	A	0	1	1	0	0	1	0	0
15	17299682	.	T	C	0	1	1	0	1	2	0	0
15	17308206	.	C	A	1	3	4	0	0	4	0	0
15	17308378	.	T	C	4	2	6	0	1	7	0	0
15	17312080	.	T	C	3	1	4	0	1	5	0	0
15	17312299	.	G	A	4	6	10	0	2	12	0	0
15	17312386	.	G	A	1	3	4	0	4	8	0	0
15	17317008	.	T	A	12	7	19	0	0	19	0	0
15	17317044	.	C	T	8	6	14	0	0	14	0	0
15	17317089	.	T	A	1	0	1	0	1	2	0	0
15	17318566	.	T	C	12	5	17	0	1	18	0	0
15	17319345	.	C	T	11	8	19	0	1	20	0	0
15	17320851	.	T	C	19	12	31	0	1	32	0	0
15	17321164	.	A	G	2	2	4	0	0	4	0	0
15	17321302	.	A	T	1	3	4	0	1	5	0	0
15	17324793	.	C	T	7	6	13	0	0	13	0	0
15	17327501	.	C	T	31	24	55	0	1	56	0	0
15	17339078	.	C	T	27	28	55	0	2	57	0	0
15	17339719	.	T	C	23	24	47	0	3	50	0	0
15	17340104	.	A	C	14	13	27	0	1	28	0	0
15	17356708	.	A	G	2	0	2	0	2	4	0	0
15	17372580	.	C	A	13	8	21	0	2	23	0	0
15	17372721	.	A	T	6	4	10	0	1	11	0	0
15	17372934	.	C	T	5	9	14	0	0	14	0	0
15	17423913	.	A	C	7	11	18	0	1	19	0	0
15	17424011	.	T	C	10	8	18	0	1	19	0	0
15	17424185	.	T	G	5	10	15	0	0	15	0	0
15	17424397	.	G	A	8	9	17	0	0	17	0	0
15	17424472	.	A	T	11	8	19	0	0	19	0	0
15	17424493	.	T	C	6	7	13	0	0	13	0	0
15	17424515	.	A	T	5	10	15	0	1	16	0	0
15	17424581	.	A	T	4	8	12	0	0	12	0	0
15	17443968	.	G	A	4	3	7	0	0	7	0	0
15	17443969	.	T	G	4	3	7	0	0	7	0	0
15	17444203	.	T	C	4	6	10	0	0	10	0	0
15	17444227	.	A	G	6	2	8	0	1	9	0	0
15	17444262	.	G	C	7	5	12	0	0	12	0	0
15	17444284	.	A	C	6	8	14	0	0	14	0	0
15	17444428	.	C	T	1	2	3	0	0	3	0	0
15	17444533	.	A	C	5	7	12	0	0	12	0	0
15	17444569	.	C	T	4	4	8	0	0	8	0	0
15	17444632	.	T	C	2	4	6	0	0	6	0	0
15	17445606	.	G	A	4	3	7	0	0	7	0	0
15	17445618	.	T	A	4	3	7	0	0	7	0	0
15	17446854	.	C	T	3	4	7	0	2	9	0	0
15	17486317	.	A	C	3	11	14	0	0	14	0	0
15	17486388	.	G	T	8	8	16	0	0	16	0	0
15	17486576	.	C	A	8	9	17	0	2	19	0	0
15	17486715	.	C	T	10	15	25	0	0	25	0	0
15	17486725	.	G	T	10	18	28	0	0	28	0	0
15	17487386	.	C	T	10	7	17	0	0	17	0	0
15	17487544	.	A	G	17	7	24	0	1	25	0	0
15	17487717	.	T	A	5	17	22	0	0	22	0	0
15	17488214	.	T	C	2	4	6	0	0	6	0	0
15	17488513	.	C	T	10	10	20	0	1	21	0	0
15	17488672	.	A	G	24	11	35	0	0	35	0	0
15	17488698	.	A	T	17	16	33	0	0	33	0	0
15	17488834	.	A	C	13	16	29	0	4	33	0	0
15	17489033	.	C	T	11	11	22	0	2	24	0	0
15	17489049	.	A	T	12	7	19	0	0	19	0	0
15	17489165	.	G	A	0	10	10	1	11	22	0	0
15	17489191	.	A	G	8	0	8	1	12	21	0	0
15	17489203	.	G	A	0	17	17	0	9	26	0	0
15	17489360	.	A	C	10	24	34	0	0	34	0	0
15	17489440	.	G	C	19	18	37	0	1	38	0	0
15	17489505	.	G	A	6	10	16	0	3	19	0	0
15	17489573	.	G	T	2	6	8	0	0	8	0	0
15	17489575	.	C	G	2	6	8	0	0	8	0	0
15	17866976	.	T	C	15	14	29	0	0	29	0	0
15	17867929	.	A	G	18	11	29	0	2	32	1	0
15	17868250	.	G	A	11	13	24	0	1	25	0	0
15	17868448	.	T	C	7	9	16	0	4	20	0	0
15	17868601	.	T	G	10	6	16	0	1	17	0	0
15	17948534	.	C	T	5	4	9	0	0	9	0	0
15	17948616	.	C	G	3	5	8	0	0	8	0	0
15	17948786	.	C	G	7	4	11	0	0	11	0	0
15	17948852	.	G	C	1	4	5	0	1	6	0	0
15	17948898	.	T	C	6	3	9	0	0	9	0	0
15	17949100	.	C	T	1	4	5	0	0	5	0	0
15	17949142	.	C	G	2	7	9	0	0	9	0	0
15	17949163	.	C	T	2	5	7	0	0	7	0	0
15	17949252	.	A	G	5	3	8	0	0	8	0	0
15	17966459	.	G	A	2	2	4	0	0	4	0	0
15	17971248	.	C	T	1	1	2	0	0	2	0	0
15	18102357	.	T	C	4	5	9	0	0	9	0	0
15	18102777	.	C	G	12	11	23	0	1	24	0	0
15	18102898	.	T	C	11	8	19	0	2	21	0	0
15	18103009	.	T	A	9	11	20	0	1	21	0	0
15	18103248	.	T	C	11	7	18	0	0	18	0	0
15	18103363	.	G	A	11	2	13	0	0	13	0	0
15	18106754	.	A	G	1	4	5	0	0	5	0	0
15	18107049	.	A	G	4	8	12	0	1	13	0	0
15	18107081	.	G	A	2	5	7	0	0	7	0	0
15	18115551	.	T	C	2	4	6	0	0	6	0	0
15	18130119	.	G	A	4	7	11	0	3	14	0	0
15	18130190	.	A	G	12	9	21	0	2	23	0	0
15	18130202	.	A	G	10	0	10	0	11	21	0	0
15	18130305	.	T	C	16	14	30	0	1	31	0	0
15	18141117	.	G	A	12	8	20	0	0	20	0	0
15	18148889	.	G	A	12	19	31	0	2	33	0	0
15	18148892	.	A	G	10	19	29	0	2	31	0	0
15	18148928	.	A	G	3	0	3	0	4	7	0	0
15	18151095	.	G	A	1	0	1	0	0	1	0	0
15	18155273	.	C	T	10	9	19	0	0	19	0	0
15	18155297	.	T	C	13	13	26	0	1	27	0	0
15	18155322	.	G	T	13	14	27	0	1	28	0	0
15	18155342	.	T	A	12	14	26	0	0	26	0	0
15	18155392	.	G	A	12	12	24	0	0	24	0	0
15	18155394	.	C	T	12	11	23	0	1	24	0	0
15	18155588	.	C	T	14	2	16	0	1	17	0	0
15	18155638	.	G	A	23	19	42	0	0	42	0	0
15	18155730	.	A	G	21	25	46	0	0	46	0	0
15	18253900	.	G	A	9	4	13	0	0	13	0	0
15	18254148	.	G	A	16	8	24	0	0	24	0	0
15	18254777	.	C	G	0	9	9	0	4	13	0	0
15	18254821	.	T	A	5	6	11	0	0	11	0	0
15	18254985	.	C	T	15	7	22	0	1	23	0	0
15	18255292	.	A	G	9	13	22	0	0	22	0	0
15	18255653	.	T	C	5	4	9	0	2	11	0	0
15	18255802	.	C	T	3	2	5	0	5	10	0	0
15	18255883	.	G	T	3	2	5	0	0	5	0	0
15	18255891	.	T	C	3	0	3	0	4	7	0	0
15	18256138	.	A	G	3	5	8	0	0	8	0	0
15	18257167	.	T	A	1	3	4	0	0	4	0	0
15	18257180	.	A	G	1	3	4	0	0	4	0	0
15	18257434	.	A	T	8	2	10	0	1	11	0	0
15	18257692	.	A	T	5	3	8	0	0	8	0	0
15	18257743	.	T	C	2	4	6	0	1	7	0	0
15	18257754	.	A	G	3	4	7	0	1	8	0	0
15	18258045	.	C	T	4	2	6	0	1	7	0	0
15	18258080	.	T	A	4	2	6	0	0	6	0	0
15	18258947	.	A	C	1	0	1	1	5	7	0	0
15	18259036	.	T	G	3	5	8	0	0	8	0	0
15	18259585	.	G	T	1	2	3	0	0	3	0	0
15	18358126	.	C	T	0	2	2	0	0	2	0	0
15	18358186	.	A	G	1	2	3	0	0	3	0	0
15	18358435	.	G	A	4	4	8	0	0	8	0	0
15	18371336	.	A	T	0	2	2	0	0	2	0	0
15	18371418	.	T	A	5	7	12	0	2	14	0	0
15	18371509	.	C	T	5	4	9	0	0	9	0	0
15	18371522	.	A	G	6	3	9	0	0	9	0	0
15	18371789	.	T	C	14	0	14	0	13	27	0	0
15	18389662	.	C	A	0	5	5	0	2	7	0	0
15	18389724	.	C	T	1	2	3	0	0	3	0	0
15	18401240	.	G	T	9	10	19	0	1	20	0	0
15	18401270	.	A	G	4	9	13	0	0	13	0	0
15	18426315	.	G	A	4	5	9	0	0	9	0	0
15	18429123	.	T	C	4	0	4	0	3	7	0	0
15	18469599	.	A	G	1	1	2	0	0	2	0	0
15	18481130	.	G	A	1	0	1	0	0	1	0	0
15	18574608	.	C	T	2	2	4	0	0	4	0	0
15	19037534	.	A	G	15	9	24	0	0	24	0	0
15	19037618	.	A	G	14	12	26	0	1	27	0	0
15	19037626	.	G	C	15	11	26	0	1	27	0	0
15	19037787	.	G	C	6	6	12	0	0	12	0	0
15	19037895	.	T	C	4	9	13	0	0	13	0	0
15	19038092	.	A	T	5	4	9	0	0	9	0	0
15	19038143	.	G	T	7	11	18	0	0	18	0	0
15	19038218	.	G	A	7	20	27	0	0	27	0	0
15	19039025	.	A	G	4	15	19	0	0	19	0	0
15	19039667	.	T	C	5	0	5	0	5	10	0	0
15	19039830	.	C	A	0	4	4	0	7	11	0	0
15	19039874	.	A	G	4	2	6	0	0	6	0	0
15	19039985	.	C	A	1	3	4	0	0	4	0	0
15	19042070	.	C	T	4	5	9	0	0	9	0	0
15	19042213	.	A	C	2	4	6	0	2	8	0	0
15	19042347	.	C	T	0	9	9	0	6	15	0	0
15	19132077	.	A	G	20	20	40	0	0	41	1	0
15	19132178	.	G	A	15	15	30	0	1	31	0	0
15	19132203	.	A	T	17	15	32	0	1	33	0	0
15	19132724	.	G	A	7	1	8	0	0	8	0	0
15	19133310	.	C	T	11	15	26	0	1	27	0	0
15	19133374	.	G	T	9	13	22	0	1	23	0	0
15	19133437	.	A	T	14	17	31	0	1	32	0	0
15	19133647	.	C	T	11	18	29	0	1	30	0	0
15	19133750	.	A	G	13	20	33	0	2	35	0	0
15	19134109	.	T	C	11	0	11	0	14	25	0	0
15	19134710	.	G	A	3	4	7	0	0	7	0	0
15	19134905	.	C	A	6	5	11	0	0	11	0	0
15	19135009	.	T	C	4	1	5	0	0	5	0	0
15	19135304	.	T	C	11	4	15	0	0	15	0	0
15	19135351	.	G	A	9	7	16	0	1	17	0	0
15	19139757	.	C	T	0	8	8	0	7	15	0	0
15	19146896	.	T	C	1	3	4	0	0	4	0	0
15	19147330	.	G	A	2	2	4	0	0	4	0	0
15	19170879	.	C	T	1	0	1	0	0	1	0	0
15	19175049	.	T	C	0	0	0	0	2	2	0	0
15	19301259	.	A	G	0	4	4	0	2	6	0	0
15	19311631	.	C	T	15	8	23	0	0	23	0	0
15	19312545	.	G	A	2	2	4	0	0	4	0	0
15	19316319	.	T	G	1	4	5	0	1	6	0	0
15	19316370	.	T	A	3	3	6	0	0	6	0	0
15	19316437	.	C	A	3	8	11	0	1	12	0	0
15	19316497	.	A	T	5	6	11	0	0	11	0	0
15	19316500	.	G	T	6	5	11	0	0	11	0	0
15	19317065	.	G	A	2	2	4	0	4	8	0	0
15	19317301	.	A	C	3	2	5	0	2	7	0	0
15	19317644	.	T	A	2	0	2	0	1	3	0	0
15	19317667	.	T	A	2	2	4	0	1	5	0	0
15	19317687	.	T	C	0	5	5	0	0	5	0	0
15	19317747	.	C	T	2	2	4	0	0	4	0	0
15	19318382	.	G	A	2	5	7	0	1	8	0	0
15	19318545	.	G	T	8	5	13	0	0	13	0	0
15	19319077	.	T	A	1	2	3	0	0	3	0	0
15	19319150	.	A	G	4	0	4	0	7	11	0	0
15	19319342	.	C	T	19	12	31	0	0	31	0	0
15	19319376	.	C	T	12	10	22	0	0	22	0	0
15	19319613	.	A	G	3	10	13	0	0	13	0	0
15	19319666	.	A	G	6	1	7	0	4	11	0	0
15	19324911	.	G	A	0	3	3	0	3	6	0	0
15	19329908	.	G	A	8	7	15	0	1	16	0	0
15	19330144	.	C	T	10	3	13	0	0	13	0	0
15	19330408	.	C	T	9	6	15	0	1	16	0	0
15	19330607	.	T	A	9	4	13	0	0	13	0	0
15	19330652	.	A	G	3	0	3	0	6	9	0	0
15	19330897	.	A	C	2	5	7	0	1	8	0	0
15	19331011	.	C	A	4	5	9	0	0	9	0	0
15	19339789	.	T	A	1	1	2	0	0	2	0	0
15	19345530	.	G	T	3	0	3	0	0	3	0	0
15	19345614	.	C	T	1	3	4	0	1	5	0	0
15	19347821	.	C	T	5	13	18	0	0	18	0	0
15	19347878	.	G	T	10	10	20	0	0	20	0	0
15	19348275	.	C	T	8	4	12	0	1	13	0	0
15	19355138	.	G	A	1	1	2	0	0	2	0	0
15	19378097	.	A	G	1	2	3	0	0	3	0	0
15	19472290	.	G	A	3	3	6	0	0	6	0	0
15	19574919	.	C	T	1	2	3	0	0	3	0	0
15	19576879	.	A	G	0	1	1	0	0	1	0	0
15	19577066	.	C	T	4	2	6	0	0	6	0	0
15	19577367	.	C	A	1	4	5	0	0	5	0	0
15	19577377	.	T	C	0	2	2	0	0	2	0	0
15	19595782	.	G	A	6	6	12	0	2	14	0	0
15	19661619	.	A	T	4	9	13	0	0	13	0	0
15	19668105	.	C	T	1	1	2	0	2	4	0	0
15	19668276	.	C	T	0	8	8	0	3	11	0	0
15	19668294	.	T	G	3	10	13	0	0	13	0	0
15	19668354	.	A	G	4	6	10	0	1	11	0	0
15	19668534	.	A	G	5	4	9	0	0	9	0	0
15	19668558	.	G	A	7	6	13	0	0	13	0	0
15	19669146	.	T	C	2	0	2	0	0	2	0	0
15	19727897	.	T	C	1	2	3	0	0	3	0	0
15	19727899	.	T	C	1	2	3	0	0	3	0	0
15	19728127	.	A	T	9	8	17	0	1	18	0	0
15	19728131	.	A	T	10	8	18	0	0	18	0	0
15	19728307	.	C	T	14	29	43	0	3	46	0	0
15	19728638	.	A	G	20	19	39	0	4	43	0	0
15	19728853	.	T	A	7	7	14	0	0	14	0	0
15	19728989	.	A	C	17	8	25	0	1	26	0	0
15	19737755	.	C	T	0	1	1	0	1	2	0	0
15	19742655	.	T	C	4	10	14	0	1	15	0	0
15	19745764	.	C	A	0	4	4	0	4	8	0	0
15	19877897	.	A	G	2	0	2	0	2	4	0	0
15	19878747	.	C	T	1	1	2	0	0	2	0	0
15	19878805	.	T	A	3	3	6	0	0	6	0	0
15	19893465	.	A	G	8	0	8	0	11	19	0	0
15	19893876	.	G	T	0	5	5	0	3	8	0	0
15	19895285	.	A	G	8	8	16	0	1	17	0	0
15	19896072	.	C	A	10	13	23	0	0	23	0	0
15	19908340	.	T	A	4	5	9	0	0	9	0	0
15	19932674	.	G	A	1	14	15	0	21	36	0	0
15	20005863	.	T	A	10	12	22	0	1	23	0	0
15	20005943	.	A	G	6	6	12	0	1	13	0	0
15	20066656	.	A	T	4	6	10	0	0	10	0	0
15	20069165	.	T	C	0	3	3	0	0	3	0	0
15	20069201	.	G	A	2	4	6	0	0	6	0	0
15	20074138	.	G	A	12	7	19	0	0	19	0	0
15	20074261	.	T	A	12	13	25	0	1	26	0	0
15	20074627	.	A	G	0	2	2	0	0	2	0	0
15	20081806	.	T	G	3	7	10	0	3	13	0	0
15	20086508	.	C	A	1	0	1	0	0	1	0	0
15	20204960	.	A	G	3	2	5	0	0	5	0	0
15	20363005	.	C	G	4	2	6	0	0	6	0	0
15	20363063	.	T	G	3	3	6	0	0	6	0	0
15	20363079	.	A	C	4	3	7	0	0	7	0	0
15	20363373	.	C	T	1	3	4	0	0	4	0	0
15	20367662	.	C	T	1	2	3	0	0	3	0	0
15	20369562	.	G	A	1	2	3	0	0	3	0	0
15	20377946	.	C	T	2	6	8	0	0	8	0	0
15	20378302	.	C	T	3	0	3	0	0	3	0	0
15	20379860	.	C	T	4	8	12	0	0	12	0	0
15	20382472	.	C	T	3	1	4	0	0	4	0	0
15	20383150	.	C	T	8	2	10	0	0	10	0	0
15	20383967	.	G	T	10	8	18	0	0	18	0	0
15	20384310	.	A	G	8	13	21	0	3	24	0	0
15	20384539	.	A	G	7	0	7	0	7	14	0	0
15	20386212	.	A	G	12	7	19	0	0	19	0	0
15	20394672	.	T	C	6	12	18	0	1	19	0	0
15	20394788	.	G	A	0	13	13	0	10	24	1	0
15	20394877	.	G	A	11	16	27	0	3	30	0	0
15	20394915	.	G	A	0	17	17	0	13	30	0	0
15	20395141	.	G	A	0	16	16	0	11	27	0	0
15	20395528	.	C	T	0	3	3	0	1	4	0	0
15	20406270	.	A	C	6	10	16	0	1	17	0	0
15	20406413	.	C	T	0	6	6	0	9	15	0	0
15	20406484	.	G	C	1	7	8	0	2	10	0	0
15	20406712	.	C	T	1	3	4	0	0	4	0	0
15	20406721	.	G	T	1	3	4	0	0	4	0	0
15	20407026	.	T	A	1	2	3	0	0	3	0	0
15	20407045	.	G	A	3	2	5	0	0	5	0	0
15	20407407	.	C	T	2	0	2	0	0	2	0	0
15	20407938	.	G	T	2	4	6	0	1	7	0	0
15	20407951	.	G	T	3	4	7	0	0	7	0	0
15	20411321	.	G	A	2	2	4	0	0	4	0	0
15	20412107	.	G	T	3	5	8	0	0	8	0	0
15	20412171	.	G	C	7	10	17	0	0	17	0	0
15	20475817	.	A	G	5	3	8	0	0	8	0	0
15	20475865	.	G	A	4	9	13	0	1	14	0	0
15	20476016	.	C	G	6	9	15	0	0	15	0	0
15	20476058	.	A	G	11	10	21	0	0	21	0	0
15	20476075	.	A	G	13	10	23	0	0	23	0	0
15	20479056	.	A	G	6	7	13	0	0	13	0	0
15	20489854	.	C	T	2	4	6	0	0	6	0	0
15	20489875	.	G	A	2	4	6	0	0	6	0	0
15	20529343	.	A	T	1	1	2	0	0	2	0	0
15	20529346	.	C	A	0	2	2	0	0	2	0	0
15	20629658	.	T	C	1	0	1	0	0	1	0	0
15	20643476	.	G	A	0	4	4	0	1	5	0	0
15	20652744	.	A	G	4	7	11	0	1	12	0	0
15	20652787	.	G	A	12	8	20	0	0	20	0	0
15	20652813	.	A	T	14	8	22	0	1	23	0	0
15	20652955	.	A	G	18	25	43	0	3	46	0	0
15	20653048	.	A	T	21	14	35	0	0	35	0	0
15	20653074	.	T	A	19	4	23	0	1	24	0	0
15	20655888	.	A	C	0	0	0	0	1	1	0	0
15	20709058	.	G	A	15	9	24	0	0	24	0	0
15	20709292	.	A	C	14	19	33	0	0	33	0	0
15	20709340	.	G	C	15	19	34	0	0	34	0	0
15	20709490	.	A	G	8	19	27	0	3	30	0	0
15	20709925	.	G	A	14	19	33	0	1	34	0	0
15	20731452	.	G	T	0	2	2	0	0	2	0	0
15	20731512	.	A	T	6	4	10	0	0	10	0	0
15	20807548	.	C	T	1	3	4	0	1	5	0	0
15	20830840	.	C	T	1	2	3	0	0	3	0	0
15	20830937	.	A	G	1	3	4	0	0	4	0	0
15	20830965	.	G	A	1	3	4	0	0	4	0	0
15	20830981	.	A	G	2	3	5	0	0	5	0	0
15	20831091	.	T	C	5	5	10	0	0	10	0	0
15	20831105	.	C	T	2	1	3	0	1	4	0	0
15	20832831	.	C	T	9	8	17	0	1	18	0	0
15	20833018	.	A	G	3	0	3	0	1	4	0	0
15	20835105	.	T	C	3	3	6	0	0	6	0	0
15	20838334	.	C	T	0	3	3	0	1	4	0	0
15	20843256	.	T	C	1	3	4	0	0	4	0	0
15	20843348	.	C	T	1	1	2	0	1	3	0	0
15	20872763	.	T	C	1	0	1	0	0	1	0	0
15	20875296	.	C	T	2	1	3	0	1	4	0	0
15	20883185	.	A	T	7	9	16	0	1	17	0	0
15	20883238	.	C	A	2	3	5	0	1	6	0	0
15	20884503	.	T	G	4	0	4	0	4	8	0	0
15	20884551	.	T	C	4	2	6	0	0	6	0	0
15	20886090	.	T	C	3	3	6	0	1	7	0	0
15	20893300	.	C	A	4	5	9	0	1	10	0	0
15	20893320	.	C	A	12	0	12	0	1	13	0	0
15	20893481	.	A	G	10	6	16	0	1	17	0	0
15	20893592	.	C	T	13	4	17	0	0	17	0	0
15	20893644	.	A	G	11	7	18	0	2	20	0	0
15	20893920	.	T	A	4	6	10	0	0	10	0	0
15	20894129	.	C	G	14	14	28	0	0	28	0	0
15	20894177	.	C	A	17	15	32	0	1	33	0	0
15	20894464	.	T	C	16	23	39	0	1	40	0	0
15	20894604	.	C	T	13	11	24	0	1	25	0	0
15	20901009	.	C	T	21	19	40	0	1	41	0	0
15	20901261	.	G	T	16	22	38	0	2	40	0	0
15	20901358	.	A	G	26	20	46	0	1	47	0	0
15	20907648	.	A	G	1	1	2	0	1	3	0	0
15	20907651	.	C	T	1	1	2	0	0	2	0	0
15	20907958	.	C	T	7	4	11	0	0	11	0	0
15	20907970	.	C	T	0	7	7	0	7	14	0	0
15	20941485	.	A	T	6	8	14	0	1	15	0	0
15	20941492	.	T	A	9	4	13	0	0	13	0	0
15	20943064	.	T	C	4	3	7	0	0	7	0	0
15	20943072	.	G	A	4	5	9	0	0	9	0	0
15	20943248	.	G	T	6	3	9	0	1	10	0	0
15	20943651	.	T	C	5	7	12	0	0	12	0	0
15	20943760	.	T	A	8	9	17	0	1	18	0	0
15	20944004	.	T	A	3	2	5	0	0	5	0	0
15	20944005	.	G	T	3	2	5	0	0	5	0	0
15	20944217	.	C	A	3	5	8	0	0	8	0	0
15	20944313	.	T	A	4	4	8	0	0	8	0	0
15	20944562	.	G	A	2	8	10	0	0	10	0	0
15	20944577	.	C	G	4	8	12	0	1	13	0	0
15	20944856	.	G	A	11	5	16	0	0	16	0	0
15	20945060	.	C	T	2	3	5	0	0	5	0	0
15	20948139	.	G	C	1	3	4	0	0	4	0	0
15	20956305	.	A	C	3	0	3	0	1	4	0	0
15	20991950	.	C	T	2	1	3	0	0	3	0	0
15	21011911	.	C	T	3	2	5	0	0	5	0	0
15	21012238	.	G	A	1	0	1	0	0	1	0	0
15	21255145	.	T	C	2	1	3	0	0	3	0	0
15	21258288	.	C	T	4	3	7	0	0	7	0	0
15	21260930	.	A	T	1	3	4	0	0	4	0	0
15	21260966	.	T	G	2	2	4	0	0	4	0	0
15	21261161	.	T	G	1	3	4	0	0	4	0	0
15	21262268	.	C	T	8	5	13	0	1	14	0	0
15	21263036	.	G	A	2	3	5	0	0	6	1	0
15	21266018	.	A	G	3	1	4	0	0	4	0	0
15	21266586	.	T	C	0	1	1	0	0	1	0	0
15	21266588	.	C	T	0	1	1	0	0	1	0	0
15	21267514	.	A	G	0	0	0	0	3	3	0	0
15	21269869	.	A	T	1	2	3	0	0	3	0	0
15	21275486	.	T	C	0	3	3	0	0	3	0	0
15	21307477	.	C	T	3	3	6	0	0	6	0	0
15	21316996	.	A	T	1	0	1	0	0	1	0	0
15	21317192	.	G	A	1	0	1	0	0	1	0	0
15	21319739	.	T	A	1	3	4	0	0	4	0	0
15	21320097	.	T	C	4	4	8	0	0	8	0	0
15	21320329	.	A	G	7	4	11	0	0	11	0	0
15	21320475	.	A	T	16	6	22	0	0	22	0	0
15	21541201	.	C	T	9	6	15	0	0	15	0	0
15	21541620	.	C	T	5	6	11	4	0	15	0	0
15	21542210	.	G	C	9	0	9	0	7	16	0	0
15	21542542	.	T	C	14	19	33	0	0	33	0	0
15	21542559	.	C	A	9	19	28	1	1	30	0	0
15	21542884	.	C	A	0	14	14	0	15	29	0	0
15	21545866	.	C	T	5	5	10	0	1	11	0	0
15	21545921	.	C	T	0	16	16	0	15	31	0	0
15	21546399	.	A	G	2	3	5	0	0	5	0	0
15	21548403	.	C	T	4	8	12	0	0	12	0	0
15	21552410	.	T	A	0	1	1	0	0	1	0	0
15	21554115	.	G	A	1	0	1	0	0	1	0	0
15	21556036	.	C	T	1	2	3	0	3	6	0	0
15	21556193	.	A	G	2	0	2	0	0	2	0	0
15	21556274	.	G	A	8	4	12	0	0	12	0	0
15	21557122	.	A	T	2	4	6	0	0	6	0	0
15	21557403	.	G	C	2	0	2	0	0	2	0	0
15	21557418	.	C	T	0	0	0	0	2	2	0	0
15	21558334	.	A	C	0	4	4	0	0	4	0	0
15	21558380	.	G	A	1	5	6	0	0	6	0	0
15	21561817	.	A	G	0	1	1	0	0	1	0	0
15	21561823	.	G	A	0	1	1	0	0	1	0	0
15	21571206	.	G	A	1	0	1	0	0	1	0	0
15	21684510	.	C	T	3	3	6	0	0	6	0	0
15	21684546	.	T	A	4	4	8	0	0	8	0	0
15	21684558	.	C	G	6	3	9	0	0	9	0	0
15	21684701	.	T	C	3	4	7	0	1	8	0	0
15	21684704	.	T	G	4	3	7	0	0	7	0	0
15	21684933	.	A	G	13	11	24	0	1	25	0	0
15	21685195	.	T	A	15	15	30	0	0	30	0	0
15	21685217	.	C	T	1	14	15	0	14	29	0	0
15	21685357	.	G	A	20	13	33	0	2	35	0	0
15	21685418	.	C	T	22	16	38	0	1	39	0	0
15	21685484	.	A	G	18	9	27	0	0	27	0	0
15	21715339	.	C	T	7	3	10	0	0	10	0	0
15	21715381	.	G	A	5	2	7	0	0	7	0	0
15	21715508	.	A	G	1	8	9	0	1	10	0	0
15	21715943	.	T	A	1	2	3	0	1	4	0	0
15	21716307	.	C	T	0	3	3	0	0	3	0	0
15	21716308	.	C	T	0	3	3	0	0	3	0	0
15	21716476	.	C	G	0	2	2	0	1	3	0	0
15	21716760	.	T	A	1	7	8	0	0	8	0	0
15	21716778	.	G	A	1	4	5	0	3	8	0	0
15	21716964	.	A	G	1	0	1	0	2	3	0	0
15	21718884	.	T	C	1	2	3	0	0	3	0	0
15	21747981	.	T	C	2	9	11	0	0	11	0	0
15	21757433	.	C	T	13	12	25	0	0	25	0	0
15	21769619	.	T	C	6	7	13	0	0	13	0	0
15	21769640	.	G	A	7	13	20	0	1	21	0	0
15	21771835	.	A	T	24	21	45	0	0	45	0	0
15	21772073	.	T	C	28	24	52	0	4	56	0	0
15	21772112	.	T	C	34	22	56	0	0	56	0	0
15	21772174	.	T	C	24	25	49	0	3	52	0	0
15	21772208	.	T	C	18	24	42	0	2	44	0	0
15	21772689	.	C	A	19	26	45	0	2	47	0	0
15	21782020	.	G	A	17	22	39	0	1	40	0	0
15	21782028	.	G	A	16	21	37	0	3	40	0	0
15	21782057	.	T	C	18	22	40	0	0	40	0	0
15	21782154	.	C	A	0	13	13	0	12	25	0	0
15	21782171	.	G	A	9	14	23	0	1	24	0	0
15	21782238	.	A	G	13	8	21	0	1	22	0	0
15	21782385	.	G	T	5	7	12	0	0	12	0	0
15	21782946	.	C	G	12	13	25	0	1	26	0	0
15	21783681	.	G	A	10	10	20	0	0	20	0	0
15	21784042	.	G	T	15	12	27	0	2	29	0	0
15	21784226	.	T	C	11	1	12	0	24	36	0	0
15	21784352	.	T	C	1	2	3	0	0	3	0	0
15	21784525	.	C	G	0	1	1	0	3	4	0	0
15	21789819	.	G	T	3	2	5	0	1	6	0	0
15	21791872	.	G	T	11	8	19	0	1	20	0	0
15	21791878	.	C	T	0	8	8	0	10	18	0	0
15	21792220	.	C	T	0	6	6	0	6	12	0	0
15	21798394	.	T	C	6	7	13	0	0	13	0	0
15	21798447	.	T	C	3	6	9	0	1	10	0	0
15	21798540	.	G	T	2	2	4	0	0	4	0	0
15	21813451	.	G	A	3	1	4	0	0	4	0	0
15	21836607	.	A	G	2	1	3	0	0	3	0	0
15	22046568	.	T	C	3	2	5	0	0	5	0	0
15	22046647	.	T	C	11	3	14	0	0	14	0	0
15	22046914	.	A	C	2	3	5	0	0	5	0	0
15	22046954	.	T	C	4	0	4	0	3	7	0	0
15	22046965	.	G	A	3	3	6	0	0	6	0	0
15	22442992	.	A	G	7	0	7	0	1	8	0	0
15	22442994	.	G	A	0	0	0	0	8	8	0	0
15	23526809	.	A	G	0	0	0	0	2	2	0	0
15	23640678	.	A	C	5	0	5	0	31	36	0	0
15	23713679	.	T	G	0	3	3	0	0	3	0	0
15	23818110	.	G	A	7	2	9	0	0	9	0	0
15	24736413	.	A	G	6	6	12	0	1	13	0	0
15	25176512	.	G	A	7	2	9	0	0	9	0	0
15	25304653	.	T	G	4	2	6	0	6	12	0	0
15	25398375	.	A	T	0	6	6	0	1	7	0	0
15	25484052	.	A	G	4	3	7	0	0	7	0	0
15	25485394	.	A	G	2	2	4	0	0	4	0	0
15	26678932	.	T	A	1	13	14	0	0	14	0	0
15	27371330	.	G	A	1	2	3	0	2	5	0	0
15	28079317	.	T	C	7	2	9	0	0	9	0	0
15	30838502	.	A	G	15	1	16	0	2	18	0	0
15	30862848	.	T	C	14	6	20	0	1	21	0	0
15	31870694	.	G	A	2	1	3	0	0	3	0	0
15	31881873	.	G	A	0	4	4	0	3	7	0	0
15	31882342	.	C	T	1	2	3	0	0	3	0	0
15	31884219	.	A	C	1	2	3	0	0	3	0	0
15	31889005	.	T	G	1	6	7	0	0	7	0	0
15	31889086	.	A	G	0	5	5	0	0	5	0	0
15	31890902	.	T	G	5	5	10	0	0	10	0	0
15	31893536	.	A	C	3	4	7	0	0	7	0	0
15	31893599	.	C	T	0	1	1	0	0	1	0	0
15	31905040	.	G	A	17	11	28	0	1	29	0	0
15	31905097	.	A	G	5	7	12	0	3	15	0	0
15	31909454	.	A	C	16	7	23	0	1	24	0	0
15	31909819	.	G	A	0	2	2	0	5	7	0	0
15	32193922	.	A	T	1	2	3	0	0	3	0	0
15	32193961	.	T	G	1	0	1	0	4	5	0	0
15	32194223	.	A	T	2	2	4	0	0	4	0	0
15	32194286	.	G	A	2	2	4	0	0	4	0	0
15	32194630	.	C	A	1	3	4	0	0	4	0	0
15	32194945	.	C	A	1	3	4	0	0	4	0	0
15	32195020	.	C	T	3	3	6	0	0	6	0	0
15	32195432	.	G	A	3	2	5	0	0	5	0	0
15	32195521	.	T	C	3	3	6	0	1	7	0	0
15	32195718	.	G	A	2	5	7	0	0	7	0	0
15	32195729	.	A	G	3	2	5	0	0	5	0	0
15	32196363	.	A	T	2	4	6	0	0	6	0	0
15	32196472	.	A	C	4	1	5	0	0	5	0	0
15	32196475	.	G	A	0	1	1	0	4	5	0	0
15	32196613	.	T	C	2	2	4	0	1	5	0	0
15	32196615	.	G	T	0	3	3	0	2	5	0	0
15	32196731	.	A	C	1	5	6	0	0	6	0	0
15	32196752	.	T	A	1	4	5	0	1	6	0	0
15	32197001	.	G	C	2	2	4	0	0	4	0	0
15	32197458	.	T	C	1	1	2	0	1	3	0	0
15	32249188	.	G	A	11	16	27	0	1	28	0	0
15	32259056	.	G	A	11	9	20	0	0	20	0	0
15	32261461	.	G	C	0	13	13	0	7	20	0	0
15	32261464	.	T	C	15	6	21	0	0	21	0	0
15	32265889	.	T	C	17	12	29	0	0	29	0	0
15	32266557	.	A	T	9	13	22	0	0	22	0	0
15	32266921	.	G	A	0	15	15	0	13	28	0	0
15	32267078	.	A	G	7	7	14	0	1	15	0	0
15	32267120	.	C	A	2	3	5	0	1	6	0	0
15	32349975	.	A	G	11	2	13	0	1	14	0	0
15	32350000	.	A	G	9	3	12	0	0	12	0	0
15	32350070	.	A	G	10	7	17	0	0	17	0	0
15	32350116	.	G	T	9	6	15	0	0	15	0	0
15	32350517	.	A	G	13	4	17	0	0	17	0	0
15	32350550	.	A	G	11	7	18	0	0	18	0	0
15	32350568	.	A	G	12	6	18	0	0	18	0	0
15	32351294	.	A	G	12	12	24	0	1	25	0	0
15	32351409	.	A	G	12	10	22	0	1	23	0	0
15	32351476	.	A	G	4	7	11	1	0	12	0	0
15	32353825	.	C	A	8	3	11	0	0	11	0	0
15	32887798	.	A	G	3	4	7	0	1	8	0	0
15	32887816	.	A	G	3	3	6	0	1	7	0	0
15	32887858	.	A	G	3	9	12	0	0	12	0	0
15	33608123	.	T	A	1	2	3	0	2	5	0	0
15	33853701	.	C	T	2	4	6	0	0	6	0	0
15	33864152	.	A	G	4	10	14	0	0	14	0	0
15	33864266	.	G	A	3	7	10	0	0	10	0	0
15	33864585	.	G	A	4	7	11	0	0	11	0	0
15	33891825	.	G	A	17	7	24	0	3	27	0	0
15	33891826	.	G	A	17	9	26	0	1	27	0	0
15	33891869	.	G	T	12	7	19	0	1	20	0	0
15	33896117	.	G	T	19	8	27	0	2	29	0	0
15	33896177	.	T	C	15	20	35	0	0	35	0	0
15	33896213	.	T	C	16	1	17	0	20	37	0	0
15	33896303	.	T	A	20	11	31	0	2	33	0	0
15	33896306	.	A	G	12	20	32	0	0	32	0	0
15	33896832	.	T	C	11	10	21	0	0	21	0	0
15	33899556	.	C	G	8	5	13	0	0	13	0	0
15	33899808	.	T	A	9	12	21	0	1	22	0	0
15	33902388	.	C	G	0	10	10	0	6	16	0	0
15	33910546	.	G	C	5	3	8	0	0	8	0	0
15	33970841	.	A	G	17	0	17	0	21	38	0	0
15	33970854	.	C	T	14	21	35	0	2	37	0	0
15	33970907	.	C	T	2	4	6	0	1	7	0	0
15	33971097	.	G	C	18	13	31	0	3	34	0	0
15	33977716	.	A	T	16	19	35	0	2	37	0	0
15	33977760	.	A	G	13	0	13	0	19	32	0	0
15	33977942	.	A	C	15	9	24	0	0	24	0	0
15	33978526	.	A	T	2	2	4	0	0	4	0	0
15	34074558	.	C	T	5	6	11	0	1	12	0	0
15	34174532	.	T	A	16	6	22	0	0	22	0	0
15	34174568	.	T	A	12	6	18	0	1	19	0	0
15	34174635	.	T	C	14	4	18	0	2	20	0	0
15	34175101	.	T	C	18	19	37	0	4	41	0	0
15	34175359	.	G	A	12	6	18	0	0	18	0	0
15	34175426	.	T	A	6	9	15	0	1	16	0	0
15	34175917	.	C	T	4	2	6	0	0	6	0	0
15	34175929	.	C	T	4	5	9	0	1	10	0	0
15	34176203	.	A	T	12	6	18	0	2	20	0	0
15	34176214	.	C	T	7	12	19	0	0	19	0	0
15	34176379	.	A	C	7	7	14	0	0	14	0	0
15	34176841	.	A	T	6	14	20	0	0	20	0	0
15	34176993	.	G	A	6	10	16	0	1	17	0	0
15	34182135	.	G	A	0	2	2	0	0	2	0	0
15	34189452	.	G	A	10	7	17	0	0	17	0	0
15	34215835	.	A	T	3	4	7	0	0	7	0	0
15	34334909	.	A	T	1	2	3	0	0	3	0	0
15	34534245	.	C	G	0	2	2	0	0	2	0	0
15	34534265	.	C	T	3	0	3	0	0	3	0	0
15	34558428	.	G	A	5	3	8	0	0	8	0	0
15	34558438	.	G	T	2	3	5	0	1	6	0	0
15	34573337	.	C	T	2	3	5	0	0	5	0	0
15	34573343	.	A	G	3	3	6	0	0	6	0	0
15	34573597	.	A	T	1	6	7	0	0	7	0	0
15	34573664	.	G	T	2	3	5	0	0	5	0	0
15	34573952	.	T	A	1	1	2	0	0	2	0	0
15	34573959	.	A	T	2	2	4	0	0	4	0	0
15	34574116	.	G	A	9	15	24	0	2	26	0	0
15	34586304	.	A	G	0	1	1	0	0	1	0	0
15	34590772	.	A	G	1	4	5	0	0	5	0	0
15	34618456	.	T	G	6	13	19	0	1	20	0	0
15	34618669	.	A	T	17	12	29	0	2	31	0	0
15	34618906	.	C	A	8	17	25	0	0	25	0	0
15	34618948	.	T	G	19	16	35	0	2	37	0	0
15	34618958	.	G	A	19	17	36	0	2	38	0	0
15	34621868	.	G	A	9	10	19	0	0	19	0	0
15	34621875	.	G	A	11	11	22	0	1	23	0	0
15	34627792	.	T	A	1	0	1	0	1	2	0	0
15	34627874	.	T	C	11	4	15	0	0	15	0	0
15	34635321	.	C	A	6	3	9	0	1	10	0	0
15	34635336	.	A	C	7	0	7	0	3	10	0	0
15	34637582	.	C	T	0	1	1	0	1	2	0	0
15	34638847	.	C	T	0	5	5	0	5	10	0	0
15	34641384	.	G	A	2	0	2	0	1	3	0	0
15	34657370	.	C	T	0	1	1	0	0	1	0	0
15	35091591	.	A	G	3	3	6	0	0	6	0	0
15	35102539	.	T	C	1	3	4	0	0	4	0	0
15	35156554	.	T	G	2	2	4	0	0	4	0	0
15	35156573	.	A	T	1	1	2	0	0	3	1	0
15	35157052	.	T	A	6	8	14	0	1	15	0	0
15	35157054	.	G	A	6	8	14	0	1	15	0	0
15	35158661	.	T	G	0	6	6	0	0	6	0	0
15	35163492	.	T	G	1	0	1	0	0	1	0	0
15	35187682	.	C	T	0	1	1	0	0	1	0	0
15	35212177	.	G	A	4	5	9	0	0	9	0	0
15	35212386	.	T	C	3	4	7	0	0	7	0	0
15	35212418	.	G	C	4	2	6	0	0	6	0	0
15	35214784	.	T	A	8	10	18	0	0	18	0	0
15	35214859	.	A	C	9	0	9	0	13	22	0	0
15	35214901	.	G	A	6	12	18	0	1	19	0	0
15	35217475	.	T	C	3	5	8	0	0	8	0	0
15	35217487	.	C	A	1	6	7	0	4	11	0	0
15	35221304	.	A	T	3	4	7	0	0	7	0	0
15	35224269	.	G	C	4	6	10	0	0	10	0	0
15	35227221	.	A	T	19	2	21	0	2	23	0	0
15	35247678	.	A	T	11	11	22	0	3	25	0	0
15	35247687	.	A	G	14	15	29	0	0	29	0	0
15	35247729	.	A	G	18	12	30	0	0	30	0	0
15	35247762	.	T	C	17	10	27	0	1	28	0	0
15	35709983	.	G	A	0	2	2	0	0	2	0	0
15	35709988	.	C	T	2	0	2	0	0	2	0	0
15	35718398	.	A	C	2	4	6	0	0	6	0	0
15	35737680	.	T	C	2	4	6	0	0	6	0	0
15	35760970	.	G	A	3	3	6	0	0	6	0	0
15	35761024	.	T	C	8	5	13	0	1	14	0	0
15	35761027	.	A	G	8	6	14	0	0	14	0	0
15	35761126	.	G	A	0	6	6	0	6	12	0	0
15	35761516	.	T	C	2	3	5	0	0	5	0	0
15	35889139	.	G	A	1	2	3	0	0	3	0	0
15	35889443	.	G	T	1	1	2	0	0	2	0	0
15	35889474	.	G	A	3	1	4	0	0	4	0	0
15	35889516	.	A	C	1	4	5	0	1	6	0	0
15	35889517	.	C	A	0	4	4	0	2	6	0	0
15	35889691	.	G	A	3	2	5	0	0	5	0	0
15	35889865	.	A	G	8	5	13	0	1	14	0	0
15	35890046	.	G	A	7	7	14	0	0	14	0	0
15	35890148	.	C	T	3	2	5	0	0	5	0	0
15	35890419	.	T	G	2	2	4	0	0	4	0	0
15	35892879	.	T	C	0	1	1	0	1	2	0	0
15	36145355	.	C	A	1	1	2	0	0	2	0	0
15	37459369	.	T	C	3	5	8	0	0	8	0	0
15	37459438	.	T	C	3	0	3	0	2	5	0	0
15	37459443	.	T	C	1	4	5	0	0	5	0	0
15	37459979	.	T	C	2	6	8	0	0	8	0	0
15	37460217	.	T	C	1	2	3	0	0	3	0	0
15	37460405	.	T	C	3	2	5	0	0	5	0	0
15	37460670	.	A	G	5	2	7	0	0	7	0	0
15	37475726	.	G	A	1	0	1	0	0	1	0	0
15	38892060	.	T	C	2	4	6	0	0	6	0	0
15	39128662	.	C	T	6	2	8	0	0	8	0	0
15	39140121	.	C	A	10	5	15	0	0	15	0	0
15	39140568	.	G	A	0	0	0	0	1	1	0	0
15	39141465	.	T	C	1	1	2	0	0	2	0	0
15	39208133	.	C	A	19	12	31	0	0	31	0	0
15	39208150	.	C	T	18	11	29	0	1	30	0	0
15	39208201	.	C	A	15	11	26	0	1	27	0	0
15	39208211	.	C	T	13	10	23	0	1	24	0	0
15	39208258	.	C	T	16	12	28	0	0	28	0	0
15	39228174	.	A	G	15	18	33	0	2	35	0	0
15	39278501	.	G	T	10	7	17	0	0	17	0	0
15	39281923	.	A	G	12	10	22	0	3	25	0	0
15	39282007	.	G	C	14	1	15	0	13	28	0	0
15	39282070	.	A	G	5	6	11	0	0	11	0	0
15	39282091	.	G	A	0	2	2	0	1	3	0	0
15	39294391	.	C	T	14	12	26	0	1	27	0	0
15	39296706	.	A	G	5	10	15	0	0	15	0	0
15	39297051	.	G	A	13	9	22	0	1	23	0	0
15	39297081	.	A	G	2	8	10	0	1	11	0	0
15	39305598	.	G	A	1	2	3	0	0	3	0	0
15	39326986	.	C	T	3	2	5	0	0	5	0	0
15	39339460	.	T	A	1	4	5	0	1	6	0	0
15	39345641	.	G	A	2	7	9	0	0	9	0	0
15	39359522	.	A	T	0	1	1	0	0	1	0	0
15	39368952	.	A	C	1	1	2	0	0	2	0	0
15	39967275	.	G	A	13	13	26	0	0	26	0	0
15	39969923	.	T	G	10	22	32	0	1	33	0	0
15	39987655	.	C	T	1	1	2	0	0	2	0	0
15	39987691	.	T	C	6	4	10	0	0	10	0	0
15	40000966	.	C	A	3	4	7	0	0	7	0	0
15	40000981	.	A	T	3	4	7	0	0	7	0	0
15	40002242	.	C	T	3	3	6	0	0	6	0	0
15	40002319	.	C	T	13	7	20	0	1	21	0	0
15	40002325	.	C	T	12	8	20	0	1	21	0	0
15	40002534	.	A	T	4	10	14	0	0	14	0	0
15	40005279	.	C	T	5	6	11	0	0	11	0	0
15	40005297	.	A	C	8	4	12	0	2	14	0	0
15	40005318	.	T	A	3	11	14	0	0	14	0	0
15	40005466	.	C	T	11	12	23	0	2	25	0	0
15	40005545	.	T	C	10	15	25	0	5	30	0	0
15	40006090	.	A	C	8	15	23	0	0	23	0	0
15	40008449	.	C	T	10	14	24	0	0	24	0	0
15	40008498	.	C	T	12	15	27	0	0	27	0	0
15	40008544	.	C	A	17	26	43	0	2	45	0	0
15	40018239	.	G	A	0	13	13	0	17	30	0	0
15	40018290	.	C	T	5	3	8	0	1	9	0	0
15	40027138	.	C	T	17	31	48	0	1	49	0	0
15	40027279	.	T	C	45	29	74	0	0	74	0	0
15	40027484	.	T	G	19	1	20	0	37	57	0	0
15	40027540	.	A	C	25	35	60	0	4	64	0	0
15	40027717	.	A	G	29	25	54	0	2	56	0	0
15	40028457	.	T	G	32	32	64	0	3	67	0	0
15	40028568	.	G	A	23	26	49	0	1	50	0	0
15	40028574	.	A	G	21	26	47	0	5	52	0	0
15	40091068	.	C	T	5	6	11	0	0	11	0	0
15	40099812	.	C	T	7	4	11	0	0	11	0	0
15	40099844	.	T	C	4	2	6	0	0	6	0	0
15	40104028	.	T	C	4	1	5	0	0	5	0	0
15	40108886	.	T	C	5	6	11	0	0	11	0	0
15	40108898	.	C	T	4	4	8	0	0	8	0	0
15	40115610	.	A	T	7	1	8	0	0	8	0	0
15	40115676	.	C	T	6	8	14	0	1	15	0	0
15	40122221	.	A	G	4	3	7	0	0	7	0	0
15	40122625	.	G	A	9	5	14	0	0	14	0	0
15	40126698	.	A	G	10	0	10	0	8	18	0	0
15	40128979	.	C	G	18	15	33	0	1	34	0	0
15	40129543	.	G	C	18	12	30	0	1	31	0	0
15	40129594	.	T	G	14	17	31	0	1	32	0	0
15	40129604	.	A	T	12	19	31	0	2	33	0	0
15	40129810	.	A	C	9	7	16	0	1	17	0	0
15	40130181	.	G	A	0	10	10	0	10	20	0	0
15	40130208	.	G	A	6	10	16	0	1	17	0	0
15	40130362	.	T	C	9	10	19	0	2	21	0	0
15	40130389	.	A	G	10	7	17	0	1	18	0	0
15	40130866	.	A	G	18	8	26	0	1	27	0	0
15	40131001	.	G	A	0	7	7	0	5	12	0	0
15	40131060	.	A	G	9	10	19	0	1	20	0	0
15	40131112	.	C	A	11	16	27	0	0	27	0	0
15	40131139	.	T	A	17	16	33	0	0	33	0	0
15	40131157	.	A	G	13	16	29	0	1	30	0	0
15	40131216	.	G	A	12	3	15	0	0	15	0	0
15	40131232	.	C	T	12	5	17	0	0	17	0	0
15	40131276	.	C	G	20	11	31	0	0	31	0	0
15	40131297	.	C	G	24	11	35	0	0	35	0	0
15	40131316	.	C	A	26	8	34	0	3	37	0	0
15	40131363	.	G	T	1	15	16	0	19	35	0	0
15	40131498	.	A	G	8	0	8	0	25	33	0	0
15	40131500	.	A	G	7	25	32	0	1	33	0	0
15	40131547	.	T	C	9	21	30	0	1	31	0	0
15	40131560	.	T	A	10	18	28	0	0	28	0	0
15	40131586	.	C	T	10	23	33	0	1	34	0	0
15	40131619	.	T	C	7	34	41	0	0	41	0	0
15	40131624	.	T	A	7	33	40	0	0	40	0	0
15	40131769	.	T	C	16	8	24	0	4	28	0	0
15	40202354	.	T	G	20	16	36	0	1	37	0	0
15	40202393	.	C	T	6	6	12	0	1	13	0	0
15	40211507	.	T	C	2	7	9	0	2	11	0	0
15	40211591	.	A	C	25	30	55	0	3	58	0	0
15	40211618	.	A	G	24	2	26	0	28	54	0	0
15	40211741	.	C	G	26	14	40	0	1	41	0	0
15	40211954	.	G	T	7	11	18	0	0	18	0	0
15	40217590	.	T	C	2	5	7	0	0	7	0	0
15	40217611	.	T	C	3	2	5	0	0	5	0	0
15	40877098	.	G	A	0	0	0	0	2	2	0	0
15	40894385	.	T	A	1	3	4	0	0	4	0	0
15	40930419	.	G	A	1	3	4	0	0	4	0	0
15	40930455	.	G	T	0	3	3	0	1	4	0	0
15	40933339	.	T	C	3	1	4	0	0	4	0	0
15	40938119	.	G	A	3	6	9	0	0	9	0	0
15	40938305	.	C	T	1	4	5	0	0	5	0	0
15	40938498	.	T	C	3	3	6	0	0	6	0	0
15	40941322	.	G	A	2	5	7	0	0	7	0	0
15	40952226	.	A	G	2	1	3	0	0	3	0	0
15	40962160	.	T	C	5	5	10	0	0	10	0	0
15	40962186	.	C	T	4	4	8	0	1	9	0	0
15	40988189	.	T	C	8	5	13	0	3	16	0	0
15	40988228	.	C	T	14	5	19	0	1	20	0	0
15	40988565	.	A	G	10	8	18	0	0	18	0	0
15	40989053	.	T	G	2	3	5	0	1	6	0	0
15	40989320	.	C	G	3	0	3	0	2	5	0	0
15	40989327	.	A	G	3	2	5	0	0	5	0	0
15	40989614	.	C	T	4	2	6	0	0	6	0	0
15	40989690	.	A	G	7	4	11	0	0	11	0	0
15	40989801	.	A	G	7	0	7	0	5	12	0	0
15	41170289	.	A	G	10	18	28	0	0	28	0	0
15	41170710	.	G	A	11	16	27	0	0	27	0	0
15	41170992	.	G	A	12	14	26	0	1	27	0	0
15	41171081	.	T	C	14	0	14	0	13	27	0	0
15	41171135	.	A	G	5	9	14	0	1	15	0	0
15	41171335	.	A	T	4	8	12	0	2	14	0	0
15	41171448	.	A	C	14	16	30	0	1	31	0	0
15	41171471	.	G	T	11	17	28	0	1	29	0	0
15	41171516	.	C	A	0	14	14	0	20	34	0	0
15	41172103	.	G	A	5	9	14	0	0	14	0	0
15	41172303	.	G	T	6	1	7	0	0	7	0	0
15	41172325	.	G	T	5	4	9	0	0	9	0	0
15	41172427	.	T	C	2	2	4	0	0	4	0	0
15	41172731	.	G	A	1	1	2	0	1	3	0	0
15	41172745	.	C	T	1	2	3	0	0	3	0	0
15	41172801	.	G	C	3	4	7	0	0	7	0	0
15	41172893	.	A	C	11	2	13	0	0	13	0	0
15	41172904	.	G	C	12	3	15	0	0	15	0	0
15	41173093	.	A	T	8	4	12	0	0	12	0	0
15	41173326	.	C	T	11	10	21	0	2	23	0	0
15	41173620	.	G	A	6	2	8	0	0	8	0	0
15	41695633	.	A	G	2	2	4	0	0	4	0	0
15	42551067	.	G	A	0	9	9	0	0	9	0	0
15	42933283	.	C	T	1	2	3	0	0	3	0	0
15	42933343	.	G	A	0	2	2	0	1	3	0	0
15	42958701	.	C	T	4	2	6	0	0	6	0	0
15	42976197	.	C	G	1	4	5	0	0	5	0	0
15	42976368	.	C	T	1	3	4	0	0	4	0	0
15	42976371	.	C	A	0	2	2	0	1	3	0	0
15	42981069	.	C	T	6	7	13	0	0	13	0	0
15	42981137	.	C	A	4	5	9	0	0	9	0	0
15	42981223	.	A	G	6	5	11	0	0	11	0	0
15	42981281	.	A	T	2	4	6	0	0	6	0	0
15	42981321	.	G	A	4	4	8	0	0	8	0	0
15	43073941	.	C	T	0	1	1	0	1	2	0	0
15	43604224	.	G	A	5	6	11	0	0	11	0	0
15	43604903	.	C	G	3	7	10	0	0	10	0	0
15	43604928	.	A	G	1	6	7	0	0	7	0	0
15	43604988	.	G	C	0	2	2	0	1	3	0	0
15	43604996	.	A	G	1	2	3	0	0	3	0	0
15	43605309	.	G	T	1	3	4	0	0	4	0	0
15	43605337	.	G	A	3	2	5	0	0	5	0	0
15	43663061	.	C	T	0	2	2	0	1	3	0	0
15	43917471	.	C	T	0	1	1	0	0	1	0	0
15	43931161	.	C	T	0	1	1	0	0	1	0	0
15	43936724	.	C	A	0	1	1	0	1	2	0	0
15	43982146	.	T	C	1	6	7	0	0	7	0	0
15	43982517	.	T	C	0	2	2	0	1	3	0	0
15	43983171	.	A	G	1	2	3	0	0	3	0	0
15	43983585	.	G	A	3	2	5	0	0	5	0	0
15	43984470	.	T	C	3	2	5	0	0	5	0	0
15	43984495	.	C	A	2	2	4	0	0	4	0	0
15	44072776	.	T	C	0	0	0	0	2	2	0	0
15	44072782	.	G	A	1	0	1	0	0	1	0	0
15	44074653	.	A	G	1	0	1	0	1	2	0	0
15	44075125	.	C	T	0	5	5	0	8	13	0	0
15	44077766	.	A	T	4	7	11	0	0	11	0	0
15	44140360	.	G	A	2	3	5	0	0	5	0	0
15	44140458	.	G	A	0	3	3	0	4	7	0	0
15	44140546	.	T	C	3	3	6	0	0	6	0	0
15	44140583	.	C	T	4	3	7	0	0	7	0	0
15	44140716	.	C	T	3	2	5	0	0	5	0	0
15	44140780	.	A	G	4	2	6	0	0	6	0	0
15	44140991	.	T	C	3	2	5	0	0	5	0	0
15	44141311	.	A	G	3	3	6	0	1	7	0	0
15	44141644	.	A	C	2	4	6	0	0	6	0	0
15	44209147	.	T	G	2	1	3	0	0	3	0	0
15	44252374	.	T	C	1	0	1	0	1	2	0	0
15	44255001	.	G	A	2	1	3	0	1	4	0	0
15	44255130	.	A	T	6	5	11	0	1	12	0	0
15	44255212	.	A	C	3	5	8	0	0	8	0	0
15	44255467	.	C	T	2	4	6	0	0	6	0	0
15	44255473	.	T	C	2	4	6	0	0	6	0	0
15	44255503	.	A	T	3	3	6	0	0	6	0	0
15	44283812	.	A	G	0	2	2	0	0	2	0	0
15	44290546	.	C	T	2	3	5	0	0	5	0	0
15	44295044	.	G	A	3	4	7	0	0	7	0	0
15	44323436	.	G	A	0	3	3	0	3	6	0	0
15	44323442	.	G	A	3	3	6	0	0	6	0	0
15	44336923	.	A	T	5	6	11	0	0	11	0	0
15	44340093	.	C	T	0	1	1	0	0	1	0	0
15	44371058	.	T	C	8	5	13	0	0	13	0	0
15	44371076	.	C	T	8	8	16	0	0	16	0	0
15	44371129	.	C	T	7	7	14	0	0	14	0	0
15	44371289	.	C	T	6	6	12	0	0	12	0	0
15	44371484	.	T	C	3	6	9	0	0	9	0	0
15	44384728	.	C	T	7	3	10	0	0	10	0	0
15	44385117	.	T	C	5	3	8	0	0	8	0	0
15	44440352	.	G	A	2	2	4	0	0	4	0	0
15	44445243	.	C	T	9	5	14	0	1	15	0	0
15	44465352	.	G	A	3	2	5	0	0	5	0	0
15	44475020	.	G	A	0	2	2	0	0	2	0	0
15	44475038	.	C	T	1	1	2	0	0	2	0	0
15	44499653	.	T	A	23	24	47	0	0	47	0	0
15	44530288	.	T	C	14	0	14	0	10	24	0	0
15	44534976	.	G	A	6	11	17	0	0	17	0	0
15	44559576	.	C	G	9	9	18	0	0	18	0	0
15	44559636	.	T	C	7	0	7	0	8	15	0	0
15	44559646	.	T	A	7	5	12	0	0	12	0	0
15	44560414	.	T	G	8	9	17	0	0	17	0	0
15	44565727	.	T	A	1	1	2	0	0	2	0	0
15	44646664	.	G	A	10	5	15	0	0	15	0	0
15	44647485	.	A	G	1	1	2	0	0	2	0	0
15	44660651	.	C	T	2	3	5	0	1	6	0	0
15	44663021	.	G	A	4	3	7	0	0	7	0	0
15	44676962	.	T	C	1	0	1	0	3	4	0	0
15	44676968	.	G	A	4	1	5	0	0	5	0	0
15	44714650	.	A	G	1	1	2	0	0	2	0	0
15	44717704	.	A	G	3	5	8	0	0	8	0	0
15	44721553	.	G	A	1	1	2	0	0	2	0	0
15	44721559	.	G	A	1	1	2	0	0	2	0	0
15	44755886	.	C	T	0	6	6	0	2	8	0	0
15	45088596	.	C	T	0	2	2	0	2	4	0	0
15	45103853	.	C	A	2	1	3	0	0	3	0	0
15	45122487	.	T	G	1	0	1	0	0	1	0	0
15	45129375	.	C	T	0	1	1	0	1	2	0	0
15	45418610	.	G	A	24	12	36	0	2	38	0	0
15	45510169	.	T	A	11	12	23	0	4	27	0	0
15	45528067	.	C	A	1	2	3	0	0	3	0	0
15	45544687	.	C	T	6	4	10	0	0	10	0	0
15	45544759	.	C	A	2	0	2	0	0	2	0	0
15	45555001	.	G	A	0	1	1	0	0	1	0	0
15	45555208	.	A	T	1	3	4	0	0	4	0	0
15	45591739	.	G	C	7	9	16	0	0	16	0	0
15	45591753	.	C	G	6	10	16	0	1	17	0	0
15	45595456	.	A	T	4	1	5	0	0	5	0	0
15	45602730	.	T	C	6	9	15	0	2	17	0	0
15	45602878	.	G	A	4	3	7	0	2	9	0	0
15	45612497	.	G	A	0	4	4	0	3	7	0	0
15	45621750	.	C	T	0	1	1	0	0	1	0	0
15	45628074	.	G	A	8	4	12	0	0	12	0	0
15	45634793	.	G	A	15	13	28	0	3	31	0	0
15	45634864	.	T	G	14	4	18	0	2	20	0	0
15	45634865	.	C	T	14	3	17	0	3	20	0	0
15	45634995	.	T	C	2	5	7	0	0	7	0	0
15	45635375	.	A	G	3	4	7	0	0	7	0	0
15	45635848	.	C	T	10	8	18	0	1	19	0	0
15	45635952	.	T	C	12	6	18	0	0	18	0	0
15	45635999	.	G	A	7	11	18	0	2	20	0	0
15	45636504	.	G	T	8	3	11	0	0	11	0	0
15	45637224	.	A	G	11	15	26	0	1	27	0	0
15	45637406	.	C	T	4	6	10	0	1	11	0	0
15	45662839	.	G	T	1	2	3	0	0	3	0	0
15	45994139	.	G	T	3	5	8	0	0	8	0	0
15	45994177	.	C	T	3	4	7	0	0	7	0	0
15	46108618	.	G	A	0	2	2	0	3	5	0	0
15	46108696	.	T	C	2	7	9	0	0	9	0	0
15	46108922	.	A	G	1	0	1	0	0	1	0	0
15	46111047	.	T	A	4	2	6	0	0	6	0	0
15	46111152	.	A	G	6	0	6	0	3	9	0	0
15	46111254	.	A	G	6	5	11	0	0	11	0	0
15	46111410	.	A	G	6	4	10	0	1	11	0	0
15	46116133	.	G	A	4	3	7	0	0	7	0	0
15	46116136	.	T	G	4	0	4	0	3	7	0	0
15	46116352	.	A	G	3	15	18	0	3	21	0	0
15	46643768	.	T	C	6	14	20	0	0	20	0	0
15	46649525	.	A	G	10	11	21	0	1	22	0	0
15	46652124	.	A	G	9	7	16	0	1	17	0	0
15	46662143	.	C	T	6	3	9	0	1	10	0	0
15	46662353	.	T	C	14	8	22	0	0	22	0	0
15	46666181	.	T	C	10	0	10	0	11	21	0	0
15	46687234	.	T	C	1	0	1	0	1	2	0	0
15	46687341	.	T	G	0	2	2	0	0	2	0	0
15	46691237	.	A	G	1	2	3	0	0	3	0	0
15	46722863	.	G	A	2	2	4	0	0	4	0	0
15	46723744	.	C	A	0	1	1	0	0	1	0	0
15	46726371	.	T	C	0	3	3	0	0	3	0	0
15	46727382	.	G	A	1	1	2	0	0	2	0	0
15	46794573	.	A	G	1	1	2	0	0	2	0	0
15	47107256	.	A	G	1	1	2	0	0	2	0	0
15	47113654	.	T	G	0	3	3	0	0	3	0	0
15	47336295	.	G	A	8	7	15	0	0	15	0	0
15	47386982	.	T	A	2	10	12	0	0	12	0	0
15	47410231	.	C	A	1	2	3	0	1	4	0	0
15	47418607	.	G	A	0	5	5	0	5	10	0	0
15	47418627	.	G	A	4	5	9	0	1	10	0	0
15	47419090	.	G	A	3	11	14	0	20	34	0	0
15	47419096	.	C	T	20	14	34	0	0	34	0	0
15	47419240	.	C	T	15	16	31	0	2	33	0	0
15	47419394	.	C	T	9	17	26	0	1	27	0	0
15	47419395	.	A	T	9	17	26	0	1	27	0	0
15	47420838	.	T	A	29	14	43	0	3	46	0	0
15	47421203	.	T	C	13	21	34	0	0	34	0	0
15	47421329	.	A	G	12	6	18	0	1	19	0	0
15	47421669	.	C	T	20	17	37	0	5	42	0	0
15	47421675	.	G	C	16	23	39	0	0	39	0	0
15	47448053	.	T	C	2	2	4	0	0	4	0	0
15	47448596	.	G	C	2	3	5	0	0	5	0	0
15	47448703	.	G	A	2	2	4	0	0	4	0	0
15	47452875	.	G	A	2	6	8	0	0	8	0	0
15	47453236	.	C	T	3	4	7	0	1	8	0	0
15	47453251	.	A	T	3	2	5	0	0	5	0	0
15	47830665	.	C	T	1	4	5	0	0	5	0	0
15	47830783	.	C	T	3	3	6	0	1	7	0	0
15	47830837	.	G	T	2	2	4	0	0	4	0	0
15	47830973	.	C	A	9	5	14	0	1	15	0	0
15	47831096	.	C	T	6	14	20	0	0	20	0	0
15	47831195	.	G	C	10	4	14	0	0	14	0	0
15	47831249	.	C	T	4	5	9	0	1	10	0	0
15	47831265	.	T	A	4	5	9	0	0	9	0	0
15	47831495	.	C	G	10	12	22	0	0	22	0	0
15	47831511	.	C	T	1	12	13	0	11	24	0	0
15	47831565	.	C	A	16	18	34	0	1	35	0	0
15	47831765	.	G	A	1	2	3	0	0	3	0	0
15	47832681	.	G	A	2	2	4	0	0	4	0	0
15	47832930	.	C	T	5	8	13	0	1	14	0	0
15	47832931	.	C	T	0	8	8	0	6	14	0	0
15	47833083	.	G	A	8	6	14	0	0	14	0	0
15	47833392	.	G	A	11	4	15	0	0	15	0	0
15	47833395	.	C	T	0	4	4	0	11	15	0	0
15	47833662	.	C	T	8	4	12	0	0	12	0	0
15	47833814	.	C	T	5	6	11	0	0	11	0	0
15	47833875	.	A	G	0	2	2	0	0	2	0	0
15	47834202	.	T	C	4	0	4	0	4	8	0	0
15	47834327	.	C	G	4	3	7	0	1	8	0	0
15	47834487	.	C	T	0	3	3	0	6	9	0	0
15	47834559	.	G	A	2	3	5	0	0	5	0	0
15	47845908	.	A	G	1	1	2	0	0	2	0	0
15	47847180	.	T	C	2	0	2	0	6	8	0	0
15	47847373	.	G	A	5	3	8	0	0	8	0	0
15	47848495	.	C	T	23	26	49	0	0	49	0	0
15	47851205	.	T	A	33	37	70	0	1	71	0	0
15	47851342	.	C	G	51	13	64	0	3	67	0	0
15	47851455	.	T	G	29	33	62	0	3	65	0	0
15	47851486	.	G	A	23	37	60	0	3	63	0	0
15	47851522	.	C	T	1	40	41	0	27	68	0	0
15	47851751	.	A	G	33	24	57	0	0	57	0	0
15	47851828	.	G	A	23	20	43	0	1	44	0	0
15	47851978	.	C	T	10	4	14	0	1	15	0	0
15	47851979	.	A	G	9	5	14	0	1	15	0	0
15	47852049	.	G	T	11	13	24	0	1	25	0	0
15	47855085	.	A	G	6	19	25	1	3	29	0	0
15	47855169	.	G	A	17	4	21	0	0	21	0	0
15	47856351	.	T	C	5	1	6	16	8	30	0	0
15	47856418	.	T	C	4	4	8	0	0	8	0	0
15	47860443	.	C	T	0	15	15	0	23	38	0	0
16	226131	.	A	G	23	6	29	0	1	30	0	0
16	226133	.	A	G	15	14	29	0	1	30	0	0
16	815859	.	C	T	6	5	11	0	0	11	0	0
16	815967	.	G	A	9	14	23	0	0	23	0	0
16	816096	.	A	G	10	16	26	0	2	28	0	0
16	817431	.	T	C	1	0	1	0	0	1	0	0
16	1199273	.	C	T	0	3	3	0	3	6	0	0
16	1199324	.	C	T	1	2	3	0	1	4	0	0
16	1199357	.	T	C	0	2	2	0	0	2	0	0
16	1199699	.	C	T	2	1	3	0	0	3	0	0
16	1199740	.	A	G	2	2	4	0	0	4	0	0
16	1199741	.	C	T	2	2	4	0	0	4	0	0
16	1205135	.	G	A	3	3	6	0	0	6	0	0
16	1207124	.	C	T	1	3	4	0	0	4	0	0
16	1207149	.	T	A	2	2	4	0	2	6	0	0
16	1207227	.	G	A	9	8	17	0	0	17	0	0
16	1207948	.	C	G	2	2	4	0	0	4	0	0
16	1209528	.	C	T	6	6	12	0	1	13	0	0
16	1210280	.	G	A	8	6	14	0	0	14	0	0
16	1210403	.	C	T	14	13	27	0	1	28	0	0
16	1228093	.	A	C	8	8	16	0	0	16	0	0
16	1234138	.	A	T	1	1	2	0	0	2	0	0
16	1239500	.	T	C	6	12	18	0	2	20	0	0
16	1334452	.	C	T	1	2	3	0	1	4	0	0
16	1354513	.	A	G	0	0	0	0	1	1	0	0
16	1355316	.	A	T	8	4	12	0	1	13	0	0
16	1355720	.	T	C	8	5	13	0	0	13	0	0
16	1359119	.	T	C	1	3	4	0	1	5	0	0
16	1397817	.	T	C	4	4	8	0	0	8	0	0
16	1397952	.	A	T	1	4	5	0	0	5	0	0
16	1398530	.	A	G	6	3	9	0	0	9	0	0
16	1398604	.	A	G	5	0	5	0	5	10	0	0
16	1466147	.	C	T	3	5	8	0	0	8	0	0
16	1466194	.	A	T	3	2	5	0	0	5	0	0
16	1466528	.	C	G	0	2	2	0	0	2	0	0
16	1466739	.	G	A	1	3	4	0	0	4	0	0
16	1466960	.	C	T	0	1	1	0	1	2	0	0
16	1523892	.	A	G	5	3	8	0	0	8	0	0
16	1523911	.	G	C	7	0	7	0	4	11	0	0
16	1577676	.	G	A	2	2	4	0	0	4	0	0
16	1580006	.	G	C	1	0	1	0	2	3	0	0
16	1884215	.	C	T	0	1	1	0	0	1	0	0
16	1884218	.	C	T	0	1	1	0	0	1	0	0
16	1906682	.	C	A	3	2	5	0	0	5	0	0
16	1996569	.	A	C	1	0	1	0	0	1	0	0
16	1996577	.	C	T	1	0	1	0	0	1	0	0
16	2009844	.	T	G	4	7	11	0	0	11	0	0
16	2017808	.	A	G	2	6	8	0	0	8	0	0
16	2043021	.	C	T	12	4	16	0	1	17	0	0
16	2043122	.	G	C	0	4	4	0	6	10	0	0
16	2071535	.	G	A	0	8	8	0	8	16	0	0
16	2102037	.	T	C	11	6	17	0	3	20	0	0
16	2102189	.	A	T	5	3	8	0	1	9	0	0
16	2102245	.	A	G	4	3	7	0	0	7	0	0
16	2102256	.	T	G	1	0	1	0	3	4	0	0
16	2102349	.	C	T	4	4	8	0	0	8	0	0
16	2102468	.	A	T	3	4	7	0	1	8	0	0
16	2102495	.	A	G	1	0	1	0	2	3	0	0
16	2102683	.	C	T	3	3	6	0	1	7	0	0
16	2102743	.	A	T	9	3	12	0	1	13	0	0
16	2103052	.	C	T	17	6	23	0	1	24	0	0
16	2103058	.	G	T	15	7	22	0	2	24	0	0
16	2103088	.	G	A	0	5	5	0	16	21	0	0
16	2103167	.	C	T	13	5	18	0	0	18	0	0
16	2103209	.	C	T	9	11	20	0	0	20	0	0
16	2103241	.	T	A	8	13	21	0	0	21	0	0
16	2103268	.	A	T	10	16	26	0	1	27	0	0
16	2103307	.	T	C	7	12	19	0	2	21	0	0
16	2103714	.	A	T	6	7	13	0	0	13	0	0
16	2103783	.	A	T	1	4	5	0	0	5	0	0
16	2104312	.	A	C	16	10	26	0	0	26	0	0
16	2104400	.	T	C	10	14	24	0	1	25	0	0
16	2104597	.	T	C	31	15	46	0	2	48	0	0
16	2104604	.	A	G	30	1	31	0	19	50	0	0
16	2105035	.	A	G	6	5	11	0	0	11	0	0
16	2353020	.	C	A	3	3	6	0	2	8	0	0
16	2353023	.	T	C	2	4	6	0	2	8	0	0
16	2360324	.	C	T	1	1	2	0	0	2	0	0
16	2368422	.	T	C	1	0	1	0	1	2	0	0
16	2373689	.	T	C	1	2	3	0	0	3	0	0
16	2380596	.	T	G	2	5	7	0	0	7	0	0
16	2472179	.	A	G	1	1	2	0	0	2	0	0
16	2472182	.	T	C	1	0	1	0	1	2	0	0
16	2472263	.	G	A	11	4	15	0	0	15	0	0
16	2472284	.	T	C	8	3	11	0	0	11	0	0
16	2484064	.	C	T	0	7	7	0	5	12	0	0
16	2485904	.	G	A	2	0	2	0	0	2	0	0
16	2494323	.	T	C	5	0	5	0	3	8	0	0
16	2495649	.	G	C	3	3	6	0	0	6	0	0
16	2517184	.	G	T	10	3	13	0	0	13	0	0
16	2519056	.	T	C	3	3	6	0	0	6	0	0
16	2519071	.	T	C	0	1	1	0	0	1	0	0
16	2526035	.	C	T	1	1	2	0	0	2	0	0
16	2528209	.	A	G	3	4	7	0	0	7	0	0
16	2539405	.	G	A	5	1	6	0	0	6	0	0
16	2540235	.	G	A	6	2	8	0	0	8	0	0
16	2542782	.	G	C	1	0	1	0	0	1	0	0
16	2545290	.	C	T	1	3	4	0	0	4	0	0
16	2567316	.	A	G	9	0	9	0	8	17	0	0
16	2568847	.	G	A	1	13	14	0	8	22	0	0
16	2577717	.	T	A	1	0	1	0	0	1	0	0
16	2580255	.	T	A	14	10	24	0	1	25	0	0
16	2637673	.	T	C	1	0	1	0	3	4	0	0
16	2640406	.	G	A	1	1	2	0	0	2	0	0
16	2825870	.	A	G	2	3	5	0	1	6	0	0
16	2843932	.	T	C	6	3	9	0	0	9	0	0
16	2844103	.	G	A	2	2	4	0	0	4	0	0
16	2964078	.	T	C	1	2	3	0	0	3	0	0
16	2987527	.	G	A	2	1	3	0	1	4	0	0
16	3089158	.	C	T	0	3	3	0	0	3	0	0
16	3091279	.	A	C	1	1	2	0	0	2	0	0
16	3096160	.	C	G	2	4	6	0	0	6	0	0
16	3096166	.	T	C	2	6	8	0	0	8	0	0
16	3096319	.	T	C	2	6	8	0	1	9	0	0
16	3096384	.	C	T	6	8	14	0	0	14	0	0
16	3096420	.	T	C	4	11	15	0	0	15	0	0
16	3096446	.	A	T	3	11	14	0	0	14	0	0
16	3463895	.	A	G	10	9	19	0	0	19	0	0
16	3470212	.	G	A	3	10	13	0	0	13	0	0
16	3470332	.	A	G	4	5	9	0	0	9	0	0
16	3499306	.	G	A	1	1	2	0	1	3	0	0
16	3523597	.	T	A	1	3	4	0	0	4	0	0
16	4067809	.	G	T	1	1	2	0	0	2	0	0
16	4115198	.	C	T	6	2	8	0	0	8	0	0
16	4117682	.	G	C	2	1	3	0	1	4	0	0
16	4119048	.	C	T	2	0	2	0	0	2	0	0
16	4126464	.	C	T	3	2	5	0	0	5	0	0
16	4126903	.	C	A	0	2	2	0	0	2	0	0
16	4126927	.	C	T	4	0	4	0	0	4	0	0
16	4128322	.	C	T	1	1	2	0	1	3	0	0
16	4131062	.	T	C	10	7	17	0	0	17	0	0
16	4138776	.	C	T	2	1	3	0	0	3	0	0
16	4163503	.	C	T	4	3	7	0	1	8	0	0
16	4168036	.	T	A	2	3	5	0	0	6	1	0
16	4168139	.	A	G	4	2	6	0	2	8	0	0
16	4189894	.	G	C	0	6	6	0	0	6	0	0
16	4190052	.	A	T	4	2	6	0	0	6	0	0
16	4190091	.	T	A	5	1	6	0	1	7	0	0
16	4190094	.	C	A	4	2	6	0	0	6	0	0
16	4190477	.	T	C	2	3	5	0	0	5	0	0
16	4190599	.	G	A	4	2	6	0	0	6	0	0
16	4197130	.	T	A	2	10	12	0	0	13	1	0
16	4200749	.	G	T	4	5	9	0	0	9	0	0
16	4201948	.	C	G	9	11	20	0	0	20	0	0
16	4202038	.	C	T	3	13	16	0	0	16	0	0
16	4202128	.	A	G	3	1	4	0	1	5	0	0
16	4287757	.	C	G	8	4	12	0	1	13	0	0
16	4287783	.	C	T	6	6	12	0	1	13	0	0
16	4287936	.	C	T	0	4	4	0	5	9	0	0
16	4287961	.	G	A	5	3	8	0	0	8	0	0
16	4288078	.	C	A	0	1	1	0	3	4	0	0
16	4288081	.	T	A	3	1	4	0	0	4	0	0
16	4288656	.	T	A	7	4	11	0	2	13	0	0
16	4317343	.	A	T	4	2	6	0	0	6	0	0
16	4317365	.	G	A	3	2	5	0	0	5	0	0
16	4513876	.	A	T	8	5	13	0	1	14	0	0
16	4513901	.	T	C	7	8	15	0	0	15	0	0
16	4513920	.	C	G	7	6	13	0	0	13	0	0
16	4514114	.	T	C	5	0	5	0	5	10	0	0
16	4514315	.	T	C	1	6	7	0	0	8	1	0
16	4514320	.	T	C	2	0	2	0	5	7	0	0
16	4514467	.	A	T	3	8	11	0	0	11	0	0
16	4514592	.	A	C	9	8	17	0	0	17	0	0
16	4514594	.	T	A	9	8	17	0	0	17	0	0
16	4514633	.	T	C	10	11	21	0	0	21	0	0
16	4514666	.	T	C	7	1	8	0	11	19	0	0
16	4514795	.	T	C	0	3	3	0	0	3	0	0
16	4515058	.	T	C	0	3	3	0	1	4	0	0
16	4517477	.	G	A	6	3	9	0	1	10	0	0
16	4517606	.	A	G	1	8	9	0	0	9	0	0
16	4517704	.	C	T	6	5	11	0	0	11	0	0
16	4531827	.	A	G	6	3	9	0	0	9	0	0
16	4533768	.	T	C	7	9	16	0	1	17	0	0
16	4538422	.	A	G	5	2	7	0	0	7	0	0
16	4540805	.	G	T	10	15	25	0	1	26	0	0
16	4540864	.	G	C	3	2	5	0	3	8	0	0
16	4541022	.	A	C	5	13	18	0	1	19	0	0
16	4541061	.	T	G	3	8	11	0	2	13	0	0
16	4541085	.	T	C	3	6	9	0	1	10	0	0
16	4541233	.	T	C	11	5	16	0	1	17	0	0
16	4541250	.	C	T	11	6	17	0	1	18	0	0
16	4541281	.	A	T	7	5	12	0	1	13	0	0
16	4541931	.	A	C	7	2	9	0	3	12	0	0
16	4541936	.	G	C	6	4	10	0	1	12	1	0
16	4542009	.	T	C	5	2	7	1	0	8	0	0
16	4542187	.	G	A	3	1	4	0	0	4	0	0
16	4542211	.	A	G	2	2	4	0	0	4	0	0
16	4542252	.	A	G	3	3	6	0	1	7	0	0
16	4542518	.	C	T	1	19	20	0	10	30	0	0
16	4545454	.	T	C	1	1	2	0	0	2	0	0
16	4573450	.	G	T	1	2	3	0	0	3	0	0
16	4573458	.	C	T	1	3	4	0	0	4	0	0
16	4575940	.	G	A	0	2	2	0	0	2	0	0
16	4615993	.	C	A	6	14	20	0	0	20	0	0
16	4616071	.	A	T	2	7	9	0	0	9	0	0
16	4619598	.	A	T	1	2	3	0	0	3	0	0
16	4619614	.	A	G	1	2	3	0	0	3	0	0
16	4628953	.	T	C	2	4	6	0	0	6	0	0
16	4630127	.	G	T	1	0	1	0	0	1	0	0
16	4630143	.	C	T	1	1	2	0	0	2	0	0
16	4695368	.	T	A	0	1	1	0	0	1	0	0
16	4695530	.	A	G	1	3	4	0	0	4	0	0
16	4697713	.	A	G	0	1	1	0	0	1	0	0
16	4697821	.	G	A	4	2	6	0	0	6	0	0
16	4697829	.	C	G	2	0	2	0	0	2	0	0
16	4700766	.	T	C	1	1	2	0	0	2	0	0
16	4707211	.	G	T	0	6	6	0	7	13	0	0
16	4707381	.	A	T	4	3	7	0	0	7	0	0
16	4707480	.	G	A	5	3	8	0	1	9	0	0
16	4711553	.	T	C	0	2	2	0	1	3	0	0
16	4711613	.	G	A	2	2	4	0	0	4	0	0
16	4711616	.	T	C	2	0	2	0	3	5	0	0
16	4746675	.	A	C	0	3	3	0	0	3	0	0
16	4755816	.	A	T	4	4	8	0	0	8	0	0
16	4759113	.	G	A	0	2	2	0	0	2	0	0
16	4761133	.	T	C	1	0	1	0	2	3	0	0
16	4770454	.	A	C	0	3	3	0	1	4	0	0
16	4772790	.	G	A	1	1	2	0	0	2	0	0
16	4772837	.	G	A	0	5	5	0	2	7	0	0
16	4784020	.	T	C	1	5	6	0	0	6	0	0
16	4842203	.	T	A	5	9	14	0	0	14	0	0
16	4860516	.	A	G	2	3	5	0	0	5	0	0
16	4867445	.	C	T	8	7	15	0	1	16	0	0
16	4867487	.	C	T	5	3	8	0	1	9	0	0
16	4869973	.	G	A	5	10	15	0	1	16	0	0
16	4870180	.	C	T	3	6	9	0	1	10	0	0
16	4872260	.	C	T	0	1	1	0	0	1	0	0
16	4872281	.	G	A	4	2	6	0	0	6	0	0
16	4872320	.	G	A	1	3	4	0	2	6	0	0
16	4872453	.	C	T	2	0	2	0	0	2	0	0
16	4876470	.	C	T	3	5	8	0	1	9	0	0
16	4882206	.	C	T	3	5	8	0	0	8	0	0
16	4882491	.	C	T	3	2	5	0	2	7	0	0
16	4882492	.	G	A	0	2	2	0	5	7	0	0
16	4885458	.	T	A	4	1	5	0	0	5	0	0
16	4895423	.	T	C	5	6	11	0	1	12	0	0
16	5014391	.	A	G	3	3	6	0	0	6	0	0
16	5014564	.	A	G	8	6	14	0	0	14	0	0
16	5025494	.	G	A	4	6	10	0	0	10	0	0
16	5105221	.	G	A	14	12	26	0	0	26	0	0
16	5145459	.	T	C	11	15	26	0	0	26	0	0
16	5145599	.	C	A	23	13	36	0	1	37	0	0
16	5145622	.	G	A	19	18	37	0	1	38	0	0
16	5149298	.	T	C	5	6	11	0	0	11	0	0
16	5153956	.	T	C	22	12	34	0	0	34	0	0
16	5156563	.	G	A	0	6	6	0	3	9	0	0
16	5159283	.	A	G	1	0	1	0	0	1	0	0
16	5159289	.	C	T	1	1	2	0	0	2	0	0
16	5159328	.	T	C	5	5	10	0	1	11	0	0
16	5164569	.	C	T	3	6	9	0	0	9	0	0
16	5166015	.	G	A	0	11	11	0	5	16	0	0
16	5166030	.	C	T	7	14	21	0	0	21	0	0
16	5166288	.	G	A	11	14	25	0	1	26	0	0
16	5166332	.	T	A	8	18	26	0	2	28	0	0
16	5166351	.	T	C	9	20	29	0	1	30	0	0
16	5166546	.	G	A	11	9	20	0	2	22	0	0
16	5166645	.	A	C	9	2	11	1	0	12	0	0
16	5166719	.	A	G	10	3	13	0	0	13	0	0
16	5166805	.	A	G	10	2	12	0	15	27	0	0
16	5166889	.	G	T	9	12	21	0	1	22	0	0
16	5166977	.	G	T	9	6	15	0	0	15	0	0
16	5167030	.	G	A	9	9	18	0	3	21	0	0
16	5167249	.	A	C	4	12	16	0	2	18	0	0
16	5167257	.	A	G	11	3	14	0	1	15	0	0
16	5187795	.	G	A	9	5	14	0	1	15	0	0
16	5188029	.	A	C	7	3	10	0	1	11	0	0
16	5190210	.	C	T	6	5	11	0	0	11	0	0
16	5190590	.	A	G	3	3	6	0	0	6	0	0
16	5193353	.	C	T	1	0	1	0	0	1	0	0
16	5193539	.	G	A	8	3	11	0	0	11	0	0
16	5193605	.	T	G	1	4	5	0	1	6	0	0
16	5193644	.	G	A	2	4	6	0	0	6	0	0
16	5193884	.	C	A	1	2	3	0	0	3	0	0
16	5196377	.	C	T	6	4	10	0	0	10	0	0
16	5196630	.	C	T	5	6	11	0	0	11	0	0
16	5199307	.	C	T	3	2	5	0	0	5	0	0
16	5199381	.	C	T	3	4	7	0	0	7	0	0
16	5199399	.	C	T	1	4	5	0	0	5	0	0
16	5199476	.	C	T	6	8	14	0	1	15	0	0
16	5199503	.	C	T	4	6	10	0	0	10	0	0
16	5205146	.	G	A	0	5	5	0	8	13	0	0
16	5216548	.	G	A	8	4	12	0	0	12	0	0
16	5216707	.	G	C	4	3	7	0	0	7	0	0
16	5221680	.	A	C	7	8	15	0	0	16	1	0
16	5221888	.	T	C	7	9	16	0	0	16	0	0
16	5223355	.	G	A	5	5	10	0	0	10	0	0
16	5223375	.	A	G	5	6	11	0	0	11	0	0
16	5223454	.	C	T	8	7	15	0	2	17	0	0
16	5223470	.	G	A	4	8	12	0	1	13	0	0
16	5223740	.	C	T	7	5	12	0	0	12	0	0
16	5224328	.	A	G	8	18	26	0	0	26	0	0
16	5230627	.	G	A	1	10	11	0	13	24	0	0
16	5230782	.	A	T	11	6	17	0	1	18	0	0
16	5251783	.	G	A	0	4	4	0	1	5	0	0
16	5604534	.	C	T	1	2	3	0	0	3	0	0
16	5604565	.	A	G	0	2	2	0	0	2	0	0
16	5612617	.	A	T	3	2	5	0	0	5	0	0
16	5612631	.	A	T	4	2	6	0	0	6	0	0
16	5620883	.	C	T	0	1	1	0	0	1	0	0
16	5623099	.	T	C	1	2	3	0	0	3	0	0
16	5636328	.	T	G	2	0	2	0	3	5	0	0
16	5700055	.	G	A	0	2	2	0	0	2	0	0
16	5700058	.	T	C	0	2	2	0	0	2	0	0
16	5700402	.	A	G	5	6	11	0	0	11	0	0
16	5700534	.	C	T	5	4	9	0	0	9	0	0
16	5702807	.	C	T	1	2	3	0	0	3	0	0
16	5708077	.	C	A	5	5	10	0	1	11	0	0
16	5708175	.	C	T	1	3	4	0	0	4	0	0
16	5708181	.	G	A	1	1	2	0	2	4	0	0
16	5710483	.	G	A	0	1	1	0	0	1	0	0
16	5710582	.	G	T	2	2	4	0	0	4	0	0
16	5710627	.	G	T	1	3	4	0	0	4	0	0
16	5776245	.	T	C	19	15	34	0	1	35	0	0
16	5778882	.	A	G	21	20	41	0	3	44	0	0
16	5778913	.	T	C	28	18	46	0	1	47	0	0
16	5786977	.	G	A	3	5	8	0	1	9	0	0
16	5786989	.	C	T	0	4	4	0	7	11	0	0
16	5787396	.	A	G	4	2	6	0	9	15	0	0
16	5787399	.	T	A	4	9	13	0	1	14	0	0
16	5787436	.	C	A	11	3	14	0	0	14	0	0
16	5787562	.	G	A	9	5	14	0	0	14	0	0
16	5787670	.	A	G	6	10	16	0	1	17	0	0
16	5787671	.	G	C	10	7	17	0	0	17	0	0
16	5787911	.	T	G	2	5	7	0	2	9	0	0
16	5788163	.	T	A	3	4	7	0	0	7	0	0
16	5788451	.	G	A	8	6	14	0	1	15	0	0
16	5789124	.	C	A	0	9	9	0	12	21	0	0
16	5789340	.	G	C	8	0	8	0	10	18	0	0
16	5795721	.	C	T	1	5	6	0	6	12	0	0
16	5800670	.	C	T	0	5	5	0	5	10	0	0
16	5806440	.	G	A	5	3	8	0	0	8	0	0
16	5806578	.	G	T	3	5	8	0	0	8	0	0
16	5808868	.	G	T	7	7	14	0	1	15	0	0
16	5808931	.	G	A	3	5	8	0	0	8	0	0
16	5812624	.	G	T	2	2	4	0	0	4	0	0
16	5817655	.	T	C	1	0	1	0	0	1	0	0
16	6101477	.	G	A	0	2	2	0	0	2	0	0
16	6126477	.	T	A	0	3	3	0	1	4	0	0
16	6182755	.	C	T	20	17	37	0	3	40	0	0
16	6191514	.	A	G	20	31	51	0	3	54	0	0
16	6191526	.	G	C	21	30	51	0	1	52	0	0
16	6191622	.	C	G	29	20	49	0	1	50	0	0
16	6192811	.	A	G	14	10	24	0	1	25	0	0
16	6197593	.	G	A	2	1	3	0	0	3	0	0
16	6205657	.	G	T	5	3	8	0	0	8	0	0
16	6356850	.	T	C	4	2	6	0	0	6	0	0
16	6356906	.	T	A	2	2	4	0	0	4	0	0
16	6387037	.	G	A	22	23	45	0	5	50	0	0
16	6387121	.	G	A	20	13	33	0	0	33	0	0
16	6387143	.	A	C	12	0	12	0	6	18	0	0
16	6387157	.	A	C	9	4	13	0	0	13	0	0
16	6395740	.	T	A	0	2	2	0	1	3	0	0
16	6395904	.	A	G	2	5	7	0	2	9	0	0
16	6395906	.	A	G	4	5	9	0	0	9	0	0
16	6405013	.	C	G	0	1	1	0	2	3	0	0
16	6649103	.	T	C	0	2	2	0	0	2	0	0
16	6650049	.	T	C	1	2	3	0	0	3	0	0
16	6650394	.	T	C	1	4	5	0	0	5	0	0
16	6650415	.	T	C	1	3	4	0	0	4	0	0
16	6650631	.	C	A	1	2	3	0	0	3	0	0
16	6651049	.	T	C	3	6	9	0	0	9	0	0
16	6653508	.	C	A	6	2	8	0	0	8	0	0
16	6654152	.	T	C	2	5	7	0	0	7	0	0
16	6733567	.	G	A	1	2	3	0	0	3	0	0
16	6735149	.	C	T	1	1	2	0	1	3	0	0
16	6735161	.	T	A	1	2	3	0	0	3	0	0
16	6741716	.	G	T	0	2	2	0	1	3	0	0
16	6745636	.	T	C	2	6	8	0	0	8	0	0
16	6745856	.	C	G	4	4	8	0	0	8	0	0
16	6746038	.	C	A	1	4	5	0	1	6	0	0
16	6770455	.	G	A	1	0	1	0	0	1	0	0
16	6771841	.	T	C	0	1	1	0	0	1	0	0
16	6776416	.	T	C	2	3	5	0	0	5	0	0
16	6778482	.	A	G	1	3	4	0	0	4	0	0
16	6784866	.	C	T	3	6	9	0	0	9	0	0
16	6787491	.	G	A	0	4	4	0	3	7	0	0
16	6787801	.	A	G	5	0	5	0	4	9	0	0
16	6790964	.	C	T	3	1	4	0	0	4	0	0
16	6790978	.	C	T	4	1	5	0	0	5	0	0
16	6792044	.	C	T	5	3	8	0	0	8	0	0
16	6792059	.	C	G	3	3	6	0	1	7	0	0
16	6796118	.	C	T	2	1	3	0	0	3	0	0
16	6800043	.	G	A	0	4	4	0	2	6	0	0
16	6800127	.	A	G	4	0	4	0	8	12	0	0
16	6800209	.	G	A	2	2	4	0	0	4	0	0
16	6800211	.	A	G	2	0	2	0	2	4	0	0
16	6800330	.	G	C	0	3	3	0	0	3	0	0
16	6800383	.	G	A	3	3	6	0	0	6	0	0
16	6803650	.	A	T	25	16	41	0	2	43	0	0
16	6803725	.	T	C	21	24	45	0	0	45	0	0
16	6803887	.	A	G	20	10	30	0	0	30	0	0
16	6820746	.	G	C	11	5	16	0	2	18	0	0
16	6821214	.	G	A	6	11	17	0	0	17	0	0
16	6821248	.	C	T	0	6	6	0	9	15	0	0
16	6821332	.	A	G	11	11	22	0	1	23	0	0
16	6821423	.	A	G	9	15	24	0	0	24	0	0
16	6821465	.	C	T	0	5	5	0	13	18	0	0
16	6821995	.	T	C	9	1	10	0	12	22	0	0
16	6822014	.	G	A	10	13	23	0	1	24	0	0
16	6923836	.	A	G	1	1	2	0	0	2	0	0
16	6929670	.	C	A	5	3	8	0	0	8	0	0
16	6929671	.	A	T	4	3	7	0	1	8	0	0
16	6929812	.	C	T	1	5	6	0	1	7	0	0
16	6929832	.	G	A	2	5	7	0	1	8	0	0
16	6929860	.	G	A	2	3	5	0	1	6	0	0
16	6932735	.	A	T	4	7	11	0	0	11	0	0
16	6932886	.	A	T	1	3	4	0	0	4	0	0
16	6944603	.	G	T	1	2	3	0	0	3	0	0
16	6944657	.	T	A	2	2	4	0	0	4	0	0
16	6944713	.	G	T	3	3	6	0	0	6	0	0
16	6944720	.	A	G	4	4	8	0	0	8	0	0
16	6944766	.	T	C	11	10	21	0	0	21	0	0
16	6955048	.	G	A	15	20	35	0	2	37	0	0
16	6955368	.	A	G	12	10	22	1	1	24	0	0
16	7202699	.	T	C	1	3	4	0	1	5	0	0
16	7202712	.	G	A	2	5	7	0	1	8	0	0
16	7202757	.	C	T	1	4	5	0	0	5	0	0
16	7202758	.	T	A	1	4	5	0	0	5	0	0
16	7202907	.	G	A	2	2	4	0	0	4	0	0
16	7202910	.	A	G	2	2	4	0	0	4	0	0
16	7203408	.	G	T	3	3	6	0	0	6	0	0
16	7203424	.	A	G	3	2	5	0	0	5	0	0
16	7208484	.	C	T	1	2	3	0	0	3	0	0
16	7217013	.	A	G	11	7	18	0	0	18	0	0
16	7217052	.	G	T	12	8	20	0	2	22	0	0
16	7220142	.	A	G	5	4	9	0	1	10	0	0
16	7220225	.	C	T	0	5	5	0	5	10	0	0
16	7221846	.	C	T	0	3	3	0	2	5	0	0
16	7226998	.	G	A	1	1	2	0	0	2	0	0
16	7239374	.	A	C	4	4	8	0	0	8	0	0
16	7242677	.	C	T	2	3	5	0	0	5	0	0
16	7242729	.	A	T	3	1	4	0	1	5	0	0
16	7242735	.	T	A	2	2	4	0	0	4	0	0
16	7242790	.	A	G	3	3	6	0	0	6	0	0
16	7242821	.	A	T	5	6	11	0	1	12	0	0
16	7242878	.	A	G	12	8	20	0	0	20	0	0
16	7242961	.	A	G	3	2	5	0	0	5	0	0
16	7252871	.	T	C	7	18	25	0	1	26	0	0
16	7254778	.	G	A	1	16	17	0	9	26	0	0
16	7259719	.	T	C	3	7	10	0	0	10	0	0
16	7259869	.	T	A	3	12	15	0	0	15	0	0
16	7259900	.	A	G	5	12	17	0	0	17	0	0
16	7259956	.	A	T	12	12	24	0	0	24	0	0
16	7259957	.	G	A	11	12	23	0	1	24	0	0
16	7260156	.	T	C	1	4	5	0	0	5	0	0
16	7260262	.	G	A	4	7	11	0	0	11	0	0
16	7260280	.	T	A	3	6	9	0	0	9	0	0
16	7315255	.	G	A	2	2	4	0	0	4	0	0
16	7315654	.	A	T	3	2	5	0	0	5	0	0
16	7315933	.	G	A	1	2	3	0	0	3	0	0
16	7316083	.	G	A	2	2	4	0	2	6	0	0
16	7376900	.	A	G	6	5	11	0	0	11	0	0
16	7385689	.	C	T	1	0	1	0	0	1	0	0
16	7385705	.	A	G	1	0	1	0	0	1	0	0
16	7385807	.	C	T	0	1	1	0	0	1	0	0
16	7415215	.	G	A	13	5	18	0	0	18	0	0
16	7415254	.	T	A	12	4	16	0	0	16	0	0
16	7415423	.	C	A	15	12	27	0	0	27	0	0
16	7415435	.	G	A	14	11	25	0	1	26	0	0
16	7415542	.	A	T	11	9	20	0	0	20	0	0
16	7415559	.	C	A	8	10	18	0	0	18	0	0
16	7415761	.	G	A	11	8	19	0	1	20	0	0
16	7415793	.	G	A	11	3	14	0	3	17	0	0
16	7416236	.	C	T	10	9	19	0	0	19	0	0
16	7416320	.	C	T	15	10	25	0	0	25	0	0
16	7416352	.	T	A	12	10	22	0	0	22	0	0
16	7630612	.	T	C	10	14	24	0	0	24	0	0
16	7635527	.	C	T	1	0	1	0	1	2	0	0
16	7635721	.	T	A	3	5	8	0	0	8	0	0
16	7638788	.	T	C	20	10	30	0	0	30	0	0
16	7638815	.	A	T	15	16	31	0	0	31	0	0
16	7638828	.	A	G	15	1	16	0	14	30	0	0
16	7638866	.	A	T	18	16	34	0	1	35	0	0
16	7638979	.	C	T	24	15	39	0	3	42	0	0
16	7638984	.	C	A	19	14	33	0	9	42	0	0
16	7639085	.	A	C	19	16	35	0	0	35	0	0
16	7639100	.	T	A	15	24	39	0	0	39	0	0
16	7639125	.	A	G	32	13	45	0	2	47	0	0
16	7639527	.	C	T	19	21	40	0	1	41	0	0
16	7639534	.	G	C	0	24	24	0	20	44	0	0
16	7639621	.	C	T	22	17	39	0	1	40	0	0
16	7639643	.	A	T	21	20	41	0	1	42	0	0
16	7639684	.	A	G	15	21	36	0	2	38	0	0
16	7639774	.	T	A	11	21	32	0	4	36	0	0
16	7639856	.	T	C	14	23	37	0	1	38	0	0
16	7640116	.	A	G	13	21	34	0	1	35	0	0
16	7640127	.	G	A	0	21	21	0	16	37	0	0
16	7640390	.	C	T	32	11	43	0	1	44	0	0
16	7640410	.	A	G	28	17	45	0	1	46	0	0
16	7640425	.	T	A	22	24	46	0	3	50	1	0
16	7640757	.	T	A	19	13	32	0	4	36	0	0
16	7640999	.	G	A	5	4	9	0	0	9	0	0
16	7679555	.	T	A	1	2	3	0	0	3	0	0
16	7716184	.	C	G	2	1	3	0	0	3	0	0
16	7725555	.	A	T	1	3	4	0	0	4	0	0
16	7728408	.	C	T	1	1	2	0	0	2	0	0
16	7743286	.	T	A	9	6	15	0	0	15	0	0
16	7743398	.	C	T	0	3	3	0	6	9	0	0
16	7743598	.	T	A	3	5	8	0	0	8	0	0
16	7743687	.	A	G	3	3	6	0	0	6	0	0
16	7745027	.	C	A	3	4	7	0	0	7	0	0
16	7745053	.	C	G	6	3	9	0	1	10	0	0
16	7745398	.	A	G	4	3	7	0	0	7	0	0
16	7746193	.	G	A	1	5	6	0	1	7	0	0
16	7746947	.	G	A	2	3	5	0	0	5	0	0
16	7748211	.	G	A	1	2	3	0	0	3	0	0
16	7803023	.	T	C	11	8	19	0	1	20	0	0
16	7803200	.	C	G	4	2	6	0	0	6	0	0
16	7803206	.	C	T	4	2	6	0	0	6	0	0
16	7803298	.	T	C	5	5	10	0	0	10	0	0
16	7803340	.	T	C	5	8	13	0	0	13	0	0
16	7803401	.	A	G	5	0	5	0	0	9	4	0
16	7803418	.	G	C	6	4	10	0	0	10	0	0
16	7803560	.	A	G	15	6	21	0	1	22	0	0
16	7803627	.	T	A	5	6	11	0	1	12	0	0
16	7803765	.	C	G	6	7	13	0	1	14	0	0
16	7803782	.	C	A	0	5	5	0	5	10	0	0
16	7803825	.	A	T	5	3	8	0	1	9	0	0
16	7803859	.	A	C	7	4	11	0	0	11	0	0
16	7803905	.	G	C	5	0	5	0	5	10	0	0
16	7803923	.	T	A	6	3	9	0	0	9	0	0
16	7803971	.	T	A	4	5	9	0	0	9	0	0
16	7804081	.	T	A	4	5	9	0	1	10	0	0
16	7804269	.	A	T	9	3	12	0	0	12	0	0
16	7804270	.	C	T	9	3	12	0	0	12	0	0
16	7804355	.	C	G	3	3	6	0	0	6	0	0
16	7804391	.	T	C	4	0	4	0	5	9	0	0
16	7804458	.	A	C	3	5	8	0	0	8	0	0
16	7804569	.	C	A	3	3	6	0	0	6	0	0
16	7804588	.	C	A	3	2	5	0	1	6	0	0
16	7804914	.	C	T	0	2	2	0	0	2	0	0
16	7804990	.	A	C	2	2	4	0	0	4	0	0
16	7805423	.	C	T	0	4	4	0	5	9	0	0
16	7805524	.	C	A	0	2	2	0	3	5	0	0
16	7821241	.	C	T	4	4	8	0	0	8	0	0
16	7821244	.	G	A	4	5	9	0	0	9	0	0
16	7999499	.	C	A	3	4	7	0	0	7	0	0
16	8041173	.	G	A	4	6	10	0	0	10	0	0
16	8041179	.	A	G	5	5	10	0	0	10	0	0
16	8041234	.	G	A	0	2	2	0	6	8	0	0
16	8041261	.	T	A	3	2	5	0	0	5	0	0
16	8051941	.	T	C	15	1	16	0	11	27	0	0
16	8052033	.	T	C	10	13	23	0	1	24	0	0
16	8052049	.	G	A	9	9	18	2	2	22	0	0
16	8052145	.	C	A	17	22	39	0	1	41	1	0
16	8052537	.	C	T	9	15	24	0	2	26	0	0
16	8052606	.	T	C	14	0	14	0	12	26	0	0
16	8052651	.	T	C	20	11	31	0	3	34	0	0
16	8052673	.	G	C	23	1	24	0	17	41	0	0
16	8052747	.	A	G	14	14	28	0	0	28	0	0
16	8052831	.	T	A	12	12	24	0	2	26	0	0
16	8052866	.	C	A	0	8	8	0	9	17	0	0
16	8052884	.	T	C	7	4	11	0	0	11	0	0
16	8052909	.	T	A	3	5	8	0	0	8	0	0
16	8052982	.	T	C	5	10	15	2	1	18	0	0
16	8053206	.	T	G	6	11	17	0	1	18	0	0
16	8053403	.	C	T	12	9	21	0	1	22	0	0
16	8053485	.	C	T	12	9	21	0	1	22	0	0
16	8053716	.	A	G	12	9	21	0	6	27	0	0
16	8053717	.	T	C	13	14	27	0	0	27	0	0
16	8054260	.	T	G	1	5	6	0	0	6	0	0
16	8054290	.	C	T	2	5	7	0	2	9	0	0
16	8054389	.	C	T	0	7	7	0	8	15	0	0
16	8054434	.	T	C	7	1	8	0	12	20	0	0
16	8055037	.	A	G	3	4	7	0	0	7	0	0
16	8059585	.	T	C	6	11	17	0	0	17	0	0
16	8066237	.	A	C	7	4	11	0	1	12	0	0
16	8066318	.	A	G	8	7	15	0	0	15	0	0
16	8119672	.	G	A	5	4	9	0	0	9	0	0
16	8119976	.	A	G	12	8	20	0	0	20	0	0
16	8120033	.	G	A	7	6	13	0	1	14	0	0
16	8120171	.	C	T	6	5	11	0	0	11	0	0
16	8139585	.	G	A	1	4	5	0	0	5	0	0
16	8139786	.	T	C	2	1	3	0	0	3	0	0
16	8160484	.	T	C	1	4	5	0	0	5	0	0
16	8160589	.	T	C	1	3	4	0	0	4	0	0
16	8161555	.	C	T	1	2	3	0	1	4	0	0
16	8161573	.	C	A	3	2	5	0	0	5	0	0
16	8161591	.	G	A	3	5	8	0	0	8	0	0
16	8161708	.	G	A	1	3	4	0	3	7	0	0
16	8161875	.	C	T	4	5	9	0	0	9	0	0
16	8298915	.	T	C	1	6	7	0	0	7	0	0
16	8299025	.	T	A	7	2	9	0	0	9	0	0
16	8299037	.	A	T	9	1	10	0	0	10	0	0
16	8299123	.	T	A	5	5	10	0	0	10	0	0
16	8299302	.	G	A	4	5	9	0	0	9	0	0
16	8299308	.	T	A	5	5	10	0	0	10	0	0
16	8299410	.	T	A	5	4	9	1	1	11	0	0
16	8299705	.	G	A	5	2	7	0	0	7	0	0
16	8300218	.	T	A	2	3	5	0	0	5	0	0
16	8300225	.	C	T	0	3	3	0	2	5	0	0
16	8300255	.	G	A	5	7	12	0	0	12	0	0
16	8300269	.	T	C	4	7	11	0	0	11	0	0
16	8300823	.	T	A	1	3	4	0	1	5	0	0
16	8300895	.	C	G	4	3	7	0	0	7	0	0
16	8300989	.	A	G	4	5	9	0	1	10	0	0
16	8301045	.	T	C	1	4	5	0	0	5	0	0
16	8301102	.	A	G	0	2	2	0	0	2	0	0
16	8301175	.	A	C	1	2	3	0	0	3	0	0
16	8530992	.	A	T	5	3	8	0	0	8	0	0
16	8531299	.	C	T	6	3	9	0	1	10	0	0
16	8565042	.	T	A	1	2	3	0	0	3	0	0
16	8752017	.	T	A	14	21	35	0	0	35	0	0
16	8752091	.	A	G	13	23	36	0	0	36	0	0
16	8752223	.	C	T	11	12	23	0	2	25	0	0
16	8752316	.	G	T	8	11	19	0	0	19	0	0
16	8752334	.	C	T	0	7	7	0	5	12	0	0
16	8759975	.	G	A	12	9	21	0	0	21	0	0
16	8788386	.	T	C	1	0	1	0	0	1	0	0
16	8788446	.	A	G	7	9	16	0	0	16	0	0
16	8788629	.	T	C	1	0	1	0	2	3	0	0
16	8818958	.	T	C	3	3	6	0	2	8	0	0
16	8845738	.	T	G	4	5	9	0	0	9	0	0
16	8847272	.	T	C	0	5	5	0	0	5	0	0
16	8862269	.	G	A	4	2	6	0	0	6	0	0
16	9276020	.	C	T	8	7	15	0	0	15	0	0
16	9281534	.	G	A	2	2	4	0	0	4	0	0
16	9286997	.	G	A	1	1	2	0	1	3	0	0
16	9299700	.	C	T	3	6	9	0	0	9	0	0
16	9306247	.	A	G	1	3	4	0	0	4	0	0
16	9383456	.	T	A	1	6	7	0	0	7	0	0
16	9409321	.	A	T	0	0	0	0	1	1	0	0
16	9410978	.	C	G	3	2	5	0	0	5	0	0
16	9411898	.	A	G	0	0	0	0	2	2	0	0
16	9411907	.	A	G	1	1	2	0	0	2	0	0
16	9411962	.	G	A	1	5	6	0	0	6	0	0
16	9411965	.	G	A	1	5	6	0	0	6	0	0
16	9412024	.	A	T	4	3	7	0	0	7	0	0
16	9412048	.	T	C	3	2	5	0	1	6	0	0
16	9412302	.	C	T	4	5	9	0	1	10	0	0
16	9412401	.	C	T	2	4	6	0	0	6	0	0
16	9412994	.	G	T	1	2	3	0	1	4	0	0
16	9415749	.	G	A	5	5	10	0	0	10	0	0
16	9415793	.	C	T	6	4	10	0	0	10	0	0
16	9420003	.	G	A	0	5	5	0	0	5	0	0
16	9433915	.	C	T	0	5	5	0	2	7	0	0
16	9437789	.	G	A	1	1	2	0	0	2	0	0
16	9453469	.	T	C	0	2	2	0	0	2	0	0
16	9453471	.	A	G	0	2	2	0	0	2	0	0
16	9596127	.	C	T	1	2	3	0	1	4	0	0
16	9602508	.	C	T	2	5	7	0	0	7	0	0
16	9602523	.	G	A	3	4	7	0	2	9	0	0
16	9602643	.	T	C	0	3	3	0	1	4	0	0
16	9602672	.	A	G	0	1	1	0	0	1	0	0
16	9605436	.	A	T	6	6	12	0	0	12	0	0
16	9605619	.	T	C	6	9	15	0	0	15	0	0
16	9605728	.	G	C	4	5	9	0	0	9	0	0
16	9605823	.	A	T	6	5	11	0	0	11	0	0
16	9605850	.	A	G	8	9	17	0	0	17	0	0
16	9605947	.	A	G	8	15	23	0	0	23	0	0
16	9605982	.	C	A	11	17	28	0	1	29	0	0
16	9606011	.	G	T	10	10	20	0	4	24	0	0
16	9606024	.	C	T	10	8	18	0	3	21	0	0
16	9606048	.	G	A	8	3	11	0	1	12	0	0
16	9714080	.	G	A	7	3	10	0	0	10	0	0
16	9716258	.	T	C	1	3	4	0	0	4	0	0
16	9725137	.	A	T	1	2	3	0	1	4	0	0
16	9748874	.	C	G	1	2	3	0	0	3	0	0
16	9752999	.	A	G	4	1	5	0	0	5	0	0
16	9753005	.	C	G	4	2	6	0	0	6	0	0
16	9753083	.	A	T	1	0	1	0	0	1	0	0
16	9755612	.	C	T	1	2	3	0	0	3	0	0
16	9755647	.	T	C	5	4	9	0	1	10	0	0
16	9758164	.	C	T	2	4	6	0	0	6	0	0
16	9758414	.	T	G	2	6	8	0	0	8	0	0
16	9758452	.	A	T	2	2	4	0	2	6	0	0
16	9758675	.	G	A	0	2	2	0	2	4	0	0
16	9758944	.	G	A	0	8	8	0	7	15	0	0
16	9758956	.	A	G	6	10	16	0	0	16	0	0
16	9759605	.	A	T	6	7	13	0	1	14	0	0
16	9759698	.	A	C	6	4	10	0	0	10	0	0
16	9759820	.	T	A	6	7	13	0	0	13	0	0
16	9759842	.	A	G	5	8	13	0	2	15	0	0
16	9759914	.	A	G	11	6	17	0	0	17	0	0
16	9760006	.	C	T	8	11	19	0	0	19	0	0
16	9760083	.	T	C	10	8	18	0	1	19	0	0
16	9760085	.	C	A	10	9	19	0	0	19	0	0
16	9760248	.	T	C	11	12	23	0	1	24	0	0
16	9760597	.	A	G	4	0	4	0	5	9	0	0
16	9760894	.	A	T	10	6	16	0	0	16	0	0
16	9761141	.	G	A	0	12	12	0	8	20	0	0
16	9761246	.	A	G	10	1	11	0	7	18	0	0
16	9761339	.	A	C	5	4	9	0	4	13	0	0
16	9766586	.	A	C	5	1	6	0	0	6	0	0
16	9766774	.	T	C	7	4	11	0	0	11	0	0
16	9771283	.	C	G	10	12	22	0	0	22	0	0
16	9771284	.	T	C	10	12	22	0	0	22	0	0
16	9774187	.	G	A	9	11	20	0	0	20	0	0
16	9777497	.	T	C	16	21	37	0	4	41	0	0
16	9777589	.	A	T	11	14	25	0	0	25	0	0
16	9777716	.	A	G	3	7	10	0	0	10	0	0
16	9777857	.	T	C	1	3	4	0	0	4	0	0
16	9781031	.	T	C	9	4	13	0	1	14	0	0
16	9785990	.	G	A	12	19	31	0	1	32	0	0
16	9787891	.	T	G	21	20	41	0	0	41	0	0
16	9788110	.	C	T	4	4	8	0	0	8	0	0
16	9788447	.	T	C	4	3	7	0	0	7	0	0
16	9788486	.	G	A	4	9	13	0	0	13	0	0
16	9788672	.	G	A	3	8	11	0	0	11	0	0
16	9788758	.	T	A	3	4	7	0	0	7	0	0
16	9788929	.	T	G	4	9	13	0	0	13	0	0
16	9789007	.	A	T	12	7	19	0	0	19	0	0
16	9789015	.	C	G	6	9	15	0	2	17	0	0
16	9789048	.	G	T	4	8	12	0	0	12	0	0
16	9789063	.	A	C	6	10	16	0	2	18	0	0
16	9789097	.	C	T	7	10	17	0	0	17	0	0
16	9789225	.	A	C	12	11	23	0	0	23	0	0
16	9789513	.	C	G	18	17	35	0	2	37	0	0
16	9789984	.	T	C	15	14	29	0	3	32	0	0
16	9790328	.	C	T	2	2	4	0	0	4	0	0
16	9791111	.	T	G	0	1	1	0	0	1	0	0
16	9796921	.	T	C	1	0	1	0	1	2	0	0
16	9797128	.	A	C	1	0	1	0	2	3	0	0
16	9801943	.	A	G	2	0	2	0	0	2	0	0
16	9807475	.	C	T	0	4	4	0	0	4	0	0
16	9813415	.	C	T	0	2	2	0	0	2	0	0
16	9833794	.	T	A	16	28	44	0	0	44	0	0
16	9833887	.	T	A	20	24	44	0	1	45	0	0
16	9833974	.	G	A	31	24	55	0	2	57	0	0
16	9834135	.	A	C	23	21	44	0	2	46	0	0
16	9834271	.	C	T	17	15	32	0	3	35	0	0
16	9834491	.	T	A	17	8	25	0	2	27	0	0
16	9834518	.	T	G	9	23	32	0	0	32	0	0
16	9834541	.	G	A	10	27	37	0	0	37	0	0
16	9834595	.	A	T	16	22	38	0	1	39	0	0
16	9834748	.	G	C	17	13	30	0	1	31	0	0
16	9834802	.	C	A	10	19	29	0	0	29	0	0
16	9834850	.	A	G	10	16	26	0	0	26	0	0
16	9834960	.	G	A	20	26	46	0	1	47	0	0
16	9835099	.	C	G	12	23	35	0	2	37	0	0
16	9835121	.	G	A	18	31	49	0	0	49	0	0
16	9835250	.	C	G	17	11	28	0	0	28	0	0
16	9847149	.	G	A	9	12	21	0	1	22	0	0
16	9847182	.	T	C	13	13	26	0	1	27	0	0
16	9978438	.	G	A	6	8	14	0	0	14	0	0
16	10026408	.	G	A	1	0	1	0	0	1	0	0
16	10027167	.	G	C	2	0	2	0	1	3	0	0
16	10031406	.	C	T	0	2	2	0	2	4	0	0
16	10055519	.	T	A	2	5	7	0	0	7	0	0
16	10055745	.	C	A	7	2	9	0	0	9	0	0
16	10055799	.	A	T	3	3	6	0	0	6	0	0
16	10066164	.	A	G	3	6	9	0	0	9	0	0
16	10068116	.	C	A	2	1	3	0	0	3	0	0
16	10068125	.	C	G	1	3	4	0	0	4	0	0
16	10068168	.	C	T	3	1	4	0	0	4	0	0
16	10071730	.	G	A	4	5	9	0	0	9	0	0
16	10071777	.	C	T	5	4	9	0	0	9	0	0
16	10199585	.	C	T	2	2	4	0	0	4	0	0
16	10213523	.	A	T	1	1	2	0	0	2	0	0
16	10213529	.	A	G	1	1	2	0	0	2	0	0
16	10213816	.	T	G	1	2	3	0	0	3	0	0
16	10279536	.	G	A	2	4	6	0	0	6	0	0
16	10283438	.	C	A	2	2	4	0	0	4	0	0
16	10284582	.	A	T	8	7	15	0	0	15	0	0
16	10288230	.	A	G	9	8	17	0	2	19	0	0
16	10288260	.	C	T	8	8	16	0	1	17	0	0
16	10288754	.	G	A	2	6	8	0	1	9	0	0
16	10288784	.	C	A	2	7	9	0	0	9	0	0
16	10300046	.	C	T	2	5	7	0	0	7	0	0
16	10300466	.	G	T	3	2	5	0	0	5	0	0
16	10300493	.	A	G	1	3	4	0	1	5	0	0
16	10323903	.	C	T	2	2	4	0	0	4	0	0
16	10325870	.	C	T	11	13	24	0	0	24	0	0
16	10326092	.	C	T	12	15	27	0	4	31	0	0
16	10326347	.	T	G	21	1	22	0	18	40	0	0
16	10337398	.	G	T	0	2	2	0	0	2	0	0
16	10339887	.	C	A	6	2	8	0	0	8	0	0
16	10341816	.	A	C	4	6	10	0	0	10	0	0
16	10342169	.	C	T	2	2	4	0	0	4	0	0
16	10345223	.	T	C	6	4	10	0	0	10	0	0
16	10345595	.	A	G	8	2	10	0	1	11	0	0
16	10345720	.	A	G	5	4	9	0	0	10	1	0
16	10360911	.	T	C	1	2	3	0	1	4	0	0
16	10360935	.	T	C	2	3	5	0	0	5	0	0
16	10360971	.	C	T	2	2	4	0	0	4	0	0
16	10364706	.	T	C	3	4	7	0	0	7	0	0
16	10366768	.	C	T	1	1	2	0	0	2	0	0
16	10367475	.	C	A	5	12	17	0	0	18	1	0
16	10367499	.	C	T	9	6	15	0	1	16	0	0
16	10367624	.	G	A	0	7	7	0	5	12	0	0
16	10367674	.	C	T	4	9	13	0	1	14	0	0
16	10367894	.	A	C	9	5	14	0	1	15	0	0
16	10367961	.	C	T	5	4	9	0	0	9	0	0
16	10368002	.	T	A	8	5	13	0	3	16	0	0
16	10368086	.	A	T	3	4	7	0	0	7	0	0
16	10368098	.	T	C	2	4	6	0	0	6	0	0
16	10368200	.	C	T	3	3	6	0	0	6	0	0
16	10368219	.	T	G	3	4	7	0	0	7	0	0
16	10368352	.	T	G	1	3	4	0	0	4	0	0
16	10368407	.	A	G	1	2	3	0	0	3	0	0
16	10368408	.	C	A	1	2	3	0	0	3	0	0
16	10368452	.	T	A	3	7	10	0	0	10	0	0
16	10368564	.	G	C	8	3	11	0	0	11	0	0
16	10368594	.	C	A	4	6	10	0	1	11	0	0
16	10368713	.	G	T	3	8	11	0	0	11	0	0
16	10368801	.	C	T	6	9	15	0	1	16	0	0
16	10368820	.	C	A	8	10	18	0	0	18	0	0
16	10369068	.	C	T	5	2	7	0	0	7	0	0
16	10369168	.	C	G	7	4	11	0	0	11	0	0
16	10369266	.	G	A	5	6	11	0	2	13	0	0
16	10413724	.	A	C	2	5	7	0	0	7	0	0
16	10413726	.	G	T	5	2	7	0	0	7	0	0
16	10413777	.	T	A	1	8	9	0	0	9	0	0
16	10413957	.	T	C	4	1	5	0	0	5	0	0
16	10417124	.	G	C	4	11	15	0	0	15	0	0
16	10426247	.	T	A	1	2	3	0	0	3	0	0
16	10426265	.	G	C	3	2	5	0	0	5	0	0
16	10426327	.	C	T	1	5	6	0	1	7	0	0
16	10426378	.	C	T	0	3	3	0	0	3	0	0
16	10426522	.	C	A	3	2	5	0	0	5	0	0
16	10426525	.	G	A	0	2	2	0	4	6	0	0
16	10426630	.	A	G	3	2	5	0	0	5	0	0
16	10426762	.	G	A	0	3	3	0	4	7	0	0
16	10427021	.	T	C	4	2	6	0	0	6	0	0
16	10427028	.	G	A	2	4	6	0	0	6	0	0
16	10427576	.	G	A	2	4	6	0	0	6	0	0
16	10427722	.	A	T	2	4	6	0	1	7	0	0
16	10427786	.	T	G	3	6	9	0	0	9	0	0
16	10427827	.	T	C	6	3	9	0	0	9	0	0
16	10427964	.	A	C	4	9	13	0	2	15	0	0
16	10428853	.	C	T	2	3	5	0	0	5	0	0
16	10432113	.	G	A	2	2	4	0	0	4	0	0
16	10432114	.	G	T	2	2	4	0	0	4	0	0
16	10438833	.	G	A	2	1	3	0	0	3	0	0
16	10439910	.	G	A	0	2	2	0	1	3	0	0
16	10444018	.	G	A	1	2	3	0	0	3	0	0
16	10447409	.	A	G	1	1	2	0	0	2	0	0
16	10447445	.	G	A	0	2	2	0	1	3	0	0
16	10447453	.	C	T	1	2	3	0	0	3	0	0
16	10447923	.	C	A	1	0	1	0	0	1	0	0
16	10454950	.	G	A	0	1	1	0	0	1	0	0
16	10461712	.	A	T	1	0	1	0	0	1	0	0
16	10464571	.	C	T	6	7	13	0	0	13	0	0
16	10475645	.	C	T	5	7	12	0	0	12	0	0
16	10475646	.	A	G	5	7	12	0	0	12	0	0
16	10477836	.	C	T	1	8	9	0	12	21	0	0
16	10481425	.	C	T	3	3	6	0	0	6	0	0
16	10481488	.	C	T	0	2	2	0	5	7	0	0
16	10489410	.	G	A	4	3	7	0	0	7	0	0
16	10502065	.	A	G	0	3	3	0	0	3	0	0
16	10502169	.	G	A	1	0	1	0	0	1	0	0
16	10504444	.	C	A	4	4	8	0	0	8	0	0
16	10506411	.	C	T	2	3	5	0	0	5	0	0
16	10620018	.	G	A	0	1	1	0	3	4	0	0
16	10633656	.	C	T	4	6	10	0	0	10	0	0
16	10633690	.	C	A	5	7	12	0	0	12	0	0
16	10634271	.	C	T	4	5	9	0	0	9	0	0
16	10634289	.	T	G	9	5	14	0	0	14	0	0
16	10634650	.	T	C	0	2	2	0	0	2	0	0
16	10635179	.	T	A	2	7	9	0	1	10	0	0
16	10635338	.	A	T	4	9	13	0	0	13	0	0
16	10635401	.	T	G	11	13	24	0	0	24	0	0
16	10635551	.	A	C	5	6	11	0	0	11	0	0
16	10635942	.	A	G	7	7	14	0	0	14	0	0
16	10636168	.	C	T	9	9	18	0	0	18	0	0
16	10636241	.	T	G	4	5	9	0	0	9	0	0
16	10636252	.	A	T	4	2	6	0	0	6	0	0
16	10636418	.	T	C	2	5	7	0	0	7	0	0
16	10636698	.	T	A	11	7	18	0	1	19	0	0
16	10636882	.	C	T	10	7	17	0	1	18	0	0
16	10637192	.	G	A	0	2	2	0	14	16	0	0
16	10637259	.	A	G	18	17	35	0	1	36	0	0
16	10637329	.	C	A	9	7	16	0	1	17	0	0
16	10637379	.	T	A	12	7	19	0	2	21	0	0
16	10637705	.	A	C	4	6	10	0	0	10	0	0
16	10637943	.	T	A	6	5	11	0	1	12	0	0
16	10724812	.	A	G	2	2	4	0	0	4	0	0
16	10731333	.	C	T	6	2	8	0	0	8	0	0
16	10731571	.	A	T	5	6	11	0	0	11	0	0
16	10731648	.	T	C	1	4	5	0	2	7	0	0
16	10731717	.	C	G	5	6	11	0	1	12	0	0
16	10731819	.	T	G	1	2	3	0	0	3	0	0
16	10731995	.	G	A	1	7	8	0	0	8	0	0
16	10732051	.	A	G	2	0	2	0	3	5	0	0
16	10732053	.	A	T	2	3	5	0	0	5	0	0
16	10732140	.	G	A	1	3	4	0	0	4	0	0
16	10733619	.	A	G	3	5	8	0	1	9	0	0
16	10733751	.	A	G	2	4	6	0	0	6	0	0
16	10733829	.	G	C	3	3	6	0	1	7	0	0
16	10734032	.	A	C	4	0	4	0	1	5	0	0
16	10734190	.	T	C	5	3	8	0	0	8	0	0
16	10777025	.	G	A	2	3	5	0	0	5	0	0
16	10795647	.	T	C	6	1	7	0	0	7	0	0
16	10798995	.	A	T	5	3	8	0	0	8	0	0
16	10799155	.	T	C	4	10	14	0	0	14	0	0
16	10801127	.	T	C	7	3	10	0	0	10	0	0
16	10801517	.	T	C	2	6	8	0	0	8	0	0
16	10801682	.	C	T	10	5	15	0	0	15	0	0
16	10804843	.	T	C	12	20	32	0	0	32	0	0
16	10804862	.	A	T	12	25	37	0	0	37	0	0
16	10804878	.	C	T	10	27	37	0	0	37	0	0
16	10807360	.	T	A	12	23	35	0	1	36	0	0
16	10807486	.	C	T	7	14	21	0	0	21	0	0
16	10813138	.	A	C	21	28	49	0	1	51	1	0
16	10813372	.	C	T	16	16	32	0	2	34	0	0
16	10815877	.	T	C	13	17	30	0	0	30	0	0
16	10820157	.	G	A	2	31	33	0	32	65	0	0
16	10820215	.	A	T	29	17	46	0	3	49	0	0
16	10820224	.	T	A	26	25	51	0	1	52	0	0
16	10820803	.	C	T	18	33	51	0	9	60	0	0
16	10820866	.	A	G	14	14	28	0	0	28	0	0
16	10828887	.	T	C	3	1	4	0	0	4	0	0
16	10829276	.	T	A	13	2	15	0	0	15	0	0
16	10829458	.	T	C	17	0	17	0	15	32	0	0
16	10829569	.	A	T	19	5	24	0	0	24	0	0
16	10829633	.	A	T	11	7	18	0	0	18	0	0
16	10829635	.	A	C	10	7	17	0	1	18	0	0
16	10829968	.	T	G	16	9	25	0	2	27	0	0
16	10830013	.	T	G	18	7	25	0	1	26	0	0
16	10830145	.	T	G	13	8	21	0	0	21	0	0
16	10830147	.	T	A	12	8	20	0	1	21	0	0
16	10830309	.	T	A	8	5	13	0	1	14	0	0
16	10830328	.	T	C	9	4	13	0	2	15	0	0
16	10830625	.	G	C	1	3	4	0	1	5	0	0
16	10832217	.	C	T	3	2	5	0	1	6	0	0
16	10833900	.	C	G	2	2	4	0	0	4	0	0
16	10833987	.	G	A	3	4	7	0	0	7	0	0
16	10841193	.	T	C	3	3	6	0	0	6	0	0
16	10841612	.	T	C	3	2	5	0	0	5	0	0
16	10843402	.	A	G	4	0	4	0	4	8	0	0
16	10846654	.	A	G	6	5	11	0	0	11	0	0
16	10855924	.	A	G	12	10	22	0	2	24	0	0
16	10856130	.	A	G	9	7	16	0	1	17	0	0
16	10856235	.	C	G	6	6	12	0	2	14	0	0
16	10856406	.	A	T	8	5	13	0	2	15	0	0
16	10858554	.	G	A	7	13	20	0	0	20	0	0
16	10858656	.	A	G	13	13	26	0	1	27	0	0
16	10859434	.	C	T	19	21	40	0	0	40	0	0
16	10859435	.	T	C	17	22	39	0	1	40	0	0
16	10859857	.	T	C	32	21	53	0	1	54	0	0
16	10861956	.	A	G	22	14	36	0	0	36	0	0
16	10861971	.	T	A	21	13	34	0	0	34	0	0
16	10862331	.	C	G	18	7	25	0	4	29	0	0
16	10862627	.	G	A	0	19	19	0	30	49	0	0
16	10862762	.	C	T	25	16	41	0	1	42	0	0
16	10862773	.	T	C	24	18	42	0	3	45	0	0
16	10919019	.	G	A	3	2	5	0	0	5	0	0
16	10919104	.	A	G	2	3	5	0	0	5	0	0
16	10979967	.	C	G	1	0	1	0	2	3	0	0
16	10987970	.	A	C	6	3	9	0	0	9	0	0
16	10990319	.	A	G	1	4	5	0	0	5	0	0
16	10990915	.	T	A	2	6	8	0	0	8	0	0
16	10990940	.	C	A	2	5	7	0	1	8	0	0
16	11134774	.	T	G	1	1	2	0	0	2	0	0
16	11135904	.	G	A	0	2	2	0	0	2	0	0
16	11137720	.	G	A	3	2	5	0	0	5	0	0
16	11137738	.	T	C	2	2	4	0	0	4	0	0
16	11137873	.	T	C	1	5	6	0	0	6	0	0
16	11137912	.	A	G	1	0	1	0	8	9	0	0
16	11138021	.	C	T	7	9	16	0	0	16	0	0
16	11138081	.	C	T	2	8	10	0	0	10	0	0
16	11138947	.	A	G	1	3	4	0	0	4	0	0
16	11139933	.	A	G	4	2	6	0	0	6	0	0
16	11140004	.	G	A	5	1	6	0	0	6	0	0
16	11140151	.	T	C	3	4	7	0	0	7	0	0
16	11140248	.	T	C	3	5	8	0	0	8	0	0
16	11140569	.	A	G	5	5	10	0	0	10	0	0
16	11140643	.	A	C	2	4	6	0	0	6	0	0
16	11140894	.	A	G	1	5	6	0	0	6	0	0
16	11140933	.	A	T	0	2	2	0	0	2	0	0
16	11140993	.	A	G	3	3	6	0	0	6	0	0
16	11141200	.	C	T	6	4	10	0	0	10	0	0
16	11141430	.	G	A	4	4	8	0	0	8	0	0
16	11141573	.	G	A	2	3	5	1	0	6	0	0
16	11141776	.	C	G	7	3	10	0	1	11	0	0
16	11141836	.	G	A	8	6	14	0	2	16	0	0
16	11141908	.	G	A	0	7	7	0	6	13	0	0
16	11142032	.	A	T	8	6	14	0	0	14	0	0
16	11142428	.	A	G	4	11	15	0	2	17	0	0
16	11142451	.	A	C	8	11	19	0	1	20	0	0
16	11168817	.	A	C	5	4	9	0	0	9	0	0
16	11168831	.	T	C	5	4	9	0	0	9	0	0
16	11169325	.	C	A	3	4	7	0	0	7	0	0
16	11169438	.	C	A	1	4	5	0	2	7	0	0
16	11169447	.	A	G	5	6	11	0	0	11	0	0
16	11169843	.	T	A	2	6	8	0	0	8	0	0
16	11170152	.	C	G	5	6	11	0	0	11	0	0
16	11189286	.	A	G	9	1	10	0	8	18	0	0
16	11190369	.	G	A	0	2	2	0	1	3	0	0
16	11193643	.	A	G	7	9	16	0	1	17	0	0
16	11193652	.	A	G	7	0	7	0	12	19	0	0
16	11199190	.	A	G	9	1	10	0	7	17	0	0
16	11199293	.	T	C	11	15	26	0	0	26	0	0
16	11199460	.	G	A	0	14	14	0	17	31	0	0
16	11199533	.	C	T	13	18	31	0	2	33	0	0
16	11206313	.	A	C	3	6	9	0	0	9	0	0
16	11206316	.	C	T	3	9	12	0	0	12	0	0
16	11212111	.	C	A	18	18	36	0	2	38	0	0
16	11212260	.	C	A	12	21	33	0	1	34	0	0
16	11212438	.	A	G	16	0	16	0	19	35	0	0
16	11215022	.	G	T	10	11	21	0	2	23	0	0
16	11215162	.	T	C	9	12	21	0	4	25	0	0
16	11215163	.	T	C	10	14	24	0	1	25	0	0
16	11215504	.	C	T	15	19	34	0	1	35	0	0
16	11221153	.	A	C	23	19	42	0	0	42	0	0
16	11221667	.	A	G	13	18	31	0	1	32	0	0
16	11222031	.	T	A	15	13	28	0	4	32	0	0
16	11222139	.	G	A	17	21	38	0	0	38	0	0
16	11222738	.	G	A	2	18	20	0	17	37	0	0
16	11227434	.	C	T	3	5	8	0	0	8	0	0
16	11227526	.	T	G	5	5	10	0	1	11	0	0
16	11227537	.	G	A	6	5	11	0	1	12	0	0
16	11227611	.	G	A	3	6	9	0	0	9	0	0
16	11227702	.	G	T	7	1	8	0	0	8	0	0
16	11227711	.	G	A	6	1	7	0	1	8	0	0
16	11227865	.	C	T	0	4	4	0	2	6	0	0
16	11228826	.	G	A	3	2	5	0	0	5	0	0
16	11228848	.	G	C	2	2	4	0	0	4	0	0
16	11241247	.	C	G	1	0	1	0	3	4	0	0
16	11266016	.	T	G	8	4	12	0	0	12	0	0
16	11276019	.	A	T	5	0	5	0	0	5	0	0
16	11290903	.	T	A	9	11	20	0	3	23	0	0
16	11290975	.	A	C	6	16	22	0	0	22	0	0
16	11291799	.	T	C	14	17	31	0	2	33	0	0
16	11291803	.	G	A	12	16	28	0	2	30	0	0
16	11313588	.	T	C	1	3	4	0	0	4	0	0
16	11313612	.	C	T	1	3	4	0	0	4	0	0
16	11313629	.	C	G	1	3	4	0	0	4	0	0
16	11344556	.	C	T	3	4	7	0	0	7	0	0
16	11486258	.	G	A	0	3	3	0	1	4	0	0
16	11506075	.	C	T	2	2	4	0	0	4	0	0
16	11506128	.	G	A	0	0	0	0	1	1	0	0
16	11530746	.	T	G	1	1	2	0	0	2	0	0
16	11531018	.	A	G	3	3	6	0	1	7	0	0
16	11533864	.	T	C	3	2	5	0	0	5	0	0
16	11773932	.	T	C	6	0	6	0	8	14	0	0
16	11774345	.	G	A	10	10	20	0	0	20	0	0
16	11774355	.	C	T	0	12	12	0	7	19	0	0
16	11774398	.	T	C	13	15	28	0	0	28	0	0
16	11774456	.	G	A	9	13	22	0	2	24	0	0
16	11774948	.	T	A	10	13	23	0	2	25	0	0
16	11775084	.	G	T	7	11	18	0	1	21	2	0
16	11775200	.	A	G	9	13	22	0	0	22	0	0
16	11775279	.	T	C	5	12	17	0	1	18	0	0
16	11775485	.	G	A	6	6	12	0	0	12	0	0
16	11775683	.	T	C	3	16	19	0	0	19	0	0
16	11778275	.	C	T	0	6	6	0	5	11	0	0
16	11965486	.	T	C	4	2	6	0	1	7	0	0
16	11974658	.	G	A	5	0	5	0	0	5	0	0
16	11974703	.	G	A	8	2	10	0	1	11	0	0
16	11978028	.	A	G	12	9	21	0	0	21	0	0
16	11978045	.	G	A	11	9	20	0	1	21	0	0
16	11978094	.	A	C	3	7	10	0	0	10	0	0
16	11979590	.	T	C	4	5	9	0	1	10	0	0
16	11982269	.	G	A	4	9	13	0	0	13	0	0
16	11982323	.	G	A	1	1	2	0	0	2	0	0
16	11985606	.	C	T	3	0	3	0	0	3	0	0
16	12052487	.	T	C	2	2	4	0	0	4	0	0
16	12065410	.	A	G	13	6	19	0	1	20	0	0
16	12073577	.	G	A	6	4	10	0	0	10	0	0
16	12076492	.	A	G	6	5	11	0	2	13	0	0
16	12078916	.	A	G	2	1	3	0	0	3	0	0
16	12078976	.	C	T	1	1	2	0	0	2	0	0
16	12078982	.	C	T	0	1	1	0	0	1	0	0
16	12095103	.	T	C	1	2	3	0	0	3	0	0
16	12097292	.	G	T	3	2	5	0	0	5	0	0
16	12102947	.	C	A	32	28	60	0	1	61	0	0
16	12103263	.	A	T	34	24	58	0	3	62	1	0
16	12103292	.	A	T	29	28	57	0	2	59	0	0
16	12103344	.	A	G	28	28	56	0	3	59	0	0
16	12103421	.	T	A	24	31	55	0	1	56	0	0
16	12103530	.	G	A	33	30	63	0	2	65	0	0
16	12103873	.	C	T	2	32	34	0	27	61	0	0
16	12103881	.	G	A	27	29	56	0	3	59	0	0
16	12103934	.	C	T	25	24	49	0	3	52	0	0
16	12103941	.	A	G	27	23	50	0	4	54	0	0
16	12104042	.	C	T	24	26	50	0	0	50	0	0
16	12104043	.	A	T	24	26	50	0	0	50	0	0
16	12104083	.	C	T	28	27	55	0	0	55	0	0
16	12104231	.	C	G	23	28	51	0	0	51	0	0
16	12104350	.	T	C	23	15	38	0	0	38	0	0
16	12104384	.	C	T	26	20	46	0	3	49	0	0
16	12104388	.	T	C	22	21	43	0	4	47	0	0
16	12104509	.	G	A	27	22	49	6	1	56	0	0
16	12104601	.	G	A	36	23	59	0	2	61	0	0
16	12104665	.	A	G	27	19	46	4	4	54	0	0
16	12104794	.	C	T	14	20	34	1	1	36	0	0
16	12104813	.	A	T	24	17	41	0	2	43	0	0
16	12104943	.	A	T	40	8	48	0	1	49	0	0
16	12104944	.	T	G	39	8	47	0	2	49	0	0
16	12105101	.	C	A	24	2	26	0	2	28	0	0
16	12105106	.	G	A	26	5	31	0	0	31	0	0
16	12105196	.	C	A	23	15	38	0	1	39	0	0
16	12105206	.	A	G	24	20	44	0	0	44	0	0
16	12105265	.	T	A	32	11	43	0	1	44	0	0
16	12105443	.	A	T	7	3	10	0	0	10	0	0
16	12105689	.	C	T	0	17	17	0	20	37	0	0
16	12105796	.	C	T	3	29	32	0	22	54	0	0
16	12105854	.	A	G	23	29	52	0	0	52	0	0
16	12108607	.	G	A	22	30	52	0	1	53	0	0
16	12108622	.	A	G	26	29	55	0	2	57	0	0
16	12114975	.	G	A	14	3	17	0	0	17	0	0
16	12118207	.	G	A	17	11	28	0	1	29	0	0
16	12118210	.	C	T	18	9	27	0	1	28	0	0
16	12126930	.	C	G	0	1	1	0	5	6	0	0
16	12135754	.	G	A	8	12	20	0	0	20	0	0
16	12138940	.	A	G	8	7	15	0	1	16	0	0
16	12138964	.	G	T	5	11	16	0	0	16	0	0
16	12138991	.	T	C	6	0	6	0	9	15	0	0
16	12150403	.	A	G	1	1	2	0	0	2	0	0
16	12150415	.	T	C	3	0	3	0	4	7	0	0
16	12150457	.	A	G	5	6	11	0	0	11	0	0
16	12150460	.	C	T	5	8	13	0	0	13	0	0
16	12162370	.	A	C	2	0	2	0	1	3	0	0
16	12173361	.	G	C	1	0	1	0	0	1	0	0
16	12174949	.	G	T	2	3	5	0	0	5	0	0
16	12175281	.	G	A	5	2	7	0	1	8	0	0
16	12175530	.	G	A	4	2	6	0	0	6	0	0
16	12243571	.	C	T	9	4	13	0	0	13	0	0
16	12245691	.	G	A	4	5	9	0	0	9	0	0
16	12245760	.	T	C	2	4	6	0	0	6	0	0
16	12245954	.	C	T	1	3	4	0	0	4	0	0
16	12259023	.	T	C	21	12	33	0	0	33	0	0
16	12259072	.	C	T	21	9	30	0	0	30	0	0
16	12263047	.	C	T	0	2	2	0	3	5	0	0
16	12263223	.	A	G	7	13	20	0	2	22	0	0
16	12263358	.	C	T	1	13	14	0	7	21	0	0
16	12263385	.	G	A	5	11	16	0	0	16	0	0
16	12264912	.	A	T	5	2	7	0	0	7	0	0
16	12264999	.	T	C	3	0	3	0	2	5	0	0
16	12265237	.	A	G	1	2	3	0	0	3	0	0
16	12266130	.	C	A	0	5	5	0	3	8	0	0
16	12266137	.	A	T	2	5	7	0	0	7	0	0
16	12273636	.	G	A	0	1	1	0	1	2	0	0
16	12273653	.	A	G	14	3	17	0	0	17	0	0
16	12276065	.	A	T	14	13	27	0	0	27	0	0
16	12286460	.	A	T	0	1	1	0	0	1	0	0
16	12294273	.	G	A	7	9	16	0	1	17	0	0
16	12346071	.	G	A	2	2	4	0	0	4	0	0
16	12346425	.	G	T	1	2	3	0	0	3	0	0
16	12475737	.	T	C	2	2	4	0	0	4	0	0
16	12475750	.	A	G	2	3	5	0	0	5	0	0
16	12560246	.	C	T	1	2	3	0	0	3	0	0
16	12632664	.	T	C	2	2	4	0	0	4	0	0
16	12636347	.	T	C	3	2	5	0	1	6	0	0
16	12636546	.	T	C	6	3	9	0	1	10	0	0
16	12637140	.	T	C	6	3	9	0	0	9	0	0
16	12637160	.	A	T	7	2	9	0	0	9	0	0
16	12637271	.	G	A	2	2	4	0	0	4	0	0
16	12637284	.	T	C	2	3	5	0	0	5	0	0
16	12637552	.	A	T	5	2	7	0	0	7	0	0
16	12637779	.	C	T	5	4	9	0	0	9	0	0
16	12637822	.	T	C	4	5	9	0	1	10	0	0
16	12637824	.	G	A	0	6	6	0	4	10	0	0
16	12638030	.	A	C	3	3	6	0	1	7	0	0
16	12638062	.	A	G	4	4	8	0	0	8	0	0
16	12638502	.	C	T	1	3	4	0	0	4	0	0
16	12638527	.	C	A	1	3	4	0	1	5	0	0
16	12638612	.	C	G	3	3	6	0	0	6	0	0
16	12638622	.	A	G	3	4	7	0	0	7	0	0
16	12639125	.	A	T	1	3	4	0	1	5	0	0
16	12639184	.	C	G	6	5	11	0	0	11	0	0
16	12639285	.	T	A	9	8	17	0	1	18	0	0
16	12639291	.	C	T	9	9	18	0	0	18	0	0
16	12639320	.	C	G	8	6	14	0	2	16	0	0
16	12639488	.	G	A	3	3	6	0	0	6	0	0
16	12730380	.	A	G	3	6	9	0	1	10	0	0
16	12730412	.	G	A	8	7	15	0	0	15	0	0
16	12730707	.	A	G	0	1	1	0	0	1	0	0
16	12738324	.	G	A	2	7	9	0	0	9	0	0
16	12743927	.	G	A	0	4	4	0	4	8	0	0
16	12748058	.	A	G	1	0	1	0	12	13	0	0
16	12748568	.	T	C	11	10	21	0	5	26	0	0
16	12748944	.	A	G	16	8	24	0	0	24	0	0
16	12754621	.	A	G	15	0	15	0	23	38	0	0
16	12754849	.	T	C	15	16	31	0	0	31	0	0
16	12754858	.	G	T	2	11	13	0	15	28	0	0
16	12755011	.	G	A	19	11	30	0	0	30	0	0
16	12756051	.	G	T	15	17	32	0	3	35	0	0
16	12764221	.	G	A	4	3	7	0	0	7	0	0
16	12794028	.	A	G	4	7	11	0	1	12	0	0
16	12794075	.	C	G	7	5	12	0	0	12	0	0
16	12807129	.	C	G	1	0	1	0	0	1	0	0
16	12812496	.	T	C	2	3	5	0	0	5	0	0
16	12816745	.	A	C	5	7	12	0	0	12	0	0
16	12816975	.	G	A	2	2	4	0	0	4	0	0
16	12821106	.	C	T	18	18	36	0	3	39	0	0
16	12821221	.	G	A	18	30	48	0	0	48	0	0
16	12821370	.	A	T	17	6	23	0	0	23	0	0
16	12821371	.	G	A	17	6	23	0	0	23	0	0
16	12821497	.	T	C	17	22	39	0	2	41	0	0
16	12821620	.	T	C	4	5	9	0	1	10	0	0
16	12882543	.	A	G	16	26	42	0	2	44	0	0
16	12882612	.	C	T	0	13	13	0	22	35	0	0
16	12883126	.	G	A	18	14	32	0	2	34	0	0
16	12883484	.	G	C	11	18	29	0	0	30	1	0
16	12883618	.	C	T	21	11	32	0	1	33	0	0
16	12884054	.	A	T	18	21	39	0	4	43	0	0
16	12884510	.	A	T	3	2	5	0	0	5	0	0
16	12963061	.	T	C	2	3	5	0	1	6	0	0
16	12963109	.	A	G	8	7	15	0	0	15	0	0
16	12963274	.	A	T	5	10	15	0	0	15	0	0
16	12963368	.	G	A	20	8	28	0	1	29	0	0
16	12963384	.	C	T	0	12	12	0	19	31	0	0
16	12963405	.	A	G	15	10	25	0	0	25	0	0
16	12963696	.	T	G	21	26	47	0	4	52	1	0
16	12967855	.	G	A	9	7	16	0	0	16	0	0
16	12981637	.	G	A	3	4	7	0	0	7	0	0
16	12984488	.	C	G	11	5	16	0	0	16	0	0
16	13033243	.	G	A	0	2	2	0	0	2	0	0
16	13180389	.	T	C	2	7	9	0	1	10	0	0
16	13569164	.	A	C	4	3	7	0	0	7	0	0
16	13569165	.	C	T	4	3	7	0	0	7	0	0
16	13569232	.	C	T	0	5	5	0	3	8	0	0
16	13599957	.	G	A	10	14	24	0	1	25	0	0
16	13600680	.	A	C	10	22	32	0	1	33	0	0
16	13601026	.	T	C	15	12	27	0	1	28	0	0
16	13601254	.	G	C	5	2	7	0	0	7	0	0
16	13601328	.	C	T	1	3	4	0	0	4	0	0
16	13602164	.	T	C	17	11	28	0	0	28	0	0
16	13602454	.	T	A	8	7	15	0	0	15	0	0
16	13602488	.	T	C	8	7	15	0	0	15	0	0
16	13602697	.	A	G	12	6	18	0	0	18	0	0
16	13602800	.	T	A	8	9	17	0	1	18	0	0
16	13602922	.	A	G	8	3	11	0	0	11	0	0
16	13603375	.	C	T	3	4	7	0	0	7	0	0
16	13606896	.	A	T	4	2	6	0	0	6	0	0
16	13606977	.	G	A	4	8	12	0	1	13	0	0
16	13610726	.	T	A	12	18	30	0	2	33	1	0
16	13610882	.	G	A	13	10	23	0	0	24	1	0
16	13610966	.	A	G	9	12	21	0	0	21	0	0
16	13611035	.	G	A	6	7	13	0	0	13	0	0
16	13612999	.	T	A	6	1	7	0	0	7	0	0
16	13613104	.	T	C	4	4	8	0	0	8	0	0
16	13617023	.	C	T	0	12	12	0	13	25	0	0
16	13617152	.	C	T	14	7	21	0	1	22	0	0
16	13617291	.	G	A	8	3	11	0	0	11	0	0
16	13617329	.	T	G	10	5	15	0	0	15	0	0
16	13617767	.	G	T	2	3	5	0	0	5	0	0
16	13618170	.	A	G	8	13	21	0	4	25	0	0
16	13618172	.	C	G	14	9	23	0	2	25	0	0
16	13618374	.	A	T	8	13	21	0	2	23	0	0
16	13618644	.	T	A	15	11	26	0	0	26	0	0
16	13619001	.	A	C	5	5	10	0	1	11	0	0
16	13619319	.	T	A	6	5	11	0	0	11	0	0
16	13619436	.	A	G	4	7	11	0	0	11	0	0
16	13619448	.	T	C	4	8	12	0	1	13	0	0
16	13619509	.	G	T	3	7	10	0	1	11	0	0
16	13621056	.	G	A	2	6	8	0	0	8	0	0
16	13623641	.	A	C	10	4	14	0	0	14	0	0
16	13636760	.	G	A	14	17	31	0	1	32	0	0
16	13643969	.	C	A	11	12	23	0	2	25	0	0
16	13644509	.	A	T	8	12	20	0	1	21	0	0
16	13644781	.	T	A	5	3	8	0	1	9	0	0
16	13645076	.	A	T	10	5	15	0	0	15	0	0
16	13645242	.	G	C	9	6	15	0	0	15	0	0
16	13645318	.	T	G	11	8	19	0	0	19	0	0
16	13645419	.	T	A	6	4	10	0	0	10	0	0
16	13673142	.	T	C	13	5	18	0	0	18	0	0
16	13673143	.	T	C	4	14	18	0	0	18	0	0
16	13673734	.	A	C	4	6	10	0	1	11	0	0
16	13673978	.	C	A	9	3	12	0	1	13	0	0
16	13679037	.	A	G	0	1	1	0	0	1	0	0
16	13680487	.	T	G	4	3	7	0	0	7	0	0
16	13680585	.	A	G	6	4	10	0	1	11	0	0
16	13701482	.	C	T	2	9	11	0	0	11	0	0
16	13701599	.	A	G	3	2	5	0	0	5	0	0
16	13706061	.	G	A	0	3	3	0	0	3	0	0
16	13706714	.	G	T	7	3	10	0	1	11	0	0
16	13721408	.	C	T	9	5	14	0	0	14	0	0
16	13721420	.	G	A	4	8	12	0	0	12	0	0
16	13729810	.	C	T	2	3	5	0	0	5	0	0
16	13741584	.	C	T	6	2	8	0	0	8	0	0
16	13743117	.	T	C	2	0	2	0	4	6	0	0
16	13743198	.	G	T	2	8	10	0	0	10	0	0
16	13743327	.	C	T	0	3	3	0	12	15	0	0
16	13743345	.	T	C	8	4	12	0	1	13	0	0
16	13743405	.	G	T	1	2	3	0	0	3	0	0
16	13780375	.	G	A	2	4	6	0	0	6	0	0
16	13789765	.	G	A	2	3	5	0	0	5	0	0
16	13810417	.	G	A	3	3	6	0	0	6	0	0
16	13818640	.	T	A	3	2	5	0	0	5	0	0
16	13818644	.	G	A	3	2	5	0	0	5	0	0
16	13819008	.	T	C	1	1	2	0	0	2	0	0
16	13826195	.	C	T	3	7	10	0	0	10	0	0
16	13841360	.	T	A	4	4	8	0	1	9	0	0
16	13845368	.	G	A	0	12	12	0	14	26	0	0
16	13845846	.	A	G	9	13	22	0	2	24	0	0
16	13845952	.	G	C	2	2	4	0	0	4	0	0
16	13855142	.	T	C	9	9	18	0	0	18	0	0
16	13855472	.	T	C	11	6	17	0	0	17	0	0
16	13855482	.	T	A	4	9	13	0	0	13	0	0
16	13870508	.	A	C	10	8	18	0	1	19	0	0
16	13870517	.	A	G	10	9	19	0	0	19	0	0
16	13870685	.	A	C	5	6	11	0	1	12	0	0
16	13870857	.	T	A	5	5	10	0	0	10	0	0
16	13875968	.	G	A	1	3	4	0	1	5	0	0
16	13876917	.	T	C	1	2	3	0	0	3	0	0
16	13883980	.	A	C	13	2	15	0	0	15	0	0
16	14010794	.	C	T	1	0	1	0	0	1	0	0
16	14016057	.	T	C	1	0	1	0	0	1	0	0
16	14021817	.	G	T	3	6	9	0	0	9	0	0
16	14021886	.	C	T	6	5	11	0	0	11	0	0
16	14021907	.	T	A	1	1	2	0	0	2	0	0
16	14022035	.	A	C	5	5	10	0	1	11	0	0
16	14022445	.	T	C	15	10	25	0	1	26	0	0
16	14022585	.	C	A	4	10	14	0	2	16	0	0
16	14022697	.	T	A	7	5	12	0	0	12	0	0
16	14022767	.	T	A	7	0	7	0	0	7	0	0
16	14022774	.	C	T	5	1	6	0	1	7	0	0
16	14022975	.	G	T	2	5	7	0	0	7	0	0
16	14022976	.	T	A	2	5	7	0	0	7	0	0
16	14029359	.	A	C	6	5	11	0	1	12	0	0
16	14039604	.	T	C	0	1	1	0	1	2	0	0
16	14039616	.	A	C	1	1	2	0	0	2	0	0
16	14051150	.	G	C	22	11	33	0	1	34	0	0
16	14051249	.	T	C	16	13	29	0	1	30	0	0
16	14051329	.	A	T	14	22	36	0	1	37	0	0
16	14051339	.	A	C	17	18	35	0	2	38	1	0
16	14052681	.	A	G	17	17	34	0	0	34	0	0
16	14055071	.	A	T	4	9	13	0	1	14	0	0
16	14094219	.	A	G	7	5	12	0	0	12	0	0
16	14094222	.	C	A	7	4	11	0	0	11	0	0
16	14094364	.	A	C	4	9	13	0	0	13	0	0
16	14094422	.	C	G	13	11	24	0	0	24	0	0
16	14094601	.	G	A	12	17	29	0	1	30	0	0
16	14094604	.	T	A	13	18	31	0	0	31	0	0
16	14094640	.	G	T	12	12	24	0	0	24	0	0
16	14094668	.	T	A	12	8	20	0	1	21	0	0
16	14094801	.	C	T	16	1	17	0	0	17	0	0
16	14094806	.	G	A	16	1	17	0	0	17	0	0
16	14095097	.	C	T	0	6	6	0	8	14	0	0
16	14095126	.	T	A	7	2	9	0	0	9	0	0
16	14095176	.	A	T	6	2	8	0	0	8	0	0
16	14095183	.	G	C	6	1	7	0	2	9	0	0
16	14095279	.	C	A	10	13	23	0	1	24	0	0
16	14095397	.	A	C	12	16	28	0	1	29	0	0
16	14095563	.	A	C	14	0	14	0	8	22	0	0
16	14098014	.	C	T	10	12	22	0	1	23	0	0
16	14101832	.	G	A	1	2	3	0	0	3	0	0
16	14101864	.	T	C	4	7	11	0	1	12	0	0
16	14126267	.	C	T	3	8	11	0	1	12	0	0
16	14126294	.	T	C	3	6	9	0	0	9	0	0
16	14133317	.	G	A	1	3	4	0	0	4	0	0
16	14133521	.	G	A	9	11	20	0	0	20	0	0
16	14133547	.	G	T	11	13	24	0	0	24	0	0
16	14133721	.	C	T	5	4	9	0	0	9	0	0
16	14133734	.	A	C	5	5	10	0	0	10	0	0
16	14133910	.	C	G	4	5	9	0	0	9	0	0
16	14134020	.	C	T	0	8	8	0	5	13	0	0
16	14134116	.	A	T	2	1	3	0	0	3	0	0
16	14154105	.	A	G	3	5	8	0	0	8	0	0
16	14154150	.	T	G	8	9	17	0	0	17	0	0
16	14154240	.	T	A	4	10	14	0	0	14	0	0
16	14154324	.	T	C	4	0	4	0	7	11	0	0
16	14154708	.	G	A	6	3	9	0	0	9	0	0
16	14155364	.	T	C	1	4	5	0	1	6	0	0
16	14155605	.	T	A	4	5	9	0	0	9	0	0
16	14155997	.	A	T	3	3	6	0	0	6	0	0
16	14156157	.	T	C	2	2	4	0	1	5	0	0
16	14156177	.	G	A	4	3	7	0	0	7	0	0
16	14157210	.	C	T	3	2	5	0	0	5	0	0
16	14157316	.	A	G	3	2	5	0	0	5	0	0
16	14157390	.	G	A	2	2	4	0	0	4	0	0
16	14157447	.	T	A	1	4	5	0	0	5	0	0
16	14157448	.	A	T	1	4	5	0	0	5	0	0
16	14158490	.	G	A	3	2	5	0	0	5	0	0
16	14158619	.	G	A	1	5	6	0	0	6	0	0
16	14158655	.	T	C	3	5	8	0	0	8	0	0
16	14158666	.	T	G	2	3	5	0	0	5	0	0
16	14167480	.	T	C	1	2	3	0	0	3	0	0
16	14202192	.	A	C	5	4	9	0	0	9	0	0
16	14202197	.	T	A	5	2	7	0	0	7	0	0
16	14206289	.	G	A	2	1	3	0	0	3	0	0
16	14209195	.	G	A	2	1	3	0	0	3	0	0
16	14209348	.	T	C	6	12	18	0	0	18	0	0
16	14210949	.	A	C	1	2	3	0	0	3	0	0
16	14212079	.	G	C	1	8	9	0	8	17	0	0
16	14214643	.	A	T	3	0	3	0	0	3	0	0
16	14215565	.	C	G	2	2	4	0	0	4	0	0
16	14223252	.	C	T	2	2	4	0	0	4	0	0
16	14224041	.	T	G	1	1	2	0	0	2	0	0
16	14226046	.	G	A	0	3	3	0	6	9	0	0
16	14227913	.	C	T	0	4	4	0	0	4	0	0
16	14228668	.	A	G	1	1	2	0	0	2	0	0
16	14229614	.	A	G	3	4	7	0	1	8	0	0
16	14230222	.	A	G	2	5	7	0	1	8	0	0
16	14230373	.	T	C	11	3	14	0	0	14	0	0
16	14231135	.	G	A	0	6	6	0	11	17	0	0
16	14231138	.	C	T	9	7	16	0	1	17	0	0
16	14231207	.	T	A	7	5	12	0	0	12	0	0
16	14231730	.	G	A	9	14	23	0	1	24	0	0
16	14242688	.	C	T	0	6	6	0	5	11	0	0
16	14255926	.	T	C	1	0	1	0	0	1	0	0
16	14269885	.	G	A	1	2	3	0	0	3	0	0
16	14269906	.	G	A	3	3	6	0	0	6	0	0
16	14269975	.	C	T	1	0	1	0	0	1	0	0
16	14278173	.	C	T	1	2	3	0	0	3	0	0
16	14383703	.	C	T	1	4	5	0	0	5	0	0
16	14383724	.	A	C	1	0	1	0	3	4	0	0
16	14416520	.	C	T	4	5	9	0	1	10	0	0
16	14416599	.	C	T	5	7	12	0	0	12	0	0
16	14416622	.	C	T	5	4	9	0	0	9	0	0
16	14588390	.	T	C	1	3	4	0	0	4	0	0
16	14588430	.	A	G	0	2	2	0	0	2	0	0
16	14588705	.	C	T	0	2	2	0	0	2	0	0
16	14602380	.	C	G	1	2	3	0	0	3	0	0
16	14627207	.	T	C	1	1	2	0	0	2	0	0
16	14627294	.	G	A	4	7	11	0	0	11	0	0
16	14638413	.	G	A	1	2	3	0	0	3	0	0
16	14638476	.	C	T	3	2	5	0	0	5	0	0
16	14670907	.	G	T	1	3	4	0	0	4	0	0
16	14671098	.	A	T	1	4	5	0	0	5	0	0
16	14671099	.	A	T	1	4	5	0	0	5	0	0
16	14674718	.	T	G	5	6	11	0	0	11	0	0
16	14674855	.	A	G	4	7	11	0	0	11	0	0
16	14674924	.	A	G	8	4	12	0	0	12	0	0
16	14674930	.	A	G	5	5	10	0	0	10	0	0
16	14675101	.	T	A	8	5	13	0	1	15	1	0
16	14675373	.	A	C	10	11	21	0	1	22	0	0
16	14675413	.	G	T	0	10	10	0	4	14	0	0
16	14675513	.	A	C	4	5	9	0	0	9	0	0
16	14675572	.	G	A	8	9	17	0	0	17	0	0
16	14675658	.	A	G	5	17	22	0	1	23	0	0
16	14675697	.	A	T	6	14	20	0	0	20	0	0
16	14901812	.	C	T	0	2	2	0	0	2	0	0
16	14933154	.	A	G	1	0	1	0	2	3	0	0
16	15034906	.	C	T	4	3	7	0	0	7	0	0
16	15048338	.	G	A	0	4	4	0	11	15	0	0
16	15048561	.	G	T	14	7	21	0	0	21	0	0
16	15048737	.	A	T	6	2	8	0	1	9	0	0
16	15049194	.	C	T	2	0	2	0	0	2	0	0
16	15049220	.	C	T	4	2	6	0	0	6	0	0
16	15050113	.	G	A	0	2	2	0	6	8	0	0
16	15050367	.	C	A	14	17	31	0	0	31	0	0
16	15165052	.	T	C	2	0	2	0	3	5	0	0
16	15165153	.	A	G	3	3	6	0	0	6	0	0
16	15944980	.	A	T	6	6	12	0	0	12	0	0
16	15987984	.	A	G	1	2	3	0	0	3	0	0
16	16042986	.	T	C	6	16	22	0	0	22	0	0
16	16081095	.	C	G	0	1	1	0	2	3	0	0
16	16081104	.	T	A	2	1	3	0	0	3	0	0
16	16165179	.	T	A	21	38	59	1	0	60	0	0
16	16165361	.	A	G	42	27	69	0	2	72	1	0
16	16165418	.	C	T	36	25	61	0	5	66	0	0
16	16165725	.	A	C	38	35	73	0	2	75	0	0
16	16212520	.	A	G	2	3	5	0	0	5	0	0
16	16232963	.	T	C	4	5	9	0	0	9	0	0
16	16233410	.	A	G	8	4	12	0	0	12	0	0
16	16234309	.	C	A	0	5	5	0	3	8	0	0
16	16234840	.	A	T	4	3	7	0	0	7	0	0
16	16267895	.	G	A	0	2	2	0	1	3	0	0
16	16267903	.	A	G	1	2	3	0	0	3	0	0
16	16269593	.	G	C	2	2	4	0	0	4	0	0
16	16269690	.	G	A	1	4	5	0	2	7	0	0
16	16269724	.	G	A	2	2	4	0	0	4	0	0
16	16269964	.	T	C	4	3	7	0	0	7	0	0
16	16270163	.	C	A	2	4	6	0	0	6	0	0
16	16271683	.	G	A	1	3	4	0	0	4	0	0
16	16276938	.	T	C	1	2	3	0	0	3	0	0
16	16277689	.	A	G	5	6	11	0	0	11	0	0
16	16277728	.	G	A	2	5	7	0	0	7	0	0
16	16277954	.	G	A	2	8	10	0	0	10	0	0
16	16278013	.	A	T	4	7	11	0	0	11	0	0
16	16278043	.	T	C	3	5	8	0	0	8	0	0
16	16278172	.	G	T	0	2	2	0	3	5	0	0
16	16281740	.	A	C	4	11	15	0	0	15	0	0
16	16283706	.	A	G	1	6	7	0	4	11	0	0
16	16284057	.	T	C	6	6	12	0	0	12	0	0
16	16284159	.	G	A	0	10	10	0	14	24	0	0
16	16284192	.	C	A	10	8	18	0	2	20	0	0
16	16289121	.	C	T	9	5	14	0	1	15	0	0
16	16297057	.	G	A	0	1	1	0	0	1	0	0
16	16302166	.	T	C	7	10	17	0	0	17	0	0
16	16302247	.	A	T	10	11	21	0	2	23	0	0
16	16302371	.	A	C	8	9	17	0	0	17	0	0
16	16302426	.	T	A	5	14	19	0	1	20	0	0
16	16302477	.	G	A	1	14	15	0	6	21	0	0
16	16302835	.	T	C	12	9	21	0	0	21	0	0
16	16303025	.	C	T	15	21	36	0	1	37	0	0
16	16303065	.	A	G	10	19	29	0	0	29	0	0
16	16303086	.	T	A	8	16	24	0	3	27	0	0
16	16303163	.	G	A	2	13	15	0	6	21	0	0
16	16303196	.	A	G	15	1	16	0	6	22	0	0
16	16303293	.	T	G	11	10	21	0	1	22	0	0
16	16553899	.	C	T	8	2	10	0	1	11	0	0
16	16555611	.	A	G	16	10	26	0	1	27	0	0
16	16555975	.	T	A	11	6	17	0	1	18	0	0
16	16565963	.	G	C	14	6	20	0	0	20	0	0
16	16565998	.	C	T	6	5	11	0	1	12	0	0
16	16566182	.	T	C	4	8	12	0	0	12	0	0
16	16566402	.	G	A	0	3	3	0	0	3	0	0
16	16569047	.	G	A	5	1	6	0	0	6	0	0
16	16569578	.	C	G	3	3	6	0	0	6	0	0
16	16574168	.	T	C	1	0	1	0	0	1	0	0
16	16586232	.	C	T	8	5	13	0	4	17	0	0
16	16586290	.	G	A	7	11	18	0	1	19	0	0
16	16589462	.	G	A	1	1	2	0	0	2	0	0
16	16589552	.	G	A	2	2	4	0	0	4	0	0
16	16590715	.	T	C	3	4	7	0	1	8	0	0
16	16597754	.	G	A	2	5	7	0	0	7	0	0
16	16597863	.	A	G	5	4	9	0	0	9	0	0
16	16849374	.	G	C	0	2	2	0	0	2	0	0
16	16908487	.	C	T	1	3	4	0	0	4	0	0
16	16908586	.	G	A	1	3	4	0	0	4	0	0
16	16913102	.	G	A	3	3	6	0	0	6	0	0
16	16916699	.	G	A	3	2	5	0	0	5	0	0
16	16916955	.	A	G	2	0	2	0	6	8	0	0
16	16920823	.	G	A	5	4	9	0	0	9	0	0
16	16921134	.	G	A	3	2	5	0	0	5	0	0
16	16939266	.	T	C	1	2	3	0	0	3	0	0
16	16939663	.	G	T	1	2	3	0	0	3	0	0
16	16940732	.	A	G	3	4	7	0	0	7	0	0
16	16940768	.	A	G	6	0	6	0	7	13	0	0
16	16941121	.	G	A	0	8	8	0	6	14	0	0
16	16941237	.	G	A	0	17	17	0	14	31	0	0
16	16941270	.	G	A	0	7	7	0	15	22	0	0
16	16941343	.	G	A	2	10	12	0	0	12	0	0
16	16941361	.	T	C	2	9	11	0	1	12	0	0
16	16941394	.	C	T	4	8	12	0	0	12	0	0
16	16941741	.	C	T	12	8	20	0	0	20	0	0
16	16941979	.	C	A	9	6	15	0	2	17	0	0
16	16942001	.	G	A	0	3	3	0	9	12	0	0
16	16942097	.	C	T	2	4	6	0	0	6	0	0
16	16942130	.	C	A	3	6	9	0	1	10	0	0
16	16942200	.	C	T	5	5	10	0	2	12	0	0
16	16942293	.	T	A	14	7	21	0	0	21	0	0
16	16942332	.	G	A	10	7	17	0	0	17	0	0
16	16942867	.	A	G	10	14	24	0	1	25	0	0
16	16942906	.	C	G	8	14	22	0	0	22	0	0
16	16942953	.	A	G	9	14	23	0	0	23	0	0
16	16943258	.	C	A	10	8	18	0	1	19	0	0
16	16943348	.	C	A	9	12	21	0	0	21	0	0
16	16943388	.	T	A	9	3	12	0	0	12	0	0
16	16943651	.	A	T	11	10	21	0	0	21	0	0
16	16944023	.	G	T	9	12	21	0	0	21	0	0
16	16944066	.	T	C	8	9	17	0	0	17	0	0
16	16944142	.	A	T	3	17	20	0	1	21	0	0
16	16944150	.	T	C	2	19	21	0	1	22	0	0
16	16944884	.	A	G	11	7	18	0	1	19	0	0
16	16945328	.	G	A	8	12	20	0	2	22	0	0
16	16945365	.	T	G	7	12	19	0	2	21	0	0
16	17062434	.	A	C	2	2	4	0	0	4	0	0
16	17107692	.	G	A	2	2	4	0	0	4	0	0
16	17107734	.	A	G	1	2	3	0	1	4	0	0
16	17120136	.	C	T	9	10	19	0	1	20	0	0
16	17137031	.	A	G	2	4	6	0	0	6	0	0
16	17161709	.	T	A	5	4	9	0	0	9	0	0
16	17161739	.	G	A	7	3	10	0	1	11	0	0
16	17161877	.	A	G	6	5	11	0	0	11	0	0
16	17195343	.	A	G	1	1	2	0	0	2	0	0
16	17235486	.	A	G	3	2	5	0	0	5	0	0
16	17235677	.	C	T	1	0	1	0	0	1	0	0
16	17235730	.	A	G	1	1	2	0	0	2	0	0
16	17238475	.	T	A	1	2	3	0	0	3	0	0
16	17238490	.	A	G	1	2	3	0	0	3	0	0
16	17252774	.	G	T	6	8	14	0	0	14	0	0
16	17253161	.	A	G	7	4	11	0	1	12	0	0
16	17253189	.	T	A	7	6	13	0	1	14	0	0
16	17253223	.	A	G	3	7	10	0	1	11	0	0
16	17253274	.	T	C	4	9	13	0	0	13	0	0
16	17254689	.	G	T	4	1	5	0	1	6	0	0
16	17254696	.	A	T	4	2	6	0	0	6	0	0
16	17256120	.	C	T	3	5	8	0	0	8	0	0
16	17256243	.	G	C	2	0	2	0	0	2	0	0
16	17302526	.	T	C	5	7	12	0	0	12	0	0
16	17302821	.	A	G	3	3	6	0	0	6	0	0
16	17305481	.	T	C	2	3	5	0	0	5	0	0
16	17305620	.	A	G	0	1	1	0	0	1	0	0
16	17465977	.	T	A	3	4	7	0	0	7	0	0
16	17466463	.	C	G	1	2	3	0	0	3	0	0
16	17466824	.	A	T	4	3	7	0	0	7	0	0
16	17466839	.	T	G	1	3	4	0	0	4	0	0
16	17548995	.	C	A	1	2	3	0	0	3	0	0
16	17549087	.	G	A	3	3	6	0	0	6	0	0
16	17549176	.	G	T	2	6	8	0	0	8	0	0
16	17549282	.	G	T	1	2	3	0	0	3	0	0
16	17550202	.	T	C	2	2	4	0	1	5	0	0
16	17551191	.	G	T	1	3	4	0	0	4	0	0
16	17578172	.	A	G	1	3	4	0	0	4	0	0
16	17578203	.	A	G	1	3	4	0	0	4	0	0
16	17580036	.	C	T	8	5	13	0	0	13	0	0
16	17585730	.	T	A	3	4	7	0	0	7	0	0
16	17586674	.	T	C	1	2	3	0	0	3	0	0
16	17646269	.	T	C	3	7	10	0	0	10	0	0
16	17798055	.	T	C	3	8	11	0	0	11	0	0
16	17798056	.	C	T	3	8	11	0	0	11	0	0
16	18535689	.	G	A	3	4	7	0	1	8	0	0
16	18570439	.	C	T	6	3	9	0	0	9	0	0
16	19100141	.	C	T	5	3	8	0	0	8	0	0
16	19100144	.	T	A	5	3	8	0	0	8	0	0
16	19124404	.	T	C	2	0	2	0	0	2	0	0
16	19124452	.	A	G	2	0	2	0	0	2	0	0
16	19126439	.	A	G	3	0	3	0	1	4	0	0
16	19136123	.	A	G	1	1	2	0	0	2	0	0
16	19136328	.	C	T	2	3	5	0	0	5	0	0
16	19141337	.	T	C	2	1	3	0	0	3	0	0
16	19143578	.	T	C	1	1	2	0	0	2	0	0
16	19143714	.	G	T	1	0	1	0	0	1	0	0
16	19145102	.	C	T	1	2	3	0	0	3	0	0
16	19150643	.	A	T	2	2	4	0	0	4	0	0
16	19150678	.	C	T	6	6	12	0	0	12	0	0
16	19150973	.	A	G	5	2	7	0	0	7	0	0
16	19151174	.	C	A	3	5	8	0	0	8	0	0
16	19151534	.	T	C	7	7	14	0	0	14	0	0
16	19151656	.	G	T	7	5	12	0	0	13	1	0
16	19151694	.	T	C	0	4	4	0	2	6	0	0
16	19151699	.	C	T	2	4	6	0	0	6	0	0
16	19151762	.	C	T	1	2	3	0	0	3	0	0
16	19182373	.	T	G	0	2	2	0	1	3	0	0
16	19538923	.	G	A	2	3	5	0	0	5	0	0
16	19643784	.	A	G	1	4	5	0	0	5	0	0
16	19681001	.	C	T	1	2	3	0	0	3	0	0
16	19840562	.	T	C	13	11	24	0	0	24	0	0
16	19840645	.	T	A	11	6	17	0	0	17	0	0
16	19840658	.	A	C	8	9	17	0	2	19	0	0
16	19840792	.	C	T	16	13	29	0	1	30	0	0
16	19841213	.	G	A	16	15	31	0	2	33	0	0
16	19841215	.	C	T	17	15	32	0	1	33	0	0
16	19841443	.	G	C	6	5	11	0	2	13	0	0
16	19841501	.	T	C	5	9	14	0	0	14	0	0
16	19841502	.	A	T	8	3	11	0	2	14	1	0
16	19841591	.	A	G	9	16	25	0	1	26	0	0
16	19841720	.	A	G	16	6	22	0	0	22	0	0
16	19841786	.	A	T	9	9	18	0	0	18	0	0
16	19841890	.	G	A	3	10	13	0	0	13	0	0
16	19841922	.	G	A	4	3	7	0	0	7	0	0
16	19842493	.	G	A	2	12	14	0	0	14	0	0
16	19842530	.	A	G	0	9	9	0	1	10	0	0
16	19843053	.	G	T	15	9	24	0	1	25	0	0
16	19843056	.	G	T	10	15	25	0	0	25	0	0
16	19850746	.	G	A	10	4	14	0	0	14	0	0
16	19853074	.	G	A	2	2	4	0	0	4	0	0
16	19853098	.	C	T	8	10	18	0	0	18	0	0
16	19853125	.	A	T	14	12	26	0	1	27	0	0
16	19853230	.	A	C	5	4	9	0	0	9	0	0
16	19854886	.	C	T	0	3	3	0	1	4	0	0
16	19861463	.	A	G	1	4	5	0	0	5	0	0
16	19861475	.	G	A	2	1	3	0	0	3	0	0
16	19864588	.	G	T	2	5	7	0	1	8	0	0
16	19878856	.	G	A	5	4	9	0	0	9	0	0
16	20140877	.	T	G	2	7	9	0	1	10	0	0
16	20151309	.	C	T	6	9	15	0	0	15	0	0
16	20151397	.	C	T	9	17	26	0	2	28	0	0
16	20151460	.	C	T	8	10	18	0	0	18	0	0
16	20151841	.	T	C	9	10	19	0	0	19	0	0
16	20151991	.	G	A	13	8	21	0	1	22	0	0
16	20152044	.	C	A	6	7	13	0	0	17	4	0
16	20152128	.	G	A	0	5	5	0	7	12	0	0
16	20152474	.	A	G	0	3	3	0	0	3	0	0
16	20152476	.	C	A	0	3	3	0	0	3	0	0
16	20164230	.	A	G	1	3	4	0	0	4	0	0
16	20173428	.	T	G	0	2	2	0	0	2	0	0
16	20187253	.	G	T	1	2	3	0	0	3	0	0
16	20238911	.	C	T	7	9	16	0	1	17	0	0
16	20265567	.	C	T	0	1	1	0	0	1	0	0
16	20265655	.	T	C	0	10	10	0	8	18	0	0
16	20265928	.	C	T	2	4	6	0	0	6	0	0
16	20266055	.	T	C	2	3	5	0	0	5	0	0
16	20266321	.	T	C	4	8	12	0	0	12	0	0
16	20266553	.	T	A	0	2	2	0	1	3	0	0
16	20266799	.	A	C	6	5	11	0	1	12	0	0
16	20266840	.	T	A	7	7	14	0	0	14	0	0
16	20266900	.	T	C	3	2	5	0	0	5	0	0
16	20267909	.	A	T	4	3	7	0	1	8	0	0
16	20268143	.	T	A	2	2	4	0	0	4	0	0
16	20268145	.	T	A	2	2	4	0	0	4	0	0
16	20268470	.	C	T	2	6	8	0	0	8	0	0
16	20289511	.	T	C	3	5	8	0	0	8	0	0
16	20289537	.	T	C	1	2	3	0	0	3	0	0
16	20291223	.	G	C	1	0	1	0	0	1	0	0
16	20292156	.	T	C	2	4	6	0	0	6	0	0
16	20318550	.	G	A	2	0	2	0	0	2	0	0
16	20324870	.	C	T	5	8	13	0	0	13	0	0
16	20324891	.	A	G	7	2	9	0	1	10	0	0
16	20328092	.	C	T	0	3	3	0	5	8	0	0
16	20402034	.	A	C	2	0	2	0	3	5	0	0
16	20492447	.	G	T	3	3	6	0	0	6	0	0
16	20497200	.	G	A	1	4	5	0	0	5	0	0
16	20497242	.	C	T	3	3	6	0	0	6	0	0
16	20499859	.	G	A	1	1	2	0	1	3	0	0
16	20512387	.	G	C	0	3	3	0	0	3	0	0
16	20512408	.	A	C	0	3	3	0	0	3	0	0
16	20512661	.	T	C	8	3	11	0	2	13	0	0
16	20513103	.	T	G	9	0	9	0	9	18	0	0
16	20513152	.	A	G	14	8	22	0	3	25	0	0
16	20514738	.	G	A	3	7	10	0	0	10	0	0
16	20800347	.	C	T	6	4	10	0	0	10	0	0
16	20806487	.	C	T	25	17	42	0	3	45	0	0
16	20813628	.	C	T	3	16	19	0	18	37	0	0
16	20822881	.	T	C	6	2	8	0	0	8	0	0
16	20824508	.	C	G	3	0	3	0	0	3	0	0
16	20824566	.	C	T	10	14	24	0	2	26	0	0
16	20826697	.	T	C	7	13	20	0	1	21	0	0
16	20826703	.	G	A	10	6	16	0	2	18	0	0
16	20836206	.	C	T	1	8	9	0	1	10	0	0
16	20836218	.	G	A	10	3	13	0	1	14	0	0
16	20855582	.	G	A	6	4	10	0	1	11	0	0
16	20855636	.	C	T	12	13	25	0	0	25	0	0
16	20889325	.	C	T	4	3	7	0	1	8	0	0
16	21038585	.	A	T	7	7	14	0	0	14	0	0
16	21038697	.	A	C	6	9	15	0	2	17	0	0
16	21038801	.	T	A	11	15	26	0	1	27	0	0
16	21038832	.	T	A	15	12	27	0	1	28	0	0
16	21038924	.	G	A	11	8	19	0	0	19	0	0
16	21039939	.	G	C	7	10	17	0	0	17	0	0
16	21180758	.	T	C	1	0	1	0	3	4	0	0
16	21180794	.	G	A	1	2	3	0	0	3	0	0
16	21398935	.	G	A	3	2	5	0	0	5	0	0
16	21443274	.	C	T	2	3	5	0	0	5	0	0
16	21443297	.	A	T	1	2	3	0	0	3	0	0
16	21443326	.	C	A	1	2	3	0	0	3	0	0
16	21444126	.	A	T	1	2	3	0	0	3	0	0
16	21548456	.	C	T	4	3	7	0	2	9	0	0
16	21548547	.	G	A	9	6	15	0	0	15	0	0
16	21548556	.	G	A	9	6	15	0	0	15	0	0
16	21548625	.	G	T	5	11	16	0	1	17	0	0
16	21548776	.	C	T	6	7	13	0	0	13	0	0
16	21548881	.	T	C	9	9	18	0	0	18	0	0
16	21548891	.	A	T	9	8	17	0	0	17	0	0
16	21549022	.	C	T	0	11	11	0	8	19	0	0
16	21549231	.	T	A	4	4	8	0	1	9	0	0
16	21549520	.	C	T	0	6	6	0	9	15	0	0
16	21549539	.	A	C	5	5	10	0	0	10	0	0
16	21549600	.	T	A	8	3	11	0	0	11	0	0
16	21549924	.	C	T	5	5	10	0	0	10	0	0
16	21549984	.	C	T	0	3	3	0	5	8	0	0
16	21550124	.	G	A	1	2	3	0	0	3	0	0
16	21550251	.	C	A	6	4	10	0	0	10	0	0
16	21550255	.	T	A	5	3	8	0	2	10	0	0
16	21551515	.	G	C	1	1	2	0	0	3	1	0
16	21551687	.	T	C	1	2	3	0	0	3	0	0
16	21551692	.	C	T	1	2	3	0	0	3	0	0
16	21551819	.	T	G	4	3	7	0	0	7	0	0
16	21551928	.	T	C	1	3	4	0	0	4	0	0
16	21551929	.	C	A	1	3	4	0	0	4	0	0
16	21552026	.	C	T	0	2	2	0	1	3	0	0
16	21552029	.	T	C	1	2	3	0	0	3	0	0
16	21553079	.	C	T	1	1	2	0	0	2	0	0
16	21553096	.	G	T	1	0	1	0	1	2	0	0
16	21651780	.	T	C	10	0	10	0	8	18	0	0
16	21652059	.	T	A	1	6	7	0	0	7	0	0
16	21655336	.	C	T	8	3	11	0	0	11	0	0
16	21655611	.	G	A	2	5	7	0	3	10	0	0
16	21663023	.	G	A	3	2	5	0	0	5	0	0
16	21665403	.	G	C	5	4	9	0	1	10	0	0
16	21665605	.	G	T	7	2	9	0	1	10	0	0
16	21668063	.	T	C	2	3	5	0	0	5	0	0
16	21668067	.	T	C	2	0	2	0	2	4	0	0
16	21673726	.	A	G	2	2	4	0	0	4	0	0
16	21673735	.	G	A	2	2	4	0	0	4	0	0
16	21691101	.	T	C	2	2	4	0	0	4	0	0
16	21734574	.	A	G	0	0	0	0	1	1	0	0
16	21739233	.	G	A	1	1	2	0	2	4	0	0
16	21763843	.	G	A	12	10	22	0	0	22	0	0
16	21769044	.	G	A	3	1	4	0	0	4	0	0
16	21777508	.	G	C	0	0	0	0	1	1	0	0
16	21780023	.	G	A	4	5	9	0	0	9	0	0
16	21782076	.	C	A	2	2	4	0	0	4	0	0
16	21892068	.	G	A	3	4	7	0	0	7	0	0
16	21892173	.	G	A	11	6	17	0	1	18	0	0
16	21892304	.	T	C	19	0	19	0	5	24	0	0
16	21892312	.	C	A	17	6	23	0	1	24	0	0
16	21898159	.	T	A	11	9	20	0	0	20	0	0
16	21898267	.	A	T	1	2	3	0	0	3	0	0
16	21899211	.	C	T	0	3	3	0	1	4	0	0
16	21899384	.	C	G	0	2	2	0	1	3	0	0
16	21900294	.	A	G	9	9	18	0	0	18	0	0
16	21900333	.	C	A	0	8	8	0	11	19	0	0
16	21902949	.	G	A	0	0	0	0	1	1	0	0
16	21903803	.	A	G	2	3	5	0	0	5	0	0
16	21903845	.	C	T	2	2	4	0	1	5	0	0
16	21903911	.	C	A	0	2	2	0	6	8	0	0
16	21905681	.	A	G	3	2	5	0	0	5	0	0
16	21905814	.	G	A	8	7	15	0	1	16	0	0
16	21906282	.	A	C	2	0	2	0	7	9	0	0
16	21909747	.	A	T	0	2	2	0	0	2	0	0
16	21912063	.	G	T	0	1	1	0	0	1	0	0
16	21912064	.	C	G	0	1	1	0	0	1	0	0
16	21912997	.	G	A	10	4	14	0	0	14	0	0
16	21913069	.	T	A	5	6	11	0	0	11	0	0
16	21913091	.	T	A	5	5	10	0	0	10	0	0
16	21917148	.	A	C	3	3	6	0	1	7	0	0
16	21921402	.	G	A	2	2	4	0	0	4	0	0
16	21922245	.	T	G	1	2	3	0	0	3	0	0
16	21928360	.	G	A	2	1	3	0	0	3	0	0
16	21928619	.	A	T	0	2	2	0	0	2	0	0
16	21937712	.	T	C	2	4	6	0	0	6	0	0
16	21937745	.	C	T	2	3	5	0	0	5	0	0
16	21937991	.	G	T	0	4	4	0	3	7	0	0
16	22217835	.	T	C	2	0	2	0	6	8	0	0
16	22218355	.	C	A	1	5	6	0	0	6	0	0
16	22358841	.	T	A	2	1	3	0	0	3	0	0
16	22358944	.	A	T	3	7	10	0	1	11	0	0
16	22358947	.	T	A	3	6	9	0	1	10	0	0
16	22361101	.	T	C	10	12	22	0	1	23	0	0
16	22363956	.	G	A	14	9	23	0	0	23	0	0
16	22363957	.	G	A	14	9	23	0	0	23	0	0
16	22364064	.	C	T	18	17	35	0	1	36	0	0
16	22364067	.	T	G	18	14	32	0	2	34	0	0
16	22364241	.	A	C	23	11	34	0	0	34	0	0
16	22364501	.	A	C	0	5	5	0	1	6	0	0
16	22365562	.	C	G	6	1	7	0	0	7	0	0
16	22368962	.	T	A	8	6	14	0	0	14	0	0
16	22659905	.	A	G	6	3	9	0	2	11	0	0
16	22660094	.	C	A	4	5	9	0	1	10	0	0
16	22673219	.	C	T	5	6	11	0	1	12	0	0
16	22673234	.	C	T	5	9	14	0	0	14	0	0
16	22673528	.	C	G	9	9	18	0	0	18	0	0
16	22673804	.	G	T	6	6	12	0	0	12	0	0
16	22673817	.	G	T	6	4	10	0	1	11	0	0
16	22674181	.	A	C	4	6	10	0	0	10	0	0
16	22674317	.	A	G	7	4	11	0	1	12	0	0
16	22674427	.	C	T	6	7	13	0	0	13	0	0
16	22674490	.	G	A	3	4	7	0	1	8	0	0
16	22674509	.	A	C	4	2	6	0	0	6	0	0
16	22675081	.	T	A	10	5	15	0	1	16	0	0
16	22675110	.	A	T	9	9	18	0	0	18	0	0
16	22675253	.	C	T	6	5	11	0	0	11	0	0
16	22675310	.	T	A	10	8	18	0	0	18	0	0
16	22675367	.	C	A	10	3	13	0	0	13	0	0
16	22675418	.	T	C	7	7	14	0	0	14	0	0
16	22675574	.	T	C	16	7	23	0	0	23	0	0
16	22675663	.	T	C	12	11	23	0	1	24	0	0
16	22675795	.	G	A	0	10	10	0	7	17	0	0
16	22676478	.	G	C	3	2	5	0	0	5	0	0
16	22676589	.	G	T	8	8	16	0	2	18	0	0
16	22676671	.	T	A	9	10	19	0	1	20	0	0
16	22677037	.	C	A	13	5	18	0	0	18	0	0
16	22677086	.	G	A	19	8	27	0	0	27	0	0
16	22677206	.	C	A	13	10	23	0	1	24	0	0
16	22677276	.	A	G	14	15	29	0	2	31	0	0
16	22677537	.	A	G	2	7	9	0	2	11	0	0
16	22677658	.	T	C	3	3	6	0	0	6	0	0
16	22750244	.	A	T	14	12	26	0	2	28	0	0
16	22750506	.	A	G	19	23	42	0	3	45	0	0
16	22750566	.	G	A	20	22	42	0	0	42	0	0
16	22750579	.	A	G	14	25	39	0	0	39	0	0
16	22750610	.	A	T	19	18	37	0	0	37	0	0
16	22750693	.	G	A	15	11	26	0	1	27	0	0
16	22750718	.	A	T	16	7	23	0	1	24	0	0
16	22750754	.	G	A	13	5	18	0	1	19	0	0
16	22750781	.	A	G	7	10	17	0	2	19	0	0
16	22750839	.	A	G	14	8	22	0	2	24	0	0
16	22751093	.	C	A	8	10	18	0	1	19	0	0
16	22751101	.	C	T	6	8	14	0	2	16	0	0
16	22751129	.	T	A	6	6	12	0	0	12	0	0
16	22751141	.	T	G	1	3	4	0	0	4	0	0
16	22751167	.	T	A	1	5	6	0	0	6	0	0
16	22751181	.	C	T	2	6	8	0	0	8	0	0
16	22751376	.	A	C	2	5	7	0	0	7	0	0
16	22751426	.	T	C	5	5	10	0	0	10	0	0
16	22751435	.	A	G	6	1	7	0	0	7	0	0
16	22751727	.	T	C	6	1	7	0	3	10	0	0
16	22751926	.	C	T	6	6	12	0	0	12	0	0
16	22752009	.	T	C	6	1	7	0	4	11	0	0
16	22752104	.	A	G	18	4	22	0	0	22	0	0
16	22752113	.	T	C	16	0	16	0	7	23	0	0
16	22752154	.	G	A	2	11	13	0	0	13	0	0
16	22752182	.	G	T	14	3	17	0	1	18	0	0
16	22752274	.	G	C	10	4	14	0	0	16	2	0
16	22752279	.	T	C	9	5	14	0	1	15	0	0
16	22752328	.	G	A	4	3	7	0	0	7	0	0
16	22752399	.	G	A	3	3	6	0	0	6	0	0
16	22752531	.	T	C	9	6	15	0	0	15	0	0
16	22752624	.	C	T	2	7	9	0	0	9	0	0
16	22752625	.	G	A	7	2	9	0	0	9	0	0
16	22752779	.	A	G	6	2	8	0	0	8	0	0
16	22752868	.	C	T	2	1	3	0	0	3	0	0
16	22752889	.	G	A	0	2	2	0	0	2	0	0
16	22752954	.	T	C	3	4	7	0	1	8	0	0
16	22753185	.	C	T	10	2	12	0	0	12	0	0
16	22753380	.	T	G	15	9	24	0	0	24	0	0
16	22753452	.	G	A	6	12	18	0	0	18	0	0
16	22753574	.	C	T	0	6	6	0	7	13	0	0
16	22753583	.	T	C	5	1	6	0	6	12	0	0
16	22753626	.	C	T	11	11	22	0	1	23	0	0
16	22753631	.	C	T	8	12	20	0	2	22	0	0
16	22753784	.	T	C	12	0	12	0	9	21	0	0
16	22782175	.	G	T	4	6	10	0	0	10	0	0
16	22782306	.	A	T	15	7	22	0	0	22	0	0
16	22782308	.	A	T	14	7	21	0	1	22	0	0
16	22782422	.	C	T	0	14	14	0	10	24	0	0
16	22782443	.	A	T	7	17	24	0	1	25	0	0
16	22782458	.	T	C	7	15	22	0	1	23	0	0
16	22782682	.	T	G	9	12	21	0	0	21	0	0
16	22782904	.	G	C	9	13	22	0	0	22	0	0
16	22783338	.	C	G	0	10	10	0	15	25	0	0
16	22783978	.	A	G	11	10	21	0	1	22	0	0
16	22783995	.	T	C	12	0	12	0	8	20	0	0
16	22866015	.	T	C	1	4	5	0	0	5	0	0
16	22866017	.	C	A	1	4	5	0	0	5	0	0
16	22868973	.	T	C	0	2	2	0	0	2	0	0
16	22872011	.	A	G	2	0	2	0	2	4	0	0
16	22872317	.	A	C	3	9	12	0	0	12	0	0
16	22872602	.	G	A	7	8	15	0	0	15	0	0
16	22872657	.	A	C	4	8	12	0	1	13	0	0
16	22872693	.	T	C	1	3	4	0	0	4	0	0
16	22872694	.	C	T	1	3	4	0	0	4	0	0
16	22872927	.	T	C	5	7	12	0	2	14	0	0
16	22878965	.	T	A	5	8	13	0	0	13	0	0
16	22879035	.	A	G	8	1	9	0	4	13	0	0
16	22879055	.	G	T	9	3	12	0	0	12	0	0
16	22879071	.	A	G	6	0	6	0	3	9	0	0
16	23087656	.	G	A	1	4	5	0	0	5	0	0
16	23961572	.	C	G	7	0	7	0	5	12	0	0
16	23961950	.	C	A	13	10	23	0	1	24	0	0
16	23962010	.	T	C	11	12	23	0	2	25	0	0
16	23963246	.	C	T	24	18	42	0	1	43	0	0
16	23963315	.	G	T	16	24	40	0	1	41	0	0
16	23972939	.	G	A	1	0	1	0	0	1	0	0
16	23973477	.	G	A	27	19	46	0	1	47	0	0
16	23973691	.	C	T	1	3	4	0	0	4	0	0
16	24190496	.	A	G	1	6	7	0	0	7	0	0
16	24191564	.	G	A	17	21	38	0	4	42	0	0
16	24213444	.	T	A	14	14	28	0	3	31	0	0
16	24213446	.	T	A	16	13	29	0	2	31	0	0
16	24213538	.	G	T	29	19	48	0	7	55	0	0
16	24213657	.	G	A	27	11	38	0	0	38	0	0
16	24213666	.	T	G	21	10	31	0	2	33	0	0
16	24213793	.	T	C	26	24	50	0	4	54	0	0
16	24214023	.	A	G	30	33	63	0	1	64	0	0
16	24214106	.	T	C	27	0	27	0	21	48	0	0
16	24214468	.	T	C	29	31	60	0	0	60	0	0
16	24261594	.	C	G	8	7	15	0	1	16	0	0
16	24277750	.	C	T	14	14	28	0	1	29	0	0
16	24302164	.	G	A	7	6	13	0	0	13	0	0
16	24552032	.	G	A	2	2	4	0	2	6	0	0
16	24552081	.	C	T	2	6	8	0	3	11	0	0
16	24553018	.	G	T	4	6	10	0	0	10	0	0
16	24553082	.	T	A	4	8	12	0	0	12	0	0
16	24553141	.	T	A	7	3	10	0	0	10	0	0
16	24553225	.	C	G	6	5	11	0	0	11	0	0
16	24553450	.	T	C	9	4	13	0	0	13	0	0
16	24553621	.	C	T	4	2	6	0	0	6	0	0
16	24553633	.	A	G	4	3	7	0	0	7	0	0
16	24554438	.	T	A	4	2	6	0	0	6	0	0
16	24554475	.	A	G	3	5	8	0	0	8	0	0
16	24590767	.	T	A	17	14	31	0	2	33	0	0
16	24590823	.	C	T	24	14	38	0	3	41	0	0
16	24591172	.	A	G	12	23	35	0	2	37	0	0
16	24591245	.	A	T	9	13	22	0	1	23	0	0
16	24591258	.	A	G	8	12	20	0	0	20	0	0
16	24591287	.	C	T	0	13	13	0	14	27	0	0
16	24591330	.	A	G	20	13	33	0	0	33	0	0
16	24591360	.	G	A	14	8	22	0	1	23	0	0
16	24591410	.	G	A	9	6	15	0	0	15	0	0
16	24591693	.	G	C	28	22	50	0	0	50	0	0
16	24591751	.	C	T	12	18	30	0	0	30	0	0
16	24591794	.	G	T	5	4	9	0	0	9	0	0
16	24632121	.	G	T	6	7	13	0	1	14	0	0
16	24632231	.	C	T	9	10	19	0	0	19	0	0
16	24645620	.	T	G	13	8	21	0	0	21	0	0
16	24669991	.	T	C	3	3	6	0	0	6	0	0
16	24695160	.	G	T	9	29	38	0	1	39	0	0
16	24695301	.	T	C	39	23	62	0	1	63	0	0
16	24695322	.	G	T	2	21	23	0	40	64	1	0
16	24695520	.	G	A	31	30	61	0	6	67	0	0
16	24695525	.	A	C	31	33	64	0	4	68	0	0
16	24732602	.	A	G	0	0	0	0	1	1	0	0
16	24739514	.	G	A	1	2	3	0	0	3	0	0
16	24819475	.	T	C	1	0	1	0	3	4	0	0
16	24819515	.	A	T	2	5	7	0	0	7	0	0
16	24819936	.	C	T	3	3	6	0	0	6	0	0
16	24820664	.	T	G	2	2	4	0	0	4	0	0
16	24820672	.	G	T	2	1	3	0	1	4	0	0
16	24842880	.	G	A	0	1	1	0	1	2	0	0
16	24872681	.	G	T	1	0	1	0	0	1	0	0
16	24916108	.	T	C	0	2	2	0	0	2	0	0
16	24980276	.	A	T	0	1	1	0	0	1	0	0
16	24990255	.	T	A	4	3	7	0	0	7	0	0
16	24990261	.	A	G	3	3	6	0	0	6	0	0
16	24990672	.	C	T	2	8	10	0	0	10	0	0
16	24990850	.	C	T	1	4	5	0	0	5	0	0
16	24991164	.	G	T	0	6	6	0	4	10	0	0
16	24991225	.	C	G	5	7	12	0	0	12	0	0
16	24991239	.	G	A	0	8	8	0	5	13	0	0
16	24991333	.	T	C	5	6	11	0	1	12	0	0
16	24991593	.	A	T	4	3	7	0	2	9	0	0
16	24991741	.	T	C	1	4	5	0	0	5	0	0
16	24991763	.	G	C	5	4	9	0	0	9	0	0
16	24991919	.	T	A	4	6	10	0	1	11	0	0
16	24991940	.	T	A	7	3	10	0	1	11	0	0
16	24992017	.	A	C	2	4	6	0	0	6	0	0
16	24992477	.	C	G	1	4	5	0	0	5	0	0
16	25012143	.	T	A	1	0	1	0	0	1	0	0
16	25033173	.	G	A	2	2	4	0	1	5	0	0
16	25033191	.	C	T	1	1	2	0	1	3	0	0
16	25033809	.	G	A	3	7	10	0	1	11	0	0
16	25034683	.	A	T	8	13	21	0	1	22	0	0
16	25034715	.	C	T	12	10	22	0	0	22	0	0
16	25036217	.	C	T	3	7	10	0	0	10	0	0
16	25038185	.	A	T	4	7	11	0	5	16	0	0
16	25038429	.	C	T	8	9	17	0	0	17	0	0
16	25068857	.	A	G	1	0	1	0	2	3	0	0
16	25070393	.	A	C	2	5	7	0	0	7	0	0
16	25071019	.	G	A	4	3	7	0	0	7	0	0
16	25071614	.	C	T	5	9	14	0	2	16	0	0
16	25071782	.	G	A	1	8	9	0	7	16	0	0
16	25072355	.	G	A	6	8	14	0	0	14	0	0
16	25076311	.	C	T	1	2	3	0	0	3	0	0
16	25076919	.	G	C	2	3	5	0	0	5	0	0
16	25077608	.	C	T	3	5	8	0	0	8	0	0
16	25077819	.	C	T	2	2	4	0	0	4	0	0
16	25078397	.	G	T	3	4	7	0	1	8	0	0
16	25078715	.	A	G	11	2	13	0	2	15	0	0
16	25079407	.	A	C	7	5	12	0	0	12	0	0
16	25080042	.	G	T	2	5	7	0	2	9	0	0
16	25080236	.	G	T	4	6	10	0	0	10	0	0
16	25080252	.	A	T	6	8	14	0	0	14	0	0
16	25080306	.	T	C	5	5	10	0	1	11	0	0
16	25080367	.	G	A	5	4	9	0	1	10	0	0
16	25104031	.	T	C	16	12	28	0	3	31	0	0
16	25104454	.	C	G	19	14	33	0	0	33	0	0
16	25104543	.	C	T	12	6	18	0	0	18	0	0
16	25104850	.	A	C	13	15	28	0	0	28	0	0
16	25104899	.	T	G	11	16	27	0	1	28	0	0
16	25104941	.	T	C	23	13	36	0	0	36	0	0
16	25111665	.	C	A	3	4	7	0	0	7	0	0
16	25111794	.	G	A	6	4	10	0	0	10	0	0
16	25111899	.	G	A	1	3	4	0	1	5	0	0
16	25111920	.	G	A	0	2	2	0	2	4	0	0
16	25112001	.	A	G	3	3	6	0	0	6	0	0
16	25112769	.	C	T	3	2	5	0	0	5	0	0
16	25113741	.	G	A	0	4	4	0	8	12	0	0
16	25119501	.	T	A	1	1	2	0	1	3	0	0
16	25121958	.	C	T	4	3	7	0	0	7	0	0
16	25121970	.	C	T	5	3	8	0	0	8	0	0
16	25122240	.	C	T	7	3	10	0	0	10	0	0
16	25122387	.	C	T	8	3	11	0	0	11	0	0
16	25122798	.	C	T	3	2	5	0	0	5	0	0
16	25123037	.	G	A	7	5	12	0	0	12	0	0
16	25123058	.	A	G	6	4	10	0	1	11	0	0
16	25123114	.	A	G	3	4	7	0	2	9	0	0
16	25123165	.	A	G	3	4	7	0	0	7	0	0
16	25123348	.	A	G	11	0	11	0	6	17	0	0
16	25123382	.	G	T	8	7	15	0	0	15	0	0
16	25123832	.	A	G	3	8	11	0	0	11	0	0
16	25123843	.	T	A	4	6	10	0	0	10	0	0
16	25123884	.	C	G	4	4	8	0	0	8	0	0
16	25124500	.	G	A	8	4	12	0	0	12	0	0
16	25124662	.	G	T	4	6	10	0	0	11	1	0
16	25124750	.	G	A	3	4	7	0	1	8	0	0
16	25124832	.	C	T	4	3	7	0	0	7	0	0
16	25148748	.	G	A	0	2	2	0	1	3	0	0
16	25149191	.	G	A	3	3	6	0	0	6	0	0
16	25149228	.	C	T	3	2	5	0	0	5	0	0
16	25149254	.	G	T	2	2	4	0	0	4	0	0
16	25149433	.	C	T	4	3	7	0	0	7	0	0
16	25149474	.	C	T	3	3	6	0	0	6	0	0
16	25149654	.	T	C	2	3	5	0	0	5	0	0
16	25149797	.	C	G	1	2	3	0	0	3	0	0
16	25149819	.	T	C	2	1	3	0	0	3	0	0
16	25150307	.	T	G	2	0	2	0	2	4	0	0
16	25150468	.	A	G	2	2	4	0	0	4	0	0
16	25151012	.	T	C	5	2	7	0	0	7	0	0
16	25151059	.	G	A	0	3	3	0	2	5	0	0
16	25151079	.	A	G	2	0	2	0	3	5	0	0
16	25154081	.	A	C	3	1	4	0	0	5	1	0
16	25154115	.	C	T	4	4	8	0	1	9	0	0
16	25160985	.	G	A	0	3	3	0	2	5	0	0
16	25161315	.	T	C	8	5	13	0	0	13	0	0
16	25161461	.	A	G	5	0	5	0	3	8	0	0
16	25161693	.	G	A	5	9	14	0	1	15	0	0
16	25161873	.	G	A	0	11	11	0	8	19	0	0
16	25161876	.	T	C	10	7	17	0	0	17	0	0
16	25162320	.	T	A	3	4	7	0	0	7	0	0
16	25164326	.	C	A	2	1	3	0	0	3	0	0
16	25168548	.	G	A	10	18	28	0	1	29	0	0
16	25168765	.	C	A	17	12	29	0	2	31	0	0
16	25169336	.	G	A	9	8	17	0	1	18	0	0
16	25169616	.	A	T	3	6	9	0	0	9	0	0
16	25173993	.	T	A	1	2	3	0	0	3	0	0
16	25180397	.	A	C	4	4	8	0	0	8	0	0
16	25180415	.	C	T	5	3	8	0	0	8	0	0
16	25180658	.	C	A	4	3	7	0	0	7	0	0
16	25180674	.	T	A	3	2	5	0	0	5	0	0
16	25180775	.	G	A	1	5	6	0	1	7	0	0
16	25180942	.	A	G	8	0	8	0	3	11	0	0
16	25181095	.	C	T	1	5	6	0	1	7	0	0
16	25181194	.	G	C	3	2	5	0	0	5	0	0
16	25181213	.	A	G	3	3	6	0	0	6	0	0
16	25181256	.	G	A	4	5	9	0	0	9	0	0
16	25181291	.	T	C	4	2	6	0	0	6	0	0
16	25181350	.	A	T	1	2	3	0	0	3	0	0
16	25199291	.	G	C	4	3	7	0	0	7	0	0
16	25199342	.	A	C	1	3	4	0	0	4	0	0
16	25199343	.	A	G	1	0	1	0	3	4	0	0
16	25232203	.	T	C	1	2	3	0	0	3	0	0
16	25232250	.	T	C	6	2	8	0	0	8	0	0
16	25232288	.	C	A	0	6	6	0	8	14	0	0
16	25232433	.	C	T	0	6	6	0	3	9	0	0
16	25232707	.	C	T	4	3	7	0	1	8	0	0
16	25232712	.	C	T	0	4	4	0	4	8	0	0
16	25272196	.	C	G	2	3	5	0	0	5	0	0
16	25272413	.	C	T	0	2	2	0	1	3	0	0
16	25272429	.	G	T	1	2	3	0	0	3	0	0
16	25275909	.	A	C	12	13	25	0	1	26	0	0
16	25275957	.	C	T	17	11	28	0	0	28	0	0
16	25276281	.	G	A	11	13	24	0	0	24	0	0
16	25276387	.	T	A	2	4	6	0	0	6	0	0
16	25285506	.	G	A	15	15	30	0	2	32	0	0
16	25285507	.	G	A	17	15	32	0	0	32	0	0
16	25308516	.	C	T	1	2	3	0	0	3	0	0
16	25308986	.	G	A	1	1	2	0	0	2	0	0
16	25311038	.	A	T	1	0	1	0	0	1	0	0
16	25311772	.	G	A	3	5	8	0	0	8	0	0
16	25314682	.	C	T	1	2	3	0	0	3	0	0
16	25317000	.	G	A	6	5	11	0	0	11	0	0
16	25327155	.	C	A	2	7	9	0	0	9	0	0
16	25327181	.	C	T	2	7	9	0	0	9	0	0
16	25327202	.	G	A	1	6	7	0	1	8	0	0
16	25327730	.	C	T	0	1	1	0	0	1	0	0
16	25329319	.	C	T	0	2	2	0	0	2	0	0
16	25333270	.	A	G	7	5	12	0	1	13	0	0
16	25337248	.	C	A	5	5	10	0	1	11	0	0
16	25337286	.	C	T	16	12	28	0	0	28	0	0
16	25337319	.	G	A	15	9	24	0	1	25	0	0
16	25354571	.	A	G	2	0	2	0	1	3	0	0
16	25360557	.	T	A	1	3	4	0	0	4	0	0
16	25360762	.	G	A	2	5	7	0	0	7	0	0
16	25364479	.	T	C	4	10	14	0	1	15	0	0
16	25364589	.	T	C	5	12	17	0	0	17	0	0
16	25364742	.	T	C	5	0	5	0	2	7	0	0
16	25365156	.	C	T	2	2	4	0	0	4	0	0
16	25367503	.	G	A	1	1	2	0	0	2	0	0
16	25367902	.	C	T	0	6	6	0	3	9	0	0
16	25367917	.	C	G	4	5	9	0	0	9	0	0
16	25367938	.	G	C	6	0	6	0	5	11	0	0
16	25373823	.	C	T	3	2	5	0	0	5	0	0
16	25373979	.	T	A	8	5	13	0	0	13	0	0
16	25374275	.	T	C	7	9	16	0	0	16	0	0
16	25374507	.	T	C	12	0	12	0	8	20	0	0
16	25375019	.	T	C	4	0	4	0	7	11	0	0
16	25376808	.	T	C	3	4	7	0	0	7	0	0
16	25380786	.	T	G	1	2	3	0	0	3	0	0
16	25389094	.	G	A	5	9	14	0	2	16	0	0
16	25389106	.	C	T	5	8	13	0	0	13	0	0
16	25393287	.	T	A	3	1	4	0	3	7	0	0
16	25395154	.	G	T	5	9	14	0	0	14	0	0
16	25395702	.	G	T	0	4	4	0	0	4	0	0
16	25399585	.	A	T	2	5	7	0	0	7	0	0
16	25399588	.	A	T	2	6	8	0	0	8	0	0
16	25399781	.	T	C	5	2	7	0	0	7	0	0
16	25454790	.	C	T	2	3	5	0	0	5	0	0
16	25454829	.	G	T	0	2	2	0	0	2	0	0
16	25463401	.	C	A	1	3	4	0	0	4	0	0
16	25470975	.	A	G	1	2	3	0	0	3	0	0
16	25477428	.	G	A	1	2	3	0	0	3	0	0
16	25487775	.	C	T	2	0	2	0	0	2	0	0
16	25490833	.	A	G	2	0	2	0	1	3	0	0
16	25498402	.	T	A	6	6	12	0	0	12	0	0
16	25500137	.	A	G	4	1	5	0	0	5	0	0
16	25500223	.	T	C	5	6	11	0	0	11	0	0
16	25504192	.	G	C	13	11	24	0	0	24	0	0
16	25504337	.	G	A	18	11	29	0	0	29	0	0
16	25504466	.	C	T	12	14	26	0	1	27	0	0
16	25504467	.	G	A	14	13	27	0	0	27	0	0
16	25504792	.	G	C	23	22	45	0	1	46	0	0
16	25504900	.	G	A	22	25	47	0	3	50	0	0
16	25535229	.	C	T	0	5	5	0	2	7	0	0
16	25556650	.	T	A	18	13	31	0	1	32	0	0
16	25556697	.	A	G	19	12	31	0	0	31	0	0
16	25556710	.	C	T	16	9	25	0	1	26	0	0
16	25556766	.	C	G	1	7	8	0	5	13	0	0
16	25556780	.	A	G	4	8	12	0	2	14	0	0
16	25556802	.	C	A	7	10	17	0	0	17	0	0
16	25556930	.	A	G	11	11	22	0	0	22	0	0
16	25556966	.	T	A	8	15	23	0	1	24	0	0
16	25557352	.	C	T	0	7	7	0	4	11	0	0
16	25557400	.	A	G	2	5	7	0	0	7	0	0
16	25557403	.	T	C	2	4	6	0	0	6	0	0
16	25557690	.	C	T	13	4	17	0	0	17	0	0
16	25557806	.	C	T	9	11	20	0	0	20	0	0
16	25558135	.	C	T	8	14	22	0	2	24	0	0
16	25558223	.	A	G	7	6	13	0	1	14	0	0
16	25558351	.	C	T	0	6	6	0	6	12	0	0
16	25558439	.	G	T	7	4	11	0	0	11	0	0
16	25558704	.	T	G	6	4	10	0	0	10	0	0
16	25558829	.	C	T	4	5	9	0	0	9	0	0
16	25558892	.	G	A	4	6	10	0	1	11	0	0
16	25558986	.	A	G	5	4	9	0	0	9	0	0
16	25559028	.	A	C	5	2	7	0	0	7	0	0
16	25559193	.	A	G	12	4	16	0	0	16	0	0
16	25559495	.	T	A	5	3	8	0	0	8	0	0
16	25559743	.	A	T	8	7	15	0	0	15	0	0
16	25560135	.	T	C	5	0	5	0	2	7	0	0
16	25560184	.	A	G	5	5	10	0	0	10	0	0
16	25560322	.	G	A	3	5	8	0	0	8	0	0
16	25561471	.	C	G	0	4	4	0	0	4	0	0
16	25561795	.	C	A	4	7	11	0	0	11	0	0
16	25562480	.	G	A	6	3	9	0	0	9	0	0
16	25562549	.	G	A	3	3	6	0	0	6	0	0
16	25597510	.	G	A	4	4	8	0	0	8	0	0
16	25639595	.	T	C	6	2	8	0	0	8	0	0
16	25642663	.	G	A	19	10	29	0	0	29	0	0
16	25642673	.	C	T	13	16	29	0	1	30	0	0
16	25643038	.	G	A	14	11	25	0	1	26	0	0
16	25643041	.	G	A	6	12	18	0	8	26	0	0
16	25643113	.	G	C	17	9	26	0	0	26	0	0
16	25643452	.	T	A	5	9	14	0	0	14	0	0
16	25643818	.	G	T	11	5	16	0	0	16	0	0
16	25644357	.	C	A	3	9	12	0	1	13	0	0
16	25644378	.	A	T	12	3	15	0	0	15	0	0
16	25673249	.	T	A	8	6	14	0	0	14	0	0
16	25683018	.	T	C	6	4	10	0	1	11	0	0
16	25683387	.	C	T	1	9	10	0	13	23	0	0
16	25698449	.	A	C	7	4	11	0	0	11	0	0
16	26043044	.	T	A	1	1	2	0	0	2	0	0
16	26141785	.	C	A	0	8	8	0	4	12	0	0
16	26141817	.	T	G	6	6	12	0	1	13	0	0
16	26142105	.	C	T	8	4	12	0	0	12	0	0
16	26142311	.	A	C	7	11	18	0	1	19	0	0
16	26142773	.	G	A	6	8	14	0	0	14	0	0
16	26142779	.	C	T	6	7	13	0	0	13	0	0
16	26142900	.	T	C	8	0	8	0	6	14	0	0
16	26143332	.	T	C	7	8	15	0	0	15	0	0
16	26143371	.	T	G	2	5	7	0	1	8	0	0
16	26143538	.	C	T	8	3	11	0	0	11	0	0
16	26143561	.	C	T	4	5	9	0	2	11	0	0
16	26146174	.	G	A	7	11	18	0	0	18	0	0
16	26146736	.	G	A	5	3	8	0	0	8	0	0
16	26148741	.	C	T	7	5	12	0	0	12	0	0
16	26148962	.	C	A	2	1	3	0	0	3	0	0
16	26148963	.	C	A	1	1	2	0	1	3	0	0
16	26149005	.	A	T	2	1	3	0	0	3	0	0
16	26169515	.	T	G	1	0	1	0	0	1	0	0
16	26186178	.	C	A	1	2	3	0	0	3	0	0
16	26186187	.	G	C	1	0	1	0	2	3	0	0
16	26234317	.	T	C	1	4	5	0	0	5	0	0
16	26235386	.	G	A	3	3	6	0	0	6	0	0
16	26378553	.	T	A	2	2	4	0	0	4	0	0
16	26378706	.	G	T	3	3	6	0	1	7	0	0
16	26378729	.	A	G	1	3	4	0	0	4	0	0
16	26379437	.	T	C	2	0	2	0	2	4	0	0
16	26380517	.	G	T	4	2	6	0	0	6	0	0
16	26380536	.	A	G	6	2	8	0	0	9	1	0
16	26380784	.	C	T	0	12	12	0	18	30	0	0
16	26380866	.	G	A	8	13	21	0	2	23	0	0
16	26381192	.	T	G	19	8	27	0	0	27	0	0
16	26381271	.	C	T	12	6	18	0	1	19	0	0
16	26381416	.	C	T	0	21	21	0	17	38	0	0
16	26381463	.	C	T	0	13	13	0	22	35	0	0
16	26381768	.	C	T	0	8	8	0	14	22	0	0
16	26382084	.	T	C	12	11	23	0	1	24	0	0
16	26382225	.	A	T	14	12	26	0	0	26	0	0
16	26382243	.	G	A	16	13	29	0	1	30	0	0
16	26382308	.	T	C	19	18	37	0	0	37	0	0
16	26382453	.	T	C	14	0	14	1	5	20	0	0
16	26382585	.	A	G	6	4	10	0	1	11	0	0
16	26382942	.	T	C	12	12	24	0	1	25	0	0
16	26383016	.	C	T	0	20	20	0	18	38	0	0
16	26384188	.	C	G	7	5	12	0	1	13	0	0
16	26384219	.	G	A	7	5	12	0	0	12	0	0
16	26384417	.	G	A	1	0	1	0	0	1	0	0
16	26386817	.	T	C	5	4	9	0	0	9	0	0
16	26388840	.	A	G	3	5	8	0	0	8	0	0
16	26391447	.	A	G	1	0	1	0	1	2	0	0
16	26391450	.	C	T	1	1	2	0	0	2	0	0
16	26391970	.	C	A	0	2	2	0	4	6	0	0
16	26440252	.	G	A	2	1	3	0	0	3	0	0
16	26441561	.	G	A	2	2	4	0	0	4	0	0
16	26441624	.	A	T	2	2	4	0	0	4	0	0
16	26443781	.	G	A	2	3	5	0	0	5	0	0
16	26443835	.	C	T	1	2	3	0	0	3	0	0
16	26443976	.	C	T	2	6	8	0	0	8	0	0
16	26444431	.	T	A	6	4	10	0	0	10	0	0
16	26444443	.	A	G	7	5	12	0	0	12	0	0
16	26444505	.	C	T	6	6	12	0	0	12	0	0
16	26444680	.	G	T	2	2	4	0	0	4	0	0
16	26444830	.	G	A	1	2	3	0	6	9	0	0
16	26445178	.	A	T	1	4	5	0	0	5	0	0
16	26445484	.	T	C	1	4	5	0	0	5	0	0
16	26445512	.	A	C	1	2	3	0	0	3	0	0
16	26445547	.	A	G	2	2	4	0	0	4	0	0
16	26445571	.	G	C	1	2	3	0	0	3	0	0
16	26482851	.	T	A	1	1	2	0	0	2	0	0
16	26482917	.	A	T	1	3	4	0	0	4	0	0
16	26643598	.	G	C	4	4	8	0	1	9	0	0
16	26702648	.	A	C	4	3	7	0	0	7	0	0
16	26702780	.	G	T	1	12	13	0	7	20	0	0
16	26702786	.	G	A	0	8	8	0	10	18	0	0
16	26706875	.	C	T	0	0	0	0	1	1	0	0
16	26707494	.	A	G	4	2	6	0	0	6	0	0
16	26710900	.	C	A	10	10	20	0	1	21	0	0
16	26710954	.	A	T	7	18	25	0	0	25	0	0
16	26710957	.	G	A	7	16	23	0	2	25	0	0
16	26713964	.	G	T	15	11	26	0	1	27	0	0
16	26717318	.	C	T	13	6	19	0	0	19	0	0
16	26717457	.	C	A	6	7	13	0	0	13	0	0
16	26766455	.	A	G	1	1	2	0	1	3	0	0
16	26766475	.	C	T	1	3	4	0	1	5	0	0
16	26766508	.	A	T	2	3	5	0	1	6	0	0
16	26766926	.	G	A	4	6	10	0	0	10	0	0
16	26769118	.	C	T	6	2	8	0	0	8	0	0
16	26816799	.	A	G	7	2	9	0	0	9	0	0
16	26816806	.	G	T	7	1	8	0	0	8	0	0
16	26816852	.	G	T	6	7	13	0	0	13	0	0
16	26816885	.	A	G	13	3	16	0	0	16	0	0
16	26816918	.	T	A	12	2	14	0	1	15	0	0
16	26817046	.	T	G	4	7	11	0	1	12	0	0
16	26817069	.	C	T	0	5	5	0	5	10	0	0
16	26817178	.	T	A	6	7	13	0	0	13	0	0
16	26817358	.	C	T	8	7	15	0	1	16	0	0
16	26817631	.	C	T	0	9	9	0	6	15	0	0
16	26817754	.	C	T	0	4	4	0	4	8	0	0
16	26850833	.	C	T	5	8	13	0	0	13	0	0
16	26850845	.	T	C	5	8	13	0	0	13	0	0
16	26850885	.	C	T	8	10	18	0	0	18	0	0
16	26851191	.	C	T	5	6	11	0	1	12	0	0
16	26851236	.	C	T	0	4	4	0	4	8	0	0
16	26855729	.	C	A	9	13	22	0	0	22	0	0
16	26855786	.	G	A	13	5	18	0	1	19	0	0
16	26855833	.	C	A	0	7	7	0	8	15	0	0
16	26855859	.	C	A	0	10	10	0	9	19	0	0
16	27064864	.	A	G	2	5	7	0	0	7	0	0
16	27069608	.	A	G	1	0	1	0	0	1	0	0
16	27072488	.	G	A	0	3	3	0	8	11	0	0
16	27080221	.	T	C	3	1	4	0	0	4	0	0
16	27089100	.	T	G	7	2	9	0	0	9	0	0
16	27098305	.	T	C	10	4	14	0	0	14	0	0
16	27098530	.	A	G	12	5	17	0	0	17	0	0
16	27098549	.	A	T	9	6	15	0	0	16	1	0
16	27099121	.	A	T	4	4	8	0	0	8	0	0
16	27100133	.	A	C	8	7	15	0	0	15	0	0
16	27100139	.	A	T	6	7	13	0	1	14	0	0
16	27100198	.	T	A	13	13	26	0	1	27	0	0
16	27100222	.	T	C	17	15	32	0	0	32	0	0
16	27126647	.	C	T	0	8	8	0	10	18	0	0
16	27126998	.	A	G	8	9	17	0	0	17	0	0
16	27126999	.	T	A	8	9	17	0	0	17	0	0
16	27127157	.	G	C	10	19	29	0	1	30	0	0
16	27127158	.	C	A	10	19	29	0	1	30	0	0
16	27127576	.	T	C	11	16	27	0	0	27	0	0
16	27127959	.	G	A	7	2	9	0	0	9	0	0
16	27131005	.	C	T	1	2	3	0	4	7	0	0
16	27136541	.	A	G	7	3	10	0	0	10	0	0
16	27138207	.	C	G	2	2	4	0	0	4	0	0
16	27138391	.	C	G	3	0	3	0	0	3	0	0
16	27148691	.	C	T	8	9	17	0	2	19	0	0
16	27158741	.	A	T	4	4	8	0	0	8	0	0
16	27161089	.	G	A	2	4	6	0	0	6	0	0
16	27169529	.	G	A	13	8	21	0	1	22	0	0
16	27169586	.	G	A	7	6	13	0	1	14	0	0
16	27169664	.	A	T	8	6	14	0	0	14	0	0
16	27169809	.	G	A	5	5	10	0	0	10	0	0
16	27170206	.	A	G	1	0	1	0	0	1	0	0
16	27216207	.	C	G	3	5	8	0	1	9	0	0
16	27216353	.	G	A	3	4	7	0	2	9	0	0
16	27216701	.	C	T	6	4	10	0	0	10	0	0
16	27216845	.	C	T	0	4	4	0	3	7	0	0
16	27216970	.	G	A	1	2	3	0	0	3	0	0
16	27222907	.	C	T	0	2	2	0	1	3	0	0
16	27224450	.	G	C	7	0	7	0	0	7	0	0
16	27225215	.	C	A	6	4	10	0	1	11	0	0
16	27231337	.	T	A	24	12	36	0	0	36	0	0
16	27231416	.	C	T	17	34	51	0	5	56	0	0
16	27345748	.	C	T	8	3	11	0	5	16	0	0
16	27354980	.	G	A	4	4	8	0	0	8	0	0
16	27356127	.	G	A	6	3	9	0	1	10	0	0
16	27367834	.	A	C	5	1	6	0	18	24	0	0
16	27368175	.	G	A	9	10	19	0	1	20	0	0
16	27368290	.	G	A	0	12	12	0	16	28	0	0
16	27368315	.	G	A	0	12	12	0	11	23	0	0
16	27368577	.	A	G	12	7	19	0	1	20	0	0
16	27368688	.	A	C	10	17	27	0	4	31	0	0
16	27368756	.	A	G	5	10	15	0	2	17	0	0
16	27368823	.	T	G	11	7	18	0	1	19	0	0
16	27368863	.	C	T	9	13	22	0	0	22	0	0
16	27417415	.	C	A	9	3	12	0	0	12	0	0
16	27417573	.	T	C	8	11	19	0	1	20	0	0
16	27417659	.	T	G	9	13	22	0	4	26	0	0
16	27417925	.	A	T	16	12	28	0	0	28	0	0
16	27427064	.	A	G	7	4	11	0	0	11	0	0
16	27427760	.	G	A	2	1	3	0	0	3	0	0
16	27428048	.	G	A	3	1	4	0	0	4	0	0
16	27430189	.	G	A	1	2	3	0	0	3	0	0
16	27508505	.	G	A	9	5	14	0	0	14	0	0
16	27513694	.	T	C	2	6	8	0	0	8	0	0
16	27529856	.	G	A	3	5	8	0	1	9	0	0
16	27532506	.	C	T	0	2	2	0	2	4	0	0
16	27533500	.	C	G	0	1	1	0	0	1	0	0
16	27536796	.	C	A	0	2	2	0	1	3	0	0
16	27539462	.	G	T	2	2	4	0	0	4	0	0
16	27542489	.	C	T	1	2	3	0	0	3	0	0
16	27547540	.	A	C	2	1	3	0	1	4	0	0
16	27547545	.	A	T	2	2	4	0	0	4	0	0
16	27554909	.	C	G	16	11	27	0	0	27	0	0
16	27555010	.	T	C	10	12	22	0	0	22	0	0
16	27555011	.	A	C	10	11	21	0	1	22	0	0
16	27555069	.	C	T	11	15	26	0	1	27	0	0
16	27555221	.	C	T	5	0	5	0	1	6	0	0
16	27555395	.	G	A	6	5	11	0	1	12	0	0
16	27562493	.	G	A	1	2	3	0	0	3	0	0
16	27578193	.	A	G	0	1	1	0	0	1	0	0
16	27578391	.	T	C	1	1	2	0	0	2	0	0
16	27578538	.	C	A	1	3	4	0	0	4	0	0
16	27621786	.	A	T	14	5	19	0	0	19	0	0
16	27622109	.	G	A	2	2	4	0	0	4	0	0
16	27626240	.	A	G	16	7	23	0	0	23	0	0
16	27626566	.	G	T	27	23	50	0	5	55	0	0
16	27627051	.	T	C	2	0	2	0	0	2	0	0
16	27629038	.	C	T	0	26	26	0	18	44	0	0
16	27629343	.	A	G	13	7	20	0	0	20	0	0
16	27629365	.	G	T	17	15	32	0	0	32	0	0
16	27629639	.	C	A	13	25	38	0	1	39	0	0
16	27629798	.	A	T	15	16	31	0	1	32	0	0
16	27630174	.	A	T	22	18	40	0	1	41	0	0
16	27630207	.	C	T	19	15	34	0	3	37	0	0
16	27630302	.	A	T	21	14	35	0	2	37	0	0
16	27630552	.	G	A	9	10	19	0	1	20	0	0
16	27630663	.	G	A	17	11	28	0	0	28	0	0
16	27631229	.	A	T	6	6	12	0	1	13	0	0
16	27631585	.	T	A	9	11	20	0	1	21	0	0
16	27631690	.	T	G	10	7	17	0	0	17	0	0
16	27631695	.	T	C	8	7	15	0	2	17	0	0
16	27631741	.	C	A	4	8	12	0	1	13	0	0
16	27631751	.	T	A	4	8	12	0	0	12	0	0
16	27632153	.	C	T	9	6	15	0	1	16	0	0
16	27632189	.	G	A	12	3	15	0	2	17	0	0
16	27632228	.	C	T	12	3	15	0	0	15	0	0
16	27632520	.	A	T	5	5	10	0	1	11	0	0
16	27632814	.	G	A	3	10	13	0	0	14	1	0
16	27632934	.	T	C	8	3	11	0	0	11	0	0
16	27633002	.	G	A	3	7	10	0	0	10	0	0
16	27633180	.	C	T	0	7	7	0	4	11	0	0
16	27633812	.	C	T	3	5	8	0	0	8	0	0
16	27633839	.	T	C	3	0	3	0	7	10	0	0
16	27633950	.	G	T	2	4	6	0	0	6	0	0
16	27669917	.	T	G	3	4	7	0	1	8	0	0
16	27670010	.	A	T	1	3	4	0	1	5	0	0
16	27670032	.	T	C	4	2	6	0	1	7	0	0
16	27735596	.	G	A	4	2	6	0	0	6	0	0
16	27735648	.	A	G	3	2	5	0	0	5	0	0
16	27735663	.	T	C	3	2	5	0	0	5	0	0
16	28112706	.	A	T	1	2	3	0	2	5	0	0
16	28112772	.	G	A	5	5	10	0	1	11	0	0
16	28113049	.	G	A	2	2	4	0	0	4	0	0
16	28256800	.	G	T	0	1	1	0	0	1	0	0
16	28263526	.	G	A	3	5	8	0	0	8	0	0
16	28265687	.	T	C	1	1	2	0	0	2	0	0
16	28268273	.	C	A	3	3	6	0	0	6	0	0
16	28270067	.	G	T	0	6	6	0	1	7	0	0
16	28270118	.	C	T	1	7	8	0	0	8	0	0
16	28270561	.	C	T	4	3	7	0	0	7	0	0
16	28270695	.	G	A	3	7	10	0	0	10	0	0
16	28276389	.	C	T	3	2	5	0	0	5	0	0
16	28278360	.	T	C	0	1	1	0	0	1	0	0
16	28280057	.	T	C	0	0	0	0	1	1	0	0
16	28370872	.	T	A	1	5	6	0	0	6	0	0
16	28370943	.	A	T	4	9	13	0	2	15	0	0
16	28557842	.	A	G	0	0	0	0	1	1	0	0
16	28557889	.	G	A	0	1	1	0	1	2	0	0
16	28557909	.	G	A	0	3	3	0	0	3	0	0
16	28573328	.	G	C	0	5	5	0	3	8	0	0
16	28573665	.	C	A	3	8	11	0	0	12	1	0
16	28573871	.	A	C	4	6	10	0	0	10	0	0
16	28573928	.	C	T	4	5	9	0	0	9	0	0
16	28573957	.	T	A	3	3	6	0	0	6	0	0
16	28574403	.	C	T	4	5	9	0	0	9	0	0
16	28574531	.	T	G	7	15	22	0	0	22	0	0
16	28574664	.	G	A	4	4	8	0	0	8	0	0
16	28591186	.	T	A	3	8	11	0	1	12	0	0
16	28591277	.	A	G	13	15	28	0	3	31	0	0
16	28591312	.	G	A	0	9	9	0	20	29	0	0
16	28591353	.	A	C	8	15	23	0	1	24	0	0
16	28591385	.	C	G	7	11	18	0	0	18	0	0
16	28592758	.	A	T	5	7	12	0	0	13	1	0
16	28593056	.	C	T	1	2	3	0	0	3	0	0
16	28593394	.	G	A	4	6	10	0	0	10	0	0
16	28593430	.	G	A	7	11	18	0	0	18	0	0
16	28593493	.	C	T	2	4	6	0	1	7	0	0
16	28622321	.	G	A	0	1	1	0	2	3	0	0
16	28624646	.	C	T	1	1	2	0	0	2	0	0
16	28624648	.	G	C	0	1	1	0	1	2	0	0
16	28626282	.	G	A	2	5	7	0	0	7	0	0
16	28626629	.	G	A	0	4	4	0	3	7	0	0
16	28626997	.	C	T	4	2	6	0	1	7	0	0
16	28627005	.	C	T	1	4	5	0	2	7	0	0
16	28627198	.	T	A	1	6	7	0	0	7	0	0
16	28627341	.	T	G	0	7	7	0	1	8	0	0
16	28627342	.	T	A	1	7	8	0	0	8	0	0
16	28629299	.	C	T	0	5	5	0	4	9	0	0
16	28629504	.	C	T	2	3	5	0	0	5	0	0
16	28634954	.	G	A	0	1	1	0	0	1	0	0
16	28663339	.	G	C	1	1	2	0	0	2	0	0
16	28663361	.	C	T	0	3	3	0	1	4	0	0
16	28664537	.	T	C	3	1	4	0	0	4	0	0
16	28665774	.	T	A	2	2	4	0	1	5	0	0
16	28842438	.	C	T	25	19	44	0	1	45	0	0
16	28856026	.	G	A	15	16	31	0	0	31	0	0
16	28886606	.	T	C	1	2	3	0	0	3	0	0
16	28983644	.	G	A	1	0	1	0	1	2	0	0
16	28983689	.	G	A	2	4	6	0	1	7	0	0
16	28990523	.	C	G	2	6	8	0	0	8	0	0
16	29010155	.	T	A	0	2	2	1	0	3	0	0
16	29010826	.	A	T	1	4	5	0	0	5	0	0
16	29012961	.	C	T	4	3	7	0	0	7	0	0
16	29012992	.	A	G	3	0	3	0	3	6	0	0
16	29013039	.	C	G	4	4	8	0	0	8	0	0
16	29013327	.	C	A	1	7	8	0	0	8	0	0
16	29013377	.	C	T	4	5	9	0	1	10	0	0
16	29014091	.	A	T	4	8	12	0	1	13	0	0
16	29014109	.	T	C	4	7	11	0	0	11	0	0
16	29016659	.	C	T	9	6	15	0	1	16	0	0
16	29016904	.	T	C	9	4	13	0	0	13	0	0
16	29017221	.	T	C	5	5	10	0	0	10	0	0
16	29019039	.	G	A	10	9	19	0	0	19	0	0
16	29020482	.	G	T	6	6	12	0	0	12	0	0
16	29022955	.	C	A	11	6	17	0	3	20	0	0
16	29023266	.	A	T	2	1	3	0	0	3	0	0
16	29024181	.	A	G	2	2	4	0	0	4	0	0
16	29024341	.	T	C	4	7	11	0	1	12	0	0
16	29024405	.	C	T	6	3	9	0	1	10	0	0
16	29024409	.	C	T	5	4	9	0	0	9	0	0
16	29024512	.	A	T	6	6	12	0	0	12	0	0
16	29024551	.	A	T	2	8	10	0	0	10	0	0
16	29024552	.	T	G	2	8	10	0	0	10	0	0
16	29027102	.	A	G	1	0	1	0	2	3	0	0
16	29027161	.	C	T	0	1	1	0	1	2	0	0
16	29029444	.	G	A	6	2	8	0	0	8	0	0
16	29030383	.	G	C	2	3	5	0	0	5	0	0
16	29030548	.	G	T	1	2	3	0	0	3	0	0
16	29050827	.	C	T	1	2	3	0	0	3	0	0
16	29051524	.	T	A	2	2	4	0	1	5	0	0
16	29051841	.	C	G	2	2	4	0	0	4	0	0
16	29051842	.	C	A	2	2	4	0	0	4	0	0
16	29052030	.	C	T	1	4	5	0	0	5	0	0
16	29052245	.	G	T	1	2	3	0	0	3	0	0
16	29052653	.	A	T	3	5	8	0	0	8	0	0
16	29052752	.	C	G	1	0	1	0	3	4	0	0
16	29052914	.	G	A	3	5	8	0	0	8	0	0
16	29052991	.	C	T	3	6	9	0	0	9	0	0
16	29053045	.	T	A	5	4	9	0	0	9	0	0
16	29073068	.	G	A	1	2	3	0	0	3	0	0
16	29073621	.	T	A	10	4	14	0	1	15	0	0
16	29074254	.	G	A	21	29	50	0	1	51	0	0
16	29074459	.	T	A	4	13	17	0	4	21	0	0
16	29075137	.	C	T	3	20	23	0	0	23	0	0
16	29075195	.	A	G	16	10	26	0	0	26	0	0
16	29075222	.	T	A	7	14	21	0	1	22	0	0
16	29075305	.	G	A	13	14	27	0	1	28	0	0
16	29075343	.	G	A	16	13	29	0	1	30	0	0
16	29075347	.	C	G	11	18	29	0	1	30	0	0
16	29075674	.	C	A	14	17	31	0	1	32	0	0
16	29075870	.	G	T	13	13	26	0	0	26	0	0
16	29075959	.	C	T	10	11	21	0	1	22	0	0
16	29075962	.	C	T	12	10	22	0	1	23	0	0
16	29076270	.	G	T	22	22	44	0	4	48	0	0
16	29076407	.	C	T	0	18	18	0	19	37	0	0
16	29076471	.	G	A	24	8	32	0	1	33	0	0
16	29076575	.	C	G	1	16	17	0	9	26	0	0
16	29076633	.	G	A	10	14	24	0	0	24	0	0
16	29076669	.	A	G	4	3	7	0	1	8	0	0
16	29076678	.	T	C	3	0	3	0	1	4	0	0
16	29111066	.	T	C	8	0	8	0	12	20	0	0
16	29225873	.	C	G	7	16	23	0	0	23	0	0
16	29226129	.	A	T	5	6	11	0	1	12	0	0
16	29226151	.	C	A	5	3	8	0	1	9	0	0
16	29226538	.	G	T	4	2	6	0	0	6	0	0
16	29226588	.	A	T	4	6	10	0	1	11	0	0
16	29266014	.	G	T	10	4	14	0	0	14	0	0
16	29266042	.	G	A	5	4	9	0	0	9	0	0
16	29266518	.	G	A	2	3	5	0	0	5	0	0
16	29266587	.	C	T	2	2	4	0	0	4	0	0
16	29267794	.	T	C	1	0	1	0	2	3	0	0
16	29310150	.	T	A	6	2	8	0	1	9	0	0
16	29310206	.	A	G	11	6	17	0	1	18	0	0
16	29310213	.	C	A	11	6	17	0	1	18	0	0
16	29310455	.	C	T	18	9	27	0	0	27	0	0
16	29310760	.	C	A	20	9	29	1	3	33	0	0
16	29311381	.	G	A	14	16	30	0	1	31	0	0
16	29311493	.	A	G	15	10	25	0	3	28	0	0
16	29311720	.	T	C	1	1	2	0	0	2	0	0
16	29313828	.	T	C	13	5	18	0	4	22	0	0
16	29314147	.	C	A	2	2	4	0	0	4	0	0
16	29320647	.	A	G	6	3	9	0	0	9	0	0
16	29320674	.	T	G	9	4	13	0	0	13	0	0
16	29320870	.	T	C	5	1	6	0	5	11	0	0
16	29320966	.	G	C	2	0	2	0	6	8	0	0
16	29321013	.	G	A	6	8	14	0	1	15	0	0
16	29321269	.	C	T	12	3	15	0	1	16	0	0
16	29321290	.	C	T	14	4	18	0	0	18	0	0
16	29323394	.	T	C	7	4	11	0	0	11	0	0
16	29323864	.	C	T	0	4	4	0	3	7	0	0
16	29325232	.	A	G	1	3	4	0	0	4	0	0
16	29369887	.	C	T	0	2	2	0	1	3	0	0
16	29371029	.	C	T	1	2	3	0	0	3	0	0
16	29373845	.	G	A	1	4	5	0	0	5	0	0
16	29374075	.	A	C	5	2	7	0	1	8	0	0
16	29381204	.	G	T	3	5	8	0	0	8	0	0
16	29381391	.	T	C	2	0	2	0	0	2	0	0
16	29384090	.	T	C	3	3	6	0	0	6	0	0
16	29384099	.	T	A	3	3	6	0	0	6	0	0
16	29384139	.	G	A	3	4	7	0	0	7	0	0
16	29384359	.	C	T	1	3	4	0	0	4	0	0
16	29389014	.	T	G	1	2	3	0	0	3	0	0
16	29391081	.	T	C	1	2	3	0	0	3	0	0
16	29407754	.	C	T	0	1	1	0	0	1	0	0
16	29407791	.	C	A	6	6	12	0	0	12	0	0
16	29408024	.	A	C	31	11	42	0	0	42	0	0
16	29408926	.	A	T	25	10	35	0	0	35	0	0
16	29408948	.	T	A	16	19	35	0	1	36	0	0
16	29409134	.	A	G	5	4	9	0	1	10	0	0
16	29409181	.	T	A	3	2	5	0	0	5	0	0
16	29409341	.	T	C	29	9	38	0	0	38	0	0
16	29409480	.	T	C	31	11	42	0	1	43	0	0
16	29409646	.	T	G	21	22	43	0	1	44	0	0
16	29410425	.	A	G	23	27	50	0	2	52	0	0
16	29410520	.	A	G	13	22	35	0	4	39	0	0
16	29411209	.	G	A	16	32	48	0	2	50	0	0
16	29413193	.	C	T	1	14	15	0	18	33	0	0
16	29414004	.	A	C	6	8	14	0	1	15	0	0
16	29420803	.	T	C	4	2	6	0	0	6	0	0
16	29421026	.	C	T	1	3	4	0	0	4	0	0
16	29424985	.	T	A	4	3	7	0	0	7	0	0
16	29425278	.	G	A	2	3	5	0	0	5	0	0
16	29427615	.	T	A	1	3	4	0	0	4	0	0
16	29456052	.	A	G	0	2	2	0	0	2	0	0
16	29456519	.	G	T	1	4	5	0	1	6	0	0
16	29456966	.	G	A	6	6	12	0	0	12	0	0
16	29456996	.	A	G	4	7	11	0	0	11	0	0
16	29457158	.	A	G	3	6	9	0	0	9	0	0
16	29457473	.	T	A	7	3	10	0	0	11	1	0
16	29458226	.	C	G	3	3	6	0	0	6	0	0
16	29586680	.	A	G	4	10	14	0	0	14	0	0
16	29587067	.	G	A	7	6	13	0	0	13	0	0
16	29642184	.	T	C	2	2	4	0	0	4	0	0
16	29644223	.	C	T	7	7	14	0	0	14	0	0
16	29686304	.	A	G	2	3	5	0	0	5	0	0
16	29686355	.	G	C	3	5	8	0	0	8	0	0
16	29686370	.	G	T	3	7	10	0	0	10	0	0
16	29689921	.	A	G	0	1	1	0	0	1	0	0
16	29691039	.	A	G	1	0	1	0	2	3	0	0
16	29691190	.	A	G	2	0	2	0	2	4	0	0
16	29693871	.	A	G	4	0	4	0	4	8	0	0
16	29693999	.	A	G	2	3	5	0	0	5	0	0
16	29695989	.	G	T	1	3	4	0	0	4	0	0
16	29696018	.	A	G	2	4	6	0	0	6	0	0
16	29696212	.	G	C	1	5	6	0	0	6	0	0
16	29696487	.	T	C	1	2	3	0	0	3	0	0
16	29696505	.	C	G	1	3	4	0	1	5	0	0
16	30002867	.	G	T	0	2	2	0	1	3	0	0
16	30036400	.	T	A	2	3	5	0	0	5	0	0
16	30036445	.	A	G	1	3	4	0	1	5	0	0
16	30266844	.	G	A	4	6	10	0	0	10	0	0
16	30267228	.	A	G	12	0	12	0	12	24	0	0
16	30267841	.	T	C	6	7	13	0	0	13	0	0
16	30268145	.	C	T	10	6	16	1	0	17	0	0
16	30268242	.	T	C	8	5	13	0	0	13	0	0
16	30268290	.	G	A	10	5	15	0	1	16	0	0
16	30268475	.	A	C	12	5	17	0	0	17	0	0
16	30268633	.	C	T	4	4	8	0	2	10	0	0
16	30268660	.	A	G	9	2	11	0	0	11	0	0
16	30268675	.	C	T	6	6	12	0	0	12	0	0
16	30269159	.	A	C	5	7	12	0	2	14	0	0
16	30270332	.	G	T	1	5	6	0	10	16	0	0
16	30270350	.	G	A	9	3	12	0	3	15	0	0
16	30270381	.	T	G	8	6	14	0	2	16	0	0
16	30270601	.	C	T	22	18	40	0	1	41	0	0
16	30323212	.	T	A	2	3	5	0	1	6	0	0
16	30323278	.	A	C	1	2	3	0	0	3	0	0
16	30323315	.	C	A	2	2	4	0	0	4	0	0
16	30408725	.	A	T	0	4	4	0	0	4	0	0
16	30408765	.	T	A	1	4	5	0	0	5	0	0
16	30408786	.	A	T	3	6	9	0	0	9	0	0
16	30408917	.	A	G	19	25	44	0	1	45	0	0
16	30409055	.	A	T	25	27	52	0	1	53	0	0
16	30409313	.	A	T	15	11	26	0	0	26	0	0
16	30415027	.	C	T	21	22	43	0	1	44	0	0
16	30417511	.	A	G	3	0	3	0	0	3	0	0
16	30417977	.	A	G	4	5	9	0	0	9	0	0
16	30417986	.	A	G	4	3	7	0	0	7	0	0
16	30419504	.	A	G	6	3	9	0	0	9	0	0
16	30422494	.	G	C	1	2	3	0	1	4	0	0
16	30422506	.	G	A	2	2	4	0	0	4	0	0
16	30422582	.	C	G	10	15	25	0	1	26	0	0
16	30422807	.	T	C	15	0	15	0	11	26	0	0
16	30422891	.	G	A	18	9	27	0	0	27	0	0
16	30423680	.	G	C	4	4	8	0	0	8	0	0
16	30423953	.	G	A	13	10	23	0	1	24	0	0
16	30426496	.	T	A	1	4	5	0	0	5	0	0
16	30427042	.	A	G	1	1	2	0	0	2	0	0
16	30429159	.	A	G	4	2	6	0	0	6	0	0
16	30432287	.	A	G	0	3	3	0	0	3	0	0
16	30515689	.	A	T	0	1	1	0	0	1	0	0
16	30518522	.	T	A	1	3	4	0	0	4	0	0
16	30518620	.	T	G	1	2	3	0	0	3	0	0
16	30521704	.	A	T	4	6	10	0	0	10	0	0
16	30522108	.	T	A	4	7	11	0	0	11	0	0
16	30522109	.	T	G	4	7	11	0	0	11	0	0
16	30522176	.	G	C	10	7	17	0	0	17	0	0
16	30522317	.	G	C	5	5	10	0	0	10	0	0
16	30522334	.	C	T	6	4	10	0	0	10	0	0
16	30522551	.	C	G	1	2	3	0	0	3	0	0
16	30522565	.	T	G	1	2	3	0	0	3	0	0
16	30522809	.	C	T	2	2	4	0	0	4	0	0
16	30522852	.	G	A	4	3	7	0	0	7	0	0
16	30522923	.	C	T	0	6	6	0	4	10	0	0
16	30522959	.	C	T	6	2	8	0	1	9	0	0
16	30523253	.	C	G	1	2	3	0	0	3	0	0
16	30525371	.	T	C	2	0	2	0	2	4	0	0
16	30525458	.	A	G	4	4	8	0	0	8	0	0
16	30525499	.	A	G	2	4	6	0	0	6	0	0
16	30530401	.	C	T	3	4	7	0	1	8	0	0
16	30531304	.	C	T	1	2	3	0	0	3	0	0
16	30531358	.	T	C	1	4	5	0	3	8	0	0
16	30537749	.	C	A	1	1	2	0	0	2	0	0
16	30562958	.	C	T	2	2	4	0	0	4	0	0
16	30737594	.	A	G	11	14	25	0	1	26	0	0
16	30737638	.	C	T	17	11	28	0	0	28	0	0
16	30737770	.	A	G	18	16	34	0	1	35	0	0
16	30740719	.	T	G	9	8	17	0	1	18	0	0
16	30760879	.	A	C	0	0	0	0	1	1	0	0
16	30772417	.	C	T	0	1	1	0	2	3	0	0
16	30785451	.	T	C	6	2	8	0	0	8	0	0
16	30788182	.	A	G	1	5	6	0	0	6	0	0
16	30794822	.	T	G	1	1	2	0	0	2	0	0
16	30808411	.	T	C	2	4	6	0	0	6	0	0
16	30826525	.	A	G	0	1	1	0	1	2	0	0
16	30826614	.	A	C	4	6	10	0	0	10	0	0
16	30869597	.	C	G	0	1	1	0	0	1	0	0
16	30869623	.	A	T	2	3	5	0	0	5	0	0
16	30908529	.	G	A	2	2	4	0	0	4	0	0
16	30908825	.	A	C	3	3	6	0	0	6	0	0
16	30909201	.	A	G	2	6	8	0	0	8	0	0
16	30910338	.	T	G	1	2	3	0	1	4	0	0
16	30910347	.	A	C	1	2	3	0	1	4	0	0
16	30919193	.	C	T	0	2	2	0	4	6	0	0
16	30919291	.	T	A	1	2	3	0	1	4	0	0
16	30921301	.	T	C	1	0	1	0	3	4	0	0
16	30927301	.	C	A	1	2	3	0	0	3	0	0
16	30927311	.	G	A	1	1	2	0	0	2	0	0
16	30948634	.	T	G	1	4	5	0	0	5	0	0
16	30948644	.	A	T	1	4	5	0	0	5	0	0
16	30949188	.	A	G	1	3	4	0	0	4	0	0
16	30949239	.	C	T	1	4	5	0	1	6	0	0
16	30949402	.	T	C	2	4	6	0	0	6	0	0
16	31186631	.	A	T	8	17	25	0	2	27	0	0
16	31187097	.	C	T	0	10	10	1	7	18	0	0
16	31187322	.	A	G	14	9	23	0	0	23	0	0
16	31188481	.	G	A	10	7	17	0	1	18	0	0
16	31260703	.	T	A	3	2	5	0	0	5	0	0
16	31260705	.	G	C	3	2	5	0	0	5	0	0
16	31260754	.	G	A	5	3	8	0	0	8	0	0
16	31261003	.	A	T	8	6	14	0	0	14	0	0
16	31261213	.	C	A	0	10	10	0	3	13	0	0
16	31261344	.	C	T	1	5	6	0	2	8	0	0
16	31266548	.	G	A	1	1	2	0	0	2	0	0
16	31267559	.	C	T	0	0	0	0	3	3	0	0
16	31268860	.	G	C	0	1	1	0	1	2	0	0
16	31268893	.	C	A	2	4	6	0	0	6	0	0
16	31272424	.	C	G	0	5	5	1	0	6	0	0
16	31274289	.	T	A	2	1	3	0	1	4	0	0
16	31274491	.	G	A	5	2	7	0	0	7	0	0
16	31280355	.	G	A	3	1	4	0	0	4	0	0
16	31428861	.	C	G	5	2	7	0	0	7	0	0
16	31429409	.	A	G	4	2	6	0	0	6	0	0
16	31437115	.	A	G	11	12	23	0	1	24	0	0
16	31437955	.	A	G	25	17	42	0	1	43	0	0
16	31444428	.	G	A	3	7	10	0	0	10	0	0
16	31445516	.	T	C	3	5	8	0	0	8	0	0
16	31454274	.	T	A	2	2	4	0	0	4	0	0
16	31454495	.	G	T	4	2	6	0	0	6	0	0
16	31454548	.	A	G	3	2	5	0	0	5	0	0
16	31454614	.	G	C	2	3	5	0	0	5	0	0
16	31454868	.	A	G	2	2	4	0	0	4	0	0
16	31454874	.	A	T	2	2	4	0	0	4	0	0
16	31516778	.	A	G	3	2	5	0	0	5	0	0
16	31602170	.	A	G	4	2	6	0	0	6	0	0
16	31608012	.	A	G	1	3	4	0	0	4	0	0
16	31608101	.	C	T	0	4	4	0	2	6	0	0
16	31608967	.	G	T	6	3	9	0	0	9	0	0
16	31610375	.	C	T	1	3	4	0	0	4	0	0
16	31613619	.	A	G	3	4	7	0	0	7	0	0
16	31614272	.	C	G	2	1	3	0	0	3	0	0
16	31614918	.	G	A	2	1	3	0	0	3	0	0
16	31615114	.	G	A	1	1	2	0	2	4	0	0
16	31709610	.	A	C	1	1	2	0	0	2	0	0
16	31717856	.	G	T	1	2	3	0	0	3	0	0
16	31723863	.	T	C	2	4	6	0	0	6	0	0
16	31762960	.	C	T	20	11	31	0	0	32	1	0
16	31763316	.	T	C	21	17	38	0	1	39	0	0
16	31763318	.	C	T	21	17	38	0	1	39	0	0
16	31763668	.	C	G	12	10	22	0	1	23	0	0
16	31763743	.	T	A	21	24	45	0	2	47	0	0
16	31763751	.	A	C	21	21	42	0	2	44	0	0
16	31763785	.	G	A	13	21	34	0	3	38	1	0
16	31763786	.	C	A	15	21	36	0	2	38	0	0
16	31763880	.	A	G	19	18	37	0	2	40	1	0
16	31764987	.	C	T	1	4	5	0	1	6	0	0
16	31766937	.	T	A	2	2	4	0	0	4	0	0
16	31767116	.	T	C	14	1	15	0	5	20	0	0
16	31767152	.	A	G	5	13	18	0	0	18	0	0
16	31767163	.	G	A	3	10	13	0	0	13	0	0
16	31768343	.	C	G	14	12	26	0	0	26	0	0
16	31768394	.	T	C	13	5	18	0	0	18	0	0
16	31768436	.	T	C	15	6	21	0	1	22	0	0
16	31769317	.	G	A	7	4	11	0	1	12	0	0
16	31769395	.	A	G	7	9	16	0	0	16	0	0
16	31769428	.	G	A	1	0	1	0	1	2	0	0
16	31770050	.	T	C	10	0	10	0	6	16	0	0
16	31776125	.	C	T	3	2	5	0	0	5	0	0
16	31780108	.	C	T	0	5	5	0	3	8	0	0
16	31789327	.	C	T	1	3	4	0	0	4	0	0
16	31810842	.	C	T	1	0	1	0	0	1	0	0
16	31810887	.	C	T	0	1	1	0	0	1	0	0
16	31815638	.	C	T	17	8	25	0	0	25	0	0
16	31815878	.	G	A	8	15	23	0	0	23	0	0
16	31816005	.	C	A	10	9	19	0	0	19	0	0
16	31816205	.	C	T	10	3	13	0	1	14	0	0
16	31816336	.	C	T	0	9	9	0	7	16	0	0
16	31816596	.	C	T	10	15	25	0	0	25	0	0
16	31827642	.	T	A	17	15	32	0	0	32	0	0
16	31827703	.	C	T	15	20	35	0	0	35	0	0
16	31832606	.	A	G	19	1	20	0	26	46	0	0
16	31833872	.	T	A	1	2	3	0	0	3	0	0
16	31834505	.	G	A	0	0	0	0	1	1	0	0
16	31834549	.	T	A	0	3	3	0	0	3	0	0
16	31834825	.	T	C	2	2	4	0	0	4	0	0
16	31853932	.	T	A	1	1	2	0	0	2	0	0
16	31854325	.	C	A	3	2	5	0	0	5	0	0
16	31855271	.	T	C	3	3	6	0	0	6	0	0
16	31855327	.	G	A	6	2	8	0	0	8	0	0
16	31855351	.	G	C	3	4	7	0	0	7	0	0
16	31855575	.	C	T	7	12	19	0	0	19	0	0
16	31855576	.	C	T	7	12	19	0	0	19	0	0
16	31855814	.	T	G	6	1	7	0	9	16	0	0
16	31856239	.	A	G	1	4	5	0	0	5	0	0
16	31856276	.	G	A	0	6	6	0	4	10	0	0
16	31859065	.	A	G	4	0	4	0	11	15	0	0
16	31859102	.	A	G	6	21	27	0	0	27	0	0
16	31859103	.	A	G	15	12	27	0	0	27	0	0
16	31859227	.	T	C	13	23	36	0	0	36	0	0
16	31859341	.	C	T	13	25	38	0	2	40	0	0
16	31859371	.	T	C	15	24	39	0	1	40	0	0
16	31859550	.	A	G	8	1	9	0	18	27	0	0
16	31859686	.	G	A	6	13	19	0	0	19	0	0
16	31868443	.	G	A	22	11	33	0	0	33	0	0
16	31922892	.	A	G	3	6	9	0	0	9	0	0
16	31923083	.	G	A	24	26	50	0	0	50	0	0
16	31923435	.	A	G	35	28	63	0	0	63	0	0
16	31924485	.	T	C	20	26	46	0	2	48	0	0
16	31924501	.	A	C	20	26	46	0	3	49	0	0
16	31925727	.	G	A	4	0	4	0	0	4	0	0
16	31927369	.	C	A	3	4	7	0	1	8	0	0
16	31928878	.	T	C	0	1	1	0	0	1	0	0
16	31951694	.	G	C	5	3	8	0	0	8	0	0
16	31955226	.	C	G	3	7	10	0	0	10	0	0
16	31958514	.	C	T	3	1	4	0	1	5	0	0
16	31959098	.	G	A	0	2	2	0	3	5	0	0
16	31959156	.	G	A	4	3	7	0	1	8	0	0
16	31959179	.	T	G	6	3	9	0	0	9	0	0
16	31959225	.	G	A	9	3	12	0	0	12	0	0
16	31959231	.	A	T	10	3	13	0	0	13	0	0
16	31959277	.	A	T	4	2	6	0	2	8	0	0
16	31959428	.	C	T	1	3	4	0	0	4	0	0
16	31959476	.	G	A	1	5	6	0	0	6	0	0
16	31959496	.	A	G	2	0	2	0	5	7	0	0
16	31959612	.	G	A	1	3	4	0	0	4	0	0
16	31959845	.	A	G	4	0	4	0	6	10	0	0
16	31960037	.	G	A	0	3	3	0	6	9	0	0
16	31960064	.	G	C	5	6	11	0	0	11	0	0
16	31960145	.	C	T	8	6	14	0	0	14	0	0
16	31960152	.	C	T	7	7	14	0	1	15	0	0
16	32011649	.	C	T	4	5	9	0	0	9	0	0
16	32011673	.	A	G	0	1	1	0	0	1	0	0
16	32013272	.	G	A	0	2	2	0	0	2	0	0
16	32013766	.	T	G	3	4	7	0	0	7	0	0
16	32013861	.	G	A	2	3	5	0	1	6	0	0
16	32013891	.	G	A	1	1	2	0	2	4	0	0
16	32021999	.	C	T	1	2	3	0	0	3	0	0
16	32023124	.	T	A	1	3	4	0	2	6	0	0
16	32025648	.	T	A	8	15	23	0	1	24	0	0
16	32025978	.	G	A	11	4	15	0	1	16	0	0
16	32025987	.	T	A	13	7	20	0	0	20	0	0
16	32026063	.	G	A	0	4	4	0	19	23	0	0
16	32026105	.	T	A	13	3	16	0	0	16	0	0
16	32026154	.	T	G	2	3	5	0	1	6	0	0
16	32026203	.	C	T	2	2	4	0	0	4	0	0
16	32026206	.	A	G	2	2	4	0	0	4	0	0
16	32026250	.	C	T	1	2	3	0	0	3	0	0
16	32051854	.	A	C	5	7	12	0	0	12	0	0
16	32052004	.	T	G	0	7	7	0	0	7	0	0
16	32052283	.	T	A	0	1	1	0	0	1	0	0
16	32052307	.	T	C	3	4	7	0	0	7	0	0
16	32052328	.	T	A	5	5	10	0	0	10	0	0
16	32052404	.	G	T	3	5	8	0	5	13	0	0
16	32055726	.	T	G	7	9	16	0	1	17	0	0
16	32057809	.	T	C	10	8	18	0	0	18	0	0
16	32057853	.	G	A	1	7	8	0	9	17	0	0
16	32060021	.	G	A	2	4	6	0	3	9	0	0
16	32060121	.	G	T	2	3	5	0	0	5	0	0
16	32060130	.	C	A	1	4	5	0	0	5	0	0
16	32066465	.	T	C	1	3	4	0	0	4	0	0
16	32068332	.	G	A	4	5	9	0	1	10	0	0
16	32068452	.	C	A	2	2	4	0	1	5	0	0
16	32068503	.	T	C	3	5	8	0	2	10	0	0
16	32069310	.	T	A	2	5	7	0	2	9	0	0
16	32069653	.	A	G	10	7	17	0	2	19	0	0
16	32070489	.	A	G	5	0	5	0	3	8	0	0
16	32070570	.	C	T	4	6	10	0	1	11	0	0
16	32070981	.	G	C	16	9	25	0	0	25	0	0
16	32071997	.	C	A	10	4	14	0	1	15	0	0
16	32072334	.	A	G	10	7	17	0	1	18	0	0
16	32073301	.	A	C	12	16	28	0	1	29	0	0
16	32073507	.	A	C	25	15	40	0	1	41	0	0
16	32073555	.	A	G	21	20	41	0	0	41	0	0
16	32073760	.	G	A	22	14	36	0	1	37	0	0
16	32074041	.	G	A	13	18	31	0	0	31	0	0
16	32074257	.	A	G	20	1	21	0	17	38	0	0
16	32074293	.	T	A	21	18	39	0	1	40	0	0
16	32074294	.	A	G	19	19	38	0	2	40	0	0
16	32080069	.	G	T	1	13	14	0	12	26	0	0
16	32080099	.	G	A	8	4	12	0	0	12	0	0
16	32080196	.	T	C	5	3	8	0	0	8	0	0
16	32080206	.	T	C	5	3	8	0	0	8	0	0
16	32080306	.	T	A	9	3	12	0	0	12	0	0
16	32080508	.	T	A	22	15	37	0	0	37	0	0
16	32080738	.	G	A	6	3	9	0	0	9	0	0
16	32082397	.	T	C	3	4	7	0	0	7	0	0
16	32082589	.	G	A	2	5	7	0	1	8	0	0
16	32082597	.	G	A	2	5	7	0	1	8	0	0
16	32085319	.	T	A	0	1	1	0	0	1	0	0
16	32085631	.	A	G	1	3	4	0	0	4	0	0
16	32086136	.	C	T	2	1	3	0	3	6	0	0
16	32088580	.	T	A	1	1	2	0	0	2	0	0
16	32090349	.	C	T	16	8	24	0	0	24	0	0
16	32090425	.	G	C	11	4	15	0	0	15	0	0
16	32110659	.	A	G	17	11	28	0	1	29	0	0
16	32111246	.	G	T	21	12	33	0	1	34	0	0
16	32113155	.	G	A	8	10	18	0	0	18	0	0
16	32113218	.	G	A	4	7	11	0	0	11	0	0
16	32116790	.	A	T	3	3	6	0	0	6	0	0
16	32117345	.	T	A	5	9	14	0	1	15	0	0
16	32119581	.	C	A	7	10	17	0	0	17	0	0
16	32119618	.	C	T	7	12	19	0	2	21	0	0
16	32119895	.	G	T	5	5	10	0	0	10	0	0
16	32120138	.	G	T	10	8	18	0	0	18	0	0
16	32120141	.	T	C	9	0	9	0	9	18	0	0
16	32120173	.	G	A	8	9	17	0	1	18	0	0
16	32120204	.	G	T	10	7	17	0	1	18	0	0
16	32120279	.	A	C	3	6	9	0	0	9	0	0
16	32128259	.	T	A	1	4	5	0	1	6	0	0
16	32140638	.	G	C	3	2	5	0	0	5	0	0
16	32140977	.	C	T	1	7	8	0	0	8	0	0
16	32140999	.	A	G	1	5	6	0	0	6	0	0
16	32141036	.	G	A	1	2	3	0	2	5	0	0
16	32141058	.	A	G	1	2	3	0	1	4	0	0
16	32141075	.	G	A	2	3	5	0	0	5	0	0
16	32141544	.	A	G	5	0	5	0	11	16	0	0
16	32141565	.	A	C	9	7	16	0	1	17	0	0
16	32141604	.	A	T	3	4	7	0	2	9	0	0
16	32144337	.	T	C	8	6	14	0	0	14	0	0
16	32144377	.	T	C	10	6	16	0	0	16	0	0
16	32144854	.	G	T	0	5	5	0	4	9	0	0
16	32144989	.	T	C	4	3	7	0	0	7	0	0
16	32145160	.	T	A	6	6	12	0	1	13	0	0
16	32145391	.	G	A	3	2	5	0	0	5	0	0
16	32145547	.	T	C	5	5	10	0	0	10	0	0
16	32145636	.	A	G	9	9	18	0	0	18	0	0
16	32252878	.	A	G	0	3	3	0	0	3	0	0
16	32267128	.	G	A	6	3	9	0	1	10	0	0
16	32267203	.	G	A	0	6	6	0	5	11	0	0
16	32273066	.	G	T	3	3	6	0	0	6	0	0
16	32273192	.	G	A	0	2	2	0	4	6	0	0
16	32274935	.	G	A	1	3	4	0	0	4	0	0
16	32275601	.	T	A	4	5	9	0	0	9	0	0
16	32275628	.	A	T	6	7	13	0	0	13	0	0
16	32561581	.	T	A	4	6	10	0	2	12	0	0
16	32562038	.	A	T	8	5	13	0	0	13	0	0
16	32562817	.	A	T	4	3	7	0	1	8	0	0
16	33735481	.	G	A	3	4	7	0	0	7	0	0
16	33735503	.	C	T	2	3	5	0	1	6	0	0
16	33736068	.	A	G	1	2	3	0	0	3	0	0
16	33736174	.	A	T	2	4	6	0	0	6	0	0
16	33736196	.	A	C	3	4	7	0	0	7	0	0
16	33774584	.	C	A	0	2	2	0	1	3	0	0
16	33905018	.	C	T	1	0	1	0	1	2	0	0
16	33915011	.	C	T	1	0	1	0	0	1	0	0
16	33919623	.	G	A	0	1	1	0	0	1	0	0
16	33923421	.	G	T	2	2	4	0	0	4	0	0
16	33923448	.	G	T	4	3	7	0	0	7	0	0
16	33923514	.	G	A	4	11	15	0	1	16	0	0
16	33925132	.	G	C	1	0	1	0	0	1	0	0
16	33925356	.	G	A	0	5	5	0	7	12	0	0
16	33925565	.	T	G	4	5	9	0	0	9	0	0
16	33926074	.	C	T	3	1	4	0	0	4	0	0
16	33928015	.	G	A	1	3	4	0	2	6	0	0
16	33933213	.	C	T	4	0	4	0	0	4	0	0
16	33933496	.	G	C	4	3	7	0	0	7	0	0
16	33933498	.	C	T	3	4	7	0	0	7	0	0
16	33933732	.	G	A	0	6	6	0	4	10	0	0
16	33939824	.	T	C	1	4	5	0	0	5	0	0
16	33939859	.	C	T	3	5	8	0	0	8	0	0
16	33940364	.	A	G	2	0	2	0	5	7	0	0
16	33940379	.	T	A	4	7	11	0	0	11	0	0
16	33953968	.	C	T	2	2	4	0	0	4	0	0
16	33971993	.	G	A	0	2	2	0	2	4	0	0
16	33972008	.	G	A	4	3	7	0	0	7	0	0
16	33972037	.	A	C	4	4	8	0	0	8	0	0
16	33972067	.	A	G	3	3	6	0	0	6	0	0
16	33972193	.	G	A	0	2	2	0	5	7	0	0
16	33972242	.	G	T	7	2	9	0	1	10	0	0
16	33972249	.	C	T	5	4	9	0	0	9	0	0
16	33972454	.	C	T	6	3	9	0	0	9	0	0
16	33979746	.	A	T	4	3	7	0	0	7	0	0
16	33981439	.	C	T	0	1	1	0	0	1	0	0
16	33981873	.	A	G	6	0	6	0	5	11	0	0
16	33983784	.	T	G	6	7	13	0	1	14	0	0
16	33983904	.	C	T	4	11	15	0	0	15	0	0
16	33984178	.	C	T	7	9	16	0	0	16	0	0
16	33984190	.	C	T	8	9	17	0	1	18	0	0
16	33985050	.	G	T	1	13	14	0	14	28	0	0
16	33985362	.	C	T	11	18	29	0	1	30	0	0
16	33986179	.	A	T	11	21	32	0	2	34	0	0
16	33986452	.	T	G	15	26	41	0	1	42	0	0
16	33989391	.	A	G	1	0	1	0	3	4	0	0
16	33989606	.	G	T	0	6	6	0	4	10	0	0
16	33995754	.	G	A	0	3	3	0	1	4	0	0
16	33996739	.	C	T	1	1	2	0	1	3	0	0
16	34004562	.	G	A	0	4	4	0	5	9	0	0
16	34004595	.	T	C	8	4	12	0	2	14	0	0
16	34004862	.	C	T	4	4	8	0	0	8	0	0
16	34005290	.	C	T	9	4	13	0	1	14	0	0
16	34005415	.	C	T	8	5	13	0	0	13	0	0
16	34005500	.	C	A	5	5	10	0	0	11	1	0
16	34005577	.	A	G	12	5	17	0	1	18	0	0
16	34005669	.	C	T	5	6	11	0	2	13	0	0
16	34005686	.	C	T	9	3	12	0	1	13	0	0
16	34005812	.	T	A	13	4	17	0	0	17	0	0
16	34005858	.	A	G	5	6	11	0	0	11	0	0
16	34005981	.	A	G	8	3	11	1	0	12	0	0
16	34054141	.	A	G	2	4	6	0	0	6	0	0
16	34054171	.	A	G	3	5	8	0	0	8	0	0
16	34054464	.	C	A	2	5	7	0	0	7	0	0
16	34054515	.	A	G	4	6	10	0	0	10	0	0
16	34054519	.	C	T	4	5	9	0	0	9	0	0
16	34054778	.	G	A	5	3	8	0	0	8	0	0
16	34054786	.	T	G	4	3	7	0	0	7	0	0
16	34054923	.	G	A	0	4	4	0	2	6	0	0
16	34055747	.	A	T	1	2	3	0	0	3	0	0
16	34055754	.	C	T	1	2	3	0	0	3	0	0
16	34055788	.	T	C	1	2	3	0	0	3	0	0
16	34055965	.	A	T	2	2	4	0	1	5	0	0
16	34055966	.	T	G	3	2	5	0	0	5	0	0
16	34056204	.	T	A	2	3	5	0	0	5	0	0
16	34056324	.	T	G	1	2	3	0	0	3	0	0
16	34056408	.	A	G	3	3	6	0	0	6	0	0
16	34160860	.	T	G	1	4	5	0	0	5	0	0
16	34172916	.	G	A	2	4	6	0	1	7	0	0
16	34173000	.	T	C	9	3	12	0	1	13	0	0
16	34173331	.	G	A	0	6	6	0	0	6	0	0
16	34185906	.	A	T	5	4	9	0	0	9	0	0
16	34200704	.	C	T	3	3	6	0	1	7	0	0
16	34201023	.	A	G	7	3	10	0	0	10	0	0
16	34208582	.	T	C	12	0	12	0	18	30	0	0
16	34208696	.	A	G	15	18	33	0	1	34	0	0
16	34212477	.	A	G	11	9	20	0	1	21	0	0
16	34212516	.	A	G	7	11	18	0	0	18	0	0
16	34212565	.	G	A	15	13	28	0	5	33	0	0
16	34212567	.	G	C	16	13	29	0	4	33	0	0
16	34212630	.	T	C	11	4	15	0	28	43	0	0
16	34212676	.	G	C	12	2	14	0	10	24	0	0
16	34222439	.	T	G	11	10	21	0	1	22	0	0
16	34225173	.	T	C	1	1	2	0	0	2	0	0
16	34225392	.	A	G	7	18	25	0	1	26	0	0
16	34225472	.	G	A	18	5	23	0	0	23	0	0
16	34267938	.	C	T	0	1	1	0	2	3	0	0
16	34267991	.	G	C	1	3	4	0	0	4	0	0
16	34301043	.	A	T	1	4	5	0	0	5	0	0
16	34321568	.	A	T	8	8	16	0	2	18	0	0
16	34322036	.	G	T	6	3	9	0	1	10	0	0
16	34322346	.	G	A	14	19	33	0	1	34	0	0
16	34322372	.	C	T	0	20	20	0	13	33	0	0
16	34331489	.	A	G	4	2	6	0	0	6	0	0
16	34337976	.	A	T	10	8	18	0	0	18	0	0
16	34338475	.	A	G	10	4	14	0	1	15	0	0
16	34339168	.	A	C	9	6	15	0	1	16	0	0
16	34339432	.	A	T	6	5	11	0	5	16	0	0
16	34339693	.	C	T	6	6	12	0	1	13	0	0
16	34339808	.	A	G	4	6	10	0	0	10	0	0
16	34340179	.	A	T	7	5	12	0	1	13	0	0
16	34340311	.	T	C	5	0	5	0	6	11	0	0
16	34340397	.	A	C	2	5	7	0	0	7	0	0
16	34340520	.	G	T	1	8	9	0	1	10	0	0
16	34340538	.	C	T	3	6	9	0	1	10	0	0
16	34340965	.	C	T	3	5	8	0	0	8	0	0
16	34340967	.	A	G	3	4	7	0	1	8	0	0
16	34341012	.	C	T	2	3	5	0	1	6	0	0
16	34341021	.	C	T	2	3	5	0	0	5	0	0
16	34341080	.	T	C	1	3	4	0	0	4	0	0
16	34342182	.	T	C	3	3	6	0	0	6	0	0
16	34461347	.	A	T	2	3	5	0	0	5	0	0
16	34497550	.	T	C	6	5	11	0	1	12	0	0
16	34498320	.	A	T	5	3	8	0	0	8	0	0
16	34499940	.	A	G	9	5	14	0	0	14	0	0
16	34500167	.	A	G	3	2	5	0	1	6	0	0
16	34500189	.	T	A	2	1	3	0	1	4	0	0
16	34500542	.	G	C	17	10	27	0	1	28	0	0
16	34500683	.	A	G	1	1	2	0	0	2	0	0
16	34500899	.	G	A	17	12	29	0	0	29	0	0
16	34501292	.	A	G	3	6	9	0	4	13	0	0
16	34501348	.	C	T	11	13	24	0	0	24	0	0
16	34501380	.	C	T	6	9	15	0	1	16	0	0
16	34501496	.	G	A	0	5	5	0	7	12	0	0
16	34525621	.	C	A	25	20	45	0	2	47	0	0
16	34526092	.	C	G	35	32	67	0	0	68	1	0
16	34526093	.	A	C	25	33	58	0	10	68	0	0
16	34526795	.	A	T	28	40	68	0	3	71	0	0
16	34526926	.	A	T	16	27	43	1	16	60	0	0
16	34527192	.	T	A	9	4	13	0	1	14	0	0
16	34532040	.	C	T	1	2	3	0	0	3	0	0
16	34532205	.	G	A	1	10	11	0	7	18	0	0
16	34532782	.	C	G	3	10	13	0	0	13	0	0
16	34532843	.	T	C	2	2	4	0	0	4	0	0
16	34930635	.	A	G	1	4	5	0	0	5	0	0
16	34930719	.	C	T	0	7	7	0	3	10	0	0
16	34948262	.	C	T	5	4	9	0	0	9	0	0
16	34953166	.	C	T	7	4	11	0	0	11	0	0
16	34975908	.	A	G	0	1	1	0	0	1	0	0
16	35022679	.	G	A	2	3	5	0	0	5	0	0
16	35053907	.	C	G	1	4	5	0	0	5	0	0
16	35372069	.	C	T	3	3	6	0	0	6	0	0
16	35376598	.	G	T	2	4	6	0	0	6	0	0
16	35376825	.	C	T	5	7	12	0	0	12	0	0
16	35376902	.	A	T	3	3	6	0	1	7	0	0
16	35409483	.	C	T	1	15	16	0	23	39	0	0
16	35409783	.	G	A	4	4	8	0	1	9	0	0
16	35414455	.	A	G	4	3	7	0	0	7	0	0
16	35414470	.	T	C	3	3	6	0	0	6	0	0
16	35414991	.	C	T	9	17	26	0	1	27	0	0
16	35416113	.	A	G	3	4	7	0	1	8	0	0
16	35416158	.	C	T	0	0	0	0	1	1	0	0
16	35416786	.	A	G	5	5	10	0	1	11	0	0
16	35418744	.	T	C	3	0	3	0	1	4	0	0
16	35420600	.	T	C	4	0	4	0	4	8	0	0
16	35423585	.	C	T	0	12	12	0	4	16	0	0
16	35426998	.	T	C	5	0	5	0	8	13	0	0
16	35536574	.	C	A	11	11	22	0	0	22	0	0
16	35536576	.	G	A	0	11	11	0	11	22	0	0
16	35536848	.	G	A	5	12	17	0	2	19	0	0
16	35536900	.	A	G	4	5	9	0	0	10	1	0
16	35536960	.	T	C	11	9	20	0	1	21	0	0
16	35536990	.	C	T	8	11	19	0	2	21	0	0
16	35537153	.	G	A	6	4	10	0	0	10	0	0
16	35537270	.	C	A	13	13	26	0	0	26	0	0
16	35556078	.	G	A	1	2	3	0	0	3	0	0
16	35556083	.	C	T	1	2	3	0	0	3	0	0
16	35556192	.	C	T	0	2	2	0	4	6	0	0
16	35556303	.	C	T	4	6	10	0	0	10	0	0
16	35556365	.	A	G	3	2	5	0	0	5	0	0
16	35556819	.	A	T	1	3	4	0	0	4	0	0
16	35661979	.	A	G	3	5	8	0	0	8	0	0
16	35662078	.	T	G	3	2	5	0	0	5	0	0
16	35662132	.	A	C	2	1	3	0	0	3	0	0
16	35728994	.	G	A	0	1	1	0	0	1	0	0
16	35743849	.	A	T	3	0	3	0	0	3	0	0
16	35750714	.	T	A	5	10	15	0	1	16	0	0
16	35752670	.	C	T	18	6	24	0	0	24	0	0
16	35752785	.	T	C	23	9	32	0	1	33	0	0
16	35773005	.	A	G	3	8	11	0	1	12	0	0
16	36041247	.	G	A	2	0	2	0	0	2	0	0
16	36062265	.	T	C	2	0	2	0	4	6	0	0
16	36075345	.	T	C	13	5	18	0	0	18	0	0
16	36075471	.	G	A	7	7	14	0	1	15	0	0
16	36075478	.	T	A	8	6	14	0	0	14	0	0
16	36075677	.	C	A	6	13	19	0	2	21	0	0
16	36075999	.	A	G	8	9	17	0	0	17	0	0
16	36076082	.	G	A	7	11	18	0	1	19	0	0
16	36080364	.	C	T	8	13	21	0	0	21	0	0
16	36080376	.	A	C	7	11	18	0	0	18	0	0
16	36118070	.	T	C	3	0	3	0	7	10	0	0
16	36118166	.	T	C	4	0	4	0	3	7	0	0
16	36150674	.	A	G	3	6	9	0	0	9	0	0
16	36150707	.	C	T	6	13	19	0	0	19	0	0
16	36150949	.	C	T	13	17	30	0	1	31	0	0
16	36150964	.	C	T	11	14	25	0	1	26	0	0
16	36151000	.	C	A	6	3	9	0	0	9	0	0
16	36159928	.	T	C	14	17	31	0	1	32	0	0
16	36162013	.	C	T	20	17	37	0	1	38	0	0
16	36162201	.	A	G	7	12	19	0	3	22	0	0
16	36162584	.	G	C	0	12	12	0	9	21	0	0
16	36162650	.	T	C	14	15	29	0	1	30	0	0
16	36162727	.	A	G	18	16	34	0	0	34	0	0
16	36162754	.	A	G	19	18	37	0	0	37	0	0
16	36162938	.	G	T	14	6	20	0	1	21	0	0
16	36163005	.	G	A	10	6	16	0	0	16	0	0
16	36163006	.	A	C	8	4	12	0	3	16	1	0
16	36168251	.	C	T	5	5	10	0	2	12	0	0
16	36168317	.	G	C	9	8	17	0	1	18	0	0
16	36168416	.	T	C	9	6	15	0	0	15	0	0
16	36168450	.	A	T	5	3	8	0	1	9	0	0
16	36168510	.	A	T	8	6	14	0	0	14	0	0
16	36168575	.	T	G	7	1	8	0	1	9	0	0
16	36168747	.	T	C	1	3	4	0	1	5	0	0
16	36168787	.	T	A	9	5	14	0	0	14	0	0
16	36168994	.	C	T	5	6	11	0	0	11	0	0
16	36169007	.	T	C	3	7	10	0	1	11	0	0
16	36169057	.	T	G	0	5	5	0	3	8	0	0
16	36169150	.	T	C	4	4	8	0	0	8	0	0
16	36169568	.	G	T	4	1	5	0	2	7	0	0
16	36169868	.	A	C	3	0	3	0	1	4	0	0
16	36172961	.	A	G	1	0	1	0	0	1	0	0
16	36172982	.	C	T	3	1	4	0	0	4	0	0
16	36173406	.	A	T	6	3	9	0	0	9	0	0
16	36180540	.	G	A	2	0	2	0	0	2	0	0
16	36180591	.	A	G	1	2	3	0	1	4	0	0
16	36180753	.	A	G	1	1	2	0	0	2	0	0
16	36180810	.	T	A	3	2	5	0	0	5	0	0
16	36185315	.	G	A	0	1	1	0	0	1	0	0
16	36719658	.	A	C	1	3	4	0	0	4	0	0
16	36719659	.	A	C	1	3	4	0	0	4	0	0
16	36721560	.	A	T	5	6	11	0	2	13	0	0
16	36721589	.	T	G	2	7	9	0	1	10	0	0
16	36724010	.	C	G	0	7	7	0	7	14	0	0
16	36729322	.	A	T	7	3	10	0	2	12	0	0
16	36729352	.	G	T	10	10	20	0	0	20	0	0
16	36729373	.	A	G	10	9	19	0	0	19	0	0
16	36731307	.	A	G	2	12	14	0	0	14	0	0
16	36735751	.	T	C	1	4	5	0	0	5	0	0
16	36735760	.	T	C	0	0	0	0	2	2	0	0
16	36743757	.	T	C	3	5	8	0	0	8	0	0
16	36743787	.	A	G	2	5	7	0	0	7	0	0
16	36745973	.	C	T	0	2	2	0	0	2	0	0
16	36748366	.	T	C	2	0	2	0	3	5	0	0
16	36749242	.	T	G	1	0	1	0	2	3	0	0
16	36752278	.	T	C	0	1	1	0	0	1	0	0
16	36759756	.	A	G	2	5	7	0	0	7	0	0
16	36759763	.	G	T	2	5	7	0	0	7	0	0
16	36759812	.	A	G	1	2	3	0	1	4	0	0
16	36759834	.	T	C	3	3	6	0	0	6	0	0
16	36759908	.	A	T	11	9	20	0	1	21	0	0
16	36759937	.	A	G	8	10	18	0	0	18	0	0
16	36766180	.	T	G	22	12	34	0	0	34	0	0
16	36766467	.	G	T	11	11	22	0	2	24	0	0
16	36914935	.	T	C	0	2	2	0	0	2	0	0
16	36923298	.	C	T	7	4	11	0	0	11	0	0
16	36925462	.	G	A	0	2	2	0	1	3	0	0
16	36926775	.	C	A	6	3	9	0	0	9	0	0
16	36926779	.	A	C	6	2	8	0	0	8	0	0
16	36928169	.	A	T	3	4	7	0	0	7	0	0
16	36928179	.	A	C	3	4	7	0	0	7	0	0
16	36928429	.	A	G	3	4	7	0	0	7	0	0
16	36931822	.	T	C	10	4	14	0	0	14	0	0
16	36934191	.	T	A	7	7	14	0	0	14	0	0
16	36934340	.	C	A	0	5	5	0	4	9	0	0
16	36934398	.	G	C	5	3	8	1	1	10	0	0
16	36939973	.	T	C	0	0	0	0	2	2	0	0
16	36939982	.	A	G	3	2	5	0	1	6	0	0
16	36940045	.	C	T	8	6	14	0	0	14	0	0
16	36941706	.	T	C	1	0	1	0	0	1	0	0
16	36941790	.	T	C	2	4	6	0	0	6	0	0
16	36941961	.	T	C	0	0	0	0	1	1	0	0
16	36942068	.	C	A	2	2	4	0	0	4	0	0
16	36945181	.	T	C	4	0	4	0	0	4	0	0
16	36945182	.	T	G	1	3	4	0	0	4	0	0
16	36945288	.	G	A	3	6	9	0	0	9	0	0
16	36974719	.	T	C	1	1	2	0	0	2	0	0
16	36975141	.	G	A	3	11	14	0	1	15	0	0
16	36975146	.	C	T	0	9	9	0	3	12	0	0
16	36975183	.	G	C	1	1	2	0	0	2	0	0
16	36975318	.	T	A	2	6	8	0	0	8	0	0
16	36976721	.	A	G	7	8	15	0	0	15	0	0
16	36977387	.	A	G	1	2	3	0	1	4	0	0
16	36979518	.	G	A	7	11	18	0	1	19	0	0
16	36979521	.	A	G	7	10	17	0	1	18	0	0
16	37167545	.	T	A	2	7	9	0	0	9	0	0
16	37167589	.	T	G	2	10	12	0	0	12	0	0
16	37167784	.	C	G	5	6	11	0	0	11	0	0
16	37167968	.	G	A	3	11	14	0	0	14	0	0
16	37306905	.	G	A	8	6	14	0	0	14	0	0
16	37323594	.	A	C	0	1	1	0	0	1	0	0
16	37521130	.	A	G	3	4	7	0	0	7	0	0
16	37552348	.	A	C	2	2	4	0	0	4	0	0
16	37552966	.	G	A	6	2	8	0	1	9	0	0
16	37554821	.	C	T	6	7	13	0	1	14	0	0
16	37563601	.	G	A	0	1	1	0	0	1	0	0
16	37563643	.	T	G	0	0	0	0	1	1	0	0
16	37565676	.	C	G	1	1	2	0	0	2	0	0
16	37593444	.	G	A	4	0	4	0	1	5	0	0
16	37596645	.	C	T	5	6	11	0	1	12	0	0
16	37596669	.	G	A	2	5	7	0	0	7	0	0
16	37614071	.	A	G	3	2	5	0	0	5	0	0
16	37617219	.	A	G	5	0	5	0	14	19	0	0
16	37617304	.	A	G	12	0	12	0	19	31	0	0
16	37617738	.	T	C	26	15	41	0	0	41	0	0
16	37627218	.	T	G	11	17	28	1	4	33	0	0
16	37627762	.	G	A	2	23	25	0	19	44	0	0
16	37627997	.	T	G	18	27	45	0	1	46	0	0
16	37930942	.	G	A	0	1	1	0	0	1	0	0
16	37944287	.	G	A	0	5	5	0	0	5	0	0
16	37944311	.	C	G	3	0	3	0	6	9	0	0
16	37947769	.	T	C	3	4	7	0	0	7	0	0
16	37948256	.	G	T	2	2	4	0	0	4	0	0
16	37948355	.	C	T	9	8	17	0	0	17	0	0
16	37948389	.	G	T	7	4	11	0	0	11	0	0
16	37948624	.	G	A	10	8	18	0	0	18	0	0
16	37948625	.	G	A	10	8	18	0	0	18	0	0
16	37963955	.	T	A	3	2	5	0	0	5	0	0
16	37964100	.	C	T	4	7	11	0	0	11	0	0
16	37964222	.	T	A	6	3	9	0	0	9	0	0
16	38018267	.	T	C	1	0	1	0	2	3	0	0
16	38018279	.	T	C	1	0	1	0	2	3	0	0
16	38125650	.	T	C	1	0	1	0	0	1	0	0
16	38127708	.	T	A	2	2	4	0	0	4	0	0
16	38129427	.	T	A	1	1	2	0	0	2	0	0
16	38129689	.	T	C	3	2	5	0	0	5	0	0
16	38130661	.	T	C	0	2	2	0	0	2	0	0
16	38135699	.	T	C	11	10	21	0	0	21	0	0
16	38136117	.	C	T	2	7	9	0	0	9	0	0
16	38136278	.	C	T	10	15	25	0	1	27	1	0
16	38136317	.	G	A	14	9	23	0	1	24	0	0
16	38136346	.	C	T	5	12	17	0	0	17	0	0
16	38136491	.	G	C	4	5	9	0	1	10	0	0
16	38154236	.	A	G	0	2	2	0	0	2	0	0
16	38159817	.	C	A	4	2	6	0	0	6	0	0
16	38167511	.	C	T	2	2	4	0	1	5	0	0
16	38167904	.	A	G	6	0	6	0	8	14	0	0
16	38168009	.	A	G	7	3	10	0	2	12	0	0
16	38168095	.	G	A	0	7	7	0	4	11	0	0
16	38188955	.	G	A	0	8	8	0	6	14	0	0
16	38189099	.	T	C	3	3	6	0	2	8	0	0
16	38191645	.	C	T	3	2	5	0	0	5	0	0
16	38194017	.	T	C	2	4	6	0	0	6	0	0
16	38199647	.	G	A	6	6	12	0	0	12	0	0
16	38266242	.	T	C	3	2	5	0	0	5	0	0
16	38313176	.	G	T	2	2	4	0	0	4	0	0
16	38350854	.	G	C	0	2	2	0	1	3	0	0
16	38350881	.	T	C	2	2	4	0	0	4	0	0
16	38355299	.	G	A	5	5	10	0	0	10	0	0
16	38454535	.	A	G	3	7	10	0	0	10	0	0
16	38499053	.	C	T	0	1	1	0	6	7	0	0
16	38553647	.	C	T	1	1	2	0	0	2	0	0
16	38556912	.	G	A	9	8	17	0	2	19	0	0
16	38556922	.	C	G	0	8	8	0	11	20	1	0
16	38557876	.	G	C	17	0	17	0	6	23	0	0
16	38568644	.	G	C	10	10	20	0	0	20	0	0
16	38729548	.	G	A	6	7	13	0	0	13	0	0
16	38729551	.	G	T	0	6	6	0	7	13	0	0
16	38943253	.	C	T	1	0	1	0	0	1	0	0
16	38943547	.	A	G	9	0	9	0	6	15	0	0
16	39146871	.	A	C	6	12	18	0	0	18	0	0
16	39157751	.	C	A	10	12	22	0	0	22	0	0
16	39157885	.	T	A	2	2	4	0	0	4	0	0
16	39160458	.	A	C	2	1	3	0	0	3	0	0
16	39162786	.	C	T	17	12	29	0	0	29	0	0
16	39164213	.	G	A	3	2	5	0	0	5	0	0
16	39166773	.	C	T	19	22	41	0	4	45	0	0
16	39166854	.	C	T	22	26	48	0	2	50	0	0
16	39167028	.	C	A	14	12	26	0	3	29	0	0
16	39167088	.	C	T	8	11	19	0	1	20	0	0
16	39185580	.	G	A	11	17	28	0	0	28	0	0
16	39191557	.	T	C	2	0	2	0	7	9	0	0
16	39196850	.	A	C	1	4	5	0	0	5	0	0
16	39213237	.	G	A	0	2	2	0	0	2	0	0
16	39233140	.	T	C	1	2	3	0	0	3	0	0
16	39238630	.	G	A	1	2	3	0	0	3	0	0
16	39244286	.	T	C	24	15	39	0	1	40	0	0
16	39248745	.	T	A	9	5	14	0	0	14	0	0
16	39248765	.	G	C	4	7	11	0	0	11	0	0
16	39248811	.	C	G	4	6	10	0	0	10	0	0
16	39248813	.	T	A	4	6	10	0	0	10	0	0
16	39248864	.	G	A	10	6	16	0	0	16	0	0
16	39248886	.	C	A	11	7	18	0	1	19	0	0
16	39248976	.	G	A	10	8	18	0	1	19	0	0
16	39249056	.	G	A	11	1	12	0	1	13	0	0
16	39249229	.	C	T	3	5	8	0	1	9	0	0
16	39249350	.	A	C	2	3	5	0	2	7	0	0
16	39249475	.	C	A	6	4	10	0	0	10	0	0
16	39249506	.	G	A	8	4	12	0	0	12	0	0
16	39249527	.	A	T	6	3	9	0	0	9	0	0
16	39250197	.	C	T	1	3	4	0	0	4	0	0
16	39253200	.	G	A	0	1	1	0	0	1	0	0
16	39271329	.	A	C	6	5	11	0	0	11	0	0
16	39271394	.	G	C	1	2	3	0	0	3	0	0
16	39297336	.	C	A	1	3	4	0	1	5	0	0
16	39297344	.	A	T	2	2	4	0	1	5	0	0
16	39297378	.	C	T	1	4	5	0	0	5	0	0
16	39323716	.	C	T	5	9	14	0	1	15	0	0
16	39323809	.	T	C	0	0	0	0	1	1	0	0
16	39325084	.	A	G	0	0	0	0	3	3	0	0
16	39325121	.	G	A	0	4	4	0	0	4	0	0
16	39361889	.	C	T	2	4	6	0	0	6	0	0
16	39362312	.	G	T	1	0	1	0	2	3	0	0
16	39372345	.	G	A	7	6	13	0	2	15	0	0
16	39372372	.	T	C	9	4	13	0	0	13	0	0
16	39372735	.	G	C	1	5	6	0	12	18	0	0
16	39372780	.	C	A	7	11	18	0	2	20	0	0
16	39378744	.	A	G	3	0	3	0	4	7	0	0
16	39382047	.	C	G	10	8	18	0	0	18	0	0
16	39382084	.	C	T	15	13	28	0	0	28	0	0
16	39382098	.	G	A	13	8	21	0	1	22	0	0
16	39382208	.	T	C	6	10	16	0	0	16	0	0
16	39382467	.	C	G	4	6	10	0	0	10	0	0
16	39382482	.	G	A	3	2	5	0	1	6	0	0
16	39385755	.	T	C	13	0	13	0	17	30	0	0
16	39386184	.	T	C	23	7	30	0	1	31	0	0
16	39386239	.	T	A	16	18	34	0	3	37	0	0
16	39386915	.	C	T	17	15	32	0	0	32	0	0
16	39390139	.	T	C	23	0	23	0	17	40	0	0
16	39390175	.	G	A	15	16	31	0	0	31	0	0
16	39393370	.	A	G	2	6	8	0	2	10	0	0
16	39394630	.	A	G	10	20	30	0	1	31	0	0
16	39399140	.	A	C	5	0	5	0	6	11	0	0
16	39532994	.	A	G	2	2	4	0	0	4	0	0
16	39533013	.	C	T	1	2	3	0	0	3	0	0
16	39901274	.	G	A	3	2	5	0	0	5	0	0
16	39901290	.	C	A	4	2	6	0	0	6	0	0
16	39901344	.	C	T	0	4	4	0	1	5	0	0
16	40025019	.	A	G	2	2	4	0	1	5	0	0
16	40025025	.	T	G	2	2	4	0	0	4	0	0
16	40026573	.	A	G	1	0	1	0	1	2	0	0
16	40031649	.	A	G	3	9	12	0	0	12	0	0
16	40319979	.	T	C	1	0	1	0	1	2	0	0
16	40340664	.	A	T	3	2	5	0	0	5	0	0
16	40340706	.	T	G	4	3	7	0	0	7	0	0
16	40340710	.	C	G	3	4	7	0	0	7	0	0
16	40340953	.	C	G	2	0	2	0	3	5	0	0
16	40340967	.	A	G	3	3	6	0	0	6	0	0
16	40343465	.	G	A	4	2	6	0	0	6	0	0
16	40343747	.	T	C	2	0	2	0	0	2	0	0
16	40346750	.	A	G	1	1	2	0	0	2	0	0
16	40346754	.	T	A	1	0	1	0	0	1	0	0
16	41030560	.	T	C	1	3	4	0	0	4	0	0
16	41732409	.	A	G	11	4	15	0	0	15	0	0
16	42322458	.	T	G	41	41	82	0	4	86	0	0
16	42373933	.	A	C	25	28	53	0	0	53	0	0
16	42374020	.	C	T	0	36	36	0	12	48	0	0
16	42374080	.	G	T	23	26	49	0	0	49	0	0
16	42374254	.	C	T	21	27	48	0	3	51	0	0
16	42374290	.	G	A	21	25	46	0	3	49	0	0
16	42374425	.	A	G	14	25	39	0	2	41	0	0
16	42374434	.	A	C	17	23	40	0	2	42	0	0
16	42390176	.	T	C	15	0	15	0	15	30	0	0
16	42424240	.	G	A	10	10	20	0	2	22	0	0
16	42424348	.	T	C	13	8	21	0	0	21	0	0
16	42424352	.	G	A	13	7	20	0	0	20	0	0
16	42424405	.	G	A	8	12	20	0	0	20	0	0
16	42424504	.	C	A	12	8	20	0	1	21	0	0
16	42424505	.	A	C	11	8	19	0	2	21	0	0
16	42424653	.	G	C	11	8	19	0	1	20	0	0
16	42424762	.	G	A	13	16	29	0	2	31	0	0
16	42428454	.	T	C	12	17	29	0	0	29	0	0
16	42428472	.	C	T	9	12	21	0	2	23	0	0
16	42440999	.	T	C	5	2	7	0	2	9	0	0
16	42443875	.	A	G	5	7	12	0	0	12	0	0
16	42452554	.	T	C	2	4	6	0	0	6	0	0
16	42452557	.	G	A	2	3	5	0	1	6	0	0
16	42452591	.	C	G	1	1	2	0	0	2	0	0
16	42452592	.	T	A	1	1	2	0	0	2	0	0
16	42461121	.	T	C	2	0	2	0	2	4	0	0
16	42472294	.	C	G	1	2	3	0	0	3	0	0
16	42482378	.	T	C	5	4	9	0	0	9	0	0
16	42482418	.	A	T	8	5	13	0	1	14	0	0
16	42670347	.	T	C	1	2	3	0	0	3	0	0
16	42681256	.	C	A	2	1	3	0	0	3	0	0
16	42683409	.	A	G	0	1	1	0	2	3	0	0
16	42829855	.	C	A	5	7	12	0	0	12	0	0
16	42831980	.	A	G	3	0	3	0	2	5	0	0
16	42840237	.	A	G	4	3	7	0	0	7	0	0
16	42842991	.	G	C	12	8	20	0	1	21	0	0
16	42842995	.	A	G	13	8	21	0	0	21	0	0
16	42898555	.	A	G	6	10	16	0	0	16	0	0
16	42900256	.	T	C	4	3	7	0	0	7	0	0
16	42900259	.	A	C	4	3	7	0	0	7	0	0
16	42900326	.	T	G	2	0	2	0	0	3	1	0
16	42900334	.	G	A	2	1	3	0	0	3	0	0
16	42900500	.	G	A	5	3	8	0	0	8	0	0
16	42900509	.	A	G	4	2	6	0	0	6	0	0
16	42900598	.	G	A	0	3	3	0	1	4	0	0
16	42938926	.	A	T	7	1	8	0	1	9	0	0
16	42938927	.	G	T	6	2	8	0	1	9	0	0
16	42938992	.	G	T	5	7	12	0	1	13	0	0
16	42938995	.	A	G	6	6	12	0	1	13	0	0
16	42939061	.	A	T	5	3	8	0	0	8	0	0
16	42939097	.	A	G	3	3	6	0	0	6	0	0
16	42939105	.	G	A	3	2	5	0	0	5	0	0
16	42939293	.	A	G	11	11	22	0	4	26	0	0
16	42939351	.	T	C	10	8	18	0	2	20	0	0
16	42939479	.	A	G	16	12	28	0	0	28	0	0
16	42939480	.	C	T	1	12	13	0	15	28	0	0
16	42939561	.	G	C	10	14	24	0	1	25	0	0
16	42939607	.	C	T	9	12	21	0	0	21	0	0
16	42939675	.	G	C	10	8	18	0	0	18	0	0
16	42939695	.	A	G	12	7	19	0	0	19	0	0
16	42939939	.	T	A	1	2	3	0	0	3	0	0
16	42939945	.	T	A	1	1	2	0	0	2	0	0
16	42940157	.	G	A	3	2	5	0	0	5	0	0
16	42940259	.	A	G	3	3	6	0	0	6	0	0
16	42940336	.	A	G	7	3	10	0	0	10	0	0
16	42940364	.	T	A	3	3	6	0	2	8	0	0
16	42940463	.	T	C	3	2	5	0	0	5	0	0
16	42940490	.	T	C	1	4	5	0	0	5	0	0
16	42940916	.	G	A	2	2	4	0	0	4	0	0
16	42941124	.	C	A	7	8	15	0	0	15	0	0
16	42941405	.	A	T	0	4	4	0	0	4	0	0
16	42949151	.	C	T	0	1	1	0	3	4	0	0
16	42949254	.	T	C	1	0	1	0	3	4	0	0
16	42951876	.	G	A	3	0	3	0	0	3	0	0
16	42951909	.	C	T	3	0	3	0	0	3	0	0
16	42975613	.	A	G	4	2	6	0	0	6	0	0
16	42975736	.	T	G	4	1	5	0	0	5	0	0
16	42975742	.	T	C	2	2	4	0	1	5	0	0
16	43000955	.	T	C	5	4	9	0	0	9	0	0
16	43001124	.	A	T	6	12	18	0	1	19	0	0
16	43001148	.	G	A	8	10	18	0	0	18	0	0
16	43001246	.	G	C	8	2	10	0	8	18	0	0
16	43001290	.	A	C	8	15	23	0	0	23	0	0
16	43001354	.	C	T	0	15	15	0	13	28	0	0
16	43001368	.	T	G	15	14	29	0	1	30	0	0
16	43003080	.	A	G	2	8	10	0	1	11	0	0
16	43015484	.	A	G	34	28	62	0	2	64	0	0
16	43026189	.	A	C	6	4	10	0	0	10	0	0
16	43028295	.	T	C	9	4	13	0	1	14	0	0
16	43028303	.	C	T	6	6	12	0	0	12	0	0
16	43028353	.	G	A	4	5	9	0	0	9	0	0
16	43028369	.	A	G	3	5	8	0	2	10	0	0
16	43028452	.	T	G	5	3	8	0	0	8	0	0
16	43028453	.	C	T	5	3	8	0	0	8	0	0
16	43028542	.	A	T	10	9	19	0	2	21	0	0
16	43028546	.	C	T	11	9	20	0	0	20	0	0
16	43126424	.	A	T	4	2	6	0	0	6	0	0
16	43126425	.	C	T	4	2	6	0	0	6	0	0
16	43126502	.	G	T	3	6	9	0	0	9	0	0
16	43126513	.	T	A	3	4	7	0	0	7	0	0
16	43126566	.	G	A	2	9	11	0	0	11	0	0
16	43126694	.	T	C	1	0	1	0	3	4	0	0
16	43126886	.	A	G	6	15	21	0	0	21	0	0
16	43126887	.	C	T	0	14	14	0	7	21	0	0
16	43130296	.	C	T	1	0	1	0	0	1	0	0
16	43145812	.	T	C	0	2	2	0	0	2	0	0
16	43149733	.	C	T	1	2	3	0	0	3	0	0
16	43211396	.	T	C	0	1	1	0	0	1	0	0
16	43227950	.	T	C	12	1	13	0	8	21	0	0
16	43228017	.	T	A	11	5	16	0	0	16	0	0
16	43228055	.	C	T	7	10	17	0	1	18	0	0
16	43228331	.	A	C	8	0	8	0	6	14	0	0
16	43228406	.	T	C	1	0	1	0	5	6	0	0
16	43228567	.	A	G	3	3	6	0	0	6	0	0
16	43228796	.	C	T	0	8	8	0	1	9	0	0
16	43228847	.	G	T	5	8	13	0	0	13	0	0
16	43228942	.	C	T	8	6	14	0	0	14	0	0
16	43228945	.	T	C	9	5	14	0	0	14	0	0
16	43229315	.	T	C	8	0	8	0	5	13	0	0
16	43229396	.	T	C	4	5	9	1	0	10	0	0
16	43229443	.	T	G	2	8	10	0	0	10	0	0
16	43229961	.	T	A	2	4	6	0	1	7	0	0
16	43230258	.	T	C	6	3	9	0	1	10	0	0
16	43230296	.	A	G	4	4	8	0	0	8	0	0
16	43230435	.	T	C	7	0	7	0	7	14	0	0
16	43230527	.	A	G	1	3	4	0	0	4	0	0
16	43230540	.	G	T	2	3	5	0	0	5	0	0
16	43230771	.	A	G	0	1	1	0	0	1	0	0
16	43255499	.	G	A	1	0	1	0	0	1	0	0
16	43263617	.	G	T	0	5	5	0	2	7	0	0
16	43269922	.	C	T	5	4	9	0	0	9	0	0
16	43283941	.	C	T	3	6	9	0	0	9	0	0
16	43284313	.	G	A	14	10	24	0	1	25	0	0
16	43284429	.	C	T	12	9	21	0	2	23	0	0
16	43291872	.	T	C	5	5	10	0	0	10	0	0
16	43291907	.	A	G	1	3	4	0	0	4	0	0
16	43297195	.	G	C	1	0	1	0	0	1	0	0
16	43300053	.	A	G	6	4	10	0	0	10	0	0
16	43300083	.	C	T	0	4	4	0	6	10	0	0
16	43301905	.	T	G	3	3	6	0	0	6	0	0
16	43303873	.	T	C	4	3	7	0	0	7	0	0
16	43303912	.	A	G	5	4	9	0	0	9	0	0
16	43303921	.	C	T	4	4	8	0	0	8	0	0
16	43303948	.	T	C	2	3	5	0	0	5	0	0
16	43306721	.	T	C	3	11	14	0	1	15	0	0
16	43306995	.	A	G	2	2	4	0	0	4	0	0
16	43309443	.	A	G	1	5	6	0	1	7	0	0
16	43309498	.	T	C	1	0	1	0	4	5	0	0
16	43319477	.	C	A	1	1	2	0	0	2	0	0
16	43321050	.	C	T	0	1	1	0	0	1	0	0
16	43321432	.	G	T	0	2	2	0	0	2	0	0
16	43336681	.	A	G	8	5	13	0	0	13	0	0
16	43341256	.	C	T	0	2	2	0	4	6	0	0
16	43345237	.	C	A	17	10	27	0	0	27	0	0
16	43346877	.	C	T	9	5	14	0	0	14	0	0
16	43349183	.	C	T	7	5	12	0	0	12	0	0
16	43349315	.	G	A	5	11	16	0	0	16	0	0
16	43349624	.	C	T	3	14	17	0	0	17	0	0
16	43349639	.	T	C	3	14	17	0	0	17	0	0
16	43349843	.	A	T	2	7	9	0	0	9	0	0
16	43350236	.	T	C	0	7	7	0	0	7	0	0
16	43368574	.	T	A	4	4	8	0	1	9	0	0
16	43368669	.	G	T	0	2	2	0	0	2	0	0
16	43375493	.	G	A	0	2	2	0	2	4	0	0
16	43389752	.	T	C	2	1	3	0	0	3	0	0
16	43389797	.	T	C	2	1	3	0	0	3	0	0
16	43391618	.	G	A	5	1	6	0	0	6	0	0
16	43392022	.	A	G	4	4	8	0	0	8	0	0
16	43413176	.	A	C	2	2	4	0	0	4	0	0
16	43517526	.	C	T	0	6	6	0	2	8	0	0
16	43742277	.	A	T	2	6	8	0	1	9	0	0
16	43766106	.	T	C	1	1	2	0	1	3	0	0
16	43804352	.	A	G	1	0	1	0	1	2	0	0
16	43804361	.	C	T	1	2	3	0	0	3	0	0
16	43814252	.	G	T	1	4	5	0	0	5	0	0
16	43818954	.	A	G	1	6	7	0	0	7	0	0
16	43819623	.	A	G	14	16	30	0	1	31	0	0
16	43819934	.	A	G	10	12	22	0	3	25	0	0
16	43820317	.	A	G	17	17	34	0	0	34	0	0
16	43820405	.	G	A	10	24	34	0	1	35	0	0
16	43820453	.	C	T	14	17	31	0	1	32	0	0
16	43820654	.	T	C	21	8	29	0	0	29	0	0
16	43820655	.	G	A	20	8	28	0	1	29	0	0
16	43820777	.	G	A	11	8	19	0	1	20	0	0
16	43821047	.	G	A	10	10	20	0	0	20	0	0
16	43821146	.	G	A	10	13	23	0	2	25	0	0
16	43821170	.	T	G	14	18	32	0	2	34	0	0
16	43821455	.	C	T	6	8	14	0	0	14	0	0
16	43822025	.	T	C	6	5	11	0	2	13	0	0
16	43822343	.	T	G	2	2	4	0	0	4	0	0
16	43822794	.	G	T	1	2	3	0	0	3	0	0
16	43920381	.	C	T	3	1	4	0	0	4	0	0
16	44044497	.	C	T	4	5	9	0	1	10	0	0
16	44338921	.	T	A	22	26	48	0	4	52	0	0
16	44339284	.	C	T	3	19	22	1	20	43	0	0
16	44339466	.	A	G	23	19	42	0	0	42	0	0
16	44339475	.	A	G	20	13	33	0	1	34	0	0
16	44342679	.	C	T	3	5	8	0	0	8	0	0
16	44349766	.	A	G	9	20	29	0	2	31	0	0
16	44349830	.	A	G	10	14	24	0	1	25	0	0
16	44460348	.	C	T	0	9	9	0	7	16	0	0
16	44462580	.	T	A	5	9	14	0	0	14	0	0
16	44509758	.	G	A	6	5	11	0	0	11	0	0
16	44509821	.	C	T	9	7	16	0	1	17	0	0
16	44509842	.	T	C	10	0	10	0	9	19	0	0
16	44509923	.	C	T	8	7	15	0	0	15	0	0
16	44510055	.	C	A	3	11	14	0	0	14	0	0
16	44512583	.	C	T	0	0	0	0	2	2	0	0
16	44512625	.	A	T	8	9	17	0	1	18	0	0
16	44512685	.	G	C	7	15	22	0	1	23	0	0
16	44512706	.	G	A	6	12	18	0	0	18	0	0
16	44512733	.	A	G	2	7	9	0	2	11	0	0
16	44512936	.	T	C	6	0	6	0	3	9	0	0
16	44588071	.	G	A	1	2	3	0	0	3	0	0
16	44588236	.	T	C	1	0	1	0	0	1	0	0
16	44665348	.	C	T	0	4	4	0	2	6	0	0
16	44665358	.	A	G	3	5	8	0	0	8	0	0
16	44668083	.	G	A	1	1	2	0	0	2	0	0
16	44669333	.	A	G	3	5	8	0	0	8	0	0
16	44672368	.	C	T	1	4	5	0	0	5	0	0
16	44673395	.	C	G	0	4	4	0	0	4	0	0
16	44673442	.	A	C	3	0	3	0	6	9	0	0
16	44673734	.	C	A	6	6	12	0	1	13	0	0
16	44673748	.	T	C	6	0	6	0	4	10	0	0
16	44673769	.	A	G	6	3	9	0	0	9	0	0
16	44679778	.	T	C	0	1	1	0	0	1	0	0
16	44687825	.	G	T	1	3	4	0	1	5	0	0
16	44687856	.	G	A	1	2	3	0	0	3	0	0
16	44788444	.	A	C	6	0	6	0	9	15	0	0
16	44788736	.	G	T	7	3	10	0	1	11	0	0
16	44790834	.	G	A	4	5	9	0	0	9	0	0
16	44793526	.	T	C	1	1	2	0	0	2	0	0
16	44819383	.	G	A	1	3	4	0	0	4	0	0
16	44877275	.	T	A	2	2	4	0	0	4	0	0
16	44881979	.	C	T	4	6	10	0	1	11	0	0
16	44884701	.	A	G	3	1	4	0	0	4	0	0
16	44888458	.	T	G	8	6	14	0	1	15	0	0
16	44888473	.	G	A	7	6	13	0	0	13	0	0
16	44892957	.	T	C	2	2	4	0	0	4	0	0
16	44893131	.	C	T	6	0	6	0	1	7	0	0
16	44893137	.	C	G	9	1	10	0	0	10	0	0
16	44900266	.	A	C	2	4	6	0	0	6	0	0
16	44983679	.	A	T	3	4	7	0	0	7	0	0
16	44983870	.	A	T	7	7	14	0	0	14	0	0
16	44983982	.	A	C	5	13	18	0	1	19	0	0
16	44984214	.	C	T	7	8	15	0	2	17	0	0
16	44984532	.	A	T	2	9	11	0	0	11	0	0
16	44986810	.	A	T	5	2	7	0	1	8	0	0
16	44989142	.	T	A	0	1	1	0	0	1	0	0
16	44995448	.	A	G	2	2	4	0	0	4	0	0
16	44995484	.	C	T	0	2	2	0	1	3	0	0
16	45019606	.	A	T	12	13	25	0	0	25	0	0
16	45019768	.	C	G	25	18	43	0	1	44	0	0
16	45019868	.	A	G	2	5	7	0	0	7	0	0
16	45034336	.	G	A	1	7	8	0	2	10	0	0
16	45036921	.	T	A	1	2	3	0	0	3	0	0
16	45041736	.	A	G	5	2	7	0	0	7	0	0
16	45044709	.	T	G	31	31	62	0	3	65	0	0
16	45044710	.	A	T	32	31	63	0	2	65	0	0
16	45044858	.	T	C	25	2	27	0	37	64	0	0
16	45044910	.	T	C	31	57	88	0	3	91	0	0
16	45044952	.	T	A	45	49	94	0	1	96	1	0
16	45054004	.	A	G	16	10	26	0	1	27	0	0
16	45088196	.	A	C	4	1	5	0	0	5	0	0
16	45094399	.	A	G	4	3	7	0	1	8	0	0
16	45094423	.	A	G	4	4	8	0	1	9	0	0
16	45094523	.	A	G	5	8	13	0	0	13	0	0
16	45202703	.	G	A	17	11	28	0	2	30	0	0
16	45202795	.	A	G	16	20	36	0	1	37	0	0
16	45202798	.	A	G	15	20	35	0	1	36	0	0
16	45202926	.	A	G	18	18	36	0	3	39	0	0
16	45202962	.	T	A	11	10	21	0	1	22	0	0
16	45203076	.	C	A	8	11	19	0	0	19	0	0
16	45209294	.	A	G	1	0	1	0	0	1	0	0
16	45209300	.	A	G	1	0	1	0	0	1	0	0
16	45225374	.	G	A	0	1	1	0	0	1	0	0
16	45225381	.	C	A	1	2	3	0	0	3	0	0
16	45355442	.	C	T	1	2	3	0	0	3	0	0
16	45355445	.	A	C	0	2	2	0	0	2	0	0
16	45357369	.	A	T	1	3	4	0	1	5	0	0
16	45364428	.	C	T	0	3	3	0	1	4	0	0
16	45364438	.	T	A	1	3	4	0	0	4	0	0
16	45368093	.	A	G	2	1	3	0	0	3	0	0
16	45368111	.	T	C	2	4	6	0	0	6	0	0
16	45368144	.	A	G	3	4	7	0	0	7	0	0
16	45394013	.	T	C	1	0	1	0	0	1	0	0
16	45433976	.	T	G	1	0	1	0	3	4	0	0
16	45440521	.	G	T	0	1	1	0	1	2	0	0
16	45440539	.	G	A	1	3	4	0	0	4	0	0
16	45456167	.	G	A	2	2	4	0	1	5	0	0
16	45456240	.	T	C	2	2	4	0	0	4	0	0
16	45456241	.	G	A	2	2	4	0	0	4	0	0
16	45572197	.	T	C	1	2	3	0	0	3	0	0
16	45573037	.	T	A	2	2	4	0	0	4	0	0
16	45573038	.	T	A	2	2	4	0	0	4	0	0
16	45573088	.	C	T	4	5	9	0	0	9	0	0
16	45573090	.	T	C	4	5	9	0	0	9	0	0
16	45573251	.	T	A	1	2	3	0	0	3	0	0
16	45590081	.	A	C	0	1	1	0	3	4	0	0
16	45625065	.	G	A	2	2	4	0	0	4	0	0
16	45627066	.	T	G	0	1	1	0	0	1	0	0
16	45627258	.	C	T	0	4	4	0	0	4	0	0
16	45627363	.	A	G	1	0	1	0	1	2	0	0
16	45630276	.	A	G	5	0	5	0	10	15	0	0
16	45686536	.	C	T	8	5	13	0	0	13	0	0
16	45686586	.	C	T	5	4	9	0	2	11	0	0
16	45686998	.	T	A	2	6	8	0	2	10	0	0
16	45687199	.	G	A	0	2	2	0	3	5	0	0
16	45687202	.	A	T	1	2	3	0	2	5	0	0
16	45687299	.	C	T	6	7	13	0	0	13	0	0
16	45687631	.	G	A	3	3	6	0	0	7	1	0
16	45687718	.	A	G	3	0	3	0	6	9	0	0
16	45687766	.	T	G	4	5	9	0	0	9	0	0
16	45687896	.	T	G	7	5	12	0	0	12	0	0
16	45688005	.	T	C	2	4	6	0	0	6	0	0
16	45688171	.	C	T	3	5	8	0	1	9	0	0
16	45688228	.	G	A	0	4	4	0	7	11	0	0
16	45688323	.	G	T	7	6	13	0	0	14	1	0
16	45688431	.	T	A	9	7	16	0	1	17	0	0
16	45688662	.	T	C	7	12	19	0	0	19	0	0
16	45688814	.	C	T	15	14	29	0	1	30	0	0
16	45689411	.	T	A	19	9	28	0	0	28	0	0
16	45689435	.	A	G	20	11	31	0	2	33	0	0
16	45689476	.	T	A	22	17	39	0	1	40	0	0
16	45689484	.	G	T	19	20	39	0	1	40	0	0
16	45689835	.	T	C	8	16	24	0	0	24	0	0
16	45689898	.	A	T	15	17	32	0	0	32	0	0
16	45690148	.	A	T	14	7	21	0	1	22	0	0
16	45690296	.	T	C	19	16	35	0	2	37	0	0
16	45693611	.	G	A	2	5	7	0	0	7	0	0
16	45697007	.	T	C	5	2	7	0	0	7	0	0
16	45701289	.	G	A	0	1	1	0	0	1	0	0
16	45708377	.	T	A	6	2	8	0	0	8	0	0
16	45709001	.	G	T	0	3	3	0	4	7	0	0
16	45710316	.	T	A	2	2	4	0	1	5	0	0
16	45710337	.	T	C	3	6	9	0	1	10	0	0
16	45710536	.	C	T	8	8	16	0	0	16	0	0
16	45710691	.	A	G	12	9	21	0	2	23	0	0
16	45711077	.	C	T	5	8	13	0	4	17	0	0
16	45711117	.	A	G	10	7	17	0	2	19	0	0
16	45712455	.	A	G	1	3	4	0	0	4	0	0
16	45713631	.	A	G	12	16	28	0	1	29	0	0
16	45713661	.	A	G	8	0	8	0	16	24	0	0
16	45725844	.	A	G	3	5	8	0	0	8	0	0
16	45726665	.	T	A	8	14	22	0	1	23	0	0
16	45726677	.	A	G	5	12	17	0	3	20	0	0
16	45733990	.	G	A	0	2	2	0	0	2	0	0
16	45739418	.	T	C	0	2	2	0	0	2	0	0
16	45763476	.	G	A	0	5	5	0	3	8	0	0
16	45765813	.	C	T	4	1	5	0	0	5	0	0
16	45782233	.	C	G	7	13	20	0	0	20	0	0
16	45782244	.	C	G	8	14	22	0	0	22	0	0
16	45929436	.	A	G	11	1	12	0	19	31	0	0
16	46069113	.	C	T	0	2	2	0	0	2	0	0
16	46081965	.	A	T	1	2	3	0	1	4	0	0
16	46082014	.	G	A	0	2	2	0	1	3	0	0
16	46086280	.	A	G	4	6	10	0	0	10	0	0
16	46086333	.	G	A	6	8	14	0	0	14	0	0
16	46086357	.	A	G	6	10	16	0	0	16	0	0
16	46086373	.	T	A	10	12	22	0	0	22	0	0
16	46086484	.	A	T	13	8	21	0	0	21	0	0
16	46086538	.	G	A	1	4	5	0	13	18	0	0
16	46086638	.	A	T	7	6	13	0	0	13	0	0
16	46086654	.	C	A	4	7	11	0	0	11	0	0
16	46086691	.	T	A	5	3	8	0	0	8	0	0
16	46086719	.	G	T	3	2	5	0	1	6	0	0
16	46086844	.	A	G	1	3	4	0	0	4	0	0
16	46086885	.	T	C	2	5	7	0	0	7	0	0
16	46087257	.	G	A	9	8	17	0	1	18	0	0
16	46087290	.	T	A	7	6	13	0	1	14	0	0
16	46087583	.	C	A	2	4	6	0	0	6	0	0
16	46087945	.	T	A	10	9	19	0	0	19	0	0
16	46087951	.	T	A	10	9	19	0	1	20	0	0
16	46088372	.	T	C	4	4	8	0	2	10	0	0
16	46088652	.	C	T	13	12	25	0	5	30	0	0
16	46088711	.	T	G	11	8	19	0	0	19	0	0
16	46088837	.	C	T	13	10	23	0	0	23	0	0
16	46089278	.	A	T	13	5	18	0	1	19	0	0
16	46089485	.	A	G	9	14	23	0	0	23	0	0
16	46089490	.	T	A	8	13	21	0	0	21	0	0
16	46089708	.	T	C	11	0	11	0	3	14	0	0
16	46089710	.	C	G	11	3	14	0	0	14	0	0
16	46089809	.	C	T	1	7	8	0	17	25	0	0
16	46089867	.	G	A	11	13	24	0	1	25	0	0
16	46089979	.	T	A	16	9	25	0	0	25	0	0
16	46090056	.	C	G	7	14	21	0	1	22	0	0
16	46090070	.	T	C	9	13	22	0	1	23	0	0
16	46090186	.	C	T	10	4	14	0	0	14	0	0
16	46090296	.	G	A	8	6	14	0	0	14	0	0
16	46090310	.	G	A	7	6	13	0	0	13	0	0
16	46090447	.	A	G	10	9	19	0	2	21	0	0
16	46090629	.	G	T	10	7	17	1	0	18	0	0
16	46090640	.	A	G	11	7	18	1	0	19	0	0
16	46090713	.	T	C	11	0	11	0	11	22	0	0
16	46090731	.	T	G	11	9	20	0	0	20	0	0
16	46090749	.	G	C	8	8	16	0	0	16	0	0
16	46091116	.	A	G	4	2	6	0	0	6	0	0
16	46091412	.	T	C	2	3	5	0	0	5	0	0
16	46091415	.	T	C	2	3	5	0	1	6	0	0
16	46093332	.	A	T	4	6	10	0	0	10	0	0
16	46093580	.	G	T	5	7	12	0	0	12	0	0
16	46093685	.	T	C	0	1	1	0	0	1	0	0
16	46097033	.	A	C	0	0	0	0	1	1	0	0
16	46097111	.	G	A	8	4	12	0	0	12	0	0
16	46097239	.	G	A	5	7	12	0	0	12	0	0
16	46097268	.	A	G	4	6	10	0	1	11	0	0
16	46172471	.	C	A	4	4	8	0	1	9	0	0
16	46179734	.	T	C	6	5	11	0	0	11	0	0
16	46185307	.	A	G	4	5	9	0	0	9	0	0
16	46185349	.	G	C	0	3	3	0	2	5	0	0
16	46187505	.	T	C	0	2	2	0	0	2	0	0
16	46196245	.	C	T	9	16	25	0	3	28	0	0
16	46196287	.	T	C	8	20	28	0	1	29	0	0
16	46196347	.	T	A	11	16	27	0	0	27	0	0
16	46196536	.	T	C	12	11	23	0	0	23	0	0
16	46197266	.	G	A	2	25	27	0	27	54	0	0
16	46197308	.	A	G	28	2	30	0	24	54	0	0
16	46197313	.	T	G	27	25	52	0	1	53	0	0
16	46197343	.	C	T	28	25	53	0	1	54	0	0
16	46197358	.	A	G	20	2	22	0	29	51	0	0
16	46197442	.	G	A	28	14	42	1	10	53	0	0
16	46197955	.	T	G	21	19	40	2	2	44	0	0
16	46197988	.	A	T	15	11	26	2	1	29	0	0
16	46197999	.	A	C	18	12	30	2	0	32	0	0
16	46198166	.	T	A	21	13	34	0	0	34	0	0
16	46198167	.	T	G	21	13	34	0	0	34	0	0
16	46198208	.	C	T	18	22	40	0	0	40	0	0
16	46198222	.	T	A	21	20	41	0	1	42	0	0
16	46198265	.	A	G	25	12	37	0	2	39	0	0
16	46198319	.	G	T	20	18	38	0	1	39	0	0
16	46198322	.	C	T	20	17	37	0	3	40	0	0
16	46198380	.	C	A	20	19	39	0	2	41	0	0
16	46198406	.	A	G	24	16	40	0	0	40	0	0
16	46198430	.	A	G	15	1	16	0	23	39	0	0
16	46198451	.	A	C	21	23	44	0	0	44	0	0
16	46198486	.	A	C	21	23	44	0	1	45	0	0
16	46198641	.	C	T	8	13	21	0	1	22	0	0
16	46198658	.	T	A	9	9	18	0	0	18	0	0
16	46199364	.	C	T	28	25	53	0	1	54	0	0
16	46199471	.	C	A	31	25	56	0	1	57	0	0
16	46199492	.	C	A	29	26	55	0	3	58	0	0
16	46200063	.	T	C	29	19	48	0	7	55	0	0
16	46200165	.	C	A	21	22	43	0	1	44	0	0
16	46200409	.	T	C	23	32	55	0	3	58	0	0
16	46200510	.	G	T	35	25	60	0	1	61	0	0
16	46200560	.	G	C	36	28	64	0	2	66	0	0
16	46200578	.	G	A	38	25	63	0	4	67	0	0
16	46200655	.	G	A	3	32	35	0	33	68	0	0
16	46200678	.	A	T	30	29	59	0	7	66	0	0
16	46200787	.	T	C	23	22	45	0	0	45	0	0
16	46200907	.	T	C	20	26	46	0	0	46	0	0
16	46200958	.	C	A	23	24	47	0	2	49	0	0
16	46201121	.	T	G	36	19	55	0	3	58	0	0
16	46201254	.	A	T	36	21	57	0	3	60	0	0
16	46201525	.	T	C	21	35	56	0	1	57	0	0
16	46201559	.	A	T	33	28	61	0	0	61	0	0
16	46201583	.	A	G	25	32	57	0	5	62	0	0
16	46201599	.	T	C	28	34	62	0	0	62	0	0
16	46201943	.	T	A	35	23	58	0	3	61	0	0
16	46202287	.	G	A	27	31	58	0	4	62	0	0
16	46202423	.	C	A	22	16	38	0	1	39	0	0
16	46209196	.	A	C	5	8	13	0	0	13	0	0
16	46209231	.	T	C	4	5	9	0	0	9	0	0
16	46209767	.	A	T	1	2	3	0	0	3	0	0
16	46398472	.	C	T	0	4	4	0	9	13	0	0
16	46398489	.	T	C	9	4	13	0	0	13	0	0
16	46398536	.	A	C	11	0	11	0	0	11	0	0
16	46398567	.	C	G	5	6	11	0	1	12	0	0
16	46399080	.	G	A	6	4	10	0	0	10	0	0
16	46399542	.	G	T	5	6	11	0	2	13	0	0
16	46399586	.	T	C	4	2	6	0	0	6	0	0
16	46399587	.	T	C	4	0	4	0	2	6	0	0
16	46399623	.	C	G	4	6	10	0	0	10	0	0
16	46399680	.	C	G	2	2	4	0	0	4	0	0
16	46399709	.	C	A	2	4	6	0	1	7	0	0
16	46400028	.	G	T	0	1	1	0	1	2	0	0
16	46401030	.	A	T	3	4	7	0	0	7	0	0
16	46401210	.	T	C	1	5	6	0	0	6	0	0
16	46401284	.	G	A	1	3	4	0	0	4	0	0
16	46401350	.	T	G	1	3	4	0	0	4	0	0
16	46401576	.	A	G	7	6	13	0	0	13	0	0
16	46401584	.	T	A	4	6	10	0	1	11	0	0
16	46401617	.	A	T	5	4	9	0	0	9	0	0
16	46401805	.	G	A	5	9	14	0	0	14	0	0
16	46401945	.	A	T	2	6	8	0	0	8	0	0
16	46402049	.	C	A	4	10	14	0	1	15	0	0
16	46402130	.	A	G	2	3	5	0	0	5	0	0
16	46402167	.	G	C	1	1	2	0	0	2	0	0
16	46415769	.	T	G	8	7	15	0	1	16	0	0
16	46423028	.	G	C	3	1	4	0	0	4	0	0
16	46423477	.	G	A	9	4	13	0	1	14	0	0
16	46423636	.	G	A	10	5	15	0	0	15	0	0
16	46423663	.	A	G	11	4	15	0	0	15	0	0
16	46423675	.	T	C	10	7	17	0	1	18	0	0
16	46423705	.	G	A	15	12	27	0	0	27	0	0
16	46423793	.	C	T	13	9	22	0	0	22	0	0
16	46423805	.	T	C	15	8	23	0	0	23	0	0
16	46428381	.	C	T	0	2	2	0	1	3	0	0
16	46428430	.	A	G	2	6	8	0	0	8	0	0
16	46428448	.	A	G	2	4	6	0	0	6	0	0
16	46430447	.	C	G	1	4	5	0	0	5	0	0
16	46434021	.	A	T	8	6	14	0	1	15	0	0
16	46434982	.	C	G	1	2	3	3	0	6	0	0
16	46453207	.	G	A	0	4	4	0	8	12	0	0
16	46453268	.	A	T	3	2	5	0	0	5	0	0
16	46453269	.	T	C	3	2	5	0	0	5	0	0
16	46464028	.	A	C	1	3	4	0	0	4	0	0
16	46464030	.	G	A	1	3	4	0	0	4	0	0
16	46464090	.	A	C	0	4	4	0	0	4	0	0
16	46464219	.	G	A	5	4	9	0	0	9	0	0
16	46464345	.	C	A	2	9	11	0	0	11	0	0
16	46464951	.	C	T	4	3	7	0	0	7	0	0
16	46464964	.	G	A	0	2	2	0	3	5	0	0
16	46492885	.	T	C	1	2	3	0	0	3	0	0
16	46493014	.	G	C	1	0	1	0	0	1	0	0
16	46495109	.	G	A	0	8	8	0	4	12	0	0
16	46495214	.	A	C	5	8	13	0	0	13	0	0
16	46495334	.	T	C	11	5	16	0	0	16	0	0
16	46495697	.	C	T	11	6	17	0	1	18	0	0
16	46495798	.	T	A	7	5	12	0	0	12	0	0
16	46495811	.	G	A	11	7	18	0	0	18	0	0
16	46495934	.	C	T	17	8	25	0	0	25	0	0
16	46495967	.	T	A	11	8	19	0	0	19	0	0
16	46495973	.	G	A	10	6	16	0	0	16	0	0
16	46518484	.	G	T	14	11	25	0	0	25	0	0
16	46519918	.	G	T	13	6	19	0	1	20	0	0
16	46519934	.	T	C	8	1	9	0	9	18	0	0
16	46521455	.	G	A	0	1	1	0	0	1	0	0
16	46596858	.	T	C	1	0	1	0	1	2	0	0
16	46596877	.	T	A	1	1	2	0	0	2	0	0
16	46598163	.	A	G	1	2	3	0	0	3	0	0
16	46669372	.	C	T	10	8	18	0	0	18	0	0
16	46672203	.	C	T	19	14	33	0	1	34	0	0
16	46673322	.	A	G	1	4	5	0	0	5	0	0
16	46675583	.	A	G	21	0	21	0	30	51	0	0
16	46679879	.	C	G	6	0	6	0	19	26	1	0
16	46680792	.	G	A	6	9	15	0	0	15	0	0
16	46680793	.	A	T	5	9	14	0	1	15	0	0
16	46681041	.	G	A	9	6	15	0	1	16	0	0
16	46681057	.	G	A	8	7	15	0	0	15	0	0
16	46686003	.	C	T	2	0	2	0	0	2	0	0
16	46690948	.	G	A	0	6	6	0	6	12	0	0
16	46691033	.	G	C	10	9	19	0	0	19	0	0
16	46691090	.	C	T	8	6	14	0	1	15	0	0
16	46691095	.	A	T	9	5	14	0	1	15	0	0
16	46760985	.	G	A	1	2	3	0	0	3	0	0
16	46996847	.	T	C	1	2	3	0	0	3	0	0
16	47166477	.	G	A	0	1	1	0	0	1	0	0
16	47172327	.	G	A	1	4	5	0	0	5	0	0
16	47212178	.	C	T	0	1	1	0	0	1	0	0
16	47212235	.	T	C	3	9	12	0	0	12	0	0
16	47212262	.	T	C	2	7	9	0	0	9	0	0
16	47213103	.	T	G	3	10	13	0	0	13	0	0
16	47213952	.	T	C	6	5	11	0	0	11	0	0
16	47220058	.	A	G	3	2	5	0	1	6	0	0
16	47220091	.	C	T	5	2	7	0	0	7	0	0
16	47228788	.	A	G	7	0	7	0	4	11	0	0
16	47390849	.	A	C	28	2	30	0	14	44	0	0
16	47390924	.	G	A	30	25	55	0	0	55	0	0
16	47407678	.	G	A	9	5	14	0	1	15	0	0
16	47412094	.	T	C	7	12	19	0	0	19	0	0
16	47414715	.	G	C	6	0	6	0	4	10	0	0
16	47446694	.	A	G	2	3	5	0	0	5	0	0
16	47449824	.	C	T	1	2	3	0	0	3	0	0
16	47449922	.	G	A	2	6	8	0	1	9	0	0
16	47449938	.	A	G	5	5	10	0	0	10	0	0
16	47449968	.	C	T	3	1	4	0	1	5	0	0
16	47449978	.	T	C	4	2	6	0	0	6	0	0
16	48310177	.	G	T	2	5	7	0	0	7	0	0
16	48400548	.	A	G	4	3	7	0	0	7	0	0
16	48409352	.	T	A	8	8	16	0	1	17	0	0
16	48413440	.	C	A	1	1	2	0	0	2	0	0
16	48413512	.	T	C	3	2	5	0	0	5	0	0
16	48413518	.	A	G	2	0	2	0	0	2	0	0
16	48415976	.	A	G	21	11	32	0	2	34	0	0
16	48416125	.	A	G	2	1	3	0	0	3	0	0
16	48420833	.	T	C	13	7	20	0	1	21	0	0
16	48420875	.	T	G	4	1	5	0	0	5	0	0
16	48421111	.	C	A	15	14	29	0	2	31	0	0
16	48421120	.	G	A	15	14	29	0	3	32	0	0
16	48423129	.	G	A	1	0	1	0	0	1	0	0
16	48425249	.	T	C	4	1	5	0	0	5	0	0
16	48425361	.	C	T	3	4	7	0	1	8	0	0
16	48425409	.	A	G	5	16	21	0	2	23	0	0
16	48427232	.	G	C	0	2	2	0	0	2	0	0
16	48428029	.	T	G	4	2	6	0	0	6	0	0
16	48572669	.	T	G	1	0	1	0	6	7	0	0
16	48631134	.	A	G	2	0	2	0	1	3	0	0
16	48640819	.	G	A	0	2	2	0	3	5	0	0
16	48647980	.	G	A	0	2	2	0	0	2	0	0
16	48702313	.	T	A	1	1	2	0	0	2	0	0
16	48718921	.	C	A	2	3	5	0	0	5	0	0
16	48724702	.	A	G	4	0	4	0	1	5	0	0
16	48734083	.	C	T	1	0	1	0	0	1	0	0
16	48734182	.	C	A	1	0	1	0	0	1	0	0
16	48734183	.	A	C	1	0	1	0	0	1	0	0
16	48736054	.	A	T	2	3	5	0	0	5	0	0
16	48736081	.	A	T	1	5	6	0	0	6	0	0
16	48736173	.	A	G	1	0	1	0	5	6	0	0
16	48736197	.	G	T	0	3	3	0	4	7	0	0
16	48738688	.	C	G	1	3	4	0	0	4	0	0
16	48740686	.	C	T	9	6	15	0	0	15	0	0
16	48740787	.	A	G	10	4	14	0	0	14	0	0
16	48740799	.	C	T	7	5	12	0	0	12	0	0
16	48740833	.	C	T	8	6	14	0	0	14	0	0
16	48740886	.	A	G	9	0	9	0	4	13	0	0
16	48746356	.	T	C	2	8	10	0	0	10	0	0
16	48746364	.	A	G	2	8	10	0	0	10	0	0
16	48746661	.	A	G	5	8	13	0	0	13	0	0
16	48746695	.	T	G	3	15	18	0	0	18	0	0
16	48746731	.	G	A	2	12	14	0	0	14	0	0
16	48746744	.	T	C	3	8	11	0	1	12	0	0
16	48746783	.	A	T	5	6	11	0	0	11	0	0
16	49092586	.	T	C	1	2	3	0	0	3	0	0
16	49092814	.	G	A	0	4	4	0	2	6	0	0
16	49093177	.	A	G	2	2	4	0	1	5	0	0
16	49093519	.	T	C	2	2	4	0	0	4	0	0
16	49093802	.	T	C	2	2	4	0	0	4	0	0
16	49094428	.	A	C	6	2	8	0	0	8	0	0
16	49094545	.	T	C	4	2	6	0	0	6	0	0
16	49101761	.	A	C	3	6	9	0	0	9	0	0
16	49101764	.	T	C	3	7	10	0	0	10	0	0
16	49101833	.	G	A	0	5	5	0	2	7	0	0
16	49152252	.	A	G	0	0	0	1	0	1	0	0
16	49601851	.	C	A	8	10	18	0	0	18	0	0
16	49602096	.	A	T	0	2	2	0	1	3	0	0
16	49602143	.	C	G	3	0	3	0	3	6	0	0
16	49604533	.	T	C	1	0	1	0	0	1	0	0
16	49604710	.	A	G	3	0	3	0	3	6	0	0
16	49618212	.	T	C	1	1	2	0	0	2	0	0
16	50075551	.	C	T	27	19	46	0	1	47	0	0
16	50075605	.	T	A	20	10	30	0	3	33	0	0
16	50075929	.	A	C	16	9	25	0	3	29	1	0
16	50076029	.	C	T	10	20	30	0	1	31	0	0
16	50089599	.	T	A	15	6	21	0	0	21	0	0
16	50100455	.	C	T	4	5	9	0	1	10	0	0
16	50101946	.	A	G	7	4	11	0	0	11	0	0
16	50103878	.	G	A	0	9	9	0	13	22	0	0
16	50106063	.	C	T	5	1	6	0	0	6	0	0
16	50106645	.	A	G	15	9	24	0	0	24	0	0
16	50108878	.	C	G	9	6	15	0	1	16	0	0
16	50108888	.	C	T	9	4	13	0	0	13	0	0
16	50109017	.	C	T	10	6	16	0	1	17	0	0
16	50109386	.	T	A	12	12	24	0	1	25	0	0
16	50109434	.	G	A	11	9	20	0	1	21	0	0
16	50109595	.	T	C	18	10	28	0	2	30	0	0
16	50109701	.	T	A	20	6	26	0	2	28	0	0
16	50109795	.	T	C	20	12	32	0	2	34	0	0
16	50110125	.	G	A	1	11	12	0	26	38	0	0
16	50110277	.	C	T	29	15	44	0	3	49	2	0
16	50110671	.	A	G	27	14	41	0	1	42	0	0
16	50110899	.	T	C	20	11	31	0	1	32	0	0
16	50214904	.	G	T	4	8	12	0	1	13	0	0
16	50215016	.	T	C	14	8	22	0	1	23	0	0
16	50215017	.	G	C	14	9	23	0	0	23	0	0
16	50215058	.	C	T	16	18	34	0	0	34	0	0
16	50215068	.	T	C	13	17	30	0	2	32	0	0
16	50215112	.	C	T	8	16	24	0	1	25	0	0
16	50215171	.	G	A	18	16	34	0	0	34	0	0
16	50215222	.	A	C	19	24	43	0	1	44	0	0
16	50215734	.	T	C	15	21	36	0	0	36	0	0
16	50218386	.	T	C	2	0	2	0	5	7	0	0
16	50218401	.	A	G	6	8	14	0	1	15	0	0
16	50218470	.	T	A	16	11	27	0	0	27	0	0
16	50229213	.	T	G	2	3	5	0	0	5	0	0
16	50824069	.	C	A	10	6	16	0	1	17	0	0
16	50824090	.	C	T	12	5	17	0	1	18	0	0
16	50824469	.	A	C	2	2	4	0	0	4	0	0
16	51183892	.	A	T	10	4	14	0	1	15	0	0
16	51244464	.	T	C	3	2	5	0	0	5	0	0
16	51244487	.	T	C	1	2	3	0	1	4	0	0
16	53708537	.	G	T	4	2	6	0	1	7	0	0
16	53799876	.	A	G	3	2	5	0	0	5	0	0
16	54474942	.	G	A	8	7	15	0	0	15	0	0
16	54474943	.	C	T	8	7	15	0	0	15	0	0
16	54475037	.	G	A	9	8	17	0	1	18	0	0
16	54475064	.	G	A	6	8	14	0	2	16	0	0
16	54478053	.	A	G	0	2	2	0	0	2	0	0
16	54491760	.	G	A	1	0	1	0	0	1	0	0
16	54498040	.	A	T	1	0	1	0	0	1	0	0
16	54498049	.	G	A	0	2	2	0	0	2	0	0
16	54568542	.	G	T	1	2	3	0	0	3	0	0
16	54568755	.	C	A	8	5	13	0	0	13	0	0
16	54574177	.	T	C	2	3	5	0	0	5	0	0
16	54580891	.	G	A	6	5	11	0	1	12	0	0
16	54580930	.	G	A	9	5	14	0	0	14	0	0
16	54582681	.	G	A	1	4	5	0	0	5	0	0
16	54585298	.	T	A	6	7	13	0	0	13	0	0
16	54585729	.	G	C	0	2	2	0	2	4	0	0
16	54585799	.	C	T	7	5	12	0	0	12	0	0
16	54588989	.	G	A	14	12	26	0	0	26	0	0
16	54590177	.	C	T	2	3	5	0	0	5	0	0
16	54590186	.	G	A	0	2	2	0	3	5	0	0
16	54590219	.	A	G	2	0	2	0	2	4	0	0
16	54590594	.	C	T	7	6	13	0	1	14	0	0
16	54594047	.	A	C	1	11	12	0	7	19	0	0
16	54594103	.	T	C	26	13	39	0	2	41	0	0
16	54594242	.	C	A	3	9	12	0	2	14	0	0
16	54594270	.	A	T	8	20	28	0	2	30	0	0
16	54594413	.	C	T	17	20	37	0	2	39	0	0
16	54594421	.	A	G	15	20	35	0	3	38	0	0
16	54636225	.	C	G	0	1	1	0	0	1	0	0
16	54636692	.	G	A	5	2	7	0	1	8	0	0
16	54639451	.	G	A	1	2	3	0	0	3	0	0
16	54780612	.	G	A	6	19	25	0	0	25	0	0
16	54782373	.	T	C	2	3	5	0	0	5	0	0
16	54782542	.	G	A	0	10	10	0	5	15	0	0
16	54785573	.	C	G	29	20	49	0	4	53	0	0
16	54785894	.	A	G	4	10	14	0	1	15	0	0
16	54786967	.	C	T	10	9	19	0	2	21	0	0
16	54787564	.	T	G	4	4	8	0	2	10	0	0
16	54787578	.	G	A	8	4	12	0	0	12	0	0
16	54787725	.	C	T	1	9	10	0	8	18	0	0
16	54793964	.	C	A	5	5	10	0	2	12	0	0
16	54794100	.	G	A	16	12	28	0	1	29	0	0
16	54800128	.	A	T	4	3	7	0	0	7	0	0
16	54805136	.	A	C	3	0	3	0	3	6	0	0
16	54805173	.	G	A	3	2	5	0	0	5	0	0
16	54805306	.	C	T	2	3	5	0	0	5	0	0
16	54806967	.	C	A	0	1	1	0	0	1	0	0
16	54807481	.	T	G	0	2	2	0	0	2	0	0
16	54809840	.	G	T	2	1	3	1	1	5	0	0
16	54810155	.	G	A	4	2	6	0	0	6	0	0
16	54931047	.	C	A	6	2	8	0	1	9	0	0
16	54960951	.	A	C	1	5	6	0	0	6	0	0
16	54964128	.	G	T	2	2	4	0	0	4	0	0
16	54964146	.	A	G	3	3	6	0	0	6	0	0
16	54964281	.	G	C	1	1	2	0	0	2	0	0
16	54964287	.	G	A	1	1	2	0	0	2	0	0
16	55004723	.	C	G	26	13	39	0	2	41	0	0
16	55007670	.	G	A	18	17	35	0	1	36	0	0
16	55012538	.	G	T	0	4	4	0	0	4	0	0
16	55012643	.	G	A	1	4	5	0	0	5	0	0
16	55090845	.	C	T	3	2	5	0	0	5	0	0
16	55090853	.	G	T	2	3	5	0	0	5	0	0
16	55102387	.	C	T	3	6	9	0	0	9	0	0
16	55102422	.	C	G	7	0	7	0	4	11	0	0
16	55102467	.	G	A	5	1	6	0	1	7	0	0
16	55102781	.	C	G	1	2	3	0	0	3	0	0
16	55106058	.	T	A	1	5	6	0	0	6	0	0
16	55106207	.	T	C	3	13	16	0	0	16	0	0
16	55106223	.	A	G	7	14	21	0	0	21	0	0
16	55106279	.	C	A	23	19	42	0	0	42	0	0
16	55106367	.	A	C	3	15	18	0	1	19	0	0
16	55106405	.	G	A	8	5	13	0	0	13	0	0
16	55106443	.	C	T	9	9	18	0	0	18	0	0
16	55122779	.	T	C	16	10	26	0	0	26	0	0
16	55181337	.	A	T	4	4	8	0	1	9	0	0
16	55181458	.	C	A	3	3	6	0	0	6	0	0
16	55181459	.	C	G	3	3	6	0	0	6	0	0
16	55181565	.	G	A	0	3	3	0	1	4	0	0
17	70665	.	A	G	5	2	7	0	0	7	0	0
17	70668	.	A	G	2	0	2	0	5	7	0	0
17	1068814	.	C	T	11	12	23	0	0	23	0	0
17	1122530	.	T	G	0	1	1	0	0	1	0	0
17	1144445	.	T	A	1	1	2	0	1	3	0	0
17	1174929	.	G	C	3	2	5	0	0	5	0	0
17	1354340	.	T	C	1	4	5	0	0	5	0	0
17	1354412	.	A	G	1	1	2	0	1	3	0	0
17	1354902	.	T	A	1	4	5	0	0	5	0	0
17	1354906	.	T	G	1	0	1	0	3	5	1	0
17	1355015	.	G	A	0	2	2	0	7	9	0	0
17	1355621	.	T	A	0	4	4	0	0	4	0	0
17	1355645	.	C	T	0	2	2	0	0	2	0	0
17	1355673	.	T	C	1	1	2	0	0	2	0	0
17	1360206	.	T	G	3	0	3	0	2	5	0	0
17	1360271	.	C	G	2	2	4	0	0	4	0	0
17	1362172	.	C	T	2	1	3	0	0	3	0	0
17	1362244	.	C	T	3	3	6	0	0	6	0	0
17	1585515	.	T	C	1	2	3	0	0	3	0	0
17	1591245	.	A	G	3	2	5	0	0	5	0	0
17	1591329	.	G	A	0	2	2	0	0	2	0	0
17	1591330	.	A	G	0	2	2	0	0	2	0	0
17	1602351	.	T	A	0	1	1	0	0	2	1	0
17	1603491	.	A	G	0	0	0	0	3	3	0	0
17	1605470	.	G	A	1	0	1	0	0	1	0	0
17	2063925	.	A	G	27	23	50	0	0	50	0	0
17	2091858	.	G	A	0	1	1	0	6	7	0	0
17	2095454	.	T	C	6	18	24	0	2	26	0	0
17	2095525	.	A	G	16	0	16	0	44	60	0	0
17	2109014	.	C	T	0	13	13	0	4	17	0	0
17	2110588	.	G	A	20	10	30	0	0	30	0	0
17	2110642	.	C	G	14	11	25	0	1	26	0	0
17	2110657	.	T	C	14	2	16	0	16	32	0	0
17	2115464	.	A	T	2	3	5	0	0	5	0	0
17	2122175	.	A	G	4	5	9	0	0	9	0	0
17	2122196	.	G	A	10	7	17	0	2	19	0	0
17	2231450	.	C	T	1	2	3	0	0	3	0	0
17	2231779	.	C	A	2	2	4	0	0	4	0	0
17	2236075	.	T	C	3	4	7	0	0	7	0	0
17	2354798	.	A	G	0	3	3	0	0	3	0	0
17	2373246	.	G	A	0	2	2	0	1	3	0	0
17	2479601	.	G	C	5	6	11	0	0	11	0	0
17	2498572	.	C	T	4	4	8	0	0	8	0	0
17	2498573	.	C	G	4	4	8	0	0	8	0	0
17	2694963	.	A	C	1	2	3	0	1	4	0	0
17	2694969	.	A	T	1	2	3	0	1	4	0	0
17	2696241	.	T	C	4	3	7	0	0	7	0	0
17	2696756	.	C	G	0	2	2	0	0	2	0	0
17	2696777	.	T	G	0	2	2	0	0	2	0	0
17	2697203	.	C	T	0	1	1	0	3	4	0	0
17	2697973	.	A	T	3	2	5	0	0	5	0	0
17	2711297	.	T	C	2	1	3	0	1	4	0	0
17	2715157	.	A	G	2	2	4	0	0	4	0	0
17	3183532	.	G	A	1	2	3	0	0	3	0	0
17	3446847	.	T	C	10	5	15	0	1	16	0	0
17	3530031	.	C	T	9	4	13	0	0	13	0	0
17	3556184	.	C	A	3	1	4	0	1	5	0	0
17	3569298	.	A	G	3	4	7	0	0	7	0	0
17	3850524	.	G	A	0	1	1	0	0	1	0	0
17	3854287	.	C	T	0	6	6	0	7	13	0	0
17	3854347	.	C	G	5	3	8	0	0	8	0	0
17	3855403	.	G	A	5	7	12	0	1	13	0	0
17	3855436	.	T	C	4	0	4	0	9	13	0	0
17	3866424	.	A	T	0	1	1	0	0	1	0	0
17	3870739	.	T	A	3	1	4	0	0	4	0	0
17	3878982	.	T	C	2	0	2	0	2	4	0	0
17	4715225	.	C	T	1	2	3	0	0	3	0	0
17	5079084	.	T	C	5	23	28	0	0	28	0	0
17	5079706	.	C	T	4	1	5	0	0	5	0	0
17	5081406	.	A	C	6	13	19	0	0	19	0	0
17	5084892	.	G	A	11	14	25	0	0	25	0	0
17	5087222	.	G	A	9	7	16	0	1	17	0	0
17	5090871	.	T	C	16	9	25	0	0	25	0	0
17	5091108	.	T	C	1	7	8	0	0	8	0	0
17	5094330	.	T	A	14	4	18	0	1	19	0	0
17	5094355	.	T	C	26	8	34	0	0	34	0	0
17	5094519	.	C	T	6	2	8	0	1	9	0	0
17	5096691	.	T	C	26	11	37	0	1	38	0	0
17	5105702	.	T	A	21	7	28	0	1	29	0	0
17	5162027	.	A	G	1	2	3	0	0	3	0	0
17	5162080	.	T	A	3	5	8	0	0	8	0	0
17	5215192	.	T	A	2	4	6	0	0	6	0	0
17	5296519	.	A	G	2	1	3	0	0	3	0	0
17	5296534	.	T	A	1	1	2	0	1	3	0	0
17	5599404	.	A	G	1	2	3	0	0	3	0	0
17	5599449	.	A	C	2	2	4	0	0	4	0	0
17	5599461	.	C	T	1	2	3	0	0	3	0	0
17	5756664	.	T	C	2	1	3	0	5	8	0	0
17	5766286	.	A	C	2	3	5	0	0	5	0	0
17	5768681	.	A	T	0	3	3	0	0	3	0	0
17	5768712	.	A	G	1	5	6	0	0	6	0	0
17	5768722	.	C	T	1	3	4	0	0	4	0	0
17	5768776	.	A	C	1	5	6	0	0	6	0	0
17	5768792	.	C	T	1	3	4	0	2	6	0	0
17	5817633	.	A	T	2	3	5	0	0	5	0	0
17	5819615	.	A	T	2	3	5	0	0	5	0	0
17	5819634	.	A	C	3	2	5	0	0	5	0	0
17	5819661	.	C	A	4	2	6	0	0	6	0	0
17	5819672	.	A	T	3	2	5	0	0	5	0	0
17	5819951	.	C	T	1	3	4	0	0	4	0	0
17	5819969	.	C	T	1	2	3	0	0	3	0	0
17	5820083	.	C	T	1	5	6	0	2	8	0	0
17	5820572	.	A	G	1	6	7	0	1	8	0	0
17	5821134	.	A	G	5	3	8	0	0	8	0	0
17	5895704	.	G	C	1	3	4	0	0	4	0	0
17	5895821	.	A	G	5	5	10	0	0	10	0	0
17	5895865	.	G	A	0	9	9	0	6	15	0	0
17	5896210	.	G	T	8	9	17	0	1	18	0	0
17	5916287	.	T	C	9	20	29	0	1	30	0	0
17	5926729	.	A	G	21	16	37	0	0	37	0	0
17	6016351	.	C	T	0	2	2	0	3	5	0	0
17	6808341	.	A	G	9	4	13	0	0	13	0	0
17	6808796	.	A	G	8	20	28	0	4	32	0	0
17	7781599	.	G	A	2	4	6	0	0	6	0	0
17	7781648	.	A	C	2	2	4	0	0	4	0	0
17	7795593	.	G	A	1	1	2	0	0	2	0	0
17	7799980	.	A	G	0	1	1	0	1	2	0	0
17	7812480	.	A	T	0	1	1	0	0	1	0	0
17	7815212	.	C	T	7	4	11	0	0	11	0	0
17	7818872	.	T	A	0	1	1	0	1	2	0	0
17	7818935	.	C	T	2	2	4	0	0	4	0	0
17	7845085	.	T	A	11	11	22	0	1	23	0	0
17	7845288	.	A	G	3	5	8	0	0	8	0	0
17	7845364	.	G	C	22	7	29	0	1	30	0	0
17	7845412	.	T	C	12	17	29	0	2	31	0	0
17	7845566	.	C	T	18	18	36	0	3	39	0	0
17	7845604	.	G	A	17	25	42	0	0	42	0	0
17	7845661	.	G	T	18	23	41	0	2	43	0	0
17	7845733	.	G	A	20	17	37	0	5	42	0	0
17	7845776	.	C	G	1	18	19	0	12	31	0	0
17	7845800	.	A	G	9	11	20	0	0	20	0	0
17	7861124	.	C	T	26	14	40	0	1	41	0	0
17	7868632	.	G	A	1	1	2	0	1	3	0	0
17	7879327	.	C	G	3	1	4	0	0	4	0	0
17	7882941	.	G	A	14	11	25	0	0	25	0	0
17	7882998	.	G	A	7	17	24	0	2	26	0	0
17	7883016	.	C	T	13	5	18	0	2	20	0	0
17	7885635	.	G	A	1	9	10	0	0	10	0	0
17	7885662	.	A	G	5	11	16	0	1	17	0	0
17	7888351	.	G	A	6	2	8	0	0	8	0	0
17	7888369	.	G	A	12	5	17	0	0	17	0	0
17	7896340	.	G	A	7	4	11	0	0	11	0	0
17	7896356	.	C	T	0	9	9	0	8	17	0	0
17	7902203	.	A	G	1	4	5	0	0	5	0	0
17	7906612	.	G	A	3	6	9	0	0	9	0	0
17	7910537	.	C	T	10	7	17	0	1	18	0	0
17	7917414	.	T	A	8	5	13	0	1	14	0	0
17	7917997	.	G	A	0	3	3	0	0	3	0	0
17	7918075	.	C	T	2	3	5	0	0	5	0	0
17	7918244	.	C	T	0	4	4	0	10	14	0	0
17	7918310	.	C	T	0	4	4	0	5	9	0	0
17	7924263	.	G	A	0	2	2	0	1	3	0	0
17	7928615	.	T	G	4	4	8	0	0	8	0	0
17	7929597	.	T	C	2	3	5	0	0	5	0	0
17	7931737	.	G	A	2	0	2	0	0	2	0	0
17	7942122	.	G	A	4	2	6	0	0	6	0	0
17	7942127	.	T	C	4	2	6	0	0	6	0	0
17	7942191	.	T	G	0	3	3	0	0	3	0	0
17	7942375	.	C	T	2	2	4	0	0	4	0	0
17	7945421	.	C	G	5	2	7	0	0	7	0	0
17	7945485	.	A	G	1	0	1	0	0	1	0	0
17	7949066	.	G	A	6	3	9	0	1	10	0	0
17	7949119	.	G	T	3	5	8	0	0	8	0	0
17	7950339	.	G	T	2	3	5	0	0	5	0	0
17	7974804	.	T	C	3	5	8	0	0	8	0	0
17	7977746	.	A	T	3	5	8	0	0	8	0	0
17	7981566	.	C	T	1	3	4	0	0	4	0	0
17	7985970	.	C	T	0	3	3	0	2	5	0	0
17	8002895	.	G	T	1	1	2	0	0	2	0	0
17	8003165	.	G	T	0	1	1	0	0	1	0	0
17	8006088	.	C	T	0	2	2	0	0	2	0	0
17	8006696	.	T	C	1	2	3	0	0	3	0	0
17	8029730	.	T	C	1	0	1	0	2	3	0	0
17	8184435	.	A	G	1	0	1	0	3	4	0	0
17	8184515	.	A	T	3	3	6	0	0	6	0	0
17	8188963	.	G	T	0	1	1	0	4	5	0	0
17	8191370	.	C	A	1	2	3	0	0	3	0	0
17	8191382	.	C	A	1	2	3	0	0	3	0	0
17	8191475	.	A	G	3	0	3	0	0	3	0	0
17	8194715	.	C	A	0	4	4	0	0	4	0	0
17	8197141	.	G	A	2	2	4	0	0	4	0	0
17	8197569	.	C	A	3	0	3	0	0	3	0	0
17	8199812	.	C	T	2	2	4	0	0	4	0	0
17	8202778	.	T	C	7	12	19	0	0	19	0	0
17	8203231	.	T	A	17	11	28	0	2	30	0	0
17	8203234	.	G	A	17	13	30	0	1	31	0	0
17	8203471	.	C	T	9	10	19	0	0	19	0	0
17	8203498	.	G	A	12	5	17	0	3	20	0	0
17	8203729	.	T	C	16	9	25	0	0	25	0	0
17	8204086	.	G	C	10	5	15	0	1	16	0	0
17	8204248	.	A	G	9	0	9	0	7	16	0	0
17	8204533	.	C	T	11	11	22	0	4	26	0	0
17	8204755	.	A	G	17	14	31	0	4	35	0	0
17	8204818	.	A	G	23	13	36	0	2	38	0	0
17	8204962	.	C	T	14	9	23	0	0	23	0	0
17	8205508	.	T	C	21	18	39	0	0	39	0	0
17	8209686	.	A	G	12	12	24	1	1	26	0	0
17	8209931	.	C	A	15	11	26	0	1	27	0	0
17	8210327	.	A	T	20	14	34	0	1	35	0	0
17	8210355	.	T	A	16	7	23	0	1	24	0	0
17	8210365	.	C	T	17	7	24	0	0	24	0	0
17	8210415	.	C	A	10	14	24	0	1	25	0	0
17	8210466	.	A	G	13	0	13	0	12	25	0	0
17	8210552	.	A	G	11	9	20	0	1	21	0	0
17	8210596	.	A	C	14	12	26	0	3	29	0	0
17	8210801	.	C	T	22	18	40	0	1	41	0	0
17	8229904	.	C	T	1	3	4	0	0	4	0	0
17	8229906	.	G	A	1	2	3	0	1	4	0	0
17	8229982	.	C	A	4	2	6	0	0	6	0	0
17	8234886	.	C	G	3	0	3	0	0	3	0	0
17	8234889	.	C	T	0	0	0	0	3	3	0	0
17	8245868	.	G	A	6	4	10	0	0	10	0	0
17	8248987	.	A	G	1	1	2	0	0	2	0	0
17	8249153	.	A	T	0	4	4	0	1	5	0	0
17	8253479	.	G	T	1	3	4	0	0	4	0	0
17	8254979	.	C	T	0	3	3	0	2	5	0	0
17	8261535	.	T	C	1	3	4	0	0	4	0	0
17	8261685	.	A	T	4	3	7	0	0	7	0	0
17	8265406	.	G	A	2	2	4	0	0	4	0	0
17	8451412	.	C	T	0	1	1	0	0	1	0	0
17	8499025	.	C	T	0	1	1	0	3	4	0	0
17	8502883	.	G	A	5	5	10	0	1	11	0	0
17	8502931	.	G	A	3	2	5	0	0	5	0	0
17	8502949	.	G	C	2	0	2	0	3	5	0	0
17	8502982	.	G	A	2	2	4	0	1	5	0	0
17	8505413	.	G	A	3	2	5	0	0	5	0	0
17	8597078	.	C	A	0	13	13	0	17	30	0	0
17	8597174	.	T	A	15	14	29	0	2	31	0	0
17	8597515	.	A	T	21	15	36	1	1	38	0	0
17	8597702	.	A	T	21	17	38	0	1	39	0	0
17	8597871	.	T	C	26	9	35	0	0	35	0	0
17	8598070	.	C	T	1	21	22	0	21	43	0	0
17	8598168	.	G	A	19	23	42	0	1	43	0	0
17	8598345	.	T	A	9	14	23	0	1	24	0	0
17	8623396	.	G	A	6	12	18	0	1	19	0	0
17	8623480	.	C	T	1	20	21	0	23	44	0	0
17	8623540	.	C	T	0	9	9	0	17	26	0	0
17	8630043	.	C	A	6	15	21	0	1	22	0	0
17	8692757	.	C	G	0	1	1	0	1	2	0	0
17	8754388	.	C	T	1	2	3	0	0	3	0	0
17	8764027	.	A	G	1	0	1	0	2	3	0	0
17	8766176	.	G	A	2	2	4	0	0	4	0	0
17	8766185	.	G	A	2	2	4	0	1	5	0	0
17	8772776	.	C	T	1	2	3	0	0	3	0	0
17	8780716	.	G	A	2	3	5	0	0	5	0	0
17	8780728	.	C	T	2	2	4	0	1	5	0	0
17	8782396	.	C	T	3	3	6	0	0	6	0	0
17	8782484	.	C	T	2	2	4	0	0	4	0	0
17	8784742	.	G	A	0	3	3	0	4	7	0	0
17	8789449	.	G	A	0	0	0	0	0	0	0	0
17	8791613	.	T	A	7	4	11	0	0	11	0	0
17	8791618	.	C	G	4	6	10	0	1	11	0	0
17	8791917	.	T	C	3	3	6	0	1	7	0	0
17	8927638	.	A	G	2	4	6	0	0	6	0	0
17	8927641	.	A	G	2	4	6	0	0	6	0	0
17	8930017	.	C	T	7	3	10	0	0	10	0	0
17	8934235	.	C	T	15	11	26	0	0	26	0	0
17	8938011	.	G	A	2	2	4	0	2	6	0	0
17	8938249	.	T	C	8	9	17	0	1	18	0	0
17	8938269	.	G	A	15	11	26	0	3	29	0	0
17	8941206	.	G	A	3	7	10	0	0	10	0	0
17	8941264	.	T	C	6	14	20	0	0	20	0	0
17	8951516	.	C	A	4	2	6	0	0	6	0	0
17	8951606	.	C	G	0	11	11	0	11	22	0	0
17	8951867	.	C	T	0	3	3	0	5	8	0	0
17	8954377	.	G	A	13	11	24	0	2	26	0	0
17	8954482	.	C	T	8	10	18	0	1	19	0	0
17	8969278	.	A	G	2	4	6	0	0	6	0	0
17	8972806	.	T	C	7	0	7	0	12	19	0	0
17	8972821	.	G	A	9	6	15	0	0	15	0	0
17	8976273	.	A	G	11	11	22	0	0	22	0	0
17	9042447	.	C	T	2	3	5	0	0	5	0	0
17	9042652	.	T	C	1	6	7	0	0	7	0	0
17	9059105	.	A	G	1	0	1	0	0	1	0	0
17	9225184	.	G	A	0	4	4	0	5	9	0	0
17	9225223	.	A	G	2	3	5	0	0	5	0	0
17	9248656	.	A	G	1	0	1	0	3	4	0	0
17	9253705	.	T	C	3	4	7	0	0	7	0	0
17	9254269	.	T	A	4	7	11	0	0	11	0	0
17	9255196	.	G	A	0	5	5	0	4	9	0	0
17	9255547	.	G	C	7	15	22	0	0	22	0	0
17	9255703	.	C	T	10	15	25	0	0	25	0	0
17	9266298	.	C	T	19	11	30	0	0	30	0	0
17	9266501	.	G	T	0	17	17	0	11	28	0	0
17	9501630	.	A	G	4	1	5	0	0	5	0	0
17	9601121	.	G	C	1	1	2	0	0	2	0	0
17	9601133	.	C	T	1	1	2	0	0	2	0	0
17	9847215	.	C	T	3	2	5	0	0	5	0	0
17	9888958	.	C	G	8	4	12	0	0	12	0	0
17	9889223	.	C	T	11	9	20	0	1	21	0	0
17	9889427	.	G	A	9	11	20	0	1	21	0	0
17	9891389	.	G	A	4	2	6	0	1	7	0	0
17	9944725	.	A	G	2	3	5	0	0	5	0	0
17	9944733	.	A	G	2	5	7	0	0	7	0	0
17	9944848	.	T	A	6	4	10	0	1	11	0	0
17	9944874	.	C	T	10	4	14	0	0	14	0	0
17	9951885	.	G	A	5	8	13	0	0	13	0	0
17	9952033	.	C	T	0	9	9	0	10	19	0	0
17	9957881	.	C	T	2	3	5	0	0	5	0	0
17	9962505	.	A	G	0	3	3	0	0	3	0	0
17	9963519	.	G	A	6	3	9	0	0	9	0	0
17	9964019	.	G	A	5	3	8	0	1	9	0	0
17	9964032	.	T	A	6	3	9	0	0	9	0	0
17	9964091	.	C	A	3	3	6	0	0	6	0	0
17	9964125	.	T	A	3	3	6	0	0	6	0	0
17	9964177	.	C	A	5	2	7	0	0	7	0	0
17	9964334	.	T	A	0	2	2	0	2	4	0	0
17	9964437	.	A	T	6	2	8	0	1	9	0	0
17	9964663	.	C	A	2	4	6	0	0	6	0	0
17	9964954	.	T	A	5	1	6	0	3	9	0	0
17	9964999	.	C	A	6	0	6	0	0	6	0	0
17	9965010	.	C	A	3	3	6	0	0	6	0	0
17	9965263	.	T	C	7	0	7	0	3	10	0	0
17	9965344	.	T	A	2	2	4	0	0	4	0	0
17	9967595	.	A	G	1	1	2	0	0	2	0	0
17	9986655	.	G	A	0	3	3	0	0	3	0	0
17	10062617	.	G	T	2	0	2	0	1	3	0	0
17	10066561	.	C	T	3	2	5	0	0	5	0	0
17	10079554	.	G	A	4	1	5	0	0	5	0	0
17	10089583	.	G	T	6	5	11	8	3	22	0	0
17	10094185	.	C	T	1	3	4	0	0	4	0	0
17	10094189	.	C	T	1	3	4	0	0	4	0	0
17	10095554	.	A	G	1	1	2	0	0	2	0	0
17	10133901	.	G	A	2	2	4	0	0	4	0	0
17	10133902	.	C	T	2	2	4	0	0	4	0	0
17	10142416	.	G	C	4	9	13	0	0	13	0	0
17	10142474	.	T	G	9	2	11	0	0	11	0	0
17	10142481	.	A	G	10	0	10	0	0	10	0	0
17	10142574	.	T	G	1	2	3	0	0	3	0	0
17	10143801	.	A	G	7	1	8	0	5	13	0	0
17	10143808	.	A	G	2	9	11	0	0	11	0	0
17	10144027	.	A	C	6	7	13	0	0	13	0	0
17	10145004	.	G	T	12	21	33	0	2	35	0	0
17	10145281	.	C	T	12	13	25	0	2	27	0	0
17	10243794	.	C	A	3	4	7	0	1	8	0	0
17	10247875	.	C	A	4	3	7	0	0	7	0	0
17	10248157	.	A	G	9	6	15	0	0	15	0	0
17	10319562	.	C	A	1	3	4	0	1	5	0	0
17	10320093	.	T	C	1	2	3	0	0	3	0	0
17	10571044	.	C	T	2	2	4	0	0	4	0	0
17	10573186	.	A	G	1	3	4	0	0	4	0	0
17	10577538	.	C	A	1	3	4	0	0	4	0	0
17	10577539	.	A	T	1	3	4	0	0	4	0	0
17	10585056	.	G	A	1	4	5	0	0	5	0	0
17	10585083	.	G	A	0	3	3	0	5	8	0	0
17	10585101	.	G	A	5	2	7	0	0	7	0	0
17	10585140	.	C	T	6	5	11	0	0	11	0	0
17	10585363	.	A	T	6	4	10	0	0	10	0	0
17	10586161	.	A	T	5	7	12	0	0	12	0	0
17	10586449	.	A	G	5	9	14	0	0	14	0	0
17	10586664	.	A	C	14	9	23	0	0	23	0	0
17	10587020	.	G	T	7	5	12	0	0	12	0	0
17	10587330	.	A	C	2	6	8	0	0	8	0	0
17	10587601	.	A	G	3	15	18	0	0	18	0	0
17	10589608	.	A	T	1	2	3	0	0	3	0	0
17	10679990	.	T	C	1	0	1	0	0	1	0	0
17	10680447	.	A	G	0	2	2	0	0	2	0	0
17	10695904	.	G	A	2	4	6	0	0	6	0	0
17	10695922	.	A	G	3	3	6	0	0	6	0	0
17	10696006	.	C	T	1	0	1	0	0	1	0	0
17	10696498	.	A	T	1	1	2	0	0	2	0	0
17	10698537	.	A	C	5	3	8	0	0	8	0	0
17	10698681	.	G	T	6	4	10	0	1	11	0	0
17	10699076	.	G	T	0	3	3	0	4	7	0	0
17	10699077	.	A	C	4	2	6	0	1	7	0	0
17	10703478	.	A	G	0	3	3	0	0	3	0	0
17	10703731	.	C	T	4	1	5	0	0	5	0	0
17	10703764	.	C	A	5	4	9	0	1	10	0	0
17	10726617	.	C	T	1	5	6	0	0	6	0	0
17	10736503	.	G	A	5	1	6	0	0	6	0	0
17	10748708	.	G	C	0	3	3	0	9	12	0	0
17	10751051	.	T	C	2	0	2	0	0	2	0	0
17	10755512	.	A	G	5	10	15	0	1	16	0	0
17	10755656	.	T	C	3	4	7	0	0	7	0	0
17	10761763	.	T	C	2	2	4	0	0	4	0	0
17	10765286	.	C	T	3	4	7	0	0	7	0	0
17	10765328	.	A	G	8	0	8	0	9	17	0	0
17	10765683	.	T	A	3	3	6	0	0	6	0	0
17	10765720	.	A	G	3	4	7	0	0	7	0	0
17	10765722	.	T	C	2	5	7	0	0	7	0	0
17	10765773	.	A	G	3	2	5	0	1	6	0	0
17	10766074	.	G	C	12	10	22	0	0	22	0	0
17	10766142	.	T	A	12	8	20	0	2	22	0	0
17	10766181	.	A	G	8	4	12	0	0	12	0	0
17	10766205	.	G	T	6	5	11	0	0	11	0	0
17	10766219	.	A	T	4	5	9	0	0	9	0	0
17	10783885	.	A	G	5	13	18	0	2	20	0	0
17	10784149	.	C	T	1	17	18	0	15	33	0	0
17	10784151	.	T	C	15	17	32	0	1	33	0	0
17	10784210	.	A	C	9	1	10	0	16	26	0	0
17	10784441	.	A	G	24	11	35	0	0	35	0	0
17	10784618	.	G	A	6	8	14	0	0	14	0	0
17	10784646	.	C	G	5	11	16	0	1	17	0	0
17	10784948	.	A	T	13	9	22	0	1	23	0	0
17	10785020	.	A	G	8	6	14	0	3	17	0	0
17	10785206	.	A	G	6	12	18	0	0	18	0	0
17	10785289	.	T	C	9	6	15	0	0	15	0	0
17	10785552	.	A	G	6	6	12	0	1	13	0	0
17	10785616	.	T	A	5	3	8	0	1	9	0	0
17	10785619	.	C	T	5	3	8	0	1	9	0	0
17	10786085	.	C	A	3	3	6	0	0	6	0	0
17	10786149	.	T	A	3	3	6	0	1	7	0	0
17	10786520	.	T	C	2	3	5	0	1	6	0	0
17	10796797	.	T	C	3	2	5	0	2	7	0	0
17	10813718	.	G	A	0	0	0	0	1	1	0	0
17	10813783	.	A	T	5	4	9	0	0	9	0	0
17	10813817	.	G	T	6	6	12	0	0	12	0	0
17	10825196	.	C	T	3	3	6	0	0	6	0	0
17	11421722	.	A	G	2	2	4	0	0	4	0	0
17	11709187	.	G	A	2	4	6	0	0	6	0	0
17	11709199	.	C	T	2	4	6	0	0	6	0	0
17	11709394	.	A	T	0	2	2	0	1	3	0	0
17	11709632	.	G	A	4	3	7	0	0	7	0	0
17	11711365	.	C	T	1	2	3	0	0	3	0	0
17	11714598	.	T	A	9	6	15	0	1	16	0	0
17	11714635	.	G	C	5	13	18	0	1	19	0	0
17	11715808	.	G	T	0	4	4	0	4	8	0	0
17	11715917	.	G	C	4	12	16	0	0	16	0	0
17	11716040	.	C	A	3	0	3	0	6	9	0	0
17	11716068	.	T	C	9	5	14	0	0	14	0	0
17	11716113	.	T	G	5	12	17	0	1	18	0	0
17	11716397	.	T	C	1	3	4	0	0	4	0	0
17	11716418	.	A	C	1	2	3	0	1	4	0	0
17	11716487	.	T	C	0	1	1	0	0	1	0	0
17	11716509	.	G	T	0	3	3	0	0	3	0	0
17	11716702	.	A	G	2	5	7	0	1	8	0	0
17	11717109	.	C	T	15	13	28	0	1	29	0	0
17	11717131	.	C	T	6	14	20	0	7	27	0	0
17	11718038	.	A	C	21	9	30	0	2	32	0	0
17	11718118	.	A	G	14	10	24	0	1	25	0	0
17	11765805	.	G	A	2	1	3	0	1	4	0	0
17	12058522	.	G	T	0	5	5	0	3	8	0	0
17	12060478	.	G	A	0	2	2	0	1	3	0	0
17	12060545	.	C	T	5	3	8	0	0	8	0	0
17	12060587	.	A	G	6	4	10	0	0	10	0	0
17	12060627	.	C	T	5	8	13	0	0	13	0	0
17	12060631	.	G	A	1	5	6	0	7	13	0	0
17	12060799	.	A	G	3	3	6	0	1	7	0	0
17	12068675	.	G	C	8	6	14	0	0	14	0	0
17	12072890	.	C	T	12	6	18	0	0	18	0	0
17	12072977	.	T	C	9	12	21	0	1	22	0	0
17	12073037	.	C	T	4	6	10	0	2	12	0	0
17	12115457	.	C	A	0	1	1	0	0	1	0	0
17	12134673	.	T	G	1	3	4	0	0	4	0	0
17	12134709	.	C	T	3	3	6	0	1	7	0	0
17	12135206	.	G	A	1	4	5	0	0	5	0	0
17	12221666	.	T	C	3	5	8	0	0	8	0	0
17	12221788	.	C	A	1	4	5	0	5	10	0	0
17	12221891	.	G	A	4	8	12	0	0	12	0	0
17	12221903	.	C	T	0	7	7	0	5	12	0	0
17	12222005	.	T	G	2	6	8	0	1	9	0	0
17	12222226	.	A	G	7	4	11	0	0	11	0	0
17	12222235	.	G	T	6	3	9	0	0	9	0	0
17	12223514	.	G	A	0	1	1	0	0	1	0	0
17	12223743	.	G	A	7	4	11	0	0	11	0	0
17	12223883	.	C	G	3	2	5	0	0	5	0	0
17	12223884	.	T	A	3	1	4	0	1	5	0	0
17	12223971	.	G	A	4	6	10	0	0	10	0	0
17	12223989	.	C	A	0	4	4	0	3	8	1	0
17	12224581	.	T	C	7	0	7	0	5	12	0	0
17	12224976	.	G	A	8	6	14	0	0	14	0	0
17	12225070	.	G	A	4	16	20	0	1	21	0	0
17	12225271	.	G	A	5	3	8	0	0	8	0	0
17	12225292	.	C	T	0	3	3	0	5	8	0	0
17	12225418	.	T	G	5	3	8	0	0	8	0	0
17	12225756	.	C	A	2	3	5	0	0	5	0	0
17	12225843	.	T	G	1	1	2	0	0	2	0	0
17	12225867	.	C	T	0	1	1	0	0	1	0	0
17	12226404	.	C	T	2	2	4	0	0	4	0	0
17	12226594	.	G	A	0	1	1	0	0	1	0	0
17	12227034	.	C	T	0	5	5	0	2	7	0	0
17	12227730	.	G	C	3	0	3	0	2	5	0	0
17	12227748	.	T	C	3	2	5	0	1	6	0	0
17	12228304	.	C	T	2	2	4	0	0	4	0	0
17	12298106	.	G	T	27	35	62	0	9	71	0	0
17	12302409	.	G	A	30	27	57	0	4	61	0	0
17	12302496	.	C	T	0	2	2	0	0	2	0	0
17	12385303	.	T	C	2	0	2	0	3	5	0	0
17	12408447	.	C	T	12	7	19	0	1	20	0	0
17	12408454	.	G	C	6	15	21	0	0	21	0	0
17	12418130	.	C	A	2	2	4	0	0	4	0	0
17	12422810	.	A	G	9	0	9	0	7	16	0	0
17	12422850	.	T	A	8	10	18	0	0	18	0	0
17	12658472	.	G	A	1	2	3	0	0	3	0	0
17	12658893	.	T	C	2	0	2	0	0	2	0	0
17	12658895	.	A	T	2	0	2	0	0	2	0	0
17	12702780	.	C	T	7	17	24	0	0	24	0	0
17	12702801	.	A	G	4	0	4	0	13	17	0	0
17	12702831	.	C	A	3	5	8	0	1	9	0	0
17	12708393	.	A	G	6	8	14	0	0	14	0	0
17	12708404	.	C	A	6	5	11	0	2	13	0	0
17	12708903	.	T	C	17	30	47	0	3	50	0	0
17	12709244	.	T	G	9	10	19	0	2	21	0	0
17	12741500	.	T	C	4	4	8	0	0	8	0	0
17	12741518	.	C	T	4	4	8	0	0	8	0	0
17	12742971	.	A	G	3	0	3	0	1	4	0	0
17	12742974	.	C	T	2	0	2	0	0	2	0	0
17	12747827	.	C	T	2	4	6	0	0	6	0	0
17	12753717	.	A	C	2	3	5	0	0	5	0	0
17	12753792	.	G	A	11	10	21	0	1	22	0	0
17	12753823	.	A	G	14	15	29	0	1	30	0	0
17	12753916	.	T	A	10	13	23	0	1	24	0	0
17	12753940	.	A	T	10	13	23	0	0	23	0	0
17	12754071	.	A	G	12	13	25	0	0	25	0	0
17	12754158	.	A	T	7	3	10	0	2	12	0	0
17	12758823	.	T	C	5	3	8	0	0	8	0	0
17	12759072	.	G	A	1	2	3	0	0	3	0	0
17	12759135	.	C	T	1	3	4	0	0	4	0	0
17	12761221	.	G	C	2	2	4	0	0	4	0	0
17	12762852	.	T	C	2	3	5	0	0	5	0	0
17	12764004	.	C	T	0	8	8	0	14	22	0	0
17	12764090	.	G	T	7	5	12	0	0	12	0	0
17	12764244	.	A	T	7	4	11	0	0	11	0	0
17	12764247	.	G	T	7	3	10	0	1	11	0	0
17	12806381	.	T	C	1	0	1	0	0	1	0	0
17	12818664	.	A	G	6	3	9	0	0	9	0	0
17	12825732	.	C	T	1	0	1	0	0	1	0	0
17	12825741	.	G	A	0	1	1	0	2	3	0	0
17	12851473	.	T	G	0	1	1	0	0	1	0	0
17	12851518	.	G	A	0	8	8	0	3	11	0	0
17	12851831	.	T	G	5	2	7	0	0	7	0	0
17	12858173	.	C	T	7	10	17	0	2	19	0	0
17	12858658	.	G	C	5	9	14	0	1	16	1	0
17	12858765	.	A	G	8	9	17	0	0	17	0	0
17	12867975	.	G	A	2	6	8	0	0	8	0	0
17	12881532	.	G	A	0	2	2	0	0	2	0	0
17	12881590	.	G	A	0	14	14	0	6	20	0	0
17	12922410	.	A	T	16	14	30	0	3	33	0	0
17	12922678	.	A	G	6	6	12	0	1	13	0	0
17	12923028	.	A	G	20	14	34	0	0	34	0	0
17	12923131	.	A	G	13	1	14	0	21	35	0	0
17	12923303	.	A	G	14	0	14	0	13	27	0	0
17	12923509	.	A	T	12	5	17	0	0	17	0	0
17	12925020	.	G	A	1	2	3	0	1	4	0	0
17	12958744	.	G	A	1	3	4	0	0	4	0	0
17	12963487	.	A	C	3	1	4	0	8	12	0	0
17	12963571	.	G	A	5	10	15	0	0	15	0	0
17	12965499	.	A	G	4	1	5	0	0	5	0	0
17	12971471	.	G	A	1	0	1	0	0	1	0	0
17	12972969	.	A	G	2	3	5	0	0	5	0	0
17	12977682	.	T	C	1	0	1	0	1	2	0	0
17	13004885	.	T	C	0	0	0	0	2	2	0	0
17	13013109	.	T	C	0	0	0	0	1	1	0	0
17	13019988	.	T	A	15	16	31	0	2	33	0	0
17	13020090	.	G	A	9	14	23	0	0	23	0	0
17	13020187	.	A	C	11	7	18	0	0	18	0	0
17	13020472	.	T	C	14	13	27	0	0	27	0	0
17	13020476	.	T	A	12	14	26	0	1	28	1	0
17	13020601	.	C	T	0	12	12	1	6	19	0	0
17	13020733	.	C	G	9	12	21	0	0	21	0	0
17	13023289	.	T	C	4	2	6	0	0	6	0	0
17	13023407	.	A	C	6	5	11	0	1	12	0	0
17	13026599	.	A	T	4	3	7	0	0	7	0	0
17	13032557	.	A	G	4	0	4	0	5	9	0	0
17	13032558	.	A	G	4	5	9	0	0	9	0	0
17	13045540	.	G	T	3	11	14	0	1	15	0	0
17	13045559	.	A	C	5	6	11	0	0	11	0	0
17	13045794	.	T	A	6	8	14	0	1	15	0	0
17	13045882	.	A	T	8	4	12	0	0	12	0	0
17	13045980	.	T	C	4	3	7	0	0	7	0	0
17	13046058	.	T	G	7	6	13	0	0	13	0	0
17	13046099	.	G	A	7	8	15	0	1	16	0	0
17	13052081	.	C	T	0	3	3	0	1	4	0	0
17	13057986	.	T	A	7	1	8	0	1	9	0	0
17	13061839	.	T	C	5	0	5	0	1	6	0	0
17	13061849	.	C	G	4	2	6	0	1	7	0	0
17	13064531	.	C	T	4	3	7	0	0	7	0	0
17	13066963	.	T	A	1	2	3	0	0	3	0	0
17	13091660	.	T	G	1	2	3	0	0	3	0	0
17	13097239	.	C	T	3	4	7	0	0	7	0	0
17	13107061	.	A	G	5	1	6	0	8	14	0	0
17	13108626	.	G	T	15	19	34	0	1	35	0	0
17	13109010	.	A	G	17	17	34	0	0	34	0	0
17	13109042	.	T	C	12	11	23	0	0	23	0	0
17	13109097	.	A	T	13	8	21	0	0	21	0	0
17	13109409	.	C	T	19	14	33	0	2	35	0	0
17	13109793	.	A	C	15	11	26	0	1	27	0	0
17	13109818	.	T	C	13	11	24	0	1	25	0	0
17	13109910	.	A	G	15	0	15	0	14	29	0	0
17	13109928	.	G	T	1	16	17	0	18	35	0	0
17	13109990	.	T	A	14	18	32	0	3	35	0	0
17	13110003	.	C	G	12	18	30	0	2	32	0	0
17	13110043	.	C	T	12	11	23	0	1	24	0	0
17	13763835	.	C	T	3	4	7	0	0	7	0	0
17	13764198	.	C	T	2	5	7	0	0	7	0	0
17	13764513	.	A	C	6	3	9	0	0	9	0	0
17	13764624	.	T	C	7	3	10	0	0	10	0	0
17	14434592	.	C	A	0	1	1	0	0	1	0	0
17	14443633	.	T	A	8	8	16	0	0	16	0	0
17	14443651	.	T	C	9	0	9	0	8	17	0	0
17	14443697	.	G	A	11	3	14	0	0	14	0	0
17	14443820	.	T	G	3	7	10	0	1	11	0	0
17	14444166	.	A	G	9	11	20	0	2	22	0	0
17	14444167	.	G	A	10	11	21	0	1	22	0	0
17	14447282	.	A	G	1	0	1	0	0	1	0	0
17	14449386	.	C	T	0	1	1	0	3	4	0	0
17	14457911	.	C	A	4	5	9	0	0	9	0	0
17	14458364	.	T	C	5	6	11	0	0	11	0	0
17	14467471	.	G	A	6	3	9	0	1	10	0	0
17	14468247	.	C	T	0	14	14	0	10	24	0	0
17	14468263	.	T	G	10	11	21	0	1	22	0	0
17	14468370	.	A	T	10	13	23	0	4	27	0	0
17	14468386	.	T	A	9	18	27	0	1	28	0	0
17	14468433	.	G	A	21	14	35	0	2	37	0	0
17	14470340	.	A	G	1	1	2	0	0	2	0	0
17	14494395	.	A	G	8	8	16	0	0	16	0	0
17	14494429	.	A	G	9	6	15	0	2	17	0	0
17	14502454	.	T	A	2	6	8	0	0	8	0	0
17	14523518	.	G	T	6	4	10	0	0	10	0	0
17	14614452	.	T	C	13	11	24	0	3	27	0	0
17	14614471	.	A	G	10	11	21	0	1	22	0	0
17	14614509	.	C	A	14	10	24	0	2	26	0	0
17	14614863	.	C	A	9	12	21	0	1	22	0	0
17	14614900	.	G	A	10	9	19	0	1	20	0	0
17	14614973	.	C	G	10	9	19	0	0	19	0	0
17	14615089	.	T	C	12	7	19	0	1	20	0	0
17	14618038	.	C	G	6	3	9	0	0	9	0	0
17	14618051	.	G	A	7	3	10	0	0	10	0	0
17	14618842	.	C	T	0	1	1	0	0	1	0	0
17	14618857	.	C	T	1	2	3	0	1	4	0	0
17	14623391	.	A	T	0	4	4	0	0	4	0	0
17	14624088	.	G	T	1	1	2	0	0	2	0	0
17	14627407	.	A	G	0	2	2	0	0	2	0	0
17	14694711	.	C	A	21	21	42	0	2	44	0	0
17	14694744	.	A	G	20	16	36	0	1	37	0	0
17	14694802	.	C	G	15	17	32	0	1	33	0	0
17	14722223	.	A	G	6	8	14	0	1	15	0	0
17	14723137	.	C	T	20	18	38	0	0	38	0	0
17	14723208	.	T	C	21	14	35	0	0	35	0	0
17	14723302	.	A	G	12	20	32	0	3	35	0	0
17	14724005	.	C	A	8	9	17	0	0	17	0	0
17	14724057	.	T	C	11	6	17	0	0	17	0	0
17	14724489	.	T	C	5	5	10	0	0	10	0	0
17	14724514	.	T	C	4	1	5	0	5	10	0	0
17	14725246	.	A	C	8	0	8	0	7	15	0	0
17	14725561	.	C	T	0	6	6	0	7	13	0	0
17	14725648	.	C	T	10	3	13	0	1	14	0	0
17	14725831	.	T	A	3	5	8	0	0	8	0	0
17	14731522	.	G	T	8	5	13	0	0	13	0	0
17	14731560	.	T	C	6	5	11	0	1	12	0	0
17	14731819	.	T	C	5	1	6	0	0	6	0	0
17	14734632	.	C	T	6	5	11	0	2	13	0	0
17	14734734	.	G	A	8	4	12	0	2	14	0	0
17	14737070	.	G	A	3	2	5	0	0	5	0	0
17	14751227	.	T	A	1	2	3	0	0	3	0	0
17	14755852	.	G	A	0	1	1	0	0	1	0	0
17	14756129	.	A	G	4	1	5	0	0	5	0	0
17	14759311	.	T	A	2	0	2	0	1	3	0	0
17	14768652	.	T	A	3	6	9	0	0	9	0	0
17	14784323	.	T	C	5	8	13	0	1	14	0	0
17	14785663	.	C	T	3	8	11	0	0	11	0	0
17	14794285	.	A	G	2	6	8	0	1	9	0	0
17	14794485	.	G	T	10	22	32	0	2	34	0	0
17	14794639	.	A	T	5	5	10	0	0	10	0	0
17	14918683	.	T	A	1	1	2	0	0	2	0	0
17	14918688	.	A	G	1	2	3	0	0	3	0	0
17	14918757	.	G	A	1	2	3	0	0	3	0	0
17	14918836	.	T	A	1	2	3	0	0	3	0	0
17	14919126	.	T	G	2	2	4	0	1	5	0	0
17	14933285	.	T	A	0	1	1	0	0	1	0	0
17	14933455	.	A	G	0	2	2	0	0	2	0	0
17	14941594	.	A	G	1	2	3	0	0	3	0	0
17	14945613	.	T	C	0	2	2	0	0	2	0	0
17	14953761	.	G	A	1	1	2	0	0	2	0	0
17	14953953	.	T	C	0	4	4	0	0	4	0	0
17	14953989	.	C	G	0	3	3	0	0	3	0	0
17	14953999	.	C	G	0	3	3	0	0	3	0	0
17	15005217	.	A	G	3	4	7	0	0	7	0	0
17	15041276	.	A	T	2	4	6	0	0	6	0	0
17	15049262	.	T	C	1	3	4	0	0	4	0	0
17	15116963	.	A	T	1	2	3	0	0	3	0	0
17	15117257	.	A	T	1	2	3	0	0	3	0	0
17	15117289	.	T	C	1	4	5	0	0	5	0	0
17	15122021	.	T	G	6	2	8	0	4	12	0	0
17	15123023	.	A	G	4	3	7	0	0	7	0	0
17	15123062	.	C	A	4	4	8	0	0	8	0	0
17	15125230	.	A	G	2	3	5	0	0	5	0	0
17	15125233	.	G	C	2	3	5	0	0	5	0	0
17	15126157	.	C	A	2	2	4	0	0	4	0	0
17	15126851	.	T	C	2	0	2	0	2	4	0	0
17	15126971	.	C	A	1	3	4	0	1	5	0	0
17	15149034	.	T	C	1	3	4	0	0	4	0	0
17	15149218	.	A	T	1	1	2	0	0	2	0	0
17	15149221	.	G	A	1	1	2	0	0	2	0	0
17	15213620	.	C	T	2	2	4	0	0	4	0	0
17	15219107	.	G	A	6	5	11	0	1	12	0	0
17	15219141	.	C	T	3	4	7	0	1	8	0	0
17	15219325	.	A	C	1	4	5	0	0	5	0	0
17	15219739	.	T	A	3	3	6	0	0	6	0	0
17	15220092	.	C	T	1	2	3	0	4	7	0	0
17	15224052	.	G	A	4	3	7	0	0	7	0	0
17	15309458	.	A	G	3	9	12	0	1	13	0	0
17	15309621	.	C	T	1	6	7	0	15	22	0	0
17	15316001	.	T	C	11	7	18	0	1	19	0	0
17	15316022	.	T	C	8	2	10	0	1	11	0	0
17	15319232	.	G	A	11	7	18	0	1	19	0	0
17	15353984	.	G	A	15	4	19	0	0	19	0	0
17	15374185	.	T	C	3	12	15	0	2	17	0	0
17	15374507	.	G	A	6	19	25	0	1	26	0	0
17	15374744	.	C	G	13	4	17	0	0	17	0	0
17	15382421	.	T	A	14	7	21	0	0	21	0	0
17	15382486	.	C	T	14	9	23	0	0	23	0	0
17	15633439	.	T	C	12	5	17	0	6	23	0	0
17	15633605	.	T	C	9	6	15	0	0	15	0	0
17	15633721	.	T	C	6	6	12	0	0	12	0	0
17	15888422	.	A	C	1	1	2	0	0	2	0	0
17	15892479	.	G	A	0	2	2	0	1	3	0	0
17	15963538	.	T	A	2	2	4	0	0	4	0	0
17	15964488	.	C	T	4	3	7	0	0	7	0	0
17	15964692	.	T	C	1	2	3	0	0	3	0	0
17	15964732	.	A	G	2	3	5	0	0	5	0	0
17	15964906	.	C	T	1	3	4	0	0	4	0	0
17	15965589	.	C	A	3	8	11	0	0	11	0	0
17	15965708	.	T	A	3	4	7	0	0	7	0	0
17	15965951	.	G	T	0	5	5	0	5	10	0	0
17	15983530	.	C	T	3	6	9	0	0	9	0	0
17	16024677	.	A	G	1	1	2	0	0	2	0	0
17	16026207	.	T	A	0	1	1	0	0	1	0	0
17	16026293	.	A	G	6	7	13	0	1	14	0	0
17	16026345	.	A	G	8	8	16	0	0	16	0	0
17	16026486	.	C	T	3	3	6	0	0	6	0	0
17	16026593	.	C	T	2	4	6	0	1	7	0	0
17	16027718	.	G	A	5	8	13	0	1	14	0	0
17	16027720	.	A	G	5	8	13	0	1	14	0	0
17	16027935	.	G	T	10	8	18	0	0	18	0	0
17	16027983	.	A	T	11	11	22	0	0	22	0	0
17	16028040	.	G	A	9	13	22	0	1	23	0	0
17	16028118	.	A	G	8	0	8	0	3	11	0	0
17	16051805	.	A	G	5	3	8	0	0	8	0	0
17	16051968	.	G	A	9	4	13	0	1	14	0	0
17	16052075	.	A	G	9	5	14	0	1	16	1	0
17	16052229	.	C	T	5	6	11	0	1	12	0	0
17	16052282	.	G	A	2	7	9	0	0	9	0	0
17	16052563	.	G	A	9	4	13	0	0	13	0	0
17	16052587	.	T	G	1	6	7	0	0	7	0	0
17	16055049	.	T	C	6	8	14	0	0	14	0	0
17	16055179	.	G	A	2	2	4	0	0	4	0	0
17	16057798	.	C	T	14	13	27	0	1	28	0	0
17	16057877	.	C	A	0	1	1	0	1	2	0	0
17	16059802	.	T	G	6	6	12	0	0	12	0	0
17	16059831	.	T	G	4	5	9	0	0	9	0	0
17	16059854	.	G	T	2	6	8	0	0	8	0	0
17	16059889	.	A	C	2	0	2	0	4	6	0	0
17	16064779	.	A	T	2	1	3	0	0	3	0	0
17	16064843	.	G	T	3	1	4	0	0	4	0	0
17	16099623	.	A	G	0	1	1	0	0	1	0	0
17	16107111	.	C	T	1	8	9	0	0	9	0	0
17	16107167	.	T	A	2	3	5	0	1	6	0	0
17	16107361	.	T	C	6	2	8	0	0	8	0	0
17	16107882	.	A	G	8	0	8	0	5	13	0	0
17	16110234	.	A	G	7	10	17	0	0	17	0	0
17	16110336	.	T	C	6	4	10	0	0	10	0	0
17	16110447	.	T	G	6	7	13	0	0	13	0	0
17	16110527	.	C	G	0	5	5	0	5	10	0	0
17	16110552	.	C	T	7	1	8	0	0	8	0	0
17	16110573	.	A	G	0	6	6	0	0	6	0	0
17	16110687	.	G	A	4	4	8	0	1	9	0	0
17	16111427	.	C	T	2	2	4	0	0	4	0	0
17	16804700	.	A	G	4	10	14	0	1	15	0	0
17	16907048	.	G	T	7	0	7	0	4	11	0	0
17	18070138	.	G	A	4	20	24	0	0	24	0	0
17	18179927	.	T	C	2	5	7	0	4	11	0	0
17	20188836	.	C	T	1	7	8	0	0	8	0	0
17	20515186	.	C	T	5	2	7	0	0	7	0	0
17	20654017	.	A	T	0	4	4	0	0	4	0	0
17	20654023	.	G	A	2	3	5	0	0	5	0	0
17	20722444	.	C	T	7	2	9	0	0	9	0	0
17	23764926	.	G	T	3	5	8	0	0	8	0	0
17	24081092	.	A	G	1	2	3	0	0	3	0	0
17	24081209	.	A	G	2	4	6	0	0	6	0	0
17	24443182	.	G	C	0	3	3	0	0	3	0	0
17	24817636	.	A	G	1	2	3	0	2	5	0	0
17	24926623	.	G	A	1	6	7	0	0	7	0	0
17	25479240	.	C	T	1	4	5	0	0	5	0	0
17	26285347	.	A	G	1	0	1	0	2	3	0	0
17	26285350	.	G	T	1	2	3	0	0	3	0	0
17	26298967	.	C	T	2	3	5	0	0	5	0	0
17	26335000	.	G	A	4	2	6	0	0	6	0	0
17	26362130	.	G	A	8	5	13	0	7	20	0	0
17	26362500	.	C	T	4	4	8	0	0	8	0	0
17	26362512	.	A	C	6	5	11	0	0	11	0	0
17	26362539	.	C	T	5	7	12	0	0	12	0	0
17	26362741	.	C	T	3	6	9	0	1	10	0	0
17	26477743	.	A	C	8	3	11	0	1	12	0	0
17	26477747	.	T	A	7	3	10	0	1	11	0	0
17	26477795	.	A	C	11	4	15	0	2	18	1	0
17	26477857	.	T	C	8	12	20	0	1	21	0	0
17	26477860	.	C	T	8	13	21	0	1	22	0	0
17	26478023	.	T	C	8	4	12	0	1	13	0	0
17	26478403	.	T	G	3	6	9	0	1	10	0	0
17	26478592	.	A	G	15	13	28	0	0	28	0	0
17	26478818	.	T	C	1	0	1	0	6	7	0	0
17	26478952	.	G	A	10	7	17	0	2	19	0	0
17	26478986	.	A	G	9	8	17	0	1	18	0	0
17	26479063	.	A	G	11	9	20	1	2	23	0	0
17	26479145	.	T	C	11	14	25	0	2	27	0	0
17	26479916	.	G	T	7	2	9	0	1	10	0	0
17	26479960	.	C	T	4	4	8	0	0	8	0	0
17	26479997	.	A	T	2	5	7	0	0	7	0	0
17	26480250	.	A	C	6	2	8	0	1	9	0	0
17	26480254	.	G	A	6	2	8	0	1	9	0	0
17	26480622	.	A	T	5	5	10	0	1	11	0	0
17	26480683	.	A	G	3	1	4	0	1	5	0	0
17	26480926	.	T	G	2	4	6	0	0	6	0	0
17	26502013	.	A	G	1	0	1	0	0	1	0	0
17	26502047	.	A	C	0	0	0	0	2	2	0	0
17	26502107	.	G	A	3	3	6	0	0	6	0	0
17	26507294	.	G	A	1	1	2	0	0	2	0	0
17	26516745	.	G	C	1	1	2	0	0	2	0	0
17	26516748	.	G	C	1	1	2	0	0	2	0	0
17	26516878	.	G	A	1	2	3	0	0	3	0	0
17	26517310	.	A	C	2	0	2	0	2	5	1	0
17	26517366	.	G	A	2	1	3	0	1	4	0	0
17	26519364	.	A	G	2	4	6	0	0	6	0	0
17	26537477	.	A	T	1	2	3	0	0	3	0	0
17	26537529	.	C	T	1	2	3	0	0	3	0	0
17	26537805	.	A	T	1	2	3	0	0	3	0	0
17	26577293	.	T	C	1	4	5	0	0	5	0	0
17	26585135	.	G	T	4	7	11	0	1	12	0	0
17	26585163	.	A	T	4	7	11	0	0	11	0	0
17	26585298	.	G	T	0	8	8	0	2	10	0	0
17	26585646	.	C	T	13	6	19	0	0	19	0	0
17	26585727	.	C	T	10	9	19	0	0	19	0	0
17	26585748	.	A	G	9	1	10	0	12	22	0	0
17	26585763	.	T	A	12	12	24	0	1	25	0	0
17	26590001	.	T	G	10	8	18	0	1	19	0	0
17	26590054	.	C	T	10	5	15	0	1	16	0	0
17	26590091	.	C	T	5	7	12	0	0	12	0	0
17	26590330	.	T	C	16	7	23	0	1	24	0	0
17	26590495	.	A	G	5	5	10	0	0	10	0	0
17	26590536	.	G	A	2	3	5	0	0	5	0	0
17	26590650	.	G	T	5	3	8	0	0	8	0	0
17	26594931	.	C	T	8	2	10	0	0	10	0	0
17	26594968	.	G	C	0	3	3	0	0	3	0	0
17	26599208	.	C	T	0	1	1	0	2	3	0	0
17	26600555	.	T	A	2	2	4	0	0	4	0	0
17	26600639	.	G	A	3	9	12	0	0	12	0	0
17	26600667	.	C	T	5	2	7	0	0	7	0	0
17	26600785	.	G	A	0	1	1	0	0	1	0	0
17	26600881	.	G	A	4	2	6	0	0	6	0	0
17	26603369	.	A	T	2	3	5	0	0	5	0	0
17	26604572	.	A	G	2	4	6	0	0	6	0	0
17	26604751	.	G	C	3	6	9	0	2	11	0	0
17	26604758	.	C	T	3	7	10	0	1	11	0	0
17	26604801	.	C	A	5	3	8	0	0	8	0	0
17	26630909	.	C	T	2	1	3	0	0	3	0	0
17	26639659	.	C	T	7	1	8	0	0	8	0	0
17	26639725	.	A	G	3	0	3	0	3	6	0	0
17	26642775	.	C	A	2	5	7	0	0	7	0	0
17	26642817	.	T	G	6	0	6	0	11	17	0	0
17	26642818	.	T	C	6	11	17	0	0	17	0	0
17	26657852	.	T	C	7	5	12	0	0	12	0	0
17	26662347	.	C	T	4	6	10	0	0	10	0	0
17	26683526	.	C	T	19	7	26	0	0	26	0	0
17	26689753	.	G	A	19	17	36	0	6	42	0	0
17	26689768	.	C	A	22	11	33	1	0	34	0	0
17	26689792	.	C	A	11	16	27	1	3	31	0	0
17	26690112	.	T	A	20	13	33	0	0	33	0	0
17	26690250	.	C	T	12	7	19	0	0	19	0	0
17	26690276	.	C	T	9	10	19	0	1	21	1	0
17	26690478	.	C	T	10	12	22	0	2	24	0	0
17	26690558	.	G	A	0	12	12	0	19	31	0	0
17	26714009	.	C	T	26	28	54	0	6	60	0	0
17	26722954	.	A	C	0	1	1	0	0	1	0	0
17	26743948	.	T	C	1	3	4	0	1	5	0	0
17	26744706	.	T	C	1	3	4	0	0	4	0	0
17	26744840	.	A	G	2	2	4	0	0	4	0	0
17	26745014	.	G	T	1	7	8	0	0	8	0	0
17	26747348	.	A	G	0	2	2	0	0	2	0	0
17	26810380	.	C	T	6	11	17	0	0	17	0	0
17	26813285	.	T	C	3	18	21	0	4	25	0	0
17	26846203	.	C	T	10	12	22	0	0	22	0	0
17	26846650	.	G	A	6	4	10	0	7	17	0	0
17	26846707	.	G	A	1	3	4	0	4	8	0	0
17	26846901	.	T	G	6	7	13	0	0	13	0	0
17	26879854	.	A	C	9	16	25	0	3	28	0	0
17	26879869	.	A	G	14	14	28	0	2	30	0	0
17	26879893	.	A	G	21	20	41	0	0	41	0	0
17	26880107	.	G	A	22	16	38	0	2	40	0	0
17	26880231	.	T	C	31	25	56	0	2	58	0	0
17	26880424	.	T	C	31	19	50	0	2	52	0	0
17	26880926	.	T	C	20	0	20	0	17	37	0	0
17	26880964	.	A	G	23	21	44	0	3	47	0	0
17	26881131	.	T	A	23	10	33	0	2	35	0	0
17	26881354	.	A	G	24	21	45	0	2	47	0	0
17	26881777	.	A	G	21	17	38	0	3	41	0	0
17	26911747	.	A	G	12	17	29	0	0	29	0	0
17	26924308	.	C	T	0	3	3	0	2	5	0	0
17	26928994	.	C	T	4	4	8	0	0	8	0	0
17	26929029	.	G	A	4	3	7	0	0	7	0	0
17	26929049	.	T	A	4	4	8	0	2	10	0	0
17	26929577	.	C	A	6	8	14	0	1	15	0	0
17	26929649	.	A	G	4	8	12	0	0	12	0	0
17	26929654	.	T	A	8	3	11	0	0	11	0	0
17	26929776	.	C	T	5	3	8	0	0	8	0	0
17	26929893	.	G	A	5	7	12	0	0	12	0	0
17	26933223	.	A	G	1	3	4	0	0	4	0	0
17	26933328	.	C	T	0	4	4	0	0	4	0	0
17	26934417	.	C	T	0	1	1	0	3	4	0	0
17	26935254	.	G	T	2	5	7	0	1	8	0	0
17	26935274	.	G	T	4	7	11	0	1	12	0	0
17	26985544	.	T	A	4	4	8	0	0	8	0	0
17	26985561	.	T	G	5	0	5	0	4	9	0	0
17	26985586	.	C	T	3	7	10	0	0	10	0	0
17	26985638	.	T	G	6	11	17	0	1	18	0	0
17	26985656	.	T	A	6	13	19	0	0	19	0	0
17	26985692	.	G	T	2	8	10	0	0	10	0	0
17	26985712	.	T	C	2	5	7	0	0	7	0	0
17	27154695	.	A	G	1	0	1	0	0	1	0	0
17	27160912	.	G	A	2	1	3	0	0	3	0	0
17	27163266	.	T	C	1	1	2	0	0	2	0	0
17	27164497	.	T	C	4	5	9	0	0	9	0	0
17	27164530	.	C	T	3	0	3	0	1	4	0	0
17	27166221	.	T	C	0	3	3	0	0	3	0	0
17	27166257	.	T	C	0	6	6	0	0	6	0	0
17	27166521	.	C	T	2	0	2	0	0	2	0	0
17	27168957	.	G	T	0	4	4	0	3	7	0	0
17	27169557	.	T	G	7	4	11	0	0	11	0	0
17	27169783	.	A	C	5	4	9	0	2	11	0	0
17	27170017	.	G	A	1	6	7	0	4	11	0	0
17	27170153	.	A	T	3	6	9	0	1	10	0	0
17	27170516	.	G	A	0	11	11	0	10	21	0	0
17	27170549	.	G	A	10	5	15	0	0	15	0	0
17	27170605	.	T	G	10	13	23	0	0	23	0	0
17	27170678	.	C	A	3	7	10	0	0	10	0	0
17	27170730	.	T	G	5	7	12	0	0	12	0	0
17	27170746	.	A	T	4	9	13	0	0	13	0	0
17	27171314	.	A	C	2	4	6	0	0	6	0	0
17	27176871	.	G	A	2	6	8	0	0	8	0	0
17	27176967	.	G	C	2	4	6	0	0	6	0	0
17	27176991	.	C	T	4	6	10	0	0	10	0	0
17	27177064	.	C	T	2	3	5	0	0	5	0	0
17	27177083	.	G	A	0	4	4	0	2	6	0	0
17	27177251	.	A	G	3	5	8	0	0	8	0	0
17	27177302	.	A	G	0	0	0	0	4	4	0	0
17	27177864	.	C	T	3	3	6	0	2	8	0	0
17	27177934	.	A	G	0	2	2	0	1	3	0	0
17	27177945	.	G	T	3	3	6	0	0	6	0	0
17	27178024	.	T	A	5	4	9	0	0	9	0	0
17	27178088	.	T	A	2	4	6	0	0	6	0	0
17	27178191	.	G	A	4	6	10	0	1	11	0	0
17	27178232	.	A	G	6	2	8	0	1	9	0	0
17	27178254	.	C	A	1	5	6	0	2	8	0	0
17	27178296	.	G	A	0	4	4	0	2	6	0	0
17	27178356	.	T	A	1	4	5	0	0	5	0	0
17	27178383	.	C	G	3	3	6	0	0	6	0	0
17	27178401	.	C	T	3	5	8	0	0	8	0	0
17	27178557	.	C	T	6	2	8	0	0	8	0	0
17	27178638	.	C	G	5	6	11	0	0	11	0	0
17	27178730	.	C	A	7	7	14	0	0	14	0	0
17	27178870	.	T	C	5	6	11	0	0	11	0	0
17	27179189	.	A	G	10	8	18	0	0	18	0	0
17	27179203	.	G	T	0	7	7	0	8	15	0	0
17	27179848	.	A	G	2	2	4	0	0	4	0	0
17	27180407	.	T	A	3	8	11	0	0	11	0	0
17	27180447	.	A	T	2	6	8	0	1	9	0	0
17	27181021	.	T	C	3	7	10	0	1	11	0	0
17	27181048	.	C	G	6	9	15	0	2	17	0	0
17	27181129	.	G	A	8	13	21	0	2	23	0	0
17	27181130	.	G	A	8	15	23	0	0	23	0	0
17	27181257	.	A	C	8	15	23	0	0	23	0	0
17	27181323	.	A	G	11	0	11	0	12	23	0	0
17	27181411	.	A	G	8	0	8	0	8	16	0	0
17	27181427	.	C	T	5	7	12	0	2	14	0	0
17	27181463	.	A	G	5	0	5	0	5	10	0	0
17	27181481	.	A	G	4	3	7	0	0	7	0	0
17	27181618	.	C	A	1	1	2	0	1	3	0	0
17	27181829	.	A	G	5	4	9	0	2	11	0	0
17	27182006	.	G	T	9	4	13	0	1	14	0	0
17	27182039	.	T	C	8	9	17	0	1	18	0	0
17	27182114	.	A	G	4	13	17	0	2	19	0	0
17	27182146	.	C	T	5	11	16	0	0	16	0	0
17	27182331	.	T	G	6	8	14	0	0	14	0	0
17	27182340	.	C	T	5	6	11	0	1	12	0	0
17	27182449	.	G	T	10	10	20	0	0	20	0	0
17	27182484	.	T	C	11	15	26	0	1	27	0	0
17	27182645	.	G	T	21	13	34	0	0	34	0	0
17	27182649	.	A	G	19	14	33	0	1	34	0	0
17	27182769	.	A	G	5	10	15	0	1	16	0	0
17	27182894	.	T	C	14	16	30	0	0	30	0	0
17	27182925	.	A	T	13	14	27	0	0	27	0	0
17	27182979	.	C	T	10	8	18	0	0	18	0	0
17	27191528	.	C	T	1	3	4	0	1	5	0	0
17	27192698	.	C	T	0	4	4	0	0	4	0	0
17	27194183	.	A	G	1	4	5	0	0	5	0	0
17	27194867	.	A	G	0	1	1	0	0	1	0	0
17	27197607	.	A	G	1	0	1	0	0	1	0	0
17	27272913	.	T	C	6	7	13	0	1	14	0	0
17	27273013	.	C	T	6	5	11	0	1	12	0	0
17	27401038	.	A	T	10	6	16	0	3	19	0	0
17	27408386	.	A	G	9	11	20	0	0	20	0	0
17	27408472	.	C	T	11	13	24	0	1	25	0	0
17	27408523	.	G	T	5	6	11	0	0	11	0	0
17	27408531	.	T	A	1	5	6	0	2	8	0	0
17	27408836	.	T	G	4	12	16	0	2	18	0	0
17	27408889	.	T	C	1	9	10	0	0	10	0	0
17	27413564	.	T	C	2	1	3	0	0	3	0	0
17	27413705	.	T	C	10	11	21	0	1	22	0	0
17	27414035	.	G	A	1	6	7	0	3	10	0	0
17	27414098	.	C	A	6	8	14	0	0	14	0	0
17	27414203	.	G	A	3	12	15	0	1	16	0	0
17	27414215	.	C	T	0	10	10	0	6	16	0	0
17	27414367	.	A	G	6	7	13	0	0	13	0	0
17	27414658	.	T	C	7	8	15	0	0	15	0	0
17	27414701	.	A	G	8	6	14	0	0	14	0	0
17	27414791	.	A	G	8	6	14	0	2	16	0	0
17	27414815	.	G	A	8	7	15	0	1	16	0	0
17	27415010	.	C	T	1	7	8	0	6	14	0	0
17	27444909	.	C	A	2	2	4	0	0	4	0	0
17	27723800	.	G	T	6	6	12	0	0	12	0	0
17	27807455	.	T	C	12	17	29	0	1	30	0	0
17	27808190	.	A	G	8	0	8	0	7	15	0	0
17	27808335	.	A	G	16	17	33	0	1	34	0	0
17	27808686	.	G	A	6	6	12	0	0	12	0	0
17	27808700	.	G	A	8	8	16	0	0	16	0	0
17	27808987	.	G	T	0	21	21	0	23	44	0	0
17	27809548	.	T	A	11	8	19	0	1	20	0	0
17	27809631	.	G	T	1	3	4	0	10	14	0	0
17	27809779	.	C	A	16	15	31	0	1	32	0	0
17	27809885	.	A	G	20	20	40	0	1	41	0	0
17	27811199	.	T	A	3	7	10	0	0	10	0	0
17	27811209	.	A	G	6	9	15	0	0	15	0	0
17	27811254	.	T	C	6	4	10	0	0	10	0	0
17	27811277	.	C	G	5	2	7	0	0	7	0	0
17	27812292	.	T	A	0	4	4	0	0	4	0	0
17	27812525	.	A	C	19	12	31	0	1	32	0	0
17	27812562	.	G	A	0	9	9	0	20	29	0	0
17	27812702	.	A	T	13	6	19	0	2	22	1	0
17	27812885	.	C	T	1	4	5	0	0	5	0	0
17	27813221	.	C	T	14	7	21	0	0	21	0	0
17	27813222	.	A	G	14	7	21	0	0	21	0	0
17	27813549	.	C	G	11	3	14	0	0	14	0	0
17	27813553	.	C	G	9	2	11	0	3	14	0	0
17	28049663	.	A	T	2	5	7	0	0	7	0	0
17	28049804	.	G	T	3	1	4	0	1	5	0	0
17	28050500	.	T	A	3	2	5	0	0	5	0	0
17	28050530	.	A	G	3	5	8	0	0	8	0	0
17	28050954	.	G	A	2	2	4	0	0	4	0	0
17	28051073	.	C	T	6	2	8	0	0	8	0	0
17	28051129	.	G	A	8	6	14	0	0	14	0	0
17	28051465	.	T	C	1	3	4	0	0	4	0	0
17	28051504	.	G	T	2	2	4	0	1	5	0	0
17	28051739	.	A	G	6	5	11	0	0	11	0	0
17	28052322	.	C	A	11	6	17	0	0	17	0	0
17	28067389	.	C	T	3	3	6	0	1	7	0	0
17	28067472	.	A	C	10	12	22	0	1	23	0	0
17	28067618	.	A	G	8	4	12	0	0	12	0	0
17	28067856	.	C	T	9	4	13	0	0	13	0	0
17	28068083	.	T	C	7	4	11	0	0	11	0	0
17	28068087	.	G	T	7	4	11	0	0	11	0	0
17	28068168	.	G	A	2	3	5	0	0	5	0	0
17	28068262	.	T	G	7	0	7	0	4	11	0	0
17	28068276	.	C	T	6	7	13	0	0	13	0	0
17	28068507	.	A	G	6	3	9	0	0	9	0	0
17	28068514	.	T	C	6	3	9	0	0	9	0	0
17	28068832	.	T	A	10	4	14	0	0	14	0	0
17	28068916	.	C	T	6	5	11	0	0	11	0	0
17	28069170	.	G	A	19	12	31	0	0	31	0	0
17	28069341	.	G	T	12	7	19	0	1	20	0	0
17	28069342	.	T	C	12	8	20	0	0	20	0	0
17	28069645	.	G	T	13	8	21	0	1	22	0	0
17	28069716	.	G	C	17	17	34	0	0	34	0	0
17	28069787	.	G	A	0	8	8	0	20	28	0	0
17	28070078	.	G	C	13	10	23	0	1	24	0	0
17	28070167	.	C	T	9	11	20	0	2	22	0	0
17	28070284	.	G	A	9	6	15	0	2	17	0	0
17	28070286	.	A	C	9	8	17	0	0	17	0	0
17	28070481	.	T	A	15	9	24	0	0	25	1	0
17	28070600	.	C	A	11	13	24	0	2	26	0	0
17	28070840	.	G	A	10	8	18	0	0	18	0	0
17	28071029	.	A	T	3	2	5	0	0	5	0	0
17	28071260	.	A	G	6	11	17	0	0	17	0	0
17	28084592	.	C	T	8	10	18	0	2	20	0	0
17	28084908	.	C	T	18	16	34	0	0	34	0	0
17	28097235	.	G	A	0	1	1	0	0	1	0	0
17	28100598	.	C	T	0	7	7	0	4	11	0	0
17	28167312	.	G	A	8	2	10	0	0	10	0	0
17	28167313	.	A	T	8	2	10	0	0	10	0	0
17	28168645	.	C	T	1	2	3	0	1	4	0	0
17	28340740	.	A	T	2	6	8	0	0	8	0	0
17	28408024	.	A	C	2	0	2	0	0	2	0	0
17	28440212	.	T	A	2	3	5	0	0	5	0	0
17	28461857	.	G	A	0	5	5	0	5	10	0	0
17	28466273	.	C	T	2	2	4	0	0	4	0	0
17	28635326	.	A	T	1	2	3	0	0	3	0	0
17	28635327	.	T	C	1	2	3	0	0	3	0	0
17	28640625	.	C	T	1	2	3	0	0	3	0	0
17	28658563	.	A	G	4	4	8	0	0	8	0	0
17	28661628	.	C	G	4	0	4	0	3	7	0	0
17	28668627	.	C	T	3	3	6	0	0	6	0	0
17	28669185	.	G	A	2	2	4	0	0	4	0	0
17	28669196	.	T	C	2	1	3	0	1	4	0	0
17	28680593	.	T	C	1	4	5	0	0	5	0	0
17	28684786	.	C	T	2	2	4	0	0	4	0	0
17	28688931	.	G	T	9	3	12	0	0	12	0	0
17	28694574	.	A	T	1	0	1	0	0	1	0	0
17	28694589	.	T	C	1	0	1	0	0	1	0	0
17	28695956	.	G	A	11	9	20	0	0	20	0	0
17	28696109	.	C	A	9	7	16	0	0	16	0	0
17	28696160	.	C	T	12	11	23	0	0	23	0	0
17	28696311	.	C	T	7	9	16	0	0	16	0	0
17	28696397	.	A	G	15	0	15	0	15	30	0	0
17	28700311	.	T	C	1	1	2	0	0	2	0	0
17	28700428	.	G	A	19	18	37	0	2	39	0	0
17	28701100	.	G	A	10	9	19	0	0	19	0	0
17	28707851	.	C	A	0	4	4	0	7	11	0	0
17	28730705	.	C	T	3	4	7	0	0	7	0	0
17	28738387	.	C	T	2	4	6	0	0	6	0	0
17	28738675	.	A	G	3	0	3	0	6	9	0	0
17	28741540	.	A	G	12	0	12	0	11	23	0	0
17	28741752	.	C	T	15	7	22	0	0	22	0	0
17	28741934	.	C	T	7	6	13	0	1	14	0	0
17	28742263	.	G	C	10	18	28	0	2	30	0	0
17	28742385	.	T	A	10	10	20	0	0	20	0	0
17	28742395	.	G	A	0	11	11	0	11	22	0	0
17	28742559	.	C	T	18	18	36	0	1	37	0	0
17	28742681	.	C	T	2	8	10	0	0	10	0	0
17	28743701	.	C	T	5	7	12	0	0	12	0	0
17	28743825	.	G	T	6	3	9	0	0	9	0	0
17	28744054	.	A	G	2	3	5	0	0	5	0	0
17	28771228	.	T	A	1	1	2	0	0	2	0	0
17	28777803	.	C	T	4	1	5	0	0	5	0	0
17	28784090	.	G	T	2	4	6	0	1	7	0	0
17	28784102	.	G	A	4	3	7	0	0	7	0	0
17	28785010	.	G	A	3	1	4	0	0	4	0	0
17	28785013	.	C	T	1	4	5	0	0	5	0	0
17	28789014	.	C	T	0	2	2	0	3	5	0	0
17	28942683	.	C	T	3	0	3	0	0	3	0	0
17	28948818	.	G	A	2	5	7	0	0	7	0	0
17	28958371	.	C	T	3	3	6	0	2	8	0	0
17	28959148	.	T	C	12	13	25	0	1	26	0	0
17	28968461	.	T	C	16	19	35	0	0	35	0	0
17	28968611	.	C	T	6	6	12	0	1	13	0	0
17	29196555	.	G	A	1	2	3	0	0	3	0	0
17	29252207	.	G	A	7	13	20	0	1	21	0	0
17	29252254	.	C	T	4	8	12	0	2	14	0	0
17	29253050	.	T	C	2	1	3	0	0	3	0	0
17	29282901	.	C	A	7	2	9	0	0	9	0	0
17	29282913	.	C	T	0	2	2	0	5	7	0	0
17	29283036	.	C	G	4	3	7	0	0	7	0	0
17	29283042	.	C	A	4	3	7	0	0	7	0	0
17	29283421	.	G	A	3	5	8	0	0	8	0	0
17	29283422	.	C	T	3	5	8	0	0	8	0	0
17	29283866	.	T	C	1	3	4	0	0	4	0	0
17	29283920	.	A	C	5	0	5	0	2	7	0	0
17	29283943	.	A	G	5	2	7	0	0	7	0	0
17	29283962	.	A	G	5	2	7	0	0	7	0	0
17	29288057	.	G	T	6	3	9	0	1	10	0	0
17	29288718	.	A	G	2	1	3	0	0	3	0	0
17	29298191	.	G	C	2	0	2	0	1	3	0	0
17	29300641	.	A	T	4	3	7	0	0	7	0	0
17	29300650	.	A	G	3	3	6	0	0	6	0	0
17	29301058	.	G	C	1	2	3	0	0	3	0	0
17	29306455	.	G	A	3	2	5	0	0	5	0	0
17	29308693	.	G	A	0	3	3	0	1	4	0	0
17	29308706	.	G	A	1	3	4	0	0	4	0	0
17	29334520	.	T	A	1	1	2	0	0	2	0	0
17	29334569	.	A	C	1	1	2	0	1	3	0	0
17	29335645	.	G	A	1	2	3	0	0	3	0	0
17	29336179	.	G	A	6	4	10	0	0	10	0	0
17	29336180	.	G	T	6	4	10	0	0	10	0	0
17	29341079	.	C	T	10	7	17	0	0	17	0	0
17	29341123	.	C	A	4	5	9	0	0	9	0	0
17	29345725	.	T	G	1	3	4	0	0	4	0	0
17	29345890	.	T	A	6	3	9	0	0	9	0	0
17	29366113	.	G	A	0	4	4	0	3	7	0	0
17	29369642	.	G	T	8	11	19	0	1	21	1	0
17	29369644	.	G	A	8	13	21	0	0	21	0	0
17	29797906	.	C	T	11	14	25	0	0	25	0	0
17	29804291	.	G	C	8	10	18	0	0	18	0	0
17	29804441	.	T	C	3	0	3	0	2	5	0	0
17	29876956	.	G	A	1	3	4	0	0	4	0	0
17	29877094	.	A	G	5	4	9	0	0	9	0	0
17	29877283	.	C	A	0	6	6	0	6	12	0	0
17	30414463	.	C	A	3	1	4	0	0	4	0	0
17	30416418	.	G	T	1	1	2	0	0	2	0	0
17	30450275	.	G	A	4	1	5	0	0	5	0	0
17	30460090	.	C	T	1	4	5	0	0	5	0	0
17	30590075	.	A	T	8	8	16	0	1	17	0	0
17	30857431	.	A	T	1	8	9	0	1	10	0	0
17	30857433	.	A	T	2	8	10	0	0	10	0	0
17	30979391	.	T	C	10	0	10	0	9	19	0	0
17	30979465	.	T	C	7	6	13	0	1	14	0	0
17	30979470	.	T	C	13	2	15	0	0	15	0	0
17	31200621	.	C	T	1	6	7	0	1	8	0	0
17	31535903	.	T	G	1	2	3	0	0	3	0	0
17	31935271	.	C	T	1	7	8	0	0	8	0	0
17	32524695	.	A	G	35	17	52	0	1	53	0	0
17	32524706	.	A	G	37	15	52	0	2	54	0	0
17	32658391	.	T	A	1	2	3	0	0	3	0	0
17	34105333	.	G	A	0	1	1	0	0	1	0	0
17	34141488	.	T	G	7	5	12	0	0	12	0	0
17	34158945	.	G	A	8	1	9	0	1	10	0	0
17	34162932	.	G	C	3	6	9	0	0	9	0	0
17	34182672	.	G	A	2	12	14	0	8	22	0	0
17	34182949	.	C	T	11	9	20	0	2	22	0	0
17	34183002	.	T	C	21	15	36	0	0	36	0	0
17	34183320	.	T	G	32	21	53	0	0	53	0	0
17	34183497	.	T	C	17	19	36	0	5	41	0	0
17	34183512	.	A	T	19	17	36	0	4	41	1	0
17	34244437	.	G	T	6	11	17	0	0	17	0	0
17	34246289	.	T	C	4	8	12	0	0	12	0	0
17	34246295	.	A	G	3	7	10	0	1	11	0	0
17	34254065	.	A	G	7	9	16	0	1	17	0	0
17	34806801	.	G	T	0	3	3	0	0	3	0	0
17	34807498	.	T	A	17	25	42	0	1	43	0	0
17	34807781	.	C	T	4	5	9	0	2	11	0	0
17	34807836	.	A	C	3	9	12	0	2	14	0	0
17	34807961	.	G	A	4	6	10	0	0	10	0	0
17	34808024	.	T	C	2	3	5	0	0	5	0	0
17	34814035	.	T	C	0	0	0	0	2	2	0	0
17	34970088	.	A	G	2	7	9	0	0	9	0	0
17	35187661	.	T	G	1	0	1	0	0	1	0	0
17	35198102	.	C	T	0	3	3	0	0	3	0	0
17	35198161	.	T	A	3	4	7	0	0	7	0	0
17	35203236	.	T	C	0	2	2	0	0	2	0	0
17	35203398	.	T	C	0	0	0	0	1	1	0	0
17	35210724	.	T	C	2	3	5	0	0	5	0	0
17	35210811	.	T	C	8	5	13	0	1	14	0	0
17	35210853	.	A	G	5	9	14	0	1	15	0	0
17	35210868	.	C	A	6	8	14	0	1	15	0	0
17	35213989	.	G	A	3	6	9	0	0	9	0	0
17	35222582	.	G	A	0	3	3	0	4	7	0	0
17	35222762	.	C	A	6	9	15	0	1	16	0	0
17	35222864	.	G	A	9	7	16	0	0	16	0	0
17	35222883	.	T	C	8	8	16	0	0	16	0	0
17	35222994	.	A	T	9	7	16	0	0	16	0	0
17	35223051	.	A	T	5	8	13	0	0	13	0	0
17	35223057	.	A	G	5	6	11	0	1	12	0	0
17	35223151	.	T	C	5	8	13	0	0	13	0	0
17	35223195	.	C	T	5	10	15	0	0	15	0	0
17	35223368	.	G	A	0	5	5	0	6	11	0	0
17	35226377	.	G	A	2	2	4	0	0	4	0	0
17	35229163	.	T	A	2	3	5	0	1	6	0	0
17	35238310	.	T	G	1	2	3	0	0	3	0	0
17	35243805	.	A	T	1	3	4	0	0	4	0	0
17	35246383	.	G	A	0	4	4	0	0	4	0	0
17	35246994	.	A	G	0	5	5	0	0	5	0	0
17	35247012	.	T	A	0	2	2	0	0	2	0	0
17	35247203	.	G	A	2	2	4	0	0	4	0	0
17	35247838	.	T	C	10	13	23	0	2	25	0	0
17	35248038	.	C	T	10	10	20	0	0	20	0	0
17	35248121	.	T	A	6	7	13	1	1	15	0	0
17	35248264	.	G	A	13	9	22	0	0	22	0	0
17	35248577	.	T	C	0	4	4	0	0	4	0	0
17	35248589	.	T	C	1	2	3	0	0	3	0	0
17	35249136	.	G	A	4	5	9	0	0	9	0	0
17	35249141	.	T	G	4	6	10	0	0	10	0	0
17	35249206	.	C	A	1	4	5	0	0	5	0	0
17	35249230	.	T	G	2	5	7	0	1	8	0	0
17	35249422	.	A	C	15	10	25	0	1	26	0	0
17	35249688	.	A	G	10	7	17	0	0	17	0	0
17	35249795	.	T	C	10	0	10	0	6	16	0	0
17	35250060	.	C	A	0	6	6	0	8	14	0	0
17	35250300	.	C	T	6	19	25	0	2	27	0	0
17	35250328	.	G	A	12	14	26	0	0	26	0	0
17	35260787	.	A	G	5	7	12	0	0	12	0	0
17	35261077	.	T	C	5	2	7	0	0	7	0	0
17	35267068	.	A	T	2	0	2	0	0	2	0	0
17	35276147	.	C	G	2	6	8	0	0	8	0	0
17	35278679	.	A	G	4	3	7	0	0	7	0	0
17	35287268	.	C	T	0	2	2	0	1	3	0	0
17	35287600	.	A	G	1	3	4	0	1	5	0	0
17	35315119	.	G	A	1	2	3	0	0	3	0	0
17	35881126	.	G	T	19	13	32	0	1	34	1	0
17	35881148	.	T	C	17	14	31	0	2	33	0	0
17	36588754	.	C	T	2	8	10	0	2	12	0	0
17	36589295	.	C	T	7	9	16	0	1	17	0	0
17	36589435	.	C	A	4	5	9	0	0	9	0	0
17	36589554	.	G	A	3	6	9	0	0	9	0	0
17	36867298	.	C	T	0	8	8	0	16	24	0	0
17	36867355	.	T	C	9	12	21	0	2	23	0	0
17	36867450	.	T	C	9	7	16	0	0	16	0	0
17	36867471	.	G	A	8	10	18	0	5	23	0	0
17	36867558	.	T	C	10	0	10	0	7	17	0	0
17	36867568	.	A	G	7	7	14	0	0	14	0	0
17	36867738	.	T	C	9	1	10	0	12	22	0	0
17	36867915	.	A	G	10	17	27	0	0	27	0	0
17	36867945	.	T	C	2	0	2	0	6	8	0	0
17	36867951	.	A	G	2	6	8	0	0	8	0	0
17	36872564	.	C	T	0	3	3	0	4	7	0	0
17	36884529	.	A	G	7	5	12	0	2	14	0	0
17	36896480	.	C	T	3	1	4	0	0	4	0	0
17	36899746	.	A	T	19	23	42	0	3	45	0	0
17	36899760	.	T	A	19	25	44	0	2	46	0	0
17	36899853	.	T	C	23	23	46	0	1	47	0	0
17	36905905	.	A	G	8	7	15	0	0	15	0	0
17	36905998	.	A	G	23	17	40	0	0	40	0	0
17	36906007	.	G	C	21	0	21	0	19	40	0	0
17	36909904	.	C	T	0	6	6	0	4	10	0	0
17	36911113	.	T	C	1	0	1	0	3	4	0	0
17	36914689	.	C	T	0	3	3	0	6	9	0	0
17	36915353	.	A	G	5	2	7	0	0	7	0	0
17	36929111	.	T	C	8	6	14	0	0	14	0	0
17	36929198	.	C	T	10	5	15	0	2	17	0	0
17	36937975	.	G	A	20	23	43	0	0	43	0	0
17	36938035	.	C	T	22	16	38	0	0	38	0	0
17	36938761	.	T	A	12	19	31	0	0	31	0	0
17	36938819	.	G	A	12	19	31	0	0	31	0	0
17	36938979	.	A	G	6	8	14	0	0	14	0	0
17	36939029	.	A	G	13	9	22	0	0	22	0	0
17	36939064	.	A	G	15	5	20	0	0	20	0	0
17	36939493	.	G	A	7	9	16	0	1	17	0	0
17	36939574	.	A	G	14	5	19	0	0	19	0	0
17	36939698	.	G	C	13	8	21	0	1	22	0	0
17	36939736	.	C	T	12	13	25	0	0	25	0	0
17	36939973	.	T	G	2	4	6	0	0	6	0	0
17	36940074	.	T	C	9	8	17	0	0	17	0	0
17	36940236	.	T	C	3	0	3	0	4	7	0	0
17	36940424	.	C	A	5	6	11	0	0	11	0	0
17	36940451	.	G	A	4	4	8	0	2	10	0	0
17	36940974	.	T	G	1	9	10	0	1	11	0	0
17	36940977	.	T	C	5	9	14	0	1	15	0	0
17	36941065	.	C	T	10	1	11	0	1	12	0	0
17	36941121	.	A	C	12	7	19	0	0	19	0	0
17	36941291	.	C	T	1	4	5	0	8	13	0	0
17	36941352	.	G	A	4	7	11	0	0	11	0	0
17	36941523	.	A	G	3	5	8	0	1	9	0	0
17	36941788	.	G	T	3	6	9	0	1	10	0	0
17	36941812	.	G	A	2	6	8	0	1	9	0	0
17	36947137	.	T	C	1	0	1	0	0	1	0	0
17	36947218	.	G	A	4	1	5	0	1	6	0	0
17	36951602	.	C	A	1	3	4	0	0	4	0	0
17	36956946	.	A	G	3	2	5	0	0	5	0	0
17	36956993	.	C	T	0	3	3	0	3	6	0	0
17	36957029	.	T	C	1	2	3	0	0	3	0	0
17	36962179	.	G	A	2	0	2	0	0	2	0	0
17	36970937	.	T	C	6	3	9	0	0	9	0	0
17	37013465	.	A	G	4	11	15	0	0	15	0	0
17	37070262	.	G	C	7	8	15	0	1	16	0	0
17	37070310	.	G	A	4	3	7	0	0	7	0	0
17	37070497	.	T	C	14	0	14	0	4	18	0	0
17	37070550	.	C	G	1	2	3	0	2	5	0	0
17	37073530	.	G	A	2	6	8	0	0	8	0	0
17	37076276	.	C	A	0	14	14	0	9	23	0	0
17	37086637	.	A	T	5	5	10	0	0	10	0	0
17	37086670	.	C	T	0	8	8	0	9	17	0	0
17	37088514	.	G	A	0	2	2	0	0	2	0	0
17	37134165	.	G	T	6	5	11	0	1	12	0	0
17	37143651	.	A	G	5	9	14	0	0	14	0	0
17	37143669	.	C	G	3	7	10	0	1	11	0	0
17	37156496	.	G	T	7	5	12	0	0	12	0	0
17	37156512	.	T	A	5	3	8	0	1	9	0	0
17	37162624	.	C	T	2	2	4	0	0	4	0	0
17	37162878	.	A	G	1	3	4	0	0	4	0	0
17	37163858	.	A	G	1	4	5	0	0	5	0	0
17	37164035	.	G	A	4	2	6	0	0	6	0	0
17	37164182	.	A	G	2	3	5	0	0	5	0	0
17	37164353	.	G	A	1	3	4	0	0	4	0	0
17	37164354	.	C	T	1	3	4	0	0	4	0	0
17	37164449	.	T	C	2	2	4	0	0	4	0	0
17	37195040	.	G	A	2	3	5	0	0	5	0	0
17	37204273	.	A	C	6	8	14	0	1	15	0	0
17	37204417	.	G	A	19	14	33	0	0	33	0	0
17	37204484	.	T	C	14	1	15	0	19	34	0	0
17	37210305	.	C	T	0	5	5	0	6	11	0	0
17	37212127	.	A	G	8	12	20	0	0	20	0	0
17	37212154	.	T	C	2	5	7	0	0	7	0	0
17	37212485	.	T	A	5	4	9	0	0	9	0	0
17	37212592	.	T	G	11	18	29	0	1	30	0	0
17	37212616	.	G	T	7	17	24	0	2	26	0	0
17	37212634	.	C	T	10	18	28	0	0	28	0	0
17	37212725	.	T	C	16	16	32	0	1	33	0	0
17	37212757	.	T	C	19	17	36	0	0	36	0	0
17	37212832	.	G	A	23	12	35	0	1	36	0	0
17	37213231	.	C	T	10	16	26	0	1	27	0	0
17	37213416	.	G	T	9	4	13	0	0	13	0	0
17	37213677	.	T	C	9	13	22	0	1	23	0	0
17	37213887	.	G	A	11	13	24	0	0	24	0	0
17	37213900	.	C	A	12	9	21	0	1	22	0	0
17	37213928	.	T	C	10	11	21	0	0	21	0	0
17	37213999	.	A	G	11	13	24	0	0	24	0	0
17	37214022	.	C	T	11	7	18	0	0	18	0	0
17	37220566	.	C	A	1	2	3	0	0	3	0	0
17	37220647	.	A	C	3	2	5	0	0	5	0	0
17	37228020	.	C	A	1	0	1	0	0	1	0	0
17	37230939	.	T	C	1	0	1	0	0	1	0	0
17	37231593	.	T	C	0	1	1	0	0	1	0	0
17	37231596	.	T	C	0	1	1	0	0	1	0	0
17	37234489	.	T	C	0	1	1	0	0	1	0	0
17	37237230	.	T	C	2	2	4	0	0	4	0	0
17	37239402	.	T	G	3	3	6	0	0	6	0	0
17	37239981	.	C	T	1	2	3	0	2	5	0	0
17	37240088	.	T	C	0	2	2	0	0	2	0	0
17	37241661	.	A	G	5	10	15	0	0	15	0	0
17	37241676	.	T	G	4	1	5	0	8	13	0	0
17	37241700	.	C	T	3	6	9	0	0	9	0	0
17	37252299	.	T	A	11	6	17	0	0	17	0	0
17	37252352	.	G	A	12	5	17	0	1	18	0	0
17	37252374	.	G	T	0	7	7	0	14	21	0	0
17	37252441	.	A	T	14	7	21	0	2	23	0	0
17	37252716	.	G	A	0	9	9	0	7	16	0	0
17	37253832	.	C	G	2	0	2	0	3	5	0	0
17	37263068	.	T	C	2	2	4	0	0	4	0	0
17	37268036	.	A	G	1	2	3	0	0	3	0	0
17	37268063	.	A	G	3	3	6	0	1	7	0	0
17	37273585	.	C	T	1	2	3	0	0	3	0	0
17	37277915	.	T	C	2	1	3	0	0	3	0	0
17	37280857	.	A	C	2	4	6	0	0	6	0	0
17	37280860	.	A	G	1	3	4	0	2	6	0	0
17	37280950	.	A	T	1	2	3	0	0	3	0	0
17	37280974	.	C	T	2	3	5	0	0	5	0	0
17	37291436	.	C	G	5	3	8	0	0	8	0	0
17	37291447	.	G	A	3	4	7	0	0	7	0	0
17	37291504	.	T	C	0	3	3	0	0	3	0	0
17	37317028	.	T	A	1	4	5	0	1	6	0	0
17	37317165	.	A	G	1	1	2	0	0	2	0	0
17	37317171	.	A	T	1	2	3	0	0	3	0	0
17	37317507	.	T	C	4	4	8	0	0	8	0	0
17	37317636	.	G	A	1	2	3	0	1	4	0	0
17	37317756	.	A	G	8	3	11	0	1	12	0	0
17	37317922	.	G	A	3	3	6	0	0	7	1	0
17	37317945	.	A	G	2	2	4	0	1	5	0	0
17	37318011	.	A	G	1	3	4	0	0	4	0	0
17	37320150	.	C	G	4	9	13	0	0	13	0	0
17	37320153	.	T	C	3	10	13	0	1	14	0	0
17	37323060	.	T	G	4	0	4	0	8	12	0	0
17	37323168	.	G	A	0	6	6	0	5	11	0	0
17	37350660	.	T	C	0	3	3	0	0	3	0	0
17	37350708	.	C	T	6	3	9	0	0	9	0	0
17	37353043	.	T	C	7	6	13	0	0	13	0	0
17	37360975	.	C	G	4	0	4	0	3	7	0	0
17	37361173	.	G	A	4	5	9	0	0	9	0	0
17	37361233	.	C	T	7	6	13	0	1	14	0	0
17	37361349	.	C	T	2	2	4	0	0	4	0	0
17	37361556	.	T	A	3	5	8	0	0	8	0	0
17	37361605	.	G	A	0	4	4	0	4	8	0	0
17	37361669	.	C	T	4	0	4	0	0	4	0	0
17	37362139	.	C	G	5	11	16	0	0	16	0	0
17	37362153	.	G	T	4	10	14	0	1	15	0	0
17	37362181	.	C	T	2	10	12	0	0	12	0	0
17	37362198	.	C	T	2	7	9	0	0	9	0	0
17	37362249	.	G	A	4	2	6	0	0	6	0	0
17	37362258	.	T	A	3	1	4	0	2	6	0	0
17	37362298	.	C	G	3	4	7	0	0	7	0	0
17	37362380	.	C	A	11	3	14	0	0	14	0	0
17	37362574	.	T	A	2	3	5	0	1	6	0	0
17	37362851	.	A	T	1	6	7	0	0	7	0	0
17	37362876	.	T	C	0	9	9	0	0	9	0	0
17	37363309	.	C	G	6	3	9	0	0	9	0	0
17	37363406	.	G	C	3	3	6	0	1	7	0	0
17	37363429	.	T	C	3	1	4	0	0	4	0	0
17	37363802	.	T	A	8	14	22	0	1	23	0	0
17	37363809	.	C	T	4	16	20	0	2	22	0	0
17	37363855	.	T	G	2	6	8	0	0	8	0	0
17	37363857	.	T	C	2	6	8	0	0	8	0	0
17	37363901	.	A	G	2	0	2	0	2	4	0	0
17	37363938	.	A	G	3	0	3	0	4	7	0	0
17	37363959	.	A	T	5	5	10	0	0	10	0	0
17	37364061	.	G	T	13	9	22	0	0	22	0	0
17	37364517	.	C	T	9	5	14	0	0	14	0	0
17	37364533	.	T	C	5	5	10	0	0	10	0	0
17	37364620	.	C	T	11	10	21	0	1	22	0	0
17	37364676	.	A	C	10	10	20	0	2	22	0	0
17	37365020	.	A	G	12	10	22	0	1	23	0	0
17	37385920	.	T	A	2	3	5	0	0	5	0	0
17	37388782	.	G	A	0	1	1	0	0	1	0	0
17	37446789	.	A	C	9	0	9	0	4	13	0	0
17	37446790	.	A	C	10	2	12	0	1	13	0	0
17	37618083	.	T	G	2	10	12	0	3	15	0	0
17	38232000	.	T	C	1	1	2	0	0	2	0	0
17	38263942	.	A	G	0	9	9	0	4	13	0	0
17	38887271	.	T	G	3	3	6	0	0	6	0	0
17	38927932	.	T	C	4	3	7	0	0	7	0	0
17	38928073	.	A	T	4	4	8	0	0	8	0	0
17	38928447	.	T	C	2	0	2	0	6	8	0	0
17	38928775	.	C	T	3	3	6	0	0	6	0	0
17	38928947	.	A	T	5	2	7	0	1	8	0	0
17	38929142	.	T	G	4	5	9	0	1	10	0	0
17	38929437	.	C	T	1	2	3	0	1	4	0	0
17	38931440	.	G	A	4	4	8	0	0	8	0	0
17	38938727	.	G	A	2	1	3	0	0	3	0	0
17	38941286	.	G	A	3	1	4	0	0	4	0	0
17	38946528	.	G	A	2	2	4	0	0	4	0	0
17	39184823	.	T	C	1	2	3	0	0	3	0	0
17	39703380	.	C	A	0	1	1	0	0	1	0	0
17	39717616	.	T	C	2	0	2	0	0	2	0	0
17	39717645	.	A	G	4	0	4	0	1	5	0	0
17	39720791	.	T	C	4	4	8	0	0	8	0	0
17	39728239	.	C	T	6	7	13	0	0	13	0	0
17	39728261	.	G	T	7	10	17	0	0	17	0	0
17	39728423	.	T	A	6	5	11	0	1	12	0	0
17	39729014	.	G	A	9	7	16	0	0	16	0	0
17	39732512	.	C	T	8	4	12	0	0	12	0	0
17	39732573	.	C	A	11	6	17	0	0	17	0	0
17	39732584	.	G	A	7	11	18	0	0	18	0	0
17	39736088	.	T	A	9	7	16	0	0	16	0	0
17	39736103	.	G	A	11	7	18	0	0	18	0	0
17	39736130	.	T	C	10	9	19	0	0	19	0	0
17	39739842	.	A	T	9	10	19	0	0	19	0	0
17	39862536	.	C	G	6	7	13	0	0	13	0	0
17	39863633	.	C	T	1	1	2	0	0	2	0	0
17	40223456	.	G	A	1	3	4	0	0	4	0	0
17	40223457	.	G	A	1	3	4	0	0	4	0	0
17	40887272	.	T	C	1	2	3	0	0	3	0	0
17	40887285	.	G	T	2	1	3	0	0	3	0	0
17	40889613	.	C	A	0	1	1	0	0	1	0	0
17	40889637	.	T	C	0	3	3	0	0	3	0	0
17	40889661	.	T	G	1	3	4	0	0	4	0	0
17	40889697	.	A	G	4	3	7	0	0	7	0	0
17	40900354	.	C	T	2	4	6	0	2	8	0	0
17	40900686	.	T	G	5	5	10	0	0	10	0	0
17	40901439	.	T	C	3	3	6	0	0	6	0	0
17	40901695	.	G	C	9	11	20	0	0	21	1	0
17	40901712	.	C	G	5	13	18	0	1	19	0	0
17	40901752	.	G	A	4	11	15	0	0	15	0	0
17	40901799	.	A	C	3	6	9	0	0	9	0	0
17	40901804	.	A	T	3	4	7	0	1	8	0	0
17	40902005	.	C	A	3	6	9	0	2	11	0	0
17	40902065	.	G	A	4	5	9	0	1	10	0	0
17	40902148	.	G	T	7	8	15	0	2	17	0	0
17	40902180	.	G	C	9	10	19	0	0	19	0	0
17	40902256	.	G	T	2	4	6	0	0	6	0	0
17	40902347	.	C	T	7	5	12	0	0	12	0	0
17	40902348	.	A	G	8	3	11	0	1	12	0	0
17	40902598	.	G	A	8	9	17	0	1	18	0	0
17	40902629	.	A	T	6	7	13	0	1	14	0	0
17	40902657	.	A	C	8	10	18	0	0	18	0	0
17	40902698	.	A	G	11	9	20	0	0	20	0	0
17	40902830	.	A	T	6	8	14	0	2	16	0	0
17	40902932	.	T	C	12	2	14	0	1	15	0	0
17	40903162	.	C	T	7	4	11	0	0	11	0	0
17	40990061	.	T	A	7	11	18	0	0	18	0	0
17	40990097	.	T	A	2	3	5	0	0	5	0	0
17	40999460	.	A	G	11	11	22	0	0	22	0	0
17	40999697	.	C	G	9	5	14	0	1	15	0	0
17	40999700	.	C	A	10	4	14	0	1	15	0	0
17	40999732	.	A	G	4	11	15	0	0	15	0	0
17	41084670	.	T	C	3	2	5	0	0	5	0	0
17	41092465	.	C	T	1	0	1	0	0	1	0	0
17	41121783	.	C	G	1	1	2	0	0	2	0	0
17	41220064	.	T	A	1	0	1	0	0	1	0	0
17	41254741	.	C	T	3	2	5	0	0	5	0	0
17	41264045	.	T	A	3	1	4	0	0	4	0	0
17	41264054	.	G	A	1	3	4	0	0	4	0	0
17	41264165	.	C	A	2	4	6	0	1	7	0	0
17	41314040	.	G	T	0	13	13	0	11	24	0	0
17	41314097	.	T	C	10	10	20	0	0	20	0	0
17	41314471	.	G	A	15	6	21	0	2	23	0	0
17	41314501	.	A	G	5	7	12	0	1	13	0	0
17	41317234	.	A	G	14	1	15	0	15	30	0	0
17	41317494	.	G	A	13	15	28	0	0	28	0	0
17	41317999	.	G	A	15	12	27	0	1	28	0	0
17	41318310	.	A	G	18	11	29	0	1	30	0	0
17	41318392	.	G	A	5	2	7	0	1	8	0	0
17	41368018	.	C	T	1	2	3	0	0	3	0	0
17	41464090	.	G	A	1	3	4	0	4	8	0	0
17	41465504	.	A	C	11	6	17	0	0	17	0	0
17	41475863	.	T	C	9	14	23	0	1	24	0	0
17	41476104	.	T	C	22	1	23	0	17	40	0	0
17	41476161	.	A	G	16	20	36	0	0	36	0	0
17	41476279	.	G	A	20	17	37	0	1	38	0	0
17	41476298	.	T	A	17	15	32	0	2	34	0	0
17	41476393	.	G	T	21	4	25	0	0	25	0	0
17	41476833	.	T	C	3	7	10	0	0	10	0	0
17	41476906	.	A	C	6	0	6	0	7	13	0	0
17	41476917	.	C	T	0	5	5	0	6	11	0	0
17	41476970	.	T	C	8	8	16	0	0	16	0	0
17	41476994	.	G	A	9	7	16	0	0	16	0	0
17	41477007	.	C	T	0	7	7	0	9	16	0	0
17	41477157	.	T	C	7	4	11	0	1	12	0	0
17	41477324	.	G	A	12	6	18	0	1	19	0	0
17	41571328	.	T	A	7	6	13	0	0	13	0	0
17	41583555	.	C	G	0	2	2	0	3	5	0	0
17	41583747	.	G	T	9	9	18	0	1	19	0	0
17	41583768	.	T	C	7	0	7	0	7	14	0	0
17	41583786	.	A	G	5	3	8	0	0	8	0	0
17	41592172	.	A	C	1	0	1	0	0	1	0	0
17	41601633	.	G	A	3	2	5	0	3	8	0	0
17	41602081	.	T	C	1	2	3	0	0	3	0	0
17	41610991	.	G	A	3	1	4	0	0	4	0	0
17	41635632	.	T	C	2	0	2	0	1	3	0	0
17	41635635	.	T	C	2	0	2	0	2	4	0	0
17	41639674	.	A	G	2	0	2	0	0	2	0	0
17	41639675	.	G	A	2	0	2	0	0	2	0	0
17	41667069	.	G	A	3	6	9	0	0	9	0	0
17	41667109	.	C	T	0	3	3	0	2	5	0	0
17	41673488	.	C	T	2	0	2	0	0	2	0	0
17	41994768	.	G	T	2	3	5	0	0	5	0	0
17	41994868	.	A	G	0	0	0	0	2	2	0	0
17	42003872	.	C	T	3	2	5	0	0	5	0	0
17	42027915	.	C	T	4	3	7	0	0	7	0	0
17	42095539	.	A	T	4	5	9	0	0	9	0	0
17	42095602	.	A	G	5	3	8	0	0	8	0	0
17	42095620	.	C	T	4	3	7	0	0	7	0	0
17	42566360	.	A	T	1	2	3	0	1	4	0	0
17	42566385	.	G	A	2	2	4	0	0	4	0	0
17	42871419	.	G	T	8	8	16	0	1	17	0	0
17	43013675	.	G	A	10	4	14	0	0	14	0	0
17	43017672	.	C	T	13	14	27	0	1	28	0	0
17	43017687	.	G	A	14	14	28	0	2	30	0	0
17	43017830	.	A	G	12	7	19	0	0	19	0	0
17	43017863	.	A	C	14	8	22	0	0	22	0	0
17	43018037	.	G	A	1	16	17	0	10	27	0	0
17	43018124	.	A	G	15	1	16	0	4	20	0	0
17	43018273	.	G	A	17	21	38	0	4	42	0	0
17	43018382	.	T	G	16	17	33	0	0	34	1	0
17	43018502	.	T	A	30	20	50	0	0	50	0	0
17	43018549	.	C	G	18	19	37	0	1	38	0	0
17	43018638	.	A	T	16	21	37	0	0	37	0	0
17	43018815	.	A	G	17	11	28	0	5	33	0	0
17	43018899	.	T	A	25	8	33	0	0	33	0	0
17	43030696	.	T	C	6	5	11	0	1	12	0	0
17	43030737	.	T	G	8	13	21	0	0	21	0	0
17	43030828	.	G	A	7	9	16	2	0	18	0	0
17	43031495	.	G	A	3	4	7	0	2	9	0	0
17	43033177	.	G	A	6	10	16	0	0	16	0	0
17	43035798	.	T	C	15	20	35	0	4	39	0	0
17	43035958	.	A	G	14	5	19	0	1	20	0	0
17	43035964	.	A	G	18	4	22	0	1	23	0	0
17	43035996	.	G	T	10	17	27	0	1	28	0	0
17	43036025	.	A	G	13	16	29	0	1	30	0	0
17	43036055	.	T	C	6	22	28	0	0	28	0	0
17	43040422	.	T	A	2	5	7	0	0	7	0	0
17	43082871	.	G	A	1	0	1	0	0	1	0	0
17	43082976	.	A	T	4	5	9	0	2	11	0	0
17	43146508	.	C	T	1	3	4	0	1	5	0	0
17	43146607	.	G	C	1	3	4	0	0	4	0	0
17	43165321	.	A	G	2	1	3	0	1	4	0	0
17	43286920	.	C	T	1	2	3	0	1	4	0	0
17	43297946	.	G	C	15	13	28	0	0	28	0	0
17	43298011	.	G	A	4	15	19	0	2	21	0	0
17	43298068	.	G	A	9	17	26	0	2	28	0	0
17	43302492	.	G	A	11	10	21	0	0	21	0	0
17	43309095	.	A	G	9	6	15	0	2	17	0	0
17	43309164	.	C	T	0	3	3	0	2	5	0	0
17	43315085	.	C	T	1	3	4	0	1	5	0	0
17	43348986	.	T	C	5	3	8	0	0	8	0	0
17	43391434	.	G	T	5	5	10	0	0	10	0	0
17	43391442	.	C	T	5	5	10	0	0	10	0	0
17	43436782	.	T	C	16	1	17	0	18	35	0	0
17	43437305	.	G	C	12	11	23	0	0	23	0	0
17	43437365	.	C	G	1	5	6	0	1	7	0	0
17	43439720	.	G	T	14	16	30	0	2	32	0	0
17	43441575	.	A	T	0	1	1	0	1	2	0	0
17	43453507	.	T	C	7	5	12	0	0	12	0	0
17	43453531	.	G	A	10	10	20	0	0	20	0	0
17	43456825	.	C	T	5	11	16	0	1	17	0	0
17	43456900	.	G	A	4	7	11	0	1	12	0	0
17	43461181	.	G	A	5	2	7	0	0	7	0	0
17	43469515	.	G	T	2	3	5	0	0	5	0	0
17	43473913	.	T	C	5	4	9	0	0	9	0	0
17	43475562	.	T	C	7	19	26	0	0	26	0	0
17	43475577	.	G	A	0	18	18	0	5	23	0	0
17	43475619	.	A	G	5	0	5	0	17	22	0	0
17	43475691	.	T	A	2	5	7	0	0	7	0	0
17	43476137	.	T	A	7	6	13	0	1	14	0	0
17	43476232	.	A	G	4	4	8	0	0	8	0	0
17	43476241	.	A	G	3	2	5	0	0	5	0	0
17	43491218	.	T	C	0	1	1	0	0	1	0	0
17	43494942	.	A	G	1	1	2	0	1	3	0	0
17	43497376	.	A	G	2	9	11	0	0	11	0	0
17	43513318	.	C	T	0	7	7	0	1	8	0	0
17	43516451	.	T	A	4	1	5	0	0	5	0	0
17	43516464	.	T	A	4	2	6	0	0	6	0	0
17	43516502	.	G	T	4	7	11	0	1	12	0	0
17	43516506	.	A	C	4	9	13	0	1	14	0	0
17	43516548	.	A	G	3	9	12	0	0	12	0	0
17	43522782	.	T	C	1	0	1	0	3	4	0	0
17	43524233	.	T	C	2	2	4	0	0	4	0	0
17	43524245	.	T	G	2	3	5	0	0	5	0	0
17	43525600	.	C	G	2	1	3	0	0	3	0	0
17	43538081	.	G	A	4	5	9	0	1	10	0	0
17	43538097	.	C	T	3	6	9	0	0	9	0	0
17	43538209	.	C	T	2	7	9	0	1	10	0	0
17	43547945	.	A	G	2	2	4	0	0	4	0	0
17	43623955	.	G	T	0	2	2	0	1	3	0	0
17	43629055	.	G	C	1	2	3	0	0	3	0	0
17	43629092	.	A	G	2	0	2	0	2	4	0	0
17	43629418	.	G	A	0	2	2	0	1	3	0	0
17	43629422	.	G	C	0	1	1	0	1	2	0	0
17	43629604	.	T	C	1	2	3	0	0	3	0	0
17	43632931	.	G	T	1	2	3	0	0	3	0	0
17	43659950	.	T	G	2	4	6	0	0	6	0	0
17	43660168	.	C	T	5	9	14	0	1	15	0	0
17	43660232	.	G	A	8	9	17	0	3	20	0	0
17	43660779	.	T	C	13	5	18	0	1	19	0	0
17	43661176	.	C	G	6	7	13	0	0	13	0	0
17	43661223	.	G	T	7	5	12	0	0	12	0	0
17	43661291	.	G	T	5	3	8	0	2	10	0	0
17	43661293	.	A	T	6	3	9	0	1	10	0	0
17	43661578	.	A	G	8	1	9	0	0	9	0	0
17	43661618	.	T	A	10	6	16	0	0	16	0	0
17	43663611	.	T	G	6	5	11	0	0	11	0	0
17	43664128	.	G	C	10	26	36	0	1	37	0	0
17	43664176	.	C	A	2	14	16	0	17	33	0	0
17	43664605	.	G	A	20	7	27	0	2	29	0	0
17	43664828	.	G	T	1	2	3	0	0	3	0	0
17	43708608	.	C	T	6	5	11	0	1	12	0	0
17	43711502	.	G	A	2	4	6	0	0	6	0	0
17	43843686	.	A	T	1	2	3	0	0	3	0	0
17	43850878	.	A	T	12	5	17	0	2	19	0	0
17	43853767	.	A	T	3	6	9	0	1	10	0	0
17	43853778	.	C	T	0	3	3	0	6	9	0	0
17	43854010	.	T	G	7	6	13	0	0	13	0	0
17	43856232	.	T	C	1	2	3	0	0	3	0	0
17	43859306	.	A	T	7	3	10	0	2	12	0	0
17	43859378	.	C	T	9	5	14	0	0	14	0	0
17	43859387	.	C	T	8	6	14	0	0	14	0	0
17	43863540	.	C	A	5	10	15	0	0	15	0	0
17	43926650	.	C	A	1	0	1	0	0	1	0	0
17	43951792	.	A	C	2	6	8	0	0	8	0	0
17	43951834	.	G	A	5	5	10	0	1	11	0	0
17	43954926	.	A	C	1	3	4	0	0	4	0	0
17	43955964	.	G	A	0	2	2	0	1	3	0	0
17	43959078	.	A	G	2	0	2	0	2	4	0	0
17	43959098	.	A	G	7	0	7	0	4	11	0	0
17	43959594	.	A	G	1	0	1	0	0	1	0	0
17	43961801	.	T	C	2	3	5	0	0	5	0	0
17	43968686	.	A	G	0	1	1	0	0	1	0	0
17	43976947	.	C	A	2	0	2	0	0	2	0	0
17	43977416	.	G	A	4	1	5	0	0	5	0	0
17	43977433	.	T	G	5	2	7	0	1	8	0	0
17	43985045	.	G	A	3	1	4	0	0	4	0	0
17	43985075	.	C	T	7	3	10	0	0	10	0	0
17	43986863	.	C	T	3	2	5	0	1	6	0	0
17	43996483	.	G	A	5	2	7	0	0	7	0	0
17	43996485	.	G	A	5	2	7	0	0	7	0	0
17	43996620	.	A	T	2	0	2	0	0	2	0	0
17	43996667	.	G	A	4	3	7	0	0	7	0	0
17	44001833	.	T	C	10	17	27	0	0	27	0	0
17	44001880	.	T	A	11	16	27	0	3	30	0	0
17	44002000	.	C	G	9	2	11	0	15	26	0	0
17	44006924	.	G	C	1	4	5	0	0	5	0	0
17	44006927	.	G	A	1	4	5	0	0	5	0	0
17	44007047	.	A	T	2	2	4	0	0	4	0	0
17	44007314	.	G	C	1	0	1	0	1	2	0	0
17	44079258	.	G	A	0	2	2	0	2	4	0	0
17	44079925	.	G	C	1	2	3	0	0	3	0	0
17	44080212	.	G	A	3	2	5	0	0	5	0	0
17	44080227	.	C	T	4	2	6	0	0	6	0	0
17	44245452	.	T	C	21	13	34	0	0	34	0	0
17	44247495	.	G	A	12	15	27	0	2	29	0	0
17	44249428	.	T	G	3	3	6	0	0	6	0	0
17	44252640	.	T	A	6	6	12	0	0	12	0	0
17	44923481	.	C	G	0	2	2	0	1	3	0	0
17	45138508	.	T	C	5	2	7	0	1	8	0	0
17	45138733	.	T	C	23	6	29	0	1	30	0	0
17	45138741	.	T	C	21	8	29	0	3	32	0	0
17	48127320	.	A	C	2	2	4	0	1	5	0	0
17	48139415	.	C	T	4	2	6	0	0	6	0	0
17	48156580	.	C	T	1	4	5	0	0	5	0	0
17	48156631	.	G	A	4	6	10	0	0	10	0	0
17	48867263	.	A	T	0	2	2	0	1	3	0	0
17	48867269	.	A	G	1	0	1	0	3	4	0	0
17	48867434	.	T	C	1	2	3	0	0	3	0	0
17	48867458	.	T	A	1	3	4	0	0	4	0	0
17	48906437	.	G	C	6	6	12	0	1	13	0	0
17	48908803	.	C	T	0	5	5	0	3	8	0	0
17	48911097	.	T	G	5	3	8	0	0	8	0	0
17	48915349	.	T	C	3	1	4	0	1	5	0	0
17	48915387	.	A	T	2	2	4	0	0	4	0	0
17	48922291	.	A	G	2	2	4	0	1	5	0	0
17	48928906	.	G	A	0	1	1	0	0	1	0	0
17	49003651	.	A	G	0	5	5	0	0	5	0	0
17	49010727	.	T	C	3	2	5	0	0	5	0	0
17	49014663	.	G	T	0	3	3	0	2	5	0	0
17	49018023	.	G	A	0	7	7	0	14	21	0	0
17	49018107	.	C	T	9	15	24	0	0	24	0	0
17	49018113	.	A	T	9	15	24	0	1	25	0	0
17	49018164	.	A	C	12	13	25	0	1	26	0	0
17	49018508	.	C	G	7	13	20	0	1	21	0	0
17	49018899	.	C	T	11	13	24	0	2	26	0	0
17	49018935	.	A	C	14	15	29	0	1	30	0	0
17	49019101	.	T	C	14	17	31	0	1	32	0	0
17	49019288	.	A	C	14	16	30	0	0	30	0	0
17	49019299	.	A	T	8	13	21	0	6	27	0	0
17	49019380	.	G	A	0	4	4	0	9	13	0	0
17	49153896	.	T	A	0	1	1	0	0	1	0	0
17	49153916	.	A	G	0	1	1	0	0	1	0	0
17	49208766	.	C	T	1	0	1	0	0	1	0	0
17	49208775	.	A	T	1	1	2	0	0	2	0	0
17	49212630	.	G	C	0	4	4	0	3	7	0	0
17	49217106	.	T	A	9	5	14	0	0	14	0	0
17	49217209	.	G	A	0	4	4	0	7	11	0	0
17	49217466	.	T	C	5	3	8	0	1	9	0	0
17	49217507	.	C	T	3	5	8	0	0	8	0	0
17	49217577	.	C	T	5	6	11	0	0	11	0	0
17	49217658	.	G	T	9	2	11	0	0	11	0	0
17	49217703	.	C	A	3	10	13	0	1	14	0	0
17	49217887	.	A	G	4	1	5	0	1	6	0	0
17	49217983	.	G	T	4	1	5	0	1	6	0	0
17	49306423	.	C	A	3	2	5	0	0	5	0	0
17	49306425	.	C	T	3	2	5	0	0	5	0	0
17	49326075	.	A	G	1	2	3	0	0	3	0	0
17	49416327	.	T	C	14	6	20	0	0	20	0	0
17	49416396	.	G	T	10	10	20	0	1	21	0	0
17	49418225	.	G	A	5	8	13	0	0	13	0	0
17	49418765	.	G	A	2	5	7	0	0	7	0	0
17	49418792	.	C	T	3	5	8	0	0	8	0	0
17	49419182	.	T	A	4	3	7	0	0	7	0	0
17	49419188	.	C	T	5	2	7	0	0	7	0	0
17	49419590	.	T	C	3	3	6	0	0	6	0	0
17	49419761	.	G	T	7	5	12	0	0	12	0	0
17	49419887	.	C	T	0	4	4	0	2	6	0	0
17	49419954	.	C	T	3	2	5	0	0	5	0	0
17	49420049	.	T	G	3	4	7	0	1	8	0	0
17	49420454	.	A	T	2	4	6	0	0	6	0	0
17	49420565	.	A	C	2	0	2	0	3	5	0	0
17	49481635	.	C	G	2	1	3	0	0	3	0	0
17	49481638	.	T	C	1	0	1	0	2	3	0	0
17	49503569	.	G	T	0	1	1	0	0	1	0	0
17	49503632	.	G	A	5	4	9	0	0	9	0	0
17	49503647	.	C	T	7	3	10	0	0	10	0	0
17	49503940	.	G	A	1	6	7	0	0	7	0	0
17	49507155	.	C	T	2	4	6	0	0	6	0	0
17	49509606	.	G	A	1	3	4	0	0	4	0	0
17	49518977	.	C	T	1	4	5	0	0	5	0	0
17	49519061	.	C	T	2	2	4	0	0	4	0	0
17	49519070	.	T	A	2	1	3	0	0	3	0	0
17	49522248	.	G	A	0	2	2	0	2	4	0	0
17	49526584	.	T	C	4	2	6	0	1	7	0	0
17	49526839	.	A	G	3	6	9	0	0	9	0	0
17	49527099	.	T	G	10	1	11	0	0	12	1	0
17	49527115	.	T	C	8	2	10	0	1	11	0	0
17	49527627	.	A	G	2	2	4	0	0	4	0	0
17	49528082	.	C	G	11	10	21	0	3	24	0	0
17	49528291	.	A	G	15	0	15	0	10	25	0	0
17	49631878	.	A	T	4	5	9	0	0	9	0	0
17	49631901	.	G	C	4	3	7	0	0	7	0	0
17	49632191	.	A	G	1	3	4	0	1	5	0	0
17	49632267	.	A	C	1	0	1	0	7	8	0	0
17	49632368	.	G	T	8	3	11	0	0	11	0	0
17	49632492	.	A	G	5	3	8	0	0	8	0	0
17	49635656	.	C	T	2	5	7	0	0	7	0	0
17	49635693	.	G	A	4	5	9	0	0	9	0	0
17	49635701	.	G	A	3	4	7	0	1	8	0	0
17	49635749	.	C	G	2	5	7	0	0	7	0	0
17	49635881	.	A	T	0	1	1	0	0	1	0	0
17	49636959	.	T	C	2	2	4	0	0	4	0	0
17	49640903	.	A	G	6	5	11	0	0	11	0	0
17	49640938	.	A	T	4	4	8	0	0	8	0	0
17	49641046	.	C	A	3	3	6	0	0	6	0	0
17	49641136	.	A	G	1	1	2	0	0	2	0	0
17	49642200	.	T	C	1	2	3	0	2	5	0	0
17	49785789	.	A	G	2	4	6	0	0	6	0	0
17	49785930	.	G	T	1	5	6	0	0	6	0	0
17	49983202	.	A	T	9	7	16	0	0	16	0	0
17	49983273	.	C	T	14	26	40	0	0	40	0	0
17	49987618	.	A	T	3	11	14	0	1	15	0	0
17	49992629	.	G	A	8	6	14	0	2	16	0	0
17	49998167	.	C	T	12	12	24	0	1	25	0	0
17	49998221	.	G	A	15	15	30	0	1	31	0	0
17	49998591	.	T	G	10	4	14	0	0	14	0	0
17	49998804	.	C	A	21	19	40	0	1	41	0	0
17	49998995	.	G	C	26	0	26	0	14	40	0	0
17	49999037	.	G	T	14	22	36	0	1	37	0	0
17	50002381	.	A	G	17	27	44	0	1	45	0	0
17	50010011	.	A	G	13	10	23	0	1	24	0	0
17	50010024	.	G	C	14	13	27	0	0	27	0	0
17	50097129	.	G	A	2	1	3	0	0	3	0	0
17	50097168	.	G	A	4	4	8	0	0	8	0	0
17	50110192	.	C	A	2	5	7	0	0	7	0	0
17	50110255	.	G	C	3	2	5	0	0	5	0	0
17	50110304	.	T	A	2	5	7	0	0	7	0	0
17	50110442	.	C	T	3	3	6	0	0	6	0	0
17	50110517	.	G	A	0	2	2	0	4	6	0	0
17	50110574	.	A	G	2	1	3	0	1	4	0	0
17	50110862	.	T	A	1	5	6	0	0	6	0	0
17	50110893	.	G	A	4	2	6	0	0	6	0	0
17	50111310	.	T	A	2	3	5	0	0	5	0	0
17	50111318	.	T	C	3	2	5	0	0	5	0	0
17	50111397	.	A	G	4	2	6	0	1	7	0	0
17	50111528	.	A	G	4	4	8	0	1	9	0	0
17	50111549	.	A	G	5	8	13	0	0	13	0	0
17	50111718	.	T	G	5	5	10	0	0	10	0	0
17	50112054	.	T	A	5	2	7	0	0	7	0	0
17	50112097	.	A	G	1	3	4	0	0	4	0	0
17	50112112	.	T	G	2	2	4	0	0	4	0	0
17	50113141	.	G	A	7	11	18	0	1	19	0	0
17	50113336	.	C	T	6	4	10	0	0	10	0	0
17	50141766	.	T	A	5	3	8	0	0	8	0	0
17	50171937	.	T	C	3	0	3	0	0	3	0	0
17	50176061	.	G	A	0	4	4	0	0	4	0	0
17	50176139	.	T	C	4	8	12	0	0	12	0	0
17	50176519	.	C	A	3	2	5	0	0	5	0	0
17	50178553	.	G	C	2	3	5	0	0	5	0	0
17	50180672	.	C	T	2	0	2	0	0	2	0	0
17	50185659	.	C	A	13	18	31	0	0	31	0	0
17	50185665	.	T	A	20	12	32	0	2	34	0	0
17	50185831	.	C	A	10	10	20	0	2	22	0	0
17	50185930	.	T	C	12	11	23	0	0	23	0	0
17	50186011	.	G	A	0	11	11	0	12	23	0	0
17	50186041	.	T	A	7	7	14	0	0	14	0	0
17	50186097	.	G	A	6	3	9	0	0	9	0	0
17	50186146	.	T	G	5	0	5	0	1	6	0	0
17	50186151	.	G	T	4	4	8	0	0	8	0	0
17	50229337	.	A	G	19	8	27	0	1	28	0	0
17	50233858	.	C	A	0	3	3	0	7	10	0	0
17	50233869	.	G	T	3	9	12	0	0	12	0	0
17	50245400	.	G	A	2	10	12	0	0	12	0	0
17	50245673	.	T	C	25	13	38	0	1	39	0	0
17	50245715	.	C	G	10	29	39	0	1	40	0	0
17	50247886	.	T	C	1	0	1	0	0	1	0	0
17	50278884	.	C	A	1	0	1	0	0	1	0	0
17	50284899	.	T	A	16	11	27	0	0	27	0	0
17	50284935	.	A	T	15	10	25	0	2	27	0	0
17	50285009	.	A	T	7	7	14	0	1	15	0	0
17	50285221	.	A	T	11	4	15	0	0	15	0	0
17	50417613	.	T	C	0	3	3	0	0	3	0	0
17	50840514	.	A	G	1	3	4	0	0	4	0	0
17	51201948	.	G	A	1	2	3	0	0	3	0	0
17	51206396	.	G	A	9	18	27	0	0	27	0	0
17	51206825	.	T	C	10	0	10	0	18	28	0	0
17	51206951	.	T	A	8	15	23	0	1	24	0	0
17	51207200	.	G	C	12	10	22	0	1	23	0	0
17	51209442	.	G	A	4	5	9	0	0	9	0	0
17	51213963	.	C	T	3	1	4	0	0	4	0	0
17	51218418	.	G	A	3	4	7	0	0	7	0	0
17	51226879	.	C	T	2	6	8	0	0	8	0	0
17	51228936	.	G	A	3	3	6	0	0	6	0	0
17	51229009	.	G	T	2	3	5	0	0	5	0	0
17	51229206	.	C	T	3	2	5	0	0	5	0	0
17	51229397	.	C	A	4	3	7	0	0	7	0	0
17	51229413	.	T	C	2	4	6	0	1	7	0	0
17	51229451	.	A	G	3	4	7	0	0	7	0	0
17	51229725	.	C	T	0	2	2	0	1	3	0	0
17	51231538	.	T	C	9	8	17	0	0	17	0	0
17	51231629	.	T	C	9	8	17	0	1	18	0	0
17	51231633	.	T	C	11	6	17	0	2	19	0	0
17	51231980	.	T	C	5	8	13	0	0	14	1	0
17	51232061	.	T	C	5	3	8	0	2	10	0	0
17	51232107	.	T	C	2	3	5	0	0	5	0	0
17	51232188	.	T	C	2	3	5	0	0	5	0	0
17	51232193	.	T	C	0	3	3	0	1	4	0	0
17	51232329	.	C	T	3	3	6	0	2	8	0	0
17	51232360	.	C	A	3	4	7	0	0	7	0	0
17	51232759	.	C	T	0	14	14	0	15	29	0	0
17	51234540	.	A	C	2	0	2	0	1	3	0	0
17	51241185	.	G	A	0	5	5	0	0	5	0	0
17	51241203	.	C	T	0	6	6	0	0	6	0	0
17	51253952	.	A	G	0	1	1	0	0	1	0	0
17	51256927	.	C	T	0	4	4	0	2	6	0	0
17	51256933	.	C	G	2	5	7	0	0	7	0	0
17	51257013	.	A	G	3	2	5	0	0	5	0	0
17	51260362	.	G	C	2	3	5	0	0	5	0	0
17	51303112	.	C	T	4	7	11	0	1	12	0	0
17	51303130	.	G	A	1	9	10	0	5	15	0	0
17	51303241	.	G	A	4	2	6	0	0	6	0	0
17	51305422	.	A	T	12	13	25	0	0	25	0	0
17	51305458	.	G	C	5	12	17	0	1	18	0	0
17	51307706	.	G	A	13	7	20	0	2	22	0	0
17	51307871	.	A	G	10	0	10	0	7	17	0	0
17	51313948	.	C	T	2	1	3	0	0	3	0	0
17	51313965	.	A	T	1	3	4	0	0	4	0	0
17	51314002	.	G	C	3	2	5	0	0	5	0	0
17	51708541	.	G	A	0	1	1	0	2	3	0	0
17	51711040	.	A	G	4	4	8	0	0	8	0	0
17	51711184	.	C	A	5	5	10	0	0	10	0	0
17	51711194	.	C	A	5	6	11	0	0	11	0	0
17	51720038	.	A	C	1	5	6	0	0	6	0	0
17	51720176	.	C	T	3	4	7	0	0	7	0	0
17	51720177	.	A	T	3	3	6	0	1	7	0	0
17	51720615	.	T	C	1	7	8	0	0	8	0	0
17	51720710	.	A	G	1	0	1	0	4	5	0	0
17	51743916	.	A	G	1	4	5	0	1	6	0	0
17	51749051	.	G	T	2	0	2	0	0	2	0	0
17	51749545	.	G	T	0	9	9	0	4	13	0	0
17	51752790	.	A	G	3	13	16	0	0	16	0	0
17	51753138	.	T	G	2	3	5	0	0	5	0	0
17	51757010	.	G	A	7	5	12	0	2	14	0	0
17	51757380	.	T	G	6	5	11	0	0	11	0	0
17	51757387	.	A	T	3	5	8	0	2	10	0	0
17	51784141	.	G	A	1	2	3	0	0	3	0	0
17	51788735	.	C	T	1	0	1	0	0	1	0	0
17	51788754	.	G	A	0	0	0	0	1	1	0	0
17	51789032	.	G	A	0	3	3	0	0	3	0	0
17	51789038	.	T	C	0	2	2	0	0	2	0	0
17	51789426	.	G	T	3	2	5	0	0	5	0	0
17	51796837	.	A	G	3	3	6	0	0	6	0	0
17	51796843	.	A	T	3	3	6	0	1	7	0	0
17	51796888	.	G	A	2	4	6	0	0	6	0	0
17	51797004	.	G	A	8	8	16	0	0	16	0	0
17	51797015	.	T	C	9	0	9	0	9	18	0	0
17	51797145	.	A	G	3	4	7	0	0	7	0	0
17	51797223	.	G	A	4	3	7	0	1	8	0	0
17	51797333	.	A	G	3	5	8	0	1	9	0	0
17	51797531	.	T	G	5	4	9	0	0	9	0	0
17	51797782	.	C	T	9	0	9	0	5	14	0	0
17	51797788	.	T	A	7	3	10	0	3	13	0	0
17	51797863	.	G	A	6	10	16	0	2	18	0	0
17	51804037	.	G	A	1	1	2	0	0	2	0	0
17	51807494	.	G	A	0	2	2	0	0	2	0	0
17	51807539	.	T	A	2	3	5	0	1	6	0	0
17	51807545	.	G	A	2	5	7	0	0	7	0	0
17	51808019	.	A	C	1	4	5	0	0	5	0	0
17	51822481	.	G	A	4	4	8	0	0	8	0	0
17	51823152	.	A	G	7	7	14	0	1	15	0	0
17	51823841	.	C	A	4	9	13	0	0	13	0	0
17	51823989	.	G	T	5	2	7	0	0	7	0	0
17	51823995	.	A	T	2	5	7	0	0	7	0	0
17	51824490	.	T	C	2	4	6	0	0	6	0	0
17	51824790	.	T	C	3	7	10	0	0	10	0	0
17	51825059	.	A	T	4	3	7	0	0	7	0	0
17	51825086	.	A	G	4	2	6	0	1	7	0	0
17	51825094	.	G	A	3	4	7	0	0	7	0	0
17	51825138	.	C	T	0	5	5	0	8	13	0	0
17	51825161	.	T	C	4	8	12	0	0	12	0	0
17	51825205	.	T	G	4	7	11	0	0	11	0	0
17	51825225	.	T	C	6	3	9	0	2	11	0	0
17	51825421	.	T	G	2	2	4	0	1	5	0	0
17	51825455	.	A	G	6	4	10	0	0	10	0	0
17	51825576	.	A	C	7	0	7	0	5	12	0	0
17	51825969	.	A	T	6	7	13	0	3	16	0	0
17	51826025	.	G	T	4	3	7	0	0	7	0	0
17	51826062	.	G	T	3	3	6	0	4	10	0	0
17	51826088	.	A	G	8	6	14	0	1	15	0	0
17	51826149	.	A	C	5	1	6	0	10	16	0	0
17	51826172	.	T	C	3	0	3	0	10	13	0	0
17	51826236	.	T	C	1	1	2	0	0	2	0	0
17	51832999	.	G	A	2	3	5	0	0	5	0	0
17	52063172	.	T	C	3	3	6	0	0	6	0	0
17	52315261	.	G	A	1	4	5	0	0	5	0	0
17	52359040	.	G	T	0	2	2	0	1	3	0	0
17	52359082	.	G	A	0	2	2	0	1	3	0	0
17	52385553	.	G	A	0	3	3	0	1	4	0	0
17	52386018	.	A	G	3	0	3	0	3	6	0	0
17	52840328	.	A	C	10	19	29	0	1	30	0	0
17	52856614	.	T	C	8	16	24	0	2	26	0	0
17	52919954	.	C	T	22	27	49	0	5	54	0	0
17	52920291	.	A	T	21	26	47	0	3	50	0	0
17	52920588	.	A	G	20	1	21	0	24	45	0	0
17	52921051	.	A	G	5	0	5	0	8	13	0	0
17	52941056	.	G	A	3	2	5	0	0	5	0	0
17	52941063	.	C	A	2	2	4	0	1	5	0	0
17	52941178	.	T	C	3	2	5	0	0	5	0	0
17	53364109	.	T	C	1	3	4	0	0	4	0	0
17	53364111	.	T	C	1	3	4	0	0	4	0	0
18	1689	.	A	C	14	12	26	0	0	26	0	0
18	1983	.	T	C	5	2	7	0	1	8	0	0
18	2725	.	G	A	13	5	18	0	1	19	0	0
18	17639	.	G	A	6	2	8	0	0	8	0	0
18	17786	.	G	A	4	4	8	0	0	8	0	0
18	17795	.	G	A	6	4	10	0	0	10	0	0
18	18606	.	T	A	2	2	4	0	0	4	0	0
18	22746	.	A	G	4	8	12	0	0	12	0	0
18	22891	.	G	A	1	1	2	0	0	2	0	0
18	73394	.	C	G	0	2	2	0	0	2	0	0
18	73410	.	A	T	1	2	3	0	0	3	0	0
18	73584	.	G	A	17	5	22	0	0	22	0	0
18	73714	.	C	G	12	4	16	0	0	16	0	0
18	74788	.	C	T	1	8	9	0	7	16	0	0
18	74866	.	C	T	10	6	16	0	0	16	0	0
18	74994	.	A	G	5	7	12	0	0	12	0	0
18	81944	.	A	T	1	2	3	0	1	4	0	0
18	82705	.	C	T	12	15	27	0	0	27	0	0
18	97588	.	C	T	1	0	1	0	0	1	0	0
18	97762	.	G	A	1	6	7	0	0	7	0	0
18	97789	.	C	T	0	2	2	0	1	3	0	0
18	98622	.	G	A	3	2	5	0	1	6	0	0
18	100483	.	A	G	5	0	5	0	17	22	0	0
18	100493	.	T	G	8	0	8	0	12	20	0	0
18	100944	.	G	A	0	6	6	0	7	13	0	0
18	102350	.	T	G	8	1	9	0	8	17	0	0
18	102353	.	A	G	9	8	17	0	0	17	0	0
18	104405	.	G	A	0	2	2	0	4	6	0	0
18	106814	.	T	C	5	14	19	0	6	25	0	0
18	107015	.	T	C	8	12	20	0	1	21	0	0
18	107135	.	A	T	11	12	23	0	0	23	0	0
18	107345	.	A	G	18	0	18	0	28	46	0	0
18	114089	.	A	C	11	10	21	0	1	22	0	0
18	114502	.	T	C	3	0	3	0	7	10	0	0
18	114713	.	A	T	6	4	10	0	0	10	0	0
18	117788	.	G	A	2	10	12	0	0	12	0	0
18	118729	.	G	A	11	5	16	0	0	16	0	0
18	118912	.	G	A	3	3	6	0	0	6	0	0
18	127438	.	G	A	4	3	7	0	0	7	0	0
18	127444	.	A	G	5	4	9	0	0	9	0	0
18	127513	.	A	G	3	5	8	0	0	8	0	0
18	127678	.	A	G	4	3	7	0	0	7	0	0
18	131065	.	T	C	3	0	3	0	5	8	0	0
18	131092	.	C	T	0	6	6	0	6	12	0	0
18	137781	.	A	G	1	1	2	0	0	2	0	0
18	144447	.	G	A	4	4	8	0	0	8	0	0
18	146940	.	C	A	0	3	3	0	0	3	0	0
18	173660	.	C	T	6	12	18	0	0	18	0	0
18	173694	.	C	T	6	14	20	0	1	21	0	0
18	173903	.	C	A	10	10	20	0	1	21	0	0
18	184917	.	T	C	4	5	9	0	0	9	0	0
18	193689	.	A	C	11	6	17	0	0	17	0	0
18	193982	.	C	T	14	10	24	0	2	26	0	0
18	194006	.	A	G	12	0	12	0	16	28	0	0
18	194078	.	C	T	18	18	36	0	1	37	0	0
18	194162	.	G	C	2	20	22	0	20	42	0	0
18	194318	.	A	G	9	8	17	0	3	20	0	0
18	194460	.	C	G	6	6	12	0	0	12	0	0
18	194464	.	C	T	5	7	12	0	0	12	0	0
18	194799	.	T	C	5	11	16	0	1	17	0	0
18	204678	.	A	C	8	5	13	0	0	13	0	0
18	204742	.	G	A	12	12	24	0	1	25	0	0
18	204828	.	G	A	21	8	29	0	0	29	0	0
18	204866	.	T	A	18	13	31	0	7	38	0	0
18	204980	.	C	T	23	16	39	0	3	42	0	0
18	204982	.	G	A	24	14	38	0	4	42	0	0
18	205095	.	C	T	0	27	27	0	15	42	0	0
18	205105	.	A	G	12	25	37	0	5	42	0	0
18	205152	.	G	A	25	12	37	0	0	37	0	0
18	205179	.	G	A	20	20	40	0	2	42	0	0
18	207172	.	T	C	4	4	8	0	1	9	0	0
18	207184	.	G	A	3	8	11	0	1	12	0	0
18	207314	.	T	A	1	1	2	0	0	2	0	0
18	209114	.	G	A	16	13	29	0	0	29	0	0
18	209118	.	A	G	15	13	28	0	1	29	0	0
18	209321	.	T	G	1	1	2	0	0	2	0	0
18	209382	.	A	G	2	6	8	0	0	8	0	0
18	210385	.	T	A	15	16	31	0	2	33	0	0
18	211101	.	G	A	13	6	19	0	2	21	0	0
18	211186	.	T	A	13	19	32	0	4	36	0	0
18	211346	.	C	T	0	5	5	0	12	17	0	0
18	211380	.	G	A	13	14	27	0	1	28	0	0
18	211399	.	T	C	13	18	31	0	3	34	0	0
18	211438	.	T	A	13	13	26	0	1	27	0	0
18	211469	.	C	A	7	11	18	0	2	20	0	0
18	211483	.	A	T	8	14	22	0	1	23	0	0
18	211605	.	A	G	14	14	28	0	2	30	0	0
18	211610	.	T	C	15	0	15	0	15	30	0	0
18	211812	.	T	A	8	7	15	0	1	16	0	0
18	212305	.	A	G	26	5	31	0	0	31	0	0
18	214688	.	A	G	2	10	12	0	0	12	0	0
18	214717	.	T	C	4	12	16	0	0	16	0	0
18	216775	.	G	A	2	0	2	0	0	2	0	0
18	216779	.	G	A	4	1	5	0	0	5	0	0
18	220144	.	G	A	12	12	24	0	2	26	0	0
18	222448	.	T	C	4	0	4	0	2	6	0	0
18	334098	.	T	C	8	5	13	0	0	13	0	0
18	334102	.	T	C	11	2	13	0	0	13	0	0
18	334355	.	T	C	2	0	2	0	3	5	0	0
18	334361	.	T	C	2	2	4	0	0	4	0	0
18	336586	.	T	C	9	8	17	0	1	18	0	0
18	609280	.	G	A	1	2	3	0	0	3	0	0
18	609877	.	G	A	7	10	17	0	1	18	0	0
18	609935	.	G	A	1	9	10	0	10	20	0	0
18	610126	.	A	T	4	11	15	0	1	16	0	0
18	610148	.	A	T	4	8	12	0	0	12	0	0
18	610184	.	G	T	5	2	7	0	1	8	0	0
18	610187	.	G	T	6	3	9	0	0	9	0	0
18	610291	.	T	C	4	6	10	0	1	11	0	0
18	610631	.	T	A	3	9	12	0	0	12	0	0
18	610721	.	A	C	4	2	6	0	0	6	0	0
18	643517	.	C	T	3	2	5	0	0	5	0	0
18	660616	.	A	G	2	3	5	0	0	5	0	0
18	660688	.	T	C	2	2	4	0	0	4	0	0
18	660846	.	C	A	1	3	4	0	0	4	0	0
18	789974	.	T	A	11	4	15	0	0	15	0	0
18	790247	.	T	C	5	8	13	0	1	14	0	0
18	790301	.	T	A	8	9	17	0	0	17	0	0
18	790451	.	T	G	13	0	13	0	14	27	0	0
18	790962	.	T	G	5	11	16	0	3	19	0	0
18	791069	.	A	G	7	0	7	0	10	17	0	0
18	791076	.	G	C	8	8	16	0	1	17	0	0
18	791137	.	T	A	3	10	13	0	0	13	0	0
18	791171	.	G	C	8	9	17	0	1	18	0	0
18	791246	.	G	A	6	12	18	0	0	18	0	0
18	791582	.	G	A	0	4	4	0	5	9	0	0
18	809012	.	G	T	15	20	35	0	0	35	0	0
18	824921	.	G	A	2	1	3	0	0	3	0	0
18	824931	.	T	A	3	0	3	0	0	3	0	0
18	825078	.	A	T	3	2	5	0	1	6	0	0
18	826116	.	G	A	3	4	7	0	0	7	0	0
18	826190	.	A	T	4	12	16	0	0	16	0	0
18	826574	.	C	T	5	7	12	0	0	12	0	0
18	826745	.	G	A	3	6	9	0	0	9	0	0
18	826749	.	T	A	3	6	9	0	0	9	0	0
18	827129	.	A	C	2	3	5	0	0	5	0	0
18	827232	.	G	A	1	4	5	0	0	5	0	0
18	888440	.	G	A	4	2	6	0	0	6	0	0
18	891534	.	C	A	4	3	7	0	1	8	0	0
18	891586	.	G	A	1	0	1	0	0	1	0	0
18	911036	.	C	A	1	2	3	0	0	3	0	0
18	911076	.	A	G	0	1	1	0	0	1	0	0
18	925088	.	C	T	10	14	24	0	2	26	0	0
18	925100	.	A	C	10	7	17	0	0	17	0	0
18	933299	.	G	A	14	8	22	0	1	23	0	0
18	936728	.	C	T	30	27	57	0	1	58	0	0
18	939430	.	C	T	14	18	32	0	3	35	0	0
18	951004	.	A	T	33	26	59	0	4	63	0	0
18	951005	.	T	C	29	28	57	0	5	63	1	0
18	955705	.	A	G	2	3	5	0	1	6	0	0
18	1151536	.	C	A	1	2	3	0	0	3	0	0
18	1152220	.	G	A	3	3	6	0	1	7	0	0
18	1161085	.	A	G	7	6	13	0	0	13	0	0
18	1161750	.	A	G	7	5	12	0	0	12	0	0
18	1173819	.	G	A	4	0	4	0	0	4	0	0
18	1173856	.	G	A	16	14	30	0	2	32	0	0
18	1173898	.	A	G	23	26	49	0	1	50	0	0
18	1292100	.	C	T	0	4	4	0	3	7	0	0
18	1292164	.	G	A	5	1	6	0	0	6	0	0
18	1292668	.	T	C	3	1	4	0	3	7	0	0
18	1293182	.	G	A	3	4	7	0	0	7	0	0
18	1391653	.	A	G	1	1	2	0	0	2	0	0
18	1391674	.	T	C	1	0	1	0	0	1	0	0
18	2180285	.	A	G	2	2	4	0	0	4	0	0
18	2180636	.	C	T	2	2	4	0	0	4	0	0
18	2197638	.	A	C	3	4	7	0	1	8	0	0
18	2204386	.	T	C	3	3	6	0	0	6	0	0
18	2205302	.	T	A	6	4	10	0	0	10	0	0
18	2210570	.	C	T	0	1	1	0	0	1	0	0
18	2211091	.	T	C	3	4	7	0	1	8	0	0
18	2215642	.	A	G	1	0	1	0	0	1	0	0
18	2225632	.	C	T	1	2	3	0	0	3	0	0
18	2225661	.	C	T	6	3	9	0	0	9	0	0
18	2377645	.	T	C	3	0	3	0	13	16	0	0
18	2377860	.	G	A	16	8	24	0	1	25	0	0
18	2378462	.	A	T	9	3	12	0	0	12	0	0
18	2378495	.	T	A	5	5	10	0	0	10	0	0
18	2378510	.	C	A	3	4	7	0	0	7	0	0
18	2378619	.	T	G	3	2	5	0	0	5	0	0
18	2378625	.	G	T	3	2	5	0	0	5	0	0
18	2378687	.	A	C	10	1	11	0	1	12	0	0
18	2378713	.	T	G	4	9	13	0	0	13	0	0
18	2378722	.	C	T	0	5	5	0	9	14	0	0
18	2379073	.	G	A	2	7	9	0	0	9	0	0
18	2412660	.	T	C	8	7	15	0	0	15	0	0
18	2414993	.	T	C	0	2	2	0	0	2	0	0
18	2533391	.	C	A	1	1	2	0	0	2	0	0
18	2683365	.	G	T	0	7	7	0	1	8	0	0
18	2684230	.	T	C	4	4	8	0	0	8	0	0
18	2922807	.	T	A	0	0	0	0	12	12	0	0
18	2922813	.	A	C	1	2	3	0	7	10	0	0
18	2934856	.	A	G	2	8	10	0	0	10	0	0
18	2934938	.	C	T	5	2	7	0	0	7	0	0
18	3043779	.	C	T	17	7	24	0	1	25	0	0
18	3078648	.	G	A	0	4	4	0	1	5	0	0
18	3078684	.	C	T	1	0	1	0	0	1	0	0
18	3081310	.	A	T	4	3	7	0	0	7	0	0
18	3081325	.	A	C	3	2	5	0	0	5	0	0
18	3081803	.	T	C	0	1	1	0	0	1	0	0
18	3084033	.	T	C	1	2	3	0	0	3	0	0
18	3084660	.	G	C	2	2	4	0	0	4	0	0
18	3089906	.	T	C	3	3	6	0	0	6	0	0
18	3094913	.	T	C	7	11	18	0	0	18	0	0
18	3094920	.	C	A	7	12	19	0	0	19	0	0
18	3096718	.	A	G	3	4	7	0	0	7	0	0
18	3096739	.	C	T	5	2	7	0	1	8	0	0
18	3096914	.	A	C	3	3	6	0	0	6	0	0
18	3097194	.	T	C	8	10	18	0	0	18	0	0
18	3100651	.	A	G	4	5	9	0	1	10	0	0
18	3140747	.	G	A	3	2	5	0	0	5	0	0
18	3140975	.	A	G	2	6	8	0	1	9	0	0
18	3142685	.	A	G	3	6	9	0	0	9	0	0
18	3149565	.	T	G	7	6	13	0	1	14	0	0
18	3158237	.	C	T	1	3	4	0	0	4	0	0
18	3158245	.	T	A	1	3	4	0	0	4	0	0
18	3158273	.	G	A	3	1	4	0	0	4	0	0
18	3158588	.	A	C	14	6	20	0	1	21	0	0
18	3158776	.	G	A	15	7	22	0	0	22	0	0
18	3158801	.	G	A	10	10	20	0	1	21	0	0
18	3158896	.	C	T	2	5	7	0	0	7	0	0
18	3159140	.	C	A	3	2	5	0	0	5	0	0
18	3159249	.	C	A	4	4	8	0	0	8	0	0
18	3159324	.	C	G	1	2	3	0	0	3	0	0
18	3159326	.	C	A	1	2	3	0	0	3	0	0
18	3159658	.	C	G	5	2	7	0	0	7	0	0
18	3159713	.	T	C	5	3	8	0	1	9	0	0
18	3159864	.	T	C	5	2	7	0	0	7	0	0
18	3159965	.	A	T	5	4	9	0	0	9	0	0
18	3160308	.	A	G	9	6	15	0	0	15	0	0
18	3160354	.	C	T	0	9	9	0	4	13	0	0
18	3160406	.	T	C	2	0	2	0	6	8	0	0
18	3160422	.	A	G	2	3	5	0	0	5	0	0
18	3166246	.	T	A	3	4	7	0	1	8	0	0
18	3166413	.	C	G	3	3	6	0	1	7	0	0
18	3166414	.	C	A	0	4	4	0	3	7	0	0
18	3166636	.	A	G	3	3	6	0	0	6	0	0
18	3259807	.	C	A	13	13	26	0	3	29	0	0
18	3276085	.	G	C	14	25	39	0	2	41	0	0
18	3276187	.	A	G	1	0	1	0	3	4	0	0
18	3278976	.	G	A	15	16	31	0	2	33	0	0
18	3283412	.	G	A	16	11	27	0	1	28	0	0
18	3283546	.	A	G	21	4	25	0	25	50	0	0
18	3283631	.	G	T	17	14	31	0	1	32	0	0
18	3283686	.	T	C	22	12	34	0	1	35	0	0
18	3283882	.	T	C	22	17	39	0	3	42	0	0
18	3323626	.	G	A	0	1	1	0	1	2	0	0
18	3327571	.	G	A	0	2	2	0	1	3	0	0
18	3334581	.	G	C	2	3	5	0	0	5	0	0
18	3345174	.	A	G	7	4	11	0	0	11	0	0
18	3371534	.	G	A	1	0	1	0	0	1	0	0
18	3371543	.	C	T	1	0	1	0	0	1	0	0
18	3371661	.	T	C	0	0	0	0	1	1	0	0
18	3371664	.	A	C	1	0	1	0	0	1	0	0
18	3536883	.	A	G	9	4	13	0	1	14	0	0
18	3540027	.	C	T	5	2	7	0	0	7	0	0
18	3542204	.	G	A	7	2	9	0	2	11	0	0
18	3556542	.	A	G	1	3	4	0	0	4	0	0
18	3556626	.	C	T	0	10	10	0	8	18	0	0
18	3556710	.	G	A	10	9	19	0	0	19	0	0
18	3556743	.	G	A	7	6	13	0	0	13	0	0
18	3562409	.	A	C	3	0	3	0	6	9	0	0
18	3575938	.	C	A	9	3	12	0	1	13	0	0
18	3575984	.	G	A	11	6	17	0	0	17	0	0
18	3576104	.	C	T	9	8	17	0	1	18	0	0
18	3576185	.	T	A	4	7	11	0	0	11	0	0
18	3635419	.	A	G	0	2	2	0	0	2	0	0
18	3635443	.	C	G	1	4	5	0	0	5	0	0
18	5094876	.	A	C	16	1	17	0	16	33	0	0
18	5095537	.	G	T	8	13	21	0	2	23	0	0
18	5140128	.	C	T	9	5	14	0	1	15	0	0
18	5142338	.	C	T	9	20	29	0	2	33	2	0
18	5167232	.	T	C	35	15	50	0	5	55	0	0
18	5167374	.	A	G	39	16	55	0	0	55	0	0
18	5167437	.	T	C	39	14	53	0	1	54	0	0
18	5167689	.	A	G	15	16	31	0	0	31	0	0
18	5169635	.	C	T	8	43	51	0	2	53	0	0
18	5169779	.	T	C	32	24	56	0	2	58	0	0
18	5170016	.	C	G	31	22	53	0	0	53	0	0
18	5170069	.	A	G	11	1	12	0	36	48	0	0
18	5170123	.	C	A	18	21	39	0	6	45	0	0
18	5234937	.	C	A	0	14	14	0	19	33	0	0
18	5234990	.	T	G	14	9	23	0	1	24	0	0
18	5235033	.	C	T	2	1	3	0	0	3	0	0
18	5242329	.	G	A	6	4	10	0	2	12	0	0
18	5243234	.	A	G	1	2	3	0	1	4	0	0
18	5243255	.	T	C	2	2	4	0	0	4	0	0
18	5245806	.	T	C	11	14	25	0	1	26	0	0
18	5245818	.	C	T	0	14	14	0	13	27	0	0
18	5308441	.	T	G	5	7	12	0	2	14	0	0
18	5316537	.	A	G	4	6	10	0	1	11	0	0
18	5316575	.	C	T	4	3	7	0	0	7	0	0
18	5375143	.	A	G	4	6	10	0	0	10	0	0
18	5378093	.	C	A	0	0	0	0	1	1	0	0
18	5454381	.	G	A	5	3	8	0	1	9	0	0
18	5455161	.	C	T	3	4	7	0	0	7	0	0
18	5455347	.	G	T	0	2	2	0	2	4	0	0
18	5456883	.	C	T	1	3	4	0	0	4	0	0
18	5456940	.	G	A	1	2	3	0	0	3	0	0
18	5491697	.	G	A	5	9	14	0	1	15	0	0
18	5494980	.	A	G	2	6	8	0	0	8	0	0
18	5495903	.	T	C	16	19	35	0	6	41	0	0
18	5506578	.	C	T	2	5	7	0	1	8	0	0
18	5509426	.	G	C	2	3	5	0	0	5	0	0
18	5514321	.	T	G	1	1	2	0	0	2	0	0
18	5514544	.	T	A	7	5	12	0	0	12	0	0
18	5514678	.	G	A	0	6	6	0	6	12	0	0
18	5516984	.	T	C	2	1	3	0	0	3	0	0
18	5518108	.	C	T	4	7	11	0	0	11	0	0
18	5518128	.	T	C	1	3	4	0	0	4	0	0
18	5518749	.	T	C	13	7	20	0	0	20	0	0
18	5518809	.	T	G	4	6	10	0	0	10	0	0
18	5519052	.	C	T	5	8	13	0	0	13	0	0
18	5519119	.	A	G	5	3	8	0	0	8	0	0
18	5519138	.	A	G	6	3	9	0	3	12	0	0
18	5519269	.	T	C	9	8	17	0	1	18	0	0
18	5519534	.	T	A	5	5	10	0	1	11	0	0
18	5519622	.	G	A	0	4	4	0	3	7	0	0
18	5531611	.	A	T	1	2	3	0	0	3	0	0
18	5533186	.	A	C	4	1	5	0	7	12	0	0
18	5535203	.	C	T	0	3	3	0	2	5	0	0
18	5535243	.	G	A	1	1	2	0	0	2	0	0
18	5537129	.	G	C	3	3	6	0	0	6	0	0
18	5537138	.	C	T	3	3	6	0	0	6	0	0
18	5537171	.	A	C	2	0	2	0	5	7	0	0
18	5537530	.	A	G	6	3	9	0	0	9	0	0
18	5619919	.	G	A	0	3	3	0	4	7	0	0
18	5619922	.	G	A	4	3	7	0	0	7	0	0
18	5624614	.	A	G	8	2	10	0	0	10	0	0
18	5624654	.	T	A	8	6	14	0	1	15	0	0
18	5626583	.	G	A	2	0	2	0	0	2	0	0
18	5626661	.	A	C	1	3	4	0	0	4	0	0
18	5692205	.	A	G	12	11	23	0	2	25	0	0
18	5692222	.	A	T	11	11	22	0	1	23	0	0
18	5910558	.	G	T	1	2	3	0	0	3	0	0
18	5911345	.	T	A	1	2	3	0	0	3	0	0
18	5911357	.	T	C	1	3	4	0	0	4	0	0
18	5911552	.	T	A	10	4	14	0	0	14	0	0
18	5911732	.	C	A	3	2	5	0	0	5	0	0
18	5962151	.	A	C	0	3	3	0	1	4	0	0
18	5962163	.	G	A	0	2	2	0	1	3	0	0
18	6056879	.	G	A	0	1	1	0	2	3	0	0
18	6056880	.	A	T	0	2	2	0	1	3	0	0
18	6057182	.	C	G	1	2	3	0	0	3	0	0
18	6073664	.	C	T	0	3	3	0	0	3	0	0
18	6074681	.	G	A	3	3	6	0	0	6	0	0
18	6075617	.	G	A	1	2	3	0	0	3	0	0
18	6075632	.	A	G	1	0	1	0	2	3	0	0
18	6075821	.	T	G	4	2	6	0	0	6	0	0
18	6076429	.	G	A	0	6	6	0	1	7	0	0
18	6076697	.	A	G	1	0	1	0	2	3	0	0
18	6076992	.	C	T	2	2	4	0	0	4	0	0
18	6077555	.	C	A	2	2	4	0	0	4	0	0
18	6077645	.	A	T	5	2	7	0	1	8	0	0
18	6078032	.	T	A	1	2	3	0	1	4	0	0
18	6078123	.	T	C	2	2	4	0	1	5	0	0
18	6078131	.	T	C	2	3	5	0	1	6	0	0
18	6078302	.	G	T	4	4	8	0	1	9	0	0
18	6079068	.	C	T	2	3	5	0	0	5	0	0
18	6079864	.	T	C	12	6	18	0	0	18	0	0
18	6080197	.	A	T	2	10	12	0	2	14	0	0
18	6080253	.	G	A	0	4	4	0	3	7	0	0
18	6080272	.	A	G	3	3	6	0	1	7	0	0
18	6080334	.	A	G	6	0	6	0	5	11	0	0
18	6082054	.	C	T	7	10	17	0	0	17	0	0
18	6431858	.	G	A	1	0	1	0	0	1	0	0
18	6433116	.	G	A	5	4	9	0	0	9	0	0
18	6443966	.	G	T	0	2	2	0	0	2	0	0
18	6443971	.	A	G	0	2	2	0	0	2	0	0
18	6458516	.	G	T	2	2	4	0	0	4	0	0
18	6458566	.	A	C	5	2	7	0	1	8	0	0
18	6458729	.	T	G	1	4	5	0	0	5	0	0
18	6459959	.	T	C	1	4	5	0	2	7	0	0
18	6490751	.	T	C	2	5	7	0	1	8	0	0
18	6498963	.	G	A	0	5	5	0	4	9	0	0
18	6499118	.	A	C	5	5	10	0	0	10	0	0
18	6499129	.	C	T	5	4	9	0	0	9	0	0
18	6502840	.	T	A	1	2	3	0	0	3	0	0
18	6536402	.	G	A	14	16	30	0	2	32	0	0
18	6536439	.	G	T	13	12	25	0	2	27	0	0
18	6536459	.	T	C	12	11	23	0	0	23	0	0
18	6536475	.	A	T	10	9	19	0	0	19	0	0
18	6536548	.	G	A	6	12	18	0	0	18	0	0
18	6536640	.	C	T	1	6	7	0	1	8	0	0
18	6536689	.	G	A	2	1	3	0	0	3	0	0
18	6537731	.	T	C	5	3	8	0	0	8	0	0
18	6537755	.	C	T	8	8	16	0	0	16	0	0
18	6538916	.	C	T	1	1	2	0	0	2	0	0
18	6546164	.	C	T	4	5	9	0	1	10	0	0
18	6549378	.	A	T	19	25	44	0	0	44	0	0
18	6549381	.	T	A	20	24	44	0	1	45	0	0
18	6549778	.	T	A	24	13	37	0	2	39	0	0
18	6549810	.	G	A	17	14	31	0	3	34	0	0
18	6549816	.	C	T	13	17	30	0	4	34	0	0
18	6639142	.	G	C	0	4	4	0	0	4	0	0
18	6642428	.	A	G	1	0	1	0	1	2	0	0
18	6643435	.	C	T	1	4	5	0	0	5	0	0
18	6644128	.	C	T	2	0	2	0	0	2	0	0
18	6646411	.	C	T	5	7	12	0	1	13	0	0
18	6657152	.	G	A	4	4	8	0	0	8	0	0
18	6657180	.	C	T	4	4	8	0	0	8	0	0
18	6676868	.	A	C	15	10	25	0	4	29	0	0
18	6679429	.	A	T	4	4	8	0	0	8	0	0
18	6682072	.	C	T	3	3	6	0	0	6	0	0
18	6699939	.	C	T	9	20	29	0	2	31	0	0
18	6699999	.	G	A	0	8	8	0	0	8	0	0
18	6702530	.	G	A	3	10	13	0	2	15	0	0
18	6702966	.	T	C	16	18	34	0	0	34	0	0
18	6703023	.	G	A	0	18	18	0	10	28	0	0
18	6703181	.	A	C	15	15	30	0	0	30	0	0
18	6703328	.	G	A	12	22	34	0	2	37	1	0
18	6724611	.	C	T	1	1	2	0	0	2	0	0
18	6724713	.	T	C	1	1	2	0	0	2	0	0
18	6727469	.	T	C	1	2	3	0	1	4	0	0
18	6727558	.	C	T	4	5	9	0	0	9	0	0
18	6727559	.	T	G	4	5	9	0	0	9	0	0
18	6727612	.	A	G	7	10	17	0	0	17	0	0
18	6727613	.	T	A	7	8	15	0	2	17	0	0
18	6727689	.	C	A	1	4	5	0	0	5	0	0
18	6727730	.	G	A	2	2	4	0	0	4	0	0
18	6815876	.	A	G	3	6	9	0	0	9	0	0
18	6815938	.	C	A	3	4	7	0	0	7	0	0
18	6815950	.	A	G	2	4	6	0	0	6	0	0
18	6822082	.	A	G	3	5	8	0	1	9	0	0
18	6822085	.	A	G	3	6	9	0	0	9	0	0
18	6822202	.	C	T	1	0	1	0	0	1	0	0
18	6823951	.	G	A	5	4	9	0	0	9	0	0
18	6827174	.	T	C	4	3	7	0	0	7	0	0
18	6827183	.	A	G	4	3	7	0	0	7	0	0
18	6830465	.	C	G	2	0	2	0	0	2	0	0
18	6833196	.	G	A	5	3	8	0	2	10	0	0
18	6842193	.	G	A	1	3	4	0	0	4	0	0
18	6846080	.	G	A	2	1	3	0	0	3	0	0
18	6857229	.	C	A	11	22	33	0	2	35	0	0
18	6860756	.	T	C	11	18	29	0	1	30	0	0
18	6863034	.	T	C	7	6	13	0	1	14	0	0
18	6866414	.	A	G	1	1	2	0	2	4	0	0
18	6868176	.	G	C	18	19	37	0	0	37	0	0
18	6868188	.	A	G	15	19	34	0	2	36	0	0
18	6868224	.	A	G	12	1	13	0	19	32	0	0
18	6868297	.	A	T	21	19	40	0	1	41	0	0
18	6868623	.	G	A	20	20	40	0	2	42	0	0
18	6868928	.	G	A	26	24	50	0	3	53	0	0
18	6868969	.	G	A	5	24	29	0	29	58	0	0
18	6868971	.	A	G	28	3	31	0	27	58	0	0
18	6869022	.	T	C	27	35	62	0	8	70	0	0
18	6869035	.	C	T	39	24	63	0	4	67	0	0
18	6869410	.	A	G	2	1	3	0	5	8	0	0
18	7571628	.	C	T	1	5	6	0	0	6	0	0
18	10693077	.	G	A	3	3	6	0	0	6	0	0
18	10693085	.	T	A	3	2	5	0	2	7	0	0
18	10693123	.	C	T	4	1	5	0	0	5	0	0
18	10693155	.	T	A	4	3	7	0	1	8	0	0
18	10693322	.	A	T	3	7	10	0	1	11	0	0
18	10698083	.	T	C	2	4	6	0	1	7	0	0
18	10698161	.	T	G	4	8	12	0	0	12	0	0
18	10698215	.	T	C	6	3	9	0	0	9	0	0
18	10703669	.	A	G	1	1	2	0	0	2	0	0
18	10709870	.	C	A	1	0	1	0	1	2	0	0
18	10709876	.	C	A	1	1	2	0	0	2	0	0
18	10713310	.	T	C	3	2	5	0	0	5	0	0
18	10820428	.	A	C	2	2	4	0	1	5	0	0
18	10825951	.	A	G	2	2	4	0	0	4	0	0
18	10840094	.	C	A	1	1	2	0	1	3	0	0
18	10840722	.	C	G	4	4	8	0	0	9	1	0
18	10846601	.	T	C	5	4	9	0	0	9	0	0
18	10847743	.	C	T	6	4	10	0	0	10	0	0
18	10867181	.	A	C	3	4	7	0	1	8	0	0
18	10870806	.	T	C	1	2	3	0	0	3	0	0
18	10877499	.	G	A	2	4	6	0	0	6	0	0
18	10879495	.	G	A	7	7	14	0	0	14	0	0
18	10888551	.	T	C	1	0	1	0	0	1	0	0
18	10888836	.	T	C	8	10	18	0	0	18	0	0
18	10889049	.	C	G	2	0	2	0	2	4	0	0
18	10889880	.	G	A	0	4	4	0	5	9	0	0
18	10889901	.	T	A	6	7	13	0	0	13	0	0
18	10889951	.	G	A	5	8	13	0	0	13	0	0
18	10890432	.	G	A	8	10	18	0	0	18	0	0
18	10921408	.	A	T	12	8	20	0	1	21	0	0
18	10921630	.	A	T	3	9	12	0	1	13	0	0
18	10921734	.	T	C	5	9	14	0	1	15	0	0
18	10921791	.	T	C	5	11	16	0	0	16	0	0
18	10921855	.	T	C	6	14	20	0	0	20	0	0
18	10921857	.	G	A	0	14	14	0	6	20	0	0
18	10921927	.	C	T	7	13	20	0	0	20	0	0
18	11016209	.	G	A	1	2	3	0	0	3	0	0
18	11515830	.	C	T	2	2	4	0	0	4	0	0
18	11558350	.	G	T	1	2	3	0	1	4	0	0
18	11558360	.	G	A	1	2	3	0	0	3	0	0
18	12058480	.	T	A	2	2	4	0	0	4	0	0
18	12111625	.	A	G	3	4	7	0	0	7	0	0
18	12111628	.	A	T	3	4	7	0	0	7	0	0
18	12111784	.	G	T	3	3	6	0	0	6	0	0
18	12112105	.	T	C	5	6	11	0	0	11	0	0
18	12112153	.	T	C	5	3	8	0	0	8	0	0
18	12112219	.	C	T	4	7	11	0	0	11	0	0
18	12112246	.	A	G	4	0	4	0	8	12	0	0
18	12112726	.	C	T	0	2	2	0	0	2	0	0
18	12112750	.	G	A	0	1	1	0	0	1	0	0
18	12113515	.	C	A	5	5	10	0	0	10	0	0
18	12113516	.	C	T	5	5	10	0	0	10	0	0
18	12171313	.	A	G	0	0	0	0	1	1	0	0
18	12207046	.	A	G	2	3	5	0	0	5	0	0
18	12207070	.	C	A	3	4	7	0	0	7	0	0
18	12214299	.	A	G	0	1	1	0	0	1	0	0
18	12228217	.	C	A	3	1	4	0	0	4	0	0
18	12228758	.	C	T	3	4	7	0	1	8	0	0
18	12228834	.	G	C	4	2	6	0	0	6	0	0
18	12229120	.	A	T	3	8	11	0	0	11	0	0
18	12229223	.	A	C	5	6	11	0	0	11	0	0
18	12229245	.	C	T	5	3	8	0	0	8	0	0
18	12229405	.	G	A	5	6	11	0	0	11	0	0
18	12236113	.	G	A	2	4	6	0	0	6	0	0
18	12236126	.	T	A	3	2	5	0	0	5	0	0
18	12236351	.	C	T	4	2	6	0	1	7	0	0
18	12238082	.	G	A	4	3	7	0	0	7	0	0
18	12240681	.	C	T	6	4	10	0	0	10	0	0
18	12240740	.	G	C	1	1	2	0	0	2	0	0
18	12242967	.	C	T	0	1	1	0	0	1	0	0
18	12245468	.	A	G	0	1	1	0	0	1	0	0
18	12254248	.	G	A	0	1	1	0	1	2	0	0
18	12254398	.	A	G	2	1	3	0	0	3	0	0
18	12254409	.	G	A	1	1	2	0	1	3	0	0
18	12255012	.	T	C	0	1	1	0	0	1	0	0
18	12276859	.	C	T	12	7	19	0	1	20	0	0
18	12277052	.	A	G	8	11	19	0	1	20	0	0
18	12277206	.	G	C	12	14	26	0	1	27	0	0
18	12277490	.	G	A	22	17	39	0	2	41	0	0
18	12280269	.	C	T	11	6	17	0	0	17	0	0
18	12292017	.	G	A	19	18	37	0	2	39	0	0
18	12327321	.	C	A	0	2	2	0	3	5	0	0
18	12364876	.	G	A	3	3	6	0	0	6	0	0
18	12366097	.	G	T	0	2	2	0	0	2	0	0
18	12366855	.	A	T	0	2	2	0	0	2	0	0
18	12385129	.	G	A	1	2	3	0	0	3	0	0
18	12385172	.	T	C	2	0	2	0	3	5	0	0
18	12409681	.	C	T	1	0	1	0	0	1	0	0
18	12409705	.	A	T	1	0	1	0	0	1	0	0
18	12464794	.	C	T	0	3	3	0	2	5	0	0
18	12465290	.	G	A	3	6	9	0	0	9	0	0
18	12465316	.	C	T	3	8	11	0	1	12	0	0
18	12467834	.	G	C	3	0	3	0	3	6	0	0
18	12470013	.	G	T	4	7	11	0	0	11	0	0
18	12470136	.	G	A	7	5	12	0	0	12	0	0
18	12470148	.	A	G	3	6	9	0	0	9	0	0
18	12470211	.	C	T	0	2	2	0	1	3	0	0
18	12471210	.	T	C	2	1	3	0	0	3	0	0
18	12471225	.	G	A	1	2	3	0	0	3	0	0
18	12495185	.	C	T	1	2	3	0	1	4	0	0
18	12612031	.	C	T	0	4	4	0	2	6	0	0
18	12653846	.	G	C	4	2	6	0	0	6	0	0
18	12659197	.	C	T	1	4	5	0	0	5	0	0
18	12659226	.	C	T	0	2	2	0	0	2	0	0
18	12776727	.	C	T	3	6	9	0	0	9	0	0
18	12779357	.	T	A	7	7	14	0	0	14	0	0
18	12828500	.	C	T	1	1	2	0	0	2	0	0
18	12833894	.	A	G	9	7	16	0	0	16	0	0
18	12839910	.	A	G	1	4	5	0	0	5	0	0
18	12839913	.	C	A	1	3	4	0	1	5	0	0
18	12844205	.	C	T	1	0	1	0	0	1	0	0
18	12867505	.	A	G	2	2	4	0	0	4	0	0
18	12867594	.	C	T	0	2	2	0	2	4	0	0
18	12871545	.	G	T	4	3	7	0	1	8	0	0
18	12871605	.	C	T	0	3	3	0	5	8	0	0
18	12871650	.	G	A	3	4	7	0	1	8	0	0
18	12949932	.	C	T	0	3	3	0	1	4	0	0
18	13063534	.	G	A	12	12	24	0	1	25	0	0
18	13082686	.	A	G	1	0	1	0	0	1	0	0
18	13121754	.	G	A	0	1	1	0	0	1	0	0
18	13124664	.	T	C	6	2	8	0	0	8	0	0
18	13125829	.	G	A	2	4	6	0	0	6	0	0
18	13125836	.	G	T	2	2	4	0	0	5	1	0
18	13133040	.	C	T	1	2	3	0	0	3	0	0
18	13196113	.	A	G	4	2	6	0	0	6	0	0
18	13196274	.	T	C	2	0	2	0	2	4	0	0
18	13196285	.	A	G	2	2	4	0	0	4	0	0
18	13215966	.	G	A	26	20	46	0	3	49	0	0
18	13216051	.	C	T	15	17	32	0	1	33	0	0
18	13216566	.	T	A	10	20	30	0	1	31	0	0
18	13238078	.	G	A	0	2	2	0	2	4	0	0
18	13238759	.	G	A	2	3	5	0	1	6	0	0
18	13240208	.	T	A	1	0	1	0	1	2	0	0
18	13245795	.	G	A	8	9	17	0	2	19	0	0
18	13245803	.	A	G	9	10	19	0	0	19	0	0
18	13324391	.	G	A	18	20	38	0	0	38	0	0
18	13324416	.	T	C	13	22	35	0	0	35	0	0
18	13324473	.	G	A	23	20	43	0	3	47	1	0
18	13324494	.	T	C	18	0	18	0	23	42	1	0
18	13324747	.	A	G	22	23	45	0	0	45	0	0
18	13325224	.	A	G	20	20	40	0	1	41	0	0
18	13325225	.	C	T	20	17	37	0	4	41	0	0
18	13325451	.	G	T	20	13	33	0	3	36	0	0
18	13325492	.	C	T	16	14	30	0	0	30	0	0
18	13325679	.	C	T	0	12	12	0	16	28	0	0
18	13325912	.	G	A	12	17	29	0	1	30	0	0
18	13326124	.	A	C	11	0	11	0	12	23	0	0
18	13326178	.	G	T	10	12	22	0	0	22	0	0
18	13326400	.	C	T	0	12	12	0	9	21	0	0
18	13326593	.	G	C	11	18	29	0	1	30	0	0
18	13336278	.	G	A	1	0	1	0	0	1	0	0
18	13345001	.	C	G	3	5	8	0	1	9	0	0
18	13345088	.	G	A	10	14	24	0	1	25	0	0
18	13345166	.	A	C	9	1	10	0	9	19	0	0
18	13347733	.	G	A	2	1	3	0	0	3	0	0
18	13356438	.	A	G	5	5	10	0	1	11	0	0
18	13837843	.	T	C	3	3	6	0	0	6	0	0
18	13888370	.	A	T	3	5	8	0	1	9	0	0
18	13888406	.	G	A	2	6	8	0	0	8	0	0
18	14041036	.	C	T	18	13	31	0	1	32	0	0
18	14075262	.	A	G	8	8	16	0	0	16	0	0
18	14114915	.	G	A	1	4	5	0	0	5	0	0
18	14114930	.	C	T	5	9	14	0	0	14	0	0
18	14115011	.	A	G	14	21	35	0	1	36	0	0
18	14115083	.	G	C	9	16	25	0	2	27	0	0
18	14132006	.	G	A	0	3	3	1	7	11	0	0
18	14132077	.	A	T	21	28	49	0	0	49	0	0
18	14132360	.	G	A	0	21	21	0	21	42	0	0
18	14132836	.	A	G	19	16	35	0	0	35	0	0
18	14132892	.	T	C	24	17	41	0	0	41	0	0
18	14244508	.	C	T	0	0	0	0	1	1	0	0
18	14334468	.	A	T	16	11	27	0	1	28	0	0
18	14337320	.	T	A	9	10	19	0	0	19	0	0
18	14529721	.	T	C	3	3	6	0	1	7	0	0
18	14529932	.	T	C	3	5	8	0	0	8	0	0
18	14530273	.	T	A	1	2	3	0	0	3	0	0
18	14530447	.	G	T	1	4	5	0	0	5	0	0
18	14530465	.	C	A	1	4	5	0	0	5	0	0
18	14633131	.	T	C	4	6	10	0	0	10	0	0
18	14637888	.	T	C	5	1	6	0	1	7	0	0
18	14642970	.	A	C	1	4	5	0	0	5	0	0
18	14648859	.	C	A	1	1	2	0	0	2	0	0
18	14649227	.	G	A	1	4	5	0	5	10	0	0
18	14649408	.	A	T	2	5	7	0	0	7	0	0
18	14652676	.	A	G	1	0	1	0	0	1	0	0
18	14660205	.	C	G	1	8	9	0	0	9	0	0
18	14688757	.	A	G	4	2	6	0	2	8	0	0
18	14690967	.	G	A	3	5	8	0	0	8	0	0
18	14691037	.	T	C	1	4	5	0	2	7	0	0
18	14691133	.	T	C	1	3	4	0	1	5	0	0
18	14691269	.	A	T	5	7	12	0	0	12	0	0
18	14691634	.	G	C	2	3	5	0	1	6	0	0
18	14698371	.	C	T	5	5	10	0	0	10	0	0
18	14698538	.	A	G	3	7	10	0	0	10	0	0
18	14698860	.	A	C	9	8	17	0	3	20	0	0
18	14698928	.	G	T	10	8	18	0	0	18	0	0
18	14700684	.	A	G	7	1	8	0	15	23	0	0
18	14700731	.	A	T	10	13	23	0	1	24	0	0
18	14702153	.	G	A	7	6	13	0	1	14	0	0
18	14702427	.	G	A	12	12	24	0	1	25	0	0
18	14702439	.	T	C	10	13	23	0	1	24	0	0
18	14702511	.	G	T	1	7	8	0	4	12	0	0
18	14705287	.	T	C	4	17	21	0	0	21	0	0
18	14705308	.	A	G	3	13	16	0	0	16	0	0
18	14705371	.	T	C	7	15	22	0	0	22	0	0
18	14705518	.	G	A	0	10	10	0	8	18	0	0
18	14705578	.	G	T	11	7	18	0	0	18	0	0
18	14705770	.	A	T	2	2	4	0	0	4	0	0
18	14731967	.	T	C	7	0	7	0	14	21	0	0
18	14732128	.	G	A	6	8	14	0	0	14	0	0
18	14732809	.	T	C	5	6	11	0	1	12	0	0
18	14732840	.	T	G	4	8	12	0	0	12	0	0
18	14732859	.	C	T	0	7	7	0	2	9	0	0
18	14732885	.	T	C	4	4	8	0	0	8	0	0
18	14732903	.	T	A	7	4	11	0	0	11	0	0
18	14732923	.	G	A	8	7	15	0	0	15	0	0
18	14732996	.	T	C	7	6	13	0	0	13	0	0
18	14733019	.	C	A	6	6	12	0	0	12	0	0
18	14733114	.	A	T	3	7	10	0	0	10	0	0
18	14733362	.	G	A	5	3	8	0	0	8	0	0
18	14733402	.	C	T	4	6	10	0	0	10	0	0
18	14733561	.	A	T	1	2	3	0	0	3	0	0
18	14733638	.	A	G	6	2	8	0	0	8	0	0
18	14733839	.	A	G	3	3	6	0	0	6	0	0
18	14772889	.	A	G	4	5	9	0	0	9	0	0
18	14773020	.	T	A	3	6	9	0	1	10	0	0
18	14773140	.	C	T	4	7	11	0	1	12	0	0
18	14779135	.	T	C	1	0	1	0	1	2	0	0
18	14779171	.	G	A	1	0	1	0	0	1	0	0
18	14779192	.	A	G	1	0	1	0	0	1	0	0
18	14780816	.	A	G	1	3	4	0	0	4	0	0
18	14780840	.	A	G	1	3	4	0	0	4	0	0
18	14836628	.	C	G	3	2	5	0	0	5	0	0
18	14836678	.	C	T	3	3	6	0	0	6	0	0
18	14836684	.	G	A	3	3	6	0	0	6	0	0
18	14836798	.	A	G	2	2	4	0	0	4	0	0
18	14836818	.	G	C	2	0	2	0	2	4	0	0
18	14863675	.	A	G	3	5	8	0	0	8	0	0
18	14863680	.	T	A	4	5	9	0	0	9	0	0
18	14863799	.	A	C	4	0	4	0	8	12	0	0
18	14866506	.	G	A	1	7	8	0	0	8	0	0
18	14866536	.	C	A	1	0	1	0	0	1	0	0
18	14867044	.	T	C	1	0	1	0	1	2	0	0
18	14867144	.	A	C	3	0	3	0	3	6	0	0
18	14867153	.	C	T	2	3	5	0	0	5	0	0
18	14871280	.	A	C	2	0	2	0	6	8	0	0
18	14886018	.	G	A	4	6	10	0	1	11	0	0
18	14886129	.	C	T	1	2	3	0	0	3	0	0
18	14909768	.	G	A	2	2	4	0	0	4	0	0
18	14910437	.	T	C	2	2	4	0	0	4	0	0
18	14928654	.	C	T	2	3	5	0	1	6	0	0
18	14928681	.	T	C	2	5	7	0	0	7	0	0
18	14928703	.	C	T	0	5	5	0	1	6	0	0
18	14975502	.	G	C	1	1	2	0	0	2	0	0
18	15121465	.	G	A	0	4	4	0	6	10	0	0
18	15125122	.	G	A	0	1	1	0	0	1	0	0
18	15125418	.	C	A	1	1	2	0	0	2	0	0
18	15128960	.	T	C	2	6	8	0	0	8	0	0
18	15128975	.	G	T	2	4	6	0	0	6	0	0
18	15128997	.	G	T	0	3	3	0	1	4	0	0
18	15132372	.	T	C	10	7	17	0	1	18	0	0
18	15132383	.	T	C	10	6	16	0	1	17	0	0
18	15134001	.	A	G	3	0	3	0	0	3	0	0
18	15139004	.	T	A	1	4	5	0	0	5	0	0
18	15139049	.	A	G	1	0	1	0	5	6	0	0
18	15139150	.	G	A	3	4	7	0	1	8	0	0
18	15139540	.	C	T	11	5	16	0	1	17	0	0
18	15139757	.	G	A	6	4	10	0	0	10	0	0
18	15139784	.	T	C	3	5	8	0	0	8	0	0
18	15148063	.	A	C	5	1	6	0	4	10	0	0
18	15148199	.	T	C	2	6	8	0	0	8	0	0
18	15148207	.	A	C	2	6	8	0	0	8	0	0
18	15148248	.	T	C	1	7	8	0	0	8	0	0
18	15148259	.	A	C	2	6	8	0	0	8	0	0
18	15148290	.	A	C	2	2	4	0	0	4	0	0
18	15148304	.	T	C	2	0	2	0	2	4	0	0
18	15148482	.	A	G	5	3	8	0	2	10	0	0
18	15148886	.	G	A	3	4	7	0	0	7	0	0
18	15148912	.	A	G	1	5	6	0	0	6	0	0
18	15148954	.	T	C	1	3	4	0	0	4	0	0
18	15148985	.	A	G	2	3	5	0	0	5	0	0
18	15149067	.	G	A	4	3	7	0	0	7	0	0
18	15149068	.	G	T	4	3	7	0	0	7	0	0
18	15149538	.	T	C	2	3	5	0	0	5	0	0
18	15149550	.	C	T	2	3	5	0	0	5	0	0
18	15150207	.	G	A	1	2	3	0	0	3	0	0
18	15150327	.	C	T	1	4	5	0	0	5	0	0
18	15150330	.	G	A	1	4	5	0	0	5	0	0
18	15289895	.	G	A	0	2	2	0	4	6	0	0
18	15295925	.	C	T	0	7	7	0	7	14	0	0
18	15295976	.	G	T	10	3	13	0	0	13	0	0
18	15296062	.	G	A	9	5	14	0	0	14	0	0
18	15309513	.	T	C	7	0	7	0	1	8	0	0
18	15345012	.	A	G	0	0	0	0	1	1	0	0
18	15383683	.	C	T	4	5	9	0	0	9	0	0
18	15393324	.	G	A	2	4	6	0	0	6	0	0
18	15393787	.	C	G	1	1	2	0	0	2	0	0
18	15394086	.	G	C	1	0	1	0	0	1	0	0
18	15394143	.	T	C	2	1	3	0	1	4	0	0
18	15395535	.	A	G	1	1	2	0	0	2	0	0
18	15459835	.	T	A	6	9	15	0	0	15	0	0
18	15459871	.	C	T	3	7	10	0	0	10	0	0
18	15469284	.	G	A	2	6	8	0	0	8	0	0
18	15478391	.	T	G	1	0	1	0	2	3	0	0
18	15478394	.	G	A	3	0	3	0	0	3	0	0
18	15478597	.	A	G	0	1	1	0	0	1	0	0
18	15481636	.	C	T	2	2	4	0	0	4	0	0
18	15483345	.	A	G	1	0	1	0	1	2	0	0
18	15483351	.	C	T	2	0	2	0	0	2	0	0
18	15512776	.	C	A	0	3	3	0	2	5	0	0
18	15512777	.	G	A	2	3	5	0	0	5	0	0
18	15514888	.	C	T	1	1	2	0	0	2	0	0
18	15514894	.	C	T	1	1	2	0	0	2	0	0
18	15569644	.	T	C	1	3	4	0	0	4	0	0
18	15570793	.	C	T	1	2	3	0	1	4	0	0
18	15610644	.	G	A	0	4	4	0	1	5	0	0
18	15610659	.	A	C	1	3	4	0	0	4	0	0
18	15635311	.	A	G	1	2	3	0	0	3	0	0
18	15635323	.	A	G	2	2	4	0	0	4	0	0
18	15792294	.	T	G	24	17	41	0	0	41	0	0
18	15792368	.	G	C	28	11	39	0	2	41	0	0
18	15792459	.	A	C	22	23	45	0	0	45	0	0
18	15792596	.	T	A	24	20	44	0	2	46	0	0
18	15792611	.	A	G	23	15	38	0	1	40	1	0
18	15792743	.	T	A	18	23	41	0	2	43	0	0
18	15793064	.	A	G	4	8	12	0	0	12	0	0
18	15829588	.	A	G	3	2	5	0	0	5	0	0
18	15836835	.	A	G	7	4	11	0	0	11	0	0
18	15836917	.	A	G	5	5	10	0	0	10	0	0
18	15836961	.	C	T	4	8	12	0	0	12	0	0
18	15858916	.	G	A	0	1	1	0	0	1	0	0
18	15863558	.	G	A	1	3	4	0	1	5	0	0
18	15866874	.	T	G	2	0	2	0	0	2	0	0
18	15866876	.	G	T	2	0	2	0	0	2	0	0
18	15872397	.	G	C	3	4	7	0	0	7	0	0
18	15872435	.	A	G	3	3	6	0	0	6	0	0
18	15872452	.	G	A	2	2	4	0	0	4	0	0
18	15875196	.	G	A	1	0	1	0	0	1	0	0
18	16111467	.	C	G	0	5	5	0	3	8	0	0
18	16127885	.	A	G	16	9	25	0	3	28	0	0
18	16127927	.	A	C	12	14	26	0	0	26	0	0
18	16128427	.	T	A	2	5	7	0	0	7	0	0
18	16128730	.	A	G	12	6	18	0	0	18	0	0
18	16128960	.	T	G	21	12	33	0	0	33	0	0
18	16129210	.	A	C	25	8	33	0	1	34	0	0
18	16129583	.	T	A	28	10	38	0	1	39	0	0
18	16129862	.	C	T	20	14	34	0	2	36	0	0
18	16133772	.	C	G	6	7	13	0	0	13	0	0
18	16133773	.	T	A	6	6	12	0	1	13	0	0
18	16133822	.	T	C	2	2	4	0	0	4	0	0
18	16140047	.	G	A	3	1	4	0	1	5	0	0
18	16140337	.	G	T	0	16	16	0	19	35	0	0
18	16145618	.	T	G	19	25	44	0	0	44	0	0
18	16145621	.	C	T	19	24	43	0	1	44	0	0
18	16145994	.	C	G	4	5	9	0	0	9	0	0
18	16151936	.	G	A	11	6	17	0	1	18	0	0
18	16152149	.	G	A	3	1	4	0	0	4	0	0
18	16153487	.	T	C	3	0	3	0	3	6	0	0
18	16158279	.	G	T	1	3	4	0	0	4	0	0
18	16215431	.	A	C	2	2	4	0	0	4	0	0
18	16388195	.	G	A	4	3	7	0	0	7	0	0
18	16388342	.	G	A	4	5	9	0	0	9	0	0
18	16388387	.	G	A	3	4	7	0	0	7	0	0
18	16388864	.	C	T	1	1	2	0	0	2	0	0
18	16391712	.	G	A	0	1	1	0	0	1	0	0
18	16719963	.	T	C	8	10	18	0	1	19	0	0
18	16720197	.	G	A	4	5	9	0	1	10	0	0
18	16721705	.	G	A	13	11	24	0	1	25	0	0
18	16721741	.	G	A	10	3	13	0	1	14	0	0
18	16722124	.	G	A	15	17	32	0	1	33	0	0
18	16722584	.	G	A	18	13	31	0	2	33	0	0
18	16723514	.	T	C	19	17	36	0	0	36	0	0
18	16723520	.	A	G	19	0	19	0	17	36	0	0
18	16723785	.	A	G	16	0	16	0	8	24	0	0
18	16725225	.	G	A	0	24	24	0	12	36	0	0
18	16725309	.	C	T	13	7	20	0	0	20	0	0
18	16725323	.	C	T	14	6	20	0	0	20	0	0
18	16725917	.	A	G	13	20	33	0	2	35	0	0
18	16726011	.	C	T	14	7	21	0	1	22	0	0
18	16755962	.	C	A	15	26	41	0	0	41	0	0
18	16756001	.	C	T	11	25	36	0	2	38	0	0
18	16756058	.	T	A	13	16	29	0	0	29	0	0
18	16756065	.	G	A	12	16	28	0	1	29	0	0
18	16876903	.	A	G	9	4	13	0	1	14	0	0
18	16877282	.	C	T	2	4	6	0	0	6	0	0
18	16877283	.	A	G	2	3	5	0	1	6	0	0
18	16886079	.	C	T	0	2	2	0	0	2	0	0
18	16894571	.	T	A	4	11	15	0	0	15	0	0
18	16894594	.	T	G	3	7	10	0	1	11	0	0
18	16894630	.	A	G	3	1	4	0	0	4	0	0
18	16906522	.	A	G	1	2	3	0	0	3	0	0
18	16915433	.	T	C	2	0	2	0	0	2	0	0
18	16918760	.	C	A	3	2	5	0	0	5	0	0
18	16929772	.	G	A	9	9	18	0	0	18	0	0
18	16936728	.	T	C	2	2	4	0	0	4	0	0
18	16936758	.	T	C	1	3	4	0	0	4	0	0
18	16936787	.	A	G	2	2	4	0	0	4	0	0
18	16950974	.	A	G	2	2	4	0	0	4	0	0
18	16961046	.	A	G	5	8	13	0	0	13	0	0
18	16962778	.	A	G	6	7	13	0	1	14	0	0
18	16962783	.	C	T	6	8	14	0	0	14	0	0
18	16962823	.	C	T	2	1	3	0	0	3	0	0
18	16963091	.	C	G	4	6	10	0	0	10	0	0
18	16966911	.	T	C	6	4	10	0	0	10	0	0
18	16968314	.	T	C	7	9	16	0	1	17	0	0
18	16970387	.	A	G	3	6	9	0	0	9	0	0
18	16970455	.	A	T	14	6	20	0	0	20	0	0
18	16970459	.	G	A	0	6	6	0	14	20	0	0
18	16970997	.	G	C	1	9	10	0	18	28	0	0
18	16971129	.	C	T	11	16	27	0	0	27	0	0
18	16971155	.	A	T	8	11	19	0	0	19	0	0
18	16989846	.	A	C	3	3	6	0	0	6	0	0
18	16990122	.	C	T	0	7	7	0	5	12	0	0
18	16990150	.	G	T	9	3	12	0	0	12	0	0
18	16990385	.	A	C	3	0	3	0	3	6	0	0
18	16990520	.	C	T	3	1	4	0	0	4	0	0
18	16990550	.	A	G	4	3	7	0	0	7	0	0
18	17002614	.	T	C	12	0	12	0	10	22	0	0
18	17002653	.	A	G	6	11	17	0	0	17	0	0
18	17003602	.	A	G	0	4	4	0	0	4	0	0
18	17007720	.	T	C	3	2	5	0	0	5	0	0
18	17016354	.	C	G	0	2	2	0	0	2	0	0
18	17016697	.	T	C	1	1	2	0	0	2	0	0
18	17021465	.	G	C	1	2	3	0	1	4	0	0
18	17021521	.	C	T	0	2	2	0	0	2	0	0
18	17021778	.	A	C	1	1	2	0	0	2	0	0
18	17043601	.	T	A	2	2	4	0	0	4	0	0
18	17051417	.	G	A	1	2	3	0	0	3	0	0
18	17062323	.	G	A	3	2	5	0	0	5	0	0
18	17062336	.	T	C	3	3	6	0	0	6	0	0
18	17062364	.	T	G	3	4	7	0	1	8	0	0
18	17062487	.	G	T	4	5	9	0	0	9	0	0
18	17062611	.	C	T	1	2	3	0	0	3	0	0
18	17078453	.	A	T	1	2	3	0	0	3	0	0
18	17078466	.	A	G	1	2	3	0	1	4	0	0
18	17078575	.	A	T	3	2	5	0	0	5	0	0
18	17078667	.	A	G	1	2	3	0	0	3	0	0
18	17079541	.	T	C	12	11	23	1	1	25	0	0
18	17079724	.	C	T	0	8	8	0	13	21	0	0
18	17080089	.	G	C	9	7	16	0	0	16	0	0
18	17080122	.	A	G	7	11	18	0	2	20	0	0
18	17080131	.	T	C	7	2	9	0	11	20	0	0
18	17084489	.	C	T	0	0	0	0	4	4	0	0
18	17097893	.	T	C	5	9	14	0	4	18	0	0
18	17098317	.	T	A	1	1	2	0	0	2	0	0
18	17098562	.	T	A	5	3	8	0	0	8	0	0
18	17102046	.	C	T	0	4	4	0	12	16	0	0
18	17131006	.	A	G	2	3	5	0	0	5	0	0
18	17139446	.	G	A	2	3	5	0	0	5	0	0
18	17139461	.	T	C	1	3	4	0	0	4	0	0
18	17144667	.	C	T	1	2	3	0	1	4	0	0
18	17144909	.	T	A	4	3	7	0	0	7	0	0
18	17173465	.	T	G	1	3	4	0	0	4	0	0
18	17173474	.	A	C	1	2	3	0	1	4	0	0
18	17173629	.	A	G	1	3	4	0	0	4	0	0
18	17173638	.	C	T	2	2	4	0	0	4	0	0
18	17173687	.	G	T	0	2	2	0	2	4	0	0
18	17994870	.	A	G	0	2	2	0	2	4	0	0
18	18472104	.	T	G	4	0	4	0	0	4	0	0
18	18472117	.	G	T	4	2	6	0	0	6	0	0
18	19405533	.	G	A	1	2	3	0	0	3	0	0
18	19419200	.	A	T	6	4	10	0	1	11	0	0
18	19419307	.	C	T	11	9	20	0	1	21	0	0
18	19441492	.	C	G	11	23	34	0	0	34	0	0
18	19441561	.	T	C	11	7	18	0	1	19	0	0
18	19441585	.	C	A	6	1	7	0	1	8	0	0
18	19450486	.	T	C	11	20	31	0	2	33	0	0
18	19450563	.	A	T	30	24	54	0	3	57	0	0
18	19450642	.	A	T	25	16	41	0	2	43	0	0
18	19450692	.	A	G	14	19	33	0	3	36	0	0
18	19450755	.	A	G	30	31	61	0	0	61	0	0
18	19451023	.	C	T	14	21	35	0	2	37	0	0
18	19451117	.	C	T	10	13	23	0	3	26	0	0
18	19451427	.	G	A	26	15	41	0	1	42	0	0
18	19451430	.	T	C	24	4	28	0	14	42	0	0
18	19451477	.	G	A	20	23	43	0	1	44	0	0
18	19452126	.	T	A	10	13	23	0	1	24	0	0
18	19452594	.	G	A	19	21	40	0	2	42	0	0
18	19452639	.	A	G	18	18	36	0	1	37	0	0
18	19487779	.	G	A	19	8	27	0	1	28	0	0
18	19490515	.	C	T	5	15	20	0	1	21	0	0
18	19648878	.	T	C	2	5	7	0	0	7	0	0
18	19698539	.	C	T	2	2	4	0	0	4	0	0
18	19698833	.	T	C	4	5	9	0	2	11	0	0
18	19698854	.	G	A	3	5	8	0	0	8	0	0
18	19805440	.	T	C	6	2	8	0	0	8	0	0
18	19805464	.	C	T	6	3	9	0	0	9	0	0
18	19812874	.	T	C	4	3	7	0	1	8	0	0
18	19812943	.	A	T	5	11	16	0	2	18	0	0
18	19813002	.	A	G	7	13	20	0	0	20	0	0
18	19814181	.	A	G	1	0	1	0	0	1	0	0
18	19815743	.	A	T	2	2	4	0	0	4	0	0
18	19817682	.	G	A	6	3	9	0	0	9	0	0
18	19819719	.	C	A	4	6	10	0	0	10	0	0
18	19883812	.	G	T	0	5	5	0	6	11	0	0
18	19981553	.	G	A	4	7	11	0	0	11	0	0
18	19981584	.	C	T	4	3	7	0	0	7	0	0
18	20006910	.	C	T	5	2	7	0	1	8	0	0
18	20022806	.	T	C	0	3	3	0	1	4	0	0
18	20024856	.	T	C	0	1	1	0	0	1	0	0
18	20024889	.	G	A	4	5	9	0	0	9	0	0
18	20031708	.	T	G	1	2	3	0	0	3	0	0
18	20041825	.	T	C	1	0	1	0	0	1	0	0
18	20042088	.	C	T	18	9	27	0	0	27	0	0
18	20044847	.	T	C	5	15	20	0	0	20	0	0
18	20045197	.	T	C	3	2	5	0	0	5	0	0
18	20468514	.	G	T	1	2	3	0	5	8	0	0
18	20479008	.	A	G	8	7	15	0	1	16	0	0
18	20482805	.	C	T	1	2	3	0	0	3	0	0
18	20482849	.	C	T	2	2	4	0	0	4	0	0
18	20488465	.	G	C	1	1	2	0	0	2	0	0
18	20488492	.	C	T	2	2	4	0	0	4	0	0
18	20490510	.	A	T	3	4	7	0	0	7	0	0
18	20521344	.	A	G	1	2	3	0	0	3	0	0
18	20521431	.	A	T	1	3	4	0	0	4	0	0
18	20521515	.	C	G	2	2	4	0	0	4	0	0
18	20521558	.	T	G	3	2	5	0	0	5	0	0
18	20532660	.	G	A	1	5	6	0	0	6	0	0
18	20535074	.	T	A	4	5	9	0	0	9	0	0
18	20539548	.	G	A	0	11	11	0	8	19	0	0
18	20539703	.	T	A	2	3	5	0	0	5	0	0
18	20539844	.	T	A	1	5	6	0	1	7	0	0
18	20539979	.	T	A	6	6	12	0	1	13	0	0
18	20540144	.	G	A	0	6	6	0	1	7	0	0
18	20540313	.	G	T	3	4	7	0	0	7	0	0
18	20540581	.	G	T	3	5	8	0	0	8	0	0
18	20540606	.	A	T	2	5	7	0	0	7	0	0
18	20541575	.	A	C	7	11	18	0	0	18	0	0
18	20541863	.	C	G	2	2	4	0	0	4	0	0
18	20542214	.	A	T	9	7	16	0	0	16	0	0
18	20542503	.	G	A	13	11	24	0	1	25	0	0
18	20542526	.	G	A	15	7	22	0	2	24	0	0
18	20542562	.	T	G	20	7	27	0	0	27	0	0
18	20542581	.	A	G	14	7	21	0	2	23	0	0
18	20542647	.	C	T	2	15	17	0	0	17	0	0
18	20542899	.	T	A	6	14	20	0	0	20	0	0
18	20542929	.	T	C	8	13	21	0	0	21	0	0
18	20542988	.	T	G	8	11	19	0	0	19	0	0
18	20544883	.	G	A	5	2	7	0	0	7	0	0
18	20544901	.	G	C	4	5	9	0	0	9	0	0
18	20559571	.	G	A	7	4	11	0	0	11	0	0
18	20582413	.	T	A	8	5	13	0	1	14	0	0
18	20582629	.	T	C	5	9	14	0	1	15	0	0
18	20582943	.	G	A	3	3	6	0	1	7	0	0
18	20583398	.	C	T	2	4	6	0	0	6	0	0
18	20583551	.	T	C	2	0	2	0	2	4	0	0
18	20583610	.	A	T	3	3	6	0	0	6	0	0
18	20583639	.	A	G	4	2	6	0	0	6	0	0
18	20583763	.	A	G	5	11	16	0	0	16	0	0
18	20583820	.	A	T	3	6	9	0	0	9	0	0
18	20584077	.	G	A	2	4	6	0	1	7	0	0
18	20584098	.	T	A	3	4	7	0	0	7	0	0
18	20584336	.	T	G	4	4	8	0	2	10	0	0
18	20584797	.	G	A	3	2	5	0	0	5	0	0
18	20584801	.	C	T	3	3	6	0	0	6	0	0
18	20585314	.	C	T	4	5	9	0	0	9	0	0
18	20585435	.	T	C	9	0	9	0	5	14	0	0
18	20585495	.	C	T	1	6	7	0	0	7	0	0
18	20585532	.	T	C	2	3	5	0	0	5	0	0
18	20585561	.	T	C	2	2	4	0	1	5	0	0
18	20726232	.	T	C	21	3	24	0	25	49	0	0
18	20730583	.	G	A	10	12	22	0	0	22	0	0
18	20735371	.	C	T	16	9	25	0	3	28	0	0
18	20735413	.	C	T	3	11	14	0	15	29	0	0
18	20738244	.	T	A	4	3	7	0	0	7	0	0
18	20738262	.	A	G	6	4	10	0	0	10	0	0
18	20738298	.	G	A	12	4	16	0	0	16	0	0
18	20738383	.	G	A	3	3	6	0	0	6	0	0
18	20739298	.	C	T	1	6	7	0	0	7	0	0
18	20742025	.	G	A	7	4	11	0	0	11	0	0
18	20752879	.	C	T	0	3	3	0	2	5	0	0
18	20755854	.	T	A	5	11	16	0	0	16	0	0
18	20760425	.	C	T	8	8	16	0	0	16	0	0
18	20768686	.	C	T	9	12	21	0	1	22	0	0
18	20768818	.	T	A	4	4	8	0	0	8	0	0
18	20771078	.	T	C	2	0	2	0	3	5	0	0
18	20771085	.	A	G	3	2	5	0	0	5	0	0
18	20853080	.	C	T	0	1	1	0	0	1	0	0
18	20853084	.	T	A	0	1	1	0	0	1	0	0
18	20853339	.	C	T	1	2	3	0	0	3	0	0
18	20859790	.	A	G	7	6	13	0	0	13	0	0
18	20859802	.	A	G	6	6	12	0	0	12	0	0
18	20860321	.	C	T	1	3	4	0	0	4	0	0
18	20861620	.	G	A	1	2	3	0	0	3	0	0
18	20868503	.	C	G	1	2	3	0	0	3	0	0
18	20881800	.	G	A	2	5	7	0	0	7	0	0
18	20882017	.	C	T	2	4	6	0	0	6	0	0
18	20882098	.	C	T	1	2	3	0	0	3	0	0
18	20882195	.	T	A	2	5	7	0	1	8	0	0
18	20883141	.	A	G	3	3	6	0	0	6	0	0
18	20914388	.	C	T	1	2	3	0	0	3	0	0
18	20917352	.	T	C	1	2	3	0	0	3	0	0
18	21071085	.	A	G	3	0	3	0	3	6	0	0
18	21102019	.	A	C	5	9	14	0	1	15	0	0
18	21102023	.	C	T	1	10	11	0	4	15	0	0
18	21102764	.	C	T	0	6	6	0	6	12	0	0
18	21102914	.	G	A	4	6	10	0	0	10	0	0
18	21102994	.	G	A	1	3	4	0	0	4	0	0
18	21102995	.	A	T	1	3	4	0	0	4	0	0
18	21103043	.	G	A	1	2	3	0	0	3	0	0
18	21103079	.	G	A	3	4	7	0	0	7	0	0
18	21103274	.	G	A	1	2	3	0	0	3	0	0
18	21105722	.	G	A	3	4	7	0	0	7	0	0
18	21105927	.	A	G	4	2	6	0	0	6	0	0
18	21105945	.	G	A	2	3	5	0	0	5	0	0
18	21113462	.	T	A	4	2	6	0	0	6	0	0
18	21114475	.	T	C	2	4	6	0	0	6	0	0
18	21116381	.	C	A	4	5	9	0	0	9	0	0
18	21117801	.	C	T	9	10	19	0	0	19	0	0
18	21118232	.	C	G	9	10	19	0	0	19	0	0
18	21119498	.	G	A	5	6	11	0	2	13	0	0
18	21119654	.	G	A	7	7	14	0	1	15	0	0
18	21119751	.	C	T	14	21	35	0	1	36	0	0
18	21119854	.	T	C	7	7	14	0	2	16	0	0
18	21123001	.	A	G	6	1	7	0	5	12	0	0
18	21136948	.	C	T	7	4	11	0	0	11	0	0
18	21143473	.	A	T	15	19	34	0	1	35	0	0
18	21143938	.	C	G	16	11	27	0	1	28	0	0
18	21143998	.	C	T	13	15	28	0	3	31	0	0
18	21144005	.	C	A	15	16	31	0	1	32	0	0
18	21144060	.	G	A	0	17	17	0	21	38	0	0
18	21144656	.	C	T	1	3	4	0	0	4	0	0
18	21144748	.	T	C	2	5	7	0	0	7	0	0
18	21144758	.	C	A	2	5	7	0	0	7	0	0
18	21144800	.	A	T	1	2	3	0	0	3	0	0
18	21144823	.	C	A	6	4	10	0	0	10	0	0
18	21144852	.	A	G	14	8	22	0	0	22	0	0
18	21144880	.	G	T	12	14	26	0	2	28	0	0
18	21144985	.	C	T	7	5	12	0	0	12	0	0
18	21145142	.	A	G	12	7	19	0	2	21	0	0
18	21145290	.	G	T	7	8	15	0	1	16	0	0
18	21178836	.	C	T	3	7	10	0	0	10	0	0
18	21179135	.	T	C	3	7	10	0	0	10	0	0
18	21179158	.	G	C	8	7	15	0	0	15	0	0
18	21179181	.	A	T	7	7	14	0	0	14	0	0
18	21179228	.	G	C	2	5	7	0	0	7	0	0
18	21179369	.	T	C	15	16	31	0	0	31	0	0
18	21179484	.	G	A	10	18	28	0	0	28	0	0
18	21179566	.	T	C	12	11	23	0	0	23	0	0
18	21179709	.	A	C	8	3	11	0	0	11	0	0
18	21179730	.	A	G	4	8	12	0	2	14	0	0
18	21182879	.	A	G	3	1	4	0	0	4	0	0
18	21185167	.	A	G	1	2	3	0	0	3	0	0
18	21198961	.	G	T	17	22	39	0	1	40	0	0
18	21199165	.	G	T	14	10	24	0	1	25	0	0
18	21257600	.	A	T	11	5	16	0	2	18	0	0
18	21257623	.	A	G	7	6	13	0	1	14	0	0
18	21257757	.	G	A	10	8	18	0	0	18	0	0
18	21257786	.	G	A	11	12	23	0	0	23	0	0
18	21257816	.	G	T	9	9	18	0	1	19	0	0
18	21257946	.	C	T	10	13	23	0	0	24	1	0
18	21257951	.	T	A	14	8	22	0	1	23	0	0
18	21258083	.	G	A	5	13	18	0	0	18	0	0
18	21263268	.	C	T	0	2	2	0	0	2	0	0
18	21399913	.	T	A	0	2	2	0	1	3	0	0
18	21400455	.	C	A	3	2	5	0	0	5	0	0
18	21409113	.	A	T	5	1	6	0	0	6	0	0
18	21492325	.	T	C	9	7	16	0	0	16	0	0
18	21617864	.	G	A	1	18	19	0	30	49	0	0
18	21618343	.	C	T	26	20	46	0	0	46	0	0
18	21618379	.	A	G	26	19	45	0	1	46	0	0
18	21618496	.	G	A	17	24	41	0	1	42	0	0
18	21618659	.	C	A	11	14	25	0	0	25	0	0
18	21618731	.	G	T	25	22	47	0	1	48	0	0
18	21618910	.	G	T	21	26	47	0	3	50	0	0
18	21619011	.	C	T	12	25	37	0	2	39	0	0
18	21619018	.	A	T	13	25	38	0	2	40	0	0
18	21619055	.	G	T	17	21	38	0	4	42	0	0
18	21619260	.	C	T	19	20	39	0	2	41	0	0
18	21619284	.	G	T	21	15	36	0	1	37	0	0
18	21619672	.	A	G	11	18	29	0	1	30	0	0
18	21619686	.	G	A	10	11	21	0	1	23	1	0
18	21619777	.	A	G	25	7	32	0	1	33	0	0
18	21619799	.	T	G	28	15	43	0	2	45	0	0
18	21619948	.	C	T	23	21	44	1	2	47	0	0
18	21620082	.	A	T	27	13	40	0	1	41	0	0
18	21620376	.	A	C	26	24	50	0	0	50	0	0
18	21620426	.	G	A	2	26	28	0	16	45	1	0
18	21645492	.	G	A	11	10	21	0	1	22	0	0
18	21645627	.	A	G	12	9	21	0	0	21	0	0
18	21645902	.	G	C	17	0	17	0	14	31	0	0
18	21645965	.	G	A	8	8	16	0	0	16	0	0
18	21645989	.	T	G	1	7	8	0	0	8	0	0
18	21647419	.	T	C	1	2	3	0	1	4	0	0
18	21648582	.	A	G	8	8	16	0	0	16	0	0
18	21648627	.	C	T	4	3	7	0	0	7	0	0
18	21648633	.	A	T	4	2	6	0	0	6	0	0
18	21653937	.	C	T	7	12	19	0	0	19	0	0
18	21654124	.	A	C	2	1	3	0	4	7	0	0
18	21654145	.	C	T	3	7	10	0	0	10	0	0
18	21654375	.	C	A	3	1	4	0	0	4	0	0
18	21654432	.	T	C	7	5	12	0	1	13	0	0
18	21654489	.	C	T	4	3	7	0	0	7	0	0
18	21656271	.	C	A	3	2	5	0	1	6	0	0
18	21656274	.	G	A	2	4	6	0	0	6	0	0
18	21656537	.	T	C	4	1	5	0	1	6	0	0
18	21656605	.	C	T	0	1	1	0	0	1	0	0
18	21657642	.	T	G	3	3	6	0	0	6	0	0
18	21662298	.	C	T	0	1	1	0	2	3	0	0
18	21662301	.	C	A	1	2	3	0	0	3	0	0
18	21674320	.	G	T	3	4	7	0	0	7	0	0
18	21678723	.	G	A	3	4	7	0	1	8	0	0
18	21689043	.	G	C	3	3	6	0	0	6	0	0
18	21689052	.	A	G	4	4	8	0	0	8	0	0
18	21689079	.	G	A	9	4	13	0	0	13	0	0
18	21693120	.	A	G	3	1	4	0	2	6	0	0
18	21693213	.	G	A	3	8	11	0	1	12	0	0
18	21693441	.	G	A	3	2	5	0	0	5	0	0
18	21697776	.	C	T	0	8	8	0	1	9	0	0
18	21698855	.	G	T	4	4	8	0	1	9	0	0
18	21725161	.	G	T	1	2	3	0	0	3	0	0
18	21782445	.	T	G	5	2	7	0	0	7	0	0
18	21782467	.	A	C	1	4	5	0	0	5	0	0
18	21782500	.	A	G	2	3	5	0	0	5	0	0
18	21782506	.	G	C	2	3	5	0	0	5	0	0
18	21782908	.	G	A	3	3	6	0	0	6	0	0
18	21783257	.	G	T	1	6	7	0	0	7	0	0
18	21783279	.	G	A	4	3	7	0	0	7	0	0
18	21783325	.	A	T	3	3	6	0	0	6	0	0
18	21783368	.	G	A	4	2	6	0	0	6	0	0
18	21784127	.	T	C	2	3	5	0	0	5	0	0
18	21796094	.	G	A	3	2	5	0	1	6	0	0
18	21860755	.	C	T	8	5	13	0	0	13	0	0
18	21861134	.	T	A	10	12	22	0	0	22	0	0
18	21861225	.	T	A	16	12	28	0	0	28	0	0
18	21861381	.	G	T	5	12	17	0	1	18	0	0
18	21861497	.	A	T	7	4	11	0	1	12	0	0
18	21861688	.	C	A	9	3	12	0	0	12	0	0
18	21862000	.	G	C	11	5	16	0	2	18	0	0
18	21862076	.	C	T	0	7	7	0	4	11	0	0
18	21862141	.	T	C	5	0	5	0	7	12	0	0
18	21862175	.	C	T	0	7	7	0	3	10	0	0
18	21862237	.	G	T	5	6	11	0	2	13	0	0
18	21880098	.	T	C	9	0	9	0	7	16	0	0
18	21880191	.	T	C	0	0	0	0	4	4	0	0
18	21888256	.	C	T	0	2	2	0	0	2	0	0
18	21891024	.	G	T	2	2	4	0	0	4	0	0
18	21900940	.	A	G	1	1	2	0	1	3	0	0
18	21900961	.	G	A	1	2	3	0	0	3	0	0
18	21913799	.	A	T	12	8	20	0	2	22	0	0
18	21913907	.	G	C	17	12	29	0	0	29	0	0
18	21913988	.	C	A	8	12	20	0	0	20	0	0
18	21914018	.	C	A	10	11	21	0	2	23	0	0
18	21914225	.	C	T	0	15	15	0	15	30	0	0
18	21914281	.	G	A	10	9	19	0	0	19	0	0
18	21914283	.	C	A	10	9	19	0	0	19	0	0
18	21941285	.	A	T	0	2	2	0	0	2	0	0
18	21983530	.	G	C	0	2	2	0	1	3	0	0
18	22002476	.	G	A	2	6	8	0	0	8	0	0
18	22002508	.	C	T	2	6	8	0	1	9	0	0
18	22029828	.	A	C	2	0	2	0	6	8	0	0
18	22030435	.	C	T	5	3	8	0	0	8	0	0
18	22030967	.	G	A	6	3	9	0	0	9	0	0
18	22030995	.	A	C	5	5	10	0	0	10	0	0
18	22031018	.	T	G	3	6	9	0	0	9	0	0
18	22082366	.	T	C	1	7	8	0	0	8	0	0
18	22255005	.	C	T	0	2	2	0	0	2	0	0
18	22261064	.	C	A	2	3	5	0	0	5	0	0
18	22272969	.	C	A	11	6	17	0	0	17	0	0
18	22275051	.	T	C	3	4	7	0	1	8	0	0
18	22282766	.	A	T	16	8	24	0	1	25	0	0
18	22282809	.	A	T	13	15	28	0	0	28	0	0
18	22282923	.	G	T	11	12	23	0	2	25	0	0
18	22282960	.	C	T	10	10	20	0	1	21	0	0
18	22282961	.	A	G	11	9	20	0	1	21	0	0
18	22283087	.	C	A	13	5	18	0	1	19	0	0
18	22283116	.	T	A	7	6	13	0	0	13	0	0
18	22288650	.	T	C	6	3	9	0	0	9	0	0
18	22288659	.	C	T	5	3	8	0	0	8	0	0
18	22289075	.	T	C	7	7	14	0	2	16	0	0
18	22289314	.	C	T	5	6	11	0	0	11	0	0
18	22290900	.	G	A	6	6	12	0	2	14	0	0
18	22290933	.	C	T	12	11	23	0	1	24	0	0
18	22292215	.	A	T	15	13	28	0	0	28	0	0
18	22292286	.	G	A	14	16	30	0	1	31	0	0
18	22292339	.	A	T	13	15	28	0	2	30	0	0
18	22293129	.	G	T	1	2	3	0	0	3	0	0
18	22293191	.	T	G	5	2	7	0	0	7	0	0
18	22356989	.	C	T	14	13	27	0	0	27	0	0
18	22377096	.	A	T	14	25	39	0	2	41	0	0
18	22377372	.	G	A	1	24	25	0	25	50	0	0
18	22377471	.	C	T	23	16	39	0	1	40	0	0
18	22385900	.	G	A	22	23	45	0	6	51	0	0
18	22405895	.	A	T	4	3	7	0	0	7	0	0
18	22406162	.	C	T	0	2	2	0	2	4	0	0
18	22406187	.	T	A	2	4	6	0	0	6	0	0
18	22406311	.	T	A	6	4	10	0	1	11	0	0
18	22406324	.	G	A	3	6	9	0	0	9	0	0
18	22406375	.	T	A	2	6	8	0	0	8	0	0
18	22406379	.	G	A	6	2	8	0	0	8	0	0
18	22406591	.	A	C	1	6	7	0	0	7	0	0
18	22406797	.	A	T	2	7	9	0	1	10	0	0
18	22406973	.	T	C	1	2	3	0	0	3	0	0
18	22407365	.	C	T	0	4	4	0	1	5	0	0
18	22410983	.	G	A	0	1	1	0	0	1	0	0
18	22417058	.	C	T	4	5	9	0	2	11	0	0
18	22417082	.	G	A	0	5	5	0	8	13	0	0
18	22417103	.	C	A	3	5	8	0	0	8	0	0
18	22420551	.	A	T	3	2	5	0	0	5	0	0
18	22420558	.	C	A	3	2	5	0	0	5	0	0
18	22424532	.	T	C	1	3	4	0	0	4	0	0
18	22424536	.	A	G	1	0	1	0	4	5	0	0
18	22424601	.	A	G	5	0	5	0	8	13	0	0
18	22486579	.	A	T	5	5	10	0	1	11	0	0
18	22669708	.	C	G	2	2	4	0	0	4	0	0
18	22679339	.	C	T	2	2	4	0	0	4	0	0
18	22679684	.	G	A	3	4	7	0	0	7	0	0
18	22679834	.	C	T	1	3	4	0	0	4	0	0
18	22679852	.	C	T	1	3	4	0	1	5	0	0
18	22685266	.	G	A	0	6	6	0	12	18	0	0
18	22685278	.	C	T	9	6	15	0	1	16	0	0
18	22685329	.	T	C	9	7	16	0	1	17	0	0
18	22685380	.	A	T	14	5	19	0	0	19	0	0
18	22685608	.	C	A	10	8	18	0	0	18	0	0
18	22686269	.	A	T	7	6	13	0	0	13	0	0
18	22686320	.	G	A	3	4	7	0	0	7	0	0
18	22686358	.	G	A	5	3	8	0	1	9	0	0
18	22686588	.	C	A	1	8	9	0	0	9	0	0
18	22686723	.	C	T	9	3	12	0	0	12	0	0
18	22686789	.	G	A	8	5	13	0	1	15	1	0
18	22686795	.	C	G	9	9	18	0	0	18	0	0
18	22686927	.	G	A	0	7	7	0	0	7	0	0
18	22687312	.	G	A	12	8	20	0	2	22	0	0
18	22687527	.	G	C	9	20	29	0	0	29	0	0
18	22687575	.	T	A	15	28	43	0	0	43	0	0
18	22687599	.	A	T	24	15	39	0	0	39	0	0
18	22687666	.	C	T	17	25	42	0	0	42	0	0
18	22728794	.	A	G	0	2	2	0	0	2	0	0
18	22732391	.	A	G	3	0	3	0	1	4	0	0
18	22921942	.	C	T	17	19	36	0	1	37	0	0
18	22921950	.	T	C	19	18	37	0	0	37	0	0
18	22975090	.	T	C	25	33	58	0	0	58	0	0
18	22975297	.	A	C	26	27	53	0	3	56	0	0
18	23070059	.	T	C	1	2	3	0	0	3	0	0
18	23071243	.	G	A	1	3	4	0	1	5	0	0
18	23071467	.	C	G	2	0	2	0	4	6	0	0
18	23071744	.	C	A	1	4	5	0	0	5	0	0
18	23071849	.	G	A	3	3	6	0	0	6	0	0
18	23071884	.	A	C	4	2	6	0	1	7	0	0
18	23072164	.	G	A	2	4	6	0	0	6	0	0
18	23072326	.	A	G	2	0	2	0	5	7	0	0
18	23200303	.	G	A	0	1	1	0	0	1	0	0
18	23249388	.	G	A	0	0	0	0	1	1	0	0
18	23869134	.	C	T	23	23	46	0	0	46	0	0
18	23869784	.	T	A	22	23	45	0	2	47	0	0
18	23870092	.	G	A	20	17	37	0	1	38	0	0
18	23870837	.	C	T	11	10	21	0	2	23	0	0
18	24922149	.	G	A	3	1	4	0	1	5	0	0
18	24929460	.	G	A	0	17	17	0	8	25	0	0
18	24929465	.	T	C	17	9	26	0	1	27	0	0
18	24930189	.	G	A	10	8	18	0	5	23	0	0
18	24930530	.	T	C	10	18	28	0	0	28	0	0
18	24930758	.	T	C	16	13	29	0	1	30	0	0
18	24931044	.	T	A	17	25	42	0	0	42	0	0
18	24931634	.	A	G	23	28	51	0	0	51	0	0
18	24931660	.	G	T	25	21	46	0	2	48	0	0
18	24934333	.	A	T	9	6	15	0	0	15	0	0
18	24934456	.	G	A	18	17	35	0	0	35	0	0
18	24934692	.	C	A	5	9	14	0	1	15	0	0
18	24935099	.	A	G	17	9	26	0	0	26	0	0
18	24938712	.	A	G	3	5	8	0	0	8	0	0
18	24938805	.	A	G	10	11	21	0	0	21	0	0
18	24938871	.	T	C	7	9	16	0	0	16	0	0
18	24938919	.	C	T	3	3	6	0	0	6	0	0
18	24944039	.	A	T	5	3	8	0	0	8	0	0
18	24944045	.	T	C	4	1	5	0	0	5	0	0
18	24946727	.	T	A	3	1	4	0	0	4	0	0
18	24947618	.	G	A	9	3	12	0	0	12	0	0
18	24952245	.	T	G	6	6	12	0	0	12	0	0
18	24966110	.	G	A	4	6	10	0	0	10	0	0
18	24968639	.	C	T	1	0	1	0	0	1	0	0
18	24969445	.	A	G	4	2	6	0	0	6	0	0
18	24984682	.	T	A	3	2	5	0	0	5	0	0
18	24988707	.	T	A	2	4	6	0	0	6	0	0
18	24989420	.	G	A	3	2	5	0	0	5	0	0
18	24989427	.	G	T	3	2	5	0	0	5	0	0
18	24990291	.	A	T	1	2	3	0	0	3	0	0
18	25003359	.	A	T	10	7	17	0	0	17	0	0
18	25003448	.	G	C	11	11	22	0	0	22	0	0
18	25009326	.	C	A	9	12	21	0	1	22	0	0
18	25009352	.	G	A	12	9	21	0	0	21	0	0
18	25009487	.	A	G	1	5	6	0	0	6	0	0
18	25027620	.	C	T	1	2	3	0	0	3	0	0
18	25027675	.	T	A	1	2	3	0	0	3	0	0
18	25027750	.	C	G	1	2	3	0	0	3	0	0
18	25596602	.	G	A	1	2	3	0	0	3	0	0
18	25754551	.	G	A	5	9	14	0	0	14	0	0
18	25754580	.	G	T	5	5	10	0	0	10	0	0
18	25754770	.	G	A	0	2	2	0	2	4	0	0
18	25783752	.	G	A	2	3	5	0	0	5	0	0
18	25783992	.	C	T	1	2	3	0	1	4	0	0
18	25784146	.	C	A	0	2	2	0	1	3	0	0
18	26089004	.	G	C	1	5	6	0	0	6	0	0
18	26089254	.	A	T	2	6	8	0	0	8	0	0
18	26089305	.	G	C	3	2	5	0	1	6	0	0
18	26089657	.	C	T	2	3	5	0	0	5	0	0
18	26094421	.	C	T	7	9	16	0	0	16	0	0
18	26094491	.	A	C	3	8	11	0	0	11	0	0
18	26097091	.	G	T	35	36	71	0	1	72	0	0
18	26097428	.	G	A	9	14	23	0	2	25	0	0
18	26125983	.	A	G	0	4	4	0	1	5	0	0
18	26126046	.	C	T	3	3	6	0	1	7	0	0
18	26362401	.	A	G	2	3	5	0	0	5	0	0
18	26393716	.	C	A	6	3	9	0	0	9	0	0
18	26401680	.	T	C	19	16	35	0	1	36	0	0
18	26401719	.	T	C	23	15	38	0	1	39	0	0
18	26401743	.	C	T	15	20	35	0	2	37	0	0
18	26405271	.	G	A	8	15	23	0	0	23	0	0
18	26422751	.	G	C	0	1	1	0	0	1	0	0
18	26444942	.	C	T	0	1	1	0	1	2	0	0
18	26460594	.	G	A	5	4	9	0	0	9	0	0
18	26460822	.	G	C	5	5	10	0	0	10	0	0
18	26460846	.	C	A	4	5	9	0	2	11	0	0
18	26474249	.	A	G	0	1	1	0	0	1	0	0
18	26476133	.	C	T	2	0	2	0	0	2	0	0
18	26790510	.	A	T	7	4	11	0	0	11	0	0
18	26800148	.	A	C	10	12	22	0	1	23	0	0
18	26800167	.	C	G	7	15	22	0	0	22	0	0
18	26804218	.	G	A	4	3	7	0	0	7	0	0
18	26804233	.	T	A	3	3	6	0	0	6	0	0
18	26807229	.	T	A	1	1	2	0	0	2	0	0
18	26807304	.	C	T	2	4	6	0	0	6	0	0
18	26809791	.	G	T	0	3	3	0	0	3	0	0
18	26810073	.	G	A	1	2	3	0	0	3	0	0
18	26810434	.	G	C	3	4	7	0	0	7	0	0
18	26870137	.	G	A	3	1	4	0	0	4	0	0
18	26876449	.	A	C	3	2	5	0	0	5	0	0
18	26896160	.	G	C	0	4	4	0	8	12	0	0
18	26896277	.	T	C	8	7	15	0	0	15	0	0
18	26896571	.	C	T	6	8	14	0	1	15	0	0
18	26899453	.	T	C	3	6	9	0	1	10	0	0
18	26919226	.	C	T	14	10	24	1	1	27	1	0
18	26919227	.	T	A	13	8	21	1	5	27	0	0
18	26919865	.	T	C	8	10	18	0	2	20	0	0
18	26919989	.	T	A	23	24	47	0	2	49	0	0
18	26920116	.	T	C	3	5	8	0	0	8	0	0
18	26968799	.	G	A	4	2	6	0	1	7	0	0
18	26971513	.	G	A	5	2	7	0	0	7	0	0
18	26977226	.	T	C	1	1	2	0	0	2	0	0
18	27063668	.	G	A	0	1	1	0	0	1	0	0
18	27080725	.	T	A	3	1	4	0	1	5	0	0
18	27081050	.	C	T	2	2	4	0	1	5	0	0
18	27081056	.	T	C	3	2	5	0	0	5	0	0
18	27081199	.	G	C	1	3	4	0	0	4	0	0
18	27085023	.	A	C	4	3	7	0	0	7	0	0
18	27085060	.	A	G	5	4	9	0	0	9	0	0
18	27085217	.	A	T	2	4	6	0	0	6	0	0
18	27085467	.	T	G	1	2	3	0	0	3	0	0
18	27085541	.	A	G	3	1	4	0	0	4	0	0
18	27085544	.	C	A	2	1	3	0	0	3	0	0
18	27254709	.	A	C	2	2	4	0	0	4	0	0
18	27254726	.	T	C	2	2	4	0	0	4	0	0
18	27254774	.	T	C	1	3	4	0	0	4	0	0
18	27254790	.	T	A	1	2	3	0	1	4	0	0
18	27254998	.	T	A	2	4	6	0	0	6	0	0
18	27281673	.	T	G	1	3	4	0	0	4	0	0
18	27281679	.	A	G	1	0	1	0	3	4	0	0
18	27283304	.	C	T	1	3	4	0	0	4	0	0
18	27309512	.	T	C	2	5	7	0	3	10	0	0
18	27309873	.	C	T	17	16	33	0	0	33	0	0
18	27335583	.	T	C	4	11	15	0	2	17	0	0
18	27335597	.	G	A	5	14	19	0	1	20	0	0
18	27335780	.	A	T	3	13	16	0	0	16	0	0
18	27335935	.	T	A	2	7	9	0	1	10	0	0
18	27340996	.	A	T	2	2	4	0	0	4	0	0
18	27341313	.	G	A	1	2	3	0	0	3	0	0
18	27341433	.	A	G	0	2	2	0	1	3	0	0
18	27358388	.	A	C	6	3	9	0	0	9	0	0
18	27358537	.	C	T	5	2	7	0	0	7	0	0
18	27358538	.	C	T	5	2	7	0	0	7	0	0
18	27358709	.	A	G	1	3	4	0	1	5	0	0
18	27439981	.	T	A	0	0	0	0	1	1	0	0
18	27568338	.	A	G	20	4	24	0	0	24	0	0
18	27568352	.	A	G	16	7	23	0	1	24	0	0
18	27993759	.	A	G	4	0	4	0	2	6	0	0
18	27993766	.	A	G	3	2	5	0	1	6	0	0
18	33729770	.	G	A	1	3	4	0	0	4	0	0
18	33729779	.	C	T	1	3	4	0	0	4	0	0
18	34213302	.	T	G	2	0	2	0	9	11	0	0
18	34214686	.	G	A	9	5	14	0	1	15	0	0
18	34214687	.	A	G	11	3	14	0	1	15	0	0
18	36869676	.	A	G	16	9	25	0	2	27	0	0
18	36869677	.	A	G	12	14	26	0	1	27	0	0
18	39523002	.	T	C	1	4	5	0	0	5	0	0
18	40379477	.	G	T	0	2	2	0	1	3	0	0
18	40379516	.	C	T	1	2	3	0	0	3	0	0
18	40379560	.	C	T	1	2	3	0	0	3	0	0
18	40382019	.	A	G	0	0	0	0	1	1	0	0
18	40383282	.	T	A	5	7	12	0	0	12	0	0
18	40383665	.	T	A	6	2	8	0	0	8	0	0
18	40384022	.	G	T	0	9	9	0	12	21	0	0
18	40384160	.	C	T	8	5	13	0	0	13	0	0
18	40384214	.	T	C	5	5	10	0	1	11	0	0
18	40384253	.	A	G	5	3	8	0	0	8	0	0
18	40384277	.	T	A	5	3	8	0	0	8	0	0
18	40387506	.	C	T	13	11	24	0	1	25	0	0
18	40387606	.	G	A	9	8	17	0	0	17	0	0
18	40387650	.	T	A	10	13	23	0	0	23	0	0
18	40387811	.	T	A	4	10	14	0	1	15	0	0
18	40467937	.	A	T	2	2	4	0	1	5	0	0
18	40467944	.	G	A	3	2	5	0	0	5	0	0
18	40476605	.	A	T	1	1	2	0	1	3	0	0
18	40476793	.	C	A	2	2	4	0	0	4	0	0
18	40486632	.	A	G	6	4	10	0	0	10	0	0
18	40489539	.	G	A	1	7	8	0	1	9	0	0
18	40492253	.	T	C	10	7	17	0	1	18	0	0
18	41278299	.	G	A	0	2	2	0	0	2	0	0
18	41278644	.	T	C	0	1	1	0	0	1	0	0
18	41284700	.	C	T	3	2	5	0	0	5	0	0
18	41293901	.	A	T	1	2	3	0	0	3	0	0
18	41295246	.	C	T	3	4	7	0	0	7	0	0
18	41297082	.	C	T	0	2	2	0	0	2	0	0
18	41300057	.	T	G	1	0	1	0	0	1	0	0
18	41300063	.	A	G	1	0	1	0	2	3	0	0
18	41305867	.	C	T	7	8	15	0	0	15	0	0
18	41309305	.	G	A	9	7	16	0	0	16	0	0
18	41310196	.	A	G	7	0	7	0	6	13	0	0
18	41310464	.	G	A	1	14	15	0	18	33	0	0
18	41364527	.	C	G	3	6	9	0	0	9	0	0
18	41365011	.	A	G	1	4	5	0	0	5	0	0
18	41365051	.	A	T	2	5	7	0	0	7	0	0
18	41365125	.	G	A	1	3	4	0	0	4	0	0
18	41365308	.	C	T	1	2	3	0	0	3	0	0
18	41365434	.	G	A	2	5	7	0	0	7	0	0
18	41365649	.	G	T	1	4	5	0	0	5	0	0
18	41372193	.	G	A	2	2	4	0	0	4	0	0
18	41465443	.	G	A	0	2	2	0	3	5	0	0
18	41495859	.	A	G	15	15	30	0	3	34	1	0
18	41495865	.	A	T	16	13	29	0	2	31	0	0
18	41499590	.	T	C	1	1	2	0	0	2	0	0
18	41499679	.	A	G	8	13	21	1	0	22	0	0
18	41499683	.	T	C	9	13	22	1	0	23	0	0
18	41499789	.	C	T	7	11	18	0	0	19	1	0
18	41503578	.	C	A	28	17	45	0	0	45	0	0
18	41505624	.	A	G	26	0	26	0	12	38	0	0
18	41509564	.	C	G	21	6	27	0	1	28	0	0
18	41509716	.	G	T	24	7	31	0	0	31	0	0
18	41512217	.	C	T	9	8	17	0	2	19	0	0
18	41512370	.	G	A	4	5	9	0	0	9	0	0
18	41524354	.	G	A	7	13	20	0	0	20	0	0
18	41524364	.	C	A	7	13	20	0	0	20	0	0
18	41525864	.	T	C	17	18	35	0	1	36	0	0
18	41525880	.	G	A	2	17	19	0	15	34	0	0
18	41526014	.	C	G	13	0	13	0	23	36	0	0
18	41526026	.	A	G	12	20	32	0	2	34	0	0
18	41526247	.	T	A	15	23	38	0	1	39	0	0
18	41526299	.	T	A	15	12	27	0	2	29	0	0
18	41526318	.	A	G	14	15	29	0	1	30	0	0
18	41526380	.	C	T	3	9	12	0	3	15	0	0
18	41526381	.	T	C	4	7	11	0	4	15	0	0
18	41533072	.	C	T	5	6	11	0	0	11	0	0
18	41538770	.	G	A	4	16	20	0	0	20	0	0
18	41538795	.	A	G	3	18	21	0	0	21	0	0
18	41538856	.	G	A	2	8	10	0	0	10	0	0
18	41542632	.	A	G	1	5	6	0	0	6	0	0
18	41542661	.	A	T	2	4	6	0	1	7	0	0
18	41542669	.	T	A	2	5	7	0	1	8	0	0
18	41542712	.	T	C	3	2	5	0	0	5	0	0
18	41542720	.	T	G	4	1	5	0	1	6	0	0
18	41542749	.	A	T	4	3	7	0	0	7	0	0
18	41542790	.	T	G	2	3	5	0	0	5	0	0
18	41543076	.	C	T	4	11	15	0	1	16	0	0
18	41544298	.	A	G	3	0	3	0	2	5	0	0
18	41544303	.	A	G	3	2	5	0	0	5	0	0
18	41547273	.	T	G	3	4	7	0	0	7	0	0
18	41547308	.	C	T	1	2	3	0	2	5	0	0
18	41556239	.	G	A	0	1	1	0	0	1	0	0
18	41558711	.	C	T	6	2	8	0	0	8	0	0
18	41565731	.	G	A	1	1	2	0	0	2	0	0
18	41572423	.	A	C	2	2	4	0	0	4	0	0
18	41572445	.	T	C	3	3	6	0	0	6	0	0
18	41573681	.	T	C	1	3	4	0	0	4	0	0
18	41573696	.	A	G	1	6	7	0	0	7	0	0
18	41573813	.	A	G	3	0	3	0	4	7	0	0
18	41573948	.	G	A	0	2	2	0	3	5	0	0
18	41574155	.	A	G	1	3	4	0	0	4	0	0
18	41574287	.	T	C	1	3	4	0	0	4	0	0
18	41574557	.	T	C	2	5	7	0	1	8	0	0
18	41574608	.	T	C	3	5	8	0	1	9	0	0
18	41579975	.	T	A	5	2	7	0	0	7	0	0
18	41580151	.	A	T	2	7	9	0	0	9	0	0
18	41586440	.	T	C	4	5	9	0	0	9	0	0
18	41588148	.	A	G	4	0	4	0	2	6	0	0
18	41588166	.	C	T	3	0	3	0	0	3	0	0
18	41589613	.	A	C	3	5	8	0	0	8	0	0
18	41591256	.	G	T	11	4	15	0	1	16	0	0
18	41648941	.	T	C	10	12	22	0	1	23	0	0
18	41649061	.	C	T	9	11	20	0	0	20	0	0
18	41649571	.	A	G	4	6	10	0	0	10	0	0
18	41649949	.	C	T	0	7	7	0	2	9	0	0
18	41650171	.	C	T	4	6	10	0	2	12	0	0
18	41650222	.	C	T	12	6	18	0	2	20	0	0
18	41650396	.	G	A	1	6	7	0	0	7	0	0
18	41757350	.	C	A	12	14	26	0	0	26	0	0
18	41757373	.	G	C	13	15	28	0	1	29	0	0
18	41757449	.	G	A	17	25	42	0	4	46	0	0
18	41757454	.	G	A	21	25	46	0	1	47	0	0
18	41757669	.	C	T	2	6	8	0	1	9	0	0
18	41784170	.	T	C	2	2	4	0	0	4	0	0
18	42151412	.	A	C	18	0	18	0	10	28	0	0
18	42165295	.	A	C	1	1	2	0	0	2	0	0
18	42171988	.	T	C	7	0	7	0	6	13	0	0
18	42201141	.	C	G	0	1	1	0	0	1	0	0
18	42215403	.	C	T	6	3	9	0	0	9	0	0
18	42276336	.	T	C	8	5	13	0	0	13	0	0
18	42313749	.	T	C	1	3	4	0	1	5	0	0
18	42394968	.	A	G	0	0	0	0	1	1	0	0
18	43162650	.	T	C	11	12	23	0	0	23	0	0
18	43183845	.	T	C	6	5	11	0	0	11	0	0
18	43225614	.	T	C	13	19	32	0	3	35	0	0
18	43225650	.	C	T	20	20	40	0	3	43	0	0
18	43225683	.	C	T	21	20	41	0	1	42	0	0
18	43225896	.	C	T	26	19	45	0	2	47	0	0
18	44321063	.	A	G	3	8	11	0	0	11	0	0
18	44321260	.	T	A	10	6	16	0	1	17	0	0
18	44321323	.	C	T	5	3	8	0	0	8	0	0
18	44321424	.	A	C	1	2	3	0	0	3	0	0
18	44321449	.	T	C	2	2	4	0	0	4	0	0
18	44321909	.	G	A	3	6	9	0	1	10	0	0
18	44321949	.	T	C	3	7	10	0	0	10	0	0
18	44321950	.	T	C	5	5	10	0	0	10	0	0
18	44322377	.	T	C	3	3	6	0	0	6	0	0
18	44322381	.	T	A	4	3	7	0	0	7	0	0
18	44322481	.	C	T	0	9	9	0	10	19	0	0
18	44325470	.	A	G	0	1	1	0	0	1	0	0
18	44325526	.	A	T	6	5	11	0	2	13	0	0
18	44327944	.	A	G	4	7	11	0	0	11	0	0
18	44327953	.	G	A	4	3	7	0	0	7	0	0
18	44331117	.	G	C	2	3	5	0	0	5	0	0
18	44332725	.	C	T	5	5	10	0	0	10	0	0
18	44345920	.	T	C	1	0	1	0	1	2	0	0
18	44364647	.	C	A	21	26	47	0	3	50	0	0
18	44365064	.	C	A	24	43	67	0	1	68	0	0
18	44365114	.	T	A	32	23	55	0	3	58	0	0
18	44365160	.	T	C	33	18	51	0	3	54	0	0
18	44365560	.	T	C	8	18	26	0	1	27	0	0
18	44365650	.	T	C	17	21	38	0	2	40	0	0
18	44365714	.	C	A	27	30	57	0	1	58	0	0
18	44365717	.	A	G	26	28	54	0	3	57	0	0
18	44365977	.	T	C	17	23	40	0	1	41	0	0
18	44365987	.	T	A	18	20	38	0	1	39	0	0
18	44366129	.	T	C	4	20	24	0	0	24	0	0
18	44367241	.	A	T	19	22	41	0	1	42	0	0
18	44367426	.	C	T	27	19	46	0	2	48	0	0
18	44367488	.	G	A	17	10	27	0	0	27	0	0
18	44377404	.	C	A	4	2	6	0	0	6	0	0
18	44377417	.	C	T	4	1	5	0	0	5	0	0
18	44388421	.	C	T	16	11	27	0	3	30	0	0
18	44397330	.	G	A	2	3	5	0	0	5	0	0
18	44404609	.	C	T	3	5	8	0	0	8	0	0
18	44404872	.	C	T	1	1	2	0	0	2	0	0
18	44408841	.	G	A	5	6	11	0	0	11	0	0
18	44418164	.	C	T	11	8	19	0	0	19	0	0
18	44425093	.	A	G	3	4	7	0	0	7	0	0
18	44425105	.	C	T	3	5	8	0	1	9	0	0
18	44425150	.	A	C	8	11	19	0	1	20	0	0
18	44453365	.	G	A	3	2	5	0	0	5	0	0
18	44453377	.	G	C	1	0	1	0	1	3	1	0
18	44567471	.	A	C	2	2	4	0	0	4	0	0
18	44568226	.	G	T	1	2	3	0	0	3	0	0
18	44576845	.	C	T	3	2	5	0	0	5	0	0
18	44579965	.	G	A	1	1	2	0	0	2	0	0
18	44587777	.	C	A	1	0	1	0	0	1	0	0
18	44589770	.	G	C	5	2	7	0	0	7	0	0
18	44597308	.	C	A	17	30	47	0	2	49	0	0
18	44597850	.	A	G	10	13	23	0	0	23	0	0
18	44597884	.	G	A	13	10	23	0	0	23	0	0
18	44598234	.	C	T	0	16	16	0	12	28	0	0
18	44598371	.	C	T	11	10	21	0	0	21	0	0
18	44598588	.	G	A	11	4	15	0	0	15	0	0
18	44599837	.	G	A	11	1	12	0	2	14	0	0
18	44606194	.	G	A	1	1	2	0	0	2	0	0
18	44615685	.	G	A	3	6	9	0	0	9	0	0
18	44615770	.	G	A	14	15	29	0	1	30	0	0
18	44615819	.	T	C	10	10	20	0	2	22	0	0
18	44615861	.	A	T	4	3	7	0	0	7	0	0
18	44618795	.	G	T	4	9	13	0	1	14	0	0
18	44619049	.	T	G	6	13	19	0	0	19	0	0
18	44623527	.	G	A	8	8	16	0	0	16	0	0
18	44637835	.	A	T	6	6	12	0	1	13	0	0
18	44637898	.	G	A	4	4	8	0	0	8	0	0
18	44640464	.	C	T	2	1	3	0	1	4	0	0
18	44645008	.	A	T	7	8	15	0	3	18	0	0
18	44645350	.	A	G	5	0	5	0	3	8	0	0
18	44645368	.	T	C	3	3	6	0	1	7	0	0
18	44645485	.	A	G	1	1	2	0	2	4	0	0
18	44645617	.	G	A	0	13	13	0	7	20	0	0
18	44645782	.	G	C	3	9	12	0	0	12	0	0
18	44645870	.	T	A	6	12	18	0	0	18	0	0
18	44646048	.	C	T	3	3	6	0	0	6	0	0
18	44646467	.	A	C	16	7	23	0	1	24	0	0
18	44646504	.	C	T	12	12	24	0	1	25	0	0
18	44646587	.	G	A	0	13	13	0	13	26	0	0
18	44646678	.	C	T	12	11	23	0	0	23	0	0
18	44646781	.	A	G	10	9	19	0	1	20	0	0
18	44696096	.	C	T	2	0	2	0	0	2	0	0
18	44696319	.	A	C	3	3	6	0	0	6	0	0
18	44696451	.	A	T	3	4	7	0	0	7	0	0
18	44765491	.	A	G	3	0	3	0	5	8	0	0
18	44770632	.	C	T	2	2	4	0	0	4	0	0
18	44782413	.	G	A	2	3	5	0	0	5	0	0
18	44783771	.	C	T	2	1	3	0	0	3	0	0
18	44790635	.	A	G	3	4	7	0	0	7	0	0
18	44791251	.	A	C	4	5	9	0	1	10	0	0
18	44791774	.	A	G	2	2	4	0	0	4	0	0
18	44826427	.	C	T	0	13	13	0	14	27	0	0
18	44826554	.	T	G	12	17	29	0	0	29	0	0
18	44826910	.	C	T	5	9	14	0	0	14	0	0
18	44830217	.	C	T	1	7	8	0	0	8	0	0
18	44830247	.	G	A	4	9	13	0	1	14	0	0
18	44830283	.	G	A	11	7	18	0	0	18	0	0
18	44832693	.	C	A	6	5	11	0	0	11	0	0
18	44834165	.	T	C	4	0	4	0	3	7	0	0
18	44837085	.	T	C	0	1	1	0	0	1	0	0
18	44838285	.	G	A	4	4	8	0	0	8	0	0
18	44838342	.	G	A	5	6	11	0	0	11	0	0
18	44840994	.	C	T	8	9	17	0	2	19	0	0
18	44843407	.	G	A	2	1	3	0	1	4	0	0
18	44843531	.	C	A	8	2	10	0	0	10	0	0
18	44852404	.	C	T	2	1	3	0	0	3	0	0
18	44857803	.	C	A	0	1	1	0	0	1	0	0
18	44866841	.	C	T	2	2	4	0	0	4	0	0
18	44870505	.	G	A	0	5	5	0	6	11	0	0
18	44870526	.	G	A	1	5	6	0	10	16	0	0
18	44870541	.	G	A	2	7	9	0	7	16	0	0
18	44873083	.	C	T	5	0	5	0	0	5	0	0
18	44873993	.	G	T	6	7	13	0	1	14	0	0
18	44874249	.	T	G	9	0	9	0	8	17	0	0
18	44874252	.	C	T	9	8	17	0	1	18	0	0
18	44913653	.	G	T	6	6	12	0	0	12	0	0
18	44913760	.	A	G	4	11	15	0	1	16	0	0
18	45231137	.	G	A	1	2	3	0	0	3	0	0
18	45248042	.	T	G	1	2	3	0	0	3	0	0
18	45257475	.	C	T	4	2	6	0	2	8	0	0
18	45259886	.	T	C	1	7	8	0	0	8	0	0
18	45259930	.	C	T	1	7	8	0	0	8	0	0
18	45260228	.	T	C	5	5	10	0	0	10	0	0
18	45260316	.	A	C	3	2	5	0	0	5	0	0
18	45260321	.	G	T	0	3	3	0	3	6	0	0
18	45261085	.	G	A	1	2	3	0	0	3	0	0
18	45261203	.	T	C	1	7	8	0	0	8	0	0
18	45261369	.	G	T	12	5	17	0	0	17	0	0
18	45261438	.	G	A	8	4	12	0	0	12	0	0
18	45261501	.	G	C	2	3	5	0	0	5	0	0
18	45261845	.	T	A	5	3	8	0	0	8	0	0
18	45261882	.	T	C	10	8	18	0	0	18	0	0
18	45262163	.	G	A	8	7	15	0	0	15	0	0
18	45262227	.	C	T	5	5	10	0	0	10	0	0
18	45262351	.	C	T	4	5	9	0	1	10	0	0
18	45262687	.	G	T	10	7	17	0	0	17	0	0
18	45262855	.	A	C	10	9	19	0	0	19	0	0
18	45262865	.	T	C	8	9	17	0	1	18	0	0
18	45550831	.	G	C	0	8	8	0	8	16	0	0
18	45550839	.	A	C	8	10	18	0	0	18	0	0
18	45561677	.	G	T	3	1	4	0	0	4	0	0
18	45569037	.	G	A	1	7	8	0	6	14	0	0
18	45574275	.	A	T	4	4	8	0	0	8	0	0
18	45575079	.	G	A	0	13	13	0	11	24	0	0
18	45581704	.	C	A	9	4	13	0	2	15	0	0
18	45581784	.	C	T	1	1	2	0	0	2	0	0
18	45583038	.	A	C	6	4	10	0	0	10	0	0
18	45583042	.	G	A	0	3	3	0	5	8	0	0
18	45584036	.	C	T	8	11	19	0	0	19	0	0
18	45584368	.	T	C	16	11	27	0	2	29	0	0
18	45588336	.	C	T	15	10	25	0	0	25	0	0
18	45591836	.	A	T	16	11	27	0	2	29	0	0
18	45591929	.	G	A	14	11	25	0	1	26	0	0
18	45647838	.	G	A	0	2	2	0	1	3	0	0
18	45647940	.	C	T	7	5	12	0	0	12	0	0
18	45649613	.	C	T	9	5	14	0	1	15	0	0
18	45649658	.	G	T	15	12	27	0	2	29	0	0
18	45651032	.	C	T	1	7	8	0	0	8	0	0
18	45651559	.	T	A	7	2	9	0	0	9	0	0
18	45656062	.	T	C	6	8	14	0	2	16	0	0
18	45656089	.	T	C	4	0	4	0	1	5	0	0
18	45685659	.	T	A	1	3	4	0	1	5	0	0
18	45685805	.	A	C	1	2	3	0	0	3	0	0
18	45686500	.	A	G	3	1	4	0	1	5	0	0
18	45686840	.	T	C	3	5	8	0	0	8	0	0
18	45686882	.	G	A	1	3	4	0	3	7	0	0
18	45687097	.	A	G	3	1	4	0	0	4	0	0
18	45687882	.	C	T	4	3	7	0	0	7	0	0
18	45689081	.	C	T	0	4	4	0	0	4	0	0
18	45691123	.	G	A	2	7	9	0	0	9	0	0
18	45697623	.	A	G	5	4	9	0	3	12	0	0
18	45697833	.	A	T	3	8	11	0	0	11	0	0
18	45697999	.	T	C	1	4	5	0	0	5	0	0
18	45734477	.	T	C	14	9	23	0	0	23	0	0
18	45742051	.	C	A	12	10	22	0	0	22	0	0
18	45742059	.	G	A	13	10	23	0	0	23	0	0
18	45743518	.	G	A	3	1	4	0	0	4	0	0
18	45743522	.	G	A	3	1	4	0	0	4	0	0
18	45743555	.	C	A	3	1	4	0	0	4	0	0
18	45745504	.	A	T	5	6	11	0	0	11	0	0
18	45750912	.	A	C	7	0	7	0	4	11	0	0
18	45750915	.	A	G	7	4	11	0	0	11	0	0
18	45752094	.	C	T	0	1	1	0	2	3	0	0
18	45759309	.	G	T	5	8	13	0	1	14	0	0
18	45784225	.	A	G	26	44	70	0	3	73	0	0
18	45807903	.	C	G	1	0	1	0	4	5	0	0
18	45807942	.	G	C	0	5	5	0	8	13	0	0
18	45809892	.	T	C	0	1	1	0	0	1	0	0
18	45818602	.	C	T	12	3	15	0	0	15	0	0
18	45820510	.	G	A	0	0	0	0	2	2	0	0
18	45820588	.	A	G	7	6	13	0	0	13	0	0
18	45824315	.	C	T	7	12	19	0	1	20	0	0
18	45824467	.	G	A	0	7	7	0	9	16	0	0
18	45835115	.	C	T	4	2	6	0	0	6	0	0
18	45840471	.	T	A	15	10	25	0	0	25	0	0
18	45840504	.	C	T	12	8	20	0	2	22	0	0
18	45842491	.	T	C	8	6	14	0	0	14	0	0
18	45842679	.	G	A	0	9	9	0	7	16	0	0
18	45844458	.	C	T	16	21	37	0	0	37	0	0
18	45844473	.	A	T	16	21	37	0	1	38	0	0
18	45848355	.	C	T	1	1	2	0	0	2	0	0
18	45849283	.	C	T	9	7	16	0	0	16	0	0
18	45851540	.	G	A	0	3	3	0	7	10	0	0
18	45885502	.	A	T	1	3	4	0	0	4	0	0
18	45886154	.	C	A	1	2	3	0	0	3	0	0
18	45886634	.	C	T	2	0	2	0	0	2	0	0
18	45886643	.	A	T	1	2	3	0	0	3	0	0
18	45886957	.	G	T	4	2	6	0	0	6	0	0
18	45936773	.	G	A	2	2	4	0	1	5	0	0
18	45944546	.	C	T	0	3	3	0	0	3	0	0
18	45947835	.	C	T	1	4	5	0	0	5	0	0
18	45947880	.	C	A	0	5	5	0	0	5	0	0
18	45948071	.	C	A	1	6	7	0	0	7	0	0
18	45948213	.	G	A	1	6	7	0	1	8	0	0
18	45962500	.	A	G	8	8	16	0	1	17	0	0
18	45962581	.	T	C	14	6	20	0	0	20	0	0
18	45962593	.	G	C	14	10	24	0	0	24	0	0
18	45962668	.	C	T	15	15	30	0	2	32	0	0
18	45969252	.	C	A	4	2	6	0	0	6	0	0
18	45979887	.	C	T	6	7	13	0	0	13	0	0
18	45983268	.	A	C	19	19	38	0	1	39	0	0
18	46005023	.	T	A	1	6	7	0	0	7	0	0
18	46012631	.	C	T	0	1	1	0	0	1	0	0
18	46015830	.	G	A	1	0	1	0	0	1	0	0
18	46057023	.	G	T	3	2	5	0	0	5	0	0
18	46059425	.	A	C	0	2	2	0	0	2	0	0
18	46061242	.	G	A	7	6	13	0	0	13	0	0
18	46061326	.	C	A	1	4	5	0	0	5	0	0
18	46063648	.	C	T	2	3	5	0	0	5	0	0
18	46367691	.	G	C	1	0	1	0	0	1	0	0
18	46367733	.	G	A	5	7	12	0	1	13	0	0
18	46367772	.	C	G	0	11	11	0	11	22	0	0
18	46368513	.	T	C	3	0	3	0	10	13	0	0
18	46368771	.	C	T	0	4	4	0	7	11	0	0
18	46369173	.	T	C	3	4	7	0	0	7	0	0
18	46417181	.	C	T	4	3	7	0	0	7	0	0
18	46417342	.	A	G	19	22	41	0	0	41	0	0
18	46417402	.	G	A	15	18	33	0	0	33	0	0
18	46417624	.	T	C	14	7	21	0	1	22	0	0
18	46417714	.	G	C	12	14	26	0	1	27	0	0
18	46417775	.	T	C	12	0	12	0	17	29	0	0
18	46418632	.	G	A	9	10	19	0	0	19	0	0
18	46418818	.	C	A	6	6	12	0	1	13	0	0
18	46418860	.	C	T	0	9	9	0	5	14	0	0
18	46418932	.	T	A	9	6	15	0	0	15	0	0
18	46419056	.	C	T	5	5	10	0	0	10	0	0
18	46419124	.	T	C	6	9	15	0	0	15	0	0
18	46419275	.	T	C	8	11	19	0	2	21	0	0
18	46419451	.	A	T	2	4	6	0	1	7	0	0
18	46419616	.	T	C	3	3	6	0	0	6	0	0
18	46634572	.	T	C	3	2	5	0	0	5	0	0
18	46635323	.	G	T	2	5	7	0	1	8	0	0
18	46635390	.	G	C	3	2	5	0	0	5	0	0
18	46635591	.	C	T	3	8	11	0	1	12	0	0
18	46635805	.	C	G	4	5	9	0	2	11	0	0
18	46684230	.	A	T	6	6	12	0	0	12	0	0
18	46684258	.	G	T	4	6	10	0	0	10	0	0
18	46699773	.	G	A	21	20	41	0	0	41	0	0
18	46702492	.	G	A	12	21	33	0	2	35	0	0
18	46714896	.	A	G	6	10	16	0	1	17	0	0
18	46729044	.	A	G	4	2	6	0	0	6	0	0
18	46729321	.	A	G	3	4	7	0	0	7	0	0
18	46732406	.	C	G	1	2	3	0	1	4	0	0
18	46732417	.	T	A	1	0	1	0	0	1	0	0
18	46738862	.	C	A	0	3	3	0	4	7	0	0
18	46738955	.	A	C	5	3	8	0	1	9	0	0
18	47301204	.	T	C	6	5	11	0	0	11	0	0
18	47305433	.	A	G	2	2	4	0	0	4	0	0
18	47306782	.	A	G	3	6	9	0	1	10	0	0
18	47523393	.	A	G	2	1	3	0	0	3	0	0
18	47566919	.	A	T	2	0	2	0	0	2	0	0
18	48620495	.	C	T	1	3	4	0	0	4	0	0
18	48640143	.	G	C	0	4	4	0	4	8	0	0
18	48640155	.	G	C	0	3	3	0	4	7	0	0
18	48640348	.	A	G	2	0	2	0	3	5	0	0
18	48640417	.	G	C	4	5	9	0	0	9	0	0
18	48640420	.	A	G	3	5	8	0	1	9	0	0
18	48641360	.	A	G	1	2	3	0	0	3	0	0
18	48642077	.	T	A	2	3	5	0	0	5	0	0
18	48642821	.	C	T	4	5	9	0	0	9	0	0
18	48642856	.	T	A	0	3	3	0	0	3	0	0
18	48642868	.	A	T	0	3	3	0	0	3	0	0
18	48794005	.	G	A	2	2	4	0	0	4	0	0
18	48807499	.	A	G	3	2	5	0	0	5	0	0
18	48807521	.	T	C	1	2	3	0	0	3	0	0
18	48808043	.	A	G	1	5	6	0	0	6	0	0
18	48808099	.	A	G	2	3	5	0	1	6	0	0
18	48808552	.	T	C	4	6	10	0	0	10	0	0
18	48808708	.	T	A	1	2	3	0	0	3	0	0
18	48809226	.	G	A	7	6	13	0	0	13	0	0
18	48809268	.	T	A	2	3	5	0	0	5	0	0
18	48864856	.	T	C	4	7	11	0	0	11	0	0
18	48864944	.	C	T	5	8	13	0	0	13	0	0
18	48898641	.	C	T	1	3	4	0	1	5	0	0
18	48928230	.	C	T	15	13	28	0	1	29	0	0
18	48928240	.	A	G	13	0	13	0	19	32	0	0
18	48928342	.	A	G	14	0	14	0	20	34	0	0
18	48928387	.	T	A	14	17	31	0	0	31	0	0
18	48934524	.	T	C	9	6	15	0	0	15	0	0
18	48934593	.	T	C	6	4	10	0	0	10	0	0
18	48934805	.	A	G	17	13	30	0	1	31	0	0
18	48934833	.	T	C	16	9	25	0	0	25	0	0
18	48935170	.	G	A	15	22	37	0	1	38	0	0
18	48935279	.	T	G	21	17	38	0	0	38	0	0
18	48935282	.	T	G	22	16	38	0	0	38	0	0
18	48935394	.	A	T	17	11	28	0	0	28	0	0
18	48935709	.	A	G	18	20	38	0	2	40	0	0
18	48935907	.	T	C	7	4	11	0	1	12	0	0
18	48957783	.	G	A	0	3	3	0	1	4	0	0
18	48966177	.	C	T	0	1	1	0	0	1	0	0
18	48967500	.	T	C	3	3	6	0	0	6	0	0
18	48971165	.	T	C	2	3	5	0	1	6	0	0
18	48971192	.	A	G	1	0	1	0	0	1	0	0
18	48972490	.	A	T	7	6	13	0	3	16	0	0
18	49154130	.	A	G	11	8	19	0	0	19	0	0
18	49154207	.	A	G	5	6	11	0	2	13	0	0
18	49155520	.	A	G	7	9	16	0	1	17	0	0
18	49239982	.	T	G	0	0	0	0	1	1	0	0
18	49265147	.	A	G	5	2	7	0	2	9	0	0
18	49266171	.	A	G	1	4	5	0	0	5	0	0
18	49266182	.	A	G	3	4	7	0	0	7	0	0
18	49266589	.	A	G	2	11	13	0	3	16	0	0
18	49266932	.	A	G	3	4	7	0	0	7	0	0
18	49266944	.	A	G	1	6	7	0	1	8	0	0
18	49266998	.	A	G	5	4	9	0	1	10	0	0
18	49446427	.	A	G	2	2	4	0	0	4	0	0
18	50038539	.	A	G	3	3	6	0	0	6	0	0
18	50099441	.	A	G	2	4	6	0	0	6	0	0
18	50099498	.	A	G	4	2	6	0	0	6	0	0
18	50537645	.	A	G	13	2	15	0	0	15	0	0
18	50538340	.	T	C	4	13	17	0	1	18	0	0
18	50538442	.	T	C	10	3	13	0	0	13	0	0
18	50538598	.	T	C	7	5	12	0	0	12	0	0
18	50689577	.	T	C	0	2	2	0	1	3	0	0
18	50689583	.	G	A	2	0	2	0	1	3	0	0
18	50706691	.	C	A	0	2	2	0	0	2	0	0
18	50706696	.	C	T	0	2	2	0	0	2	0	0
18	50823336	.	A	G	1	0	1	0	3	4	0	0
18	50911943	.	C	G	5	0	5	0	0	5	0	0
18	50911951	.	T	C	0	5	5	0	0	5	0	0
19	371692	.	A	G	1	2	3	0	2	5	0	0
19	371695	.	A	G	2	3	5	0	0	5	0	0
19	372211	.	A	G	1	3	4	0	0	4	0	0
19	372233	.	A	G	2	4	6	0	0	6	0	0
19	1185281	.	G	A	3	4	7	0	0	7	0	0
19	1673672	.	T	C	1	4	5	0	0	5	0	0
19	2000142	.	C	G	4	3	7	0	0	7	0	0
19	2001557	.	T	C	3	3	6	0	0	6	0	0
19	2001618	.	A	C	1	4	5	0	0	5	0	0
19	2002992	.	A	G	1	0	1	0	0	1	0	0
19	2003150	.	T	C	8	3	11	0	1	12	0	0
19	2003158	.	C	T	7	5	12	0	0	12	0	0
19	2003767	.	C	T	9	5	14	0	0	14	0	0
19	2003803	.	C	G	11	0	11	0	8	19	0	0
19	2003902	.	A	T	9	16	25	0	0	25	0	0
19	2003962	.	G	T	2	11	13	0	9	22	0	0
19	2004046	.	G	C	5	12	17	0	0	18	1	0
19	2019147	.	C	T	0	3	3	0	0	3	0	0
19	2019480	.	C	T	0	4	4	0	1	5	0	0
19	2064629	.	G	A	1	3	4	0	0	4	0	0
19	2064762	.	G	C	5	6	11	0	0	11	0	0
19	2071672	.	A	G	0	1	1	0	1	2	0	0
19	2279284	.	C	T	4	4	8	0	0	8	0	0
19	2294971	.	G	C	1	4	5	0	0	5	0	0
19	2300980	.	G	A	0	0	0	0	1	1	0	0
19	2307248	.	C	A	4	4	8	0	1	9	0	0
19	2307268	.	C	T	4	5	9	0	0	9	0	0
19	2307500	.	C	T	2	2	4	0	1	5	0	0
19	2315511	.	C	T	0	3	3	0	2	5	0	0
19	2315666	.	A	G	5	5	10	0	0	10	0	0
19	2315752	.	A	T	8	3	11	0	0	11	0	0
19	2315961	.	G	A	5	2	7	0	1	8	0	0
19	2316354	.	A	T	5	4	9	0	0	9	0	0
19	2316510	.	T	C	9	5	14	0	0	14	0	0
19	2316729	.	G	C	7	3	10	0	1	11	0	0
19	2316765	.	T	C	7	3	10	0	1	11	0	0
19	2316894	.	T	C	3	3	6	0	1	7	0	0
19	2396013	.	C	T	0	2	2	0	2	4	0	0
19	2396022	.	C	T	3	3	6	1	0	7	0	0
19	2396421	.	T	C	2	0	2	0	4	6	0	0
19	2396492	.	C	A	3	2	5	0	0	5	0	0
19	2396647	.	C	T	5	2	7	0	0	7	0	0
19	2396675	.	G	T	2	2	4	0	0	5	1	0
19	2396743	.	A	G	2	3	5	0	0	5	0	0
19	2396926	.	G	A	0	2	2	0	1	3	0	0
19	2397268	.	A	T	1	5	6	0	0	6	0	0
19	2397381	.	G	C	0	4	4	0	1	5	0	0
19	2397559	.	T	C	1	4	5	0	1	6	0	0
19	2400403	.	G	A	1	0	1	0	0	1	0	0
19	2402609	.	T	A	2	4	6	0	0	6	0	0
19	2402611	.	T	A	2	3	5	0	1	6	0	0
19	2403906	.	T	C	1	0	1	0	2	3	0	0
19	2550676	.	G	A	3	4	7	0	2	9	0	0
19	2550839	.	C	T	7	3	10	0	0	10	0	0
19	2551178	.	A	G	3	8	11	0	0	11	0	0
19	2551214	.	C	T	6	9	15	0	0	15	0	0
19	2551727	.	C	T	7	7	14	0	0	14	0	0
19	2560950	.	A	G	5	7	12	0	1	13	0	0
19	2561048	.	A	C	8	9	17	0	1	18	0	0
19	2561322	.	T	A	2	7	9	1	0	10	0	0
19	2561739	.	G	A	2	13	15	0	7	22	0	0
19	2561873	.	A	G	1	5	6	0	0	6	0	0
19	2561874	.	A	G	2	4	6	0	0	6	0	0
19	2602934	.	G	A	4	6	10	0	0	10	0	0
19	2645115	.	C	T	5	3	8	0	2	10	0	0
19	2651344	.	G	A	1	1	2	0	1	3	0	0
19	2654388	.	A	T	5	2	7	0	1	8	0	0
19	2654424	.	C	T	3	9	12	0	1	13	0	0
19	2663609	.	A	G	15	9	24	0	1	25	0	0
19	2664125	.	G	A	2	14	16	0	1	17	0	0
19	2664394	.	C	T	19	11	30	0	0	30	0	0
19	2664613	.	T	C	11	5	16	0	1	17	0	0
19	2685839	.	T	C	0	4	4	0	0	4	0	0
19	2695314	.	G	A	10	5	15	0	1	16	0	0
19	2695351	.	A	G	4	0	4	0	3	7	0	0
19	2695358	.	G	A	3	3	6	0	0	6	0	0
19	2731100	.	C	T	1	0	1	0	0	1	0	0
19	2732833	.	C	T	1	5	6	0	0	6	0	0
19	2732836	.	G	A	1	4	5	0	1	6	0	0
19	2744169	.	C	G	0	3	3	0	0	3	0	0
19	2746008	.	G	A	0	3	3	0	3	6	0	0
19	2746134	.	C	T	6	2	8	0	0	8	0	0
19	2750162	.	G	A	0	2	2	0	5	7	0	0
19	2849833	.	A	G	0	0	0	0	2	2	0	0
19	2849838	.	G	T	0	2	2	0	0	2	0	0
19	2871511	.	A	G	5	7	12	0	0	12	0	0
19	2871553	.	C	T	3	3	6	0	0	6	0	0
19	2871559	.	G	A	3	2	5	0	0	5	0	0
19	2874618	.	T	C	1	1	2	0	1	3	0	0
19	2884207	.	C	T	0	2	2	0	0	2	0	0
19	2886952	.	G	A	5	4	9	0	0	9	0	0
19	2887046	.	G	C	0	2	2	0	1	3	0	0
19	2930451	.	G	A	3	2	5	0	0	5	0	0
19	2930521	.	T	C	3	2	5	0	0	5	0	0
19	2930597	.	A	G	9	7	16	0	0	16	0	0
19	2934321	.	A	G	0	1	1	0	0	1	0	0
19	2940673	.	T	C	1	0	1	0	2	3	0	0
19	2940680	.	G	T	1	2	3	0	0	3	0	0
19	3052970	.	A	G	1	4	5	0	0	5	0	0
19	3080712	.	T	A	4	10	14	0	1	15	0	0
19	3080863	.	A	T	3	2	5	0	0	5	0	0
19	3080907	.	A	T	7	5	12	0	0	12	0	0
19	3081037	.	A	G	5	3	8	0	0	8	0	0
19	3081106	.	C	G	2	2	4	0	0	4	0	0
19	3081122	.	A	T	3	1	4	0	2	6	0	0
19	3081154	.	G	C	5	3	8	0	0	8	0	0
19	3081206	.	G	T	1	5	6	0	0	6	0	0
19	3081388	.	A	G	5	0	5	0	9	14	0	0
19	3081628	.	T	C	0	2	2	1	0	3	0	0
19	3081927	.	G	A	9	6	15	0	0	15	0	0
19	3081933	.	G	A	1	5	6	0	9	15	0	0
19	3082102	.	C	T	7	6	13	0	1	14	0	0
19	3082159	.	C	G	9	5	14	0	1	15	0	0
19	3087025	.	A	G	4	9	13	0	1	14	0	0
19	3137727	.	C	T	0	27	27	0	26	53	0	0
19	3137761	.	C	A	18	30	48	0	1	49	0	0
19	3137803	.	A	T	20	21	41	0	7	48	0	0
19	3137888	.	T	C	20	0	20	0	30	50	0	0
19	3138166	.	G	T	14	3	17	0	0	17	0	0
19	3138325	.	A	C	21	22	43	0	1	44	0	0
19	3138355	.	T	G	24	18	42	0	1	43	0	0
19	3138638	.	T	C	10	0	10	0	14	24	0	0
19	3149296	.	A	C	1	6	7	0	0	7	0	0
19	3149320	.	T	G	1	5	6	0	0	6	0	0
19	3186901	.	C	T	1	2	3	0	0	3	0	0
19	3187063	.	A	T	6	4	10	0	0	10	0	0
19	3206382	.	G	A	1	0	1	0	0	1	0	0
19	3215468	.	A	G	1	2	3	0	0	3	0	0
19	3229424	.	A	G	1	2	3	0	0	3	0	0
19	3231206	.	T	C	2	1	3	0	0	3	0	0
19	3238395	.	T	A	24	20	44	0	0	44	0	0
19	3238425	.	T	C	19	22	41	0	2	43	0	0
19	3238721	.	T	A	32	29	61	0	1	62	0	0
19	3240409	.	G	C	24	22	46	0	2	48	0	0
19	3376893	.	G	C	1	0	1	0	2	3	0	0
19	3386258	.	T	A	16	14	30	0	1	31	0	0
19	3386358	.	A	G	10	12	22	0	1	23	0	0
19	3386485	.	C	A	10	10	20	0	1	21	0	0
19	3386580	.	T	A	6	4	10	0	0	10	0	0
19	3386873	.	C	T	20	12	32	0	3	35	0	0
19	3387040	.	C	A	1	13	14	0	14	28	0	0
19	3387068	.	A	C	16	11	27	0	2	29	0	0
19	3387097	.	C	G	18	15	33	0	1	34	0	0
19	3387506	.	G	A	16	20	36	0	1	37	0	0
19	3387713	.	G	A	18	20	38	0	2	40	0	0
19	3388376	.	T	C	17	21	38	0	1	39	0	0
19	3388467	.	T	C	19	19	38	0	1	39	0	0
19	3388617	.	G	A	16	16	32	0	1	33	0	0
19	3390203	.	G	A	9	16	25	0	0	25	0	0
19	3390283	.	G	T	1	6	7	0	0	7	0	0
19	3390506	.	C	G	4	2	6	0	0	6	0	0
19	3391479	.	G	A	2	3	5	0	0	5	0	0
19	3391530	.	G	T	5	9	14	0	1	15	0	0
19	3391608	.	T	A	7	2	9	0	1	10	0	0
19	3391669	.	A	G	7	4	11	0	1	12	0	0
19	3391805	.	T	G	6	10	16	0	1	17	0	0
19	3392127	.	G	A	5	8	13	0	0	13	0	0
19	3392415	.	G	T	11	6	17	0	0	17	0	0
19	3392481	.	A	G	7	9	16	0	0	16	0	0
19	3393128	.	A	T	8	6	14	0	0	14	0	0
19	3393343	.	G	C	4	3	7	0	0	7	0	0
19	3393437	.	T	A	6	7	13	0	0	13	0	0
19	3393924	.	G	A	3	6	9	0	0	9	0	0
19	3395277	.	C	G	0	2	2	0	1	3	0	0
19	3395435	.	C	T	1	3	4	0	0	4	0	0
19	3395457	.	T	A	1	5	6	0	0	6	0	0
19	3573912	.	A	T	2	4	6	0	0	6	0	0
19	3573971	.	A	G	1	2	3	0	0	3	0	0
19	3578066	.	G	A	1	2	3	0	0	3	0	0
19	3578087	.	A	T	1	2	3	0	0	3	0	0
19	3681134	.	C	T	2	5	7	0	0	7	0	0
19	3698249	.	C	G	2	1	3	0	0	3	0	0
19	3702675	.	G	A	1	2	3	0	0	3	0	0
19	3702941	.	G	A	0	4	4	0	8	12	0	0
19	3703149	.	A	G	3	3	6	0	0	6	0	0
19	3703178	.	C	T	4	5	9	0	0	9	0	0
19	3706875	.	C	T	1	5	6	0	0	6	0	0
19	3707235	.	A	G	6	13	19	0	0	19	0	0
19	3707334	.	G	A	5	6	11	0	0	11	0	0
19	3707562	.	T	A	2	3	5	0	0	5	0	0
19	3707576	.	C	T	3	2	5	0	0	5	0	0
19	3707625	.	G	A	0	9	9	0	8	17	0	0
19	3718110	.	A	T	12	10	22	0	0	22	0	0
19	3718222	.	G	A	11	20	31	0	2	33	0	0
19	3718251	.	C	A	12	14	26	0	0	26	0	0
19	3718330	.	G	A	26	14	40	0	0	40	0	0
19	3718415	.	G	T	27	11	38	0	2	40	0	0
19	3718675	.	C	A	22	24	46	0	0	46	0	0
19	3865928	.	C	T	0	10	10	0	6	16	0	0
19	3866029	.	C	T	3	17	20	0	0	20	0	0
19	3866031	.	G	A	3	17	20	0	0	20	0	0
19	3866075	.	T	C	14	11	25	0	0	25	0	0
19	3866102	.	A	G	14	15	29	0	2	31	0	0
19	3866165	.	T	C	15	10	25	0	3	28	0	0
19	3866206	.	T	A	8	2	10	0	0	10	0	0
19	3866289	.	C	G	7	18	25	0	0	25	0	0
19	3866424	.	A	T	15	20	35	0	3	38	0	0
19	3866727	.	C	T	0	14	14	0	19	33	0	0
19	3868535	.	T	C	12	16	28	0	2	30	0	0
19	3868541	.	C	T	2	15	17	0	13	30	0	0
19	3872386	.	G	A	1	1	2	0	0	2	0	0
19	3872419	.	C	T	3	2	5	0	2	7	0	0
19	3872833	.	C	T	13	9	22	0	0	22	0	0
19	3873019	.	C	T	2	5	7	0	2	9	0	0
19	3873055	.	C	T	2	2	4	0	0	4	0	0
19	3873847	.	A	C	3	5	8	0	0	8	0	0
19	3873955	.	G	A	4	6	10	0	0	10	0	0
19	3874195	.	A	G	9	7	16	0	0	16	0	0
19	3874277	.	C	A	9	3	12	0	0	12	0	0
19	3874339	.	G	A	6	5	11	0	1	12	0	0
19	3874381	.	G	A	3	4	7	0	0	7	0	0
19	3876296	.	C	T	3	3	6	0	1	7	0	0
19	3878548	.	C	T	2	7	9	0	1	10	0	0
19	3878565	.	G	C	3	2	5	0	1	6	0	0
19	3937971	.	T	C	19	27	46	0	5	51	0	0
19	3939887	.	C	T	14	17	31	0	0	31	0	0
19	3939902	.	G	T	18	24	42	0	1	43	0	0
19	3940022	.	C	T	2	21	23	0	25	48	0	0
19	3945750	.	G	T	13	6	19	0	0	19	0	0
19	4010175	.	C	A	8	5	13	0	2	15	0	0
19	4024467	.	T	C	1	2	3	0	0	3	0	0
19	4089843	.	A	C	6	0	6	0	4	10	0	0
19	4089974	.	T	C	4	2	6	0	0	6	0	0
19	4090243	.	T	A	2	2	4	0	0	4	0	0
19	4090658	.	T	A	5	2	7	0	0	7	0	0
19	4090662	.	A	G	5	2	7	0	0	7	0	0
19	4127217	.	G	A	5	2	7	0	0	7	0	0
19	4137043	.	G	A	1	3	4	0	0	4	0	0
19	4137044	.	A	G	1	3	4	0	0	4	0	0
19	4194072	.	T	C	1	1	2	0	0	2	0	0
19	4279835	.	A	C	3	2	5	0	0	5	0	0
19	4341539	.	T	C	4	7	11	0	0	11	0	0
19	4443334	.	T	C	2	8	10	0	0	10	0	0
19	4443403	.	T	C	8	5	13	0	1	14	0	0
19	4445154	.	T	C	3	7	10	0	1	11	0	0
19	4445222	.	A	T	3	2	5	0	0	5	0	0
19	4445269	.	T	C	4	4	8	0	1	9	0	0
19	4445565	.	G	T	1	0	1	0	0	3	2	0
19	4445568	.	A	G	2	0	2	0	1	3	0	0
19	4447347	.	G	A	4	3	7	0	0	7	0	0
19	4447403	.	A	T	10	6	16	0	1	18	1	0
19	4447502	.	T	A	10	8	18	0	0	18	0	0
19	4464121	.	G	A	1	2	3	0	0	3	0	0
19	4464232	.	G	A	1	2	3	0	0	3	0	0
19	4828428	.	A	T	4	3	7	0	2	9	0	0
19	4828832	.	G	T	1	0	1	0	0	1	0	0
19	4836346	.	C	T	3	2	5	0	0	5	0	0
19	4856678	.	A	G	2	2	4	0	0	4	0	0
19	4856691	.	G	A	2	2	4	0	0	4	0	0
19	4857526	.	C	T	6	4	10	0	0	10	0	0
19	4857697	.	C	A	2	2	4	0	0	4	0	0
19	4857746	.	G	A	2	3	5	0	0	5	0	0
19	4857802	.	C	T	4	4	8	0	1	9	0	0
19	4857910	.	A	G	8	6	14	0	0	14	0	0
19	4858000	.	C	T	5	5	10	0	1	11	0	0
19	4866919	.	T	C	12	10	22	0	0	22	0	0
19	4867132	.	G	A	1	7	8	0	8	16	0	0
19	4867232	.	C	G	6	8	14	0	1	15	0	0
19	4867274	.	G	A	0	3	3	0	9	12	0	0
19	4875595	.	A	G	2	4	6	0	0	6	0	0
19	4877141	.	T	C	5	8	13	0	1	14	0	0
19	4878751	.	C	T	7	7	14	0	0	14	0	0
19	4881345	.	G	T	1	2	3	0	0	3	0	0
19	4881414	.	T	C	8	3	11	0	1	12	0	0
19	4885398	.	A	G	2	0	2	0	0	2	0	0
19	4885431	.	A	G	1	0	1	0	1	2	0	0
19	4888471	.	T	G	6	8	14	0	0	14	0	0
19	4888684	.	T	C	11	15	26	0	1	27	0	0
19	4888693	.	T	C	9	16	25	0	1	26	0	0
19	4888720	.	A	G	5	18	23	0	2	25	0	0
19	4888744	.	A	G	8	17	25	0	1	26	0	0
19	4892530	.	G	T	0	6	6	0	10	16	0	0
19	4892628	.	A	G	7	6	13	0	0	13	0	0
19	4892643	.	T	C	7	8	15	0	0	15	0	0
19	4892787	.	C	T	5	4	9	0	1	10	0	0
19	4892940	.	G	A	0	9	9	0	9	18	0	0
19	4893033	.	A	G	2	0	2	0	4	6	0	0
19	4903907	.	C	T	7	6	13	0	0	13	0	0
19	4903971	.	A	T	22	9	31	0	0	31	0	0
19	4903998	.	A	G	17	8	25	0	1	26	0	0
19	4904041	.	C	T	16	4	20	0	5	25	0	0
19	4904127	.	C	T	11	6	17	0	0	17	0	0
19	4904221	.	G	C	4	5	9	0	0	9	0	0
19	4904407	.	T	C	2	2	4	0	0	4	0	0
19	4904643	.	T	A	4	3	7	0	0	7	0	0
19	4904665	.	A	C	3	2	5	0	0	5	0	0
19	4904747	.	A	C	5	4	9	0	0	9	0	0
19	4904767	.	T	C	8	6	14	0	1	15	0	0
19	4904972	.	T	C	6	9	15	0	0	15	0	0
19	4904991	.	T	C	9	9	18	0	0	18	0	0
19	4905175	.	G	A	9	8	17	0	1	18	0	0
19	4905229	.	T	C	11	9	20	0	1	21	0	0
19	4912841	.	G	A	1	1	2	0	0	2	0	0
19	4913087	.	A	G	5	5	10	0	0	10	0	0
19	4961603	.	C	T	3	3	6	0	0	6	0	0
19	4961656	.	A	G	4	3	7	0	0	7	0	0
19	4961950	.	A	T	10	17	27	0	0	27	0	0
19	4961977	.	A	T	9	12	21	0	1	22	0	0
19	4973136	.	G	A	0	3	3	0	3	6	0	0
19	4976906	.	C	T	1	1	2	0	1	3	0	0
19	4976925	.	C	G	0	2	2	0	1	3	0	0
19	4985064	.	T	A	3	5	8	0	3	11	0	0
19	4985105	.	A	G	3	3	6	0	0	6	0	0
19	4985151	.	T	A	1	2	3	0	0	3	0	0
19	4985444	.	T	C	3	6	9	0	0	9	0	0
19	4985465	.	T	A	3	6	9	0	0	9	0	0
19	4985720	.	A	T	5	7	12	0	0	12	0	0
19	4985721	.	T	A	5	7	12	0	0	12	0	0
19	4993133	.	T	C	0	3	3	0	0	3	0	0
19	4998305	.	G	A	1	3	4	0	0	4	0	0
19	5001119	.	C	T	0	5	5	0	12	17	0	0
19	5009251	.	A	C	6	4	10	0	0	10	0	0
19	5009353	.	G	A	4	6	10	0	0	10	0	0
19	5016071	.	T	C	4	6	10	0	0	10	0	0
19	5016302	.	T	G	7	20	27	0	1	28	0	0
19	5018307	.	A	G	3	7	10	0	0	10	0	0
19	5018340	.	A	G	2	1	3	0	0	3	0	0
19	5020451	.	G	A	1	6	7	0	0	7	0	0
19	5022301	.	C	T	13	6	19	0	0	19	0	0
19	5024424	.	G	A	0	2	2	0	1	3	0	0
19	5024436	.	C	T	3	3	6	0	0	6	0	0
19	5024685	.	T	C	1	2	3	0	1	4	0	0
19	5026119	.	A	G	1	1	2	0	0	2	0	0
19	5028136	.	G	A	2	2	4	0	0	4	0	0
19	5028605	.	A	G	1	4	5	0	0	5	0	0
19	5028719	.	C	T	0	2	2	0	0	2	0	0
19	5030214	.	G	T	2	3	5	0	1	6	0	0
19	5030274	.	G	A	3	4	7	0	1	8	0	0
19	5031617	.	T	C	3	0	3	0	0	3	0	0
19	5032178	.	T	C	2	4	6	0	0	6	0	0
19	5032199	.	A	C	1	2	3	0	0	3	0	0
19	5035253	.	G	A	3	1	4	0	0	4	0	0
19	5037382	.	T	C	3	0	3	0	3	6	0	0
19	5039148	.	A	G	4	8	12	0	0	12	0	0
19	5039259	.	G	T	0	1	1	0	0	1	0	0
19	5042062	.	T	C	2	0	2	0	3	5	0	0
19	5042074	.	G	A	2	3	5	0	0	5	0	0
19	5077173	.	C	T	9	7	16	0	1	17	0	0
19	5080124	.	T	A	2	1	3	1	0	4	0	0
19	5081758	.	T	C	19	7	26	0	2	28	0	0
19	5081796	.	C	T	30	14	44	0	1	45	0	0
19	5082095	.	A	G	18	29	47	0	2	49	0	0
19	5089755	.	C	G	13	5	18	0	0	18	0	0
19	5089900	.	C	G	32	2	34	0	33	67	0	0
19	5090070	.	A	T	21	25	46	0	3	49	0	0
19	5090071	.	G	T	21	26	47	0	2	49	0	0
19	5090264	.	G	A	22	21	43	0	3	46	0	0
19	5090357	.	T	C	26	23	49	0	3	52	0	0
19	5090379	.	C	T	28	24	52	0	0	52	0	0
19	5090409	.	G	A	31	22	53	0	1	54	0	0
19	5090483	.	A	T	32	28	60	0	0	60	0	0
19	5090593	.	T	A	7	3	10	0	1	11	0	0
19	5090677	.	A	C	7	5	12	0	1	13	0	0
19	5090691	.	A	G	8	3	11	0	0	11	0	0
19	5091483	.	T	C	32	31	63	0	5	68	0	0
19	5094288	.	G	T	6	6	12	0	1	13	0	0
19	5094389	.	C	T	2	6	8	0	0	8	0	0
19	5094471	.	T	C	10	13	23	0	2	25	0	0
19	5094504	.	A	G	12	15	27	0	0	27	0	0
19	5094616	.	C	T	1	16	17	0	14	31	0	0
19	5100191	.	G	A	12	12	24	0	0	24	0	0
19	5145097	.	T	C	2	2	4	0	0	4	0	0
19	5146708	.	C	T	8	11	19	0	0	19	0	0
19	5158795	.	A	G	40	28	68	0	9	77	0	0
19	5159083	.	A	T	27	30	57	0	0	57	0	0
19	5159157	.	C	A	30	38	68	0	2	71	1	0
19	5160048	.	C	G	36	31	67	0	7	74	0	0
19	5160121	.	T	C	30	2	32	0	27	59	0	0
19	5160133	.	C	A	0	27	27	0	30	57	0	0
19	5160201	.	A	G	31	22	53	0	5	58	0	0
19	5160302	.	T	C	29	3	32	0	14	46	0	0
19	5160310	.	C	T	1	19	20	0	30	50	0	0
19	5160379	.	T	A	28	23	51	0	5	56	0	0
19	5160996	.	A	T	19	23	42	0	3	45	0	0
19	5161750	.	A	G	26	22	48	0	5	53	0	0
19	5162105	.	G	A	31	21	52	0	3	55	0	0
19	5162252	.	A	T	34	31	65	0	1	66	0	0
19	5162253	.	T	C	34	1	35	0	31	66	0	0
19	5162544	.	A	G	14	28	42	0	1	43	0	0
19	5162827	.	C	T	23	18	41	0	2	43	0	0
19	5162839	.	T	C	22	0	22	0	22	44	0	0
19	5162923	.	C	T	19	14	33	0	1	35	1	0
19	5163031	.	C	T	15	19	34	0	1	35	0	0
19	5163747	.	G	A	24	5	29	0	1	30	0	0
19	5163910	.	T	C	26	28	54	0	0	54	0	0
19	5254510	.	A	G	24	20	44	0	1	45	0	0
19	5299970	.	T	C	3	3	6	0	1	7	0	0
19	5300076	.	A	G	5	4	9	0	0	9	0	0
19	5552433	.	G	A	0	0	0	0	1	1	0	0
19	5552442	.	G	A	1	1	2	0	0	2	0	0
19	5552550	.	C	T	2	5	7	0	0	7	0	0
19	5552559	.	T	C	0	5	5	0	0	5	0	0
19	5569767	.	C	G	3	3	6	0	1	7	0	0
19	5569864	.	A	C	3	6	9	0	0	9	0	0
19	5569981	.	C	T	1	2	3	0	0	3	0	0
19	5582319	.	G	T	3	2	5	0	0	5	0	0
19	5587716	.	C	T	5	6	11	0	0	11	0	0
19	5611439	.	G	A	1	14	15	0	13	28	0	0
19	5611586	.	T	C	17	13	30	0	0	30	0	0
19	5617832	.	T	C	4	9	13	0	1	14	0	0
19	5619892	.	G	A	12	8	20	0	1	21	0	0
19	5619931	.	A	G	9	10	19	0	2	21	0	0
19	5620094	.	A	T	7	9	16	0	3	19	0	0
19	5620175	.	T	G	12	9	21	0	1	22	0	0
19	5620208	.	G	T	12	4	16	0	3	19	0	0
19	5620459	.	T	C	11	23	34	0	3	37	0	0
19	5620525	.	C	T	15	23	38	0	2	40	0	0
19	5621131	.	A	G	22	0	22	0	15	37	0	0
19	5621165	.	G	A	21	11	32	0	0	32	0	0
19	5686916	.	C	T	3	3	6	0	0	6	0	0
19	5687082	.	G	T	0	2	2	0	1	3	0	0
19	5687178	.	G	A	1	2	3	0	0	3	0	0
19	5779170	.	C	T	7	4	11	0	2	13	0	0
19	5779601	.	T	C	18	12	30	0	1	31	0	0
19	5779897	.	T	C	15	11	26	0	1	27	0	0
19	5779946	.	G	C	15	13	28	0	1	29	0	0
19	5780032	.	C	G	0	5	5	0	7	12	0	0
19	5780301	.	T	A	2	11	13	0	1	14	0	0
19	5780342	.	A	C	13	0	13	0	6	19	0	0
19	5780989	.	G	A	9	10	19	0	1	20	0	0
19	5781316	.	G	T	10	5	15	0	0	15	0	0
19	5781367	.	T	C	6	5	11	0	1	12	0	0
19	5781397	.	A	G	6	5	11	0	0	11	0	0
19	5781421	.	T	G	3	8	11	0	2	13	0	0
19	5793484	.	C	G	1	8	9	0	0	9	0	0
19	5793532	.	T	C	1	8	9	0	1	10	0	0
19	5805773	.	T	G	2	0	2	0	0	2	0	0
19	5805833	.	G	A	3	8	11	0	0	11	0	0
19	5805839	.	G	A	4	8	12	0	0	12	0	0
19	5805869	.	A	G	7	2	9	0	0	9	0	0
19	6060309	.	A	T	16	13	29	0	0	29	0	0
19	6073362	.	T	C	3	6	9	0	0	9	0	0
19	6076813	.	C	A	3	4	7	0	0	7	0	0
19	6085987	.	A	G	3	13	16	0	1	17	0	0
19	6086441	.	C	G	13	19	32	0	1	33	0	0
19	6086577	.	C	T	1	21	22	0	17	39	0	0
19	6087130	.	T	A	10	18	28	0	2	30	0	0
19	6087146	.	C	T	0	19	19	0	13	32	0	0
19	6087186	.	A	T	9	12	21	0	2	24	1	0
19	6087894	.	G	A	9	10	19	0	1	20	0	0
19	6087948	.	A	T	12	6	18	0	1	19	0	0
19	6088000	.	C	T	1	12	13	0	14	27	0	0
19	6088166	.	T	C	7	14	21	0	1	22	0	0
19	6088259	.	A	C	12	11	23	0	1	24	0	0
19	6088419	.	A	T	6	5	11	0	0	11	0	0
19	6090702	.	T	C	6	4	10	0	1	11	0	0
19	6090732	.	T	A	0	1	1	0	0	1	0	0
19	6097416	.	A	G	13	10	23	0	0	23	0	0
19	6099984	.	G	A	10	6	16	0	0	16	0	0
19	6099992	.	G	A	13	5	18	0	1	19	0	0
19	6100027	.	G	A	10	4	14	0	3	17	0	0
19	6100037	.	C	T	10	7	17	0	1	18	0	0
19	6100073	.	T	G	10	11	21	0	0	21	0	0
19	6100139	.	G	C	10	0	10	1	15	26	0	0
19	6104838	.	C	T	1	9	10	0	2	12	0	0
19	6110968	.	A	T	1	0	1	0	0	1	0	0
19	6111085	.	G	A	3	7	10	0	2	12	0	0
19	6111214	.	A	G	7	10	17	0	0	17	0	0
19	6111223	.	A	G	6	9	15	0	0	15	0	0
19	6111268	.	G	A	9	6	15	0	1	16	0	0
19	6111366	.	C	T	1	5	6	0	7	13	0	0
19	6111460	.	C	G	4	7	11	0	0	11	0	0
19	6111496	.	G	A	6	5	11	0	0	11	0	0
19	6111724	.	T	C	0	3	3	0	0	3	0	0
19	6111730	.	C	A	1	2	3	0	0	3	0	0
19	6111793	.	G	A	2	0	2	0	0	2	0	0
19	6116638	.	A	G	0	2	2	0	0	2	0	0
19	6125197	.	C	A	0	3	3	0	5	8	0	0
19	6125926	.	G	A	4	6	10	0	0	10	0	0
19	6125941	.	C	T	4	6	10	0	1	11	0	0
19	6126001	.	G	A	4	10	14	0	0	14	0	0
19	6126046	.	A	T	0	5	5	0	4	9	0	0
19	6126403	.	C	G	3	2	5	0	0	5	0	0
19	6126625	.	G	A	2	3	5	0	0	5	0	0
19	6126645	.	T	C	4	2	6	0	0	6	0	0
19	6127669	.	C	A	2	2	4	0	0	4	0	0
19	6127696	.	T	C	2	2	4	0	0	4	0	0
19	6142187	.	C	A	1	5	6	0	5	11	0	0
19	6142714	.	A	T	12	8	20	0	1	21	0	0
19	6142803	.	A	G	7	9	16	0	0	16	0	0
19	6142951	.	A	G	3	5	8	0	2	10	0	0
19	6142970	.	C	T	6	7	13	0	0	13	0	0
19	6143278	.	A	C	1	5	6	0	2	8	0	0
19	6143373	.	T	C	7	5	12	0	0	12	0	0
19	6143583	.	C	G	8	4	12	0	0	12	0	0
19	6143610	.	T	A	5	7	12	0	0	12	0	0
19	6143919	.	T	C	2	6	8	0	0	8	0	0
19	6144101	.	T	A	2	5	7	0	1	8	0	0
19	6144267	.	C	A	3	4	7	0	0	7	0	0
19	6144342	.	A	G	4	2	6	0	0	6	0	0
19	6144722	.	C	T	3	7	10	0	0	10	0	0
19	6144822	.	C	G	1	5	6	0	0	6	0	0
19	6145568	.	T	C	3	1	4	0	7	11	0	0
19	6145610	.	A	G	5	4	9	0	2	11	0	0
19	6145964	.	A	G	4	2	6	0	0	6	0	0
19	6145970	.	C	T	0	2	2	0	3	5	0	0
19	6214772	.	G	A	5	8	13	0	1	14	0	0
19	6214835	.	G	T	4	6	10	0	1	11	0	0
19	6216392	.	A	G	2	5	7	0	0	7	0	0
19	6216471	.	A	C	7	4	11	0	0	11	0	0
19	6216606	.	G	A	1	7	8	0	0	8	0	0
19	6217132	.	T	A	3	2	5	0	0	5	0	0
19	6328442	.	T	C	43	11	54	0	35	89	0	0
19	6328514	.	A	C	41	38	79	0	3	82	0	0
19	6329154	.	C	T	7	31	38	0	29	67	0	0
19	6329236	.	A	G	24	30	54	0	3	57	0	0
19	6329237	.	G	A	25	30	55	0	2	57	0	0
19	6329301	.	A	C	37	34	71	0	3	74	0	0
19	6329329	.	G	A	41	31	72	0	1	73	0	0
19	6329533	.	C	T	2	22	24	0	46	71	1	0
19	6329660	.	C	T	9	21	30	1	45	82	6	0
19	6330050	.	T	C	33	28	61	0	4	65	0	0
19	6332902	.	C	A	0	9	9	0	11	20	0	0
19	6333448	.	G	A	28	23	51	0	4	55	0	0
19	6338207	.	A	G	6	4	10	0	1	11	0	0
19	6338261	.	A	G	20	10	30	0	3	33	0	0
19	6339131	.	A	G	8	5	13	0	0	13	0	0
19	6341941	.	A	G	4	5	9	0	1	10	0	0
19	6342076	.	C	G	5	5	10	0	2	12	0	0
19	6344573	.	G	T	25	28	53	0	0	53	0	0
19	6344621	.	C	T	16	24	40	0	2	42	0	0
19	6346506	.	C	G	19	23	42	0	1	43	0	0
19	6346587	.	C	T	0	14	14	0	9	23	0	0
19	6352379	.	A	G	9	7	16	0	2	18	0	0
19	6358232	.	A	G	2	5	7	0	0	7	0	0
19	6358244	.	C	A	2	3	5	0	0	5	0	0
19	6362636	.	A	G	1	1	2	0	1	3	0	0
19	6362804	.	T	A	2	5	7	0	0	7	0	0
19	6606673	.	T	A	1	1	2	0	0	2	0	0
19	6606764	.	A	T	1	1	2	0	0	2	0	0
19	6892337	.	A	G	1	2	3	1	0	4	0	0
19	6893008	.	A	G	1	3	4	0	0	4	0	0
19	6899949	.	C	T	0	2	2	0	0	2	0	0
19	6900002	.	G	T	0	2	2	0	0	2	0	0
19	6901345	.	T	A	3	2	5	0	0	5	0	0
19	6906995	.	A	T	2	2	4	0	0	4	0	0
19	6907006	.	A	G	2	2	4	0	0	4	0	0
19	6907240	.	T	A	5	2	7	0	0	7	0	0
19	6907716	.	C	T	2	1	3	0	0	3	0	0
19	6907740	.	T	C	1	3	4	0	0	4	0	0
19	6907785	.	G	A	0	2	2	0	0	2	0	0
19	6908495	.	A	T	0	2	2	0	0	2	0	0
19	6908520	.	T	C	1	2	3	0	0	3	0	0
19	6908650	.	T	C	3	5	8	0	0	8	0	0
19	6908651	.	T	C	3	5	8	0	0	8	0	0
19	6910409	.	A	G	2	6	8	0	2	10	0	0
19	6914280	.	A	T	1	3	4	0	0	4	0	0
19	6914370	.	A	C	0	2	2	0	0	2	0	0
19	6914415	.	T	C	1	2	3	0	0	3	0	0
19	6914706	.	T	G	0	0	0	1	3	4	0	0
19	6914871	.	G	A	1	1	2	0	1	3	0	0
19	6915030	.	T	C	2	6	8	0	0	8	0	0
19	6915114	.	C	T	2	7	9	0	2	11	0	0
19	6915175	.	A	C	8	4	12	0	0	12	0	0
19	6915177	.	A	G	8	4	12	0	0	12	0	0
19	6915234	.	G	A	3	4	7	0	0	7	0	0
19	6916019	.	T	C	4	3	7	0	0	7	0	0
19	6916029	.	G	A	4	4	8	0	1	9	0	0
19	6916158	.	C	A	5	4	9	0	0	9	0	0
19	6921535	.	G	A	0	3	3	0	1	4	0	0
19	6922498	.	C	T	2	1	3	1	0	4	0	0
19	6933469	.	G	A	5	2	7	0	0	7	0	0
19	6934005	.	C	T	1	2	3	0	0	3	0	0
19	6934166	.	C	T	1	2	3	0	0	3	0	0
19	6938377	.	A	T	8	2	10	0	1	11	0	0
19	6940213	.	C	T	2	0	2	0	0	2	0	0
19	6949256	.	G	A	1	15	16	0	14	30	0	0
19	6949316	.	C	A	10	9	19	0	1	20	0	0
19	6952600	.	T	C	19	21	40	0	2	42	0	0
19	6955061	.	C	T	22	14	36	0	1	37	0	0
19	6955130	.	C	T	16	13	29	0	1	30	0	0
19	6955131	.	C	T	15	13	28	0	2	30	0	0
19	6955198	.	C	A	20	19	39	0	0	39	0	0
19	6955411	.	C	T	8	14	22	0	2	24	0	0
19	6955475	.	T	C	11	7	18	0	0	18	0	0
19	6955609	.	C	G	8	14	22	0	1	23	0	0
19	6955620	.	G	A	1	11	12	0	9	21	0	0
19	6955920	.	G	A	14	11	25	0	0	25	0	0
19	6956058	.	T	C	13	21	34	0	0	34	0	0
19	6956060	.	G	A	13	21	34	0	0	34	0	0
19	6956259	.	C	A	2	3	5	0	0	5	0	0
19	6956553	.	A	C	3	4	7	0	1	8	0	0
19	6956555	.	A	T	4	4	8	0	0	8	0	0
19	6956665	.	C	A	17	14	31	0	0	31	0	0
19	6956728	.	T	A	19	17	36	0	0	36	0	0
19	6956829	.	T	A	19	11	30	0	1	31	0	0
19	6956835	.	C	G	15	9	24	0	3	27	0	0
19	6956881	.	T	C	11	6	17	0	1	18	0	0
19	6956892	.	T	A	9	9	18	0	0	18	0	0
19	6957127	.	A	T	35	16	51	0	4	55	0	0
19	6957131	.	C	A	36	18	54	0	1	55	0	0
19	6960653	.	C	A	9	10	19	0	0	19	0	0
19	6961095	.	G	A	7	8	15	0	0	15	0	0
19	6961120	.	T	C	8	6	14	0	0	14	0	0
19	6961211	.	T	C	6	5	11	0	0	11	0	0
19	6961421	.	T	A	6	5	11	0	0	11	0	0
19	6961610	.	G	A	3	6	9	0	1	10	0	0
19	6961674	.	A	G	7	9	16	0	0	16	0	0
19	6962787	.	T	C	10	5	15	0	1	16	0	0
19	6963020	.	C	T	5	9	14	0	1	15	0	0
19	6963670	.	A	T	0	1	1	0	0	1	0	0
19	6963679	.	G	T	3	4	7	0	0	7	0	0
19	6963966	.	G	A	6	2	8	0	0	8	0	0
19	6963996	.	G	A	6	5	11	0	1	12	0	0
19	6964041	.	A	G	4	4	8	0	0	8	0	0
19	6964058	.	T	C	4	2	6	0	0	6	0	0
19	6964189	.	G	A	3	2	5	0	0	5	0	0
19	6964195	.	C	T	4	2	6	0	2	8	0	0
19	6964273	.	C	A	5	7	12	0	0	12	0	0
19	6964364	.	C	T	4	7	11	0	1	12	0	0
19	6964381	.	T	C	5	7	12	0	0	12	0	0
19	6964417	.	A	G	3	6	9	0	0	9	0	0
19	6964530	.	C	T	0	2	2	0	6	8	0	0
19	6964636	.	C	T	4	2	6	0	2	8	0	0
19	6964641	.	T	C	5	0	5	0	2	7	0	0
19	6965382	.	A	T	1	4	5	0	0	5	0	0
19	6965420	.	A	T	1	3	4	0	0	4	0	0
19	6965656	.	T	C	1	3	4	0	0	4	0	0
19	6965668	.	T	C	2	0	2	0	2	4	0	0
19	6965894	.	C	A	0	2	2	0	2	4	0	0
19	6965897	.	C	T	2	2	4	0	0	4	0	0
19	6966003	.	C	A	1	4	5	0	0	5	0	0
19	6966022	.	A	G	1	5	6	0	0	6	0	0
19	6966208	.	G	A	10	3	13	0	0	13	0	0
19	6966271	.	T	G	5	4	9	0	0	9	0	0
19	6966781	.	A	T	2	3	5	0	1	6	0	0
19	6975261	.	A	C	2	0	2	0	3	5	0	0
19	6980493	.	C	T	2	3	5	0	1	6	0	0
19	6988778	.	T	C	1	2	3	0	1	4	0	0
19	6996114	.	C	A	1	1	2	0	0	2	0	0
19	6996131	.	A	G	1	2	3	0	0	3	0	0
19	6996152	.	T	C	1	2	3	0	0	3	0	0
19	6996885	.	A	G	4	0	4	0	0	4	0	0
19	6998402	.	A	G	0	0	0	0	1	1	0	0
19	6998429	.	T	G	0	0	0	0	1	1	0	0
19	7000068	.	C	T	4	3	7	0	0	7	0	0
19	7005030	.	C	T	1	3	4	0	0	4	0	0
19	7005032	.	G	C	1	3	4	0	0	4	0	0
19	7005462	.	G	A	0	2	2	0	5	7	0	0
19	7005881	.	C	T	1	4	5	0	0	5	0	0
19	7006682	.	G	A	3	2	5	0	0	5	0	0
19	7006709	.	G	T	0	2	2	0	3	5	0	0
19	7006826	.	C	A	1	3	4	0	0	4	0	0
19	7006837	.	A	C	1	3	4	0	1	5	0	0
19	7006928	.	C	T	2	2	4	0	0	4	0	0
19	7014743	.	G	A	3	2	5	0	0	5	0	0
19	7014778	.	T	A	5	2	7	0	0	7	0	0
19	7014863	.	T	G	7	4	11	0	0	11	0	0
19	7014909	.	C	A	6	3	9	0	0	9	0	0
19	7014912	.	G	A	6	3	9	0	0	9	0	0
19	7015111	.	A	G	3	2	5	0	0	5	0	0
19	7020179	.	G	A	3	4	7	0	0	7	0	0
19	7020359	.	T	C	3	0	3	0	4	7	0	0
19	7020775	.	T	C	1	3	4	0	0	4	0	0
19	7022107	.	G	A	3	3	6	0	0	6	0	0
19	7022128	.	G	A	1	3	4	0	0	4	0	0
19	7024591	.	T	G	4	4	8	0	1	9	0	0
19	7024593	.	C	T	4	3	7	0	2	9	0	0
19	7027127	.	G	C	1	1	2	0	0	2	0	0
19	7027810	.	A	T	2	3	5	0	0	5	0	0
19	7027927	.	G	A	4	3	7	0	0	7	0	0
19	7038940	.	A	G	1	1	2	0	0	2	0	0
19	7038942	.	G	A	1	1	2	0	0	2	0	0
19	7039308	.	G	A	0	1	1	0	0	1	0	0
19	7039335	.	T	C	0	0	0	0	1	1	0	0
19	7039344	.	G	A	0	1	1	0	0	1	0	0
19	7106920	.	G	C	2	1	3	0	2	5	0	0
19	7120577	.	T	A	1	2	3	0	0	3	0	0
19	7121807	.	C	G	0	0	0	0	1	1	0	0
19	7122104	.	G	A	1	1	2	0	0	2	0	0
19	7152971	.	G	T	0	10	10	0	6	16	0	0
19	7152974	.	G	A	4	11	15	0	0	15	0	0
19	7154729	.	A	G	13	17	30	0	0	30	0	0
19	7154770	.	A	C	19	12	31	0	0	31	0	0
19	7155001	.	A	T	10	9	19	0	1	20	0	0
19	7155034	.	A	G	16	10	26	0	1	27	0	0
19	7155065	.	T	C	9	11	20	0	3	23	0	0
19	7158469	.	C	T	4	2	6	0	0	6	0	0
19	7158546	.	A	G	1	0	1	0	3	4	0	0
19	7159062	.	G	A	0	1	1	0	5	6	0	0
19	7159107	.	T	C	9	8	17	0	1	18	0	0
19	7161452	.	G	A	1	2	3	0	0	3	0	0
19	7161527	.	A	G	2	0	2	0	3	5	0	0
19	7161539	.	G	T	2	1	3	0	0	3	0	0
19	7163872	.	C	T	9	8	17	0	0	17	0	0
19	7163908	.	A	G	9	12	21	0	0	21	0	0
19	7164022	.	G	A	9	3	12	0	0	12	0	0
19	7166211	.	C	T	9	11	20	0	1	21	0	0
19	7166454	.	C	A	2	2	4	0	0	4	0	0
19	7169204	.	A	C	6	10	16	0	1	17	0	0
19	7169228	.	C	T	14	15	29	0	0	29	0	0
19	7169304	.	G	A	14	5	19	0	2	21	0	0
19	7169770	.	A	C	3	12	15	0	0	15	0	0
19	7169809	.	C	T	6	10	16	0	1	17	0	0
19	7169880	.	T	C	12	6	18	0	0	18	0	0
19	7169886	.	G	A	11	7	18	0	1	19	0	0
19	7169929	.	G	A	9	12	21	0	0	21	0	0
19	7170014	.	A	C	7	9	16	0	0	16	0	0
19	7170015	.	T	C	6	8	14	0	2	16	0	0
19	7170128	.	A	G	8	8	16	0	0	16	0	0
19	7170191	.	A	C	5	10	15	0	0	15	0	0
19	7170228	.	A	T	4	6	10	0	0	10	0	0
19	7170642	.	C	T	2	4	6	0	0	6	0	0
19	7174456	.	T	C	6	2	8	0	0	8	0	0
19	7174486	.	G	T	5	4	9	0	0	9	0	0
19	7174669	.	T	C	1	1	2	0	0	2	0	0
19	7174672	.	T	A	1	1	2	0	0	2	0	0
19	7180589	.	T	C	1	2	3	0	0	3	0	0
19	7180607	.	G	A	1	2	3	0	0	3	0	0
19	7249800	.	A	G	12	6	18	0	2	20	0	0
19	7249811	.	T	C	13	7	20	0	1	21	0	0
19	7250372	.	T	C	1	6	7	0	0	7	0	0
19	7258085	.	A	G	9	6	15	0	1	16	0	0
19	7258118	.	C	T	7	5	12	0	2	14	0	0
19	7265377	.	T	C	1	1	2	0	0	2	0	0
19	7270102	.	G	A	3	2	5	0	2	7	0	0
19	7270156	.	C	A	0	2	2	0	6	8	0	0
19	7272935	.	G	A	2	1	3	0	0	3	0	0
19	7276106	.	G	A	8	14	22	0	2	24	0	0
19	7276149	.	A	G	22	25	47	0	1	48	0	0
19	7276194	.	T	A	29	25	54	0	2	56	0	0
19	7276559	.	G	A	33	32	65	0	2	67	0	0
19	7276610	.	G	A	25	30	55	0	6	61	0	0
19	7277506	.	C	G	1	1	2	0	0	2	0	0
19	7279235	.	A	G	12	12	24	0	1	25	0	0
19	7279721	.	A	G	6	3	9	0	0	9	0	0
19	7282541	.	C	T	9	8	17	0	0	17	0	0
19	7282554	.	G	A	12	14	26	0	1	27	0	0
19	7283427	.	C	A	19	13	32	0	1	33	0	0
19	7283499	.	A	G	14	12	26	0	1	27	0	0
19	7284840	.	C	T	1	18	19	0	9	28	0	0
19	7286301	.	A	G	4	8	12	0	0	12	0	0
19	7286355	.	A	G	20	18	38	0	2	40	0	0
19	7286421	.	T	A	8	7	15	0	2	17	0	0
19	7286742	.	A	G	8	8	16	0	0	16	0	0
19	7287600	.	T	C	10	19	29	0	0	29	0	0
19	7287603	.	G	A	10	17	27	0	0	27	0	0
19	7288195	.	A	G	7	4	11	0	0	11	0	0
19	7290175	.	A	G	0	1	1	0	1	2	0	0
19	7290214	.	A	G	10	12	22	0	0	22	0	0
19	7291642	.	A	T	2	1	3	0	0	3	0	0
19	7292621	.	G	A	2	2	4	0	0	4	0	0
19	7292636	.	A	T	2	2	4	0	0	4	0	0
19	7293138	.	A	G	2	2	4	0	0	4	0	0
19	7295279	.	G	A	7	8	15	0	0	15	0	0
19	7295572	.	G	C	1	3	4	0	0	4	0	0
19	7309154	.	G	A	15	9	24	0	0	24	0	0
19	7309391	.	C	A	26	18	44	0	4	48	0	0
19	7309522	.	G	C	24	19	43	0	0	43	0	0
19	7309556	.	T	A	17	18	35	0	1	36	0	0
19	7309557	.	T	A	17	19	36	0	0	36	0	0
19	7309754	.	T	G	11	17	28	0	2	30	0	0
19	7309929	.	A	T	14	21	35	0	2	37	0	0
19	7309968	.	G	T	19	20	39	0	0	39	0	0
19	7310117	.	T	C	12	0	12	0	18	30	0	0
19	7310131	.	C	T	15	13	28	0	2	30	0	0
19	7310154	.	A	T	12	12	24	0	1	25	0	0
19	7310974	.	T	G	2	1	3	0	0	3	0	0
19	7311678	.	T	G	4	2	6	0	0	6	0	0
19	7313933	.	C	G	6	7	13	0	0	13	0	0
19	7327462	.	A	G	7	8	15	0	1	16	0	0
19	7327519	.	C	T	9	9	18	0	0	18	0	0
19	7327564	.	G	T	4	2	6	0	0	6	0	0
19	7327570	.	T	C	3	2	5	0	0	5	0	0
19	7338033	.	C	T	0	8	8	0	18	26	0	0
19	7338125	.	C	T	8	7	15	0	1	16	0	0
19	7338150	.	G	A	9	5	14	0	0	14	0	0
19	7338218	.	A	T	5	2	7	0	1	8	0	0
19	7338309	.	C	T	0	5	5	0	9	14	0	0
19	7338402	.	C	T	0	5	5	0	7	12	0	0
19	7338425	.	T	C	5	5	10	0	1	11	0	0
19	7338444	.	T	C	5	0	5	0	7	12	0	0
19	7338969	.	C	T	10	10	20	0	0	20	0	0
19	7338978	.	T	C	10	0	10	0	11	21	0	0
19	7339008	.	T	G	9	6	15	0	0	15	0	0
19	7341300	.	G	A	10	5	15	0	0	15	0	0
19	7341385	.	A	G	0	2	2	0	0	2	0	0
19	7358131	.	A	G	1	2	3	0	0	3	0	0
19	7379637	.	T	C	5	0	5	0	3	8	0	0
19	7408360	.	T	G	9	4	13	0	0	13	0	0
19	7409961	.	A	G	0	1	1	0	0	1	0	0
19	7411975	.	T	C	0	5	5	0	0	5	0	0
19	7412320	.	C	T	5	8	13	0	0	13	0	0
19	7412358	.	A	T	5	10	15	0	0	15	0	0
19	7412432	.	C	A	6	4	10	0	0	10	0	0
19	7412441	.	C	A	5	5	10	0	0	10	0	0
19	7412490	.	T	C	3	4	7	0	1	8	0	0
19	7424794	.	G	A	0	3	3	0	1	4	0	0
19	7426637	.	C	T	6	3	9	0	0	9	0	0
19	7426814	.	C	T	6	2	8	0	0	8	0	0
19	7426832	.	G	A	3	3	6	0	0	6	0	0
19	7426967	.	T	C	7	9	16	0	1	17	0	0
19	7430160	.	T	C	12	9	21	0	2	23	0	0
19	7430607	.	G	A	0	13	13	0	13	26	0	0
19	7430652	.	C	T	10	11	21	0	0	21	0	0
19	7430700	.	A	G	5	0	5	0	10	15	0	0
19	7430715	.	C	A	10	4	14	0	0	14	0	0
19	7432806	.	A	C	1	3	4	0	0	4	0	0
19	7433068	.	T	A	1	3	4	0	0	4	0	0
19	7433149	.	A	T	1	2	3	0	0	3	0	0
19	7433454	.	G	A	3	2	5	0	0	5	0	0
19	7433598	.	C	T	2	4	6	0	2	8	0	0
19	7433601	.	T	C	2	5	7	0	1	8	0	0
19	7433637	.	C	A	2	2	4	0	1	5	0	0
19	7433841	.	G	T	4	4	8	0	0	8	0	0
19	7433864	.	T	G	3	3	6	0	0	6	0	0
19	7434139	.	T	C	1	4	5	0	0	5	0	0
19	7434161	.	G	T	3	3	6	0	0	6	0	0
19	7434203	.	T	C	5	2	7	0	0	7	0	0
19	7434252	.	T	C	2	3	5	0	0	5	0	0
19	7434611	.	G	C	8	7	15	0	0	15	0	0
19	7434813	.	G	A	2	2	4	0	0	4	0	0
19	7435535	.	C	A	1	4	5	0	0	5	0	0
19	7435605	.	T	C	0	4	4	0	0	4	0	0
19	7441832	.	T	A	1	1	2	0	0	2	0	0
19	7445676	.	G	A	6	7	13	0	1	14	0	0
19	7445897	.	C	T	28	27	55	0	2	57	0	0
19	7446050	.	T	C	31	24	55	0	1	56	0	0
19	7446137	.	G	T	23	29	52	0	2	54	0	0
19	7446286	.	G	T	28	27	55	0	1	56	0	0
19	7446495	.	G	T	35	25	60	0	5	65	0	0
19	7446621	.	C	A	33	29	62	0	0	62	0	0
19	7446702	.	T	C	4	1	5	0	0	5	0	0
19	7450572	.	G	A	23	18	41	0	0	41	0	0
19	7450658	.	T	C	11	19	30	0	1	31	0	0
19	7450783	.	C	T	0	3	3	0	8	11	0	0
19	7454109	.	A	C	3	6	9	0	0	9	0	0
19	7456364	.	T	C	2	3	5	0	0	5	0	0
19	7456371	.	A	C	2	2	4	0	1	5	0	0
19	7456722	.	C	G	3	6	9	0	0	9	0	0
19	7456793	.	A	G	6	7	13	0	0	13	0	0
19	7456816	.	C	G	6	8	14	0	1	15	0	0
19	7468556	.	G	T	7	6	13	0	0	13	0	0
19	7468580	.	C	T	8	7	15	0	0	15	0	0
19	7468746	.	T	A	0	1	1	0	0	1	0	0
19	7474242	.	T	C	6	7	13	0	0	13	0	0
19	7474245	.	T	G	6	1	7	0	6	13	0	0
19	7478159	.	A	G	8	9	17	0	0	17	0	0
19	7478283	.	C	T	2	7	9	0	1	10	0	0
19	7478356	.	G	A	7	9	16	0	1	17	0	0
19	7482931	.	C	T	9	3	12	0	0	12	0	0
19	7482993	.	G	A	4	6	10	0	0	10	0	0
19	7483059	.	A	T	6	5	11	0	0	11	0	0
19	7483469	.	T	G	4	2	6	0	2	8	0	0
19	7483667	.	G	A	1	2	3	0	0	3	0	0
19	7484313	.	T	A	1	5	6	0	0	6	0	0
19	7484354	.	A	T	3	3	6	0	0	6	0	0
19	7484357	.	G	A	3	2	5	0	0	5	0	0
19	7484433	.	A	G	3	2	5	0	1	6	0	0
19	7484434	.	C	G	3	2	5	0	1	6	0	0
19	7484668	.	A	T	2	2	4	0	0	4	0	0
19	7484746	.	G	A	7	3	10	0	0	10	0	0
19	7484834	.	A	G	1	6	7	0	0	7	0	0
19	7484856	.	C	G	0	4	4	0	1	5	0	0
19	7484990	.	G	T	3	2	5	0	2	7	0	0
19	7485117	.	C	T	1	3	4	0	0	4	0	0
19	7485298	.	A	C	1	3	4	0	0	4	0	0
19	7485457	.	C	T	3	2	5	0	0	5	0	0
19	7485528	.	T	C	2	0	2	0	4	6	0	0
19	7485839	.	G	T	5	2	7	0	0	7	0	0
19	7485890	.	G	A	2	4	6	0	1	7	0	0
19	7486022	.	T	C	4	2	6	0	0	6	0	0
19	7487163	.	A	G	4	2	6	0	0	6	0	0
19	7487321	.	C	T	3	4	7	0	0	7	0	0
19	7495867	.	A	T	8	0	8	0	0	8	0	0
19	7498046	.	T	C	12	5	17	0	2	19	0	0
19	7498079	.	A	G	10	11	21	0	2	23	0	0
19	7498103	.	A	G	7	11	18	0	3	21	0	0
19	7505591	.	A	G	3	7	10	0	1	11	0	0
19	7505907	.	A	G	8	0	8	0	5	13	0	0
19	7506036	.	A	G	6	0	6	0	3	9	0	0
19	7507833	.	A	T	9	10	19	0	0	19	0	0
19	7510223	.	T	C	13	7	20	0	1	21	0	0
19	7510348	.	T	C	11	7	18	0	2	20	0	0
19	7510501	.	G	A	0	8	8	0	7	15	0	0
19	7510567	.	C	T	3	7	10	0	0	10	0	0
19	7512406	.	C	G	11	14	25	0	0	25	0	0
19	7513085	.	C	T	12	9	21	0	0	21	0	0
19	7513291	.	A	C	6	12	18	0	1	19	0	0
19	7513406	.	A	T	9	12	21	0	0	21	0	0
19	7514025	.	T	C	10	5	15	0	0	15	0	0
19	7514031	.	C	T	11	1	12	0	1	13	0	0
19	7514066	.	C	T	6	1	7	0	0	7	0	0
19	7514069	.	G	T	6	1	7	0	0	7	0	0
19	7515293	.	A	G	2	5	7	0	0	7	0	0
19	7515309	.	T	A	5	5	10	0	0	10	0	0
19	7515336	.	A	T	5	10	15	0	0	15	0	0
19	7515356	.	G	A	9	12	21	0	1	22	0	0
19	7515423	.	A	G	9	5	14	0	1	15	0	0
19	7515459	.	A	G	5	0	5	0	1	6	0	0
19	7515461	.	T	G	5	1	6	0	0	6	0	0
19	7515515	.	A	G	1	2	3	0	0	3	0	0
19	7515516	.	A	G	1	2	3	0	0	3	0	0
19	7515787	.	A	T	12	8	20	0	0	20	0	0
19	7515829	.	C	T	7	17	24	0	0	24	0	0
19	7515845	.	A	T	10	18	28	0	0	28	0	0
19	7516035	.	A	G	11	12	23	0	0	23	0	0
19	7516063	.	A	C	14	14	28	0	0	28	0	0
19	7516169	.	C	A	11	16	27	0	1	28	0	0
19	7516183	.	T	G	9	12	21	0	2	23	0	0
19	7525148	.	C	T	0	0	0	0	3	3	0	0
19	7525222	.	T	G	1	6	7	0	1	8	0	0
19	7525337	.	C	A	7	4	11	0	0	11	0	0
19	7529754	.	C	G	0	3	3	0	3	6	0	0
19	7530925	.	T	G	1	1	2	0	1	3	0	0
19	7531061	.	T	C	2	2	4	0	0	4	0	0
19	7534401	.	A	G	2	2	4	0	0	4	0	0
19	7549916	.	G	A	4	6	10	0	1	11	0	0
19	7552736	.	C	G	1	2	3	0	0	3	0	0
19	7552737	.	G	T	0	2	2	0	1	3	0	0
19	7552875	.	G	C	0	1	1	0	1	2	0	0
19	7552887	.	A	G	1	1	2	0	1	3	0	0
19	7553416	.	C	T	1	0	1	0	0	1	0	0
19	7557447	.	C	A	6	8	14	0	0	14	0	0
19	7557538	.	T	C	11	8	19	0	2	21	0	0
19	7557589	.	T	G	13	0	13	0	11	24	0	0
19	7557619	.	A	T	18	11	29	0	0	29	0	0
19	7557773	.	A	T	10	11	21	0	0	21	0	0
19	7557793	.	G	C	12	10	22	0	0	22	0	0
19	7557992	.	C	T	4	1	5	0	0	5	0	0
19	7558009	.	G	A	2	1	3	0	0	3	0	0
19	7559818	.	G	T	8	6	14	0	1	15	0	0
19	7559905	.	A	G	9	13	22	0	0	22	0	0
19	7564073	.	A	G	2	7	9	0	1	10	0	0
19	7565142	.	G	A	17	15	32	0	0	32	0	0
19	7565244	.	A	G	19	23	42	0	1	43	0	0
19	7566493	.	A	T	11	5	16	0	2	19	1	0
19	7567021	.	T	A	16	25	41	0	0	41	0	0
19	7567196	.	A	C	4	2	6	0	0	6	0	0
19	7590501	.	T	C	1	2	3	0	0	3	0	0
19	7590506	.	G	A	1	3	4	0	0	4	0	0
19	7590695	.	A	T	1	3	4	0	0	4	0	0
19	7590964	.	G	A	0	2	2	0	2	4	0	0
19	7604866	.	G	A	5	1	6	0	0	6	0	0
19	7608836	.	G	A	4	3	7	0	0	7	0	0
19	7608980	.	C	T	4	3	7	1	0	8	0	0
19	7609119	.	A	G	5	0	5	0	3	8	0	0
19	7630329	.	T	A	4	2	6	0	0	6	0	0
19	7630785	.	C	T	1	2	3	0	0	3	0	0
19	7631700	.	G	A	0	9	9	0	6	15	0	0
19	7631784	.	A	G	13	13	26	0	1	27	0	0
19	7631829	.	C	A	14	13	27	0	1	28	0	0
19	7631860	.	T	C	18	15	33	0	1	34	0	0
19	7632056	.	C	T	5	6	11	0	0	11	0	0
19	7632216	.	C	T	10	12	22	0	2	24	0	0
19	7632348	.	G	A	0	13	13	0	8	21	0	0
19	7632470	.	C	T	12	9	21	0	0	21	0	0
19	7632526	.	T	C	14	7	21	0	0	21	0	0
19	7632837	.	C	T	6	9	15	0	1	16	0	0
19	7679233	.	C	T	1	3	4	0	0	4	0	0
19	7761855	.	C	T	1	0	1	0	0	1	0	0
19	7762934	.	G	A	4	5	9	0	0	9	0	0
19	7762958	.	G	A	0	1	1	0	4	5	0	0
19	7773391	.	C	G	3	3	6	0	0	6	0	0
19	7775547	.	A	T	9	11	20	0	5	25	0	0
19	7775552	.	T	C	13	12	25	0	1	26	0	0
19	7775789	.	G	A	0	0	0	0	1	1	0	0
19	7782743	.	G	T	1	4	5	0	7	12	0	0
19	7784681	.	T	A	4	1	5	1	1	7	0	0
19	7784684	.	T	A	4	1	5	1	1	7	0	0
19	7785138	.	C	T	4	1	5	0	0	5	0	0
19	7794887	.	C	T	16	24	40	0	2	42	0	0
19	7794893	.	A	T	16	24	40	0	3	44	1	0
19	7796842	.	C	A	8	12	20	0	2	23	1	0
19	7796951	.	T	C	12	9	21	0	3	24	0	0
19	7796975	.	T	C	14	4	18	0	2	20	0	0
19	7796986	.	A	T	13	7	20	0	2	22	0	0
19	7797259	.	T	A	17	19	36	0	1	37	0	0
19	7797539	.	T	G	17	19	36	0	0	36	0	0
19	7797651	.	G	T	9	7	16	0	1	17	0	0
19	7799225	.	A	G	1	0	1	0	0	1	0	0
19	7799226	.	A	T	1	0	1	0	0	1	0	0
19	7800812	.	A	G	1	0	1	0	0	1	0	0
19	7802700	.	G	A	4	1	5	0	0	5	0	0
19	7803424	.	C	A	3	5	8	0	1	9	0	0
19	7803435	.	A	T	4	4	8	0	1	9	0	0
19	7803460	.	G	T	0	2	2	0	3	5	0	0
19	7804785	.	A	C	2	2	4	0	0	4	0	0
19	7820040	.	T	C	9	11	20	0	1	21	0	0
19	7820079	.	T	A	12	9	21	0	0	21	0	0
19	7820107	.	G	A	9	6	15	0	0	15	0	0
19	7820466	.	C	A	1	6	7	0	8	15	0	0
19	7823285	.	G	A	0	2	2	0	0	2	0	0
19	7823306	.	G	A	3	3	6	0	0	6	0	0
19	7823330	.	C	T	6	4	10	0	1	11	0	0
19	7825127	.	T	C	0	4	4	0	0	4	0	0
19	7825163	.	C	T	1	4	5	0	0	5	0	0
19	7825181	.	G	C	3	9	12	0	0	12	0	0
19	7825259	.	G	A	9	5	14	0	0	14	0	0
19	7825300	.	A	G	2	3	5	0	0	5	0	0
19	7827016	.	G	A	2	3	5	0	0	5	0	0
19	7827377	.	C	T	0	2	2	0	6	8	0	0
19	7827579	.	G	A	1	2	3	0	0	3	0	0
19	7827666	.	A	G	2	4	6	0	0	6	0	0
19	7827672	.	G	C	2	4	6	0	0	6	0	0
19	7828600	.	T	C	3	2	5	0	1	6	0	0
19	7828674	.	G	A	7	2	9	0	0	9	0	0
19	7828774	.	A	G	2	3	5	0	0	5	0	0
19	7828912	.	G	A	2	6	8	0	0	8	0	0
19	7828930	.	T	G	5	4	9	0	0	9	0	0
19	7829506	.	A	T	1	2	3	0	0	3	0	0
19	7829998	.	A	G	4	3	7	0	0	7	0	0
19	7830013	.	G	A	4	3	7	0	0	7	0	0
19	7830064	.	A	G	2	2	4	0	0	4	0	0
19	7830700	.	G	A	1	2	3	0	0	3	0	0
19	7835774	.	G	A	3	4	7	0	0	7	0	0
19	7837736	.	T	C	2	5	7	0	0	7	0	0
19	7837747	.	C	T	1	4	5	0	2	7	0	0
19	7837810	.	T	C	1	2	3	0	0	3	0	0
19	7837811	.	A	T	1	2	3	0	0	3	0	0
19	8144609	.	G	A	3	2	5	0	0	5	0	0
19	8315244	.	T	C	3	2	5	0	0	5	0	0
19	8336640	.	G	C	9	14	23	0	1	24	0	0
19	8336642	.	C	T	9	15	24	0	0	24	0	0
19	8336689	.	G	A	4	5	9	0	1	10	0	0
19	8337115	.	T	C	3	4	7	0	0	7	0	0
19	8337135	.	C	A	5	3	8	0	0	9	1	0
19	8337182	.	A	G	2	0	2	0	2	4	0	0
19	8337185	.	C	G	2	2	4	0	0	4	0	0
19	8338616	.	T	A	6	11	17	0	1	18	0	0
19	8338649	.	T	A	7	9	16	0	0	16	0	0
19	8338711	.	C	G	7	2	9	0	1	10	0	0
19	8339202	.	T	A	10	20	30	0	0	30	0	0
19	8339302	.	A	G	14	24	38	0	0	38	0	0
19	8482053	.	T	A	2	0	2	0	0	2	0	0
19	8496701	.	C	T	1	7	8	0	0	8	0	0
19	8497743	.	C	A	1	2	3	0	0	3	0	0
19	8497744	.	A	C	1	2	3	0	0	3	0	0
19	8500688	.	T	C	5	13	18	0	0	18	0	0
19	8501067	.	C	T	7	2	9	0	1	10	0	0
19	8501075	.	A	T	7	2	9	0	1	10	0	0
19	8501218	.	G	A	4	10	14	0	2	16	0	0
19	8501490	.	G	T	6	7	13	0	0	13	0	0
19	8501499	.	T	C	8	5	13	0	1	14	0	0
19	8501526	.	T	A	8	10	18	0	0	18	0	0
19	8501535	.	C	T	7	13	20	0	1	21	0	0
19	8501660	.	G	T	0	2	2	0	8	10	0	0
19	8501663	.	C	T	7	2	9	0	1	10	0	0
19	8501751	.	T	A	6	2	8	0	1	9	0	0
19	8501901	.	A	T	8	10	18	0	0	18	0	0
19	8501961	.	G	A	0	3	3	0	10	13	0	0
19	8501962	.	G	A	9	3	12	0	1	13	0	0
19	8502104	.	C	G	2	5	7	0	0	7	0	0
19	8502133	.	C	T	4	6	10	0	0	10	0	0
19	8502166	.	G	T	0	13	13	0	8	21	0	0
19	8502225	.	T	A	13	13	26	0	0	26	0	0
19	8502244	.	G	A	13	10	23	0	3	26	0	0
19	8534126	.	G	C	5	5	10	0	0	10	0	0
19	8534201	.	A	T	6	3	9	0	0	9	0	0
19	8534320	.	C	A	10	3	13	0	0	13	0	0
19	8534339	.	A	C	15	4	19	0	0	19	0	0
19	8534426	.	G	A	18	10	28	0	2	30	0	0
19	8534428	.	A	G	19	11	30	0	0	30	0	0
19	8582809	.	A	G	2	7	9	0	1	10	0	0
19	8583065	.	A	G	10	10	20	0	0	20	0	0
19	8592419	.	A	G	6	3	9	0	0	9	0	0
19	8592906	.	C	T	0	2	2	0	0	2	0	0
19	8613041	.	G	C	7	7	14	0	0	14	0	0
19	8637657	.	T	C	4	3	7	0	0	7	0	0
19	8638539	.	C	A	2	1	3	0	0	3	0	0
19	8681470	.	G	A	5	3	8	0	0	8	0	0
19	8724356	.	A	T	0	2	2	0	0	2	0	0
19	8747688	.	G	A	15	26	41	0	0	41	0	0
19	8817121	.	C	A	7	6	13	0	1	14	0	0
19	8817480	.	A	G	20	17	37	0	3	40	0	0
19	8817608	.	G	A	31	18	49	0	1	50	0	0
19	8822347	.	A	G	1	1	2	0	0	2	0	0
19	8824364	.	A	G	8	8	16	0	3	19	0	0
19	8831907	.	C	T	0	2	2	0	2	4	0	0
19	8836805	.	C	T	6	4	10	0	3	13	0	0
19	8880614	.	C	G	5	4	9	0	0	9	0	0
19	8894119	.	T	A	6	7	13	0	1	14	0	0
19	8894138	.	A	G	6	5	11	0	1	12	0	0
19	8894229	.	T	C	8	5	13	0	0	13	0	0
19	8894905	.	G	T	6	6	12	0	1	13	0	0
19	8895074	.	G	A	15	14	29	0	0	29	0	0
19	8895163	.	T	C	8	11	19	0	1	20	0	0
19	8895514	.	C	A	0	5	5	0	4	9	0	0
19	8897625	.	A	C	2	0	2	0	4	7	1	0
19	8898597	.	A	C	2	0	2	0	2	4	0	0
19	8928718	.	G	A	10	4	14	0	1	15	0	0
19	8928767	.	G	C	14	12	26	0	1	27	0	0
19	8929035	.	T	C	3	5	8	0	0	8	0	0
19	8929488	.	C	T	0	15	15	0	15	30	0	0
19	8929549	.	T	C	6	0	6	0	18	24	0	0
19	8929669	.	A	G	10	5	15	0	1	16	0	0
19	8929678	.	A	G	9	6	15	0	0	15	0	0
19	8929743	.	T	A	12	4	16	0	1	17	0	0
19	8930187	.	A	G	8	3	11	0	1	12	0	0
19	8937285	.	G	A	0	3	3	0	1	4	0	0
19	8937377	.	T	C	5	6	11	0	1	12	0	0
19	8958892	.	A	G	12	14	26	0	1	27	0	0
19	8962835	.	C	T	5	6	11	0	1	12	0	0
19	8962840	.	A	C	6	0	6	0	6	12	0	0
19	8978611	.	C	T	1	3	4	0	0	4	0	0
19	8979185	.	G	T	5	3	8	0	1	9	0	0
19	8979268	.	G	C	2	2	4	0	0	4	0	0
19	8997627	.	T	C	4	4	8	0	0	8	0	0
19	9000665	.	C	T	21	27	48	0	2	50	0	0
19	9000674	.	T	C	23	27	50	0	0	50	0	0
19	9000718	.	G	A	0	25	25	0	16	41	0	0
19	9000838	.	C	T	17	24	41	0	2	43	0	0
19	9000855	.	T	A	16	23	39	0	2	41	0	0
19	9000907	.	A	G	17	1	18	0	14	32	0	0
19	9001100	.	C	T	11	20	31	0	0	31	0	0
19	9001180	.	A	G	13	15	28	0	1	29	0	0
19	9001246	.	C	T	10	14	24	0	2	26	0	0
19	9001317	.	G	A	16	18	34	0	0	34	0	0
19	9044331	.	C	T	2	1	3	0	0	3	0	0
19	9044727	.	G	A	2	3	5	0	1	6	0	0
19	9044799	.	T	A	1	5	6	0	1	7	0	0
19	9045097	.	G	T	0	2	2	0	1	3	0	0
19	9045443	.	C	G	2	2	4	0	1	5	0	0
19	9046327	.	C	T	4	3	7	0	0	7	0	0
19	9046467	.	G	A	6	6	12	0	0	12	0	0
19	9050609	.	C	G	3	11	14	0	0	14	0	0
19	9050631	.	T	C	4	13	17	0	0	17	0	0
19	9050737	.	G	C	7	8	15	0	0	15	0	0
19	9050745	.	A	G	7	5	12	0	0	12	0	0
19	9050823	.	A	G	13	3	16	0	1	17	0	0
19	9064759	.	T	C	3	3	6	0	0	6	0	0
19	9064777	.	C	A	5	6	11	0	0	11	0	0
19	9064822	.	A	G	9	8	17	0	0	17	0	0
19	9064853	.	T	C	7	3	10	0	0	10	0	0
19	9064885	.	G	A	0	0	0	0	1	1	0	0
19	9067211	.	G	A	8	9	17	0	1	18	0	0
19	9070546	.	T	G	12	0	12	0	8	20	0	0
19	9072451	.	C	T	4	11	15	0	2	17	0	0
19	9078840	.	A	T	1	3	4	0	0	4	0	0
19	9079084	.	T	C	14	5	19	0	0	19	0	0
19	9081228	.	T	C	14	15	29	0	1	30	0	0
19	9081272	.	C	T	13	13	26	0	1	27	0	0
19	9084630	.	G	A	1	10	11	0	18	29	0	0
19	9084634	.	A	G	18	0	18	0	11	29	0	0
19	9084797	.	A	T	21	19	40	0	1	41	0	0
19	9084848	.	G	A	1	21	22	0	19	41	0	0
19	9084859	.	G	T	19	19	38	0	2	40	0	0
19	9085835	.	A	G	20	11	31	0	0	31	0	0
19	9086132	.	C	A	18	25	43	0	1	44	0	0
19	9117114	.	G	A	1	2	3	0	2	5	0	0
19	9117473	.	T	G	2	3	5	0	0	5	0	0
19	9117511	.	A	G	1	4	5	0	0	5	0	0
19	9117731	.	G	T	1	2	3	0	1	4	0	0
19	9117769	.	A	G	1	1	2	0	1	3	0	0
19	9117777	.	T	A	1	2	3	0	0	3	0	0
19	9117912	.	T	C	4	3	7	0	0	7	0	0
19	9117928	.	A	G	4	2	6	0	0	6	0	0
19	9118044	.	G	A	0	3	3	0	3	6	0	0
19	9125062	.	G	A	2	0	2	0	0	2	0	0
19	9134017	.	G	A	0	4	4	0	6	10	0	0
19	9135065	.	A	G	6	1	7	0	3	10	0	0
19	9135754	.	A	T	8	9	17	0	0	17	0	0
19	9138695	.	A	G	2	0	2	0	10	12	0	0
19	9138850	.	C	A	5	3	8	0	2	10	0	0
19	9140675	.	A	T	12	11	23	0	1	24	0	0
19	9140750	.	T	C	7	8	15	0	1	16	0	0
19	9140950	.	T	C	0	3	3	0	0	3	0	0
19	9144175	.	G	A	1	8	9	0	5	14	0	0
19	9144228	.	T	G	1	5	6	0	0	7	1	0
19	9150074	.	T	C	3	7	10	0	1	11	0	0
19	9152720	.	C	A	1	3	4	0	0	4	0	0
19	9152841	.	A	T	14	10	24	0	2	26	0	0
19	9155603	.	A	G	7	0	7	0	14	21	0	0
19	9155691	.	C	T	11	15	26	0	2	28	0	0
19	9158481	.	A	T	6	10	16	0	0	16	0	0
19	9161621	.	C	T	7	4	11	0	0	11	0	0
19	9161631	.	T	G	4	2	6	0	0	6	0	0
19	9161824	.	T	C	18	9	27	0	0	27	0	0
19	9168699	.	T	C	13	22	35	0	0	35	0	0
19	9169162	.	G	C	9	5	14	0	0	14	0	0
19	9179365	.	G	A	1	2	3	0	0	3	0	0
19	9216201	.	T	A	10	6	16	0	9	25	0	0
19	9216221	.	A	C	7	10	17	0	0	17	0	0
19	9216367	.	G	A	2	3	5	0	0	5	0	0
19	9217143	.	C	T	11	15	26	0	4	30	0	0
19	9218405	.	G	A	12	23	35	0	0	35	0	0
19	9220849	.	T	C	18	13	31	0	1	32	0	0
19	9225567	.	C	T	6	4	10	0	0	10	0	0
19	9228326	.	A	T	16	13	29	0	2	31	0	0
19	9228378	.	A	G	14	0	14	0	10	24	0	0
19	9228380	.	C	T	13	8	21	0	3	24	0	0
19	9228428	.	G	T	9	4	13	0	2	15	0	0
19	9232751	.	A	G	1	2	3	0	0	3	0	0
19	9232753	.	C	A	1	2	3	0	0	3	0	0
19	9241173	.	T	C	1	2	3	0	0	3	0	0
19	9247042	.	A	G	2	3	5	0	0	5	0	0
19	9262904	.	C	T	1	0	1	0	0	1	0	0
19	9265048	.	T	C	7	4	11	0	0	11	0	0
19	9265417	.	C	T	3	4	7	0	0	7	0	0
19	9265429	.	G	T	3	4	7	0	0	7	0	0
19	9266027	.	A	G	5	3	8	0	0	8	0	0
19	9266749	.	T	C	1	6	7	0	0	7	0	0
19	9266793	.	A	C	2	4	6	0	0	6	0	0
19	9270836	.	T	C	4	1	5	0	0	5	0	0
19	9273997	.	A	G	8	0	8	0	3	11	0	0
19	9274428	.	T	A	8	6	14	0	0	14	0	0
19	9274497	.	G	A	7	4	11	0	1	12	0	0
19	9274705	.	C	T	5	2	7	0	1	8	0	0
19	9274891	.	G	T	13	6	19	0	0	19	0	0
19	9604114	.	A	G	2	6	8	0	0	8	0	0
19	9685695	.	A	G	30	24	54	0	1	55	0	0
19	9685714	.	A	C	26	23	49	0	2	51	0	0
19	9686078	.	C	A	10	16	26	0	1	27	0	0
19	9686099	.	G	T	11	15	26	0	1	27	0	0
19	9686160	.	T	C	14	22	36	0	0	36	0	0
19	9686199	.	G	T	17	21	38	0	1	39	0	0
19	9686503	.	A	G	15	15	30	0	3	33	0	0
19	9686548	.	T	A	7	10	17	1	0	18	0	0
19	9686575	.	T	A	4	12	16	1	0	17	0	0
19	9686616	.	A	T	14	11	25	0	0	25	0	0
19	9686646	.	C	T	21	11	32	0	0	32	0	0
19	9686678	.	T	A	15	13	28	0	0	28	0	0
19	9686806	.	T	C	7	7	14	0	0	14	0	0
19	9686905	.	T	C	8	0	8	0	8	16	0	0
19	9687033	.	C	T	13	11	24	0	3	27	0	0
19	9687073	.	G	A	19	16	35	0	1	36	0	0
19	9687146	.	T	C	26	17	43	0	1	44	0	0
19	9691780	.	A	G	9	8	17	0	1	18	0	0
19	9702271	.	T	C	0	1	1	0	0	1	0	0
19	9712444	.	G	A	5	6	11	0	0	11	0	0
19	9712514	.	C	T	3	3	6	0	0	6	0	0
19	9813608	.	G	A	18	24	42	0	1	43	0	0
19	9813905	.	A	G	3	15	18	0	0	18	0	0
19	9813942	.	A	G	6	9	15	0	1	16	0	0
19	9822610	.	G	A	11	17	28	0	1	29	0	0
19	9840924	.	C	T	11	12	23	0	1	24	0	0
19	9841006	.	A	G	10	18	28	0	1	29	0	0
19	9841035	.	G	A	6	12	18	0	0	18	0	0
19	9841054	.	T	C	6	0	6	0	8	14	0	0
19	9841523	.	G	A	14	11	25	0	1	26	0	0
19	9841728	.	T	C	2	13	15	0	1	16	0	0
19	9841825	.	C	T	9	7	16	0	0	16	0	0
19	9841902	.	A	T	22	11	33	0	0	33	0	0
19	9842252	.	T	C	18	11	29	0	4	33	0	0
19	9842306	.	A	G	23	13	36	0	1	37	0	0
19	9866933	.	C	T	4	4	8	0	0	8	0	0
19	9910842	.	G	A	11	11	22	0	0	22	0	0
19	9911419	.	G	A	4	3	7	0	0	7	0	0
19	9911855	.	G	A	5	3	8	0	1	9	0	0
19	9911863	.	A	T	5	3	8	0	0	8	0	0
19	9912063	.	C	T	8	7	15	0	2	17	0	0
19	9912496	.	A	G	4	4	8	0	0	8	0	0
19	9912535	.	C	T	0	5	5	1	0	6	0	0
19	9912756	.	C	A	5	12	17	0	0	17	0	0
19	9912946	.	A	T	7	10	17	0	1	18	0	0
19	9912993	.	C	A	3	9	12	0	1	13	0	0
19	9912998	.	T	C	4	10	14	0	0	14	0	0
19	9913647	.	A	T	4	7	11	0	0	11	0	0
19	9913868	.	T	G	3	3	6	0	0	6	0	0
19	9914291	.	T	G	1	7	8	0	0	8	0	0
19	9914357	.	G	A	3	3	6	0	1	7	0	0
19	9914424	.	T	A	3	3	6	0	0	6	0	0
19	9914737	.	A	G	2	3	5	0	1	6	0	0
19	9914845	.	G	A	4	5	9	0	2	11	0	0
19	9914866	.	T	A	6	4	10	0	1	11	0	0
19	9917518	.	C	T	1	2	3	0	0	3	0	0
19	9917581	.	G	A	1	5	6	0	0	6	0	0
19	10177290	.	G	A	11	20	31	0	1	32	0	0
19	10177397	.	T	G	14	18	32	0	0	32	0	0
19	10177951	.	A	G	12	20	32	0	0	32	0	0
19	10178339	.	T	A	13	21	34	0	3	37	0	0
19	10180561	.	C	T	0	8	8	0	7	15	0	0
19	10190085	.	A	G	0	1	1	0	0	1	0	0
19	10195432	.	T	C	6	5	11	0	0	11	0	0
19	10196070	.	T	A	3	3	6	0	0	10	4	0
19	10196113	.	T	C	3	10	13	0	0	13	0	0
19	10201566	.	T	G	10	6	16	0	0	16	0	0
19	10201719	.	A	G	16	15	31	0	1	32	0	0
19	10202598	.	T	C	12	0	12	0	11	23	0	0
19	10202682	.	T	C	10	0	10	0	13	23	0	0
19	10202756	.	T	A	11	13	24	0	1	25	0	0
19	10203024	.	C	A	0	6	6	0	10	16	0	0
19	10203480	.	C	T	0	8	8	0	12	20	0	0
19	10204407	.	G	C	6	6	12	0	0	12	0	0
19	10205505	.	G	A	6	5	11	0	0	11	0	0
19	10205946	.	C	T	1	4	5	0	0	5	0	0
19	10206414	.	G	A	4	3	7	0	0	7	0	0
19	10206420	.	G	A	3	4	7	0	0	7	0	0
19	10217742	.	A	G	1	12	13	0	5	18	0	0
19	10217844	.	T	A	7	6	13	0	3	16	0	0
19	10218136	.	T	A	7	19	26	0	0	26	0	0
19	10218807	.	C	T	0	10	10	0	9	19	0	0
19	10219001	.	C	T	15	12	27	0	2	29	0	0
19	10219051	.	T	A	9	8	17	0	0	17	0	0
19	10219186	.	C	A	16	21	37	0	1	38	0	0
19	10219209	.	T	G	16	14	30	0	1	31	0	0
19	10219387	.	T	C	15	16	31	0	1	32	0	0
19	10219542	.	G	A	12	22	34	0	1	35	0	0
19	10219547	.	T	C	9	24	33	0	2	35	0	0
19	10219749	.	C	T	13	14	27	0	0	28	1	0
19	10220013	.	G	A	17	30	47	0	1	48	0	0
19	10220064	.	A	T	13	22	35	0	2	37	0	0
19	10220421	.	A	G	13	23	36	0	1	37	0	0
19	10220448	.	C	G	0	24	24	0	13	37	0	0
19	10220651	.	T	C	21	7	28	0	28	56	0	0
19	10220790	.	C	T	4	13	17	0	0	17	0	0
19	10237365	.	C	A	2	11	13	0	5	18	0	0
19	10252679	.	A	T	5	4	9	0	0	9	0	0
19	10253058	.	A	T	5	5	10	0	0	10	0	0
19	10253316	.	T	C	5	9	14	0	1	15	0	0
19	10253347	.	T	C	4	6	10	0	3	13	0	0
19	10253759	.	A	G	5	4	9	0	0	9	0	0
19	10253915	.	T	C	6	6	12	0	0	12	0	0
19	10253985	.	G	A	6	3	9	0	0	9	0	0
19	10254772	.	C	T	3	6	9	0	0	9	0	0
19	10254840	.	C	T	0	11	11	0	5	16	0	0
19	10255387	.	T	A	0	3	3	0	0	3	0	0
19	10255458	.	T	C	1	0	1	0	5	6	0	0
19	10255459	.	A	G	1	5	6	0	0	6	0	0
19	10255680	.	G	A	5	7	12	0	2	14	0	0
19	10281958	.	C	T	0	1	1	0	2	3	0	0
19	10299174	.	A	C	9	13	22	0	0	22	0	0
19	10299383	.	G	A	23	12	35	0	4	39	0	0
19	10299579	.	C	A	10	7	17	0	1	18	0	0
19	10299593	.	A	G	9	4	13	0	0	13	0	0
19	10299706	.	C	T	1	13	14	0	14	28	0	0
19	10301236	.	T	C	8	17	25	0	1	26	0	0
19	10351495	.	A	T	2	3	5	0	0	5	0	0
19	10376610	.	A	C	16	2	18	0	0	18	0	0
19	10377097	.	C	T	12	15	27	0	1	28	0	0
19	10377534	.	G	T	11	18	29	0	1	30	0	0
19	10377633	.	A	G	4	18	22	0	1	23	0	0
19	10377777	.	T	C	16	11	27	0	0	27	0	0
19	10377815	.	A	C	12	18	30	0	0	30	0	0
19	10377892	.	A	C	16	12	28	0	1	29	0	0
19	10377911	.	A	T	15	16	31	0	1	32	0	0
19	10378192	.	G	A	16	25	41	0	2	43	0	0
19	10378457	.	A	T	11	14	25	0	2	27	0	0
19	10378544	.	C	T	11	12	23	0	1	24	0	0
19	10378599	.	T	C	11	11	22	0	1	23	0	0
19	10378618	.	C	T	11	11	22	0	0	22	0	0
19	10378700	.	A	G	10	13	23	0	0	23	0	0
19	10378848	.	C	T	14	7	21	0	1	22	0	0
19	10378868	.	T	C	8	1	9	0	9	18	0	0
19	10378889	.	C	T	8	8	16	0	0	16	0	0
19	10378959	.	C	A	7	15	22	0	1	23	0	0
19	10379011	.	T	C	10	5	15	0	1	16	0	0
19	10379183	.	C	A	10	6	16	0	0	16	0	0
19	10379192	.	C	T	9	6	15	0	1	16	0	0
19	10379314	.	C	T	0	13	13	0	11	24	0	0
19	10379321	.	C	T	11	14	25	0	0	25	0	0
19	10379369	.	C	T	11	11	22	0	2	24	0	0
19	10379475	.	A	G	16	11	27	0	1	28	0	0
19	10379555	.	T	G	9	11	20	0	1	21	0	0
19	10379575	.	A	G	11	12	23	0	0	23	0	0
19	10379821	.	T	A	17	19	36	0	0	36	0	0
19	10379833	.	T	G	14	17	31	0	0	31	0	0
19	10379873	.	A	G	13	17	30	0	0	30	0	0
19	10379965	.	T	C	8	9	17	0	1	18	0	0
19	10383100	.	A	G	9	8	17	0	2	19	0	0
19	10383112	.	G	T	11	10	21	0	1	22	0	0
19	10383532	.	G	A	11	7	18	0	1	19	0	0
19	10383533	.	T	A	8	7	15	0	4	19	0	0
19	10383616	.	C	T	0	3	3	0	4	7	0	0
19	10383631	.	C	T	0	2	2	0	1	3	0	0
19	10386619	.	C	T	11	10	21	0	0	21	0	0
19	10388285	.	C	T	2	3	5	0	0	5	0	0
19	10393034	.	G	A	2	3	5	0	0	5	0	0
19	10393072	.	A	G	5	6	11	0	0	11	0	0
19	10394835	.	T	G	0	5	5	0	0	5	0	0
19	10407312	.	C	T	7	6	13	0	2	15	0	0
19	10407546	.	A	T	21	30	51	0	0	51	0	0
19	10407732	.	T	A	30	31	61	0	3	65	1	0
19	10407767	.	G	T	25	31	56	0	1	57	0	0
19	10408021	.	G	A	1	2	3	0	0	3	0	0
19	10497175	.	C	A	2	2	4	0	0	4	0	0
19	10561001	.	A	G	7	6	13	0	0	13	0	0
19	10565385	.	C	T	2	2	4	0	1	5	0	0
19	10569122	.	T	C	2	3	5	0	0	5	0	0
19	10575315	.	T	C	8	2	10	0	2	12	0	0
19	10575318	.	G	T	9	4	13	0	0	13	0	0
19	10575565	.	G	C	0	13	13	0	7	20	0	0
19	10575824	.	T	G	10	10	20	0	0	20	0	0
19	10576120	.	G	T	9	3	12	0	0	12	0	0
19	10576138	.	G	T	8	4	12	0	0	12	0	0
19	10576289	.	C	G	3	6	9	0	0	9	0	0
19	10576297	.	A	T	3	5	8	0	1	9	0	0
19	10576338	.	G	A	0	3	3	0	3	6	0	0
19	10576482	.	C	T	4	7	11	0	0	11	0	0
19	10576520	.	T	C	10	7	17	0	0	17	0	0
19	10576909	.	G	A	7	8	15	0	0	15	0	0
19	10576970	.	A	T	7	15	22	0	0	22	0	0
19	10577011	.	T	G	7	0	7	0	17	24	0	0
19	10577194	.	T	A	4	10	14	0	0	14	0	0
19	10577253	.	T	A	8	6	14	0	0	14	0	0
19	10649711	.	T	A	5	5	10	0	1	11	0	0
19	10649722	.	T	C	6	5	11	0	1	12	0	0
19	10649830	.	G	T	3	3	6	0	1	7	0	0
19	10653644	.	C	T	0	4	4	0	2	6	0	0
19	10654540	.	G	A	3	2	5	0	0	5	0	0
19	10654553	.	C	A	0	4	4	0	2	6	0	0
19	10668840	.	G	A	1	0	1	0	0	1	0	0
19	10674335	.	C	T	0	3	3	0	0	3	0	0
19	10674341	.	C	T	0	3	3	0	0	3	0	0
19	10826516	.	G	A	0	2	2	0	0	2	0	0
19	10826564	.	A	G	0	2	2	0	0	2	0	0
19	10841477	.	G	T	11	12	23	0	1	24	0	0
19	10867358	.	T	G	2	3	5	0	0	5	0	0
19	10867365	.	G	T	2	3	5	0	0	5	0	0
19	10868522	.	G	A	0	2	2	0	2	4	0	0
19	10868541	.	C	A	2	4	6	0	0	6	0	0
19	10869699	.	A	G	1	3	4	0	0	4	0	0
19	10869722	.	C	T	1	3	4	0	0	4	0	0
19	10870305	.	A	G	2	0	2	0	7	9	0	0
19	10870361	.	C	T	6	5	11	0	0	11	0	0
19	10870602	.	G	A	6	5	11	0	1	12	0	0
19	10870737	.	A	G	2	3	5	0	0	5	0	0
19	10870845	.	C	T	3	7	10	0	0	10	0	0
19	10870956	.	A	G	2	4	6	0	0	6	0	0
19	10871719	.	A	G	12	8	20	0	1	21	0	0
19	10871803	.	C	T	0	12	12	0	6	18	0	0
19	10871823	.	A	G	6	9	15	0	0	15	0	0
19	10872397	.	C	T	4	7	11	0	0	11	0	0
19	10875854	.	A	G	13	11	24	0	0	24	0	0
19	10876446	.	C	T	3	1	4	0	0	4	0	0
19	10893211	.	T	C	2	2	4	0	0	4	0	0
19	10893284	.	G	A	1	2	3	0	1	4	0	0
19	10904927	.	G	A	3	0	3	0	1	4	0	0
19	10908005	.	A	G	1	2	3	0	0	3	0	0
19	12188083	.	G	T	16	21	37	0	3	40	0	0
19	12188207	.	A	G	30	22	52	0	4	56	0	0
19	12188243	.	A	G	34	26	60	0	0	60	0	0
19	12188249	.	A	G	34	26	60	0	2	62	0	0
19	12193578	.	G	C	0	7	7	0	1	8	0	0
19	12206504	.	T	G	16	9	25	0	1	26	0	0
19	12211809	.	T	C	5	5	10	0	1	11	0	0
19	12297178	.	C	T	3	5	8	0	0	8	0	0
19	12297375	.	A	G	9	6	15	0	0	15	0	0
19	12297869	.	A	C	1	3	4	0	0	4	0	0
19	12300840	.	G	A	0	4	4	0	0	4	0	0
19	12304095	.	C	T	10	5	15	0	3	18	0	0
19	12304137	.	A	G	7	4	11	0	1	12	0	0
19	12356418	.	G	A	0	1	1	0	3	4	0	0
19	12363275	.	C	T	10	8	18	0	1	19	0	0
19	12380004	.	A	T	5	5	10	0	1	11	0	0
19	12380029	.	A	T	2	2	4	0	1	5	0	0
19	12383623	.	G	A	2	0	2	0	0	2	0	0
19	12385998	.	A	G	1	5	6	0	0	6	0	0
19	12410252	.	A	G	4	3	7	0	0	7	0	0
19	12413422	.	C	A	4	5	9	0	0	9	0	0
19	12413479	.	C	T	5	9	14	0	2	16	0	0
19	12420188	.	G	A	0	3	3	0	9	12	0	0
19	12424420	.	A	T	1	0	1	0	0	1	0	0
19	12427675	.	G	A	12	7	19	0	0	19	0	0
19	12428228	.	A	G	1	2	3	0	0	3	0	0
19	12428413	.	C	G	3	3	6	0	0	6	0	0
19	12428454	.	A	G	3	4	7	0	1	8	0	0
19	12428634	.	A	G	9	12	21	0	1	22	0	0
19	12428646	.	A	G	6	10	16	0	2	18	0	0
19	12428741	.	T	C	8	8	16	0	0	16	0	0
19	12428754	.	A	G	13	9	22	0	1	23	0	0
19	12645583	.	G	T	4	9	13	0	1	14	0	0
19	12645661	.	C	T	1	0	1	0	0	1	0	0
19	12648372	.	T	C	4	7	11	0	0	11	0	0
19	12655606	.	G	C	2	1	3	0	2	5	0	0
19	12661671	.	T	G	3	2	5	0	0	5	0	0
19	12762981	.	G	C	6	2	8	0	1	9	0	0
19	12801983	.	T	C	5	5	10	0	0	10	0	0
19	12801987	.	T	C	5	5	10	0	0	10	0	0
19	12802035	.	C	A	5	7	12	0	0	12	0	0
19	12802125	.	A	C	3	3	6	0	0	6	0	0
19	12802137	.	C	T	4	3	7	0	0	7	0	0
19	12802173	.	G	A	2	2	4	0	0	4	0	0
19	12802326	.	A	G	2	2	4	0	0	4	0	0
19	12802554	.	T	C	3	3	6	0	0	6	0	0
19	12802662	.	T	C	5	5	10	0	1	11	0	0
19	12802665	.	T	C	6	6	12	0	0	12	0	0
19	12802956	.	C	T	4	9	13	0	0	13	0	0
19	12802986	.	T	C	5	9	14	0	0	14	0	0
19	12803053	.	T	C	6	3	9	0	2	11	0	0
19	12937143	.	A	G	2	4	6	0	1	7	0	0
19	12937176	.	G	C	5	7	12	0	2	14	0	0
19	12937249	.	A	G	22	18	40	0	0	40	0	0
19	12937364	.	G	A	8	24	32	0	2	34	0	0
19	12937444	.	T	C	12	1	13	0	24	37	0	0
19	12937542	.	C	T	11	14	25	0	4	29	0	0
19	12937574	.	A	G	11	17	28	0	2	31	1	0
19	12937785	.	G	A	1	6	7	0	0	7	0	0
19	12938085	.	G	A	2	2	4	0	0	4	0	0
19	12938817	.	A	T	3	2	5	0	0	5	0	0
19	12938855	.	T	A	2	3	5	0	0	5	0	0
19	12939317	.	A	G	6	2	8	0	0	8	0	0
19	12939380	.	T	C	2	10	12	0	0	12	0	0
19	12939385	.	G	A	2	10	12	0	1	13	0	0
19	12939424	.	G	A	2	3	5	0	0	5	0	0
19	12939471	.	A	T	8	5	13	0	0	13	0	0
19	12939482	.	C	A	6	4	10	0	2	12	0	0
19	12964728	.	C	T	5	5	10	0	0	10	0	0
19	13121476	.	C	T	6	9	15	0	1	16	0	0
19	13151155	.	A	G	2	1	3	0	17	20	0	0
19	13184781	.	A	T	4	0	4	0	0	4	0	0
19	13185127	.	G	A	13	7	20	0	1	21	0	0
19	13185378	.	C	A	15	23	38	0	3	41	0	0
19	13186340	.	C	T	25	17	42	0	3	45	0	0
19	13186357	.	A	G	20	18	38	0	4	42	0	0
19	13186673	.	A	G	6	24	30	0	0	30	0	0
19	13193332	.	C	T	5	2	7	0	0	7	0	0
19	13193382	.	T	A	8	5	13	0	0	13	0	0
19	13193894	.	G	A	3	2	5	0	0	5	0	0
19	13193956	.	T	C	5	0	5	0	6	11	0	0
19	13194073	.	T	A	3	8	11	0	0	11	0	0
19	13194133	.	C	T	5	10	15	0	0	15	0	0
19	13194246	.	A	G	5	7	12	0	0	12	0	0
19	13194309	.	T	G	3	9	12	0	0	12	0	0
19	13194522	.	T	C	9	0	9	0	5	14	0	0
19	13194812	.	T	A	4	5	9	0	0	9	0	0
19	13194902	.	G	T	9	9	18	0	0	18	0	0
19	13194930	.	T	C	10	8	18	0	0	18	0	0
19	13194974	.	C	G	7	9	16	0	1	17	0	0
19	13195023	.	A	T	11	5	16	0	0	16	0	0
19	13195224	.	G	C	4	0	4	0	4	8	0	0
19	13196073	.	A	G	3	5	8	0	0	8	0	0
19	13196586	.	A	G	3	4	7	0	0	7	0	0
19	13390921	.	G	C	3	2	5	0	0	5	0	0
19	13395156	.	T	A	0	1	1	0	0	1	0	0
19	13395347	.	G	A	0	4	4	0	13	17	0	0
19	13395737	.	A	G	10	4	14	0	0	14	0	0
19	13395819	.	T	C	8	10	18	0	1	19	0	0
19	13395959	.	G	T	9	9	18	0	1	19	0	0
19	13395962	.	T	G	9	8	17	0	0	17	0	0
19	13396252	.	C	T	8	4	12	0	1	13	0	0
19	13396481	.	T	C	19	14	33	0	1	35	1	0
19	13396486	.	G	C	17	16	33	0	1	34	0	0
19	13396619	.	C	A	12	8	20	0	0	20	0	0
19	13396702	.	C	G	15	9	24	0	1	25	0	0
19	13397219	.	A	G	2	7	9	0	0	9	0	0
19	13413068	.	A	T	4	3	7	0	2	9	0	0
19	13413387	.	T	C	8	8	16	0	0	16	0	0
19	13413432	.	C	A	5	5	10	0	2	12	0	0
19	13413445	.	A	G	3	5	8	0	0	8	0	0
19	13413615	.	A	G	3	7	10	0	0	10	0	0
19	13413617	.	A	G	3	7	10	0	0	10	0	0
19	13413727	.	G	A	5	6	11	0	0	11	0	0
19	13413776	.	G	C	2	5	7	0	1	8	0	0
19	13413844	.	C	T	4	5	9	0	1	10	0	0
19	13414896	.	C	T	4	8	12	0	0	12	0	0
19	13415169	.	C	T	10	12	22	0	0	22	0	0
19	13419582	.	T	C	22	16	38	0	2	40	0	0
19	13419696	.	A	G	10	0	10	0	31	41	0	0
19	13419948	.	A	C	8	5	13	0	5	18	0	0
19	13419986	.	C	G	11	9	20	0	3	23	0	0
19	13425618	.	T	C	4	13	17	0	0	17	0	0
19	13425707	.	A	G	6	5	11	0	1	12	0	0
19	13426090	.	A	T	5	4	9	0	1	10	0	0
19	13426863	.	T	G	3	0	3	0	4	7	0	0
19	13426961	.	T	C	1	2	3	0	0	3	0	0
19	13639492	.	T	A	8	4	12	0	1	13	0	0
19	13651691	.	G	T	1	2	3	0	0	3	0	0
19	13670103	.	C	T	0	12	12	0	11	23	0	0
19	13688974	.	G	A	8	11	19	0	1	20	0	0
19	13698643	.	G	A	3	3	6	0	0	6	0	0
19	13698685	.	T	C	3	3	6	0	1	7	0	0
19	13714963	.	A	G	9	13	22	0	2	24	0	0
19	13724014	.	T	C	9	13	22	0	2	24	0	0
19	13724320	.	T	G	15	8	23	0	0	23	0	0
19	13733583	.	C	G	22	18	40	0	1	41	0	0
19	13905442	.	T	A	10	8	18	0	0	18	0	0
19	13905469	.	T	G	10	6	16	0	0	16	0	0
19	13919292	.	A	T	2	3	5	0	0	5	0	0
19	13939883	.	C	G	10	23	33	0	0	33	0	0
19	13940106	.	A	G	19	20	39	0	4	43	0	0
19	13940123	.	A	T	19	20	39	0	1	40	0	0
19	13940168	.	G	A	19	20	39	0	1	40	0	0
19	13940227	.	G	T	25	22	47	0	0	47	0	0
19	13940423	.	G	T	22	23	45	0	0	45	0	0
19	13940500	.	C	T	14	20	34	0	1	35	0	0
19	13940614	.	T	C	11	20	31	0	2	33	0	0
19	13940728	.	A	G	4	5	9	0	0	9	0	0
19	13940936	.	C	A	12	12	24	0	0	24	0	0
19	13941161	.	C	T	25	17	42	0	2	44	0	0
19	13941285	.	T	C	13	17	30	0	2	32	0	0
19	13941311	.	C	T	17	14	31	0	1	32	0	0
19	13941403	.	T	A	5	20	25	0	1	26	0	0
19	13941442	.	T	C	11	16	27	0	0	27	0	0
19	13941448	.	A	G	12	17	29	0	0	29	0	0
19	13941505	.	G	C	18	13	31	0	2	33	0	0
19	13941526	.	G	T	14	7	21	0	0	21	0	0
19	13941667	.	T	A	27	27	54	0	2	56	0	0
19	13950183	.	T	C	6	12	18	0	0	18	0	0
19	14035815	.	A	T	2	4	6	0	0	6	0	0
19	14165408	.	G	A	0	4	4	0	2	6	0	0
19	14169238	.	T	A	3	6	9	0	0	9	0	0
19	14352629	.	C	A	5	2	7	0	0	7	0	0
19	14352661	.	C	T	3	2	5	0	0	5	0	0
19	14394930	.	A	T	3	2	5	0	0	5	0	0
19	14419371	.	A	G	0	0	0	0	1	1	0	0
19	14421259	.	A	G	2	0	2	0	2	4	0	0
19	14433417	.	A	G	8	5	13	0	0	13	0	0
19	14434077	.	A	G	12	12	24	0	0	24	0	0
19	14434078	.	G	A	12	12	24	0	0	24	0	0
19	14434441	.	A	T	6	8	14	0	0	14	0	0
19	14435968	.	T	C	13	18	31	0	0	31	0	0
19	14436033	.	A	T	15	7	22	0	0	22	0	0
19	14436060	.	C	T	5	7	12	0	1	13	0	0
19	14454521	.	G	A	1	6	7	0	1	8	0	0
19	14462446	.	G	A	0	1	1	0	0	1	0	0
19	14950741	.	T	C	1	2	3	0	0	3	0	0
19	14951474	.	T	C	6	2	8	0	0	8	0	0
19	15142926	.	C	T	2	2	4	0	0	4	0	0
19	15142936	.	G	A	1	2	3	0	0	3	0	0
19	15308389	.	G	T	12	17	29	0	0	29	0	0
19	15313034	.	A	C	7	11	18	0	0	18	0	0
19	15313115	.	G	A	8	4	12	0	2	14	0	0
19	15331663	.	T	C	6	7	13	0	0	13	0	0
19	15331686	.	T	C	6	6	12	0	0	12	0	0
19	15331699	.	C	T	0	2	2	0	12	14	0	0
19	15331805	.	C	A	9	6	15	0	0	15	0	0
19	15331970	.	T	C	10	0	10	0	6	16	0	0
19	15331978	.	G	A	8	5	13	0	1	14	0	0
19	15332115	.	G	T	4	6	10	0	0	10	0	0
19	15332116	.	A	G	3	6	9	0	1	10	0	0
19	15332911	.	T	C	5	5	10	0	0	10	0	0
19	15333709	.	T	A	1	4	5	0	0	5	0	0
19	15334851	.	C	G	2	3	5	0	0	5	0	0
19	15334858	.	G	A	2	2	4	0	0	4	0	0
19	15496293	.	C	G	0	1	1	0	0	1	0	0
19	15509458	.	A	C	0	3	3	0	0	3	0	0
19	15509850	.	C	A	1	3	4	0	0	4	0	0
19	15532081	.	C	T	2	9	11	0	1	12	0	0
19	15532082	.	G	A	0	10	10	0	2	12	0	0
19	15532120	.	G	C	4	4	8	0	0	8	0	0
19	15532386	.	G	C	3	4	7	0	0	7	0	0
19	15532391	.	C	T	3	4	7	0	0	7	0	0
19	15618501	.	G	A	1	3	4	0	0	4	0	0
19	15618813	.	C	T	7	8	15	0	0	15	0	0
19	15618951	.	G	A	6	5	11	0	0	11	0	0
19	15619503	.	C	T	8	4	12	0	1	13	0	0
19	15619584	.	A	G	12	5	17	0	1	18	0	0
19	15619675	.	A	G	8	0	8	0	9	17	0	0
19	15619842	.	C	T	6	3	9	0	0	9	0	0
19	15620715	.	G	A	2	2	4	0	0	4	0	0
19	15851707	.	C	A	9	12	21	0	0	21	0	0
19	15851710	.	G	A	11	9	20	0	0	20	0	0
19	15851777	.	G	A	11	8	19	0	0	19	0	0
19	15851890	.	C	T	7	7	14	0	0	14	0	0
19	15852389	.	T	A	11	9	20	0	1	21	0	0
19	15852965	.	C	T	0	6	6	0	7	13	0	0
19	15853008	.	C	T	0	9	9	0	2	11	0	0
19	15853153	.	C	T	12	8	20	0	1	21	0	0
19	15853275	.	A	G	13	11	24	0	0	24	0	0
19	15855335	.	A	T	10	6	16	0	0	16	0	0
19	16022671	.	G	A	2	1	3	0	0	3	0	0
19	16023901	.	C	T	0	1	1	0	0	2	1	0
19	16026881	.	G	A	2	0	2	0	0	2	0	0
19	16026907	.	G	T	0	1	1	0	1	2	0	0
19	16027319	.	A	T	0	3	3	0	0	3	0	0
19	16027334	.	G	A	2	0	2	0	0	2	0	0
19	16028018	.	G	T	1	3	4	0	0	4	0	0
19	16061892	.	T	C	3	2	5	0	0	5	0	0
19	16070475	.	A	G	0	3	3	0	0	3	0	0
19	16076887	.	C	T	3	4	7	0	0	7	0	0
19	16077033	.	C	T	1	1	2	0	0	2	0	0
19	16078744	.	C	A	1	3	4	0	0	4	0	0
19	16082756	.	G	A	1	0	1	0	0	1	0	0
19	16085862	.	A	T	1	1	2	0	0	2	0	0
19	16086025	.	T	A	15	7	22	0	1	23	0	0
19	16086937	.	G	A	6	5	11	0	0	11	0	0
19	16086957	.	T	C	5	5	10	0	0	10	0	0
19	16087201	.	T	C	6	3	9	0	0	9	0	0
19	16541333	.	C	T	2	4	6	0	0	6	0	0
19	16541375	.	A	T	3	3	6	0	0	6	0	0
19	16541378	.	G	A	3	3	6	0	0	6	0	0
19	16576532	.	G	A	4	2	6	0	0	6	0	0
19	16576574	.	A	T	5	4	9	0	0	9	0	0
19	16584121	.	G	A	0	8	8	0	6	14	0	0
19	16584205	.	C	T	1	5	6	0	0	6	0	0
19	16629317	.	A	G	3	9	12	0	0	12	0	0
19	16638661	.	C	T	0	1	1	0	0	1	0	0
19	16638786	.	C	T	17	16	33	0	2	35	0	0
19	16638906	.	C	G	5	8	13	0	2	15	0	0
19	16651469	.	T	C	2	3	5	0	0	5	0	0
19	16653867	.	T	C	11	8	19	0	3	22	0	0
19	16653977	.	T	C	8	13	21	0	0	21	0	0
19	16653998	.	T	C	6	13	19	0	0	19	0	0
19	16654012	.	T	C	7	10	17	0	2	19	0	0
19	16654277	.	G	A	2	10	12	0	12	24	0	0
19	16654640	.	A	G	17	20	37	0	1	38	0	0
19	17260250	.	C	G	5	7	12	0	0	12	0	0
19	17275765	.	A	G	5	2	7	0	1	8	0	0
19	17276921	.	A	T	12	12	24	0	0	24	0	0
19	17292831	.	A	T	4	2	6	0	0	6	0	0
19	17292898	.	T	A	6	11	17	0	0	17	0	0
19	17292905	.	G	A	6	9	15	0	0	15	0	0
19	17293153	.	T	G	1	1	2	0	2	4	0	0
19	17293345	.	C	T	1	0	1	0	0	1	0	0
19	17295656	.	G	A	5	4	9	0	0	9	0	0
19	17295674	.	C	T	0	1	1	0	0	1	0	0
19	17300130	.	G	A	7	1	8	0	0	8	0	0
19	17300536	.	C	T	6	4	10	0	0	10	0	0
19	17302363	.	T	A	2	1	3	0	0	3	0	0
19	17304888	.	A	G	7	3	10	0	0	10	0	0
19	17304891	.	T	C	7	3	10	0	0	10	0	0
19	17377786	.	T	G	2	2	4	0	0	4	0	0
19	17378142	.	G	A	5	4	9	0	1	10	0	0
19	17378361	.	C	T	2	0	2	0	0	2	0	0
19	17386556	.	G	T	11	8	19	0	1	20	0	0
19	17393069	.	T	C	29	28	57	0	2	59	0	0
19	17400653	.	G	C	6	5	11	0	0	11	0	0
19	17404237	.	C	T	19	14	33	0	1	34	0	0
19	17405304	.	C	T	14	6	20	0	0	20	0	0
19	17405364	.	C	T	35	24	59	0	0	59	0	0
19	17406014	.	A	T	13	24	37	0	2	39	0	0
19	17406081	.	A	C	16	22	38	0	0	38	0	0
19	17406082	.	G	A	16	22	38	0	0	38	0	0
19	17406271	.	T	G	13	16	29	0	1	30	0	0
19	17406656	.	C	G	24	1	25	0	26	51	0	0
19	17406770	.	T	G	19	27	46	0	3	49	0	0
19	17406918	.	T	C	21	15	36	0	2	38	0	0
19	17514860	.	T	A	14	6	20	0	4	24	0	0
19	17514897	.	T	C	26	0	26	0	8	34	0	0
19	17515048	.	T	C	7	6	13	0	0	13	0	0
19	17515142	.	T	A	1	4	5	0	0	5	0	0
19	17515218	.	T	A	2	4	6	0	0	6	0	0
19	17515304	.	A	T	0	1	1	0	0	1	0	0
19	17515347	.	G	C	6	7	13	0	0	13	0	0
19	17516039	.	G	A	2	3	5	0	0	5	0	0
19	17516070	.	A	G	7	6	13	0	1	14	0	0
19	17516103	.	G	C	5	1	6	0	7	13	0	0
19	17516130	.	T	C	10	10	20	0	2	22	0	0
19	17516162	.	A	T	11	14	25	0	2	27	0	0
19	17516195	.	T	C	13	0	13	0	13	26	0	0
19	17516211	.	G	T	12	11	23	1	0	24	0	0
19	17516330	.	A	G	17	12	29	0	0	29	0	0
19	17516390	.	A	G	21	18	39	0	1	40	0	0
19	17516482	.	A	C	20	5	25	0	0	25	0	0
19	17516489	.	T	A	11	7	18	0	1	19	0	0
19	17516585	.	C	A	13	3	16	0	1	17	0	0
19	17516920	.	A	G	10	9	19	0	0	19	0	0
19	17516922	.	A	G	10	9	19	0	0	19	0	0
19	17516962	.	T	C	4	5	9	0	0	9	0	0
19	17516997	.	A	G	2	8	10	0	0	10	0	0
19	17517282	.	T	C	3	1	4	0	1	5	0	0
19	17517305	.	T	G	1	3	4	0	0	5	1	0
19	17517320	.	A	G	2	3	5	0	0	5	0	0
19	17517542	.	A	C	4	2	6	0	1	7	0	0
19	17517669	.	C	G	3	4	7	0	0	7	0	0
19	17517768	.	T	G	10	6	16	0	1	17	0	0
19	17517816	.	T	C	9	9	18	0	0	18	0	0
19	17517821	.	A	G	11	7	18	0	2	20	0	0
19	17517912	.	T	G	3	3	6	1	0	7	0	0
19	17517928	.	C	G	5	4	9	0	0	9	0	0
19	17518071	.	C	T	4	5	9	0	0	9	0	0
19	17518179	.	A	T	11	8	19	0	0	19	0	0
19	17518231	.	T	C	5	11	16	0	2	18	0	0
19	17518276	.	G	C	8	5	13	0	0	13	0	0
19	17518330	.	T	C	6	6	12	0	0	12	0	0
19	17518351	.	C	A	0	7	7	0	7	14	0	0
19	17518366	.	A	T	9	9	18	0	0	18	0	0
19	17518489	.	T	A	8	4	12	0	0	12	0	0
19	17518531	.	T	G	8	5	13	0	0	13	0	0
19	17518550	.	A	C	6	6	12	0	1	13	0	0
19	17520859	.	A	G	7	2	9	0	1	10	0	0
19	17521027	.	A	T	6	6	12	0	0	12	0	0
19	17722355	.	T	C	0	1	1	0	0	1	0	0
19	17733001	.	G	A	4	6	10	0	0	10	0	0
19	17834633	.	T	A	2	2	4	0	0	4	0	0
19	17834671	.	T	A	1	0	1	0	0	1	0	0
19	17951870	.	A	G	1	1	2	0	0	2	0	0
19	18143837	.	C	T	7	4	11	0	0	11	0	0
19	18765784	.	G	T	3	3	6	0	0	6	0	0
19	18990243	.	G	A	12	7	19	0	0	19	0	0
19	18990267	.	G	A	7	2	9	0	0	9	0	0
19	19200483	.	A	G	3	0	3	0	0	3	0	0
19	19201301	.	T	G	1	1	2	0	0	2	0	0
19	19213871	.	C	T	0	1	1	0	0	1	0	0
19	19214295	.	T	G	1	1	2	0	0	2	0	0
19	19214316	.	T	A	1	1	2	0	0	2	0	0
19	19217233	.	T	C	1	2	3	0	1	4	0	0
19	19269522	.	C	T	2	3	5	0	0	5	0	0
19	19269931	.	G	A	4	3	7	0	0	7	0	0
19	19270468	.	C	T	4	8	12	0	0	12	0	0
19	19270606	.	A	C	2	2	4	0	0	4	0	0
19	19270623	.	T	C	2	3	5	0	0	5	0	0
19	19278351	.	C	T	2	3	5	0	0	5	0	0
19	19287981	.	G	A	19	19	38	0	1	39	0	0
19	19319164	.	T	C	10	17	27	0	1	28	0	0
19	19319229	.	C	T	10	24	34	0	2	36	0	0
19	19319315	.	G	A	14	8	22	0	0	22	0	0
19	19319337	.	A	G	12	13	25	0	1	26	0	0
19	19319556	.	T	C	6	0	6	0	6	12	0	0
19	19319626	.	A	C	9	4	13	0	1	14	0	0
19	19319692	.	C	T	0	12	12	0	10	22	0	0
19	19319724	.	A	G	9	13	22	0	0	22	0	0
19	19319814	.	T	A	7	12	19	0	0	19	0	0
19	19319852	.	T	A	5	5	10	0	1	11	0	0
19	19319864	.	T	A	5	5	10	0	0	10	0	0
19	19338885	.	T	A	7	6	13	0	0	13	0	0
19	19338923	.	T	A	3	4	7	0	1	8	0	0
19	19339071	.	C	G	4	8	12	0	0	12	0	0
19	19339232	.	C	A	0	7	7	0	10	17	0	0
19	19342328	.	C	T	2	3	5	0	0	5	0	0
19	19347856	.	T	C	2	4	6	0	0	6	0	0
19	19401507	.	T	C	2	2	4	0	0	4	0	0
19	19402950	.	T	C	1	3	4	0	0	4	0	0
19	19417985	.	C	T	2	3	5	0	0	5	0	0
19	19418066	.	G	A	1	0	1	0	0	1	0	0
19	19432598	.	C	T	8	8	16	0	0	16	0	0
19	19498760	.	T	C	3	3	6	0	0	6	0	0
19	19498814	.	C	T	0	2	2	0	2	4	0	0
19	19544615	.	C	T	6	5	11	0	1	12	0	0
19	19544812	.	C	T	2	2	4	0	0	4	0	0
19	19549921	.	T	C	10	10	20	0	0	20	0	0
19	19550141	.	T	G	12	6	18	0	0	18	0	0
19	19550381	.	T	G	10	14	24	0	1	25	0	0
19	19550601	.	C	A	18	15	33	0	0	33	0	0
19	19551819	.	G	A	4	7	11	0	1	12	0	0
19	19551828	.	A	G	5	10	15	0	0	15	0	0
19	19561923	.	C	T	0	4	4	0	6	10	0	0
19	19562669	.	A	G	1	0	1	0	2	3	0	0
19	19573913	.	C	T	0	1	1	0	0	1	0	0
19	19579200	.	C	T	4	7	11	0	1	12	0	0
19	19580971	.	C	T	0	11	11	0	7	18	0	0
19	19592010	.	C	T	0	10	10	0	7	17	0	0
19	19596944	.	G	A	0	1	1	0	0	1	0	0
19	19767902	.	T	C	1	2	3	0	0	3	0	0
19	19769016	.	C	A	2	7	9	0	0	9	0	0
19	19979049	.	C	T	4	5	9	0	0	9	0	0
19	20112056	.	G	C	28	24	52	0	3	55	0	0
19	20113526	.	G	A	8	7	15	0	0	15	0	0
19	20164058	.	G	A	0	5	5	0	5	10	0	0
19	20173714	.	G	A	0	2	2	0	6	8	0	0
19	20176418	.	G	A	0	9	9	0	4	13	0	0
19	20179257	.	G	A	13	10	23	0	0	23	0	0
19	20179291	.	G	A	10	8	18	0	1	19	0	0
19	20185030	.	C	T	16	9	25	0	1	26	0	0
19	20243263	.	G	T	1	3	4	0	0	4	0	0
19	20244114	.	C	T	0	2	2	0	1	3	0	0
19	20244346	.	T	A	3	3	6	0	0	6	0	0
19	20292344	.	C	T	1	2	3	0	0	3	0	0
19	20292924	.	C	A	1	3	4	0	0	4	0	0
19	20293189	.	A	G	0	2	2	0	0	2	0	0
19	20293373	.	G	T	5	3	8	0	0	8	0	0
19	20293390	.	C	T	3	3	6	0	0	6	0	0
19	20293548	.	C	G	2	2	4	0	0	4	0	0
19	20301572	.	C	T	1	4	5	0	0	5	0	0
19	20301573	.	C	T	0	4	4	0	1	5	0	0
19	20301691	.	A	C	1	0	1	0	7	8	0	0
19	20305514	.	A	G	1	0	1	0	0	1	0	0
19	20404494	.	C	A	10	3	13	0	0	13	0	0
19	20415143	.	T	A	3	14	17	0	1	18	0	0
19	20415146	.	T	C	12	0	12	0	5	17	0	0
19	20415242	.	G	A	4	5	9	0	0	9	0	0
19	20423507	.	A	G	0	1	1	0	0	1	0	0
19	20453881	.	A	G	2	4	6	0	0	6	0	0
19	20453933	.	C	T	0	2	2	0	4	6	0	0
19	20454087	.	G	A	6	3	9	0	0	9	0	0
19	20454123	.	A	G	1	6	7	0	0	7	0	0
19	20454276	.	G	A	5	6	11	0	0	11	0	0
19	20454324	.	G	A	5	3	8	0	1	9	0	0
19	20454393	.	G	A	1	7	8	0	0	8	0	0
19	20482254	.	T	A	1	2	3	0	0	3	0	0
19	20720782	.	T	C	16	29	45	0	1	46	0	0
19	20721025	.	C	T	25	27	52	0	0	52	0	0
19	20721135	.	G	A	27	25	52	1	5	58	0	0
19	20721215	.	C	T	31	25	56	0	6	62	0	0
19	20721761	.	A	C	2	21	23	0	4	27	0	0
19	20722093	.	C	A	20	21	41	0	0	41	0	0
19	20722144	.	C	T	19	12	31	0	2	33	0	0
19	20722330	.	C	G	3	9	12	0	0	12	0	0
19	20724504	.	A	G	2	0	2	0	2	4	0	0
19	20742041	.	T	C	0	2	2	0	0	2	0	0
19	20753194	.	G	T	5	2	7	0	0	7	0	0
19	20761382	.	C	T	0	4	4	0	4	8	0	0
19	20761710	.	T	G	2	3	5	0	0	5	0	0
19	20762228	.	T	C	11	5	16	0	0	16	0	0
19	20762239	.	G	A	3	9	12	0	1	13	0	0
19	20771290	.	G	A	2	4	6	0	0	6	0	0
19	20785859	.	T	A	1	3	4	0	0	4	0	0
19	20789481	.	G	A	0	3	3	0	5	8	0	0
19	20790572	.	T	C	6	9	15	0	0	15	0	0
19	20790809	.	C	T	10	10	20	0	0	20	0	0
19	20791295	.	T	C	9	9	18	0	1	19	0	0
19	20791525	.	T	G	9	5	14	0	2	16	0	0
19	20792049	.	T	A	3	2	5	0	0	5	0	0
19	20792054	.	C	T	4	2	6	0	0	6	0	0
19	20796566	.	C	T	4	4	8	0	0	8	0	0
19	20796605	.	C	T	8	9	17	0	2	19	0	0
19	20815229	.	T	A	1	2	3	0	0	3	0	0
19	20815256	.	G	A	2	2	4	0	0	4	0	0
19	20823024	.	C	T	4	2	6	0	0	6	0	0
19	20823070	.	A	G	3	2	5	0	0	5	0	0
19	21367862	.	C	T	0	3	3	0	0	3	0	0
19	21408969	.	C	T	5	2	7	0	0	7	0	0
19	21410404	.	G	A	11	5	16	0	1	17	0	0
19	21411022	.	C	T	9	13	22	0	0	22	0	0
19	21412041	.	C	T	13	17	30	0	3	33	0	0
19	21412293	.	A	G	6	5	11	0	0	11	0	0
19	21412755	.	T	C	9	12	21	0	2	23	0	0
19	21413152	.	G	A	0	15	15	0	16	31	0	0
19	21698413	.	G	A	6	11	17	0	1	18	0	0
19	21711187	.	G	C	5	0	5	0	5	10	0	0
19	21711267	.	G	C	5	3	8	0	0	8	0	0
19	21711681	.	A	G	2	4	6	0	0	6	0	0
19	21712031	.	A	T	2	2	4	0	0	4	0	0
19	21712032	.	C	G	2	2	4	0	0	4	0	0
19	21712285	.	T	A	1	4	5	0	0	5	0	0
19	21715094	.	A	T	1	2	3	0	0	3	0	0
19	21716775	.	C	A	0	1	1	0	0	1	0	0
19	21814362	.	A	C	38	41	79	0	3	82	0	0
19	21814372	.	T	A	42	38	80	0	2	83	1	0
19	21814408	.	T	C	39	21	60	0	1	61	0	0
19	21814457	.	C	T	36	68	104	0	9	113	0	0
19	21814515	.	C	T	61	42	103	0	6	109	0	0
19	21814644	.	T	G	38	27	65	0	9	74	0	0
19	21814852	.	T	C	32	48	80	1	2	83	0	0
19	21815151	.	C	T	13	37	50	0	32	82	0	0
19	21832562	.	A	G	6	4	10	0	0	10	0	0
19	22070526	.	C	A	4	3	7	0	0	7	0	0
19	22070606	.	T	C	1	3	4	0	0	4	0	0
19	22071792	.	T	C	2	7	9	0	0	9	0	0
19	22072839	.	T	G	3	3	6	0	0	6	0	0
19	22072880	.	G	A	4	2	6	0	1	7	0	0
19	22073191	.	A	T	5	4	9	0	0	9	0	0
19	22152330	.	G	A	2	0	2	0	0	2	0	0
19	22156048	.	G	A	0	1	1	0	0	1	0	0
19	22158833	.	T	A	1	0	1	0	0	1	0	0
19	22177104	.	G	A	0	8	8	0	5	13	0	0
19	22177122	.	G	A	0	10	10	0	5	15	0	0
19	22177164	.	T	C	8	8	16	0	0	16	0	0
19	22281444	.	C	G	1	0	1	0	2	3	0	0
19	22303980	.	C	A	2	2	4	0	0	4	0	0
19	22333705	.	C	T	0	2	2	0	2	4	0	0
19	22336023	.	T	G	0	1	1	0	0	1	0	0
19	22346497	.	T	A	1	4	5	0	0	5	0	0
19	22361962	.	A	C	9	5	14	0	1	15	0	0
19	22362260	.	A	C	4	6	10	0	0	10	0	0
19	22408563	.	C	G	4	2	6	0	0	6	0	0
19	22408746	.	T	C	2	6	8	0	0	8	0	0
19	22408905	.	G	A	8	3	11	0	0	11	0	0
19	22409431	.	G	T	13	5	18	0	1	19	0	0
19	22409533	.	G	A	8	5	13	0	0	13	0	0
19	22409994	.	G	C	3	5	8	0	1	9	0	0
19	22410447	.	C	T	8	3	11	0	0	11	0	0
19	22410578	.	C	G	0	8	8	0	7	15	0	0
19	22410665	.	G	A	6	7	13	0	0	13	0	0
19	22410707	.	C	T	0	5	5	0	7	12	0	0
19	22410923	.	T	A	7	10	17	0	0	17	0	0
19	22411136	.	G	A	6	9	15	0	0	15	0	0
19	22411187	.	A	G	6	6	12	0	0	12	0	0
19	22411664	.	A	G	1	5	6	0	0	6	0	0
19	22411991	.	T	G	3	3	6	0	0	6	0	0
19	22412240	.	G	A	2	5	7	0	1	8	0	0
19	22412822	.	C	T	1	5	6	0	0	6	0	0
19	22412827	.	G	A	1	5	6	0	0	6	0	0
19	22413296	.	C	T	5	5	10	0	0	10	0	0
19	22413508	.	T	C	3	2	5	0	1	6	0	0
19	22413713	.	A	G	3	7	10	0	0	10	0	0
19	22413733	.	A	G	8	3	11	0	0	11	0	0
19	22414304	.	A	G	2	3	5	0	0	5	0	0
19	22415905	.	T	A	1	2	3	0	0	3	0	0
19	22416257	.	G	A	2	2	4	0	1	5	0	0
19	22416317	.	G	A	3	2	5	0	0	5	0	0
19	22623421	.	G	A	1	2	3	0	1	4	0	0
19	22623596	.	G	A	3	2	5	0	0	5	0	0
19	22623724	.	G	T	3	3	6	0	0	6	0	0
19	22624236	.	A	T	1	3	4	0	0	4	0	0
19	22624237	.	C	T	1	3	4	0	0	4	0	0
19	22624554	.	G	A	15	3	18	0	0	18	0	0
19	22624557	.	G	A	14	3	17	0	0	17	0	0
19	22638187	.	T	C	1	6	7	0	0	7	0	0
19	22638250	.	C	A	3	6	9	0	1	10	0	0
19	22655190	.	A	G	5	7	12	0	0	12	0	0
19	22655690	.	T	C	7	3	10	0	0	10	0	0
19	22728869	.	C	A	1	3	4	0	0	4	0	0
19	22731075	.	C	T	3	4	7	0	0	7	0	0
19	22731086	.	A	G	2	2	4	0	0	4	0	0
19	22759523	.	C	A	0	8	8	0	5	13	0	0
19	22764168	.	T	G	3	4	7	0	1	8	0	0
19	22764259	.	A	G	1	1	2	0	0	2	0	0
19	22764274	.	G	A	1	0	1	0	0	1	0	0
19	22788813	.	C	T	0	1	1	0	0	1	0	0
19	22807233	.	A	T	4	0	4	0	0	4	0	0
19	22826116	.	C	A	1	1	2	0	0	2	0	0
19	23897803	.	T	A	3	2	5	0	0	5	0	0
19	23920598	.	G	T	0	8	8	0	6	14	0	0
19	23920826	.	T	G	3	3	6	0	0	6	0	0
19	23921127	.	T	C	9	7	16	0	1	17	0	0
19	23921147	.	C	G	7	0	7	0	9	16	0	0
19	23921282	.	T	A	7	17	24	0	0	24	0	0
19	23921381	.	G	A	10	13	23	0	0	23	0	0
19	23921617	.	A	G	16	12	28	0	3	31	0	0
19	23921662	.	A	G	15	1	16	0	15	31	0	0
19	23921669	.	G	A	0	14	14	0	21	35	0	0
19	23921858	.	A	G	4	6	10	0	0	10	0	0
19	23921898	.	T	C	1	2	3	0	0	3	0	0
19	23921981	.	A	T	3	1	4	0	0	4	0	0
19	23921996	.	T	A	4	3	7	0	0	7	0	0
19	23922030	.	T	C	3	2	5	0	0	5	0	0
19	23922103	.	G	T	3	6	9	0	0	9	0	0
19	23922237	.	T	G	16	0	16	0	17	33	0	0
19	23922260	.	A	T	12	16	28	0	1	29	0	0
19	23982575	.	T	G	12	12	24	0	2	26	0	0
19	24007465	.	G	A	14	12	26	0	0	26	0	0
19	24007471	.	C	T	11	13	24	0	1	25	0	0
19	24031592	.	C	T	15	15	30	0	2	32	0	0
19	24031761	.	T	A	22	28	50	0	1	51	0	0
19	24032122	.	T	A	14	29	43	0	0	43	0	0
19	24032386	.	G	A	1	10	11	0	9	20	0	0
19	24032407	.	C	A	8	8	16	0	1	17	0	0
19	24032502	.	T	G	13	10	23	0	1	24	0	0
19	24032528	.	C	T	11	14	25	0	0	25	0	0
19	24032766	.	A	T	24	23	47	0	3	51	1	0
19	24032867	.	T	A	25	23	48	0	0	48	0	0
19	24032907	.	T	C	15	29	44	0	2	46	0	0
19	24033226	.	A	C	19	28	47	0	9	56	0	0
19	24033288	.	A	G	32	19	51	0	0	51	0	0
19	24033494	.	G	A	3	30	33	0	35	68	0	0
19	24033686	.	C	T	34	27	61	0	2	63	0	0
19	24033804	.	C	T	34	26	60	0	0	60	0	0
19	24033856	.	A	C	29	28	57	0	4	61	0	0
19	24034115	.	C	T	30	22	52	0	2	54	0	0
19	24034148	.	T	C	31	15	46	0	8	54	0	0
19	24034169	.	T	C	20	29	49	0	5	54	0	0
19	24034276	.	T	G	27	31	58	0	6	64	0	0
19	24034410	.	G	A	26	29	55	0	2	57	0	0
19	24034437	.	G	A	0	39	39	0	26	65	0	0
19	24034525	.	C	T	34	34	68	0	0	68	0	0
19	24034573	.	T	A	32	29	61	0	2	63	0	0
19	24065240	.	G	T	0	2	2	0	2	4	0	0
19	24065367	.	T	G	1	2	3	0	1	4	0	0
19	24070243	.	G	A	0	1	1	0	0	1	0	0
19	24072602	.	C	T	3	4	7	0	0	7	0	0
19	24072644	.	T	G	2	0	2	0	2	4	0	0
19	24074564	.	G	A	0	5	5	0	0	5	0	0
19	24074617	.	G	A	0	7	7	0	2	9	0	0
19	24074632	.	C	A	2	11	13	0	0	13	0	0
19	24074679	.	C	T	2	9	11	0	2	13	0	0
19	24074716	.	A	G	3	0	3	0	9	12	0	0
19	24074773	.	C	A	6	4	10	0	2	12	0	0
19	24074794	.	A	G	3	8	11	0	2	13	0	0
19	24074812	.	G	A	3	6	9	0	0	10	1	0
19	24123657	.	T	A	2	3	5	0	0	5	0	0
19	24123690	.	A	C	3	7	10	0	0	10	0	0
19	24123693	.	T	A	3	7	10	0	0	10	0	0
19	24123917	.	G	C	5	5	10	0	0	10	0	0
19	24123919	.	A	T	4	5	9	0	1	10	0	0
19	24124448	.	C	T	4	2	6	0	0	6	0	0
19	24124577	.	C	A	1	2	3	0	1	4	0	0
19	24127762	.	C	A	0	2	2	0	0	2	0	0
19	24128178	.	A	G	2	3	5	0	0	5	0	0
19	24128743	.	A	T	2	4	6	0	0	6	0	0
19	24129199	.	A	T	5	4	9	0	0	9	0	0
19	24129244	.	C	T	4	4	8	0	0	8	0	0
19	24129347	.	T	C	0	0	0	0	3	3	0	0
19	24129398	.	G	A	0	4	4	0	0	4	0	0
19	24129464	.	A	T	2	6	8	0	1	9	0	0
19	24129494	.	A	T	2	5	7	0	0	7	0	0
19	24129728	.	C	A	3	6	9	0	0	9	0	0
19	24130179	.	G	T	4	8	12	0	0	12	0	0
19	24130541	.	T	G	3	5	8	0	0	8	0	0
19	24130685	.	C	G	7	8	15	0	1	16	0	0
19	24131162	.	C	G	2	3	5	0	1	6	0	0
19	24133938	.	G	T	1	0	1	0	0	1	0	0
19	24263893	.	G	T	3	6	9	0	0	9	0	0
19	24264105	.	G	A	6	4	10	0	1	11	0	0
19	24264106	.	C	G	0	5	5	0	6	11	0	0
19	24382124	.	G	A	1	2	3	0	1	5	1	0
19	24385036	.	T	C	0	2	2	0	0	2	0	0
19	24385063	.	A	C	2	0	2	0	0	2	0	0
19	24388639	.	T	C	4	3	7	0	0	7	0	0
19	24389170	.	G	A	0	5	5	0	7	12	0	0
19	24389280	.	G	A	4	1	5	0	1	6	0	0
19	24389282	.	A	G	4	2	6	0	0	6	0	0
19	24389357	.	G	A	3	3	6	0	0	6	0	0
19	24389679	.	T	C	1	1	2	0	0	2	0	0
19	24390282	.	T	C	1	2	3	0	0	3	0	0
19	24390433	.	T	A	1	1	2	0	0	2	0	0
19	24390446	.	C	T	0	2	2	0	0	2	0	0
19	24391280	.	T	G	3	2	5	0	0	5	0	0
19	24391289	.	G	A	3	2	5	0	0	5	0	0
19	24391373	.	T	C	4	4	8	0	0	8	0	0
19	24391726	.	G	A	4	5	9	0	0	9	0	0
19	24394573	.	A	G	1	4	5	0	0	5	0	0
19	24448940	.	T	C	6	3	9	0	0	9	0	0
19	24448985	.	T	C	4	0	4	0	4	8	0	0
19	24488632	.	T	A	1	2	3	0	2	5	0	0
19	24489371	.	G	T	0	0	0	0	1	1	0	0
19	24491086	.	A	T	7	2	9	0	1	10	0	0
19	24491140	.	G	T	3	6	9	0	0	9	0	0
19	24491224	.	C	T	7	4	11	0	0	11	0	0
19	24491230	.	A	T	7	3	10	0	0	10	0	0
19	24491268	.	C	T	2	8	10	0	0	10	0	0
19	24491588	.	T	A	6	3	9	0	1	10	0	0
19	24491793	.	C	T	3	4	7	0	1	8	0	0
19	24491982	.	G	C	11	11	22	0	1	23	0	0
19	24596426	.	C	T	4	2	6	0	0	6	0	0
19	24596725	.	A	G	3	2	5	0	1	6	0	0
19	24596788	.	A	G	2	2	4	0	1	5	0	0
19	24596890	.	G	T	5	3	8	0	0	8	0	0
19	24596989	.	G	C	1	2	3	0	1	4	0	0
19	24597055	.	C	A	4	3	7	0	1	8	0	0
19	24597082	.	T	G	3	0	3	0	7	10	0	0
19	24597091	.	C	T	4	6	10	0	0	10	0	0
19	24597217	.	T	A	5	2	7	0	0	7	0	0
19	24882961	.	G	A	5	5	10	0	0	10	0	0
19	24883750	.	G	A	0	1	1	0	0	1	0	0
19	24888024	.	A	G	12	13	25	0	0	25	0	0
19	24888090	.	A	T	15	13	28	0	2	30	0	0
19	24888187	.	C	T	17	17	34	0	0	34	0	0
19	24888195	.	A	T	15	14	29	0	0	29	0	0
19	24888398	.	G	A	0	13	13	0	28	41	0	0
19	24888748	.	T	C	23	22	45	0	2	47	0	0
19	24902408	.	T	C	0	1	1	0	0	1	0	0
19	24906427	.	G	A	0	2	2	0	5	7	0	0
19	24909651	.	T	C	1	1	2	0	0	2	0	0
19	24914462	.	C	T	3	6	9	0	0	9	0	0
19	24914632	.	T	C	4	3	7	0	1	8	0	0
19	24914687	.	G	T	1	2	3	0	0	3	0	0
19	24915208	.	A	T	1	3	4	0	0	4	0	0
19	24915403	.	G	A	0	4	4	0	3	7	0	0
19	24915680	.	A	G	6	4	10	0	0	10	0	0
19	24915688	.	C	T	7	4	11	0	0	11	0	0
19	24915742	.	T	A	5	5	10	0	0	10	0	0
19	24915782	.	G	A	0	4	4	0	5	9	0	0
19	24915796	.	A	G	4	6	10	0	0	10	0	0
19	24916007	.	T	G	4	10	14	0	0	14	0	0
19	24916427	.	C	T	7	4	11	0	0	11	0	0
19	24916445	.	A	T	7	3	10	0	2	12	0	0
19	24916766	.	T	G	5	6	11	0	0	11	0	0
19	25089839	.	A	G	10	10	20	0	2	22	0	0
19	25089979	.	A	G	5	11	16	0	1	17	0	0
19	25090032	.	T	G	9	10	19	0	0	19	0	0
19	25090079	.	A	G	7	12	19	0	0	19	0	0
19	25090231	.	T	C	3	4	7	0	0	7	0	0
19	25113207	.	C	A	9	16	25	0	0	26	1	0
19	25113524	.	T	C	5	9	14	0	0	14	0	0
19	25156572	.	C	T	7	8	15	0	1	16	0	0
19	25156639	.	T	C	6	0	6	0	8	14	0	0
19	25156669	.	T	C	5	8	13	0	2	15	0	0
19	25156717	.	A	C	5	11	16	0	0	16	0	0
19	25156774	.	T	A	10	11	21	0	0	21	0	0
19	25156959	.	A	T	11	17	28	0	0	28	0	0
19	25163587	.	G	A	12	11	23	0	2	25	0	0
19	25163633	.	G	T	7	9	16	0	2	18	0	0
19	25169531	.	A	C	2	0	2	0	0	2	0	0
19	25270949	.	A	G	9	2	11	0	0	11	0	0
19	25352327	.	T	C	8	8	16	0	0	16	0	0
19	25352503	.	G	A	10	6	16	0	2	18	0	0
19	25352702	.	A	C	4	6	10	1	1	12	0	0
19	25352789	.	T	C	6	9	15	0	0	15	0	0
19	25352901	.	A	T	14	5	19	0	3	22	0	0
19	25353088	.	A	G	10	17	27	0	0	27	0	0
19	25367246	.	G	A	0	3	3	0	0	3	0	0
19	25367270	.	T	C	2	1	3	0	8	11	0	0
19	25367291	.	C	T	2	9	11	0	6	17	0	0
19	25370392	.	G	A	3	5	8	0	1	9	0	0
19	25370730	.	C	T	3	2	5	0	0	5	0	0
19	25435501	.	T	G	0	0	0	0	1	1	0	0
19	25466549	.	A	T	0	2	2	0	0	2	0	0
19	25512025	.	A	G	1	2	3	0	0	3	0	0
19	25526483	.	G	A	0	7	7	0	2	9	0	0
19	25526529	.	T	C	7	12	19	0	0	19	0	0
19	25548114	.	C	G	11	9	20	0	1	21	0	0
19	25652962	.	C	T	9	17	26	0	3	29	0	0
19	25653042	.	C	T	13	22	35	0	5	40	0	0
19	25653147	.	C	T	5	18	23	0	3	26	0	0
19	25653170	.	G	T	7	15	22	0	7	29	0	0
19	25657306	.	C	A	1	8	9	0	0	9	0	0
19	25680169	.	A	T	9	3	12	0	0	12	0	0
19	25680170	.	C	T	9	3	12	0	0	12	0	0
19	25680248	.	A	T	6	7	13	0	0	13	0	0
19	25682029	.	G	A	1	2	3	0	0	3	0	0
19	25693539	.	T	C	1	5	6	0	0	6	0	0
19	25699903	.	G	A	3	2	5	0	0	5	0	0
19	25699929	.	G	A	2	3	5	0	0	5	0	0
19	25699959	.	C	A	3	2	5	0	0	5	0	0
19	25701161	.	G	A	1	2	3	0	0	3	0	0
19	25701183	.	G	A	2	2	4	0	0	4	0	0
19	25701237	.	A	G	4	5	9	0	0	9	0	0
19	25701450	.	G	A	0	3	3	0	0	3	0	0
19	25701474	.	T	A	0	3	3	0	1	4	0	0
19	25701495	.	A	T	1	1	2	0	1	3	0	0
19	26164906	.	G	A	7	7	14	0	0	14	0	0
19	26235083	.	G	A	5	8	13	0	0	13	0	0
19	26235089	.	C	T	5	8	13	0	1	14	0	0
19	26369614	.	C	T	0	1	1	0	0	1	0	0
19	26370720	.	A	T	2	4	6	0	0	6	0	0
19	26370726	.	C	T	4	3	7	0	0	7	0	0
19	26375471	.	C	T	2	0	2	0	0	2	0	0
19	26375643	.	T	G	4	11	15	0	0	15	0	0
19	26375699	.	G	T	4	11	15	0	0	15	0	0
19	26377775	.	A	T	1	5	6	0	0	6	0	0
19	26377946	.	T	A	4	8	12	0	0	12	0	0
19	26378250	.	T	C	1	5	6	0	0	6	0	0
19	26378265	.	G	A	5	2	7	0	0	7	0	0
19	26378285	.	G	A	3	6	9	0	0	9	0	0
19	26378447	.	T	A	6	6	12	0	0	12	0	0
19	26378451	.	G	A	6	4	10	0	2	12	0	0
19	26622680	.	C	T	1	0	1	0	0	1	0	0
19	26623634	.	C	T	1	1	2	0	0	2	0	0
19	26628037	.	A	G	1	2	3	0	0	3	0	0
19	26628173	.	T	A	1	4	5	0	0	5	0	0
19	26628225	.	G	A	5	7	12	0	0	12	0	0
19	26628244	.	C	T	3	6	9	0	0	9	0	0
19	26628279	.	C	T	5	3	8	0	0	8	0	0
19	26628287	.	G	A	4	1	5	0	0	5	0	0
19	26628825	.	G	A	0	2	2	0	1	3	0	0
19	26628980	.	C	A	3	3	6	0	1	7	0	0
19	26657193	.	T	C	0	1	1	0	0	1	0	0
19	26669225	.	G	A	5	4	9	0	0	9	0	0
19	26669228	.	T	C	5	4	9	0	0	9	0	0
19	26670618	.	A	G	1	0	1	0	2	3	0	0
19	26688868	.	G	A	0	1	1	0	1	2	0	0
19	26707167	.	A	G	1	0	1	0	0	1	0	0
19	26707185	.	C	T	1	0	1	0	0	1	0	0
19	26710828	.	C	T	1	1	2	0	0	2	0	0
19	26711151	.	A	T	3	3	6	0	0	6	0	0
19	26711447	.	G	A	1	4	5	0	1	6	0	0
19	26715006	.	A	G	2	0	2	0	6	8	0	0
19	26717511	.	G	T	2	3	5	0	0	5	0	0
19	26717549	.	T	C	2	3	5	0	0	5	0	0
19	26721300	.	C	T	2	1	3	0	0	3	0	0
19	26723474	.	G	C	2	3	5	0	0	5	0	0
19	26723498	.	A	G	3	4	7	0	0	7	0	0
19	26723690	.	G	A	1	4	5	0	0	5	0	0
19	26723705	.	A	T	1	6	7	0	0	7	0	0
19	26727535	.	G	A	0	1	1	0	7	8	0	0
19	26729597	.	A	T	7	8	15	0	2	17	0	0
19	26729651	.	T	C	7	9	16	0	0	16	0	0
19	26729811	.	A	C	3	7	10	0	0	10	0	0
19	26729867	.	C	T	8	4	12	0	0	12	0	0
19	26729887	.	T	A	5	5	10	0	1	11	0	0
19	26730073	.	A	T	4	4	8	0	1	9	0	0
19	26730077	.	G	T	3	6	9	0	1	10	0	0
19	26730108	.	A	G	6	0	6	0	6	12	0	0
19	26730545	.	C	T	13	21	34	0	0	34	0	0
19	26730642	.	T	C	22	0	22	0	28	50	0	0
19	26731183	.	C	T	2	18	20	0	6	26	0	0
19	26741296	.	C	G	19	31	50	0	1	51	0	0
19	26741378	.	T	C	19	1	20	0	20	40	0	0
19	26741427	.	G	A	23	14	37	0	3	40	0	0
19	26741831	.	C	T	1	18	19	0	21	40	0	0
19	26741918	.	G	T	8	20	28	0	1	29	0	0
19	26742224	.	T	C	14	18	32	0	1	33	0	0
19	26742321	.	G	A	12	17	29	0	0	29	0	0
19	26742379	.	A	C	6	1	7	0	17	24	0	0
19	26742598	.	A	T	15	24	39	0	0	39	0	0
19	26742716	.	T	A	23	17	40	0	1	41	0	0
19	26742732	.	A	G	26	18	44	0	1	45	0	0
19	26742751	.	C	T	21	27	48	0	3	51	0	0
19	26743295	.	A	T	12	17	29	0	0	29	0	0
19	26743446	.	T	A	22	22	44	0	0	44	0	0
19	26743781	.	G	A	20	14	34	0	1	35	0	0
19	26743808	.	C	T	13	18	31	0	1	32	0	0
19	26743900	.	T	A	16	8	24	0	0	24	0	0
19	26743943	.	C	T	18	11	29	0	0	29	0	0
19	26743984	.	A	G	17	14	31	0	0	31	0	0
19	26744235	.	G	T	7	15	22	0	2	24	0	0
19	26744840	.	C	T	14	15	29	0	0	29	0	0
19	26745392	.	T	A	12	10	22	0	2	24	0	0
19	26746246	.	C	T	0	1	1	0	0	1	0	0
19	26747192	.	C	T	12	7	19	0	1	20	0	0
19	26747682	.	G	A	9	11	20	0	2	22	0	0
19	26747979	.	C	T	5	7	12	0	0	12	0	0
19	26748003	.	T	G	3	2	5	0	0	5	0	0
19	26748499	.	G	C	3	0	3	0	5	8	0	0
19	26750310	.	T	C	2	0	2	0	2	4	0	0
19	26756636	.	G	A	5	4	9	0	0	9	0	0
19	26810460	.	C	T	9	7	16	0	1	17	0	0
19	26813901	.	G	A	6	6	12	0	0	12	0	0
19	26822657	.	G	A	1	2	3	0	0	3	0	0
19	26838704	.	T	C	0	1	1	0	0	1	0	0
19	26860799	.	T	C	8	0	8	0	5	13	0	0
19	26868876	.	C	T	10	12	22	0	0	22	0	0
19	26868899	.	G	A	17	8	25	0	1	26	0	0
19	26868972	.	G	T	3	2	5	1	0	6	0	0
19	26872742	.	C	A	1	2	3	0	1	4	0	0
19	26872886	.	T	C	4	0	4	0	8	12	0	0
19	26872898	.	C	T	4	9	13	0	1	14	0	0
19	26873020	.	C	T	13	4	17	0	4	21	0	0
19	26910877	.	T	C	6	0	6	0	3	9	0	0
19	26925280	.	G	A	0	1	1	0	0	1	0	0
19	26925296	.	T	C	0	1	1	0	0	1	0	0
19	26925526	.	G	A	4	10	14	0	1	15	0	0
19	26928320	.	C	T	13	10	23	0	2	25	0	0
19	26928356	.	A	G	16	7	23	0	2	26	1	0
19	26928399	.	A	C	9	3	12	0	0	12	0	0
19	26931520	.	G	A	7	9	16	0	1	17	0	0
19	26931680	.	T	A	7	9	16	0	0	16	0	0
19	26931730	.	T	A	4	9	13	0	1	14	0	0
19	26931732	.	A	T	10	4	14	0	0	14	0	0
19	26931765	.	G	A	0	12	12	0	2	14	0	0
19	26938030	.	G	A	2	2	4	0	0	4	0	0
19	26958040	.	G	A	6	5	11	0	0	11	0	0
19	26958349	.	G	A	5	5	10	0	0	10	0	0
19	26958604	.	G	A	3	2	5	0	0	5	0	0
19	26958687	.	T	G	5	5	10	0	0	10	0	0
19	26967634	.	G	T	11	9	20	0	0	21	1	0
19	26967737	.	A	C	2	5	7	0	0	7	0	0
19	26967780	.	C	T	1	7	8	0	2	10	0	0
19	26994683	.	C	A	0	2	2	0	0	2	0	0
19	27043887	.	A	G	9	16	25	0	0	25	0	0
19	27073262	.	A	G	1	2	3	0	0	3	0	0
19	27105078	.	G	A	4	7	11	0	0	11	0	0
19	27260906	.	T	C	1	0	1	0	4	5	0	0
19	27283342	.	C	G	8	7	15	0	0	15	0	0
19	27283472	.	A	T	7	4	11	0	1	12	0	0
19	27283557	.	C	A	9	5	14	0	1	15	0	0
19	27283612	.	A	G	7	3	10	0	1	11	0	0
19	27283715	.	G	A	2	3	5	0	0	5	0	0
19	27283717	.	G	T	2	3	5	0	0	5	0	0
19	27283783	.	G	C	3	7	10	0	0	10	0	0
19	27283940	.	C	T	6	11	17	0	2	19	0	0
19	27284178	.	G	A	8	5	13	0	0	13	0	0
19	27284195	.	T	G	8	5	13	0	0	13	0	0
19	27284387	.	A	G	7	6	13	0	0	13	0	0
19	27284741	.	C	T	7	6	13	0	0	13	0	0
19	27284744	.	C	T	6	6	12	0	1	13	0	0
19	27284817	.	A	C	4	10	14	0	0	14	0	0
19	27284860	.	C	T	8	6	14	0	0	14	0	0
19	27284957	.	G	A	8	11	19	0	1	20	0	0
19	27285085	.	T	C	7	0	7	0	7	14	0	0
19	27286354	.	C	T	3	3	6	0	0	6	0	0
19	27286390	.	G	T	4	3	7	0	0	7	0	0
19	27286406	.	C	T	6	2	8	0	0	8	0	0
19	27286590	.	G	C	2	0	2	0	5	7	0	0
19	27286912	.	A	T	2	0	2	0	1	3	0	0
19	27286940	.	C	T	1	1	2	0	1	3	0	0
19	27287204	.	T	C	7	6	13	0	0	13	0	0
19	27287294	.	T	G	7	6	13	0	0	13	0	0
19	27307583	.	G	A	1	2	3	0	1	4	0	0
19	27314273	.	T	C	2	2	4	0	0	4	0	0
19	27314393	.	C	G	3	3	6	0	0	6	0	0
19	27314624	.	C	T	4	3	7	0	0	7	0	0
19	27321573	.	C	G	7	7	14	0	0	14	0	0
19	27321615	.	A	G	1	2	3	0	0	3	0	0
19	27321843	.	G	A	1	2	3	0	0	3	0	0
19	27331814	.	T	C	0	0	0	0	1	1	0	0
19	27334273	.	A	T	2	2	4	0	0	4	0	0
19	27351218	.	G	A	5	4	9	0	0	9	0	0
19	27354331	.	C	A	10	8	18	0	1	19	0	0
19	27357250	.	C	A	4	12	16	0	1	17	0	0
19	27357485	.	A	T	8	21	29	0	1	30	0	0
19	27368719	.	T	C	4	4	8	0	0	8	0	0
19	27368870	.	A	G	3	4	7	0	0	7	0	0
19	27369504	.	G	A	0	4	4	0	0	4	0	0
19	27369613	.	T	C	3	0	3	0	2	5	0	0
19	27369659	.	A	T	4	3	7	0	1	8	0	0
19	27369795	.	T	C	4	3	7	0	1	8	0	0
19	27369853	.	T	A	4	4	8	0	1	9	0	0
19	27370232	.	C	A	2	2	4	0	0	4	0	0
19	27370273	.	C	T	0	2	2	0	3	5	0	0
19	27370380	.	C	T	0	3	3	0	1	4	0	0
19	27370606	.	C	A	2	2	4	0	0	4	0	0
19	27370662	.	C	T	0	2	2	0	3	5	0	0
19	27370774	.	A	T	1	2	3	0	1	4	0	0
19	27370805	.	C	T	0	3	3	0	1	4	0	0
19	27401412	.	G	A	4	2	6	0	0	6	0	0
19	27401680	.	G	A	4	4	8	0	0	8	0	0
19	27422029	.	G	A	1	2	3	0	0	3	0	0
19	27437597	.	T	G	0	2	2	0	0	2	0	0
19	27441059	.	G	A	1	2	3	0	0	3	0	0
19	27457166	.	T	C	6	0	6	0	9	15	0	0
19	27457213	.	T	C	6	8	14	0	3	17	0	0
19	27457505	.	G	T	14	8	22	0	1	23	0	0
19	27457516	.	T	G	6	14	20	0	1	21	0	0
19	27457607	.	C	T	7	5	12	0	0	12	0	0
19	27457621	.	T	A	5	8	13	0	0	13	0	0
19	27457749	.	C	T	12	6	18	0	1	19	0	0
19	27457892	.	T	C	9	11	20	0	0	20	0	0
19	27457989	.	T	A	5	5	10	0	0	10	0	0
19	27461139	.	C	T	0	7	7	0	7	14	0	0
19	27461183	.	C	T	11	6	17	0	2	19	0	0
19	27461560	.	C	T	0	6	6	0	14	20	0	0
19	27462092	.	A	T	0	2	2	0	0	2	0	0
19	27462620	.	C	A	1	5	6	0	0	6	0	0
19	27464344	.	A	T	1	1	2	0	0	2	0	0
19	27468983	.	A	C	9	6	15	0	0	15	0	0
19	27469060	.	C	G	0	8	8	0	13	21	0	0
19	27469130	.	A	G	7	1	8	0	1	9	0	0
19	27469178	.	A	C	9	4	13	0	0	13	0	0
19	27469184	.	G	A	10	4	14	0	0	14	0	0
19	27505122	.	G	A	0	2	2	0	5	7	0	0
19	27505191	.	G	A	0	7	7	0	11	18	0	0
19	27505211	.	G	A	9	6	15	0	1	16	0	0
19	27505962	.	G	T	2	6	8	0	0	8	0	0
19	27515099	.	A	G	1	2	3	0	0	3	0	0
19	27609998	.	C	T	15	9	24	0	2	26	0	0
19	27616055	.	C	T	6	10	16	0	0	16	0	0
19	27616337	.	G	A	8	6	14	0	0	14	0	0
19	27634823	.	C	T	3	6	9	0	0	9	0	0
19	28281343	.	G	A	8	3	11	0	1	12	0	0
19	28281351	.	T	G	3	5	8	0	0	8	0	0
19	28283749	.	C	T	1	15	16	0	13	29	0	0
19	28283786	.	C	T	30	25	55	0	1	56	0	0
19	28284146	.	T	A	5	5	10	0	0	10	0	0
19	28284203	.	A	T	9	8	17	0	1	18	0	0
19	28284220	.	T	A	6	4	10	0	0	10	0	0
19	28288148	.	C	T	1	3	4	0	0	5	1	0
19	28288480	.	G	A	7	13	20	0	2	22	0	0
19	28288489	.	C	T	6	14	20	0	0	20	0	0
19	28359920	.	G	A	11	8	19	0	3	22	0	0
19	28360028	.	T	G	2	1	3	0	0	3	0	0
19	28360029	.	C	T	2	1	3	0	0	3	0	0
19	28787154	.	C	T	20	16	36	0	1	37	0	0
19	28788220	.	A	G	15	20	35	0	4	39	0	0
19	28788430	.	T	A	17	17	34	0	6	40	0	0
19	28802039	.	A	G	6	3	9	0	1	10	0	0
19	28802469	.	G	A	10	3	13	0	1	14	0	0
19	28802487	.	G	T	7	4	11	0	1	12	0	0
19	28802954	.	C	A	12	21	33	0	3	36	0	0
19	28803173	.	G	A	23	23	46	0	2	48	0	0
19	28803267	.	G	A	1	10	11	0	12	23	0	0
19	28820643	.	C	T	27	13	40	0	1	41	0	0
19	28821230	.	G	A	11	12	23	0	2	25	0	0
19	28821333	.	G	A	0	19	19	0	12	31	0	0
19	28821334	.	G	T	12	19	31	0	0	31	0	0
19	28821383	.	A	C	3	4	7	0	1	8	0	0
19	28821666	.	G	C	16	19	35	0	0	36	1	0
19	28822057	.	T	C	15	5	20	0	1	21	0	0
19	28822187	.	C	T	15	15	30	0	0	30	0	0
19	28822521	.	A	G	5	7	12	0	1	13	0	0
19	28822624	.	G	A	2	6	8	0	1	9	0	0
19	28823124	.	C	T	5	6	11	0	1	12	0	0
19	28823162	.	T	C	6	4	10	0	0	10	0	0
19	28823385	.	A	T	7	5	12	0	2	14	0	0
19	29297070	.	G	T	0	2	2	0	0	2	0	0
19	29298102	.	A	T	1	5	6	0	0	6	0	0
19	29301805	.	C	T	1	4	5	0	0	5	0	0
19	29303871	.	A	C	1	1	2	0	1	3	0	0
19	29305506	.	C	T	1	0	1	0	0	1	0	0
19	29310226	.	G	A	0	1	1	0	2	3	0	0
19	29318861	.	A	C	7	5	12	0	0	12	0	0
19	29327825	.	A	G	2	0	2	0	6	8	0	0
19	29333382	.	C	T	3	5	8	0	2	10	0	0
19	29333418	.	G	T	6	4	10	0	1	11	0	0
19	29333565	.	G	A	4	8	12	0	0	12	0	0
19	29333597	.	A	C	3	4	7	0	1	8	0	0
19	29337897	.	A	T	1	3	4	0	0	4	0	0
19	29363454	.	G	T	1	3	4	0	0	4	0	0
19	29363473	.	T	A	0	4	4	0	0	5	1	0
19	29383644	.	C	T	0	11	11	0	11	22	0	0
19	29383675	.	G	C	8	9	17	0	0	17	0	0
19	29799885	.	C	T	38	39	77	0	16	93	0	0
19	29799900	.	T	C	47	29	76	0	4	80	0	0
19	29800229	.	A	G	28	37	65	0	2	67	0	0
19	29812799	.	G	T	0	1	1	0	2	3	0	0
19	29815096	.	T	C	23	29	52	0	2	54	0	0
19	29817914	.	C	G	23	7	30	0	1	31	0	0
19	29818142	.	C	T	31	26	57	0	1	58	0	0
19	29822615	.	C	T	1	10	11	0	19	30	0	0
19	29830215	.	G	A	14	21	35	0	0	35	0	0
19	29832781	.	G	A	4	12	16	1	1	18	0	0
19	29836645	.	T	C	3	0	3	0	7	10	0	0
19	29836779	.	A	G	3	6	9	0	0	9	0	0
19	29836821	.	T	G	2	4	6	0	0	6	0	0
19	29837251	.	T	C	3	2	5	0	0	5	0	0
19	29837310	.	A	G	5	3	8	0	0	8	0	0
19	29837619	.	T	A	1	2	3	0	1	4	0	0
19	29837964	.	C	T	13	9	22	0	0	22	0	0
19	29852666	.	C	T	2	1	3	0	0	3	0	0
19	29861961	.	C	A	1	7	8	0	6	14	0	0
19	29866548	.	G	T	5	2	7	0	0	7	0	0
19	29866559	.	G	A	4	5	9	0	0	9	0	0
19	29866630	.	C	T	0	7	7	0	5	12	0	0
19	29866882	.	G	A	1	8	9	0	0	9	0	0
19	29866918	.	G	A	1	4	5	0	1	6	0	0
19	29872768	.	C	T	0	2	2	0	1	3	0	0
19	29872783	.	C	T	1	2	3	0	2	5	0	0
19	29879393	.	C	T	1	2	3	0	0	3	0	0
19	30348804	.	G	A	22	18	40	0	1	41	0	0
19	30349310	.	A	T	12	13	25	0	2	28	1	0
19	30349553	.	C	G	2	10	12	0	14	26	0	0
19	30355383	.	T	C	12	15	27	0	1	28	0	0
19	30355907	.	A	T	6	1	7	0	0	7	0	0
19	30388080	.	G	T	0	6	6	0	10	16	0	0
19	30388091	.	C	T	10	6	16	0	0	16	0	0
19	30388169	.	G	T	3	2	5	0	0	5	0	0
19	30393919	.	C	A	1	0	1	0	0	1	0	0
19	30396440	.	T	G	7	1	8	0	0	8	0	0
19	30396777	.	C	T	5	3	8	0	0	8	0	0
19	30398392	.	T	C	7	15	22	0	2	24	0	0
19	30398395	.	T	C	8	15	23	0	1	24	0	0
19	30398487	.	G	A	5	6	11	0	0	11	0	0
19	30398632	.	T	C	8	4	12	0	0	12	0	0
19	30398909	.	T	C	2	7	9	0	1	10	0	0
19	30398978	.	G	A	0	3	3	0	1	4	0	0
19	30399047	.	A	T	5	3	8	0	0	8	0	0
19	30410519	.	C	A	13	10	23	0	0	23	0	0
19	30413354	.	G	A	3	7	10	0	0	10	0	0
19	30414279	.	G	A	7	10	17	0	0	17	0	0
19	30416170	.	T	C	2	0	2	0	2	4	0	0
19	30416496	.	G	T	5	3	8	0	0	8	0	0
19	30416523	.	A	T	3	2	5	0	0	5	0	0
19	30423199	.	A	T	5	1	6	0	0	6	0	0
19	30423209	.	A	G	3	1	4	0	1	5	0	0
19	30423366	.	A	G	3	1	4	0	0	4	0	0
19	30423368	.	G	A	3	0	3	0	1	4	0	0
19	30425616	.	G	T	3	4	7	0	0	7	0	0
19	30434753	.	A	G	0	0	0	0	1	1	0	0
19	30436629	.	G	A	1	3	4	0	0	4	0	0
19	30436891	.	G	A	3	5	8	0	0	8	0	0
19	30438496	.	G	A	1	2	3	0	0	3	0	0
19	30439733	.	C	T	4	5	9	0	2	11	0	0
19	30439754	.	C	T	5	6	11	0	0	11	0	0
19	30445915	.	C	A	3	2	5	0	0	5	0	0
19	30445927	.	A	G	4	3	7	0	1	8	0	0
19	30446181	.	T	A	0	0	0	0	1	1	0	0
19	30447533	.	C	T	6	3	9	0	1	10	0	0
19	30457627	.	G	A	5	6	11	0	1	12	0	0
19	30457648	.	C	T	6	7	13	0	0	13	0	0
19	30457770	.	A	T	4	7	11	0	4	15	0	0
19	30457811	.	C	A	5	5	10	0	0	10	0	0
19	30458121	.	C	T	6	10	16	0	1	17	0	0
19	30460936	.	T	A	1	0	1	0	0	1	0	0
19	30460953	.	C	T	1	0	1	0	0	1	0	0
19	30463210	.	G	C	4	2	6	0	0	6	0	0
19	30481692	.	T	C	6	0	6	0	5	11	0	0
19	30481799	.	T	A	10	8	18	0	2	20	0	0
19	30485029	.	G	A	2	0	2	0	0	2	0	0
19	30485085	.	T	C	9	9	18	0	0	18	0	0
19	30485247	.	T	G	0	3	3	0	0	3	0	0
19	30485253	.	A	G	0	4	4	0	0	4	0	0
19	30500052	.	T	G	1	3	4	0	0	4	0	0
19	30500053	.	G	A	1	3	4	0	0	4	0	0
19	30506619	.	C	T	6	3	9	0	0	9	0	0
19	30518480	.	T	A	20	21	41	0	0	41	0	0
19	30518646	.	A	C	25	30	55	0	3	58	0	0
19	30518906	.	A	G	19	18	37	0	1	38	0	0
19	30518973	.	C	T	26	22	48	0	1	49	0	0
19	30519319	.	A	G	7	10	17	0	0	17	0	0
19	30519324	.	C	T	7	12	19	0	0	19	0	0
19	30519459	.	T	A	6	6	12	0	0	12	0	0
19	30519550	.	T	A	2	3	5	0	0	5	0	0
19	30519802	.	C	T	13	20	33	0	0	33	0	0
19	30519803	.	T	G	13	20	33	0	0	33	0	0
19	30519858	.	A	G	14	22	36	0	2	38	0	0
19	30520061	.	T	G	18	19	37	0	1	38	0	0
19	30520214	.	C	T	16	26	42	0	1	43	0	0
19	30520337	.	A	G	18	14	32	0	1	33	0	0
19	30520419	.	G	A	14	21	35	0	0	35	0	0
19	30520431	.	C	G	13	17	30	0	0	30	0	0
19	30520567	.	T	A	11	9	20	0	1	21	0	0
19	30520569	.	T	A	11	9	20	0	1	21	0	0
19	30521443	.	C	A	4	3	7	0	0	7	0	0
19	30522182	.	T	C	9	10	19	0	0	19	0	0
19	30669900	.	G	A	0	1	1	0	1	2	0	0
19	30669930	.	A	G	15	6	21	0	0	21	0	0
19	30672935	.	T	C	18	14	32	0	0	32	0	0
19	30673004	.	T	A	12	3	15	0	0	15	0	0
19	30676543	.	G	A	3	2	5	0	0	5	0	0
19	30676699	.	C	T	10	12	22	0	1	23	0	0
19	30681938	.	G	A	0	16	16	0	25	41	0	0
19	30682680	.	G	A	39	27	66	0	0	66	0	0
19	30682781	.	C	A	24	27	51	0	2	53	0	0
19	30682947	.	A	G	21	23	44	0	3	47	0	0
19	30683129	.	A	C	21	32	53	0	1	54	0	0
19	30683395	.	A	T	23	19	42	0	0	42	0	0
19	30722843	.	G	A	1	2	3	0	0	3	0	0
19	30723172	.	C	T	5	7	12	0	0	12	0	0
19	30723251	.	A	T	6	3	9	0	0	9	0	0
19	30723456	.	G	A	2	3	5	0	0	5	0	0
19	30723675	.	A	T	4	5	9	0	1	10	0	0
19	30723691	.	G	A	5	5	10	0	1	11	0	0
19	30755362	.	C	A	0	3	3	0	1	4	0	0
19	30763040	.	G	T	4	1	5	0	0	5	0	0
19	30805698	.	C	G	11	4	15	0	0	15	0	0
19	30805886	.	A	C	4	6	10	0	0	10	0	0
19	30807557	.	A	G	7	12	19	0	1	20	0	0
19	30810911	.	A	T	3	4	7	0	0	7	0	0
19	30810916	.	T	G	2	3	5	0	0	5	0	0
19	30811103	.	A	G	1	6	7	0	0	7	0	0
19	30867948	.	G	A	4	3	7	0	0	7	0	0
19	30867955	.	A	T	4	3	7	0	0	7	0	0
19	30868063	.	C	G	0	1	1	0	0	1	0	0
19	30870930	.	C	T	0	1	1	0	0	1	0	0
19	30876669	.	G	A	1	0	1	0	0	1	0	0
19	30876941	.	G	A	1	0	1	0	0	1	0	0
19	30878655	.	G	T	3	1	4	0	0	4	0	0
19	30878688	.	C	T	2	1	3	0	0	3	0	0
19	30882576	.	G	T	8	9	17	0	0	17	0	0
19	30882688	.	T	C	9	5	14	0	0	14	0	0
19	30882743	.	G	A	6	6	12	0	1	13	0	0
19	30882973	.	A	T	21	14	35	0	0	35	0	0
19	30883224	.	C	T	6	5	11	0	0	11	0	0
19	30883298	.	G	A	8	11	19	0	0	19	0	0
19	30883302	.	G	A	8	9	17	0	1	18	0	0
19	30883476	.	A	T	12	6	18	0	0	18	0	0
19	30883549	.	T	C	7	7	14	0	0	14	0	0
19	30886970	.	T	C	1	2	3	0	0	3	0	0
19	30894883	.	G	A	16	11	27	0	0	27	0	0
19	30894980	.	A	G	6	7	13	0	0	13	0	0
19	30895163	.	G	A	5	9	14	0	1	15	0	0
19	30897438	.	T	C	5	1	6	0	7	13	0	0
19	30897545	.	T	A	9	4	13	0	0	13	0	0
19	30897585	.	A	C	6	4	10	0	0	10	0	0
19	30897649	.	G	C	2	2	4	0	0	4	0	0
19	30897916	.	C	A	2	4	6	0	1	7	0	0
19	30898050	.	C	T	6	4	10	0	0	10	0	0
19	30898291	.	A	T	1	2	3	0	0	3	0	0
19	30898841	.	C	A	5	3	8	0	2	10	0	0
19	30899256	.	T	C	2	2	4	0	1	5	0	0
19	30899280	.	T	G	1	1	2	0	1	3	0	0
19	30899805	.	T	A	5	3	8	0	0	8	0	0
19	30899816	.	T	C	5	0	5	0	3	8	0	0
19	30900332	.	T	C	1	2	3	0	0	3	0	0
19	30900447	.	C	T	1	2	3	0	0	3	0	0
19	30902042	.	C	T	1	2	3	0	0	3	0	0
19	30997185	.	A	G	1	0	1	0	4	5	0	0
19	30999947	.	T	C	8	0	8	0	8	16	0	0
19	31000077	.	C	T	0	8	8	0	9	17	0	0
19	31000207	.	T	C	8	12	20	0	2	22	0	0
19	31001318	.	T	G	3	4	7	0	0	7	0	0
19	31001417	.	A	G	0	4	4	0	1	5	0	0
19	31003330	.	A	T	6	5	11	0	0	11	0	0
19	31005005	.	A	C	6	6	12	0	0	12	0	0
19	31010033	.	A	C	6	9	15	0	0	15	0	0
19	31010061	.	T	A	3	2	5	0	0	5	0	0
19	31012900	.	G	A	10	12	22	0	1	23	0	0
19	31016410	.	A	T	6	13	19	0	0	19	0	0
19	31016458	.	C	A	16	10	26	0	0	26	0	0
19	31340089	.	G	A	6	8	14	0	2	16	0	0
19	31340882	.	C	G	0	4	4	0	7	11	0	0
19	31341000	.	C	T	8	8	16	0	0	16	0	0
19	31341829	.	C	T	2	8	10	0	0	10	0	0
19	31392375	.	C	T	14	12	26	0	0	26	0	0
19	31392700	.	G	A	19	13	32	0	1	33	0	0
19	31392803	.	C	T	0	2	2	0	3	5	0	0
19	31394550	.	A	G	7	6	13	0	0	13	0	0
19	31398961	.	A	G	3	2	5	0	1	6	0	0
19	31398979	.	A	G	4	6	10	0	0	10	0	0
19	31416787	.	G	A	3	9	12	0	2	14	0	0
19	31424215	.	C	G	1	0	1	0	5	6	0	0
19	31431021	.	T	C	6	11	17	0	0	17	0	0
19	31437956	.	A	G	9	11	20	0	1	21	0	0
19	31437974	.	G	A	8	6	14	0	2	16	0	0
19	31449834	.	T	G	2	5	7	0	0	7	0	0
19	31461620	.	C	G	1	1	2	0	0	2	0	0
19	32050593	.	A	T	0	15	15	0	0	15	0	0
19	32895873	.	T	A	5	4	9	0	7	16	0	0
19	32896083	.	G	A	6	3	9	0	1	10	0	0
19	33839595	.	G	A	11	4	15	0	0	15	0	0
19	33847935	.	A	T	2	1	3	0	0	3	0	0
19	33858734	.	A	G	0	1	1	0	0	1	0	0
19	33861796	.	A	G	4	2	6	0	0	6	0	0
19	33868335	.	T	C	1	0	1	0	0	1	0	0
19	33871868	.	C	T	3	3	6	0	1	7	0	0
19	33872816	.	T	G	6	11	17	0	0	17	0	0
19	33872859	.	G	A	0	3	3	0	7	10	0	0
19	33888520	.	A	C	28	23	51	0	2	53	0	0
19	33888881	.	T	G	4	3	7	0	1	8	0	0
19	33902586	.	G	A	10	6	16	0	0	16	0	0
19	33915802	.	C	T	9	6	15	0	0	15	0	0
19	33921715	.	A	G	3	4	7	0	0	7	0	0
19	33956909	.	C	T	1	2	3	0	0	3	0	0
19	33963773	.	G	T	3	1	4	0	0	4	0	0
19	33964353	.	A	G	5	8	13	0	0	13	0	0
19	33996170	.	G	A	2	0	2	0	0	2	0	0
19	34074028	.	G	A	6	10	16	0	2	18	0	0
19	34074072	.	A	G	14	8	22	0	0	22	0	0
19	34074386	.	T	G	12	7	19	0	1	20	0	0
19	34089132	.	T	G	10	7	17	0	2	19	0	0
19	34217347	.	C	A	2	3	5	0	0	5	0	0
19	34563588	.	T	C	4	4	8	0	0	8	0	0
19	34691678	.	T	C	3	0	3	0	2	5	0	0
19	34696921	.	C	T	1	0	1	0	0	1	0	0
19	34698294	.	G	A	0	3	3	0	0	4	1	0
19	34720217	.	G	A	1	4	5	0	0	5	0	0
19	34742818	.	C	T	3	1	4	0	1	5	0	0
19	34744060	.	T	G	1	1	2	0	0	2	0	0
19	34744231	.	T	C	2	2	4	0	0	4	0	0
19	34744288	.	C	A	1	2	3	0	0	3	0	0
19	34746659	.	G	A	5	8	13	0	0	13	0	0
19	34746810	.	T	G	2	3	5	0	0	5	0	0
19	34746826	.	G	A	0	2	2	0	0	2	0	0
19	34753645	.	G	A	1	1	2	0	0	2	0	0
19	34753669	.	G	C	2	1	3	0	3	6	0	0
19	34957709	.	G	C	0	3	3	0	1	4	0	0
19	34957738	.	A	G	1	3	4	0	0	4	0	0
19	34960099	.	A	G	4	3	7	0	1	8	0	0
19	34960190	.	C	G	0	9	9	0	20	29	0	0
19	34960198	.	T	C	20	7	27	0	0	27	0	0
19	34960315	.	T	A	7	6	13	0	0	13	0	0
19	34960574	.	A	G	2	2	4	1	0	5	0	0
19	34960694	.	T	A	3	7	10	0	2	12	0	0
19	34961152	.	C	T	7	10	17	0	0	17	0	0
19	34961269	.	A	G	0	1	1	0	0	1	0	0
19	35002450	.	G	A	3	2	5	0	0	5	0	0
19	35002714	.	A	C	1	3	4	0	0	4	0	0
19	35002723	.	T	C	1	3	4	0	0	4	0	0
19	35003821	.	C	T	1	2	3	0	0	3	0	0
19	35004117	.	A	C	7	6	13	0	0	13	0	0
19	35004135	.	C	T	6	5	11	0	0	11	0	0
19	35004941	.	T	C	10	3	13	0	0	13	0	0
19	35005136	.	A	C	6	3	9	0	0	9	0	0
19	35005137	.	A	T	6	3	9	0	0	9	0	0
19	35005318	.	G	A	11	12	23	0	7	30	0	0
19	35007021	.	G	A	0	2	2	0	3	5	0	0
19	35007220	.	G	A	3	5	8	0	0	8	0	0
19	35007235	.	G	A	2	3	5	0	0	5	0	0
19	35013806	.	C	T	22	21	43	0	0	43	0	0
19	35016553	.	T	G	16	10	26	0	0	26	0	0
19	35016646	.	A	T	20	18	38	0	4	42	0	0
19	35016696	.	T	G	13	15	28	0	0	28	0	0
19	35016835	.	C	T	13	12	25	0	0	25	0	0
19	35016962	.	T	A	7	6	13	0	1	14	0	0
19	35019339	.	C	A	2	2	4	0	1	5	0	0
19	35019351	.	T	C	2	2	4	0	1	5	0	0
19	35019560	.	A	G	1	4	5	0	0	5	0	0
19	35040003	.	G	T	5	3	8	0	2	10	0	0
19	35041158	.	T	A	20	21	41	0	3	44	0	0
19	35041308	.	A	G	27	25	52	0	0	52	0	0
19	35041458	.	T	C	14	0	14	0	9	23	0	0
19	35052411	.	G	T	7	13	20	0	0	20	0	0
19	35052435	.	T	C	7	1	8	0	12	20	0	0
19	35055889	.	A	G	11	9	20	0	0	20	0	0
19	35057869	.	C	T	3	2	5	0	0	5	0	0
19	35058232	.	T	C	5	5	10	0	1	11	0	0
19	35060217	.	A	C	11	15	26	0	0	26	0	0
19	35065906	.	A	T	1	8	9	0	0	9	0	0
19	35067367	.	G	A	7	9	16	0	0	16	0	0
19	35069299	.	G	T	3	0	3	0	0	3	0	0
19	35069755	.	C	A	5	2	7	0	0	7	0	0
19	35069934	.	T	G	2	1	3	0	0	3	0	0
19	35070015	.	C	T	4	2	6	0	0	6	0	0
19	35072613	.	A	C	13	10	23	0	0	23	0	0
19	35072712	.	G	C	2	0	2	0	3	5	0	0
19	35075637	.	C	T	0	11	11	0	12	23	0	0
19	35076301	.	C	T	0	7	7	0	5	12	0	0
19	35076773	.	G	A	3	12	15	0	0	15	0	0
19	35078584	.	T	C	9	0	9	0	5	14	0	0
19	35078632	.	T	C	5	0	5	0	6	11	0	0
19	35079259	.	C	T	3	8	11	0	1	12	0	0
19	35083010	.	G	A	2	1	3	0	0	3	0	0
19	35083019	.	C	T	2	0	2	0	0	2	0	0
19	35083182	.	C	T	1	1	2	0	0	2	0	0
19	35116228	.	A	G	5	8	13	0	0	13	0	0
19	35116297	.	T	C	3	5	8	0	0	8	0	0
19	35116405	.	A	G	5	6	11	0	0	11	0	0
19	35116438	.	G	A	2	7	9	0	0	9	0	0
19	35118911	.	C	A	6	6	12	0	0	12	0	0
19	35118983	.	A	T	5	3	8	0	1	9	0	0
19	35119169	.	G	A	6	5	11	0	0	11	0	0
19	35119205	.	G	A	7	5	12	0	0	12	0	0
19	35119436	.	C	T	3	4	7	0	0	7	0	0
19	35123452	.	A	T	2	2	4	0	0	4	0	0
19	35123508	.	T	C	3	0	3	0	5	8	0	0
19	35135406	.	C	A	0	3	3	0	2	5	0	0
19	35135626	.	T	G	3	2	5	0	0	5	0	0
19	35135711	.	A	G	1	1	2	0	0	2	0	0
19	35135961	.	A	G	2	2	4	0	1	5	0	0
19	35155676	.	C	T	2	1	3	0	1	4	0	0
19	35159665	.	G	T	1	0	1	0	0	1	0	0
19	35159668	.	G	A	1	0	1	0	0	1	0	0
19	35159721	.	A	G	2	3	5	0	0	5	0	0
19	35165047	.	T	C	0	0	0	0	1	1	0	0
19	35167368	.	C	G	0	1	1	0	0	1	0	0
19	35359341	.	C	T	18	26	44	0	0	44	0	0
19	35379917	.	A	G	3	6	9	0	1	10	0	0
19	35379923	.	G	A	4	5	9	0	0	9	0	0
19	35379998	.	A	G	1	5	6	0	0	6	0	0
19	35380031	.	G	A	7	5	12	0	0	12	0	0
19	35380070	.	G	A	11	3	14	0	0	14	0	0
19	35380168	.	T	C	5	0	5	0	3	8	0	0
19	35381956	.	A	G	2	4	6	0	0	6	0	0
19	35386288	.	T	G	3	3	6	0	0	6	0	0
19	35419202	.	A	G	6	3	9	0	0	9	0	0
19	35419215	.	T	A	6	4	10	0	0	10	0	0
19	35419292	.	T	A	2	2	4	0	1	5	0	0
19	35419300	.	A	T	2	3	5	0	1	6	0	0
19	35422354	.	T	C	5	5	10	0	0	10	0	0
19	35428735	.	G	A	3	2	5	0	1	6	0	0
19	35459414	.	A	G	11	15	26	2	2	30	0	0
19	35459737	.	G	A	25	18	43	0	2	45	0	0
19	35459801	.	A	T	19	19	38	0	1	39	0	0
19	35473080	.	C	A	0	3	3	0	5	8	0	0
19	35492712	.	T	A	1	2	3	0	0	3	0	0
19	36115044	.	G	A	2	6	8	0	1	9	0	0
19	36115210	.	G	A	11	8	19	0	0	19	0	0
19	36120265	.	C	T	0	6	6	0	5	11	0	0
19	36122534	.	C	T	2	3	5	0	0	5	0	0
19	36212370	.	G	A	2	1	3	0	0	3	0	0
19	36251978	.	A	G	1	1	2	0	0	2	0	0
19	36378314	.	G	A	0	2	2	0	0	2	0	0
19	37122536	.	A	G	4	1	5	0	2	7	0	0
19	37133533	.	C	A	6	4	10	0	1	11	0	0
19	37133762	.	C	T	8	5	13	0	0	14	1	0
19	37133825	.	G	A	5	6	11	0	0	11	0	0
19	37133844	.	C	T	6	4	10	0	0	10	0	0
19	37133872	.	T	C	2	5	7	0	1	8	0	0
19	37138388	.	G	A	0	4	4	0	3	7	0	0
19	37138643	.	G	A	0	11	11	0	12	23	0	0
19	37138955	.	A	G	12	12	24	0	2	26	0	0
19	37478230	.	C	A	1	2	3	0	0	3	0	0
19	37481628	.	C	A	3	2	5	0	0	5	0	0
19	37481658	.	C	T	7	3	10	0	1	11	0	0
19	37488830	.	C	T	3	4	7	0	1	8	0	0
19	37491689	.	G	A	0	2	2	0	0	2	0	0
19	37492351	.	G	A	1	4	5	0	0	5	0	0
19	37492514	.	A	T	1	4	5	0	0	5	0	0
19	37501935	.	A	G	22	25	47	0	1	48	0	0
19	37502105	.	A	G	9	5	14	0	0	14	0	0
19	37505808	.	G	A	5	4	9	0	0	9	0	0
19	37701637	.	A	G	1	1	2	0	1	3	0	0
19	37702123	.	T	A	2	2	4	0	0	4	0	0
19	37702255	.	A	T	2	2	4	0	0	4	0	0
19	37802966	.	C	T	0	1	1	0	0	1	0	0
19	37802971	.	A	T	0	1	1	0	0	1	0	0
19	37804452	.	G	A	0	3	3	0	1	4	0	0
19	37804477	.	G	A	0	2	2	0	1	3	0	0
19	37804647	.	C	T	1	1	2	1	0	3	0	0
19	37815763	.	G	A	3	4	7	0	0	7	0	0
19	37835322	.	G	A	1	2	3	0	0	3	0	0
19	37835367	.	G	A	4	2	6	0	0	6	0	0
19	37835433	.	A	C	2	3	5	0	0	5	0	0
19	37835502	.	A	G	0	2	2	0	1	3	0	0
19	37835508	.	T	C	1	1	2	0	0	2	0	0
19	37858144	.	G	C	7	8	15	0	3	18	0	0
19	37926003	.	C	T	17	14	31	0	6	37	0	0
19	37926066	.	C	A	20	20	40	0	2	42	0	0
19	37926653	.	A	T	7	15	22	0	1	23	0	0
19	37926666	.	C	A	7	17	24	0	4	28	0	0
19	37926816	.	T	G	25	20	45	0	2	47	0	0
19	37926865	.	G	A	27	15	42	0	0	42	0	0
19	37927304	.	G	T	0	13	13	0	21	34	0	0
19	38171067	.	G	A	0	2	2	0	0	2	0	0
19	38175399	.	C	T	4	3	7	0	0	7	0	0
19	38175515	.	G	C	4	6	10	0	0	10	0	0
19	38216247	.	A	G	5	4	9	0	0	9	0	0
19	38227086	.	T	G	1	2	3	0	1	4	0	0
19	38240541	.	A	G	1	0	1	0	0	1	0	0
19	38240844	.	C	T	2	2	4	0	0	4	0	0
19	38327091	.	A	T	3	2	5	0	0	5	0	0
19	38327186	.	T	C	5	2	7	0	0	7	0	0
19	38464589	.	C	T	0	2	2	0	0	2	0	0
19	38467032	.	C	T	3	3	6	0	0	6	0	0
19	38467142	.	T	G	3	6	9	0	0	9	0	0
19	38467197	.	T	C	1	3	4	0	0	4	0	0
19	38805570	.	G	A	0	2	2	0	0	2	0	0
19	40026661	.	T	C	16	21	37	0	0	37	0	0
19	40031002	.	G	A	6	6	12	0	1	13	0	0
19	40039603	.	G	A	8	14	22	0	0	22	0	0
19	40039606	.	T	A	6	11	17	0	3	21	1	0
19	40053055	.	A	G	12	0	12	0	23	35	0	0
19	40053061	.	A	T	12	23	35	0	3	38	0	0
19	40055030	.	A	G	4	4	8	0	0	8	0	0
19	40055318	.	A	G	1	4	5	0	0	5	0	0
19	40071539	.	T	G	2	1	3	0	0	3	0	0
19	40071541	.	G	A	2	1	3	0	0	3	0	0
19	40083731	.	C	T	1	0	1	0	1	2	0	0
19	40085806	.	T	C	1	2	3	0	1	4	0	0
19	40099361	.	C	T	2	2	4	0	0	4	0	0
19	40110840	.	G	A	0	0	0	0	2	2	0	0
19	40113305	.	G	A	0	0	0	0	2	2	0	0
19	40113425	.	C	A	6	8	14	0	1	15	0	0
19	40113549	.	T	G	8	4	12	0	0	12	0	0
19	40113677	.	C	G	13	5	18	0	0	18	0	0
19	40113692	.	G	T	12	3	15	0	0	15	0	0
19	40129299	.	C	T	0	2	2	0	1	3	0	0
19	40129443	.	A	G	1	2	3	0	0	3	0	0
19	40129474	.	A	G	2	0	2	0	1	3	0	0
19	40145504	.	T	C	1	1	2	0	0	2	0	0
19	40145888	.	G	A	2	3	5	0	0	5	0	0
19	40147821	.	G	A	0	8	8	0	7	15	0	0
19	40151970	.	G	A	5	6	11	0	0	11	0	0
19	40151983	.	C	T	4	5	9	0	0	9	0	0
19	40155144	.	C	A	4	5	9	0	0	9	0	0
19	40156870	.	T	C	6	3	9	0	0	9	0	0
19	40160049	.	T	C	11	5	16	0	3	19	0	0
19	40162945	.	C	A	17	16	33	0	2	35	0	0
19	40163256	.	C	T	10	7	17	0	4	21	0	0
19	40165405	.	A	G	14	14	28	0	1	29	0	0
19	40165681	.	A	G	5	0	5	0	6	11	0	0
19	40177406	.	G	T	0	1	1	0	1	2	0	0
19	40177762	.	T	C	1	0	1	0	0	1	0	0
19	40179763	.	G	A	0	0	0	0	2	2	0	0
19	40180011	.	C	T	3	8	11	0	0	11	0	0
19	40190997	.	A	C	4	0	4	0	6	10	0	0
19	40340319	.	A	G	4	2	6	0	0	6	0	0
19	40344730	.	A	C	0	1	1	0	0	1	0	0
19	40345966	.	G	T	0	7	7	0	1	8	0	0
19	40347600	.	T	G	4	0	4	0	1	5	0	0
19	40347702	.	T	A	9	23	32	0	5	37	0	0
19	40347760	.	T	A	20	10	30	0	3	33	0	0
19	40347785	.	A	T	20	5	25	0	3	28	0	0
19	40347842	.	G	T	0	3	3	0	2	5	0	0
19	40540324	.	C	T	2	2	4	0	0	4	0	0
19	40558221	.	C	T	0	2	2	0	0	2	0	0
19	40558281	.	A	G	1	0	1	0	0	1	0	0
19	40565356	.	C	A	2	0	2	0	0	2	0	0
19	40641356	.	C	G	0	0	0	0	1	1	0	0
19	40641379	.	A	G	0	3	3	0	0	3	0	0
19	40641433	.	T	C	2	3	5	0	0	5	0	0
19	40685447	.	A	G	8	0	8	0	3	11	0	0
19	40685518	.	G	A	0	9	9	0	5	14	0	0
19	40685520	.	T	C	5	7	12	0	2	14	0	0
19	40685664	.	A	G	4	3	7	0	1	8	0	0
19	40685845	.	G	A	3	4	7	0	0	7	0	0
19	40685875	.	G	A	3	4	7	0	1	8	0	0
19	40685923	.	T	C	5	3	8	0	0	8	0	0
19	40685935	.	A	G	2	3	5	0	1	6	0	0
19	40686099	.	A	G	3	6	9	0	1	10	0	0
19	40716977	.	T	C	3	4	7	0	0	7	0	0
19	40717209	.	T	A	5	5	10	0	0	10	0	0
19	40717649	.	C	A	3	7	10	0	0	11	1	0
19	40731649	.	C	T	2	2	4	0	0	4	0	0
19	40859012	.	T	C	11	14	25	0	0	25	0	0
19	40859147	.	C	A	9	6	15	0	0	15	0	0
19	40859207	.	A	G	5	11	16	0	0	16	0	0
19	40859369	.	A	G	9	4	13	0	0	13	0	0
19	40859378	.	T	C	9	4	13	0	0	13	0	0
19	40892312	.	T	C	5	3	8	0	0	8	0	0
19	40895763	.	G	A	5	6	11	0	0	11	0	0
19	40895826	.	T	C	1	3	4	0	0	4	0	0
19	40898468	.	C	T	6	4	10	0	0	10	0	0
19	40900059	.	T	A	10	8	18	0	0	18	0	0
19	40903335	.	G	A	5	2	7	0	0	7	0	0
19	41021048	.	T	C	4	3	7	0	0	7	0	0
19	41031941	.	G	A	1	9	10	0	5	15	0	0
19	41033898	.	C	T	14	14	28	0	3	31	0	0
19	41038942	.	C	A	17	30	47	0	1	48	0	0
19	41039012	.	G	C	10	1	11	0	19	30	0	0
19	41052229	.	G	A	9	15	24	0	0	24	0	0
19	41054464	.	T	C	8	1	9	0	12	21	0	0
19	41057049	.	C	A	3	2	5	0	0	5	0	0
19	41057079	.	G	A	6	7	13	0	1	14	0	0
19	41060384	.	C	T	1	10	11	0	22	33	0	0
19	41081118	.	G	A	3	3	6	0	0	6	0	0
19	41081198	.	T	C	2	3	5	0	0	5	0	0
19	41081211	.	C	G	2	0	2	0	2	4	0	0
19	41127263	.	G	A	0	2	2	0	0	2	0	0
19	41159124	.	G	A	0	2	2	0	2	4	0	0
19	41160117	.	G	A	1	3	4	0	0	4	0	0
19	41160202	.	A	T	1	3	4	0	0	4	0	0
19	41191266	.	T	C	1	2	3	0	0	3	0	0
19	41401637	.	C	A	8	14	22	0	1	23	0	0
19	41401727	.	C	T	0	15	15	0	5	20	0	0
19	41401878	.	G	A	11	8	19	0	1	20	0	0
19	41401926	.	A	G	20	15	35	0	0	35	0	0
19	41401928	.	G	A	20	14	34	0	1	35	0	0
19	41401979	.	G	C	30	13	43	1	1	45	0	0
19	41404250	.	G	A	5	11	16	0	1	17	0	0
19	41404273	.	C	T	0	5	5	0	2	7	0	0
19	41447257	.	A	G	4	2	6	0	1	7	0	0
19	41447368	.	G	A	1	2	3	1	0	4	0	0
19	41447420	.	A	G	6	3	9	0	0	9	0	0
19	41447427	.	A	G	3	3	6	0	3	9	0	0
19	41447600	.	G	T	5	3	8	0	0	8	0	0
19	41447767	.	A	G	2	2	4	0	0	4	0	0
19	41447793	.	A	G	2	2	4	0	0	4	0	0
19	41448040	.	G	A	5	3	8	0	1	9	0	0
19	41448047	.	G	T	5	5	10	0	0	10	0	0
19	41466725	.	T	C	6	5	11	0	1	12	0	0
19	41466726	.	G	A	5	6	11	0	1	12	0	0
19	41466777	.	G	A	0	9	9	0	6	15	0	0
19	41466783	.	T	C	6	9	15	0	0	15	0	0
19	41516139	.	T	G	8	4	12	0	0	12	0	0
19	41516281	.	C	A	4	5	9	0	0	9	0	0
19	41531232	.	A	C	4	3	7	0	0	7	0	0
19	41531236	.	C	T	5	3	8	0	0	8	0	0
19	41533610	.	T	A	0	1	1	0	0	1	0	0
19	41533987	.	A	T	2	2	4	0	1	5	0	0
19	41533991	.	A	T	2	3	5	0	0	5	0	0
19	41534035	.	G	C	1	3	4	0	0	4	0	0
19	41534050	.	G	A	2	3	5	0	1	6	0	0
19	41534092	.	T	C	2	5	7	0	0	7	0	0
19	41538865	.	A	G	2	1	3	0	0	3	0	0
19	41538932	.	G	A	0	3	3	0	3	6	0	0
19	41539045	.	T	C	0	2	2	0	0	2	0	0
19	41539065	.	G	A	0	2	2	0	0	2	0	0
19	41539133	.	C	T	2	3	5	0	0	5	0	0
19	41539216	.	A	T	1	4	5	0	0	5	0	0
19	41539227	.	C	T	1	4	5	0	0	5	0	0
19	41539270	.	G	C	2	2	4	0	0	4	0	0
19	41539346	.	G	C	1	2	3	0	0	3	0	0
19	41539467	.	T	C	1	3	4	0	0	4	0	0
19	41539516	.	A	T	0	5	5	0	1	6	0	0
19	41539517	.	A	C	0	6	6	0	0	6	0	0
19	41539663	.	T	C	1	2	3	0	0	3	0	0
19	41539664	.	T	C	1	2	3	0	0	3	0	0
19	41539821	.	G	T	1	3	4	0	1	5	0	0
19	41539868	.	A	C	1	5	6	0	0	6	0	0
19	41539935	.	G	A	2	3	5	0	0	5	0	0
19	41717013	.	G	C	0	10	10	0	7	17	0	0
19	41723561	.	C	T	10	4	14	0	1	15	0	0
19	41723577	.	C	T	0	1	1	0	1	2	0	0
19	41724049	.	G	A	0	6	6	0	10	16	0	0
19	41841261	.	C	A	9	3	12	0	1	13	0	0
19	41841824	.	T	C	15	16	31	0	0	31	0	0
19	41846849	.	G	T	10	7	17	0	1	18	0	0
19	41849679	.	A	G	1	4	5	0	0	5	0	0
19	41851698	.	G	T	2	2	4	0	1	5	0	0
19	41853967	.	G	T	12	6	18	0	1	19	0	0
19	41857795	.	G	A	8	9	17	0	0	17	0	0
19	41857846	.	C	T	7	8	15	0	0	15	0	0
19	41860157	.	G	A	9	7	16	0	0	16	0	0
19	41870495	.	G	A	5	3	8	0	0	8	0	0
19	41870515	.	T	A	2	1	3	0	0	3	0	0
19	41882152	.	G	A	6	2	8	0	0	8	0	0
19	41882212	.	G	A	4	5	9	0	1	10	0	0
19	41884108	.	A	G	4	3	7	0	0	7	0	0
19	41884129	.	C	T	0	4	4	0	5	9	0	0
19	41884162	.	G	A	3	3	6	0	0	6	0	0
19	41902743	.	A	G	1	1	2	0	0	2	0	0
19	41937394	.	G	A	1	2	3	0	0	3	0	0
19	41946709	.	G	A	2	3	5	0	0	5	0	0
19	42061290	.	C	T	5	6	11	0	1	12	0	0
19	42061441	.	C	G	10	4	14	0	0	14	0	0
19	42061455	.	A	G	10	3	13	0	1	14	0	0
19	42061491	.	C	T	12	5	17	0	0	17	0	0
19	42061521	.	A	G	12	14	26	0	0	26	0	0
19	42061605	.	A	G	6	1	7	0	8	15	0	0
19	42065010	.	C	T	2	1	3	0	0	3	0	0
19	42066899	.	T	C	9	13	22	0	2	24	0	0
19	42067065	.	T	C	14	17	31	0	1	32	0	0
19	42067149	.	T	C	19	15	34	0	1	35	0	0
19	42068537	.	A	C	8	9	17	0	0	17	0	0
19	42068818	.	A	G	1	2	3	0	0	3	0	0
19	42068847	.	A	T	2	2	4	0	0	4	0	0
19	42071867	.	T	A	1	1	2	0	0	2	0	0
19	42117777	.	A	T	10	12	22	0	2	25	1	0
19	42118040	.	T	G	10	13	23	0	4	27	0	0
19	42235042	.	G	C	8	4	12	0	0	12	0	0
19	42235161	.	G	T	7	8	15	0	0	15	0	0
19	42235205	.	A	G	5	10	15	0	0	15	0	0
19	42235286	.	A	T	7	4	11	0	3	14	0	0
19	42235655	.	A	C	14	8	22	0	0	22	0	0
19	42235967	.	A	G	1	2	3	0	1	4	0	0
19	42241740	.	G	T	2	5	7	0	0	7	0	0
19	42241755	.	G	T	3	6	9	0	0	9	0	0
19	42244118	.	G	A	0	2	2	0	0	2	0	0
19	42244281	.	T	C	6	0	6	0	7	13	0	0
19	42244342	.	G	T	1	5	6	0	0	6	0	0
19	42328467	.	T	C	19	12	31	0	0	31	0	0
19	42328510	.	C	T	22	27	49	0	1	50	0	0
19	42336375	.	G	A	7	10	17	0	0	17	0	0
19	42336526	.	C	T	3	2	5	0	0	5	0	0
19	42336636	.	C	T	19	15	34	0	1	35	0	0
19	42336675	.	C	T	4	2	6	0	1	7	0	0
19	42340452	.	A	G	14	1	15	0	13	28	0	0
19	42340455	.	C	T	13	13	26	0	1	27	0	0
19	42340508	.	G	C	24	21	45	0	0	45	0	0
19	42340658	.	G	A	8	25	33	0	29	62	0	0
19	42340855	.	G	A	1	21	22	0	28	50	0	0
19	42341530	.	T	C	29	19	48	0	1	49	0	0
19	42341613	.	T	A	23	21	44	0	4	48	0	0
19	42341693	.	G	A	18	26	44	0	3	47	0	0
19	42367500	.	T	A	2	2	4	0	0	4	0	0
19	42367531	.	G	A	2	6	8	0	0	8	0	0
19	42368065	.	C	T	0	4	4	0	8	12	0	0
19	42368511	.	A	C	2	4	6	0	0	6	0	0
19	42368619	.	T	A	2	4	6	0	1	7	0	0
19	42368620	.	T	C	2	0	2	0	5	7	0	0
19	42389797	.	C	T	0	3	3	0	0	3	0	0
19	42389876	.	C	T	0	1	1	0	0	1	0	0
19	42397975	.	G	A	23	9	32	0	0	32	0	0
19	42400567	.	A	G	3	3	6	0	1	7	0	0
19	42402060	.	G	A	0	2	2	0	0	2	0	0
19	42402382	.	A	G	2	1	3	0	0	3	0	0
19	42416665	.	A	T	4	6	10	0	1	11	0	0
19	42449170	.	C	G	1	2	3	0	0	3	0	0
19	42453907	.	C	A	1	2	3	0	0	3	0	0
19	42454302	.	A	G	1	2	3	0	0	3	0	0
19	42455273	.	C	T	1	4	5	0	0	5	0	0
19	42458099	.	T	C	8	12	20	0	0	20	0	0
19	42458112	.	T	A	5	9	14	0	0	14	0	0
19	42459868	.	T	A	1	6	7	0	0	7	0	0
19	42491132	.	G	T	7	10	17	0	2	19	0	0
19	42493255	.	C	T	7	11	18	0	0	18	0	0
19	42493353	.	T	A	4	4	8	0	1	9	0	0
19	42493986	.	G	T	0	1	1	0	0	1	0	0
19	42494130	.	T	C	2	0	2	0	1	3	0	0
19	42495678	.	T	G	2	2	4	0	0	4	0	0
19	42495829	.	G	A	0	2	2	0	0	2	0	0
19	42495850	.	G	A	1	3	4	0	0	4	0	0
19	42495901	.	A	G	7	5	12	0	0	12	0	0
19	42498306	.	T	C	1	2	3	0	5	8	0	0
19	42498376	.	C	T	1	3	4	0	0	4	0	0
19	42498378	.	A	C	1	2	3	0	1	4	0	0
19	42498715	.	G	A	1	1	2	0	0	2	0	0
19	42559818	.	G	T	2	2	4	0	0	4	0	0
19	42559839	.	C	G	2	2	4	0	0	4	0	0
19	42559853	.	G	A	1	2	3	0	0	3	0	0
19	42574042	.	C	A	3	2	5	0	0	5	0	0
19	42574179	.	T	C	0	3	3	0	1	4	0	0
19	42574180	.	T	C	1	3	4	0	0	4	0	0
19	42574523	.	A	T	3	4	7	0	0	7	0	0
19	42617593	.	C	T	4	2	6	0	0	6	0	0
19	42667987	.	C	T	2	1	3	0	0	3	0	0
19	42682502	.	A	G	9	7	16	0	0	16	0	0
19	42682504	.	G	A	2	7	9	0	6	16	1	0
19	42682628	.	G	A	7	10	17	0	0	17	0	0
19	42682678	.	C	T	4	7	11	0	0	11	0	0
19	42682699	.	C	A	4	5	9	0	0	9	0	0
19	42732770	.	G	C	5	3	8	0	1	9	0	0
19	42735350	.	C	A	1	0	1	0	0	1	0	0
19	42740353	.	G	C	1	2	3	0	1	4	0	0
19	42743837	.	G	A	1	2	3	0	0	3	0	0
19	42744744	.	C	T	2	1	3	0	0	3	0	0
19	42747212	.	G	A	0	13	13	0	10	23	0	0
19	42754892	.	C	T	2	4	6	0	0	6	0	0
19	42791291	.	T	C	11	10	21	0	0	21	0	0
19	42795751	.	A	G	23	30	53	0	4	57	0	0
19	42795799	.	C	T	19	21	40	0	3	43	0	0
19	42798696	.	C	T	4	7	11	0	0	11	0	0
19	42801687	.	G	A	10	30	40	0	27	67	0	0
19	42801708	.	T	A	27	27	54	0	2	56	0	0
19	42802018	.	C	A	30	34	64	0	4	68	0	0
19	42802075	.	T	C	26	26	52	0	3	55	0	0
19	42802077	.	C	T	27	27	54	0	1	55	0	0
19	42819989	.	G	A	1	0	1	0	0	1	0	0
19	42821808	.	G	A	1	2	3	0	0	3	0	0
19	42821859	.	T	C	1	2	3	0	0	3	0	0
19	42826201	.	T	C	1	0	1	0	0	1	0	0
19	42835133	.	C	T	1	4	5	0	0	5	0	0
19	42841599	.	A	C	9	5	14	0	1	15	0	0
19	42843642	.	A	G	8	9	17	0	0	17	0	0
19	42843725	.	A	C	8	6	14	0	0	14	0	0
19	42843751	.	A	T	6	5	11	0	0	11	0	0
19	42843845	.	A	G	12	7	19	0	2	21	0	0
19	42843894	.	A	G	17	5	22	0	2	24	0	0
19	42843917	.	T	C	14	6	20	0	0	20	0	0
19	42844126	.	A	G	10	4	14	0	0	14	0	0
19	42856838	.	C	T	1	2	3	0	0	3	0	0
19	42864222	.	G	T	4	5	9	0	0	9	0	0
19	42868330	.	T	C	4	0	4	0	0	4	0	0
19	42868446	.	A	G	10	11	21	0	0	21	0	0
19	42870307	.	T	G	6	0	6	0	7	13	0	0
19	42870512	.	C	T	6	5	11	0	0	11	0	0
19	42872200	.	G	C	14	14	28	0	0	28	0	0
19	42872386	.	A	C	4	0	4	0	14	18	0	0
19	42873858	.	G	A	1	12	13	0	10	23	0	0
19	42874075	.	C	G	9	12	21	0	1	22	0	0
19	42874172	.	C	T	12	17	29	0	1	30	0	0
19	42874188	.	A	G	14	0	14	0	15	29	0	0
19	42874231	.	C	T	12	14	26	0	0	26	0	0
19	42874301	.	G	A	15	10	25	0	2	27	0	0
19	42874336	.	G	C	8	6	14	0	7	21	0	0
19	42874414	.	T	C	14	4	18	0	3	21	0	0
19	42874564	.	G	A	14	6	20	0	1	21	0	0
19	42874674	.	A	G	17	16	33	0	2	35	0	0
19	42894574	.	G	A	1	1	2	0	0	2	0	0
19	42894603	.	A	T	3	3	6	0	0	6	0	0
19	42894624	.	C	T	5	4	9	0	0	9	0	0
19	42894742	.	A	C	4	3	7	0	0	7	0	0
19	42906166	.	T	C	2	0	2	0	0	2	0	0
19	42906169	.	G	A	0	0	0	0	2	2	0	0
19	42908916	.	T	A	4	5	9	0	0	9	0	0
19	42909168	.	C	T	3	2	5	0	1	6	0	0
19	42912376	.	C	A	8	15	23	0	0	23	0	0
19	42912394	.	G	A	0	10	10	0	12	22	0	0
19	42919465	.	C	T	0	7	7	0	10	17	0	0
19	42928242	.	C	T	0	3	3	0	3	6	0	0
19	42928647	.	C	T	0	9	9	0	7	16	0	0
19	42928845	.	C	A	0	7	7	0	5	12	0	0
19	42988059	.	C	T	6	14	20	0	0	20	0	0
19	42997087	.	G	A	5	3	8	0	1	9	0	0
19	42997106	.	C	G	5	5	10	0	0	10	0	0
19	42997337	.	C	G	2	3	5	0	0	5	0	0
19	43000034	.	G	C	2	0	2	0	8	10	0	0
19	43000067	.	C	T	2	7	9	0	1	10	0	0
19	43000070	.	A	G	2	7	9	0	1	10	0	0
19	43002605	.	A	C	1	1	2	0	0	2	0	0
19	43004118	.	G	A	0	1	1	0	0	1	0	0
19	43004133	.	T	C	0	2	2	0	0	2	0	0
19	43004259	.	A	G	16	5	21	0	0	21	0	0
19	43004283	.	T	C	14	6	20	0	0	20	0	0
19	43004297	.	C	A	5	10	15	0	0	15	0	0
19	43007838	.	T	C	0	1	1	0	0	1	0	0
19	43007913	.	C	T	0	1	1	0	0	1	0	0
19	43009476	.	C	T	2	2	4	0	1	5	0	0
19	43015255	.	A	C	1	0	1	0	0	1	0	0
19	43015276	.	C	A	0	1	1	0	0	1	0	0
19	43018243	.	T	C	7	10	17	0	2	19	0	0
19	43018257	.	G	A	0	10	10	0	14	24	0	0
19	43018352	.	T	C	11	13	24	0	1	25	0	0
19	43029462	.	G	A	0	6	6	0	5	11	0	0
19	43030654	.	G	A	28	22	50	0	0	50	0	0
19	43030655	.	A	G	28	22	50	0	0	50	0	0
19	43031169	.	G	A	3	27	30	0	14	44	0	0
19	43031261	.	G	A	0	6	6	0	4	10	0	0
19	43031264	.	A	G	6	4	10	0	0	10	0	0
19	43054736	.	A	G	2	1	3	0	0	3	0	0
19	43054854	.	C	T	8	3	11	0	0	11	0	0
19	43059329	.	C	T	6	3	9	0	1	10	0	0
19	43061448	.	G	A	1	2	3	0	0	3	0	0
19	43062374	.	T	A	5	4	9	0	0	9	0	0
19	43063825	.	C	A	1	2	3	0	0	3	0	0
19	43063846	.	C	T	1	2	3	0	0	3	0	0
19	43065875	.	C	T	9	9	18	0	0	18	0	0
19	43072588	.	T	C	12	16	28	0	0	28	0	0
19	43072645	.	G	A	0	6	6	0	12	19	1	0
19	43072663	.	C	T	9	7	16	0	3	19	0	0
19	43074635	.	C	T	12	14	26	0	0	26	0	0
19	43074668	.	G	T	13	14	27	0	0	27	0	0
19	43074692	.	G	C	13	15	28	0	2	30	0	0
19	43074716	.	G	A	11	12	23	0	0	23	0	0
19	43076458	.	C	T	12	7	19	0	0	19	0	0
19	43083844	.	C	T	4	4	8	0	1	9	0	0
19	43120316	.	C	T	23	8	31	0	2	33	0	0
19	43120471	.	T	C	14	22	36	0	2	38	0	0
19	43121440	.	G	A	35	34	69	0	2	71	0	0
19	43121700	.	G	A	3	3	6	0	1	7	0	0
19	43121736	.	G	A	13	23	36	0	7	43	0	0
19	43121784	.	C	T	30	27	57	0	5	62	0	0
19	43121826	.	T	C	9	11	20	0	1	21	0	0
19	43126014	.	G	A	14	20	34	0	1	35	0	0
19	43126104	.	C	T	5	9	14	0	1	15	0	0
19	43126113	.	C	T	9	8	17	0	0	17	0	0
19	43126140	.	C	T	13	13	26	0	0	26	0	0
19	43129049	.	G	T	0	12	12	0	15	27	0	0
19	43129076	.	A	G	13	16	29	0	3	32	0	0
19	43133087	.	A	G	12	15	27	0	1	28	0	0
19	43357197	.	C	A	1	3	4	0	2	6	0	0
19	43491305	.	C	T	2	1	3	0	0	3	0	0
19	43491350	.	A	G	2	3	5	0	0	5	0	0
19	43491739	.	T	A	6	4	10	0	2	12	0	0
19	43491972	.	C	A	2	3	5	0	0	5	0	0
19	43492136	.	G	A	4	3	7	0	1	8	0	0
19	43492175	.	A	G	7	5	12	0	1	13	0	0
19	43492280	.	T	C	2	5	7	0	0	7	0	0
19	43492361	.	G	A	0	4	4	0	5	9	0	0
19	43492363	.	T	A	3	5	8	0	1	9	0	0
19	43492439	.	G	A	1	2	3	0	1	4	0	0
19	43492955	.	T	C	5	7	12	0	1	13	0	0
19	43493300	.	G	A	3	3	6	0	0	6	0	0
19	43493372	.	G	A	4	5	9	0	0	9	0	0
19	43493514	.	G	A	6	6	12	0	0	12	0	0
19	43494040	.	A	C	4	13	17	0	1	18	0	0
19	43494128	.	G	A	0	6	6	0	9	15	0	0
19	43494452	.	G	T	2	3	5	0	1	6	0	0
19	43494456	.	G	C	2	3	5	0	0	5	0	0
19	43494700	.	C	T	10	13	23	0	0	23	0	0
19	43494911	.	C	T	12	14	26	0	0	26	0	0
19	43495376	.	G	A	0	9	9	0	11	20	0	0
19	43498940	.	A	G	13	14	27	0	0	27	0	0
19	43499311	.	C	T	15	11	26	0	0	26	0	0
19	43499616	.	T	C	15	18	33	0	0	33	0	0
19	43499930	.	G	T	9	15	24	0	3	27	0	0
19	43499942	.	A	T	8	16	24	0	0	24	0	0
19	43500163	.	C	T	3	3	6	0	0	6	0	0
19	43508028	.	T	C	1	0	1	0	3	4	0	0
19	43542602	.	G	A	1	4	5	0	1	6	0	0
19	43542758	.	A	C	0	2	2	0	0	2	0	0
19	43542848	.	T	A	3	3	6	0	0	6	0	0
19	43542863	.	T	A	3	2	5	0	1	6	0	0
19	43547605	.	T	C	12	12	24	0	0	24	0	0
19	43547685	.	A	T	6	3	9	0	0	9	0	0
19	43547843	.	T	G	3	6	9	0	0	9	0	0
19	43548910	.	T	A	9	10	19	0	0	19	0	0
19	43549200	.	C	T	1	19	20	0	17	37	0	0
19	43549215	.	T	C	20	13	33	0	1	34	0	0
19	43549305	.	A	G	23	7	30	0	3	33	0	0
19	43549554	.	C	T	7	7	14	0	0	14	0	0
19	43549622	.	A	G	10	4	14	0	0	14	0	0
19	43549860	.	G	T	3	7	10	0	0	10	0	0
19	43552135	.	C	T	4	5	9	0	0	9	0	0
19	43552189	.	C	A	0	8	8	0	9	17	0	0
19	43552223	.	G	C	7	8	15	0	0	15	0	0
19	43681225	.	C	T	1	1	2	0	0	2	0	0
19	43681270	.	C	T	2	3	5	0	1	6	0	0
19	43681375	.	G	A	2	5	7	0	0	7	0	0
19	43681496	.	G	A	0	1	1	0	0	1	0	0
19	43684392	.	C	A	0	1	1	0	0	1	0	0
19	43688667	.	G	A	0	1	1	0	0	1	0	0
19	43688727	.	C	T	4	0	4	0	0	4	0	0
19	43693709	.	C	A	3	2	5	0	0	5	0	0
19	43693915	.	C	T	3	3	6	0	0	6	0	0
19	43696851	.	T	C	1	3	4	0	0	4	0	0
19	43696953	.	G	A	1	2	3	0	0	3	0	0
19	43697424	.	G	C	3	5	8	0	0	8	0	0
19	43697484	.	T	C	2	3	5	0	0	5	0	0
19	43699765	.	T	A	0	2	2	0	0	2	0	0
19	43704324	.	G	A	2	1	3	0	0	3	0	0
19	43704744	.	C	T	4	2	6	0	0	6	0	0
19	43706681	.	T	C	8	10	18	0	1	19	0	0
19	43706684	.	C	T	8	10	18	0	0	18	0	0
19	43706736	.	G	A	0	5	5	0	13	18	0	0
19	43706808	.	G	C	8	9	17	0	1	18	0	0
19	43706848	.	T	C	5	7	12	0	0	12	0	0
19	43706909	.	C	G	8	6	14	0	0	14	0	0
19	43706921	.	G	T	8	3	11	0	0	11	0	0
19	43706990	.	A	T	1	3	4	0	0	4	0	0
19	43707256	.	T	A	3	3	6	0	0	6	0	0
19	43707261	.	A	T	3	3	6	0	0	6	0	0
19	43725304	.	C	T	2	3	5	0	0	5	0	0
19	43736765	.	G	A	0	3	3	0	2	5	0	0
19	43738237	.	C	T	13	14	27	0	0	27	0	0
19	43740988	.	A	C	25	12	37	0	1	38	0	0
19	43748671	.	A	C	5	3	8	0	0	8	0	0
19	43748672	.	G	C	5	3	8	0	0	8	0	0
19	43750020	.	T	C	0	0	0	0	6	6	0	0
19	43750085	.	A	G	5	1	6	0	1	7	0	0
19	43782397	.	G	T	33	27	60	0	6	66	0	0
19	43783581	.	C	T	11	16	27	0	0	27	0	0
19	43825877	.	G	T	1	2	3	0	1	4	0	0
19	43831544	.	G	A	3	3	6	0	0	6	0	0
19	43831701	.	C	T	12	7	19	0	1	20	0	0
19	43878258	.	C	T	0	1	1	0	0	1	0	0
19	43880674	.	C	T	1	1	2	0	0	2	0	0
19	43891949	.	C	T	5	4	9	0	0	9	0	0
19	43898915	.	C	A	10	12	22	0	1	23	0	0
19	43899208	.	T	A	8	7	15	0	2	17	0	0
19	43899451	.	A	T	16	10	26	0	2	28	0	0
19	43899721	.	G	T	3	3	6	0	0	6	0	0
19	43899851	.	A	G	7	10	17	0	4	21	0	0
19	43899891	.	G	A	5	4	9	0	0	9	0	0
19	43899936	.	G	A	1	5	6	0	0	6	0	0
19	43900013	.	A	G	5	3	8	0	1	9	0	0
19	43900453	.	C	A	13	6	19	0	0	20	1	0
19	43900470	.	C	T	4	7	11	0	1	12	0	0
19	43900568	.	G	A	10	10	20	0	0	20	0	0
19	43900585	.	A	T	10	13	23	0	1	24	0	0
19	43900630	.	C	T	18	11	29	0	2	31	0	0
19	43900896	.	C	T	13	11	24	0	0	24	0	0
19	43900995	.	A	G	14	8	22	0	0	22	0	0
19	43901028	.	A	G	11	3	14	0	0	14	0	0
19	43901305	.	A	C	17	13	30	0	0	30	0	0
19	43960093	.	G	T	1	2	3	0	0	3	0	0
19	43960094	.	A	T	1	2	3	0	0	3	0	0
19	43971171	.	T	C	1	2	3	0	1	4	0	0
19	43974224	.	A	T	7	7	14	0	0	14	0	0
19	43976249	.	G	A	9	4	13	0	0	13	0	0
19	43976286	.	C	T	6	4	10	0	0	10	0	0
19	44036459	.	C	T	4	2	6	0	0	6	0	0
19	44036656	.	A	T	1	2	3	0	1	4	0	0
19	44049755	.	G	A	24	16	40	0	1	41	0	0
19	44052585	.	A	C	26	26	52	0	0	52	0	0
19	44052588	.	A	G	26	20	46	0	3	49	0	0
19	44054457	.	C	T	3	4	7	0	1	8	0	0
19	44062448	.	G	A	0	1	1	0	0	1	0	0
19	44063620	.	T	C	4	4	8	0	0	8	0	0
19	44063765	.	G	T	0	1	1	0	0	1	0	0
19	44063766	.	T	G	0	1	1	0	0	1	0	0
19	44065516	.	A	C	1	0	1	0	0	1	0	0
19	44068272	.	G	A	26	10	36	0	0	36	0	0
19	44068292	.	A	G	29	4	33	0	0	33	0	0
19	44068328	.	G	A	16	9	25	0	0	25	0	0
19	44068378	.	C	A	11	21	32	0	4	36	0	0
19	44068543	.	G	A	23	13	36	0	1	37	0	0
19	45856213	.	T	C	5	5	10	0	0	10	0	0
19	45856414	.	A	G	15	18	33	0	1	34	0	0
19	45859824	.	C	T	10	10	20	0	0	20	0	0
19	45896193	.	C	T	7	16	23	0	3	26	0	0
19	45965617	.	A	G	1	0	1	0	1	2	0	0
19	45967297	.	C	G	6	0	6	0	6	12	0	0
19	45967372	.	G	A	9	10	19	0	1	20	0	0
19	45979394	.	A	G	3	2	5	0	0	5	0	0
19	45980423	.	T	A	4	3	7	0	0	7	0	0
19	45980428	.	A	C	4	3	7	0	0	7	0	0
19	45994212	.	A	G	7	3	10	0	1	11	0	0
19	45994263	.	T	C	2	0	2	0	1	3	0	0
19	45997919	.	T	A	1	2	3	0	1	4	0	0
19	45997964	.	A	G	4	4	8	0	0	8	0	0
19	45999081	.	G	A	2	0	2	0	0	2	0	0
19	46006195	.	G	A	0	1	1	0	0	1	0	0
19	46007595	.	A	G	0	1	1	0	0	1	0	0
19	46007631	.	A	G	2	1	3	0	0	3	0	0
19	46007639	.	A	G	2	2	4	0	0	4	0	0
19	46014424	.	G	A	0	1	1	0	0	1	0	0
19	46014993	.	A	T	2	2	4	0	0	4	0	0
19	46015027	.	C	T	0	2	2	0	3	5	0	0
19	46020177	.	A	C	8	0	8	0	9	17	0	0
19	46020228	.	G	A	12	10	22	0	4	26	0	0
19	46020276	.	C	T	0	13	13	0	9	22	0	0
19	46020462	.	G	A	15	14	29	0	0	29	0	0
19	46020471	.	G	T	14	14	28	0	0	28	0	0
19	46020544	.	G	C	4	0	4	0	6	10	0	0
19	46022418	.	A	G	4	5	9	0	0	9	0	0
19	46028151	.	T	A	10	14	24	0	0	24	0	0
19	46032475	.	A	G	7	5	12	0	0	12	0	0
19	46032485	.	G	T	6	5	11	0	0	11	0	0
19	46032527	.	G	T	5	6	11	0	0	11	0	0
19	46032947	.	A	G	3	5	8	0	0	8	0	0
19	46033012	.	C	T	1	5	6	0	0	6	0	0
19	46049311	.	C	T	3	3	6	0	0	6	0	0
19	46202060	.	T	C	3	5	8	0	1	9	0	0
19	46202110	.	G	A	1	2	3	0	0	3	0	0
19	46209433	.	G	A	0	2	2	0	1	3	0	0
19	46209516	.	T	A	4	3	7	0	0	7	0	0
19	46209522	.	A	T	3	3	6	0	0	6	0	0
19	46210054	.	T	G	4	2	6	0	0	6	0	0
19	46210120	.	G	T	4	2	6	0	0	6	0	0
19	46210209	.	A	T	7	6	13	0	0	13	0	0
19	46210242	.	G	C	6	9	15	0	0	15	0	0
19	46210286	.	A	G	1	6	7	0	0	7	0	0
19	46210354	.	A	T	2	3	5	0	1	6	0	0
19	46210355	.	T	G	3	3	6	0	0	6	0	0
19	46210412	.	T	A	0	3	3	0	0	3	0	0
19	46225972	.	G	A	1	2	3	0	0	3	0	0
19	46237787	.	C	T	9	19	28	0	1	29	0	0
19	46237794	.	A	T	7	20	27	0	4	31	0	0
19	46237844	.	G	T	1	15	16	0	14	30	0	0
19	46238199	.	G	A	0	9	9	0	6	15	0	0
19	46238227	.	T	C	7	11	18	0	0	18	0	0
19	46238366	.	T	C	3	3	6	0	0	6	0	0
19	46238382	.	G	A	0	3	3	0	4	7	0	0
19	46253556	.	T	C	1	0	1	0	0	1	0	0
19	46255532	.	G	C	0	2	2	0	0	2	0	0
19	46259649	.	A	G	15	9	24	0	0	24	0	0
19	46259660	.	A	T	16	10	26	0	0	26	0	0
19	46259709	.	G	A	0	4	4	0	7	11	0	0
19	46280672	.	G	T	1	12	13	0	11	24	0	0
19	46280861	.	G	A	0	9	9	0	9	18	0	0
19	46288632	.	T	C	17	10	27	0	0	27	0	0
19	46303140	.	C	T	21	31	52	0	3	55	0	0
19	46303320	.	G	A	16	14	30	0	1	31	0	0
19	46303330	.	G	A	0	16	16	0	17	33	0	0
19	46303414	.	C	T	33	18	51	0	0	51	0	0
19	46303457	.	A	T	28	24	52	0	3	55	0	0
19	46309664	.	C	A	3	5	8	0	1	9	0	0
19	46309686	.	A	G	1	0	1	0	2	3	0	0
19	46309787	.	G	A	2	4	6	0	0	6	0	0
19	46332910	.	G	A	0	5	5	0	6	11	0	0
19	46333761	.	A	C	3	6	9	0	0	9	0	0
19	46373704	.	T	G	6	7	13	0	0	13	0	0
19	46373705	.	G	T	6	7	13	0	0	13	0	0
19	47405935	.	C	T	10	17	27	0	3	30	0	0
19	47405946	.	G	T	11	19	30	0	1	31	0	0
19	47423600	.	T	C	5	4	9	0	2	11	0	0
19	47431220	.	C	T	4	4	8	0	0	8	0	0
19	47431230	.	G	A	4	1	5	0	0	5	0	0
19	47431333	.	G	A	8	5	13	0	1	14	0	0
19	47431459	.	C	T	12	5	17	0	3	20	0	0
19	47431501	.	C	T	0	6	6	0	11	17	0	0
19	47431510	.	A	G	7	4	11	0	0	11	0	0
19	47434142	.	T	C	10	0	10	0	10	20	0	0
19	47438149	.	C	G	4	5	9	0	0	9	0	0
19	47448486	.	G	A	0	1	1	0	0	1	0	0
19	47452971	.	A	C	2	0	2	0	5	7	0	0
19	47465387	.	C	A	0	1	1	0	3	4	0	0
19	47465577	.	A	G	1	0	1	0	0	1	0	0
19	47465652	.	C	T	4	6	10	0	0	10	0	0
19	47465745	.	A	G	4	2	6	0	0	6	0	0
19	47465754	.	A	G	4	2	6	0	0	6	0	0
19	47467729	.	A	C	2	2	4	0	1	5	0	0
19	47467792	.	A	G	2	2	4	0	0	4	0	0
19	47467988	.	A	G	1	2	3	0	0	3	0	0
19	47468013	.	T	A	1	0	1	0	0	1	0	0
19	47471680	.	G	T	4	2	6	0	0	6	0	0
19	47471886	.	A	C	1	3	4	0	0	4	0	0
19	47478108	.	G	A	6	7	13	0	0	13	0	0
19	47478140	.	G	A	6	5	11	0	0	11	0	0
19	47478161	.	C	T	4	3	7	0	1	8	0	0
19	47478842	.	C	T	6	3	9	0	0	9	0	0
19	47479051	.	G	T	2	2	4	0	0	4	0	0
19	47479084	.	A	G	2	2	4	0	0	4	0	0
19	47481235	.	C	T	1	4	5	0	0	5	0	0
19	47481276	.	T	G	4	5	9	0	0	9	0	0
19	47481393	.	A	T	2	3	5	0	0	5	0	0
19	47481435	.	C	A	3	3	6	0	0	6	0	0
19	47481449	.	T	C	2	2	4	0	0	4	0	0
19	47481484	.	T	G	1	3	4	0	0	4	0	0
19	47784172	.	C	T	6	2	8	0	1	9	0	0
19	47800607	.	T	C	5	0	5	0	16	22	1	0
19	47800673	.	A	C	11	14	25	0	2	27	0	0
19	47802932	.	A	G	6	12	18	0	2	20	0	0
19	47807819	.	C	T	0	6	6	0	7	13	0	0
19	47807855	.	G	A	11	13	24	0	1	25	0	0
19	47808044	.	A	G	6	4	10	0	0	10	0	0
19	47811955	.	A	G	5	2	7	0	0	7	0	0
19	47819698	.	G	A	8	2	10	0	0	10	0	0
19	47820986	.	G	A	4	7	11	0	0	11	0	0
19	47821025	.	A	G	3	3	6	0	0	6	0	0
19	47910483	.	A	T	1	2	3	0	0	3	0	0
19	47910488	.	C	T	1	2	3	0	0	3	0	0
19	47976325	.	C	T	20	25	45	0	3	48	0	0
19	47982897	.	A	G	17	17	34	0	1	35	0	0
19	47983014	.	C	G	7	9	16	0	0	16	0	0
19	47983859	.	G	A	3	4	7	0	1	8	0	0
19	47984483	.	C	T	8	3	11	0	0	11	0	0
19	47986324	.	C	T	0	17	17	0	14	31	0	0
19	48013142	.	G	A	6	9	15	0	1	16	0	0
19	48013172	.	A	G	9	11	20	0	0	20	0	0
19	48014266	.	A	G	6	5	11	0	0	11	0	0
19	48018005	.	C	A	2	2	4	0	0	4	0	0
19	48018336	.	T	C	5	2	7	0	2	9	0	0
19	48018554	.	A	G	2	1	3	0	0	3	0	0
19	48018561	.	C	A	2	1	3	0	1	4	0	0
19	48022023	.	G	A	0	1	1	0	0	1	0	0
19	48022989	.	T	G	15	14	29	0	0	29	0	0
19	48023309	.	A	G	24	1	25	0	25	50	0	0
19	48031094	.	T	C	4	5	9	0	0	9	0	0
19	48032167	.	G	A	0	2	2	0	5	7	0	0
19	48033631	.	A	G	8	8	16	0	0	16	0	0
19	48036809	.	T	G	18	1	19	0	24	43	0	0
19	48049279	.	T	G	12	8	20	0	1	21	0	0
19	48050029	.	G	A	0	10	10	0	1	11	0	0
19	48053315	.	A	C	17	11	28	0	3	31	0	0
19	48065272	.	G	A	0	2	2	0	2	4	0	0
19	48065455	.	G	A	0	5	5	0	2	7	0	0
19	48069366	.	T	C	9	6	15	0	0	15	0	0
19	48102652	.	C	T	8	1	9	0	0	9	0	0
19	48119203	.	T	C	9	6	15	2	0	17	0	0
19	48120238	.	A	G	13	0	13	0	10	23	0	0
19	48251308	.	T	C	1	5	6	0	0	6	0	0
19	48269841	.	T	C	0	1	1	0	0	1	0	0
19	48284234	.	A	T	2	3	5	0	0	5	0	0
19	48364454	.	T	A	1	4	5	0	1	6	0	0
19	48364713	.	T	A	1	6	7	0	0	7	0	0
19	48364835	.	T	A	3	15	18	0	0	18	0	0
19	48364848	.	C	T	0	16	16	0	4	20	0	0
19	48364870	.	T	C	5	20	25	0	1	26	0	0
19	48407241	.	T	C	1	2	3	0	0	3	0	0
2	71743	.	A	G	0	4	4	0	0	4	0	0
2	114825	.	G	A	0	3	3	0	0	3	0	0
2	177241	.	G	T	20	0	20	0	1	21	0	0
2	177243	.	G	C	21	0	21	0	0	21	0	0
2	281634	.	A	G	5	3	8	0	0	8	0	0
2	281639	.	A	G	8	0	8	0	3	11	0	0
2	374634	.	T	C	5	2	7	0	0	7	0	0
2	1213640	.	C	T	2	2	4	0	0	4	0	0
2	1220802	.	T	C	0	3	3	0	0	3	0	0
2	1453259	.	G	A	1	0	1	0	0	1	0	0
2	1463612	.	A	C	1	0	1	0	3	4	0	0
2	1466829	.	G	A	2	1	3	0	0	3	0	0
2	1527682	.	C	G	2	5	7	0	1	8	0	0
2	1527828	.	T	C	4	0	4	0	4	8	0	0
2	1529602	.	G	C	0	0	0	0	2	2	0	0
2	1540611	.	A	C	0	0	0	0	2	2	0	0
2	1543191	.	A	G	4	2	6	0	0	6	0	0
2	1548430	.	T	A	6	3	9	0	0	9	0	0
2	1548470	.	A	C	6	0	6	0	4	10	0	0
2	1595187	.	C	T	9	9	18	0	0	18	0	0
2	1595275	.	T	C	6	22	28	0	1	29	0	0
2	1595330	.	A	G	11	1	12	0	1	13	0	0
2	1595334	.	G	A	11	0	11	0	2	13	0	0
2	1595582	.	C	T	0	10	10	0	14	24	0	0
2	1595601	.	A	G	16	7	23	0	1	24	0	0
2	1595696	.	A	G	3	8	11	0	1	12	0	0
2	1595744	.	T	C	10	4	14	0	0	14	0	0
2	1595897	.	T	C	9	5	14	0	0	14	0	0
2	1595914	.	T	C	2	9	11	0	3	14	0	0
2	1595945	.	G	C	9	10	19	0	0	19	0	0
2	1596159	.	C	T	1	4	5	0	7	12	0	0
2	1596165	.	T	C	5	4	9	0	2	11	0	0
2	1596196	.	T	A	10	4	14	0	2	16	0	0
2	1596282	.	G	T	9	6	15	0	0	15	0	0
2	1596325	.	C	A	0	4	4	0	11	15	0	0
2	1596327	.	C	T	0	4	4	0	11	15	0	0
2	1596424	.	T	A	16	8	24	0	0	24	0	0
2	1596671	.	C	T	3	2	5	0	3	8	0	0
2	1596690	.	T	C	4	3	7	0	1	8	0	0
2	1596830	.	C	T	0	4	4	0	4	8	0	0
2	1596908	.	A	T	2	8	10	0	0	10	0	0
2	1597048	.	C	T	9	2	11	0	1	12	0	0
2	1597054	.	A	G	9	3	12	0	0	12	0	0
2	1597084	.	G	A	10	6	16	0	0	16	0	0
2	1597096	.	G	A	9	7	16	0	1	17	0	0
2	1597226	.	G	A	3	2	5	0	0	5	0	0
2	1597355	.	T	C	8	4	12	0	2	14	0	0
2	1597396	.	A	C	6	9	15	0	1	16	0	0
2	1597413	.	T	C	4	10	14	0	1	15	0	0
2	1597534	.	T	C	4	0	4	0	7	11	0	0
2	1597588	.	A	G	4	3	7	0	0	7	0	0
2	1597617	.	T	C	4	5	9	0	1	10	0	0
2	1597634	.	T	A	4	5	9	0	0	9	0	0
2	1597658	.	C	T	0	5	5	0	6	11	0	0
2	1597691	.	T	C	9	2	11	0	1	12	0	0
2	1598065	.	A	G	2	3	5	0	0	5	0	0
2	1598115	.	C	A	5	5	10	0	1	11	0	0
2	1598124	.	G	A	7	5	12	0	0	12	0	0
2	1598533	.	A	C	7	0	7	0	8	15	0	0
2	1602477	.	C	T	0	1	1	0	0	1	0	0
2	1759608	.	G	T	0	2	2	0	0	2	0	0
2	1868115	.	T	C	0	4	4	0	0	4	0	0
2	1941054	.	G	A	2	2	4	0	0	4	0	0
2	1942812	.	C	T	6	3	9	0	0	9	0	0
2	1943037	.	A	G	6	0	6	0	9	15	0	0
2	1989937	.	A	C	1	1	2	0	0	2	0	0
2	2005807	.	T	C	2	2	4	0	1	5	0	0
2	2005836	.	T	A	3	3	6	0	1	7	0	0
2	2005844	.	C	A	3	5	8	0	0	8	0	0
2	2005892	.	T	C	1	2	3	0	0	3	0	0
2	2010287	.	A	C	11	5	16	0	1	17	0	0
2	2010288	.	T	A	11	4	15	0	2	17	0	0
2	2010765	.	T	C	32	0	32	0	25	57	0	0
2	2010945	.	G	C	18	25	43	0	0	43	0	0
2	2011287	.	T	A	23	16	39	0	1	41	1	0
2	2013834	.	C	T	0	8	8	0	12	20	0	0
2	2017450	.	T	C	4	5	9	0	2	11	0	0
2	2024876	.	A	G	3	6	9	0	0	9	0	0
2	2025044	.	A	G	4	9	13	0	0	13	0	0
2	2025080	.	T	C	4	9	13	0	0	13	0	0
2	2025175	.	C	A	7	11	18	0	3	21	0	0
2	2025219	.	G	T	10	7	17	0	0	17	0	0
2	2025302	.	T	C	1	8	9	0	0	9	0	0
2	2025617	.	A	G	6	6	12	0	1	13	0	0
2	2026068	.	G	A	6	3	9	0	0	9	0	0
2	2026164	.	G	A	0	2	2	0	0	2	0	0
2	2026178	.	G	A	0	3	3	0	0	3	0	0
2	2026218	.	G	A	1	5	6	0	0	6	0	0
2	2026397	.	T	C	8	6	14	0	2	16	0	0
2	2026475	.	G	T	6	6	12	0	2	14	0	0
2	2045780	.	T	C	1	0	1	0	1	2	0	0
2	2047189	.	G	A	1	1	2	0	0	2	0	0
2	2095574	.	G	C	2	2	4	0	0	4	0	0
2	2161758	.	C	T	1	1	2	0	1	3	0	0
2	2168642	.	T	A	4	3	7	0	0	7	0	0
2	2169353	.	T	C	3	3	6	0	0	6	0	0
2	2172878	.	G	A	0	16	16	0	17	33	0	0
2	2172879	.	T	A	16	16	32	0	1	33	0	0
2	2173317	.	A	T	27	19	46	0	0	46	0	0
2	2248991	.	C	A	4	2	6	0	0	6	0	0
2	2248993	.	C	T	2	4	6	0	0	6	0	0
2	2251501	.	C	T	3	10	13	0	0	13	0	0
2	2256216	.	T	C	1	3	4	0	0	4	0	0
2	2256372	.	C	G	5	4	9	0	0	9	0	0
2	2256375	.	C	T	4	5	9	0	0	9	0	0
2	2256424	.	T	C	1	4	5	0	0	5	0	0
2	2630212	.	A	G	18	13	31	2	0	33	0	0
2	2633731	.	G	A	2	2	4	0	0	4	0	0
2	2638528	.	C	T	0	3	3	0	2	5	0	0
2	2737855	.	T	C	1	3	4	0	0	4	0	0
2	2781099	.	T	C	1	1	2	0	0	2	0	0
2	2785378	.	C	T	3	9	12	0	0	12	0	0
2	2786198	.	T	A	2	1	3	0	0	3	0	0
2	2791168	.	C	T	0	9	9	0	10	19	0	0
2	2795564	.	C	T	1	5	6	0	0	6	0	0
2	2805882	.	T	C	0	0	0	0	2	2	0	0
2	2849616	.	C	T	1	1	2	0	0	2	0	0
2	2857400	.	T	C	1	1	2	0	0	2	0	0
2	2869590	.	A	G	1	1	2	0	0	2	0	0
2	2872180	.	G	T	0	1	1	0	2	3	0	0
2	2872550	.	G	A	2	4	6	0	0	6	0	0
2	2872565	.	A	G	4	6	10	0	0	10	0	0
2	2873531	.	A	G	4	0	4	0	5	9	0	0
2	2873546	.	G	A	4	5	9	0	0	9	0	0
2	2873579	.	T	A	1	3	4	0	0	4	0	0
2	2892531	.	A	G	6	12	18	0	0	18	0	0
2	2894098	.	A	T	10	8	18	0	2	20	0	0
2	2900553	.	A	T	2	1	3	0	0	3	0	0
2	2905776	.	G	A	4	1	5	0	0	5	0	0
2	2905996	.	T	C	4	7	11	0	0	11	0	0
2	2908617	.	A	G	7	0	7	0	7	14	0	0
2	2911892	.	A	T	1	1	2	0	0	2	0	0
2	2913151	.	C	T	5	6	11	0	0	11	0	0
2	2913161	.	G	A	8	8	16	0	0	16	0	0
2	2916697	.	T	C	1	4	5	0	0	5	0	0
2	2917105	.	T	C	13	11	24	0	0	24	0	0
2	2967361	.	A	C	1	4	5	0	0	5	0	0
2	2967440	.	T	G	3	2	5	0	0	5	0	0
2	2967453	.	C	T	3	2	5	0	0	5	0	0
2	2975272	.	G	A	0	3	3	0	0	3	0	0
2	2977237	.	C	A	1	6	7	0	0	7	0	0
2	2987062	.	G	A	5	4	9	0	1	10	0	0
2	2987488	.	A	C	6	7	13	0	2	15	0	0
2	2988626	.	A	C	1	4	5	0	0	5	0	0
2	3001340	.	G	T	1	2	3	0	0	3	0	0
2	3014242	.	G	C	1	2	3	0	0	3	0	0
2	3014326	.	G	A	2	1	3	0	0	3	0	0
2	3015951	.	T	C	1	3	4	0	0	4	0	0
2	3015975	.	T	C	0	1	1	0	0	1	0	0
2	3020186	.	G	T	5	2	7	0	0	7	0	0
2	3022253	.	G	A	0	3	3	0	2	5	0	0
2	3022607	.	A	T	1	2	3	0	1	4	0	0
2	3026997	.	T	C	9	7	16	0	3	19	0	0
2	3027200	.	T	A	20	13	33	0	2	35	0	0
2	3027286	.	G	A	11	10	21	0	2	23	0	0
2	3027383	.	C	T	10	7	17	0	2	19	0	0
2	3027504	.	C	T	18	6	24	0	2	26	0	0
2	3027704	.	C	G	16	14	30	0	2	32	0	0
2	3027765	.	G	T	8	12	20	0	5	25	0	0
2	3027804	.	C	T	2	10	12	0	13	26	1	0
2	3027859	.	T	C	17	2	19	0	11	30	0	0
2	3027862	.	A	G	17	11	28	0	1	29	0	0
2	3027928	.	T	C	5	8	13	0	0	13	0	0
2	3028117	.	A	G	13	13	26	0	0	26	0	0
2	3028156	.	G	T	17	13	30	0	0	30	0	0
2	3028203	.	T	C	21	14	35	0	2	37	0	0
2	3028233	.	C	T	14	13	27	0	0	27	0	0
2	3028270	.	A	T	10	9	19	0	2	21	0	0
2	3028312	.	T	G	10	9	19	0	2	21	0	0
2	3028463	.	G	A	6	7	13	0	0	13	0	0
2	3028558	.	T	C	5	6	11	0	3	14	0	0
2	3028605	.	G	A	7	10	17	0	2	19	0	0
2	3028893	.	A	G	5	4	9	0	0	9	0	0
2	3028908	.	A	T	3	4	7	0	0	7	0	0
2	3029383	.	T	A	6	10	16	0	3	19	0	0
2	3029437	.	T	C	12	0	12	0	12	24	0	0
2	3032707	.	G	A	11	9	20	0	1	21	0	0
2	3032944	.	C	T	1	3	4	0	2	6	0	0
2	3034819	.	G	A	8	1	9	0	0	9	0	0
2	3045272	.	C	G	8	6	14	0	1	15	0	0
2	3056588	.	A	G	2	1	3	0	0	3	0	0
2	3056627	.	A	G	3	3	6	0	0	6	0	0
2	3056663	.	A	C	1	2	3	0	0	3	0	0
2	3061015	.	A	C	0	0	0	0	9	9	0	0
2	3061083	.	G	A	2	2	4	0	0	4	0	0
2	3061208	.	T	C	1	3	4	0	0	4	0	0
2	3062181	.	T	G	4	5	9	0	0	9	0	0
2	3062464	.	C	A	6	3	9	0	2	11	0	0
2	3062738	.	T	A	1	2	3	0	1	4	0	0
2	3063463	.	C	T	1	2	3	0	0	3	0	0
2	3064268	.	T	C	1	2	3	0	0	3	0	0
2	3064922	.	A	G	8	6	14	0	0	14	0	0
2	3064984	.	C	G	6	4	10	0	0	10	0	0
2	3064991	.	T	C	6	4	10	0	1	11	0	0
2	3065248	.	C	T	4	7	11	0	0	11	0	0
2	3065428	.	C	T	5	3	8	0	0	8	0	0
2	3065451	.	C	T	5	3	8	0	2	10	0	0
2	3065474	.	C	G	3	4	7	0	0	7	0	0
2	3065507	.	C	T	5	3	8	0	1	9	0	0
2	3065563	.	G	A	4	5	9	0	0	9	0	0
2	3065581	.	A	T	3	5	8	0	0	8	0	0
2	3065633	.	A	T	1	3	4	0	0	4	0	0
2	3066074	.	T	A	4	2	6	0	0	6	0	0
2	3066075	.	C	T	4	2	6	0	0	6	0	0
2	3066860	.	A	T	1	1	2	0	0	2	0	0
2	3067118	.	C	A	0	3	3	0	0	3	0	0
2	3067132	.	T	C	0	0	0	0	4	4	0	0
2	4045522	.	C	A	0	5	5	0	0	5	0	0
2	4045547	.	A	T	0	4	4	0	0	4	0	0
2	4729279	.	A	T	3	4	7	0	1	8	0	0
2	4729329	.	G	A	5	5	10	0	0	10	0	0
2	4729340	.	G	A	7	5	12	0	0	12	0	0
2	4729554	.	A	G	12	7	19	0	0	19	0	0
2	4729682	.	A	T	5	11	16	0	0	16	0	0
2	4729757	.	A	G	4	2	6	0	0	6	0	0
2	4729798	.	A	T	4	4	8	0	0	8	0	0
2	4729857	.	G	T	0	8	8	0	0	8	0	0
2	4730051	.	T	C	2	2	4	0	0	4	0	0
2	4735995	.	G	A	1	2	3	0	0	3	0	0
2	4736978	.	G	A	7	5	12	0	2	14	0	0
2	4737177	.	C	G	6	6	12	0	0	12	0	0
2	4737217	.	G	T	3	5	8	0	0	8	0	0
2	4737427	.	C	T	0	5	5	0	3	8	0	0
2	4737524	.	T	A	4	2	6	0	0	6	0	0
2	4737607	.	G	A	4	2	6	0	0	6	0	0
2	4900650	.	T	C	28	11	39	0	6	45	0	0
2	4900688	.	A	C	21	15	36	0	0	36	0	0
2	4900798	.	T	C	8	22	30	0	0	30	0	0
2	4903760	.	G	A	0	3	3	0	0	3	0	0
2	4907857	.	C	T	1	4	5	0	0	5	0	0
2	4930730	.	T	C	9	6	15	0	0	15	0	0
2	4948832	.	A	G	9	4	13	0	0	13	0	0
2	4948850	.	G	A	8	4	12	0	0	12	0	0
2	4950607	.	C	T	3	2	5	0	1	6	0	0
2	4995045	.	C	G	5	5	10	0	0	10	0	0
2	4995084	.	C	T	0	4	4	0	3	7	0	0
2	5014631	.	A	C	8	5	13	0	0	13	0	0
2	5407517	.	A	G	3	7	10	0	1	11	0	0
2	5407534	.	A	G	1	0	1	0	9	10	0	0
2	5480576	.	C	T	2	5	7	0	0	7	0	0
2	5480620	.	T	C	2	3	5	0	0	5	0	0
2	5480710	.	A	G	4	4	8	0	1	9	0	0
2	5480733	.	C	T	1	7	8	0	0	8	0	0
2	5481067	.	G	A	9	5	14	0	0	14	0	0
2	5482157	.	G	A	1	5	6	0	0	6	0	0
2	5482175	.	A	G	0	6	6	0	0	6	0	0
2	5513223	.	T	A	0	1	1	0	0	1	0	0
2	5544076	.	T	C	3	0	3	0	4	7	0	0
2	5544261	.	C	G	1	4	5	0	0	5	0	0
2	5546933	.	T	C	2	0	2	0	0	2	0	0
2	5552875	.	C	T	2	2	4	0	0	4	0	0
2	5555349	.	C	A	0	2	2	0	0	2	0	0
2	5555407	.	C	G	3	2	5	0	0	5	0	0
2	5577647	.	A	G	1	0	1	0	3	4	0	0
2	5578745	.	C	T	5	10	15	0	0	15	0	0
2	5578772	.	C	T	3	12	15	0	0	15	0	0
2	5578820	.	T	A	6	11	17	0	0	17	0	0
2	5578872	.	A	G	7	0	7	0	6	13	0	0
2	5578936	.	A	T	5	8	13	0	0	13	0	0
2	5579111	.	A	G	3	6	9	0	0	9	0	0
2	5579120	.	G	A	0	5	5	0	3	8	0	0
2	5579246	.	A	G	6	5	11	0	0	11	0	0
2	5579276	.	T	C	2	4	6	0	0	6	0	0
2	5579320	.	T	A	3	2	5	1	0	6	0	0
2	5579325	.	T	C	3	2	5	1	0	6	0	0
2	5579415	.	G	A	5	6	11	1	0	12	0	0
2	5579721	.	G	A	3	5	8	0	1	9	0	0
2	5580140	.	G	A	5	5	10	1	1	12	0	0
2	5580249	.	A	G	3	5	8	0	0	8	0	0
2	5580267	.	T	G	2	4	6	0	1	7	0	0
2	5580439	.	T	C	14	9	23	0	0	23	0	0
2	5580510	.	C	T	10	3	13	0	0	13	0	0
2	5580544	.	A	G	12	9	21	1	1	23	0	0
2	5580592	.	C	T	19	11	30	0	1	31	0	0
2	5580644	.	A	G	10	0	10	0	11	21	0	0
2	5580887	.	G	T	3	5	8	0	1	9	0	0
2	5580918	.	C	T	5	2	7	0	0	7	0	0
2	5581063	.	G	A	0	5	5	0	5	10	0	0
2	5581073	.	A	G	5	3	8	0	0	8	0	0
2	5581233	.	C	T	7	15	22	0	0	22	0	0
2	5581234	.	G	T	0	12	12	0	10	22	0	0
2	5581482	.	T	A	10	11	21	0	1	22	0	0
2	5581612	.	A	G	6	9	15	0	3	18	0	0
2	5581660	.	T	A	7	10	17	0	0	17	0	0
2	5601282	.	A	T	3	4	7	0	2	9	0	0
2	5621176	.	A	T	10	8	18	0	1	19	0	0
2	5621360	.	C	T	8	12	20	0	1	21	0	0
2	5621394	.	A	C	9	11	20	0	3	23	0	0
2	5644548	.	C	T	3	4	7	0	0	7	0	0
2	5677650	.	C	T	13	16	29	0	0	29	0	0
2	5681049	.	A	C	24	19	43	0	1	44	0	0
2	5681388	.	T	G	13	1	14	0	21	35	0	0
2	5681446	.	T	C	13	16	29	0	2	31	0	0
2	5709579	.	T	C	9	0	9	0	7	16	0	0
2	5709663	.	C	G	13	7	20	0	1	21	0	0
2	5709746	.	T	A	14	2	16	0	0	16	0	0
2	5709782	.	C	T	8	6	14	0	1	15	0	0
2	5709843	.	C	A	15	12	27	0	2	29	0	0
2	5709850	.	T	G	14	12	26	0	2	28	0	0
2	5711684	.	C	A	4	8	12	0	0	12	0	0
2	5714194	.	A	G	7	11	18	0	1	19	0	0
2	5714303	.	G	T	12	10	22	0	1	23	0	0
2	5714789	.	C	T	1	1	2	0	0	2	0	0
2	5714813	.	C	T	0	3	3	0	5	8	0	0
2	5716793	.	T	C	12	10	22	0	1	23	0	0
2	5721008	.	C	T	1	1	2	0	5	7	0	0
2	5723497	.	A	G	5	6	11	0	0	11	0	0
2	5723515	.	A	G	8	10	18	0	1	19	0	0
2	5735134	.	C	T	1	8	9	0	8	17	0	0
2	5735271	.	G	A	3	3	6	0	0	6	0	0
2	5735622	.	A	G	0	7	7	0	0	7	0	0
2	5735623	.	G	A	0	7	7	0	0	7	0	0
2	5736158	.	T	C	4	4	8	0	0	8	0	0
2	5736291	.	G	A	5	5	10	0	1	11	0	0
2	5736405	.	G	A	0	5	5	0	0	5	0	0
2	5740418	.	T	A	1	1	2	0	0	2	0	0
2	5740678	.	T	C	1	4	5	0	0	5	0	0
2	5740709	.	A	G	5	2	7	0	0	7	0	0
2	5741110	.	C	G	7	4	11	0	2	13	0	0
2	5741305	.	C	G	8	6	14	0	0	14	0	0
2	5741391	.	A	G	5	5	10	0	0	10	0	0
2	5741400	.	G	C	4	3	7	0	2	9	0	0
2	5741631	.	A	G	3	5	8	0	0	8	0	0
2	5749293	.	C	T	0	1	1	0	4	5	0	0
2	5749335	.	A	G	3	2	5	0	0	5	0	0
2	5749641	.	C	T	0	4	4	0	5	9	0	0
2	5749806	.	C	T	6	2	8	0	1	9	0	0
2	5749893	.	G	A	2	5	7	0	1	8	0	0
2	5758126	.	G	T	3	1	4	0	0	4	0	0
2	5811778	.	T	A	2	7	9	0	0	9	0	0
2	5811783	.	T	A	7	2	9	0	1	10	0	0
2	5811868	.	G	A	1	3	4	0	1	5	0	0
2	5811891	.	T	C	2	2	4	0	0	4	0	0
2	5812047	.	T	A	1	2	3	0	0	3	0	0
2	5812049	.	A	T	1	2	3	0	0	3	0	0
2	5812197	.	G	A	3	2	5	0	0	5	0	0
2	5812518	.	T	C	3	3	6	0	0	6	0	0
2	5813681	.	C	T	3	5	8	0	0	8	0	0
2	5813710	.	C	T	4	4	8	0	0	8	0	0
2	5813904	.	G	T	3	4	7	0	0	7	0	0
2	5813913	.	G	A	3	4	7	0	0	7	0	0
2	5814029	.	T	A	0	3	3	0	1	4	0	0
2	5843880	.	A	T	1	2	3	0	0	3	0	0
2	5844019	.	T	G	2	3	5	0	1	6	0	0
2	5844113	.	G	A	4	4	8	0	0	8	0	0
2	5844126	.	A	T	4	3	7	0	1	8	0	0
2	5866850	.	T	A	2	3	5	0	0	5	0	0
2	5866977	.	C	T	5	5	10	0	1	11	0	0
2	5866989	.	G	A	5	3	8	0	1	9	0	0
2	5872950	.	C	T	1	2	3	0	0	3	0	0
2	5873674	.	T	C	3	1	4	0	0	4	0	0
2	5882398	.	A	T	12	3	15	0	1	16	0	0
2	5882542	.	T	C	6	6	12	0	0	12	0	0
2	5882665	.	C	T	3	7	10	0	0	10	0	0
2	5882793	.	A	C	7	10	17	0	1	18	0	0
2	5882799	.	A	G	12	0	12	0	7	19	0	0
2	5883039	.	C	T	3	7	10	0	1	11	0	0
2	5883198	.	G	A	12	5	17	1	2	20	0	0
2	5909405	.	C	T	1	3	4	0	0	4	0	0
2	5909435	.	C	T	1	2	3	0	0	3	0	0
2	5909982	.	G	C	1	1	2	0	0	2	0	0
2	5910120	.	C	G	1	0	1	0	2	3	0	0
2	5919314	.	C	T	4	4	8	0	2	10	0	0
2	5923438	.	G	A	6	9	15	0	0	15	0	0
2	5923640	.	A	T	4	3	7	0	0	7	0	0
2	5923645	.	C	T	5	3	8	0	0	8	0	0
2	5923679	.	G	A	4	2	6	0	2	8	0	0
2	5923759	.	G	C	0	2	2	0	2	4	0	0
2	5923863	.	C	T	7	7	14	0	0	14	0	0
2	5923921	.	T	G	5	7	12	0	0	12	0	0
2	5923943	.	C	T	6	7	13	0	1	14	0	0
2	5923978	.	C	T	7	7	14	0	0	14	0	0
2	5924170	.	T	A	4	7	11	0	0	11	0	0
2	5924207	.	T	C	4	9	13	0	0	13	0	0
2	5929896	.	G	A	1	1	2	0	0	2	0	0
2	5934920	.	G	C	8	14	22	0	2	24	0	0
2	5935219	.	A	T	8	9	17	0	1	18	0	0
2	5935294	.	G	A	7	5	12	0	0	12	0	0
2	5935963	.	C	G	1	2	3	0	0	3	0	0
2	5936035	.	T	A	2	8	10	0	0	10	0	0
2	5936038	.	A	G	2	6	8	0	0	8	0	0
2	5936465	.	G	T	5	2	7	0	0	7	0	0
2	5936476	.	G	C	2	6	8	0	0	8	0	0
2	5936751	.	T	G	4	7	11	0	1	12	0	0
2	5936910	.	G	A	1	3	4	0	1	5	0	0
2	5936922	.	A	G	1	3	4	0	1	5	0	0
2	5937051	.	C	T	1	0	1	0	0	1	0	0
2	5937079	.	T	G	0	1	1	0	0	1	0	0
2	6005568	.	T	G	3	2	5	0	1	6	0	0
2	6011531	.	G	A	1	2	3	0	0	3	0	0
2	6032755	.	C	T	0	3	3	0	3	6	0	0
2	6032802	.	G	A	2	1	3	0	0	3	0	0
2	6037004	.	C	A	1	0	1	0	0	1	0	0
2	6039678	.	T	C	1	3	4	0	0	4	0	0
2	6042195	.	T	C	14	8	22	0	1	23	0	0
2	6052179	.	A	T	10	6	16	0	0	16	0	0
2	6052295	.	A	T	3	4	7	0	0	7	0	0
2	6052379	.	C	A	2	2	4	0	0	4	0	0
2	6052380	.	A	T	2	2	4	0	0	4	0	0
2	6052580	.	T	A	3	6	9	0	0	9	0	0
2	6052932	.	G	A	11	6	17	0	0	17	0	0
2	6054935	.	A	G	2	3	5	0	0	5	0	0
2	6058633	.	G	A	4	2	6	0	1	7	0	0
2	6073604	.	A	T	0	0	0	1	0	1	0	0
2	6073939	.	A	T	0	2	2	0	0	2	0	0
2	6082748	.	T	C	4	6	10	0	0	10	0	0
2	6082752	.	A	C	3	4	7	0	1	8	0	0
2	6089471	.	T	C	3	2	5	0	0	5	0	0
2	6091689	.	G	A	0	2	2	0	7	9	0	0
2	6091764	.	A	G	5	1	6	0	7	13	0	0
2	6091819	.	A	G	4	1	5	0	4	9	0	0
2	6091920	.	A	T	0	2	2	0	1	3	0	0
2	6091921	.	T	G	1	2	3	0	0	3	0	0
2	6106727	.	T	C	5	1	6	0	3	9	0	0
2	6106742	.	G	A	6	5	11	0	1	12	0	0
2	6107289	.	G	A	11	11	22	0	1	23	0	0
2	6107310	.	A	T	7	6	13	0	0	13	0	0
2	6126753	.	T	A	13	7	20	0	0	20	0	0
2	6126783	.	A	T	11	7	18	0	0	18	0	0
2	6126857	.	T	C	4	8	12	0	2	14	0	0
2	6143912	.	T	C	3	1	4	0	1	5	0	0
2	6144085	.	G	A	0	12	12	0	8	20	0	0
2	6149006	.	T	C	4	10	14	0	3	17	0	0
2	6149220	.	T	G	0	4	4	0	1	5	0	0
2	6186956	.	T	A	5	4	9	0	0	9	0	0
2	6187031	.	G	T	5	11	16	0	1	17	0	0
2	6187138	.	T	C	7	5	12	0	0	12	0	0
2	6191691	.	T	C	10	12	22	0	0	22	0	0
2	6191829	.	C	T	2	0	2	0	0	2	0	0
2	6194151	.	T	C	8	4	12	0	5	17	0	0
2	6196798	.	T	A	9	9	18	0	0	18	0	0
2	6196804	.	A	G	9	1	10	0	10	20	0	0
2	6196858	.	C	A	9	12	21	0	1	22	0	0
2	6197216	.	G	T	14	12	26	0	1	27	0	0
2	6197249	.	G	A	9	8	17	0	1	18	0	0
2	6258361	.	T	A	1	4	5	0	0	5	0	0
2	6258373	.	G	A	1	4	5	0	0	5	0	0
2	6258497	.	G	A	1	2	3	0	0	3	0	0
2	6258564	.	G	A	2	2	4	0	0	4	0	0
2	6265929	.	C	A	25	20	45	0	0	45	0	0
2	6266115	.	T	A	15	18	33	0	1	34	0	0
2	6292405	.	T	G	18	18	36	0	0	36	0	0
2	6292416	.	G	C	18	17	35	0	1	36	0	0
2	6292453	.	G	T	18	15	33	0	2	35	0	0
2	6326226	.	C	T	0	2	2	0	3	5	0	0
2	6334330	.	C	T	0	0	0	0	4	4	0	0
2	6334331	.	G	A	3	0	3	0	1	4	0	0
2	6734267	.	A	G	3	2	5	0	0	5	0	0
2	6761213	.	C	G	3	2	5	0	0	5	0	0
2	6805112	.	G	A	7	11	18	0	0	18	0	0
2	6886758	.	T	G	8	0	8	0	4	12	0	0
2	6886837	.	G	A	1	8	9	0	6	15	0	0
2	6888679	.	G	A	10	10	20	0	0	20	0	0
2	6926619	.	C	A	2	4	6	0	0	6	0	0
2	6948707	.	C	T	8	8	16	0	0	16	0	0
2	6948717	.	T	C	10	8	18	0	1	19	0	0
2	6952249	.	C	T	5	2	7	0	0	7	0	0
2	6952596	.	C	T	3	3	6	0	0	6	0	0
2	6952707	.	A	G	5	2	7	0	0	7	0	0
2	6958671	.	A	T	17	12	29	0	1	30	0	0
2	6958677	.	A	T	16	14	30	0	0	30	0	0
2	6958712	.	T	A	10	9	19	0	0	19	0	0
2	6958940	.	C	A	17	9	26	0	0	26	0	0
2	7037580	.	C	T	0	1	1	0	0	1	0	0
2	7039765	.	C	A	4	3	7	0	0	7	0	0
2	7040053	.	A	T	0	1	1	0	0	1	0	0
2	7040253	.	C	T	1	0	1	0	0	1	0	0
2	7042165	.	C	T	3	1	4	0	0	4	0	0
2	7046777	.	C	T	2	4	6	0	1	7	0	0
2	7051164	.	G	A	0	13	13	0	6	19	0	0
2	7056102	.	G	A	6	13	19	0	2	21	0	0
2	7056359	.	G	T	11	9	20	0	0	20	0	0
2	7056417	.	C	T	2	8	10	0	0	10	0	0
2	7056450	.	T	A	0	3	3	0	0	3	0	0
2	7056604	.	A	G	11	1	12	0	10	22	0	0
2	7056610	.	A	G	11	9	20	0	1	21	0	0
2	7056711	.	T	G	8	9	17	0	0	17	0	0
2	7056761	.	G	A	1	9	10	0	11	21	0	0
2	7056763	.	G	A	1	9	10	0	11	21	0	0
2	7057010	.	T	C	8	13	21	0	1	22	0	0
2	7148000	.	G	A	0	3	3	0	1	4	0	0
2	7150075	.	G	T	10	6	16	0	2	18	0	0
2	7150571	.	C	G	13	11	24	0	1	25	0	0
2	7150573	.	A	G	14	11	25	0	0	25	0	0
2	7150790	.	G	C	5	0	5	0	6	11	0	0
2	7150908	.	C	G	9	6	15	0	0	15	0	0
2	7150950	.	A	T	5	3	8	0	3	11	0	0
2	7151148	.	A	G	5	3	8	0	0	8	0	0
2	7151161	.	A	T	6	6	12	0	0	12	0	0
2	7151197	.	C	T	7	8	15	0	1	16	0	0
2	7151392	.	C	A	1	8	9	0	8	17	0	0
2	7151485	.	A	T	12	5	17	0	0	17	0	0
2	7151613	.	A	G	2	3	5	0	0	5	0	0
2	7151647	.	C	G	2	5	7	0	0	7	0	0
2	7151667	.	C	G	2	6	8	0	0	8	0	0
2	7151682	.	C	A	3	7	10	0	0	10	0	0
2	7151843	.	C	A	0	8	8	0	7	15	0	0
2	7152168	.	C	T	1	2	3	0	5	8	0	0
2	7152196	.	T	A	1	5	6	0	0	6	0	0
2	7152263	.	G	A	6	5	11	0	1	12	0	0
2	7152268	.	T	C	7	5	12	0	0	12	0	0
2	7152326	.	G	A	6	2	8	0	0	8	0	0
2	7152350	.	C	A	0	2	2	0	5	7	0	0
2	7152409	.	T	C	9	7	16	0	0	16	0	0
2	7152431	.	T	C	9	8	17	0	0	17	0	0
2	7152469	.	G	T	6	6	12	0	0	12	0	0
2	7152518	.	A	G	4	2	6	0	1	7	0	0
2	7152520	.	C	G	4	2	6	0	1	7	0	0
2	7152681	.	C	A	2	4	6	0	0	6	0	0
2	7152762	.	T	C	1	5	6	0	0	6	0	0
2	7152774	.	T	C	2	3	5	0	1	6	0	0
2	7153293	.	A	T	3	3	6	0	0	6	0	0
2	7153829	.	T	A	4	4	8	0	0	8	0	0
2	7153861	.	T	C	3	2	5	0	0	5	0	0
2	7153868	.	T	C	2	0	2	0	3	5	0	0
2	7154474	.	C	T	2	5	7	0	0	7	0	0
2	7154527	.	C	T	0	2	2	0	1	3	0	0
2	7163378	.	G	A	4	5	9	0	1	10	0	0
2	7168167	.	G	A	3	5	8	0	0	8	0	0
2	7168179	.	T	A	6	3	9	0	0	9	0	0
2	7168762	.	G	A	4	1	5	0	0	5	0	0
2	7184903	.	C	T	1	1	2	0	0	2	0	0
2	7185054	.	G	A	1	2	3	0	0	3	0	0
2	7238725	.	A	G	1	3	4	0	0	4	0	0
2	7239079	.	T	C	10	6	16	0	1	17	0	0
2	7239308	.	G	A	6	3	9	0	0	9	0	0
2	7239505	.	T	C	13	8	21	0	0	21	0	0
2	7239812	.	G	A	7	10	17	0	2	19	0	0
2	7239816	.	C	T	6	10	16	0	1	17	0	0
2	7239919	.	A	T	4	4	8	1	1	10	0	0
2	7240484	.	A	C	0	3	3	0	0	3	0	0
2	7240865	.	C	T	0	6	6	0	1	7	0	0
2	7241356	.	T	G	1	2	3	0	0	3	0	0
2	7241358	.	T	G	1	2	3	0	0	3	0	0
2	7241649	.	C	T	4	4	8	0	0	8	0	0
2	7241704	.	G	C	3	4	7	0	0	7	0	0
2	7241962	.	G	A	6	6	12	0	0	12	0	0
2	7241980	.	T	A	6	8	14	0	0	14	0	0
2	7422454	.	T	C	2	4	6	0	0	6	0	0
2	7422457	.	T	C	2	4	6	0	0	6	0	0
2	7423098	.	T	C	1	5	6	0	0	6	0	0
2	7602133	.	T	G	4	5	9	0	0	9	0	0
2	7602149	.	A	G	5	5	10	0	0	10	0	0
2	7687899	.	G	A	0	3	3	0	0	3	0	0
2	7720800	.	C	T	15	19	34	0	3	37	0	0
2	7720836	.	T	C	11	16	27	0	0	27	0	0
2	7720879	.	C	A	3	3	6	0	0	6	0	0
2	7726414	.	T	A	1	4	5	0	0	5	0	0
2	7726924	.	T	A	14	21	35	0	1	36	0	0
2	7764894	.	C	T	0	15	15	0	12	27	0	0
2	7764983	.	T	C	14	0	14	0	20	34	0	0
2	7765145	.	A	G	4	4	8	0	0	8	0	0
2	7765215	.	G	A	4	2	6	0	1	7	0	0
2	7765308	.	A	T	4	4	8	0	2	10	0	0
2	7765613	.	C	T	7	11	18	0	0	18	0	0
2	7765685	.	A	G	7	7	14	0	0	14	0	0
2	7765821	.	A	G	2	7	9	0	0	9	0	0
2	7766698	.	G	A	0	2	2	0	0	2	0	0
2	7766946	.	G	A	3	2	5	0	0	5	0	0
2	7766970	.	C	T	1	3	4	0	0	4	0	0
2	7767128	.	A	G	2	2	4	0	1	5	0	0
2	7767496	.	C	A	0	4	4	0	1	5	0	0
2	7768114	.	G	T	4	2	6	0	0	6	0	0
2	7768615	.	T	C	0	9	9	0	1	10	0	0
2	7768648	.	G	T	0	9	9	0	0	9	0	0
2	7772234	.	G	C	1	1	2	0	0	2	0	0
2	7923987	.	T	C	4	2	6	0	0	6	0	0
2	7924183	.	A	T	12	15	27	0	0	27	0	0
2	7924713	.	T	C	18	22	40	0	1	41	0	0
2	7924867	.	G	A	14	24	38	0	2	40	0	0
2	7937238	.	C	T	1	6	7	0	3	10	0	0
2	7943854	.	G	A	10	18	28	0	0	28	0	0
2	7954914	.	G	A	10	16	26	0	2	28	0	0
2	7956982	.	T	C	2	3	5	0	0	5	0	0
2	7979881	.	T	C	3	5	8	0	0	8	0	0
2	7979938	.	G	A	2	3	5	0	0	5	0	0
2	7982680	.	G	A	3	5	8	0	1	9	0	0
2	7991728	.	C	A	2	3	5	0	1	6	0	0
2	7995486	.	A	G	2	3	5	0	1	6	0	0
2	8017314	.	C	T	4	5	9	0	0	9	0	0
2	8062447	.	A	G	1	2	3	0	0	3	0	0
2	8112516	.	C	T	7	20	27	0	0	27	0	0
2	8112611	.	G	A	5	6	11	0	0	11	0	0
2	8112679	.	C	A	5	10	15	0	3	18	0	0
2	8112687	.	A	T	4	12	16	0	3	19	0	0
2	8113819	.	A	G	13	23	36	0	2	38	0	0
2	8114179	.	T	C	19	27	46	0	0	46	0	0
2	9875267	.	A	G	1	9	10	0	0	10	0	0
2	10685924	.	A	G	11	0	11	0	4	15	0	0
2	11854009	.	T	C	2	4	6	0	0	6	0	0
2	11854040	.	T	C	4	3	7	0	0	7	0	0
2	13265191	.	G	A	0	1	1	0	0	1	0	0
2	14791200	.	A	T	1	2	3	0	0	3	0	0
2	16548514	.	T	C	17	10	27	0	0	27	0	0
2	16646094	.	A	G	2	1	3	0	0	3	0	0
2	16838837	.	C	G	0	0	0	5	5	17	7	0
2	17266812	.	G	C	2	0	2	0	6	8	0	0
2	17267217	.	C	T	0	3	3	0	1	4	0	0
2	17317821	.	G	A	0	2	2	0	0	2	0	0
2	17450642	.	C	T	3	5	8	0	1	9	0	0
2	17450726	.	A	T	5	5	10	0	1	12	1	0
2	17450841	.	A	T	3	2	5	0	1	6	0	0
2	17450859	.	C	A	0	4	4	0	3	7	0	0
2	17451003	.	G	A	10	3	13	0	0	13	0	0
2	17451198	.	G	A	5	8	13	0	1	14	0	0
2	17451327	.	A	G	9	11	20	0	1	21	0	0
2	17451375	.	G	A	3	10	13	0	0	13	0	0
2	17578710	.	A	G	17	23	40	0	4	44	0	0
2	17579033	.	G	A	20	10	30	0	2	32	0	0
2	17579109	.	A	C	24	0	24	0	12	37	1	0
2	17579110	.	A	G	25	9	34	0	2	37	1	0
2	17579324	.	T	C	29	10	39	0	0	39	0	0
2	17579888	.	A	C	21	0	21	0	18	39	0	0
2	17579926	.	G	C	22	0	22	0	19	41	0	0
2	17596503	.	A	G	0	1	1	0	0	1	0	0
2	17604640	.	G	C	6	3	9	0	0	9	0	0
2	17617513	.	T	C	2	2	4	0	2	6	0	0
2	17644591	.	G	A	16	5	21	0	0	21	0	0
2	17644609	.	T	C	6	1	7	0	15	22	0	0
2	17646976	.	G	A	0	1	1	0	0	1	0	0
2	17651370	.	A	G	0	3	3	0	0	3	0	0
2	17651466	.	A	G	4	13	17	0	2	19	0	0
2	17651565	.	C	T	1	13	14	0	3	17	0	0
2	17651574	.	C	T	1	13	14	0	1	15	0	0
2	17702137	.	T	C	2	0	2	0	3	5	0	0
2	17717026	.	A	G	1	1	2	0	0	2	0	0
2	18702915	.	C	A	3	2	5	0	0	5	0	0
2	20285762	.	G	A	1	1	2	0	0	2	0	0
2	20367846	.	A	C	7	10	17	0	0	17	0	0
2	20367927	.	G	T	6	15	21	0	0	21	0	0
2	20368569	.	A	C	15	13	28	0	0	28	0	0
2	20368630	.	G	A	0	12	12	0	14	26	0	0
2	20368761	.	T	C	16	16	32	0	2	34	0	0
2	20368812	.	G	A	21	11	32	0	3	35	0	0
2	20368965	.	C	T	25	19	44	0	2	46	0	0
2	20369516	.	A	G	21	20	41	0	2	43	0	0
2	20369836	.	A	T	30	17	47	0	0	47	0	0
2	20369925	.	T	A	9	15	24	0	0	24	0	0
2	20369947	.	A	C	9	11	20	0	2	22	0	0
2	20370012	.	C	T	12	15	27	0	2	29	0	0
2	20370090	.	G	C	11	27	38	0	3	41	0	0
2	20370143	.	C	T	18	23	41	0	1	42	0	0
2	20370792	.	T	C	17	22	39	0	2	41	0	0
2	20370893	.	C	T	19	21	40	0	0	40	0	0
2	20370998	.	A	G	15	20	35	0	1	36	0	0
2	20371060	.	T	A	12	4	16	0	1	17	0	0
2	20371210	.	G	C	2	8	10	0	0	10	0	0
2	20437721	.	G	A	7	7	14	0	0	14	0	0
2	20437878	.	G	A	9	3	12	0	0	12	0	0
2	20438054	.	G	A	7	13	20	0	0	20	0	0
2	20438061	.	A	T	14	7	21	0	0	21	0	0
2	20438589	.	C	T	6	3	9	0	0	9	0	0
2	20439070	.	A	G	6	0	6	0	14	20	0	0
2	20439223	.	G	T	7	25	32	0	1	33	0	0
2	20439303	.	C	T	15	5	20	0	0	20	0	0
2	20440244	.	G	A	2	0	2	0	0	2	0	0
2	20448110	.	A	T	1	2	3	0	0	3	0	0
2	20473191	.	T	G	2	1	3	0	0	3	0	0
2	20475819	.	A	G	0	1	1	0	0	1	0	0
2	20477158	.	C	T	2	2	4	0	0	4	0	0
2	20501627	.	C	A	1	2	3	0	0	3	0	0
2	20501646	.	C	T	2	3	5	0	1	6	0	0
2	20503698	.	C	A	6	6	12	0	0	12	0	0
2	20503734	.	T	G	8	0	8	0	7	15	0	0
2	20503770	.	C	T	3	3	6	0	0	6	0	0
2	20505994	.	C	T	3	3	6	0	1	7	0	0
2	20505995	.	C	T	4	3	7	0	0	7	0	0
2	20514915	.	A	G	1	0	1	0	0	1	0	0
2	20515013	.	G	A	7	9	16	0	0	16	0	0
2	20515056	.	G	A	2	5	7	0	0	7	0	0
2	20515060	.	T	G	2	3	5	0	0	5	0	0
2	20515307	.	C	T	1	4	5	0	1	6	0	0
2	20515377	.	C	T	2	1	3	0	0	3	0	0
2	20516291	.	G	A	4	2	6	0	0	6	0	0
2	20523002	.	C	T	6	4	10	0	0	10	0	0
2	20523004	.	C	T	6	4	10	0	0	10	0	0
2	20523351	.	T	A	10	10	20	0	0	20	0	0
2	20523364	.	A	G	11	14	25	0	0	25	0	0
2	20526411	.	T	C	24	15	39	0	2	41	0	0
2	20526592	.	A	G	16	0	16	0	13	29	0	0
2	20526599	.	T	A	17	11	28	0	1	29	0	0
2	20556182	.	A	T	1	4	5	0	0	5	0	0
2	20614879	.	T	C	1	4	5	0	2	7	0	0
2	20666594	.	G	T	0	1	1	0	0	1	0	0
2	20811654	.	A	T	3	3	6	0	0	6	0	0
2	20814291	.	T	G	9	8	17	0	0	17	0	0
2	20814419	.	T	C	0	1	1	0	0	1	0	0
2	20814488	.	C	T	12	6	18	0	3	21	0	0
2	20814688	.	G	C	4	0	4	0	2	6	0	0
2	20814754	.	G	T	1	0	1	0	0	1	0	0
2	20817736	.	G	A	3	5	8	0	0	8	0	0
2	20820587	.	C	T	6	3	9	0	0	9	0	0
2	20822794	.	A	G	3	4	7	0	0	7	0	0
2	20824654	.	T	C	3	0	3	0	0	3	0	0
2	20826495	.	T	C	1	3	4	0	0	4	0	0
2	20828000	.	G	A	2	2	4	0	0	4	0	0
2	20828235	.	C	T	0	0	0	0	1	1	0	0
2	20830387	.	A	G	3	5	8	0	0	8	0	0
2	20830993	.	C	G	1	5	6	0	0	6	0	0
2	20836438	.	A	C	5	2	7	0	0	7	0	0
2	20836780	.	G	A	3	3	6	0	0	6	0	0
2	20840539	.	C	A	3	2	5	0	0	5	0	0
2	20875112	.	G	A	0	6	6	0	7	13	0	0
2	20875166	.	C	T	2	0	2	0	0	2	0	0
2	20875860	.	A	G	2	3	5	0	1	6	0	0
2	20875922	.	T	A	1	1	2	0	0	2	0	0
2	20920946	.	C	T	1	0	1	0	0	1	0	0
2	20967782	.	C	G	4	5	9	0	1	10	0	0
2	20967788	.	G	A	5	5	10	0	0	10	0	0
2	20971423	.	T	C	1	1	2	0	0	2	0	0
2	20972877	.	A	G	5	8	13	0	0	13	0	0
2	20973003	.	G	A	2	2	4	0	0	4	0	0
2	20973008	.	G	T	2	2	4	0	0	4	0	0
2	20973369	.	G	A	1	6	7	0	1	8	0	0
2	20973419	.	G	A	4	4	8	0	1	9	0	0
2	20973794	.	A	T	6	2	8	0	2	10	0	0
2	20973864	.	G	A	0	3	3	0	4	7	0	0
2	20974837	.	T	G	5	0	5	0	3	8	0	0
2	20975010	.	T	C	6	3	9	0	0	9	0	0
2	20975255	.	G	C	11	5	16	0	0	16	0	0
2	20975283	.	C	T	12	6	18	0	0	18	0	0
2	20975460	.	T	C	8	6	14	0	0	14	0	0
2	20980356	.	T	C	7	8	15	0	0	15	0	0
2	21071401	.	T	A	2	1	3	0	0	3	0	0
2	21073286	.	T	A	3	2	5	0	0	5	0	0
2	21073350	.	A	C	0	1	1	0	0	1	0	0
2	21076203	.	C	T	8	6	14	0	4	18	0	0
2	21076342	.	T	C	7	3	10	0	0	10	0	0
2	21076805	.	C	A	10	3	13	0	0	13	0	0
2	21076932	.	A	T	1	3	4	0	1	5	0	0
2	21077101	.	A	T	3	2	5	0	0	5	0	0
2	21077268	.	G	T	11	7	18	0	2	20	0	0
2	21077299	.	C	T	17	8	25	0	1	26	0	0
2	21077726	.	C	T	5	5	10	0	0	10	0	0
2	21082585	.	C	G	2	5	7	0	0	7	0	0
2	21082596	.	C	A	2	4	6	0	0	6	0	0
2	21156350	.	G	A	4	5	9	0	1	10	0	0
2	21156613	.	T	A	3	2	5	0	0	5	0	0
2	21165495	.	C	G	1	5	6	0	8	14	0	0
2	21177237	.	G	A	0	2	2	0	0	2	0	0
2	21182482	.	G	T	2	4	6	0	0	6	0	0
2	21298986	.	G	C	0	4	4	0	4	8	0	0
2	21299023	.	G	C	1	2	3	0	0	3	0	0
2	21300087	.	G	A	5	2	7	0	0	7	0	0
2	21309811	.	C	T	4	1	5	0	0	5	0	0
2	21312257	.	T	C	1	3	4	0	0	4	0	0
2	21338276	.	T	C	2	2	4	0	0	4	0	0
2	21340915	.	G	A	1	1	2	0	0	2	0	0
2	21356392	.	C	T	7	5	12	0	0	12	0	0
2	21356584	.	T	G	3	4	7	0	0	7	0	0
2	21356614	.	A	T	2	4	6	0	0	6	0	0
2	21367952	.	A	G	4	4	8	0	0	8	0	0
2	21367977	.	C	T	5	5	10	0	1	11	0	0
2	21368006	.	T	C	4	4	8	0	0	8	0	0
2	21376407	.	C	T	2	2	4	0	0	4	0	0
2	21381230	.	C	T	3	6	9	0	0	9	0	0
2	21456950	.	G	A	1	1	2	0	0	2	0	0
2	21459061	.	G	A	2	2	4	0	0	4	0	0
2	21459091	.	G	T	3	2	5	0	0	5	0	0
2	21459100	.	G	A	3	3	6	0	0	6	0	0
2	21459196	.	C	T	6	6	12	0	0	12	0	0
2	21459661	.	C	G	2	4	6	0	0	7	1	0
2	21459701	.	C	A	3	2	5	0	0	5	0	0
2	21462185	.	A	G	3	3	6	0	0	6	0	0
2	21462191	.	A	G	2	3	5	0	0	5	0	0
2	21466555	.	T	C	15	12	27	0	0	27	0	0
2	21466567	.	A	T	18	13	31	0	1	32	0	0
2	21468807	.	G	A	27	16	43	0	2	45	0	0
2	21468825	.	G	A	14	24	38	0	3	41	0	0
2	21469405	.	T	C	8	14	22	0	0	22	0	0
2	21469490	.	T	C	10	8	18	0	0	18	0	0
2	21469644	.	A	G	9	9	18	0	0	18	0	0
2	21469830	.	T	A	6	6	12	0	0	12	0	0
2	21486980	.	T	G	4	2	6	0	0	6	0	0
2	21502307	.	C	T	1	2	3	0	0	3	0	0
2	21502364	.	C	T	4	3	7	0	0	7	0	0
2	21502540	.	G	C	3	7	10	0	0	10	0	0
2	21503584	.	A	G	1	3	4	0	0	4	0	0
2	21605644	.	A	T	3	2	5	0	1	6	0	0
2	21605724	.	T	C	1	2	3	0	0	3	0	0
2	21605857	.	T	C	5	3	8	0	0	8	0	0
2	21605877	.	G	A	0	3	3	0	4	7	0	0
2	21605937	.	G	T	4	3	7	0	1	8	0	0
2	21607456	.	G	C	6	6	12	0	0	12	0	0
2	21608427	.	C	G	3	5	8	0	0	8	0	0
2	21608582	.	G	A	9	11	20	0	0	20	0	0
2	21608587	.	C	T	9	12	21	0	0	21	0	0
2	21608710	.	T	A	9	15	24	0	0	24	0	0
2	21608781	.	T	G	6	5	11	0	0	11	0	0
2	21609104	.	A	T	3	4	7	0	0	7	0	0
2	21609223	.	C	T	0	5	5	0	2	7	0	0
2	21609443	.	C	A	12	4	16	0	0	16	0	0
2	21609446	.	C	T	10	5	15	0	1	16	0	0
2	21609777	.	G	A	1	3	4	0	0	4	0	0
2	21609789	.	A	T	1	3	4	0	0	4	0	0
2	21609830	.	T	G	1	4	5	0	0	5	0	0
2	21610233	.	G	A	0	1	1	0	0	1	0	0
2	21612380	.	C	T	1	2	3	0	4	7	0	0
2	21613008	.	T	C	1	0	1	0	1	2	0	0
2	21620412	.	A	G	7	7	14	0	0	14	0	0
2	21620469	.	T	C	9	0	9	0	10	19	0	0
2	21620691	.	G	A	8	3	11	0	0	11	0	0
2	21620856	.	C	T	8	5	13	0	1	14	0	0
2	21621151	.	G	A	4	3	7	0	0	7	0	0
2	21621400	.	C	T	0	6	6	0	4	10	0	0
2	21621423	.	C	T	0	4	4	0	4	8	0	0
2	21621507	.	T	C	7	4	11	0	0	11	0	0
2	21621528	.	A	G	5	3	8	0	0	8	0	0
2	21621606	.	C	T	2	4	6	0	1	7	0	0
2	21733428	.	A	G	0	1	1	0	0	1	0	0
2	21766212	.	A	G	3	12	15	0	1	16	0	0
2	21766237	.	G	A	16	7	23	0	0	23	0	0
2	21766277	.	G	A	12	6	18	0	1	19	0	0
2	21766478	.	T	A	9	11	20	0	1	21	0	0
2	21766554	.	G	A	5	10	15	0	2	17	0	0
2	21766785	.	G	A	7	12	19	0	3	24	2	0
2	21767207	.	C	T	15	12	27	0	0	27	0	0
2	21767244	.	A	T	12	8	20	0	0	20	0	0
2	21767286	.	T	C	3	8	11	0	1	12	0	0
2	21768168	.	G	A	4	3	7	0	2	9	0	0
2	21768821	.	T	A	6	5	11	0	0	11	0	0
2	21771191	.	G	T	6	5	11	0	0	11	0	0
2	21772099	.	G	A	1	4	5	0	1	6	0	0
2	21774400	.	G	A	2	1	3	0	0	3	0	0
2	21777101	.	C	A	2	2	4	0	0	4	0	0
2	21777102	.	A	G	1	2	3	0	1	4	0	0
2	21806152	.	C	T	0	4	4	0	1	5	0	0
2	21822288	.	C	A	21	29	50	0	4	54	0	0
2	21822304	.	A	G	31	12	43	0	6	49	0	0
2	21822816	.	T	A	18	19	37	0	0	37	0	0
2	21827276	.	A	G	16	14	30	0	2	32	0	0
2	21855248	.	C	G	5	4	9	0	0	9	0	0
2	21855253	.	G	A	0	5	5	0	4	9	0	0
2	21861735	.	T	G	0	0	0	0	1	1	0	0
2	21862511	.	C	T	1	3	4	0	1	5	0	0
2	21865620	.	G	C	8	10	18	0	0	18	0	0
2	21877711	.	C	G	9	8	17	0	0	17	0	0
2	21877878	.	G	A	8	4	12	0	1	13	0	0
2	21878036	.	G	C	17	13	30	0	2	32	0	0
2	21878053	.	T	C	18	12	30	0	1	31	0	0
2	21878197	.	T	C	19	14	33	0	0	33	0	0
2	21878415	.	C	T	5	23	28	0	0	28	0	0
2	21878462	.	T	C	16	12	28	0	0	29	1	0
2	21983064	.	T	G	4	0	4	0	8	12	0	0
2	22058071	.	A	G	2	0	2	0	2	4	0	0
2	22058098	.	C	T	7	5	12	0	2	14	0	0
2	22058200	.	C	T	12	5	17	0	2	19	0	0
2	22058254	.	G	A	9	4	13	0	0	13	0	0
2	22073176	.	C	T	15	12	27	0	0	27	0	0
2	22101657	.	C	T	21	25	46	0	0	46	0	0
2	22101699	.	A	C	11	11	22	0	0	22	0	0
2	22104292	.	C	T	19	21	40	0	1	41	0	0
2	22104415	.	C	A	19	11	30	0	4	34	0	0
2	22104506	.	T	C	13	13	26	0	0	26	0	0
2	22104999	.	A	G	23	21	44	0	1	45	0	0
2	22105137	.	T	C	5	2	7	0	0	7	0	0
2	22208514	.	G	T	6	6	12	0	0	12	0	0
2	22208560	.	G	A	11	9	20	0	1	21	0	0
2	22208638	.	A	G	16	9	25	0	3	28	0	0
2	22209045	.	C	A	11	14	25	0	1	27	1	0
2	22209722	.	C	T	9	13	22	0	2	24	0	0
2	22210412	.	G	A	11	9	20	0	0	20	0	0
2	22286813	.	T	A	4	8	12	0	0	12	0	0
2	22353568	.	T	C	13	15	28	0	4	32	0	0
2	22353661	.	T	A	17	12	29	0	0	29	0	0
2	22362290	.	G	A	11	17	28	0	0	28	0	0
2	22362302	.	G	A	10	18	28	0	0	28	0	0
2	22363365	.	T	C	2	0	2	0	0	2	0	0
2	22363418	.	T	A	2	1	3	0	0	3	0	0
2	22381591	.	T	C	2	2	4	0	1	5	0	0
2	22390361	.	G	A	1	1	2	0	0	2	0	0
2	22480321	.	G	T	4	11	15	0	1	16	0	0
2	22480759	.	G	A	18	21	39	0	3	42	0	0
2	22483222	.	G	A	5	2	7	0	1	8	0	0
2	22483351	.	A	G	12	12	24	0	2	26	0	0
2	22483381	.	A	G	10	10	20	0	1	21	0	0
2	22483423	.	C	T	5	5	10	0	0	10	0	0
2	22483444	.	A	G	4	2	6	0	0	6	0	0
2	22513202	.	A	G	9	3	12	0	1	13	0	0
2	22516758	.	A	G	0	2	2	0	0	2	0	0
2	22521337	.	G	A	3	2	5	0	0	5	0	0
2	22521526	.	C	T	1	2	3	0	0	3	0	0
2	22521582	.	A	T	1	1	2	0	1	3	0	0
2	22522073	.	A	G	2	4	6	0	0	6	0	0
2	22522211	.	G	T	7	2	9	0	0	9	0	0
2	22599787	.	C	T	7	4	11	0	1	12	0	0
2	22602653	.	A	G	4	4	8	0	1	9	0	0
2	22602808	.	C	T	5	5	10	0	1	11	0	0
2	22602826	.	C	T	5	5	10	0	0	10	0	0
2	22607462	.	G	A	0	2	2	0	2	4	0	0
2	22608314	.	G	T	5	5	10	0	1	11	0	0
2	22614357	.	T	A	6	2	8	0	1	9	0	0
2	22614448	.	T	A	5	9	14	0	1	15	0	0
2	22614959	.	A	T	7	8	15	0	0	15	0	0
2	22617836	.	A	G	8	7	15	0	3	18	0	0
2	22617848	.	A	G	13	7	20	0	2	22	0	0
2	22617932	.	G	A	19	16	35	0	3	38	0	0
2	22626878	.	T	A	13	9	22	0	0	22	0	0
2	22627149	.	G	A	17	7	24	0	0	24	0	0
2	22629684	.	C	T	0	12	12	0	5	17	0	0
2	22633869	.	G	A	6	4	10	0	1	11	0	0
2	22634070	.	A	G	5	3	8	0	0	8	0	0
2	22653693	.	T	A	10	9	19	0	0	19	0	0
2	22656651	.	G	A	4	6	10	0	3	13	0	0
2	22656708	.	T	C	0	2	2	0	2	4	0	0
2	22656870	.	A	G	9	6	15	0	0	15	0	0
2	22659072	.	G	A	4	2	6	0	1	7	0	0
2	22702423	.	T	C	0	2	2	0	0	2	0	0
2	22707536	.	A	C	3	3	6	0	0	6	0	0
2	22711898	.	T	G	0	2	2	0	0	2	0	0
2	22714603	.	A	G	8	11	19	0	0	19	0	0
2	22714618	.	G	A	7	10	17	0	0	17	0	0
2	22716770	.	T	C	6	6	12	0	0	12	0	0
2	22718895	.	T	A	7	7	14	0	1	15	0	0
2	22719145	.	A	G	15	0	15	0	7	22	0	0
2	22724661	.	T	C	2	2	4	0	0	4	0	0
2	22731426	.	C	T	5	1	6	0	0	6	0	0
2	22731456	.	G	A	4	1	5	0	0	5	0	0
2	22733494	.	A	T	2	3	5	0	0	5	0	0
2	22733813	.	A	G	6	12	18	0	0	18	0	0
2	22735037	.	T	A	2	1	3	0	0	3	0	0
2	22735205	.	A	T	11	7	18	0	1	19	0	0
2	22735232	.	C	T	4	4	8	0	0	8	0	0
2	22742179	.	C	T	4	7	11	0	0	11	0	0
2	22745690	.	C	T	9	5	14	0	0	14	0	0
2	22747304	.	C	T	7	11	18	0	0	18	0	0
2	22750164	.	C	T	0	0	0	0	1	1	0	0
2	22750621	.	C	T	2	2	4	0	2	6	0	0
2	22750622	.	A	G	2	3	5	0	1	6	0	0
2	22756528	.	C	T	18	6	24	0	3	27	0	0
2	22795615	.	A	G	13	23	36	0	0	36	0	0
2	22799294	.	T	A	2	0	2	0	0	2	0	0
2	22801748	.	T	C	28	24	52	0	1	53	0	0
2	22801899	.	A	T	17	12	29	1	2	32	0	0
2	22802030	.	G	A	3	18	21	0	24	45	0	0
2	22802117	.	A	T	18	21	39	0	5	44	0	0
2	22802402	.	T	C	25	22	47	0	0	47	0	0
2	22802504	.	G	A	18	13	31	0	2	33	0	0
2	22802524	.	T	A	18	12	30	0	1	31	0	0
2	22803110	.	T	A	23	26	49	0	0	49	0	0
2	22803128	.	G	T	31	22	53	0	1	54	0	0
2	22803190	.	C	T	25	22	47	0	4	51	0	0
2	22852886	.	A	G	1	3	4	0	0	4	0	0
2	22852911	.	C	A	1	2	3	0	0	3	0	0
2	22933175	.	T	G	1	4	5	0	0	5	0	0
2	22933218	.	C	A	0	3	3	0	1	4	0	0
2	22933381	.	C	T	2	4	6	0	0	6	0	0
2	22933539	.	G	A	3	9	12	0	2	14	0	0
2	22933554	.	G	A	3	9	12	0	3	15	0	0
2	22944464	.	G	A	4	1	5	0	0	5	0	0
2	22953191	.	T	C	1	0	1	0	1	2	0	0
2	22957590	.	C	T	0	1	1	0	1	2	0	0
2	22970413	.	G	A	4	4	8	0	1	9	0	0
2	22970485	.	A	G	4	2	6	0	0	6	0	0
2	22970683	.	C	G	4	2	6	0	0	6	0	0
2	22970707	.	G	A	3	2	5	0	0	5	0	0
2	22970764	.	G	A	6	2	8	0	0	8	0	0
2	22971012	.	T	A	11	6	17	0	1	18	0	0
2	22979805	.	G	A	6	8	14	0	0	14	0	0
2	22980020	.	G	C	8	0	8	0	3	11	0	0
2	22994327	.	G	A	10	6	16	0	0	16	0	0
2	22996520	.	A	T	2	2	4	0	0	4	0	0
2	23001533	.	G	A	6	12	18	0	1	19	0	0
2	23001638	.	G	T	7	16	23	0	0	23	0	0
2	23013730	.	C	A	2	1	3	0	0	3	0	0
2	23023331	.	G	A	2	3	5	0	0	5	0	0
2	23023353	.	C	A	4	6	10	0	0	10	0	0
2	23023465	.	G	A	4	2	6	0	0	6	0	0
2	23023466	.	C	G	2	4	6	0	0	6	0	0
2	23023801	.	C	T	2	7	9	0	0	9	0	0
2	23023890	.	G	T	5	3	8	0	0	8	0	0
2	23024069	.	C	A	7	9	16	0	0	16	0	0
2	23024252	.	A	T	2	2	4	0	0	4	0	0
2	23066671	.	C	T	5	1	6	0	0	6	0	0
2	23077998	.	C	T	10	0	10	0	0	10	0	0
2	23078020	.	A	T	5	3	8	0	2	10	0	0
2	23078082	.	A	G	8	9	17	0	3	20	0	0
2	23085185	.	C	T	3	3	6	0	0	6	0	0
2	23085242	.	A	G	5	0	5	0	4	9	0	0
2	23090867	.	C	T	0	4	4	0	0	4	0	0
2	23098856	.	T	A	4	3	7	0	0	7	0	0
2	23099141	.	G	A	4	4	8	0	0	8	0	0
2	23099307	.	T	C	2	2	4	0	0	4	0	0
2	23099369	.	G	C	7	7	14	0	0	14	0	0
2	23223037	.	C	T	6	3	9	0	1	10	0	0
2	23232884	.	T	C	7	2	9	0	1	10	0	0
2	23263294	.	T	A	3	4	7	0	0	7	0	0
2	23292123	.	A	T	2	3	5	0	0	5	0	0
2	23292262	.	G	A	5	12	17	0	1	18	0	0
2	23292429	.	A	T	10	7	17	1	0	18	0	0
2	23292516	.	G	A	2	11	13	0	9	22	0	0
2	23292549	.	C	A	7	4	11	0	1	12	0	0
2	23292690	.	T	A	9	6	15	0	1	16	0	0
2	23292776	.	G	A	8	3	11	0	0	11	0	0
2	23293029	.	T	C	2	4	6	0	0	6	0	0
2	23293031	.	A	T	2	4	6	0	0	6	0	0
2	23293123	.	G	C	13	5	18	0	0	18	0	0
2	23293230	.	A	T	8	13	21	0	0	21	0	0
2	23361020	.	T	G	14	14	28	0	0	28	0	0
2	23361605	.	C	T	16	21	37	0	0	37	0	0
2	23361784	.	A	T	7	6	13	0	2	15	0	0
2	23379480	.	G	C	4	3	7	0	0	7	0	0
2	23379532	.	G	A	4	7	11	0	0	11	0	0
2	23379588	.	C	T	7	5	12	0	1	13	0	0
2	23380621	.	C	A	3	4	7	0	0	7	0	0
2	23381056	.	A	G	1	0	1	0	0	1	0	0
2	23701714	.	A	C	3	3	6	0	0	6	0	0
2	23701743	.	T	A	3	5	8	0	0	8	0	0
2	23714743	.	A	T	0	2	2	0	0	2	0	0
2	23716575	.	T	C	2	2	4	0	0	4	0	0
2	23716617	.	C	T	2	2	4	0	0	4	0	0
2	23722518	.	A	G	2	0	2	0	9	11	0	0
2	23722849	.	T	C	2	7	9	0	0	9	0	0
2	23723172	.	A	C	1	6	7	0	0	8	1	0
2	23723187	.	A	G	2	4	6	0	1	7	0	0
2	23723256	.	C	T	3	4	7	0	0	7	0	0
2	23723438	.	G	T	0	2	2	0	4	6	0	0
2	23723521	.	A	T	1	7	8	0	0	8	0	0
2	23723711	.	T	G	2	2	4	0	0	4	0	0
2	23724469	.	G	A	1	3	4	0	7	11	0	0
2	23724535	.	T	G	7	7	14	0	0	14	0	0
2	23725075	.	G	A	10	4	14	0	1	15	0	0
2	23725159	.	T	C	2	14	16	0	0	16	0	0
2	23725239	.	C	T	7	4	11	0	0	11	0	0
2	23725608	.	A	T	8	7	15	0	0	15	0	0
2	23726043	.	A	G	11	5	16	0	0	16	0	0
2	23726206	.	T	A	11	3	14	0	1	15	0	0
2	23726312	.	G	A	14	10	24	0	1	25	0	0
2	23794620	.	A	G	1	2	3	0	1	4	0	0
2	23794719	.	C	G	0	1	1	0	0	1	0	0
2	23804300	.	T	C	3	4	7	0	0	7	0	0
2	23804309	.	G	A	4	4	8	0	0	8	0	0
2	23804516	.	G	A	0	2	2	0	4	6	0	0
2	23804585	.	C	T	0	3	3	0	0	3	0	0
2	23804650	.	T	G	1	3	4	0	0	4	0	0
2	23816293	.	A	C	4	2	6	0	0	6	0	0
2	23818145	.	T	C	1	2	3	0	0	3	0	0
2	23818271	.	G	A	0	3	3	0	2	5	0	0
2	23818835	.	T	C	2	3	5	0	0	5	0	0
2	23819113	.	A	T	1	3	4	0	0	4	0	0
2	23819125	.	A	G	3	3	6	0	0	6	0	0
2	23819237	.	T	G	2	3	5	0	0	5	0	0
2	23819241	.	G	C	2	3	5	0	0	5	0	0
2	23819471	.	T	G	4	0	4	0	6	10	0	0
2	23819603	.	T	C	2	3	5	0	0	5	0	0
2	23819946	.	T	G	2	1	3	0	4	7	0	0
2	23937227	.	G	A	3	4	7	0	0	7	0	0
2	23937231	.	C	G	3	4	7	0	0	7	0	0
2	23937549	.	T	G	3	4	7	0	0	7	0	0
2	23943462	.	G	A	1	0	1	0	0	1	0	0
2	24188637	.	G	A	2	5	7	0	0	7	0	0
2	24199338	.	C	A	8	16	24	0	1	25	0	0
2	24218922	.	A	T	11	27	38	0	1	39	0	0
2	24218927	.	G	A	1	13	14	0	24	38	0	0
2	24222069	.	A	C	6	12	18	0	3	21	0	0
2	24223991	.	A	G	22	13	35	0	5	40	0	0
2	24238635	.	A	T	0	3	3	0	0	3	0	0
2	24248498	.	C	T	22	30	52	0	2	54	0	0
2	24249037	.	T	A	29	19	48	0	0	48	0	0
2	24249083	.	T	A	15	7	22	0	1	24	1	0
2	24249397	.	G	T	0	29	29	0	24	53	0	0
2	24249943	.	T	A	23	10	33	1	1	35	0	0
2	24249947	.	T	A	23	8	31	1	1	33	0	0
2	24250059	.	T	G	13	6	19	0	0	20	1	0
2	24250062	.	G	T	14	5	19	0	1	20	0	0
2	24250097	.	T	C	10	16	26	0	0	26	0	0
2	24250112	.	T	A	19	5	24	0	0	24	0	0
2	24250147	.	G	A	0	10	10	0	17	27	0	0
2	24250209	.	A	C	5	4	9	0	0	9	0	0
2	24250212	.	G	C	4	4	8	0	1	9	0	0
2	24250303	.	C	T	24	19	43	0	2	45	0	0
2	24250419	.	C	T	6	3	9	0	4	17	4	0
2	24250482	.	C	T	20	19	39	0	2	41	0	0
2	24250577	.	A	T	31	21	52	0	0	52	0	0
2	24250637	.	A	G	28	29	57	0	0	57	0	0
2	24250879	.	T	G	28	30	58	0	1	59	0	0
2	24250972	.	C	A	29	28	57	0	3	60	0	0
2	24251294	.	G	A	1	31	32	0	28	60	0	0
2	24251430	.	A	G	24	31	55	0	5	60	0	0
2	24251690	.	G	A	28	26	54	0	2	56	0	0
2	24251800	.	G	A	25	39	64	0	4	68	0	0
2	24251909	.	A	T	48	24	72	0	1	74	1	0
2	24252078	.	A	T	46	23	69	0	0	69	0	0
2	24252088	.	C	T	47	22	69	0	0	69	0	0
2	24252192	.	T	A	28	26	54	0	2	56	0	0
2	24252196	.	G	T	5	25	30	0	22	53	1	0
2	24252333	.	T	A	1	2	3	0	1	4	0	0
2	24310739	.	G	T	8	6	14	0	0	14	0	0
2	24310850	.	G	C	15	15	30	0	3	33	0	0
2	24310897	.	G	A	14	24	38	0	0	38	0	0
2	24311045	.	T	C	16	0	16	0	20	36	0	0
2	24311151	.	G	A	8	5	13	0	1	14	0	0
2	24311218	.	T	A	13	10	23	0	0	23	0	0
2	24311296	.	G	C	17	12	29	0	1	30	0	0
2	24311703	.	A	G	9	5	14	0	1	15	0	0
2	24311879	.	A	G	8	4	12	0	0	12	0	0
2	24313884	.	T	C	6	3	9	0	1	10	0	0
2	24313896	.	G	A	6	7	13	0	1	14	0	0
2	24314221	.	T	C	5	7	12	0	1	13	0	0
2	24316503	.	C	T	0	3	3	0	1	4	0	0
2	24317537	.	G	A	8	8	16	0	0	16	0	0
2	24319740	.	A	G	11	17	28	0	0	28	0	0
2	24319945	.	T	G	4	4	8	0	0	8	0	0
2	24320173	.	C	T	6	10	16	0	3	19	0	0
2	24321853	.	T	C	9	1	10	0	6	16	0	0
2	24322189	.	G	C	17	13	30	0	0	30	0	0
2	24326455	.	A	G	4	5	9	0	0	9	0	0
2	24326509	.	G	A	5	2	7	0	0	7	0	0
2	24331392	.	T	A	11	8	19	0	0	19	0	0
2	24335246	.	G	A	1	1	2	0	0	2	0	0
2	24382093	.	A	G	7	5	12	0	1	13	0	0
2	24385210	.	C	T	1	5	6	0	0	6	0	0
2	24385271	.	T	G	7	5	12	0	0	12	0	0
2	24385603	.	G	A	1	13	14	0	11	25	0	0
2	24385633	.	C	T	8	14	22	0	1	23	0	0
2	24385685	.	T	C	11	9	20	0	0	20	0	0
2	24385724	.	G	A	2	5	7	0	1	8	0	0
2	24385837	.	A	G	6	0	6	0	4	10	0	0
2	24386286	.	A	T	2	4	6	0	0	6	0	0
2	24410544	.	T	C	1	1	2	0	5	7	0	0
2	24410851	.	C	T	12	20	32	0	1	33	0	0
2	24410882	.	G	A	16	23	39	0	1	40	0	0
2	24411114	.	G	C	18	9	27	0	2	29	0	0
2	24411536	.	T	C	15	1	16	0	10	26	0	0
2	24411625	.	T	C	16	13	29	0	2	31	0	0
2	24411812	.	A	T	14	12	26	0	1	27	0	0
2	24411840	.	T	C	13	13	26	0	2	28	0	0
2	24412947	.	A	T	5	5	10	0	1	11	0	0
2	24413155	.	C	T	11	15	26	0	1	27	0	0
2	24414032	.	G	C	6	13	19	0	2	21	0	0
2	24414062	.	G	A	15	7	22	0	1	23	0	0
2	24421813	.	T	C	2	0	2	0	0	2	0	0
2	24421816	.	G	A	0	2	2	0	0	2	0	0
2	24432634	.	G	T	3	5	8	0	0	8	0	0
2	24432661	.	C	T	5	4	9	0	0	9	0	0
2	24444650	.	C	T	3	3	6	0	0	6	0	0
2	24508902	.	A	G	1	0	1	0	2	3	0	0
2	24541478	.	G	A	0	2	2	0	3	5	0	0
2	24558443	.	C	T	6	3	9	0	1	10	0	0
2	24558465	.	C	T	10	3	13	0	1	14	0	0
2	24559652	.	T	A	7	2	9	0	0	9	0	0
2	24560881	.	C	T	3	2	5	0	0	5	0	0
2	24565123	.	A	G	2	6	8	0	0	8	0	0
2	24650758	.	C	T	2	3	5	0	0	5	0	0
2	24663602	.	C	G	1	0	1	0	2	3	0	0
2	24672447	.	T	C	2	5	7	0	0	7	0	0
2	24677139	.	A	G	5	4	9	0	1	10	0	0
2	24683093	.	A	G	13	8	21	0	9	30	0	0
2	24683311	.	G	A	17	15	32	0	0	32	0	0
2	24701102	.	A	G	1	2	3	0	0	3	0	0
2	24737749	.	C	T	1	1	2	0	0	2	0	0
2	24737776	.	C	T	1	1	2	0	0	2	0	0
2	24740354	.	T	C	1	2	3	0	0	3	0	0
2	24740439	.	C	T	1	4	5	0	0	5	0	0
2	24740468	.	T	A	1	2	3	0	0	3	0	0
2	24743787	.	G	A	0	1	1	0	1	2	0	0
2	24748308	.	G	T	0	2	2	0	5	7	0	0
2	24749403	.	G	A	3	2	5	0	1	6	0	0
2	24749467	.	G	A	5	6	11	0	1	12	0	0
2	24749582	.	T	C	2	9	11	0	2	13	0	0
2	24750869	.	C	T	1	2	3	0	0	3	0	0
2	24751165	.	T	C	5	2	7	0	0	7	0	0
2	24751526	.	G	A	0	3	3	0	1	4	0	0
2	24751888	.	A	G	5	0	5	0	3	8	0	0
2	24751948	.	C	T	3	7	10	0	0	10	0	0
2	24751991	.	A	G	2	6	8	0	2	10	0	0
2	24752048	.	C	T	6	6	12	0	1	13	0	0
2	24752181	.	T	A	3	10	13	0	0	13	0	0
2	24752193	.	C	T	2	9	11	0	2	13	0	0
2	24752247	.	A	G	9	5	14	0	1	15	0	0
2	24752293	.	C	T	10	7	17	0	0	17	0	0
2	24752385	.	C	T	7	10	17	0	0	17	0	0
2	24753062	.	T	C	5	13	18	0	1	19	0	0
2	24753253	.	T	C	2	1	3	0	0	3	0	0
2	24753269	.	G	A	0	4	4	0	3	7	0	0
2	24753423	.	A	G	0	11	11	0	0	11	0	0
2	24753425	.	G	A	7	3	10	0	1	11	0	0
2	24753917	.	C	T	6	3	9	0	1	10	0	0
2	24754043	.	G	T	4	7	11	0	0	11	0	0
2	24754044	.	T	A	4	7	11	0	0	11	0	0
2	24754465	.	A	G	1	4	5	0	0	5	0	0
2	24754783	.	C	T	14	17	31	0	2	33	0	0
2	24754796	.	A	C	19	12	31	0	3	34	0	0
2	24755018	.	T	C	20	6	26	0	1	27	0	0
2	24766941	.	G	A	3	1	4	0	0	4	0	0
2	24767291	.	C	T	2	3	5	0	0	5	0	0
2	24770755	.	G	C	1	2	3	0	0	3	0	0
2	24863918	.	T	G	2	2	4	0	0	4	0	0
2	24864372	.	A	G	4	4	8	0	0	8	0	0
2	24864376	.	A	G	6	2	8	0	0	8	0	0
2	24864536	.	A	T	5	6	11	0	0	11	0	0
2	24864570	.	A	T	4	4	8	0	1	9	0	0
2	24865360	.	T	C	4	6	10	0	0	10	0	0
2	24866568	.	C	T	3	4	7	0	0	7	0	0
2	24876864	.	T	A	6	3	9	0	2	11	0	0
2	24877010	.	A	G	11	9	20	0	2	22	0	0
2	24877227	.	C	T	16	5	21	0	1	22	0	0
2	24877879	.	T	C	4	7	11	0	0	11	0	0
2	24877900	.	T	A	3	11	14	0	0	14	0	0
2	24878211	.	C	T	15	10	25	0	0	25	0	0
2	24878332	.	A	G	7	5	12	0	0	12	0	0
2	24943482	.	G	T	9	7	16	0	1	17	0	0
2	24943536	.	C	T	5	8	13	0	0	13	0	0
2	24943660	.	T	C	1	5	6	0	1	7	0	0
2	24943689	.	C	T	6	9	15	0	1	16	0	0
2	24943717	.	C	T	15	7	22	0	2	24	0	0
2	24943891	.	A	T	14	10	24	0	2	26	0	0
2	24943916	.	T	C	15	8	23	0	1	24	0	0
2	24943971	.	A	T	14	7	21	0	4	25	0	0
2	24944317	.	A	G	9	8	17	0	1	18	0	0
2	24944415	.	C	T	8	17	25	0	1	26	0	0
2	24944644	.	A	G	9	6	15	0	0	15	0	0
2	24947129	.	G	T	3	2	5	0	0	5	0	0
2	24958705	.	A	G	0	1	1	0	0	1	0	0
2	24958712	.	T	G	0	1	1	0	0	1	0	0
2	24964416	.	C	A	2	2	4	0	0	4	0	0
2	24964424	.	C	T	2	2	4	0	0	4	0	0
2	24969756	.	G	A	2	2	4	0	0	4	0	0
2	24970042	.	C	T	0	2	2	0	2	4	0	0
2	24970127	.	T	A	1	4	5	0	2	7	0	0
2	24990555	.	G	A	2	3	5	0	0	5	0	0
2	24990558	.	C	G	2	3	5	0	0	5	0	0
2	24991149	.	G	A	14	11	25	0	1	26	0	0
2	24991153	.	T	C	13	11	24	0	4	28	0	0
2	24991476	.	G	A	18	18	36	0	1	37	0	0
2	24991639	.	G	A	19	14	33	0	3	36	0	0
2	24991825	.	G	A	20	14	34	0	0	34	0	0
2	24992185	.	T	C	11	7	18	0	1	19	0	0
2	24992242	.	C	T	0	9	9	0	14	23	0	0
2	24992368	.	T	C	6	14	20	0	2	22	0	0
2	24992464	.	C	T	10	19	29	0	5	34	0	0
2	24992536	.	C	G	7	7	14	0	1	15	0	0
2	24992584	.	G	A	1	2	3	0	0	3	0	0
2	24996241	.	C	T	5	2	7	0	0	7	0	0
2	24996402	.	G	C	10	6	16	0	1	17	0	0
2	25094623	.	C	T	1	1	2	0	0	2	0	0
2	25094630	.	C	T	1	1	2	0	0	2	0	0
2	25102571	.	C	T	9	2	11	0	0	11	0	0
2	25105482	.	G	A	1	2	3	0	0	3	0	0
2	25105586	.	C	T	4	6	10	0	1	11	0	0
2	25105612	.	T	C	4	6	10	0	1	11	0	0
2	25105681	.	G	T	8	5	13	0	0	13	0	0
2	25105683	.	C	T	8	5	13	0	0	13	0	0
2	25106020	.	T	C	5	5	10	0	1	11	0	0
2	25106310	.	A	T	1	3	4	0	0	4	0	0
2	25106359	.	C	A	3	3	6	0	0	6	0	0
2	25106380	.	A	G	2	7	9	0	2	11	0	0
2	25106402	.	C	A	5	14	19	0	0	19	0	0
2	25106772	.	T	A	4	5	9	0	0	9	0	0
2	25106795	.	G	A	4	6	10	0	1	11	0	0
2	25106874	.	A	C	2	6	8	0	0	8	0	0
2	25106952	.	C	T	5	3	8	0	0	8	0	0
2	25106984	.	A	T	2	2	4	0	0	4	0	0
2	25107571	.	G	T	6	2	8	0	0	8	0	0
2	25107673	.	T	G	8	7	15	0	1	16	0	0
2	25107717	.	C	G	10	9	19	0	1	20	0	0
2	25107891	.	G	T	7	15	22	0	1	23	0	0
2	25107942	.	C	A	14	10	24	0	0	24	0	0
2	25108039	.	C	T	12	8	20	0	0	20	0	0
2	25108050	.	T	A	11	7	18	0	1	19	0	0
2	25108104	.	A	G	11	11	22	0	0	22	0	0
2	25108377	.	T	A	5	8	13	0	0	13	0	0
2	25108597	.	T	A	2	2	4	0	0	4	0	0
2	25108633	.	C	T	0	4	4	0	7	11	0	0
2	25113163	.	A	G	1	4	5	0	0	5	0	0
2	25113448	.	A	G	0	0	0	0	1	1	0	0
2	25124683	.	A	C	2	2	4	0	0	4	0	0
2	25125073	.	G	A	3	2	5	0	1	6	0	0
2	25125318	.	C	T	1	2	3	0	0	3	0	0
2	25126591	.	A	G	1	2	3	0	0	3	0	0
2	25127042	.	G	T	5	5	10	0	0	10	0	0
2	25127132	.	C	A	4	5	9	0	1	10	0	0
2	25127219	.	T	C	4	2	6	0	1	7	0	0
2	25128328	.	G	A	3	4	7	0	0	7	0	0
2	25128581	.	T	C	7	6	13	0	0	13	0	0
2	25128595	.	A	T	7	7	14	0	0	14	0	0
2	25128668	.	C	T	11	6	17	0	2	19	0	0
2	25247457	.	A	G	1	0	1	0	3	4	0	0
2	25247634	.	A	G	2	3	5	0	0	5	0	0
2	25247755	.	T	A	2	2	4	0	0	4	0	0
2	25247769	.	A	C	2	1	3	0	0	3	0	0
2	25291113	.	G	T	1	2	3	0	0	3	0	0
2	25291177	.	G	T	2	5	7	0	0	7	0	0
2	25540429	.	G	A	0	3	3	0	1	4	0	0
2	25540582	.	C	T	3	3	6	0	0	6	0	0
2	25540691	.	T	A	4	6	10	0	1	11	0	0
2	25541074	.	A	C	2	0	2	0	0	2	0	0
2	25541483	.	T	C	0	5	5	0	1	6	0	0
2	25541488	.	T	C	2	4	6	0	1	7	0	0
2	25542867	.	A	T	4	2	6	0	1	7	0	0
2	25542890	.	C	A	7	1	8	0	3	11	0	0
2	25772113	.	G	A	3	3	6	0	2	8	0	0
2	25781640	.	C	T	4	3	7	0	0	7	0	0
2	25787553	.	G	C	2	3	5	0	0	5	0	0
2	25794226	.	A	G	0	2	2	0	0	2	0	0
2	25794241	.	C	A	1	3	4	0	0	4	0	0
2	25797439	.	C	T	1	6	7	0	0	7	0	0
2	25797472	.	C	T	2	3	5	0	1	6	0	0
2	25798647	.	A	G	2	3	5	0	0	5	0	0
2	25809736	.	C	T	2	0	2	0	0	2	0	0
2	25814694	.	C	T	7	4	11	0	0	11	0	0
2	25815329	.	G	C	7	4	11	0	1	12	0	0
2	25815452	.	G	A	3	14	17	0	2	19	0	0
2	25815737	.	G	T	6	2	8	0	1	9	0	0
2	25815780	.	T	G	4	3	7	0	0	7	0	0
2	25816321	.	C	T	7	7	14	0	1	15	0	0
2	25843922	.	G	A	0	11	11	0	13	24	0	0
2	25844840	.	C	T	23	14	37	1	2	40	0	0
2	25844986	.	T	A	17	17	34	0	1	35	0	0
2	25952983	.	C	T	2	1	3	0	0	3	0	0
2	25984970	.	C	T	7	5	12	0	0	12	0	0
2	25985159	.	G	A	0	3	3	0	10	13	0	0
2	25985234	.	G	A	3	5	8	0	1	9	0	0
2	25985405	.	C	T	2	6	8	0	0	8	0	0
2	25985409	.	C	T	2	6	8	0	0	8	0	0
2	25988269	.	A	G	14	11	25	0	1	26	0	0
2	25988378	.	C	A	6	10	16	0	2	18	0	0
2	25988414	.	G	A	0	8	8	0	14	22	0	0
2	25988475	.	C	T	6	8	14	0	0	14	0	0
2	25988551	.	A	T	10	4	14	0	0	14	0	0
2	25988846	.	A	G	11	1	12	0	12	24	0	0
2	25989059	.	G	A	0	11	11	0	8	19	0	0
2	25989610	.	C	T	15	17	32	0	1	33	0	0
2	25989827	.	C	T	6	8	14	0	0	14	0	0
2	25989884	.	T	A	4	6	10	0	0	10	0	0
2	25989905	.	C	A	4	6	10	0	1	11	0	0
2	25989994	.	A	G	16	9	25	0	2	27	0	0
2	25990323	.	G	A	19	12	31	0	1	32	0	0
2	25990337	.	A	G	18	16	34	0	1	35	0	0
2	25990522	.	A	C	8	9	17	0	1	18	0	0
2	25990563	.	A	G	9	5	14	0	1	15	0	0
2	25990702	.	G	A	25	10	35	0	1	36	0	0
2	25990777	.	T	G	5	3	8	2	0	10	0	0
2	26156108	.	C	G	0	1	1	0	0	1	0	0
2	26179183	.	G	A	1	2	3	0	0	3	0	0
2	26179223	.	C	T	2	2	4	0	0	4	0	0
2	26207944	.	T	C	15	14	29	0	0	29	0	0
2	26207977	.	G	A	0	11	11	0	15	26	0	0
2	26208369	.	A	G	11	3	14	0	0	14	0	0
2	26208416	.	G	A	9	7	16	0	0	16	0	0
2	26208425	.	G	A	10	7	17	0	1	18	0	0
2	26208480	.	A	C	4	8	12	0	2	14	0	0
2	26208520	.	A	G	4	9	13	0	2	15	0	0
2	26208589	.	A	G	13	8	21	0	0	21	0	0
2	26208621	.	T	C	16	6	22	0	1	23	0	0
2	26208668	.	T	G	12	1	13	0	10	23	0	0
2	26208815	.	G	T	13	13	26	0	1	27	0	0
2	26208832	.	C	G	17	1	18	0	13	31	0	0
2	26208904	.	T	C	14	17	31	0	0	31	0	0
2	26208987	.	G	A	0	11	11	0	21	32	0	0
2	26209030	.	G	A	16	8	24	0	0	24	0	0
2	26209058	.	C	T	11	10	21	0	1	22	0	0
2	26209266	.	A	C	5	3	8	0	0	8	0	0
2	26240771	.	A	T	20	23	43	0	3	46	0	0
2	26240930	.	A	T	9	16	25	0	1	26	0	0
2	26282688	.	C	T	29	21	50	0	5	55	0	0
2	26283723	.	A	G	5	23	28	0	0	28	0	0
2	26299479	.	C	T	3	0	3	0	0	3	0	0
2	26303684	.	T	A	2	4	6	0	1	7	0	0
2	26303689	.	A	T	0	5	5	0	0	5	0	0
2	26303831	.	C	T	3	6	9	0	0	9	0	0
2	26303845	.	A	C	6	3	9	0	0	9	0	0
2	26303905	.	C	A	2	4	6	0	2	8	0	0
2	26304008	.	C	A	4	2	6	0	1	7	0	0
2	26304066	.	T	C	8	5	13	0	0	13	0	0
2	26443146	.	G	T	16	12	28	0	2	31	1	0
2	26443517	.	T	C	4	4	8	0	0	8	0	0
2	26443859	.	A	G	9	11	20	0	0	20	0	0
2	26463193	.	A	C	4	0	4	0	6	10	0	0
2	26463199	.	C	A	5	4	9	0	1	10	0	0
2	26463309	.	C	T	5	12	17	0	2	19	0	0
2	26463534	.	C	A	5	9	14	0	0	14	0	0
2	26463598	.	T	C	5	0	5	0	3	8	0	0
2	26467131	.	T	G	5	3	8	0	0	8	0	0
2	26467150	.	G	A	4	2	6	0	0	6	0	0
2	26468683	.	A	G	1	2	3	0	0	3	0	0
2	26470087	.	A	G	2	7	9	0	0	9	0	0
2	26470208	.	G	A	18	21	39	0	1	40	0	0
2	26470237	.	G	T	15	20	35	0	0	35	0	0
2	26470267	.	G	A	14	19	33	0	2	35	0	0
2	26470537	.	C	T	12	9	21	0	1	22	0	0
2	26470636	.	C	T	1	15	16	0	21	37	0	0
2	26470666	.	A	G	19	18	37	0	0	37	0	0
2	26473106	.	T	C	5	3	8	0	1	9	0	0
2	26473361	.	C	T	6	2	8	0	0	8	0	0
2	26476109	.	G	A	1	2	3	0	0	3	0	0
2	26479799	.	C	T	2	3	5	0	1	6	0	0
2	26479824	.	T	C	1	2	3	0	0	3	0	0
2	26481029	.	C	T	2	1	3	0	0	3	0	0
2	26483946	.	G	T	4	5	9	0	0	9	0	0
2	26491457	.	G	C	3	3	6	0	1	7	0	0
2	26491667	.	G	A	2	3	5	0	0	5	0	0
2	26491676	.	A	T	4	1	5	0	0	5	0	0
2	26494507	.	G	A	3	3	6	0	0	6	0	0
2	26500899	.	G	A	38	31	69	0	4	73	0	0
2	26576855	.	A	G	1	2	3	0	0	3	0	0
2	26577378	.	A	G	9	5	14	0	0	14	0	0
2	26583609	.	G	A	0	2	2	0	0	2	0	0
2	26583666	.	A	G	7	3	10	0	1	11	0	0
2	26602115	.	A	T	0	1	1	0	0	1	0	0
2	26610677	.	T	C	0	3	3	0	0	3	0	0
2	26610852	.	G	A	5	2	7	0	0	7	0	0
2	26612624	.	G	C	9	8	17	0	1	18	0	0
2	26612676	.	A	T	13	11	24	0	0	24	0	0
2	26613106	.	G	A	16	30	46	0	4	50	0	0
2	26619786	.	C	T	9	11	20	0	0	20	0	0
2	26620441	.	C	T	4	9	13	0	1	14	0	0
2	26623587	.	C	T	13	19	32	0	1	33	0	0
2	26623832	.	T	C	11	15	26	0	3	29	0	0
2	26627301	.	C	A	15	10	25	0	0	25	0	0
2	26627332	.	T	A	5	2	7	0	1	8	0	0
2	26630855	.	A	G	13	11	24	0	0	24	0	0
2	26652852	.	C	T	1	2	3	0	0	3	0	0
2	26656349	.	G	A	0	4	4	0	3	7	0	0
2	26662047	.	G	C	2	4	6	0	0	6	0	0
2	26665081	.	A	G	9	7	16	0	0	16	0	0
2	26665155	.	A	T	10	3	13	0	2	15	0	0
2	26665233	.	G	A	7	4	11	0	2	13	0	0
2	26665375	.	A	G	3	4	7	0	1	8	0	0
2	26665631	.	A	T	9	6	15	0	0	15	0	0
2	26672488	.	A	G	12	7	19	0	2	21	0	0
2	26672761	.	T	G	10	0	10	0	5	15	0	0
2	26672800	.	G	A	2	2	4	0	1	5	0	0
2	26676807	.	T	A	3	3	6	0	1	7	0	0
2	26677109	.	T	A	6	3	9	0	1	10	0	0
2	26677125	.	C	G	3	6	9	0	1	10	0	0
2	26677283	.	C	G	1	4	5	0	1	6	0	0
2	26677346	.	T	G	2	7	9	0	0	9	0	0
2	26677512	.	A	T	6	4	10	0	0	10	0	0
2	26677513	.	G	A	6	4	10	0	0	10	0	0
2	26680370	.	C	T	4	2	6	0	0	6	0	0
2	26680759	.	T	A	4	6	10	0	0	10	0	0
2	26680762	.	C	T	3	7	10	0	0	10	0	0
2	26680801	.	A	T	2	6	8	0	0	8	0	0
2	26681064	.	A	T	6	6	12	0	0	12	0	0
2	26681219	.	T	A	3	6	9	0	0	9	0	0
2	26682031	.	G	T	0	8	8	0	10	18	0	0
2	26684689	.	A	G	2	2	4	0	0	4	0	0
2	26686752	.	T	C	3	8	11	0	0	11	0	0
2	27000575	.	G	T	1	2	3	0	0	3	0	0
2	27049123	.	C	A	2	1	3	0	0	3	0	0
2	27075702	.	G	A	3	2	5	0	0	5	0	0
2	27075980	.	G	A	0	12	12	0	5	17	0	0
2	27075992	.	A	T	13	7	20	0	0	20	0	0
2	27094393	.	C	T	6	6	12	0	0	12	0	0
2	27378439	.	A	G	4	0	4	0	6	10	0	0
2	27380366	.	C	A	0	6	6	0	4	10	0	0
2	27382232	.	C	G	3	1	4	0	0	4	0	0
2	27382489	.	G	A	0	1	1	0	1	2	0	0
2	27382516	.	A	G	2	2	4	0	0	4	0	0
2	27532523	.	A	G	2	3	5	0	0	5	0	0
2	27538619	.	G	A	4	3	7	0	2	9	0	0
2	27540458	.	C	T	8	11	19	0	1	20	0	0
2	27541512	.	A	G	2	4	6	0	0	6	0	0
2	27541740	.	C	T	15	7	22	0	0	22	0	0
2	27541743	.	A	G	16	6	22	0	0	22	0	0
2	27541778	.	G	T	7	10	17	0	3	20	0	0
2	27542058	.	A	G	13	0	13	0	10	23	0	0
2	27542721	.	C	T	11	10	21	0	0	21	0	0
2	27542856	.	G	A	0	14	14	0	6	20	0	0
2	27543103	.	A	T	12	9	21	0	1	22	0	0
2	27543212	.	T	A	14	9	23	0	1	24	0	0
2	27543478	.	G	A	1	3	4	0	13	17	0	0
2	27543499	.	C	A	11	8	19	0	2	21	0	0
2	27614082	.	G	C	1	0	1	0	0	1	0	0
2	27636010	.	G	C	4	4	8	0	0	8	0	0
2	27641130	.	G	A	6	3	9	0	0	9	0	0
2	27641159	.	T	C	3	0	3	0	2	5	0	0
2	27641349	.	G	T	0	3	3	0	0	3	0	0
2	27642776	.	C	G	2	3	5	0	0	5	0	0
2	27646157	.	A	C	4	2	6	0	0	6	0	0
2	27646419	.	G	A	5	2	7	0	0	7	0	0
2	27646430	.	T	A	3	2	5	0	0	5	0	0
2	27658566	.	A	G	3	5	8	0	0	8	0	0
2	27658579	.	C	T	6	3	9	0	1	10	0	0
2	27658973	.	T	G	2	7	9	0	1	10	0	0
2	27662374	.	C	T	6	4	10	0	0	10	0	0
2	27662706	.	T	C	0	5	5	0	0	5	0	0
2	27663345	.	A	G	3	2	5	0	0	5	0	0
2	27663435	.	C	T	7	3	10	0	0	10	0	0
2	27663666	.	G	T	6	11	17	0	0	18	1	0
2	27663672	.	C	T	7	9	16	0	1	17	0	0
2	27663785	.	C	A	5	2	7	0	0	7	0	0
2	27664105	.	G	C	1	7	8	0	0	8	0	0
2	27664202	.	T	C	2	6	8	0	0	8	0	0
2	27664215	.	A	C	2	3	5	0	1	6	0	0
2	27664317	.	G	T	9	5	14	0	0	14	0	0
2	27670767	.	T	C	5	2	7	0	0	7	0	0
2	27670769	.	T	C	4	3	7	0	0	7	0	0
2	27670836	.	C	T	1	11	12	0	12	24	0	0
2	27670884	.	T	G	13	14	27	0	1	28	0	0
2	27670973	.	G	A	10	3	13	0	1	14	0	0
2	27671172	.	C	T	15	13	28	0	0	28	0	0
2	27671290	.	G	T	13	4	17	0	3	20	0	0
2	27671334	.	T	C	16	7	23	0	0	23	0	0
2	27671485	.	A	T	10	4	14	0	1	15	0	0
2	27671486	.	G	A	10	5	15	0	0	15	0	0
2	27671623	.	A	T	12	10	22	0	1	23	0	0
2	27671650	.	C	A	0	4	4	0	12	16	0	0
2	27671681	.	G	T	12	8	20	0	0	20	0	0
2	27671704	.	C	T	13	9	22	0	1	23	0	0
2	27671724	.	G	A	14	13	27	0	0	27	0	0
2	27672215	.	G	T	7	13	20	0	0	20	0	0
2	27672426	.	T	C	7	8	15	0	0	15	0	0
2	27672440	.	C	T	0	11	11	0	5	16	0	0
2	27672535	.	C	T	7	10	17	0	2	19	0	0
2	27672636	.	C	T	4	8	12	0	1	13	0	0
2	27673041	.	A	G	8	11	19	0	0	19	0	0
2	27673080	.	G	A	10	5	15	0	0	15	0	0
2	27673148	.	G	A	6	5	11	0	0	11	0	0
2	27673173	.	A	G	8	4	12	0	0	12	0	0
2	27774370	.	G	A	3	5	8	0	2	10	0	0
2	27812578	.	G	A	2	0	2	0	0	2	0	0
2	27843845	.	G	A	3	5	8	0	0	8	0	0
2	27843937	.	A	G	1	4	5	0	0	5	0	0
2	27845694	.	G	A	4	2	6	0	0	6	0	0
2	27846071	.	G	A	4	5	9	0	0	9	0	0
2	27933143	.	C	T	3	5	8	0	0	8	0	0
2	27933215	.	C	A	2	5	7	0	1	8	0	0
2	27933260	.	C	A	2	4	6	0	0	6	0	0
2	27933764	.	G	T	2	3	5	0	0	5	0	0
2	27957786	.	T	A	2	4	6	0	0	6	0	0
2	27963660	.	G	A	4	2	6	0	0	6	0	0
2	27963686	.	C	T	0	3	3	0	5	8	0	0
2	27966602	.	C	T	0	2	2	0	2	4	0	0
2	27966636	.	C	T	2	4	6	0	0	6	0	0
2	28049696	.	C	T	11	8	19	0	0	19	0	0
2	28049996	.	A	G	13	8	21	0	0	21	0	0
2	28050058	.	C	A	9	4	13	0	0	13	0	0
2	28050243	.	T	C	8	0	8	0	12	20	0	0
2	28050565	.	T	A	7	3	10	0	0	10	0	0
2	28050600	.	G	C	8	0	8	0	4	12	0	0
2	28050759	.	A	G	6	7	13	0	0	13	0	0
2	28050921	.	G	T	7	7	14	0	0	14	0	0
2	28050933	.	G	A	7	5	12	0	0	12	0	0
2	28051041	.	T	A	7	13	20	0	1	21	0	0
2	28051092	.	C	T	0	18	18	0	7	25	0	0
2	28051104	.	G	A	4	17	21	0	1	22	0	0
2	28057518	.	G	A	9	7	16	0	0	16	0	0
2	28077152	.	C	A	0	2	2	0	0	2	0	0
2	28650309	.	A	T	5	1	6	0	1	7	0	0
2	28650320	.	G	A	4	2	6	0	0	6	0	0
2	28650422	.	T	C	5	5	10	0	3	13	0	0
2	28650504	.	T	C	2	5	7	0	0	7	0	0
2	28650612	.	T	G	10	9	19	0	1	20	0	0
2	28650629	.	G	T	9	12	21	0	1	22	0	0
2	28651128	.	T	A	9	17	26	0	0	26	0	0
2	28651193	.	A	G	9	13	22	0	0	22	0	0
2	28651497	.	G	A	4	3	7	0	0	7	0	0
2	28653707	.	C	G	0	2	2	0	0	2	0	0
2	28657927	.	G	T	0	1	1	0	0	1	0	0
2	28910813	.	C	G	0	1	1	0	0	1	0	0
2	28930100	.	T	C	6	6	12	0	0	12	0	0
2	28933846	.	T	G	6	1	7	0	0	7	0	0
2	28934011	.	C	T	9	10	19	0	0	19	0	0
2	28934152	.	T	C	6	7	13	0	0	13	0	0
2	29289068	.	G	T	0	2	2	0	1	3	0	0
2	29317718	.	G	A	5	9	14	0	0	14	0	0
2	29352279	.	G	A	0	14	14	0	10	24	0	0
2	29352379	.	A	C	8	8	16	0	1	17	0	0
2	29352411	.	A	C	5	8	13	0	0	13	0	0
2	29352481	.	G	C	7	5	12	0	0	12	0	0
2	29352579	.	T	C	7	7	14	0	0	14	0	0
2	29352673	.	C	T	9	9	18	0	1	19	0	0
2	29477653	.	T	C	21	14	35	0	2	37	0	0
2	29477733	.	A	T	20	17	37	0	1	38	0	0
2	29477769	.	G	T	17	16	33	0	1	34	0	0
2	29482390	.	G	A	5	4	9	0	0	9	0	0
2	29482417	.	A	G	5	4	9	0	0	9	0	0
2	29485046	.	G	A	2	4	6	0	1	7	0	0
2	29485068	.	G	T	6	2	8	0	0	8	0	0
2	29638529	.	T	C	2	2	4	0	0	4	0	0
2	30568944	.	A	T	5	9	14	0	0	14	0	0
2	30568959	.	C	T	4	9	13	0	0	13	0	0
2	30574092	.	C	T	0	4	4	0	7	11	0	0
2	30586847	.	G	C	1	3	4	0	0	4	0	0
2	30611283	.	G	T	5	4	9	0	0	9	0	0
2	30613764	.	G	A	4	3	7	0	0	7	0	0
2	30614153	.	C	A	7	5	12	0	1	13	0	0
2	30614370	.	T	G	2	3	5	0	1	6	0	0
2	30618155	.	C	T	4	1	5	0	0	5	0	0
2	30693635	.	G	A	1	5	6	0	0	6	0	0
2	30741192	.	C	T	2	8	10	0	0	10	0	0
2	30743041	.	T	C	6	4	10	0	0	10	0	0
2	30743864	.	A	G	11	6	17	0	3	20	0	0
2	30743907	.	T	C	14	10	24	0	3	27	0	0
2	30743951	.	C	A	4	2	6	0	1	7	0	0
2	30752675	.	C	T	1	3	4	0	0	4	0	0
2	30753072	.	A	T	13	12	25	0	1	26	0	0
2	30753273	.	G	A	13	11	24	0	1	25	0	0
2	30753888	.	A	G	8	7	15	0	1	16	0	0
2	30753899	.	C	T	9	6	15	0	0	15	0	0
2	30753928	.	G	A	5	9	14	0	1	15	0	0
2	30753991	.	A	G	4	7	11	0	1	12	0	0
2	30754030	.	A	T	7	8	15	0	0	15	0	0
2	30754113	.	T	C	9	14	23	0	1	24	0	0
2	30754196	.	G	A	15	16	31	0	0	31	0	0
2	30754300	.	C	T	20	12	32	0	0	32	0	0
2	30754306	.	G	A	12	17	29	0	3	32	0	0
2	30754346	.	A	G	15	20	35	0	1	36	0	0
2	30754432	.	G	T	17	13	30	0	1	31	0	0
2	30754733	.	A	G	13	5	18	0	1	19	0	0
2	30754741	.	A	G	11	7	18	0	2	20	0	0
2	30754777	.	A	T	4	11	15	0	2	17	0	0
2	30754793	.	A	T	4	11	15	0	0	15	0	0
2	30755195	.	G	A	3	3	6	0	0	6	0	0
2	30755359	.	A	T	2	10	12	1	1	14	0	0
2	30755522	.	G	T	4	3	7	0	0	7	0	0
2	30762969	.	G	A	1	1	2	0	0	2	0	0
2	30846870	.	C	A	2	3	5	0	0	5	0	0
2	31638004	.	C	T	0	2	2	0	0	2	0	0
2	31891344	.	T	A	4	25	29	0	0	31	2	0
2	32392166	.	A	G	0	6	6	0	0	6	0	0
2	32392314	.	C	T	2	2	4	0	0	4	0	0
2	32392787	.	C	A	1	3	4	0	4	8	0	0
2	32392988	.	T	C	3	5	8	0	0	8	0	0
2	32393101	.	A	G	3	6	9	0	1	10	0	0
2	32393125	.	C	T	0	3	3	0	3	6	0	0
2	32393259	.	A	G	4	4	8	0	0	8	0	0
2	32393281	.	T	A	5	5	10	0	1	11	0	0
2	32393321	.	A	G	5	2	7	0	0	7	0	0
2	32393460	.	C	T	0	3	3	0	10	13	0	0
2	32393579	.	T	C	3	3	6	0	0	6	0	0
2	32393731	.	G	A	6	6	12	0	0	12	0	0
2	32393834	.	C	T	0	2	2	0	2	4	0	0
2	32393918	.	A	T	5	2	7	0	0	7	0	0
2	32396773	.	A	G	1	1	2	0	0	2	0	0
2	32396845	.	C	T	0	2	2	0	4	6	0	0
2	32475941	.	A	T	3	4	7	0	0	7	0	0
2	32477432	.	T	C	12	12	24	0	1	25	0	0
2	32483020	.	C	G	3	7	10	0	0	10	0	0
2	32485832	.	A	G	6	5	11	0	1	12	0	0
2	32485895	.	C	T	0	8	8	0	7	15	0	0
2	32485962	.	G	A	6	13	19	0	1	20	0	0
2	32485999	.	A	G	10	5	15	0	1	16	0	0
2	32494486	.	G	A	12	11	23	0	0	23	0	0
2	32494705	.	C	T	0	1	1	0	0	1	0	0
2	32494720	.	G	A	1	0	1	0	0	1	0	0
2	32505664	.	G	A	5	7	12	0	2	14	0	0
2	32507094	.	C	T	4	2	6	0	0	6	0	0
2	32507218	.	G	A	2	3	5	0	0	5	0	0
2	32508418	.	C	A	1	1	2	0	0	2	0	0
2	32509238	.	T	G	8	9	17	0	0	17	0	0
2	32509247	.	G	A	10	8	18	0	0	18	0	0
2	32509309	.	G	T	3	4	7	0	0	7	0	0
2	32509573	.	G	A	5	7	12	0	0	12	0	0
2	32509636	.	C	T	1	3	4	0	0	4	0	0
2	32515861	.	C	T	0	15	15	0	5	20	0	0
2	32516110	.	T	C	3	9	12	0	4	16	0	0
2	32516359	.	A	T	7	6	13	0	0	13	0	0
2	32516469	.	T	C	8	0	8	0	14	22	0	0
2	32519690	.	G	A	10	6	16	0	3	19	0	0
2	32531232	.	C	T	0	1	1	0	1	2	0	0
2	32558621	.	G	A	5	4	9	0	0	9	0	0
2	32561752	.	A	G	8	5	13	0	1	14	0	0
2	32561754	.	G	A	8	6	14	0	0	14	0	0
2	32562059	.	G	A	9	9	18	0	0	18	0	0
2	32569639	.	G	A	9	10	19	0	0	19	0	0
2	32569717	.	A	G	10	5	15	0	1	16	0	0
2	32569745	.	A	G	4	10	14	0	1	15	0	0
2	32569909	.	T	C	5	0	5	0	4	9	0	0
2	32569930	.	G	A	3	6	9	0	0	9	0	0
2	32577939	.	G	A	3	3	6	0	1	7	0	0
2	32578124	.	A	T	12	10	22	0	0	22	0	0
2	32578230	.	C	T	13	14	27	0	1	28	0	0
2	32578330	.	A	G	6	10	16	0	1	17	0	0
2	32578539	.	C	G	1	7	8	0	0	8	0	0
2	32578580	.	C	A	11	9	20	0	0	21	1	0
2	32578677	.	C	A	7	9	16	0	0	16	0	0
2	32579170	.	C	A	4	0	4	0	0	4	0	0
2	32583144	.	A	G	6	11	17	0	0	17	0	0
2	32583162	.	T	A	11	7	18	0	0	18	0	0
2	32583209	.	C	T	4	9	13	0	2	15	0	0
2	32583345	.	C	T	4	7	11	0	1	12	0	0
2	32583411	.	C	A	0	9	9	0	10	19	0	0
2	32583453	.	T	A	4	10	14	0	2	16	0	0
2	32583459	.	A	G	5	8	13	0	0	13	0	0
2	32583629	.	A	C	1	0	1	0	6	7	0	0
2	32583639	.	T	C	0	0	0	0	7	7	0	0
2	32583681	.	T	A	1	1	2	0	0	2	0	0
2	32583687	.	G	A	1	1	2	0	0	2	0	0
2	32584548	.	C	T	0	2	2	0	0	2	0	0
2	32591488	.	C	A	2	2	4	0	0	4	0	0
2	32594670	.	A	T	1	4	5	0	0	5	0	0
2	32594699	.	T	A	2	2	4	0	0	4	0	0
2	32642909	.	A	T	1	0	1	0	0	1	0	0
2	32654052	.	G	C	1	0	1	0	7	8	0	0
2	32665798	.	G	A	3	2	5	0	0	5	0	0
2	32666565	.	C	T	0	1	1	0	0	1	0	0
2	32667941	.	C	A	0	8	8	0	7	15	0	0
2	32676228	.	T	A	2	8	10	0	1	11	0	0
2	32676482	.	A	C	2	3	5	0	1	6	0	0
2	32680338	.	C	T	2	5	7	0	0	7	0	0
2	32680356	.	C	T	2	7	9	0	1	10	0	0
2	32682216	.	C	T	1	0	1	0	0	1	0	0
2	32686594	.	C	T	2	8	10	0	1	11	0	0
2	32749864	.	C	G	1	0	1	0	0	1	0	0
2	32751636	.	T	C	0	1	1	0	0	1	0	0
2	32752294	.	G	A	1	0	1	0	0	1	0	0
2	32752300	.	T	C	0	1	1	0	0	1	0	0
2	32752447	.	G	A	1	5	6	0	0	6	0	0
2	32756074	.	C	T	6	2	8	0	0	8	0	0
2	32756630	.	C	T	5	5	10	0	1	11	0	0
2	32756660	.	A	C	3	1	4	0	0	4	0	0
2	32814503	.	G	A	2	1	3	0	0	3	0	0
2	32814677	.	G	C	4	5	9	0	0	9	0	0
2	32814695	.	T	C	4	7	11	0	0	11	0	0
2	32817615	.	T	A	5	2	7	0	0	7	0	0
2	32817627	.	G	A	7	3	10	0	0	10	0	0
2	32817921	.	G	A	1	1	2	0	0	2	0	0
2	32820764	.	G	A	1	4	5	0	0	5	0	0
2	32821393	.	G	A	1	0	1	0	0	1	0	0
2	32821622	.	T	G	0	1	1	0	0	1	0	0
2	32823494	.	C	G	0	2	2	0	5	7	0	0
2	32824727	.	G	A	2	3	5	0	0	5	0	0
2	32824745	.	C	A	0	2	2	0	4	6	0	0
2	32824778	.	G	A	5	5	10	0	0	10	0	0
2	32824805	.	G	A	3	6	9	0	0	9	0	0
2	32824896	.	C	T	5	4	9	0	0	9	0	0
2	32825018	.	C	G	0	1	1	0	6	7	0	0
2	32825033	.	G	A	5	5	10	0	0	10	0	0
2	32827265	.	A	C	5	3	8	0	0	8	0	0
2	32827268	.	C	T	5	2	7	0	0	7	0	0
2	32828839	.	C	A	3	2	5	0	0	5	0	0
2	32829016	.	T	C	6	3	9	0	0	9	0	0
2	32831664	.	C	A	7	3	10	0	1	11	0	0
2	32833524	.	T	C	8	6	14	0	0	14	0	0
2	32846004	.	G	A	7	3	10	0	0	10	0	0
2	32849667	.	A	G	1	5	6	0	1	7	0	0
2	32850138	.	C	T	8	3	11	0	0	11	0	0
2	32850305	.	T	C	11	7	18	0	0	18	0	0
2	32850401	.	T	C	12	4	16	0	0	16	0	0
2	32850477	.	T	A	3	9	12	0	0	12	0	0
2	32850510	.	A	T	2	4	6	0	0	6	0	0
2	33209645	.	T	G	1	0	1	0	1	2	0	0
2	33216346	.	C	T	15	12	27	0	1	28	0	0
2	33216518	.	G	A	2	19	21	0	15	36	0	0
2	33216563	.	C	G	17	18	35	0	3	38	0	0
2	33416145	.	G	A	0	3	3	0	0	3	0	0
2	33416755	.	A	G	1	0	1	0	2	3	0	0
2	33416771	.	T	A	1	3	4	0	0	4	0	0
2	33417474	.	C	T	0	2	2	0	0	2	0	0
2	33418476	.	G	A	4	2	6	0	0	6	0	0
2	33418586	.	C	A	1	4	5	0	0	5	0	0
2	33418604	.	A	T	1	4	5	0	1	6	0	0
2	33418887	.	A	G	4	0	4	0	3	7	0	0
2	33419506	.	A	G	3	2	5	0	0	5	0	0
2	33419602	.	A	G	0	4	4	0	1	5	0	0
2	33419650	.	A	G	0	5	5	0	0	5	0	0
2	33419661	.	C	T	0	3	3	0	0	3	0	0
2	33419704	.	A	G	1	0	1	0	2	3	0	0
2	33419730	.	A	G	1	2	3	0	0	3	0	0
2	33420218	.	T	A	4	4	8	0	0	8	0	0
2	33420309	.	T	A	1	2	3	0	0	3	0	0
2	33420318	.	A	G	1	0	1	0	2	3	0	0
2	33420384	.	G	A	0	2	2	0	2	4	0	0
2	33420806	.	C	T	10	8	18	0	1	19	0	0
2	33420925	.	C	A	6	9	15	0	0	15	0	0
2	33421078	.	G	T	2	8	10	0	0	10	0	0
2	33421200	.	C	T	5	5	10	0	0	10	0	0
2	33421222	.	A	C	7	8	15	0	0	15	0	0
2	33421275	.	C	G	7	10	17	0	0	17	0	0
2	33421276	.	T	C	7	10	17	0	0	17	0	0
2	33421331	.	C	A	3	9	12	0	0	12	0	0
2	33421382	.	A	T	6	7	13	0	1	14	0	0
2	33421404	.	T	A	7	11	18	0	1	19	0	0
2	33421441	.	T	G	10	1	11	0	11	22	0	0
2	33421547	.	A	G	11	5	16	0	0	16	0	0
2	33421549	.	A	C	11	5	16	0	0	16	0	0
2	33421720	.	A	G	10	7	17	0	1	18	0	0
2	33421774	.	A	G	10	9	19	0	2	21	0	0
2	33421860	.	T	G	7	2	9	0	0	9	0	0
2	33421872	.	A	T	6	3	9	0	1	10	0	0
2	33421985	.	T	A	9	5	14	0	1	15	0	0
2	33422001	.	C	T	11	7	18	0	1	19	0	0
2	33422125	.	C	T	5	9	14	0	0	14	0	0
2	33422169	.	T	C	5	9	14	0	0	14	0	0
2	33422211	.	G	A	6	7	13	0	0	13	0	0
2	33422286	.	T	G	8	11	19	0	0	19	0	0
2	33422289	.	C	T	7	12	19	0	1	20	0	0
2	33422327	.	G	A	14	14	28	0	2	30	0	0
2	33422509	.	T	A	17	4	21	0	1	22	0	0
2	33476776	.	A	G	3	2	5	0	0	5	0	0
2	33477139	.	G	A	2	7	9	0	1	10	0	0
2	33477160	.	T	C	4	3	7	0	0	7	0	0
2	33477175	.	A	G	5	3	8	0	0	8	0	0
2	33522070	.	C	T	1	3	4	0	0	4	0	0
2	33645058	.	A	G	4	2	6	0	1	7	0	0
2	33645157	.	A	G	6	7	13	0	0	13	0	0
2	33645335	.	G	A	5	4	9	0	0	9	0	0
2	33645344	.	C	A	4	5	9	0	0	9	0	0
2	33676225	.	G	A	1	2	3	0	0	3	0	0
2	33681337	.	A	T	30	17	47	0	2	50	1	0
2	33687090	.	G	A	17	8	25	0	1	26	0	0
2	33687110	.	C	A	18	11	29	0	2	31	0	0
2	33821103	.	C	G	1	2	3	0	0	3	0	0
2	33943366	.	G	A	1	2	3	0	0	3	0	0
2	34009014	.	G	A	1	3	4	0	0	4	0	0
2	34022992	.	T	A	2	3	5	0	0	5	0	0
2	34024832	.	A	G	4	3	7	0	0	7	0	0
2	34029353	.	G	A	0	2	2	0	0	2	0	0
2	34071782	.	T	A	1	2	3	0	0	3	0	0
2	34119467	.	A	C	1	3	4	0	0	4	0	0
2	34119783	.	G	A	0	4	4	0	1	5	0	0
2	34122859	.	A	G	11	6	17	0	0	17	0	0
2	34122985	.	C	T	2	0	2	0	0	2	0	0
2	34126040	.	T	C	2	2	4	0	0	4	0	0
2	34173018	.	T	A	4	5	9	0	0	9	0	0
2	34173253	.	C	T	1	8	9	0	0	9	0	0
2	34173335	.	A	C	7	5	12	0	0	12	0	0
2	34173336	.	G	A	6	5	11	0	1	12	0	0
2	34381013	.	T	G	13	13	26	0	1	27	0	0
2	34381032	.	T	C	13	11	24	0	1	25	0	0
2	34381066	.	C	T	15	12	27	0	0	27	0	0
2	34555410	.	A	G	2	3	5	0	1	6	0	0
2	34573032	.	A	T	4	5	9	0	0	9	0	0
2	34573064	.	C	T	3	3	6	0	0	6	0	0
2	34698215	.	C	A	7	2	9	0	0	9	0	0
2	34725878	.	A	G	2	4	6	0	0	6	0	0
2	34924412	.	A	G	4	16	20	0	2	22	0	0
2	34962193	.	A	T	1	2	3	0	1	4	0	0
2	34962223	.	A	G	10	0	10	0	11	21	0	0
2	34970135	.	T	C	6	2	8	0	0	8	0	0
2	34970329	.	A	G	16	18	34	0	7	41	0	0
2	34981747	.	G	A	26	26	52	0	0	52	0	0
2	34981986	.	G	A	31	22	53	0	1	55	1	0
2	34982205	.	T	G	18	24	42	0	2	44	0	0
2	34982322	.	A	T	6	5	11	0	0	11	0	0
2	34986320	.	A	G	1	4	5	0	0	5	0	0
2	34986337	.	C	A	0	5	5	0	1	6	0	0
2	34986484	.	A	G	1	3	4	0	0	4	0	0
2	34986702	.	C	T	3	5	8	0	2	10	0	0
2	35011823	.	A	T	1	4	5	0	0	5	0	0
2	35012056	.	C	G	0	3	3	0	0	3	0	0
2	35017023	.	G	A	2	5	7	0	0	7	0	0
2	35117066	.	A	C	1	3	4	0	0	4	0	0
2	35118607	.	C	T	2	2	4	0	0	4	0	0
2	35126353	.	A	C	2	3	5	0	0	5	0	0
2	35419271	.	T	G	1	0	1	0	1	2	0	0
2	35421399	.	A	T	2	2	4	0	0	4	0	0
2	35434910	.	C	T	3	1	4	0	1	5	0	0
2	35437417	.	C	T	1	1	2	0	0	2	0	0
2	35457782	.	C	T	2	1	3	0	0	3	0	0
2	35473847	.	G	A	0	4	4	0	8	12	0	0
2	35473975	.	G	T	6	3	9	0	0	9	0	0
2	35474049	.	G	A	0	7	7	0	13	20	0	0
2	35593364	.	T	G	2	5	7	0	0	7	0	0
2	35594003	.	G	A	4	8	12	0	0	12	0	0
2	35595514	.	C	A	14	9	23	0	1	24	0	0
2	35595551	.	A	T	5	10	15	0	3	18	0	0
2	35598219	.	A	T	5	9	14	0	0	14	0	0
2	35598257	.	C	G	2	6	8	0	0	8	0	0
2	35601212	.	T	G	5	6	11	0	1	12	0	0
2	35605841	.	G	A	3	0	3	0	0	3	0	0
2	35607206	.	C	T	6	11	17	0	1	18	0	0
2	35608445	.	T	A	11	8	19	0	0	19	0	0
2	35610890	.	T	G	8	18	26	0	2	28	0	0
2	35611051	.	T	A	7	17	24	0	1	25	0	0
2	35611172	.	C	T	17	17	34	0	0	34	0	0
2	35611765	.	G	A	4	3	7	0	0	7	0	0
2	35728228	.	T	A	2	2	4	0	0	4	0	0
2	35730701	.	G	A	0	2	2	0	0	2	0	0
2	35731033	.	C	G	1	6	7	0	0	7	0	0
2	35731106	.	C	T	0	2	2	0	0	2	0	0
2	36712529	.	A	T	0	0	0	0	1	1	0	0
2	36714251	.	T	G	1	0	1	0	0	1	0	0
2	36720559	.	G	A	0	2	2	0	1	3	0	0
2	36722846	.	T	C	3	3	6	0	0	6	0	0
2	36724384	.	A	C	11	13	24	0	2	26	0	0
2	36727360	.	A	T	3	2	5	0	0	5	0	0
2	36816003	.	A	G	7	10	17	0	1	18	0	0
2	36816120	.	T	G	8	7	15	0	0	15	0	0
2	36816312	.	T	C	2	3	5	0	0	5	0	0
2	36816495	.	T	G	7	7	14	0	2	16	0	0
2	36816501	.	T	G	8	6	14	0	1	15	0	0
2	36816828	.	T	C	4	3	7	0	0	7	0	0
2	36817362	.	G	A	2	5	7	0	0	7	0	0
2	36819320	.	C	T	3	3	6	0	0	6	0	0
2	36828901	.	C	G	1	0	1	0	1	2	0	0
2	36834542	.	C	T	0	1	1	0	0	1	0	0
2	36838094	.	C	T	1	1	2	0	1	3	0	0
2	36838274	.	G	A	2	1	3	0	0	3	0	0
2	36838322	.	T	C	2	0	2	0	0	2	0	0
2	36840594	.	C	T	0	6	6	0	0	6	0	0
2	36840789	.	C	T	2	3	5	0	0	5	0	0
2	36841523	.	A	G	3	3	6	0	1	7	0	0
2	36852056	.	C	G	8	16	24	0	0	24	0	0
2	36853630	.	C	T	3	1	4	0	0	4	0	0
2	36853936	.	T	C	4	16	20	0	0	20	0	0
2	36853955	.	A	C	4	16	20	0	0	20	0	0
2	36854173	.	T	C	12	17	29	0	2	31	0	0
2	36854184	.	C	A	11	16	27	0	1	28	0	0
2	36862501	.	A	G	2	2	4	0	0	4	0	0
2	36862726	.	T	C	3	3	6	0	1	7	0	0
2	36889867	.	A	T	4	3	7	0	0	7	0	0
2	36892504	.	C	T	2	5	7	0	0	7	0	0
2	36892518	.	A	G	3	8	11	0	0	11	0	0
2	36921495	.	A	T	6	5	11	0	0	11	0	0
2	36921579	.	G	C	11	0	11	0	14	25	0	0
2	36921588	.	A	G	9	14	23	0	1	24	0	0
2	36922595	.	G	A	3	1	4	0	0	4	0	0
2	36922604	.	A	T	4	2	6	0	0	6	0	0
2	36922883	.	C	T	5	10	15	0	1	16	0	0
2	36922988	.	A	T	10	5	15	0	0	15	0	0
2	36923167	.	T	C	7	1	8	0	13	21	0	0
2	36923300	.	A	T	12	14	26	0	0	26	0	0
2	36924051	.	T	C	3	0	3	0	5	8	0	0
2	36924739	.	T	C	6	2	8	0	0	8	0	0
2	36939965	.	T	A	1	6	7	0	1	8	0	0
2	36941365	.	A	G	5	1	6	0	0	6	0	0
2	36990050	.	A	T	14	28	42	0	1	43	0	0
2	36990185	.	A	C	20	25	45	0	2	47	0	0
2	36990283	.	A	T	19	17	36	0	0	36	0	0
2	36990294	.	A	T	18	16	34	0	3	37	0	0
2	36990363	.	A	G	16	26	42	0	1	43	0	0
2	36990458	.	A	G	25	25	50	0	1	51	0	0
2	36992795	.	T	C	5	0	5	0	3	8	0	0
2	37043708	.	A	C	4	0	4	0	6	10	0	0
2	37043776	.	A	C	6	4	10	0	1	11	0	0
2	37043783	.	T	C	7	5	12	0	0	12	0	0
2	37059643	.	A	G	3	7	10	0	0	10	0	0
2	37098525	.	G	A	2	8	10	0	1	11	0	0
2	37123507	.	T	C	13	19	32	0	2	34	0	0
2	37123901	.	T	C	17	10	27	0	1	28	0	0
2	37124181	.	A	C	24	21	45	0	0	46	1	0
2	37124509	.	A	G	12	12	24	0	0	24	0	0
2	37124546	.	G	A	6	5	11	0	3	14	0	0
2	37124682	.	C	A	5	3	8	0	0	8	0	0
2	37124761	.	C	T	4	5	9	0	0	9	0	0
2	37124821	.	C	A	11	9	20	0	0	20	0	0
2	37124961	.	C	G	19	15	34	0	0	34	0	0
2	37128450	.	C	T	18	12	30	0	0	30	0	0
2	37138717	.	A	T	5	3	8	0	0	8	0	0
2	37138899	.	C	A	0	1	1	0	1	2	0	0
2	37139990	.	G	T	0	2	2	0	0	2	0	0
2	37141002	.	G	A	0	3	3	0	1	4	0	0
2	37145793	.	T	A	22	15	37	0	1	38	0	0
2	37145820	.	G	C	22	21	43	0	1	44	0	0
2	37146474	.	C	T	13	13	26	0	1	27	0	0
2	37146512	.	A	G	9	1	10	0	8	18	0	0
2	37189834	.	T	C	1	3	4	0	0	4	0	0
2	37195406	.	C	A	0	4	4	0	1	5	0	0
2	37195472	.	A	C	5	8	13	0	1	14	0	0
2	37205437	.	T	G	3	1	4	0	6	10	0	0
2	37205989	.	T	A	1	1	2	0	1	3	0	0
2	37257571	.	A	G	3	3	6	0	1	7	0	0
2	37258084	.	C	A	1	2	3	0	0	3	0	0
2	37261326	.	A	T	5	4	9	0	1	10	0	0
2	37263874	.	C	A	27	23	50	0	1	51	0	0
2	37264364	.	A	T	7	8	15	0	1	16	0	0
2	37264423	.	G	T	9	9	18	0	1	19	0	0
2	37264693	.	T	C	17	8	25	0	3	28	0	0
2	37264856	.	T	A	18	14	32	0	3	35	0	0
2	37264889	.	T	G	13	20	33	0	0	33	0	0
2	37264915	.	T	A	14	19	33	0	1	34	0	0
2	37264928	.	A	T	14	18	32	0	2	34	0	0
2	37265021	.	C	T	15	7	22	0	2	24	0	0
2	37265125	.	T	A	11	10	21	0	0	21	0	0
2	37265302	.	G	A	15	15	30	0	3	33	0	0
2	37265409	.	T	A	17	16	33	0	1	34	0	0
2	37267465	.	T	C	3	3	6	0	0	6	0	0
2	37267831	.	T	A	3	6	9	0	0	9	0	0
2	37274451	.	C	T	1	3	4	0	0	4	0	0
2	37274483	.	T	C	1	5	6	0	0	6	0	0
2	37274504	.	A	G	1	5	6	0	0	6	0	0
2	37280268	.	T	C	1	0	1	0	0	1	0	0
2	37280399	.	A	G	3	4	7	0	0	7	0	0
2	37307422	.	T	A	7	11	18	0	1	19	0	0
2	37307557	.	T	C	2	3	5	0	0	5	0	0
2	37322252	.	G	A	1	0	1	0	1	2	0	0
2	37365855	.	C	T	1	16	17	0	24	41	0	0
2	37366234	.	A	G	11	10	21	0	0	21	0	0
2	37366496	.	A	T	13	13	26	0	1	27	0	0
2	37366526	.	T	C	16	11	27	0	0	27	0	0
2	37366810	.	G	C	10	13	23	0	1	24	0	0
2	37366815	.	G	A	12	13	25	0	0	25	0	0
2	37375027	.	G	A	3	3	6	0	0	6	0	0
2	37379482	.	A	G	3	4	7	0	0	7	0	0
2	37383444	.	A	G	4	6	10	0	0	10	0	0
2	37391319	.	T	C	1	0	1	0	1	2	0	0
2	37428557	.	C	T	1	1	2	0	0	2	0	0
2	37428741	.	G	A	0	1	1	0	0	1	0	0
2	37428804	.	A	G	3	5	8	0	0	8	0	0
2	37433540	.	C	T	1	4	5	0	0	5	0	0
2	37436778	.	T	A	3	9	12	0	0	12	0	0
2	37457985	.	T	G	1	1	2	0	0	2	0	0
2	37458522	.	G	A	3	3	6	0	0	6	0	0
2	37469926	.	G	A	24	17	41	0	1	42	0	0
2	37469962	.	A	G	28	14	42	0	1	43	0	0
2	37470001	.	A	G	19	10	29	0	1	30	0	0
2	37471495	.	C	G	3	6	9	0	0	9	0	0
2	37496982	.	A	G	0	1	1	0	0	1	0	0
2	37502213	.	G	A	6	13	19	0	0	19	0	0
2	37502412	.	T	G	4	16	20	0	3	23	0	0
2	37545462	.	A	G	8	9	17	0	0	17	0	0
2	37545473	.	C	G	8	11	19	0	0	19	0	0
2	37545628	.	G	A	11	13	24	0	2	26	0	0
2	37546225	.	T	C	12	1	13	0	12	25	0	0
2	37547874	.	T	C	2	1	3	0	0	3	0	0
2	37554817	.	G	A	2	5	7	0	0	7	0	0
2	37559306	.	C	T	3	4	7	0	0	7	0	0
2	37559318	.	G	A	3	3	6	0	0	6	0	0
2	37564375	.	T	A	5	5	10	0	0	10	0	0
2	37566708	.	C	T	0	2	2	0	0	2	0	0
2	37632100	.	C	T	1	4	5	0	0	5	0	0
2	37656317	.	A	C	12	6	18	0	1	19	0	0
2	37656372	.	A	G	12	9	21	0	0	21	0	0
2	37656498	.	T	A	4	5	9	0	1	10	0	0
2	37656580	.	G	C	1	3	4	0	0	4	0	0
2	37664128	.	G	A	0	2	2	0	0	2	0	0
2	37823104	.	C	T	5	4	9	0	0	9	0	0
2	37823647	.	A	G	5	0	5	0	4	9	0	0
2	37823663	.	A	G	3	0	3	0	4	7	0	0
2	37827612	.	T	A	1	4	5	0	0	5	0	0
2	37827660	.	C	T	0	5	5	0	1	6	0	0
2	37827977	.	C	T	0	6	6	0	9	15	0	0
2	37830066	.	G	T	1	1	2	0	0	2	0	0
2	37830908	.	G	T	2	2	4	0	0	4	0	0
2	37830922	.	C	T	2	2	4	0	0	4	0	0
2	37833702	.	A	G	1	1	2	0	0	2	0	0
2	37833708	.	A	T	1	1	2	0	0	2	0	0
2	37833739	.	A	C	1	1	2	0	0	2	0	0
2	37834433	.	T	C	1	1	2	0	0	2	0	0
2	37834703	.	C	T	1	5	6	0	0	6	0	0
2	37837577	.	A	G	1	3	4	0	0	4	0	0
2	37837608	.	A	G	3	1	4	0	0	4	0	0
2	37840887	.	G	A	1	1	2	0	0	2	0	0
2	37841270	.	T	C	1	3	4	0	0	4	0	0
2	37841295	.	A	C	2	5	7	0	0	7	0	0
2	37841333	.	T	C	2	5	7	0	0	7	0	0
2	37846286	.	A	G	1	0	1	0	0	1	0	0
2	37846513	.	C	T	1	1	2	0	0	2	0	0
2	37867148	.	C	T	14	8	22	0	0	22	0	0
2	37867165	.	C	T	0	7	7	0	15	22	0	0
2	37892694	.	C	G	1	2	3	0	0	3	0	0
2	37892884	.	C	T	1	7	8	0	0	8	0	0
2	37986847	.	C	T	1	2	3	0	1	4	0	0
2	37990187	.	T	C	1	3	4	0	0	4	0	0
2	37990315	.	A	G	1	5	6	0	0	6	0	0
2	38000133	.	G	T	7	9	16	0	1	17	0	0
2	38000185	.	G	A	21	25	46	0	1	47	0	0
2	38004485	.	G	A	0	0	0	0	3	3	0	0
2	38004500	.	G	T	3	0	3	0	0	3	0	0
2	38008491	.	G	A	4	6	10	0	0	10	0	0
2	38008916	.	C	T	4	6	10	0	2	12	0	0
2	38018076	.	G	A	6	3	9	0	0	9	0	0
2	38027068	.	G	T	6	5	11	0	0	11	0	0
2	38032270	.	G	A	10	9	19	0	0	19	0	0
2	38033937	.	G	A	16	13	29	0	1	30	0	0
2	38033979	.	C	T	9	19	28	0	1	29	0	0
2	38055638	.	G	C	2	3	5	0	0	5	0	0
2	38055662	.	C	G	3	1	4	0	2	6	0	0
2	38064638	.	T	C	4	3	7	0	0	7	0	0
2	38065056	.	G	A	0	6	6	0	4	10	0	0
2	38065095	.	C	T	6	4	10	0	0	10	0	0
2	38065101	.	G	A	0	3	3	0	6	9	0	0
2	38065450	.	C	T	4	2	6	0	0	6	0	0
2	38065579	.	C	T	8	3	11	0	0	11	0	0
2	38065676	.	G	T	1	3	4	0	0	4	0	0
2	38068593	.	A	G	5	2	7	0	0	7	0	0
2	38068677	.	T	A	4	9	13	0	0	13	0	0
2	38072328	.	T	C	9	9	18	0	3	21	0	0
2	38072460	.	C	T	10	8	18	0	4	22	0	0
2	38072463	.	G	A	11	9	20	0	2	22	0	0
2	38072547	.	C	T	0	8	8	0	8	16	0	0
2	38072670	.	G	T	13	6	19	0	0	19	0	0
2	38072703	.	G	A	7	12	19	0	0	19	0	0
2	38073092	.	A	G	1	0	1	0	0	1	0	0
2	38076425	.	C	T	1	6	7	0	0	7	0	0
2	38076579	.	A	G	1	0	1	0	1	2	0	0
2	38076884	.	A	T	5	3	8	0	2	10	0	0
2	38078188	.	C	T	3	2	5	0	0	5	0	0
2	38078227	.	G	A	3	3	6	0	0	6	0	0
2	38087670	.	A	G	2	9	11	0	0	11	0	0
2	38087879	.	T	A	4	13	17	0	0	17	0	0
2	38088096	.	A	T	9	9	18	0	0	18	0	0
2	38088329	.	C	G	5	7	12	0	1	13	0	0
2	38088454	.	A	G	15	9	24	0	2	26	0	0
2	38088475	.	A	G	15	12	27	0	1	28	0	0
2	38088535	.	C	T	8	11	19	0	0	19	0	0
2	38092067	.	G	T	7	9	16	0	1	17	0	0
2	38095343	.	A	T	9	5	14	0	0	14	0	0
2	38098810	.	G	A	8	5	13	0	0	13	0	0
2	38098871	.	C	T	0	5	5	0	1	6	0	0
2	38101590	.	G	A	4	3	7	0	0	7	0	0
2	38101616	.	T	G	2	3	5	0	0	5	0	0
2	38102335	.	A	T	3	6	9	0	0	9	0	0
2	38106816	.	G	A	0	3	3	0	0	3	0	0
2	38115528	.	A	T	1	2	3	0	1	4	0	0
2	38121433	.	T	C	4	3	7	0	1	8	0	0
2	38121536	.	C	T	13	33	46	0	0	46	0	0
2	38121558	.	C	T	14	36	50	0	1	51	0	0
2	38123931	.	G	T	20	22	42	1	1	44	0	0
2	38124030	.	A	G	17	29	46	0	3	49	0	0
2	38151478	.	G	A	0	2	2	0	1	3	0	0
2	38154098	.	T	C	7	7	14	0	1	15	0	0
2	38154107	.	G	A	7	5	12	0	0	12	0	0
2	38154177	.	C	A	4	4	8	0	0	8	0	0
2	38154307	.	A	G	14	4	18	0	1	19	0	0
2	38154879	.	A	T	13	8	21	0	2	23	0	0
2	38155339	.	G	C	3	6	9	0	1	10	0	0
2	38155340	.	T	C	6	4	10	0	0	10	0	0
2	38155479	.	G	A	0	9	9	0	3	12	0	0
2	38155511	.	G	A	4	5	9	0	0	9	0	0
2	38155651	.	G	T	5	6	11	0	0	11	0	0
2	38155802	.	C	T	11	4	15	0	0	15	0	0
2	38156165	.	C	T	4	10	14	0	1	15	0	0
2	38156783	.	G	A	3	4	7	0	0	7	0	0
2	38181561	.	G	T	0	2	2	0	1	3	0	0
2	38198118	.	G	T	23	21	44	0	3	48	1	0
2	38198626	.	C	T	27	24	51	0	1	52	0	0
2	38198627	.	T	G	27	23	50	0	2	52	0	0
2	38199761	.	C	T	4	5	9	0	0	9	0	0
2	38199764	.	G	T	4	4	8	0	0	8	0	0
2	38200181	.	A	G	22	19	41	0	3	44	0	0
2	38200830	.	G	A	2	5	7	0	0	7	0	0
2	38201073	.	T	C	16	0	16	0	12	28	0	0
2	38201864	.	C	A	5	18	23	0	1	24	0	0
2	38202356	.	C	T	5	12	17	0	0	17	0	0
2	38202890	.	C	A	0	3	3	0	1	4	0	0
2	38204025	.	C	A	0	7	7	0	3	10	0	0
2	38204177	.	C	T	4	6	10	0	0	10	0	0
2	38205968	.	A	C	1	0	1	0	1	2	0	0
2	38205997	.	C	T	0	1	1	0	1	2	0	0
2	38213642	.	G	T	15	20	35	0	6	41	0	0
2	38214094	.	C	T	3	25	28	0	22	50	0	0
2	38214102	.	C	T	28	24	52	0	0	52	0	0
2	38214164	.	C	T	16	31	47	0	0	47	0	0
2	38214720	.	C	T	24	26	50	0	2	52	0	0
2	38214974	.	T	G	10	4	14	1	1	16	0	0
2	38215275	.	C	T	6	7	13	0	1	14	0	0
2	38215391	.	G	A	31	20	51	1	1	53	0	0
2	38215860	.	C	T	2	21	23	0	21	44	0	0
2	38216481	.	C	T	8	16	24	0	6	30	0	0
2	38216502	.	C	T	10	21	31	0	2	33	0	0
2	38216580	.	T	C	10	16	26	0	0	26	0	0
2	38227332	.	C	A	4	5	9	0	0	9	0	0
2	38229906	.	C	T	2	4	6	0	1	7	0	0
2	38265504	.	G	A	2	2	4	0	0	4	0	0
2	38266439	.	C	T	3	4	7	0	0	7	0	0
2	38269105	.	G	A	2	2	4	0	0	4	0	0
2	38269114	.	T	G	2	2	4	0	0	4	0	0
2	38269355	.	G	A	13	10	23	0	0	23	0	0
2	38269435	.	T	C	0	8	8	0	0	8	0	0
2	38269446	.	A	T	0	8	8	0	0	8	0	0
2	38289260	.	G	A	15	16	31	0	0	31	0	0
2	38289393	.	C	T	10	11	21	0	1	22	0	0
2	38289494	.	T	A	7	15	22	0	1	23	0	0
2	38289496	.	A	G	7	1	8	0	15	23	0	0
2	38289633	.	G	A	3	3	6	0	1	7	0	0
2	38373380	.	T	C	17	13	30	0	2	32	0	0
2	38378888	.	T	A	3	2	5	0	1	6	0	0
2	38391846	.	T	C	11	10	21	0	1	22	0	0
2	38391847	.	T	C	12	9	21	0	1	22	0	0
2	38391945	.	C	T	27	20	47	0	0	47	0	0
2	38556203	.	C	A	2	2	4	0	0	4	0	0
2	38689219	.	C	T	3	1	4	0	0	4	0	0
2	38699469	.	C	T	3	4	7	0	0	7	0	0
2	38699526	.	G	A	5	3	8	0	0	8	0	0
2	38708714	.	A	T	4	4	8	0	1	9	0	0
2	38708744	.	C	T	5	4	9	0	0	9	0	0
2	38708780	.	T	A	6	8	14	0	1	15	0	0
2	38852648	.	T	C	0	2	2	0	0	2	0	0
2	38862880	.	G	A	2	3	5	0	0	5	0	0
2	38880942	.	C	T	7	5	12	0	2	14	0	0
2	38880999	.	G	A	4	2	6	0	0	6	0	0
2	38881164	.	A	G	3	0	3	0	0	3	0	0
2	38887527	.	A	G	6	3	9	0	0	9	0	0
2	38887772	.	C	A	7	3	10	0	0	10	0	0
2	38887932	.	G	C	4	4	8	0	0	8	0	0
2	38888157	.	T	A	5	5	10	0	1	11	0	0
2	38888170	.	T	C	6	5	11	0	0	11	0	0
2	38888235	.	A	G	7	11	18	0	1	19	0	0
2	38888272	.	T	C	14	6	20	0	0	20	0	0
2	38888463	.	G	A	4	14	18	0	0	18	0	0
2	38888517	.	A	C	9	13	22	0	0	22	0	0
2	38888789	.	C	T	1	2	3	0	0	3	0	0
2	38888820	.	A	C	2	8	10	0	2	12	0	0
2	38888895	.	T	C	9	7	16	0	1	17	0	0
2	38888939	.	G	T	3	6	9	0	0	9	0	0
2	38888953	.	T	C	4	3	7	0	1	8	0	0
2	38889114	.	G	A	5	2	7	0	0	7	0	0
2	38889369	.	A	G	12	0	12	0	9	21	0	0
2	38889389	.	G	T	10	14	24	0	1	25	0	0
2	38889487	.	A	G	11	2	13	0	14	27	0	0
2	38889523	.	G	C	1	14	15	0	16	31	0	0
2	38890481	.	T	C	8	7	15	0	0	15	0	0
2	38890495	.	C	A	6	5	11	0	1	12	0	0
2	38926665	.	C	G	1	3	4	0	2	6	0	0
2	38926780	.	A	C	5	2	7	0	1	8	0	0
2	38926787	.	T	C	5	3	8	0	0	8	0	0
2	38927465	.	A	G	0	0	0	0	1	1	0	0
2	38977157	.	G	A	3	3	6	0	0	6	0	0
2	38977159	.	T	C	2	3	5	0	1	6	0	0
2	38977266	.	C	A	1	6	7	0	0	7	0	0
2	38977269	.	A	G	0	6	6	0	0	6	0	0
2	38997627	.	G	T	19	16	35	0	1	36	0	0
2	38997631	.	A	G	19	16	35	0	1	36	0	0
2	38998100	.	G	T	18	21	39	0	0	39	0	0
2	39001713	.	G	A	0	4	4	0	0	4	0	0
2	39001975	.	A	G	5	1	6	0	0	6	0	0
2	39001993	.	G	T	6	3	9	0	0	9	0	0
2	39002164	.	C	T	0	1	1	0	2	3	0	0
2	39002546	.	G	C	13	5	18	0	1	19	0	0
2	39002692	.	T	C	1	1	2	0	0	2	0	0
2	39005438	.	C	T	0	2	2	0	0	2	0	0
2	39013488	.	T	C	0	0	0	0	1	1	0	0
2	39013572	.	A	T	1	5	6	0	0	6	0	0
2	39015083	.	G	A	4	3	7	0	0	7	0	0
2	39028379	.	T	G	2	2	4	0	0	4	0	0
2	39028774	.	G	T	7	6	13	0	1	14	0	0
2	39028811	.	G	T	4	5	9	0	0	9	0	0
2	39036516	.	G	T	1	11	12	0	1	13	0	0
2	39063306	.	A	T	1	2	3	0	0	3	0	0
2	39063307	.	G	C	1	0	1	0	2	3	0	0
2	39068409	.	C	A	6	2	8	0	0	8	0	0
2	39506808	.	T	G	1	0	1	0	2	3	0	0
2	39549780	.	C	T	2	3	5	0	0	5	0	0
2	39550307	.	T	C	5	4	9	0	1	10	0	0
2	39550343	.	T	A	3	4	7	0	0	7	0	0
2	39550380	.	A	C	7	3	10	0	0	10	0	0
2	39550460	.	A	T	1	2	3	0	0	3	0	0
2	39550494	.	C	T	0	7	7	0	0	7	0	0
2	39550627	.	G	A	6	6	12	0	0	12	0	0
2	39550677	.	T	C	5	7	12	0	0	12	0	0
2	39550755	.	C	T	2	9	11	0	0	11	0	0
2	39550761	.	A	C	1	6	7	0	2	9	0	0
2	39550854	.	G	A	0	10	10	0	5	15	0	0
2	39550901	.	C	T	2	3	5	0	1	6	0	0
2	39551023	.	T	C	0	3	3	0	1	4	0	0
2	39551093	.	A	C	5	4	9	1	0	10	0	0
2	39551185	.	T	C	6	12	18	1	1	20	0	0
2	39551213	.	G	A	0	8	8	0	8	16	0	0
2	39551304	.	C	T	2	7	9	0	0	9	0	0
2	39551421	.	T	C	2	4	6	0	0	6	0	0
2	39551538	.	A	G	3	0	3	0	5	8	0	0
2	39551581	.	C	G	1	2	3	0	0	3	0	0
2	39551869	.	T	G	2	2	4	0	0	4	0	0
2	39552101	.	C	T	4	4	8	0	0	8	0	0
2	39553173	.	A	C	7	4	11	0	0	11	0	0
2	39553209	.	C	T	6	7	13	0	0	13	0	0
2	39553279	.	G	A	10	7	17	0	1	18	0	0
2	39553283	.	A	T	7	11	18	0	1	19	0	0
2	39553351	.	G	A	7	5	12	0	0	12	0	0
2	39554098	.	A	C	11	13	24	0	0	25	1	0
2	39554514	.	A	C	6	7	13	0	0	13	0	0
2	39555273	.	A	G	7	14	21	0	0	21	0	0
2	39584287	.	A	T	4	4	8	0	0	8	0	0
2	39584370	.	T	C	1	0	1	0	4	5	0	0
2	39584465	.	A	T	6	4	10	0	0	10	0	0
2	39584466	.	T	A	6	4	10	0	0	10	0	0
2	39584528	.	G	A	8	5	13	0	0	13	0	0
2	39649592	.	C	T	2	9	11	0	0	11	0	0
2	39649655	.	G	C	9	0	9	0	8	17	0	0
2	39649673	.	C	T	8	9	17	0	4	21	0	0
2	39650108	.	T	C	5	2	7	0	0	7	0	0
2	39650191	.	T	C	4	2	6	0	1	7	0	0
2	39731366	.	A	C	0	2	2	0	4	6	0	0
2	39731567	.	C	T	21	17	38	0	1	39	0	0
2	39732139	.	C	A	13	11	24	0	0	24	0	0
2	39732157	.	G	A	10	10	20	0	2	22	0	0
2	39732710	.	T	C	11	4	15	0	1	16	0	0
2	39732743	.	T	C	6	0	6	0	5	11	0	0
2	39732767	.	A	G	6	5	11	0	0	11	0	0
2	39732818	.	C	T	0	5	5	0	9	14	0	0
2	39732833	.	G	A	8	6	14	0	1	15	0	0
2	39732955	.	A	G	12	11	23	0	0	23	0	0
2	39732967	.	T	G	12	14	26	0	0	26	0	0
2	39733130	.	T	A	17	17	34	0	3	37	0	0
2	39733531	.	C	T	16	17	33	0	0	33	0	0
2	39734396	.	G	A	13	13	26	0	0	26	0	0
2	39734410	.	A	T	12	12	24	0	0	24	0	0
2	39734444	.	A	G	11	16	27	0	3	30	0	0
2	39734494	.	T	A	13	16	29	0	1	30	0	0
2	39735568	.	T	C	2	0	2	0	1	3	0	0
2	39753775	.	C	A	0	4	4	0	4	8	0	0
2	39759009	.	G	A	3	5	8	0	0	8	0	0
2	40067983	.	A	G	11	5	16	0	0	16	0	0
2	40068188	.	C	T	26	20	46	0	3	49	0	0
2	40068238	.	G	A	21	27	48	0	0	48	0	0
2	40068279	.	G	A	24	20	44	0	6	51	1	0
2	40068281	.	T	G	24	19	43	0	8	51	0	0
2	40068372	.	G	A	27	15	42	0	1	43	0	0
2	40068386	.	G	A	13	28	41	0	4	45	0	0
2	40069392	.	G	A	13	16	29	0	4	33	0	0
2	40070040	.	A	G	9	4	13	0	1	14	0	0
2	40074474	.	G	A	6	5	11	0	0	11	0	0
2	40088719	.	G	A	2	0	2	0	0	2	0	0
2	40088785	.	G	A	0	1	1	0	0	1	0	0
2	40094202	.	A	T	6	5	11	0	1	12	0	0
2	40094217	.	G	C	7	7	14	1	0	15	0	0
2	40100281	.	G	A	2	1	3	0	0	3	0	0
2	40131941	.	G	C	4	5	9	0	0	9	0	0
2	40132034	.	C	T	7	4	11	0	1	12	0	0
2	40135884	.	G	A	1	2	3	0	1	4	0	0
2	40407135	.	A	G	1	2	3	0	0	3	0	0
2	40412057	.	C	A	2	4	6	0	0	6	0	0
2	40469097	.	T	C	1	0	1	0	0	1	0	0
2	40500542	.	T	C	4	4	8	0	0	8	0	0
2	40500596	.	T	C	0	1	1	0	0	1	0	0
2	40507030	.	T	C	5	4	9	0	1	10	0	0
2	40507060	.	A	G	6	4	10	0	0	10	0	0
2	40513710	.	T	C	0	1	1	0	0	1	0	0
2	40830967	.	T	C	6	7	13	0	0	13	0	0
2	40831047	.	A	G	6	7	13	0	0	13	0	0
2	40831103	.	T	C	6	0	6	0	5	11	0	0
2	40831119	.	C	A	6	5	11	0	0	11	0	0
2	40831568	.	G	A	7	5	12	0	0	12	0	0
2	40831728	.	T	C	7	8	15	0	1	16	0	0
2	40831797	.	C	T	6	5	11	0	0	11	0	0
2	40831822	.	T	A	7	6	13	0	1	14	0	0
2	40832412	.	T	A	4	4	8	0	0	8	0	0
2	40832416	.	A	G	3	4	7	0	1	8	0	0
2	40832457	.	A	T	2	3	5	0	1	6	0	0
2	40832537	.	T	A	5	3	8	0	0	8	0	0
2	40832596	.	C	T	5	2	7	0	1	8	0	0
2	40832984	.	T	C	3	4	7	0	0	7	0	0
2	40833032	.	C	T	0	4	4	0	2	6	0	0
2	40833063	.	A	G	4	6	10	0	0	10	0	0
2	40833068	.	A	G	4	7	11	0	0	11	0	0
2	40833229	.	A	T	0	0	0	0	1	1	0	0
2	40834944	.	A	G	0	1	1	0	0	1	0	0
2	40902411	.	A	G	2	2	4	0	1	5	0	0
2	41532745	.	A	G	2	1	3	0	0	3	0	0
2	41532746	.	A	G	2	0	2	0	1	3	0	0
2	41537384	.	T	G	6	0	6	0	9	15	0	0
2	41539251	.	G	A	0	1	1	0	3	4	0	0
2	41542080	.	T	G	10	11	21	0	2	23	0	0
2	41542451	.	T	C	9	5	14	0	0	14	0	0
2	41542601	.	G	A	11	12	23	0	0	23	0	0
2	41542637	.	A	G	9	0	9	0	10	19	0	0
2	41552835	.	G	A	1	2	3	0	0	3	0	0
2	41563610	.	T	C	1	7	8	0	0	8	0	0
2	41563612	.	A	C	1	6	7	0	1	8	0	0
2	41563686	.	T	G	7	12	19	0	0	19	0	0
2	41563689	.	G	A	7	11	18	0	0	18	0	0
2	41566463	.	T	C	6	7	13	0	0	13	0	0
2	41566770	.	T	G	9	16	25	0	1	26	0	0
2	41566852	.	C	T	3	1	4	0	0	4	0	0
2	41569177	.	T	C	4	7	11	0	2	13	0	0
2	41571398	.	A	T	0	1	1	0	0	1	0	0
2	41578123	.	G	C	12	10	22	0	1	23	0	0
2	41578139	.	G	C	9	17	26	0	2	32	4	0
2	41578181	.	A	T	12	35	47	0	4	52	1	0
2	41578281	.	C	T	12	14	26	0	7	34	1	0
2	41578656	.	C	A	19	12	31	0	1	32	0	0
2	41578716	.	T	A	16	6	22	0	0	22	0	0
2	41578921	.	C	T	7	7	14	0	1	15	0	0
2	41579539	.	C	G	1	7	8	0	7	15	0	0
2	41579572	.	C	G	12	5	17	0	1	18	0	0
2	41579621	.	A	C	6	0	6	0	4	10	0	0
2	41579646	.	G	T	3	5	8	0	2	10	0	0
2	41579701	.	G	C	5	10	15	0	0	15	0	0
2	41579804	.	T	C	9	22	31	0	0	31	0	0
2	41579952	.	C	A	14	6	20	0	0	20	0	0
2	41579984	.	A	G	10	6	16	0	0	16	0	0
2	41580004	.	C	A	14	5	19	0	0	19	0	0
2	41580028	.	T	C	13	5	18	0	0	18	0	0
2	41580125	.	C	T	12	11	23	0	1	24	0	0
2	41580263	.	T	A	12	9	21	0	3	24	0	0
2	41580473	.	C	T	0	14	14	0	7	22	1	0
2	41580522	.	G	A	8	12	20	0	0	20	0	0
2	41580546	.	A	G	10	12	22	0	1	23	0	0
2	41580832	.	G	T	6	8	14	0	0	14	0	0
2	41580897	.	T	C	10	9	19	0	0	19	0	0
2	41580946	.	A	C	9	8	17	0	0	17	0	0
2	41580966	.	T	C	7	10	17	0	0	17	0	0
2	41581815	.	T	A	8	12	20	0	4	24	0	0
2	41581998	.	G	T	11	14	25	0	2	27	0	0
2	41582136	.	G	A	12	16	28	0	0	28	0	0
2	41582383	.	A	C	7	9	16	0	1	17	0	0
2	41582923	.	C	T	7	7	14	0	1	15	0	0
2	41583007	.	A	G	8	7	15	0	0	15	0	0
2	41583043	.	A	G	7	7	14	0	2	16	0	0
2	41583171	.	C	T	0	7	7	0	3	10	0	0
2	41585878	.	A	G	1	2	3	0	0	3	0	0
2	41620101	.	A	T	3	0	3	0	1	4	0	0
2	41835464	.	G	A	1	4	5	0	0	5	0	0
2	41841958	.	C	T	1	1	2	0	0	2	0	0
2	41846755	.	C	T	2	3	5	0	1	6	0	0
2	42420933	.	C	T	2	4	6	0	0	6	0	0
2	44192795	.	C	T	5	2	7	0	0	7	0	0
2	45496344	.	T	C	1	1	2	0	0	2	0	0
2	46140293	.	G	C	0	2	2	0	0	2	0	0
2	46140470	.	T	C	1	7	8	0	0	8	0	0
2	46140479	.	T	C	1	8	9	0	0	9	0	0
2	46140512	.	G	A	0	4	4	0	0	4	0	0
2	46140539	.	G	A	0	1	1	0	0	1	0	0
2	46172217	.	A	G	1	2	3	0	0	3	0	0
2	46172238	.	A	G	1	1	2	0	0	2	0	0
2	46176783	.	A	G	0	4	4	0	1	5	0	0
2	46176822	.	T	C	1	3	4	0	0	4	0	0
2	46181029	.	T	C	4	2	6	0	0	6	0	0
2	46183855	.	T	C	10	9	19	0	0	19	0	0
2	46183897	.	G	A	12	12	24	0	1	25	0	0
2	46183985	.	A	T	10	7	17	0	0	17	0	0
2	46184024	.	T	A	7	7	14	0	2	16	0	0
2	46184057	.	C	A	12	5	17	0	1	18	0	0
2	46184193	.	C	T	9	9	18	0	0	18	0	0
2	46184248	.	G	C	5	6	11	0	1	12	0	0
2	46184277	.	C	A	3	6	9	0	1	10	0	0
2	46184555	.	A	G	7	10	17	0	3	20	0	0
2	46715639	.	G	A	0	1	1	0	1	2	0	0
2	46715681	.	G	A	1	3	4	0	0	4	0	0
2	47472068	.	T	A	4	2	6	0	0	6	0	0
2	47493456	.	C	G	3	0	3	0	2	5	0	0
2	47500251	.	C	T	2	3	5	0	0	5	0	0
2	47506185	.	C	T	2	0	2	0	0	2	0	0
2	47506187	.	G	A	2	0	2	0	0	2	0	0
2	47511341	.	T	C	3	2	5	0	0	5	0	0
2	47512820	.	G	A	6	14	20	0	1	21	0	0
2	47513002	.	G	T	10	15	25	0	1	26	0	0
2	47513391	.	G	A	0	3	3	0	7	10	0	0
2	47513712	.	C	A	12	19	31	0	0	31	0	0
2	47513871	.	C	A	16	21	37	0	0	37	0	0
2	47514001	.	A	G	16	17	33	0	2	35	0	0
2	47514504	.	C	A	3	2	5	0	1	6	0	0
2	47514582	.	T	G	7	6	13	0	0	13	0	0
2	47514613	.	T	A	11	9	20	0	0	20	0	0
2	47514619	.	A	T	10	11	21	0	0	21	0	0
2	47514697	.	A	G	14	16	30	0	1	31	0	0
2	47514878	.	T	G	13	18	31	0	1	32	0	0
2	47515019	.	T	C	16	15	31	0	1	32	0	0
2	47515073	.	T	C	7	17	24	0	0	24	0	0
2	47515111	.	G	A	7	18	25	0	0	25	0	0
2	47515223	.	T	A	14	12	26	0	0	26	0	0
2	47582891	.	A	G	21	18	39	0	1	40	0	0
2	47583029	.	C	A	24	30	54	0	3	57	0	0
2	47583377	.	G	A	2	28	30	0	28	58	0	0
2	47583701	.	C	T	25	29	54	0	0	54	0	0
2	47583788	.	T	A	31	25	56	0	2	58	0	0
2	47584064	.	G	A	0	32	32	0	34	66	0	0
2	47584092	.	G	A	33	39	72	0	3	75	0	0
2	47584547	.	T	A	24	29	53	0	5	58	0	0
2	47584612	.	G	A	32	18	50	0	2	52	0	0
2	47584799	.	A	T	36	36	72	0	0	72	0	0
2	47587387	.	C	A	4	4	8	0	0	8	0	0
2	47587423	.	A	T	5	3	8	0	0	8	0	0
2	47587652	.	C	T	8	7	15	0	2	17	0	0
2	47587703	.	A	G	8	8	16	0	0	16	0	0
2	47620714	.	C	T	0	0	0	0	1	1	0	0
2	47633835	.	T	A	2	3	5	0	0	5	0	0
2	47633841	.	C	T	2	3	5	0	0	5	0	0
2	47644488	.	T	G	28	17	45	0	0	45	0	0
2	47648076	.	A	G	16	16	32	0	2	34	0	0
2	47648091	.	T	G	11	12	23	0	0	23	0	0
2	47651598	.	A	G	7	4	11	0	0	11	0	0
2	47652403	.	A	G	7	4	11	0	0	11	0	0
2	47652406	.	A	G	6	4	10	0	1	11	0	0
2	47658641	.	T	G	3	4	7	0	1	8	0	0
2	47658653	.	G	A	4	4	8	0	1	9	0	0
2	47658752	.	A	G	6	5	11	0	1	12	0	0
2	47661273	.	A	C	5	0	5	0	4	9	0	0
2	47662955	.	A	G	9	9	18	0	1	19	0	0
2	47754496	.	G	T	0	5	5	0	2	7	0	0
2	47754503	.	A	C	2	6	8	0	0	8	0	0
2	47805071	.	G	C	0	2	2	0	5	7	0	0
2	47827274	.	A	G	1	1	2	0	0	2	0	0
2	47829112	.	T	C	5	5	10	0	1	11	0	0
2	47829126	.	C	T	6	5	11	0	0	11	0	0
2	47911210	.	T	G	1	1	2	0	0	2	0	0
2	47911214	.	G	A	1	2	3	0	0	3	0	0
2	47918505	.	T	C	0	1	1	0	0	1	0	0
2	47918584	.	C	T	0	5	5	0	1	6	0	0
2	47918632	.	T	G	0	3	3	0	0	3	0	0
2	47918643	.	C	G	0	1	1	0	0	1	0	0
2	47955325	.	A	G	1	4	5	0	0	5	0	0
2	47955412	.	A	G	6	3	9	0	0	9	0	0
2	47955727	.	T	G	2	4	6	0	0	6	0	0
2	47955737	.	T	G	3	3	6	0	0	6	0	0
2	48101420	.	C	G	1	0	1	0	1	2	0	0
2	48107376	.	C	T	0	3	3	0	0	3	0	0
2	48112887	.	A	T	1	0	1	0	0	1	0	0
2	48113040	.	G	A	0	1	1	0	0	1	0	0
2	48114388	.	G	A	1	5	6	0	1	7	0	0
2	48114391	.	T	G	1	0	1	0	6	7	0	0
2	48115732	.	T	A	2	4	6	0	1	7	0	0
2	48115990	.	C	T	1	3	4	0	1	5	0	0
2	48118470	.	T	C	3	0	3	0	1	4	0	0
2	48118485	.	G	A	0	1	1	0	3	4	0	0
2	48119134	.	G	A	3	6	9	0	1	10	0	0
2	48119209	.	G	A	5	4	9	0	0	9	0	0
2	48119530	.	T	A	1	4	5	0	0	5	0	0
2	48119631	.	A	C	7	11	18	0	0	18	0	0
2	48119696	.	A	T	9	10	19	0	0	19	0	0
2	48119704	.	A	T	8	9	17	0	1	18	0	0
2	48119744	.	A	G	5	11	16	0	1	17	0	0
2	48119793	.	A	C	13	21	34	0	1	35	0	0
2	48119821	.	T	A	10	19	29	0	2	31	0	0
2	48120190	.	A	T	18	6	24	0	1	25	0	0
2	48120273	.	T	C	17	4	21	0	3	24	0	0
2	48120274	.	T	A	15	5	20	0	4	24	0	0
2	48120318	.	A	T	14	6	20	0	2	22	0	0
2	48120392	.	C	G	10	5	15	0	0	15	0	0
2	48120401	.	A	G	11	5	16	0	0	16	0	0
2	48120430	.	C	T	13	6	19	0	0	19	0	0
2	48120516	.	T	C	17	14	31	0	3	34	0	0
2	48120689	.	G	A	19	8	27	0	0	27	0	0
2	48120694	.	C	G	19	8	27	0	1	28	0	0
2	48120743	.	T	C	11	7	18	0	0	19	1	0
2	48120744	.	G	A	11	6	17	0	2	19	0	0
2	48120805	.	T	A	8	7	15	0	1	16	0	0
2	48120825	.	A	C	6	5	11	0	2	13	0	0
2	48120864	.	C	A	3	5	8	0	0	8	0	0
2	48120971	.	T	C	2	2	4	0	0	4	0	0
2	48121039	.	T	C	3	2	5	0	0	5	0	0
2	48121078	.	T	C	1	2	3	0	0	3	0	0
2	48121312	.	G	A	12	6	18	0	1	19	0	0
2	48121351	.	G	C	12	8	20	0	0	20	0	0
2	48121352	.	T	C	12	8	20	0	0	20	0	0
2	48121428	.	T	A	7	3	10	0	0	10	0	0
2	48121713	.	G	T	7	5	12	0	0	12	0	0
2	48121743	.	A	G	5	5	10	0	1	11	0	0
2	48127614	.	G	A	1	0	1	0	0	1	0	0
2	48130281	.	A	G	0	2	2	0	0	2	0	0
2	48203544	.	A	G	17	9	26	0	0	26	0	0
2	48203554	.	C	T	14	8	22	0	5	27	0	0
2	48203622	.	G	A	13	15	28	0	1	29	0	0
2	48203920	.	C	A	0	8	8	0	7	15	0	0
2	48207319	.	C	T	0	10	10	0	11	21	0	0
2	48212114	.	C	A	2	1	3	0	0	3	0	0
2	48221479	.	C	T	0	11	11	0	4	15	0	0
2	48232643	.	T	A	5	4	9	0	1	10	0	0
2	48284721	.	G	A	34	13	47	0	0	47	0	0
2	48285153	.	C	G	15	15	30	0	1	31	0	0
2	48285241	.	T	G	11	4	15	0	1	16	0	0
2	48285265	.	A	C	11	5	16	0	0	16	0	0
2	48290805	.	A	T	26	30	56	0	2	58	0	0
2	48290820	.	C	T	27	30	57	0	1	58	0	0
2	48304467	.	G	A	16	14	30	0	0	30	0	0
2	48309874	.	T	A	12	15	27	0	1	29	1	0
2	48309876	.	A	T	13	16	29	0	0	29	0	0
2	48309970	.	C	A	21	11	32	0	0	32	0	0
2	48310207	.	C	T	0	9	9	0	9	18	0	0
2	48310258	.	A	T	10	10	20	0	1	21	0	0
2	48310266	.	T	C	10	0	10	0	11	21	0	0
2	48310330	.	C	G	9	6	15	0	0	15	0	0
2	48310342	.	A	G	7	7	14	0	1	15	0	0
2	48310374	.	G	A	7	4	11	0	0	11	0	0
2	48313598	.	A	G	5	7	12	0	0	12	0	0
2	48317363	.	G	T	17	12	29	0	1	30	0	0
2	48317418	.	C	G	6	11	17	0	2	19	0	0
2	48317444	.	G	T	5	6	11	0	1	12	0	0
2	48323317	.	C	T	7	15	22	0	0	22	0	0
2	48323341	.	T	C	9	14	23	0	0	23	0	0
2	48323470	.	A	T	16	15	31	0	0	31	0	0
2	48323562	.	A	T	16	9	25	0	7	32	0	0
2	48323572	.	A	G	17	13	30	0	3	33	0	0
2	48323695	.	A	G	14	14	28	0	2	30	0	0
2	48323863	.	A	G	16	14	30	0	0	30	0	0
2	48326354	.	G	A	2	10	12	0	0	12	0	0
2	48326408	.	C	T	0	9	9	0	8	17	0	0
2	48332566	.	A	G	5	2	7	0	0	7	0	0
2	48335187	.	G	A	1	2	3	0	0	3	0	0
2	48343367	.	G	A	3	3	6	0	0	6	0	0
2	48344066	.	C	G	3	1	4	0	0	4	0	0
2	48344072	.	T	C	3	0	3	0	1	4	0	0
2	48345379	.	A	G	0	3	3	0	0	3	0	0
2	48356642	.	C	T	1	4	5	0	0	5	0	0
2	48478720	.	A	T	1	2	3	0	0	3	0	0
2	48512106	.	A	C	2	0	2	0	5	7	0	0
2	48546121	.	T	A	1	3	4	0	0	4	0	0
2	48552301	.	A	G	3	5	8	0	0	8	0	0
2	48552681	.	A	T	1	2	3	0	0	3	0	0
2	48552687	.	A	T	1	2	3	0	0	3	0	0
2	48753714	.	C	T	2	4	6	0	0	6	0	0
2	49007765	.	A	G	12	10	22	0	1	23	0	0
2	49007781	.	A	T	11	12	23	0	1	24	0	0
2	49008073	.	T	A	3	5	8	0	1	9	0	0
2	49008382	.	T	G	5	10	15	0	0	15	0	0
2	49017754	.	C	T	3	1	4	0	0	4	0	0
2	49039195	.	C	G	2	0	2	0	3	5	0	0
2	49448732	.	A	T	4	2	6	0	1	7	0	0
2	49609178	.	T	C	3	7	10	0	2	12	0	0
2	49609190	.	T	C	5	5	10	0	0	10	0	0
2	50892529	.	A	G	12	0	12	0	7	19	0	0
2	50892537	.	A	G	2	14	16	0	2	18	0	0
2	50892671	.	A	G	8	3	11	0	0	11	0	0
2	52052697	.	A	G	0	0	0	0	2	2	0	0
2	52052790	.	T	C	4	6	10	0	0	10	0	0
2	52057394	.	A	G	1	0	1	0	3	4	0	0
2	52060070	.	T	G	0	1	1	0	1	2	0	0
2	52060365	.	C	T	2	1	3	0	0	3	0	0
2	52060390	.	T	C	3	7	10	0	0	10	0	0
2	52060409	.	A	G	7	9	16	0	1	17	0	0
2	52060450	.	G	A	10	12	22	0	1	23	0	0
2	52060492	.	A	T	3	5	8	0	1	9	0	0
2	52062918	.	G	A	0	13	13	0	11	24	0	0
2	52062989	.	T	A	5	5	10	0	0	10	0	0
2	52063101	.	T	A	6	4	10	0	1	11	0	0
2	52063207	.	T	C	3	6	9	0	0	9	0	0
2	52063208	.	C	T	3	6	9	0	0	9	0	0
2	52063250	.	C	G	8	7	15	0	1	16	0	0
2	52549738	.	A	G	5	2	7	0	0	7	0	0
2	52810997	.	G	T	6	4	10	0	0	10	0	0
2	52814146	.	C	T	4	4	8	0	0	8	0	0
2	52815260	.	G	A	3	2	5	0	1	6	0	0
2	52815292	.	C	T	5	4	9	0	0	9	0	0
2	52826659	.	A	G	1	0	1	0	0	1	0	0
2	52827298	.	A	G	2	6	8	0	1	9	0	0
2	53665098	.	A	G	2	1	3	0	0	3	0	0
2	53673285	.	G	A	0	1	1	0	1	2	0	0
2	53673342	.	G	A	12	15	27	0	1	28	0	0
2	53673354	.	T	G	16	14	30	0	3	33	0	0
2	53673393	.	C	A	12	16	28	0	2	30	0	0
2	53675227	.	C	T	17	4	21	0	2	23	0	0
2	53720058	.	G	C	0	3	3	0	4	7	0	0
2	53720098	.	A	G	4	0	4	0	5	9	0	0
2	53720122	.	C	G	2	2	4	0	0	4	0	0
2	53721966	.	G	C	2	2	4	0	0	4	0	0
2	53721976	.	A	G	3	2	5	0	0	5	0	0
2	53724856	.	G	A	0	3	3	0	0	3	0	0
2	53750668	.	T	C	7	7	14	0	4	18	0	0
2	53750707	.	C	T	5	4	9	0	1	10	0	0
2	53750719	.	C	T	6	2	8	0	0	8	0	0
2	54017861	.	G	T	1	2	3	0	1	4	0	0
2	54018350	.	C	T	0	4	4	0	3	7	0	0
2	54018407	.	G	A	4	2	6	0	0	6	0	0
2	54018461	.	G	A	1	2	3	0	0	3	0	0
2	54039142	.	A	G	1	3	4	0	0	4	0	0
2	54039159	.	C	T	0	4	4	0	3	7	0	0
2	54049402	.	T	C	2	4	6	0	2	8	0	0
2	54049453	.	C	A	0	2	2	0	2	4	0	0
2	54051923	.	G	A	1	0	1	0	0	1	0	0
2	54054112	.	C	T	1	1	2	0	0	2	0	0
2	54054184	.	T	A	3	2	5	0	0	5	0	0
2	54771064	.	G	A	0	7	7	0	2	9	0	0
2	54771112	.	C	T	0	1	1	0	0	1	0	0
2	54771296	.	T	G	5	6	11	0	0	11	0	0
2	54774957	.	C	T	6	4	10	0	3	13	0	0
2	54775406	.	C	T	8	10	18	0	0	18	0	0
2	54775415	.	A	G	7	7	14	0	1	15	0	0
2	54775475	.	G	A	11	8	19	0	0	19	0	0
2	54775929	.	G	C	7	6	13	0	0	13	0	0
2	54775940	.	T	C	8	6	14	0	0	14	0	0
2	54775998	.	T	C	5	12	17	0	1	18	0	0
2	54776108	.	G	T	1	9	10	0	6	16	0	0
2	54776357	.	A	C	8	5	13	0	1	14	0	0
2	54776560	.	T	C	11	7	18	0	0	18	0	0
2	54776870	.	C	T	9	6	15	0	0	15	0	0
2	54776966	.	A	G	9	7	16	0	0	16	0	0
2	54777178	.	T	G	12	10	22	0	2	24	0	0
2	54777642	.	G	A	5	7	12	0	0	12	0	0
2	54777849	.	G	A	14	10	24	0	1	25	0	0
2	54777855	.	C	A	14	11	25	0	0	25	0	0
2	54778064	.	G	A	4	8	12	0	0	12	0	0
2	54778255	.	C	T	17	7	24	0	1	25	0	0
2	54778577	.	C	G	19	11	30	0	0	30	0	0
2	54786533	.	G	A	2	5	7	0	1	8	0	0
2	54786741	.	A	C	17	4	21	0	0	21	0	0
2	54831890	.	A	G	1	2	3	0	0	3	0	0
2	54831900	.	A	G	3	2	5	0	0	5	0	0
2	54832541	.	A	G	4	2	6	0	0	6	0	0
2	54832563	.	A	T	1	5	6	0	0	6	0	0
2	54832709	.	T	C	3	3	6	0	1	7	0	0
2	54832750	.	T	A	3	6	9	0	0	9	0	0
2	54832961	.	A	G	1	0	1	0	3	4	0	0
2	54971464	.	C	T	1	0	1	0	0	1	0	0
2	54975551	.	T	C	3	5	8	0	0	8	0	0
2	54977337	.	A	G	9	0	9	0	13	22	0	0
2	54977431	.	C	T	9	9	18	0	0	18	0	0
2	54977959	.	T	G	4	0	4	0	2	6	0	0
2	54977960	.	T	A	4	2	6	0	0	6	0	0
2	54978348	.	A	G	6	6	12	0	0	12	0	0
2	54978423	.	C	T	2	2	4	0	0	4	0	0
2	54978640	.	T	G	4	0	4	0	7	11	0	0
2	54978647	.	T	A	4	5	9	0	2	11	0	0
2	54979273	.	G	C	0	8	8	0	8	16	0	0
2	55200897	.	C	T	1	1	2	0	1	3	0	0
2	55210962	.	C	T	3	5	8	0	0	8	0	0
2	55298004	.	G	A	3	2	5	0	0	5	0	0
2	55489017	.	A	G	6	0	6	0	8	14	0	0
2	55489067	.	G	T	1	4	5	0	10	15	0	0
2	55489261	.	C	T	7	9	16	0	1	17	0	0
2	55489317	.	T	A	13	18	31	0	2	33	0	0
2	55489342	.	T	G	15	17	32	0	3	35	0	0
2	55489499	.	T	A	3	2	5	0	1	6	0	0
2	55490062	.	C	T	9	9	18	0	0	18	0	0
2	55490181	.	A	G	11	24	35	0	1	36	0	0
2	55490232	.	T	C	11	21	32	0	0	32	0	0
2	55490325	.	T	A	18	22	40	0	0	40	0	0
2	55490326	.	C	T	17	21	38	0	2	40	0	0
2	55490377	.	A	G	14	14	28	0	0	28	0	0
2	55490378	.	G	A	14	14	28	0	0	28	0	0
2	55490521	.	T	C	20	13	33	0	2	35	0	0
2	55490686	.	T	A	14	15	29	0	2	31	0	0
2	55490812	.	T	C	13	9	22	0	0	22	0	0
2	55491272	.	C	T	11	2	13	0	0	13	0	0
2	55491380	.	A	G	6	10	16	0	0	16	0	0
2	55491445	.	T	G	17	13	30	0	2	32	0	0
2	55491471	.	C	T	19	15	34	0	1	35	0	0
2	55491666	.	G	A	20	10	30	0	1	31	0	0
2	55491717	.	G	A	21	20	41	0	1	42	0	0
2	55491884	.	T	C	17	19	36	0	1	37	0	0
2	55491893	.	T	C	11	19	30	0	4	34	0	0
2	55492010	.	G	A	13	20	33	0	5	38	0	0
2	55492064	.	T	C	14	22	36	0	2	38	0	0
2	55492108	.	A	G	14	0	14	0	14	28	0	0
2	55492127	.	T	A	14	9	23	0	1	24	0	0
2	55492285	.	T	C	3	6	9	0	0	9	0	0
2	55492286	.	C	T	0	6	6	0	3	9	0	0
2	55670243	.	G	T	1	4	5	0	0	5	0	0
2	55670614	.	G	C	0	3	3	0	0	3	0	0
2	55784141	.	C	T	6	3	9	0	2	11	0	0
2	55784243	.	G	T	4	2	6	0	0	6	0	0
2	55784269	.	A	G	3	4	7	0	0	7	0	0
2	55784877	.	G	A	2	2	4	0	0	4	0	0
2	55784880	.	A	T	2	2	4	0	0	4	0	0
2	55785044	.	G	A	5	3	8	0	1	9	0	0
2	55785177	.	T	A	3	5	8	0	0	8	0	0
2	55785240	.	T	G	5	4	9	0	0	9	0	0
2	55785341	.	G	T	1	3	4	0	0	4	0	0
2	55785636	.	C	A	4	3	7	0	0	7	0	0
2	55787862	.	C	T	1	3	4	0	0	4	0	0
2	55791100	.	G	A	2	0	2	0	0	2	0	0
2	55915076	.	A	T	2	3	5	0	0	5	0	0
2	55933277	.	C	T	0	1	1	0	1	2	0	0
2	55963060	.	C	T	2	4	6	0	0	6	0	0
2	55963116	.	G	A	1	2	3	0	0	3	0	0
2	55963497	.	C	T	6	3	9	0	0	9	0	0
2	55963834	.	C	T	3	2	5	0	0	5	0	0
2	55963853	.	C	T	3	1	4	0	0	4	0	0
2	55963869	.	A	G	3	2	5	0	0	5	0	0
2	55964201	.	A	G	2	2	4	0	0	4	0	0
2	55964231	.	A	T	3	2	5	0	0	5	0	0
2	55964727	.	G	A	7	3	10	0	0	10	0	0
2	55964935	.	A	T	6	3	9	0	0	9	0	0
2	55964953	.	G	A	0	4	4	0	7	11	0	0
2	55965050	.	T	C	10	7	17	0	1	18	0	0
2	55965076	.	T	C	10	6	16	0	1	17	0	0
2	55965256	.	C	T	8	8	16	0	0	16	0	0
2	55965295	.	G	A	10	3	13	0	2	15	0	0
2	55965900	.	G	A	0	2	2	1	6	9	0	0
2	55966028	.	A	C	1	3	4	0	0	4	0	0
2	55966487	.	A	C	1	2	3	0	0	3	0	0
2	55966491	.	T	A	1	1	2	0	0	2	0	0
2	55966658	.	G	A	5	4	9	0	1	10	0	0
2	55966952	.	T	C	3	2	5	0	0	5	0	0
2	55967195	.	T	C	7	7	14	0	1	15	0	0
2	55967341	.	A	T	9	4	13	0	3	16	0	0
2	55967471	.	A	T	12	15	27	0	0	27	0	0
2	55967473	.	C	T	18	9	27	0	0	27	0	0
2	55967758	.	T	C	27	13	40	0	1	41	0	0
2	55967881	.	A	T	0	2	2	0	1	3	0	0
2	55967908	.	C	A	2	2	4	0	1	5	0	0
2	55967916	.	C	A	2	3	5	0	0	5	0	0
2	55967949	.	A	G	2	2	4	0	1	5	0	0
2	55968056	.	C	A	5	5	10	0	1	11	0	0
2	55968117	.	G	A	6	9	15	0	1	16	0	0
2	55968383	.	A	C	18	17	35	0	0	35	0	0
2	55968447	.	C	T	13	19	32	0	1	33	0	0
2	55968472	.	A	G	14	0	14	0	16	30	0	0
2	55968617	.	T	A	3	2	5	0	0	5	0	0
2	56061520	.	C	T	0	4	4	0	0	4	0	0
2	56125687	.	T	C	15	22	37	0	3	40	0	0
2	56125744	.	G	C	26	0	26	0	25	51	0	0
2	56125773	.	C	T	30	14	44	0	0	44	0	0
2	56126047	.	A	C	1	1	2	0	1	3	0	0
2	56126053	.	T	A	1	1	2	0	1	3	0	0
2	56126086	.	A	T	1	2	3	0	0	3	0	0
2	56126132	.	C	G	5	6	11	0	0	11	0	0
2	56127493	.	T	C	10	15	25	0	0	25	0	0
2	56127693	.	T	G	14	16	30	0	0	30	0	0
2	56127720	.	C	G	11	17	28	0	2	30	0	0
2	56127848	.	T	A	7	9	16	0	2	18	0	0
2	56127881	.	T	A	5	5	10	0	1	11	0	0
2	56127884	.	A	T	6	4	10	0	0	10	0	0
2	56128025	.	A	G	5	24	29	0	0	29	0	0
2	56128527	.	A	G	4	12	16	0	2	18	0	0
2	56128582	.	A	G	10	14	24	0	1	25	0	0
2	56128622	.	T	C	10	12	22	0	4	26	0	0
2	56128677	.	C	T	9	12	21	0	1	22	0	0
2	56128687	.	A	T	9	13	22	0	1	23	0	0
2	56128768	.	A	T	5	10	15	0	0	15	0	0
2	56129001	.	A	G	11	14	25	0	1	26	0	0
2	56129462	.	C	G	2	5	7	0	0	7	0	0
2	56129633	.	A	G	10	10	20	0	1	21	0	0
2	56129793	.	A	G	6	3	9	0	2	11	0	0
2	56129920	.	T	A	11	12	23	0	1	24	0	0
2	56129931	.	A	G	11	10	21	0	1	22	0	0
2	56130019	.	A	C	9	14	23	0	0	23	0	0
2	56130259	.	A	G	10	11	21	0	3	24	0	0
2	56130260	.	C	A	10	13	23	0	1	24	0	0
2	56131264	.	A	T	17	11	28	0	1	29	0	0
2	56158782	.	C	T	1	2	3	0	0	3	0	0
2	56162254	.	G	C	3	3	6	0	0	6	0	0
2	56162404	.	C	G	3	9	12	0	0	12	0	0
2	56162412	.	C	T	7	3	10	0	1	11	0	0
2	56181821	.	C	T	2	1	3	0	0	3	0	0
2	56196950	.	C	T	0	3	3	0	0	3	0	0
2	56213096	.	A	G	3	0	3	0	2	5	0	0
2	56218685	.	A	G	4	2	6	0	0	6	0	0
2	56233253	.	C	T	10	18	28	0	0	28	0	0
2	56233498	.	C	G	10	1	11	0	1	12	0	0
2	56233508	.	G	T	9	8	17	0	1	18	0	0
2	56234286	.	C	T	11	12	23	0	0	23	0	0
2	56234580	.	T	G	9	8	17	0	2	19	0	0
2	56234584	.	G	T	5	10	15	0	0	15	0	0
2	56234670	.	A	T	13	17	30	0	0	30	0	0
2	56234700	.	C	T	16	11	27	0	0	27	0	0
2	56234872	.	A	T	11	15	26	0	0	26	0	0
2	56268014	.	C	T	5	2	7	0	0	7	0	0
2	56342894	.	G	A	10	11	21	0	1	22	0	0
2	56344833	.	A	G	7	6	13	0	1	14	0	0
2	56356730	.	G	T	14	19	33	0	0	33	0	0
2	56356806	.	T	C	12	4	16	0	0	16	0	0
2	56359434	.	A	G	9	6	15	0	0	15	0	0
2	56359680	.	G	A	0	1	1	0	0	1	0	0
2	56374961	.	T	G	1	0	1	0	0	1	0	0
2	56380210	.	T	C	0	1	1	0	1	2	0	0
2	56380284	.	G	T	0	2	2	0	0	2	0	0
2	56385241	.	G	A	0	1	1	0	2	3	0	0
2	56463308	.	C	T	10	14	24	0	1	25	0	0
2	56463333	.	C	A	9	15	24	0	2	26	0	0
2	56474451	.	C	T	3	2	5	0	2	7	0	0
2	56476732	.	C	T	19	16	35	0	3	38	0	0
2	56476762	.	A	G	13	13	26	0	2	28	0	0
2	56508695	.	T	C	22	15	37	0	3	40	0	0
2	56508715	.	C	G	15	15	30	0	3	33	0	0
2	56508769	.	T	G	20	17	37	0	1	38	0	0
2	56508797	.	A	T	26	16	42	0	0	42	0	0
2	56508878	.	A	G	15	7	22	0	1	23	0	0
2	56508880	.	C	T	16	7	23	0	0	23	0	0
2	56509165	.	T	C	12	12	24	0	3	27	0	0
2	56509183	.	T	C	14	14	28	0	2	30	0	0
2	56509912	.	A	T	27	15	42	0	0	42	0	0
2	56509929	.	A	C	19	28	47	0	0	47	0	0
2	56510040	.	T	C	20	0	20	0	18	38	0	0
2	56510200	.	G	A	24	5	29	0	1	30	0	0
2	56510216	.	G	A	8	25	33	0	1	34	0	0
2	56510424	.	G	T	11	9	20	0	0	20	0	0
2	56510450	.	T	C	4	6	10	0	0	10	0	0
2	56510492	.	T	C	2	12	14	1	0	15	0	0
2	56511575	.	C	T	8	6	14	0	0	14	0	0
2	56512032	.	C	T	2	2	4	0	0	4	0	0
2	56512054	.	T	C	3	0	3	0	3	6	0	0
2	56512121	.	A	G	5	2	7	0	0	7	0	0
2	56512133	.	A	T	3	7	10	0	0	10	0	0
2	56512162	.	C	T	3	16	19	0	0	19	0	0
2	56512173	.	A	C	3	15	18	0	1	19	0	0
2	56512255	.	T	G	1	8	9	0	1	10	0	0
2	56513510	.	A	C	8	11	19	0	2	21	0	0
2	56513660	.	C	T	1	13	14	0	4	18	0	0
2	56513742	.	C	A	16	11	27	0	0	27	0	0
2	56533104	.	C	G	5	11	16	0	1	17	0	0
2	56533178	.	A	C	12	0	12	0	7	19	0	0
2	56533234	.	A	T	2	2	4	0	0	4	0	0
2	56541387	.	G	A	1	3	4	0	0	4	0	0
2	56541388	.	T	C	3	0	3	0	1	4	0	0
2	56553809	.	G	T	3	9	12	0	1	13	0	0
2	56572165	.	C	A	9	8	17	0	1	18	0	0
2	56572168	.	C	A	0	9	9	0	9	18	0	0
2	56572431	.	A	G	1	4	5	0	2	7	0	0
2	56572461	.	G	A	2	4	6	0	1	7	0	0
2	56574525	.	C	T	0	4	4	0	1	5	0	0
2	56642185	.	C	G	17	7	24	0	2	26	0	0
2	56645018	.	G	A	24	35	59	0	3	62	0	0
2	56645027	.	G	A	37	25	62	0	3	65	0	0
2	56811844	.	A	G	1	3	4	0	0	4	0	0
2	56834054	.	C	G	0	2	2	0	0	2	0	0
2	57082243	.	G	A	1	0	1	0	0	1	0	0
2	57082309	.	G	A	2	2	4	0	0	4	0	0
2	57121623	.	A	T	3	3	6	0	0	6	0	0
2	57121773	.	C	T	0	2	2	0	1	3	0	0
2	57130154	.	G	A	1	4	5	0	1	6	0	0
2	57143433	.	G	A	1	1	2	0	0	2	0	0
2	57143436	.	C	T	1	1	2	0	0	2	0	0
2	57151194	.	G	A	17	13	30	0	1	31	0	0
2	57151242	.	G	T	19	29	48	0	0	48	0	0
2	57151326	.	A	G	8	1	9	0	10	19	0	0
2	57152858	.	T	G	27	21	48	0	3	51	0	0
2	57156050	.	C	A	17	27	44	0	3	47	0	0
2	57156092	.	C	A	17	21	38	0	2	40	0	0
2	57157952	.	C	T	22	24	46	0	0	46	0	0
2	57159557	.	G	A	9	25	34	0	4	38	0	0
2	57159668	.	G	A	40	22	62	0	2	64	0	0
2	57160272	.	C	T	24	23	47	0	4	51	0	0
2	57164902	.	A	G	13	12	25	0	0	25	0	0
2	57165001	.	C	T	25	29	54	0	4	58	0	0
2	57165544	.	C	T	28	32	60	0	4	64	0	0
2	57165565	.	C	T	30	34	64	0	1	65	0	0
2	57212966	.	T	C	5	0	5	0	8	13	0	0
2	57227354	.	A	C	7	6	13	0	0	13	0	0
2	57240283	.	G	T	2	3	5	0	0	5	0	0
2	57240649	.	C	T	0	5	5	0	10	15	0	0
2	57240668	.	G	T	4	9	13	0	1	14	0	0
2	57247280	.	C	A	0	9	9	0	7	16	0	0
2	57247385	.	C	G	3	2	5	0	0	5	0	0
2	57251501	.	A	T	8	3	11	0	1	12	0	0
2	57268947	.	C	A	24	24	48	0	3	51	0	0
2	57269031	.	C	G	26	29	55	0	1	56	0	0
2	57269123	.	C	A	8	14	22	0	2	24	0	0
2	57269136	.	T	A	10	3	13	0	1	14	0	0
2	57417062	.	C	T	5	3	8	0	0	8	0	0
2	57417223	.	G	A	2	5	7	0	1	8	0	0
2	57442945	.	T	C	2	3	5	0	0	5	0	0
2	57617218	.	A	G	1	1	2	0	0	2	0	0
2	57830385	.	T	C	13	0	13	0	17	30	0	0
2	57834927	.	T	C	6	11	17	0	1	18	0	0
2	57834930	.	T	C	6	11	17	0	0	17	0	0
2	57848889	.	G	C	7	8	15	0	1	16	0	0
2	57848936	.	G	C	7	7	14	0	0	14	0	0
2	57867406	.	G	A	2	7	9	0	7	16	0	0
2	57867471	.	C	T	4	2	6	0	0	6	0	0
2	57867473	.	C	T	4	2	6	0	0	6	0	0
2	57867579	.	G	T	7	4	11	0	1	12	0	0
2	57867642	.	A	T	4	6	10	0	0	10	0	0
2	57868151	.	C	T	4	3	7	0	0	7	0	0
2	57868208	.	A	G	0	2	2	0	1	3	0	0
2	57868433	.	T	C	7	8	15	1	1	17	0	0
2	57868580	.	A	G	14	16	30	0	1	31	0	0
2	57869966	.	A	T	2	4	6	0	1	7	0	0
2	57870003	.	A	G	3	7	10	0	1	11	0	0
2	57870049	.	G	A	5	6	11	1	1	13	0	0
2	57870051	.	A	G	6	0	6	1	6	13	0	0
2	57870180	.	T	C	22	7	29	0	3	32	0	0
2	57870323	.	G	T	2	1	3	0	1	4	0	0
2	57870343	.	A	G	2	1	3	0	5	8	0	0
2	57870383	.	G	A	3	7	10	0	1	11	0	0
2	57870559	.	A	G	3	0	3	0	1	4	0	0
2	57870563	.	T	G	4	0	4	0	1	5	0	0
2	57870713	.	C	G	12	5	17	0	0	17	0	0
2	57870794	.	G	T	21	11	32	0	1	33	0	0
2	57870795	.	T	A	21	10	31	0	2	33	0	0
2	57870830	.	A	G	16	11	27	0	2	29	0	0
2	57870868	.	G	A	0	15	15	0	14	29	0	0
2	57870887	.	A	G	19	1	20	0	11	31	0	0
2	57870934	.	T	C	18	10	28	0	4	32	0	0
2	57870984	.	A	T	10	11	21	0	1	22	0	0
2	57879582	.	T	C	9	16	25	0	1	26	0	0
2	57879615	.	T	C	5	0	5	0	6	11	0	0
2	57879618	.	T	C	5	3	8	0	1	9	0	0
2	57883433	.	C	T	6	15	21	0	0	21	0	0
2	57883452	.	C	T	8	22	30	0	3	33	0	0
2	57883509	.	C	T	0	29	29	0	14	43	0	0
2	57891444	.	G	A	9	16	25	0	0	25	0	0
2	57891463	.	T	C	4	8	12	0	0	12	0	0
2	57893054	.	C	T	4	2	6	0	0	6	0	0
2	57893082	.	A	C	4	2	6	0	0	6	0	0
2	57893103	.	T	G	4	2	6	0	0	6	0	0
2	57893340	.	A	T	4	5	9	0	1	10	0	0
2	57893494	.	G	A	4	4	8	0	1	9	0	0
2	57893547	.	A	G	4	3	7	0	1	8	0	0
2	57893684	.	G	A	4	3	7	0	0	7	0	0
2	57893826	.	A	G	2	2	4	0	0	4	0	0
2	57893933	.	C	G	1	2	3	0	0	3	0	0
2	57894012	.	T	C	8	0	8	0	5	13	0	0
2	57894127	.	T	G	4	4	8	0	0	8	0	0
2	57897143	.	T	C	5	2	7	0	0	7	0	0
2	57900156	.	A	G	1	1	2	0	1	3	0	0
2	57900222	.	T	C	1	3	4	0	0	4	0	0
2	57918095	.	G	A	1	3	4	0	0	4	0	0
2	57940928	.	A	G	5	2	7	0	0	7	0	0
2	58009416	.	A	G	2	3	5	0	0	5	0	0
2	58012271	.	T	C	5	8	13	0	0	13	0	0
2	58012293	.	T	C	1	9	10	0	1	11	0	0
2	58013054	.	G	A	5	3	8	0	0	8	0	0
2	58013308	.	A	T	7	16	23	0	0	23	0	0
2	58013336	.	T	C	7	13	20	0	1	21	0	0
2	58013477	.	A	G	0	2	2	0	0	2	0	0
2	58013484	.	C	T	0	2	2	0	0	2	0	0
2	58013903	.	A	G	7	0	7	0	9	16	0	0
2	58014110	.	G	T	3	7	10	0	0	10	0	0
2	58014156	.	A	T	6	15	21	0	0	21	0	0
2	58014364	.	G	A	9	7	16	0	1	17	0	0
2	58014502	.	G	A	2	4	6	0	0	6	0	0
2	58014537	.	T	C	1	7	8	0	0	8	0	0
2	58077783	.	T	G	2	9	11	0	1	12	0	0
2	58077795	.	C	A	4	9	13	0	0	13	0	0
2	58077869	.	T	C	8	6	14	0	2	16	0	0
2	58078071	.	G	C	3	2	5	0	0	5	0	0
2	58081768	.	G	A	1	2	3	0	0	3	0	0
2	58122023	.	A	T	3	1	4	0	0	4	0	0
2	58126268	.	C	T	0	3	3	0	0	3	0	0
2	58129968	.	C	G	2	0	2	0	0	2	0	0
2	58137902	.	A	C	2	5	7	0	0	7	0	0
2	58186872	.	T	C	7	2	9	0	0	9	0	0
2	58186891	.	G	T	8	2	10	0	0	10	0	0
2	58187038	.	G	A	11	3	14	0	0	14	0	0
2	58187052	.	T	A	10	5	15	0	0	15	0	0
2	58187621	.	G	T	11	4	15	0	1	16	0	0
2	58187624	.	C	T	1	5	6	0	10	16	0	0
2	58349088	.	A	G	1	1	2	0	0	2	0	0
2	58349253	.	G	A	2	1	3	0	0	3	0	0
2	58358563	.	A	T	0	0	0	0	1	1	0	0
2	58411998	.	T	C	3	5	8	0	1	9	0	0
2	58412124	.	G	A	0	3	3	0	9	12	0	0
2	58514819	.	T	C	3	3	6	0	0	6	0	0
2	58523710	.	C	A	1	5	6	0	3	9	0	0
2	58541894	.	C	T	7	10	17	0	1	18	0	0
2	58546821	.	G	T	10	12	22	0	0	22	0	0
2	58560081	.	G	C	0	1	1	0	1	2	0	0
2	58570715	.	C	G	0	1	1	0	0	1	0	0
2	58577045	.	A	C	3	4	7	0	0	7	0	0
2	58632210	.	T	C	2	0	2	0	12	14	0	0
2	58632433	.	G	A	2	4	6	0	0	6	0	0
2	58632475	.	G	A	1	0	1	0	0	1	0	0
2	58639153	.	C	T	0	2	2	0	6	8	0	0
2	58739714	.	G	A	8	12	20	0	0	20	0	0
2	58742652	.	G	A	0	3	3	0	6	9	0	0
2	58778264	.	G	A	8	15	23	0	0	23	0	0
2	58785286	.	G	A	6	3	9	0	0	9	0	0
2	58785866	.	T	C	1	10	11	0	2	13	0	0
2	58786091	.	G	A	3	5	8	0	1	9	0	0
2	58788301	.	A	G	4	3	7	0	0	7	0	0
2	58793667	.	G	A	6	6	12	0	2	14	0	0
2	58795599	.	C	T	2	0	2	0	0	2	0	0
2	58841219	.	T	C	7	7	14	0	0	14	0	0
2	58845161	.	G	T	0	1	1	0	0	1	0	0
2	58845396	.	T	C	5	10	15	0	0	15	0	0
2	58868190	.	G	A	4	6	10	0	4	14	0	0
2	58868193	.	G	A	9	6	15	0	0	15	0	0
2	58868508	.	A	C	10	0	10	0	13	23	0	0
2	58868577	.	G	C	14	0	14	0	11	25	0	0
2	58868841	.	G	A	8	9	17	0	0	17	0	0
2	58869040	.	C	T	2	1	3	0	0	3	0	0
2	58869142	.	G	A	7	9	16	1	1	18	0	0
2	58869166	.	G	A	3	9	12	0	1	13	0	0
2	58869268	.	A	G	8	6	14	0	2	16	0	0
2	58878612	.	C	T	15	11	26	0	1	27	0	0
2	58879122	.	C	G	19	1	20	0	10	31	1	0
2	58887668	.	T	C	6	3	9	0	1	10	0	0
2	58888909	.	G	A	7	3	10	0	2	12	0	0
2	58888916	.	T	A	3	3	6	0	2	8	0	0
2	58888966	.	C	A	5	15	20	0	4	24	0	0
2	58892160	.	C	T	9	7	16	0	0	16	0	0
2	58898167	.	C	T	0	0	0	0	1	1	0	0
2	58914896	.	A	G	2	2	4	0	1	5	0	0
2	58917504	.	A	T	4	2	6	0	0	6	0	0
2	58996000	.	A	T	3	4	7	0	0	7	0	0
2	59023901	.	T	C	7	11	18	0	1	19	0	0
2	59032670	.	T	C	9	14	23	0	1	24	0	0
2	59045797	.	G	A	0	0	0	0	1	1	0	0
2	59045912	.	A	G	8	0	8	0	9	17	0	0
2	59050160	.	C	T	2	2	4	0	0	4	0	0
2	59136533	.	G	A	0	3	3	0	0	3	0	0
2	59136823	.	T	A	1	3	4	0	0	4	0	0
2	59136859	.	T	C	5	5	10	0	0	10	0	0
2	59136919	.	T	G	3	5	8	0	0	8	0	0
2	59137027	.	C	G	1	2	3	0	1	4	0	0
2	59137050	.	T	A	2	8	10	0	0	10	0	0
2	59137113	.	C	T	5	3	8	0	3	11	0	0
2	59137184	.	G	T	5	5	10	0	1	11	0	0
2	59143183	.	A	G	3	9	12	0	0	12	0	0
2	59565508	.	C	T	2	3	5	0	0	5	0	0
2	59565584	.	G	A	0	3	3	0	0	3	0	0
20	66919	.	C	T	3	4	7	0	0	7	0	0
20	67388	.	C	A	2	4	6	0	0	6	0	0
20	67755	.	C	T	5	2	7	0	0	7	0	0
20	67867	.	T	G	5	3	8	0	0	8	0	0
20	75079	.	C	A	11	7	18	0	0	18	0	0
20	75121	.	C	T	8	10	18	0	0	18	0	0
20	75148	.	T	C	12	7	19	0	1	20	0	0
20	75266	.	G	A	1	8	9	0	8	17	0	0
20	75330	.	T	A	8	7	15	0	2	17	0	0
20	75374	.	A	G	11	9	20	0	0	20	0	0
20	75376	.	G	T	0	9	9	0	11	20	0	0
20	75889	.	C	T	13	12	25	0	2	27	0	0
20	76193	.	G	A	1	6	7	0	10	17	0	0
20	76209	.	A	G	5	10	15	0	1	16	0	0
20	76285	.	C	T	16	13	29	0	1	30	0	0
20	87796	.	A	G	1	3	4	0	0	4	0	0
20	89176	.	A	G	11	8	19	0	0	19	0	0
20	89188	.	G	T	1	8	9	0	11	20	0	0
20	89351	.	C	G	2	2	4	0	0	4	0	0
20	89354	.	C	T	2	2	4	0	0	4	0	0
20	89567	.	G	A	6	18	24	0	1	25	0	0
20	89607	.	G	T	0	6	6	0	12	18	0	0
20	89625	.	T	A	8	9	17	0	0	17	0	0
20	89720	.	G	A	9	10	19	0	0	19	0	0
20	90003	.	A	T	18	15	33	0	2	35	0	0
20	90167	.	C	T	7	19	26	0	2	28	0	0
20	90242	.	T	C	15	15	30	0	2	32	0	0
20	90246	.	T	C	14	15	29	0	3	32	0	0
20	114147	.	G	A	1	4	5	0	1	6	0	0
20	114708	.	A	G	30	16	46	0	4	50	0	0
20	114776	.	A	G	18	10	28	0	2	30	0	0
20	116164	.	A	T	20	21	41	0	1	42	0	0
20	122244	.	C	G	2	2	4	0	0	4	0	0
20	122577	.	G	A	2	2	4	0	0	4	0	0
20	125470	.	G	A	3	2	5	0	2	7	0	0
20	125488	.	A	G	6	2	8	0	1	9	0	0
20	147500	.	A	T	2	3	5	0	1	6	0	0
20	151548	.	C	T	0	11	11	0	8	19	0	0
20	151846	.	C	T	22	11	33	0	3	36	0	0
20	152496	.	G	C	1	1	2	0	0	2	0	0
20	159486	.	T	C	1	2	3	0	0	3	0	0
20	186752	.	G	A	13	12	25	0	3	28	0	0
20	188449	.	A	G	16	9	25	0	1	26	0	0
20	188638	.	T	C	4	11	15	0	0	15	0	0
20	188687	.	C	G	2	3	5	0	0	5	0	0
20	196767	.	G	A	11	7	18	0	1	19	0	0
20	196773	.	T	A	10	9	19	0	0	19	0	0
20	196838	.	G	A	8	11	19	0	2	21	0	0
20	197274	.	T	C	15	9	24	0	3	27	0	0
20	197560	.	C	G	12	10	22	0	2	24	0	0
20	197842	.	T	C	17	7	24	0	1	25	0	0
20	198040	.	G	T	11	9	20	0	0	20	0	0
20	198049	.	C	T	11	11	22	0	0	22	0	0
20	198112	.	G	T	21	14	35	0	0	35	0	0
20	198127	.	A	T	15	21	36	0	1	37	0	0
20	198352	.	G	A	11	12	23	0	3	26	0	0
20	199168	.	C	T	0	13	13	0	5	18	0	0
20	199504	.	C	T	3	8	11	0	1	12	0	0
20	199956	.	G	A	6	5	11	0	0	11	0	0
20	199962	.	T	C	4	5	9	0	1	10	0	0
20	200302	.	C	T	6	2	8	0	0	8	0	0
20	200851	.	G	A	2	11	13	0	0	13	0	0
20	201524	.	G	C	6	4	10	0	0	10	0	0
20	202012	.	A	G	1	3	4	0	0	4	0	0
20	202384	.	G	A	2	5	7	0	1	8	0	0
20	202389	.	A	G	5	2	7	0	1	8	0	0
20	239679	.	T	C	1	0	1	0	0	1	0	0
20	239684	.	T	A	1	0	1	0	0	1	0	0
20	240766	.	T	A	1	2	3	0	0	3	0	0
20	247639	.	G	A	1	0	1	0	0	1	0	0
20	247648	.	G	C	1	0	1	0	0	1	0	0
20	254130	.	G	A	1	3	4	0	0	4	0	0
20	254601	.	C	T	1	2	3	0	0	3	0	0
20	255859	.	G	A	0	4	4	0	4	8	0	0
20	258687	.	G	A	1	3	4	0	0	4	0	0
20	259602	.	T	C	5	8	13	0	0	13	0	0
20	259625	.	T	C	3	10	13	0	0	13	0	0
20	259763	.	C	T	7	7	14	0	1	15	0	0
20	259766	.	C	A	7	7	14	0	1	15	0	0
20	259847	.	C	T	3	5	8	0	0	8	0	0
20	329072	.	A	C	2	4	6	0	2	8	0	0
20	329113	.	G	A	1	1	2	0	0	2	0	0
20	369583	.	A	G	0	0	0	0	3	3	0	0
20	379577	.	A	C	1	6	7	0	0	7	0	0
20	384606	.	C	T	1	1	2	0	0	2	0	0
20	395704	.	C	T	12	3	15	0	0	15	0	0
20	396013	.	A	G	2	3	5	0	0	5	0	0
20	405867	.	G	A	2	6	8	0	0	8	0	0
20	405925	.	A	C	11	5	16	0	1	17	0	0
20	405928	.	A	G	7	0	7	0	12	19	0	0
20	406264	.	T	A	3	1	4	0	1	5	0	0
20	406278	.	T	A	0	4	4	0	1	5	0	0
20	409377	.	C	A	5	5	10	0	1	11	0	0
20	409524	.	C	T	7	4	11	0	0	11	0	0
20	409629	.	T	C	6	3	9	0	0	9	0	0
20	410832	.	A	T	8	14	22	0	0	22	0	0
20	410981	.	A	T	17	11	28	0	1	29	0	0
20	411063	.	T	A	2	10	12	0	1	13	0	0
20	423977	.	G	C	2	0	2	0	0	2	0	0
20	426390	.	T	C	2	0	2	0	0	2	0	0
20	426434	.	T	A	6	4	10	0	1	11	0	0
20	429984	.	G	A	3	1	4	0	1	5	0	0
20	430080	.	A	G	3	2	5	0	0	5	0	0
20	430539	.	C	T	0	1	1	0	0	1	0	0
20	431851	.	C	T	1	1	2	0	0	3	1	0
20	438554	.	G	A	3	4	7	0	0	7	0	0
20	442224	.	T	C	1	3	4	0	0	4	0	0
20	474341	.	C	A	3	5	8	0	0	8	0	0
20	483866	.	C	T	1	0	1	0	0	1	0	0
20	522541	.	G	A	5	4	9	0	0	9	0	0
20	522778	.	C	T	2	1	3	0	0	3	0	0
20	522811	.	T	A	1	2	3	0	0	3	0	0
20	528561	.	C	T	12	7	19	0	0	19	0	0
20	530335	.	C	T	4	4	8	0	0	8	0	0
20	530405	.	G	A	0	14	14	0	5	19	0	0
20	530408	.	C	T	5	16	21	0	0	21	0	0
20	530443	.	C	T	13	14	27	0	0	27	0	0
20	530445	.	T	G	13	13	26	0	1	27	0	0
20	530534	.	C	G	11	3	14	0	0	14	0	0
20	530536	.	C	T	3	11	14	0	0	14	0	0
20	530624	.	G	T	6	8	14	0	0	14	0	0
20	555324	.	C	T	1	2	3	0	0	3	0	0
20	560996	.	G	C	2	1	3	0	0	3	0	0
20	565863	.	G	C	3	2	5	0	0	5	0	0
20	566309	.	C	A	3	3	6	0	1	7	0	0
20	566411	.	C	T	2	2	4	0	0	4	0	0
20	566439	.	G	T	1	2	3	0	0	3	0	0
20	605171	.	A	T	1	2	3	0	0	3	0	0
20	605471	.	G	A	4	2	6	0	0	6	0	0
20	700683	.	C	T	0	2	2	0	0	2	0	0
20	700686	.	A	T	0	1	1	0	1	2	0	0
20	700899	.	C	A	10	7	17	0	1	18	0	0
20	700995	.	C	T	3	1	4	0	0	4	0	0
20	707767	.	C	T	2	1	3	0	0	3	0	0
20	712497	.	A	G	1	6	7	0	1	8	0	0
20	742087	.	A	C	2	1	3	0	0	3	0	0
20	752624	.	G	A	0	0	0	0	2	2	0	0
20	755725	.	G	A	0	1	1	0	0	1	0	0
20	757522	.	G	A	4	2	6	0	0	6	0	0
20	757525	.	C	A	2	3	5	0	1	6	0	0
20	761004	.	C	T	5	1	6	0	0	6	0	0
20	761006	.	G	C	1	5	6	0	0	6	0	0
20	764346	.	A	G	3	5	8	0	0	8	0	0
20	764355	.	G	A	6	4	10	0	0	10	0	0
20	764388	.	A	G	8	6	14	0	0	14	0	0
20	764436	.	T	C	3	3	6	0	0	6	0	0
20	764807	.	G	A	15	11	26	0	2	28	0	0
20	771986	.	C	G	3	7	10	0	0	10	0	0
20	772700	.	C	T	2	1	3	0	0	3	0	0
20	775412	.	G	A	0	5	5	0	3	8	0	0
20	775487	.	C	T	9	13	22	0	2	24	0	0
20	775538	.	G	A	0	11	11	0	22	33	0	0
20	775562	.	C	T	14	9	23	0	2	25	0	0
20	775583	.	T	A	7	8	15	0	0	15	0	0
20	776171	.	C	T	22	15	37	1	0	38	0	0
20	776261	.	A	T	14	26	40	0	4	44	0	0
20	776630	.	G	T	12	9	21	0	1	22	0	0
20	776745	.	C	T	1	8	9	0	1	10	0	0
20	776826	.	G	A	9	12	21	0	0	21	0	0
20	776961	.	G	T	14	5	19	0	1	20	0	0
20	845679	.	G	A	0	0	0	0	2	2	0	0
20	847735	.	T	G	1	5	6	0	1	7	0	0
20	847758	.	T	A	2	2	4	0	1	5	0	0
20	847779	.	G	A	3	2	5	0	0	5	0	0
20	847820	.	G	A	0	5	5	0	3	8	0	0
20	847854	.	G	A	3	5	8	0	0	8	0	0
20	847887	.	T	A	3	4	7	0	0	7	0	0
20	851746	.	G	A	2	8	10	0	1	11	0	0
20	851843	.	T	C	6	10	16	0	1	17	0	0
20	851876	.	C	T	12	9	21	0	2	23	0	0
20	852184	.	A	G	5	3	8	0	1	9	0	0
20	856170	.	G	A	3	4	7	0	2	9	0	0
20	856185	.	G	A	4	10	14	0	1	15	0	0
20	875008	.	C	G	4	1	5	0	0	5	0	0
20	875042	.	G	A	1	0	1	0	0	1	0	0
20	880430	.	G	A	9	2	11	0	0	11	0	0
20	880447	.	A	G	8	2	10	0	1	11	0	0
20	883163	.	C	T	0	2	2	0	8	10	0	0
20	892055	.	C	T	1	1	2	0	0	2	0	0
20	902647	.	A	G	7	6	13	0	0	13	0	0
20	902671	.	G	A	4	9	13	0	1	14	0	0
20	902712	.	A	T	3	15	18	0	0	18	0	0
20	908195	.	A	G	9	6	15	0	0	15	0	0
20	908294	.	A	G	4	12	16	0	0	16	0	0
20	908641	.	C	T	0	5	5	0	1	6	0	0
20	908717	.	G	A	3	2	5	0	1	6	0	0
20	943995	.	T	C	3	4	7	0	1	8	0	0
20	944106	.	A	G	1	3	4	0	0	4	0	0
20	946681	.	G	A	4	4	8	0	0	8	0	0
20	1079035	.	G	A	2	4	6	0	0	6	0	0
20	1079084	.	G	C	1	0	1	0	0	1	0	0
20	1081952	.	G	T	6	3	9	0	1	10	0	0
20	1081960	.	G	A	2	5	7	0	0	7	0	0
20	1119975	.	C	G	5	3	8	0	0	8	0	0
20	1125057	.	A	G	11	5	16	0	0	16	0	0
20	1125135	.	G	A	0	10	10	0	10	20	0	0
20	1132561	.	G	A	3	2	5	0	1	6	0	0
20	1177879	.	A	T	8	5	13	0	2	15	0	0
20	1178040	.	T	A	2	5	7	0	0	7	0	0
20	1178041	.	T	C	2	5	7	0	0	7	0	0
20	1178759	.	G	C	4	5	9	0	0	9	0	0
20	1179196	.	T	C	5	7	12	0	0	12	0	0
20	1179348	.	A	C	2	3	5	0	0	5	0	0
20	1179404	.	T	G	3	4	7	0	0	7	0	0
20	1179485	.	T	C	6	4	10	0	0	10	0	0
20	1179577	.	C	T	0	4	4	0	4	8	0	0
20	1179715	.	A	C	6	0	6	0	7	13	0	0
20	1185942	.	G	A	1	0	1	0	0	1	0	0
20	1198485	.	C	T	4	10	14	0	2	16	0	0
20	1198558	.	A	T	7	9	16	0	3	19	0	0
20	1198819	.	T	A	6	7	13	5	3	21	0	0
20	1201917	.	A	T	5	3	8	0	2	10	0	0
20	1202099	.	T	C	7	6	13	0	1	14	0	0
20	1202107	.	C	T	7	6	13	0	0	13	0	0
20	1202134	.	A	T	5	5	10	0	0	10	0	0
20	1203280	.	C	A	2	2	4	1	1	6	0	0
20	1204020	.	T	G	6	3	9	0	2	11	0	0
20	1240552	.	A	T	7	8	15	0	0	15	0	0
20	1240684	.	G	A	4	6	10	0	3	13	0	0
20	1241409	.	A	T	4	5	9	0	0	9	0	0
20	1241478	.	A	T	3	4	7	0	0	8	1	0
20	1241522	.	T	C	6	2	8	0	1	9	0	0
20	1241523	.	T	C	6	2	8	0	1	9	0	0
20	1241809	.	A	T	1	2	3	0	0	3	0	0
20	1257193	.	G	A	2	2	4	0	0	4	0	0
20	1278796	.	G	A	6	4	10	0	2	12	0	0
20	1279033	.	G	A	5	3	8	0	0	8	0	0
20	1294012	.	T	G	11	9	20	0	1	21	0	0
20	1294062	.	C	G	11	20	31	0	0	31	0	0
20	1294612	.	T	C	3	1	4	1	0	5	0	0
20	1294863	.	T	G	7	8	15	0	1	16	0	0
20	1294903	.	C	G	6	5	11	0	2	13	0	0
20	1294970	.	A	G	18	12	30	0	2	32	0	0
20	1295017	.	T	C	2	4	6	0	0	6	0	0
20	1295331	.	T	C	7	0	7	0	2	9	0	0
20	1295387	.	T	C	2	3	5	0	0	5	0	0
20	1295426	.	G	T	3	4	7	0	0	7	0	0
20	1295840	.	G	A	20	14	34	0	0	34	0	0
20	1296022	.	G	C	12	14	26	0	0	27	1	0
20	1296114	.	G	A	17	15	32	0	0	32	0	0
20	1296139	.	A	G	12	14	26	0	4	30	0	0
20	1316764	.	A	G	2	2	4	0	1	5	0	0
20	1316860	.	G	C	0	6	6	0	2	8	0	0
20	1324404	.	G	A	2	2	4	0	0	4	0	0
20	1324976	.	C	A	3	1	4	0	0	4	0	0
20	1327545	.	A	T	7	9	16	0	0	16	0	0
20	1327776	.	C	A	1	1	2	0	0	2	0	0
20	1338988	.	T	G	2	0	2	0	4	6	0	0
20	1339084	.	G	A	2	7	9	0	0	9	0	0
20	1339657	.	T	C	4	9	13	0	1	14	0	0
20	1339786	.	T	C	0	6	6	0	0	6	0	0
20	1339798	.	G	A	4	3	7	0	1	8	0	0
20	1339843	.	C	T	3	5	8	0	0	8	0	0
20	1339924	.	G	A	4	2	6	0	0	6	0	0
20	1340015	.	G	A	0	4	4	0	5	9	0	0
20	1348890	.	A	T	4	1	5	0	1	6	0	0
20	1348913	.	C	T	5	3	8	0	0	8	0	0
20	1349264	.	A	T	7	6	13	0	0	13	0	0
20	1349357	.	G	A	0	4	4	0	6	10	0	0
20	1349739	.	A	G	2	0	2	0	3	5	0	0
20	1349947	.	G	A	0	6	6	0	3	9	0	0
20	1350101	.	G	A	1	5	6	0	3	9	0	0
20	1441815	.	A	C	15	19	34	0	0	37	3	0
20	1441825	.	T	C	17	17	34	0	1	35	0	0
20	1442358	.	G	T	11	9	20	0	0	20	0	0
20	1442468	.	G	A	9	11	20	0	2	22	0	0
20	1442515	.	A	T	10	11	21	0	2	23	0	0
20	1442522	.	C	A	14	6	20	0	1	21	0	0
20	1442582	.	G	T	12	6	18	0	0	18	0	0
20	1442624	.	C	T	9	13	22	0	1	23	0	0
20	1454065	.	T	C	7	7	14	0	1	15	0	0
20	1455104	.	G	A	8	7	15	0	0	15	0	0
20	1460979	.	C	A	10	7	17	0	2	19	0	0
20	1476772	.	C	T	3	6	9	0	0	9	0	0
20	1513605	.	A	G	5	3	8	0	0	8	0	0
20	1513617	.	G	A	5	5	10	0	0	10	0	0
20	1518414	.	G	A	2	2	4	0	0	4	0	0
20	1519699	.	A	G	4	3	7	0	0	7	0	0
20	2069429	.	T	G	1	2	3	0	0	3	0	0
20	2069445	.	T	A	2	3	5	0	0	5	0	0
20	2073828	.	T	C	1	3	4	0	0	4	0	0
20	2197323	.	A	G	1	1	2	0	1	3	0	0
20	2205982	.	A	G	1	3	4	0	0	4	0	0
20	2206190	.	T	A	2	2	4	0	0	4	0	0
20	2206192	.	A	T	2	2	4	0	0	4	0	0
20	2240414	.	C	T	2	3	5	0	0	5	0	0
20	2240626	.	C	A	1	4	5	0	0	5	0	0
20	2241590	.	A	C	4	4	8	0	0	8	0	0
20	2241871	.	C	T	3	5	8	0	0	8	0	0
20	2241905	.	T	C	2	8	10	0	0	10	0	0
20	2290470	.	G	A	2	4	6	0	1	7	0	0
20	2293263	.	C	A	0	9	9	0	6	15	0	0
20	2295306	.	T	C	9	15	24	0	7	31	0	0
20	2295532	.	G	A	10	22	32	0	4	36	0	0
20	2295640	.	A	G	7	8	15	0	1	16	0	0
20	2318995	.	A	G	2	5	7	0	0	7	0	0
20	2319013	.	C	T	0	1	1	0	1	2	0	0
20	2338942	.	C	T	1	5	6	0	0	6	0	0
20	2338954	.	C	A	4	1	5	0	1	6	0	0
20	2359155	.	T	A	10	9	19	0	0	19	0	0
20	2361074	.	G	A	0	2	2	0	0	2	0	0
20	2361194	.	C	T	4	5	9	0	0	9	0	0
20	2361200	.	C	T	1	4	5	0	2	7	0	0
20	2460902	.	G	C	2	4	6	0	1	7	0	0
20	2479225	.	C	T	9	10	19	0	0	19	0	0
20	2499748	.	T	G	7	2	9	0	1	10	0	0
20	2499749	.	G	T	7	3	10	0	0	10	0	0
20	2499995	.	C	T	15	20	35	0	6	41	0	0
20	2500083	.	G	A	4	4	8	0	0	8	0	0
20	2506085	.	G	T	7	9	16	0	0	16	0	0
20	2513660	.	C	A	3	1	4	0	1	5	0	0
20	2515792	.	A	G	1	1	2	0	0	2	0	0
20	2515807	.	C	T	3	1	4	0	0	4	0	0
20	2515903	.	G	A	1	2	3	0	0	3	0	0
20	2519064	.	G	A	1	2	3	0	0	3	0	0
20	2519136	.	G	A	4	5	9	0	1	10	0	0
20	2519674	.	G	A	2	1	3	0	0	3	0	0
20	2519854	.	G	A	3	0	3	0	0	3	0	0
20	2524484	.	C	T	1	3	4	0	2	6	0	0
20	2524499	.	G	A	3	4	7	0	0	7	0	0
20	2529276	.	T	G	3	3	6	0	1	7	0	0
20	2529291	.	A	T	2	2	4	0	0	4	0	0
20	2545635	.	G	A	1	3	4	0	0	4	0	0
20	2548520	.	C	T	1	3	4	0	0	4	0	0
20	2548523	.	C	T	0	3	3	0	1	4	0	0
20	2552049	.	T	A	0	1	1	0	0	1	0	0
20	2708172	.	C	T	0	2	2	0	0	2	0	0
20	2709023	.	G	A	2	4	6	0	0	6	0	0
20	2709024	.	C	T	2	4	6	0	0	6	0	0
20	2716055	.	A	G	9	1	10	0	1	11	0	0
20	2716234	.	A	G	8	8	16	0	1	17	0	0
20	2716614	.	A	G	4	2	6	0	0	6	0	0
20	2718643	.	C	T	1	0	1	0	0	1	0	0
20	2718866	.	G	A	9	11	20	0	1	21	0	0
20	2721834	.	G	A	12	8	20	0	0	20	0	0
20	2725716	.	C	T	12	16	28	0	0	28	0	0
20	2737535	.	G	A	5	3	8	0	0	8	0	0
20	2738620	.	C	T	7	4	11	0	0	11	0	0
20	2739065	.	C	T	16	14	30	0	2	32	0	0
20	2739543	.	T	C	8	13	21	0	0	21	0	0
20	2739760	.	A	T	9	3	12	0	0	12	0	0
20	2742486	.	G	A	1	6	7	1	1	9	0	0
20	2744280	.	A	T	5	8	13	0	2	15	0	0
20	2744455	.	A	T	16	6	22	0	5	27	0	0
20	2744759	.	G	T	11	17	28	0	1	29	0	0
20	2744945	.	C	A	13	12	25	0	0	25	0	0
20	2882403	.	G	C	4	0	4	0	1	5	0	0
20	2882428	.	G	A	5	2	7	0	0	7	0	0
20	2970030	.	C	T	11	10	21	0	1	22	0	0
20	2975121	.	A	C	14	11	25	0	1	26	0	0
20	2975271	.	C	T	22	12	34	0	2	36	0	0
20	2976094	.	A	G	2	0	2	0	0	2	0	0
20	2976257	.	A	G	17	8	25	0	1	26	0	0
20	2976308	.	A	T	1	5	6	4	0	10	0	0
20	2976683	.	A	G	5	5	10	3	2	15	0	0
20	2976804	.	T	C	21	1	22	6	1	29	0	0
20	2976909	.	C	A	17	9	26	2	1	29	0	0
20	2977257	.	C	T	24	27	51	0	1	52	0	0
20	2977417	.	C	A	23	0	23	1	0	24	0	0
20	2977418	.	C	A	22	0	22	1	1	24	0	0
20	2982464	.	C	T	3	7	10	0	0	10	0	0
20	2982755	.	G	T	14	5	19	0	0	19	0	0
20	2982820	.	T	C	4	2	6	0	1	7	0	0
20	2982825	.	C	G	3	3	6	0	0	6	0	0
20	2983251	.	T	C	1	2	3	0	0	3	0	0
20	2983673	.	G	T	2	0	2	0	0	2	0	0
20	2986822	.	G	C	4	5	9	0	0	9	0	0
20	2986861	.	G	A	3	6	9	0	1	10	0	0
20	2996564	.	A	C	2	0	2	0	1	3	0	0
20	2996621	.	C	T	1	0	1	0	0	1	0	0
20	3017445	.	C	T	4	2	6	0	0	6	0	0
20	3017513	.	C	A	0	5	5	0	13	18	0	0
20	3018319	.	T	C	1	0	1	0	5	6	0	0
20	3020423	.	G	A	1	2	3	0	0	3	0	0
20	3028142	.	A	G	0	1	1	0	0	1	0	0
20	3029617	.	G	C	5	2	7	0	0	7	0	0
20	3029659	.	A	C	0	1	1	0	0	1	0	0
20	3029662	.	A	G	0	1	1	0	0	1	0	0
20	3039818	.	G	A	0	2	2	0	0	2	0	0
20	3050790	.	T	A	1	0	1	0	0	1	0	0
20	3050877	.	T	C	7	0	7	0	7	14	0	0
20	3086374	.	G	A	3	2	5	0	0	5	0	0
20	3086570	.	G	C	4	2	6	0	0	6	0	0
20	3087029	.	T	C	2	0	2	0	3	5	0	0
20	3118250	.	A	C	1	4	5	0	0	5	0	0
20	3118397	.	A	T	2	2	4	0	0	4	0	0
20	3118607	.	T	C	1	3	4	0	0	4	0	0
20	3121027	.	A	C	3	3	6	0	0	6	0	0
20	3121462	.	T	A	3	3	6	0	0	6	0	0
20	3121475	.	T	C	2	3	5	0	0	5	0	0
20	3121539	.	T	A	3	3	6	0	0	6	0	0
20	3121623	.	C	T	2	3	5	0	1	6	0	0
20	3121644	.	G	A	0	4	4	0	1	5	0	0
20	3121689	.	T	A	3	4	7	0	0	7	0	0
20	3121947	.	G	A	3	4	7	0	1	8	0	0
20	3122251	.	G	A	2	6	8	0	1	9	0	0
20	3129754	.	C	G	0	2	2	0	0	2	0	0
20	3130347	.	C	A	4	2	6	0	0	6	0	0
20	3130487	.	T	C	1	2	3	0	1	4	0	0
20	3145831	.	G	A	2	2	4	0	0	4	0	0
20	3239324	.	C	T	1	7	8	0	11	19	0	0
20	3239470	.	T	G	9	7	16	0	0	16	0	0
20	3242661	.	C	T	3	5	8	0	1	9	0	0
20	3242664	.	T	A	3	6	9	0	1	10	0	0
20	3242887	.	T	A	3	1	4	0	1	5	0	0
20	3242944	.	A	G	1	4	5	0	0	5	0	0
20	3246643	.	A	G	2	4	6	0	1	7	0	0
20	3248766	.	G	A	8	13	21	0	2	23	0	0
20	3249029	.	G	A	10	9	19	0	0	19	0	0
20	3249414	.	A	T	9	6	15	0	0	15	0	0
20	3249500	.	T	G	5	5	10	0	0	10	0	0
20	3249513	.	G	T	3	5	8	0	1	9	0	0
20	3249796	.	G	T	3	6	9	0	0	9	0	0
20	3266067	.	A	G	5	2	7	0	1	8	0	0
20	3284553	.	C	T	2	7	9	0	1	10	0	0
20	3287847	.	A	G	1	0	1	0	0	5	4	0
20	3288058	.	C	T	5	9	14	0	0	14	0	0
20	3290378	.	G	T	8	4	12	0	0	12	0	0
20	3290462	.	G	A	9	12	21	0	0	21	0	0
20	3290744	.	G	A	0	5	5	0	0	5	0	0
20	3292039	.	C	T	2	0	2	0	0	2	0	0
20	3295009	.	T	C	3	2	5	0	0	5	0	0
20	3298096	.	T	C	3	2	5	0	0	5	0	0
20	3298321	.	T	C	2	1	3	0	0	3	0	0
20	3303484	.	C	T	6	3	9	0	0	9	0	0
20	3307934	.	A	G	3	3	6	0	0	6	0	0
20	3309893	.	C	T	3	5	8	0	0	8	0	0
20	3309933	.	C	A	0	4	4	0	5	9	0	0
20	3312997	.	T	C	2	5	7	0	0	7	0	0
20	3313037	.	C	G	9	4	13	0	0	13	0	0
20	3313205	.	G	T	2	2	4	0	1	5	0	0
20	3313206	.	C	T	2	3	5	0	0	5	0	0
20	3313282	.	C	T	6	10	16	0	1	17	0	0
20	3316852	.	C	A	0	3	3	0	2	5	0	0
20	3343829	.	A	C	1	1	2	0	0	2	0	0
20	3344016	.	G	C	1	4	5	0	0	5	0	0
20	3344084	.	G	A	1	5	6	0	1	7	0	0
20	3344324	.	C	T	5	2	7	0	0	7	0	0
20	3344696	.	G	T	0	3	3	0	7	10	0	0
20	3344735	.	A	C	6	3	9	0	1	10	0	0
20	3344975	.	T	C	9	3	12	0	0	12	0	0
20	3345151	.	G	A	0	3	3	0	10	13	0	0
20	3345197	.	G	T	4	6	10	0	0	10	0	0
20	3345198	.	T	C	6	4	10	0	0	10	0	0
20	3346490	.	A	T	10	10	20	0	1	21	0	0
20	3346497	.	C	A	0	13	13	0	9	22	0	0
20	3346599	.	G	A	10	11	21	0	0	21	0	0
20	3346629	.	C	T	12	13	25	0	1	26	0	0
20	3346710	.	C	T	15	21	36	0	0	36	0	0
20	3346865	.	C	G	0	6	6	0	11	17	0	0
20	3346907	.	C	T	4	5	9	0	1	10	0	0
20	3349049	.	A	G	7	8	15	0	1	16	0	0
20	3349067	.	T	A	6	5	11	0	0	11	0	0
20	3351627	.	A	T	8	8	16	0	2	18	0	0
20	3351661	.	A	C	7	4	11	0	0	11	0	0
20	3353337	.	C	T	8	11	19	0	0	19	0	0
20	3355695	.	A	T	4	4	8	0	0	8	0	0
20	3357024	.	C	T	8	4	12	0	0	12	0	0
20	3359346	.	C	T	6	9	15	0	0	15	0	0
20	3361480	.	A	T	3	6	9	0	3	12	0	0
20	3365747	.	C	T	1	4	5	0	0	5	0	0
20	3365752	.	C	A	1	4	5	0	0	5	0	0
20	3365809	.	C	T	0	2	2	0	0	2	0	0
20	3365934	.	A	G	3	4	7	0	1	8	0	0
20	3369377	.	G	A	2	1	3	0	0	3	0	0
20	3369392	.	A	G	1	1	2	0	0	2	0	0
20	3372441	.	G	A	0	1	1	0	0	1	0	0
20	3375982	.	C	T	4	3	7	0	0	7	0	0
20	3376003	.	T	G	4	4	8	0	0	8	0	0
20	3376379	.	C	T	2	4	6	0	0	6	0	0
20	3378072	.	G	A	1	2	3	0	0	3	0	0
20	3916456	.	T	A	5	6	11	0	0	11	0	0
20	3916464	.	C	T	6	8	14	0	0	14	0	0
20	3916621	.	T	G	4	5	9	0	1	10	0	0
20	3920746	.	T	G	5	7	12	0	1	13	0	0
20	3920873	.	T	A	6	14	20	0	0	20	0	0
20	3920875	.	G	A	5	14	19	0	1	20	0	0
20	3920977	.	G	A	0	2	2	0	15	17	0	0
20	3921127	.	A	T	6	10	16	0	1	17	0	0
20	3921184	.	G	A	1	6	7	0	0	7	0	0
20	3921202	.	T	C	1	3	4	0	0	4	0	0
20	3923735	.	C	G	8	3	11	0	1	12	0	0
20	3923983	.	G	A	0	8	8	0	5	13	0	0
20	3924098	.	A	T	13	11	24	0	0	24	0	0
20	3924349	.	G	A	8	3	11	0	0	11	0	0
20	3924430	.	G	A	1	11	12	0	4	17	1	0
20	3924943	.	T	G	5	0	5	0	12	17	0	0
20	3925146	.	A	T	4	7	11	0	0	11	0	0
20	3925260	.	T	G	9	0	9	0	5	14	0	0
20	3925261	.	A	G	9	5	14	0	0	14	0	0
20	3925537	.	T	C	6	4	10	0	0	10	0	0
20	3925544	.	T	A	5	7	12	0	0	12	0	0
20	3925842	.	C	A	13	7	20	0	0	20	0	0
20	3925934	.	C	T	0	3	3	2	0	5	0	0
20	3925942	.	A	G	3	4	7	0	0	7	0	0
20	3926020	.	C	T	7	4	11	0	0	11	0	0
20	3926337	.	C	T	3	7	10	3	0	13	0	0
20	3926721	.	T	C	10	6	16	0	0	16	0	0
20	3926736	.	T	A	11	8	19	0	0	19	0	0
20	3926907	.	T	G	18	10	28	0	2	30	0	0
20	3926928	.	T	A	18	14	32	0	2	34	0	0
20	3926951	.	A	G	24	15	39	0	1	40	0	0
20	3927267	.	C	A	24	16	40	0	4	45	1	0
20	3927326	.	A	G	14	22	36	0	0	36	0	0
20	3927446	.	C	G	15	8	23	0	1	24	0	0
20	3953593	.	T	C	4	3	7	0	1	8	0	0
20	3954813	.	G	C	7	8	15	0	0	15	0	0
20	3954846	.	A	T	4	6	10	0	0	10	0	0
20	3971246	.	G	C	3	1	4	0	0	4	0	0
20	4000366	.	C	T	2	2	4	0	0	4	0	0
20	4009409	.	C	G	3	2	5	0	0	5	0	0
20	4010256	.	T	C	6	6	12	0	0	12	0	0
20	4010462	.	C	T	3	7	10	0	0	10	0	0
20	4011161	.	C	T	2	2	4	0	0	4	0	0
20	4035614	.	T	A	1	3	4	0	0	4	0	0
20	4035837	.	G	A	4	10	14	0	1	15	0	0
20	4035858	.	G	C	5	5	10	0	0	10	0	0
20	4036375	.	A	G	2	5	7	0	0	7	0	0
20	4036462	.	A	G	2	1	3	0	0	3	0	0
20	4036559	.	T	G	4	3	7	0	2	9	0	0
20	4036587	.	T	C	1	7	8	0	0	8	0	0
20	4036720	.	T	C	4	6	10	0	0	10	0	0
20	4036737	.	T	C	8	3	11	0	1	12	0	0
20	4037016	.	T	C	4	2	6	0	0	6	0	0
20	4037057	.	G	A	6	3	9	0	0	9	0	0
20	4037349	.	T	C	3	2	5	0	1	6	0	0
20	4037500	.	C	T	2	3	5	0	1	6	0	0
20	4037942	.	C	T	1	5	6	0	0	6	0	0
20	4038242	.	C	A	1	2	3	0	0	3	0	0
20	4043508	.	C	G	3	2	5	0	0	5	0	0
20	4051818	.	C	T	6	5	11	0	0	11	0	0
20	4052460	.	C	T	3	4	7	0	0	7	0	0
20	4052490	.	G	A	3	2	5	0	0	5	0	0
20	4052502	.	G	T	0	2	2	0	2	4	0	0
20	4052854	.	G	C	2	4	6	0	0	6	0	0
20	4053012	.	G	A	0	3	3	0	3	6	0	0
20	4175807	.	T	A	1	2	3	0	0	3	0	0
20	4180743	.	C	T	0	2	2	0	0	2	0	0
20	4248208	.	A	T	3	2	5	0	0	5	0	0
20	4453006	.	G	A	6	4	10	0	1	11	0	0
20	4453024	.	T	C	2	6	8	0	1	9	0	0
20	4453714	.	C	T	3	4	7	0	0	7	0	0
20	4454196	.	C	A	4	5	9	0	1	10	0	0
20	4712880	.	G	A	6	11	17	0	0	17	0	0
20	4712979	.	A	T	9	21	30	0	1	31	0	0
20	4713027	.	T	A	9	14	23	0	2	25	0	0
20	4713033	.	C	T	10	14	24	0	1	25	0	0
20	4713169	.	G	T	15	19	34	0	1	35	0	0
20	4713654	.	G	A	10	20	30	0	0	30	0	0
20	4713716	.	G	A	13	18	31	0	1	32	0	0
20	4713956	.	C	T	8	15	23	0	2	25	0	0
20	4716436	.	A	G	0	1	1	0	0	1	0	0
20	4717647	.	C	T	4	11	15	0	1	16	0	0
20	4726955	.	A	T	7	6	13	0	0	13	0	0
20	4726973	.	A	G	8	5	13	0	0	13	0	0
20	4728418	.	T	G	1	2	3	0	0	3	0	0
20	4728808	.	C	T	7	12	19	0	2	21	0	0
20	4730914	.	G	A	1	0	1	0	0	1	0	0
20	4730935	.	C	T	1	0	1	0	0	1	0	0
20	4734412	.	C	T	0	1	1	0	0	1	0	0
20	4738004	.	T	C	5	9	14	0	2	16	0	0
20	4745754	.	T	C	7	7	14	0	1	15	0	0
20	4745774	.	C	T	8	8	16	0	0	16	0	0
20	4756804	.	C	A	1	0	1	0	0	1	0	0
20	4766473	.	T	C	0	0	0	0	2	2	0	0
20	4769843	.	T	G	2	2	4	0	0	4	0	0
20	4769885	.	C	T	0	2	2	0	2	4	0	0
20	4769923	.	G	A	3	2	5	0	0	5	0	0
20	4769924	.	T	G	3	1	4	0	1	5	0	0
20	4769969	.	T	A	3	2	5	0	0	5	0	0
20	4812287	.	C	A	1	1	2	0	0	2	0	0
20	4813835	.	T	G	2	2	4	0	0	4	0	0
20	4813847	.	C	T	1	3	4	0	0	4	0	0
20	4813881	.	T	A	2	2	4	0	0	4	0	0
20	4813976	.	C	A	3	3	6	0	0	6	0	0
20	4827972	.	C	T	0	2	2	0	1	3	0	0
20	4828170	.	T	A	6	5	11	0	0	11	0	0
20	4828230	.	A	G	5	5	10	0	0	10	0	0
20	4885321	.	A	G	1	2	3	0	0	3	0	0
20	4887996	.	G	T	2	2	4	0	0	4	0	0
20	4888004	.	A	G	2	2	4	0	0	4	0	0
20	4888037	.	T	C	1	1	2	0	0	2	0	0
20	4895176	.	A	C	1	1	2	0	0	2	0	0
20	4895955	.	C	T	9	9	18	0	0	18	0	0
20	4896240	.	A	C	3	4	7	0	0	7	0	0
20	4898126	.	A	G	1	2	3	0	0	3	0	0
20	4898160	.	T	A	1	2	3	0	0	3	0	0
20	4898173	.	T	C	2	2	4	0	0	4	0	0
20	4898515	.	C	T	14	10	24	0	0	24	0	0
20	4898575	.	A	T	16	8	24	0	0	24	0	0
20	4898631	.	A	T	14	2	16	0	0	16	0	0
20	4898855	.	C	T	1	12	13	0	17	30	0	0
20	4899342	.	T	G	15	18	33	0	3	36	0	0
20	4899479	.	A	G	12	11	23	0	0	23	0	0
20	4899716	.	G	T	5	10	15	0	0	15	0	0
20	4899935	.	A	T	13	13	26	0	2	28	0	0
20	4899969	.	T	G	10	13	23	0	1	24	0	0
20	4900495	.	C	T	0	10	10	0	11	21	0	0
20	4900564	.	T	C	6	5	11	0	1	12	0	0
20	4900609	.	T	C	8	0	8	0	7	15	0	0
20	4900697	.	T	C	11	10	21	0	1	22	0	0
20	4900909	.	T	C	3	1	4	0	5	9	0	0
20	4900921	.	A	G	4	5	9	0	1	10	0	0
20	4901013	.	C	T	5	11	16	0	0	16	0	0
20	4901545	.	T	G	2	4	6	0	0	6	0	0
20	4902868	.	T	G	1	1	2	0	0	2	0	0
20	4902871	.	C	T	0	1	1	0	1	2	0	0
20	4902954	.	A	G	3	4	7	0	0	7	0	0
20	4903334	.	G	C	4	9	13	0	1	14	0	0
20	4903456	.	A	G	5	6	11	0	0	11	0	0
20	4911076	.	A	G	0	1	1	0	0	1	0	0
20	4921034	.	G	A	3	4	7	0	0	7	0	0
20	4933977	.	A	G	1	1	2	0	0	2	0	0
20	4934016	.	T	C	2	0	2	0	3	5	0	0
20	4938844	.	A	G	1	4	5	0	0	5	0	0
20	5065776	.	T	A	1	3	4	0	1	5	0	0
20	5067424	.	A	T	1	0	1	0	0	1	0	0
20	5069212	.	C	G	2	0	2	0	3	5	0	0
20	5069252	.	T	A	2	3	5	0	2	7	0	0
20	5069389	.	G	A	6	5	11	0	0	11	0	0
20	5090908	.	A	C	3	1	4	0	7	11	0	0
20	5090912	.	T	G	6	0	6	0	6	12	0	0
20	5093872	.	A	T	5	3	8	0	1	9	0	0
20	5093882	.	G	A	4	3	7	0	1	8	0	0
20	5094205	.	A	C	4	4	8	0	0	8	0	0
20	5158670	.	T	C	4	2	6	0	0	6	0	0
20	5158691	.	C	T	0	2	2	0	3	5	0	0
20	5158705	.	A	G	3	3	6	0	1	7	0	0
20	5158742	.	A	G	2	3	5	0	0	5	0	0
20	5158787	.	T	A	1	3	4	0	0	4	0	0
20	5158791	.	G	T	1	3	4	0	0	4	0	0
20	5159001	.	A	C	3	2	5	0	0	5	0	0
20	5228120	.	A	G	3	2	5	0	0	5	0	0
20	5330859	.	C	G	7	9	16	0	0	16	0	0
20	5330875	.	A	G	9	7	16	0	2	18	0	0
20	5330990	.	T	A	4	4	8	0	1	9	0	0
20	5331095	.	A	G	4	2	6	0	0	6	0	0
20	5331112	.	G	C	1	5	6	0	0	6	0	0
20	5331186	.	T	C	3	0	3	0	4	7	0	0
20	5331362	.	A	C	2	0	2	0	4	6	0	0
20	5332145	.	C	G	7	3	10	0	1	11	0	0
20	5332901	.	T	C	3	0	3	0	3	6	0	0
20	5333317	.	A	G	3	2	5	0	0	5	0	0
20	5333405	.	T	G	3	3	6	0	0	6	0	0
20	5333541	.	G	A	1	3	4	0	0	4	0	0
20	5348081	.	G	A	3	2	5	0	0	5	0	0
20	5390784	.	A	T	1	2	3	0	2	5	0	0
20	5391138	.	G	T	5	6	11	0	0	11	0	0
20	5394584	.	G	A	4	3	7	0	1	8	0	0
20	5563947	.	A	C	1	3	4	0	0	4	0	0
20	5564233	.	T	C	1	4	5	0	0	5	0	0
20	5679786	.	T	C	2	2	4	0	0	4	0	0
20	5696935	.	C	T	1	2	3	0	0	3	0	0
20	5742118	.	C	T	3	7	10	0	0	10	0	0
20	5742169	.	T	C	1	4	5	0	0	5	0	0
20	5744339	.	T	C	1	4	5	0	0	5	0	0
20	5921278	.	T	C	8	9	17	0	0	17	0	0
20	6308648	.	G	A	10	3	13	0	1	14	0	0
20	6540485	.	C	A	1	3	4	0	0	4	0	0
20	6540486	.	G	A	0	3	3	0	1	4	0	0
20	6666099	.	T	G	1	5	6	0	0	6	0	0
20	6666224	.	G	C	4	3	7	0	0	7	0	0
20	6774183	.	A	G	2	0	2	0	2	4	0	0
20	6791662	.	A	G	4	1	5	0	2	7	0	0
20	6802354	.	T	G	2	6	8	0	0	8	0	0
20	6802441	.	A	C	3	4	7	0	0	7	0	0
20	6802879	.	A	G	4	3	7	0	0	7	0	0
20	6803497	.	C	T	3	2	5	0	2	7	0	0
20	6809612	.	C	T	6	6	12	0	0	12	0	0
20	6894902	.	A	G	4	5	9	0	0	9	0	0
20	6898118	.	A	G	2	4	6	0	0	6	0	0
20	7263207	.	C	A	2	2	4	0	0	4	0	0
20	7582925	.	G	A	0	4	4	0	2	6	0	0
20	7583371	.	A	G	0	2	2	0	0	2	0	0
20	7588957	.	A	G	3	0	3	0	2	6	1	0
20	7965965	.	G	A	2	6	8	0	0	8	0	0
20	7966006	.	A	T	4	7	11	0	1	12	0	0
20	7966049	.	T	G	6	7	13	0	2	15	0	0
20	7966090	.	T	G	6	6	12	0	1	13	0	0
20	7966127	.	G	A	4	4	8	0	0	8	0	0
20	7966135	.	A	C	5	5	10	0	0	11	1	0
20	7966227	.	A	G	3	11	14	0	0	14	0	0
20	7966555	.	C	G	4	4	8	0	0	8	0	0
20	7966808	.	A	C	2	2	4	0	1	5	0	0
20	7966938	.	G	A	0	3	3	0	0	3	0	0
20	7967030	.	T	C	1	0	1	0	4	5	0	0
20	7967128	.	C	T	0	4	4	0	8	12	0	0
20	7967251	.	C	T	4	3	7	0	0	7	0	0
20	7967305	.	A	G	2	2	4	0	0	4	0	0
20	8122772	.	A	T	1	2	3	0	0	3	0	0
20	8154139	.	G	A	4	2	6	0	0	6	0	0
20	8154169	.	A	G	6	5	11	0	0	11	0	0
20	8163955	.	C	T	0	1	1	0	0	1	0	0
20	9096451	.	T	A	2	2	4	0	0	4	0	0
20	9096596	.	C	A	1	2	3	0	0	3	0	0
20	9097322	.	A	G	2	2	4	0	0	4	0	0
20	9097597	.	T	A	9	12	21	0	0	21	0	0
20	9097639	.	A	G	5	6	11	0	0	11	0	0
20	9097666	.	T	C	2	3	5	0	0	5	0	0
20	9105204	.	C	G	4	6	10	0	0	10	0	0
20	9115236	.	G	T	3	1	4	0	0	4	0	0
20	9115241	.	G	A	4	2	6	0	0	6	0	0
20	9124503	.	A	T	5	6	11	0	0	11	0	0
20	9124759	.	C	T	3	3	6	0	0	6	0	0
20	9124996	.	A	G	2	0	2	0	4	6	0	0
20	9133095	.	G	C	2	1	3	0	0	3	0	0
20	9148079	.	A	G	10	3	13	0	0	13	0	0
20	9148121	.	G	C	6	9	15	0	1	16	0	0
20	9172447	.	G	C	4	3	7	0	0	7	0	0
20	9174014	.	T	C	19	12	31	0	1	32	0	0
20	9183159	.	T	G	5	1	6	0	0	6	0	0
20	9184708	.	C	T	7	6	13	0	0	13	0	0
20	9185389	.	G	T	1	0	1	0	0	1	0	0
20	9185479	.	G	T	10	3	13	0	0	13	0	0
20	9185515	.	T	C	1	1	2	0	0	2	0	0
20	9186200	.	A	G	4	2	6	0	0	6	0	0
20	9186281	.	T	C	8	0	8	0	9	17	0	0
20	9190238	.	A	T	7	6	13	0	0	13	0	0
20	9190468	.	T	G	3	6	9	0	0	9	0	0
20	9190510	.	C	T	0	1	1	0	0	1	0	0
20	9190637	.	G	T	0	1	1	0	0	1	0	0
20	9190767	.	T	C	4	5	9	0	1	10	0	0
20	9190768	.	T	C	5	5	10	0	0	10	0	0
20	9190991	.	A	G	1	7	8	0	0	8	0	0
20	9191203	.	G	T	3	8	11	0	0	11	0	0
20	9191255	.	T	C	2	1	3	0	4	7	0	0
20	9191267	.	T	A	2	2	4	0	0	4	0	0
20	9191353	.	T	G	4	6	10	0	0	10	0	0
20	9191461	.	C	T	8	10	18	0	0	19	1	0
20	9191729	.	C	T	1	6	7	0	0	7	0	0
20	9192375	.	T	A	5	4	9	0	0	9	0	0
20	9193359	.	C	T	2	2	4	0	0	4	0	0
20	9199256	.	G	C	3	4	7	0	0	7	0	0
20	9241873	.	T	C	4	0	4	0	4	8	0	0
20	9241884	.	G	A	4	2	6	0	0	6	0	0
20	9242422	.	G	C	10	3	13	0	0	13	0	0
20	9242476	.	T	C	6	5	11	0	0	11	0	0
20	9248482	.	T	C	2	0	2	0	3	5	0	0
20	9248524	.	T	C	4	3	7	0	0	7	0	0
20	9248635	.	C	T	0	2	2	0	2	4	0	0
20	9249934	.	C	T	0	1	1	0	2	3	0	0
20	9355967	.	C	T	10	5	15	0	2	17	0	0
20	9420974	.	A	T	16	12	28	1	1	30	0	0
20	9420976	.	C	T	17	12	29	1	0	30	0	0
20	10099521	.	T	G	5	6	11	0	1	12	0	0
20	10099602	.	C	A	3	4	7	0	0	7	0	0
20	10099603	.	C	A	2	4	6	0	1	7	0	0
20	10099640	.	G	A	6	9	15	0	0	15	0	0
20	10099816	.	C	T	11	15	26	0	0	26	0	0
20	10099932	.	C	A	11	9	20	0	0	20	0	0
20	10102593	.	G	A	6	8	14	0	0	14	0	0
20	10118393	.	A	T	1	4	5	0	0	5	0	0
20	10118691	.	T	C	1	3	4	0	1	5	0	0
20	10204518	.	T	C	1	0	1	0	0	1	0	0
20	10210313	.	C	T	5	2	7	0	0	7	0	0
20	10210328	.	A	G	2	0	2	0	5	7	0	0
20	10210358	.	C	T	3	1	4	0	2	6	0	0
20	10215552	.	G	A	0	2	2	0	2	4	0	0
20	10218637	.	T	A	4	3	7	0	2	9	0	0
20	10218937	.	C	A	0	5	5	0	3	8	0	0
20	10219336	.	T	G	3	4	7	0	0	7	0	0
20	10219377	.	T	A	2	2	4	0	0	4	0	0
20	10219396	.	A	T	2	3	5	0	0	5	0	0
20	10219431	.	A	G	2	0	2	0	2	4	0	0
20	10219447	.	G	A	2	3	5	0	0	5	0	0
20	10219467	.	C	A	1	3	4	0	0	4	0	0
20	10219504	.	G	A	0	6	6	0	5	11	0	0
20	10219537	.	C	T	4	5	9	0	1	10	0	0
20	10219558	.	T	C	0	5	5	0	1	6	0	0
20	10220138	.	T	C	6	4	10	0	0	10	0	0
20	10220188	.	A	C	6	3	9	0	0	9	0	0
20	10220261	.	G	T	4	3	7	0	0	7	0	0
20	10353220	.	G	A	2	3	5	0	0	5	0	0
20	10353222	.	G	A	2	3	5	0	0	5	0	0
20	10353318	.	G	A	3	4	7	0	1	8	0	0
20	10353528	.	G	A	6	9	15	0	0	15	0	0
20	10353654	.	T	C	4	0	4	0	5	9	0	0
20	10353727	.	C	T	0	3	3	0	2	5	0	0
20	10353762	.	T	C	2	5	7	0	0	7	0	0
20	10353797	.	A	G	3	6	9	0	0	9	0	0
20	10353798	.	A	T	3	4	7	0	2	9	0	0
20	10353912	.	G	C	2	8	10	0	0	10	0	0
20	10354329	.	A	G	3	3	6	0	0	6	0	0
20	10422619	.	A	C	2	5	7	0	0	7	0	0
20	10489564	.	A	G	2	3	5	0	1	6	0	0
20	11098255	.	G	A	4	4	8	0	3	11	0	0
20	11098301	.	T	C	5	3	8	0	2	10	0	0
20	11098547	.	T	A	3	6	9	0	0	9	0	0
20	11098710	.	C	A	5	6	11	0	1	12	0	0
20	11098851	.	G	A	11	3	14	0	0	14	0	0
20	11098859	.	G	A	11	4	15	0	0	15	0	0
20	11098960	.	G	A	6	3	9	0	0	9	0	0
20	11099013	.	G	A	3	4	7	0	2	9	0	0
20	11099064	.	C	T	3	7	10	0	0	10	0	0
20	11099223	.	C	T	0	8	8	0	6	14	0	0
20	11099304	.	A	G	3	7	10	0	5	15	0	0
20	11102169	.	G	A	2	3	5	0	0	5	0	0
20	11102328	.	C	T	0	4	4	0	3	7	0	0
20	11102805	.	G	A	4	5	9	0	0	9	0	0
20	11103244	.	T	A	1	3	4	0	3	7	0	0
20	11103392	.	G	T	4	2	6	0	0	6	0	0
20	11104994	.	G	A	1	3	4	0	0	4	0	0
20	13567497	.	T	C	11	5	16	0	0	16	0	0
20	13567503	.	T	C	7	0	7	0	7	14	0	0
20	13567560	.	T	C	5	4	9	0	1	10	0	0
20	13567574	.	T	C	5	3	8	0	0	8	0	0
20	15935978	.	T	C	4	4	8	0	0	8	0	0
20	18249646	.	T	C	13	6	19	0	1	20	0	0
20	18255748	.	A	G	12	8	20	0	1	21	0	0
20	18255755	.	A	G	16	8	24	0	0	24	0	0
20	18255929	.	A	G	11	0	11	0	22	33	0	0
20	18255931	.	A	T	12	20	32	0	1	33	0	0
20	18256170	.	G	A	5	4	9	0	0	9	0	0
20	18312860	.	C	T	7	11	18	0	3	21	0	0
20	18354627	.	C	T	6	7	13	0	0	13	0	0
20	18363238	.	T	C	5	0	5	0	5	10	0	0
20	18369979	.	G	A	0	0	0	0	1	1	0	0
20	18373014	.	T	G	0	2	2	0	0	2	0	0
20	18392845	.	C	T	19	20	39	0	2	41	0	0
20	18393128	.	G	A	9	8	17	0	3	20	0	0
20	18393132	.	A	C	11	10	21	0	0	21	0	0
20	18393249	.	T	C	20	14	34	0	1	35	0	0
20	18393359	.	A	T	12	12	24	0	0	25	1	0
20	18393376	.	C	T	17	11	28	0	0	28	0	0
20	18396134	.	A	G	4	3	7	0	0	7	0	0
20	18413987	.	T	C	5	0	5	0	8	13	0	0
20	18417768	.	G	A	9	8	17	0	0	17	0	0
20	18417777	.	T	C	10	7	17	0	0	17	0	0
20	18431770	.	T	C	1	0	1	0	1	2	0	0
20	18432732	.	C	T	5	1	6	0	2	8	0	0
20	18443489	.	T	C	1	3	4	0	0	4	0	0
20	18535350	.	G	A	0	1	1	0	0	1	0	0
20	18551728	.	T	A	11	7	18	0	2	20	0	0
20	18591704	.	G	A	20	20	40	0	1	41	0	0
20	18591716	.	A	C	15	16	31	0	1	32	0	0
20	18591743	.	A	T	9	10	19	0	0	19	0	0
20	18594958	.	C	A	28	25	53	0	1	54	0	0
20	18672033	.	G	A	0	8	8	0	0	8	0	0
20	18672094	.	T	C	1	10	11	0	2	13	0	0
20	18672162	.	G	A	3	4	7	0	2	9	0	0
20	18672610	.	C	G	3	3	6	0	0	6	0	0
20	18672733	.	A	T	3	11	14	0	1	15	0	0
20	18672970	.	G	A	5	14	19	0	0	19	0	0
20	18673132	.	C	T	3	19	22	0	2	24	0	0
20	18677343	.	G	A	0	3	3	0	0	3	0	0
20	18683158	.	T	C	3	7	10	0	1	11	0	0
20	18683177	.	A	G	1	0	1	0	4	5	0	0
20	18684760	.	G	A	6	22	28	0	0	29	1	0
20	18684769	.	G	A	6	22	28	0	2	30	0	0
20	18685235	.	C	G	7	14	21	0	1	22	0	0
20	18685256	.	G	A	7	10	17	0	1	18	0	0
20	18685279	.	G	C	0	8	8	0	9	17	0	0
20	18685323	.	G	C	3	2	5	0	0	5	0	0
20	18708770	.	T	C	21	15	36	0	0	36	0	0
20	18713016	.	C	T	22	28	50	0	4	54	0	0
20	18713067	.	T	C	13	16	29	0	2	31	0	0
20	18714052	.	A	G	3	2	5	0	0	5	0	0
20	18714282	.	A	G	2	0	2	0	3	5	0	0
20	18721340	.	G	T	1	4	5	0	0	5	0	0
20	18721788	.	C	T	14	10	24	0	2	26	0	0
20	18721910	.	G	A	9	12	21	0	2	23	0	0
20	18722565	.	A	T	18	14	32	0	2	34	0	0
20	18722652	.	T	A	8	7	15	0	0	15	0	0
20	18722860	.	A	T	14	4	18	0	0	18	0	0
20	18723105	.	C	T	10	15	25	0	2	27	0	0
20	18723277	.	T	C	14	13	27	0	1	28	0	0
20	18723327	.	T	C	8	2	10	0	8	18	0	0
20	18723347	.	T	C	0	13	13	0	0	13	0	0
20	18723362	.	T	C	9	7	16	0	0	16	0	0
20	18723383	.	A	T	9	6	15	0	0	15	0	0
20	18723401	.	T	C	3	0	3	0	13	16	0	0
20	18723421	.	T	C	13	4	17	0	0	17	0	0
20	18723459	.	T	C	3	10	13	0	0	13	0	0
20	18727506	.	T	C	5	7	12	0	0	12	0	0
20	18730498	.	G	A	9	8	17	0	0	17	0	0
20	18730840	.	T	C	10	6	16	0	1	17	0	0
20	18731068	.	C	T	8	10	18	0	0	18	0	0
20	18747062	.	C	A	1	3	4	0	0	4	0	0
20	18747210	.	G	A	1	3	4	0	0	4	0	0
20	18755283	.	C	T	4	4	8	0	0	8	0	0
20	18755824	.	A	C	2	2	4	0	0	4	0	0
20	18756032	.	A	G	3	0	3	0	1	4	0	0
20	18756047	.	A	T	5	1	6	0	0	6	0	0
20	18756069	.	A	G	6	1	7	0	0	7	0	0
20	18756613	.	A	G	1	2	3	0	0	3	0	0
20	18774169	.	A	T	2	2	4	0	0	4	0	0
20	18774616	.	A	G	4	2	6	0	2	8	0	0
20	18774618	.	T	C	4	2	6	0	2	8	0	0
20	18802438	.	A	G	5	6	11	0	0	11	0	0
20	18915249	.	C	T	5	5	10	0	0	10	0	0
20	18958090	.	G	A	0	5	5	0	3	8	0	0
20	18958106	.	C	G	7	4	11	0	2	13	0	0
20	18958420	.	T	C	7	6	13	0	0	13	0	0
20	18958433	.	G	A	0	6	6	0	8	14	0	0
20	18958477	.	G	A	0	6	6	0	4	10	0	0
20	18961838	.	C	T	5	5	10	0	0	10	0	0
20	18968826	.	C	T	8	11	19	0	0	19	0	0
20	18983543	.	T	G	9	18	27	0	1	28	0	0
20	18983567	.	T	C	16	16	32	0	1	33	0	0
20	18983625	.	G	A	19	16	35	0	4	39	0	0
20	18983755	.	T	C	8	9	17	0	0	17	0	0
20	18983767	.	T	C	8	9	17	0	0	17	0	0
20	18994634	.	C	T	1	0	1	0	0	1	0	0
20	18996133	.	T	A	11	5	16	0	0	16	0	0
20	18997610	.	A	G	13	19	32	0	2	34	0	0
20	18997853	.	G	C	12	19	31	1	1	33	0	0
20	19007198	.	G	T	1	3	4	0	0	4	0	0
20	19007210	.	C	A	0	2	2	0	0	2	0	0
20	19018520	.	G	A	3	2	5	0	0	5	0	0
20	19058143	.	G	A	7	9	16	0	0	16	0	0
20	19058152	.	T	G	7	9	16	0	0	16	0	0
20	19058188	.	A	G	8	7	15	0	0	15	0	0
20	19058194	.	T	C	8	6	14	0	1	15	0	0
20	19058241	.	A	C	11	7	18	0	2	20	0	0
20	19058475	.	T	G	7	3	10	0	1	11	0	0
20	19058500	.	A	G	6	1	7	0	1	8	0	0
20	19059193	.	A	T	3	2	5	0	0	5	0	0
20	19078159	.	T	G	2	2	4	0	0	4	0	0
20	19213586	.	T	A	7	11	18	0	2	20	0	0
20	19213587	.	G	C	7	13	20	0	0	20	0	0
20	19277498	.	G	A	4	2	6	0	0	6	0	0
20	19277551	.	C	T	0	2	2	0	2	4	0	0
20	19277663	.	C	T	3	5	8	1	0	9	0	0
20	19277893	.	C	T	1	2	3	0	0	3	0	0
20	19278025	.	C	T	2	2	4	0	0	4	0	0
20	19290547	.	C	T	2	2	4	0	0	4	0	0
20	19290586	.	G	A	3	2	5	0	0	5	0	0
20	19290958	.	T	C	1	0	1	0	0	1	0	0
20	19373510	.	A	T	7	7	14	0	0	14	0	0
20	19373511	.	G	T	7	7	14	0	0	14	0	0
20	19373597	.	G	A	11	9	20	0	2	22	0	0
20	19373852	.	A	G	10	11	21	0	1	22	0	0
20	19373919	.	A	G	13	6	19	0	3	22	0	0
20	19373939	.	G	A	14	10	24	0	1	25	0	0
20	19374043	.	A	C	3	0	3	0	7	10	0	0
20	19374415	.	C	T	0	9	9	0	7	16	0	0
20	19374524	.	G	A	5	2	7	0	0	7	0	0
20	19374728	.	G	A	5	9	14	0	0	14	0	0
20	19391677	.	T	A	8	3	11	0	0	11	0	0
20	19406515	.	A	G	3	2	5	0	0	5	0	0
20	19406643	.	C	T	0	3	3	0	8	11	0	0
20	19406689	.	G	A	1	1	2	0	1	3	0	0
20	19415161	.	A	G	0	2	2	0	0	2	0	0
20	19415260	.	G	A	3	7	10	0	0	10	0	0
20	19415309	.	T	C	3	0	3	0	11	14	0	0
20	19423997	.	C	T	6	1	7	0	0	7	0	0
20	19430640	.	T	C	2	4	6	0	1	7	0	0
20	19430641	.	G	A	2	4	6	0	1	7	0	0
20	19430736	.	A	G	6	2	8	0	10	18	0	0
20	19431012	.	T	C	8	5	13	0	0	13	0	0
20	19431385	.	A	G	7	3	10	0	0	10	0	0
20	19431477	.	T	A	4	4	8	0	1	9	0	0
20	19431665	.	G	A	6	5	11	0	3	14	0	0
20	19431960	.	C	G	8	5	13	0	0	13	0	0
20	19432213	.	A	G	3	7	10	0	0	10	0	0
20	19436440	.	G	A	6	5	11	0	1	12	0	0
20	19436577	.	C	G	8	7	15	0	0	15	0	0
20	19437848	.	T	C	5	1	6	0	6	12	0	0
20	19437969	.	A	G	3	2	5	0	0	5	0	0
20	19438110	.	C	A	6	7	13	0	0	13	0	0
20	19438181	.	C	T	0	5	5	0	4	9	0	0
20	19438425	.	G	A	3	12	15	0	0	15	0	0
20	19438458	.	T	A	6	0	6	0	0	6	0	0
20	19442994	.	G	A	5	2	7	0	0	7	0	0
20	19443045	.	G	T	1	2	3	0	0	3	0	0
20	19443060	.	C	T	0	1	1	0	2	3	0	0
20	19447392	.	C	T	4	2	6	0	0	6	0	0
20	19447443	.	G	A	5	3	8	0	0	8	0	0
20	19510904	.	A	G	1	3	4	0	0	4	0	0
20	19510950	.	C	A	3	2	5	0	0	5	0	0
20	19510968	.	C	T	2	2	4	0	0	4	0	0
20	19511182	.	A	T	2	2	4	0	0	4	0	0
20	19511225	.	T	A	4	2	6	0	0	6	0	0
20	19511264	.	C	G	4	2	6	0	0	6	0	0
20	19513054	.	G	A	7	3	10	0	0	10	0	0
20	19513093	.	G	A	8	6	14	0	1	15	0	0
20	19513258	.	C	T	1	0	1	0	0	1	0	0
20	19513289	.	A	T	1	0	1	0	0	1	0	0
20	19516009	.	A	G	8	5	13	0	4	17	0	0
20	19516035	.	A	G	7	0	7	0	7	14	0	0
20	19516096	.	T	A	6	6	12	0	3	16	1	0
20	19516206	.	T	A	7	8	15	0	2	17	0	0
20	19516746	.	A	G	8	5	13	0	0	13	0	0
20	19516772	.	T	C	0	12	12	0	1	13	0	0
20	19516803	.	T	C	5	9	14	0	0	14	0	0
20	19516850	.	T	C	9	10	19	0	0	19	0	0
20	19519403	.	C	G	9	11	20	0	0	20	0	0
20	19519454	.	T	G	8	3	11	0	0	11	0	0
20	19521387	.	G	A	0	1	1	0	0	1	0	0
20	19530702	.	G	A	4	2	6	0	0	6	0	0
20	19562437	.	C	T	2	3	5	0	0	5	0	0
20	19562524	.	T	C	3	2	5	0	0	5	0	0
20	19562565	.	G	T	4	3	7	0	0	7	0	0
20	19562664	.	C	A	3	7	10	0	0	10	0	0
20	19562736	.	G	T	9	5	14	0	0	14	0	0
20	19562743	.	G	T	5	9	14	0	0	14	0	0
20	19573889	.	C	A	1	1	2	0	0	2	0	0
20	19579940	.	G	A	3	2	5	0	1	6	0	0
20	19580091	.	A	T	5	9	14	0	0	14	0	0
20	19580205	.	G	T	10	8	18	0	1	19	0	0
20	19580234	.	C	T	11	7	18	0	2	20	0	0
20	19580397	.	A	G	4	6	10	0	0	10	0	0
20	19580405	.	G	A	4	6	10	0	0	10	0	0
20	19580441	.	A	G	6	7	13	0	0	13	0	0
20	19580654	.	C	T	13	7	20	0	1	21	0	0
20	19582896	.	G	A	6	7	13	0	1	14	0	0
20	19582955	.	C	T	6	7	13	0	2	15	0	0
20	19583028	.	C	G	2	2	4	0	0	4	0	0
20	19588759	.	G	A	9	7	16	0	1	17	0	0
20	19590288	.	G	A	9	4	13	0	0	13	0	0
20	19822051	.	C	T	2	2	4	0	0	4	0	0
20	19822153	.	G	A	0	3	3	0	2	5	0	0
20	19822347	.	A	G	3	0	3	0	2	5	0	0
20	19822442	.	A	G	3	0	3	0	3	6	0	0
20	19822603	.	G	C	3	2	5	0	0	5	0	0
20	19822612	.	C	T	3	2	5	0	0	5	0	0
20	19823472	.	C	T	3	2	5	0	0	5	0	0
20	19823761	.	A	T	4	2	6	0	0	6	0	0
20	19823802	.	T	G	4	2	6	0	0	6	0	0
20	19823939	.	T	C	2	3	5	0	0	5	0	0
20	20231857	.	C	T	13	3	16	0	2	18	0	0
20	20231919	.	A	G	10	12	22	0	0	22	0	0
20	20232456	.	G	T	16	9	25	0	1	26	0	0
20	20244405	.	G	A	0	1	1	0	0	1	0	0
20	20269729	.	C	T	1	0	1	0	0	1	0	0
20	20269835	.	T	A	2	5	7	0	0	7	0	0
20	20269836	.	T	C	2	5	7	0	0	7	0	0
20	20270109	.	G	T	2	2	4	0	0	4	0	0
20	20275088	.	G	A	11	3	14	0	0	14	0	0
20	20275193	.	A	T	12	9	21	0	0	21	0	0
20	20275196	.	C	A	11	10	21	0	0	21	0	0
20	20275244	.	G	T	10	8	18	0	0	18	0	0
20	20275609	.	T	A	15	16	31	0	2	33	0	0
20	20275674	.	A	G	11	14	25	0	2	27	0	0
20	20276130	.	G	A	9	2	11	0	0	11	0	0
20	20276369	.	C	G	8	5	13	0	0	13	0	0
20	20276607	.	T	G	6	9	15	0	1	16	0	0
20	20276730	.	G	C	5	6	11	0	0	11	0	0
20	20277162	.	T	C	6	3	9	2	1	12	0	0
20	20277183	.	T	C	6	3	9	2	0	11	0	0
20	20277337	.	A	T	9	8	17	0	1	18	0	0
20	20277370	.	T	C	7	10	17	0	1	18	0	0
20	20277460	.	G	C	6	12	18	0	1	19	0	0
20	20277481	.	A	T	4	10	14	0	0	14	0	0
20	20277525	.	T	C	6	0	6	0	9	15	0	0
20	20277530	.	A	T	5	9	14	0	0	14	0	0
20	20277776	.	A	T	1	2	3	0	0	3	0	0
20	20277779	.	A	C	1	1	2	0	0	2	0	0
20	20278161	.	G	C	4	0	4	0	6	10	0	0
20	20278213	.	G	A	5	9	14	0	0	14	0	0
20	20278360	.	A	G	2	7	9	0	0	9	0	0
20	20278442	.	G	C	5	3	8	0	1	9	0	0
20	20278461	.	G	C	6	0	6	0	5	11	0	0
20	20278692	.	A	C	7	6	13	0	0	13	0	0
20	20278703	.	C	T	4	6	10	0	1	11	0	0
20	20278827	.	T	C	7	4	11	0	0	11	0	0
20	20278907	.	C	A	3	5	8	0	2	10	0	0
20	20279031	.	T	C	1	0	1	0	7	8	0	0
20	20279036	.	G	A	1	5	6	0	1	7	0	0
20	20279069	.	G	A	3	3	6	0	0	6	0	0
20	20279100	.	T	G	4	3	7	0	0	7	0	0
20	20279127	.	A	T	3	2	5	0	1	6	0	0
20	20279142	.	A	G	3	3	6	0	0	6	0	0
20	20312408	.	A	T	1	2	3	0	0	3	0	0
20	20328047	.	T	G	15	3	18	0	33	51	0	0
20	20601985	.	T	C	14	8	22	1	0	23	0	0
20	20602167	.	T	C	3	4	7	0	0	7	0	0
20	20602187	.	T	C	5	2	7	0	0	7	0	0
20	20605071	.	T	C	0	5	5	0	0	5	0	0
20	20729975	.	C	T	10	11	21	0	1	22	0	0
20	20730008	.	C	G	26	22	48	0	0	48	0	0
20	20730141	.	A	T	20	12	32	0	0	32	0	0
20	20730151	.	G	A	17	12	29	0	3	32	0	0
20	20730182	.	T	A	7	8	15	0	1	16	0	0
20	20761545	.	C	T	0	1	1	0	0	1	0	0
20	20793358	.	G	A	4	4	8	0	0	8	0	0
20	20807987	.	C	T	7	4	11	0	1	12	0	0
20	20808038	.	G	T	5	3	8	0	1	9	0	0
20	20808044	.	C	A	4	4	8	0	0	8	0	0
20	20809702	.	T	C	9	11	20	0	0	20	0	0
20	20812680	.	C	T	16	21	37	0	3	40	0	0
20	20812852	.	C	A	12	12	24	0	0	24	0	0
20	20812876	.	C	T	16	6	22	0	0	22	0	0
20	20813014	.	G	A	14	7	21	0	0	21	0	0
20	20813033	.	A	G	13	0	13	0	10	23	0	0
20	20813116	.	A	T	12	20	32	0	0	32	0	0
20	20813270	.	C	T	8	18	26	0	3	29	0	0
20	20813336	.	T	C	4	32	36	0	0	36	0	0
20	20813570	.	G	A	21	10	31	0	0	31	0	0
20	20813624	.	G	A	9	5	14	0	0	14	0	0
20	20813685	.	A	T	14	6	20	0	0	20	0	0
20	20813731	.	T	C	3	4	7	0	0	7	0	0
20	20813735	.	A	T	4	3	7	0	0	7	0	0
20	20816875	.	G	A	46	35	81	0	1	83	1	0
20	20817011	.	G	A	34	35	69	0	9	78	0	0
20	20817263	.	A	G	17	16	33	0	1	34	0	0
20	20818523	.	A	G	37	29	66	0	1	67	0	0
20	20897037	.	T	G	1	2	3	0	0	3	0	0
20	20897090	.	G	A	1	2	3	0	1	4	0	0
20	20898262	.	G	A	2	2	4	0	0	4	0	0
20	20899424	.	A	T	1	2	3	0	0	3	0	0
20	20902714	.	C	G	0	2	2	0	0	2	0	0
20	20927973	.	A	C	6	0	6	0	8	14	0	0
20	20928272	.	C	T	13	19	32	0	1	33	0	0
20	20928536	.	G	A	20	18	38	0	2	40	0	0
20	20928932	.	A	G	13	8	21	0	2	23	0	0
20	20929166	.	G	A	20	15	35	0	1	36	0	0
20	20930149	.	G	A	7	11	18	0	0	18	0	0
20	20930889	.	G	A	2	3	5	0	0	5	0	0
20	20942176	.	G	A	0	2	2	0	1	3	0	0
20	20980716	.	C	T	4	3	7	0	1	8	0	0
20	21008381	.	G	A	1	2	3	0	0	3	0	0
20	21015747	.	A	C	4	7	11	0	0	11	0	0
20	21015748	.	G	A	0	4	4	0	7	11	0	0
20	21016348	.	C	T	2	5	7	0	0	7	0	0
20	21016521	.	T	A	6	3	9	0	1	10	0	0
20	21016545	.	C	A	2	3	5	0	0	5	0	0
20	21392106	.	A	T	0	2	2	0	1	3	0	0
20	21440027	.	C	A	0	3	3	0	0	3	0	0
20	21458540	.	G	T	0	2	2	0	0	2	0	0
20	21465982	.	C	T	2	3	5	0	0	5	0	0
20	21467733	.	G	T	3	4	7	0	0	7	0	0
20	21473644	.	A	G	9	9	18	0	1	19	0	0
20	21473674	.	C	T	12	7	19	0	1	20	0	0
20	21474159	.	T	C	13	10	23	0	0	23	0	0
20	21474185	.	C	T	14	10	24	0	0	24	0	0
20	21474271	.	A	G	2	7	9	0	1	10	0	0
20	21474664	.	A	G	9	0	9	0	10	19	0	0
20	21475432	.	A	T	2	5	7	0	0	7	0	0
20	21638903	.	T	C	1	2	3	0	0	3	0	0
20	21815659	.	G	T	16	16	32	0	2	34	0	0
20	21815986	.	C	T	0	18	18	0	14	32	0	0
20	21816061	.	C	G	13	14	27	0	0	27	0	0
20	21819062	.	T	C	17	19	36	0	0	36	0	0
20	21828117	.	T	C	1	0	1	0	0	1	0	0
20	21839504	.	G	A	6	1	7	0	0	7	0	0
20	21841312	.	G	A	0	2	2	0	0	2	0	0
20	21841316	.	G	T	0	2	2	0	0	2	0	0
20	21855195	.	T	C	3	5	8	0	0	8	0	0
20	21862963	.	C	T	2	11	13	0	6	19	0	0
20	21862975	.	C	T	1	11	12	0	10	22	0	0
20	21872945	.	A	G	1	2	3	0	0	3	0	0
20	21872990	.	G	A	1	2	3	0	0	3	0	0
20	21875111	.	G	A	2	1	3	0	0	3	0	0
20	21875162	.	G	A	6	3	9	0	0	9	0	0
20	21875165	.	T	G	5	3	8	0	1	9	0	0
20	21910005	.	C	T	0	8	8	0	5	13	0	0
20	22709610	.	C	A	15	14	29	0	1	30	0	0
20	22720443	.	A	G	5	4	9	0	0	9	0	0
20	22722200	.	C	A	17	14	31	0	1	32	0	0
20	22722255	.	G	C	8	14	22	0	2	24	0	0
20	22734031	.	G	A	0	19	19	0	17	36	0	0
20	22734052	.	G	A	0	24	24	0	23	47	0	0
20	22734145	.	C	A	4	3	7	0	0	7	0	0
20	22736625	.	T	C	8	5	13	0	0	13	0	0
20	22736673	.	C	T	27	13	40	0	2	42	0	0
20	22738204	.	C	A	9	8	17	0	0	17	0	0
20	22739985	.	T	C	22	22	44	0	4	48	0	0
20	22740533	.	A	T	20	8	28	0	2	30	0	0
20	23007547	.	G	A	4	6	10	0	1	11	0	0
20	23026151	.	C	G	7	3	10	0	0	10	0	0
20	23026160	.	A	T	6	3	9	0	0	9	0	0
20	23160902	.	T	A	2	2	4	0	0	4	0	0
20	23175479	.	C	A	14	4	18	0	0	18	0	0
20	23175495	.	C	A	12	5	17	0	0	17	0	0
20	23177734	.	G	A	3	3	6	0	0	6	0	0
20	23179753	.	A	G	2	0	2	0	7	9	0	0
20	23179786	.	C	T	13	7	20	0	0	20	0	0
20	23204754	.	C	A	12	13	25	0	0	25	0	0
20	23205004	.	G	T	11	17	28	0	0	28	0	0
20	23205102	.	T	C	12	17	29	0	3	32	0	0
20	23215901	.	C	T	2	3	5	0	0	5	0	0
20	23215949	.	C	T	2	3	5	0	0	5	0	0
20	23245852	.	C	T	5	6	11	0	1	12	0	0
20	23245866	.	T	A	6	6	12	0	0	12	0	0
20	23248572	.	G	A	9	13	22	0	0	22	0	0
20	23248635	.	T	C	14	8	22	0	0	22	0	0
20	23250491	.	A	C	7	0	7	0	6	13	0	0
20	23250530	.	C	A	5	3	8	0	0	8	0	0
20	23253455	.	G	A	2	4	6	0	0	6	0	0
20	23376342	.	C	T	2	4	6	0	0	6	0	0
20	23376396	.	T	A	0	1	1	0	0	1	0	0
20	23378401	.	G	A	1	2	3	0	0	3	0	0
20	23385790	.	G	A	3	2	5	0	0	5	0	0
20	23386096	.	G	A	5	3	8	0	0	8	0	0
20	23386198	.	A	T	3	4	7	0	2	9	0	0
20	23387619	.	G	A	0	2	2	0	2	4	0	0
20	23387775	.	C	T	4	3	7	0	0	7	0	0
20	23387808	.	C	T	2	3	5	0	0	5	0	0
20	23387811	.	C	T	2	3	5	0	0	5	0	0
20	23390621	.	G	A	0	1	1	0	1	2	0	0
20	23395376	.	T	A	1	1	2	0	9	11	0	0
20	23402554	.	A	G	5	5	10	0	0	10	0	0
20	23421442	.	T	C	13	21	34	0	2	36	0	0
20	23446698	.	G	A	6	11	17	0	0	17	0	0
20	23446868	.	T	A	3	5	8	0	1	9	0	0
20	23447086	.	T	C	10	0	10	0	11	21	0	0
20	23447224	.	T	C	2	0	2	0	5	7	0	0
20	23447467	.	A	T	7	3	10	0	1	11	0	0
20	23447540	.	C	T	14	11	25	0	1	26	0	0
20	23447873	.	C	G	1	6	7	0	0	7	0	0
20	23453642	.	C	T	3	3	6	0	0	6	0	0
20	23453671	.	C	T	0	2	2	0	0	2	0	0
20	23453802	.	G	A	2	0	2	0	0	2	0	0
20	23467400	.	C	A	0	1	1	0	2	3	0	0
20	23475653	.	G	C	2	3	5	0	0	5	0	0
20	23477436	.	C	T	1	4	5	0	0	5	0	0
20	23478294	.	T	C	1	0	1	0	0	1	0	0
20	23480658	.	C	T	0	1	1	0	0	1	0	0
20	24819416	.	C	T	4	6	10	0	0	10	0	0
20	24819582	.	C	T	1	9	10	0	13	23	0	0
20	24819646	.	C	T	9	9	18	0	0	18	0	0
20	24819929	.	T	C	10	4	14	0	0	14	0	0
20	24820032	.	T	C	6	4	10	0	1	11	0	0
20	24820566	.	A	T	6	6	12	0	0	12	0	0
20	24820885	.	C	T	0	7	7	0	10	17	0	0
20	24821048	.	C	A	13	12	25	0	1	26	0	0
20	24821094	.	C	T	0	9	9	0	9	18	0	0
20	24841039	.	G	A	3	4	7	0	0	7	0	0
20	24915706	.	T	C	3	0	3	0	2	5	0	0
20	24962906	.	C	T	0	1	1	0	0	1	0	0
20	24962956	.	G	A	1	4	5	0	0	5	0	0
20	25342397	.	C	T	1	2	3	0	0	3	0	0
20	25355721	.	C	T	1	2	3	0	0	3	0	0
20	25368785	.	A	G	2	6	8	0	0	8	0	0
20	25368871	.	C	T	7	4	11	0	1	12	0	0
20	25372677	.	A	G	1	1	2	0	0	2	0	0
20	25374871	.	A	G	0	1	1	0	0	1	0	0
20	25374908	.	G	A	1	3	4	0	1	5	0	0
20	25374912	.	G	A	1	5	6	0	0	6	0	0
20	25374965	.	G	T	3	3	6	0	1	7	0	0
20	25378556	.	C	T	0	1	1	0	0	1	0	0
20	25378583	.	T	G	1	1	2	0	0	2	0	0
20	25378661	.	A	G	2	4	6	0	0	6	0	0
20	25379771	.	T	C	1	2	3	0	0	3	0	0
20	25385938	.	A	C	1	1	2	0	0	2	0	0
20	25387931	.	T	C	1	1	2	0	0	2	0	0
20	25387940	.	A	C	1	0	1	0	0	1	0	0
20	25440668	.	T	C	10	7	17	0	0	17	0	0
20	25440790	.	A	C	8	8	16	0	0	16	0	0
20	25445182	.	A	T	2	1	3	0	1	4	0	0
20	25445213	.	C	T	2	2	4	0	0	4	0	0
20	25472172	.	G	C	0	2	2	0	0	2	0	0
20	25494179	.	A	G	2	2	4	0	0	4	0	0
20	25494601	.	C	A	0	0	0	0	1	1	0	0
20	25496941	.	T	A	1	2	3	0	0	3	0	0
20	25500859	.	A	G	1	0	1	0	3	4	0	0
20	25500922	.	C	T	1	2	3	0	0	3	0	0
20	25508260	.	G	T	0	1	1	0	2	3	0	0
20	25509772	.	C	T	5	10	15	0	0	15	0	0
20	25509842	.	C	A	7	15	22	0	1	23	0	0
20	25509851	.	A	T	5	16	21	0	1	22	0	0
20	25509934	.	T	C	4	8	12	0	1	13	0	0
20	25510234	.	A	T	2	3	5	0	0	5	0	0
20	25510256	.	T	A	3	5	8	0	0	8	0	0
20	25510270	.	G	T	5	5	10	0	0	10	0	0
20	25510481	.	A	G	7	10	17	0	0	17	0	0
20	25510586	.	A	G	6	12	18	0	1	19	0	0
20	25510630	.	G	A	3	17	20	0	0	20	0	0
20	25510739	.	C	A	10	8	18	0	0	18	0	0
20	25510769	.	T	C	7	8	15	0	0	15	0	0
20	25510798	.	C	T	9	5	14	0	1	15	0	0
20	25510897	.	G	C	6	7	13	0	0	13	0	0
20	25511312	.	T	A	8	10	18	0	0	18	0	0
20	25511609	.	T	C	13	16	29	0	2	31	0	0
20	25511785	.	T	C	4	9	13	0	0	13	0	0
20	25511940	.	G	A	0	6	6	0	11	17	0	0
20	25511957	.	A	T	7	9	16	0	2	18	0	0
20	25511997	.	A	G	5	4	9	0	0	9	0	0
20	25548780	.	C	T	0	5	5	0	6	11	0	0
20	25550527	.	G	A	1	1	2	0	0	2	0	0
20	25618240	.	G	A	5	2	7	0	0	7	0	0
20	25618330	.	G	A	4	7	11	0	1	12	0	0
20	25618336	.	A	C	5	7	12	0	0	12	0	0
20	25618908	.	G	A	6	7	13	0	0	13	0	0
20	25619965	.	G	A	0	2	2	0	0	2	0	0
20	25621633	.	G	A	1	1	2	0	0	2	0	0
20	25623921	.	C	T	1	2	3	0	1	4	0	0
20	25626180	.	T	C	1	2	3	0	0	3	0	0
20	25629072	.	A	G	3	2	5	0	0	5	0	0
20	25629317	.	C	T	2	3	5	0	0	5	0	0
20	25630011	.	A	G	5	2	7	0	0	7	0	0
20	25630961	.	G	A	2	2	4	0	0	4	0	0
20	25630962	.	G	T	2	2	4	0	0	4	0	0
20	25637658	.	G	C	0	2	2	0	0	2	0	0
20	25639384	.	G	A	0	3	3	0	1	4	0	0
20	25660033	.	T	A	4	4	8	0	0	8	0	0
20	25660441	.	A	G	18	17	35	0	3	38	0	0
20	25661396	.	G	A	13	13	26	0	0	27	1	0
20	25661403	.	T	G	12	7	19	0	3	22	0	0
20	25663590	.	T	G	4	3	7	0	0	7	0	0
20	25665101	.	G	T	15	12	27	0	1	28	0	0
20	25665115	.	G	T	16	7	23	0	4	27	0	0
20	25665144	.	G	T	14	13	27	0	3	30	0	0
20	25665195	.	G	A	13	14	27	0	0	27	0	0
20	25665506	.	C	T	7	7	14	0	5	19	0	0
20	25665515	.	C	T	8	10	18	0	2	20	0	0
20	25665627	.	T	C	6	9	15	0	0	15	0	0
20	25665822	.	G	A	5	8	13	0	0	13	0	0
20	25665927	.	T	C	6	4	10	0	0	10	0	0
20	25666142	.	C	T	8	7	15	0	1	16	0	0
20	25666277	.	G	T	7	7	14	0	1	15	0	0
20	25666402	.	A	T	5	19	24	0	1	25	0	0
20	25666524	.	T	C	6	5	11	0	0	11	0	0
20	25666812	.	T	A	11	16	27	0	0	27	0	0
20	25666947	.	C	T	5	5	10	1	0	11	0	0
20	25669888	.	C	A	1	5	6	0	1	7	0	0
20	25709311	.	C	T	0	3	3	0	1	4	0	0
20	25716005	.	C	A	1	2	3	0	0	3	0	0
20	25718101	.	C	A	1	1	2	0	0	2	0	0
20	25726388	.	T	C	2	2	4	0	1	5	0	0
20	25734829	.	T	G	1	2	3	0	0	3	0	0
20	25735011	.	G	A	0	2	2	0	3	5	0	0
20	25853228	.	T	C	3	7	10	0	0	10	0	0
20	25853767	.	A	G	13	21	34	0	2	36	0	0
20	25855561	.	G	A	1	2	3	0	0	3	0	0
20	25859494	.	C	T	17	10	27	0	1	28	0	0
20	25875221	.	T	C	3	0	3	0	2	5	0	0
20	25877666	.	G	A	1	1	2	0	0	2	0	0
20	25906480	.	A	T	2	1	3	0	0	3	0	0
20	25907347	.	G	C	1	0	1	0	0	1	0	0
20	25909330	.	C	T	5	6	11	0	2	13	0	0
20	25909462	.	T	C	3	8	11	0	0	11	0	0
20	25909661	.	C	A	5	6	11	0	1	12	0	0
20	25909699	.	C	T	5	6	11	0	2	13	0	0
20	25909765	.	A	C	12	12	24	0	0	24	0	0
20	25910099	.	C	T	6	6	12	0	0	12	0	0
20	25910133	.	G	A	5	5	10	0	1	11	0	0
20	25910298	.	A	T	9	6	15	0	1	16	0	0
20	25910366	.	A	T	4	3	7	0	0	7	0	0
20	25910522	.	G	T	2	2	4	0	0	4	0	0
20	25910531	.	G	A	3	4	7	0	0	7	0	0
20	25910574	.	T	C	3	4	7	0	1	8	0	0
20	25919371	.	T	C	6	3	9	0	0	9	0	0
20	25923747	.	T	C	13	9	22	0	1	23	0	0
20	25923960	.	T	C	18	16	34	0	2	36	0	0
20	25926048	.	A	G	9	25	34	0	4	38	0	0
20	25926474	.	G	A	4	12	16	0	1	17	0	0
20	25926540	.	T	A	4	11	15	0	0	15	0	0
20	25926792	.	T	G	2	4	6	0	0	6	0	0
20	25926793	.	T	G	2	4	6	0	0	6	0	0
20	25927126	.	C	A	18	10	28	0	0	28	0	0
20	25927259	.	C	G	15	0	15	0	18	33	0	0
20	25928098	.	C	T	14	11	25	0	1	26	0	0
20	25929576	.	A	T	5	3	8	0	2	10	0	0
20	25929913	.	T	A	13	16	29	0	2	31	0	0
20	25930671	.	T	C	5	4	9	0	0	9	0	0
20	25952800	.	T	C	2	4	6	0	0	6	0	0
20	25953487	.	T	C	2	4	6	0	0	6	0	0
20	25953538	.	T	C	1	3	4	0	0	4	0	0
20	26002683	.	T	C	2	4	6	0	1	7	0	0
20	26002970	.	A	G	4	1	5	0	4	9	0	0
20	26004160	.	T	A	8	7	15	0	0	15	0	0
20	26004251	.	A	G	6	6	12	0	0	12	0	0
20	26023822	.	T	C	2	4	6	0	0	6	0	0
20	26024196	.	G	A	15	23	38	0	0	38	0	0
20	26024432	.	C	T	10	12	22	0	3	25	0	0
20	26024434	.	A	G	11	13	24	0	1	25	0	0
20	26024565	.	G	A	1	15	16	0	16	32	0	0
20	26027048	.	C	T	0	11	11	0	10	21	0	0
20	26027434	.	G	T	7	8	15	0	0	15	0	0
20	26027630	.	C	T	4	10	14	0	0	14	0	0
20	26030641	.	G	T	7	4	11	0	0	11	0	0
20	26035649	.	A	G	4	2	6	0	1	7	0	0
20	26047462	.	G	A	4	6	10	0	0	10	0	0
20	26048474	.	T	C	1	0	1	0	2	3	0	0
20	26048815	.	C	T	2	2	4	0	0	4	0	0
20	26050226	.	T	C	5	1	6	0	3	9	0	0
20	26290451	.	G	A	3	3	6	0	0	6	0	0
20	26290738	.	A	T	5	2	7	0	0	7	0	0
20	26290739	.	T	C	5	2	7	0	0	7	0	0
20	26290855	.	G	C	3	3	6	0	0	6	0	0
20	26291213	.	A	G	2	3	5	0	0	5	0	0
20	26291331	.	T	C	1	3	4	0	1	5	0	0
20	26300840	.	G	T	3	1	4	0	1	5	0	0
20	26301092	.	C	T	6	5	11	0	0	11	0	0
20	26320221	.	C	T	2	6	8	0	0	8	0	0
20	26320288	.	T	C	3	1	4	0	0	4	0	0
20	26323356	.	T	C	5	4	9	0	0	9	0	0
20	26323658	.	C	T	3	4	7	0	0	7	0	0
20	26323673	.	C	T	3	5	8	0	1	9	0	0
20	26324196	.	T	G	0	3	3	0	0	3	0	0
20	26324307	.	T	A	8	8	16	0	1	17	0	0
20	26325380	.	A	G	1	1	2	0	0	2	0	0
20	26325481	.	T	A	5	1	6	0	0	6	0	0
20	26325493	.	T	C	3	1	4	0	0	4	0	0
20	26325671	.	A	G	6	9	15	0	0	15	0	0
20	26326345	.	T	C	4	12	16	0	1	17	0	0
20	26327719	.	C	T	10	4	14	0	0	14	0	0
20	26328051	.	C	T	7	5	12	0	0	12	0	0
20	26331595	.	A	G	3	5	8	0	0	8	0	0
20	26331683	.	C	T	7	12	19	0	0	19	0	0
20	26334414	.	A	G	4	11	15	0	0	15	0	0
20	26336921	.	C	G	1	3	4	0	0	4	0	0
20	26337036	.	C	T	5	15	20	0	0	20	0	0
20	26337733	.	C	T	17	20	37	0	0	37	0	0
20	26337790	.	C	A	12	10	22	0	1	23	0	0
20	26344835	.	A	G	7	3	10	0	0	10	0	0
20	26345230	.	C	T	13	18	31	0	2	33	0	0
20	26348838	.	G	A	2	11	13	0	3	16	0	0
20	26351914	.	T	A	20	17	37	0	3	40	0	0
20	26353751	.	T	C	6	8	14	0	3	17	0	0
20	26353793	.	T	C	19	18	37	0	1	38	0	0
20	26358574	.	T	C	21	29	50	0	1	51	0	0
20	26358743	.	G	A	28	29	57	0	2	59	0	0
20	26358964	.	G	A	21	20	41	0	1	42	0	0
20	26359109	.	A	T	13	4	17	0	0	17	0	0
20	26360192	.	C	T	8	5	13	0	1	14	0	0
20	26360470	.	A	G	2	4	6	0	0	6	0	0
20	26360594	.	A	T	1	4	5	0	0	5	0	0
20	26360800	.	T	C	0	2	2	0	0	2	0	0
20	26361333	.	C	T	0	5	5	0	1	6	0	0
20	26361403	.	G	A	2	3	5	0	0	5	0	0
20	26387413	.	A	T	7	10	17	0	1	18	0	0
20	26387881	.	T	G	5	7	12	0	0	12	0	0
20	26394500	.	C	T	3	2	5	0	1	6	0	0
20	26404320	.	A	G	1	1	2	0	2	4	0	0
20	26404369	.	G	A	7	4	11	0	0	11	0	0
20	26404479	.	C	T	3	3	6	0	0	6	0	0
20	26404753	.	C	A	7	8	15	0	1	16	0	0
20	26405121	.	G	A	0	3	3	0	7	10	0	0
20	26405406	.	T	G	4	0	4	0	6	10	0	0
20	26405479	.	A	T	1	2	3	0	0	3	0	0
20	26405485	.	A	T	1	2	3	0	0	3	0	0
20	26405719	.	G	A	1	2	3	0	1	4	0	0
20	26405857	.	G	A	0	4	4	0	2	6	0	0
20	26406352	.	T	C	5	3	8	0	0	8	0	0
20	26406369	.	G	A	2	3	5	0	1	6	0	0
20	26406565	.	A	T	3	3	6	0	0	6	0	0
20	26407091	.	T	C	1	4	5	0	0	5	0	0
20	26409372	.	T	G	7	10	17	0	2	19	0	0
20	26409403	.	A	T	6	8	14	0	1	15	0	0
20	26409428	.	C	T	7	11	18	0	2	20	0	0
20	26409599	.	C	T	24	26	50	0	0	50	0	0
20	26409723	.	C	T	15	23	38	0	1	39	0	0
20	26409931	.	C	T	18	9	27	0	1	28	0	0
20	26409991	.	G	A	12	8	20	0	2	22	0	0
20	26412712	.	T	C	9	17	26	0	0	26	0	0
20	26412799	.	G	C	10	19	29	0	1	31	1	0
20	26413038	.	C	T	10	12	22	0	1	23	0	0
20	26413181	.	T	C	5	8	13	0	1	14	0	0
20	26413584	.	G	A	2	5	7	0	0	7	0	0
20	26413640	.	C	A	1	6	7	0	0	7	0	0
20	26415760	.	G	A	2	2	4	0	1	5	0	0
20	26416114	.	A	G	3	5	8	0	1	9	0	0
20	26416515	.	C	T	1	3	4	0	0	4	0	0
20	26684713	.	C	A	2	3	5	0	0	5	0	0
20	26684715	.	G	T	2	2	4	0	1	5	0	0
20	26704167	.	C	T	1	2	3	0	0	3	0	0
20	26775892	.	G	A	5	4	9	0	0	9	0	0
20	26807385	.	G	A	3	2	5	0	0	5	0	0
20	26886607	.	A	G	2	0	2	0	2	4	0	0
20	26907743	.	G	A	4	2	6	0	1	7	0	0
20	26907806	.	T	C	5	5	10	0	0	10	0	0
20	26907857	.	T	C	4	6	10	0	0	10	0	0
20	26913282	.	G	C	1	2	3	0	0	3	0	0
20	26943163	.	T	C	2	2	4	0	0	4	0	0
20	26944090	.	C	T	14	7	21	0	1	22	0	0
20	26944762	.	C	A	9	16	25	0	0	25	0	0
20	26945114	.	A	T	3	7	10	0	0	10	0	0
20	26945180	.	T	A	6	6	12	0	1	13	0	0
20	26945394	.	C	T	10	8	18	0	0	18	0	0
20	26945913	.	T	C	8	21	29	0	2	31	0	0
20	26948002	.	T	G	3	4	7	0	0	7	0	0
20	26948033	.	A	T	3	3	6	0	2	8	0	0
20	26948347	.	T	C	1	1	2	0	0	2	0	0
20	26958737	.	C	T	11	6	17	0	0	17	0	0
20	26959139	.	G	C	4	4	8	0	0	8	0	0
20	26959572	.	C	T	8	8	16	0	2	18	0	0
20	26960001	.	A	T	11	9	20	0	1	21	0	0
20	26960044	.	G	A	0	8	8	0	11	19	0	0
20	26960102	.	T	C	8	8	16	0	0	16	0	0
20	26960220	.	C	A	10	13	23	0	0	23	0	0
20	26960540	.	A	G	6	1	7	0	12	19	0	0
20	26960580	.	G	A	12	12	24	0	0	24	0	0
20	26960619	.	A	G	10	11	21	0	0	21	0	0
20	26960673	.	A	G	5	6	11	0	0	11	0	0
20	26960802	.	T	C	8	8	16	0	1	17	0	0
20	26960843	.	C	T	11	10	21	0	1	22	0	0
20	26961079	.	G	A	0	3	3	0	3	6	0	0
20	26961353	.	G	A	4	2	6	0	1	7	0	0
20	26961419	.	A	T	6	8	14	0	1	15	0	0
20	26961469	.	A	G	8	7	15	0	0	15	0	0
20	26961533	.	A	G	2	4	6	0	0	6	0	0
20	26961799	.	C	T	9	4	13	0	1	14	0	0
20	26961832	.	T	G	10	3	13	0	1	14	0	0
20	26961907	.	A	G	11	12	23	0	0	23	0	0
20	26962057	.	A	G	10	1	11	0	8	19	0	0
20	26962119	.	T	C	9	8	17	0	0	17	0	0
20	26962177	.	C	T	8	8	16	0	0	16	0	0
20	26962290	.	G	T	6	12	18	0	0	18	0	0
20	26962385	.	T	A	7	10	17	0	0	17	0	0
20	26962455	.	G	A	0	9	9	0	6	15	0	0
20	26973619	.	G	A	1	2	3	0	0	3	0	0
20	27002175	.	T	G	9	13	22	0	0	22	0	0
20	27002248	.	G	A	7	7	14	0	0	14	0	0
20	27002271	.	A	G	7	7	14	0	1	15	0	0
20	27002766	.	T	A	2	3	5	0	0	5	0	0
20	27002778	.	A	G	3	3	6	0	0	6	0	0
20	27003134	.	C	A	3	2	5	0	0	5	0	0
20	27020221	.	G	A	5	7	12	0	0	12	0	0
20	27020446	.	G	A	4	1	5	0	0	5	0	0
20	27693094	.	C	A	1	4	5	0	0	5	0	0
20	27708306	.	A	G	4	5	9	0	0	9	0	0
20	27716356	.	C	T	2	4	6	0	0	6	0	0
20	27716376	.	A	C	3	5	8	0	0	8	0	0
20	27716413	.	G	A	0	5	5	0	1	6	0	0
20	27718091	.	G	A	3	3	6	0	0	6	0	0
20	27718097	.	A	T	3	3	6	0	0	6	0	0
20	27718329	.	A	T	1	5	6	0	0	6	0	0
20	27718418	.	A	C	1	2	3	0	0	3	0	0
20	27719088	.	A	G	5	7	12	0	0	12	0	0
20	27719099	.	A	G	2	7	9	0	1	10	0	0
20	27719570	.	C	T	1	2	3	0	0	3	0	0
20	27719602	.	T	C	2	4	6	0	0	6	0	0
20	27719642	.	G	T	1	4	5	0	1	6	0	0
20	27719652	.	C	A	2	4	6	0	0	6	0	0
20	27719713	.	G	A	5	3	8	0	0	8	0	0
20	27719859	.	T	C	5	7	12	0	0	12	0	0
20	27719869	.	T	A	5	8	13	0	0	13	0	0
20	27732628	.	A	G	2	5	7	0	0	7	0	0
20	27732832	.	A	G	2	4	6	0	0	6	0	0
20	27732879	.	C	T	0	3	3	0	3	6	0	0
20	27732911	.	T	A	6	5	11	0	0	11	0	0
20	27733009	.	C	T	0	4	4	0	4	8	0	0
20	27733316	.	A	T	0	5	5	0	0	5	0	0
20	27733568	.	C	T	11	10	21	0	0	21	0	0
20	27733611	.	T	C	7	4	11	0	0	11	0	0
20	27733686	.	C	A	0	5	5	0	4	9	0	0
20	27822132	.	A	G	4	7	11	0	0	11	0	0
20	28252152	.	G	T	1	3	4	0	0	4	0	0
20	28252167	.	A	G	3	2	5	0	0	5	0	0
20	28253930	.	A	C	4	5	9	0	0	9	0	0
20	28254141	.	A	G	4	1	5	0	0	5	0	0
20	28267512	.	A	T	27	17	44	0	3	47	0	0
20	28268623	.	T	C	0	2	2	0	0	2	0	0
20	28268828	.	A	G	29	2	31	0	28	59	0	0
20	28268888	.	C	T	33	25	58	0	0	58	0	0
20	28269024	.	A	T	27	20	47	0	3	50	0	0
20	28269165	.	G	A	21	19	40	0	2	42	0	0
20	28269181	.	C	T	25	16	41	0	4	45	0	0
20	28269210	.	A	G	24	1	25	0	22	47	0	0
20	28269219	.	A	C	21	25	46	0	1	47	0	0
20	28269355	.	T	C	21	28	49	0	3	52	0	0
20	28269418	.	T	G	3	14	17	0	0	17	0	0
20	28269842	.	T	A	1	4	5	0	0	5	0	0
20	28269958	.	T	A	2	3	5	0	0	5	0	0
20	28270416	.	A	G	5	2	7	0	0	7	0	0
20	28270442	.	A	G	5	1	6	0	0	6	0	0
20	28270474	.	G	T	6	2	8	0	0	8	0	0
20	28270493	.	C	T	0	3	3	0	4	7	0	0
20	28273541	.	C	T	0	3	3	0	3	6	0	0
20	28273631	.	A	G	5	3	8	0	1	9	0	0
20	28281509	.	A	C	4	4	8	0	0	8	0	0
20	28281515	.	A	G	4	7	11	0	0	11	0	0
20	28281578	.	C	G	0	4	4	0	0	4	0	0
20	28310920	.	A	G	1	2	3	0	0	3	0	0
20	28316845	.	G	T	1	3	4	0	0	4	0	0
20	28354951	.	A	G	9	6	15	0	0	15	0	0
20	28355029	.	C	T	11	3	14	0	0	14	0	0
20	28356989	.	T	C	4	8	12	0	0	12	0	0
20	28356998	.	G	A	6	8	14	0	0	14	0	0
20	28357055	.	G	T	9	6	15	0	1	16	0	0
20	28357184	.	A	G	5	3	8	0	0	8	0	0
20	28357190	.	C	T	5	5	10	0	0	10	0	0
20	28357253	.	C	T	5	5	10	0	0	10	0	0
20	28357570	.	A	G	5	5	10	0	0	10	0	0
20	28357580	.	G	A	5	5	10	0	0	10	0	0
20	28357610	.	A	G	5	7	12	0	0	12	0	0
20	28357769	.	A	G	3	2	5	0	0	5	0	0
20	28358114	.	G	A	4	2	6	0	0	6	0	0
20	28400232	.	A	T	1	4	5	0	0	5	0	0
20	28400390	.	C	T	1	3	4	0	2	6	0	0
20	28400422	.	C	T	5	5	10	0	0	10	0	0
20	28400455	.	A	C	7	8	15	0	0	15	0	0
20	28400506	.	T	A	8	13	21	0	0	21	0	0
20	28400704	.	A	G	15	10	25	0	0	25	0	0
20	28400783	.	C	A	11	6	17	0	0	17	0	0
20	28400823	.	T	C	6	4	10	0	0	10	0	0
20	28400945	.	C	G	5	8	13	0	0	13	0	0
20	28401147	.	A	G	9	12	21	0	0	21	0	0
20	28401232	.	T	A	3	2	5	0	1	6	0	0
20	28401268	.	G	T	6	4	10	0	0	10	0	0
20	28401799	.	T	G	1	2	3	0	0	3	0	0
20	28402067	.	T	C	1	1	2	0	0	2	0	0
20	28402495	.	G	A	4	6	10	0	1	11	0	0
20	28413925	.	C	T	2	1	3	0	0	3	0	0
20	28414423	.	T	C	4	3	7	0	0	7	0	0
20	28417175	.	G	C	7	3	10	0	0	10	0	0
20	28417184	.	G	A	7	3	10	0	0	10	0	0
20	28418550	.	A	G	3	4	7	0	0	7	0	0
20	28418587	.	C	T	5	5	10	0	0	10	0	0
20	28418939	.	T	C	4	7	11	0	0	11	0	0
20	28418951	.	T	A	8	4	12	0	0	12	0	0
20	28419015	.	A	T	4	8	12	0	2	14	0	0
20	28419133	.	A	T	4	3	7	0	0	7	0	0
20	28419831	.	T	C	3	5	8	0	0	8	0	0
20	28420234	.	T	A	10	7	17	0	1	18	0	0
20	28420361	.	C	T	7	7	14	0	2	16	0	0
20	28420438	.	C	G	10	8	18	0	2	20	0	0
20	28420522	.	G	A	3	4	7	0	0	7	0	0
20	28422842	.	C	A	2	3	5	0	0	5	0	0
20	28423035	.	G	T	1	2	3	0	1	4	0	0
20	28456574	.	T	C	10	5	15	0	0	15	0	0
20	28456616	.	C	T	2	2	4	0	0	4	0	0
20	28469934	.	G	A	1	2	3	0	0	3	0	0
20	28469982	.	A	G	6	8	14	0	1	15	0	0
20	28470057	.	T	C	2	0	2	0	0	2	0	0
20	28476107	.	T	C	1	0	1	0	0	1	0	0
20	28487287	.	T	C	2	4	6	0	0	6	0	0
20	28514822	.	G	C	3	1	4	0	1	5	0	0
20	28514878	.	T	C	7	5	12	0	0	12	0	0
20	28541670	.	A	G	1	1	2	0	0	2	0	0
20	28541754	.	A	G	1	1	2	0	0	2	0	0
20	28650328	.	A	C	13	8	21	0	1	22	0	0
20	28650945	.	A	T	21	8	29	0	1	30	0	0
20	28650946	.	T	G	21	8	29	0	1	30	0	0
20	28650980	.	T	C	17	9	26	0	1	27	0	0
20	28651239	.	A	G	15	25	40	0	2	42	0	0
20	28651693	.	G	T	12	13	25	0	1	26	0	0
20	28651958	.	T	G	8	9	17	0	3	20	0	0
20	28652277	.	G	C	25	13	38	0	0	38	0	0
20	28652449	.	G	C	14	18	32	0	1	34	1	0
20	28652485	.	G	A	13	19	32	0	3	35	0	0
20	28652597	.	G	C	13	10	23	0	0	23	0	0
20	28658597	.	T	C	9	10	19	0	1	20	0	0
20	28658666	.	A	C	7	5	12	0	0	12	0	0
20	28659924	.	A	G	3	3	6	0	1	7	0	0
20	28660582	.	G	A	7	5	12	0	0	12	0	0
20	28660729	.	T	C	7	0	7	0	7	14	0	0
20	28660795	.	G	A	12	5	17	0	0	17	0	0
20	28660828	.	G	T	12	3	15	0	0	15	0	0
20	28660837	.	T	C	12	3	15	0	0	16	1	0
20	28692254	.	G	A	1	0	1	0	0	1	0	0
20	28692264	.	A	T	1	0	1	0	0	1	0	0
20	28834684	.	T	C	0	2	2	0	0	2	0	0
20	28870922	.	T	C	39	10	49	0	2	51	0	0
20	28886991	.	T	A	1	2	3	0	0	3	0	0
20	29216103	.	G	T	2	3	5	0	0	5	0	0
20	29268367	.	A	G	7	0	7	0	4	11	0	0
20	30894743	.	T	C	7	3	10	0	0	10	0	0
20	31238061	.	A	G	4	7	11	0	0	11	0	0
20	31309796	.	A	G	1	2	3	0	0	3	0	0
20	31310313	.	T	A	3	2	5	0	0	5	0	0
20	31429132	.	T	C	2	4	6	0	0	6	0	0
20	31429181	.	C	T	6	5	11	0	0	11	0	0
20	31429648	.	C	T	9	16	25	0	0	25	0	0
20	31429824	.	G	A	7	7	14	0	0	14	0	0
20	31430039	.	G	C	6	8	14	0	1	15	0	0
20	31430115	.	A	T	1	4	5	0	0	5	0	0
20	31430204	.	C	A	6	7	13	0	1	14	0	0
20	31430279	.	A	G	5	10	15	0	0	15	0	0
20	31430320	.	T	C	5	0	5	0	8	13	0	0
20	31430769	.	C	T	0	5	5	0	15	20	0	0
20	31430922	.	T	A	7	2	9	0	0	9	0	0
20	31430993	.	C	T	0	6	6	0	5	11	0	0
20	31431106	.	A	T	6	3	9	0	0	9	0	0
20	31431160	.	A	T	8	6	14	0	0	14	0	0
20	31431345	.	C	T	6	3	9	0	0	9	0	0
20	31431375	.	T	C	5	4	9	0	0	9	0	0
20	31431645	.	A	T	5	5	10	0	3	13	0	0
20	31431701	.	A	G	9	4	13	0	0	13	0	0
20	31431739	.	A	G	9	4	13	0	1	14	0	0
20	31431962	.	A	G	9	8	17	0	0	17	0	0
20	31432826	.	G	T	0	2	2	0	0	2	0	0
20	31436304	.	C	T	10	7	17	0	1	18	0	0
20	31436387	.	T	C	5	0	5	0	11	16	0	0
20	31436450	.	G	A	7	7	14	0	1	15	0	0
20	31436504	.	T	C	1	0	1	0	8	9	0	0
20	31436819	.	C	A	7	3	10	0	0	10	0	0
20	31441076	.	G	A	0	2	2	0	0	2	0	0
20	31442308	.	C	T	0	2	2	0	0	2	0	0
20	31447356	.	A	G	1	0	1	0	0	1	0	0
20	31447413	.	C	T	0	2	2	0	1	3	0	0
20	31451649	.	A	G	3	2	5	0	0	5	0	0
20	31483629	.	C	A	1	0	1	0	0	1	0	0
20	31746445	.	C	T	13	13	26	0	3	29	0	0
20	31747860	.	C	T	0	13	13	0	12	25	0	0
20	31747984	.	C	T	7	14	21	0	1	22	0	0
20	31747988	.	A	C	8	15	23	0	0	23	0	0
20	31748032	.	G	T	7	10	17	0	0	17	0	0
20	31748124	.	T	C	11	0	11	0	19	30	0	0
20	31748431	.	A	G	6	4	10	0	1	11	0	0
20	31748448	.	A	C	7	5	12	1	0	13	0	0
20	31748765	.	A	G	6	6	12	0	0	12	0	0
20	31748803	.	A	G	12	6	18	0	0	18	0	0
20	31749118	.	A	G	16	8	24	0	1	25	0	0
20	31749207	.	C	T	0	18	18	0	14	32	0	0
20	31769469	.	A	G	8	4	12	0	1	13	0	0
20	31769523	.	T	A	2	0	2	0	0	2	0	0
20	31929962	.	C	T	2	2	4	0	0	4	0	0
20	32047448	.	T	A	8	6	14	0	0	14	0	0
20	32047457	.	T	C	9	6	15	0	0	15	0	0
20	32047546	.	C	T	7	8	15	0	1	16	0	0
20	32047640	.	T	A	14	11	25	0	2	27	0	0
20	32048117	.	A	G	26	10	36	0	2	38	0	0
20	32048369	.	T	A	18	15	33	0	3	36	0	0
20	32049056	.	G	T	14	8	22	0	1	23	0	0
20	32049178	.	G	T	25	8	33	0	1	34	0	0
20	32052708	.	G	A	15	12	27	0	4	31	0	0
20	32052873	.	C	T	3	21	24	0	13	37	0	0
20	32071416	.	G	A	6	7	13	0	0	13	0	0
20	32098046	.	A	G	6	4	10	0	1	11	0	0
20	32110370	.	T	C	6	0	6	0	6	12	0	0
20	32110790	.	T	C	1	4	5	0	0	5	0	0
20	32110862	.	G	A	6	3	9	0	1	10	0	0
20	32110892	.	C	T	0	2	2	0	3	5	0	0
20	32110898	.	A	T	3	2	5	0	0	5	0	0
20	32118658	.	A	G	6	0	6	0	8	14	0	0
20	32134705	.	A	G	0	1	1	0	0	1	0	0
20	32135962	.	T	C	7	10	17	0	0	17	0	0
20	32136048	.	C	T	5	7	12	0	0	12	0	0
20	32136443	.	T	G	12	15	27	0	4	31	0	0
20	32136446	.	A	T	11	16	27	0	3	30	0	0
20	32136584	.	T	A	11	8	19	0	0	19	0	0
20	32136847	.	C	G	2	3	5	0	0	5	0	0
20	32137866	.	C	T	6	7	13	0	0	13	0	0
20	32137886	.	C	T	5	6	11	0	0	11	0	0
20	32137984	.	A	C	14	12	26	0	3	29	0	0
20	32138029	.	T	A	19	2	21	0	4	25	0	0
20	32138127	.	C	T	18	6	24	0	1	25	0	0
20	32138305	.	T	C	10	6	16	0	2	18	0	0
20	32138360	.	T	C	12	13	25	0	1	26	0	0
20	32138400	.	A	G	19	7	26	0	0	26	0	0
20	32138478	.	A	G	17	16	33	0	1	34	0	0
20	32138723	.	A	G	18	0	18	0	13	31	0	0
20	32141838	.	G	A	2	2	4	0	0	4	0	0
20	32144872	.	T	G	1	2	3	0	1	4	0	0
20	32148981	.	A	G	1	3	4	0	0	4	0	0
20	32224532	.	T	C	3	7	10	0	0	10	0	0
20	32225711	.	G	A	6	1	7	0	0	7	0	0
20	32226995	.	G	T	13	8	21	0	1	22	0	0
20	32227025	.	C	T	7	4	11	0	1	12	0	0
20	32229214	.	G	T	12	17	29	0	0	29	0	0
20	32230168	.	T	C	24	19	43	0	0	43	0	0
20	32230376	.	T	C	10	8	18	0	1	19	0	0
20	32230893	.	C	T	16	15	31	0	0	31	0	0
20	32230957	.	C	T	17	14	31	0	2	33	0	0
20	32286923	.	A	T	17	14	31	0	1	32	0	0
20	32287041	.	C	G	6	10	16	0	0	16	0	0
20	32287943	.	A	C	7	6	13	0	1	14	0	0
20	32288208	.	T	A	3	3	6	0	0	6	0	0
20	32288318	.	T	A	8	8	16	0	0	16	0	0
20	32288372	.	T	C	6	1	7	0	9	16	0	0
20	32290222	.	G	A	8	10	18	0	2	20	0	0
20	32290435	.	A	G	9	11	20	0	1	21	0	0
20	32290828	.	C	T	0	7	7	0	7	14	0	0
20	32291287	.	G	A	2	3	5	0	0	5	0	0
20	32330687	.	G	C	1	0	1	0	3	4	0	0
20	32330924	.	T	G	6	7	13	0	0	13	0	0
20	32331316	.	A	G	1	3	4	0	0	4	0	0
20	32331317	.	G	A	1	3	4	0	0	4	0	0
20	32332298	.	T	C	5	2	7	0	4	11	0	0
20	32337689	.	A	C	2	5	7	0	0	7	0	0
20	32337918	.	A	C	1	5	6	0	0	6	0	0
20	32337927	.	G	A	0	3	3	0	0	3	0	0
20	32339847	.	A	G	3	2	5	0	0	5	0	0
20	32405384	.	G	A	2	4	6	0	0	6	0	0
20	32432657	.	A	G	7	0	7	0	10	17	0	0
20	32438053	.	G	T	1	3	4	0	0	4	0	0
20	32438054	.	G	T	1	3	4	0	0	4	0	0
20	32438446	.	A	T	2	2	4	0	0	4	0	0
20	32478509	.	T	C	2	0	2	0	0	2	0	0
20	32484573	.	C	T	1	2	3	0	0	3	0	0
20	32484582	.	T	C	2	2	4	0	0	4	0	0
20	32487624	.	G	A	1	2	3	0	0	3	0	0
20	32487643	.	G	T	1	3	4	0	0	4	0	0
20	32489484	.	C	G	0	3	3	0	2	5	0	0
20	32489486	.	C	T	1	4	5	0	0	5	0	0
20	32489963	.	T	G	3	4	7	0	1	8	0	0
20	32489964	.	G	A	3	5	8	0	0	8	0	0
20	32490004	.	G	T	3	6	9	0	0	9	0	0
20	32490033	.	C	T	5	4	9	0	0	9	0	0
20	32490783	.	C	G	3	2	5	0	0	5	0	0
20	32490894	.	G	A	2	3	5	0	0	5	0	0
20	32498410	.	C	G	7	7	14	0	1	15	0	0
20	32498662	.	G	A	2	3	5	0	0	5	0	0
20	32499199	.	T	C	6	6	12	0	0	12	0	0
20	32499263	.	T	C	1	2	3	0	0	3	0	0
20	32501840	.	T	G	6	4	10	0	0	10	0	0
20	32520351	.	A	G	14	0	14	0	10	25	1	0
20	32520365	.	A	G	17	0	17	0	11	28	0	0
20	32520461	.	G	A	8	9	17	0	0	17	0	0
20	32520615	.	T	A	13	7	20	0	2	22	0	0
20	32520673	.	A	G	2	8	10	0	0	10	0	0
20	32520779	.	A	G	6	13	19	0	1	20	0	0
20	32520815	.	A	G	5	0	5	0	10	15	0	0
20	32520847	.	A	T	5	9	14	0	0	14	0	0
20	32520852	.	A	G	5	8	13	0	0	13	0	0
20	32520882	.	C	T	3	2	5	0	2	7	0	0
20	32521048	.	A	T	5	5	10	0	0	10	0	0
20	32521175	.	T	A	14	13	27	0	1	28	0	0
20	32521186	.	T	C	14	11	25	0	1	26	0	0
20	32521266	.	T	G	13	7	20	0	2	22	0	0
20	32521488	.	T	C	6	10	16	0	0	16	0	0
20	32521517	.	A	T	7	20	27	0	0	27	0	0
20	32521534	.	T	A	9	20	29	0	2	31	0	0
20	32521605	.	G	A	13	16	29	0	1	30	0	0
20	32521618	.	T	C	15	16	31	0	0	31	0	0
20	32521719	.	A	C	10	20	30	0	1	31	0	0
20	32521742	.	G	A	14	19	33	0	0	34	1	0
20	32557375	.	C	T	2	2	4	0	0	4	0	0
20	32567982	.	T	C	1	2	3	0	0	3	0	0
20	32571913	.	T	C	1	1	2	0	0	2	0	0
20	32838484	.	T	C	2	0	2	0	4	6	0	0
20	32838589	.	A	G	4	3	7	0	0	7	0	0
20	32838695	.	C	A	4	1	5	0	0	5	0	0
20	32872075	.	C	A	1	0	1	0	0	1	0	0
20	32872156	.	C	A	1	1	2	0	0	2	0	0
20	32948512	.	G	A	1	3	4	0	1	5	0	0
20	33007794	.	A	C	1	2	3	0	0	3	0	0
20	33177904	.	C	T	0	1	1	0	0	1	0	0
20	33180111	.	T	C	1	0	1	0	0	1	0	0
20	33189386	.	G	A	0	2	2	0	2	4	0	0
20	33294503	.	A	T	2	1	3	0	0	3	0	0
20	33295692	.	T	A	6	5	11	0	1	12	0	0
20	33297776	.	A	C	6	5	11	0	0	11	0	0
20	33298184	.	C	T	2	6	8	0	0	8	0	0
20	33298651	.	G	A	6	12	18	0	0	18	0	0
20	33298996	.	G	T	2	3	5	0	0	5	0	0
20	33467794	.	A	T	7	4	11	0	1	13	1	0
20	33471085	.	G	A	4	5	9	0	0	9	0	0
20	33471127	.	A	T	10	8	18	0	1	19	0	0
20	33471166	.	C	T	0	10	10	0	11	21	0	0
20	33471199	.	T	C	6	1	7	0	8	15	0	0
20	33487374	.	G	T	3	4	7	0	0	7	0	0
20	33494027	.	C	A	10	11	21	0	0	21	0	0
20	33494064	.	A	G	10	13	23	0	1	24	0	0
20	33494165	.	A	G	14	13	27	0	3	30	0	0
20	33494411	.	G	T	18	18	36	0	3	39	0	0
20	33494436	.	C	T	27	14	41	0	1	42	0	0
20	33497087	.	A	T	2	7	9	0	0	9	0	0
20	33759043	.	T	C	6	5	11	0	1	12	0	0
20	33759067	.	C	T	1	9	10	0	8	18	0	0
20	33759151	.	G	C	11	0	11	0	17	28	0	0
20	33759196	.	A	C	4	0	4	0	4	8	0	0
20	33763208	.	G	A	6	1	7	0	0	7	0	0
20	33771605	.	A	G	1	1	2	0	0	2	0	0
20	33795105	.	A	C	0	1	1	0	0	1	0	0
20	33810496	.	G	A	5	3	8	0	2	10	0	0
20	33811574	.	G	T	6	10	16	0	2	18	0	0
20	33811622	.	A	G	14	9	23	0	1	24	0	0
20	33860144	.	G	A	6	6	12	0	0	12	0	0
20	33860147	.	G	A	5	5	10	0	1	11	0	0
20	33909806	.	C	T	1	1	2	0	0	2	0	0
20	33982016	.	G	A	6	5	11	0	1	12	0	0
20	34007128	.	G	A	1	2	3	0	0	3	0	0
20	34007589	.	G	C	0	2	2	0	0	2	0	0
20	34009363	.	G	A	0	2	2	0	1	3	0	0
20	34009947	.	A	G	5	4	9	0	0	9	0	0
20	34010028	.	A	G	5	3	8	0	0	8	0	0
20	34010108	.	A	G	1	0	1	0	4	5	0	0
20	34012790	.	T	A	5	6	11	0	1	12	0	0
20	34012798	.	T	C	6	5	11	0	1	12	0	0
20	34012828	.	T	A	5	11	16	0	0	16	0	0
20	34012837	.	A	T	7	7	14	0	2	16	0	0
20	34015907	.	G	A	12	7	19	0	1	20	0	0
20	34015921	.	T	A	15	8	23	0	1	24	0	0
20	34015994	.	T	A	10	11	21	0	1	22	0	0
20	34020861	.	T	A	4	1	5	0	0	5	0	0
20	34020891	.	G	A	7	1	8	0	0	8	0	0
20	34021396	.	A	G	1	0	1	0	0	1	0	0
20	34039390	.	G	A	7	5	12	0	1	13	0	0
20	34042070	.	A	G	3	5	8	0	1	9	0	0
20	34042209	.	A	G	4	2	6	0	1	7	0	0
20	34044813	.	G	A	3	6	9	0	0	9	0	0
20	34056162	.	A	G	2	4	6	0	0	6	0	0
20	34057305	.	T	C	1	0	1	0	1	2	0	0
20	34059175	.	A	T	1	5	6	0	0	6	0	0
20	34059346	.	T	C	3	3	6	0	0	6	0	0
20	34062317	.	C	T	1	0	1	0	0	1	0	0
20	34064264	.	G	T	1	0	1	0	0	1	0	0
20	34064272	.	C	T	1	0	1	0	0	1	0	0
20	34154076	.	C	T	8	8	16	0	0	16	0	0
20	34154618	.	C	A	6	10	16	0	0	16	0	0
20	34154619	.	C	A	6	6	12	0	4	16	0	0
20	34155134	.	G	A	9	6	15	0	1	16	0	0
20	34155339	.	C	A	14	11	25	0	1	26	0	0
20	34155428	.	A	G	16	9	25	0	0	25	0	0
20	34157730	.	T	C	2	2	4	0	0	4	0	0
20	34159140	.	C	T	1	3	4	0	0	4	0	0
20	34338371	.	T	C	5	5	10	0	0	10	0	0
20	34338884	.	G	A	2	8	10	0	4	14	0	0
20	34339473	.	G	A	6	9	15	0	0	15	0	0
20	34339516	.	C	T	15	30	45	0	0	45	0	0
20	34339786	.	T	A	17	17	34	0	3	37	0	0
20	34340047	.	C	T	18	26	44	0	3	47	0	0
20	34340055	.	T	C	23	29	52	0	0	52	0	0
20	34340176	.	G	A	0	27	27	0	24	51	0	0
20	34340200	.	C	T	17	28	45	0	3	48	0	0
20	34340520	.	T	C	17	17	34	0	1	35	0	0
20	34340675	.	A	C	17	20	37	0	6	43	0	0
20	34341000	.	C	T	17	15	32	0	2	34	0	0
20	34341166	.	C	T	0	4	4	0	0	4	0	0
20	34343977	.	G	T	1	3	4	0	0	4	0	0
20	34344363	.	A	C	1	3	4	0	0	4	0	0
20	34364267	.	A	G	1	2	3	0	0	3	0	0
20	34364295	.	T	C	1	0	1	0	0	1	0	0
20	34364936	.	A	G	2	4	6	0	0	6	0	0
20	34365141	.	C	T	1	3	4	0	0	4	0	0
20	34365146	.	C	A	1	5	6	0	0	6	0	0
20	34368274	.	G	A	1	1	2	0	0	2	0	0
20	34396763	.	T	G	0	2	2	0	0	2	0	0
20	34398646	.	G	A	1	1	2	0	1	3	0	0
20	34420823	.	A	G	18	22	40	0	2	42	0	0
20	34421155	.	C	T	17	16	33	0	3	36	0	0
20	34421159	.	G	A	17	17	34	0	1	35	0	0
20	34421307	.	A	G	9	21	30	0	1	31	0	0
20	34421485	.	C	T	14	15	29	0	3	32	0	0
20	34421672	.	G	A	10	10	20	0	1	21	0	0
20	34421701	.	T	C	5	11	16	0	0	16	0	0
20	34421758	.	G	A	8	14	22	0	0	22	0	0
20	34421801	.	G	C	7	0	7	0	10	17	0	0
20	34421804	.	G	A	7	10	17	0	0	17	0	0
20	34426759	.	A	C	12	13	25	0	1	26	0	0
20	34430100	.	T	G	11	6	17	0	0	17	0	0
20	34431337	.	G	A	4	4	8	0	0	8	0	0
20	34431661	.	A	G	7	3	10	0	1	11	0	0
20	34444945	.	T	C	4	5	9	0	0	9	0	0
20	34445005	.	A	G	0	1	1	0	0	1	0	0
20	34446733	.	A	G	1	3	4	0	0	4	0	0
20	34447025	.	A	G	5	7	12	0	0	12	0	0
20	34447049	.	G	A	2	0	2	0	0	2	0	0
20	34502644	.	G	A	0	1	1	0	0	1	0	0
20	34507247	.	A	G	2	3	5	0	0	5	0	0
20	34537814	.	G	T	5	4	9	0	2	11	0	0
20	34592483	.	C	T	3	2	5	0	0	5	0	0
20	34596468	.	A	T	8	6	14	0	0	14	0	0
20	34596788	.	C	T	2	3	5	0	0	5	0	0
20	34596797	.	G	T	2	3	5	0	0	5	0	0
20	34596914	.	A	T	3	2	5	0	1	6	0	0
20	34597127	.	C	T	5	11	16	0	0	16	0	0
20	34597292	.	G	A	3	7	10	0	1	11	0	0
20	34597844	.	T	C	9	12	21	0	1	22	0	0
20	34598113	.	C	A	2	1	3	0	0	3	0	0
20	34601127	.	A	G	14	18	32	0	1	33	0	0
20	34602340	.	C	T	10	5	15	0	3	18	0	0
20	34602561	.	A	C	9	18	27	0	1	28	0	0
20	34603575	.	G	T	10	4	14	0	1	15	0	0
20	34603733	.	T	G	0	2	2	0	0	2	0	0
20	34604356	.	C	T	19	11	30	0	0	30	0	0
20	34604432	.	C	T	7	2	9	0	0	9	0	0
20	34607698	.	A	G	4	1	5	0	8	13	0	0
20	34607893	.	A	G	11	12	23	0	0	23	0	0
20	34608194	.	C	T	6	11	17	0	2	19	0	0
20	34608235	.	A	G	4	9	13	0	0	13	0	0
20	34608272	.	T	C	4	5	9	0	1	10	0	0
20	34608404	.	T	G	3	4	7	0	0	7	0	0
20	34611709	.	G	T	2	1	3	0	0	3	0	0
20	34613651	.	A	G	0	1	1	0	0	1	0	0
20	34627817	.	G	C	3	2	5	0	0	5	0	0
20	34630192	.	T	C	5	5	10	0	1	11	0	0
20	34630381	.	C	T	4	2	6	0	0	6	0	0
20	34630861	.	C	T	1	3	4	0	0	4	0	0
20	34642639	.	C	A	1	1	2	0	0	2	0	0
20	34643491	.	A	T	7	6	13	0	0	13	0	0
20	34643535	.	T	C	2	7	9	0	1	10	0	0
20	34658609	.	G	A	2	3	5	0	0	5	0	0
20	34695326	.	C	T	1	1	2	0	0	2	0	0
20	34696329	.	A	C	0	2	2	0	0	2	0	0
20	34696628	.	A	T	11	6	17	0	0	17	0	0
20	34700135	.	G	T	6	5	11	0	0	11	0	0
20	34700237	.	G	T	0	8	8	0	4	12	0	0
20	34700238	.	T	C	3	8	11	0	1	12	0	0
20	34727666	.	G	A	5	4	9	0	0	9	0	0
20	34733259	.	A	G	8	0	8	0	9	17	0	0
20	34733604	.	G	A	10	14	24	0	3	27	0	0
20	34733819	.	G	A	21	8	29	0	0	29	0	0
20	34737818	.	A	G	4	8	12	0	0	12	0	0
20	34737886	.	T	A	4	3	7	0	1	8	0	0
20	34737920	.	C	A	2	6	8	0	2	10	0	0
20	34738198	.	G	A	19	17	36	0	3	39	0	0
20	34738205	.	C	T	4	19	23	0	18	41	0	0
20	34738272	.	A	G	33	13	46	0	1	47	0	0
20	34738314	.	G	A	11	24	35	0	3	38	0	0
20	34738397	.	G	T	12	12	24	0	0	24	0	0
20	34738756	.	A	G	11	20	31	0	1	32	0	0
20	34742840	.	G	A	1	3	4	0	0	4	0	0
20	34746019	.	G	A	10	11	21	0	1	22	0	0
20	34749672	.	G	A	3	1	4	0	0	4	0	0
20	34749747	.	G	A	11	7	18	0	1	19	0	0
20	34749754	.	C	T	6	9	15	0	0	15	0	0
20	34749793	.	C	T	2	1	3	0	0	3	0	0
20	34749794	.	A	G	2	1	3	0	0	3	0	0
20	34779087	.	T	C	3	2	5	0	0	5	0	0
20	34794939	.	C	T	31	25	56	0	1	57	0	0
20	34794988	.	C	G	30	21	51	0	3	55	1	0
20	34795111	.	C	A	37	38	75	0	1	76	0	0
20	34795126	.	A	G	36	34	70	0	2	72	0	0
20	34795221	.	A	T	37	27	64	0	4	68	0	0
20	34795418	.	G	C	29	25	54	0	1	55	0	0
20	34795559	.	C	T	3	33	36	0	30	66	0	0
20	34795631	.	T	G	32	19	51	0	2	53	0	0
20	34795689	.	C	T	22	30	52	0	3	55	0	0
20	34797252	.	G	T	32	26	58	0	2	60	0	0
20	34797532	.	C	A	31	28	59	0	3	62	0	0
20	34801164	.	C	T	3	4	7	0	0	7	0	0
20	34933209	.	C	A	11	20	31	1	3	35	0	0
20	34955791	.	C	T	25	26	51	0	2	53	0	0
20	34956159	.	A	T	10	12	22	0	0	22	0	0
20	34956164	.	T	A	11	12	23	0	1	24	0	0
20	34991776	.	G	A	1	2	3	0	0	3	0	0
20	34991804	.	C	T	0	2	2	0	2	4	0	0
20	34993974	.	G	A	2	1	3	0	0	3	0	0
20	35000029	.	C	T	3	3	6	0	1	7	0	0
20	35000163	.	C	T	0	2	2	0	2	4	0	0
20	35017831	.	C	T	4	3	7	0	0	7	0	0
20	35017898	.	G	A	0	3	3	0	0	3	0	0
20	35017899	.	T	A	0	2	2	0	1	3	0	0
20	35021763	.	T	C	1	0	1	0	2	3	0	0
20	35058727	.	T	A	10	13	23	0	3	26	0	0
20	35059085	.	G	A	1	5	6	0	5	11	0	0
20	35064521	.	G	A	3	3	6	0	0	6	0	0
20	35065345	.	G	A	0	1	1	0	3	4	0	0
20	35065588	.	G	A	9	8	17	0	1	18	0	0
20	35066821	.	G	A	0	7	7	0	15	22	0	0
20	35068702	.	T	C	16	13	29	0	1	30	0	0
20	35068765	.	A	T	13	13	26	0	0	26	0	0
20	35069756	.	A	G	12	12	24	0	1	25	0	0
20	35069928	.	C	T	19	14	33	0	0	34	1	0
20	35069963	.	A	C	16	23	39	0	1	40	0	0
20	35070176	.	C	T	15	18	33	0	2	35	0	0
20	35070340	.	C	T	14	11	25	0	2	27	0	0
20	35165533	.	G	A	0	1	1	0	0	1	0	0
20	35171257	.	C	T	1	0	1	0	0	1	0	0
20	35177501	.	T	C	1	1	2	0	0	2	0	0
20	35191113	.	G	A	5	2	7	0	0	7	0	0
20	35195185	.	G	A	1	5	6	0	4	10	0	0
20	35198116	.	G	A	5	2	7	0	1	8	0	0
20	35198780	.	G	A	0	1	1	0	1	2	0	0
20	35204668	.	C	T	12	12	24	0	3	27	0	0
20	35204773	.	C	T	5	11	16	0	0	16	0	0
20	35205061	.	C	T	8	11	19	0	0	19	0	0
20	35205182	.	T	C	2	6	8	0	0	8	0	0
20	35205361	.	T	A	3	3	6	0	0	6	0	0
20	35205550	.	A	G	9	0	9	0	7	16	0	0
20	35205552	.	T	G	7	0	7	0	9	16	0	0
20	35205600	.	A	T	12	12	24	0	0	24	0	0
20	35205626	.	T	G	9	0	9	0	15	24	0	0
20	35205772	.	T	A	7	7	14	0	1	15	0	0
20	35206023	.	G	A	12	14	26	0	0	26	0	0
20	35206101	.	A	T	1	10	11	0	1	12	0	0
20	35206272	.	T	C	5	2	7	0	0	7	0	0
20	35208046	.	A	G	5	12	17	0	0	17	0	0
20	35209080	.	T	A	0	8	8	0	0	8	0	0
20	35209405	.	C	T	18	14	32	0	0	32	0	0
20	35209625	.	G	A	10	8	18	0	0	18	0	0
20	35210047	.	T	C	10	0	10	0	8	18	0	0
20	35210175	.	C	A	8	14	22	0	0	22	0	0
20	35210176	.	T	C	14	0	14	0	8	22	0	0
20	35210212	.	G	T	10	8	18	0	0	18	0	0
20	35210538	.	C	G	3	8	11	0	0	11	0	0
20	35210575	.	C	T	3	2	5	0	0	5	0	0
20	35210649	.	A	G	4	6	10	0	0	10	0	0
20	35210853	.	A	T	5	6	11	0	0	11	0	0
20	35210909	.	T	C	4	3	7	0	0	7	0	0
20	35211062	.	A	G	2	2	4	0	0	4	0	0
20	35211515	.	C	T	0	2	2	0	7	9	0	0
20	35211641	.	C	T	3	5	8	0	1	9	0	0
20	35212064	.	T	A	4	2	6	0	0	6	0	0
20	35212070	.	G	A	4	2	6	0	0	6	0	0
20	35212366	.	T	C	1	4	5	0	0	5	0	0
20	35212398	.	A	G	2	3	5	0	0	5	0	0
20	35212405	.	C	T	3	2	5	0	0	5	0	0
20	35212946	.	T	A	2	7	9	0	1	10	0	0
20	35215773	.	C	G	0	5	5	0	3	8	0	0
20	35215776	.	G	C	3	4	7	0	1	8	0	0
20	35220065	.	G	A	2	3	5	0	0	5	0	0
20	35227187	.	A	G	2	3	5	0	0	5	0	0
20	35295208	.	C	T	0	1	1	0	0	1	0	0
20	35297648	.	C	T	5	6	11	0	0	11	0	0
20	35297693	.	G	A	7	6	13	0	0	13	0	0
20	35297819	.	T	C	1	5	6	0	0	6	0	0
20	35297832	.	A	C	5	0	5	0	0	5	0	0
20	35297867	.	C	T	1	5	6	0	0	6	0	0
20	35297968	.	T	C	4	2	6	0	0	6	0	0
20	35427536	.	G	C	3	5	8	0	0	8	0	0
20	35428128	.	A	T	13	23	36	4	3	43	0	0
20	35428305	.	C	T	43	11	54	0	0	54	0	0
20	35428633	.	T	C	17	28	45	0	3	48	0	0
20	35428931	.	T	A	32	36	68	0	3	72	1	0
20	35429017	.	T	A	15	12	27	0	2	29	0	0
20	35429269	.	C	T	37	28	65	0	2	67	0	0
20	35429299	.	A	G	39	23	62	0	2	64	0	0
20	35429384	.	C	T	31	31	62	0	2	64	0	0
20	35429610	.	A	T	41	36	77	0	2	79	0	0
20	35433262	.	G	C	14	10	24	0	1	25	0	0
20	35433264	.	G	C	14	10	24	0	1	25	0	0
20	35464735	.	C	G	0	1	1	0	1	2	0	0
20	35798370	.	G	A	18	17	35	0	4	39	0	0
20	35798717	.	A	G	10	12	22	0	1	23	0	0
20	35798973	.	T	A	7	10	17	0	0	17	0	0
20	35800001	.	G	A	4	3	7	0	2	9	0	0
20	35800128	.	C	T	15	6	21	0	1	22	0	0
20	35800249	.	C	T	12	5	17	0	1	18	0	0
20	35800349	.	C	T	15	6	21	0	1	22	0	0
20	35800520	.	G	A	4	6	10	0	1	11	0	0
20	35800749	.	G	A	2	10	12	0	0	12	0	0
20	35816606	.	G	A	4	9	13	0	0	13	0	0
20	35816630	.	C	T	6	5	11	0	1	12	0	0
20	35827890	.	C	T	3	3	6	0	0	6	0	0
20	35827896	.	C	A	3	4	7	0	0	7	0	0
20	35827945	.	G	C	4	2	6	0	1	7	0	0
20	35831719	.	C	T	1	5	6	0	1	7	0	0
20	35831954	.	T	C	3	0	3	0	4	7	0	0
20	35832168	.	G	A	6	2	8	0	0	8	0	0
20	35941146	.	G	A	0	1	1	0	1	2	0	0
20	35972539	.	T	C	1	2	3	0	1	4	0	0
20	35972544	.	G	A	1	2	3	0	1	4	0	0
20	35979899	.	G	T	3	3	6	0	0	6	0	0
20	35979910	.	T	G	3	3	6	0	0	6	0	0
20	35979983	.	G	C	2	1	3	0	0	3	0	0
20	35980009	.	A	G	3	0	3	0	0	3	0	0
20	35980021	.	C	T	3	1	4	0	0	4	0	0
20	36234334	.	T	A	9	8	17	0	0	17	0	0
20	36290217	.	C	T	5	5	10	0	0	10	0	0
20	36297304	.	C	T	5	6	11	0	1	12	0	0
20	36297356	.	G	A	0	15	15	0	12	27	0	0
20	36297418	.	C	A	12	10	22	0	0	22	0	0
20	36297448	.	C	T	14	13	27	0	0	27	0	0
20	36297518	.	G	A	0	15	15	0	12	27	0	0
20	36297832	.	C	T	8	7	15	0	1	16	0	0
20	36394970	.	G	A	1	2	3	0	0	3	0	0
20	36395717	.	G	A	2	2	4	0	0	4	0	0
20	36395748	.	C	T	2	2	4	0	0	4	0	0
20	36396616	.	T	C	3	0	3	0	4	7	0	0
20	36404990	.	C	T	0	1	1	0	1	2	0	0
20	36420218	.	A	C	13	20	33	0	0	33	0	0
20	36420713	.	C	T	0	13	13	0	20	33	0	0
20	36420804	.	G	T	18	13	31	0	0	31	0	0
20	36420982	.	G	A	12	8	20	0	1	21	0	0
20	36421530	.	A	C	12	0	12	0	11	23	0	0
20	36421757	.	C	T	0	13	13	0	9	22	0	0
20	36422043	.	G	A	20	13	33	0	1	34	0	0
20	36422098	.	C	A	6	14	20	0	3	23	0	0
20	36422291	.	G	T	6	10	16	0	1	17	0	0
20	36437314	.	A	G	3	5	8	0	0	8	0	0
20	36440113	.	C	T	0	2	2	0	14	16	0	0
20	36449286	.	G	A	1	1	2	0	0	2	0	0
20	36449385	.	C	T	6	4	10	0	2	12	0	0
20	36449442	.	A	C	6	11	17	0	0	17	0	0
20	36449601	.	C	T	5	2	7	0	0	7	0	0
20	36626195	.	A	G	12	0	12	0	9	21	0	0
20	36626248	.	G	A	8	16	24	0	1	25	0	0
20	36626335	.	C	T	16	8	24	0	3	27	0	0
20	36633082	.	C	T	6	4	10	0	0	10	0	0
20	36637941	.	C	T	3	4	7	0	1	8	0	0
20	36637999	.	G	A	6	3	9	0	0	9	0	0
20	36638133	.	A	T	7	2	9	0	0	9	0	0
20	36675273	.	T	C	9	3	12	0	0	12	0	0
20	36677574	.	G	A	4	1	5	0	0	5	0	0
20	36769391	.	G	T	0	2	2	0	2	4	0	0
20	36773579	.	G	T	0	3	3	0	6	9	0	0
20	36773949	.	G	A	0	2	2	0	3	5	0	0
20	36777354	.	A	C	3	3	6	0	0	6	0	0
20	36783480	.	C	T	5	5	10	0	0	10	0	0
20	36785477	.	G	A	4	4	8	0	0	8	0	0
20	36797957	.	A	T	0	2	2	0	0	2	0	0
20	36799816	.	A	G	5	6	11	0	1	12	0	0
20	36799934	.	C	T	0	8	8	0	6	14	0	0
20	36816850	.	T	C	3	3	6	0	0	7	1	0
20	36816961	.	A	C	0	7	7	0	0	7	0	0
20	36816972	.	C	T	1	7	8	0	0	8	0	0
20	36817162	.	T	G	5	3	8	0	0	8	0	0
20	36817184	.	G	A	0	5	5	0	4	9	0	0
20	36828948	.	A	C	7	5	12	0	0	12	0	0
20	36829418	.	G	A	1	3	4	0	7	11	0	0
20	36829428	.	A	C	6	3	9	0	0	9	0	0
20	36838717	.	C	T	6	12	18	0	0	18	0	0
20	36838871	.	C	T	22	7	29	0	0	29	0	0
20	36838946	.	A	C	4	8	12	0	0	12	0	0
20	36846606	.	A	G	7	4	11	0	1	12	0	0
20	36915481	.	G	A	10	11	21	0	0	21	0	0
20	36915493	.	A	T	10	9	19	0	0	20	1	0
20	36915529	.	G	A	14	9	23	0	1	24	0	0
20	36915826	.	C	A	17	13	30	0	0	31	1	0
20	36916050	.	A	G	7	15	22	0	1	23	0	0
20	36916187	.	T	C	9	0	9	0	9	18	0	0
20	36916428	.	A	T	3	7	10	0	0	10	0	0
20	36916429	.	A	T	3	8	11	0	0	11	0	0
20	36917037	.	C	T	16	13	29	0	0	29	0	0
20	36917631	.	C	T	9	4	13	0	0	13	0	0
20	37300798	.	G	A	9	7	16	0	0	16	0	0
20	37300862	.	G	C	1	1	2	0	2	4	0	0
20	37376467	.	G	A	0	6	6	0	6	12	0	0
20	37533078	.	C	T	2	2	4	0	1	5	0	0
20	37533137	.	C	T	1	2	3	0	0	3	0	0
20	37733776	.	C	A	2	3	5	0	1	6	0	0
20	37735957	.	C	G	15	18	33	0	1	34	0	0
20	37735980	.	T	C	13	14	27	0	2	29	0	0
20	37736041	.	T	A	10	7	17	0	3	20	0	0
20	37736409	.	T	G	4	10	14	0	0	14	0	0
20	37750616	.	C	T	1	2	3	0	0	3	0	0
20	37752015	.	C	G	3	2	5	0	0	5	0	0
20	37760596	.	G	C	4	2	6	0	0	6	0	0
20	37761205	.	C	T	2	1	3	0	0	3	0	0
20	37768621	.	C	T	10	4	14	0	2	16	0	0
20	37768712	.	A	C	3	11	14	0	0	14	0	0
20	37768844	.	G	T	7	10	17	0	0	17	0	0
20	37768995	.	T	A	3	7	10	0	1	11	0	0
20	37768997	.	A	T	1	6	7	0	4	11	0	0
20	37769084	.	A	G	3	6	9	0	0	9	0	0
20	37769099	.	C	A	3	6	9	0	1	10	0	0
20	37798627	.	G	A	5	6	11	0	0	11	0	0
20	37798805	.	A	G	3	5	8	0	0	8	0	0
20	37798860	.	A	C	2	2	4	0	0	4	0	0
20	37798892	.	C	T	1	3	4	0	2	6	0	0
20	37799497	.	T	C	6	4	10	0	0	10	0	0
20	37799688	.	G	A	0	2	2	0	3	5	0	0
20	37800100	.	A	C	0	5	5	0	0	5	0	0
20	37800476	.	T	C	1	2	3	0	0	3	0	0
20	37826300	.	G	T	1	2	3	0	0	3	0	0
20	37826843	.	T	A	0	5	5	0	1	6	0	0
20	37831776	.	T	C	2	6	8	0	1	9	0	0
20	37899289	.	T	C	3	1	4	0	1	5	0	0
20	37912863	.	C	A	6	2	8	0	1	9	0	0
20	37913114	.	G	A	7	3	10	0	1	11	0	0
20	37913123	.	T	G	6	3	9	0	0	9	0	0
20	37913237	.	G	A	2	4	6	0	0	6	0	0
20	37913335	.	A	T	2	3	5	0	1	6	0	0
20	37913767	.	T	G	5	6	11	0	1	12	0	0
20	37913866	.	A	G	3	3	6	0	0	6	0	0
20	37914048	.	G	C	5	5	10	0	0	10	0	0
20	37914057	.	G	A	5	5	10	0	0	10	0	0
20	37914145	.	C	T	7	3	10	0	0	10	0	0
20	37914838	.	C	T	4	3	7	0	1	8	0	0
20	37914855	.	T	G	9	6	15	0	0	15	0	0
20	37915005	.	A	C	7	4	11	0	0	11	0	0
20	37915080	.	T	A	7	2	9	0	0	9	0	0
20	37915097	.	C	G	8	5	13	0	0	13	0	0
20	37915217	.	A	T	11	11	22	0	0	22	0	0
20	37915237	.	C	T	7	6	13	0	1	14	0	0
20	37915292	.	A	G	5	7	12	0	0	12	0	0
20	37915465	.	A	G	12	0	12	0	9	21	0	0
20	37915479	.	C	T	11	8	19	0	0	19	0	0
20	37915658	.	T	C	4	6	10	0	0	10	0	0
20	37915699	.	G	T	0	9	9	0	6	15	0	0
20	37915701	.	C	T	6	9	15	0	0	15	0	0
20	37916043	.	T	A	9	5	14	0	2	16	0	0
20	37916143	.	C	T	5	4	9	0	2	11	0	0
20	37916161	.	A	T	5	5	10	0	1	11	0	0
20	37920396	.	C	T	2	1	3	0	0	3	0	0
20	37920773	.	T	C	6	4	10	0	0	10	0	0
20	37920822	.	C	T	0	2	2	0	0	2	0	0
20	37924995	.	G	T	2	1	3	0	0	3	0	0
20	37928510	.	C	G	2	2	4	0	1	5	0	0
20	37930593	.	A	G	4	9	13	0	0	13	0	0
20	37930874	.	C	T	0	5	5	0	3	8	0	0
20	38032694	.	G	C	1	2	3	0	0	3	0	0
20	38076127	.	G	A	0	1	1	0	0	1	0	0
20	38086653	.	A	G	6	0	6	0	0	6	0	0
20	38091814	.	C	T	4	2	6	0	2	8	0	0
20	38104080	.	C	A	21	9	30	0	1	31	0	0
20	38202135	.	G	T	2	2	4	0	1	5	0	0
20	38202183	.	C	A	4	2	6	0	0	6	0	0
20	38241282	.	C	A	5	5	10	0	0	10	0	0
20	38241357	.	T	C	1	3	4	0	0	4	0	0
20	38241363	.	T	A	2	4	6	0	0	6	0	0
20	38241762	.	C	T	2	4	6	0	0	6	0	0
20	38241781	.	C	G	3	4	7	0	0	7	0	0
20	38358660	.	C	A	5	11	16	0	0	16	0	0
20	38358864	.	T	C	4	5	9	0	0	9	0	0
20	38358866	.	T	C	4	4	8	0	1	9	0	0
20	38358955	.	A	T	5	4	9	0	0	9	0	0
20	38473700	.	C	T	2	8	10	0	0	10	0	0
20	38473763	.	T	C	8	10	18	0	0	18	0	0
20	38508375	.	G	A	1	0	1	0	0	1	0	0
20	38517929	.	T	A	9	7	16	0	1	17	0	0
20	38517941	.	C	T	7	9	16	0	0	16	0	0
20	38518015	.	C	T	7	6	13	0	2	15	0	0
20	38518082	.	T	G	14	10	24	0	2	26	0	0
20	38518267	.	A	G	13	7	20	0	1	21	0	0
20	38518454	.	T	G	12	5	17	0	1	18	0	0
20	38532334	.	C	T	3	3	6	0	0	6	0	0
20	38538248	.	C	T	2	5	7	0	0	7	0	0
20	38657824	.	C	T	3	3	6	0	0	6	0	0
20	38657825	.	T	C	2	3	5	0	1	6	0	0
20	38669294	.	T	C	7	7	14	0	0	14	0	0
20	38669329	.	A	G	6	0	6	0	8	14	0	0
20	38669453	.	C	G	5	3	8	0	0	8	0	0
20	38669481	.	C	T	7	4	11	0	1	12	0	0
20	38669562	.	C	T	4	6	10	0	0	10	0	0
20	38669869	.	T	G	2	5	7	0	0	7	0	0
20	38669888	.	T	A	2	8	10	0	1	11	0	0
20	38670071	.	C	T	7	4	11	0	0	11	0	0
20	38670100	.	C	T	3	5	8	0	0	8	0	0
20	38670108	.	T	C	4	5	9	0	0	9	0	0
20	38670143	.	C	T	6	8	14	0	0	14	0	0
20	38670157	.	G	A	0	8	8	0	3	11	0	0
20	38726399	.	A	C	4	13	17	0	1	18	0	0
20	38726421	.	A	T	6	13	19	0	0	19	0	0
20	38726624	.	C	G	8	12	20	0	0	20	0	0
20	38764192	.	C	A	16	15	31	0	2	33	0	0
20	38764201	.	C	A	18	15	33	0	0	33	0	0
20	38764265	.	A	G	8	15	23	0	0	23	0	0
20	38764992	.	T	C	9	4	13	0	1	14	0	0
20	38765100	.	C	T	0	10	10	0	9	19	0	0
20	38765296	.	T	G	12	5	17	0	0	17	0	0
20	38765318	.	T	C	4	14	18	0	0	18	0	0
20	38765364	.	T	A	8	10	18	0	3	21	0	0
20	38765450	.	C	A	5	3	8	0	0	8	0	0
20	38765452	.	A	G	6	1	7	0	1	8	0	0
20	38765487	.	T	G	2	6	8	0	0	8	0	0
20	38765552	.	C	T	0	15	15	0	12	27	0	0
20	38778463	.	G	A	2	1	3	0	0	3	0	0
20	39181809	.	A	G	1	5	6	0	2	8	0	0
20	39257354	.	A	C	1	5	6	0	0	6	0	0
20	39582056	.	A	T	3	2	5	0	0	5	0	0
20	39589080	.	A	T	4	2	6	0	0	6	0	0
20	39692306	.	G	C	1	2	3	0	0	3	0	0
20	39692392	.	T	G	2	3	5	0	0	5	0	0
20	39692433	.	C	A	4	2	6	0	0	6	0	0
20	39693062	.	G	A	3	2	5	0	0	5	0	0
20	39713145	.	G	A	1	0	1	0	0	1	0	0
20	39806592	.	T	C	4	2	6	0	0	6	0	0
20	40119676	.	C	T	2	2	4	0	0	4	0	0
20	40269926	.	T	C	11	2	13	0	18	31	0	0
20	40319575	.	A	C	2	4	6	0	0	6	0	0
20	40319649	.	C	G	2	3	5	0	1	6	0	0
20	40369463	.	C	A	0	1	1	0	0	1	0	0
20	40372760	.	T	A	22	12	34	0	2	36	0	0
20	40372811	.	A	G	14	16	30	0	2	32	0	0
20	40451106	.	C	T	4	4	8	0	0	8	0	0
20	40457669	.	G	C	5	3	8	0	1	9	0	0
20	40461550	.	G	A	12	13	25	0	3	28	0	0
20	40464613	.	C	G	2	2	4	0	0	4	0	0
20	40466540	.	C	T	10	10	20	0	1	21	0	0
20	40466662	.	C	T	11	5	16	0	0	16	0	0
20	40467044	.	C	T	19	16	35	0	2	37	0	0
20	40471756	.	A	T	32	44	76	0	4	80	0	0
20	40471844	.	C	T	21	22	43	1	2	46	0	0
20	40471886	.	T	A	17	16	33	0	6	39	0	0
20	40472009	.	T	A	31	31	62	0	2	64	0	0
20	40472075	.	C	A	29	29	58	0	3	61	0	0
20	40472175	.	G	C	32	26	58	0	0	58	0	0
20	40475815	.	C	T	5	12	17	0	0	17	0	0
20	40475872	.	G	A	8	7	15	0	1	16	0	0
20	40476094	.	G	A	10	9	19	0	0	19	0	0
20	40476165	.	C	T	18	15	33	0	0	33	0	0
20	40476214	.	A	T	17	16	33	0	6	39	0	0
20	40478289	.	A	C	3	1	4	0	0	4	0	0
20	40480227	.	G	T	6	9	15	0	0	15	0	0
20	40480250	.	C	T	9	9	18	0	0	18	0	0
20	40485077	.	T	G	1	0	1	0	0	1	0	0
20	40715260	.	A	G	19	21	40	0	5	45	0	0
20	40716899	.	G	A	16	22	38	0	2	40	0	0
20	40716911	.	A	G	21	18	39	0	1	40	0	0
20	40717271	.	G	T	6	8	14	0	2	17	1	0
20	40717418	.	G	A	1	6	7	0	0	7	0	0
20	40762073	.	A	G	2	2	4	0	0	4	0	0
20	40762361	.	T	C	1	1	2	0	0	2	0	0
20	40764132	.	G	T	1	2	3	0	1	4	0	0
20	40819423	.	C	G	3	1	4	0	0	4	0	0
20	40835131	.	A	G	5	3	8	0	0	8	0	0
20	40840802	.	G	A	7	6	13	0	0	13	0	0
20	40840963	.	A	C	5	3	8	0	0	8	0	0
20	41236764	.	G	A	0	4	4	0	3	7	0	0
20	41237675	.	T	C	1	2	3	1	0	4	0	0
20	41237731	.	G	A	3	2	5	0	1	6	0	0
20	41238473	.	T	A	5	2	7	0	0	7	0	0
20	41239038	.	T	C	3	3	6	0	0	6	0	0
20	41239110	.	G	A	0	3	3	0	3	6	0	0
20	41239396	.	T	A	8	4	12	0	1	14	1	0
20	41239399	.	A	G	8	5	13	0	1	14	0	0
20	41239439	.	T	C	6	7	13	0	2	15	0	0
20	41239461	.	C	T	5	8	13	0	1	14	0	0
20	41239604	.	C	T	11	6	17	0	0	17	0	0
20	41239624	.	G	A	11	8	19	0	0	19	0	0
20	41239753	.	G	T	0	13	13	0	6	19	0	0
20	41239760	.	G	A	0	12	12	0	7	19	0	0
20	41239838	.	A	G	2	9	11	0	0	11	0	0
20	41239899	.	G	T	4	4	8	0	0	8	0	0
20	41239916	.	A	T	4	3	7	0	0	7	0	0
20	41239946	.	A	G	4	6	10	0	0	10	0	0
20	41239977	.	T	C	3	4	7	0	0	7	0	0
20	41239992	.	T	C	3	3	6	0	0	6	0	0
20	41240107	.	G	C	3	12	15	0	0	15	0	0
20	41240108	.	A	G	3	0	3	0	12	15	0	0
20	41240148	.	A	G	5	0	5	0	7	12	0	0
20	41240176	.	C	T	8	0	8	0	0	10	2	0
20	41240480	.	A	G	4	1	5	0	11	16	0	0
20	41240512	.	A	C	3	13	16	0	0	16	0	0
20	41240643	.	G	A	0	3	3	0	5	8	0	0
20	41240736	.	T	C	6	6	12	0	1	13	0	0
20	41240958	.	A	G	9	15	24	0	0	24	0	0
20	41240986	.	A	G	9	1	10	0	15	25	0	0
20	41241316	.	G	C	7	1	8	0	0	8	0	0
20	41241350	.	C	A	8	6	14	0	0	14	0	0
20	41241355	.	C	T	7	8	15	0	0	15	0	0
20	41241443	.	A	C	8	3	11	0	1	12	0	0
20	41242045	.	G	A	0	11	11	0	18	29	0	0
20	41640701	.	A	C	4	4	8	0	0	8	0	0
20	41640743	.	G	A	7	9	16	0	1	17	0	0
20	41640878	.	T	G	5	13	18	0	0	18	0	0
20	41640903	.	T	C	5	9	14	0	1	15	0	0
20	41640917	.	A	G	3	9	12	0	2	14	0	0
20	41641019	.	A	T	5	11	16	0	0	16	0	0
20	41643457	.	C	T	5	7	12	0	0	12	0	0
20	41651639	.	C	T	2	2	4	0	1	5	0	0
20	41674544	.	C	T	0	0	0	0	3	3	0	0
20	41689967	.	A	G	13	9	22	0	0	22	0	0
20	41689979	.	C	T	8	9	17	0	2	19	0	0
20	41734344	.	C	T	5	11	16	0	1	17	0	0
20	41757835	.	A	G	14	13	27	0	1	28	0	0
20	41765105	.	T	C	6	10	16	0	1	17	0	0
20	41838958	.	C	T	3	1	4	0	0	4	0	0
20	41838965	.	G	A	0	1	1	0	2	3	0	0
20	41911863	.	A	C	1	2	3	0	0	3	0	0
20	41946745	.	A	G	0	1	1	0	0	1	0	0
20	41949408	.	G	A	3	7	10	0	0	10	0	0
20	41949432	.	C	T	3	5	8	0	0	8	0	0
20	41961043	.	G	A	3	2	5	0	0	5	0	0
20	41961076	.	G	A	3	3	6	0	0	6	0	0
20	41961113	.	C	T	2	3	5	0	0	5	0	0
20	41961283	.	A	G	1	1	2	0	1	3	0	0
20	41961287	.	T	C	1	2	3	0	0	3	0	0
20	41961779	.	C	T	2	4	6	0	0	6	0	0
20	41961909	.	A	T	5	3	8	0	0	8	0	0
20	41961978	.	G	T	3	3	6	0	0	6	0	0
20	41962523	.	A	G	0	0	0	0	2	2	0	0
20	41962677	.	C	G	4	0	4	0	4	8	0	0
20	41962872	.	A	G	4	8	12	0	0	12	0	0
20	41963188	.	G	A	2	4	6	0	0	6	0	0
20	41963398	.	T	G	4	4	8	0	0	8	0	0
20	41963451	.	G	A	0	9	9	0	8	17	0	0
20	41963530	.	A	G	7	7	14	0	0	14	0	0
20	41963652	.	C	T	9	3	12	0	1	13	0	0
20	41963660	.	C	T	8	1	9	0	2	11	0	0
20	41998601	.	C	G	8	10	18	0	2	20	0	0
20	41999025	.	C	A	14	10	24	0	4	28	0	0
20	41999046	.	G	A	15	10	25	0	1	26	0	0
20	41999106	.	A	G	14	15	29	0	0	29	0	0
20	42047386	.	C	T	0	3	3	0	0	3	0	0
20	42049122	.	G	A	1	2	3	0	0	3	0	0
20	42049131	.	G	A	0	1	1	0	0	1	0	0
20	42221269	.	T	C	7	6	13	0	0	13	0	0
20	42221438	.	C	A	7	5	12	0	0	12	0	0
20	42221439	.	A	T	7	5	12	0	0	12	0	0
20	42221710	.	C	T	13	10	23	0	3	26	0	0
20	42222113	.	A	G	6	3	9	0	0	9	0	0
20	42222480	.	C	T	5	7	12	0	0	12	0	0
20	42222546	.	A	T	4	7	11	0	0	11	0	0
20	42222549	.	A	T	3	7	10	0	0	10	0	0
20	42222769	.	T	C	13	4	17	0	0	17	0	0
20	42222770	.	T	C	5	12	17	0	0	17	0	0
20	42222823	.	T	A	8	4	12	0	0	12	0	0
20	42222824	.	A	T	8	4	12	0	0	12	0	0
20	42222883	.	T	C	6	3	9	0	3	12	0	0
20	42223350	.	A	T	5	2	7	1	0	8	0	0
20	42223480	.	A	T	6	3	9	0	2	11	0	0
20	42232554	.	A	G	0	7	7	0	0	7	0	0
20	42241224	.	T	G	7	4	11	0	1	12	0	0
20	42241254	.	A	T	3	7	10	0	0	10	0	0
20	42246990	.	C	T	2	2	4	0	0	4	0	0
20	42247018	.	G	C	1	2	3	0	0	3	0	0
20	42247048	.	G	A	1	2	3	0	0	3	0	0
20	42247180	.	T	C	1	3	4	0	0	4	0	0
20	42247231	.	G	A	1	2	3	0	1	4	0	0
20	42275414	.	C	T	7	7	14	0	0	14	0	0
20	42278043	.	C	T	4	7	11	0	1	12	0	0
20	42281068	.	C	T	4	6	10	0	0	10	0	0
20	42281408	.	G	A	0	4	4	0	11	15	0	0
20	42660491	.	G	T	4	2	6	0	1	7	0	0
20	43120256	.	T	G	9	6	15	1	3	19	0	0
20	43122921	.	G	T	2	15	17	0	1	18	0	0
20	43122925	.	T	G	2	17	19	0	0	19	0	0
20	44373013	.	T	C	10	3	13	0	1	14	0	0
20	44373025	.	T	C	6	12	18	0	0	18	0	0
20	44373112	.	T	C	12	8	20	0	2	22	0	0
20	44373117	.	T	C	10	6	16	0	3	19	0	0
20	45644152	.	G	C	6	1	7	0	0	7	0	0
20	45644163	.	G	T	8	3	11	0	0	11	0	0
20	47942651	.	A	G	0	6	6	0	0	6	0	0
20	48039634	.	A	G	4	2	6	0	0	6	0	0
20	48043220	.	G	A	1	1	2	0	0	2	0	0
20	48483088	.	A	C	6	3	9	2	1	12	0	0
20	48483184	.	T	A	4	7	11	0	1	12	0	0
20	48483921	.	C	G	11	6	17	0	0	17	0	0
20	48483989	.	A	T	4	7	11	0	0	11	0	0
20	48484411	.	A	C	6	1	7	0	9	16	0	0
20	48490177	.	A	G	1	0	1	0	1	2	0	0
20	48598493	.	C	T	1	1	2	0	0	2	0	0
20	48844050	.	T	C	2	0	2	0	5	7	0	0
20	48844134	.	A	G	4	6	10	0	0	10	0	0
20	48844259	.	G	T	1	0	1	0	0	1	0	0
20	48844295	.	C	T	0	0	0	0	1	1	0	0
20	48860755	.	G	A	1	3	4	0	0	4	0	0
20	48869895	.	G	A	1	4	5	0	0	5	0	0
20	48886005	.	C	T	1	0	1	0	0	1	0	0
20	48895103	.	G	A	0	3	3	0	0	3	0	0
20	49082581	.	C	T	2	2	4	0	0	4	0	0
20	49085648	.	G	A	4	3	7	0	0	7	0	0
20	49087816	.	G	T	0	2	2	0	0	2	0	0
20	49094970	.	C	T	0	1	1	0	0	1	0	0
20	49094973	.	T	C	0	1	1	0	0	1	0	0
20	49099900	.	A	G	5	0	5	0	0	5	0	0
20	49100237	.	C	T	4	8	12	0	2	14	0	0
20	49103131	.	G	A	12	6	18	0	0	18	0	0
20	49103164	.	G	A	5	6	11	0	0	11	0	0
20	49103217	.	A	T	3	6	9	0	0	9	0	0
20	49105469	.	A	T	3	4	7	0	0	7	0	0
20	49902337	.	A	G	0	2	2	0	0	2	0	0
20	49916653	.	T	C	1	3	4	0	0	4	0	0
20	49928292	.	C	A	4	5	9	0	0	9	0	0
20	49928295	.	A	G	4	1	5	0	4	9	0	0
20	49940895	.	G	A	6	3	9	0	0	9	0	0
20	49952738	.	A	G	9	3	12	0	0	12	0	0
20	49959810	.	T	A	1	2	3	0	0	3	0	0
20	49960314	.	A	G	5	6	11	0	0	11	0	0
20	49960328	.	A	G	6	6	12	0	0	12	0	0
20	50015754	.	C	T	1	4	5	0	0	5	0	0
20	50037402	.	T	G	6	0	6	0	10	16	0	0
20	50041707	.	A	G	3	3	6	0	0	6	0	0
20	50049036	.	G	C	30	0	30	0	26	56	0	0
20	50049078	.	C	A	13	9	22	0	2	24	0	0
20	50057348	.	C	T	2	3	5	0	0	5	0	0
20	50074077	.	C	T	3	2	5	0	0	5	0	0
20	50074173	.	C	T	3	6	9	0	0	9	0	0
20	50074212	.	C	T	1	2	3	0	0	3	0	0
20	50076480	.	G	A	0	4	4	0	2	6	0	0
20	50079019	.	C	G	5	3	8	0	1	9	0	0
20	50079067	.	T	C	7	3	10	0	0	10	0	0
20	50079070	.	A	G	7	3	10	0	0	10	0	0
20	50079154	.	T	C	2	0	2	0	1	3	0	0
20	50082425	.	A	G	6	7	13	0	0	13	0	0
20	50082861	.	T	C	2	5	7	0	0	7	0	0
20	50085935	.	T	A	6	3	9	0	0	9	0	0
20	50086483	.	T	C	1	2	3	0	0	3	0	0
20	50086493	.	T	C	0	2	2	0	0	2	0	0
20	50650253	.	G	A	0	5	5	0	5	10	0	0
20	50740230	.	G	T	1	5	6	0	2	8	0	0
20	50898883	.	T	C	0	1	1	0	0	1	0	0
20	50917646	.	T	C	1	3	4	0	0	4	0	0
20	50923848	.	G	A	12	7	19	0	0	19	0	0
20	50926695	.	G	A	1	7	8	0	6	14	0	0
20	50989199	.	A	G	8	0	8	0	6	14	0	0
20	50999024	.	C	G	21	26	47	0	4	51	0	0
20	51069864	.	A	G	7	0	7	0	11	18	0	0
20	51069996	.	T	C	6	6	12	0	0	12	0	0
20	51073369	.	A	T	3	9	12	0	0	12	0	0
20	51073449	.	G	A	1	8	9	0	12	21	0	0
20	51073670	.	A	T	7	5	12	0	0	12	0	0
20	51073692	.	G	A	9	11	20	0	0	20	0	0
20	51073730	.	G	A	10	13	23	0	1	24	0	0
20	51074463	.	T	C	1	4	5	0	0	5	0	0
20	51074535	.	C	T	1	4	5	0	0	5	0	0
20	51076420	.	C	A	1	2	3	0	0	3	0	0
20	51076424	.	T	C	1	2	3	0	0	3	0	0
20	51081265	.	A	G	1	0	1	0	1	2	0	0
20	51088802	.	A	T	32	31	63	0	3	66	0	0
20	51089054	.	T	C	21	25	46	0	0	46	0	0
20	51100498	.	T	C	14	5	19	0	1	20	0	0
20	51100562	.	A	G	28	14	42	0	2	44	0	0
20	51112184	.	C	T	3	4	7	0	2	9	0	0
20	51112208	.	C	T	7	11	18	0	0	18	0	0
20	51117661	.	A	C	6	8	14	0	0	14	0	0
20	51117664	.	G	A	7	6	13	0	1	14	0	0
20	51118227	.	A	G	5	0	5	0	9	14	0	0
20	51118281	.	C	A	27	26	53	0	2	56	1	0
20	51118314	.	T	C	14	16	30	0	2	32	0	0
20	51122939	.	C	T	21	10	31	0	1	32	0	0
20	51123088	.	C	T	13	19	32	0	2	34	0	0
20	51123109	.	G	C	22	12	34	0	1	35	0	0
20	51123229	.	C	T	6	2	8	0	0	8	0	0
20	51132127	.	C	G	6	6	12	0	0	12	0	0
20	51132284	.	A	G	22	15	37	0	2	39	0	0
20	51141284	.	C	T	0	11	11	0	14	25	0	0
20	51146152	.	T	G	10	6	16	0	0	16	0	0
20	51146153	.	G	A	6	9	15	0	1	16	0	0
20	51146194	.	A	G	7	1	8	0	0	8	0	0
20	51150029	.	G	T	7	5	12	0	2	14	0	0
20	51151647	.	G	A	1	0	1	0	0	1	0	0
20	51157010	.	T	G	3	2	5	0	0	5	0	0
20	51157061	.	C	T	1	14	15	0	9	24	0	0
20	51157082	.	T	C	11	12	23	0	1	24	0	0
20	51157109	.	C	T	12	12	24	0	0	24	0	0
20	51157204	.	G	A	8	7	15	0	0	15	0	0
20	51168502	.	T	C	6	5	11	0	0	11	0	0
20	51200015	.	C	T	28	33	61	0	4	65	0	0
20	51204759	.	C	T	12	16	28	0	4	32	0	0
20	51205691	.	T	G	8	12	20	0	1	21	0	0
20	51205745	.	G	A	38	45	83	0	5	88	0	0
20	51206976	.	C	A	39	31	70	0	5	75	0	0
20	51207030	.	C	T	40	33	73	0	1	74	0	0
20	51207051	.	G	A	42	31	73	0	2	75	0	0
20	51207609	.	C	A	3	4	7	0	2	9	0	0
20	51207672	.	C	T	34	37	71	0	1	72	0	0
20	51207726	.	C	T	46	36	82	0	5	87	0	0
20	51211455	.	G	A	15	29	44	0	40	84	0	0
20	51240121	.	C	G	0	1	1	0	2	3	0	0
20	51240130	.	T	G	0	1	1	0	0	1	0	0
20	51274609	.	C	T	0	5	5	0	4	9	0	0
20	51274618	.	G	T	4	4	8	0	1	9	0	0
20	51274693	.	C	T	4	3	7	0	0	7	0	0
20	51313049	.	C	T	7	10	17	0	0	17	0	0
20	51332232	.	A	C	2	0	2	0	0	2	0	0
20	51332239	.	C	T	2	2	4	0	0	4	0	0
20	51332296	.	A	G	1	3	4	0	1	5	0	0
20	51332731	.	T	C	1	3	4	0	0	4	0	0
20	51332818	.	C	T	2	2	4	0	1	5	0	0
20	51333118	.	A	T	1	3	4	0	0	4	0	0
20	51333238	.	T	C	1	2	3	0	0	3	0	0
20	51333283	.	T	A	2	1	3	0	1	4	0	0
20	51333410	.	T	C	2	4	6	0	0	6	0	0
20	51333835	.	C	T	1	3	4	0	0	4	0	0
20	51333840	.	A	G	1	3	4	0	0	4	0	0
20	51334081	.	G	A	4	3	7	0	1	8	0	0
20	51334434	.	G	A	2	2	4	0	0	4	0	0
20	51363902	.	C	T	0	9	9	0	10	19	0	0
20	51363926	.	A	T	12	8	20	0	0	20	0	0
20	51370329	.	C	T	13	14	27	0	1	28	0	0
20	51377075	.	C	T	3	0	3	0	2	5	0	0
20	51383472	.	G	A	3	1	4	0	0	4	0	0
20	51383706	.	C	T	0	8	8	0	9	17	0	0
20	51383804	.	C	G	6	7	13	0	1	14	0	0
20	51384072	.	C	T	0	1	1	0	1	2	0	0
20	51390501	.	T	C	3	1	4	0	0	4	0	0
20	51475644	.	C	T	5	2	7	0	0	7	0	0
20	51475650	.	G	A	4	2	6	0	0	6	0	0
20	51475935	.	T	G	1	5	6	0	0	6	0	0
20	51489485	.	A	C	1	2	3	0	0	3	0	0
20	51489645	.	T	G	2	2	4	0	0	4	0	0
20	51489705	.	A	G	1	2	3	0	0	3	0	0
20	51489862	.	A	G	2	2	4	0	0	4	0	0
20	51489866	.	G	A	2	2	4	0	0	4	0	0
20	51647988	.	A	T	10	5	15	0	1	16	0	0
20	51648072	.	A	G	4	5	9	0	0	9	0	0
20	51648156	.	T	C	5	8	13	0	1	14	0	0
20	51649830	.	C	A	0	6	6	0	3	9	0	0
20	51649884	.	C	G	0	3	3	0	3	6	0	0
20	51649887	.	A	G	3	3	6	0	0	6	0	0
20	51649935	.	G	A	3	2	5	0	0	5	0	0
20	51703406	.	T	C	4	7	11	0	2	13	0	0
20	51703445	.	C	T	0	1	1	0	0	1	0	0
20	51703939	.	G	A	19	7	26	0	1	27	0	0
20	51704001	.	C	T	3	0	3	0	0	3	0	0
20	51720465	.	A	G	1	0	1	0	1	2	0	0
20	51721612	.	A	G	1	1	2	0	0	2	0	0
20	51723187	.	G	T	2	4	6	0	0	6	0	0
20	51730662	.	T	G	3	3	6	0	0	6	0	0
20	51743891	.	T	C	2	0	2	0	0	2	0	0
20	51753384	.	A	T	5	10	15	1	0	16	0	0
20	51753509	.	G	A	0	7	7	0	9	16	0	0
20	51753562	.	C	T	5	5	10	0	0	10	0	0
20	51753617	.	C	G	4	10	14	0	0	14	0	0
20	51753655	.	C	A	5	3	8	0	0	8	0	0
20	51753657	.	T	C	5	3	8	0	0	8	0	0
20	51758602	.	A	C	15	8	23	0	0	23	0	0
20	51758975	.	A	G	11	10	21	0	0	21	0	0
20	51759191	.	A	C	10	5	15	0	1	16	0	0
20	51759272	.	G	A	12	4	16	0	1	17	0	0
20	51759273	.	T	A	10	5	15	0	2	17	0	0
20	51787380	.	A	G	0	6	6	0	0	6	0	0
20	51794071	.	A	G	2	0	2	0	0	2	0	0
20	51798112	.	T	C	2	5	7	0	0	7	0	0
20	51799052	.	G	A	2	3	5	0	0	5	0	0
20	51803856	.	G	T	3	4	7	0	0	7	0	0
20	51821286	.	G	T	1	3	4	0	0	4	0	0
20	52333070	.	A	G	3	2	5	0	1	6	0	0
20	52333177	.	T	C	2	1	3	0	10	13	0	0
20	52333202	.	T	C	2	12	14	0	2	16	0	0
20	52333344	.	A	G	4	7	11	0	0	11	0	0
20	52333388	.	A	G	4	7	11	0	1	12	0	0
20	52390271	.	T	C	1	2	3	0	0	3	0	0
20	52404347	.	G	A	3	2	5	0	0	5	0	0
20	52404387	.	T	A	3	3	6	0	0	6	0	0
20	52404398	.	T	C	3	2	5	0	0	5	0	0
20	52404554	.	A	G	2	0	2	0	6	8	0	0
20	52404578	.	C	T	3	3	6	0	0	6	0	0
20	52404722	.	T	C	1	4	5	0	0	5	0	0
20	52415876	.	T	C	3	2	5	0	1	6	0	0
20	52416080	.	C	T	2	4	6	0	1	7	0	0
20	52416107	.	C	T	1	3	4	0	0	4	0	0
20	52420015	.	T	G	3	0	3	0	6	9	0	0
20	52458788	.	C	G	3	2	5	0	0	5	0	0
20	52458831	.	A	T	6	3	9	0	0	9	0	0
20	52458987	.	G	T	1	0	1	0	0	1	0	0
20	52473266	.	C	T	2	2	4	0	1	5	0	0
20	52482448	.	G	A	6	6	12	0	0	12	0	0
20	52482484	.	T	C	1	1	2	0	0	2	0	0
20	52487851	.	C	T	2	6	8	0	0	8	0	0
20	52487948	.	T	C	1	3	4	0	0	4	0	0
20	52488003	.	A	C	2	4	6	0	0	6	0	0
20	52488226	.	A	T	4	3	7	0	0	7	0	0
20	52525145	.	C	G	1	2	3	0	0	3	0	0
20	52525157	.	C	T	1	2	3	0	0	3	0	0
20	52540721	.	A	G	1	4	5	0	1	6	0	0
20	52540928	.	C	T	3	2	5	0	1	6	0	0
20	52540946	.	T	A	2	4	6	0	0	6	0	0
20	52541076	.	T	A	1	2	3	0	0	3	0	0
20	52544394	.	G	T	0	7	7	0	6	13	0	0
20	52544491	.	A	C	7	8	15	0	0	15	0	0
20	52544559	.	T	C	8	9	17	0	0	17	0	0
20	52544612	.	G	T	6	2	8	0	0	8	0	0
20	52554222	.	G	A	23	16	39	0	1	40	0	0
20	52554283	.	C	T	11	28	39	0	1	40	0	0
20	52574813	.	G	A	1	18	19	0	20	39	0	0
20	52574900	.	G	A	0	25	25	0	33	58	0	0
20	52575020	.	A	G	19	1	20	0	30	50	0	0
20	52575377	.	T	C	12	20	32	0	3	35	0	0
20	52582594	.	A	T	9	6	15	0	1	16	0	0
20	53279543	.	C	T	1	3	4	0	0	4	0	0
20	53312604	.	G	T	8	8	16	0	1	17	0	0
20	53318814	.	G	T	6	9	15	0	1	16	0	0
20	53318884	.	C	T	0	2	2	0	0	2	0	0
20	53365862	.	C	T	3	4	7	0	0	7	0	0
20	53366073	.	A	C	1	5	6	0	0	6	0	0
20	53377661	.	A	G	1	0	1	0	2	3	0	0
20	53377691	.	G	A	1	2	3	0	0	3	0	0
20	53378919	.	T	G	3	1	4	0	4	8	0	0
20	53393594	.	T	C	2	3	5	0	0	5	0	0
20	53393669	.	C	A	5	5	10	0	0	10	0	0
20	53398784	.	T	A	6	12	18	0	1	19	0	0
20	53401771	.	T	C	13	6	19	0	0	19	0	0
20	53401778	.	A	G	12	5	17	0	1	18	0	0
20	53401887	.	T	C	3	3	6	0	0	6	0	0
20	53408532	.	G	A	1	2	3	0	0	3	0	0
20	53422244	.	G	T	0	1	1	0	0	1	0	0
20	53600883	.	G	A	1	2	3	0	0	3	0	0
20	53637818	.	C	T	0	3	3	0	0	3	0	0
20	53639358	.	C	T	1	5	6	0	0	6	0	0
20	53639391	.	C	G	1	4	5	0	0	5	0	0
20	53639462	.	T	C	1	3	4	0	0	4	0	0
20	53640199	.	A	T	2	0	2	0	0	2	0	0
20	53640200	.	T	C	2	0	2	0	0	2	0	0
20	53803637	.	C	T	6	5	11	0	1	12	0	0
20	53803783	.	T	A	9	12	21	0	1	22	0	0
20	53804306	.	A	G	4	12	16	0	1	17	0	0
20	53804342	.	A	G	7	7	14	0	1	15	0	0
20	53804470	.	G	A	6	5	11	0	0	11	0	0
20	53810197	.	A	T	21	12	33	0	0	33	0	0
20	53810395	.	G	A	10	3	13	0	2	15	0	0
20	53810419	.	A	G	6	5	11	0	1	12	0	0
20	53898735	.	T	A	18	12	30	0	4	34	0	0
20	53898770	.	C	T	1	13	14	0	22	36	0	0
20	53898930	.	G	A	3	15	18	0	0	18	0	0
20	53899023	.	G	C	8	24	32	0	2	34	0	0
20	53899035	.	G	A	7	23	30	0	2	32	0	0
20	53901183	.	A	G	1	5	6	0	1	7	0	0
20	53902151	.	G	A	5	5	10	0	0	10	0	0
20	53902155	.	G	C	4	5	9	0	0	9	0	0
20	53912151	.	T	C	3	1	4	0	8	12	0	0
20	53912208	.	C	T	0	6	6	0	0	6	0	0
20	53921147	.	T	C	1	3	4	0	0	4	0	0
20	53928363	.	T	C	1	0	1	0	0	1	0	0
20	53930457	.	G	A	0	2	2	0	1	3	0	0
20	53930466	.	C	T	0	2	2	0	0	2	0	0
20	53949741	.	A	G	1	2	3	0	0	3	0	0
20	53968105	.	A	G	28	25	53	0	1	54	0	0
20	54067639	.	G	A	7	15	22	0	0	22	0	0
20	54067714	.	A	G	8	7	15	0	0	15	0	0
20	54067908	.	G	A	5	3	8	0	0	8	0	0
20	54175443	.	C	T	6	2	8	0	0	8	0	0
20	54197221	.	A	C	18	1	19	0	16	35	0	0
20	54197287	.	A	T	12	31	43	0	0	43	0	0
20	54197383	.	G	A	7	14	21	0	0	21	0	0
20	54197473	.	A	G	16	18	34	0	1	35	0	0
20	54197485	.	C	T	0	16	16	0	16	32	0	0
20	54197751	.	A	G	12	13	25	0	2	27	0	0
20	54197752	.	G	A	12	15	27	0	0	27	0	0
20	54205704	.	C	T	8	8	16	0	2	18	0	0
20	54215073	.	C	A	5	10	15	0	3	18	0	0
20	54215081	.	T	C	8	0	8	0	10	18	0	0
20	54215133	.	A	C	13	16	29	0	0	30	1	0
20	54219286	.	T	C	2	0	2	0	2	4	0	0
20	54228003	.	A	T	14	20	34	0	0	34	0	0
20	54233207	.	T	C	2	0	2	0	2	4	0	0
20	54235969	.	G	A	5	5	10	0	1	11	0	0
20	54236421	.	A	C	2	1	3	0	0	3	0	0
20	54236423	.	G	A	2	1	3	0	0	3	0	0
20	54249577	.	G	C	8	10	18	0	0	18	0	0
20	54251406	.	T	C	7	4	11	0	2	13	0	0
20	54274561	.	G	A	9	6	15	0	1	16	0	0
20	54278129	.	T	A	1	3	4	0	0	4	0	0
20	54283833	.	T	C	1	3	4	0	1	5	0	0
20	54284869	.	A	G	4	1	5	0	12	17	0	0
20	54284986	.	A	G	15	20	35	0	2	37	0	0
20	54285758	.	T	C	21	25	46	0	3	49	0	0
20	54285799	.	C	T	13	27	40	0	2	42	0	0
20	54285804	.	C	T	14	29	43	0	1	44	0	0
20	54285853	.	A	T	21	12	33	0	0	33	0	0
20	54286016	.	G	A	23	11	34	0	2	36	0	0
20	54286097	.	A	T	27	13	40	0	0	40	0	0
20	54286454	.	C	A	11	14	25	0	2	27	0	0
20	54286666	.	C	T	15	13	28	0	2	30	0	0
20	54286682	.	G	A	17	10	27	0	4	31	0	0
20	54286797	.	G	T	7	6	13	0	1	14	0	0
20	54286798	.	A	G	6	7	13	0	1	14	0	0
20	54334478	.	C	T	5	4	9	0	0	9	0	0
20	54340285	.	C	T	10	4	14	0	0	14	0	0
20	54340700	.	T	C	2	4	6	0	0	6	0	0
20	54340865	.	C	T	2	4	6	0	0	6	0	0
20	54341082	.	A	C	4	5	9	0	0	9	0	0
20	54341108	.	G	T	0	4	4	0	4	8	0	0
20	54341130	.	C	T	6	3	9	0	0	9	0	0
20	54341154	.	A	G	5	5	10	0	0	10	0	0
20	54341203	.	T	A	5	5	10	0	0	10	0	0
20	54341643	.	A	G	7	3	10	0	0	10	0	0
20	54341644	.	T	A	7	3	10	0	0	10	0	0
20	54341950	.	T	C	2	5	7	0	1	8	0	0
20	54342530	.	G	T	1	0	1	0	0	1	0	0
20	54342589	.	A	T	4	3	7	0	0	7	0	0
20	54342674	.	T	C	1	6	7	0	3	10	0	0
20	54342715	.	C	T	1	6	7	0	0	7	0	0
20	54343566	.	G	C	0	9	9	0	11	20	0	0
20	54343639	.	C	A	3	2	5	0	0	5	0	0
20	54343682	.	T	C	3	4	7	0	0	7	0	0
20	54343695	.	A	T	2	8	10	0	0	10	0	0
20	54343866	.	G	A	7	5	12	0	2	14	0	0
20	54343928	.	A	G	6	4	10	0	0	10	0	0
20	54344711	.	A	G	9	0	9	0	7	16	0	0
20	54344748	.	T	C	13	12	25	0	1	26	0	0
20	54344795	.	G	A	8	12	20	0	0	20	0	0
20	54344815	.	G	T	4	11	15	0	1	16	0	0
20	54344910	.	C	T	7	7	14	0	1	15	0	0
20	54345955	.	A	T	13	9	22	0	1	23	0	0
20	54345979	.	A	G	15	13	28	0	0	28	0	0
20	54346012	.	G	C	0	6	6	0	13	24	5	0
20	54346124	.	A	T	16	6	22	0	0	23	1	0
20	54346159	.	G	T	0	11	11	0	19	30	0	0
20	54346178	.	G	T	18	14	32	0	0	32	0	0
20	54346239	.	A	G	9	13	22	0	0	22	0	0
20	54356452	.	G	C	9	7	16	0	0	16	0	0
20	54357955	.	C	T	8	5	13	0	1	14	0	0
20	54358656	.	T	C	1	3	4	0	0	4	0	0
20	54360143	.	G	A	3	3	6	0	0	6	0	0
20	54360148	.	G	T	0	2	2	0	3	5	0	0
20	54397812	.	T	C	2	4	6	0	0	6	0	0
20	54397846	.	A	G	7	0	7	0	5	12	0	0
20	54397897	.	G	C	11	8	19	0	1	20	0	0
20	54398242	.	C	T	10	10	20	0	1	21	0	0
20	54398380	.	T	A	7	9	16	0	1	17	0	0
20	54398443	.	A	G	5	4	9	0	0	9	0	0
20	54402157	.	G	T	0	9	9	0	18	27	0	0
20	54402346	.	G	A	10	12	22	0	0	22	0	0
20	54402489	.	G	A	17	14	31	0	1	32	0	0
20	54406699	.	A	T	11	14	25	0	3	28	0	0
20	54406813	.	A	G	12	9	21	0	2	23	0	0
20	54407401	.	G	C	17	19	36	0	1	37	0	0
20	54407456	.	T	C	17	13	30	0	2	32	0	0
20	54407556	.	C	T	6	8	14	0	1	15	0	0
20	54422636	.	G	A	17	15	32	0	1	33	0	0
20	54422780	.	C	G	15	12	27	0	1	28	0	0
20	54422909	.	C	T	9	21	30	0	1	31	0	0
20	54422929	.	G	A	7	22	29	0	2	31	0	0
20	54423027	.	C	G	15	14	29	0	0	29	0	0
20	54423065	.	T	C	18	5	23	0	3	26	0	0
20	54428696	.	A	G	2	1	3	0	1	4	0	0
20	54432835	.	T	C	7	0	7	0	13	20	0	0
20	54432855	.	T	C	5	0	5	0	7	12	0	0
20	54434895	.	G	A	15	18	33	0	1	34	0	0
20	54434918	.	C	T	16	11	27	0	2	29	0	0
20	54446877	.	G	A	12	10	22	0	1	23	0	0
20	54462151	.	G	C	4	9	13	0	0	13	0	0
20	54525439	.	T	C	5	5	10	0	1	11	0	0
20	54563425	.	A	G	13	5	18	0	1	19	0	0
20	54670746	.	T	C	0	1	1	0	0	1	0	0
20	54670966	.	A	G	1	3	4	0	2	6	0	0
20	54670984	.	T	A	2	2	4	0	1	5	0	0
20	54671032	.	A	C	1	6	7	0	1	8	0	0
20	54671864	.	T	G	3	4	7	0	0	7	0	0
20	54671989	.	G	A	0	2	2	0	0	2	0	0
20	54672839	.	A	G	4	0	4	0	3	7	0	0
20	54672869	.	T	C	6	1	7	0	1	8	0	0
20	54672891	.	T	C	6	3	9	0	0	9	0	0
20	54672974	.	G	A	0	10	10	0	6	16	0	0
20	54673175	.	T	C	6	7	13	0	2	15	0	0
20	54673198	.	T	A	6	6	12	0	1	13	0	0
20	54675294	.	T	C	4	9	13	0	1	14	0	0
20	54675308	.	C	G	7	0	7	0	9	16	0	0
20	54675356	.	C	T	7	9	16	0	0	16	0	0
20	54675391	.	T	C	1	5	6	0	2	8	0	0
20	54676529	.	A	G	6	0	6	0	14	20	0	0
20	54676532	.	T	G	7	12	19	0	1	20	0	0
20	54681734	.	G	A	4	10	14	0	0	14	0	0
20	54681797	.	T	A	4	8	12	0	3	15	0	0
20	54681944	.	A	T	8	2	10	0	0	10	0	0
20	54698791	.	C	T	10	4	14	0	0	14	0	0
20	54699133	.	C	T	10	7	17	0	1	18	0	0
20	54708193	.	T	C	11	10	21	0	0	21	0	0
20	54711535	.	G	C	1	8	9	0	2	11	0	0
20	54738249	.	C	G	5	3	8	0	0	8	0	0
20	54740904	.	G	A	19	11	30	0	1	31	0	0
20	54740907	.	A	G	19	0	19	0	14	33	0	0
20	54740955	.	C	T	17	11	28	0	0	28	0	0
20	54740976	.	G	T	2	13	15	0	13	28	0	0
20	54741763	.	G	A	8	6	14	0	1	15	0	0
20	54742139	.	G	A	3	2	5	0	0	5	0	0
20	54742146	.	G	A	3	2	5	0	0	5	0	0
20	54742641	.	C	G	14	8	22	0	1	23	0	0
20	54742912	.	A	C	7	14	21	0	2	23	0	0
20	54743851	.	T	G	27	21	48	0	2	50	0	0
20	54743917	.	G	A	24	10	34	0	1	35	0	0
20	54744230	.	C	T	15	22	37	0	1	38	0	0
20	54744314	.	A	G	13	4	17	0	26	43	0	0
20	54744363	.	A	G	15	1	16	0	25	41	0	0
20	54744419	.	A	G	18	23	41	0	4	45	0	0
21	18055	.	A	T	4	8	12	0	7	19	0	0
21	18057	.	T	A	2	11	13	0	6	19	0	0
21	18176	.	G	A	7	3	10	0	0	10	0	0
21	40609	.	T	C	14	13	27	0	0	27	0	0
21	41914	.	A	G	3	6	9	0	0	9	0	0
21	103308	.	T	C	4	3	7	0	0	7	0	0
21	103962	.	C	T	4	5	9	0	0	9	0	0
21	104046	.	T	C	2	6	8	0	1	9	0	0
21	104316	.	A	T	1	2	3	0	0	3	0	0
21	112730	.	C	A	2	5	7	0	1	8	0	0
21	170052	.	C	A	2	0	2	0	1	3	0	0
21	170842	.	C	G	2	2	4	0	0	4	0	0
21	170896	.	A	C	3	5	8	0	1	9	0	0
21	170916	.	T	C	3	5	8	0	0	8	0	0
21	171853	.	A	G	3	0	3	0	8	11	0	0
21	173536	.	A	G	2	6	8	0	0	8	0	0
21	173545	.	T	C	5	7	12	0	0	12	0	0
21	178193	.	T	A	4	12	16	0	0	16	0	0
21	178227	.	G	A	0	12	12	0	8	20	0	0
21	178247	.	G	T	4	14	18	0	1	19	0	0
21	178559	.	T	C	5	9	14	0	2	16	0	0
21	178697	.	A	T	2	5	7	0	2	9	0	0
21	178703	.	A	T	2	2	4	0	4	8	0	0
21	201649	.	A	G	2	2	4	0	0	4	0	0
21	217974	.	T	C	12	8	20	0	1	21	0	0
21	218795	.	A	G	3	7	10	0	0	10	0	0
21	219250	.	C	T	2	9	11	0	3	14	0	0
21	219259	.	T	C	2	1	3	0	7	10	0	0
21	233123	.	G	C	11	18	29	0	0	29	0	0
21	237246	.	G	C	4	1	5	0	0	5	0	0
21	240046	.	A	G	1	1	2	0	2	4	0	0
21	243053	.	C	G	3	7	10	0	0	10	0	0
21	245641	.	G	A	0	1	1	0	1	2	0	0
21	248156	.	C	G	13	7	20	0	1	21	0	0
21	248284	.	A	C	3	2	5	0	0	5	0	0
21	248286	.	A	C	3	2	5	0	0	5	0	0
21	252150	.	G	A	2	4	6	0	0	6	0	0
21	259559	.	A	G	2	0	2	0	0	2	0	0
21	261182	.	A	G	5	0	5	0	5	10	0	0
21	262572	.	C	G	7	1	8	0	0	8	0	0
21	266087	.	T	A	3	4	7	0	0	7	0	0
21	266195	.	A	G	5	0	5	0	4	9	0	0
21	267453	.	C	G	2	0	2	0	1	3	0	0
21	267717	.	T	C	3	1	4	0	0	4	0	0
21	269053	.	G	C	0	16	16	0	10	26	0	0
21	269057	.	G	A	9	14	23	0	2	25	0	0
21	269117	.	T	C	8	12	20	0	0	20	0	0
21	269328	.	G	A	0	8	8	0	6	14	0	0
21	269348	.	A	G	6	7	13	0	0	13	0	0
21	269391	.	G	A	4	5	9	0	0	9	0	0
21	269471	.	G	C	2	4	6	0	0	6	0	0
21	269634	.	T	C	8	6	14	0	0	14	0	0
21	269676	.	C	T	9	4	13	0	1	14	0	0
21	269693	.	A	T	11	3	14	0	2	16	0	0
21	269727	.	C	T	10	5	15	0	0	15	0	0
21	272086	.	G	A	4	5	9	0	0	9	0	0
21	278952	.	T	C	1	0	1	0	1	2	0	0
21	278977	.	C	G	1	2	3	0	0	3	0	0
21	301298	.	G	A	10	6	16	0	0	16	0	0
21	303310	.	G	A	5	3	8	0	0	8	0	0
21	350020	.	C	T	4	4	8	0	0	8	0	0
21	350728	.	T	C	1	3	4	0	1	5	0	0
21	350740	.	C	T	1	4	5	0	0	5	0	0
21	350902	.	G	A	2	3	5	0	0	5	0	0
21	363753	.	T	C	2	3	5	0	0	5	0	0
21	363795	.	T	C	0	2	2	0	0	2	0	0
21	370856	.	C	T	2	2	4	0	0	4	0	0
21	382570	.	T	G	9	0	9	0	16	25	0	0
21	409978	.	G	A	0	10	10	0	11	21	0	0
21	409986	.	G	A	9	11	20	0	1	21	0	0
21	410025	.	T	A	4	10	14	0	0	14	0	0
21	410139	.	A	G	10	7	17	0	0	17	0	0
21	410268	.	A	G	6	7	13	0	0	13	0	0
21	410281	.	C	T	4	6	10	0	2	12	0	0
21	410320	.	T	G	7	2	9	0	0	9	0	0
21	419903	.	T	C	2	0	2	0	1	3	0	0
21	426623	.	C	T	1	3	4	0	0	4	0	0
21	426626	.	G	A	1	2	3	0	1	4	0	0
21	520628	.	G	A	6	4	10	0	0	10	0	0
21	522633	.	A	T	5	2	7	0	0	7	0	0
21	522926	.	A	G	2	5	7	0	1	8	0	0
21	527570	.	A	T	2	3	5	0	1	6	0	0
21	734962	.	A	G	9	0	9	0	20	29	0	0
21	735222	.	A	G	26	1	27	0	33	60	0	0
21	1781035	.	T	C	3	0	3	0	2	5	0	0
21	3302296	.	A	G	0	0	0	0	1	1	0	0
21	3422565	.	T	G	3	6	9	0	2	11	0	0
21	3452462	.	A	G	5	5	10	0	0	11	1	0
21	3478014	.	A	G	5	5	10	0	0	10	0	0
21	3485351	.	T	C	7	0	7	0	8	15	0	0
21	3536113	.	A	C	0	2	2	0	0	2	0	0
21	3536116	.	G	A	0	2	2	0	0	2	0	0
21	3536597	.	C	T	0	1	1	0	2	3	0	0
21	3539275	.	C	T	1	3	4	0	1	5	0	0
21	3567722	.	A	G	2	5	7	0	1	8	0	0
21	3613551	.	G	A	2	2	4	0	2	6	0	0
21	3715950	.	A	G	11	9	20	0	1	21	0	0
21	3715986	.	T	A	12	8	20	0	1	21	0	0
21	3715989	.	A	G	11	9	20	0	1	21	0	0
21	3716058	.	T	A	8	13	21	0	0	21	0	0
21	3716732	.	G	T	13	18	31	0	1	32	0	0
21	3716845	.	G	A	2	8	10	0	5	15	0	0
21	3716846	.	A	T	1	7	8	0	7	15	0	0
21	3716930	.	G	A	15	19	34	0	2	36	0	0
21	3717055	.	G	A	13	16	29	0	1	30	0	0
21	3717505	.	T	C	1	0	1	0	1	2	0	0
21	3738181	.	C	T	0	2	2	0	2	4	0	0
21	3785401	.	C	T	1	2	3	0	0	3	0	0
21	3786377	.	C	T	7	6	13	0	0	13	0	0
21	3787070	.	G	C	4	6	10	0	0	10	0	0
21	3787071	.	A	C	4	6	10	0	0	10	0	0
21	3789922	.	T	A	9	8	17	0	2	19	0	0
21	3789930	.	C	T	11	10	21	0	1	22	0	0
21	3789998	.	A	G	18	21	39	0	3	42	0	0
21	3793211	.	G	A	5	3	8	0	1	9	0	0
21	3793309	.	T	C	2	1	3	0	0	3	0	0
21	3793413	.	C	T	28	24	52	0	0	52	0	0
21	3796376	.	G	T	13	16	29	0	0	29	0	0
21	3796398	.	G	T	9	7	16	0	2	18	0	0
21	3797577	.	A	T	2	2	4	0	0	4	0	0
21	3801868	.	C	T	1	0	1	0	0	1	0	0
21	3801871	.	C	T	1	0	1	0	0	1	0	0
21	3803384	.	C	T	1	0	1	0	0	1	0	0
21	3822666	.	T	C	3	0	3	0	4	7	0	0
21	3822827	.	T	G	2	5	7	0	0	7	0	0
21	3822841	.	A	T	5	5	10	0	0	10	0	0
21	3822896	.	T	C	5	0	5	0	3	8	0	0
21	3825019	.	T	A	4	5	9	0	0	9	0	0
21	3841327	.	C	T	1	2	3	0	1	4	0	0
21	3844113	.	G	A	1	4	5	0	0	5	0	0
21	3866706	.	A	G	0	0	0	0	2	2	0	0
21	3880834	.	C	A	2	2	4	0	1	5	0	0
21	3880885	.	G	A	0	3	3	0	0	3	0	0
21	3881003	.	G	A	2	2	4	0	1	5	0	0
21	3881105	.	C	T	1	2	3	0	0	3	0	0
21	3917912	.	C	A	9	4	13	0	1	14	0	0
21	3918006	.	A	G	4	10	14	0	0	14	0	0
21	3918186	.	G	A	9	9	18	0	0	18	0	0
21	3918288	.	T	A	1	3	4	0	0	4	0	0
21	3955445	.	G	A	1	3	4	0	0	4	0	0
21	3972766	.	G	A	4	8	12	0	0	12	0	0
21	3995529	.	A	G	3	2	5	0	0	5	0	0
21	4116559	.	T	C	2	2	4	0	0	4	0	0
21	4188269	.	A	G	0	3	3	0	2	5	0	0
21	4188272	.	G	C	2	3	5	0	0	5	0	0
21	4219400	.	T	A	2	5	7	0	0	7	0	0
21	4227350	.	A	C	5	0	5	2	3	10	0	0
21	4227387	.	C	G	10	5	15	0	0	15	0	0
21	4227392	.	T	A	8	5	13	0	0	13	0	0
21	4227433	.	T	G	2	3	5	0	0	5	0	0
21	4227788	.	G	A	10	10	20	0	1	21	0	0
21	4228026	.	G	A	7	10	17	0	0	17	0	0
21	4232774	.	A	G	0	1	1	0	0	1	0	0
21	4237466	.	T	A	2	1	3	0	0	3	0	0
21	4237496	.	C	T	0	0	0	0	1	1	0	0
21	4240121	.	T	C	1	0	1	0	0	1	0	0
21	4244348	.	T	A	6	11	17	0	0	17	0	0
21	4244377	.	C	G	4	11	15	0	0	15	0	0
21	4250360	.	T	C	6	3	9	0	0	9	0	0
21	4250401	.	C	T	11	5	16	0	0	16	0	0
21	4250583	.	C	A	4	8	12	0	1	13	0	0
21	4250596	.	C	T	0	6	6	0	6	12	0	0
21	4304262	.	A	G	1	2	3	0	0	3	0	0
21	4304822	.	G	A	0	6	6	0	0	6	0	0
21	4304848	.	C	T	2	3	5	0	0	5	0	0
21	4534186	.	T	C	2	3	5	0	0	5	0	0
21	4571398	.	T	C	0	0	0	0	1	1	0	0
21	4576310	.	G	C	1	3	4	0	0	4	0	0
21	4576319	.	G	C	0	3	3	0	1	4	0	0
21	4578137	.	G	A	0	1	1	0	1	2	0	0
21	4578352	.	G	T	0	2	2	0	1	3	0	0
21	4578428	.	C	A	3	6	9	0	0	9	0	0
21	4578520	.	T	C	0	1	1	0	0	1	0	0
21	4585012	.	A	C	0	1	1	0	0	1	0	0
21	4585027	.	A	G	0	0	0	0	1	1	0	0
21	4585189	.	C	A	3	0	3	0	0	3	0	0
21	4589826	.	A	G	1	5	6	0	0	6	0	0
21	4591407	.	C	G	2	5	7	0	0	7	0	0
21	4591410	.	A	T	2	5	7	0	0	7	0	0
21	4591443	.	A	G	1	2	3	0	1	4	0	0
21	4592959	.	T	C	1	2	3	0	0	3	0	0
21	4592984	.	A	G	1	2	3	0	0	3	0	0
21	4593008	.	A	T	1	1	2	0	1	3	0	0
21	4596883	.	G	T	9	6	15	0	1	16	0	0
21	4596970	.	A	G	4	7	11	0	0	11	0	0
21	4603372	.	C	T	3	6	9	0	0	9	0	0
21	4653403	.	C	T	2	3	5	0	0	5	0	0
21	4653421	.	G	A	2	3	5	0	0	5	0	0
21	4656793	.	A	T	0	3	3	0	0	3	0	0
21	4667092	.	C	T	1	1	2	0	0	2	0	0
21	4679623	.	T	C	1	2	3	0	0	3	0	0
21	4712743	.	A	G	4	3	7	0	0	7	0	0
21	4712756	.	T	C	3	0	3	0	4	7	0	0
21	4713252	.	T	C	7	0	7	0	20	27	0	0
21	4718518	.	G	A	10	7	17	0	0	17	0	0
21	4720325	.	C	T	3	4	7	0	1	8	0	0
21	4723670	.	G	A	13	10	23	0	1	24	0	0
21	4724351	.	C	T	0	5	5	0	3	8	0	0
21	4724428	.	A	G	9	5	14	0	0	14	0	0
21	4724564	.	G	A	10	4	14	0	1	15	0	0
21	4724810	.	T	C	2	6	8	0	0	8	0	0
21	4729876	.	G	A	0	4	4	0	0	4	0	0
21	4748802	.	G	C	4	3	7	0	0	7	0	0
21	5002800	.	T	C	3	3	6	0	0	6	0	0
21	5004771	.	C	T	0	3	3	0	0	3	0	0
21	5004779	.	T	A	1	2	3	0	0	3	0	0
21	5034791	.	G	A	3	2	5	0	1	6	0	0
21	5034793	.	A	C	3	3	6	0	0	6	0	0
21	5056600	.	T	C	1	0	1	0	2	3	0	0
21	5066371	.	A	G	3	6	9	0	0	9	0	0
21	5066417	.	T	C	1	0	1	0	4	5	0	0
21	5159695	.	T	C	0	1	1	0	0	1	0	0
21	5160219	.	T	C	9	3	12	0	1	13	0	0
21	5160428	.	G	A	2	3	5	0	0	5	0	0
21	5162305	.	T	A	3	6	9	0	0	9	0	0
21	5169217	.	T	A	17	16	33	0	1	34	0	0
21	5171036	.	C	T	28	30	58	0	0	58	0	0
21	5173402	.	T	G	11	2	13	0	12	25	0	0
21	5173447	.	C	T	30	27	57	0	1	58	0	0
21	5173638	.	T	C	19	14	33	3	1	37	0	0
21	5199875	.	G	A	10	6	16	0	0	16	0	0
21	5200683	.	C	T	24	17	41	0	3	44	0	0
21	5209585	.	A	G	6	0	6	0	9	15	0	0
21	5209666	.	C	T	3	10	13	0	0	13	0	0
21	5237137	.	G	A	4	5	9	0	0	9	0	0
21	5240259	.	C	T	16	9	25	0	0	25	0	0
21	7367374	.	C	A	1	2	3	0	0	3	0	0
21	7901070	.	T	G	1	1	2	0	5	7	0	0
21	7901072	.	T	G	1	0	1	0	6	7	0	0
21	8343954	.	T	C	3	5	8	0	0	8	0	0
21	8344326	.	T	C	6	19	25	0	2	28	1	0
21	8346125	.	T	C	5	6	11	0	0	11	0	0
21	8348920	.	G	A	0	15	15	0	8	23	0	0
21	8348959	.	T	C	14	17	31	0	0	32	1	0
21	8348980	.	A	G	11	9	20	0	0	20	0	0
21	8348998	.	T	C	6	4	10	0	3	13	0	0
21	8352010	.	T	A	12	10	22	0	1	24	1	0
21	8427115	.	G	A	0	3	3	0	4	7	0	0
21	9367272	.	A	T	1	1	2	0	0	2	0	0
21	9367281	.	A	G	1	2	3	0	0	3	0	0
21	9370684	.	C	T	0	1	1	0	2	3	0	0
21	9370780	.	G	A	2	0	2	0	0	2	0	0
21	9377080	.	G	A	0	2	2	0	0	2	0	0
21	9377107	.	T	C	0	0	0	0	1	1	0	0
21	9381158	.	G	A	1	0	1	0	0	1	0	0
21	9384281	.	C	G	4	2	6	0	0	6	0	0
21	9384316	.	T	C	3	2	5	0	0	5	0	0
21	9399918	.	G	C	0	1	1	0	0	1	0	0
21	9401182	.	T	A	1	0	1	0	0	1	0	0
21	9401191	.	C	T	0	0	0	0	1	1	0	0
21	9406459	.	C	T	0	3	3	0	3	6	0	0
21	9406468	.	G	T	3	3	6	0	0	6	0	0
21	9418214	.	A	G	1	1	2	0	0	2	0	0
21	9418217	.	A	G	1	0	1	0	1	2	0	0
21	9446650	.	A	G	2	2	4	0	0	4	0	0
21	9450385	.	G	A	1	2	3	0	0	3	0	0
21	9460633	.	C	T	0	2	2	0	1	3	0	0
21	9987496	.	T	A	1	5	6	0	0	6	0	0
21	9987923	.	C	G	8	3	11	0	1	12	0	0
21	9989373	.	A	G	4	4	8	0	1	9	0	0
21	9991332	.	T	C	3	5	8	0	0	8	0	0
21	9991340	.	A	C	4	4	8	0	1	9	0	0
21	10254231	.	A	T	6	9	15	0	0	15	0	0
21	10254246	.	C	T	0	9	9	0	4	13	0	0
21	10288926	.	G	A	1	3	4	0	0	4	0	0
21	10319303	.	G	A	1	4	5	0	0	5	0	0
21	10422549	.	G	A	2	2	4	0	0	4	0	0
21	10702117	.	G	T	4	2	6	0	0	6	0	0
21	10702132	.	C	G	4	0	4	0	2	6	0	0
21	10702215	.	G	A	4	2	6	0	1	7	0	0
21	10713176	.	G	A	2	3	5	0	0	5	0	0
21	10715837	.	G	A	8	3	11	0	0	11	0	0
21	10715855	.	T	C	8	3	11	0	0	11	0	0
21	10729109	.	C	T	6	5	11	0	0	11	0	0
21	10731101	.	A	G	10	8	18	0	0	18	0	0
21	10731133	.	A	G	2	8	10	0	2	12	0	0
21	10731142	.	G	C	2	7	9	0	0	9	0	0
21	10796054	.	G	A	1	2	3	0	0	3	0	0
21	10890736	.	G	T	3	7	10	0	1	11	0	0
21	10891065	.	T	G	4	8	12	0	1	13	0	0
21	10891085	.	T	C	4	0	4	0	9	13	0	0
21	10892031	.	A	G	2	3	5	0	0	5	0	0
21	10903625	.	T	C	2	3	5	0	0	5	0	0
21	10918101	.	G	A	1	0	1	0	0	1	0	0
21	10933016	.	G	A	3	2	5	0	0	5	0	0
21	11131346	.	C	T	1	2	3	0	1	4	0	0
21	11133284	.	A	G	1	2	3	0	0	3	0	0
21	11133544	.	C	T	1	2	3	0	0	3	0	0
21	11133547	.	T	C	1	2	3	0	0	3	0	0
21	11133630	.	A	G	1	2	3	0	0	3	0	0
21	11133729	.	C	A	3	2	5	0	0	5	0	0
21	11133762	.	A	G	3	3	6	0	0	6	0	0
21	11133849	.	G	A	2	2	4	0	0	4	0	0
21	11133857	.	T	C	2	2	4	0	0	4	0	0
21	11134595	.	G	A	3	4	7	0	1	8	0	0
21	11135186	.	C	T	2	2	4	0	0	4	0	0
21	11135188	.	T	G	2	2	4	0	0	4	0	0
21	11180061	.	T	C	3	0	3	0	3	6	0	0
21	11180201	.	T	C	4	4	8	0	0	8	0	0
21	11180215	.	C	T	3	6	9	0	0	9	0	0
21	11182127	.	G	T	6	7	13	0	1	14	0	0
21	11188405	.	A	G	2	3	5	0	0	5	0	0
21	11191971	.	A	T	4	1	5	0	0	5	0	0
21	11193317	.	A	G	2	1	3	0	0	3	0	0
21	11330670	.	T	A	1	0	1	0	0	1	0	0
21	11330903	.	T	G	5	2	7	0	1	8	0	0
21	11339191	.	C	T	8	3	11	0	0	11	0	0
21	11339654	.	A	T	3	2	5	0	0	5	0	0
21	11339704	.	T	C	5	4	9	0	0	9	0	0
21	11339710	.	T	C	4	2	6	0	3	9	0	0
21	11342305	.	T	C	3	4	7	0	0	7	0	0
21	11342333	.	A	G	5	2	7	0	0	7	0	0
21	11342604	.	C	G	0	3	3	0	1	4	0	0
21	11342622	.	T	C	3	4	7	0	0	7	0	0
21	11342740	.	A	G	2	3	5	0	0	5	0	0
21	11354025	.	T	C	0	4	4	0	0	4	0	0
21	11354077	.	A	G	1	3	4	0	0	4	0	0
21	11363835	.	G	A	1	2	3	0	0	3	0	0
21	11365321	.	G	T	3	1	4	0	0	4	0	0
21	11369788	.	G	T	0	3	3	0	1	4	0	0
21	11369871	.	A	G	2	1	3	0	0	3	0	0
21	11369899	.	A	T	1	0	1	0	0	1	0	0
21	11380368	.	A	G	1	1	2	0	0	2	0	0
21	11382887	.	C	T	7	1	8	0	0	8	0	0
21	11382899	.	T	C	6	2	8	0	1	9	0	0
21	11410396	.	A	T	1	2	3	0	0	3	0	0
21	11415249	.	T	A	2	2	4	0	0	4	0	0
21	11425152	.	C	T	6	4	10	0	1	11	0	0
21	11425182	.	G	A	4	9	13	0	1	14	0	0
21	11425218	.	T	C	6	10	16	0	0	16	0	0
21	11427850	.	T	C	1	2	3	0	1	4	0	0
21	11431070	.	G	T	5	5	10	0	2	12	0	0
21	11434022	.	C	A	14	14	28	0	3	31	0	0
21	11434116	.	T	C	6	14	20	0	1	21	0	0
21	11468957	.	A	C	17	18	35	0	1	36	0	0
21	11469119	.	A	G	23	10	33	0	2	35	0	0
21	11477418	.	A	G	13	1	14	0	7	21	0	0
21	11477496	.	T	C	16	23	39	0	1	40	0	0
21	11486933	.	T	C	12	6	18	0	0	18	0	0
21	11492826	.	C	T	32	24	56	0	1	57	0	0
21	11494536	.	A	G	34	3	37	0	20	57	0	0
21	11501308	.	T	C	32	25	57	0	0	57	0	0
21	11501618	.	T	A	14	18	32	0	1	33	0	0
21	11501665	.	C	T	24	23	47	0	0	47	0	0
21	11502120	.	T	C	33	23	56	0	7	63	0	0
21	11502143	.	A	G	28	30	58	0	2	60	0	0
21	11502807	.	G	T	3	21	24	0	23	47	0	0
21	11518424	.	G	A	2	1	3	0	0	3	0	0
21	11527709	.	G	A	3	2	5	0	0	5	0	0
21	11527723	.	C	G	3	0	3	0	2	5	0	0
21	11527746	.	T	C	4	3	7	0	0	7	0	0
21	11527950	.	A	G	0	1	1	0	2	3	0	0
21	11527977	.	C	T	1	2	3	0	0	3	0	0
21	11527986	.	A	G	2	0	2	0	2	4	0	0
21	11528040	.	A	G	2	4	6	0	1	7	0	0
21	11528047	.	A	C	2	4	6	0	1	7	0	0
21	11528094	.	G	A	4	2	6	0	0	6	0	0
21	11566285	.	T	G	1	5	6	0	1	7	0	0
21	11566478	.	G	T	10	7	17	0	1	18	0	0
21	11571108	.	G	A	0	2	2	0	0	2	0	0
21	11571147	.	T	C	0	2	2	0	0	2	0	0
21	11571279	.	C	G	3	0	3	0	0	3	0	0
21	11571287	.	T	A	3	0	3	0	0	3	0	0
21	11571353	.	G	A	1	0	1	0	0	1	0	0
21	11575596	.	T	G	2	1	3	0	0	3	0	0
21	11575611	.	T	C	2	1	3	0	0	3	0	0
21	11575632	.	T	A	1	0	1	0	0	1	0	0
21	11602249	.	T	A	0	2	2	0	0	2	0	0
21	11709084	.	G	A	0	1	1	0	0	1	0	0
21	11713042	.	G	A	0	7	7	0	2	9	0	0
21	11718420	.	T	C	3	12	15	0	0	15	0	0
21	11721310	.	T	C	1	3	4	0	0	4	0	0
21	11721984	.	A	G	13	1	14	0	14	28	0	0
21	11722262	.	C	T	8	12	20	0	0	20	0	0
21	11722277	.	C	T	10	8	18	0	0	18	0	0
21	11759242	.	A	G	1	0	1	0	0	1	0	0
21	11762456	.	T	G	2	2	4	0	0	4	0	0
21	11766523	.	A	T	6	4	10	0	1	11	0	0
21	11766535	.	G	A	0	4	4	0	7	11	0	0
21	11766598	.	T	A	1	1	2	0	1	3	0	0
21	11766609	.	C	A	0	1	1	0	2	3	0	0
21	11766663	.	T	G	2	0	2	0	3	5	0	0
21	11766664	.	T	C	2	3	5	0	0	5	0	0
21	11767009	.	G	C	0	3	3	0	0	3	0	0
21	11773106	.	G	A	0	4	4	0	0	4	0	0
21	11774398	.	T	G	2	0	2	0	5	7	0	0
21	11774860	.	C	T	2	4	6	0	0	6	0	0
21	11781541	.	A	G	4	7	11	0	1	12	0	0
21	11791937	.	A	T	1	0	1	0	0	1	0	0
21	11799553	.	A	G	6	2	8	0	1	9	0	0
21	11855947	.	C	T	2	2	4	0	0	4	0	0
21	11866057	.	A	C	9	9	18	0	0	18	0	0
21	11867908	.	T	C	4	4	8	0	0	8	0	0
21	11869495	.	C	A	9	6	15	0	0	15	0	0
21	11869774	.	G	C	0	9	9	0	8	17	0	0
21	11869870	.	C	T	11	9	20	0	0	20	0	0
21	11880927	.	G	A	1	2	3	0	0	3	0	0
21	11880996	.	G	A	15	11	26	0	1	27	0	0
21	11881129	.	G	C	15	4	19	0	1	20	0	0
21	11881140	.	C	T	16	5	21	0	2	23	0	0
21	11881344	.	G	A	7	17	24	0	1	25	0	0
21	11881715	.	C	T	13	7	20	0	0	20	0	0
21	11881875	.	A	T	2	3	5	0	0	5	0	0
21	11883079	.	A	G	2	0	2	0	2	4	0	0
21	11883806	.	G	T	1	2	3	0	0	3	0	0
21	11883984	.	C	A	2	2	4	0	0	4	0	0
21	11883991	.	A	T	2	1	3	0	0	3	0	0
21	11898772	.	A	C	2	2	4	0	0	4	0	0
21	11911722	.	A	T	8	20	28	0	0	28	0	0
21	11911730	.	A	T	8	21	29	0	1	30	0	0
21	11911921	.	C	T	8	13	21	0	2	23	0	0
21	11927809	.	G	C	0	11	11	0	4	15	0	0
21	11932372	.	T	C	2	0	2	0	0	2	0	0
21	11937522	.	A	G	9	12	21	0	4	25	0	0
21	11942334	.	T	C	10	5	15	0	4	19	0	0
21	11942407	.	T	C	12	11	23	0	1	24	0	0
21	11946133	.	C	T	14	9	23	0	0	23	0	0
21	11949317	.	C	T	4	7	11	0	1	12	0	0
21	11950217	.	C	A	6	2	8	0	0	8	0	0
21	11955208	.	A	C	4	11	15	0	8	23	0	0
21	11958852	.	A	T	10	6	16	0	1	17	0	0
21	11958928	.	A	G	8	9	17	0	0	17	0	0
21	11958971	.	G	T	9	12	21	0	0	21	0	0
21	11958982	.	C	T	6	10	16	0	2	18	0	0
21	11959034	.	G	A	8	12	20	0	3	23	0	0
21	11959061	.	T	G	8	13	21	0	0	21	0	0
21	11959185	.	A	G	17	15	32	0	1	33	0	0
21	11959309	.	T	C	3	2	5	0	0	5	0	0
21	11961122	.	C	T	5	11	16	0	0	16	0	0
21	11963648	.	C	G	1	3	4	0	0	4	0	0
21	11963778	.	C	A	2	4	6	0	1	7	0	0
21	11964981	.	C	T	2	6	8	0	0	8	0	0
21	11965035	.	T	G	0	3	3	0	0	3	0	0
21	11967077	.	T	C	1	0	1	0	0	1	0	0
21	11967857	.	A	C	1	2	3	0	0	3	0	0
21	12023854	.	C	T	0	2	2	0	1	3	0	0
21	12023880	.	A	C	2	2	4	0	0	4	0	0
21	12028080	.	G	A	8	7	15	0	2	17	0	0
21	12036013	.	C	T	7	4	11	0	0	11	0	0
21	12058705	.	C	T	1	4	5	0	0	5	0	0
21	12073880	.	G	A	0	2	2	0	1	3	0	0
21	12073944	.	T	C	1	3	4	0	0	4	0	0
21	12080051	.	C	G	0	23	23	0	12	35	0	0
21	12104957	.	C	A	7	6	13	0	0	13	0	0
21	12107367	.	A	G	0	2	2	0	0	2	0	0
21	12272375	.	T	G	11	13	24	0	1	25	0	0
21	13193928	.	C	T	12	14	26	0	0	26	0	0
21	13260193	.	T	C	0	2	2	0	0	2	0	0
21	13360446	.	C	T	5	1	6	0	0	6	0	0
21	13362830	.	A	C	3	0	3	0	1	4	0	0
21	13362896	.	C	T	5	3	8	0	0	8	0	0
21	13364790	.	T	A	5	6	11	0	0	11	0	0
21	13364802	.	T	C	6	9	15	0	1	16	0	0
21	13384144	.	A	G	4	2	6	0	0	6	0	0
21	13388094	.	T	C	3	2	5	0	0	5	0	0
21	13388223	.	T	C	1	5	6	0	0	6	0	0
21	13389927	.	A	C	0	1	1	0	0	1	0	0
21	13389943	.	G	A	0	1	1	0	0	1	0	0
21	13431198	.	G	A	4	11	15	0	1	16	0	0
21	13431261	.	G	C	5	6	11	0	2	13	0	0
21	13431309	.	A	G	5	0	5	0	8	13	0	0
21	13431363	.	A	T	3	4	7	0	0	7	0	0
21	13431379	.	T	A	3	3	6	0	0	6	0	0
21	13431470	.	A	G	2	3	5	0	0	5	0	0
21	13431573	.	T	C	5	5	10	0	0	10	0	0
21	13431620	.	T	C	3	4	7	0	0	7	0	0
21	13431639	.	C	T	3	2	5	0	0	5	0	0
21	13431668	.	T	A	2	1	3	0	0	3	0	0
21	13431924	.	A	G	4	5	9	0	1	10	0	0
21	13431947	.	A	T	2	7	9	0	1	10	0	0
21	13432049	.	A	G	2	3	5	0	0	5	0	0
21	13432071	.	A	C	2	4	6	0	0	6	0	0
21	13432315	.	T	C	5	13	18	0	0	18	0	0
21	13432369	.	C	A	12	5	17	0	0	17	0	0
21	13493762	.	A	G	1	2	3	0	0	3	0	0
21	13493781	.	T	G	1	0	1	0	1	2	0	0
21	13611930	.	G	T	2	4	6	0	0	6	0	0
21	13611990	.	C	T	0	3	3	0	4	7	0	0
21	13612174	.	T	A	4	5	9	0	0	9	0	0
21	13612559	.	A	T	7	4	11	0	0	11	0	0
21	13612803	.	T	C	0	1	1	0	0	1	0	0
21	13612827	.	G	A	0	2	2	0	0	2	0	0
21	13612846	.	T	C	1	0	1	0	2	3	0	0
21	13612927	.	A	T	6	2	8	0	0	8	0	0
21	13613017	.	A	G	2	2	4	0	0	4	0	0
21	13613172	.	C	T	0	4	4	0	2	6	0	0
21	13613559	.	T	C	4	2	6	0	0	6	0	0
21	13614703	.	G	T	3	2	5	0	0	5	0	0
21	13618076	.	T	G	0	1	1	0	0	1	0	0
21	13702751	.	A	T	12	13	25	0	1	26	0	0
21	13714602	.	T	C	19	8	27	0	2	29	0	0
21	13714603	.	G	A	21	7	28	0	1	29	0	0
21	13715285	.	T	A	1	0	1	0	0	1	0	0
21	13715347	.	T	A	3	4	7	0	1	8	0	0
21	13715356	.	A	G	3	4	7	0	0	7	0	0
21	13751205	.	G	C	11	6	17	0	1	18	0	0
21	13762547	.	C	T	0	2	2	0	1	3	0	0
21	13762760	.	C	T	4	4	8	0	0	8	0	0
21	13771269	.	G	T	1	0	1	0	0	1	0	0
21	13786089	.	G	A	1	3	4	0	0	4	0	0
21	13794602	.	C	T	2	0	2	0	0	2	0	0
21	13794652	.	G	T	3	2	5	0	0	5	0	0
21	13796033	.	G	A	2	0	2	0	0	2	0	0
21	13796165	.	G	A	2	8	10	0	0	10	0	0
21	13796743	.	A	G	5	9	14	0	1	15	0	0
21	13895741	.	C	T	7	10	17	0	0	17	0	0
21	13895799	.	C	A	21	26	47	0	2	49	0	0
21	13895849	.	G	A	0	6	6	0	6	12	0	0
21	13895862	.	A	C	2	2	4	0	0	4	0	0
21	14173820	.	T	G	2	2	4	0	0	4	0	0
21	14175614	.	C	T	0	2	2	0	1	3	0	0
21	14239956	.	C	T	3	4	7	0	0	7	0	0
21	14239988	.	C	T	5	5	10	0	0	10	0	0
21	14240025	.	G	T	3	3	6	0	0	6	0	0
21	14241982	.	G	T	2	1	3	0	0	3	0	0
21	14251160	.	T	A	3	5	8	0	0	9	1	0
21	14381335	.	G	A	4	5	9	0	0	9	0	0
21	14381356	.	C	T	0	5	5	0	4	9	0	0
21	14381547	.	T	C	4	0	4	0	7	11	0	0
21	14383767	.	T	C	2	0	2	0	5	7	0	0
21	14383809	.	C	T	0	1	1	0	3	4	0	0
21	14399414	.	A	C	0	0	0	0	1	1	0	0
21	14399710	.	T	G	0	2	2	0	0	2	0	0
21	14399729	.	A	G	0	2	2	0	0	2	0	0
21	14415698	.	A	G	1	1	2	0	0	2	0	0
21	14644363	.	T	C	6	9	15	0	0	15	0	0
21	14644704	.	A	T	13	13	26	0	1	27	0	0
21	14644869	.	C	G	6	12	18	0	2	20	0	0
21	14644885	.	A	T	9	11	20	0	1	21	0	0
21	14644969	.	A	G	9	11	20	0	0	20	0	0
21	14644981	.	G	C	11	8	19	0	0	19	0	0
21	14645006	.	G	A	5	10	15	0	0	15	0	0
21	14645021	.	G	A	5	14	19	0	0	19	0	0
21	14645113	.	A	G	3	9	12	0	1	13	0	0
21	14645125	.	A	G	4	8	12	0	1	13	0	0
21	14645300	.	G	A	9	8	17	0	1	18	0	0
21	14645369	.	A	T	4	8	12	0	0	12	0	0
21	14645641	.	C	A	9	12	21	0	0	21	0	0
21	14645642	.	A	C	9	11	20	0	1	21	0	0
21	14654497	.	G	A	4	5	9	0	0	9	0	0
21	14657314	.	C	T	0	3	3	0	4	7	0	0
21	14659421	.	C	T	0	3	3	0	0	3	0	0
21	14659462	.	T	A	2	0	2	0	0	2	0	0
21	14659997	.	T	C	0	2	2	0	0	2	0	0
21	14663428	.	A	G	0	2	2	0	0	2	0	0
21	14663853	.	C	G	0	1	1	0	0	1	0	0
21	14663911	.	T	C	4	3	7	0	0	7	0	0
21	14664425	.	T	C	6	5	11	0	1	12	0	0
21	14664851	.	T	C	0	3	3	0	0	3	0	0
21	14665397	.	C	A	3	4	7	0	1	8	0	0
21	14665427	.	C	T	3	8	11	0	0	11	0	0
21	14701897	.	G	A	5	14	19	0	2	21	0	0
21	14702073	.	C	G	4	3	7	1	0	8	0	0
21	14702211	.	C	T	0	1	1	0	1	2	0	0
21	14704871	.	G	A	0	1	1	0	0	1	0	0
21	14706677	.	C	A	2	4	6	0	1	7	0	0
21	14810988	.	T	C	3	5	8	0	0	8	0	0
21	14813064	.	A	G	10	8	18	0	0	18	0	0
21	14813138	.	A	G	5	6	11	0	1	12	0	0
21	14813282	.	C	G	4	16	20	0	2	22	0	0
21	14813380	.	G	C	10	11	21	0	0	21	0	0
21	14813402	.	T	A	9	10	19	0	0	19	0	0
21	14813479	.	T	C	10	0	10	0	18	28	0	0
21	14815804	.	A	G	8	10	18	0	2	20	0	0
21	14819421	.	C	G	0	2	2	0	3	5	0	0
21	14819766	.	G	A	1	0	1	0	0	1	0	0
21	14825750	.	G	A	1	0	1	0	0	1	0	0
21	14825756	.	G	A	1	0	1	0	0	1	0	0
21	14826689	.	C	T	1	0	1	0	0	1	0	0
21	14828692	.	C	T	0	2	2	0	6	8	0	0
21	14828722	.	A	C	4	2	6	0	0	6	0	0
21	14828848	.	T	C	6	6	12	0	0	12	0	0
21	14828935	.	T	C	3	2	5	0	0	5	0	0
21	14829081	.	C	A	0	6	6	0	4	10	0	0
21	14829091	.	G	A	3	6	9	0	0	9	0	0
21	14829145	.	A	G	6	4	10	0	0	10	0	0
21	14831911	.	A	G	1	2	3	0	0	3	0	0
21	14831929	.	T	C	1	0	1	0	4	5	0	0
21	14832141	.	C	T	2	0	2	0	1	3	0	0
21	14842944	.	T	C	2	0	2	0	0	2	0	0
21	14843085	.	C	T	4	1	5	0	0	5	0	0
21	14846607	.	T	C	8	4	12	0	0	12	0	0
21	14848426	.	A	C	7	9	16	0	0	16	0	0
21	14848427	.	T	A	7	9	16	0	0	16	0	0
21	14859396	.	C	T	9	5	14	0	1	15	0	0
21	14859447	.	A	C	2	1	3	0	0	3	0	0
21	14862981	.	G	A	1	3	4	0	0	4	0	0
21	14904837	.	G	A	2	3	5	0	0	5	0	0
21	14913330	.	G	C	0	1	1	0	0	1	0	0
21	15125603	.	A	C	11	2	13	0	0	13	0	0
21	15125661	.	G	A	21	6	27	0	1	28	0	0
21	15125667	.	G	A	20	5	25	0	2	27	0	0
21	15125825	.	T	C	12	0	12	0	10	22	0	0
21	15125859	.	T	C	11	13	24	0	0	24	0	0
21	15125867	.	C	T	10	14	24	0	0	24	0	0
21	15126048	.	G	A	15	12	27	0	2	29	0	0
21	15126068	.	G	T	15	7	22	0	0	22	0	0
21	15126088	.	G	A	15	9	24	0	0	24	0	0
21	15154547	.	A	T	16	15	31	0	2	33	0	0
21	15154625	.	A	G	13	13	26	0	3	29	0	0
21	15230556	.	C	T	1	13	14	0	12	26	0	0
21	15234284	.	T	A	16	12	28	0	1	29	0	0
21	15252402	.	G	A	2	8	10	0	0	10	0	0
21	15252491	.	C	A	0	5	5	0	8	13	0	0
21	15263962	.	C	T	0	0	0	0	2	2	0	0
21	15811307	.	T	C	0	1	1	0	0	1	0	0
21	17192901	.	C	A	1	0	1	0	1	2	0	0
21	17192940	.	C	T	7	5	12	0	0	12	0	0
21	17246756	.	G	A	3	5	8	0	1	9	0	0
21	17253496	.	T	C	2	2	4	0	0	4	0	0
21	17255773	.	C	T	5	4	9	0	0	9	0	0
21	17255815	.	C	G	8	3	11	0	2	13	0	0
21	17256590	.	A	C	9	10	19	0	1	20	0	0
21	17256656	.	A	G	7	3	10	0	0	10	0	0
21	17258362	.	A	G	13	6	19	0	1	20	0	0
21	17258421	.	T	A	11	6	17	0	2	19	0	0
21	17258486	.	C	T	14	10	24	0	0	24	0	0
21	17258576	.	T	G	11	9	20	0	1	21	0	0
21	17258670	.	A	G	5	0	5	0	8	13	0	0
21	17258771	.	G	A	0	4	4	0	10	14	0	0
21	17258784	.	A	C	10	4	14	0	0	14	0	0
21	17258842	.	A	G	8	5	13	0	0	13	0	0
21	17259081	.	C	G	11	12	23	0	0	23	0	0
21	17259279	.	G	T	0	13	13	0	6	19	0	0
21	17259332	.	T	C	13	14	27	0	0	27	0	0
21	17259466	.	A	T	14	9	23	0	0	23	0	0
21	17259935	.	A	G	1	4	5	0	0	5	0	0
21	17260532	.	C	G	10	8	18	0	1	19	0	0
21	17307144	.	C	T	2	2	4	0	0	4	0	0
21	17312383	.	C	T	3	0	3	0	0	3	0	0
21	17314054	.	C	T	1	3	4	0	0	4	0	0
21	17322472	.	G	A	0	1	1	0	0	1	0	0
21	17325413	.	G	A	0	4	4	0	0	4	0	0
21	17325965	.	G	A	2	3	5	0	0	5	0	0
21	17327264	.	A	G	7	0	7	0	4	11	0	0
21	17327293	.	A	G	8	0	8	0	6	14	0	0
21	17327518	.	T	A	1	2	3	0	1	4	0	0
21	17327524	.	G	A	2	2	4	0	0	4	0	0
21	17327599	.	C	T	2	2	4	0	0	4	0	0
21	17335595	.	T	C	5	2	7	0	0	7	0	0
21	17335709	.	C	T	4	5	9	0	0	9	0	0
21	17337807	.	C	T	7	7	14	0	2	16	0	0
21	17337865	.	C	T	8	15	23	0	0	23	0	0
21	17337898	.	A	T	8	14	22	0	0	22	0	0
21	17338101	.	A	C	11	12	23	0	1	24	0	0
21	17338141	.	T	G	14	10	24	0	1	25	0	0
21	17338352	.	A	G	3	4	7	0	1	8	0	0
21	17338593	.	G	A	4	7	11	0	0	11	0	0
21	17339664	.	C	T	11	20	31	0	1	32	0	0
21	17339716	.	G	A	4	9	13	0	0	13	0	0
21	17419933	.	A	T	1	5	6	0	0	6	0	0
21	17419958	.	C	T	0	3	3	0	2	5	0	0
21	17420960	.	A	C	1	5	6	0	0	6	0	0
21	17424390	.	G	C	0	1	1	0	1	2	0	0
21	17478552	.	T	A	3	2	5	0	0	5	0	0
21	17478936	.	C	T	0	15	15	0	20	35	0	0
21	17480251	.	T	A	1	1	2	0	0	2	0	0
21	17482237	.	A	G	11	9	20	0	2	22	0	0
21	17567289	.	G	A	13	15	28	0	0	28	0	0
21	17567593	.	T	C	4	6	10	0	1	11	0	0
21	17567612	.	C	T	5	7	12	0	1	13	0	0
21	17567642	.	T	C	7	9	16	0	1	17	0	0
21	17567649	.	T	C	3	12	15	0	2	17	0	0
21	17567857	.	C	A	16	7	23	0	0	23	0	0
21	17567880	.	A	T	20	8	28	0	0	28	0	0
21	17567911	.	C	T	16	5	21	0	0	21	0	0
21	17567940	.	C	A	12	6	18	0	1	19	0	0
21	17567994	.	A	C	2	1	3	0	2	5	0	0
21	17568027	.	G	A	9	3	12	0	1	13	0	0
21	17568482	.	A	G	7	12	19	0	1	20	0	0
21	17568507	.	A	T	10	14	24	0	0	24	0	0
21	17568543	.	A	G	10	17	27	0	1	28	0	0
21	17568655	.	G	A	1	14	15	0	13	28	0	0
21	17568819	.	G	A	0	14	14	0	8	22	0	0
21	17568825	.	T	A	6	11	17	0	3	20	0	0
21	17568954	.	G	A	0	13	13	0	6	19	0	0
21	17569200	.	A	G	14	12	26	0	1	27	0	0
21	17569587	.	C	A	18	26	44	0	7	51	0	0
21	17569647	.	T	C	19	24	43	0	1	44	0	0
21	17569745	.	T	A	13	13	26	0	0	26	0	0
21	17569747	.	T	A	13	11	24	0	1	26	1	0
21	17569808	.	A	C	12	9	21	0	1	22	0	0
21	17569812	.	C	G	13	6	19	0	1	20	0	0
21	17572916	.	C	T	0	3	3	0	1	4	0	0
21	17577997	.	G	C	7	0	7	0	2	9	0	0
21	17578010	.	G	T	5	1	6	0	0	6	0	0
21	17578655	.	C	T	0	3	3	0	2	5	0	0
21	17578717	.	G	A	2	2	4	0	0	4	0	0
21	17589992	.	G	A	0	0	0	0	1	1	0	0
21	17910473	.	A	C	2	5	7	0	0	7	0	0
21	17932675	.	T	C	2	4	6	0	0	6	0	0
21	17944772	.	C	T	3	6	9	0	0	9	0	0
21	17984484	.	C	A	13	14	27	0	0	27	0	0
21	17984685	.	G	A	10	11	21	0	0	21	0	0
21	17984919	.	G	A	9	8	17	0	0	17	0	0
21	17984965	.	G	A	7	9	16	0	0	16	0	0
21	17985047	.	C	T	4	7	11	0	0	11	0	0
21	18013155	.	T	C	12	4	16	0	0	16	0	0
21	18023170	.	G	T	10	10	20	0	0	20	0	0
21	18023283	.	G	A	13	7	20	0	0	20	0	0
21	18023309	.	T	G	8	6	14	0	0	14	0	0
21	18023504	.	A	G	9	3	12	0	1	13	0	0
21	18023704	.	A	G	4	10	14	0	1	15	0	0
21	18023717	.	A	G	3	9	12	0	1	13	0	0
21	18023792	.	G	T	8	5	13	0	1	14	0	0
21	18024032	.	A	C	5	6	11	0	1	12	0	0
21	18024345	.	T	G	1	2	3	0	1	4	0	0
21	18024633	.	C	T	0	10	10	0	7	17	0	0
21	18065958	.	T	C	2	1	3	0	0	3	0	0
21	18266852	.	A	T	2	4	6	0	0	6	0	0
21	18269653	.	C	T	2	6	8	0	10	18	0	0
21	18269695	.	C	T	4	5	9	0	0	9	0	0
21	18271138	.	C	T	11	9	20	0	0	20	0	0
21	18271650	.	T	A	4	1	5	0	0	5	0	0
21	18272195	.	T	C	8	5	13	0	0	13	0	0
21	18272435	.	T	C	4	1	5	0	1	6	0	0
21	18273434	.	G	A	6	6	12	0	1	13	0	0
21	18273485	.	A	T	4	4	8	0	0	8	0	0
21	18286641	.	C	T	4	0	4	0	0	4	0	0
21	18289749	.	T	C	16	19	35	0	0	35	0	0
21	18289909	.	G	C	7	12	19	0	0	19	0	0
21	18331963	.	G	A	2	2	4	0	0	4	0	0
21	18332010	.	A	G	1	2	3	0	0	3	0	0
21	18339622	.	G	A	1	0	1	0	0	1	0	0
21	18370570	.	G	A	0	4	4	0	5	9	0	0
21	18372902	.	G	A	7	10	17	0	6	23	0	0
21	18375442	.	A	G	4	3	7	0	0	7	0	0
21	18375662	.	G	A	0	0	0	0	3	3	0	0
21	18382501	.	T	C	8	4	12	0	1	13	0	0
21	18382546	.	C	T	5	1	6	0	0	6	0	0
21	18385061	.	C	T	6	6	12	0	1	13	0	0
21	18386613	.	C	T	4	8	12	0	0	12	0	0
21	18386704	.	A	G	3	0	3	0	7	10	0	0
21	18386849	.	C	T	7	6	13	0	1	14	0	0
21	18600454	.	T	C	5	2	7	0	0	7	0	0
21	18600495	.	G	A	4	2	6	0	0	6	0	0
21	18600505	.	G	A	4	4	8	0	0	8	0	0
21	18600750	.	T	A	3	5	8	0	0	8	0	0
21	18600764	.	A	G	2	3	5	0	0	5	0	0
21	18600880	.	C	T	0	3	3	0	3	6	0	0
21	18602893	.	A	T	3	2	5	0	0	5	0	0
21	18604999	.	T	C	4	2	6	0	0	6	0	0
21	18616098	.	T	C	1	2	3	0	0	3	0	0
21	18648803	.	A	G	1	2	3	0	0	3	0	0
21	18759575	.	G	A	2	3	5	0	0	5	0	0
21	18922940	.	T	C	1	2	3	0	0	3	0	0
21	18922973	.	G	A	1	0	1	0	0	1	0	0
21	18924082	.	G	A	0	2	2	0	0	2	0	0
21	18924676	.	C	T	3	3	6	0	0	6	0	0
21	18924712	.	T	C	2	4	6	0	0	6	0	0
21	18924751	.	T	C	0	5	5	0	0	5	0	0
21	18925053	.	T	C	1	1	2	0	1	3	0	0
21	18925078	.	G	A	1	1	2	0	1	3	0	0
21	18925521	.	A	G	4	4	8	0	1	9	0	0
21	18925531	.	A	G	5	4	9	0	0	9	0	0
21	18929509	.	T	C	9	9	18	0	1	19	0	0
21	18932088	.	A	G	5	5	10	0	1	11	0	0
21	18932287	.	C	T	0	6	6	0	5	11	0	0
21	18932717	.	G	A	5	15	20	0	0	20	0	0
21	18933748	.	G	T	5	3	8	0	1	9	0	0
21	18934265	.	C	A	0	6	6	0	9	15	0	0
21	18934289	.	C	T	0	7	7	0	7	14	0	0
21	18938388	.	A	G	5	2	7	0	1	8	0	0
21	18938391	.	C	T	3	2	5	0	3	8	0	0
21	18950633	.	C	T	4	5	9	0	0	9	0	0
21	18950997	.	T	G	11	10	21	0	0	21	0	0
21	18956779	.	C	T	14	8	22	0	0	22	0	0
21	18956883	.	T	A	12	9	21	0	0	21	0	0
21	18957259	.	G	A	17	13	30	0	1	31	0	0
21	18957601	.	C	G	9	9	18	0	1	19	0	0
21	18957624	.	T	C	8	10	18	0	1	19	0	0
21	18957776	.	T	C	6	10	16	0	1	17	0	0
21	19005512	.	G	A	1	1	2	0	0	2	0	0
21	19008736	.	G	A	18	13	31	0	1	32	0	0
21	19008845	.	C	T	12	9	21	0	0	21	0	0
21	19009346	.	T	C	16	16	32	0	0	32	0	0
21	19013852	.	T	A	11	8	19	0	4	24	1	0
21	19014036	.	T	G	22	15	37	0	1	38	0	0
21	19014298	.	C	T	39	28	67	0	0	67	0	0
21	19015460	.	C	A	16	23	39	0	1	40	0	0
21	19015461	.	C	A	15	23	38	0	2	40	0	0
21	19017819	.	G	A	15	23	38	0	3	41	0	0
21	19018434	.	T	A	8	15	23	0	0	23	0	0
21	19067092	.	A	G	23	23	46	0	3	49	0	0
21	19073143	.	G	T	5	4	9	0	0	9	0	0
21	19324534	.	T	C	1	2	3	0	0	3	0	0
21	19324614	.	G	A	0	1	1	0	0	1	0	0
21	19329135	.	C	T	5	4	9	0	0	9	0	0
21	19329971	.	C	G	0	0	0	0	2	2	0	0
21	19341581	.	C	T	1	2	3	0	0	3	0	0
21	19341617	.	C	T	1	2	3	0	0	3	0	0
21	19345608	.	A	G	1	1	2	0	0	2	0	0
21	19347379	.	T	G	0	1	1	0	0	1	0	0
21	19347929	.	A	G	0	2	2	0	0	2	0	0
21	19350312	.	G	A	0	1	1	0	0	1	0	0
21	19353416	.	C	T	1	0	1	0	0	1	0	0
21	19488647	.	C	T	0	2	2	0	1	3	0	0
21	19602415	.	T	C	1	2	3	0	0	3	0	0
21	19607006	.	C	T	2	4	6	0	1	7	0	0
21	19607018	.	A	C	3	4	7	0	0	7	0	0
21	19607552	.	C	T	5	2	7	0	0	7	0	0
21	19763668	.	C	T	21	16	37	0	1	39	1	0
21	19763692	.	A	T	22	21	43	0	3	46	0	0
21	19763715	.	T	G	28	24	52	0	0	52	0	0
21	19763942	.	G	A	28	22	50	0	3	53	0	0
21	19764230	.	C	T	27	25	52	0	5	57	0	0
21	19764432	.	G	A	19	32	51	0	0	51	0	0
21	19785355	.	G	T	9	21	30	0	1	31	0	0
21	19785379	.	A	T	14	27	41	0	0	41	0	0
21	19790527	.	A	C	8	3	11	0	0	11	0	0
21	19790590	.	G	A	14	13	27	0	0	27	0	0
21	19792767	.	T	G	8	11	19	0	0	19	0	0
21	19792803	.	G	A	15	19	34	0	2	36	0	0
21	19796215	.	G	A	10	8	18	0	0	18	0	0
21	19804193	.	T	G	0	0	0	0	1	1	0	0
21	19809122	.	T	C	1	1	2	0	3	5	0	0
21	19821323	.	C	A	0	5	5	0	7	12	0	0
21	19821449	.	A	T	2	0	2	0	0	2	0	0
21	19868489	.	C	T	6	3	9	0	0	9	0	0
21	19868674	.	G	A	9	10	19	0	0	19	0	0
21	19869129	.	C	T	8	8	16	0	1	17	0	0
21	19872681	.	A	G	4	5	9	0	0	9	0	0
21	19872772	.	G	A	8	10	18	0	0	18	0	0
21	19872904	.	C	T	7	5	12	0	0	12	0	0
21	19903584	.	G	A	3	13	16	0	0	16	0	0
21	19904556	.	T	C	5	4	9	0	0	9	0	0
21	19904713	.	G	C	7	7	14	0	0	14	0	0
21	19904871	.	G	A	6	3	9	0	0	9	0	0
21	19905105	.	G	A	4	5	9	0	0	9	0	0
21	19906355	.	G	A	7	3	10	0	0	10	0	0
21	19906513	.	T	C	1	4	5	0	0	5	0	0
21	19906589	.	G	C	2	2	4	0	1	5	0	0
21	19906590	.	A	C	2	0	2	0	3	5	0	0
21	19906666	.	C	T	1	4	5	0	1	6	0	0
21	19911433	.	G	T	3	3	6	0	1	7	0	0
21	19911467	.	C	A	3	1	4	0	0	4	0	0
21	19913445	.	G	C	5	5	10	0	0	10	0	0
21	19915594	.	T	G	0	2	2	0	0	3	1	0
21	20035065	.	T	C	4	4	8	0	1	9	0	0
21	20067528	.	C	T	1	1	2	0	0	2	0	0
21	20080608	.	G	T	0	1	1	0	1	2	0	0
21	20086915	.	C	T	1	0	1	0	0	1	0	0
21	20089886	.	C	T	9	9	18	0	0	18	0	0
21	20101713	.	A	G	3	0	3	0	2	5	0	0
21	20105111	.	A	T	4	4	8	0	0	8	0	0
21	20105129	.	C	T	2	2	4	0	0	4	0	0
21	20106551	.	A	G	6	13	19	0	0	19	0	0
21	20113519	.	C	A	9	9	18	0	1	19	0	0
21	20113659	.	A	G	5	3	8	0	0	8	0	0
21	20114148	.	G	A	11	16	27	0	3	30	0	0
21	20118979	.	C	T	6	3	9	0	0	9	0	0
21	20120057	.	A	G	6	6	12	0	0	12	0	0
21	20120404	.	G	A	5	10	15	0	0	15	0	0
21	20245434	.	C	T	2	2	4	0	0	4	0	0
21	20339796	.	C	T	0	9	9	0	9	18	0	0
21	20377931	.	C	T	6	8	14	0	0	14	0	0
21	20377944	.	C	T	6	10	16	0	0	16	0	0
21	20394936	.	C	T	1	3	4	0	0	4	0	0
21	20395011	.	G	A	0	3	3	0	1	4	0	0
21	20395245	.	C	A	3	4	7	0	0	7	0	0
21	20633152	.	A	G	1	2	3	0	0	3	0	0
21	20634265	.	A	G	5	2	7	0	1	8	0	0
21	20634363	.	A	G	2	1	3	0	0	3	0	0
21	20634380	.	T	A	1	2	3	0	0	3	0	0
21	20634424	.	T	A	1	5	6	0	1	7	0	0
21	20634442	.	C	A	1	4	5	0	1	6	0	0
21	20635320	.	T	A	1	2	3	0	0	3	0	0
21	20635546	.	T	C	2	4	6	0	1	7	0	0
21	20636063	.	G	T	0	6	6	0	4	10	0	0
21	20636119	.	T	C	2	3	5	0	1	6	0	0
21	20636130	.	G	T	4	2	6	0	1	7	0	0
21	20636403	.	C	T	12	5	17	0	0	17	0	0
21	20909676	.	C	T	2	2	4	0	0	4	0	0
21	20950679	.	T	C	3	3	6	0	0	6	0	0
21	20950811	.	C	G	5	3	8	0	0	8	0	0
21	20950841	.	A	G	2	2	4	0	0	4	0	0
21	21017513	.	C	T	19	13	32	0	1	33	0	0
21	21020589	.	C	T	8	5	13	0	1	14	0	0
21	21029465	.	G	C	5	2	7	0	0	7	0	0
21	21038891	.	G	T	2	5	7	0	0	7	0	0
21	21039092	.	C	T	0	5	5	0	0	5	0	0
21	21046882	.	C	T	0	3	3	0	0	3	0	0
21	21046960	.	G	A	3	5	8	0	0	8	0	0
21	21048363	.	G	A	2	2	4	0	0	4	0	0
21	21049323	.	G	A	3	1	4	0	0	4	0	0
21	21051391	.	A	C	5	1	6	0	8	14	0	0
21	21051688	.	G	A	6	5	11	0	1	12	0	0
21	21069395	.	C	A	1	2	3	0	6	9	0	0
21	21069692	.	G	C	2	1	3	0	0	3	0	0
21	21072309	.	C	T	0	2	2	0	0	2	0	0
21	21075987	.	C	T	2	1	3	0	0	3	0	0
21	21076080	.	C	T	0	2	2	0	3	5	0	0
21	21170669	.	G	A	2	3	5	0	0	5	0	0
21	21170858	.	T	A	3	2	5	0	0	5	0	0
21	21170882	.	C	G	3	3	6	0	0	6	0	0
21	21177120	.	T	C	0	2	2	0	0	2	0	0
21	21210857	.	T	C	1	1	2	0	0	2	0	0
21	21221016	.	T	G	3	1	4	0	0	4	0	0
21	21221151	.	C	T	2	0	2	0	0	2	0	0
21	21230016	.	C	T	5	3	8	0	1	9	0	0
21	21230137	.	C	A	2	2	4	0	0	4	0	0
21	21233095	.	T	C	4	3	7	0	0	7	0	0
21	21233266	.	A	T	3	3	6	0	0	6	0	0
21	21233281	.	G	A	3	4	7	0	0	7	0	0
21	21233674	.	T	A	3	4	7	0	0	7	0	0
21	21236883	.	G	A	6	2	8	0	0	8	0	0
21	21236886	.	G	A	2	5	7	0	1	8	0	0
21	21238089	.	C	T	1	0	1	0	0	1	0	0
21	21238098	.	C	T	3	0	3	0	0	3	0	0
21	21239969	.	A	G	6	4	10	0	1	11	0	0
21	21239977	.	A	C	4	6	10	0	1	11	0	0
21	21240079	.	G	A	4	6	10	0	1	11	0	0
21	21240166	.	A	G	3	6	9	0	0	9	0	0
21	21240568	.	C	T	8	3	11	0	1	12	0	0
21	21240651	.	C	T	13	7	20	0	0	20	0	0
21	21240927	.	C	G	3	9	12	0	0	12	0	0
21	21241218	.	T	A	3	3	6	0	0	6	0	0
21	21241223	.	T	A	3	4	7	0	0	7	0	0
21	21241364	.	T	A	3	7	10	0	0	10	0	0
21	21241412	.	A	T	6	3	9	0	0	9	0	0
21	21241598	.	A	G	6	3	9	0	0	9	0	0
21	21241802	.	C	T	4	4	8	0	1	9	0	0
21	21241900	.	C	T	9	6	15	0	0	15	0	0
21	21242132	.	A	G	5	6	11	0	0	11	0	0
21	21242292	.	G	A	3	3	6	0	0	6	0	0
21	21242295	.	C	T	3	3	6	0	0	6	0	0
21	21264861	.	G	A	3	3	6	0	1	7	0	0
21	21269737	.	A	G	4	6	10	0	4	14	0	0
21	21272549	.	C	T	1	1	2	0	0	2	0	0
21	21273096	.	A	G	2	2	4	0	0	4	0	0
21	21277089	.	G	A	0	3	3	0	2	5	0	0
21	21277238	.	A	G	4	4	8	0	0	8	0	0
21	21279262	.	G	T	1	7	8	0	4	12	0	0
21	21279360	.	A	G	6	1	7	0	6	13	0	0
21	21279368	.	G	A	2	8	10	0	5	15	0	0
21	21279791	.	T	C	1	0	1	1	0	2	0	0
21	21286183	.	G	C	0	3	3	0	0	3	0	0
21	21294260	.	C	T	5	5	10	0	0	10	0	0
21	21294272	.	C	T	7	6	13	0	0	13	0	0
21	21294299	.	C	T	6	9	15	0	0	15	0	0
21	21294362	.	A	G	2	0	2	0	4	6	0	0
21	21298158	.	G	T	11	4	15	0	1	16	0	0
21	21298340	.	G	A	9	11	20	0	1	21	0	0
21	21298387	.	A	G	14	0	14	0	12	26	0	0
21	21333080	.	T	G	1	0	1	0	0	1	0	0
21	21339410	.	A	T	3	5	8	0	0	8	0	0
21	21342595	.	A	G	1	7	8	0	0	8	0	0
21	21343266	.	A	G	3	2	5	0	0	5	0	0
21	21344079	.	A	G	2	2	4	0	1	5	0	0
21	21346850	.	C	T	17	13	30	0	0	30	0	0
21	21347039	.	G	A	8	6	14	0	1	15	0	0
21	21347053	.	T	A	10	5	15	0	2	17	0	0
21	21347180	.	G	C	9	7	16	0	0	16	0	0
21	21368363	.	A	G	15	13	28	0	1	29	0	0
21	21370406	.	T	C	7	0	7	0	2	9	0	0
21	21372874	.	T	A	12	14	26	0	1	27	0	0
21	21450574	.	C	T	8	5	13	0	0	13	0	0
21	21450735	.	A	G	3	3	6	0	0	6	0	0
21	21450789	.	G	C	2	2	4	0	0	4	0	0
21	21523303	.	T	A	7	4	11	0	0	11	0	0
21	21523344	.	A	G	10	4	14	0	1	15	0	0
21	21523465	.	A	G	4	9	13	0	0	13	0	0
21	21523612	.	G	T	2	2	4	0	0	4	0	0
21	21615351	.	T	G	5	5	10	0	1	11	0	0
21	21633601	.	G	A	4	10	14	0	0	14	0	0
21	21744345	.	T	C	2	3	5	0	0	5	0	0
21	21745654	.	G	A	3	5	8	0	1	9	0	0
21	21750684	.	T	C	2	3	5	0	0	5	0	0
21	21750702	.	A	G	2	3	5	0	0	5	0	0
21	21751303	.	A	G	1	1	2	0	0	2	0	0
21	21754470	.	T	C	8	7	15	0	0	15	0	0
21	21754624	.	G	A	6	2	8	0	0	8	0	0
21	21791934	.	A	T	0	2	2	0	0	2	0	0
21	21793903	.	C	T	1	3	4	0	0	4	0	0
21	21794443	.	G	A	2	2	4	0	1	5	0	0
21	21820136	.	A	G	3	5	8	0	0	8	0	0
21	21996637	.	G	A	4	4	8	0	0	8	0	0
21	22030596	.	A	G	0	0	0	0	1	1	0	0
21	22038369	.	T	C	7	4	11	0	1	12	0	0
21	22044690	.	T	A	8	12	20	0	1	21	0	0
21	22048143	.	G	A	10	7	17	0	1	18	0	0
21	22070486	.	A	G	2	1	3	0	0	3	0	0
21	22070522	.	C	T	6	6	12	0	0	12	0	0
21	22070591	.	G	A	1	6	7	0	12	19	0	0
21	22082184	.	C	T	15	22	37	0	2	39	0	0
21	22082257	.	C	T	16	9	25	0	3	28	0	0
21	22099610	.	A	G	9	7	16	0	0	16	0	0
21	22099698	.	A	G	22	21	43	0	3	46	0	0
21	22099727	.	A	G	22	24	46	0	1	47	0	0
21	22099869	.	G	A	43	17	60	0	2	62	0	0
21	22100026	.	A	G	33	23	56	0	3	59	0	0
21	22100156	.	A	G	42	4	46	1	9	57	1	0
21	22100453	.	C	T	33	30	63	0	1	64	0	0
21	22100511	.	G	A	27	22	49	0	3	52	0	0
21	22100594	.	A	G	22	34	56	0	2	58	0	0
21	22100767	.	C	T	29	28	57	0	3	60	0	0
21	22101056	.	C	A	24	20	44	0	0	44	0	0
21	22101423	.	C	T	5	15	20	0	28	48	0	0
21	22101460	.	C	T	30	14	44	0	3	47	0	0
21	22101540	.	G	A	30	26	56	1	2	59	0	0
21	22101637	.	T	C	25	1	26	0	24	50	0	0
21	22101769	.	A	G	16	23	39	0	2	41	0	0
21	22101777	.	G	A	16	24	40	0	0	40	0	0
21	22101827	.	C	G	7	23	30	0	21	51	0	0
21	22101835	.	C	T	26	22	48	0	0	49	1	0
21	22101917	.	A	T	28	35	63	0	1	64	0	0
21	22102037	.	G	A	27	20	47	0	1	48	0	0
21	22102154	.	C	A	18	24	42	0	3	45	0	0
21	22102281	.	A	C	23	29	52	0	0	52	0	0
21	22102361	.	C	G	12	25	37	0	3	40	0	0
21	22102365	.	A	T	15	25	40	0	0	40	0	0
21	22102416	.	C	T	2	34	36	0	11	47	0	0
21	22102440	.	A	C	12	36	48	0	0	48	0	0
21	22102457	.	A	C	14	31	45	0	0	45	0	0
21	22102542	.	C	T	8	23	31	0	3	34	0	0
21	22102586	.	C	A	8	31	39	0	1	40	0	0
21	22102653	.	A	G	10	21	31	0	1	32	0	0
21	22102838	.	T	G	30	14	44	0	1	45	0	0
21	22102930	.	C	T	26	22	48	0	2	50	0	0
21	22110288	.	T	C	7	1	8	0	3	11	0	0
21	22110303	.	G	A	5	1	6	0	0	6	0	0
21	22111880	.	G	A	4	4	8	0	0	8	0	0
21	22111982	.	C	A	2	5	7	0	1	8	0	0
21	22138571	.	C	G	2	6	8	0	0	8	0	0
21	22140937	.	C	A	2	2	4	0	0	4	0	0
21	22142362	.	A	G	5	5	10	0	0	10	0	0
21	22142820	.	G	A	0	8	8	0	6	14	0	0
21	22330027	.	C	T	1	3	4	0	0	4	0	0
21	22330028	.	T	G	1	3	4	0	0	4	0	0
21	22330468	.	C	A	1	2	3	0	0	3	0	0
21	22336365	.	C	T	1	3	4	0	0	4	0	0
21	22347765	.	C	T	1	2	3	0	0	3	0	0
21	22386107	.	A	C	3	2	5	0	0	5	0	0
21	22386134	.	G	A	1	3	4	0	0	4	0	0
21	22387180	.	A	G	7	2	9	0	0	9	0	0
21	22387293	.	G	A	1	2	3	0	0	3	0	0
21	22404852	.	T	C	2	5	7	0	0	7	0	0
21	22404855	.	T	C	2	3	5	0	1	6	0	0
21	22405045	.	T	C	3	1	4	0	0	4	0	0
21	22406755	.	T	C	3	2	5	0	0	5	0	0
21	22407000	.	T	C	2	0	2	0	0	2	0	0
21	22410965	.	T	A	3	3	6	0	1	7	0	0
21	22412343	.	C	T	12	12	24	0	0	24	0	0
21	22421867	.	T	G	6	8	14	0	1	15	0	0
21	22422052	.	A	G	15	17	32	0	1	33	0	0
21	22422184	.	A	G	10	11	21	0	0	21	0	0
21	22422565	.	C	G	5	9	14	0	2	16	0	0
21	22422733	.	A	G	9	8	17	0	0	17	0	0
21	22880016	.	A	T	0	20	20	0	2	22	0	0
21	22888260	.	G	T	1	2	3	0	0	3	0	0
21	23160558	.	T	G	3	11	14	0	1	15	0	0
21	25103676	.	T	A	2	7	9	0	0	9	0	0
21	25380817	.	T	A	9	3	12	0	0	12	0	0
21	25605515	.	T	A	5	2	7	0	0	7	0	0
21	25695070	.	A	G	2	2	4	0	0	4	0	0
21	25817132	.	A	G	4	3	7	0	0	7	0	0
21	25817133	.	A	G	4	3	7	0	0	7	0	0
21	25817230	.	A	G	5	4	9	0	0	9	0	0
21	25817286	.	A	G	4	2	6	0	0	7	1	0
21	27198592	.	T	C	4	3	7	0	0	7	0	0
21	27283720	.	G	A	1	1	2	0	1	3	0	0
21	27602975	.	C	T	0	2	2	0	0	2	0	0
21	29075247	.	G	T	8	10	18	0	8	26	0	0
21	29090907	.	T	A	10	4	14	0	2	16	0	0
21	30019156	.	A	C	2	2	4	0	0	4	0	0
21	30692625	.	A	G	2	5	7	0	0	7	0	0
21	30692632	.	A	G	2	6	8	0	0	8	0	0
21	30692687	.	G	A	1	7	8	0	0	8	0	0
21	30692796	.	A	G	4	3	7	0	0	7	0	0
21	30692817	.	A	G	4	0	4	0	7	11	0	0
21	30693311	.	A	G	6	10	16	0	1	17	0	0
21	30693312	.	A	G	8	9	17	0	0	17	0	0
21	32281076	.	G	A	3	9	12	0	0	12	0	0
21	32281122	.	G	A	5	14	19	0	0	19	0	0
21	32281155	.	G	A	4	15	19	0	2	21	0	0
21	32281680	.	C	T	3	1	4	0	0	4	0	0
21	32283519	.	G	A	2	1	3	0	0	3	0	0
21	32284398	.	A	G	5	6	11	0	0	11	0	0
21	32285080	.	C	T	2	5	7	0	0	7	0	0
21	32285135	.	T	C	3	0	3	0	3	6	0	0
21	32285161	.	A	G	6	4	10	0	0	10	0	0
21	32343230	.	C	A	1	1	2	0	0	2	0	0
21	32343248	.	C	A	1	2	3	0	0	3	0	0
21	32343316	.	T	A	10	4	14	0	0	14	0	0
21	32343453	.	C	T	9	6	15	0	0	15	0	0
21	32343577	.	T	C	12	7	19	0	0	19	0	0
21	32343649	.	C	A	9	5	14	0	1	15	0	0
21	32343721	.	T	G	7	0	7	0	4	11	0	0
21	32344021	.	C	A	8	9	17	0	0	17	0	0
21	32345162	.	T	C	6	11	17	0	0	17	0	0
21	32345318	.	G	A	0	4	4	0	4	8	0	0
21	32345499	.	A	G	5	3	8	0	0	8	0	0
21	32345607	.	C	T	10	9	19	0	0	19	0	0
21	32345724	.	A	G	6	2	8	0	0	8	0	0
21	32345749	.	A	G	5	1	6	0	0	6	0	0
21	32345774	.	A	T	5	5	10	0	0	10	0	0
21	32345899	.	G	A	0	2	2	0	2	4	0	0
21	32346021	.	A	C	2	4	6	0	0	6	0	0
21	32346273	.	G	A	17	27	44	0	2	46	0	0
21	32346603	.	G	C	15	15	30	0	0	30	0	0
21	32346630	.	T	C	11	21	32	0	2	34	0	0
21	32346674	.	T	A	17	17	34	0	1	35	0	0
21	32346689	.	A	G	15	13	28	0	0	28	0	0
21	32346799	.	G	A	13	18	31	0	0	31	0	0
21	32346800	.	T	A	13	17	30	0	1	31	0	0
21	32346899	.	A	G	18	12	30	0	1	31	0	0
21	32346901	.	A	G	18	12	30	0	1	31	0	0
21	32347134	.	T	A	13	22	35	0	2	37	0	0
21	32347569	.	G	T	17	15	32	0	0	32	0	0
21	32347855	.	T	C	14	12	26	0	0	26	0	0
21	32347966	.	A	C	10	0	10	0	13	23	0	0
21	32348230	.	A	T	9	14	23	0	1	24	0	0
21	32348512	.	G	T	6	10	16	0	0	16	0	0
21	32348542	.	A	T	8	16	24	0	1	25	0	0
21	32348570	.	C	T	7	21	28	0	0	28	0	0
21	32348600	.	C	T	15	10	25	0	1	26	0	0
21	32353049	.	G	A	2	7	9	0	0	9	0	0
21	32354980	.	A	G	4	14	18	0	0	18	0	0
21	32374460	.	A	T	2	6	8	0	0	8	0	0
21	32457785	.	T	C	11	14	25	0	1	26	0	0
21	32457931	.	T	G	14	15	29	0	0	29	0	0
21	32457983	.	G	A	14	20	34	0	1	35	0	0
21	32458261	.	A	G	25	24	49	0	0	49	0	0
21	32458315	.	T	A	15	22	37	0	2	40	1	0
21	32460912	.	A	G	12	15	27	0	0	27	0	0
21	32466140	.	G	C	4	7	11	0	0	11	0	0
21	32467660	.	A	G	12	14	26	0	1	27	0	0
21	32467724	.	T	C	16	13	29	0	4	33	0	0
21	32476760	.	A	G	22	33	55	0	1	56	0	0
21	32477584	.	T	C	27	23	50	0	0	50	0	0
21	32477967	.	C	T	19	26	45	0	3	48	0	0
21	32477987	.	A	T	21	23	44	0	7	51	0	0
21	32478227	.	G	T	16	11	27	0	0	27	0	0
21	32482797	.	C	T	9	8	17	0	1	18	0	0
21	32482854	.	T	C	25	3	28	0	19	47	0	0
21	32523607	.	C	T	1	1	2	0	0	2	0	0
21	32758254	.	G	A	6	10	16	0	0	16	0	0
21	32758351	.	C	T	12	12	24	0	2	26	0	0
21	32758584	.	G	A	14	17	31	0	3	34	0	0
21	32759421	.	C	T	11	6	17	0	0	17	0	0
21	32766389	.	G	A	9	4	13	0	0	13	0	0
21	32772450	.	G	A	2	0	2	0	0	2	0	0
21	33058940	.	G	C	10	7	17	0	0	17	0	0
21	33066214	.	T	G	1	1	2	0	0	2	0	0
21	33069896	.	A	G	2	3	5	0	0	5	0	0
21	33211506	.	T	A	9	12	21	0	0	21	0	0
21	33211568	.	C	T	15	10	25	0	0	25	0	0
21	33211664	.	T	G	10	11	21	0	1	22	0	0
21	33211720	.	A	T	10	9	19	0	0	19	0	0
21	33211809	.	A	T	12	25	37	0	3	40	0	0
21	33213315	.	C	T	7	10	17	0	0	17	0	0
21	33213384	.	G	A	5	5	10	0	1	11	0	0
21	33218312	.	T	C	3	2	5	0	0	5	0	0
21	33218405	.	G	A	7	4	11	0	1	12	0	0
21	33447251	.	A	G	11	12	23	0	1	24	0	0
21	33463486	.	A	G	0	4	4	0	1	5	0	0
21	34001982	.	C	T	15	11	26	0	1	27	0	0
21	34002041	.	C	A	15	14	29	0	1	30	0	0
21	34002154	.	A	C	7	13	20	0	0	20	0	0
21	34002155	.	A	T	7	13	20	0	0	20	0	0
21	34002333	.	T	C	6	5	11	0	0	11	0	0
21	34002455	.	G	A	2	7	9	0	1	10	0	0
21	34002507	.	A	G	7	10	17	0	0	17	0	0
21	34074618	.	A	G	4	12	16	0	0	16	0	0
21	34074684	.	G	A	4	8	12	0	0	12	0	0
21	34074712	.	T	C	4	9	13	0	0	13	0	0
21	34098006	.	T	C	0	1	1	0	0	1	0	0
21	34098048	.	C	T	1	2	3	0	0	3	0	0
21	34128660	.	A	G	2	10	12	0	0	12	0	0
21	34129007	.	C	G	3	0	3	0	5	8	0	0
21	34129073	.	G	C	12	18	30	0	3	33	0	0
21	34129195	.	G	T	12	13	25	0	1	26	0	0
21	34129279	.	A	G	13	22	35	0	0	35	0	0
21	34129401	.	T	A	8	5	13	0	1	14	0	0
21	34199704	.	T	C	2	4	6	0	0	6	0	0
21	34210970	.	G	A	3	6	9	0	0	9	0	0
21	34211206	.	T	C	8	11	19	0	0	19	0	0
21	34211344	.	G	A	10	10	20	0	0	20	0	0
21	34211418	.	G	A	0	6	6	0	8	14	0	0
21	34211427	.	A	C	6	10	16	0	0	16	0	0
21	34211511	.	A	T	5	5	10	0	0	10	0	0
21	34364595	.	G	A	9	7	16	0	0	16	0	0
21	34364774	.	G	A	5	4	9	0	0	9	0	0
21	34364962	.	G	T	12	11	23	0	1	24	0	0
21	34391104	.	C	T	8	9	17	0	1	18	0	0
21	34391155	.	T	C	3	2	5	0	0	5	0	0
21	34392786	.	C	T	4	0	4	0	0	4	0	0
21	34424116	.	A	G	10	7	17	0	0	17	0	0
21	34430544	.	A	G	6	4	10	0	0	10	0	0
21	34714359	.	G	A	0	4	4	0	5	9	0	0
21	34714403	.	C	A	3	7	10	0	0	10	0	0
21	34741120	.	T	C	1	0	1	0	0	1	0	0
21	34770460	.	G	A	1	3	4	0	0	4	0	0
21	34770483	.	G	A	1	3	4	0	0	4	0	0
21	34770510	.	C	T	0	3	3	0	0	3	0	0
21	34792896	.	G	A	2	2	4	0	1	5	0	0
21	34793224	.	C	T	14	16	30	0	1	31	0	0
21	34793660	.	T	A	7	6	13	0	0	13	0	0
21	34793694	.	T	C	1	4	5	0	2	7	0	0
21	34793753	.	A	C	4	4	8	0	1	9	0	0
21	34793786	.	C	G	6	4	10	0	0	10	0	0
21	34815231	.	A	G	2	2	4	0	0	4	0	0
21	34815276	.	T	A	2	2	4	0	0	4	0	0
21	34826781	.	G	A	0	2	2	0	1	3	0	0
21	34834472	.	A	T	2	4	6	0	0	6	0	0
21	34834829	.	T	A	1	2	3	0	0	3	0	0
21	34834874	.	A	T	3	2	5	0	0	5	0	0
21	34849534	.	A	G	1	7	8	0	0	8	0	0
21	34856770	.	C	T	3	2	5	0	0	5	0	0
21	34981031	.	G	A	3	4	7	0	0	7	0	0
21	34987505	.	C	T	7	4	11	0	0	11	0	0
21	34987612	.	G	A	0	5	5	0	4	9	0	0
21	34987662	.	G	T	5	4	9	0	0	9	0	0
21	35009472	.	C	T	2	1	3	0	1	4	0	0
21	35009509	.	A	G	2	3	5	0	0	5	0	0
21	35013762	.	A	G	3	4	7	0	0	7	0	0
21	35025588	.	G	A	0	2	2	0	2	4	0	0
21	35033847	.	G	A	2	5	7	0	0	7	0	0
21	35033853	.	G	A	1	3	4	0	0	4	0	0
21	35035560	.	G	A	0	2	2	0	3	5	0	0
21	35040310	.	C	T	5	4	9	0	1	10	0	0
21	35040912	.	G	T	1	1	2	0	0	2	0	0
21	35040965	.	G	A	2	2	4	0	1	5	0	0
21	35048278	.	T	A	4	2	6	0	0	6	0	0
21	35048320	.	A	G	2	0	2	0	2	4	0	0
21	35051605	.	G	T	1	1	2	0	0	2	0	0
21	35054466	.	A	G	4	2	6	0	1	7	0	0
21	35054515	.	C	T	5	5	10	0	0	10	0	0
21	35054521	.	C	A	3	6	9	0	1	10	0	0
21	35055009	.	G	A	3	2	5	0	1	6	0	0
21	35078983	.	C	T	1	2	3	0	0	3	0	0
21	35279874	.	C	T	3	7	10	0	0	10	0	0
21	35280099	.	A	G	9	6	15	0	1	16	0	0
21	35280209	.	G	A	0	6	6	0	2	8	0	0
21	35280233	.	T	C	1	5	6	0	0	6	0	0
21	35280388	.	T	A	5	6	11	0	0	11	0	0
21	35280389	.	A	T	5	6	11	0	0	11	0	0
21	35280482	.	G	T	5	7	12	0	0	12	0	0
21	35280938	.	C	T	16	15	31	0	1	32	0	0
21	35281246	.	A	C	16	9	25	0	1	26	0	0
21	35305571	.	G	C	2	4	6	0	0	6	0	0
21	35652761	.	G	C	2	2	4	0	0	4	0	0
21	35653043	.	T	C	6	1	7	0	0	7	0	0
21	35653077	.	A	C	3	5	8	0	1	9	0	0
21	35653321	.	G	A	0	1	1	0	0	1	0	0
21	35677566	.	C	A	0	2	2	0	2	4	0	0
21	36386928	.	G	A	6	5	11	0	2	13	0	0
21	36387018	.	A	G	9	8	17	0	1	18	0	0
21	36387051	.	T	C	4	3	7	0	0	7	0	0
21	36392696	.	A	G	1	0	1	0	0	1	0	0
21	36413239	.	G	A	3	2	5	0	0	5	0	0
21	36413281	.	G	A	1	2	3	0	0	3	0	0
21	36417065	.	C	A	1	0	1	0	0	1	0	0
21	36419430	.	A	G	2	1	3	0	0	3	0	0
21	36435492	.	G	A	0	2	2	0	6	8	0	0
21	36435493	.	T	A	6	2	8	0	0	8	0	0
21	36435575	.	G	C	1	2	3	0	0	3	0	0
21	36435851	.	G	A	0	1	1	0	0	1	0	0
21	36435859	.	G	A	0	1	1	0	0	1	0	0
21	36439834	.	C	A	1	0	1	0	0	1	0	0
21	36442260	.	T	A	7	11	18	0	2	20	0	0
21	36442633	.	G	A	14	12	26	0	2	28	0	0
21	36446952	.	A	G	5	3	8	0	2	10	0	0
21	36449385	.	T	G	6	2	8	0	1	9	0	0
21	36449427	.	G	A	3	5	8	0	0	8	0	0
21	36449686	.	T	C	6	4	10	0	1	11	0	0
21	36449716	.	G	A	3	5	8	0	0	8	0	0
21	36465970	.	T	C	1	2	3	0	0	3	0	0
21	36468431	.	G	A	2	3	5	0	0	5	0	0
21	36474436	.	T	C	1	2	3	0	0	3	0	0
21	36474440	.	C	T	0	3	3	0	0	3	0	0
21	36496157	.	C	T	0	1	1	0	0	1	0	0
21	36496160	.	C	T	0	1	1	0	0	1	0	0
21	36570995	.	A	G	1	2	3	0	0	3	0	0
21	36592212	.	T	C	7	3	10	0	0	10	0	0
21	36598143	.	G	A	1	7	8	0	9	17	0	0
21	36598350	.	T	G	3	2	5	0	0	5	0	0
21	36598471	.	T	C	9	8	17	0	0	17	0	0
21	36598474	.	C	A	8	9	17	0	0	17	0	0
21	36598529	.	G	T	6	8	14	0	1	15	0	0
21	36598583	.	T	C	4	3	7	0	0	7	0	0
21	36598596	.	A	G	3	3	6	0	0	6	0	0
21	36598750	.	A	G	6	3	9	0	0	9	0	0
21	36598853	.	G	A	0	6	6	0	11	17	0	0
21	36598915	.	C	T	0	2	2	1	0	3	0	0
21	36598959	.	A	T	3	2	5	0	0	5	0	0
21	36599020	.	A	T	8	9	17	0	1	18	0	0
21	36599077	.	T	C	14	6	20	0	0	20	0	0
21	36599320	.	C	T	11	3	14	0	0	14	0	0
21	36599358	.	A	C	9	4	13	0	0	13	0	0
21	36599847	.	G	A	7	7	14	0	1	15	0	0
21	36599944	.	C	T	1	3	4	0	0	4	0	0
21	36600174	.	C	A	0	11	11	0	0	11	0	0
21	36612586	.	T	A	3	2	5	0	1	6	0	0
21	36612633	.	T	C	1	4	5	0	1	6	0	0
21	37107035	.	T	A	24	14	38	0	2	40	0	0
21	37107307	.	G	A	3	7	10	0	0	10	0	0
21	37107432	.	A	T	6	6	12	0	1	13	0	0
21	37107614	.	T	C	8	10	18	0	0	18	0	0
21	37107861	.	T	C	11	13	24	0	1	25	0	0
21	37108022	.	A	G	10	10	20	1	0	21	0	0
21	37108204	.	A	T	16	20	36	0	0	36	0	0
21	37637792	.	G	A	7	13	20	0	1	21	0	0
21	37637794	.	A	T	8	13	21	0	0	21	0	0
21	37640005	.	G	A	3	3	6	0	0	6	0	0
21	37650311	.	C	T	3	0	3	0	0	3	0	0
21	37686849	.	C	T	4	5	9	0	1	10	0	0
21	37686850	.	A	G	4	6	10	0	0	10	0	0
21	37687042	.	T	C	0	0	0	1	4	5	0	0
21	37687523	.	G	A	2	14	16	0	2	18	0	0
21	37687590	.	C	T	4	3	7	0	0	7	0	0
21	37687729	.	C	T	6	11	17	0	3	20	0	0
21	37689192	.	T	G	5	5	10	1	0	11	0	0
21	37690468	.	T	C	4	6	10	0	1	11	0	0
21	37693648	.	T	A	1	0	1	0	0	1	0	0
21	37733096	.	C	T	1	2	3	0	1	4	0	0
21	37733199	.	G	A	4	8	12	0	0	12	0	0
21	37788147	.	G	A	1	1	2	0	0	2	0	0
21	37822681	.	G	A	3	3	6	0	1	7	0	0
21	38013631	.	T	C	2	5	7	0	0	7	0	0
21	38587378	.	T	C	4	17	21	0	0	21	0	0
21	39511387	.	A	G	6	3	9	0	0	9	0	0
21	39972938	.	C	A	1	2	3	0	0	3	0	0
21	39973385	.	C	T	1	2	3	0	0	3	0	0
21	39973496	.	G	A	0	3	3	0	2	5	0	0
21	39973498	.	T	C	2	3	5	0	0	5	0	0
21	40045441	.	T	C	1	9	10	0	1	11	0	0
21	40045569	.	G	T	11	8	19	0	1	20	0	0
21	40045665	.	G	A	13	18	31	0	0	31	0	0
21	40045701	.	G	A	13	17	30	0	1	31	0	0
21	40045754	.	G	A	2	4	6	0	0	6	0	0
21	40048981	.	C	A	0	0	0	0	2	2	0	0
21	40049524	.	A	G	4	2	6	0	0	6	0	0
21	40049556	.	T	G	5	8	13	0	0	13	0	0
21	40053929	.	T	C	1	1	2	0	2	4	0	0
21	40144483	.	T	C	0	1	1	0	0	1	0	0
21	40167191	.	G	A	1	2	3	0	0	3	0	0
21	40354884	.	A	G	7	2	9	0	0	9	0	0
21	40354894	.	A	T	6	2	8	0	0	8	0	0
21	40355063	.	A	C	7	8	15	0	0	15	0	0
21	40355113	.	A	G	5	9	14	0	1	15	0	0
21	40355226	.	G	A	8	4	12	0	0	12	0	0
21	40355539	.	G	T	8	10	18	0	1	19	0	0
21	40355710	.	A	T	10	8	18	0	1	19	0	0
21	40355764	.	C	T	14	9	23	0	2	25	0	0
21	40355886	.	T	G	9	4	13	0	0	13	0	0
21	40356104	.	T	C	12	1	13	0	6	19	0	0
21	40365356	.	G	T	4	6	10	0	1	11	0	0
21	40365359	.	A	T	4	7	11	0	0	11	0	0
21	40365404	.	G	A	4	6	10	0	0	10	0	0
21	40368568	.	A	G	1	2	3	0	0	3	0	0
21	40368991	.	C	T	2	2	4	0	0	4	0	0
21	40373048	.	G	T	6	4	10	0	0	10	0	0
21	40373049	.	G	T	6	4	10	0	0	10	0	0
21	40373283	.	C	G	2	2	4	0	1	5	0	0
21	40376536	.	G	A	1	1	2	0	0	2	0	0
21	40389761	.	G	T	3	0	3	0	0	3	0	0
21	40391928	.	G	A	1	2	3	0	0	3	0	0
21	40402644	.	G	A	4	2	6	0	0	6	0	0
21	40402864	.	C	T	0	6	6	0	14	20	0	0
21	40403465	.	G	A	13	7	20	0	2	22	0	0
21	40406485	.	A	G	2	1	3	0	0	3	0	0
21	40411061	.	C	T	2	3	5	0	0	5	0	0
21	40466539	.	A	G	4	0	4	0	4	8	0	0
21	40475370	.	A	G	2	0	2	0	5	7	0	0
21	40475563	.	C	G	5	3	8	0	2	10	0	0
21	40528986	.	C	T	19	21	40	0	0	40	0	0
21	40530901	.	A	G	11	20	31	0	3	34	0	0
21	40531101	.	T	C	11	0	11	0	9	20	0	0
21	40531110	.	C	T	8	7	15	0	2	17	0	0
21	40531217	.	A	C	6	10	16	0	0	16	0	0
21	40531240	.	C	T	0	10	10	0	4	14	0	0
21	40531328	.	T	C	8	23	31	0	0	31	0	0
21	40532139	.	A	T	4	12	16	0	0	16	0	0
21	40532206	.	T	C	7	5	12	0	0	12	0	0
21	40532312	.	A	G	5	3	8	0	0	8	0	0
21	40532328	.	A	G	2	3	5	0	0	5	0	0
21	40532551	.	C	T	1	4	5	0	5	10	0	0
21	40532584	.	T	G	4	10	14	0	0	14	0	0
21	40532649	.	T	C	4	1	5	0	10	15	0	0
21	40532662	.	T	C	5	0	5	0	7	12	0	0
21	40532886	.	T	C	2	8	10	0	0	10	0	0
21	40532891	.	A	G	1	8	9	0	0	9	0	0
21	40532931	.	G	C	6	7	13	1	0	14	0	0
21	40532989	.	A	G	7	7	14	0	0	14	0	0
21	40532990	.	T	A	7	7	14	0	0	14	0	0
21	40533313	.	C	T	2	6	8	0	0	8	0	0
21	40533456	.	A	G	8	3	11	0	0	11	0	0
21	40537149	.	C	T	5	7	12	0	2	14	0	0
21	40537152	.	G	A	4	8	12	0	2	14	0	0
21	40553288	.	A	G	3	6	9	0	0	9	0	0
21	40553356	.	G	T	1	4	5	0	0	5	0	0
21	40553365	.	C	T	1	3	4	0	0	4	0	0
21	40553497	.	G	A	3	1	4	0	0	4	0	0
21	40619271	.	A	T	1	3	4	0	1	5	0	0
21	40619300	.	G	A	1	0	1	0	0	1	0	0
21	40671190	.	C	T	2	2	4	0	0	4	0	0
21	40671271	.	T	A	2	2	4	0	0	4	0	0
21	40671292	.	T	C	2	0	2	0	2	4	0	0
21	40686004	.	T	A	3	5	8	0	2	10	0	0
21	40686010	.	G	C	4	3	7	0	0	7	0	0
21	40686139	.	C	T	3	5	8	0	0	8	0	0
21	40691449	.	A	G	9	0	9	0	9	18	0	0
21	40703190	.	C	T	2	0	2	0	0	2	0	0
21	40703402	.	A	C	7	14	21	0	1	22	0	0
21	40703445	.	G	A	0	8	8	0	8	16	0	0
21	40708974	.	T	A	5	23	28	0	1	29	0	0
21	40708978	.	C	A	5	25	30	0	0	30	0	0
21	40709069	.	G	A	6	4	10	0	0	10	0	0
21	40709089	.	G	A	5	4	9	0	0	9	0	0
21	40709140	.	A	T	5	5	10	0	0	10	0	0
21	40714691	.	C	T	4	14	18	0	0	18	0	0
21	40715622	.	A	G	0	1	1	0	0	1	0	0
21	40715730	.	T	C	2	6	8	0	0	8	0	0
21	40715808	.	A	G	4	3	7	0	1	8	0	0
21	40731482	.	A	G	0	1	1	0	0	1	0	0
21	40930179	.	G	A	6	7	13	0	4	17	0	0
21	40930469	.	T	C	3	1	4	0	3	7	0	0
21	40930528	.	C	A	5	6	11	0	0	11	0	0
21	40930650	.	T	A	9	8	17	0	0	17	0	0
21	40930651	.	G	A	9	8	17	0	0	17	0	0
21	40931215	.	A	G	2	3	5	0	0	5	0	0
21	40931236	.	T	C	1	0	1	0	0	1	0	0
21	40932888	.	T	A	6	5	11	0	0	11	0	0
21	40934586	.	G	A	3	8	11	0	0	11	0	0
21	40934703	.	T	C	2	0	2	0	4	6	0	0
21	40936548	.	A	G	1	1	2	0	0	2	0	0
21	40959490	.	T	C	3	2	5	0	0	5	0	0
21	40959517	.	C	A	4	3	7	0	0	7	0	0
21	41040366	.	A	G	0	2	2	0	0	2	0	0
21	41311052	.	T	A	3	2	5	0	0	5	0	0
21	41311053	.	T	A	3	2	5	0	0	5	0	0
21	41312822	.	C	G	25	18	43	0	2	45	0	0
21	41313042	.	A	G	14	17	31	0	4	35	0	0
21	41313124	.	G	A	22	14	36	0	0	36	0	0
21	41313216	.	G	A	13	17	30	0	3	33	0	0
21	41313257	.	T	C	25	14	39	0	1	40	0	0
21	41316974	.	C	T	13	15	28	0	3	31	0	0
21	41323551	.	C	T	0	0	0	0	3	3	0	0
21	41599060	.	T	C	1	7	8	0	0	8	0	0
21	41600295	.	T	C	5	0	5	0	3	8	0	0
21	41601180	.	T	C	2	4	6	0	0	6	0	0
21	42046839	.	T	A	0	15	15	3	0	18	0	0
21	42046969	.	G	A	0	9	9	11	0	20	0	0
21	42777772	.	T	C	1	2	3	0	0	3	0	0
21	42778937	.	G	A	5	7	12	0	0	12	0	0
21	42779096	.	C	T	5	3	8	0	0	8	0	0
21	42779259	.	A	G	3	1	4	0	1	5	0	0
21	42779260	.	T	G	2	2	4	0	1	5	0	0
21	42779684	.	G	T	2	6	8	0	0	8	0	0
21	42971463	.	T	C	27	16	43	0	12	55	0	0
21	43032261	.	T	G	4	1	5	0	8	13	0	0
21	43363939	.	A	G	1	0	1	0	0	1	0	0
21	43363957	.	G	C	1	0	1	0	0	1	0	0
21	43374543	.	C	T	4	2	6	0	0	6	0	0
21	43420623	.	T	C	1	0	1	0	10	11	0	0
21	43461392	.	T	C	3	5	8	0	0	8	0	0
21	43461434	.	T	C	3	2	5	0	0	5	0	0
21	43477593	.	T	C	23	8	31	0	0	31	0	0
21	43477856	.	T	C	8	9	17	0	0	17	0	0
21	43477858	.	T	C	8	9	17	0	0	17	0	0
21	43477894	.	T	C	16	4	20	0	1	21	0	0
21	43505699	.	G	A	2	2	4	0	0	5	1	0
21	43505877	.	A	G	1	2	3	0	0	3	0	0
21	43506620	.	A	G	3	5	8	0	0	8	0	0
21	43506854	.	G	A	0	2	2	0	1	3	0	0
21	43506860	.	T	C	1	2	3	0	0	3	0	0
21	43506966	.	T	G	2	4	6	0	2	8	0	0
21	43506980	.	G	A	3	4	7	0	0	7	0	0
21	43507055	.	A	G	3	2	5	0	0	5	0	0
21	43507058	.	C	T	3	2	5	0	0	5	0	0
21	43507114	.	T	G	6	6	12	0	0	12	0	0
21	43507142	.	A	G	5	0	5	0	7	12	0	0
21	43507768	.	C	A	3	2	5	0	0	5	0	0
21	43507954	.	A	G	2	1	3	0	0	3	0	0
21	43508293	.	A	T	9	3	12	0	0	12	0	0
21	43508297	.	C	T	9	3	12	0	0	12	0	0
21	43515692	.	C	T	0	4	4	0	2	6	0	0
21	43515698	.	C	T	0	6	6	0	2	8	0	0
21	43515778	.	A	T	2	7	9	0	0	9	0	0
21	43524271	.	G	A	11	9	20	0	1	21	0	0
21	43524778	.	T	C	12	11	23	0	0	23	0	0
21	43525429	.	T	C	3	2	5	0	1	6	0	0
21	43525618	.	T	G	4	8	12	0	0	12	0	0
21	43525861	.	G	A	8	7	15	0	0	15	0	0
21	43525909	.	C	T	0	6	6	0	8	14	0	0
21	43525978	.	G	A	2	2	4	0	1	5	0	0
21	43526434	.	G	C	1	2	3	0	0	3	0	0
21	43536532	.	A	G	5	8	13	0	3	16	0	0
21	43536592	.	G	A	5	6	11	0	0	11	0	0
21	43537073	.	C	T	0	2	2	0	2	4	0	0
21	43537082	.	G	A	2	4	6	0	0	6	0	0
21	43539461	.	G	C	6	0	6	0	5	11	0	0
21	43540090	.	G	T	4	5	9	0	1	10	0	0
21	43540412	.	G	C	3	0	3	0	4	7	0	0
21	43581478	.	A	G	14	13	27	0	1	28	0	0
21	43581505	.	T	C	14	0	14	0	17	31	0	0
21	43581606	.	A	G	13	13	26	0	1	27	0	0
21	43584745	.	G	A	17	14	31	0	2	33	0	0
21	43584822	.	A	G	13	25	38	0	0	38	0	0
21	43586774	.	C	T	0	18	18	0	8	26	0	0
21	43588112	.	T	C	2	7	9	0	0	9	0	0
21	43588136	.	G	C	1	0	1	0	2	3	0	0
21	43595318	.	G	A	9	15	24	0	1	25	0	0
21	43595384	.	C	T	4	2	6	0	0	6	0	0
21	43606392	.	T	A	2	0	2	0	0	2	0	0
21	43685025	.	C	T	1	2	3	0	0	3	0	0
21	43688783	.	G	A	2	3	5	0	0	5	0	0
21	43695580	.	T	C	0	4	4	0	0	4	0	0
21	43704161	.	T	C	1	1	2	0	0	2	0	0
21	43705848	.	G	A	0	7	7	0	3	10	0	0
21	43705866	.	G	A	4	7	11	0	1	12	0	0
21	43705893	.	C	T	3	4	7	0	0	7	0	0
21	43709743	.	T	C	1	4	5	0	0	5	0	0
21	43710834	.	A	C	3	2	5	0	0	5	0	0
21	43710842	.	A	G	3	0	3	0	1	4	0	0
21	43713566	.	A	G	3	0	3	0	3	6	0	0
21	43886259	.	C	A	0	2	2	0	1	3	0	0
21	43891196	.	A	G	2	4	6	0	0	6	0	0
21	43891376	.	A	T	1	2	3	0	0	3	0	0
21	43897365	.	C	T	19	33	52	0	2	54	0	0
21	43900196	.	T	C	15	17	32	0	1	33	0	0
21	43920541	.	A	G	2	4	6	0	0	6	0	0
21	43926773	.	C	A	1	0	1	0	0	1	0	0
21	43952949	.	G	T	5	5	10	0	0	10	0	0
21	44005548	.	G	A	3	8	11	0	0	11	0	0
21	44005583	.	G	A	5	25	30	0	1	31	0	0
21	44005587	.	A	C	6	25	31	0	3	34	0	0
21	44005637	.	T	G	5	15	20	0	1	21	0	0
21	44013498	.	A	T	1	2	3	0	0	3	0	0
21	44022008	.	T	A	16	19	35	0	1	36	0	0
21	44022014	.	A	G	17	16	33	0	1	34	0	0
21	44025907	.	A	G	16	22	38	0	1	39	0	0
21	44028691	.	G	A	21	20	41	0	0	41	0	0
21	44028755	.	C	A	10	21	31	0	6	37	0	0
21	44031139	.	T	C	2	4	6	0	0	6	0	0
21	44031145	.	T	A	2	4	6	0	0	6	0	0
21	44036872	.	A	T	4	9	13	0	0	13	0	0
21	44036912	.	A	C	5	17	22	0	0	22	0	0
21	44036984	.	T	A	14	15	29	0	0	29	0	0
21	44037011	.	T	A	12	14	26	0	3	29	0	0
21	44037040	.	G	A	1	13	14	0	6	20	0	0
21	44037046	.	A	G	7	1	8	0	10	18	0	0
21	44037090	.	A	G	1	6	7	0	1	8	0	0
21	44037092	.	A	G	2	1	3	0	5	8	0	0
21	44687941	.	A	G	14	0	14	0	21	35	0	0
21	44687949	.	T	C	12	17	29	0	2	31	0	0
21	44688711	.	G	A	16	11	27	0	1	28	0	0
21	44689277	.	A	T	8	12	20	0	1	21	0	0
21	44689476	.	C	T	16	14	30	0	2	32	0	0
21	44689503	.	A	T	20	18	38	0	0	38	0	0
21	44689528	.	A	G	17	0	17	0	19	36	0	0
21	44689655	.	C	T	16	8	24	0	3	27	0	0
21	44690520	.	A	G	23	1	24	0	14	38	0	0
21	44933461	.	G	T	0	2	2	0	1	3	0	0
21	45017302	.	C	A	0	1	1	0	0	1	0	0
21	45017303	.	G	A	0	1	1	0	0	1	0	0
21	45043527	.	G	T	7	7	14	0	0	14	0	0
21	45043548	.	G	A	8	8	16	0	0	16	0	0
21	45043590	.	T	C	6	0	6	0	4	10	0	0
21	45043611	.	A	G	4	3	7	0	0	7	0	0
21	45052584	.	G	A	3	1	4	0	1	5	0	0
21	45054887	.	G	A	1	1	2	0	2	4	0	0
21	45058331	.	T	G	3	6	9	0	0	9	0	0
21	45059466	.	T	A	3	5	8	0	0	8	0	0
21	45061877	.	G	T	4	2	6	0	0	6	0	0
21	45061889	.	G	A	2	5	7	0	0	7	0	0
21	45068223	.	T	C	2	1	3	0	1	4	0	0
21	45107329	.	G	A	0	1	1	0	0	1	0	0
21	45114489	.	G	T	0	4	4	0	4	8	0	0
21	45114642	.	T	A	1	4	5	0	1	6	0	0
21	45114657	.	A	G	2	0	2	0	6	8	0	0
21	45114735	.	T	A	0	2	2	0	0	2	0	0
21	45114925	.	G	A	0	3	3	0	2	5	0	0
21	45115228	.	A	G	1	2	3	0	0	3	0	0
21	45115265	.	C	A	3	1	4	0	1	5	0	0
21	45117422	.	A	G	4	4	8	0	1	9	0	0
21	45117430	.	T	A	2	6	8	0	1	9	0	0
21	45117465	.	T	C	2	4	6	0	0	6	0	0
21	45117469	.	T	G	2	4	6	0	0	6	0	0
21	45182311	.	A	T	3	2	5	0	0	5	0	0
21	45182488	.	G	A	3	4	7	0	0	7	0	0
21	45182687	.	T	C	8	4	12	0	1	13	0	0
21	45186175	.	G	A	14	10	24	0	1	25	0	0
21	45187072	.	T	G	6	7	13	0	0	13	0	0
21	45187123	.	C	T	6	4	10	0	0	10	0	0
21	45190704	.	A	G	18	35	53	0	1	54	0	0
21	45190766	.	T	A	29	31	60	0	1	61	0	0
21	45190861	.	A	T	26	25	51	0	1	52	0	0
21	45190926	.	C	T	29	17	46	0	1	47	0	0
21	45193365	.	G	A	5	4	9	0	1	10	0	0
21	45341958	.	A	T	14	33	47	0	4	51	0	0
21	45342043	.	G	T	28	31	59	0	1	60	0	0
21	45349469	.	G	A	6	7	13	0	0	13	0	0
21	45352211	.	G	A	27	7	34	0	3	37	0	0
21	45352212	.	G	A	28	8	36	0	1	37	0	0
21	45352415	.	C	T	1	10	11	0	15	26	0	0
21	45359397	.	G	A	21	14	35	0	0	35	0	0
21	45363684	.	C	T	15	14	29	0	0	29	0	0
21	45363728	.	C	T	21	20	41	0	0	41	0	0
21	45363778	.	T	G	19	23	42	0	1	43	0	0
21	45366262	.	T	A	4	4	8	0	1	9	0	0
21	45366301	.	A	C	5	12	17	0	0	17	0	0
21	45374413	.	C	A	10	11	21	0	0	21	0	0
21	45374509	.	T	C	6	9	15	0	0	15	0	0
21	45374583	.	A	T	2	4	6	0	1	7	0	0
21	45374725	.	G	A	5	10	15	0	0	15	0	0
21	45374747	.	T	G	3	12	15	0	0	15	0	0
21	45374928	.	A	G	15	5	20	0	0	20	0	0
21	45375109	.	G	T	6	5	11	0	0	11	0	0
21	45375144	.	G	A	6	3	9	0	0	9	0	0
21	45377351	.	G	T	4	11	15	0	0	15	0	0
21	45377404	.	T	C	10	12	22	0	0	22	0	0
21	45377409	.	T	C	11	13	24	0	0	24	0	0
21	45377546	.	G	A	13	9	22	0	0	22	0	0
21	45377604	.	T	G	10	7	17	0	2	19	0	0
21	45377685	.	G	A	15	12	27	0	1	28	0	0
21	45382162	.	G	A	1	2	3	0	0	3	0	0
21	45410118	.	T	C	2	4	6	0	0	6	0	0
21	45544108	.	C	T	5	4	9	0	0	9	0	0
21	45544374	.	C	T	4	4	8	0	2	10	0	0
21	45544615	.	T	A	3	3	6	0	0	6	0	0
21	45544616	.	G	A	3	3	6	0	0	6	0	0
21	45547147	.	C	T	2	5	7	0	0	7	0	0
21	45549075	.	A	G	4	3	7	0	0	7	0	0
21	45550066	.	G	A	0	10	10	0	6	16	0	0
21	45550122	.	A	G	5	0	5	0	6	11	0	0
21	45550156	.	T	C	5	3	8	0	0	8	0	0
21	45550163	.	T	G	4	1	5	0	3	8	0	0
21	45550242	.	T	C	7	2	9	0	0	9	0	0
21	45550244	.	C	G	5	3	8	0	1	9	0	0
21	45550354	.	C	T	2	6	8	0	0	8	0	0
21	45550450	.	C	T	1	3	4	0	0	4	0	0
21	45550454	.	G	C	1	3	4	0	0	4	0	0
21	45550527	.	C	G	4	3	7	0	0	7	0	0
21	45550734	.	T	C	4	4	8	0	0	8	0	0
21	45550736	.	C	T	4	4	8	0	0	8	0	0
21	45550928	.	A	T	5	7	12	0	0	12	0	0
21	45551011	.	T	A	3	4	7	0	0	7	0	0
21	45551014	.	T	C	3	3	6	0	1	7	0	0
21	45551095	.	A	C	3	5	8	0	0	8	0	0
21	45551096	.	G	A	3	5	8	0	0	8	0	0
21	45551386	.	G	C	1	6	7	0	0	7	0	0
21	45551391	.	A	G	1	6	7	0	0	7	0	0
21	45551421	.	T	C	3	4	7	0	0	7	0	0
21	45551606	.	T	A	5	3	8	0	0	8	0	0
21	45551620	.	C	T	3	3	6	0	0	6	0	0
21	45551785	.	G	A	1	6	7	0	0	7	0	0
21	45551845	.	C	T	6	3	9	0	0	9	0	0
21	45551972	.	G	A	0	11	11	0	6	17	0	0
21	45552187	.	T	C	11	10	21	0	1	22	0	0
21	45552282	.	T	C	8	9	17	0	4	21	0	0
21	45552286	.	C	T	10	8	18	0	1	19	0	0
21	45552676	.	G	A	13	11	24	0	0	24	0	0
21	45552924	.	C	T	10	11	21	0	1	22	0	0
21	45582048	.	T	C	10	18	28	0	3	31	0	0
21	45582907	.	A	G	6	4	10	0	0	10	0	0
21	45582931	.	G	A	3	3	6	0	0	6	0	0
21	45584817	.	C	T	2	1	3	0	1	4	0	0
21	45586600	.	A	G	2	3	5	0	0	5	0	0
21	45591105	.	A	G	4	6	10	0	1	11	0	0
21	45597559	.	A	T	1	1	2	0	0	2	0	0
21	45598671	.	G	A	2	2	4	0	0	4	0	0
21	45599335	.	C	G	1	1	2	0	0	2	0	0
21	45599379	.	G	A	3	2	5	0	0	5	0	0
21	45628374	.	G	A	0	4	4	0	4	8	0	0
21	45628486	.	C	A	2	3	5	0	0	5	0	0
21	45629420	.	T	C	0	3	3	0	0	3	0	0
21	45632866	.	T	C	1	3	4	0	0	4	0	0
21	45673826	.	G	A	12	20	32	0	0	32	0	0
21	45674321	.	T	C	12	34	46	0	0	46	0	0
21	45674488	.	C	T	0	7	7	0	6	13	0	0
21	45687940	.	T	C	0	1	1	0	0	1	0	0
21	45694166	.	C	T	3	3	6	0	0	6	0	0
21	45696135	.	C	T	1	1	2	0	0	2	0	0
21	45696164	.	G	A	0	1	1	0	1	2	0	0
21	45699347	.	T	A	2	4	6	0	0	7	1	0
21	45703234	.	C	G	2	1	3	0	0	3	0	0
21	45703316	.	T	C	4	2	6	0	0	6	0	0
21	45704975	.	C	T	8	1	9	0	0	9	0	0
21	45704999	.	C	T	5	0	5	0	0	5	0	0
21	45705267	.	T	C	3	4	7	0	0	7	0	0
21	45705276	.	T	C	4	4	8	0	0	8	0	0
21	45705375	.	A	G	3	2	5	0	0	5	0	0
21	45705948	.	T	C	1	2	3	0	0	3	0	0
21	45707154	.	T	C	1	1	2	0	0	2	0	0
21	45707734	.	T	C	2	2	4	0	0	4	0	0
21	45714390	.	T	C	10	7	17	0	0	17	0	0
21	45715241	.	T	C	20	27	47	0	1	48	0	0
21	45715271	.	G	A	24	5	29	1	16	46	0	0
21	45715558	.	G	C	11	4	15	0	0	15	0	0
21	45716032	.	T	C	8	1	9	0	1	10	0	0
21	45716112	.	A	G	4	7	11	0	0	11	0	0
21	45719205	.	T	G	6	0	6	0	14	20	0	0
21	45721245	.	T	C	8	5	13	0	0	13	0	0
21	45721246	.	C	G	8	0	8	0	5	13	0	0
21	45721760	.	G	A	8	6	14	0	0	14	0	0
21	45723174	.	G	C	2	0	2	0	0	2	0	0
21	45726391	.	C	T	4	2	6	0	0	6	0	0
21	45726600	.	C	T	2	2	4	0	0	4	0	0
21	45728723	.	T	G	13	11	24	0	0	24	0	0
21	45728774	.	T	C	7	8	15	0	1	16	0	0
21	45729365	.	C	G	6	10	16	0	0	16	0	0
21	45730150	.	G	C	25	20	45	0	0	45	0	0
21	45732018	.	C	G	9	11	20	0	0	20	0	0
21	45733905	.	C	T	13	13	26	0	0	26	0	0
21	45734044	.	T	C	2	1	3	0	0	3	0	0
21	45735918	.	G	A	0	3	3	0	3	6	0	0
21	45736157	.	T	G	17	0	17	0	11	28	0	0
21	45736179	.	T	C	15	11	26	0	0	26	0	0
21	45736244	.	T	C	13	16	29	0	3	32	0	0
21	45736463	.	T	A	8	10	18	0	2	20	0	0
21	45737960	.	T	G	11	6	17	0	0	17	0	0
21	45738043	.	T	C	7	12	19	0	0	19	0	0
21	45738046	.	T	C	6	11	17	0	1	18	0	0
21	45738125	.	C	T	8	7	15	0	1	16	0	0
21	45738525	.	G	A	1	9	10	0	25	35	0	0
21	45738592	.	T	C	12	8	20	0	0	20	0	0
21	45738658	.	A	C	6	13	19	0	1	20	0	0
21	45738775	.	A	G	10	17	27	0	0	27	0	0
21	45738852	.	G	A	18	14	32	0	1	33	0	0
21	45738856	.	C	T	19	14	33	0	0	33	0	0
21	45738945	.	A	G	17	0	17	0	13	30	0	0
21	45739074	.	A	C	13	14	27	0	0	27	0	0
21	45739087	.	A	C	16	14	30	0	0	30	0	0
21	45739125	.	A	G	17	14	31	0	1	32	0	0
21	45739139	.	C	T	16	12	28	0	0	28	0	0
21	45739169	.	T	A	14	10	24	0	1	25	0	0
21	45739235	.	T	C	7	8	15	0	2	17	0	0
21	45739519	.	C	G	13	7	20	0	3	23	0	0
21	45739613	.	A	T	16	11	27	0	1	28	0	0
21	45739642	.	G	A	1	11	12	0	21	33	0	0
21	45739724	.	A	T	21	17	38	0	3	42	1	0
21	45758525	.	T	A	6	3	9	0	0	9	0	0
21	45761690	.	A	T	1	0	1	0	0	1	0	0
21	45765797	.	A	C	1	1	2	0	0	2	0	0
21	45765889	.	C	T	3	1	4	0	0	4	0	0
21	45767470	.	C	A	1	2	3	0	0	3	0	0
21	45767676	.	A	T	1	5	6	0	0	6	0	0
21	45767758	.	C	G	3	4	7	0	0	7	0	0
21	45767848	.	T	A	2	2	4	0	0	4	0	0
21	45767920	.	G	A	0	2	2	0	5	7	0	0
21	45767965	.	A	T	7	4	11	0	1	12	0	0
21	45768031	.	G	A	1	1	2	0	5	7	0	0
21	45768043	.	T	C	2	2	4	0	1	5	0	0
21	45768114	.	G	C	6	2	8	0	1	9	0	0
21	45768220	.	A	G	7	4	11	0	0	11	0	0
21	45768260	.	T	A	4	7	11	0	0	11	0	0
21	45768317	.	A	C	4	5	9	0	0	9	0	0
21	45768462	.	A	G	8	10	18	0	0	18	0	0
21	45768597	.	G	C	10	4	14	0	1	15	0	0
21	45769130	.	C	G	15	6	21	0	0	21	0	0
21	45769199	.	C	A	9	11	20	0	2	22	0	0
21	45838304	.	C	T	12	14	26	0	0	26	0	0
21	45839258	.	A	G	12	17	29	0	0	29	0	0
21	45840307	.	C	A	0	7	7	0	5	13	1	0
21	45840317	.	G	T	5	7	12	0	1	13	0	0
21	45848701	.	T	C	1	7	8	0	0	8	0	0
21	45850905	.	G	A	0	5	5	0	11	16	0	0
21	45851180	.	T	C	8	13	21	0	0	21	0	0
21	45851493	.	A	T	14	4	18	0	0	19	1	0
21	45851496	.	A	C	15	4	19	0	1	20	0	0
21	45851563	.	A	C	16	17	33	0	1	34	0	0
21	45856614	.	G	A	6	3	9	0	0	9	0	0
21	45857425	.	G	A	1	3	4	0	0	4	0	0
21	45857954	.	T	G	8	11	19	0	0	19	0	0
21	45859589	.	C	T	5	6	11	0	1	12	0	0
21	45860602	.	A	G	1	0	1	0	0	1	0	0
21	45863053	.	G	A	8	11	19	0	1	20	0	0
21	45865174	.	C	T	11	8	19	0	0	19	0	0
21	45866065	.	G	A	10	8	18	0	0	18	0	0
21	45866066	.	G	A	10	8	18	0	0	18	0	0
21	45876230	.	T	C	9	8	17	0	0	17	0	0
21	45876253	.	A	T	8	10	18	0	1	19	0	0
21	45876638	.	A	G	8	0	8	0	3	25	14	0
21	45876642	.	C	A	0	13	13	0	13	26	0	0
21	45905088	.	T	C	5	8	13	0	0	13	0	0
21	45905257	.	C	G	2	5	7	0	1	8	0	0
21	45907386	.	T	C	0	1	1	0	0	1	0	0
21	45907392	.	G	C	0	0	0	0	1	1	0	0
21	45914107	.	C	A	1	0	1	0	0	1	0	0
21	45914182	.	A	G	0	3	3	0	0	3	0	0
21	45916436	.	C	T	3	6	9	0	0	9	0	0
21	45919139	.	G	T	3	2	5	0	0	5	0	0
21	45919290	.	C	T	3	3	6	0	0	6	0	0
22	6910	.	A	G	0	2	2	0	0	2	0	0
22	11433	.	T	C	0	3	3	0	2	5	0	0
22	13985	.	C	T	4	13	17	0	1	18	0	0
22	13988	.	C	T	4	15	19	0	1	20	0	0
22	14278	.	C	T	18	10	28	0	3	31	0	0
22	15785	.	T	C	24	34	58	0	7	65	0	0
22	15819	.	T	C	28	29	57	0	6	63	0	0
22	15855	.	A	G	28	3	31	0	23	54	0	0
22	15860	.	C	G	29	24	53	0	1	54	0	0
22	15950	.	A	G	12	0	12	0	28	40	0	0
22	16047	.	G	A	12	19	31	0	4	35	0	0
22	16297	.	C	G	8	9	17	0	0	17	0	0
22	16538	.	A	G	6	0	6	0	4	10	0	0
22	23325	.	C	T	3	3	6	0	0	6	0	0
22	23380	.	C	A	2	5	7	0	1	8	0	0
22	23417	.	C	T	3	6	9	0	0	9	0	0
22	23706	.	A	T	2	4	6	0	1	7	0	0
22	23842	.	A	C	5	6	11	0	0	11	0	0
22	23916	.	A	T	9	12	21	0	2	23	0	0
22	24117	.	C	T	6	4	10	0	0	10	0	0
22	24237	.	T	C	0	2	2	0	1	3	0	0
22	44474	.	T	C	2	4	6	0	1	7	0	0
22	44508	.	A	C	2	3	5	0	0	5	0	0
22	44529	.	G	A	3	3	6	0	0	6	0	0
22	44826	.	A	T	3	9	12	0	1	13	0	0
22	46997	.	T	C	6	4	10	0	2	12	0	0
22	47177	.	G	A	2	6	8	0	0	8	0	0
22	89749	.	T	A	2	3	5	0	0	5	0	0
22	89779	.	T	G	1	3	4	0	0	4	0	0
22	89795	.	T	G	1	3	4	0	0	4	0	0
22	90083	.	A	C	6	11	17	0	2	19	0	0
22	90084	.	C	A	0	11	11	0	7	19	1	0
22	94323	.	C	A	7	7	14	0	1	16	1	0
22	94699	.	A	G	5	1	6	0	4	11	1	0
22	94817	.	A	C	1	6	7	0	3	10	0	0
22	96200	.	C	T	1	5	6	0	0	6	0	0
22	96852	.	T	C	0	4	4	0	0	4	0	0
22	96959	.	T	C	5	8	13	0	4	17	0	0
22	97325	.	T	G	2	0	2	0	2	4	0	0
22	97346	.	G	T	0	4	4	0	2	6	0	0
22	97565	.	A	G	8	11	19	0	0	19	0	0
22	101661	.	C	T	3	0	3	0	0	3	0	0
22	102261	.	C	A	17	13	30	0	1	31	0	0
22	105466	.	C	A	5	7	12	0	1	13	0	0
22	105548	.	T	G	3	0	3	0	6	9	0	0
22	105584	.	G	A	0	4	4	0	1	5	0	0
22	106007	.	T	C	1	4	5	0	0	5	0	0
22	107916	.	G	A	0	1	1	0	1	2	0	0
22	108003	.	G	A	3	4	7	0	1	8	0	0
22	108186	.	A	G	1	0	1	0	0	1	0	0
22	108407	.	A	G	2	0	2	0	0	2	0	0
22	110280	.	A	G	1	2	3	0	0	3	0	0
22	119417	.	G	A	11	4	15	0	0	15	0	0
22	119441	.	T	C	8	2	10	0	0	10	0	0
22	130115	.	C	T	11	4	15	0	1	16	0	0
22	133647	.	T	C	3	0	3	0	4	7	0	0
22	134008	.	C	T	0	14	14	0	12	26	0	0
22	134272	.	T	C	16	18	34	0	4	38	0	0
22	134353	.	T	C	12	16	28	0	0	28	0	0
22	134563	.	T	C	12	0	12	0	16	28	0	0
22	134848	.	C	A	17	9	26	0	0	26	0	0
22	134950	.	G	A	11	10	21	0	2	23	0	0
22	135045	.	C	T	11	8	19	0	1	20	0	0
22	135214	.	C	A	1	10	11	0	14	25	0	0
22	135678	.	T	C	10	5	15	0	0	15	0	0
22	135684	.	A	G	9	5	14	0	0	14	0	0
22	136183	.	T	A	7	3	10	0	0	10	0	0
22	136552	.	C	A	0	2	2	0	3	5	0	0
22	137259	.	T	C	2	9	11	0	0	11	0	0
22	137786	.	G	A	3	2	5	0	0	5	0	0
22	138339	.	C	A	0	4	4	0	1	5	0	0
22	138505	.	G	A	2	3	5	0	0	5	0	0
22	138684	.	A	G	1	2	3	0	0	3	0	0
22	139069	.	G	A	2	3	5	0	0	5	0	0
22	139396	.	T	A	1	2	3	0	0	3	0	0
22	139474	.	G	A	3	3	6	0	1	7	0	0
22	139538	.	G	A	3	2	5	0	0	5	0	0
22	139562	.	G	A	3	2	5	0	0	5	0	0
22	140080	.	G	A	1	2	3	0	0	3	0	0
22	140308	.	T	C	1	0	1	0	2	3	0	0
22	141177	.	G	A	1	1	2	0	0	2	0	0
22	144801	.	T	C	1	2	3	0	0	3	0	0
22	158468	.	A	T	2	4	6	0	0	6	0	0
22	158472	.	T	A	3	3	6	0	0	6	0	0
22	192443	.	G	A	9	17	26	0	4	30	0	0
22	192713	.	C	T	0	3	3	0	15	18	0	0
22	192754	.	A	G	7	10	17	0	2	19	0	0
22	192953	.	A	G	13	12	25	0	1	26	0	0
22	193193	.	A	C	4	0	4	0	7	11	0	0
22	336325	.	T	C	14	27	41	0	1	42	0	0
22	336378	.	A	G	0	5	5	0	1	6	0	0
22	337063	.	A	G	19	18	37	0	2	39	0	0
22	337121	.	A	C	4	4	8	0	19	27	0	0
22	337124	.	A	C	7	1	8	0	19	27	0	0
22	337457	.	T	C	17	9	26	0	7	33	0	0
22	337606	.	G	T	15	12	27	0	1	28	0	0
22	337607	.	T	G	15	13	28	0	0	28	0	0
22	337705	.	C	T	16	12	28	0	1	29	0	0
22	337918	.	G	T	5	13	18	0	0	18	0	0
22	338187	.	G	A	22	11	33	0	4	37	0	0
22	338199	.	G	T	5	12	17	0	27	44	0	0
22	338226	.	C	T	28	8	36	0	0	36	0	0
22	338431	.	C	T	11	11	22	0	1	23	0	0
22	342257	.	G	C	10	0	10	0	4	14	0	0
22	344977	.	T	G	4	2	6	0	0	6	0	0
22	345794	.	C	G	6	9	15	0	0	15	0	0
22	346601	.	C	T	1	5	6	0	0	6	0	0
22	349378	.	G	A	17	37	54	0	1	55	0	0
22	354076	.	G	C	12	12	24	0	1	25	0	0
22	354269	.	T	C	18	11	29	0	1	30	0	0
22	354272	.	C	T	16	12	28	0	1	29	0	0
22	354466	.	C	T	18	11	29	0	4	33	0	0
22	354509	.	T	G	13	12	25	0	1	26	0	0
22	360302	.	A	G	10	5	15	0	0	15	0	0
22	367517	.	A	G	16	11	27	0	1	28	0	0
22	371121	.	T	G	6	13	19	0	0	19	0	0
22	371141	.	G	C	11	12	23	0	1	24	0	0
22	371689	.	C	T	20	16	36	0	3	39	0	0
22	371926	.	C	T	0	9	9	0	12	21	0	0
22	371933	.	T	C	13	0	13	0	7	20	0	0
22	404666	.	T	C	7	2	9	0	1	10	0	0
22	405177	.	T	C	4	7	11	0	1	12	0	0
22	426243	.	C	T	1	2	3	0	0	3	0	0
22	431242	.	C	T	3	2	5	0	0	5	0	0
22	431314	.	T	C	1	2	3	0	0	3	0	0
22	443622	.	T	C	0	4	4	0	0	4	0	0
22	446686	.	G	C	0	1	1	0	1	2	0	0
22	446716	.	G	T	0	3	3	0	1	4	0	0
22	447384	.	T	C	1	1	2	0	0	2	0	0
22	451371	.	T	C	1	1	2	0	0	2	0	0
22	452694	.	T	G	4	6	10	0	0	10	0	0
22	452748	.	A	G	6	0	6	0	4	10	0	0
22	452776	.	A	G	5	1	6	0	7	13	0	0
22	452784	.	A	G	4	7	11	0	0	11	0	0
22	453170	.	C	A	2	1	3	0	0	3	0	0
22	461258	.	T	C	2	2	4	0	0	4	0	0
22	461502	.	G	A	0	4	4	0	1	5	0	0
22	464971	.	T	A	1	3	4	0	0	4	0	0
22	468088	.	T	C	4	10	14	0	4	18	0	0
22	468375	.	T	C	5	7	12	0	0	12	0	0
22	473607	.	A	G	25	28	53	0	0	53	0	0
22	474787	.	C	A	0	5	5	0	4	9	0	0
22	479703	.	C	T	0	10	10	0	11	21	0	0
22	479754	.	C	T	9	14	23	0	2	25	0	0
22	481670	.	A	G	3	4	7	0	0	7	0	0
22	483593	.	G	T	14	13	27	0	0	27	0	0
22	483841	.	C	T	1	2	3	0	0	3	0	0
22	485328	.	A	C	6	0	6	0	8	14	0	0
22	485352	.	G	A	10	15	25	0	2	27	0	0
22	486713	.	C	T	10	20	30	0	1	31	0	0
22	489566	.	T	C	16	8	24	0	0	24	0	0
22	489694	.	G	T	5	10	15	0	0	15	0	0
22	534484	.	A	G	2	4	6	0	0	6	0	0
22	534492	.	C	T	4	2	6	0	0	6	0	0
22	535020	.	T	A	2	2	4	0	0	4	0	0
22	535110	.	G	A	5	4	9	0	0	9	0	0
22	535154	.	C	T	5	2	7	0	0	7	0	0
22	551166	.	C	T	0	7	7	0	14	21	0	0
22	551262	.	A	G	5	2	7	0	0	7	0	0
22	552169	.	T	C	3	0	3	0	7	10	0	0
22	554411	.	T	C	10	0	10	0	13	23	0	0
22	555234	.	C	T	6	5	11	0	3	14	0	0
22	557733	.	G	A	15	9	24	0	2	26	0	0
22	557770	.	C	T	2	9	11	0	17	28	0	0
22	557886	.	G	A	10	17	27	0	2	29	0	0
22	563826	.	G	A	0	3	3	0	2	5	0	0
22	564097	.	G	A	3	1	4	0	2	6	0	0
22	569783	.	T	C	1	2	3	0	0	3	0	0
22	569840	.	C	G	1	2	3	0	0	3	0	0
22	581732	.	A	G	4	2	6	0	0	6	0	0
22	582041	.	A	G	0	0	0	0	4	4	0	0
22	582412	.	C	T	4	2	6	0	1	7	0	0
22	582525	.	A	C	5	9	14	0	0	14	0	0
22	583240	.	A	G	5	2	7	0	0	7	0	0
22	583260	.	A	G	4	3	7	0	0	7	0	0
22	583290	.	G	A	6	6	12	0	0	12	0	0
22	583295	.	T	C	6	6	12	0	0	12	0	0
22	583343	.	A	G	5	7	12	0	1	13	0	0
22	583376	.	T	G	6	4	10	0	0	10	0	0
22	583390	.	T	C	8	4	12	0	0	12	0	0
22	583421	.	C	T	6	6	12	0	0	12	0	0
22	583538	.	A	C	8	6	14	0	0	14	0	0
22	591851	.	A	T	11	10	21	0	0	21	0	0
22	591937	.	A	G	20	14	34	0	2	36	0	0
22	591942	.	G	T	18	14	32	0	4	36	0	0
22	592029	.	A	G	13	20	33	0	0	33	0	0
22	592069	.	G	A	13	19	32	0	2	34	0	0
22	592107	.	T	A	12	10	22	0	2	24	0	0
22	593071	.	A	G	2	6	8	0	1	9	0	0
22	593708	.	C	T	4	3	7	0	0	7	0	0
22	593819	.	C	A	19	19	38	0	0	38	0	0
22	593828	.	G	A	19	18	37	0	1	38	0	0
22	593903	.	T	C	17	1	18	0	12	30	0	0
22	599951	.	A	T	15	19	34	0	1	35	0	0
22	613352	.	G	A	15	21	36	0	0	36	0	0
22	613355	.	C	G	15	22	37	0	0	37	0	0
22	613572	.	T	A	36	9	45	0	1	46	0	0
22	613591	.	C	A	0	16	16	0	24	40	0	0
22	616076	.	T	G	9	6	15	0	1	16	0	0
22	617692	.	G	A	1	4	5	0	1	6	0	0
22	618149	.	G	A	13	10	23	0	0	23	0	0
22	635832	.	C	G	3	3	6	0	0	6	0	0
22	637508	.	C	A	6	5	11	0	0	11	0	0
22	637517	.	G	C	6	5	11	0	0	11	0	0
22	710974	.	A	G	26	27	53	0	3	56	0	0
22	711158	.	T	G	18	30	48	0	0	48	0	0
22	711285	.	G	T	10	15	25	0	0	25	0	0
22	711337	.	T	A	12	7	19	0	0	19	0	0
22	711370	.	A	C	8	7	15	0	1	16	0	0
22	711437	.	C	T	6	8	14	0	0	14	0	0
22	711475	.	T	C	15	9	24	0	0	24	0	0
22	711725	.	A	T	15	22	37	0	2	39	0	0
22	712146	.	T	A	6	13	19	0	1	20	0	0
22	712160	.	A	G	5	18	23	0	2	25	0	0
22	712187	.	G	T	7	18	25	0	1	26	0	0
22	712222	.	G	A	12	16	28	0	5	33	0	0
22	712484	.	G	A	17	22	39	0	1	40	0	0
22	712578	.	A	G	23	18	41	0	1	42	0	0
22	728144	.	T	A	2	2	4	0	0	4	0	0
22	728176	.	C	T	4	3	7	0	0	7	0	0
22	729619	.	C	A	1	2	3	0	0	3	0	0
22	732794	.	T	A	5	5	10	0	0	10	0	0
22	741559	.	T	C	1	1	2	0	0	2	0	0
22	742065	.	A	G	0	1	1	0	0	1	0	0
22	748837	.	C	T	7	7	14	0	0	14	0	0
22	748951	.	T	C	1	1	2	0	0	2	0	0
22	750695	.	T	C	3	4	7	0	0	7	0	0
22	750699	.	G	A	0	3	3	0	4	7	0	0
22	750759	.	C	A	3	4	7	0	1	8	0	0
22	750770	.	C	G	3	4	7	0	1	8	0	0
22	750863	.	T	C	1	3	4	0	0	4	0	0
22	751075	.	A	G	1	2	3	0	0	3	0	0
22	753210	.	C	T	5	8	13	0	0	13	0	0
22	753219	.	T	C	5	8	13	0	0	13	0	0
22	753267	.	A	G	0	0	0	0	3	3	0	0
22	770233	.	T	A	8	13	21	0	0	21	0	0
22	774989	.	T	C	11	0	11	0	21	32	0	0
22	779246	.	C	T	0	5	5	0	8	13	0	0
22	779255	.	G	A	7	4	11	0	0	11	0	0
22	786611	.	T	C	6	6	12	0	0	12	0	0
22	796937	.	C	T	7	4	11	0	0	11	0	0
22	796994	.	G	T	0	2	2	0	2	4	0	0
22	797000	.	G	A	0	2	2	0	2	4	0	0
22	797117	.	G	A	2	1	3	0	0	3	0	0
22	799595	.	A	G	11	1	12	0	10	22	0	0
22	799712	.	C	T	10	4	14	0	1	15	0	0
22	804324	.	G	C	7	7	14	0	0	14	0	0
22	804409	.	C	T	20	27	47	0	3	50	0	0
22	808069	.	T	A	11	5	16	0	4	20	0	0
22	808134	.	G	A	9	7	16	0	0	16	0	0
22	808175	.	T	C	3	4	7	0	1	8	0	0
22	808200	.	T	A	6	6	12	0	1	13	0	0
22	808228	.	A	G	10	9	19	0	0	19	0	0
22	808655	.	G	C	11	11	22	0	1	23	0	0
22	813148	.	C	G	0	3	3	0	4	7	0	0
22	813152	.	G	A	3	4	7	0	0	7	0	0
22	820087	.	G	T	14	13	27	0	1	28	0	0
22	820660	.	A	G	5	1	6	0	0	6	0	0
22	822601	.	A	C	10	0	10	0	8	18	0	0
22	822940	.	G	A	2	6	8	0	0	8	0	0
22	825091	.	T	A	6	10	16	0	0	16	0	0
22	825178	.	C	G	0	1	1	0	3	4	0	0
22	828517	.	C	T	0	0	0	0	2	2	0	0
22	831180	.	C	T	1	2	3	0	0	3	0	0
22	831345	.	A	G	5	8	13	0	0	13	0	0
22	831354	.	C	T	0	8	8	0	5	13	0	0
22	831591	.	T	C	4	0	4	0	0	4	0	0
22	833928	.	G	A	2	1	3	0	0	3	0	0
22	833990	.	T	C	3	8	11	0	1	12	0	0
22	857029	.	A	G	4	3	7	0	1	8	0	0
22	857233	.	T	A	2	2	4	0	0	4	0	0
22	857328	.	C	T	2	4	6	0	0	6	0	0
22	857350	.	T	C	3	0	3	0	5	8	0	0
22	857572	.	A	T	8	10	18	0	0	18	0	0
22	857720	.	A	G	7	14	21	0	0	21	0	0
22	857733	.	T	G	4	15	19	0	1	20	0	0
22	859511	.	T	C	7	0	7	0	3	10	0	0
22	868098	.	A	G	1	6	7	0	1	8	0	0
22	868114	.	T	C	1	11	12	0	0	12	0	0
22	868175	.	A	G	3	15	18	0	1	19	0	0
22	868312	.	A	G	7	10	17	0	2	19	0	0
22	868321	.	T	C	5	15	20	0	0	20	0	0
22	868353	.	T	A	4	18	22	0	2	24	0	0
22	868648	.	G	C	3	12	15	0	0	15	0	0
22	869989	.	A	G	1	0	1	0	0	1	0	0
22	877097	.	C	T	0	1	1	0	0	1	0	0
22	995476	.	T	A	1	1	2	0	0	2	0	0
22	995499	.	A	G	1	2	3	0	0	3	0	0
22	1069191	.	G	A	1	4	5	0	0	5	0	0
22	1203320	.	A	T	6	10	16	0	0	16	0	0
22	1203373	.	A	T	8	9	17	0	1	18	0	0
22	1209816	.	T	C	0	6	6	0	0	6	0	0
22	1214289	.	T	C	3	3	6	0	1	7	0	0
22	1214535	.	T	G	3	2	5	0	0	5	0	0
22	1216047	.	C	T	3	3	6	0	0	6	0	0
22	1267013	.	C	T	2	5	7	0	0	7	0	0
22	1267045	.	A	G	3	5	8	0	0	8	0	0
22	1267081	.	G	A	3	5	8	0	0	8	0	0
22	1267213	.	G	C	0	2	2	0	7	9	0	0
22	1276710	.	A	T	1	3	4	0	0	4	0	0
22	1277741	.	T	C	0	1	1	0	0	1	0	0
22	1277766	.	A	G	2	3	5	0	0	5	0	0
22	1281832	.	C	A	1	4	5	0	0	5	0	0
22	1281951	.	G	A	2	6	8	0	1	9	0	0
22	1281978	.	T	C	3	6	9	0	1	10	0	0
22	1281993	.	A	G	2	6	8	0	0	8	0	0
22	1282296	.	G	T	6	9	15	0	0	15	0	0
22	1294642	.	C	T	2	3	5	0	0	5	0	0
22	1322749	.	T	G	3	0	3	0	2	5	0	0
22	1322755	.	C	T	4	2	6	0	0	6	0	0
22	1323514	.	G	A	5	2	7	0	0	7	0	0
22	1323628	.	G	A	6	3	9	0	0	9	0	0
22	1326647	.	A	C	6	6	12	0	0	12	0	0
22	1327074	.	A	G	4	3	7	0	0	7	0	0
22	1327209	.	C	T	5	5	10	0	0	10	0	0
22	1327433	.	T	A	2	5	7	0	0	7	0	0
22	1327452	.	G	A	3	6	9	0	0	9	0	0
22	1327475	.	A	C	3	5	8	0	0	8	0	0
22	1327979	.	G	A	1	6	7	0	7	14	0	0
22	1328001	.	C	T	7	6	13	0	0	13	0	0
22	1328402	.	T	C	9	6	15	0	1	16	0	0
22	1328660	.	A	T	11	11	22	0	0	22	0	0
22	1328708	.	G	A	18	13	31	0	1	32	0	0
22	1328748	.	A	G	14	0	14	0	18	32	0	0
22	1328880	.	A	C	10	5	15	0	0	15	0	0
22	1328890	.	A	G	10	0	10	0	6	16	0	0
22	1328967	.	G	A	3	2	5	0	0	5	0	0
22	1328968	.	C	A	3	2	5	0	0	5	0	0
22	1373320	.	G	T	1	3	4	0	0	4	0	0
22	1373633	.	T	C	2	4	6	1	0	7	0	0
22	1373672	.	T	C	2	4	6	0	0	6	0	0
22	1373676	.	T	A	2	4	6	0	0	6	0	0
22	1374783	.	C	T	3	4	7	0	0	7	0	0
22	1375083	.	T	C	2	4	6	0	0	6	0	0
22	1375160	.	G	T	4	2	6	0	0	6	0	0
22	1375162	.	T	C	4	2	6	0	0	6	0	0
22	1375219	.	A	T	2	2	4	0	0	4	0	0
22	1394277	.	C	T	2	2	4	0	0	4	0	0
22	1394290	.	G	A	2	2	4	0	0	4	0	0
22	1394328	.	A	G	1	0	1	0	2	3	0	0
22	1394330	.	T	A	1	2	3	0	0	3	0	0
22	1406858	.	T	C	4	4	8	0	0	8	0	0
22	1407074	.	A	G	1	7	8	0	0	8	0	0
22	1407152	.	T	C	2	2	4	0	0	4	0	0
22	1421264	.	T	C	1	2	3	0	0	3	0	0
22	1421278	.	G	T	0	3	3	0	1	4	0	0
22	1423588	.	A	G	1	3	4	0	0	4	0	0
22	1423717	.	C	G	1	2	3	0	0	3	0	0
22	1424065	.	C	A	1	1	2	0	2	4	0	0
22	1424456	.	T	A	2	2	4	0	0	4	0	0
22	1432101	.	T	C	1	4	5	0	0	5	0	0
22	1440977	.	A	G	2	0	2	0	6	8	0	0
22	1440989	.	A	C	2	4	6	0	0	6	0	0
22	1441154	.	A	G	1	4	5	0	0	5	0	0
22	1441200	.	C	G	1	0	1	0	4	5	0	0
22	1441337	.	C	T	3	4	7	0	0	7	0	0
22	1441470	.	T	C	0	2	2	0	0	2	0	0
22	1441475	.	A	T	0	2	2	0	0	2	0	0
22	1891862	.	T	C	0	0	0	1	0	1	0	0
22	2638161	.	A	G	2	2	4	0	0	4	0	0
22	2648608	.	A	G	1	2	3	0	1	4	0	0
22	2648619	.	A	G	2	2	4	0	0	4	0	0
22	2869790	.	G	A	3	2	5	0	0	5	0	0
22	2897580	.	T	C	7	0	7	0	21	28	0	0
22	2897681	.	A	G	12	19	31	0	2	33	0	0
22	2897742	.	G	A	9	14	23	0	3	26	0	0
22	2897997	.	G	C	14	11	25	0	2	27	0	0
22	2898089	.	C	A	1	15	16	0	19	35	0	0
22	2900999	.	G	A	7	2	9	0	1	10	0	0
22	2908264	.	T	G	0	1	1	0	0	1	0	0
22	2912869	.	G	T	4	1	5	0	1	6	0	0
22	2912905	.	G	A	13	1	14	1	1	16	0	0
22	2919050	.	A	G	5	10	15	0	1	16	0	0
22	2919501	.	C	T	3	3	6	0	0	6	0	0
22	2931374	.	T	A	2	2	4	0	0	4	0	0
22	2931377	.	C	T	2	2	4	0	0	4	0	0
22	2931544	.	T	A	5	4	9	0	0	9	0	0
22	2933861	.	G	C	6	6	12	0	0	12	0	0
22	2937428	.	A	G	3	1	4	0	0	4	0	0
22	2941538	.	A	G	9	1	10	0	7	17	0	0
22	2941886	.	C	T	3	2	5	0	0	5	0	0
22	2941888	.	C	T	3	2	5	0	0	5	0	0
22	2951416	.	C	G	0	3	3	0	1	4	0	0
22	3077768	.	G	A	2	4	6	0	0	6	0	0
22	3077828	.	A	G	3	0	3	0	5	8	0	0
22	3078101	.	T	C	2	2	4	0	0	4	0	0
22	3121191	.	T	G	7	4	11	0	1	12	0	0
22	3121451	.	C	A	0	8	8	0	9	17	0	0
22	3121531	.	A	T	7	8	15	0	1	16	0	0
22	3121683	.	T	A	5	6	11	0	0	11	0	0
22	3121725	.	T	G	5	8	13	0	1	14	0	0
22	3121789	.	A	T	7	13	20	0	0	20	0	0
22	3122004	.	A	G	5	7	12	0	0	12	0	0
22	3122258	.	C	T	16	18	34	0	0	34	0	0
22	3123805	.	G	A	6	4	10	0	0	10	0	0
22	3124031	.	G	A	3	6	9	0	0	9	0	0
22	3124071	.	C	T	0	4	4	0	3	7	0	0
22	3124132	.	G	T	8	3	11	0	0	11	0	0
22	3127257	.	T	C	2	0	2	0	1	3	0	0
22	3143236	.	C	T	0	2	2	0	1	4	1	0
22	3161346	.	C	T	9	9	18	0	0	18	0	0
22	3162335	.	T	C	9	5	14	0	0	14	0	0
22	3162405	.	G	A	4	1	5	0	0	5	0	0
22	3169448	.	C	T	0	2	2	0	1	3	0	0
22	3172774	.	C	T	4	6	10	0	0	10	0	0
22	3177196	.	T	G	4	2	6	0	0	6	0	0
22	3177227	.	A	G	0	1	1	0	0	1	0	0
22	3181612	.	C	A	0	2	2	0	0	2	0	0
22	3182452	.	G	C	2	1	3	0	7	10	0	0
22	3182457	.	T	C	6	4	10	0	1	11	0	0
22	3182698	.	G	C	2	2	4	0	0	4	0	0
22	3182728	.	T	C	2	2	4	0	0	4	0	0
22	3192000	.	C	T	0	1	1	0	0	1	0	0
22	3198047	.	C	T	0	1	1	0	0	1	0	0
22	3202141	.	C	G	0	1	1	0	0	1	0	0
22	3204054	.	G	A	3	3	6	0	0	6	0	0
22	3208281	.	A	G	4	7	11	0	0	11	0	0
22	3211809	.	C	T	5	3	8	0	1	9	0	0
22	3214180	.	C	A	2	2	4	0	0	4	0	0
22	3214309	.	G	A	4	4	8	0	2	10	0	0
22	3231677	.	T	G	6	6	12	0	0	12	0	0
22	3261741	.	T	C	1	2	3	0	0	3	0	0
22	3262925	.	C	T	2	10	12	0	7	19	0	0
22	3263129	.	T	C	5	5	10	0	0	10	0	0
22	3263672	.	G	T	12	4	16	0	1	17	0	0
22	3263760	.	G	A	8	6	14	0	0	14	0	0
22	3263776	.	T	G	9	8	17	0	1	18	0	0
22	3273835	.	T	C	10	4	14	0	0	14	0	0
22	3384831	.	G	A	24	20	44	0	0	44	0	0
22	3384844	.	C	T	21	19	40	0	5	45	0	0
22	3387668	.	C	T	2	2	4	0	1	5	0	0
22	3387859	.	G	A	7	5	12	0	0	12	0	0
22	3389606	.	A	G	9	18	27	0	1	28	0	0
22	3389615	.	T	C	7	16	23	0	1	24	0	0
22	3389803	.	G	A	13	5	18	0	1	19	0	0
22	3392768	.	A	T	5	2	7	0	1	8	0	0
22	3413993	.	G	A	6	1	7	0	0	7	0	0
22	3446337	.	G	A	1	3	4	0	1	5	0	0
22	4397947	.	A	G	4	4	8	0	1	9	0	0
22	4397966	.	C	G	2	7	9	0	1	10	0	0
22	4407768	.	T	C	2	2	4	0	0	4	0	0
22	4444620	.	T	C	2	2	4	0	0	4	0	0
22	4444688	.	G	C	1	2	3	0	1	4	0	0
22	4444736	.	C	G	0	6	6	0	0	6	0	0
22	4444740	.	T	C	1	7	8	0	0	8	0	0
22	4445269	.	T	C	1	3	4	0	0	4	0	0
22	4450231	.	T	G	1	0	1	0	1	2	0	0
22	4453459	.	G	T	0	4	4	0	5	9	0	0
22	4457622	.	G	C	7	10	17	0	0	17	0	0
22	4459772	.	T	C	3	4	7	0	0	7	0	0
22	4460297	.	A	G	8	1	9	0	0	9	0	0
22	4462713	.	C	G	0	1	1	0	0	1	0	0
22	4462800	.	T	C	13	9	22	0	1	23	0	0
22	4462889	.	A	G	5	7	12	0	3	15	0	0
22	4462890	.	C	A	8	5	13	0	2	15	0	0
22	4463041	.	A	G	9	5	14	0	0	14	0	0
22	4463160	.	C	T	7	5	12	0	0	12	0	0
22	4463192	.	G	A	0	3	3	0	4	7	0	0
22	4711814	.	A	T	0	2	2	0	0	2	0	0
22	4711816	.	A	G	0	0	0	0	2	2	0	0
22	4711929	.	C	T	6	2	8	0	1	9	0	0
22	4716716	.	A	G	1	1	2	0	0	2	0	0
22	4719525	.	G	A	0	5	5	0	5	10	0	0
22	4719526	.	T	G	5	5	10	0	0	10	0	0
22	4726694	.	A	G	5	2	7	0	0	7	0	0
22	4726733	.	T	G	0	1	1	0	0	1	0	0
22	4728712	.	A	G	0	0	0	0	1	1	0	0
22	4728730	.	C	T	4	2	6	0	0	6	0	0
22	4730881	.	G	A	8	2	10	0	0	10	0	0
22	4730882	.	A	T	8	2	10	0	0	10	0	0
22	4732627	.	C	A	20	8	28	0	1	29	0	0
22	4745227	.	C	T	8	4	12	0	2	14	0	0
22	4745421	.	A	G	10	17	27	0	1	28	0	0
22	4745642	.	G	A	17	5	22	0	0	22	0	0
22	4745677	.	C	G	14	7	21	0	1	22	0	0
22	4745682	.	A	T	14	8	22	0	0	22	0	0
22	4745779	.	C	T	0	17	17	0	11	28	0	0
22	4746120	.	A	T	10	14	24	0	0	24	0	0
22	4746401	.	A	G	7	4	11	0	1	12	0	0
22	4746577	.	C	A	7	7	14	0	1	15	0	0
22	4746721	.	C	T	10	9	19	0	2	21	0	0
22	4746750	.	C	T	8	9	17	0	1	18	0	0
22	4746988	.	A	T	4	2	6	0	1	7	0	0
22	4747076	.	A	G	3	3	6	0	0	6	0	0
22	4747278	.	A	C	5	4	9	0	0	9	0	0
22	4747287	.	C	T	5	4	9	0	0	9	0	0
22	4747456	.	C	A	4	5	9	0	0	9	0	0
22	4747684	.	C	T	3	2	5	0	1	6	0	0
22	4747832	.	C	T	5	4	9	0	1	10	0	0
22	4747862	.	C	T	5	6	11	0	0	11	0	0
22	4747921	.	G	T	10	9	19	0	0	19	0	0
22	4752478	.	C	T	5	4	9	0	3	12	0	0
22	4754306	.	C	T	5	4	9	0	0	9	0	0
22	4755338	.	A	G	3	6	9	0	0	9	0	0
22	4755656	.	C	T	0	6	6	0	7	13	0	0
22	4755681	.	G	A	3	11	14	0	0	14	0	0
22	4758015	.	C	T	1	1	2	0	0	2	0	0
22	4762663	.	C	T	0	13	13	0	8	21	0	0
22	4762664	.	A	G	14	7	21	0	0	21	0	0
22	4762773	.	T	C	16	15	31	0	1	32	0	0
22	4763125	.	G	A	9	5	14	0	0	14	0	0
22	4763474	.	C	A	0	6	6	0	17	23	0	0
22	4766818	.	C	T	3	2	5	0	0	5	0	0
22	4767075	.	A	C	8	0	8	0	6	14	0	0
22	4767534	.	C	T	2	4	6	0	0	6	0	0
22	4767738	.	C	G	1	1	2	0	0	2	0	0
22	4767754	.	C	T	2	1	3	0	0	3	0	0
22	4769024	.	C	G	3	7	10	0	0	10	0	0
22	4952505	.	C	A	1	1	2	0	1	3	0	0
22	4952506	.	A	G	1	2	3	0	0	3	0	0
22	4952823	.	C	A	1	3	4	0	0	4	0	0
22	4962472	.	T	A	1	9	10	0	0	10	0	0
22	4962550	.	A	C	8	1	9	0	10	20	1	0
22	4962559	.	G	A	6	10	16	0	2	18	0	0
22	4962590	.	A	G	7	12	19	0	2	21	0	0
22	4962610	.	A	T	6	16	22	0	0	22	0	0
22	4962635	.	A	G	11	15	26	0	0	26	0	0
22	4962878	.	G	A	13	17	30	0	0	30	0	0
22	4967354	.	G	T	3	4	7	0	1	8	0	0
22	4968955	.	A	G	0	3	3	0	0	3	0	0
22	4969021	.	A	G	20	12	32	0	1	33	0	0
22	4970773	.	T	C	4	0	4	0	2	6	0	0
22	4970797	.	G	C	5	3	8	0	1	9	0	0
22	4972848	.	T	G	10	13	23	0	1	24	0	0
22	4975236	.	T	A	6	15	21	0	4	25	0	0
22	4977106	.	G	A	8	4	12	0	0	12	0	0
22	4987889	.	T	C	1	0	1	0	4	5	0	0
22	4989754	.	G	T	1	3	4	0	0	4	0	0
22	5056607	.	A	G	8	11	19	0	1	20	0	0
22	5056760	.	T	G	9	17	26	0	0	26	0	0
22	5056978	.	A	T	3	8	11	0	0	11	0	0
22	5057034	.	G	T	8	4	12	0	0	12	0	0
22	5057254	.	T	A	5	6	11	0	0	11	0	0
22	5057421	.	C	A	0	6	6	0	9	15	0	0
22	5057489	.	T	A	5	4	9	0	2	11	0	0
22	5057504	.	T	A	7	5	12	0	0	12	0	0
22	5057562	.	G	T	6	7	13	0	0	13	0	0
22	5120172	.	C	T	10	7	17	0	0	17	0	0
22	5122486	.	A	C	2	2	4	0	1	5	0	0
22	5122498	.	C	A	2	2	4	0	0	4	0	0
22	5144566	.	G	C	5	4	9	0	0	9	0	0
22	5144750	.	T	A	9	7	16	0	1	17	0	0
22	5144882	.	T	G	5	6	11	0	0	11	0	0
22	5144981	.	T	C	4	6	10	0	0	10	0	0
22	5145330	.	C	T	4	2	6	0	0	6	0	0
22	5176514	.	C	G	2	2	4	0	0	4	0	0
22	5209139	.	A	G	2	1	3	0	0	3	0	0
22	5227738	.	C	T	9	7	16	0	0	16	0	0
22	5227869	.	C	T	4	7	11	0	0	11	0	0
22	5227870	.	C	G	4	6	10	0	1	11	0	0
22	5228124	.	G	T	1	4	5	0	12	17	0	0
22	5228158	.	C	T	11	5	16	0	0	16	0	0
22	5228711	.	T	C	1	2	3	0	0	3	0	0
22	5228744	.	G	A	1	3	4	0	6	10	0	0
22	5229151	.	A	G	11	4	15	1	0	16	0	0
22	5229267	.	A	C	1	6	7	0	2	9	0	0
22	5229315	.	A	C	1	3	4	0	0	4	0	0
22	5229320	.	G	A	1	3	4	0	0	4	0	0
22	5229861	.	A	G	7	4	11	0	0	11	0	0
22	5230339	.	A	G	15	4	19	0	0	19	0	0
22	5230455	.	A	C	3	0	3	0	3	6	0	0
22	5230684	.	A	G	3	2	5	0	0	5	0	0
22	5230751	.	G	C	5	9	14	0	0	14	0	0
22	5230794	.	T	A	5	16	21	0	1	22	0	0
22	5230839	.	A	G	4	17	21	0	1	22	0	0
22	5231145	.	T	C	8	10	18	0	0	18	0	0
22	5231263	.	A	G	11	11	22	0	1	23	0	0
22	5231354	.	C	T	13	10	23	0	0	23	0	0
22	5231696	.	A	G	11	20	31	0	2	33	0	0
22	5232088	.	T	G	10	7	17	0	0	17	0	0
22	5233560	.	C	T	7	2	9	0	0	9	0	0
22	5233620	.	G	A	4	2	6	0	0	6	0	0
22	5233712	.	C	A	2	3	5	0	0	5	0	0
22	5233920	.	T	C	9	12	21	0	1	22	0	0
22	5233975	.	T	C	8	2	10	0	0	10	0	0
22	5234042	.	T	A	9	7	16	0	0	16	0	0
22	5235322	.	G	A	1	1	2	0	0	2	0	0
22	5244560	.	T	C	0	3	3	0	0	3	0	0
22	5251783	.	C	T	2	3	5	0	0	5	0	0
22	5414892	.	G	A	0	1	1	0	1	2	0	0
22	5414907	.	A	T	1	1	2	0	0	2	0	0
22	5416247	.	C	T	0	1	1	0	0	1	0	0
22	5416295	.	C	T	0	3	3	0	1	4	0	0
22	5416641	.	A	T	0	1	1	0	0	1	0	0
22	5575088	.	C	T	8	10	18	0	2	20	0	0
22	5577139	.	T	C	7	5	12	0	1	13	0	0
22	5577196	.	A	G	4	0	4	0	2	6	0	0
22	5577211	.	T	C	0	1	1	0	0	1	0	0
22	5578880	.	T	C	15	12	27	0	0	27	0	0
22	5586896	.	T	C	16	13	29	0	1	30	0	0
22	5586902	.	C	T	15	12	27	0	2	29	0	0
22	5587075	.	C	A	6	15	21	0	3	24	0	0
22	5587077	.	C	T	6	18	24	0	0	24	0	0
22	5587124	.	G	A	9	23	32	0	1	33	0	0
22	5587204	.	A	G	15	1	16	0	20	36	0	0
22	5587285	.	A	C	13	7	20	0	1	21	0	0
22	5587355	.	T	C	5	3	8	0	0	8	0	0
22	5587826	.	T	C	24	33	57	0	1	58	0	0
22	5587930	.	T	C	21	24	45	0	4	49	0	0
22	5634158	.	A	T	0	3	3	0	0	3	0	0
22	5634763	.	T	G	2	3	5	0	0	5	0	0
22	5639691	.	G	T	1	1	2	0	1	3	0	0
22	5639715	.	T	C	2	0	2	0	0	2	0	0
22	5651720	.	T	C	0	1	1	0	0	1	0	0
22	5657155	.	G	A	7	4	11	0	1	12	0	0
22	5657191	.	C	T	0	7	7	0	11	18	0	0
22	5657278	.	A	T	6	5	11	0	0	11	0	0
22	5657365	.	C	T	7	7	14	0	0	14	0	0
22	5657456	.	T	C	3	1	4	0	5	9	0	0
22	5657704	.	T	C	10	7	17	0	0	17	0	0
22	5657731	.	T	C	6	0	6	0	9	15	0	0
22	5657800	.	T	A	6	7	13	0	1	14	0	0
22	5660962	.	T	C	9	5	14	0	0	14	0	0
22	5661524	.	C	T	0	3	3	0	4	7	0	0
22	5661530	.	G	T	4	3	7	0	0	7	0	0
22	5663260	.	T	A	4	2	6	0	1	7	0	0
22	5663275	.	G	A	4	5	9	0	0	9	0	0
22	5667582	.	A	G	20	4	24	0	0	24	0	0
22	5667596	.	T	G	20	5	25	0	0	25	0	0
22	5667629	.	T	C	10	3	13	0	0	13	0	0
22	5667672	.	T	A	2	3	5	0	0	5	0	0
22	5667681	.	A	C	1	3	4	0	1	5	0	0
22	5738194	.	C	T	1	3	4	0	0	4	0	0
22	5739091	.	C	T	1	2	3	0	0	3	0	0
22	5739109	.	C	T	1	2	3	0	0	3	0	0
22	5752305	.	T	C	4	2	6	0	1	7	0	0
22	5752315	.	G	A	5	2	7	0	0	7	0	0
22	5756066	.	G	A	9	5	14	0	0	14	0	0
22	5756317	.	C	T	8	4	12	0	1	13	0	0
22	5756340	.	A	T	6	3	9	0	0	9	0	0
22	5758228	.	T	A	7	3	10	0	1	11	0	0
22	5758678	.	C	T	8	11	19	0	3	22	0	0
22	5758689	.	A	T	6	11	17	0	1	18	0	0
22	5761968	.	G	A	1	0	1	0	0	1	0	0
22	5762097	.	C	T	1	0	1	0	0	1	0	0
22	6073976	.	C	T	2	2	4	0	0	4	0	0
22	6074074	.	T	C	1	2	3	0	0	3	0	0
22	6074856	.	G	T	1	3	4	0	0	4	0	0
22	6077713	.	A	G	3	2	5	0	0	5	0	0
22	6077735	.	C	T	2	2	4	0	0	4	0	0
22	6183523	.	T	C	2	2	4	1	0	5	0	0
22	6515440	.	A	G	0	1	1	0	0	1	0	0
22	6527553	.	C	A	0	5	5	0	12	17	0	0
22	6527758	.	G	T	1	2	3	0	0	3	0	0
22	6528059	.	A	T	3	2	5	0	0	5	0	0
22	6528134	.	A	G	8	3	11	0	0	11	0	0
22	6528313	.	T	C	6	0	6	0	3	9	0	0
22	6528445	.	C	A	4	4	8	0	1	9	0	0
22	6528446	.	A	G	3	4	7	0	1	9	1	0
22	6528632	.	C	T	3	3	6	0	0	6	0	0
22	6528746	.	A	G	7	4	11	0	0	11	0	0
22	6529158	.	T	A	2	2	4	0	0	4	0	0
22	6562428	.	A	T	0	2	2	0	1	3	0	0
22	6767352	.	T	A	6	2	8	0	0	8	0	0
22	7556516	.	C	T	3	3	6	0	0	6	0	0
22	7556580	.	A	G	3	2	5	0	0	5	0	0
22	7558417	.	C	T	1	1	2	0	1	3	0	0
22	7558430	.	T	A	1	2	3	0	0	3	0	0
22	7558973	.	C	T	0	3	3	0	1	4	0	0
22	7558980	.	C	T	1	4	5	0	0	5	0	0
22	7627878	.	G	C	1	3	4	0	0	4	0	0
22	7628399	.	C	T	0	1	1	0	2	3	0	0
22	7628414	.	G	A	1	1	2	0	0	2	0	0
22	7682820	.	T	A	2	1	3	0	0	3	0	0
22	7682825	.	T	G	3	1	4	0	0	4	0	0
22	7683759	.	C	T	0	9	9	0	6	15	0	0
22	7683828	.	T	G	3	5	8	0	0	8	0	0
22	7971790	.	G	A	1	3	4	0	0	4	0	0
22	7972256	.	G	A	0	2	2	0	0	2	0	0
22	7972544	.	G	A	0	5	5	0	0	5	0	0
22	7972580	.	C	A	2	0	2	0	0	2	0	0
22	7972583	.	A	C	0	2	2	0	0	2	0	0
22	7972792	.	A	G	3	6	9	0	0	9	0	0
22	7972848	.	A	G	4	5	9	0	1	10	0	0
22	7972851	.	T	C	5	5	10	0	0	10	0	0
22	8074068	.	G	T	0	2	2	0	0	2	0	0
22	8161183	.	A	C	3	4	7	0	0	7	0	0
22	8161804	.	T	G	0	2	2	0	0	2	0	0
22	8161809	.	T	C	0	0	0	0	2	2	0	0
22	8162059	.	C	T	0	2	2	0	2	4	0	0
22	8163917	.	G	A	3	4	7	0	0	7	0	0
22	8163993	.	G	T	2	3	5	0	0	5	0	0
22	8240649	.	C	A	2	2	4	0	1	5	0	0
22	8296714	.	C	T	4	6	10	0	2	12	0	0
22	8342100	.	A	G	8	3	11	0	0	11	0	0
22	8342101	.	A	T	8	2	10	0	1	11	0	0
22	8345354	.	C	T	0	1	1	0	1	2	0	0
22	8351214	.	T	C	1	3	4	0	0	4	0	0
22	8351215	.	G	A	1	2	3	0	1	4	0	0
22	8715641	.	C	T	2	4	6	0	1	7	0	0
22	8715670	.	C	T	0	6	6	0	7	13	0	0
22	8715692	.	C	T	0	3	3	0	6	9	0	0
22	8769121	.	T	A	0	3	3	0	0	3	0	0
22	8769431	.	A	G	2	4	6	0	2	8	0	0
22	8769518	.	G	C	7	7	14	0	0	14	0	0
22	8769730	.	T	C	6	3	9	0	0	9	0	0
22	8769809	.	G	A	4	3	7	0	0	7	0	0
22	8769816	.	G	A	5	3	8	0	0	8	0	0
22	8770013	.	G	A	0	4	4	0	4	8	0	0
22	8784437	.	A	G	2	2	4	0	1	5	0	0
22	8784438	.	G	T	3	2	5	0	0	5	0	0
22	8784482	.	G	A	0	2	2	0	0	2	0	0
22	8784483	.	C	A	0	2	2	0	0	2	0	0
22	8784521	.	T	A	2	2	4	0	0	4	0	0
22	8784522	.	G	T	2	2	4	0	0	4	0	0
22	8785223	.	G	A	1	3	4	0	0	4	0	0
22	8785647	.	T	C	2	3	5	0	0	5	0	0
22	8785982	.	T	G	3	2	5	0	0	5	0	0
22	8786445	.	G	A	0	3	3	0	3	6	0	0
22	8787636	.	T	A	2	2	4	0	0	4	0	0
22	8787704	.	A	C	5	4	9	0	0	9	0	0
22	8994906	.	G	A	2	8	10	0	0	10	0	0
22	8994922	.	T	G	2	11	13	0	0	13	0	0
22	8994946	.	A	C	3	14	17	0	0	17	0	0
22	8996008	.	A	C	2	4	6	0	0	6	0	0
22	9006944	.	T	C	1	2	3	0	1	4	0	0
22	9007148	.	G	A	1	2	3	0	0	3	0	0
22	9007162	.	C	T	1	2	3	0	0	3	0	0
22	9029936	.	G	A	1	3	4	0	0	4	0	0
22	9029958	.	G	A	1	2	3	0	0	3	0	0
22	9056738	.	A	C	1	0	1	1	0	2	0	0
22	9057090	.	T	G	2	2	4	0	0	4	0	0
22	9057095	.	G	T	2	1	3	0	0	3	0	0
22	9483293	.	C	T	1	1	2	0	0	2	0	0
22	9496936	.	G	A	1	1	2	0	0	2	0	0
22	9503739	.	G	A	2	1	3	0	0	3	0	0
22	9504689	.	C	T	2	2	4	0	0	4	0	0
22	9504749	.	T	C	7	7	14	0	2	16	0	0
22	9508114	.	G	A	5	3	8	0	0	8	0	0
22	9508704	.	T	G	5	9	14	0	0	14	0	0
22	9512885	.	T	G	9	3	12	0	1	13	0	0
22	9513048	.	T	C	11	15	26	0	0	26	0	0
22	9524673	.	T	C	1	0	1	0	0	1	0	0
22	9526251	.	A	G	1	0	1	0	0	1	0	0
22	9526254	.	T	G	1	0	1	0	0	1	0	0
22	9527450	.	C	G	1	3	4	0	0	4	0	0
22	9527983	.	A	G	2	1	3	0	1	4	0	0
22	9530377	.	G	A	2	7	9	0	0	9	0	0
22	9530466	.	A	G	3	7	10	0	0	10	0	0
22	9530562	.	G	A	0	2	2	0	0	2	0	0
22	9530571	.	T	C	0	2	2	0	0	2	0	0
22	9532339	.	C	T	0	1	1	0	0	1	0	0
22	9532455	.	T	C	3	1	4	0	0	4	0	0
22	9532488	.	G	A	3	0	3	0	0	3	0	0
22	9535191	.	T	C	2	7	9	0	0	9	0	0
22	9535290	.	C	T	1	6	7	0	0	7	0	0
22	9535890	.	T	C	7	0	7	0	0	7	0	0
22	9535932	.	C	A	5	0	5	0	0	5	0	0
22	9536984	.	C	T	0	10	10	0	0	10	0	0
22	9537583	.	T	C	13	19	32	0	16	48	0	0
22	9537637	.	T	C	15	21	36	0	13	49	0	0
22	9537779	.	A	G	14	4	18	0	8	26	0	0
22	9538004	.	C	T	12	3	15	0	2	17	0	0
22	9591254	.	T	C	1	3	4	0	0	4	0	0
22	9591295	.	C	T	1	3	4	0	0	4	0	0
22	9824884	.	C	T	0	2	2	0	1	3	0	0
22	9824904	.	T	C	1	3	4	0	0	4	0	0
22	9831270	.	T	C	1	1	2	0	0	2	0	0
22	9831281	.	G	C	1	1	2	0	0	2	0	0
22	9835096	.	A	G	1	4	5	0	0	5	0	0
22	9835108	.	C	T	0	3	3	0	0	3	0	0
22	9835189	.	T	C	2	5	7	0	0	7	0	0
22	9835604	.	G	A	2	2	4	0	0	4	0	0
22	9835622	.	A	G	1	3	4	0	0	4	0	0
22	9835639	.	T	C	1	4	5	0	0	5	0	0
22	9835885	.	T	C	1	4	5	0	0	5	0	0
22	9868095	.	C	G	4	0	4	0	6	10	0	0
22	9868134	.	A	G	2	6	8	0	0	8	0	0
22	9868136	.	A	T	2	6	8	0	0	8	0	0
22	9868366	.	A	C	1	3	4	0	1	5	0	0
22	9871329	.	A	T	2	3	5	0	0	5	0	0
22	9872510	.	C	A	2	3	5	0	0	5	0	0
22	9872545	.	C	G	3	2	5	0	0	5	0	0
22	9876978	.	A	G	1	0	1	0	1	2	0	0
22	9876986	.	C	A	1	2	3	0	0	3	0	0
22	9877095	.	A	G	9	6	15	0	1	16	0	0
22	9877115	.	G	A	10	8	18	0	1	19	0	0
22	9877501	.	C	G	5	7	12	0	1	13	0	0
22	9877667	.	C	G	6	4	10	0	0	10	0	0
22	9877902	.	C	T	7	5	12	0	0	12	0	0
22	9877956	.	C	T	12	8	20	0	1	21	0	0
22	9878045	.	T	C	6	2	8	0	0	8	0	0
22	9878047	.	A	T	5	2	7	0	1	8	0	0
22	9878148	.	T	A	5	4	9	0	0	9	0	0
22	9878218	.	G	C	4	2	6	0	0	6	0	0
22	9878366	.	T	A	8	5	13	0	0	13	0	0
22	9887054	.	A	T	2	3	5	0	0	5	0	0
22	9887293	.	A	G	3	2	5	0	0	5	0	0
22	9887632	.	C	T	1	2	3	0	0	3	0	0
22	9887881	.	A	G	2	2	4	0	0	4	0	0
22	9888247	.	G	A	0	2	2	0	0	2	0	0
22	9888706	.	C	T	2	2	4	0	0	4	0	0
22	9893297	.	G	A	1	2	3	0	0	3	0	0
22	9898031	.	A	G	3	2	5	0	0	5	0	0
22	9898898	.	T	C	3	4	7	0	0	7	0	0
22	9898952	.	G	A	1	2	3	0	0	3	0	0
22	9898955	.	T	C	1	2	3	0	0	3	0	0
22	9899057	.	T	C	2	2	4	0	0	4	0	0
22	9899094	.	A	G	1	2	3	0	0	3	0	0
22	9899279	.	A	G	1	6	7	0	0	7	0	0
22	9899402	.	A	G	1	3	4	0	0	4	0	0
22	10049478	.	T	C	2	3	5	0	0	5	0	0
22	10049504	.	G	A	1	2	3	0	0	3	0	0
22	10049524	.	C	G	1	3	4	0	0	4	0	0
22	10196621	.	C	A	4	24	28	0	1	29	0	0
22	10197180	.	T	A	21	8	29	0	0	29	0	0
22	11156275	.	C	T	1	4	5	0	0	5	0	0
22	12090165	.	A	T	4	3	7	0	3	10	0	0
22	12163370	.	T	A	0	2	2	0	0	2	0	0
22	12171293	.	G	A	3	6	9	0	0	9	0	0
22	12174573	.	T	G	16	7	23	0	0	23	0	0
22	12174740	.	A	G	6	11	17	0	1	18	0	0
22	12175021	.	T	G	9	0	9	0	16	25	0	0
22	12175181	.	T	C	8	11	19	0	3	22	0	0
22	12175556	.	A	G	6	0	6	0	8	14	0	0
22	12175583	.	A	T	6	8	14	0	3	17	0	0
22	12176043	.	G	T	15	18	33	0	1	34	0	0
22	12218882	.	C	A	1	3	4	0	0	4	0	0
22	12218884	.	G	A	1	3	4	0	0	4	0	0
22	12218920	.	A	G	2	5	7	0	0	7	0	0
22	12218979	.	C	T	2	2	4	0	0	4	0	0
22	12247778	.	G	A	1	2	3	0	0	3	0	0
22	13846395	.	T	A	8	11	19	0	2	21	0	0
22	13846606	.	G	A	7	18	25	0	2	27	0	0
22	13846788	.	C	A	8	9	17	0	0	17	0	0
22	13847783	.	A	G	25	32	57	0	1	58	0	0
22	13847797	.	C	G	26	33	59	0	1	60	0	0
22	13847940	.	G	A	25	20	45	0	1	46	0	0
22	13848006	.	A	C	24	2	26	0	17	43	0	0
22	13848031	.	G	A	21	20	41	0	1	42	0	0
22	13848085	.	G	A	18	16	34	0	0	34	0	0
22	13848106	.	A	G	14	8	22	0	2	24	0	0
22	13850865	.	A	G	20	11	31	0	1	32	0	0
22	13919155	.	A	C	1	2	3	0	0	3	0	0
22	13919476	.	G	A	3	4	7	0	0	7	0	0
22	13939993	.	G	C	1	2	3	0	0	3	0	0
22	13940036	.	T	C	4	3	7	0	0	7	0	0
22	13942934	.	T	C	0	2	2	0	0	2	0	0
22	13942941	.	G	A	0	2	2	0	0	2	0	0
22	13977910	.	T	G	6	7	13	0	0	13	0	0
22	13978228	.	T	C	4	10	14	0	0	14	0	0
22	13978465	.	A	G	6	0	6	0	8	14	0	0
22	13978480	.	T	C	6	7	13	0	2	15	0	0
22	13978849	.	C	T	5	9	14	0	1	15	0	0
22	14076954	.	G	A	0	1	1	0	0	1	0	0
22	14077017	.	A	G	0	2	2	0	0	2	0	0
22	14083209	.	T	C	0	1	1	0	0	1	0	0
22	14083218	.	A	G	2	0	2	0	2	4	0	0
22	14083929	.	A	T	2	3	5	0	0	5	0	0
22	14124381	.	C	T	18	11	29	0	1	30	0	0
22	14124465	.	G	A	9	7	16	0	1	17	0	0
22	14124655	.	C	T	17	11	28	0	1	29	0	0
22	14125440	.	T	A	5	3	8	0	0	8	0	0
22	14125448	.	A	T	5	5	10	0	0	10	0	0
22	14366267	.	C	T	2	2	4	0	0	4	0	0
22	14408112	.	C	A	1	1	2	0	0	2	0	0
22	14410011	.	C	A	0	1	1	0	0	1	0	0
22	14427749	.	G	A	1	1	2	0	0	2	0	0
22	14454650	.	T	C	1	0	1	0	0	1	0	0
22	14557666	.	T	C	0	1	1	0	0	1	0	0
22	14845774	.	T	C	2	2	4	0	0	4	0	0
22	14847535	.	G	C	1	0	1	0	0	1	0	0
22	15251931	.	T	C	1	3	4	0	0	4	0	0
22	15257077	.	G	A	1	2	3	0	0	3	0	0
22	15344144	.	T	A	0	1	1	0	0	1	0	0
22	15345546	.	T	C	1	7	8	0	1	9	0	0
22	15345580	.	G	A	1	4	5	0	0	5	0	0
22	15350053	.	T	C	4	3	7	0	1	8	0	0
22	15351505	.	A	G	6	6	12	0	0	12	0	0
22	15352257	.	T	C	6	3	9	0	0	9	0	0
22	15352373	.	A	G	2	1	3	0	0	3	0	0
22	15352382	.	T	C	1	1	2	0	1	3	0	0
22	15384612	.	G	T	7	7	14	0	0	14	0	0
22	15384695	.	T	C	6	0	6	0	4	10	0	0
22	15384696	.	C	G	6	4	10	0	0	10	0	0
22	15384759	.	A	T	6	7	13	0	0	13	0	0
22	15385026	.	G	C	6	0	6	0	3	9	0	0
22	15385389	.	G	A	2	2	4	0	1	5	0	0
22	15429753	.	T	C	1	1	2	0	1	3	0	0
22	15429795	.	T	A	2	3	5	0	0	5	0	0
22	15541277	.	C	T	0	2	2	0	0	2	0	0
22	15544595	.	C	A	3	1	4	0	0	4	0	0
22	15544834	.	C	T	1	1	2	0	0	2	0	0
22	15548150	.	C	T	5	16	21	0	0	21	0	0
22	15552081	.	C	T	4	2	6	0	0	6	0	0
22	15552082	.	T	C	4	2	6	0	0	6	0	0
22	15585848	.	C	T	2	2	4	0	0	4	0	0
22	15585860	.	T	C	1	2	3	0	1	4	0	0
22	15585893	.	A	G	2	2	4	0	0	4	0	0
22	15628710	.	G	A	1	2	3	0	0	3	0	0
22	15629043	.	G	A	3	2	5	0	0	5	0	0
22	15629328	.	C	T	2	2	4	0	0	4	0	0
22	15643424	.	A	G	1	2	3	0	0	3	0	0
22	15696007	.	A	G	13	29	42	0	0	42	0	0
22	15696026	.	A	G	18	28	46	0	1	47	0	0
22	15696191	.	T	G	8	5	13	0	2	15	0	0
22	15697354	.	G	A	9	17	26	0	3	29	0	0
22	15700157	.	C	T	0	8	8	0	11	19	0	0
22	15701545	.	A	T	12	12	24	0	0	24	0	0
22	15701561	.	G	A	13	16	29	1	1	31	0	0
22	15701636	.	A	G	18	14	32	0	1	33	0	0
22	15704622	.	C	T	16	15	31	0	0	31	0	0
22	15719440	.	A	G	1	3	4	0	1	5	0	0
22	15719444	.	T	C	2	2	4	0	1	5	0	0
22	15719547	.	C	A	4	2	6	0	1	8	1	0
22	15719625	.	T	A	19	10	29	0	0	29	0	0
22	15719672	.	G	T	5	7	12	0	0	12	0	0
22	15719682	.	G	A	3	4	7	0	0	7	0	0
22	15719821	.	A	C	1	3	4	0	0	4	0	0
22	15720250	.	T	G	14	18	32	0	1	33	0	0
22	15720608	.	T	C	15	12	27	0	0	27	0	0
22	15720676	.	T	A	4	6	10	0	1	11	0	0
22	15720677	.	C	A	4	7	11	0	0	11	0	0
22	15720925	.	T	A	15	20	35	0	1	36	0	0
22	15721408	.	G	A	0	14	14	0	14	28	0	0
22	15721443	.	C	T	9	9	18	0	0	18	0	0
22	15721466	.	G	A	5	3	8	0	2	12	2	0
22	15721584	.	T	G	18	9	27	0	1	28	0	0
22	15721730	.	C	A	13	5	18	0	0	18	0	0
22	15899283	.	G	A	1	3	4	0	1	5	0	0
22	15900812	.	T	C	6	5	11	0	1	12	0	0
22	15912316	.	T	C	7	6	13	0	0	13	0	0
22	15912346	.	C	T	0	8	8	0	7	15	0	0
22	15915582	.	A	G	2	2	4	0	0	4	0	0
22	15917855	.	G	A	2	4	6	0	0	6	0	0
22	15932440	.	T	C	3	3	6	0	0	6	0	0
22	15939162	.	C	T	0	2	2	0	3	5	0	0
22	15946565	.	A	T	3	2	5	0	0	5	0	0
22	15946575	.	G	A	3	1	4	0	1	5	0	0
22	16342535	.	T	A	1	2	3	0	0	3	0	0
22	16345485	.	A	G	0	1	1	0	0	1	0	0
22	16350682	.	G	A	18	10	28	0	2	30	0	0
22	16350792	.	T	A	25	20	45	0	4	49	0	0
22	16350811	.	T	G	26	13	39	0	4	43	0	0
22	16350877	.	T	A	30	6	36	0	1	37	0	0
22	16351141	.	G	A	20	9	29	0	1	30	0	0
22	16351199	.	C	G	20	8	28	0	3	31	0	0
22	16351404	.	C	T	3	3	6	0	0	6	0	0
22	16351439	.	C	T	5	4	9	0	0	9	0	0
22	16351490	.	T	G	7	3	10	0	0	10	0	0
22	16351552	.	A	T	3	4	7	0	0	7	0	0
22	16352146	.	G	T	1	2	3	0	0	3	0	0
22	16352215	.	A	G	5	8	13	0	0	13	0	0
22	16352249	.	T	C	6	11	17	0	0	17	0	0
22	16352269	.	T	G	8	11	19	0	1	20	0	0
22	16352668	.	T	C	15	0	15	0	17	32	0	0
22	16352768	.	A	G	15	12	27	0	0	27	0	0
22	16357818	.	A	G	1	0	1	0	0	1	0	0
22	16357831	.	A	G	3	1	4	0	0	4	0	0
22	16357867	.	G	A	4	6	10	0	0	10	0	0
22	16357909	.	C	T	1	3	4	0	0	4	0	0
22	16367007	.	T	C	5	1	6	0	7	13	0	0
22	16367055	.	A	G	6	6	12	0	0	12	0	0
22	16377364	.	A	G	6	6	12	0	0	12	0	0
22	16410600	.	A	G	2	1	3	0	0	3	0	0
22	16412091	.	A	G	0	5	5	0	1	6	0	0
22	16416462	.	T	C	0	2	2	0	0	2	0	0
22	16423042	.	G	A	0	3	3	0	2	5	0	0
22	16424576	.	T	C	6	1	7	0	1	8	0	0
22	16427969	.	A	G	5	0	5	0	2	7	0	0
22	16428005	.	C	A	7	4	11	0	0	11	0	0
22	16430623	.	G	A	10	6	16	0	1	17	0	0
22	16430782	.	T	A	5	12	17	0	0	17	0	0
22	16430913	.	T	C	8	3	11	0	0	11	0	0
22	16433009	.	G	A	5	4	9	0	2	11	0	0
22	16433054	.	T	A	10	11	21	0	0	21	0	0
22	16433078	.	G	A	12	12	24	0	1	25	0	0
22	16433096	.	A	G	14	17	31	0	1	32	0	0
22	16433895	.	T	C	8	4	12	0	2	14	0	0
22	16433912	.	T	A	10	6	16	0	0	16	0	0
22	16433940	.	C	T	10	8	18	0	0	18	0	0
22	16434056	.	G	A	18	10	28	0	0	28	0	0
22	16440072	.	G	A	2	2	4	0	0	4	0	0
22	16484167	.	A	T	5	5	10	0	1	11	0	0
22	16484489	.	G	C	23	1	24	0	17	41	0	0
22	16484712	.	C	T	4	7	11	0	1	12	0	0
22	16484877	.	A	T	4	13	17	0	0	18	1	0
22	16484938	.	A	G	14	20	34	0	1	35	0	0
22	16484944	.	T	C	12	17	29	0	3	32	0	0
22	16485238	.	A	C	3	13	16	0	0	16	0	0
22	16485379	.	A	T	11	16	27	0	1	28	0	0
22	16485538	.	T	C	10	0	10	0	5	15	0	0
22	16485563	.	A	T	8	0	8	0	0	8	0	0
22	16485768	.	G	A	6	5	11	0	0	11	0	0
22	16485790	.	C	T	3	5	8	0	0	8	0	0
22	16485920	.	G	A	6	12	18	0	1	19	0	0
22	16485962	.	C	G	13	7	20	0	0	20	0	0
22	16486008	.	A	C	14	1	15	0	3	18	0	0
22	16486027	.	G	A	8	4	12	0	0	13	1	0
22	16486102	.	G	A	13	4	17	0	0	17	0	0
22	16486112	.	T	C	14	3	17	0	1	18	0	0
22	16491711	.	C	A	2	9	11	0	0	11	0	0
22	16491942	.	G	A	13	17	30	0	1	31	0	0
22	16498232	.	T	C	15	16	31	0	1	32	0	0
22	16498333	.	A	C	21	13	34	0	0	34	0	0
22	16498661	.	A	G	11	0	11	0	22	33	0	0
22	16537701	.	C	T	4	4	8	0	0	8	0	0
22	16537854	.	C	T	7	8	15	0	0	15	0	0
22	16537878	.	C	A	8	9	17	0	1	18	0	0
22	16544185	.	A	G	8	4	12	0	0	12	0	0
22	16544186	.	A	G	5	6	11	0	1	12	0	0
22	16544243	.	C	T	6	11	17	0	1	18	0	0
22	16544308	.	A	G	3	3	6	5	0	11	0	0
22	16544384	.	G	A	12	12	24	0	0	24	0	0
22	16544400	.	T	G	12	11	23	0	1	24	0	0
22	16544599	.	A	G	16	0	16	0	15	31	0	0
22	16544674	.	T	G	23	15	38	0	3	41	0	0
22	16544780	.	A	T	11	20	31	0	0	31	0	0
22	16544800	.	G	A	11	15	26	0	0	26	0	0
22	16594852	.	G	A	2	0	2	0	0	2	0	0
22	16594870	.	T	A	1	3	4	0	0	4	0	0
22	16594981	.	C	A	8	3	11	0	0	11	0	0
22	16597623	.	G	A	3	1	4	0	0	4	0	0
22	16601400	.	C	T	4	3	7	0	0	7	0	0
22	16601422	.	C	T	1	4	5	0	0	5	0	0
22	16606938	.	G	A	0	3	3	0	0	3	0	0
22	16775197	.	G	A	0	15	15	0	9	24	0	0
22	16775284	.	T	G	9	9	18	0	1	21	2	0
22	16775306	.	C	T	8	9	17	0	0	17	0	0
22	16840260	.	G	A	3	3	6	0	0	6	0	0
22	16862842	.	A	G	3	2	5	0	0	5	0	0
22	16893867	.	C	T	0	1	1	0	0	1	0	0
22	16991847	.	C	T	0	3	3	0	1	4	0	0
22	17197367	.	A	T	0	0	0	0	1	1	0	0
22	17200635	.	G	A	11	5	16	0	0	16	0	0
22	17200890	.	G	A	12	10	22	0	0	22	0	0
22	17200985	.	A	C	12	14	26	0	0	26	0	0
22	17201015	.	C	G	12	17	29	0	0	29	0	0
22	17201102	.	C	G	12	16	28	0	0	28	0	0
22	17201135	.	G	A	10	9	19	0	3	22	0	0
22	17201172	.	C	T	5	2	7	0	0	7	0	0
22	17201617	.	T	G	6	3	9	0	0	9	0	0
22	17208680	.	T	C	6	1	7	0	1	8	0	0
22	17208695	.	A	G	12	2	14	0	1	15	0	0
22	17208770	.	T	C	14	11	25	0	0	25	0	0
22	17208913	.	A	C	8	9	17	0	3	20	0	0
22	17208973	.	G	A	13	13	26	0	0	26	0	0
22	17208983	.	T	C	14	14	28	0	1	29	0	0
22	17209036	.	A	T	24	6	30	0	0	30	0	0
22	17209384	.	A	C	22	18	40	0	1	41	0	0
22	17209413	.	T	A	23	16	39	0	1	40	0	0
22	17209484	.	T	A	18	14	32	0	1	33	0	0
22	17209492	.	T	A	18	13	31	0	1	32	0	0
22	17209523	.	A	T	18	7	25	0	0	25	0	0
22	17209737	.	T	C	16	21	37	0	1	38	0	0
22	17209762	.	T	C	16	19	35	0	1	36	0	0
22	17209986	.	A	T	18	11	29	0	0	29	0	0
22	17209993	.	A	T	17	13	30	0	0	30	0	0
22	17210053	.	C	G	21	4	25	0	1	26	0	0
22	17210157	.	T	A	23	8	31	0	4	35	0	0
22	17210196	.	C	G	20	0	20	0	14	34	0	0
22	17210217	.	C	A	15	7	22	0	3	25	0	0
22	17210820	.	A	C	25	21	46	0	2	48	0	0
22	17210825	.	G	A	0	20	20	0	27	47	0	0
22	17211295	.	T	C	19	5	24	0	0	24	0	0
22	17211343	.	C	T	19	13	32	0	0	32	0	0
22	17211361	.	A	G	19	13	32	0	1	33	0	0
22	17211431	.	C	T	14	16	30	0	4	34	0	0
22	17211438	.	T	C	16	17	33	0	1	34	0	0
22	17211875	.	G	C	22	22	44	0	2	46	0	0
22	17211990	.	A	G	20	21	41	0	0	41	0	0
22	17212235	.	T	A	17	17	34	0	1	35	0	0
22	17212236	.	T	C	17	17	34	0	1	35	0	0
22	17214755	.	T	A	1	3	4	0	0	4	0	0
22	17214767	.	A	G	1	0	1	0	3	4	0	0
22	17226483	.	T	C	0	1	1	0	0	1	0	0
22	17234487	.	G	A	0	1	1	0	0	1	0	0
22	17234620	.	G	A	0	2	2	0	6	8	0	0
22	17235449	.	A	C	1	2	3	0	0	3	0	0
22	17235841	.	T	C	2	2	4	0	0	4	0	0
22	17249594	.	C	A	1	1	2	0	0	2	0	0
22	17286889	.	C	T	1	2	3	0	0	3	0	0
22	17286895	.	T	C	1	2	3	0	0	3	0	0
22	17318172	.	C	T	2	0	2	0	0	2	0	0
22	17318401	.	T	C	4	3	7	0	0	7	0	0
22	17318404	.	T	C	2	1	3	0	3	6	0	0
22	17322532	.	C	T	0	2	2	0	0	2	0	0
22	17331325	.	A	G	3	1	4	0	0	4	0	0
22	17343530	.	A	G	0	2	2	0	1	3	0	0
22	17359735	.	A	G	3	0	3	0	4	7	0	0
22	17359816	.	G	C	0	4	4	0	6	10	0	0
22	17360107	.	C	A	8	4	12	0	0	12	0	0
22	17360428	.	G	A	0	12	12	0	7	19	0	0
22	17405361	.	C	T	5	4	9	0	0	9	0	0
22	17446858	.	T	C	4	1	5	0	0	5	0	0
22	17448778	.	G	A	2	3	5	0	0	5	0	0
22	17448781	.	C	T	2	3	5	0	0	5	0	0
22	17450115	.	G	A	0	15	15	0	18	33	0	0
22	17452798	.	C	T	8	25	33	0	0	33	0	0
22	17453286	.	T	G	25	19	44	0	0	44	0	0
22	17453336	.	A	G	23	1	24	0	22	46	0	0
22	17453419	.	G	A	15	13	28	0	2	30	0	0
22	17453478	.	T	A	19	22	41	0	0	41	0	0
22	17453552	.	T	C	17	13	30	0	0	30	0	0
22	17453569	.	C	G	12	7	19	0	0	19	0	0
22	17453680	.	C	T	21	6	27	0	1	28	0	0
22	17453688	.	A	G	20	3	23	0	0	23	0	0
22	17453742	.	A	G	8	14	22	0	2	24	0	0
22	17453836	.	A	G	14	11	25	0	0	25	0	0
22	17453883	.	A	T	10	21	31	0	1	32	0	0
22	17453884	.	T	C	10	21	31	0	1	32	0	0
22	17454015	.	T	C	14	20	34	0	2	36	0	0
22	17454038	.	G	T	12	17	29	0	0	29	0	0
22	17454120	.	C	T	5	11	16	0	0	16	0	0
22	17454178	.	A	G	14	0	14	0	10	24	0	0
22	17454179	.	T	G	13	10	23	0	1	24	0	0
22	17454320	.	T	C	16	15	31	0	1	32	0	0
22	17454382	.	C	T	16	6	22	0	3	25	0	0
22	17454424	.	C	T	7	2	9	0	0	9	0	0
22	17455835	.	C	A	1	2	3	0	0	3	0	0
22	17455881	.	G	C	1	2	3	0	0	3	0	0
22	17501623	.	G	C	6	4	10	0	0	10	0	0
22	17505820	.	A	C	23	29	52	0	2	54	0	0
22	17506006	.	T	C	15	4	19	0	1	20	0	0
22	17506016	.	C	T	4	5	9	0	9	18	0	0
22	17506536	.	A	T	21	23	44	0	0	44	0	0
22	17506537	.	T	G	21	22	43	0	1	44	0	0
22	17509449	.	A	T	1	7	8	0	0	8	0	0
22	17509494	.	T	A	4	11	15	0	0	15	0	0
22	17509533	.	T	A	2	1	3	0	2	5	0	0
22	17520792	.	A	G	1	0	1	0	3	4	0	0
22	17531044	.	G	A	0	8	8	0	2	10	0	0
22	17531188	.	A	G	11	5	16	0	0	16	0	0
22	17533907	.	C	T	3	4	7	0	0	7	0	0
22	17539153	.	A	T	1	3	4	0	0	4	0	0
22	17539297	.	C	T	26	18	44	0	2	46	0	0
22	17539633	.	G	A	13	6	19	0	0	19	0	0
22	17541191	.	T	G	5	6	11	0	1	12	0	0
22	17541450	.	C	A	10	16	26	0	0	26	0	0
22	17541593	.	G	A	13	15	28	0	1	29	0	0
22	17542016	.	C	T	14	13	27	0	0	27	0	0
22	17542057	.	C	T	18	9	27	0	1	28	0	0
22	17542117	.	T	C	18	11	29	0	0	29	0	0
22	17542136	.	G	A	15	13	28	0	2	30	0	0
22	17542199	.	A	T	16	9	25	0	0	25	0	0
22	17542293	.	C	T	11	16	27	0	0	27	0	0
22	17542594	.	G	T	10	6	16	0	1	17	0	0
22	17542702	.	G	A	2	9	11	0	0	11	0	0
22	17542774	.	C	T	1	2	3	0	0	3	0	0
22	17543079	.	C	G	3	2	5	0	0	5	0	0
22	17543408	.	A	G	7	4	11	0	0	11	0	0
22	17543421	.	G	A	6	3	9	0	0	9	0	0
22	17543552	.	G	A	7	10	17	0	2	19	0	0
22	17543634	.	A	C	5	13	18	0	0	18	0	0
22	17543668	.	A	T	3	9	12	0	1	13	0	0
22	17543748	.	A	C	7	0	7	0	5	12	0	0
22	17543903	.	A	G	6	8	14	0	1	15	0	0
22	17550643	.	T	C	7	0	7	0	5	12	0	0
22	17550664	.	G	A	8	8	16	0	1	17	0	0
22	17550684	.	C	T	0	5	5	0	10	15	0	0
22	17550724	.	T	G	4	1	5	0	0	5	0	0
22	17552526	.	A	G	2	6	8	0	0	8	0	0
22	17554785	.	G	A	11	8	19	0	1	20	0	0
22	17564009	.	T	C	7	9	16	0	0	16	0	0
22	17565735	.	C	T	10	9	19	0	0	19	0	0
22	17565837	.	A	G	1	0	1	0	0	1	0	0
22	17571428	.	G	A	1	2	3	0	0	3	0	0
22	17571533	.	C	A	1	2	3	0	0	3	0	0
22	17590019	.	G	A	0	3	3	0	0	3	0	0
22	17590037	.	C	T	0	3	3	0	0	3	0	0
22	17591712	.	G	A	7	16	23	0	1	24	0	0
22	17596874	.	G	A	1	4	5	0	0	5	0	0
22	17596903	.	C	G	5	21	26	0	0	26	0	0
22	17596943	.	A	T	9	30	39	0	1	40	0	0
22	17606908	.	A	C	7	5	12	0	0	12	0	0
22	17607226	.	G	A	5	4	9	0	0	9	0	0
22	17609589	.	C	G	1	1	2	0	0	2	0	0
22	17612089	.	G	C	1	1	2	0	1	3	0	0
22	17820204	.	C	T	1	2	3	0	0	3	0	0
22	17820208	.	T	C	1	2	3	0	0	3	0	0
22	17820615	.	G	T	2	3	5	0	0	5	0	0
22	17820645	.	T	C	1	2	3	0	0	3	0	0
22	17829168	.	A	G	4	6	10	0	0	10	0	0
22	17830360	.	A	G	20	9	29	0	0	29	0	0
22	17830632	.	A	G	15	9	24	0	0	24	0	0
22	17830640	.	A	G	14	7	21	0	1	22	0	0
22	17865106	.	G	A	3	5	8	0	0	8	0	0
22	18156402	.	G	A	0	2	2	0	1	3	0	0
22	18156459	.	G	A	0	0	0	0	1	1	0	0
22	18160090	.	T	G	1	2	3	0	0	3	0	0
22	18209465	.	T	G	1	0	1	0	0	1	0	0
22	18231080	.	A	G	1	5	6	0	0	6	0	0
22	18231099	.	G	T	2	5	7	0	0	7	0	0
22	18231256	.	T	A	4	3	7	0	1	8	0	0
22	18231366	.	T	C	16	7	23	0	0	23	0	0
22	18231370	.	A	G	9	12	21	0	1	22	0	0
22	18231472	.	T	C	6	2	8	0	0	8	0	0
22	18231492	.	G	C	4	4	8	0	0	8	0	0
22	18231673	.	T	A	4	5	9	0	0	9	0	0
22	18231770	.	C	G	2	4	6	0	0	6	0	0
22	18231831	.	T	A	4	3	7	0	0	7	0	0
22	18232503	.	G	C	2	5	7	0	2	9	0	0
22	18232527	.	C	T	2	6	8	0	0	8	0	0
22	18232725	.	T	C	1	1	2	0	0	2	0	0
22	18232754	.	T	C	2	3	5	0	1	6	0	0
22	18232868	.	G	T	7	7	14	0	0	14	0	0
22	18232935	.	T	G	3	5	8	0	0	8	0	0
22	18233053	.	C	A	5	9	14	0	0	14	0	0
22	18233143	.	T	A	7	4	11	0	0	11	0	0
22	18233367	.	T	A	2	5	7	0	0	7	0	0
22	18233403	.	G	A	3	6	9	0	0	9	0	0
22	18234340	.	A	C	1	0	1	0	0	1	0	0
22	18376143	.	G	C	0	0	0	0	1	1	0	0
22	18376167	.	C	T	2	1	3	0	0	3	0	0
22	18376359	.	C	A	3	5	8	0	0	8	0	0
22	18376434	.	G	A	7	4	11	0	0	11	0	0
22	18376467	.	A	C	3	4	7	0	1	8	0	0
22	18383311	.	G	T	0	2	2	0	1	3	0	0
22	18383996	.	C	T	4	4	8	0	0	8	0	0
22	18459182	.	C	T	5	2	7	0	0	7	0	0
22	18461964	.	C	T	6	5	11	0	0	11	0	0
22	18462018	.	A	G	9	12	21	0	0	21	0	0
22	18462239	.	C	T	10	9	19	0	1	20	0	0
22	18464455	.	T	C	2	1	3	0	1	4	0	0
22	18488823	.	T	C	6	8	14	0	0	14	0	0
22	18488952	.	C	A	1	6	7	0	0	7	0	0
22	18489191	.	A	G	3	1	4	0	0	4	0	0
22	18530449	.	G	C	1	2	3	0	0	3	0	0
22	18542090	.	C	T	31	19	50	0	0	50	0	0
22	18542393	.	C	T	7	19	26	0	0	26	0	0
22	18542508	.	A	G	30	7	37	0	3	40	0	0
22	18542720	.	A	T	11	28	39	1	2	42	0	0
22	18543819	.	C	G	32	28	60	0	2	62	0	0
22	18543847	.	T	G	33	31	64	0	1	65	0	0
22	18544465	.	C	T	0	1	1	0	5	6	0	0
22	18544992	.	T	C	15	7	22	0	1	23	0	0
22	18725485	.	T	A	6	12	18	0	1	19	0	0
22	18726040	.	A	T	16	19	35	0	2	38	1	0
22	18726470	.	A	T	19	24	43	0	2	45	0	0
22	18726505	.	T	A	18	24	42	0	3	45	0	0
22	18726668	.	C	A	20	15	35	0	1	36	0	0
22	18727787	.	C	A	0	8	8	0	12	20	0	0
22	18727890	.	G	A	17	6	23	0	1	24	0	0
22	18736155	.	T	C	15	2	17	0	24	41	0	0
22	18736182	.	C	T	11	22	33	0	3	36	0	0
22	18736859	.	A	G	18	15	33	0	4	37	0	0
22	18746486	.	A	G	10	10	20	0	0	20	0	0
22	18778872	.	C	T	25	20	45	0	0	45	0	0
22	18778895	.	A	C	22	22	44	0	2	46	0	0
22	18787118	.	G	A	1	2	3	0	1	4	0	0
22	18799110	.	T	G	0	1	1	0	0	1	0	0
22	18971667	.	T	C	4	5	9	0	0	9	0	0
22	18971697	.	T	C	7	6	13	1	1	15	0	0
22	18971725	.	T	C	4	4	8	1	0	9	0	0
22	18984654	.	T	C	4	1	5	0	0	5	0	0
22	19004960	.	T	C	10	1	11	0	0	11	0	0
22	19004989	.	A	T	1	2	3	0	0	3	0	0
22	19006676	.	A	G	5	3	8	0	0	8	0	0
22	19006763	.	T	C	8	5	13	0	0	13	0	0
22	19006994	.	T	C	8	12	20	0	0	20	0	0
22	19007574	.	A	G	8	10	18	0	2	20	0	0
22	19007677	.	C	A	13	6	19	0	5	24	0	0
22	19007764	.	A	G	9	6	15	0	1	16	0	0
22	19007931	.	A	T	6	3	9	0	0	9	0	0
22	19547501	.	A	T	10	11	21	0	0	21	0	0
22	19547573	.	C	G	0	14	14	0	11	25	0	0
22	19547575	.	A	C	11	0	11	0	14	25	0	0
22	19547796	.	C	T	7	19	26	0	3	29	0	0
22	19552745	.	C	T	12	11	23	0	0	23	0	0
22	19642960	.	T	A	5	2	7	0	0	7	0	0
22	19645155	.	G	A	3	3	6	0	0	6	0	0
22	19645170	.	G	A	3	2	5	0	0	5	0	0
22	19645673	.	C	G	4	0	4	0	4	8	0	0
22	19645802	.	G	A	1	5	6	0	0	6	0	0
22	19665618	.	C	T	5	3	8	0	0	8	0	0
22	19671776	.	A	G	11	13	24	0	0	24	0	0
22	20105123	.	C	G	8	3	11	0	0	11	0	0
22	20105242	.	A	G	4	3	7	0	0	7	0	0
22	20105500	.	G	A	2	2	4	0	0	4	0	0
22	20105686	.	T	C	1	1	2	0	2	4	0	0
22	20141539	.	C	G	5	2	7	0	0	7	0	0
22	20141551	.	C	A	5	2	7	0	0	7	0	0
22	20142160	.	T	C	3	3	6	0	0	6	0	0
22	20142178	.	A	T	4	3	7	0	0	7	0	0
22	20142226	.	C	G	5	4	9	0	0	9	0	0
22	20142373	.	A	T	5	2	7	0	0	7	0	0
22	20142378	.	T	A	5	2	7	0	1	8	0	0
22	20142713	.	C	T	2	3	5	0	0	5	0	0
22	20142723	.	A	T	2	5	7	0	0	7	0	0
22	20142753	.	T	A	3	5	8	0	0	8	0	0
22	20142772	.	T	G	3	3	6	0	0	6	0	0
22	20143002	.	G	T	6	3	9	0	0	9	0	0
22	20143138	.	A	G	5	2	7	0	0	7	0	0
22	20143143	.	G	T	4	3	7	0	0	7	0	0
22	20159200	.	A	C	20	9	29	0	1	30	0	0
22	20159576	.	A	T	14	23	37	0	2	39	0	0
22	20159771	.	C	A	19	21	40	0	0	40	0	0
22	20164449	.	T	C	2	1	3	0	0	3	0	0
22	20172105	.	A	G	3	0	3	0	1	4	0	0
22	20172642	.	A	G	3	7	10	0	0	10	0	0
22	20175295	.	G	A	9	8	17	0	1	18	0	0
22	20177970	.	G	A	0	13	13	0	11	24	0	0
22	20177981	.	G	A	13	10	23	0	1	24	0	0
22	20178045	.	C	T	6	8	14	0	0	14	0	0
22	20178065	.	T	C	5	8	13	0	0	13	0	0
22	20202641	.	G	A	3	6	9	0	0	9	0	0
22	20211187	.	T	C	2	3	5	0	0	5	0	0
22	20211289	.	G	T	0	1	1	0	2	3	0	0
22	20212794	.	G	T	0	0	0	0	2	2	0	0
22	20214649	.	G	A	0	2	2	0	5	7	0	0
22	20215089	.	T	A	2	3	5	0	0	5	0	0
22	20215351	.	C	T	1	1	2	0	0	2	0	0
22	20220161	.	A	G	4	0	4	0	6	10	0	0
22	20220197	.	C	T	6	10	16	0	0	16	0	0
22	20222950	.	G	C	0	1	1	0	0	1	0	0
22	20240483	.	T	C	12	16	28	0	0	28	0	0
22	20240835	.	A	G	15	14	29	0	1	30	0	0
22	20292595	.	A	T	9	13	22	0	0	22	0	0
22	20292789	.	T	C	17	22	39	0	3	42	0	0
22	20293049	.	T	A	7	5	12	0	0	12	0	0
22	20293440	.	G	A	13	9	22	0	0	22	0	0
22	20296615	.	A	T	19	19	38	0	3	42	1	0
22	20296669	.	T	C	9	10	19	0	2	21	0	0
22	20299280	.	A	G	7	6	13	0	1	14	0	0
22	20299283	.	G	A	8	7	15	0	0	15	0	0
22	20299349	.	T	C	17	23	40	0	2	42	0	0
22	20303406	.	A	G	13	24	37	0	1	38	0	0
22	20303412	.	G	T	13	27	40	0	2	42	0	0
22	20303487	.	A	G	0	4	4	0	0	4	0	0
22	20305443	.	G	T	19	16	35	0	3	38	0	0
22	20313722	.	C	A	13	11	24	0	7	31	0	0
22	20313791	.	A	G	12	15	27	0	1	28	0	0
22	20313887	.	C	G	15	13	28	0	4	32	0	0
22	20313926	.	C	A	1	11	12	0	20	32	0	0
22	20315851	.	T	C	3	0	3	0	12	15	0	0
22	20315883	.	C	T	5	13	18	0	2	20	0	0
22	20315896	.	G	A	4	15	19	0	1	20	0	0
22	20316020	.	G	A	1	1	2	0	1	3	0	0
22	20318937	.	C	T	0	7	7	0	12	19	0	0
22	20319149	.	A	G	1	7	8	0	1	9	0	0
22	20342078	.	A	T	1	3	4	0	0	4	0	0
22	20388735	.	T	A	1	5	6	0	0	7	1	0
22	20388853	.	G	A	13	13	26	0	1	27	0	0
22	20389198	.	C	A	17	13	30	0	0	30	0	0
22	20389286	.	A	G	8	9	17	0	2	19	0	0
22	20389392	.	A	G	9	9	18	0	1	19	0	0
22	20389538	.	A	T	21	13	34	0	0	34	0	0
22	20389545	.	G	A	19	13	32	0	2	34	0	0
22	20389580	.	T	G	20	10	30	0	2	32	0	0
22	20389620	.	T	A	19	10	29	0	1	30	0	0
22	20390002	.	C	A	8	11	19	0	0	19	0	0
22	20390041	.	C	T	13	14	27	0	1	28	0	0
22	20402889	.	T	C	4	5	9	0	0	9	0	0
22	20408865	.	T	C	8	0	8	0	6	14	0	0
22	20409099	.	C	T	4	10	14	0	0	14	0	0
22	20475994	.	T	C	2	2	4	0	0	4	0	0
22	20574066	.	T	C	12	10	22	0	0	22	0	0
22	20574402	.	A	G	11	7	18	0	2	20	0	0
22	20574585	.	A	G	8	7	15	0	1	16	0	0
22	20575634	.	G	A	4	5	9	0	0	9	0	0
22	20848297	.	G	A	5	6	11	0	1	12	0	0
22	20848326	.	C	T	3	3	6	0	0	6	0	0
22	20848488	.	G	A	10	10	20	0	0	20	0	0
22	20848501	.	A	G	9	10	19	0	0	19	0	0
22	20849615	.	T	C	0	0	0	0	1	1	0	0
22	20877036	.	T	C	1	0	1	0	2	3	0	0
22	20926466	.	G	A	13	8	21	0	0	21	0	0
22	20926511	.	G	A	12	7	19	0	1	20	0	0
22	20940039	.	C	T	0	6	6	0	3	9	0	0
22	20940048	.	G	A	4	7	11	0	0	11	0	0
22	20944679	.	A	G	3	6	9	0	1	10	0	0
22	20951387	.	T	C	14	0	14	0	8	22	0	0
22	20951514	.	C	T	0	17	17	0	18	35	0	0
22	20951788	.	G	A	27	18	45	0	1	46	0	0
22	20951861	.	C	T	12	10	22	0	1	23	0	0
22	20951866	.	G	T	11	8	19	0	1	20	0	0
22	20952257	.	A	G	14	25	39	0	2	41	0	0
22	20952292	.	A	T	13	16	29	0	3	32	0	0
22	20953053	.	T	A	10	11	21	0	0	21	0	0
22	20953127	.	A	T	10	5	15	0	1	16	0	0
22	20953141	.	C	A	9	5	14	0	1	15	0	0
22	20953418	.	G	A	13	14	27	0	0	27	0	0
22	20953555	.	C	A	16	9	25	0	0	25	0	0
22	20953578	.	A	G	13	9	22	0	0	22	0	0
22	20954086	.	T	A	0	1	1	0	0	1	0	0
22	20954386	.	C	T	7	4	11	0	0	11	0	0
22	20954391	.	C	T	7	4	11	0	0	11	0	0
22	20954557	.	T	A	8	7	15	0	0	15	0	0
22	20954717	.	A	T	13	21	34	0	0	34	0	0
22	20954810	.	C	T	2	15	17	0	18	35	0	0
22	20954953	.	C	T	13	23	36	0	0	36	0	0
22	20955427	.	C	T	0	12	12	0	6	18	0	0
22	20955469	.	C	T	0	14	14	0	3	17	0	0
22	21032184	.	A	G	0	1	1	0	0	1	0	0
22	21128200	.	A	G	14	16	30	0	2	32	0	0
22	21129075	.	G	A	22	36	58	0	5	63	0	0
22	21129101	.	G	A	29	34	63	0	3	66	0	0
22	21129407	.	A	G	31	32	63	0	6	69	0	0
22	21129558	.	T	G	35	27	62	0	2	64	0	0
22	21129575	.	T	C	30	31	61	0	3	64	0	0
22	21676215	.	A	G	0	5	5	0	0	5	0	0
22	21676233	.	G	A	1	9	10	0	0	10	0	0
22	21676296	.	G	A	2	14	16	0	1	17	0	0
22	22129568	.	T	A	5	4	9	0	1	10	0	0
22	22129586	.	T	C	7	5	12	0	0	12	0	0
22	22129754	.	A	G	7	3	10	0	0	10	0	0
22	22141175	.	C	T	1	3	4	0	3	7	0	0
22	22141373	.	T	C	4	2	6	0	0	6	0	0
22	22141533	.	T	C	7	3	10	0	1	11	0	0
22	22179714	.	A	G	5	6	11	0	0	11	0	0
22	22187939	.	T	A	4	4	8	0	0	8	0	0
22	22188715	.	T	C	8	13	21	0	1	22	0	0
22	22188717	.	C	T	9	13	22	0	0	22	0	0
22	22196339	.	G	A	6	5	11	0	0	11	0	0
22	22199227	.	G	A	4	3	7	0	0	7	0	0
22	22204002	.	C	T	5	6	11	0	0	11	0	0
22	22204098	.	C	T	2	2	4	0	0	4	0	0
22	22204395	.	G	A	4	5	9	0	0	9	0	0
22	22204440	.	G	A	2	0	2	0	0	2	0	0
22	22214640	.	G	A	6	3	9	0	0	9	0	0
22	22215458	.	G	T	1	3	4	0	1	5	0	0
22	22234750	.	G	A	14	6	20	0	0	20	0	0
22	22241769	.	A	G	1	7	8	0	0	8	0	0
22	22241772	.	A	T	1	8	9	0	1	10	0	0
22	22245400	.	T	C	2	2	4	0	0	4	0	0
22	22245435	.	C	T	5	5	10	0	1	11	0	0
22	22245617	.	A	G	6	5	11	0	0	11	0	0
22	22245812	.	C	T	4	12	16	0	0	16	0	0
22	22251493	.	A	C	8	0	8	0	3	11	0	0
22	22260456	.	G	A	1	0	1	0	0	1	0	0
22	22266519	.	T	C	1	3	4	0	2	6	0	0
22	22267524	.	G	C	0	2	2	0	1	3	0	0
22	22273465	.	G	A	5	4	9	0	0	9	0	0
22	22273871	.	A	C	7	12	19	0	0	19	0	0
22	22274000	.	A	T	4	6	10	0	0	10	0	0
22	22274137	.	C	T	4	4	8	0	0	8	0	0
22	22276418	.	C	T	4	3	7	0	0	7	0	0
22	22276897	.	C	T	1	3	4	0	0	4	0	0
22	22277159	.	C	T	0	1	1	0	3	4	0	0
22	22311283	.	T	C	3	3	6	0	0	6	0	0
22	22313104	.	A	T	6	4	10	0	0	10	0	0
22	22313260	.	A	T	4	4	8	0	1	9	0	0
22	22313376	.	T	C	6	3	9	0	0	9	0	0
22	22313651	.	C	A	3	2	5	0	0	5	0	0
22	22313652	.	G	T	0	2	2	0	3	5	0	0
22	22313686	.	G	A	0	2	2	0	6	8	0	0
22	22313710	.	C	A	5	3	8	0	0	8	0	0
22	22313794	.	G	A	4	5	9	0	0	9	0	0
22	22313927	.	G	C	5	2	7	0	0	7	0	0
22	22313959	.	C	T	5	2	7	0	0	7	0	0
22	22314427	.	G	T	6	11	17	0	0	17	0	0
22	22314430	.	A	C	6	11	17	0	0	17	0	0
22	22314721	.	A	G	17	11	28	0	1	29	0	0
22	22314861	.	C	G	4	3	7	0	3	10	0	0
22	22314870	.	G	C	4	5	9	0	1	10	0	0
22	22315048	.	T	C	1	5	6	0	0	6	0	0
22	22345136	.	C	T	0	13	13	0	7	20	0	0
22	22345179	.	A	C	10	9	19	0	1	20	0	0
22	22345197	.	C	T	12	9	21	0	2	23	0	0
22	22345255	.	G	A	12	15	27	0	0	27	0	0
22	22345367	.	C	T	0	10	10	0	20	30	0	0
22	22345403	.	G	A	14	11	25	0	0	25	0	0
22	22345418	.	G	A	12	11	23	0	1	24	0	0
22	22348234	.	A	G	6	0	6	0	0	6	0	0
22	22350963	.	C	T	4	5	9	0	1	10	0	0
22	22351103	.	A	T	0	3	3	0	0	4	1	0
22	22352249	.	C	T	3	3	6	0	0	6	0	0
22	22352312	.	T	C	6	11	17	0	0	17	0	0
22	22353128	.	G	A	6	9	15	0	0	15	0	0
22	22353222	.	G	A	8	2	10	0	0	10	0	0
22	22353416	.	A	G	3	6	9	0	0	9	0	0
22	22353803	.	C	T	0	8	8	0	2	10	0	0
22	22353822	.	G	A	1	6	7	0	1	8	0	0
22	22354145	.	G	A	2	4	6	0	0	6	0	0
22	22354698	.	C	T	0	0	0	0	2	2	0	0
22	22354867	.	C	T	3	2	5	0	0	5	0	0
22	22376174	.	C	T	0	4	4	0	4	8	0	0
22	22397336	.	G	A	3	2	5	0	0	5	0	0
22	22397402	.	A	C	4	0	4	0	5	9	0	0
22	22418342	.	C	T	2	3	5	0	1	6	0	0
22	22418446	.	A	G	2	0	2	0	4	6	0	0
22	22420456	.	G	A	0	1	1	0	0	1	0	0
22	22424058	.	C	T	3	2	5	0	0	5	0	0
22	22424085	.	A	T	2	3	5	0	0	5	0	0
22	22424106	.	G	A	0	3	3	0	1	4	0	0
22	22427415	.	T	C	9	6	15	0	0	15	0	0
22	22427612	.	C	T	4	7	11	0	0	11	0	0
22	22427880	.	C	T	2	3	5	0	0	5	0	0
22	22428076	.	A	G	1	0	1	0	2	3	0	0
22	22428125	.	T	C	1	4	5	0	0	5	0	0
22	22634168	.	A	G	2	2	4	0	0	4	0	0
22	22634864	.	G	A	3	2	5	0	0	5	0	0
22	22979798	.	T	C	1	2	3	0	0	3	0	0
22	22981064	.	G	A	1	1	2	0	0	2	0	0
22	22982792	.	G	A	0	2	2	0	0	2	0	0
22	24360043	.	C	T	0	2	2	0	0	2	0	0
22	24360443	.	G	T	1	2	3	0	0	3	0	0
22	24360615	.	G	T	3	2	5	0	0	5	0	0
22	24361095	.	A	G	11	10	21	0	0	21	0	0
22	25942829	.	A	C	3	4	7	0	0	7	0	0
22	26134616	.	T	C	0	1	1	0	0	1	0	0
22	26180265	.	T	C	0	4	4	0	0	4	0	0
22	26180280	.	A	G	0	4	4	0	0	4	0	0
22	26180300	.	C	T	0	7	7	0	0	7	0	0
22	29096343	.	C	T	0	1	1	0	0	1	0	0
22	29585244	.	G	A	1	2	3	0	0	3	0	0
22	29585247	.	G	C	3	2	5	0	0	5	0	0
22	29615056	.	A	G	1	2	3	0	0	3	0	0
22	29617050	.	G	A	2	4	6	0	0	6	0	0
22	29620488	.	T	G	4	5	9	0	0	9	0	0
22	29651938	.	C	T	13	13	26	0	0	26	0	0
22	29652161	.	T	A	6	13	19	0	1	20	0	0
22	29652201	.	A	G	10	0	10	0	9	19	0	0
22	29659031	.	T	A	8	5	13	0	3	16	0	0
22	29659637	.	G	A	14	8	22	0	0	22	0	0
22	29666501	.	G	A	17	11	28	0	3	31	0	0
22	29666505	.	C	T	0	19	19	0	13	32	0	0
22	29666746	.	G	A	7	6	13	0	0	13	0	0
22	29668796	.	C	T	0	2	2	0	2	4	0	0
22	29668799	.	C	T	4	0	4	0	0	4	0	0
22	29670324	.	G	A	4	5	9	0	2	11	0	0
22	29671553	.	A	G	4	1	5	0	0	5	0	0
22	29689458	.	T	C	1	4	5	0	0	5	0	0
22	29858936	.	T	C	11	11	22	0	1	23	0	0
22	31440674	.	C	T	0	1	1	0	1	2	0	0
22	31456026	.	A	T	3	2	5	0	0	5	0	0
22	31513575	.	C	T	0	1	1	0	0	1	0	0
22	32235134	.	G	C	2	2	4	0	0	4	0	0
22	32240395	.	A	G	9	11	20	0	2	22	0	0
22	33190835	.	C	T	8	10	18	0	2	20	0	0
22	33190874	.	T	G	5	2	7	0	7	14	0	0
22	33190994	.	C	T	5	12	17	0	0	17	0	0
22	33191033	.	C	A	15	6	21	0	1	22	0	0
22	33191039	.	C	T	8	14	22	0	0	22	0	0
22	33191097	.	A	G	11	5	16	0	1	17	0	0
22	33191312	.	C	G	1	0	1	0	6	7	0	0
22	33191426	.	G	T	0	8	8	0	5	13	0	0
22	33191831	.	C	A	6	9	15	0	0	15	0	0
22	33191852	.	G	T	0	3	3	0	7	10	0	0
22	33192392	.	T	G	13	1	14	0	15	29	0	0
22	33192496	.	G	A	12	12	24	0	0	24	0	0
22	33193261	.	C	T	3	7	10	0	0	10	0	0
22	33193821	.	G	T	4	3	7	0	1	8	0	0
22	33194419	.	T	A	11	11	22	0	0	22	0	0
22	33194475	.	C	T	11	7	18	0	0	18	0	0
22	33194507	.	G	A	0	13	13	0	8	21	0	0
22	33364271	.	A	T	2	1	3	0	0	3	0	0
22	33364536	.	C	T	2	8	10	0	0	10	0	0
22	33378479	.	G	A	0	2	2	0	3	5	0	0
22	33535881	.	C	T	0	6	6	0	2	8	0	0
22	33535884	.	C	T	0	6	6	0	2	8	0	0
22	33591895	.	C	T	1	2	3	0	7	10	0	0
22	33592708	.	T	C	7	1	8	0	13	21	0	0
22	33639382	.	C	T	0	0	0	0	1	1	0	0
22	33639388	.	G	A	0	1	1	0	0	1	0	0
22	33639418	.	G	A	3	4	7	0	0	7	0	0
22	34701851	.	G	A	3	2	5	0	0	5	0	0
22	34701901	.	G	C	13	21	34	0	0	34	0	0
22	34706938	.	T	C	16	14	30	0	0	30	0	0
22	34707119	.	G	T	15	30	45	0	0	45	0	0
22	34707272	.	T	A	15	15	30	0	5	35	0	0
22	34707295	.	C	T	9	15	24	0	1	25	0	0
22	34843381	.	T	A	1	2	3	0	0	3	0	0
22	34843507	.	G	A	1	3	4	0	0	4	0	0
22	34843569	.	C	T	4	5	9	0	1	10	0	0
22	34843910	.	T	C	4	2	6	0	0	6	0	0
22	34843964	.	C	A	0	1	1	0	1	2	0	0
22	34847690	.	A	G	4	2	6	0	0	6	0	0
22	34849054	.	A	C	1	0	1	0	1	2	0	0
22	35013549	.	A	T	4	6	10	0	0	10	0	0
22	35013675	.	C	T	0	10	10	0	7	17	0	0
22	35013679	.	C	T	6	10	16	0	0	16	0	0
22	35014014	.	G	A	3	2	5	0	0	5	0	0
22	35014251	.	T	C	1	0	1	0	3	4	0	0
22	35015828	.	C	T	3	5	8	0	0	8	0	0
22	35016177	.	G	A	8	9	17	0	0	17	0	0
22	35016185	.	A	G	7	9	16	0	0	16	0	0
22	35042857	.	T	C	1	0	1	0	1	2	0	0
22	35049063	.	A	G	0	1	1	0	0	1	0	0
22	35530191	.	A	G	2	3	5	0	0	5	0	0
22	35530193	.	A	C	2	2	4	0	0	5	1	0
22	35531281	.	G	A	2	10	12	0	0	12	0	0
22	35531291	.	G	A	1	3	4	0	9	13	0	0
22	35531376	.	A	G	1	4	5	0	0	5	0	0
22	36505067	.	G	A	1	2	3	0	0	3	0	0
22	36505097	.	A	G	1	2	3	0	0	3	0	0
22	36524050	.	G	A	1	1	2	0	0	2	0	0
22	36524073	.	C	A	3	2	5	0	0	5	0	0
22	36524302	.	T	C	1	5	6	0	0	6	0	0
22	36527591	.	A	G	2	4	6	0	0	6	0	0
22	36530090	.	C	T	0	2	2	0	7	9	0	0
22	36592878	.	T	C	1	0	1	0	0	1	0	0
22	36616814	.	G	A	0	0	0	0	3	3	0	0
22	36622717	.	A	G	1	2	3	0	0	3	0	0
22	36634111	.	T	C	5	3	8	0	0	8	0	0
22	36634127	.	T	C	4	2	6	0	0	6	0	0
22	36634167	.	G	C	0	3	3	0	2	5	0	0
22	36634213	.	G	A	0	2	2	0	1	3	0	0
22	36676056	.	G	C	15	8	23	0	1	24	0	0
22	36679390	.	G	A	15	19	34	0	4	38	0	0
22	36683803	.	C	A	2	4	6	0	0	6	0	0
22	36685729	.	C	T	19	16	35	0	1	36	0	0
22	36686828	.	G	A	2	3	5	0	0	5	0	0
22	36686867	.	G	A	7	8	15	0	1	16	0	0
22	36686870	.	A	G	6	6	12	0	4	16	0	0
22	36686948	.	G	T	2	3	5	0	0	5	0	0
22	36687328	.	G	A	1	6	7	0	0	7	0	0
22	36687403	.	G	A	5	7	12	0	0	12	0	0
22	36687541	.	T	C	2	1	3	0	0	3	0	0
22	36687616	.	C	T	0	11	11	0	8	19	0	0
22	36690668	.	T	A	11	15	26	0	0	26	0	0
22	36741467	.	T	C	2	0	2	0	2	4	0	0
22	36755458	.	A	T	5	4	9	0	0	9	0	0
22	36755554	.	A	C	5	5	10	0	0	10	0	0
22	36755641	.	C	T	4	3	7	0	0	7	0	0
22	36755751	.	A	T	5	3	8	0	0	8	0	0
22	36755831	.	G	A	3	5	8	0	0	8	0	0
22	36755963	.	G	C	7	0	7	0	11	18	0	0
22	36756112	.	A	G	2	9	11	0	0	11	0	0
22	36756325	.	G	A	5	4	9	0	1	10	0	0
22	36756333	.	T	C	4	0	4	0	4	8	0	0
22	36756400	.	C	T	7	4	11	0	0	11	0	0
22	36756404	.	G	C	7	4	11	0	0	11	0	0
22	36756464	.	T	A	9	6	15	0	1	16	0	0
22	36768060	.	C	T	0	1	1	0	2	3	0	0
22	36768102	.	G	A	1	0	1	0	0	1	0	0
22	36795845	.	G	T	5	6	11	0	0	11	0	0
22	36800981	.	G	C	7	6	13	0	0	13	0	0
22	36802988	.	A	T	1	3	4	0	0	4	0	0
22	36839462	.	T	C	0	0	0	0	1	1	0	0
22	36875581	.	T	C	2	4	6	0	0	6	0	0
22	36875584	.	A	G	2	0	2	0	4	6	0	0
22	36877531	.	G	A	0	4	4	0	1	5	0	0
22	36877534	.	G	T	0	4	4	0	1	5	0	0
22	36878044	.	T	A	0	1	1	0	0	1	0	0
22	36879468	.	G	T	5	2	7	0	0	7	0	0
22	36879483	.	C	T	4	1	5	0	1	6	0	0
22	36882150	.	G	A	6	4	10	0	0	10	0	0
22	36882168	.	G	A	0	6	6	0	8	14	0	0
22	36882189	.	G	A	0	6	6	0	6	12	0	0
22	36882388	.	T	C	3	3	6	0	0	6	0	0
22	36882409	.	T	A	2	1	3	0	0	3	0	0
22	36887954	.	C	T	0	1	1	0	1	2	0	0
22	36888623	.	A	G	2	2	4	0	0	4	0	0
22	36891142	.	G	A	2	1	3	0	0	3	0	0
22	36893330	.	T	C	6	3	9	0	0	9	0	0
22	36893357	.	G	A	3	10	13	0	1	14	0	0
22	36894316	.	T	A	5	9	14	0	1	15	0	0
22	36894410	.	A	C	2	3	5	0	0	5	0	0
22	36896641	.	G	A	0	1	1	0	0	1	0	0
22	36896677	.	G	T	6	7	13	0	1	14	0	0
22	36899269	.	C	T	0	3	3	0	0	3	0	0
22	36899483	.	G	A	0	7	7	0	7	14	0	0
22	36899611	.	C	A	4	7	11	0	0	11	0	0
22	36899621	.	A	T	9	4	13	0	0	13	0	0
22	36947793	.	T	A	5	10	15	0	0	15	0	0
22	36947836	.	C	A	3	11	14	0	1	15	0	0
22	36947849	.	G	A	4	10	14	0	0	14	0	0
22	36947879	.	G	C	5	8	13	0	0	14	1	0
22	36947997	.	A	G	7	6	13	0	0	13	0	0
22	36948052	.	T	G	5	5	10	0	0	10	0	0
22	36948133	.	G	A	8	7	15	0	1	16	0	0
22	36948134	.	C	T	9	6	15	0	1	16	0	0
22	36948202	.	C	A	4	7	11	0	1	12	0	0
22	36948312	.	C	T	0	5	5	0	8	13	0	0
22	36948395	.	T	C	9	0	9	0	5	14	0	0
22	36948603	.	T	A	13	10	23	0	0	23	0	0
22	37276635	.	T	C	4	0	4	0	14	18	0	0
22	37276709	.	C	T	0	8	8	0	6	14	0	0
22	37277688	.	A	G	1	2	3	0	0	3	0	0
22	37278175	.	C	T	0	2	2	0	4	6	0	0
22	37278283	.	A	T	3	3	6	0	1	7	0	0
22	37278475	.	A	G	21	12	33	0	0	33	0	0
22	37278479	.	T	C	20	0	20	0	11	31	0	0
22	37278634	.	C	T	7	1	8	0	0	8	0	0
22	37352700	.	C	G	5	10	15	0	0	15	0	0
22	37534114	.	T	C	2	3	5	0	0	5	0	0
22	37534122	.	C	G	4	5	9	0	0	9	0	0
22	37542836	.	C	A	5	5	10	0	1	11	0	0
22	37543070	.	A	T	14	9	23	0	0	23	0	0
22	37543457	.	A	G	9	10	19	0	0	19	0	0
22	37551481	.	G	C	4	2	6	0	2	8	0	0
22	37551496	.	T	C	1	0	1	0	0	1	0	0
22	37552717	.	G	A	5	8	13	0	1	14	0	0
22	37552783	.	A	C	9	2	11	0	16	27	0	0
22	37553015	.	C	T	0	4	4	0	3	7	0	0
22	37557531	.	G	A	4	10	14	0	2	16	0	0
22	37561609	.	G	A	2	1	3	0	1	4	0	0
22	37561642	.	C	G	1	3	4	0	0	4	0	0
22	37588622	.	T	C	5	0	5	0	10	15	0	0
22	37588667	.	A	C	7	10	17	0	2	19	0	0
22	37588715	.	T	C	4	8	12	0	1	13	0	0
22	37589898	.	A	T	14	5	19	0	0	19	0	0
22	37590171	.	C	T	5	3	8	0	1	9	0	0
22	37590339	.	A	T	7	9	16	0	6	22	0	0
22	37590535	.	C	T	8	4	12	0	0	12	0	0
22	37590710	.	T	G	3	9	12	0	0	12	0	0
22	37590711	.	C	T	3	9	12	0	0	12	0	0
22	37590925	.	T	C	5	5	10	0	1	11	0	0
22	37591023	.	A	C	2	3	5	0	0	5	0	0
22	37591444	.	T	C	7	0	7	0	4	11	0	0
22	37591457	.	T	C	2	6	8	0	0	8	0	0
22	37596906	.	C	T	1	0	1	0	0	1	0	0
22	37599007	.	C	A	0	2	2	0	0	2	0	0
22	37599058	.	G	A	4	2	6	0	0	6	0	0
22	37599076	.	A	G	2	2	4	0	0	4	0	0
22	37610043	.	C	T	0	1	1	0	2	3	0	0
22	37611298	.	T	G	1	6	7	0	0	7	0	0
22	37611657	.	A	G	1	2	3	0	0	3	0	0
22	37639239	.	C	T	1	5	6	0	0	6	0	0
22	37639311	.	C	T	1	2	3	0	0	3	0	0
22	37641741	.	G	A	3	2	5	0	0	5	0	0
22	37644009	.	C	A	7	6	13	0	0	13	0	0
22	37644021	.	C	G	6	5	11	0	2	13	0	0
22	37644048	.	A	G	1	1	2	0	1	3	0	0
22	37646124	.	C	T	0	2	2	0	1	3	0	0
22	37646226	.	T	A	1	2	3	0	0	3	0	0
22	37652191	.	C	T	3	2	5	0	0	5	0	0
22	37652925	.	C	T	2	0	2	0	0	2	0	0
22	37655702	.	C	T	2	1	3	0	1	4	0	0
22	37697408	.	C	T	7	6	13	0	1	14	0	0
22	37708199	.	T	A	12	17	29	0	0	29	0	0
22	37710178	.	G	T	1	2	3	0	0	3	0	0
22	37712570	.	A	G	15	2	17	0	23	40	0	0
22	37716493	.	G	C	6	3	9	0	0	9	0	0
22	37716613	.	A	T	2	4	6	0	0	6	0	0
22	37738043	.	C	T	0	1	1	0	1	2	0	0
22	37738049	.	G	T	1	2	3	0	0	3	0	0
22	37746900	.	G	C	1	0	1	0	0	1	0	0
22	37746901	.	G	A	1	0	1	0	0	1	0	0
22	37805329	.	C	T	13	23	36	0	3	39	0	0
22	37823332	.	C	A	0	2	2	0	3	5	0	0
22	37881126	.	C	T	5	9	14	0	0	14	0	0
22	37881134	.	G	A	5	8	13	0	0	13	0	0
22	37951769	.	G	A	0	2	2	0	0	2	0	0
22	37951790	.	G	C	1	2	3	0	0	3	0	0
22	38005162	.	C	G	0	1	1	0	0	1	0	0
22	38030803	.	C	T	0	1	1	0	1	2	0	0
22	38030812	.	C	T	1	1	2	0	0	2	0	0
22	38034577	.	A	T	1	3	4	0	0	4	0	0
22	38034830	.	C	T	0	4	4	0	1	5	0	0
22	38037578	.	A	T	13	7	20	0	0	20	0	0
22	38037603	.	G	T	8	5	13	0	0	13	0	0
22	38040050	.	G	A	0	2	2	0	0	2	0	0
22	38044902	.	G	C	0	14	14	0	3	17	0	0
22	38045009	.	T	A	4	13	17	0	3	20	0	0
22	38045213	.	G	T	3	1	4	0	1	5	0	0
22	38178747	.	G	A	1	7	8	0	0	8	0	0
22	38186409	.	A	G	1	2	3	0	0	3	0	0
22	38191136	.	G	A	3	5	8	0	0	8	0	0
22	38191168	.	C	G	6	5	11	0	0	11	0	0
22	38191718	.	T	A	4	11	15	0	0	15	0	0
22	38192440	.	A	G	6	5	11	0	0	11	0	0
22	38194106	.	C	T	6	9	15	0	2	17	0	0
22	38194415	.	A	G	4	5	9	0	0	9	0	0
22	38194419	.	G	C	4	2	6	0	1	7	0	0
22	38195217	.	G	A	9	21	30	1	1	32	0	0
22	38199812	.	A	G	5	6	11	0	0	11	0	0
22	38205099	.	C	T	0	7	7	0	3	10	0	0
22	38207367	.	T	A	4	2	6	0	0	6	0	0
22	38209190	.	C	T	1	2	3	0	0	3	0	0
22	38284020	.	A	C	2	4	6	0	0	6	0	0
22	38290307	.	G	A	0	1	1	0	0	1	0	0
22	38343351	.	T	C	1	1	2	0	1	3	0	0
22	38567348	.	C	T	0	1	1	0	1	2	0	0
22	39093913	.	G	A	1	7	8	0	0	8	0	0
23	310662	.	G	T	14	15	29	0	0	29	0	0
23	310860	.	G	C	0	2	2	0	0	2	0	0
23	312700	.	C	A	4	4	8	0	0	8	0	0
23	312703	.	A	C	5	4	9	0	0	9	0	0
23	313274	.	G	A	12	6	18	0	0	18	0	0
23	313368	.	A	G	9	0	9	0	10	19	0	0
23	313559	.	G	A	1	4	5	0	1	6	0	0
23	314018	.	G	A	5	2	7	0	0	7	0	0
23	314055	.	T	C	0	7	7	0	0	7	0	0
23	314093	.	A	T	4	5	9	0	1	10	0	0
23	314268	.	T	C	2	5	7	0	0	7	0	0
23	314370	.	T	A	4	10	14	0	0	14	0	0
23	314413	.	G	T	0	13	13	0	4	17	0	0
23	314523	.	C	T	3	5	8	0	0	8	0	0
23	314573	.	A	G	2	6	8	0	0	8	0	0
23	314841	.	A	T	1	3	4	0	0	4	0	0
23	314910	.	C	T	8	3	11	0	0	11	0	0
23	315057	.	G	C	5	4	9	0	0	9	0	0
23	315286	.	A	G	14	24	38	0	4	42	0	0
23	320806	.	T	C	4	6	10	0	0	10	0	0
23	320819	.	A	G	4	2	6	0	2	8	0	0
23	322290	.	A	G	1	2	3	0	1	4	0	0
23	327998	.	C	T	4	3	7	0	0	7	0	0
23	328248	.	G	C	2	3	5	0	0	5	0	0
23	328251	.	T	C	2	0	2	0	3	5	0	0
23	328469	.	A	T	3	3	6	0	0	6	0	0
23	328589	.	T	A	3	2	5	0	0	5	0	0
23	328825	.	C	T	0	3	3	0	1	4	0	0
23	355954	.	C	T	1	2	3	0	0	3	0	0
23	359371	.	A	T	1	1	2	0	0	2	0	0
23	360355	.	G	A	3	1	4	0	0	4	0	0
23	365495	.	A	G	6	0	6	0	5	11	0	0
23	365528	.	C	T	1	2	3	0	0	3	0	0
23	366662	.	T	C	4	5	9	0	1	10	0	0
23	367431	.	T	A	2	3	5	0	0	5	0	0
23	367500	.	C	T	5	4	9	0	0	9	0	0
23	367674	.	A	T	2	2	4	0	0	4	0	0
23	367682	.	T	C	1	2	3	0	0	3	0	0
23	423609	.	A	T	4	2	6	0	0	6	0	0
23	423790	.	G	A	3	3	6	0	1	7	0	0
23	423802	.	C	T	4	3	7	0	0	7	0	0
23	457872	.	T	C	7	8	15	0	0	15	0	0
23	457995	.	A	T	5	2	7	0	0	7	0	0
23	458086	.	G	A	4	3	7	0	0	7	0	0
23	458194	.	T	A	4	16	20	0	1	21	0	0
23	458995	.	A	T	1	2	3	0	0	3	0	0
23	459015	.	T	C	2	0	2	0	0	2	0	0
23	459671	.	C	T	0	10	10	0	9	19	0	0
23	460612	.	G	C	6	3	9	0	1	10	0	0
23	460794	.	C	T	3	1	4	0	1	5	0	0
23	461177	.	T	C	4	3	7	0	0	7	0	0
23	461999	.	G	A	0	2	2	0	0	2	0	0
23	462156	.	G	T	2	3	5	0	1	6	0	0
23	462162	.	G	A	2	4	6	0	0	6	0	0
23	480551	.	C	G	12	9	21	0	2	23	0	0
23	480552	.	A	G	13	9	22	0	1	23	0	0
23	481089	.	T	G	25	20	45	0	2	47	0	0
23	484376	.	C	A	5	3	8	0	0	8	0	0
23	484588	.	G	A	7	3	10	0	0	10	0	0
23	488257	.	A	G	1	5	6	0	0	6	0	0
23	488996	.	G	A	6	3	9	0	2	11	0	0
23	493127	.	A	C	3	0	3	0	5	8	0	0
23	495732	.	A	T	1	5	6	0	0	6	0	0
23	495747	.	C	T	0	4	4	0	1	5	0	0
23	495817	.	T	A	2	2	4	0	0	4	0	0
23	496582	.	C	T	1	4	5	0	2	7	0	0
23	496672	.	G	A	3	3	6	0	0	6	0	0
23	517969	.	C	T	0	1	1	0	0	1	0	0
23	517994	.	C	T	0	2	2	0	0	2	0	0
23	528234	.	T	A	2	1	3	0	0	3	0	0
23	547870	.	T	G	1	1	2	0	0	2	0	0
23	547873	.	G	A	1	1	2	0	0	2	0	0
23	551277	.	C	T	3	2	5	0	0	5	0	0
23	552367	.	T	C	5	6	11	0	0	11	0	0
23	552392	.	C	G	0	8	8	0	5	13	0	0
23	555870	.	A	G	0	3	3	0	0	3	0	0
23	566986	.	C	G	4	2	6	0	0	6	0	0
23	570688	.	G	A	2	13	15	0	1	16	0	0
23	570702	.	A	C	2	10	12	0	3	15	0	0
23	571355	.	A	G	16	10	26	0	0	26	0	0
23	571415	.	C	A	0	10	10	0	9	19	0	0
23	571724	.	A	G	3	0	3	0	1	4	0	0
23	580115	.	G	C	0	2	2	0	0	2	0	0
23	584380	.	G	A	0	3	3	0	13	16	0	0
23	584411	.	A	T	10	6	16	0	0	16	0	0
23	584426	.	C	A	6	6	12	0	0	12	0	0
23	584580	.	G	A	0	9	9	0	10	19	0	0
23	584790	.	G	A	0	8	8	0	10	18	0	0
23	584928	.	G	T	0	1	1	0	5	6	0	0
23	584938	.	G	A	2	5	7	0	0	7	0	0
23	585221	.	C	T	5	2	7	0	0	7	0	0
23	585624	.	A	G	5	11	16	0	1	17	0	0
23	585655	.	C	T	9	10	19	0	1	20	0	0
23	585691	.	G	C	0	5	5	0	13	18	0	0
23	586149	.	T	C	6	4	10	0	0	10	0	0
23	586158	.	A	T	6	7	13	0	0	13	0	0
23	586529	.	C	G	10	0	10	0	5	15	0	0
23	586614	.	A	T	14	5	19	0	1	20	0	0
23	586874	.	G	A	11	6	17	0	1	18	0	0
23	587161	.	A	G	10	6	16	0	5	21	0	0
23	587169	.	A	C	12	6	18	0	1	19	0	0
23	587341	.	G	T	8	10	18	0	1	19	0	0
23	587410	.	C	G	6	7	13	0	2	15	0	0
23	587437	.	G	T	9	8	17	0	1	18	0	0
23	587581	.	G	A	14	16	30	0	0	30	0	0
23	587614	.	T	G	11	13	24	0	1	25	0	0
23	587806	.	T	G	11	13	24	0	0	24	0	0
23	587830	.	A	C	15	8	23	0	1	24	0	0
23	587890	.	A	C	17	16	33	0	2	35	0	0
23	587924	.	A	T	10	23	33	0	6	39	0	0
23	587966	.	C	T	11	29	40	0	2	42	0	0
23	597127	.	A	C	2	4	6	0	0	6	0	0
23	597548	.	T	G	6	12	18	0	0	18	0	0
23	597657	.	G	A	9	11	20	0	1	21	0	0
23	607189	.	C	G	2	3	5	0	0	5	0	0
23	607222	.	G	T	1	4	5	0	0	5	0	0
23	607246	.	T	A	1	6	7	0	0	7	0	0
23	610881	.	T	G	2	0	2	0	0	2	0	0
23	611858	.	G	A	0	1	1	0	1	2	0	0
23	614651	.	G	A	0	1	1	0	0	1	0	0
23	614699	.	T	C	0	1	1	0	0	1	0	0
23	614732	.	G	A	0	1	1	0	0	1	0	0
23	804124	.	A	G	0	1	1	0	0	1	0	0
23	804154	.	G	C	0	0	0	0	1	1	0	0
23	804164	.	A	G	0	1	1	0	0	1	0	0
23	813290	.	T	C	0	2	2	0	0	2	0	0
23	816171	.	A	G	0	2	2	0	0	2	0	0
23	828299	.	G	A	2	3	5	0	0	5	0	0
23	828372	.	C	A	6	5	11	0	0	11	0	0
23	830033	.	C	T	1	3	4	0	1	5	0	0
23	830047	.	G	C	1	4	5	0	0	5	0	0
23	831608	.	G	C	0	1	1	0	1	2	0	0
23	831613	.	A	G	2	1	3	0	0	3	0	0
23	831659	.	C	T	3	4	7	0	1	8	0	0
23	835575	.	G	C	6	5	11	0	0	11	0	0
23	835631	.	A	G	5	3	8	0	0	8	0	0
23	835712	.	A	G	3	6	9	0	0	9	0	0
23	835717	.	T	C	4	5	9	0	0	9	0	0
23	835970	.	G	A	1	2	3	0	0	3	0	0
23	862782	.	T	A	5	11	16	0	0	16	0	0
23	863024	.	G	A	1	6	7	0	2	9	0	0
23	863105	.	T	A	6	2	8	0	0	8	0	0
23	863135	.	A	G	11	4	15	0	0	16	1	0
23	863261	.	C	A	6	6	12	0	1	13	0	0
23	863317	.	C	T	0	2	2	0	1	3	0	0
23	863318	.	G	A	1	2	3	0	0	3	0	0
23	863520	.	T	C	4	7	11	0	0	11	0	0
23	863574	.	T	C	7	3	10	0	1	11	0	0
23	863659	.	T	C	4	7	11	0	0	11	0	0
23	864113	.	T	C	3	3	6	0	0	6	0	0
23	864376	.	T	C	1	3	4	0	1	5	0	0
23	864380	.	T	C	4	2	6	0	0	6	0	0
23	865619	.	T	C	6	3	9	0	0	9	0	0
23	865644	.	G	T	2	4	6	0	1	7	0	0
23	865685	.	T	C	1	2	3	0	0	3	0	0
23	865999	.	C	T	0	2	2	0	5	7	0	0
23	866004	.	A	T	5	3	8	0	0	8	0	0
23	866409	.	A	G	0	1	1	0	0	1	0	0
23	866439	.	C	T	0	1	1	0	0	1	0	0
23	866444	.	T	C	0	0	0	0	1	1	0	0
23	883062	.	C	G	0	2	2	0	3	5	0	0
23	896023	.	C	A	2	1	3	0	0	3	0	0
23	898127	.	A	G	1	1	2	0	1	3	0	0
23	903104	.	A	G	4	8	12	0	0	12	0	0
23	903212	.	G	C	18	16	34	0	0	34	0	0
23	903334	.	G	A	13	21	34	0	1	35	0	0
23	903415	.	T	A	14	13	27	0	2	29	0	0
23	903553	.	T	G	20	27	47	0	0	47	0	0
23	903848	.	G	A	12	19	31	0	3	34	0	0
23	906346	.	T	A	3	3	6	0	0	6	0	0
23	910357	.	A	G	8	10	18	0	0	18	0	0
23	1043082	.	T	C	1	0	1	0	2	3	0	0
23	1043283	.	G	A	2	0	2	0	0	2	0	0
23	1043295	.	T	C	1	0	1	0	0	1	0	0
23	1691708	.	G	A	0	0	0	0	1	1	0	0
23	1697329	.	G	A	1	2	3	0	9	12	0	0
23	1697434	.	C	T	3	4	7	0	0	7	0	0
23	1697469	.	G	A	0	3	3	0	7	10	0	0
23	1697689	.	A	G	4	5	9	0	0	9	0	0
23	1697690	.	A	G	5	4	9	0	0	9	0	0
23	1697860	.	C	T	6	2	8	0	1	9	0	0
23	1698202	.	C	T	7	7	14	0	0	14	0	0
23	1698229	.	G	T	7	4	11	0	2	13	0	0
23	1698256	.	G	A	9	5	14	0	0	14	0	0
23	1698329	.	T	A	8	3	11	0	0	11	0	0
23	1698358	.	G	T	0	2	2	0	4	6	0	0
23	1702648	.	C	T	2	1	3	0	0	3	0	0
23	1709724	.	C	T	4	7	11	0	0	11	0	0
23	1709740	.	A	G	3	0	3	0	6	9	0	0
23	2771793	.	A	G	1	7	8	0	1	9	0	0
23	5565897	.	A	G	2	7	9	0	0	9	0	0
23	5583113	.	C	T	1	2	3	0	0	3	0	0
23	5585483	.	T	C	1	4	5	0	0	5	0	0
23	5585528	.	G	T	1	2	3	0	0	3	0	0
23	5587625	.	T	C	3	6	9	0	0	9	0	0
23	5587626	.	C	A	3	6	9	0	0	9	0	0
23	5587882	.	T	C	0	2	2	0	0	2	0	0
23	5756600	.	G	A	3	6	9	0	0	9	0	0
23	5756781	.	G	T	5	4	9	0	0	9	0	0
23	5756847	.	C	T	8	5	13	0	0	13	0	0
23	5757010	.	G	A	2	3	5	0	0	5	0	0
23	5757047	.	A	T	4	1	5	0	1	6	0	0
23	5757193	.	G	T	1	1	2	0	0	2	0	0
23	5757202	.	C	T	0	0	0	0	1	1	0	0
23	5758610	.	G	A	5	5	10	0	1	11	0	0
23	5759014	.	A	T	3	2	5	0	1	6	0	0
23	5767157	.	G	A	1	2	3	0	0	3	0	0
23	6006977	.	T	C	1	0	1	0	0	1	0	0
23	6035912	.	C	G	1	1	2	0	0	2	0	0
23	6058704	.	C	T	2	2	4	0	0	4	0	0
23	6060084	.	C	A	0	1	1	0	0	1	0	0
23	6064579	.	T	C	1	2	3	0	1	4	0	0
23	6272793	.	C	T	4	3	7	0	0	7	0	0
23	6301287	.	T	A	3	3	6	0	0	6	0	0
23	6301332	.	T	C	9	8	17	0	1	18	0	0
23	6301413	.	A	G	0	1	1	0	0	1	0	0
23	6301416	.	T	C	0	0	0	0	1	1	0	0
23	6304243	.	A	G	6	0	6	0	4	10	0	0
23	6304249	.	T	C	6	3	9	0	1	10	0	0
23	6421776	.	T	C	3	4	7	0	0	7	0	0
23	6736265	.	C	A	10	5	15	0	0	15	0	0
23	6938373	.	G	A	1	1	2	0	0	2	0	0
23	6951157	.	C	T	0	5	5	0	4	9	0	0
23	6952261	.	T	C	1	0	1	0	2	3	0	0
23	6955860	.	G	A	5	6	11	0	1	12	0	0
23	6958166	.	A	G	1	1	2	0	0	2	0	0
23	6958211	.	A	T	3	1	4	0	1	5	0	0
23	6958250	.	G	C	3	1	4	0	0	4	0	0
23	6958256	.	A	G	3	1	4	0	0	4	0	0
23	6966857	.	C	T	0	1	1	0	1	2	0	0
23	6982389	.	T	C	0	0	0	0	4	4	0	0
23	7003744	.	C	T	3	3	6	0	1	7	0	0
23	7007480	.	C	T	9	7	16	0	0	16	0	0
23	7027534	.	C	T	0	4	4	0	3	7	0	0
23	7029600	.	G	A	4	2	6	0	0	6	0	0
23	7029741	.	G	A	3	5	8	0	1	9	0	0
23	7029777	.	A	T	3	1	4	0	0	4	0	0
23	7029916	.	A	T	4	4	8	0	0	8	0	0
23	7029964	.	A	C	0	0	0	0	1	1	0	0
23	7032435	.	C	A	4	4	8	0	0	9	1	0
23	7040708	.	T	A	1	1	2	0	0	2	0	0
23	7067257	.	T	C	5	2	7	0	1	8	0	0
23	7545326	.	A	T	1	2	3	0	0	3	0	0
23	7545327	.	C	T	1	2	3	0	0	3	0	0
23	7554409	.	T	C	1	0	1	0	0	1	0	0
23	7556970	.	C	G	0	3	3	0	1	4	0	0
23	7556979	.	G	C	2	3	5	0	0	5	0	0
23	7557383	.	G	A	0	1	1	0	3	4	0	0
23	7567446	.	C	T	1	0	1	0	0	1	0	0
23	7572445	.	A	G	2	0	2	0	3	5	0	0
23	7578710	.	T	C	13	11	24	0	1	25	0	0
23	7702128	.	A	G	1	2	3	0	0	3	0	0
23	7708803	.	T	A	1	3	4	0	0	4	0	0
23	7714912	.	G	T	0	3	3	0	1	4	0	0
23	7715747	.	A	G	1	5	6	0	0	6	0	0
23	7715873	.	G	A	2	2	4	0	0	4	0	0
23	7715909	.	T	C	2	4	6	0	0	6	0	0
23	7715945	.	G	C	0	3	3	0	4	7	0	0
23	7716281	.	T	C	5	4	9	0	0	9	0	0
23	7718380	.	G	A	1	0	1	0	0	1	0	0
23	7718972	.	G	A	0	2	2	0	2	4	0	0
23	7718999	.	C	T	2	0	2	0	0	2	0	0
23	7721342	.	A	G	1	1	2	0	0	2	0	0
23	7732578	.	T	C	4	6	10	0	0	10	0	0
23	7732820	.	G	A	2	4	6	0	0	6	0	0
23	7733088	.	C	G	8	7	15	0	0	15	0	0
23	7733603	.	T	C	4	4	8	0	1	9	0	0
23	7733614	.	G	T	6	4	10	0	0	10	0	0
23	7733826	.	T	A	1	3	4	0	0	4	0	0
23	7733836	.	T	C	2	5	7	0	0	7	0	0
23	7733861	.	A	G	2	6	8	0	0	8	0	0
23	7735497	.	T	C	3	11	14	0	0	14	0	0
23	7735649	.	C	T	7	10	17	0	1	18	0	0
23	7735809	.	A	T	5	4	9	0	1	10	0	0
23	7736024	.	A	G	2	5	7	0	1	8	0	0
23	7736089	.	T	G	2	0	2	0	8	10	0	0
23	7743670	.	T	C	3	7	10	0	0	10	0	0
23	7743691	.	T	C	4	6	10	0	1	11	0	0
23	7746618	.	T	C	1	0	1	0	2	3	0	0
23	7746797	.	T	G	0	1	1	0	1	2	0	0
23	7750693	.	A	C	1	2	3	0	0	3	0	0
23	7755112	.	A	C	1	3	4	0	0	4	0	0
23	7755189	.	T	G	4	7	11	0	0	11	0	0
23	7755215	.	T	C	2	4	6	0	0	6	0	0
23	7762045	.	A	G	5	10	15	0	0	15	0	0
23	7765955	.	G	A	0	3	3	0	0	3	0	0
23	7765961	.	C	T	0	2	2	0	0	2	0	0
23	7768416	.	T	C	4	0	4	0	3	7	0	0
23	7778670	.	G	A	4	13	17	0	0	17	0	0
23	7778715	.	A	G	2	10	12	0	0	12	0	0
23	7789635	.	G	A	3	2	5	0	0	5	0	0
23	7789802	.	C	T	1	3	4	0	1	5	0	0
23	7789930	.	C	T	0	4	4	0	2	6	0	0
23	8284779	.	C	T	1	1	2	0	0	2	0	0
23	8284791	.	C	T	1	1	2	0	0	2	0	0
23	8285094	.	G	T	5	6	11	0	0	11	0	0
23	8285236	.	G	T	5	24	29	0	0	29	0	0
23	8285297	.	C	T	0	16	16	0	17	33	0	0
23	8285365	.	G	A	14	20	34	0	1	35	0	0
23	8285468	.	T	C	5	8	13	0	2	15	0	0
23	8285585	.	A	T	6	10	16	0	2	18	0	0
23	8285640	.	C	T	10	11	21	0	0	21	0	0
23	8286192	.	T	C	7	0	7	0	10	17	0	0
23	8286237	.	G	A	7	7	14	0	0	14	0	0
23	8286342	.	C	T	0	5	5	0	7	12	0	0
23	8286384	.	G	T	5	5	10	0	1	11	0	0
23	8286483	.	G	A	2	5	7	0	1	8	0	0
23	8373535	.	T	G	2	4	6	0	1	7	0	0
23	8373641	.	A	G	3	4	7	0	0	7	0	0
23	8687821	.	G	A	1	2	3	0	0	3	0	0
23	8719074	.	T	C	8	5	13	0	1	14	0	0
23	8724467	.	G	A	10	6	16	0	0	16	0	0
23	8993280	.	G	A	2	4	6	0	0	6	0	0
23	9013456	.	C	G	2	0	2	0	5	7	0	0
23	9013597	.	T	C	7	8	15	0	0	15	0	0
23	9013843	.	G	A	11	7	18	0	1	19	0	0
23	9013876	.	T	A	13	9	22	0	1	23	0	0
23	9014122	.	G	A	0	14	14	0	6	20	0	0
23	9014259	.	G	A	8	13	21	0	0	21	0	0
23	9014712	.	A	T	4	2	6	0	0	6	0	0
23	9058105	.	A	T	4	3	7	0	0	7	0	0
23	9058108	.	C	A	3	4	7	0	0	7	0	0
23	9058157	.	A	T	1	3	4	0	1	5	0	0
23	9058160	.	C	A	1	3	4	0	0	4	0	0
23	9067121	.	G	A	0	2	2	0	0	2	0	0
23	9069900	.	A	G	2	1	3	0	0	3	0	0
23	9081471	.	A	T	5	4	9	0	0	9	0	0
23	9132147	.	A	G	3	5	8	0	0	8	0	0
23	9132150	.	T	C	3	5	8	0	0	8	0	0
23	9137400	.	A	C	1	2	3	0	0	3	0	0
23	9137410	.	A	G	3	0	3	0	2	5	0	0
23	9137628	.	T	C	1	2	3	0	0	3	0	0
23	9137629	.	G	A	1	2	3	0	0	3	0	0
23	9220531	.	T	A	1	3	4	0	0	4	0	0
23	9268466	.	T	C	6	5	11	0	1	12	0	0
23	9272674	.	C	T	4	3	7	0	0	7	0	0
23	9272984	.	T	C	8	4	12	0	1	13	0	0
23	9287619	.	G	A	2	1	3	0	0	3	0	0
23	9287629	.	C	A	2	3	5	0	1	7	1	0
23	9287666	.	C	T	4	7	11	0	0	11	0	0
23	9287689	.	T	C	4	6	10	0	2	12	0	0
23	9288047	.	T	A	5	3	8	0	2	10	0	0
23	9288062	.	C	G	7	5	12	0	0	12	0	0
23	9288200	.	G	T	6	5	11	0	0	11	0	0
23	9288294	.	T	C	2	2	4	0	0	4	0	0
23	9288331	.	G	T	2	2	4	0	0	4	0	0
23	9400902	.	G	A	2	3	5	0	0	5	0	0
23	9401006	.	A	T	3	3	6	0	0	6	0	0
23	9401107	.	C	T	1	3	4	0	1	5	0	0
23	9401210	.	T	C	5	0	5	0	7	12	0	0
23	9401344	.	G	A	5	5	10	0	1	11	0	0
23	9401439	.	T	C	0	5	5	0	0	5	0	0
23	9401470	.	C	T	1	4	5	0	1	6	0	0
23	9401918	.	A	G	2	1	3	0	0	3	0	0
23	9401954	.	G	A	3	3	6	0	0	6	0	0
23	9402459	.	G	A	2	2	4	0	0	4	0	0
23	9405572	.	C	G	0	1	1	0	1	2	0	0
23	9405633	.	C	A	0	2	2	0	1	3	0	0
23	9413159	.	G	A	0	1	1	0	0	1	0	0
23	9422133	.	A	G	0	1	1	0	0	1	0	0
23	9794733	.	T	C	7	3	10	0	0	10	0	0
23	9794959	.	T	A	11	17	28	0	3	31	0	0
23	9795057	.	A	G	16	21	37	0	1	38	0	0
23	9795097	.	C	T	1	17	18	0	15	33	0	0
23	9795663	.	A	C	5	21	26	0	1	27	0	0
23	9795908	.	C	T	10	18	28	0	3	31	0	0
23	9800761	.	T	G	7	6	13	0	0	13	0	0
23	9800993	.	G	T	7	5	12	0	0	12	0	0
23	9809863	.	A	G	12	15	27	0	1	28	0	0
23	9809977	.	C	T	0	7	7	0	7	14	0	0
23	9810491	.	C	G	12	7	19	0	1	20	0	0
23	9818153	.	C	T	6	6	12	0	0	12	0	0
23	9828802	.	T	C	6	0	6	0	8	14	0	0
23	9837018	.	G	A	2	3	5	0	0	5	0	0
23	9842935	.	G	A	2	0	2	0	0	2	0	0
23	9842980	.	C	T	3	0	3	0	0	3	0	0
23	9843221	.	T	C	1	1	2	0	0	2	0	0
23	9938315	.	A	C	4	0	4	0	4	8	0	0
23	9938349	.	T	C	4	4	8	0	0	8	0	0
23	9938497	.	G	A	4	4	8	0	0	8	0	0
23	9938765	.	A	G	4	3	7	0	0	7	0	0
23	9938812	.	A	T	5	6	11	0	1	12	0	0
23	9938824	.	T	C	6	0	6	0	7	13	0	0
23	9938869	.	C	A	9	1	10	0	0	14	4	0
23	9938905	.	T	C	6	0	6	0	3	9	0	0
23	9939602	.	T	C	7	10	17	0	1	18	0	0
23	9939817	.	A	G	2	5	7	0	0	7	0	0
23	9950087	.	A	C	3	1	4	0	1	5	0	0
23	9952460	.	C	T	0	5	5	0	0	5	0	0
23	9952532	.	C	G	0	4	4	0	1	5	0	0
23	9963048	.	T	C	1	2	3	0	0	3	0	0
23	9963087	.	T	C	1	1	2	0	0	2	0	0
23	10174773	.	G	A	0	1	1	0	0	1	0	0
23	10174904	.	C	T	1	1	2	0	0	2	0	0
23	10174961	.	A	G	3	2	5	0	0	5	0	0
23	10250357	.	G	A	8	7	15	0	1	16	0	0
23	10251076	.	A	G	8	6	14	0	2	16	0	0
23	10251750	.	T	C	3	3	6	0	2	8	0	0
23	10252499	.	A	G	8	6	14	0	0	14	0	0
23	10252526	.	G	A	7	10	17	0	2	19	0	0
23	10252625	.	T	A	6	4	10	0	1	11	0	0
23	10254018	.	A	G	8	8	16	0	0	16	0	0
23	10254075	.	G	A	6	5	11	0	0	11	0	0
23	10254081	.	A	G	5	4	9	0	0	9	0	0
23	10348049	.	T	C	1	5	6	0	0	6	0	0
23	10348052	.	C	T	2	4	6	0	0	6	0	0
23	10350549	.	T	C	1	2	3	0	0	3	0	0
23	10350591	.	G	A	5	2	7	0	1	8	0	0
23	10405707	.	A	G	4	0	4	0	10	14	0	0
23	10405742	.	G	C	0	10	10	0	5	15	0	0
23	10411562	.	A	C	6	5	11	0	0	11	0	0
23	10419933	.	A	C	11	10	21	0	0	21	0	0
23	10421216	.	A	C	4	1	5	0	0	5	0	0
23	10423909	.	C	G	2	0	2	0	0	2	0	0
23	10426291	.	C	T	4	7	11	0	0	11	0	0
23	10448936	.	C	T	10	8	18	0	0	18	0	0
23	10449063	.	T	C	10	8	18	0	1	19	0	0
23	10449136	.	A	G	9	0	9	0	7	16	0	0
23	10449185	.	C	T	7	6	13	0	0	13	0	0
23	10638386	.	A	G	1	3	4	0	1	5	0	0
23	10638430	.	T	A	2	2	4	0	1	5	0	0
23	10639121	.	G	A	2	3	5	0	0	5	0	0
23	10725272	.	A	T	2	3	5	0	2	7	0	0
23	10725320	.	T	C	6	10	16	0	2	18	0	0
23	10725334	.	T	C	8	9	17	0	0	17	0	0
23	10725638	.	A	T	8	10	18	0	0	18	0	0
23	10725919	.	C	A	12	13	25	0	1	26	0	0
23	10727563	.	G	A	10	8	18	0	1	19	0	0
23	10727614	.	C	T	3	1	4	0	2	6	0	0
23	10727644	.	C	T	0	1	1	0	0	1	0	0
23	10745058	.	G	T	6	3	9	0	0	9	0	0
23	10762922	.	G	A	10	8	18	0	1	19	0	0
23	10762972	.	T	A	5	7	12	0	0	12	0	0
23	10763070	.	G	A	7	5	12	0	1	13	0	0
23	10771991	.	C	A	1	11	12	0	10	22	0	0
23	10817179	.	G	A	3	4	7	0	0	7	0	0
23	10817292	.	T	G	2	3	5	0	0	5	0	0
23	10825591	.	C	T	8	5	13	0	2	15	0	0
23	10826427	.	C	T	8	8	16	0	0	16	0	0
23	10826718	.	C	A	11	10	21	0	0	21	0	0
23	10826754	.	C	T	6	8	14	0	0	14	0	0
23	10826856	.	A	T	2	5	7	0	0	7	0	0
23	10826917	.	C	T	4	3	7	0	0	7	0	0
23	11772230	.	A	C	0	1	1	0	0	1	0	0
23	11851545	.	T	C	3	1	4	0	0	4	0	0
23	11851603	.	C	T	1	1	2	0	0	2	0	0
23	11855160	.	A	G	3	3	6	0	0	6	0	0
23	11855169	.	G	A	3	3	6	0	0	6	0	0
23	11859294	.	C	T	6	7	13	0	0	13	0	0
23	11865055	.	T	A	12	7	19	0	0	19	0	0
23	11865934	.	C	T	15	12	27	0	1	28	0	0
23	11866086	.	G	A	22	19	41	0	3	44	0	0
23	11866183	.	G	A	17	19	36	0	1	37	0	0
23	11866259	.	T	C	26	11	37	0	1	38	0	0
23	11870203	.	A	T	4	4	8	0	0	8	0	0
23	11896251	.	G	A	4	5	9	0	0	9	0	0
23	11920705	.	G	A	0	2	2	0	1	3	0	0
23	11920712	.	C	T	2	3	5	0	0	5	0	0
23	12155166	.	G	A	7	6	13	0	0	13	0	0
23	12155298	.	G	A	6	7	13	0	1	14	0	0
23	12155319	.	G	A	9	7	16	0	0	16	0	0
23	12155364	.	A	G	4	6	10	0	0	10	0	0
23	12155391	.	G	A	4	4	8	0	1	9	0	0
23	12158643	.	A	G	4	5	9	0	0	9	0	0
23	12161399	.	T	C	0	1	1	0	0	1	0	0
23	12161557	.	A	G	1	0	1	0	4	5	0	0
23	12161794	.	T	C	1	5	6	0	0	6	0	0
23	12162034	.	G	A	5	7	12	0	0	12	0	0
23	12162073	.	T	G	3	1	4	0	7	11	0	0
23	12162099	.	G	C	1	9	10	0	0	10	0	0
23	12162163	.	C	T	4	5	9	0	0	9	0	0
23	12162386	.	A	C	2	9	11	0	0	11	0	0
23	12233117	.	G	A	15	11	26	0	0	26	0	0
23	12233121	.	C	T	0	16	16	0	12	28	0	0
23	12245729	.	A	C	1	2	3	0	0	3	0	0
23	12259026	.	C	T	0	10	10	0	9	19	0	0
23	12345695	.	G	A	7	8	15	0	2	17	0	0
23	12486063	.	T	C	2	1	3	0	0	3	0	0
23	12546823	.	C	T	2	2	4	0	1	5	0	0
23	13332216	.	G	C	2	2	4	0	0	4	0	0
23	13567194	.	C	T	6	4	10	0	0	10	0	0
23	13598094	.	C	T	3	1	4	0	0	4	0	0
23	13598632	.	T	C	11	6	17	0	1	18	0	0
23	13598679	.	C	T	4	8	12	0	2	14	0	0
23	13599079	.	G	A	0	4	4	0	2	6	0	0
23	13722416	.	C	A	5	4	9	0	0	9	0	0
23	13722755	.	C	G	6	0	6	0	0	6	0	0
23	13806408	.	C	T	4	8	12	0	1	13	0	0
23	13833376	.	T	A	2	1	3	0	1	4	0	0
23	13840297	.	G	A	3	2	5	0	0	5	0	0
23	13840362	.	C	T	0	11	11	0	7	18	0	0
23	13845114	.	A	C	6	9	15	0	1	16	0	0
23	13845131	.	G	A	9	7	16	0	1	17	0	0
23	13845149	.	T	G	7	11	18	0	0	19	1	0
23	13845201	.	A	G	3	10	13	0	0	13	0	0
23	13845389	.	C	A	4	9	13	0	0	13	0	0
23	13845411	.	G	T	12	5	17	0	0	17	0	0
23	13845447	.	T	C	13	8	21	0	0	21	0	0
23	13845901	.	G	T	7	5	12	0	0	12	0	0
23	13846482	.	G	T	8	3	11	0	0	11	0	0
23	13846535	.	G	A	1	4	5	0	0	5	0	0
23	13846542	.	A	G	1	3	4	0	0	4	0	0
23	13846664	.	T	C	3	8	11	0	0	11	0	0
23	13847142	.	G	A	0	3	3	0	1	4	0	0
23	13848537	.	G	A	0	2	2	0	0	2	0	0
23	13857114	.	G	A	0	3	3	0	0	3	0	0
23	13941275	.	C	T	6	8	14	0	1	15	0	0
23	13946174	.	C	T	0	5	5	0	9	14	0	0
23	13948993	.	G	A	9	2	11	0	0	11	0	0
23	14056306	.	C	T	2	3	5	0	0	5	0	0
23	14193676	.	A	G	11	3	14	0	2	16	0	0
23	14193777	.	C	T	10	17	27	0	1	28	0	0
23	14193880	.	C	T	10	15	25	0	1	26	0	0
23	14193923	.	A	C	9	11	20	0	1	21	0	0
23	14193940	.	C	T	10	10	20	0	2	22	0	0
23	14194035	.	C	G	6	20	26	0	2	28	0	0
23	14194058	.	G	A	6	22	28	0	1	29	0	0
23	14198137	.	G	A	8	5	13	0	0	13	0	0
23	14201512	.	T	C	9	4	13	0	1	14	0	0
23	14201521	.	T	C	9	7	16	0	0	16	0	0
23	14203829	.	T	G	9	11	20	0	0	20	0	0
23	14208718	.	A	G	5	2	7	0	0	7	0	0
23	14208817	.	A	T	6	3	9	0	0	9	0	0
23	14209024	.	T	G	5	3	8	0	1	9	0	0
23	14211707	.	C	T	7	7	14	0	0	14	0	0
23	14217769	.	G	A	0	2	2	0	3	5	0	0
23	14222841	.	G	A	1	2	3	0	0	3	0	0
23	14720159	.	G	A	1	2	3	0	0	3	0	0
23	14777039	.	A	C	1	2	3	0	0	3	0	0
23	14782566	.	A	G	3	2	5	0	1	6	0	0
23	14782599	.	C	T	1	0	1	0	0	1	0	0
23	14784237	.	A	C	2	2	4	0	1	5	0	0
23	14784285	.	G	A	1	2	3	0	0	3	0	0
23	14786347	.	T	C	1	2	3	0	0	3	0	0
23	14786429	.	A	T	1	4	5	0	0	5	0	0
23	14787336	.	A	G	1	0	1	0	1	2	0	0
23	14787372	.	T	C	0	3	3	0	1	4	0	0
23	14787378	.	A	G	1	0	1	0	3	4	0	0
23	14787409	.	G	A	0	2	2	0	0	2	0	0
23	14787426	.	G	A	0	2	2	0	0	2	0	0
23	14790659	.	T	C	2	0	2	0	0	2	0	0
23	14790795	.	A	G	1	0	1	0	0	1	0	0
23	14790827	.	G	A	1	0	1	0	0	1	0	0
23	14799653	.	T	C	4	4	8	0	0	8	0	0
23	14808537	.	G	T	3	4	7	0	0	7	0	0
23	14809613	.	C	A	2	3	5	0	0	5	0	0
23	14832585	.	T	G	2	13	15	0	6	21	0	0
23	14832733	.	G	A	20	33	53	0	0	53	0	0
23	14832740	.	A	C	23	32	55	0	0	55	0	0
23	14832866	.	C	T	23	33	56	0	1	57	0	0
23	14832941	.	C	A	0	32	32	0	21	53	0	0
23	14833142	.	A	T	25	23	48	0	0	48	0	0
23	14833143	.	A	T	24	19	43	0	5	48	0	0
23	14833389	.	A	C	27	17	44	0	1	46	1	0
23	14861741	.	A	G	0	1	1	0	0	1	0	0
23	14990819	.	G	T	11	5	16	0	0	16	0	0
23	14993089	.	G	A	15	8	23	0	1	24	0	0
23	14993302	.	A	C	17	15	32	0	0	32	0	0
23	14993393	.	C	A	14	9	23	0	0	23	0	0
23	14993421	.	G	A	11	4	15	0	0	15	0	0
23	14993438	.	A	G	10	8	18	0	1	19	0	0
23	14993493	.	A	T	9	19	28	0	0	28	0	0
23	14993525	.	A	T	9	15	24	0	0	24	0	0
23	14993563	.	C	G	13	14	27	0	0	27	0	0
23	14997341	.	A	G	12	10	22	0	1	23	0	0
23	14999053	.	C	T	11	8	19	0	1	20	0	0
23	14999095	.	C	T	1	15	16	0	12	28	0	0
23	15003551	.	T	C	5	1	6	0	8	14	0	0
23	15022511	.	C	T	1	0	1	0	1	2	0	0
23	15022526	.	C	T	1	1	2	0	0	2	0	0
23	15036698	.	G	A	1	4	5	0	2	7	0	0
23	15046702	.	T	C	1	1	2	0	1	3	0	0
23	15046705	.	A	G	1	1	2	0	1	3	0	0
23	15047065	.	G	T	3	2	5	0	0	5	0	0
23	15047674	.	A	G	2	5	7	0	0	7	0	0
23	15048070	.	A	G	2	2	4	0	0	4	0	0
23	15053433	.	A	G	4	3	7	0	0	7	0	0
23	15076070	.	T	C	1	2	3	0	0	3	0	0
23	15204028	.	C	T	18	9	27	0	0	27	0	0
23	15204038	.	T	G	17	8	25	0	0	25	0	0
23	15204222	.	C	T	0	9	9	0	28	37	0	0
23	15204321	.	T	A	10	14	24	0	3	27	0	0
23	15204324	.	T	A	11	15	26	0	3	29	0	0
23	15204417	.	A	G	9	20	29	0	2	31	0	0
23	15204926	.	C	A	8	13	21	0	2	23	0	0
23	15204936	.	G	T	14	5	19	0	4	23	0	0
23	15205100	.	T	G	12	14	26	0	5	31	0	0
23	15205428	.	A	T	14	17	31	0	0	31	0	0
23	15205487	.	C	G	24	14	38	0	0	38	0	0
23	15211253	.	G	C	15	15	30	0	2	32	0	0
23	15215709	.	G	A	17	13	30	0	0	30	0	0
23	15216664	.	G	T	3	2	5	0	1	6	0	0
23	15222509	.	G	A	4	4	8	0	0	8	0	0
23	15222521	.	C	T	5	3	8	0	2	10	0	0
23	15259821	.	G	A	4	1	5	0	0	5	0	0
23	15284602	.	G	T	1	1	2	0	1	3	0	0
23	15284668	.	A	G	5	5	10	0	0	10	0	0
23	15284671	.	G	A	5	5	10	0	0	10	0	0
23	15851064	.	A	G	21	10	31	0	1	32	0	0
23	15851506	.	C	G	9	9	18	0	1	19	0	0
23	15854004	.	T	C	19	14	33	0	2	35	0	0
23	15854102	.	A	C	4	10	14	0	0	14	0	0
23	15861092	.	C	T	0	7	7	0	9	16	0	0
23	15861536	.	T	C	3	2	5	0	1	6	0	0
23	15872605	.	T	A	2	0	2	0	0	2	0	0
23	15900255	.	C	T	10	7	17	0	0	17	0	0
23	15900330	.	G	A	15	17	32	0	1	33	0	0
23	15900387	.	G	A	11	15	26	0	2	28	0	0
23	15916232	.	A	T	9	9	18	0	0	18	0	0
23	16640852	.	A	G	10	0	10	0	6	16	0	0
23	16640925	.	A	G	7	6	13	0	2	15	0	0
23	16641017	.	A	G	12	8	20	0	1	21	0	0
23	16648643	.	A	G	4	2	6	0	0	6	0	0
23	16648656	.	A	G	6	2	8	0	0	8	0	0
23	16660094	.	G	T	0	3	3	0	1	4	0	0
23	16748903	.	A	T	3	2	5	0	0	5	0	0
23	16748915	.	T	A	2	2	4	0	0	4	0	0
23	16753735	.	T	C	3	5	8	0	0	8	0	0
23	16757414	.	T	G	0	0	0	0	1	1	0	0
23	16769220	.	C	A	2	3	5	0	0	5	0	0
23	16769700	.	A	G	1	2	3	0	0	3	0	0
23	16769862	.	A	T	2	1	3	0	1	4	0	0
23	16769991	.	T	G	1	0	1	0	4	5	0	0
23	16770008	.	G	A	0	4	4	0	1	5	0	0
23	16770091	.	A	G	2	0	2	2	4	8	0	0
23	16770121	.	G	A	0	3	3	1	7	11	0	0
23	16770292	.	G	A	4	2	6	0	1	7	0	0
23	16770293	.	T	G	4	2	6	0	0	7	1	0
23	16786790	.	G	C	0	1	1	0	0	1	0	0
23	16810343	.	A	G	1	1	2	0	0	2	0	0
23	16817055	.	T	C	2	1	3	1	0	4	0	0
23	16821667	.	A	C	3	2	5	0	0	5	0	0
23	16822095	.	T	G	9	0	9	0	4	13	0	0
23	16831106	.	A	T	3	2	5	0	0	5	0	0
23	16831207	.	A	T	2	5	7	0	0	7	0	0
23	16831386	.	G	A	1	4	5	0	0	5	0	0
23	16831507	.	A	T	0	2	2	0	0	2	0	0
23	16849383	.	A	G	2	4	6	0	0	6	0	0
23	16883618	.	T	A	1	2	3	0	0	3	0	0
23	16883876	.	G	A	0	2	2	0	2	4	0	0
23	16961626	.	T	C	1	3	4	0	0	4	0	0
23	16971989	.	G	A	2	2	4	0	0	4	0	0
23	16972054	.	G	A	1	2	3	0	0	3	0	0
23	16978690	.	G	A	3	1	4	0	0	4	0	0
23	17014763	.	T	C	1	2	3	0	0	3	0	0
23	17018886	.	G	A	1	1	2	0	0	2	0	0
23	17113842	.	A	G	2	1	3	0	0	3	0	0
23	17340346	.	G	A	1	5	6	0	4	10	0	0
23	17385136	.	A	G	5	4	9	0	1	10	0	0
23	17657074	.	A	G	0	12	12	0	0	12	0	0
23	17782767	.	G	A	1	5	6	0	0	6	0	0
23	17812711	.	C	T	26	25	51	0	0	51	0	0
23	17812720	.	T	A	25	25	50	0	1	51	0	0
23	17812755	.	G	T	24	20	44	0	1	45	0	0
23	17813057	.	G	A	27	8	35	0	0	35	0	0
23	17813161	.	T	A	9	13	22	0	1	23	0	0
23	17813717	.	G	A	29	29	58	0	1	59	0	0
23	17813952	.	G	T	9	11	20	0	0	20	0	0
23	17814056	.	G	A	24	23	47	0	0	47	0	0
23	17814223	.	C	T	16	23	39	0	13	52	0	0
23	17814281	.	G	T	23	21	44	0	2	46	0	0
23	17814299	.	A	C	27	16	43	0	1	44	0	0
23	17814408	.	A	C	19	13	32	0	3	35	0	0
23	17849275	.	T	G	4	11	15	0	3	18	0	0
23	17849296	.	C	G	1	8	9	0	7	16	0	0
23	17849627	.	C	T	12	12	24	0	1	25	0	0
23	17851768	.	C	T	0	5	5	0	8	13	0	0
23	17853145	.	T	G	3	3	6	0	0	6	0	0
23	17853396	.	A	T	1	0	1	0	0	1	0	0
23	17855427	.	C	A	4	4	8	0	0	8	0	0
23	17871893	.	G	C	2	2	4	0	0	4	0	0
23	17873750	.	C	A	26	27	53	0	3	56	0	0
23	17879066	.	C	A	6	3	9	0	0	9	0	0
23	17879107	.	C	T	1	5	6	0	0	6	0	0
23	17879152	.	A	T	1	2	3	0	1	4	0	0
23	17880800	.	C	T	3	5	8	0	0	8	0	0
23	17994354	.	T	C	3	9	12	0	0	12	0	0
23	17994359	.	C	T	8	3	11	0	0	11	0	0
23	17994897	.	C	T	5	2	7	0	1	8	0	0
23	17995123	.	A	C	1	0	1	0	2	3	0	0
23	17995169	.	A	T	0	2	2	0	2	4	0	0
23	17995469	.	G	T	4	7	11	0	0	11	0	0
23	17996051	.	A	T	3	3	6	0	0	6	0	0
23	17997033	.	A	G	1	4	5	0	0	5	0	0
23	17997043	.	T	C	1	0	1	0	4	5	0	0
23	18004297	.	A	G	2	2	4	0	0	4	0	0
23	18014744	.	C	T	0	1	1	0	0	1	0	0
23	18014942	.	A	G	0	1	1	0	1	2	0	0
23	18032772	.	G	A	4	2	6	0	0	6	0	0
23	18032912	.	A	C	5	5	10	0	0	10	0	0
23	18032924	.	T	A	5	5	10	0	0	10	0	0
23	18118653	.	A	T	2	3	5	0	0	5	0	0
23	18118922	.	G	A	31	19	50	0	2	52	0	0
23	18119166	.	C	T	21	19	40	0	0	40	0	0
23	18119192	.	T	C	16	0	16	0	15	31	0	0
23	18119399	.	A	G	18	13	31	0	0	31	0	0
23	18286781	.	G	A	6	8	14	0	1	15	0	0
23	18286782	.	C	T	6	8	14	0	1	15	0	0
23	18375847	.	G	A	2	1	3	0	0	3	0	0
23	18375853	.	T	C	1	1	2	0	4	6	0	0
23	18387709	.	T	A	19	34	53	0	1	54	0	0
23	18388004	.	G	A	20	10	30	0	1	31	0	0
23	18388166	.	T	A	12	8	20	0	3	23	0	0
23	18388476	.	G	A	9	8	17	0	0	17	0	0
23	18388555	.	A	G	11	17	28	0	1	29	0	0
23	18388620	.	A	C	5	17	22	0	2	24	0	0
23	18388685	.	G	A	11	13	24	0	2	26	0	0
23	18388764	.	G	A	9	12	21	0	0	21	0	0
23	18388858	.	T	G	3	5	8	0	1	9	0	0
23	18388954	.	G	A	5	15	20	0	0	20	0	0
23	18389594	.	G	T	12	19	31	0	0	31	0	0
23	18390402	.	G	A	7	15	22	0	1	23	0	0
23	18390635	.	G	A	11	6	17	0	1	18	0	0
23	18390758	.	T	C	11	1	12	0	6	18	0	0
23	18390780	.	C	T	7	9	16	0	1	17	0	0
23	18391490	.	G	A	5	10	15	0	1	16	0	0
23	18394401	.	T	G	10	10	20	0	0	20	0	0
23	18405812	.	C	T	7	3	10	0	1	11	0	0
23	18405862	.	A	G	1	0	1	0	0	1	0	0
23	18406479	.	G	A	5	3	8	0	1	9	0	0
23	18406573	.	C	A	2	6	8	0	0	8	0	0
23	18409242	.	C	T	5	2	7	0	0	7	0	0
23	18415427	.	T	A	1	5	6	0	0	6	0	0
23	18537386	.	C	T	2	3	5	0	0	5	0	0
23	18561289	.	T	A	16	19	35	0	0	35	0	0
23	18561434	.	C	T	1	15	16	0	9	25	0	0
23	18562299	.	A	T	1	2	3	0	1	4	0	0
23	18562357	.	C	T	0	5	5	0	0	5	0	0
23	18562358	.	T	G	1	5	6	0	0	6	0	0
23	18562427	.	C	T	6	7	13	0	0	13	0	0
23	18562484	.	G	A	1	9	10	0	1	11	0	0
23	18562522	.	A	C	0	7	7	0	0	7	0	0
23	18562623	.	C	T	12	8	20	0	1	21	0	0
23	18562911	.	C	A	1	14	15	0	12	27	0	0
23	18563951	.	G	T	8	8	16	0	0	16	0	0
23	18563952	.	T	C	8	0	8	0	8	16	0	0
23	18568144	.	G	A	2	4	6	0	1	7	0	0
23	18568206	.	G	A	4	8	12	0	2	14	0	0
23	18568421	.	T	A	9	3	12	0	0	12	0	0
23	18569380	.	T	A	5	8	13	0	2	15	0	0
23	18569399	.	C	A	1	7	8	0	7	15	0	0
23	18569543	.	T	C	15	12	27	0	0	27	0	0
23	18569625	.	A	G	28	14	42	0	1	43	0	0
23	18570887	.	C	T	0	1	1	0	0	1	0	0
23	18572547	.	T	A	1	5	6	0	1	7	0	0
23	18572605	.	T	A	10	6	16	0	1	17	0	0
23	18572618	.	G	A	6	11	17	0	0	17	0	0
23	18574353	.	G	A	15	13	28	0	0	28	0	0
23	18574720	.	T	C	17	14	31	0	2	33	0	0
23	18574800	.	C	T	0	19	19	0	18	37	0	0
23	18580933	.	C	A	1	1	2	0	0	2	0	0
23	18580939	.	C	A	0	1	1	0	2	3	0	0
23	18581065	.	A	G	1	1	2	0	0	2	0	0
23	18581835	.	G	A	5	1	6	0	2	8	0	0
23	18581933	.	T	G	7	7	14	0	1	15	0	0
23	18584225	.	G	A	14	10	24	0	1	25	0	0
23	18588969	.	C	T	7	8	15	0	1	16	0	0
23	18597667	.	G	A	7	13	20	0	2	22	0	0
23	18616517	.	A	T	8	5	13	0	3	16	0	0
23	18616880	.	T	A	10	10	20	0	5	25	0	0
23	18616980	.	C	G	8	7	15	0	1	16	0	0
23	18617300	.	G	A	11	11	22	0	1	23	0	0
23	18619766	.	C	T	0	2	2	0	0	2	0	0
23	18622541	.	T	G	9	8	17	0	0	17	0	0
23	18628746	.	C	T	6	6	12	0	1	13	0	0
23	18651789	.	G	A	3	1	4	0	0	4	0	0
23	18651918	.	C	A	2	3	5	0	0	5	0	0
23	18652067	.	T	C	4	1	5	0	0	5	0	0
23	18668440	.	T	C	3	4	7	0	0	7	0	0
23	18702862	.	A	G	2	4	6	0	0	6	0	0
23	18702863	.	G	A	2	4	6	0	0	6	0	0
23	18703204	.	T	A	0	1	1	0	0	1	0	0
23	18759802	.	C	A	12	5	17	0	0	17	0	0
23	18759827	.	T	C	4	9	13	0	0	13	0	0
23	18759944	.	C	T	5	8	13	0	0	13	0	0
23	18759945	.	G	A	8	5	13	0	0	13	0	0
23	18760004	.	G	C	5	0	5	0	3	8	0	0
23	18760049	.	T	A	10	5	15	0	0	15	0	0
23	18760223	.	T	A	4	5	9	0	1	10	0	0
23	18760256	.	C	T	3	5	8	0	0	8	0	0
23	18760519	.	T	A	4	2	6	0	0	6	0	0
23	18764770	.	A	C	0	3	3	0	0	3	0	0
23	18777816	.	C	T	1	1	2	0	0	2	0	0
23	18795055	.	T	C	8	9	17	0	0	17	0	0
23	18795620	.	A	G	17	18	35	0	1	36	0	0
23	18795721	.	C	T	10	5	15	0	1	16	0	0
23	18801275	.	G	A	9	6	15	0	2	17	0	0
23	18869550	.	C	A	0	4	4	0	2	6	0	0
23	18870235	.	A	T	6	2	8	0	0	8	0	0
23	18870245	.	T	C	2	0	2	0	7	9	0	0
23	18870716	.	G	T	7	4	11	0	0	11	0	0
23	18944489	.	A	G	5	8	13	0	0	13	0	0
23	18944543	.	G	A	0	7	7	0	8	15	0	0
23	18947344	.	C	A	14	11	25	0	0	25	0	0
23	18947385	.	G	C	14	10	24	0	0	24	0	0
23	18950968	.	T	C	18	13	31	0	0	31	0	0
23	18950970	.	T	A	18	13	31	0	0	31	0	0
23	18951010	.	G	A	18	12	30	0	0	30	0	0
23	18951103	.	T	C	0	3	3	0	0	3	0	0
23	18954023	.	A	G	4	7	11	0	0	11	0	0
23	18954100	.	A	G	7	5	12	0	1	13	0	0
23	18954151	.	G	A	4	9	13	0	0	13	0	0
23	18954759	.	T	G	7	19	26	0	0	26	0	0
23	18979342	.	C	T	16	14	30	0	1	31	0	0
23	18979561	.	G	A	11	19	30	0	2	32	0	0
23	18979756	.	T	C	11	8	19	0	0	19	0	0
23	18982375	.	G	A	5	8	13	0	0	13	0	0
23	18986338	.	G	A	15	11	26	0	0	26	0	0
23	18986344	.	G	A	11	14	25	0	0	25	0	0
23	18990914	.	C	T	0	9	9	0	4	13	0	0
23	18993525	.	T	C	14	9	23	0	0	23	0	0
23	18993827	.	C	T	0	5	5	0	1	6	0	0
23	18996030	.	C	T	1	2	3	0	0	3	0	0
23	19003263	.	A	G	4	1	5	0	0	5	0	0
23	19005426	.	G	T	1	0	1	0	0	1	0	0
23	19005486	.	T	C	6	4	10	0	0	10	0	0
23	19005758	.	C	T	1	1	2	0	0	2	0	0
23	19005761	.	C	G	1	1	2	0	0	2	0	0
23	19007389	.	G	T	2	2	4	0	0	4	0	0
23	19008149	.	C	T	2	2	4	0	1	5	0	0
23	19017421	.	C	A	0	1	1	0	0	1	0	0
23	19022254	.	A	G	0	1	1	0	0	1	0	0
23	19027408	.	G	A	1	2	3	0	0	3	0	0
23	19042706	.	A	T	1	0	1	0	0	1	0	0
23	19098900	.	G	A	0	2	2	0	0	2	0	0
23	19118372	.	G	T	3	3	6	0	0	6	0	0
23	19118960	.	G	T	2	3	5	0	1	6	0	0
23	19148453	.	A	T	0	1	1	0	0	1	0	0
23	19198348	.	A	T	3	12	15	0	0	15	0	0
23	19198588	.	A	T	0	3	3	0	0	3	0	0
23	19200168	.	G	A	8	11	19	0	1	20	0	0
23	19201103	.	C	A	16	12	28	0	0	28	0	0
23	19201148	.	G	T	3	6	9	0	0	9	0	0
23	19201227	.	C	T	2	2	4	0	0	4	0	0
23	19202799	.	A	T	2	2	4	0	0	4	0	0
23	19202800	.	A	T	2	2	4	0	0	4	0	0
23	19203952	.	C	T	1	2	3	0	0	3	0	0
23	19204126	.	C	T	0	3	3	0	0	3	0	0
23	19204130	.	T	C	0	3	3	0	0	3	0	0
23	19204597	.	G	A	2	5	7	0	0	7	0	0
23	19204738	.	C	T	3	3	6	0	0	6	0	0
23	19206052	.	C	T	2	6	8	0	0	8	0	0
23	19222218	.	C	A	2	2	4	0	0	4	0	0
23	19222257	.	G	A	3	2	5	0	0	5	0	0
23	19474823	.	G	T	14	11	25	0	3	28	0	0
23	19483010	.	C	T	0	0	0	0	1	1	0	0
23	19484584	.	C	T	0	3	3	0	4	7	0	0
23	19575044	.	G	A	0	11	11	0	6	17	0	0
23	19575134	.	C	T	9	16	25	0	0	25	0	0
23	19577464	.	G	A	0	19	19	0	10	29	0	0
23	19582481	.	T	C	11	14	25	0	1	26	0	0
23	19582559	.	G	T	14	8	22	0	0	22	0	0
23	19582668	.	T	C	10	15	25	0	1	26	0	0
23	19582678	.	C	T	13	15	28	0	2	30	0	0
23	19583208	.	G	A	0	12	12	0	18	30	0	0
23	19583252	.	C	T	12	17	29	0	0	29	0	0
23	19603630	.	T	C	13	11	24	0	0	24	0	0
23	19603753	.	T	C	23	36	59	0	2	61	0	0
23	19603803	.	T	C	18	24	42	0	1	43	0	0
23	19603880	.	A	T	18	20	38	0	6	44	0	0
23	19603994	.	G	A	26	26	52	0	2	54	0	0
23	19604263	.	A	G	15	0	15	0	23	38	0	0
23	19604351	.	G	T	11	10	21	0	0	21	0	0
23	19670139	.	G	C	8	3	11	0	0	11	0	0
23	19670185	.	A	T	4	6	10	0	2	12	0	0
23	19672720	.	T	C	4	7	11	0	0	11	0	0
23	19673170	.	C	T	20	12	32	0	1	33	0	0
23	19673376	.	C	T	11	11	22	0	0	22	0	0
23	19712898	.	G	A	23	21	44	0	1	45	0	0
23	19713291	.	A	G	17	15	32	0	0	32	0	0
23	19713324	.	A	G	32	28	60	0	4	64	0	0
23	19715606	.	T	G	1	2	3	0	0	3	0	0
23	19792821	.	T	C	1	0	1	0	0	1	0	0
23	19795565	.	T	C	1	2	3	0	0	3	0	0
23	19795568	.	C	T	1	2	3	0	0	3	0	0
23	19798493	.	T	C	1	0	1	0	0	1	0	0
23	19804543	.	C	A	0	1	1	0	0	1	0	0
23	19805577	.	A	T	2	1	3	0	0	3	0	0
23	19808022	.	C	T	11	8	19	0	0	19	0	0
23	19808078	.	T	C	6	6	12	0	0	12	0	0
23	19808691	.	G	A	1	8	9	0	20	29	0	0
23	19821136	.	A	G	2	0	2	0	14	16	0	0
23	19821150	.	C	T	4	14	18	0	1	19	0	0
23	19821277	.	A	C	11	7	18	0	1	19	0	0
23	19821408	.	C	T	7	5	12	0	1	13	0	0
23	19821489	.	A	T	2	2	4	0	0	4	0	0
23	19821549	.	C	A	1	3	4	0	1	5	0	0
23	19822100	.	G	T	1	2	3	0	1	4	0	0
23	19835308	.	T	C	38	18	56	0	0	56	0	0
23	19836260	.	C	T	31	26	57	0	0	57	0	0
23	19837080	.	T	C	33	24	57	0	1	58	0	0
23	19837503	.	G	A	23	19	42	0	0	42	0	0
23	19837939	.	A	G	10	7	17	0	1	18	0	0
23	19837974	.	G	A	9	7	16	0	0	16	0	0
23	19838100	.	C	A	22	25	47	0	1	48	0	0
23	19838295	.	T	G	4	5	9	0	1	10	0	0
23	19838312	.	A	T	4	5	9	0	0	9	0	0
23	19838387	.	A	T	9	9	18	0	1	19	0	0
23	19838388	.	T	A	7	9	16	0	3	19	0	0
23	19838458	.	A	T	11	13	24	0	0	24	0	0
23	19838459	.	A	C	11	13	24	0	0	24	0	0
23	19869132	.	G	A	10	13	23	0	0	23	0	0
23	19871615	.	A	G	25	18	43	0	2	45	0	0
23	19879576	.	C	T	0	5	5	0	3	8	0	0
23	19883318	.	T	C	1	2	3	0	0	3	0	0
23	19893409	.	A	T	9	7	16	0	0	16	0	0
23	19933542	.	A	G	7	7	14	0	0	14	0	0
23	19933578	.	G	A	4	7	11	0	0	11	0	0
23	19933742	.	G	A	7	9	16	0	0	16	0	0
23	19933850	.	A	G	6	4	10	0	0	10	0	0
23	19933896	.	A	G	7	6	13	0	0	13	0	0
23	19933952	.	A	G	7	7	14	0	0	14	0	0
23	19952743	.	C	T	0	8	8	0	9	17	0	0
23	19952869	.	T	A	7	2	9	0	0	9	0	0
23	19969109	.	A	T	2	5	7	0	1	8	0	0
23	19969136	.	C	A	3	4	7	0	1	8	0	0
23	19969420	.	A	T	4	7	11	0	0	11	0	0
23	19969710	.	G	A	8	5	13	0	0	13	0	0
23	19974092	.	G	A	2	5	7	0	0	7	0	0
23	19976882	.	G	C	2	2	4	0	0	4	0	0
23	19980896	.	A	C	2	1	3	0	1	4	0	0
23	19981191	.	A	T	1	2	3	0	0	3	0	0
23	19981510	.	G	T	9	11	20	0	0	20	0	0
23	19981554	.	T	C	7	5	12	0	0	12	0	0
23	19981608	.	A	T	11	4	15	0	1	16	0	0
23	19985054	.	A	G	2	5	7	0	0	7	0	0
23	19985201	.	A	G	0	2	2	0	0	2	0	0
23	19985403	.	T	C	6	6	12	0	0	12	0	0
23	20000716	.	A	G	0	3	3	0	2	5	0	0
23	20002373	.	T	A	6	4	10	0	0	10	0	0
23	20002439	.	G	C	4	0	4	0	6	10	0	0
23	20002524	.	A	G	3	4	7	0	0	7	0	0
23	20014285	.	A	T	2	3	5	0	0	6	1	0
23	20014407	.	A	T	3	2	5	0	0	5	0	0
23	20014528	.	G	A	5	2	7	0	0	7	0	0
23	20113599	.	T	C	21	5	26	0	0	26	0	0
23	20113848	.	G	T	16	15	31	0	3	34	0	0
23	20114327	.	C	A	5	7	12	0	2	14	0	0
23	20117625	.	C	G	0	15	15	0	12	27	0	0
23	20117830	.	A	G	1	2	3	1	0	4	0	0
23	20117938	.	A	C	8	0	8	0	8	16	0	0
23	20118597	.	T	G	4	1	5	0	0	5	0	0
23	20118730	.	T	A	3	2	5	0	0	5	0	0
23	20121265	.	T	A	2	1	3	0	0	3	0	0
23	20121270	.	G	T	2	2	4	0	1	5	0	0
23	20121326	.	G	A	16	11	27	0	0	27	0	0
23	20122190	.	A	G	2	4	6	0	1	7	0	0
23	20123575	.	C	A	4	4	8	0	0	8	0	0
23	20123576	.	C	T	4	4	8	0	0	8	0	0
23	20123629	.	A	G	2	3	5	0	0	5	0	0
23	20138134	.	T	C	3	1	4	0	0	4	0	0
23	20139248	.	T	C	1	2	3	0	0	3	0	0
23	20139320	.	T	C	3	2	5	0	0	5	0	0
23	20141925	.	C	T	1	2	3	0	0	3	0	0
23	20142886	.	G	A	2	3	5	0	0	5	0	0
23	20143037	.	T	G	3	2	5	0	0	5	0	0
23	20145420	.	T	A	15	12	27	0	1	28	0	0
23	20145823	.	T	C	9	12	21	0	2	23	0	0
23	20146080	.	A	G	9	10	19	0	1	20	0	0
23	20152477	.	T	C	2	8	10	0	1	11	0	0
23	20152640	.	G	A	1	6	7	0	0	7	0	0
23	20154486	.	A	G	9	3	12	0	0	12	0	0
23	20157790	.	G	A	4	4	8	0	0	8	0	0
23	20157923	.	G	C	5	0	5	0	7	12	0	0
23	20157930	.	T	C	7	0	7	0	5	12	0	0
23	20159225	.	C	T	0	2	2	0	2	4	0	0
23	20159234	.	G	T	2	2	4	0	0	4	0	0
23	20162522	.	C	T	0	1	1	0	1	2	0	0
23	20167966	.	G	A	3	3	6	0	0	6	0	0
23	20168111	.	T	A	3	4	7	0	0	7	0	0
23	20168127	.	C	T	0	4	4	0	3	7	0	0
23	20168404	.	C	G	2	3	5	0	0	5	0	0
23	20168568	.	T	C	1	3	4	0	0	4	0	0
23	20168573	.	A	G	1	4	5	0	0	5	0	0
23	20168642	.	G	A	2	8	10	0	0	10	0	0
23	20168739	.	T	C	1	0	1	0	0	1	0	0
23	20169105	.	C	G	0	1	1	0	0	1	0	0
23	20170945	.	T	A	1	2	3	0	1	4	0	0
23	20636325	.	A	C	5	2	7	0	11	18	0	0
23	20636328	.	T	A	5	0	5	0	10	15	0	0
23	20748650	.	A	G	5	2	7	0	0	7	0	0
23	20902390	.	T	A	6	5	11	0	2	13	0	0
23	20931095	.	C	A	12	6	18	0	3	21	0	0
23	20931119	.	C	T	7	9	16	0	1	17	0	0
23	20936226	.	G	A	0	10	10	0	8	18	0	0
23	20936395	.	T	A	9	7	16	0	0	16	0	0
23	20936467	.	T	C	6	7	13	0	0	13	0	0
23	21106219	.	A	T	1	0	1	0	1	2	0	0
23	21111170	.	A	G	3	0	3	0	3	6	0	0
23	21113750	.	T	C	0	1	1	0	0	1	0	0
23	21113770	.	C	T	0	1	1	0	0	1	0	0
23	21114732	.	A	C	3	4	7	0	0	7	0	0
23	21264226	.	A	G	1	2	3	0	0	3	0	0
23	21265446	.	C	T	1	2	3	0	1	4	0	0
23	21266896	.	C	T	0	1	1	0	0	1	0	0
23	21268808	.	T	C	2	4	6	0	0	6	0	0
23	21269494	.	A	G	2	2	4	0	0	4	0	0
23	21269620	.	A	G	1	2	3	0	1	4	0	0
23	21269626	.	T	G	1	2	3	0	1	4	0	0
23	21269792	.	T	G	1	3	4	0	0	4	0	0
23	21276362	.	T	C	7	6	13	0	1	14	0	0
23	21277208	.	G	A	2	4	6	0	1	7	0	0
23	21277247	.	T	A	5	5	10	0	0	10	0	0
23	21330864	.	T	C	1	2	3	0	0	3	0	0
23	21331172	.	C	A	0	1	1	0	0	1	0	0
23	21343661	.	A	G	1	3	4	0	0	4	0	0
23	21349972	.	T	C	0	1	1	0	0	1	0	0
23	21353837	.	C	T	3	5	8	0	0	8	0	0
23	21356056	.	C	T	3	7	10	0	0	10	0	0
23	21361347	.	T	C	1	4	5	0	0	5	0	0
23	21361570	.	G	A	3	0	3	0	0	3	0	0
23	21362178	.	G	A	0	2	2	0	2	4	0	0
23	21362217	.	G	T	1	3	4	0	0	4	0	0
23	21362735	.	G	A	4	2	6	0	1	7	0	0
23	21362822	.	C	T	6	4	10	0	0	10	0	0
23	21363039	.	C	A	3	4	7	0	0	7	0	0
23	21364431	.	G	A	2	4	6	0	0	6	0	0
23	21364449	.	G	A	0	4	4	0	6	10	0	0
23	21364632	.	T	C	1	1	2	0	0	2	0	0
23	21364725	.	C	T	3	0	3	0	0	3	0	0
23	21366588	.	C	T	3	0	3	0	0	3	0	0
23	21366743	.	A	C	3	5	8	0	0	8	0	0
23	21366764	.	C	T	1	1	2	0	0	2	0	0
23	21367861	.	A	G	3	6	9	0	2	11	0	0
23	21367994	.	A	T	0	2	2	0	0	2	0	0
23	21368078	.	C	T	7	13	20	0	1	21	0	0
23	21368090	.	G	A	7	14	21	0	0	21	0	0
23	21368156	.	A	G	9	8	17	0	0	17	0	0
23	21368183	.	G	A	4	4	8	0	0	8	0	0
23	21369126	.	G	C	0	5	5	0	3	8	0	0
23	21369678	.	T	C	9	19	28	0	1	29	0	0
23	21369703	.	C	A	10	19	29	0	0	29	0	0
23	21369750	.	C	T	4	3	7	0	1	8	0	0
23	21376413	.	T	A	19	13	32	0	5	38	1	0
23	21376570	.	C	T	21	13	34	0	1	35	0	0
23	21376617	.	A	G	16	1	17	0	9	26	0	0
23	21376678	.	G	T	15	17	32	0	0	32	0	0
23	21376689	.	C	T	12	17	29	0	1	30	0	0
23	21376787	.	C	G	9	11	20	0	1	21	0	0
23	21380288	.	C	T	1	2	3	0	0	3	0	0
23	21380370	.	C	A	1	2	3	0	0	3	0	0
23	21455709	.	C	T	0	3	3	0	1	4	0	0
23	21455786	.	A	C	2	2	4	0	0	4	0	0
23	21455788	.	A	G	2	2	4	0	0	4	0	0
23	21483656	.	C	T	3	4	7	0	0	7	0	0
23	21483803	.	G	A	3	4	7	0	0	7	0	0
23	21488054	.	T	C	4	7	11	0	0	11	0	0
23	21488208	.	A	G	4	3	7	0	0	7	0	0
23	21488221	.	A	T	2	3	5	0	1	6	0	0
23	21488438	.	C	A	2	2	4	0	0	4	0	0
23	21488630	.	A	C	10	3	13	0	1	14	0	0
23	21488726	.	T	C	1	3	4	0	0	4	0	0
23	21488872	.	G	A	8	6	14	0	0	14	0	0
23	21489121	.	C	T	11	8	19	0	0	19	0	0
23	21489233	.	T	C	9	9	18	0	1	19	0	0
23	21489567	.	T	C	8	9	17	0	1	18	0	0
23	21490211	.	G	A	0	5	5	0	3	8	0	0
23	21492284	.	A	G	2	3	5	0	1	6	0	0
23	21492314	.	A	T	4	2	6	0	0	6	0	0
23	21492756	.	A	T	2	0	2	0	0	2	0	0
23	21497808	.	C	T	6	2	8	0	0	8	0	0
23	21498165	.	T	C	3	2	5	0	0	5	0	0
23	21498240	.	A	G	1	0	1	0	4	5	0	0
23	21498326	.	C	T	0	2	2	0	0	2	0	0
23	21498383	.	A	T	4	2	6	0	0	6	0	0
23	21498449	.	T	C	5	8	13	0	1	14	0	0
23	21498478	.	T	C	4	9	13	0	2	15	0	0
23	21522091	.	G	A	4	0	4	0	1	5	0	0
23	21569490	.	G	A	1	1	2	0	2	4	0	0
23	21618055	.	C	T	1	3	4	0	0	4	0	0
23	21626211	.	C	T	5	3	8	0	0	8	0	0
23	21630363	.	T	G	4	6	10	0	0	10	0	0
23	21630393	.	G	A	4	3	7	0	0	7	0	0
23	21630676	.	G	A	7	6	13	0	0	13	0	0
23	21630973	.	C	T	9	9	18	0	1	19	0	0
23	21638300	.	C	T	4	5	9	0	1	10	0	0
23	21647187	.	C	T	3	6	9	0	0	9	0	0
23	21647196	.	G	A	1	3	4	0	5	9	0	0
23	21661227	.	C	T	9	5	14	0	1	15	0	0
23	21661483	.	G	A	0	7	7	0	9	16	0	0
23	21674163	.	G	T	2	2	4	0	0	4	0	0
23	21721568	.	T	C	5	3	8	0	0	8	0	0
23	21721667	.	C	T	1	3	4	0	0	4	0	0
23	21721868	.	G	A	2	4	6	0	0	6	0	0
23	21722153	.	G	A	0	1	1	0	0	1	0	0
23	21735090	.	C	T	3	2	5	0	0	5	0	0
23	21741133	.	C	T	2	3	5	0	0	5	0	0
23	21797387	.	G	A	4	3	7	0	0	7	0	0
23	21803494	.	T	G	4	4	8	0	0	8	0	0
23	21803685	.	G	A	1	7	8	0	0	8	0	0
23	21803801	.	T	C	3	2	5	0	0	5	0	0
23	21803925	.	T	A	2	1	3	0	0	3	0	0
23	21805289	.	T	A	1	3	4	0	0	4	0	0
23	21805710	.	C	T	4	2	6	0	0	6	0	0
23	21807113	.	T	C	3	3	6	0	0	6	0	0
23	21810048	.	A	G	3	2	5	0	0	5	0	0
23	22018738	.	G	T	2	1	3	0	0	3	0	0
23	22030235	.	T	C	3	4	7	0	0	7	0	0
23	22030410	.	G	A	2	5	7	0	1	8	0	0
23	22030411	.	G	T	1	5	6	0	2	8	0	0
23	22033661	.	G	A	0	1	1	0	0	1	0	0
23	22051041	.	G	A	4	2	6	0	0	6	0	0
23	22051380	.	C	T	3	3	6	0	0	6	0	0
23	22054542	.	C	A	2	2	4	0	0	4	0	0
23	22060088	.	T	A	6	3	9	0	3	12	0	0
23	22064493	.	A	G	4	7	11	0	0	11	0	0
23	22067865	.	G	T	3	1	4	0	1	5	0	0
23	22072641	.	T	G	1	2	3	0	0	3	0	0
23	22084627	.	A	G	1	3	4	0	1	5	0	0
23	22379008	.	T	C	3	3	6	0	0	6	0	0
23	22424506	.	T	A	2	3	5	0	0	5	0	0
23	22424524	.	C	T	3	3	6	0	2	8	0	0
23	22424562	.	A	G	3	4	7	0	1	8	0	0
23	22424574	.	G	A	0	4	4	0	4	8	0	0
23	22425126	.	G	C	2	5	7	0	0	7	0	0
23	22496525	.	C	A	3	5	8	0	0	8	0	0
23	22496589	.	A	G	7	8	15	0	0	15	0	0
23	22497049	.	A	T	9	4	13	0	0	13	0	0
23	22497550	.	A	G	5	7	12	0	1	13	0	0
23	22508141	.	A	T	0	3	3	0	0	3	0	0
23	22591327	.	T	C	1	3	4	0	0	4	0	0
23	22635036	.	T	A	2	5	7	0	1	8	0	0
23	22635284	.	G	A	9	6	15	0	0	15	0	0
23	22635490	.	C	G	1	3	4	0	0	4	0	0
23	22635732	.	C	A	0	1	1	0	3	4	0	0
23	22667247	.	C	T	26	24	50	0	0	50	0	0
23	22674704	.	C	T	4	3	7	0	1	8	0	0
23	22677394	.	A	C	7	9	16	0	2	18	0	0
23	22677496	.	C	T	36	41	77	0	3	80	0	0
23	22677638	.	C	T	32	32	64	0	3	67	0	0
23	22895465	.	G	A	1	0	1	0	0	1	0	0
23	22922775	.	A	C	12	4	16	0	4	20	0	0
23	22922795	.	G	T	9	6	15	0	0	15	0	0
23	22923021	.	A	C	11	14	25	0	2	27	0	0
23	22923033	.	C	T	12	18	30	0	1	31	0	0
23	22923198	.	C	T	9	12	21	0	2	23	0	0
23	22923339	.	C	T	19	16	35	0	1	36	0	0
23	22923537	.	C	T	16	15	31	0	2	33	0	0
23	22923603	.	T	C	10	9	19	0	0	19	0	0
23	22925490	.	C	A	4	0	4	0	0	4	0	0
23	23118653	.	A	T	4	7	11	0	1	12	0	0
23	23118815	.	C	T	3	3	6	0	0	6	0	0
23	23122381	.	C	T	7	8	15	0	0	15	0	0
23	23122955	.	G	T	2	0	2	1	0	3	0	0
23	23123146	.	G	T	6	10	16	0	0	16	0	0
23	23123715	.	C	T	5	3	8	0	0	8	0	0
23	23126589	.	A	C	5	4	9	0	0	9	0	0
23	23126621	.	T	C	5	3	8	0	0	8	0	0
23	23136745	.	G	A	1	0	1	0	0	1	0	0
23	23154388	.	T	A	1	0	1	0	0	1	0	0
23	23170963	.	T	G	2	2	4	0	0	4	0	0
23	23171172	.	C	T	2	3	5	0	0	5	0	0
23	23190151	.	T	A	8	3	11	0	0	11	0	0
23	23192478	.	G	A	8	5	13	0	0	13	0	0
23	23192514	.	A	T	1	1	2	0	0	2	0	0
23	23194228	.	C	T	9	5	14	0	1	15	0	0
23	23205469	.	A	G	4	0	4	0	17	21	0	0
23	23205511	.	T	C	1	8	9	0	0	9	0	0
23	23210288	.	A	G	8	11	19	0	0	19	0	0
23	23210303	.	A	G	11	11	22	0	0	23	1	0
23	23210339	.	C	T	4	13	17	0	2	19	0	0
23	23212257	.	C	T	2	3	5	0	0	5	0	0
23	23212567	.	C	T	13	10	23	0	0	23	0	0
23	23213219	.	T	C	22	11	33	0	1	34	0	0
23	23213417	.	C	T	11	5	16	0	2	18	0	0
23	23213437	.	G	A	1	8	9	0	10	19	0	0
23	23213582	.	C	A	18	17	35	0	0	35	0	0
23	23213613	.	T	A	22	15	37	0	1	38	0	0
23	23213657	.	G	A	25	15	40	0	2	42	0	0
23	23213757	.	G	A	24	18	42	0	0	42	0	0
23	23213800	.	G	A	1	12	13	0	14	27	0	0
23	23213917	.	T	A	13	19	32	0	0	32	0	0
23	23213939	.	T	A	15	12	27	0	2	29	0	0
23	23214070	.	C	T	7	7	14	0	2	16	0	0
23	23399987	.	T	C	6	2	8	0	0	8	0	0
23	23400332	.	G	C	2	4	6	0	0	6	0	0
23	23741687	.	G	A	0	3	3	0	1	4	0	0
23	23754415	.	C	T	3	4	7	0	0	7	0	0
23	23816509	.	A	C	2	5	7	0	0	7	0	0
23	23844523	.	A	C	1	0	1	0	0	1	0	0
23	23844529	.	T	C	3	0	3	0	0	3	0	0
23	23860113	.	T	A	2	3	5	0	0	5	0	0
23	23860117	.	G	A	2	3	5	0	0	5	0	0
23	23877088	.	A	G	9	0	9	0	4	13	0	0
23	23888136	.	G	A	0	11	11	0	16	27	0	0
23	23891551	.	G	A	0	3	3	0	1	4	0	0
23	23903278	.	G	A	1	11	12	0	7	19	0	0
23	23903432	.	C	T	4	5	9	0	0	9	0	0
23	23912720	.	G	T	17	20	37	0	3	40	0	0
23	23912723	.	C	A	18	22	40	0	0	40	0	0
23	23912900	.	C	G	14	12	26	0	0	26	0	0
23	23913240	.	G	T	17	22	39	0	3	42	0	0
23	23913818	.	A	T	12	19	31	0	4	35	0	0
23	23913858	.	A	C	24	18	42	0	5	47	0	0
23	23914017	.	G	A	0	17	17	0	26	43	0	0
23	23914176	.	A	T	14	26	40	0	2	42	0	0
23	23983662	.	A	T	2	7	9	0	0	9	0	0
23	23983677	.	C	T	2	7	9	0	0	9	0	0
23	23987646	.	A	G	1	0	1	0	0	1	0	0
23	23987652	.	G	A	1	0	1	0	0	1	0	0
23	23994595	.	C	T	8	6	14	0	1	15	0	0
23	23995111	.	G	T	0	2	2	0	0	2	0	0
23	24112906	.	A	G	1	1	2	0	1	3	0	0
23	24144860	.	A	G	5	4	9	0	0	9	0	0
23	24144872	.	T	C	4	3	7	0	0	7	0	0
23	24148183	.	T	C	1	2	3	0	0	3	0	0
23	24170870	.	G	A	12	13	25	0	1	26	0	0
23	24188087	.	C	T	0	0	0	0	1	1	0	0
23	24195469	.	C	T	3	5	8	0	0	8	0	0
23	24202602	.	C	T	5	2	7	0	2	9	0	0
23	24202658	.	G	A	4	2	6	0	0	6	0	0
23	24202858	.	C	T	4	5	9	0	0	9	0	0
23	24202985	.	T	C	1	3	4	0	0	4	0	0
23	24208208	.	G	C	4	2	6	0	0	6	0	0
23	24214226	.	C	T	2	2	4	0	0	4	0	0
23	24214381	.	G	A	2	3	5	0	1	6	0	0
23	24214414	.	C	T	5	2	7	0	0	7	0	0
23	24216192	.	G	A	1	3	4	0	0	4	0	0
23	24216339	.	A	C	1	0	1	0	3	4	0	0
23	24227352	.	A	T	3	11	14	0	0	14	0	0
23	24227380	.	A	G	6	7	13	0	3	16	0	0
23	24227458	.	T	C	9	19	28	0	1	29	0	0
23	24227673	.	C	A	18	19	37	0	4	41	0	0
23	24228767	.	G	A	16	9	25	0	0	25	0	0
23	24229110	.	G	A	8	10	18	0	0	18	0	0
23	24231222	.	A	G	5	6	11	0	0	11	0	0
23	24233458	.	A	G	3	3	6	0	0	6	0	0
23	24233831	.	A	G	3	2	5	0	0	5	0	0
23	24238551	.	G	A	4	4	8	0	0	8	0	0
23	24240979	.	G	T	10	5	15	0	0	15	0	0
23	24243168	.	G	A	1	2	3	0	0	3	0	0
23	24244694	.	C	T	0	4	4	0	1	5	0	0
23	24247719	.	A	T	2	1	3	0	1	4	0	0
23	24251829	.	T	A	3	7	10	0	0	10	0	0
23	24301288	.	G	A	2	3	5	0	0	5	0	0
23	24304648	.	T	C	3	1	4	0	0	4	0	0
23	24439480	.	G	T	14	10	24	0	2	26	0	0
23	24439780	.	G	A	11	14	25	0	1	26	0	0
23	24440397	.	C	T	5	6	11	0	4	15	0	0
23	24442787	.	T	G	1	2	3	0	0	3	0	0
23	24443161	.	G	T	7	10	17	0	0	17	0	0
23	24443576	.	A	G	10	8	18	0	0	18	0	0
23	24443609	.	C	T	1	8	9	0	6	15	0	0
23	24444291	.	A	G	9	20	29	0	2	31	0	0
23	24444344	.	C	G	9	10	19	0	0	19	0	0
23	24444543	.	C	T	0	13	13	0	13	26	0	0
23	24444803	.	T	G	9	9	18	0	1	19	0	0
23	24444861	.	G	A	11	8	19	0	0	19	0	0
23	24445112	.	G	T	12	10	22	0	2	24	0	0
23	24445338	.	A	G	6	14	20	0	1	21	0	0
23	24445584	.	A	G	11	6	17	0	1	18	0	0
23	24445876	.	A	G	9	6	15	0	1	16	0	0
23	24445906	.	G	C	10	5	15	0	1	16	0	0
23	24446411	.	C	T	3	3	6	0	3	9	0	0
23	24447113	.	C	T	3	4	7	0	0	7	0	0
23	24447297	.	C	T	3	2	5	0	1	6	0	0
23	24447794	.	G	A	9	3	12	0	0	12	0	0
23	24448071	.	T	A	3	5	8	0	0	8	0	0
23	24448273	.	G	C	5	3	8	0	0	8	0	0
23	24448621	.	G	C	4	3	7	0	0	7	0	0
23	24448630	.	G	T	4	3	7	0	0	7	0	0
23	24451512	.	T	C	2	4	6	0	0	6	0	0
23	24451791	.	T	C	1	1	2	0	0	2	0	0
23	24504389	.	A	G	4	0	4	0	5	9	0	0
23	24591399	.	G	A	2	2	4	0	1	5	0	0
23	24592340	.	T	C	1	0	1	0	0	1	0	0
23	24600513	.	C	T	2	1	3	0	0	3	0	0
23	24600947	.	T	C	11	11	22	0	0	22	0	0
23	24604042	.	C	T	13	14	27	0	1	28	0	0
23	24604461	.	A	G	1	1	2	0	4	6	0	0
23	24605243	.	T	A	3	4	7	0	0	7	0	0
23	24608805	.	G	A	4	4	8	0	0	8	0	0
23	24608847	.	G	A	0	15	15	0	10	25	0	0
23	24611786	.	G	A	0	4	4	0	3	7	0	0
23	24652909	.	G	A	0	3	3	0	1	4	0	0
23	24652929	.	G	A	0	4	4	0	1	5	0	0
23	24654287	.	G	T	3	2	5	0	0	5	0	0
23	24655227	.	T	C	2	5	7	0	0	7	0	0
23	24655478	.	C	T	1	4	5	0	0	5	0	0
23	24655761	.	T	G	2	1	3	0	3	6	0	0
23	24655833	.	A	G	5	2	7	0	0	7	0	0
23	24659777	.	C	T	3	3	6	0	0	6	0	0
23	24661851	.	C	T	11	4	15	0	0	15	0	0
23	24669381	.	C	T	0	6	6	0	8	14	0	0
23	24669633	.	T	C	10	0	10	0	13	23	0	0
23	24672365	.	C	T	2	4	6	0	0	6	0	0
23	24676192	.	G	C	1	8	9	0	0	9	0	0
23	24694242	.	C	A	16	11	27	0	2	29	0	0
23	24694756	.	C	T	0	1	1	0	0	1	0	0
23	24694763	.	T	A	2	1	3	0	0	3	0	0
23	24697036	.	G	A	10	16	26	0	0	26	0	0
23	24699281	.	T	A	14	15	29	0	0	29	0	0
23	24747961	.	G	A	0	2	2	0	1	3	0	0
23	24749514	.	A	G	3	0	3	0	2	5	0	0
23	24749528	.	A	T	2	3	5	0	0	5	0	0
23	24750010	.	C	T	2	3	5	0	0	5	0	0
23	24750203	.	G	A	2	2	4	0	0	4	0	0
23	24750339	.	C	A	1	2	3	0	0	3	0	0
23	24750425	.	C	T	2	2	4	0	0	4	0	0
23	24803130	.	C	T	11	11	22	0	2	24	0	0
23	24803221	.	T	C	5	1	6	0	2	8	0	0
23	24819831	.	C	G	7	5	12	0	1	13	0	0
23	24823899	.	T	C	3	1	4	0	0	4	0	0
23	24855864	.	G	T	0	1	1	0	0	1	0	0
23	24932493	.	G	T	4	2	6	0	0	6	0	0
23	24932979	.	G	A	5	3	8	0	0	8	0	0
23	24933121	.	C	T	6	6	12	0	0	12	0	0
23	24934567	.	T	C	9	10	19	0	2	21	0	0
23	24934597	.	C	G	9	7	16	0	2	18	0	0
23	24938290	.	T	A	3	5	8	0	1	9	0	0
23	24957161	.	G	C	1	2	3	0	0	3	0	0
23	24959374	.	G	C	4	3	7	0	0	7	0	0
23	24959406	.	T	C	4	2	6	0	0	6	0	0
23	24960393	.	T	A	3	2	5	0	0	5	0	0
23	24960740	.	T	G	2	2	4	0	0	4	0	0
23	24960741	.	G	T	2	2	4	0	0	4	0	0
23	24965393	.	C	T	2	10	12	0	1	13	0	0
23	24965396	.	G	A	3	11	14	0	0	14	0	0
23	24965432	.	G	T	4	7	11	0	0	11	0	0
23	24965767	.	C	G	3	1	4	0	0	4	0	0
23	24968676	.	C	A	5	6	11	0	0	11	0	0
23	24970331	.	A	G	1	0	1	0	1	2	0	0
23	24970372	.	G	A	6	6	12	0	0	12	0	0
23	24970451	.	T	C	4	3	7	0	0	7	0	0
23	24970589	.	A	G	3	5	8	0	0	8	0	0
23	24970593	.	G	A	2	6	8	0	1	9	0	0
23	24970710	.	G	A	5	3	8	0	0	8	0	0
23	24970732	.	C	T	4	2	6	0	0	6	0	0
23	24973871	.	T	C	3	3	6	0	0	6	0	0
23	24973928	.	A	G	2	4	6	0	0	6	0	0
23	24973931	.	A	G	2	0	2	0	4	6	0	0
23	24977048	.	G	T	4	8	12	0	0	12	0	0
23	24977060	.	C	T	3	7	10	0	0	10	0	0
23	24980093	.	A	G	1	0	1	0	0	1	0	0
23	24980349	.	T	A	2	2	4	0	0	4	0	0
23	24980448	.	A	G	2	2	4	0	0	4	0	0
23	24983469	.	C	G	7	2	9	0	0	9	0	0
23	24983479	.	G	C	7	1	8	0	1	9	0	0
23	24983536	.	A	G	1	0	1	0	3	4	0	0
23	25551282	.	G	A	1	1	2	0	0	2	0	0
23	25756641	.	A	G	1	2	3	0	1	4	0	0
23	25757012	.	G	A	1	1	2	0	0	2	0	0
23	25757378	.	G	A	0	2	2	0	3	5	0	0
23	25767757	.	G	A	0	6	6	0	6	12	0	0
23	25768133	.	C	G	4	2	6	0	1	7	0	0
23	25768384	.	C	T	1	5	6	0	0	6	0	0
23	25770804	.	T	A	0	2	2	0	1	3	0	0
23	25772369	.	A	G	0	2	2	0	0	2	0	0
23	25772799	.	G	A	2	3	5	0	0	5	0	0
23	25773460	.	G	A	4	4	8	0	0	8	0	0
23	25773469	.	G	A	4	2	6	0	0	6	0	0
23	25773505	.	G	T	1	1	2	0	0	2	0	0
23	25776824	.	C	T	2	2	4	0	1	5	0	0
23	25777286	.	A	G	3	2	5	0	0	5	0	0
23	25796410	.	T	A	6	9	15	0	0	15	0	0
23	25796484	.	G	C	3	0	3	0	4	7	0	0
23	25796670	.	T	G	3	7	10	0	1	11	0	0
23	25796691	.	T	C	5	0	5	0	4	9	0	0
23	25797011	.	T	A	3	3	6	0	1	7	0	0
23	25797022	.	T	A	4	2	6	0	0	6	0	0
23	25797143	.	G	C	3	6	9	0	1	10	0	0
23	25797216	.	G	A	7	4	11	0	1	12	0	0
23	25869424	.	A	G	7	0	7	0	6	13	0	0
23	25869658	.	C	T	6	8	14	0	0	14	0	0
23	25869706	.	A	G	13	11	24	0	0	24	0	0
23	25871764	.	C	A	8	3	11	0	0	11	0	0
23	25872703	.	G	A	1	0	1	0	2	3	0	0
23	25873362	.	G	T	4	6	10	0	0	10	0	0
23	25873365	.	T	A	5	5	10	0	0	10	0	0
23	25873444	.	C	A	5	11	16	0	0	16	0	0
23	25873670	.	A	G	3	3	6	0	0	6	0	0
23	25873876	.	A	T	2	3	5	0	0	5	0	0
23	25873882	.	G	C	2	2	4	0	1	5	0	0
23	25873967	.	T	A	3	1	4	0	0	4	0	0
23	25873976	.	T	A	5	1	6	0	0	6	0	0
23	25874249	.	A	G	10	0	10	0	16	26	0	0
23	25874261	.	T	A	9	15	24	0	0	24	0	0
23	25874334	.	C	G	2	3	5	0	0	5	0	0
23	25874355	.	A	T	2	4	6	0	0	6	0	0
23	25874459	.	A	T	9	12	21	0	0	21	0	0
23	25874498	.	G	A	6	7	13	0	0	13	0	0
23	25874615	.	G	A	1	4	5	0	0	5	0	0
23	25879786	.	A	G	8	10	18	0	0	18	0	0
23	25879930	.	A	C	2	5	7	0	1	8	0	0
23	25930689	.	C	T	2	6	8	0	0	8	0	0
23	25942399	.	T	G	7	1	8	0	14	22	0	0
23	25942559	.	T	A	5	6	11	0	1	12	0	0
23	25942708	.	G	A	0	6	6	0	2	8	0	0
23	25946732	.	A	G	3	4	7	0	0	7	0	0
23	25946766	.	C	T	1	3	4	0	0	4	0	0
23	25947258	.	A	C	1	2	3	0	0	3	0	0
23	25947416	.	T	G	1	2	3	0	0	3	0	0
23	25947599	.	T	C	2	0	2	0	4	6	0	0
23	25948000	.	G	A	2	3	5	0	0	5	0	0
23	26063179	.	A	T	2	2	4	0	0	4	0	0
23	26063560	.	A	T	31	23	54	0	1	55	0	0
23	26063614	.	A	C	28	28	56	0	2	58	0	0
23	26063734	.	G	A	29	24	53	0	0	53	0	0
23	26063843	.	G	A	24	33	57	0	4	61	0	0
23	26063985	.	A	T	27	29	56	0	3	59	0	0
23	26064050	.	T	A	24	29	53	0	4	57	0	0
23	26064122	.	T	A	12	15	27	0	0	27	0	0
23	26064124	.	T	A	19	8	27	0	0	27	0	0
23	26064266	.	T	A	16	25	41	0	1	42	0	0
23	26064923	.	T	C	31	0	31	0	28	59	0	0
23	26064948	.	T	G	31	25	56	0	3	60	1	0
23	26064989	.	A	G	32	26	58	0	1	60	1	0
23	26065079	.	T	C	34	32	66	0	1	67	0	0
23	26074123	.	G	A	11	10	21	0	1	22	0	0
23	26074252	.	T	A	2	0	2	0	0	2	0	0
23	26088791	.	G	C	2	5	7	0	0	7	0	0
23	26088845	.	A	G	1	3	4	0	0	4	0	0
23	26093095	.	C	T	10	4	14	0	0	14	0	0
23	26093597	.	A	G	4	4	8	0	0	8	0	0
23	26093868	.	T	C	2	2	4	0	1	5	0	0
23	26093933	.	A	T	5	4	9	0	0	9	0	0
23	26094063	.	A	G	6	4	10	0	0	10	0	0
23	26094533	.	A	G	7	6	13	0	0	13	0	0
23	26094589	.	G	C	11	20	31	0	1	32	0	0
23	26094617	.	T	C	14	23	37	0	2	39	0	0
23	26094626	.	T	C	14	0	14	0	27	41	0	0
23	26094694	.	A	C	7	16	23	0	2	25	0	0
23	26094877	.	A	G	11	11	22	0	0	22	0	0
23	26094932	.	G	A	12	4	16	0	0	16	0	0
23	26094938	.	C	A	14	3	17	0	1	18	0	0
23	26095081	.	G	A	11	14	25	0	2	27	0	0
23	26095096	.	C	T	14	15	29	0	2	31	0	0
23	26095153	.	G	A	17	10	27	0	0	27	0	0
23	26095285	.	T	A	13	12	25	0	1	26	0	0
23	26095400	.	C	T	14	18	32	0	1	33	0	0
23	26095416	.	T	G	8	13	21	0	1	22	0	0
23	26110735	.	G	A	11	10	21	0	2	23	0	0
23	26120198	.	C	A	0	6	6	0	3	9	0	0
23	26187735	.	C	T	2	0	2	0	0	2	0	0
23	26225907	.	A	T	5	5	10	0	0	10	0	0
23	26227697	.	C	T	0	4	4	0	3	7	0	0
23	26232509	.	C	A	16	9	25	0	0	25	0	0
23	26240860	.	G	A	3	5	8	0	2	10	0	0
23	26249884	.	G	A	1	1	2	0	0	2	0	0
23	26251940	.	G	A	1	7	8	0	0	8	0	0
23	26251946	.	A	G	1	6	7	0	1	8	0	0
23	26258065	.	C	T	0	4	4	0	4	8	0	0
23	26503884	.	T	C	32	0	32	0	28	60	0	0
23	26504151	.	A	C	26	2	28	0	20	48	0	0
23	26504202	.	A	T	33	15	48	0	3	51	0	0
23	26504254	.	G	A	26	18	44	0	0	44	0	0
23	26504264	.	C	T	25	22	47	0	0	47	0	0
23	26507741	.	G	A	19	36	55	0	3	58	0	0
23	26509764	.	G	A	16	21	37	0	0	37	0	0
23	26517183	.	G	A	12	16	28	0	1	29	0	0
23	26522647	.	A	G	7	10	17	0	1	18	0	0
23	26522892	.	G	A	16	9	25	0	1	26	0	0
23	26523020	.	A	G	1	4	5	0	0	5	0	0
23	26763798	.	A	T	4	6	10	0	1	11	0	0
23	26763994	.	C	A	7	9	16	0	1	17	0	0
23	26764230	.	G	T	6	5	11	0	0	11	0	0
23	26764351	.	A	C	3	3	6	0	0	6	0	0
23	26766668	.	A	G	8	7	15	0	0	15	0	0
23	26797108	.	T	A	3	2	5	0	1	6	0	0
23	26811454	.	G	A	1	2	3	0	0	3	0	0
23	26828760	.	G	A	1	2	3	0	0	3	0	0
23	26888069	.	G	A	1	1	2	0	0	2	0	0
23	26946805	.	A	G	1	3	4	0	0	4	0	0
23	26955383	.	C	T	5	2	7	0	0	7	0	0
23	26955401	.	A	G	4	2	6	0	0	6	0	0
23	26979223	.	C	A	12	13	25	0	0	25	0	0
23	27003630	.	T	A	10	9	19	0	0	19	0	0
23	27003720	.	G	A	28	23	51	0	4	55	0	0
23	27003801	.	T	C	22	18	40	0	3	43	0	0
23	27004310	.	C	T	21	22	43	0	0	43	0	0
23	27004339	.	C	T	19	19	38	0	1	39	0	0
23	27004347	.	G	A	18	19	37	0	1	38	0	0
23	27004383	.	C	T	16	10	26	0	1	27	0	0
23	27004397	.	T	C	13	8	21	0	1	22	0	0
23	27004665	.	T	C	20	10	30	0	0	30	0	0
23	27005195	.	G	A	22	20	42	0	3	45	0	0
23	27005514	.	A	G	10	0	10	0	16	26	0	0
23	27005610	.	C	G	9	0	9	0	24	33	0	0
23	27005973	.	G	T	1	2	3	0	0	3	0	0
23	27041461	.	A	T	5	5	10	0	1	11	0	0
23	27041503	.	C	G	5	7	12	0	1	13	0	0
23	27041778	.	A	T	5	4	9	0	1	10	0	0
23	27041786	.	A	C	4	3	7	0	0	7	0	0
23	27042132	.	A	G	7	6	13	0	0	13	0	0
23	27044526	.	A	G	1	2	3	0	1	4	0	0
23	27044638	.	T	A	2	5	7	0	0	7	0	0
23	27044946	.	C	G	4	4	8	0	0	8	0	0
23	27044947	.	T	C	4	0	4	0	4	8	0	0
23	27052123	.	C	A	4	6	10	0	0	10	0	0
23	27052125	.	C	T	3	6	9	0	1	10	0	0
23	27054361	.	C	T	5	7	12	0	0	12	0	0
23	27059120	.	G	A	0	20	20	0	13	33	0	0
23	27059376	.	T	A	9	18	27	0	3	30	0	0
23	27059422	.	C	T	11	19	30	0	1	31	0	0
23	27059459	.	A	G	15	0	15	0	21	36	0	0
23	27059526	.	G	A	0	18	18	0	15	33	0	0
23	27251789	.	G	C	23	14	37	0	0	37	0	0
23	27251859	.	G	A	18	25	43	0	3	46	0	0
23	27251872	.	C	T	0	26	26	0	17	43	0	0
23	27252425	.	G	A	23	22	45	0	0	45	0	0
23	27252587	.	A	G	14	19	33	0	0	33	0	0
23	27252833	.	A	G	18	17	35	0	1	36	0	0
23	27254226	.	T	C	3	4	7	0	0	7	0	0
23	27254586	.	C	T	1	8	9	0	12	21	0	0
23	27274110	.	G	A	2	4	6	0	0	6	0	0
23	27279281	.	A	G	3	9	12	0	1	13	0	0
23	27279320	.	A	G	10	6	16	0	0	16	0	0
23	27279476	.	G	A	7	9	16	0	2	18	0	0
23	27279533	.	C	T	1	7	8	0	0	8	0	0
23	27294611	.	G	A	3	3	6	0	1	7	0	0
23	27296964	.	G	C	4	0	4	0	2	6	0	0
23	27305186	.	C	T	2	5	7	0	0	7	0	0
23	27305195	.	G	A	2	4	6	0	0	6	0	0
23	27358990	.	A	T	5	12	17	0	1	18	0	0
23	27359203	.	A	G	11	9	20	0	0	20	0	0
23	27359410	.	G	A	8	8	16	0	0	16	0	0
23	27359526	.	T	C	10	4	14	0	0	14	0	0
23	27359755	.	C	T	0	5	5	0	11	16	0	0
23	27359825	.	C	A	9	9	18	0	3	21	0	0
23	27359867	.	A	C	7	7	14	0	1	15	0	0
23	27360007	.	G	A	5	3	8	0	0	8	0	0
23	27361210	.	A	T	3	5	8	0	1	9	0	0
23	27361216	.	G	A	4	5	9	0	1	10	0	0
23	27364018	.	C	T	7	3	10	0	1	11	0	0
23	27366669	.	C	T	1	2	3	0	0	3	0	0
23	27373181	.	C	T	0	1	1	0	1	2	0	0
23	27373186	.	G	T	1	1	2	0	0	2	0	0
23	27497811	.	T	A	2	4	6	0	0	6	0	0
23	27497960	.	A	T	16	13	29	1	0	30	0	0
23	27498027	.	A	T	8	11	19	0	0	19	0	0
23	27498040	.	C	G	14	11	25	0	1	26	0	0
23	27498195	.	A	T	14	12	26	0	0	26	0	0
23	27498441	.	A	T	8	5	13	0	0	13	0	0
23	27498798	.	C	T	0	17	17	0	14	31	0	0
23	27499096	.	G	A	17	12	29	0	1	30	0	0
23	27499195	.	A	T	9	18	27	0	1	28	0	0
23	27499246	.	G	A	8	11	19	0	1	20	0	0
23	27499306	.	C	T	9	14	23	0	0	23	0	0
23	27501872	.	A	G	10	12	22	0	0	22	0	0
23	27513952	.	A	G	6	3	9	0	0	9	0	0
23	27515931	.	G	A	4	3	7	0	1	8	0	0
23	27516268	.	T	C	1	0	1	0	0	1	0	0
23	27518434	.	G	A	4	6	10	0	2	12	0	0
23	27521608	.	A	T	2	0	2	0	0	2	0	0
23	27521815	.	G	A	2	3	5	0	0	5	0	0
23	27521863	.	A	G	6	5	11	0	0	11	0	0
23	27547467	.	C	T	0	1	1	0	1	2	0	0
23	27547568	.	G	A	2	2	4	0	0	4	0	0
23	27547650	.	A	T	3	2	5	0	0	5	0	0
23	27547850	.	C	T	0	2	2	0	1	3	0	0
23	27591834	.	C	T	7	6	13	0	0	13	0	0
23	27591859	.	C	T	12	5	17	0	1	18	0	0
23	27591939	.	A	G	3	16	19	0	0	19	0	0
23	27592411	.	A	C	5	4	9	0	1	10	0	0
23	27592796	.	T	C	7	1	8	0	8	16	0	0
23	27593230	.	C	T	8	11	19	0	2	21	0	0
23	27597141	.	C	A	0	1	1	0	2	3	0	0
23	27597808	.	G	A	11	5	16	0	1	17	0	0
23	27597980	.	G	A	1	3	4	0	0	4	0	0
23	27597981	.	C	A	1	3	4	0	0	4	0	0
23	27599110	.	A	C	1	1	2	0	0	2	0	0
23	27599365	.	G	A	2	2	4	0	1	5	0	0
23	27601803	.	C	T	2	2	4	0	0	4	0	0
23	27603302	.	G	A	0	1	1	0	0	1	0	0
23	27622036	.	T	A	19	26	45	0	0	45	0	0
23	27622212	.	C	A	13	12	25	0	0	25	0	0
23	27622258	.	T	C	17	7	24	0	1	25	0	0
23	27622324	.	T	C	8	9	17	0	0	17	0	0
23	27629923	.	A	T	1	1	2	0	0	2	0	0
23	27641530	.	G	A	1	2	3	0	0	3	0	0
23	27657816	.	C	T	1	2	3	0	0	3	0	0
23	27677263	.	G	A	23	22	45	0	0	45	0	0
23	27677278	.	G	A	15	16	31	0	4	35	0	0
23	27683248	.	C	A	0	3	3	0	1	4	0	0
23	27683371	.	C	T	0	3	3	0	6	9	0	0
23	27683497	.	C	T	6	4	10	0	1	11	0	0
23	27683629	.	C	T	1	4	5	0	1	6	0	0
23	27683710	.	G	A	1	4	5	0	0	5	0	0
23	27684618	.	T	C	2	0	2	0	3	5	0	0
23	27784281	.	A	T	2	2	4	0	1	5	0	0
23	27785413	.	G	A	3	3	6	0	0	6	0	0
23	27787598	.	T	C	1	2	3	0	0	3	0	0
23	27788665	.	C	T	4	7	11	0	1	12	0	0
23	27788768	.	G	A	8	6	14	0	1	15	0	0
23	27793510	.	T	C	12	5	17	0	0	17	0	0
23	27800681	.	G	T	5	8	13	0	0	13	0	0
23	27801104	.	T	C	13	7	20	0	2	22	0	0
23	27801237	.	T	C	6	13	19	0	2	21	0	0
23	27801268	.	C	A	13	13	26	0	3	29	0	0
23	27801629	.	C	T	8	8	16	0	0	16	0	0
23	27801849	.	G	A	5	6	11	0	0	11	0	0
23	27801880	.	G	T	5	6	11	0	0	11	0	0
23	27805414	.	A	G	4	6	10	0	0	10	0	0
23	27807294	.	A	G	9	11	20	0	0	20	0	0
23	27807523	.	A	G	1	1	2	0	0	2	0	0
23	27835898	.	G	A	6	2	8	0	0	8	0	0
23	27836235	.	C	T	1	4	5	0	6	11	0	0
23	27836245	.	G	A	6	4	10	0	0	10	0	0
23	27966981	.	G	A	2	2	4	0	1	5	0	0
23	27967014	.	T	G	3	3	6	0	0	6	0	0
23	28005087	.	C	T	3	4	7	0	0	7	0	0
23	28005338	.	A	G	2	8	10	0	0	10	0	0
23	28023784	.	T	C	10	11	21	0	0	21	0	0
23	28025586	.	G	A	10	9	19	0	0	19	0	0
23	28025664	.	A	G	1	6	7	0	0	7	0	0
23	28125796	.	C	T	1	6	7	0	0	7	0	0
23	28125841	.	C	T	2	5	7	0	0	7	0	0
23	28125932	.	T	A	1	2	3	0	0	3	0	0
23	28128445	.	T	C	2	0	2	0	0	2	0	0
23	28130983	.	G	A	2	4	6	0	0	6	0	0
23	28130999	.	A	G	1	4	5	0	2	7	0	0
23	28131047	.	T	C	4	5	9	0	0	9	0	0
23	28131083	.	A	G	4	5	9	0	0	9	0	0
23	28131248	.	C	T	4	2	6	0	0	6	0	0
23	28131251	.	C	T	4	2	6	0	0	6	0	0
23	28131285	.	C	T	4	4	8	0	0	8	0	0
23	28131320	.	G	A	5	4	9	0	0	9	0	0
23	28136167	.	G	T	5	1	6	0	0	6	0	0
23	28136471	.	T	G	4	3	7	0	0	7	0	0
23	28136498	.	A	G	3	3	6	0	0	6	0	0
23	28139515	.	C	T	3	4	7	0	0	7	0	0
23	28139564	.	A	G	3	5	8	0	0	8	0	0
23	28139633	.	T	C	3	11	14	0	0	14	0	0
23	28141324	.	G	C	8	5	13	0	0	13	0	0
23	28186060	.	T	A	6	9	15	0	0	15	0	0
23	28186688	.	T	G	2	3	5	0	0	5	0	0
23	28186995	.	T	C	4	0	4	0	7	11	0	0
23	28190648	.	A	G	7	6	13	0	0	13	0	0
23	28200967	.	A	G	3	15	18	0	0	18	0	0
23	28231248	.	G	A	1	4	5	0	0	5	0	0
23	28294259	.	T	A	0	2	2	0	0	2	0	0
23	28294709	.	A	G	1	4	5	0	0	5	0	0
23	28344853	.	C	T	0	4	4	0	1	5	0	0
23	28344855	.	G	A	1	4	5	0	0	5	0	0
23	28374570	.	G	A	17	17	34	0	3	37	0	0
23	28374711	.	C	A	13	14	27	0	3	30	0	0
23	28374756	.	A	G	7	13	20	0	3	23	0	0
23	28377424	.	T	C	3	1	4	0	0	4	0	0
23	28382953	.	C	T	13	8	21	0	1	22	0	0
23	28388013	.	C	A	15	14	29	0	2	31	0	0
23	28388318	.	C	T	19	19	38	0	0	38	0	0
23	28388325	.	T	C	16	17	33	0	2	35	0	0
23	28486050	.	C	A	0	3	3	0	0	3	0	0
23	28486843	.	T	C	0	0	0	0	2	2	0	0
23	28487088	.	C	A	0	8	8	0	7	15	0	0
23	28522491	.	A	G	2	0	2	0	6	8	0	0
23	28527739	.	A	C	1	2	3	0	2	5	0	0
23	28537575	.	G	A	0	4	4	0	2	6	0	0
23	28539108	.	T	C	3	0	3	0	0	3	0	0
23	28539626	.	G	A	3	3	6	0	0	6	0	0
23	28541413	.	A	G	2	4	6	0	0	6	0	0
23	28541416	.	T	C	2	4	6	0	0	6	0	0
23	28541633	.	A	G	2	5	7	0	1	8	0	0
23	28541638	.	C	T	2	7	9	0	0	9	0	0
23	28541683	.	G	T	7	4	11	0	3	14	0	0
23	28546798	.	T	C	4	6	10	0	0	10	0	0
23	28551764	.	A	G	10	0	10	0	9	19	0	0
23	28557288	.	T	G	3	0	3	0	16	19	0	0
23	28557292	.	A	C	1	2	3	0	15	18	0	0
23	28561502	.	C	A	15	16	31	0	1	32	0	0
23	28561836	.	C	T	3	5	8	0	0	8	0	0
23	28564191	.	C	A	13	23	36	0	1	37	0	0
23	28663266	.	G	A	0	2	2	0	0	2	0	0
23	28667294	.	T	C	1	4	5	0	0	5	0	0
23	28674046	.	C	T	2	2	4	0	0	4	0	0
23	28674634	.	T	A	1	0	1	0	0	1	0	0
23	28674890	.	A	C	8	8	16	0	0	16	0	0
23	28679693	.	A	G	2	5	7	0	2	9	0	0
23	28679696	.	C	T	4	5	9	0	0	9	0	0
23	28679753	.	C	T	10	9	19	0	1	20	0	0
23	28680239	.	A	G	2	0	2	0	0	2	0	0
23	28681558	.	G	C	23	24	47	0	2	49	0	0
23	28681559	.	C	A	24	24	48	0	1	49	0	0
23	28681723	.	T	A	19	23	42	0	1	43	0	0
23	28685377	.	A	G	5	1	6	0	0	6	0	0
23	28687561	.	C	T	5	1	6	0	0	6	0	0
23	28687637	.	G	T	6	3	9	0	0	9	0	0
23	28687766	.	C	T	3	2	5	0	0	5	0	0
23	28698340	.	T	C	2	6	8	0	0	8	0	0
23	28704611	.	G	A	5	7	12	0	2	14	0	0
23	28704683	.	G	A	1	0	1	0	0	1	0	0
23	28705908	.	C	T	8	2	10	0	0	10	0	0
23	28707195	.	T	A	3	4	7	0	0	7	0	0
23	28710002	.	A	G	5	2	7	0	0	7	0	0
23	28710429	.	T	C	8	7	15	0	0	15	0	0
23	28712193	.	T	G	1	2	3	0	0	3	0	0
23	28722887	.	G	A	0	1	1	0	0	1	0	0
23	28722917	.	C	T	2	3	5	0	0	5	0	0
23	28723338	.	C	A	1	2	3	0	0	3	0	0
23	28724964	.	A	G	2	3	5	0	1	6	0	0
23	28725644	.	G	A	4	2	6	0	0	6	0	0
23	28725743	.	A	G	6	5	11	0	0	11	0	0
23	28725804	.	G	A	3	6	9	0	0	9	0	0
23	28725830	.	T	C	4	3	7	0	0	7	0	0
23	28725991	.	T	C	3	1	4	0	0	4	0	0
23	28725994	.	G	A	3	0	3	0	0	3	0	0
23	28726026	.	T	C	1	0	1	0	0	1	0	0
23	28726278	.	A	G	2	2	4	0	0	4	0	0
23	28726302	.	T	G	1	3	4	0	1	5	0	0
23	28726521	.	A	G	9	5	14	0	1	15	0	0
23	28726634	.	A	C	5	10	15	0	1	16	0	0
23	28726985	.	A	T	2	3	5	0	0	5	0	0
23	28731489	.	A	C	26	23	49	0	1	50	0	0
23	28731499	.	C	T	27	24	51	0	0	51	0	0
23	28731834	.	C	T	28	35	63	0	1	64	0	0
23	28731914	.	T	C	29	27	56	0	6	62	0	0
23	28732305	.	A	T	1	4	5	0	0	5	0	0
23	28803302	.	T	C	5	6	11	0	1	12	0	0
23	28803305	.	C	T	6	6	12	0	0	12	0	0
23	28806171	.	A	G	1	1	2	0	0	2	0	0
23	28806278	.	A	G	1	4	5	0	0	5	0	0
23	28882508	.	T	C	1	0	1	0	0	1	0	0
23	28922024	.	A	G	2	4	6	0	0	6	0	0
23	28922165	.	C	A	1	2	3	0	0	3	0	0
23	28922300	.	G	A	0	3	3	0	3	6	0	0
23	28923192	.	G	T	2	4	6	0	2	8	0	0
23	28923217	.	T	G	4	0	4	0	6	10	0	0
23	28923378	.	C	T	0	2	2	0	1	3	0	0
23	28923717	.	T	A	1	4	5	0	0	5	0	0
23	28923760	.	T	A	2	4	6	0	0	6	0	0
23	28923962	.	A	G	9	9	18	0	0	18	0	0
23	28924117	.	G	C	5	2	7	1	0	8	0	0
23	28924399	.	C	G	5	6	11	0	0	11	0	0
23	28924672	.	C	T	2	4	6	0	0	6	0	0
23	28924806	.	A	G	3	4	7	0	1	8	0	0
23	28925275	.	T	C	3	5	8	0	1	9	0	0
23	28925354	.	T	C	8	8	16	0	0	16	0	0
23	28925441	.	G	A	3	8	11	0	0	11	0	0
23	28925451	.	A	T	3	7	10	0	0	10	0	0
23	28925620	.	A	G	2	3	5	0	0	5	0	0
23	29358241	.	G	A	0	15	15	0	24	39	0	0
23	29358253	.	C	T	28	12	40	0	0	40	0	0
23	29359664	.	T	A	6	9	15	0	1	16	0	0
23	29360407	.	G	T	0	13	13	0	9	23	1	0
23	29360687	.	G	T	5	4	9	0	0	10	1	0
23	29360707	.	G	T	5	5	10	0	0	10	0	0
23	29361357	.	C	A	18	18	36	0	1	37	0	0
23	29361365	.	A	C	16	17	33	0	1	34	0	0
23	29361557	.	A	T	10	10	20	0	0	20	0	0
23	29376410	.	C	T	7	5	12	0	0	12	0	0
23	29381612	.	C	A	12	9	21	0	0	21	0	0
23	29393787	.	A	G	2	2	4	0	0	4	0	0
23	29393817	.	T	C	1	3	4	0	0	4	0	0
23	29396452	.	C	T	0	28	28	0	25	53	0	0
23	29397116	.	C	G	22	19	41	0	2	43	0	0
23	29397230	.	T	A	27	24	51	0	2	53	0	0
23	29397501	.	C	T	20	21	41	0	5	46	0	0
23	29397506	.	T	G	18	28	46	0	1	47	0	0
23	29397563	.	C	T	1	26	27	0	21	48	0	0
23	29397665	.	T	G	20	24	44	0	0	44	0	0
23	29397816	.	G	A	20	24	44	0	3	47	0	0
23	29397907	.	T	C	25	27	52	0	4	56	0	0
23	29398065	.	T	C	23	28	51	0	4	55	0	0
23	29398544	.	C	A	2	22	24	0	27	51	0	0
23	29398548	.	A	G	27	24	51	0	2	53	0	0
23	29399085	.	T	C	7	0	7	0	3	10	0	0
23	29403306	.	T	G	8	9	17	0	1	18	0	0
23	29403437	.	G	A	7	5	12	0	0	12	0	0
23	29403491	.	C	A	8	7	15	0	1	16	0	0
23	29403515	.	A	C	2	1	3	0	0	3	0	0
23	29405829	.	A	G	25	11	36	0	2	38	0	0
23	29408773	.	A	G	16	24	40	0	1	41	0	0
23	29412411	.	A	G	4	17	21	0	0	21	0	0
23	29415484	.	A	G	10	8	18	0	1	19	0	0
23	29421959	.	C	G	11	13	24	0	0	24	0	0
23	29431995	.	T	C	10	8	18	0	1	19	0	0
23	29432040	.	A	G	12	8	20	0	1	21	0	0
23	29432055	.	G	A	12	10	22	0	0	22	0	0
23	29432867	.	T	G	7	2	9	0	0	9	0	0
23	29433715	.	C	A	11	7	18	0	0	18	0	0
23	29435044	.	T	C	3	2	5	0	0	5	0	0
23	29457909	.	G	A	1	0	1	0	0	1	0	0
23	29457942	.	T	C	5	0	5	0	4	9	0	0
23	29463158	.	A	G	0	3	3	0	0	3	0	0
23	29468959	.	A	G	4	5	9	0	0	9	0	0
23	29468980	.	G	A	5	2	7	0	0	7	0	0
23	29502227	.	C	T	0	1	1	0	5	6	0	0
23	29502302	.	C	T	0	2	2	0	3	5	0	0
23	29502311	.	C	T	2	1	3	0	0	3	0	0
23	29505482	.	C	T	0	3	3	0	2	5	0	0
23	29507723	.	A	T	17	19	36	0	1	37	0	0
23	29507825	.	T	C	14	0	14	0	9	23	0	0
23	29507859	.	T	G	11	7	18	0	0	18	0	0
23	29507883	.	G	A	7	9	16	0	2	18	0	0
23	29508247	.	G	C	9	0	9	0	4	13	0	0
23	29516726	.	T	C	8	7	15	0	0	15	0	0
23	29519565	.	G	A	5	3	8	0	0	8	0	0
23	29520070	.	A	C	3	2	5	0	0	5	0	0
23	29523602	.	G	A	3	4	7	0	0	7	0	0
23	29541251	.	C	T	2	1	3	0	0	3	0	0
23	29541317	.	G	A	0	1	1	0	0	1	0	0
23	29555019	.	T	A	1	2	3	0	0	3	0	0
23	29565835	.	T	C	0	1	1	0	0	1	0	0
23	29567633	.	T	A	1	0	1	0	0	1	0	0
23	29582416	.	T	C	27	32	59	0	3	62	0	0
23	29582420	.	T	C	22	34	56	0	5	61	0	0
23	29582496	.	T	C	30	25	55	0	2	57	0	0
23	29582634	.	C	A	35	33	68	0	3	71	0	0
23	29582673	.	A	G	37	22	59	0	4	63	0	0
23	29583417	.	T	A	28	28	56	0	5	61	0	0
23	29583708	.	G	A	38	27	65	0	1	66	0	0
23	29583814	.	T	A	39	45	84	0	1	85	0	0
23	29583882	.	A	G	34	32	66	0	4	70	0	0
23	29583960	.	G	A	28	31	59	0	5	64	0	0
23	29586380	.	G	A	17	9	26	0	3	29	0	0
23	29589392	.	A	G	20	17	37	0	1	38	0	0
23	29592588	.	T	C	15	1	16	0	17	33	0	0
23	29592708	.	G	A	31	28	59	0	0	59	0	0
23	29592741	.	C	T	20	16	36	0	4	40	0	0
23	29592927	.	T	C	15	0	15	0	11	26	0	0
23	29594441	.	A	G	8	10	18	0	2	20	0	0
23	29601269	.	C	T	12	4	16	0	1	17	0	0
23	29603174	.	T	C	3	2	5	0	0	5	0	0
23	29607011	.	A	G	13	16	29	0	0	29	0	0
23	29607029	.	A	G	11	19	30	0	0	30	0	0
23	29608769	.	A	G	4	5	9	0	0	9	0	0
23	29617571	.	A	C	7	0	7	0	5	12	0	0
23	29667473	.	A	C	1	1	2	0	1	3	0	0
23	29667480	.	G	A	4	1	5	0	0	5	0	0
23	29667614	.	C	G	9	4	13	0	0	13	0	0
23	29711788	.	G	A	12	11	23	0	2	25	0	0
23	29711911	.	C	T	14	16	30	0	0	30	0	0
23	29711998	.	G	A	14	18	32	0	0	32	0	0
23	29712140	.	G	A	11	7	18	0	0	18	0	0
23	29712465	.	G	A	13	8	21	0	1	22	0	0
23	29712493	.	C	T	0	8	8	0	10	18	0	0
23	29712922	.	C	A	12	12	24	0	0	24	0	0
23	29756865	.	A	T	11	5	16	0	2	18	0	0
23	29757099	.	A	T	6	4	10	0	1	11	0	0
23	29757980	.	T	C	8	0	8	0	5	13	0	0
23	29758030	.	C	T	0	10	10	0	6	16	0	0
23	29758088	.	A	G	9	14	23	0	0	23	0	0
23	29764120	.	T	C	4	1	5	0	0	5	0	0
23	29812595	.	G	C	2	5	7	0	1	8	0	0
23	29812663	.	A	T	4	5	9	0	0	9	0	0
23	29829115	.	A	G	0	1	1	0	1	2	0	0
23	29829160	.	A	T	1	2	3	0	0	3	0	0
23	29829186	.	A	C	0	1	1	0	0	1	0	0
23	29840178	.	A	G	0	1	1	0	0	1	0	0
23	29840274	.	C	A	8	5	13	0	0	13	0	0
23	29841374	.	T	C	6	6	12	0	0	12	0	0
23	29842966	.	C	T	2	5	7	0	0	7	0	0
23	29842967	.	T	G	2	5	7	0	0	7	0	0
23	29843067	.	A	T	1	2	3	0	1	4	0	0
23	29843104	.	T	C	1	2	3	0	1	4	0	0
23	29843847	.	A	C	1	2	3	0	0	3	0	0
23	29843863	.	T	C	1	0	1	0	2	3	0	0
23	29854359	.	G	A	1	0	1	0	0	1	0	0
23	29854362	.	C	T	0	0	0	0	1	1	0	0
23	29857920	.	A	T	2	1	3	0	0	3	0	0
23	29857967	.	T	A	5	4	9	0	0	9	0	0
23	29861645	.	A	T	6	7	13	0	0	13	0	0
23	29861973	.	A	G	21	21	42	0	0	43	1	0
23	29861976	.	T	C	21	0	21	0	20	41	0	0
23	29867576	.	G	A	1	3	4	0	0	4	0	0
23	29872254	.	A	G	5	5	10	0	1	11	0	0
23	29886897	.	G	C	14	16	30	0	1	31	0	0
23	29886937	.	T	A	17	16	33	0	2	35	0	0
23	29966518	.	A	T	2	2	4	0	0	4	0	0
23	29979467	.	T	C	3	0	3	0	0	3	0	0
23	29992023	.	G	C	3	6	9	0	0	9	0	0
23	30061605	.	A	C	22	9	31	0	4	35	0	0
23	30061763	.	C	T	1	33	34	0	23	57	0	0
23	30061804	.	A	C	27	22	49	0	0	49	0	0
23	30061960	.	T	C	33	2	35	0	20	55	0	0
23	30062364	.	T	A	21	14	35	0	3	38	0	0
23	30062792	.	C	T	10	10	20	0	3	23	0	0
23	30062888	.	C	T	0	18	18	0	21	39	0	0
23	30063216	.	T	C	16	0	16	0	14	30	0	0
23	30063217	.	T	G	15	14	29	0	1	30	0	0
23	30063527	.	G	A	8	9	17	0	2	19	0	0
23	30063578	.	A	G	11	7	18	0	0	18	0	0
23	30063643	.	C	T	9	9	18	0	1	19	0	0
23	30063722	.	G	A	11	8	19	0	0	19	0	0
23	30064289	.	T	C	4	13	17	0	0	17	0	0
23	30064579	.	A	G	14	14	28	0	1	29	0	0
23	30064743	.	C	A	13	18	31	0	0	31	0	0
23	30064804	.	A	G	11	18	29	0	1	30	0	0
23	30064853	.	A	G	15	13	28	0	1	29	0	0
23	30065144	.	G	A	6	9	15	0	1	16	0	0
23	30065641	.	T	G	2	2	4	0	1	5	0	0
23	30071637	.	G	A	1	1	2	0	0	2	0	0
23	30075201	.	G	A	9	4	13	0	3	16	0	0
23	30075367	.	A	T	0	1	1	0	0	1	0	0
23	30077023	.	T	C	6	0	6	0	10	16	0	0
23	30085812	.	A	T	2	1	3	0	0	3	0	0
23	30124048	.	A	C	3	0	3	0	3	6	0	0
23	30124303	.	C	T	0	7	7	0	7	14	0	0
23	30124430	.	C	G	4	3	7	0	0	7	0	0
23	30124651	.	A	G	5	7	12	0	0	12	0	0
23	30124818	.	C	T	3	5	8	0	0	8	0	0
23	30124960	.	G	A	3	2	5	0	0	5	0	0
23	30124998	.	T	C	2	4	6	0	2	8	0	0
23	30125004	.	G	A	4	4	8	0	0	8	0	0
23	30125206	.	A	G	6	5	11	0	0	11	0	0
23	30125599	.	G	A	3	5	8	0	1	9	0	0
23	30715328	.	T	C	4	1	5	0	1	6	0	0
23	30715397	.	G	A	0	3	3	0	0	3	0	0
23	30715991	.	A	G	1	0	1	0	0	1	0	0
23	30716096	.	C	T	2	5	7	0	0	7	0	0
23	30718514	.	T	A	3	1	4	0	0	4	0	0
23	30724230	.	C	A	6	5	11	0	0	11	0	0
23	30724698	.	T	A	2	8	10	0	1	11	0	0
23	30724828	.	G	C	1	5	6	0	0	6	0	0
23	30750183	.	G	A	0	10	10	0	14	24	0	0
23	30750402	.	C	A	5	13	18	0	2	20	0	0
23	30752095	.	C	A	14	12	26	0	1	27	0	0
23	30752233	.	T	G	5	5	10	0	0	10	0	0
23	30752352	.	A	T	6	9	15	0	1	16	0	0
23	30761144	.	G	A	3	3	6	0	0	6	0	0
23	30764212	.	T	C	9	13	22	0	0	22	0	0
23	30770193	.	A	G	6	5	11	0	2	13	0	0
23	30772902	.	C	T	3	5	8	0	0	8	0	0
23	30775273	.	T	C	4	6	10	0	0	10	0	0
23	30778499	.	G	A	5	11	16	0	0	16	0	0
23	30890018	.	G	T	3	3	6	0	0	6	0	0
23	30890191	.	T	G	1	3	4	0	1	5	0	0
23	30890701	.	T	A	4	2	6	0	0	6	0	0
23	30890839	.	C	T	2	4	6	0	0	6	0	0
23	30898132	.	C	T	2	5	7	0	0	7	0	0
23	30898150	.	T	C	2	6	8	0	0	8	0	0
23	30898467	.	G	C	0	2	2	0	3	5	0	0
23	30898503	.	A	T	2	1	3	0	0	3	0	0
23	30918919	.	A	G	4	3	7	0	0	7	0	0
23	30918933	.	T	C	2	2	4	0	1	5	0	0
23	30918998	.	A	G	4	2	6	0	0	6	0	0
23	30919027	.	T	G	4	4	8	0	1	9	0	0
23	30940412	.	A	T	1	0	1	0	0	1	0	0
23	30996626	.	G	A	1	2	3	0	0	3	0	0
23	31245593	.	A	T	5	2	7	0	0	7	0	0
23	31248605	.	A	T	1	6	7	0	1	8	0	0
23	31248779	.	T	C	2	4	6	0	0	6	0	0
23	31276453	.	G	A	9	5	14	0	0	14	0	0
23	31276509	.	C	T	2	4	6	0	0	6	0	0
23	31276657	.	T	C	8	3	11	0	0	11	0	0
23	31278237	.	C	T	0	2	2	0	4	6	0	0
23	31278322	.	A	G	2	6	8	0	1	9	0	0
23	31278375	.	A	G	4	5	9	0	0	9	0	0
23	31278417	.	G	T	6	2	8	0	0	8	0	0
23	31278450	.	T	A	4	2	6	0	0	6	0	0
23	31278792	.	G	T	4	3	7	0	0	7	0	0
23	31279122	.	G	T	1	1	2	0	0	2	0	0
23	31281768	.	T	G	1	0	1	0	0	1	0	0
23	31358342	.	A	T	19	17	36	0	1	37	0	0
23	31358344	.	A	T	20	17	37	0	0	37	0	0
23	31358489	.	T	G	27	18	45	0	0	45	0	0
23	31358631	.	G	A	29	22	51	0	3	54	0	0
23	31381068	.	C	T	5	6	11	0	0	11	0	0
23	31381335	.	A	G	4	2	6	0	0	6	0	0
23	31381389	.	T	C	1	3	4	0	0	4	0	0
23	31381392	.	C	T	1	4	5	0	0	5	0	0
23	31381425	.	C	T	4	4	8	0	1	9	0	0
23	31388310	.	G	A	2	1	3	0	0	3	0	0
23	31405519	.	C	T	5	3	8	0	0	8	0	0
23	31405570	.	A	C	7	11	18	0	0	18	0	0
23	31419064	.	C	T	3	2	5	0	1	6	0	0
23	31419172	.	A	T	5	3	8	0	0	8	0	0
23	31422369	.	A	T	3	7	10	0	0	10	0	0
23	31422429	.	C	T	7	2	9	0	0	9	0	0
23	31422577	.	A	G	3	4	7	0	0	7	0	0
23	31422600	.	C	T	5	1	6	0	1	7	0	0
23	31422768	.	A	G	3	8	11	0	0	11	0	0
23	31423091	.	T	C	7	3	10	0	1	11	0	0
23	31423145	.	G	A	0	7	7	0	7	14	0	0
23	31423392	.	C	A	17	11	28	0	0	29	1	0
23	31423427	.	A	G	13	0	13	0	15	28	0	0
23	31423432	.	C	A	12	14	26	0	1	27	0	0
23	31432102	.	A	G	5	1	6	0	15	21	0	0
23	31440119	.	T	A	3	4	7	0	0	7	0	0
23	31597571	.	T	C	6	6	12	0	0	12	0	0
23	31604900	.	C	T	7	4	11	0	0	11	0	0
23	31604912	.	G	T	5	4	9	0	0	9	0	0
23	31640363	.	A	G	5	2	7	0	0	7	0	0
23	31641153	.	C	A	24	21	45	0	3	48	0	0
23	31641197	.	A	G	19	26	45	0	2	47	0	0
23	31641270	.	G	A	18	21	39	0	3	42	0	0
23	31643818	.	A	G	5	18	23	0	3	26	0	0
23	31644368	.	A	G	14	8	22	0	1	23	0	0
23	31644419	.	A	G	6	6	12	0	0	12	0	0
23	31644602	.	T	G	11	10	21	0	1	22	0	0
23	31684244	.	A	G	1	2	3	0	0	3	0	0
23	31684352	.	G	A	11	10	21	0	0	21	0	0
23	31768596	.	T	C	10	7	17	0	1	18	0	0
23	31771282	.	T	C	2	1	3	0	2	5	0	0
23	31774194	.	G	A	2	2	4	0	0	4	0	0
23	31782969	.	T	C	1	1	2	0	1	3	0	0
23	31787127	.	C	G	0	1	1	0	0	1	0	0
23	31804162	.	A	G	2	1	3	0	0	3	0	0
23	31933739	.	T	G	3	3	6	0	0	6	0	0
23	31940711	.	T	A	5	2	7	0	0	7	0	0
23	31953228	.	A	T	2	2	4	0	0	4	0	0
23	31962971	.	T	C	5	8	13	0	0	13	0	0
23	31963226	.	C	T	3	9	12	0	0	12	0	0
23	31963360	.	A	G	1	1	2	0	0	2	0	0
23	31964680	.	C	T	1	3	4	0	1	6	1	0
23	31981951	.	A	C	1	2	3	0	0	3	0	0
23	31981972	.	A	G	2	2	4	0	0	4	0	0
23	31986705	.	T	G	1	0	1	0	2	3	0	0
23	31992522	.	T	C	1	4	5	0	0	5	0	0
23	31992537	.	C	T	1	6	7	0	0	7	0	0
23	31992690	.	C	T	0	1	1	0	1	2	0	0
23	31993590	.	C	T	1	1	2	0	0	2	0	0
23	31997582	.	G	A	3	7	10	0	0	10	0	0
23	31998162	.	T	C	1	0	1	0	0	1	0	0
23	31998741	.	A	G	1	0	1	0	1	2	0	0
23	32003354	.	T	A	4	9	13	0	0	13	0	0
23	32003808	.	T	C	3	3	6	0	1	7	0	0
23	32003820	.	G	T	4	2	6	0	0	6	0	0
23	32007376	.	T	G	9	5	14	0	0	14	0	0
23	32007445	.	T	A	9	5	14	0	1	15	0	0
23	32007520	.	T	C	8	5	13	0	0	13	0	0
23	32007526	.	C	G	7	5	12	0	1	13	0	0
23	32026927	.	T	C	2	3	5	0	0	5	0	0
23	32026978	.	C	T	3	5	8	0	0	8	0	0
23	32026996	.	G	A	0	1	1	0	2	3	0	0
23	32081708	.	C	T	4	6	10	0	0	10	0	0
23	32081717	.	T	C	4	6	10	0	0	10	0	0
23	32085908	.	G	T	4	3	7	0	0	7	0	0
23	32128848	.	A	T	3	2	5	0	0	5	0	0
23	32128893	.	T	C	2	4	6	0	0	6	0	0
23	32129326	.	C	A	5	2	7	0	0	7	0	0
23	32129476	.	G	T	3	2	5	0	0	5	0	0
23	32151669	.	A	C	14	17	31	0	0	31	0	0
23	32152022	.	C	T	22	15	37	0	0	37	0	0
23	32154021	.	G	T	4	4	8	0	0	8	0	0
23	32155325	.	A	G	4	1	5	0	1	6	0	0
23	32155719	.	C	T	5	6	11	0	1	12	0	0
23	32155720	.	C	T	0	6	6	0	6	12	0	0
23	32155864	.	A	C	2	0	2	0	5	7	0	0
23	32155975	.	C	T	2	3	5	0	0	5	0	0
23	32157787	.	G	T	1	0	1	0	1	2	0	0
23	32200071	.	A	G	4	3	7	0	0	7	0	0
23	32200076	.	T	G	2	3	5	0	0	5	0	0
23	32200114	.	A	C	1	3	4	0	0	4	0	0
23	32200410	.	A	G	1	4	5	0	0	5	0	0
23	32200482	.	T	C	3	4	7	0	0	7	0	0
23	32200517	.	C	A	1	4	5	0	0	5	0	0
23	32200689	.	G	A	2	3	5	0	0	5	0	0
23	32200979	.	A	G	7	3	10	0	0	10	0	0
23	32201087	.	G	T	2	2	4	0	1	5	0	0
23	32235977	.	C	A	2	2	4	0	0	4	0	0
23	32236040	.	T	A	2	2	4	0	0	4	0	0
23	32239474	.	A	G	4	2	6	0	0	6	0	0
23	32239672	.	G	A	12	9	21	0	1	22	0	0
23	32239688	.	C	A	12	8	20	0	0	20	0	0
23	32239708	.	G	A	13	11	24	0	0	24	0	0
23	32239824	.	G	A	15	11	26	0	0	26	0	0
23	32240258	.	C	T	7	4	11	0	0	11	0	0
23	32240290	.	A	G	6	4	10	0	0	10	0	0
23	32242086	.	C	A	4	2	6	0	1	7	0	0
23	32242251	.	T	C	6	8	14	0	0	14	0	0
23	32248595	.	C	G	1	0	1	0	0	1	0	0
23	32251473	.	T	G	0	1	1	0	0	1	0	0
23	32309187	.	T	C	17	11	28	0	2	30	0	0
23	32309193	.	G	A	18	12	30	0	0	30	0	0
23	32309323	.	G	A	20	21	41	0	1	42	0	0
23	32309533	.	A	G	13	8	21	0	0	21	0	0
23	32309659	.	C	A	1	9	10	0	10	20	0	0
23	32309709	.	G	A	9	8	17	0	0	17	0	0
23	32309787	.	A	C	11	10	21	0	0	21	0	0
23	32309846	.	T	A	4	2	6	0	1	7	0	0
23	32309943	.	A	G	6	4	10	0	1	11	0	0
23	32310209	.	C	T	5	4	9	0	1	10	0	0
23	32310254	.	T	A	4	4	8	0	1	9	0	0
23	32310808	.	C	T	6	2	8	0	1	9	0	0
23	32310864	.	G	A	6	7	13	0	0	13	0	0
23	32311418	.	T	C	11	12	23	0	0	23	0	0
23	32311555	.	G	C	19	19	38	0	1	39	0	0
23	32311612	.	G	A	21	14	35	0	0	35	0	0
23	32318047	.	A	G	12	15	27	0	0	27	0	0
23	32326532	.	A	G	7	3	10	0	1	11	0	0
23	32589398	.	C	T	2	2	4	0	0	4	0	0
23	32592593	.	C	T	0	3	3	0	8	11	0	0
23	32592608	.	A	C	3	2	5	0	2	7	0	0
23	32599214	.	G	T	2	1	3	0	0	3	0	0
23	32621780	.	C	T	0	3	3	0	0	3	0	0
23	32621792	.	G	A	0	2	2	0	0	2	0	0
23	32636209	.	T	C	3	1	4	0	0	4	0	0
23	32892403	.	G	T	1	2	3	0	0	3	0	0
23	33357953	.	T	A	6	4	10	0	1	12	1	0
23	33361310	.	C	T	6	6	12	0	0	12	0	0
23	33449656	.	G	T	1	3	4	0	0	4	0	0
23	33657205	.	A	G	14	20	34	0	1	35	0	0
23	33657451	.	A	G	14	12	26	0	0	26	0	0
23	33658013	.	T	G	8	4	12	0	0	12	0	0
23	33658031	.	A	C	8	5	13	0	0	13	0	0
23	33658052	.	G	A	3	9	12	0	0	12	0	0
23	33663285	.	C	T	2	4	6	0	0	6	0	0
23	33664546	.	C	T	6	7	13	0	2	15	0	0
23	33728877	.	T	A	3	40	43	0	1	45	1	0
23	34559897	.	C	T	1	3	4	0	0	4	0	0
23	34641484	.	C	T	2	1	3	0	0	3	0	0
23	34659533	.	C	T	0	3	3	0	0	3	0	0
23	34678957	.	G	T	0	1	1	0	2	3	0	0
23	34679008	.	A	G	5	2	7	0	0	7	0	0
23	34696631	.	C	T	2	2	4	0	0	4	0	0
23	34726384	.	A	G	3	0	3	0	4	7	0	0
23	34726387	.	A	G	3	4	7	0	1	8	0	0
23	34726438	.	T	C	6	8	14	0	0	14	0	0
23	34726444	.	G	T	6	8	14	0	0	14	0	0
23	34732871	.	A	G	2	0	2	0	2	4	0	0
23	34748833	.	G	A	0	10	10	0	5	15	0	0
23	34753803	.	A	G	13	14	27	0	0	27	0	0
23	35027480	.	T	G	3	2	5	0	1	6	0	0
23	35039803	.	C	T	2	5	7	0	0	7	0	0
23	35187936	.	C	G	0	3	3	0	1	4	0	0
23	35188009	.	G	C	1	0	1	0	2	3	0	0
23	35188012	.	T	C	1	2	3	0	0	3	0	0
23	35256186	.	G	A	2	4	6	0	0	6	0	0
23	35362951	.	C	T	5	11	16	0	0	16	0	0
23	35362973	.	G	T	5	10	15	0	0	15	0	0
23	35363024	.	A	T	6	10	16	0	2	18	0	0
23	35363067	.	A	T	5	7	12	0	3	15	0	0
23	35363106	.	G	A	9	16	25	0	1	26	0	0
23	35363111	.	C	G	8	20	28	0	1	29	0	0
23	35363226	.	T	C	15	0	15	0	21	36	0	0
23	35363341	.	A	G	19	12	31	0	1	32	0	0
23	35369733	.	G	A	4	4	8	0	0	8	0	0
23	35386349	.	A	G	2	2	4	0	0	4	0	0
23	35386394	.	C	T	0	4	4	0	1	5	0	0
23	35386415	.	G	A	1	3	4	0	0	4	0	0
23	35386436	.	T	C	1	2	3	0	0	3	0	0
23	35393459	.	A	G	0	2	2	0	0	2	0	0
23	35393473	.	G	T	0	1	1	0	0	1	0	0
23	35396735	.	C	A	5	3	8	0	0	8	0	0
23	35396791	.	C	A	4	6	10	0	0	10	0	0
23	35469006	.	T	A	2	4	6	0	0	6	0	0
23	35469135	.	T	C	2	5	7	0	0	7	0	0
23	35469136	.	G	A	2	5	7	0	0	7	0	0
23	35469479	.	A	G	11	4	15	0	0	15	0	0
23	35469668	.	G	T	13	10	23	0	0	23	0	0
23	35473640	.	A	G	4	4	8	0	0	8	0	0
23	35537474	.	G	A	8	9	17	0	2	19	0	0
23	35537482	.	C	T	12	9	21	0	0	21	0	0
23	35537599	.	G	A	8	7	15	0	1	16	0	0
23	35537617	.	G	A	7	6	13	0	0	13	0	0
23	35537693	.	A	C	1	7	8	0	0	8	0	0
23	35642195	.	C	T	5	2	7	0	0	7	0	0
23	35642327	.	T	G	6	9	15	0	1	16	0	0
23	35644234	.	C	T	0	1	1	0	0	1	0	0
23	35661380	.	C	T	2	2	4	0	0	4	0	0
23	35661549	.	A	C	2	2	4	0	0	4	0	0
23	35661692	.	C	A	3	3	6	0	1	7	0	0
23	35664298	.	A	G	4	2	6	0	1	7	0	0
23	35709839	.	T	C	24	11	35	0	2	37	0	0
23	35710620	.	A	C	30	23	53	0	1	54	0	0
23	35771483	.	T	C	4	4	8	0	0	8	0	0
23	35771486	.	T	C	3	4	7	0	0	7	0	0
23	35782311	.	T	C	6	6	12	0	0	12	0	0
23	35787110	.	T	A	3	4	7	0	0	7	0	0
23	35787299	.	A	C	3	4	7	0	1	8	0	0
23	35787331	.	T	G	2	8	10	0	0	10	0	0
23	35787449	.	A	G	3	3	6	0	0	6	0	0
23	35787573	.	A	G	6	5	11	0	0	11	0	0
23	35787841	.	G	T	1	5	6	0	1	7	0	0
23	35788256	.	G	A	5	4	9	0	0	9	0	0
23	35788328	.	G	A	2	9	11	0	1	12	0	0
23	35788505	.	C	T	3	2	5	0	0	5	0	0
23	35788513	.	G	A	3	3	6	0	0	6	0	0
23	35788775	.	G	A	4	6	10	0	0	10	0	0
23	35798545	.	G	A	2	3	5	0	1	6	0	0
23	35800550	.	C	T	1	7	8	0	10	18	0	0
23	35800591	.	C	T	7	9	16	0	0	16	0	0
23	35821442	.	T	A	1	3	4	0	0	4	0	0
23	35918697	.	A	T	4	5	9	0	0	9	0	0
23	35918795	.	G	A	4	4	8	0	0	8	0	0
23	35960683	.	G	A	1	2	3	0	1	4	0	0
23	35963076	.	G	T	0	1	1	0	2	3	0	0
23	35963176	.	T	G	12	9	21	0	1	22	0	0
23	35963718	.	C	A	0	4	4	0	0	4	0	0
23	35982441	.	A	G	13	10	23	0	1	24	0	0
23	35982533	.	G	A	12	7	19	0	1	20	0	0
23	35982637	.	G	A	8	8	16	0	0	16	0	0
23	35982726	.	C	G	5	4	9	1	1	11	0	0
23	35982755	.	T	C	5	4	9	0	1	10	0	0
23	35983029	.	A	G	12	8	20	0	1	21	0	0
23	35993540	.	T	A	3	6	9	0	0	9	0	0
23	36000704	.	T	C	1	0	1	0	1	2	0	0
23	36132338	.	C	A	8	8	16	0	0	16	0	0
23	36297367	.	C	T	1	2	3	0	2	5	0	0
23	36297471	.	C	T	9	11	20	0	1	21	0	0
23	36297916	.	C	T	7	7	14	0	1	15	0	0
23	36298320	.	T	A	16	14	30	0	1	31	0	0
23	36298327	.	A	T	13	17	30	0	1	31	0	0
23	36298375	.	T	C	13	23	36	0	1	37	0	0
23	36298719	.	G	A	20	14	34	0	2	36	0	0
23	36301544	.	G	A	16	12	28	0	0	28	0	0
23	36301679	.	A	G	14	17	31	0	1	32	0	0
23	36303266	.	G	C	1	3	4	0	0	4	0	0
23	36306566	.	G	T	1	0	1	0	1	2	0	0
23	36307656	.	A	T	18	18	36	0	2	38	0	0
23	36307779	.	C	T	3	1	4	0	0	4	0	0
23	36307906	.	C	G	1	2	3	0	0	3	0	0
23	36310375	.	C	T	1	3	4	0	0	4	0	0
23	36343467	.	T	C	4	6	10	0	0	10	0	0
23	36353698	.	A	G	12	17	29	0	1	30	0	0
23	36353869	.	C	G	9	14	23	0	1	24	0	0
23	36353876	.	G	T	0	6	6	0	15	21	0	0
23	36353979	.	G	T	0	8	8	0	15	23	0	0
23	36401591	.	T	C	2	2	4	0	0	4	0	0
23	36401624	.	T	A	1	2	3	0	0	3	0	0
23	36401632	.	C	T	1	2	3	0	0	3	0	0
23	36401818	.	T	C	3	0	3	0	1	4	0	0
23	36401844	.	A	G	5	6	11	0	0	11	0	0
23	36401926	.	T	C	4	4	8	0	1	9	0	0
23	36401930	.	A	G	4	4	8	0	0	8	0	0
23	36401986	.	G	C	4	4	8	0	0	8	0	0
23	36402184	.	A	G	3	2	5	0	0	5	0	0
23	36402256	.	A	C	2	5	7	0	0	7	0	0
23	36402274	.	T	C	1	6	7	0	0	7	0	0
23	36404967	.	A	G	1	3	4	0	0	4	0	0
23	36405429	.	A	G	1	1	2	0	0	2	0	0
23	36443511	.	A	T	12	9	21	0	0	21	0	0
23	36443813	.	C	T	3	3	6	0	0	6	0	0
23	36443865	.	C	A	6	9	15	0	0	15	0	0
23	36444201	.	G	C	6	0	6	0	14	20	0	0
23	36445967	.	C	G	3	2	5	0	0	5	0	0
23	36446023	.	G	A	6	6	12	0	1	13	0	0
23	36446132	.	A	G	8	5	13	0	0	13	0	0
23	36446190	.	A	T	8	7	15	0	0	15	0	0
23	36446258	.	T	C	1	0	1	0	5	6	0	0
23	36487925	.	A	T	3	2	5	0	0	5	0	0
23	36488378	.	G	C	0	6	6	0	0	6	0	0
23	36491169	.	C	G	0	7	7	0	7	14	0	0
23	36538298	.	G	A	5	2	7	0	0	7	0	0
23	36604488	.	G	A	1	1	2	0	1	3	0	0
23	36616998	.	C	T	2	4	6	0	0	6	0	0
23	36627793	.	C	T	11	17	28	0	0	28	0	0
23	36638542	.	G	A	6	10	16	0	1	17	0	0
23	36644423	.	T	G	25	21	46	0	0	46	0	0
23	36644907	.	C	T	12	19	31	0	2	33	0	0
23	36662273	.	G	A	3	6	9	0	1	10	0	0
23	36662327	.	T	A	4	3	7	0	1	8	0	0
23	36662400	.	A	G	3	2	5	0	0	5	0	0
23	36662651	.	G	C	3	5	8	0	0	8	0	0
23	36662685	.	C	A	1	3	4	0	0	4	0	0
23	36662714	.	G	A	1	1	2	0	1	3	0	0
23	36663407	.	G	A	3	3	6	0	0	6	0	0
23	36663506	.	C	A	1	4	5	0	4	9	0	0
23	36663512	.	C	T	0	4	4	0	5	9	0	0
23	36663953	.	T	G	1	2	3	0	0	3	0	0
23	36679751	.	C	T	19	22	41	0	1	42	0	0
23	36679829	.	G	C	18	1	19	0	23	42	0	0
23	36679874	.	T	C	14	0	14	0	9	23	0	0
23	36681545	.	C	T	0	3	3	0	4	7	0	0
23	36681557	.	A	G	6	8	14	0	0	14	0	0
23	36681927	.	T	C	2	1	3	0	0	3	0	0
23	36683801	.	G	A	7	7	14	0	0	14	0	0
23	36688236	.	T	C	10	1	11	0	13	24	0	0
23	36689677	.	C	T	8	4	12	0	1	13	0	0
23	36690595	.	G	A	6	12	18	0	3	21	0	0
23	36690641	.	T	A	13	15	28	0	3	31	0	0
23	36700836	.	T	G	7	0	7	0	0	7	0	0
23	36700891	.	G	A	10	15	25	0	1	26	0	0
23	36700896	.	T	A	10	12	22	0	2	24	0	0
23	36730854	.	A	T	2	1	3	0	0	3	0	0
23	36738776	.	C	T	0	2	2	0	1	3	0	0
23	36749380	.	G	A	2	20	22	0	25	47	0	0
23	36750005	.	C	G	15	20	35	0	1	36	0	0
23	36753191	.	A	G	2	1	3	0	4	7	0	0
23	36772018	.	G	A	0	11	11	0	18	29	0	0
23	36798184	.	C	T	13	11	24	0	1	25	0	0
23	36798220	.	G	A	17	14	31	0	1	32	0	0
23	36798612	.	G	A	1	10	11	0	12	23	0	0
23	36816840	.	C	T	0	1	1	0	0	1	0	0
23	36845696	.	A	G	2	3	5	0	0	5	0	0
23	36895095	.	C	A	1	1	2	0	0	2	0	0
23	36895096	.	G	A	0	1	1	0	1	2	0	0
23	36907690	.	A	G	1	0	1	0	0	1	0	0
23	36914223	.	A	G	0	2	2	0	0	2	0	0
23	36920063	.	C	T	0	4	4	0	1	5	0	0
23	37062365	.	C	T	1	2	3	0	0	3	0	0
23	37065182	.	G	A	1	1	2	0	0	2	0	0
23	37077689	.	A	C	0	2	2	0	0	2	0	0
23	37086288	.	A	C	5	6	11	0	0	11	0	0
23	37086317	.	G	T	5	5	10	0	0	10	0	0
23	37086368	.	G	A	8	5	13	0	0	13	0	0
23	37089042	.	G	A	5	5	10	0	1	11	0	0
23	37089102	.	G	A	7	3	10	0	1	11	0	0
23	37089162	.	C	T	11	5	16	0	0	16	0	0
23	37089192	.	C	T	12	6	18	0	0	18	0	0
23	37089333	.	C	T	4	7	11	0	0	11	0	0
23	37089568	.	C	T	9	8	17	0	0	17	0	0
23	37089609	.	T	G	8	12	20	0	0	20	0	0
23	37089852	.	A	T	11	4	15	0	1	16	0	0
23	37090003	.	T	C	2	8	10	0	1	11	0	0
23	37187430	.	G	A	3	2	5	0	0	5	0	0
23	37277157	.	A	G	13	15	28	0	1	29	0	0
23	37277289	.	G	A	1	2	3	0	0	3	0	0
23	37280658	.	C	T	8	1	9	0	0	9	0	0
23	37288406	.	A	G	3	2	5	0	0	5	0	0
23	37324009	.	A	G	13	1	14	0	13	27	0	0
23	37324638	.	A	C	18	19	37	0	0	37	0	0
23	37324848	.	G	A	15	13	28	0	2	30	0	0
23	37324868	.	G	C	15	7	22	0	1	23	0	0
23	37324990	.	A	G	20	24	44	0	0	44	0	0
23	37325026	.	C	T	27	20	47	0	0	47	0	0
23	37325138	.	T	G	20	0	20	1	24	45	0	0
23	37325570	.	A	C	23	17	40	0	2	42	0	0
23	37325817	.	T	G	10	18	28	0	0	28	0	0
23	37458666	.	G	T	0	3	3	0	1	4	0	0
23	37458748	.	G	A	3	7	10	0	0	10	0	0
23	37458791	.	A	T	0	1	1	0	0	1	0	0
23	37464452	.	A	G	7	1	8	0	1	9	0	0
23	37464621	.	A	G	3	1	4	0	1	5	0	0
23	37464661	.	T	A	5	1	6	1	1	8	0	0
23	37464760	.	G	C	1	5	6	0	6	12	0	0
23	37464804	.	C	A	5	4	9	0	0	9	0	0
23	37465007	.	T	C	7	4	11	0	0	11	0	0
23	37465257	.	A	G	7	0	7	0	3	10	0	0
23	37465276	.	A	T	6	4	10	0	0	10	0	0
23	37465332	.	A	T	11	4	15	0	0	15	0	0
23	37465414	.	G	A	8	7	15	0	1	16	0	0
23	37465479	.	G	C	13	7	20	0	0	20	0	0
23	37465505	.	A	G	14	7	21	0	0	21	0	0
23	37465887	.	G	A	0	2	2	0	7	9	0	0
23	37467056	.	A	G	5	0	5	0	3	8	0	0
23	37467073	.	A	G	4	2	6	0	0	6	0	0
23	37468225	.	T	C	0	1	1	0	0	1	0	0
23	37468267	.	C	T	1	2	3	0	0	4	1	0
23	37468393	.	A	G	1	8	9	0	1	10	0	0
23	37476475	.	T	C	0	1	1	0	0	1	0	0
23	37476675	.	G	A	1	3	4	0	2	6	0	0
23	37478227	.	G	T	0	3	3	0	0	3	0	0
23	37478506	.	C	G	8	5	13	0	1	14	0	0
23	37503288	.	A	G	0	1	1	0	0	1	0	0
23	37504900	.	A	G	2	2	4	0	0	4	0	0
23	37823651	.	T	A	5	2	7	0	0	7	0	0
23	37823704	.	A	G	3	2	5	0	0	5	0	0
23	37823710	.	T	C	3	3	6	0	0	6	0	0
23	37823795	.	T	C	5	3	8	0	0	8	0	0
23	37828884	.	A	G	3	1	4	0	0	4	0	0
23	37955054	.	C	G	1	2	3	0	0	3	0	0
23	37955083	.	C	T	2	3	5	0	0	5	0	0
23	38151520	.	C	T	8	12	20	0	0	20	0	0
23	38257428	.	A	G	1	0	1	0	3	4	0	0
23	38379786	.	C	T	0	18	18	0	9	27	0	0
23	38380005	.	C	T	13	17	30	0	2	32	0	0
23	38380047	.	G	A	16	17	33	0	0	33	0	0
23	38381217	.	C	T	0	6	6	0	10	16	0	0
23	38381281	.	T	C	7	6	13	0	0	13	0	0
23	38381316	.	T	C	10	0	10	0	8	18	0	0
23	38381490	.	G	A	7	5	12	0	1	13	0	0
23	38816824	.	T	C	2	5	7	0	0	7	0	0
23	38816827	.	T	C	2	5	7	0	0	7	0	0
23	38817509	.	T	C	2	4	6	0	1	7	0	0
23	38817745	.	G	A	1	2	3	0	0	3	0	0
23	38817922	.	T	A	2	4	6	0	0	6	0	0
23	38818001	.	G	A	3	3	6	0	0	6	0	0
23	38818004	.	G	A	3	4	7	0	0	7	0	0
23	38818234	.	A	G	3	0	3	0	4	7	0	0
23	38818249	.	G	T	5	4	9	0	0	9	0	0
23	38818351	.	A	G	2	3	5	0	0	5	0	0
23	38944817	.	C	T	1	3	4	0	0	4	0	0
23	38948090	.	C	T	2	3	5	0	0	5	0	0
23	39006514	.	T	A	1	1	2	0	0	2	0	0
23	39332006	.	T	C	3	4	7	0	0	7	0	0
23	39332007	.	G	A	2	4	6	0	1	7	0	0
23	39433818	.	C	T	1	3	4	0	0	4	0	0
23	39445059	.	A	G	2	0	2	0	0	2	0	0
23	39448012	.	A	G	0	0	0	0	1	1	0	0
23	39449770	.	C	G	1	2	3	0	0	3	0	0
23	39450022	.	A	G	2	6	8	0	0	8	0	0
23	39516525	.	T	C	2	2	4	0	0	4	0	0
23	39516528	.	T	C	2	2	4	0	0	4	0	0
23	39516810	.	T	A	2	4	6	0	1	7	0	0
23	39516879	.	C	T	0	1	1	0	0	1	0	0
23	39587284	.	G	C	2	2	4	0	0	4	0	0
23	39587323	.	A	G	2	0	2	0	2	4	0	0
23	39587347	.	G	T	1	1	2	0	0	2	0	0
23	39593793	.	T	C	1	3	4	0	0	4	0	0
23	39594141	.	C	T	0	1	1	0	0	1	0	0
23	39594211	.	A	G	1	0	1	0	8	9	0	0
23	39594950	.	T	A	2	4	6	0	0	6	0	0
23	39594962	.	C	T	3	3	6	0	0	6	0	0
23	39594993	.	A	G	3	0	3	0	6	9	0	0
23	39595026	.	A	G	5	3	8	0	1	9	0	0
23	39595044	.	C	T	3	4	7	0	0	7	0	0
23	39595297	.	G	T	7	5	12	0	0	12	0	0
23	39595974	.	C	T	4	11	15	0	1	16	0	0
23	39596028	.	C	T	4	7	11	0	1	12	0	0
23	39596776	.	T	C	9	8	17	0	0	17	0	0
23	39597119	.	G	T	9	10	19	0	1	20	0	0
23	39597309	.	G	A	0	10	10	0	8	18	0	0
23	39597566	.	T	C	6	5	11	0	0	11	0	0
23	39607439	.	A	G	5	4	9	0	1	10	0	0
23	39611787	.	G	T	0	3	3	0	1	4	0	0
23	39615660	.	C	T	1	2	3	0	0	3	0	0
23	39615689	.	G	C	6	3	9	0	0	9	0	0
23	39615706	.	C	A	6	3	9	0	0	9	0	0
23	39623042	.	G	A	0	2	2	0	9	11	0	0
23	39626230	.	G	C	9	8	17	0	0	17	0	0
23	39626311	.	C	T	14	9	23	0	1	24	0	0
23	39626395	.	C	T	9	6	15	0	0	15	0	0
23	39626525	.	G	A	8	2	10	0	1	12	1	0
23	39626554	.	G	A	1	5	6	0	3	9	0	0
23	39632901	.	A	G	5	10	15	0	0	15	0	0
23	39633114	.	C	T	0	0	0	0	5	5	0	0
23	39633545	.	A	G	0	3	3	0	0	3	0	0
23	39635959	.	C	T	0	2	2	0	1	3	0	0
23	39636079	.	G	T	10	3	13	0	0	14	1	0
23	39636181	.	C	T	1	1	2	0	0	2	0	0
23	39638480	.	A	G	1	3	4	0	0	4	0	0
23	39642002	.	C	T	0	4	4	0	5	9	0	0
23	39649499	.	C	A	1	2	3	0	0	3	0	0
23	39649569	.	C	T	2	2	4	0	0	4	0	0
23	39649607	.	C	T	3	1	4	0	0	4	0	0
23	39744501	.	A	G	6	6	12	0	1	13	0	0
23	39744788	.	T	A	9	0	9	0	0	9	0	0
23	39744943	.	A	T	12	10	22	0	0	22	0	0
23	39756666	.	A	G	9	6	15	0	0	15	0	0
23	39756775	.	T	G	14	8	22	0	1	23	0	0
23	39756958	.	A	G	11	13	24	0	1	25	0	0
23	39757017	.	A	G	8	4	12	0	0	12	0	0
23	39757349	.	T	C	1	4	5	0	0	5	0	0
23	39758527	.	C	A	2	5	7	0	0	7	0	0
23	39758540	.	T	C	2	0	2	0	4	6	0	0
23	39758678	.	G	A	0	1	1	0	0	1	0	0
23	39758689	.	T	C	0	1	1	0	0	1	0	0
23	39758980	.	T	C	1	3	4	1	0	5	0	0
23	39759044	.	C	T	2	3	5	0	0	5	0	0
23	39759290	.	A	C	3	3	6	0	0	6	0	0
23	39759344	.	A	C	3	0	3	0	6	9	0	0
23	39759355	.	T	C	3	0	3	0	8	11	0	0
23	39759400	.	T	C	3	0	3	0	14	17	0	0
23	39764906	.	C	T	1	5	6	0	1	7	0	0
23	39765105	.	G	A	0	6	6	0	0	6	0	0
23	39767894	.	A	G	11	8	19	0	0	19	0	0
23	39768001	.	T	G	3	2	5	0	0	5	0	0
23	39771935	.	C	T	3	5	8	0	0	8	0	0
23	39771972	.	A	T	5	5	10	0	0	10	0	0
23	39772002	.	C	T	3	8	11	0	0	11	0	0
23	39772035	.	G	A	1	7	8	0	0	8	0	0
23	39808332	.	G	A	17	4	21	0	0	21	0	0
23	39808337	.	G	C	16	7	23	0	2	25	0	0
23	39808439	.	A	G	23	26	49	0	0	49	0	0
23	39808644	.	A	C	15	20	35	0	0	35	0	0
23	39808705	.	A	G	11	15	26	0	1	27	0	0
23	39809381	.	A	T	11	5	16	7	2	25	0	0
23	39809437	.	A	G	8	12	20	0	2	22	0	0
23	39809454	.	T	G	6	10	16	0	1	17	0	0
23	39809876	.	C	T	0	13	13	1	6	20	0	0
23	39811187	.	C	T	1	6	7	0	9	16	0	0
23	39811191	.	C	A	9	6	15	0	2	17	0	0
23	39811242	.	T	C	10	10	20	0	2	22	0	0
23	39811324	.	A	G	13	11	24	0	1	25	0	0
23	39811401	.	T	C	3	7	10	0	0	10	0	0
23	39811548	.	A	G	11	5	16	0	0	16	0	0
23	39811587	.	G	A	4	2	6	0	0	6	0	0
23	39811612	.	T	C	5	7	12	0	0	12	0	0
23	39811647	.	C	G	6	12	18	0	0	18	0	0
23	39811741	.	G	A	3	14	17	0	0	17	0	0
23	39811956	.	T	A	9	4	13	0	1	14	0	0
23	39812003	.	A	G	11	8	19	0	0	19	0	0
23	39812131	.	T	C	12	14	26	0	0	26	0	0
23	39812142	.	C	G	9	12	21	0	0	21	0	0
23	39812482	.	G	A	5	6	11	0	0	11	0	0
23	39812535	.	T	C	8	9	17	0	1	18	0	0
23	39812608	.	C	T	2	17	19	0	8	27	0	0
23	39812633	.	A	T	12	13	25	0	0	25	0	0
23	39812643	.	C	T	2	15	17	0	9	26	0	0
23	39901454	.	T	C	1	2	3	0	0	3	0	0
23	39919571	.	T	C	1	1	2	0	0	2	0	0
23	39924005	.	G	C	3	4	7	0	0	7	0	0
23	39936259	.	T	G	4	3	7	0	1	8	0	0
23	39940473	.	A	C	1	3	4	0	0	4	0	0
23	39940519	.	G	T	1	3	4	0	0	4	0	0
23	39940575	.	G	C	2	4	6	0	0	6	0	0
23	39940577	.	G	A	2	3	5	0	1	6	0	0
23	40284188	.	T	G	1	0	1	0	3	4	0	0
23	40285845	.	A	T	2	2	4	0	0	4	0	0
23	40437837	.	G	C	2	2	4	0	0	4	0	0
23	40437858	.	A	T	2	2	4	0	0	4	0	0
23	40452660	.	A	T	6	7	13	0	1	14	0	0
23	40452667	.	T	C	7	7	14	0	0	14	0	0
23	40452735	.	G	T	6	5	11	0	0	11	0	0
23	40452739	.	G	C	0	5	5	0	7	12	0	0
23	40452793	.	A	G	3	2	5	0	0	5	0	0
23	40460860	.	G	C	2	1	3	0	0	3	0	0
23	40462004	.	A	G	6	3	9	0	0	9	0	0
23	40462538	.	G	A	4	7	11	0	0	11	0	0
23	40466320	.	C	T	2	3	5	0	0	5	0	0
23	40466714	.	T	A	8	7	15	0	1	16	0	0
23	40471963	.	G	A	0	14	14	0	10	24	0	0
23	40472068	.	A	G	7	0	7	0	5	12	0	0
23	40480255	.	C	A	16	12	28	0	1	29	0	0
23	40480263	.	C	T	14	16	30	0	0	30	0	0
23	40526326	.	T	C	0	0	0	0	3	3	0	0
23	40526745	.	G	T	3	5	8	0	1	9	0	0
23	40526760	.	G	A	6	6	12	0	1	13	0	0
23	40526883	.	T	G	2	4	6	0	0	6	0	0
23	40526926	.	G	A	3	7	10	0	1	11	0	0
23	40526953	.	T	C	4	4	8	0	1	9	0	0
23	40526961	.	A	T	3	4	7	0	0	7	0	0
23	40527219	.	T	C	3	1	4	0	1	5	0	0
23	40527276	.	T	C	2	3	5	0	2	7	0	0
23	40527359	.	T	C	5	0	5	0	5	10	0	0
23	40527581	.	T	C	6	1	7	0	2	9	0	0
23	40527583	.	G	A	6	3	9	0	0	9	0	0
23	40527632	.	G	A	7	3	10	0	0	10	0	0
23	40527653	.	T	G	6	2	8	0	0	8	0	0
23	40527759	.	G	T	3	3	6	0	1	7	0	0
23	40527993	.	A	C	6	3	9	0	0	9	0	0
23	40528019	.	C	T	5	4	9	0	0	9	0	0
23	40528182	.	T	C	2	0	2	0	2	4	0	0
23	40528389	.	T	C	2	0	2	0	4	6	0	0
23	40528669	.	C	T	0	8	8	0	6	14	0	0
23	40528727	.	G	A	7	13	20	0	0	20	0	0
23	40528886	.	T	A	5	10	15	0	0	15	0	0
23	40528998	.	G	A	12	11	23	0	0	23	0	0
23	40529137	.	T	C	8	9	17	0	1	18	0	0
23	40529288	.	T	C	4	4	8	0	0	8	0	0
23	40529318	.	A	G	7	4	11	0	0	11	0	0
23	40529693	.	T	C	3	3	6	0	0	6	0	0
23	40529708	.	T	C	2	3	5	0	0	5	0	0
23	40529747	.	G	A	0	3	3	0	0	3	0	0
23	40605155	.	T	C	1	2	3	0	0	3	0	0
23	40605193	.	A	T	1	3	4	0	0	4	0	0
23	40605356	.	C	T	1	2	3	0	0	3	0	0
23	40720200	.	T	C	4	2	6	0	0	6	0	0
23	40720216	.	G	A	0	4	4	0	5	9	0	0
23	40731713	.	G	A	0	3	3	0	2	5	0	0
23	40731757	.	A	G	1	2	3	0	0	3	0	0
23	40738508	.	A	G	1	5	6	0	0	6	0	0
23	40741673	.	A	G	4	3	7	0	0	7	0	0
23	40742067	.	G	A	0	10	10	0	1	11	0	0
23	40742145	.	A	G	8	1	9	0	5	14	0	0
23	40742236	.	G	C	5	12	17	0	1	18	0	0
23	40756296	.	A	C	2	0	2	0	0	2	0	0
23	40761073	.	T	A	4	0	4	0	0	4	0	0
23	40766436	.	A	G	3	5	8	0	1	9	0	0
23	40766470	.	C	T	2	3	5	0	1	6	0	0
23	40873341	.	G	A	2	2	4	0	0	4	0	0
23	40873364	.	T	A	2	2	4	0	0	4	0	0
23	40873393	.	C	A	3	2	5	0	0	5	0	0
23	40873434	.	C	A	1	1	2	0	0	2	0	0
23	40972121	.	G	A	0	1	1	0	0	1	0	0
23	40972205	.	A	T	1	2	3	0	2	5	0	0
23	40976740	.	T	C	0	3	3	0	0	3	0	0
23	40976760	.	C	T	0	3	3	0	0	3	0	0
23	40986765	.	G	A	0	1	1	0	1	2	0	0
23	41228997	.	A	T	3	2	5	0	0	5	0	0
23	41313116	.	G	C	8	7	15	0	0	15	0	0
23	41754587	.	A	G	2	5	7	0	0	7	0	0
23	41799849	.	C	A	1	1	2	0	0	2	0	0
23	41801492	.	C	T	13	11	24	0	0	24	0	0
23	41801555	.	G	A	10	12	22	0	1	23	0	0
23	41801940	.	G	T	14	13	27	0	1	28	0	0
23	41802130	.	T	G	17	9	26	0	2	28	0	0
23	41802944	.	G	T	0	1	1	0	0	1	0	0
23	41803017	.	G	A	3	3	6	0	2	8	0	0
23	41803124	.	G	T	6	10	16	0	4	20	0	0
23	41803160	.	C	T	3	14	17	0	1	18	0	0
23	41803217	.	T	C	3	0	3	0	9	12	0	0
23	41803447	.	G	A	5	8	13	0	1	14	0	0
23	41803473	.	A	G	6	6	12	0	0	12	0	0
23	41803672	.	C	T	3	2	5	0	1	6	0	0
23	41803740	.	A	G	5	7	12	0	0	12	0	0
23	41804070	.	C	T	0	4	4	0	2	6	0	0
23	41804202	.	T	A	5	8	13	0	0	13	0	0
23	41804287	.	C	A	3	2	5	0	0	5	0	0
23	41804518	.	A	C	4	6	10	0	0	10	0	0
23	41804600	.	T	A	4	11	15	0	0	15	0	0
23	41805158	.	C	T	3	5	8	0	0	8	0	0
23	41805348	.	G	A	6	3	9	0	0	9	0	0
23	41807922	.	A	G	0	2	2	0	0	2	0	0
23	41807929	.	G	T	0	2	2	0	0	2	0	0
23	41821117	.	G	C	1	4	5	0	0	5	0	0
23	41831305	.	T	A	6	12	18	0	0	18	0	0
23	41831306	.	C	T	7	11	18	0	0	18	0	0
23	41853782	.	T	C	8	8	16	0	0	16	0	0
23	41853876	.	T	C	6	7	13	0	0	13	0	0
23	41853892	.	A	T	5	7	12	0	0	12	0	0
23	41854025	.	C	A	9	6	15	0	0	15	0	0
23	41854030	.	C	A	8	6	14	0	1	15	0	0
23	41854068	.	G	T	7	8	15	0	1	16	0	0
23	41949585	.	A	C	1	3	4	0	0	4	0	0
23	41949602	.	T	G	1	3	4	0	0	4	0	0
23	41949703	.	G	A	1	4	5	0	1	6	0	0
23	41949748	.	T	G	4	4	8	0	0	8	0	0
23	41949751	.	A	G	4	4	8	0	0	8	0	0
23	41976923	.	C	T	1	2	3	0	0	3	0	0
23	41976938	.	T	C	1	0	1	0	2	3	0	0
23	42275411	.	A	T	2	0	2	0	0	2	0	0
23	42283476	.	A	G	4	7	11	0	0	11	0	0
23	42289260	.	C	A	2	2	4	0	0	4	0	0
23	42329684	.	C	G	2	1	3	0	1	4	0	0
23	42639730	.	G	T	4	1	5	0	1	6	0	0
23	42640138	.	T	G	4	3	7	0	0	7	0	0
23	42640374	.	A	G	6	4	10	0	0	10	0	0
23	42641651	.	A	G	1	2	3	0	0	3	0	0
23	42641652	.	A	G	1	2	3	0	0	3	0	0
23	42641879	.	T	C	10	3	13	0	0	13	0	0
23	42642044	.	G	A	15	5	20	0	1	21	0	0
23	42642182	.	T	G	10	4	14	0	0	14	0	0
23	42642361	.	G	A	15	8	23	0	3	26	0	0
23	42642593	.	T	G	9	5	14	0	0	14	0	0
23	42642623	.	C	A	6	3	9	0	0	9	0	0
23	42642629	.	T	G	6	3	9	0	0	9	0	0
23	42642780	.	G	T	5	3	8	0	0	8	0	0
23	42642897	.	A	T	3	4	7	0	0	7	0	0
23	42765741	.	C	T	3	3	6	0	0	6	0	0
23	42766378	.	A	G	1	3	4	0	0	4	0	0
23	42766555	.	T	C	3	0	3	0	4	7	0	0
23	42766563	.	T	C	1	4	5	0	2	7	0	0
23	42766607	.	G	A	3	5	8	0	0	8	0	0
23	42766609	.	A	T	3	5	8	0	0	8	0	0
23	42767453	.	C	T	0	7	7	0	1	8	0	0
23	43519618	.	G	C	2	4	6	0	0	6	0	0
23	43519636	.	C	G	2	3	5	0	0	5	0	0
23	43540359	.	G	C	3	2	5	0	0	5	0	0
23	43649431	.	T	C	1	5	6	0	0	6	0	0
23	43652819	.	T	C	3	1	4	0	0	4	0	0
23	43652912	.	G	T	1	1	2	0	1	3	0	0
23	43688361	.	A	T	2	2	4	0	0	4	0	0
23	43688364	.	A	T	2	2	4	0	0	4	0	0
23	43688548	.	A	G	2	2	4	0	0	4	0	0
23	43688669	.	C	G	4	2	6	0	0	6	0	0
23	43688810	.	T	C	1	3	4	0	0	4	0	0
23	43689026	.	A	T	1	2	3	0	0	3	0	0
23	43689034	.	C	G	1	2	3	0	0	3	0	0
23	43689202	.	T	C	1	2	3	0	0	3	0	0
23	43690506	.	C	A	5	2	7	0	0	7	0	0
23	43690715	.	T	C	1	6	7	0	0	7	0	0
23	43690762	.	C	A	2	5	7	0	0	7	0	0
23	43690808	.	A	T	2	4	6	0	0	6	0	0
23	43690838	.	A	G	2	3	5	0	0	5	0	0
23	43690913	.	T	G	1	2	3	0	0	3	0	0
23	43691045	.	T	C	2	2	4	0	0	4	0	0
23	43691069	.	G	A	2	3	5	0	0	5	0	0
23	43691117	.	T	G	2	3	5	0	0	5	0	0
23	43691336	.	T	G	2	4	6	0	1	7	0	0
23	43691528	.	C	T	3	4	7	0	0	7	0	0
23	43691770	.	T	C	0	1	1	0	1	2	0	0
23	43691810	.	A	T	5	2	7	0	0	7	0	0
23	43691992	.	T	C	2	3	5	0	0	5	0	0
23	43695927	.	C	A	0	6	6	0	6	12	0	0
23	43696095	.	G	A	15	19	34	0	1	35	0	0
23	43696211	.	G	T	23	17	40	0	1	41	0	0
23	43696355	.	G	A	17	15	32	0	0	32	0	0
23	43699846	.	A	G	9	10	19	0	0	19	0	0
23	43700064	.	T	C	6	1	7	0	13	20	0	0
23	43700114	.	G	A	3	7	10	0	0	10	0	0
23	43700121	.	G	A	2	5	7	0	0	7	0	0
23	43705961	.	G	T	10	11	21	0	0	21	0	0
23	43706003	.	A	G	15	20	35	0	1	36	0	0
23	43706102	.	T	G	10	13	23	0	0	23	0	0
23	43713602	.	A	G	0	1	1	0	0	1	0	0
23	43713692	.	T	A	1	5	6	0	0	6	0	0
23	43718185	.	T	A	6	2	8	0	1	9	0	0
23	43718225	.	G	A	1	1	2	0	3	5	0	0
23	43723615	.	G	A	3	0	3	0	0	3	0	0
23	43723633	.	C	T	3	0	3	0	0	3	0	0
23	43723765	.	C	T	6	6	12	0	0	12	0	0
23	43770210	.	C	T	6	4	10	0	0	10	0	0
23	43770240	.	A	C	7	4	11	0	0	11	0	0
23	43770279	.	A	T	3	2	5	0	1	6	0	0
23	43770319	.	T	G	3	0	3	0	2	5	0	0
23	43770360	.	A	T	3	5	8	0	0	8	0	0
23	43770414	.	T	C	7	5	12	0	0	12	0	0
23	43770433	.	T	C	8	4	12	0	0	12	0	0
23	43770467	.	T	C	7	8	15	0	0	15	0	0
23	43770583	.	C	A	5	11	16	0	0	16	0	0
23	43770634	.	G	C	7	9	16	0	0	16	0	0
23	43770832	.	T	C	3	5	8	0	0	8	0	0
23	43778396	.	T	G	1	0	1	0	0	1	0	0
23	43780214	.	C	T	3	2	5	0	1	6	0	0
23	43781781	.	C	T	4	5	9	0	0	9	0	0
23	43784587	.	T	C	5	4	9	3	3	15	0	0
23	43784985	.	C	T	12	7	19	0	0	19	0	0
23	43799463	.	T	C	2	3	5	0	0	5	0	0
23	43800684	.	G	A	0	2	2	0	1	3	0	0
23	43800701	.	T	C	1	2	3	0	0	3	0	0
23	43800723	.	G	A	0	2	2	0	2	4	0	0
23	43800747	.	A	C	1	3	4	0	0	4	0	0
23	43801018	.	A	G	1	0	1	0	2	3	0	0
23	43801090	.	A	C	2	2	4	0	0	4	0	0
23	43801284	.	C	G	1	3	4	0	1	5	0	0
23	43801687	.	C	T	1	2	3	0	0	3	0	0
23	43801773	.	C	T	4	3	7	0	0	7	0	0
23	43801777	.	T	C	4	3	7	0	0	7	0	0
23	43801810	.	T	C	4	3	7	0	0	7	0	0
23	43801835	.	T	C	2	2	4	0	0	4	0	0
23	43802049	.	C	T	2	6	8	0	0	8	0	0
23	43802158	.	A	T	4	4	8	0	0	8	0	0
23	43802301	.	A	C	1	2	3	0	0	3	0	0
23	43830137	.	T	A	2	2	4	0	0	4	0	0
23	43830185	.	T	C	8	3	11	0	0	11	0	0
23	43830408	.	C	T	3	2	5	0	0	5	0	0
23	43830412	.	T	C	3	3	6	0	0	6	0	0
23	43898097	.	A	C	1	2	3	0	0	3	0	0
23	44521330	.	A	G	7	3	10	0	0	10	0	0
23	45244364	.	C	T	0	2	2	0	0	2	0	0
23	45295434	.	G	A	0	3	3	0	3	6	0	0
23	45423138	.	A	C	4	5	9	0	0	9	0	0
23	45423167	.	T	C	4	6	10	0	0	10	0	0
23	45423268	.	A	G	6	5	11	0	0	11	0	0
23	45423324	.	G	T	3	2	5	0	0	5	0	0
23	45423414	.	G	T	5	2	7	0	0	7	0	0
23	45424107	.	G	A	4	3	7	0	0	7	0	0
23	45515555	.	C	G	3	2	5	0	0	5	0	0
23	45515570	.	C	G	2	0	2	0	2	4	0	0
23	45516336	.	C	T	2	9	11	0	0	11	0	0
23	45516804	.	T	A	2	1	3	0	0	3	0	0
23	45516867	.	C	G	2	1	3	0	1	4	0	0
23	45521246	.	G	C	11	6	17	0	0	17	0	0
23	45521285	.	G	C	7	4	11	0	0	11	0	0
23	45521293	.	C	A	6	2	8	0	2	10	0	0
23	45521385	.	T	G	9	3	12	0	0	12	0	0
23	45521557	.	A	G	8	10	18	0	1	19	0	0
23	45521622	.	C	T	8	4	12	0	0	12	0	0
23	45521742	.	T	G	4	4	8	0	0	8	0	0
23	45521775	.	C	T	5	5	10	0	0	10	0	0
23	45521811	.	A	G	8	9	17	0	1	18	0	0
23	45521816	.	T	A	9	8	17	0	0	17	0	0
23	45521853	.	G	A	13	4	17	0	3	20	0	0
23	45521857	.	G	A	14	6	20	0	1	21	0	0
23	45521942	.	A	G	14	10	24	0	0	24	0	0
23	45522046	.	G	A	10	11	21	0	0	21	0	0
23	45522166	.	T	G	14	9	23	0	1	24	0	0
23	45522170	.	T	G	16	9	25	0	1	26	0	0
23	45522238	.	A	G	15	10	25	0	1	26	0	0
23	45522434	.	G	A	17	9	26	0	1	27	0	0
23	45523409	.	T	C	15	12	27	1	2	30	0	0
23	45523562	.	A	G	11	0	11	0	8	19	0	0
23	45523619	.	C	T	7	6	13	0	1	14	0	0
23	45523669	.	A	T	6	4	10	0	1	11	0	0
23	45547600	.	A	C	3	8	11	0	1	12	0	0
23	45547807	.	A	G	4	0	4	0	10	14	0	0
23	45547902	.	C	T	6	7	13	0	0	13	0	0
23	45548034	.	G	C	1	5	6	0	1	7	0	0
23	45548355	.	A	G	7	5	12	0	2	14	0	0
23	45548641	.	A	C	1	6	7	0	1	8	0	0
23	45548703	.	C	T	2	3	5	0	1	6	0	0
23	45548704	.	T	A	2	4	6	0	0	6	0	0
23	45579547	.	A	G	14	17	31	0	0	31	0	0
23	45579629	.	A	C	12	19	31	0	1	32	0	0
23	45580052	.	C	T	15	14	29	0	0	30	1	0
23	45580442	.	C	T	24	18	42	0	1	43	0	0
23	45580508	.	C	T	25	19	44	0	2	46	0	0
23	45580562	.	C	T	30	17	47	0	2	49	0	0
23	45581181	.	C	T	18	18	36	0	0	36	0	0
23	45586655	.	C	G	1	2	3	0	0	3	0	0
23	45586744	.	C	A	1	3	4	0	0	4	0	0
23	45586828	.	A	T	5	2	7	0	0	7	0	0
23	45586833	.	G	A	5	3	8	0	0	8	0	0
23	45586979	.	G	A	3	4	7	0	0	7	0	0
23	45587030	.	G	C	1	2	3	0	0	3	0	0
23	45587702	.	C	T	5	2	7	0	0	7	0	0
23	45588412	.	G	A	0	4	4	0	2	6	0	0
23	45591606	.	A	G	4	0	4	0	4	8	0	0
23	45591639	.	A	G	5	7	12	0	0	12	0	0
23	45595151	.	C	T	3	5	8	0	0	8	0	0
23	45595178	.	C	T	4	11	15	0	0	15	0	0
23	45600773	.	G	C	0	3	3	0	5	8	0	0
23	45622106	.	G	A	1	4	5	0	1	6	0	0
24	20671	.	T	C	1	1	2	0	0	2	0	0
24	83308	.	C	T	1	4	5	0	0	5	0	0
24	86994	.	T	C	0	3	3	0	0	3	0	0
24	145697	.	A	C	2	2	4	0	0	4	0	0
24	150167	.	C	T	1	2	3	0	0	3	0	0
24	150176	.	C	T	1	3	4	0	0	4	0	0
24	166969	.	T	G	5	5	10	0	1	11	0	0
24	167149	.	A	T	2	8	10	0	0	10	0	0
24	167177	.	A	G	1	3	4	0	1	5	0	0
24	174353	.	A	G	3	0	3	0	5	8	0	0
24	178693	.	G	A	4	9	13	0	0	13	0	0
24	184800	.	A	G	15	0	15	0	5	20	0	0
24	184818	.	C	T	12	3	15	0	1	16	0	0
24	187371	.	T	A	13	13	26	0	3	29	0	0
24	187414	.	T	A	14	8	22	0	0	22	0	0
24	187686	.	T	A	15	7	22	0	1	23	0	0
24	187811	.	A	T	9	13	22	0	0	23	1	0
24	187971	.	A	G	7	4	11	0	4	15	0	0
24	188013	.	A	G	4	3	7	0	0	7	0	0
24	188015	.	A	G	0	7	7	0	0	7	0	0
24	188155	.	C	G	6	9	15	0	0	15	0	0
24	188191	.	T	A	5	9	14	0	0	14	0	0
24	188363	.	G	A	19	13	32	0	2	34	0	0
24	188382	.	G	A	0	15	15	0	15	30	0	0
24	188423	.	T	C	12	15	27	0	0	27	0	0
24	188425	.	A	T	12	15	27	0	0	27	0	0
24	188464	.	T	C	12	23	35	0	2	37	0	0
24	196679	.	G	A	5	6	11	0	0	11	0	0
24	197062	.	C	T	1	1	2	0	0	2	0	0
24	197072	.	C	T	0	1	1	0	0	1	0	0
24	788327	.	A	G	2	8	10	0	1	11	0	0
24	788343	.	A	G	7	6	13	0	1	14	0	0
24	945478	.	C	T	0	2	2	0	3	5	0	0
24	945706	.	T	C	18	9	27	0	0	27	0	0
24	945841	.	T	G	14	4	18	0	0	18	0	0
24	945869	.	T	G	9	5	14	0	0	14	0	0
24	945883	.	G	A	7	5	12	0	1	13	0	0
24	947503	.	G	C	2	8	10	0	1	11	0	0
24	947518	.	C	T	2	10	12	0	1	13	0	0
24	947611	.	C	T	2	10	12	0	7	19	0	0
24	947899	.	G	C	11	5	16	0	1	17	0	0
24	947917	.	C	A	4	5	9	0	8	17	0	0
24	947957	.	C	A	3	8	11	0	8	19	0	0
24	947984	.	G	C	12	10	22	0	1	23	0	0
24	948080	.	A	G	10	4	14	0	0	14	0	0
24	948313	.	C	A	3	3	6	0	5	11	0	0
24	948438	.	T	C	11	4	15	0	8	23	0	0
24	948466	.	C	G	5	8	13	0	3	16	0	0
24	948503	.	C	T	4	7	11	0	5	16	0	0
24	948565	.	T	C	9	4	13	0	8	21	0	0
24	948571	.	G	A	12	6	18	0	0	18	0	0
24	948806	.	G	A	4	7	11	0	1	12	0	0
24	985094	.	A	T	6	11	17	0	4	21	0	0
24	985740	.	C	G	12	11	23	0	0	23	0	0
24	988373	.	A	C	6	0	6	0	5	11	0	0
24	1000112	.	G	A	4	6	10	0	1	11	0	0
24	1002664	.	T	C	6	5	11	0	2	13	0	0
24	1003494	.	C	T	0	8	8	0	4	12	0	0
24	1003551	.	C	A	0	7	7	0	6	13	0	0
24	1009078	.	A	G	7	6	13	0	0	13	0	0
24	1009978	.	A	C	5	0	5	0	5	10	0	0
24	1012613	.	C	G	5	2	7	0	0	7	0	0
24	1013057	.	A	T	1	2	3	0	0	3	0	0
24	1013059	.	A	T	1	2	3	0	0	3	0	0
24	1013105	.	T	G	3	3	6	0	0	6	0	0
24	1013106	.	G	T	3	3	6	0	0	6	0	0
24	1013290	.	G	C	5	6	11	0	1	12	0	0
24	1013303	.	G	A	6	6	12	0	0	12	0	0
24	1013359	.	G	C	4	3	7	0	1	8	0	0
24	1013375	.	A	T	4	4	8	0	0	8	0	0
24	1013763	.	T	C	1	2	3	0	0	3	0	0
24	1013861	.	A	G	1	3	4	0	0	4	0	0
24	1014745	.	A	T	5	4	9	0	1	10	0	0
24	1015292	.	T	C	14	1	15	0	9	24	0	0
24	1018672	.	T	C	4	0	4	0	15	19	0	0
24	1110150	.	T	C	4	9	13	0	0	13	0	0
24	1110152	.	T	A	4	9	13	0	0	13	0	0
24	1110227	.	G	A	3	5	8	0	0	8	0	0
24	1110325	.	C	A	2	9	11	0	0	11	0	0
24	1110492	.	C	T	5	4	9	0	0	9	0	0
24	1110512	.	C	T	0	4	4	0	6	10	0	0
24	1110527	.	C	T	6	5	11	0	0	11	0	0
24	1110595	.	G	C	5	5	10	0	2	12	0	0
24	1110601	.	G	A	9	3	12	0	0	12	0	0
24	1110748	.	T	C	2	4	6	0	0	6	0	0
24	1110992	.	G	A	4	2	6	0	1	7	0	0
24	1111076	.	G	A	1	2	3	0	0	3	0	0
24	1111102	.	G	T	0	6	6	0	1	7	0	0
24	1111146	.	T	C	6	3	9	0	1	10	0	0
24	1111164	.	T	C	3	6	9	0	0	9	0	0
24	1111469	.	C	T	1	5	6	0	5	11	0	0
24	1111571	.	T	A	3	5	8	0	0	8	0	0
24	1111572	.	G	T	3	5	8	0	0	8	0	0
24	1111628	.	A	C	1	2	3	0	0	3	0	0
24	1112087	.	T	G	3	2	5	0	0	5	0	0
24	1112950	.	G	T	1	3	4	0	0	4	0	0
24	1112972	.	T	G	1	3	4	0	0	4	0	0
24	1163061	.	G	A	21	12	33	0	1	34	0	0
24	1166957	.	G	A	4	4	8	0	0	8	0	0
24	1167496	.	G	A	7	4	11	0	0	11	0	0
24	1167506	.	G	A	6	3	9	0	0	9	0	0
24	1169291	.	C	T	0	9	9	0	12	21	0	0
24	1177074	.	T	A	5	9	14	0	2	16	0	0
24	1185142	.	G	A	0	1	1	0	1	2	0	0
24	1185271	.	G	A	10	7	17	0	1	18	0	0
24	1203573	.	A	G	1	1	2	0	0	2	0	0
24	1221280	.	C	T	0	5	5	0	1	6	0	0
24	1229646	.	G	C	11	0	11	0	6	17	0	0
24	1229683	.	G	C	4	3	7	0	0	7	0	0
24	1236358	.	A	G	9	9	18	0	1	19	0	0
24	1301258	.	C	T	1	1	2	0	0	2	0	0
24	1303892	.	A	G	3	4	7	0	1	8	0	0
24	2284456	.	A	T	16	6	22	0	1	23	0	0
24	2284526	.	T	C	13	0	13	0	15	28	0	0
24	2284647	.	C	T	0	6	6	0	8	14	0	0
24	2290232	.	T	C	7	0	7	0	3	10	0	0
24	2297093	.	T	A	1	2	3	0	0	3	0	0
24	2297117	.	A	G	2	4	6	0	0	6	0	0
24	2303715	.	T	G	1	0	1	0	0	1	0	0
24	2303784	.	C	T	3	3	6	0	1	7	0	0
24	2307342	.	C	T	1	6	7	0	0	7	0	0
24	2308075	.	A	G	3	2	5	0	0	5	0	0
24	2322519	.	A	G	1	3	4	0	0	4	0	0
24	2327295	.	T	C	1	1	2	0	0	2	0	0
24	2333811	.	C	T	2	2	4	0	0	4	0	0
24	2333841	.	T	C	2	3	5	0	0	5	0	0
24	2340671	.	A	T	5	8	13	0	0	13	0	0
24	2346758	.	A	G	4	3	7	0	1	8	0	0
24	2346825	.	A	T	3	3	6	0	0	6	0	0
24	2346826	.	A	T	3	3	6	0	0	6	0	0
24	2842994	.	T	A	4	2	6	0	1	7	0	0
24	2899877	.	A	G	6	2	8	0	0	8	0	0
24	3470086	.	T	C	13	4	17	0	0	17	0	0
24	3470115	.	T	C	11	7	18	0	1	19	0	0
24	3470408	.	T	C	6	4	10	0	0	10	0	0
24	3470608	.	T	C	4	3	7	0	1	8	0	0
24	3471342	.	T	C	8	4	12	0	0	12	0	0
24	5653468	.	C	T	2	3	5	0	0	5	0	0
24	7941849	.	C	A	5	3	8	0	1	9	0	0
24	7942785	.	T	C	2	0	2	0	9	11	0	0
24	8861380	.	T	C	2	6	8	0	0	8	0	0
24	9270074	.	G	A	1	3	4	0	1	5	0	0
24	9508123	.	G	C	0	1	1	0	0	1	0	0
24	9518441	.	A	G	1	0	1	0	2	3	0	0
24	9518447	.	T	C	1	2	3	0	0	3	0	0
24	9543510	.	G	T	0	2	2	0	2	4	0	0
24	9566928	.	A	G	1	3	4	0	0	4	0	0
24	9573300	.	A	C	1	0	1	0	0	1	0	0
24	9594999	.	T	C	4	7	11	0	0	11	0	0
24	9596423	.	T	C	2	3	5	0	1	6	0	0
24	9673568	.	G	T	12	7	19	0	0	19	0	0
24	9676144	.	T	C	7	10	17	0	0	17	0	0
24	9676147	.	T	A	7	11	18	0	0	18	0	0
24	9676204	.	C	A	3	3	6	0	1	7	0	0
24	9678514	.	A	T	14	10	24	0	0	24	0	0
24	9689709	.	G	T	5	4	9	0	0	9	0	0
24	9689758	.	T	C	6	0	6	0	3	9	0	0
24	9714103	.	C	G	1	3	4	0	0	4	0	0
24	9714155	.	C	T	0	1	1	0	0	1	0	0
24	9714423	.	T	C	3	2	5	0	1	6	0	0
24	9714585	.	G	A	0	1	1	0	0	1	0	0
24	9717383	.	C	T	3	2	5	0	0	5	0	0
24	9717625	.	C	G	0	1	1	0	0	1	0	0
24	9721103	.	A	C	0	2	2	0	0	2	0	0
24	9723632	.	A	G	2	0	2	0	2	4	0	0
24	9723636	.	C	T	2	3	5	0	0	5	0	0
24	9729966	.	A	T	0	3	3	0	0	3	0	0
24	9730098	.	G	A	3	6	9	0	1	10	0	0
24	9730134	.	G	A	5	4	9	0	2	11	0	0
24	9732066	.	T	A	1	1	2	0	0	2	0	0
24	9744227	.	G	A	4	1	5	0	1	6	0	0
24	9744236	.	G	A	0	3	3	0	5	8	0	0
24	10303168	.	C	T	3	5	8	0	0	8	0	0
24	10303178	.	G	T	0	5	5	0	4	9	0	0
24	10303221	.	A	G	4	0	4	0	4	8	0	0
24	10303240	.	T	A	4	4	8	0	0	8	0	0
24	10309289	.	C	T	4	6	10	0	0	10	0	0
24	10309382	.	T	C	7	4	11	0	0	11	0	0
24	10309532	.	T	A	4	4	8	0	0	8	0	0
24	10319239	.	G	C	0	2	2	0	4	6	0	0
24	10323534	.	G	A	0	1	1	0	0	1	0	0
24	10329528	.	C	G	1	2	3	0	1	4	0	0
24	10349671	.	C	T	6	6	12	0	0	12	0	0
24	10349818	.	G	A	4	5	9	0	0	9	0	0
24	10349865	.	T	G	6	10	16	0	1	17	0	0
24	10349898	.	T	C	7	8	15	0	0	15	0	0
24	10350089	.	T	A	3	5	8	0	0	8	0	0
24	10350135	.	A	T	2	4	6	0	1	7	0	0
24	10350239	.	T	A	4	10	14	0	1	15	0	0
24	10356563	.	G	A	1	4	5	0	0	5	0	0
24	10356592	.	T	C	1	3	4	0	0	4	0	0
24	10356617	.	G	A	1	0	1	0	0	1	0	0
24	10376984	.	G	A	1	0	1	0	0	1	0	0
24	10376990	.	T	C	1	0	1	0	0	1	0	0
24	10394027	.	A	G	2	3	5	0	0	5	0	0
24	10394224	.	G	A	2	3	5	0	0	5	0	0
24	10406159	.	G	A	1	3	4	0	1	5	0	0
24	10413560	.	C	T	8	4	12	0	0	12	0	0
24	10414439	.	G	T	0	3	3	0	5	8	0	0
24	10415193	.	A	G	12	9	21	0	1	22	0	0
24	10415370	.	G	C	13	11	24	0	1	25	0	0
24	10415790	.	C	T	0	3	3	0	2	5	0	0
24	10415827	.	T	G	1	2	3	0	0	3	0	0
24	10464195	.	A	G	0	2	2	0	0	2	0	0
24	10464347	.	A	G	2	1	3	0	4	7	0	0
24	10464354	.	T	G	1	4	5	0	0	5	0	0
24	10793398	.	T	A	3	0	3	0	1	4	0	0
24	10797306	.	T	C	2	0	2	0	0	2	0	0
24	10810390	.	C	T	0	1	1	0	2	3	0	0
24	10824235	.	C	T	6	10	16	0	2	18	0	0
24	10828512	.	A	G	0	1	1	0	0	1	0	0
24	10897254	.	G	A	3	1	4	0	0	4	0	0
24	10901467	.	A	C	5	8	13	0	0	13	0	0
24	10901696	.	C	G	25	23	48	1	4	53	0	0
24	10901759	.	G	T	28	15	43	0	1	44	0	0
24	10901946	.	C	T	7	14	21	0	1	22	0	0
24	10902065	.	T	G	11	9	20	0	2	22	0	0
24	10902192	.	T	A	11	11	22	0	0	22	0	0
24	10902268	.	G	A	5	19	24	0	0	24	0	0
24	10902568	.	T	C	19	1	20	0	20	40	0	0
24	10902688	.	G	A	21	17	38	0	1	39	0	0
24	10907000	.	T	C	3	4	7	0	0	7	0	0
24	10907473	.	C	T	17	15	32	0	3	35	0	0
24	10907587	.	G	T	8	4	12	0	0	12	0	0
24	10917040	.	C	T	5	2	7	0	0	7	0	0
24	10917046	.	C	T	0	2	2	0	6	8	0	0
24	10917238	.	C	T	2	3	5	0	0	5	0	0
24	10919519	.	A	G	2	5	7	0	1	8	0	0
24	10919563	.	G	T	2	3	5	0	0	5	0	0
24	10924880	.	C	T	7	9	16	0	1	17	0	0
24	10924912	.	C	T	6	10	16	0	0	16	0	0
24	10924930	.	T	A	3	8	11	0	0	11	0	0
24	10925951	.	G	A	1	1	2	0	1	3	0	0
24	10928291	.	G	A	3	3	6	0	0	6	0	0
24	10961510	.	T	C	3	0	3	0	0	3	0	0
24	10971160	.	G	A	2	1	3	0	1	4	0	0
24	11049421	.	G	A	4	2	6	0	1	7	0	0
24	11049670	.	C	T	3	2	5	0	0	5	0	0
24	11049678	.	C	T	2	2	4	0	1	5	0	0
24	11049819	.	C	G	7	5	12	0	1	13	0	0
24	11049825	.	C	T	6	4	10	0	1	11	0	0
24	11083860	.	C	T	4	4	8	0	0	8	0	0
24	11084074	.	A	C	0	2	2	0	0	2	0	0
24	11084085	.	T	G	0	2	2	0	0	2	0	0
24	11086437	.	G	T	3	2	5	0	0	5	0	0
24	11086679	.	T	A	5	4	9	0	0	9	0	0
24	11086887	.	C	A	2	1	3	0	0	3	0	0
24	11112153	.	T	A	7	9	16	0	0	16	0	0
24	11112290	.	G	A	11	9	20	0	0	20	0	0
24	11112474	.	A	G	7	11	18	0	0	18	0	0
24	11112710	.	A	C	10	1	11	0	13	24	0	0
24	11112839	.	G	A	13	14	27	0	0	27	0	0
24	11113027	.	T	C	10	12	22	0	0	22	0	0
24	11113110	.	C	T	6	12	18	0	3	21	0	0
24	11113243	.	G	A	6	8	14	0	0	14	0	0
24	11113493	.	T	C	3	0	3	0	9	12	0	0
24	11113507	.	T	C	7	5	12	0	0	12	0	0
24	11113667	.	C	G	1	2	3	1	0	4	0	0
24	11113912	.	A	T	6	14	20	0	0	20	0	0
24	11113966	.	T	C	5	12	17	0	0	17	0	0
24	11113972	.	C	G	6	12	18	0	2	20	0	0
24	11114094	.	T	C	2	3	5	0	0	5	0	0
24	11114184	.	G	T	10	9	19	0	0	19	0	0
24	11114236	.	A	T	10	7	17	0	1	18	0	0
24	11114300	.	A	T	3	9	12	0	0	12	0	0
24	11114786	.	A	G	3	10	13	0	0	13	0	0
24	11114996	.	G	T	2	9	11	0	0	11	0	0
24	11115114	.	G	A	5	6	11	0	0	11	0	0
24	11115222	.	A	C	6	4	10	0	0	10	0	0
24	11115280	.	C	G	3	4	7	0	0	7	0	0
24	11115428	.	C	T	0	2	2	0	0	2	0	0
24	11115451	.	C	A	1	2	3	0	0	3	0	0
24	11115513	.	G	A	2	3	5	0	0	5	0	0
24	11115532	.	G	A	4	4	8	0	0	8	0	0
24	11115719	.	T	A	4	4	8	0	0	8	0	0
24	11115720	.	A	G	4	4	8	0	0	8	0	0
24	11115806	.	A	G	6	2	8	0	0	8	0	0
24	11115920	.	T	C	1	3	4	0	1	5	0	0
24	11124199	.	C	T	0	1	1	0	0	1	0	0
24	11127483	.	G	A	1	2	3	0	0	3	0	0
24	11141027	.	G	A	4	2	6	0	0	6	0	0
24	11141065	.	C	T	6	3	9	0	2	11	0	0
24	11141654	.	A	G	5	3	8	0	1	9	0	0
24	11141757	.	T	C	6	4	10	0	0	10	0	0
24	11141849	.	G	A	6	4	10	0	0	10	0	0
24	11145250	.	G	A	5	3	8	0	1	9	0	0
24	11145460	.	A	G	3	3	6	0	0	6	0	0
24	11145499	.	T	G	3	3	6	0	0	6	0	0
24	11153576	.	C	T	0	1	1	0	0	1	0	0
24	11390254	.	C	T	1	2	3	0	0	3	0	0
24	11473180	.	T	C	1	2	3	0	0	3	0	0
24	11473845	.	T	G	7	5	12	0	2	14	0	0
24	11473857	.	C	A	5	7	12	0	2	14	0	0
24	11473968	.	T	C	7	0	7	0	11	18	0	0
24	11474167	.	T	C	11	9	20	0	3	23	0	0
24	11474257	.	G	A	11	4	15	0	0	15	0	0
24	11483833	.	C	T	0	1	1	0	0	1	0	0
24	11490060	.	C	T	8	3	11	0	2	13	0	0
24	11490238	.	A	T	1	0	1	0	0	1	0	0
24	11496890	.	G	A	3	2	5	0	0	5	0	0
24	11496922	.	G	A	4	5	9	0	0	9	0	0
24	11496937	.	A	G	5	7	12	0	0	12	0	0
24	11497243	.	A	G	6	5	11	0	0	11	0	0
24	11529966	.	C	T	5	6	11	0	0	11	0	0
24	11530003	.	T	C	4	3	7	0	0	7	0	0
24	11530377	.	T	C	2	2	4	0	0	4	0	0
24	11888799	.	T	C	7	9	16	0	0	16	0	0
24	11888854	.	T	C	6	6	12	0	0	12	0	0
24	11889027	.	T	C	9	4	13	0	1	14	0	0
24	11889038	.	C	G	9	5	14	0	1	15	0	0
24	11889353	.	C	T	4	2	6	0	0	6	0	0
24	11893314	.	G	A	4	3	7	0	0	7	0	0
24	11893428	.	G	A	4	2	6	0	0	6	0	0
24	11900292	.	C	T	1	2	3	0	1	4	0	0
24	11919170	.	A	G	1	4	5	0	0	5	0	0
24	12133963	.	C	A	11	4	15	0	2	17	0	0
24	12133998	.	A	C	8	4	12	0	1	13	0	0
24	12252675	.	G	T	13	11	24	0	0	24	0	0
24	12253067	.	G	A	13	6	19	0	0	19	0	0
24	12253154	.	T	G	7	4	11	0	1	12	0	0
24	12630352	.	A	G	6	3	9	0	0	9	0	0
24	12634439	.	C	T	9	9	18	0	1	19	0	0
24	12743987	.	G	T	2	0	2	0	1	3	0	0
24	12743992	.	G	A	1	1	2	0	1	3	0	0
24	12744603	.	C	T	3	2	5	0	0	5	0	0
24	12744606	.	G	A	2	2	4	0	1	5	0	0
24	12744653	.	T	C	2	2	4	0	0	4	0	0
24	12744829	.	T	C	0	0	0	0	2	2	0	0
24	12744894	.	G	T	5	8	13	0	0	13	0	0
24	12746597	.	A	G	1	2	3	0	0	3	0	0
24	12749046	.	G	A	8	11	19	0	2	21	0	0
24	12766875	.	G	T	1	0	1	0	0	1	0	0
24	12802203	.	T	A	0	5	5	0	0	5	0	0
24	12966730	.	C	T	12	6	18	0	1	19	0	0
24	12966981	.	G	A	10	12	22	0	0	22	0	0
24	12967041	.	C	T	2	2	4	0	0	4	0	0
24	12967163	.	G	A	6	4	10	0	0	10	0	0
24	12970814	.	A	T	1	3	4	0	0	4	0	0
24	12978892	.	A	G	4	1	5	0	0	5	0	0
24	12981349	.	A	T	1	6	7	0	0	7	0	0
24	12981384	.	C	T	0	4	4	0	5	9	0	0
24	12983478	.	A	T	0	1	1	0	0	1	0	0
24	12998907	.	G	A	0	1	1	0	1	2	0	0
24	13014280	.	C	T	4	6	10	0	0	10	0	0
24	13014423	.	A	T	3	2	5	0	1	6	0	0
24	13015293	.	A	T	5	3	8	0	0	8	0	0
24	13015843	.	C	G	3	2	5	0	0	5	0	0
24	13023054	.	C	T	26	15	41	0	0	41	0	0
24	13026060	.	G	A	16	18	34	0	4	38	0	0
24	13026449	.	T	C	2	0	2	0	0	2	0	0
24	13101143	.	C	A	30	26	56	0	2	58	0	0
24	13229408	.	G	A	6	11	17	0	0	17	0	0
24	13239040	.	C	T	8	17	25	0	32	57	0	0
24	13239712	.	G	T	1	39	40	0	26	66	0	0
24	13239934	.	G	T	19	19	38	0	4	42	0	0
24	13239985	.	G	C	23	17	40	0	2	42	0	0
24	13251801	.	A	C	9	7	16	0	0	16	0	0
24	13251963	.	T	C	8	12	20	0	0	20	0	0
24	13255400	.	C	T	8	8	16	0	0	16	0	0
24	13326719	.	C	T	3	1	4	0	0	4	0	0
24	13361973	.	C	T	2	4	6	0	0	6	0	0
24	13361974	.	C	T	2	4	6	0	0	6	0	0
24	13966477	.	T	C	1	2	3	0	1	4	0	0
24	14013282	.	G	A	0	2	2	0	2	4	0	0
24	14013552	.	C	G	1	2	3	0	0	3	0	0
24	14233793	.	C	T	0	2	2	0	1	3	0	0
24	14233799	.	C	T	0	2	2	0	1	3	0	0
24	14234355	.	A	G	1	2	3	0	0	3	0	0
24	14234412	.	T	G	1	3	4	0	0	5	1	0
24	14234518	.	T	A	3	6	9	0	0	9	0	0
24	14234567	.	A	T	2	7	9	0	1	11	1	0
24	14234594	.	A	C	2	6	8	0	0	8	0	0
24	14355885	.	T	C	1	2	3	0	0	3	0	0
24	14384979	.	C	T	5	3	8	0	0	8	0	0
24	14385405	.	G	A	0	2	2	0	5	7	0	0
24	14385520	.	A	G	5	1	6	0	0	6	0	0
24	14385526	.	C	A	4	2	6	0	0	6	0	0
24	14385751	.	G	A	1	4	5	0	4	9	0	0
24	14385765	.	G	T	6	4	10	0	0	10	0	0
24	14414325	.	G	A	0	3	3	0	1	4	0	0
24	14415844	.	C	T	1	3	4	0	0	4	0	0
24	14415965	.	G	A	3	3	6	0	0	6	0	0
24	14416018	.	G	C	0	1	1	0	0	1	0	0
24	14443291	.	C	T	6	8	14	0	1	15	0	0
24	14443592	.	C	G	8	6	14	0	0	14	0	0
24	14443953	.	A	G	12	0	12	0	9	21	0	0
24	14542501	.	A	G	1	2	3	0	0	3	0	0
24	14550242	.	T	G	2	3	5	0	0	5	0	0
24	14550305	.	T	A	4	1	5	0	0	5	0	0
24	14550479	.	G	A	8	7	15	0	0	15	0	0
24	14550487	.	A	T	8	11	19	0	1	20	0	0
24	14550545	.	C	T	17	7	24	0	0	24	0	0
24	14559391	.	A	G	10	12	22	0	2	24	0	0
24	14560155	.	G	A	25	23	48	0	1	49	0	0
24	14568300	.	G	T	23	19	42	0	2	45	1	0
24	14575607	.	G	A	7	3	10	0	1	11	0	0
24	14576693	.	A	G	6	6	12	0	0	12	0	0
24	14576782	.	A	G	8	3	11	0	1	12	0	0
24	14577512	.	G	C	3	4	7	0	0	7	0	0
24	14597264	.	G	A	4	5	9	0	2	11	0	0
24	14597311	.	C	T	4	3	7	0	0	7	0	0
24	14597313	.	G	A	4	3	7	0	0	7	0	0
24	14599954	.	A	G	0	5	5	0	0	5	0	0
24	14600137	.	G	A	1	2	3	0	0	3	0	0
24	14711793	.	A	G	2	3	5	0	0	5	0	0
24	14713865	.	A	G	16	14	30	0	0	30	0	0
24	14713927	.	T	C	8	9	17	0	0	17	0	0
24	14718476	.	A	G	4	1	5	0	0	5	0	0
24	14725323	.	T	C	12	38	50	0	3	53	0	0
24	15061397	.	T	C	2	3	5	0	0	5	0	0
24	15061434	.	T	C	2	2	4	0	1	5	0	0
24	15061866	.	G	A	2	6	8	0	0	8	0	0
24	15124818	.	C	T	1	9	10	0	0	10	0	0
24	15124847	.	C	T	0	12	12	0	1	13	0	0
24	15127376	.	G	T	1	1	2	0	0	2	0	0
24	15127487	.	A	T	1	6	7	0	0	7	0	0
24	15127581	.	G	T	4	2	6	0	1	7	0	0
24	15277470	.	A	G	3	2	5	0	0	5	0	0
24	15278403	.	A	G	4	0	4	0	2	6	0	0
24	15648158	.	A	G	1	2	3	0	1	4	0	0
24	15898505	.	C	G	0	5	5	0	0	5	0	0
24	16162009	.	A	T	2	4	6	0	0	6	0	0
24	16162344	.	A	T	5	9	14	0	1	15	0	0
24	16471603	.	C	A	1	1	2	0	1	3	0	0
24	16572266	.	G	A	1	2	3	0	0	3	0	0
24	16612792	.	G	T	9	7	16	0	1	17	0	0
24	16612819	.	G	A	1	5	6	0	5	11	0	0
24	16615706	.	A	G	2	0	2	0	0	2	0	0
24	16630964	.	T	C	1	7	8	0	0	8	0	0
24	16646712	.	C	G	12	5	17	0	1	18	0	0
24	16685001	.	G	A	0	2	2	0	0	2	0	0
24	16696741	.	T	C	5	6	11	0	0	11	0	0
24	16702886	.	G	T	0	10	10	0	14	24	0	0
24	16705890	.	A	C	17	18	35	0	1	36	0	0
24	16705948	.	C	T	18	25	43	0	1	44	0	0
24	16705949	.	A	G	17	26	43	0	0	44	1	0
24	16706349	.	T	C	10	18	28	0	2	30	0	0
24	16855423	.	A	T	1	1	2	0	1	3	0	0
24	16855433	.	T	A	2	2	4	0	0	4	0	0
24	16855561	.	T	A	2	3	5	0	0	5	0	0
24	16855593	.	A	G	3	2	5	0	0	5	0	0
24	16855646	.	C	T	0	2	2	0	1	3	0	0
24	16870586	.	G	T	0	2	2	0	0	2	0	0
24	16870644	.	C	T	3	0	3	0	0	3	0	0
24	16896701	.	C	T	0	1	1	0	1	2	0	0
24	16905265	.	A	C	11	13	24	0	0	25	1	0
24	16905292	.	C	T	12	16	28	0	1	29	0	0
24	16906200	.	T	G	0	0	0	0	1	1	0	0
24	16906239	.	A	G	0	1	1	0	0	1	0	0
24	16908771	.	A	C	5	4	9	0	2	11	0	0
24	16908827	.	G	A	12	18	30	0	1	31	0	0
24	16908848	.	C	T	16	10	26	0	0	26	0	0
24	16908908	.	C	T	8	7	15	0	1	16	0	0
24	16911940	.	G	C	18	20	38	0	1	39	0	0
24	16911949	.	T	A	16	18	34	0	0	34	0	0
24	16912086	.	G	A	0	2	2	0	4	6	0	0
24	16912188	.	G	A	3	22	25	0	23	49	1	0
24	16912191	.	G	A	24	23	47	0	1	48	0	0
24	16912710	.	G	A	21	23	44	0	0	44	0	0
24	16913077	.	G	A	3	4	7	0	0	7	0	0
24	16913143	.	A	T	2	5	7	0	0	7	0	0
24	16913144	.	G	T	2	5	7	0	0	7	0	0
24	16914728	.	A	C	1	0	1	0	3	4	0	0
24	16964353	.	C	A	3	3	6	0	0	6	0	0
24	16964452	.	G	A	6	7	13	0	1	14	0	0
24	16964787	.	T	A	1	2	3	0	0	3	0	0
24	16964819	.	T	C	1	4	5	0	1	6	0	0
24	16964839	.	A	C	2	7	9	0	0	9	0	0
24	16964854	.	T	C	2	6	8	0	0	8	0	0
24	16964881	.	G	C	1	5	6	0	0	6	0	0
24	16964889	.	A	G	1	5	6	0	0	6	0	0
24	16964943	.	A	T	1	6	7	0	1	8	0	0
24	16965020	.	C	T	5	8	13	0	0	13	0	0
24	16965032	.	G	A	6	7	13	0	1	14	0	0
24	16965503	.	G	A	5	3	8	0	0	8	0	0
24	16965545	.	C	A	6	4	10	0	0	10	0	0
24	16965972	.	A	G	6	8	14	0	0	14	0	0
24	16966176	.	G	A	9	4	13	0	0	13	0	0
24	16966185	.	T	C	9	0	9	0	3	12	0	0
24	16966479	.	T	C	4	5	9	0	1	10	0	0
24	16966617	.	G	A	2	5	7	0	0	7	0	0
24	16966662	.	G	A	1	2	3	0	0	3	0	0
24	16966932	.	A	G	2	4	6	0	0	6	0	0
24	16968778	.	C	T	0	3	3	0	5	8	0	0
24	16992440	.	A	G	15	11	26	0	1	27	0	0
24	16992506	.	A	C	2	2	4	0	2	6	0	0
24	16999057	.	T	G	19	29	48	0	1	49	0	0
24	17005737	.	A	G	1	2	3	0	0	3	0	0
24	17010923	.	G	T	1	5	6	0	1	7	0	0
24	17016658	.	T	C	3	3	6	0	0	6	0	0
24	17017060	.	T	C	0	1	1	0	0	1	0	0
24	17019252	.	A	G	2	0	2	0	2	4	0	0
24	17019483	.	T	G	3	0	3	0	3	6	0	0
24	17019504	.	G	A	1	3	4	0	0	4	0	0
24	17019669	.	A	G	7	5	12	0	0	12	0	0
24	17019843	.	A	G	7	0	7	0	5	12	0	0
24	17020128	.	C	T	7	3	10	0	0	10	0	0
24	17020761	.	T	A	0	3	3	0	0	3	0	0
24	17020764	.	A	T	0	3	3	0	0	3	0	0
24	17022028	.	A	G	0	12	12	0	5	17	0	0
24	17022029	.	T	A	0	16	16	0	1	17	0	0
24	17022133	.	T	C	1	0	1	0	1	2	0	0
24	17022230	.	T	G	0	2	2	0	0	2	0	0
24	17022231	.	A	T	0	2	2	0	0	2	0	0
24	17027464	.	G	A	15	19	34	0	0	34	0	0
24	17027484	.	C	A	17	22	39	0	3	42	0	0
24	17028990	.	C	T	0	1	1	0	0	1	0	0
24	17040803	.	A	T	5	4	9	0	0	9	0	0
24	17042014	.	A	G	1	4	5	0	0	5	0	0
24	17042022	.	A	G	1	4	5	0	1	6	0	0
24	17042302	.	A	T	1	1	2	0	1	3	0	0
24	17042698	.	A	T	4	4	8	0	0	8	0	0
24	17068942	.	C	T	8	5	13	0	0	13	0	0
24	17068949	.	A	G	8	0	8	0	5	13	0	0
24	17069249	.	C	A	5	5	10	0	0	10	0	0
24	17069297	.	A	G	3	2	5	0	0	5	0	0
24	17119170	.	C	T	1	0	1	0	0	1	0	0
24	17124124	.	C	T	7	13	20	0	0	20	0	0
24	17124306	.	T	A	9	4	13	0	0	13	0	0
24	17125503	.	G	A	16	9	25	0	0	25	0	0
24	17126069	.	G	A	15	15	30	0	2	32	0	0
24	17126391	.	T	C	16	9	25	0	0	25	0	0
24	17126738	.	T	A	17	23	40	0	2	42	0	0
24	17214629	.	T	C	15	11	26	0	1	27	0	0
24	17214642	.	G	A	12	9	21	0	1	22	0	0
24	17214746	.	C	T	14	7	21	0	2	23	0	0
24	17258451	.	G	T	0	1	1	0	0	1	0	0
24	17258500	.	C	A	0	2	2	0	1	3	0	0
24	17259535	.	G	T	6	3	9	0	2	11	0	0
24	17266382	.	G	A	8	3	11	0	3	14	0	0
24	17266876	.	G	A	5	11	16	0	0	16	0	0
24	17276447	.	T	C	1	2	3	0	0	3	0	0
24	17334815	.	T	C	3	5	8	0	0	8	0	0
24	17345618	.	C	A	1	4	5	0	1	6	0	0
24	17352009	.	C	T	1	1	2	0	0	2	0	0
24	17352335	.	C	A	4	2	6	0	0	6	0	0
24	17360183	.	T	C	0	3	3	0	0	3	0	0
24	17364010	.	G	A	0	2	2	0	5	7	0	0
24	17365081	.	A	G	4	15	19	0	1	20	0	0
24	17368343	.	T	A	2	3	5	0	0	5	0	0
24	17368816	.	G	A	6	4	10	0	0	10	0	0
24	17372074	.	G	A	3	5	8	0	0	8	0	0
24	17377871	.	G	A	4	3	7	0	0	7	0	0
24	17377874	.	G	A	4	4	8	0	0	8	0	0
24	17378123	.	T	C	0	0	0	0	5	5	0	0
24	17381017	.	G	A	4	4	8	0	0	8	0	0
24	17389385	.	A	T	2	4	6	0	0	6	0	0
24	17389415	.	G	A	0	3	3	0	0	3	0	0
24	17400069	.	T	A	0	1	1	0	0	1	0	0
24	17410153	.	A	T	3	6	9	0	0	9	0	0
24	17417535	.	T	G	16	16	32	0	0	32	0	0
24	17417899	.	G	C	6	13	19	0	1	20	0	0
24	17417947	.	A	G	11	8	19	0	0	19	0	0
24	17418024	.	C	A	13	19	32	0	0	32	0	0
24	17418180	.	G	T	17	6	23	0	1	24	0	0
24	17418460	.	T	C	11	10	21	0	0	21	0	0
24	17418576	.	T	C	5	5	10	0	2	12	0	0
24	17418659	.	A	T	1	3	4	0	0	4	0	0
24	17418668	.	T	C	2	6	8	0	0	8	0	0
24	17418741	.	G	C	4	17	21	0	0	21	0	0
24	17418993	.	C	T	0	5	5	0	3	8	0	0
24	17419049	.	T	A	1	4	5	0	0	5	0	0
24	17419563	.	A	T	5	6	11	0	0	11	0	0
24	17419604	.	C	A	7	11	18	0	0	18	0	0
24	17419607	.	A	T	7	11	18	0	1	19	0	0
24	17420516	.	G	A	16	10	26	0	0	26	0	0
24	17420519	.	T	C	17	0	17	0	9	26	0	0
24	17420595	.	T	A	0	14	14	0	0	14	0	0
24	17420989	.	T	C	10	0	10	0	11	21	0	0
24	17421216	.	G	T	21	9	30	0	2	32	0	0
24	17421311	.	G	C	13	10	23	0	3	26	0	0
24	17465715	.	C	T	2	3	5	0	0	5	0	0
24	17465722	.	A	T	2	3	5	0	0	5	0	0
24	17505209	.	G	A	2	0	2	0	0	2	0	0
24	17505248	.	C	T	0	4	4	0	0	4	0	0
24	17733702	.	A	G	0	3	3	0	0	3	0	0
24	17733735	.	T	G	0	1	1	0	0	1	0	0
24	17736234	.	A	G	0	1	1	0	0	1	0	0
24	18376848	.	A	C	1	2	3	0	0	3	0	0
24	18444095	.	A	C	4	3	7	0	0	7	0	0
24	18444097	.	A	T	3	2	5	0	1	7	1	0
24	18444153	.	G	C	5	5	10	0	0	10	0	0
24	18444265	.	A	T	15	17	32	0	1	33	0	0
24	18444399	.	C	T	2	5	7	0	0	7	0	0
24	18444429	.	A	C	1	8	9	0	0	9	0	0
24	18444434	.	T	C	1	8	9	0	0	9	0	0
24	18444476	.	A	G	1	5	6	0	0	6	0	0
24	18445784	.	A	G	13	18	31	0	0	31	0	0
24	18446527	.	T	A	9	13	22	0	0	22	0	0
24	18446545	.	G	A	16	8	24	0	1	25	0	0
24	18486705	.	C	T	2	2	4	0	0	4	0	0
24	18487615	.	A	G	1	2	3	0	0	3	0	0
24	18521384	.	T	A	3	3	6	0	1	7	0	0
24	18521467	.	C	A	9	10	19	0	0	19	0	0
24	18549388	.	A	G	4	3	7	0	0	7	0	0
24	18549400	.	G	A	0	1	1	0	0	1	0	0
24	18553898	.	C	T	4	1	5	0	1	6	0	0
24	18557481	.	A	G	3	9	12	0	0	12	0	0
24	18563695	.	G	A	1	0	1	0	1	2	0	0
24	18599254	.	A	G	3	2	5	0	0	5	0	0
24	18724019	.	T	G	0	1	1	0	0	1	0	0
24	18731867	.	T	C	7	4	11	0	1	12	0	0
24	18731918	.	G	A	2	3	5	0	3	8	0	0
24	18737472	.	G	T	9	5	14	0	3	18	1	0
24	18746161	.	C	T	3	0	3	0	0	3	0	0
24	18750012	.	G	C	12	10	22	0	3	25	0	0
24	18751785	.	G	A	8	8	16	0	0	16	0	0
24	18751833	.	A	G	5	6	11	0	0	11	0	0
24	18752695	.	C	T	5	6	11	0	0	11	0	0
24	18757399	.	G	A	0	1	1	0	1	2	0	0
24	18769556	.	G	A	2	2	4	0	0	4	0	0
24	18769625	.	C	G	3	3	6	0	0	6	0	0
24	18769652	.	A	G	2	2	4	0	0	4	0	0
24	18776192	.	T	A	2	2	4	0	0	4	0	0
24	18776298	.	A	G	2	1	3	0	0	3	0	0
24	18777699	.	T	G	0	1	1	0	0	1	0	0
24	18780044	.	G	A	3	0	3	0	0	3	0	0
24	18780131	.	C	T	0	2	2	0	0	2	0	0
24	18782982	.	G	T	2	1	3	0	0	3	0	0
24	18783090	.	A	G	2	2	4	0	0	4	0	0
24	18783404	.	C	T	0	1	1	0	1	2	0	0
24	18783638	.	G	A	5	3	8	0	0	8	0	0
24	18794455	.	T	C	1	3	4	0	0	4	0	0
24	18797129	.	G	T	1	2	3	0	1	4	0	0
24	18797142	.	G	A	1	1	2	0	0	2	0	0
24	19190953	.	G	A	0	1	1	0	0	1	0	0
24	19206473	.	C	A	3	2	5	0	0	5	0	0
24	19249658	.	C	T	2	1	3	0	0	3	0	0
24	19260876	.	G	A	0	6	6	0	3	9	0	0
24	19260900	.	C	T	3	3	6	0	0	6	0	0
24	19402505	.	G	T	7	6	13	0	0	13	0	0
24	19402602	.	A	G	8	3	11	0	1	12	0	0
24	19586439	.	G	C	0	2	2	0	1	3	0	0
24	19695904	.	C	T	3	2	5	0	0	5	0	0
24	19695943	.	T	C	1	6	7	0	0	7	0	0
24	19696431	.	G	C	1	2	3	0	0	3	0	0
24	19696442	.	T	A	2	2	4	0	0	4	0	0
24	19696884	.	A	G	6	2	8	0	0	8	0	0
24	19697108	.	G	A	2	3	5	0	0	5	0	0
24	19707742	.	G	A	6	12	18	0	1	19	0	0
24	19707838	.	G	A	18	16	34	0	0	34	0	0
24	19708085	.	A	G	15	20	35	0	0	35	0	0
24	19708366	.	C	T	12	13	25	0	1	26	0	0
24	19708846	.	T	C	10	6	16	0	0	16	0	0
24	19708927	.	G	A	7	10	17	0	0	17	0	0
24	19709272	.	C	A	9	12	21	0	1	22	0	0
24	19711455	.	A	G	4	2	6	0	0	6	0	0
24	19719122	.	G	A	12	13	25	0	1	26	0	0
24	20064504	.	G	A	1	8	9	0	0	9	0	0
24	20064844	.	A	G	4	7	11	0	1	12	0	0
24	20064892	.	G	A	6	3	9	0	1	10	0	0
24	20064924	.	A	G	3	4	7	0	0	7	0	0
24	20065002	.	T	A	3	4	7	0	0	7	0	0
24	20065156	.	C	A	0	2	2	0	1	3	0	0
24	20065236	.	T	C	1	3	4	0	0	4	0	0
24	20065366	.	T	G	2	2	4	0	0	4	0	0
24	20065375	.	T	A	2	2	4	0	0	4	0	0
24	20066002	.	G	A	1	2	3	0	0	3	0	0
24	20066022	.	T	C	1	4	5	0	0	5	0	0
24	20066488	.	G	C	3	2	5	0	0	5	0	0
24	20200528	.	A	G	0	1	1	0	0	1	0	0
24	20200540	.	T	C	0	0	0	0	1	1	0	0
24	20328349	.	A	G	0	1	1	0	0	1	0	0
24	20328430	.	C	T	1	1	2	0	0	2	0	0
24	20329346	.	A	T	0	1	1	0	0	1	0	0
24	20334297	.	C	T	0	1	1	0	0	1	0	0
24	20334326	.	T	G	1	1	2	0	0	2	0	0
24	20334386	.	C	T	1	1	2	0	0	2	0	0
24	20336686	.	T	C	2	6	8	0	0	8	0	0
24	20336784	.	G	A	1	2	3	0	0	3	0	0
24	20450270	.	G	C	6	10	16	0	0	16	0	0
24	20450417	.	C	G	10	6	16	0	1	18	1	0
24	20450424	.	A	T	8	6	14	0	4	18	0	0
24	20450467	.	C	G	10	7	17	0	0	17	0	0
24	20450475	.	G	A	7	8	15	0	0	15	0	0
24	20450536	.	C	T	7	6	13	0	0	13	0	0
24	20450766	.	G	A	20	16	36	0	1	37	0	0
24	20450843	.	A	C	14	0	14	0	11	25	0	0
24	20501159	.	G	A	6	2	8	0	0	8	0	0
24	20531566	.	C	T	10	7	17	0	1	18	0	0
24	20531624	.	C	A	2	4	6	0	0	6	0	0
24	20531692	.	C	A	4	5	9	0	1	10	0	0
24	20542907	.	G	A	1	5	6	0	0	6	0	0
24	20542909	.	C	T	1	5	6	0	0	6	0	0
24	20552393	.	A	T	6	11	17	0	0	17	0	0
24	20552578	.	A	C	6	6	12	0	2	14	0	0
24	20554857	.	G	T	15	7	22	0	0	22	0	0
24	20554858	.	T	G	14	7	21	0	1	22	0	0
24	20589565	.	G	C	1	2	3	0	0	3	0	0
24	20600496	.	T	C	1	2	3	0	0	3	0	0
24	20600517	.	T	C	1	0	1	0	2	3	0	0
24	20600794	.	G	A	0	5	5	0	0	5	0	0
24	20628266	.	T	C	0	1	1	0	0	1	0	0
24	20644063	.	A	C	10	5	15	0	6	21	0	0
24	20644123	.	A	C	10	7	17	0	0	17	0	0
24	20644356	.	C	T	10	2	12	0	1	13	0	0
24	20644685	.	C	T	0	1	1	0	0	1	0	0
24	20645662	.	T	C	15	0	15	0	14	29	0	0
24	20646270	.	T	A	13	9	22	0	0	22	0	0
24	20646289	.	T	A	11	7	18	0	1	19	0	0
24	20647423	.	G	T	2	6	8	0	1	9	0	0
24	20648942	.	C	T	4	2	6	0	0	6	0	0
24	20648945	.	T	C	3	3	6	0	1	7	0	0
24	20658386	.	C	A	1	0	1	0	0	1	0	0
24	20893389	.	A	G	2	8	10	0	1	11	0	0
24	20897011	.	T	A	3	4	7	0	0	7	0	0
24	20897560	.	T	C	1	2	3	0	0	3	0	0
24	20897561	.	G	T	1	2	3	0	0	3	0	0
24	20913316	.	G	A	5	4	9	0	1	10	0	0
24	20913353	.	A	G	0	13	13	0	2	15	0	0
24	20913362	.	C	T	0	11	11	0	0	11	0	0
24	20917075	.	G	C	0	0	0	1	0	1	0	0
24	20918130	.	G	A	4	3	7	0	0	7	0	0
24	20918385	.	C	A	1	0	1	0	0	1	0	0
24	20918394	.	T	A	1	0	1	0	0	1	0	0
24	20920648	.	G	C	0	16	16	0	0	16	0	0
24	20921594	.	C	T	10	7	17	0	0	17	0	0
24	20921670	.	G	A	1	3	4	0	0	4	0	0
24	20922603	.	C	T	1	3	4	0	0	4	0	0
24	20941687	.	A	G	16	19	35	0	2	37	0	0
24	20941789	.	A	G	17	19	36	0	2	38	0	0
24	20942281	.	G	A	10	13	23	0	2	25	0	0
24	20942541	.	G	T	22	12	34	0	3	37	0	0
24	20946263	.	G	A	3	4	7	0	0	7	0	0
24	20946305	.	C	T	6	9	15	0	2	17	0	0
24	20948122	.	C	T	13	8	21	0	1	22	0	0
24	20949494	.	A	G	12	10	22	0	1	23	0	0
24	20953045	.	C	T	0	1	1	0	0	1	0	0
24	20968317	.	G	A	2	2	4	0	0	4	0	0
24	20968324	.	T	A	1	2	3	0	0	3	0	0
24	20968498	.	A	T	2	3	5	0	0	5	0	0
24	20968514	.	A	T	2	5	7	0	0	7	0	0
24	20969467	.	C	T	1	3	4	0	0	4	0	0
24	20969491	.	G	A	0	2	2	0	1	3	0	0
24	20980197	.	C	T	0	1	1	0	0	1	0	0
24	20984901	.	T	C	1	1	2	0	0	2	0	0
24	20987732	.	C	T	2	4	6	0	0	6	0	0
24	21005546	.	C	T	4	6	10	0	0	10	0	0
24	21005729	.	A	G	10	11	21	0	2	23	0	0
24	21005973	.	A	T	8	12	20	0	1	21	0	0
24	21060167	.	C	T	1	2	3	0	0	3	0	0
24	21154160	.	G	A	10	10	20	0	1	21	0	0
24	21154165	.	G	A	11	11	22	0	0	22	0	0
24	21154586	.	T	C	20	34	54	0	3	57	0	0
24	21157661	.	G	A	3	8	11	0	0	11	0	0
24	21167389	.	A	G	2	3	5	0	0	5	0	0
24	21167443	.	G	A	7	16	23	0	0	23	0	0
24	21167446	.	G	A	7	16	23	0	1	24	0	0
24	21167660	.	G	A	4	4	8	0	0	8	0	0
24	21167720	.	G	A	4	4	8	0	1	9	0	0
24	21172062	.	G	A	1	6	7	0	0	7	0	0
24	21179803	.	T	A	1	0	1	0	0	1	0	0
24	21182156	.	A	G	1	5	6	0	1	7	0	0
24	21182176	.	G	T	0	9	9	0	0	9	0	0
24	21182783	.	C	T	9	10	19	0	2	21	0	0
24	21183047	.	A	C	8	8	16	0	1	17	0	0
24	21183290	.	A	C	16	13	29	0	1	30	0	0
24	21183474	.	G	A	8	7	15	0	1	16	0	0
24	21198226	.	G	T	1	3	4	0	2	6	0	0
24	21198532	.	C	T	1	3	4	0	0	4	0	0
24	21200739	.	C	T	5	3	8	0	0	8	0	0
24	21200926	.	C	T	4	5	9	0	0	9	0	0
24	21200953	.	C	G	6	5	11	0	0	11	0	0
24	21201500	.	G	T	1	8	9	0	11	20	0	0
24	21201506	.	T	C	10	9	19	0	0	19	0	0
24	21201830	.	A	T	7	6	13	0	2	15	0	0
24	21201860	.	G	A	0	5	5	0	7	12	0	0
24	21202203	.	A	G	2	4	6	0	2	8	0	0
24	21202225	.	C	T	1	2	3	0	1	4	0	0
24	21202256	.	G	T	2	2	4	0	0	4	0	0
24	21202310	.	C	A	3	2	5	0	0	5	0	0
24	21206352	.	G	T	3	5	8	0	0	8	0	0
24	21207571	.	G	C	9	3	12	0	0	12	0	0
24	21220810	.	C	T	1	0	1	0	0	1	0	0
24	21222598	.	G	A	1	0	1	0	0	1	0	0
24	21333648	.	G	T	0	1	1	0	0	1	0	0
24	21361193	.	G	A	0	1	1	0	2	3	0	0
24	21371345	.	C	T	0	11	11	0	9	20	0	0
24	21371481	.	T	C	24	13	37	0	0	37	0	0
24	21371520	.	G	C	23	18	41	0	0	41	0	0
24	21371547	.	T	C	21	27	48	0	1	49	0	0
24	21371599	.	C	T	26	22	48	0	5	53	0	0
24	21371833	.	A	T	23	22	45	0	2	47	0	0
24	21372208	.	G	T	1	4	5	0	0	5	0	0
24	21382737	.	C	A	9	2	11	0	1	12	0	0
24	21411463	.	G	A	1	4	5	0	2	7	0	0
24	21411834	.	G	T	7	3	10	0	1	11	0	0
24	21411876	.	T	A	10	15	25	0	3	28	0	0
24	21417797	.	C	T	0	14	14	0	11	25	0	0
24	21417872	.	C	T	1	4	5	0	2	7	0	0
24	21502133	.	T	C	11	0	11	0	8	19	0	0
24	21502305	.	A	G	12	10	22	0	2	24	0	0
24	21502762	.	T	A	8	5	13	0	0	13	0	0
24	21502842	.	T	A	10	5	15	0	1	16	0	0
24	21502880	.	G	T	10	9	19	0	1	20	0	0
24	21503350	.	C	T	5	2	7	0	0	7	0	0
24	21503575	.	A	G	7	4	11	0	0	11	0	0
24	21503694	.	C	G	2	5	7	0	0	7	0	0
24	21503748	.	T	C	2	4	6	0	0	6	0	0
24	21504746	.	C	T	1	10	11	0	6	17	0	0
24	21504785	.	A	G	7	10	17	0	0	17	0	0
24	21504860	.	G	T	5	10	15	0	0	15	0	0
24	21505043	.	C	A	7	5	12	0	1	13	0	0
24	21505178	.	A	C	3	6	9	0	0	9	0	0
24	21505271	.	C	T	0	3	3	0	5	8	0	0
24	21505505	.	C	T	0	2	2	0	3	5	0	0
24	21505931	.	G	T	5	4	9	0	0	9	0	0
24	21538568	.	A	C	5	9	14	0	0	15	1	0
24	21538982	.	T	A	10	12	22	0	1	23	0	0
24	21539131	.	T	G	3	4	7	0	0	7	0	0
24	21561074	.	C	T	1	5	6	0	0	6	0	0
24	21567672	.	C	T	3	2	5	0	0	5	0	0
24	21568808	.	T	A	4	9	13	0	1	14	0	0
24	21572604	.	G	T	7	7	14	0	0	14	0	0
24	21575273	.	T	A	1	1	2	0	0	2	0	0
24	21575311	.	G	C	8	9	17	0	0	17	0	0
24	21575372	.	G	A	6	13	19	0	1	20	0	0
24	21575461	.	A	C	5	3	8	0	8	16	0	0
24	21575467	.	T	G	6	0	6	0	10	16	0	0
24	21577239	.	G	A	2	0	2	0	0	2	0	0
24	21577394	.	C	A	11	9	20	0	0	20	0	0
24	21577573	.	T	G	3	9	12	0	0	12	0	0
24	21577638	.	A	G	10	5	15	0	0	15	0	0
24	21584231	.	T	A	5	2	7	0	0	7	0	0
24	21585366	.	C	A	0	4	4	0	5	9	0	0
24	21586013	.	C	A	4	2	6	0	0	6	0	0
24	21586020	.	C	T	2	4	6	0	0	6	0	0
24	21586111	.	T	A	6	2	8	0	0	8	0	0
24	21586122	.	T	A	6	3	9	0	0	9	0	0
24	21586189	.	G	A	1	6	7	0	0	7	0	0
24	21586190	.	C	A	1	6	7	0	0	7	0	0
24	21586229	.	G	A	4	6	10	0	1	11	0	0
24	21586454	.	C	G	4	4	8	0	0	8	0	0
24	21600893	.	G	T	14	12	26	1	2	29	0	0
24	21625149	.	C	T	27	23	50	0	9	59	0	0
24	21650034	.	T	A	10	6	16	0	1	17	0	0
24	21650088	.	G	A	15	13	28	0	1	29	0	0
24	21657606	.	T	C	13	13	26	0	2	28	0	0
24	21659593	.	T	C	11	3	14	0	17	31	0	0
24	21659792	.	C	T	0	11	11	0	6	17	0	0
24	21659819	.	G	A	12	15	27	0	2	29	0	0
24	21659864	.	A	T	8	7	15	0	0	15	0	0
24	21671381	.	A	G	8	10	18	0	0	18	0	0
24	21671387	.	G	A	9	8	17	0	1	18	0	0
24	21671506	.	G	A	6	6	12	0	0	12	0	0
24	21679971	.	G	A	8	10	18	0	0	18	0	0
24	21680010	.	G	A	0	9	9	0	8	17	0	0
24	21680143	.	T	C	7	10	17	0	0	17	0	0
24	21680661	.	T	G	2	2	4	0	0	4	0	0
24	21680811	.	C	G	3	6	9	0	1	10	0	0
24	21680970	.	A	C	10	9	19	0	0	19	0	0
24	21681074	.	G	T	8	8	16	0	0	16	0	0
24	21681112	.	T	A	7	4	11	0	0	11	0	0
24	21681305	.	A	G	2	3	5	0	0	5	0	0
24	21729346	.	C	T	3	2	5	0	0	5	0	0
24	21735379	.	G	A	2	3	5	0	0	5	0	0
24	21735466	.	A	G	0	3	3	0	0	3	0	0
24	21735502	.	C	T	0	1	1	0	0	1	0	0
24	21738430	.	T	C	2	5	7	0	0	7	0	0
24	21744200	.	C	T	7	5	12	0	0	12	0	0
24	21744239	.	G	A	0	5	5	0	4	9	0	0
24	21744266	.	A	G	0	3	3	0	1	4	0	0
24	21747316	.	T	G	6	3	9	0	0	9	0	0
24	21747325	.	T	C	5	0	5	0	3	8	0	0
24	21747368	.	T	C	5	5	10	0	1	11	0	0
24	21747376	.	C	T	4	3	7	0	1	8	0	0
24	21747550	.	G	T	6	6	12	0	0	12	0	0
24	21747672	.	G	A	0	6	6	0	8	14	0	0
24	21748249	.	T	C	15	16	31	0	1	32	0	0
24	21748371	.	C	T	6	3	9	0	1	10	0	0
24	21781238	.	C	A	3	4	7	0	0	7	0	0
24	21781451	.	T	G	1	2	3	0	0	3	0	0
24	21867244	.	G	A	2	3	5	0	0	5	0	0
24	21917704	.	G	C	6	10	16	0	1	17	0	0
24	21917777	.	C	A	8	3	11	0	1	12	0	0
24	21917955	.	G	A	2	4	6	0	0	6	0	0
24	21927358	.	C	T	2	1	3	0	1	4	0	0
24	21927638	.	G	A	8	5	13	0	2	15	0	0
24	21927720	.	T	G	5	3	8	0	0	8	0	0
24	21928294	.	C	T	0	2	2	0	2	4	0	0
24	21960351	.	C	T	11	4	15	0	0	15	0	0
24	21960358	.	C	G	2	8	10	0	0	10	0	0
24	21960538	.	A	G	1	4	5	0	0	5	0	0
24	21960887	.	T	C	5	0	5	0	4	9	0	0
24	21960945	.	C	G	10	9	19	0	0	19	0	0
24	21978394	.	T	C	1	3	4	0	0	4	0	0
24	21978470	.	A	G	16	9	25	0	0	25	0	0
24	21978524	.	C	T	12	10	22	0	1	23	0	0
24	21978593	.	T	C	9	2	11	0	19	30	0	0
24	21978805	.	T	C	18	13	31	0	2	33	0	0
24	21984256	.	C	A	0	4	4	0	4	8	0	0
24	21989334	.	C	A	1	0	1	0	0	1	0	0
24	22070389	.	T	A	6	7	13	0	2	15	0	0
24	22070477	.	A	G	9	11	20	0	0	20	0	0
24	22070877	.	G	A	2	4	6	0	0	6	0	0
24	22070878	.	A	G	0	3	3	0	3	6	0	0
24	22071174	.	C	T	5	2	7	0	0	7	0	0
24	22071556	.	G	C	6	1	7	0	10	17	0	0
24	22071649	.	G	T	20	18	38	0	4	42	0	0
24	22100861	.	G	C	7	6	13	0	1	14	0	0
24	22122823	.	A	C	9	8	17	0	1	18	0	0
24	22122827	.	A	C	11	7	18	0	0	18	0	0
24	22122929	.	G	A	11	14	25	0	4	29	0	0
24	22123024	.	G	A	14	9	23	0	2	25	0	0
24	22123115	.	C	T	0	16	16	0	15	31	0	0
24	22123176	.	T	A	19	25	44	0	0	44	0	0
24	22123434	.	G	C	8	10	18	0	2	20	0	0
24	22123640	.	A	G	20	7	27	0	0	27	0	0
24	22123784	.	T	A	19	21	40	0	2	42	0	0
24	22123927	.	A	C	14	0	14	0	21	35	0	0
24	22123930	.	G	T	18	12	30	0	4	34	0	0
24	22174471	.	A	G	4	2	6	0	0	6	0	0
24	22219741	.	C	T	6	5	11	0	0	11	0	0
24	22219792	.	G	A	6	14	20	0	1	21	0	0
24	22219810	.	C	T	1	7	8	0	11	19	0	0
24	22254056	.	G	T	5	6	11	0	1	12	0	0
24	22275400	.	C	T	7	1	8	0	0	8	0	0
24	22275403	.	A	T	7	1	8	0	0	8	0	0
24	22291190	.	C	T	1	1	2	0	4	6	0	0
24	22291193	.	T	C	5	0	5	0	1	6	0	0
24	22395255	.	T	C	5	9	14	0	0	14	0	0
24	22412434	.	C	T	0	9	9	0	4	13	0	0
24	22533940	.	T	C	2	0	2	0	0	2	0	0
24	22737427	.	G	A	1	1	2	0	0	2	0	0
24	22740589	.	T	C	4	6	10	0	0	10	0	0
24	22740772	.	T	A	9	6	15	0	0	15	0	0
24	22744460	.	C	T	7	10	17	0	0	17	0	0
24	22744487	.	C	T	7	9	16	0	1	17	0	0
24	22744502	.	A	G	8	5	13	0	0	13	0	0
24	22746843	.	T	G	4	5	9	0	0	9	0	0
24	22759703	.	C	T	14	12	26	0	2	28	0	0
24	22769484	.	C	T	9	4	13	0	2	15	0	0
24	23213206	.	C	G	1	2	3	0	0	3	0	0
24	23213411	.	C	A	1	2	3	0	0	3	0	0
24	23213644	.	C	T	2	3	5	0	0	5	0	0
24	23214011	.	G	A	1	3	4	0	0	4	0	0
24	23243116	.	T	C	8	0	8	0	14	22	0	0
24	23243257	.	A	G	2	2	4	0	0	4	0	0
24	23243872	.	A	T	11	14	25	0	1	26	0	0
24	23243946	.	C	A	9	7	16	1	2	19	0	0
24	23244161	.	T	A	14	17	31	0	1	32	0	0
24	23250140	.	C	T	0	4	4	0	3	8	1	0
24	23687961	.	A	G	0	1	1	0	0	1	0	0
24	23690815	.	C	A	0	1	1	0	0	1	0	0
24	23716987	.	T	A	2	2	4	0	0	4	0	0
24	23716991	.	A	G	2	2	4	0	0	4	0	0
24	23717064	.	C	G	9	6	15	0	0	15	0	0
24	23717079	.	T	G	8	6	14	0	2	16	0	0
24	23720091	.	G	A	13	7	20	0	0	20	0	0
24	23723983	.	G	A	3	4	7	0	0	7	0	0
24	23747302	.	T	C	3	3	6	0	1	7	0	0
24	23758880	.	A	C	3	3	6	0	0	6	0	0
24	23759787	.	T	G	1	3	4	0	0	4	0	0
24	23838469	.	C	A	0	5	5	0	5	10	0	0
24	23838535	.	T	A	6	3	9	0	0	9	0	0
24	23838823	.	C	T	8	7	15	0	0	15	0	0
24	23839088	.	C	T	7	8	15	0	0	15	0	0
24	23839303	.	A	G	5	3	8	0	0	8	0	0
24	23839342	.	T	C	6	4	10	0	2	12	0	0
24	23839600	.	A	G	11	3	14	0	0	14	0	0
24	23884402	.	G	A	1	1	2	0	1	3	0	0
24	23931982	.	C	T	3	4	7	0	0	7	0	0
24	23937985	.	C	T	9	7	16	0	1	17	0	0
24	23942642	.	G	A	2	3	5	0	0	5	0	0
24	23971151	.	C	G	14	16	30	0	1	31	0	0
24	23971205	.	T	C	4	7	11	0	0	11	0	0
24	23974411	.	C	T	26	25	51	0	3	54	0	0
24	23974484	.	C	T	0	21	21	0	13	34	0	0
24	24027990	.	A	T	8	9	17	0	1	18	0	0
24	24028059	.	T	A	15	16	31	0	1	32	0	0
24	24102026	.	C	T	0	6	6	0	9	15	0	0
24	24102190	.	A	T	16	24	40	0	1	41	0	0
24	24102318	.	A	C	26	15	41	0	2	43	0	0
24	24108653	.	T	C	8	7	15	0	0	15	0	0
24	24110935	.	C	T	9	11	20	0	1	21	0	0
24	24111470	.	G	A	8	14	22	0	0	22	0	0
24	24111587	.	G	T	2	2	4	0	1	5	0	0
24	24114272	.	G	C	15	7	22	0	0	22	0	0
24	24114424	.	C	T	1	11	12	0	5	17	0	0
24	24114447	.	A	G	8	15	23	0	1	24	0	0
24	24114810	.	A	C	4	6	10	0	0	10	0	0
24	24115352	.	T	G	5	9	14	0	0	14	0	0
24	24115485	.	C	G	0	8	8	0	11	19	0	0
24	24115602	.	A	G	7	6	13	0	0	13	0	0
24	24115626	.	G	T	6	6	12	0	0	12	0	0
24	24118304	.	A	G	7	8	15	0	0	15	0	0
24	24120574	.	A	T	4	3	7	0	0	7	0	0
24	24121282	.	C	G	2	27	29	0	18	47	0	0
24	24121502	.	T	A	12	8	20	0	1	21	0	0
24	24121568	.	C	T	22	16	38	0	2	40	0	0
24	24121582	.	T	C	21	2	23	0	19	42	0	0
24	24122040	.	G	A	2	2	4	0	0	4	0	0
24	24129728	.	C	T	15	16	31	0	2	33	0	0
24	24130794	.	A	G	24	34	58	0	3	61	0	0
24	24130824	.	T	C	28	32	60	0	1	61	0	0
24	24136047	.	T	G	19	26	45	0	1	46	0	0
24	24146669	.	T	C	14	0	14	0	21	35	0	0
24	24146815	.	T	A	10	4	14	0	0	14	0	0
24	24155607	.	G	A	7	10	17	0	0	17	0	0
24	24155655	.	A	G	15	14	29	0	0	29	0	0
24	24155664	.	C	A	14	11	25	0	1	26	0	0
24	24155718	.	A	T	3	1	4	0	0	4	0	0
24	24159360	.	C	G	1	1	2	0	0	2	0	0
24	24164278	.	C	A	8	4	12	0	1	13	0	0
24	24164770	.	G	A	21	13	34	0	1	35	0	0
24	24164812	.	A	T	12	12	24	0	0	24	0	0
24	24165563	.	G	T	6	6	12	0	0	12	0	0
24	24168359	.	G	C	21	10	31	0	0	31	0	0
24	24168471	.	C	G	2	3	5	0	0	5	0	0
24	24171315	.	G	T	1	2	3	0	0	3	0	0
24	24175497	.	G	T	2	7	9	0	0	9	0	0
24	24176665	.	T	A	1	2	3	0	0	3	0	0
24	24177010	.	G	A	5	2	7	0	0	7	0	0
24	24177024	.	T	C	5	3	8	1	0	9	0	0
24	24177080	.	G	A	5	5	10	1	1	12	0	0
24	24177200	.	G	T	5	5	10	0	1	11	0	0
24	24177213	.	G	C	6	4	10	0	1	11	0	0
24	24184414	.	A	C	6	8	14	0	0	14	0	0
24	24273912	.	T	G	2	2	4	0	0	4	0	0
24	24274024	.	A	G	1	5	6	0	0	6	0	0
24	24287980	.	T	C	2	2	4	0	0	4	0	0
24	24288004	.	T	C	2	2	4	0	0	4	0	0
24	24288223	.	T	C	5	3	8	0	1	9	0	0
24	24299421	.	G	A	0	2	2	0	3	5	0	0
24	24299597	.	T	C	5	4	9	0	0	9	0	0
24	24300125	.	C	T	4	3	7	0	0	7	0	0
24	24417438	.	A	G	0	2	2	0	0	2	0	0
24	24417480	.	G	A	0	1	1	0	0	1	0	0
24	24462036	.	G	C	0	12	12	0	14	26	0	0
24	24462081	.	C	T	14	12	26	0	1	27	0	0
24	24463212	.	T	A	21	15	36	0	1	37	0	0
24	25025864	.	C	T	0	1	1	0	0	1	0	0
24	25351091	.	A	G	2	4	6	0	0	6	0	0
24	25351121	.	T	C	1	6	7	0	0	7	0	0
24	25351172	.	A	T	1	4	5	0	0	5	0	0
24	25351368	.	A	T	4	4	8	0	0	8	0	0
24	25351588	.	T	G	3	6	9	0	1	10	0	0
24	25351649	.	A	G	4	5	9	0	0	9	0	0
24	25351693	.	A	G	4	4	8	0	0	8	0	0
24	25352109	.	G	A	6	3	9	0	0	9	0	0
24	25352187	.	A	C	3	0	3	0	4	7	0	0
24	25352561	.	A	G	2	2	4	0	0	4	0	0
24	25448185	.	C	A	1	12	13	0	3	16	0	0
24	25448374	.	G	A	8	4	12	0	1	13	0	0
24	25448475	.	C	T	2	3	5	0	0	5	0	0
24	25449245	.	A	C	2	3	5	0	1	6	0	0
24	25449319	.	G	A	5	6	11	0	2	13	0	0
24	25452620	.	G	A	6	2	8	0	0	8	0	0
24	25458885	.	T	C	2	2	4	0	0	4	0	0
24	25496133	.	T	C	7	6	13	0	1	14	0	0
24	25496194	.	A	C	3	7	10	0	0	10	0	0
24	25496215	.	T	G	1	6	7	0	1	8	0	0
24	25496271	.	C	T	3	3	6	0	0	6	0	0
24	25496318	.	A	G	3	0	3	0	5	8	0	0
24	25496336	.	G	C	3	6	9	0	0	9	0	0
24	25496435	.	T	C	5	5	10	0	0	10	0	0
24	25496590	.	T	C	6	5	11	0	0	11	0	0
24	25496789	.	T	C	7	7	14	0	0	14	0	0
24	25497036	.	A	T	8	9	17	0	0	17	0	0
24	25497189	.	G	A	10	6	16	0	1	17	0	0
24	25497236	.	A	C	9	6	15	0	0	15	0	0
24	25497273	.	A	T	6	6	12	0	0	12	0	0
24	25497412	.	C	A	6	9	15	0	0	15	0	0
24	25497414	.	A	T	5	8	13	0	3	16	0	0
24	25497477	.	G	T	9	7	16	0	0	16	0	0
24	25497680	.	G	T	6	9	15	0	1	16	0	0
24	25498256	.	C	G	4	1	5	0	0	5	0	0
24	25498880	.	G	T	1	2	3	0	0	3	0	0
24	25499010	.	T	A	0	2	2	0	0	2	0	0
24	25514777	.	A	T	6	2	8	0	3	11	0	0
24	25525977	.	G	T	9	4	13	0	0	13	0	0
24	25526192	.	C	A	6	5	11	0	0	11	0	0
24	25535863	.	T	C	2	6	8	0	0	8	0	0
24	25564486	.	T	A	3	1	4	0	0	4	0	0
24	25602136	.	G	T	0	1	1	0	0	1	0	0
24	25635801	.	C	T	1	1	2	0	0	2	0	0
24	26196647	.	A	G	1	2	3	0	0	3	0	0
24	26901690	.	T	C	0	3	3	0	0	3	0	0
24	26901727	.	G	A	0	2	2	0	2	4	0	0
24	26901737	.	T	G	4	0	4	0	2	6	0	0
24	26936841	.	T	C	3	2	5	0	0	5	0	0
24	26941996	.	A	G	10	10	20	0	0	20	0	0
24	26942242	.	C	G	11	10	21	0	0	21	0	0
24	26942614	.	C	T	1	8	9	0	11	20	0	0
24	26948933	.	A	T	2	4	6	0	0	6	0	0
24	26949229	.	T	C	7	6	13	0	2	15	0	0
24	26949426	.	A	C	4	7	11	0	2	13	0	0
24	26949555	.	T	G	7	5	12	0	2	14	0	0
24	26962107	.	G	A	1	1	2	0	0	2	0	0
24	26962277	.	C	T	5	4	9	0	1	10	0	0
24	26970936	.	T	C	0	0	0	0	1	1	0	0
24	26980770	.	A	C	2	2	4	0	0	4	0	0
24	26997881	.	T	G	1	2	3	0	0	3	0	0
24	26998086	.	T	A	1	3	4	0	1	5	0	0
24	27009231	.	C	A	1	0	1	0	0	1	0	0
24	27013469	.	A	T	4	7	11	0	0	11	0	0
24	27168681	.	T	C	0	1	1	0	0	1	0	0
24	27169734	.	T	C	0	2	2	0	0	2	0	0
24	27181057	.	G	A	2	4	6	0	0	6	0	0
24	27181135	.	A	G	2	0	2	0	3	5	0	0
24	27185574	.	A	G	13	4	17	0	0	17	0	0
24	27207238	.	G	T	5	7	12	0	1	13	0	0
24	27222574	.	G	A	7	8	15	0	1	16	0	0
24	27222610	.	A	C	12	15	27	0	0	27	0	0
24	27222662	.	C	T	11	14	25	0	0	25	0	0
24	27222713	.	A	G	10	0	10	0	12	22	0	0
24	27222731	.	A	G	9	0	9	0	16	25	0	0
24	27222937	.	G	A	0	15	15	0	11	26	0	0
24	27223018	.	C	T	9	4	13	0	0	13	0	0
24	27224383	.	T	A	23	14	37	0	5	42	0	0
24	27224415	.	G	A	15	18	33	0	2	35	0	0
24	27224484	.	A	T	15	16	31	0	6	37	0	0
24	27224598	.	G	A	9	3	12	0	0	12	0	0
24	27224842	.	G	A	16	12	28	0	2	30	0	0
24	27224990	.	G	A	20	20	40	0	2	42	0	0
24	27225423	.	C	A	11	13	24	0	1	25	0	0
24	27225842	.	A	G	9	10	19	0	0	19	0	0
24	27226044	.	A	G	4	6	10	0	1	11	0	0
24	27236653	.	C	T	5	10	15	0	1	16	0	0
24	27236716	.	T	C	16	9	25	0	1	26	0	0
24	27238527	.	G	A	4	0	4	0	0	4	0	0
24	27713822	.	G	A	2	3	5	0	2	7	0	0
24	27714331	.	C	T	3	6	9	0	1	10	0	0
24	27714338	.	C	T	3	6	9	0	0	9	0	0
24	27783955	.	G	A	5	6	11	0	0	11	0	0
24	27783982	.	G	A	6	6	12	0	0	12	0	0
24	27784009	.	C	T	4	10	14	0	0	14	0	0
24	27784036	.	A	G	8	15	23	0	0	23	0	0
24	27784057	.	T	C	7	11	18	0	1	19	0	0
24	27784102	.	C	G	6	9	15	0	1	16	0	0
24	27784129	.	A	G	10	9	19	0	0	19	0	0
24	27784210	.	G	T	5	11	16	0	0	16	0	0
24	27784246	.	G	A	7	10	17	0	0	17	0	0
24	27784342	.	A	G	6	6	12	0	0	12	0	0
24	27784444	.	G	A	6	2	8	0	1	9	0	0
24	28137355	.	G	A	2	5	7	0	0	7	0	0
24	28228495	.	G	A	6	3	9	0	1	10	0	0
24	28228572	.	G	A	2	2	4	0	0	4	0	0
24	28252605	.	C	T	6	3	9	0	0	9	0	0
24	28252608	.	C	T	3	6	9	0	0	9	0	0
24	28252677	.	T	A	4	5	9	0	1	10	0	0
24	28252699	.	G	A	5	4	9	0	1	10	0	0
24	28253646	.	A	T	11	8	19	0	0	19	0	0
24	28253663	.	G	A	10	3	13	0	0	13	0	0
24	28253782	.	A	T	15	9	24	0	0	24	0	0
24	28253802	.	T	C	10	0	10	0	15	25	0	0
24	28258991	.	G	A	0	1	1	0	0	1	0	0
24	28259011	.	G	A	0	2	2	0	0	2	0	0
24	28259128	.	C	T	6	4	10	0	0	10	0	0
24	28426131	.	A	T	7	13	20	0	0	20	0	0
24	28426244	.	G	C	8	10	18	0	2	20	0	0
24	28426597	.	G	A	26	15	41	0	0	41	0	0
24	28426617	.	C	T	0	16	16	0	23	39	0	0
24	28432465	.	C	T	5	7	12	0	0	12	0	0
24	28557186	.	T	A	1	2	3	0	0	3	0	0
24	28645142	.	T	A	1	2	3	0	0	3	0	0
24	28686815	.	C	T	0	4	4	0	4	8	0	0
24	28687245	.	A	C	4	0	4	0	3	7	0	0
24	28687253	.	G	A	5	6	11	0	0	11	0	0
24	28687424	.	C	T	0	8	8	0	15	23	0	0
24	28687783	.	G	T	10	12	22	0	0	22	0	0
24	28688137	.	G	A	9	8	17	0	2	19	0	0
24	28688416	.	G	A	7	9	16	0	0	16	0	0
24	28691389	.	C	T	5	1	6	0	2	8	0	0
24	28691457	.	C	T	1	6	7	0	5	12	0	0
24	28764251	.	A	C	2	2	4	0	0	4	0	0
24	28764825	.	G	T	0	0	0	0	4	4	0	0
24	28949511	.	G	A	2	4	6	0	0	6	0	0
24	28966892	.	T	C	4	3	7	0	0	7	0	0
24	28967895	.	G	T	0	2	2	0	1	3	0	0
24	30182391	.	G	A	0	3	3	0	3	6	0	0
24	30194386	.	G	A	0	1	1	0	0	1	0	0
24	30352234	.	C	T	3	1	4	0	0	4	0	0
24	30352907	.	T	C	13	16	29	0	1	30	0	0
24	30352940	.	T	A	14	13	27	0	2	29	0	0
24	30353036	.	T	A	20	11	31	0	2	33	0	0
24	30353065	.	G	A	18	13	31	0	3	34	0	0
24	30353083	.	G	A	18	16	34	0	1	35	0	0
24	30353298	.	A	G	11	10	21	0	2	23	0	0
24	30353447	.	T	C	14	12	26	0	1	27	0	0
24	30353683	.	A	G	8	14	22	0	0	22	0	0
24	30353825	.	A	G	8	0	8	0	5	13	0	0
24	30353893	.	C	A	10	10	20	0	1	21	0	0
24	30353918	.	C	T	11	11	22	0	0	22	0	0
24	30835934	.	T	C	5	6	11	0	0	11	0	0
24	30835936	.	A	G	5	5	10	0	1	11	0	0
24	30836042	.	C	T	9	3	12	0	0	12	0	0
24	30837512	.	A	G	0	2	2	0	0	2	0	0
24	30845845	.	G	A	4	3	7	0	0	7	0	0
24	30845875	.	G	C	3	0	3	0	2	5	0	0
24	30845893	.	C	T	3	1	4	0	0	4	0	0
24	30852329	.	C	T	0	2	2	0	2	4	0	0
24	30855507	.	A	G	0	1	1	0	0	1	0	0
24	30862120	.	C	A	3	3	6	0	0	6	0	0
24	31098720	.	A	G	12	6	18	0	0	18	0	0
24	31098874	.	G	T	2	8	10	0	0	10	0	0
24	31140110	.	G	A	2	1	3	0	0	3	0	0
24	31140187	.	A	T	2	5	7	0	1	8	0	0
24	31140251	.	A	G	1	3	4	0	0	4	0	0
24	31140269	.	C	T	1	3	4	0	0	4	0	0
24	31140293	.	G	A	3	4	7	0	0	7	0	0
24	31170558	.	T	A	11	14	25	0	2	27	0	0
24	31170751	.	A	T	2	2	4	0	1	5	0	0
24	31171057	.	T	A	4	5	9	0	0	9	0	0
24	31171285	.	G	A	7	3	10	0	1	11	0	0
24	31171417	.	G	A	4	5	9	0	0	9	0	0
24	31171468	.	A	T	3	5	8	0	0	8	0	0
24	31176087	.	A	G	4	1	5	0	0	5	0	0
24	31286187	.	A	C	0	1	1	0	0	1	0	0
24	31310849	.	T	A	7	7	14	0	1	15	0	0
24	31311185	.	T	G	3	2	5	0	0	5	0	0
24	31311323	.	C	G	0	7	7	0	9	16	0	0
24	31311334	.	G	C	5	6	11	0	1	12	0	0
24	31315985	.	A	G	0	1	1	0	0	1	0	0
24	31319592	.	C	T	0	1	1	0	1	2	0	0
24	31323287	.	A	C	2	1	3	0	0	3	0	0
24	31323293	.	G	A	3	2	5	0	0	5	0	0
24	31330040	.	G	A	0	3	3	0	0	3	0	0
24	31334313	.	A	G	10	8	18	0	1	19	0	0
24	31340819	.	A	T	8	8	16	0	2	18	0	0
24	31346647	.	G	T	17	26	43	0	1	44	0	0
24	31364654	.	A	G	2	0	2	0	2	4	0	0
24	31367612	.	C	T	3	4	7	0	2	9	0	0
24	31367880	.	A	G	4	0	4	0	3	7	0	0
24	31367891	.	C	T	3	4	7	0	0	7	0	0
24	31367999	.	A	G	2	4	6	0	0	6	0	0
24	31397840	.	G	A	2	3	5	0	1	6	0	0
24	31398002	.	A	G	3	1	4	0	0	4	0	0
24	31404580	.	C	G	11	7	18	0	1	19	0	0
24	31832549	.	G	A	6	7	13	0	2	15	0	0
24	31832615	.	T	G	5	3	8	0	1	9	0	0
24	31832657	.	G	A	6	8	14	0	0	14	0	0
24	31833114	.	A	T	9	11	20	0	3	23	0	0
24	31833991	.	G	A	6	7	13	0	0	13	0	0
24	31834286	.	A	G	6	9	15	0	0	15	0	0
24	31834396	.	G	A	4	10	14	0	2	16	0	0
24	31834681	.	A	T	5	7	12	0	1	13	0	0
24	31836483	.	A	T	7	3	10	0	1	11	0	0
24	31838972	.	T	C	3	2	5	0	0	5	0	0
24	31838995	.	C	A	1	3	4	0	0	4	0	0
24	31846257	.	C	T	0	1	1	0	0	1	0	0
24	31846871	.	G	A	0	3	3	0	0	3	0	0
24	32152921	.	T	C	1	3	4	0	0	4	0	0
24	32163896	.	C	A	0	3	3	0	4	8	1	0
24	32164027	.	C	T	2	4	6	0	0	6	0	0
24	32176448	.	C	T	13	16	29	0	0	29	0	0
24	32176499	.	T	C	22	11	33	0	1	34	0	0
24	32180747	.	C	T	2	7	9	0	0	9	0	0
24	32192518	.	G	A	0	36	36	0	17	53	0	0
24	32192529	.	T	C	19	32	51	0	1	52	0	0
24	32192558	.	G	A	14	27	41	0	2	43	0	0
24	32192622	.	T	C	11	16	27	0	1	28	0	0
24	32473291	.	C	T	12	10	22	0	2	24	0	0
24	32473326	.	C	G	11	0	11	0	13	24	0	0
24	32473386	.	C	T	13	11	24	0	0	24	0	0
24	32473464	.	T	C	7	8	15	0	0	15	0	0
24	32473594	.	C	G	5	3	8	0	0	8	0	0
24	32473750	.	G	A	2	2	4	0	0	4	0	0
24	32473821	.	G	A	3	3	6	0	1	7	0	0
24	32473829	.	A	G	3	7	10	0	0	10	0	0
24	32474070	.	G	C	5	7	12	0	0	12	0	0
24	32474439	.	A	T	2	2	4	0	0	4	0	0
24	32474546	.	A	C	6	17	23	0	0	23	0	0
24	32519528	.	C	T	1	18	19	0	26	45	0	0
24	32522526	.	A	G	24	25	49	0	2	51	0	0
24	32522577	.	A	T	11	7	18	0	1	19	0	0
24	32533158	.	G	C	1	1	2	0	0	2	0	0
24	32536869	.	T	C	1	0	1	0	0	1	0	0
24	32547755	.	T	C	2	4	6	0	0	6	0	0
24	32547920	.	A	G	3	0	3	0	5	8	0	0
24	32547926	.	A	C	6	3	9	0	0	9	0	0
24	32548038	.	A	C	5	3	8	0	1	9	0	0
24	32658577	.	C	T	0	2	2	0	0	2	0	0
24	32664790	.	A	T	6	4	10	0	0	10	0	0
24	32664823	.	T	G	4	14	18	0	0	18	0	0
24	32664870	.	A	C	1	8	9	0	2	11	0	0
24	32668834	.	G	A	10	5	15	0	0	15	0	0
24	32668880	.	T	A	6	6	12	0	1	13	0	0
24	32674686	.	T	A	9	11	20	0	0	20	0	0
24	32674798	.	T	G	11	0	11	1	13	25	0	0
24	32674886	.	A	G	6	9	15	0	1	16	0	0
24	33234934	.	T	C	1	0	1	0	2	3	0	0
24	33280005	.	T	C	5	4	9	0	0	9	0	0
24	33280006	.	A	T	6	3	9	0	0	9	0	0
24	33280061	.	C	T	1	2	3	0	1	4	0	0
24	33283197	.	G	A	2	1	3	0	1	4	0	0
24	33284689	.	G	A	5	6	11	0	0	11	0	0
24	33290326	.	A	G	2	0	2	0	0	2	0	0
24	33290618	.	T	G	2	2	4	0	0	4	0	0
24	33400863	.	C	T	1	0	1	0	0	1	0	0
24	33401158	.	C	T	1	1	2	0	0	2	0	0
24	33403328	.	G	A	0	1	1	0	2	3	0	0
24	33411157	.	A	C	1	0	1	0	0	1	0	0
24	33696694	.	C	G	3	2	5	0	0	5	0	0
24	33709143	.	G	C	3	14	17	0	8	25	0	0
24	33709247	.	C	G	23	31	54	0	3	57	0	0
24	33714797	.	A	G	24	14	38	0	0	38	0	0
24	33714854	.	G	A	6	3	9	0	0	9	0	0
24	33723289	.	C	A	0	3	3	0	7	10	0	0
24	33755683	.	C	T	15	17	32	0	2	34	0	0
24	33767992	.	T	C	7	8	15	0	0	15	0	0
24	33768192	.	G	A	1	4	5	0	0	5	0	0
24	33768346	.	T	A	9	2	11	1	0	12	0	0
24	33768705	.	A	G	4	5	9	0	0	9	0	0
24	33777341	.	C	T	0	2	2	0	1	3	0	0
24	33785746	.	G	C	1	2	3	0	0	3	0	0
24	33785898	.	G	A	0	1	1	0	0	1	0	0
24	33790094	.	G	A	7	2	9	0	0	9	0	0
24	33813573	.	A	G	1	0	1	0	2	3	0	0
24	33824554	.	G	A	0	4	4	0	1	5	0	0
24	33824590	.	A	G	2	1	3	0	2	5	0	0
24	33824635	.	C	T	4	5	9	0	0	9	0	0
24	33832513	.	G	A	3	1	4	0	0	4	0	0
24	33835259	.	T	G	4	7	11	0	0	11	0	0
24	33836380	.	A	T	2	2	4	0	0	4	0	0
24	33836490	.	T	A	3	3	6	0	1	7	0	0
24	33837196	.	A	G	2	6	8	0	1	9	0	0
24	33837342	.	A	T	0	3	3	0	0	3	0	0
24	33837470	.	A	G	5	1	6	0	1	7	0	0
24	33837595	.	A	G	5	2	7	0	0	7	0	0
24	33837636	.	G	T	5	4	9	0	1	10	0	0
24	33837753	.	A	G	7	8	15	0	0	15	0	0
24	33837865	.	A	G	1	1	2	0	0	2	0	0
24	33837898	.	T	G	3	2	5	0	0	5	0	0
24	33837923	.	A	G	5	3	8	0	0	8	0	0
24	33838012	.	A	C	2	6	8	0	0	9	1	0
24	33838097	.	A	G	6	3	9	0	0	9	0	0
24	33838105	.	A	G	6	2	8	0	1	9	0	0
24	33838293	.	A	G	6	12	18	0	0	18	0	0
24	33838533	.	T	G	3	0	3	0	5	8	0	0
24	33838753	.	G	A	4	4	8	0	1	9	0	0
24	33838876	.	A	G	4	0	4	0	15	19	0	0
24	33838954	.	A	C	10	6	16	0	0	16	0	0
24	33839031	.	G	A	9	8	17	0	1	18	0	0
24	33839211	.	T	C	3	3	6	0	1	7	0	0
24	33839221	.	A	C	2	3	5	0	0	5	0	0
24	33873397	.	C	T	0	3	3	0	1	4	0	0
24	34034647	.	T	G	1	2	3	0	0	3	0	0
24	34115661	.	G	C	6	5	11	0	0	11	0	0
24	34115850	.	G	A	0	6	6	0	2	8	0	0
24	34116386	.	G	C	2	3	5	0	0	5	0	0
24	34116399	.	C	T	2	2	4	0	0	4	0	0
24	34139278	.	G	A	2	8	10	0	0	10	0	0
24	34139317	.	C	T	2	6	8	0	1	9	0	0
24	34139323	.	T	C	1	0	1	0	5	6	0	0
24	34185357	.	G	T	3	2	5	0	0	5	0	0
24	34185364	.	G	A	4	2	6	0	0	6	0	0
24	34208747	.	A	G	1	1	2	0	0	2	0	0
24	34284596	.	G	T	5	6	11	0	1	12	0	0
24	34607240	.	C	T	9	6	15	0	0	15	0	0
24	34607282	.	C	G	10	4	14	0	1	15	0	0
24	34608653	.	C	T	9	16	25	0	0	25	0	0
24	34608844	.	C	T	4	9	13	0	3	16	0	0
24	34610215	.	G	T	0	10	10	0	15	25	0	0
24	34610391	.	T	C	11	4	15	0	0	15	0	0
24	34610515	.	G	A	13	12	25	0	1	26	0	0
24	34610655	.	G	A	0	8	8	0	11	19	0	0
24	34610874	.	A	G	12	16	28	0	3	31	0	0
24	34610920	.	A	T	10	16	26	0	0	26	0	0
24	34611151	.	T	C	15	14	29	0	1	30	0	0
24	34611211	.	G	A	24	11	35	0	2	37	0	0
24	34611236	.	G	A	1	11	12	0	24	36	0	0
24	34611407	.	G	C	18	20	38	0	3	41	0	0
24	34611445	.	A	G	18	16	34	0	1	35	0	0
24	34611681	.	C	T	19	7	26	0	4	30	0	0
24	34611779	.	T	A	7	7	14	0	0	14	0	0
24	34611798	.	C	T	6	4	10	0	1	11	0	0
24	34611885	.	T	A	16	12	28	0	1	29	0	0
24	34611915	.	A	G	15	0	15	0	10	25	0	0
24	34612123	.	A	G	9	15	24	0	1	25	0	0
24	34612160	.	A	G	11	19	30	0	0	30	0	0
24	34612187	.	C	A	13	16	29	0	1	30	0	0
24	34612327	.	A	T	21	18	39	0	0	39	0	0
24	34612564	.	G	A	3	17	20	0	20	40	0	0
24	34974105	.	C	T	3	3	6	0	0	6	0	0
24	34976187	.	A	G	3	0	3	0	4	7	0	0
24	34976465	.	G	A	0	1	1	0	1	2	0	0
24	34991185	.	A	G	14	7	21	0	1	22	0	0
24	34993400	.	A	G	5	7	12	0	0	12	0	0
24	34993406	.	T	C	3	6	9	0	0	9	0	0
24	34996173	.	C	T	11	14	25	0	0	25	0	0
24	35000961	.	G	T	0	1	1	0	1	2	0	0
24	35196205	.	C	G	8	5	13	0	0	13	0	0
24	35216541	.	C	T	25	20	45	0	0	45	0	0
24	35216973	.	C	T	7	8	15	0	0	15	0	0
24	35217222	.	A	T	13	18	31	0	0	31	0	0
24	35217302	.	T	G	10	7	17	0	0	17	0	0
24	35217426	.	C	T	10	15	25	0	3	28	0	0
24	35218334	.	G	A	0	2	2	0	1	3	0	0
24	35218336	.	T	G	1	2	3	0	0	3	0	0
24	35218874	.	A	G	9	6	15	0	0	15	0	0
24	35218889	.	A	G	3	10	13	0	0	13	0	0
24	35219022	.	C	A	7	3	10	0	0	10	0	0
24	35219031	.	G	A	7	1	8	0	1	9	0	0
24	35219128	.	A	T	2	5	7	0	0	7	0	0
24	35269903	.	G	T	1	2	3	0	0	3	0	0
24	35269915	.	A	G	1	2	3	0	0	3	0	0
24	35522379	.	A	T	9	9	18	0	0	18	0	0
24	35522417	.	C	A	13	9	22	0	2	24	0	0
24	35522568	.	C	T	27	16	43	0	2	45	0	0
24	35522962	.	A	G	22	27	49	0	1	50	0	0
24	35523088	.	A	T	24	24	48	0	8	57	1	0
24	35523135	.	T	A	30	16	46	0	1	47	0	0
24	35530249	.	T	G	15	23	38	0	1	39	0	0
24	35536906	.	C	A	1	5	6	0	1	7	0	0
24	35537156	.	G	A	1	2	3	0	0	3	0	0
24	35565350	.	C	G	11	0	11	0	14	25	0	0
24	35681625	.	G	A	24	22	46	0	3	49	0	0
24	35681753	.	G	A	2	4	6	0	0	6	0	0
24	35683349	.	T	C	8	4	12	0	1	13	0	0
24	35683883	.	A	G	14	28	42	0	0	42	0	0
24	35686180	.	A	G	20	13	33	0	1	34	0	0
24	35692741	.	C	T	0	0	0	0	1	1	0	0
24	35713710	.	T	C	5	3	8	0	0	8	0	0
24	35720364	.	G	A	1	0	1	0	0	1	0	0
24	35720498	.	C	T	0	5	5	0	7	12	0	0
24	35742791	.	A	G	2	2	4	0	0	4	0	0
24	35749830	.	T	C	0	2	2	0	0	2	0	0
24	35749858	.	C	A	0	2	2	0	0	2	0	0
24	35899121	.	A	G	1	0	1	0	0	1	0	0
24	35899358	.	A	G	0	0	0	0	3	3	0	0
24	35906191	.	G	A	2	6	8	0	6	14	0	0
24	35918445	.	C	G	2	2	4	0	0	4	0	0
24	35925145	.	T	C	1	2	3	0	0	3	0	0
24	35925163	.	C	A	3	3	6	0	0	6	0	0
24	35925322	.	C	T	0	1	1	0	0	1	0	0
24	35925499	.	T	C	0	1	1	0	1	2	0	0
24	35925529	.	T	C	1	2	3	0	1	4	0	0
24	35926460	.	C	T	2	1	3	0	0	3	0	0
24	35926476	.	C	G	2	1	3	0	0	3	0	0
24	35929814	.	A	C	1	2	3	0	0	3	0	0
24	35930005	.	A	C	4	6	10	0	0	10	0	0
24	35930056	.	T	G	3	4	7	0	1	8	0	0
24	36027212	.	T	C	10	14	24	0	2	26	0	0
24	36129239	.	T	C	1	0	1	0	3	4	0	0
24	36166121	.	T	G	2	2	4	0	1	5	0	0
24	36175078	.	G	A	0	0	0	0	1	1	0	0
24	36177597	.	A	C	9	8	17	0	0	17	0	0
24	36177609	.	T	C	13	9	22	0	1	23	0	0
24	36178063	.	C	G	6	5	11	0	1	12	0	0
24	36180824	.	C	T	1	5	6	0	0	6	0	0
24	36182443	.	A	G	3	2	5	0	0	5	0	0
24	36182455	.	G	A	3	4	7	0	0	7	0	0
24	36182503	.	G	C	2	3	5	0	0	5	0	0
24	36187933	.	A	T	1	0	1	0	0	1	0	0
24	36193431	.	C	T	0	1	1	0	3	4	0	0
24	36193557	.	C	A	7	3	10	0	0	10	0	0
24	36193938	.	A	C	2	2	4	0	0	4	0	0
24	36193974	.	G	A	2	3	5	0	0	5	0	0
24	36193988	.	T	G	3	3	6	0	0	6	0	0
24	36194330	.	T	C	1	5	6	0	0	6	0	0
24	36194365	.	C	T	1	5	6	0	0	6	0	0
24	36194586	.	G	A	3	3	6	0	0	6	0	0
24	36213074	.	T	C	2	3	5	0	0	5	0	0
24	36223627	.	T	C	1	3	4	0	0	4	0	0
24	36227170	.	G	T	2	3	5	0	0	5	0	0
24	36244407	.	C	T	3	4	7	0	1	8	0	0
24	36247261	.	A	T	0	3	3	0	0	3	0	0
24	36248705	.	C	T	0	2	2	0	0	2	0	0
24	36249910	.	G	T	2	1	3	0	0	3	0	0
24	36250403	.	T	C	1	1	2	0	0	2	0	0
24	36253324	.	C	T	19	20	39	0	3	42	0	0
24	36261445	.	T	C	1	2	3	0	0	3	0	0
24	36261730	.	C	T	0	1	1	0	2	3	0	0
24	36266484	.	A	G	1	1	2	0	1	3	0	0
24	36266649	.	T	C	0	0	0	0	1	1	0	0
24	36271269	.	T	A	7	4	11	0	0	11	0	0
24	36271274	.	T	A	6	5	11	0	0	11	0	0
24	36275987	.	C	T	3	4	7	0	0	7	0	0
24	36276035	.	A	C	1	6	7	0	0	7	0	0
24	36276087	.	A	G	2	7	9	0	1	10	0	0
24	36276363	.	A	G	5	8	13	0	1	14	0	0
24	36276364	.	G	T	6	7	13	0	1	14	0	0
24	36280272	.	A	G	1	3	4	0	0	4	0	0
24	36280296	.	T	G	1	4	5	0	0	5	0	0
24	36284470	.	G	A	2	5	7	0	0	7	0	0
24	36289642	.	T	C	1	0	1	0	0	1	0	0
24	36295355	.	C	T	1	2	3	0	0	3	0	0
24	36295817	.	A	G	0	6	6	0	0	6	0	0
24	36295833	.	G	C	0	5	5	0	0	5	0	0
24	36298928	.	G	A	6	3	9	0	1	10	0	0
24	36298934	.	G	A	6	3	9	0	0	9	0	0
24	36298963	.	A	G	3	2	5	0	0	5	0	0
24	36325256	.	C	G	4	2	6	0	0	6	0	0
24	36325262	.	C	G	4	2	6	0	0	6	0	0
24	36329292	.	A	G	2	2	4	0	0	4	0	0
24	36329668	.	G	A	1	3	4	0	0	4	0	0
24	36329671	.	A	C	0	2	2	0	2	4	0	0
24	36331134	.	T	A	1	2	3	0	0	3	0	0
24	36331150	.	A	G	2	4	6	0	0	6	0	0
24	36331180	.	G	C	1	5	6	0	0	6	0	0
24	36331207	.	G	T	1	5	6	0	0	6	0	0
24	36331220	.	G	T	0	3	3	0	0	3	0	0
24	36331298	.	A	G	4	1	5	0	2	7	0	0
24	36334677	.	T	C	4	5	9	0	0	9	0	0
24	36334724	.	A	G	5	8	13	0	0	13	0	0
24	36335024	.	C	G	1	4	5	0	0	5	0	0
24	36335106	.	A	T	4	3	7	0	0	7	0	0
24	36339310	.	A	C	0	2	2	0	0	2	0	0
24	36352446	.	G	A	0	1	1	0	2	3	0	0
24	36352450	.	G	A	2	2	4	0	0	4	0	0
24	36358711	.	T	C	5	3	8	0	0	8	0	0
24	36362031	.	G	C	2	9	11	0	0	11	0	0
24	36362141	.	T	C	2	2	4	0	0	4	0	0
24	36364389	.	T	A	3	2	5	0	0	5	0	0
24	36364454	.	A	G	1	4	5	0	0	5	0	0
24	37195514	.	T	A	14	9	23	0	1	24	0	0
24	37203849	.	A	G	2	6	8	0	0	8	0	0
24	37206315	.	G	A	1	5	6	0	0	6	0	0
24	37211694	.	C	T	1	0	1	0	0	1	0	0
24	37221302	.	C	T	2	2	4	0	0	4	0	0
24	37221323	.	C	T	0	1	1	0	2	3	0	0
24	37257922	.	T	G	16	7	23	0	0	26	3	0
24	37261221	.	A	G	5	4	9	0	0	9	0	0
24	37275971	.	G	A	3	4	7	0	0	7	0	0
24	37275975	.	T	A	3	4	7	0	0	7	0	0
24	37277000	.	A	G	2	2	4	0	0	4	0	0
24	37277246	.	G	T	0	3	3	0	0	3	0	0
24	37277257	.	T	G	0	3	3	0	0	3	0	0
24	37302011	.	T	A	13	9	22	0	2	24	0	0
24	37302539	.	G	A	21	24	45	0	2	47	0	0
24	37302747	.	G	A	18	18	36	0	1	38	1	0
24	37302764	.	G	T	19	18	37	0	3	40	0	0
24	37303266	.	A	G	12	10	22	0	6	28	0	0
24	37303275	.	G	T	17	10	27	0	4	31	0	0
24	37310338	.	A	C	8	15	23	0	2	25	0	0
24	37312146	.	T	C	16	9	25	0	1	26	0	0
24	37312173	.	A	G	12	9	21	0	0	21	0	0
24	37319839	.	G	A	1	2	3	0	0	3	0	0
24	37319851	.	G	A	1	2	3	0	0	3	0	0
24	37329315	.	A	G	2	3	5	0	0	5	0	0
24	37329321	.	C	T	3	1	4	0	0	4	0	0
24	37329390	.	A	G	3	4	7	0	0	7	0	0
24	37329476	.	T	A	2	9	11	0	0	11	0	0
24	37329578	.	T	A	4	6	10	0	2	12	0	0
24	37329586	.	C	A	5	5	10	0	2	12	0	0
24	37336975	.	A	G	3	1	4	0	0	4	0	0
24	37337763	.	C	T	2	8	10	0	0	10	0	0
24	37337851	.	A	C	4	2	6	0	0	6	0	0
24	37338980	.	T	C	3	1	4	0	0	4	0	0
24	37340776	.	A	G	1	2	3	0	0	3	0	0
24	37340846	.	A	T	1	1	2	0	0	2	0	0
24	37344146	.	A	T	8	13	21	0	0	21	0	0
24	37344164	.	G	A	8	11	19	0	2	21	0	0
24	37347758	.	A	C	4	5	9	0	0	9	0	0
24	37347937	.	A	C	4	4	8	0	1	9	0	0
24	37347946	.	T	C	4	4	8	0	0	8	0	0
24	37370207	.	T	G	9	0	9	0	6	15	0	0
24	37375160	.	C	T	11	13	24	0	6	30	0	0
24	37375165	.	T	C	12	15	27	0	2	29	0	0
24	37469699	.	G	A	3	7	10	0	0	10	0	0
24	37474110	.	A	G	7	11	18	0	0	18	0	0
24	37476633	.	A	C	1	4	5	0	1	6	0	0
24	37476735	.	A	C	6	6	12	0	0	12	0	0
24	37476759	.	T	C	1	3	4	0	0	4	0	0
24	37476955	.	A	G	4	10	14	0	0	14	0	0
24	37477036	.	C	T	0	2	2	0	0	2	0	0
24	37482699	.	T	A	0	2	2	0	1	3	0	0
24	37521171	.	A	G	0	2	2	0	1	3	0	0
24	37524329	.	T	G	0	1	1	0	0	1	0	0
24	37527338	.	C	G	1	3	4	0	1	5	0	0
24	37527540	.	G	A	0	1	1	0	0	1	0	0
24	37531321	.	T	G	1	2	3	0	0	3	0	0
24	37531360	.	G	A	0	2	2	0	1	3	0	0
24	37531515	.	A	T	1	4	5	0	0	5	0	0
24	37555605	.	C	T	2	3	5	0	0	5	0	0
24	37567342	.	C	T	22	14	36	0	4	40	0	0
24	37567734	.	C	T	1	20	21	0	27	48	0	0
24	37567953	.	A	G	29	18	47	0	2	49	0	0
24	37568186	.	A	C	17	23	40	0	0	40	0	0
24	37568349	.	T	G	7	4	11	0	1	12	0	0
24	37631701	.	G	A	1	2	3	0	0	3	0	0
24	37631702	.	A	C	1	2	3	0	0	3	0	0
24	37639393	.	C	A	0	1	1	0	0	1	0	0
24	37649846	.	G	A	0	2	2	0	1	3	0	0
24	37653447	.	C	T	1	0	1	0	0	1	0	0
24	37654952	.	A	C	1	0	1	0	0	1	0	0
24	37657923	.	C	T	3	6	9	0	0	9	0	0
24	37657974	.	T	C	4	5	9	0	0	9	0	0
24	37660472	.	C	T	3	3	6	0	1	7	0	0
24	37661949	.	C	T	2	3	5	0	1	6	0	0
24	37685942	.	C	T	0	2	2	0	6	8	0	0
24	37689919	.	T	C	24	24	48	0	2	50	0	0
24	37692529	.	G	A	17	10	27	0	2	29	0	0
24	37696427	.	G	A	8	4	12	0	0	12	0	0
24	37702758	.	G	A	0	0	0	0	2	2	0	0
24	37705685	.	C	G	3	0	3	0	5	8	0	0
24	37708288	.	A	C	2	3	5	0	0	5	0	0
24	37723110	.	C	T	1	1	2	0	1	3	0	0
24	37723574	.	T	C	1	4	5	0	0	5	0	0
24	37724550	.	G	A	2	3	5	0	0	5	0	0
24	37725179	.	T	A	2	3	5	0	0	5	0	0
24	37725593	.	C	T	4	3	7	0	0	7	0	0
24	37725837	.	G	A	5	0	5	0	0	5	0	0
24	37726004	.	G	A	3	2	5	0	0	5	0	0
24	37726022	.	A	G	3	1	4	0	2	6	0	0
24	37726139	.	C	T	5	2	7	0	0	7	0	0
24	37726147	.	T	A	4	2	6	0	0	6	0	0
24	37726329	.	C	T	2	2	4	0	0	4	0	0
24	37726367	.	C	T	4	2	6	0	0	6	0	0
24	37726377	.	A	G	3	4	7	0	0	7	0	0
24	37726453	.	A	G	3	0	3	0	2	5	0	0
24	37726475	.	C	T	3	4	7	0	0	7	0	0
24	37726649	.	G	A	0	2	2	0	3	5	0	0
24	37726867	.	C	G	2	3	5	0	0	5	0	0
24	37726991	.	C	T	5	3	8	0	0	8	0	0
24	37726997	.	G	A	3	4	7	0	0	7	0	0
24	37727272	.	C	A	3	10	13	0	0	13	0	0
24	37767077	.	C	T	1	2	3	0	0	3	0	0
24	37781446	.	C	T	4	6	10	0	0	10	0	0
24	37786365	.	C	T	10	4	14	0	0	14	0	0
24	37788853	.	G	A	1	2	3	0	1	4	0	0
24	37793276	.	C	A	2	2	4	0	1	5	0	0
24	37793282	.	C	T	2	3	5	0	0	5	0	0
24	37793315	.	C	T	4	7	11	0	0	11	0	0
24	37793725	.	C	T	8	3	11	0	0	11	0	0
24	37815037	.	G	A	2	1	3	0	0	3	0	0
24	37818511	.	G	A	7	5	12	0	0	12	0	0
24	37893269	.	A	G	0	2	2	0	0	2	0	0
24	37895022	.	C	T	1	1	2	0	0	2	0	0
24	37896875	.	C	T	0	2	2	0	0	2	0	0
24	37897208	.	G	C	3	3	6	0	0	6	0	0
24	37901014	.	A	G	4	3	7	0	0	7	0	0
24	37901035	.	T	G	2	2	4	0	0	4	0	0
24	37901114	.	A	G	5	3	8	0	0	8	0	0
24	37901178	.	C	T	2	6	8	0	1	9	0	0
24	37941862	.	C	T	0	4	4	0	4	8	0	0
24	37941922	.	A	C	10	6	16	0	0	16	0	0
24	37941958	.	A	G	6	9	15	0	0	15	0	0
24	37942032	.	C	T	5	8	13	0	0	13	0	0
24	37942183	.	A	T	1	5	6	0	0	6	0	0
24	37942323	.	C	T	0	2	2	0	6	8	0	0
24	37942359	.	G	A	5	2	7	0	1	8	0	0
24	37942559	.	C	T	5	5	10	0	0	10	0	0
24	37943005	.	T	A	1	2	3	0	1	4	0	0
24	37943012	.	A	G	1	2	3	0	1	4	0	0
24	37943052	.	A	G	3	2	5	0	0	5	0	0
24	38073271	.	G	A	16	15	31	0	2	33	0	0
24	38073319	.	G	A	26	15	41	0	3	44	0	0
24	38073502	.	G	C	13	14	27	0	1	28	0	0
24	38073511	.	G	A	11	13	24	0	0	24	0	0
24	38073655	.	A	G	9	7	16	0	1	17	0	0
24	38073688	.	G	A	12	7	19	0	0	19	0	0
24	38073712	.	C	T	11	10	21	0	1	22	0	0
24	38073793	.	G	A	5	8	13	0	0	13	0	0
24	38184900	.	G	A	0	2	2	0	0	2	0	0
24	38188149	.	G	A	0	2	2	0	4	6	0	0
24	38188388	.	C	A	3	2	5	0	0	5	0	0
24	38188416	.	C	G	2	2	4	0	0	4	0	0
24	38189099	.	A	G	3	2	5	0	0	5	0	0
24	38189957	.	G	A	1	2	3	0	0	3	0	0
24	38189988	.	T	C	1	2	3	0	0	3	0	0
24	38190160	.	T	A	3	2	5	0	0	5	0	0
24	38190870	.	G	A	3	3	6	0	1	7	0	0
24	38190933	.	G	A	0	2	2	0	3	5	0	0
24	38190985	.	G	T	2	2	4	0	0	4	0	0
24	38191841	.	C	T	3	4	7	0	0	7	0	0
24	38369559	.	T	A	19	23	42	0	0	42	0	0
24	38369819	.	A	G	19	18	37	0	1	38	0	0
24	38369873	.	G	A	19	18	37	0	1	38	0	0
24	38370188	.	A	G	9	10	19	0	0	19	0	0
24	38370325	.	A	G	13	12	25	0	2	27	0	0
24	38370404	.	T	A	4	18	22	0	0	22	0	0
24	38370518	.	C	T	10	6	16	0	2	18	0	0
24	38370796	.	T	G	8	7	15	0	0	15	0	0
24	38370998	.	A	G	8	7	15	0	0	15	0	0
24	38371178	.	A	G	6	10	16	0	0	16	0	0
24	38374684	.	G	A	5	2	7	0	1	8	0	0
24	38384245	.	A	T	4	8	12	0	0	12	0	0
24	38558290	.	G	A	1	1	2	0	1	3	0	0
24	38815105	.	T	A	1	4	5	0	0	5	0	0
24	38816010	.	G	T	5	3	8	0	0	8	0	0
24	38816184	.	T	G	3	3	6	0	0	6	0	0
24	38816340	.	T	G	2	2	4	0	0	4	0	0
24	39051042	.	T	C	6	2	8	0	0	8	0	0
24	39051114	.	A	G	7	0	7	0	7	14	0	0
24	39051692	.	G	C	12	7	19	0	2	21	0	0
24	39051981	.	G	A	0	4	4	0	4	8	0	0
24	39052117	.	T	C	7	6	13	0	1	14	0	0
24	39052125	.	A	G	6	5	11	0	0	11	0	0
24	39052200	.	C	T	4	6	10	0	0	10	0	0
24	39052302	.	G	A	6	12	18	0	0	18	0	0
24	39052386	.	A	G	2	7	9	0	0	9	0	0
24	39052410	.	C	T	1	1	2	0	0	2	0	0
24	39064643	.	T	C	1	1	2	0	0	2	0	0
24	39064719	.	T	C	5	5	10	0	1	11	0	0
24	39065822	.	A	G	2	0	2	0	2	4	0	0
24	39065978	.	T	C	4	2	6	0	0	6	0	0
24	39075534	.	T	C	8	11	19	0	0	19	0	0
24	39078696	.	G	A	2	1	3	0	0	3	0	0
24	39136940	.	A	C	0	1	1	0	0	1	0	0
24	39137015	.	C	T	4	2	6	0	0	6	0	0
24	39137027	.	G	C	4	3	7	0	0	7	0	0
24	39137165	.	A	G	3	7	10	0	0	10	0	0
24	39147852	.	A	G	10	11	21	0	1	22	0	0
24	39147871	.	A	G	10	1	11	0	9	20	0	0
24	39150853	.	C	G	14	0	14	0	12	26	0	0
24	39150946	.	T	C	5	6	11	0	2	13	0	0
24	39150975	.	G	T	2	9	11	0	0	11	0	0
24	39151004	.	A	T	6	13	19	0	0	19	0	0
24	39151040	.	C	T	7	11	18	0	0	18	0	0
24	39151067	.	A	G	3	0	3	0	11	14	0	0
24	39151075	.	A	G	4	11	15	0	0	15	0	0
24	39151225	.	G	T	9	1	10	0	0	10	0	0
24	39151235	.	G	A	8	1	9	0	1	10	0	0
24	39151301	.	A	C	4	5	9	0	1	10	0	0
24	39151343	.	G	A	11	5	16	0	0	16	0	0
24	39151467	.	T	C	8	7	15	0	1	16	0	0
24	39151637	.	G	C	17	11	28	0	0	28	0	0
24	39151725	.	C	T	12	11	23	0	1	24	0	0
24	39151727	.	T	C	13	9	22	0	2	24	0	0
24	39151796	.	A	G	8	12	20	0	1	21	0	0
24	39152077	.	C	G	4	9	13	0	0	13	0	0
24	39152168	.	A	G	1	3	4	0	0	9	5	0
24	39152236	.	A	G	1	6	7	0	0	7	0	0
24	39152239	.	A	G	3	4	7	0	0	7	0	0
24	39152533	.	A	G	8	2	10	0	0	10	0	0
24	39152603	.	A	T	11	3	14	0	0	14	0	0
24	39152612	.	C	A	14	3	17	0	0	17	0	0
24	39152794	.	A	G	8	7	15	0	2	17	0	0
24	39152917	.	G	A	7	5	12	0	0	12	0	0
24	39153635	.	T	C	5	8	13	1	0	14	0	0
24	39153647	.	G	A	7	7	14	1	0	15	0	0
24	39153817	.	G	A	11	9	20	0	0	20	0	0
24	39153857	.	G	T	12	6	18	0	0	18	0	0
24	39153890	.	A	G	9	4	13	0	1	14	0	0
24	39153911	.	G	T	11	0	11	0	0	11	0	0
24	39153952	.	A	G	10	0	10	0	6	16	0	0
24	39153995	.	A	G	17	13	30	0	0	30	0	0
24	39154001	.	C	T	17	13	30	0	1	31	0	0
24	39154044	.	G	A	19	13	32	0	3	35	0	0
24	39154315	.	C	T	17	32	49	0	1	50	0	0
24	39154551	.	C	A	15	23	38	0	1	39	0	0
24	39154865	.	C	A	13	12	25	0	0	25	0	0
24	39154892	.	T	G	14	5	19	0	0	19	0	0
24	39172141	.	T	C	25	26	51	0	2	53	0	0
24	39172222	.	A	G	12	24	36	0	0	36	0	0
24	39174437	.	T	C	4	4	8	0	0	8	0	0
24	39174570	.	C	T	36	37	73	0	1	74	0	0
24	39175002	.	A	C	25	6	31	0	6	37	0	0
24	39175044	.	A	G	30	20	50	0	0	50	0	0
24	39175047	.	T	C	30	18	48	0	1	49	0	0
24	39175083	.	C	G	28	26	54	0	1	55	0	0
24	39175109	.	T	A	37	17	54	1	1	56	0	0
24	39175143	.	C	T	36	21	57	1	3	61	0	0
24	39175207	.	A	G	39	4	43	0	33	76	0	0
24	39178484	.	C	G	1	2	3	0	0	3	0	0
24	39178516	.	T	G	3	3	6	0	0	6	0	0
24	39178591	.	C	A	0	3	3	0	3	6	0	0
24	39178627	.	C	A	0	2	2	0	2	4	0	0
24	39182404	.	G	A	2	0	2	0	1	3	0	0
24	39182676	.	G	A	5	3	8	0	0	8	0	0
24	39184715	.	T	C	2	2	4	0	0	4	0	0
24	39215736	.	G	T	0	1	1	0	3	4	0	0
24	39274786	.	C	A	0	5	5	0	1	6	0	0
24	39277575	.	C	G	5	4	9	0	0	9	0	0
24	39277581	.	T	A	4	4	8	0	0	8	0	0
24	39309684	.	A	G	3	0	3	0	7	10	0	0
24	39309698	.	T	G	9	0	9	0	3	12	0	0
24	39310061	.	A	G	2	6	8	0	0	8	0	0
24	39310129	.	G	A	8	6	14	0	1	15	0	0
24	39310163	.	G	T	7	4	11	0	0	11	0	0
24	39322945	.	G	T	0	11	11	0	8	20	1	0
24	39323791	.	C	T	6	8	14	0	0	14	0	0
24	39333916	.	C	T	6	4	10	0	0	10	0	0
24	39333972	.	A	C	14	28	42	0	0	42	0	0
24	39334054	.	A	G	16	21	37	0	0	37	0	0
24	39334187	.	G	A	0	15	15	0	14	29	0	0
24	39334388	.	A	G	29	23	52	0	1	53	0	0
24	39334400	.	G	A	1	29	30	0	21	51	0	0
24	39510712	.	A	G	1	3	4	0	0	4	0	0
24	39510891	.	T	C	1	2	3	0	1	4	0	0
24	39514296	.	C	G	9	2	11	0	0	11	0	0
24	39518841	.	T	C	8	4	12	0	0	12	0	0
24	39530034	.	G	A	0	7	7	0	6	13	0	0
24	39533987	.	T	A	6	6	12	0	1	13	0	0
24	39534532	.	A	G	3	0	3	0	5	8	0	0
24	39549379	.	C	T	2	2	4	0	0	4	0	0
24	39556276	.	G	T	0	2	2	0	3	5	0	0
24	39556324	.	G	A	0	1	1	0	0	1	0	0
24	39559345	.	A	G	3	0	3	0	3	6	0	0
24	39559356	.	C	T	3	3	6	0	0	6	0	0
24	39576166	.	G	A	0	2	2	0	4	6	0	0
24	39576247	.	C	T	1	6	7	0	1	8	0	0
24	39576414	.	C	T	3	3	6	0	0	6	0	0
24	39579569	.	G	A	2	4	6	0	0	6	0	0
24	39579730	.	A	G	5	2	7	0	0	7	0	0
24	39579989	.	G	A	0	3	3	0	11	14	0	0
24	39586778	.	A	T	5	2	7	0	0	7	0	0
24	39587369	.	C	G	4	0	4	0	2	6	0	0
24	39593009	.	T	C	2	1	3	0	0	3	0	0
24	39593038	.	G	A	0	2	2	0	2	4	0	0
24	39595866	.	A	C	3	5	8	0	0	8	0	0
24	39606237	.	G	A	22	18	40	0	4	44	0	0
24	39610535	.	G	T	10	13	23	0	2	25	0	0
24	39615373	.	G	T	3	4	7	1	1	17	8	0
24	39615374	.	G	T	3	13	16	1	0	17	0	0
24	39616170	.	C	A	6	7	13	0	0	13	0	0
24	39638642	.	G	A	12	24	36	0	0	36	0	0
24	39642072	.	A	T	11	6	17	0	0	17	0	0
24	39642229	.	A	G	4	2	6	0	0	6	0	0
24	39642336	.	C	A	14	8	22	0	0	22	0	0
24	39642361	.	G	T	14	11	25	0	1	26	0	0
24	39644259	.	T	C	9	4	13	0	2	15	0	0
24	39646762	.	C	T	10	11	21	0	0	21	0	0
24	39647021	.	C	T	2	6	8	0	2	10	0	0
24	39647042	.	G	C	14	5	19	0	2	21	0	0
24	39648806	.	C	T	12	9	21	0	2	23	0	0
24	39651567	.	T	G	25	22	47	0	3	50	0	0
24	39651612	.	A	T	20	12	32	0	1	33	0	0
24	39653626	.	G	A	25	11	36	9	1	46	0	0
24	39660219	.	C	T	2	4	6	0	0	6	0	0
24	39661890	.	T	A	0	1	1	0	0	1	0	0
24	39661905	.	C	T	2	4	6	0	0	6	0	0
24	39662074	.	T	C	3	6	9	0	0	9	0	0
24	39663197	.	A	G	4	3	7	0	0	7	0	0
24	39667348	.	T	C	9	9	18	0	1	19	0	0
24	39742273	.	G	A	3	5	8	0	0	8	0	0
24	39742336	.	G	A	5	4	9	0	0	9	0	0
24	39742396	.	G	A	6	6	12	0	0	12	0	0
24	39742786	.	T	A	4	5	9	0	0	9	0	0
24	39742869	.	G	T	2	1	3	0	1	4	0	0
24	39771659	.	G	T	3	3	6	0	1	7	0	0
24	39771976	.	G	A	1	5	6	0	0	6	0	0
24	39771983	.	A	G	1	6	7	0	0	7	0	0
24	39779108	.	G	T	4	4	8	0	0	8	0	0
24	39787653	.	G	C	0	0	0	0	1	1	0	0
24	39792961	.	C	T	1	0	1	0	0	1	0	0
24	40001569	.	T	C	1	3	4	0	0	4	0	0
24	40001698	.	C	T	5	3	8	0	0	8	0	0
24	40004620	.	G	A	1	3	4	0	0	4	0	0
24	40004806	.	G	A	5	1	6	0	0	6	0	0
24	40004839	.	A	G	1	0	1	0	0	1	0	0
24	40156163	.	G	A	1	0	1	0	0	1	0	0
24	40167076	.	C	T	1	2	3	0	0	3	0	0
24	40167164	.	A	T	1	1	2	0	0	2	0	0
24	41246800	.	G	A	0	2	2	0	0	2	0	0
24	41281297	.	T	C	1	1	2	0	0	2	0	0
24	41290602	.	G	A	0	1	1	0	1	2	0	0
24	41290604	.	G	A	1	1	2	0	0	2	0	0
24	41290712	.	C	T	1	0	1	0	0	1	0	0
24	41291588	.	C	T	1	4	5	0	1	6	0	0
24	41293409	.	G	A	5	4	9	0	0	9	0	0
24	41317090	.	A	T	20	8	28	0	5	34	1	0
24	41317132	.	G	A	12	14	26	1	1	28	0	0
24	41317285	.	T	A	2	12	14	0	2	16	0	0
24	41317287	.	T	A	3	13	16	0	0	16	0	0
24	41317350	.	G	C	4	4	8	0	14	22	0	0
24	41473618	.	G	A	3	0	3	0	0	3	0	0
24	41473627	.	G	A	5	0	5	0	0	5	0	0
24	41478831	.	C	T	2	1	3	0	0	3	0	0
24	41757026	.	G	A	0	2	2	0	1	3	0	0
24	41770723	.	A	T	1	0	1	0	0	1	0	0
24	41773216	.	G	C	0	5	5	0	1	6	0	0
24	41781968	.	C	T	1	8	9	0	0	9	0	0
24	41783906	.	G	A	0	8	8	0	6	14	0	0
24	41783999	.	C	T	5	11	16	0	1	17	0	0
24	41786281	.	C	G	2	5	7	0	0	7	0	0
24	41786304	.	G	A	4	4	8	0	1	9	0	0
24	41916584	.	G	A	3	4	7	0	0	7	0	0
24	41916677	.	A	G	5	0	5	0	5	10	0	0
24	41916887	.	G	A	8	3	11	0	0	11	0	0
24	41917543	.	T	C	5	9	14	0	0	14	0	0
24	41953649	.	T	G	4	2	6	0	0	6	0	0
24	41954745	.	A	G	5	0	5	0	10	15	0	0
24	41954764	.	A	C	4	8	12	0	0	12	0	0
24	41954781	.	C	T	3	8	11	0	0	11	0	0
24	41964613	.	A	C	1	5	6	0	1	7	0	0
24	41965147	.	T	C	10	2	12	0	2	14	0	0
24	41969781	.	C	A	3	5	8	0	0	9	1	0
24	41972519	.	A	G	11	14	25	0	0	25	0	0
24	41972633	.	C	G	3	0	3	0	5	8	0	0
24	41972638	.	A	T	2	3	5	0	2	7	0	0
24	41974769	.	C	T	4	2	6	0	0	6	0	0
24	41981865	.	A	G	2	3	5	0	0	5	0	0
24	41986626	.	G	C	0	11	11	0	18	29	0	0
24	41986704	.	C	T	16	19	35	0	0	35	0	0
24	41989196	.	A	C	1	4	5	0	1	6	0	0
24	41990626	.	A	T	4	10	14	0	1	15	0	0
24	41990821	.	G	A	1	6	7	0	9	17	1	0
24	41994096	.	G	A	9	8	17	0	1	18	0	0
24	41994147	.	G	T	8	16	24	0	0	24	0	0
24	41994615	.	G	T	4	2	6	0	1	7	0	0
24	42061369	.	C	T	1	6	7	0	1	8	0	0
24	42061423	.	G	T	1	3	4	0	0	4	0	0
24	42061426	.	G	A	1	2	3	0	1	4	0	0
24	42061460	.	A	G	0	3	3	0	2	5	0	0
24	42083876	.	A	G	13	11	24	0	0	24	0	0
24	42138533	.	A	G	14	1	15	0	18	33	0	0
24	42141461	.	T	C	6	0	6	0	4	10	0	0
24	42141605	.	G	A	0	1	1	0	0	1	0	0
24	42141770	.	T	C	7	8	15	0	0	15	0	0
24	42153241	.	A	G	9	4	13	0	0	13	0	0
24	42155187	.	T	C	11	11	22	0	1	23	0	0
25	403590	.	G	T	2	1	3	0	1	4	0	0
25	403592	.	A	T	1	1	2	0	2	4	0	0
25	487975	.	A	T	9	8	17	0	1	18	0	0
25	488029	.	A	G	0	3	3	0	0	3	0	0
25	1048784	.	A	C	1	3	4	0	0	4	0	0
25	1048814	.	T	C	3	1	4	0	0	4	0	0
25	1048843	.	T	C	0	5	5	0	0	5	0	0
25	1049179	.	G	C	1	1	2	0	0	2	0	0
25	1049194	.	T	C	0	2	2	0	0	2	0	0
25	1049686	.	G	C	3	2	5	0	0	5	0	0
25	1088800	.	A	G	2	3	5	0	1	6	0	0
25	1089010	.	G	A	12	11	23	0	2	25	0	0
25	1089026	.	G	A	8	7	15	0	0	15	0	0
25	1091760	.	A	G	9	3	12	0	1	13	0	0
25	1092451	.	C	T	2	1	3	0	0	3	0	0
25	1093520	.	G	A	7	3	10	0	0	10	0	0
25	1093526	.	A	G	7	3	10	0	0	10	0	0
25	1093567	.	G	A	0	2	2	0	0	2	0	0
25	1094460	.	T	G	3	3	6	0	0	6	0	0
25	1098649	.	T	C	2	0	2	0	0	2	0	0
25	1098666	.	T	G	2	0	2	0	2	4	0	0
25	1101860	.	A	G	2	4	6	0	0	6	0	0
25	1103486	.	C	T	0	6	6	0	0	6	0	0
25	1105866	.	A	G	2	3	5	0	0	5	0	0
25	1106187	.	G	A	2	2	4	0	0	4	0	0
25	1108057	.	T	C	0	0	0	0	1	1	0	0
25	1108222	.	T	C	0	0	0	0	1	1	0	0
25	1132543	.	G	A	10	10	20	0	0	20	0	0
25	1133793	.	G	A	1	11	12	0	9	21	0	0
25	1133797	.	T	G	12	8	20	0	2	22	0	0
25	1592111	.	G	A	9	11	20	0	1	21	0	0
25	1603727	.	G	A	1	2	3	0	6	9	0	0
25	1603772	.	C	A	2	1	3	0	1	4	0	0
25	1603787	.	G	T	0	1	1	0	0	1	0	0
25	1604543	.	T	G	7	0	7	0	6	13	0	0
25	1608836	.	C	G	4	1	5	0	0	5	0	0
25	1608857	.	C	G	1	8	9	0	1	10	0	0
25	1624547	.	C	A	16	12	28	0	1	29	0	0
25	1624777	.	G	A	14	22	36	0	0	36	0	0
25	1635419	.	G	A	7	6	13	0	2	15	0	0
25	1635714	.	C	G	14	10	24	0	1	25	0	0
25	1635783	.	G	A	14	12	26	0	3	29	0	0
25	1635786	.	C	T	0	9	9	0	19	28	0	0
25	1635879	.	G	A	9	8	17	0	0	17	0	0
25	1639932	.	G	T	3	5	8	0	1	9	0	0
25	1642319	.	C	A	11	15	26	0	2	28	0	0
25	1644857	.	C	T	3	3	6	0	0	6	0	0
25	1652138	.	C	T	1	8	9	0	4	13	0	0
25	1652294	.	G	A	8	7	15	0	1	16	0	0
25	1652450	.	A	G	6	3	9	0	0	9	0	0
25	1652513	.	G	A	6	6	12	0	0	12	0	0
25	1652543	.	C	T	0	4	4	0	5	9	0	0
25	1652591	.	A	G	3	6	9	0	0	9	0	0
25	1652793	.	C	T	0	1	1	0	3	4	0	0
25	1652916	.	G	A	2	1	3	0	0	3	0	0
25	1654432	.	G	T	6	6	12	0	0	12	0	0
25	1655408	.	G	A	2	1	3	0	1	4	0	0
25	1655502	.	G	A	5	5	10	0	0	10	0	0
25	1655535	.	G	C	1	2	3	0	0	3	0	0
25	1655537	.	G	A	1	2	3	0	0	3	0	0
25	1660233	.	G	A	1	1	2	0	0	2	0	0
25	1660255	.	G	T	1	1	2	0	0	2	0	0
25	1662047	.	G	A	1	0	1	0	0	1	0	0
25	1670850	.	C	T	3	4	7	0	0	7	0	0
25	1670878	.	T	C	3	3	6	0	0	6	0	0
25	1672911	.	C	T	1	2	3	0	0	3	0	0
25	1672920	.	G	T	2	1	3	0	0	3	0	0
25	1681344	.	A	C	0	2	2	0	0	2	0	0
25	2702880	.	A	T	1	2	3	0	0	3	0	0
25	3245895	.	A	G	8	3	11	0	0	11	0	0
25	3451196	.	T	A	8	6	14	0	0	14	0	0
25	3451250	.	A	C	12	12	24	0	2	26	0	0
25	3451760	.	A	C	7	2	9	0	0	9	0	0
25	3451779	.	A	G	6	2	8	0	0	8	0	0
25	3453651	.	G	A	1	0	1	0	0	1	0	0
25	3454644	.	G	A	9	6	15	0	0	15	0	0
25	3454719	.	G	A	14	11	25	0	1	26	0	0
25	3457756	.	G	A	3	2	5	0	0	5	0	0
25	3461097	.	C	G	0	1	1	0	1	2	0	0
25	3465854	.	G	A	3	1	4	0	1	5	0	0
25	3465911	.	A	G	1	8	9	0	0	9	0	0
25	3469442	.	A	G	0	2	2	0	0	2	0	0
25	3469502	.	G	A	3	6	9	0	0	9	0	0
25	3478467	.	G	T	0	1	1	0	0	1	0	0
25	3478617	.	C	T	2	1	3	0	1	4	0	0
25	3481088	.	G	T	9	4	13	0	0	13	0	0
25	3483727	.	G	A	3	3	6	0	0	6	0	0
25	3513274	.	G	A	3	2	5	0	0	5	0	0
25	3536470	.	G	T	4	3	7	0	0	7	0	0
25	3539575	.	G	A	1	3	4	0	0	4	0	0
25	3544210	.	G	A	1	1	2	0	0	2	0	0
25	3544217	.	G	C	1	0	1	0	1	2	0	0
25	3552350	.	A	G	1	4	5	0	0	5	0	0
25	3557470	.	G	A	0	6	6	0	4	10	0	0
25	3560066	.	G	A	0	1	1	0	0	1	0	0
25	3573266	.	T	G	2	1	3	1	1	5	0	0
25	3573283	.	A	G	2	5	7	0	2	9	0	0
25	3573350	.	G	A	2	10	12	0	0	12	0	0
25	3573447	.	T	C	4	0	4	0	5	9	0	0
25	3573624	.	G	C	4	6	10	0	0	10	0	0
25	3573635	.	A	T	4	3	7	0	0	7	0	0
25	3573796	.	C	A	1	11	12	0	19	31	0	0
25	3573815	.	G	A	16	7	23	0	2	25	0	0
25	3579429	.	A	C	11	8	19	0	0	19	0	0
25	3579459	.	C	A	9	8	17	0	0	17	0	0
25	3582443	.	A	G	8	6	14	0	0	14	0	0
25	3583975	.	C	T	2	0	2	0	0	2	0	0
25	3583983	.	G	T	2	0	2	0	0	2	0	0
25	3584053	.	G	A	7	9	16	0	1	17	0	0
25	3590931	.	G	A	1	1	2	0	0	2	0	0
25	3594911	.	T	C	3	5	8	0	2	10	0	0
25	3596319	.	C	T	3	4	7	0	2	9	0	0
25	3596361	.	T	G	3	5	8	0	0	8	0	0
25	3599390	.	A	G	2	3	5	0	2	7	0	0
25	3606940	.	G	A	4	0	4	0	0	4	0	0
25	3606970	.	C	T	5	0	5	0	0	5	0	0
25	3623403	.	T	C	0	1	1	0	0	1	0	0
25	3638484	.	T	G	1	2	3	0	0	3	0	0
25	3677703	.	G	A	0	1	1	0	0	1	0	0
25	3682253	.	C	T	15	12	27	0	0	27	0	0
25	3682610	.	G	A	0	10	10	0	11	21	0	0
25	3682789	.	G	A	21	23	44	0	4	48	0	0
25	3682795	.	A	C	22	27	49	0	0	49	0	0
25	3683247	.	G	A	21	28	49	0	3	52	0	0
25	3683297	.	C	T	22	28	50	0	4	54	0	0
25	3683386	.	C	T	18	27	45	0	2	47	0	0
25	3683527	.	G	A	4	26	30	0	17	47	0	0
25	3683796	.	A	T	11	6	17	0	0	17	0	0
25	3683887	.	C	T	22	11	33	0	2	35	0	0
25	3684141	.	C	A	29	32	61	0	3	64	0	0
25	3684148	.	A	G	31	28	59	0	4	63	0	0
25	3684195	.	G	A	0	13	13	0	17	30	0	0
25	3684409	.	G	T	4	14	18	2	39	59	0	0
25	3684741	.	A	G	15	36	51	0	1	52	0	0
25	3708287	.	G	A	2	4	6	0	0	6	0	0
25	3708429	.	G	T	4	4	8	0	2	10	0	0
25	3713652	.	T	C	10	0	10	0	12	22	0	0
25	3713724	.	T	C	1	1	2	0	1	3	0	0
25	3719768	.	T	C	0	3	3	0	2	5	0	0
25	3719888	.	G	T	3	6	9	0	2	11	0	0
25	3721726	.	G	C	2	1	3	0	2	5	0	0
25	3724275	.	T	C	0	0	0	0	2	2	0	0
25	3724598	.	G	A	3	3	6	0	0	6	0	0
25	3725000	.	G	A	3	4	7	0	0	7	0	0
25	3750168	.	T	C	4	0	4	0	5	9	0	0
25	3750509	.	T	A	1	4	5	0	1	6	0	0
25	3750545	.	A	T	9	7	16	0	0	16	0	0
25	3750559	.	T	C	13	11	24	0	0	24	0	0
25	3750655	.	C	T	10	16	26	0	1	27	0	0
25	3754606	.	G	A	4	8	12	0	0	12	0	0
25	3755271	.	G	A	11	11	22	0	0	22	0	0
25	3755303	.	A	G	6	8	14	0	0	14	0	0
25	3757584	.	G	A	5	4	9	0	1	10	0	0
25	3757606	.	G	A	9	6	15	0	0	15	0	0
25	3757670	.	C	T	9	5	14	0	0	14	0	0
25	3758022	.	T	C	0	1	1	0	0	1	0	0
25	3761443	.	G	A	1	0	1	0	0	1	0	0
25	3761475	.	C	T	1	0	1	0	0	1	0	0
25	3765897	.	G	A	0	2	2	0	0	2	0	0
25	3772165	.	T	C	1	3	4	0	1	5	0	0
25	3774637	.	A	C	2	0	2	0	1	3	0	0
25	3774681	.	G	A	3	0	3	0	0	3	0	0
25	3777625	.	T	G	0	1	1	0	0	1	0	0
25	3777774	.	A	G	4	0	4	0	1	5	0	0
25	3777795	.	G	C	0	0	0	0	4	4	0	0
25	3782576	.	T	C	2	4	6	0	0	6	0	0
25	3784679	.	C	T	0	1	1	0	1	2	0	0
25	3789004	.	G	A	0	6	6	0	6	12	0	0
25	3790279	.	G	A	0	7	7	0	8	15	0	0
25	3792945	.	A	G	8	0	8	0	0	8	0	0
25	3793096	.	T	C	10	8	18	0	0	18	0	0
25	3793141	.	T	A	9	7	16	0	0	16	0	0
25	3794786	.	A	G	5	0	5	0	2	7	0	0
25	3794975	.	A	G	2	0	2	0	1	3	0	0
25	3801505	.	T	G	7	3	10	0	1	11	0	0
25	3801612	.	T	C	3	0	3	0	5	8	0	0
25	3801726	.	A	G	16	11	27	0	1	28	0	0
25	3801737	.	T	C	15	14	29	0	0	29	0	0
25	3804410	.	A	G	4	6	10	0	1	11	0	0
25	3807526	.	C	T	0	3	3	0	3	6	0	0
25	3808572	.	T	A	8	10	18	0	2	20	0	0
25	3810105	.	T	A	2	4	6	0	0	6	0	0
25	3810107	.	T	A	2	4	6	0	0	6	0	0
25	3810273	.	C	T	1	3	4	0	1	5	0	0
25	3810316	.	A	G	1	2	3	0	0	3	0	0
25	3891940	.	A	T	11	14	25	0	0	25	0	0
25	3897988	.	G	A	4	5	9	0	0	9	0	0
25	3898013	.	A	G	6	2	8	0	1	9	0	0
25	3898332	.	A	G	3	2	5	0	3	8	0	0
25	3898449	.	T	C	5	0	5	0	4	9	0	0
25	3898483	.	C	T	6	4	10	0	0	10	0	0
25	3898937	.	T	A	3	7	10	1	1	12	0	0
25	3898976	.	C	T	0	7	7	0	1	8	0	0
25	3899039	.	A	C	1	6	7	0	0	7	0	0
25	3899169	.	C	T	7	4	11	0	0	11	0	0
25	3906840	.	A	C	1	0	1	0	2	3	0	0
25	3907063	.	A	G	2	1	3	0	0	3	0	0
25	4112013	.	C	T	1	0	1	0	0	1	0	0
25	4113930	.	T	C	1	0	1	0	0	1	0	0
25	4126771	.	G	A	1	2	3	0	0	3	0	0
25	4129075	.	G	T	2	2	4	0	0	4	0	0
25	4129165	.	C	A	6	2	8	0	0	8	0	0
25	4133498	.	T	C	13	16	29	0	0	29	0	0
25	4133647	.	C	A	14	22	36	0	0	36	0	0
25	4133648	.	T	C	14	1	15	0	21	36	0	0
25	4133708	.	T	G	28	7	35	0	1	36	0	0
25	4133720	.	C	A	22	9	31	0	1	32	0	0
25	4136001	.	C	A	6	7	13	0	1	14	0	0
25	4136292	.	A	G	9	3	12	0	0	12	0	0
25	4141629	.	G	A	7	2	9	0	1	10	0	0
25	4460165	.	T	C	7	7	14	0	1	15	0	0
25	4460441	.	G	A	13	15	28	1	0	29	0	0
25	4465382	.	T	C	5	0	5	0	8	13	0	0
25	4475705	.	A	G	2	1	3	0	0	3	0	0
25	4479613	.	G	C	3	2	5	0	0	5	0	0
25	4668799	.	C	T	1	1	2	0	0	2	0	0
25	4677100	.	A	C	1	1	2	0	0	2	0	0
25	4689578	.	A	G	1	3	4	0	0	4	0	0
25	4717246	.	C	T	0	7	7	0	2	9	0	0
25	4723885	.	A	G	1	2	3	0	0	3	0	0
25	4733021	.	A	G	2	3	5	0	0	5	0	0
25	4837937	.	G	C	14	7	21	0	0	21	0	0
25	4838118	.	A	G	5	2	7	0	0	7	0	0
25	4841406	.	T	C	0	4	4	0	0	4	0	0
25	4843398	.	A	G	9	6	15	0	1	16	0	0
25	4848808	.	C	T	2	2	4	0	1	5	0	0
25	4849326	.	A	G	12	0	12	0	4	16	0	0
25	4849422	.	T	A	12	5	17	0	3	20	0	0
25	4849453	.	C	T	3	3	6	0	0	6	0	0
25	4850969	.	C	G	7	0	7	0	8	15	0	0
25	4850989	.	G	A	12	11	23	0	0	23	0	0
25	4871568	.	T	C	1	1	2	0	0	2	0	0
25	4876366	.	A	G	1	0	1	0	3	4	0	0
25	4877685	.	A	G	0	1	1	0	0	1	0	0
25	4877781	.	C	A	4	2	6	0	0	6	0	0
25	4879964	.	C	T	8	3	11	0	0	11	0	0
25	4879973	.	A	C	8	3	11	0	0	11	0	0
25	4880138	.	A	C	3	3	6	0	0	6	0	0
25	4880144	.	A	G	2	0	2	0	4	6	0	0
25	4880363	.	C	T	2	4	6	0	0	6	0	0
25	4880372	.	T	A	2	4	6	0	0	6	0	0
25	4883338	.	A	G	4	0	4	0	2	6	0	0
25	4890782	.	A	C	1	0	1	0	4	5	0	0
25	4890802	.	G	T	1	5	6	0	0	6	0	0
25	4891272	.	G	A	29	18	47	0	2	49	0	0
25	4891286	.	A	T	23	21	44	0	5	50	1	0
25	4891350	.	C	T	14	43	57	0	2	59	0	0
25	4891538	.	A	G	14	24	38	0	2	40	0	0
25	4891597	.	G	A	7	27	34	0	2	36	0	0
25	4891762	.	C	G	13	20	33	0	1	34	0	0
25	4891867	.	T	C	4	0	4	0	4	8	0	0
25	4891882	.	C	T	1	3	4	0	0	4	0	0
25	4892010	.	A	C	6	10	16	0	1	17	0	0
25	4892172	.	G	T	18	24	42	0	0	42	0	0
25	4892203	.	T	A	16	23	39	0	0	39	0	0
25	4892291	.	T	C	12	22	34	0	2	36	0	0
25	4892348	.	A	G	16	13	29	0	3	32	0	0
25	4892356	.	G	A	17	9	26	0	3	29	0	0
25	4892830	.	C	T	6	9	15	0	1	16	0	0
25	4892982	.	T	C	5	7	12	0	0	12	0	0
25	4892985	.	T	C	4	6	10	0	1	11	0	0
25	4893024	.	A	C	2	2	4	0	0	5	1	0
25	4893398	.	T	C	12	25	37	0	1	38	0	0
25	4893435	.	C	T	15	19	34	0	0	34	0	0
25	4896182	.	A	G	2	8	10	0	0	10	0	0
25	4896281	.	A	C	2	0	2	0	1	3	0	0
25	4896290	.	A	G	2	0	2	0	0	2	0	0
25	4899071	.	G	A	4	6	10	0	0	10	0	0
25	4902538	.	A	T	0	6	6	0	0	6	0	0
25	5020225	.	C	T	2	1	3	0	0	3	0	0
25	5020270	.	C	T	1	1	2	0	0	2	0	0
25	5189406	.	C	T	0	2	2	0	2	4	0	0
25	5189445	.	T	C	4	0	4	0	2	6	0	0
25	5702160	.	G	T	2	6	8	0	1	9	0	0
25	5709328	.	T	G	2	5	7	0	0	7	0	0
25	5710949	.	C	G	7	4	11	0	0	11	0	0
25	5713704	.	G	C	2	0	2	0	4	6	0	0
25	5722072	.	A	G	1	1	2	0	0	2	0	0
25	5724887	.	C	T	0	5	5	0	5	10	0	0
25	5724905	.	G	A	5	6	11	0	0	11	0	0
25	5730936	.	A	T	2	2	4	0	0	4	0	0
25	5733681	.	G	A	0	1	1	0	0	1	0	0
25	5733684	.	G	A	1	1	2	0	0	2	0	0
25	5734392	.	C	T	0	1	1	0	1	2	0	0
25	5774925	.	C	T	1	0	1	0	0	1	0	0
25	5775124	.	C	T	3	4	7	0	0	7	0	0
25	5775139	.	T	A	3	3	6	0	3	9	0	0
25	5775536	.	T	A	4	2	6	0	0	6	0	0
25	5775552	.	C	T	6	2	8	0	1	9	0	0
25	5776138	.	G	A	0	5	5	0	5	10	0	0
25	5776920	.	T	A	2	6	8	0	1	9	0	0
25	5776966	.	G	C	1	4	5	0	1	6	0	0
25	5777032	.	T	A	2	4	6	0	0	6	0	0
25	5777674	.	G	A	3	4	7	0	0	7	0	0
25	5778842	.	C	G	4	10	14	0	0	14	0	0
25	5778851	.	T	C	4	8	12	0	1	13	0	0
25	5779557	.	G	A	4	6	10	0	0	10	0	0
25	5780633	.	T	C	4	0	4	0	0	4	0	0
25	5783309	.	T	C	3	0	3	0	0	3	0	0
25	5783523	.	C	T	7	7	14	0	0	14	0	0
25	5783598	.	T	A	5	8	13	0	0	13	0	0
25	5786668	.	T	C	2	6	8	0	0	8	0	0
25	5787487	.	G	A	1	3	4	0	0	4	0	0
25	5787511	.	A	T	2	2	4	0	0	4	0	0
25	5787684	.	C	T	7	16	23	0	0	23	0	0
25	5787966	.	C	A	8	13	21	0	2	23	0	0
25	5788310	.	T	C	3	6	9	0	0	9	0	0
25	5788321	.	C	T	6	6	12	0	0	12	0	0
25	5788384	.	C	T	11	9	20	0	0	20	0	0
25	5788432	.	A	G	11	6	17	0	0	17	0	0
25	5788519	.	G	T	8	10	18	0	1	19	0	0
25	5788670	.	C	T	1	19	20	0	18	38	0	0
25	5788783	.	G	C	18	13	31	0	1	32	0	0
25	5788838	.	A	G	7	11	18	0	1	19	0	0
25	5788842	.	C	T	0	11	11	0	7	18	0	0
25	5789625	.	T	A	4	8	12	0	0	12	0	0
25	5789626	.	T	C	4	0	4	0	8	12	0	0
25	5789660	.	A	T	9	2	11	0	0	11	0	0
25	5789721	.	G	A	9	5	14	0	1	15	0	0
25	5789734	.	G	C	9	5	14	0	0	14	0	0
25	5789937	.	A	C	11	6	17	0	1	18	0	0
25	5790050	.	T	G	10	7	17	0	0	17	0	0
25	5790341	.	C	G	5	13	18	0	0	18	0	0
25	5790414	.	A	T	5	5	10	0	0	10	0	0
25	5790742	.	G	A	6	10	16	0	2	18	0	0
25	5796606	.	A	G	13	6	19	0	0	19	0	0
25	5796675	.	A	C	2	0	2	0	0	2	0	0
25	5803512	.	T	C	1	2	3	0	0	3	0	0
25	5803529	.	A	G	2	2	4	0	1	5	0	0
25	5805328	.	G	A	4	4	8	0	0	8	0	0
25	5805346	.	G	T	6	4	10	0	0	10	0	0
25	5805382	.	G	A	4	2	6	0	0	6	0	0
25	5835390	.	T	G	1	0	1	0	0	1	0	0
25	5835564	.	T	C	2	2	4	0	0	4	0	0
25	5936080	.	C	T	7	11	18	0	1	19	0	0
25	5936556	.	A	T	15	16	31	0	0	31	0	0
25	5936725	.	T	A	15	22	37	0	1	38	0	0
25	5936764	.	C	A	12	23	35	0	1	36	0	0
25	5936886	.	C	T	0	4	4	0	8	12	0	0
25	5937012	.	C	T	6	10	16	0	2	18	0	0
25	5937424	.	T	G	7	8	15	0	2	17	0	0
25	5937516	.	C	T	1	17	18	0	25	43	0	0
25	5937607	.	T	G	2	0	2	0	19	21	0	0
25	5937686	.	G	C	19	2	21	0	16	37	0	0
25	5938065	.	A	T	6	11	17	0	0	17	0	0
25	5938694	.	G	A	5	3	8	0	0	8	0	0
25	5938858	.	A	C	5	6	11	0	0	11	0	0
25	5938881	.	G	T	8	5	13	0	0	13	0	0
25	5938895	.	C	T	8	6	14	0	1	15	0	0
25	5939484	.	C	T	9	8	17	0	1	18	0	0
25	5939569	.	T	C	6	4	10	0	1	11	0	0
25	5947539	.	G	A	5	1	6	0	0	6	0	0
25	5962763	.	C	T	0	4	4	0	8	12	0	0
25	5963021	.	T	A	2	2	4	0	0	4	0	0
25	5963435	.	T	A	1	5	6	0	0	6	0	0
25	5986994	.	A	G	27	2	29	0	18	47	0	0
25	5990107	.	A	C	22	15	37	0	0	37	0	0
25	6016708	.	G	A	7	3	10	0	0	10	0	0
25	6016752	.	T	C	5	1	6	0	3	9	0	0
25	6016829	.	C	T	11	7	18	0	1	19	0	0
25	6017382	.	A	T	15	13	28	0	0	28	0	0
25	6017623	.	C	T	0	2	2	0	0	2	0	0
25	6025278	.	C	A	2	0	2	0	1	3	0	0
25	6025326	.	G	T	7	8	15	0	0	15	0	0
25	6026106	.	G	A	3	6	9	0	0	9	0	0
25	6028947	.	G	A	3	2	5	0	0	5	0	0
25	6042871	.	G	A	7	7	14	0	0	14	0	0
25	6055998	.	C	T	1	0	1	0	0	1	0	0
25	6056001	.	C	A	1	0	1	0	0	1	0	0
25	6065064	.	G	A	3	2	5	0	0	5	0	0
25	6065094	.	G	A	0	2	2	0	0	2	0	0
25	6067712	.	A	C	0	0	0	0	1	1	0	0
25	6152324	.	G	A	4	6	10	0	0	10	0	0
25	6152347	.	T	A	3	3	6	0	0	6	0	0
25	6152363	.	A	C	4	1	5	0	2	7	0	0
25	6186933	.	A	G	1	5	6	0	1	7	0	0
25	6202870	.	T	A	8	8	16	0	0	17	1	0
25	6203292	.	A	G	5	7	12	0	2	14	0	0
25	6204824	.	A	G	15	6	21	0	0	21	0	0
25	6205703	.	C	T	13	20	33	0	1	34	0	0
25	6206264	.	G	T	2	2	4	0	0	4	0	0
25	6206292	.	A	T	3	2	5	0	0	5	0	0
25	6206304	.	A	G	3	0	3	0	3	6	0	0
25	6206331	.	G	T	2	3	5	0	1	6	0	0
25	6216349	.	A	C	7	11	18	0	0	18	0	0
25	6222555	.	G	A	5	4	9	0	1	10	0	0
25	6222600	.	C	A	0	18	18	0	10	28	0	0
25	6228616	.	G	A	6	7	13	0	1	14	0	0
25	6228651	.	A	G	4	8	12	0	1	13	0	0
25	6230616	.	G	A	9	11	20	0	0	20	0	0
25	6230721	.	T	C	13	3	16	0	0	16	0	0
25	6230736	.	T	G	6	3	9	0	0	9	0	0
25	6230935	.	T	C	4	5	9	0	0	9	0	0
25	6233485	.	C	T	6	9	15	0	1	16	0	0
25	6237656	.	G	A	4	5	9	0	0	9	0	0
25	6237674	.	T	C	1	0	1	0	5	6	0	0
25	6237993	.	A	G	0	1	1	0	0	1	0	0
25	6240154	.	G	A	1	0	1	0	0	1	0	0
25	6242742	.	C	T	0	2	2	0	0	2	0	0
25	6245099	.	A	G	0	0	0	0	1	1	0	0
25	6268616	.	C	A	1	2	3	0	1	4	0	0
25	6288353	.	G	C	4	4	8	0	0	8	0	0
25	6292370	.	A	G	4	3	7	0	0	7	0	0
25	6292381	.	T	A	4	4	8	0	0	8	0	0
25	6292417	.	G	T	5	2	7	0	0	7	0	0
25	6307064	.	T	C	7	8	15	0	1	16	0	0
25	6312955	.	A	C	20	27	47	0	0	47	0	0
25	6313069	.	G	A	0	9	9	0	10	19	0	0
25	6313075	.	T	C	7	8	15	0	0	15	0	0
25	6337111	.	G	A	0	13	13	0	15	28	0	0
25	6337136	.	C	T	15	28	43	0	1	44	0	0
25	6337253	.	A	T	18	11	29	0	2	31	0	0
25	6337271	.	C	A	22	11	33	0	0	33	0	0
25	6351282	.	A	G	9	11	20	0	1	21	0	0
25	6351283	.	C	G	9	12	21	0	0	21	0	0
25	6357227	.	C	T	5	3	8	0	0	8	0	0
25	6357245	.	C	T	0	1	1	0	2	3	0	0
25	6357451	.	T	C	1	4	5	0	0	5	0	0
25	6357503	.	G	A	1	2	3	0	0	3	0	0
25	6359728	.	G	C	6	3	9	0	0	9	0	0
25	6360049	.	T	A	4	4	8	0	2	10	0	0
25	6360225	.	T	C	8	3	11	0	1	12	0	0
25	6365322	.	T	C	3	5	8	0	0	8	0	0
25	6365361	.	C	A	3	2	5	0	0	5	0	0
25	6366888	.	G	A	4	4	8	0	0	8	0	0
25	6370173	.	T	C	0	0	0	0	1	1	0	0
25	6377724	.	T	C	1	0	1	0	4	5	0	0
25	6403890	.	T	C	5	2	7	0	0	7	0	0
25	6403986	.	A	T	1	3	4	0	0	4	0	0
25	6404129	.	G	A	3	3	6	0	0	6	0	0
25	6404146	.	T	A	3	2	5	0	0	5	0	0
25	6404599	.	C	T	0	3	3	0	4	7	0	0
25	6404630	.	T	G	3	4	7	0	0	7	0	0
25	6407526	.	T	C	1	0	1	0	3	4	0	0
25	6407562	.	T	C	4	0	4	0	4	8	0	0
25	6410720	.	A	G	0	1	1	0	0	1	0	0
25	6417123	.	C	T	1	1	2	0	0	2	0	0
25	6431715	.	T	C	3	4	7	0	1	8	0	0
25	6431914	.	C	A	4	4	8	0	1	9	0	0
25	6435955	.	A	G	3	4	7	0	0	7	0	0
25	6436199	.	G	C	7	10	17	0	0	17	0	0
25	6437716	.	A	G	3	1	4	0	0	4	0	0
25	6437735	.	A	G	3	1	4	0	0	4	0	0
25	7229255	.	T	A	4	5	9	0	0	9	0	0
25	7230239	.	T	C	8	5	13	0	0	13	0	0
25	7324580	.	C	T	0	2	2	0	1	3	0	0
25	7334900	.	A	G	4	0	4	0	5	9	0	0
25	7334915	.	T	C	7	7	14	0	0	14	0	0
25	7334957	.	G	A	1	13	14	0	16	30	0	0
25	7334987	.	G	C	9	10	19	0	1	20	0	0
25	7401601	.	C	G	1	3	4	0	0	4	0	0
25	7410399	.	A	G	3	4	7	0	0	7	0	0
25	7410645	.	G	A	1	2	3	0	0	3	0	0
25	7412640	.	T	G	5	2	7	0	0	7	0	0
25	7413144	.	C	T	2	2	4	0	0	4	0	0
25	7413351	.	C	T	3	5	8	0	0	8	0	0
25	7413501	.	C	T	2	2	4	0	0	4	0	0
25	7428932	.	A	C	3	11	14	0	1	15	0	0
25	7428944	.	T	C	4	10	14	0	1	15	0	0
25	7428971	.	A	T	5	10	15	0	0	15	0	0
25	7429028	.	C	A	0	2	2	0	0	2	0	0
25	7431297	.	G	A	0	1	1	0	0	1	0	0
25	7431301	.	G	A	0	1	1	0	0	1	0	0
25	7431421	.	A	G	0	2	2	0	0	2	0	0
25	7431430	.	A	G	0	0	0	0	2	2	0	0
25	7456535	.	C	A	0	2	2	0	0	2	0	0
25	7456843	.	G	A	1	1	2	0	0	2	0	0
25	7480949	.	G	C	14	15	29	0	0	29	0	0
25	7481063	.	C	A	18	23	41	0	4	45	0	0
25	7481123	.	G	A	1	20	21	0	20	41	0	0
25	7481159	.	C	T	19	21	40	0	1	41	0	0
25	7485040	.	A	G	8	0	8	0	14	22	0	0
25	7485073	.	G	A	3	4	7	0	1	8	0	0
25	7485527	.	C	T	14	23	37	0	1	38	0	0
25	7485588	.	A	G	2	3	5	0	0	5	0	0
25	7487809	.	T	C	28	23	51	0	3	54	0	0
25	7488310	.	T	A	0	22	22	0	0	22	0	0
25	7488749	.	T	G	21	20	41	0	1	42	0	0
25	7488753	.	C	T	18	21	39	0	3	42	0	0
25	7488812	.	G	A	27	23	50	0	2	52	0	0
25	7488813	.	G	T	27	21	48	0	4	52	0	0
25	7489034	.	G	A	0	25	25	0	29	54	0	0
25	7489082	.	A	G	22	12	34	0	3	37	0	0
25	7489085	.	G	C	24	12	36	0	1	37	0	0
25	7492888	.	C	T	5	4	9	0	1	10	0	0
25	7494184	.	C	T	0	1	1	0	0	1	0	0
25	7494207	.	T	C	1	4	5	0	0	5	0	0
25	7494258	.	G	C	4	5	9	0	1	10	0	0
25	7496021	.	C	T	3	3	6	0	1	7	0	0
25	7496039	.	C	T	5	3	8	0	0	8	0	0
25	7496099	.	G	A	0	1	1	0	0	1	0	0
25	7502022	.	G	C	9	14	23	0	0	23	0	0
25	7502201	.	G	A	4	5	9	0	0	9	0	0
25	7502204	.	T	G	4	5	9	0	0	9	0	0
25	7502241	.	G	A	0	1	1	0	0	1	0	0
25	7502271	.	T	G	2	1	3	0	5	8	0	0
25	7520131	.	G	A	1	5	6	0	0	6	0	0
25	7533220	.	T	C	2	3	5	0	0	5	0	0
25	7533437	.	C	T	1	2	3	0	0	3	0	0
25	7533476	.	C	T	2	2	4	0	0	4	0	0
25	7533559	.	G	C	2	3	5	0	0	5	0	0
25	7553064	.	G	T	1	4	5	0	0	5	0	0
25	7556410	.	T	C	5	6	11	0	0	11	0	0
25	7556427	.	C	T	4	5	9	0	0	9	0	0
25	7556454	.	C	T	3	3	6	0	0	6	0	0
25	7560350	.	C	A	5	2	7	0	2	9	0	0
25	7562272	.	C	A	2	4	6	0	0	6	0	0
25	7562301	.	T	A	6	10	16	0	0	16	0	0
25	7562418	.	G	A	0	8	8	0	7	15	0	0
25	7562921	.	C	T	16	12	28	0	2	30	0	0
25	7562925	.	A	T	17	12	29	0	0	29	0	0
25	7562975	.	A	G	11	16	27	0	2	29	0	0
25	7580840	.	G	A	3	2	5	0	0	5	0	0
25	7580945	.	C	T	3	3	6	0	0	6	0	0
25	7585103	.	A	G	1	0	1	0	0	1	0	0
25	7586915	.	A	G	0	2	2	0	1	3	0	0
25	7587748	.	A	T	0	2	2	0	0	2	0	0
25	7589915	.	A	G	10	0	10	0	11	21	0	0
25	7589951	.	C	T	6	6	12	0	1	13	0	0
25	7590702	.	C	T	0	3	3	0	0	3	0	0
25	7590731	.	A	G	0	5	5	0	0	5	0	0
25	7667870	.	T	C	4	2	6	0	0	6	0	0
25	7668161	.	A	G	3	1	4	0	0	4	0	0
25	7668166	.	C	T	0	3	3	0	1	4	0	0
25	7672067	.	C	T	3	5	8	0	1	9	0	0
25	7672382	.	G	A	1	3	4	0	10	14	0	0
25	7672385	.	C	T	9	3	12	0	1	13	0	0
25	7673040	.	T	C	9	6	15	0	1	16	0	0
25	7673052	.	C	T	8	7	15	0	0	15	0	0
25	7673139	.	T	A	12	15	27	0	0	27	0	0
25	7673140	.	C	T	12	15	27	0	0	27	0	0
25	7673897	.	T	G	0	5	5	0	0	5	0	0
25	7673930	.	G	A	7	8	15	0	0	15	0	0
25	7673951	.	C	T	9	9	18	0	1	19	0	0
25	7674098	.	G	A	3	1	4	0	0	4	0	0
25	7678180	.	A	T	21	17	38	0	2	40	0	0
25	7693323	.	C	A	1	2	3	0	0	3	0	0
25	7693339	.	A	C	3	4	7	0	0	7	0	0
25	7693511	.	T	C	4	6	10	0	0	10	0	0
25	7693546	.	G	A	6	3	9	0	0	9	0	0
25	7693889	.	C	T	2	6	8	0	0	8	0	0
25	7694471	.	C	G	2	2	4	0	0	4	0	0
25	7694577	.	A	T	1	3	4	0	0	4	0	0
25	7695625	.	C	T	5	3	8	0	0	8	0	0
25	7695831	.	C	T	0	2	2	0	1	3	0	0
25	7696399	.	G	A	1	2	3	0	0	3	0	0
25	7697487	.	G	A	1	2	3	0	0	3	0	0
25	7697938	.	T	C	1	0	1	0	2	3	0	0
25	7697977	.	G	A	2	2	4	0	1	5	0	0
25	7697986	.	A	G	3	1	4	0	0	4	0	0
25	7698022	.	T	C	2	1	3	0	0	3	0	0
25	7698031	.	T	C	1	0	1	0	1	2	0	0
25	7734809	.	C	G	2	2	4	0	0	4	0	0
25	7784981	.	G	T	2	3	5	0	0	5	0	0
25	7890351	.	T	C	5	3	8	0	1	9	0	0
25	7890606	.	T	C	4	0	4	0	3	7	0	0
25	7890801	.	T	C	4	2	6	0	0	6	0	0
25	7890814	.	T	C	3	2	5	0	0	5	0	0
25	7891836	.	T	C	3	3	6	0	1	7	0	0
25	7891965	.	T	C	2	3	5	0	0	5	0	0
25	7892218	.	T	C	5	4	9	0	0	9	0	0
25	7892297	.	T	C	3	4	7	0	0	7	0	0
25	7988516	.	A	G	2	4	6	0	1	7	0	0
25	7988517	.	A	G	3	3	6	0	1	7	0	0
25	8478634	.	G	A	0	8	8	0	0	8	0	0
25	8478869	.	T	C	6	1	7	0	5	12	0	0
25	8482771	.	G	A	1	2	3	0	0	3	0	0
25	8486622	.	C	T	0	10	10	0	1	11	0	0
25	8486631	.	A	C	1	0	1	0	9	10	0	0
25	8486705	.	A	G	3	5	8	0	0	8	0	0
25	8486884	.	T	A	3	9	12	0	0	12	0	0
25	8495246	.	A	G	0	4	4	0	0	4	0	0
25	8500663	.	T	G	2	1	3	0	1	4	0	0
25	8500720	.	G	A	1	3	4	0	1	5	0	0
25	8500741	.	T	C	0	2	2	0	0	2	0	0
25	8511250	.	C	T	0	2	2	0	0	2	0	0
25	8624595	.	C	T	0	2	2	0	0	2	0	0
25	8627940	.	G	A	5	4	9	0	2	11	0	0
25	8627943	.	T	C	1	7	8	0	2	10	0	0
25	8628139	.	G	C	3	4	7	0	0	7	0	0
25	8630910	.	A	G	1	1	2	0	0	2	0	0
25	8631015	.	A	T	0	2	2	0	0	2	0	0
25	8631017	.	C	T	0	0	0	0	2	2	0	0
25	8639640	.	C	T	1	1	2	0	1	3	0	0
25	8642211	.	A	G	0	1	1	0	0	1	0	0
25	8642262	.	C	T	3	5	8	0	0	8	0	0
25	8645422	.	C	A	0	1	1	0	0	1	0	0
25	8646670	.	A	G	0	2	2	0	0	2	0	0
25	8660651	.	G	A	2	2	4	0	0	4	0	0
25	8666016	.	T	C	1	2	3	0	1	4	0	0
25	8666051	.	A	G	2	2	4	0	0	4	0	0
25	8700514	.	G	A	2	2	4	0	0	4	0	0
25	8700603	.	G	A	0	2	2	0	3	5	0	0
25	8707860	.	A	G	1	0	1	0	0	1	0	0
25	8722680	.	T	G	1	0	1	0	0	1	0	0
25	8736254	.	C	T	4	1	5	0	0	5	0	0
25	8739444	.	T	A	8	3	11	0	1	12	0	0
25	8739881	.	A	T	7	6	13	0	0	13	0	0
25	8740013	.	G	C	5	4	9	0	0	9	0	0
25	8740236	.	G	T	0	4	4	0	5	9	0	0
25	8740545	.	G	A	0	0	0	0	10	10	0	0
25	8740550	.	G	C	11	0	11	0	0	11	0	0
25	8740794	.	G	A	1	0	1	0	0	1	0	0
25	8740795	.	G	T	1	0	1	0	0	1	0	0
25	8740951	.	A	G	2	0	2	0	3	5	0	0
25	8740998	.	A	T	3	5	8	0	0	8	0	0
25	8741303	.	C	T	11	9	20	0	0	20	0	0
25	8741469	.	T	A	9	2	11	0	0	11	0	0
25	8741471	.	C	T	9	2	11	0	0	11	0	0
25	8741549	.	A	G	4	0	4	0	6	10	0	0
25	8741624	.	C	T	4	5	9	0	0	9	0	0
25	8741758	.	C	T	7	3	10	0	0	10	0	0
25	8741759	.	G	T	0	3	3	0	7	10	0	0
25	8741877	.	G	C	10	10	20	0	0	20	0	0
25	8741968	.	G	C	12	14	26	0	1	27	0	0
25	8742126	.	T	C	20	15	35	0	3	38	0	0
25	8742148	.	T	A	15	15	30	0	2	32	0	0
25	8756099	.	T	C	4	5	9	0	0	9	0	0
25	8756492	.	A	G	3	3	6	0	0	6	0	0
25	8756516	.	A	G	1	1	2	0	1	3	0	0
25	8756573	.	C	A	5	6	11	0	1	12	0	0
25	8757038	.	A	C	4	0	4	0	7	11	0	0
25	8767925	.	A	G	6	17	23	0	1	24	0	0
25	8773257	.	A	G	4	2	6	0	0	6	0	0
25	8773867	.	T	G	0	4	4	0	1	5	0	0
25	8773897	.	C	T	0	5	5	0	0	5	0	0
25	8834967	.	T	G	0	1	1	0	0	1	0	0
25	8834968	.	G	C	0	0	0	0	1	1	0	0
25	8852072	.	A	T	2	1	3	0	0	3	0	0
25	8908297	.	C	T	0	3	3	0	4	7	0	0
25	8916632	.	G	A	8	2	10	0	0	10	0	0
25	8916635	.	C	G	2	8	10	0	0	10	0	0
25	8925678	.	C	A	1	2	3	0	0	3	0	0
25	8925748	.	T	C	2	7	9	0	0	9	0	0
25	8925928	.	T	C	4	4	8	0	0	8	0	0
25	8926171	.	G	T	2	2	4	0	0	4	0	0
25	8946730	.	A	G	2	1	3	0	5	8	0	0
25	8946942	.	T	C	9	3	12	0	0	12	0	0
25	8948700	.	G	A	0	5	5	0	6	11	0	0
25	8948978	.	C	A	4	4	8	0	0	8	0	0
25	8949062	.	A	T	4	10	14	0	0	14	0	0
25	8949124	.	C	T	9	5	14	0	0	14	0	0
25	8949561	.	A	G	1	0	1	0	4	5	0	0
25	9012290	.	G	A	1	2	3	0	0	3	0	0
25	9678666	.	G	A	8	8	16	0	1	17	0	0
25	9679242	.	G	A	14	7	21	0	1	22	0	0
25	9679389	.	G	A	11	5	16	0	1	17	0	0
25	9679413	.	C	T	0	6	6	0	8	14	0	0
25	9679539	.	T	C	4	6	10	0	0	10	0	0
25	9680022	.	T	C	4	5	9	0	1	10	0	0
25	9680196	.	T	A	3	2	5	0	0	5	0	0
25	9680448	.	A	G	3	4	7	0	0	7	0	0
25	11702989	.	A	C	1	3	4	0	0	4	0	0
25	11702997	.	G	A	0	3	3	0	1	4	0	0
25	11796531	.	T	C	19	1	20	0	12	32	0	0
25	11796579	.	T	A	20	19	39	0	0	39	0	0
25	11796728	.	A	T	16	17	33	0	1	34	0	0
25	11796860	.	T	C	21	8	29	0	1	30	0	0
25	11796973	.	T	C	8	0	8	0	8	16	0	0
25	11796987	.	A	G	7	9	16	0	1	17	0	0
25	11797056	.	G	C	10	7	17	0	1	18	0	0
25	11797515	.	A	G	10	13	23	0	0	23	0	0
25	11797550	.	G	T	9	10	19	0	2	21	0	0
25	11797789	.	A	T	7	8	15	0	0	15	0	0
25	11797912	.	T	A	7	7	14	0	0	14	0	0
25	11797979	.	A	G	3	5	8	0	0	8	0	0
25	11797990	.	A	G	3	5	8	0	0	8	0	0
25	11798043	.	G	A	1	4	5	0	0	5	0	0
25	11798081	.	T	C	3	0	3	0	7	10	0	0
25	11798215	.	A	C	13	3	16	0	1	17	0	0
25	11798227	.	T	A	11	2	13	0	0	13	0	0
25	11798333	.	A	T	3	7	10	0	1	11	0	0
25	11798381	.	T	A	9	9	18	0	0	18	0	0
25	11798509	.	A	T	8	4	12	0	1	13	0	0
25	11798511	.	C	A	0	5	5	0	8	13	0	0
25	11798598	.	C	T	3	8	11	0	0	11	0	0
25	11798659	.	A	T	1	3	4	0	1	5	0	0
25	11798863	.	G	C	2	2	4	0	0	4	0	0
25	11798922	.	A	G	5	3	8	0	1	9	0	0
25	11799527	.	A	T	6	6	12	0	0	12	0	0
25	11799577	.	G	A	8	7	15	0	0	15	0	0
25	11799625	.	A	T	8	3	11	0	0	11	0	0
25	11799670	.	G	T	9	4	13	0	1	14	0	0
25	11799685	.	A	G	7	4	11	0	0	11	0	0
25	11799750	.	A	T	4	5	9	0	0	9	0	0
25	11799768	.	A	G	7	3	10	0	0	10	0	0
25	11800098	.	G	C	4	6	10	0	1	11	0	0
25	11800140	.	A	G	3	4	7	0	0	7	0	0
25	11800328	.	C	T	0	3	3	0	2	5	0	0
25	11800358	.	C	A	1	4	5	0	0	5	0	0
25	11800522	.	G	A	4	6	10	0	1	11	0	0
25	11800652	.	C	T	1	8	9	0	1	10	0	0
25	11800883	.	C	T	7	5	12	0	0	12	0	0
25	11801111	.	C	A	2	3	5	0	0	5	0	0
25	11801513	.	A	C	4	4	8	0	0	8	0	0
25	11801642	.	C	G	4	7	11	0	0	11	0	0
25	11801731	.	C	G	3	3	6	0	0	6	0	0
25	11801838	.	A	C	3	0	3	0	3	6	0	0
25	11801841	.	G	T	3	3	6	0	0	6	0	0
25	11802115	.	C	A	2	3	5	0	1	6	0	0
25	11802192	.	T	A	1	3	4	0	1	5	0	0
25	11802306	.	C	A	0	6	6	0	4	10	0	0
25	11802485	.	C	T	1	4	5	0	8	13	0	0
25	11803455	.	G	T	4	4	8	0	0	8	0	0
25	11803467	.	A	T	4	5	9	0	0	9	0	0
25	11804490	.	T	G	6	3	9	0	0	9	0	0
25	11894540	.	G	A	1	3	4	0	0	4	0	0
25	12406706	.	A	G	1	3	4	0	0	4	0	0
25	12409479	.	G	T	2	2	4	0	0	4	0	0
25	12412696	.	G	T	1	2	3	0	0	3	0	0
25	12494253	.	A	C	25	16	41	0	0	41	0	0
25	12504795	.	G	A	33	23	56	0	6	62	0	0
25	12504863	.	C	T	24	25	49	0	0	49	0	0
25	12504913	.	A	T	31	20	51	0	3	54	0	0
25	12504926	.	T	G	28	23	51	0	0	51	0	0
25	12505103	.	C	T	25	13	38	0	3	41	0	0
25	12505121	.	A	G	22	0	22	0	19	41	0	0
25	12505185	.	T	C	31	19	50	0	1	51	0	0
25	12505222	.	T	C	32	23	55	0	3	59	1	0
25	12505299	.	C	T	33	15	48	0	3	51	0	0
25	12505327	.	T	C	26	17	43	0	5	48	0	0
25	12505356	.	T	G	22	23	45	0	3	48	0	0
25	12505542	.	A	G	17	3	20	0	26	46	0	0
25	12505984	.	C	T	3	3	6	0	0	6	0	0
25	12640549	.	C	T	3	6	9	0	0	9	0	0
25	12656712	.	C	G	9	4	13	0	0	13	0	0
25	12657103	.	C	T	11	8	19	0	0	19	0	0
25	12657193	.	C	T	7	5	12	0	1	13	0	0
25	12688845	.	C	T	3	4	7	0	0	7	0	0
25	12695658	.	C	T	9	10	19	0	0	19	0	0
25	12695750	.	T	A	6	6	12	0	2	14	0	0
25	12695779	.	T	C	12	9	21	0	0	21	0	0
25	12695810	.	T	A	17	13	30	0	0	30	0	0
25	12707716	.	C	T	6	8	14	0	0	14	0	0
25	12707730	.	A	G	5	10	15	0	0	15	0	0
25	12707849	.	T	C	2	0	2	0	5	7	0	0
25	12707884	.	A	G	0	1	1	0	0	1	0	0
25	12717574	.	C	T	12	4	16	0	1	17	0	0
25	12717704	.	G	T	2	2	4	0	0	4	0	0
25	12719867	.	A	G	2	4	6	0	0	6	0	0
25	12723890	.	G	A	1	1	2	0	0	2	0	0
25	12723960	.	A	G	1	2	3	0	0	3	0	0
25	12727852	.	T	C	2	0	2	0	1	3	0	0
25	12729928	.	A	G	0	1	1	0	0	1	0	0
25	12730124	.	T	C	2	5	7	0	0	7	0	0
25	12730164	.	A	G	1	7	8	0	0	8	0	0
25	12798321	.	C	T	1	1	2	0	1	3	0	0
25	12798328	.	T	C	1	2	3	0	0	3	0	0
25	12798468	.	T	G	4	5	9	0	0	9	0	0
25	12798560	.	G	A	7	4	11	0	0	11	0	0
25	12804003	.	A	G	2	4	6	0	0	6	0	0
25	12804006	.	A	G	2	4	6	0	0	6	0	0
25	12804051	.	T	C	0	1	1	0	0	1	0	0
25	12804428	.	A	G	5	1	6	0	0	6	0	0
25	12804512	.	A	T	5	4	9	0	0	9	0	0
25	12809004	.	A	G	2	4	6	0	0	6	0	0
25	12811755	.	A	G	7	8	15	0	0	15	0	0
25	12811901	.	G	A	8	12	20	0	1	21	0	0
25	12816557	.	G	A	1	5	6	0	1	7	0	0
25	12816888	.	G	A	5	8	13	0	0	13	0	0
25	12818948	.	T	G	3	2	5	0	0	5	0	0
25	12819014	.	C	A	0	1	1	0	0	1	0	0
25	12819197	.	A	C	1	2	3	0	0	3	0	0
25	12843535	.	C	T	0	1	1	0	0	1	0	0
25	12853243	.	C	T	1	2	3	0	0	3	0	0
25	12853318	.	C	A	11	15	26	0	1	27	0	0
25	12853377	.	T	C	18	0	18	0	29	47	0	0
25	12853407	.	A	T	21	25	46	0	2	48	0	0
25	12853498	.	A	C	18	9	27	0	0	27	0	0
25	12853602	.	T	C	19	23	42	0	4	46	0	0
25	12853611	.	T	A	22	26	48	0	1	49	0	0
25	12853762	.	T	C	15	1	16	0	22	38	0	0
25	12853850	.	A	C	19	25	44	0	1	45	0	0
25	12854016	.	G	A	23	26	49	0	1	50	0	0
25	12854021	.	T	A	22	27	49	0	3	52	0	0
25	12854266	.	A	T	29	13	42	0	4	46	0	0
25	12854279	.	T	G	26	23	49	0	1	50	0	0
25	12854393	.	T	C	16	17	33	0	2	35	0	0
25	12858013	.	C	T	7	9	16	1	0	17	0	0
25	12858025	.	G	T	5	5	10	0	0	10	0	0
25	12859458	.	T	C	1	1	2	0	0	2	0	0
25	12859464	.	T	C	1	0	1	0	1	2	0	0
25	12866625	.	C	T	3	2	5	0	0	5	0	0
25	12871405	.	G	A	3	6	9	0	0	9	0	0
25	12906738	.	A	G	11	6	17	0	1	18	0	0
25	12906775	.	G	T	7	13	20	0	2	22	0	0
25	12906777	.	C	A	7	14	21	0	1	22	0	0
25	12906814	.	G	A	12	17	29	0	0	29	0	0
25	12925325	.	G	A	1	4	5	0	0	5	0	0
25	12925326	.	C	A	1	4	5	0	0	5	0	0
25	12925574	.	A	T	2	0	2	0	0	2	0	0
25	13332406	.	A	T	32	27	59	0	5	64	0	0
25	13332531	.	C	T	31	28	59	0	4	63	0	0
25	13332693	.	G	A	38	41	79	0	1	80	0	0
25	13333191	.	G	T	47	33	80	0	0	80	0	0
25	13333463	.	G	A	32	43	75	0	17	92	0	0
25	13333508	.	A	T	36	38	74	0	1	75	0	0
25	13333665	.	C	T	31	33	64	1	3	68	0	0
25	13333809	.	G	A	20	34	54	0	1	55	0	0
25	13333839	.	A	T	21	11	32	0	4	36	0	0
25	13333986	.	T	A	28	37	65	0	4	69	0	0
25	13334304	.	T	C	27	0	27	0	22	49	0	0
25	13334487	.	A	T	35	12	47	0	1	48	0	0
25	13334729	.	C	T	33	37	70	0	5	75	0	0
25	13334744	.	C	T	29	46	75	0	2	77	0	0
25	13334977	.	A	T	39	27	66	0	5	71	0	0
25	13334990	.	A	T	27	40	67	0	2	71	2	0
25	13335040	.	T	C	28	4	32	0	34	66	0	0
25	13335071	.	G	C	30	34	64	0	3	67	0	0
25	13335607	.	G	T	22	33	55	0	5	60	0	0
25	13335674	.	A	T	24	30	54	0	2	56	0	0
25	13335762	.	C	T	11	16	27	0	0	27	0	0
25	13335765	.	C	T	0	16	16	0	11	27	0	0
25	13335926	.	C	T	49	12	61	0	2	63	0	0
25	13336129	.	C	A	30	24	54	0	3	57	0	0
25	13336277	.	G	A	15	25	40	0	2	42	0	0
25	13336323	.	T	G	31	35	66	0	3	69	0	0
25	13336343	.	T	C	36	26	62	0	3	65	0	0
25	13336493	.	A	G	25	30	55	0	5	60	0	0
25	13336545	.	T	C	23	34	57	0	2	59	0	0
25	13336598	.	C	G	28	36	64	0	1	65	0	0
25	13336685	.	G	A	3	6	9	0	8	17	0	0
25	13336768	.	A	C	40	20	60	0	2	62	0	0
25	13336861	.	A	G	29	21	50	0	3	53	0	0
25	13336926	.	C	T	20	30	50	0	2	52	0	0
25	13336930	.	C	T	19	28	47	0	2	49	0	0
25	13337184	.	C	G	29	19	48	0	4	53	1	0
25	13337272	.	G	A	35	29	64	0	10	74	0	0
25	13337338	.	G	A	25	21	46	0	3	49	0	0
25	13350259	.	A	G	4	3	7	0	0	7	0	0
25	13351957	.	T	C	15	21	36	0	3	39	0	0
25	13352008	.	G	A	3	2	5	0	0	5	0	0
25	13363206	.	C	T	0	10	10	0	10	20	0	0
25	13363248	.	G	T	19	17	36	0	1	37	0	0
25	13363258	.	G	A	18	16	34	0	0	34	0	0
25	13406138	.	G	C	12	11	23	0	1	24	0	0
25	13470123	.	T	C	23	17	40	0	1	41	0	0
25	13470336	.	G	T	0	10	10	0	14	24	0	0
25	13470430	.	A	T	19	17	36	0	2	38	0	0
25	13471079	.	A	C	21	15	36	0	0	36	0	0
25	13474192	.	G	A	1	2	3	0	0	3	0	0
25	13474246	.	C	T	5	5	10	0	1	11	0	0
25	13474411	.	A	G	1	2	3	0	1	4	0	0
25	13478185	.	G	T	1	2	3	0	0	3	0	0
25	13478217	.	T	G	4	4	8	0	1	9	0	0
25	13479710	.	G	A	0	2	2	0	0	2	0	0
25	13484787	.	A	G	2	2	4	0	0	4	0	0
25	13484791	.	T	C	2	2	4	0	0	4	0	0
25	13485301	.	G	A	2	5	7	0	0	7	0	0
25	13485370	.	A	T	8	1	9	0	0	9	0	0
25	13488501	.	C	T	1	2	3	0	0	3	0	0
25	13490637	.	T	C	3	0	3	0	3	6	0	0
25	13510467	.	G	C	0	4	4	0	7	11	0	0
25	13525848	.	A	T	4	14	18	0	1	19	0	0
25	13525864	.	G	A	5	13	18	0	2	20	0	0
25	13526171	.	A	C	4	16	20	0	0	20	0	0
25	13528361	.	G	A	4	3	7	0	0	7	0	0
25	13528732	.	G	A	2	5	7	0	0	7	0	0
25	13529294	.	A	G	2	2	4	0	0	4	0	0
25	13531933	.	G	A	1	0	1	0	0	1	0	0
25	13559168	.	T	G	7	7	14	0	2	16	0	0
25	13559194	.	G	A	6	10	16	0	1	17	0	0
25	13559548	.	T	A	10	7	17	0	3	20	0	0
25	13559633	.	T	C	8	0	8	0	11	19	0	0
25	13559950	.	G	A	5	14	19	0	0	19	0	0
25	13559953	.	A	T	14	6	20	0	0	20	0	0
25	13560080	.	C	T	5	6	11	0	1	12	0	0
25	13560342	.	T	C	21	9	30	0	0	30	0	0
25	13560518	.	G	A	10	6	16	0	0	16	0	0
25	13560638	.	C	A	3	3	6	0	0	6	0	0
25	13561133	.	T	C	6	4	10	0	0	10	0	0
25	13561149	.	T	C	5	6	11	0	0	11	0	0
25	13561775	.	C	A	0	4	4	0	1	5	0	0
25	13561851	.	A	C	1	2	3	0	0	3	0	0
25	13689166	.	G	A	1	6	7	0	0	7	0	0
25	14421980	.	A	C	1	0	1	0	3	4	0	0
25	15349502	.	G	T	3	2	5	0	0	5	0	0
25	15648092	.	A	G	4	3	7	0	0	7	0	0
25	15694794	.	T	G	3	1	4	0	0	4	0	0
25	15694823	.	G	A	3	0	3	0	0	3	0	0
25	15769320	.	C	G	2	1	3	0	1	4	0	0
25	15792621	.	C	T	13	12	25	0	1	26	0	0
25	15792625	.	A	G	14	11	25	0	0	25	0	0
25	15799767	.	C	A	18	22	40	0	0	40	0	0
25	15800559	.	A	G	8	1	9	0	9	18	0	0
25	15841757	.	T	C	12	7	19	0	0	19	0	0
25	15841767	.	T	C	11	6	17	0	0	17	0	0
25	15857126	.	C	G	3	6	9	0	0	9	0	0
25	15857129	.	C	T	3	6	9	0	0	9	0	0
25	15888282	.	G	T	1	5	6	0	0	6	0	0
25	15893140	.	C	T	12	9	21	0	0	21	0	0
25	15905378	.	A	G	7	0	7	0	3	10	0	0
25	15905654	.	G	A	0	5	5	0	9	14	0	0
25	16027795	.	G	A	0	1	1	0	0	1	0	0
25	16032614	.	C	A	1	1	2	0	0	2	0	0
25	16035983	.	G	T	0	1	1	0	0	1	0	0
25	16036064	.	G	A	2	5	7	0	0	7	0	0
25	16041768	.	G	C	4	2	6	0	0	6	0	0
25	16041823	.	T	G	4	2	6	0	0	6	0	0
25	16042405	.	A	G	1	2	3	0	0	3	0	0
25	16042428	.	C	A	3	2	5	0	1	6	0	0
25	16042539	.	G	A	2	1	3	0	0	3	0	0
25	16044986	.	T	A	1	0	1	0	0	1	0	0
25	16045078	.	C	T	4	3	7	0	2	9	0	0
25	16045418	.	C	G	2	5	7	0	0	7	0	0
25	16045427	.	C	G	2	6	8	0	1	9	0	0
25	16045517	.	T	C	4	8	12	0	1	13	0	0
25	16045574	.	T	C	1	6	7	0	0	7	0	0
25	16045656	.	A	G	2	0	2	0	3	5	0	0
25	16045686	.	G	C	4	4	8	0	0	8	0	0
25	16045700	.	A	G	4	3	7	0	1	8	0	0
25	16045786	.	T	C	1	0	1	0	0	5	4	0
25	16045789	.	T	G	1	0	1	0	0	5	4	0
25	16046004	.	C	T	4	7	11	0	0	11	0	0
25	16046407	.	A	G	1	2	3	0	0	3	0	0
25	16046419	.	G	T	2	5	7	0	0	7	0	0
25	16046473	.	T	G	2	10	12	0	0	12	0	0
25	16046492	.	T	G	1	7	8	0	0	8	0	0
25	16046543	.	T	C	2	4	6	0	0	6	0	0
25	16046544	.	C	T	2	4	6	0	0	6	0	0
25	17417529	.	G	A	1	6	7	0	1	8	0	0
25	17479430	.	A	G	2	3	5	0	0	5	0	0
25	17479760	.	G	A	4	3	7	0	0	7	0	0
25	17485825	.	A	T	4	3	7	0	0	7	0	0
25	17490629	.	A	G	3	2	5	0	0	5	0	0
25	17495663	.	G	T	2	0	2	0	0	2	0	0
25	17495671	.	C	T	2	2	4	0	0	4	0	0
25	17495947	.	C	T	0	2	2	0	2	4	0	0
25	17590330	.	C	G	2	2	4	0	0	4	0	0
25	17590670	.	C	T	1	0	1	0	0	1	0	0
25	17596788	.	C	T	0	1	1	0	0	1	0	0
25	17605433	.	A	G	4	0	4	0	1	5	0	0
25	17606587	.	C	T	10	4	14	0	0	14	0	0
25	17610834	.	T	C	14	12	26	0	0	26	0	0
25	17610867	.	A	G	14	0	14	0	13	27	0	0
25	17611017	.	C	T	9	5	14	0	0	14	0	0
25	17611217	.	C	A	4	4	8	0	0	8	0	0
25	17756661	.	G	A	1	3	4	0	1	5	0	0
25	17756675	.	A	G	2	0	2	0	3	5	0	0
25	17793907	.	T	C	0	3	3	0	0	3	0	0
25	17807652	.	G	A	0	2	2	0	0	2	0	0
25	17807679	.	A	T	2	3	5	0	0	5	0	0
25	17825010	.	T	C	2	6	8	0	0	8	0	0
25	17825186	.	G	A	0	3	3	0	2	5	0	0
25	17847117	.	C	T	13	5	18	0	0	18	0	0
25	17847242	.	T	C	8	12	20	0	0	20	0	0
25	17847251	.	G	T	10	11	21	0	1	22	0	0
25	17847328	.	A	G	1	0	1	0	2	3	0	0
25	17849049	.	G	A	0	3	3	0	2	5	0	0
25	17849306	.	G	C	8	4	12	0	0	12	0	0
25	17849572	.	A	T	1	4	5	0	1	6	0	0
25	17850151	.	T	G	3	4	7	0	0	7	0	0
25	17864945	.	A	G	1	2	3	0	0	3	0	0
25	17870916	.	A	G	2	2	4	0	0	4	0	0
25	17887154	.	A	G	6	9	15	0	0	15	0	0
25	17891011	.	G	A	17	17	34	0	2	36	0	0
25	17891218	.	A	C	11	11	22	0	2	24	0	0
25	17891616	.	A	T	17	9	26	0	2	28	0	0
25	17891654	.	G	A	6	15	21	0	0	21	0	0
25	17892352	.	A	T	4	3	7	0	0	7	0	0
25	17892354	.	A	T	4	4	8	0	0	8	0	0
25	17892405	.	A	T	5	13	18	0	2	20	0	0
25	17892517	.	T	G	10	12	22	0	0	22	0	0
25	17892643	.	G	A	1	16	17	0	1	18	0	0
25	17901093	.	C	T	3	2	5	0	11	16	0	0
25	17904020	.	G	A	10	10	20	0	6	26	0	0
25	17904131	.	G	A	3	4	7	0	0	7	0	0
25	17905153	.	C	T	1	0	1	0	0	1	0	0
25	17905297	.	T	C	4	2	6	0	0	6	0	0
25	17905486	.	A	G	0	1	1	0	0	1	0	0
25	17907138	.	G	A	4	6	10	0	1	11	0	0
25	17918735	.	T	C	1	1	2	0	0	2	0	0
25	17924018	.	C	T	2	0	2	0	0	2	0	0
25	17924680	.	C	T	6	8	14	0	0	14	0	0
25	17925482	.	T	A	2	5	7	0	0	7	0	0
25	17932234	.	T	C	3	3	6	0	0	6	0	0
25	17932249	.	G	A	4	2	6	0	0	6	0	0
25	17932486	.	G	A	9	5	14	0	2	16	0	0
25	17934417	.	G	A	3	8	11	0	0	11	0	0
25	17934452	.	G	A	10	5	15	0	0	15	0	0
25	17934557	.	T	A	10	3	13	0	0	13	0	0
25	17934587	.	G	C	7	2	9	0	1	11	1	0
25	17934604	.	C	A	7	2	9	0	1	10	0	0
25	17934711	.	C	T	5	9	14	0	10	24	0	0
25	17934813	.	A	G	9	5	14	0	5	19	0	0
25	17938365	.	G	A	1	1	2	0	0	2	0	0
25	17954629	.	G	A	0	1	1	0	1	2	0	0
25	17955987	.	C	T	1	4	5	0	0	5	0	0
25	17956071	.	C	T	0	4	4	0	1	5	0	0
25	17969931	.	C	T	0	2	2	0	0	2	0	0
25	17972820	.	C	T	0	1	1	0	0	1	0	0
25	17977799	.	A	T	2	3	5	0	0	5	0	0
25	17990393	.	T	A	1	1	2	0	0	2	0	0
25	17998404	.	A	C	1	2	3	0	0	3	0	0
25	18031372	.	G	A	1	4	5	0	0	5	0	0
25	18031462	.	C	T	1	2	3	0	0	3	0	0
25	18039060	.	C	T	1	1	2	0	0	2	0	0
25	18039078	.	T	A	1	1	2	0	0	2	0	0
25	18052468	.	C	A	2	2	4	0	1	5	0	0
25	18052663	.	T	C	4	4	8	0	1	9	0	0
25	18052840	.	T	C	5	9	14	0	1	15	0	0
25	18052864	.	C	T	5	7	12	0	0	12	0	0
25	18053319	.	T	G	1	3	4	0	0	4	0	0
25	18053338	.	A	G	3	3	6	0	0	6	0	0
25	18053440	.	T	A	5	2	7	0	1	8	0	0
25	18053680	.	A	C	2	3	5	0	0	5	0	0
25	18054030	.	G	C	3	6	9	0	0	9	0	0
25	18054317	.	T	C	5	8	13	0	0	13	0	0
25	18054503	.	G	C	4	6	10	0	0	10	0	0
25	18054573	.	C	A	7	10	17	0	0	17	0	0
25	18054723	.	T	C	11	7	18	0	1	19	0	0
25	18119387	.	C	A	0	5	5	0	0	5	0	0
25	18122159	.	C	T	0	0	0	0	1	1	0	0
25	18122202	.	G	A	1	0	1	0	0	1	0	0
25	18326988	.	T	G	22	23	45	0	3	48	0	0
25	18327559	.	G	A	14	10	24	0	2	26	0	0
25	18328884	.	G	C	10	0	10	0	16	26	0	0
25	18440779	.	A	T	2	3	5	0	0	5	0	0
25	18440803	.	A	G	1	0	1	0	1	2	0	0
25	18443485	.	A	C	5	2	7	0	0	7	0	0
25	18443596	.	T	C	2	1	3	0	0	3	0	0
25	18575547	.	G	A	0	2	2	0	1	3	0	0
25	18575636	.	A	T	1	4	5	0	0	5	0	0
25	18576273	.	G	T	1	2	3	0	1	4	0	0
25	18576336	.	C	A	0	1	1	0	1	2	0	0
25	18577142	.	A	G	3	2	5	0	0	5	0	0
25	18711899	.	T	A	2	4	6	0	0	6	0	0
25	18711913	.	T	A	2	4	6	0	0	6	0	0
25	18714979	.	C	T	1	0	1	0	0	1	0	0
25	18715376	.	C	T	2	5	7	0	0	7	0	0
25	18715662	.	A	T	2	0	2	0	0	2	0	0
25	18720143	.	T	A	2	1	3	0	0	3	0	0
25	18720166	.	G	A	5	3	8	0	0	8	0	0
25	18720205	.	T	A	3	6	9	0	0	9	0	0
25	18720216	.	T	C	2	5	7	0	0	7	0	0
25	18720384	.	C	T	0	1	1	0	0	1	0	0
25	18720512	.	A	G	3	3	6	0	0	6	0	0
25	18885964	.	G	A	3	3	6	0	0	6	0	0
25	18886500	.	C	A	1	2	3	0	0	3	0	0
25	18886644	.	T	G	3	2	5	0	0	5	0	0
25	18886658	.	T	C	2	2	4	0	0	4	0	0
25	18886899	.	C	A	4	6	10	0	0	10	0	0
25	18886941	.	A	G	3	0	3	0	2	5	0	0
25	18886944	.	T	A	3	2	5	0	0	5	0	0
25	18887065	.	A	G	3	3	6	0	0	6	0	0
25	18887476	.	G	A	2	2	4	0	0	4	0	0
25	18887477	.	C	A	2	1	3	0	1	4	0	0
25	18887600	.	T	G	2	9	11	0	1	12	0	0
25	18887738	.	G	T	2	3	5	0	0	5	0	0
25	18887774	.	A	G	4	4	8	0	0	8	0	0
25	18890561	.	G	A	0	1	1	0	0	1	0	0
25	18890580	.	C	T	0	1	1	0	0	1	0	0
25	18890880	.	C	G	0	1	1	0	0	1	0	0
25	18894751	.	T	C	3	3	6	0	0	6	0	0
25	18894807	.	C	T	0	1	1	0	0	1	0	0
25	18899589	.	G	A	0	1	1	0	0	1	0	0
25	18899616	.	T	A	2	2	4	0	0	4	0	0
25	18899637	.	G	A	0	1	1	0	3	4	0	0
25	18903419	.	T	C	1	2	3	0	0	3	0	0
25	18903422	.	A	G	1	2	3	0	0	3	0	0
25	18906540	.	A	G	2	4	6	0	0	6	0	0
25	18906596	.	T	A	2	2	4	0	0	4	0	0
25	18906760	.	G	T	2	3	5	0	0	5	0	0
25	18906917	.	A	G	3	4	7	0	1	8	0	0
25	18907043	.	A	T	5	6	11	0	1	12	0	0
25	18907074	.	C	T	5	3	8	0	0	8	0	0
25	18907213	.	G	A	9	4	13	0	1	14	0	0
25	18907218	.	C	T	11	4	15	0	0	15	0	0
25	18908255	.	T	C	5	4	9	0	1	10	0	0
25	18908313	.	G	A	6	6	12	0	0	12	0	0
25	18908397	.	C	A	1	11	12	0	1	13	0	0
25	18908403	.	T	C	3	10	13	0	0	13	0	0
25	18908647	.	A	G	4	2	6	0	0	6	0	0
25	18908661	.	A	G	6	5	11	0	1	12	0	0
25	18908774	.	T	C	0	3	3	0	0	3	0	0
25	18908794	.	T	A	1	1	2	0	0	2	0	0
25	18908810	.	G	A	1	1	2	0	1	3	0	0
25	18948706	.	G	T	1	1	2	0	0	2	0	0
25	18948752	.	A	T	1	2	3	0	0	3	0	0
25	18951829	.	G	A	1	4	5	0	0	5	0	0
25	18952163	.	A	G	1	6	7	0	0	7	0	0
25	18952238	.	G	A	4	9	13	0	0	13	0	0
25	18953285	.	T	C	4	3	7	0	0	7	0	0
25	18953830	.	G	T	2	2	4	0	0	4	0	0
25	18956959	.	G	A	0	4	4	0	2	6	0	0
25	18959047	.	G	C	0	1	1	0	0	1	0	0
25	18959251	.	G	A	7	4	11	0	0	11	0	0
25	18961792	.	A	T	4	3	7	0	0	7	0	0
25	18962041	.	A	G	1	3	4	0	0	4	0	0
25	18962235	.	A	G	2	2	4	0	1	5	0	0
25	18962782	.	G	T	3	3	6	0	1	7	0	0
25	18962802	.	T	C	4	4	8	0	1	9	0	0
25	18962858	.	C	T	9	10	19	0	1	20	0	0
25	18963052	.	G	A	3	2	5	0	1	6	0	0
25	18963418	.	G	A	9	2	11	0	0	11	0	0
25	18963607	.	A	G	3	3	6	0	1	7	0	0
25	18970837	.	C	T	1	8	9	0	0	9	0	0
25	18976498	.	C	T	0	1	1	0	0	1	0	0
25	18976522	.	A	G	1	0	1	0	3	4	0	0
25	18976555	.	C	T	3	7	10	0	0	10	0	0
25	18977092	.	A	G	4	3	7	0	0	7	0	0
25	18977364	.	A	G	6	8	14	0	1	15	0	0
25	18977422	.	A	G	7	4	11	0	1	12	0	0
25	18977423	.	A	G	7	5	12	0	0	12	0	0
25	19009527	.	T	C	1	2	3	0	0	3	0	0
25	19013611	.	C	T	1	4	5	0	0	5	0	0
25	19016690	.	T	C	1	3	4	0	0	4	0	0
25	19016736	.	C	T	1	3	4	0	0	4	0	0
25	19018845	.	T	C	1	0	1	0	0	1	0	0
25	19019003	.	A	T	7	20	27	0	1	28	0	0
25	19020981	.	G	A	0	15	15	0	13	28	0	0
25	19021062	.	T	C	2	4	6	0	0	6	0	0
25	19021618	.	C	A	7	5	12	0	1	13	0	0
25	19021647	.	T	G	8	0	8	0	8	16	0	0
25	19021680	.	A	G	6	9	15	0	0	15	0	0
25	19026877	.	A	C	0	1	1	0	0	1	0	0
25	19028610	.	G	A	2	5	7	0	0	7	0	0
25	19028637	.	C	T	1	4	5	0	1	6	0	0
25	19090298	.	G	A	3	2	5	0	0	5	0	0
25	19090299	.	A	G	3	2	5	0	0	5	0	0
25	19097035	.	A	T	2	4	6	0	0	6	0	0
25	19097082	.	A	T	3	4	7	0	0	7	0	0
25	19097214	.	A	C	6	5	11	0	0	11	0	0
25	19097247	.	A	G	4	8	12	0	1	13	0	0
25	19097314	.	A	C	2	5	7	0	0	7	0	0
25	19100030	.	T	A	12	14	26	0	1	27	0	0
25	19100353	.	G	T	2	6	8	0	0	8	0	0
25	19100358	.	T	C	2	7	9	0	0	9	0	0
25	19107718	.	G	A	0	3	3	0	0	3	0	0
25	19109211	.	T	G	1	3	4	0	0	4	0	0
25	19111574	.	C	T	3	5	8	0	0	8	0	0
25	19111758	.	C	T	2	0	2	0	0	2	0	0
25	19111806	.	C	T	4	4	8	0	0	8	0	0
25	19112824	.	T	C	2	1	3	0	0	3	0	0
25	19112875	.	G	A	1	1	2	0	0	2	0	0
25	19117965	.	A	G	1	4	5	0	0	5	0	0
25	19118062	.	T	A	2	2	4	0	0	4	0	0
25	19118089	.	T	A	2	2	4	0	0	4	0	0
25	19120764	.	A	G	3	2	5	0	0	5	0	0
25	19120800	.	C	T	3	5	8	0	1	9	0	0
25	19120918	.	T	C	3	3	6	0	0	6	0	0
25	19120926	.	T	C	3	3	6	0	0	6	0	0
25	19121092	.	T	C	4	8	12	0	0	12	0	0
25	19121126	.	T	C	8	0	8	0	5	13	0	0
25	19133092	.	G	C	0	1	1	0	0	1	0	0
25	19179124	.	A	C	3	2	5	0	0	5	0	0
25	19180159	.	C	T	2	2	4	0	0	4	0	0
25	19181396	.	T	C	5	11	16	0	1	17	0	0
25	19181471	.	A	T	5	2	7	0	0	7	0	0
25	19184051	.	T	C	1	2	3	0	2	5	0	0
25	19184105	.	T	G	5	0	5	0	5	10	0	0
25	19184159	.	A	C	1	0	1	0	0	2	1	0
25	19188454	.	C	T	13	13	26	0	3	29	0	0
25	19189113	.	T	G	1	3	4	0	0	4	0	0
25	19189144	.	T	C	2	3	5	0	0	5	0	0
25	19189194	.	A	G	2	1	3	0	6	9	0	0
25	19189217	.	G	A	4	6	10	0	0	10	0	0
25	19189238	.	C	A	2	4	6	0	1	7	0	0
25	19189461	.	C	A	3	4	7	0	0	7	0	0
25	19189502	.	T	G	7	3	10	0	0	10	0	0
25	19189968	.	C	A	3	3	6	0	0	6	0	0
25	19190111	.	T	C	5	7	12	0	0	12	0	0
25	19190183	.	G	A	6	4	10	0	0	10	0	0
25	19190244	.	C	A	2	7	9	0	0	9	0	0
25	19190282	.	A	C	2	4	6	0	0	6	0	0
25	19190376	.	G	T	5	8	13	0	0	13	0	0
25	19190408	.	C	T	4	6	10	0	0	10	0	0
25	19190541	.	A	C	3	3	6	0	0	6	0	0
25	19191325	.	C	T	3	4	7	0	0	7	0	0
25	19191575	.	C	T	12	15	27	0	0	27	0	0
25	19191652	.	T	G	15	1	16	0	21	37	0	0
25	19191797	.	A	C	6	13	19	0	7	26	0	0
25	19191959	.	A	T	10	12	22	0	0	22	0	0
25	19205783	.	G	C	1	6	7	0	0	7	0	0
25	19272737	.	A	G	1	0	1	0	0	1	0	0
25	19312623	.	C	T	1	1	2	0	0	2	0	0
25	19356594	.	C	T	8	3	11	0	0	11	0	0
25	19359314	.	G	A	17	14	31	0	1	32	0	0
25	19359402	.	A	G	19	15	34	0	0	34	0	0
25	19359640	.	C	T	1	15	16	0	26	42	0	0
25	19359734	.	A	G	28	20	48	0	0	48	0	0
25	19361012	.	C	T	14	13	27	0	2	29	0	0
25	19363616	.	G	A	17	13	30	0	1	31	0	0
25	19364155	.	G	A	24	18	42	0	3	45	0	0
25	19364184	.	T	A	19	22	41	0	1	42	0	0
25	19364210	.	T	G	13	22	35	0	2	37	0	0
25	19364519	.	T	A	27	18	45	0	2	47	0	0
25	19364598	.	T	G	20	19	39	0	1	40	0	0
25	19364642	.	C	T	19	21	40	0	2	42	0	0
25	19364717	.	A	G	11	18	29	0	0	29	0	0
25	19365053	.	G	A	17	10	27	0	2	29	0	0
25	19365559	.	G	A	14	12	26	0	2	28	0	0
25	19365647	.	A	G	11	18	29	0	1	30	0	0
25	19366124	.	A	G	11	17	28	0	0	28	0	0
25	19366175	.	A	T	8	13	21	0	0	21	0	0
25	19366363	.	T	C	9	17	26	0	0	26	0	0
25	19366432	.	A	T	14	14	28	0	3	31	0	0
25	19366741	.	A	C	18	13	31	0	0	31	0	0
25	19367304	.	T	A	10	9	19	0	0	19	0	0
25	19367531	.	A	G	7	6	13	0	0	13	0	0
25	19367753	.	A	T	9	16	25	0	1	27	1	0
25	19368016	.	A	T	11	8	19	0	0	19	0	0
25	19368105	.	A	G	11	8	19	0	1	20	0	0
25	19368429	.	G	A	13	6	19	0	1	20	0	0
25	19368548	.	G	T	10	6	16	0	1	17	0	0
25	19368620	.	T	A	9	9	18	0	0	19	1	0
25	19368803	.	T	C	6	9	15	0	0	15	0	0
25	19369400	.	A	C	5	6	11	0	1	12	0	0
25	19369420	.	C	T	6	5	11	0	0	11	0	0
25	19369448	.	G	T	7	7	14	0	0	14	0	0
25	19369701	.	T	A	4	4	8	0	0	8	0	0
25	19369822	.	C	T	2	4	6	0	0	6	0	0
25	19369911	.	G	A	2	8	10	0	0	10	0	0
25	19369913	.	A	T	2	7	9	0	1	10	0	0
25	19370082	.	G	A	3	7	10	0	1	11	0	0
25	19370308	.	G	C	8	4	12	0	0	12	0	0
25	19370464	.	T	C	8	6	14	0	1	15	0	0
25	19370507	.	T	C	8	5	13	0	1	14	0	0
25	19370623	.	A	C	4	0	4	0	4	8	0	0
25	19370670	.	A	T	6	4	10	0	1	11	0	0
25	19371087	.	G	A	6	3	9	0	1	10	0	0
25	19372297	.	A	G	8	8	16	0	0	16	0	0
25	19372490	.	A	T	1	3	4	0	2	6	0	0
25	19372491	.	T	G	2	4	6	0	0	6	0	0
25	19372943	.	T	G	6	7	13	0	0	13	0	0
25	19433024	.	A	G	4	3	7	0	0	7	0	0
25	19433039	.	T	A	3	2	5	0	0	5	0	0
25	19442049	.	T	C	1	4	5	0	0	5	0	0
25	19442955	.	G	A	1	4	5	0	0	5	0	0
25	19443192	.	T	C	8	4	12	0	1	13	0	0
25	19443356	.	C	T	30	27	57	0	2	59	0	0
25	19486356	.	A	C	11	0	11	0	6	17	0	0
25	19489593	.	C	T	2	2	4	0	0	4	0	0
25	19528542	.	A	G	0	1	1	0	0	1	0	0
25	19531894	.	T	A	2	3	5	0	0	5	0	0
25	19535304	.	A	G	3	0	3	0	2	5	0	0
25	19535338	.	C	T	5	3	8	0	1	9	0	0
25	19535374	.	G	A	4	5	9	0	0	9	0	0
25	19535727	.	G	T	2	3	5	0	0	5	0	0
25	19535746	.	C	T	4	4	8	0	0	8	0	0
25	19535883	.	C	T	0	3	3	0	0	3	0	0
25	19535953	.	G	A	0	2	2	0	0	2	0	0
25	19556410	.	G	T	0	3	3	0	1	4	0	0
25	19560468	.	A	G	4	2	6	0	0	6	0	0
25	19560479	.	A	G	3	3	6	0	0	6	0	0
25	19560556	.	T	C	1	3	4	0	0	4	0	0
25	19560744	.	C	T	6	4	10	0	0	10	0	0
25	19560890	.	T	C	5	2	7	0	1	8	0	0
25	19562558	.	G	A	3	4	7	0	4	11	0	0
25	19562756	.	C	T	6	2	8	0	0	8	0	0
25	19570612	.	T	C	1	0	1	0	1	2	0	0
25	19570631	.	G	T	2	0	2	0	0	2	0	0
25	19570873	.	A	G	7	3	10	0	0	10	0	0
25	19570995	.	T	G	0	2	2	0	0	2	0	0
25	19571018	.	A	G	0	1	1	0	0	1	0	0
25	19585916	.	C	A	5	7	12	0	0	12	0	0
25	19586712	.	G	A	0	1	1	0	0	1	0	0
25	19586743	.	A	G	0	1	1	0	0	1	0	0
25	19588294	.	A	G	1	1	2	0	0	2	0	0
25	19591844	.	T	C	2	4	6	0	0	6	0	0
25	19610376	.	C	T	2	3	5	0	0	5	0	0
25	19610459	.	A	C	3	0	3	0	2	5	0	0
25	19610708	.	G	T	2	2	4	0	0	4	0	0
25	19612818	.	G	T	0	1	1	0	0	1	0	0
25	19730570	.	T	C	1	3	4	0	1	5	0	0
25	19730643	.	G	T	2	5	7	0	1	8	0	0
25	19730645	.	G	T	2	5	7	0	1	8	0	0
25	19741229	.	A	G	1	2	3	0	0	3	0	0
25	19743556	.	A	T	1	1	2	0	0	2	0	0
25	19743751	.	A	G	0	3	3	0	0	3	0	0
25	19746661	.	A	G	2	0	2	0	4	6	0	0
25	19747150	.	T	C	11	13	24	0	1	25	0	0
25	19747668	.	A	T	0	2	2	0	0	2	0	0
25	19857979	.	G	A	1	0	1	0	0	1	0	0
25	19857993	.	G	A	0	0	0	0	2	2	0	0
25	19858043	.	G	A	0	2	2	0	1	3	0	0
25	19865897	.	T	G	5	0	5	0	1	6	0	0
25	19865904	.	G	T	5	2	7	0	1	8	0	0
25	19865986	.	G	C	3	2	5	0	0	5	0	0
25	19866120	.	G	A	2	3	5	0	0	5	0	0
25	19866290	.	G	T	3	2	5	0	0	5	0	0
25	19866660	.	A	G	2	0	2	0	7	9	0	0
25	19866713	.	C	T	2	2	4	0	0	4	0	0
25	19866902	.	T	C	2	3	5	0	0	5	0	0
25	19866950	.	G	C	1	2	3	0	0	3	0	0
25	19867045	.	G	C	1	4	5	0	0	5	0	0
25	19867046	.	C	T	1	4	5	0	0	5	0	0
25	19867103	.	C	T	4	7	11	0	0	11	0	0
25	19867143	.	A	G	7	0	7	0	7	14	0	0
25	19867180	.	C	T	6	5	11	0	0	11	0	0
25	19867208	.	T	C	4	3	7	0	0	7	0	0
25	19867327	.	G	A	0	4	4	0	6	10	0	0
25	19867331	.	C	T	6	5	11	0	0	11	0	0
25	19867383	.	T	C	4	5	9	0	0	9	0	0
25	19867436	.	A	T	3	2	5	0	0	5	0	0
25	19867442	.	G	A	0	1	1	0	3	4	0	0
25	19867752	.	G	T	8	3	11	0	0	11	0	0
25	19867948	.	C	T	1	2	3	0	0	3	0	0
25	19868056	.	C	T	3	2	5	0	0	5	0	0
25	19905241	.	A	G	1	2	3	0	0	3	0	0
25	19931796	.	A	G	0	0	0	0	4	4	0	0
25	19931803	.	C	T	1	5	6	0	0	6	0	0
25	19932096	.	C	T	7	4	11	0	0	11	0	0
25	19932352	.	T	C	1	3	4	0	0	4	0	0
25	19933622	.	G	T	1	1	2	0	2	4	0	0
25	19934006	.	A	G	4	2	6	0	0	6	0	0
25	19934008	.	T	A	4	1	5	0	1	6	0	0
25	19934181	.	A	G	4	3	7	0	0	7	0	0
25	19934231	.	A	T	4	4	8	0	0	8	0	0
25	19934455	.	G	A	2	7	9	0	1	10	0	0
25	19934482	.	G	C	2	6	8	0	0	8	0	0
25	19934727	.	T	G	2	0	2	0	3	5	0	0
25	19934763	.	A	C	1	2	3	0	0	3	0	0
25	19934831	.	C	T	2	3	5	0	0	5	0	0
25	19934942	.	A	G	3	0	3	0	10	13	0	0
25	19934966	.	A	G	1	0	1	0	7	8	0	0
25	19935059	.	C	G	7	4	11	0	0	11	0	0
25	19935213	.	A	C	9	11	20	0	1	21	0	0
25	19935222	.	T	A	9	13	22	0	0	22	0	0
25	19935269	.	C	T	9	10	19	0	0	19	0	0
25	19935313	.	G	A	0	10	10	0	6	16	0	0
25	19935330	.	G	A	2	10	12	0	1	13	0	0
25	19935402	.	A	T	9	4	13	0	1	14	0	0
25	19935437	.	G	A	0	8	8	0	16	24	0	0
25	19935446	.	C	G	3	0	3	0	23	26	0	0
25	19935538	.	T	C	7	6	13	0	1	14	0	0
25	19935556	.	G	A	5	5	10	1	1	12	0	0
25	19935700	.	A	G	7	8	15	0	1	16	0	0
25	19935791	.	A	G	7	0	7	0	6	13	0	0
25	19935951	.	G	A	12	6	18	0	0	18	0	0
25	19936101	.	G	A	7	5	12	0	0	12	0	0
25	19936123	.	A	G	9	5	14	0	0	14	0	0
25	19936304	.	A	T	12	10	22	0	0	22	0	0
25	19936445	.	T	G	3	0	3	0	7	10	0	0
25	19955458	.	A	G	2	8	10	0	0	10	0	0
25	19955855	.	T	C	4	4	8	0	1	9	0	0
25	19955984	.	G	A	5	6	11	0	0	11	0	0
25	19956833	.	T	C	5	9	14	0	1	15	0	0
25	19957759	.	A	C	10	5	15	0	0	15	0	0
25	20003413	.	G	C	0	7	7	0	25	32	0	0
25	20121387	.	T	C	15	12	27	0	1	28	0	0
25	20121447	.	A	G	14	0	14	0	13	27	0	0
25	20121462	.	G	A	17	13	30	0	0	30	0	0
25	20125725	.	A	T	8	8	16	0	0	16	0	0
25	20125731	.	G	T	9	9	18	0	0	18	0	0
25	20125827	.	C	T	20	20	40	0	2	42	0	0
25	20125879	.	T	A	19	6	25	0	0	25	0	0
25	20125897	.	T	C	19	6	25	0	0	25	0	0
25	20125934	.	G	T	14	8	22	0	2	24	0	0
25	20125949	.	C	T	16	9	25	0	0	25	0	0
25	20126004	.	T	A	13	10	23	0	1	24	0	0
25	20126152	.	T	C	3	6	9	0	0	9	0	0
25	20126157	.	T	A	4	5	9	0	1	10	0	0
25	20126204	.	G	T	8	5	13	0	0	13	0	0
25	20126261	.	A	G	8	10	18	0	0	18	0	0
25	20126273	.	A	G	7	10	17	0	0	17	0	0
25	20126305	.	T	A	8	6	14	0	0	14	0	0
25	20126433	.	G	A	1	3	4	0	7	11	0	0
25	20126661	.	G	T	8	3	11	0	0	11	0	0
25	20126688	.	A	T	8	3	11	0	0	11	0	0
25	20126702	.	A	G	7	2	9	0	3	12	0	0
25	20126750	.	T	A	10	8	18	0	0	18	0	0
25	20126870	.	T	G	7	12	19	0	1	20	0	0
25	20126915	.	A	G	9	4	13	0	1	14	0	0
25	20188877	.	C	T	1	3	4	0	0	4	0	0
25	20226431	.	A	C	1	3	4	0	0	4	0	0
25	20226432	.	T	G	1	0	1	0	3	4	0	0
25	20229802	.	C	T	1	21	22	0	21	43	0	0
25	20229843	.	T	C	20	2	22	0	16	38	0	0
25	20229887	.	C	A	7	8	15	0	0	15	0	0
25	20231657	.	G	A	19	12	31	0	0	31	0	0
25	20241699	.	T	A	5	5	10	0	1	11	0	0
25	20241705	.	T	G	8	5	13	0	0	13	0	0
25	20241759	.	A	G	6	1	7	0	0	7	0	0
25	20241884	.	C	T	0	0	0	0	1	1	0	0
25	20244861	.	T	C	3	0	3	0	1	4	0	0
25	20245022	.	C	T	0	1	1	0	1	2	0	0
25	20245332	.	C	T	1	2	3	0	0	3	0	0
25	20247968	.	T	C	1	0	1	0	0	1	0	0
25	20252987	.	T	C	2	1	3	0	2	5	0	0
25	20253053	.	C	T	0	3	3	0	11	14	0	0
25	20253092	.	C	T	1	2	3	0	2	5	0	0
25	20279817	.	C	T	1	1	2	0	0	2	0	0
25	20286325	.	A	C	1	0	1	0	0	1	0	0
25	20290315	.	G	A	4	2	6	0	0	6	0	0
25	20297601	.	C	T	1	2	3	0	0	3	0	0
25	20355326	.	G	C	1	1	2	0	0	2	0	0
25	20355432	.	C	T	4	3	7	0	0	7	0	0
25	20358708	.	A	T	12	17	29	0	1	30	0	0
25	20358999	.	G	A	12	17	29	0	0	29	0	0
25	20359005	.	C	A	0	15	15	0	15	31	1	0
25	20359639	.	G	A	5	9	14	0	0	14	0	0
25	20366747	.	C	T	0	0	0	0	1	1	0	0
25	20378086	.	G	A	6	3	9	0	1	10	0	0
25	20378095	.	T	C	7	4	11	0	0	11	0	0
25	20378282	.	C	T	0	2	2	0	1	3	0	0
25	20381198	.	C	T	4	2	6	0	0	6	0	0
25	20388721	.	C	T	2	4	6	0	0	6	0	0
25	20388899	.	G	A	4	5	9	0	0	9	0	0
25	20389277	.	G	A	5	6	11	0	0	11	0	0
25	20389337	.	G	A	1	2	3	0	0	3	0	0
25	20389844	.	G	A	1	2	3	0	0	3	0	0
25	20390144	.	G	C	6	6	12	0	0	12	0	0
25	20568273	.	C	A	2	2	4	0	0	4	0	0
25	20578628	.	G	A	2	2	4	0	1	5	0	0
25	20601690	.	A	T	5	2	7	0	0	7	0	0
25	20601819	.	T	A	5	4	9	0	3	12	0	0
25	20602316	.	T	A	15	15	30	0	7	37	0	0
25	20602347	.	C	T	18	11	29	0	1	30	0	0
25	20602373	.	C	T	18	10	28	0	1	29	0	0
25	20602716	.	A	G	15	18	33	0	0	33	0	0
25	20631440	.	C	T	0	2	2	0	3	5	0	0
25	20666018	.	T	C	3	5	8	0	0	8	0	0
25	20666024	.	T	C	3	4	7	0	0	7	0	0
25	20669130	.	G	T	7	8	15	0	0	15	0	0
25	20669332	.	G	A	1	6	7	0	0	7	0	0
25	20669411	.	G	T	4	2	6	0	0	6	0	0
25	20669565	.	T	C	1	4	5	0	0	5	0	0
25	20669585	.	A	C	2	6	8	0	0	8	0	0
25	20669657	.	A	G	3	13	16	0	0	16	0	0
25	20669777	.	G	T	3	4	7	0	0	7	0	0
25	20670029	.	A	G	3	9	12	0	0	12	0	0
25	20670036	.	T	C	8	3	11	0	1	12	0	0
25	20670127	.	G	A	6	4	10	0	1	11	0	0
25	20670203	.	G	C	8	4	12	0	0	12	0	0
25	20670288	.	A	G	5	4	9	0	0	9	0	0
25	20670632	.	A	T	2	4	6	0	0	6	0	0
25	20670669	.	G	A	5	2	7	0	0	7	0	0
25	20670673	.	T	A	5	2	7	0	0	7	0	0
25	20670840	.	A	G	2	4	6	0	0	6	0	0
25	20678773	.	G	T	1	2	3	0	0	3	0	0
25	20701369	.	G	A	3	5	8	0	2	10	0	0
25	20701408	.	T	C	7	10	17	0	1	18	0	0
25	20701409	.	G	A	7	10	17	0	1	18	0	0
25	20701516	.	A	G	3	1	4	0	8	12	0	0
25	20701594	.	C	A	7	7	14	0	0	14	0	0
25	20721482	.	A	C	2	8	10	0	0	10	0	0
25	20721502	.	C	T	2	7	9	0	1	10	0	0
25	20723017	.	A	C	4	5	9	0	1	10	0	0
25	20724822	.	G	A	0	2	2	0	4	6	0	0
25	20724879	.	G	A	11	10	21	0	1	22	0	0
25	20726626	.	G	A	0	0	0	0	2	2	0	0
25	20726884	.	G	T	4	7	11	0	1	12	0	0
25	20730707	.	T	A	11	4	15	0	0	15	0	0
25	20998004	.	G	A	5	4	9	0	0	9	0	0
25	20999104	.	G	A	3	3	6	0	0	6	0	0
25	20999140	.	T	A	3	3	6	0	1	7	0	0
25	21064337	.	A	T	3	4	7	0	1	8	0	0
25	21064361	.	C	G	4	4	8	0	0	8	0	0
25	21065024	.	T	C	7	8	15	0	0	15	0	0
25	21066091	.	T	C	2	0	2	0	3	5	0	0
25	21066092	.	G	A	3	2	5	0	0	5	0	0
25	21075410	.	G	T	4	2	6	0	2	8	0	0
25	21077571	.	A	C	0	0	0	0	1	2	1	0
25	21085659	.	C	T	1	0	1	0	0	1	0	0
25	21091634	.	C	A	0	6	6	0	2	8	0	0
25	21115784	.	C	A	12	21	33	0	1	34	0	0
25	21119687	.	G	A	14	11	25	0	0	25	0	0
25	21119697	.	T	C	10	0	10	0	12	22	0	0
25	21121964	.	C	T	3	4	7	0	0	7	0	0
25	21125075	.	G	A	11	10	21	0	0	21	0	0
25	21125108	.	A	G	13	10	23	0	0	23	0	0
25	21126004	.	C	T	4	4	8	0	1	9	0	0
25	21129695	.	A	G	2	2	4	0	0	4	0	0
25	21132534	.	C	A	1	0	1	0	0	1	0	0
25	21133118	.	T	C	4	0	4	0	9	13	0	0
25	21134472	.	C	T	3	3	6	0	1	7	0	0
25	21153474	.	C	T	0	3	3	0	3	6	0	0
25	21154418	.	G	T	2	3	5	0	0	5	0	0
25	21177396	.	A	G	6	0	6	0	7	13	0	0
25	21180649	.	G	T	1	0	1	0	0	1	0	0
25	21180658	.	C	T	1	1	2	0	0	2	0	0
25	21194552	.	C	T	10	7	17	0	3	20	0	0
25	21202349	.	C	T	2	2	4	0	0	4	0	0
25	21206481	.	G	A	15	8	23	0	1	24	0	0
25	21213122	.	G	T	5	15	20	0	0	20	0	0
25	21253053	.	T	C	23	19	42	0	0	42	0	0
25	21276550	.	A	G	2	3	5	0	0	5	0	0
25	21277721	.	A	G	1	4	5	0	0	5	0	0
25	21277739	.	C	T	0	5	5	0	2	7	0	0
25	21277765	.	T	C	8	3	11	0	0	11	0	0
25	21277786	.	C	T	0	5	5	0	6	11	0	0
25	21277811	.	C	T	3	7	10	0	0	10	0	0
25	21277927	.	G	T	14	4	18	0	0	18	0	0
25	21278053	.	T	A	12	6	18	0	1	20	1	0
25	21278055	.	A	G	13	7	20	0	0	20	0	0
25	21278193	.	G	A	3	15	18	0	0	18	0	0
25	21278235	.	G	A	4	7	11	0	0	11	0	0
25	21278244	.	A	G	3	5	8	0	0	8	0	0
25	21280506	.	T	G	3	4	7	0	0	7	0	0
25	21298370	.	A	C	3	0	3	0	2	5	0	0
25	21324726	.	C	A	5	2	7	0	0	7	0	0
25	21341712	.	T	A	5	3	8	0	1	9	0	0
25	21342512	.	C	T	4	8	12	0	1	13	0	0
25	21343250	.	A	C	5	3	8	0	1	9	0	0
25	21343301	.	C	T	10	15	25	0	1	26	0	0
25	21343340	.	G	C	11	18	29	0	0	29	0	0
25	21343358	.	C	T	15	9	24	0	2	26	0	0
25	21343408	.	T	C	12	8	20	0	0	20	0	0
25	21343420	.	A	T	11	8	19	0	1	20	0	0
25	21343476	.	G	A	3	8	11	0	1	12	0	0
25	21343487	.	C	T	4	9	13	0	0	13	0	0
25	21343631	.	T	A	12	15	27	0	1	28	0	0
25	21343643	.	A	G	13	0	13	0	15	28	0	0
25	21343901	.	T	C	13	20	33	0	0	33	0	0
25	21344290	.	G	T	11	15	26	0	0	26	0	0
25	21518679	.	T	A	2	6	8	0	0	8	0	0
25	21535738	.	G	A	1	0	1	0	0	1	0	0
25	21724668	.	T	C	1	0	1	0	0	1	0	0
25	21726776	.	C	T	1	0	1	0	0	1	0	0
25	21737010	.	T	C	1	4	5	0	0	5	0	0
25	21741444	.	A	G	3	3	6	0	0	6	0	0
25	21743630	.	G	A	3	7	10	0	0	10	0	0
25	21743694	.	A	G	1	0	1	0	3	4	0	0
25	21771898	.	T	G	1	0	1	0	0	1	0	0
25	21833163	.	A	G	16	12	28	0	1	29	0	0
25	21833307	.	C	T	26	17	43	0	1	44	0	0
25	21833308	.	G	T	2	15	17	0	28	45	0	0
25	21834976	.	G	A	0	2	2	0	3	5	0	0
25	21835081	.	T	C	24	24	48	0	1	49	0	0
25	21835093	.	T	C	27	24	51	0	2	53	0	0
25	21835126	.	A	T	15	13	28	0	1	29	0	0
25	21835268	.	T	C	11	4	15	0	0	15	0	0
25	21841487	.	G	A	3	4	7	0	1	8	0	0
25	21843369	.	G	T	27	17	44	0	3	47	0	0
25	21847233	.	C	T	41	37	78	0	2	80	0	0
25	21860841	.	T	A	6	2	8	0	0	8	0	0
25	21860842	.	A	T	6	2	8	0	0	8	0	0
25	21860969	.	G	T	8	5	13	0	0	13	0	0
25	21861070	.	C	T	0	8	8	0	5	13	0	0
25	21863452	.	C	T	3	2	5	0	1	6	0	0
25	21863525	.	T	G	1	2	3	0	0	3	0	0
25	21865988	.	C	T	0	2	2	0	7	9	0	0
25	21866386	.	G	A	4	4	8	0	0	8	0	0
25	21866404	.	C	T	0	4	4	0	4	8	0	0
25	21893988	.	G	C	3	4	7	0	0	7	0	0
25	21894072	.	A	G	2	5	7	0	0	7	0	0
25	22079673	.	C	T	2	3	5	0	0	5	0	0
25	22079682	.	T	C	2	4	6	0	0	6	0	0
25	22086896	.	T	C	0	1	1	0	0	1	0	0
25	22228713	.	G	T	0	1	1	0	2	3	0	0
25	22232870	.	C	T	3	2	5	0	0	5	0	0
25	22232873	.	C	A	3	2	5	0	0	5	0	0
25	22288473	.	G	C	3	5	8	0	0	8	0	0
25	22291766	.	T	C	4	4	8	0	0	8	0	0
25	22633831	.	T	C	2	1	3	0	0	3	0	0
25	22633999	.	T	G	5	4	9	0	0	9	0	0
25	22634029	.	C	T	4	3	7	0	1	8	0	0
25	22635759	.	A	G	29	29	58	0	5	63	0	0
25	22635812	.	T	G	29	26	55	0	0	55	0	0
25	22635999	.	C	A	27	17	44	0	0	44	0	0
25	22636020	.	T	A	25	14	39	0	1	40	0	0
25	22636565	.	A	T	26	24	50	0	5	55	0	0
25	22636574	.	G	A	23	24	47	0	3	50	0	0
25	22636967	.	C	T	15	20	35	0	1	36	0	0
25	22637039	.	A	G	20	20	40	0	0	40	0	0
25	22637273	.	A	G	21	17	38	0	1	39	0	0
25	22637290	.	C	A	1	21	22	0	20	42	0	0
25	22637384	.	G	A	11	19	30	0	3	33	0	0
25	22637444	.	A	T	11	14	25	0	0	25	0	0
25	22637501	.	A	G	16	16	32	0	1	33	0	0
25	22637584	.	A	T	12	22	34	0	1	35	0	0
25	22637667	.	T	C	16	16	32	0	0	32	0	0
25	22637729	.	G	T	13	25	38	0	2	40	0	0
25	22637732	.	G	A	12	26	38	0	1	39	0	0
25	22638037	.	A	G	9	7	16	0	0	16	0	0
25	22638047	.	C	T	7	7	14	0	0	14	0	0
25	22638101	.	G	A	6	4	10	0	0	10	0	0
25	22638170	.	C	G	0	5	5	0	6	11	0	0
25	22639039	.	G	A	9	11	20	0	0	20	0	0
25	22730594	.	G	A	0	1	1	0	2	3	0	0
25	22737094	.	G	A	0	4	4	0	3	7	0	0
25	22737119	.	C	T	3	6	9	0	0	9	0	0
25	22739486	.	G	T	0	2	2	0	1	3	0	0
25	22748533	.	G	T	0	3	3	0	0	3	0	0
25	22748535	.	A	C	0	2	2	0	1	3	0	0
25	22748589	.	T	C	5	5	10	0	1	11	0	0
25	22748739	.	T	C	2	0	2	0	0	2	0	0
25	22762088	.	G	A	0	2	2	0	3	5	0	0
25	22763599	.	G	A	2	2	4	0	0	4	0	0
25	22779492	.	G	A	1	0	1	0	0	1	0	0
25	22784956	.	G	A	0	1	1	0	0	1	0	0
25	22807977	.	T	C	3	3	6	0	0	6	0	0
25	22808076	.	A	G	4	3	7	0	1	8	0	0
25	22821577	.	A	G	3	0	3	0	5	8	0	0
25	22829714	.	T	C	4	10	14	0	2	16	0	0
25	22829738	.	C	T	2	7	9	0	0	9	0	0
25	22834487	.	G	A	2	4	6	0	0	6	0	0
25	22853789	.	A	T	1	4	5	0	0	5	0	0
25	22853810	.	G	A	2	4	6	0	0	6	0	0
25	22854008	.	C	T	1	7	8	0	4	12	0	0
25	22854194	.	A	T	1	5	6	0	0	6	0	0
25	22854378	.	A	C	2	1	3	0	3	6	0	0
25	22854452	.	A	C	1	4	5	0	0	5	0	0
25	22854563	.	G	A	4	3	7	0	1	8	0	0
25	22854653	.	T	C	3	8	11	0	0	11	0	0
25	22979939	.	A	G	7	5	12	0	0	12	0	0
25	22979996	.	C	G	1	5	6	0	0	6	0	0
25	22980436	.	G	T	2	11	13	0	0	13	0	0
25	22981075	.	A	C	11	5	16	0	0	16	0	0
25	22981268	.	A	G	4	16	20	0	1	21	0	0
25	22981493	.	A	G	8	8	16	0	0	16	0	0
25	22981550	.	G	A	9	5	14	0	0	14	0	0
25	22981774	.	T	C	11	7	18	0	0	18	0	0
25	22982469	.	A	G	1	0	1	0	0	1	0	0
25	22982478	.	G	T	1	0	1	0	0	1	0	0
25	22982752	.	A	G	5	3	8	0	1	9	0	0
25	23015692	.	T	C	2	0	2	0	4	6	0	0
25	23359332	.	T	G	1	2	3	0	0	3	0	0
25	23403835	.	G	C	0	3	3	0	1	4	0	0
25	23419896	.	G	A	1	2	3	0	0	3	0	0
25	23448513	.	T	C	11	9	20	0	0	20	0	0
25	23448584	.	A	G	12	0	12	0	11	23	0	0
25	23449814	.	A	G	7	0	7	0	4	11	0	0
25	23450319	.	T	A	9	8	17	0	2	19	0	0
25	23450388	.	A	G	9	8	17	0	1	18	0	0
25	23450390	.	C	A	10	7	17	0	1	18	0	0
25	23450424	.	A	G	8	8	16	0	0	16	0	0
25	23524975	.	T	G	3	4	7	0	1	8	0	0
25	23525518	.	G	T	1	1	2	0	0	2	0	0
25	23525524	.	A	T	1	1	2	0	0	2	0	0
25	23525983	.	A	C	2	0	2	0	4	6	0	0
25	23555815	.	C	T	0	6	6	0	10	16	0	0
25	23555852	.	T	C	4	0	4	0	11	15	0	0
25	23555998	.	A	T	4	6	10	0	1	11	0	0
25	23556047	.	G	A	3	5	8	0	0	8	0	0
25	23556240	.	A	T	4	7	11	0	0	11	0	0
25	23556254	.	C	T	5	7	12	0	1	13	0	0
25	23556378	.	C	G	12	9	21	0	1	22	0	0
25	23560111	.	A	T	0	1	1	0	0	1	0	0
25	23562487	.	C	T	1	5	6	0	2	8	0	0
25	23570933	.	G	A	1	3	4	0	0	4	0	0
25	23571614	.	A	G	8	3	11	0	0	11	0	0
25	24583223	.	C	T	1	0	1	0	0	1	0	0
25	24593493	.	G	A	0	0	0	0	1	1	0	0
25	24594153	.	T	C	2	3	5	0	1	6	0	0
25	24594163	.	C	T	2	3	5	0	1	6	0	0
25	24594339	.	C	T	2	4	6	0	0	6	0	0
25	24594633	.	A	G	3	0	3	0	2	5	0	0
25	24598826	.	C	A	4	2	6	0	1	7	0	0
25	24607933	.	A	G	2	0	2	0	1	3	0	0
25	24609463	.	T	A	5	2	7	0	0	7	0	0
25	24610543	.	A	T	6	3	9	0	0	9	0	0
25	24610544	.	A	G	5	3	8	0	1	9	0	0
25	24723129	.	G	A	2	4	6	0	1	7	0	0
25	24736314	.	T	G	1	3	4	0	2	6	0	0
25	24736579	.	A	T	7	11	18	0	0	18	0	0
25	24736669	.	A	C	6	8	14	0	0	14	0	0
25	24736828	.	A	T	7	6	13	0	0	13	0	0
25	24736921	.	G	A	8	3	11	0	0	11	0	0
25	24737080	.	G	A	4	3	7	0	0	7	0	0
25	24737081	.	A	G	4	3	7	0	0	7	0	0
25	24737154	.	C	T	0	4	4	0	4	8	0	0
25	24737335	.	C	A	0	3	3	0	1	4	0	0
25	24737940	.	A	C	1	4	5	0	0	5	0	0
25	24737961	.	C	T	1	7	8	0	0	8	0	0
25	24738084	.	T	C	13	3	16	0	9	25	0	0
25	24738155	.	T	A	3	9	12	0	1	13	0	0
25	24738810	.	C	A	6	4	10	0	0	10	0	0
25	24738826	.	G	A	6	5	11	0	0	11	0	0
25	24738892	.	G	A	7	9	16	0	0	16	0	0
25	24739029	.	A	G	5	6	11	0	2	13	0	0
25	24752103	.	T	C	2	3	5	0	0	5	0	0
25	24752175	.	G	A	10	10	20	0	1	21	0	0
25	24752181	.	A	G	9	11	20	0	1	21	0	0
25	24752211	.	C	T	0	6	6	0	4	10	0	0
25	24763746	.	A	G	1	3	4	0	0	4	0	0
25	24763755	.	G	T	2	2	4	0	1	5	0	0
25	24763914	.	C	T	1	2	3	0	0	3	0	0
25	24792647	.	C	A	4	2	6	0	0	6	0	0
25	24826237	.	G	T	2	4	6	0	1	7	0	0
25	24826240	.	T	C	2	0	2	0	5	7	0	0
25	24847561	.	A	T	1	2	3	0	0	3	0	0
25	25058180	.	C	T	2	3	5	0	0	5	0	0
25	25058334	.	A	C	1	0	1	0	5	6	0	0
25	25123444	.	G	T	5	3	8	0	0	8	0	0
25	25123445	.	T	C	4	3	7	0	1	8	0	0
25	25124779	.	A	T	8	9	17	0	2	19	0	0
25	25127673	.	G	A	0	7	7	0	7	14	0	0
25	25130749	.	G	C	18	10	28	0	1	29	0	0
25	25130782	.	G	A	22	14	36	0	1	37	0	0
25	25130908	.	C	T	23	30	53	0	1	54	0	0
25	25130968	.	C	T	26	23	49	0	4	53	0	0
25	25131165	.	G	A	3	8	11	0	1	12	0	0
25	25131298	.	A	T	13	31	44	0	2	46	0	0
25	25131427	.	G	A	14	22	36	0	2	38	0	0
25	25132985	.	C	T	9	8	17	0	0	17	0	0
25	25133030	.	G	A	11	13	24	0	1	25	0	0
25	25133104	.	G	A	15	15	30	0	2	32	0	0
25	25133123	.	T	G	18	20	38	0	0	38	0	0
25	25133171	.	A	G	13	17	30	0	0	30	0	0
25	25133353	.	G	A	18	9	27	0	0	27	0	0
25	25133365	.	T	A	22	10	32	0	1	33	0	0
25	25133509	.	A	G	5	4	9	0	0	9	0	0
25	25133721	.	G	A	16	17	33	0	1	34	0	0
25	25142171	.	T	C	1	9	10	0	2	12	0	0
25	25142202	.	T	A	3	8	11	0	0	11	0	0
25	25396237	.	T	C	13	13	26	0	1	27	0	0
25	25396295	.	T	C	3	2	5	0	0	5	0	0
25	25538786	.	T	G	2	0	2	0	5	7	0	0
25	25539270	.	C	A	1	5	6	0	0	6	0	0
25	25539539	.	C	A	4	4	8	0	0	8	0	0
25	25539723	.	C	A	6	9	15	0	1	16	0	0
25	25540058	.	T	A	6	2	8	0	0	8	0	0
25	25540060	.	G	A	6	2	8	0	0	8	0	0
25	25540181	.	A	T	6	4	10	0	1	11	0	0
25	25540245	.	A	G	3	4	7	0	1	8	0	0
25	25540312	.	C	A	6	5	11	0	0	11	0	0
25	25540935	.	A	G	8	0	8	0	11	19	0	0
25	25540954	.	G	A	13	10	23	0	0	23	0	0
25	25542708	.	C	T	0	2	2	0	0	2	0	0
25	25544468	.	C	T	12	9	21	0	1	22	0	0
25	25545007	.	G	A	4	5	9	0	0	9	0	0
25	25545502	.	T	C	4	1	5	0	2	7	0	0
25	25545654	.	T	C	1	3	4	0	0	4	0	0
25	25546053	.	G	A	2	3	5	0	0	5	0	0
25	25547043	.	C	A	3	2	5	0	0	5	0	0
25	25547228	.	G	A	3	3	6	0	0	6	0	0
25	25548032	.	G	T	3	3	6	0	0	6	0	0
25	25548220	.	G	C	1	3	4	0	0	4	0	0
25	25565303	.	T	C	1	2	3	0	0	3	0	0
25	25565819	.	A	G	5	2	7	0	0	7	0	0
25	25565837	.	A	C	2	5	7	0	0	7	0	0
25	25566006	.	A	G	1	2	3	0	0	3	0	0
25	25594104	.	A	G	5	4	9	0	0	9	0	0
25	25594291	.	T	A	1	3	4	0	0	4	0	0
25	25594348	.	C	T	0	4	4	0	5	9	0	0
25	25736923	.	C	G	15	10	25	0	0	25	0	0
25	25736949	.	C	T	12	9	21	0	0	21	0	0
25	25737674	.	C	A	1	2	3	0	0	3	0	0
25	25737676	.	G	A	1	2	3	0	0	3	0	0
25	25740451	.	G	A	0	1	1	0	0	1	0	0
25	25740469	.	G	A	0	1	1	0	0	1	0	0
25	25829020	.	T	C	8	5	13	0	1	14	0	0
25	26673233	.	A	G	2	5	7	0	0	7	0	0
25	26738746	.	T	C	4	4	8	0	0	8	0	0
25	26823007	.	T	C	1	1	2	0	0	2	0	0
25	26823927	.	T	C	2	2	4	0	0	4	0	0
25	26824236	.	T	C	1	1	2	0	0	2	0	0
25	26824254	.	A	G	1	3	4	0	0	4	0	0
25	26829918	.	A	G	1	2	3	0	0	3	0	0
25	26830142	.	C	T	2	2	4	0	0	4	0	0
25	26830555	.	G	A	5	1	6	0	0	6	0	0
25	26832023	.	A	G	3	3	6	0	0	6	0	0
25	26832141	.	A	G	2	1	3	0	0	3	0	0
25	26834061	.	A	T	4	1	5	0	0	5	0	0
25	26840480	.	T	G	12	8	20	0	2	22	0	0
25	26840678	.	A	T	1	1	2	0	0	2	0	0
25	26840919	.	G	A	1	1	2	0	0	2	0	0
25	26867237	.	C	A	1	2	3	0	0	3	0	0
25	26867671	.	A	T	3	2	5	0	1	6	0	0
25	26867765	.	C	A	0	1	1	0	0	1	0	0
25	26867787	.	C	T	0	1	1	0	0	1	0	0
25	26879592	.	T	C	7	8	15	0	1	16	0	0
25	26884407	.	C	T	2	3	5	0	1	6	0	0
25	26888024	.	A	G	3	1	4	0	0	4	0	0
25	26888170	.	A	G	3	1	4	0	0	4	0	0
25	26906224	.	A	G	0	0	0	0	1	1	0	0
25	26909013	.	C	T	5	3	8	0	0	8	0	0
25	26909041	.	A	C	3	4	7	0	0	7	0	0
25	26909197	.	G	A	2	5	7	0	0	7	0	0
25	26909269	.	A	G	6	6	12	0	0	12	0	0
25	26909392	.	A	T	8	9	17	0	0	17	0	0
25	26909560	.	T	C	3	9	12	0	2	14	0	0
25	26909572	.	A	G	3	1	4	0	9	13	0	0
25	26911236	.	A	C	6	4	10	0	1	11	0	0
25	26911350	.	T	A	2	6	8	0	0	8	0	0
25	26911428	.	A	C	4	2	6	0	0	6	0	0
25	26911554	.	T	A	10	8	18	0	0	18	0	0
25	26911605	.	C	A	7	9	16	0	0	16	0	0
25	26911768	.	A	G	4	5	9	0	2	11	0	0
25	26911883	.	A	G	6	11	17	0	0	17	0	0
25	26912037	.	C	T	4	10	14	0	0	14	0	0
25	26922991	.	A	G	1	3	4	0	0	4	0	0
25	26923004	.	A	G	1	0	1	0	4	5	0	0
25	26923055	.	C	T	3	3	6	0	0	6	0	0
25	26923108	.	A	G	1	0	1	0	4	5	0	0
25	26923177	.	G	A	2	2	4	0	0	4	0	0
25	26923180	.	T	A	2	2	4	0	0	4	0	0
25	26923579	.	T	C	2	2	4	0	0	4	0	0
25	27089335	.	G	A	0	3	3	0	0	3	0	0
25	27089349	.	G	A	0	3	3	0	0	3	0	0
25	27092669	.	C	G	2	5	7	0	0	7	0	0
25	27166182	.	A	G	5	0	5	0	5	10	0	0
25	27173849	.	G	A	3	5	8	0	0	8	0	0
25	27173979	.	G	A	2	6	8	0	1	9	0	0
25	27174323	.	C	T	6	5	11	0	0	11	0	0
25	27174512	.	A	G	13	0	13	0	10	23	0	0
25	27210906	.	T	C	5	17	22	0	0	22	0	0
25	27443692	.	G	A	0	1	1	0	0	1	0	0
25	27499322	.	T	C	1	2	3	0	0	3	0	0
25	27715164	.	T	G	7	12	19	0	0	19	0	0
25	27715234	.	A	G	8	13	21	0	2	23	0	0
25	27715335	.	T	A	3	6	9	0	0	9	0	0
25	27715429	.	A	G	6	2	8	0	1	9	0	0
25	27715468	.	G	A	5	4	9	0	0	9	0	0
25	27718173	.	A	T	2	3	5	0	0	5	0	0
25	27718481	.	C	T	0	4	4	0	0	4	0	0
25	27718493	.	G	A	0	1	1	0	0	1	0	0
25	27718641	.	A	T	2	0	2	0	0	2	0	0
25	27718698	.	A	G	7	6	13	0	0	13	0	0
25	27718709	.	T	C	3	6	9	0	5	14	0	0
25	27718739	.	G	A	3	2	5	0	2	7	0	0
25	27744408	.	C	A	1	6	7	0	0	7	0	0
25	27759983	.	A	G	5	4	9	0	1	10	0	0
25	27763514	.	A	T	0	3	3	0	0	3	0	0
25	27788094	.	T	C	6	8	14	0	2	16	0	0
25	27788109	.	C	T	6	16	22	0	1	23	0	0
25	27795017	.	A	G	17	9	26	0	2	28	0	0
25	27795083	.	C	T	7	5	12	0	1	13	0	0
25	27795086	.	G	A	7	5	12	0	1	13	0	0
25	27801759	.	T	G	12	2	14	0	19	33	0	0
25	27801783	.	A	T	14	10	24	0	10	34	0	0
25	27802005	.	C	T	9	8	17	0	1	18	0	0
25	27806800	.	C	T	8	5	13	0	0	13	0	0
25	27932249	.	C	A	1	2	3	0	0	3	0	0
25	28222152	.	T	C	1	1	2	0	1	3	0	0
25	28229540	.	C	T	0	1	1	0	0	1	0	0
25	28240151	.	T	C	5	5	10	0	0	10	0	0
25	28244215	.	A	G	2	0	2	0	0	2	0	0
25	28244242	.	A	T	4	2	6	0	0	6	0	0
25	28269652	.	T	C	6	4	10	0	2	12	0	0
25	28269735	.	T	C	6	6	12	0	1	13	0	0
25	28273732	.	C	T	2	3	5	0	0	5	0	0
25	28273779	.	C	G	1	2	3	0	0	3	0	0
25	28317697	.	C	T	1	3	4	0	0	4	0	0
25	28323048	.	C	T	3	6	9	0	0	9	0	0
25	28323054	.	A	C	3	6	9	0	0	9	0	0
25	28332985	.	C	A	1	1	2	0	1	3	0	0
25	28334245	.	A	G	5	2	7	0	0	7	0	0
25	28334272	.	C	T	3	5	8	0	1	9	0	0
25	28335632	.	C	A	2	2	4	0	0	4	0	0
25	28335744	.	G	A	0	5	5	0	4	9	0	0
25	28357358	.	G	C	1	0	1	0	0	1	0	0
25	28376926	.	A	G	2	0	2	0	0	2	0	0
25	28597194	.	A	G	1	1	2	0	0	2	0	0
25	28597198	.	G	C	0	0	0	0	2	2	0	0
25	28640526	.	G	A	7	8	15	0	1	16	0	0
25	28640599	.	G	A	9	17	26	0	1	27	0	0
25	28640662	.	G	A	13	20	33	0	0	33	0	0
25	28641005	.	A	C	6	13	19	0	0	19	0	0
25	28648166	.	G	A	20	18	38	0	3	41	0	0
25	28650764	.	T	A	3	4	7	0	1	8	0	0
25	28650812	.	G	A	9	9	18	0	1	19	0	0
25	28652511	.	G	A	12	17	29	0	0	29	0	0
25	28656024	.	G	C	0	4	4	0	0	4	0	0
25	28656078	.	G	T	0	1	1	0	1	2	0	0
25	28661279	.	T	C	7	8	15	0	2	17	0	0
25	28661351	.	G	A	6	9	15	0	1	16	0	0
25	28665386	.	T	A	4	5	9	0	0	9	0	0
25	28668001	.	G	A	0	1	1	0	0	1	0	0
25	28668046	.	G	T	1	0	1	0	0	1	0	0
25	28668614	.	T	C	3	5	8	0	1	9	0	0
25	28668627	.	G	A	5	5	10	0	1	11	0	0
25	28668723	.	C	A	6	13	19	0	1	20	0	0
25	28668746	.	G	T	9	4	13	0	0	13	0	0
25	28715414	.	T	C	2	4	6	0	0	6	0	0
25	29427951	.	A	C	15	5	20	0	5	25	0	0
25	29427955	.	A	C	14	5	19	0	5	24	0	0
25	29429187	.	A	G	3	20	23	0	3	26	0	0
25	29666468	.	A	T	4	3	7	0	2	9	0	0
25	30549871	.	T	G	0	4	4	0	0	4	0	0
25	32216389	.	A	G	3	0	3	0	5	8	0	0
25	32886762	.	A	G	3	2	5	0	0	5	0	0
25	32886771	.	C	T	0	1	1	0	4	5	0	0
25	33091554	.	A	G	0	0	0	0	1	1	0	0
25	33093485	.	T	C	1	0	1	0	0	1	0	0
25	33104491	.	T	C	1	1	2	0	0	2	0	0
25	33104494	.	T	C	1	1	2	0	0	2	0	0
25	33121740	.	C	T	1	2	3	0	0	3	0	0
25	33121782	.	A	G	2	0	2	0	1	3	0	0
25	33125185	.	C	T	4	0	4	0	0	4	0	0
25	33125194	.	A	C	3	1	4	0	0	4	0	0
25	33145031	.	C	T	1	1	2	0	0	2	0	0
25	33151573	.	C	G	1	0	1	0	1	2	0	0
25	33225248	.	A	G	7	8	15	0	0	15	0	0
25	33225287	.	G	A	9	10	19	0	0	19	0	0
25	33238303	.	G	A	2	2	4	0	0	4	0	0
25	33242605	.	A	T	6	5	11	0	0	11	0	0
25	33242606	.	T	G	5	3	8	0	3	11	0	0
25	33249905	.	T	G	14	18	32	0	1	33	0	0
25	33250017	.	C	A	11	9	20	0	3	23	0	0
25	33250053	.	A	G	11	13	24	0	0	24	0	0
25	33258739	.	G	A	0	3	3	0	0	3	0	0
25	33258811	.	A	G	1	0	1	0	2	3	0	0
25	33258817	.	C	T	1	1	2	0	0	2	0	0
25	33262180	.	A	G	6	7	13	0	2	15	0	0
25	33265759	.	A	G	0	3	3	0	0	3	0	0
25	33265814	.	C	T	4	9	13	0	0	13	0	0
25	33265898	.	C	T	8	3	11	0	0	11	0	0
25	33266029	.	G	A	4	5	9	0	0	10	1	0
25	33266128	.	A	G	3	0	3	0	4	7	0	0
25	33266157	.	A	C	3	6	9	0	0	9	0	0
25	33962809	.	G	A	0	8	8	0	11	19	0	0
25	33963168	.	C	A	8	8	16	0	1	17	0	0
25	33963427	.	A	T	9	9	18	0	0	18	0	0
25	33964506	.	A	C	3	4	7	0	0	7	0	0
25	33964791	.	A	G	5	6	11	0	1	12	0	0
25	33964962	.	A	G	5	7	12	0	3	15	0	0
25	33964968	.	A	G	6	8	14	0	2	16	0	0
25	33965016	.	C	A	4	6	10	0	1	11	0	0
25	33965238	.	A	G	7	3	10	0	0	10	0	0
25	33965251	.	G	A	1	3	4	0	5	9	0	0
25	33965518	.	G	T	8	3	11	0	0	11	0	0
25	33965541	.	C	T	10	4	14	0	0	14	0	0
25	33965786	.	T	C	6	6	12	0	0	12	0	0
25	33965831	.	G	A	0	4	4	0	3	7	0	0
25	33965893	.	C	T	4	4	8	0	0	8	0	0
25	33965974	.	A	C	13	9	22	0	1	23	0	0
25	33966100	.	G	A	4	7	11	0	0	11	0	0
25	33966251	.	T	G	12	17	29	0	1	30	0	0
25	33966585	.	C	G	14	2	16	0	12	28	0	0
25	33966731	.	T	C	8	11	19	0	1	20	0	0
25	33966854	.	C	T	12	13	25	0	0	25	0	0
25	33966969	.	T	A	11	9	20	0	0	20	0	0
25	33967133	.	T	A	6	14	20	0	1	21	0	0
25	33967361	.	A	G	16	13	29	0	1	30	0	0
25	33967495	.	T	C	12	9	21	0	1	22	0	0
25	33967695	.	T	C	11	8	19	0	0	19	0	0
25	33967791	.	C	T	9	20	29	0	1	30	0	0
25	33967803	.	G	A	12	15	27	0	1	28	0	0
25	33968091	.	C	T	4	13	17	0	0	17	0	0
25	33968470	.	T	A	9	6	15	0	1	16	0	0
25	33968691	.	A	G	10	15	25	0	1	26	0	0
25	33968842	.	G	C	21	19	40	0	2	42	0	0
25	33968857	.	C	T	18	15	33	0	4	37	0	0
25	33968881	.	T	A	16	17	33	0	1	34	0	0
25	33981180	.	A	G	0	0	0	0	2	2	0	0
25	33983108	.	G	A	4	4	8	0	0	8	0	0
25	33987782	.	G	C	1	4	5	0	0	5	0	0
25	33987783	.	G	A	1	4	5	0	0	5	0	0
25	33987881	.	A	G	1	3	4	0	0	4	0	0
25	33988893	.	G	A	3	1	4	0	0	4	0	0
25	33988899	.	T	C	3	0	3	0	1	4	0	0
25	34002853	.	T	C	7	2	9	0	0	9	0	0
25	34017089	.	A	G	1	1	2	0	0	2	0	0
25	34018537	.	C	T	1	4	5	0	0	5	0	0
25	34022288	.	T	C	2	1	3	0	1	4	0	0
25	34022309	.	T	C	2	2	4	0	0	4	0	0
25	34027086	.	A	T	10	13	23	0	0	23	0	0
25	34027215	.	C	A	5	4	9	0	0	9	0	0
25	34027263	.	G	T	10	5	15	0	0	15	0	0
25	34154496	.	A	T	7	8	15	0	3	18	0	0
25	34154540	.	T	G	11	9	20	0	1	21	0	0
25	34154678	.	G	A	19	19	38	0	2	40	0	0
25	34257427	.	T	C	0	3	3	0	0	3	0	0
25	34257433	.	G	A	0	5	5	0	0	5	0	0
25	34421753	.	C	T	2	4	6	0	0	6	0	0
25	34456976	.	A	G	2	3	5	0	1	6	0	0
25	34457251	.	G	C	6	7	13	0	0	13	0	0
25	34457288	.	A	G	4	3	7	0	0	7	0	0
25	34457663	.	C	T	11	5	16	0	0	16	0	0
25	34457841	.	A	T	5	7	12	0	1	13	0	0
25	34458131	.	A	C	2	3	5	0	0	5	0	0
25	34487775	.	G	A	1	3	4	0	1	5	0	0
25	34487895	.	C	G	0	3	3	0	6	9	0	0
25	34488373	.	T	A	3	2	5	0	0	5	0	0
25	34488650	.	T	C	1	2	3	0	0	3	0	0
25	34489315	.	G	T	4	8	12	0	0	12	0	0
25	34511600	.	A	G	3	3	6	0	4	10	0	0
25	34511604	.	T	C	4	6	10	0	1	11	0	0
25	34511852	.	C	A	0	12	12	0	3	15	0	0
25	34511927	.	T	C	4	7	11	0	0	11	0	0
25	34511963	.	C	A	4	8	12	0	0	12	0	0
25	34647825	.	A	G	3	3	6	0	0	6	0	0
25	34649896	.	T	C	5	8	13	0	0	13	0	0
25	34649907	.	A	C	5	8	13	0	0	13	0	0
25	34662400	.	C	A	3	5	8	0	0	8	0	0
25	34662430	.	A	G	6	6	12	0	0	12	0	0
25	34697157	.	G	A	0	2	2	0	0	2	0	0
25	34703720	.	A	G	4	2	6	0	0	6	0	0
25	34703749	.	C	A	0	2	2	0	4	6	0	0
25	34704377	.	G	A	0	2	2	0	0	2	0	0
25	34706944	.	G	A	2	1	3	0	0	3	0	0
25	34709562	.	T	G	0	1	1	0	0	1	0	0
25	34714287	.	T	C	1	0	1	0	1	2	0	0
25	34728253	.	C	T	0	6	6	0	11	17	0	0
25	34728762	.	T	G	5	10	15	0	0	15	0	0
25	34728921	.	G	C	14	5	19	0	1	20	0	0
25	34728924	.	T	C	14	0	14	0	7	21	0	0
25	34740542	.	A	G	2	4	6	0	0	6	0	0
25	34752389	.	T	C	2	3	5	0	0	5	0	0
25	34762343	.	A	G	3	0	3	0	5	8	0	0
25	34762403	.	A	G	4	0	4	0	3	7	0	0
25	34763022	.	T	A	4	12	16	0	2	18	0	0
25	34763065	.	A	G	8	14	22	0	0	22	0	0
25	34763121	.	T	A	5	5	10	0	1	11	0	0
25	34763473	.	G	A	1	4	5	0	0	5	0	0
25	34765654	.	A	C	10	6	16	0	1	17	0	0
25	34765717	.	A	G	8	0	8	0	7	15	0	0
25	34765732	.	G	T	4	6	10	0	0	10	0	0
25	34794357	.	T	C	2	2	4	0	0	4	0	0
25	34797387	.	G	A	2	2	4	0	0	4	0	0
25	34798189	.	C	T	2	7	9	0	0	9	0	0
25	34798237	.	T	C	3	10	13	0	0	14	1	0
25	34798246	.	A	G	3	7	10	0	0	10	0	0
25	34799413	.	T	C	3	7	10	0	0	10	0	0
25	34799446	.	T	C	2	9	11	0	2	13	0	0
25	34801664	.	T	C	8	14	22	0	2	24	0	0
25	34801945	.	A	G	1	0	1	0	5	6	0	0
25	34801977	.	C	T	3	9	12	0	1	13	0	0
25	34802054	.	T	C	2	14	16	0	0	16	0	0
25	34802119	.	G	A	7	10	17	0	0	17	0	0
25	34802235	.	C	T	5	3	8	0	0	8	0	0
25	34802236	.	G	A	0	3	3	0	5	8	0	0
25	34802308	.	G	A	1	3	4	0	7	11	0	0
25	34802310	.	G	T	8	3	11	0	0	11	0	0
25	34802426	.	C	T	6	5	11	0	2	13	0	0
25	34802897	.	C	T	7	14	21	0	0	21	0	0
25	34802995	.	A	C	16	5	21	0	1	22	0	0
25	34803010	.	C	A	19	8	27	0	0	27	0	0
25	34803128	.	C	T	16	20	36	0	3	39	0	0
25	34803153	.	A	G	23	18	41	0	2	43	0	0
25	34803254	.	T	C	15	15	30	0	4	34	0	0
25	34803496	.	T	A	11	13	24	0	0	24	0	0
25	34803524	.	C	T	13	15	28	0	1	29	0	0
25	34803744	.	G	A	23	17	40	0	2	42	0	0
25	34803871	.	T	C	8	10	18	0	0	18	0	0
25	34803908	.	G	A	0	4	4	0	10	14	0	0
25	34803954	.	T	C	11	4	15	0	1	16	0	0
25	34804010	.	G	A	1	4	5	0	0	5	0	0
25	34804015	.	A	G	2	4	6	0	0	6	0	0
25	34804046	.	T	A	3	5	8	0	0	8	0	0
25	34817933	.	G	A	0	2	2	0	1	3	0	0
25	34825943	.	G	A	0	1	1	0	0	1	0	0
25	34835772	.	A	G	21	34	55	0	0	55	0	0
25	34841329	.	C	T	0	20	20	0	27	47	0	0
25	34844995	.	C	T	1	37	38	0	11	49	0	0
25	34845042	.	T	C	13	0	13	0	20	33	0	0
25	34845741	.	A	G	1	0	1	0	0	1	0	0
25	34845749	.	A	G	1	1	2	0	0	2	0	0
25	34845865	.	A	G	0	1	1	0	0	1	0	0
25	34851815	.	A	G	0	0	0	0	1	1	0	0
25	34859364	.	G	A	0	2	2	0	2	4	0	0
25	34859413	.	C	T	3	6	9	0	0	9	0	0
25	34859416	.	C	T	3	5	8	0	1	9	0	0
25	34888146	.	C	T	0	3	3	0	1	4	0	0
25	34888148	.	T	C	1	3	4	0	0	4	0	0
25	34889487	.	A	G	4	4	8	0	3	11	0	0
25	34911316	.	A	G	0	2	2	0	0	2	0	0
25	34911317	.	A	G	0	2	2	0	0	2	0	0
25	34911352	.	A	G	1	3	4	1	1	6	0	0
25	34956661	.	T	C	1	1	2	0	0	2	0	0
25	34972856	.	T	A	1	0	1	0	0	1	0	0
25	34973070	.	C	T	1	3	4	0	0	4	0	0
25	35002394	.	G	A	22	34	56	0	2	58	0	0
25	35005362	.	G	A	13	8	21	0	0	21	0	0
25	35006830	.	G	A	2	19	21	0	16	37	0	0
25	35006989	.	C	T	15	20	35	0	1	37	1	0
25	35007857	.	C	T	3	4	7	0	0	7	0	0
25	35007864	.	G	A	6	5	11	0	0	11	0	0
25	35270407	.	A	G	5	2	7	0	0	7	0	0
25	35467246	.	A	C	5	4	9	1	2	12	0	0
25	35713260	.	G	A	4	5	9	0	0	9	0	0
25	35713263	.	G	C	4	4	8	0	0	8	0	0
25	35730381	.	T	C	1	7	8	0	0	8	0	0
25	35765206	.	A	G	16	7	23	0	2	25	0	0
25	36199100	.	T	C	10	5	15	0	2	17	0	0
25	36405132	.	A	T	0	1	1	0	0	1	0	0
25	37078906	.	G	A	1	1	2	0	0	2	0	0
25	37137135	.	A	G	8	3	11	0	0	11	0	0
25	37335961	.	A	G	2	3	5	0	0	5	0	0
25	37336605	.	G	A	6	2	8	0	1	9	0	0
25	37336710	.	A	G	4	5	9	0	1	10	0	0
25	37364458	.	A	G	3	3	6	0	0	6	0	0
3	13937	.	C	T	0	7	7	0	0	7	0	0
3	40869	.	G	C	2	2	4	0	0	4	0	0
3	240680	.	G	A	0	3	3	0	2	5	0	0
3	240735	.	C	A	2	2	4	0	0	4	0	0
3	248989	.	C	T	2	2	4	0	0	4	0	0
3	249334	.	T	A	2	3	5	0	0	5	0	0
3	1130299	.	C	A	2	11	13	0	0	13	0	0
3	1134009	.	C	G	0	7	7	0	1	8	0	0
3	1134012	.	C	T	0	8	8	0	0	8	0	0
3	1134044	.	C	T	0	3	3	0	0	3	0	0
3	1266737	.	T	C	5	2	7	0	0	7	0	0
3	1323879	.	T	A	7	9	16	0	1	17	0	0
3	1324064	.	C	A	9	16	25	0	3	28	0	0
3	1324281	.	G	T	3	3	6	0	0	6	0	0
3	1324300	.	T	C	3	5	8	0	0	8	0	0
3	1324383	.	G	C	3	1	4	0	6	10	0	0
3	1324509	.	C	A	3	9	12	0	0	12	0	0
3	1324515	.	C	T	4	12	16	0	0	16	0	0
3	1324666	.	T	C	13	8	21	0	1	22	0	0
3	1324688	.	T	C	12	11	23	0	0	23	0	0
3	1337593	.	A	G	8	9	17	0	2	19	0	0
3	1339147	.	T	A	2	2	4	0	0	4	0	0
3	1500004	.	A	T	9	13	22	0	0	22	0	0
3	3610185	.	C	A	1	2	3	0	0	3	0	0
3	3610202	.	A	T	3	2	5	0	0	5	0	0
3	3610224	.	C	T	4	4	8	0	0	8	0	0
3	3617633	.	G	A	0	5	5	0	4	9	0	0
3	3630587	.	T	C	1	0	1	0	0	1	0	0
3	3631407	.	T	C	10	7	17	0	1	18	0	0
3	3634408	.	G	A	9	6	15	0	4	19	0	0
3	3813805	.	G	A	1	3	4	0	0	4	0	0
3	3813838	.	C	T	1	3	4	0	0	4	0	0
3	3820708	.	T	C	1	2	3	0	0	3	0	0
3	4459394	.	A	G	1	3	4	0	0	4	0	0
3	4459436	.	T	C	1	0	1	0	2	3	0	0
3	4460727	.	G	A	0	2	2	0	0	2	0	0
3	4502158	.	C	A	1	1	2	0	0	2	0	0
3	4506897	.	A	G	3	6	9	0	0	9	0	0
3	4506961	.	G	A	0	0	0	0	2	2	0	0
3	4508042	.	A	C	7	10	17	0	0	17	0	0
3	4508093	.	C	A	2	10	12	0	0	12	0	0
3	4508120	.	C	T	1	4	5	0	0	5	0	0
3	4511052	.	T	C	2	0	2	0	0	2	0	0
3	4511163	.	A	G	1	0	1	0	2	3	0	0
3	4514030	.	G	A	0	1	1	0	0	1	0	0
3	4530061	.	G	A	1	1	2	0	0	2	0	0
3	4530118	.	T	A	1	2	3	0	0	3	0	0
3	4530139	.	T	C	0	0	0	0	2	2	0	0
3	4648886	.	C	A	0	3	3	0	0	3	0	0
3	4997917	.	A	T	1	0	1	0	0	1	0	0
3	5009112	.	G	C	5	0	5	0	2	7	0	0
3	5012832	.	C	G	0	6	6	0	2	8	0	0
3	5021432	.	G	A	9	5	14	0	0	14	0	0
3	5021453	.	C	T	0	9	9	0	9	18	0	0
3	5040591	.	A	G	4	4	8	0	0	8	0	0
3	5052823	.	T	G	7	8	15	0	1	16	0	0
3	5052868	.	G	A	5	5	10	0	0	10	0	0
3	5053060	.	C	T	0	20	20	0	24	44	0	0
3	5053454	.	T	A	13	22	35	0	0	35	0	0
3	5053934	.	G	A	26	16	42	0	1	43	0	0
3	5053988	.	C	G	15	15	30	0	0	30	0	0
3	5056247	.	G	A	17	14	31	0	1	32	0	0
3	5056390	.	A	T	5	4	9	0	0	9	0	0
3	5062827	.	C	T	1	1	2	0	0	2	0	0
3	5063125	.	G	A	9	15	24	0	1	25	0	0
3	5063176	.	G	A	6	3	9	0	0	9	0	0
3	5067581	.	T	A	4	9	13	0	1	14	0	0
3	5130791	.	C	A	6	5	11	0	1	12	0	0
3	5130851	.	T	C	0	1	1	0	0	1	0	0
3	5134113	.	G	A	4	1	5	0	0	5	0	0
3	5134122	.	G	A	1	4	5	0	0	5	0	0
3	5134669	.	T	C	7	6	13	0	0	13	0	0
3	5136617	.	G	A	3	2	5	0	0	5	0	0
3	5140851	.	A	G	0	1	1	0	0	1	0	0
3	5141035	.	C	T	5	0	5	0	0	5	0	0
3	5141152	.	C	T	2	4	6	0	0	6	0	0
3	5143522	.	C	T	3	0	3	0	0	3	0	0
3	5145139	.	C	A	1	4	5	0	5	10	0	0
3	5145797	.	C	T	0	0	0	0	1	1	0	0
3	5147544	.	G	A	1	3	4	0	0	4	0	0
3	5152715	.	T	C	2	1	3	0	0	3	0	0
3	5228084	.	A	G	2	2	4	0	2	6	0	0
3	5267221	.	G	A	4	4	8	0	2	10	0	0
3	5267251	.	C	T	7	7	14	0	1	15	0	0
3	5270274	.	C	T	0	8	8	0	22	30	0	0
3	5349879	.	G	A	1	3	4	0	0	4	0	0
3	5624487	.	C	T	0	6	6	0	7	13	0	0
3	5633056	.	A	G	13	16	29	0	1	30	0	0
3	5633089	.	G	A	11	15	26	0	0	26	0	0
3	5633122	.	A	G	10	11	21	0	0	21	0	0
3	5634976	.	A	G	4	6	10	0	0	10	0	0
3	5637213	.	A	C	5	5	10	0	0	10	0	0
3	5637222	.	A	G	5	3	8	0	0	8	0	0
3	5723572	.	G	A	1	2	3	0	0	3	0	0
3	5778981	.	G	A	10	8	18	0	0	18	0	0
3	5779044	.	T	A	9	10	19	0	2	21	0	0
3	5779093	.	G	T	8	13	21	0	0	21	0	0
3	5782501	.	A	G	3	1	4	0	0	4	0	0
3	5782715	.	A	G	0	2	2	0	0	2	0	0
3	5792569	.	T	A	1	2	3	0	0	3	0	0
3	5812205	.	C	T	1	0	1	0	0	1	0	0
3	5812802	.	C	T	0	2	2	0	3	5	0	0
3	5812813	.	G	A	1	2	3	0	0	3	0	0
3	5814475	.	C	T	0	3	3	0	0	3	0	0
3	5814478	.	C	T	0	3	3	0	0	3	0	0
3	5824870	.	C	T	3	6	9	0	0	9	0	0
3	5829415	.	A	G	2	3	5	0	1	6	0	0
3	5882351	.	G	A	1	2	3	0	0	3	0	0
3	5882397	.	A	G	1	2	3	0	0	3	0	0
3	5882418	.	T	C	1	2	3	0	0	3	0	0
3	5886917	.	C	T	1	18	19	0	33	52	0	0
3	5887223	.	T	C	15	15	30	0	1	31	0	0
3	5887463	.	T	G	18	19	37	0	0	37	0	0
3	5887661	.	A	T	20	17	37	0	1	38	0	0
3	5887673	.	G	C	22	2	24	0	18	42	0	0
3	5887715	.	T	C	13	17	30	0	3	33	0	0
3	5887841	.	T	A	16	22	38	0	4	42	0	0
3	5887931	.	A	T	22	8	30	0	3	33	0	0
3	5888245	.	C	T	10	15	25	0	0	25	0	0
3	5888664	.	G	A	12	9	21	0	1	22	0	0
3	5888868	.	G	A	11	9	20	0	1	21	0	0
3	5889077	.	G	T	7	11	18	0	0	18	0	0
3	5889302	.	T	C	5	3	8	0	2	10	0	0
3	5889983	.	A	G	2	2	4	0	0	4	0	0
3	5890274	.	T	A	5	4	9	0	0	9	0	0
3	5890287	.	A	G	5	5	10	0	0	10	0	0
3	5890698	.	C	T	0	11	11	0	10	21	0	0
3	5908262	.	C	T	3	6	9	0	1	10	0	0
3	5908302	.	T	C	2	0	2	0	3	5	0	0
3	5908452	.	T	C	1	0	1	0	4	5	0	0
3	5908569	.	C	A	1	5	6	0	1	7	0	0
3	5964113	.	G	A	1	1	2	0	0	2	0	0
3	5991822	.	G	A	5	2	7	0	0	7	0	0
3	5994984	.	C	T	4	6	10	0	0	10	0	0
3	5995038	.	A	G	2	2	4	0	1	5	0	0
3	5995071	.	A	G	2	0	2	0	0	2	0	0
3	6018562	.	A	G	1	4	5	0	0	5	0	0
3	6018622	.	G	A	0	2	2	0	0	2	0	0
3	6380368	.	T	C	14	26	40	0	2	42	0	0
3	6417172	.	G	A	14	17	31	0	0	31	0	0
3	6477596	.	G	C	0	3	3	0	0	3	0	0
3	6491117	.	C	A	0	2	2	0	3	5	0	0
3	6491540	.	C	T	5	5	10	0	0	10	0	0
3	6491542	.	G	T	5	5	10	0	0	10	0	0
3	6491670	.	C	T	1	5	6	1	0	7	0	0
3	6491820	.	A	T	4	4	8	0	1	9	0	0
3	6491833	.	A	G	5	5	10	0	0	10	0	0
3	6491881	.	G	T	2	6	8	0	0	8	0	0
3	6491906	.	T	C	2	5	7	0	0	7	0	0
3	6498049	.	C	G	0	4	4	0	6	10	0	0
3	6499606	.	T	C	3	0	3	0	4	7	0	0
3	6502039	.	G	A	2	6	8	0	1	9	0	0
3	6504814	.	T	A	3	1	4	0	0	4	0	0
3	6515014	.	C	G	1	1	2	0	0	2	0	0
3	6515029	.	A	G	1	1	2	0	0	2	0	0
3	6659702	.	G	A	0	4	4	0	1	5	0	0
3	6659843	.	C	T	3	2	5	0	0	5	0	0
3	6663606	.	G	A	2	2	4	0	0	4	0	0
3	6664474	.	A	G	9	0	9	0	2	11	0	0
3	6664498	.	A	G	2	4	6	0	1	7	0	0
3	6664514	.	A	G	1	3	4	0	0	4	0	0
3	6664609	.	T	C	3	4	7	0	0	7	0	0
3	6665902	.	G	T	3	5	8	0	0	8	0	0
3	6665951	.	C	A	4	4	8	0	0	8	0	0
3	6665985	.	A	T	8	4	12	0	0	12	0	0
3	6666027	.	C	T	3	12	15	0	0	15	0	0
3	6666080	.	A	G	4	7	11	0	0	11	0	0
3	6666092	.	T	C	10	5	15	0	0	15	0	0
3	6666194	.	G	C	7	13	20	0	0	20	0	0
3	6666283	.	A	T	10	11	21	0	0	21	0	0
3	6666342	.	A	G	15	4	19	0	0	19	0	0
3	6666362	.	G	A	11	6	17	0	0	17	0	0
3	6666689	.	T	C	5	2	7	0	0	7	0	0
3	6666691	.	T	C	2	5	7	0	0	7	0	0
3	6666730	.	C	T	2	2	4	0	0	4	0	0
3	6666838	.	T	A	0	5	5	0	0	5	0	0
3	6666846	.	T	C	2	4	6	0	0	6	0	0
3	6667060	.	G	C	16	12	28	0	0	28	0	0
3	6667209	.	C	T	12	8	20	0	0	20	0	0
3	6667557	.	A	T	1	2	3	0	0	3	0	0
3	6667836	.	T	A	0	3	3	0	1	4	0	0
3	6721278	.	A	G	4	6	10	0	0	10	0	0
3	6721286	.	G	C	1	5	6	0	2	8	0	0
3	6721421	.	T	G	10	14	24	0	1	25	0	0
3	6721456	.	A	T	5	15	20	0	0	20	0	0
3	6721497	.	T	A	2	15	17	0	0	17	0	0
3	6721504	.	A	T	2	13	15	0	1	16	0	0
3	6721763	.	T	C	5	8	13	0	1	14	0	0
3	6721773	.	T	G	7	7	14	0	1	15	0	0
3	6721851	.	C	T	12	7	19	0	1	20	0	0
3	6722021	.	T	A	5	5	10	0	0	10	0	0
3	6722070	.	C	G	6	4	10	0	0	10	0	0
3	6722333	.	C	A	6	8	14	0	1	15	0	0
3	6722341	.	G	A	6	9	15	0	1	16	0	0
3	6722401	.	T	C	13	10	23	0	0	23	0	0
3	6722438	.	C	T	9	5	14	0	1	15	0	0
3	6723257	.	A	G	8	9	17	0	0	17	0	0
3	6725130	.	C	T	7	1	8	0	1	9	0	0
3	6725150	.	G	C	1	4	5	0	0	5	0	0
3	6725378	.	A	T	3	3	6	0	3	9	0	0
3	6725737	.	T	A	4	2	6	0	0	6	0	0
3	6726004	.	A	G	5	4	9	0	0	9	0	0
3	6726020	.	C	T	3	4	7	0	0	7	0	0
3	6726170	.	G	T	3	9	12	0	0	12	0	0
3	6726284	.	A	T	5	3	8	0	0	8	0	0
3	6726323	.	T	G	2	4	6	0	0	6	0	0
3	6726359	.	G	A	2	8	10	0	0	10	0	0
3	6727154	.	C	T	0	7	7	0	5	12	0	0
3	6731289	.	G	T	2	1	3	0	0	3	0	0
3	6732346	.	T	A	2	1	3	0	0	3	0	0
3	6732696	.	G	A	1	1	2	0	0	2	0	0
3	6732697	.	C	T	0	1	1	0	1	2	0	0
3	6737079	.	G	A	1	0	1	0	0	1	0	0
3	6737099	.	G	T	2	0	2	0	0	2	0	0
3	6749311	.	T	C	0	2	2	0	0	2	0	0
3	6895940	.	A	T	1	2	3	0	0	3	0	0
3	7007642	.	C	T	2	4	6	0	0	6	0	0
3	7007650	.	C	T	2	4	6	0	0	6	0	0
3	7007845	.	C	T	1	4	5	0	0	5	0	0
3	7008290	.	C	T	5	7	12	0	0	12	0	0
3	7008415	.	C	T	4	2	6	0	1	7	0	0
3	7099160	.	A	G	2	7	9	0	2	11	0	0
3	7099210	.	T	C	2	5	7	0	0	7	0	0
3	7099344	.	A	G	0	6	6	0	0	6	0	0
3	7099380	.	C	T	1	6	7	0	0	7	0	0
3	7099460	.	T	G	1	2	3	0	0	3	0	0
3	7099670	.	A	T	5	3	8	0	0	8	0	0
3	7099704	.	A	T	3	2	5	0	0	5	0	0
3	7099791	.	G	A	1	4	5	0	0	5	0	0
3	7112990	.	C	T	0	9	9	0	6	15	0	0
3	7113036	.	G	T	6	11	17	0	0	17	0	0
3	7113075	.	T	G	7	8	15	0	0	15	0	0
3	7113126	.	A	G	10	8	18	1	0	19	0	0
3	7113327	.	T	C	4	0	4	0	7	11	0	0
3	7113330	.	T	C	3	7	10	0	1	11	0	0
3	7113424	.	G	C	3	6	9	0	0	9	0	0
3	7113433	.	T	C	3	5	8	0	0	8	0	0
3	7113465	.	A	G	3	3	6	0	0	6	0	0
3	7113660	.	A	G	2	5	7	0	0	7	0	0
3	7113669	.	C	T	2	2	4	0	0	4	0	0
3	7113720	.	G	A	4	6	10	0	1	11	0	0
3	7113894	.	C	T	4	2	6	0	0	6	0	0
3	7113934	.	A	G	9	5	14	0	0	14	0	0
3	7114043	.	T	G	2	4	6	0	0	6	0	0
3	7124140	.	G	A	5	4	9	0	0	9	0	0
3	7124584	.	G	T	2	2	4	0	0	4	0	0
3	7124585	.	G	T	2	1	3	0	1	4	0	0
3	7124659	.	C	T	3	5	8	0	0	8	0	0
3	7124705	.	C	T	4	2	6	0	0	6	0	0
3	7124751	.	C	T	3	1	4	0	0	4	0	0
3	7124765	.	T	A	2	1	3	0	0	3	0	0
3	7128979	.	A	G	3	2	5	0	0	5	0	0
3	7133388	.	G	A	2	6	8	1	0	9	0	0
3	7133435	.	T	G	2	7	9	0	0	9	0	0
3	7133743	.	A	G	6	5	11	1	0	12	0	0
3	7133751	.	A	G	6	5	11	1	0	12	0	0
3	7133925	.	T	C	4	2	6	1	1	8	0	0
3	7141527	.	G	T	2	6	8	0	0	8	0	0
3	7141846	.	G	A	2	2	4	0	0	4	0	0
3	7141981	.	C	T	2	2	4	0	0	4	0	0
3	7142011	.	G	A	4	2	6	0	1	7	0	0
3	7155012	.	T	C	3	0	3	0	3	6	0	0
3	7155039	.	T	C	6	4	10	0	1	11	0	0
3	7155156	.	C	T	0	1	1	1	0	2	0	0
3	7155196	.	T	A	3	4	7	0	0	7	0	0
3	7155198	.	A	G	3	4	7	0	0	7	0	0
3	7155428	.	G	A	5	8	13	0	2	15	0	0
3	7156141	.	C	T	0	2	2	0	0	2	0	0
3	7160695	.	A	G	2	0	2	0	0	2	0	0
3	7277080	.	G	C	1	3	4	0	0	4	0	0
3	7277274	.	T	C	1	0	1	0	2	3	0	0
3	7509930	.	T	A	1	2	3	0	0	3	0	0
3	7509946	.	G	A	1	2	3	0	0	3	0	0
3	7509988	.	G	T	2	3	5	0	0	5	0	0
3	7510019	.	G	A	2	2	4	0	1	5	0	0
3	7638510	.	A	G	3	9	12	0	0	12	0	0
3	7819497	.	A	G	8	2	10	0	0	10	0	0
3	8323624	.	G	A	1	2	3	0	0	3	0	0
3	8399700	.	G	A	4	2	6	0	0	6	0	0
3	10163405	.	T	C	5	2	7	0	0	7	0	0
3	10421097	.	A	G	1	3	4	0	0	4	0	0
3	11564499	.	G	A	1	0	1	0	0	1	0	0
3	11564523	.	T	C	6	4	10	0	0	10	0	0
3	11564592	.	C	T	0	3	3	0	0	3	0	0
3	11575354	.	G	A	0	6	6	0	3	9	0	0
3	11575471	.	T	C	13	5	18	0	2	20	0	0
3	11575591	.	C	A	4	11	15	1	0	16	0	0
3	11575828	.	A	C	1	4	5	0	2	7	0	0
3	11585815	.	A	G	9	10	19	0	0	19	0	0
3	11585852	.	T	A	7	11	18	0	2	20	0	0
3	11585937	.	G	A	17	17	34	0	1	35	0	0
3	11586002	.	T	G	12	6	18	0	11	29	0	0
3	11586217	.	G	A	7	3	10	0	4	14	0	0
3	11586223	.	C	A	8	3	11	0	0	11	0	0
3	11586331	.	C	T	2	16	18	0	19	37	0	0
3	11586346	.	C	T	19	15	34	0	1	35	0	0
3	11586382	.	G	A	29	13	42	0	2	44	0	0
3	11586635	.	A	G	24	9	33	0	2	35	0	0
3	11586679	.	C	T	16	8	24	0	1	25	0	0
3	11586695	.	C	T	0	3	3	0	14	17	0	0
3	11590280	.	A	G	6	14	20	0	1	21	0	0
3	11614970	.	T	C	4	5	9	0	0	9	0	0
3	11615007	.	A	T	14	10	24	0	7	31	0	0
3	11615041	.	T	C	26	0	26	0	19	45	0	0
3	11615109	.	G	A	22	15	37	0	1	38	0	0
3	11615133	.	A	G	23	19	42	0	1	43	0	0
3	11615224	.	A	G	19	19	38	0	2	40	0	0
3	11624298	.	A	G	11	13	24	0	0	24	0	0
3	11781003	.	A	C	16	9	25	0	0	25	0	0
3	11781079	.	T	C	14	5	19	0	2	21	0	0
3	11781113	.	G	A	17	16	33	0	6	39	0	0
3	11784743	.	G	A	15	18	33	0	3	36	0	0
3	11797076	.	C	T	0	8	8	0	6	14	0	0
3	11922695	.	G	T	1	3	4	0	0	4	0	0
3	11934018	.	G	A	9	7	16	0	0	16	0	0
3	11934021	.	T	C	8	7	15	0	0	15	0	0
3	11934072	.	C	T	3	1	4	0	0	4	0	0
3	11937063	.	G	A	5	6	11	0	1	12	0	0
3	11937093	.	T	C	3	2	5	0	1	6	0	0
3	11937295	.	C	T	3	7	10	0	0	10	0	0
3	11941226	.	A	C	0	1	1	0	0	1	0	0
3	11947012	.	A	G	15	0	15	0	11	26	0	0
3	11947323	.	C	G	7	5	12	1	1	14	0	0
3	11947401	.	A	T	6	16	22	0	1	23	0	0
3	11947462	.	G	A	8	2	10	0	0	10	0	0
3	11958700	.	A	T	2	0	2	0	0	2	0	0
3	12335244	.	C	A	1	1	2	0	0	2	0	0
3	12345351	.	T	C	8	7	15	0	0	15	0	0
3	12345373	.	G	T	10	7	17	0	2	19	0	0
3	12349672	.	A	G	7	7	14	0	0	14	0	0
3	12376803	.	C	T	0	1	1	0	0	1	0	0
3	12585591	.	A	G	5	1	6	0	1	7	0	0
3	12585894	.	G	T	3	3	6	0	0	6	0	0
3	12647256	.	C	T	3	3	6	0	0	6	0	0
3	12647316	.	T	C	0	1	1	0	0	1	0	0
3	12652186	.	T	C	2	1	3	0	0	3	0	0
3	12652243	.	T	C	4	2	6	0	0	6	0	0
3	12658066	.	G	C	0	2	2	0	0	2	0	0
3	12678383	.	G	A	5	3	8	0	1	9	0	0
3	12678482	.	A	G	1	2	3	0	1	4	0	0
3	12678993	.	T	C	4	3	7	0	0	7	0	0
3	12679090	.	C	T	6	2	8	0	0	8	0	0
3	12681141	.	C	T	13	8	21	0	0	21	0	0
3	12681359	.	G	A	11	4	15	0	1	16	0	0
3	12689490	.	T	C	5	3	8	0	1	9	0	0
3	12689511	.	A	G	6	0	6	0	6	12	0	0
3	12689613	.	T	A	6	3	9	0	0	9	0	0
3	12691823	.	C	A	10	9	19	0	0	19	0	0
3	12692858	.	G	T	8	6	14	0	1	15	0	0
3	12692859	.	T	G	7	6	13	0	2	15	0	0
3	12698502	.	A	G	10	1	11	0	9	20	0	0
3	12698831	.	A	T	15	11	26	0	0	26	0	0
3	12698890	.	T	C	23	12	35	0	1	36	0	0
3	12698897	.	A	G	22	14	36	0	0	36	0	0
3	12698976	.	C	A	12	20	32	0	2	34	0	0
3	12699026	.	T	A	13	9	22	0	1	23	0	0
3	12699044	.	T	C	16	7	23	0	1	24	0	0
3	12699073	.	T	A	13	8	21	0	1	22	0	0
3	12699260	.	A	G	16	8	24	0	2	26	0	0
3	12699274	.	C	T	18	11	29	0	0	29	0	0
3	12699311	.	A	T	12	13	25	0	1	26	0	0
3	12699525	.	C	T	12	15	27	0	0	27	0	0
3	12699645	.	G	C	20	12	32	0	0	32	0	0
3	12699662	.	C	T	16	12	28	0	1	29	0	0
3	12831862	.	A	C	0	5	5	0	0	5	0	0
3	13424069	.	C	A	8	4	12	0	3	15	0	0
3	13424392	.	T	G	5	2	7	0	0	7	0	0
3	13424418	.	T	A	3	2	5	0	0	5	0	0
3	13424467	.	C	A	4	2	6	0	0	6	0	0
3	13424595	.	A	T	2	7	9	0	0	10	1	0
3	13424601	.	T	G	3	7	10	0	0	10	0	0
3	13424635	.	G	A	1	5	6	0	0	6	0	0
3	13424847	.	G	T	8	9	17	0	0	17	0	0
3	13424877	.	T	C	8	11	19	0	0	19	0	0
3	13424919	.	T	C	5	12	17	0	0	17	0	0
3	13424950	.	A	T	4	6	10	0	1	11	0	0
3	13424968	.	C	T	3	4	7	0	0	7	0	0
3	13424989	.	C	A	0	2	2	0	2	4	0	0
3	13426691	.	G	A	1	1	2	0	0	2	0	0
3	13426754	.	C	A	0	13	13	0	5	18	0	0
3	13430606	.	A	G	0	1	1	0	0	1	0	0
3	13431327	.	G	A	4	5	9	0	0	9	0	0
3	13432609	.	C	T	3	1	4	0	1	5	0	0
3	13434860	.	C	T	0	9	9	0	7	16	0	0
3	13434888	.	A	G	8	13	21	0	0	21	0	0
3	13434920	.	C	G	2	9	11	0	0	11	0	0
3	13434930	.	A	T	2	6	8	0	0	8	0	0
3	13435924	.	A	G	2	9	11	0	4	15	0	0
3	13435998	.	T	C	6	0	6	0	11	17	0	0
3	13437767	.	G	A	3	10	13	0	0	13	0	0
3	13441459	.	G	A	1	0	1	0	0	1	0	0
3	13445758	.	G	A	1	12	13	0	11	24	0	0
3	13445884	.	T	G	11	5	16	0	0	16	0	0
3	13446019	.	C	T	7	9	16	0	0	16	0	0
3	13447870	.	C	T	8	17	25	0	0	25	0	0
3	13453494	.	C	T	7	4	11	0	0	11	0	0
3	13453500	.	A	G	7	3	10	0	1	11	0	0
3	13455893	.	T	C	1	0	1	0	3	4	0	0
3	13456436	.	A	G	2	3	5	0	1	6	0	0
3	13456472	.	C	T	0	3	3	0	6	9	0	0
3	13458400	.	T	C	1	0	1	0	1	2	0	0
3	13458430	.	C	T	0	2	2	0	1	3	0	0
3	13458443	.	G	A	1	2	3	0	0	3	0	0
3	13488321	.	G	A	4	3	7	0	0	7	0	0
3	13488472	.	A	G	5	2	7	0	0	7	0	0
3	13488486	.	T	A	3	3	6	0	1	7	0	0
3	13488518	.	G	C	4	3	7	0	1	8	0	0
3	13525976	.	C	G	6	9	15	0	0	15	0	0
3	13526043	.	A	G	1	2	3	0	0	3	0	0
3	13534291	.	C	T	0	4	4	0	8	12	0	0
3	13534311	.	G	C	2	3	5	0	0	5	0	0
3	13534339	.	C	T	0	1	1	0	1	2	0	0
3	13535786	.	A	T	2	3	5	0	0	5	0	0
3	13541879	.	C	T	0	2	2	0	4	6	0	0
3	13542252	.	C	T	2	2	4	0	0	4	0	0
3	13582031	.	A	T	0	2	2	0	0	2	0	0
3	13582156	.	T	C	10	8	18	0	0	18	0	0
3	13582181	.	G	A	7	9	16	0	4	20	0	0
3	13582217	.	G	T	17	2	19	0	3	22	0	0
3	13582220	.	A	T	18	3	21	0	2	23	0	0
3	13582288	.	A	T	20	7	27	0	2	29	0	0
3	13582295	.	T	A	15	7	22	0	4	26	0	0
3	13582547	.	C	G	0	10	10	0	11	21	0	0
3	13589391	.	G	T	2	3	5	0	0	5	0	0
3	13589412	.	G	A	4	8	12	0	1	13	0	0
3	13589469	.	A	G	10	14	24	0	3	27	0	0
3	13590995	.	G	A	5	8	13	0	0	13	0	0
3	13593605	.	C	T	4	9	13	0	0	13	0	0
3	13595100	.	A	G	9	9	18	0	0	18	0	0
3	13595245	.	G	A	6	1	7	0	0	7	0	0
3	13595686	.	C	T	5	5	10	0	0	10	0	0
3	13603365	.	T	G	0	1	1	0	0	1	0	0
3	13607036	.	G	A	0	0	0	0	1	1	0	0
3	13607051	.	T	C	1	0	1	0	0	1	0	0
3	13609168	.	T	A	1	2	3	0	0	3	0	0
3	13617725	.	C	T	7	2	9	0	0	9	0	0
3	13617738	.	T	A	6	3	9	0	0	9	0	0
3	13618203	.	A	T	4	2	6	0	0	6	0	0
3	14497004	.	T	C	5	32	37	0	2	39	0	0
3	14860158	.	C	T	10	4	14	0	1	15	0	0
3	15057191	.	A	T	16	8	24	0	0	24	0	0
3	15057214	.	G	T	19	7	26	0	2	28	0	0
3	15057549	.	T	G	9	8	17	0	1	18	0	0
3	15057656	.	G	A	0	7	7	0	15	22	0	0
3	15057696	.	T	C	12	4	16	0	0	16	0	0
3	15057928	.	G	A	5	3	8	0	0	8	0	0
3	15058259	.	G	T	8	9	17	0	0	17	0	0
3	15058323	.	A	G	9	9	18	0	0	18	0	0
3	15085422	.	G	A	2	5	7	0	3	10	0	0
3	15085528	.	C	T	4	3	7	0	0	7	0	0
3	15085530	.	G	T	4	3	7	0	0	7	0	0
3	15085673	.	G	A	13	7	20	0	2	22	0	0
3	15085784	.	G	C	8	17	25	0	0	25	0	0
3	15085821	.	C	T	12	10	22	0	0	22	0	0
3	15091183	.	C	T	0	4	4	0	1	5	0	0
3	15629022	.	T	C	6	5	11	0	0	11	0	0
3	15670572	.	A	G	5	2	7	0	1	8	0	0
3	15714627	.	G	A	0	1	1	0	0	1	0	0
3	15988337	.	A	G	14	21	35	0	2	37	0	0
3	16020530	.	A	G	3	2	5	0	0	5	0	0
3	16282398	.	A	G	1	2	3	0	0	3	0	0
3	16284495	.	T	A	0	2	2	0	0	2	0	0
3	16389180	.	G	T	10	4	14	0	0	14	0	0
3	16389230	.	C	T	18	6	24	0	2	26	0	0
3	16389517	.	C	T	1	2	3	0	0	3	0	0
3	16391695	.	G	A	2	6	8	0	1	9	0	0
3	16391719	.	T	C	1	0	1	0	0	1	0	0
3	16395548	.	A	G	4	2	6	0	0	6	0	0
3	16397627	.	A	T	1	1	2	0	0	2	0	0
3	16404204	.	T	C	3	3	6	0	1	7	0	0
3	16404406	.	G	C	1	2	3	0	0	3	0	0
3	16644872	.	C	T	0	2	2	0	0	2	0	0
3	16648459	.	G	T	7	4	11	0	0	11	0	0
3	16650129	.	G	A	2	1	3	0	0	3	0	0
3	16664476	.	T	C	5	5	10	0	0	10	0	0
3	16668671	.	C	T	1	0	1	0	0	1	0	0
3	16679136	.	C	T	9	8	17	0	2	19	0	0
3	16679248	.	C	T	7	10	17	0	0	17	0	0
3	16679331	.	T	C	7	8	15	0	1	16	0	0
3	16679349	.	G	A	7	4	11	0	0	11	0	0
3	16679387	.	G	A	6	3	9	0	0	9	0	0
3	16679520	.	G	A	9	10	19	0	0	19	0	0
3	16679556	.	G	A	0	9	9	0	8	17	0	0
3	16679561	.	A	G	7	0	7	0	10	17	0	0
3	16679820	.	C	T	4	7	11	0	1	12	0	0
3	16692232	.	A	G	1	0	1	0	0	1	0	0
3	16693877	.	G	C	1	0	1	0	0	1	0	0
3	16729101	.	G	A	2	1	3	0	0	3	0	0
3	16731938	.	A	G	0	0	0	0	1	1	0	0
3	16733790	.	C	T	2	6	8	0	0	8	0	0
3	16735384	.	T	C	0	2	2	0	0	2	0	0
3	16735423	.	C	T	2	4	6	0	0	6	0	0
3	16735507	.	C	T	0	1	1	0	0	1	0	0
3	16738857	.	T	A	1	0	1	0	0	1	0	0
3	16741179	.	A	C	4	7	11	0	3	14	0	0
3	16741830	.	A	G	5	6	11	0	1	12	0	0
3	16741851	.	T	C	6	6	12	0	2	14	0	0
3	16746153	.	A	C	27	14	41	0	0	41	0	0
3	16746659	.	A	T	2	3	5	0	0	5	0	0
3	16746666	.	T	C	2	2	4	0	0	4	0	0
3	16746796	.	G	A	5	3	8	0	0	8	0	0
3	16746947	.	A	T	7	17	24	0	0	24	0	0
3	16747229	.	A	G	3	0	3	0	7	10	0	0
3	16747233	.	G	T	0	7	7	0	3	10	0	0
3	16972949	.	T	A	3	2	5	0	1	6	0	0
3	16972991	.	T	C	3	7	10	0	0	10	0	0
3	17090941	.	G	A	2	2	4	0	0	4	0	0
3	17093097	.	T	C	5	2	7	0	0	7	0	0
3	17458960	.	C	T	1	1	2	0	0	2	0	0
3	17508107	.	T	C	3	0	3	0	0	3	0	0
3	17541305	.	G	A	0	2	2	0	1	3	0	0
3	17541332	.	C	A	1	2	3	0	0	3	0	0
3	17600870	.	A	T	2	5	7	0	0	7	0	0
3	17601019	.	A	G	1	3	4	0	0	4	0	0
3	17601239	.	A	C	2	4	6	0	0	6	0	0
3	17601247	.	C	T	1	5	6	0	0	6	0	0
3	17601569	.	C	T	3	5	8	0	0	8	0	0
3	17601570	.	A	G	3	5	8	0	0	8	0	0
3	17601611	.	A	T	2	4	6	0	0	6	0	0
3	17601636	.	C	A	2	2	4	0	0	4	0	0
3	17601717	.	G	A	0	3	3	0	1	4	0	0
3	17602081	.	A	T	6	9	15	0	1	16	0	0
3	17603512	.	T	C	3	2	5	0	0	5	0	0
3	17603558	.	G	A	2	4	6	0	0	6	0	0
3	17603926	.	T	C	2	2	4	0	0	4	0	0
3	17604002	.	T	A	1	2	3	0	0	3	0	0
3	17650983	.	G	A	26	19	45	0	1	46	0	0
3	17651208	.	C	A	19	16	35	0	6	41	0	0
3	17651508	.	G	A	18	18	36	0	2	38	0	0
3	17651718	.	C	T	18	20	38	0	2	40	0	0
3	17651837	.	C	T	21	10	31	0	1	32	0	0
3	17651847	.	C	A	9	17	26	0	0	26	0	0
3	17653813	.	A	T	1	3	4	0	0	4	0	0
3	17660156	.	C	T	2	2	4	0	0	4	0	0
3	17669502	.	T	A	0	1	1	0	0	1	0	0
3	17671567	.	C	T	1	7	8	0	0	8	0	0
3	17671843	.	G	A	1	0	1	0	0	1	0	0
3	17673250	.	C	T	1	1	2	0	0	2	0	0
3	17673386	.	C	T	4	2	6	0	1	7	0	0
3	17678335	.	T	C	0	1	1	0	0	1	0	0
3	17744438	.	T	A	2	4	6	0	0	6	0	0
3	17867319	.	A	G	3	2	5	0	0	5	0	0
3	17867334	.	A	G	4	2	6	0	0	6	0	0
3	17867440	.	T	C	17	7	24	0	1	25	0	0
3	17867716	.	C	A	4	3	7	0	0	7	0	0
3	17867870	.	T	C	6	3	9	0	0	9	0	0
3	17868174	.	T	G	2	13	15	0	1	16	0	0
3	17868669	.	C	A	8	5	13	0	0	13	0	0
3	17868673	.	A	G	7	4	11	0	2	13	0	0
3	17868710	.	T	C	2	8	10	0	0	10	0	0
3	17868776	.	C	T	3	9	12	0	1	13	0	0
3	17868949	.	G	C	12	11	23	0	0	23	0	0
3	17869030	.	G	C	4	12	16	0	2	18	0	0
3	17869300	.	G	A	8	6	14	0	0	14	0	0
3	17878505	.	A	G	3	1	4	0	0	4	0	0
3	17886528	.	G	A	3	5	8	0	2	10	0	0
3	17886996	.	C	T	2	6	8	0	1	9	0	0
3	18061557	.	C	T	5	2	7	0	0	7	0	0
3	18562893	.	G	T	1	2	3	0	0	3	0	0
3	18686781	.	T	C	8	1	9	0	4	13	0	0
3	18838547	.	C	T	3	6	9	0	1	10	0	0
3	18838559	.	T	A	5	2	7	0	1	9	1	0
3	18838595	.	T	A	2	9	11	0	1	12	0	0
3	18838878	.	C	T	7	7	14	0	0	14	0	0
3	18838900	.	T	A	4	4	8	0	0	8	0	0
3	18839017	.	C	T	7	3	10	0	0	10	0	0
3	18922660	.	A	C	4	2	6	0	0	6	0	0
3	18922801	.	G	A	2	4	6	0	0	6	0	0
3	18922819	.	C	T	4	4	8	0	0	8	0	0
3	18923246	.	A	G	4	4	8	0	1	9	0	0
3	18923536	.	C	T	5	6	11	0	1	12	0	0
3	18923586	.	C	G	6	0	6	0	8	14	0	0
3	18923601	.	T	C	3	3	6	0	1	7	0	0
3	18923824	.	A	T	1	2	3	0	1	4	0	0
3	19006010	.	G	A	3	11	14	0	1	15	0	0
3	19006388	.	G	A	12	15	27	0	2	29	0	0
3	19068868	.	G	A	2	2	4	0	0	4	0	0
3	19162582	.	A	G	1	1	2	0	0	2	0	0
3	19172284	.	G	T	3	4	7	0	0	7	0	0
3	19180634	.	G	A	1	2	3	0	0	3	0	0
3	19180775	.	C	A	3	5	8	0	0	8	0	0
3	19180778	.	A	G	3	3	6	0	1	7	0	0
3	19180811	.	C	T	3	2	5	0	0	5	0	0
3	19194126	.	C	T	0	2	2	0	3	5	0	0
3	19194135	.	A	T	3	3	6	0	0	6	0	0
3	19207219	.	A	G	10	0	10	0	10	20	0	0
3	19210238	.	T	C	11	20	31	0	0	31	0	0
3	19210287	.	A	G	19	1	20	0	20	40	0	0
3	19210352	.	A	G	15	13	28	0	1	29	0	0
3	19264751	.	A	G	3	8	11	0	1	12	0	0
3	19264760	.	T	A	4	5	9	0	2	11	0	0
3	19264787	.	G	T	5	10	15	0	1	16	0	0
3	19264874	.	T	C	1	0	1	0	0	1	0	0
3	19267552	.	C	T	1	6	7	0	0	7	0	0
3	19267564	.	T	C	1	4	5	0	0	5	0	0
3	19267906	.	A	G	4	0	4	0	7	11	0	0
3	19270732	.	C	T	3	3	6	0	0	6	0	0
3	19271549	.	A	G	14	16	30	0	0	30	0	0
3	19273907	.	A	G	17	18	35	0	1	36	0	0
3	19274532	.	C	G	10	15	25	0	0	25	0	0
3	19274544	.	A	C	12	16	28	0	1	29	0	0
3	19274688	.	T	C	14	8	22	0	2	24	0	0
3	19277027	.	A	G	9	7	16	0	0	16	0	0
3	19277084	.	T	A	3	1	4	0	0	4	0	0
3	19278247	.	T	C	9	6	15	0	0	15	0	0
3	19278796	.	C	T	0	4	4	0	0	4	0	0
3	19281259	.	G	A	0	13	13	0	11	24	0	0
3	19281295	.	A	G	19	22	41	0	2	43	0	0
3	19281310	.	T	A	14	23	37	0	2	39	0	0
3	19336553	.	T	A	4	3	7	0	0	7	0	0
3	19338599	.	C	T	1	1	2	0	0	2	0	0
3	19339833	.	A	G	0	2	2	0	0	2	0	0
3	19346162	.	C	G	3	3	6	0	0	6	0	0
3	19354657	.	G	C	8	4	12	0	1	13	0	0
3	19354902	.	T	C	11	6	17	0	0	17	0	0
3	19609716	.	G	A	10	15	25	0	1	26	0	0
3	19609747	.	G	A	6	13	19	0	2	21	0	0
3	19609897	.	A	C	9	15	24	0	0	24	0	0
3	19610495	.	T	A	1	8	9	0	0	9	0	0
3	19610648	.	A	T	16	11	27	0	1	28	0	0
3	19610655	.	G	T	14	14	28	0	1	29	0	0
3	19610865	.	A	C	18	21	39	0	1	40	0	0
3	19610933	.	A	G	1	4	5	0	1	6	0	0
3	19665429	.	G	A	6	3	9	0	0	9	0	0
3	19676791	.	A	G	1	0	1	0	0	1	0	0
3	19678301	.	A	G	0	1	1	0	0	1	0	0
3	19678310	.	C	T	0	2	2	0	0	2	0	0
3	19686149	.	C	T	3	3	6	0	0	6	0	0
3	19686332	.	G	T	1	4	5	0	0	5	0	0
3	19687393	.	T	C	1	1	2	0	0	2	0	0
3	19702196	.	G	A	3	2	5	0	0	5	0	0
3	19702224	.	T	C	5	4	9	0	0	9	0	0
3	19702551	.	T	C	4	1	5	0	0	5	0	0
3	19706564	.	A	G	7	4	11	0	0	11	0	0
3	19710389	.	T	C	5	10	15	0	3	18	0	0
3	19716761	.	C	T	8	6	14	0	0	14	0	0
3	19717047	.	G	C	10	3	13	0	0	13	0	0
3	19717079	.	T	C	10	7	17	0	1	18	0	0
3	19717171	.	T	A	5	8	13	0	1	14	0	0
3	19717459	.	C	T	20	14	34	0	0	34	0	0
3	19717589	.	T	G	11	4	15	0	19	34	0	0
3	19717656	.	T	C	10	10	20	0	3	23	0	0
3	19717669	.	G	A	12	11	23	0	0	23	0	0
3	19813466	.	T	A	3	2	5	0	0	5	0	0
3	19851120	.	G	C	6	4	10	0	0	10	0	0
3	19851289	.	G	T	13	11	24	0	0	24	0	0
3	19851325	.	T	C	14	10	24	0	1	25	0	0
3	19914453	.	A	G	13	13	26	0	2	28	0	0
3	19914619	.	C	T	11	11	22	0	1	23	0	0
3	19914781	.	G	A	1	14	15	0	7	22	0	0
3	19969409	.	C	T	24	11	35	0	2	37	0	0
3	19969416	.	G	C	21	14	35	0	1	36	0	0
3	19969530	.	G	C	21	16	37	0	0	37	0	0
3	19969560	.	C	T	16	18	34	0	3	37	0	0
3	19969909	.	C	T	28	22	50	0	2	52	0	0
3	19970397	.	C	A	20	21	41	0	3	44	0	0
3	19970589	.	G	A	1	16	17	0	23	40	0	0
3	19971063	.	T	G	29	31	60	0	1	61	0	0
3	19971316	.	A	G	24	24	48	0	1	49	0	0
3	19971719	.	A	C	14	23	37	0	14	51	0	0
3	20015458	.	G	T	8	6	14	0	2	16	0	0
3	20015752	.	T	C	4	10	14	0	0	14	0	0
3	20015785	.	G	C	0	1	1	0	1	2	0	0
3	20021477	.	C	T	6	9	15	0	0	15	0	0
3	20021593	.	C	T	2	6	8	0	1	9	0	0
3	20026042	.	G	T	16	17	33	0	1	34	0	0
3	20026106	.	G	A	20	14	34	0	0	34	0	0
3	20026148	.	G	A	18	12	30	0	2	32	0	0
3	20036309	.	A	G	5	2	7	0	0	7	0	0
3	20040557	.	C	G	0	15	15	0	11	26	0	0
3	20042325	.	A	T	24	20	44	0	3	47	0	0
3	20042453	.	G	C	19	19	38	0	1	39	0	0
3	20042476	.	C	T	15	17	32	0	1	33	0	0
3	20042824	.	A	G	15	23	38	0	1	39	0	0
3	20042965	.	T	C	14	23	37	0	0	37	0	0
3	20043024	.	A	G	19	15	34	0	2	36	0	0
3	20043069	.	C	A	16	9	25	0	0	25	0	0
3	20043121	.	A	T	11	19	30	0	1	31	0	0
3	20043279	.	A	T	11	11	22	0	0	22	0	0
3	20043556	.	C	T	12	18	30	0	0	30	0	0
3	20045679	.	A	G	15	11	26	0	1	27	0	0
3	20049714	.	G	A	11	6	17	0	1	18	0	0
3	20051185	.	G	A	6	6	12	0	0	12	0	0
3	20051290	.	G	A	3	0	3	0	0	3	0	0
3	20063757	.	A	G	6	17	23	0	1	24	0	0
3	20063901	.	C	T	8	5	13	0	0	13	0	0
3	20063917	.	G	A	7	5	12	0	0	12	0	0
3	20063978	.	T	C	0	5	5	0	1	6	0	0
3	20064002	.	C	T	2	5	7	0	0	7	0	0
3	20108424	.	A	T	25	26	51	0	1	52	0	0
3	20108636	.	A	T	17	22	39	0	0	39	0	0
3	20108643	.	G	T	19	21	40	0	0	40	0	0
3	20108790	.	T	C	12	12	24	0	0	24	0	0
3	20109247	.	T	C	17	0	17	0	14	31	0	0
3	20109421	.	T	C	16	16	32	0	0	32	0	0
3	20109583	.	A	G	8	15	23	0	0	23	0	0
3	20109861	.	G	A	17	18	35	0	2	37	0	0
3	20109951	.	C	A	21	22	43	0	0	43	0	0
3	20110269	.	T	C	29	9	38	0	1	39	0	0
3	20110346	.	A	G	20	13	33	0	4	37	0	0
3	20110359	.	T	A	13	15	28	0	0	28	0	0
3	20110444	.	C	A	8	16	24	0	2	26	0	0
3	20110557	.	A	G	17	27	44	0	1	45	0	0
3	20118281	.	C	G	1	4	5	0	0	5	0	0
3	20192178	.	A	G	1	3	4	0	1	5	0	0
3	20208474	.	A	G	1	0	1	0	4	5	0	0
3	20224046	.	T	C	1	2	3	0	0	3	0	0
3	20224065	.	A	G	2	2	4	0	0	4	0	0
3	20224700	.	A	C	2	3	5	0	0	5	0	0
3	20224704	.	G	T	0	3	3	0	2	5	0	0
3	20224832	.	T	C	1	2	3	0	0	3	0	0
3	20226236	.	G	A	4	7	11	0	0	11	0	0
3	20226274	.	T	C	2	4	6	0	1	7	0	0
3	20226300	.	T	G	1	6	7	0	1	8	0	0
3	20226515	.	T	C	1	2	3	0	0	3	0	0
3	20226855	.	C	G	1	0	1	0	1	3	1	0
3	20226889	.	G	T	2	3	5	0	0	5	0	0
3	20226924	.	T	C	5	3	8	0	0	8	0	0
3	20226937	.	A	C	5	3	8	0	0	8	0	0
3	20227147	.	T	A	3	2	5	0	0	5	0	0
3	20227420	.	A	T	5	2	7	0	0	7	0	0
3	20227443	.	A	G	3	5	8	0	1	9	0	0
3	20227555	.	G	A	4	2	6	0	0	6	0	0
3	20227781	.	T	A	2	4	6	0	0	6	0	0
3	20227805	.	T	C	1	3	4	0	1	5	0	0
3	20227848	.	A	C	3	5	8	0	0	8	0	0
3	20228052	.	C	T	4	5	9	0	1	10	0	0
3	20228168	.	A	T	6	8	14	0	0	14	0	0
3	20228303	.	C	T	3	5	8	0	0	8	0	0
3	20228335	.	T	C	3	4	7	0	0	7	0	0
3	20228686	.	T	G	3	1	4	0	0	4	0	0
3	20228874	.	C	T	3	2	5	0	0	5	0	0
3	20228961	.	A	G	7	0	7	0	4	11	0	0
3	20229033	.	C	G	6	0	6	0	5	11	0	0
3	20229057	.	A	T	3	3	6	0	2	8	0	0
3	20229235	.	A	G	11	8	19	0	2	21	0	0
3	20229260	.	G	A	15	9	24	0	0	24	0	0
3	20229479	.	A	G	4	6	10	0	0	10	0	0
3	20229503	.	T	A	4	6	10	0	0	10	0	0
3	20230539	.	T	A	5	3	8	0	0	8	0	0
3	20230598	.	T	C	11	3	14	0	0	14	0	0
3	20231025	.	T	G	7	5	12	0	0	12	0	0
3	20231060	.	C	T	10	3	13	0	1	14	0	0
3	20231080	.	G	A	0	4	4	0	11	15	0	0
3	20231288	.	G	A	4	8	12	0	0	12	0	0
3	20231289	.	C	T	4	8	12	0	0	12	0	0
3	20231385	.	C	T	11	14	25	0	0	25	0	0
3	20231483	.	T	A	4	5	9	0	2	11	0	0
3	20231510	.	G	A	7	3	10	0	1	11	0	0
3	20231539	.	C	G	7	5	12	0	0	12	0	0
3	20461541	.	G	C	2	2	4	0	0	4	0	0
3	20658235	.	C	T	12	9	21	0	0	21	0	0
3	20658333	.	G	T	21	15	36	0	2	38	0	0
3	20658653	.	C	G	17	8	25	0	0	25	0	0
3	20658809	.	C	T	11	14	25	1	1	27	0	0
3	20658899	.	T	A	10	9	19	0	0	19	0	0
3	20659051	.	T	G	22	15	37	0	0	37	0	0
3	20666937	.	A	G	5	8	13	0	1	14	0	0
3	20666970	.	A	T	0	1	1	0	1	2	0	0
3	20677240	.	A	G	2	2	4	0	0	4	0	0
3	20677261	.	C	A	4	8	12	0	1	13	0	0
3	20720843	.	G	A	3	2	5	0	1	6	0	0
3	20721042	.	C	A	1	3	4	0	0	4	0	0
3	20721049	.	T	A	0	2	2	0	1	3	0	0
3	20752904	.	A	T	9	2	11	0	0	11	0	0
3	20752928	.	A	T	5	0	5	0	0	5	0	0
3	20948584	.	G	C	1	0	1	0	6	7	0	0
3	20948598	.	G	C	1	5	6	0	1	7	0	0
3	20950366	.	C	T	21	17	38	0	1	39	0	0
3	20950529	.	T	C	16	28	44	0	3	47	0	0
3	20956926	.	C	A	14	26	40	0	3	43	0	0
3	20956957	.	G	A	19	13	32	0	4	36	0	0
3	20973017	.	C	T	1	2	3	0	0	3	0	0
3	20982056	.	G	A	4	3	7	0	0	7	0	0
3	20982061	.	T	C	2	4	6	0	0	6	0	0
3	21020188	.	A	G	4	6	10	0	0	10	0	0
3	21022558	.	C	A	5	6	11	0	0	11	0	0
3	21022993	.	A	G	0	1	1	0	0	1	0	0
3	21025709	.	A	T	22	30	52	0	2	54	0	0
3	21025986	.	A	T	20	19	39	0	3	43	1	0
3	21026079	.	A	G	19	27	46	0	1	47	0	0
3	21026293	.	A	G	27	12	39	0	1	40	0	0
3	21026370	.	T	C	14	25	39	0	1	40	0	0
3	21026894	.	A	T	6	4	10	0	0	11	1	0
3	21027101	.	A	T	13	11	24	0	0	24	0	0
3	21027504	.	C	T	13	10	23	0	1	24	0	0
3	21027715	.	C	T	12	13	25	0	3	28	0	0
3	21029813	.	C	A	31	22	53	0	0	53	0	0
3	21029902	.	T	G	12	22	34	0	1	35	0	0
3	21030101	.	G	A	25	18	43	0	0	43	0	0
3	21030293	.	C	T	30	24	54	0	4	58	0	0
3	21030318	.	A	C	24	33	57	0	1	58	0	0
3	21030730	.	T	C	21	16	37	0	1	38	0	0
3	21037760	.	C	T	1	5	6	0	1	7	0	0
3	21044189	.	G	A	17	15	32	0	0	32	0	0
3	21066745	.	A	T	7	12	19	0	0	19	0	0
3	21067384	.	A	G	10	12	22	0	0	22	0	0
3	21067565	.	A	G	5	7	12	0	1	13	0	0
3	21067606	.	A	T	12	8	20	0	2	22	0	0
3	21067718	.	T	A	5	8	13	0	1	14	0	0
3	21067911	.	G	T	13	11	24	0	2	26	0	0
3	21068176	.	G	A	6	8	14	0	0	14	0	0
3	21068205	.	G	T	5	3	8	0	1	9	0	0
3	21068378	.	T	G	6	1	7	0	1	8	0	0
3	21074598	.	G	A	6	12	18	0	0	18	0	0
3	21074667	.	G	A	4	8	12	0	0	12	0	0
3	21086092	.	G	A	3	3	6	0	0	6	0	0
3	21087743	.	G	T	6	2	8	0	0	8	0	0
3	21094398	.	C	A	4	3	7	0	0	7	0	0
3	21094462	.	G	A	0	4	4	0	1	5	0	0
3	21096176	.	C	T	9	5	14	0	1	15	0	0
3	21096487	.	G	A	18	19	37	0	1	38	0	0
3	21096693	.	T	A	19	14	33	0	0	33	0	0
3	21104470	.	A	G	3	6	9	0	2	11	0	0
3	21111671	.	C	T	0	2	2	0	1	3	0	0
3	21111680	.	T	C	2	5	7	0	0	7	0	0
3	21111916	.	G	C	12	6	18	0	1	19	0	0
3	21111940	.	A	G	8	12	20	0	0	20	0	0
3	21113913	.	C	A	24	14	38	0	1	39	0	0
3	21125687	.	G	T	24	15	39	0	0	39	0	0
3	21126015	.	C	T	28	27	55	0	4	59	0	0
3	21139754	.	T	C	10	10	20	0	1	21	0	0
3	21140789	.	A	G	4	7	11	0	1	12	0	0
3	21141184	.	C	T	9	8	17	0	0	17	0	0
3	21142429	.	A	T	6	5	11	0	0	11	0	0
3	21240878	.	A	T	5	7	12	0	1	13	0	0
3	21240971	.	C	G	1	7	8	0	0	8	0	0
3	21241269	.	A	G	4	8	12	0	0	12	0	0
3	21241413	.	C	A	0	6	6	0	3	9	0	0
3	21241416	.	A	G	4	5	9	0	0	9	0	0
3	21241461	.	G	A	5	4	9	0	0	9	0	0
3	21251642	.	A	T	5	10	15	0	0	15	0	0
3	21251732	.	G	C	9	4	13	0	1	14	0	0
3	21251873	.	A	G	6	12	18	0	0	18	0	0
3	21251924	.	G	A	6	7	13	0	0	13	0	0
3	21252172	.	C	G	22	21	43	0	0	43	0	0
3	21281483	.	G	C	11	11	22	0	0	22	0	0
3	21281677	.	C	T	1	12	13	0	13	26	0	0
3	21281926	.	A	C	3	5	8	0	1	9	0	0
3	21281927	.	T	A	4	5	9	0	0	9	0	0
3	21282192	.	T	C	3	11	14	0	0	14	0	0
3	21282340	.	A	G	13	13	26	0	0	26	0	0
3	21282546	.	G	A	6	9	15	0	2	17	0	0
3	21282981	.	A	G	12	10	22	0	0	22	0	0
3	21283509	.	C	A	9	7	16	0	0	17	1	0
3	21283741	.	T	C	3	9	12	0	1	13	0	0
3	21283759	.	T	C	2	8	10	0	0	10	0	0
3	21283811	.	T	G	6	4	10	0	0	10	0	0
3	21284429	.	A	G	2	3	5	0	0	5	0	0
3	21284430	.	A	G	2	3	5	0	0	5	0	0
3	21284514	.	A	T	2	3	5	0	0	5	0	0
3	21284752	.	G	A	3	2	5	0	0	5	0	0
3	21284794	.	G	T	3	3	6	0	0	6	0	0
3	21287697	.	A	G	3	2	5	0	0	5	0	0
3	21287981	.	C	T	5	0	5	0	1	6	0	0
3	21288007	.	T	C	2	0	2	0	1	3	0	0
3	21348283	.	T	G	3	4	7	0	0	7	0	0
3	21882991	.	A	T	3	3	6	0	0	6	0	0
3	21883505	.	C	A	1	3	4	0	0	4	0	0
3	21883524	.	G	A	1	2	3	0	0	4	1	0
3	21887512	.	T	A	1	3	4	0	0	4	0	0
3	21887513	.	A	T	1	3	4	0	0	4	0	0
3	21887641	.	G	A	3	3	6	0	0	6	0	0
3	21889028	.	T	A	2	5	7	0	0	7	0	0
3	21889036	.	T	C	1	6	7	0	0	7	0	0
3	21889213	.	A	T	2	3	5	0	0	5	0	0
3	21889268	.	A	G	7	6	13	0	0	13	0	0
3	21889443	.	A	G	2	2	4	0	0	4	0	0
3	21889615	.	A	G	0	1	1	0	1	2	0	0
3	22050000	.	C	A	0	2	2	0	0	2	0	0
3	22050026	.	G	A	2	6	8	0	0	8	0	0
3	22050263	.	G	A	5	7	12	0	0	12	0	0
3	22054324	.	G	A	8	13	21	0	1	22	0	0
3	22054356	.	C	T	5	12	17	0	0	17	0	0
3	22054491	.	C	T	6	10	16	0	3	19	0	0
3	22054724	.	T	C	8	3	11	0	1	12	0	0
3	22054793	.	A	C	6	10	16	0	0	16	0	0
3	22054856	.	G	A	6	7	13	0	0	13	0	0
3	22055128	.	A	G	5	0	5	0	9	14	0	0
3	22055216	.	T	A	6	5	11	0	1	12	0	0
3	22059083	.	A	T	3	3	6	0	0	6	0	0
3	22080117	.	A	G	5	4	9	0	0	9	0	0
3	22080356	.	T	G	4	3	7	0	0	7	0	0
3	22127948	.	G	A	0	4	4	0	0	4	0	0
3	22146900	.	G	C	0	6	6	0	6	12	0	0
3	22146945	.	T	C	3	2	5	0	1	6	0	0
3	22146969	.	C	T	1	0	1	0	0	1	0	0
3	22153178	.	C	T	6	8	14	0	0	14	0	0
3	22153372	.	A	G	3	0	3	0	5	8	0	0
3	22153412	.	A	C	6	12	18	0	0	18	0	0
3	22153762	.	C	G	5	3	8	0	0	8	0	0
3	22153848	.	A	G	3	0	3	0	4	7	0	0
3	22153849	.	A	G	3	4	7	0	0	7	0	0
3	22153885	.	A	G	1	6	7	0	1	8	0	0
3	22153944	.	T	G	6	0	6	0	8	14	0	0
3	22153983	.	A	G	1	8	9	0	0	9	0	0
3	22154050	.	A	G	13	1	14	0	1	15	0	0
3	22154051	.	A	G	8	6	14	0	1	15	0	0
3	22154174	.	A	G	4	7	11	0	0	11	0	0
3	22154274	.	C	G	3	9	12	1	1	14	0	0
3	22154306	.	G	T	0	4	4	1	6	11	0	0
3	22154610	.	A	C	15	10	25	0	1	26	0	0
3	22158373	.	G	T	32	16	48	0	2	50	0	0
3	22158416	.	G	C	32	26	58	0	0	58	0	0
3	22158551	.	T	C	35	27	62	0	1	63	0	0
3	22158768	.	T	G	29	32	61	0	1	62	0	0
3	22158904	.	A	T	42	13	55	0	1	56	0	0
3	22159569	.	A	G	24	11	35	0	1	36	0	0
3	22159584	.	C	A	1	6	7	0	24	31	0	0
3	22159697	.	A	G	14	35	49	0	0	49	0	0
3	22159797	.	G	A	10	11	21	0	0	21	0	0
3	22159886	.	C	T	1	4	5	0	0	5	0	0
3	22159892	.	G	T	1	4	5	0	0	5	0	0
3	22160042	.	T	G	15	23	38	0	0	38	0	0
3	22160131	.	C	G	4	10	14	0	2	16	0	0
3	22160421	.	C	T	15	25	40	0	2	42	0	0
3	22160436	.	A	C	18	26	44	0	0	44	0	0
3	22160706	.	T	A	12	19	31	0	3	34	0	0
3	22160767	.	G	T	26	8	34	0	1	38	3	0
3	22160779	.	C	T	25	10	35	0	0	35	0	0
3	22160947	.	C	A	9	5	14	0	1	16	1	0
3	22161153	.	A	G	16	15	31	0	1	32	0	0
3	22161176	.	G	T	13	13	26	0	2	28	0	0
3	22161317	.	C	T	0	9	9	0	18	27	0	0
3	22161366	.	G	A	12	9	21	0	1	22	0	0
3	22161389	.	T	A	12	12	24	0	0	24	0	0
3	22161588	.	C	T	13	6	19	0	3	22	0	0
3	22168615	.	C	T	3	2	5	0	0	5	0	0
3	22172765	.	A	G	17	15	32	0	0	32	0	0
3	22172837	.	G	A	16	15	31	0	0	31	0	0
3	22176777	.	C	T	1	1	2	0	0	2	0	0
3	22179835	.	A	C	2	3	5	0	0	5	0	0
3	22180315	.	T	C	3	2	5	0	0	5	0	0
3	22191042	.	T	C	14	18	32	0	4	36	0	0
3	22191044	.	C	A	14	18	32	0	4	36	0	0
3	22213993	.	T	A	0	2	2	0	0	2	0	0
3	22216212	.	T	C	1	0	1	0	2	3	0	0
3	22216265	.	G	A	3	4	7	0	0	7	0	0
3	22216296	.	A	T	2	4	6	0	0	6	0	0
3	22216358	.	G	A	2	9	11	0	0	11	0	0
3	22216413	.	C	G	2	3	5	0	0	5	0	0
3	22432213	.	G	T	3	22	25	0	1	26	0	0
3	22534546	.	C	T	1	2	3	0	0	3	0	0
3	22547182	.	A	G	9	7	16	0	0	16	0	0
3	22547227	.	C	T	2	5	7	0	1	8	0	0
3	22548052	.	G	A	6	2	8	0	1	9	0	0
3	22548094	.	A	G	8	10	18	0	1	19	0	0
3	22548095	.	G	T	8	11	19	0	0	19	0	0
3	22548177	.	G	T	2	4	6	0	0	6	0	0
3	22548388	.	G	A	6	12	18	0	0	18	0	0
3	22548666	.	C	G	11	11	22	0	0	22	0	0
3	22548677	.	C	T	12	12	24	0	0	24	0	0
3	22548903	.	A	C	11	13	24	0	2	26	0	0
3	22548928	.	T	A	8	16	24	0	1	25	0	0
3	22636743	.	T	A	1	2	3	0	0	3	0	0
3	22760872	.	C	A	0	2	2	0	0	2	0	0
3	22783298	.	G	A	3	3	6	0	0	6	0	0
3	22788163	.	T	C	4	3	7	0	0	7	0	0
3	22789725	.	G	T	2	5	7	0	0	7	0	0
3	22790117	.	A	G	3	3	6	0	0	6	0	0
3	22792033	.	T	C	1	5	6	0	0	6	0	0
3	22794477	.	A	G	2	2	4	0	0	4	0	0
3	22794705	.	T	C	0	2	2	0	0	2	0	0
3	22811835	.	G	A	0	13	13	0	12	25	0	0
3	22812753	.	A	G	10	1	11	0	18	29	0	0
3	22812759	.	C	A	14	15	29	0	2	31	0	0
3	22813052	.	G	A	0	15	15	0	23	38	0	0
3	22813515	.	T	A	9	12	21	0	1	22	0	0
3	22813563	.	G	T	11	6	17	0	2	19	0	0
3	22813569	.	T	G	11	7	18	0	1	19	0	0
3	22813628	.	C	A	12	11	23	0	1	24	0	0
3	22813629	.	T	A	13	10	23	0	1	24	0	0
3	22813778	.	C	T	7	8	15	0	0	15	0	0
3	22813954	.	A	G	8	1	9	0	0	9	0	0
3	22813998	.	T	G	6	8	14	0	0	14	0	0
3	22814109	.	G	A	15	9	24	0	2	26	0	0
3	22814147	.	G	A	0	12	12	0	16	28	0	0
3	22814209	.	T	C	14	20	34	0	1	35	0	0
3	22814230	.	A	G	17	1	18	0	14	32	0	0
3	22814453	.	A	G	10	14	24	0	1	25	0	0
3	22814478	.	A	G	9	13	22	0	1	23	0	0
3	22814546	.	G	A	19	12	31	0	1	32	0	0
3	22815296	.	C	A	1	7	8	0	0	8	0	0
3	22815994	.	C	T	1	5	6	0	16	22	0	0
3	22816166	.	T	C	8	5	13	0	0	13	0	0
3	22816167	.	G	A	8	5	13	0	0	13	0	0
3	22816586	.	G	A	9	8	17	0	1	18	0	0
3	22816616	.	T	A	6	7	13	0	1	14	0	0
3	22816652	.	A	G	7	6	13	0	0	13	0	0
3	22816676	.	T	C	8	6	14	0	1	15	0	0
3	22816783	.	A	C	10	0	10	0	10	20	0	0
3	22816793	.	T	C	12	7	19	0	1	20	0	0
3	22816989	.	C	T	10	5	15	0	0	15	0	0
3	22817004	.	G	T	9	8	17	0	1	18	0	0
3	22817300	.	T	C	14	1	15	0	7	22	0	0
3	22823823	.	A	C	0	1	1	0	0	1	0	0
3	22828257	.	A	G	1	3	4	0	0	4	0	0
3	22935364	.	G	A	3	1	4	0	1	5	0	0
3	22947802	.	A	G	2	0	2	0	3	5	0	0
3	22947820	.	T	C	1	1	2	0	0	2	0	0
3	22953826	.	G	A	0	2	2	0	2	4	0	0
3	22953926	.	T	C	1	2	3	0	0	3	0	0
3	22967007	.	A	G	1	2	3	0	0	3	0	0
3	22993279	.	A	C	6	5	11	0	0	11	0	0
3	22993542	.	G	A	8	6	14	0	0	14	0	0
3	22993614	.	C	T	7	4	11	0	0	11	0	0
3	22993828	.	C	T	8	6	14	0	0	14	0	0
3	22993844	.	A	C	8	2	10	0	0	10	0	0
3	22993997	.	C	A	4	9	13	0	0	13	0	0
3	22994019	.	A	C	5	12	17	0	1	18	0	0
3	22994078	.	G	T	1	14	15	0	8	23	0	0
3	22994318	.	A	G	6	0	6	0	3	9	0	0
3	22994344	.	G	T	0	3	3	0	4	7	0	0
3	23020490	.	C	T	1	4	5	0	0	5	0	0
3	23020496	.	A	G	4	2	6	0	0	6	0	0
3	23092841	.	C	A	1	0	1	0	0	1	0	0
3	23248840	.	A	G	1	0	1	0	0	1	0	0
3	23250603	.	C	G	5	4	9	0	0	9	0	0
3	23250652	.	G	A	0	3	3	0	3	6	0	0
3	23251258	.	A	C	3	6	9	0	0	9	0	0
3	23251299	.	C	G	6	5	11	0	0	11	0	0
3	23251744	.	G	A	1	7	8	0	4	12	0	0
3	23251822	.	A	G	7	10	17	0	3	20	0	0
3	23302371	.	A	G	2	6	8	0	2	10	0	0
3	23307870	.	G	T	0	1	1	0	5	6	0	0
3	23309155	.	C	A	4	0	4	0	0	4	0	0
3	23309214	.	A	G	16	7	23	0	0	23	0	0
3	23318362	.	G	A	1	1	2	0	0	2	0	0
3	23318368	.	C	T	1	3	4	0	0	4	0	0
3	23323560	.	T	A	6	11	17	0	1	18	0	0
3	23323719	.	T	C	2	6	8	0	0	8	0	0
3	23323788	.	G	A	4	4	8	0	0	8	0	0
3	23323829	.	T	C	2	4	6	0	0	6	0	0
3	23324159	.	T	A	6	4	10	0	0	10	0	0
3	23324235	.	G	A	6	9	15	0	0	15	0	0
3	23324420	.	T	C	2	5	7	0	0	7	0	0
3	23324421	.	T	C	2	5	7	0	0	7	0	0
3	23324536	.	C	T	9	6	15	0	0	15	0	0
3	23324746	.	T	A	11	9	20	0	1	21	0	0
3	23324815	.	T	A	7	11	18	0	0	18	0	0
3	23324829	.	C	T	8	11	19	0	1	20	0	0
3	23325207	.	A	C	8	8	16	0	0	16	0	0
3	23325476	.	G	A	2	3	5	0	0	5	0	0
3	23325559	.	C	T	7	4	11	0	1	12	0	0
3	23326418	.	C	G	4	1	5	0	2	7	0	0
3	23326478	.	G	A	9	7	16	0	0	16	0	0
3	23326711	.	G	A	9	11	20	0	1	21	0	0
3	23327282	.	C	T	21	18	39	0	0	39	0	0
3	23334465	.	A	T	8	9	17	0	0	18	1	0
3	23335024	.	G	A	16	13	29	0	1	30	0	0
3	23351944	.	G	A	7	6	13	0	0	13	0	0
3	23363193	.	G	A	3	2	5	0	0	5	0	0
3	23406614	.	G	A	6	5	11	0	0	11	0	0
3	23406637	.	G	C	7	1	8	0	6	14	0	0
3	23406701	.	C	T	4	6	10	0	0	10	0	0
3	23407085	.	G	T	5	8	13	0	0	13	0	0
3	23429169	.	A	C	11	8	19	0	3	22	0	0
3	23429262	.	A	T	9	15	24	0	0	24	0	0
3	23429263	.	T	C	9	14	23	0	1	24	0	0
3	23429433	.	A	G	10	5	15	0	2	17	0	0
3	23429696	.	A	G	6	8	14	0	0	14	0	0
3	23429763	.	A	C	12	0	12	0	17	29	0	0
3	23430011	.	G	A	8	7	15	0	2	17	0	0
3	23430067	.	A	G	10	9	19	0	1	20	0	0
3	23430116	.	T	A	15	10	25	0	0	25	0	0
3	23430119	.	C	T	1	9	10	0	15	25	0	0
3	23436305	.	T	A	8	13	21	0	0	21	0	0
3	23442923	.	A	G	7	11	18	0	2	20	0	0
3	23443487	.	G	A	4	12	16	0	1	17	0	0
3	23444539	.	A	T	1	3	4	0	0	4	0	0
3	23444551	.	T	G	2	4	6	0	0	6	0	0
3	23456344	.	T	C	2	0	2	0	7	9	0	0
3	23464828	.	T	C	0	5	5	0	0	5	0	0
3	23464865	.	T	C	4	5	9	0	0	9	0	0
3	23464894	.	G	A	5	6	11	0	0	11	0	0
3	23464911	.	C	T	5	5	10	0	0	10	0	0
3	23465292	.	T	C	3	3	6	0	0	6	0	0
3	23466160	.	A	G	1	7	8	0	0	8	0	0
3	23469391	.	C	T	8	7	15	0	1	16	0	0
3	23469438	.	A	G	8	5	13	0	0	13	0	0
3	23469472	.	T	C	7	3	10	0	0	10	0	0
3	23469848	.	T	A	7	7	14	0	0	14	0	0
3	23470037	.	A	C	6	0	6	0	8	14	0	0
3	23470044	.	T	A	6	7	13	0	0	13	0	0
3	23470172	.	G	A	6	5	11	0	0	11	0	0
3	23470173	.	T	A	6	5	11	0	0	11	0	0
3	23488794	.	T	A	9	4	13	0	1	14	0	0
3	23493694	.	T	C	18	13	31	0	1	32	0	0
3	23495767	.	T	C	23	21	44	0	2	46	0	0
3	23495872	.	T	C	18	16	34	0	0	34	0	0
3	23495905	.	G	T	10	13	23	0	0	23	0	0
3	23495908	.	A	G	10	13	23	0	0	23	0	0
3	23518249	.	G	A	2	2	4	0	0	4	0	0
3	23584128	.	G	A	6	5	11	0	0	11	0	0
3	23584577	.	A	C	8	11	19	0	3	22	0	0
3	23584703	.	A	T	10	8	18	0	0	18	0	0
3	23584704	.	T	A	9	7	16	0	2	18	0	0
3	23584748	.	C	A	4	10	14	0	0	14	0	0
3	23591620	.	T	C	3	0	3	0	3	6	0	0
3	23591662	.	G	C	5	0	5	0	6	11	0	0
3	23599844	.	A	C	16	14	30	0	0	30	0	0
3	23690146	.	C	T	4	4	8	0	0	8	0	0
3	23705327	.	T	G	3	1	4	0	5	9	0	0
3	23709399	.	A	G	4	1	5	0	7	12	0	0
3	23723582	.	C	G	5	2	7	0	0	7	0	0
3	23723655	.	T	A	1	3	4	0	0	4	0	0
3	23748628	.	T	A	7	5	12	0	0	12	0	0
3	24071108	.	T	C	12	9	21	0	0	21	0	0
3	24100770	.	C	T	2	6	8	0	0	8	0	0
3	24109865	.	T	A	2	3	5	0	0	5	0	0
3	24111146	.	T	C	5	5	10	0	1	11	0	0
3	24111188	.	G	C	1	4	5	0	0	5	0	0
3	24134600	.	C	T	5	1	6	0	0	6	0	0
3	24134607	.	T	G	4	0	4	0	2	6	0	0
3	24142965	.	C	T	10	10	20	0	0	20	0	0
3	24143559	.	G	A	3	7	10	0	0	10	0	0
3	24144037	.	A	G	6	5	11	0	1	12	0	0
3	24196092	.	C	T	2	4	6	0	0	6	0	0
3	24196204	.	T	C	4	4	8	0	1	9	0	0
3	24196365	.	T	G	3	3	6	0	0	6	0	0
3	24198970	.	G	A	20	16	36	0	0	36	0	0
3	24200563	.	T	A	10	10	20	0	2	24	2	0
3	24203310	.	A	G	8	7	15	0	0	15	0	0
3	24203504	.	A	G	12	4	16	0	3	19	0	0
3	24203588	.	T	C	7	4	11	0	1	12	0	0
3	24203676	.	G	T	4	2	6	0	0	6	0	0
3	24203767	.	A	G	1	3	4	0	1	5	0	0
3	24209715	.	T	A	3	4	7	0	0	7	0	0
3	24209852	.	T	C	1	1	2	0	0	2	0	0
3	24216029	.	A	G	6	3	9	0	0	9	0	0
3	24216161	.	T	C	0	2	2	0	0	2	0	0
3	24218282	.	C	T	7	10	17	0	0	17	0	0
3	24295067	.	C	A	4	3	7	0	0	7	0	0
3	24295149	.	A	G	2	5	7	0	1	8	0	0
3	24295198	.	C	T	6	3	9	0	0	9	0	0
3	24361257	.	T	C	26	20	46	0	1	47	0	0
3	24434494	.	T	A	40	16	56	0	10	66	0	0
3	24434512	.	C	G	42	24	66	0	1	67	0	0
3	24434601	.	C	T	37	24	61	0	2	63	0	0
3	24483164	.	A	T	10	14	24	0	1	25	0	0
3	24483259	.	G	A	0	11	11	0	7	18	0	0
3	24487821	.	A	G	17	19	36	0	0	36	0	0
3	24487905	.	A	G	6	10	16	0	0	16	0	0
3	24489662	.	T	C	1	1	2	0	0	2	0	0
3	24489838	.	A	G	10	11	21	0	1	22	0	0
3	24501686	.	G	C	19	24	43	0	2	45	0	0
3	24501757	.	G	A	0	16	16	0	18	34	0	0
3	24501772	.	G	A	18	17	35	0	1	36	0	0
3	24516825	.	A	C	3	2	5	0	1	6	0	0
3	24516948	.	G	A	2	2	4	0	0	4	0	0
3	24518063	.	A	G	4	2	6	0	0	6	0	0
3	24690213	.	T	C	1	2	3	0	0	3	0	0
3	24690346	.	A	G	0	3	3	1	1	5	0	0
3	24692117	.	T	C	6	4	10	0	0	10	0	0
3	24765063	.	G	T	3	2	5	0	2	7	0	0
3	24765117	.	C	G	1	6	7	0	0	7	0	0
3	24973667	.	T	A	12	16	28	0	0	28	0	0
3	24973867	.	T	A	10	23	33	0	1	34	0	0
3	24973912	.	T	C	7	0	7	0	19	26	0	0
3	24974298	.	G	A	12	19	31	0	0	31	0	0
3	24990641	.	G	A	0	26	26	0	18	44	0	0
3	24990746	.	A	C	19	26	45	0	5	50	0	0
3	24993657	.	G	C	21	21	42	0	0	42	0	0
3	24993682	.	A	G	20	21	41	0	0	41	0	0
3	24994253	.	T	C	19	28	47	0	2	49	0	0
3	24997055	.	A	T	17	15	32	0	7	39	0	0
3	24997955	.	A	T	13	7	20	0	0	20	0	0
3	24998204	.	C	G	7	9	16	0	0	16	0	0
3	24998533	.	A	G	18	18	36	0	2	38	0	0
3	24998536	.	A	G	19	18	37	0	0	37	0	0
3	24998797	.	C	T	12	10	22	0	1	23	0	0
3	24998833	.	C	T	9	11	20	0	1	21	0	0
3	24998860	.	C	T	7	10	17	0	1	18	0	0
3	24999049	.	T	C	9	3	12	0	2	14	0	0
3	24999601	.	C	T	1	5	6	0	4	10	0	0
3	24999636	.	A	C	6	8	14	0	2	16	0	0
3	24999916	.	A	G	10	7	17	0	0	18	1	0
3	24999955	.	T	G	5	7	12	0	0	12	0	0
3	24999967	.	A	G	6	7	13	0	0	13	0	0
3	25000051	.	G	T	4	7	11	0	0	11	0	0
3	25000114	.	G	A	7	5	12	0	3	15	0	0
3	25000417	.	C	A	0	6	6	0	5	11	0	0
3	25002169	.	A	G	2	4	6	0	0	6	0	0
3	25005814	.	A	C	2	4	6	0	0	6	0	0
3	25027734	.	G	A	7	2	9	0	0	9	0	0
3	25039408	.	C	G	0	3	3	0	0	3	0	0
3	25040475	.	T	C	0	2	2	0	0	2	0	0
3	25051437	.	A	G	2	2	4	0	1	5	0	0
3	25059771	.	A	G	6	4	10	0	0	10	0	0
3	25060009	.	C	T	4	7	11	0	0	11	0	0
3	25066348	.	A	G	5	6	11	0	0	11	0	0
3	25081126	.	T	G	1	2	3	0	1	4	0	0
3	25086740	.	T	A	0	1	1	0	0	1	0	0
3	25097047	.	C	A	15	19	34	0	3	37	0	0
3	25097257	.	T	C	1	0	1	0	0	1	0	0
3	25099018	.	A	G	1	4	5	0	0	5	0	0
3	25099883	.	T	C	10	8	18	0	2	20	0	0
3	25099988	.	T	A	21	21	42	0	4	46	0	0
3	25100004	.	A	G	24	19	43	0	2	45	0	0
3	25100182	.	A	T	18	24	42	0	0	42	0	0
3	25100222	.	G	A	0	23	23	0	22	46	1	0
3	25100311	.	C	G	24	24	48	0	2	51	1	0
3	25100379	.	A	T	25	14	39	0	3	42	0	0
3	25100535	.	G	T	7	13	20	0	3	23	0	0
3	25100565	.	T	G	8	0	8	0	9	17	0	0
3	25100620	.	G	A	4	4	8	0	0	8	0	0
3	25102030	.	A	T	21	11	32	0	3	35	0	0
3	25102095	.	A	G	22	12	34	0	2	37	1	0
3	25105097	.	A	C	5	0	5	0	3	8	0	0
3	25107705	.	T	C	5	6	11	0	0	11	0	0
3	25107729	.	A	T	8	6	14	0	0	14	0	0
3	25132325	.	T	C	2	2	4	0	0	4	0	0
3	25136479	.	C	T	0	10	10	0	17	27	0	0
3	25136571	.	G	A	7	9	16	0	0	16	0	0
3	25136655	.	T	A	6	8	14	0	0	14	0	0
3	25136706	.	C	G	8	6	14	0	1	15	0	0
3	25136819	.	T	G	7	9	16	0	0	16	0	0
3	25136855	.	G	T	5	7	12	0	0	12	0	0
3	25136868	.	A	G	2	7	9	0	0	9	0	0
3	25137144	.	G	T	3	3	6	0	1	7	0	0
3	25137706	.	A	G	4	5	9	0	0	9	0	0
3	25138011	.	G	A	2	6	8	0	2	10	0	0
3	25138264	.	G	T	5	10	15	0	1	16	0	0
3	25138306	.	C	T	5	13	18	0	0	18	0	0
3	25138543	.	C	T	0	4	4	0	4	8	0	0
3	25144108	.	A	C	2	1	3	0	1	4	0	0
3	25144109	.	T	C	3	1	4	0	0	4	0	0
3	25144211	.	A	G	3	4	7	0	0	7	0	0
3	25167162	.	A	G	2	8	10	0	0	10	0	0
3	25167238	.	C	A	4	13	17	0	1	18	0	0
3	25167332	.	A	C	4	9	13	0	0	13	0	0
3	25167351	.	A	C	5	8	13	0	0	13	0	0
3	25168907	.	A	T	8	7	15	0	0	15	0	0
3	25168994	.	C	T	7	10	17	0	1	18	0	0
3	25169181	.	C	T	8	7	15	0	0	15	0	0
3	25169426	.	C	T	4	2	6	0	1	7	0	0
3	25169483	.	C	T	3	2	5	0	0	5	0	0
3	25169600	.	A	T	3	2	5	0	0	5	0	0
3	25169612	.	A	T	3	2	5	0	0	5	0	0
3	25269936	.	A	C	4	17	21	0	1	22	0	0
3	25269960	.	A	G	7	21	28	0	2	30	0	0
3	25270023	.	A	G	11	13	24	0	0	24	0	0
3	25270048	.	G	T	14	16	30	0	1	31	0	0
3	25270058	.	A	C	15	14	29	0	1	30	0	0
3	25270311	.	A	G	42	19	61	0	12	73	0	0
3	25270320	.	A	G	41	18	59	0	12	71	0	0
3	25270602	.	C	G	29	35	64	0	6	70	0	0
3	25270680	.	C	T	36	35	71	0	2	73	0	0
3	25270710	.	A	C	31	36	67	0	2	69	0	0
3	25270752	.	A	G	27	27	54	0	6	60	0	0
3	25271209	.	T	A	33	20	53	0	3	56	0	0
3	25271579	.	C	T	15	16	31	0	4	35	0	0
3	25271653	.	T	C	15	27	42	0	3	45	0	0
3	25272051	.	T	A	5	3	8	0	1	9	0	0
3	25272623	.	C	T	23	27	50	0	7	57	0	0
3	25272859	.	T	A	22	26	48	0	0	48	0	0
3	25273463	.	G	A	21	22	43	0	2	45	0	0
3	25273524	.	G	C	6	5	11	0	0	11	0	0
3	25273648	.	A	G	6	5	11	0	1	12	0	0
3	25286050	.	G	A	8	5	13	0	1	14	0	0
3	25379483	.	C	A	0	19	19	0	15	34	0	0
3	25379546	.	A	G	19	19	38	0	2	40	0	0
3	25381494	.	G	A	26	15	41	0	0	41	0	0
3	25393308	.	A	G	13	11	24	0	2	26	0	0
3	25396677	.	G	T	13	20	33	0	4	37	0	0
3	25403685	.	G	A	4	2	6	0	0	6	0	0
3	25403812	.	G	C	5	5	10	0	0	10	0	0
3	25403865	.	G	T	1	2	3	0	0	3	0	0
3	25404591	.	G	A	3	4	7	0	1	8	0	0
3	25404618	.	T	C	2	5	7	0	0	7	0	0
3	25404626	.	G	T	2	3	5	0	0	5	0	0
3	25404699	.	G	A	0	1	1	0	0	1	0	0
3	25405540	.	T	C	0	1	1	0	0	1	0	0
3	25417279	.	G	A	1	5	6	0	0	6	0	0
3	25420845	.	T	C	3	2	5	0	0	5	0	0
3	25436830	.	T	C	8	2	10	0	0	10	0	0
3	25436893	.	T	G	4	12	16	0	6	22	0	0
3	25437284	.	G	T	20	14	34	0	0	35	1	0
3	25491134	.	A	G	6	5	11	0	0	11	0	0
3	25892828	.	A	G	0	2	2	0	1	3	0	0
3	25892831	.	A	G	0	3	3	0	0	3	0	0
3	25892882	.	A	G	3	0	3	0	3	6	0	0
3	26351448	.	A	G	12	22	34	0	0	34	0	0
3	27695434	.	A	G	2	0	2	0	5	7	0	0
3	27695450	.	A	G	2	0	2	0	4	6	0	0
3	27767182	.	A	G	16	3	19	0	1	20	0	0
3	27831277	.	A	G	4	2	6	0	1	7	0	0
3	27833009	.	T	C	26	7	33	0	1	34	0	0
3	27833093	.	T	C	18	12	30	0	2	32	0	0
3	27834305	.	T	C	27	8	35	0	2	37	0	0
3	27834412	.	T	C	17	18	35	0	1	36	0	0
3	27836036	.	T	C	11	7	18	0	0	18	0	0
3	28626340	.	A	C	4	3	7	0	1	8	0	0
3	28627044	.	T	A	6	13	19	0	0	19	0	0
3	28634485	.	T	A	8	8	16	0	0	16	0	0
3	28634549	.	A	G	11	14	25	0	0	25	0	0
3	28634883	.	C	A	12	11	23	0	5	28	0	0
3	28634884	.	A	C	8	12	20	0	8	28	0	0
3	28635106	.	G	A	21	7	28	0	1	29	0	0
3	28640608	.	C	T	0	6	6	0	5	11	0	0
3	28640734	.	G	A	9	10	19	0	1	20	0	0
3	28650721	.	T	C	2	0	2	0	1	3	0	0
3	28665218	.	T	C	8	9	17	0	1	18	0	0
3	28665239	.	G	A	7	8	15	0	1	16	0	0
3	28719103	.	G	A	9	5	14	0	1	15	0	0
3	28719189	.	C	T	3	5	8	0	1	9	0	0
3	28719506	.	C	G	4	10	14	0	1	15	0	0
3	28719592	.	T	G	15	5	20	0	0	20	0	0
3	28719636	.	T	A	13	7	20	0	0	20	0	0
3	28719649	.	C	T	12	6	18	0	1	19	0	0
3	28719730	.	G	T	8	4	12	0	1	13	0	0
3	28719852	.	T	C	5	10	15	0	1	16	0	0
3	28719878	.	G	A	6	7	13	0	1	14	0	0
3	28719905	.	C	A	0	5	5	0	6	11	0	0
3	28719971	.	C	A	0	7	7	0	2	9	0	0
3	28720010	.	G	A	2	5	7	0	0	7	0	0
3	28750223	.	G	T	1	3	4	0	0	4	0	0
3	28750376	.	A	C	5	3	8	0	0	8	0	0
3	28750377	.	G	C	5	3	8	0	0	8	0	0
3	29950927	.	T	C	12	15	27	0	1	28	0	0
3	30150935	.	T	C	4	2	6	0	0	6	0	0
3	30749508	.	T	C	3	0	3	0	5	8	0	0
3	30749541	.	G	A	2	2	4	0	0	4	0	0
3	30801282	.	G	A	1	2	3	0	0	3	0	0
3	30801297	.	G	T	1	2	3	0	0	3	0	0
3	30860896	.	A	T	0	1	1	0	0	1	0	0
3	30868430	.	A	G	1	3	4	0	1	5	0	0
3	30868853	.	T	G	8	6	14	0	0	14	0	0
3	30868855	.	T	C	8	6	14	0	0	14	0	0
3	30869205	.	A	G	3	13	16	0	0	16	0	0
3	30869206	.	C	T	3	9	12	0	4	16	0	0
3	30869662	.	C	T	4	7	11	0	0	11	0	0
3	30869728	.	C	T	0	8	8	0	6	14	0	0
3	30869938	.	A	G	3	5	8	0	0	8	0	0
3	30870382	.	T	G	5	3	8	0	0	8	0	0
3	30870409	.	G	A	5	2	7	0	0	7	0	0
3	30870508	.	G	A	8	3	11	0	0	11	0	0
3	30870670	.	G	A	2	3	5	0	0	5	0	0
3	30870838	.	T	A	2	6	8	0	0	8	0	0
3	30870974	.	A	C	5	3	8	0	0	8	0	0
3	30871478	.	A	T	3	5	8	0	0	8	0	0
3	30871873	.	C	G	0	4	4	0	4	8	0	0
3	30872264	.	T	G	6	4	10	0	0	10	0	0
3	30872655	.	T	C	0	3	3	0	0	3	0	0
3	30873165	.	C	T	0	2	2	0	0	2	0	0
3	30873185	.	A	T	0	2	2	0	0	2	0	0
3	30877163	.	C	T	0	2	2	0	0	2	0	0
3	30890630	.	T	A	11	9	20	0	1	21	0	0
3	30890869	.	G	A	21	25	46	0	2	48	0	0
3	30891201	.	A	G	25	20	45	0	2	47	0	0
3	30894281	.	A	G	5	18	23	0	0	23	0	0
3	30926689	.	A	G	4	1	5	0	0	5	0	0
3	30926817	.	T	C	1	0	1	0	1	2	0	0
3	30929960	.	G	A	0	3	3	0	0	3	0	0
3	30948173	.	G	A	4	6	10	0	1	11	0	0
3	30948206	.	C	A	3	3	6	0	1	7	0	0
3	30962456	.	C	G	2	2	4	0	0	4	0	0
3	30962536	.	C	T	0	2	2	0	1	3	0	0
3	31044431	.	C	T	1	5	6	0	0	6	0	0
3	31044493	.	A	C	3	2	5	0	0	5	0	0
3	31044579	.	A	G	4	4	8	0	1	9	0	0
3	31044649	.	T	C	4	2	6	0	0	6	0	0
3	31044782	.	A	C	2	0	2	0	5	7	0	0
3	31044850	.	T	C	5	2	7	0	0	7	0	0
3	31044986	.	G	T	2	4	6	0	0	6	0	0
3	31045098	.	G	A	2	2	4	0	1	5	0	0
3	31045271	.	T	G	1	2	3	0	0	3	0	0
3	31045335	.	C	G	3	2	5	0	0	5	0	0
3	31050126	.	T	A	6	2	8	0	1	9	0	0
3	31052589	.	G	A	1	2	3	0	0	3	0	0
3	31053268	.	A	C	0	0	0	0	1	1	0	0
3	31060366	.	C	T	6	3	9	0	0	9	0	0
3	31063625	.	A	T	4	6	10	0	0	10	0	0
3	31066259	.	A	G	1	2	3	0	0	3	0	0
3	31069634	.	T	C	17	14	31	0	1	32	0	0
3	31070892	.	A	G	3	5	8	0	0	8	0	0
3	31084598	.	C	T	0	1	1	0	0	1	0	0
3	31086366	.	A	G	1	2	3	0	0	3	0	0
3	31090353	.	C	G	1	4	5	0	0	5	0	0
3	31090424	.	T	C	3	2	5	0	0	5	0	0
3	31103852	.	G	A	3	2	5	0	0	5	0	0
3	31103861	.	C	T	3	2	5	0	1	6	0	0
3	31104046	.	T	C	0	3	3	0	1	4	0	0
3	31104065	.	T	C	2	3	5	0	0	5	0	0
3	31104309	.	C	T	0	2	2	0	4	6	0	0
3	31104333	.	A	G	3	3	6	0	0	6	0	0
3	31104652	.	G	A	9	3	12	0	0	12	0	0
3	31104655	.	G	T	9	2	11	0	1	12	0	0
3	31104943	.	C	T	2	5	7	0	1	8	0	0
3	31104969	.	G	A	7	9	16	0	0	16	0	0
3	31105259	.	A	C	31	26	57	0	1	58	0	0
3	31120249	.	C	T	9	8	17	0	1	18	0	0
3	31122581	.	T	G	12	19	31	0	3	34	0	0
3	31135832	.	T	C	3	0	3	0	5	8	0	0
3	31137957	.	G	A	1	1	2	0	1	3	0	0
3	31138225	.	A	G	1	2	3	0	0	3	0	0
3	31138247	.	C	T	2	2	4	0	0	4	0	0
3	31140267	.	C	T	1	2	3	0	0	4	1	0
3	31144674	.	A	G	1	0	1	0	0	1	0	0
3	31149781	.	C	A	0	1	1	0	0	1	0	0
3	31184034	.	C	T	2	1	3	0	0	3	0	0
3	31187564	.	C	G	6	6	12	0	0	12	0	0
3	31187608	.	C	T	3	6	9	0	1	10	0	0
3	31187719	.	G	A	4	4	8	0	0	8	0	0
3	31187721	.	A	C	4	4	8	0	0	8	0	0
3	31201643	.	T	G	3	3	6	0	0	6	0	0
3	31217714	.	G	T	1	0	1	0	2	3	0	0
3	31217723	.	G	A	2	3	5	0	0	5	0	0
3	31218153	.	C	T	0	0	0	0	1	1	0	0
3	31218240	.	T	A	0	2	2	0	1	3	0	0
3	31396679	.	A	G	6	7	13	0	1	14	0	0
3	31396760	.	A	C	6	8	14	0	0	14	0	0
3	31396781	.	C	G	7	0	7	0	4	11	0	0
3	31396826	.	T	C	4	1	5	0	0	5	0	0
3	31430327	.	T	C	6	1	7	0	1	8	0	0
3	31600731	.	T	C	2	2	4	0	0	4	0	0
3	31603766	.	G	A	0	1	1	0	4	5	0	0
3	31603787	.	G	A	1	1	2	0	1	3	0	0
3	31603803	.	T	A	0	1	1	0	0	1	0	0
3	31603925	.	A	G	2	4	6	0	2	8	0	0
3	31603976	.	G	A	2	3	5	0	0	5	0	0
3	31604030	.	T	C	3	7	10	0	0	10	0	0
3	31604053	.	G	A	4	6	10	0	1	11	0	0
3	31604133	.	T	C	2	3	5	0	0	5	0	0
3	31604411	.	T	A	3	3	6	0	0	6	0	0
3	31604834	.	A	T	3	6	9	0	0	9	0	0
3	31605033	.	A	G	3	4	7	0	0	7	0	0
3	31605039	.	C	T	3	4	7	0	0	7	0	0
3	31706607	.	C	A	19	12	31	0	0	31	0	0
3	31706966	.	T	C	11	7	18	0	1	19	0	0
3	31709010	.	C	T	13	19	32	0	1	33	0	0
3	31709079	.	G	A	14	6	20	0	1	21	0	0
3	31711526	.	T	C	3	9	12	0	0	12	0	0
3	31712328	.	G	T	2	3	5	0	1	6	0	0
3	31717595	.	C	T	15	13	28	0	0	28	0	0
3	31722101	.	A	T	19	14	33	0	0	33	0	0
3	31722342	.	A	G	3	9	12	0	0	12	0	0
3	31725824	.	C	T	24	22	46	0	1	47	0	0
3	31726066	.	T	C	16	24	40	0	1	41	0	0
3	31726395	.	G	A	1	7	8	0	15	23	0	0
3	31726541	.	A	T	5	11	16	0	3	19	0	0
3	31726829	.	C	T	10	13	23	0	2	25	0	0
3	31729328	.	A	G	2	3	5	0	1	6	0	0
3	31792683	.	G	T	19	6	25	0	0	25	0	0
3	31792856	.	G	A	19	11	30	1	0	31	0	0
3	31793080	.	C	T	10	6	16	0	0	16	0	0
3	31793515	.	T	G	5	16	21	0	0	21	0	0
3	31793518	.	G	A	15	4	19	0	0	19	0	0
3	31793557	.	A	G	11	6	17	0	0	17	0	0
3	31793715	.	G	C	14	7	21	0	0	21	0	0
3	31793739	.	C	T	6	9	15	0	1	16	0	0
3	31797508	.	C	G	11	6	17	0	0	17	0	0
3	31797749	.	A	G	2	4	6	0	0	6	0	0
3	31804244	.	A	G	2	2	4	0	0	4	0	0
3	31874969	.	G	T	2	9	11	0	1	12	0	0
3	31879513	.	T	A	3	6	9	0	0	9	0	0
3	31879626	.	G	A	2	5	7	0	2	9	0	0
3	31879725	.	T	A	11	8	19	0	0	19	0	0
3	31879726	.	C	A	11	8	19	0	0	19	0	0
3	31879880	.	G	T	7	10	17	0	3	20	0	0
3	31879911	.	T	C	3	14	17	0	0	17	0	0
3	31880184	.	C	G	0	6	6	0	9	15	0	0
3	31880641	.	C	T	1	6	7	0	16	23	0	0
3	31881082	.	G	T	3	0	3	0	0	3	0	0
3	31884001	.	A	G	0	1	1	0	0	1	0	0
3	31884321	.	C	T	0	0	0	0	3	3	0	0
3	31884477	.	C	T	4	8	12	0	0	12	0	0
3	31886783	.	C	T	0	2	2	0	1	3	0	0
3	31897070	.	A	G	3	4	7	0	0	7	0	0
3	31914167	.	T	A	0	3	3	0	0	3	0	0
3	31916624	.	T	G	4	1	5	0	11	16	0	0
3	31916701	.	A	T	4	7	11	0	0	11	0	0
3	31916724	.	A	G	10	7	17	0	0	17	0	0
3	31916787	.	G	T	20	16	36	0	0	36	0	0
3	31916863	.	T	C	10	12	22	0	1	23	0	0
3	31917075	.	T	G	15	0	15	0	7	22	0	0
3	31917279	.	G	T	4	7	11	0	0	11	0	0
3	31939272	.	A	G	1	1	2	0	0	2	0	0
3	31939473	.	G	T	0	20	20	0	9	29	0	0
3	31939566	.	C	A	19	15	34	0	2	36	0	0
3	31941152	.	C	T	4	7	11	0	1	12	0	0
3	31944357	.	A	T	17	6	23	0	0	23	0	0
3	31946903	.	A	G	4	2	6	0	0	6	0	0
3	31951034	.	A	C	1	3	4	0	0	4	0	0
3	31961992	.	G	A	0	3	3	0	6	9	0	0
3	32021628	.	G	A	8	7	15	0	0	15	0	0
3	32049740	.	C	T	10	8	18	0	1	19	0	0
3	32087455	.	T	G	1	1	2	0	0	2	0	0
3	32092698	.	A	T	1	2	3	0	0	3	0	0
3	32098130	.	G	A	0	2	2	0	3	5	0	0
3	32098194	.	C	T	3	3	6	0	0	6	0	0
3	32099841	.	A	G	23	0	23	0	30	53	0	0
3	32100183	.	G	T	4	8	12	0	0	12	0	0
3	32100206	.	T	C	4	8	12	0	0	12	0	0
3	32100755	.	T	C	19	12	31	0	0	31	0	0
3	32105746	.	C	A	6	3	9	0	0	9	0	0
3	32120241	.	A	G	3	2	5	0	0	5	0	0
3	32139671	.	G	A	4	2	6	0	0	6	0	0
3	32139701	.	C	G	3	3	6	0	0	6	0	0
3	32157262	.	C	G	1	2	3	0	0	3	0	0
3	32160490	.	G	A	7	2	9	0	0	9	0	0
3	32169545	.	G	A	2	1	3	0	0	3	0	0
3	32170835	.	C	T	1	1	2	0	0	2	0	0
3	32175918	.	C	A	0	2	2	0	0	2	0	0
3	32175945	.	T	C	0	0	0	0	2	2	0	0
3	32194861	.	G	T	1	2	3	0	0	3	0	0
3	32294745	.	G	A	14	19	33	0	1	34	0	0
3	32294869	.	C	G	2	13	15	0	28	43	0	0
3	32295151	.	C	T	8	21	29	0	0	29	0	0
3	32295294	.	G	A	23	11	34	0	0	34	0	0
3	32295519	.	A	C	17	10	27	0	1	28	0	0
3	32295635	.	T	A	3	14	17	0	3	20	0	0
3	32295880	.	C	T	0	4	4	0	3	7	0	0
3	32295903	.	A	T	5	7	12	0	1	13	0	0
3	32295923	.	C	T	0	11	11	0	7	18	0	0
3	32296122	.	C	T	14	9	23	0	1	24	0	0
3	32296202	.	G	A	14	14	28	0	1	29	0	0
3	32296253	.	T	A	13	11	24	0	1	25	0	0
3	32296283	.	G	A	8	7	15	0	1	16	0	0
3	32296306	.	G	A	6	7	13	0	1	14	0	0
3	32296379	.	A	G	22	12	34	0	0	34	0	0
3	32296559	.	G	A	9	16	25	0	2	27	0	0
3	32296560	.	C	T	1	8	9	0	18	27	0	0
3	32296673	.	A	G	25	10	35	0	0	35	0	0
3	32296873	.	G	A	15	16	31	0	1	32	0	0
3	32303045	.	G	A	6	6	12	0	1	13	0	0
3	32303698	.	A	G	0	1	1	0	0	1	0	0
3	32325218	.	A	G	3	5	8	0	0	8	0	0
3	32329167	.	A	T	10	14	24	0	0	24	0	0
3	32357596	.	C	T	15	20	35	0	7	42	0	0
3	32357799	.	A	C	22	31	53	0	2	55	0	0
3	32360978	.	G	A	10	3	13	0	0	13	0	0
3	32361669	.	G	A	14	10	24	0	1	25	0	0
3	32361865	.	A	G	6	6	12	0	0	12	0	0
3	32366279	.	T	C	2	3	5	0	0	5	0	0
3	32366332	.	G	A	7	3	10	0	0	10	0	0
3	32366403	.	C	T	5	6	11	0	0	11	0	0
3	32400967	.	C	T	27	34	61	0	3	64	0	0
3	32401159	.	C	A	36	25	61	0	4	65	0	0
3	32401252	.	C	T	20	27	47	0	1	48	0	0
3	32403959	.	T	G	7	0	7	0	4	11	0	0
3	32405571	.	C	T	2	4	6	0	0	6	0	0
3	32405865	.	G	C	17	13	30	0	1	31	0	0
3	32405910	.	C	T	19	21	40	0	0	40	0	0
3	32406447	.	T	C	31	24	55	0	3	58	0	0
3	32406547	.	T	C	33	23	56	0	0	56	0	0
3	32406618	.	G	A	30	22	52	0	3	55	0	0
3	32406631	.	C	G	20	29	49	0	3	52	0	0
3	32414873	.	T	C	3	5	8	0	0	8	0	0
3	32414882	.	G	C	3	6	9	0	0	9	0	0
3	32415781	.	A	C	1	3	4	0	0	4	0	0
3	32434974	.	G	A	0	3	3	0	7	10	0	0
3	32435034	.	G	T	0	7	7	0	8	15	0	0
3	32435757	.	G	A	0	6	6	0	6	12	0	0
3	32435874	.	G	A	0	4	4	0	5	9	0	0
3	32436024	.	C	A	7	5	12	0	0	12	0	0
3	32436109	.	T	A	3	6	9	0	1	10	0	0
3	32436156	.	T	C	5	4	9	0	0	9	0	0
3	32436426	.	C	T	14	10	24	0	0	24	0	0
3	32436736	.	G	C	5	7	12	0	1	13	0	0
3	32436774	.	G	A	6	7	13	0	0	13	0	0
3	32438425	.	A	C	11	9	20	0	1	22	1	0
3	32440805	.	A	G	5	4	9	0	0	9	0	0
3	32441156	.	T	G	18	0	18	0	18	36	0	0
3	32441297	.	C	A	13	14	27	0	1	28	0	0
3	32441385	.	G	C	20	13	33	0	1	34	0	0
3	32441532	.	G	A	4	12	16	0	0	16	0	0
3	32441779	.	C	T	18	23	41	0	2	43	0	0
3	32447386	.	G	A	13	10	23	0	0	23	0	0
3	32447505	.	G	T	21	12	33	0	1	35	1	0
3	32447674	.	C	G	15	19	34	0	0	34	0	0
3	32447800	.	T	C	5	7	12	0	0	12	0	0
3	32450399	.	T	C	10	11	21	0	0	21	0	0
3	32453727	.	G	A	9	7	16	0	0	16	0	0
3	32457325	.	G	A	0	3	3	0	7	10	0	0
3	32457620	.	T	C	15	22	37	0	1	38	0	0
3	32457686	.	T	C	12	19	31	0	1	32	0	0
3	32458627	.	C	T	6	15	21	0	1	23	1	0
3	32477891	.	T	C	4	2	6	0	0	6	0	0
3	32477950	.	T	A	3	0	3	0	1	4	0	0
3	32479471	.	T	C	0	1	1	0	0	1	0	0
3	32482222	.	A	T	7	5	12	0	1	13	0	0
3	32482231	.	A	G	7	0	7	0	5	12	0	0
3	32482495	.	G	T	0	5	5	0	10	15	0	0
3	32482834	.	A	G	10	5	15	0	0	15	0	0
3	32483557	.	T	G	9	9	18	0	0	18	0	0
3	32483956	.	T	C	9	6	15	0	1	16	0	0
3	32484034	.	A	G	15	0	15	0	11	26	0	0
3	32484039	.	A	G	14	0	14	0	13	27	0	0
3	32484204	.	T	C	16	6	22	0	0	22	0	0
3	32484472	.	T	C	7	8	15	0	1	16	0	0
3	32484676	.	T	G	11	14	25	0	1	26	0	0
3	32484892	.	A	G	10	5	15	0	3	18	0	0
3	32485306	.	A	G	19	23	42	0	2	44	0	0
3	32485324	.	C	T	23	18	41	0	2	43	0	0
3	32485366	.	A	G	19	17	36	0	0	36	0	0
3	32485519	.	A	C	13	13	26	0	3	29	0	0
3	32485967	.	C	A	26	14	40	0	2	42	0	0
3	32486049	.	A	T	18	18	36	0	1	37	0	0
3	32486069	.	C	G	15	1	16	0	21	37	0	0
3	32489613	.	C	T	19	25	44	0	2	46	0	0
3	32490098	.	C	T	18	10	28	0	1	29	0	0
3	32490251	.	G	T	15	12	27	0	0	27	0	0
3	32490264	.	G	A	12	11	23	0	0	23	0	0
3	32490487	.	G	T	9	10	19	0	2	21	0	0
3	32532801	.	G	A	1	2	3	0	0	3	0	0
3	32532878	.	C	T	2	2	4	0	0	4	0	0
3	32534263	.	A	G	4	0	4	0	0	4	0	0
3	32534353	.	C	T	2	4	6	0	1	7	0	0
3	32534365	.	T	A	0	1	1	0	0	1	0	0
3	32587304	.	C	T	3	7	10	0	0	10	0	0
3	32591894	.	T	C	2	1	3	0	2	5	0	0
3	32615862	.	G	A	0	3	3	0	1	4	0	0
3	32615895	.	G	A	1	2	3	0	1	4	0	0
3	32616036	.	A	G	1	2	3	0	0	3	0	0
3	32643512	.	G	A	14	6	20	0	0	20	0	0
3	32647124	.	T	C	17	17	34	0	3	37	0	0
3	32647194	.	C	T	15	9	24	0	3	27	0	0
3	32647252	.	G	A	13	11	24	0	2	26	0	0
3	32647308	.	G	C	7	15	22	0	2	24	0	0
3	32647414	.	A	G	0	2	2	0	0	2	0	0
3	32647558	.	A	G	8	0	8	0	8	16	0	0
3	32649846	.	C	T	14	13	27	0	0	27	0	0
3	32649960	.	G	A	11	14	25	0	0	25	0	0
3	32650004	.	A	G	11	15	26	0	0	26	0	0
3	32650199	.	C	A	8	4	12	0	0	12	0	0
3	32663485	.	T	C	8	3	11	0	0	11	0	0
3	32663764	.	T	G	4	6	10	0	0	10	0	0
3	32665515	.	G	A	1	2	3	0	0	3	0	0
3	32667118	.	A	C	5	2	7	0	0	7	0	0
3	32668806	.	A	G	9	7	16	0	0	16	0	0
3	32668818	.	A	G	10	4	14	0	0	14	0	0
3	32669040	.	C	G	2	2	4	0	2	6	0	0
3	32669077	.	T	A	3	3	6	0	0	6	0	0
3	32675236	.	G	A	6	12	18	0	0	18	0	0
3	32679267	.	T	A	5	14	19	0	1	20	0	0
3	32679289	.	T	A	8	20	28	0	1	29	0	0
3	32679332	.	C	T	12	13	25	0	3	28	0	0
3	32679528	.	C	A	13	9	22	0	3	25	0	0
3	32685708	.	A	G	4	0	4	0	5	9	0	0
3	32686230	.	A	G	3	0	3	0	5	8	0	0
3	32686245	.	T	C	0	1	1	0	0	1	0	0
3	32698500	.	A	G	8	10	18	0	1	19	0	0
3	32700697	.	A	G	6	4	10	0	0	10	0	0
3	32700758	.	A	G	9	15	24	0	1	25	0	0
3	32700988	.	C	T	11	10	21	0	1	22	0	0
3	32701031	.	T	G	6	0	6	0	10	16	0	0
3	32702596	.	T	A	13	6	19	0	2	21	0	0
3	32707219	.	G	A	7	8	15	0	0	15	0	0
3	32707267	.	T	C	8	6	14	0	0	14	0	0
3	32707272	.	C	A	7	6	13	0	0	13	0	0
3	32707480	.	C	T	10	9	19	0	0	19	0	0
3	32707621	.	C	G	9	10	19	0	1	20	0	0
3	32707813	.	C	G	12	15	27	0	1	28	0	0
3	32708077	.	T	C	9	12	21	0	0	21	0	0
3	32710705	.	A	G	12	7	19	0	0	19	0	0
3	32710812	.	G	A	0	1	1	0	2	3	0	0
3	32710999	.	C	A	9	7	16	0	0	16	0	0
3	32720342	.	T	C	2	4	6	0	0	6	0	0
3	32722973	.	C	T	4	4	8	0	0	8	0	0
3	32723033	.	A	G	3	0	3	0	3	6	0	0
3	32723497	.	A	G	6	1	7	0	8	15	0	0
3	32723698	.	C	T	1	3	4	0	1	5	0	0
3	32724100	.	G	A	1	2	3	0	0	3	0	0
3	32726271	.	A	G	2	8	10	0	1	11	0	0
3	32728304	.	T	C	3	5	8	0	0	8	0	0
3	32729150	.	T	C	10	6	16	0	0	16	0	0
3	32729232	.	T	C	4	6	10	0	3	13	0	0
3	32729591	.	C	T	5	5	10	0	0	10	0	0
3	32729663	.	C	T	8	6	14	0	0	14	0	0
3	32729759	.	C	A	5	4	9	0	0	9	0	0
3	32729827	.	A	T	4	4	8	0	1	9	0	0
3	32729845	.	G	A	5	3	8	0	1	9	0	0
3	32730011	.	A	G	8	0	8	0	7	15	0	0
3	32730071	.	T	A	6	6	12	0	1	13	0	0
3	32730131	.	A	G	6	6	12	0	0	12	0	0
3	32731255	.	A	G	4	0	4	0	10	14	0	0
3	32731418	.	C	T	7	6	13	0	2	15	0	0
3	32731750	.	A	G	1	0	1	0	3	4	0	0
3	32731804	.	T	C	5	10	15	0	1	16	0	0
3	32731840	.	T	C	4	9	13	0	1	14	0	0
3	32731855	.	T	C	2	6	8	0	1	9	0	0
3	32731879	.	A	G	1	0	1	0	3	4	0	0
3	32734926	.	G	A	0	4	4	0	4	8	0	0
3	32737727	.	C	T	5	3	8	0	0	8	0	0
3	32741137	.	G	A	0	11	11	0	8	19	0	0
3	32741385	.	G	A	1	8	9	0	13	22	0	0
3	32741809	.	A	G	11	0	11	0	12	23	0	0
3	32777481	.	A	C	7	17	24	0	1	25	0	0
3	32777733	.	G	T	5	16	21	0	0	21	0	0
3	32789985	.	T	C	1	0	1	0	0	1	0	0
3	32795068	.	C	T	6	8	14	0	0	14	0	0
3	32795425	.	G	A	5	4	9	0	0	9	0	0
3	32795461	.	A	T	3	4	7	0	0	7	0	0
3	32795614	.	C	T	2	5	7	0	0	7	0	0
3	32807667	.	G	A	2	5	7	0	1	8	0	0
3	32808023	.	T	A	10	7	17	0	0	17	0	0
3	32808185	.	T	C	17	12	29	0	0	29	0	0
3	32808214	.	G	A	12	15	27	0	2	29	0	0
3	32808338	.	A	C	13	22	35	0	6	41	0	0
3	32808554	.	T	G	6	15	21	0	2	23	0	0
3	32808771	.	G	A	8	10	18	0	1	19	0	0
3	32808772	.	G	C	8	10	18	0	1	19	0	0
3	32808979	.	T	G	9	15	24	0	0	24	0	0
3	32809154	.	A	T	3	11	14	0	0	15	1	0
3	32809368	.	G	A	10	12	22	0	2	24	0	0
3	32809410	.	G	A	5	15	20	0	1	21	0	0
3	32809432	.	T	A	6	11	17	0	1	18	0	0
3	32809548	.	T	C	10	14	24	0	0	24	0	0
3	32809561	.	G	A	8	18	26	0	0	26	0	0
3	32809836	.	A	G	9	0	9	0	8	17	0	0
3	32809927	.	T	C	8	15	23	0	1	24	0	0
3	32810011	.	T	A	14	11	25	0	1	26	0	0
3	32810580	.	C	T	18	21	39	0	1	40	0	0
3	32810715	.	A	G	19	19	38	0	1	39	0	0
3	32811094	.	A	T	6	12	18	0	0	18	0	0
3	32823917	.	T	C	4	3	7	0	0	7	0	0
3	32824612	.	T	C	2	4	6	0	0	6	0	0
3	32831417	.	T	C	1	2	3	0	0	3	0	0
3	32837514	.	G	A	10	8	18	0	0	18	0	0
3	32837643	.	G	A	18	10	28	0	8	36	0	0
3	32837904	.	A	G	27	1	28	0	20	48	0	0
3	32838033	.	G	A	1	5	6	0	10	16	0	0
3	32838039	.	A	G	7	5	12	0	2	14	0	0
3	32842163	.	C	T	11	8	19	0	0	19	0	0
3	32842235	.	G	T	8	10	18	0	1	19	0	0
3	32842318	.	C	T	9	4	13	0	0	13	0	0
3	32847607	.	C	T	2	4	6	0	0	6	0	0
3	32847771	.	G	A	0	2	2	0	4	6	0	0
3	32847839	.	C	A	2	5	7	0	0	7	0	0
3	32847887	.	C	G	4	3	7	0	0	7	0	0
3	32847923	.	C	A	5	3	8	0	0	8	0	0
3	32847942	.	A	G	4	0	4	0	2	6	0	0
3	32848175	.	T	G	1	4	5	0	0	5	0	0
3	32848418	.	C	T	7	6	13	0	1	14	0	0
3	32848714	.	A	G	6	2	8	0	2	10	0	0
3	32849079	.	C	T	10	6	16	0	0	16	0	0
3	32849679	.	T	A	9	13	22	0	2	24	0	0
3	32850265	.	A	G	1	0	1	0	3	4	0	0
3	32854276	.	T	C	7	4	11	0	2	13	0	0
3	32854533	.	T	C	7	9	16	0	0	16	0	0
3	32854743	.	C	G	7	0	7	0	9	16	0	0
3	32854744	.	A	G	8	8	16	0	0	16	0	0
3	32855066	.	G	A	10	4	14	0	0	15	1	0
3	32863016	.	A	G	1	5	6	0	0	6	0	0
3	32863128	.	C	A	1	1	2	0	0	2	0	0
3	32864848	.	A	G	3	1	4	0	0	4	0	0
3	32864854	.	T	A	3	1	4	0	0	4	0	0
3	32865309	.	A	C	0	1	1	0	0	1	0	0
3	32866135	.	C	T	1	2	3	0	0	3	0	0
3	32867711	.	C	A	0	1	1	0	0	1	0	0
3	32868114	.	G	T	4	4	8	0	0	8	0	0
3	32868143	.	C	T	3	3	6	0	0	6	0	0
3	32868590	.	C	T	3	7	10	0	1	11	0	0
3	32868593	.	A	G	3	5	8	0	4	12	0	0
3	32869770	.	C	T	4	13	17	0	0	17	0	0
3	32869773	.	G	A	4	13	17	0	0	17	0	0
3	32869913	.	C	T	1	5	6	0	0	6	0	0
3	32869930	.	C	T	1	5	6	0	0	6	0	0
3	32871023	.	G	C	3	4	7	0	0	7	0	0
3	32871202	.	T	C	1	2	3	0	2	5	0	0
3	32871247	.	A	G	1	2	3	0	2	5	0	0
3	32889849	.	T	C	8	1	9	0	14	23	0	0
3	32890002	.	G	T	13	14	27	0	3	30	0	0
3	32890058	.	A	G	15	12	27	0	3	30	0	0
3	32892061	.	G	A	6	7	13	0	1	14	0	0
3	32892422	.	A	G	6	5	11	0	1	12	0	0
3	32900428	.	A	G	4	5	9	0	1	10	0	0
3	32924386	.	G	A	7	4	11	0	0	11	0	0
3	32924643	.	G	A	4	4	8	0	1	9	0	0
3	32924836	.	T	A	7	11	18	0	1	19	0	0
3	32925066	.	G	A	4	7	11	0	0	11	0	0
3	32925248	.	C	T	4	1	5	0	0	5	0	0
3	32925400	.	C	T	5	3	8	0	0	8	0	0
3	32926058	.	A	G	4	3	7	0	0	7	0	0
3	32933774	.	A	C	4	4	8	0	1	9	0	0
3	32933849	.	A	T	5	7	12	0	0	12	0	0
3	32935936	.	A	G	3	0	3	0	5	8	0	0
3	32937628	.	A	G	11	8	19	0	1	20	0	0
3	32941242	.	G	A	3	3	6	0	0	6	0	0
3	32941661	.	A	G	2	6	8	0	1	9	0	0
3	32944203	.	C	A	6	11	17	0	0	17	0	0
3	32944569	.	C	T	2	3	5	0	0	5	0	0
3	32944668	.	C	A	12	8	20	0	4	24	0	0
3	32944854	.	C	T	14	15	29	0	2	31	0	0
3	32947971	.	T	C	3	4	7	0	0	7	0	0
3	32950959	.	G	A	12	15	27	0	0	27	0	0
3	32950977	.	G	A	2	14	16	0	13	29	0	0
3	32951001	.	G	T	0	12	12	0	13	26	1	0
3	32951394	.	G	A	21	23	44	0	1	45	0	0
3	32951564	.	A	C	2	12	14	0	1	15	0	0
3	32951637	.	G	A	13	17	30	0	1	31	0	0
3	32951778	.	C	T	15	21	36	0	2	38	0	0
3	32951891	.	T	C	21	15	36	0	1	37	0	0
3	33065643	.	T	A	4	4	8	0	0	8	0	0
3	33066155	.	C	T	1	6	7	0	7	14	0	0
3	33066241	.	C	T	0	1	1	0	12	13	0	0
3	33066292	.	C	T	11	4	15	0	2	17	0	0
3	33066629	.	C	T	0	3	3	0	8	11	0	0
3	33066714	.	A	T	2	7	9	0	0	9	0	0
3	33066804	.	T	C	12	0	12	0	6	18	0	0
3	33066809	.	C	G	11	6	17	0	0	17	0	0
3	33066969	.	T	C	7	0	7	0	4	11	0	0
3	33066976	.	T	C	7	3	10	0	1	11	0	0
3	33067337	.	A	G	5	3	8	0	0	8	0	0
3	33067340	.	A	G	4	3	7	0	0	8	1	0
3	33067376	.	G	A	6	6	12	0	1	13	0	0
3	33067438	.	G	A	2	1	3	0	0	3	0	0
3	33069274	.	A	C	4	5	9	0	0	9	0	0
3	33069596	.	G	A	3	11	14	0	1	15	0	0
3	33259407	.	G	A	1	2	3	0	0	3	0	0
3	33341072	.	T	A	3	2	5	0	2	7	0	0
3	33344470	.	T	A	7	9	16	0	1	17	0	0
3	33344636	.	A	T	1	5	6	0	0	6	0	0
3	33345482	.	G	A	0	1	1	0	2	3	0	0
3	33372555	.	G	C	0	6	6	0	3	9	0	0
3	33373540	.	A	C	6	8	14	0	0	14	0	0
3	33375645	.	C	A	6	4	10	0	0	10	0	0
3	33379072	.	C	T	6	5	11	0	3	14	0	0
3	33379440	.	A	C	1	2	3	0	1	4	0	0
3	33424010	.	C	T	1	9	10	0	10	20	0	0
3	33424420	.	G	A	21	15	36	0	5	41	0	0
3	33426513	.	G	A	9	4	13	0	1	14	0	0
3	33432379	.	A	C	4	0	4	0	5	9	0	0
3	33433319	.	T	C	0	0	0	0	2	2	0	0
3	33433621	.	G	A	4	7	11	0	0	11	0	0
3	33440693	.	C	T	5	5	10	0	0	10	0	0
3	33445039	.	A	T	2	5	7	0	0	7	0	0
3	33445090	.	G	C	0	2	2	0	7	9	0	0
3	33449405	.	C	T	3	1	4	0	0	4	0	0
3	33449554	.	G	A	0	3	3	0	5	8	0	0
3	33452168	.	C	T	16	26	42	0	1	43	0	0
3	33455809	.	G	A	0	13	13	0	9	22	0	0
3	33458803	.	C	T	16	19	35	0	0	35	0	0
3	33458911	.	A	T	14	18	32	0	1	33	0	0
3	33459394	.	T	A	3	3	6	0	0	6	0	0
3	33459489	.	C	T	5	5	10	0	1	11	0	0
3	33459517	.	C	T	3	9	12	0	0	12	0	0
3	33459532	.	G	A	6	9	15	0	0	15	0	0
3	33461366	.	C	T	0	19	19	0	9	28	0	0
3	33461646	.	C	T	0	12	12	0	10	22	0	0
3	33461796	.	A	T	16	9	25	0	0	25	0	0
3	33469614	.	T	A	6	1	7	0	0	7	0	0
3	33473131	.	C	T	0	6	6	0	10	16	0	0
3	33476589	.	T	C	3	6	9	0	1	10	0	0
3	33478690	.	G	A	10	3	13	0	0	13	0	0
3	33494089	.	A	T	9	9	18	0	1	19	0	0
3	33494091	.	G	C	9	10	19	0	0	19	0	0
3	33571231	.	C	T	1	3	4	0	1	5	0	0
3	33571264	.	T	C	0	0	0	0	3	3	0	0
3	33571294	.	C	T	0	2	2	0	1	3	0	0
3	33572206	.	G	C	4	0	4	0	3	7	0	0
3	33572298	.	G	A	4	3	7	0	0	7	0	0
3	33572335	.	C	T	2	2	4	0	0	4	0	0
3	33572464	.	T	C	2	0	2	0	3	5	0	0
3	33572473	.	A	G	3	3	6	0	0	6	0	0
3	33572512	.	C	A	3	2	5	0	0	5	0	0
3	33572553	.	T	G	1	3	4	0	0	4	0	0
3	33747527	.	A	G	1	0	1	0	0	1	0	0
3	33747563	.	A	G	5	0	5	0	2	7	0	0
3	33761597	.	C	T	11	7	18	0	0	18	0	0
3	33761705	.	G	A	0	10	10	0	10	20	0	0
3	33761834	.	G	A	6	15	21	0	1	22	0	0
3	33761835	.	A	T	5	16	21	0	1	22	0	0
3	33762068	.	A	G	8	11	19	0	6	25	0	0
3	33762278	.	A	G	9	8	17	0	1	18	0	0
3	33762310	.	C	A	7	11	18	0	0	18	0	0
3	33762408	.	T	A	4	15	19	0	1	20	0	0
3	33762480	.	C	T	9	7	16	0	0	16	0	0
3	33773294	.	A	G	17	17	34	0	3	37	0	0
3	33777317	.	T	G	7	7	14	0	2	16	0	0
3	33777425	.	A	G	16	17	33	0	1	34	0	0
3	33777807	.	A	G	2	0	2	0	0	2	0	0
3	33820291	.	T	C	2	5	7	0	1	8	0	0
3	33820312	.	T	C	3	0	3	0	2	5	0	0
3	33820568	.	C	T	2	2	4	0	0	4	0	0
3	33820580	.	A	G	1	2	3	0	0	3	0	0
3	33837287	.	G	A	7	2	9	0	0	9	0	0
3	33847104	.	A	G	1	1	2	0	0	2	0	0
3	33847191	.	T	C	2	2	4	0	1	5	0	0
3	33854972	.	A	G	0	1	1	0	0	1	0	0
3	33918611	.	A	G	4	3	7	0	0	7	0	0
3	33918675	.	T	G	5	4	9	0	1	10	0	0
3	33918775	.	A	G	4	6	10	0	0	10	0	0
3	33921663	.	A	C	5	13	18	0	0	18	0	0
3	33922269	.	A	G	4	8	12	1	1	14	0	0
3	33922359	.	G	A	7	11	18	0	1	19	0	0
3	33922413	.	T	A	5	9	14	0	0	14	0	0
3	33922415	.	G	A	5	9	14	0	0	14	0	0
3	33922471	.	T	C	6	5	11	0	1	12	0	0
3	33932170	.	C	T	0	3	3	0	3	6	0	0
3	33932628	.	G	A	6	5	11	0	0	11	0	0
3	33934848	.	T	C	3	3	6	0	0	6	0	0
3	33934849	.	G	C	3	3	6	0	0	6	0	0
3	33936783	.	G	C	3	3	6	0	0	6	0	0
3	34129941	.	C	T	0	15	15	0	15	30	0	0
3	34135868	.	C	T	5	0	5	0	1	6	0	0
3	34144353	.	A	T	1	2	3	0	0	3	0	0
3	34146338	.	C	T	3	3	6	0	1	7	0	0
3	34146882	.	G	T	6	9	15	0	0	15	0	0
3	34146955	.	A	G	2	4	6	0	0	6	0	0
3	34166288	.	C	A	2	8	10	0	1	11	0	0
3	34170913	.	G	A	17	10	27	0	1	28	0	0
3	34180332	.	A	G	4	2	6	0	0	6	0	0
3	34180386	.	G	A	7	5	12	0	0	12	0	0
3	34182164	.	C	T	7	3	10	0	0	10	0	0
3	34182306	.	G	C	7	9	16	0	0	16	0	0
3	34182376	.	A	C	4	7	11	0	0	11	0	0
3	34182386	.	G	A	0	6	6	0	4	10	0	0
3	34220359	.	A	T	1	2	3	0	0	3	0	0
3	34244901	.	G	C	9	6	15	0	2	17	0	0
3	34258965	.	G	A	11	15	26	0	2	28	0	0
3	34259013	.	C	G	17	17	34	0	4	38	0	0
3	34259060	.	C	T	22	19	41	0	1	42	0	0
3	34260325	.	T	C	8	14	22	0	0	22	0	0
3	34260808	.	T	C	10	11	21	0	0	21	0	0
3	34261204	.	T	C	5	5	10	0	1	11	0	0
3	34261354	.	A	G	16	14	30	0	0	30	0	0
3	34261795	.	G	A	9	11	20	0	0	20	0	0
3	34262290	.	C	T	16	7	23	0	0	23	0	0
3	34262421	.	C	A	10	5	15	0	0	15	0	0
3	34262639	.	G	A	19	9	28	0	2	30	0	0
3	34262823	.	A	T	11	7	18	0	2	20	0	0
3	34263007	.	C	T	0	8	8	0	7	15	0	0
3	34264140	.	A	T	4	1	5	0	0	5	0	0
3	34264634	.	T	A	3	4	7	0	1	8	0	0
3	34264657	.	A	T	2	5	7	0	0	7	0	0
3	34270546	.	A	G	5	5	10	0	0	10	0	0
3	34337389	.	A	G	2	2	4	0	1	5	0	0
3	34455822	.	T	C	3	0	3	0	2	5	0	0
3	34456131	.	G	T	1	2	3	0	0	3	0	0
3	34456538	.	A	G	4	5	9	0	0	9	0	0
3	34588493	.	A	G	1	3	4	0	0	4	0	0
3	34590350	.	A	C	2	2	4	0	0	4	0	0
3	34599655	.	T	G	2	2	4	0	0	4	0	0
3	34604202	.	A	G	1	4	5	0	0	5	0	0
3	34697461	.	G	A	3	8	11	0	1	12	0	0
3	34697514	.	T	C	3	0	3	0	10	13	0	0
3	34703722	.	T	G	3	4	7	0	1	8	0	0
3	34703731	.	G	C	3	5	8	0	0	8	0	0
3	34767112	.	G	T	30	28	58	0	3	61	0	0
3	34767662	.	T	G	29	36	65	0	2	67	0	0
3	34767669	.	G	A	29	36	65	0	0	65	0	0
3	34772941	.	T	G	18	25	43	0	0	43	0	0
3	34775942	.	G	A	22	15	37	0	4	41	0	0
3	34776115	.	T	G	0	1	1	0	1	2	0	0
3	34776133	.	G	C	1	2	3	0	0	3	0	0
3	34776151	.	C	A	1	2	3	0	0	3	0	0
3	34781074	.	A	G	20	27	47	0	2	49	0	0
3	34781095	.	C	T	20	21	41	0	2	43	0	0
3	34781448	.	T	C	8	7	15	0	0	15	0	0
3	34781586	.	T	C	0	0	0	0	2	2	0	0
3	34783970	.	G	A	4	8	12	0	0	12	0	0
3	34783982	.	A	G	4	9	13	0	1	14	0	0
3	34801034	.	T	C	6	2	8	0	0	8	0	0
3	34804427	.	A	G	8	11	19	0	5	24	0	0
3	34814839	.	A	G	3	3	6	0	0	6	0	0
3	34822049	.	C	T	14	11	25	0	2	27	0	0
3	34822169	.	C	T	10	14	24	0	2	26	0	0
3	34822214	.	T	C	8	13	21	0	1	22	0	0
3	34919892	.	C	T	9	8	17	0	0	17	0	0
3	34977497	.	A	G	5	1	6	0	3	9	0	0
3	34977508	.	A	G	3	0	3	0	1	4	0	0
3	34981394	.	T	C	4	5	9	0	0	9	0	0
3	34994140	.	C	T	33	28	61	0	2	63	0	0
3	34994750	.	A	G	17	15	32	0	1	33	0	0
3	35170112	.	T	C	6	2	8	0	2	10	0	0
3	35225160	.	A	G	13	0	13	0	14	27	0	0
3	35225202	.	C	T	19	14	33	0	0	33	0	0
3	35248470	.	T	C	11	9	20	0	0	20	0	0
3	35248492	.	T	A	12	10	22	0	0	22	0	0
3	35249369	.	T	C	17	15	32	0	0	32	0	0
3	35249535	.	T	C	14	19	33	0	1	34	0	0
3	35250145	.	A	T	19	15	34	0	1	35	0	0
3	35250188	.	A	G	6	14	20	0	2	22	0	0
3	35264406	.	T	G	24	15	39	0	0	39	0	0
3	35264460	.	C	T	23	23	46	0	2	48	0	0
3	35264744	.	T	A	20	14	34	0	1	35	0	0
3	35264951	.	G	A	15	10	25	0	3	28	0	0
3	35265350	.	T	C	17	14	31	0	2	33	0	0
3	35265419	.	T	G	19	18	37	0	3	40	0	0
3	35265654	.	G	A	1	28	29	0	26	55	0	0
3	35266006	.	G	A	4	2	6	0	0	6	0	0
3	35298531	.	G	T	1	4	5	0	0	5	0	0
3	35298725	.	T	A	5	3	8	0	1	9	0	0
3	35374719	.	C	T	10	14	24	0	0	24	0	0
3	35375112	.	G	A	21	9	30	0	0	30	0	0
3	35375162	.	T	A	19	8	27	0	3	30	0	0
3	35375279	.	A	T	13	9	22	0	2	24	0	0
3	35375306	.	T	C	16	10	26	0	0	26	0	0
3	35375448	.	T	G	21	0	21	0	15	36	0	0
3	35375638	.	T	A	24	16	40	0	1	41	0	0
3	35406475	.	G	A	2	6	8	0	0	8	0	0
3	35406648	.	G	T	0	2	2	0	1	3	0	0
3	35418047	.	A	G	5	6	11	0	1	12	0	0
3	35419683	.	A	T	8	14	22	0	2	24	0	0
3	35420588	.	A	G	8	7	15	0	0	15	0	0
3	35420604	.	C	T	4	7	11	0	1	12	0	0
3	35420733	.	A	T	10	4	14	0	1	15	0	0
3	35514786	.	C	T	4	6	10	0	0	10	0	0
3	35514849	.	C	A	2	5	7	0	1	8	0	0
3	35515053	.	G	T	6	2	8	0	0	8	0	0
3	35515103	.	G	A	2	2	4	0	0	4	0	0
3	35515179	.	T	C	5	5	10	0	0	10	0	0
3	35515206	.	G	A	3	5	8	0	0	8	0	0
3	35517999	.	A	C	7	5	12	0	1	13	0	0
3	35518036	.	C	G	4	7	11	0	0	11	0	0
3	35518962	.	C	A	1	2	3	0	0	3	0	0
3	35523824	.	C	G	9	4	13	0	1	14	0	0
3	35527024	.	T	C	3	2	5	0	0	5	0	0
3	35529040	.	T	C	11	11	22	0	0	22	0	0
3	35530787	.	C	T	4	9	13	0	0	13	0	0
3	35531018	.	T	C	8	6	14	0	0	14	0	0
3	35531028	.	T	C	12	5	17	0	2	19	0	0
3	35531328	.	G	A	0	6	6	0	11	17	0	0
3	35531329	.	A	T	11	6	17	0	0	17	0	0
3	35531671	.	A	T	17	11	28	0	1	29	0	0
3	35531791	.	A	G	16	1	17	0	14	31	0	0
3	35531866	.	T	A	14	19	33	0	0	33	0	0
3	35531985	.	G	A	18	24	42	0	4	46	0	0
3	35532074	.	A	T	17	17	34	0	0	34	0	0
3	35532452	.	A	T	16	22	38	0	2	40	0	0
3	35532634	.	A	G	18	0	18	0	21	39	0	0
3	35532665	.	C	T	16	15	31	0	0	31	0	0
3	35532736	.	A	C	11	13	24	0	0	24	0	0
3	35535695	.	A	C	1	2	3	0	0	3	0	0
3	35535702	.	G	T	1	2	3	0	0	3	0	0
3	35536115	.	C	G	11	14	25	0	1	26	0	0
3	35536269	.	G	A	0	4	4	0	0	4	0	0
3	35541273	.	A	G	35	19	54	0	1	55	0	0
3	35548780	.	T	C	5	3	8	0	0	8	0	0
3	35548822	.	C	A	3	4	7	0	0	7	0	0
3	35549002	.	G	A	7	2	9	0	0	9	0	0
3	35549223	.	A	T	2	3	5	0	0	5	0	0
3	35551047	.	A	T	15	19	34	0	0	34	0	0
3	35551190	.	C	T	0	9	9	0	15	24	0	0
3	35589548	.	C	T	23	15	38	0	2	40	0	0
3	35589881	.	T	C	18	25	43	0	4	47	0	0
3	35589908	.	A	G	27	23	50	0	1	51	0	0
3	35589918	.	G	A	25	24	49	0	0	49	0	0
3	35590270	.	T	C	22	0	22	0	32	54	0	0
3	35602007	.	A	C	16	0	16	0	22	38	0	0
3	35602047	.	A	G	25	20	45	0	1	46	0	0
3	35602153	.	A	G	11	22	33	0	0	33	0	0
3	35602154	.	T	A	11	22	33	0	0	33	0	0
3	35621515	.	T	G	3	0	3	0	1	4	0	0
3	35623614	.	A	G	2	0	2	0	0	2	0	0
3	35634953	.	A	G	6	9	15	0	0	15	0	0
3	35635039	.	C	T	6	8	14	0	1	15	0	0
3	35636081	.	A	G	4	2	6	0	4	10	0	0
3	35636095	.	A	G	6	2	8	0	1	9	0	0
3	35636188	.	A	G	7	0	7	0	5	12	0	0
3	35637505	.	A	G	3	2	5	0	0	5	0	0
3	35637535	.	A	G	2	0	2	0	3	5	0	0
3	35638008	.	T	A	16	9	25	0	0	25	0	0
3	35638119	.	A	C	14	15	29	0	3	32	0	0
3	35638201	.	A	G	17	14	31	0	1	32	0	0
3	35638240	.	C	T	13	17	30	0	1	31	0	0
3	35638366	.	T	C	8	7	15	0	0	15	0	0
3	35638450	.	T	A	5	5	10	0	2	12	0	0
3	35638513	.	G	A	7	10	17	0	0	17	0	0
3	35638908	.	C	T	0	19	19	0	18	37	0	0
3	35638986	.	C	A	17	16	33	0	1	34	0	0
3	35639020	.	A	G	19	14	33	0	0	33	0	0
3	35639021	.	G	A	19	14	33	0	0	33	0	0
3	35639194	.	T	C	17	17	34	0	1	35	0	0
3	35639621	.	A	C	13	14	27	0	1	28	0	0
3	35639817	.	T	A	5	6	11	0	1	12	0	0
3	35639862	.	G	T	10	6	16	0	0	16	0	0
3	35639884	.	T	C	13	0	13	0	5	18	0	0
3	35639958	.	T	C	10	1	11	0	0	11	0	0
3	35640042	.	A	G	6	8	14	1	2	17	0	0
3	35640122	.	G	T	8	10	18	0	1	19	0	0
3	35640313	.	A	G	12	6	18	0	2	20	0	0
3	35640331	.	G	A	11	4	15	0	0	15	0	0
3	35640441	.	C	A	14	4	18	2	1	21	0	0
3	35640588	.	A	G	7	3	10	0	0	10	0	0
3	35640625	.	C	T	11	8	19	0	1	20	0	0
3	35640784	.	T	C	13	11	24	0	0	24	0	0
3	35641173	.	C	T	9	2	11	0	0	11	0	0
3	35641371	.	C	T	0	12	12	0	15	27	0	0
3	35641382	.	G	A	13	14	27	0	0	27	0	0
3	35641595	.	A	T	8	13	21	0	0	21	0	0
3	35641785	.	C	T	0	9	9	0	2	11	0	0
3	35642012	.	A	T	4	11	15	0	0	15	0	0
3	35642072	.	A	G	8	11	19	0	0	19	0	0
3	35642242	.	T	C	5	0	5	0	5	10	0	0
3	35642462	.	T	C	11	0	11	0	7	18	0	0
3	35643320	.	G	A	3	3	6	0	0	6	0	0
3	35643540	.	G	A	8	5	13	0	1	14	0	0
3	35643546	.	A	T	7	5	12	0	1	13	0	0
3	35645380	.	T	C	8	0	8	0	11	19	0	0
3	35645411	.	G	A	6	5	11	0	0	11	0	0
3	35645661	.	T	G	9	10	19	0	2	21	0	0
3	35646025	.	G	T	4	9	13	0	0	13	0	0
3	35646160	.	G	T	7	4	11	0	0	11	0	0
3	35646611	.	T	G	5	4	9	0	0	9	0	0
3	35647181	.	A	G	2	13	15	0	0	15	0	0
3	35647321	.	G	A	5	3	8	0	1	9	0	0
3	35647882	.	G	A	1	0	1	0	0	1	0	0
3	35647975	.	A	G	1	6	7	0	0	7	0	0
3	35800614	.	C	G	1	3	4	0	0	4	0	0
3	35800738	.	T	C	5	4	9	0	0	9	0	0
3	35800758	.	T	G	5	1	6	0	2	8	0	0
3	35800936	.	A	C	2	4	6	0	0	6	0	0
3	35831029	.	T	C	1	1	2	0	0	2	0	0
3	35831167	.	T	C	5	2	7	0	0	7	0	0
3	35840264	.	A	G	1	0	1	0	3	4	0	0
3	35840267	.	T	A	1	2	3	0	1	4	0	0
3	35845774	.	T	C	2	2	4	0	0	4	0	0
3	35845805	.	A	G	2	5	7	0	2	9	0	0
3	35846120	.	C	G	5	4	9	0	0	9	0	0
3	35846343	.	C	G	6	2	8	0	1	9	0	0
3	35846440	.	G	A	3	3	6	0	0	6	0	0
3	35846823	.	A	G	1	10	11	0	1	12	0	0
3	35850254	.	G	A	6	3	9	0	1	10	0	0
3	35850364	.	A	G	4	5	9	0	0	9	0	0
3	35850380	.	C	T	5	3	8	0	0	8	0	0
3	35864419	.	G	A	1	1	2	0	0	2	0	0
3	36023342	.	T	G	14	22	36	0	0	36	0	0
3	36023455	.	A	G	9	14	23	0	1	24	0	0
3	36023465	.	A	G	11	15	26	0	1	27	0	0
3	36026294	.	C	G	0	15	15	0	7	22	0	0
3	36032241	.	G	A	2	1	3	0	1	4	0	0
3	36038631	.	G	A	13	12	25	0	3	28	0	0
3	36040863	.	A	G	6	3	9	0	0	9	0	0
3	36041017	.	A	C	10	7	17	0	0	17	0	0
3	36125256	.	C	G	0	3	3	0	2	5	0	0
3	36127108	.	G	A	1	2	3	0	0	3	0	0
3	36129646	.	T	G	1	2	3	0	0	3	0	0
3	36131883	.	T	A	1	3	4	0	0	4	0	0
3	36132740	.	T	C	9	8	17	0	0	17	0	0
3	36135309	.	G	A	2	2	4	0	0	4	0	0
3	36135481	.	A	G	3	4	7	0	0	7	0	0
3	36136184	.	T	A	2	2	4	0	0	4	0	0
3	36136186	.	A	T	1	2	3	0	1	4	0	0
3	36136290	.	G	C	1	4	5	0	0	5	0	0
3	36136405	.	A	T	5	2	7	0	0	7	0	0
3	36136609	.	T	C	6	5	11	0	0	11	0	0
3	36136855	.	C	T	4	2	6	0	0	6	0	0
3	36143917	.	C	T	0	2	2	0	4	6	0	0
3	36167286	.	T	C	3	5	8	0	0	8	0	0
3	36173633	.	T	C	11	16	27	0	0	27	0	0
3	36174175	.	C	A	17	12	29	0	0	29	0	0
3	36174248	.	C	G	15	13	28	0	0	28	0	0
3	36174276	.	T	C	13	0	13	0	9	22	0	0
3	36184806	.	A	G	7	5	12	0	2	14	0	0
3	36188400	.	A	G	3	1	4	0	0	4	0	0
3	36210030	.	G	A	1	4	5	0	0	5	0	0
3	36210074	.	C	T	3	2	5	0	1	6	0	0
3	36228235	.	A	G	2	0	2	0	2	4	0	0
3	36228319	.	T	G	3	0	3	0	0	3	0	0
3	36229823	.	G	A	6	3	9	0	0	9	0	0
3	36229886	.	A	T	4	1	5	0	0	5	0	0
3	36232331	.	C	T	5	6	11	0	0	11	0	0
3	36241839	.	T	C	1	1	2	0	0	2	0	0
3	36241938	.	T	C	4	0	4	0	3	7	0	0
3	36242239	.	C	T	0	3	3	0	3	6	0	0
3	36249172	.	C	T	4	8	12	0	1	13	0	0
3	36249419	.	G	A	19	6	25	0	1	26	0	0
3	36249476	.	T	A	23	21	44	0	0	44	0	0
3	36249516	.	T	A	15	20	35	0	3	38	0	0
3	36249518	.	A	C	16	19	35	0	3	38	0	0
3	36255436	.	A	G	3	5	8	0	0	8	0	0
3	36259855	.	T	C	12	12	24	0	2	26	0	0
3	36262799	.	A	C	20	0	20	0	22	42	0	0
3	36263099	.	T	C	15	2	17	0	18	35	0	0
3	36263151	.	A	G	18	21	39	0	3	42	0	0
3	36263163	.	C	T	14	24	38	0	2	40	0	0
3	36263464	.	C	A	18	14	32	0	0	32	0	0
3	36263557	.	A	G	12	23	35	0	3	38	0	0
3	36263563	.	T	A	11	23	34	0	2	36	0	0
3	36263596	.	T	C	8	1	9	0	14	23	0	0
3	36263666	.	T	C	9	0	9	0	7	16	0	0
3	36263824	.	T	C	24	26	50	0	0	50	0	0
3	36263895	.	A	T	19	22	41	0	0	41	0	0
3	36264028	.	T	C	19	0	19	0	18	37	0	0
3	36264204	.	T	G	9	17	26	0	0	26	0	0
3	36264217	.	A	C	12	15	27	0	1	28	0	0
3	36264248	.	T	C	16	9	25	0	0	25	0	0
3	36264498	.	G	A	10	11	21	0	2	23	0	0
3	36264582	.	C	G	12	9	21	0	1	22	0	0
3	36264822	.	C	A	5	4	9	0	0	9	0	0
3	36265895	.	C	T	0	3	3	0	4	7	0	0
3	36266137	.	T	A	1	1	2	0	0	2	0	0
3	36266173	.	A	G	7	3	10	0	1	11	0	0
3	36268616	.	A	G	9	7	16	0	0	16	0	0
3	36291213	.	A	G	4	0	4	0	2	6	0	0
3	36292481	.	G	C	0	3	3	0	1	4	0	0
3	36292657	.	T	C	1	3	4	0	0	4	0	0
3	36293950	.	C	T	7	1	8	0	0	8	0	0
3	36293964	.	C	T	7	1	8	0	0	8	0	0
3	36305854	.	A	G	17	24	41	0	3	44	0	0
3	36305860	.	A	G	19	0	19	0	25	44	0	0
3	36305971	.	T	A	12	13	25	0	1	26	0	0
3	36322947	.	C	T	1	2	3	0	0	3	0	0
3	36323001	.	T	C	2	3	5	0	0	5	0	0
3	36323397	.	C	A	2	2	4	0	0	4	0	0
3	36325599	.	G	C	3	2	5	0	0	5	0	0
3	36325726	.	C	T	6	2	8	0	0	8	0	0
3	36325802	.	A	G	3	0	3	0	6	9	0	0
3	36326139	.	T	G	6	3	9	0	0	9	0	0
3	36326270	.	A	G	1	3	4	0	0	4	0	0
3	36326286	.	A	G	2	4	6	0	0	6	0	0
3	36326370	.	A	G	2	5	7	0	0	7	0	0
3	36326482	.	T	A	4	2	6	0	0	6	0	0
3	36326490	.	A	T	3	2	5	0	1	6	0	0
3	36326681	.	T	C	7	3	10	0	0	10	0	0
3	36326685	.	T	A	7	3	10	0	1	11	0	0
3	36326839	.	T	A	7	4	11	0	0	11	0	0
3	36327060	.	G	A	0	4	4	0	2	6	0	0
3	36327061	.	A	C	2	4	6	0	0	6	0	0
3	36327872	.	G	A	5	6	11	0	1	12	0	0
3	36327906	.	G	T	3	4	7	0	1	8	0	0
3	36327909	.	G	T	0	4	4	0	4	8	0	0
3	36328083	.	G	T	3	2	5	0	0	5	0	0
3	36328204	.	C	A	7	3	10	0	4	14	0	0
3	36328218	.	G	A	9	9	18	0	0	18	0	0
3	36328339	.	G	A	2	5	7	0	0	7	0	0
3	36328390	.	A	T	0	4	4	0	0	4	0	0
3	36328414	.	T	A	0	2	2	0	1	3	0	0
3	36402930	.	T	C	3	0	3	0	2	5	0	0
3	36407283	.	C	A	1	3	4	0	0	4	0	0
3	36407604	.	A	G	1	3	4	0	0	4	0	0
3	36409656	.	C	T	2	2	4	0	1	5	0	0
3	36409877	.	C	T	3	4	7	0	0	7	0	0
3	36410038	.	T	A	1	2	3	0	0	3	0	0
3	36410157	.	A	G	1	4	5	0	0	5	0	0
3	36410172	.	A	G	1	4	5	0	0	5	0	0
3	36428612	.	T	A	18	23	41	0	6	47	0	0
3	36428620	.	T	A	15	25	40	0	5	45	0	0
3	36431380	.	T	C	8	13	21	0	0	21	0	0
3	36441465	.	G	A	4	4	8	0	0	8	0	0
3	36441484	.	T	C	4	6	10	0	1	11	0	0
3	36442021	.	T	C	4	9	13	0	0	13	0	0
3	36442029	.	A	G	2	7	9	0	0	9	0	0
3	36442071	.	A	G	1	3	4	0	0	4	0	0
3	36442551	.	C	T	0	12	12	0	12	24	0	0
3	36442661	.	T	G	7	9	16	0	1	17	0	0
3	36442726	.	A	G	10	14	24	0	1	25	0	0
3	36443189	.	G	A	1	1	2	0	1	3	0	0
3	37053166	.	A	G	1	2	3	0	1	4	0	0
3	37104617	.	A	G	3	3	6	0	0	6	0	0
3	37107093	.	C	T	4	2	6	0	0	6	0	0
3	37558810	.	G	A	17	4	21	0	0	21	0	0
3	37559334	.	A	T	29	25	54	0	2	56	0	0
3	37559905	.	A	C	17	25	42	0	2	44	0	0
3	37564769	.	G	A	11	15	26	0	2	28	0	0
3	37649598	.	G	C	1	1	2	0	0	2	0	0
3	37660307	.	G	A	9	9	18	0	0	18	0	0
3	37664117	.	A	T	12	12	24	0	0	24	0	0
3	37664635	.	A	G	15	13	28	0	1	29	0	0
3	37665855	.	G	A	24	13	37	0	1	38	0	0
3	37666774	.	C	T	0	12	12	0	12	24	0	0
3	37667562	.	C	T	0	20	20	0	11	31	0	0
3	37667608	.	G	C	8	15	23	0	0	23	0	0
3	37667646	.	C	T	10	10	20	0	1	21	0	0
3	37667952	.	C	T	0	11	11	0	9	20	0	0
3	37668319	.	A	G	6	4	10	0	0	10	0	0
3	37668370	.	T	C	2	2	4	0	0	4	0	0
3	37668578	.	T	A	7	5	12	0	0	12	0	0
3	37725453	.	A	G	1	0	1	0	2	3	0	0
3	37726111	.	C	T	1	2	3	0	0	3	0	0
3	37727784	.	T	C	3	2	5	0	0	5	0	0
3	37737680	.	C	A	5	6	11	0	0	11	0	0
3	37737735	.	T	G	1	0	1	0	4	5	0	0
3	37737736	.	C	T	1	2	3	0	2	5	0	0
3	37737852	.	A	G	0	1	1	0	0	1	0	0
3	37738024	.	A	G	6	5	11	0	0	11	0	0
3	37738050	.	C	G	7	4	11	0	0	11	0	0
3	37738089	.	G	A	7	9	16	0	0	16	0	0
3	37742116	.	A	C	0	1	1	0	0	1	0	0
3	37742152	.	T	C	3	2	5	0	0	5	0	0
3	37742284	.	T	G	6	3	9	0	1	10	0	0
3	37742338	.	C	G	5	4	9	0	0	9	0	0
3	37742363	.	C	T	3	2	5	0	1	6	0	0
3	37776713	.	T	C	6	3	9	0	0	9	0	0
3	37777590	.	C	T	2	3	5	0	0	5	0	0
3	37777811	.	C	T	0	7	7	0	7	14	0	0
3	37781162	.	A	G	2	2	4	0	1	5	0	0
3	37788401	.	T	C	2	2	4	1	0	5	0	0
3	37827822	.	C	T	2	4	6	0	0	6	0	0
3	37827948	.	C	T	3	3	6	0	0	6	0	0
3	38505629	.	A	G	7	4	11	0	0	11	0	0
3	38614366	.	C	T	3	1	4	0	0	4	0	0
3	38614426	.	A	G	5	0	5	0	1	6	0	0
3	38614562	.	C	T	1	1	2	0	0	2	0	0
3	38624737	.	A	G	3	0	3	0	3	6	0	0
3	38624823	.	G	A	17	7	24	0	0	24	0	0
3	38625098	.	A	C	14	8	22	0	0	22	0	0
3	38625497	.	G	T	12	3	15	0	1	16	0	0
3	38625559	.	T	C	12	3	15	0	1	17	1	0
3	38625605	.	G	A	13	11	24	0	1	25	0	0
3	38625751	.	A	C	8	8	16	0	0	16	0	0
3	38625901	.	T	G	8	10	18	0	0	18	0	0
3	38649991	.	A	T	9	13	22	0	2	24	0	0
3	38650440	.	T	C	6	7	13	0	3	17	1	0
3	38650462	.	T	C	6	6	12	0	0	12	0	0
3	38763153	.	T	A	7	8	15	0	1	16	0	0
3	38763391	.	A	G	7	7	14	0	0	14	0	0
3	38763449	.	C	T	6	5	11	0	1	12	0	0
3	38763505	.	G	A	3	4	7	0	0	7	0	0
3	38763527	.	C	T	0	3	3	0	5	8	0	0
3	38763564	.	C	A	6	5	11	0	0	11	0	0
3	38763700	.	G	A	2	8	10	0	0	10	0	0
3	38764227	.	C	T	2	4	6	0	1	7	0	0
3	38764229	.	G	A	2	5	7	0	0	7	0	0
3	38764738	.	A	C	9	0	9	0	4	13	0	0
3	38765149	.	A	T	3	1	4	0	1	5	0	0
3	38766207	.	C	T	0	6	6	0	8	14	0	0
3	38766395	.	G	A	2	2	4	0	0	4	0	0
3	38766507	.	G	A	1	3	4	0	0	4	0	0
3	38766813	.	A	G	2	3	5	0	0	5	0	0
3	38793631	.	C	T	1	2	3	0	0	3	0	0
3	38793674	.	A	G	1	2	3	0	0	3	0	0
3	38793729	.	G	T	0	2	2	0	2	4	0	0
3	38794422	.	G	C	2	2	4	0	2	6	0	0
3	38858649	.	A	G	2	5	7	0	0	7	0	0
3	38858673	.	C	A	3	3	6	0	1	7	0	0
3	38858908	.	G	A	1	2	3	0	2	5	0	0
3	38858949	.	G	C	5	4	9	0	0	9	0	0
3	38859066	.	G	A	3	3	6	0	0	6	0	0
3	38859126	.	A	T	3	2	5	0	0	5	0	0
3	39181560	.	A	C	3	2	5	0	0	5	0	0
3	39181635	.	C	T	4	4	8	0	0	8	0	0
3	39181823	.	A	G	2	3	5	0	0	5	0	0
3	39181849	.	A	G	4	5	9	0	1	10	0	0
3	39184156	.	A	G	3	4	7	0	1	8	0	0
3	39184180	.	C	T	3	4	7	0	0	7	0	0
3	39184710	.	A	G	3	3	6	0	1	7	0	0
3	39189208	.	G	T	4	2	6	0	0	6	0	0
3	39189212	.	A	G	4	2	6	0	0	6	0	0
3	39238579	.	C	A	10	6	16	0	1	17	0	0
3	39238580	.	C	A	11	6	17	0	0	17	0	0
3	39239380	.	A	G	9	6	15	0	0	15	0	0
3	39241350	.	G	T	3	2	5	0	1	6	0	0
3	39248863	.	A	G	4	11	15	0	0	15	0	0
3	39251020	.	G	T	0	3	3	0	0	3	0	0
3	39251341	.	T	C	1	0	1	0	0	1	0	0
3	39259624	.	T	C	9	0	9	0	6	15	0	0
3	39260767	.	A	T	1	2	3	0	0	3	0	0
3	39261182	.	C	A	0	5	5	0	2	7	0	0
3	39261672	.	G	A	0	4	4	0	0	4	0	0
3	39261709	.	T	C	1	0	1	0	3	4	0	0
3	39261718	.	C	T	1	2	3	0	1	4	0	0
3	39262338	.	C	G	2	2	4	0	0	4	0	0
3	39262694	.	A	G	1	2	3	0	0	3	0	0
3	39262695	.	T	A	1	2	3	0	0	3	0	0
3	39262786	.	G	A	2	2	4	0	0	4	0	0
3	39263444	.	T	G	1	2	3	0	0	3	0	0
3	39313310	.	A	G	9	7	16	0	2	18	0	0
3	39313625	.	T	C	7	12	19	0	1	20	0	0
3	39314028	.	C	T	17	18	35	0	1	36	0	0
3	39314101	.	T	C	13	7	20	0	1	21	0	0
3	39314146	.	C	G	9	12	21	0	0	21	0	0
3	39314260	.	A	G	8	6	14	0	2	16	0	0
3	39314502	.	G	C	7	10	17	0	2	19	0	0
3	39314631	.	C	T	1	9	10	0	8	18	0	0
3	39314677	.	C	T	5	7	12	0	0	12	0	0
3	39315154	.	C	A	5	8	13	0	0	13	0	0
3	39315169	.	C	G	5	8	13	0	0	13	0	0
3	39315191	.	C	G	1	6	7	0	0	7	0	0
3	39315229	.	A	T	1	2	3	0	1	4	0	0
3	39315292	.	A	G	2	4	6	0	0	6	0	0
3	39315728	.	C	T	5	2	7	0	0	7	0	0
3	39315737	.	T	C	5	2	7	0	0	7	0	0
3	39315816	.	A	G	6	5	11	0	0	11	0	0
3	39315874	.	C	A	6	7	13	0	2	15	0	0
3	39315876	.	C	T	8	7	15	0	0	15	0	0
3	39315937	.	A	C	4	0	4	0	4	8	0	0
3	39316037	.	T	C	3	4	7	0	1	8	0	0
3	39316062	.	G	A	6	6	12	0	0	12	0	0
3	39316167	.	A	G	2	3	5	0	0	5	0	0
3	39316570	.	G	A	2	2	4	0	0	4	0	0
3	39316846	.	T	C	12	6	18	0	2	20	0	0
3	39316906	.	C	A	14	7	21	0	0	21	0	0
3	39316912	.	G	A	12	7	19	0	1	20	0	0
3	39316996	.	A	G	12	9	21	0	0	22	1	0
3	39317215	.	C	G	4	3	7	0	1	8	0	0
3	39317279	.	C	T	2	4	6	0	0	6	0	0
3	39317310	.	T	C	4	4	8	0	0	8	0	0
3	39328095	.	G	C	3	4	7	0	0	7	0	0
3	39330407	.	T	C	2	0	2	0	3	5	0	0
3	39348533	.	G	A	5	4	9	0	0	9	0	0
3	39348914	.	G	A	4	3	7	0	0	7	0	0
3	39454708	.	C	G	2	2	4	0	0	4	0	0
3	39560664	.	T	C	0	3	3	0	0	3	0	0
3	39568368	.	T	G	6	2	8	0	0	8	0	0
3	39568856	.	A	G	13	19	32	0	0	32	0	0
3	39574883	.	C	A	17	20	37	0	1	38	0	0
3	39574961	.	G	A	29	34	63	0	3	66	0	0
3	39576621	.	T	G	26	3	29	0	29	58	0	0
3	39576663	.	A	G	29	44	73	0	3	76	0	0
3	39576866	.	T	C	25	15	40	0	2	42	0	0
3	39579616	.	C	A	1	2	3	0	0	3	0	0
3	39579660	.	G	T	0	1	1	0	0	1	0	0
3	39580908	.	T	C	1	1	2	0	0	2	0	0
3	39586473	.	A	T	1	2	3	0	0	3	0	0
3	39592640	.	T	G	0	1	1	0	0	1	0	0
3	39592797	.	C	T	6	5	11	0	1	12	0	0
3	39592800	.	G	C	0	4	4	0	9	13	0	0
3	39606220	.	C	T	2	3	5	0	0	5	0	0
3	39612261	.	T	A	17	9	26	0	2	28	0	0
3	39612430	.	T	C	9	9	18	0	0	18	0	0
3	39612579	.	G	C	14	13	27	0	1	28	0	0
3	39612715	.	A	T	9	6	15	0	0	15	0	0
3	39613024	.	T	C	8	15	23	0	1	24	0	0
3	39631505	.	T	C	7	7	14	0	0	14	0	0
3	39634053	.	T	A	1	1	2	0	0	2	0	0
3	39686559	.	T	C	2	2	4	0	0	4	0	0
3	39686776	.	T	A	2	3	5	0	1	6	0	0
3	39686807	.	A	T	2	2	4	0	0	4	0	0
3	39687418	.	C	T	2	4	6	0	0	6	0	0
3	39688852	.	A	C	5	2	7	0	0	7	0	0
3	39688892	.	T	C	2	3	5	0	0	5	0	0
3	39688906	.	C	T	1	4	5	0	0	5	0	0
3	39691978	.	C	G	3	3	6	0	1	7	0	0
3	39692008	.	G	T	4	2	6	0	1	7	0	0
3	39692165	.	A	T	4	5	9	0	3	12	0	0
3	39692196	.	C	T	0	9	9	0	7	16	0	0
3	39692206	.	C	T	5	8	13	0	3	16	0	0
3	39692235	.	C	A	4	11	15	0	2	17	0	0
3	39692265	.	G	A	10	6	16	0	0	16	0	0
3	39692307	.	A	G	10	3	13	0	0	13	0	0
3	39695744	.	T	C	1	0	1	0	0	1	0	0
3	39878822	.	T	C	1	3	4	0	0	4	0	0
3	39884348	.	G	A	0	3	3	0	2	5	0	0
3	39919127	.	G	A	2	1	3	0	0	3	0	0
3	39923512	.	G	A	0	1	1	0	1	2	0	0
3	39945696	.	A	G	1	1	2	0	0	2	0	0
3	39949650	.	G	A	0	2	2	0	3	5	0	0
3	39950276	.	A	C	6	9	15	0	3	18	0	0
3	39950340	.	C	T	10	11	21	0	1	22	0	0
3	39950414	.	T	C	12	12	24	0	1	25	0	0
3	39950954	.	T	C	8	8	16	0	0	16	0	0
3	39951124	.	C	T	7	3	10	0	1	11	0	0
3	39951216	.	T	C	14	7	21	0	0	21	0	0
3	39951703	.	A	T	10	6	16	0	0	16	0	0
3	39952025	.	T	C	10	5	15	0	0	15	0	0
3	39952272	.	A	G	8	12	20	0	0	20	0	0
3	39952273	.	A	T	8	12	20	0	0	20	0	0
3	39958680	.	C	T	3	8	11	0	0	11	0	0
3	39958729	.	T	A	2	4	6	0	2	8	0	0
3	39959679	.	A	C	5	7	12	0	1	13	0	0
3	39960535	.	G	C	0	2	2	0	0	2	0	0
3	39962981	.	T	C	7	9	16	0	0	16	0	0
3	39963053	.	T	C	9	11	20	0	1	21	0	0
3	39963089	.	A	G	2	9	11	0	1	12	0	0
3	39963128	.	G	A	1	2	3	0	0	3	0	0
3	39970555	.	G	A	8	7	15	0	2	17	0	0
3	39970568	.	C	A	14	4	18	0	1	19	0	0
3	39970641	.	T	G	9	9	18	0	0	18	0	0
3	39971373	.	T	C	5	3	8	0	0	8	0	0
3	39971447	.	T	C	7	3	10	0	0	10	0	0
3	39971470	.	T	C	7	3	10	0	0	10	0	0
3	39971499	.	T	C	7	4	11	0	1	12	0	0
3	39971592	.	T	C	3	8	11	0	0	11	0	0
3	39971604	.	T	C	11	3	14	0	0	14	0	0
3	39971894	.	T	C	6	7	13	0	0	13	0	0
3	39972055	.	T	C	3	2	5	0	2	7	0	0
3	39975467	.	T	C	6	0	6	0	4	10	0	0
3	39982019	.	C	T	4	7	11	0	0	11	0	0
3	39982198	.	A	T	2	0	2	0	0	2	0	0
3	39982423	.	T	C	1	0	1	0	0	1	0	0
3	40207086	.	T	C	18	17	35	0	1	36	0	0
3	40256334	.	T	C	2	3	5	0	0	5	0	0
3	40256418	.	C	T	4	4	8	0	0	8	0	0
3	40257357	.	A	G	3	0	3	0	7	10	0	0
3	40258465	.	T	C	1	0	1	0	0	1	0	0
3	40278023	.	C	T	0	20	20	0	13	33	0	0
3	40278180	.	T	C	8	0	8	0	5	13	0	0
3	40280034	.	T	C	2	3	5	0	0	5	0	0
3	40284375	.	T	C	12	0	12	0	6	18	0	0
3	40284447	.	T	A	11	8	19	0	1	20	0	0
3	40284860	.	G	T	10	9	19	0	2	21	0	0
3	40284982	.	T	C	6	2	8	0	2	10	0	0
3	40287185	.	G	C	1	7	8	0	14	22	0	0
3	40287188	.	G	A	11	8	19	0	0	19	0	0
3	40287227	.	C	T	1	3	4	0	0	4	0	0
3	40287691	.	T	C	4	5	9	0	0	9	0	0
3	40287712	.	T	A	4	7	11	0	1	12	0	0
3	40290123	.	T	C	2	11	13	0	0	13	0	0
3	40290138	.	A	G	2	12	14	0	0	14	0	0
3	40294179	.	G	A	1	4	5	0	0	5	0	0
3	40294260	.	A	T	10	10	20	0	0	20	0	0
3	40294511	.	G	C	6	14	20	0	1	21	0	0
3	40296839	.	C	T	0	6	6	0	1	7	0	0
3	40297428	.	G	A	21	20	41	0	2	43	0	0
3	40297479	.	C	T	5	7	12	0	0	12	0	0
3	40299995	.	G	A	6	7	13	0	0	13	0	0
3	40301233	.	A	G	1	1	2	0	0	2	0	0
3	40318555	.	C	G	1	0	1	0	0	1	0	0
3	40318556	.	C	G	1	0	1	0	0	1	0	0
3	40318733	.	T	A	1	0	1	0	0	1	0	0
3	40333700	.	A	G	7	2	9	0	4	13	0	0
3	40346035	.	C	T	9	8	17	0	1	18	0	0
3	40346059	.	T	C	7	4	11	0	0	11	0	0
3	40348839	.	T	C	16	8	24	0	0	24	0	0
3	40349310	.	A	G	4	10	14	0	2	16	0	0
3	40349354	.	T	G	4	9	13	0	0	13	0	0
3	40443096	.	C	G	2	2	4	0	0	4	0	0
3	40444020	.	C	T	2	3	5	0	0	5	0	0
3	40448130	.	A	G	2	0	2	0	2	4	0	0
3	40449595	.	C	A	1	2	3	0	0	3	0	0
3	40449603	.	T	C	2	2	4	0	0	4	0	0
3	40450743	.	C	T	5	6	11	0	1	12	0	0
3	40450961	.	T	G	7	0	7	0	5	12	0	0
3	40451268	.	C	T	5	4	9	0	0	9	0	0
3	40451319	.	T	C	3	2	5	0	0	5	0	0
3	40451574	.	A	C	3	3	6	0	0	6	0	0
3	40452119	.	G	C	4	6	10	0	0	10	0	0
3	40452134	.	A	G	2	0	2	0	7	9	0	0
3	40458531	.	C	A	1	0	1	0	0	1	0	0
3	40458594	.	G	A	0	7	7	0	9	16	0	0
3	40467693	.	A	G	7	0	7	0	5	12	0	0
3	40467756	.	C	T	5	6	11	0	1	12	0	0
3	40469891	.	T	C	4	2	6	0	0	6	0	0
3	40480877	.	G	A	0	2	2	0	0	2	0	0
3	40480986	.	G	T	8	7	15	0	1	16	0	0
3	40481346	.	G	A	0	2	2	0	4	6	0	0
3	40481459	.	C	T	13	6	19	0	1	20	0	0
3	40481649	.	T	G	5	9	14	0	1	15	0	0
3	40481930	.	T	A	10	11	21	0	0	21	0	0
3	40482007	.	T	C	12	16	28	0	2	30	0	0
3	40482027	.	A	G	16	0	16	0	12	28	0	0
3	40482289	.	C	A	21	15	36	0	0	36	0	0
3	40482446	.	A	G	10	19	29	0	0	29	0	0
3	40484376	.	A	T	7	7	14	0	0	14	0	0
3	40485360	.	C	A	11	9	20	0	0	20	0	0
3	40485378	.	T	G	7	12	19	0	0	20	1	0
3	40485422	.	G	T	2	19	21	0	13	34	0	0
3	40485499	.	G	A	18	12	30	0	2	32	0	0
3	40485965	.	G	C	7	7	14	0	1	15	0	0
3	40487095	.	G	T	10	12	22	0	0	22	0	0
3	40487162	.	A	C	13	7	20	0	1	21	0	0
3	40487385	.	T	A	17	15	32	0	1	33	0	0
3	40487704	.	T	C	14	9	23	0	4	27	0	0
3	40487820	.	A	G	14	22	36	0	1	37	0	0
3	40487821	.	G	C	14	21	35	0	2	37	0	0
3	40488212	.	C	T	16	21	37	0	2	39	0	0
3	40488264	.	C	T	4	24	28	0	12	40	0	0
3	40488630	.	T	C	1	10	11	0	0	11	0	0
3	40488640	.	T	C	1	7	8	0	0	8	0	0
3	40527028	.	G	A	19	19	38	1	1	41	1	0
3	40527512	.	G	A	33	38	71	0	1	72	0	0
3	40527575	.	G	A	11	5	16	0	2	18	0	0
3	40527665	.	A	G	8	4	12	0	0	12	0	0
3	40527727	.	G	A	7	4	11	0	1	12	0	0
3	40528241	.	A	T	14	19	33	0	3	36	0	0
3	40576600	.	C	T	16	17	33	0	5	38	0	0
3	40576736	.	C	T	14	21	35	0	1	36	0	0
3	40576972	.	A	G	11	1	12	0	19	31	0	0
3	40577032	.	C	T	18	10	28	0	1	29	0	0
3	40583989	.	C	G	9	7	16	0	1	17	0	0
3	40584318	.	T	A	14	11	25	0	6	31	0	0
3	40587967	.	C	T	31	27	58	0	0	58	0	0
3	40588109	.	A	T	22	28	50	0	4	54	0	0
3	40588195	.	T	C	33	23	56	0	1	57	0	0
3	40588363	.	C	T	33	21	54	0	0	54	0	0
3	40588410	.	C	A	22	26	48	0	1	49	0	0
3	40588467	.	T	C	18	23	41	0	2	43	0	0
3	40588595	.	A	C	18	20	38	0	1	39	0	0
3	40588746	.	C	G	19	25	44	0	0	44	0	0
3	40588845	.	A	G	20	23	43	0	0	43	0	0
3	40589147	.	T	C	25	28	53	0	2	55	0	0
3	40589179	.	C	A	29	24	53	0	2	55	0	0
3	40589191	.	T	G	34	21	55	0	2	57	0	0
3	40589214	.	C	A	34	17	51	0	2	53	0	0
3	40589232	.	A	G	30	17	47	0	3	50	0	0
3	40589266	.	C	T	27	20	47	0	2	49	0	0
3	40589348	.	A	G	16	25	41	0	0	41	0	0
3	40589356	.	A	G	17	23	40	0	0	40	0	0
3	40656338	.	A	G	0	1	1	0	0	1	0	0
3	40690704	.	T	C	7	0	7	0	16	23	0	0
3	40690901	.	G	A	5	7	12	0	0	12	0	0
3	40691448	.	A	G	7	1	8	0	0	8	0	0
3	40691473	.	A	T	9	4	13	0	0	13	0	0
3	40691643	.	A	T	5	2	7	0	1	8	0	0
3	40691792	.	T	C	6	0	6	0	4	10	0	0
3	40691969	.	C	T	12	6	18	0	1	19	0	0
3	40692064	.	A	T	5	7	12	0	1	13	0	0
3	40698424	.	C	A	7	4	11	0	1	12	0	0
3	40698481	.	A	G	11	7	18	0	0	18	0	0
3	40712935	.	G	A	1	2	3	0	0	3	0	0
3	40713085	.	G	T	3	4	7	0	1	8	0	0
3	40804271	.	T	G	20	12	32	0	0	32	0	0
3	40804285	.	T	G	24	3	27	0	0	28	1	0
3	40814587	.	G	A	4	5	9	0	0	9	0	0
3	40819959	.	A	C	2	0	2	0	0	2	0	0
3	40820007	.	A	G	3	0	3	0	0	3	0	0
3	40821838	.	C	A	6	13	19	0	0	19	0	0
3	40821871	.	A	T	11	13	24	0	1	25	0	0
3	40821953	.	C	A	0	14	14	0	15	29	0	0
3	40828768	.	T	C	1	0	1	0	1	2	0	0
3	40876757	.	G	A	5	7	12	0	1	13	0	0
3	40882964	.	A	T	3	2	5	0	0	5	0	0
3	40885997	.	C	A	1	2	3	0	1	4	0	0
3	40888210	.	C	A	0	1	1	0	0	1	0	0
3	40888219	.	C	T	0	1	1	0	0	1	0	0
3	40902163	.	C	T	0	7	7	0	6	13	0	0
3	40907953	.	T	C	5	0	5	0	1	6	0	0
3	40913730	.	G	A	3	3	6	0	0	6	0	0
3	40933029	.	A	C	1	2	3	0	0	3	0	0
3	40969547	.	C	T	0	0	0	0	1	1	0	0
3	40973744	.	A	C	1	2	3	0	0	3	0	0
3	40979281	.	T	C	3	7	10	0	0	10	0	0
3	40980024	.	G	A	9	7	16	0	1	17	0	0
3	40980166	.	T	A	15	6	21	0	2	23	0	0
3	40983062	.	A	G	9	6	15	0	0	15	0	0
3	40983077	.	G	A	9	5	14	0	0	14	0	0
3	40997589	.	T	A	4	3	7	0	0	7	0	0
3	41030861	.	T	G	1	2	3	0	0	3	0	0
3	41047649	.	C	T	1	1	2	0	0	2	0	0
3	41705468	.	A	T	1	3	4	0	0	4	0	0
3	41705476	.	C	T	1	3	4	0	0	4	0	0
3	41705626	.	G	T	3	2	5	0	0	5	0	0
3	41705949	.	G	A	1	3	4	0	1	5	0	0
3	41719049	.	G	A	4	2	6	0	0	6	0	0
3	41721916	.	G	A	1	1	2	0	0	2	0	0
3	41723437	.	G	A	5	10	15	0	0	15	0	0
3	41724806	.	G	A	16	19	35	1	0	36	0	0
3	41917747	.	T	C	2	2	4	0	0	4	0	0
3	41922587	.	C	T	1	4	5	0	0	5	0	0
3	41922766	.	A	G	1	0	1	0	0	1	0	0
3	41923195	.	T	C	0	3	3	0	0	3	0	0
3	41925508	.	A	G	2	5	7	0	0	7	0	0
3	41925541	.	C	G	1	6	7	0	0	7	0	0
3	41925823	.	C	T	4	3	7	0	0	7	0	0
3	41925889	.	T	C	4	3	7	0	0	7	0	0
3	41926020	.	T	A	6	3	9	0	0	9	0	0
3	41926557	.	G	A	3	5	8	0	0	8	0	0
3	41926633	.	T	A	4	4	8	0	1	9	0	0
3	41926695	.	T	C	3	2	5	0	1	6	0	0
3	41955449	.	A	G	3	3	6	0	0	6	0	0
3	41955526	.	C	T	3	3	6	0	0	6	0	0
3	41955613	.	G	T	21	19	40	0	1	41	0	0
3	41955911	.	C	G	16	15	31	1	1	33	0	0
3	41956040	.	G	T	15	12	27	0	4	31	0	0
3	41956299	.	T	C	13	8	21	0	1	22	0	0
3	41956353	.	T	A	9	12	21	0	0	21	0	0
3	41956467	.	T	A	2	6	8	0	0	8	0	0
3	41956504	.	C	T	2	4	6	0	0	6	0	0
3	41956792	.	A	T	5	14	19	0	2	21	0	0
3	41956818	.	T	C	3	15	18	0	0	18	0	0
3	41956837	.	T	G	7	11	18	0	0	18	0	0
3	41956855	.	C	T	8	16	24	0	0	24	0	0
3	41956921	.	T	A	5	17	22	1	0	23	0	0
3	41956941	.	T	C	9	10	19	1	1	21	0	0
3	41956978	.	G	A	7	8	15	0	0	15	0	0
3	41957457	.	T	A	5	2	7	0	1	8	0	0
3	41957580	.	G	T	5	8	13	0	0	13	0	0
3	41957839	.	A	T	2	0	2	0	1	3	0	0
3	41958291	.	T	G	4	5	9	0	0	9	0	0
3	41958491	.	A	G	1	2	3	0	0	3	0	0
3	41959370	.	G	T	6	8	14	0	1	15	0	0
3	41959658	.	G	T	6	7	13	0	0	13	0	0
3	41959772	.	A	G	2	9	11	0	2	13	0	0
3	41959906	.	T	A	5	4	9	0	1	10	0	0
3	41959943	.	T	C	5	4	9	0	0	9	0	0
3	41959958	.	A	G	5	6	11	0	0	11	0	0
3	41960005	.	C	A	10	9	19	0	0	19	0	0
3	41960069	.	G	T	3	9	12	0	3	15	0	0
3	41960346	.	A	G	2	6	8	0	1	9	0	0
3	41960652	.	G	A	1	3	4	0	0	4	0	0
3	41960654	.	T	A	1	3	4	0	0	4	0	0
3	41961314	.	G	A	3	4	7	0	1	8	0	0
3	41961341	.	T	G	4	7	11	0	1	13	1	0
3	41961469	.	A	G	4	4	8	0	1	9	0	0
3	41961558	.	A	T	4	7	11	0	1	12	0	0
3	41961587	.	T	G	5	6	11	0	0	11	0	0
3	41961651	.	G	A	3	5	8	0	1	9	0	0
3	41961688	.	T	C	6	0	6	0	7	13	0	0
3	41961993	.	C	G	0	6	6	0	3	9	0	0
3	41962098	.	T	C	1	4	5	0	1	6	0	0
3	41985866	.	G	A	0	2	2	0	0	2	0	0
3	41985953	.	C	T	0	1	1	0	0	1	0	0
3	42125556	.	G	A	1	1	2	0	0	2	0	0
3	42125560	.	G	A	1	1	2	0	0	2	0	0
3	42126782	.	A	G	1	0	1	0	2	3	0	0
3	42918924	.	C	A	11	10	21	0	0	21	0	0
3	42919474	.	C	T	11	8	19	0	0	19	0	0
3	42919510	.	C	T	8	4	12	0	1	13	0	0
3	42919664	.	C	T	5	2	7	0	0	7	0	0
3	42919846	.	T	G	4	4	8	0	2	10	0	0
3	42919849	.	C	T	5	5	10	0	0	10	0	0
3	42919881	.	C	T	3	4	7	0	0	7	0	0
3	42919895	.	A	G	2	4	6	0	0	6	0	0
3	42919943	.	G	C	5	1	6	0	0	6	0	0
3	42919959	.	A	T	4	1	5	0	0	5	0	0
3	43017912	.	T	C	1	1	2	0	0	2	0	0
3	43036193	.	T	C	0	1	1	0	0	1	0	0
3	43039306	.	A	G	2	1	3	0	1	4	0	0
3	43040677	.	G	A	0	7	7	0	4	11	0	0
3	43052230	.	T	C	4	7	11	0	0	11	0	0
3	43059090	.	A	G	1	0	1	0	0	1	0	0
3	43059153	.	A	G	6	5	11	0	0	11	0	0
3	43060866	.	T	C	2	5	7	0	2	9	0	0
3	43376543	.	A	G	1	3	4	0	0	4	0	0
3	43380283	.	C	T	3	8	11	0	0	11	0	0
3	43392755	.	T	A	6	3	9	0	0	9	0	0
3	43392795	.	C	A	6	2	8	0	0	8	0	0
3	43474920	.	A	T	4	4	8	0	0	8	0	0
3	43475184	.	C	T	4	4	8	0	0	8	0	0
3	43475265	.	G	A	2	7	9	0	0	9	0	0
3	43475325	.	A	G	5	7	12	0	2	14	0	0
3	43475376	.	T	C	4	5	9	0	2	11	0	0
3	43475397	.	C	T	4	5	9	0	0	9	0	0
3	43475592	.	A	C	5	6	11	0	0	11	0	0
3	43475617	.	G	T	0	4	4	0	3	7	0	0
3	43475654	.	C	T	4	5	9	0	0	9	0	0
3	43475742	.	G	T	4	3	7	0	0	7	0	0
3	43476088	.	G	T	5	2	7	0	0	7	0	0
3	43476097	.	C	A	5	2	7	0	0	7	0	0
3	43476411	.	A	T	3	2	5	0	0	5	0	0
3	43476435	.	G	T	5	5	10	0	1	11	0	0
3	43476698	.	A	G	8	3	11	0	0	11	0	0
3	43476880	.	C	T	5	5	10	0	1	11	0	0
3	43476887	.	T	G	6	4	10	0	0	10	0	0
3	43477255	.	T	A	3	4	7	0	0	8	1	0
3	43477705	.	T	A	0	4	4	0	0	4	0	0
3	43477751	.	G	T	5	2	7	0	0	7	0	0
3	43478137	.	T	C	10	7	17	0	0	17	0	0
3	43478238	.	C	T	3	4	7	0	0	7	0	0
3	43478310	.	T	G	11	5	16	0	3	19	0	0
3	43478321	.	A	G	10	0	10	0	7	17	0	0
3	43478433	.	A	T	10	8	18	0	1	19	0	0
3	43478586	.	C	T	4	4	8	0	2	10	0	0
3	43579820	.	C	T	0	14	14	0	5	19	0	0
3	43580055	.	A	G	10	14	24	0	1	25	0	0
3	43580195	.	A	T	8	9	17	0	0	17	0	0
3	43580583	.	T	C	8	14	22	0	1	23	0	0
3	43581272	.	A	C	6	13	19	0	0	19	0	0
3	43584423	.	T	C	16	0	16	0	8	24	0	0
3	43584453	.	T	C	11	4	15	0	1	16	0	0
3	43594256	.	A	G	2	2	4	0	1	5	0	0
3	43594358	.	C	T	13	4	17	0	0	17	0	0
3	43594376	.	C	T	1	8	9	0	9	18	0	0
3	43594577	.	G	A	11	12	23	0	0	23	0	0
3	43594655	.	C	T	1	6	7	0	5	12	0	0
3	43594658	.	G	A	6	6	12	0	0	12	0	0
3	43594735	.	T	C	5	6	11	0	1	12	0	0
3	43600999	.	C	T	0	6	6	0	5	11	0	0
3	43645900	.	G	C	8	7	15	0	0	15	0	0
3	43646161	.	A	G	5	5	10	0	0	10	0	0
3	43646362	.	C	T	0	5	5	0	5	10	0	0
3	43711455	.	A	T	3	0	3	0	0	3	0	0
3	43754860	.	T	A	1	3	4	0	0	4	0	0
3	43776850	.	T	A	3	0	3	0	0	3	0	0
3	43776859	.	T	C	2	0	2	0	1	3	0	0
3	43785646	.	A	T	1	1	2	0	0	2	0	0
3	43791284	.	T	C	3	7	10	0	0	10	0	0
3	43791317	.	G	A	3	4	7	0	0	7	0	0
3	43793273	.	G	A	4	1	5	0	0	5	0	0
3	43796956	.	T	G	1	0	1	0	0	1	0	0
3	43797073	.	C	T	1	1	2	0	0	2	0	0
3	43801338	.	C	T	1	1	2	0	0	2	0	0
3	43807512	.	T	C	11	10	21	0	0	21	0	0
3	43807921	.	C	A	9	11	20	0	1	21	0	0
3	43807945	.	T	A	12	9	21	0	0	21	0	0
3	43814607	.	C	T	13	6	19	0	0	19	0	0
3	43821273	.	G	T	3	6	9	0	0	9	0	0
3	43821328	.	A	G	4	3	7	0	0	7	0	0
3	43825892	.	T	A	1	1	2	0	1	3	0	0
3	43825901	.	T	C	0	1	1	0	1	2	0	0
3	43828902	.	G	A	2	5	7	0	0	7	0	0
3	43828906	.	T	C	2	5	7	0	0	7	0	0
3	43829154	.	G	C	1	6	7	0	0	7	0	0
3	43829179	.	G	C	2	6	8	0	0	8	0	0
3	43829370	.	A	C	1	6	7	0	0	7	0	0
3	43829411	.	C	T	3	3	6	0	0	6	0	0
3	43829413	.	C	T	3	3	6	0	0	6	0	0
3	43829712	.	G	A	2	3	5	0	3	8	0	0
3	43942053	.	A	C	2	5	7	0	0	7	0	0
3	43944611	.	A	G	0	5	5	0	0	5	0	0
3	43973568	.	T	A	0	1	1	0	0	1	0	0
3	43985690	.	C	T	2	2	4	0	0	4	0	0
3	43985691	.	C	T	2	2	4	0	0	4	0	0
3	43986252	.	T	A	3	2	5	0	0	5	0	0
3	43986759	.	T	C	3	3	6	0	0	6	0	0
3	44076950	.	C	G	1	0	1	0	2	3	0	0
3	44077429	.	A	C	3	4	7	0	0	7	0	0
3	44081793	.	G	A	0	2	2	0	0	2	0	0
3	44089576	.	A	G	1	5	6	0	0	6	0	0
3	44093661	.	T	C	1	1	2	0	2	4	0	0
3	44093896	.	T	G	0	2	2	0	1	3	0	0
3	44094172	.	C	T	0	4	4	0	1	5	0	0
3	44541766	.	C	T	0	7	7	0	2	9	0	0
3	44541955	.	C	A	1	4	5	0	0	5	0	0
3	45715511	.	T	A	4	4	8	0	0	8	0	0
3	45715716	.	C	T	3	5	8	0	0	8	0	0
3	45715776	.	T	C	7	6	13	0	0	13	0	0
3	45716156	.	A	T	4	5	9	0	0	9	0	0
3	45717180	.	C	T	5	13	18	0	2	20	0	0
3	45776520	.	T	C	24	0	24	0	25	49	0	0
3	45776721	.	T	C	6	21	27	0	1	28	0	0
3	45790559	.	T	C	0	1	1	0	0	1	0	0
3	45805605	.	C	G	0	1	1	0	0	1	0	0
3	45814631	.	A	T	5	8	13	0	1	14	0	0
3	45815997	.	G	A	0	2	2	0	6	8	0	0
3	45816004	.	C	T	5	3	8	0	0	8	0	0
3	45816549	.	A	G	9	9	18	0	0	18	0	0
3	45816618	.	T	C	10	6	16	0	0	16	0	0
3	46043483	.	G	A	3	2	5	0	0	5	0	0
3	46114491	.	C	A	1	3	4	0	0	4	0	0
3	46353917	.	C	T	1	4	5	0	0	5	0	0
3	46362640	.	C	T	2	1	3	0	0	3	0	0
3	46363103	.	G	A	1	2	3	0	0	3	0	0
3	46363127	.	G	A	0	3	3	0	1	4	0	0
3	46363666	.	A	G	1	0	1	0	3	4	0	0
3	46364103	.	T	A	0	3	3	0	0	3	0	0
3	46364162	.	T	A	0	3	3	0	0	3	0	0
3	46364542	.	G	A	3	2	5	0	0	5	0	0
3	46364583	.	T	C	0	2	2	0	0	2	0	0
3	46364847	.	T	G	2	0	2	0	3	5	0	0
3	46377497	.	A	T	2	5	7	0	0	7	0	0
3	46377528	.	C	A	3	6	9	0	0	9	0	0
3	46379849	.	C	G	2	3	5	0	1	6	0	0
3	46380144	.	A	C	3	3	6	0	0	6	0	0
3	46380189	.	A	G	8	8	16	0	1	17	0	0
3	46380194	.	T	A	9	8	17	0	1	18	0	0
3	46388058	.	C	T	3	10	13	0	4	17	0	0
3	46388285	.	G	A	9	9	18	0	0	18	0	0
3	46388386	.	C	T	0	5	5	0	5	10	0	0
3	46388393	.	T	A	5	4	9	0	1	10	0	0
3	46388439	.	A	T	4	10	14	0	0	14	0	0
3	46388487	.	A	C	8	7	15	0	0	15	0	0
3	46388490	.	T	A	7	7	14	0	1	15	0	0
3	46388636	.	T	C	3	4	7	0	0	7	0	0
3	46388711	.	C	T	6	4	10	0	0	10	0	0
3	46388714	.	G	A	4	7	11	0	0	11	0	0
3	46388854	.	T	C	7	8	15	0	0	15	0	0
3	46388905	.	G	A	7	8	15	0	1	16	0	0
3	46388954	.	A	C	7	6	13	0	0	13	0	0
3	46388968	.	G	C	5	9	14	0	0	14	0	0
3	46389009	.	C	T	8	12	20	0	2	22	0	0
3	46391844	.	C	T	0	3	3	0	2	5	0	0
3	46398380	.	G	A	5	9	14	0	0	14	0	0
3	46403743	.	C	T	0	1	1	0	3	4	0	0
3	46410288	.	T	C	0	3	3	0	0	3	0	0
3	46463113	.	T	C	2	6	8	0	0	8	0	0
3	46463156	.	C	T	5	5	10	0	0	10	0	0
3	46463213	.	A	C	2	4	6	0	0	6	0	0
3	46463240	.	C	T	0	2	2	0	0	2	0	0
3	46473247	.	G	C	0	2	2	0	1	3	0	0
3	46473292	.	G	A	3	9	12	0	1	13	0	0
3	46502744	.	C	T	1	2	3	0	1	4	0	0
3	46502745	.	T	C	1	3	4	0	0	4	0	0
3	46524684	.	A	G	1	0	1	0	0	1	0	0
3	46551285	.	T	A	3	3	6	0	1	7	0	0
3	46552775	.	G	A	2	2	4	0	0	4	0	0
3	46552832	.	A	C	0	5	5	0	0	5	0	0
3	46552993	.	A	G	6	5	11	0	0	11	0	0
3	46553206	.	T	G	3	3	6	0	1	7	0	0
3	46553234	.	G	C	3	4	7	0	0	7	0	0
3	46553470	.	A	G	1	0	1	0	3	4	0	0
3	46553480	.	C	A	0	4	4	0	0	4	0	0
3	46553534	.	C	T	6	5	11	0	0	11	0	0
3	46553540	.	C	A	6	4	10	0	1	11	0	0
3	46553711	.	A	C	6	2	8	0	0	8	0	0
3	46553720	.	C	A	7	2	9	0	0	9	0	0
3	46553850	.	A	C	4	2	6	0	0	6	0	0
3	46553893	.	T	C	6	4	10	0	0	10	0	0
3	46553986	.	A	T	7	7	14	0	1	15	0	0
3	46554085	.	G	T	4	10	14	0	0	14	0	0
3	46554177	.	C	A	5	9	14	0	1	15	0	0
3	46554181	.	C	A	8	6	14	0	1	15	0	0
3	46554259	.	G	A	5	3	8	0	1	9	0	0
3	46554348	.	G	A	3	3	6	0	0	6	0	0
3	46554360	.	C	G	2	4	6	0	0	6	0	0
3	46554458	.	G	T	3	4	7	0	0	7	0	0
3	46554564	.	A	G	9	8	17	0	1	18	0	0
3	46554648	.	T	A	10	3	13	0	0	13	0	0
3	46554711	.	G	A	11	9	20	0	3	23	0	0
3	46586834	.	A	G	0	3	3	0	0	3	0	0
3	46586852	.	A	G	0	3	3	0	0	3	0	0
3	46749479	.	A	G	0	1	1	0	0	1	0	0
3	46750272	.	C	T	6	4	10	0	0	10	0	0
3	46750752	.	G	A	8	10	18	0	0	18	0	0
3	46750996	.	C	T	9	9	18	0	1	19	0	0
3	46751630	.	G	A	7	8	15	0	0	15	0	0
3	46752486	.	A	C	12	7	19	0	2	21	0	0
3	46752522	.	T	G	5	4	9	0	0	9	0	0
3	46752558	.	C	T	5	2	7	0	0	7	0	0
3	46753340	.	T	G	11	0	11	0	0	14	3	0
3	46753613	.	T	C	7	8	15	0	0	15	0	0
3	46753619	.	G	A	8	7	15	0	2	17	0	0
3	46753742	.	A	G	12	0	12	0	13	25	0	0
3	46754078	.	T	A	23	22	45	0	1	46	0	0
3	46754296	.	A	T	8	4	12	0	1	13	0	0
3	46764485	.	A	T	1	1	2	0	0	2	0	0
3	46764572	.	A	T	3	2	5	0	0	5	0	0
3	46767646	.	T	C	0	3	3	0	0	3	0	0
3	46778789	.	G	T	3	4	7	0	0	7	0	0
3	46795113	.	G	T	1	2	3	0	0	3	0	0
3	46800490	.	A	T	34	27	61	0	5	66	0	0
3	46800692	.	G	A	22	30	52	0	5	57	0	0
3	46800741	.	T	C	11	2	13	1	16	30	0	0
3	46800743	.	T	C	10	1	11	1	18	30	0	0
3	46800940	.	C	T	32	24	56	0	5	61	0	0
3	46800946	.	T	G	32	28	60	0	0	60	0	0
3	46802227	.	T	C	34	3	37	0	21	58	0	0
3	46919523	.	C	T	2	2	4	0	0	4	0	0
3	46923471	.	T	C	1	4	5	0	0	5	0	0
3	46923509	.	G	A	2	6	8	0	0	8	0	0
3	46925154	.	G	A	1	2	3	0	1	4	0	0
3	46925227	.	A	G	1	4	5	0	0	5	0	0
3	46928680	.	G	C	0	1	1	0	0	1	0	0
3	46928982	.	G	T	0	1	1	0	1	2	0	0
3	46942272	.	A	G	1	2	3	0	0	3	0	0
3	47114558	.	G	A	1	2	3	0	0	3	0	0
3	47114573	.	A	G	1	1	2	0	0	2	0	0
3	47114734	.	A	G	0	1	1	0	0	1	0	0
3	47114746	.	G	A	0	2	2	0	0	2	0	0
3	47119900	.	G	A	2	3	5	0	0	5	0	0
3	47131174	.	C	T	3	2	5	0	0	5	0	0
3	47131249	.	C	T	0	2	2	0	1	3	0	0
3	47198805	.	G	A	3	2	5	0	0	5	0	0
3	47201409	.	C	T	1	1	2	0	0	2	0	0
3	47201440	.	A	G	5	2	7	0	0	7	0	0
3	47201479	.	T	C	8	3	11	0	0	11	0	0
3	47201482	.	T	C	6	2	8	0	2	10	0	0
3	47201518	.	C	T	4	1	5	0	0	5	0	0
3	47205408	.	C	T	0	2	2	0	0	2	0	0
3	47205417	.	A	G	3	0	3	0	0	3	0	0
3	47205507	.	G	A	4	6	10	0	0	10	0	0
3	47205534	.	A	G	4	0	4	0	11	15	0	0
3	47205543	.	C	T	8	4	12	0	1	13	0	0
3	47205585	.	A	T	4	2	6	0	1	7	0	0
3	47205597	.	C	T	2	3	5	0	1	6	0	0
3	47209433	.	T	C	6	4	10	0	0	10	0	0
3	47209445	.	A	T	4	3	7	0	2	9	0	0
3	47212662	.	A	G	7	4	11	0	0	11	0	0
3	47212774	.	T	C	4	3	7	0	0	7	0	0
3	47212790	.	A	G	4	0	4	0	3	7	0	0
3	47212896	.	A	T	1	3	4	0	0	4	0	0
3	47212914	.	T	C	1	3	4	0	0	4	0	0
3	47213009	.	A	T	1	3	4	0	0	4	0	0
3	47213046	.	G	A	1	3	4	0	0	4	0	0
3	47213067	.	C	G	1	5	6	0	0	6	0	0
3	47387084	.	A	C	2	2	4	0	0	4	0	0
3	47387085	.	A	C	2	2	4	0	0	4	0	0
3	47387347	.	T	G	0	2	2	0	2	4	0	0
3	47498625	.	C	A	10	3	13	0	0	13	0	0
3	47498633	.	G	A	10	4	14	0	0	14	0	0
3	47498981	.	T	G	5	1	6	0	0	6	0	0
3	47498985	.	C	T	2	4	6	0	0	6	0	0
3	47529406	.	G	A	3	2	5	0	1	6	0	0
3	47529490	.	G	A	2	1	3	0	0	3	0	0
3	48229390	.	A	G	1	0	1	0	4	5	0	0
3	48229423	.	C	T	1	3	4	0	1	5	0	0
3	48229507	.	A	G	2	7	9	0	0	9	0	0
3	48229654	.	C	T	3	3	6	0	0	6	0	0
3	48229928	.	T	G	1	2	3	0	0	3	0	0
3	48229929	.	C	T	1	2	3	0	0	3	0	0
3	48241645	.	G	T	0	3	3	0	0	3	0	0
3	48241805	.	C	T	1	0	1	0	0	1	0	0
3	48247601	.	A	G	0	1	1	0	1	2	0	0
3	48254271	.	G	A	0	1	1	0	0	1	0	0
3	48261761	.	T	C	4	2	6	0	0	6	0	0
3	48283768	.	C	A	1	0	1	0	0	1	0	0
3	48286490	.	C	T	0	3	3	0	0	3	0	0
3	48286648	.	C	A	0	1	1	0	0	1	0	0
3	48286654	.	G	C	0	1	1	0	0	1	0	0
3	48301180	.	A	G	1	1	2	0	2	4	0	0
3	48301232	.	T	C	3	1	4	0	1	5	0	0
3	48301243	.	A	G	0	0	0	0	1	1	0	0
3	48305837	.	C	G	1	2	3	0	0	3	0	0
3	48305841	.	G	A	0	1	1	0	2	3	0	0
3	48305898	.	C	G	2	1	3	0	0	3	0	0
3	48326568	.	G	A	2	2	4	0	0	4	0	0
3	48326631	.	C	T	3	2	5	0	0	5	0	0
3	48327002	.	G	A	1	0	1	0	0	1	0	0
3	48473565	.	A	G	2	6	8	0	0	8	0	0
3	48479982	.	C	T	0	3	3	0	0	3	0	0
3	48480156	.	T	G	3	13	16	0	0	16	0	0
3	48480333	.	T	C	1	3	4	0	0	4	0	0
3	48488909	.	G	T	8	6	14	0	0	14	0	0
3	48488993	.	T	C	8	6	14	0	0	14	0	0
3	48489101	.	C	G	5	1	6	0	5	11	0	0
3	48489154	.	A	G	5	1	6	0	2	8	0	0
3	48550676	.	G	A	16	22	38	0	1	39	0	0
3	48557707	.	T	C	0	0	0	0	4	4	0	0
3	48584800	.	A	T	7	13	20	0	0	20	0	0
3	48585222	.	C	T	0	17	17	0	18	35	0	0
3	48585236	.	C	A	17	18	35	0	2	37	0	0
3	48585271	.	A	C	15	14	29	0	2	31	0	0
3	48585331	.	A	G	24	10	34	0	2	36	0	0
3	48585377	.	G	T	23	16	39	0	2	41	0	0
3	48585411	.	G	T	22	16	38	0	0	38	0	0
3	48586985	.	A	G	20	11	31	0	0	31	0	0
3	48587176	.	C	A	13	10	23	0	0	24	1	0
3	48587191	.	C	T	14	5	19	0	0	19	0	0
3	48588830	.	A	G	6	7	13	0	0	13	0	0
3	48588884	.	A	G	10	5	15	0	0	15	0	0
3	48589156	.	A	G	2	0	2	0	0	2	0	0
3	48591769	.	A	G	7	7	14	0	1	15	0	0
3	48591825	.	G	T	3	2	5	0	2	7	0	0
3	48593781	.	T	C	10	13	23	0	0	23	0	0
3	48593811	.	G	A	5	7	12	0	0	12	0	0
3	48594098	.	T	C	16	0	16	0	7	24	1	0
3	48596834	.	T	C	7	5	12	0	0	12	0	0
3	48612027	.	T	C	0	0	0	0	3	3	0	0
3	48612038	.	A	G	0	2	2	0	1	3	0	0
3	48612075	.	T	C	0	0	0	0	3	3	0	0
3	48638932	.	C	T	1	7	8	0	0	8	0	0
3	48645801	.	G	T	0	1	1	0	0	1	0	0
3	48645863	.	A	C	1	4	5	0	0	5	0	0
3	48661465	.	C	A	0	3	3	0	1	4	0	0
3	48665796	.	C	G	0	2	2	0	3	5	0	0
3	48665832	.	T	A	4	3	7	0	0	7	0	0
3	48665841	.	T	G	5	3	8	0	0	8	0	0
3	48686990	.	G	A	0	1	1	0	0	1	0	0
3	48687134	.	C	T	0	2	2	0	1	3	0	0
3	48691411	.	A	G	1	1	2	0	0	2	0	0
3	48713618	.	G	A	0	1	1	0	0	1	0	0
3	49130387	.	A	C	1	0	1	0	2	3	0	0
3	49130480	.	G	A	1	1	2	0	0	2	0	0
3	49134128	.	G	A	6	2	8	0	0	8	0	0
3	49134385	.	A	G	1	3	4	0	0	4	0	0
3	49134411	.	T	A	2	4	6	0	0	6	0	0
3	49137821	.	C	A	0	2	2	0	0	2	0	0
3	49154214	.	G	A	3	3	6	0	0	6	0	0
3	49163407	.	G	T	2	3	5	0	0	5	0	0
3	49163528	.	G	T	7	2	9	0	0	9	0	0
3	49426063	.	G	A	11	6	17	0	1	18	0	0
3	49426184	.	G	A	10	10	20	0	2	22	0	0
3	49440129	.	G	T	0	1	1	0	0	1	0	0
3	49447514	.	C	A	0	6	6	0	6	12	0	0
3	49503880	.	A	G	11	6	17	0	1	18	0	0
3	49505527	.	C	T	7	3	10	0	0	10	0	0
3	49559444	.	C	T	26	39	65	0	1	66	0	0
3	49559523	.	C	T	28	40	68	0	2	70	0	0
3	49559527	.	G	T	28	37	65	0	2	67	0	0
3	49559637	.	G	T	32	36	68	0	5	73	0	0
3	49559703	.	G	A	34	34	68	0	3	71	0	0
3	49559904	.	G	A	36	30	66	0	4	70	0	0
3	49559979	.	A	G	40	23	63	0	1	64	0	0
3	49559988	.	T	A	39	22	61	0	2	63	0	0
3	49560084	.	A	G	28	33	61	0	1	62	0	0
3	49560204	.	G	C	26	34	60	0	3	63	0	0
3	49560276	.	T	G	25	30	55	0	4	59	0	0
3	49560420	.	C	T	25	24	49	0	4	53	0	0
3	49560507	.	G	A	25	26	51	0	3	54	0	0
3	49758064	.	A	G	1	2	3	0	0	3	0	0
3	49759153	.	G	A	2	2	4	0	0	4	0	0
3	49759382	.	G	A	1	2	3	0	0	3	0	0
3	50054508	.	G	A	13	4	17	0	1	18	0	0
3	50054578	.	C	G	5	6	11	0	1	12	0	0
3	50054619	.	A	T	2	5	7	0	0	7	0	0
3	50054766	.	G	A	5	7	12	0	1	13	0	0
3	50059143	.	A	T	12	8	20	0	0	20	0	0
3	50063458	.	C	T	4	9	13	0	4	17	0	0
3	50063491	.	C	T	0	6	6	0	15	21	0	0
3	50066373	.	A	G	7	12	19	0	1	20	0	0
3	50066402	.	G	A	11	12	23	0	0	23	0	0
3	50077077	.	G	A	7	10	17	0	0	17	0	0
3	50077311	.	A	G	15	17	32	0	4	36	0	0
3	50077364	.	T	A	19	7	26	0	1	27	0	0
3	50077371	.	G	A	6	16	22	0	0	22	0	0
3	50077428	.	G	C	0	1	1	0	0	1	0	0
3	50081696	.	G	A	4	5	9	0	1	10	0	0
3	50083980	.	C	A	2	2	4	0	0	4	0	0
3	50084011	.	A	G	9	9	18	0	2	20	0	0
3	50087361	.	C	A	0	1	1	0	6	7	0	0
3	50087370	.	G	A	7	4	11	0	0	11	0	0
3	50087433	.	C	A	0	11	11	0	7	18	0	0
3	50089113	.	G	A	4	2	6	0	1	7	0	0
3	50089470	.	T	C	5	2	7	0	0	7	0	0
3	50091985	.	A	G	10	8	18	0	2	20	0	0
3	50095869	.	A	T	3	3	6	0	0	6	0	0
3	50095929	.	C	T	1	2	3	0	1	4	0	0
3	50110369	.	T	C	1	1	2	0	0	2	0	0
3	50110399	.	A	G	1	1	2	0	0	2	0	0
3	50123650	.	C	A	0	16	16	0	14	30	0	0
3	50123709	.	A	G	15	18	33	0	2	35	0	0
3	50123758	.	A	G	20	26	46	0	3	49	0	0
3	50123760	.	C	A	26	21	47	0	2	49	0	0
3	50123936	.	G	A	20	25	45	0	0	45	0	0
3	50124107	.	A	G	12	10	22	0	0	22	0	0
3	50124108	.	C	G	12	10	22	0	0	22	0	0
3	50127039	.	G	T	3	5	8	0	0	8	0	0
3	50127196	.	G	A	0	3	3	0	1	4	0	0
3	50156275	.	T	C	2	3	5	0	0	5	0	0
3	50159356	.	C	G	0	0	0	0	1	1	0	0
3	50159431	.	C	T	1	2	3	0	0	3	0	0
3	50166550	.	T	C	2	1	3	0	0	3	0	0
3	50170236	.	A	G	2	0	2	0	2	4	0	0
3	50170338	.	T	A	1	5	6	0	0	6	0	0
3	50170354	.	C	T	0	3	3	0	0	3	0	0
3	50172725	.	G	C	3	3	6	0	0	6	0	0
3	50172735	.	T	A	2	3	5	0	1	6	0	0
3	50172788	.	C	T	2	3	5	0	0	5	0	0
3	50175478	.	G	A	1	2	3	0	1	4	0	0
3	50175940	.	G	T	3	4	7	0	0	7	0	0
3	50176620	.	G	T	6	5	11	0	0	11	0	0
3	50256147	.	G	A	1	1	2	0	0	2	0	0
3	50256938	.	A	C	6	1	7	0	2	9	0	0
3	50265852	.	C	T	1	9	10	0	0	10	0	0
3	50265903	.	A	C	4	8	12	0	1	13	0	0
3	50265906	.	T	C	5	8	13	0	0	13	0	0
3	50265994	.	C	T	2	5	7	0	0	7	0	0
3	50266043	.	C	A	1	7	8	0	1	9	0	0
3	50266063	.	A	G	1	8	9	0	0	9	0	0
3	50266330	.	T	A	4	4	8	0	0	8	0	0
3	50267171	.	T	G	3	3	6	0	0	6	0	0
3	50267256	.	T	A	6	5	11	0	0	11	0	0
3	50267460	.	G	A	5	6	11	0	0	11	0	0
3	50267471	.	A	T	5	4	9	0	0	9	0	0
3	50267686	.	T	C	5	10	15	0	1	16	0	0
3	50267860	.	A	T	6	13	19	0	1	20	0	0
3	50267981	.	G	C	4	14	18	0	1	19	0	0
3	50267992	.	T	A	8	8	16	0	3	19	0	0
3	50268016	.	T	C	7	9	16	0	0	16	0	0
3	50268106	.	G	T	8	3	11	0	0	11	0	0
3	50268146	.	T	A	7	3	10	1	2	13	0	0
3	50268220	.	C	T	8	7	15	0	0	15	0	0
3	50268422	.	G	A	4	3	7	0	0	7	0	0
3	50268535	.	A	C	6	10	16	0	0	17	1	0
3	50268715	.	C	T	4	9	13	0	1	14	0	0
3	50268744	.	G	A	5	6	11	0	0	11	0	0
3	50272273	.	G	A	4	3	7	0	0	7	0	0
3	50272435	.	T	G	8	4	12	0	0	12	0	0
3	50272438	.	T	G	7	4	11	0	1	12	0	0
3	50273026	.	G	A	7	13	20	0	0	20	0	0
3	50273031	.	C	T	7	12	19	0	0	19	0	0
3	50273469	.	C	T	0	3	3	0	3	6	0	0
3	50276336	.	A	T	2	0	2	0	0	2	0	0
3	50365808	.	C	A	0	5	5	0	1	6	0	0
3	50418826	.	G	C	7	12	19	0	0	19	0	0
3	50419046	.	C	T	8	10	18	0	0	18	0	0
3	50419155	.	C	T	7	7	14	0	0	14	0	0
3	50419329	.	G	A	5	0	5	0	0	5	0	0
3	50419344	.	T	A	2	2	4	0	0	4	0	0
3	50419658	.	T	A	4	2	6	0	1	7	0	0
3	50419686	.	A	T	4	6	10	0	1	11	0	0
3	50419722	.	G	C	4	7	11	0	1	12	0	0
3	50419723	.	C	A	5	7	12	0	0	12	0	0
3	50419759	.	C	T	4	3	7	0	2	9	0	0
3	50419791	.	T	C	7	3	10	0	1	11	0	0
3	50419803	.	C	A	4	7	11	0	1	12	0	0
3	50419827	.	T	C	4	7	11	0	0	11	0	0
3	50419866	.	T	C	4	2	6	0	0	8	2	0
3	50420087	.	A	G	6	7	13	0	0	13	0	0
3	50420152	.	G	T	4	7	11	0	2	13	0	0
3	50861448	.	G	T	1	2	3	0	0	3	0	0
3	50951299	.	C	A	3	6	9	0	0	9	0	0
3	50951644	.	C	G	7	5	12	0	0	12	0	0
3	50951770	.	T	G	8	3	11	0	0	11	0	0
3	50952021	.	T	C	3	3	6	0	0	6	0	0
3	50952163	.	G	A	2	4	6	0	0	6	0	0
3	51034995	.	G	T	5	5	10	0	0	10	0	0
3	51039012	.	C	T	0	3	3	0	2	5	0	0
3	51056350	.	A	G	0	1	1	0	0	1	0	0
3	51056368	.	T	A	0	1	1	0	0	1	0	0
3	51074579	.	T	A	1	2	3	0	0	3	0	0
3	51074618	.	C	T	0	2	2	0	1	3	0	0
3	51563736	.	G	A	0	4	4	0	2	6	0	0
3	51619789	.	A	C	1	2	3	0	0	3	0	0
3	51642491	.	G	A	2	2	4	0	0	4	0	0
3	51642536	.	A	C	1	0	1	0	0	1	0	0
3	51642720	.	C	T	1	0	1	0	0	1	0	0
3	51645783	.	C	T	1	0	1	0	0	1	0	0
3	51653411	.	G	A	7	3	10	0	0	10	0	0
3	51653435	.	C	T	7	4	11	0	0	11	0	0
3	51656720	.	G	A	11	5	16	0	0	16	0	0
3	51656726	.	C	A	12	5	17	0	1	18	0	0
3	51656762	.	G	A	11	3	14	0	0	14	0	0
3	51656849	.	T	A	5	6	11	0	0	11	0	0
3	51656921	.	T	C	9	5	14	0	0	14	0	0
3	51656931	.	G	A	7	7	14	0	2	16	0	0
3	51656973	.	C	A	4	7	11	0	0	11	0	0
3	51657033	.	T	A	6	11	17	0	1	18	0	0
3	51657082	.	C	T	9	8	17	0	1	18	0	0
3	51657158	.	A	G	12	0	12	0	6	18	0	0
3	51657291	.	G	A	12	9	21	0	1	22	0	0
3	51657314	.	G	A	11	7	18	0	1	19	0	0
3	51657339	.	C	T	6	6	12	0	0	12	0	0
3	51657382	.	G	C	2	7	9	0	0	9	0	0
3	51657439	.	A	G	9	7	16	0	0	16	0	0
3	51657456	.	C	T	10	6	16	0	2	18	0	0
3	51742263	.	G	A	0	1	1	0	0	1	0	0
3	51813083	.	G	A	1	0	1	0	0	1	0	0
3	51861767	.	G	A	3	7	10	0	0	10	0	0
3	51871663	.	A	T	6	6	12	0	0	12	0	0
3	51871671	.	C	T	6	5	11	0	0	11	0	0
3	51871704	.	G	C	2	3	5	0	0	5	0	0
3	51874163	.	G	A	3	3	6	0	0	6	0	0
3	51874274	.	G	A	5	6	11	0	0	11	0	0
3	51879297	.	G	T	10	5	15	0	0	15	0	0
3	51891785	.	A	G	9	0	9	0	15	24	0	0
3	51891787	.	C	T	9	15	24	0	0	24	0	0
3	51891923	.	T	C	1	3	4	0	1	5	0	0
3	51892095	.	T	A	2	4	6	0	0	6	0	0
3	51892136	.	A	T	4	6	10	0	0	10	0	0
3	51892162	.	A	G	4	7	11	0	2	13	0	0
3	51892176	.	T	A	5	10	15	0	1	16	0	0
3	51892212	.	A	G	2	7	9	0	0	9	0	0
3	51892225	.	T	A	3	7	10	0	0	10	0	0
3	51892502	.	G	A	6	3	9	0	0	9	0	0
3	51892573	.	T	C	1	6	7	0	2	9	0	0
3	51899772	.	T	A	7	5	12	0	1	13	0	0
3	51899802	.	C	T	0	6	6	0	6	12	0	0
3	51899872	.	C	T	0	4	4	0	7	11	0	0
3	51900357	.	C	A	8	6	14	0	0	14	0	0
3	51900400	.	A	G	12	3	15	0	1	16	0	0
3	51900415	.	T	C	7	7	14	0	1	15	0	0
3	51900487	.	A	C	12	15	27	0	0	28	1	0
3	51900552	.	A	G	9	4	13	0	1	14	0	0
3	51900587	.	C	T	7	10	17	0	0	17	0	0
3	51900589	.	A	C	7	8	15	0	2	17	0	0
3	51900693	.	C	G	8	13	21	0	0	21	0	0
3	51900702	.	C	A	1	12	13	0	10	23	0	0
3	51900768	.	T	A	8	5	13	0	2	15	0	0
3	51900784	.	T	C	6	0	6	0	5	11	0	0
3	51901018	.	C	T	0	1	1	0	0	1	0	0
3	51901092	.	A	T	8	10	18	0	1	19	0	0
3	51901127	.	A	G	10	11	21	0	1	22	0	0
3	51901178	.	T	A	8	3	11	0	0	11	0	0
3	51901199	.	G	T	2	0	2	0	0	2	0	0
3	51901309	.	G	A	7	4	11	0	1	12	0	0
3	51901344	.	T	C	8	9	17	0	3	20	0	0
3	51901413	.	A	G	2	4	6	0	0	6	0	0
3	51901670	.	C	T	8	12	20	0	1	21	0	0
3	51901799	.	T	C	10	18	28	0	0	28	0	0
3	51901835	.	G	A	11	17	28	0	1	29	0	0
3	51901873	.	A	G	13	13	26	0	2	28	0	0
3	51901885	.	T	C	13	12	25	0	1	26	0	0
3	51902099	.	C	T	3	12	15	0	0	15	0	0
3	51902171	.	T	A	8	8	16	0	0	16	0	0
3	51902454	.	T	A	4	11	15	0	0	15	0	0
3	51902591	.	T	A	12	5	17	0	0	17	0	0
3	51902695	.	C	T	10	4	14	0	1	15	0	0
3	51902834	.	A	G	8	15	23	0	1	24	0	0
3	51902883	.	G	A	7	12	19	0	1	20	0	0
3	51902987	.	A	G	6	8	14	0	0	14	0	0
3	51903048	.	A	C	4	2	6	0	0	6	0	0
3	51903080	.	A	G	3	4	7	0	1	8	0	0
3	51903168	.	C	T	4	7	11	0	0	11	0	0
3	51903198	.	A	C	6	1	7	0	10	17	0	0
3	51903211	.	T	G	7	14	21	0	2	23	0	0
3	51903233	.	A	G	7	16	23	0	1	24	0	0
3	51903286	.	G	T	5	6	11	0	1	12	0	0
3	51903495	.	A	G	7	4	11	0	1	12	0	0
3	51903591	.	C	T	5	8	13	0	0	13	0	0
3	51903605	.	G	A	7	7	14	0	0	14	0	0
3	51903742	.	C	G	2	2	4	0	1	5	0	0
3	51903810	.	T	G	1	5	6	0	0	6	0	0
3	51903815	.	T	A	2	6	8	0	0	8	0	0
3	51903979	.	T	C	2	4	6	0	0	6	0	0
3	51904019	.	G	T	2	5	7	0	0	7	0	0
3	51904043	.	G	T	6	3	9	0	1	10	0	0
3	51904226	.	A	G	3	6	9	0	0	9	0	0
3	51904359	.	T	A	3	8	11	0	0	11	0	0
3	51907077	.	G	T	1	2	3	0	0	3	0	0
3	51907297	.	G	A	0	1	1	0	0	1	0	0
3	51907657	.	A	G	0	1	1	0	0	1	0	0
3	52558309	.	G	A	0	3	3	0	1	4	0	0
3	52558333	.	A	G	2	2	4	0	0	4	0	0
3	52563568	.	C	T	2	6	8	0	0	8	0	0
3	52584332	.	C	T	4	3	7	0	1	8	0	0
3	52584428	.	C	T	2	4	6	0	0	6	0	0
3	52588941	.	C	T	4	6	10	0	1	11	0	0
3	52594760	.	G	A	7	7	14	0	1	15	0	0
3	52594966	.	T	C	10	9	19	0	0	19	0	0
3	52603216	.	A	C	10	14	24	0	5	29	0	0
3	52641771	.	C	A	3	2	5	0	0	5	0	0
3	52641819	.	T	C	2	0	2	0	6	8	0	0
3	52641831	.	C	T	0	6	6	0	3	9	0	0
3	52642132	.	T	A	3	3	6	0	1	7	0	0
3	52642614	.	T	C	2	0	2	0	3	5	0	0
3	52647870	.	C	T	5	4	9	0	0	9	0	0
3	52660909	.	T	C	4	2	6	0	0	6	0	0
3	52660929	.	T	A	2	3	5	0	0	5	0	0
3	52668150	.	C	T	2	3	5	0	4	9	0	0
3	52668542	.	G	A	14	10	24	0	1	25	0	0
3	52668679	.	C	T	0	2	2	0	2	4	0	0
3	52669995	.	G	A	4	2	6	0	0	6	0	0
3	52673834	.	T	A	8	9	17	0	2	19	0	0
3	52673854	.	A	T	9	7	16	0	1	17	0	0
3	52673936	.	G	A	5	3	8	0	0	8	0	0
3	52674017	.	T	A	3	5	8	0	1	9	0	0
3	52674018	.	A	C	5	3	8	0	1	9	0	0
3	52676973	.	A	G	2	3	5	0	0	5	0	0
3	52676993	.	C	T	2	2	4	0	0	4	0	0
3	52677087	.	C	T	0	4	4	0	5	9	0	0
3	52677492	.	C	G	1	1	2	0	0	2	0	0
3	52677501	.	T	C	2	1	3	0	0	3	0	0
3	52689511	.	C	T	1	2	3	0	1	4	0	0
3	52697304	.	G	C	0	2	2	0	0	2	0	0
3	52697312	.	A	C	1	2	3	0	0	3	0	0
3	52697371	.	T	A	2	2	4	0	0	4	0	0
3	52699441	.	G	A	12	4	16	0	0	16	0	0
3	52699449	.	G	T	0	4	4	0	13	17	0	0
3	52699775	.	C	T	6	3	9	0	0	9	0	0
3	52699830	.	G	T	6	2	8	0	2	10	0	0
3	52699995	.	T	C	11	4	15	0	0	15	0	0
3	52800959	.	C	T	1	3	4	0	0	4	0	0
3	52895631	.	G	A	2	1	3	0	0	3	0	0
3	52895667	.	G	A	4	2	6	0	0	6	0	0
3	52895688	.	C	T	3	2	5	0	0	5	0	0
3	52895725	.	C	G	0	1	1	0	0	1	0	0
3	52898520	.	C	T	0	3	3	0	1	4	0	0
3	52899872	.	A	T	1	2	3	0	1	4	0	0
3	52913391	.	T	C	0	3	3	0	0	3	0	0
3	52913508	.	C	T	0	1	1	0	0	1	0	0
3	52913529	.	A	G	1	2	3	0	0	3	0	0
3	52921926	.	A	G	1	0	1	0	0	1	0	0
3	52925915	.	G	A	0	2	2	0	2	4	0	0
3	52932770	.	C	T	4	3	7	0	0	7	0	0
3	52932793	.	A	C	4	5	9	0	1	10	0	0
3	52935355	.	C	A	1	1	2	0	0	2	0	0
3	52937419	.	T	C	2	2	4	0	0	4	0	0
3	52937723	.	G	T	6	4	10	0	0	10	0	0
3	52937747	.	G	A	0	3	3	0	6	9	0	0
3	53000280	.	G	A	0	2	2	0	2	4	0	0
3	53000517	.	T	C	2	7	9	0	0	9	0	0
3	53000558	.	A	G	1	0	1	0	6	7	0	0
3	53000673	.	G	T	1	4	5	0	4	9	0	0
3	53001045	.	C	A	4	3	7	0	0	7	0	0
3	53047981	.	A	G	6	0	6	0	5	11	0	0
3	53048032	.	C	T	2	3	5	0	1	6	0	0
3	53074317	.	C	T	14	19	33	1	1	35	0	0
3	53074581	.	C	T	15	12	27	0	2	29	0	0
3	53075050	.	C	A	6	8	14	0	1	15	0	0
3	53075475	.	T	G	11	12	23	0	0	23	0	0
3	53076037	.	A	T	15	10	25	0	1	26	0	0
3	53076160	.	G	T	0	28	28	2	23	54	1	0
3	53140883	.	A	G	1	2	3	0	0	3	0	0
3	53140955	.	T	A	1	1	2	0	0	2	0	0
3	53198571	.	A	C	5	4	9	0	1	10	0	0
3	53198736	.	T	C	2	4	6	0	0	6	0	0
3	53198987	.	T	G	4	2	6	0	0	6	0	0
3	53199182	.	C	T	3	2	5	0	0	5	0	0
3	53199433	.	A	T	0	2	2	0	0	2	0	0
3	53203566	.	C	T	1	3	4	0	0	4	0	0
3	53203782	.	A	G	0	2	2	0	0	2	0	0
3	53203823	.	T	G	3	0	3	0	3	6	0	0
3	53206260	.	A	G	4	3	7	0	1	8	0	0
3	53206418	.	G	A	10	8	18	0	0	18	0	0
3	53206427	.	C	T	8	7	15	0	0	15	0	0
3	53206469	.	A	T	7	4	11	0	0	11	0	0
3	53206472	.	C	T	6	4	10	0	0	10	0	0
3	53211032	.	A	G	3	3	6	0	1	7	0	0
3	53211168	.	G	C	10	2	12	0	5	17	0	0
3	53211170	.	T	C	10	7	17	0	0	17	0	0
3	53211206	.	A	T	5	11	16	0	1	17	0	0
3	53211239	.	A	G	4	10	14	0	2	16	0	0
3	53211248	.	T	G	5	0	5	0	10	15	0	0
3	53211356	.	A	T	4	4	8	0	2	10	0	0
3	53211366	.	C	A	5	6	11	0	0	11	0	0
3	53211604	.	C	G	15	6	21	0	0	21	0	0
3	53211605	.	C	T	14	6	20	0	1	21	0	0
3	53214615	.	T	C	4	3	7	0	0	7	0	0
3	53215644	.	C	T	1	0	1	0	0	1	0	0
3	53215711	.	T	A	13	2	15	0	1	16	0	0
3	53215729	.	G	A	11	3	14	0	0	14	0	0
3	53218471	.	C	T	5	8	13	0	0	13	0	0
3	53222943	.	G	T	0	8	8	0	17	25	0	0
3	53223032	.	C	A	9	12	21	0	1	22	0	0
3	53223110	.	T	C	10	4	14	0	2	16	0	0
3	53223290	.	G	A	14	7	21	0	0	21	0	0
3	53223415	.	C	T	14	8	22	0	1	23	0	0
3	53223973	.	A	C	20	9	29	0	1	30	0	0
3	53224029	.	G	A	14	7	21	0	0	21	0	0
3	53224181	.	A	G	18	10	28	0	0	28	0	0
3	53228771	.	T	A	1	0	1	0	0	1	0	0
3	53229021	.	G	A	4	5	9	0	0	9	0	0
3	53229036	.	T	A	5	3	8	0	2	10	0	0
3	53230980	.	T	C	4	4	8	0	0	8	0	0
3	53231102	.	A	T	11	5	16	0	1	17	0	0
3	53231133	.	T	G	5	6	11	0	1	12	0	0
3	53231144	.	G	A	5	6	11	0	0	11	0	0
3	53231178	.	C	T	2	3	5	0	0	5	0	0
3	53264641	.	T	G	2	3	5	0	0	5	0	0
3	53273841	.	T	A	2	2	4	0	0	4	0	0
3	53273889	.	C	G	1	3	4	0	0	4	0	0
3	53274090	.	C	G	1	3	4	0	0	4	0	0
3	53329569	.	G	A	0	3	3	0	1	4	0	0
3	53330005	.	A	G	3	1	4	0	0	4	0	0
3	53340939	.	G	C	1	2	3	0	1	4	0	0
3	53342706	.	C	A	1	1	2	0	0	2	0	0
3	53343415	.	C	T	0	1	1	0	0	1	0	0
3	53343418	.	C	T	0	1	1	0	0	1	0	0
3	53344694	.	T	C	3	1	4	0	1	5	0	0
3	53344842	.	C	T	1	1	2	0	0	2	0	0
3	53344968	.	C	T	1	3	4	0	0	4	0	0
3	53350410	.	T	C	4	3	7	0	0	7	0	0
3	53350411	.	G	A	4	3	7	0	0	7	0	0
3	53352516	.	G	T	4	4	8	0	0	8	0	0
3	53445979	.	C	T	1	5	6	0	0	6	0	0
3	53446429	.	A	G	0	3	3	0	0	3	0	0
3	53446569	.	C	T	1	6	7	0	0	7	0	0
3	53447603	.	A	C	3	1	4	0	5	9	0	0
3	53447606	.	T	A	2	0	2	0	7	9	0	0
3	53447714	.	C	T	7	3	10	0	0	10	0	0
3	53447717	.	C	T	7	3	10	0	0	10	0	0
3	53447960	.	C	T	1	3	4	0	0	4	0	0
3	53448188	.	T	C	0	1	1	0	0	1	0	0
3	53448920	.	A	G	0	0	0	0	1	1	0	0
3	53449227	.	C	A	7	5	12	0	1	13	0	0
3	53449263	.	A	G	13	4	17	0	0	17	0	0
3	53476314	.	T	C	10	0	10	0	4	14	0	0
3	53476338	.	T	C	3	1	4	0	0	4	0	0
3	53476654	.	T	C	9	4	13	0	1	14	0	0
3	53527681	.	T	C	2	4	6	0	0	6	0	0
3	53528017	.	T	C	7	4	11	0	1	12	0	0
3	53528039	.	G	A	7	4	11	0	0	11	0	0
3	53528190	.	T	C	6	4	10	0	0	10	0	0
3	53528251	.	C	A	0	5	5	0	10	15	0	0
3	53528748	.	A	G	0	2	2	0	1	3	0	0
3	53528750	.	T	A	1	2	3	0	0	3	0	0
3	53528814	.	T	C	4	4	8	0	1	9	0	0
3	53528893	.	A	T	3	3	6	0	0	6	0	0
3	53529027	.	A	G	2	2	4	0	0	4	0	0
3	53530298	.	G	A	2	4	6	0	1	7	0	0
3	53530334	.	G	A	2	2	4	0	0	4	0	0
3	53687983	.	C	T	1	3	4	0	0	4	0	0
3	53688047	.	A	T	1	5	6	0	0	6	0	0
3	53688077	.	C	G	0	2	2	0	1	3	0	0
3	53688106	.	G	T	1	2	3	0	0	3	0	0
3	53688276	.	T	C	3	0	3	0	5	8	0	0
3	53688309	.	T	G	7	4	11	0	0	11	0	0
3	53688315	.	T	C	9	0	9	0	3	12	0	0
3	54047599	.	T	G	4	8	12	0	0	12	0	0
3	54047881	.	T	C	1	0	1	0	0	1	0	0
3	54168046	.	C	T	20	17	37	0	1	38	0	0
3	54168127	.	C	T	6	8	14	0	0	14	0	0
3	54168174	.	T	C	10	6	16	0	0	16	0	0
3	54168192	.	T	C	8	6	14	0	1	15	0	0
3	54168318	.	T	C	7	3	10	0	2	12	0	0
3	54207610	.	C	T	25	17	42	0	2	44	0	0
3	54223504	.	G	A	4	2	6	0	0	6	0	0
3	54236612	.	A	G	2	0	2	0	2	4	0	0
3	54236621	.	T	G	4	4	8	0	0	8	0	0
3	54236657	.	C	A	11	11	22	0	0	22	0	0
3	54236750	.	A	G	22	23	45	0	2	47	0	0
3	54236996	.	G	A	0	28	28	0	27	55	0	0
3	54237347	.	C	T	28	23	51	0	2	53	0	0
3	54237443	.	G	C	12	16	28	0	1	29	0	0
3	54237472	.	T	C	10	10	20	0	2	22	0	0
3	54434322	.	A	G	2	4	6	0	1	7	0	0
3	54434724	.	G	A	3	1	4	0	1	5	0	0
3	54435002	.	A	G	6	3	9	0	0	9	0	0
3	54435273	.	G	A	6	2	8	0	1	9	0	0
3	54435336	.	C	G	0	8	8	0	7	15	0	0
3	54435453	.	G	A	1	1	2	0	0	2	0	0
3	54438753	.	G	A	3	1	4	0	0	4	0	0
3	54455168	.	C	T	0	0	0	0	1	1	0	0
3	54455616	.	G	T	4	2	6	0	0	6	0	0
3	54561375	.	A	G	7	4	11	0	0	11	0	0
3	54567303	.	T	A	1	5	6	0	0	6	0	0
3	54567463	.	T	A	3	6	9	0	1	10	0	0
3	54567502	.	G	A	8	2	10	0	1	11	0	0
3	54567715	.	A	C	3	4	7	0	1	8	0	0
3	54567777	.	A	G	3	0	3	0	7	10	0	0
3	54583742	.	C	T	5	3	8	0	0	8	0	0
3	54585281	.	A	G	2	6	8	0	0	8	0	0
3	54585359	.	C	T	6	4	10	0	0	10	0	0
3	54585637	.	T	C	23	24	47	0	0	47	0	0
3	54585685	.	C	T	10	8	18	0	0	18	0	0
3	54586125	.	T	C	1	1	2	0	0	2	0	0
3	54589582	.	T	C	11	12	23	0	1	25	1	0
3	54591385	.	G	A	7	3	10	0	2	12	0	0
3	54591432	.	A	C	12	5	17	0	1	18	0	0
3	54591677	.	G	A	6	4	10	0	0	10	0	0
3	54591701	.	A	G	2	5	7	0	0	7	0	0
3	54591849	.	G	A	10	7	17	0	1	18	0	0
3	54592322	.	G	A	13	7	20	0	0	20	0	0
3	54592376	.	A	T	8	14	22	0	2	24	0	0
3	54592986	.	T	C	2	1	3	0	4	7	0	0
3	54593034	.	A	T	9	5	14	0	1	15	0	0
3	54593046	.	C	T	9	4	13	0	0	13	0	0
3	54594823	.	C	T	5	1	6	0	0	6	0	0
3	54594865	.	T	A	6	3	9	0	0	9	0	0
3	54594880	.	T	C	4	2	6	0	0	6	0	0
3	54595071	.	G	A	6	3	9	0	0	9	0	0
3	54596362	.	A	G	4	4	8	0	0	8	0	0
3	54596385	.	C	T	3	3	6	0	0	6	0	0
3	54596634	.	G	A	0	1	1	0	0	1	0	0
3	54596651	.	G	A	1	0	1	0	0	1	0	0
3	54596892	.	T	C	4	0	4	0	7	11	0	0
3	54596935	.	A	G	7	0	7	0	0	7	0	0
3	54597183	.	G	A	3	4	7	0	0	7	0	0
3	54598196	.	T	G	2	3	5	0	0	5	0	0
3	54600682	.	A	G	0	0	0	0	1	1	0	0
3	54601833	.	G	A	1	1	2	0	0	2	0	0
3	54601836	.	C	T	0	1	1	0	1	2	0	0
3	54771659	.	A	T	1	4	5	0	0	5	0	0
3	54771720	.	C	A	3	5	8	0	0	8	0	0
3	54810164	.	G	A	0	1	1	0	0	1	0	0
3	54810588	.	A	G	8	0	8	0	5	13	0	0
3	54834906	.	T	C	3	2	5	0	0	5	0	0
3	54835200	.	C	T	4	2	6	0	0	6	0	0
3	54835707	.	T	C	2	0	2	0	3	5	0	0
3	54837876	.	C	T	0	1	1	0	0	1	0	0
3	54849375	.	A	G	1	0	1	0	2	3	0	0
3	54849459	.	C	A	1	2	3	0	0	3	0	0
3	54849466	.	C	T	1	4	5	0	0	5	0	0
3	54850678	.	C	T	1	1	2	0	0	2	0	0
3	54856591	.	T	C	2	4	6	0	0	6	0	0
3	54856592	.	C	T	1	4	5	0	1	6	0	0
3	54856645	.	T	C	2	4	6	0	0	6	0	0
3	54859127	.	T	C	6	6	12	0	1	13	0	0
3	54866207	.	A	G	8	3	11	0	0	11	0	0
3	54868514	.	C	T	4	5	9	0	0	9	0	0
3	54871515	.	C	A	19	11	30	0	1	32	1	0
3	54871745	.	C	T	2	9	11	0	1	12	0	0
3	54871805	.	G	A	3	13	16	0	0	16	0	0
3	54871897	.	A	G	7	4	11	0	0	11	0	0
3	54872003	.	C	G	1	14	15	0	1	16	0	0
3	54872172	.	T	A	11	5	16	0	0	16	0	0
3	54872494	.	A	G	1	3	4	0	0	4	0	0
3	54872520	.	C	G	9	4	13	0	0	13	0	0
3	54873055	.	C	A	12	15	27	0	2	29	0	0
3	54873844	.	T	C	19	17	36	0	0	36	0	0
3	54874245	.	C	T	12	14	26	0	0	26	0	0
3	54874371	.	C	T	20	11	31	0	1	32	0	0
3	54874477	.	A	G	21	16	37	0	0	37	0	0
3	54874631	.	G	A	17	18	35	0	1	36	0	0
3	54874660	.	C	T	17	15	32	0	2	34	0	0
3	54874711	.	G	A	4	11	15	0	2	17	0	0
3	54887965	.	T	C	1	2	3	0	0	3	0	0
3	54896748	.	A	C	7	0	7	0	6	13	0	0
3	54896985	.	A	G	5	6	11	0	0	11	0	0
3	54897039	.	G	A	2	3	5	0	0	5	0	0
3	54897099	.	G	T	6	3	9	0	0	9	0	0
3	54897152	.	G	A	3	4	7	0	0	7	0	0
3	54902365	.	C	T	0	1	1	0	0	1	0	0
3	54908057	.	C	T	0	2	2	0	0	2	0	0
3	54911854	.	T	G	1	3	4	0	0	4	0	0
3	54911890	.	T	C	1	5	6	0	0	6	0	0
3	54912019	.	C	T	0	1	1	0	0	1	0	0
3	54914258	.	A	G	2	3	5	0	0	5	0	0
3	55032137	.	C	G	1	2	3	0	1	4	0	0
3	55039041	.	T	C	3	3	6	0	0	6	0	0
3	55039047	.	C	A	3	4	7	0	0	7	0	0
3	55042728	.	C	T	1	3	4	0	0	4	0	0
3	55045602	.	T	A	7	2	9	0	0	9	0	0
3	55045709	.	G	T	3	7	10	0	0	10	0	0
3	55045854	.	A	G	7	2	9	0	1	10	0	0
3	55045904	.	C	T	1	2	3	0	4	7	0	0
3	55046165	.	A	G	1	5	6	0	0	6	0	0
3	55050175	.	A	G	6	7	13	0	0	13	0	0
3	55050191	.	T	A	6	6	12	0	0	12	0	0
3	55051090	.	C	T	0	2	2	0	0	2	0	0
3	55053879	.	A	G	0	1	1	0	0	1	0	0
3	55054294	.	C	T	0	2	2	0	0	2	0	0
3	55079269	.	T	C	3	2	5	0	0	5	0	0
3	55079287	.	T	C	3	0	3	0	3	6	0	0
3	55091710	.	A	G	0	2	2	0	0	2	0	0
3	55093923	.	T	C	3	4	7	0	0	7	0	0
3	55093980	.	T	C	1	3	4	0	0	4	0	0
3	55098576	.	A	G	0	4	4	5	0	9	0	0
3	55100228	.	T	C	14	0	14	0	1	15	0	0
3	55100522	.	A	G	4	14	18	0	0	18	0	0
3	55100590	.	T	G	19	7	26	0	2	28	0	0
3	55100795	.	A	G	29	17	46	0	1	47	0	0
3	55103453	.	A	G	6	3	9	0	0	9	0	0
3	55104214	.	T	C	7	0	7	0	6	13	0	0
3	55104215	.	A	G	6	6	12	0	1	13	0	0
3	55105254	.	T	C	10	9	19	0	0	19	0	0
3	55161680	.	C	T	0	1	1	0	2	3	0	0
3	55161697	.	G	T	1	3	4	0	0	4	0	0
3	55161724	.	C	T	1	5	6	0	0	6	0	0
3	55161753	.	C	T	2	3	5	0	0	5	0	0
3	55161763	.	G	T	2	2	4	0	0	4	0	0
3	55218724	.	C	T	0	4	4	0	5	9	0	0
3	55218772	.	G	A	1	2	3	0	1	4	0	0
3	55218830	.	T	C	1	0	1	0	2	3	0	0
3	55222778	.	G	T	1	0	1	0	0	1	0	0
3	55422831	.	G	A	8	5	13	0	1	14	0	0
3	55422850	.	G	T	5	10	15	0	1	16	0	0
3	55422926	.	C	A	0	6	6	0	3	9	0	0
3	55422980	.	T	C	3	6	9	0	2	11	0	0
3	55423385	.	T	C	4	3	7	0	0	7	0	0
3	55423611	.	G	A	1	2	3	0	0	3	0	0
3	55423663	.	A	G	3	2	5	0	0	5	0	0
3	55423861	.	T	C	1	0	1	0	2	3	0	0
3	55423902	.	T	C	1	1	2	0	0	2	0	0
3	55424465	.	C	T	4	5	9	0	0	9	0	0
3	55426258	.	T	C	1	0	1	0	0	1	0	0
3	55438733	.	C	T	1	2	3	0	0	3	0	0
3	56783428	.	G	A	0	1	1	0	1	2	0	0
3	56883657	.	T	C	2	0	2	0	4	6	0	0
3	56883678	.	T	C	3	2	5	0	0	5	0	0
3	57462643	.	A	C	0	7	7	0	0	7	0	0
3	57462962	.	T	C	4	11	15	0	1	16	0	0
3	57603732	.	T	C	3	0	3	0	2	5	0	0
3	57603737	.	C	T	0	5	5	0	0	5	0	0
3	57608888	.	A	G	0	3	3	0	0	3	0	0
3	58197600	.	A	G	0	3	3	2	0	5	0	0
3	58211317	.	T	C	0	3	3	0	0	3	0	0
3	58610890	.	G	A	1	3	4	0	0	4	0	0
3	58615428	.	T	G	3	2	5	1	0	6	0	0
3	58615543	.	G	C	5	3	8	0	0	8	0	0
3	58704605	.	A	C	2	0	2	0	1	3	0	0
3	58704640	.	T	C	1	0	1	0	0	1	0	0
3	58704655	.	C	A	1	0	1	0	0	1	0	0
3	58710350	.	T	C	2	22	24	1	0	25	0	0
3	59961399	.	G	A	9	5	14	0	0	14	0	0
3	59994744	.	G	A	5	4	9	0	0	9	0	0
3	59995019	.	T	G	2	10	12	0	2	14	0	0
3	59995028	.	C	T	2	10	12	0	3	15	0	0
3	59997180	.	C	T	0	3	3	0	1	4	0	0
3	59998195	.	C	T	1	1	2	0	0	2	0	0
3	60002951	.	T	C	3	1	4	0	0	4	0	0
3	60003007	.	T	A	3	4	7	0	0	7	0	0
3	60055155	.	T	C	3	2	5	0	1	6	0	0
3	60073517	.	A	G	2	2	4	0	0	4	0	0
3	60073702	.	G	T	2	2	4	0	1	5	0	0
3	60073756	.	A	G	0	5	5	0	0	5	0	0
3	60073820	.	G	C	0	2	2	0	1	3	0	0
3	60073825	.	T	C	1	2	3	0	0	3	0	0
3	60074497	.	C	G	0	2	2	0	0	2	0	0
3	60099074	.	C	T	2	3	5	0	1	6	0	0
3	60288397	.	C	T	0	1	1	0	0	1	0	0
3	60294089	.	C	G	1	0	1	0	0	1	0	0
3	60526316	.	C	T	0	5	5	0	5	10	0	0
3	60526385	.	G	C	4	5	9	0	3	12	0	0
3	60526426	.	A	G	3	6	9	1	1	11	0	0
3	60526504	.	T	A	3	3	6	0	0	6	0	0
3	60575823	.	T	A	2	3	5	0	0	5	0	0
3	60577258	.	A	T	3	2	5	0	0	5	0	0
3	60577319	.	T	C	1	3	4	0	0	4	0	0
3	60578872	.	G	C	2	2	4	0	0	4	0	0
3	60584225	.	A	G	1	2	3	0	0	3	0	0
3	60589244	.	G	T	1	2	3	0	1	4	0	0
3	60589503	.	G	A	1	2	3	0	0	3	0	0
3	60589725	.	A	G	1	5	6	0	0	6	0	0
3	60590093	.	A	G	1	2	3	0	0	3	0	0
3	60594169	.	A	G	1	2	3	0	0	3	0	0
3	60594197	.	C	G	4	4	8	0	0	8	0	0
3	60596020	.	G	A	1	3	4	0	0	4	0	0
3	60596647	.	A	G	5	1	6	0	0	6	0	0
3	60596651	.	G	A	6	0	6	0	1	7	0	0
3	60596808	.	A	C	6	3	9	0	0	9	0	0
3	60601907	.	A	T	1	0	1	0	0	1	0	0
3	60601958	.	G	A	5	4	9	0	0	9	0	0
3	60685042	.	G	A	2	3	5	0	0	5	0	0
3	60710969	.	C	T	1	2	3	0	0	3	0	0
3	60711017	.	T	C	3	3	6	0	0	6	0	0
3	60731022	.	A	C	1	3	4	0	0	4	0	0
3	60731100	.	A	T	1	3	4	0	0	4	0	0
3	60731132	.	G	A	0	2	2	0	0	2	0	0
3	60731546	.	C	T	2	3	5	0	0	5	0	0
3	60732098	.	A	T	5	2	7	0	0	7	0	0
3	60732306	.	C	A	1	2	3	0	0	3	0	0
3	60732406	.	C	T	1	2	3	0	0	3	0	0
3	60732416	.	G	A	1	2	3	0	0	3	0	0
3	60732551	.	C	T	2	2	4	0	0	4	0	0
3	60732761	.	G	T	0	2	2	0	2	4	0	0
3	60733051	.	G	A	1	4	5	0	2	7	0	0
3	60733056	.	G	A	3	4	7	0	0	7	0	0
3	60795738	.	A	G	1	0	1	0	2	3	0	0
3	60836838	.	G	A	0	2	2	0	3	5	0	0
3	60841113	.	G	A	0	6	6	0	2	8	0	0
3	60841149	.	C	T	2	5	7	0	0	7	0	0
3	60854011	.	C	T	5	1	6	0	0	6	0	0
3	60855800	.	C	T	6	2	8	0	0	8	0	0
3	60855961	.	G	C	2	2	4	0	0	4	0	0
3	60862519	.	G	A	14	7	21	0	1	22	0	0
3	60864804	.	G	A	3	2	5	0	0	5	0	0
3	60875169	.	T	G	3	2	5	0	0	5	0	0
3	60962589	.	T	C	0	1	1	0	0	1	0	0
3	60976921	.	C	T	2	5	7	0	0	7	0	0
3	60977060	.	A	G	7	0	7	0	6	13	0	0
3	60977134	.	T	A	1	0	1	0	0	1	0	0
3	60978344	.	G	A	2	3	5	0	0	5	0	0
3	60978389	.	T	C	6	9	15	0	0	15	0	0
3	60982492	.	A	C	5	4	9	0	1	10	0	0
3	60984213	.	A	G	1	0	1	0	0	1	0	0
3	60985817	.	T	C	2	5	7	0	1	8	0	0
3	60994742	.	G	T	0	6	6	0	3	9	0	0
3	60997781	.	C	G	2	3	5	0	0	5	0	0
3	61004295	.	G	A	0	3	3	0	10	13	0	0
3	61004397	.	C	T	13	9	22	0	0	23	1	0
3	61004442	.	G	T	8	13	21	0	1	22	0	0
3	61030699	.	G	C	11	15	26	0	1	27	0	0
3	61030800	.	G	A	9	5	14	0	1	15	0	0
3	61033183	.	C	T	15	23	38	0	4	42	0	0
3	61033697	.	T	C	17	21	38	0	1	39	0	0
3	61033979	.	C	A	8	18	26	0	1	27	0	0
3	61034024	.	T	C	25	32	57	0	2	59	0	0
3	61034060	.	T	G	22	1	23	0	35	58	0	0
3	61034096	.	T	C	12	32	44	0	5	49	0	0
3	61034139	.	A	C	8	2	10	0	20	30	0	0
3	61043925	.	G	T	2	3	5	0	0	5	0	0
3	61244015	.	C	T	2	1	3	0	0	3	0	0
3	61264122	.	G	A	7	2	9	0	0	9	0	0
3	61278692	.	C	T	2	3	5	0	0	5	0	0
3	61278866	.	C	T	1	2	3	0	0	3	0	0
3	61279085	.	T	C	4	6	10	0	0	10	0	0
3	61279124	.	T	C	3	6	9	0	0	9	0	0
3	61279588	.	T	A	8	3	11	0	0	11	0	0
3	61279781	.	C	T	2	3	5	0	0	5	0	0
3	61279844	.	G	A	0	4	4	0	5	9	0	0
3	61280326	.	G	T	6	10	16	0	0	16	0	0
3	61280350	.	C	G	6	7	13	0	1	14	0	0
3	61280495	.	T	C	5	6	11	0	0	11	0	0
3	61280527	.	G	A	0	5	5	0	7	12	0	0
3	61281592	.	A	G	2	0	2	0	1	3	0	0
3	61281681	.	G	A	0	4	4	0	1	5	0	0
3	61285200	.	G	T	17	13	30	0	2	32	0	0
3	61285224	.	T	A	17	12	29	0	1	30	0	0
3	61285260	.	C	T	10	4	14	0	0	14	0	0
3	61285303	.	G	A	2	6	8	0	1	9	0	0
3	61285310	.	G	C	0	6	6	0	2	8	0	0
3	61285398	.	G	A	4	0	4	0	0	4	0	0
3	61285401	.	C	T	4	0	4	0	0	7	3	0
3	61285437	.	C	T	2	7	9	0	0	9	0	0
3	61285444	.	A	G	2	6	8	0	0	8	0	0
3	61285784	.	C	T	4	8	12	0	4	16	0	0
3	61285947	.	A	G	4	0	4	0	4	8	0	0
3	61286007	.	T	G	1	7	8	0	0	8	0	0
3	61286062	.	T	A	6	7	13	0	0	13	0	0
3	61286065	.	T	G	6	7	13	0	0	13	0	0
3	61286143	.	C	G	10	11	21	0	0	21	0	0
3	61286236	.	A	G	9	0	9	0	16	25	0	0
3	61286414	.	A	T	16	5	21	0	0	21	0	0
3	61286420	.	T	G	15	5	20	0	0	20	0	0
3	61286468	.	C	T	8	6	14	0	1	15	0	0
3	61286639	.	G	T	6	7	13	0	0	13	0	0
3	61286687	.	T	A	4	4	8	0	0	8	0	0
3	61286878	.	T	C	5	12	17	0	0	17	0	0
3	61287260	.	G	T	9	6	15	0	2	18	1	0
3	61287343	.	G	T	10	13	23	0	0	23	0	0
3	61287383	.	T	A	15	11	26	0	0	26	0	0
3	61287395	.	G	A	16	10	26	0	0	26	0	0
3	61287491	.	T	A	8	15	23	0	0	23	0	0
3	61287496	.	T	C	9	14	23	0	0	23	0	0
3	61287590	.	G	T	20	18	38	0	0	38	0	0
3	61288097	.	G	T	18	11	29	0	0	29	0	0
3	61293028	.	A	G	1	3	4	0	0	4	0	0
3	61293531	.	T	G	1	2	3	0	0	3	0	0
3	61297154	.	C	T	1	0	1	0	0	1	0	0
3	61306165	.	A	G	1	1	2	0	0	2	0	0
3	61326352	.	A	C	1	0	1	0	2	3	0	0
3	61342032	.	C	T	0	4	4	0	3	7	0	0
3	61342341	.	G	T	2	4	6	0	0	6	0	0
3	61342368	.	T	C	1	5	6	0	1	7	0	0
3	61342387	.	G	A	1	7	8	0	0	8	0	0
3	61342408	.	G	A	7	4	11	0	0	11	0	0
3	61342423	.	G	C	5	7	12	0	0	12	0	0
3	61342501	.	A	C	9	0	9	0	4	13	0	0
3	61342833	.	T	C	3	0	3	0	5	8	0	0
3	61342891	.	A	G	2	9	11	0	0	11	0	0
3	61343224	.	C	T	3	2	5	0	0	5	0	0
3	61343425	.	T	A	1	6	7	0	0	7	0	0
3	61349477	.	C	T	0	2	2	0	2	4	0	0
3	61349734	.	G	A	7	8	15	0	0	15	0	0
3	61349820	.	A	G	4	6	10	0	0	10	0	0
3	61349931	.	G	T	3	8	11	0	0	11	0	0
3	61350120	.	C	T	3	2	5	0	0	5	0	0
3	61350156	.	A	G	1	2	3	0	0	3	0	0
3	61350303	.	T	G	2	2	4	0	0	4	0	0
3	61350529	.	T	A	1	5	6	0	0	6	0	0
3	61350600	.	T	C	0	3	3	0	0	3	0	0
3	61350648	.	G	A	2	3	5	0	0	5	0	0
3	61350667	.	C	T	2	4	6	0	0	6	0	0
3	61350700	.	C	T	4	2	6	0	0	6	0	0
3	61351073	.	C	T	2	2	4	0	0	4	0	0
3	61354125	.	T	A	1	0	1	0	0	1	0	0
3	61354221	.	A	G	1	3	4	0	1	5	0	0
3	61358195	.	T	C	3	2	5	0	0	5	0	0
3	61358196	.	T	C	3	2	5	0	0	5	0	0
3	61358265	.	C	T	4	2	6	0	1	7	0	0
3	61358269	.	G	A	3	4	7	0	0	7	0	0
3	61358361	.	T	C	1	2	3	0	0	3	0	0
3	61358716	.	G	T	3	2	5	1	0	6	0	0
3	61358739	.	A	C	4	1	5	0	1	6	0	0
3	61359397	.	G	T	5	4	9	0	2	11	0	0
3	61359807	.	A	C	1	5	6	0	0	6	0	0
3	61359843	.	C	G	1	4	5	2	0	7	0	0
3	61360089	.	C	T	0	2	2	0	0	2	0	0
3	61365135	.	G	A	0	2	2	1	0	3	0	0
3	61373027	.	C	G	3	1	4	1	0	5	0	0
3	61382682	.	C	T	0	3	3	2	4	9	0	0
3	61383237	.	A	G	0	4	4	1	0	5	0	0
3	61383492	.	T	C	3	0	3	0	4	7	0	0
3	61391687	.	T	C	8	10	18	0	0	18	0	0
3	61391797	.	G	A	0	13	13	0	3	16	0	0
3	61391953	.	C	A	6	6	12	0	0	12	0	0
3	61395181	.	C	T	2	1	3	0	0	3	0	0
3	61395211	.	G	A	0	5	5	0	4	9	0	0
3	61396523	.	C	T	1	4	5	0	1	6	0	0
3	61397037	.	T	A	8	5	13	0	2	15	0	0
3	61397141	.	G	T	9	5	14	0	1	15	0	0
3	61397248	.	A	G	8	0	8	0	5	13	0	0
3	61397294	.	C	T	7	9	16	0	0	16	0	0
3	61397725	.	A	G	4	1	5	0	0	5	0	0
3	61397744	.	T	A	2	3	5	0	0	5	0	0
3	61398308	.	A	G	3	3	6	0	0	6	0	0
3	61398326	.	A	G	4	3	7	0	0	7	0	0
3	61398505	.	C	G	3	4	7	0	0	7	0	0
3	61398882	.	T	C	2	1	3	0	1	4	0	0
3	61540764	.	C	T	2	3	5	0	0	5	0	0
3	61540804	.	C	G	2	0	2	0	0	5	3	0
3	61540821	.	A	G	2	0	2	0	2	4	0	0
3	61540852	.	G	C	1	1	2	0	0	2	0	0
3	61540861	.	G	A	1	1	2	0	0	2	0	0
3	62091376	.	C	T	1	2	3	0	0	3	0	0
3	62095397	.	T	C	1	10	11	0	1	12	0	0
3	62095404	.	C	T	2	10	12	0	3	15	0	0
3	62329049	.	T	C	6	2	8	0	0	8	0	0
4	316946	.	A	T	19	24	43	0	1	44	0	0
4	317091	.	A	G	13	21	34	0	1	35	0	0
4	317217	.	T	A	10	20	30	0	0	30	0	0
4	317275	.	G	T	8	9	17	0	2	19	0	0
4	317938	.	G	A	4	3	7	0	1	8	0	0
4	325073	.	C	T	6	3	9	0	1	10	0	0
4	325126	.	G	A	7	5	12	0	0	12	0	0
4	325136	.	G	A	6	8	14	0	0	14	0	0
4	325161	.	A	C	6	1	7	0	8	15	0	0
4	329743	.	G	A	0	0	0	0	1	1	0	0
4	329746	.	A	G	0	1	1	0	0	1	0	0
4	349490	.	A	C	5	6	11	0	0	11	0	0
4	349514	.	T	C	4	5	9	0	0	9	0	0
4	350652	.	C	T	2	3	5	0	0	5	0	0
4	351654	.	T	A	2	2	4	0	1	5	0	0
4	351840	.	G	C	3	2	5	0	0	5	0	0
4	351845	.	A	C	2	2	4	0	0	4	0	0
4	352284	.	A	G	6	0	6	0	3	9	0	0
4	352289	.	T	C	6	3	9	0	1	10	0	0
4	352504	.	T	C	8	6	14	0	1	15	0	0
4	353049	.	A	T	4	4	8	0	0	8	0	0
4	353064	.	C	G	3	4	7	0	0	7	0	0
4	353238	.	T	G	8	1	9	0	6	15	0	0
4	353247	.	T	C	8	7	15	0	0	15	0	0
4	353379	.	A	T	10	10	20	0	1	21	0	0
4	353638	.	C	T	0	4	4	0	0	4	0	0
4	353778	.	T	A	1	5	6	0	1	7	0	0
4	357954	.	G	A	2	2	4	0	0	4	0	0
4	362282	.	C	T	3	0	3	0	0	3	0	0
4	367532	.	T	G	1	0	1	0	0	1	0	0
4	385625	.	A	T	4	2	6	0	0	6	0	0
4	385668	.	G	A	12	5	17	0	0	17	0	0
4	385710	.	T	C	18	12	30	0	2	32	0	0
4	386037	.	T	G	21	9	30	0	1	31	0	0
4	386085	.	G	A	15	9	24	0	0	24	0	0
4	386124	.	C	A	5	6	11	0	6	17	0	0
4	386537	.	T	A	15	17	32	0	4	36	0	0
4	386538	.	T	A	18	16	34	0	6	40	0	0
4	394020	.	T	C	21	17	38	0	1	39	0	0
4	397913	.	A	G	6	8	14	0	1	15	0	0
4	647752	.	G	T	0	1	1	0	0	1	0	0
4	659276	.	C	T	2	6	8	0	0	8	0	0
4	659345	.	T	C	0	1	1	0	0	1	0	0
4	660571	.	G	A	5	7	12	0	0	12	0	0
4	660649	.	T	A	3	9	12	0	1	13	0	0
4	660655	.	G	A	0	8	8	0	3	11	0	0
4	660715	.	T	C	7	11	18	0	0	18	0	0
4	667358	.	T	C	3	9	12	0	0	12	0	0
4	667382	.	A	G	3	0	3	0	14	17	0	0
4	674838	.	T	C	3	13	16	0	2	18	0	0
4	675080	.	T	C	6	5	11	0	2	13	0	0
4	676885	.	A	G	5	4	9	0	1	10	0	0
4	678853	.	C	T	8	5	13	0	0	13	0	0
4	679441	.	C	G	0	9	9	0	10	19	0	0
4	680314	.	G	T	7	13	20	0	0	20	0	0
4	680320	.	C	T	9	12	21	0	0	21	0	0
4	680359	.	C	T	7	5	12	0	1	13	0	0
4	680395	.	T	C	2	0	2	0	2	4	0	0
4	680404	.	G	A	0	2	2	0	0	2	0	0
4	685300	.	T	C	0	1	1	0	0	1	0	0
4	686987	.	G	A	0	4	4	0	2	6	0	0
4	686999	.	C	G	3	3	6	0	0	6	0	0
4	687083	.	A	G	2	0	2	0	3	5	0	0
4	694680	.	A	C	6	9	15	0	0	15	0	0
4	694718	.	G	A	4	4	8	0	1	9	0	0
4	694741	.	T	G	0	1	1	0	1	2	0	0
4	694757	.	A	T	0	2	2	0	0	2	0	0
4	695219	.	T	C	1	4	5	0	1	6	0	0
4	695367	.	C	T	0	0	0	0	1	1	0	0
4	700281	.	A	C	6	10	16	0	2	18	0	0
4	700284	.	G	T	0	7	7	0	12	19	0	0
4	700563	.	G	T	6	2	8	0	1	9	0	0
4	700569	.	G	A	1	3	4	0	4	8	0	0
4	700598	.	A	T	3	4	7	0	0	7	0	0
4	700606	.	T	C	3	3	6	0	0	6	0	0
4	702061	.	C	G	2	8	10	0	0	10	0	0
4	702130	.	G	A	1	3	4	0	0	4	0	0
4	736442	.	A	G	7	3	10	0	1	11	0	0
4	737636	.	A	T	10	4	14	0	1	15	0	0
4	737883	.	T	A	4	4	8	0	0	8	0	0
4	737927	.	T	G	0	1	1	0	0	1	0	0
4	740435	.	A	T	3	0	3	0	0	3	0	0
4	740965	.	T	G	7	3	10	0	0	10	0	0
4	749803	.	G	A	18	10	28	0	0	28	0	0
4	749989	.	G	T	6	7	13	0	0	13	0	0
4	750016	.	T	C	3	0	3	0	1	4	0	0
4	750526	.	C	G	1	2	3	0	0	3	0	0
4	750531	.	C	T	3	1	4	0	1	5	0	0
4	750661	.	C	T	0	4	4	0	2	6	0	0
4	751275	.	A	G	2	1	3	0	0	3	0	0
4	751546	.	G	A	9	5	14	0	0	14	0	0
4	751553	.	C	T	8	4	12	0	0	12	0	0
4	751640	.	T	G	5	7	12	0	0	12	0	0
4	753723	.	T	C	3	0	3	0	5	8	0	0
4	755539	.	C	T	3	2	5	0	0	5	0	0
4	765112	.	A	G	7	13	20	0	0	20	0	0
4	766575	.	G	A	7	7	14	0	0	14	0	0
4	766588	.	G	A	7	8	15	0	0	15	0	0
4	766613	.	A	C	6	8	14	0	0	14	0	0
4	769533	.	A	T	0	2	2	0	0	2	0	0
4	772363	.	C	T	4	4	8	0	0	8	0	0
4	777976	.	A	G	2	3	5	0	0	5	0	0
4	778111	.	G	A	0	2	2	0	0	2	0	0
4	779310	.	G	A	1	1	2	0	0	2	0	0
4	779363	.	T	C	3	0	3	0	10	13	0	0
4	779429	.	A	G	9	4	13	0	0	13	0	0
4	779442	.	G	A	10	5	15	0	0	15	0	0
4	783816	.	G	T	21	20	41	0	1	42	0	0
4	783835	.	A	G	19	22	41	0	0	41	0	0
4	784002	.	T	A	29	16	45	0	1	46	0	0
4	784177	.	T	C	22	23	45	0	2	47	0	0
4	784325	.	A	T	12	10	22	0	2	24	0	0
4	784373	.	T	A	4	7	11	0	0	11	0	0
4	784733	.	T	A	6	2	8	0	0	8	0	0
4	784854	.	C	A	7	10	17	0	0	17	0	0
4	784990	.	T	A	15	14	29	0	4	33	0	0
4	785011	.	T	C	13	12	25	0	1	26	0	0
4	785060	.	T	A	15	6	21	0	2	23	0	0
4	785132	.	G	A	19	16	35	0	3	38	0	0
4	787098	.	T	G	2	0	2	0	5	7	0	0
4	788970	.	G	C	8	0	8	0	17	25	0	0
4	789589	.	A	G	10	12	22	0	1	23	0	0
4	798743	.	G	C	3	8	11	0	0	11	0	0
4	798804	.	G	A	11	14	25	0	0	25	0	0
4	798850	.	A	C	18	15	33	0	0	33	0	0
4	798861	.	G	T	18	15	33	0	2	35	0	0
4	799006	.	G	T	20	14	34	0	1	35	0	0
4	799090	.	T	C	13	21	34	0	0	34	0	0
4	799127	.	T	G	13	19	32	0	1	33	0	0
4	799245	.	G	A	17	13	30	0	0	30	0	0
4	799385	.	C	G	8	3	11	0	0	11	0	0
4	799475	.	A	G	13	17	30	0	1	31	0	0
4	799513	.	G	A	16	20	36	0	0	36	0	0
4	799620	.	C	T	26	12	38	0	1	39	0	0
4	799643	.	T	A	23	16	39	0	3	42	0	0
4	799933	.	C	T	16	28	44	0	3	47	0	0
4	800027	.	C	T	19	15	34	0	0	34	0	0
4	800094	.	A	G	18	21	39	0	4	43	0	0
4	800113	.	A	G	20	22	42	0	4	46	0	0
4	800363	.	C	T	3	15	18	0	24	42	0	0
4	800520	.	T	C	12	9	21	0	0	21	0	0
4	802909	.	T	A	16	9	25	0	1	26	0	0
4	803862	.	T	C	5	0	5	0	4	9	0	0
4	806319	.	G	A	4	4	8	0	0	8	0	0
4	806322	.	T	C	4	4	8	0	0	8	0	0
4	807895	.	C	G	2	7	9	0	2	11	0	0
4	807898	.	A	G	2	9	11	0	1	12	0	0
4	808031	.	C	T	0	2	2	0	0	2	0	0
4	809456	.	A	G	8	8	16	0	2	19	1	0
4	809512	.	T	C	15	0	15	0	19	35	1	0
4	809549	.	A	G	7	9	16	0	1	17	0	0
4	813157	.	G	A	2	7	9	0	1	10	0	0
4	813226	.	A	G	10	9	19	0	1	20	0	0
4	824283	.	C	T	0	2	2	0	1	3	0	0
4	861474	.	G	A	3	2	5	0	0	5	0	0
4	862009	.	A	G	4	8	12	0	0	12	0	0
4	864712	.	C	T	7	4	11	0	0	11	0	0
4	867454	.	A	G	0	1	1	0	0	1	0	0
4	870876	.	C	T	3	1	4	0	0	4	0	0
4	872296	.	T	C	0	0	0	0	2	2	0	0
4	872356	.	A	G	1	3	4	0	0	4	0	0
4	873763	.	C	G	4	4	8	0	0	8	0	0
4	874241	.	G	T	1	1	2	0	0	2	0	0
4	874323	.	C	T	0	1	1	0	0	1	0	0
4	880318	.	G	T	1	3	4	0	0	4	0	0
4	880323	.	C	G	1	4	5	0	0	5	0	0
4	880365	.	G	A	1	3	4	0	0	4	0	0
4	880890	.	C	G	2	2	4	0	0	4	0	0
4	881009	.	T	C	1	2	3	0	0	3	0	0
4	881030	.	T	A	1	3	4	0	0	4	0	0
4	881051	.	A	G	2	3	5	0	0	5	0	0
4	881758	.	G	T	1	4	5	0	0	5	0	0
4	882207	.	G	T	0	3	3	0	0	3	0	0
4	883906	.	T	A	1	2	3	0	0	3	0	0
4	905657	.	A	G	3	2	5	0	0	5	0	0
4	958978	.	A	T	5	2	7	0	1	8	0	0
4	959015	.	T	C	3	4	7	0	1	8	0	0
4	961542	.	G	A	3	2	5	0	1	6	0	0
4	967974	.	C	T	1	2	3	0	0	3	0	0
4	968001	.	G	A	0	3	3	0	1	4	0	0
4	969475	.	A	T	1	0	1	0	0	1	0	0
4	969486	.	T	G	2	0	2	0	0	2	0	0
4	971765	.	A	G	1	6	7	0	2	9	0	0
4	971842	.	G	C	0	0	0	0	2	2	0	0
4	974465	.	A	T	0	6	6	0	0	6	0	0
4	974482	.	C	T	5	4	9	0	0	9	0	0
4	975735	.	G	C	0	2	2	0	0	2	0	0
4	975758	.	C	T	8	0	8	0	0	8	0	0
4	975792	.	G	C	0	13	13	0	1	14	0	0
4	975938	.	T	C	1	0	1	0	0	1	0	0
4	982892	.	G	A	2	2	4	0	0	4	0	0
4	982893	.	T	C	2	2	4	0	0	4	0	0
4	986133	.	A	G	1	3	4	0	0	4	0	0
4	986350	.	C	A	0	6	6	0	4	10	0	0
4	1054775	.	G	A	21	12	33	0	2	35	0	0
4	1055200	.	A	G	10	8	18	0	3	21	0	0
4	1055724	.	C	T	20	19	39	0	1	40	0	0
4	1055770	.	A	G	24	16	40	0	1	41	0	0
4	1283626	.	T	C	1	2	3	0	0	3	0	0
4	1283707	.	C	T	1	2	3	0	0	3	0	0
4	1301455	.	G	T	1	2	3	0	0	3	0	0
4	1301582	.	G	A	4	4	8	0	1	9	0	0
4	1301848	.	G	A	1	6	7	0	0	7	0	0
4	1301866	.	A	T	2	4	6	0	2	8	0	0
4	1301921	.	T	C	2	0	2	0	4	6	0	0
4	1302059	.	T	C	4	1	5	0	4	9	0	0
4	1302155	.	A	G	1	8	9	0	0	9	0	0
4	1302385	.	G	A	1	4	5	0	0	5	0	0
4	1302401	.	G	A	2	5	7	0	0	7	0	0
4	1302437	.	A	G	6	5	11	0	0	11	0	0
4	1302485	.	T	C	3	0	3	0	6	9	0	0
4	1302488	.	T	C	3	0	3	0	7	10	0	0
4	1302584	.	A	G	1	3	4	1	1	6	0	0
4	1302609	.	A	G	2	3	5	1	0	6	0	0
4	1302624	.	A	G	1	5	6	1	0	7	0	0
4	1302702	.	C	A	3	7	10	0	0	10	0	0
4	1302785	.	C	T	0	3	3	0	1	4	0	0
4	1303044	.	C	T	2	4	6	0	0	6	0	0
4	1389106	.	C	T	9	10	19	0	0	19	0	0
4	1390926	.	C	T	11	4	15	0	2	17	0	0
4	1390932	.	T	C	10	5	15	0	0	15	0	0
4	1392957	.	G	A	12	6	18	0	0	18	0	0
4	1393032	.	T	A	4	5	9	0	0	9	0	0
4	1393062	.	A	G	3	2	5	0	1	6	0	0
4	1396176	.	C	T	0	1	1	0	0	1	0	0
4	1469788	.	T	C	8	6	14	0	0	15	1	0
4	1469839	.	A	T	5	5	10	0	1	11	0	0
4	1470380	.	C	A	22	13	35	0	0	35	0	0
4	1470693	.	T	C	3	3	6	0	1	7	0	0
4	1470853	.	T	C	4	5	9	0	0	9	0	0
4	1470854	.	T	C	4	5	9	0	0	9	0	0
4	1479855	.	C	A	1	0	1	0	1	2	0	0
4	1497159	.	G	A	3	2	5	0	0	5	0	0
4	1565315	.	G	T	5	3	8	0	0	8	0	0
4	1565336	.	C	T	3	3	6	0	0	6	0	0
4	1565405	.	C	A	4	3	7	0	0	7	0	0
4	1565461	.	A	C	3	2	5	0	1	6	0	0
4	1565462	.	A	C	4	2	6	0	0	6	0	0
4	1565789	.	A	G	5	4	9	0	2	11	0	0
4	1565832	.	G	A	6	6	12	0	0	12	0	0
4	1565901	.	G	A	5	6	11	0	0	11	0	0
4	1566427	.	C	A	8	6	14	0	1	15	0	0
4	1566501	.	T	C	3	3	6	0	1	7	0	0
4	1566502	.	T	G	3	0	3	0	4	7	0	0
4	1839142	.	T	C	3	2	5	0	0	5	0	0
4	1989101	.	T	C	0	0	0	0	4	4	0	0
4	1989156	.	T	C	1	2	3	0	0	3	0	0
4	1994560	.	A	T	1	2	3	0	0	3	0	0
4	1997528	.	C	T	0	1	1	0	1	2	0	0
4	2036617	.	C	A	0	1	1	0	0	1	0	0
4	2044213	.	A	G	15	9	24	0	1	25	0	0
4	2044432	.	G	T	14	11	25	0	1	26	0	0
4	2044517	.	A	G	16	8	24	0	1	25	0	0
4	2044721	.	A	C	1	5	6	0	0	6	0	0
4	2044944	.	T	A	1	3	4	0	0	4	0	0
4	2051223	.	C	G	0	2	2	0	1	3	0	0
4	2051372	.	T	C	1	2	3	0	0	3	0	0
4	2051447	.	A	G	2	3	5	0	0	5	0	0
4	2055103	.	G	T	1	3	4	0	1	5	0	0
4	2055118	.	T	A	1	4	5	0	0	5	0	0
4	2055265	.	G	A	9	13	22	0	5	28	1	0
4	2055318	.	G	A	3	5	8	0	0	8	0	0
4	2056028	.	G	A	15	12	27	0	3	30	0	0
4	2059765	.	C	A	4	10	14	0	0	14	0	0
4	2059801	.	T	A	12	5	17	0	0	17	0	0
4	2059831	.	C	G	11	10	21	0	0	21	0	0
4	2059846	.	A	T	10	7	17	0	0	17	0	0
4	2060125	.	T	C	3	2	5	0	0	5	0	0
4	2060134	.	C	T	0	1	1	0	1	2	0	0
4	2061214	.	G	A	4	3	7	0	0	7	0	0
4	2062085	.	A	G	5	5	10	0	1	11	0	0
4	2062133	.	G	A	10	12	22	0	0	22	0	0
4	2062237	.	T	A	9	5	14	0	1	15	0	0
4	2151743	.	G	A	4	5	9	0	1	10	0	0
4	2160995	.	G	A	1	5	6	0	0	6	0	0
4	2162664	.	T	G	4	3	7	0	1	8	0	0
4	2162726	.	C	G	0	9	9	0	9	18	0	0
4	2162798	.	G	A	10	10	20	0	0	20	0	0
4	2162804	.	A	G	12	10	22	0	0	22	0	0
4	2163521	.	A	G	3	2	5	0	0	5	0	0
4	2260515	.	T	C	3	0	3	0	1	4	0	0
4	2349386	.	G	A	5	5	10	0	0	10	0	0
4	2349391	.	C	T	4	5	9	0	0	9	0	0
4	2349527	.	A	G	5	10	15	0	0	15	0	0
4	2349542	.	A	T	6	9	15	0	1	16	0	0
4	2349576	.	A	C	6	11	17	0	1	18	0	0
4	2349656	.	T	C	1	2	3	0	5	8	0	0
4	2349798	.	G	A	5	10	15	0	0	15	0	0
4	2349805	.	G	T	6	9	15	0	1	16	0	0
4	2368016	.	A	G	3	4	7	0	0	7	0	0
4	2396616	.	C	T	1	2	3	0	0	3	0	0
4	2404872	.	A	G	1	3	4	0	0	4	0	0
4	2506611	.	C	T	3	4	7	0	0	7	0	0
4	2508427	.	A	C	12	6	18	0	0	18	0	0
4	2511830	.	C	T	23	17	40	1	1	42	0	0
4	2511921	.	T	C	17	16	33	0	0	33	0	0
4	2511991	.	A	T	19	11	30	0	2	32	0	0
4	2514580	.	G	A	1	4	5	0	0	5	0	0
4	2514596	.	C	A	1	2	3	0	1	4	0	0
4	2516385	.	G	A	1	2	3	0	0	3	0	0
4	2525925	.	A	T	2	4	6	0	0	6	0	0
4	2534255	.	C	T	1	1	2	0	0	2	0	0
4	2534258	.	A	G	1	1	2	0	0	2	0	0
4	2548836	.	C	T	1	5	6	0	0	6	0	0
4	2548838	.	T	C	1	5	6	0	0	6	0	0
4	2549121	.	T	C	2	5	7	0	0	7	0	0
4	2550932	.	T	C	0	2	2	0	1	3	0	0
4	2550934	.	C	T	0	2	2	0	1	3	0	0
4	2554997	.	G	A	0	1	1	0	0	1	0	0
4	2556364	.	A	C	1	0	1	0	0	1	0	0
4	2559498	.	A	G	4	1	5	0	0	5	0	0
4	2563181	.	G	A	1	2	3	0	0	3	0	0
4	2571695	.	T	A	0	3	3	0	0	3	0	0
4	2571701	.	A	G	0	2	2	0	0	2	0	0
4	2573559	.	G	T	0	2	2	0	0	2	0	0
4	2620973	.	C	A	9	13	22	0	0	22	0	0
4	2621086	.	G	A	12	6	18	0	0	18	0	0
4	2621186	.	G	A	10	7	17	0	2	19	0	0
4	2621761	.	T	C	4	6	10	0	0	10	0	0
4	2622344	.	G	C	18	9	27	0	1	28	0	0
4	2622496	.	T	C	13	14	27	0	1	28	0	0
4	2622529	.	C	A	14	15	29	0	1	30	0	0
4	2638351	.	A	T	1	1	2	0	0	2	0	0
4	2642254	.	T	A	0	5	5	0	0	5	0	0
4	2662696	.	A	G	1	3	4	0	0	4	0	0
4	2665830	.	C	T	2	4	6	0	5	11	0	0
4	2666037	.	T	C	6	1	7	0	3	10	0	0
4	2666085	.	G	C	3	3	6	0	0	6	0	0
4	2666219	.	T	C	5	3	8	0	0	8	0	0
4	2675061	.	T	C	5	4	9	0	0	9	0	0
4	2675148	.	C	T	11	3	14	0	1	15	0	0
4	2675235	.	C	T	6	12	18	0	3	21	0	0
4	2752987	.	C	T	2	3	5	0	0	5	0	0
4	2773997	.	G	A	1	1	2	0	0	2	0	0
4	2866721	.	C	A	1	1	2	0	0	2	0	0
4	2866748	.	T	C	0	2	2	0	1	3	0	0
4	2867111	.	C	A	3	4	7	0	0	7	0	0
4	2867168	.	G	A	1	4	5	0	0	5	0	0
4	2867795	.	C	T	2	2	4	0	2	6	0	0
4	3337690	.	A	G	0	4	4	1	0	5	0	0
4	3338195	.	A	G	4	2	6	0	1	7	0	0
4	3474618	.	A	G	3	2	5	0	0	5	0	0
4	4079716	.	T	C	1	3	4	0	1	5	0	0
4	4090438	.	C	T	1	1	2	0	0	2	0	0
4	4104264	.	A	G	0	0	0	0	6	6	0	0
4	4111070	.	A	G	8	5	13	0	1	14	0	0
4	4111229	.	A	T	6	9	15	0	0	15	0	0
4	4111396	.	T	C	11	11	22	0	0	22	0	0
4	4111673	.	G	A	3	2	5	0	0	5	0	0
4	4117480	.	T	C	1	3	4	0	0	4	0	0
4	4119344	.	G	A	1	2	3	0	0	3	0	0
4	4120825	.	C	T	1	1	2	0	0	2	0	0
4	4120854	.	C	T	1	3	4	0	0	4	0	0
4	4120872	.	A	G	1	4	5	0	0	5	0	0
4	4122577	.	G	A	2	3	5	0	0	5	0	0
4	4122586	.	G	A	1	2	3	0	0	3	0	0
4	4232578	.	T	A	1	2	3	0	0	3	0	0
4	4232886	.	C	G	3	0	3	0	3	6	0	0
4	4232994	.	T	C	4	3	7	0	0	7	0	0
4	4233088	.	T	C	6	2	8	0	0	8	0	0
4	4235162	.	A	G	19	26	45	0	3	48	0	0
4	4238175	.	C	T	0	4	4	0	2	6	0	0
4	4240177	.	T	C	0	8	8	0	1	9	0	0
4	4243084	.	G	A	2	7	9	0	1	10	0	0
4	4249690	.	G	A	0	2	2	0	0	2	0	0
4	4258884	.	A	G	0	2	2	0	0	2	0	0
4	4258927	.	T	C	3	12	15	0	0	15	0	0
4	4258951	.	C	T	5	15	20	0	1	21	0	0
4	4331151	.	C	T	1	1	2	0	0	2	0	0
4	4348785	.	C	T	5	3	8	0	0	8	0	0
4	4348902	.	A	G	0	0	0	0	1	1	0	0
4	4355791	.	G	T	0	4	4	0	8	12	0	0
4	4357003	.	G	T	3	1	4	0	0	4	0	0
4	4357023	.	G	T	1	3	4	0	0	4	0	0
4	4357073	.	A	G	12	4	16	0	0	16	0	0
4	4357173	.	C	T	6	6	12	0	1	13	0	0
4	4357175	.	G	A	6	6	12	0	1	13	0	0
4	4357757	.	C	T	5	2	7	0	0	7	0	0
4	4358201	.	G	A	0	3	3	0	1	4	0	0
4	4358471	.	C	T	10	12	22	0	0	22	0	0
4	4358610	.	C	A	10	10	20	0	0	20	0	0
4	4484788	.	A	G	15	14	29	0	1	30	0	0
4	4484914	.	T	A	16	14	30	0	1	31	0	0
4	4485186	.	A	T	18	18	36	1	6	43	0	0
4	4485247	.	A	T	17	23	40	0	0	40	0	0
4	4485306	.	T	C	22	15	37	0	3	41	1	0
4	4485534	.	C	A	10	17	27	0	1	28	0	0
4	4485650	.	A	T	9	13	22	0	1	23	0	0
4	4485736	.	T	G	14	18	32	0	0	32	0	0
4	4485793	.	C	G	16	11	27	0	1	28	0	0
4	4488137	.	A	G	6	6	12	0	0	12	0	0
4	4488207	.	G	A	14	5	19	0	1	20	0	0
4	4491740	.	T	C	7	1	8	0	3	11	0	0
4	4491782	.	T	C	5	1	6	0	3	9	0	0
4	4492003	.	C	T	4	2	6	0	3	9	0	0
4	4492336	.	A	G	2	2	4	0	0	4	0	0
4	4492369	.	C	A	1	4	5	0	5	10	0	0
4	4492444	.	A	G	1	4	5	0	0	5	0	0
4	4492456	.	T	C	1	0	1	0	2	3	0	0
4	4494733	.	C	A	2	2	4	0	0	4	0	0
4	4514215	.	A	G	5	0	5	0	4	9	0	0
4	4516310	.	G	C	0	12	12	0	12	24	0	0
4	4516313	.	A	G	12	1	13	0	12	25	0	0
4	4516346	.	C	T	10	11	21	0	1	22	0	0
4	4519688	.	G	A	7	9	16	0	1	17	0	0
4	4519697	.	T	C	6	7	13	0	0	13	0	0
4	4523403	.	C	G	10	22	32	0	0	32	0	0
4	4523579	.	T	C	23	30	53	0	2	55	0	0
4	4523885	.	A	C	13	17	30	0	0	30	0	0
4	4524215	.	T	A	2	7	9	0	0	9	0	0
4	4635691	.	C	G	15	17	32	0	0	32	0	0
4	4638701	.	G	C	1	0	1	0	0	1	0	0
4	4640605	.	G	A	12	8	20	0	0	20	0	0
4	4640614	.	G	A	12	8	20	0	0	20	0	0
4	4647977	.	A	G	9	7	16	0	0	16	0	0
4	4653380	.	A	C	2	0	2	0	1	3	0	0
4	4657961	.	G	A	2	3	5	0	0	5	0	0
4	4706819	.	C	T	1	7	8	0	8	16	0	0
4	4706825	.	C	G	9	7	16	0	2	18	0	0
4	4712951	.	G	A	3	2	5	0	0	5	0	0
4	4713962	.	T	A	2	3	5	0	0	5	0	0
4	4713982	.	C	G	2	2	4	0	0	4	0	0
4	4714109	.	C	A	2	2	4	0	0	4	0	0
4	4714743	.	A	T	1	2	3	0	0	3	0	0
4	4751738	.	T	C	1	3	4	0	0	4	0	0
4	4753372	.	T	A	0	1	1	0	1	2	0	0
4	4754474	.	A	G	4	8	12	0	0	12	0	0
4	4762804	.	T	A	2	0	2	0	1	3	0	0
4	4768062	.	T	C	3	0	3	0	3	6	0	0
4	4782962	.	A	C	5	5	10	0	0	10	0	0
4	4783059	.	A	T	9	7	16	0	0	16	0	0
4	4783067	.	C	T	11	6	17	0	0	17	0	0
4	4784802	.	G	A	2	7	9	0	0	9	0	0
4	4831630	.	T	G	4	6	10	0	0	10	0	0
4	4831660	.	G	A	3	4	7	0	2	9	0	0
4	4831722	.	A	C	5	3	8	0	1	9	0	0
4	4831759	.	C	A	6	4	10	0	1	11	0	0
4	4831763	.	A	T	6	4	10	0	1	11	0	0
4	4831885	.	A	C	3	5	8	0	0	8	0	0
4	4831898	.	T	C	4	4	8	0	0	8	0	0
4	4831968	.	A	C	3	6	9	0	0	9	0	0
4	4832241	.	A	G	9	8	17	0	2	19	0	0
4	4834125	.	G	A	2	1	3	0	0	3	0	0
4	4834497	.	A	G	11	12	23	0	0	23	0	0
4	4834526	.	T	C	10	9	19	0	0	19	0	0
4	4894486	.	C	A	3	2	5	0	0	5	0	0
4	4902137	.	A	C	3	2	5	0	1	6	0	0
4	4902425	.	G	C	7	10	17	0	0	17	0	0
4	4908409	.	C	T	0	3	3	0	0	3	0	0
4	4911071	.	C	T	2	2	4	0	0	4	0	0
4	4911247	.	A	G	3	0	3	0	0	3	0	0
4	4913422	.	C	T	4	6	10	0	0	10	0	0
4	4914832	.	A	G	3	6	9	0	0	9	0	0
4	4921733	.	T	C	7	10	17	0	2	19	0	0
4	4921773	.	G	A	0	4	4	0	3	7	0	0
4	4923290	.	A	T	11	4	15	0	1	16	0	0
4	4923323	.	C	T	3	2	5	0	0	5	0	0
4	4923755	.	T	G	6	6	12	0	0	12	0	0
4	4925611	.	C	T	6	3	9	0	0	9	0	0
4	4926035	.	G	A	3	9	12	0	1	13	0	0
4	4926037	.	G	T	9	4	13	0	0	13	0	0
4	4966169	.	T	A	5	2	7	0	0	7	0	0
4	4971354	.	C	A	6	5	11	0	1	12	0	0
4	4971836	.	T	C	4	3	7	0	0	7	0	0
4	4971847	.	T	A	5	3	8	0	0	8	0	0
4	4971911	.	G	T	5	10	15	0	1	16	0	0
4	4972056	.	C	T	7	8	15	0	0	15	0	0
4	4972533	.	G	A	9	9	18	0	2	20	0	0
4	4972555	.	G	C	9	10	19	0	0	19	0	0
4	4972664	.	G	T	6	4	10	0	0	10	0	0
4	4973053	.	G	A	5	3	8	0	1	9	0	0
4	4975329	.	C	G	2	2	4	0	0	4	0	0
4	4985789	.	G	A	0	2	2	0	0	2	0	0
4	4992114	.	A	C	1	1	2	0	0	2	0	0
4	5025964	.	G	C	17	15	32	0	2	34	0	0
4	5026355	.	T	C	4	4	8	0	0	8	0	0
4	5042755	.	C	T	6	6	12	0	1	13	0	0
4	5048903	.	C	T	4	4	8	0	1	9	0	0
4	5094237	.	C	T	5	10	15	0	0	15	0	0
4	5097421	.	C	T	0	0	0	0	3	3	0	0
4	5098152	.	G	A	4	0	4	0	0	4	0	0
4	5098507	.	A	G	1	2	3	0	0	3	0	0
4	5102316	.	A	C	5	0	5	0	4	9	0	0
4	5104859	.	G	A	2	2	4	0	1	5	0	0
4	5158749	.	C	T	5	2	7	0	0	7	0	0
4	5161241	.	G	T	2	5	7	0	0	7	0	0
4	5161256	.	A	C	4	5	9	0	1	10	0	0
4	5200306	.	T	C	0	1	1	0	0	1	0	0
4	5240203	.	A	C	22	4	26	0	26	52	0	0
4	5240265	.	C	T	25	17	42	2	2	46	0	0
4	5240472	.	T	A	22	27	49	1	2	53	1	0
4	5240505	.	A	G	30	18	48	0	4	52	0	0
4	5242055	.	T	G	3	12	15	0	1	16	0	0
4	5242300	.	C	G	5	5	10	0	1	11	0	0
4	5243657	.	C	A	0	5	5	0	0	5	0	0
4	5244568	.	C	A	0	3	3	0	1	4	0	0
4	5244789	.	G	A	1	0	1	1	0	2	0	0
4	5247107	.	G	A	22	19	41	0	2	43	0	0
4	5247127	.	G	C	26	21	47	0	0	47	0	0
4	5247145	.	C	T	0	17	17	0	29	46	0	0
4	5255128	.	C	A	12	16	28	0	2	30	0	0
4	5255148	.	C	T	15	16	31	0	2	33	0	0
4	5255180	.	T	C	10	8	18	0	1	19	0	0
4	5256482	.	A	G	9	9	18	0	1	19	0	0
4	5256659	.	A	G	9	1	10	0	9	19	0	0
4	5256674	.	G	T	11	6	17	0	1	18	0	0
4	5256737	.	A	G	4	9	13	0	0	13	0	0
4	5269608	.	G	A	10	10	20	0	0	20	0	0
4	5269660	.	C	G	18	13	31	0	0	31	0	0
4	5291755	.	T	C	10	4	14	0	1	15	0	0
4	5291794	.	T	C	1	2	3	0	1	4	0	0
4	5302127	.	C	T	0	16	16	0	22	38	0	0
4	5302195	.	A	G	13	12	25	0	0	25	0	0
4	5302327	.	G	A	9	8	17	0	1	18	0	0
4	5302689	.	G	A	4	2	6	0	0	6	0	0
4	5318995	.	G	A	3	6	9	0	2	11	0	0
4	5324871	.	G	T	14	7	21	0	0	21	0	0
4	5325105	.	C	T	13	14	27	1	0	28	0	0
4	5329849	.	G	A	4	2	6	0	1	7	0	0
4	5329850	.	G	A	2	4	6	0	1	7	0	0
4	5330192	.	C	A	0	3	3	0	1	4	0	0
4	5331720	.	G	A	5	5	10	0	2	12	0	0
4	5334029	.	G	C	3	3	6	0	0	6	0	0
4	5334061	.	G	A	3	2	5	0	0	5	0	0
4	5338909	.	T	A	11	3	14	0	2	16	0	0
4	5338950	.	G	T	5	5	10	0	1	11	0	0
4	5339053	.	T	A	7	17	24	0	0	24	0	0
4	5363600	.	G	C	2	2	4	0	0	4	0	0
4	5363744	.	A	C	3	6	9	0	0	9	0	0
4	5363760	.	A	T	4	6	10	0	0	10	0	0
4	5363836	.	G	A	6	4	10	0	0	10	0	0
4	5364786	.	G	T	3	2	5	0	0	5	0	0
4	5365307	.	C	T	1	1	2	0	0	2	0	0
4	5365325	.	C	T	1	1	2	0	0	2	0	0
4	5365359	.	A	G	2	2	4	0	0	4	0	0
4	5365399	.	G	A	4	5	9	0	0	9	0	0
4	5366462	.	C	G	1	3	4	0	0	4	0	0
4	5366765	.	G	A	1	5	6	0	1	7	0	0
4	5366789	.	G	A	4	3	7	0	0	7	0	0
4	5367455	.	G	A	1	2	3	0	0	3	0	0
4	5423999	.	T	C	1	0	1	0	1	2	0	0
4	5456777	.	T	G	0	1	1	0	3	4	0	0
4	5521510	.	C	T	12	12	24	0	0	24	0	0
4	5521996	.	G	T	16	6	22	0	2	24	0	0
4	5522154	.	G	T	17	10	27	0	1	28	0	0
4	5522161	.	C	T	8	17	25	0	1	26	0	0
4	5522298	.	C	A	4	3	7	0	0	7	0	0
4	5530189	.	G	A	0	2	2	0	1	3	0	0
4	5595171	.	C	T	6	3	9	0	0	9	0	0
4	5643321	.	G	A	0	2	2	0	0	2	0	0
4	5644808	.	G	A	6	6	12	0	0	12	0	0
4	5644974	.	G	A	5	14	19	0	0	19	0	0
4	5645097	.	C	T	4	8	12	0	0	12	0	0
4	5645116	.	T	G	1	7	8	0	2	10	0	0
4	5645155	.	T	C	0	0	0	0	2	2	0	0
4	5665612	.	T	C	3	0	3	0	8	11	0	0
4	5742551	.	G	A	14	7	21	0	0	21	0	0
4	5742831	.	A	C	14	17	31	0	2	33	0	0
4	5742846	.	C	T	16	19	35	0	1	36	0	0
4	5742936	.	G	A	1	20	21	0	9	30	0	0
4	5742962	.	A	T	14	13	27	0	1	28	0	0
4	5743027	.	A	G	12	10	22	0	2	24	0	0
4	5750854	.	G	A	8	9	17	0	3	20	0	0
4	5750884	.	T	A	14	10	24	0	0	24	0	0
4	5750924	.	A	G	7	5	12	0	0	12	0	0
4	5751381	.	A	C	8	14	22	0	0	22	0	0
4	5751382	.	C	T	0	13	13	0	9	22	0	0
4	5751551	.	G	A	8	6	14	0	2	16	0	0
4	5755018	.	C	T	0	7	7	0	6	13	0	0
4	5755027	.	C	T	0	5	5	0	7	12	0	0
4	5757253	.	C	T	3	5	8	0	0	8	0	0
4	5759617	.	T	G	6	3	9	0	0	9	0	0
4	5763975	.	G	A	15	9	24	0	1	25	0	0
4	5764128	.	T	A	6	13	19	0	3	22	0	0
4	5765181	.	C	T	2	2	4	0	0	4	0	0
4	5765183	.	C	T	2	2	4	0	0	4	0	0
4	5765247	.	A	G	3	2	5	0	0	5	0	0
4	5765516	.	T	G	1	4	5	0	1	6	0	0
4	5765529	.	T	G	1	7	8	0	0	8	0	0
4	5765985	.	C	A	3	5	8	0	0	9	1	0
4	5766063	.	G	A	4	2	6	0	0	6	0	0
4	5766156	.	C	T	0	8	8	0	5	13	0	0
4	5766200	.	T	A	5	9	14	0	0	14	0	0
4	5766315	.	G	A	7	10	17	0	1	18	0	0
4	5785957	.	G	T	1	3	4	0	1	5	0	0
4	5786267	.	G	T	3	3	6	0	0	6	0	0
4	5786961	.	T	C	1	0	1	0	1	2	0	0
4	5794344	.	C	T	1	0	1	0	0	1	0	0
4	5806252	.	T	A	2	2	4	0	0	4	0	0
4	5806303	.	C	T	2	2	4	0	0	4	0	0
4	5806312	.	C	A	2	2	4	0	0	4	0	0
4	5806708	.	T	C	3	2	5	0	0	5	0	0
4	5834459	.	C	T	2	3	5	0	0	5	0	0
4	5835612	.	C	T	2	2	4	0	0	4	0	0
4	5835688	.	T	G	2	5	7	0	0	7	0	0
4	5835733	.	G	A	1	2	3	0	0	3	0	0
4	5838505	.	G	A	2	4	6	0	1	7	0	0
4	5849003	.	C	A	4	5	9	0	0	9	0	0
4	5849180	.	A	G	8	1	9	0	8	17	0	0
4	5849225	.	G	A	6	2	8	0	0	8	0	0
4	5849282	.	C	T	5	2	7	0	2	9	0	0
4	5849295	.	T	A	5	2	7	0	0	7	0	0
4	5850169	.	T	C	3	8	11	0	1	12	0	0
4	5850281	.	T	C	9	11	20	0	2	22	0	0
4	5850297	.	A	G	9	9	18	0	1	19	0	0
4	5850800	.	C	T	3	4	7	0	0	7	0	0
4	5851097	.	C	G	2	2	4	0	0	4	0	0
4	5892269	.	T	C	1	2	3	0	0	3	0	0
4	5905677	.	C	T	1	2	3	0	0	3	0	0
4	5907465	.	G	T	0	2	2	0	2	4	0	0
4	5908763	.	T	C	5	5	10	0	0	10	0	0
4	5908764	.	C	T	5	5	10	0	0	10	0	0
4	5910137	.	A	G	3	2	5	0	0	5	0	0
4	5910302	.	C	T	4	6	10	0	0	10	0	0
4	5910492	.	A	G	12	11	23	0	13	36	0	0
4	5910516	.	A	G	10	24	34	0	4	38	0	0
4	5910644	.	G	A	18	35	53	0	1	54	0	0
4	5912445	.	C	T	3	0	3	0	0	3	0	0
4	5912475	.	G	A	8	10	18	0	0	18	0	0
4	5912707	.	A	G	4	1	5	0	0	5	0	0
4	6432112	.	G	A	3	2	5	0	2	7	0	0
4	6449366	.	G	A	0	3	3	0	0	3	0	0
4	6455849	.	G	A	5	4	9	0	0	9	0	0
4	6507418	.	C	T	1	2	3	0	0	3	0	0
4	6507474	.	A	C	0	4	4	0	0	4	0	0
4	6639440	.	A	G	12	10	22	1	0	23	0	0
4	6639665	.	G	A	9	15	24	0	1	25	0	0
4	6639786	.	C	T	15	15	30	0	0	30	0	0
4	6640145	.	G	C	10	16	26	0	1	27	0	0
4	6640156	.	T	C	9	16	25	0	1	26	0	0
4	6645994	.	C	T	14	19	33	0	1	34	0	0
4	6646283	.	A	C	11	9	20	0	1	21	0	0
4	6646851	.	G	A	9	17	26	0	1	27	0	0
4	6749054	.	T	C	2	4	6	0	0	6	0	0
4	6749060	.	C	G	1	4	5	0	0	5	0	0
4	6799942	.	A	G	27	26	53	0	3	56	0	0
4	6800153	.	T	C	17	13	30	0	3	33	0	0
4	6800162	.	C	T	17	13	30	0	1	31	0	0
4	6800393	.	G	A	9	3	12	0	1	13	0	0
4	6802173	.	T	G	14	7	21	0	3	24	0	0
4	6802506	.	A	C	13	11	24	0	1	25	0	0
4	6802518	.	C	G	0	15	15	0	16	31	0	0
4	6946831	.	G	A	1	1	2	0	0	2	0	0
4	6960365	.	G	A	0	1	1	0	2	3	0	0
4	6960377	.	C	T	2	2	4	0	0	4	0	0
4	6990096	.	C	T	11	7	18	0	3	21	0	0
4	6990392	.	G	T	1	2	3	0	1	4	0	0
4	6990421	.	T	C	1	4	5	0	1	6	0	0
4	6990621	.	G	A	0	7	7	0	9	16	0	0
4	6990632	.	A	G	7	7	14	0	0	14	0	0
4	6990682	.	G	A	4	5	9	0	1	10	0	0
4	6990882	.	C	T	7	10	17	0	0	17	0	0
4	6990886	.	C	A	9	6	15	0	2	17	0	0
4	6991272	.	G	A	1	2	3	0	0	3	0	0
4	6991764	.	G	T	7	5	12	0	0	12	0	0
4	6992264	.	G	T	13	15	28	0	0	28	0	0
4	6992744	.	C	T	8	11	19	0	0	19	0	0
4	6992918	.	G	C	17	9	26	0	1	27	0	0
4	7211013	.	G	A	20	15	35	0	0	35	0	0
4	7211097	.	C	T	17	13	30	0	2	32	0	0
4	7211264	.	A	G	23	14	37	0	1	38	0	0
4	7211364	.	C	T	0	15	15	0	10	25	0	0
4	7212228	.	G	A	2	7	9	0	1	10	0	0
4	7212236	.	G	A	3	8	11	0	0	11	0	0
4	7212342	.	G	A	2	6	8	0	0	8	0	0
4	7212461	.	G	A	6	6	12	0	0	12	0	0
4	7212606	.	A	G	7	6	13	0	1	14	0	0
4	7212624	.	G	A	6	7	13	0	0	13	0	0
4	7222118	.	G	T	4	4	8	0	0	8	0	0
4	7476736	.	C	T	1	0	1	0	1	2	0	0
4	7546046	.	T	A	1	2	3	0	0	3	0	0
4	7652726	.	G	A	5	3	8	0	0	8	0	0
4	7653670	.	T	C	2	1	3	0	1	4	0	0
4	7653671	.	T	A	3	1	4	0	0	4	0	0
4	7664811	.	G	A	0	2	2	0	1	3	0	0
4	7665110	.	T	A	1	0	1	0	0	1	0	0
4	7666747	.	C	T	0	1	1	0	0	1	0	0
4	7668432	.	G	A	2	0	2	0	0	2	0	0
4	7668510	.	A	G	0	2	2	0	0	2	0	0
4	7668516	.	G	A	0	1	1	0	0	1	0	0
4	7713041	.	A	G	5	0	5	0	1	6	0	0
4	7713176	.	C	T	1	3	4	0	0	4	0	0
4	7713513	.	G	A	1	2	3	0	0	3	0	0
4	7718868	.	C	T	6	11	17	0	2	19	0	0
4	7726665	.	G	A	1	1	2	0	0	2	0	0
4	7726752	.	T	C	3	3	6	0	0	6	0	0
4	7729807	.	G	A	4	3	7	0	0	7	0	0
4	7737468	.	G	T	5	4	9	0	0	9	0	0
4	7743092	.	C	T	0	5	5	0	5	10	0	0
4	7870444	.	A	T	2	1	3	0	1	4	0	0
4	7870599	.	T	C	3	4	7	0	0	7	0	0
4	7870624	.	T	C	3	2	5	0	0	5	0	0
4	7870913	.	T	G	7	7	14	0	1	15	0	0
4	7870952	.	C	T	0	7	7	0	9	16	0	0
4	7870983	.	C	T	8	8	16	0	1	17	0	0
4	7871084	.	A	C	1	0	1	0	0	1	0	0
4	7872637	.	G	A	1	0	1	0	0	1	0	0
4	7875901	.	T	G	1	0	1	0	0	1	0	0
4	7875917	.	A	T	1	0	1	0	0	1	0	0
4	7881534	.	C	G	6	0	6	0	7	13	0	0
4	7883462	.	A	C	4	9	13	0	0	13	0	0
4	7883466	.	G	A	4	9	13	0	0	13	0	0
4	7888181	.	A	C	3	3	6	0	0	6	0	0
4	7943958	.	C	T	1	0	1	0	0	1	0	0
4	8609608	.	T	A	1	7	8	0	1	9	0	0
4	8609620	.	A	T	5	5	10	0	0	10	0	0
4	8609648	.	G	A	3	5	8	0	0	8	0	0
4	8609799	.	T	C	11	8	19	0	0	19	0	0
4	8680965	.	C	T	7	7	14	0	0	14	0	0
4	8681039	.	C	T	1	0	1	0	0	1	0	0
4	8697269	.	A	G	1	5	6	0	0	6	0	0
4	8702687	.	G	A	1	4	5	0	1	6	0	0
4	8702729	.	C	A	5	4	9	0	0	9	0	0
4	8702765	.	C	T	2	4	6	0	0	6	0	0
4	8704655	.	C	T	6	5	11	0	1	12	0	0
4	8706385	.	G	A	8	6	14	0	1	15	0	0
4	8706412	.	G	T	7	6	13	0	0	13	0	0
4	8706716	.	A	G	8	7	15	0	1	16	0	0
4	8706855	.	A	T	4	6	10	0	1	11	0	0
4	8707154	.	C	T	9	12	21	0	0	21	0	0
4	8707182	.	T	C	9	11	20	0	1	21	0	0
4	8707381	.	A	G	1	5	6	0	0	6	0	0
4	8781919	.	T	A	0	1	1	0	0	1	0	0
4	8797201	.	T	A	16	15	31	0	2	33	0	0
4	8797234	.	T	A	15	16	31	0	3	34	0	0
4	8797315	.	T	C	22	14	36	0	0	36	0	0
4	8803071	.	C	T	3	5	8	0	1	9	0	0
4	8805792	.	T	C	8	10	18	0	2	20	0	0
4	8808775	.	C	T	16	4	20	0	1	21	0	0
4	8808823	.	C	T	16	27	43	0	1	44	0	0
4	8808974	.	C	T	27	18	45	0	4	49	0	0
4	8809268	.	T	G	32	18	50	0	2	52	0	0
4	8809431	.	T	G	9	14	23	0	1	24	0	0
4	8809444	.	T	G	14	10	24	0	0	24	0	0
4	8809506	.	A	T	18	6	24	0	0	25	1	0
4	8809544	.	C	G	23	0	23	0	21	44	0	0
4	8809690	.	G	T	0	14	14	0	1	15	0	0
4	8809695	.	C	T	0	23	23	0	0	23	0	0
4	8809772	.	T	A	3	6	9	1	0	10	0	0
4	8810200	.	G	T	15	9	24	0	1	25	0	0
4	8810367	.	A	C	27	21	48	0	2	50	0	0
4	8810474	.	A	T	20	28	48	1	2	51	0	0
4	8810597	.	A	T	29	18	47	0	1	48	0	0
4	8810607	.	C	T	25	17	42	0	0	42	0	0
4	8851503	.	T	A	13	10	23	0	1	25	1	0
4	8851547	.	A	G	9	26	35	0	0	35	0	0
4	8851740	.	G	A	8	13	21	0	0	21	0	0
4	8851864	.	G	A	14	7	21	0	0	21	0	0
4	8851999	.	C	T	11	10	21	0	1	22	0	0
4	8852085	.	G	T	11	13	24	0	0	24	0	0
4	8854403	.	G	T	11	10	21	0	0	21	0	0
4	8857562	.	T	G	1	1	2	0	0	2	0	0
4	8898917	.	C	T	0	9	9	0	8	17	0	0
4	8898939	.	G	A	8	5	13	0	1	14	0	0
4	8903051	.	T	A	1	0	1	0	0	1	0	0
4	9012215	.	T	G	0	0	0	0	1	1	0	0
4	9012218	.	T	C	0	1	1	0	0	1	0	0
4	9012258	.	A	T	2	3	5	0	0	5	0	0
4	9017996	.	C	T	2	0	2	0	0	2	0	0
4	9021369	.	T	C	4	7	11	0	0	11	0	0
4	9024665	.	T	G	10	7	17	0	1	18	0	0
4	9024671	.	A	G	8	7	15	0	0	15	0	0
4	9024720	.	A	C	12	9	21	0	0	21	0	0
4	9024784	.	A	G	14	11	25	0	0	25	0	0
4	9024807	.	A	G	12	14	26	0	1	27	0	0
4	9028868	.	T	C	1	4	5	0	0	5	0	0
4	9045979	.	C	T	0	0	0	0	1	1	0	0
4	9048957	.	G	T	3	3	6	0	0	6	0	0
4	9070929	.	T	G	1	1	2	0	0	2	0	0
4	9085337	.	A	G	3	0	3	0	4	7	0	0
4	9094270	.	G	T	4	5	9	0	1	10	0	0
4	9094347	.	G	A	5	3	8	0	1	9	0	0
4	9094666	.	T	G	4	3	7	0	1	8	0	0
4	9094668	.	T	A	4	3	7	0	1	8	0	0
4	9104173	.	G	C	7	3	10	0	1	11	0	0
4	9105199	.	T	C	2	0	2	0	7	9	0	0
4	9128095	.	T	C	2	0	2	0	1	3	0	0
4	9173425	.	A	G	2	5	7	0	0	7	0	0
4	9180680	.	G	A	6	10	16	0	0	16	0	0
4	9180746	.	T	C	9	7	16	0	0	16	0	0
4	9183115	.	T	A	2	2	4	0	0	4	0	0
4	9184684	.	A	T	3	2	5	0	0	5	0	0
4	9189969	.	C	T	0	1	1	0	0	1	0	0
4	9192444	.	G	A	7	4	11	0	0	11	0	0
4	9192507	.	A	C	8	0	8	0	3	11	0	0
4	9208486	.	C	G	4	2	6	0	0	6	0	0
4	9208911	.	C	A	0	3	3	0	0	3	0	0
4	9208978	.	G	A	3	2	5	0	0	5	0	0
4	9209469	.	G	A	1	5	6	0	0	6	0	0
4	9213133	.	G	A	1	2	3	0	0	3	0	0
4	9308332	.	C	T	1	4	5	0	0	5	0	0
4	9308344	.	G	A	1	2	3	0	0	3	0	0
4	9317959	.	T	C	0	1	1	0	0	1	0	0
4	9329819	.	T	A	6	3	9	0	0	9	0	0
4	9329912	.	C	A	1	4	5	0	0	5	0	0
4	9331330	.	G	A	0	14	14	0	8	22	0	0
4	9331495	.	T	G	3	0	3	0	7	10	0	0
4	9333448	.	C	T	1	0	1	0	0	1	0	0
4	9333565	.	G	A	0	15	15	0	15	30	0	0
4	9333739	.	A	C	11	20	31	0	1	32	0	0
4	9334180	.	G	C	0	6	6	0	10	16	0	0
4	9334196	.	A	G	9	6	15	0	0	15	0	0
4	9334735	.	A	G	9	1	10	0	10	20	0	0
4	9339140	.	G	A	5	5	10	0	0	10	0	0
4	9339202	.	G	A	9	4	13	0	0	13	0	0
4	9339637	.	C	T	0	5	5	0	3	8	0	0
4	9339964	.	T	C	2	0	2	0	3	5	0	0
4	9350496	.	G	T	2	3	5	0	0	5	0	0
4	9372530	.	C	T	0	1	1	0	0	1	0	0
4	9385390	.	A	G	9	0	9	0	7	16	0	0
4	9386108	.	C	T	2	3	5	0	0	5	0	0
4	9388890	.	C	T	7	2	9	0	0	9	0	0
4	9389003	.	A	C	9	5	14	0	1	15	0	0
4	9389112	.	G	A	5	4	9	0	1	10	0	0
4	9429769	.	G	A	1	0	1	0	1	2	0	0
4	9447758	.	C	T	2	3	5	0	0	5	0	0
4	9448634	.	G	A	1	5	6	0	0	6	0	0
4	9448643	.	G	T	1	4	5	0	0	5	0	0
4	9460213	.	A	G	7	0	7	0	7	14	0	0
4	9460603	.	A	C	3	5	8	0	0	8	0	0
4	9461286	.	T	C	2	3	5	0	0	5	0	0
4	9461548	.	A	G	2	0	2	0	3	5	0	0
4	9461822	.	C	A	2	4	6	0	0	6	0	0
4	9461839	.	C	A	3	6	9	0	0	9	0	0
4	9461946	.	T	A	7	7	14	0	0	14	0	0
4	9462237	.	T	C	4	2	6	0	0	6	0	0
4	9462897	.	A	G	9	0	9	0	5	14	0	0
4	9463634	.	T	G	5	2	7	0	1	8	0	0
4	9463840	.	C	G	5	9	14	0	0	14	0	0
4	9463855	.	T	A	7	10	17	0	0	17	0	0
4	9464143	.	T	G	3	3	6	0	0	6	0	0
4	9464224	.	T	C	5	2	7	0	1	8	0	0
4	9465193	.	T	A	1	2	3	0	0	3	0	0
4	9465197	.	G	A	0	2	2	0	0	2	0	0
4	9465637	.	A	G	1	4	5	0	0	5	0	0
4	9465832	.	G	T	10	5	15	0	1	16	0	0
4	9465899	.	C	A	10	11	21	0	1	22	0	0
4	9465900	.	C	A	10	11	21	0	1	22	0	0
4	9466075	.	G	T	9	7	16	0	0	16	0	0
4	9492315	.	A	G	1	2	3	0	0	3	0	0
4	9496926	.	C	T	1	3	4	0	0	4	0	0
4	9496934	.	G	A	1	2	3	0	0	3	0	0
4	9498803	.	C	A	2	1	3	0	0	3	0	0
4	9498886	.	G	C	4	5	9	0	0	9	0	0
4	9498896	.	T	C	3	5	8	0	0	8	0	0
4	9499404	.	G	A	2	2	4	0	1	5	0	0
4	9500311	.	A	T	4	3	7	0	1	8	0	0
4	9500312	.	G	T	4	3	7	0	1	8	0	0
4	9500370	.	G	A	1	0	1	0	0	1	0	0
4	9502243	.	G	T	12	9	21	0	1	22	0	0
4	9502312	.	T	A	5	10	15	0	2	17	0	0
4	9502347	.	C	G	11	1	12	0	9	21	0	0
4	9502388	.	T	C	5	10	15	0	0	15	0	0
4	9502422	.	G	A	6	5	11	0	1	12	0	0
4	9502440	.	A	G	9	0	9	0	8	17	0	0
4	9502608	.	T	G	13	0	13	0	9	22	0	0
4	9537015	.	A	G	4	4	8	0	0	8	0	0
4	9537025	.	C	T	4	4	8	0	0	8	0	0
4	9539303	.	G	A	6	4	10	0	1	11	0	0
4	9565450	.	C	T	0	4	4	0	3	7	0	0
4	9573368	.	G	A	3	0	3	0	1	4	0	0
4	9593832	.	C	A	2	0	2	0	0	2	0	0
4	9596614	.	A	G	4	6	10	0	0	10	0	0
4	9598642	.	C	T	4	4	8	0	0	8	0	0
4	9598690	.	C	T	0	1	1	0	0	1	0	0
4	9601158	.	C	T	7	6	13	0	0	13	0	0
4	9601174	.	T	C	6	6	12	0	1	13	0	0
4	9601256	.	A	C	3	5	8	0	0	8	0	0
4	9601329	.	C	T	5	4	9	0	0	9	0	0
4	9601401	.	A	T	8	16	24	0	0	24	0	0
4	9601628	.	G	T	5	3	8	0	1	9	0	0
4	9603479	.	A	C	2	5	7	0	0	7	0	0
4	9603491	.	T	C	5	3	8	0	0	8	0	0
4	9603589	.	G	A	1	1	2	0	0	2	0	0
4	9603791	.	G	A	10	16	26	0	0	26	0	0
4	9603803	.	G	A	13	8	21	0	4	25	0	0
4	9604134	.	G	A	6	7	13	0	2	15	0	0
4	9604294	.	C	T	0	5	5	0	8	13	0	0
4	9604336	.	T	C	3	1	4	0	10	14	0	0
4	9604384	.	A	G	0	5	5	0	0	5	0	0
4	9605221	.	C	T	0	2	2	0	2	4	0	0
4	9605397	.	A	G	3	3	6	0	0	6	0	0
4	9607259	.	A	G	0	2	2	0	0	2	0	0
4	9611446	.	T	C	2	3	5	0	0	5	0	0
4	9616190	.	A	G	4	2	6	0	1	7	0	0
4	9618867	.	A	C	7	2	9	0	0	9	0	0
4	9624781	.	C	A	0	0	0	0	1	1	0	0
4	9653570	.	A	G	4	7	11	0	0	11	0	0
4	9653574	.	C	A	0	7	7	0	4	11	0	0
4	9653626	.	G	A	2	5	7	0	0	7	0	0
4	9653925	.	T	G	5	5	10	0	1	11	0	0
4	9654020	.	T	A	5	4	9	0	1	10	0	0
4	9654071	.	T	C	10	7	17	0	0	17	0	0
4	9654103	.	A	G	8	13	21	0	0	21	0	0
4	9654114	.	C	T	0	12	12	0	8	20	0	0
4	9654149	.	C	G	2	5	7	0	1	9	1	0
4	9655534	.	T	C	2	0	2	0	5	7	0	0
4	9655807	.	G	A	10	8	18	0	0	18	0	0
4	9659858	.	G	A	2	4	6	0	0	6	0	0
4	9661625	.	T	A	1	1	2	0	0	2	0	0
4	9664900	.	G	A	1	0	1	0	0	1	0	0
4	9669846	.	A	T	5	3	8	0	0	8	0	0
4	9669869	.	C	T	2	3	5	0	0	5	0	0
4	9674206	.	G	A	1	0	1	0	0	1	0	0
4	9675420	.	G	A	0	2	2	0	0	2	0	0
4	9677280	.	G	C	1	1	2	0	1	3	0	0
4	9686153	.	A	G	3	0	3	0	6	9	0	0
4	9688093	.	T	C	6	6	12	0	0	12	0	0
4	9688570	.	C	T	5	8	13	0	0	13	0	0
4	9688636	.	G	A	14	20	34	0	1	35	0	0
4	9689825	.	G	A	1	25	26	0	19	45	0	0
4	9697283	.	T	A	1	3	4	0	0	4	0	0
4	9697289	.	T	A	2	3	5	0	0	5	0	0
4	9697599	.	C	A	10	7	17	0	0	17	0	0
4	9697763	.	A	C	3	6	9	0	0	10	1	0
4	9697813	.	C	T	3	6	9	0	0	9	0	0
4	9698023	.	C	T	1	1	2	0	0	2	0	0
4	9724441	.	A	G	6	7	13	0	1	14	0	0
4	9724635	.	T	A	13	17	30	0	1	31	0	0
4	9724644	.	C	T	14	15	29	0	0	29	0	0
4	9724718	.	C	A	12	13	25	0	1	26	0	0
4	9724898	.	A	G	8	24	32	0	1	33	0	0
4	9736186	.	A	G	2	7	9	0	0	9	0	0
4	9736211	.	C	T	5	10	15	0	0	15	0	0
4	9737157	.	G	T	10	3	13	0	0	13	0	0
4	9737314	.	A	C	12	0	12	0	8	20	0	0
4	9740769	.	G	A	3	7	10	0	1	11	0	0
4	9743708	.	G	C	4	0	4	0	0	4	0	0
4	9743762	.	T	G	8	3	11	0	0	11	0	0
4	9743774	.	C	T	6	3	9	0	0	9	0	0
4	9746515	.	A	G	1	0	1	0	0	1	0	0
4	9746547	.	C	T	3	2	5	0	0	5	0	0
4	9746559	.	C	A	3	4	7	0	0	7	0	0
4	9746604	.	G	A	3	3	6	0	2	8	0	0
4	9747647	.	C	T	3	3	6	0	0	6	0	0
4	9750109	.	G	T	2	3	5	0	0	5	0	0
4	9750154	.	T	G	5	4	9	0	0	9	0	0
4	9751050	.	A	G	2	1	3	0	0	3	0	0
4	9751310	.	T	G	1	3	4	0	0	4	0	0
4	9753200	.	A	G	3	3	6	0	0	6	0	0
4	9784331	.	T	A	14	10	24	0	0	24	0	0
4	9784669	.	G	A	6	9	15	0	1	16	0	0
4	9784678	.	C	T	0	10	10	0	5	15	0	0
4	9784740	.	A	G	9	6	15	0	1	16	0	0
4	9784747	.	T	A	8	6	14	0	3	17	0	0
4	9785900	.	T	A	6	10	16	0	0	16	0	0
4	9785985	.	C	T	7	0	7	0	2	9	0	0
4	9786203	.	A	G	10	13	23	0	0	23	0	0
4	9786338	.	T	A	11	4	15	0	0	15	0	0
4	9786466	.	C	G	0	8	8	0	10	18	0	0
4	9786514	.	C	T	7	5	12	0	0	12	0	0
4	9786574	.	T	A	7	1	8	0	0	8	0	0
4	9786617	.	C	A	5	10	15	0	0	15	0	0
4	9786670	.	C	A	5	7	12	0	0	12	0	0
4	9786705	.	A	C	4	5	9	0	0	9	0	0
4	9786855	.	T	C	5	5	10	0	1	11	0	0
4	9786976	.	G	A	5	3	8	0	0	8	0	0
4	9787090	.	T	C	12	4	16	0	0	16	0	0
4	9787130	.	A	G	10	3	13	0	1	14	0	0
4	9787156	.	A	T	7	3	10	0	0	10	0	0
4	9787250	.	A	G	9	5	14	0	0	14	0	0
4	9787415	.	G	A	4	6	10	0	2	12	0	0
4	9787516	.	C	T	8	7	15	0	1	16	0	0
4	9787600	.	G	T	6	10	16	0	0	16	0	0
4	9787761	.	A	G	9	12	21	1	1	23	0	0
4	9789478	.	A	G	2	6	8	0	0	8	0	0
4	9791466	.	A	T	4	2	6	0	0	6	0	0
4	9791493	.	T	C	3	0	3	0	1	4	0	0
4	9792229	.	G	T	7	9	16	0	0	16	0	0
4	9792798	.	A	G	2	0	2	0	0	2	0	0
4	9795288	.	C	T	3	4	7	0	0	7	0	0
4	9795309	.	C	T	4	4	8	0	0	8	0	0
4	9797312	.	C	T	0	5	5	0	1	6	0	0
4	9797376	.	G	A	0	3	3	0	0	3	0	0
4	9797390	.	G	C	0	0	0	0	2	2	0	0
4	9798825	.	C	A	0	5	5	0	3	8	0	0
4	9801626	.	G	A	2	2	4	0	0	4	0	0
4	9801730	.	A	T	3	5	8	0	0	8	0	0
4	9801747	.	G	A	3	4	7	0	0	7	0	0
4	9801935	.	A	G	2	4	6	0	0	6	0	0
4	9802472	.	A	T	3	3	6	0	0	6	0	0
4	9802487	.	C	T	0	4	4	0	3	7	0	0
4	9813844	.	T	A	4	4	8	0	0	8	0	0
4	9814044	.	C	G	4	11	15	0	1	16	0	0
4	9814880	.	T	G	5	3	8	0	1	9	0	0
4	9817327	.	C	T	3	2	5	0	0	5	0	0
4	9819858	.	A	T	5	6	11	0	0	11	0	0
4	9838138	.	A	G	0	1	1	0	0	1	0	0
4	9838875	.	T	C	4	9	13	0	2	15	0	0
4	9838932	.	C	T	4	2	6	0	0	6	0	0
4	9838974	.	T	C	5	3	8	0	0	8	0	0
4	9840136	.	T	C	2	1	3	0	1	4	0	0
4	9840338	.	T	C	1	1	2	0	0	2	0	0
4	9841657	.	G	A	16	10	26	0	1	27	0	0
4	9854313	.	T	C	6	4	10	0	1	11	0	0
4	9854458	.	T	C	1	0	1	0	4	5	0	0
4	9854467	.	C	T	1	6	7	0	0	7	0	0
4	9855482	.	G	A	6	4	10	0	1	11	0	0
4	9858023	.	A	G	2	1	3	0	0	3	0	0
4	9858050	.	C	T	3	3	6	0	0	6	0	0
4	9860188	.	T	G	0	4	4	0	0	4	0	0
4	9867387	.	A	G	1	4	5	0	0	5	0	0
4	9957319	.	T	C	4	2	6	0	0	6	0	0
4	9957331	.	C	T	3	2	5	0	1	6	0	0
4	9957367	.	T	C	1	1	2	0	1	3	0	0
4	9962466	.	C	T	1	2	3	0	0	3	0	0
4	9966229	.	C	T	1	1	2	0	0	2	0	0
4	9969261	.	C	T	3	8	11	0	0	11	0	0
4	9969306	.	G	T	5	5	10	0	2	12	0	0
4	9969447	.	T	C	1	0	1	0	0	1	0	0
4	9974720	.	C	T	1	2	3	0	0	3	0	0
4	9980400	.	G	A	0	4	4	0	1	5	0	0
4	9981763	.	C	T	1	0	1	0	0	1	0	0
4	9981838	.	G	A	4	3	7	0	0	7	0	0
4	9982775	.	G	T	0	1	1	0	0	1	0	0
4	9982872	.	A	T	2	4	6	0	0	6	0	0
4	9982883	.	A	G	2	3	5	0	0	5	0	0
4	9983251	.	G	A	3	2	5	0	1	6	0	0
4	9983269	.	C	G	4	4	8	0	1	9	0	0
4	9983347	.	G	T	2	6	8	0	1	9	0	0
4	9985320	.	G	C	2	5	7	0	0	7	0	0
4	9986279	.	G	A	6	5	11	0	0	11	0	0
4	9988867	.	C	T	2	1	3	0	0	3	0	0
4	9990796	.	G	A	1	4	5	0	1	6	0	0
4	9993789	.	C	T	14	8	22	0	1	23	0	0
4	9996182	.	T	C	6	5	11	0	0	11	0	0
4	9998553	.	G	A	1	17	18	0	17	35	0	0
4	9998566	.	A	C	14	17	31	0	0	31	0	0
4	9998677	.	A	G	10	11	21	0	0	21	0	0
4	9998986	.	A	T	13	12	25	0	1	26	0	0
4	9998988	.	T	C	13	12	25	0	1	26	0	0
4	9999240	.	C	T	15	19	34	0	0	34	0	0
4	9999367	.	A	G	22	16	38	0	0	38	0	0
4	9999830	.	T	C	12	3	15	0	5	20	0	0
4	9999909	.	A	T	10	4	14	0	2	16	0	0
4	10011770	.	A	C	2	3	5	0	1	6	0	0
4	10017468	.	A	G	19	15	34	0	0	34	0	0
4	10038009	.	T	C	1	1	2	0	0	2	0	0
4	10040249	.	G	A	0	19	19	0	20	39	0	0
4	10040285	.	A	G	23	1	24	0	11	35	0	0
4	10040297	.	C	T	25	14	39	0	2	41	0	0
4	10367028	.	A	G	2	2	4	0	0	4	0	0
4	10367349	.	G	A	0	1	1	0	0	1	0	0
4	10367358	.	A	G	1	0	1	0	2	3	0	0
4	10367412	.	A	C	3	5	8	0	0	8	0	0
4	10367562	.	C	T	4	2	6	0	0	6	0	0
4	10367610	.	C	T	5	3	8	0	0	8	0	0
4	10367619	.	C	T	5	4	9	0	0	9	0	0
4	10553528	.	G	A	3	5	8	0	0	8	0	0
4	10558370	.	C	T	7	7	14	0	0	14	0	0
4	10558578	.	C	T	0	9	9	0	0	9	0	0
4	10559088	.	C	A	6	1	7	1	2	10	0	0
4	10559213	.	C	G	4	9	13	0	1	14	0	0
4	10559558	.	A	G	0	0	0	0	4	4	0	0
4	10559621	.	C	A	6	5	11	0	1	12	0	0
4	10559992	.	C	T	2	2	4	0	0	4	0	0
4	10560246	.	G	A	17	14	31	0	1	32	0	0
4	10560253	.	A	T	19	14	33	0	0	33	0	0
4	10560284	.	C	T	15	13	28	0	2	30	0	0
4	10560404	.	A	T	22	12	34	0	1	35	0	0
4	10560607	.	A	G	12	6	18	0	0	18	0	0
4	10560916	.	C	T	11	5	16	0	2	18	0	0
4	10561598	.	T	C	17	13	30	0	0	30	0	0
4	10561603	.	G	A	17	13	30	0	0	30	0	0
4	10605409	.	T	C	6	3	9	0	0	9	0	0
4	10608878	.	G	T	8	5	13	0	0	13	0	0
4	10611014	.	T	A	15	10	25	0	3	28	0	0
4	10615123	.	A	T	12	15	27	0	0	27	0	0
4	10615127	.	G	T	12	15	27	0	0	27	0	0
4	10615175	.	A	G	17	0	17	0	11	28	0	0
4	10690319	.	T	C	1	2	3	0	0	3	0	0
4	10709500	.	T	C	1	2	3	0	0	3	0	0
4	10755396	.	T	G	0	2	2	0	1	3	0	0
4	10835494	.	C	G	3	3	6	0	1	7	0	0
4	10888890	.	T	A	4	2	6	0	0	6	0	0
4	10890516	.	G	T	1	4	5	0	0	5	0	0
4	10890822	.	G	A	2	4	6	0	1	7	0	0
4	10896354	.	G	C	4	4	8	0	1	9	0	0
4	10896570	.	G	A	1	2	3	0	0	3	0	0
4	10896582	.	G	T	1	2	3	0	0	3	0	0
4	10904784	.	C	T	2	2	4	0	0	4	0	0
4	10905246	.	C	T	6	2	8	0	2	10	0	0
4	10906254	.	C	T	7	5	12	0	1	13	0	0
4	10907182	.	C	A	4	2	6	0	1	7	0	0
4	10908001	.	C	T	11	20	31	0	1	32	0	0
4	10908182	.	T	C	7	5	12	0	3	15	0	0
4	10908294	.	C	T	7	10	17	0	0	17	0	0
4	10908726	.	T	C	13	6	19	0	0	19	0	0
4	10974612	.	G	A	4	2	6	0	0	6	0	0
4	10974650	.	C	T	4	3	7	0	1	8	0	0
4	10974722	.	G	A	3	2	5	0	0	5	0	0
4	10974747	.	A	T	4	3	7	0	0	7	0	0
4	10976944	.	G	A	3	6	9	0	0	9	0	0
4	10982291	.	C	T	0	1	1	0	0	1	0	0
4	10982339	.	T	G	3	3	6	0	1	7	0	0
4	10982390	.	C	A	0	1	1	0	0	1	0	0
4	10988403	.	A	G	4	2	6	0	0	6	0	0
4	10988581	.	C	T	0	1	1	0	1	2	0	0
4	10994694	.	A	G	3	2	5	0	0	5	0	0
4	10994841	.	G	A	2	2	4	0	0	4	0	0
4	11053815	.	C	T	3	3	6	0	0	6	0	0
4	11053822	.	A	G	3	4	7	0	0	7	0	0
4	11053851	.	G	A	0	8	8	0	4	12	0	0
4	11054484	.	A	C	9	9	18	0	1	19	0	0
4	11054509	.	G	C	9	13	22	0	0	22	0	0
4	11055798	.	G	A	1	2	3	0	0	3	0	0
4	11311383	.	G	A	2	4	6	0	0	6	0	0
4	11356555	.	A	G	7	7	14	0	0	14	0	0
4	11358626	.	C	T	4	3	7	0	0	7	0	0
4	11366360	.	T	C	4	11	15	0	0	15	0	0
4	11366481	.	G	A	8	4	12	0	7	19	0	0
4	11367668	.	T	A	9	10	19	0	0	19	0	0
4	11367952	.	T	C	10	8	18	0	2	20	0	0
4	11368056	.	A	T	17	21	38	0	0	38	0	0
4	11368076	.	G	T	19	19	38	0	1	39	0	0
4	11368171	.	G	A	0	26	26	0	21	47	0	0
4	11368432	.	A	T	3	4	7	0	0	7	0	0
4	11389372	.	G	C	0	2	2	0	1	3	0	0
4	11414424	.	A	T	1	2	3	0	0	3	0	0
4	11415483	.	G	A	2	1	3	0	1	4	0	0
4	11416701	.	C	T	8	5	13	0	0	13	0	0
4	11416758	.	T	A	4	3	7	0	1	8	0	0
4	11417829	.	C	A	2	2	4	0	0	4	0	0
4	11418969	.	C	T	1	4	5	0	0	5	0	0
4	11419062	.	G	A	6	3	9	0	0	9	0	0
4	11419163	.	C	G	3	3	6	0	0	6	0	0
4	11419510	.	C	T	5	2	7	0	0	7	0	0
4	11419656	.	C	T	4	4	8	0	0	8	0	0
4	11419836	.	A	T	2	2	4	0	1	5	0	0
4	11419869	.	T	C	3	2	5	0	0	5	0	0
4	11420005	.	A	T	7	4	11	0	2	13	0	0
4	11422121	.	C	T	8	8	16	0	0	16	0	0
4	11425839	.	G	T	4	2	6	0	0	6	0	0
4	11439544	.	C	A	6	7	13	0	2	15	0	0
4	11446078	.	A	G	23	20	43	0	1	44	0	0
4	11446365	.	A	T	21	11	32	0	2	34	0	0
4	11447135	.	T	C	29	10	39	0	0	39	0	0
4	11447144	.	G	A	13	21	34	0	2	36	0	0
4	11447226	.	T	G	15	1	16	0	20	36	0	0
4	11447251	.	T	C	12	17	29	0	2	31	0	0
4	11447719	.	T	G	22	19	41	0	0	41	0	0
4	11448296	.	A	T	14	27	41	0	0	41	0	0
4	11448403	.	G	A	1	23	24	0	22	47	1	0
4	11461181	.	C	G	1	6	7	0	0	7	0	0
4	11461914	.	A	G	3	4	7	0	1	8	0	0
4	11464390	.	A	G	3	5	8	0	1	9	0	0
4	11470854	.	A	G	4	0	4	0	0	4	0	0
4	11471203	.	T	C	10	3	13	0	3	16	0	0
4	11472674	.	T	C	8	12	20	0	1	21	0	0
4	11476472	.	G	A	2	35	37	0	20	57	0	0
4	11476487	.	C	T	19	37	56	0	2	58	0	0
4	11476740	.	C	T	28	30	58	0	2	60	0	0
4	11476868	.	C	G	24	32	56	0	0	57	1	0
4	11476945	.	C	T	31	29	60	0	3	63	0	0
4	11477047	.	T	A	27	32	59	0	3	62	0	0
4	11477377	.	C	T	44	15	59	1	6	66	0	0
4	11480649	.	T	C	3	1	4	0	0	4	0	0
4	11480824	.	C	A	7	5	12	0	1	13	0	0
4	11480866	.	C	T	1	1	2	0	0	2	0	0
4	11482235	.	G	A	0	7	7	0	6	13	0	0
4	11482259	.	G	A	8	8	16	0	1	17	0	0
4	11482358	.	T	G	1	2	3	0	0	3	0	0
4	11482367	.	C	G	1	0	1	0	0	1	0	0
4	11482668	.	T	A	11	15	26	0	0	26	0	0
4	11482830	.	C	T	4	2	6	0	0	6	0	0
4	11489736	.	C	T	1	1	2	0	0	2	0	0
4	11489758	.	G	A	0	1	1	0	3	4	0	0
4	11573837	.	C	T	0	3	3	0	1	4	0	0
4	11573918	.	C	T	2	2	4	0	0	4	0	0
4	11573961	.	G	A	2	3	5	0	0	5	0	0
4	11574829	.	A	G	1	2	3	0	0	3	0	0
4	11575059	.	G	C	2	0	2	0	2	4	0	0
4	11575115	.	G	A	2	2	4	0	0	4	0	0
4	11704180	.	C	T	1	2	3	0	0	3	0	0
4	11704195	.	A	G	1	0	1	0	0	1	0	0
4	11712653	.	C	T	1	3	4	0	0	4	0	0
4	11712794	.	T	C	0	1	1	0	0	1	0	0
4	11713065	.	C	T	4	3	7	0	0	7	0	0
4	11721731	.	C	T	4	2	6	0	0	6	0	0
4	11726366	.	T	A	3	3	6	0	0	6	0	0
4	11728959	.	G	A	0	4	4	0	1	5	0	0
4	11729719	.	G	A	8	5	13	0	1	14	0	0
4	11730159	.	G	C	3	7	10	0	1	11	0	0
4	11730515	.	C	A	8	8	16	0	0	16	0	0
4	11732589	.	T	C	5	8	13	0	1	14	0	0
4	11732590	.	T	C	5	9	14	0	0	14	0	0
4	11732956	.	A	G	5	2	7	0	0	7	0	0
4	11732975	.	G	A	6	2	8	0	0	8	0	0
4	11733061	.	A	C	3	2	5	0	0	5	0	0
4	11733114	.	A	C	1	0	1	0	3	4	0	0
4	11733222	.	C	T	2	2	4	0	0	4	0	0
4	11733545	.	T	C	5	0	5	0	4	9	0	0
4	11733573	.	G	A	7	2	9	0	1	10	0	0
4	11733726	.	A	C	5	6	11	0	0	11	0	0
4	11733778	.	C	A	0	4	4	0	3	7	0	0
4	11734001	.	A	T	1	3	4	0	0	4	0	0
4	11734071	.	T	C	3	3	6	0	0	6	0	0
4	11734072	.	A	C	3	3	6	0	0	6	0	0
4	11734423	.	G	A	2	2	4	0	0	4	0	0
4	11765801	.	T	C	0	1	1	0	0	1	0	0
4	11765871	.	C	T	2	1	3	0	1	4	0	0
4	11780560	.	C	T	1	2	3	0	0	3	0	0
4	11804825	.	C	G	4	10	14	0	1	15	0	0
4	11804940	.	G	A	7	8	15	0	0	15	0	0
4	11805396	.	G	T	2	2	4	0	1	5	0	0
4	11805423	.	T	C	2	4	6	0	0	6	0	0
4	11806934	.	G	A	3	4	7	0	0	7	0	0
4	11806965	.	G	C	2	3	5	0	0	5	0	0
4	11814022	.	A	G	20	13	33	0	0	33	0	0
4	11814055	.	C	T	0	29	29	0	17	46	0	0
4	11814074	.	T	A	18	27	45	0	3	48	0	0
4	11814429	.	A	T	11	6	17	0	0	17	0	0
4	11814456	.	A	G	3	10	13	0	0	13	0	0
4	11814471	.	G	A	8	4	12	0	1	13	0	0
4	11814494	.	C	T	5	8	13	0	3	16	0	0
4	11814565	.	A	T	11	4	15	0	2	17	0	0
4	11814684	.	C	T	11	8	19	0	4	23	0	0
4	11814723	.	A	C	8	14	22	0	0	22	0	0
4	11815137	.	G	T	10	15	25	0	2	27	0	0
4	11815143	.	C	G	12	13	25	0	0	27	2	0
4	11815324	.	A	C	15	11	26	0	4	30	0	0
4	11816535	.	T	C	3	0	3	0	7	10	0	0
4	11818347	.	G	A	2	0	2	0	1	3	0	0
4	11818353	.	A	G	3	1	4	0	0	4	0	0
4	11827171	.	C	T	0	1	1	0	0	1	0	0
4	11841949	.	T	A	1	6	7	0	0	7	0	0
4	12006542	.	G	A	3	3	6	0	1	7	0	0
4	12007097	.	A	G	4	2	6	0	0	6	0	0
4	12013470	.	T	G	5	5	10	0	0	10	0	0
4	12013513	.	A	T	5	6	11	0	0	11	0	0
4	12020936	.	C	T	1	3	4	0	0	4	0	0
4	12021120	.	C	T	6	0	6	0	0	6	0	0
4	12021703	.	C	T	1	4	5	0	0	5	0	0
4	12021748	.	G	T	0	14	14	0	11	25	0	0
4	12022108	.	A	G	21	0	21	0	15	36	0	0
4	12022444	.	T	C	9	14	23	0	1	24	0	0
4	12023445	.	A	C	11	13	24	0	0	24	0	0
4	12025771	.	G	A	1	13	14	0	2	16	0	0
4	12026098	.	G	A	10	10	20	0	0	20	0	0
4	12026286	.	A	T	19	17	36	0	3	39	0	0
4	12026305	.	T	C	19	16	35	0	3	38	0	0
4	12026369	.	G	T	10	17	27	0	0	27	0	0
4	12026429	.	C	A	12	10	22	0	0	22	0	0
4	12026488	.	T	C	4	4	8	0	1	9	0	0
4	12078423	.	T	C	0	0	0	0	1	1	0	0
4	12080673	.	C	T	3	5	8	0	1	9	0	0
4	12080911	.	T	G	5	7	12	0	1	13	0	0
4	12087262	.	G	C	3	0	3	0	2	5	0	0
4	12091104	.	G	T	5	7	12	0	0	12	0	0
4	12103535	.	G	A	1	6	7	0	0	7	0	0
4	12103619	.	T	C	3	0	3	0	5	8	0	0
4	12103911	.	A	T	2	4	6	0	0	6	0	0
4	12103964	.	T	A	4	7	11	0	3	14	0	0
4	12106000	.	G	C	5	1	6	0	6	12	0	0
4	12111399	.	G	A	2	4	6	0	0	6	0	0
4	12230029	.	C	T	5	7	12	0	0	12	0	0
4	12230509	.	C	A	4	8	12	0	3	15	0	0
4	12230510	.	T	C	4	10	14	0	1	15	0	0
4	12230608	.	T	C	5	4	9	0	0	9	0	0
4	12230665	.	C	T	4	5	9	0	0	9	0	0
4	12230698	.	C	T	4	3	7	0	0	7	0	0
4	12230713	.	T	C	5	5	10	0	0	10	0	0
4	12230909	.	G	A	3	2	5	0	0	5	0	0
4	12231008	.	G	A	0	9	9	0	4	13	0	0
4	12231131	.	A	C	2	5	7	0	0	7	0	0
4	12231328	.	A	T	3	7	10	0	0	10	0	0
4	12231751	.	A	C	6	6	12	0	0	12	0	0
4	12231789	.	C	A	5	6	11	0	0	12	1	0
4	12232164	.	C	G	11	9	20	0	0	20	0	0
4	12232253	.	G	T	14	9	23	0	1	24	0	0
4	12232254	.	C	T	15	8	23	0	1	24	0	0
4	12232323	.	A	T	9	6	15	0	0	15	0	0
4	12232328	.	A	T	9	5	14	0	1	15	0	0
4	12232415	.	G	T	8	5	13	0	1	14	0	0
4	12232435	.	T	G	5	0	5	0	4	9	0	0
4	12232509	.	C	T	3	2	5	0	0	5	0	0
4	12232614	.	A	C	5	9	14	0	1	15	0	0
4	12232644	.	A	T	4	9	13	0	1	14	0	0
4	12232737	.	G	A	1	4	5	0	0	5	0	0
4	12232746	.	T	C	2	2	4	0	0	4	0	0
4	12232958	.	T	C	2	4	6	0	2	8	0	0
4	12232985	.	G	T	2	8	10	0	0	10	0	0
4	12233004	.	A	G	3	0	3	0	7	10	0	0
4	12233125	.	T	A	6	8	14	0	1	15	0	0
4	12233220	.	C	T	7	5	12	0	1	13	0	0
4	12233252	.	A	T	5	6	11	0	0	11	0	0
4	12233431	.	C	A	1	5	6	0	0	6	0	0
4	12233450	.	C	A	3	8	11	0	1	12	0	0
4	12233595	.	C	T	3	3	6	3	0	9	0	0
4	12233651	.	A	T	4	7	11	2	0	13	0	0
4	12233728	.	G	T	2	8	10	0	0	10	0	0
4	12233770	.	G	T	5	3	8	0	0	8	0	0
4	12233908	.	A	C	6	8	14	2	0	16	0	0
4	12234398	.	T	G	7	10	17	0	0	17	0	0
4	12234458	.	C	T	4	7	11	0	0	11	0	0
4	12234755	.	C	A	6	11	17	0	1	18	0	0
4	12234792	.	A	G	14	5	19	0	2	21	0	0
4	12234828	.	C	T	5	13	18	0	2	20	0	0
4	12234955	.	C	T	7	15	22	0	0	22	0	0
4	12235677	.	T	C	6	12	18	0	0	18	0	0
4	12235722	.	A	G	8	6	14	0	0	14	0	0
4	12235770	.	T	C	4	14	18	0	0	18	0	0
4	12235987	.	T	G	6	6	12	1	0	13	0	0
4	12236171	.	G	A	5	13	18	1	1	20	0	0
4	12236178	.	T	G	5	11	16	1	0	17	0	0
4	12236584	.	C	T	10	3	13	0	1	14	0	0
4	12236641	.	A	G	4	7	11	0	1	12	0	0
4	12236667	.	C	A	5	7	12	0	0	12	0	0
4	12236740	.	A	C	2	3	5	0	0	5	0	0
4	12237235	.	T	A	2	3	5	0	0	5	0	0
4	12237237	.	A	T	2	3	5	0	0	5	0	0
4	12237337	.	T	C	6	4	10	0	1	11	0	0
4	12237340	.	G	A	5	4	9	0	1	10	0	0
4	12237375	.	A	T	9	4	13	0	0	13	0	0
4	12237490	.	C	A	19	10	29	0	1	30	0	0
4	12237689	.	C	A	16	15	31	0	2	33	0	0
4	12237849	.	C	T	20	11	31	0	0	31	0	0
4	12238161	.	C	T	10	19	29	0	6	35	0	0
4	12238418	.	C	T	22	20	42	0	0	42	0	0
4	12238711	.	G	A	17	15	32	0	0	32	0	0
4	12238800	.	G	A	2	2	4	0	0	4	0	0
4	12238904	.	G	A	6	6	12	0	0	12	0	0
4	12238956	.	G	A	18	15	33	0	5	38	0	0
4	12243881	.	T	G	7	11	18	0	1	19	0	0
4	12243930	.	T	C	13	1	14	0	1	15	0	0
4	12244071	.	T	C	14	13	27	0	2	29	0	0
4	12244099	.	T	C	16	22	38	0	1	39	0	0
4	12244153	.	T	A	18	17	35	0	1	36	0	0
4	12244258	.	T	C	9	13	22	0	0	22	0	0
4	12244322	.	C	T	12	10	22	0	1	23	0	0
4	12244607	.	C	T	0	4	4	0	6	10	0	0
4	12245058	.	G	A	7	4	11	0	0	11	0	0
4	12245584	.	A	G	15	9	24	0	1	25	0	0
4	12265268	.	T	A	5	11	16	0	0	16	0	0
4	12265337	.	T	C	0	0	0	0	4	4	0	0
4	12285925	.	T	C	2	2	4	0	0	4	0	0
4	12312865	.	T	C	1	2	3	0	0	3	0	0
4	12317636	.	T	G	6	8	14	0	0	14	0	0
4	12317674	.	A	T	6	9	15	0	0	15	0	0
4	12317764	.	G	A	0	4	4	0	3	7	0	0
4	12381900	.	T	C	10	9	19	0	0	20	1	0
4	12381930	.	G	A	5	9	14	0	1	15	0	0
4	12382076	.	A	G	17	8	25	0	4	29	0	0
4	12382234	.	C	T	15	7	22	0	0	22	0	0
4	12382336	.	T	G	9	10	19	0	0	19	0	0
4	12382433	.	G	C	17	5	22	0	1	23	0	0
4	12382673	.	A	T	12	9	21	0	1	22	0	0
4	12382871	.	G	A	21	15	36	0	0	36	0	0
4	12382889	.	T	G	16	13	29	0	7	36	0	0
4	12382943	.	T	G	14	11	25	0	1	26	0	0
4	12383030	.	C	T	22	13	35	0	0	35	0	0
4	12383081	.	C	T	5	5	10	0	1	11	0	0
4	12384831	.	A	G	9	9	18	0	2	20	0	0
4	12384840	.	G	A	7	8	15	0	1	16	0	0
4	12384873	.	C	G	0	3	3	0	4	7	0	0
4	12388419	.	T	C	8	11	19	0	0	19	0	0
4	13459114	.	G	C	6	2	8	0	0	8	0	0
4	13755907	.	A	G	20	12	32	0	2	34	0	0
4	14449660	.	T	A	3	3	6	0	14	20	0	0
4	14992422	.	T	C	4	3	7	0	1	8	0	0
4	14992423	.	T	C	4	4	8	0	0	8	0	0
4	16318963	.	G	A	0	2	2	0	2	4	0	0
4	16319377	.	C	T	7	4	11	0	0	11	0	0
4	16319954	.	T	C	2	3	5	0	0	5	0	0
4	16319961	.	T	C	2	3	5	0	0	5	0	0
4	16368805	.	T	C	14	0	14	0	9	23	0	0
4	16368977	.	G	A	10	9	19	0	1	20	0	0
4	16369033	.	T	A	7	9	16	0	0	17	1	0
4	16369335	.	T	C	11	0	11	0	14	25	0	0
4	16369375	.	G	C	8	6	14	0	0	14	0	0
4	16369384	.	T	C	7	5	12	0	1	13	0	0
4	16369440	.	C	T	0	7	7	0	1	8	0	0
4	16369486	.	T	C	2	3	5	0	0	5	0	0
4	16380491	.	G	C	4	0	4	0	1	5	0	0
4	16382917	.	A	G	2	2	4	0	0	4	0	0
4	16536356	.	G	A	2	7	9	0	6	15	0	0
4	16536946	.	C	A	11	25	36	0	0	36	0	0
4	16537045	.	T	C	14	20	34	0	4	38	0	0
4	16537099	.	A	T	34	24	58	0	2	60	0	0
4	16537575	.	T	G	25	28	53	0	1	54	0	0
4	16537770	.	G	A	29	21	50	0	0	50	0	0
4	16538055	.	T	A	24	12	36	0	1	37	0	0
4	16539253	.	A	G	17	25	42	0	3	45	0	0
4	16616024	.	G	A	1	2	3	0	0	3	0	0
4	16632415	.	G	A	7	7	14	0	0	14	0	0
4	16632650	.	A	T	14	7	21	0	1	22	0	0
4	16632762	.	A	T	15	8	23	0	0	23	0	0
4	16633208	.	C	T	14	5	19	0	0	19	0	0
4	16633448	.	T	C	8	9	17	0	2	19	0	0
4	16633451	.	T	C	10	7	17	0	2	19	0	0
4	16634791	.	C	A	3	4	7	0	1	8	0	0
4	16634794	.	G	T	4	5	9	0	0	9	0	0
4	16634916	.	A	G	9	7	16	0	2	18	0	0
4	16634929	.	A	T	9	5	14	0	3	17	0	0
4	16635088	.	G	A	5	5	10	0	0	10	0	0
4	16635162	.	G	A	5	7	12	0	0	12	0	0
4	16635208	.	G	A	3	9	12	0	0	12	0	0
4	16635326	.	T	C	13	0	13	0	7	20	0	0
4	16635426	.	A	G	2	3	5	0	0	5	0	0
4	16635460	.	T	A	1	2	3	0	0	3	0	0
4	16635710	.	T	C	3	7	10	0	1	11	0	0
4	16638015	.	T	C	2	3	5	0	1	6	0	0
4	16638021	.	T	G	3	3	6	0	1	7	0	0
4	16650102	.	T	C	5	10	15	0	0	15	0	0
4	16650142	.	A	T	4	10	14	0	0	14	0	0
4	16650433	.	A	C	13	19	32	0	1	33	0	0
4	16650482	.	T	C	20	12	32	0	1	33	0	0
4	16650611	.	T	G	9	10	19	0	0	19	0	0
4	16650618	.	A	G	8	12	20	0	0	20	0	0
4	16651010	.	G	C	12	0	12	0	8	20	0	0
4	16651046	.	G	C	11	6	17	0	0	17	0	0
4	16651121	.	A	G	9	9	18	0	0	18	0	0
4	16651414	.	G	A	9	8	17	0	0	17	0	0
4	16652890	.	A	G	4	2	6	0	0	6	0	0
4	16654337	.	G	C	6	5	11	0	1	12	0	0
4	16654349	.	C	T	0	8	8	0	10	18	0	0
4	16659679	.	G	A	2	0	2	0	0	2	0	0
4	16666267	.	C	T	2	0	2	0	0	2	0	0
4	16671232	.	C	T	0	2	2	0	1	3	0	0
4	16672771	.	C	T	9	6	15	0	0	15	0	0
4	16706865	.	T	C	2	3	5	0	0	5	0	0
4	16733585	.	G	A	1	1	2	0	0	2	0	0
4	16733984	.	C	T	2	3	5	0	0	5	0	0
4	16736812	.	C	G	3	0	3	0	3	6	0	0
4	16739122	.	G	A	0	4	4	0	5	9	0	0
4	16741979	.	T	G	4	15	19	0	0	19	0	0
4	16742444	.	G	C	11	13	24	0	0	24	0	0
4	16768990	.	C	T	0	2	2	0	0	2	0	0
4	16784712	.	A	T	3	3	6	0	0	6	0	0
4	16784840	.	G	T	13	11	24	0	0	24	0	0
4	16784876	.	C	T	1	2	3	0	0	3	0	0
4	16785393	.	A	G	23	12	35	0	2	37	0	0
4	16785664	.	A	T	17	12	29	0	2	31	0	0
4	16785766	.	T	C	11	1	12	0	1	13	0	0
4	16786002	.	C	A	2	8	10	0	2	12	0	0
4	16786018	.	A	T	1	9	10	0	0	10	0	0
4	16786059	.	T	C	2	8	10	0	0	10	0	0
4	16786077	.	G	A	3	8	11	0	0	11	0	0
4	16786208	.	C	T	5	14	19	0	0	19	0	0
4	16791616	.	G	A	2	3	5	0	0	5	0	0
4	16791673	.	C	A	6	3	9	0	0	9	0	0
4	16791780	.	A	G	8	0	8	0	6	14	0	0
4	16791781	.	G	C	9	5	14	0	0	14	0	0
4	16791883	.	T	A	4	5	9	0	2	11	0	0
4	16791934	.	C	T	4	3	7	0	1	8	0	0
4	16797045	.	A	G	1	1	2	0	0	2	0	0
4	16797173	.	A	T	1	2	3	0	0	3	0	0
4	16829355	.	T	C	44	26	70	0	2	72	0	0
4	16829387	.	T	G	33	29	62	0	4	66	0	0
4	16829651	.	G	A	25	35	60	0	10	70	0	0
4	16831399	.	A	T	14	15	29	0	1	30	0	0
4	16832124	.	C	A	2	16	18	0	8	26	0	0
4	16832894	.	G	A	5	8	13	0	0	13	0	0
4	16858074	.	A	T	5	4	9	0	0	10	1	0
4	16858075	.	A	G	5	5	10	0	0	10	0	0
4	16858289	.	G	C	8	0	8	0	6	14	0	0
4	16858414	.	A	T	4	3	7	0	0	7	0	0
4	16858442	.	C	G	0	3	3	0	3	6	0	0
4	16876881	.	A	T	2	2	4	0	0	4	0	0
4	16877387	.	C	T	0	19	19	0	14	33	0	0
4	16879505	.	T	C	12	0	12	0	11	23	0	0
4	16881865	.	T	G	0	4	4	0	0	4	0	0
4	16885898	.	A	T	2	8	10	0	0	10	0	0
4	16893050	.	A	G	2	2	4	0	0	4	0	0
4	16893062	.	T	C	4	4	8	0	0	8	0	0
4	16898904	.	A	T	6	8	14	0	1	15	0	0
4	16899273	.	T	C	9	1	10	0	0	10	0	0
4	16904521	.	C	G	19	24	43	0	1	44	0	0
4	16904527	.	A	G	20	3	23	0	22	45	0	0
4	16905090	.	T	C	9	11	20	0	2	22	0	0
4	16905119	.	T	C	12	14	26	0	0	26	0	0
4	16905184	.	T	C	13	16	29	0	2	31	0	0
4	16905224	.	A	G	13	19	32	0	1	33	0	0
4	16905318	.	G	A	20	6	26	0	1	27	0	0
4	16905370	.	G	A	7	3	10	0	1	11	0	0
4	16905410	.	C	A	1	3	4	0	0	4	0	0
4	16905511	.	C	T	6	5	11	0	1	12	0	0
4	16905684	.	T	G	19	10	29	0	2	31	0	0
4	16905708	.	T	A	20	16	36	0	0	36	0	0
4	16905723	.	C	A	16	17	33	0	1	34	0	0
4	16905853	.	T	A	14	13	27	0	1	28	0	0
4	16906173	.	C	A	18	16	34	0	2	36	0	0
4	16906198	.	C	A	19	16	35	0	0	35	0	0
4	16906244	.	A	T	17	23	40	0	1	41	0	0
4	16906562	.	G	A	19	28	47	0	0	47	0	0
4	16982269	.	G	A	13	20	33	0	4	37	0	0
4	16982682	.	C	A	8	14	22	0	0	22	0	0
4	16983183	.	G	A	2	3	5	0	0	5	0	0
4	16983434	.	T	C	21	1	22	0	19	41	0	0
4	16984252	.	C	G	7	8	15	0	1	16	0	0
4	16984542	.	A	G	14	8	22	0	1	23	0	0
4	16985045	.	C	T	10	8	18	0	0	18	0	0
4	16988139	.	A	G	12	7	19	0	0	19	0	0
4	17008995	.	A	G	2	1	3	0	0	3	0	0
4	17253737	.	A	G	10	8	18	0	1	19	0	0
4	17253758	.	C	T	6	6	12	0	1	13	0	0
4	17253813	.	A	C	6	6	12	0	0	12	0	0
4	17253818	.	A	G	6	6	12	0	0	12	0	0
4	17253925	.	T	A	12	8	20	0	0	20	0	0
4	17253927	.	T	A	12	7	19	0	1	20	0	0
4	17254046	.	A	G	11	13	24	0	1	25	0	0
4	17257386	.	G	A	2	1	3	0	0	3	0	0
4	17257458	.	C	T	5	3	8	0	0	8	0	0
4	17287446	.	T	G	6	5	11	0	0	11	0	0
4	17288964	.	T	C	14	10	24	0	1	25	0	0
4	17291024	.	A	G	6	18	24	0	2	26	0	0
4	17292575	.	C	A	7	2	9	0	1	10	0	0
4	17292770	.	G	A	14	2	16	0	1	17	0	0
4	17292789	.	A	C	19	7	26	0	0	26	0	0
4	17292837	.	A	G	21	22	43	0	1	44	0	0
4	17294947	.	T	C	0	4	4	0	0	4	0	0
4	17296974	.	A	G	8	13	21	0	1	22	0	0
4	17297086	.	C	A	12	20	32	0	2	34	0	0
4	17297338	.	T	G	4	17	21	0	0	21	0	0
4	17326234	.	C	T	1	2	3	0	0	3	0	0
4	17326465	.	A	C	1	4	5	0	1	6	0	0
4	17326506	.	T	C	1	2	3	0	0	3	0	0
4	17328010	.	G	C	3	2	5	0	0	5	0	0
4	17336624	.	C	T	7	4	11	0	1	12	0	0
4	17336693	.	G	A	6	2	8	0	0	8	0	0
4	17337593	.	A	T	3	0	3	0	0	3	0	0
4	17354747	.	G	C	3	2	5	0	1	6	0	0
4	17380828	.	C	A	2	2	4	0	0	4	0	0
4	17382878	.	G	A	0	3	3	0	0	3	0	0
4	17383774	.	G	C	1	0	1	0	0	1	0	0
4	17417692	.	C	T	0	2	2	0	1	3	0	0
4	17418109	.	G	A	2	5	7	0	0	7	0	0
4	17533769	.	C	T	4	2	6	0	0	6	0	0
4	17536140	.	T	G	1	3	4	0	0	4	0	0
4	17537639	.	A	G	2	9	11	0	1	12	0	0
4	17537939	.	G	T	0	5	5	0	8	13	0	0
4	17539261	.	T	G	4	2	6	0	0	6	0	0
4	17541730	.	G	A	1	1	2	0	1	3	0	0
4	17545083	.	A	G	0	0	0	0	2	2	0	0
4	17572583	.	C	T	18	12	30	0	1	31	0	0
4	17572589	.	C	A	17	9	26	0	1	27	0	0
4	17572898	.	T	C	10	13	23	0	2	25	0	0
4	17572901	.	A	C	10	16	26	0	0	26	0	0
4	17573071	.	A	T	18	10	28	0	0	28	0	0
4	17573081	.	G	C	18	11	29	0	0	29	0	0
4	17573464	.	A	G	5	11	16	0	0	16	0	0
4	17573465	.	A	G	5	10	15	0	1	16	0	0
4	17573594	.	T	A	10	11	21	0	0	21	0	0
4	17573616	.	A	G	8	8	16	0	0	16	0	0
4	17573644	.	A	C	7	3	10	0	1	11	0	0
4	17573802	.	T	C	16	11	27	0	2	29	0	0
4	17573841	.	A	G	13	8	21	0	3	24	0	0
4	17573865	.	T	A	9	11	20	0	5	25	0	0
4	17573959	.	T	A	12	8	20	0	0	20	0	0
4	17573982	.	A	T	11	10	21	0	0	21	0	0
4	17574093	.	A	G	15	15	30	0	1	31	0	0
4	17574175	.	G	C	12	6	18	0	0	19	1	0
4	17574390	.	C	T	13	11	24	0	2	26	0	0
4	17574608	.	A	C	7	14	21	0	0	21	0	0
4	17574706	.	T	C	8	5	13	0	0	13	0	0
4	17580468	.	A	T	2	0	2	0	0	2	0	0
4	17596433	.	T	C	9	0	9	0	11	20	0	0
4	17596490	.	T	C	2	7	9	0	0	9	0	0
4	17629138	.	C	T	0	9	9	0	6	15	0	0
4	17629266	.	C	A	6	3	9	0	0	9	0	0
4	17634668	.	G	A	1	2	3	0	0	3	0	0
4	17634841	.	G	T	4	2	6	0	0	6	0	0
4	17634881	.	T	A	2	2	4	0	0	4	0	0
4	17642813	.	G	T	0	2	2	0	0	2	0	0
4	17643252	.	A	G	1	0	1	0	0	1	0	0
4	17644600	.	T	C	3	3	6	0	0	6	0	0
4	17644913	.	A	G	3	4	7	0	0	7	0	0
4	17644964	.	G	A	1	0	1	0	0	1	0	0
4	17645408	.	T	C	4	1	5	0	1	6	0	0
4	17645890	.	A	C	0	1	1	0	1	2	0	0
4	17645962	.	C	T	1	1	2	0	0	2	0	0
4	17657549	.	A	G	3	0	3	0	6	9	0	0
4	17660723	.	C	T	8	4	12	0	0	12	0	0
4	17660732	.	A	G	11	3	14	0	0	14	0	0
4	17660859	.	G	A	6	3	9	0	1	10	0	0
4	17660871	.	A	G	5	3	8	0	0	8	0	0
4	17660938	.	T	A	3	2	5	0	0	5	0	0
4	17661046	.	A	G	2	3	5	0	0	5	0	0
4	17661062	.	A	G	3	2	5	0	0	5	0	0
4	17661102	.	T	G	2	3	5	0	0	5	0	0
4	17661265	.	A	G	9	3	12	0	0	12	0	0
4	17661349	.	C	T	8	4	12	0	1	13	0	0
4	17661354	.	T	G	7	4	11	0	1	12	0	0
4	17688795	.	T	C	5	3	8	0	0	8	0	0
4	17688849	.	T	C	7	5	12	0	0	12	0	0
4	17688874	.	T	C	6	6	12	0	0	12	0	0
4	17688897	.	C	T	7	6	13	0	0	13	0	0
4	17689128	.	C	T	0	2	2	0	0	2	0	0
4	17689464	.	C	A	1	5	6	0	0	6	0	0
4	17689476	.	A	G	1	0	1	0	3	4	0	0
4	17689551	.	G	A	3	3	6	0	0	6	0	0
4	17689561	.	T	C	4	2	6	0	0	6	0	0
4	17693223	.	C	T	2	1	3	0	0	3	0	0
4	17693286	.	T	C	6	3	9	0	0	9	0	0
4	17693400	.	A	G	2	2	4	0	0	4	0	0
4	17695054	.	A	G	0	2	2	0	0	2	0	0
4	17696254	.	G	A	1	0	1	0	0	1	0	0
4	17696341	.	A	G	3	0	3	0	5	8	0	0
4	17704067	.	G	A	0	2	2	0	0	2	0	0
4	17704123	.	T	C	4	4	8	0	1	9	0	0
4	17704279	.	T	A	5	6	11	0	0	11	0	0
4	17704345	.	C	T	4	4	8	0	0	8	0	0
4	17704393	.	A	T	4	7	11	0	0	11	0	0
4	17704560	.	A	G	4	4	8	0	0	8	0	0
4	17704885	.	T	C	0	2	2	0	0	2	0	0
4	17704915	.	A	T	0	5	5	0	1	6	0	0
4	17704928	.	T	A	1	4	5	0	0	5	0	0
4	17707849	.	A	C	3	8	11	0	0	11	0	0
4	17708230	.	T	C	7	8	15	0	0	15	0	0
4	17822279	.	G	A	0	2	2	0	0	2	0	0
4	17851366	.	T	C	1	2	3	0	0	3	0	0
4	17854396	.	C	T	2	0	2	0	0	2	0	0
4	17873351	.	A	G	5	3	8	0	1	9	0	0
4	17873530	.	T	G	4	9	13	0	0	13	0	0
4	17873743	.	C	T	5	3	8	0	0	8	0	0
4	17873787	.	G	A	0	8	8	0	6	14	0	0
4	17873808	.	G	C	5	7	12	0	0	12	0	0
4	17874009	.	T	A	3	3	6	0	0	6	0	0
4	17874010	.	G	A	3	3	6	0	0	6	0	0
4	17886974	.	G	A	12	27	39	0	4	43	0	0
4	17887059	.	T	C	26	6	32	0	2	34	0	0
4	17887388	.	A	T	14	26	40	0	1	41	0	0
4	17887826	.	C	T	23	24	47	0	2	50	1	0
4	17887885	.	A	C	19	20	39	0	4	43	0	0
4	17887966	.	C	T	0	8	8	1	9	18	0	0
4	17902098	.	A	G	16	12	28	0	0	28	0	0
4	17904325	.	A	C	8	1	9	0	12	21	0	0
4	17915070	.	G	A	7	5	12	0	0	12	0	0
4	17949261	.	C	T	10	7	17	0	2	19	0	0
4	18207890	.	T	C	4	2	6	0	1	7	0	0
4	18208347	.	C	G	6	9	15	0	1	16	0	0
4	18208519	.	A	G	0	2	2	0	0	2	0	0
4	18208635	.	T	A	1	4	5	0	1	6	0	0
4	18208939	.	C	T	5	3	8	0	0	8	0	0
4	18209107	.	G	C	5	4	9	0	1	10	0	0
4	18209185	.	A	T	8	4	12	0	0	12	0	0
4	18213267	.	C	T	8	5	13	0	0	13	0	0
4	18216182	.	A	G	2	6	8	0	0	8	0	0
4	18216251	.	T	C	5	10	15	0	0	15	0	0
4	18216332	.	A	G	7	10	17	0	3	20	0	0
4	18235106	.	T	C	4	3	7	0	0	7	0	0
4	18235397	.	A	T	4	3	7	0	1	8	0	0
4	18237355	.	A	G	1	8	9	0	0	9	0	0
4	18240356	.	A	G	1	3	4	0	0	4	0	0
4	18240451	.	G	A	1	3	4	0	0	4	0	0
4	18240536	.	G	T	3	6	9	0	0	9	0	0
4	18240546	.	C	T	0	5	5	0	5	10	0	0
4	18240607	.	C	A	0	3	3	0	4	7	0	0
4	18240658	.	T	C	0	2	2	0	1	3	0	0
4	18240690	.	A	T	0	3	3	0	0	3	0	0
4	18241255	.	C	G	1	4	5	0	0	5	0	0
4	18241297	.	C	T	1	2	3	0	0	3	0	0
4	18244632	.	T	A	1	1	2	0	0	2	0	0
4	18244669	.	G	A	1	1	2	0	0	2	0	0
4	18244670	.	G	C	1	0	1	0	1	2	0	0
4	18248692	.	C	T	0	2	2	0	4	6	0	0
4	18283111	.	A	G	2	2	4	0	0	4	0	0
4	18287449	.	T	G	5	3	8	0	1	9	0	0
4	18416371	.	C	G	3	3	6	0	0	6	0	0
4	18416462	.	T	G	1	2	3	0	0	3	0	0
4	18454352	.	A	G	7	4	11	0	0	11	0	0
4	18454363	.	T	A	6	4	10	0	1	11	0	0
4	18502437	.	A	G	2	1	3	0	0	3	0	0
4	18503393	.	G	C	0	5	5	0	0	5	0	0
4	18505935	.	G	C	0	2	2	0	0	2	0	0
4	18509231	.	A	G	0	1	1	0	0	1	0	0
4	18592863	.	A	C	1	3	4	0	1	5	0	0
4	18592916	.	T	A	3	2	5	0	0	5	0	0
4	18593839	.	G	A	15	8	23	0	3	26	0	0
4	18593989	.	T	A	6	7	13	0	3	16	0	0
4	18594019	.	G	T	8	9	17	0	0	17	0	0
4	18594045	.	T	C	7	8	15	0	1	16	0	0
4	18594125	.	T	A	13	5	18	0	0	18	0	0
4	18594789	.	T	G	2	2	4	0	1	5	0	0
4	18594871	.	T	C	8	4	12	0	0	12	0	0
4	18594920	.	G	A	11	8	19	0	2	21	0	0
4	18597841	.	C	G	12	11	23	0	1	24	0	0
4	18606501	.	G	T	3	4	7	0	1	8	0	0
4	18606512	.	C	T	4	6	10	0	1	11	0	0
4	18609613	.	T	G	6	3	9	0	0	9	0	0
4	18609759	.	C	G	0	2	2	0	1	3	0	0
4	18609769	.	A	G	1	2	3	0	0	3	0	0
4	18609855	.	G	C	3	3	6	0	0	6	0	0
4	18614208	.	C	T	4	4	8	0	0	8	0	0
4	18614232	.	A	G	5	5	10	0	0	10	0	0
4	18614367	.	A	G	3	3	6	0	0	6	0	0
4	18614484	.	G	A	0	1	1	0	0	1	0	0
4	18623708	.	A	G	2	2	4	0	0	4	0	0
4	18720871	.	C	T	9	5	14	0	1	15	0	0
4	18720942	.	C	T	4	3	7	0	0	7	0	0
4	18720947	.	G	T	4	3	7	0	0	7	0	0
4	18737966	.	T	G	1	2	3	0	0	3	0	0
4	18741886	.	T	C	1	2	3	0	0	3	0	0
4	18837166	.	T	G	1	1	2	0	12	14	0	0
4	18837177	.	T	G	4	0	4	0	12	16	0	0
4	18837898	.	A	T	7	8	15	0	2	17	0	0
4	18848977	.	A	C	3	4	7	0	0	7	0	0
4	18850630	.	A	G	1	1	2	0	0	2	0	0
4	18852954	.	T	A	1	2	3	0	0	3	0	0
4	18853153	.	C	T	3	5	8	0	1	9	0	0
4	18853972	.	C	G	11	13	24	0	2	26	0	0
4	18854250	.	A	C	10	0	10	0	21	31	0	0
4	18963897	.	G	A	0	3	3	0	6	9	0	0
4	18963908	.	C	A	5	3	8	0	0	8	0	0
4	18963960	.	G	C	6	4	10	0	0	10	0	0
4	18976182	.	A	G	2	1	3	0	0	3	0	0
4	18976574	.	C	T	1	0	1	0	1	2	0	0
4	18979820	.	T	A	2	4	6	0	0	6	0	0
4	18985807	.	T	A	21	6	27	0	2	29	0	0
4	18985846	.	A	G	18	10	28	0	0	28	0	0
4	18985995	.	G	A	15	9	24	0	1	25	0	0
4	18986107	.	C	T	6	5	11	0	1	12	0	0
4	18986282	.	T	C	8	0	8	0	6	14	0	0
4	18986293	.	T	G	7	6	13	0	0	13	0	0
4	18986413	.	G	A	10	14	24	0	0	24	0	0
4	18986497	.	C	T	1	14	15	0	10	25	0	0
4	18986805	.	G	T	10	4	14	0	0	14	0	0
4	18986893	.	C	G	3	8	11	0	0	11	0	0
4	18986897	.	T	A	3	6	9	0	0	9	0	0
4	18987216	.	T	C	10	3	13	0	0	13	0	0
4	18987250	.	G	A	10	3	13	0	0	13	0	0
4	18987275	.	A	G	9	3	12	0	0	12	0	0
4	18987391	.	G	A	7	7	14	0	0	14	0	0
4	18987523	.	T	C	10	11	21	0	3	24	0	0
4	18987835	.	G	C	11	0	11	0	12	23	0	0
4	18988068	.	T	C	4	0	4	0	13	17	0	0
4	18988084	.	G	A	8	9	17	0	0	17	0	0
4	18988150	.	T	G	8	4	12	0	0	12	0	0
4	18988222	.	A	G	7	8	15	0	0	15	0	0
4	18988270	.	T	A	6	9	15	0	1	16	0	0
4	18989185	.	T	C	1	0	1	0	7	8	0	0
4	18999680	.	C	T	0	3	3	0	2	5	0	0
4	19007377	.	T	A	4	2	6	0	0	6	0	0
4	19007601	.	A	T	2	5	7	0	0	7	0	0
4	19007711	.	T	C	4	0	4	0	4	8	0	0
4	19007811	.	T	C	5	2	7	0	1	8	0	0
4	19007823	.	A	G	3	2	5	0	3	8	0	0
4	19008090	.	C	T	0	2	2	0	3	5	0	0
4	19397641	.	A	T	17	9	26	0	0	26	0	0
4	19414905	.	G	A	2	3	5	0	1	6	0	0
4	19493773	.	G	T	9	3	12	0	1	13	0	0
4	19493808	.	G	A	12	3	15	0	1	16	0	0
4	19535841	.	T	G	10	14	24	0	2	26	0	0
4	19536422	.	T	C	14	14	28	0	0	28	0	0
4	19536917	.	C	T	16	25	41	0	1	42	0	0
4	19537703	.	A	G	31	26	57	0	2	59	0	0
4	19537937	.	A	G	29	0	29	0	26	55	0	0
4	19539017	.	C	T	13	8	21	0	1	22	0	0
4	19567605	.	A	G	5	7	12	0	1	13	0	0
4	19611694	.	G	A	3	1	4	0	0	4	0	0
4	19611739	.	T	G	5	3	8	0	0	8	0	0
4	19630280	.	A	G	1	0	1	0	0	1	0	0
4	19651917	.	G	A	1	0	1	0	0	1	0	0
4	19948131	.	G	A	2	4	6	0	0	6	0	0
4	19948312	.	A	G	4	5	9	0	0	9	0	0
4	19948313	.	A	G	5	4	9	0	0	9	0	0
4	19948467	.	T	C	1	3	4	0	0	4	0	0
4	19948602	.	C	A	2	4	6	0	0	6	0	0
4	19948746	.	T	C	5	5	10	0	0	10	0	0
4	19949069	.	T	A	3	2	5	0	0	5	0	0
4	19949148	.	T	C	7	9	16	0	0	16	0	0
4	19949178	.	A	T	7	8	15	0	0	15	0	0
4	19949651	.	C	T	0	4	4	0	3	7	0	0
4	19949963	.	T	C	4	6	10	0	0	10	0	0
4	19949985	.	T	C	3	3	6	0	0	6	0	0
4	19950024	.	T	A	3	2	5	0	0	5	0	0
4	19950032	.	T	A	6	1	7	0	0	7	0	0
4	19950162	.	C	T	0	2	2	0	2	4	0	0
4	19954907	.	G	C	1	0	1	0	5	6	0	0
4	20049543	.	C	T	30	29	59	0	1	60	0	0
4	20051021	.	A	G	24	20	44	0	1	45	0	0
4	20051092	.	C	T	0	15	15	0	17	32	0	0
4	20051485	.	A	G	0	1	1	0	0	1	0	0
4	20051488	.	A	G	0	1	1	0	0	1	0	0
4	20053199	.	T	C	13	7	20	0	0	20	0	0
4	20053211	.	A	G	13	7	20	0	0	20	0	0
4	20053901	.	C	T	11	15	26	0	1	27	0	0
4	20054036	.	C	T	17	6	23	0	1	24	0	0
4	20054135	.	A	G	10	11	21	0	0	21	0	0
4	20054190	.	T	G	2	4	6	0	0	6	0	0
4	20054243	.	A	G	4	5	9	0	0	9	0	0
4	20054516	.	C	T	3	2	5	0	0	5	0	0
4	20060589	.	A	G	0	0	0	0	3	3	0	0
4	20060614	.	C	T	3	1	4	0	0	4	0	0
4	20066194	.	T	G	4	2	6	0	0	6	0	0
4	20066208	.	G	A	4	3	7	0	1	8	0	0
4	20068149	.	T	G	4	3	7	0	1	8	0	0
4	20068185	.	A	G	3	4	7	0	0	7	0	0
4	20068266	.	A	G	7	4	11	0	0	11	0	0
4	20068446	.	G	A	5	11	16	0	0	16	0	0
4	20068470	.	C	G	6	10	16	0	0	17	1	0
4	20068717	.	G	A	2	4	6	0	0	6	0	0
4	20068890	.	G	A	9	6	15	0	3	18	0	0
4	20068903	.	T	C	11	12	23	0	1	24	0	0
4	20069343	.	C	A	3	15	18	0	0	18	0	0
4	20069417	.	T	C	6	5	11	0	1	12	0	0
4	20069449	.	G	A	8	2	10	0	0	10	0	0
4	20071344	.	A	T	5	6	11	0	0	11	0	0
4	20071401	.	G	T	6	4	10	0	0	10	0	0
4	20071877	.	C	T	0	3	3	0	6	9	0	0
4	20072035	.	T	C	2	4	6	0	0	6	0	0
4	20072084	.	G	C	2	1	3	0	0	3	0	0
4	20072094	.	C	T	2	2	4	0	0	4	0	0
4	20072394	.	C	G	6	10	16	0	2	18	0	0
4	20072429	.	T	G	8	12	20	0	0	20	0	0
4	20073790	.	T	C	2	1	3	0	0	3	0	0
4	20073799	.	A	G	2	1	3	0	0	3	0	0
4	20080778	.	T	A	1	0	1	0	0	1	0	0
4	20081520	.	C	A	0	4	4	0	2	6	0	0
4	20089075	.	C	A	2	1	3	0	0	3	0	0
4	20091055	.	G	C	0	5	5	0	2	7	0	0
4	20099261	.	C	T	6	4	10	0	2	12	0	0
4	20099516	.	G	A	0	5	5	0	2	7	0	0
4	20099564	.	C	T	5	5	10	0	0	10	0	0
4	20101105	.	G	T	5	10	15	0	0	15	0	0
4	20102901	.	C	A	5	2	7	0	1	8	0	0
4	20103319	.	A	G	1	2	3	0	1	4	0	0
4	20103813	.	T	A	1	0	1	0	0	1	0	0
4	20103864	.	G	A	1	0	1	0	0	1	0	0
4	20103873	.	T	C	0	2	2	0	0	2	0	0
4	20127909	.	C	T	2	2	4	0	0	4	0	0
4	20129813	.	C	T	2	2	4	0	0	4	0	0
4	20129822	.	C	T	2	1	3	0	1	4	0	0
4	20130015	.	G	T	2	1	3	0	0	3	0	0
4	20226677	.	A	G	0	2	2	0	1	3	0	0
4	20226826	.	T	C	1	1	2	0	0	2	0	0
4	20226916	.	A	C	1	3	4	0	0	4	0	0
4	20229626	.	C	T	3	6	9	0	3	12	0	0
4	20229920	.	C	A	0	8	8	0	11	19	0	0
4	20230213	.	G	A	7	6	13	0	0	13	0	0
4	20235766	.	G	A	7	3	10	0	2	12	0	0
4	20237997	.	G	T	1	2	3	0	0	3	0	0
4	20265309	.	C	T	8	4	12	0	0	12	0	0
4	20303423	.	T	C	2	4	6	0	0	6	0	0
4	20303545	.	T	C	1	2	3	0	0	3	0	0
4	20303604	.	T	C	0	1	1	0	0	1	0	0
4	20305777	.	T	G	2	2	4	0	0	4	0	0
4	20305985	.	A	C	2	3	5	0	0	5	0	0
4	20305991	.	G	C	2	2	4	0	0	4	0	0
4	20464937	.	C	T	1	0	1	0	0	1	0	0
4	20465899	.	C	T	1	1	2	0	0	2	0	0
4	20470061	.	G	A	5	3	8	0	0	8	0	0
4	20470316	.	C	T	6	5	11	0	0	11	0	0
4	20473032	.	G	A	8	5	13	0	0	13	0	0
4	20473127	.	G	A	0	7	7	0	7	14	0	0
4	20473142	.	C	T	8	6	14	0	0	14	0	0
4	20473175	.	C	T	5	7	12	0	0	12	0	0
4	20474728	.	A	T	7	6	13	0	0	13	0	0
4	20474969	.	A	G	9	0	9	0	4	13	0	0
4	20480734	.	G	A	2	6	8	0	0	8	0	0
4	20482150	.	T	C	3	4	7	0	0	7	0	0
4	20482425	.	A	G	8	4	12	0	0	12	0	0
4	20482506	.	C	T	9	8	17	0	1	18	0	0
4	20482615	.	G	T	4	5	9	0	0	9	0	0
4	20482726	.	A	G	4	7	11	0	0	11	0	0
4	20483785	.	G	A	1	2	3	0	0	3	0	0
4	20483846	.	T	G	6	3	9	0	0	9	0	0
4	20486260	.	A	T	1	1	2	0	0	2	0	0
4	20490031	.	C	T	1	0	1	0	0	1	0	0
4	20490043	.	T	C	2	0	2	0	0	2	0	0
4	20494332	.	C	T	3	4	7	0	3	10	0	0
4	20496653	.	A	G	2	4	6	0	1	7	0	0
4	20496655	.	C	T	3	4	7	0	0	7	0	0
4	20499421	.	G	C	4	2	6	0	0	6	0	0
4	20499440	.	A	G	5	3	8	0	0	8	0	0
4	20507121	.	T	A	8	7	15	0	3	18	0	0
4	20507155	.	A	C	10	7	17	0	3	20	0	0
4	20507473	.	T	A	2	0	2	0	0	2	0	0
4	20507546	.	T	A	4	7	11	0	1	12	0	0
4	20508691	.	G	A	1	0	1	0	0	1	0	0
4	20508913	.	A	G	5	14	19	0	1	20	0	0
4	20508928	.	A	G	6	14	20	0	0	20	0	0
4	20508992	.	C	T	10	5	15	0	0	15	0	0
4	20950816	.	T	C	1	2	3	0	0	3	0	0
4	20955052	.	T	C	3	2	5	0	0	5	0	0
4	20965483	.	T	C	3	2	5	0	0	5	0	0
4	20976062	.	A	T	2	0	2	0	0	2	0	0
4	20976252	.	G	A	2	0	2	0	0	2	0	0
4	20976371	.	C	T	0	2	2	0	0	2	0	0
4	20979435	.	C	A	6	6	12	0	0	12	0	0
4	20980971	.	A	G	2	1	3	0	0	3	0	0
4	20981198	.	G	A	2	7	9	0	12	21	0	0
4	20981273	.	A	C	3	0	3	0	0	3	0	0
4	21290798	.	G	A	12	11	23	0	1	24	0	0
4	21295949	.	T	C	18	9	27	0	1	28	0	0
4	21297417	.	A	C	14	15	29	0	1	30	0	0
4	21312981	.	C	T	27	26	53	0	10	63	0	0
4	21313120	.	A	G	32	6	38	0	27	65	0	0
4	21313136	.	T	C	33	24	57	0	7	64	0	0
4	21313779	.	T	G	34	20	54	0	2	56	0	0
4	21313805	.	G	A	1	27	28	0	36	64	0	0
4	21314120	.	T	C	23	23	46	0	1	47	0	0
4	21314204	.	G	T	27	13	40	0	0	41	1	0
4	21314338	.	G	T	29	33	62	0	1	63	0	0
4	21314583	.	T	C	26	31	57	0	2	59	0	0
4	21323174	.	T	A	4	3	7	0	0	7	0	0
4	21323363	.	G	C	1	4	5	0	0	5	0	0
4	21323454	.	A	G	2	3	5	0	0	5	0	0
4	21323467	.	G	C	2	4	6	0	0	6	0	0
4	21323532	.	C	T	0	5	5	0	5	10	0	0
4	21323536	.	T	C	5	5	10	0	0	10	0	0
4	21369434	.	G	A	1	2	3	0	0	3	0	0
4	21489550	.	A	G	15	2	17	0	2	19	0	0
4	21489629	.	G	T	16	10	26	0	2	28	0	0
4	21490320	.	T	C	18	9	27	0	0	27	0	0
4	21490344	.	A	G	18	7	25	0	4	30	1	0
4	21499521	.	G	A	4	0	4	0	0	4	0	0
4	21507026	.	G	A	4	2	6	0	1	7	0	0
4	21508353	.	C	T	7	7	14	0	0	14	0	0
4	21512191	.	C	T	1	4	5	0	1	6	0	0
4	21517970	.	A	G	1	2	3	0	1	4	0	0
4	21523541	.	A	T	3	3	6	0	1	7	0	0
4	21523789	.	T	G	9	7	16	0	0	16	0	0
4	21526300	.	A	G	1	1	2	0	0	2	0	0
4	21649505	.	G	A	14	16	30	0	5	35	0	0
4	21651486	.	G	A	17	14	31	0	1	32	0	0
4	21652609	.	A	T	0	1	1	0	0	1	0	0
4	21752284	.	G	A	8	12	20	0	2	22	0	0
4	21752291	.	C	T	10	13	23	0	1	24	0	0
4	21752372	.	T	A	8	8	16	0	0	16	0	0
4	21752493	.	T	C	1	6	7	0	0	7	0	0
4	21752495	.	C	G	1	6	7	0	0	7	0	0
4	21752688	.	G	C	21	0	21	0	9	30	0	0
4	21752736	.	T	C	15	11	26	0	1	27	0	0
4	21752941	.	T	A	9	13	22	0	2	24	0	0
4	21752969	.	C	T	10	15	25	0	1	26	0	0
4	21752984	.	C	A	11	12	23	0	1	24	0	0
4	21753139	.	C	T	10	16	26	0	0	26	0	0
4	21753185	.	T	C	17	15	32	0	0	32	0	0
4	21753316	.	T	C	15	13	28	0	3	31	0	0
4	21753344	.	G	A	16	11	27	0	1	28	0	0
4	21761688	.	A	T	10	9	19	0	0	19	0	0
4	21975679	.	T	C	5	4	9	0	0	9	0	0
4	22445728	.	A	G	3	0	3	0	0	3	0	0
4	22756239	.	T	C	13	16	29	0	1	30	0	0
4	25755866	.	T	C	3	2	5	0	0	5	0	0
4	25843710	.	T	C	1	1	2	0	0	2	0	0
4	26080441	.	C	T	2	16	18	0	0	18	0	0
4	26080593	.	T	C	1	8	9	0	0	9	0	0
4	27112663	.	T	A	1	4	5	0	2	7	0	0
4	28379053	.	A	T	3	2	5	0	0	5	0	0
4	31412388	.	G	A	0	3	3	0	1	4	0	0
4	31635025	.	C	G	1	0	1	0	0	1	0	0
4	40959639	.	T	G	1	4	5	0	0	5	0	0
4	50756495	.	G	A	1	3	4	0	0	4	0	0
4	59701366	.	T	C	1	0	1	0	4	5	0	0
4	61802443	.	T	A	1	2	3	0	0	3	0	0
4	65727802	.	C	T	1	3	4	0	0	4	0	0
4	65727822	.	G	A	0	3	3	0	1	4	0	0
4	69899771	.	C	T	1	2	3	0	0	3	0	0
4	70849692	.	C	T	0	1	1	0	1	2	0	0
4	70850966	.	G	T	6	4	10	0	0	10	0	0
4	70851051	.	A	G	6	5	11	0	0	11	0	0
4	70851105	.	A	G	3	3	6	1	1	8	0	0
4	70860034	.	A	C	0	0	0	0	1	1	0	0
4	70860166	.	A	G	4	3	7	0	2	9	0	0
4	70866787	.	A	T	6	4	10	0	0	10	0	0
4	70866791	.	A	T	7	4	11	0	0	11	0	0
4	72217058	.	T	A	1	2	3	0	0	3	0	0
4	72217061	.	T	A	1	2	3	0	0	3	0	0
4	72217405	.	C	T	1	5	6	0	0	6	0	0
4	72217438	.	A	C	2	7	9	0	0	9	0	0
4	72217779	.	A	G	3	0	3	0	2	5	0	0
4	72217813	.	T	C	2	2	4	0	1	5	0	0
4	72235663	.	A	G	1	1	2	0	0	2	0	0
4	72235685	.	C	G	1	3	4	0	0	4	0	0
4	72235804	.	C	T	1	5	6	0	1	7	0	0
4	72272239	.	G	A	8	3	11	0	0	11	0	0
4	72272461	.	C	T	1	4	5	0	0	5	0	0
4	72272491	.	A	G	3	3	6	0	0	6	0	0
4	72272617	.	G	A	3	4	7	0	0	7	0	0
4	72272890	.	A	C	2	0	2	0	6	8	0	0
4	72275308	.	C	T	1	1	2	0	0	2	0	0
4	72295873	.	T	A	1	2	3	0	0	3	0	0
4	72348855	.	A	C	2	0	2	0	2	4	0	0
4	72348990	.	C	G	2	2	4	0	0	4	0	0
4	72559558	.	A	G	7	5	12	0	0	12	0	0
4	72559585	.	A	G	5	5	10	0	0	10	0	0
4	72559612	.	A	G	5	4	9	0	0	9	0	0
4	72560536	.	C	A	0	3	3	0	1	4	0	0
4	72560546	.	T	A	1	3	4	0	0	4	0	0
4	72603653	.	G	A	1	4	5	0	0	5	0	0
4	72604255	.	G	A	3	3	6	0	0	6	0	0
4	72604579	.	T	C	2	3	5	0	0	5	0	0
4	72629250	.	T	A	1	3	4	0	0	4	0	0
4	72629295	.	T	C	1	4	5	0	0	5	0	0
4	72629345	.	T	C	1	2	3	0	0	3	0	0
4	72629601	.	G	A	1	4	5	0	0	5	0	0
4	72629622	.	G	A	1	4	5	0	0	5	0	0
4	72629787	.	G	A	2	2	4	0	0	4	0	0
4	72678592	.	G	C	2	2	4	0	0	4	0	0
4	72678610	.	T	C	2	0	2	0	2	4	0	0
4	72754244	.	C	T	18	16	34	0	1	35	0	0
4	72772769	.	T	C	9	9	18	0	2	20	0	0
4	72774085	.	C	T	9	8	17	0	0	17	0	0
4	72775687	.	C	A	2	2	4	0	0	4	0	0
4	72781277	.	A	G	1	0	1	0	0	1	0	0
4	72784800	.	T	C	7	16	23	0	0	23	0	0
4	72784939	.	T	G	0	1	1	0	5	6	0	0
4	72784940	.	A	C	1	4	5	0	1	6	0	0
4	72785055	.	T	C	1	3	4	0	0	4	0	0
4	72785056	.	T	C	1	3	4	0	0	4	0	0
4	72785238	.	T	A	1	4	5	0	0	5	0	0
4	72785245	.	C	T	1	5	6	0	0	6	0	0
4	72785632	.	A	G	3	0	3	0	3	6	0	0
4	73049227	.	C	G	1	2	3	0	0	3	0	0
4	73059149	.	C	T	1	3	4	0	0	4	0	0
4	73059245	.	C	T	2	3	5	0	0	5	0	0
4	73063082	.	A	G	1	0	1	0	0	1	0	0
4	73063117	.	C	T	4	2	6	0	2	8	0	0
4	73063417	.	T	G	7	3	10	0	0	10	0	0
4	73063427	.	A	C	6	2	8	0	0	8	0	0
4	73063511	.	C	T	3	3	6	0	0	6	0	0
4	73064480	.	A	G	1	2	3	0	0	3	0	0
4	73186078	.	A	G	0	2	2	0	0	2	0	0
4	73186096	.	A	T	1	2	3	0	0	3	0	0
4	73186138	.	T	C	2	2	4	0	0	4	0	0
4	73186143	.	C	A	2	2	4	0	0	4	0	0
4	73186242	.	A	C	1	3	4	0	0	4	0	0
4	73186708	.	G	A	1	2	3	0	0	3	0	0
4	73187473	.	G	A	1	2	3	0	0	3	0	0
4	73228154	.	C	T	1	0	1	0	0	1	0	0
4	73279057	.	T	C	0	2	2	0	0	2	0	0
4	73335530	.	A	G	2	2	4	0	0	4	0	0
4	73335956	.	G	A	3	2	5	0	0	5	0	0
4	73335990	.	T	A	3	5	8	0	0	8	0	0
4	73336229	.	T	C	4	3	7	0	1	8	0	0
4	73336233	.	T	C	2	0	2	0	5	7	0	0
4	73336618	.	C	T	2	3	5	0	0	5	0	0
4	73336629	.	C	T	2	4	6	0	0	6	0	0
4	73336700	.	T	C	1	3	4	0	0	4	0	0
4	73336711	.	T	C	1	1	2	0	4	6	0	0
4	73336748	.	C	T	0	1	1	0	5	6	0	0
4	73336818	.	C	T	2	3	5	0	0	5	0	0
4	73336909	.	G	A	3	2	5	0	0	5	0	0
4	73337244	.	A	G	6	4	10	0	0	10	0	0
4	73337248	.	G	A	6	3	9	0	1	10	0	0
4	73337565	.	T	A	0	1	1	0	1	2	0	0
4	73337601	.	G	A	1	2	3	0	0	3	0	0
4	73338060	.	C	A	2	3	5	0	0	5	0	0
4	73338062	.	T	C	2	3	5	0	0	5	0	0
4	73338265	.	G	T	1	2	3	0	0	3	0	0
4	73383499	.	G	A	3	4	7	0	0	7	0	0
4	73418744	.	A	T	1	8	9	0	0	9	0	0
4	73418823	.	T	C	2	8	10	0	0	10	0	0
4	73419010	.	G	A	2	4	6	1	0	7	0	0
4	73419026	.	C	T	3	4	7	1	1	9	0	0
4	73419160	.	C	T	1	2	3	0	0	3	0	0
4	73419209	.	G	T	1	3	4	0	0	4	0	0
4	73419217	.	G	A	1	3	4	0	0	4	0	0
4	73419550	.	G	A	1	2	3	0	0	3	0	0
4	73419799	.	G	A	1	1	2	0	1	3	0	0
4	73419970	.	G	A	2	2	4	0	1	5	0	0
4	73419995	.	C	T	5	1	6	0	0	6	0	0
4	73447096	.	C	T	0	1	1	0	1	2	0	0
4	73456087	.	T	G	2	2	4	0	0	4	0	0
4	73472829	.	A	G	1	2	3	0	0	3	0	0
4	73473128	.	T	C	2	5	7	0	0	7	0	0
4	73473154	.	T	C	1	2	3	0	0	3	0	0
4	73473169	.	G	C	0	2	2	0	0	2	0	0
4	73491352	.	C	A	1	3	4	0	0	4	0	0
4	73491361	.	G	A	1	3	4	0	0	4	0	0
4	73499231	.	T	A	4	5	9	0	0	9	0	0
4	73499235	.	T	A	3	5	8	0	1	9	0	0
4	73499279	.	T	C	3	4	7	0	0	7	0	0
4	73501310	.	T	C	1	2	3	0	0	3	0	0
4	73501311	.	G	A	1	2	3	0	0	3	0	0
4	73501516	.	T	C	1	2	3	0	0	3	0	0
4	73501699	.	T	C	3	3	6	0	0	6	0	0
4	73502140	.	G	A	3	2	5	0	0	5	0	0
4	73519301	.	T	A	4	5	9	0	0	9	0	0
4	73542536	.	G	A	3	3	6	0	0	6	0	0
4	73542582	.	A	G	2	4	6	0	0	6	0	0
4	73542757	.	C	A	1	2	3	0	1	4	0	0
4	73542775	.	C	T	0	2	2	0	2	4	0	0
4	73542830	.	C	T	3	3	6	0	1	7	0	0
4	73542845	.	G	A	3	4	7	0	0	7	0	0
4	73542913	.	A	G	4	4	8	0	0	8	0	0
4	73543369	.	A	G	1	3	4	0	2	6	0	0
4	73543687	.	T	C	3	0	3	0	2	5	0	0
4	73550570	.	A	T	3	2	5	0	0	5	0	0
4	73550610	.	A	T	3	2	5	0	0	5	0	0
4	73551240	.	T	C	4	3	7	0	0	7	0	0
4	73551581	.	T	A	1	3	4	0	0	4	0	0
4	73551600	.	T	C	1	3	4	0	0	4	0	0
4	73573799	.	T	A	6	3	9	0	0	9	0	0
4	73574235	.	A	G	5	3	8	0	0	8	0	0
4	73574325	.	C	T	5	2	7	0	1	8	0	0
4	73574332	.	G	A	6	3	9	0	0	9	0	0
4	73574374	.	G	A	3	4	7	0	0	7	0	0
4	73574386	.	T	A	3	6	9	0	1	10	0	0
4	73574579	.	A	G	2	2	4	0	0	4	0	0
4	73574583	.	C	G	2	2	4	0	0	4	0	0
4	73575094	.	T	C	2	4	6	0	1	7	0	0
4	73575171	.	A	G	3	2	5	0	0	5	0	0
4	73575354	.	T	C	5	0	5	0	2	7	0	0
4	73575746	.	T	A	0	2	2	0	0	2	0	0
4	73575898	.	G	A	2	3	5	0	0	5	0	0
4	73575899	.	G	A	2	3	5	0	0	5	0	0
4	73638857	.	G	A	3	4	7	0	0	7	0	0
4	73677396	.	G	A	1	2	3	0	0	3	0	0
4	73681574	.	A	G	1	3	4	0	0	4	0	0
4	73681663	.	T	A	3	3	6	0	0	6	0	0
4	73690653	.	T	C	2	3	5	0	0	5	0	0
4	73701906	.	C	A	0	2	2	0	1	3	0	0
4	73701909	.	T	C	0	1	1	0	2	3	0	0
4	73711740	.	G	C	0	2	2	0	0	2	0	0
4	73713434	.	C	T	1	2	3	0	0	3	0	0
4	73713818	.	A	G	2	2	4	0	0	4	0	0
4	73713850	.	G	T	2	2	4	0	0	4	0	0
4	73729780	.	C	A	4	4	8	0	1	9	0	0
4	73731331	.	T	C	1	2	3	0	1	4	0	0
4	73740179	.	G	A	2	3	5	0	0	5	0	0
4	73740209	.	G	A	6	3	9	0	0	9	0	0
4	73740301	.	G	A	8	6	14	0	0	14	0	0
4	73740391	.	C	G	8	6	14	0	0	14	0	0
4	73740409	.	C	A	8	3	11	0	0	11	0	0
4	73740487	.	C	G	3	4	7	0	0	7	0	0
4	73740517	.	A	G	4	4	8	0	0	8	0	0
4	73740651	.	G	C	5	7	12	0	0	12	0	0
4	73740691	.	T	A	6	3	9	0	0	9	0	0
4	73740763	.	T	A	3	2	5	0	0	5	0	0
4	73740814	.	T	C	1	2	3	0	3	6	0	0
4	73740824	.	A	G	1	3	4	0	1	5	0	0
4	73740850	.	G	T	0	2	2	0	3	5	0	0
4	73740879	.	A	C	5	4	9	0	0	9	0	0
4	73741258	.	G	A	2	3	5	0	0	5	0	0
4	73741283	.	T	C	2	3	5	0	1	6	0	0
4	73741298	.	A	G	2	2	4	0	2	6	0	0
4	73741749	.	G	T	2	2	4	0	0	4	0	0
4	73741764	.	G	A	2	2	4	0	0	4	0	0
4	73758301	.	A	C	3	1	4	0	0	4	0	0
4	73758308	.	T	C	2	1	3	0	1	4	0	0
4	73759668	.	T	C	2	0	2	0	3	5	0	0
4	73773222	.	T	G	1	0	1	0	0	1	0	0
4	73796355	.	A	T	3	2	5	0	2	7	0	0
4	73815760	.	G	C	2	0	2	0	2	4	0	0
4	73815767	.	C	T	2	2	4	0	0	4	0	0
4	73816163	.	T	C	3	0	3	0	3	6	0	0
4	73816175	.	T	C	3	0	3	0	3	6	0	0
4	73816252	.	C	T	0	2	2	0	0	2	0	0
4	73848472	.	T	C	1	0	1	0	3	4	0	0
4	73899511	.	A	G	4	0	4	0	4	8	0	0
4	73981397	.	C	T	5	2	7	0	0	7	0	0
4	73981558	.	G	A	0	2	2	0	4	6	0	0
4	73982780	.	A	G	0	2	2	0	0	2	0	0
4	73982976	.	A	G	0	1	1	0	1	2	0	0
4	73982980	.	A	G	1	1	2	0	1	3	0	0
4	74008378	.	T	A	1	2	3	0	0	3	0	0
4	74087781	.	G	A	7	14	21	0	3	24	0	0
4	74087785	.	G	C	11	13	24	0	0	24	0	0
4	74088060	.	T	G	9	11	20	0	0	20	0	0
4	74109763	.	A	T	7	10	17	0	0	17	0	0
4	74131583	.	T	G	7	0	7	0	3	10	0	0
4	74131717	.	G	A	1	2	3	0	5	8	0	0
4	74135244	.	G	T	2	2	4	0	1	5	0	0
4	74135295	.	A	G	5	6	11	0	2	13	0	0
4	74135415	.	C	T	10	5	15	0	0	15	0	0
4	74141580	.	C	A	2	2	4	0	1	5	0	0
4	74141797	.	A	G	2	4	6	0	0	6	0	0
4	74141819	.	T	C	3	3	6	0	0	6	0	0
4	74174078	.	C	T	0	1	1	0	0	1	0	0
4	74176550	.	G	A	2	2	4	0	0	4	0	0
4	74180716	.	G	A	0	7	7	0	13	20	0	0
4	74180788	.	T	C	3	1	4	0	0	4	0	0
4	74182382	.	G	C	2	7	9	0	0	9	0	0
4	74182389	.	G	T	2	6	8	0	0	8	0	0
4	74193480	.	C	G	2	0	2	0	0	2	0	0
4	74196686	.	T	C	1	1	2	0	0	2	0	0
4	74196704	.	T	C	1	4	5	0	0	5	0	0
4	74196764	.	G	T	1	6	7	0	1	8	0	0
4	74200391	.	C	T	2	2	4	0	1	5	0	0
4	74204177	.	T	C	12	14	26	0	2	28	0	0
4	74204236	.	G	T	0	8	8	0	9	17	0	0
4	74204387	.	G	T	6	6	12	0	0	12	0	0
4	74204494	.	A	T	6	2	8	0	2	10	0	0
4	74204687	.	A	G	0	6	6	0	0	6	0	0
4	74204842	.	A	G	11	8	19	0	1	20	0	0
4	74205295	.	T	C	7	4	11	0	0	11	0	0
4	74267225	.	A	G	7	5	12	0	1	13	0	0
4	74267348	.	C	T	3	8	11	0	0	11	0	0
4	74267519	.	A	G	10	13	23	0	3	26	0	0
4	74267540	.	G	A	1	9	10	0	14	24	0	0
4	74267582	.	T	G	6	11	17	0	2	19	0	0
4	74267639	.	T	A	15	8	23	0	0	23	0	0
4	74267733	.	A	T	16	16	32	0	1	33	0	0
4	74267748	.	C	T	14	18	32	0	2	34	0	0
4	74267865	.	A	C	9	13	22	0	0	22	0	0
4	74268175	.	A	G	3	6	9	0	0	9	0	0
4	74271251	.	G	A	4	3	7	0	0	7	0	0
4	74278079	.	T	G	7	6	13	0	2	15	0	0
4	74278093	.	C	T	0	4	4	0	5	9	0	0
4	74282709	.	C	T	3	2	5	0	0	5	0	0
4	74282917	.	G	A	0	3	3	0	0	3	0	0
4	74284790	.	A	C	4	2	6	0	0	6	0	0
4	74287776	.	T	A	1	0	1	0	0	1	0	0
4	74301564	.	C	T	0	2	2	0	0	2	0	0
4	74456555	.	G	C	1	0	1	0	1	2	0	0
4	74875802	.	A	G	0	3	3	0	0	3	0	0
4	74943202	.	A	T	6	13	19	0	1	20	0	0
4	74952477	.	G	A	8	12	20	0	2	22	0	0
4	74952525	.	A	G	14	2	16	0	14	30	0	0
4	74952660	.	G	T	2	12	14	0	13	27	0	0
4	74960826	.	C	T	10	22	32	0	2	34	0	0
4	74961011	.	C	T	17	9	26	0	3	29	0	0
4	74961075	.	G	A	14	14	28	0	1	29	0	0
4	74961520	.	T	A	4	5	9	0	0	9	0	0
4	76322771	.	T	C	2	6	8	0	0	8	0	0
4	76334633	.	A	G	1	0	1	0	3	4	0	0
4	76335026	.	A	T	0	2	2	0	0	2	0	0
4	76336468	.	T	A	3	2	5	0	0	5	0	0
4	76336471	.	A	C	2	3	5	0	0	5	0	0
4	76343850	.	A	G	2	2	4	0	0	4	0	0
4	76345974	.	A	G	1	4	5	0	2	7	0	0
4	76346004	.	T	C	5	4	9	0	1	10	0	0
4	76346011	.	T	C	7	4	11	0	0	11	0	0
4	76346188	.	T	A	6	6	12	0	0	12	0	0
4	76346564	.	C	T	2	3	5	0	0	5	0	0
4	76347126	.	T	C	4	6	10	0	0	10	0	0
4	76347163	.	A	G	3	3	6	0	0	6	0	0
4	76347508	.	T	G	4	5	9	0	0	9	0	0
4	76347722	.	C	T	7	5	12	0	1	13	0	0
4	76347885	.	G	C	2	4	6	0	0	6	0	0
4	76347977	.	A	T	6	2	8	0	0	8	0	0
4	76348088	.	T	A	7	7	14	0	0	14	0	0
4	76360086	.	A	G	1	2	3	0	0	3	0	0
4	76363195	.	C	T	0	8	8	0	3	11	0	0
4	76363204	.	A	C	3	6	9	0	2	11	0	0
4	76409422	.	C	T	1	5	6	0	0	6	0	0
4	76409461	.	A	G	1	0	1	0	6	7	0	0
4	76410654	.	T	C	2	2	4	0	0	4	0	0
4	76411252	.	G	A	6	2	8	0	0	8	0	0
4	76411255	.	A	C	6	2	8	0	0	8	0	0
4	76411558	.	C	T	1	3	4	0	0	4	0	0
4	76411925	.	T	G	7	4	11	0	0	11	0	0
4	76412107	.	C	T	4	2	6	0	0	6	0	0
4	76412432	.	G	T	2	14	16	0	0	16	0	0
4	76412464	.	G	T	2	10	12	0	1	13	0	0
4	76412570	.	G	A	3	2	5	0	1	6	0	0
4	76412751	.	A	T	1	4	5	0	0	5	0	0
4	76412937	.	C	T	11	3	14	0	0	14	0	0
4	76412938	.	A	C	11	3	14	0	0	14	0	0
4	76420809	.	A	G	1	5	6	0	0	6	0	0
4	76420875	.	C	T	2	3	5	0	0	5	0	0
4	76420883	.	G	A	1	3	4	0	0	4	0	0
4	76421602	.	A	C	6	5	11	0	0	11	0	0
4	76421898	.	A	G	3	2	5	0	0	5	0	0
4	76422231	.	G	A	0	6	6	0	2	8	0	0
4	76422395	.	C	T	2	2	4	0	0	4	0	0
4	76422424	.	A	G	3	2	5	0	0	5	0	0
4	76422432	.	G	A	4	3	7	0	0	7	0	0
4	76423190	.	A	G	0	7	7	1	0	10	2	0
4	76423537	.	C	T	1	3	4	0	0	4	0	0
4	76429102	.	A	G	1	1	2	0	0	2	0	0
4	76429202	.	A	C	0	6	6	0	0	6	0	0
4	76429234	.	A	C	5	2	7	0	0	7	0	0
4	76429237	.	G	C	5	2	7	0	0	7	0	0
4	76429270	.	C	T	5	2	7	0	0	7	0	0
4	76429545	.	C	A	3	4	7	0	1	8	0	0
4	76429584	.	A	G	1	6	7	0	2	9	0	0
4	76429734	.	A	G	5	0	5	0	2	7	0	0
4	76429944	.	G	C	6	2	8	0	0	8	0	0
4	76429969	.	G	A	3	5	8	0	0	8	0	0
4	76437869	.	A	G	0	8	8	0	0	8	0	0
4	76437999	.	A	T	2	2	4	0	0	4	0	0
4	76438019	.	A	T	1	2	3	0	1	4	0	0
4	76438967	.	T	C	1	3	4	0	0	4	0	0
4	76439095	.	T	A	4	4	8	0	0	8	0	0
4	76439101	.	C	T	3	4	7	0	1	8	0	0
4	76439158	.	A	T	4	2	6	0	0	6	0	0
4	76463366	.	A	T	3	2	5	0	0	5	0	0
4	76463378	.	A	C	3	2	5	0	0	5	0	0
4	76463780	.	G	C	3	2	5	0	0	5	0	0
4	76465087	.	C	T	2	6	8	0	4	12	0	0
4	76465346	.	C	T	1	5	6	0	1	7	0	0
4	76473716	.	G	A	2	3	5	0	0	5	0	0
4	76473737	.	T	C	2	3	5	0	0	5	0	0
4	76473911	.	A	G	1	3	4	0	0	4	0	0
4	76474339	.	G	C	1	4	5	0	0	5	0	0
4	76474844	.	G	C	0	3	3	0	1	4	0	0
4	76480996	.	C	T	0	2	2	0	3	5	0	0
4	76481177	.	T	C	6	0	6	0	3	9	0	0
4	76481216	.	G	C	5	0	5	0	6	11	0	0
4	76481403	.	T	A	9	8	17	0	3	20	0	0
4	76481572	.	G	A	4	9	13	0	0	13	0	0
4	76481692	.	T	C	2	0	2	0	2	4	0	0
4	76482075	.	G	T	3	3	6	0	1	7	0	0
4	76482207	.	A	G	1	4	5	0	0	5	0	0
4	76482249	.	C	T	0	2	2	0	0	2	0	0
4	76482673	.	T	C	0	3	3	0	0	3	0	0
4	76482756	.	G	T	2	0	2	0	0	2	0	0
4	76484343	.	G	A	1	0	1	0	0	1	0	0
4	76484424	.	T	C	3	2	5	0	0	5	0	0
4	76488514	.	T	A	1	4	5	0	0	5	0	0
4	76504337	.	G	A	1	2	3	0	0	3	0	0
4	76960838	.	C	A	10	0	10	0	11	21	0	0
4	77158384	.	A	G	1	0	1	0	3	4	0	0
4	77158391	.	A	G	2	0	2	0	2	4	0	0
4	77250926	.	T	C	10	3	13	0	0	13	0	0
4	77250931	.	T	C	5	6	11	0	0	11	0	0
4	77389832	.	G	C	8	4	12	0	0	12	0	0
4	77390083	.	A	T	5	5	10	0	1	11	0	0
5	318077	.	G	A	1	1	2	0	0	2	0	0
5	318125	.	C	T	0	0	0	0	1	1	0	0
5	320383	.	T	C	2	0	2	0	1	3	0	0
5	340614	.	A	G	3	1	4	0	0	4	0	0
5	340667	.	T	C	12	4	16	0	0	16	0	0
5	341288	.	T	C	11	5	16	0	0	16	0	0
5	341331	.	C	T	15	6	21	0	0	21	0	0
5	341687	.	C	T	2	11	13	0	7	20	0	0
5	341740	.	A	C	18	12	30	0	2	32	0	0
5	342134	.	A	G	4	3	7	0	1	8	0	0
5	342167	.	A	G	2	0	2	0	3	5	0	0
5	342228	.	C	T	4	3	7	0	1	8	0	0
5	393858	.	G	A	10	8	18	0	1	19	0	0
5	393979	.	T	C	6	8	14	0	1	15	0	0
5	394181	.	G	A	9	14	23	0	2	26	1	0
5	394184	.	T	C	9	18	27	0	0	27	0	0
5	394238	.	A	G	19	11	30	0	0	30	0	0
5	394239	.	T	G	19	11	30	0	0	30	0	0
5	394360	.	C	G	14	7	21	0	1	22	0	0
5	394417	.	G	A	0	7	7	0	14	21	0	0
5	394484	.	A	G	10	0	10	0	10	20	0	0
5	395404	.	T	A	4	9	13	0	2	15	0	0
5	395405	.	T	C	3	10	13	0	2	15	0	0
5	440032	.	A	G	9	0	9	0	8	17	0	0
5	440033	.	A	C	8	8	16	0	1	17	0	0
5	440106	.	T	C	7	4	11	0	0	11	0	0
5	457736	.	C	G	9	3	12	0	0	12	0	0
5	491375	.	C	T	1	2	3	0	0	3	0	0
5	491376	.	A	C	1	2	3	0	0	3	0	0
5	496604	.	G	T	0	3	3	0	11	14	0	0
5	895581	.	T	C	2	0	2	0	0	2	0	0
5	896908	.	C	A	4	9	13	0	0	13	0	0
5	899952	.	C	T	2	0	2	0	0	2	0	0
5	905263	.	C	A	8	2	10	0	0	10	0	0
5	917336	.	C	T	2	2	4	0	0	4	0	0
5	1055103	.	C	T	3	1	4	0	0	4	0	0
5	1059697	.	T	C	0	3	3	0	0	3	0	0
5	1064013	.	A	G	1	0	1	0	0	1	0	0
5	1068116	.	T	A	8	5	13	0	1	14	0	0
5	1073609	.	G	A	3	3	6	0	0	6	0	0
5	1079480	.	C	T	10	9	19	0	1	20	0	0
5	1079558	.	G	T	3	1	4	0	0	5	1	0
5	1083073	.	A	G	3	0	3	0	3	6	0	0
5	1083203	.	G	C	4	4	8	0	0	8	0	0
5	1083237	.	T	A	1	4	5	0	1	6	0	0
5	1083242	.	T	C	2	3	5	0	0	5	0	0
5	1083679	.	G	A	0	2	2	0	3	5	0	0
5	1083894	.	T	G	6	0	6	0	11	17	0	0
5	1149832	.	C	T	1	2	3	0	1	4	0	0
5	1152132	.	C	A	1	0	1	0	0	1	0	0
5	1155594	.	G	A	1	4	5	0	0	5	0	0
5	1187950	.	G	A	1	0	1	0	0	1	0	0
5	1207835	.	C	T	6	3	9	0	0	9	0	0
5	1216494	.	A	G	4	7	11	0	0	11	0	0
5	1216536	.	C	T	0	12	12	0	4	16	0	0
5	1216575	.	G	A	1	4	5	0	0	5	0	0
5	1218781	.	G	A	5	1	6	0	0	6	0	0
5	1219263	.	C	T	15	7	22	0	0	22	0	0
5	1219381	.	G	A	14	4	18	0	0	18	0	0
5	1223368	.	A	T	12	15	27	0	0	27	0	0
5	1223369	.	C	T	10	15	25	0	2	27	0	0
5	1223460	.	G	A	19	6	25	0	1	26	0	0
5	1223487	.	G	T	14	5	19	0	3	22	0	0
5	1240403	.	C	A	0	3	3	0	3	6	0	0
5	1311041	.	G	A	3	4	7	0	0	7	0	0
5	1317871	.	T	C	2	3	5	0	0	5	0	0
5	1317883	.	G	A	2	2	4	0	0	4	0	0
5	1420741	.	A	G	12	5	17	0	1	18	0	0
5	1420926	.	C	A	2	2	4	0	0	4	0	0
5	1420949	.	A	C	2	3	5	0	0	5	0	0
5	1438628	.	G	A	1	1	2	0	0	2	0	0
5	1445964	.	G	A	3	7	10	0	0	10	0	0
5	1451568	.	G	A	1	1	2	0	0	2	0	0
5	1456393	.	G	A	1	1	2	0	0	2	0	0
5	1456411	.	T	C	2	2	4	0	1	5	0	0
5	1461953	.	C	T	0	1	1	0	0	1	0	0
5	1519571	.	G	C	1	1	2	0	1	3	0	0
5	1519574	.	T	A	1	1	2	0	1	3	0	0
5	1624525	.	G	A	11	6	17	0	2	19	0	0
5	1653920	.	C	T	19	17	36	0	1	37	0	0
5	1653989	.	T	C	2	7	9	0	1	10	0	0
5	1688200	.	T	C	2	2	4	0	0	4	0	0
5	1709098	.	G	C	1	2	3	0	0	3	0	0
5	1726781	.	C	T	4	2	6	0	0	6	0	0
5	1869447	.	T	C	1	2	3	0	0	3	0	0
5	1869497	.	T	C	5	0	5	0	4	9	0	0
5	1950783	.	G	A	36	35	71	0	4	75	0	0
5	1952857	.	T	C	10	5	15	0	0	15	0	0
5	1952872	.	A	G	16	11	27	0	4	31	0	0
5	1952940	.	A	G	37	39	76	0	4	80	0	0
5	1953019	.	C	A	12	7	19	0	0	19	0	0
5	1955757	.	G	A	28	23	51	0	5	56	0	0
5	1957996	.	G	A	17	20	37	0	3	40	0	0
5	1958120	.	T	A	10	7	17	0	0	17	0	0
5	1962010	.	G	A	5	11	16	0	0	16	0	0
5	1990965	.	C	G	4	3	7	0	0	7	0	0
5	1991091	.	T	G	0	2	2	0	0	2	0	0
5	1991092	.	C	T	0	2	2	0	0	2	0	0
5	1991408	.	G	C	2	3	5	0	1	6	0	0
5	1991410	.	G	C	2	4	6	0	0	6	0	0
5	1997902	.	A	G	16	6	22	0	0	22	0	0
5	1997957	.	A	G	17	11	28	0	1	29	0	0
5	1997958	.	G	A	17	12	29	0	0	29	0	0
5	1998019	.	A	C	35	3	38	0	13	51	0	0
5	1998755	.	C	G	1	3	4	0	0	4	0	0
5	1998863	.	C	T	1	3	4	0	0	4	0	0
5	1999199	.	G	A	16	23	39	0	0	39	0	0
5	1999289	.	C	T	17	20	37	0	1	38	0	0
5	2047372	.	G	T	0	5	5	0	4	9	0	0
5	2066324	.	C	A	4	2	6	0	0	6	0	0
5	2067557	.	T	C	1	0	1	0	4	5	0	0
5	2067597	.	T	G	1	5	6	0	0	6	0	0
5	2067781	.	G	A	2	7	9	0	1	10	0	0
5	2067832	.	C	T	6	4	10	0	0	10	0	0
5	2067842	.	T	A	5	4	9	0	0	9	0	0
5	2068318	.	G	T	3	0	3	0	0	3	0	0
5	2068484	.	A	G	1	4	5	0	0	5	0	0
5	2068515	.	T	A	4	7	11	0	0	11	0	0
5	2069012	.	T	G	15	3	18	1	0	19	0	0
5	2086120	.	G	A	1	2	3	0	0	3	0	0
5	2242346	.	G	A	1	3	4	0	0	4	0	0
5	2242499	.	C	T	4	2	6	0	0	6	0	0
5	2242549	.	G	A	4	3	7	0	0	7	0	0
5	2242550	.	G	T	4	3	7	0	0	7	0	0
5	2242599	.	G	A	2	3	5	0	0	5	0	0
5	2242602	.	G	T	2	3	5	0	0	5	0	0
5	2242795	.	G	A	3	5	8	0	0	8	0	0
5	2242815	.	A	T	2	5	7	0	0	7	0	0
5	2243005	.	G	T	5	3	8	0	1	9	0	0
5	2410373	.	T	C	30	3	33	0	19	52	0	0
5	2410610	.	G	A	6	6	12	0	2	14	0	0
5	2413134	.	G	A	11	18	29	0	4	33	0	0
5	2413303	.	A	G	1	2	3	0	0	3	0	0
5	2413327	.	G	A	1	1	2	0	1	3	0	0
5	2419100	.	G	A	14	5	19	0	0	19	0	0
5	2420156	.	G	A	8	6	14	0	0	14	0	0
5	2426103	.	C	T	3	2	5	0	0	5	0	0
5	2434335	.	C	A	2	3	5	0	0	5	0	0
5	2434362	.	G	A	3	2	5	0	0	5	0	0
5	2434504	.	C	T	4	0	4	0	0	4	0	0
5	2434507	.	T	A	1	4	5	0	0	5	0	0
5	2435940	.	G	A	6	1	7	0	1	8	0	0
5	2451222	.	G	A	14	15	29	0	2	31	0	0
5	2451276	.	C	T	0	3	3	0	11	14	0	0
5	2451294	.	A	C	3	0	3	0	3	6	0	0
5	2454780	.	C	G	4	9	13	0	1	14	0	0
5	2457599	.	C	T	0	2	2	0	0	2	0	0
5	2461886	.	G	A	3	2	5	0	0	5	0	0
5	2463679	.	T	C	1	0	1	0	2	3	0	0
5	2467870	.	G	A	1	4	5	0	0	5	0	0
5	2495522	.	T	C	1	3	4	0	0	4	0	0
5	2509488	.	A	T	12	10	22	0	0	22	0	0
5	2509521	.	G	A	3	6	9	0	0	9	0	0
5	2521496	.	G	A	7	3	10	0	0	10	0	0
5	2571365	.	T	G	5	0	5	0	9	14	0	0
5	2658348	.	G	A	4	3	7	0	0	7	0	0
5	2686225	.	G	C	7	8	15	0	0	15	0	0
5	2689283	.	G	A	0	1	1	0	0	1	0	0
5	2689347	.	G	A	5	7	12	0	1	13	0	0
5	2689361	.	C	G	6	7	13	0	0	13	0	0
5	2693889	.	T	C	1	0	1	0	0	1	0	0
5	2709533	.	A	G	4	4	8	0	1	9	0	0
5	2709561	.	T	C	1	2	3	0	0	3	0	0
5	2709609	.	T	C	3	2	5	0	0	5	0	0
5	2713967	.	A	G	23	21	44	0	3	47	0	0
5	2714042	.	C	T	20	25	45	0	1	46	0	0
5	2714135	.	C	T	30	21	51	0	6	57	0	0
5	2714237	.	G	A	11	34	45	0	7	52	0	0
5	2714495	.	G	A	22	24	46	0	5	51	0	0
5	2714507	.	A	G	21	26	47	0	2	49	0	0
5	2714531	.	T	C	15	0	15	0	17	32	0	0
5	2716930	.	G	A	7	14	21	0	1	22	0	0
5	2716963	.	G	A	7	12	19	0	0	19	0	0
5	2717014	.	G	A	10	7	17	0	1	18	0	0
5	2717022	.	G	A	10	8	18	0	0	18	0	0
5	2717260	.	T	C	1	3	4	0	0	4	0	0
5	2717350	.	G	C	3	0	3	0	11	14	0	0
5	2717611	.	C	T	4	4	8	0	0	8	0	0
5	2717623	.	A	G	3	1	4	0	0	4	0	0
5	2717960	.	A	G	0	2	2	0	0	2	0	0
5	2718696	.	A	G	6	7	13	0	0	13	0	0
5	2718834	.	G	A	0	1	1	0	0	1	0	0
5	2720119	.	A	G	1	1	2	0	2	4	0	0
5	2742784	.	A	G	8	3	11	0	0	11	0	0
5	2744938	.	C	T	5	9	14	0	0	14	0	0
5	2744962	.	C	G	6	9	15	0	0	15	0	0
5	2744998	.	C	T	8	3	11	0	0	11	0	0
5	2745220	.	G	T	0	3	3	0	1	4	0	0
5	2750087	.	G	A	5	6	11	0	0	11	0	0
5	2750127	.	G	A	8	5	13	0	0	13	0	0
5	2750244	.	G	A	5	3	8	0	1	9	0	0
5	2750256	.	G	A	3	3	6	0	1	7	0	0
5	2751319	.	G	A	3	2	5	0	1	6	0	0
5	2751511	.	G	A	3	9	12	0	0	12	0	0
5	3118842	.	A	G	14	19	33	0	1	34	0	0
5	3127488	.	T	A	6	3	9	0	0	9	0	0
5	3185231	.	G	A	0	1	1	0	0	1	0	0
5	3192019	.	C	T	0	1	1	0	1	2	0	0
5	3545205	.	A	T	30	0	30	0	1	31	0	0
5	6427002	.	C	T	1	1	2	0	1	3	0	0
5	6672965	.	G	T	1	4	5	0	0	5	0	0
5	6717757	.	C	A	4	2	6	0	0	6	0	0
5	6717804	.	T	C	5	2	7	0	0	7	0	0
5	6717809	.	G	A	5	2	7	0	0	7	0	0
5	6726416	.	T	C	6	6	12	0	0	12	0	0
5	6727099	.	C	A	0	1	1	0	1	2	0	0
5	6827651	.	G	A	2	3	5	0	0	5	0	0
5	6827669	.	G	C	4	3	7	0	1	8	0	0
5	6828589	.	A	T	1	3	4	0	0	4	0	0
5	6828721	.	G	A	1	1	2	0	0	2	0	0
5	6832646	.	C	T	0	1	1	0	0	1	0	0
5	6839136	.	A	C	1	1	2	0	0	2	0	0
5	6844179	.	C	T	3	2	5	0	0	5	0	0
5	6858380	.	C	A	0	7	7	0	0	7	0	0
5	6858389	.	T	A	2	6	8	0	0	8	0	0
5	6858540	.	T	A	11	6	17	0	0	17	0	0
5	6858779	.	G	T	0	11	11	0	6	17	0	0
5	6863577	.	C	T	6	2	8	0	0	8	0	0
5	6863647	.	C	T	16	8	24	0	1	25	0	0
5	6863768	.	G	C	9	8	17	0	2	19	0	0
5	6863793	.	G	A	11	9	20	0	3	23	0	0
5	6863834	.	A	G	10	0	10	0	6	16	0	0
5	6864010	.	C	T	4	7	11	0	0	11	0	0
5	6864061	.	A	G	1	3	4	0	0	4	0	0
5	6864067	.	G	A	0	3	3	0	0	3	0	0
5	6881679	.	C	T	3	2	5	0	0	5	0	0
5	6921397	.	T	C	0	1	1	0	0	1	0	0
5	6921448	.	A	G	2	3	5	0	0	5	0	0
5	6956547	.	C	G	2	3	5	0	0	5	0	0
5	6958910	.	T	C	4	2	6	0	2	8	0	0
5	6958965	.	G	C	6	6	12	0	1	13	0	0
5	6959148	.	C	A	7	2	9	0	1	10	0	0
5	6959834	.	T	A	5	7	12	0	0	12	0	0
5	6959839	.	C	T	5	7	12	0	0	12	0	0
5	7460727	.	T	C	1	2	3	0	0	3	0	0
5	7504448	.	C	T	1	1	2	0	0	2	0	0
5	8006206	.	A	G	5	11	16	0	1	17	0	0
5	8006977	.	A	G	6	10	16	0	1	17	0	0
5	8015099	.	C	T	0	3	3	0	5	8	0	0
5	8015361	.	G	T	9	14	23	0	0	23	0	0
5	8019962	.	A	G	8	4	12	0	0	12	0	0
5	8020001	.	C	T	5	5	10	0	0	10	0	0
5	8033036	.	A	G	2	2	4	0	0	4	0	0
5	8038472	.	C	T	1	2	3	0	0	3	0	0
5	9443251	.	T	C	5	7	12	0	0	12	0	0
5	9824885	.	C	T	1	3	4	0	0	4	0	0
5	9824894	.	G	T	1	3	4	0	0	4	0	0
5	10053867	.	C	T	5	3	8	0	0	8	0	0
5	10084310	.	C	T	4	3	7	0	1	8	0	0
5	10766286	.	G	A	7	8	15	0	1	16	0	0
5	10766505	.	A	G	13	13	26	0	0	26	0	0
5	10766529	.	G	A	18	9	27	0	1	28	0	0
5	10766879	.	A	G	15	16	31	0	2	33	0	0
5	10767113	.	C	T	17	10	27	0	1	28	0	0
5	10767259	.	A	G	22	18	40	0	1	41	0	0
5	10767456	.	G	A	4	5	9	0	0	9	0	0
5	10767588	.	C	T	1	6	7	0	0	7	0	0
5	10768089	.	G	A	6	6	12	0	0	12	0	0
5	10768182	.	G	A	10	7	17	0	0	17	0	0
5	10768215	.	T	C	2	0	2	0	4	6	0	0
5	10946038	.	G	A	4	2	6	0	0	6	0	0
5	10946085	.	G	T	3	3	6	0	1	7	0	0
5	11244183	.	C	G	1	3	4	0	0	4	0	0
5	11244675	.	A	G	4	6	10	0	1	11	0	0
5	11250049	.	C	T	0	1	1	0	0	1	0	0
5	11507602	.	A	G	2	2	4	0	0	4	0	0
5	11573461	.	C	T	9	3	12	0	1	13	0	0
5	11725571	.	C	G	2	2	4	1	0	5	0	0
5	11812278	.	C	T	0	2	2	0	1	3	0	0
5	11816527	.	T	C	1	2	3	0	0	3	0	0
5	11816599	.	G	A	1	3	4	0	0	4	0	0
5	11824059	.	G	A	0	5	5	0	2	7	0	0
5	11824188	.	T	C	1	1	2	0	0	2	0	0
5	11826347	.	T	C	2	2	4	0	1	5	0	0
5	11836437	.	T	C	9	3	12	0	0	12	0	0
5	11863264	.	T	C	1	2	3	0	1	4	0	0
5	11864572	.	C	G	1	2	3	0	0	3	0	0
5	11864593	.	A	G	2	2	4	0	0	4	0	0
5	11864774	.	T	G	11	12	23	0	0	23	0	0
5	11869576	.	C	A	0	2	2	0	9	11	0	0
5	11900230	.	T	C	5	0	5	0	2	7	0	0
5	11905038	.	G	A	2	3	5	0	1	6	0	0
5	11905044	.	A	C	3	3	6	0	1	7	0	0
5	11905661	.	T	C	2	0	2	0	3	5	0	0
5	11905725	.	C	T	1	2	3	0	0	3	0	0
5	11905890	.	A	G	8	4	12	0	1	13	0	0
5	11905903	.	T	G	5	8	13	0	0	13	0	0
5	11917125	.	C	T	5	10	15	0	1	16	0	0
5	11917405	.	G	A	11	7	18	0	0	18	0	0
5	11917436	.	G	A	2	10	12	0	1	13	0	0
5	11917485	.	G	A	15	7	22	0	0	22	0	0
5	11917596	.	C	A	0	13	13	0	6	19	0	0
5	11933155	.	A	G	6	6	12	0	0	12	0	0
5	11935444	.	G	A	1	1	2	0	0	2	0	0
5	11937486	.	G	A	2	1	3	0	1	4	0	0
5	11937564	.	A	T	0	5	5	0	0	5	0	0
5	11943868	.	G	A	7	4	11	0	0	11	0	0
5	11943934	.	C	A	4	5	9	0	0	9	0	0
5	11943948	.	T	A	5	5	10	0	0	10	0	0
5	11943989	.	G	A	2	3	5	0	1	6	0	0
5	11949244	.	G	T	6	11	17	0	0	17	0	0
5	11959776	.	G	T	0	7	7	0	17	24	0	0
5	11959777	.	C	T	7	17	24	0	0	24	0	0
5	11959818	.	C	T	15	17	32	0	0	32	0	0
5	11959966	.	C	G	17	10	27	0	1	28	0	0
5	11959988	.	G	A	0	17	17	0	15	32	0	0
5	11982950	.	C	A	7	3	10	0	2	12	0	0
5	11983017	.	T	C	4	4	8	0	0	8	0	0
5	11983395	.	T	A	3	2	5	0	0	5	0	0
5	11983548	.	C	G	3	8	11	0	1	12	0	0
5	11984086	.	T	C	0	2	2	0	0	2	0	0
5	11984133	.	C	T	3	7	10	0	0	10	0	0
5	11984369	.	C	T	0	4	4	0	2	6	0	0
5	11985546	.	A	T	1	4	5	0	0	5	0	0
5	11985672	.	A	T	1	2	3	0	0	3	0	0
5	12041978	.	G	A	0	1	1	0	0	1	0	0
5	12100335	.	G	A	5	3	8	0	1	9	0	0
5	12284075	.	C	T	13	19	32	0	3	35	0	0
5	12285172	.	T	C	13	1	14	0	11	25	0	0
5	12285316	.	C	T	4	1	5	0	0	5	0	0
5	12285601	.	C	G	3	3	6	0	0	6	0	0
5	12288511	.	T	C	3	6	9	0	2	11	0	0
5	12288541	.	A	G	4	5	9	0	0	9	0	0
5	12297084	.	C	T	0	3	3	0	0	3	0	0
5	12322321	.	G	A	2	1	3	0	0	3	0	0
5	12357538	.	G	A	1	2	3	0	0	3	0	0
5	12357554	.	C	T	1	2	3	0	0	3	0	0
5	12454563	.	T	C	6	0	6	0	9	15	0	0
5	12503554	.	G	A	3	4	7	0	0	7	0	0
5	12524938	.	A	G	1	5	6	0	1	7	0	0
5	12533197	.	C	T	1	1	2	0	0	2	0	0
5	12549258	.	C	T	7	6	13	0	0	13	0	0
5	12549326	.	C	T	3	9	12	0	0	12	0	0
5	12549642	.	C	A	1	2	3	0	0	3	0	0
5	12549776	.	G	T	1	2	3	0	0	3	0	0
5	12549807	.	A	G	2	4	6	0	0	6	0	0
5	12549981	.	G	T	2	5	7	0	0	7	0	0
5	12553935	.	C	T	0	3	3	0	0	3	0	0
5	12554119	.	A	G	1	2	3	0	0	3	0	0
5	12724121	.	C	T	11	5	16	0	2	18	0	0
5	12724224	.	G	A	5	15	20	0	2	22	0	0
5	12724249	.	A	C	10	5	15	0	1	16	0	0
5	12724292	.	C	A	5	2	7	0	1	8	0	0
5	12724307	.	A	G	1	4	5	0	1	6	0	0
5	12724412	.	A	G	4	1	5	0	0	5	0	0
5	12724450	.	C	T	0	6	6	0	9	15	0	0
5	12724505	.	C	A	9	12	21	0	0	21	0	0
5	12724518	.	G	C	9	1	10	0	12	22	0	0
5	12724567	.	A	G	18	11	29	0	3	32	0	0
5	12725930	.	G	A	4	3	7	0	0	7	0	0
5	12726842	.	A	G	2	2	4	0	1	5	0	0
5	12729397	.	C	T	4	3	7	0	0	7	0	0
5	12732247	.	C	T	3	1	4	0	0	4	0	0
5	12734883	.	G	T	2	2	4	0	0	4	0	0
5	12734910	.	T	C	2	3	5	0	0	5	0	0
5	12743159	.	A	T	2	3	5	0	0	5	0	0
5	12800301	.	C	T	1	3	4	0	0	4	0	0
5	12802341	.	A	T	1	1	2	0	0	2	0	0
5	12802353	.	G	T	1	1	2	0	0	2	0	0
5	12837064	.	G	A	4	4	8	0	0	8	0	0
5	12859258	.	T	C	15	9	24	0	1	25	0	0
5	12905911	.	A	C	1	3	4	0	1	5	0	0
5	12906273	.	C	T	3	5	8	0	0	8	0	0
5	12906343	.	A	G	1	0	1	0	2	3	0	0
5	12956918	.	T	C	2	2	4	0	0	4	0	0
5	12956960	.	C	T	2	1	3	0	1	4	0	0
5	12975532	.	C	T	2	2	4	0	0	4	0	0
5	12979889	.	C	T	6	3	9	0	0	9	0	0
5	13037199	.	C	T	0	5	5	0	3	8	0	0
5	13037203	.	C	T	0	2	2	0	7	9	0	0
5	13037723	.	A	G	6	5	11	0	0	11	0	0
5	13037939	.	T	G	6	10	16	0	1	17	0	0
5	13037967	.	G	A	10	10	20	0	0	20	0	0
5	13037998	.	A	G	8	4	12	0	2	14	0	0
5	13105020	.	C	T	23	16	39	0	5	44	0	0
5	13105070	.	C	A	0	21	21	0	18	39	0	0
5	13112979	.	G	A	2	0	2	0	0	2	0	0
5	13167048	.	A	T	9	8	17	0	1	18	0	0
5	13214008	.	A	T	2	3	5	0	0	5	0	0
5	13214048	.	T	C	3	2	5	0	2	7	0	0
5	13214102	.	T	C	1	3	4	0	0	4	0	0
5	13214110	.	T	C	1	2	3	0	0	3	0	0
5	13214637	.	C	G	5	11	16	0	1	17	0	0
5	13214802	.	C	G	6	3	9	0	0	9	0	0
5	13223062	.	G	A	2	3	5	0	0	5	0	0
5	13226925	.	G	A	3	2	5	0	0	5	0	0
5	13227057	.	C	T	0	0	0	0	1	1	0	0
5	13229024	.	C	A	1	1	2	0	0	2	0	0
5	13237809	.	G	A	1	0	1	0	0	1	0	0
5	13308985	.	T	C	0	3	3	0	0	3	0	0
5	13308997	.	G	T	1	5	6	0	0	6	0	0
5	13309174	.	T	C	10	0	10	0	14	24	0	0
5	13309215	.	C	T	9	7	16	0	0	16	0	0
5	13309273	.	C	T	14	7	21	0	0	21	0	0
5	13309309	.	G	A	12	14	26	0	0	26	0	0
5	13309402	.	A	G	14	12	26	0	2	28	0	0
5	13309435	.	A	T	11	18	29	0	2	31	0	0
5	13309522	.	G	A	10	17	27	0	1	28	0	0
5	13312671	.	A	T	2	2	4	0	0	4	0	0
5	13312746	.	G	A	16	9	25	0	1	26	0	0
5	13315490	.	G	C	7	4	11	0	0	11	0	0
5	13315526	.	T	C	10	6	16	0	1	17	0	0
5	13315603	.	A	C	18	7	25	0	1	26	0	0
5	13329785	.	G	C	0	1	1	0	0	1	0	0
5	13332930	.	A	G	1	4	5	0	1	6	0	0
5	13335333	.	G	A	2	7	9	0	1	10	0	0
5	13335373	.	G	T	0	3	3	0	4	7	0	0
5	13337803	.	C	T	10	10	20	0	1	21	0	0
5	13337883	.	T	A	16	15	31	0	1	32	0	0
5	13338441	.	C	T	0	12	12	0	14	26	0	0
5	13338762	.	A	T	10	15	25	0	1	26	0	0
5	13339038	.	G	C	12	18	30	0	10	41	1	0
5	13385888	.	A	G	2	0	2	0	2	4	0	0
5	13385916	.	T	A	2	1	3	0	0	3	0	0
5	13465095	.	T	C	0	6	6	0	0	6	0	0
5	13468108	.	G	T	0	3	3	0	2	5	0	0
5	13468440	.	T	A	6	3	9	0	0	9	0	0
5	13468574	.	G	A	0	2	2	0	0	2	0	0
5	13468655	.	G	A	3	3	6	0	0	6	0	0
5	13468656	.	A	T	3	3	6	0	0	6	0	0
5	13469137	.	C	A	4	8	12	0	0	12	0	0
5	13472279	.	C	T	4	3	7	0	0	7	0	0
5	13472295	.	G	T	3	4	7	0	0	7	0	0
5	13501336	.	C	T	0	1	1	0	0	1	0	0
5	13501345	.	C	T	0	1	1	0	0	1	0	0
5	13539403	.	A	G	2	0	2	0	2	4	0	0
5	13539493	.	A	G	1	0	1	0	5	6	0	0
5	13540689	.	C	T	6	8	14	0	0	14	0	0
5	13540846	.	T	A	7	6	13	0	0	13	0	0
5	13643325	.	G	A	13	13	26	0	0	26	0	0
5	13643411	.	C	T	0	19	19	0	29	48	0	0
5	13643824	.	G	A	11	12	23	0	1	24	0	0
5	13644126	.	A	T	16	23	39	0	1	40	0	0
5	13644185	.	T	G	15	22	37	0	0	37	0	0
5	13644189	.	T	G	15	20	35	0	1	36	0	0
5	13644227	.	A	G	8	21	29	0	0	29	0	0
5	13644256	.	A	T	8	9	17	0	0	17	0	0
5	13644581	.	T	G	20	13	33	0	4	37	0	0
5	13644602	.	T	A	22	13	35	0	0	36	1	0
5	13644781	.	C	T	12	10	22	0	2	24	0	0
5	13644797	.	A	G	12	11	23	0	0	23	0	0
5	13645047	.	C	G	12	22	34	0	0	34	0	0
5	13645746	.	A	G	16	12	28	0	3	31	0	0
5	13645885	.	T	C	15	11	26	0	1	27	0	0
5	13649518	.	C	T	12	2	14	0	0	15	1	0
5	13652410	.	T	C	11	27	38	0	0	38	0	0
5	13671624	.	G	T	5	3	8	0	0	8	0	0
5	13671631	.	A	C	3	6	9	0	0	9	0	0
5	13671899	.	C	G	10	19	29	0	0	29	0	0
5	13672004	.	C	T	0	22	22	0	22	44	0	0
5	13672211	.	C	T	19	27	46	0	3	49	0	0
5	13672232	.	C	T	26	14	40	0	2	42	0	0
5	13673016	.	C	G	0	8	8	0	6	14	0	0
5	13684132	.	A	G	12	15	27	0	2	29	0	0
5	13684502	.	C	A	4	18	22	0	14	36	0	0
5	13684983	.	G	T	3	2	5	0	1	6	0	0
5	14309520	.	T	A	7	3	10	0	0	10	0	0
5	14312576	.	A	G	6	2	8	0	0	8	0	0
5	14319686	.	C	A	1	1	2	0	0	2	0	0
5	15357517	.	A	G	6	7	13	0	2	15	0	0
5	17726347	.	A	C	1	0	1	0	8	9	0	0
5	17726356	.	G	C	0	0	0	0	7	7	0	0
5	18827368	.	T	C	12	3	15	0	0	15	0	0
5	18935168	.	A	G	6	4	10	1	1	12	0	0
5	18935182	.	A	G	4	4	8	1	0	9	0	0
5	19008334	.	A	G	18	7	25	1	12	38	0	0
5	19437518	.	T	C	1	4	5	0	0	5	0	0
5	19851321	.	G	A	2	2	4	0	0	4	0	0
5	20419373	.	G	C	20	5	25	0	0	25	0	0
5	20787190	.	T	C	6	6	12	0	1	13	0	0
5	22012459	.	T	C	4	7	11	0	0	11	0	0
5	22012895	.	T	C	6	3	9	0	0	9	0	0
5	22106347	.	A	G	3	3	6	0	0	6	0	0
5	22172569	.	C	T	3	4	7	0	1	8	0	0
5	22600579	.	A	G	0	12	12	0	0	12	0	0
5	22828072	.	T	C	2	0	2	0	4	6	0	0
5	22828073	.	C	G	3	0	3	0	3	6	0	0
5	23027521	.	T	A	7	0	7	0	0	7	0	0
5	23132256	.	G	T	1	2	3	0	0	3	0	0
5	23362593	.	T	C	1	7	8	0	0	8	0	0
5	23370824	.	T	C	1	6	7	0	0	7	0	0
5	23397221	.	T	C	1	0	1	0	0	1	0	0
5	23641948	.	T	A	4	2	6	0	1	7	0	0
5	24163099	.	A	G	2	2	4	0	0	4	0	0
5	24163289	.	A	G	3	5	8	1	0	9	0	0
5	24330493	.	A	G	11	7	18	0	2	20	0	0
5	24535156	.	A	G	3	1	4	0	0	4	0	0
5	24567258	.	T	C	6	2	8	0	0	8	0	0
5	24818564	.	T	C	11	4	15	0	2	17	0	0
5	24819037	.	T	C	3	5	8	0	0	8	0	0
5	24819872	.	T	G	6	1	7	0	6	13	0	0
5	25728428	.	C	T	0	4	4	0	1	5	0	0
5	25755135	.	G	T	11	0	11	0	1	12	0	0
5	26062582	.	A	G	7	3	10	0	1	11	0	0
5	28758525	.	C	T	0	3	3	0	0	3	0	0
5	29572514	.	T	C	1	3	4	0	0	4	0	0
5	29572525	.	T	C	0	3	3	0	0	3	0	0
5	29598984	.	T	C	31	0	31	0	17	48	0	0
5	30055414	.	T	C	2	2	4	0	0	4	0	0
5	30416057	.	A	C	6	0	6	0	13	19	0	0
5	30589697	.	T	A	6	2	8	0	0	8	0	0
5	30606287	.	A	G	3	2	5	0	0	5	0	0
5	31432387	.	A	G	0	2	2	0	1	3	0	0
5	31916381	.	G	A	2	3	5	0	0	5	0	0
5	31994846	.	C	A	10	2	12	0	17	29	0	0
5	32796644	.	T	C	3	2	5	0	0	5	0	0
5	32796648	.	T	C	3	2	5	0	0	5	0	0
5	33019181	.	G	A	10	4	14	0	0	14	0	0
5	33019571	.	C	G	12	5	17	0	2	19	0	0
5	33019826	.	T	C	2	3	5	0	1	6	0	0
5	33021257	.	A	T	3	4	7	0	0	7	0	0
5	33200071	.	G	A	8	14	22	0	1	23	0	0
5	33200279	.	T	C	1	0	1	0	2	3	0	0
5	33208429	.	A	G	9	14	23	0	1	24	0	0
5	33215307	.	G	A	3	5	8	0	0	8	0	0
5	33238950	.	C	A	7	3	10	0	1	11	0	0
5	33239090	.	G	T	2	1	3	0	1	4	0	0
5	33239099	.	C	T	2	3	5	0	0	5	0	0
5	33239444	.	G	T	9	11	20	0	0	20	0	0
5	33239486	.	A	G	5	5	10	0	0	10	0	0
5	33239551	.	A	T	4	6	10	0	0	10	0	0
5	33239625	.	T	C	7	5	12	0	2	14	0	0
5	33239965	.	G	C	5	10	15	0	0	15	0	0
5	33239996	.	T	C	3	10	13	0	0	13	0	0
5	33240295	.	G	A	8	16	24	0	0	24	0	0
5	33240425	.	A	T	5	8	13	0	0	13	0	0
5	33240469	.	T	C	8	14	22	0	0	22	0	0
5	33240600	.	G	A	8	6	14	0	0	14	0	0
5	33240930	.	A	T	5	5	10	0	0	10	0	0
5	33245668	.	C	A	0	2	2	0	3	5	0	0
5	33247152	.	C	T	3	1	4	0	1	5	0	0
5	33248925	.	G	A	2	4	6	0	0	6	0	0
5	33251276	.	A	T	3	4	7	0	0	7	0	0
5	33266785	.	T	G	2	2	4	0	0	4	0	0
5	33266832	.	T	A	4	4	8	0	0	8	0	0
5	33269645	.	A	G	1	3	4	0	0	4	0	0
5	33277928	.	C	T	0	2	2	0	3	5	0	0
5	33280951	.	A	G	3	2	5	0	0	5	0	0
5	33280976	.	G	A	3	4	7	0	0	7	0	0
5	33281196	.	T	C	4	4	8	0	0	8	0	0
5	33282484	.	A	C	4	4	8	0	0	8	0	0
5	33285096	.	C	T	0	7	7	0	4	11	0	0
5	33289072	.	T	G	1	0	1	0	0	1	0	0
5	33289170	.	A	T	5	4	9	0	0	9	0	0
5	33290815	.	A	G	7	0	7	0	7	14	0	0
5	33295805	.	A	G	4	3	7	0	0	7	0	0
5	33295806	.	A	G	4	2	6	0	1	7	0	0
5	33296924	.	G	T	9	10	19	0	1	20	0	0
5	33302826	.	C	A	1	0	1	0	0	1	0	0
5	33307805	.	C	G	3	3	6	0	0	6	0	0
5	33307812	.	C	A	1	1	2	0	0	2	0	0
5	33310947	.	T	G	7	3	10	0	2	12	0	0
5	33315247	.	A	T	3	4	7	0	0	7	0	0
5	33318597	.	G	A	0	2	2	0	2	4	0	0
5	33328791	.	C	A	11	15	26	0	0	26	0	0
5	33328939	.	A	G	11	8	19	0	0	19	0	0
5	33329210	.	G	A	0	9	9	0	12	21	0	0
5	33329345	.	G	A	0	17	17	0	11	28	0	0
5	33329418	.	G	A	14	16	30	0	0	30	0	0
5	33329600	.	T	C	15	12	27	0	0	27	0	0
5	33329740	.	G	T	12	12	24	0	0	24	0	0
5	33329774	.	A	G	11	6	17	0	0	17	0	0
5	33329786	.	A	G	12	8	20	0	1	21	0	0
5	33330146	.	G	C	15	6	21	0	1	22	0	0
5	33336805	.	C	A	1	2	3	0	0	3	0	0
5	33337470	.	C	G	4	4	8	0	0	8	0	0
5	33337593	.	A	T	3	5	8	0	0	8	0	0
5	33337610	.	A	G	3	8	11	0	0	11	0	0
5	33337776	.	A	C	5	5	10	0	0	10	0	0
5	33338099	.	T	A	6	6	12	0	1	13	0	0
5	33360761	.	C	G	6	7	13	0	1	14	0	0
5	33360835	.	T	G	11	7	18	0	0	18	0	0
5	33360884	.	T	C	0	2	2	0	0	2	0	0
5	33385512	.	T	A	0	5	5	0	1	6	0	0
5	33387624	.	A	G	2	3	5	0	0	5	0	0
5	33460936	.	A	G	1	3	4	0	1	5	0	0
5	33538011	.	G	T	5	2	7	0	0	7	0	0
5	33554892	.	T	C	3	1	4	0	0	4	0	0
5	33555115	.	T	C	1	0	1	0	0	1	0	0
5	33558640	.	T	C	1	0	1	0	3	4	0	0
5	33636449	.	C	T	2	3	5	0	0	5	0	0
5	33668755	.	A	G	3	3	6	0	0	6	0	0
5	33668821	.	G	A	3	6	9	0	0	9	0	0
5	33668827	.	C	T	3	7	10	0	0	10	0	0
5	33668894	.	C	T	7	7	14	0	0	14	0	0
5	33668936	.	G	T	4	1	5	0	0	5	0	0
5	33668943	.	A	T	5	0	5	0	0	5	0	0
5	33679862	.	T	G	2	4	6	0	2	8	0	0
5	33680184	.	T	G	7	10	17	0	0	17	0	0
5	33692389	.	C	T	0	2	2	0	6	8	0	0
5	33694109	.	T	C	3	9	12	0	0	12	0	0
5	34066594	.	C	T	3	3	6	0	0	6	0	0
5	34066837	.	G	A	0	3	3	0	0	3	0	0
5	34098880	.	G	T	2	0	2	0	1	3	0	0
5	34532592	.	A	C	1	2	3	0	1	4	0	0
5	34542344	.	C	T	3	4	7	0	0	7	0	0
5	34542389	.	G	C	3	4	7	0	0	7	0	0
5	34568883	.	T	C	10	13	23	0	1	24	0	0
5	34573792	.	T	C	5	1	6	0	0	6	0	0
5	34573807	.	T	C	7	4	11	0	0	11	0	0
5	34574165	.	G	A	14	10	24	0	1	25	0	0
5	34574191	.	T	G	15	9	24	0	0	24	0	0
5	34574224	.	G	A	18	9	27	0	0	27	0	0
5	34574238	.	C	A	13	11	24	0	0	24	0	0
5	34574267	.	G	A	10	13	23	0	1	24	0	0
5	34574546	.	A	G	18	1	19	0	17	36	0	0
5	34574915	.	C	T	13	16	29	0	2	31	0	0
5	34574919	.	A	G	13	18	31	0	2	33	0	0
5	34575079	.	T	A	26	0	26	0	2	28	0	0
5	34588977	.	A	G	4	0	4	0	2	6	0	0
5	34589009	.	G	T	5	4	9	0	0	9	0	0
5	34589225	.	G	T	2	1	3	0	0	3	0	0
5	34593289	.	A	C	1	2	3	0	0	3	0	0
5	34593568	.	A	G	3	5	8	0	0	8	0	0
5	34603811	.	T	C	3	3	6	0	0	6	0	0
5	34606570	.	C	T	0	1	1	0	0	1	0	0
5	34609005	.	A	G	2	0	2	0	0	2	0	0
5	34609116	.	G	C	0	1	1	0	1	2	0	0
5	34609357	.	G	A	3	1	4	0	0	4	0	0
5	34616060	.	T	C	1	0	1	0	2	3	0	0
5	34625129	.	T	C	1	2	3	0	0	3	0	0
5	34625152	.	G	A	0	2	2	0	1	3	0	0
5	34626076	.	T	C	3	4	7	0	1	8	0	0
5	34634180	.	C	A	2	8	10	0	1	11	0	0
5	34634253	.	T	G	6	5	11	0	0	11	0	0
5	34634894	.	G	T	2	7	9	0	1	10	0	0
5	34635098	.	T	A	11	9	20	0	0	20	0	0
5	34635133	.	A	T	7	11	18	0	2	20	0	0
5	34635194	.	A	G	2	7	9	0	0	9	0	0
5	34635451	.	A	C	4	3	7	0	1	8	0	0
5	34635673	.	G	A	7	9	16	0	0	16	0	0
5	34635795	.	A	T	4	1	5	0	0	6	1	0
5	34636252	.	G	A	6	5	11	0	0	11	0	0
5	34636347	.	G	T	7	3	10	0	0	10	0	0
5	34636413	.	G	A	2	2	4	0	0	4	0	0
5	34636457	.	A	T	2	6	8	0	2	10	0	0
5	34636638	.	T	C	5	5	10	0	0	10	0	0
5	34636731	.	A	T	5	7	12	0	0	12	0	0
5	34636986	.	T	G	8	6	14	0	0	14	0	0
5	34637067	.	T	C	3	5	8	0	0	8	0	0
5	34637399	.	A	C	4	9	13	3	0	16	0	0
5	34637466	.	T	C	6	8	14	0	1	15	0	0
5	34637539	.	A	G	4	10	14	0	0	14	0	0
5	34637667	.	T	G	9	6	15	0	1	16	0	0
5	34637681	.	A	G	13	8	21	0	0	21	0	0
5	34637706	.	T	G	11	12	23	0	0	23	0	0
5	34637843	.	A	G	13	13	26	0	0	26	0	0
5	34637849	.	G	C	15	12	27	0	0	27	0	0
5	34637997	.	A	C	19	25	44	0	1	45	0	0
5	34829227	.	C	T	2	3	5	0	0	5	0	0
5	34830046	.	A	T	1	2	3	0	0	3	0	0
5	34982414	.	G	A	7	6	13	0	1	14	0	0
5	34982866	.	C	G	5	0	5	0	8	13	0	0
5	34987043	.	A	T	20	20	40	0	0	40	0	0
5	34991271	.	C	T	28	34	62	0	2	64	0	0
5	34998822	.	C	T	1	2	3	0	0	3	0	0
5	35123955	.	C	T	8	4	12	0	0	12	0	0
5	35124398	.	C	T	5	13	18	0	1	19	0	0
5	35124435	.	T	C	9	0	9	0	12	21	0	0
5	35124939	.	G	A	2	9	11	0	0	11	0	0
5	35125414	.	C	T	0	5	5	0	1	6	0	0
5	35125423	.	C	T	1	5	6	0	0	6	0	0
5	35125492	.	C	T	0	4	4	0	8	12	0	0
5	35125882	.	G	A	7	6	13	0	0	13	0	0
5	35125883	.	A	T	7	5	12	0	1	13	0	0
5	35127255	.	G	C	3	3	6	0	1	7	0	0
5	35129861	.	C	A	2	2	4	0	1	5	0	0
5	35129892	.	T	C	1	0	1	0	1	2	0	0
5	35133188	.	A	T	1	2	3	0	0	3	0	0
5	35137621	.	C	T	0	3	3	0	2	5	0	0
5	35178673	.	T	C	1	0	1	0	2	3	0	0
5	35202676	.	A	G	2	3	5	0	0	5	0	0
5	35202771	.	G	T	7	2	9	0	0	10	1	0
5	35202876	.	A	T	10	8	18	0	2	20	0	0
5	35202958	.	G	A	11	8	19	0	2	21	0	0
5	35202959	.	A	T	11	8	19	0	2	21	0	0
5	35203092	.	G	A	11	7	18	0	2	20	0	0
5	35203544	.	G	A	10	8	18	0	1	19	0	0
5	35203629	.	C	T	0	10	10	0	18	28	0	0
5	35204077	.	T	G	6	13	19	0	1	20	0	0
5	35204390	.	G	A	7	4	11	0	0	11	0	0
5	35204681	.	A	C	4	6	10	0	1	11	0	0
5	35204689	.	A	C	6	0	6	0	5	11	0	0
5	35204857	.	T	C	9	0	9	0	0	9	0	0
5	35204934	.	A	T	12	3	15	0	2	17	0	0
5	35204945	.	T	C	13	6	19	0	0	19	0	0
5	35205005	.	G	A	10	8	18	0	2	20	0	0
5	35205123	.	C	G	1	1	2	0	1	3	0	0
5	35207914	.	T	G	5	9	14	0	0	14	0	0
5	35220402	.	T	A	1	4	5	0	0	5	0	0
5	35222413	.	T	G	1	0	1	0	0	1	0	0
5	35230015	.	G	A	3	1	4	0	0	4	0	0
5	35253608	.	T	C	2	0	2	0	7	9	0	0
5	35258669	.	T	C	3	0	3	0	3	6	0	0
5	35259846	.	G	C	0	2	2	0	0	2	0	0
5	35260553	.	A	G	1	0	1	0	0	1	0	0
5	35260554	.	C	T	1	0	1	0	0	1	0	0
5	35271001	.	C	T	29	17	46	0	0	46	0	0
5	35271465	.	T	C	34	19	53	0	3	56	0	0
5	35271613	.	G	A	11	28	39	0	4	43	0	0
5	35271706	.	C	T	13	26	39	0	2	41	0	0
5	35271791	.	T	A	21	5	26	0	0	26	0	0
5	35271824	.	C	A	3	14	17	0	0	17	0	0
5	35271889	.	T	A	17	12	29	0	1	30	0	0
5	35272562	.	A	C	10	15	25	0	3	28	0	0
5	35272774	.	T	G	17	27	44	0	0	44	0	0
5	35272835	.	G	A	14	29	43	0	3	46	0	0
5	35272909	.	A	G	25	17	42	0	3	45	0	0
5	35273099	.	G	C	25	20	45	0	1	46	0	0
5	35273164	.	T	C	25	11	36	0	1	37	0	0
5	35273632	.	T	C	8	8	16	0	2	18	0	0
5	35273793	.	A	T	24	14	38	0	1	39	0	0
5	35273825	.	C	A	9	22	31	0	2	33	0	0
5	35273838	.	A	C	19	10	29	0	1	30	0	0
5	35274029	.	C	A	12	11	23	0	2	25	0	0
5	35275070	.	G	A	14	22	36	0	0	36	0	0
5	35275103	.	C	T	22	11	33	0	0	33	0	0
5	35276154	.	A	G	11	13	24	0	1	25	0	0
5	35276911	.	C	T	1	4	5	0	10	15	0	0
5	35277256	.	T	A	6	6	12	0	1	13	0	0
5	35277319	.	T	C	8	10	18	0	0	18	0	0
5	35277459	.	T	C	4	7	11	0	0	11	0	0
5	35278597	.	C	T	4	3	7	0	0	7	0	0
5	35278933	.	T	C	3	0	3	0	3	6	0	0
5	35278977	.	T	G	2	4	6	0	1	7	0	0
5	35279275	.	T	G	6	3	9	0	1	10	0	0
5	35279341	.	G	A	7	8	15	0	0	15	0	0
5	35279647	.	G	T	5	3	8	0	0	8	0	0
5	35279884	.	G	A	3	3	6	0	0	6	0	0
5	35422550	.	G	C	6	1	7	0	4	11	0	0
5	35422692	.	C	T	10	14	24	0	1	25	0	0
5	35431641	.	A	G	5	7	12	0	1	13	0	0
5	35431703	.	T	G	1	1	2	0	0	2	0	0
5	35454416	.	C	T	1	3	4	0	9	13	0	0
5	35454464	.	C	T	6	3	9	0	0	9	0	0
5	35478593	.	G	C	0	0	0	0	1	1	0	0
5	35486917	.	C	A	1	3	4	0	0	4	0	0
5	35487132	.	C	T	11	8	19	0	0	19	0	0
5	35487658	.	G	C	4	9	13	0	1	14	0	0
5	35682874	.	A	G	4	3	7	0	0	7	0	0
5	35683116	.	G	A	2	3	5	0	0	5	0	0
5	35683134	.	C	A	2	4	6	0	0	6	0	0
5	35683950	.	T	A	1	3	4	0	0	4	0	0
5	35683965	.	C	T	0	3	3	0	1	4	0	0
5	35749458	.	A	G	0	2	2	0	0	2	0	0
5	35749470	.	A	G	2	0	2	0	0	2	0	0
5	35749826	.	A	G	2	4	6	0	0	6	0	0
5	35751883	.	G	T	2	4	6	0	0	6	0	0
5	35751970	.	C	T	2	6	8	0	1	9	0	0
5	35751977	.	A	G	6	1	7	0	2	9	0	0
5	35754354	.	A	G	7	14	21	0	0	21	0	0
5	35754481	.	T	G	17	12	29	0	1	30	0	0
5	35877578	.	C	A	3	4	7	0	0	7	0	0
5	35880250	.	T	C	0	2	2	0	1	3	0	0
5	35955514	.	T	C	13	13	26	0	0	26	0	0
5	35955534	.	G	T	19	11	30	0	1	31	0	0
5	35955663	.	T	A	1	2	3	0	0	3	0	0
5	35967234	.	C	T	5	8	13	0	0	13	0	0
5	35967270	.	T	A	9	8	17	0	0	17	0	0
5	35967438	.	A	T	1	6	7	0	0	7	0	0
5	36274750	.	C	A	0	5	5	0	1	6	0	0
5	36296066	.	G	A	2	4	6	0	1	7	0	0
5	36296114	.	T	C	1	2	3	0	0	3	0	0
5	36416597	.	C	G	17	16	33	0	0	33	0	0
5	36421991	.	G	A	0	7	7	0	12	19	0	0
5	36537182	.	G	A	0	9	9	0	3	12	0	0
5	36551493	.	A	G	1	3	4	0	0	4	0	0
5	36551614	.	C	A	9	14	23	0	0	23	0	0
5	36551824	.	C	T	0	11	11	0	15	26	0	0
5	36558059	.	G	A	13	5	18	0	0	18	0	0
5	36558286	.	G	A	9	9	18	0	2	20	0	0
5	36558369	.	G	A	18	9	27	0	1	28	0	0
5	36558441	.	C	T	9	7	16	0	0	16	0	0
5	36563257	.	T	C	3	2	5	0	1	6	0	0
5	36567750	.	C	A	0	6	6	0	4	10	0	0
5	36568071	.	A	T	4	2	6	0	0	6	0	0
5	36570280	.	G	A	2	0	2	0	0	2	0	0
5	36577828	.	T	C	1	2	3	0	0	3	0	0
5	36583575	.	C	T	0	3	3	0	1	4	0	0
5	36584779	.	G	T	0	2	2	0	0	2	0	0
5	36584985	.	C	T	2	1	3	0	0	3	0	0
5	36585662	.	G	A	1	2	3	0	0	3	0	0
5	36585933	.	C	T	1	2	3	0	0	3	0	0
5	36596278	.	G	A	2	2	4	0	0	4	0	0
5	36596294	.	G	A	1	5	6	0	0	6	0	0
5	36624638	.	A	T	9	6	15	0	0	15	0	0
5	36625809	.	A	T	18	17	35	0	3	38	0	0
5	36626632	.	A	T	22	17	39	0	2	41	0	0
5	36650176	.	A	T	5	2	7	0	0	7	0	0
5	36650289	.	T	G	2	1	3	0	0	3	0	0
5	36653522	.	G	A	1	6	7	0	0	7	0	0
5	36653876	.	T	G	1	0	1	0	0	1	0	0
5	36654147	.	G	A	0	8	8	0	5	13	0	0
5	36654334	.	A	T	2	5	7	0	0	7	0	0
5	36654344	.	G	A	3	3	6	0	1	7	0	0
5	36665351	.	C	T	11	10	21	0	0	21	0	0
5	36668321	.	C	T	4	5	9	0	0	9	0	0
5	36673347	.	C	T	2	7	9	0	0	9	0	0
5	36673470	.	C	A	1	6	7	0	0	7	0	0
5	36673609	.	A	G	1	5	6	0	0	6	0	0
5	36673687	.	A	T	2	2	4	0	0	4	0	0
5	36674796	.	G	C	4	7	11	0	1	12	0	0
5	36674831	.	C	T	3	8	11	0	0	11	0	0
5	36674911	.	C	T	3	5	8	0	0	8	0	0
5	36674925	.	T	C	2	6	8	0	0	8	0	0
5	36700952	.	C	T	2	3	5	0	0	5	0	0
5	36701332	.	C	A	1	2	3	0	0	3	0	0
5	36732199	.	G	C	2	4	6	0	1	7	0	0
5	36732217	.	A	G	2	4	6	0	1	7	0	0
5	36739134	.	T	C	19	10	29	0	0	29	0	0
5	36739310	.	T	A	15	18	33	0	0	33	0	0
5	36739316	.	T	C	16	18	34	0	0	34	0	0
5	36739352	.	T	A	16	11	27	0	2	29	0	0
5	36739361	.	T	C	14	11	25	0	1	26	0	0
5	36786641	.	G	A	0	2	2	0	1	3	0	0
5	36802407	.	T	C	1	5	6	0	1	7	0	0
5	36851191	.	C	T	4	1	5	0	0	5	0	0
5	36852564	.	A	G	1	0	1	0	2	3	0	0
5	36852848	.	G	A	0	0	0	0	2	2	0	0
5	36853849	.	C	G	9	2	11	0	0	11	0	0
5	36854177	.	C	T	7	2	9	0	0	9	0	0
5	36895627	.	G	A	0	1	1	0	0	1	0	0
5	36897361	.	T	A	2	2	4	0	0	4	0	0
5	36898476	.	C	T	6	5	11	0	1	12	0	0
5	36898668	.	A	G	12	0	12	0	8	20	0	0
5	36901003	.	T	G	2	2	4	0	0	4	0	0
5	36902610	.	A	G	6	0	6	0	5	11	0	0
5	36902628	.	T	C	6	4	10	0	0	10	0	0
5	36907182	.	G	T	8	4	12	0	0	12	0	0
5	36908034	.	T	C	21	18	39	0	2	42	1	0
5	36913570	.	A	G	5	3	8	0	0	8	0	0
5	36914002	.	C	T	5	3	8	0	0	8	0	0
5	36914018	.	A	C	6	0	6	0	3	9	0	0
5	36916370	.	A	T	0	2	2	0	0	2	0	0
5	36922399	.	A	G	0	2	2	0	0	2	0	0
5	36924122	.	G	C	0	2	2	0	0	2	0	0
5	36935562	.	T	C	2	3	5	0	0	5	0	0
5	36935585	.	A	G	0	0	0	0	2	2	0	0
5	36935753	.	C	A	2	2	4	0	0	4	0	0
5	36935756	.	A	G	2	2	4	0	0	4	0	0
5	36935897	.	A	C	1	2	3	0	0	3	0	0
5	36945378	.	T	A	21	18	39	0	1	40	0	0
5	36945383	.	A	T	18	21	39	0	2	42	1	0
5	36945463	.	T	A	23	25	48	0	2	50	0	0
5	36945518	.	T	G	29	19	48	0	5	53	0	0
5	36945719	.	G	T	24	33	57	0	12	69	0	0
5	36945747	.	T	A	20	31	51	0	12	63	0	0
5	36945927	.	A	C	38	23	61	0	0	61	0	0
5	36945937	.	C	T	36	20	56	0	0	56	0	0
5	36946244	.	A	G	37	31	68	0	11	79	0	0
5	36946261	.	T	C	34	11	45	0	28	73	0	0
5	36946341	.	C	T	2	28	30	0	38	68	0	0
5	36996458	.	A	G	8	8	16	0	0	16	0	0
5	36996638	.	A	G	13	0	13	0	14	27	0	0
5	36997133	.	A	G	11	19	30	0	1	31	0	0
5	37032095	.	A	G	10	13	23	0	2	25	0	0
5	37032191	.	T	C	7	14	21	0	2	23	0	0
5	37032280	.	C	G	13	10	23	0	0	23	0	0
5	37032339	.	A	G	10	1	11	0	9	20	0	0
5	37032611	.	T	C	8	10	18	0	0	18	0	0
5	37032782	.	G	A	13	9	22	0	1	23	0	0
5	37032799	.	A	T	11	7	18	0	1	19	0	0
5	37032959	.	A	G	5	2	7	0	0	7	0	0
5	37034111	.	T	C	2	4	6	0	0	6	0	0
5	37036404	.	T	C	6	6	12	0	0	12	0	0
5	37036648	.	A	G	8	0	8	0	5	13	0	0
5	37036662	.	T	A	8	4	12	0	0	12	0	0
5	37036856	.	T	C	10	10	20	0	0	20	0	0
5	37036975	.	A	T	11	11	22	0	0	22	0	0
5	37037079	.	C	T	16	9	25	0	2	27	0	0
5	37037152	.	T	C	12	16	28	0	0	28	0	0
5	37037308	.	C	A	8	5	13	0	0	13	0	0
5	37037436	.	G	T	0	2	2	0	5	7	0	0
5	37037583	.	T	C	15	16	31	0	2	33	0	0
5	37037617	.	A	T	20	16	36	0	0	36	0	0
5	37037669	.	T	G	18	15	33	0	2	35	0	0
5	37037742	.	A	T	14	23	37	0	3	40	0	0
5	37038017	.	T	C	5	6	11	0	1	12	0	0
5	37061485	.	G	A	9	4	13	0	0	13	0	0
5	37061487	.	C	T	9	4	13	0	0	13	0	0
5	37065416	.	T	C	25	20	45	0	1	46	0	0
5	37065729	.	C	T	23	4	27	0	0	27	0	0
5	37087733	.	C	A	2	1	3	0	0	3	0	0
5	37095076	.	A	T	6	4	10	0	1	11	0	0
5	37293841	.	G	A	4	0	4	0	0	4	0	0
5	37295469	.	C	T	1	4	5	0	0	5	0	0
5	37299125	.	G	A	3	7	10	0	0	10	0	0
5	37312520	.	T	A	6	13	19	0	1	20	0	0
5	37312556	.	A	T	8	27	35	0	4	39	0	0
5	37312577	.	A	G	13	0	13	0	27	40	0	0
5	37312681	.	C	A	8	8	16	0	1	17	0	0
5	37316716	.	G	C	9	0	9	0	14	23	0	0
5	37316743	.	A	G	6	6	12	0	1	13	0	0
5	37316954	.	A	G	8	9	17	0	1	18	0	0
5	37320254	.	A	G	6	7	13	0	2	15	0	0
5	37321251	.	C	G	0	2	2	0	3	5	0	0
5	37321488	.	G	A	2	1	3	0	0	3	0	0
5	37321519	.	C	T	2	4	6	0	0	6	0	0
5	37331854	.	C	T	3	1	4	0	0	4	0	0
5	37333870	.	G	A	11	7	18	0	0	18	0	0
5	37334264	.	T	A	2	0	2	0	1	3	0	0
5	37380701	.	T	G	6	6	12	0	0	12	0	0
5	37406445	.	G	A	0	3	3	0	2	5	0	0
5	37413846	.	C	T	3	2	5	0	0	5	0	0
5	37422993	.	C	T	0	4	4	0	1	5	0	0
5	37423193	.	G	A	5	8	13	0	0	13	0	0
5	37423298	.	G	A	0	5	5	0	8	13	0	0
5	37494835	.	G	A	1	2	3	0	0	3	0	0
5	37495108	.	A	T	1	2	3	0	0	3	0	0
5	37495132	.	T	C	1	2	3	0	1	4	0	0
5	37504636	.	A	T	2	2	4	0	0	4	0	0
5	37504637	.	T	A	2	2	4	0	0	4	0	0
5	37504720	.	T	C	2	4	6	0	0	6	0	0
5	37505245	.	G	A	2	3	5	0	1	6	0	0
5	37509285	.	T	C	5	10	15	0	0	15	0	0
5	37509374	.	T	A	2	5	7	0	1	8	0	0
5	37510491	.	T	A	7	9	16	0	0	16	0	0
5	37510520	.	C	T	5	7	12	0	1	13	0	0
5	37510565	.	A	T	9	6	15	0	1	16	0	0
5	37510574	.	C	G	8	7	15	0	0	15	0	0
5	37573605	.	T	A	0	1	1	0	0	1	0	0
5	37584180	.	T	A	4	2	6	0	0	6	0	0
5	37584852	.	G	T	1	2	3	0	0	3	0	0
5	37584870	.	T	C	1	2	3	0	0	3	0	0
5	37677229	.	C	T	5	1	6	0	1	7	0	0
5	37680600	.	C	T	0	0	0	0	1	1	0	0
5	37684289	.	G	A	3	5	8	0	0	8	0	0
5	37688371	.	C	T	3	9	12	0	0	12	0	0
5	37688422	.	A	G	1	1	2	0	0	2	0	0
5	37688560	.	C	G	1	1	2	0	0	2	0	0
5	37691223	.	A	G	0	2	2	0	0	2	0	0
5	37691459	.	T	C	6	10	16	0	0	16	0	0
5	37691516	.	C	T	3	4	7	0	0	7	0	0
5	37692171	.	A	G	1	1	2	0	0	2	0	0
5	37692198	.	C	T	3	3	6	0	0	6	0	0
5	37692620	.	T	C	7	5	12	0	0	12	0	0
5	37694283	.	G	A	0	3	3	0	0	3	0	0
5	37699373	.	C	T	10	12	22	0	0	22	0	0
5	37700905	.	C	T	12	7	19	0	0	19	0	0
5	37700908	.	T	C	10	7	17	0	2	19	0	0
5	37701262	.	T	A	9	10	19	0	0	19	0	0
5	37701281	.	C	T	8	9	17	0	1	18	0	0
5	37702934	.	C	T	14	8	22	0	2	24	0	0
5	37703180	.	G	A	5	6	11	0	0	11	0	0
5	37706798	.	C	T	3	7	10	0	1	12	1	0
5	37708995	.	A	T	19	20	39	0	3	42	0	0
5	37709057	.	T	A	19	17	36	0	1	37	0	0
5	37749854	.	G	C	2	1	3	0	0	3	0	0
5	37757331	.	A	G	2	0	2	0	4	6	0	0
5	37757690	.	T	C	6	8	14	0	0	14	0	0
5	37812657	.	T	C	0	1	1	0	1	2	0	0
5	37838415	.	T	C	6	2	8	0	1	9	0	0
5	37839029	.	G	T	25	28	53	0	2	55	0	0
5	37845300	.	A	G	1	0	1	0	2	3	0	0
5	37850979	.	A	C	1	3	4	0	0	4	0	0
5	37851261	.	G	T	5	2	7	0	0	7	0	0
5	37851438	.	T	A	5	2	7	0	0	7	0	0
5	37851923	.	G	A	3	3	6	0	1	7	0	0
5	37852048	.	A	T	3	7	10	0	0	10	0	0
5	37852053	.	G	A	3	6	9	0	1	10	0	0
5	37864789	.	G	A	14	8	22	0	1	23	0	0
5	37864845	.	A	G	11	9	20	0	1	21	0	0
5	37864849	.	T	G	10	11	21	0	1	22	0	0
5	37864982	.	T	A	6	5	11	0	0	11	0	0
5	37865142	.	C	T	6	5	11	0	1	12	0	0
5	37865429	.	T	A	8	9	17	0	2	19	0	0
5	37865487	.	T	A	2	7	9	0	0	9	0	0
5	37865677	.	G	T	7	2	9	0	0	9	0	0
5	37866310	.	C	T	10	4	14	0	2	16	0	0
5	37867046	.	C	T	4	5	9	0	2	11	0	0
5	37867491	.	C	T	0	1	1	0	0	1	0	0
5	37912292	.	T	A	19	17	36	0	0	36	0	0
5	37912859	.	A	C	15	17	32	0	0	32	0	0
5	37918882	.	C	T	0	3	3	0	13	16	0	0
5	37918932	.	A	T	14	4	18	0	1	19	0	0
5	37934058	.	G	A	8	3	11	0	0	11	0	0
5	37963259	.	C	T	8	10	18	0	5	23	0	0
5	37968879	.	G	T	0	1	1	0	0	1	0	0
5	37968912	.	T	G	2	2	4	0	1	5	0	0
5	37970764	.	C	T	10	8	18	0	0	18	0	0
5	37970773	.	A	T	7	6	13	0	1	14	0	0
5	37970818	.	T	G	4	0	4	0	8	12	0	0
5	37982040	.	A	G	2	2	4	0	0	4	0	0
5	37982156	.	G	C	2	0	2	0	2	4	0	0
5	37987114	.	A	T	10	9	19	0	0	19	0	0
5	37987301	.	T	C	1	2	3	0	0	3	0	0
5	37987325	.	C	T	0	4	4	0	4	8	0	0
5	37987369	.	G	A	3	2	5	0	0	5	0	0
5	37989128	.	G	C	8	0	8	0	6	14	0	0
5	37989135	.	A	G	6	6	12	0	1	13	0	0
5	37989204	.	A	G	6	6	12	0	1	13	0	0
5	37989325	.	G	A	3	5	8	0	0	8	0	0
5	37989379	.	G	T	5	5	10	0	0	10	0	0
5	37989443	.	A	C	3	5	8	0	0	8	0	0
5	37989447	.	A	G	3	4	7	0	0	7	0	0
5	37991350	.	T	A	0	1	1	0	0	1	0	0
5	37991535	.	T	G	2	0	2	0	1	3	0	0
5	37991566	.	C	A	1	1	2	0	1	3	0	0
5	37991756	.	C	T	1	1	2	0	0	2	0	0
5	37991757	.	C	T	1	1	2	0	0	2	0	0
5	37993446	.	G	T	1	2	3	0	0	3	0	0
5	37994266	.	G	C	1	1	2	0	0	2	0	0
5	38089247	.	G	T	2	4	6	0	0	6	0	0
5	38089309	.	G	A	5	5	10	0	0	10	0	0
5	38089537	.	T	C	5	4	9	0	1	10	0	0
5	38089578	.	T	G	6	5	11	0	2	13	0	0
5	38089651	.	G	A	4	6	10	0	0	10	0	0
5	38089733	.	G	C	4	0	4	0	4	8	0	0
5	38089834	.	A	G	3	4	7	0	0	7	0	0
5	38089930	.	G	T	2	2	4	0	0	4	0	0
5	38090070	.	A	G	3	2	5	0	0	5	0	0
5	38090230	.	A	C	3	2	5	0	0	5	0	0
5	38090707	.	G	A	3	2	5	0	0	5	0	0
5	38090734	.	G	T	2	2	4	0	0	4	0	0
5	38091247	.	A	G	1	2	3	0	0	3	0	0
5	38091259	.	T	C	2	0	2	0	2	4	0	0
5	38091547	.	A	G	1	3	4	0	0	4	0	0
5	38091573	.	G	A	1	2	3	0	0	3	0	0
5	38101142	.	C	T	0	1	1	0	0	1	0	0
5	38101587	.	T	C	2	2	4	0	0	4	0	0
5	38101745	.	T	G	4	0	4	0	3	7	0	0
5	38101912	.	A	C	2	2	4	0	0	4	0	0
5	38104971	.	G	T	0	2	2	0	1	3	0	0
5	38105327	.	T	C	1	3	4	0	0	4	0	0
5	38110826	.	G	T	6	12	18	0	0	18	0	0
5	38110908	.	A	T	6	13	19	0	1	20	0	0
5	38111060	.	T	C	13	0	13	0	9	22	0	0
5	38115349	.	T	C	5	8	13	0	0	13	0	0
5	38115361	.	T	C	4	9	13	0	0	13	0	0
5	38115395	.	A	G	2	10	12	0	0	12	0	0
5	38115502	.	C	T	12	5	17	0	0	17	0	0
5	38115582	.	C	T	10	8	18	0	1	19	0	0
5	38115685	.	A	T	6	4	10	0	4	14	0	0
5	38115940	.	T	C	5	0	5	0	4	9	0	0
5	38120116	.	A	G	1	1	2	0	1	3	0	0
5	38120117	.	C	A	1	2	3	0	0	3	0	0
5	38120162	.	T	C	1	2	3	0	0	3	0	0
5	38121914	.	T	A	6	2	8	0	1	9	0	0
5	38121942	.	A	G	8	5	13	0	0	13	0	0
5	38121991	.	A	T	6	9	15	0	1	16	0	0
5	38121993	.	T	C	5	10	15	0	1	16	0	0
5	38122100	.	C	A	6	5	11	0	0	11	0	0
5	38122112	.	T	A	6	4	10	0	0	10	0	0
5	38216140	.	C	T	2	4	6	0	0	6	0	0
5	38216469	.	C	A	6	3	9	0	0	9	0	0
5	38216471	.	C	T	1	3	4	0	5	9	0	0
5	38217376	.	T	C	3	2	5	0	0	5	0	0
5	38217422	.	G	T	4	2	6	0	0	6	0	0
5	38225079	.	G	A	1	0	1	0	0	1	0	0
5	38241247	.	A	G	2	2	4	0	0	4	0	0
5	38251120	.	A	C	1	4	5	0	2	7	0	0
5	38251506	.	C	T	0	5	5	0	9	14	0	0
5	38251968	.	T	G	6	6	12	0	0	12	0	0
5	38252113	.	G	C	3	3	6	0	0	6	0	0
5	38254734	.	A	G	7	5	12	0	0	12	0	0
5	38254919	.	A	G	2	2	4	0	0	4	0	0
5	38255108	.	G	T	1	3	4	0	1	5	0	0
5	38255132	.	G	A	1	3	4	0	0	4	0	0
5	38255219	.	A	C	3	1	4	0	5	9	0	0
5	38263384	.	G	A	15	14	29	0	0	29	0	0
5	38263611	.	G	A	12	8	20	0	1	21	0	0
5	38263870	.	C	T	2	2	4	0	0	4	0	0
5	38281540	.	G	C	0	10	10	0	5	15	0	0
5	38287103	.	C	T	13	15	28	0	1	29	0	0
5	38289358	.	A	C	13	20	33	0	1	34	0	0
5	38296192	.	C	T	20	23	43	0	1	44	0	0
5	38296193	.	A	G	21	21	42	0	2	44	0	0
5	38296475	.	G	A	16	19	35	0	2	37	0	0
5	38296765	.	A	C	25	17	42	0	2	44	0	0
5	38296799	.	A	C	25	17	42	0	1	43	0	0
5	38297305	.	A	G	21	2	23	0	21	44	0	0
5	38302085	.	G	A	12	11	23	0	0	23	0	0
5	38302158	.	C	A	17	19	36	0	2	38	0	0
5	38302159	.	A	C	25	12	37	0	1	38	0	0
5	38302490	.	A	G	18	23	41	0	2	43	0	0
5	38302589	.	T	A	18	19	37	0	2	39	0	0
5	38302753	.	G	T	26	25	51	0	3	54	0	0
5	38302859	.	C	T	23	22	45	0	1	46	0	0
5	38302911	.	A	T	23	11	34	0	1	35	0	0
5	38303028	.	G	T	14	23	37	0	1	38	0	0
5	38303301	.	T	C	12	1	13	0	15	28	0	0
5	38303895	.	A	T	21	21	42	0	1	43	0	0
5	38303896	.	G	A	19	22	41	0	2	43	0	0
5	38304578	.	C	T	20	23	43	0	2	45	0	0
5	38304633	.	T	G	20	18	38	0	3	41	0	0
5	38304768	.	G	A	20	22	42	0	0	42	0	0
5	38305068	.	G	A	14	26	40	0	0	40	0	0
5	38305127	.	T	C	13	11	24	0	1	26	1	0
5	38305493	.	C	T	9	7	16	0	0	16	0	0
5	38305698	.	G	A	16	10	26	0	1	27	0	0
5	38308378	.	C	A	4	1	5	0	0	5	0	0
5	38314069	.	C	T	5	2	7	0	0	7	0	0
5	38320825	.	A	G	4	2	6	0	0	6	0	0
5	38324453	.	C	T	0	1	1	0	0	1	0	0
5	38388741	.	C	A	6	4	10	0	0	10	0	0
5	38388786	.	G	A	2	2	4	0	0	4	0	0
5	38388875	.	C	G	0	2	2	0	4	6	0	0
5	38389087	.	C	G	4	4	8	0	0	8	0	0
5	38389089	.	G	A	4	4	8	0	0	8	0	0
5	38389538	.	G	A	4	3	7	0	0	7	0	0
5	38389641	.	G	A	5	5	10	0	1	11	0	0
5	38389642	.	G	T	5	6	11	0	0	11	0	0
5	38389975	.	T	G	1	2	3	0	0	3	0	0
5	38390672	.	C	T	3	3	6	0	0	6	0	0
5	38390728	.	C	T	1	2	3	0	0	3	0	0
5	38476185	.	C	T	2	2	4	0	0	4	0	0
5	38476750	.	C	A	8	6	14	0	0	14	0	0
5	38531848	.	T	A	2	6	8	0	0	8	0	0
5	38532216	.	A	T	3	5	8	0	0	8	0	0
5	38532462	.	T	C	3	0	3	0	12	15	0	0
5	38532535	.	A	G	8	7	15	0	0	15	0	0
5	38532594	.	A	C	9	0	9	0	0	9	0	0
5	38532600	.	C	A	8	1	9	0	0	9	0	0
5	38533170	.	A	G	2	5	7	0	0	7	0	0
5	38533248	.	G	A	2	4	6	0	0	7	1	0
5	38533296	.	T	G	3	8	11	0	0	11	0	0
5	38533392	.	G	T	5	9	14	0	1	15	0	0
5	38533404	.	C	T	0	9	9	0	7	16	0	0
5	38533464	.	A	G	3	8	11	0	1	12	0	0
5	38533551	.	A	G	4	3	7	0	0	7	0	0
5	38602562	.	C	T	1	2	3	0	0	3	0	0
5	38605094	.	C	T	7	6	13	0	0	13	0	0
5	38605106	.	A	T	7	6	13	0	2	15	0	0
5	38605164	.	C	T	5	7	12	0	0	12	0	0
5	38605201	.	A	C	4	7	11	0	0	11	0	0
5	38605347	.	G	T	16	5	21	0	1	22	0	0
5	38611096	.	G	T	3	1	4	0	0	4	0	0
5	38611108	.	T	C	1	0	1	0	1	2	0	0
5	38721044	.	G	C	0	2	2	0	0	2	0	0
5	38745925	.	C	T	4	2	6	0	0	6	0	0
5	38749541	.	T	A	1	2	3	0	0	3	0	0
5	38749767	.	C	T	4	5	9	0	0	9	0	0
5	38749939	.	C	A	4	2	6	0	0	6	0	0
5	38750354	.	T	G	2	2	4	0	0	4	0	0
5	38786808	.	C	T	3	3	6	0	1	7	0	0
5	38786823	.	G	A	3	4	7	0	0	7	0	0
5	38786922	.	T	C	9	8	17	0	1	18	0	0
5	38831573	.	A	G	6	2	8	0	0	8	0	0
5	39067289	.	T	C	0	1	1	0	0	1	0	0
5	39081359	.	C	G	4	0	4	0	4	8	0	0
5	39082830	.	T	C	2	0	2	0	1	3	0	0
5	39082833	.	C	T	3	0	3	0	0	3	0	0
5	39083065	.	A	C	1	2	3	0	2	5	0	0
5	39083116	.	T	C	0	1	1	0	0	1	0	0
5	39085271	.	T	C	2	2	4	0	0	4	0	0
5	39085302	.	T	A	2	3	5	0	1	6	0	0
5	39085328	.	C	T	2	2	4	0	0	4	0	0
5	39085976	.	C	T	3	7	10	0	2	12	0	0
5	39086295	.	T	A	6	5	11	0	0	11	0	0
5	39099642	.	T	C	3	3	6	0	0	6	0	0
5	39124314	.	C	T	0	4	4	0	0	4	0	0
5	39136032	.	G	A	7	6	13	0	1	14	0	0
5	39142657	.	A	G	5	0	5	0	0	5	0	0
5	39142677	.	A	T	1	0	1	0	0	1	0	0
5	39143310	.	C	T	5	4	9	0	0	9	0	0
5	39143447	.	C	T	6	6	12	0	0	12	0	0
5	39150608	.	C	A	3	2	5	0	1	6	0	0
5	39150803	.	T	C	1	2	3	0	0	3	0	0
5	39151045	.	A	T	3	4	7	0	0	7	0	0
5	39151379	.	G	A	0	2	2	0	1	3	0	0
5	39151493	.	G	A	0	2	2	0	1	3	0	0
5	39151610	.	T	A	3	3	6	0	0	6	0	0
5	39152411	.	C	T	4	4	8	0	0	8	0	0
5	39152582	.	A	G	4	7	11	0	0	11	0	0
5	39152613	.	T	A	4	3	7	0	1	8	0	0
5	39154714	.	A	C	7	0	7	0	4	11	0	0
5	39154819	.	C	G	10	11	21	0	0	21	0	0
5	39154829	.	G	T	9	14	23	0	1	24	0	0
5	39154919	.	A	G	7	13	20	0	0	20	0	0
5	39154958	.	C	G	12	12	24	0	3	28	1	0
5	39154979	.	C	T	0	10	10	0	15	25	0	0
5	39155006	.	T	A	14	7	21	0	0	21	0	0
5	39155044	.	A	G	12	6	18	0	0	18	0	0
5	39155146	.	T	A	3	2	5	0	0	5	0	0
5	39155419	.	C	T	5	6	11	0	0	11	0	0
5	39155473	.	T	A	4	10	14	0	0	14	0	0
5	39155474	.	G	T	4	8	12	0	2	14	0	0
5	39155511	.	A	G	5	6	11	0	1	12	0	0
5	39386667	.	A	G	6	2	8	0	0	8	0	0
5	39386685	.	A	G	5	3	8	0	0	8	0	0
5	39386709	.	T	A	3	3	6	0	1	7	0	0
5	39386721	.	A	T	4	2	6	0	1	7	0	0
5	39388407	.	A	T	1	2	3	0	1	4	0	0
5	39388692	.	C	G	0	1	1	0	0	1	0	0
5	39504271	.	G	C	1	3	4	0	0	4	0	0
5	39508009	.	C	T	13	24	37	0	0	37	0	0
5	39508059	.	T	A	12	24	36	0	1	37	0	0
5	39508540	.	G	A	0	9	9	0	11	20	0	0
5	39707758	.	A	C	3	7	10	0	2	12	0	0
5	39707825	.	G	A	7	9	16	0	1	17	0	0
5	39708046	.	A	G	8	14	22	0	1	23	0	0
5	39712557	.	T	C	1	1	2	0	1	3	0	0
5	39714917	.	T	C	0	1	1	0	0	1	0	0
5	39715249	.	G	A	2	4	6	0	1	7	0	0
5	39730511	.	A	G	5	4	9	0	0	9	0	0
5	39730575	.	C	T	0	1	1	0	0	1	0	0
5	39730713	.	T	C	2	2	4	0	0	4	0	0
5	39730785	.	A	G	1	2	3	0	0	3	0	0
5	39731805	.	T	C	7	3	10	0	0	10	0	0
5	39736279	.	C	T	4	2	6	0	0	6	0	0
5	39805398	.	T	C	3	0	3	0	2	5	0	0
5	40024831	.	C	T	0	2	2	0	1	3	0	0
5	40052933	.	A	G	6	27	33	0	2	35	0	0
5	40054407	.	C	G	1	5	6	0	0	6	0	0
5	40059722	.	C	G	13	17	30	0	1	31	0	0
5	40059761	.	T	C	8	17	25	0	3	28	0	0
5	40062351	.	A	G	9	12	21	0	1	22	0	0
5	40062390	.	G	A	4	6	10	0	0	10	0	0
5	40077300	.	G	A	1	1	2	0	1	3	0	0
5	40080885	.	G	A	2	2	4	0	0	4	0	0
5	40093858	.	G	A	1	1	2	0	0	2	0	0
5	40095602	.	C	T	0	1	1	0	1	2	0	0
5	40203540	.	G	A	7	4	11	0	0	11	0	0
5	40206117	.	G	A	0	2	2	0	0	2	0	0
5	40206358	.	A	C	7	7	14	0	1	15	0	0
5	40210379	.	A	C	6	3	9	0	0	9	0	0
5	40273444	.	A	C	3	2	5	0	1	6	0	0
5	40273468	.	T	C	2	3	5	0	0	5	0	0
5	40273510	.	G	T	3	2	5	0	0	5	0	0
5	40273606	.	C	T	1	3	4	0	2	6	0	0
5	40505124	.	C	T	0	5	5	0	3	8	0	0
5	40506670	.	G	A	3	3	6	0	0	6	0	0
5	40506837	.	A	G	2	2	4	0	0	4	0	0
5	40507001	.	G	A	2	3	5	0	1	6	0	0
5	40507154	.	C	G	2	2	4	0	1	5	0	0
5	40507577	.	C	A	6	3	9	0	0	9	0	0
5	40728852	.	A	G	5	3	8	0	0	8	0	0
5	40729081	.	A	C	4	4	8	0	1	9	0	0
5	40729147	.	T	C	6	7	13	0	0	13	0	0
5	40729408	.	G	A	14	10	24	0	1	25	0	0
5	40729618	.	A	G	10	6	16	0	0	16	0	0
5	40732293	.	A	G	5	5	10	0	0	10	0	0
5	40732341	.	T	A	3	4	7	0	0	7	0	0
5	40845312	.	A	G	9	6	15	0	0	15	0	0
5	40845344	.	G	C	8	7	15	0	0	15	0	0
5	40845387	.	A	G	8	8	16	0	0	16	0	0
5	40845389	.	A	T	7	8	15	0	1	16	0	0
5	40845433	.	A	G	5	6	11	0	0	11	0	0
5	40845434	.	G	A	4	6	10	0	1	11	0	0
5	40845505	.	G	C	5	0	5	0	3	8	0	0
5	40845556	.	C	A	10	4	14	0	1	15	0	0
5	40845893	.	A	G	2	7	9	0	0	9	0	0
5	40846122	.	G	A	3	9	12	0	0	12	0	0
5	40935003	.	C	T	2	2	4	0	0	4	0	0
5	40953260	.	T	C	1	1	2	0	0	2	0	0
5	40956146	.	T	A	1	0	1	0	0	1	0	0
5	41082921	.	C	G	10	11	21	0	1	22	0	0
5	41082951	.	A	C	9	0	9	0	12	21	0	0
5	41083000	.	C	A	14	7	21	0	0	21	0	0
5	41083001	.	T	C	14	0	14	0	7	21	0	0
5	41083118	.	C	T	0	4	4	0	5	9	0	0
5	41083227	.	A	G	8	5	13	0	0	13	0	0
5	41083763	.	A	G	12	11	23	0	0	23	0	0
5	41084063	.	G	C	11	9	20	0	0	20	0	0
5	41084116	.	A	T	5	4	9	2	0	11	0	0
5	41084274	.	A	G	12	17	29	0	1	30	0	0
5	41084367	.	C	A	0	9	9	0	13	22	0	0
5	41085118	.	A	G	4	3	7	0	1	8	0	0
5	41085414	.	T	A	7	3	10	0	0	10	0	0
5	41085511	.	C	T	0	5	5	0	1	6	0	0
5	41085571	.	T	C	3	0	3	0	4	7	0	0
5	41085582	.	C	T	3	2	5	0	1	6	0	0
5	41086082	.	T	G	4	5	9	0	0	9	0	0
5	41086195	.	A	T	4	7	11	0	0	11	0	0
5	41103286	.	T	C	5	10	15	0	3	18	0	0
5	41103462	.	A	G	2	7	9	0	0	9	0	0
5	41103469	.	G	A	3	6	9	0	1	10	0	0
5	41124760	.	T	C	3	0	3	0	5	8	0	0
5	41125097	.	C	T	1	6	7	0	2	9	0	0
5	41125140	.	G	A	2	2	4	0	1	5	0	0
5	41125229	.	G	T	11	4	15	0	0	15	0	0
5	41125310	.	A	C	27	17	44	0	1	45	0	0
5	41125311	.	A	C	25	16	41	0	3	45	1	0
5	41125354	.	C	A	30	17	47	0	0	47	0	0
5	41125996	.	T	C	25	20	45	0	1	46	0	0
5	41126059	.	G	A	29	12	41	0	4	45	0	0
5	41127078	.	A	G	2	5	7	0	0	7	0	0
5	41127111	.	T	C	8	6	14	0	1	15	0	0
5	41127132	.	C	T	8	7	15	0	0	15	0	0
5	41128808	.	T	G	5	9	14	0	3	17	0	0
5	41133401	.	A	T	19	6	25	0	2	27	0	0
5	41134921	.	A	T	5	8	13	0	1	14	0	0
5	41134942	.	A	G	7	13	20	0	0	20	0	0
5	41135002	.	A	G	8	10	18	0	1	19	0	0
5	41137311	.	G	A	12	6	18	0	0	18	0	0
5	41137341	.	G	A	12	9	21	0	1	22	0	0
5	41138377	.	C	T	12	5	17	0	0	17	0	0
5	41138720	.	T	C	9	6	15	0	0	15	0	0
5	41138738	.	A	G	7	7	14	0	2	16	0	0
5	41138756	.	C	A	10	10	20	0	1	21	0	0
5	41138807	.	T	C	12	0	12	0	9	21	0	0
5	41146801	.	G	A	0	1	1	0	0	1	0	0
5	41150615	.	C	T	8	16	24	0	0	24	0	0
5	41150898	.	T	A	21	20	41	0	0	41	0	0
5	41150979	.	A	C	23	18	41	0	0	41	0	0
5	41151265	.	G	A	10	9	19	0	1	20	0	0
5	41260937	.	C	T	4	7	11	0	0	11	0	0
5	41261901	.	G	C	2	3	5	0	0	5	0	0
5	41261907	.	G	A	2	4	6	0	0	6	0	0
5	41286949	.	G	A	0	2	2	0	0	2	0	0
5	41286973	.	G	T	0	1	1	0	0	1	0	0
5	41478264	.	A	G	2	0	2	0	3	5	0	0
5	41478349	.	C	T	1	7	8	0	0	8	0	0
5	41478382	.	T	C	0	2	2	0	0	2	0	0
5	41481405	.	A	G	3	4	7	0	0	7	0	0
5	41484391	.	A	C	4	8	12	0	0	12	0	0
5	41484460	.	T	C	13	10	23	0	1	24	0	0
5	41484496	.	T	C	12	7	19	0	2	21	0	0
5	41484680	.	C	T	10	8	18	0	2	20	0	0
5	41484797	.	C	A	6	11	17	0	2	19	0	0
5	41485363	.	C	G	20	14	34	0	4	38	0	0
5	41485365	.	A	G	20	16	36	0	2	38	0	0
5	41485497	.	C	G	23	21	44	0	1	45	0	0
5	41485533	.	C	T	0	26	26	0	27	53	0	0
5	41485709	.	A	T	31	31	62	0	1	63	0	0
5	41485814	.	A	T	23	33	56	0	0	56	0	0
5	41486025	.	A	G	26	36	62	0	1	63	0	0
5	41486031	.	T	G	27	33	60	0	2	62	0	0
5	41486803	.	G	A	2	3	5	0	1	6	0	0
5	41486890	.	C	T	28	20	48	0	5	53	0	0
5	41488903	.	A	G	21	12	33	0	1	34	0	0
5	41489487	.	G	T	18	16	34	0	4	38	0	0
5	41489493	.	C	T	23	14	37	0	4	41	0	0
5	41489748	.	T	C	7	10	17	0	0	17	0	0
5	41492135	.	C	T	2	2	4	0	0	4	0	0
5	41492183	.	C	T	0	16	16	0	15	31	0	0
5	41492234	.	G	A	22	16	38	0	0	38	0	0
5	41492279	.	G	A	10	9	19	0	0	19	0	0
5	41492901	.	G	A	15	24	39	0	3	42	0	0
5	41492934	.	A	G	11	21	32	0	5	37	0	0
5	41508900	.	C	G	0	1	1	0	0	1	0	0
5	41509101	.	C	T	4	2	6	0	0	6	0	0
5	41513013	.	T	C	5	6	11	0	0	11	0	0
5	41514127	.	A	G	4	4	8	0	0	8	0	0
5	41516322	.	A	C	1	3	4	0	0	4	0	0
5	41516521	.	G	A	6	3	9	0	0	9	0	0
5	41518836	.	T	C	24	15	39	0	0	39	0	0
5	41519423	.	A	C	20	26	46	0	1	47	0	0
5	41519459	.	T	C	13	13	26	0	0	26	0	0
5	41520822	.	A	T	21	23	44	0	1	45	0	0
5	41520823	.	T	C	22	22	44	0	1	45	0	0
5	41559351	.	G	T	1	3	4	0	0	4	0	0
5	41582736	.	G	A	6	3	9	0	0	9	0	0
5	41585126	.	C	T	2	2	4	0	0	4	0	0
5	41585186	.	G	A	7	4	11	0	1	12	0	0
5	41595242	.	C	T	0	1	1	0	0	1	0	0
5	41595243	.	T	C	0	1	1	0	0	1	0	0
5	41597384	.	C	T	0	2	2	0	1	3	0	0
5	41637233	.	G	A	1	2	3	0	0	3	0	0
5	41639787	.	A	T	2	7	9	0	0	9	0	0
5	41639814	.	A	G	4	6	10	0	1	11	0	0
5	41639874	.	G	T	5	4	9	0	1	10	0	0
5	41641750	.	G	A	6	12	18	0	0	18	0	0
5	41641835	.	G	C	12	10	22	0	0	22	0	0
5	41641887	.	A	G	11	9	20	0	0	20	0	0
5	41642167	.	A	G	0	1	1	0	0	1	0	0
5	41642348	.	G	A	2	1	3	0	0	3	0	0
5	41643084	.	A	G	4	3	7	0	0	7	0	0
5	41643095	.	A	G	5	4	9	0	0	9	0	0
5	41643359	.	G	A	0	4	4	0	0	4	0	0
5	41645652	.	A	G	14	18	32	0	1	33	0	0
5	41645815	.	C	G	12	7	19	0	1	20	0	0
5	41645827	.	T	A	13	10	23	0	1	24	0	0
5	41645982	.	A	G	17	12	29	0	1	30	0	0
5	41650451	.	T	C	18	0	18	0	16	34	0	0
5	41655134	.	G	A	0	3	3	0	0	3	0	0
5	41655155	.	T	A	5	7	12	0	0	12	0	0
5	41670193	.	G	A	3	6	9	0	0	9	0	0
5	41676855	.	T	C	2	3	5	0	1	6	0	0
5	41684870	.	A	G	2	4	6	0	0	6	0	0
5	41684885	.	A	T	2	5	7	0	0	7	0	0
5	41691606	.	A	G	0	1	1	0	0	1	0	0
5	41708947	.	C	T	0	2	2	0	0	2	0	0
5	41878612	.	A	C	10	8	18	0	0	18	0	0
5	41878660	.	A	G	14	9	23	0	0	23	0	0
5	41878711	.	C	T	0	12	12	0	13	25	0	0
5	41878965	.	G	C	3	9	12	0	0	12	0	0
5	41879465	.	C	G	10	10	20	0	2	22	0	0
5	41879497	.	T	C	8	7	15	0	1	16	0	0
5	41879848	.	C	A	1	8	9	0	0	9	0	0
5	41880186	.	G	C	2	1	3	0	17	20	0	0
5	41880240	.	T	C	12	1	13	0	14	27	0	0
5	41880243	.	T	C	11	1	12	0	16	28	0	0
5	41880280	.	C	G	18	17	35	0	0	35	0	0
5	41880288	.	G	A	21	11	32	0	1	33	0	0
5	41882364	.	T	C	2	3	5	0	0	5	0	0
5	41888132	.	T	C	6	0	6	0	7	13	0	0
5	41890054	.	G	A	14	11	25	0	1	26	0	0
5	41890092	.	A	G	11	9	20	0	0	20	0	0
5	41890277	.	T	G	1	0	1	0	0	1	0	0
5	41898424	.	A	G	0	3	3	0	0	3	0	0
5	41899006	.	C	G	0	3	3	0	3	6	0	0
5	41899015	.	C	T	0	2	2	0	4	6	0	0
5	41900012	.	A	C	1	0	1	0	0	1	0	0
5	41900020	.	A	G	1	0	1	0	0	1	0	0
5	41900153	.	T	C	2	0	2	0	6	8	0	0
5	41900604	.	C	T	1	3	4	0	0	4	0	0
5	41914647	.	A	G	3	2	5	0	0	5	0	0
5	41914679	.	G	T	3	2	5	0	0	5	0	0
5	41915295	.	G	T	0	1	1	0	0	1	0	0
5	41917306	.	A	G	1	2	3	0	0	3	0	0
5	41917426	.	C	T	3	4	7	0	0	7	0	0
5	41917501	.	G	A	3	3	6	0	0	6	0	0
5	41917544	.	C	T	2	3	5	0	0	5	0	0
5	41984305	.	A	G	2	2	4	0	0	4	0	0
5	42028963	.	C	A	0	1	1	0	0	1	0	0
5	42028974	.	C	T	0	1	1	0	0	1	0	0
5	42053399	.	T	C	3	5	8	0	0	8	0	0
5	42053465	.	G	C	2	6	8	0	0	8	0	0
5	42067447	.	T	C	0	3	3	0	0	3	0	0
5	42122838	.	G	A	2	2	4	0	0	4	0	0
5	42122907	.	C	T	10	10	20	0	1	21	0	0
5	42122914	.	C	T	12	11	23	0	1	24	0	0
5	42123023	.	C	T	24	11	35	0	3	38	0	0
5	42123125	.	C	T	20	18	38	0	3	41	0	0
5	42123375	.	C	A	16	12	28	0	1	29	0	0
5	42123664	.	A	G	7	12	19	0	1	20	0	0
5	42123697	.	G	C	11	21	32	0	0	32	0	0
5	42123766	.	G	T	6	11	17	0	1	18	0	0
5	43073005	.	A	T	5	6	11	0	0	11	0	0
5	43073019	.	T	C	5	6	11	0	0	11	0	0
5	43073116	.	T	C	4	3	7	0	0	7	0	0
5	43082997	.	A	G	12	1	13	0	18	31	0	0
5	43083084	.	A	C	12	9	21	0	1	22	0	0
5	43617277	.	C	G	9	3	12	0	1	13	0	0
5	43617295	.	C	G	11	3	14	0	1	15	0	0
5	43617692	.	T	C	4	0	4	0	12	16	0	0
5	43629881	.	G	C	1	0	1	0	2	3	0	0
5	43629884	.	T	C	1	0	1	0	2	3	0	0
5	43801223	.	T	C	1	0	1	0	0	1	0	0
5	43804475	.	T	C	4	0	4	0	4	8	0	0
5	43807016	.	C	T	2	3	5	0	0	5	0	0
5	43807340	.	T	C	2	1	3	0	0	3	0	0
5	43808206	.	G	A	1	1	2	0	0	2	0	0
5	43808213	.	T	A	1	2	3	0	0	3	0	0
5	43808965	.	T	C	13	8	21	0	1	22	0	0
5	43810302	.	G	A	2	2	4	0	0	4	0	0
5	43813003	.	G	A	1	2	3	0	0	3	0	0
5	43819422	.	T	A	6	16	22	0	0	22	0	0
5	43861561	.	A	T	12	9	21	0	0	21	0	0
5	43861922	.	A	T	7	6	13	0	0	13	0	0
5	43862069	.	C	T	0	7	7	0	6	13	0	0
5	43862449	.	G	A	6	6	12	0	0	12	0	0
5	43862628	.	G	A	9	5	14	0	0	14	0	0
5	43862725	.	T	A	10	3	13	0	0	13	0	0
5	43862924	.	A	G	11	8	19	0	1	20	0	0
5	43862954	.	A	T	9	13	22	0	4	26	0	0
5	43863052	.	C	T	9	6	15	1	1	17	0	0
5	43863222	.	A	T	3	3	6	0	0	6	0	0
5	43863241	.	G	A	3	6	9	0	0	9	0	0
5	43863304	.	T	C	4	5	9	0	0	9	0	0
5	43863315	.	G	A	6	6	12	0	0	12	0	0
5	43864122	.	T	A	3	3	6	0	0	6	0	0
5	43864127	.	C	T	2	3	5	0	1	6	0	0
5	43864907	.	G	A	0	2	2	0	0	2	0	0
5	43866804	.	T	G	4	6	10	0	0	10	0	0
5	43867013	.	A	C	1	3	4	0	0	4	0	0
5	43893543	.	C	T	2	2	4	0	0	4	0	0
5	43893744	.	C	T	0	2	2	0	0	2	0	0
5	43893750	.	C	T	0	2	2	0	0	2	0	0
5	44235994	.	A	T	4	4	8	0	1	9	0	0
5	44238706	.	G	A	2	0	2	0	0	2	0	0
5	44262756	.	C	G	6	3	9	0	1	10	0	0
5	44262935	.	A	G	1	3	4	0	0	4	0	0
5	44263024	.	T	A	3	12	15	0	0	15	0	0
5	44263078	.	A	T	4	11	15	0	0	15	0	0
5	44263204	.	C	A	15	11	26	0	0	26	0	0
5	44263851	.	T	A	8	6	14	0	2	16	0	0
5	44354265	.	C	A	0	1	1	0	0	1	0	0
5	44365957	.	T	A	0	1	1	0	0	1	0	0
5	44366090	.	G	A	2	3	5	0	0	5	0	0
5	44370681	.	A	G	5	1	6	0	11	17	0	0
5	44370828	.	C	T	13	10	23	0	2	25	0	0
5	44370910	.	C	T	7	15	22	0	0	22	0	0
5	44370943	.	G	A	4	9	13	0	1	14	0	0
5	44370998	.	G	A	6	13	19	0	0	19	0	0
5	44371043	.	C	T	8	5	13	0	0	13	0	0
5	44494998	.	T	A	3	4	7	0	0	7	0	0
5	44495224	.	A	T	4	2	6	0	2	8	0	0
5	44495275	.	A	T	3	7	10	0	0	10	0	0
5	44495363	.	A	C	2	7	9	0	0	9	0	0
5	44495377	.	C	T	1	7	8	0	0	8	0	0
5	44495822	.	G	A	4	2	6	0	0	6	0	0
5	44496434	.	T	C	3	4	7	0	2	9	0	0
5	44496692	.	T	A	1	4	5	0	0	5	0	0
5	44754973	.	A	C	1	2	3	0	0	3	0	0
5	44757992	.	C	T	3	2	5	0	0	5	0	0
5	44778273	.	T	C	1	0	1	0	0	1	0	0
5	44778279	.	G	C	1	0	1	0	0	1	0	0
5	44778893	.	A	G	3	0	3	0	0	3	0	0
5	44794455	.	G	A	7	9	16	0	0	16	0	0
5	44794459	.	T	G	8	0	8	0	10	18	0	0
5	44794606	.	C	G	7	12	19	0	0	19	0	0
5	44794613	.	G	T	0	12	12	0	6	18	0	0
5	44794816	.	C	T	6	10	16	0	0	16	0	0
5	44794955	.	A	C	7	6	13	0	1	14	0	0
5	44794969	.	A	G	6	7	13	0	0	13	0	0
5	44795162	.	G	A	7	3	10	0	0	10	0	0
5	44795297	.	A	G	9	0	9	0	18	27	0	0
5	44795308	.	A	G	12	14	26	0	1	27	0	0
5	44795467	.	T	G	21	8	29	0	1	30	0	0
5	44795468	.	A	T	20	9	29	0	1	30	0	0
5	44795598	.	G	A	1	8	9	0	13	22	0	0
5	44806446	.	G	A	13	6	19	0	1	20	0	0
5	44808520	.	T	G	1	1	2	0	0	2	0	0
5	44808553	.	C	T	7	10	17	0	1	18	0	0
5	44810341	.	T	C	10	1	11	0	1	12	0	0
5	44833783	.	A	T	2	3	5	0	0	5	0	0
5	44920250	.	G	A	0	1	1	0	2	3	0	0
5	44920591	.	G	A	1	2	3	0	0	3	0	0
5	44920592	.	A	C	1	2	3	0	0	3	0	0
5	44930071	.	G	A	1	2	3	0	0	3	0	0
5	44935952	.	C	T	4	2	6	0	0	6	0	0
5	45204118	.	C	T	4	7	11	0	0	11	0	0
5	45204175	.	G	A	1	2	3	0	0	3	0	0
5	45220330	.	A	G	4	2	6	0	0	6	0	0
5	45230659	.	C	A	3	3	6	0	0	6	0	0
5	45261926	.	C	T	2	5	7	0	2	9	0	0
5	45268941	.	C	T	1	0	1	0	0	1	0	0
5	45271966	.	C	A	2	2	4	0	2	6	0	0
5	45274429	.	G	A	11	5	16	0	0	16	0	0
5	45274486	.	C	T	8	6	14	0	2	16	0	0
5	45282910	.	G	A	2	12	14	0	0	14	0	0
5	45283046	.	G	T	3	8	11	0	2	13	0	0
5	45283446	.	A	G	10	7	17	0	0	17	0	0
5	45283654	.	T	C	6	5	11	0	0	11	0	0
5	45613585	.	T	C	3	2	5	0	0	5	0	0
5	45747924	.	A	T	7	3	10	0	0	10	0	0
5	45748025	.	A	C	3	5	8	0	0	8	0	0
5	45748172	.	T	A	0	3	3	0	0	3	0	0
5	45748313	.	G	A	6	3	9	0	1	10	0	0
5	45748528	.	T	C	3	3	6	0	0	6	0	0
5	45748545	.	T	A	3	6	9	0	0	9	0	0
5	45748563	.	C	T	6	7	13	0	0	13	0	0
5	45748627	.	A	C	5	0	5	0	5	10	0	0
5	45748672	.	G	T	3	3	6	0	0	6	0	0
5	45748726	.	A	C	5	0	5	0	7	12	0	0
5	45751208	.	C	T	0	1	1	0	2	3	0	0
5	45754818	.	C	T	5	3	8	0	0	8	0	0
5	45754851	.	A	G	9	9	18	0	1	19	0	0
5	45757617	.	A	G	1	3	4	0	0	4	0	0
5	45757644	.	A	G	2	6	8	0	0	8	0	0
5	45757731	.	A	G	1	2	3	0	0	3	0	0
5	45781987	.	C	T	0	2	2	0	1	3	0	0
5	45890074	.	C	T	0	10	10	0	4	14	0	0
5	45890086	.	A	T	3	11	14	0	0	14	0	0
5	45890159	.	A	G	6	5	11	0	1	12	0	0
5	45890195	.	A	G	6	9	15	0	2	17	0	0
5	45890219	.	A	T	8	11	19	0	1	20	0	0
5	45890663	.	T	A	13	13	26	0	0	26	0	0
5	45891090	.	A	G	8	8	16	0	0	16	0	0
5	45891226	.	T	A	11	10	21	0	0	21	0	0
5	45891327	.	G	T	14	12	26	0	0	26	0	0
5	45891431	.	C	T	3	4	7	0	0	7	0	0
5	45894547	.	G	A	6	5	11	0	0	11	0	0
5	45894560	.	G	C	5	4	9	0	0	9	0	0
5	45894619	.	A	G	5	5	10	0	0	10	0	0
5	45894699	.	C	T	9	5	14	0	1	15	0	0
5	45894720	.	T	C	13	9	22	0	0	22	0	0
5	45894737	.	T	C	13	7	20	0	0	20	0	0
5	45900422	.	T	G	0	1	1	0	0	1	0	0
5	45902041	.	A	C	0	0	0	0	1	1	0	0
5	45910811	.	G	A	0	2	2	0	1	3	0	0
5	45910838	.	G	T	3	3	6	0	0	6	0	0
5	45914359	.	G	T	1	2	3	0	1	4	0	0
5	46066228	.	A	G	0	0	0	0	1	1	0	0
5	46328215	.	C	T	8	4	12	0	2	14	0	0
5	46328218	.	A	T	9	4	13	0	1	14	0	0
5	46328314	.	C	T	6	8	14	0	0	14	0	0
5	46328476	.	T	C	3	0	3	0	4	7	0	0
5	46328611	.	C	T	5	5	10	0	2	12	0	0
5	46328758	.	C	T	5	3	8	0	0	8	0	0
5	46328797	.	G	A	4	2	6	0	1	7	0	0
5	46491059	.	C	G	4	2	6	0	0	6	0	0
5	46659401	.	A	G	18	31	49	0	1	50	0	0
5	46659666	.	T	A	29	18	47	0	4	51	0	0
5	46659707	.	C	A	39	22	61	0	0	61	0	0
5	46659861	.	G	A	19	21	40	0	3	43	0	0
5	46659984	.	A	G	21	31	52	0	2	54	0	0
5	46659985	.	A	G	20	31	51	0	3	54	0	0
5	46660068	.	C	T	8	25	33	0	4	37	0	0
5	46660120	.	A	G	7	21	28	0	1	29	0	0
5	46660201	.	A	G	21	18	39	0	1	40	0	0
5	46660259	.	T	C	14	28	42	0	3	45	0	0
5	46660541	.	T	C	24	17	41	0	2	43	0	0
5	46660577	.	T	C	20	4	24	1	0	29	4	0
5	46660600	.	T	A	23	9	32	1	0	33	0	0
5	46660672	.	G	A	16	17	33	0	3	36	0	0
5	46660681	.	A	G	17	15	32	0	0	32	0	0
5	46660727	.	T	C	13	10	23	0	3	26	0	0
5	46660735	.	G	C	13	12	25	0	4	29	0	0
5	46660780	.	A	G	20	23	43	0	4	47	0	0
5	46660819	.	A	G	26	20	46	0	0	46	0	0
5	46660906	.	A	G	15	21	36	0	0	36	0	0
5	46660941	.	A	T	11	22	33	0	2	36	1	0
5	46661006	.	A	T	10	13	23	0	1	24	0	0
5	46661157	.	A	T	4	6	10	0	0	10	0	0
5	46661240	.	A	G	13	11	24	0	0	24	0	0
5	46661348	.	G	C	17	20	37	0	0	37	0	0
5	46661349	.	G	A	17	18	35	0	2	37	0	0
5	46661418	.	T	C	23	19	42	0	4	46	0	0
5	46661423	.	T	C	27	0	27	0	20	47	0	0
5	46661519	.	C	T	15	15	30	0	0	30	0	0
5	46661678	.	T	A	5	3	8	0	0	8	0	0
5	46724854	.	G	A	12	9	21	0	0	21	0	0
5	46808477	.	A	G	1	1	2	0	0	2	0	0
5	46808567	.	G	A	2	0	2	0	0	2	0	0
5	46868923	.	A	G	5	5	10	0	1	11	0	0
5	47862761	.	T	C	1	4	5	0	0	5	0	0
5	47924339	.	G	C	1	1	2	0	0	2	0	0
5	47959994	.	C	A	0	1	1	0	2	3	0	0
5	47968970	.	C	T	1	1	2	0	0	2	0	0
5	47972770	.	T	C	2	0	2	0	4	6	0	0
5	47973386	.	T	G	0	1	1	0	0	1	0	0
5	47976525	.	C	T	1	6	7	0	0	7	0	0
5	47976728	.	C	G	6	5	11	0	1	12	0	0
5	47976747	.	C	A	8	3	11	0	0	11	0	0
5	47976827	.	A	G	4	3	7	0	0	7	0	0
5	48022826	.	G	A	0	2	2	0	3	5	0	0
5	48022939	.	G	A	5	2	7	0	0	7	0	0
5	48023209	.	C	T	6	3	9	0	0	9	0	0
5	48028112	.	G	A	4	5	9	0	0	9	0	0
5	48028338	.	C	A	0	5	5	0	1	6	0	0
5	48028406	.	A	C	10	13	23	0	0	23	0	0
5	48028435	.	G	T	10	9	19	0	0	19	0	0
5	48028508	.	T	C	12	7	19	0	0	19	0	0
5	48029490	.	T	A	5	5	10	0	2	12	0	0
5	48029510	.	C	A	2	4	6	0	1	7	0	0
5	48050510	.	C	A	0	1	1	0	0	2	1	0
5	48110331	.	G	A	8	15	23	0	0	23	0	0
5	48154436	.	G	A	1	1	2	0	0	2	0	0
5	48154456	.	T	A	1	1	2	0	0	2	0	0
5	48172446	.	C	A	0	2	2	0	5	7	0	0
5	48182021	.	A	G	7	8	15	0	0	15	0	0
5	48182030	.	T	C	8	1	9	0	10	19	0	0
5	48182066	.	C	G	16	8	24	0	3	27	0	0
5	48182216	.	A	G	5	4	9	0	0	9	0	0
5	48182334	.	A	G	5	5	10	0	0	10	0	0
5	48182550	.	A	T	9	8	17	0	0	17	0	0
5	48183414	.	T	C	6	0	6	0	7	13	0	0
5	48183577	.	C	T	0	7	7	0	17	24	0	0
5	48183579	.	A	G	15	8	23	0	1	24	0	0
5	48183628	.	T	C	11	0	11	0	13	24	0	0
5	48188963	.	A	G	6	8	14	0	0	14	0	0
5	48205945	.	T	A	0	0	0	0	1	1	0	0
5	48208539	.	G	A	5	3	8	0	0	8	0	0
5	48242529	.	T	G	2	0	2	0	0	2	0	0
5	48242610	.	G	A	7	3	10	0	0	10	0	0
5	48285619	.	C	T	3	2	5	0	0	5	0	0
5	48285629	.	A	G	7	1	8	0	0	8	0	0
5	48664229	.	T	C	2	3	5	0	1	6	0	0
5	48672740	.	G	A	11	5	16	0	0	16	0	0
5	48672752	.	C	T	0	10	10	0	6	16	0	0
5	48672925	.	A	T	5	3	8	0	0	8	0	0
5	48672970	.	G	A	5	5	10	0	0	10	0	0
5	48673501	.	A	G	8	5	13	0	1	14	0	0
5	48673639	.	C	A	0	8	8	0	4	12	0	0
5	48679320	.	A	G	0	1	1	0	0	1	0	0
5	48679428	.	A	T	5	3	8	0	2	10	0	0
5	48841813	.	T	C	1	3	4	0	0	4	0	0
5	48841822	.	T	C	1	3	4	0	0	4	0	0
5	48888269	.	G	A	1	1	2	0	0	2	0	0
5	48899697	.	C	G	0	0	0	0	4	4	0	0
5	48929274	.	G	A	0	1	1	0	1	2	0	0
5	48936023	.	T	G	1	2	3	0	1	4	0	0
5	48939864	.	A	G	3	0	3	0	2	5	0	0
5	48940038	.	C	T	1	3	4	0	0	4	0	0
5	48986593	.	A	G	12	39	51	0	1	52	0	0
5	48986937	.	T	C	0	12	12	0	30	42	0	0
5	48987007	.	A	T	33	11	44	0	3	47	0	0
5	48987772	.	G	A	27	11	38	2	2	42	0	0
5	48987920	.	T	C	29	8	37	0	3	40	0	0
5	48988084	.	A	G	1	0	1	0	0	1	0	0
5	48992401	.	T	C	18	1	19	0	9	28	0	0
5	48993345	.	T	C	3	0	3	0	0	3	0	0
5	48995559	.	A	T	7	7	14	0	0	14	0	0
5	48995613	.	A	G	5	9	14	0	1	15	0	0
5	48995637	.	A	T	9	11	20	0	2	22	0	0
5	48995884	.	G	A	9	13	22	0	1	23	0	0
5	48995945	.	G	A	4	13	17	0	0	17	0	0
5	49019528	.	T	C	1	2	3	0	0	3	0	0
5	49019572	.	G	T	2	6	8	0	0	8	0	0
5	49019744	.	A	T	1	4	5	0	0	5	0	0
5	49019746	.	C	A	1	4	5	0	0	5	0	0
5	49019821	.	T	A	1	2	3	0	1	4	0	0
5	49019865	.	C	T	4	2	6	0	1	7	0	0
5	49019880	.	G	T	3	3	6	0	0	6	0	0
5	49020028	.	G	A	1	2	3	0	0	3	0	0
5	49020032	.	C	T	0	1	1	0	2	3	0	0
5	49020066	.	A	T	4	2	6	0	0	6	0	0
5	49020200	.	T	A	2	5	7	0	2	9	0	0
5	49020221	.	G	C	2	0	2	0	3	5	0	0
5	49021461	.	C	T	1	5	6	0	0	6	0	0
5	49734545	.	G	A	1	5	6	0	1	7	0	0
5	49734581	.	C	T	8	3	11	0	1	12	0	0
5	49734682	.	C	A	5	8	13	0	0	13	0	0
5	49734751	.	T	G	3	6	9	0	3	12	0	0
5	49734889	.	C	T	7	2	9	0	0	9	0	0
5	49735022	.	G	T	1	5	6	0	1	7	0	0
5	49735135	.	C	A	5	3	8	0	0	8	0	0
5	49735721	.	T	A	1	3	4	0	0	4	0	0
5	49735722	.	C	T	1	3	4	0	0	4	0	0
5	49735942	.	T	G	5	6	11	0	0	11	0	0
5	49743020	.	A	T	0	1	1	0	0	1	0	0
5	49745130	.	T	A	9	6	15	0	0	15	0	0
5	49747271	.	G	T	0	13	13	0	16	29	0	0
5	49750796	.	A	C	8	14	22	0	0	22	0	0
5	49750834	.	A	C	12	9	21	0	3	25	1	0
5	49755368	.	G	C	4	3	7	0	0	7	0	0
5	49768324	.	G	T	2	3	5	0	0	5	0	0
5	49768429	.	A	T	3	2	5	0	1	6	0	0
5	49768707	.	G	T	4	3	7	0	1	8	0	0
5	49768774	.	C	G	2	3	5	0	0	5	0	0
5	49768885	.	T	C	1	2	3	0	0	3	0	0
5	49768977	.	A	G	4	3	7	0	0	7	0	0
5	49769217	.	A	G	2	2	4	0	0	4	0	0
5	49769277	.	G	T	4	5	9	0	0	9	0	0
5	49769345	.	G	T	7	4	11	0	1	12	0	0
5	49769485	.	A	G	5	3	8	0	0	8	0	0
5	49769665	.	T	A	4	6	10	0	0	10	0	0
5	49769812	.	A	T	4	5	9	0	0	9	0	0
5	49773649	.	C	T	4	7	11	0	0	11	0	0
5	49919762	.	G	A	4	1	5	0	0	5	0	0
5	49919774	.	T	A	1	6	7	0	0	7	0	0
5	49951020	.	C	A	0	2	2	0	1	3	0	0
5	50035819	.	A	C	2	0	2	0	2	4	0	0
5	50035831	.	G	A	2	2	4	0	0	4	0	0
5	50081761	.	T	C	0	0	0	0	1	1	0	0
5	50081865	.	T	A	2	1	3	0	0	3	0	0
5	50256257	.	C	T	2	2	4	0	0	4	0	0
5	50256327	.	T	G	4	2	6	0	0	6	0	0
5	50256351	.	T	C	2	2	4	0	0	4	0	0
5	50296705	.	A	T	1	2	3	0	0	3	0	0
5	50296731	.	C	T	1	2	3	0	0	3	0	0
5	50397521	.	C	T	0	1	1	0	0	1	0	0
5	50405911	.	C	T	1	2	3	0	0	3	0	0
5	50405932	.	G	A	1	3	4	0	0	4	0	0
5	50405947	.	A	G	1	0	1	0	2	3	0	0
5	50407324	.	T	C	1	1	2	0	1	3	0	0
5	50436015	.	C	G	6	5	11	0	1	12	0	0
5	50436038	.	C	A	5	7	12	0	0	12	0	0
5	50436069	.	C	T	5	3	8	0	0	8	0	0
5	50443077	.	T	C	14	15	29	0	4	33	0	0
5	50443184	.	A	G	11	14	25	0	1	26	0	0
5	50443211	.	C	A	11	9	20	0	0	20	0	0
5	50443399	.	G	C	21	10	31	0	0	31	0	0
5	50443418	.	T	A	14	22	36	0	0	36	0	0
5	50443466	.	A	G	13	20	33	0	0	33	0	0
5	50520009	.	G	A	4	5	9	0	1	10	0	0
5	50520057	.	C	A	0	3	3	0	0	3	0	0
5	50544281	.	T	C	2	4	6	0	0	6	0	0
5	50576705	.	A	G	2	3	5	0	1	6	0	0
5	50582271	.	G	A	3	1	4	0	0	4	0	0
5	50582482	.	T	G	2	1	3	0	0	3	0	0
5	50636066	.	C	T	0	0	0	0	4	4	0	0
5	50781069	.	G	A	1	1	2	0	3	5	0	0
5	50817403	.	C	T	3	3	6	0	0	6	0	0
5	50817414	.	C	T	3	3	6	0	0	6	0	0
5	50819775	.	C	T	0	2	2	0	0	2	0	0
5	50819811	.	G	A	1	4	5	0	0	5	0	0
5	50819861	.	A	G	2	7	9	0	0	9	0	0
5	50840669	.	G	T	1	3	4	0	0	4	0	0
5	50840893	.	A	G	0	0	0	0	1	1	0	0
5	50843442	.	G	A	1	1	2	0	0	2	0	0
5	50879164	.	G	A	0	4	4	0	0	4	0	0
5	50886309	.	C	T	1	0	1	0	0	1	0	0
5	50893082	.	A	G	1	0	1	0	1	2	0	0
5	50893654	.	C	T	1	1	2	0	0	2	0	0
5	50895544	.	C	T	2	1	3	0	1	4	0	0
5	50895606	.	C	T	0	1	1	0	0	1	0	0
5	50896056	.	C	T	3	5	8	0	0	8	0	0
5	50897509	.	C	T	5	5	10	0	0	10	0	0
5	50897528	.	C	A	1	4	5	0	1	6	0	0
5	50960348	.	G	A	2	0	2	0	0	2	0	0
5	50960402	.	C	A	0	4	4	0	0	4	0	0
5	50963250	.	C	G	0	2	2	0	0	2	0	0
5	50970249	.	T	G	1	1	2	0	0	2	0	0
5	50973014	.	C	T	2	2	4	0	0	4	0	0
5	50973039	.	C	T	6	3	9	0	0	9	0	0
5	50973471	.	C	G	3	5	8	0	0	8	0	0
5	50973518	.	A	C	8	9	17	0	0	17	0	0
5	50973625	.	A	T	1	7	8	0	0	8	0	0
5	50973748	.	C	T	2	6	8	0	1	9	0	0
5	50976624	.	C	T	0	1	1	0	2	3	0	0
5	50981123	.	C	T	0	4	4	0	3	7	0	0
5	51096280	.	A	G	2	2	4	0	0	4	0	0
5	51096285	.	G	C	2	2	4	0	0	4	0	0
5	51102044	.	T	C	4	3	7	0	0	7	0	0
5	51102315	.	G	A	1	3	4	0	0	4	0	0
5	51102602	.	T	G	2	2	4	0	0	4	0	0
5	51102828	.	G	A	3	4	7	0	1	8	0	0
5	51103006	.	T	C	3	4	7	0	0	7	0	0
5	51103007	.	T	C	4	3	7	0	0	7	0	0
5	51103550	.	G	A	4	6	10	0	0	10	0	0
5	51103717	.	T	C	2	2	4	0	0	4	0	0
5	51103904	.	A	T	3	3	6	0	1	7	0	0
5	51103944	.	A	T	5	2	7	0	0	7	0	0
5	51104151	.	G	A	4	6	10	0	0	10	0	0
5	51104458	.	G	T	4	2	6	0	0	6	0	0
5	51111786	.	G	A	1	1	2	0	0	2	0	0
5	51124019	.	G	A	2	7	9	0	0	9	0	0
5	51126885	.	A	T	5	1	6	0	0	6	0	0
5	51127305	.	A	T	5	2	7	0	0	7	0	0
5	51127335	.	C	T	1	5	6	0	0	6	0	0
5	51127348	.	C	T	5	1	6	0	0	6	0	0
5	51127396	.	C	G	4	5	9	0	0	9	0	0
5	51127467	.	C	A	9	8	17	0	0	17	0	0
5	51127538	.	C	G	4	0	4	0	4	8	0	0
5	51127672	.	C	G	3	2	5	0	0	5	0	0
5	51127718	.	T	A	3	4	7	0	0	7	0	0
5	51169022	.	G	T	3	3	6	0	0	6	0	0
5	51169167	.	T	G	1	2	3	0	0	3	0	0
5	51169354	.	A	T	4	3	7	0	1	8	0	0
5	51169376	.	T	C	5	0	5	0	4	9	0	0
5	51169732	.	G	A	1	7	8	0	0	8	0	0
5	51169749	.	C	T	1	5	6	0	1	7	0	0
5	51169858	.	T	C	3	3	6	0	1	7	0	0
5	51169859	.	T	A	2	4	6	0	1	7	0	0
5	51170048	.	C	T	4	5	9	0	0	9	0	0
5	51170113	.	G	A	6	2	8	0	0	8	0	0
5	51170171	.	T	C	3	7	10	0	0	10	0	0
5	51170375	.	C	T	3	6	9	0	0	9	0	0
5	51170694	.	G	A	2	2	4	0	0	4	0	0
5	51171189	.	G	A	1	2	3	0	2	5	0	0
5	51171202	.	T	A	1	3	4	0	1	5	0	0
5	51200429	.	G	A	2	1	3	0	1	4	0	0
5	51200441	.	A	T	2	2	4	0	0	4	0	0
5	51200697	.	G	A	2	1	3	0	0	3	0	0
5	51202374	.	T	A	0	1	1	0	0	1	0	0
5	51202938	.	G	A	2	5	7	0	0	7	0	0
5	51203146	.	C	T	1	0	1	0	0	1	0	0
5	51205439	.	G	T	3	4	7	0	0	7	0	0
5	51205593	.	G	A	3	1	4	0	0	4	0	0
5	51209048	.	G	A	1	2	3	0	0	3	0	0
5	51227011	.	T	A	6	3	9	0	0	9	0	0
5	51227197	.	C	T	3	5	8	0	0	8	0	0
5	51228496	.	C	A	3	2	5	0	1	6	0	0
5	51228926	.	T	C	0	1	1	0	0	1	0	0
5	51230901	.	T	C	1	3	4	0	0	4	0	0
5	51232024	.	G	A	3	3	6	0	0	6	0	0
5	51236474	.	A	T	1	2	3	0	0	3	0	0
5	51240679	.	A	G	5	2	7	0	0	7	0	0
5	51240711	.	C	T	2	4	6	0	0	6	0	0
5	51240830	.	T	C	3	4	7	0	0	7	0	0
5	51241023	.	A	G	4	7	11	0	1	12	0	0
5	51241046	.	T	C	7	9	16	0	1	17	0	0
5	51241095	.	C	T	7	4	11	0	0	11	0	0
5	51241422	.	T	C	2	4	6	0	0	6	0	0
5	51241663	.	G	A	1	1	2	0	1	3	0	0
5	51242049	.	A	C	3	3	6	0	0	6	0	0
5	51242489	.	A	G	3	0	3	0	10	13	0	0
5	51242882	.	A	G	12	11	23	0	0	23	0	0
5	51243106	.	A	G	12	6	18	0	0	18	0	0
5	51243287	.	G	A	11	8	19	0	0	19	0	0
5	51243302	.	A	C	8	7	15	0	1	16	0	0
5	51243341	.	G	A	9	5	14	0	1	15	0	0
5	51360567	.	C	T	2	1	3	0	0	3	0	0
5	51360591	.	C	T	1	2	3	0	1	4	0	0
5	51425579	.	C	A	1	1	2	0	0	2	0	0
5	51548092	.	C	T	3	2	5	0	0	5	0	0
5	51548398	.	A	T	0	3	3	0	0	3	0	0
5	51548408	.	A	C	0	2	2	0	0	2	0	0
5	51571150	.	A	G	2	1	3	0	0	3	0	0
5	51575586	.	C	T	0	1	1	0	0	1	0	0
5	51578289	.	A	G	1	0	1	0	3	4	0	0
5	51579076	.	C	T	1	1	2	0	0	2	0	0
5	51616474	.	A	T	2	7	9	0	0	9	0	0
5	51617022	.	T	C	11	7	18	0	2	20	0	0
5	51775052	.	A	G	6	7	13	0	0	13	0	0
5	51775291	.	A	T	19	14	33	0	1	34	0	0
5	51775391	.	A	G	15	18	33	0	1	34	0	0
5	51775458	.	A	C	23	11	34	0	0	34	0	0
5	51775501	.	T	G	16	18	34	0	3	37	0	0
5	51775805	.	A	G	26	15	41	0	2	43	0	0
5	51775837	.	G	C	16	16	32	0	2	34	0	0
5	51775962	.	G	T	15	9	24	0	3	27	0	0
5	51775997	.	A	T	19	11	30	0	2	32	0	0
5	51776150	.	C	A	15	9	24	0	0	24	0	0
5	51779513	.	C	T	4	2	6	0	0	6	0	0
5	51789180	.	C	T	1	3	4	0	4	8	0	0
5	51789264	.	T	G	11	8	19	0	2	21	0	0
5	51789286	.	A	T	9	4	13	0	0	13	0	0
5	51789428	.	A	G	4	6	10	0	0	10	0	0
5	51789453	.	T	C	2	3	5	0	1	6	0	0
5	51835998	.	T	A	1	0	1	0	0	1	0	0
5	51840420	.	C	T	0	1	1	0	0	1	0	0
5	51846285	.	C	A	0	2	2	0	0	2	0	0
5	51847274	.	T	C	1	0	1	0	0	1	0	0
5	51847429	.	T	C	3	4	7	0	1	8	0	0
5	51847675	.	C	G	1	3	4	0	0	4	0	0
5	51894040	.	T	C	4	3	7	0	1	8	0	0
5	51898796	.	C	T	0	2	2	0	2	4	0	0
5	51898933	.	C	G	1	1	2	0	0	2	0	0
5	51932684	.	T	C	1	3	4	0	0	4	0	0
5	51932690	.	C	T	1	3	4	0	0	4	0	0
5	51935005	.	T	C	1	1	2	0	0	2	0	0
5	51935050	.	T	C	3	1	4	0	0	4	0	0
5	51947370	.	G	T	9	5	14	0	1	15	0	0
5	51947497	.	C	T	18	13	31	0	0	31	0	0
5	51947551	.	T	C	12	12	24	0	1	25	0	0
5	51947650	.	T	C	9	12	21	0	1	22	0	0
5	51947696	.	A	T	10	10	20	0	1	21	0	0
5	51947770	.	T	G	8	8	16	0	3	19	0	0
5	51947976	.	C	G	1	2	3	1	0	4	0	0
5	51948017	.	G	T	5	3	8	0	0	8	0	0
5	51948076	.	G	A	5	3	8	0	0	8	0	0
5	51948389	.	A	T	13	11	24	0	0	24	0	0
5	51948436	.	G	T	6	5	11	0	0	11	0	0
5	51948461	.	G	A	1	5	6	0	1	7	0	0
5	51948490	.	C	A	1	4	5	0	1	6	0	0
5	51948498	.	T	C	1	4	5	0	0	5	0	0
5	51948708	.	A	T	5	3	8	0	1	9	0	0
5	51948737	.	C	T	0	7	7	0	3	10	0	0
5	51948755	.	C	A	5	5	10	0	0	10	0	0
5	51948919	.	G	A	13	10	23	0	0	23	0	0
5	51948946	.	T	C	15	0	15	0	14	29	0	0
5	51949069	.	T	A	9	12	21	0	0	21	0	0
5	51949071	.	T	A	8	12	20	0	1	21	0	0
5	51949306	.	T	A	3	3	6	0	0	6	0	0
5	51949896	.	G	A	5	2	7	0	0	7	0	0
5	51950032	.	G	C	8	6	14	0	0	14	0	0
5	51958296	.	T	A	5	3	8	0	0	8	0	0
5	51958596	.	G	A	1	2	3	0	0	3	0	0
5	51985355	.	G	A	2	2	4	0	0	4	0	0
5	52002660	.	T	G	6	2	8	0	3	11	0	0
5	52002708	.	T	C	9	5	14	0	2	16	0	0
5	52002743	.	T	G	2	3	5	0	0	5	0	0
5	52008556	.	T	A	1	5	6	0	0	6	0	0
5	52010104	.	T	C	1	2	3	0	1	4	0	0
5	52010123	.	A	T	0	3	3	0	0	3	0	0
5	52068001	.	T	C	2	5	7	0	0	7	0	0
5	52068422	.	C	T	1	4	5	0	0	5	0	0
5	52068452	.	G	A	0	3	3	0	0	3	0	0
5	52121517	.	T	C	1	2	3	0	0	3	0	0
5	52121725	.	C	T	0	2	2	0	0	2	0	0
5	52121759	.	A	G	2	1	3	0	0	3	0	0
5	52121801	.	G	C	1	2	3	0	0	3	0	0
5	52122057	.	C	G	2	0	2	0	2	4	0	0
5	52122855	.	T	C	5	2	7	0	0	7	0	0
5	52123640	.	G	T	3	6	9	0	0	9	0	0
5	52124734	.	A	G	7	5	12	0	1	13	0	0
5	52132498	.	A	T	1	1	2	0	0	2	0	0
5	52132561	.	C	T	6	4	10	0	0	10	0	0
5	52132966	.	A	G	7	8	15	0	0	15	0	0
5	52190877	.	A	C	5	3	8	0	0	8	0	0
5	52190969	.	A	G	3	3	6	0	0	6	0	0
5	52191185	.	G	T	4	10	14	0	1	15	0	0
5	52191212	.	A	G	0	9	9	0	3	12	0	0
5	52191263	.	T	C	6	4	10	0	0	10	0	0
5	52191288	.	C	A	7	5	12	0	0	12	0	0
5	52191499	.	G	A	4	2	6	0	0	6	0	0
5	52191758	.	C	T	3	8	11	0	1	12	0	0
5	52191987	.	A	G	6	4	10	0	0	10	0	0
5	52192032	.	T	G	3	5	8	0	0	8	0	0
5	52192572	.	T	C	0	6	6	0	1	7	0	0
5	52192603	.	G	A	1	2	3	0	0	3	0	0
5	52193066	.	C	T	2	3	5	0	2	7	0	0
5	52193240	.	A	T	1	5	6	0	2	8	0	0
5	52193283	.	T	C	1	0	1	0	4	5	0	0
5	52193817	.	A	G	0	1	1	0	0	1	0	0
5	52197793	.	C	T	1	1	2	0	0	2	0	0
5	52198066	.	G	A	5	2	7	0	0	7	0	0
5	52201458	.	T	C	0	0	0	0	1	1	0	0
5	52227660	.	T	A	3	3	6	0	0	6	0	0
5	52234708	.	A	G	2	6	8	0	0	8	0	0
5	52234729	.	G	A	5	3	8	0	0	8	0	0
5	52235385	.	C	T	1	2	3	0	0	3	0	0
5	52236775	.	G	T	1	0	1	0	0	1	0	0
5	52240005	.	C	T	0	1	1	0	1	2	0	0
5	52240449	.	C	A	2	3	5	0	0	5	0	0
5	52242924	.	C	G	0	2	2	0	2	4	0	0
5	52257106	.	A	C	7	0	7	0	8	15	0	0
5	52257299	.	G	A	8	10	18	0	0	18	0	0
5	52257463	.	T	C	9	15	24	0	4	28	0	0
5	52257530	.	A	G	15	14	29	0	1	30	0	0
5	52257976	.	G	T	16	7	23	0	1	25	1	0
5	52258036	.	G	A	15	8	23	0	0	23	0	0
5	52258234	.	G	A	10	11	21	0	0	21	0	0
5	52258464	.	T	C	8	0	8	0	9	17	0	0
5	52258653	.	C	G	5	5	10	0	0	10	0	0
5	52258701	.	A	T	5	5	10	0	2	12	0	0
5	52258703	.	G	A	6	4	10	0	2	12	0	0
5	52258921	.	T	G	2	6	8	0	1	9	0	0
5	52258945	.	A	G	11	3	14	0	0	14	0	0
5	52259221	.	T	A	8	7	15	0	1	16	0	0
5	52259289	.	A	G	10	5	15	0	0	15	0	0
5	52259542	.	G	C	9	0	9	0	6	15	0	0
5	52259579	.	A	T	7	8	15	0	0	15	0	0
5	52259887	.	G	A	9	8	17	0	0	17	0	0
5	52264354	.	C	T	0	6	6	0	5	11	0	0
5	52264456	.	C	G	0	10	10	0	8	18	0	0
5	52264512	.	G	A	5	3	8	0	0	8	0	0
5	52264549	.	C	T	5	8	13	0	0	13	0	0
5	52264654	.	C	G	0	9	9	0	4	13	0	0
5	52277390	.	G	A	5	8	13	0	0	13	0	0
5	52277487	.	T	A	4	4	8	0	0	8	0	0
5	52277574	.	G	A	8	4	12	0	0	12	0	0
5	52598377	.	C	T	1	0	1	0	0	1	0	0
5	52608696	.	G	A	3	7	10	0	0	10	0	0
5	52621663	.	A	C	6	4	10	0	1	11	0	0
5	52621885	.	T	C	1	5	6	0	0	6	0	0
5	52696879	.	C	T	4	7	11	0	0	11	0	0
5	52697519	.	A	C	9	6	15	0	0	15	0	0
5	52710951	.	A	G	2	0	2	0	0	2	0	0
5	52710957	.	G	A	2	0	2	0	0	2	0	0
5	52730540	.	C	T	10	5	15	0	0	15	0	0
5	52730645	.	C	T	3	3	6	0	1	7	0	0
5	52730704	.	C	T	4	4	8	0	0	8	0	0
5	52730742	.	G	C	6	2	8	0	0	8	0	0
5	52730793	.	G	A	0	6	6	0	0	6	0	0
5	52730846	.	C	A	4	4	8	0	0	8	0	0
5	52730988	.	C	G	2	0	2	0	3	5	0	0
5	52731647	.	G	A	0	9	9	0	10	19	0	0
5	52731664	.	C	T	10	9	19	0	0	19	0	0
5	52731787	.	G	A	7	7	14	0	0	14	0	0
5	52731845	.	T	C	11	7	18	0	0	18	0	0
5	52732146	.	C	T	6	9	15	0	0	15	0	0
5	52732147	.	G	A	9	6	15	0	0	15	0	0
5	52732727	.	G	A	6	10	16	0	0	16	0	0
5	52732818	.	G	T	8	9	17	0	0	17	0	0
5	52732931	.	C	T	8	8	16	0	2	18	0	0
5	52733022	.	G	T	15	14	29	0	0	29	0	0
5	52733201	.	C	T	10	7	17	0	1	18	0	0
5	52733230	.	G	A	12	9	21	0	0	21	0	0
5	52733259	.	T	G	20	13	33	0	0	33	0	0
5	52733266	.	T	G	19	15	34	0	0	34	0	0
5	52733370	.	A	T	8	9	17	0	3	20	0	0
5	52733411	.	G	A	10	12	22	0	0	22	0	0
5	52745571	.	T	G	2	11	13	0	0	13	0	0
5	52745637	.	T	C	0	1	1	0	0	1	0	0
5	52748724	.	T	C	1	3	4	0	0	4	0	0
5	52845320	.	A	G	4	3	7	0	0	7	0	0
5	52858847	.	C	T	1	4	5	0	0	5	0	0
5	52858898	.	A	G	5	0	5	0	4	9	0	0
5	52859624	.	A	G	4	0	4	0	9	13	0	0
5	52859769	.	C	T	4	3	7	0	0	7	0	0
5	52859912	.	G	A	2	4	6	0	0	6	0	0
5	52860310	.	T	A	2	2	4	0	1	5	0	0
5	52860338	.	T	C	2	3	5	0	0	5	0	0
5	52860863	.	G	T	9	9	18	0	0	18	0	0
5	52860933	.	T	A	1	2	3	0	0	3	0	0
5	52861334	.	T	A	3	14	17	0	0	17	0	0
5	52861396	.	C	G	10	1	11	0	5	16	0	0
5	52861410	.	A	T	11	8	19	0	0	19	0	0
5	52937785	.	G	T	6	3	9	0	0	9	0	0
5	52937849	.	A	T	6	4	10	0	0	10	0	0
5	52937901	.	C	A	10	7	17	0	0	17	0	0
5	52937956	.	A	T	4	6	10	0	0	10	0	0
5	52938787	.	C	A	6	4	10	0	1	11	0	0
5	52939163	.	T	C	2	1	3	0	0	3	0	0
5	52962667	.	T	C	5	1	6	0	1	7	0	0
5	52972260	.	A	G	10	4	14	0	0	14	0	0
5	52972323	.	C	A	3	0	3	0	0	3	0	0
5	52988108	.	C	T	2	7	9	0	1	10	0	0
5	52988147	.	C	T	3	3	6	0	0	6	0	0
5	53003463	.	C	G	0	0	0	0	1	1	0	0
5	53003640	.	C	G	2	4	6	0	0	6	0	0
5	53003896	.	G	A	3	8	11	0	0	11	0	0
5	53003988	.	A	C	5	0	5	0	4	9	0	0
5	53009239	.	T	A	1	2	3	0	0	3	0	0
5	53734556	.	C	T	1	2	3	0	0	3	0	0
5	53748244	.	C	T	3	7	10	0	0	10	0	0
5	53759491	.	A	T	7	8	15	0	5	20	0	0
5	53761461	.	C	T	15	3	18	0	0	19	1	0
5	53761541	.	A	T	10	12	22	0	0	22	0	0
5	53761969	.	T	G	0	0	0	0	2	2	0	0
5	53762143	.	C	G	1	0	1	0	4	5	0	0
5	53762301	.	G	A	1	1	2	0	1	3	0	0
5	53825047	.	G	A	7	4	11	0	0	11	0	0
5	53825054	.	T	A	7	5	12	0	0	12	0	0
5	53899573	.	T	C	7	13	20	0	0	20	0	0
5	53908333	.	C	T	9	7	16	0	0	16	0	0
5	53908613	.	T	A	2	3	5	0	0	5	0	0
5	53908695	.	T	A	6	4	10	0	1	11	0	0
5	53908722	.	G	T	5	5	10	0	1	11	0	0
5	53908892	.	A	G	7	5	12	0	0	12	0	0
5	53908893	.	G	A	7	5	12	0	0	12	0	0
5	53909000	.	G	C	7	6	13	0	0	13	0	0
5	53909031	.	T	A	9	3	12	0	1	13	0	0
5	53909141	.	C	G	3	2	5	0	0	5	0	0
5	53909244	.	A	T	5	2	7	0	1	8	0	0
5	53909914	.	C	T	6	3	9	0	0	9	0	0
5	53910324	.	C	T	4	5	9	0	0	9	0	0
5	54280294	.	T	C	1	3	4	0	0	4	0	0
5	54280460	.	T	G	3	2	5	0	1	6	0	0
5	54280495	.	T	G	3	1	4	0	0	4	0	0
5	54280889	.	G	A	3	1	4	0	0	4	0	0
5	54297461	.	T	G	3	2	5	0	0	5	0	0
5	54297668	.	C	T	1	1	2	0	0	2	0	0
5	54304666	.	C	G	1	3	4	0	0	4	0	0
5	54305209	.	G	A	0	6	6	0	0	6	0	0
5	54309365	.	C	T	2	4	6	0	0	6	0	0
5	54309395	.	G	A	8	5	13	0	0	13	0	0
5	54309449	.	C	T	0	4	4	0	8	12	0	0
5	54309459	.	T	A	5	3	8	0	0	8	0	0
5	54337485	.	A	G	4	2	6	0	0	6	0	0
5	54337517	.	A	T	3	7	10	0	0	10	0	0
5	54337604	.	A	C	3	0	3	0	3	6	0	0
5	54337618	.	C	A	0	4	4	0	1	5	0	0
5	54337831	.	T	A	10	6	16	0	0	16	0	0
5	54337880	.	T	C	7	0	7	0	6	13	0	0
5	54337933	.	G	T	6	9	15	0	5	20	0	0
5	54337934	.	C	A	9	9	18	0	2	20	0	0
5	54338040	.	C	A	3	8	11	0	0	11	0	0
5	54339734	.	A	G	1	3	4	0	0	4	0	0
5	54340047	.	G	A	5	5	10	0	0	10	0	0
5	54342135	.	C	T	2	0	2	0	0	2	0	0
5	54416333	.	T	A	3	2	5	0	1	6	0	0
5	54419992	.	T	C	1	1	2	0	0	2	0	0
5	54420465	.	T	A	2	1	3	0	0	3	0	0
5	54457983	.	G	A	4	6	10	0	0	10	0	0
5	54458053	.	A	C	2	7	9	0	1	10	0	0
5	54458125	.	T	C	3	5	8	0	0	8	0	0
5	54458127	.	A	G	2	5	7	0	1	8	0	0
5	54458326	.	G	A	10	6	16	0	2	18	0	0
5	54458345	.	T	A	6	9	15	0	0	15	0	0
5	54458437	.	C	T	9	7	16	0	0	16	0	0
5	54458477	.	C	T	9	7	16	0	1	17	0	0
5	54458668	.	C	A	8	8	16	0	0	16	0	0
5	54458774	.	A	C	8	0	8	0	6	14	0	0
5	54458791	.	C	G	0	8	8	0	4	12	0	0
5	54458827	.	C	A	0	12	12	0	0	12	0	0
5	54458974	.	C	G	8	7	15	0	2	17	0	0
5	54459073	.	T	G	8	7	15	0	1	16	0	0
5	54459086	.	G	T	6	7	13	0	2	15	0	0
5	54459682	.	C	T	5	2	7	0	2	9	0	0
5	54459700	.	T	C	6	0	6	0	3	9	0	0
5	54460218	.	A	C	0	5	5	0	0	5	0	0
5	54460237	.	T	A	1	5	6	0	0	6	0	0
5	54460259	.	G	A	6	2	8	0	0	8	0	0
5	54460274	.	T	A	5	4	9	0	0	9	0	0
5	54460322	.	T	A	5	9	14	0	0	14	0	0
5	54460371	.	T	A	5	11	16	0	0	16	0	0
5	54460481	.	C	T	0	8	8	0	11	19	0	0
5	54460555	.	G	A	5	8	13	0	1	14	0	0
5	54460558	.	A	T	5	9	14	0	2	16	0	0
5	54468032	.	A	G	4	7	11	0	1	12	0	0
5	54468506	.	G	A	1	3	4	0	0	4	0	0
5	54470845	.	C	G	0	2	2	0	1	3	0	0
5	54470912	.	C	G	2	8	10	1	0	11	0	0
5	54482550	.	G	A	1	1	2	0	0	2	0	0
5	54482561	.	A	C	1	1	2	0	1	3	0	0
5	54482795	.	C	A	3	2	5	0	0	5	0	0
5	54482806	.	C	T	2	2	4	0	1	5	0	0
5	54497019	.	G	A	1	0	1	0	0	1	0	0
5	54497620	.	C	T	1	2	3	0	0	3	0	0
5	54497628	.	C	T	2	1	3	0	0	3	0	0
5	54498363	.	C	T	4	13	17	0	0	17	0	0
5	54498375	.	T	G	13	5	18	0	1	19	0	0
5	54498452	.	C	T	7	12	19	0	1	20	0	0
5	54501179	.	C	T	4	5	9	0	3	12	0	0
5	54502307	.	G	A	0	7	7	0	4	11	0	0
5	54502414	.	G	C	6	11	17	0	1	18	0	0
5	54541975	.	C	A	1	6	7	0	0	7	0	0
5	54558738	.	A	C	4	2	6	0	0	6	0	0
5	54565223	.	T	G	0	0	0	0	1	1	0	0
5	54565379	.	A	C	1	0	1	0	1	2	0	0
5	54576142	.	C	T	4	2	6	0	1	7	0	0
5	54576223	.	C	T	6	4	10	0	1	11	0	0
5	54576238	.	G	A	3	6	9	0	0	9	0	0
5	54576562	.	G	T	1	1	2	0	0	2	0	0
5	54585600	.	C	T	1	2	3	0	0	3	0	0
5	54602360	.	C	A	0	1	1	0	0	1	0	0
5	54632954	.	A	C	2	3	5	0	0	5	0	0
5	54633277	.	C	T	2	2	4	0	0	4	0	0
5	54633313	.	C	T	0	2	2	0	0	2	0	0
5	54643746	.	T	A	2	4	6	0	0	6	0	0
5	54652941	.	T	A	8	7	15	0	0	15	0	0
5	54652947	.	C	A	8	7	15	0	0	15	0	0
5	54656583	.	A	G	1	0	1	0	3	4	0	0
5	54656613	.	T	C	1	3	4	0	0	4	0	0
5	54685235	.	T	C	10	12	22	0	1	23	0	0
5	54685349	.	A	G	11	8	19	0	1	20	0	0
5	54685371	.	A	T	14	9	23	0	1	24	0	0
5	54685445	.	C	A	8	7	15	0	1	16	0	0
5	54712283	.	C	T	0	2	2	0	1	3	0	0
5	54712409	.	C	T	2	2	4	0	0	4	0	0
5	54716828	.	T	C	5	0	5	0	10	15	0	0
5	54719503	.	A	G	4	5	9	0	1	10	0	0
5	54719844	.	G	A	10	11	21	0	0	21	0	0
5	54724444	.	A	T	1	1	2	0	0	2	0	0
5	54767734	.	T	A	17	15	32	0	2	34	0	0
5	54769091	.	A	G	13	12	25	0	0	25	0	0
5	54769133	.	A	G	14	7	21	0	1	22	0	0
5	54769896	.	A	G	16	11	27	0	1	28	0	0
5	54769914	.	C	T	15	11	26	0	1	27	0	0
5	54770121	.	T	C	2	0	2	0	0	2	0	0
5	54770370	.	G	A	20	8	28	0	1	29	0	0
5	54770889	.	C	T	5	4	9	0	0	9	0	0
5	54772818	.	G	A	0	1	1	0	0	1	0	0
5	54772955	.	T	C	3	3	6	0	0	6	0	0
5	54773182	.	C	A	0	7	7	0	5	12	0	0
5	54773250	.	A	G	10	10	20	0	0	20	0	0
5	54776408	.	T	C	3	5	8	0	0	8	0	0
5	54776413	.	G	C	4	3	7	0	0	7	0	0
5	54777482	.	G	A	0	1	1	0	0	1	0	0
5	54778115	.	G	C	0	1	1	0	0	1	0	0
5	54778236	.	G	C	1	0	1	0	0	1	0	0
5	54790426	.	A	C	2	3	5	0	0	5	0	0
5	54790513	.	T	C	3	3	6	0	0	6	0	0
5	54945035	.	T	G	7	22	29	0	1	30	0	0
5	54945048	.	A	G	8	20	28	0	1	29	0	0
5	54955874	.	T	C	2	2	4	0	0	4	0	0
5	54955892	.	G	A	1	1	2	0	0	2	0	0
5	54961109	.	A	G	1	0	1	0	0	1	0	0
5	54964633	.	G	A	0	3	3	0	0	3	0	0
5	54971774	.	G	C	1	2	3	0	0	3	0	0
5	54974350	.	A	G	1	1	2	0	0	2	0	0
5	54977130	.	A	G	2	0	2	0	0	2	0	0
5	55160470	.	A	G	1	4	5	0	1	6	0	0
5	55160572	.	G	A	12	3	15	0	0	15	0	0
5	55168177	.	G	T	15	12	27	0	0	27	0	0
5	55168436	.	T	A	1	3	4	0	0	4	0	0
5	55171359	.	G	A	2	1	3	0	0	3	0	0
5	55371356	.	C	T	7	7	14	0	2	16	0	0
5	55372218	.	A	G	22	10	32	0	1	33	0	0
5	55372425	.	A	C	14	16	30	0	4	34	0	0
5	55372773	.	A	T	10	8	18	0	0	18	0	0
5	55373299	.	G	A	20	15	35	0	2	37	0	0
5	55373869	.	G	T	6	6	12	0	0	12	0	0
5	55374343	.	T	A	7	13	20	0	0	20	0	0
5	55588449	.	G	A	5	9	14	0	2	16	0	0
5	55588458	.	T	C	6	10	16	0	0	16	0	0
5	55588562	.	T	C	7	1	8	0	0	8	0	0
5	55592805	.	A	G	4	0	4	0	0	4	0	0
5	55593011	.	G	T	7	5	12	0	0	12	0	0
5	55596851	.	C	G	0	3	3	0	3	6	0	0
5	55598383	.	T	C	9	4	13	0	3	16	0	0
5	55599950	.	G	C	4	11	15	0	0	15	0	0
5	55600108	.	A	C	6	7	13	0	1	14	0	0
5	55600149	.	T	C	3	6	9	0	3	12	0	0
5	55600154	.	A	G	5	6	11	0	2	13	0	0
5	55604037	.	G	C	9	4	13	0	0	14	1	0
5	55604162	.	G	C	16	6	22	0	3	25	0	0
5	55604211	.	A	T	12	5	17	0	1	18	0	0
5	55604228	.	G	T	11	8	19	0	5	24	0	0
5	55604302	.	A	T	20	1	21	0	0	21	0	0
5	55604392	.	T	A	9	12	21	0	8	29	0	0
5	55604438	.	A	G	11	23	34	0	2	36	0	0
5	55609426	.	T	G	25	19	44	0	1	45	0	0
5	55613789	.	G	A	11	19	30	0	1	31	0	0
5	55613813	.	A	C	7	20	27	0	2	29	0	0
5	55613864	.	A	G	13	10	23	0	0	23	0	0
5	55613999	.	G	A	0	1	1	0	0	1	0	0
5	55669528	.	C	T	1	2	3	0	1	4	0	0
5	55670269	.	T	C	2	1	3	0	0	3	0	0
5	55674606	.	A	G	0	1	1	0	0	1	0	0
5	55686574	.	T	C	1	5	6	0	0	6	0	0
5	55689628	.	C	T	6	5	11	0	1	12	0	0
5	55720486	.	C	T	0	7	7	0	8	15	0	0
5	55723534	.	A	G	6	2	8	0	0	8	0	0
5	55763752	.	G	T	24	17	41	0	1	43	1	0
5	55764509	.	G	A	26	23	49	0	3	52	0	0
5	55773856	.	A	G	2	2	4	0	0	4	0	0
5	55801489	.	G	A	2	3	5	0	0	5	0	0
5	55848084	.	C	T	2	2	4	0	4	8	0	0
5	55866925	.	C	T	0	4	4	0	2	6	0	0
5	55876508	.	C	G	4	4	8	0	0	8	0	0
5	55920930	.	A	C	4	5	9	0	0	9	0	0
5	55920943	.	A	T	4	5	9	0	0	9	0	0
5	55921076	.	A	T	9	11	20	0	1	21	0	0
5	55921335	.	G	A	17	19	36	0	0	36	0	0
5	55933055	.	G	A	7	2	9	0	0	9	0	0
5	55951602	.	G	A	5	4	9	0	1	10	0	0
5	55951639	.	A	T	1	3	4	0	0	4	0	0
5	55951810	.	G	T	1	3	4	0	0	4	0	0
5	55951821	.	C	T	3	2	5	0	0	5	0	0
5	55951937	.	T	C	2	3	5	0	1	6	0	0
5	56100260	.	T	A	0	4	4	0	0	4	0	0
5	56102276	.	G	A	1	3	4	0	0	4	0	0
5	56105919	.	C	T	0	1	1	0	0	1	0	0
5	56111071	.	A	G	1	0	1	0	1	2	0	0
5	56274002	.	A	G	2	3	5	0	0	5	0	0
5	56289800	.	G	A	0	4	4	0	5	9	0	0
5	56289818	.	C	A	4	4	8	0	0	8	0	0
5	56289925	.	G	A	0	0	0	0	3	3	0	0
5	56305674	.	G	A	0	1	1	0	1	2	0	0
5	56308698	.	T	C	6	2	8	0	6	14	0	0
5	56308816	.	C	T	0	10	10	0	16	26	0	0
5	56309013	.	G	C	15	5	20	0	0	20	0	0
5	56309046	.	G	A	19	2	21	0	0	21	0	0
5	56309109	.	C	T	0	25	25	0	11	36	0	0
5	56309115	.	A	T	8	25	33	0	1	34	0	0
5	56309445	.	C	T	5	20	25	0	1	26	0	0
5	56309454	.	A	G	20	6	26	0	1	27	0	0
5	56309506	.	G	A	9	14	23	0	2	25	0	0
5	56309517	.	T	C	16	7	23	0	3	26	0	0
5	56309672	.	C	A	0	11	11	0	10	21	0	0
5	56309677	.	C	A	11	9	20	0	0	20	0	0
5	56313207	.	G	A	16	14	30	0	0	30	0	0
5	56313246	.	C	T	15	12	27	0	1	28	0	0
5	56317153	.	T	A	6	6	12	0	1	13	0	0
5	56317170	.	C	T	2	3	5	0	0	5	0	0
5	56317377	.	G	A	8	11	19	0	1	20	0	0
5	56317470	.	C	T	0	5	5	0	0	5	0	0
5	56317473	.	T	G	0	3	3	0	0	3	0	0
5	56322205	.	C	T	20	7	27	0	0	27	0	0
5	56322404	.	A	G	3	4	7	0	0	7	0	0
5	56322449	.	T	C	7	5	12	0	0	12	0	0
5	56322467	.	G	A	5	1	6	0	1	7	0	0
5	56322680	.	A	G	1	0	1	0	0	1	0	0
5	56343032	.	C	T	0	5	5	0	2	7	0	0
5	56343053	.	G	A	6	2	8	0	0	8	0	0
5	56343095	.	C	T	0	2	2	0	0	2	0	0
5	56345036	.	G	C	2	3	5	0	0	5	0	0
5	56345109	.	A	G	5	5	10	0	2	12	0	0
5	56355129	.	C	T	4	3	7	0	0	7	0	0
5	56355296	.	C	A	1	0	1	0	0	1	0	0
5	56355467	.	T	C	0	1	1	0	0	1	0	0
5	56364862	.	A	G	1	1	2	0	0	2	0	0
5	56364946	.	G	A	2	3	5	0	0	5	0	0
5	56364979	.	A	G	1	1	2	0	0	2	0	0
5	56364982	.	G	T	0	1	1	0	1	2	0	0
5	56915023	.	G	A	3	4	7	0	1	8	0	0
5	56915190	.	C	T	6	4	10	0	2	12	0	0
5	56915250	.	T	A	3	10	13	0	3	16	0	0
5	56915422	.	G	A	4	5	9	0	0	9	0	0
5	56915457	.	T	C	0	0	0	0	1	1	0	0
5	56918932	.	G	A	7	6	13	0	0	13	0	0
5	56918974	.	A	G	6	8	14	0	0	14	0	0
5	56920348	.	G	T	3	2	5	0	0	5	0	0
5	56924447	.	G	T	3	3	6	0	0	6	0	0
5	56924686	.	C	T	2	4	6	0	1	7	0	0
5	56927772	.	C	T	2	3	5	0	0	5	0	0
5	56927784	.	G	A	2	2	4	0	0	4	0	0
5	56935031	.	G	T	1	1	2	0	0	2	0	0
5	56937131	.	C	A	1	2	3	0	0	3	0	0
5	56939414	.	G	A	1	2	3	0	0	3	0	0
5	56951034	.	G	A	10	14	24	0	0	24	0	0
5	56951156	.	C	T	11	6	17	0	1	18	0	0
5	56951229	.	C	T	14	14	28	0	3	31	0	0
5	56951258	.	A	C	8	7	15	0	1	16	0	0
5	56951713	.	T	C	4	4	8	0	0	8	0	0
5	56951729	.	G	A	0	9	9	0	0	9	0	0
5	56951769	.	A	G	4	14	18	0	0	18	0	0
5	56951830	.	T	A	9	3	12	0	1	13	0	0
5	56952295	.	G	A	13	14	27	0	1	28	0	0
5	56952316	.	A	G	5	9	14	0	0	14	0	0
5	56956359	.	G	A	7	9	16	0	0	16	0	0
5	56958513	.	C	T	2	4	6	0	0	6	0	0
5	56961194	.	A	G	2	0	2	0	0	2	0	0
5	56964475	.	G	A	3	5	8	0	0	8	0	0
5	57217249	.	G	A	0	0	0	0	2	2	0	0
5	57217343	.	T	G	5	3	8	0	0	8	0	0
5	57217391	.	C	G	1	1	2	0	0	2	0	0
5	57219429	.	T	C	2	2	4	0	0	4	0	0
5	57219430	.	T	A	2	2	4	0	0	4	0	0
5	57219496	.	G	A	5	5	10	0	0	10	0	0
5	57219736	.	T	C	3	4	7	0	0	7	0	0
5	57219789	.	C	T	5	6	11	0	0	11	0	0
5	57219938	.	G	C	0	5	5	0	7	12	0	0
5	57220033	.	T	C	3	9	12	0	0	12	0	0
5	57220108	.	G	A	1	8	9	0	3	12	0	0
5	57220190	.	A	G	6	0	6	0	5	11	0	0
5	57220324	.	T	C	1	3	4	0	0	4	0	0
5	57225343	.	C	T	1	3	4	0	0	4	0	0
5	57225496	.	C	G	1	0	1	0	1	2	0	0
5	57234053	.	A	C	4	3	7	0	0	7	0	0
5	57234074	.	C	T	4	3	7	0	0	7	0	0
5	57244390	.	C	G	1	2	3	0	0	3	0	0
5	57320235	.	C	T	32	24	56	0	0	56	0	0
5	57320274	.	G	A	28	22	50	0	3	53	0	0
5	57324956	.	A	C	31	23	54	0	5	59	0	0
5	57325158	.	T	G	30	25	55	0	4	59	0	0
5	57325204	.	T	G	33	1	34	0	27	61	0	0
5	57325210	.	G	A	36	26	62	0	1	63	0	0
5	57325359	.	G	A	30	31	61	0	3	64	0	0
5	57325537	.	C	T	10	5	15	0	1	16	0	0
5	57347737	.	T	C	2	5	7	0	0	7	0	0
5	57352090	.	T	A	1	4	5	0	0	5	0	0
5	57352139	.	G	A	0	2	2	0	1	3	0	0
5	57352495	.	A	G	1	7	8	0	0	8	0	0
5	57353387	.	T	C	3	3	6	0	0	6	0	0
5	57353959	.	C	A	2	8	10	0	3	13	0	0
5	57353981	.	C	T	2	7	9	0	3	12	0	0
5	57354046	.	G	A	7	8	15	0	3	18	0	0
5	57354096	.	A	G	4	7	11	0	1	12	0	0
5	57354552	.	C	T	5	7	12	0	0	12	0	0
5	57354596	.	C	T	2	5	7	0	1	8	0	0
5	57354656	.	A	G	7	6	13	0	1	14	0	0
5	57354680	.	G	A	1	10	11	0	9	20	0	0
5	57354719	.	T	G	5	9	14	0	0	14	0	0
5	57354786	.	G	T	2	8	10	0	1	11	0	0
5	57354839	.	A	G	3	0	3	0	3	6	0	0
5	57359740	.	G	A	5	17	22	0	0	22	0	0
5	57359811	.	A	G	9	11	20	0	1	21	0	0
5	57444345	.	A	G	2	2	4	0	0	4	0	0
5	57447301	.	C	T	0	3	3	0	0	3	0	0
5	57450440	.	C	A	2	3	5	0	1	6	0	0
5	57450973	.	A	G	1	1	2	0	3	5	0	0
5	57453587	.	T	C	7	10	17	0	0	17	0	0
5	57453635	.	T	C	6	8	14	0	0	14	0	0
5	57482894	.	T	G	1	0	1	0	2	3	0	0
5	57489777	.	T	C	12	0	12	0	15	27	0	0
5	57490081	.	C	A	13	4	17	0	1	18	0	0
5	57490099	.	G	A	14	7	21	0	0	22	1	0
5	57490153	.	T	C	11	15	26	0	0	26	0	0
5	57500086	.	T	C	10	5	15	0	0	15	0	0
5	57506568	.	A	C	2	3	5	0	0	5	0	0
5	57506622	.	A	G	6	8	14	0	0	14	0	0
5	57506646	.	C	T	0	5	5	0	6	11	0	0
5	57514332	.	G	A	12	7	19	0	1	20	0	0
5	57514428	.	G	A	7	3	10	0	0	10	0	0
5	57641711	.	A	T	1	3	4	0	0	4	0	0
5	57641751	.	C	T	2	6	8	0	0	8	0	0
5	57643949	.	T	C	2	3	5	0	0	5	0	0
5	57644184	.	T	G	0	4	4	0	0	4	0	0
5	57644256	.	G	A	7	10	17	0	1	18	0	0
5	57647626	.	A	T	2	2	4	0	0	4	0	0
5	57650592	.	G	T	0	4	4	0	1	5	0	0
5	57650777	.	C	T	3	2	5	0	1	6	0	0
5	57650782	.	C	T	3	2	5	0	1	6	0	0
5	57693926	.	T	C	2	2	4	0	0	4	0	0
5	57704805	.	T	C	0	0	0	0	1	1	0	0
5	57715904	.	T	C	11	7	18	0	0	18	0	0
5	57718488	.	A	C	12	11	23	0	1	25	1	0
5	57718554	.	T	G	7	8	15	1	1	17	0	0
5	57718558	.	G	T	8	6	14	1	1	16	0	0
5	57718649	.	A	G	16	0	16	0	1	18	1	0
5	57718659	.	C	T	13	11	24	0	0	24	0	0
5	57718716	.	T	C	7	13	20	0	0	20	0	0
5	57718739	.	T	C	3	11	14	0	0	14	0	0
5	57718794	.	T	C	1	5	6	0	0	6	0	0
5	57718804	.	G	A	0	3	3	0	0	3	0	0
5	57726543	.	T	C	8	1	9	0	1	10	0	0
5	57726573	.	T	A	5	5	10	0	0	10	0	0
5	57734692	.	A	T	3	4	7	0	0	7	0	0
5	57735420	.	A	G	3	4	7	0	1	8	0	0
5	57737337	.	A	G	3	3	6	0	0	6	0	0
5	57737389	.	C	T	1	7	8	0	1	9	0	0
5	57737395	.	T	C	1	8	9	0	1	10	0	0
5	57737504	.	C	A	5	4	9	0	0	9	0	0
5	57737587	.	G	A	6	4	10	0	0	10	0	0
5	57737589	.	T	C	6	4	10	0	0	10	0	0
5	57737673	.	T	C	4	4	8	0	0	8	0	0
5	57737704	.	C	T	2	8	10	0	0	10	0	0
5	57737727	.	A	T	2	6	8	0	0	8	0	0
5	57737862	.	T	A	3	4	7	0	1	8	0	0
5	57737863	.	A	C	4	4	8	0	0	8	0	0
5	57737949	.	A	T	7	3	10	0	0	10	0	0
5	57737955	.	A	G	6	3	9	0	0	9	0	0
5	57738078	.	C	T	8	4	12	0	0	12	0	0
5	57738233	.	C	T	4	6	10	0	1	11	0	0
5	57738321	.	G	A	4	2	6	0	0	6	0	0
5	57743868	.	G	A	4	7	11	0	0	11	0	0
5	57743907	.	A	G	3	7	10	0	1	11	0	0
5	57744681	.	C	T	1	3	4	0	0	4	0	0
5	57744731	.	T	C	1	1	2	0	0	2	0	0
5	57747691	.	A	G	1	2	3	0	0	3	0	0
5	57751167	.	A	G	0	2	2	0	1	3	0	0
5	57751676	.	T	A	4	1	5	0	0	5	0	0
5	57753821	.	C	T	2	4	6	0	0	6	0	0
5	57753827	.	A	G	0	0	0	0	2	2	0	0
5	57755422	.	T	C	2	4	6	0	0	6	0	0
5	57755844	.	C	T	2	3	5	0	1	6	0	0
5	57762423	.	A	T	8	13	21	0	0	21	0	0
5	57762468	.	G	T	13	27	40	0	2	42	0	0
5	57762479	.	A	T	15	25	40	0	2	42	0	0
5	57762656	.	T	G	15	21	36	0	2	38	0	0
5	57762849	.	A	T	11	16	27	0	0	27	0	0
5	57762868	.	A	G	11	16	27	0	1	28	0	0
5	57762900	.	T	C	13	16	29	0	0	29	0	0
5	57762938	.	A	T	10	19	29	0	0	29	0	0
5	57762986	.	C	G	17	6	23	0	0	23	0	0
5	57777906	.	C	G	7	0	7	0	4	11	0	0
5	57787630	.	C	T	11	8	19	0	2	21	0	0
5	57790583	.	G	A	27	15	42	0	1	43	0	0
5	57797085	.	A	C	11	16	27	0	3	30	0	0
5	57797152	.	G	A	1	25	26	0	29	55	0	0
5	57797844	.	C	T	19	38	57	0	6	63	0	0
5	57797887	.	A	T	22	38	60	0	0	60	0	0
5	57797914	.	A	G	17	4	21	0	29	50	0	0
5	57797954	.	T	C	20	18	38	0	0	38	0	0
5	57814523	.	A	G	8	3	11	0	0	11	0	0
5	57814627	.	G	A	6	4	10	0	1	11	0	0
5	57814685	.	A	G	5	3	8	0	0	8	0	0
5	57819001	.	A	G	4	1	5	0	0	5	0	0
5	57820683	.	A	G	1	2	3	0	0	3	0	0
5	57838329	.	G	A	2	2	4	0	0	4	0	0
5	58075599	.	C	T	1	1	2	0	0	2	0	0
5	58075686	.	A	G	4	5	9	0	0	9	0	0
5	58075815	.	T	G	1	4	5	0	3	8	0	0
5	58075863	.	G	A	4	3	7	0	0	7	0	0
5	58081110	.	C	T	1	0	1	0	0	1	0	0
5	58081173	.	T	A	2	3	5	0	0	5	0	0
5	58086215	.	G	C	4	0	4	0	3	7	0	0
5	58173388	.	C	T	1	0	1	0	0	1	0	0
5	58173573	.	T	A	1	3	4	0	0	4	0	0
5	58372268	.	T	C	14	28	42	0	1	43	0	0
5	58382159	.	A	G	23	0	23	0	25	48	0	0
5	58382358	.	C	T	24	33	57	0	3	60	0	0
5	58382440	.	T	A	22	11	33	0	5	47	9	0
5	58382457	.	C	G	28	2	30	0	9	39	0	0
5	58457014	.	T	C	2	1	3	0	0	3	0	0
5	58459461	.	T	C	0	1	1	0	0	1	0	0
5	58459476	.	A	C	0	0	0	0	1	1	0	0
5	58462891	.	A	G	8	0	8	0	16	24	0	0
5	58468137	.	T	C	4	3	7	0	0	7	0	0
5	58468173	.	A	G	7	0	7	0	6	13	0	0
5	58470952	.	C	G	1	4	5	0	0	5	0	0
5	58477449	.	A	T	0	2	2	0	0	2	0	0
5	58478136	.	T	C	3	10	13	0	2	15	0	0
5	58478188	.	C	T	0	1	1	0	0	1	0	0
5	58481826	.	T	C	2	6	8	0	0	8	0	0
5	58500489	.	G	A	1	0	1	0	0	1	0	0
5	58504447	.	G	T	0	1	1	0	0	1	0	0
5	58687573	.	T	C	3	2	5	0	0	5	0	0
5	58687623	.	A	T	4	10	14	0	1	15	0	0
5	58687649	.	C	A	4	7	11	0	2	13	0	0
5	58687673	.	T	C	4	3	7	0	2	9	0	0
5	58687690	.	T	A	5	3	8	0	0	8	0	0
5	58687739	.	G	A	0	1	1	0	0	1	0	0
5	58688621	.	T	A	2	1	3	0	0	3	0	0
5	58688644	.	A	G	2	5	7	0	0	7	0	0
5	58688687	.	G	A	0	15	15	0	6	21	0	0
5	58690170	.	A	C	1	4	5	0	0	5	0	0
5	58690198	.	T	G	1	3	4	0	1	5	0	0
5	58690215	.	G	A	2	2	4	0	0	4	0	0
5	58691748	.	A	G	5	9	14	0	1	15	0	0
5	58691763	.	T	G	7	8	15	0	1	16	0	0
5	58695746	.	A	T	1	7	8	0	0	8	0	0
5	58695764	.	G	A	0	4	4	0	2	6	0	0
5	58696063	.	G	A	2	6	8	0	1	9	0	0
5	58696236	.	G	A	3	2	5	0	0	5	0	0
5	58696412	.	A	C	9	9	18	0	1	19	0	0
5	58696670	.	T	C	9	1	10	0	9	19	0	0
5	58696840	.	G	A	10	7	17	0	1	18	0	0
5	58696997	.	T	G	8	10	18	0	1	19	0	0
5	58697007	.	A	C	8	10	18	0	0	18	0	0
5	58697050	.	C	T	8	5	13	0	0	13	0	0
5	58699888	.	C	T	0	3	3	0	0	3	0	0
5	58704284	.	G	C	1	2	3	0	0	3	0	0
5	58707265	.	A	G	1	6	7	0	0	7	0	0
5	58708812	.	T	G	4	2	6	0	0	6	0	0
5	58708832	.	T	G	4	2	6	0	0	6	0	0
5	58708996	.	G	T	0	1	1	0	0	1	0	0
5	58711159	.	G	T	2	1	3	0	0	3	0	0
5	58713579	.	C	T	1	0	1	0	0	1	0	0
5	58717412	.	C	T	3	0	3	0	0	3	0	0
5	58717535	.	C	G	1	3	4	0	0	4	0	0
5	58719797	.	C	T	1	3	4	0	0	4	0	0
5	58721406	.	C	T	0	4	4	0	4	8	0	0
5	58722507	.	T	C	2	3	5	0	1	6	0	0
5	58850883	.	A	T	20	22	42	0	2	44	0	0
5	58850923	.	A	C	17	25	42	0	0	42	0	0
5	58850958	.	T	C	15	0	15	0	15	31	1	0
5	58850981	.	A	T	16	16	32	0	1	33	0	0
5	58851041	.	G	T	20	13	33	0	6	40	1	0
5	58852256	.	G	A	11	12	23	0	1	24	0	0
5	58852582	.	G	A	6	6	12	0	0	12	0	0
5	58852687	.	A	G	12	17	29	0	0	29	0	0
5	58852758	.	C	A	7	7	14	0	0	14	0	0
5	58852784	.	A	G	7	10	17	0	1	18	0	0
5	58852825	.	A	C	12	11	23	0	1	24	0	0
5	58852873	.	T	A	7	9	16	0	1	17	0	0
5	58853407	.	C	T	5	2	7	0	2	9	0	0
5	59060620	.	C	T	5	0	5	0	0	5	0	0
5	59060824	.	C	T	0	3	3	0	0	3	0	0
5	59063090	.	C	A	3	1	4	0	0	4	0	0
5	59063102	.	C	T	3	1	4	0	0	4	0	0
5	59079594	.	A	G	4	2	6	0	0	6	0	0
5	59079726	.	C	A	9	11	20	0	0	21	1	0
5	59079732	.	A	C	9	13	22	0	1	23	0	0
5	59079806	.	C	A	16	11	27	0	0	28	1	0
5	59079919	.	G	A	0	2	2	0	7	9	0	0
5	59080392	.	C	A	9	8	17	0	2	19	0	0
5	59080874	.	A	G	3	3	6	0	0	6	0	0
5	59081699	.	C	T	1	2	3	0	0	3	0	0
5	59081730	.	C	T	1	2	3	0	0	3	0	0
5	59081816	.	T	G	1	5	6	0	0	6	0	0
5	59082395	.	C	T	6	3	9	0	0	9	0	0
5	59082497	.	A	T	14	11	25	0	1	26	0	0
5	59082540	.	C	T	13	5	18	0	2	20	0	0
5	59082581	.	T	A	3	10	13	0	0	13	0	0
5	59082685	.	G	A	15	5	20	0	0	20	0	0
5	59082703	.	T	C	13	7	20	0	1	21	0	0
5	59082882	.	C	T	13	13	26	0	1	27	0	0
5	59083136	.	T	G	12	12	24	0	1	25	0	0
5	59083180	.	G	T	1	10	11	0	11	22	0	0
5	59083201	.	T	A	9	9	18	0	0	18	0	0
5	59092513	.	A	G	1	3	4	0	1	5	0	0
5	59092644	.	G	A	2	1	3	0	0	3	0	0
5	59100577	.	G	A	2	2	4	0	1	5	0	0
5	59101813	.	G	A	1	1	2	0	0	2	0	0
5	59111584	.	G	A	0	3	3	0	0	3	0	0
5	59147690	.	C	T	3	7	10	0	1	11	0	0
5	59147711	.	T	C	3	7	10	0	0	10	0	0
5	59198679	.	C	T	4	4	8	0	0	8	0	0
5	59199993	.	A	G	1	0	1	0	4	5	0	0
5	59200435	.	T	G	3	3	6	0	0	6	0	0
5	59200444	.	G	A	2	2	4	0	1	5	0	0
5	59200523	.	C	G	4	4	8	0	0	8	0	0
5	59200687	.	C	A	3	1	4	0	1	5	0	0
5	59200721	.	G	A	0	4	4	0	7	11	0	0
5	59200733	.	G	A	7	8	15	0	0	15	0	0
5	59201199	.	C	T	3	4	7	0	0	7	0	0
5	59201211	.	A	T	3	3	6	0	1	7	0	0
5	59201259	.	G	A	3	2	5	0	0	5	0	0
5	59201263	.	G	A	3	2	5	0	0	5	0	0
5	59201474	.	C	T	4	3	7	0	0	7	0	0
5	59201609	.	A	T	5	8	13	0	0	13	0	0
5	59201624	.	C	T	4	5	9	0	2	11	0	0
5	59201883	.	T	G	6	7	13	0	0	13	0	0
5	59239773	.	C	G	1	5	6	0	0	6	0	0
5	59278463	.	T	C	1	2	3	0	0	3	0	0
5	59297918	.	C	G	1	1	2	0	0	2	0	0
5	59328475	.	C	T	0	1	1	0	1	2	0	0
5	59367819	.	C	G	3	1	4	0	2	6	0	0
5	59368510	.	C	T	0	2	2	0	0	2	0	0
5	59380488	.	C	T	0	1	1	0	0	1	0	0
5	59386337	.	G	T	0	6	6	0	5	11	0	0
5	59386456	.	T	C	6	9	15	0	0	15	0	0
5	59386512	.	C	G	6	5	11	0	0	11	0	0
5	59386964	.	G	T	4	2	6	0	0	6	0	0
5	59387094	.	A	T	4	2	6	0	0	6	0	0
5	59387184	.	A	T	4	6	10	0	0	10	0	0
5	59387237	.	T	G	4	7	11	0	0	11	0	0
5	59387274	.	C	T	7	4	11	0	0	11	0	0
5	59387476	.	C	A	10	3	13	0	1	14	0	0
5	59387478	.	C	A	9	3	12	0	2	14	0	0
5	59388343	.	T	C	8	4	12	0	0	12	0	0
5	59388586	.	T	A	10	8	18	0	0	18	0	0
5	59388604	.	T	C	9	12	21	0	0	21	0	0
5	59388951	.	T	A	9	9	18	0	0	18	0	0
5	59389440	.	T	A	3	3	6	0	1	7	0	0
5	59389444	.	T	A	3	3	6	0	0	6	0	0
5	59389688	.	G	A	15	7	22	0	1	23	0	0
5	59389786	.	T	G	6	3	9	0	0	9	0	0
5	59398452	.	T	C	0	1	1	0	0	1	0	0
5	59398522	.	A	G	3	5	8	0	0	8	0	0
5	59419988	.	T	C	4	1	5	0	0	5	0	0
5	59420138	.	G	A	0	3	3	0	2	5	0	0
5	59420249	.	A	G	3	0	3	0	5	8	0	0
5	59420291	.	A	G	3	0	3	0	3	6	0	0
5	59420321	.	A	C	4	4	8	0	0	8	0	0
5	59420414	.	G	T	0	7	7	0	3	10	0	0
5	59444562	.	C	A	5	5	10	0	0	10	0	0
5	59449713	.	G	A	0	3	3	0	1	4	0	0
5	59449767	.	C	T	3	6	9	0	0	9	0	0
5	59462424	.	G	T	1	1	2	0	0	2	0	0
5	59462457	.	G	A	2	4	6	0	0	6	0	0
5	59462881	.	G	A	4	4	8	0	0	8	0	0
5	59462991	.	T	C	4	11	15	0	0	15	0	0
5	59462994	.	A	T	4	11	15	0	0	15	0	0
5	59463183	.	G	T	3	4	7	0	1	8	0	0
5	59463261	.	C	A	7	5	12	0	0	12	0	0
5	59463327	.	A	C	8	4	12	0	0	12	0	0
5	59466867	.	T	G	2	0	2	0	0	2	0	0
5	59466882	.	G	A	0	0	0	0	5	5	0	0
5	59472724	.	T	C	1	1	2	0	0	2	0	0
5	59473728	.	T	C	1	3	4	0	0	4	0	0
5	59479973	.	C	T	7	10	17	0	1	18	0	0
5	59510265	.	A	C	2	2	4	0	0	4	0	0
5	59515419	.	A	T	3	1	4	0	0	4	0	0
5	59515573	.	T	C	2	2	4	0	0	4	0	0
5	59525071	.	A	G	0	0	0	0	1	1	0	0
5	59544225	.	A	G	3	0	3	0	2	5	0	0
5	59544249	.	T	C	3	5	8	0	0	8	0	0
5	59544291	.	T	C	6	6	12	0	0	12	0	0
5	59544327	.	C	T	5	4	9	0	0	9	0	0
5	59544645	.	G	T	0	2	2	0	0	2	0	0
5	59548976	.	C	G	3	4	7	0	0	7	0	0
5	59549006	.	G	A	0	4	4	0	7	11	0	0
5	59549038	.	A	C	5	3	8	0	0	8	0	0
5	59549143	.	A	G	6	1	7	0	5	12	0	0
5	59549148	.	G	A	6	5	11	0	0	11	0	0
5	59549182	.	G	A	5	5	10	0	0	10	0	0
5	59549382	.	A	G	7	5	12	0	0	12	0	0
5	59549389	.	G	A	8	4	12	0	0	12	0	0
5	59549516	.	T	G	4	2	6	0	1	7	0	0
5	59549528	.	T	A	4	1	5	0	0	5	0	0
5	59550260	.	A	T	10	6	16	0	1	17	0	0
5	59550529	.	T	G	12	5	17	0	1	18	0	0
5	59550581	.	T	C	8	5	13	0	0	13	0	0
5	59550636	.	A	T	6	9	15	0	0	15	0	0
5	59550713	.	T	C	4	5	9	0	0	9	0	0
5	59550725	.	G	T	3	4	7	0	0	7	0	0
5	59550762	.	A	C	4	1	5	0	2	7	0	0
5	59553797	.	A	G	6	0	6	0	6	12	0	0
5	59559950	.	T	C	11	5	16	0	0	16	0	0
5	59560110	.	T	C	12	8	20	0	1	21	0	0
5	59560131	.	A	G	9	0	9	0	6	15	0	0
5	59593297	.	G	C	1	10	11	0	10	21	0	0
5	59593408	.	G	T	12	9	21	0	1	22	0	0
5	59593523	.	C	T	5	3	8	0	0	8	0	0
5	59593773	.	G	C	8	3	11	0	0	11	0	0
5	59593884	.	T	G	8	4	12	0	0	12	0	0
5	59594037	.	G	T	1	1	2	0	1	3	0	0
5	59594126	.	G	T	2	2	4	0	0	4	0	0
5	59594199	.	T	C	6	4	10	0	0	10	0	0
5	59594328	.	T	C	8	7	15	0	0	15	0	0
5	59594485	.	G	T	15	12	27	0	1	28	0	0
5	59594559	.	A	G	14	4	18	0	3	21	0	0
5	59594648	.	A	T	4	8	12	0	1	13	0	0
5	59595127	.	T	C	5	4	9	0	0	9	0	0
5	59595241	.	T	C	9	8	17	0	0	17	0	0
5	59595252	.	C	T	9	12	21	0	1	22	0	0
5	59595502	.	T	C	5	7	12	0	0	12	0	0
5	59595503	.	G	C	5	7	12	0	0	12	0	0
5	60665225	.	A	C	6	4	10	0	1	11	0	0
5	60665315	.	G	A	0	0	0	0	2	2	0	0
5	60665324	.	A	C	2	0	2	0	0	2	0	0
5	60684257	.	C	T	4	5	9	0	0	9	0	0
5	60684494	.	T	C	6	4	10	0	0	10	0	0
5	60684603	.	A	G	12	0	12	0	9	21	0	0
5	60684866	.	C	T	5	6	11	0	1	12	0	0
5	60685209	.	A	T	5	10	15	0	0	15	0	0
5	60685481	.	G	A	13	6	19	0	1	20	0	0
5	60685513	.	A	G	9	10	19	0	0	19	0	0
5	60685758	.	T	C	6	6	12	0	0	12	0	0
5	60685773	.	C	T	5	7	12	0	2	14	0	0
5	60685822	.	C	T	7	8	15	0	0	15	0	0
5	60685851	.	G	A	4	6	10	0	0	10	0	0
5	60685952	.	A	C	7	7	14	0	0	14	0	0
5	60686374	.	A	T	6	10	16	0	0	16	0	0
5	60686380	.	C	A	5	9	14	0	0	14	0	0
5	60686686	.	C	G	4	5	9	0	0	9	0	0
5	60686910	.	G	T	8	13	21	0	0	21	0	0
5	60687327	.	T	C	6	7	13	0	1	14	0	0
5	60687344	.	A	T	10	4	14	0	0	14	0	0
5	60687537	.	T	C	5	7	12	0	1	13	0	0
5	60855129	.	G	A	2	1	3	0	0	3	0	0
5	60866063	.	G	T	0	2	2	0	0	2	0	0
5	60868009	.	A	G	2	0	2	0	2	4	0	0
5	60868173	.	G	A	0	4	4	0	2	6	0	0
5	60868216	.	G	A	2	2	4	0	0	4	0	0
5	60871999	.	A	T	2	2	4	0	1	5	0	0
5	60872126	.	G	A	9	10	19	0	0	19	0	0
5	60872299	.	T	G	2	5	7	0	0	7	0	0
5	60872320	.	T	C	4	7	11	0	0	11	0	0
5	60872472	.	G	A	12	6	18	0	0	18	0	0
5	60894675	.	G	A	2	0	2	0	1	3	0	0
5	60894738	.	G	T	0	3	3	0	1	4	0	0
5	60906313	.	G	A	0	1	1	0	4	5	0	0
5	61270901	.	G	A	10	7	17	0	0	17	0	0
5	61270905	.	C	T	9	6	15	0	2	17	0	0
5	61329486	.	G	A	18	6	24	0	0	24	0	0
5	61329604	.	C	T	5	13	18	0	1	19	0	0
5	61351582	.	C	A	1	2	3	0	1	4	0	0
5	61351600	.	C	A	2	1	3	0	1	4	0	0
5	61351851	.	C	T	0	1	1	0	4	5	0	0
5	61353710	.	G	C	1	0	1	0	3	4	0	0
5	61354112	.	G	T	5	5	10	0	0	10	0	0
5	61380103	.	T	A	9	5	14	0	0	14	0	0
5	61380130	.	C	T	10	9	19	0	1	20	0	0
5	61392719	.	C	T	16	10	26	0	1	27	0	0
5	61396054	.	G	A	3	3	6	0	0	6	0	0
5	61402030	.	G	A	10	7	17	0	2	19	0	0
5	61402455	.	A	T	11	19	30	0	1	31	0	0
5	61402479	.	G	A	21	11	32	0	1	33	0	0
5	61402570	.	T	C	13	16	29	0	1	30	0	0
5	61402584	.	A	G	15	0	15	0	13	28	0	0
5	61402761	.	T	A	21	16	37	0	2	39	0	0
5	61402999	.	T	A	10	16	26	0	2	28	0	0
5	61404563	.	C	T	1	2	3	0	0	3	0	0
5	61405203	.	C	T	2	3	5	0	0	5	0	0
5	61405245	.	C	A	1	3	4	0	0	4	0	0
5	61405885	.	A	G	1	1	2	0	1	3	0	0
5	61405954	.	A	G	4	9	13	0	0	13	0	0
5	61414619	.	C	T	2	7	9	0	0	9	0	0
5	61425708	.	C	T	1	3	4	0	0	4	0	0
5	61425723	.	C	T	1	3	4	0	0	4	0	0
5	61425795	.	G	C	1	3	4	0	0	4	0	0
5	61425800	.	A	G	1	3	4	0	0	4	0	0
5	61428878	.	A	G	1	0	1	0	1	2	0	0
5	61428915	.	C	G	1	4	5	0	0	5	0	0
5	61428984	.	C	T	2	3	5	0	0	5	0	0
5	61429058	.	G	T	3	4	7	0	0	7	0	0
5	61431675	.	G	A	4	2	6	0	0	6	0	0
5	61433102	.	G	T	2	2	4	0	0	4	0	0
5	61433329	.	A	G	2	3	5	0	0	5	0	0
5	61435041	.	G	A	2	3	5	0	0	5	0	0
5	61435047	.	A	G	2	4	6	0	0	6	0	0
5	61459502	.	T	C	1	5	6	0	0	6	0	0
5	61464874	.	G	T	7	7	14	0	3	17	0	0
5	61464900	.	G	T	12	6	18	0	0	18	0	0
5	61472429	.	G	A	7	7	14	0	0	14	0	0
5	61472457	.	C	T	8	6	14	0	0	14	0	0
5	61472543	.	C	G	3	3	6	0	0	6	0	0
5	61472598	.	C	G	1	2	3	0	0	3	0	0
5	61508451	.	A	G	7	8	15	0	0	15	0	0
5	61508648	.	G	T	10	6	16	0	2	18	0	0
5	61548819	.	T	G	18	0	18	0	9	27	0	0
5	61552787	.	T	A	8	12	20	0	4	24	0	0
5	61553022	.	G	A	20	12	32	0	0	32	0	0
5	61553119	.	A	G	2	6	8	0	0	8	0	0
5	61553207	.	C	T	9	7	16	0	0	16	0	0
5	61553309	.	A	G	5	1	6	0	11	17	0	0
5	61553409	.	A	T	14	11	25	0	0	25	0	0
5	61553418	.	G	A	12	14	26	0	0	26	0	0
5	61553452	.	C	T	15	13	28	0	1	29	0	0
5	61553556	.	A	T	8	7	15	0	0	15	0	0
5	61553699	.	G	T	15	8	23	0	1	24	0	0
5	61566819	.	T	C	2	0	2	0	0	2	0	0
5	61584144	.	G	C	6	4	10	0	1	11	0	0
5	61584178	.	T	C	3	1	4	0	1	5	0	0
5	61586142	.	C	A	1	1	2	0	0	2	0	0
5	61660310	.	C	T	2	0	2	0	1	3	0	0
5	61660526	.	C	T	0	1	1	0	0	1	0	0
5	61665215	.	G	A	1	0	1	0	0	1	0	0
5	61668302	.	G	A	0	0	0	0	3	3	0	0
5	61676676	.	T	G	13	0	13	0	7	20	0	0
5	61676700	.	T	G	15	10	25	0	0	25	0	0
5	61676739	.	A	C	8	7	15	0	0	15	0	0
5	61682577	.	C	T	5	7	12	0	1	13	0	0
5	61682715	.	A	C	12	18	30	0	3	33	0	0
5	61682721	.	C	T	13	19	32	0	1	33	0	0
5	61698770	.	C	T	4	2	6	0	0	6	0	0
5	61701969	.	C	A	5	7	12	0	0	12	0	0
5	61706220	.	T	C	7	5	12	0	0	12	0	0
5	61723061	.	G	A	34	25	59	0	5	64	0	0
5	61723481	.	G	T	3	35	38	0	16	54	0	0
5	61723584	.	A	T	19	20	39	0	1	40	0	0
5	61723637	.	A	G	30	16	46	0	1	47	0	0
5	61723674	.	G	A	27	25	52	0	4	56	0	0
5	61723694	.	T	G	23	28	51	0	3	54	0	0
5	61723914	.	T	C	19	30	49	0	2	51	0	0
5	61723979	.	C	T	18	8	26	0	1	27	0	0
5	61724055	.	G	A	1	2	3	0	3	7	1	0
5	61790154	.	C	T	1	5	6	0	0	6	0	0
5	61790157	.	T	C	1	4	5	0	1	6	0	0
5	61793019	.	T	A	1	1	2	0	0	2	0	0
5	61793756	.	T	C	3	1	4	0	0	4	0	0
5	61793811	.	T	C	2	0	2	0	6	8	0	0
5	61793886	.	T	A	5	5	10	0	0	10	0	0
5	61793978	.	C	T	0	1	1	0	0	1	0	0
5	61873987	.	T	C	1	2	3	0	0	3	0	0
5	61951038	.	A	G	8	7	15	0	2	17	0	0
5	62290448	.	A	T	0	12	12	0	0	12	0	0
5	62334694	.	A	T	0	13	13	0	1	14	0	0
5	62639596	.	G	A	17	21	38	0	2	40	0	0
5	62806599	.	T	A	6	5	11	0	0	11	0	0
5	62806675	.	A	G	13	7	20	0	0	20	0	0
5	62806701	.	A	G	9	9	18	0	0	18	0	0
5	62806786	.	C	A	2	4	6	0	0	6	0	0
5	62806867	.	C	T	0	8	8	0	15	23	0	0
5	62806951	.	A	G	6	6	12	0	0	12	0	0
5	62807044	.	T	A	2	3	5	0	0	5	0	0
5	62807258	.	T	A	1	6	7	0	0	7	0	0
5	62807263	.	G	A	1	6	7	0	0	7	0	0
5	62807294	.	G	A	4	4	8	0	0	8	0	0
5	62807357	.	G	A	1	2	3	0	0	3	0	0
5	62860901	.	A	G	2	6	8	0	0	8	0	0
5	62860902	.	G	T	2	5	7	0	1	8	0	0
5	62860943	.	T	C	2	4	6	0	0	6	0	0
5	62860969	.	T	A	1	0	1	0	0	1	0	0
5	62865289	.	G	A	2	2	4	0	0	4	0	0
5	62884052	.	T	C	1	0	1	0	0	1	0	0
5	62889651	.	C	T	13	3	16	0	1	17	0	0
5	62889957	.	G	A	8	3	11	0	0	11	0	0
5	62889966	.	C	G	4	4	8	0	0	8	0	0
5	62890011	.	T	G	4	4	8	0	0	8	0	0
5	62890026	.	G	A	3	5	8	0	0	8	0	0
5	62890642	.	G	A	4	8	12	0	0	12	0	0
5	62890846	.	A	G	2	3	5	0	0	5	0	0
5	62937377	.	T	G	2	4	6	0	0	6	0	0
5	62937410	.	C	A	2	3	5	0	0	5	0	0
5	62937428	.	C	T	0	2	2	0	2	4	0	0
5	62989260	.	C	T	5	7	12	0	1	13	0	0
5	63092339	.	A	G	2	3	5	0	0	5	0	0
5	63248320	.	G	T	1	3	4	0	0	4	0	0
5	63248335	.	A	G	1	3	4	0	0	4	0	0
5	63248433	.	G	A	1	2	3	0	1	4	0	0
5	63248665	.	A	C	4	3	7	0	0	7	0	0
5	63248668	.	T	C	4	3	7	0	0	7	0	0
5	63267269	.	A	G	0	1	1	0	0	1	0	0
5	63273840	.	T	G	1	1	2	0	0	2	0	0
5	63276533	.	A	G	2	4	6	0	1	7	0	0
5	63285995	.	T	G	0	1	1	0	0	1	0	0
5	63305505	.	A	T	3	2	5	0	0	5	0	0
5	63305607	.	G	A	2	3	5	2	0	7	0	0
5	63308418	.	C	T	0	1	1	0	0	1	0	0
5	63310766	.	T	A	2	2	4	0	0	4	0	0
5	63322195	.	G	C	3	2	5	0	0	5	0	0
5	63322568	.	A	T	1	2	3	0	0	4	1	0
5	63329526	.	G	A	0	1	1	0	2	3	0	0
5	63331691	.	A	G	4	2	6	0	0	6	0	0
5	63335216	.	C	A	0	3	3	0	0	3	0	0
5	63338422	.	C	T	5	3	8	1	0	9	0	0
5	63338518	.	A	T	5	2	7	0	0	7	0	0
5	63338557	.	C	T	6	3	9	0	0	9	0	0
5	63338563	.	A	G	5	3	8	0	0	8	0	0
5	63359675	.	T	C	0	1	1	0	0	1	0	0
5	63359680	.	T	C	0	1	1	0	0	1	0	0
5	63359863	.	T	A	1	2	3	0	0	3	0	0
5	63360161	.	T	G	1	0	1	0	2	3	0	0
5	63360290	.	A	G	1	2	3	0	0	3	0	0
5	63360344	.	T	C	1	4	5	0	0	5	0	0
5	63363010	.	G	A	2	4	6	0	0	6	0	0
5	63363058	.	C	T	2	3	5	0	0	5	0	0
5	63394174	.	C	A	11	13	24	0	0	24	0	0
5	63395057	.	A	T	3	6	9	0	1	10	0	0
5	63398847	.	T	C	15	16	31	0	0	31	0	0
5	63398973	.	G	A	15	15	30	0	5	35	0	0
5	63399066	.	G	C	19	22	41	0	0	41	0	0
5	63399111	.	T	A	21	23	44	0	4	48	0	0
5	63399683	.	T	A	20	16	36	0	2	38	0	0
5	63400524	.	T	G	3	2	5	0	0	5	0	0
5	63407169	.	G	A	3	1	4	0	0	4	0	0
5	63510908	.	G	T	10	10	20	0	0	20	0	0
5	63511045	.	A	G	7	8	15	0	1	16	0	0
5	63511110	.	T	C	5	0	5	0	11	16	0	0
5	63511264	.	A	G	2	2	4	0	1	5	0	0
5	63511315	.	A	G	6	5	11	0	0	11	0	0
5	63511788	.	A	T	5	3	8	0	0	8	0	0
5	63511791	.	A	G	4	3	7	0	1	8	0	0
5	63629121	.	C	A	7	4	11	0	1	12	0	0
5	63629136	.	G	A	8	7	15	0	0	15	0	0
5	63629299	.	A	T	8	3	11	0	0	11	0	0
5	63644801	.	T	C	0	0	0	0	3	3	0	0
5	63644850	.	G	A	0	2	2	0	0	3	1	0
5	63648376	.	T	C	2	0	2	0	2	4	0	0
5	63648811	.	A	G	2	1	3	0	1	4	0	0
5	63653276	.	A	G	0	3	3	0	0	3	0	0
5	63655829	.	T	C	0	1	1	0	0	1	0	0
5	63658512	.	G	A	2	3	5	0	0	5	0	0
5	63680655	.	A	G	8	0	8	0	4	12	0	0
5	63680661	.	C	G	6	4	10	0	1	11	0	0
5	63680709	.	T	G	3	1	4	0	0	4	0	0
5	63680718	.	A	G	0	0	0	0	1	1	0	0
5	63681123	.	A	G	0	1	1	0	0	1	0	0
5	63695760	.	C	T	4	4	8	0	0	8	0	0
5	63698549	.	T	C	3	3	6	0	0	6	0	0
5	63699468	.	T	C	0	1	1	0	0	1	0	0
5	63720639	.	A	G	9	8	17	0	2	19	0	0
5	63723807	.	G	A	0	8	8	0	8	16	0	0
5	63730115	.	G	A	0	12	12	0	15	27	0	0
5	63740093	.	C	T	14	10	24	0	0	24	0	0
5	63740097	.	T	A	13	10	23	0	0	23	0	0
5	63740149	.	T	C	12	7	19	0	0	19	0	0
5	63740167	.	A	G	8	8	16	0	2	19	1	0
5	63740465	.	C	A	14	11	25	0	1	26	0	0
5	63740815	.	A	C	20	29	49	0	1	50	0	0
5	63740874	.	A	C	22	26	48	0	1	49	0	0
5	63740895	.	A	C	19	28	47	0	1	48	0	0
5	63740910	.	A	G	21	29	50	0	0	50	0	0
5	63741023	.	T	A	22	6	28	0	1	29	0	0
5	63741077	.	A	T	9	16	25	0	0	25	0	0
5	63848662	.	C	T	4	2	6	0	0	6	0	0
5	63848668	.	G	T	3	1	4	0	2	6	0	0
5	63857154	.	A	C	0	1	1	0	0	1	0	0
5	63857156	.	G	A	0	1	1	0	0	1	0	0
5	63860815	.	C	T	5	6	11	0	0	11	0	0
5	63860936	.	A	G	3	2	5	0	0	5	0	0
5	63860943	.	A	G	3	0	3	0	2	5	0	0
5	63862209	.	G	A	0	2	2	0	2	4	0	0
5	63862696	.	C	A	2	2	4	0	0	4	0	0
5	63862709	.	G	A	2	2	4	0	0	4	0	0
5	63863537	.	G	T	3	3	6	0	0	6	0	0
5	63863538	.	T	C	3	3	6	0	0	6	0	0
5	63863945	.	G	C	5	2	7	0	0	7	0	0
5	63864117	.	C	T	11	7	18	0	1	19	0	0
5	63864150	.	T	C	7	5	12	0	1	13	0	0
5	64413842	.	C	T	14	4	18	0	0	18	0	0
5	64849349	.	C	T	3	0	3	0	0	8	5	0
5	64863673	.	T	C	2	2	4	0	0	4	0	0
5	66252054	.	G	A	0	0	0	0	1	1	0	0
5	66266997	.	A	G	4	3	7	0	0	7	0	0
5	66268964	.	A	G	1	1	2	0	2	4	0	0
5	66271189	.	G	A	4	1	5	0	0	5	0	0
5	66271214	.	C	T	5	3	8	0	1	9	0	0
5	66389676	.	C	T	0	2	2	0	0	2	0	0
5	66676766	.	C	G	5	2	7	0	0	7	0	0
5	66676768	.	G	A	5	2	7	0	0	7	0	0
5	66699135	.	G	T	7	12	19	0	1	20	0	0
5	66699138	.	C	G	9	12	21	0	0	21	0	0
5	66699564	.	G	T	5	3	8	0	1	9	0	0
5	66700388	.	C	T	4	2	6	0	1	7	0	0
5	66700602	.	T	A	3	4	7	0	0	7	0	0
5	66700608	.	T	C	3	4	7	0	0	7	0	0
5	66700734	.	C	A	0	2	2	0	6	8	0	0
5	66700833	.	T	C	5	0	5	0	6	11	0	0
5	66700974	.	T	A	4	3	7	0	0	7	0	0
5	66701493	.	T	C	2	8	10	0	1	11	0	0
5	66702411	.	G	A	2	2	4	0	0	4	0	0
5	66733482	.	C	G	2	2	4	0	0	4	0	0
5	66733572	.	C	T	0	6	6	0	5	11	0	0
5	66733682	.	T	C	16	10	26	0	1	27	0	0
5	66733694	.	T	C	16	1	17	0	12	29	0	0
5	66733891	.	G	C	12	6	18	0	0	18	0	0
5	66736211	.	T	C	2	2	4	0	0	4	0	0
5	66736280	.	A	G	8	9	17	0	2	19	0	0
5	66740183	.	A	T	9	4	13	0	1	14	0	0
5	66740239	.	T	G	7	3	10	0	0	10	0	0
5	66807482	.	C	T	13	14	27	0	2	29	0	0
5	66807543	.	C	T	0	26	26	0	17	43	0	0
5	66807735	.	A	G	8	13	21	0	2	23	0	0
5	66807771	.	T	G	10	14	24	0	1	25	0	0
5	66807788	.	C	T	0	13	13	0	11	24	0	0
5	66807830	.	G	A	5	14	19	0	1	20	0	0
5	66807831	.	A	G	5	14	19	0	1	20	0	0
5	66807881	.	A	G	12	10	22	0	0	22	0	0
5	66807916	.	T	C	19	17	36	0	2	38	0	0
5	66813647	.	T	C	8	2	10	0	5	15	0	0
5	66813674	.	G	A	9	8	17	0	0	17	0	0
5	66813722	.	A	G	1	0	1	0	0	1	0	0
5	66814504	.	T	C	3	5	8	0	0	8	0	0
5	66814522	.	A	G	5	5	10	0	0	10	0	0
5	66818699	.	C	T	8	8	16	0	3	19	0	0
5	66819515	.	T	C	7	12	19	0	1	20	0	0
5	66820859	.	A	T	5	10	15	0	1	16	0	0
5	68766688	.	T	C	6	0	6	0	10	16	0	0
5	68766704	.	C	T	11	6	17	0	2	19	0	0
5	68767050	.	C	T	0	18	18	0	8	26	0	0
5	68767439	.	G	T	5	3	8	0	0	8	0	0
5	68767642	.	A	C	4	8	12	0	0	12	0	0
5	68767802	.	G	A	2	2	4	0	0	4	0	0
5	68778040	.	G	T	4	3	7	0	1	8	0	0
5	68778455	.	T	A	4	8	12	0	1	13	0	0
5	68778524	.	C	A	0	7	7	0	7	14	0	0
5	68778746	.	C	G	0	5	5	0	6	11	0	0
5	68778895	.	C	G	8	4	12	0	0	12	0	0
5	68778957	.	G	T	7	2	9	0	0	9	0	0
5	68779049	.	A	G	4	5	9	0	0	9	0	0
5	68779214	.	A	G	5	4	9	0	2	11	0	0
5	68779472	.	G	T	7	6	13	0	0	13	0	0
5	68779595	.	G	T	6	4	10	0	0	10	0	0
5	68782584	.	C	T	7	2	9	0	0	9	0	0
5	68831382	.	C	T	1	2	3	0	0	3	0	0
5	68832435	.	A	G	1	0	1	0	0	1	0	0
5	68840928	.	T	C	2	1	3	0	0	3	0	0
5	68846542	.	G	T	1	1	2	0	0	2	0	0
5	68848116	.	G	A	5	0	5	0	0	5	0	0
5	68850967	.	C	G	0	6	6	0	6	12	0	0
5	68860776	.	A	C	1	0	1	0	1	2	0	0
5	68863784	.	C	T	0	8	8	0	1	9	0	0
5	68863806	.	T	C	3	0	3	0	8	11	0	0
5	68892515	.	A	C	1	1	2	0	0	2	0	0
5	68892601	.	T	C	3	3	6	0	0	6	0	0
5	68892801	.	G	A	1	8	9	0	1	10	0	0
5	68900820	.	C	G	6	8	14	0	0	14	0	0
5	68900825	.	G	A	6	5	11	0	1	12	0	0
5	68900891	.	C	T	0	0	0	0	1	1	0	0
5	68927410	.	T	A	1	0	1	0	0	1	0	0
5	68927539	.	G	A	5	4	9	0	0	9	0	0
5	68927557	.	G	A	4	5	9	0	0	9	0	0
5	68927591	.	G	A	4	3	7	0	0	7	0	0
5	68963602	.	A	T	2	2	4	0	0	4	0	0
5	68982340	.	G	A	1	5	6	0	1	7	0	0
5	68996186	.	C	T	1	1	2	0	0	2	0	0
5	69008453	.	A	C	2	0	2	0	2	4	0	0
5	69140658	.	T	C	5	1	6	0	0	6	0	0
5	69140680	.	T	A	2	5	7	0	0	7	0	0
5	69141307	.	G	A	7	3	10	0	0	10	0	0
5	69141440	.	G	T	10	11	21	0	1	22	0	0
5	69144428	.	C	T	0	6	6	0	5	11	0	0
5	69155281	.	G	A	1	2	3	1	0	4	0	0
5	69235583	.	G	A	0	1	1	0	0	1	0	0
5	69235589	.	A	C	0	1	1	0	0	1	0	0
5	69259068	.	C	T	0	1	1	0	0	1	0	0
5	69278192	.	A	G	10	0	10	0	22	32	0	0
5	69287061	.	C	T	8	4	12	0	0	12	0	0
5	69287180	.	A	T	18	15	33	0	0	33	0	0
5	69287264	.	C	G	11	10	21	0	0	21	0	0
5	69287498	.	C	T	2	9	11	0	0	11	0	0
5	69290940	.	G	T	3	2	5	0	0	5	0	0
5	69290962	.	A	G	1	3	4	0	0	4	0	0
5	69290980	.	C	T	1	2	3	0	0	3	0	0
5	69316105	.	T	G	1	2	3	0	0	3	0	0
5	69316129	.	C	T	1	2	3	0	0	3	0	0
5	69427984	.	A	G	17	19	36	0	0	36	0	0
5	69428056	.	A	T	5	7	12	0	0	12	0	0
5	69428148	.	T	C	2	4	6	0	0	6	0	0
5	69429544	.	G	A	15	18	33	0	3	36	0	0
5	69431287	.	G	C	13	10	23	0	1	24	0	0
5	69462882	.	G	A	2	0	2	0	0	2	0	0
5	69462894	.	C	T	0	2	2	0	0	2	0	0
5	69463008	.	C	A	0	1	1	0	0	1	0	0
5	69463077	.	G	A	5	5	10	0	1	11	0	0
5	69464731	.	G	A	7	2	9	0	0	9	0	0
5	69464773	.	G	A	10	3	13	0	0	13	0	0
5	69464811	.	C	T	0	3	3	0	3	6	0	0
5	69466375	.	G	T	0	1	1	0	1	2	0	0
5	69469336	.	G	A	0	2	2	0	0	2	0	0
5	69486618	.	T	C	7	7	14	0	1	15	0	0
5	69486698	.	G	A	5	6	11	0	1	12	0	0
5	69486749	.	A	T	7	10	17	0	2	19	0	0
5	69486756	.	G	A	7	12	19	0	0	19	0	0
5	69486844	.	G	T	1	3	4	0	0	4	0	0
5	69491754	.	G	A	7	4	11	0	0	11	0	0
5	69491766	.	T	C	8	0	8	0	5	13	0	0
5	69492039	.	A	G	0	5	5	0	0	5	0	0
5	69492126	.	G	C	3	0	3	0	4	7	0	0
5	69557764	.	A	G	4	1	5	0	0	5	0	0
5	69557776	.	G	T	5	1	6	0	0	6	0	0
5	69574886	.	A	G	4	5	9	0	0	9	0	0
5	69574972	.	G	T	14	13	27	0	1	28	0	0
5	69579118	.	T	C	4	1	5	0	7	12	0	0
5	69579378	.	G	A	3	0	3	0	0	3	0	0
5	69579435	.	A	C	0	2	2	0	0	2	0	0
5	69588720	.	A	T	0	5	5	0	0	5	0	0
5	69595361	.	G	A	1	6	7	0	0	7	0	0
5	69599798	.	G	T	0	1	1	0	0	1	0	0
5	69607398	.	T	C	0	2	2	0	0	2	0	0
5	69616625	.	A	T	1	0	1	0	0	1	0	0
5	69666561	.	C	G	1	2	3	0	0	3	0	0
5	69907537	.	T	C	7	4	11	0	0	11	0	0
5	69927246	.	A	C	1	2	3	0	0	3	0	0
5	70183091	.	T	C	17	15	32	1	0	33	0	0
6	28313	.	G	A	6	5	11	0	0	11	0	0
6	29439	.	T	C	18	9	27	0	2	29	0	0
6	32147	.	A	G	0	0	0	0	1	1	0	0
6	32436	.	G	A	0	3	3	0	2	5	0	0
6	35464	.	G	C	3	2	5	0	0	5	0	0
6	37050	.	C	T	4	2	6	0	0	6	0	0
6	37919	.	C	T	8	5	13	0	0	13	0	0
6	38168	.	C	T	2	2	4	0	0	4	0	0
6	41065	.	A	T	8	10	18	0	0	18	0	0
6	41164	.	A	G	6	3	9	0	8	17	0	0
6	42301	.	A	T	10	11	21	1	2	24	0	0
6	58559	.	G	A	0	4	4	0	5	9	0	0
6	59048	.	C	T	6	5	11	0	0	11	0	0
6	59171	.	G	A	3	7	10	0	1	11	0	0
6	59459	.	T	C	2	5	7	0	0	7	0	0
6	59465	.	G	A	2	4	6	0	1	7	0	0
6	68277	.	A	T	2	5	7	0	0	7	0	0
6	92359	.	T	G	8	6	14	0	1	15	0	0
6	92383	.	A	G	7	5	12	0	1	13	0	0
6	93840	.	T	C	16	7	23	0	1	24	0	0
6	93966	.	A	G	2	1	3	0	0	3	0	0
6	102633	.	T	C	2	2	4	0	0	4	0	0
6	121239	.	C	T	7	5	12	0	0	12	0	0
6	132157	.	G	C	9	4	13	0	1	14	0	0
6	132867	.	C	T	10	4	14	0	0	14	0	0
6	132868	.	A	G	10	4	14	0	0	14	0	0
6	134267	.	C	G	3	8	11	0	0	11	0	0
6	134270	.	C	T	0	9	9	0	3	12	0	0
6	136988	.	A	T	2	3	5	0	0	5	0	0
6	152306	.	A	G	3	0	3	0	3	6	0	0
6	152680	.	T	A	10	4	14	0	0	15	1	0
6	169959	.	A	C	1	3	4	0	1	5	0	0
6	184361	.	C	T	4	12	16	0	0	16	0	0
6	184382	.	A	G	3	0	3	0	7	10	0	0
6	202561	.	T	C	6	3	9	0	0	9	0	0
6	202699	.	C	A	0	1	1	0	0	1	0	0
6	203950	.	A	T	4	6	10	0	0	10	0	0
6	204004	.	C	T	8	8	16	0	0	16	0	0
6	204014	.	A	C	7	8	15	0	0	15	0	0
6	204106	.	G	A	0	2	2	0	4	6	0	0
6	204354	.	T	C	2	4	6	0	0	6	0	0
6	204385	.	C	T	2	3	5	0	1	6	0	0
6	204952	.	T	C	7	6	13	0	0	13	0	0
6	205090	.	T	C	6	3	9	0	0	9	0	0
6	205102	.	G	A	7	4	11	0	0	11	0	0
6	205159	.	T	C	5	9	14	0	2	16	0	0
6	205258	.	G	A	1	10	11	0	6	17	0	0
6	265188	.	G	T	10	12	22	0	0	22	0	0
6	265191	.	A	T	11	11	22	0	1	23	0	0
6	265837	.	G	A	6	5	11	0	0	11	0	0
6	267412	.	C	T	10	2	12	0	1	13	0	0
6	267568	.	A	G	10	4	14	0	1	15	0	0
6	267645	.	C	T	6	7	13	0	0	13	0	0
6	267669	.	C	T	5	6	11	0	0	11	0	0
6	267720	.	C	G	4	4	8	0	0	8	0	0
6	267817	.	G	A	6	11	17	0	0	17	0	0
6	267884	.	T	C	6	4	10	0	0	10	0	0
6	267886	.	T	C	6	4	10	0	0	10	0	0
6	271793	.	C	A	19	27	46	0	3	49	0	0
6	272041	.	C	T	27	19	46	0	2	48	0	0
6	272056	.	A	G	26	18	44	0	3	47	0	0
6	272194	.	A	G	35	0	35	0	11	46	0	0
6	272298	.	G	A	0	20	20	0	27	47	0	0
6	272503	.	T	C	9	12	21	0	1	22	0	0
6	322371	.	C	T	5	3	8	0	1	9	0	0
6	331909	.	T	A	7	8	15	0	1	16	0	0
6	331912	.	C	T	7	11	18	0	0	18	0	0
6	340480	.	A	C	29	12	41	0	0	41	0	0
6	340488	.	T	C	14	13	27	0	4	31	0	0
6	340670	.	A	G	20	16	36	0	1	37	0	0
6	340800	.	T	G	12	13	25	0	0	25	0	0
6	340839	.	A	G	10	4	14	0	1	15	0	0
6	340931	.	G	A	5	7	12	0	1	13	0	0
6	341882	.	G	A	25	16	41	0	2	43	0	0
6	341933	.	G	A	22	25	47	0	0	47	0	0
6	341953	.	C	T	25	28	53	0	0	53	0	0
6	342017	.	T	A	15	20	35	0	2	37	0	0
6	342123	.	C	T	12	18	30	0	1	31	0	0
6	374956	.	T	A	8	11	19	0	0	19	0	0
6	374988	.	G	T	8	8	16	0	1	17	0	0
6	375007	.	A	C	7	9	16	0	0	16	0	0
6	375051	.	T	C	2	1	3	0	4	7	0	0
6	543429	.	C	T	1	5	6	0	0	6	0	0
6	840792	.	C	G	9	24	33	0	0	33	0	0
6	841511	.	T	C	10	11	21	0	0	21	0	0
6	841557	.	A	G	21	9	30	0	0	30	0	0
6	841851	.	T	C	12	14	26	0	0	26	0	0
6	841941	.	G	A	11	9	20	1	2	23	0	0
6	842009	.	G	A	16	12	28	0	2	30	0	0
6	842010	.	C	T	0	12	12	0	18	30	0	0
6	842149	.	A	T	16	8	24	0	0	26	2	0
6	842192	.	T	C	12	0	12	0	13	25	0	0
6	842241	.	T	C	11	6	17	0	0	17	0	0
6	842264	.	T	C	14	7	21	0	0	21	0	0
6	842391	.	T	C	8	5	13	0	0	13	0	0
6	842461	.	C	T	5	4	9	0	2	11	0	0
6	842739	.	C	T	1	12	13	0	8	21	0	0
6	842791	.	C	A	14	19	33	0	2	35	0	0
6	842816	.	A	C	20	10	30	0	0	30	0	0
6	843745	.	C	A	6	6	12	0	1	13	0	0
6	843836	.	G	A	11	6	17	0	0	17	0	0
6	844146	.	G	T	8	4	12	0	1	13	0	0
6	844164	.	C	T	5	9	14	0	0	14	0	0
6	844209	.	G	A	2	6	8	0	0	8	0	0
6	844282	.	T	C	4	5	9	0	0	9	0	0
6	844337	.	A	G	3	6	9	0	0	9	0	0
6	844388	.	A	G	17	5	22	0	0	22	0	0
6	858026	.	C	T	0	10	10	0	9	19	0	0
6	858128	.	C	T	0	8	8	0	18	26	0	0
6	858713	.	A	G	9	13	22	0	0	22	0	0
6	858961	.	A	G	6	2	8	0	0	8	0	0
6	859364	.	C	T	5	9	14	0	1	15	0	0
6	859907	.	A	G	4	2	6	0	0	6	0	0
6	859910	.	C	T	3	2	5	0	0	5	0	0
6	869374	.	T	C	1	1	2	0	0	2	0	0
6	1494882	.	G	A	4	6	10	0	0	10	0	0
6	1511685	.	A	G	2	4	6	0	0	6	0	0
6	1535603	.	G	T	1	5	6	0	0	6	0	0
6	1538150	.	G	A	3	0	3	0	0	3	0	0
6	1539074	.	G	A	1	0	1	0	0	1	0	0
6	1539129	.	G	A	0	3	3	0	0	3	0	0
6	1539135	.	A	G	0	2	2	0	0	2	0	0
6	1544724	.	G	A	0	2	2	0	0	2	0	0
6	1555015	.	C	T	1	2	3	0	1	4	0	0
6	1555034	.	T	G	4	2	6	0	0	6	0	0
6	1562026	.	A	C	3	3	6	0	0	6	0	0
6	1562230	.	G	A	2	2	4	0	0	4	0	0
6	1581491	.	T	A	1	2	3	0	0	3	0	0
6	1780069	.	T	C	5	17	22	0	0	22	0	0
6	1797668	.	T	A	1	6	7	0	0	8	1	0
6	1797681	.	G	A	4	2	6	0	0	6	0	0
6	1798645	.	T	G	2	4	6	0	0	6	0	0
6	1798716	.	T	G	5	9	14	0	0	14	0	0
6	1799112	.	A	T	2	4	6	0	0	6	0	0
6	1833542	.	C	T	0	3	3	0	0	3	0	0
6	1838527	.	C	T	2	7	9	0	0	9	0	0
6	1843300	.	G	C	1	0	1	0	3	4	0	0
6	1843315	.	C	T	0	2	2	0	3	5	0	0
6	1843342	.	C	T	0	2	2	0	3	5	0	0
6	1843423	.	C	G	0	4	4	0	2	6	0	0
6	1874191	.	A	G	2	2	4	0	0	4	0	0
6	2091200	.	G	A	1	2	3	0	0	3	0	0
6	2091268	.	T	C	2	1	3	0	0	3	0	0
6	2091278	.	G	A	1	1	2	0	1	3	0	0
6	2118355	.	C	G	1	4	5	0	0	5	0	0
6	2118418	.	G	T	2	1	3	0	0	3	0	0
6	2120821	.	A	C	1	2	3	0	0	3	0	0
6	2126043	.	G	A	2	3	5	0	0	5	0	0
6	2126320	.	G	A	2	3	5	0	0	5	0	0
6	2126486	.	T	A	3	5	8	0	0	8	0	0
6	2126512	.	C	T	6	4	10	0	0	10	0	0
6	2165703	.	T	G	3	3	6	0	0	6	0	0
6	2165735	.	A	T	3	3	6	0	0	6	0	0
6	2165955	.	A	G	4	5	9	0	0	9	0	0
6	2165982	.	A	T	7	4	11	0	0	11	0	0
6	2166074	.	G	A	1	6	7	0	0	7	0	0
6	2166085	.	T	G	1	5	6	0	0	6	0	0
6	2166157	.	G	A	5	8	13	0	0	13	0	0
6	2166240	.	T	C	3	0	3	0	8	11	0	0
6	2166287	.	A	T	2	2	4	0	0	4	0	0
6	2166531	.	A	T	4	3	7	0	1	8	0	0
6	2166690	.	T	A	2	2	4	0	0	4	0	0
6	2170215	.	A	C	2	0	2	0	0	2	0	0
6	2190325	.	T	A	3	2	5	0	0	5	0	0
6	2190337	.	C	T	2	2	4	0	1	5	0	0
6	2190857	.	C	T	2	5	7	0	0	7	0	0
6	2198105	.	G	C	5	5	10	0	1	11	0	0
6	2198659	.	A	G	2	3	5	0	0	5	0	0
6	2206682	.	C	T	3	7	10	0	0	10	0	0
6	2206704	.	G	T	3	4	7	0	0	7	0	0
6	2206884	.	G	A	4	8	12	0	0	12	0	0
6	2208261	.	A	T	4	6	10	0	0	10	0	0
6	2208479	.	T	G	10	2	12	0	0	12	0	0
6	2208522	.	T	C	5	4	9	0	0	9	0	0
6	2208562	.	C	T	5	5	10	0	2	12	0	0
6	2208609	.	C	T	6	7	13	0	1	14	0	0
6	2208655	.	A	G	3	5	8	0	0	8	0	0
6	2210120	.	A	G	3	3	6	0	0	6	0	0
6	2215208	.	T	A	5	5	10	0	1	11	0	0
6	2217689	.	C	T	0	0	0	0	3	3	0	0
6	2271637	.	A	C	6	3	9	0	0	9	0	0
6	2384828	.	C	T	3	1	4	0	0	4	0	0
6	2391475	.	G	A	0	5	5	0	1	6	0	0
6	2453730	.	T	C	1	2	3	0	0	3	0	0
6	2453751	.	A	C	5	6	11	0	1	12	0	0
6	2560464	.	C	T	0	1	1	0	0	1	0	0
6	2586037	.	A	G	1	0	1	0	2	3	0	0
6	2620078	.	C	G	3	7	10	0	0	10	0	0
6	2621637	.	C	G	1	4	5	0	6	11	0	0
6	2621656	.	G	A	8	8	16	0	0	16	0	0
6	2621677	.	C	T	8	6	14	0	0	14	0	0
6	2621719	.	T	A	1	2	3	0	0	3	0	0
6	2623378	.	G	C	1	2	3	0	0	3	0	0
6	2624527	.	G	C	2	3	5	0	0	5	0	0
6	3005215	.	T	C	0	1	1	0	0	1	0	0
6	3142968	.	T	C	1	3	4	0	0	4	0	0
6	3143019	.	C	T	2	2	4	0	0	4	0	0
6	3143292	.	T	A	4	3	7	0	0	7	0	0
6	3197028	.	C	T	6	6	12	0	0	12	0	0
6	3205538	.	T	C	4	10	14	0	0	14	0	0
6	3223245	.	C	T	4	4	8	0	0	8	0	0
6	3223341	.	C	G	2	0	2	0	0	2	0	0
6	3268327	.	T	C	4	4	8	0	0	8	0	0
6	3270011	.	G	A	6	10	16	0	1	17	0	0
6	3273341	.	T	A	8	8	16	0	0	16	0	0
6	3273379	.	A	G	6	8	14	0	0	14	0	0
6	3273588	.	A	T	7	9	16	0	3	19	0	0
6	3273826	.	A	T	15	17	32	0	2	34	0	0
6	3273965	.	C	T	15	20	35	0	1	36	0	0
6	3273986	.	T	C	14	25	39	0	0	39	0	0
6	3274114	.	G	C	1	21	22	0	21	43	0	0
6	3274289	.	C	T	14	18	32	0	0	32	0	0
6	3298797	.	C	T	1	0	1	0	0	1	0	0
6	3302599	.	C	T	2	1	3	0	0	3	0	0
6	3309358	.	C	T	7	5	12	0	0	12	0	0
6	3312627	.	C	T	3	1	4	0	1	5	0	0
6	3312750	.	A	T	1	0	1	0	0	1	0	0
6	3318673	.	T	C	5	2	7	0	0	7	0	0
6	3319073	.	A	G	1	2	3	0	0	3	0	0
6	3334437	.	G	A	1	4	5	0	0	5	0	0
6	3343800	.	T	C	1	2	3	0	0	3	0	0
6	3395649	.	C	T	0	1	1	0	0	1	0	0
6	3398876	.	A	G	1	0	1	0	2	3	0	0
6	3398906	.	A	G	3	3	6	0	0	6	0	0
6	3404956	.	G	A	0	3	3	0	3	6	0	0
6	3405060	.	G	A	0	10	10	0	1	11	0	0
6	3405143	.	T	C	8	8	16	0	0	16	0	0
6	3405191	.	G	C	8	7	15	0	1	16	0	0
6	3405244	.	A	G	1	10	11	0	0	11	0	0
6	3405245	.	C	A	1	10	11	0	0	11	0	0
6	3499159	.	T	A	1	3	4	0	0	4	0	0
6	3514481	.	A	C	25	16	41	0	1	42	0	0
6	3564344	.	A	G	1	2	3	0	0	3	0	0
6	3698558	.	C	T	1	2	3	0	0	3	0	0
6	3704391	.	G	A	0	1	1	0	1	2	0	0
6	3707095	.	A	G	4	9	13	0	0	13	0	0
6	3707116	.	G	A	9	11	20	0	0	20	0	0
6	3707371	.	G	A	0	10	10	0	11	21	0	0
6	3707372	.	A	G	10	10	20	0	1	21	0	0
6	3707407	.	T	C	7	14	21	0	4	25	0	0
6	3708061	.	A	G	9	7	16	0	0	16	0	0
6	3708149	.	T	C	7	6	13	0	1	14	0	0
6	3711200	.	T	A	2	5	7	0	0	7	0	0
6	3711221	.	A	G	4	7	11	0	1	12	0	0
6	3711282	.	T	G	10	2	12	0	11	23	0	0
6	3711338	.	A	G	7	8	15	0	0	15	0	0
6	3711386	.	T	C	7	6	13	0	0	13	0	0
6	3711419	.	A	G	3	5	8	0	1	9	0	0
6	3711448	.	C	A	4	3	7	0	0	7	0	0
6	3711616	.	G	A	3	6	9	0	0	9	0	0
6	3711971	.	G	A	3	3	6	0	0	6	0	0
6	3712045	.	T	A	5	5	10	0	0	10	0	0
6	3712069	.	A	T	5	4	9	0	0	9	0	0
6	3712136	.	G	A	4	3	7	0	0	7	0	0
6	3712198	.	G	T	2	10	12	0	0	12	0	0
6	3712199	.	A	C	1	10	11	0	1	12	0	0
6	3712238	.	A	T	7	12	19	0	0	19	0	0
6	3712264	.	A	C	11	9	20	0	0	20	0	0
6	3712335	.	T	G	7	0	7	0	8	15	0	0
6	3712389	.	C	T	5	4	9	0	0	9	0	0
6	3712433	.	A	T	4	2	6	0	0	6	0	0
6	3717060	.	T	A	0	1	1	0	0	1	0	0
6	3717843	.	C	T	2	1	3	0	0	3	0	0
6	3724870	.	A	C	10	13	23	0	0	23	0	0
6	3725767	.	C	A	14	12	26	0	1	27	0	0
6	3727891	.	C	T	16	6	22	0	2	24	0	0
6	3728295	.	A	T	6	5	11	0	0	11	0	0
6	3812470	.	T	C	1	2	3	0	0	3	0	0
6	3827894	.	C	A	8	14	22	0	1	23	0	0
6	3834630	.	G	C	22	17	39	0	1	40	0	0
6	3853120	.	T	G	16	0	16	0	13	29	0	0
6	3853165	.	T	C	18	13	31	0	0	31	0	0
6	3862018	.	A	G	12	18	30	0	1	31	0	0
6	3867542	.	A	T	0	2	2	0	0	2	0	0
6	3869454	.	G	A	0	9	9	0	5	14	0	0
6	3869891	.	C	T	8	6	14	0	0	14	0	0
6	3871982	.	T	A	6	4	10	0	2	12	0	0
6	3874504	.	G	A	0	15	15	0	27	42	0	0
6	3874533	.	C	T	24	17	41	0	0	41	0	0
6	3874686	.	A	G	13	13	26	0	1	27	0	0
6	3878513	.	T	A	5	6	11	0	0	11	0	0
6	3878593	.	A	G	6	9	15	0	0	15	0	0
6	3878831	.	G	C	7	6	13	0	1	14	0	0
6	3878983	.	A	T	7	8	15	0	3	18	0	0
6	3879158	.	A	G	11	7	18	0	2	20	0	0
6	3879247	.	C	A	0	12	12	0	7	19	0	0
6	3879314	.	C	G	0	10	10	0	11	21	0	0
6	3879335	.	C	T	5	10	15	0	1	16	0	0
6	3879367	.	G	A	1	4	5	0	0	5	0	0
6	3881078	.	G	A	3	1	4	0	0	4	0	0
6	3885451	.	C	T	11	12	23	0	0	23	0	0
6	3895442	.	A	T	2	1	3	0	0	3	0	0
6	3895460	.	C	T	0	4	4	0	5	9	0	0
6	3901120	.	C	T	0	1	1	0	2	3	0	0
6	3907796	.	A	T	8	4	12	0	2	14	0	0
6	3944518	.	G	T	0	1	1	0	0	1	0	0
6	3950309	.	C	T	1	3	4	0	0	4	0	0
6	3953280	.	T	C	2	4	6	0	0	6	0	0
6	3953302	.	A	C	3	4	7	0	0	7	0	0
6	3961387	.	G	A	5	4	9	0	0	9	0	0
6	3962132	.	G	A	20	22	42	0	3	45	0	0
6	3962192	.	A	T	11	11	22	0	0	22	0	0
6	3965389	.	G	T	2	4	6	0	0	6	0	0
6	3965461	.	A	G	9	7	16	0	0	16	0	0
6	3973572	.	G	A	1	1	2	0	0	2	0	0
6	3973638	.	T	G	3	2	5	0	0	5	0	0
6	3974047	.	G	A	1	4	5	0	1	6	0	0
6	3985083	.	G	A	7	6	13	0	1	14	0	0
6	3985137	.	G	A	9	13	22	0	2	24	0	0
6	4185678	.	G	A	13	13	26	0	1	27	0	0
6	4191449	.	C	T	6	7	13	0	0	13	0	0
6	4191554	.	A	T	3	5	8	0	0	8	0	0
6	4192031	.	A	G	1	1	2	0	0	2	0	0
6	4204117	.	G	T	0	2	2	0	0	2	0	0
6	4219856	.	G	A	3	5	8	0	0	8	0	0
6	4229854	.	A	G	1	2	3	0	0	3	0	0
6	4241945	.	C	T	1	0	1	0	0	1	0	0
6	4241954	.	A	G	1	1	2	0	0	2	0	0
6	4246466	.	T	C	4	0	4	0	0	4	0	0
6	4246638	.	A	C	1	3	4	0	0	4	0	0
6	4247011	.	A	G	1	3	4	0	0	4	0	0
6	4247755	.	C	T	2	2	4	0	0	4	0	0
6	4247928	.	C	T	4	2	6	0	1	7	0	0
6	4248231	.	A	G	4	0	4	0	5	9	0	0
6	4248307	.	G	A	0	3	3	0	1	4	0	0
6	4248399	.	A	T	6	2	8	0	0	8	0	0
6	4248412	.	T	A	5	2	7	0	1	8	0	0
6	4248527	.	T	A	2	6	8	0	1	9	0	0
6	4248562	.	C	T	1	3	4	0	0	4	0	0
6	4248563	.	T	A	1	3	4	0	0	4	0	0
6	4249420	.	C	T	0	5	5	0	0	5	0	0
6	4249437	.	A	G	2	4	6	0	0	6	0	0
6	4249684	.	A	G	3	5	8	0	1	9	0	0
6	4249821	.	G	A	3	5	8	0	0	8	0	0
6	4250046	.	A	T	3	3	6	0	0	6	0	0
6	4314415	.	A	T	1	3	4	0	0	4	0	0
6	4314446	.	C	T	0	2	2	0	0	2	0	0
6	4334616	.	T	G	0	0	0	0	2	2	0	0
6	4347490	.	C	A	1	1	2	0	0	2	0	0
6	4347505	.	A	T	1	2	3	0	0	3	0	0
6	4352140	.	G	T	1	2	3	0	0	3	0	0
6	4360110	.	C	T	3	1	4	0	0	4	0	0
6	4365163	.	C	T	3	5	8	0	1	9	0	0
6	4365295	.	G	C	6	9	15	0	0	15	0	0
6	4377182	.	A	G	0	1	1	0	0	1	0	0
6	4379760	.	G	A	0	6	6	0	2	8	0	0
6	4386999	.	C	T	4	3	7	0	0	7	0	0
6	4389434	.	G	A	1	0	1	0	0	1	0	0
6	4389436	.	T	C	0	1	1	0	0	1	0	0
6	4392639	.	C	T	8	4	12	0	1	13	0	0
6	4397173	.	G	A	4	11	15	0	2	17	0	0
6	4397181	.	C	A	3	16	19	0	1	20	0	0
6	4397262	.	C	T	3	0	3	0	0	3	0	0
6	4398906	.	C	T	3	5	8	0	0	8	0	0
6	4398939	.	A	C	1	2	3	0	0	3	0	0
6	4400803	.	T	A	6	2	8	0	1	9	0	0
6	4400999	.	C	T	7	6	13	0	0	13	0	0
6	4401087	.	T	A	4	8	12	0	0	12	0	0
6	4401088	.	A	T	4	8	12	0	0	12	0	0
6	4416859	.	G	A	2	4	6	0	0	6	0	0
6	4417007	.	G	A	4	3	7	0	1	8	0	0
6	4540115	.	C	A	1	2	3	0	0	3	0	0
6	4540422	.	A	G	1	1	2	0	0	2	0	0
6	4541178	.	T	C	6	7	13	0	0	13	0	0
6	4542260	.	G	A	0	5	5	0	5	10	0	0
6	4542492	.	A	G	3	0	3	0	3	6	0	0
6	4542573	.	A	C	8	8	16	0	0	16	0	0
6	4874563	.	C	T	2	2	4	0	0	4	0	0
6	4874821	.	G	C	2	2	4	0	0	4	0	0
6	4875292	.	C	T	1	2	3	0	0	3	0	0
6	4876522	.	G	C	0	6	6	0	1	7	0	0
6	4876738	.	G	A	6	8	14	0	0	14	0	0
6	4876946	.	C	A	2	6	8	0	0	8	0	0
6	4877023	.	C	T	4	6	10	0	0	10	0	0
6	6231040	.	A	T	3	2	5	0	1	6	0	0
6	6231117	.	T	C	5	4	9	0	0	9	0	0
6	6231186	.	C	A	8	1	9	0	0	9	0	0
6	6231244	.	T	C	3	8	11	0	0	11	0	0
6	6231262	.	T	C	10	3	13	0	1	14	0	0
6	6231321	.	C	A	4	4	8	0	1	9	0	0
6	6231337	.	A	C	4	4	8	0	0	8	0	0
6	6232301	.	A	C	34	20	54	0	0	54	0	0
6	6232315	.	T	C	32	1	33	0	21	54	0	0
6	6258045	.	G	C	4	0	4	0	3	7	0	0
6	6258130	.	C	T	6	5	11	0	0	11	0	0
6	6258239	.	C	T	0	3	3	0	4	7	0	0
6	6258240	.	A	G	3	4	7	0	0	7	0	0
6	6270811	.	C	G	2	3	5	0	0	5	0	0
6	6270833	.	T	G	2	3	5	0	0	5	0	0
6	6270882	.	G	C	0	3	3	0	0	3	0	0
6	6273345	.	C	T	30	42	72	0	2	74	0	0
6	6273396	.	C	T	29	30	59	0	1	60	0	0
6	6275574	.	G	A	1	6	7	0	0	7	0	0
6	6275599	.	A	G	2	7	9	0	0	9	0	0
6	6275667	.	C	T	3	7	10	0	0	10	0	0
6	6275668	.	A	G	3	7	10	0	0	10	0	0
6	6284114	.	A	G	2	3	5	0	0	5	0	0
6	6293926	.	T	C	1	0	1	0	0	1	0	0
6	6308018	.	A	G	1	1	2	0	0	2	0	0
6	6395096	.	C	T	0	4	4	0	2	6	0	0
6	6395211	.	T	A	4	4	8	0	0	8	0	0
6	6395222	.	T	A	4	5	9	0	0	9	0	0
6	6395367	.	C	T	0	3	3	0	3	6	0	0
6	6395405	.	C	T	2	2	4	0	0	4	0	0
6	6459235	.	T	C	7	7	14	0	2	16	0	0
6	6459315	.	G	A	2	3	5	0	0	5	0	0
6	6466502	.	C	T	2	0	2	0	0	2	0	0
6	6467931	.	C	T	0	6	6	0	5	11	0	0
6	6470529	.	G	A	9	3	12	0	0	12	0	0
6	6471174	.	C	G	3	2	5	0	1	6	0	0
6	6471391	.	G	A	2	3	5	0	0	5	0	0
6	6471486	.	G	A	1	3	4	0	0	4	0	0
6	6471843	.	T	G	6	4	10	0	0	10	0	0
6	6471875	.	C	G	4	6	10	0	1	11	0	0
6	6475576	.	G	T	1	3	4	0	1	5	0	0
6	6475578	.	G	T	3	2	5	0	0	5	0	0
6	6475740	.	T	A	2	2	4	0	1	5	0	0
6	6477785	.	G	A	2	2	4	0	0	4	0	0
6	6540964	.	T	A	1	5	6	0	0	6	0	0
6	6541039	.	C	T	5	2	7	0	0	7	0	0
6	6541128	.	G	A	1	2	3	0	0	3	0	0
6	6665965	.	G	A	5	3	8	0	0	8	0	0
6	6666322	.	T	A	3	6	9	0	0	9	0	0
6	6669502	.	C	G	1	1	2	0	0	2	0	0
6	6669743	.	G	A	2	5	7	0	0	7	0	0
6	6671545	.	G	C	6	6	12	0	0	12	0	0
6	6671607	.	C	G	3	3	6	0	0	6	0	0
6	6671769	.	T	A	2	5	7	0	2	9	0	0
6	6737391	.	C	T	11	16	27	0	1	28	0	0
6	6737401	.	G	T	10	13	23	0	0	23	0	0
6	6737982	.	T	A	12	20	32	0	2	34	0	0
6	6737998	.	C	T	1	23	24	0	14	38	0	0
6	6769345	.	T	A	8	5	13	0	0	13	0	0
6	6769716	.	C	T	10	11	21	0	0	21	0	0
6	6769719	.	T	C	10	9	19	0	0	19	0	0
6	6769782	.	A	G	2	4	6	0	0	6	0	0
6	6775689	.	G	T	5	3	8	0	0	8	0	0
6	6784239	.	G	C	1	2	3	0	1	4	0	0
6	6785788	.	G	A	3	1	4	0	0	4	0	0
6	6788714	.	A	G	0	0	0	0	1	1	0	0
6	6793164	.	C	T	11	10	21	0	0	21	0	0
6	6793224	.	G	A	0	5	5	0	2	7	0	0
6	6795520	.	T	A	3	6	9	0	0	9	0	0
6	6795526	.	C	T	5	3	8	0	0	8	0	0
6	6795664	.	T	C	9	9	18	0	0	18	0	0
6	6796229	.	G	A	1	1	2	0	1	3	0	0
6	6797583	.	A	G	7	7	14	0	2	16	0	0
6	6797598	.	T	C	8	11	19	0	1	20	0	0
6	6797694	.	T	A	8	1	9	0	1	10	0	0
6	6799367	.	G	T	0	2	2	0	1	3	0	0
6	6800031	.	G	T	8	4	12	0	0	12	0	0
6	6800091	.	A	G	4	3	7	0	1	8	0	0
6	6800107	.	T	A	2	3	5	0	0	5	0	0
6	6800283	.	T	A	3	3	6	0	0	6	0	0
6	6803534	.	T	A	2	1	3	0	0	3	0	0
6	6803726	.	T	A	5	4	9	0	0	9	0	0
6	6805275	.	G	A	3	3	6	0	1	7	0	0
6	6805477	.	T	C	4	2	6	0	0	6	0	0
6	6805572	.	G	T	17	21	38	0	0	38	0	0
6	6805891	.	T	C	1	2	3	0	0	3	0	0
6	6805903	.	T	A	1	2	3	0	0	3	0	0
6	6808431	.	C	G	1	4	5	0	0	5	0	0
6	6903468	.	C	T	2	4	6	0	1	7	0	0
6	6905848	.	G	A	0	1	1	0	2	3	0	0
6	6908699	.	A	G	3	3	6	0	1	7	0	0
6	6909792	.	G	A	2	1	3	0	0	3	0	0
6	6919866	.	G	T	0	7	7	0	8	15	0	0
6	6920673	.	A	T	3	5	8	1	4	13	0	0
6	6921577	.	C	T	16	16	32	0	0	32	0	0
6	6921581	.	T	C	16	13	29	0	2	31	0	0
6	6921802	.	G	A	19	24	43	0	0	43	0	0
6	6921889	.	T	A	16	21	37	0	0	37	0	0
6	6922072	.	G	T	8	9	17	0	0	17	0	0
6	6922187	.	T	C	9	10	19	0	1	20	0	0
6	6966699	.	T	A	1	2	3	0	0	3	0	0
6	6973009	.	A	T	7	10	17	0	1	18	0	0
6	6973383	.	G	T	4	7	11	0	1	12	0	0
6	7089952	.	C	G	3	2	5	0	0	5	0	0
6	7107034	.	A	G	1	0	1	0	0	1	0	0
6	7107833	.	C	T	1	1	2	0	0	2	0	0
6	7110148	.	C	T	14	5	19	0	1	20	0	0
6	7110434	.	C	T	11	16	27	0	0	27	0	0
6	7110435	.	T	G	10	16	26	0	0	27	1	0
6	7110551	.	C	T	23	14	37	0	0	37	0	0
6	7113001	.	T	G	2	3	5	0	1	6	0	0
6	7114482	.	C	T	4	3	7	0	0	7	0	0
6	7114937	.	A	G	1	1	2	0	0	2	0	0
6	7115967	.	T	C	1	2	3	0	0	3	0	0
6	7157570	.	G	A	5	2	7	0	0	7	0	0
6	7157615	.	C	T	3	5	8	0	1	9	0	0
6	7207652	.	G	A	2	1	3	0	0	3	0	0
6	7207934	.	G	A	2	4	6	0	0	6	0	0
6	7251362	.	A	T	4	2	6	0	0	6	0	0
6	7251426	.	A	G	4	3	7	0	1	8	0	0
6	7251564	.	G	A	9	6	15	0	0	15	0	0
6	7251627	.	A	G	7	4	11	0	0	11	0	0
6	7251694	.	G	A	2	4	6	0	0	6	0	0
6	7270355	.	T	C	5	7	12	0	0	12	0	0
6	7273005	.	A	G	1	0	1	0	0	1	0	0
6	7273021	.	C	T	1	0	1	0	0	1	0	0
6	7273512	.	T	A	1	2	3	0	2	5	0	0
6	7273518	.	G	A	0	3	3	0	2	5	0	0
6	7276139	.	T	C	2	4	6	0	0	6	0	0
6	7276178	.	T	A	6	6	12	0	0	12	0	0
6	7276212	.	C	T	9	9	18	0	1	19	0	0
6	7276263	.	G	A	0	11	11	0	9	20	0	0
6	7276776	.	A	C	3	1	4	0	0	4	0	0
6	7414917	.	G	A	1	2	3	0	0	3	0	0
6	7425208	.	T	C	1	2	3	0	0	3	0	0
6	7435565	.	C	T	2	1	3	0	0	3	0	0
6	7438474	.	C	T	5	5	10	0	0	10	0	0
6	7444930	.	T	C	15	8	23	0	1	24	0	0
6	7451563	.	T	G	12	10	22	0	0	22	0	0
6	7452519	.	T	C	7	13	20	0	0	20	0	0
6	7453379	.	T	G	10	0	10	0	17	27	0	0
6	7453567	.	G	T	11	6	17	0	1	18	0	0
6	7453649	.	C	G	12	9	21	0	1	22	0	0
6	7453660	.	C	T	9	6	15	0	1	16	0	0
6	7531043	.	T	C	1	3	4	0	0	4	0	0
6	7542491	.	G	T	0	5	5	0	1	6	0	0
6	7545794	.	C	T	10	8	18	0	1	19	0	0
6	7545824	.	T	C	11	7	18	0	1	19	0	0
6	7547451	.	C	T	2	2	4	0	0	4	0	0
6	7549967	.	G	A	8	6	14	0	0	14	0	0
6	7550210	.	A	C	13	10	23	0	0	23	0	0
6	7550405	.	C	T	11	9	20	0	3	23	0	0
6	7551087	.	C	A	4	5	9	0	0	9	0	0
6	7591018	.	G	A	2	1	3	0	0	3	0	0
6	7626457	.	C	T	2	0	2	0	0	2	0	0
6	7633452	.	G	C	1	4	5	0	6	11	0	0
6	7636811	.	A	T	3	3	6	0	0	6	0	0
6	7637195	.	C	T	3	5	8	0	0	8	0	0
6	7638717	.	G	A	8	6	14	0	0	14	0	0
6	7645319	.	T	C	1	2	3	0	0	3	0	0
6	7646039	.	A	G	1	4	5	0	0	5	0	0
6	7646102	.	G	A	15	11	26	0	0	26	0	0
6	7646111	.	G	C	13	14	27	0	1	28	0	0
6	7648224	.	A	G	5	0	5	0	9	14	0	0
6	7652458	.	C	T	11	11	22	0	2	24	0	0
6	7652470	.	A	C	11	8	19	0	2	21	0	0
6	7652896	.	G	A	0	21	21	0	16	37	0	0
6	7652959	.	C	T	13	13	26	0	0	26	0	0
6	7652989	.	C	T	3	3	6	0	1	7	0	0
6	7656920	.	A	G	10	0	10	0	17	27	0	0
6	7656932	.	A	G	12	23	35	0	2	37	0	0
6	7657177	.	C	T	17	10	27	0	0	27	0	0
6	7657793	.	A	C	17	18	35	0	2	37	0	0
6	7657886	.	T	A	19	20	39	0	0	39	0	0
6	7657887	.	G	T	18	20	38	0	1	39	0	0
6	7657972	.	T	G	17	7	24	0	3	27	0	0
6	7658076	.	G	A	10	14	24	0	3	27	0	0
6	7659915	.	G	A	2	8	10	0	0	10	0	0
6	7660063	.	C	A	9	1	10	0	0	10	0	0
6	7660119	.	A	G	8	8	16	0	1	17	0	0
6	7660300	.	T	C	1	0	1	0	3	4	0	0
6	7660369	.	T	C	2	4	6	0	0	6	0	0
6	7660458	.	A	C	4	0	4	0	7	11	0	0
6	7660594	.	C	T	1	6	7	0	1	8	0	0
6	7660659	.	C	A	0	4	4	0	4	8	0	0
6	7660707	.	C	T	0	6	6	0	4	10	0	0
6	7679455	.	G	A	1	2	3	0	0	3	0	0
6	7688598	.	C	T	0	2	2	0	2	4	0	0
6	7688757	.	A	C	4	0	4	0	8	12	0	0
6	7697573	.	G	A	0	2	2	0	0	2	0	0
6	7702770	.	G	T	3	1	4	0	0	4	0	0
6	7705984	.	G	A	4	2	6	0	0	6	0	0
6	7711239	.	G	A	1	3	4	0	0	4	0	0
6	7713350	.	A	T	6	1	7	0	2	10	1	0
6	7713433	.	G	A	18	23	41	0	3	44	0	0
6	7721530	.	T	A	5	11	16	1	4	21	0	0
6	7721860	.	G	A	7	3	10	0	0	10	0	0
6	7721906	.	G	A	5	13	18	0	2	20	0	0
6	7721958	.	C	A	13	16	29	0	1	30	0	0
6	7722143	.	G	T	19	9	28	0	0	28	0	0
6	7722159	.	A	T	14	9	23	0	4	27	0	0
6	7722195	.	G	T	9	7	16	0	0	16	0	0
6	7722205	.	G	A	10	6	16	0	1	17	0	0
6	7722333	.	G	A	9	7	16	0	2	18	0	0
6	7722387	.	T	C	11	9	20	0	2	22	0	0
6	7722402	.	T	C	3	10	13	0	3	16	0	0
6	7722467	.	T	A	2	4	6	0	0	6	0	0
6	7722577	.	C	T	0	17	17	0	11	28	0	0
6	7723008	.	G	T	9	9	18	0	1	19	0	0
6	7723155	.	A	C	13	9	22	0	0	22	0	0
6	7723232	.	A	T	8	4	12	0	3	15	0	0
6	7723850	.	C	T	0	9	9	0	2	11	0	0
6	7723961	.	G	A	8	12	20	0	1	21	0	0
6	7726824	.	G	A	10	7	17	0	0	17	0	0
6	7734250	.	A	C	2	2	4	0	0	4	0	0
6	7795698	.	C	T	18	8	26	0	6	33	1	0
6	7842013	.	C	T	0	6	6	0	3	9	0	0
6	7842034	.	C	A	4	7	11	0	0	11	0	0
6	8176101	.	A	G	7	3	10	0	0	10	0	0
6	8176575	.	C	T	7	5	12	0	2	14	0	0
6	8177030	.	T	C	9	10	19	0	0	19	0	0
6	8177399	.	T	C	8	10	18	0	3	21	0	0
6	8177600	.	T	C	12	13	25	0	0	25	0	0
6	8177678	.	C	T	8	16	24	0	2	26	0	0
6	8178002	.	T	C	13	23	36	0	0	36	0	0
6	8178053	.	G	A	0	12	12	0	9	21	0	0
6	8178113	.	T	C	12	16	28	0	0	28	0	0
6	8178351	.	G	A	15	16	31	0	1	32	0	0
6	8179022	.	G	T	0	15	15	0	28	43	0	0
6	8179373	.	G	A	26	13	39	0	1	40	0	0
6	8179683	.	A	T	8	10	18	0	0	18	0	0
6	8210404	.	C	T	1	3	4	0	0	4	0	0
6	8210487	.	T	C	0	3	3	0	0	3	0	0
6	8210488	.	G	A	0	3	3	0	0	3	0	0
6	8210902	.	C	G	1	3	4	0	0	4	0	0
6	8211075	.	C	T	3	2	5	0	0	5	0	0
6	8211106	.	T	C	3	3	6	0	0	6	0	0
6	8211143	.	A	T	5	3	8	0	0	8	0	0
6	8211154	.	T	C	5	2	7	0	0	7	0	0
6	8211253	.	G	A	1	5	6	0	0	6	0	0
6	8214044	.	G	A	0	3	3	0	0	3	0	0
6	8214045	.	T	G	0	3	3	0	0	3	0	0
6	8214947	.	T	C	1	0	1	0	1	2	0	0
6	8265282	.	G	A	7	7	14	0	0	14	0	0
6	8267111	.	C	T	12	20	32	0	0	32	0	0
6	8267266	.	A	G	16	16	32	0	0	32	0	0
6	8267284	.	G	A	15	16	31	0	2	33	0	0
6	8267307	.	G	C	11	14	25	0	1	26	0	0
6	8267352	.	A	T	14	16	30	0	4	34	0	0
6	8267519	.	G	A	21	12	33	0	2	35	0	0
6	8267563	.	G	T	14	25	39	0	2	41	0	0
6	8267635	.	T	C	24	15	39	0	1	40	0	0
6	8267795	.	T	A	8	8	16	0	0	16	0	0
6	8267880	.	G	A	10	12	22	0	0	22	0	0
6	8268529	.	A	G	8	8	16	0	0	16	0	0
6	8273066	.	G	A	0	2	2	0	0	2	0	0
6	8282275	.	A	G	2	0	2	0	0	2	0	0
6	8315076	.	A	G	5	2	7	0	1	8	0	0
6	8315078	.	A	G	6	2	8	0	0	8	0	0
6	8318001	.	T	C	1	3	4	0	0	4	0	0
6	8318037	.	G	A	0	5	5	0	2	7	0	0
6	8328181	.	G	T	9	17	26	0	1	27	0	0
6	8329059	.	G	C	4	2	6	0	0	6	0	0
6	8365753	.	T	C	3	3	6	0	0	6	0	0
6	8366006	.	A	T	7	10	17	0	0	17	0	0
6	8366167	.	C	T	19	8	27	0	1	28	0	0
6	8370489	.	T	C	9	7	16	0	1	17	0	0
6	8374716	.	G	A	2	4	6	0	1	7	0	0
6	8375089	.	C	T	12	7	19	0	0	19	0	0
6	8380433	.	G	C	4	3	7	0	0	7	0	0
6	8380485	.	G	T	3	3	6	0	0	6	0	0
6	8391629	.	C	T	0	5	5	0	4	9	0	0
6	8392005	.	G	A	1	1	2	0	0	2	0	0
6	8453550	.	A	G	3	3	6	0	0	6	0	0
6	8454024	.	G	A	3	3	6	0	0	6	0	0
6	8460493	.	G	T	5	3	8	0	0	8	0	0
6	8460603	.	T	G	2	3	5	0	0	5	0	0
6	8460793	.	T	C	2	3	5	0	0	5	0	0
6	8460808	.	A	T	1	2	3	0	0	3	0	0
6	9130575	.	A	G	4	11	15	0	0	15	0	0
6	9130596	.	A	G	4	0	4	0	5	9	0	0
6	10008329	.	G	A	1	7	8	0	23	31	0	0
6	10008398	.	A	G	16	20	36	0	0	36	0	0
6	10008407	.	C	T	14	15	29	0	2	31	0	0
6	10009850	.	C	T	19	18	37	0	1	38	0	0
6	10009903	.	A	T	18	18	36	0	1	37	0	0
6	10015551	.	T	C	3	2	5	0	1	6	0	0
6	10015602	.	T	C	29	13	42	0	2	44	0	0
6	10015794	.	A	T	18	8	26	1	2	29	0	0
6	10015902	.	A	T	29	24	53	0	4	57	0	0
6	10015952	.	C	A	29	28	57	0	1	59	1	0
6	10015992	.	A	C	26	35	61	0	3	64	0	0
6	10015993	.	G	A	28	34	62	0	2	64	0	0
6	10016114	.	C	T	20	36	56	0	1	57	0	0
6	10016116	.	C	A	20	34	54	0	3	57	0	0
6	10016174	.	T	G	23	18	41	0	2	43	0	0
6	10016363	.	T	G	31	19	50	0	3	58	5	0
6	10020055	.	G	A	24	16	40	0	2	42	0	0
6	10026677	.	C	T	9	7	16	0	0	16	0	0
6	10026818	.	G	A	5	5	10	0	0	10	0	0
6	10032925	.	T	G	2	5	7	0	0	7	0	0
6	10032932	.	C	T	2	5	7	0	0	7	0	0
6	10033015	.	G	A	1	3	4	0	0	4	0	0
6	10045449	.	G	T	3	6	9	0	1	10	0	0
6	10047204	.	T	C	13	7	20	0	0	20	0	0
6	10047805	.	G	A	2	2	4	0	0	4	0	0
6	10047814	.	T	C	2	1	3	0	0	3	0	0
6	10050050	.	G	A	11	14	25	0	0	25	0	0
6	10056466	.	G	T	22	11	33	0	1	35	1	0
6	10087683	.	C	A	2	1	3	0	0	3	0	0
6	10087915	.	G	C	3	2	5	0	0	5	0	0
6	10088109	.	C	T	4	2	6	0	1	7	0	0
6	10248476	.	T	A	14	11	25	0	0	25	0	0
6	10248530	.	A	G	13	11	24	0	2	26	0	0
6	10248546	.	T	C	12	0	12	0	10	22	0	0
6	10248596	.	T	C	9	7	16	0	3	19	0	0
6	10248980	.	A	G	4	8	12	0	0	12	0	0
6	10249451	.	A	G	5	5	10	0	0	10	0	0
6	10251188	.	C	A	10	6	16	0	1	17	0	0
6	10257886	.	A	G	2	2	4	0	0	4	0	0
6	10264656	.	T	C	3	0	3	0	1	4	0	0
6	10283118	.	T	A	2	1	3	0	0	3	0	0
6	10305922	.	G	A	1	2	3	0	0	3	0	0
6	10354469	.	T	C	0	3	3	0	0	3	0	0
6	10512903	.	C	G	1	2	3	0	0	3	0	0
6	10513182	.	C	G	4	3	7	0	0	7	0	0
6	10522332	.	C	T	1	3	4	0	0	4	0	0
6	10547409	.	C	T	1	3	4	0	0	4	0	0
6	10547556	.	T	C	1	3	4	0	0	4	0	0
6	10564408	.	C	T	1	2	3	0	0	3	0	0
6	10564426	.	T	C	1	1	2	0	0	2	0	0
6	10567861	.	C	T	2	3	5	0	0	5	0	0
6	10570843	.	C	T	4	1	5	0	0	5	0	0
6	10576573	.	A	G	6	0	6	0	3	9	0	0
6	10701627	.	C	T	4	3	7	0	0	7	0	0
6	10701642	.	C	A	0	4	4	0	3	7	0	0
6	10702244	.	T	C	4	1	5	0	3	8	0	0
6	10705814	.	C	T	0	4	4	0	2	6	0	0
6	10705815	.	G	T	1	4	5	0	1	6	0	0
6	10706871	.	A	G	0	5	5	0	1	6	0	0
6	10721767	.	C	T	23	0	23	0	1	24	0	0
6	10721971	.	T	G	5	12	17	0	1	18	0	0
6	10722541	.	G	A	3	3	6	0	0	6	0	0
6	10724275	.	G	A	3	6	9	0	0	9	0	0
6	10724336	.	C	T	0	10	10	0	10	20	0	0
6	10724591	.	G	T	9	10	19	0	1	20	0	0
6	10724645	.	A	T	9	4	13	0	2	15	0	0
6	10724665	.	G	A	7	10	17	0	0	17	0	0
6	10724765	.	G	A	8	4	12	0	0	12	0	0
6	10725365	.	T	C	1	0	1	0	4	5	0	0
6	10725506	.	T	C	4	4	8	0	1	9	0	0
6	10733176	.	G	A	1	3	4	0	0	4	0	0
6	10736760	.	A	C	3	2	5	0	0	5	0	0
6	10736798	.	T	A	2	2	4	0	0	4	0	0
6	10736978	.	G	C	1	1	2	0	0	2	0	0
6	10740030	.	A	G	3	2	5	0	0	5	0	0
6	10740119	.	T	G	2	2	4	0	0	4	0	0
6	10741432	.	G	T	1	2	3	0	0	3	0	0
6	10741616	.	A	G	1	5	6	0	1	7	0	0
6	10741853	.	T	G	4	2	6	0	0	6	0	0
6	10741916	.	G	C	12	7	19	0	1	20	0	0
6	10742120	.	T	C	9	15	24	0	1	25	0	0
6	10742121	.	G	A	9	15	24	0	1	25	0	0
6	10742306	.	A	G	16	20	36	0	0	36	0	0
6	10742318	.	G	A	18	13	31	0	0	31	0	0
6	10742497	.	T	C	8	0	8	0	9	17	0	0
6	10758866	.	A	T	1	4	5	0	1	6	0	0
6	10764001	.	A	G	4	3	7	0	0	7	0	0
6	10780694	.	A	G	2	2	4	0	0	4	0	0
6	10787844	.	T	C	1	0	1	0	2	3	0	0
6	10787853	.	T	A	1	2	3	0	0	3	0	0
6	10831093	.	G	A	24	29	53	0	3	56	0	0
6	10833078	.	T	C	18	2	20	0	18	38	0	0
6	10834821	.	G	C	3	4	7	0	1	8	0	0
6	10835676	.	G	A	2	3	5	0	0	5	0	0
6	10835700	.	T	A	3	3	6	0	0	6	0	0
6	10835721	.	A	G	3	4	7	0	0	7	0	0
6	10838690	.	C	T	0	3	3	0	3	6	0	0
6	10838716	.	A	C	3	6	9	0	1	10	0	0
6	10838741	.	G	A	4	8	12	0	0	12	0	0
6	10838753	.	T	C	3	8	11	0	0	11	0	0
6	10839885	.	C	A	0	12	12	0	12	24	0	0
6	10846001	.	G	A	0	1	1	0	0	1	0	0
6	10859011	.	G	A	4	3	7	0	0	7	0	0
6	10863617	.	T	C	0	1	1	0	0	1	0	0
6	10877269	.	A	G	0	1	1	0	1	2	0	0
6	10879525	.	T	C	5	7	12	0	0	12	0	0
6	10879633	.	T	C	22	14	36	0	1	37	0	0
6	10879679	.	G	A	17	19	36	0	1	37	0	0
6	10879816	.	A	T	11	13	24	0	0	24	0	0
6	10879833	.	A	G	10	0	10	0	15	25	0	0
6	10910684	.	G	A	5	4	9	0	1	10	0	0
6	10910784	.	C	A	24	12	36	0	1	37	0	0
6	10911066	.	T	C	19	36	55	0	2	57	0	0
6	10911198	.	A	G	13	25	38	0	1	39	0	0
6	10912341	.	G	A	16	23	39	0	0	39	0	0
6	10983061	.	T	C	3	0	3	0	2	5	0	0
6	10983337	.	T	A	1	3	4	0	0	4	0	0
6	11067436	.	A	C	1	2	3	0	0	3	0	0
6	11071222	.	A	G	23	34	57	0	2	59	0	0
6	11101781	.	T	C	5	8	13	0	0	13	0	0
6	11101790	.	C	T	0	8	8	0	5	13	0	0
6	11101852	.	G	A	10	9	19	0	0	19	0	0
6	11106924	.	C	G	1	3	4	0	0	4	0	0
6	11107167	.	G	C	5	0	5	0	5	10	0	0
6	11107233	.	C	A	1	1	2	0	2	4	0	0
6	11107326	.	T	C	2	0	2	0	2	4	0	0
6	11120420	.	G	A	1	2	3	0	0	3	0	0
6	11129357	.	T	C	1	2	3	0	0	3	0	0
6	11141514	.	T	G	1	2	3	0	0	3	0	0
6	11250309	.	A	C	4	2	6	0	0	6	0	0
6	11250427	.	A	T	1	2	3	0	0	3	0	0
6	11250462	.	C	T	3	2	5	0	0	5	0	0
6	11250973	.	T	C	3	1	4	0	0	4	0	0
6	11253881	.	T	C	0	1	1	0	0	1	0	0
6	11253890	.	C	T	0	1	1	0	0	1	0	0
6	11254142	.	T	G	7	0	7	0	13	20	0	0
6	11254358	.	A	G	7	0	7	0	6	13	0	0
6	11254526	.	C	T	7	5	12	0	2	14	0	0
6	11257827	.	G	A	0	16	16	0	19	35	0	0
6	11257866	.	G	C	0	14	14	0	12	26	0	0
6	11257917	.	T	A	15	14	29	0	1	30	0	0
6	11259970	.	C	A	16	13	29	0	0	29	0	0
6	11265612	.	G	T	1	17	18	0	13	31	0	0
6	11265681	.	T	A	20	13	33	0	0	33	0	0
6	11265717	.	T	C	28	10	38	0	1	39	0	0
6	11266255	.	C	T	13	13	26	0	3	29	0	0
6	11266490	.	A	T	9	5	14	0	1	15	0	0
6	11266496	.	T	C	8	6	14	0	1	15	0	0
6	11276827	.	T	A	3	4	7	0	0	7	0	0
6	11276912	.	A	G	2	2	4	0	0	4	0	0
6	11279804	.	T	C	5	4	9	0	0	9	0	0
6	11279815	.	T	C	4	3	7	0	1	8	0	0
6	11281923	.	A	G	4	3	7	0	0	7	0	0
6	11282371	.	A	T	1	1	2	0	0	2	0	0
6	11285310	.	C	T	1	3	4	0	1	5	0	0
6	11285362	.	T	C	5	0	5	0	5	10	0	0
6	11285374	.	C	T	4	5	9	0	2	11	0	0
6	11285453	.	T	C	3	8	11	0	0	11	0	0
6	11285583	.	C	T	5	4	9	0	0	9	0	0
6	11285662	.	C	T	0	3	3	0	3	6	0	0
6	11285772	.	C	T	4	3	7	0	0	7	0	0
6	11288179	.	T	A	0	4	4	0	0	4	0	0
6	11288460	.	G	T	2	0	2	0	0	2	0	0
6	11295616	.	T	G	2	3	5	0	0	5	0	0
6	11299643	.	C	T	3	2	5	0	0	5	0	0
6	11299680	.	A	T	1	1	2	0	0	2	0	0
6	11299682	.	C	T	1	1	2	0	0	2	0	0
6	11303424	.	T	G	1	1	2	0	0	2	0	0
6	11397818	.	G	C	0	0	0	0	3	3	0	0
6	11403359	.	C	A	5	0	5	0	0	5	0	0
6	11407918	.	G	A	1	3	4	0	0	4	0	0
6	11407944	.	A	G	0	3	3	0	1	4	0	0
6	11407954	.	A	G	1	3	4	0	0	4	0	0
6	11410523	.	C	T	6	2	8	0	0	8	0	0
6	11414715	.	C	T	8	3	11	0	0	11	0	0
6	11414748	.	G	A	2	9	11	0	1	12	0	0
6	11414777	.	A	T	2	11	13	0	1	14	0	0
6	11414822	.	T	G	4	0	4	0	8	12	0	0
6	11415220	.	A	C	16	13	29	0	1	30	0	0
6	11415460	.	G	A	1	12	13	0	7	20	0	0
6	11512622	.	C	T	0	2	2	0	0	2	0	0
6	11765506	.	A	G	20	35	55	0	1	56	0	0
6	11766190	.	T	A	19	17	36	0	2	38	0	0
6	11766267	.	G	A	23	16	39	0	0	39	0	0
6	11766276	.	A	G	25	13	38	0	0	38	0	0
6	11766765	.	T	C	4	6	10	0	0	10	0	0
6	11816206	.	G	A	3	3	6	0	0	6	0	0
6	12503989	.	T	G	3	2	5	0	0	5	0	0
6	12504230	.	T	C	2	4	6	0	1	7	0	0
6	12504362	.	C	T	4	2	6	0	0	6	0	0
6	12529163	.	C	T	0	1	1	0	0	1	0	0
6	12529247	.	C	T	3	0	3	0	0	3	0	0
6	12550437	.	G	A	5	1	6	0	0	6	0	0
6	12550764	.	G	A	10	7	17	0	3	20	0	0
6	12550934	.	C	T	10	17	27	0	1	28	0	0
6	12629345	.	T	C	2	3	5	0	0	5	0	0
6	12797677	.	C	T	4	7	11	0	0	11	0	0
6	12797755	.	G	A	12	5	17	0	1	18	0	0
6	12797815	.	A	G	20	10	30	0	0	30	0	0
6	12798083	.	G	T	4	6	10	0	0	10	0	0
6	12798124	.	T	C	1	3	4	0	1	5	0	0
6	12798345	.	T	C	4	2	6	0	0	6	0	0
6	12803257	.	C	A	7	4	11	0	0	11	0	0
6	12803325	.	A	G	4	4	8	0	0	8	0	0
6	12803568	.	A	G	7	5	12	0	0	12	0	0
6	12803598	.	T	C	6	5	11	0	0	11	0	0
6	12803790	.	A	G	7	3	10	0	0	10	0	0
6	12803919	.	C	G	2	2	4	0	0	4	0	0
6	12804132	.	G	A	2	4	6	0	0	6	0	0
6	13037675	.	C	T	3	2	5	0	1	6	0	0
6	13510493	.	G	A	1	1	2	0	0	2	0	0
6	13513936	.	C	T	2	7	9	0	0	9	0	0
6	13688377	.	G	A	2	2	4	0	0	4	0	0
6	13698862	.	T	C	2	2	4	0	0	4	0	0
6	13698863	.	T	A	2	2	4	0	0	4	0	0
6	13699239	.	T	A	1	2	3	0	0	3	0	0
6	13703286	.	T	C	1	3	4	0	0	4	0	0
6	13709142	.	G	A	1	2	3	0	0	3	0	0
6	13730697	.	G	A	2	1	3	0	0	3	0	0
6	13734266	.	G	A	2	3	5	0	0	5	0	0
6	13734439	.	C	T	5	8	13	0	0	13	0	0
6	13734449	.	C	T	8	3	11	0	0	11	0	0
6	13734474	.	C	T	1	4	5	0	1	6	0	0
6	13743317	.	G	A	17	35	52	0	2	54	0	0
6	13743753	.	T	C	29	28	57	0	3	60	0	0
6	13743923	.	C	T	26	38	64	0	2	66	0	0
6	13744099	.	C	T	31	33	64	0	3	67	0	0
6	13746346	.	T	A	6	3	9	0	0	9	0	0
6	13806522	.	C	T	11	6	17	0	0	17	0	0
6	13862171	.	C	T	7	6	13	0	0	13	0	0
6	13862576	.	A	C	12	16	28	0	2	30	0	0
6	13866551	.	G	A	15	12	27	0	1	28	0	0
6	13868823	.	A	G	18	19	37	0	1	38	0	0
6	13868850	.	A	T	18	11	29	0	2	33	2	0
6	13869343	.	A	C	3	6	9	0	4	14	1	0
6	13869540	.	C	A	24	8	32	0	1	33	0	0
6	13869608	.	C	T	20	16	36	0	1	37	0	0
6	13871773	.	A	G	1	2	3	0	0	3	0	0
6	13878848	.	G	A	2	0	2	0	0	2	0	0
6	13900918	.	C	G	1	0	1	0	1	2	0	0
6	13901255	.	A	T	2	2	4	0	0	4	0	0
6	13901312	.	C	T	2	0	2	0	0	2	0	0
6	13901538	.	G	C	0	3	3	0	1	4	0	0
6	13901604	.	T	C	0	1	1	0	0	1	0	0
6	13903413	.	T	C	0	1	1	0	0	1	0	0
6	13908633	.	G	A	0	9	9	0	6	15	0	0
6	13914821	.	T	C	5	4	9	0	0	9	0	0
6	13914824	.	G	A	5	4	9	0	0	9	0	0
6	13920194	.	A	G	6	4	10	0	0	10	0	0
6	13920275	.	T	G	1	6	7	0	1	8	0	0
6	13941729	.	C	A	9	12	21	0	2	23	0	0
6	13967038	.	A	T	6	1	7	0	0	7	0	0
6	13967328	.	G	A	1	0	1	0	1	2	0	0
6	13967512	.	C	A	11	9	20	0	4	25	1	0
6	13977080	.	T	A	5	2	7	0	0	7	0	0
6	13977567	.	G	T	18	14	32	0	0	32	0	0
6	13977588	.	C	T	23	20	43	0	0	43	0	0
6	13977648	.	G	A	8	10	18	0	0	18	0	0
6	13987287	.	G	C	14	9	23	0	0	23	0	0
6	13987299	.	A	T	12	14	26	0	1	27	0	0
6	13987346	.	C	T	11	9	20	0	2	22	0	0
6	13987560	.	T	C	12	21	33	0	0	33	0	0
6	13987631	.	G	A	23	17	40	0	2	42	0	0
6	13987663	.	T	A	26	18	44	0	0	45	1	0
6	13987710	.	G	A	9	18	27	0	1	28	0	0
6	13987713	.	T	G	9	16	25	0	2	27	0	0
6	14032693	.	T	C	25	7	32	1	2	35	0	0
6	14032698	.	T	A	27	5	32	1	0	33	0	0
6	14032739	.	G	A	14	13	27	0	2	29	0	0
6	14033030	.	G	T	15	10	25	0	0	25	0	0
6	14033167	.	G	A	18	21	39	0	0	39	0	0
6	14033556	.	T	A	5	5	10	0	0	10	0	0
6	14033836	.	G	C	3	8	11	0	0	11	0	0
6	14034887	.	G	C	5	9	14	0	0	14	0	0
6	14034907	.	C	T	0	10	10	0	7	17	0	0
6	14034949	.	G	A	9	9	18	0	1	19	0	0
6	14038506	.	T	A	0	3	3	0	0	3	0	0
6	14086810	.	T	C	21	22	43	0	4	47	0	0
6	14086901	.	G	T	26	27	53	1	4	58	0	0
6	14086942	.	G	C	24	27	51	1	0	52	0	0
6	14087182	.	C	A	27	26	53	0	3	56	0	0
6	14087220	.	T	A	23	24	47	0	1	48	0	0
6	14087569	.	T	G	20	31	51	0	2	53	0	0
6	14087641	.	A	C	23	25	48	0	0	48	0	0
6	14088095	.	C	T	20	26	46	0	2	48	0	0
6	14092942	.	T	A	12	12	24	0	6	30	0	0
6	14096684	.	C	T	0	1	1	0	1	2	0	0
6	14098760	.	C	T	1	18	19	0	11	30	0	0
6	14105071	.	G	T	5	3	8	0	0	8	0	0
6	14172926	.	A	T	5	2	7	0	0	7	0	0
6	14173159	.	C	A	4	4	8	0	1	9	0	0
6	14173599	.	A	G	3	2	5	0	2	7	0	0
6	14191637	.	A	G	2	3	5	0	0	5	0	0
6	14191676	.	G	A	4	4	8	0	0	8	0	0
6	14191709	.	T	C	5	0	5	0	5	10	0	0
6	14209151	.	C	T	4	4	8	0	0	8	0	0
6	14209674	.	A	G	1	4	5	0	1	6	0	0
6	14212352	.	G	A	0	2	2	0	0	2	0	0
6	14212430	.	T	G	2	2	4	0	0	4	0	0
6	14950538	.	T	A	4	3	7	0	0	7	0	0
6	14950567	.	T	C	5	3	8	0	1	9	0	0
6	14950759	.	T	C	10	5	15	0	0	15	0	0
6	14951854	.	C	T	16	12	28	0	1	29	0	0
6	14952579	.	T	C	15	11	26	0	1	27	0	0
6	14988559	.	G	T	2	1	3	0	0	3	0	0
6	15023688	.	G	A	8	6	14	0	0	14	0	0
6	15023713	.	A	G	2	3	5	0	0	5	0	0
6	15037025	.	A	G	3	2	5	0	0	5	0	0
6	15037258	.	A	G	2	0	2	0	0	2	0	0
6	15042303	.	A	T	1	3	4	0	0	4	0	0
6	15043636	.	T	A	1	1	2	0	0	2	0	0
6	15043886	.	A	T	0	2	2	0	0	2	0	0
6	15071618	.	A	T	1	2	3	0	0	3	0	0
6	15127591	.	G	A	0	2	2	0	5	7	0	0
6	15127666	.	T	G	2	0	2	0	1	3	0	0
6	15130982	.	G	A	0	5	5	0	4	9	0	0
6	15236344	.	G	A	2	2	4	0	0	4	0	0
6	15242287	.	A	T	1	2	3	0	0	3	0	0
6	15242641	.	C	T	5	5	10	0	0	10	0	0
6	15243129	.	T	C	2	3	5	0	0	5	0	0
6	15243137	.	A	C	3	2	5	0	0	5	0	0
6	15426063	.	T	C	1	2	3	0	0	3	0	0
6	15434544	.	T	A	6	11	17	0	1	18	0	0
6	15437352	.	G	T	1	2	3	0	0	3	0	0
6	15446948	.	G	A	0	1	1	0	0	1	0	0
6	15447086	.	C	T	1	3	4	0	0	4	0	0
6	15447143	.	T	C	2	6	8	0	0	8	0	0
6	15447165	.	A	G	2	0	2	0	5	7	0	0
6	15447202	.	T	C	1	2	3	0	0	3	0	0
6	15447203	.	A	G	1	0	1	0	2	3	0	0
6	15447305	.	G	A	1	2	3	0	0	3	0	0
6	15447344	.	G	A	3	3	6	0	0	6	0	0
6	15455804	.	C	A	0	2	2	0	1	3	0	0
6	15459617	.	C	T	0	1	1	0	1	2	0	0
6	15491378	.	C	T	0	0	0	0	1	1	0	0
6	15527107	.	A	G	5	2	7	0	0	7	0	0
6	15527202	.	T	C	2	2	4	0	0	4	0	0
6	15527385	.	G	A	8	3	11	0	0	11	0	0
6	15531697	.	G	A	1	2	3	0	0	3	0	0
6	15541015	.	G	A	4	3	7	0	0	7	0	0
6	15548966	.	A	G	5	1	6	0	0	6	0	0
6	15752298	.	A	C	8	1	9	0	5	14	0	0
6	15752348	.	A	G	8	8	16	0	2	18	0	0
6	15752489	.	C	T	4	3	7	0	1	8	0	0
6	15752602	.	A	G	3	4	7	0	0	8	1	0
6	15752681	.	A	C	2	6	8	0	1	9	0	0
6	15753256	.	A	G	1	2	3	0	0	3	0	0
6	15789877	.	C	A	0	1	1	0	0	1	0	0
6	15889765	.	C	T	1	2	3	0	0	3	0	0
6	15889816	.	G	A	0	4	4	0	3	7	0	0
6	15892805	.	T	G	2	2	4	0	0	4	0	0
6	16033239	.	A	G	3	3	6	0	0	6	0	0
6	16043950	.	C	T	0	9	9	0	13	22	0	0
6	16043980	.	A	G	17	11	28	0	0	28	0	0
6	16044019	.	T	C	17	0	17	0	18	35	0	0
6	16044597	.	C	T	14	9	23	0	1	24	0	0
6	16044664	.	T	C	11	15	26	0	2	28	0	0
6	16045413	.	T	C	6	9	15	0	0	15	0	0
6	16045463	.	G	C	7	0	7	0	15	22	0	0
6	16045511	.	G	A	17	9	26	0	0	26	0	0
6	16045650	.	G	A	5	10	15	0	1	16	0	0
6	16045712	.	C	T	9	12	21	0	1	22	0	0
6	16045768	.	C	G	8	8	16	0	2	18	0	0
6	16045798	.	T	C	12	6	18	0	2	20	0	0
6	16045884	.	A	G	12	8	20	0	0	20	0	0
6	16045912	.	T	C	3	0	3	0	23	26	0	0
6	16045946	.	A	C	15	11	26	1	1	28	0	0
6	16045947	.	A	T	14	9	23	1	4	28	0	0
6	16046025	.	T	A	11	13	24	0	0	24	0	0
6	16046049	.	G	T	11	8	19	0	1	23	3	0
6	16046098	.	T	C	16	9	25	0	0	25	0	0
6	16046110	.	T	C	12	11	23	0	0	23	0	0
6	16046272	.	G	T	8	8	16	0	1	18	1	0
6	16046365	.	G	A	1	5	6	0	2	8	0	0
6	16046371	.	A	T	1	4	5	0	2	7	0	0
6	16046443	.	T	C	6	5	11	0	0	11	0	0
6	16046664	.	A	G	3	11	14	0	0	14	0	0
6	16046676	.	G	A	12	5	17	0	0	17	0	0
6	16046850	.	G	A	10	14	24	0	1	25	0	0
6	16047197	.	C	T	0	12	12	0	8	20	0	0
6	16084168	.	T	C	1	0	1	0	0	1	0	0
6	16104448	.	G	T	7	6	13	0	0	13	0	0
6	16135963	.	C	T	2	1	3	0	0	3	0	0
6	16135966	.	C	T	1	2	3	0	0	3	0	0
6	16162994	.	G	A	0	2	2	0	0	2	0	0
6	16169641	.	G	A	1	2	3	0	0	3	0	0
6	16393459	.	G	T	1	3	4	0	0	4	0	0
6	16393570	.	G	T	1	2	3	0	0	3	0	0
6	16393816	.	G	C	1	2	3	0	0	3	0	0
6	16394244	.	A	G	3	2	5	0	0	5	0	0
6	16474853	.	T	C	2	4	6	0	0	6	0	0
6	16474879	.	T	C	1	4	5	0	0	5	0	0
6	16474948	.	T	C	7	7	14	0	1	15	0	0
6	16475047	.	T	A	11	6	17	0	0	17	0	0
6	16475395	.	A	C	7	5	12	0	0	12	0	0
6	16475499	.	G	A	6	8	14	0	0	14	0	0
6	16475502	.	G	T	6	8	14	0	0	14	0	0
6	16475728	.	G	A	1	5	6	0	7	13	0	0
6	16478198	.	C	A	0	5	5	0	16	21	0	0
6	16478200	.	T	G	12	5	17	0	2	19	0	0
6	16485073	.	A	T	4	1	5	0	0	5	0	0
6	16493381	.	A	T	7	12	19	0	0	19	0	0
6	16499206	.	G	A	3	7	10	0	0	10	0	0
6	16499260	.	A	G	2	6	8	0	2	10	0	0
6	16499312	.	A	G	5	0	5	0	7	12	0	0
6	16499422	.	A	G	4	7	11	0	0	11	0	0
6	16521166	.	C	A	3	2	5	0	0	5	0	0
6	16523647	.	A	G	1	0	1	0	0	1	0	0
6	16523662	.	C	T	0	1	1	0	1	2	0	0
6	16523704	.	A	G	2	2	4	0	0	4	0	0
6	16523788	.	G	A	1	0	1	0	0	1	0	0
6	16524019	.	G	A	3	2	5	0	1	6	0	0
6	16524618	.	C	G	2	2	4	0	0	4	0	0
6	16524653	.	G	A	5	6	11	0	0	11	0	0
6	16524663	.	T	C	5	6	11	0	0	11	0	0
6	16535731	.	G	C	1	3	4	0	0	4	0	0
6	16545661	.	A	G	2	0	2	0	0	2	0	0
6	16571935	.	G	A	1	3	4	0	0	4	0	0
6	16571947	.	G	T	1	3	4	0	0	4	0	0
6	16673876	.	C	T	2	3	5	0	1	6	0	0
6	16674296	.	A	G	4	11	15	0	0	15	0	0
6	16674344	.	T	A	12	13	25	0	2	27	0	0
6	16674371	.	T	C	10	5	15	0	4	19	0	0
6	16674435	.	A	C	9	11	20	0	1	21	0	0
6	16674618	.	G	A	15	11	26	0	0	26	0	0
6	16674808	.	T	C	4	2	6	0	0	6	0	0
6	16683385	.	T	C	3	5	8	0	1	9	0	0
6	16683421	.	A	G	6	6	12	0	0	12	0	0
6	16684004	.	A	G	7	5	12	0	0	12	0	0
6	16687429	.	C	A	8	9	17	0	1	18	0	0
6	16687432	.	T	A	7	9	16	0	1	17	0	0
6	16688900	.	T	C	1	2	3	0	0	3	0	0
6	16688921	.	A	G	4	1	5	0	0	5	0	0
6	16689416	.	T	A	1	7	8	0	0	8	0	0
6	16696083	.	C	T	0	1	1	0	0	1	0	0
6	16717807	.	C	A	0	2	2	0	1	3	0	0
6	17725972	.	A	G	4	2	6	0	0	6	0	0
6	18078439	.	G	A	1	4	5	0	0	5	0	0
6	18203842	.	G	A	13	18	31	0	1	32	0	0
6	18220141	.	G	A	1	0	1	0	0	1	0	0
6	18228324	.	G	A	7	4	11	0	0	11	0	0
6	18245385	.	G	A	9	8	17	0	1	18	0	0
6	18290937	.	G	A	0	1	1	0	1	2	0	0
6	18359389	.	G	A	6	7	13	0	1	14	0	0
6	18361359	.	A	T	3	3	6	0	0	6	0	0
6	18361609	.	T	C	5	9	14	0	0	14	0	0
6	18364081	.	G	A	0	5	5	0	2	7	0	0
6	18381278	.	G	A	0	6	6	0	4	10	0	0
6	18388387	.	T	G	4	3	7	0	0	7	0	0
6	18388517	.	G	C	4	6	10	0	0	10	0	0
6	18388569	.	C	T	7	6	13	0	0	13	0	0
6	18389220	.	G	A	4	7	11	0	0	11	0	0
6	18389541	.	C	T	4	12	16	0	0	16	0	0
6	18389655	.	G	A	6	2	8	0	1	9	0	0
6	18418714	.	T	G	4	6	10	0	0	10	0	0
6	18418760	.	G	A	5	3	8	0	0	8	0	0
6	18437514	.	T	G	8	0	8	0	12	20	0	0
6	18438459	.	A	G	2	1	3	0	0	3	0	0
6	18439256	.	C	A	7	7	14	0	0	14	0	0
6	18439481	.	A	T	5	10	15	0	0	15	0	0
6	18439576	.	A	G	10	7	17	0	1	18	0	0
6	18439723	.	G	A	7	6	13	0	0	13	0	0
6	18439774	.	G	A	0	7	7	0	7	14	0	0
6	18520930	.	T	A	17	8	25	0	1	26	0	0
6	18523549	.	C	A	12	12	24	0	1	25	0	0
6	18523770	.	A	T	22	13	35	0	0	35	0	0
6	18523772	.	C	G	12	21	33	0	2	35	0	0
6	18523817	.	T	A	10	12	22	0	2	24	0	0
6	18524550	.	A	G	3	5	8	0	0	8	0	0
6	18524579	.	A	G	4	11	15	0	0	15	0	0
6	18526432	.	A	G	0	1	1	0	0	1	0	0
6	18529148	.	G	T	1	0	1	0	0	1	0	0
6	18529457	.	G	A	1	0	1	0	0	1	0	0
6	18529589	.	G	A	2	0	2	0	0	2	0	0
6	18529593	.	T	G	1	1	2	0	0	2	0	0
6	18531946	.	T	C	3	2	5	0	0	5	0	0
6	18532445	.	A	T	3	3	6	0	1	7	0	0
6	18536239	.	G	T	3	0	3	0	0	3	0	0
6	18536748	.	C	T	1	1	2	0	0	2	0	0
6	18540815	.	G	T	1	0	1	0	0	1	0	0
6	18542933	.	T	C	3	7	10	0	1	11	0	0
6	18543385	.	C	T	15	16	31	0	0	31	0	0
6	18543400	.	A	G	14	15	29	0	3	32	0	0
6	18543637	.	A	G	8	11	19	0	1	20	0	0
6	18543735	.	A	G	4	9	13	0	0	13	0	0
6	18543950	.	G	T	11	6	17	0	0	17	0	0
6	18554177	.	T	G	5	6	11	0	0	11	0	0
6	18554541	.	G	A	2	3	5	0	0	5	0	0
6	18554702	.	C	G	3	3	6	0	0	6	0	0
6	18554719	.	T	C	3	0	3	0	2	5	0	0
6	18554764	.	G	C	4	2	6	0	0	6	0	0
6	18555195	.	T	C	1	2	3	0	1	4	0	0
6	18569606	.	T	G	5	2	7	0	0	7	0	0
6	18587728	.	G	A	4	1	5	0	0	5	0	0
6	18595391	.	C	A	2	3	5	0	0	5	0	0
6	18598494	.	A	T	3	1	4	0	1	5	0	0
6	18600288	.	C	T	0	3	3	0	1	4	0	0
6	18606063	.	T	C	5	9	14	0	0	14	0	0
6	18606135	.	T	G	11	12	23	0	0	23	0	0
6	18607590	.	G	A	11	19	30	0	2	32	0	0
6	18624371	.	A	G	5	2	7	0	1	8	0	0
6	18624464	.	T	A	10	3	13	0	0	13	0	0
6	18714592	.	T	G	2	5	7	0	0	7	0	0
6	18714753	.	A	T	2	3	5	0	0	5	0	0
6	18714754	.	A	T	2	3	5	0	0	5	0	0
6	18714845	.	A	C	3	5	8	0	1	9	0	0
6	18714890	.	T	A	8	10	18	0	0	18	0	0
6	18715090	.	A	G	6	4	10	0	0	10	0	0
6	18715309	.	T	C	2	0	2	0	4	6	0	0
6	18715540	.	A	G	5	3	8	0	0	8	0	0
6	18715544	.	C	T	3	5	8	0	0	8	0	0
6	18715879	.	A	C	6	3	9	0	1	10	0	0
6	18716054	.	G	A	5	6	11	0	0	11	0	0
6	18716242	.	G	A	4	6	10	0	0	10	0	0
6	18716269	.	A	G	6	3	9	0	0	9	0	0
6	18716330	.	C	T	2	4	6	0	0	6	0	0
6	18716539	.	C	T	0	8	8	0	3	11	0	0
6	18716551	.	T	C	7	3	10	0	0	10	0	0
6	18717315	.	T	C	5	2	7	0	0	7	0	0
6	18717319	.	A	T	5	2	7	0	0	7	0	0
6	18717449	.	C	A	0	5	5	0	6	11	0	0
6	18718006	.	T	C	1	0	1	0	2	3	0	0
6	18718438	.	T	G	5	2	7	0	0	7	0	0
6	18724415	.	T	A	3	5	8	0	0	8	0	0
6	18725196	.	C	T	3	3	6	0	0	6	0	0
6	18725232	.	A	G	1	3	4	0	0	4	0	0
6	18728766	.	A	G	1	2	3	0	0	3	0	0
6	18728793	.	T	C	1	0	1	0	0	1	0	0
6	18737442	.	A	G	2	2	4	0	0	4	0	0
6	18953406	.	G	C	1	3	4	0	0	4	0	0
6	18992696	.	G	C	2	3	5	0	0	5	0	0
6	18992723	.	G	A	2	4	6	0	0	6	0	0
6	19265802	.	C	A	4	2	6	0	0	6	0	0
6	19295015	.	T	A	17	16	33	0	4	37	0	0
6	19295044	.	A	T	23	13	36	0	0	36	0	0
6	19295469	.	T	C	21	0	21	0	17	38	0	0
6	19295609	.	A	T	14	12	26	0	1	27	0	0
6	19295644	.	C	T	0	15	15	0	17	32	0	0
6	19320696	.	C	T	0	4	4	0	6	10	0	0
6	19327380	.	C	T	3	2	5	0	0	5	0	0
6	19334722	.	A	C	2	5	7	0	0	7	0	0
6	19334948	.	A	T	2	2	4	0	0	4	0	0
6	19334949	.	C	A	2	2	4	0	0	4	0	0
6	19339426	.	C	T	4	2	6	0	0	6	0	0
6	19344846	.	C	T	3	18	21	0	0	21	0	0
6	19344930	.	G	C	5	7	12	0	4	16	0	0
6	19344950	.	C	T	10	11	21	0	2	23	0	0
6	19345191	.	G	A	2	7	9	0	0	9	0	0
6	19347426	.	C	T	0	4	4	0	10	14	0	0
6	19381679	.	C	G	4	2	6	0	0	6	0	0
6	19381846	.	G	C	1	4	5	0	0	5	0	0
6	19381856	.	C	T	2	3	5	0	0	5	0	0
6	19715507	.	A	C	2	0	2	0	0	2	0	0
6	19802042	.	T	C	4	10	14	0	0	14	0	0
6	19802242	.	C	T	9	16	25	0	0	25	0	0
6	19802330	.	G	A	12	7	19	0	2	21	0	0
6	19802354	.	G	A	11	6	17	0	0	17	0	0
6	19802414	.	C	G	2	1	3	0	7	10	0	0
6	19804213	.	A	C	3	4	7	0	0	7	0	0
6	19807574	.	A	G	3	1	4	0	0	4	0	0
6	19807599	.	A	T	0	2	2	0	0	2	0	0
6	19808818	.	G	A	1	5	6	0	0	6	0	0
6	20766136	.	C	T	5	7	12	0	0	12	0	0
6	20766307	.	A	G	19	18	37	0	1	38	0	0
6	20766500	.	G	T	7	13	20	0	0	20	0	0
6	20767015	.	T	A	16	15	31	0	3	34	0	0
6	20767537	.	A	G	20	19	39	0	0	39	0	0
6	20767830	.	T	G	8	6	14	0	1	15	0	0
6	20767958	.	T	G	5	4	9	0	1	10	0	0
6	20767994	.	T	C	13	8	21	0	0	21	0	0
6	20768061	.	A	G	9	8	17	0	1	18	0	0
6	20768076	.	C	A	7	8	15	0	0	15	0	0
6	20768107	.	A	T	10	4	14	0	1	16	1	0
6	20768239	.	A	G	16	6	22	0	1	23	0	0
6	20768338	.	G	A	11	12	23	0	1	24	0	0
6	20768346	.	T	G	12	12	24	0	1	25	0	0
6	20773961	.	G	A	15	9	24	0	0	24	0	0
6	20774048	.	A	C	17	13	30	0	1	31	0	0
6	20774701	.	G	A	4	2	6	0	0	6	0	0
6	20774768	.	C	T	5	9	14	0	1	15	0	0
6	20785089	.	A	G	2	4	6	0	0	6	0	0
6	20785105	.	C	T	0	5	5	0	3	9	1	0
6	20785144	.	G	A	11	6	17	0	1	18	0	0
6	20789072	.	A	G	12	10	22	0	0	22	0	0
6	20789162	.	G	A	8	5	13	0	1	14	0	0
6	20789195	.	C	T	10	5	15	0	0	15	0	0
6	20789351	.	T	C	8	4	12	0	1	13	0	0
6	20789369	.	T	A	7	4	11	0	1	12	0	0
6	20814418	.	A	G	1	0	1	0	0	1	0	0
6	20822000	.	A	G	2	3	5	0	0	5	0	0
6	20910713	.	G	T	2	0	2	0	0	2	0	0
6	20917730	.	A	T	4	2	6	0	0	6	0	0
6	20917780	.	T	A	5	3	8	0	1	9	0	0
6	20917921	.	G	A	8	9	17	0	0	17	0	0
6	20917922	.	A	C	8	9	17	0	0	17	0	0
6	20917991	.	A	T	7	5	12	0	1	13	0	0
6	20917994	.	C	T	6	3	9	0	2	11	0	0
6	20918456	.	C	A	8	6	14	0	0	14	0	0
6	20918613	.	G	T	12	9	21	0	0	21	0	0
6	20918673	.	T	C	7	6	13	0	2	15	0	0
6	20921859	.	G	A	10	4	14	0	0	14	0	0
6	20921888	.	T	C	8	7	15	0	0	15	0	0
6	20922057	.	A	T	7	8	15	0	1	16	0	0
6	20922316	.	G	C	14	0	14	0	4	18	0	0
6	20922330	.	G	A	13	3	16	0	0	16	0	0
6	20922396	.	G	A	9	6	15	0	0	15	0	0
6	20922468	.	G	A	5	5	10	0	0	11	1	0
6	20965710	.	G	A	0	3	3	0	2	5	0	0
6	20965745	.	T	A	1	4	5	0	0	5	0	0
6	20970989	.	T	A	3	2	5	0	0	5	0	0
6	20978972	.	C	T	1	0	1	0	0	2	1	0
6	20995800	.	A	G	4	7	11	0	1	12	0	0
6	20996705	.	C	T	4	6	10	0	0	10	0	0
6	20996733	.	A	C	4	3	7	0	5	12	0	0
6	20997031	.	A	T	6	5	11	0	0	11	0	0
6	21009283	.	G	C	1	2	3	0	0	3	0	0
6	21118608	.	G	A	2	1	3	0	0	3	0	0
6	21119953	.	C	A	4	3	7	0	0	7	0	0
6	21119994	.	T	C	4	7	11	0	0	11	0	0
6	21120001	.	A	G	4	7	11	0	0	11	0	0
6	21120080	.	A	G	4	2	6	0	2	8	0	0
6	21120146	.	G	C	2	6	8	0	0	8	0	0
6	21120193	.	T	C	4	6	10	0	0	10	0	0
6	21120201	.	T	C	4	5	9	0	0	9	0	0
6	21120261	.	C	T	8	4	12	0	0	12	0	0
6	21120341	.	A	C	2	4	6	0	0	6	0	0
6	21120387	.	T	C	4	5	9	0	0	9	0	0
6	21130623	.	C	T	1	3	4	0	0	4	0	0
6	21131142	.	A	T	1	2	3	0	0	3	0	0
6	21131414	.	C	A	1	3	4	0	0	4	0	0
6	21138869	.	C	T	0	2	2	0	0	2	0	0
6	21138870	.	T	G	0	2	2	0	0	2	0	0
6	21146813	.	T	G	1	0	1	0	4	5	0	0
6	21147218	.	G	A	0	9	9	0	2	11	0	0
6	21147240	.	A	G	1	9	10	0	0	10	0	0
6	21147291	.	C	A	5	3	8	0	0	8	0	0
6	21147332	.	T	A	6	6	12	0	0	12	0	0
6	21147334	.	T	A	6	6	12	0	0	12	0	0
6	21147368	.	G	A	0	6	6	0	3	9	0	0
6	21147818	.	T	C	8	4	12	0	1	13	0	0
6	21147837	.	A	G	8	3	11	0	0	11	0	0
6	21147920	.	A	C	7	5	12	0	1	13	0	0
6	21148166	.	A	T	8	4	12	0	1	13	0	0
6	21148167	.	T	C	7	4	11	0	2	13	0	0
6	21148736	.	T	A	1	1	2	0	0	2	0	0
6	21148737	.	A	T	1	1	2	0	0	2	0	0
6	21148972	.	G	C	3	2	5	0	0	5	0	0
6	21149337	.	G	A	2	2	4	0	0	4	0	0
6	21150661	.	T	C	8	10	18	0	0	18	0	0
6	21150672	.	G	A	10	12	22	0	0	22	0	0
6	21150712	.	A	T	18	12	30	0	2	32	0	0
6	21150872	.	C	T	15	20	35	0	1	36	0	0
6	21150958	.	A	G	14	18	32	0	0	32	0	0
6	21151027	.	A	G	12	7	19	0	2	21	0	0
6	21151078	.	T	C	8	13	21	0	0	21	0	0
6	21151312	.	T	C	1	2	3	0	1	4	0	0
6	21151379	.	A	C	2	16	18	0	1	19	0	0
6	21151415	.	T	C	3	8	11	0	2	13	0	0
6	21151459	.	T	C	4	12	16	0	0	16	0	0
6	21153285	.	G	A	0	10	10	0	6	16	0	0
6	21154996	.	T	A	5	6	11	0	0	11	0	0
6	21369132	.	G	C	1	1	2	0	0	2	0	0
6	21390316	.	G	A	0	2	2	0	6	8	0	0
6	21391444	.	C	T	0	3	3	0	0	3	0	0
6	21391675	.	A	G	4	5	9	0	0	9	0	0
6	21392126	.	A	G	6	6	12	0	0	12	0	0
6	21392472	.	G	A	1	4	5	0	0	5	0	0
6	21392545	.	C	T	4	3	7	0	0	7	0	0
6	21392584	.	C	A	6	6	12	0	0	12	0	0
6	21392722	.	T	C	5	7	12	0	0	12	0	0
6	21393635	.	G	A	1	6	7	0	10	17	0	0
6	21454984	.	C	A	6	4	10	0	0	10	0	0
6	21513490	.	A	T	2	3	5	0	0	5	0	0
6	21513778	.	A	G	1	6	7	0	0	7	0	0
6	21513826	.	C	A	2	8	10	0	1	11	0	0
6	21513885	.	G	T	5	3	8	0	0	8	0	0
6	21514651	.	G	T	1	3	4	0	1	5	0	0
6	21515063	.	A	G	1	2	3	0	0	3	0	0
6	21525887	.	C	A	8	6	14	0	1	15	0	0
6	21525916	.	A	G	11	10	21	0	0	21	0	0
6	21525943	.	T	A	13	12	25	0	3	28	0	0
6	21526047	.	C	A	2	4	6	0	0	6	0	0
6	21526069	.	T	C	7	0	7	0	3	10	0	0
6	21526109	.	A	G	14	1	15	0	0	15	0	0
6	21526322	.	A	G	11	15	26	0	0	26	0	0
6	21526357	.	C	T	0	17	17	0	7	24	0	0
6	21526620	.	T	C	2	3	5	0	0	5	0	0
6	21529229	.	A	G	2	7	9	0	0	9	0	0
6	21529253	.	C	A	9	10	19	0	1	20	0	0
6	21529379	.	A	T	5	2	7	0	0	7	0	0
6	21578702	.	G	A	0	1	1	0	0	1	0	0
6	21578732	.	A	T	4	2	6	0	0	6	0	0
6	21578760	.	C	T	3	5	8	0	1	9	0	0
6	21588594	.	C	A	0	9	9	0	10	19	0	0
6	21588597	.	T	G	10	8	18	0	1	19	0	0
6	21588727	.	T	A	7	10	17	0	0	17	0	0
6	21598085	.	C	T	3	5	8	0	1	9	0	0
6	21602679	.	T	G	0	5	5	0	1	6	0	0
6	21615529	.	C	T	4	3	7	0	0	7	0	0
6	21693910	.	A	G	6	8	14	0	0	14	0	0
6	21694306	.	G	A	11	7	18	0	0	18	0	0
6	21694369	.	T	A	7	8	15	0	0	15	0	0
6	21694486	.	C	A	5	12	17	0	2	19	0	0
6	21694591	.	C	A	3	9	12	0	1	13	0	0
6	21694652	.	T	A	7	9	16	0	1	17	0	0
6	21694917	.	C	A	6	8	14	0	0	14	0	0
6	21695033	.	C	A	7	4	11	0	1	12	0	0
6	21695034	.	C	T	8	3	11	0	1	12	0	0
6	21726584	.	C	T	1	2	3	0	0	3	0	0
6	21811551	.	G	A	2	3	5	0	0	5	0	0
6	21861324	.	G	T	19	17	36	0	4	40	0	0
6	21861490	.	C	A	0	17	17	0	19	36	0	0
6	21861590	.	G	T	7	8	15	0	0	15	0	0
6	21861725	.	A	T	9	1	10	0	6	16	0	0
6	21861736	.	T	G	6	8	14	0	1	15	0	0
6	21862054	.	C	A	19	17	36	0	0	36	0	0
6	21862158	.	G	C	19	14	33	0	1	34	0	0
6	21862486	.	G	A	22	20	42	0	1	43	0	0
6	21875429	.	A	C	2	3	5	0	0	5	0	0
6	21875691	.	T	C	5	0	5	0	8	13	0	0
6	21875960	.	A	G	1	3	4	0	0	4	0	0
6	21876045	.	A	G	0	6	6	0	0	6	0	0
6	21876060	.	G	A	2	3	5	0	0	5	0	0
6	21876131	.	T	A	5	9	14	0	0	14	0	0
6	21877981	.	G	A	1	4	5	0	0	5	0	0
6	21996194	.	A	C	5	4	9	0	0	9	0	0
6	21996281	.	C	A	3	4	7	0	0	7	0	0
6	21996320	.	A	G	2	4	6	0	0	6	0	0
6	21996452	.	C	A	3	5	8	0	0	8	0	0
6	21999860	.	A	T	0	1	1	0	1	2	0	0
6	22007420	.	G	A	4	2	6	0	0	6	0	0
6	22026339	.	T	A	4	5	9	0	0	9	0	0
6	22026431	.	G	C	3	3	6	0	0	6	0	0
6	22026440	.	G	A	3	3	6	0	0	6	0	0
6	22026825	.	C	A	1	2	3	0	1	4	0	0
6	22027263	.	A	G	4	0	4	0	8	12	0	0
6	22028009	.	A	T	1	0	1	0	0	1	0	0
6	22034802	.	A	G	5	5	10	0	0	10	0	0
6	22034961	.	A	C	6	11	17	0	0	17	0	0
6	22035222	.	G	A	0	18	18	0	8	26	0	0
6	22035426	.	A	G	10	12	22	0	0	22	0	0
6	22035519	.	G	A	7	6	13	0	1	14	0	0
6	22037517	.	A	G	3	0	3	0	6	9	0	0
6	22037553	.	G	A	8	6	14	0	2	16	0	0
6	22037565	.	A	G	10	1	11	0	7	18	0	0
6	22037625	.	C	T	11	8	19	0	0	19	0	0
6	22053067	.	C	T	0	2	2	0	0	2	0	0
6	22090275	.	T	C	8	3	11	0	0	11	0	0
6	22093674	.	T	A	0	1	1	0	0	1	0	0
6	22093707	.	A	G	0	1	1	0	0	1	0	0
6	22099448	.	C	T	1	0	1	0	0	1	0	0
6	22102095	.	C	T	1	5	6	0	0	6	0	0
6	22102116	.	A	G	1	6	7	0	0	7	0	0
6	22105061	.	G	C	3	5	8	0	0	8	0	0
6	22105118	.	A	T	2	5	7	0	1	8	0	0
6	22105289	.	T	G	2	0	2	0	0	2	0	0
6	22107277	.	C	T	2	2	4	0	0	4	0	0
6	22107813	.	T	G	4	0	4	0	4	8	0	0
6	22107858	.	C	T	2	3	5	0	0	5	0	0
6	22108307	.	C	A	2	3	5	0	1	6	0	0
6	22109552	.	T	G	3	0	3	0	3	6	0	0
6	22109678	.	A	T	1	0	1	0	0	1	0	0
6	22111594	.	A	G	10	17	27	0	1	28	0	0
6	22112416	.	C	T	1	0	1	0	0	1	0	0
6	22118497	.	G	C	13	15	28	0	0	28	0	0
6	22118630	.	G	A	22	16	38	0	4	42	0	0
6	22118681	.	C	T	12	17	29	0	3	32	0	0
6	22119201	.	T	A	13	13	26	0	0	26	0	0
6	22119241	.	A	T	12	10	22	0	1	23	0	0
6	22119376	.	A	C	14	18	32	0	1	33	0	0
6	22119516	.	T	C	17	26	43	0	3	46	0	0
6	22119582	.	T	C	26	13	39	0	0	39	0	0
6	22119668	.	T	C	5	3	8	0	1	9	0	0
6	22119836	.	T	A	5	3	8	0	1	9	0	0
6	22119977	.	T	A	16	10	26	0	1	27	0	0
6	22120342	.	T	A	10	8	18	0	0	18	0	0
6	22120445	.	A	G	10	5	15	0	2	17	0	0
6	22127270	.	C	T	5	7	12	0	1	13	0	0
6	22327331	.	T	C	0	2	2	0	0	2	0	0
6	22328821	.	A	G	3	0	3	0	2	5	0	0
6	22333884	.	A	T	3	11	14	0	0	14	0	0
6	22344452	.	C	T	4	10	14	0	1	15	0	0
6	22351692	.	T	C	24	27	51	0	1	52	0	0
6	22351727	.	T	C	24	28	52	0	0	52	0	0
6	22351770	.	A	C	25	20	45	0	2	47	0	0
6	22351780	.	T	A	17	22	39	0	5	44	0	0
6	22352229	.	T	C	5	12	17	0	3	20	0	0
6	22352370	.	C	T	9	9	18	0	0	18	0	0
6	22352539	.	C	T	8	25	33	0	1	34	0	0
6	22354759	.	A	G	2	1	3	0	0	3	0	0
6	22355040	.	T	C	0	1	1	0	2	3	0	0
6	22364151	.	T	C	4	2	6	0	0	6	0	0
6	22463151	.	A	G	4	3	7	0	0	7	0	0
6	22464834	.	A	G	1	0	1	0	0	1	0	0
6	22464835	.	C	A	1	0	1	0	0	1	0	0
6	22597503	.	G	A	15	8	23	0	2	25	0	0
6	22615546	.	G	A	9	24	33	0	2	35	0	0
6	22628073	.	T	G	7	13	20	0	0	20	0	0
6	22628112	.	A	G	2	8	10	0	1	11	0	0
6	22628483	.	G	A	0	14	14	0	20	34	0	0
6	22628779	.	T	C	14	23	37	0	3	40	0	0
6	22628997	.	T	G	4	0	4	0	6	10	0	0
6	22629099	.	A	T	8	6	14	0	0	14	0	0
6	22629182	.	A	G	5	5	10	0	0	10	0	0
6	22966966	.	C	A	1	0	1	0	0	1	0	0
6	23001363	.	G	A	0	2	2	0	0	2	0	0
6	23018861	.	G	A	3	3	6	0	0	6	0	0
6	23042113	.	G	T	1	0	1	0	0	1	0	0
6	23053129	.	C	T	7	2	9	0	0	9	0	0
6	23053296	.	A	G	4	10	14	0	1	15	0	0
6	23053374	.	G	A	0	9	9	0	7	16	0	0
6	23053482	.	G	C	4	9	13	0	1	14	0	0
6	23053761	.	A	G	8	12	20	0	2	22	0	0
6	23053980	.	A	T	12	13	25	0	2	27	0	0
6	23054266	.	C	T	16	13	29	0	2	31	0	0
6	23054569	.	C	T	4	16	20	0	2	22	0	0
6	23054705	.	A	G	5	0	5	0	11	16	0	0
6	23137335	.	T	A	2	2	4	0	0	4	0	0
6	23781314	.	C	T	5	7	12	0	0	12	0	0
6	23810922	.	G	C	3	2	5	0	0	5	0	0
6	23811154	.	C	T	4	7	11	0	0	11	0	0
6	23812768	.	T	A	4	4	8	0	0	8	0	0
6	23812771	.	C	G	4	3	7	0	0	7	0	0
6	23812885	.	T	C	6	13	19	0	0	19	0	0
6	23813437	.	G	C	14	16	30	0	0	30	0	0
6	23813554	.	C	A	18	17	35	0	0	35	0	0
6	23813767	.	C	A	16	18	34	0	0	34	0	0
6	23938676	.	A	C	4	12	16	0	0	16	0	0
6	23938738	.	A	G	5	9	14	0	1	15	0	0
6	24055743	.	T	A	5	11	16	0	1	17	0	0
6	24055784	.	G	A	4	9	13	0	2	15	0	0
6	24055866	.	G	T	3	5	8	0	3	11	0	0
6	24056103	.	C	T	0	8	8	0	7	15	0	0
6	24065975	.	C	G	0	1	1	0	2	3	0	0
6	24066253	.	T	C	12	2	14	0	3	17	0	0
6	24066345	.	A	G	8	5	13	0	0	13	0	0
6	24066382	.	T	A	8	9	17	0	0	17	0	0
6	24066547	.	C	T	1	9	10	0	9	19	0	0
6	24066575	.	T	C	8	8	16	0	0	16	0	0
6	24066662	.	A	T	2	4	6	0	0	6	0	0
6	24091437	.	G	T	1	4	5	0	0	5	0	0
6	24094574	.	T	A	1	2	3	0	0	3	0	0
6	24094588	.	A	G	1	3	4	0	0	4	0	0
6	24153159	.	C	T	18	25	43	0	2	45	0	0
6	24155442	.	A	T	13	21	34	0	0	34	0	0
6	24155744	.	T	C	10	25	35	0	2	37	0	0
6	24155766	.	T	C	21	12	33	0	0	33	0	0
6	24155886	.	A	C	9	0	9	0	13	22	0	0
6	24155898	.	C	T	10	9	19	0	1	20	0	0
6	24156027	.	T	C	20	20	40	0	0	40	0	0
6	24156344	.	T	G	15	9	24	0	5	29	0	0
6	24156399	.	C	G	12	10	22	0	1	23	0	0
6	24156428	.	A	T	8	13	21	0	0	21	0	0
6	24156476	.	T	G	8	8	16	0	1	17	0	0
6	24156486	.	A	C	8	7	15	0	0	15	0	0
6	24156567	.	T	C	14	0	14	0	6	20	0	0
6	24157177	.	C	T	4	2	6	0	1	7	0	0
6	24158601	.	T	C	5	0	5	0	9	14	0	0
6	24161409	.	G	A	9	8	17	0	1	18	0	0
6	24163543	.	T	C	1	1	2	0	0	2	0	0
6	24338496	.	T	A	16	13	29	0	1	30	0	0
6	24338526	.	G	A	10	11	21	0	0	21	0	0
6	24358326	.	G	A	5	5	10	0	2	12	0	0
6	24358596	.	G	A	3	8	11	0	0	11	0	0
6	24358608	.	T	A	7	2	9	0	2	11	0	0
6	24365205	.	T	A	9	7	16	0	0	16	0	0
6	24365482	.	C	A	8	7	15	0	0	15	0	0
6	24370637	.	C	T	7	8	15	0	1	16	0	0
6	24370646	.	T	C	9	8	17	0	1	18	0	0
6	24379745	.	T	C	2	5	7	0	0	7	0	0
6	24379760	.	T	C	1	5	6	0	1	7	0	0
6	24379802	.	T	G	2	5	7	0	0	7	0	0
6	24379865	.	G	A	10	16	26	0	2	28	0	0
6	24380335	.	C	A	9	6	15	0	0	15	0	0
6	24382063	.	A	T	3	4	7	0	0	7	0	0
6	24384613	.	T	C	4	5	9	0	0	9	0	0
6	24389518	.	A	T	0	1	1	0	0	1	0	0
6	24392318	.	C	T	3	4	7	0	0	7	0	0
6	24392562	.	T	C	4	0	4	0	3	7	0	0
6	24392732	.	T	C	5	2	7	0	0	7	0	0
6	24392837	.	T	C	2	2	4	0	0	4	0	0
6	24681529	.	C	T	2	4	6	0	0	6	0	0
6	24682165	.	G	C	4	5	9	0	0	9	0	0
6	24682721	.	C	T	4	6	10	0	1	11	0	0
6	24682759	.	G	T	7	5	12	0	0	12	0	0
6	24682925	.	T	C	7	4	11	0	1	12	0	0
6	24683354	.	C	T	5	7	12	0	1	13	0	0
6	24683723	.	A	T	6	3	9	0	0	9	0	0
6	24691718	.	A	T	8	8	16	0	0	16	0	0
6	24691791	.	A	T	8	3	11	0	1	12	0	0
6	24697940	.	G	C	7	11	18	0	0	18	0	0
6	24698036	.	A	G	4	0	4	0	5	9	0	0
6	24818240	.	C	A	13	9	22	0	0	22	0	0
6	24818312	.	C	G	16	9	25	0	0	25	0	0
6	25168647	.	G	C	7	3	10	0	0	10	0	0
6	25169241	.	A	T	4	1	5	0	0	5	0	0
6	25169277	.	C	T	0	5	5	0	2	7	0	0
6	25169334	.	A	C	0	4	4	0	2	6	0	0
6	25169385	.	T	A	1	3	4	0	0	4	0	0
6	25170022	.	G	C	0	0	0	0	1	1	0	0
6	25170035	.	C	T	1	2	3	0	0	3	0	0
6	25170438	.	T	C	4	3	7	0	0	7	0	0
6	25170743	.	G	A	6	2	8	0	0	8	0	0
6	25171078	.	T	A	5	2	7	0	0	7	0	0
6	25171100	.	A	G	3	5	8	0	1	9	0	0
6	25171285	.	A	G	8	5	13	0	0	13	0	0
6	25172176	.	A	T	2	5	7	0	0	7	0	0
6	25173005	.	G	A	4	4	8	0	0	8	0	0
6	25173026	.	A	G	3	2	5	0	2	7	0	0
6	25188225	.	A	T	1	2	3	0	0	3	0	0
6	25188226	.	C	T	1	2	3	0	0	3	0	0
6	25265306	.	G	A	1	2	3	0	0	3	0	0
6	25266275	.	C	T	0	3	3	0	0	3	0	0
6	25266345	.	T	C	0	2	2	0	0	2	0	0
6	25314577	.	T	A	3	5	8	0	0	8	0	0
6	25933917	.	T	C	16	1	17	0	22	39	0	0
6	25934214	.	A	G	24	5	29	0	1	32	2	0
6	25934313	.	A	T	20	19	39	0	2	41	0	0
6	26065499	.	A	C	8	2	10	0	0	10	0	0
6	26065508	.	C	A	0	2	2	0	7	9	0	0
6	26066097	.	A	T	0	1	1	0	0	1	0	0
6	26080187	.	A	G	4	3	7	0	0	7	0	0
6	26080352	.	C	T	5	3	8	0	0	8	0	0
6	26225456	.	G	A	3	2	5	0	0	5	0	0
6	26225479	.	T	G	4	3	7	0	0	7	0	0
6	26225575	.	A	C	3	0	3	0	7	10	0	0
6	26225657	.	G	C	2	4	6	0	0	6	0	0
6	26558837	.	C	T	1	15	16	0	20	36	0	0
6	26558927	.	C	T	0	21	21	0	12	33	0	0
6	26559179	.	T	C	14	1	15	0	31	46	0	0
6	26559780	.	A	G	14	14	28	0	1	29	0	0
6	26559807	.	A	G	11	12	23	0	1	24	0	0
6	26875804	.	C	A	3	16	19	0	1	20	0	0
6	26875944	.	T	A	18	20	38	0	0	38	0	0
6	26878802	.	G	A	0	3	3	0	1	4	0	0
6	26879486	.	G	T	4	8	12	0	1	13	0	0
6	26879510	.	T	C	2	5	7	0	0	7	0	0
6	26883895	.	T	G	7	6	13	0	0	13	0	0
6	26891891	.	A	G	2	3	5	0	0	5	0	0
6	27038198	.	G	A	1	2	3	0	1	4	0	0
6	27038507	.	A	T	3	4	7	0	0	7	0	0
6	27041886	.	T	C	8	6	14	0	0	14	0	0
6	27041988	.	C	T	7	0	7	0	0	7	0	0
6	27045205	.	G	A	5	9	14	0	0	14	0	0
6	27045238	.	A	G	1	5	6	0	0	6	0	0
6	27045424	.	T	C	0	0	0	0	1	1	0	0
6	27048800	.	T	A	3	6	9	0	2	11	0	0
6	27048976	.	A	G	7	3	10	0	1	11	0	0
6	27051710	.	G	A	2	1	3	0	0	3	0	0
6	27051749	.	C	T	6	6	12	0	0	12	0	0
6	27051836	.	G	A	5	1	6	0	0	6	0	0
6	27055569	.	T	C	0	1	1	0	0	1	0	0
6	27057438	.	A	G	0	2	2	0	0	2	0	0
6	27057561	.	A	G	6	5	11	0	0	11	0	0
6	27063155	.	T	A	2	2	4	0	0	4	0	0
6	27063158	.	G	A	2	1	3	0	0	3	0	0
6	27067560	.	C	T	1	1	2	0	0	2	0	0
6	27087515	.	T	A	10	4	14	0	0	14	0	0
6	27087776	.	A	G	8	3	11	0	0	11	0	0
6	27087788	.	C	T	6	2	8	0	0	8	0	0
6	27087827	.	A	T	1	4	5	0	0	5	0	0
6	27087843	.	A	G	3	3	6	0	0	6	0	0
6	27087875	.	G	A	3	1	4	0	1	5	0	0
6	27087884	.	C	T	3	2	5	0	0	5	0	0
6	27087929	.	T	C	1	5	6	0	0	6	0	0
6	27088076	.	G	C	7	6	13	0	1	14	0	0
6	27099004	.	T	C	1	1	2	0	1	3	0	0
6	27099061	.	G	A	4	3	7	0	0	7	0	0
6	27101393	.	A	G	6	0	6	0	7	13	0	0
6	27104458	.	G	C	14	9	23	0	1	24	0	0
6	27104584	.	T	C	8	12	20	0	0	20	0	0
6	27104898	.	A	T	4	3	7	0	0	7	0	0
6	27104906	.	C	G	3	1	4	0	0	4	0	0
6	27108716	.	T	A	4	3	7	0	0	7	0	0
6	27146872	.	C	T	3	5	8	0	0	8	0	0
6	27216458	.	T	A	1	0	1	0	0	1	0	0
6	27220245	.	C	T	6	4	10	0	0	10	0	0
6	27231706	.	G	A	0	1	1	0	0	1	0	0
6	27233775	.	G	A	0	7	7	0	3	10	0	0
6	27234032	.	T	G	2	3	5	0	0	5	0	0
6	27234250	.	C	T	2	2	4	0	0	4	0	0
6	27259107	.	T	A	9	3	12	0	0	12	0	0
6	27260541	.	A	G	8	0	8	0	5	13	0	0
6	27265434	.	C	T	3	0	3	0	1	4	0	0
6	27269862	.	G	A	0	20	20	0	15	35	0	0
6	27269873	.	C	T	20	13	33	0	3	36	0	0
6	27269902	.	T	A	14	22	36	0	0	36	0	0
6	27270389	.	C	A	8	15	23	0	1	24	0	0
6	27270548	.	G	A	16	20	36	0	0	36	0	0
6	27270738	.	A	G	23	1	24	0	15	39	0	0
6	27270959	.	C	A	8	8	16	0	3	19	0	0
6	27271352	.	G	A	1	14	15	0	19	34	0	0
6	27271355	.	C	T	20	13	33	0	1	34	0	0
6	27271390	.	T	A	12	16	28	0	2	30	0	0
6	27271409	.	G	A	26	8	34	0	0	34	0	0
6	27271443	.	G	A	24	16	40	0	2	42	0	0
6	27271498	.	C	T	22	28	50	0	1	51	0	0
6	27271610	.	A	T	14	6	20	0	0	20	0	0
6	27271617	.	G	A	13	7	20	0	2	22	0	0
6	27272205	.	G	C	25	21	46	0	1	47	0	0
6	27272440	.	C	T	17	20	37	0	3	40	0	0
6	27272487	.	A	T	23	14	37	0	1	38	0	0
6	27272488	.	T	C	23	14	37	0	1	38	0	0
6	27272623	.	A	G	17	30	47	0	2	49	0	0
6	27272660	.	C	G	10	34	44	0	0	44	0	0
6	27272835	.	G	T	21	18	39	0	0	39	0	0
6	27276750	.	G	A	1	0	1	0	1	2	0	0
6	27450385	.	G	A	1	2	3	0	0	3	0	0
6	27497895	.	C	T	3	2	5	0	0	5	0	0
6	27578216	.	C	T	1	0	1	0	0	1	0	0
6	27613633	.	C	T	1	2	3	0	0	3	0	0
6	27614989	.	A	T	2	2	4	0	0	4	0	0
6	27614993	.	T	C	2	2	4	0	0	4	0	0
6	27615210	.	G	A	0	3	3	0	1	4	0	0
6	27615242	.	A	C	1	4	5	0	0	5	0	0
6	27664008	.	G	A	0	4	4	0	1	5	0	0
6	27664368	.	T	A	1	2	3	0	0	3	0	0
6	27667415	.	A	C	16	17	33	0	1	34	0	0
6	27775416	.	T	A	0	1	1	0	0	1	0	0
6	27874674	.	T	C	12	16	28	0	1	29	0	0
6	27874680	.	C	G	11	17	28	0	3	31	0	0
6	27874730	.	A	G	11	0	11	0	17	28	0	0
6	27874753	.	G	C	1	9	10	0	11	21	0	0
6	27874769	.	T	A	10	6	16	0	2	18	0	0
6	27874896	.	T	A	22	13	35	0	2	37	0	0
6	27875309	.	T	C	33	20	53	0	0	53	0	0
6	27875383	.	G	T	21	32	53	0	2	56	1	0
6	27875519	.	G	T	24	18	42	2	3	47	0	0
6	27875598	.	T	C	1	25	26	0	1	27	0	0
6	27875600	.	A	C	26	1	27	0	0	27	0	0
6	27875873	.	A	G	16	25	41	0	2	43	0	0
6	27876060	.	T	A	29	33	62	0	0	62	0	0
6	27876134	.	C	T	31	27	58	0	0	58	0	0
6	27876503	.	G	A	1	4	5	0	0	5	0	0
6	27884952	.	G	A	2	2	4	0	0	4	0	0
6	27884967	.	G	A	2	4	6	0	0	6	0	0
6	27889080	.	A	T	3	2	5	0	0	5	0	0
6	27993569	.	T	C	1	3	4	0	0	4	0	0
6	27997333	.	C	T	2	2	4	0	0	4	0	0
6	27998329	.	C	A	1	1	2	0	0	2	0	0
6	27999645	.	C	T	1	4	5	0	0	5	0	0
6	27999744	.	A	C	6	4	10	0	0	10	0	0
6	28000242	.	T	A	4	8	12	0	2	14	0	0
6	28000316	.	G	A	0	14	14	0	5	19	0	0
6	28000597	.	A	C	4	2	6	0	0	6	0	0
6	28000768	.	G	T	8	6	14	0	2	16	0	0
6	28031468	.	G	A	0	1	1	0	0	1	0	0
6	28031474	.	T	C	0	1	1	0	0	1	0	0
6	28033221	.	T	A	0	2	2	0	0	2	0	0
6	28036311	.	C	T	2	5	7	0	0	7	0	0
6	28036714	.	A	G	0	0	0	0	1	1	0	0
6	28039175	.	T	A	3	7	10	0	0	10	0	0
6	28041161	.	G	A	0	5	5	0	5	10	0	0
6	28044401	.	A	G	4	4	8	0	0	8	0	0
6	28048949	.	T	G	4	2	6	0	0	6	0	0
6	28207418	.	C	G	11	16	27	0	0	27	0	0
6	28207532	.	C	A	1	4	5	0	0	5	0	0
6	28207534	.	A	G	1	4	5	0	0	5	0	0
6	28208665	.	G	A	4	2	6	0	0	6	0	0
6	28217596	.	C	T	0	7	7	0	7	14	0	0
6	28218159	.	G	T	8	9	17	0	0	17	0	0
6	28218555	.	T	G	7	9	16	0	0	17	1	0
6	28223273	.	G	C	2	2	4	0	0	4	0	0
6	28224044	.	T	A	2	2	4	0	0	4	0	0
6	28689130	.	A	C	1	1	2	0	0	2	0	0
6	28914331	.	A	G	5	5	10	0	0	10	0	0
6	28914336	.	C	T	5	5	10	0	0	10	0	0
6	28914418	.	A	G	12	12	24	0	0	24	0	0
6	28914523	.	G	A	13	12	25	0	0	25	0	0
6	28914571	.	T	A	17	9	26	0	0	26	0	0
6	28914886	.	G	A	8	8	16	0	1	17	0	0
6	28914975	.	T	A	16	13	29	0	0	29	0	0
6	28923667	.	G	A	0	2	2	0	0	2	0	0
6	28926540	.	C	T	3	1	4	0	0	4	0	0
6	28926567	.	T	A	4	3	7	0	1	8	0	0
6	28931184	.	C	T	2	2	4	0	0	4	0	0
6	28932634	.	G	A	6	2	8	0	0	8	0	0
6	28946199	.	T	G	22	20	42	0	2	44	0	0
6	28956323	.	A	G	10	6	16	0	0	16	0	0
6	28957089	.	G	A	6	4	10	0	1	11	0	0
6	28957814	.	C	G	7	3	10	0	0	10	0	0
6	28961407	.	A	G	2	3	5	0	0	5	0	0
6	29011988	.	C	T	7	9	16	0	1	17	0	0
6	29012037	.	A	T	12	9	21	0	1	22	0	0
6	29034576	.	G	C	6	2	8	0	0	8	0	0
6	29040789	.	C	T	2	6	8	0	1	9	0	0
6	29040885	.	C	T	0	3	3	0	7	10	0	0
6	29043162	.	T	G	0	1	1	0	0	1	0	0
6	29043673	.	G	A	3	4	7	0	0	7	0	0
6	29044933	.	A	G	3	2	5	0	0	5	0	0
6	29087164	.	T	G	1	1	2	0	0	2	0	0
6	29096659	.	A	C	14	4	18	0	4	22	0	0
6	29097297	.	G	A	27	22	49	0	1	50	0	0
6	29097344	.	T	C	16	4	20	0	3	23	0	0
6	29103005	.	G	A	2	3	5	0	1	6	0	0
6	29103419	.	G	A	4	2	6	0	0	6	0	0
6	29108423	.	T	G	1	0	1	0	0	1	0	0
6	29144951	.	T	A	3	3	6	0	2	8	0	0
6	29144952	.	A	T	5	3	8	0	0	8	0	0
6	29145433	.	C	A	0	6	6	0	14	20	0	0
6	29145742	.	T	A	4	6	10	0	0	10	0	0
6	29152208	.	C	T	5	10	15	0	0	15	0	0
6	29152618	.	A	G	4	3	7	0	1	8	0	0
6	29152769	.	G	A	4	6	10	0	0	10	0	0
6	29152819	.	C	T	7	6	13	0	1	14	0	0
6	29154280	.	T	A	4	7	11	0	0	11	0	0
6	29154295	.	T	C	8	0	8	0	4	12	0	0
6	29154520	.	C	T	5	2	7	0	1	8	0	0
6	29154721	.	G	A	4	4	8	0	0	8	0	0
6	29154889	.	C	A	3	4	7	0	0	7	0	0
6	29155039	.	G	A	4	2	6	0	0	6	0	0
6	29159616	.	T	C	5	2	7	0	0	7	0	0
6	29159851	.	G	A	2	5	7	0	2	9	0	0
6	29221040	.	C	T	3	2	5	0	0	5	0	0
6	29222796	.	A	C	12	4	16	0	0	16	0	0
6	29223651	.	T	C	2	7	9	0	0	9	0	0
6	29226126	.	G	A	0	14	14	0	9	23	0	0
6	29226186	.	A	G	13	18	31	0	1	32	0	0
6	29226189	.	C	T	18	10	28	0	2	30	0	0
6	29226767	.	A	T	16	14	30	0	0	30	0	0
6	29226790	.	G	A	15	14	29	0	0	29	0	0
6	29226823	.	A	C	16	9	25	0	0	25	0	0
6	29227527	.	A	T	0	1	1	0	0	1	0	0
6	29273690	.	C	T	3	0	3	0	0	3	0	0
6	29273855	.	G	A	4	3	7	0	0	7	0	0
6	29278868	.	T	G	1	4	5	0	0	5	0	0
6	29278874	.	G	A	1	4	5	0	0	5	0	0
6	29287954	.	G	A	4	3	7	0	0	7	0	0
6	29288042	.	G	A	1	3	4	0	0	4	0	0
6	29289386	.	G	A	0	2	2	0	0	2	0	0
6	29289883	.	C	T	4	3	7	0	0	7	0	0
6	29292610	.	A	C	3	2	5	0	1	6	0	0
6	29292651	.	A	G	4	8	12	0	0	12	0	0
6	29292728	.	C	T	5	7	12	0	1	13	0	0
6	29292780	.	G	A	6	9	15	0	0	15	0	0
6	29292804	.	G	A	7	7	14	0	0	14	0	0
6	29292849	.	G	T	7	5	12	0	0	12	0	0
6	29295492	.	T	A	7	11	18	0	2	20	0	0
6	29295517	.	G	C	10	10	20	0	0	20	0	0
6	29295535	.	T	A	6	6	12	0	4	16	0	0
6	29295713	.	C	A	6	10	16	0	1	17	0	0
6	29295714	.	G	A	11	6	17	0	0	17	0	0
6	29295851	.	G	A	8	5	13	0	0	13	0	0
6	29295860	.	C	T	7	4	11	0	0	11	0	0
6	29303573	.	C	T	6	8	14	0	1	15	0	0
6	29303625	.	G	A	4	8	12	0	1	13	0	0
6	29303630	.	G	A	10	3	13	0	0	13	0	0
6	29303778	.	C	T	0	12	12	0	4	16	0	0
6	29303925	.	C	T	6	3	9	0	0	9	0	0
6	29303958	.	C	T	0	0	0	0	1	1	0	0
6	29322547	.	G	A	7	4	11	0	0	11	0	0
6	29328308	.	G	A	3	7	10	0	1	11	0	0
6	29328524	.	A	G	4	7	11	0	1	12	0	0
6	29328866	.	G	A	3	1	4	0	0	4	0	0
6	29330727	.	A	G	3	2	5	0	0	5	0	0
6	29336100	.	T	C	2	0	2	0	0	2	0	0
6	29343892	.	G	A	3	3	6	0	0	6	0	0
6	29348152	.	T	A	1	3	4	0	0	4	0	0
6	29393714	.	C	T	1	0	1	0	0	1	0	0
6	29394244	.	A	T	3	0	3	0	0	3	0	0
6	29395424	.	G	A	13	10	23	0	1	24	0	0
6	29395497	.	T	A	9	13	22	0	1	23	0	0
6	29395577	.	T	G	2	2	4	1	0	5	0	0
6	29395583	.	T	G	1	2	3	1	1	5	0	0
6	29397697	.	G	A	5	2	7	0	0	7	0	0
6	29401837	.	T	C	7	2	9	0	0	9	0	0
6	29403052	.	G	T	0	9	9	0	14	23	0	0
6	29403076	.	C	T	11	15	26	0	0	26	0	0
6	29410040	.	C	T	2	4	6	0	0	6	0	0
6	29458942	.	T	C	1	1	2	0	0	2	0	0
6	29466626	.	C	A	4	3	7	0	0	7	0	0
6	29466993	.	T	A	2	2	4	0	0	4	0	0
6	29467644	.	A	G	1	2	3	0	1	4	0	0
6	29467898	.	C	T	2	2	4	0	0	4	0	0
6	29468196	.	T	G	3	3	6	0	0	6	0	0
6	29468198	.	C	T	2	1	3	0	3	6	0	0
6	29468320	.	C	T	4	3	7	0	0	7	0	0
6	29468331	.	A	T	5	2	7	0	0	7	0	0
6	29468551	.	A	T	4	1	5	0	1	6	0	0
6	29468556	.	T	G	4	2	6	0	0	6	0	0
6	29468671	.	A	G	7	4	11	0	0	11	0	0
6	29468797	.	C	T	1	3	4	0	0	4	0	0
6	29477526	.	C	T	2	3	5	0	1	6	0	0
6	29477739	.	C	T	2	4	6	0	0	6	0	0
6	29705343	.	C	T	4	4	8	0	1	9	0	0
6	29705561	.	A	T	10	13	23	0	2	25	0	0
6	29705614	.	G	A	6	5	11	0	5	16	0	0
6	29705901	.	T	C	1	2	3	0	1	4	0	0
6	29708100	.	C	T	1	2	3	0	0	3	0	0
6	29710252	.	T	C	3	3	6	0	0	6	0	0
6	29713920	.	G	T	7	2	9	0	1	10	0	0
6	29713926	.	T	C	7	5	12	0	0	12	0	0
6	29714017	.	A	G	6	9	15	0	1	16	0	0
6	29714054	.	A	C	1	5	6	0	0	6	0	0
6	29714064	.	C	T	0	4	4	0	0	4	0	0
6	29714171	.	A	G	0	1	1	0	0	1	0	0
6	29793814	.	C	T	7	11	18	0	2	20	0	0
6	29794003	.	T	G	4	6	10	0	1	11	0	0
6	29794042	.	G	A	6	4	10	0	1	11	0	0
6	29794695	.	T	C	30	32	62	1	1	64	0	0
6	30027896	.	C	A	13	4	17	0	1	18	0	0
6	30032574	.	A	G	2	0	2	0	10	13	1	0
6	30048285	.	A	G	5	0	5	0	4	9	0	0
6	30052061	.	C	A	9	10	19	0	1	20	0	0
6	30052085	.	A	G	5	7	12	0	0	12	0	0
6	30060296	.	C	T	22	23	45	0	1	46	0	0
6	30081420	.	C	T	18	15	33	0	2	35	0	0
6	30081421	.	T	C	20	14	34	0	1	35	0	0
6	30081503	.	A	G	23	15	38	0	2	40	0	0
6	30081725	.	C	T	23	15	38	0	1	39	0	0
6	30082838	.	G	T	17	9	26	0	0	26	0	0
6	30124575	.	C	T	13	17	30	0	2	32	0	0
6	30133958	.	G	T	15	16	31	0	4	35	0	0
6	30147249	.	T	C	17	1	18	0	7	25	0	0
6	30148182	.	G	A	7	5	12	0	0	12	0	0
6	30148422	.	C	T	11	6	17	0	0	17	0	0
6	30148863	.	T	C	7	9	16	0	0	16	0	0
6	30151519	.	G	A	6	10	16	0	0	16	0	0
6	30151537	.	G	A	10	9	19	0	0	19	0	0
6	30160956	.	C	T	7	8	15	0	0	15	0	0
6	30177635	.	G	A	5	2	7	0	0	7	0	0
6	30177724	.	G	A	2	0	2	0	0	2	0	0
6	30441536	.	G	A	4	3	7	0	1	8	0	0
6	30441756	.	T	C	0	4	4	0	0	4	0	0
6	30441762	.	G	A	1	2	3	0	1	4	0	0
6	30450458	.	T	C	1	3	4	0	0	4	0	0
6	30452540	.	T	G	6	0	6	0	3	9	0	0
6	30452573	.	C	T	2	3	5	0	0	5	0	0
6	30452669	.	A	T	2	3	5	0	0	5	0	0
6	30452843	.	G	T	2	2	4	0	0	4	0	0
6	30452932	.	G	C	1	3	4	0	0	4	0	0
6	30583815	.	A	G	1	4	5	0	0	5	0	0
6	30587201	.	T	A	3	1	4	0	0	4	0	0
6	30592624	.	C	G	1	2	3	0	0	3	0	0
6	30626630	.	T	G	10	7	17	0	0	17	0	0
6	30626908	.	G	A	10	9	19	0	0	19	0	0
6	30626931	.	T	C	4	7	11	0	2	13	0	0
6	30627182	.	T	A	10	10	20	0	2	22	0	0
6	30627228	.	A	C	19	16	35	0	0	35	0	0
6	30627549	.	G	A	10	13	23	0	1	24	0	0
6	30627674	.	G	T	9	13	22	0	1	23	0	0
6	30627764	.	G	T	13	12	25	0	0	25	0	0
6	30627807	.	G	T	7	11	18	0	1	19	0	0
6	30627811	.	T	C	11	8	19	0	0	19	0	0
6	30628066	.	T	C	9	4	13	0	1	14	0	0
6	30628097	.	C	T	8	9	17	0	1	18	0	0
6	30628185	.	G	A	3	11	14	0	1	15	0	0
6	30628447	.	G	A	6	10	16	0	1	17	0	0
6	30628459	.	A	G	6	11	17	0	0	17	0	0
6	30628540	.	T	C	2	0	2	0	4	6	0	0
6	30628651	.	G	A	5	6	11	0	0	11	0	0
6	30628684	.	C	A	8	4	12	0	0	12	0	0
6	30628848	.	C	T	14	6	20	0	0	20	0	0
6	30628976	.	T	A	4	13	17	0	0	17	0	0
6	30628978	.	C	T	13	4	17	0	0	17	0	0
6	30629142	.	G	A	12	8	20	0	0	20	0	0
6	30629229	.	T	A	4	5	9	0	0	9	0	0
6	30629317	.	C	A	1	6	7	0	0	7	0	0
6	30629384	.	T	C	3	0	3	0	10	13	0	0
6	30629553	.	C	T	0	5	5	0	8	13	0	0
6	30629827	.	C	A	4	8	12	0	0	12	0	0
6	30630454	.	T	G	4	9	13	0	1	14	0	0
6	30630811	.	T	C	7	8	15	0	0	15	0	0
6	30630904	.	A	G	5	3	8	0	0	8	0	0
6	30658102	.	T	C	3	3	6	0	0	6	0	0
6	30658524	.	T	C	1	1	2	0	1	3	0	0
6	30658545	.	G	A	5	4	9	0	0	9	0	0
6	30658728	.	A	C	5	3	8	0	0	8	0	0
6	30677445	.	G	C	5	4	9	0	0	9	0	0
6	30677582	.	T	C	6	2	8	0	0	8	0	0
6	30677602	.	A	T	3	6	9	0	0	9	0	0
6	30677646	.	A	G	4	7	11	0	0	11	0	0
6	30677701	.	C	T	0	4	4	0	1	5	0	0
6	30678133	.	A	T	0	1	1	0	0	1	0	0
6	30678396	.	T	C	2	7	9	0	0	9	0	0
6	30681291	.	C	A	3	3	6	0	0	6	0	0
6	30683571	.	T	A	1	5	6	0	0	6	0	0
6	30683578	.	T	C	2	5	7	0	0	7	0	0
6	30685311	.	A	G	4	2	6	0	1	7	0	0
6	30685353	.	T	C	1	5	6	0	1	7	0	0
6	30685354	.	G	A	2	5	7	0	0	7	0	0
6	30688021	.	A	G	3	3	6	0	0	6	0	0
6	30710313	.	C	A	23	19	42	0	2	44	0	0
6	30710591	.	G	A	3	12	15	0	1	16	0	0
6	30710805	.	T	C	4	3	7	0	0	7	0	0
6	30711447	.	C	T	5	4	9	0	0	9	0	0
6	30711485	.	A	T	13	14	27	0	0	27	0	0
6	30711511	.	C	T	15	14	29	0	3	32	0	0
6	30711554	.	C	T	0	11	11	0	12	23	0	0
6	30711586	.	A	C	14	0	14	0	11	25	0	0
6	30711612	.	G	A	13	16	29	0	1	30	0	0
6	30711777	.	C	T	4	14	18	0	0	18	0	0
6	30712121	.	G	T	12	16	28	0	3	31	0	0
6	30712458	.	A	G	13	4	17	0	2	19	0	0
6	30712508	.	G	A	16	10	26	0	0	26	0	0
6	30712616	.	C	T	0	3	3	0	10	13	0	0
6	30712622	.	A	G	10	4	14	1	0	15	0	0
6	30712883	.	A	C	5	9	14	0	1	15	0	0
6	30712917	.	G	A	8	9	17	0	0	17	0	0
6	30713184	.	T	A	11	9	20	0	0	20	0	0
6	30713334	.	G	C	13	12	25	0	0	25	0	0
6	30713341	.	G	A	10	10	20	0	2	22	0	0
6	30713647	.	C	T	4	7	11	0	0	11	0	0
6	30713910	.	C	T	18	20	38	0	1	39	0	0
6	30713929	.	C	G	21	20	41	0	2	43	0	0
6	30714177	.	T	A	13	8	21	0	1	22	0	0
6	30715647	.	A	T	15	11	26	0	0	26	0	0
6	30715865	.	A	T	8	6	14	0	1	15	0	0
6	30719348	.	G	C	9	10	19	0	0	19	0	0
6	30719391	.	A	T	4	1	5	0	0	5	0	0
6	30719935	.	C	T	5	7	12	0	1	13	0	0
6	30721397	.	G	A	10	3	13	0	0	13	0	0
6	30740160	.	C	A	0	4	4	0	2	6	0	0
6	30851611	.	A	T	8	5	13	0	2	15	0	0
6	30853053	.	T	A	26	29	55	0	2	57	0	0
6	30855423	.	G	A	8	7	15	0	0	15	0	0
6	30859381	.	T	A	10	15	25	0	2	27	0	0
6	30931362	.	C	T	0	0	0	0	3	3	0	0
6	30931476	.	A	T	2	3	5	0	0	5	0	0
6	30931479	.	T	C	2	0	2	0	3	5	0	0
6	31069622	.	T	A	3	4	7	0	0	7	0	0
6	31146849	.	T	C	1	2	3	0	0	3	0	0
6	31184478	.	A	G	9	3	12	0	0	12	0	0
6	31184674	.	C	T	3	2	5	0	0	5	0	0
6	31184880	.	G	A	1	4	5	0	0	5	0	0
6	31184891	.	A	G	1	4	5	0	0	5	0	0
6	31185133	.	G	A	6	4	10	0	1	11	0	0
6	31185292	.	A	C	2	5	7	0	0	7	0	0
6	31185825	.	A	T	4	2	6	0	0	6	0	0
6	31186737	.	A	C	4	4	8	0	0	8	0	0
6	31186981	.	G	A	7	2	9	0	1	10	0	0
6	31279834	.	G	A	16	12	28	0	3	31	0	0
6	31280141	.	G	A	21	22	43	0	0	43	0	0
6	31280185	.	T	A	18	20	38	0	4	42	0	0
6	31280495	.	C	T	5	22	27	0	0	27	0	0
6	31280586	.	A	G	12	15	27	0	2	29	0	0
6	31280936	.	A	T	13	11	24	0	1	25	0	0
6	31281006	.	C	T	1	10	11	0	16	27	0	0
6	31281130	.	A	G	26	26	52	0	0	52	0	0
6	31281304	.	C	A	16	21	37	0	0	37	0	0
6	31281481	.	A	G	5	7	12	0	1	13	0	0
6	31281533	.	T	A	2	11	13	0	0	13	0	0
6	31281537	.	A	G	2	12	14	0	0	14	0	0
6	31281594	.	A	T	12	11	23	0	1	24	0	0
6	31281694	.	C	T	11	7	18	0	0	18	0	0
6	31281994	.	T	A	11	11	22	0	2	24	0	0
6	31282028	.	T	G	12	6	18	0	0	18	0	0
6	31282118	.	T	G	2	2	4	0	0	4	0	0
6	31282170	.	T	C	8	0	8	0	6	14	0	0
6	31282205	.	C	T	8	7	15	0	0	15	0	0
6	31283049	.	C	A	4	6	10	0	1	11	0	0
6	31283055	.	G	A	7	5	12	0	0	12	0	0
6	31283167	.	G	T	3	13	16	0	0	16	0	0
6	31283245	.	A	G	13	7	20	0	1	21	0	0
6	31283280	.	T	A	7	3	10	0	0	10	0	0
6	31309823	.	C	T	0	3	3	0	2	5	0	0
6	31336156	.	G	A	2	2	4	0	1	5	0	0
6	31352406	.	C	A	5	10	15	0	0	15	0	0
6	31352556	.	G	A	5	5	10	0	0	10	0	0
6	31352664	.	C	T	3	6	9	0	0	9	0	0
6	31353022	.	G	C	11	15	26	0	0	26	0	0
6	31353345	.	T	A	9	18	27	0	0	27	0	0
6	31353451	.	A	T	7	10	17	0	1	18	0	0
6	31355787	.	C	T	2	3	5	0	0	5	0	0
6	31358525	.	C	T	0	2	2	0	1	3	0	0
6	31394453	.	A	C	2	1	3	0	0	3	0	0
6	31395943	.	C	T	1	2	3	0	0	3	0	0
6	31396249	.	A	T	3	4	7	0	0	7	0	0
6	31405898	.	G	A	0	3	3	0	1	4	0	0
6	31405923	.	C	T	1	3	4	0	0	4	0	0
6	31411751	.	C	T	1	3	4	0	0	4	0	0
6	31414061	.	A	C	2	0	2	0	1	3	0	0
6	31419749	.	T	C	0	1	1	0	0	1	0	0
6	31426246	.	A	G	12	0	12	0	6	18	0	0
6	31426727	.	C	G	5	10	15	0	2	17	0	0
6	31426881	.	C	T	12	7	19	0	0	19	0	0
6	31426886	.	C	T	8	13	21	0	0	21	0	0
6	31427226	.	C	T	2	3	5	0	0	5	0	0
6	31427261	.	T	C	11	3	14	0	0	14	0	0
6	31427646	.	A	T	3	6	9	0	0	9	0	0
6	31427815	.	G	T	0	7	7	0	9	16	0	0
6	31427818	.	A	G	9	8	17	0	0	17	0	0
6	31428283	.	C	A	18	13	31	0	0	31	0	0
6	31428448	.	T	A	3	2	5	0	0	5	0	0
6	31428565	.	T	G	7	7	14	0	0	14	0	0
6	31428566	.	A	G	7	7	14	0	0	14	0	0
6	31428705	.	C	T	24	8	32	0	1	33	0	0
6	31430900	.	T	C	3	5	8	0	0	8	0	0
6	31431145	.	T	G	9	5	14	0	0	14	0	0
6	31431355	.	G	A	12	16	28	0	4	32	0	0
6	31431520	.	A	G	22	14	36	0	0	36	0	0
6	31431775	.	T	C	16	11	27	0	9	36	0	0
6	31431870	.	G	A	20	10	30	0	0	30	0	0
6	31431926	.	A	T	18	18	36	0	2	38	0	0
6	31432302	.	G	A	6	2	8	0	0	8	0	0
6	31432554	.	A	T	1	6	7	0	0	7	0	0
6	31432563	.	T	C	5	2	7	0	0	7	0	0
6	31432617	.	T	G	2	5	7	0	0	7	0	0
6	31432679	.	T	A	3	6	9	0	1	10	0	0
6	31432684	.	T	C	7	3	10	0	0	10	0	0
6	31432881	.	C	T	0	4	4	1	5	10	0	0
6	31432950	.	G	A	3	6	9	0	0	9	0	0
6	31432955	.	T	C	2	4	6	0	1	7	0	0
6	31433341	.	G	A	8	3	11	0	0	11	0	0
6	31433412	.	A	G	5	5	10	0	1	11	0	0
6	31433572	.	T	A	4	2	6	0	0	6	0	0
6	31433692	.	A	T	3	2	5	0	0	5	0	0
6	31433846	.	G	A	5	4	9	0	0	9	0	0
6	31434050	.	C	A	2	6	8	0	0	8	0	0
6	31434245	.	A	T	5	6	11	0	0	11	0	0
6	31434554	.	G	A	5	2	7	0	0	7	0	0
6	31434830	.	A	G	4	6	10	0	0	10	0	0
6	31434923	.	C	T	0	7	7	0	8	15	0	0
6	31435017	.	C	T	0	6	6	0	4	10	0	0
6	31441574	.	A	T	4	1	5	0	0	5	0	0
6	31462606	.	G	A	1	3	4	0	0	4	0	0
6	31463147	.	A	T	1	0	1	0	0	1	0	0
6	31470041	.	T	C	1	1	2	0	0	2	0	0
6	31591116	.	C	T	6	8	14	0	2	16	0	0
6	31591452	.	C	T	9	14	23	0	1	24	0	0
6	31591838	.	T	G	12	14	26	0	1	27	0	0
6	31591841	.	G	A	15	10	25	0	2	27	0	0
6	31591883	.	C	T	0	6	6	0	18	24	0	0
6	31591997	.	A	C	14	0	14	0	17	31	0	0
6	31598783	.	C	T	4	5	9	0	1	10	0	0
6	31624107	.	T	C	0	2	2	0	1	3	0	0
6	31632508	.	T	C	1	2	3	0	0	3	0	0
6	31632519	.	G	A	2	2	4	0	0	4	0	0
6	31632550	.	G	C	1	0	1	0	5	7	1	0
6	31773530	.	C	T	0	2	2	0	0	2	0	0
6	32010215	.	C	T	5	2	7	0	1	8	0	0
6	32010259	.	G	A	8	5	13	0	2	15	0	0
6	32010341	.	C	T	1	12	13	0	23	36	0	0
6	32010475	.	A	G	2	3	5	0	0	5	0	0
6	32014771	.	T	G	2	4	6	0	0	6	0	0
6	32016492	.	T	C	7	4	11	0	1	12	0	0
6	32020326	.	G	A	5	4	9	0	1	10	0	0
6	32020327	.	T	A	5	2	7	0	3	10	0	0
6	32025109	.	C	A	4	10	14	0	0	14	0	0
6	32029267	.	A	T	4	4	8	0	0	8	0	0
6	32029269	.	A	T	4	4	8	0	0	8	0	0
6	32032371	.	A	C	5	6	11	0	0	11	0	0
6	32032479	.	C	T	2	8	10	0	0	10	0	0
6	32034354	.	G	A	1	2	3	0	0	3	0	0
6	32035921	.	G	A	2	3	5	0	0	5	0	0
6	32040581	.	G	A	4	3	7	0	0	7	0	0
6	32040620	.	G	A	3	3	6	0	0	6	0	0
6	32042381	.	G	A	4	3	7	0	0	7	0	0
6	32065310	.	C	T	4	2	6	0	0	6	0	0
6	32068390	.	C	T	0	4	4	0	1	5	0	0
6	32068411	.	G	C	3	4	7	0	0	7	0	0
6	32092825	.	C	T	0	3	3	0	1	4	0	0
6	32300717	.	G	A	4	2	6	0	0	6	0	0
6	32301137	.	A	T	7	7	14	0	0	14	0	0
6	32301161	.	C	T	5	5	10	0	0	10	0	0
6	32301214	.	A	T	2	7	9	0	0	9	0	0
6	32301265	.	A	T	7	4	11	0	0	11	0	0
6	32301808	.	G	C	2	2	4	0	0	4	0	0
6	32301900	.	C	G	1	3	4	0	4	8	0	0
6	32301969	.	T	G	7	3	10	0	1	11	0	0
6	32302086	.	T	A	3	4	7	0	0	7	0	0
6	32302236	.	C	T	0	1	1	0	1	2	0	0
6	32339831	.	C	A	1	1	2	0	0	2	0	0
6	32340005	.	C	T	0	4	4	0	0	4	0	0
6	32344261	.	T	C	3	3	6	0	0	6	0	0
6	32359470	.	G	A	2	3	5	0	0	5	0	0
6	32371466	.	A	T	1	2	3	0	0	3	0	0
6	32375838	.	T	C	3	0	3	0	0	3	0	0
6	32382629	.	C	T	1	3	4	0	0	4	0	0
6	32397588	.	C	T	18	20	38	0	0	38	0	0
6	32398844	.	G	A	13	12	25	0	0	25	0	0
6	32403028	.	G	A	13	20	33	0	2	35	0	0
6	32403052	.	T	C	11	14	25	0	0	25	0	0
6	32404206	.	C	G	2	4	6	0	0	6	0	0
6	32404863	.	C	T	0	4	4	0	9	13	0	0
6	32405020	.	G	A	17	6	23	0	1	24	0	0
6	32405266	.	G	A	8	3	11	0	0	11	0	0
6	32405478	.	A	T	3	3	6	0	0	6	0	0
6	32405741	.	A	T	6	6	12	0	0	12	0	0
6	32405784	.	A	G	9	7	16	0	1	17	0	0
6	32405952	.	C	T	2	3	5	0	1	6	0	0
6	32408299	.	G	A	0	1	1	0	0	1	0	0
6	32408437	.	C	T	0	0	0	0	1	1	0	0
6	32409301	.	G	A	3	2	5	0	1	6	0	0
6	32409490	.	T	A	1	1	2	0	0	2	0	0
6	32415560	.	C	A	1	3	4	0	0	4	0	0
6	32481998	.	T	C	1	3	4	0	0	4	0	0
6	32482376	.	G	A	3	2	5	0	0	5	0	0
6	32483265	.	A	G	3	3	6	0	1	7	0	0
6	32483750	.	T	C	4	9	13	0	0	13	0	0
6	32497690	.	A	G	1	0	1	0	0	1	0	0
6	32504356	.	C	T	5	2	7	0	0	7	0	0
6	32506349	.	T	A	4	4	8	0	0	8	0	0
6	32506386	.	C	T	8	5	13	0	1	14	0	0
6	32506473	.	G	A	0	6	6	0	7	13	0	0
6	32506526	.	A	G	2	3	5	0	1	6	0	0
6	32506949	.	T	C	2	2	4	0	0	4	0	0
6	32507270	.	C	T	2	2	4	0	0	4	0	0
6	32699666	.	G	A	5	12	17	0	0	17	0	0
6	32699682	.	T	A	11	6	17	0	1	18	0	0
6	32699775	.	A	C	4	0	4	0	4	8	0	0
6	32699870	.	A	T	2	9	11	0	1	12	0	0
6	32700069	.	G	A	1	7	8	0	0	8	0	0
6	32700228	.	G	A	9	4	13	0	2	15	0	0
6	32700607	.	T	G	4	3	7	0	0	7	0	0
6	32702198	.	C	T	1	9	10	0	0	10	0	0
6	32722579	.	A	G	4	3	7	0	1	8	0	0
6	32722640	.	C	T	0	6	6	0	9	16	1	0
6	32722680	.	A	T	3	2	5	0	0	5	0	0
6	32739226	.	A	G	2	2	4	0	0	4	0	0
6	32747707	.	T	G	1	1	2	0	0	2	0	0
6	32747709	.	A	G	1	1	2	0	0	2	0	0
6	32830082	.	T	C	1	3	4	0	0	4	0	0
6	32830083	.	A	G	3	1	4	0	0	4	0	0
6	32832113	.	G	A	1	2	3	0	1	4	0	0
6	32832166	.	T	C	2	0	2	0	3	5	0	0
6	32832662	.	A	G	4	4	8	0	0	8	0	0
6	32966915	.	G	C	9	15	24	0	0	24	0	0
6	32967065	.	C	T	3	0	3	0	0	3	0	0
6	32967080	.	T	C	7	2	9	0	0	9	0	0
6	32967174	.	G	A	9	10	19	0	1	20	0	0
6	32967182	.	A	T	9	9	18	0	1	19	0	0
6	32967357	.	G	A	9	13	22	0	1	23	0	0
6	32970032	.	G	A	1	2	3	0	0	3	0	0
6	32970178	.	T	C	1	0	1	0	0	1	0	0
6	32976281	.	G	A	1	2	3	0	0	3	0	0
6	32999747	.	A	C	0	0	0	0	2	2	0	0
6	33023439	.	G	A	3	5	8	0	0	8	0	0
6	33023545	.	T	C	1	0	1	0	2	3	0	0
6	33023601	.	A	G	3	9	12	0	1	13	0	0
6	33092969	.	A	C	0	2	2	0	0	2	0	0
6	33094767	.	A	C	4	7	11	0	0	11	0	0
6	33095499	.	T	C	2	3	5	0	0	5	0	0
6	33548919	.	A	G	1	0	1	0	0	1	0	0
6	33549187	.	T	G	5	0	5	0	4	9	0	0
6	33553084	.	G	A	6	2	8	0	1	9	0	0
6	33554433	.	A	T	3	4	7	0	2	9	0	0
6	33554435	.	C	T	5	4	9	0	0	9	0	0
6	33555159	.	G	A	0	5	5	0	7	12	0	0
6	33555168	.	C	T	6	6	12	0	1	13	0	0
6	33555570	.	G	A	6	7	13	0	0	13	0	0
6	33555594	.	T	C	3	3	6	0	0	6	0	0
6	33555691	.	T	G	3	0	3	0	8	11	0	0
6	33555952	.	T	A	13	9	22	0	1	23	0	0
6	33556036	.	T	A	10	15	25	0	0	25	0	0
6	33556316	.	C	T	12	14	26	0	1	27	0	0
6	33556424	.	A	G	6	13	19	0	1	20	0	0
6	33556441	.	G	A	12	10	22	0	2	24	0	0
6	33556493	.	A	T	0	19	19	0	4	23	0	0
6	33556497	.	A	T	9	15	24	0	6	30	0	0
6	33556706	.	G	C	13	11	24	0	0	24	0	0
6	33556877	.	G	A	0	18	18	0	14	32	0	0
6	33556968	.	G	C	17	7	24	0	1	25	0	0
6	33557077	.	G	A	0	12	12	0	10	22	0	0
6	33557141	.	G	C	11	8	19	0	1	20	0	0
6	33557438	.	T	A	9	12	21	0	0	21	0	0
6	33557625	.	C	T	23	22	45	0	2	47	0	0
6	33558437	.	G	A	19	22	41	0	2	43	0	0
6	33558711	.	G	C	12	25	37	0	1	38	0	0
6	33558837	.	C	T	6	11	17	0	0	17	0	0
6	33663690	.	T	C	10	10	20	0	1	21	0	0
6	33663701	.	T	C	12	7	19	0	1	20	0	0
6	33663839	.	C	T	0	14	14	0	13	27	0	0
6	33664182	.	A	G	11	14	25	0	0	25	0	0
6	33664460	.	A	G	3	4	7	0	1	8	0	0
6	33664556	.	C	T	2	5	7	0	2	9	0	0
6	33664801	.	A	G	8	4	12	0	0	12	0	0
6	33664899	.	G	A	2	7	9	0	0	9	0	0
6	33665123	.	T	G	14	13	27	0	1	28	0	0
6	33665320	.	G	A	4	6	10	0	0	10	0	0
6	33665327	.	C	T	3	4	7	0	0	7	0	0
6	33665513	.	C	T	0	5	5	0	5	10	0	0
6	33665734	.	C	T	10	14	24	0	1	25	0	0
6	33665867	.	G	T	12	7	19	0	1	20	0	0
6	33665968	.	C	T	7	16	23	0	0	23	0	0
6	33666166	.	G	A	5	9	14	0	2	16	0	0
6	33666250	.	C	A	0	9	9	0	7	16	0	0
6	33666302	.	C	A	7	10	17	0	0	17	0	0
6	33666308	.	G	A	8	10	18	0	0	18	0	0
6	33666472	.	G	T	13	9	22	0	1	23	0	0
6	33666578	.	G	T	10	10	20	0	1	21	0	0
6	33666631	.	C	T	9	14	23	0	0	23	0	0
6	33666715	.	C	A	12	11	23	0	2	25	0	0
6	33666733	.	A	G	12	12	24	0	0	24	0	0
6	33666910	.	G	T	5	7	12	0	0	12	0	0
6	33667056	.	T	C	3	0	3	0	8	11	0	0
6	33667180	.	C	T	0	4	4	0	4	8	0	0
6	33667234	.	T	A	3	5	8	0	2	10	0	0
6	33667345	.	G	C	2	11	13	0	0	13	0	0
6	33667369	.	G	A	10	3	13	0	1	14	0	0
6	33668228	.	A	T	5	4	9	0	0	9	0	0
6	33668729	.	A	T	6	3	9	0	1	10	0	0
6	33669168	.	G	C	4	0	4	0	6	10	0	0
6	33683837	.	G	A	0	1	1	0	0	1	0	0
6	33875397	.	T	C	0	2	2	0	0	2	0	0
6	33875746	.	T	A	1	8	9	0	0	9	0	0
6	33875833	.	G	A	0	2	2	0	0	2	0	0
6	33883580	.	C	T	1	1	2	0	0	2	0	0
6	33896399	.	T	A	21	15	36	0	3	39	0	0
6	33896457	.	A	G	21	26	47	0	1	48	0	0
6	33896538	.	T	C	27	10	37	0	3	40	0	0
6	33896562	.	A	G	23	14	37	0	0	37	0	0
6	33896615	.	G	A	0	12	12	0	21	33	0	0
6	33896620	.	C	T	15	17	32	0	1	33	0	0
6	33897505	.	G	A	18	14	32	0	1	33	0	0
6	33912228	.	G	T	1	1	2	0	0	2	0	0
6	33912708	.	A	C	3	0	3	0	2	5	0	0
6	33913345	.	A	T	2	1	3	0	0	3	0	0
6	33916648	.	T	C	5	0	5	0	3	8	0	0
6	33918858	.	G	T	1	4	5	0	0	5	0	0
6	33921298	.	C	T	8	4	12	0	0	12	0	0
6	33921511	.	G	A	2	1	3	0	0	3	0	0
6	33921631	.	A	G	3	4	7	0	0	7	0	0
6	33923900	.	C	T	0	2	2	0	0	2	0	0
6	33924693	.	A	G	4	3	7	0	0	7	0	0
6	33927040	.	A	T	5	7	12	0	0	12	0	0
6	33931582	.	T	C	10	7	17	0	2	19	0	0
6	33981717	.	T	C	1	2	3	0	0	3	0	0
6	33981746	.	A	C	2	0	2	0	2	4	0	0
6	33981754	.	G	A	1	2	3	0	0	3	0	0
6	33982863	.	A	G	0	2	2	0	0	2	0	0
6	33982865	.	A	T	0	2	2	0	0	2	0	0
6	33984216	.	T	A	3	2	5	0	0	5	0	0
6	34039046	.	T	A	2	2	4	0	0	4	0	0
6	34072052	.	T	A	1	2	3	0	0	3	0	0
6	34072117	.	A	G	2	3	5	0	1	6	0	0
6	34806307	.	T	C	1	3	4	0	0	4	0	0
6	34806407	.	G	A	4	2	6	0	0	6	0	0
6	34806745	.	G	A	5	4	9	0	0	9	0	0
6	34806893	.	A	T	2	4	6	0	0	6	0	0
6	34807534	.	C	A	5	7	12	0	0	12	0	0
6	34807640	.	A	C	2	2	4	0	0	4	0	0
6	34807843	.	A	T	2	3	5	0	0	5	0	0
6	34807927	.	T	A	2	2	4	0	0	4	0	0
6	34807933	.	G	T	1	3	4	0	1	5	0	0
6	34807999	.	G	T	7	4	11	0	0	11	0	0
6	34808517	.	A	G	4	4	8	0	0	8	0	0
6	34808591	.	G	A	6	7	13	0	2	15	0	0
6	34808754	.	C	T	11	5	16	0	0	16	0	0
6	34808821	.	G	A	3	9	12	0	0	12	0	0
6	34808996	.	A	G	2	0	2	0	4	6	0	0
6	34809697	.	C	G	7	1	8	0	13	21	0	0
6	34810495	.	G	A	0	10	10	0	16	26	0	0
6	34810748	.	A	C	11	10	21	0	0	21	0	0
6	34810763	.	T	A	8	11	19	0	2	21	0	0
6	34810896	.	G	A	8	15	23	0	0	24	1	0
6	34810908	.	T	C	15	7	22	0	0	22	0	0
6	34811130	.	A	T	3	3	6	0	0	6	0	0
6	34811175	.	T	C	3	10	13	0	1	14	0	0
6	34826051	.	T	C	7	3	10	0	1	11	0	0
6	34826870	.	G	A	9	9	18	0	0	18	0	0
6	34826882	.	T	G	9	8	17	0	1	18	0	0
6	34828893	.	A	T	1	2	3	0	0	3	0	0
6	34836778	.	G	T	2	2	4	0	0	4	0	0
6	34848320	.	C	T	1	5	6	0	0	6	0	0
6	34848447	.	C	A	1	3	4	0	0	4	0	0
6	34931646	.	G	A	15	12	27	0	1	28	0	0
6	34931911	.	C	T	22	25	47	0	0	47	0	0
6	34931912	.	C	T	21	25	46	0	1	47	0	0
6	34933574	.	C	T	0	4	4	0	0	4	0	0
6	34934903	.	G	T	27	21	48	0	2	50	0	0
6	34943451	.	G	T	3	3	6	0	0	6	0	0
6	34943714	.	G	A	6	4	10	0	2	12	0	0
6	34943760	.	A	G	4	3	7	0	1	8	0	0
6	34943824	.	A	T	3	5	8	0	1	9	0	0
6	34943938	.	T	C	4	3	7	0	0	7	0	0
6	34944523	.	G	A	1	0	1	0	0	1	0	0
6	35036303	.	C	T	4	5	9	0	1	10	0	0
6	35036320	.	C	T	8	4	12	0	2	14	0	0
6	35036459	.	A	T	4	3	7	0	1	8	0	0
6	35036463	.	T	C	4	0	4	0	4	8	0	0
6	35036520	.	A	G	4	5	9	0	1	10	0	0
6	35036525	.	T	G	2	5	7	0	1	8	0	0
6	35036755	.	T	A	3	3	6	0	1	7	0	0
6	35039912	.	G	T	8	3	11	0	0	11	0	0
6	35039966	.	C	T	8	5	13	0	0	13	0	0
6	35042176	.	C	T	4	6	10	0	1	11	0	0
6	35042201	.	A	G	4	5	9	0	0	9	0	0
6	35046852	.	T	C	2	2	4	0	0	4	0	0
6	35053243	.	G	A	1	3	4	0	0	4	0	0
6	35053250	.	A	G	1	2	3	0	0	3	0	0
6	35056519	.	C	A	1	1	2	0	0	2	0	0
6	35056787	.	A	G	1	1	2	0	0	2	0	0
6	35058696	.	A	G	1	1	2	0	0	2	0	0
6	35061237	.	C	T	4	3	7	0	0	7	0	0
6	35061298	.	T	C	3	4	7	0	0	7	0	0
6	35099980	.	T	C	2	5	7	0	0	7	0	0
6	35100084	.	G	A	3	7	10	0	0	10	0	0
6	35100230	.	T	A	2	4	6	0	2	8	0	0
6	35100423	.	C	T	1	3	4	0	1	5	0	0
6	35100442	.	T	C	1	2	3	0	0	3	0	0
6	35100795	.	C	G	0	5	5	0	7	12	0	0
6	35100801	.	T	G	4	8	12	0	1	13	0	0
6	35100857	.	A	G	5	5	10	0	0	10	0	0
6	35100868	.	T	A	5	6	11	0	0	11	0	0
6	35100894	.	C	T	0	6	6	0	1	7	0	0
6	35100933	.	A	G	2	7	9	1	0	10	0	0
6	35101184	.	A	T	4	7	11	0	0	11	0	0
6	35101605	.	C	G	2	2	4	0	0	4	0	0
6	35102555	.	G	C	2	2	4	0	0	4	0	0
6	35102576	.	C	T	2	2	4	0	0	4	0	0
6	35136451	.	T	C	5	5	10	0	0	10	0	0
6	35136471	.	C	T	0	6	6	0	2	8	0	0
6	35136505	.	T	A	3	6	9	0	0	9	0	0
6	35136558	.	G	A	1	7	8	0	0	8	0	0
6	35136983	.	A	G	5	4	9	0	0	9	0	0
6	35137587	.	A	G	4	1	5	0	0	5	0	0
6	35139248	.	T	C	2	3	5	0	0	5	0	0
6	35309798	.	T	G	1	2	3	0	1	4	0	0
6	35309823	.	A	T	2	3	5	0	0	5	0	0
6	35365098	.	A	T	7	5	12	0	1	13	0	0
6	35365234	.	C	T	1	5	6	0	1	7	0	0
6	35365441	.	C	A	1	2	3	0	0	3	0	0
6	35365462	.	T	A	1	2	3	0	1	4	0	0
6	35365492	.	A	G	1	2	3	0	1	4	0	0
6	35365872	.	C	T	6	7	13	0	1	14	0	0
6	35365877	.	C	T	7	6	13	0	0	13	0	0
6	35366140	.	G	T	0	14	14	0	5	19	0	0
6	35366141	.	A	G	4	15	19	0	0	19	0	0
6	35366544	.	A	G	11	2	13	0	3	16	0	0
6	35366640	.	C	G	9	4	13	0	1	14	0	0
6	35389384	.	T	A	3	3	6	0	0	6	0	0
6	35389517	.	C	G	0	5	5	0	5	10	0	0
6	35461688	.	T	C	3	4	7	0	1	8	0	0
6	35462087	.	G	A	16	14	30	0	0	30	0	0
6	35462088	.	A	G	15	13	28	0	2	30	0	0
6	35462134	.	G	A	12	8	20	1	0	21	0	0
6	35462186	.	A	G	18	10	28	0	2	30	0	0
6	35462470	.	G	A	24	16	40	0	2	42	0	0
6	35472834	.	C	T	7	5	12	0	0	12	0	0
6	35472858	.	G	T	8	9	17	0	0	17	0	0
6	35487433	.	C	T	0	2	2	0	1	3	0	0
6	35676784	.	A	G	13	11	24	0	1	25	0	0
6	35676799	.	C	T	16	13	29	0	1	30	0	0
6	35688231	.	G	A	6	5	11	0	0	11	0	0
6	35693656	.	C	T	3	6	9	0	0	9	0	0
6	35718058	.	T	C	7	5	12	0	2	14	0	0
6	35737276	.	G	T	1	2	3	0	0	3	0	0
6	35737289	.	A	G	1	3	4	0	1	5	0	0
6	35738397	.	G	A	2	1	3	0	0	3	0	0
6	36128976	.	C	T	4	2	6	0	1	7	0	0
6	36129003	.	T	G	2	3	5	0	1	6	0	0
6	36129115	.	C	G	1	2	3	0	0	3	0	0
6	36129779	.	C	T	6	2	8	0	0	8	0	0
6	36130207	.	T	G	7	3	10	0	0	10	0	0
6	36130245	.	G	A	4	7	11	0	0	11	0	0
6	36130351	.	T	A	6	6	12	0	1	13	0	0
6	36130358	.	A	C	7	6	13	0	0	13	0	0
6	36130501	.	A	G	3	3	6	0	0	6	0	0
6	36130727	.	T	G	1	2	3	0	0	3	0	0
6	36130962	.	G	A	2	2	4	0	0	4	0	0
6	36130963	.	A	G	2	2	4	0	0	4	0	0
6	36131055	.	A	G	8	6	14	0	0	14	0	0
6	36131097	.	A	T	2	3	5	0	1	6	0	0
6	36131376	.	A	G	3	8	11	0	0	11	0	0
6	36132072	.	C	T	0	5	5	0	4	9	0	0
6	36137010	.	G	A	7	2	9	0	1	10	0	0
6	36141631	.	G	A	4	2	6	0	0	6	0	0
6	36141739	.	T	G	2	3	5	0	0	5	0	0
6	36141741	.	A	G	2	3	5	0	0	5	0	0
6	36758758	.	A	G	6	3	9	0	0	9	0	0
6	36760065	.	A	C	12	0	12	0	12	24	0	0
6	36760080	.	T	A	13	10	23	0	0	23	0	0
6	36760140	.	C	T	2	3	5	0	0	5	0	0
6	36770666	.	C	T	1	0	1	0	0	1	0	0
6	36783178	.	T	C	2	0	2	0	0	2	0	0
6	36783187	.	T	A	1	0	1	0	0	1	0	0
6	36789072	.	A	G	4	6	10	0	0	10	0	0
6	36792028	.	A	C	2	4	6	0	0	6	0	0
6	36792112	.	A	G	6	9	15	0	0	15	0	0
6	36792130	.	A	T	7	4	11	0	2	13	0	0
6	36792163	.	C	G	6	6	12	0	0	13	1	0
6	36792294	.	A	G	1	2	3	0	0	3	0	0
6	36818551	.	G	A	0	3	3	0	2	5	0	0
6	36819202	.	C	G	1	2	3	0	0	3	0	0
6	36865734	.	C	G	1	2	3	0	0	3	0	0
6	36865756	.	C	T	1	2	3	0	0	3	0	0
6	36877078	.	G	A	3	2	5	0	0	5	0	0
6	36877097	.	A	T	3	3	6	0	0	6	0	0
6	36877265	.	A	G	1	3	4	0	0	4	0	0
6	36897568	.	A	C	1	9	10	0	0	10	0	0
6	37071353	.	G	A	6	8	14	0	2	16	0	0
6	37071374	.	A	G	8	8	16	0	0	16	0	0
6	37163366	.	A	T	8	12	20	0	2	22	0	0
6	37163449	.	G	A	1	7	8	0	23	31	0	0
6	37163488	.	G	A	21	17	38	0	2	40	0	0
6	37163588	.	G	T	0	20	20	0	18	38	0	0
6	37163932	.	T	C	19	18	37	0	0	37	0	0
6	37163943	.	C	T	18	18	36	0	0	36	0	0
6	37164060	.	T	C	14	16	30	0	3	33	0	0
6	37164173	.	T	G	20	18	38	0	0	38	0	0
6	37301438	.	G	T	8	6	14	0	0	14	0	0
6	37301458	.	A	G	11	5	16	0	0	16	0	0
6	37301479	.	A	T	14	6	20	0	1	21	0	0
6	37305142	.	A	C	6	12	18	0	0	18	0	0
6	37305368	.	A	G	5	0	5	0	3	8	0	0
6	37305383	.	A	G	4	5	9	0	0	9	0	0
6	37305470	.	G	A	4	1	5	0	0	5	0	0
6	37305532	.	G	T	4	3	7	0	1	8	0	0
6	37305539	.	G	T	5	3	8	0	0	8	0	0
6	37306620	.	A	T	15	5	20	0	0	20	0	0
6	37306827	.	C	T	12	5	17	0	1	18	0	0
6	37409738	.	C	T	11	9	20	0	0	20	0	0
6	37409986	.	C	T	6	6	12	0	1	13	0	0
6	37410029	.	A	G	5	6	11	0	0	11	0	0
6	37410047	.	C	T	9	7	16	0	0	16	0	0
6	37417345	.	T	A	0	3	3	0	0	3	0	0
6	37419449	.	G	A	1	2	3	0	0	3	0	0
6	37419479	.	G	A	1	2	3	0	0	3	0	0
6	37421038	.	C	A	0	1	1	0	0	1	0	0
6	37422787	.	A	G	6	3	9	0	1	10	0	0
6	37431476	.	T	G	1	6	7	0	1	8	0	0
6	37431532	.	G	C	1	8	9	0	0	9	0	0
6	37431649	.	T	C	2	1	3	0	0	3	0	0
6	37440515	.	G	T	2	2	4	0	0	4	0	0
6	37440547	.	T	A	2	2	4	0	0	4	0	0
6	37441474	.	T	C	0	1	1	0	0	1	0	0
6	37441492	.	G	A	0	1	1	0	0	1	0	0
6	37442276	.	A	G	0	2	2	0	1	3	0	0
6	37445357	.	T	C	1	3	4	0	0	4	0	0
6	37460889	.	C	T	6	4	10	0	0	10	0	0
6	37461661	.	G	A	4	3	7	0	0	7	0	0
6	37461662	.	T	A	4	3	7	0	0	7	0	0
6	37465953	.	C	T	2	1	3	0	0	3	0	0
6	37478859	.	G	A	6	2	8	0	1	9	0	0
6	37478878	.	G	A	5	2	7	0	0	7	0	0
6	37479506	.	G	A	5	9	14	0	0	14	0	0
6	37479563	.	C	G	8	6	14	0	0	14	0	0
6	37479578	.	G	A	7	5	12	0	0	12	0	0
6	37479779	.	A	C	7	8	15	0	0	15	0	0
6	37479785	.	A	C	8	7	15	0	1	16	0	0
6	37479910	.	T	G	8	7	15	0	1	16	0	0
6	37479932	.	G	A	8	8	16	0	0	16	0	0
6	37479998	.	A	G	6	4	10	0	1	11	0	0
6	37480100	.	T	A	0	2	2	0	0	2	0	0
6	37489092	.	C	G	1	1	2	0	0	2	0	0
6	37495117	.	G	A	3	1	4	0	0	4	0	0
6	37495147	.	G	A	5	5	10	0	0	10	0	0
6	37514941	.	T	A	2	2	4	0	0	4	0	0
6	37515100	.	A	T	3	3	6	0	0	6	0	0
6	37515169	.	G	A	4	1	5	0	0	5	0	0
6	37515170	.	G	A	4	1	5	0	0	5	0	0
6	37515270	.	A	G	5	3	8	0	2	10	0	0
6	37515300	.	C	T	10	5	15	0	0	15	0	0
6	37515353	.	T	A	7	9	16	0	0	16	0	0
6	37521529	.	A	T	4	5	9	0	1	10	0	0
6	37521594	.	C	A	5	5	10	0	0	10	0	0
6	37521778	.	G	A	2	2	4	0	1	5	0	0
6	37525748	.	G	A	7	6	13	0	0	13	0	0
6	37529504	.	C	A	5	10	15	0	2	17	0	0
6	37548605	.	T	C	3	1	4	0	0	4	0	0
6	37548897	.	C	T	9	3	12	0	0	12	0	0
6	37551165	.	G	A	0	5	5	0	2	7	0	0
6	37551548	.	T	C	1	4	5	0	1	6	0	0
6	37552621	.	C	T	3	5	8	0	2	10	0	0
6	37554293	.	C	T	1	2	3	0	0	3	0	0
6	37598966	.	C	T	16	19	35	0	1	36	0	0
6	37599293	.	C	T	14	12	26	0	0	26	0	0
6	37599406	.	G	A	19	11	30	0	0	30	0	0
6	37599499	.	G	T	14	16	30	0	1	31	0	0
6	37599687	.	A	T	15	19	34	0	1	35	0	0
6	37599937	.	T	G	24	20	44	0	2	46	0	0
6	37599954	.	C	T	26	16	42	0	0	42	0	0
6	37600173	.	A	G	19	1	20	0	22	42	0	0
6	37600210	.	G	A	0	22	22	0	18	40	0	0
6	37600233	.	G	A	14	23	37	0	0	37	0	0
6	37604146	.	G	A	1	2	3	0	0	3	0	0
6	37604219	.	G	C	0	3	3	0	0	3	0	0
6	37604233	.	C	T	4	1	5	0	0	5	0	0
6	37604311	.	C	A	2	2	4	0	1	5	0	0
6	37604410	.	T	A	5	6	11	0	1	12	0	0
6	37604724	.	G	A	4	6	10	0	1	11	0	0
6	37604866	.	A	C	4	4	8	0	0	8	0	0
6	37621150	.	T	C	2	5	7	0	0	7	0	0
6	37621918	.	A	G	2	3	5	0	0	5	0	0
6	37623826	.	A	G	2	2	4	0	0	4	0	0
6	37623836	.	A	T	2	3	5	0	0	5	0	0
6	37627004	.	A	G	1	0	1	0	0	1	0	0
6	37628973	.	G	A	2	4	6	0	0	6	0	0
6	37628991	.	C	T	1	2	3	0	0	3	0	0
6	37631456	.	A	G	0	1	1	0	0	1	0	0
6	37632921	.	G	A	2	2	4	0	0	4	0	0
6	37632963	.	A	G	2	0	2	0	2	4	0	0
6	37632966	.	C	T	2	2	4	0	0	4	0	0
6	37632999	.	T	C	0	3	3	0	0	3	0	0
6	37633005	.	C	A	2	1	3	0	1	4	0	0
6	37633549	.	G	A	0	1	1	0	4	5	0	0
6	37635589	.	G	A	3	5	8	0	1	9	0	0
6	37635595	.	C	A	4	6	10	0	0	10	0	0
6	37635649	.	T	C	2	2	4	0	1	5	0	0
6	37651619	.	T	C	7	9	16	0	1	17	0	0
6	37729880	.	T	C	1	3	4	0	0	4	0	0
6	37730520	.	C	T	4	3	7	0	0	7	0	0
6	37730527	.	C	T	3	3	6	0	0	6	0	0
6	37733992	.	G	A	10	4	14	0	1	15	0	0
6	37737188	.	C	A	2	2	4	0	1	5	0	0
6	37743456	.	T	C	4	1	5	0	3	8	0	0
6	37744304	.	C	A	1	1	2	0	0	2	0	0
6	37745914	.	A	T	1	2	3	0	0	3	0	0
6	37746099	.	G	A	2	4	6	0	0	6	0	0
6	37808238	.	G	A	0	2	2	0	0	2	0	0
6	37809918	.	C	T	2	3	5	0	0	5	0	0
6	37810029	.	T	C	5	1	6	0	0	6	0	0
6	37812199	.	A	G	2	2	4	0	0	4	0	0
6	37815348	.	C	G	1	2	3	0	0	3	0	0
6	37815525	.	T	C	1	1	2	0	0	2	0	0
6	37815799	.	C	T	1	0	1	0	0	1	0	0
6	37820306	.	C	T	3	6	9	0	1	10	0	0
6	37820960	.	T	C	4	4	8	0	0	8	0	0
6	37821169	.	G	T	0	2	2	0	1	3	0	0
6	37824355	.	G	T	7	5	12	0	0	12	0	0
6	37824645	.	T	C	4	3	7	0	0	7	0	0
6	37825508	.	T	G	1	1	2	0	0	3	1	0
6	37829585	.	G	A	4	5	9	0	0	9	0	0
6	37829613	.	T	C	2	3	5	0	1	6	0	0
6	37830742	.	A	T	5	7	12	0	0	12	0	0
6	37830784	.	C	T	6	10	16	0	0	16	0	0
6	37830811	.	C	T	6	8	14	0	0	14	0	0
6	37832947	.	C	T	11	4	15	0	1	16	0	0
6	37832953	.	G	A	9	3	12	0	1	13	0	0
6	37833493	.	T	C	4	8	12	0	1	13	0	0
6	37835767	.	T	C	16	7	23	0	1	24	0	0
6	37835797	.	C	T	13	4	17	0	0	17	0	0
6	37836387	.	G	A	6	18	24	0	0	24	0	0
6	37841100	.	C	T	5	6	11	0	0	11	0	0
6	37846026	.	C	T	25	19	44	0	2	46	0	0
6	38367062	.	G	C	8	0	8	0	15	23	0	0
6	38367107	.	T	C	13	12	25	0	0	25	0	0
6	38375020	.	G	A	12	11	23	0	2	25	0	0
6	38381094	.	G	A	10	6	16	0	0	16	0	0
6	38386454	.	T	A	0	1	1	0	0	1	0	0
6	38415315	.	G	A	2	1	3	0	0	3	0	0
6	38415385	.	A	G	9	7	16	0	0	16	0	0
6	38427427	.	G	A	3	2	5	0	0	5	0	0
6	38477019	.	G	T	2	3	5	0	1	6	0	0
6	38503673	.	C	T	2	3	5	0	1	6	0	0
6	38511604	.	G	A	3	13	16	0	0	16	0	0
6	38511739	.	C	T	10	9	19	0	0	19	0	0
6	38511967	.	A	T	11	4	15	0	3	18	0	0
6	38512160	.	T	C	20	8	28	0	0	28	0	0
6	38512178	.	G	A	10	19	29	0	0	29	0	0
6	38512236	.	C	T	15	13	28	0	1	29	0	0
6	38512629	.	C	T	19	12	31	0	2	33	0	0
6	38513231	.	C	T	15	7	22	1	1	24	0	0
6	38778327	.	T	C	1	2	3	0	0	3	0	0
6	38782025	.	C	T	3	7	10	0	0	10	0	0
6	38782439	.	C	A	3	3	6	0	0	6	0	0
6	38782442	.	C	T	2	3	5	0	0	5	0	0
6	38782712	.	T	C	1	6	7	0	0	7	0	0
6	38782794	.	C	T	4	6	10	0	0	10	0	0
6	38782799	.	T	A	4	5	9	0	1	10	0	0
6	38783044	.	T	A	0	2	2	0	0	2	0	0
6	38786301	.	G	A	0	0	0	0	1	1	0	0
6	38786622	.	C	A	2	1	3	0	0	3	0	0
6	38789065	.	C	A	11	11	22	0	0	22	0	0
6	38789292	.	C	T	12	14	26	0	4	30	0	0
6	38789317	.	C	T	9	14	23	0	3	26	0	0
6	38789507	.	A	T	9	13	22	0	0	23	1	0
6	38789583	.	G	C	17	13	30	0	0	30	0	0
6	38789733	.	A	G	14	11	25	0	7	32	0	0
6	38789832	.	A	G	20	16	36	0	0	36	0	0
6	38789853	.	T	A	18	15	33	0	0	33	0	0
6	38789903	.	A	T	7	4	11	0	11	23	1	0
6	38845797	.	G	A	4	3	7	0	0	7	0	0
6	38845817	.	T	C	7	4	11	0	0	11	0	0
6	38845865	.	G	A	6	5	11	0	0	11	0	0
6	38845943	.	C	G	7	4	11	0	0	11	0	0
6	38845964	.	A	G	6	3	9	0	0	9	0	0
6	38845986	.	A	G	6	0	6	0	3	9	0	0
6	38858036	.	G	T	0	1	1	0	2	3	0	0
6	38858784	.	T	G	9	10	19	0	1	20	0	0
6	38858832	.	T	G	7	6	13	0	0	13	0	0
6	38858902	.	T	A	2	2	4	0	1	5	0	0
6	38859796	.	T	A	4	8	12	0	1	13	0	0
6	38859938	.	A	G	13	9	22	0	1	23	0	0
6	38860293	.	C	G	6	7	13	0	6	19	0	0
6	38860362	.	T	A	10	7	17	0	1	18	0	0
6	38860421	.	C	T	8	6	14	0	0	14	0	0
6	38860815	.	A	G	1	7	8	0	1	9	0	0
6	38860823	.	C	T	1	10	11	0	0	11	0	0
6	38860898	.	T	C	8	13	21	0	4	25	0	0
6	38860905	.	C	T	8	15	23	0	1	24	0	0
6	38860981	.	T	C	9	6	15	0	1	16	0	0
6	38860985	.	T	G	9	7	16	0	1	17	0	0
6	38861020	.	G	A	6	8	14	0	0	14	0	0
6	38861035	.	C	A	4	9	13	0	0	14	1	0
6	38896523	.	T	C	5	2	7	0	0	7	0	0
6	38899123	.	T	C	1	1	2	0	0	2	0	0
6	38901991	.	T	C	14	5	19	0	2	21	0	0
6	38902291	.	T	A	8	5	13	0	1	14	0	0
6	39068424	.	A	G	15	16	31	0	0	31	0	0
6	39075254	.	A	C	3	4	7	0	1	8	0	0
6	39075513	.	G	A	5	8	13	0	1	14	0	0
6	39077308	.	G	C	4	8	12	0	0	12	0	0
6	39077364	.	C	T	0	1	1	0	0	1	0	0
6	39123673	.	T	C	1	0	1	0	2	3	0	0
6	39123923	.	C	A	3	7	10	0	0	10	0	0
6	39124288	.	C	A	7	7	14	0	0	14	0	0
6	39124304	.	A	C	6	9	15	0	0	15	0	0
6	39124389	.	G	A	4	5	9	0	0	9	0	0
6	39124688	.	C	T	0	2	2	0	4	6	0	0
6	39124784	.	T	A	7	1	8	0	0	9	1	0
6	39124789	.	C	A	7	4	11	0	0	11	0	0
6	39125228	.	G	A	10	4	14	0	0	14	0	0
6	39125390	.	T	A	1	2	3	0	0	3	0	0
6	39125392	.	C	A	1	2	3	0	0	3	0	0
6	39125609	.	A	C	6	5	11	0	0	11	0	0
6	39125626	.	G	A	3	6	9	0	3	12	0	0
6	39125653	.	G	A	5	7	12	0	0	12	0	0
6	39125746	.	A	C	3	5	8	0	0	8	0	0
6	39125748	.	T	C	5	3	8	0	0	8	0	0
6	39126503	.	G	A	2	2	4	0	0	4	0	0
6	39126533	.	C	T	0	0	0	0	4	4	0	0
6	39136487	.	A	G	3	2	5	0	0	5	0	0
6	39162488	.	C	A	2	4	6	0	0	6	0	0
6	39162491	.	C	G	2	4	6	0	1	7	0	0
6	39162607	.	C	T	10	9	19	0	0	19	0	0
6	39162718	.	A	T	7	9	16	0	0	16	0	0
6	39162756	.	T	A	8	11	19	0	1	20	0	0
6	39162855	.	C	T	10	5	15	0	0	15	0	0
6	39162896	.	G	A	7	11	18	0	0	18	0	0
6	39163058	.	T	A	0	6	6	0	0	6	0	0
6	39163286	.	G	A	7	8	15	0	0	15	0	0
6	39163363	.	A	T	7	7	14	0	1	15	0	0
6	39163657	.	T	G	5	4	9	0	1	10	0	0
6	39163690	.	T	C	6	0	6	0	6	12	0	0
6	39163876	.	A	G	4	4	8	0	0	8	0	0
6	39164046	.	T	G	3	5	8	0	1	9	0	0
6	39993909	.	T	C	0	6	6	0	1	7	0	0
6	40761940	.	T	C	2	2	4	0	1	5	0	0
6	40761959	.	T	C	2	6	8	0	0	8	0	0
6	40761975	.	T	C	5	4	9	0	0	9	0	0
6	40762228	.	T	C	2	3	5	0	0	5	0	0
6	40946908	.	C	T	6	3	9	0	4	13	0	0
6	41435866	.	A	G	12	12	24	0	0	24	0	0
6	41460563	.	A	T	0	6	6	0	1	7	0	0
6	43232282	.	G	A	4	1	5	0	1	6	0	0
6	43903849	.	A	G	1	0	1	0	6	7	0	0
6	44924866	.	A	C	0	2	2	0	0	2	0	0
6	44945301	.	C	T	6	2	8	0	0	8	0	0
6	44945320	.	T	C	5	3	8	0	0	8	0	0
6	44947635	.	G	A	0	1	1	0	0	1	0	0
6	44950364	.	C	T	4	4	8	0	0	8	0	0
6	44950644	.	C	T	5	6	11	0	0	11	0	0
6	44950701	.	T	G	8	6	14	0	1	15	0	0
6	44961519	.	A	G	6	5	11	0	0	11	0	0
6	44970154	.	A	G	1	0	1	0	1	2	0	0
6	44977406	.	G	A	14	10	24	0	2	26	0	0
6	45375002	.	A	G	2	2	4	0	0	4	0	0
6	46319753	.	A	T	1	2	3	0	0	3	0	0
6	46319754	.	G	A	1	2	3	0	0	3	0	0
6	46343180	.	T	C	1	2	3	0	0	3	0	0
6	46346865	.	A	C	1	2	3	0	0	3	0	0
6	46357708	.	C	A	0	2	2	0	1	3	0	0
6	46419928	.	A	T	2	5	7	0	0	7	0	0
6	46422955	.	G	A	3	4	7	0	2	9	0	0
6	46423470	.	C	A	3	2	5	0	0	5	0	0
6	46423593	.	G	T	5	3	8	0	0	8	0	0
6	46425620	.	A	G	4	4	8	0	0	8	0	0
6	46428718	.	A	C	1	3	4	0	0	4	0	0
6	46431113	.	G	A	0	7	7	0	6	13	0	0
6	46431950	.	A	G	30	19	49	0	1	50	0	0
6	46432016	.	G	A	3	5	8	0	0	8	0	0
6	46450487	.	C	G	32	23	55	0	2	57	0	0
6	46450547	.	T	C	28	20	48	0	3	51	0	0
6	46450804	.	C	T	12	10	22	0	9	31	0	0
6	46452997	.	C	T	2	3	5	0	1	6	0	0
6	46454103	.	C	A	14	19	33	0	1	34	0	0
6	46454148	.	G	A	21	8	29	0	4	33	0	0
6	46454173	.	T	G	24	18	42	0	0	42	0	0
6	46454396	.	T	A	23	26	49	0	1	50	0	0
6	46508072	.	G	T	7	4	11	0	0	11	0	0
6	46559848	.	C	T	1	2	3	0	0	3	0	0
6	46686705	.	T	A	1	3	4	0	0	4	0	0
6	46701953	.	C	T	1	2	3	0	0	3	0	0
6	46715454	.	T	A	2	0	2	0	0	2	0	0
6	46716897	.	T	C	4	7	11	0	0	11	0	0
6	46716915	.	C	T	5	6	11	0	2	13	0	0
6	46716954	.	T	C	4	6	10	0	0	10	0	0
6	46717535	.	T	C	3	4	7	0	0	7	0	0
6	46717731	.	A	G	4	0	4	0	4	8	0	0
6	46717772	.	T	C	4	5	9	0	1	10	0	0
6	46718103	.	T	G	8	8	16	0	0	16	0	0
6	46718193	.	G	T	12	10	22	0	0	22	0	0
6	46718237	.	G	A	3	5	8	0	0	8	0	0
6	46718243	.	G	A	3	4	7	0	0	7	0	0
6	46721369	.	C	T	0	3	3	0	0	3	0	0
6	46722670	.	G	A	3	9	12	0	1	13	0	0
6	46722671	.	G	T	3	10	13	0	0	13	0	0
6	46722783	.	G	T	0	8	8	0	9	17	0	0
6	46722786	.	C	G	8	7	15	0	0	15	0	0
6	46722883	.	T	G	11	10	21	0	0	21	0	0
6	46725949	.	T	C	2	4	6	0	1	7	0	0
6	46725966	.	T	A	1	3	4	0	3	7	0	0
6	46726080	.	A	G	9	3	12	0	1	13	0	0
6	46726234	.	T	G	6	7	13	0	1	14	0	0
6	46726901	.	C	T	0	4	4	0	0	4	0	0
6	47006599	.	G	A	2	1	3	0	0	3	0	0
6	47006611	.	A	G	6	4	10	0	1	11	0	0
6	47032679	.	C	T	6	7	13	0	0	13	0	0
6	47032772	.	A	G	7	6	13	0	1	14	0	0
6	47054448	.	A	G	0	2	2	0	0	2	0	0
6	47246513	.	C	T	3	5	8	0	0	8	0	0
6	47460346	.	T	A	2	2	4	0	0	4	0	0
6	47530112	.	C	G	5	3	8	0	0	8	0	0
6	47530428	.	T	C	4	2	6	0	0	6	0	0
6	47530562	.	G	T	1	4	5	0	0	5	0	0
6	47530563	.	T	A	0	4	4	0	1	5	0	0
6	47530828	.	C	T	0	4	4	0	8	12	0	0
6	47531110	.	C	A	4	3	7	0	0	7	0	0
6	47531176	.	G	C	2	0	2	0	0	2	0	0
6	47538035	.	C	A	5	3	8	0	0	8	0	0
6	47540093	.	C	T	4	2	6	0	0	6	0	0
6	47540405	.	A	T	0	2	2	0	0	2	0	0
6	47558374	.	C	T	0	3	3	0	2	5	0	0
6	47810323	.	A	G	9	7	16	0	0	16	0	0
6	47810671	.	T	A	16	5	21	0	0	21	0	0
6	47810688	.	T	C	12	1	13	0	4	17	0	0
6	47810804	.	A	T	11	12	23	0	0	23	0	0
6	47810810	.	T	A	11	9	20	0	0	20	0	0
6	47810941	.	C	T	1	5	6	0	4	10	0	0
6	47811024	.	G	A	4	10	14	0	0	14	0	0
6	47811463	.	G	A	5	6	11	0	0	11	0	0
6	47811473	.	G	A	4	7	11	0	0	11	0	0
6	47811687	.	T	C	2	0	2	0	4	6	0	0
6	47811940	.	G	A	3	3	6	0	1	7	0	0
6	47812067	.	G	T	1	2	3	0	1	4	0	0
6	47812280	.	G	C	4	0	4	0	5	9	0	0
6	47812843	.	C	T	0	2	2	0	5	7	0	0
6	47813100	.	T	G	2	2	4	0	0	4	0	0
6	47813366	.	G	A	2	3	5	0	1	6	0	0
6	47813407	.	T	A	3	3	6	0	0	6	0	0
6	47813548	.	T	C	1	2	3	0	0	3	0	0
6	47813877	.	G	A	4	4	8	0	0	8	0	0
6	47816711	.	A	G	1	1	2	0	1	3	0	0
6	47816730	.	T	C	3	1	4	0	1	5	0	0
6	47825364	.	T	A	1	2	3	0	0	3	0	0
6	47825404	.	C	A	2	4	6	0	0	6	0	0
6	47833110	.	T	A	1	0	1	0	0	1	0	0
6	47865238	.	C	G	7	3	10	0	0	10	0	0
6	47865287	.	C	A	5	10	15	0	0	15	0	0
6	47865322	.	C	T	5	8	13	0	2	15	0	0
6	47865391	.	C	T	7	14	21	0	0	21	0	0
6	47865588	.	T	C	2	6	8	0	0	8	0	0
6	47865626	.	G	T	5	3	8	0	2	10	0	0
6	47865661	.	A	T	7	5	12	0	1	13	0	0
6	47865770	.	A	C	3	3	6	0	0	6	0	0
6	47865780	.	C	G	3	2	5	0	0	5	0	0
6	47869454	.	C	T	1	3	4	0	2	6	0	0
6	47869499	.	T	C	1	1	2	0	1	3	0	0
6	47869510	.	C	G	2	2	4	0	0	4	0	0
6	47869802	.	C	A	4	4	8	0	2	10	0	0
6	47869982	.	G	A	8	4	12	0	0	12	0	0
6	47870185	.	T	C	6	0	6	0	3	9	0	0
6	47870463	.	G	A	1	4	5	0	0	5	0	0
6	47872510	.	G	A	1	0	1	0	0	1	0	0
6	47875681	.	G	A	3	4	7	0	0	7	0	0
6	47879230	.	C	T	1	1	2	0	0	2	0	0
6	48045699	.	C	A	0	1	1	0	0	1	0	0
6	48052310	.	C	T	1	3	4	0	0	4	0	0
6	48054766	.	C	T	1	2	3	0	0	3	0	0
6	48057928	.	C	T	11	11	22	0	0	22	0	0
6	48058088	.	T	A	4	4	8	0	0	8	0	0
6	48058351	.	G	A	0	5	5	0	10	15	0	0
6	48058628	.	A	G	6	14	20	0	0	20	0	0
6	48058719	.	A	G	8	0	8	0	4	12	0	0
6	48058720	.	C	T	8	4	12	0	0	12	0	0
6	49108157	.	T	C	18	8	26	0	2	28	0	0
6	49577340	.	A	G	1	2	3	0	0	3	0	0
6	49577358	.	A	G	2	3	5	0	1	6	0	0
6	49577405	.	A	G	5	3	8	0	1	9	0	0
6	49577418	.	A	G	5	2	7	0	0	7	0	0
6	49577497	.	A	G	4	8	12	0	0	12	0	0
6	49577503	.	A	G	4	6	10	0	0	10	0	0
6	49738006	.	A	G	10	4	14	0	1	15	0	0
6	49738171	.	A	G	3	0	3	0	19	22	0	0
6	49738348	.	A	G	8	0	8	0	8	16	0	0
6	49738353	.	A	G	7	0	7	0	10	17	0	0
6	49738490	.	A	G	9	4	13	0	0	13	0	0
6	49738729	.	A	G	1	1	2	0	16	18	0	0
6	49738752	.	A	G	12	7	19	0	0	19	0	0
6	52224090	.	A	G	38	13	51	0	3	54	0	0
6	52224406	.	A	G	32	19	51	0	1	52	0	0
6	54806458	.	T	C	3	3	6	0	2	8	0	0
6	55217796	.	A	G	10	5	15	0	1	16	0	0
6	55217903	.	A	G	2	3	5	0	1	6	0	0
6	55217907	.	A	G	2	4	6	0	0	6	0	0
6	55218047	.	A	G	3	6	9	0	0	9	0	0
6	55218127	.	A	G	12	7	19	0	1	20	0	0
6	55218137	.	A	G	5	15	20	0	0	20	0	0
6	55218256	.	A	G	4	3	7	0	1	8	0	0
6	57439021	.	T	C	2	4	6	0	0	6	0	0
6	57439429	.	C	T	0	1	1	0	0	1	0	0
6	57455557	.	T	C	4	0	4	0	0	4	0	0
6	57459817	.	C	T	3	3	6	0	2	8	0	0
6	57459823	.	T	G	3	5	8	0	0	8	0	0
6	57465261	.	T	C	0	0	0	0	1	1	0	0
6	57478900	.	C	T	1	3	4	0	3	7	0	0
6	57481377	.	A	G	4	7	11	0	0	12	1	0
6	57492086	.	G	A	4	7	11	0	1	12	0	0
6	57494354	.	C	G	0	1	1	0	0	1	0	0
6	57498040	.	G	A	1	4	5	0	0	5	0	0
6	57498088	.	T	C	1	3	4	0	0	4	0	0
6	57498253	.	A	G	5	2	7	0	0	7	0	0
6	57498255	.	A	T	5	2	7	0	0	7	0	0
6	57500563	.	G	A	2	0	2	0	0	2	0	0
6	57500608	.	C	T	2	1	3	0	0	3	0	0
6	57500617	.	G	C	2	0	2	0	1	3	0	0
6	57503976	.	T	G	5	2	7	0	1	8	0	0
6	57503979	.	C	T	5	2	7	0	0	7	0	0
6	57504571	.	G	T	1	2	3	0	0	3	0	0
6	57504592	.	C	T	3	4	7	0	1	8	0	0
6	57504646	.	G	A	2	2	4	0	1	5	0	0
6	57519597	.	G	C	1	3	4	0	1	5	0	0
6	57523315	.	T	G	1	1	2	0	0	2	0	0
6	57523330	.	T	A	1	1	2	0	0	2	0	0
6	57541942	.	T	A	4	6	10	0	0	10	0	0
6	57583996	.	T	C	2	3	5	0	0	5	0	0
6	57595160	.	T	C	5	9	14	0	1	15	0	0
6	57618934	.	C	T	6	6	12	0	0	12	0	0
6	57620177	.	T	C	25	19	44	0	9	53	0	0
6	57620315	.	A	C	19	22	41	0	2	43	0	0
6	57630819	.	A	G	10	7	17	0	0	17	0	0
6	57630879	.	C	A	9	5	14	0	0	14	0	0
6	57634880	.	T	G	9	11	20	0	1	21	0	0
6	57634922	.	G	A	8	11	19	0	0	19	0	0
6	57634949	.	G	A	4	9	13	0	1	14	0	0
6	57644311	.	A	G	7	6	13	0	5	18	0	0
6	57644779	.	C	T	0	0	0	0	1	1	0	0
6	57651978	.	C	A	1	3	4	0	0	4	0	0
6	57652041	.	T	C	3	0	3	0	5	8	0	0
6	57900462	.	C	T	1	8	9	0	0	9	0	0
6	57900569	.	G	A	9	2	11	0	0	11	0	0
6	57901172	.	C	T	8	10	18	0	1	19	0	0
6	57909067	.	T	G	8	1	9	1	17	27	0	0
6	57909090	.	T	C	10	0	10	1	16	27	0	0
6	57930218	.	A	G	2	4	6	0	0	6	0	0
6	57984041	.	C	T	1	3	4	0	0	4	0	0
6	58038349	.	A	C	1	0	1	0	0	1	0	0
6	58307588	.	C	T	0	1	1	0	0	1	0	0
6	58359460	.	T	C	1	2	3	0	0	3	0	0
6	58359511	.	G	A	2	3	5	0	0	5	0	0
6	58364534	.	A	T	0	1	1	0	0	1	0	0
6	58369530	.	T	C	0	2	2	0	0	2	0	0
6	58370814	.	A	G	1	0	1	0	2	3	0	0
6	58370817	.	C	T	1	2	3	0	0	3	0	0
6	58374508	.	T	C	1	0	1	0	0	1	0	0
6	58381405	.	T	G	2	0	2	0	2	4	0	0
6	58381417	.	T	C	2	2	4	0	0	4	0	0
6	58382915	.	T	G	3	6	9	0	0	9	0	0
6	58382939	.	C	T	1	4	5	0	0	5	0	0
6	58382954	.	C	T	1	4	5	0	0	5	0	0
6	58384067	.	A	G	0	1	1	0	5	6	0	0
6	58389115	.	A	C	4	0	4	0	0	4	0	0
6	58389139	.	C	T	0	4	4	0	0	4	0	0
6	58389151	.	G	T	4	0	4	0	0	4	0	0
6	58393919	.	A	T	2	3	5	0	0	5	0	0
6	58395444	.	G	A	0	9	9	0	18	27	0	0
6	58395451	.	C	A	14	11	25	0	1	26	0	0
6	58459515	.	A	G	1	3	4	0	0	4	0	0
6	58459557	.	G	C	1	3	4	0	0	4	0	0
6	58495301	.	G	A	1	7	8	0	1	9	0	0
6	58495315	.	A	C	1	6	7	0	1	8	0	0
6	58496002	.	A	G	1	0	1	0	4	5	0	0
6	58496148	.	T	C	4	4	8	0	0	8	0	0
6	58496633	.	T	C	1	2	3	0	0	3	0	0
6	58497757	.	C	T	3	1	4	0	0	4	0	0
6	58497805	.	A	C	3	4	7	0	0	7	0	0
6	58497864	.	A	T	5	3	8	0	0	8	0	0
6	58497993	.	C	T	2	2	4	0	0	4	0	0
6	58498087	.	G	A	0	2	2	0	0	2	0	0
6	58498101	.	T	G	0	2	2	0	0	2	0	0
6	58498439	.	A	T	4	2	6	0	1	7	0	0
6	58498474	.	G	C	1	3	4	0	0	4	0	0
6	58498500	.	A	G	1	0	1	0	2	3	0	0
6	58498600	.	G	T	3	5	8	0	0	8	0	0
6	58499600	.	A	C	5	4	9	0	0	9	0	0
6	58499657	.	T	C	7	4	11	0	0	11	0	0
6	58499755	.	T	C	3	3	6	0	0	6	0	0
6	58499773	.	T	C	3	2	5	0	0	5	0	0
6	58499794	.	A	T	4	3	7	0	0	7	0	0
6	58522771	.	A	G	13	8	21	0	0	21	0	0
6	58524509	.	C	A	2	1	3	0	0	3	0	0
6	58549100	.	A	G	0	0	0	0	1	1	0	0
6	58553387	.	G	A	5	5	10	0	2	12	0	0
6	58553424	.	T	C	12	21	33	0	0	33	0	0
6	58560682	.	G	A	20	18	38	0	3	41	0	0
6	58560718	.	G	A	26	19	45	0	2	47	0	0
6	58561057	.	T	C	16	18	34	0	0	34	0	0
6	58561081	.	A	C	13	21	34	0	1	35	0	0
6	58561190	.	C	G	16	17	33	0	1	34	0	0
6	58562393	.	G	T	21	7	28	0	1	29	0	0
6	58563093	.	T	A	27	28	55	0	0	55	0	0
6	58563157	.	T	C	19	34	53	0	4	57	0	0
6	58563159	.	G	A	19	38	57	0	0	57	0	0
6	58563229	.	A	C	27	10	37	0	1	38	0	0
6	58563374	.	C	T	18	17	35	0	1	36	0	0
6	58563415	.	A	T	15	8	23	0	1	24	0	0
6	58612933	.	C	A	1	2	3	0	0	3	0	0
6	58698673	.	A	G	2	5	7	0	0	7	0	0
6	58698737	.	C	T	1	2	3	0	0	3	0	0
6	58698875	.	C	A	3	4	7	0	1	8	0	0
6	58698910	.	T	G	3	0	3	0	5	8	0	0
6	58698960	.	C	T	5	3	8	0	0	8	0	0
6	58708185	.	A	G	1	3	4	0	1	5	0	0
6	58708194	.	T	C	3	3	6	0	0	6	0	0
6	58708227	.	T	G	4	4	8	0	0	8	0	0
6	58712458	.	G	C	9	10	19	0	0	19	0	0
6	58712477	.	C	G	8	9	17	0	0	17	0	0
6	58712540	.	G	A	0	6	6	0	8	14	0	0
6	58723254	.	C	G	6	5	11	0	0	11	0	0
6	58723383	.	T	G	12	10	22	0	1	23	0	0
6	58725930	.	T	C	10	10	20	0	3	23	0	0
6	58726154	.	A	G	3	7	10	0	5	15	0	0
6	58728706	.	G	A	0	5	5	0	12	17	0	0
6	58728825	.	A	G	9	8	17	0	2	19	0	0
6	58728858	.	G	A	0	11	11	0	5	16	0	0
6	58729053	.	T	A	6	7	13	0	0	13	0	0
6	58729059	.	T	G	7	0	7	0	5	12	0	0
6	58729100	.	C	G	5	0	5	0	5	10	0	0
6	58729120	.	T	C	3	10	13	0	0	13	0	0
6	58729145	.	G	A	5	9	14	0	0	14	0	0
6	58730208	.	A	T	2	8	10	0	0	10	0	0
6	58730474	.	A	T	2	3	5	0	0	5	0	0
6	58730493	.	G	C	1	3	4	0	0	4	0	0
6	58730603	.	A	G	4	5	9	0	3	12	0	0
6	58730657	.	T	C	11	6	17	0	1	18	0	0
6	58732475	.	C	G	18	22	40	0	0	40	0	0
6	58773647	.	T	G	4	3	7	0	0	7	0	0
6	58773785	.	C	T	0	8	8	0	13	21	0	0
6	58773788	.	A	G	13	8	21	0	0	21	0	0
6	58778896	.	G	C	0	0	0	0	1	1	0	0
6	58781017	.	G	A	0	3	3	0	0	3	0	0
6	58784810	.	A	G	5	5	10	0	2	12	0	0
6	58808298	.	G	A	0	3	3	0	0	3	0	0
6	58808328	.	C	T	0	1	1	0	0	1	0	0
6	58828036	.	A	G	6	4	10	0	2	12	0	0
6	58855648	.	C	T	2	1	3	0	0	3	0	0
6	58857964	.	A	G	1	0	1	0	0	1	0	0
6	58859737	.	G	A	0	1	1	0	5	6	0	0
6	58862341	.	G	A	0	6	6	0	10	16	0	0
6	58867018	.	A	G	35	0	35	0	21	56	0	0
6	58867240	.	A	G	17	6	23	0	1	24	0	0
6	58867470	.	C	A	17	21	38	0	0	38	0	0
6	58874121	.	T	C	3	0	3	0	3	6	0	0
6	58875665	.	T	C	4	0	4	0	1	5	0	0
6	58877981	.	G	C	0	0	0	0	1	1	0	0
6	58878077	.	T	C	1	1	2	0	0	2	0	0
6	58889105	.	G	A	2	2	4	0	0	4	0	0
6	58889426	.	C	A	1	2	3	0	0	3	0	0
6	58889713	.	T	C	3	2	5	0	0	5	0	0
6	58891765	.	T	A	3	2	5	0	0	5	0	0
6	58918095	.	T	C	0	1	1	0	0	1	0	0
6	58918506	.	A	G	20	0	20	0	19	39	0	0
6	58918676	.	T	G	19	12	31	0	1	32	0	0
6	58918693	.	T	C	23	10	33	0	0	33	0	0
6	58921434	.	C	A	5	5	10	0	1	11	0	0
6	58921506	.	G	T	5	12	17	0	0	17	0	0
6	58923246	.	T	C	5	2	7	0	0	7	0	0
6	58934546	.	T	C	1	5	6	0	0	6	0	0
6	58939261	.	T	C	2	5	7	0	0	7	0	0
6	58939303	.	G	T	1	2	3	0	1	4	0	0
6	58948931	.	C	T	3	2	5	0	0	5	0	0
6	58949364	.	C	A	0	2	2	0	0	2	0	0
6	59671954	.	A	G	2	1	3	0	6	9	0	0
6	59679633	.	G	A	0	6	6	0	7	13	0	0
6	59679636	.	C	A	4	9	13	0	0	13	0	0
6	59681450	.	A	T	1	4	5	0	0	5	0	0
6	59681464	.	G	A	1	2	3	0	1	4	0	0
6	59691533	.	C	T	3	8	11	0	1	12	0	0
6	59813578	.	G	A	0	2	2	0	7	9	0	0
6	59813608	.	A	G	14	10	24	0	2	26	0	0
6	59813857	.	G	A	0	1	1	0	3	4	0	0
6	59813905	.	A	G	11	0	11	0	11	22	0	0
6	59819362	.	C	T	12	9	21	0	3	24	0	0
6	59824482	.	C	T	19	22	41	0	1	42	0	0
6	59824496	.	C	T	18	21	39	0	2	41	0	0
6	59824672	.	C	T	24	17	41	0	3	44	0	0
6	59824736	.	C	T	13	19	32	0	3	35	0	0
6	59832922	.	T	C	15	4	19	0	0	19	0	0
6	59833006	.	T	A	9	9	18	0	1	19	0	0
6	59833007	.	A	G	8	9	17	0	2	19	0	0
6	59837587	.	C	G	2	8	10	0	1	11	0	0
6	59837710	.	A	G	1	0	1	0	0	1	0	0
6	59837747	.	G	A	0	4	4	0	5	9	0	0
6	59839033	.	G	A	1	6	7	0	10	17	0	0
6	59839048	.	G	A	8	6	14	0	0	14	0	0
6	59841394	.	G	A	0	11	11	0	9	20	0	0
6	59848119	.	C	T	11	10	21	0	4	25	0	0
6	59848345	.	T	C	18	18	36	0	2	39	1	0
6	59848624	.	C	G	8	9	17	3	0	20	0	0
6	59848894	.	T	C	17	23	40	0	2	42	0	0
6	59850253	.	C	T	18	18	36	0	0	36	0	0
6	59850308	.	T	C	22	17	39	0	1	40	0	0
6	59882680	.	T	C	8	12	20	0	0	20	0	0
6	59882704	.	T	C	2	12	14	0	0	14	0	0
6	59883154	.	G	A	11	5	16	0	0	16	0	0
6	59889640	.	G	T	0	1	1	0	3	4	0	0
6	59891289	.	T	C	7	7	14	0	1	15	0	0
6	59894548	.	T	C	14	13	27	0	2	29	0	0
6	59894580	.	T	A	17	7	24	0	2	26	0	0
6	59894719	.	T	C	14	4	18	0	0	18	0	0
6	59915599	.	T	C	1	1	2	0	0	2	0	0
6	59915608	.	T	C	1	0	1	0	0	1	0	0
6	59917077	.	T	C	2	5	7	0	1	8	0	0
6	59920132	.	G	A	0	1	1	0	0	1	0	0
6	59921661	.	T	G	13	15	28	0	2	30	0	0
6	59921685	.	T	C	9	18	27	0	2	29	0	0
6	59921788	.	A	C	7	9	16	0	2	18	0	0
6	59939277	.	G	A	12	7	19	0	0	19	0	0
6	59945088	.	A	G	1	2	3	0	0	3	0	0
6	59949374	.	C	A	2	2	4	0	0	4	0	0
6	59951038	.	C	T	3	4	7	0	0	7	0	0
6	59951324	.	C	G	2	2	4	0	0	4	0	0
6	59951450	.	T	A	3	4	7	0	0	7	0	0
6	59971416	.	C	T	20	24	44	0	4	48	0	0
6	59971598	.	A	G	30	14	44	0	1	45	0	0
6	59971711	.	G	A	13	27	40	0	0	41	1	0
6	59971718	.	C	A	12	27	39	0	1	40	0	0
6	59971897	.	G	A	5	2	7	0	2	9	0	0
6	59972259	.	T	A	6	22	28	0	1	29	0	0
6	59985833	.	C	T	1	4	5	0	0	5	0	0
6	60031520	.	G	A	5	7	12	0	0	12	0	0
6	60031641	.	C	T	0	3	3	0	13	16	0	0
6	60043150	.	A	G	3	6	9	0	0	9	0	0
6	60043179	.	T	C	3	3	6	0	0	6	0	0
6	60043297	.	T	A	3	3	6	0	0	6	0	0
6	60043413	.	G	A	8	5	13	0	1	14	0	0
6	60043580	.	G	C	2	3	5	0	0	5	0	0
6	60044319	.	T	A	2	4	6	0	0	6	0	0
6	60044320	.	A	T	2	4	6	0	0	6	0	0
6	60044393	.	C	T	0	8	8	0	0	8	0	0
7	742828	.	T	C	6	26	32	0	1	33	0	0
7	762326	.	G	A	8	2	10	0	0	10	0	0
7	846972	.	T	C	3	5	8	1	0	9	0	0
7	847189	.	A	T	3	9	12	0	0	12	0	0
7	871038	.	C	T	1	4	5	0	1	6	0	0
7	1417365	.	G	A	0	1	1	0	3	4	0	0
7	1618771	.	G	A	0	4	4	0	1	5	0	0
7	3931029	.	A	G	38	15	53	0	2	55	0	0
7	3931264	.	C	T	24	28	52	0	3	55	0	0
7	3931396	.	A	T	30	29	59	0	0	59	0	0
7	3931543	.	A	T	31	15	46	0	2	48	0	0
7	3931598	.	G	T	26	27	53	0	1	54	0	0
7	3931644	.	T	C	30	1	31	0	16	47	0	0
7	3932209	.	A	T	17	19	36	0	1	37	0	0
7	3932402	.	T	C	7	21	28	1	3	32	0	0
7	3932405	.	A	T	9	20	29	1	2	32	0	0
7	3932463	.	T	G	10	13	23	0	4	27	0	0
7	3932546	.	C	A	3	4	7	0	0	7	0	0
7	3932694	.	G	A	26	6	32	0	1	33	0	0
7	3932698	.	T	C	28	6	34	0	1	35	0	0
7	3932731	.	C	A	29	10	39	0	1	40	0	0
7	3932935	.	C	A	15	15	30	0	3	33	0	0
7	3933121	.	G	A	26	27	53	0	1	54	0	0
7	3933243	.	C	A	16	13	29	0	0	29	0	0
7	3933271	.	C	T	20	17	37	0	2	39	0	0
7	3933383	.	A	C	10	1	11	0	27	38	0	0
7	3933481	.	T	C	19	0	19	0	12	31	0	0
7	3933483	.	C	T	0	12	12	0	19	31	0	0
7	3933998	.	C	T	18	18	36	0	3	39	0	0
7	3934038	.	A	T	15	25	40	0	0	40	0	0
7	3934387	.	C	T	12	24	36	0	3	39	0	0
7	3934428	.	G	T	14	20	34	0	4	38	0	0
7	3934645	.	A	C	4	11	15	0	0	15	0	0
7	3934818	.	G	A	14	7	21	0	1	22	0	0
7	3934970	.	A	G	10	16	26	0	1	27	0	0
7	3935055	.	T	C	8	15	23	0	0	23	0	0
7	3935123	.	A	G	11	15	26	0	2	28	0	0
7	3935171	.	G	C	18	5	23	0	1	25	1	0
7	3935283	.	G	A	14	15	29	0	0	29	0	0
7	3935737	.	C	T	0	13	13	0	18	31	0	0
7	3935788	.	C	A	5	6	11	0	0	11	0	0
7	3936127	.	C	T	0	10	10	0	14	24	0	0
7	3936702	.	A	G	2	2	4	0	1	5	0	0
7	3936764	.	G	A	9	6	15	0	3	18	0	0
7	3936946	.	C	T	0	7	7	0	7	14	0	0
7	3955628	.	G	A	0	1	1	0	0	1	0	0
7	4088334	.	C	T	14	21	35	0	2	37	0	0
7	4088545	.	C	T	0	13	13	0	18	31	0	0
7	4088680	.	G	A	13	20	33	0	2	35	0	0
7	4088727	.	A	T	17	26	43	0	1	44	0	0
7	4088832	.	A	G	19	20	39	0	1	40	0	0
7	4089042	.	A	G	22	8	30	0	1	31	0	0
7	4089090	.	G	A	17	6	23	0	0	23	0	0
7	4095265	.	C	T	0	11	11	0	14	25	0	0
7	4100931	.	C	T	9	9	18	0	1	19	0	0
7	4100967	.	G	A	17	14	31	0	1	32	0	0
7	4110441	.	T	C	0	0	0	0	1	1	0	0
7	4175054	.	G	A	2	6	8	0	0	8	0	0
7	4175078	.	G	A	1	4	5	0	1	6	0	0
7	4180419	.	G	A	1	3	4	0	0	4	0	0
7	4180742	.	C	T	1	3	4	0	0	4	0	0
7	4181728	.	G	A	2	9	11	0	0	11	0	0
7	4183317	.	G	A	0	2	2	0	0	2	0	0
7	4183345	.	C	T	4	2	6	0	0	6	0	0
7	4183996	.	C	T	2	3	5	0	1	6	0	0
7	4184203	.	G	C	1	2	3	0	0	3	0	0
7	4184897	.	G	T	1	5	6	0	1	7	0	0
7	4185160	.	A	T	13	7	20	0	0	20	0	0
7	4185312	.	G	T	0	3	3	0	1	4	0	0
7	4186499	.	A	G	2	5	7	1	1	9	0	0
7	4186568	.	T	A	0	7	7	0	0	7	0	0
7	5487184	.	G	A	3	1	4	0	0	4	0	0
7	7248193	.	C	T	4	13	17	0	7	24	0	0
7	7248212	.	A	T	4	9	13	0	10	23	0	0
7	7371177	.	A	G	8	7	15	0	2	17	0	0
7	7372341	.	A	G	9	12	21	0	0	21	0	0
7	7372404	.	A	G	18	10	28	0	0	28	0	0
7	7478533	.	T	C	12	14	26	0	2	28	0	0
7	7478546	.	T	C	16	12	28	0	1	29	0	0
7	7552113	.	G	A	11	9	20	0	0	20	0	0
7	7597059	.	A	G	2	0	2	0	3	5	0	0
7	7608920	.	G	A	0	8	8	0	4	12	0	0
7	7608944	.	T	G	8	0	8	0	8	16	0	0
7	7608965	.	C	T	6	5	11	0	0	11	0	0
7	7611758	.	C	T	13	13	26	0	2	28	0	0
7	7611803	.	C	A	10	9	19	0	7	26	0	0
7	7611866	.	T	C	13	12	25	0	1	26	0	0
7	7617855	.	T	C	17	16	33	0	0	33	0	0
7	7617963	.	C	G	18	8	26	0	0	26	0	0
7	7624082	.	A	G	20	22	42	0	3	45	0	0
7	7624090	.	T	C	23	21	44	0	1	45	0	0
7	7641230	.	A	T	19	24	43	0	1	44	0	0
7	7641351	.	G	A	19	18	37	0	1	38	0	0
7	7641353	.	G	A	19	18	37	0	1	38	0	0
7	7641559	.	C	T	13	28	41	0	4	45	0	0
7	7641567	.	C	T	13	25	38	0	3	41	0	0
7	7641608	.	A	G	18	23	41	0	1	42	0	0
7	7641678	.	T	A	17	5	22	0	2	24	0	0
7	7641976	.	T	C	17	13	30	0	0	30	0	0
7	7641984	.	G	T	13	11	24	0	2	26	0	0
7	7642730	.	C	T	20	11	31	0	0	31	0	0
7	7642819	.	G	A	19	12	31	0	1	32	0	0
7	7642840	.	T	A	22	12	34	0	3	37	0	0
7	7642856	.	C	T	23	18	41	0	2	43	0	0
7	7642991	.	T	A	1	6	7	0	0	7	0	0
7	7643184	.	A	G	21	4	25	0	12	37	0	0
7	7643348	.	G	A	18	27	45	0	1	46	0	0
7	7643362	.	T	A	21	22	43	0	0	43	0	0
7	7643488	.	A	G	26	22	48	0	7	55	0	0
7	7643629	.	A	G	27	27	54	0	7	61	0	0
7	7643820	.	C	T	4	2	6	0	0	6	0	0
7	7662467	.	C	G	12	7	19	0	0	19	0	0
7	7662475	.	T	C	12	0	12	0	8	20	0	0
7	7662527	.	A	C	10	11	21	0	3	24	0	0
7	7662580	.	G	A	12	25	37	0	1	38	0	0
7	7662872	.	A	C	13	12	25	0	1	26	0	0
7	7662978	.	A	C	13	18	31	0	0	31	0	0
7	7663017	.	T	A	14	21	35	0	1	36	0	0
7	7663048	.	A	G	9	25	34	0	4	38	0	0
7	7663132	.	A	G	9	17	26	0	1	27	0	0
7	7663152	.	A	T	8	8	16	0	4	20	0	0
7	7663320	.	C	G	17	7	24	0	1	25	0	0
7	7663449	.	A	C	20	0	20	0	11	31	0	0
7	7663453	.	A	T	19	10	29	0	1	30	0	0
7	7663682	.	C	T	0	7	7	0	9	16	0	0
7	7663902	.	G	T	10	10	20	0	0	20	0	0
7	7664083	.	G	A	6	2	8	0	0	8	0	0
7	7664503	.	G	A	0	4	4	0	0	4	0	0
7	7664558	.	G	T	9	5	14	0	2	16	0	0
7	7664838	.	G	T	7	3	10	0	1	11	0	0
7	7664870	.	G	T	4	4	8	0	0	8	0	0
7	7664882	.	G	C	5	3	8	0	1	9	0	0
7	7664912	.	A	C	4	3	7	0	0	7	0	0
7	7665338	.	G	T	12	8	20	0	0	20	0	0
7	7665353	.	T	A	11	8	19	0	1	20	0	0
7	7665480	.	A	C	4	9	13	0	0	13	0	0
7	7665952	.	T	A	3	4	7	0	0	7	0	0
7	7665961	.	T	C	3	3	6	0	0	6	0	0
7	7666388	.	G	A	13	9	22	0	1	23	0	0
7	7666625	.	G	A	9	7	16	0	1	17	0	0
7	7674378	.	T	C	7	1	8	0	8	16	0	0
7	7674462	.	C	G	3	4	7	0	0	7	0	0
7	7674474	.	T	A	0	3	3	0	0	3	0	0
7	7676086	.	C	T	1	1	2	0	0	2	0	0
7	7676112	.	C	T	1	1	2	0	1	3	0	0
7	7680073	.	C	T	1	1	2	0	1	3	0	0
7	7684895	.	T	A	0	1	1	0	0	1	0	0
7	7696726	.	G	C	7	10	17	0	0	17	0	0
7	7696742	.	A	G	9	11	20	0	0	20	0	0
7	7696785	.	T	A	5	10	15	0	0	15	0	0
7	7696794	.	G	T	0	8	8	0	5	13	0	0
7	7700867	.	G	A	0	1	1	0	1	2	0	0
7	7700965	.	T	G	2	1	3	0	9	12	0	0
7	7700987	.	T	C	3	9	12	0	0	12	0	0
7	7701016	.	G	C	3	7	10	0	0	10	0	0
7	7701293	.	T	C	4	6	10	0	0	10	0	0
7	7705993	.	C	G	4	0	4	0	4	8	0	0
7	7706005	.	C	T	5	5	10	0	0	10	0	0
7	7706702	.	G	A	1	7	8	0	5	13	0	0
7	7706869	.	A	G	1	4	5	0	2	7	0	0
7	7706997	.	C	A	7	7	14	0	0	14	0	0
7	7707029	.	T	G	8	7	15	0	3	18	0	0
7	7708527	.	C	T	3	3	6	0	0	6	0	0
7	7708572	.	T	C	1	9	10	0	0	10	0	0
7	7708714	.	T	C	7	6	13	0	1	14	0	0
7	7708826	.	T	G	3	6	9	0	0	9	0	0
7	7708840	.	C	A	3	4	7	0	0	7	0	0
7	7709061	.	A	G	5	6	11	0	0	11	0	0
7	7709233	.	C	T	1	2	3	0	0	3	0	0
7	7709252	.	A	G	3	4	7	0	0	7	0	0
7	7709282	.	T	A	3	2	5	0	1	6	0	0
7	7709296	.	G	A	4	2	6	0	0	6	0	0
7	7710531	.	A	G	0	3	3	0	0	3	0	0
7	7717371	.	C	T	0	2	2	0	1	3	0	0
7	7779047	.	A	T	2	9	11	0	3	14	0	0
7	7779060	.	G	A	0	11	11	0	2	13	0	0
7	7779091	.	A	G	2	6	8	0	0	8	0	0
7	7796019	.	T	C	0	1	1	0	0	1	0	0
7	7796088	.	T	C	2	1	3	0	0	3	0	0
7	7797397	.	T	G	3	3	6	0	0	6	0	0
7	8694596	.	C	T	1	2	3	0	0	3	0	0
7	8694818	.	T	G	4	4	8	0	1	9	0	0
7	8694999	.	T	A	2	3	5	0	0	5	0	0
7	8695001	.	C	A	2	3	5	0	0	5	0	0
7	8890495	.	C	T	0	8	8	0	3	11	0	0
7	8890515	.	G	C	4	0	4	0	12	16	0	0
7	8891412	.	T	C	2	4	6	0	0	6	0	0
7	8891675	.	T	A	5	5	10	0	0	10	0	0
7	8891710	.	A	G	2	10	12	0	0	12	0	0
7	8891717	.	A	G	2	10	12	0	0	12	0	0
7	8891755	.	T	G	3	2	5	0	0	5	0	0
7	8891813	.	T	C	3	0	3	0	4	7	0	0
7	8891823	.	T	C	2	0	2	0	6	8	0	0
7	8893271	.	T	C	5	2	7	0	0	7	0	0
7	8909438	.	C	T	6	1	7	0	1	8	0	0
7	8950378	.	G	A	1	1	2	0	0	2	0	0
7	9229327	.	A	C	3	1	4	0	0	4	0	0
7	9232531	.	T	C	1	1	2	0	0	2	0	0
7	9261589	.	T	C	3	3	6	0	0	6	0	0
7	9291049	.	C	A	12	8	20	0	0	20	0	0
7	9299776	.	T	A	4	2	6	0	0	6	0	0
7	9302654	.	G	A	0	3	3	0	3	6	0	0
7	9302664	.	T	C	4	3	7	0	0	7	0	0
7	9302736	.	C	A	8	2	10	0	1	11	0	0
7	9302841	.	A	G	9	5	14	0	0	14	0	0
7	9302905	.	A	G	11	0	11	0	5	16	0	0
7	9302990	.	T	A	11	4	15	0	0	15	0	0
7	9303000	.	T	A	11	3	14	0	0	14	0	0
7	9304692	.	T	C	10	7	17	0	0	17	0	0
7	9305501	.	G	A	3	3	6	0	0	6	0	0
7	9308683	.	A	G	16	16	32	0	1	33	0	0
7	9308715	.	C	T	17	10	27	0	1	28	0	0
7	9308817	.	A	G	3	4	7	0	0	7	0	0
7	9312770	.	G	A	0	4	4	0	13	17	0	0
7	9319626	.	T	C	16	16	32	0	3	35	0	0
7	9320431	.	A	T	14	9	23	0	1	24	0	0
7	9320719	.	C	T	15	18	33	0	0	33	0	0
7	9321124	.	G	A	0	4	4	0	7	11	0	0
7	9321188	.	G	A	4	2	6	0	1	7	0	0
7	9321230	.	A	G	2	2	4	0	0	4	0	0
7	9321374	.	C	T	4	6	10	0	0	10	0	0
7	9321375	.	T	A	3	5	8	0	2	10	0	0
7	9321800	.	G	A	0	11	11	0	12	23	0	0
7	9321981	.	G	T	18	22	40	0	1	41	0	0
7	9322176	.	C	A	16	5	21	0	0	22	1	0
7	9322178	.	T	C	17	5	22	0	0	22	0	0
7	9322216	.	A	G	13	6	19	0	1	20	0	0
7	9322271	.	G	C	13	16	29	0	1	30	0	0
7	9322441	.	C	T	10	6	16	0	0	16	0	0
7	9509429	.	C	T	1	4	5	0	0	5	0	0
7	9509450	.	C	T	1	6	7	0	0	7	0	0
7	9509583	.	A	C	2	3	5	0	0	5	0	0
7	9511184	.	C	T	5	2	7	0	1	8	0	0
7	10875187	.	A	G	19	12	31	0	2	33	0	0
7	10875386	.	A	G	20	5	25	0	3	28	0	0
7	10875552	.	A	G	12	10	22	0	1	23	0	0
7	10875751	.	A	G	26	8	34	0	1	35	0	0
7	10875761	.	A	G	21	9	30	0	2	32	0	0
7	11340658	.	A	G	7	0	7	0	8	15	0	0
7	11340660	.	A	G	8	0	8	0	7	15	0	0
7	11340964	.	A	G	6	0	6	0	4	10	0	0
7	11341038	.	A	G	2	3	5	0	0	5	0	0
7	11341044	.	A	G	3	0	3	0	2	5	0	0
7	12843975	.	T	C	5	0	5	0	4	9	0	0
7	12843987	.	T	C	1	7	8	0	0	8	0	0
7	13371464	.	G	C	0	1	1	0	1	2	0	0
7	13569928	.	T	C	3	3	6	1	0	7	0	0
7	13677777	.	A	G	8	7	15	0	0	15	0	0
7	13858831	.	G	A	0	3	3	0	1	4	0	0
7	13897395	.	T	C	1	2	3	0	0	3	0	0
7	13897822	.	G	A	4	4	8	0	0	8	0	0
7	14203174	.	G	T	1	3	4	0	1	5	0	0
7	14203921	.	A	G	2	2	4	0	0	4	0	0
7	14203922	.	A	G	1	3	4	0	0	4	0	0
7	14204447	.	T	A	4	4	8	0	0	8	0	0
7	14204493	.	G	C	1	2	3	0	0	3	0	0
7	14205503	.	G	A	3	5	8	0	0	8	0	0
7	14205527	.	G	C	4	7	11	0	0	11	0	0
7	14205559	.	T	C	4	7	11	0	0	11	0	0
7	14205857	.	C	A	4	4	8	0	0	8	0	0
7	14205881	.	A	G	6	2	8	0	0	8	0	0
7	14205992	.	G	T	0	3	3	0	0	3	0	0
7	14206499	.	T	A	1	2	3	0	0	3	0	0
7	14206847	.	C	A	5	4	9	0	0	9	0	0
7	14240991	.	T	C	1	2	3	0	1	4	0	0
7	14265966	.	A	T	2	2	4	0	0	4	0	0
7	14350772	.	T	C	1	0	1	0	0	1	0	0
7	14350822	.	G	A	1	2	3	0	0	3	0	0
7	14354038	.	T	C	2	3	5	0	1	6	0	0
7	14394401	.	T	G	1	0	1	0	0	1	0	0
7	14394824	.	G	T	3	5	8	0	0	8	0	0
7	14394839	.	G	C	2	6	8	0	0	8	0	0
7	14394860	.	A	C	3	4	7	0	0	7	0	0
7	14394891	.	G	A	5	6	11	0	0	11	0	0
7	14394925	.	A	G	6	5	11	0	0	11	0	0
7	14394991	.	G	A	2	6	8	0	0	8	0	0
7	14395029	.	A	G	0	5	5	0	0	5	0	0
7	14397850	.	A	G	2	2	4	0	0	4	0	0
7	14400446	.	G	A	2	0	2	0	0	2	0	0
7	14532066	.	T	C	2	2	4	0	0	4	0	0
7	14534326	.	T	C	6	1	7	0	6	13	0	0
7	14534789	.	T	C	0	3	3	0	0	3	0	0
7	14535719	.	T	C	2	1	3	0	0	3	0	0
7	14535749	.	T	A	5	8	13	0	0	13	0	0
7	14535782	.	G	T	9	13	22	0	0	22	0	0
7	14535834	.	A	C	3	3	6	0	0	6	0	0
7	14539470	.	T	C	3	3	6	0	0	6	0	0
7	14542854	.	C	T	6	5	11	0	0	11	0	0
7	14542893	.	C	T	7	6	13	0	1	14	0	0
7	14543002	.	T	C	8	6	14	0	0	14	0	0
7	14543031	.	G	A	6	4	10	0	3	13	0	0
7	14543391	.	A	G	1	6	7	0	1	8	0	0
7	14543454	.	G	T	4	8	12	0	0	12	0	0
7	14543463	.	T	C	3	7	10	0	1	11	0	0
7	14543742	.	C	T	1	4	5	0	0	5	0	0
7	14632554	.	A	C	3	3	6	0	0	6	0	0
7	14774086	.	C	A	0	3	3	0	0	3	0	0
7	14789964	.	G	A	0	5	5	0	2	7	0	0
7	14860521	.	C	T	13	8	21	0	0	21	0	0
7	14860524	.	A	C	13	7	20	0	1	21	0	0
7	14900869	.	G	A	4	0	4	0	0	4	0	0
7	14905516	.	G	C	4	4	8	0	0	8	0	0
7	14938134	.	C	T	7	11	18	0	1	19	0	0
7	14938404	.	C	T	2	5	7	0	0	7	0	0
7	15087435	.	G	C	3	2	5	0	0	5	0	0
7	15087643	.	G	A	2	3	5	0	0	5	0	0
7	15088130	.	A	G	1	3	4	0	0	4	0	0
7	15088906	.	T	C	2	2	4	0	0	4	0	0
7	15374420	.	G	A	2	2	4	0	0	4	0	0
7	15603667	.	A	T	0	1	1	0	1	2	0	0
7	15604146	.	G	A	0	2	2	0	2	4	0	0
7	15604167	.	A	G	0	4	4	0	1	5	0	0
7	15605057	.	A	G	2	0	2	0	2	4	0	0
7	15605058	.	G	T	2	2	4	0	0	4	0	0
7	15605844	.	C	T	3	3	6	0	2	8	0	0
7	15605846	.	T	C	3	4	7	0	1	8	0	0
7	15605950	.	T	C	5	3	8	0	0	8	0	0
7	15605968	.	T	A	4	3	7	0	0	7	0	0
7	15606058	.	C	T	1	2	3	0	0	3	0	0
7	15606059	.	A	G	0	2	2	0	1	3	0	0
7	15607650	.	C	T	8	5	13	0	1	14	0	0
7	15607757	.	G	A	0	7	7	0	2	9	0	0
7	15608108	.	A	C	1	6	7	0	0	7	0	0
7	15608113	.	T	C	2	5	7	0	0	7	0	0
7	15608520	.	G	A	5	2	7	0	0	7	0	0
7	15608620	.	G	A	6	3	9	0	0	9	0	0
7	15609137	.	A	C	7	7	14	0	0	14	0	0
7	15609156	.	G	A	5	2	7	0	2	9	0	0
7	15609387	.	T	A	5	5	10	0	0	10	0	0
7	15609469	.	C	T	7	6	13	0	4	17	0	0
7	15609520	.	G	A	2	3	5	0	2	7	0	0
7	15609826	.	C	T	8	11	19	0	1	20	0	0
7	15609961	.	C	T	9	16	25	0	2	27	0	0
7	15623727	.	A	C	1	0	1	0	0	1	0	0
7	15634379	.	A	G	2	2	4	0	0	4	0	0
7	15634391	.	G	A	0	2	2	0	2	4	0	0
7	15653514	.	G	A	5	5	10	0	0	10	0	0
7	15653537	.	G	A	4	3	7	0	1	8	0	0
7	15819692	.	C	T	2	0	2	0	0	2	0	0
7	15825888	.	T	C	5	0	5	0	2	7	0	0
7	15825932	.	T	C	6	0	6	0	5	11	0	0
7	15830007	.	T	C	5	3	8	0	0	8	0	0
7	15830026	.	A	G	2	3	5	0	0	5	0	0
7	15882074	.	C	A	0	2	2	0	0	2	0	0
7	15896959	.	G	C	2	3	5	0	0	5	0	0
7	15896998	.	G	A	0	5	5	0	1	6	0	0
7	15897024	.	G	A	1	4	5	0	1	6	0	0
7	15897076	.	G	A	2	2	4	0	1	5	0	0
7	15897671	.	G	T	1	4	5	0	0	5	0	0
7	15897676	.	T	C	1	3	4	0	1	5	0	0
7	15897755	.	A	G	3	4	7	0	1	8	0	0
7	15898112	.	G	T	1	2	3	0	0	3	0	0
7	15898280	.	T	C	3	2	5	0	0	5	0	0
7	15898400	.	T	C	6	3	9	0	0	9	0	0
7	15898712	.	C	A	7	4	11	0	0	11	0	0
7	15899286	.	A	G	4	3	7	0	3	10	0	0
7	15899468	.	A	T	4	5	9	0	0	9	0	0
7	15899532	.	T	A	5	11	16	0	1	17	0	0
7	15900102	.	G	A	2	2	4	0	0	4	0	0
7	16232308	.	G	A	1	3	4	0	0	4	0	0
7	16348898	.	A	G	13	8	21	0	0	21	0	0
7	16388262	.	C	T	1	2	3	0	0	3	0	0
7	16388307	.	C	T	8	9	17	0	0	17	0	0
7	16388310	.	G	C	8	9	17	0	0	17	0	0
7	16388358	.	T	C	2	9	11	0	0	11	0	0
7	16456854	.	C	T	4	4	8	0	1	9	0	0
7	16460093	.	C	T	7	9	16	0	5	21	0	0
7	16460252	.	G	A	9	9	18	0	2	20	0	0
7	16461100	.	G	T	1	4	5	0	1	6	0	0
7	16514265	.	C	T	0	1	1	0	0	1	0	0
7	16545638	.	C	T	0	6	6	0	1	7	0	0
7	16546048	.	T	A	4	2	6	0	0	6	0	0
7	16546052	.	G	C	1	2	3	0	3	6	0	0
7	16963155	.	A	G	1	2	3	0	0	3	0	0
7	16963444	.	C	A	5	2	7	0	0	7	0	0
7	16994582	.	G	A	0	1	1	0	0	1	0	0
7	16994639	.	G	A	0	1	1	0	0	1	0	0
7	17004383	.	C	T	1	0	1	0	0	1	0	0
7	17008188	.	G	T	0	2	2	0	0	2	0	0
7	17008217	.	C	A	1	2	3	0	0	3	0	0
7	17008230	.	T	C	2	3	5	0	1	6	0	0
7	17009538	.	C	T	1	5	6	0	1	7	0	0
7	17010015	.	T	C	2	3	5	0	2	7	0	0
7	17011427	.	T	C	2	2	4	0	0	4	0	0
7	17012233	.	T	G	2	2	4	0	0	4	0	0
7	17012299	.	T	A	2	2	4	0	0	4	0	0
7	17012967	.	C	A	1	6	7	0	0	7	0	0
7	17013000	.	G	A	0	4	4	0	3	7	0	0
7	17013825	.	T	C	1	3	4	0	0	4	0	0
7	17013827	.	T	A	1	3	4	0	0	4	0	0
7	17013899	.	C	T	3	4	7	0	0	7	0	0
7	17014017	.	G	C	3	6	9	0	0	9	0	0
7	17014219	.	A	G	3	5	8	0	0	8	0	0
7	17014301	.	T	C	5	4	9	0	0	9	0	0
7	17014338	.	T	G	1	0	1	0	4	5	0	0
7	17014453	.	A	C	5	5	10	0	0	10	0	0
7	17014531	.	C	A	8	8	16	0	0	16	0	0
7	17014548	.	G	T	6	9	15	0	1	16	0	0
7	17014621	.	T	A	11	17	28	0	1	29	0	0
7	17014653	.	C	T	9	12	21	0	1	22	0	0
7	17014748	.	T	C	9	4	13	0	1	14	0	0
7	17014809	.	A	C	7	5	12	0	0	12	0	0
7	17014815	.	T	C	8	6	14	0	0	14	0	0
7	17096358	.	A	C	4	3	7	0	1	8	0	0
7	17096366	.	G	A	6	3	9	0	0	9	0	0
7	17097176	.	G	A	2	3	5	0	0	5	0	0
7	17097191	.	C	T	5	4	9	0	0	9	0	0
7	17100076	.	T	C	9	4	13	0	0	13	0	0
7	17102964	.	G	T	7	3	10	0	1	11	0	0
7	17103021	.	A	G	1	7	8	0	1	9	0	0
7	17103943	.	T	G	1	1	2	0	3	5	0	0
7	17104445	.	C	A	1	3	4	0	0	4	0	0
7	17106599	.	C	T	1	1	2	0	0	2	0	0
7	17246018	.	G	A	0	1	1	0	1	2	0	0
7	17246036	.	C	T	2	2	4	0	0	4	0	0
7	17248579	.	T	C	1	8	9	0	0	9	0	0
7	17248656	.	G	A	10	4	14	0	1	15	0	0
7	17248865	.	T	A	2	3	5	0	1	6	0	0
7	17249293	.	A	T	2	4	6	0	0	6	0	0
7	17249642	.	C	T	1	7	8	0	0	8	0	0
7	17249829	.	A	T	1	7	8	0	0	8	0	0
7	17249885	.	G	A	1	3	4	0	0	4	0	0
7	17249945	.	A	C	2	9	11	0	1	12	0	0
7	17250069	.	C	T	2	4	6	0	1	7	0	0
7	17250073	.	C	A	4	2	6	0	0	6	0	0
7	17250191	.	C	T	4	18	22	0	0	22	0	0
7	17250249	.	G	A	0	11	11	0	2	13	0	0
7	17251098	.	C	A	25	13	38	0	0	38	0	0
7	17251222	.	G	A	0	22	22	0	21	43	0	0
7	17251234	.	A	G	20	22	42	0	0	42	0	0
7	17663289	.	T	C	2	2	4	0	0	4	0	0
7	17692797	.	G	A	1	7	8	0	0	8	0	0
7	17695039	.	C	T	1	3	4	0	0	4	0	0
7	17695051	.	A	G	3	1	4	0	0	4	0	0
7	17695425	.	A	G	0	1	1	0	0	1	0	0
7	17708783	.	C	T	1	3	4	0	1	5	0	0
7	17708811	.	G	A	1	4	5	0	0	5	0	0
7	17754299	.	G	A	10	13	23	1	1	25	0	0
7	17754811	.	T	A	1	12	13	0	1	15	1	0
7	17755699	.	C	T	0	3	3	0	0	3	0	0
7	17756705	.	A	G	33	15	48	0	4	52	0	0
7	17757019	.	A	G	33	17	50	0	9	59	0	0
7	17757024	.	C	T	20	38	58	0	2	60	0	0
7	17757078	.	A	G	28	32	60	0	2	62	0	0
7	17757243	.	T	G	37	12	49	0	4	53	0	0
7	17757371	.	T	C	26	36	62	0	3	65	0	0
7	17757408	.	G	A	45	25	70	0	0	70	0	0
7	17761063	.	A	C	4	6	10	0	0	10	0	0
7	17761117	.	T	G	3	2	5	0	0	5	0	0
7	17761446	.	A	T	1	4	5	0	0	5	0	0
7	17761795	.	G	T	2	2	4	0	0	4	0	0
7	17762433	.	C	T	5	2	7	0	2	9	0	0
7	17762455	.	C	G	0	5	5	0	6	11	0	0
7	17762480	.	G	C	3	7	10	0	0	10	0	0
7	17762919	.	G	A	2	3	5	0	0	5	0	0
7	17770871	.	G	A	1	3	4	0	0	4	0	0
7	17800956	.	A	G	2	4	6	0	0	6	0	0
7	17801339	.	C	A	4	2	6	0	0	6	0	0
7	17801385	.	A	G	2	3	5	0	0	5	0	0
7	17801398	.	C	T	3	3	6	0	0	6	0	0
7	17801896	.	T	G	3	1	4	0	0	4	0	0
7	17801900	.	A	G	2	0	2	0	2	4	0	0
7	17801938	.	A	G	0	0	0	0	5	5	0	0
7	17802497	.	C	A	4	2	6	0	0	6	0	0
7	17803056	.	T	G	1	3	4	0	0	4	0	0
7	17805706	.	C	G	9	7	16	0	0	16	0	0
7	17809860	.	C	T	2	2	4	0	0	4	0	0
7	17810581	.	C	T	4	4	8	0	0	8	0	0
7	17810611	.	G	A	2	4	6	0	0	6	0	0
7	17810624	.	C	T	1	4	5	0	0	5	0	0
7	17812892	.	T	A	6	6	12	0	0	12	0	0
7	17813987	.	T	C	0	0	0	0	1	1	0	0
7	17933314	.	C	G	1	5	6	0	0	6	0	0
7	17933323	.	C	T	2	4	6	0	1	7	0	0
7	17933350	.	G	A	0	4	4	0	11	15	0	0
7	17933413	.	T	A	9	4	13	0	0	13	0	0
7	17936753	.	C	G	6	19	25	0	1	26	0	0
7	17936795	.	G	A	0	10	10	0	5	15	0	0
7	17938069	.	C	A	6	4	10	0	2	12	0	0
7	17941936	.	C	T	5	12	17	0	0	17	0	0
7	17942370	.	G	A	5	11	16	0	1	17	0	0
7	17942451	.	A	C	2	5	7	0	0	7	0	0
7	17942482	.	A	G	1	5	6	0	0	6	0	0
7	17942883	.	T	G	12	11	23	0	0	23	0	0
7	17943078	.	A	G	11	10	21	0	2	23	0	0
7	17943133	.	C	T	15	6	21	0	1	22	0	0
7	17943170	.	G	A	1	14	15	0	19	34	0	0
7	17943376	.	C	G	18	13	31	0	0	31	0	0
7	17943509	.	A	G	19	0	19	0	18	37	0	0
7	17943851	.	G	C	3	3	6	0	0	6	0	0
7	17957770	.	C	A	4	1	5	0	0	5	0	0
7	17963800	.	C	G	1	3	4	0	0	4	0	0
7	17963815	.	C	T	2	4	6	0	0	6	0	0
7	17965749	.	G	A	4	4	8	0	0	8	0	0
7	17969145	.	C	T	6	10	16	0	0	16	0	0
7	17969461	.	T	A	4	2	6	0	0	6	0	0
7	17969720	.	C	T	4	4	8	1	0	9	0	0
7	17969778	.	A	G	6	2	8	0	0	8	0	0
7	17969792	.	A	G	3	5	8	0	0	8	0	0
7	17969851	.	A	G	4	2	6	0	0	6	0	0
7	17969883	.	G	C	1	3	4	0	2	6	0	0
7	17970016	.	C	T	2	7	9	0	1	10	0	0
7	17970301	.	A	G	1	6	7	0	0	7	0	0
7	17970337	.	A	G	12	0	12	0	0	12	0	0
7	17970338	.	C	T	12	0	12	0	0	12	0	0
7	17970654	.	G	A	8	5	13	0	0	13	0	0
7	17970790	.	A	G	2	2	4	0	0	4	0	0
7	18070998	.	G	A	2	1	3	0	0	3	0	0
7	18071019	.	G	T	0	2	2	0	6	8	0	0
7	18072762	.	C	A	1	3	4	0	0	4	0	0
7	18072797	.	T	G	4	3	7	0	0	7	0	0
7	18072800	.	C	T	4	4	8	0	0	8	0	0
7	18072856	.	G	A	2	5	7	0	0	7	0	0
7	18114316	.	G	A	5	25	30	0	34	64	0	0
7	18114495	.	C	T	17	23	40	0	6	46	0	0
7	18114518	.	A	T	14	12	26	0	14	40	0	0
7	18115220	.	T	A	18	30	48	0	1	49	0	0
7	18115261	.	G	T	19	22	41	0	1	42	0	0
7	18115302	.	G	A	0	21	21	0	12	33	0	0
7	18115470	.	C	T	25	23	48	0	0	48	0	0
7	18115584	.	T	G	10	17	27	1	1	29	0	0
7	18115721	.	G	A	0	32	32	0	16	48	0	0
7	18116037	.	C	T	11	15	26	0	0	26	0	0
7	18116204	.	G	A	28	28	56	0	2	58	0	0
7	18122445	.	C	G	5	8	13	0	1	14	0	0
7	18122541	.	G	C	17	0	17	0	30	47	0	0
7	18124218	.	C	T	5	8	13	0	0	13	0	0
7	18124314	.	C	T	11	9	20	0	2	22	0	0
7	18124329	.	T	A	12	9	21	0	0	21	0	0
7	18137325	.	C	T	0	12	12	0	16	28	0	0
7	18146699	.	T	G	6	5	11	0	0	11	0	0
7	18168253	.	T	A	16	13	29	0	2	31	0	0
7	18365387	.	A	G	1	2	3	0	0	3	0	0
7	18365393	.	C	T	1	1	2	0	1	3	0	0
7	18366192	.	T	C	4	2	6	0	0	6	0	0
7	18366718	.	C	T	3	2	5	0	0	5	0	0
7	18366865	.	T	A	1	2	3	0	0	3	0	0
7	18366932	.	T	C	3	4	7	0	0	7	0	0
7	18366936	.	A	T	3	4	7	0	0	7	0	0
7	18367052	.	C	T	4	3	7	0	0	7	0	0
7	18367075	.	A	C	4	3	7	0	0	7	0	0
7	18367165	.	A	T	1	2	3	0	0	3	0	0
7	18412706	.	T	C	1	0	1	0	2	3	0	0
7	18412779	.	A	G	3	6	9	0	0	9	0	0
7	18413054	.	G	T	5	4	9	0	0	9	0	0
7	18413086	.	G	T	4	5	9	0	0	9	0	0
7	18413348	.	C	G	2	2	4	0	0	4	0	0
7	18413402	.	G	A	1	1	2	0	0	2	0	0
7	18413585	.	A	C	3	7	10	0	0	10	0	0
7	18413642	.	A	G	2	3	5	0	0	5	0	0
7	18413745	.	G	A	0	2	2	0	0	2	0	0
7	18413798	.	G	A	1	1	2	0	1	3	0	0
7	18414124	.	C	T	4	3	7	0	0	7	0	0
7	18414158	.	A	G	1	3	4	0	0	4	0	0
7	18415653	.	G	A	1	2	3	0	0	3	0	0
7	18416136	.	G	A	3	3	6	0	1	7	0	0
7	18416611	.	G	C	0	0	0	0	3	3	0	0
7	18462733	.	G	A	6	6	12	0	0	12	0	0
7	18463132	.	T	A	5	4	9	0	0	9	0	0
7	18463259	.	T	C	8	3	11	0	1	12	0	0
7	18463488	.	A	T	8	3	11	0	0	11	0	0
7	18464919	.	C	T	5	6	11	0	1	12	0	0
7	18465000	.	G	A	10	8	18	0	0	18	0	0
7	18465096	.	A	G	10	11	21	0	0	21	0	0
7	18465435	.	T	G	1	3	4	0	0	4	0	0
7	18470573	.	C	A	5	8	13	0	0	13	0	0
7	18470813	.	C	A	6	4	10	0	0	10	0	0
7	18474945	.	G	A	4	2	6	0	0	6	0	0
7	18474994	.	C	T	5	6	11	0	0	11	0	0
7	18475150	.	C	G	2	3	5	0	0	5	0	0
7	18482163	.	G	A	1	3	4	0	0	4	0	0
7	18484268	.	C	T	3	0	3	0	0	3	0	0
7	18558504	.	C	T	14	8	22	0	0	22	0	0
7	18558586	.	T	C	4	0	4	0	3	7	0	0
7	18558806	.	A	T	18	12	30	0	1	31	0	0
7	18558871	.	G	A	12	8	20	0	0	20	0	0
7	18558906	.	T	G	16	6	22	0	0	23	1	0
7	18559197	.	G	T	5	10	15	0	0	15	0	0
7	18559212	.	C	A	5	13	18	0	2	20	0	0
7	18559258	.	A	G	9	11	20	0	2	22	0	0
7	18559402	.	G	T	4	11	15	0	0	15	0	0
7	18559548	.	C	T	4	6	10	0	0	10	0	0
7	18559576	.	A	G	11	4	15	0	0	15	0	0
7	18560013	.	C	A	9	9	18	0	0	18	0	0
7	18560047	.	G	A	6	6	12	0	1	13	0	0
7	18560397	.	C	T	0	4	4	0	3	7	0	0
7	18560474	.	C	T	0	5	5	0	7	12	0	0
7	18560478	.	T	A	4	6	10	0	1	11	0	0
7	18560952	.	C	T	0	4	4	0	6	10	0	0
7	18564318	.	G	A	1	1	2	0	0	2	0	0
7	18594557	.	T	C	4	0	4	0	7	11	0	0
7	18598610	.	C	T	2	4	6	0	0	6	0	0
7	18607928	.	A	T	3	3	6	0	1	7	0	0
7	18607932	.	A	G	3	3	6	0	1	7	0	0
7	18608190	.	A	G	1	2	3	0	0	3	0	0
7	18618113	.	T	A	4	7	11	0	2	13	0	0
7	18618608	.	T	A	3	2	5	0	1	6	0	0
7	18618776	.	T	C	12	13	25	0	1	26	0	0
7	18618859	.	A	G	11	4	15	0	1	16	0	0
7	18618860	.	T	C	4	0	4	0	12	16	0	0
7	18618927	.	T	C	15	10	25	0	0	25	0	0
7	18619426	.	C	G	7	4	11	0	0	11	0	0
7	18619661	.	G	A	8	6	14	0	0	14	0	0
7	18619956	.	T	A	3	3	6	0	0	6	0	0
7	18619990	.	C	T	4	3	7	0	1	8	0	0
7	18620027	.	A	T	5	4	9	0	1	10	0	0
7	18620049	.	A	C	8	3	11	0	1	12	0	0
7	18620223	.	C	T	0	6	6	0	9	15	0	0
7	18620273	.	T	C	4	9	13	0	0	13	0	0
7	18645360	.	G	A	0	1	1	0	0	1	0	0
7	18655772	.	A	C	1	2	3	0	0	3	0	0
7	18655798	.	T	G	1	3	4	0	0	4	0	0
7	18655807	.	C	T	3	2	5	0	0	5	0	0
7	18655921	.	G	A	3	4	7	0	0	7	0	0
7	18655949	.	T	G	2	4	6	0	0	6	0	0
7	18656025	.	G	A	2	5	7	0	0	7	0	0
7	18705665	.	G	A	3	4	7	0	0	7	0	0
7	18705728	.	G	A	0	0	0	0	1	1	0	0
7	18711374	.	G	C	6	4	10	0	0	10	0	0
7	18711378	.	G	C	6	4	10	0	0	10	0	0
7	18780119	.	A	G	3	2	5	0	0	5	0	0
7	18780196	.	A	G	7	5	12	0	2	14	0	0
7	18810675	.	A	G	3	2	5	0	0	5	0	0
7	18810692	.	T	C	5	4	9	0	0	9	0	0
7	18810710	.	C	T	5	4	9	0	1	10	0	0
7	18810768	.	C	A	1	6	7	0	3	10	0	0
7	18810971	.	C	T	0	3	3	0	5	8	0	0
7	18810990	.	C	A	4	3	7	0	0	7	0	0
7	18811128	.	A	G	6	4	10	0	0	10	0	0
7	18976568	.	T	C	4	2	6	0	0	6	0	0
7	18980857	.	T	C	1	2	3	0	0	3	0	0
7	18983123	.	G	A	0	2	2	0	2	4	0	0
7	18983230	.	G	A	1	2	3	0	4	7	0	0
7	19055605	.	C	T	13	11	24	0	1	25	0	0
7	19065861	.	A	G	7	2	9	0	1	10	0	0
7	19070994	.	C	T	2	20	22	0	18	40	0	0
7	19071420	.	T	C	13	0	13	0	13	26	0	0
7	19071617	.	T	C	15	7	22	0	1	23	0	0
7	19071639	.	C	A	11	11	22	0	2	24	0	0
7	19073202	.	T	C	6	0	6	0	3	9	0	0
7	19073481	.	T	C	19	6	25	0	1	26	0	0
7	19073495	.	G	A	15	6	21	0	1	22	0	0
7	19073563	.	A	T	16	5	21	0	0	21	0	0
7	19073576	.	T	A	16	6	22	0	1	23	0	0
7	19073788	.	T	C	3	15	18	0	0	18	0	0
7	19073818	.	T	C	0	7	7	0	3	10	0	0
7	19073833	.	G	A	5	4	9	0	0	9	0	0
7	19073918	.	G	A	8	4	12	0	0	12	0	0
7	19073984	.	G	A	1	2	3	0	0	3	0	0
7	19073985	.	C	T	0	2	2	0	1	3	0	0
7	19074041	.	G	A	6	5	11	0	0	12	1	0
7	19074056	.	T	C	6	7	13	0	2	15	0	0
7	19074173	.	C	T	12	13	25	0	3	28	0	0
7	19074194	.	A	T	10	15	25	0	1	26	0	0
7	19074270	.	G	A	9	10	19	0	0	19	0	0
7	19074363	.	T	C	3	9	12	0	0	12	0	0
7	19075025	.	C	T	0	6	6	0	7	13	0	0
7	19075058	.	T	C	6	0	6	0	6	12	0	0
7	19075591	.	T	C	5	5	10	0	0	10	0	0
7	19075605	.	A	C	4	5	9	0	0	9	0	0
7	19075760	.	A	G	2	2	4	0	0	4	0	0
7	19076154	.	A	G	4	3	7	0	0	7	0	0
7	19076354	.	C	G	6	4	10	0	0	10	0	0
7	19076536	.	A	G	4	2	6	0	1	7	0	0
7	19076550	.	G	A	4	2	6	0	0	6	0	0
7	19077092	.	G	A	4	4	8	0	0	8	0	0
7	19095988	.	C	A	0	2	2	0	3	5	0	0
7	19101929	.	C	T	0	1	1	0	0	1	0	0
7	19179977	.	C	T	0	2	2	0	4	6	0	0
7	19180024	.	T	C	6	0	6	0	3	9	0	0
7	19180029	.	A	G	6	3	9	0	0	9	0	0
7	19180589	.	C	T	5	4	9	0	0	9	0	0
7	19397449	.	T	C	2	3	5	0	0	5	0	0
7	19753008	.	C	A	1	1	2	0	1	3	0	0
7	19759079	.	G	T	1	2	3	0	0	3	0	0
7	19759194	.	C	A	3	3	6	0	0	6	0	0
7	19759209	.	G	A	0	3	3	0	4	7	0	0
7	19759263	.	T	A	6	8	14	0	1	15	0	0
7	19759296	.	C	T	6	10	16	0	1	17	0	0
7	19759299	.	A	T	7	10	17	0	0	17	0	0
7	19759550	.	C	T	8	8	16	0	0	16	0	0
7	19759895	.	C	T	8	6	14	0	1	15	0	0
7	19759968	.	A	T	1	6	7	0	0	7	0	0
7	19864504	.	G	A	0	0	0	0	1	1	0	0
7	19891283	.	A	G	2	2	4	0	0	4	0	0
7	19892265	.	C	T	2	4	6	0	0	6	0	0
7	19892592	.	A	G	4	0	4	0	4	8	0	0
7	19892880	.	G	A	0	2	2	0	5	7	0	0
7	19893573	.	T	A	3	6	9	0	1	10	0	0
7	19893705	.	A	T	5	4	9	0	0	9	0	0
7	19894099	.	A	G	3	0	3	0	4	7	0	0
7	19895088	.	G	A	0	4	4	0	11	15	0	0
7	19895139	.	G	C	4	3	7	0	0	7	0	0
7	19895259	.	A	C	0	4	4	0	0	4	0	0
7	19895268	.	G	A	2	2	4	0	0	4	0	0
7	19895683	.	C	T	3	6	9	0	0	9	0	0
7	19896060	.	A	G	5	3	8	0	0	8	0	0
7	19896400	.	A	C	9	10	19	0	3	22	0	0
7	19896628	.	G	A	8	3	11	0	0	11	0	0
7	19896642	.	G	T	7	3	10	0	0	10	0	0
7	19897309	.	C	T	9	7	16	0	0	16	0	0
7	19897599	.	G	A	3	2	5	0	0	5	0	0
7	19897959	.	T	C	9	5	14	0	1	15	0	0
7	19899331	.	A	G	18	0	18	0	7	25	0	0
7	19910307	.	G	A	1	2	3	0	0	3	0	0
7	19910308	.	A	G	1	2	3	0	0	3	0	0
7	19910438	.	A	T	4	3	7	0	1	8	0	0
7	19965281	.	G	A	4	6	10	0	0	10	0	0
7	19966252	.	G	A	2	4	6	0	1	7	0	0
7	19966273	.	T	G	4	4	8	0	0	8	0	0
7	19978616	.	G	A	2	2	4	0	0	4	0	0
7	19978847	.	G	A	6	6	12	0	0	12	0	0
7	19978875	.	T	A	5	5	10	0	0	10	0	0
7	19979133	.	C	T	3	5	8	0	1	9	0	0
7	19979200	.	A	G	4	6	10	0	1	11	0	0
7	19979561	.	C	T	0	3	3	0	3	6	0	0
7	19979575	.	G	T	6	4	10	0	0	10	0	0
7	19979669	.	G	A	5	3	8	0	0	8	0	0
7	19979759	.	G	T	3	2	5	0	0	5	0	0
7	19979876	.	A	C	5	1	6	0	3	9	0	0
7	19979943	.	A	T	5	3	8	0	0	8	0	0
7	19979968	.	C	A	0	2	2	0	6	8	0	0
7	19988581	.	G	A	4	6	10	0	0	10	0	0
7	19991783	.	G	T	1	0	1	0	0	1	0	0
7	19995011	.	T	C	3	2	5	0	1	6	0	0
7	20027043	.	T	C	0	2	2	0	0	2	0	0
7	20027044	.	T	C	0	2	2	0	0	2	0	0
7	20027495	.	G	A	4	4	8	0	1	9	0	0
7	20027595	.	A	T	3	4	7	0	0	7	0	0
7	20027717	.	G	A	5	4	9	0	0	9	0	0
7	20046096	.	C	T	1	2	3	0	0	3	0	0
7	20052095	.	G	A	1	2	3	0	0	3	0	0
7	20118228	.	C	G	3	7	10	0	0	10	0	0
7	20118330	.	T	C	3	1	4	0	0	4	0	0
7	20141697	.	T	C	20	17	37	0	1	38	0	0
7	20141916	.	T	C	7	10	17	0	1	18	0	0
7	20142253	.	A	T	2	2	4	0	0	4	0	0
7	20142360	.	A	G	3	3	6	0	0	6	0	0
7	20142361	.	A	T	3	3	6	0	0	6	0	0
7	20142497	.	T	A	2	6	8	0	1	9	0	0
7	20142523	.	T	C	1	3	4	0	0	4	0	0
7	20176444	.	A	T	3	5	8	0	0	8	0	0
7	20222385	.	A	G	3	4	7	0	0	7	0	0
7	20222861	.	C	G	1	3	4	0	0	4	0	0
7	20222949	.	A	C	4	2	6	0	0	6	0	0
7	20222993	.	A	T	3	7	10	0	0	10	0	0
7	20223074	.	G	A	4	4	8	0	0	8	0	0
7	20223079	.	A	G	5	4	9	0	0	9	0	0
7	20223110	.	G	A	5	3	8	0	0	8	0	0
7	20223384	.	A	C	5	4	9	0	1	10	0	0
7	20223385	.	C	T	5	5	10	0	0	10	0	0
7	20223478	.	T	A	6	3	9	0	1	10	0	0
7	20223568	.	C	T	7	7	14	0	1	15	0	0
7	20223632	.	C	T	1	8	9	0	0	9	0	0
7	20223880	.	G	A	0	2	2	0	4	6	0	0
7	20293332	.	G	A	0	2	2	0	2	4	0	0
7	20294039	.	T	C	3	2	5	0	0	5	0	0
7	20294168	.	A	C	1	2	3	0	0	3	0	0
7	20295116	.	T	C	1	2	3	0	1	4	0	0
7	20298501	.	G	A	1	2	3	0	1	4	0	0
7	20298563	.	A	T	1	0	1	0	0	1	0	0
7	20298577	.	A	G	1	0	1	0	0	1	0	0
7	20298598	.	A	T	1	0	1	0	0	1	0	0
7	20298670	.	T	C	2	3	5	0	0	5	0	0
7	20298709	.	A	C	1	5	6	0	0	6	0	0
7	20298789	.	C	G	2	2	4	0	0	4	0	0
7	20298851	.	C	G	1	2	3	0	0	3	0	0
7	20302952	.	A	G	4	2	6	0	1	7	0	0
7	20305694	.	C	T	3	1	4	0	1	5	0	0
7	20305697	.	C	T	3	2	5	0	0	5	0	0
7	20310893	.	T	C	4	2	6	0	1	7	0	0
7	20310929	.	T	C	4	5	9	0	1	10	0	0
7	20315913	.	G	A	2	3	5	0	0	5	0	0
7	20325995	.	C	T	4	4	8	0	0	8	0	0
7	20332513	.	T	C	11	13	24	0	0	24	0	0
7	20332775	.	A	T	14	4	18	0	1	19	0	0
7	20332784	.	G	A	16	6	22	0	0	22	0	0
7	20332959	.	G	A	21	9	30	0	4	34	0	0
7	20332963	.	G	A	20	11	31	0	1	32	0	0
7	20333061	.	A	G	7	0	7	0	6	13	0	0
7	20333076	.	C	A	4	4	8	0	2	10	0	0
7	20333120	.	A	C	5	5	10	0	1	11	0	0
7	20333276	.	T	G	5	6	11	0	0	11	0	0
7	20334603	.	T	C	6	7	13	0	0	13	0	0
7	20334891	.	T	G	4	3	7	0	2	9	0	0
7	20335035	.	C	T	1	6	7	0	1	8	0	0
7	20335283	.	T	C	1	2	3	0	1	4	0	0
7	20529043	.	A	C	1	2	3	0	0	3	0	0
7	20529155	.	A	G	3	4	7	0	0	7	0	0
7	20529578	.	A	C	4	1	5	0	0	5	0	0
7	20529725	.	C	T	14	10	24	0	1	25	0	0
7	20529728	.	G	A	13	11	24	0	1	25	0	0
7	20529760	.	C	T	12	10	22	0	3	25	0	0
7	20529773	.	T	C	10	11	21	0	0	21	0	0
7	20530284	.	A	T	6	7	13	0	1	14	0	0
7	20530314	.	G	A	3	6	9	0	2	11	0	0
7	20530338	.	C	T	4	6	10	0	0	10	0	0
7	20530373	.	T	A	3	7	10	0	1	11	0	0
7	20542251	.	G	A	7	5	12	0	1	13	0	0
7	20542262	.	C	A	6	3	9	0	0	9	0	0
7	20587681	.	G	T	9	8	17	0	0	17	0	0
7	20587685	.	T	G	8	8	16	0	1	17	0	0
7	20587812	.	T	C	2	3	5	0	0	5	0	0
7	20588280	.	C	G	0	1	1	0	0	1	0	0
7	20593682	.	G	A	0	3	3	0	0	3	0	0
7	20593809	.	G	A	4	6	10	0	0	10	0	0
7	20597033	.	G	A	5	6	11	0	0	11	0	0
7	20597132	.	C	T	7	4	11	0	0	11	0	0
7	20600211	.	T	A	1	1	2	0	0	2	0	0
7	20600398	.	C	T	12	4	16	0	0	16	0	0
7	20600447	.	A	G	3	0	3	0	11	14	0	0
7	20601052	.	G	A	12	7	19	0	1	20	0	0
7	20601072	.	T	C	11	6	17	0	0	17	0	0
7	20601192	.	C	T	6	6	12	0	0	12	0	0
7	20601250	.	A	G	3	6	9	0	2	11	0	0
7	20601325	.	A	G	4	13	17	0	0	17	0	0
7	20601410	.	T	A	5	9	14	0	2	16	0	0
7	20601524	.	G	A	5	5	10	0	0	10	0	0
7	20601539	.	T	C	7	7	14	0	0	14	0	0
7	20601578	.	T	C	6	9	15	0	0	15	0	0
7	20601583	.	T	C	6	8	14	0	0	14	0	0
7	20601713	.	A	T	4	8	12	0	0	12	0	0
7	20601835	.	G	T	6	7	13	0	1	14	0	0
7	20601907	.	A	T	7	8	15	0	0	15	0	0
7	20601925	.	T	C	6	8	14	0	0	14	0	0
7	20602053	.	T	C	3	2	5	0	2	7	0	0
7	20602205	.	A	G	5	2	7	0	0	7	0	0
7	20605541	.	C	T	4	4	8	0	1	9	0	0
7	20605661	.	A	G	4	5	9	0	0	9	0	0
7	20610565	.	C	A	1	0	1	0	0	1	0	0
7	20629684	.	T	C	1	4	5	0	0	5	0	0
7	20629792	.	G	A	3	5	8	0	1	9	0	0
7	20629801	.	A	G	4	7	11	0	0	11	0	0
7	20633683	.	A	C	1	2	3	0	0	3	0	0
7	20633686	.	T	A	1	2	3	0	0	3	0	0
7	20634045	.	A	G	1	0	1	0	0	1	0	0
7	20634444	.	A	T	3	6	9	0	0	9	0	0
7	20634498	.	T	A	6	14	20	0	0	20	0	0
7	20634577	.	T	G	14	15	29	0	1	30	0	0
7	20635475	.	A	G	2	19	21	0	1	22	0	0
7	20635495	.	T	A	9	11	20	0	0	20	0	0
7	20635519	.	A	G	13	7	20	0	1	21	0	0
7	20635616	.	T	C	4	10	14	0	0	14	0	0
7	20635760	.	A	G	5	7	12	0	0	12	0	0
7	20636168	.	C	A	1	5	6	0	0	6	0	0
7	20636344	.	A	G	8	14	22	0	0	22	0	0
7	20636379	.	A	T	6	17	23	0	0	23	0	0
7	20636410	.	C	T	7	16	23	0	0	23	0	0
7	20636414	.	T	G	7	15	22	0	0	22	0	0
7	20636464	.	G	A	9	16	25	0	0	25	0	0
7	20636465	.	A	G	8	16	24	0	1	25	0	0
7	20636802	.	T	G	11	21	32	0	1	33	0	0
7	20636833	.	A	G	10	21	31	0	1	32	0	0
7	20636844	.	T	A	10	22	32	0	1	33	0	0
7	20664794	.	T	C	6	3	9	0	0	9	0	0
7	20693673	.	G	T	18	14	32	0	0	32	0	0
7	20695949	.	G	T	10	7	17	0	0	17	0	0
7	20698208	.	T	A	1	2	3	0	0	3	0	0
7	20712555	.	C	T	6	6	12	0	1	13	0	0
7	20715178	.	G	A	3	3	6	0	1	7	0	0
7	20715434	.	C	T	2	2	4	0	1	5	0	0
7	20715485	.	A	G	7	6	13	0	0	13	0	0
7	20731052	.	C	T	7	5	12	0	0	12	0	0
7	20731166	.	A	G	3	5	8	0	0	8	0	0
7	20735155	.	G	A	4	1	5	0	1	6	0	0
7	20738148	.	A	G	8	7	15	0	0	15	0	0
7	20743583	.	G	A	5	6	11	0	1	12	0	0
7	20743984	.	C	T	0	0	0	0	2	2	0	0
7	20748580	.	C	T	3	2	5	0	1	6	0	0
7	20748583	.	A	G	3	3	6	0	0	6	0	0
7	20754669	.	G	A	2	1	3	0	1	4	0	0
7	20780285	.	G	A	6	3	9	0	0	9	0	0
7	20780317	.	C	T	5	2	7	0	1	8	0	0
7	20780337	.	A	C	5	2	7	0	0	7	0	0
7	20780356	.	A	G	3	7	10	0	0	10	0	0
7	20780424	.	A	T	1	5	6	0	1	7	0	0
7	20780453	.	C	A	2	6	8	0	0	8	0	0
7	20780732	.	A	C	8	4	12	0	0	12	0	0
7	20780758	.	T	C	9	3	12	0	2	14	0	0
7	20780918	.	C	T	0	3	3	0	13	16	0	0
7	20780987	.	G	A	6	11	17	0	0	17	0	0
7	20781110	.	C	T	7	7	14	0	1	15	0	0
7	20781327	.	A	G	6	7	13	0	0	13	0	0
7	20781549	.	C	G	6	7	13	0	0	13	0	0
7	20781996	.	T	G	4	2	6	0	0	6	0	0
7	20784496	.	C	T	4	3	7	0	0	7	0	0
7	20784772	.	G	A	1	0	1	0	0	1	0	0
7	20787233	.	C	T	2	2	4	0	0	4	0	0
7	20790796	.	A	G	1	1	2	0	0	2	0	0
7	20796929	.	T	C	2	2	4	0	1	5	0	0
7	20859446	.	G	C	7	5	12	0	0	12	0	0
7	20859823	.	T	A	2	2	4	0	0	4	0	0
7	20859975	.	G	A	7	11	18	0	0	18	0	0
7	20860011	.	T	C	0	3	3	0	0	3	0	0
7	20864097	.	A	G	2	1	3	0	0	3	0	0
7	20864256	.	T	C	1	2	3	0	0	3	0	0
7	20889840	.	C	A	0	2	2	0	0	2	0	0
7	20890420	.	T	C	4	3	7	0	1	8	0	0
7	20890435	.	C	T	6	3	9	0	0	9	0	0
7	20892307	.	A	T	3	2	5	0	0	5	0	0
7	20897911	.	G	A	2	0	2	0	0	2	0	0
7	20901170	.	C	T	1	1	2	0	0	2	0	0
7	20904582	.	G	A	0	1	1	0	1	2	0	0
7	20923330	.	A	G	2	3	5	0	0	5	0	0
7	20935058	.	T	C	5	5	10	0	0	10	0	0
7	20935547	.	G	A	2	2	4	0	0	4	0	0
7	20935684	.	C	T	0	1	1	0	0	1	0	0
7	20935737	.	T	A	2	2	4	0	1	5	0	0
7	20935765	.	A	G	1	1	2	0	1	3	0	0
7	20938812	.	C	T	3	5	8	0	0	8	0	0
7	20938928	.	C	T	1	2	3	0	0	3	0	0
7	20966508	.	G	T	0	1	1	0	4	5	0	0
7	21752348	.	C	A	2	2	4	0	0	4	0	0
7	21752398	.	T	C	2	2	4	0	0	4	0	0
7	21765244	.	G	A	1	3	4	0	0	4	0	0
7	21765562	.	C	A	2	1	3	0	1	4	0	0
7	21765702	.	T	A	5	2	7	0	3	10	0	0
7	21766917	.	G	A	3	6	9	0	1	10	0	0
7	21766937	.	C	A	3	4	7	0	0	7	0	0
7	21767286	.	C	A	2	2	4	0	0	4	0	0
7	21767423	.	A	G	4	5	9	0	0	9	0	0
7	21768002	.	T	C	5	3	8	0	3	11	0	0
7	21768060	.	A	G	5	2	7	0	0	7	0	0
7	21768270	.	G	A	2	5	7	0	1	8	0	0
7	21768334	.	C	A	5	2	7	0	2	9	0	0
7	21768540	.	T	A	3	4	7	0	4	11	0	0
7	21769286	.	T	G	2	3	5	0	0	5	0	0
7	21769733	.	G	A	5	3	8	0	0	8	0	0
7	21770141	.	A	G	2	2	4	0	7	11	0	0
7	21770567	.	C	T	12	7	19	0	1	20	0	0
7	21770819	.	G	T	0	3	3	0	6	9	0	0
7	21772869	.	A	T	0	1	1	0	0	1	0	0
7	21773542	.	C	T	15	9	24	0	1	25	0	0
7	21773626	.	C	T	4	6	10	0	0	10	0	0
7	21774127	.	G	A	5	12	17	0	0	17	0	0
7	21776426	.	C	T	1	6	7	0	0	7	0	0
7	21776683	.	G	A	11	11	22	0	1	23	0	0
7	21776693	.	T	C	10	8	18	0	1	19	0	0
7	21777110	.	G	A	12	9	21	0	0	21	0	0
7	21777111	.	C	T	12	9	21	0	0	21	0	0
7	21777203	.	G	T	9	5	14	0	2	16	0	0
7	21777720	.	G	A	13	16	29	0	2	31	0	0
7	21777978	.	T	G	14	17	31	0	3	34	0	0
7	21778055	.	G	A	10	4	14	0	2	16	0	0
7	21778070	.	T	C	5	5	10	0	1	11	0	0
7	21859402	.	C	T	1	4	5	0	0	5	0	0
7	21872185	.	G	T	0	1	1	0	0	1	0	0
7	21872656	.	G	A	1	2	3	0	0	3	0	0
7	21872759	.	T	A	1	2	3	0	0	3	0	0
7	21872969	.	G	C	2	2	4	0	0	4	0	0
7	21873176	.	G	A	2	2	4	0	0	4	0	0
7	21873246	.	C	G	2	4	6	0	0	6	0	0
7	21873266	.	G	A	0	3	3	0	1	4	0	0
7	21873342	.	A	C	5	5	10	0	0	10	0	0
7	21873350	.	G	A	5	4	9	0	1	10	0	0
7	21873388	.	T	A	2	3	5	0	0	5	0	0
7	21874092	.	A	G	1	0	1	0	3	4	0	0
7	21874117	.	G	A	1	2	3	0	0	3	0	0
7	21878507	.	G	A	2	1	3	0	0	3	0	0
7	21879728	.	A	G	3	3	6	0	0	6	0	0
7	21881863	.	C	T	4	1	5	0	0	5	0	0
7	21884570	.	A	C	3	0	3	0	4	7	0	0
7	21887797	.	A	T	5	1	6	0	0	6	0	0
7	21887967	.	C	T	21	22	43	0	0	43	0	0
7	21888084	.	T	A	18	23	41	0	3	44	0	0
7	21888274	.	T	A	14	19	33	0	0	33	0	0
7	21890998	.	C	T	6	8	14	0	1	15	0	0
7	21891031	.	G	A	0	3	3	0	8	11	0	0
7	21891208	.	C	T	4	6	10	0	1	11	0	0
7	21891510	.	T	G	2	4	6	0	0	6	0	0
7	21917927	.	C	A	3	2	5	0	0	5	0	0
7	21917972	.	C	G	2	2	4	0	0	4	0	0
7	21918410	.	G	A	1	4	5	0	5	10	0	0
7	21918412	.	T	A	5	4	9	0	1	10	0	0
7	21940965	.	T	G	1	12	13	0	1	14	0	0
7	21940992	.	A	G	5	14	19	0	0	19	0	0
7	21941016	.	T	G	14	13	27	0	1	29	1	0
7	21941460	.	G	A	16	8	24	0	1	25	0	0
7	21941477	.	C	A	13	13	26	0	2	29	1	0
7	21941568	.	C	T	15	11	26	0	0	27	1	0
7	21941579	.	A	C	11	13	24	0	0	24	0	0
7	21942378	.	C	T	16	13	29	0	0	29	0	0
7	21942513	.	A	T	15	11	26	0	0	26	0	0
7	21942644	.	T	A	12	11	23	0	1	24	0	0
7	21942672	.	C	T	12	13	25	0	0	25	0	0
7	21943553	.	A	G	12	16	28	0	0	28	0	0
7	21943625	.	G	A	7	9	16	0	0	16	0	0
7	21943716	.	T	G	11	8	19	0	0	19	0	0
7	21943772	.	T	C	7	15	22	0	1	23	0	0
7	21943886	.	C	A	6	4	10	0	0	10	0	0
7	21944495	.	T	C	6	10	16	0	0	16	0	0
7	21944753	.	G	A	11	7	18	0	1	19	0	0
7	21945257	.	C	T	0	11	11	0	13	24	0	0
7	21945347	.	C	T	0	12	12	0	12	24	0	0
7	21947228	.	G	A	9	5	14	0	0	14	0	0
7	21947237	.	C	T	4	7	11	0	1	13	1	0
7	21951353	.	G	A	7	4	11	0	0	11	0	0
7	21956571	.	A	G	0	0	0	0	1	1	0	0
7	22131815	.	C	T	0	0	0	0	1	1	0	0
7	22132134	.	A	G	4	2	6	0	0	6	0	0
7	22324261	.	C	T	1	3	4	0	0	4	0	0
7	22324900	.	A	T	2	3	5	0	0	5	0	0
7	22799377	.	A	C	3	1	4	0	14	18	0	0
7	23541637	.	A	G	5	0	5	0	12	17	0	0
7	23541640	.	A	G	2	0	2	0	16	18	0	0
7	23750469	.	T	C	2	0	2	0	17	19	0	0
7	23750477	.	C	T	3	14	17	0	0	17	0	0
7	23751420	.	T	C	18	5	23	0	1	24	0	0
7	23751956	.	C	A	11	4	15	0	0	15	0	0
7	23907784	.	G	T	20	20	40	0	1	41	0	0
7	23909369	.	A	C	17	18	35	0	0	35	0	0
7	23909456	.	T	G	22	17	39	0	0	39	0	0
7	23915104	.	G	A	2	17	19	0	26	45	0	0
7	23915296	.	C	T	25	32	57	0	3	60	0	0
7	23915359	.	G	A	1	33	34	0	23	57	0	0
7	23915379	.	T	A	34	24	58	0	2	60	0	0
7	23915700	.	G	T	11	16	27	0	3	30	0	0
7	23915731	.	G	T	20	20	40	0	0	40	0	0
7	23915926	.	C	T	34	27	61	0	2	63	0	0
7	23915963	.	A	G	27	1	28	0	24	52	0	0
7	23915964	.	A	T	27	25	52	0	0	52	0	0
7	23967515	.	A	C	10	0	10	0	11	22	1	0
7	23967522	.	G	A	11	10	21	0	0	21	0	0
7	23967591	.	G	A	7	18	25	0	0	25	0	0
7	23967596	.	G	A	8	12	20	0	0	20	0	0
7	23967705	.	G	A	7	5	12	0	0	12	0	0
7	23967772	.	A	G	13	13	26	0	2	28	0	0
7	23967861	.	C	T	0	22	22	0	16	38	0	0
7	23967878	.	G	A	11	25	36	0	0	36	0	0
7	23967930	.	A	G	16	19	35	0	2	37	0	0
7	23968009	.	T	C	20	0	20	0	19	39	0	0
7	23968174	.	A	C	13	10	23	0	3	26	0	0
7	23968267	.	A	C	12	8	20	0	0	20	0	0
7	23968292	.	T	G	9	9	18	0	2	20	0	0
7	23968414	.	A	C	4	3	7	0	0	7	0	0
7	23969226	.	G	A	3	7	10	0	0	10	0	0
7	23969446	.	C	T	10	8	18	0	0	18	0	0
7	23969593	.	G	A	8	5	13	0	3	16	0	0
7	23969819	.	A	G	4	4	8	0	0	8	0	0
7	23970196	.	A	G	5	10	15	0	0	15	0	0
7	23970236	.	T	A	8	8	16	0	1	17	0	0
7	23970320	.	G	T	9	18	27	0	0	27	0	0
7	23970331	.	G	A	10	15	25	0	1	26	0	0
7	23970428	.	T	C	6	8	14	0	0	14	0	0
7	23970545	.	C	A	6	5	11	0	0	11	0	0
7	23970560	.	T	A	6	3	9	0	0	9	0	0
7	23970674	.	T	A	1	3	4	0	1	5	0	0
7	23970695	.	T	C	3	9	12	0	2	14	0	0
7	23971115	.	T	C	0	4	4	0	1	5	0	0
7	23971682	.	T	A	6	4	10	0	0	10	0	0
7	23971714	.	G	C	1	2	3	0	0	3	0	0
7	23971728	.	T	A	1	1	2	0	0	2	0	0
7	23977711	.	T	C	0	3	3	0	0	3	0	0
7	23977872	.	A	G	4	2	6	0	0	6	0	0
7	23977905	.	A	C	3	3	6	0	0	6	0	0
7	24006992	.	A	T	1	3	4	0	1	5	0	0
7	24007014	.	T	C	1	4	5	0	0	5	0	0
7	24007097	.	A	G	2	4	6	0	0	6	0	0
7	24007347	.	G	A	0	3	3	0	2	5	0	0
7	24007373	.	A	G	2	3	5	0	0	5	0	0
7	24011474	.	C	A	1	3	4	0	1	5	0	0
7	24011926	.	T	C	4	10	14	0	0	14	0	0
7	24012794	.	T	C	13	8	21	0	0	21	0	0
7	24013269	.	G	A	4	9	13	0	0	13	0	0
7	24013489	.	G	A	0	5	5	0	12	17	0	0
7	24033639	.	C	G	3	2	5	0	0	5	0	0
7	24036340	.	G	A	0	1	1	0	0	1	0	0
7	24041379	.	C	A	1	2	3	0	0	3	0	0
7	24041627	.	T	C	3	0	3	0	3	6	0	0
7	24043391	.	G	A	1	1	2	0	1	3	0	0
7	24053673	.	A	G	2	6	8	0	1	9	0	0
7	24053689	.	C	T	5	2	7	0	2	9	0	0
7	24059449	.	T	A	1	3	4	0	0	4	0	0
7	24059705	.	G	A	3	3	6	0	0	6	0	0
7	24060071	.	A	C	3	4	7	0	1	8	0	0
7	24060107	.	G	T	2	4	6	0	0	6	0	0
7	24066825	.	C	T	5	2	7	0	0	7	0	0
7	24067056	.	G	T	3	3	6	0	0	6	0	0
7	24068078	.	T	G	9	7	16	0	0	16	0	0
7	24068224	.	A	T	5	7	12	0	1	13	0	0
7	24068586	.	C	T	6	6	12	0	0	12	0	0
7	24068669	.	T	G	4	6	10	0	0	10	0	0
7	24068761	.	G	T	4	3	7	0	0	7	0	0
7	24068868	.	G	A	0	4	4	0	3	7	0	0
7	24072217	.	C	T	1	2	3	0	0	3	0	0
7	24075911	.	G	A	4	4	8	0	0	8	0	0
7	24076009	.	A	T	2	2	4	0	0	4	0	0
7	24076192	.	C	T	0	6	6	0	0	6	0	0
7	24076198	.	C	T	4	4	8	0	0	8	0	0
7	24076269	.	C	T	3	7	10	0	0	10	0	0
7	24076329	.	C	T	7	7	14	0	0	14	0	0
7	24076373	.	C	T	4	5	9	0	0	9	0	0
7	24076568	.	G	A	0	8	8	0	2	10	0	0
7	24076583	.	T	A	2	8	10	0	0	10	0	0
7	24084783	.	C	T	1	1	2	0	2	4	0	0
7	24084879	.	C	T	4	4	8	0	0	8	0	0
7	24087362	.	A	T	4	5	9	0	0	9	0	0
7	24087365	.	T	C	5	4	9	0	0	9	0	0
7	24087724	.	C	A	2	2	4	0	0	4	0	0
7	24090182	.	G	A	5	7	12	0	0	12	0	0
7	24091054	.	G	A	8	8	16	0	1	17	0	0
7	24091269	.	G	A	0	5	5	0	3	8	0	0
7	24092626	.	C	T	2	2	4	0	0	4	0	0
7	24093165	.	C	G	14	22	36	0	2	38	0	0
7	24093300	.	C	T	12	14	26	1	2	29	0	0
7	24093301	.	A	C	12	15	27	1	1	29	0	0
7	24093372	.	A	G	3	1	4	0	0	4	0	0
7	24095515	.	C	G	21	16	37	0	1	38	0	0
7	24095717	.	G	A	1	12	13	0	18	31	0	0
7	24095776	.	G	A	13	13	26	0	2	28	0	0
7	24095788	.	A	G	14	12	26	0	1	27	0	0
7	24095836	.	C	T	2	11	13	1	2	16	0	0
7	24095848	.	G	A	4	15	19	1	1	21	0	0
7	24095883	.	T	A	17	10	27	0	1	28	0	0
7	24095926	.	A	C	12	14	26	0	1	27	0	0
7	24095978	.	T	A	23	14	37	0	0	37	0	0
7	24096399	.	C	A	15	13	28	0	1	29	0	0
7	24096505	.	G	A	0	11	11	0	10	21	0	0
7	24096541	.	C	T	13	5	18	0	2	20	0	0
7	24096767	.	A	C	20	13	33	0	4	37	0	0
7	24100743	.	A	C	3	0	3	0	3	6	0	0
7	24100761	.	C	T	1	2	3	0	0	3	0	0
7	24110214	.	C	G	1	3	4	0	0	4	0	0
7	24115186	.	G	A	1	0	1	0	0	1	0	0
7	24156373	.	A	G	1	2	3	0	0	3	0	0
7	24156994	.	G	A	0	2	2	0	5	7	0	0
7	24158843	.	A	G	4	0	4	0	5	9	0	0
7	24158918	.	G	A	0	2	2	0	3	5	0	0
7	24159284	.	G	A	4	1	5	0	0	5	0	0
7	24161591	.	C	A	10	7	17	0	5	22	0	0
7	24162019	.	G	A	4	3	7	0	1	8	0	0
7	24162368	.	A	T	6	14	20	0	1	21	0	0
7	24162369	.	A	C	6	15	21	0	0	21	0	0
7	24162485	.	C	T	12	9	21	0	0	21	0	0
7	24162567	.	T	C	6	11	17	0	1	18	0	0
7	24162761	.	G	T	2	7	9	0	0	9	0	0
7	24197574	.	C	A	9	7	16	0	0	16	0	0
7	24197607	.	A	T	2	3	5	0	0	5	0	0
7	24197814	.	G	A	4	3	7	0	1	8	0	0
7	24197841	.	G	A	5	2	7	0	1	8	0	0
7	24197867	.	T	A	4	2	6	0	0	6	0	0
7	24198281	.	T	C	3	3	6	0	0	6	0	0
7	24198282	.	T	C	4	2	6	0	0	6	0	0
7	24198334	.	C	T	4	6	10	0	0	10	0	0
7	24198335	.	C	T	0	6	6	0	4	10	0	0
7	24200052	.	C	T	0	3	3	0	4	7	0	0
7	24207520	.	A	C	18	19	37	0	0	37	0	0
7	24207552	.	A	G	24	0	24	0	20	44	0	0
7	24207590	.	A	T	21	26	47	0	2	50	1	0
7	24207632	.	G	C	18	22	40	0	0	40	0	0
7	24210121	.	T	C	4	2	6	0	1	7	0	0
7	24210323	.	C	A	2	15	17	0	10	27	0	0
7	24210422	.	T	C	10	15	25	0	1	26	0	0
7	24210629	.	T	A	14	17	31	0	1	32	0	0
7	24210659	.	A	G	21	17	38	0	2	40	0	0
7	24210676	.	A	G	25	20	45	0	0	45	0	0
7	24211015	.	A	T	6	14	20	0	1	21	0	0
7	24211054	.	G	A	10	9	19	0	1	20	0	0
7	24211081	.	T	A	15	16	31	0	0	31	0	0
7	24211342	.	C	T	0	19	19	0	13	32	0	0
7	24211443	.	C	T	0	4	4	0	13	17	0	0
7	24211542	.	G	T	6	2	8	0	0	8	0	0
7	24211560	.	A	T	1	5	6	0	0	6	0	0
7	24211646	.	C	T	0	4	4	0	5	9	0	0
7	24211778	.	T	A	3	2	5	0	0	5	0	0
7	24211779	.	T	A	3	2	5	0	0	5	0	0
7	24211978	.	G	A	14	7	21	0	0	21	0	0
7	24212093	.	C	G	14	8	22	0	0	22	0	0
7	24212122	.	T	C	8	9	17	0	0	17	0	0
7	24212159	.	G	C	7	1	8	0	12	20	0	0
7	24212383	.	G	A	14	17	31	0	0	31	0	0
7	24214655	.	C	T	2	3	5	0	1	6	0	0
7	24214673	.	C	A	3	2	5	0	1	6	0	0
7	24219052	.	A	G	2	1	3	0	1	4	0	0
7	24227149	.	T	G	5	5	10	0	0	10	0	0
7	24235806	.	G	A	2	2	4	0	0	4	0	0
7	24236035	.	A	G	2	2	4	0	0	4	0	0
7	24457691	.	C	A	26	30	56	0	1	57	0	0
7	24457788	.	C	A	26	8	34	0	0	36	2	0
7	24457803	.	A	C	26	5	31	0	0	31	0	0
7	24457845	.	T	C	29	6	35	0	1	36	0	0
7	24458103	.	C	A	24	16	40	0	1	41	0	0
7	24458128	.	G	C	25	20	45	0	2	47	0	0
7	24458205	.	G	A	35	22	57	0	2	59	0	0
7	24458282	.	C	T	31	18	49	0	3	52	0	0
7	24458339	.	A	G	23	18	41	0	6	47	0	0
7	24458866	.	T	C	25	18	43	0	1	44	0	0
7	24458894	.	T	A	19	24	43	0	3	47	1	0
7	24459452	.	G	A	19	19	38	0	0	38	0	0
7	24459847	.	A	G	23	12	35	0	4	39	0	0
7	24459932	.	T	C	21	23	44	0	0	44	0	0
7	24460025	.	G	A	19	19	38	0	0	38	0	0
7	24460026	.	C	T	19	18	37	0	1	38	0	0
7	24460189	.	T	C	20	13	33	0	0	33	0	0
7	24460443	.	G	A	15	11	26	0	0	26	0	0
7	24460461	.	G	A	14	13	27	0	0	27	0	0
7	24461115	.	A	C	16	13	29	0	1	30	0	0
7	24461298	.	G	A	12	9	21	0	0	21	0	0
7	24461601	.	A	G	11	10	21	0	1	22	0	0
7	24462394	.	A	G	8	8	16	0	0	16	0	0
7	24470812	.	A	G	8	11	19	0	1	20	0	0
7	24485836	.	A	T	8	3	11	0	0	11	0	0
7	24486345	.	A	G	25	24	49	0	3	52	0	0
7	24486515	.	A	C	25	33	58	0	3	61	0	0
7	24486546	.	G	C	27	33	60	0	1	64	3	0
7	24486721	.	G	A	34	31	65	0	7	72	0	0
7	24486822	.	G	A	34	29	63	0	2	65	0	0
7	24489888	.	A	G	4	9	13	0	0	13	0	0
7	24498912	.	C	T	0	3	3	0	0	3	0	0
7	24501156	.	T	C	0	1	1	0	1	2	0	0
7	24504508	.	C	T	7	2	9	0	0	9	0	0
7	24504875	.	C	T	12	11	23	0	0	23	0	0
7	24569961	.	T	C	3	4	7	0	2	9	0	0
7	24569990	.	T	G	7	10	17	0	0	17	0	0
7	24570012	.	A	T	5	10	15	0	3	18	0	0
7	24570714	.	G	A	0	9	9	0	5	14	0	0
7	24570973	.	G	A	2	3	5	0	0	5	0	0
7	24571056	.	C	T	2	5	7	0	0	7	0	0
7	24593439	.	T	C	5	5	10	0	1	11	0	0
7	24593452	.	T	A	6	4	10	0	0	10	0	0
7	24594860	.	T	A	7	5	12	0	0	12	0	0
7	24598728	.	G	T	3	1	4	0	0	4	0	0
7	24603028	.	G	T	1	2	3	0	0	3	0	0
7	24603231	.	C	T	0	1	1	0	3	4	0	0
7	24612524	.	G	A	0	1	1	0	0	1	0	0
7	24612623	.	C	T	1	1	2	0	0	2	0	0
7	24616240	.	G	A	1	1	2	0	0	2	0	0
7	24621385	.	C	T	2	2	4	0	0	4	0	0
7	24632080	.	C	T	0	1	1	0	1	2	0	0
7	24637765	.	C	A	2	1	3	0	0	3	0	0
7	24643742	.	C	T	1	0	1	0	0	1	0	0
7	24644434	.	G	C	1	3	4	0	0	4	0	0
7	24644446	.	A	C	1	3	4	0	0	4	0	0
7	24644588	.	G	A	2	2	4	0	0	4	0	0
7	24645292	.	A	G	2	4	6	0	0	6	0	0
7	24651636	.	C	T	2	2	4	0	0	4	0	0
7	24652951	.	A	G	3	0	3	0	4	7	0	0
7	24653020	.	G	A	3	3	6	0	0	6	0	0
7	24653068	.	C	T	3	3	6	0	0	6	0	0
7	24653079	.	G	A	3	2	5	0	0	5	0	0
7	24655086	.	T	A	5	2	7	0	1	8	0	0
7	24655094	.	T	C	6	2	8	0	0	8	0	0
7	24655261	.	A	G	0	1	1	0	0	1	0	0
7	24658938	.	G	A	0	2	2	0	3	5	0	0
7	24662235	.	G	A	0	3	3	0	0	3	0	0
7	24672147	.	A	G	8	0	8	0	10	18	0	0
7	24672257	.	G	C	8	19	27	0	0	27	0	0
7	24672766	.	A	G	1	5	6	0	0	6	0	0
7	24681673	.	A	G	24	20	44	0	4	48	0	0
7	24681731	.	T	C	26	27	53	0	4	57	0	0
7	24681755	.	A	G	21	22	43	0	2	45	0	0
7	24681806	.	A	G	0	4	4	0	0	4	0	0
7	24699881	.	G	T	6	12	18	0	1	19	0	0
7	24715143	.	G	A	2	1	3	0	1	4	0	0
7	24715168	.	A	C	1	3	4	0	0	4	0	0
7	24715278	.	A	G	1	3	4	0	0	4	0	0
7	24715361	.	T	C	2	2	4	0	0	4	0	0
7	24716056	.	G	T	1	2	3	0	1	4	0	0
7	24796095	.	A	C	1	2	3	0	0	3	0	0
7	24796137	.	G	A	0	2	2	0	1	3	0	0
7	24812127	.	C	A	1	3	4	0	0	4	0	0
7	24812538	.	G	C	4	4	8	0	0	8	0	0
7	24812587	.	C	T	2	9	11	0	0	11	0	0
7	24812662	.	G	T	8	3	11	0	1	12	0	0
7	24812783	.	A	G	2	0	2	0	3	5	0	0
7	24812829	.	A	G	2	3	5	0	0	5	0	0
7	24815992	.	C	T	13	5	18	0	0	18	0	0
7	24819788	.	G	A	2	0	2	0	0	2	0	0
7	24819812	.	G	A	9	6	15	0	0	15	0	0
7	24822914	.	G	A	3	9	12	0	2	14	0	0
7	24888986	.	T	C	3	4	7	0	0	7	0	0
7	24889617	.	T	G	4	0	4	0	5	9	0	0
7	24889808	.	C	G	1	0	1	0	0	1	0	0
7	24923112	.	G	A	0	2	2	0	7	9	0	0
7	24944724	.	C	T	7	2	9	0	0	9	0	0
7	24946895	.	C	T	1	2	3	0	0	3	0	0
7	24946913	.	T	C	1	3	4	0	1	5	0	0
7	24947440	.	T	C	4	3	7	0	0	7	0	0
7	24974916	.	T	C	5	6	11	0	0	11	0	0
7	24974937	.	T	C	5	5	10	0	0	10	0	0
7	24975264	.	T	C	12	9	21	0	1	22	0	0
7	24975646	.	C	T	10	15	25	0	2	27	0	0
7	24975678	.	G	A	14	13	27	0	0	27	0	0
7	24976245	.	T	A	14	6	20	0	0	20	0	0
7	24976539	.	T	C	13	18	31	0	0	31	0	0
7	24979979	.	A	G	5	3	8	0	0	8	0	0
7	24980107	.	T	G	8	5	13	0	0	13	0	0
7	24980185	.	T	G	6	6	12	0	1	13	0	0
7	24980469	.	C	T	11	9	20	0	0	20	0	0
7	24984869	.	G	T	3	3	6	0	0	6	0	0
7	24985300	.	A	C	3	0	3	0	4	7	0	0
7	24985318	.	C	G	0	3	3	0	4	7	0	0
7	25010745	.	C	T	15	17	32	0	4	36	0	0
7	25011238	.	A	G	10	11	21	0	0	21	0	0
7	25011375	.	T	C	1	8	9	0	0	9	0	0
7	25011585	.	T	G	7	4	11	0	1	12	0	0
7	25015154	.	C	T	6	5	11	0	0	11	0	0
7	25015239	.	C	T	5	7	12	0	2	14	0	0
7	25015419	.	T	C	2	5	7	0	0	7	0	0
7	25015424	.	G	A	2	3	5	0	0	5	0	0
7	25017967	.	G	C	2	3	5	0	0	5	0	0
7	25021647	.	T	G	3	2	5	0	0	5	0	0
7	25021697	.	T	C	9	5	14	0	0	14	0	0
7	25021718	.	C	T	6	3	9	0	0	9	0	0
7	25024266	.	T	C	5	9	14	0	2	16	0	0
7	25024277	.	A	T	6	11	17	0	1	18	0	0
7	25024346	.	G	C	0	5	5	0	4	9	0	0
7	25026873	.	C	T	5	14	19	0	1	20	0	0
7	25026960	.	C	T	7	9	16	0	0	16	0	0
7	25027022	.	T	C	7	10	17	0	2	19	0	0
7	25027034	.	A	G	5	12	17	0	1	18	0	0
7	25027208	.	G	A	7	6	13	0	2	15	0	0
7	25027211	.	G	T	1	7	8	0	7	15	0	0
7	25027266	.	T	C	4	8	12	0	1	13	0	0
7	25027466	.	C	A	3	7	10	0	3	13	0	0
7	25027561	.	C	T	4	11	15	0	0	15	0	0
7	25027571	.	A	G	4	13	17	0	1	18	0	0
7	25027756	.	T	C	7	10	17	0	1	18	0	0
7	25028034	.	C	T	6	16	22	0	0	22	0	0
7	25028081	.	A	G	12	14	26	0	1	27	0	0
7	25028085	.	G	C	11	12	23	0	1	24	0	0
7	25028205	.	T	A	10	9	19	0	0	19	0	0
7	25028219	.	C	G	9	7	16	0	0	16	0	0
7	25028440	.	A	T	3	2	5	0	0	5	0	0
7	25029003	.	T	C	7	4	11	0	0	11	0	0
7	25029191	.	G	A	0	4	4	0	1	5	0	0
7	25045777	.	A	G	4	1	5	0	0	5	0	0
7	25047307	.	G	C	2	8	10	0	2	12	0	0
7	25047318	.	A	C	6	11	17	0	1	18	0	0
7	25047441	.	T	G	13	12	25	0	0	25	0	0
7	25047604	.	T	A	12	19	31	0	1	32	0	0
7	25047954	.	G	A	1	3	4	0	0	4	0	0
7	25049262	.	A	G	18	10	28	0	0	28	0	0
7	25059856	.	C	T	9	10	19	0	0	19	0	0
7	25096889	.	T	C	13	6	19	0	0	19	0	0
7	25098910	.	G	A	36	21	57	0	0	57	0	0
7	25099133	.	A	G	34	2	36	0	14	50	0	0
7	25099302	.	T	C	8	16	24	0	1	25	0	0
7	25099594	.	T	G	10	18	28	0	0	28	0	0
7	25099704	.	T	C	20	13	33	0	3	36	0	0
7	25128575	.	T	A	3	6	9	0	1	10	0	0
7	25128611	.	T	C	3	4	7	0	1	8	0	0
7	25128620	.	G	A	4	4	8	0	0	8	0	0
7	25129180	.	G	T	0	2	2	0	1	3	0	0
7	25129954	.	T	A	1	3	4	0	0	4	0	0
7	25292660	.	T	C	3	2	5	0	0	5	0	0
7	25292978	.	G	A	0	2	2	0	4	6	0	0
7	25293123	.	C	A	2	3	5	0	0	5	0	0
7	25293131	.	G	T	3	3	6	0	0	6	0	0
7	25293261	.	T	C	3	8	11	0	0	11	0	0
7	25293666	.	A	G	5	4	9	0	0	9	0	0
7	25346765	.	T	C	4	6	10	0	0	10	0	0
7	25346924	.	G	C	0	4	4	0	5	9	0	0
7	25347024	.	C	T	6	6	12	0	0	12	0	0
7	25347459	.	T	G	10	18	28	0	0	29	1	0
7	25347679	.	A	T	8	2	10	0	1	11	0	0
7	25348031	.	C	T	4	4	8	0	0	8	0	0
7	25558747	.	G	A	1	3	4	0	0	4	0	0
7	25558952	.	C	A	0	7	7	0	1	8	0	0
7	25559010	.	T	C	3	6	9	0	0	9	0	0
7	25559093	.	A	G	3	4	7	0	0	7	0	0
7	25559380	.	C	T	2	2	4	0	0	4	0	0
7	25559763	.	A	T	2	5	7	0	0	7	0	0
7	25559814	.	C	T	1	5	6	0	0	6	0	0
7	25560010	.	T	A	2	4	6	0	0	6	0	0
7	25560013	.	C	A	2	3	5	0	0	5	0	0
7	25561039	.	T	G	1	2	3	0	0	3	0	0
7	25843643	.	A	G	3	0	3	0	2	5	0	0
7	25852549	.	A	G	0	0	0	0	1	1	0	0
7	25854239	.	T	C	3	6	9	0	0	9	0	0
7	25854245	.	C	G	3	6	9	0	0	9	0	0
7	25858611	.	C	A	0	1	1	0	1	2	0	0
7	25863708	.	C	T	2	6	8	0	0	8	0	0
7	25867412	.	C	T	6	6	12	0	0	12	0	0
7	25869617	.	C	T	3	0	3	0	0	3	0	0
7	25872580	.	C	T	5	8	13	0	0	13	0	0
7	25872691	.	G	A	0	1	1	0	0	1	0	0
7	25873009	.	C	T	7	3	10	0	1	11	0	0
7	25873601	.	A	T	3	2	5	0	0	5	0	0
7	25873728	.	T	G	7	0	7	0	3	10	0	0
7	25873743	.	C	A	11	5	16	0	0	16	0	0
7	25873857	.	T	C	5	5	10	0	1	11	0	0
7	25876947	.	A	C	11	12	23	0	1	24	0	0
7	25877033	.	A	T	14	7	21	0	0	21	0	0
7	25877038	.	G	A	15	7	22	0	1	23	0	0
7	25877420	.	T	C	14	13	27	0	0	27	0	0
7	25877445	.	G	C	12	18	30	0	0	30	0	0
7	25878417	.	T	G	16	6	22	0	3	25	0	0
7	25878642	.	G	T	23	15	38	0	1	39	0	0
7	25878723	.	A	C	30	24	54	0	2	56	0	0
7	25878786	.	C	T	0	25	25	0	30	55	0	0
7	25878849	.	T	C	24	20	44	0	4	48	0	0
7	25878977	.	A	G	25	21	46	0	3	49	0	0
7	25879116	.	T	G	26	26	52	0	1	53	0	0
7	25879130	.	G	C	27	25	52	0	1	53	0	0
7	25879514	.	T	A	18	25	43	0	1	44	0	0
7	25879905	.	G	A	15	22	37	0	2	39	0	0
7	25879920	.	G	T	27	18	45	0	1	46	0	0
7	25880033	.	A	T	12	18	30	0	0	30	0	0
7	25880046	.	C	A	12	16	28	0	0	28	0	0
7	25880207	.	T	A	11	11	22	0	1	23	0	0
7	25880226	.	G	A	14	14	28	0	1	29	0	0
7	25880313	.	T	A	25	11	36	0	1	37	0	0
7	25880340	.	C	T	0	17	17	0	24	41	0	0
7	25880754	.	C	T	1	10	11	0	21	32	0	0
7	25880843	.	G	A	13	13	26	0	2	28	0	0
7	25881215	.	C	T	14	16	30	0	2	32	0	0
7	25881583	.	G	A	15	11	26	0	0	26	0	0
7	25881605	.	A	C	3	17	20	0	0	20	0	0
7	25884007	.	G	T	6	6	12	0	0	12	0	0
7	25917046	.	A	G	12	13	25	0	3	28	0	0
7	25917473	.	G	A	0	30	30	0	31	61	0	0
7	25917634	.	A	T	29	43	72	0	2	74	0	0
7	25918056	.	C	T	25	40	65	0	9	74	0	0
7	25918101	.	T	G	24	2	26	0	31	58	1	0
7	25920966	.	A	G	6	0	6	0	3	9	0	0
7	25979417	.	C	T	11	8	19	0	1	20	0	0
7	25979468	.	C	T	11	10	21	0	0	21	0	0
7	25979510	.	T	C	5	4	9	0	0	9	0	0
7	25986069	.	G	T	0	2	2	0	2	4	0	0
7	25986099	.	C	T	11	8	19	0	0	19	0	0
7	25988324	.	C	A	2	1	3	0	0	3	0	0
7	26002674	.	C	T	20	18	38	0	4	42	0	0
7	26002915	.	T	A	18	15	33	0	1	34	0	0
7	26003853	.	C	T	2	5	7	0	1	8	0	0
7	26004014	.	G	T	4	6	10	0	0	10	0	0
7	26004616	.	A	G	5	6	11	0	0	11	0	0
7	26004876	.	T	A	13	4	17	0	0	17	0	0
7	26004951	.	A	G	9	5	14	0	2	16	0	0
7	26005033	.	A	G	4	8	12	0	0	12	0	0
7	26005108	.	A	G	0	0	0	0	2	2	0	0
7	26005574	.	A	T	3	5	8	0	0	8	0	0
7	26013041	.	C	G	1	1	2	0	0	2	0	0
7	26015544	.	G	T	5	10	15	0	1	16	0	0
7	26015595	.	C	A	8	5	13	0	0	13	0	0
7	26015628	.	T	C	7	5	12	0	0	12	0	0
7	26015663	.	T	C	6	3	9	0	2	11	0	0
7	26015693	.	C	A	4	1	5	0	1	6	0	0
7	26020078	.	T	C	1	2	3	0	0	3	0	0
7	26020192	.	C	T	6	13	19	0	0	19	0	0
7	26020273	.	G	A	0	7	7	0	12	19	0	0
7	26020370	.	T	C	8	7	15	0	0	15	0	0
7	26020408	.	A	C	8	6	14	0	0	14	0	0
7	26020659	.	C	T	14	11	25	0	0	25	0	0
7	26020779	.	C	T	14	11	25	0	0	25	0	0
7	26020927	.	A	T	11	5	16	0	2	18	0	0
7	26021146	.	A	G	17	21	38	0	0	38	0	0
7	26026114	.	A	G	17	0	17	0	17	34	0	0
7	26026176	.	C	T	9	9	18	0	0	18	0	0
7	26026188	.	C	A	6	11	17	0	1	18	0	0
7	26026241	.	G	A	6	11	17	0	0	17	0	0
7	26026264	.	C	G	7	6	13	0	0	13	0	0
7	26026298	.	T	G	5	0	5	0	5	10	0	0
7	26026330	.	A	T	5	9	14	0	1	15	0	0
7	26026358	.	A	C	4	10	14	0	0	14	0	0
7	26026379	.	C	T	7	8	15	0	0	15	0	0
7	26026491	.	T	G	2	2	4	0	0	4	0	0
7	26048364	.	T	A	2	3	5	0	0	6	1	0
7	26048541	.	G	A	0	0	0	0	1	1	0	0
7	26074160	.	C	A	14	11	25	0	1	26	0	0
7	26076368	.	A	G	2	4	6	0	0	6	0	0
7	26076458	.	A	T	4	9	13	0	0	13	0	0
7	26076531	.	G	C	1	4	5	0	0	5	0	0
7	26077845	.	G	T	21	20	41	0	2	43	0	0
7	26077947	.	T	A	24	29	53	0	2	55	0	0
7	26077949	.	C	T	24	28	52	0	3	55	0	0
7	26078061	.	T	C	12	32	44	0	1	45	0	0
7	26078243	.	A	C	22	16	38	0	1	39	0	0
7	26078284	.	C	T	11	27	38	0	0	38	0	0
7	26078345	.	T	A	20	25	45	0	0	45	0	0
7	26078435	.	G	T	15	12	27	0	3	30	0	0
7	26078897	.	G	A	30	22	52	0	3	55	0	0
7	26078947	.	G	A	29	17	46	0	1	47	0	0
7	26079370	.	T	G	18	29	47	0	1	48	0	0
7	26079667	.	C	G	2	26	28	0	21	49	0	0
7	26081171	.	C	T	16	13	29	0	3	32	0	0
7	26081252	.	A	G	2	9	11	0	0	11	0	0
7	26081744	.	T	C	14	11	25	0	3	28	0	0
7	26082281	.	G	A	4	7	11	0	0	11	0	0
7	26082311	.	A	G	5	7	12	0	0	12	0	0
7	26116876	.	A	G	6	2	8	0	0	8	0	0
7	26118856	.	C	T	4	2	6	0	1	7	0	0
7	26118930	.	T	G	1	3	4	0	0	4	0	0
7	26132724	.	C	T	7	3	10	0	0	10	0	0
7	26132743	.	C	T	2	0	2	0	0	2	0	0
7	26140767	.	A	G	5	2	7	0	2	9	0	0
7	26141394	.	G	C	12	13	25	0	0	25	0	0
7	26141519	.	T	A	10	18	28	0	0	28	0	0
7	26141568	.	T	A	20	18	38	0	0	38	0	0
7	26142339	.	T	C	12	5	17	0	2	19	0	0
7	26142525	.	T	G	14	0	14	0	17	31	0	0
7	26142702	.	A	G	14	16	30	0	0	30	0	0
7	26142736	.	A	T	14	18	32	0	2	34	0	0
7	26143343	.	A	G	6	15	21	0	0	21	0	0
7	26143501	.	T	C	16	20	36	0	1	37	0	0
7	26143760	.	G	A	12	20	32	0	0	33	1	0
7	26144551	.	T	A	4	2	6	0	0	7	1	0
7	26144628	.	C	T	3	7	10	0	0	10	0	0
7	26145605	.	T	C	21	29	50	0	0	50	0	0
7	26145816	.	C	T	3	6	9	0	0	9	0	0
7	26145873	.	C	T	7	6	13	0	0	13	0	0
7	26145910	.	T	C	9	6	15	0	0	15	0	0
7	26146176	.	A	C	21	28	49	0	3	52	0	0
7	26146188	.	T	C	18	32	50	0	3	53	0	0
7	26146796	.	A	G	30	2	32	0	24	56	0	0
7	26146993	.	C	T	34	27	61	0	3	64	0	0
7	26148181	.	A	C	21	34	55	0	2	57	0	0
7	26148260	.	A	G	33	1	34	0	16	50	0	0
7	26148263	.	A	G	32	17	49	0	1	50	0	0
7	26148312	.	T	G	17	23	40	0	2	43	1	0
7	26149252	.	G	A	34	27	61	0	3	65	1	0
7	26149690	.	C	T	24	32	56	0	3	59	0	0
7	26150096	.	T	A	24	24	48	0	2	50	0	0
7	26224320	.	A	G	10	11	21	0	0	21	0	0
7	26224365	.	A	T	10	7	17	0	0	17	0	0
7	26226772	.	G	C	13	18	31	0	2	33	0	0
7	26227119	.	C	T	17	12	29	0	0	29	0	0
7	26227149	.	C	T	14	13	27	0	1	28	0	0
7	26227527	.	T	C	17	13	30	0	0	30	0	0
7	26227539	.	T	C	15	15	30	0	1	31	0	0
7	26228290	.	C	T	25	20	45	0	1	46	0	0
7	26228639	.	T	C	24	21	45	0	2	47	0	0
7	26229449	.	G	A	17	12	29	0	4	33	0	0
7	26229529	.	C	T	29	18	47	0	2	49	0	0
7	26229551	.	T	A	31	18	49	0	1	50	0	0
7	26229640	.	T	C	33	21	54	0	2	56	0	0
7	26229935	.	C	T	23	19	42	0	1	43	0	0
7	26229979	.	A	G	5	17	22	0	4	26	0	0
7	26245668	.	T	C	13	14	27	0	2	29	0	0
7	26245714	.	A	T	17	14	31	0	2	33	0	0
7	26263153	.	C	T	8	5	13	0	0	13	0	0
7	26263174	.	T	C	5	0	5	0	3	8	0	0
7	26265832	.	C	A	0	6	6	0	1	7	0	0
7	26265961	.	G	A	4	3	7	0	0	7	0	0
7	26266069	.	G	C	4	3	7	0	1	8	0	0
7	26268126	.	G	A	1	1	2	0	0	2	0	0
7	26268150	.	A	G	1	1	2	0	0	2	0	0
7	26300184	.	A	G	5	2	7	0	0	7	0	0
7	26300263	.	A	G	8	8	16	0	0	16	0	0
7	26300359	.	A	G	10	11	21	0	2	23	0	0
7	26300955	.	T	C	1	0	1	0	3	4	0	0
7	26366620	.	T	C	8	8	16	0	0	16	0	0
7	26366684	.	C	T	7	11	18	0	1	19	0	0
7	26366778	.	G	A	7	17	24	0	0	25	1	0
7	26366919	.	G	A	10	7	17	0	0	17	0	0
7	26367056	.	T	C	12	0	12	0	10	22	0	0
7	26367364	.	T	G	4	2	6	0	0	6	0	0
7	26367486	.	A	C	8	4	12	0	0	12	0	0
7	26367525	.	A	G	8	10	18	0	2	20	0	0
7	26367612	.	T	C	3	2	5	0	0	5	0	0
7	26367628	.	A	G	3	1	4	0	0	4	0	0
7	26367944	.	G	A	11	6	17	0	0	17	0	0
7	26368080	.	T	A	9	9	18	0	1	19	0	0
7	26368240	.	C	A	7	7	14	0	0	14	0	0
7	26368291	.	A	C	2	5	7	0	0	7	0	0
7	26368333	.	A	T	6	4	10	0	0	10	0	0
7	26368483	.	T	A	7	6	13	0	1	14	0	0
7	26368549	.	A	G	4	9	13	0	0	13	0	0
7	26368719	.	C	A	8	4	12	0	0	12	0	0
7	26368748	.	A	T	8	2	10	0	1	11	0	0
7	26368836	.	A	T	8	12	20	0	1	21	0	0
7	26368955	.	G	T	9	15	24	0	0	24	0	0
7	26369030	.	C	T	9	7	16	0	0	16	0	0
7	26369034	.	G	C	7	7	14	0	1	15	0	0
7	26369106	.	T	A	4	2	6	0	0	6	0	0
7	26369114	.	C	T	4	4	8	0	0	8	0	0
7	26369227	.	G	A	5	5	10	0	0	10	0	0
7	26369583	.	A	C	7	0	7	0	8	15	0	0
7	26371702	.	G	A	3	2	5	0	0	5	0	0
7	26371711	.	G	A	5	2	7	0	1	8	0	0
7	26378224	.	G	A	4	2	6	0	1	7	0	0
7	26380290	.	T	C	0	1	1	0	0	1	0	0
7	26389369	.	G	A	3	2	5	0	0	5	0	0
7	26389429	.	C	T	2	8	10	0	2	12	0	0
7	26389486	.	G	A	5	6	11	0	0	11	0	0
7	26389805	.	A	G	3	3	6	0	0	6	0	0
7	26393903	.	T	C	1	2	3	0	0	3	0	0
7	26394208	.	A	T	18	11	29	0	1	30	0	0
7	26394285	.	A	T	11	17	28	0	3	31	0	0
7	26394382	.	C	T	2	19	21	0	14	35	0	0
7	26394476	.	G	A	16	22	38	0	3	41	0	0
7	26394791	.	A	G	17	20	37	0	4	41	0	0
7	26394848	.	G	A	19	13	32	0	1	33	0	0
7	26394951	.	T	A	9	5	14	0	1	15	0	0
7	26395538	.	T	C	15	7	22	0	0	23	1	0
7	26395625	.	T	A	2	8	10	0	0	10	0	0
7	26395778	.	T	G	7	7	14	0	1	15	0	0
7	26396170	.	G	A	11	9	20	0	0	20	0	0
7	26396560	.	C	G	9	8	17	0	1	18	0	0
7	26396768	.	G	A	14	15	29	0	1	30	0	0
7	26396915	.	A	C	9	11	20	0	0	20	0	0
7	26396975	.	A	G	8	8	16	0	0	16	0	0
7	26397003	.	T	G	8	7	15	0	0	15	0	0
7	26397243	.	G	A	10	13	23	0	1	24	0	0
7	26397475	.	T	A	5	10	15	0	0	15	0	0
7	26397760	.	C	T	7	9	16	0	2	18	0	0
7	26398159	.	A	T	11	9	20	0	0	20	0	0
7	26398351	.	A	G	11	8	19	0	1	20	0	0
7	26398867	.	G	A	12	6	18	0	0	18	0	0
7	26402680	.	C	A	8	6	14	0	1	15	0	0
7	26402788	.	T	G	3	4	7	0	1	8	0	0
7	26408340	.	C	T	6	2	8	0	0	8	0	0
7	26408466	.	C	A	0	2	2	0	4	6	0	0
7	26432105	.	G	A	2	2	4	0	0	4	0	0
7	26432306	.	T	C	5	2	7	0	0	7	0	0
7	26432464	.	A	T	1	1	2	0	3	5	0	0
7	26457037	.	A	T	1	1	2	0	0	2	0	0
7	26457085	.	A	G	1	5	6	0	0	6	0	0
7	26457103	.	C	T	0	6	6	0	1	7	0	0
7	26459917	.	C	T	0	4	4	0	1	5	0	0
7	26469820	.	G	A	0	4	4	0	0	4	0	0
7	26472340	.	A	C	7	6	13	0	0	13	0	0
7	26472346	.	A	T	6	6	12	0	1	13	0	0
7	26472398	.	C	T	7	9	16	0	1	17	0	0
7	26472413	.	A	G	8	9	17	0	1	18	0	0
7	26472512	.	G	T	2	8	10	0	2	12	0	0
7	26472971	.	C	G	2	8	10	0	0	10	0	0
7	26473040	.	A	G	5	0	5	0	8	13	0	0
7	26473163	.	G	A	7	4	11	0	1	12	0	0
7	26511439	.	A	T	23	12	35	0	2	37	0	0
7	26511691	.	G	A	26	19	45	0	0	45	0	0
7	26511760	.	A	G	21	22	43	0	0	43	0	0
7	26511801	.	T	G	22	21	43	0	0	43	0	0
7	26519052	.	A	G	7	4	11	0	0	11	0	0
7	26519150	.	A	T	12	17	29	0	0	29	0	0
7	26522358	.	T	C	6	10	16	0	0	16	0	0
7	26522364	.	C	T	4	10	14	0	0	14	0	0
7	26523169	.	A	G	1	0	1	0	0	1	0	0
7	26525463	.	C	T	1	1	2	0	0	2	0	0
7	27681025	.	G	T	12	9	21	0	0	21	0	0
7	27681071	.	A	T	11	12	23	0	0	24	1	0
7	27682919	.	C	T	8	11	19	0	0	19	0	0
7	27700517	.	G	A	7	12	19	0	3	22	0	0
7	27700777	.	C	T	1	14	15	0	16	31	0	0
7	27701155	.	C	G	0	4	4	0	8	12	0	0
7	27701231	.	T	A	8	15	23	0	0	23	0	0
7	27701348	.	A	C	4	8	12	0	0	12	0	0
7	27701431	.	T	A	5	5	10	0	0	10	0	0
7	27701561	.	A	T	6	6	12	0	1	13	0	0
7	27701623	.	C	A	5	5	10	0	3	13	0	0
7	27701634	.	A	G	7	4	11	0	1	12	0	0
7	27702003	.	A	C	3	5	8	0	0	8	0	0
7	27702571	.	T	G	10	5	15	0	0	15	0	0
7	27702934	.	G	A	10	13	23	0	1	24	0	0
7	27702998	.	T	A	8	6	14	0	0	14	0	0
7	27703102	.	T	C	3	0	3	0	0	3	0	0
7	27705837	.	G	A	1	9	10	0	1	11	0	0
7	27712933	.	C	T	0	1	1	0	0	1	0	0
7	27718258	.	C	G	0	2	2	0	0	2	0	0
7	27722513	.	A	G	1	2	3	0	0	3	0	0
7	27722534	.	A	G	1	4	5	0	1	6	0	0
7	27797760	.	A	G	1	2	3	0	0	3	0	0
7	27798561	.	A	C	3	2	5	0	0	5	0	0
7	27805547	.	C	T	3	7	10	0	0	10	0	0
7	27806074	.	G	A	0	2	2	0	2	4	0	0
7	27811770	.	C	T	19	8	27	0	0	27	0	0
7	27813749	.	C	T	1	4	5	0	0	5	0	0
7	27813942	.	G	A	10	4	14	0	1	15	0	0
7	27813978	.	A	G	7	0	7	0	8	15	0	0
7	27814326	.	C	T	7	7	14	0	0	14	0	0
7	27816668	.	T	C	13	12	25	0	1	26	0	0
7	27816875	.	C	T	12	9	21	0	0	21	0	0
7	27817229	.	C	A	9	13	22	0	1	23	0	0
7	27817283	.	A	G	11	0	11	0	9	20	0	0
7	27817755	.	G	C	6	1	7	0	2	9	0	0
7	27820177	.	G	A	5	9	14	0	0	14	0	0
7	27820496	.	T	A	1	4	5	0	0	5	0	0
7	27820838	.	G	A	1	2	3	0	2	5	0	0
7	27834170	.	A	G	5	2	7	0	1	8	0	0
7	27884185	.	A	G	6	9	15	0	1	16	0	0
7	27884211	.	A	G	5	9	14	0	1	15	0	0
7	27884611	.	T	G	2	6	8	0	1	9	0	0
7	27884618	.	C	T	3	5	8	0	1	9	0	0
7	27884979	.	G	T	4	3	7	0	0	7	0	0
7	27885000	.	T	C	3	4	7	0	0	7	0	0
7	27885043	.	C	T	3	4	7	0	0	7	0	0
7	27885160	.	A	G	4	2	6	0	0	6	0	0
7	27885259	.	A	G	4	6	10	0	0	10	0	0
7	27885703	.	A	T	7	3	10	0	0	10	0	0
7	27885706	.	C	T	6	4	10	0	0	10	0	0
7	27885941	.	G	A	8	4	12	0	0	12	0	0
7	27886502	.	A	T	7	4	11	0	0	11	0	0
7	27886508	.	A	T	5	3	8	0	1	9	0	0
7	27886602	.	C	A	6	15	21	0	0	21	0	0
7	27886923	.	A	G	4	7	11	0	1	12	0	0
7	27886924	.	A	G	5	7	12	0	0	12	0	0
7	27887044	.	T	A	7	7	14	0	0	14	0	0
7	27977061	.	C	T	0	3	3	0	0	3	0	0
7	27977083	.	G	A	0	1	1	0	0	1	0	0
7	28033649	.	G	A	0	2	2	0	1	3	0	0
7	28040014	.	G	T	0	2	2	0	7	9	0	0
7	28040083	.	T	C	2	0	2	0	0	2	0	0
7	28040885	.	T	C	5	2	7	0	1	8	0	0
7	28041336	.	T	A	2	4	6	0	0	6	0	0
7	28041496	.	T	C	9	6	15	0	0	15	0	0
7	28041538	.	T	C	8	7	15	0	0	15	0	0
7	28041570	.	G	T	8	5	13	0	0	14	1	0
7	28041736	.	A	G	2	6	8	0	0	8	0	0
7	28041842	.	T	C	8	4	12	0	0	12	0	0
7	28041942	.	T	C	7	2	9	0	0	9	0	0
7	28042027	.	G	A	7	4	11	0	1	12	0	0
7	28042740	.	G	A	2	7	9	0	0	9	0	0
7	28043040	.	C	A	2	4	6	0	3	9	0	0
7	28043184	.	A	G	4	0	4	0	5	9	0	0
7	28043284	.	A	G	4	7	11	0	0	11	0	0
7	28043416	.	A	G	3	12	15	0	0	15	0	0
7	28043837	.	T	G	6	0	6	0	7	13	0	0
7	28043852	.	G	A	7	5	12	0	0	12	0	0
7	28044193	.	A	G	18	8	26	0	1	27	0	0
7	28044334	.	A	G	9	2	11	0	1	12	0	0
7	28044339	.	A	G	5	6	11	0	0	11	0	0
7	28044628	.	A	G	7	3	10	0	0	10	0	0
7	28044640	.	A	G	7	2	9	0	0	9	0	0
7	28045160	.	G	A	0	10	10	0	5	15	0	0
7	28045263	.	C	G	7	4	11	0	1	12	0	0
7	28045444	.	T	A	11	7	18	0	1	19	0	0
7	28045600	.	C	T	11	8	19	0	0	19	0	0
7	28045685	.	C	T	17	7	24	0	0	24	0	0
7	28046436	.	T	C	4	6	10	0	1	11	0	0
7	28046530	.	A	G	11	12	23	0	1	24	0	0
7	28046572	.	T	C	14	12	26	0	0	26	0	0
7	28046580	.	A	G	12	16	28	0	1	29	0	0
7	28046718	.	G	A	9	4	13	0	0	13	0	0
7	28046723	.	G	A	10	4	14	0	0	14	0	0
7	28046918	.	A	C	0	4	4	0	0	4	0	0
7	28047004	.	G	A	12	4	16	0	1	17	0	0
7	28047163	.	C	T	3	4	7	0	1	8	0	0
7	28147806	.	T	A	19	18	37	0	1	38	0	0
7	28406725	.	A	G	1	2	3	0	0	3	0	0
7	28406732	.	T	A	0	2	2	0	1	3	0	0
7	28407339	.	A	G	1	6	7	0	1	8	0	0
7	28424095	.	G	A	4	3	7	0	0	7	0	0
7	28424237	.	C	G	15	12	27	0	0	27	0	0
7	28424381	.	A	T	14	7	21	0	3	24	0	0
7	28430010	.	G	A	1	4	5	0	0	5	0	0
7	28430127	.	C	A	1	2	3	0	1	4	0	0
7	28430430	.	C	T	6	4	10	0	0	10	0	0
7	28430454	.	C	A	4	6	10	0	0	10	0	0
7	28430503	.	G	A	7	5	12	0	0	12	0	0
7	28430528	.	G	T	6	4	10	0	0	10	0	0
7	28434034	.	A	T	1	0	1	0	0	1	0	0
7	28436486	.	G	C	15	3	18	0	2	20	0	0
7	28442009	.	G	C	6	3	9	0	0	9	0	0
7	28448588	.	C	T	3	4	7	0	0	7	0	0
7	28465338	.	G	A	10	8	18	0	1	19	0	0
7	28467182	.	A	G	7	9	16	0	1	17	0	0
7	28515998	.	T	C	1	0	1	0	3	4	0	0
7	28516231	.	A	G	1	2	3	0	0	3	0	0
7	28516250	.	G	A	1	2	3	0	0	3	0	0
7	28559907	.	G	A	16	15	31	0	1	32	0	0
7	28559969	.	G	T	11	8	19	0	1	20	0	0
7	28560250	.	G	C	18	18	36	0	1	37	0	0
7	28560256	.	G	A	19	18	37	0	0	37	0	0
7	28560467	.	C	G	11	30	41	0	1	42	0	0
7	28562196	.	A	G	17	10	27	0	0	27	0	0
7	28587256	.	G	A	1	3	4	0	0	4	0	0
7	28612726	.	T	C	14	11	25	0	1	26	0	0
7	28612899	.	G	A	1	7	8	0	6	14	0	0
7	28612929	.	A	G	3	10	13	0	1	14	0	0
7	28612962	.	G	A	3	2	5	0	1	6	0	0
7	28615709	.	T	C	4	2	6	0	0	6	0	0
7	28615850	.	G	A	14	11	25	0	2	27	0	0
7	28615922	.	A	G	19	0	19	0	10	29	0	0
7	28618813	.	C	T	4	4	8	0	0	8	0	0
7	28622856	.	G	A	19	21	40	0	7	47	0	0
7	28622970	.	T	C	22	19	41	0	5	46	0	0
7	28623456	.	G	A	9	4	13	0	0	13	0	0
7	28623506	.	T	A	2	3	5	0	1	6	0	0
7	28623533	.	A	T	1	3	4	0	1	5	0	0
7	28623803	.	G	A	2	2	4	0	0	4	0	0
7	28623823	.	G	T	5	4	9	0	2	11	0	0
7	28623860	.	A	G	8	4	12	0	2	14	0	0
7	28623863	.	A	G	9	5	14	0	0	14	0	0
7	28624106	.	A	T	5	6	11	0	0	11	0	0
7	28624157	.	C	G	6	4	10	0	0	11	1	0
7	28624490	.	T	G	2	1	3	0	0	3	0	0
7	28624688	.	A	T	6	6	12	0	0	12	0	0
7	28624692	.	T	C	6	6	12	0	0	12	0	0
7	28624802	.	T	C	10	3	13	0	0	13	0	0
7	28625080	.	G	T	4	5	9	0	0	9	0	0
7	28625174	.	G	C	4	2	6	0	0	6	0	0
7	28626098	.	G	A	0	2	2	0	0	2	0	0
7	29051855	.	A	G	5	4	9	0	0	9	0	0
7	29051871	.	A	G	3	3	6	0	1	7	0	0
7	29099963	.	A	G	1	2	3	0	0	3	0	0
7	29654044	.	A	G	4	1	5	0	2	7	0	0
7	29657144	.	T	C	0	0	0	0	9	9	0	0
7	29945481	.	A	G	12	9	21	0	1	22	0	0
7	29969031	.	A	G	7	0	7	0	3	10	0	0
7	29969704	.	A	G	4	5	9	0	0	9	0	0
7	30270675	.	T	G	7	2	9	0	0	9	0	0
7	30270676	.	T	A	7	2	9	0	0	9	0	0
7	30409234	.	G	A	1	2	3	0	0	3	0	0
7	30537613	.	A	G	1	8	9	0	0	9	0	0
7	30769474	.	A	G	2	1	3	0	1	4	0	0
7	31392725	.	A	T	5	3	8	0	0	8	0	0
7	31497897	.	T	C	2	1	3	0	1	4	0	0
7	31500424	.	T	C	3	3	6	0	0	6	0	0
7	31500425	.	T	C	3	3	6	0	0	6	0	0
7	31625865	.	A	G	1	4	5	0	0	5	0	0
7	32743365	.	A	G	10	3	13	0	0	13	0	0
7	32746213	.	A	G	17	6	23	0	1	24	0	0
7	32747956	.	A	G	18	0	18	0	9	27	0	0
7	32747973	.	A	G	10	18	28	0	1	29	0	0
7	32835820	.	A	G	4	2	6	0	0	6	0	0
7	33884239	.	T	C	1	3	4	0	0	4	0	0
7	34314850	.	A	G	4	0	4	0	3	7	0	0
7	34417537	.	T	A	0	6	6	0	0	6	0	0
7	34651491	.	T	C	1	7	8	0	0	8	0	0
7	37762107	.	C	A	9	3	12	0	1	13	0	0
7	38257552	.	A	G	1	3	4	0	0	4	0	0
7	38257557	.	A	G	2	3	5	0	0	5	0	0
7	38392031	.	C	T	4	4	8	0	0	8	0	0
7	38392422	.	A	C	1	2	3	0	2	5	0	0
7	38392424	.	C	T	2	2	4	0	1	5	0	0
7	38428094	.	A	G	1	1	2	0	0	2	0	0
7	38456516	.	C	A	3	6	9	0	0	9	0	0
7	38456517	.	C	T	3	5	8	0	1	9	0	0
7	38456578	.	T	C	3	5	8	0	0	8	0	0
7	38456592	.	A	T	3	3	6	0	0	6	0	0
7	38456699	.	T	C	2	6	8	0	0	8	0	0
7	38456944	.	T	C	8	1	9	0	4	13	0	0
7	38476911	.	T	A	9	8	17	0	1	18	0	0
7	38476976	.	C	T	3	8	11	0	1	12	0	0
7	38477026	.	C	T	1	9	10	0	4	14	0	0
7	38477075	.	G	A	6	7	13	0	2	15	0	0
7	38477196	.	C	T	3	3	6	0	0	6	0	0
7	38529617	.	G	T	0	2	2	0	1	3	0	0
7	38529623	.	C	T	1	1	2	0	0	2	0	0
7	38529867	.	A	T	4	2	6	0	0	6	0	0
7	38529950	.	G	T	2	2	4	0	1	5	0	0
7	38531729	.	G	A	6	2	8	0	0	8	0	0
7	38532382	.	A	C	1	1	2	0	1	3	0	0
7	38532390	.	G	A	0	3	3	0	1	4	0	0
7	38532541	.	G	C	4	2	6	0	0	6	0	0
7	38533013	.	T	C	5	2	7	0	0	7	0	0
7	38533048	.	C	A	3	3	6	0	1	7	0	0
7	38533301	.	A	G	4	1	5	0	2	7	0	0
7	38533393	.	G	A	4	2	6	0	0	6	0	0
7	38533397	.	T	C	4	1	5	0	1	6	0	0
7	38533683	.	A	T	5	3	8	0	0	8	0	0
7	38536370	.	C	T	20	18	38	0	0	38	0	0
7	38536416	.	C	T	18	15	33	0	1	34	0	0
7	38536697	.	A	G	24	10	34	0	2	36	0	0
7	38536703	.	A	T	24	11	35	0	0	35	0	0
7	38536889	.	G	T	17	16	33	0	1	34	0	0
7	38537085	.	T	A	10	17	27	0	0	27	0	0
7	38537345	.	C	T	17	18	35	0	0	35	0	0
7	38537657	.	C	T	8	11	19	0	6	25	0	0
7	38539320	.	T	A	6	5	11	0	0	11	0	0
7	38539554	.	A	G	8	10	18	0	0	18	0	0
7	38539577	.	A	G	8	9	17	0	1	18	0	0
7	38539643	.	C	A	7	7	14	0	0	14	0	0
7	38539730	.	G	A	6	5	11	0	1	12	0	0
7	38539768	.	T	A	13	6	19	0	1	20	0	0
7	38539992	.	G	A	9	6	15	0	0	15	0	0
7	38540134	.	G	A	11	7	18	0	0	18	0	0
7	38544706	.	A	G	6	6	12	0	1	13	0	0
7	38552294	.	T	C	3	2	5	0	1	6	0	0
7	38578128	.	T	C	2	4	6	0	0	6	0	0
7	38578140	.	T	C	1	2	3	0	0	3	0	0
7	38588890	.	T	G	0	12	12	0	0	12	0	0
7	38594474	.	A	C	11	15	26	0	0	26	0	0
7	38594510	.	G	C	15	13	28	0	0	28	0	0
7	38600226	.	A	G	21	14	35	0	3	38	0	0
7	38600265	.	T	C	29	18	47	0	1	48	0	0
7	38600483	.	A	G	13	20	33	0	2	35	0	0
7	38600585	.	C	T	3	22	25	0	22	47	0	0
7	38600892	.	G	A	17	21	38	0	0	38	0	0
7	38600982	.	G	A	33	28	61	0	3	64	0	0
7	38601025	.	G	T	37	18	55	0	3	58	0	0
7	38601067	.	G	T	37	14	51	0	3	54	0	0
7	38601156	.	G	T	25	15	40	0	3	43	0	0
7	38601374	.	C	T	25	29	54	0	0	54	0	0
7	38601391	.	T	A	28	27	55	0	1	56	0	0
7	38601417	.	A	C	31	32	63	0	0	63	0	0
7	38601625	.	C	A	30	11	41	0	2	44	1	0
7	38601646	.	G	A	23	22	45	0	2	47	0	0
7	38601751	.	T	C	27	21	48	0	2	50	0	0
7	38601759	.	C	G	32	18	50	0	2	52	0	0
7	38601823	.	C	A	0	9	9	1	34	44	0	0
7	38601909	.	C	T	1	15	16	0	26	42	0	0
7	38602123	.	C	T	36	17	53	0	2	55	0	0
7	38602160	.	A	T	23	26	49	0	1	50	0	0
7	38602623	.	T	C	33	29	62	0	1	63	0	0
7	38602656	.	G	A	26	27	53	0	0	53	0	0
7	38602917	.	A	T	32	21	53	0	2	56	1	0
7	38612100	.	A	G	3	1	4	0	0	4	0	0
7	38612109	.	G	A	4	5	9	0	1	10	0	0
7	38612334	.	T	C	1	0	1	0	2	3	0	0
7	38673259	.	G	A	0	1	1	0	0	1	0	0
7	38677497	.	T	C	24	13	37	0	1	38	0	0
7	38677880	.	G	T	19	15	34	0	0	34	0	0
7	38677999	.	A	T	13	9	22	0	1	23	0	0
7	38681322	.	C	T	1	1	2	0	1	3	0	0
7	38683834	.	T	C	8	6	14	0	1	15	0	0
7	38684830	.	C	T	17	6	23	0	0	23	0	0
7	38684970	.	C	T	16	16	32	0	0	32	0	0
7	38685201	.	T	G	0	3	3	0	1	4	0	0
7	38686849	.	T	C	1	2	3	0	0	3	0	0
7	38687535	.	G	A	1	2	3	0	0	3	0	0
7	38688270	.	G	A	0	5	5	0	1	6	0	0
7	38688294	.	A	G	1	4	5	0	0	5	0	0
7	38689387	.	G	A	1	2	3	0	1	4	0	0
7	38689531	.	G	T	1	5	6	0	1	7	0	0
7	38689592	.	A	T	1	5	6	0	0	6	0	0
7	38689603	.	A	C	1	4	5	0	0	5	0	0
7	38689701	.	G	A	0	3	3	0	2	5	0	0
7	38696163	.	A	G	35	39	74	0	2	76	0	0
7	38703509	.	C	T	0	6	6	0	6	12	0	0
7	38703598	.	C	T	6	5	11	0	1	12	0	0
7	38704006	.	G	A	7	8	15	0	0	15	0	0
7	38704009	.	G	A	6	8	14	0	0	15	1	0
7	38704063	.	T	C	5	17	22	0	0	22	0	0
7	38704188	.	T	C	5	3	8	0	0	8	0	0
7	38704622	.	C	A	3	10	13	0	1	14	0	0
7	38704623	.	T	C	4	0	4	0	10	14	0	0
7	38704754	.	C	T	4	6	10	0	1	11	0	0
7	38704832	.	G	A	5	7	12	0	1	14	1	0
7	38704834	.	A	G	5	8	13	0	1	14	0	0
7	38705012	.	A	T	5	5	10	0	0	10	0	0
7	38705097	.	A	C	2	0	2	0	8	10	0	0
7	38705367	.	C	G	0	4	4	0	5	9	0	0
7	38705643	.	A	G	3	3	6	0	0	6	0	0
7	38709326	.	G	T	4	3	7	0	1	8	0	0
7	38714503	.	A	T	2	2	4	0	0	4	0	0
7	38717795	.	G	A	0	5	5	0	8	13	0	0
7	38717819	.	A	C	6	8	14	0	0	14	0	0
7	38726646	.	A	G	2	15	17	0	1	18	0	0
7	38734152	.	G	A	0	9	9	0	6	15	0	0
7	38734276	.	T	G	7	9	16	0	0	16	0	0
7	38734431	.	C	A	19	10	29	0	1	30	0	0
7	38734475	.	A	C	16	14	30	0	0	30	0	0
7	38734527	.	T	C	17	16	33	0	3	36	0	0
7	38734573	.	A	G	19	13	32	0	0	32	0	0
7	38734626	.	G	T	21	13	34	0	0	34	0	0
7	38735363	.	A	G	16	17	33	0	1	34	0	0
7	38735406	.	C	T	16	19	35	0	3	38	0	0
7	38735460	.	G	T	21	18	39	0	1	40	0	0
7	38735465	.	A	C	22	18	40	0	0	40	0	0
7	38735501	.	T	C	12	10	22	0	1	23	0	0
7	38735711	.	G	A	10	6	16	0	0	16	0	0
7	38735727	.	A	T	10	7	17	0	0	17	0	0
7	38735827	.	A	C	11	13	24	0	2	26	0	0
7	38736320	.	G	C	23	20	43	0	4	47	0	0
7	38736526	.	C	T	16	14	30	0	0	30	0	0
7	38736818	.	C	A	2	3	5	0	0	5	0	0
7	38736819	.	A	G	2	3	5	0	0	5	0	0
7	38736912	.	T	C	3	7	10	0	0	10	0	0
7	38737020	.	T	C	11	11	22	0	1	23	0	0
7	38737224	.	C	T	16	5	21	0	0	21	0	0
7	38737286	.	C	T	17	9	26	0	1	27	0	0
7	38748725	.	A	G	1	2	3	0	0	3	0	0
7	38762091	.	A	C	0	1	1	0	0	1	0	0
7	38762127	.	A	G	0	0	0	0	1	1	0	0
7	38773039	.	C	T	3	3	6	0	1	7	0	0
7	38775075	.	A	G	3	0	3	0	1	4	0	0
7	38775078	.	C	T	4	0	4	0	0	4	0	0
7	38777082	.	C	T	5	4	9	0	1	10	0	0
7	38779759	.	A	G	9	0	9	0	7	16	0	0
7	38783439	.	C	T	25	17	42	0	0	42	0	0
7	38783644	.	A	G	16	18	34	0	1	35	0	0
7	38783742	.	G	A	22	16	38	0	2	40	0	0
7	38783972	.	T	C	12	7	19	0	2	21	0	0
7	38784439	.	A	G	10	19	29	0	0	29	0	0
7	38784648	.	A	G	38	23	61	0	0	61	0	0
7	38784766	.	C	A	27	12	39	0	1	40	0	0
7	38784786	.	T	A	14	30	44	0	1	45	0	0
7	38784818	.	G	A	32	17	49	0	2	51	0	0
7	38784976	.	T	A	19	26	45	0	0	45	0	0
7	38785069	.	C	T	25	21	46	0	1	47	0	0
7	38785182	.	G	C	0	18	18	0	24	42	0	0
7	38785224	.	G	A	0	20	20	0	23	43	0	0
7	38794090	.	T	G	19	18	37	0	0	37	0	0
7	38794235	.	C	T	18	13	31	0	0	31	0	0
7	38798630	.	A	G	2	2	4	0	0	4	0	0
7	38805508	.	T	G	1	0	1	0	0	1	0	0
7	38807677	.	T	G	8	0	8	0	0	8	0	0
7	38807714	.	G	A	5	10	15	0	0	15	0	0
7	38807723	.	A	T	7	9	16	0	1	17	0	0
7	38807797	.	G	A	8	3	11	0	0	11	0	0
7	38809508	.	C	T	2	2	4	0	3	7	0	0
7	38809865	.	G	T	0	7	7	0	6	13	0	0
7	38810084	.	A	C	2	3	5	0	0	5	0	0
7	38810518	.	A	G	1	0	1	0	4	5	0	0
7	38821256	.	T	C	2	2	4	0	0	4	0	0
7	38822327	.	C	T	5	7	12	0	2	14	0	0
7	38822368	.	A	T	4	7	11	0	0	11	0	0
7	38822523	.	G	A	7	4	11	0	0	11	0	0
7	38822528	.	C	A	0	5	5	0	5	10	0	0
7	38822559	.	C	T	0	2	2	0	4	6	0	0
7	38822825	.	T	C	3	4	7	0	0	7	0	0
7	38824387	.	C	G	5	7	12	0	0	12	0	0
7	38827635	.	T	A	1	0	1	0	0	1	0	0
7	38842502	.	C	T	0	3	3	0	5	8	0	0
7	38954102	.	T	C	4	5	9	0	0	9	0	0
7	38954158	.	T	A	2	3	5	0	0	5	0	0
7	39100137	.	C	A	1	1	2	0	0	2	0	0
7	39123095	.	G	A	0	1	1	0	3	4	0	0
7	39153769	.	C	A	5	7	12	0	0	12	0	0
7	39153849	.	G	A	0	2	2	0	7	9	0	0
7	39153975	.	G	A	2	5	7	0	2	9	0	0
7	39154119	.	C	T	5	6	11	0	0	11	0	0
7	39154181	.	A	T	3	5	8	0	0	8	0	0
7	39154272	.	A	T	1	7	8	0	1	9	0	0
7	39154971	.	C	T	4	3	7	0	0	7	0	0
7	39155099	.	C	T	2	6	8	0	0	8	0	0
7	39155115	.	T	C	4	7	11	0	0	11	0	0
7	39155163	.	C	A	6	6	12	0	0	12	0	0
7	39155298	.	A	G	4	2	6	0	0	6	0	0
7	39155344	.	G	A	5	6	11	0	1	12	0	0
7	39155758	.	T	G	5	4	9	0	0	9	0	0
7	39155940	.	T	A	4	8	12	0	0	12	0	0
7	39156140	.	T	C	8	10	18	0	0	18	0	0
7	39156161	.	C	T	12	8	20	0	1	21	0	0
7	39156207	.	T	C	9	12	21	0	1	22	0	0
7	39156474	.	T	C	11	11	22	0	1	23	0	0
7	39156553	.	C	A	15	12	27	0	2	29	0	0
7	39156673	.	A	T	11	2	13	0	0	13	0	0
7	39156760	.	A	G	15	8	23	0	1	24	0	0
7	39157175	.	A	T	11	10	21	0	2	23	0	0
7	39157219	.	G	A	0	7	7	0	10	17	0	0
7	39157239	.	C	A	7	11	18	0	1	19	0	0
7	39174052	.	T	C	2	3	5	0	1	6	0	0
7	39174452	.	G	A	0	13	13	0	13	26	0	0
7	39176261	.	G	A	0	14	14	0	12	26	0	0
7	39176444	.	G	A	1	23	24	0	22	46	0	0
7	39176447	.	A	C	17	26	43	0	2	45	0	0
7	39176739	.	A	T	11	14	25	0	1	26	0	0
7	39176863	.	G	A	10	27	37	0	1	38	0	0
7	39176881	.	G	A	29	7	36	0	2	38	0	0
7	39176940	.	A	G	6	12	18	1	0	19	0	0
7	39176957	.	A	G	3	12	15	0	0	15	0	0
7	39176983	.	T	C	4	7	11	0	3	14	0	0
7	39177729	.	A	G	9	17	26	0	2	28	0	0
7	39177871	.	C	A	3	11	14	0	0	14	0	0
7	39178065	.	A	G	2	9	11	0	2	13	0	0
7	39178123	.	A	G	1	3	4	0	0	4	0	0
7	39181318	.	C	T	24	11	35	0	0	35	0	0
7	39181597	.	C	A	19	15	34	0	1	35	0	0
7	39181853	.	C	A	5	12	17	0	0	17	0	0
7	39182265	.	T	C	17	9	26	0	0	26	0	0
7	39182433	.	T	C	12	17	29	0	0	29	0	0
7	39182910	.	G	A	10	8	18	0	0	18	0	0
7	39183045	.	A	G	6	9	15	0	0	15	0	0
7	39474551	.	A	G	0	5	5	0	0	5	0	0
7	39482671	.	C	G	0	4	4	0	2	6	0	0
7	39482674	.	G	C	1	0	1	0	4	5	0	0
7	39537921	.	A	T	2	2	4	0	0	4	0	0
7	39537983	.	C	G	4	9	13	0	0	13	0	0
7	39538001	.	T	C	11	3	14	0	0	14	0	0
7	39538153	.	T	C	2	3	5	0	0	5	0	0
7	39541293	.	T	G	0	2	2	0	0	2	0	0
7	39541452	.	A	C	2	2	4	0	0	4	0	0
7	39548697	.	G	A	1	1	2	0	0	2	0	0
7	39552198	.	G	A	1	2	3	0	0	3	0	0
7	39643001	.	G	A	0	2	2	0	0	2	0	0
7	39648980	.	A	G	0	1	1	0	0	1	0	0
7	39649070	.	C	T	4	2	6	0	0	6	0	0
7	39654722	.	C	T	8	5	13	0	1	14	0	0
7	39655392	.	T	G	5	4	9	0	0	9	0	0
7	39655586	.	C	G	3	4	7	0	0	7	0	0
7	39656372	.	C	T	3	2	5	0	0	5	0	0
7	39658224	.	A	C	13	5	18	0	0	18	0	0
7	39658293	.	C	A	6	6	12	0	1	13	0	0
7	39658356	.	T	C	7	9	16	0	0	16	0	0
7	39658445	.	C	A	9	8	17	0	2	19	0	0
7	39658730	.	G	T	1	12	13	0	19	32	0	0
7	39658831	.	T	G	8	19	27	0	2	29	0	0
7	39659275	.	A	C	3	3	6	0	0	6	0	0
7	39659400	.	T	A	4	3	7	0	0	7	0	0
7	39659758	.	C	A	0	4	4	0	0	4	0	0
7	39659806	.	G	A	3	6	9	0	2	11	0	0
7	39659973	.	A	G	8	7	15	0	0	16	1	0
7	39660054	.	A	C	5	10	15	0	1	16	0	0
7	39660201	.	G	A	16	17	33	0	3	36	0	0
7	39660249	.	A	C	13	24	37	0	0	37	0	0
7	39670892	.	G	C	7	8	15	0	0	15	0	0
7	39671118	.	T	A	4	4	8	0	0	8	0	0
7	39671281	.	G	A	5	8	13	0	0	13	0	0
7	39671647	.	C	T	1	8	9	0	1	10	0	0
7	39671715	.	A	C	4	4	8	0	0	8	0	0
7	39672054	.	A	T	6	7	13	0	0	13	0	0
7	39672165	.	G	A	5	4	9	0	1	10	0	0
7	39672741	.	A	G	9	4	13	0	0	13	0	0
7	39673095	.	A	G	5	0	5	0	12	17	0	0
7	39673773	.	G	C	1	11	12	0	4	16	0	0
7	39675838	.	A	G	8	3	11	0	3	14	0	0
7	39676183	.	T	A	8	3	11	0	1	12	0	0
7	39676364	.	T	G	3	9	12	0	1	13	0	0
7	39676365	.	C	T	3	10	13	0	0	13	0	0
7	39676446	.	A	T	7	7	14	0	1	15	0	0
7	39676518	.	A	G	5	9	14	0	0	14	0	0
7	39676833	.	T	C	14	10	24	0	1	25	0	0
7	39677347	.	G	A	8	17	25	0	1	26	0	0
7	39677948	.	G	T	8	17	25	0	0	25	0	0
7	39691119	.	G	A	0	3	3	0	8	11	0	0
7	39691357	.	G	A	4	6	10	0	1	11	0	0
7	39695776	.	A	C	0	2	2	0	0	2	0	0
7	39701913	.	A	C	2	8	10	0	0	10	0	0
7	39702337	.	C	A	5	7	12	0	0	12	0	0
7	39702800	.	C	T	1	4	5	0	0	5	0	0
7	39703792	.	A	G	2	2	4	0	0	4	0	0
7	39704063	.	T	A	5	9	14	0	0	14	0	0
7	39704085	.	A	G	6	7	13	0	1	14	0	0
7	39704166	.	A	T	8	5	13	0	0	13	0	0
7	39705601	.	A	G	9	4	13	0	0	13	0	0
7	39705683	.	T	A	7	0	7	0	0	7	0	0
7	39730698	.	T	A	1	2	3	0	0	3	0	0
7	39731015	.	T	A	2	2	4	0	0	4	0	0
7	39740651	.	A	G	1	5	6	0	0	6	0	0
7	39741767	.	G	A	1	3	4	0	0	4	0	0
7	39742841	.	A	T	3	12	15	0	0	15	0	0
7	39743014	.	A	G	2	1	3	0	7	10	0	0
7	39743126	.	G	A	4	8	12	0	0	12	0	0
7	39743358	.	G	A	2	3	5	0	0	5	0	0
7	39744543	.	G	A	4	4	8	0	0	8	0	0
7	39745091	.	T	C	4	7	11	0	1	12	0	0
7	39745110	.	A	T	7	9	16	0	1	17	0	0
7	39748847	.	T	C	1	3	4	0	0	4	0	0
7	39748934	.	A	C	8	9	17	0	0	17	0	0
7	40046734	.	T	C	1	1	2	0	0	2	0	0
7	40053306	.	G	A	1	1	2	0	0	2	0	0
7	40053490	.	T	C	4	2	6	0	0	6	0	0
7	40053537	.	C	T	6	10	16	0	0	16	0	0
7	40053717	.	T	A	7	6	13	0	0	13	0	0
7	40053720	.	G	A	6	7	13	0	0	13	0	0
7	40053978	.	C	T	4	6	10	0	1	11	0	0
7	40054464	.	A	C	1	2	3	0	1	4	0	0
7	40054814	.	C	T	3	4	7	0	0	8	1	0
7	40054901	.	G	T	4	6	10	0	0	10	0	0
7	40054925	.	G	T	0	3	3	0	8	11	0	0
7	40055080	.	T	C	9	8	17	0	0	17	0	0
7	40055099	.	C	T	8	7	15	0	0	15	0	0
7	40055117	.	T	A	5	3	8	0	0	8	0	0
7	40055178	.	C	G	2	10	12	0	0	12	0	0
7	40055353	.	A	G	3	0	3	0	7	10	0	0
7	40055612	.	C	T	6	7	13	0	0	13	0	0
7	40055628	.	G	A	7	7	14	0	2	16	0	0
7	40055672	.	G	A	8	8	16	0	1	17	0	0
7	40055711	.	A	T	5	4	9	0	0	9	0	0
7	40055844	.	C	T	6	9	15	0	0	15	0	0
7	40056060	.	C	T	6	10	16	0	1	17	0	0
7	40056112	.	T	G	11	10	21	0	0	21	0	0
7	40056307	.	C	T	11	6	17	0	1	18	0	0
7	40056353	.	G	A	10	9	19	0	1	20	0	0
7	40056417	.	C	A	6	7	13	0	0	13	0	0
7	40056542	.	A	T	8	8	16	0	0	16	0	0
7	40056587	.	C	T	8	12	20	0	0	20	0	0
7	40056589	.	T	C	8	12	20	0	0	20	0	0
7	40056729	.	A	T	12	6	18	0	2	20	0	0
7	40056851	.	T	C	4	9	13	0	0	13	0	0
7	40056854	.	C	T	8	4	12	0	1	13	0	0
7	40056982	.	C	T	2	2	4	0	0	4	0	0
7	40057140	.	G	A	12	5	17	0	0	17	0	0
7	40057393	.	C	T	10	6	16	0	0	16	0	0
7	40057581	.	T	G	9	11	20	0	1	21	0	0
7	40057674	.	A	G	3	4	7	0	1	8	0	0
7	40059207	.	G	A	10	5	15	0	0	15	0	0
7	40059248	.	T	C	13	6	19	0	2	21	0	0
7	40059673	.	G	A	2	2	4	0	3	7	0	0
7	40059983	.	T	C	0	1	1	0	0	1	0	0
7	40060083	.	C	T	1	4	5	0	6	11	0	0
7	40060089	.	C	G	7	3	10	0	0	10	0	0
7	40060505	.	C	T	2	3	5	0	0	5	0	0
7	40060543	.	A	T	2	2	4	0	0	4	0	0
7	40064621	.	G	C	2	1	3	0	0	3	0	0
7	40070301	.	G	A	4	7	11	0	1	12	0	0
7	40070531	.	C	G	3	3	6	0	0	6	0	0
7	40071776	.	G	A	2	2	4	0	1	5	0	0
7	40071978	.	G	A	2	2	4	0	1	5	0	0
7	40072371	.	T	G	6	5	11	0	0	11	0	0
7	40074825	.	A	G	0	1	1	0	0	1	0	0
7	40076634	.	T	C	6	0	6	0	5	11	0	0
7	40076782	.	A	G	2	4	6	0	0	6	0	0
7	40079824	.	A	C	0	0	0	0	3	3	0	0
7	40081813	.	C	T	3	2	5	0	3	8	0	0
7	40083683	.	T	A	10	11	21	0	1	22	0	0
7	40083762	.	C	G	4	5	9	0	1	10	0	0
7	40083786	.	A	T	3	6	9	0	2	11	0	0
7	40083815	.	T	A	6	4	10	0	1	11	0	0
7	40090547	.	T	A	4	8	12	0	1	13	0	0
7	40090602	.	T	C	19	13	32	0	1	33	0	0
7	40091010	.	A	T	1	4	5	0	0	5	0	0
7	40091190	.	C	T	1	2	3	0	0	3	0	0
7	40091332	.	C	A	5	5	10	0	0	10	0	0
7	40091460	.	C	T	7	4	11	0	2	13	0	0
7	40091510	.	G	T	2	2	4	0	1	5	0	0
7	40091543	.	T	C	1	2	3	0	1	4	0	0
7	40091552	.	A	T	2	2	4	0	1	5	0	0
7	40091622	.	C	G	12	3	15	0	0	15	0	0
7	40091718	.	G	A	16	9	25	0	1	26	0	0
7	40091749	.	T	C	15	13	28	0	0	28	0	0
7	40091818	.	T	G	11	13	24	0	2	26	0	0
7	40091951	.	A	T	2	4	6	0	0	6	0	0
7	40094092	.	T	A	0	1	1	0	0	1	0	0
7	40094359	.	C	A	0	0	0	0	1	1	0	0
7	40097105	.	A	C	4	6	10	0	2	12	0	0
7	40097271	.	C	G	9	3	12	0	0	12	0	0
7	40097395	.	A	G	4	4	8	0	0	8	0	0
7	40097396	.	T	C	4	4	8	0	0	8	0	0
7	40097602	.	A	G	4	0	4	0	3	7	0	0
7	40097681	.	T	A	7	3	10	0	0	10	0	0
7	40100168	.	A	C	5	1	6	0	0	6	0	0
7	40100294	.	C	T	3	2	5	0	0	5	0	0
7	40100357	.	C	T	1	3	4	0	0	4	0	0
7	40100575	.	G	A	0	2	2	0	6	8	0	0
7	40100591	.	G	A	4	2	6	0	0	6	0	0
7	40100976	.	C	T	2	5	7	0	0	7	0	0
7	40101389	.	G	T	1	1	2	0	0	2	0	0
7	40102457	.	C	A	0	3	3	0	0	3	0	0
7	40102481	.	A	T	1	2	3	0	0	3	0	0
7	40123989	.	T	C	4	0	4	0	4	8	0	0
7	40138766	.	A	T	1	2	3	0	0	3	0	0
7	40138794	.	C	T	1	1	2	0	0	2	0	0
7	40138808	.	C	T	1	1	2	0	0	2	0	0
7	40140213	.	A	T	1	0	1	0	0	1	0	0
7	40140399	.	T	C	3	2	5	0	0	5	0	0
7	40144195	.	C	T	2	1	3	0	1	4	0	0
7	40144329	.	T	A	2	2	4	0	0	4	0	0
7	40144339	.	C	T	2	2	4	0	0	4	0	0
7	40145032	.	A	T	1	1	2	0	0	2	0	0
7	40188991	.	C	T	4	5	9	0	2	11	0	0
7	40197623	.	C	A	1	1	2	0	0	2	0	0
7	40200740	.	G	A	3	3	6	0	0	6	0	0
7	40201016	.	C	T	2	6	8	0	0	8	0	0
7	40201108	.	G	T	4	12	16	0	0	16	0	0
7	40201200	.	G	A	6	3	9	0	1	10	0	0
7	40201296	.	C	T	1	3	4	0	1	5	0	0
7	40201975	.	A	G	6	7	13	0	1	14	0	0
7	40228499	.	A	T	6	11	17	0	0	17	0	0
7	40292834	.	T	C	0	2	2	0	0	2	0	0
7	40318309	.	T	A	8	10	18	0	0	18	0	0
7	40318486	.	A	G	12	0	12	0	14	26	0	0
7	40318580	.	G	T	3	15	18	0	0	18	0	0
7	40318593	.	G	A	3	10	13	0	4	17	0	0
7	40321174	.	C	T	11	18	29	0	0	29	0	0
7	40321224	.	A	G	10	14	24	0	0	24	0	0
7	40321273	.	G	T	17	17	34	0	0	34	0	0
7	40321443	.	C	T	8	8	16	0	0	16	0	0
7	40460256	.	T	C	6	7	13	0	0	13	0	0
7	40460371	.	C	T	23	16	39	0	0	39	0	0
7	40466026	.	A	G	14	15	29	0	0	29	0	0
7	40471301	.	A	G	5	9	14	0	0	14	0	0
7	40492740	.	T	A	3	4	7	0	0	7	0	0
7	40492764	.	G	C	1	5	6	0	1	7	0	0
7	40492789	.	T	C	1	3	4	0	0	4	0	0
7	40492800	.	G	T	1	2	3	0	1	4	0	0
7	40498598	.	G	A	27	22	49	0	2	51	0	0
7	40498934	.	C	A	30	26	56	0	1	57	0	0
7	40499177	.	A	C	8	15	23	0	1	24	0	0
7	40499182	.	A	G	8	13	21	0	0	21	0	0
7	40537064	.	A	G	1	2	3	0	0	3	0	0
7	40560398	.	C	T	2	4	6	0	0	6	0	0
7	40560934	.	G	A	14	11	25	0	0	25	0	0
7	40562662	.	C	T	0	1	1	0	1	2	0	0
7	40562743	.	G	A	1	1	2	0	0	2	0	0
7	40562757	.	T	G	1	0	1	0	0	1	0	0
7	40567075	.	T	C	0	1	1	0	1	2	0	0
7	40569966	.	G	A	3	1	4	0	0	4	0	0
7	40578658	.	C	G	9	3	12	0	0	12	0	0
7	40584065	.	A	C	6	7	13	1	0	14	0	0
7	40584121	.	A	C	16	12	28	0	0	28	0	0
7	40584148	.	T	C	14	0	14	0	11	25	0	0
7	40584395	.	G	C	18	8	26	0	0	26	0	0
7	40584415	.	G	C	17	8	25	0	2	27	0	0
7	40584469	.	C	T	5	8	13	0	0	13	0	0
7	40584988	.	A	C	4	3	7	0	2	9	0	0
7	40585112	.	A	G	2	4	6	0	0	6	0	0
7	40585217	.	T	C	7	5	12	0	0	12	0	0
7	40585546	.	A	T	7	5	12	0	0	12	0	0
7	40602439	.	G	A	6	2	8	0	1	9	0	0
7	40607911	.	T	A	1	2	3	0	0	3	0	0
7	40608459	.	T	C	0	0	0	0	1	1	0	0
7	40616896	.	A	G	2	3	5	0	0	5	0	0
7	40645217	.	A	G	0	1	1	0	0	1	0	0
7	40650862	.	G	T	1	3	4	0	0	4	0	0
7	40650869	.	G	A	1	2	3	0	0	3	0	0
7	40707966	.	G	A	0	2	2	0	3	5	0	0
7	40708059	.	A	G	3	3	6	0	0	6	0	0
7	40728086	.	T	C	0	1	1	0	0	1	0	0
7	40884570	.	T	C	3	2	5	0	0	5	0	0
7	40889981	.	C	T	6	3	9	0	0	9	0	0
7	40890410	.	A	G	5	6	11	0	0	11	0	0
7	40890678	.	G	A	6	11	17	0	0	17	0	0
7	40900772	.	G	A	12	6	18	0	3	21	0	0
7	40900785	.	C	A	0	13	13	0	9	22	0	0
7	40901126	.	A	T	4	3	7	0	0	7	0	0
7	40901425	.	T	A	1	2	3	0	1	4	0	0
7	40901436	.	G	A	3	3	6	0	0	6	0	0
7	40901584	.	A	C	2	5	7	0	0	7	0	0
7	40901592	.	T	C	5	2	7	0	0	7	0	0
7	40901628	.	A	G	2	4	6	0	0	6	0	0
7	40901779	.	C	G	4	6	10	0	1	11	0	0
7	40901945	.	T	C	3	6	9	0	0	9	0	0
7	40902205	.	G	A	0	3	3	0	0	3	0	0
7	40903491	.	T	A	7	8	15	0	1	16	0	0
7	40904129	.	T	A	2	2	4	0	0	4	0	0
7	40904446	.	C	T	1	1	2	0	0	2	0	0
7	40904666	.	C	G	1	2	3	0	0	3	0	0
7	40904762	.	T	A	3	2	5	0	1	6	0	0
7	40905695	.	A	T	13	5	18	0	1	19	0	0
7	40905774	.	C	T	0	9	9	0	11	20	0	0
7	40906286	.	T	C	11	5	16	0	1	17	0	0
7	40906377	.	T	C	4	2	6	0	0	6	0	0
7	40906415	.	T	A	3	3	6	0	0	6	0	0
7	40931873	.	T	A	2	3	5	0	2	7	0	0
7	40931874	.	C	T	0	3	3	0	4	7	0	0
7	40989156	.	A	G	8	6	14	0	1	15	0	0
7	40990473	.	G	C	4	4	8	0	0	8	0	0
7	40990589	.	T	A	2	4	6	0	0	6	0	0
7	40993298	.	G	A	4	5	9	0	0	9	0	0
7	41008076	.	T	A	2	4	6	0	0	6	0	0
7	41008618	.	T	C	7	13	20	0	2	22	0	0
7	41008856	.	C	T	0	14	14	0	18	32	0	0
7	41009217	.	C	T	1	12	13	0	17	30	0	0
7	41009797	.	T	A	13	26	39	0	0	39	0	0
7	41012081	.	A	T	5	7	12	0	0	12	0	0
7	41012505	.	C	T	0	2	2	0	9	11	0	0
7	41014175	.	C	T	4	4	8	0	1	9	0	0
7	41081943	.	T	A	1	2	3	0	0	3	0	0
7	41082391	.	T	G	4	3	7	0	0	7	0	0
7	41094385	.	C	T	1	3	4	0	0	4	0	0
7	41094469	.	T	C	1	0	1	0	2	3	0	0
7	41147792	.	A	G	1	0	1	0	1	2	0	0
7	41157531	.	G	C	11	16	27	0	3	30	0	0
7	41157735	.	T	C	21	18	39	0	1	40	0	0
7	41157805	.	C	A	13	24	37	0	0	37	0	0
7	41157997	.	G	A	21	9	30	0	0	30	0	0
7	41158057	.	C	T	14	8	22	0	0	22	0	0
7	41223561	.	C	T	1	0	1	0	0	1	0	0
7	41229427	.	T	C	2	2	4	0	0	4	0	0
7	41238313	.	C	T	1	0	1	0	0	1	0	0
7	41250813	.	T	C	1	1	2	0	0	2	0	0
7	41255443	.	A	T	1	0	1	0	0	1	0	0
7	41257549	.	G	T	4	2	6	0	0	6	0	0
7	41258015	.	T	C	4	4	8	0	1	9	0	0
7	41261343	.	C	A	3	2	5	0	0	5	0	0
7	41262058	.	T	G	1	1	2	0	0	2	0	0
7	41262277	.	A	G	9	11	20	0	0	20	0	0
7	41262361	.	G	A	1	3	4	0	0	4	0	0
7	41263277	.	G	A	0	4	4	0	4	8	0	0
7	41273527	.	T	C	9	7	16	0	0	16	0	0
7	41273889	.	T	C	10	7	17	0	1	18	0	0
7	41274080	.	T	G	8	12	20	0	0	20	0	0
7	41274258	.	T	C	10	12	22	0	0	22	0	0
7	41274261	.	A	G	10	1	11	0	11	22	0	0
7	41274802	.	C	A	17	10	27	0	5	32	0	0
7	41274896	.	A	C	14	9	23	0	5	28	0	0
7	41274916	.	A	C	15	12	27	0	0	27	0	0
7	41274943	.	T	A	15	14	29	0	0	29	0	0
7	41313645	.	G	A	1	4	5	0	0	5	0	0
7	41313853	.	C	A	6	4	10	0	0	10	0	0
7	41313894	.	G	C	3	9	12	0	0	12	0	0
7	41313920	.	C	A	2	6	8	0	0	8	0	0
7	41314900	.	G	T	1	1	2	0	0	2	0	0
7	41318020	.	A	G	3	2	5	0	0	5	0	0
7	41318023	.	A	T	3	2	5	0	0	5	0	0
7	41318087	.	A	T	2	6	8	0	0	8	0	0
7	41322946	.	G	A	0	2	2	0	0	2	0	0
7	41329433	.	G	C	2	3	5	0	0	5	0	0
7	41329674	.	T	G	1	6	7	0	0	7	0	0
7	41329683	.	A	G	1	6	7	0	0	7	0	0
7	41329736	.	C	T	5	4	9	0	0	9	0	0
7	41330517	.	A	C	3	4	7	0	0	7	0	0
7	41333320	.	G	T	1	1	2	0	0	2	0	0
7	41340562	.	C	T	1	2	3	0	0	3	0	0
7	41340840	.	C	A	0	3	3	0	0	3	0	0
7	41344440	.	T	A	2	2	4	0	0	4	0	0
7	41345059	.	G	A	1	2	3	0	0	3	0	0
7	41345105	.	C	T	3	3	6	0	0	6	0	0
7	41345123	.	C	T	2	3	5	0	0	5	0	0
7	41345282	.	A	C	1	7	8	0	1	9	0	0
7	41345463	.	T	G	1	3	4	0	0	4	0	0
7	41345720	.	G	A	2	3	5	0	0	5	0	0
7	41345723	.	T	C	2	4	6	0	0	6	0	0
7	41345828	.	G	T	8	5	13	0	0	13	0	0
7	41347123	.	A	G	2	0	2	0	2	4	0	0
7	41347138	.	C	T	2	3	5	0	0	5	0	0
7	41347642	.	T	C	5	5	10	0	1	11	0	0
7	41347813	.	C	T	8	4	12	0	0	12	0	0
7	41348023	.	C	T	3	2	5	0	0	5	0	0
7	41348026	.	T	C	3	2	5	0	0	5	0	0
7	41349128	.	C	T	0	4	4	0	4	8	0	0
7	41349454	.	G	T	5	7	12	0	1	13	0	0
7	41353258	.	G	A	4	5	9	0	0	9	0	0
7	41355308	.	T	C	4	2	6	0	0	6	0	0
7	41356188	.	A	G	1	2	3	0	1	4	0	0
7	41356547	.	C	T	1	5	6	0	0	6	0	0
7	41357623	.	G	C	2	1	3	0	0	3	0	0
7	41358708	.	C	T	1	2	3	0	0	3	0	0
7	41359987	.	A	T	3	2	5	0	1	6	0	0
7	41363014	.	C	G	0	3	3	0	0	3	0	0
7	41363065	.	T	C	0	1	1	0	0	1	0	0
7	41367337	.	G	A	1	0	1	0	0	1	0	0
7	41401851	.	C	T	4	3	7	0	0	7	0	0
7	41401881	.	T	C	4	1	5	0	0	5	0	0
7	41402943	.	C	G	4	3	7	0	1	8	0	0
7	41402988	.	G	C	3	3	6	0	0	6	0	0
7	41404081	.	C	T	12	3	15	0	1	16	0	0
7	41404090	.	T	C	9	4	13	0	2	15	0	0
7	41404552	.	G	A	7	3	10	0	0	10	0	0
7	41404564	.	A	G	8	3	11	0	0	11	0	0
7	41406005	.	G	A	3	2	5	0	0	5	0	0
7	41413530	.	G	A	3	3	6	0	0	6	0	0
7	41413829	.	T	C	1	2	3	0	0	3	0	0
7	41413838	.	A	C	1	0	1	0	2	3	0	0
7	41416192	.	G	A	3	2	5	0	1	6	0	0
7	41419036	.	A	C	1	0	1	0	0	1	0	0
7	41419132	.	G	A	2	2	4	0	0	4	0	0
7	41419183	.	G	T	1	0	1	0	0	1	0	0
7	41422318	.	C	G	1	3	4	0	0	4	0	0
7	41427737	.	G	T	3	6	9	0	1	10	0	0
7	41430417	.	T	C	6	1	7	0	0	7	0	0
7	41431901	.	A	T	6	2	8	0	1	9	0	0
7	41431916	.	T	C	7	4	11	0	0	11	0	0
7	41432039	.	T	C	3	7	10	0	0	10	0	0
7	41432220	.	G	A	0	8	8	0	6	14	0	0
7	41432324	.	T	A	4	6	10	0	0	10	0	0
7	41432676	.	T	C	11	11	22	0	1	23	0	0
7	41432732	.	A	T	10	6	16	0	1	17	0	0
7	41432906	.	T	C	9	11	20	0	0	20	0	0
7	41433244	.	A	G	2	0	2	0	5	7	0	0
7	41433390	.	T	A	8	6	14	0	1	15	0	0
7	41436575	.	T	C	7	0	7	0	7	14	0	0
7	41436811	.	T	A	9	4	13	0	0	13	0	0
7	41436902	.	A	G	8	6	14	0	0	14	0	0
7	41436907	.	G	A	7	7	14	0	2	16	0	0
7	41437342	.	A	C	12	13	25	0	0	25	0	0
7	41437363	.	A	G	7	17	24	0	0	24	0	0
7	41437623	.	C	A	9	8	17	0	1	18	0	0
7	41437715	.	T	G	9	19	28	0	0	28	0	0
7	41437827	.	C	A	0	8	8	0	10	18	0	0
7	41437948	.	G	A	13	5	18	0	2	20	0	0
7	41438036	.	A	C	8	5	13	0	0	13	0	0
7	41438417	.	T	A	8	2	10	0	2	12	0	0
7	41438502	.	C	T	1	2	3	0	4	7	0	0
7	41438676	.	G	T	9	3	12	0	0	12	0	0
7	41438677	.	T	C	8	3	11	0	1	12	0	0
7	41438826	.	C	T	0	6	6	0	14	20	0	0
7	41438871	.	C	T	1	6	7	0	7	14	0	0
7	41438896	.	C	T	1	8	9	0	5	14	0	0
7	41438970	.	G	A	15	6	21	0	0	21	0	0
7	41439411	.	C	T	0	5	5	0	2	7	0	0
7	41443125	.	G	A	5	5	10	0	0	10	0	0
7	41443186	.	C	T	0	0	0	0	1	1	0	0
7	41491701	.	A	T	11	5	16	0	0	16	0	0
7	41491841	.	T	C	5	4	9	0	0	9	0	0
7	41498075	.	T	C	1	1	2	0	0	2	0	0
7	41500538	.	A	G	10	6	16	0	0	16	0	0
7	41500676	.	G	A	0	1	1	0	0	1	0	0
7	41501061	.	A	G	0	4	4	0	0	4	0	0
7	41501124	.	A	G	0	1	1	0	1	2	0	0
7	41503775	.	G	A	1	0	1	0	0	1	0	0
7	41506677	.	A	G	2	3	5	0	0	5	0	0
7	41506683	.	T	C	2	2	4	0	0	4	0	0
7	41517442	.	C	G	5	8	13	0	0	13	0	0
7	41517467	.	A	G	5	8	13	0	1	14	0	0
7	41517659	.	G	A	2	2	4	0	1	5	0	0
7	41517777	.	T	A	1	4	5	0	0	5	0	0
7	41517796	.	T	C	1	6	7	0	1	8	0	0
7	41517909	.	T	A	5	7	12	0	1	13	0	0
7	41517978	.	A	G	7	11	18	0	0	18	0	0
7	41518033	.	G	A	7	3	10	0	2	12	0	0
7	41518109	.	C	A	8	9	17	0	1	18	0	0
7	41518146	.	G	A	6	9	15	0	0	15	0	0
7	41518147	.	C	G	6	9	15	0	0	15	0	0
7	41518217	.	C	A	1	9	10	1	11	22	0	0
7	41518328	.	T	G	11	11	22	0	1	23	0	0
7	41518420	.	G	C	5	10	15	0	0	15	0	0
7	41518721	.	G	T	5	9	14	0	2	16	0	0
7	41518727	.	C	T	7	5	12	0	2	14	0	0
7	41518871	.	T	G	3	7	10	0	0	10	0	0
7	41518875	.	G	A	2	9	11	0	0	11	0	0
7	41519162	.	T	A	4	3	7	0	0	7	0	0
7	41519390	.	A	G	4	7	11	0	0	11	0	0
7	41636001	.	T	C	1	0	1	0	0	1	0	0
7	41713997	.	G	A	4	1	5	0	1	6	0	0
7	41714059	.	C	T	0	5	5	0	5	10	0	0
7	41714076	.	A	T	6	3	9	0	0	9	0	0
7	41714140	.	C	T	0	3	3	0	6	9	0	0
7	41714196	.	T	A	12	6	18	0	0	18	0	0
7	41714205	.	C	T	11	7	18	0	0	18	0	0
7	41714244	.	A	G	7	8	15	0	0	15	0	0
7	41714481	.	C	T	7	10	17	0	1	18	0	0
7	41714557	.	T	C	2	0	2	0	8	10	0	0
7	41714923	.	G	A	10	12	22	0	2	24	0	0
7	41715156	.	A	T	2	5	7	0	0	7	0	0
7	41715288	.	C	T	0	2	2	0	6	8	0	0
7	41715446	.	G	A	7	9	16	0	2	18	0	0
7	41715594	.	T	A	6	11	17	0	1	18	0	0
7	41715721	.	T	A	4	6	10	0	1	11	0	0
7	41715794	.	C	T	0	10	10	0	5	16	1	0
7	41726186	.	C	T	5	2	7	0	1	8	0	0
7	41726339	.	C	T	0	4	4	0	5	9	0	0
7	41726355	.	G	T	6	6	12	0	0	12	0	0
7	41748916	.	G	T	5	4	9	0	1	10	0	0
7	41749093	.	A	T	5	2	7	0	0	7	0	0
7	41749150	.	A	G	4	3	7	0	1	8	0	0
7	41751146	.	C	T	0	4	4	0	1	5	0	0
7	41751510	.	T	C	13	5	18	0	0	18	0	0
7	41751671	.	C	T	10	10	20	0	0	20	0	0
7	41752422	.	G	T	8	5	13	0	0	13	0	0
7	41752440	.	A	C	8	6	14	0	1	15	0	0
7	41752463	.	A	G	12	0	12	0	13	25	0	0
7	41752497	.	C	A	16	12	28	0	0	28	0	0
7	41752507	.	C	G	14	9	23	0	1	24	0	0
7	41752631	.	A	G	13	13	26	0	3	29	0	0
7	41752662	.	G	A	17	11	28	0	3	31	0	0
7	41752892	.	T	A	8	6	14	0	1	15	0	0
7	41752974	.	T	G	4	2	6	0	5	11	0	0
7	41753038	.	C	T	6	3	9	0	0	9	0	0
7	41753061	.	A	G	8	4	12	0	0	12	0	0
7	41753093	.	T	A	8	2	10	0	0	10	0	0
7	41753107	.	T	A	4	5	9	0	0	9	0	0
7	41753195	.	A	T	5	7	12	0	1	13	0	0
7	41757730	.	G	A	24	31	55	0	0	55	0	0
7	41773951	.	T	G	13	13	26	0	1	27	0	0
7	41774020	.	A	G	15	18	33	0	1	34	0	0
7	41774035	.	G	A	16	17	33	0	2	35	0	0
7	41774125	.	A	G	0	3	3	0	0	3	0	0
7	41780925	.	A	T	13	7	20	0	4	24	0	0
7	41791391	.	A	G	5	5	10	0	0	10	0	0
7	41791469	.	T	C	8	7	15	0	1	16	0	0
7	41791538	.	G	A	1	3	4	0	0	4	0	0
7	41791857	.	C	T	6	7	13	0	0	13	0	0
7	41791920	.	C	T	5	11	16	0	0	16	0	0
7	41805215	.	G	T	1	1	2	0	0	2	0	0
7	41805518	.	C	T	2	0	2	0	0	2	0	0
7	41805881	.	G	A	0	1	1	0	0	1	0	0
7	41873215	.	A	T	6	12	18	0	2	20	0	0
7	41873256	.	C	T	10	12	22	0	0	22	0	0
7	41873257	.	T	G	10	12	22	0	0	22	0	0
7	41873368	.	T	A	16	12	28	0	1	29	0	0
7	41873426	.	T	C	18	9	27	0	0	27	0	0
7	41873503	.	A	G	19	19	38	0	1	39	0	0
7	41873554	.	A	T	20	29	49	0	0	49	0	0
7	41873691	.	T	C	14	15	29	0	1	30	0	0
7	41875951	.	T	C	10	10	20	0	2	22	0	0
7	41896315	.	A	C	2	7	9	0	0	9	0	0
7	41899051	.	A	C	3	4	7	0	1	8	0	0
7	41899352	.	C	T	3	3	6	0	2	8	0	0
7	41899426	.	C	A	3	2	5	0	0	5	0	0
7	41899674	.	T	C	4	8	12	0	0	12	0	0
7	41900402	.	G	C	0	4	4	0	0	4	0	0
7	41900741	.	G	T	9	3	12	0	0	12	0	0
7	41900943	.	A	G	1	5	6	0	1	7	0	0
7	41900948	.	A	G	4	3	7	0	0	7	0	0
7	41901093	.	A	G	3	4	7	0	0	7	0	0
7	41901355	.	A	G	8	9	17	0	1	18	0	0
7	41903555	.	A	G	2	2	4	0	0	4	0	0
7	41903633	.	T	A	8	14	22	0	0	22	0	0
7	41903681	.	C	T	15	17	32	0	0	32	0	0
7	41903907	.	A	G	6	10	16	0	1	17	0	0
7	41904152	.	A	G	26	23	49	0	2	51	0	0
7	41904520	.	G	A	5	18	23	0	0	23	0	0
7	41911604	.	C	T	0	8	8	0	6	14	0	0
7	41957814	.	G	A	0	1	1	0	0	1	0	0
7	41995046	.	T	C	2	1	3	0	0	3	0	0
7	42068201	.	C	T	0	2	2	0	0	2	0	0
7	42096376	.	C	A	4	2	6	0	0	6	0	0
7	42096378	.	A	G	3	2	5	0	1	6	0	0
7	42096413	.	C	T	0	5	5	0	5	10	0	0
7	42125466	.	G	A	0	3	3	0	0	3	0	0
7	42125480	.	C	G	0	3	3	0	0	3	0	0
7	42267249	.	C	T	2	2	4	0	0	4	0	0
7	42267339	.	T	C	3	2	5	0	0	5	0	0
7	42323699	.	G	C	0	2	2	0	2	4	0	0
7	42338816	.	A	G	9	13	22	0	1	23	0	0
7	42345361	.	G	T	20	8	28	0	1	29	0	0
7	42345782	.	G	A	5	4	9	0	1	10	0	0
7	42545554	.	G	C	2	2	4	0	0	4	0	0
7	43174642	.	G	A	4	5	9	0	1	10	0	0
7	43309851	.	T	G	7	7	14	0	3	17	0	0
7	43309985	.	T	A	1	9	10	0	0	10	0	0
7	43760755	.	T	C	15	12	27	0	3	30	0	0
7	43760822	.	G	A	10	12	22	0	1	23	0	0
7	43760875	.	T	A	11	11	22	0	2	24	0	0
7	43760881	.	G	A	8	12	20	0	0	20	0	0
7	43761810	.	T	A	11	13	24	0	1	25	0	0
7	43765189	.	A	G	12	6	18	0	1	19	0	0
7	43765197	.	A	G	13	8	21	0	0	21	0	0
7	43765348	.	G	A	11	7	18	0	0	18	0	0
7	43775054	.	G	A	5	5	10	0	0	10	0	0
7	43778690	.	C	G	6	12	18	0	1	19	0	0
7	43781554	.	G	T	0	5	5	0	0	5	0	0
7	43787480	.	C	G	2	3	5	0	0	5	0	0
7	43840624	.	C	T	5	4	9	0	0	9	0	0
7	43840669	.	G	C	2	2	4	0	1	5	0	0
7	44588458	.	A	G	8	6	14	0	2	16	0	0
7	45400790	.	C	T	3	10	13	0	0	13	0	0
7	45402452	.	C	T	12	4	16	0	1	17	0	0
7	45402887	.	C	A	17	25	42	0	1	43	0	0
7	45402989	.	C	T	16	18	34	0	1	35	0	0
7	45403244	.	C	T	12	15	27	0	2	29	0	0
7	45403292	.	G	A	10	16	26	0	3	29	0	0
7	45403294	.	A	T	10	16	26	0	3	29	0	0
7	45403360	.	T	G	12	8	20	0	1	21	0	0
7	45403370	.	A	T	12	11	23	0	1	24	0	0
7	45403416	.	C	T	15	12	27	0	1	28	0	0
7	45403735	.	G	A	0	5	5	0	8	13	0	0
7	45403793	.	G	A	3	8	11	0	0	11	0	0
7	45404490	.	C	T	3	7	10	0	1	11	0	0
7	45405163	.	C	T	11	7	18	0	1	19	0	0
7	45405179	.	G	T	12	8	20	0	0	20	0	0
7	45405839	.	G	T	5	8	13	0	0	13	0	0
7	45405871	.	A	C	2	2	4	0	1	5	0	0
7	45405992	.	C	T	3	2	5	0	0	5	0	0
7	45840234	.	T	A	0	2	2	0	0	2	0	0
7	45966120	.	C	T	2	3	5	0	0	5	0	0
7	45971454	.	A	T	5	10	15	0	1	16	0	0
7	46004948	.	T	G	7	7	14	0	0	14	0	0
7	46004971	.	C	G	9	7	16	0	0	16	0	0
7	46004991	.	C	G	7	0	7	0	8	15	0	0
7	46009637	.	G	C	3	3	6	0	0	6	0	0
7	46373295	.	A	G	3	4	7	0	0	7	0	0
7	46373463	.	T	C	1	4	5	0	0	5	0	0
7	46374390	.	A	G	2	4	6	0	0	6	0	0
7	46430098	.	C	T	4	5	9	0	0	9	0	0
7	46430847	.	C	G	8	7	15	0	1	16	0	0
7	46431108	.	T	A	8	8	16	0	0	16	0	0
7	46431256	.	C	A	12	10	22	0	1	23	0	0
7	46431273	.	C	G	11	9	20	0	0	20	0	0
7	46431319	.	A	G	8	5	13	0	0	13	0	0
7	46431577	.	G	A	8	14	22	0	1	23	0	0
7	46486048	.	C	T	4	12	16	0	0	16	0	0
7	46486244	.	A	C	10	7	17	0	1	18	0	0
7	46486629	.	G	A	0	9	9	0	19	28	0	0
7	46486719	.	G	T	16	15	31	0	1	32	0	0
7	46487322	.	C	T	9	19	28	0	2	30	0	0
7	46728687	.	G	A	2	7	9	0	1	10	0	0
7	46728721	.	A	C	6	0	6	0	8	14	0	0
7	46728791	.	A	C	7	3	10	0	0	10	0	0
7	46729053	.	C	T	3	4	7	0	1	8	0	0
7	46729545	.	C	T	0	11	11	0	10	21	0	0
7	46730076	.	A	G	8	5	13	0	0	13	0	0
7	46730178	.	A	T	5	4	9	0	1	10	0	0
7	46730199	.	A	C	5	0	5	0	4	9	0	0
7	46730469	.	C	T	11	12	23	0	1	24	0	0
7	46730705	.	C	T	3	9	12	0	0	12	0	0
7	46730754	.	G	A	2	4	6	0	0	6	0	0
7	46730820	.	T	C	2	0	2	0	8	10	0	0
7	46731141	.	C	T	3	4	7	0	0	7	0	0
7	46731669	.	T	C	2	5	7	0	0	7	0	0
7	46732134	.	G	A	3	2	5	0	0	5	0	0
7	46732680	.	G	A	4	2	6	0	0	6	0	0
7	46782166	.	A	T	0	3	3	0	0	3	0	0
7	47265569	.	A	G	4	0	4	0	5	9	0	0
7	47265859	.	A	T	6	7	13	0	0	13	0	0
7	47265898	.	G	A	0	5	5	0	5	10	0	0
7	47358467	.	G	T	1	1	2	0	0	2	0	0
7	47410821	.	A	G	0	0	0	0	3	3	0	0
7	47410829	.	C	T	1	3	4	0	0	4	0	0
7	47411071	.	G	A	0	8	8	0	4	12	0	0
7	47411434	.	C	T	2	3	5	0	0	5	0	0
7	47411617	.	A	G	3	3	6	0	0	6	0	0
7	47411791	.	C	G	3	6	9	0	0	9	0	0
7	47411837	.	T	G	10	0	10	0	5	15	0	0
7	47411838	.	G	A	11	4	15	0	0	15	0	0
7	47411962	.	C	A	10	7	17	0	0	17	0	0
7	47412000	.	T	A	10	8	18	0	1	19	0	0
7	47412040	.	C	T	12	7	19	0	1	20	0	0
7	47412366	.	C	T	2	4	6	0	0	6	0	0
7	47412418	.	C	T	8	3	11	0	0	11	0	0
7	47412447	.	T	A	2	10	12	0	1	13	0	0
7	47412525	.	C	T	2	2	4	0	0	4	0	0
7	47413517	.	C	A	3	7	10	0	1	11	0	0
7	47413560	.	T	A	7	2	9	0	0	9	0	0
7	47413568	.	T	C	7	2	9	0	0	9	0	0
7	47413601	.	G	T	8	3	11	0	0	11	0	0
7	47413691	.	A	T	3	3	6	0	0	6	0	0
7	47413794	.	G	A	2	3	5	0	0	5	0	0
7	47413948	.	A	T	6	5	11	0	0	11	0	0
7	47414174	.	C	T	6	8	14	0	0	14	0	0
7	47414348	.	C	T	11	16	27	0	1	28	0	0
7	47416438	.	T	A	3	14	17	0	1	18	0	0
7	47416439	.	C	T	14	3	17	0	1	18	0	0
7	47416473	.	G	A	5	13	18	0	0	18	0	0
7	47416496	.	T	A	6	5	11	0	1	12	0	0
7	47416790	.	T	A	9	6	15	0	6	21	0	0
7	47416807	.	A	T	7	8	15	0	2	17	0	0
7	47416825	.	A	G	5	0	5	0	8	13	0	0
7	47416904	.	T	A	5	7	12	0	0	12	0	0
7	47417002	.	C	A	13	14	27	0	0	27	0	0
7	47417080	.	T	C	13	4	17	0	2	19	0	0
7	47417810	.	C	T	9	10	19	0	1	21	1	0
7	47417934	.	T	A	15	10	25	0	0	25	0	0
7	47418575	.	G	T	10	13	23	0	1	24	0	0
7	47418697	.	C	A	14	17	31	0	0	31	0	0
7	47418847	.	T	A	9	7	16	0	0	16	0	0
7	47419114	.	A	C	12	7	19	0	0	19	0	0
7	47419177	.	A	C	15	0	15	0	14	29	0	0
7	47419250	.	T	G	11	8	19	0	1	21	1	0
7	47419653	.	G	A	16	9	25	0	0	25	0	0
7	47419842	.	G	A	15	9	24	0	0	24	0	0
7	47420019	.	A	G	9	16	25	0	2	27	0	0
7	47421313	.	C	T	8	7	15	0	1	16	0	0
7	47448218	.	G	A	4	5	9	0	0	9	0	0
7	47462909	.	G	A	0	1	1	0	0	1	0	0
7	47488246	.	C	T	6	5	11	0	0	11	0	0
7	47507136	.	G	A	7	5	12	0	0	12	0	0
7	47563359	.	C	T	0	2	2	0	1	3	0	0
7	47563853	.	G	A	3	4	7	0	1	8	0	0
7	47596707	.	T	A	0	2	2	0	0	2	0	0
7	47614349	.	A	G	1	3	4	0	0	4	0	0
7	48041940	.	G	A	1	5	6	0	0	6	0	0
7	48041967	.	G	A	3	4	7	0	0	7	0	0
7	48042195	.	G	A	2	3	5	0	0	5	0	0
7	48042456	.	A	G	2	6	8	0	1	9	0	0
7	48042483	.	G	T	2	4	6	0	1	7	0	0
7	48054990	.	G	A	2	2	4	0	0	4	0	0
7	48063519	.	A	G	5	4	9	0	0	9	0	0
7	48063546	.	A	G	4	1	5	0	0	5	0	0
7	48253537	.	G	A	1	2	3	0	0	3	0	0
7	48288848	.	A	G	2	3	5	0	0	5	0	0
7	48291844	.	A	G	6	5	11	0	0	11	0	0
7	48291864	.	G	A	13	6	19	0	0	19	0	0
7	48295902	.	G	T	12	11	23	0	1	24	0	0
7	48295910	.	C	T	11	11	22	0	0	22	0	0
7	48296075	.	A	G	7	6	13	0	0	13	0	0
7	48300621	.	T	C	4	2	6	0	0	6	0	0
7	48300795	.	C	T	2	3	5	0	0	5	0	0
7	48302925	.	A	G	2	4	6	0	0	6	0	0
7	48303198	.	T	A	3	3	6	0	0	6	0	0
7	48303216	.	G	A	5	1	6	0	0	6	0	0
7	48303497	.	A	G	4	4	8	0	1	9	0	0
7	48304118	.	C	T	2	4	6	0	1	7	0	0
7	48304119	.	T	C	2	3	5	0	2	7	0	0
7	48304348	.	C	T	2	2	4	0	1	5	0	0
7	48304350	.	A	T	1	3	4	0	0	5	1	0
7	48304548	.	A	T	6	2	8	0	1	9	0	0
7	48327801	.	A	G	2	4	6	0	1	7	0	0
7	48327867	.	C	A	3	6	9	0	0	9	0	0
7	48327906	.	T	C	0	3	3	0	0	3	0	0
7	48327912	.	C	T	0	3	3	0	0	3	0	0
7	48342526	.	T	C	2	5	7	0	0	7	0	0
7	48342575	.	C	T	1	3	4	0	0	4	0	0
7	48347478	.	T	G	10	11	21	0	0	21	0	0
7	48347680	.	A	C	8	12	20	0	0	20	0	0
7	48348003	.	G	A	10	19	29	0	0	29	0	0
7	48348006	.	A	G	10	17	27	0	1	28	0	0
7	48348062	.	C	T	12	9	21	0	1	22	0	0
7	48348485	.	A	G	8	7	15	0	2	17	0	0
7	48348519	.	C	T	5	4	9	0	3	12	0	0
7	48348554	.	G	A	9	4	13	0	2	15	0	0
7	48353844	.	G	A	6	4	10	0	1	11	0	0
7	48358792	.	A	T	2	3	5	0	0	5	0	0
7	48369043	.	C	G	0	5	5	0	4	9	0	0
7	48369999	.	C	T	3	3	6	0	0	6	0	0
7	48370014	.	T	G	4	5	9	0	0	9	0	0
7	48391532	.	C	T	0	3	3	0	0	3	0	0
7	48460315	.	C	T	11	7	18	0	0	18	0	0
7	48482286	.	C	A	8	6	14	0	0	14	0	0
7	48482370	.	C	T	10	3	13	0	0	13	0	0
7	48482616	.	T	C	4	4	8	0	0	8	0	0
7	48483513	.	T	A	19	17	36	0	1	37	0	0
7	48484269	.	T	C	19	9	28	0	4	32	0	0
7	48484307	.	G	A	0	5	5	0	12	17	0	0
7	48484621	.	C	T	10	20	30	0	1	31	0	0
7	48664032	.	A	G	2	4	6	0	0	6	0	0
7	48720796	.	T	A	3	2	5	0	0	5	0	0
7	48721832	.	A	C	3	4	7	0	0	7	0	0
7	48722450	.	T	C	1	0	1	0	2	3	0	0
7	48787121	.	A	C	1	3	4	0	0	4	0	0
7	48788256	.	G	A	3	3	6	0	0	6	0	0
7	48788265	.	A	T	3	3	6	0	0	6	0	0
7	48788369	.	T	C	7	7	14	0	0	14	0	0
7	48788389	.	G	C	6	1	7	0	5	12	0	0
7	48788622	.	G	A	4	3	7	0	0	7	0	0
7	48788790	.	A	T	3	4	7	0	0	7	0	0
7	48788791	.	T	A	3	4	7	0	0	7	0	0
7	48788910	.	C	T	6	3	9	0	1	10	0	0
7	48788966	.	C	T	3	4	7	0	1	8	0	0
7	48790794	.	A	C	1	2	3	0	0	3	0	0
7	48805629	.	C	T	3	3	6	0	0	6	0	0
7	48809031	.	T	C	2	5	7	0	0	7	0	0
7	48811446	.	C	T	0	2	2	0	0	2	0	0
7	48818563	.	T	C	1	1	2	0	0	2	0	0
7	48820740	.	T	A	3	1	4	0	0	4	0	0
7	48820773	.	C	T	8	3	11	0	0	11	0	0
7	48821065	.	T	C	7	4	11	0	0	11	0	0
7	48821331	.	T	C	3	7	10	0	0	10	0	0
7	48821362	.	C	T	0	1	1	0	0	1	0	0
7	48823809	.	A	T	1	3	4	0	0	4	0	0
7	48829569	.	G	C	14	13	27	0	0	27	0	0
7	48829728	.	A	G	11	6	17	0	0	17	0	0
7	48829926	.	A	T	3	5	8	0	2	10	0	0
7	49036296	.	T	C	0	2	2	0	0	2	0	0
7	49046764	.	C	T	1	2	3	0	0	3	0	0
7	49049686	.	G	C	5	4	9	0	0	9	0	0
7	49051660	.	C	T	8	5	13	0	0	13	0	0
7	49052044	.	T	A	9	9	18	0	0	18	0	0
7	49052097	.	T	G	9	7	16	0	2	18	0	0
7	49052112	.	C	T	8	9	17	0	1	18	0	0
7	49052138	.	G	A	11	7	18	0	2	20	0	0
7	49052333	.	C	T	6	6	12	0	0	12	0	0
7	49052359	.	A	G	6	7	13	0	1	14	0	0
7	49052476	.	G	A	7	5	12	0	1	13	0	0
7	49052575	.	G	A	2	6	8	0	2	10	0	0
7	49052625	.	C	T	5	8	13	0	0	13	0	0
7	49052840	.	T	G	3	0	3	0	17	20	0	0
7	49053143	.	T	C	3	4	7	0	0	7	0	0
7	49053445	.	A	G	9	12	21	0	0	21	0	0
7	49053454	.	T	A	9	11	20	0	0	20	0	0
7	49053483	.	A	C	6	13	19	0	2	21	0	0
7	49053491	.	T	A	7	12	19	0	2	21	0	0
7	49054161	.	G	A	8	4	12	0	1	13	0	0
7	49054212	.	C	A	2	2	4	0	0	4	0	0
7	49054475	.	T	C	10	8	18	0	1	19	0	0
7	49054739	.	A	G	11	14	25	0	1	26	0	0
7	49054885	.	C	T	3	8	11	0	1	12	0	0
7	49054899	.	C	T	2	8	10	0	0	10	0	0
7	49054981	.	T	A	1	3	4	0	1	5	0	0
7	49054985	.	T	C	1	4	5	0	0	5	0	0
7	49055227	.	G	A	0	12	12	0	10	22	0	0
7	49055256	.	T	C	8	9	17	0	0	17	0	0
7	49079010	.	A	T	1	2	3	0	0	3	0	0
7	49079029	.	T	G	1	4	5	0	0	5	0	0
7	49251540	.	A	G	1	3	4	0	0	4	0	0
7	49257220	.	C	T	6	10	16	0	0	16	0	0
7	49257686	.	G	T	5	6	11	0	0	11	0	0
7	49257774	.	C	T	6	11	17	0	0	17	0	0
7	49257979	.	A	G	6	5	11	0	0	11	0	0
7	49258012	.	G	A	8	6	14	0	2	16	0	0
7	49258132	.	G	C	3	4	7	0	1	8	0	0
7	49258279	.	C	T	6	6	12	0	1	13	0	0
7	49269896	.	A	G	4	0	4	0	7	11	0	0
7	49269913	.	A	G	3	0	3	0	4	7	0	0
7	49271069	.	C	T	8	9	17	0	0	17	0	0
7	49271121	.	G	T	8	4	12	0	0	12	0	0
7	49271147	.	A	C	12	5	17	0	0	17	0	0
7	49271208	.	C	T	9	9	18	0	0	18	0	0
7	49273372	.	A	G	2	2	4	0	0	4	0	0
7	49320253	.	G	A	4	8	12	0	0	12	0	0
7	49320342	.	A	T	7	3	10	0	0	10	0	0
7	49324690	.	C	T	0	3	3	0	3	6	0	0
7	49325125	.	G	A	7	3	10	1	0	11	0	0
7	49325319	.	T	C	5	7	12	0	0	12	0	0
7	49325346	.	A	G	7	10	17	0	0	17	0	0
7	49338336	.	G	A	11	23	34	0	0	34	0	0
7	49355496	.	T	C	7	0	7	0	10	17	0	0
7	49357357	.	G	A	6	5	11	0	0	11	0	0
7	49358228	.	A	C	4	4	8	0	1	9	0	0
7	49619680	.	T	C	1	4	5	0	0	5	0	0
7	49620241	.	T	C	4	0	4	0	4	8	0	0
7	49620536	.	C	A	2	5	7	0	0	7	0	0
7	49624379	.	T	C	2	0	2	0	3	5	0	0
7	49638742	.	G	A	10	3	13	0	0	13	0	0
7	49638748	.	T	A	10	5	15	0	0	15	0	0
7	49638880	.	T	G	9	5	14	0	2	16	0	0
7	49639272	.	G	T	8	5	13	0	0	13	0	0
7	49639520	.	C	A	1	4	5	0	0	5	0	0
7	49639701	.	T	C	3	7	10	0	0	10	0	0
7	49639876	.	A	T	8	13	21	0	0	21	0	0
7	49639926	.	A	C	13	8	21	0	0	21	0	0
7	49640040	.	G	A	14	20	34	0	1	35	0	0
7	49716898	.	T	C	3	2	5	0	0	5	0	0
7	49716935	.	T	A	3	2	5	0	0	5	0	0
7	49799470	.	A	T	5	2	7	0	3	10	0	0
7	49799526	.	T	A	5	12	17	0	0	17	0	0
7	49799584	.	G	A	3	5	8	0	0	8	0	0
7	49799805	.	A	T	3	2	5	0	0	5	0	0
7	49800039	.	T	C	5	0	5	0	3	8	0	0
7	49800384	.	C	T	0	5	5	0	1	6	0	0
7	49844053	.	A	G	2	3	5	0	0	5	0	0
7	49844510	.	C	T	1	2	3	0	0	3	0	0
7	50053347	.	C	T	3	2	5	0	0	5	0	0
7	50109317	.	T	C	9	3	12	0	0	12	0	0
7	50110585	.	C	T	9	6	15	0	1	16	0	0
7	50111330	.	C	T	9	5	14	0	0	14	0	0
7	50112025	.	C	T	10	14	24	0	0	24	0	0
7	50112039	.	T	G	10	14	24	0	1	25	0	0
7	50112063	.	G	A	10	13	23	0	1	24	0	0
7	50112196	.	A	G	3	0	3	0	0	13	10	0
7	50112286	.	T	C	4	8	12	0	3	15	0	0
7	50112383	.	G	A	9	11	20	0	3	23	0	0
7	50112460	.	C	T	18	16	34	0	0	34	0	0
7	50112825	.	A	T	12	12	24	0	0	24	0	0
7	50112922	.	C	A	9	3	12	0	1	13	0	0
7	50228314	.	C	A	7	12	19	0	0	19	0	0
7	50228326	.	T	C	8	1	9	0	11	20	0	0
7	50228355	.	C	T	10	19	29	0	0	29	0	0
7	50228548	.	T	C	9	7	16	0	0	16	0	0
7	50228702	.	A	T	3	2	5	0	0	5	0	0
7	50228785	.	C	G	5	8	13	0	0	13	0	0
7	50228872	.	A	C	3	6	9	0	0	9	0	0
7	50229223	.	T	C	10	11	21	0	0	21	0	0
7	50272707	.	G	A	5	5	10	0	0	10	0	0
7	50272779	.	A	G	4	4	8	0	1	9	0	0
7	50277832	.	G	C	1	2	3	0	0	3	0	0
7	50277869	.	T	A	1	3	4	0	0	4	0	0
7	50277915	.	C	T	2	2	4	0	0	4	0	0
7	50295736	.	A	G	1	3	4	0	0	4	0	0
7	50295823	.	G	A	12	4	16	0	1	17	0	0
7	50295974	.	G	T	7	8	15	0	0	15	0	0
7	50295997	.	T	A	9	6	15	0	0	15	0	0
7	50296016	.	A	G	4	4	8	0	0	8	0	0
7	50296545	.	T	G	2	5	7	0	0	7	0	0
7	50296612	.	G	C	7	6	13	0	0	13	0	0
7	50296815	.	G	A	2	6	8	0	0	8	0	0
7	50296981	.	A	G	13	8	21	0	0	21	0	0
7	50299379	.	G	A	3	1	4	0	2	6	0	0
7	50310148	.	C	T	1	3	4	0	0	4	0	0
7	50323793	.	A	G	4	2	6	0	2	8	0	0
7	50323934	.	G	A	2	3	5	0	0	5	0	0
7	50323967	.	C	T	0	1	1	0	0	1	0	0
7	50324984	.	C	T	0	1	1	0	0	1	0	0
7	50325006	.	G	C	0	1	1	0	0	1	0	0
7	50328275	.	T	A	2	1	3	0	0	3	0	0
7	50330039	.	T	G	0	1	1	0	0	1	0	0
7	50330042	.	A	G	0	1	1	0	0	1	0	0
7	50338221	.	A	T	5	3	8	0	0	8	0	0
7	50349225	.	T	C	5	5	10	0	0	10	0	0
7	50376101	.	T	A	2	3	5	0	0	5	0	0
7	50376214	.	T	C	2	3	5	0	0	5	0	0
7	50376285	.	A	G	3	2	5	0	0	5	0	0
7	50376395	.	G	A	7	4	11	0	0	11	0	0
7	50376518	.	C	A	5	3	8	0	1	9	0	0
7	50376720	.	A	T	10	3	13	0	1	15	1	0
7	50376751	.	G	A	7	4	11	0	0	11	0	0
7	50377025	.	A	G	4	6	10	0	3	13	0	0
7	50377045	.	C	T	0	7	7	0	6	13	0	0
7	50383553	.	C	T	1	0	1	0	0	1	0	0
7	50388859	.	C	T	0	1	1	0	0	1	0	0
7	50388889	.	G	A	0	1	1	0	0	1	0	0
7	50389050	.	C	T	0	1	1	0	0	1	0	0
7	50395947	.	T	G	3	2	5	0	0	5	0	0
7	50396019	.	C	T	2	2	4	0	0	4	0	0
7	50399759	.	A	G	7	0	7	0	6	13	0	0
7	50399782	.	T	C	6	4	10	0	0	10	0	0
7	50400267	.	A	G	3	4	7	0	0	7	0	0
7	50407469	.	A	G	9	15	24	0	0	24	0	0
7	50407532	.	T	C	12	8	20	0	2	22	0	0
7	50407587	.	T	C	15	15	30	0	1	31	0	0
7	50407588	.	C	A	14	16	30	0	1	31	0	0
7	50407724	.	C	T	11	11	22	0	6	28	0	0
7	50410394	.	T	A	21	25	46	0	1	47	0	0
7	50410475	.	T	C	8	13	21	0	0	21	0	0
7	50475638	.	C	T	1	1	2	0	0	2	0	0
7	50476004	.	A	G	3	2	5	0	0	5	0	0
7	50476757	.	A	T	2	5	7	0	0	7	0	0
7	50476769	.	T	C	3	5	8	0	0	8	0	0
7	50548086	.	A	G	3	3	6	0	1	7	0	0
7	50828894	.	T	A	1	2	3	0	0	3	0	0
7	50829201	.	A	C	5	2	7	0	0	7	0	0
7	50829360	.	G	C	2	5	7	0	1	8	0	0
7	50829393	.	G	A	2	3	5	0	0	5	0	0
7	50830997	.	C	T	2	1	3	0	0	3	0	0
7	50833143	.	T	C	4	2	6	0	0	6	0	0
7	50834821	.	A	G	0	2	2	0	0	2	0	0
7	50836382	.	C	T	1	4	5	0	0	5	0	0
7	50836424	.	C	T	9	5	14	0	0	14	0	0
7	50837949	.	G	A	4	4	8	0	1	9	0	0
7	50838135	.	G	C	0	1	1	0	2	3	0	0
7	50838194	.	C	A	2	4	6	0	0	6	0	0
7	50838210	.	G	T	0	3	3	0	2	5	0	0
7	50838251	.	C	T	2	1	3	0	0	3	0	0
7	50840008	.	C	T	6	3	9	0	0	9	0	0
7	50840428	.	G	A	6	5	11	0	0	11	0	0
7	50840512	.	C	T	3	0	3	0	0	3	0	0
7	50841072	.	G	A	8	12	20	0	1	21	0	0
7	50841237	.	C	T	16	13	29	0	1	30	0	0
7	50841690	.	G	A	0	8	8	0	14	22	0	0
7	50841693	.	A	T	14	8	22	0	0	22	0	0
7	50843813	.	C	A	7	4	11	0	0	11	0	0
7	50843827	.	A	G	9	5	14	0	0	14	0	0
7	50844117	.	G	A	1	18	19	0	14	33	0	0
7	50844142	.	G	A	16	14	30	0	2	32	0	0
7	50844165	.	C	T	12	16	28	0	1	29	0	0
7	50844830	.	G	T	8	6	14	0	0	14	0	0
7	50844834	.	G	A	0	9	9	0	6	15	0	0
7	50844895	.	A	T	13	9	22	0	0	23	1	0
7	50844936	.	A	T	7	7	14	0	0	14	0	0
7	50845000	.	G	A	17	15	32	0	2	34	0	0
7	50845105	.	A	T	14	14	28	0	1	29	0	0
7	50845158	.	A	G	8	11	19	0	1	20	0	0
7	50845210	.	A	G	9	19	28	0	0	28	0	0
7	50845331	.	G	A	0	4	4	0	6	10	0	0
7	50845486	.	A	T	6	5	11	0	0	11	0	0
7	50845646	.	C	T	6	6	12	0	0	12	0	0
7	50845892	.	C	A	14	20	34	0	1	35	0	0
7	50846055	.	T	C	9	19	28	0	1	29	0	0
7	50846081	.	T	A	15	7	22	0	1	23	0	0
7	50877064	.	T	C	7	8	15	0	2	17	0	0
7	50878385	.	T	C	7	3	10	0	0	10	0	0
7	50878473	.	A	C	9	4	13	0	0	13	0	0
7	50878838	.	G	A	1	4	5	0	1	6	0	0
7	50878864	.	A	T	4	3	7	0	1	8	0	0
7	50879166	.	C	T	2	4	6	0	0	6	0	0
7	50879168	.	C	G	4	2	6	0	0	6	0	0
7	50879293	.	C	A	1	2	3	0	0	3	0	0
7	50880114	.	T	C	3	2	5	0	0	5	0	0
7	50880527	.	G	T	2	3	5	0	0	5	0	0
7	50881177	.	G	A	1	2	3	0	0	3	0	0
7	50881252	.	G	A	1	2	3	0	0	3	0	0
7	50881363	.	C	T	2	4	6	0	0	6	0	0
7	50881465	.	A	G	2	3	5	0	0	5	0	0
7	50881600	.	G	A	3	2	5	0	1	6	0	0
7	50882215	.	A	T	3	4	7	0	0	7	0	0
7	50911223	.	T	A	9	6	15	0	0	15	0	0
7	50911278	.	C	T	15	10	25	0	6	31	0	0
7	50912212	.	C	T	10	5	15	0	1	16	0	0
7	50912227	.	C	G	4	8	12	0	0	12	0	0
7	50917219	.	C	T	4	2	6	0	0	6	0	0
7	50921206	.	C	T	2	1	3	0	0	3	0	0
7	51186862	.	G	C	0	1	1	0	1	2	0	0
7	51219420	.	C	G	7	4	11	0	2	13	0	0
7	51219436	.	A	C	6	6	12	0	0	12	0	0
7	51220278	.	T	C	13	6	19	0	1	20	0	0
7	51220739	.	A	G	10	7	17	0	0	17	0	0
7	51220740	.	C	A	0	7	7	0	10	17	0	0
7	51221418	.	T	A	0	5	5	0	1	6	0	0
7	51221475	.	C	T	4	3	7	0	1	8	0	0
7	51221784	.	A	G	6	5	11	0	0	11	0	0
7	51222115	.	G	A	5	6	11	0	0	11	0	0
7	51222297	.	G	A	2	1	3	0	0	3	0	0
7	51246426	.	G	A	7	9	16	0	0	16	0	0
7	51246457	.	G	T	8	8	16	0	1	17	0	0
7	51246573	.	T	C	6	5	11	0	0	11	0	0
7	51247467	.	C	T	1	3	4	0	1	5	0	0
7	51248010	.	C	A	1	5	6	0	0	6	0	0
7	51248834	.	C	T	0	2	2	0	5	7	0	0
7	51353421	.	C	T	5	8	13	0	1	14	0	0
7	51353447	.	G	T	4	8	12	0	0	12	0	0
7	51353854	.	T	A	1	2	3	0	0	3	0	0
7	51354066	.	G	A	0	2	2	0	2	4	0	0
7	51354176	.	A	G	0	5	5	0	1	6	0	0
7	51354296	.	A	G	0	8	8	0	0	8	0	0
7	51354424	.	T	A	5	4	9	0	1	10	0	0
7	51355151	.	A	G	2	4	6	0	0	7	1	0
7	51355437	.	A	G	2	3	5	0	2	7	0	0
7	51355515	.	A	T	2	2	4	0	0	4	0	0
7	51355531	.	T	A	1	1	2	0	0	2	0	0
7	51356303	.	G	A	3	1	4	0	1	5	0	0
7	51356319	.	G	A	0	4	4	0	4	8	0	0
7	51356542	.	C	G	14	16	30	0	0	30	0	0
7	51356625	.	C	A	11	9	20	0	0	20	0	0
7	51356733	.	G	T	6	5	11	0	3	14	0	0
7	51356767	.	C	A	7	3	10	0	0	10	0	0
7	51365935	.	G	A	1	2	3	0	1	4	0	0
7	51468119	.	C	T	13	20	33	0	1	34	0	0
7	51468241	.	C	T	12	22	34	0	2	36	0	0
7	51468389	.	C	T	0	15	15	0	18	33	0	0
7	51468411	.	A	T	15	13	28	0	0	28	0	0
7	51468577	.	C	A	21	18	39	1	0	40	0	0
7	51469048	.	T	G	18	19	37	0	2	39	0	0
7	51469166	.	A	T	15	15	30	0	0	30	0	0
7	51469267	.	G	C	17	9	26	0	0	26	0	0
7	51469304	.	T	A	11	10	21	0	0	21	0	0
7	51469518	.	T	A	5	17	22	0	2	24	0	0
7	51469578	.	T	G	8	13	21	0	0	21	0	0
7	51469814	.	C	T	0	11	11	0	10	21	0	0
7	51469897	.	A	G	9	9	18	0	1	19	0	0
7	51470070	.	T	C	7	0	7	0	6	13	0	0
7	51470569	.	G	T	5	5	10	0	1	11	0	0
7	51471195	.	T	C	9	7	16	0	0	16	0	0
7	51471201	.	G	A	10	5	15	0	3	18	0	0
7	51471379	.	G	A	3	6	9	0	0	9	0	0
7	51471554	.	T	C	6	0	6	0	10	16	0	0
7	51471714	.	A	G	6	8	14	0	0	14	0	0
7	51472456	.	C	T	4	4	8	0	0	8	0	0
7	51472534	.	T	A	5	4	9	0	0	10	1	0
7	51472536	.	T	A	6	4	10	0	0	10	0	0
7	51472793	.	A	C	9	0	9	0	6	15	0	0
7	51472853	.	G	A	8	7	15	0	0	15	0	0
7	51473000	.	C	T	2	3	5	0	1	6	0	0
7	51473814	.	C	T	3	5	8	0	0	8	0	0
7	51473831	.	T	G	6	4	10	0	0	10	0	0
7	51474238	.	G	A	8	6	14	0	0	14	0	0
7	51474279	.	C	A	2	7	9	0	0	9	0	0
7	51474300	.	G	T	2	2	4	0	0	4	0	0
7	51474832	.	T	G	2	4	6	0	1	7	0	0
7	51475180	.	A	G	7	3	10	0	1	11	0	0
7	51476634	.	G	T	1	2	3	0	0	3	0	0
7	51634285	.	C	T	13	20	33	0	2	35	0	0
7	51634480	.	G	A	44	25	69	0	1	70	0	0
7	51635615	.	A	G	20	10	30	0	0	30	0	0
7	51643163	.	A	G	4	4	8	0	1	9	0	0
7	51643212	.	G	A	4	7	11	0	0	11	0	0
7	51643409	.	C	A	4	5	9	0	1	10	0	0
7	51643639	.	A	C	3	2	5	0	0	5	0	0
7	51656256	.	G	A	2	6	8	0	0	8	0	0
7	51656560	.	A	T	1	2	3	0	0	3	0	0
7	51698403	.	T	A	1	0	1	0	0	1	0	0
7	51709914	.	C	A	2	5	7	0	0	7	0	0
7	51713257	.	G	A	4	3	7	0	0	7	0	0
7	51713267	.	G	A	3	1	4	0	1	5	0	0
7	51714712	.	A	G	0	1	1	0	0	1	0	0
7	51779628	.	G	A	2	3	5	0	1	6	0	0
7	51779636	.	T	C	2	2	4	0	0	4	0	0
7	51788227	.	T	G	12	7	19	0	2	21	0	0
7	51788756	.	A	C	6	8	14	0	5	19	0	0
7	51792959	.	T	C	1	4	5	0	0	5	0	0
7	51811165	.	G	A	7	3	10	0	1	11	0	0
7	51813946	.	T	G	1	4	5	0	1	6	0	0
7	51814287	.	C	G	3	11	14	0	0	14	0	0
7	51814445	.	T	A	10	5	15	0	0	15	0	0
7	51814512	.	C	T	5	5	10	0	0	10	0	0
7	51824244	.	T	C	1	2	3	0	1	4	0	0
7	51824892	.	T	A	1	2	3	0	0	3	0	0
7	52150793	.	A	T	1	1	2	0	1	3	0	0
7	52150811	.	A	C	3	3	6	0	0	6	0	0
7	52150911	.	A	G	1	2	3	0	0	3	0	0
7	52152016	.	C	T	1	1	2	0	0	2	0	0
7	52152053	.	A	T	2	2	4	0	0	4	0	0
7	52152063	.	C	T	0	2	2	0	2	4	0	0
7	52152101	.	C	T	3	2	5	0	0	5	0	0
7	52153001	.	G	A	0	3	3	0	0	3	0	0
7	52153006	.	C	T	1	3	4	0	0	4	0	0
7	52153052	.	T	C	2	2	4	0	0	4	0	0
7	52153075	.	C	T	1	1	2	0	0	2	0	0
7	52156095	.	G	A	0	2	2	0	1	3	0	0
7	52156113	.	G	A	0	2	2	0	3	5	0	0
7	52156137	.	T	A	5	4	9	0	1	10	0	0
7	52157845	.	A	T	5	3	8	0	0	8	0	0
7	52165601	.	C	T	3	3	6	0	0	6	0	0
7	52165631	.	C	T	4	3	7	0	1	8	0	0
7	52173207	.	G	A	4	6	10	0	0	10	0	0
7	52173228	.	A	G	2	3	5	0	1	6	0	0
7	52285027	.	T	C	5	9	14	0	3	17	0	0
7	52285113	.	C	G	7	9	16	0	1	17	0	0
7	52285257	.	T	G	2	2	4	0	0	4	0	0
7	52285266	.	T	A	2	1	3	0	0	3	0	0
7	52290945	.	T	C	1	2	3	0	0	3	0	0
7	52290949	.	G	A	1	3	4	0	0	4	0	0
7	52293935	.	C	T	3	4	7	0	0	7	0	0
7	52294009	.	G	T	9	3	12	0	1	13	0	0
7	52294540	.	A	T	11	12	23	0	0	23	0	0
7	52294579	.	C	T	12	5	17	0	0	17	0	0
7	52294756	.	A	T	8	11	19	0	2	21	0	0
7	52295016	.	C	T	0	13	13	0	13	26	0	0
7	52295183	.	G	A	17	18	35	0	2	37	0	0
7	52295795	.	C	T	1	12	13	0	11	24	0	0
7	52296064	.	A	C	12	0	12	0	12	24	0	0
7	52296221	.	G	A	11	11	22	0	3	25	0	0
7	52296320	.	G	A	5	12	17	0	1	18	0	0
7	52296352	.	G	T	5	10	15	0	2	17	0	0
7	52296791	.	G	A	15	16	31	0	2	33	0	0
7	52309924	.	G	A	0	1	1	0	1	2	0	0
7	52315434	.	C	G	0	5	5	0	2	7	0	0
7	52328569	.	C	T	2	2	4	0	0	4	0	0
7	52432249	.	G	A	2	3	5	0	0	5	0	0
7	52432459	.	G	A	2	4	6	0	0	6	0	0
7	52517759	.	G	A	5	9	14	0	2	16	0	0
7	52518017	.	T	A	1	2	3	0	0	3	0	0
7	52518018	.	T	A	1	2	3	0	0	3	0	0
7	52518529	.	T	G	3	8	11	0	1	12	0	0
7	52518813	.	C	T	4	4	8	0	1	9	0	0
7	52519015	.	T	C	5	4	9	0	0	9	0	0
7	52521352	.	G	A	8	4	12	0	0	12	0	0
7	52522182	.	T	C	10	7	17	0	0	17	0	0
7	52531152	.	C	T	0	4	4	0	6	10	0	0
7	52551518	.	G	A	1	1	2	0	0	2	0	0
7	52716777	.	T	A	5	1	6	0	0	6	0	0
7	52716875	.	C	A	0	1	1	0	0	1	0	0
7	52717095	.	T	C	3	4	7	0	1	8	0	0
7	52750565	.	C	T	14	7	21	0	1	22	0	0
7	52750656	.	G	A	7	10	17	0	0	17	0	0
7	52750776	.	G	T	7	10	17	0	0	17	0	0
7	52750847	.	C	T	10	8	18	0	1	19	0	0
7	52751016	.	C	T	13	3	16	0	0	16	0	0
7	52751306	.	T	C	3	4	7	0	0	7	0	0
7	52753582	.	C	T	2	0	2	0	0	2	0	0
7	52753772	.	C	T	1	3	4	0	0	4	0	0
7	52765959	.	A	C	1	2	3	0	0	3	0	0
7	52765985	.	G	T	0	2	2	0	1	3	0	0
7	52793313	.	C	T	1	1	2	0	0	2	0	0
7	52820092	.	G	C	5	7	12	0	0	12	0	0
7	52820221	.	G	A	0	5	5	0	11	16	0	0
7	52820320	.	C	T	14	4	18	0	2	20	0	0
7	52821432	.	A	G	8	3	11	0	0	11	0	0
7	52821561	.	T	A	2	2	4	0	0	4	0	0
7	52821691	.	A	C	2	3	5	0	1	6	0	0
7	52821904	.	G	A	11	6	17	0	3	20	0	0
7	52822136	.	G	A	16	7	23	0	1	24	0	0
7	52822217	.	T	A	12	8	20	0	0	20	0	0
7	52822351	.	A	T	10	8	18	0	0	18	0	0
7	52822493	.	A	C	11	5	16	0	3	19	0	0
7	52822773	.	C	T	7	15	22	0	0	22	0	0
7	52822791	.	T	G	5	1	6	0	14	20	0	0
7	52822860	.	A	G	3	10	13	0	2	15	0	0
7	52823161	.	G	A	11	11	22	0	0	22	0	0
7	52823210	.	C	G	12	8	20	0	0	20	0	0
7	52823377	.	T	A	5	4	9	0	0	9	0	0
7	52823388	.	C	T	4	5	9	0	1	10	0	0
7	52823429	.	A	T	4	10	14	0	0	14	0	0
7	52830447	.	G	T	1	6	7	0	1	8	0	0
7	52830591	.	A	T	18	15	33	0	1	34	0	0
7	52830601	.	T	G	18	16	34	0	0	34	0	0
7	52830639	.	C	T	18	21	39	0	2	41	0	0
7	52831053	.	G	T	25	19	44	0	3	47	0	0
7	52831198	.	T	A	11	21	32	0	1	33	0	0
7	52831236	.	A	G	14	16	30	0	1	31	0	0
7	52831430	.	C	T	18	9	27	0	0	27	0	0
7	52833126	.	C	G	8	13	21	0	1	22	0	0
7	52833248	.	A	T	15	9	24	0	1	25	0	0
7	52833329	.	G	T	16	16	32	0	0	32	0	0
7	52833682	.	T	A	14	11	25	0	0	25	0	0
7	52833792	.	G	A	13	20	33	0	0	33	0	0
7	52834334	.	T	G	6	4	10	0	0	10	0	0
7	52836325	.	C	T	17	20	37	0	0	37	0	0
7	52836403	.	A	G	21	17	38	0	0	38	0	0
7	52836451	.	C	T	17	20	37	0	2	39	0	0
7	52837644	.	G	A	9	12	21	0	0	21	0	0
7	52837686	.	C	A	3	12	15	0	2	17	0	0
7	52837687	.	T	A	4	13	17	0	0	17	0	0
7	52839062	.	C	T	5	6	11	0	1	12	0	0
7	52840871	.	T	A	14	9	23	0	3	26	0	0
7	52841033	.	T	C	2	0	2	0	7	9	0	0
7	52841276	.	A	G	2	7	9	0	0	9	0	0
7	52900987	.	C	T	10	7	17	0	0	17	0	0
7	52921521	.	C	A	14	8	22	0	1	23	0	0
7	52924873	.	T	A	5	5	10	0	0	10	0	0
7	52929182	.	G	A	7	7	14	0	0	14	0	0
7	52933088	.	C	A	22	16	38	0	2	40	0	0
7	52933191	.	C	T	5	4	9	0	0	9	0	0
7	52937334	.	G	A	5	9	14	0	0	14	0	0
7	52942312	.	G	T	4	5	9	0	0	9	0	0
7	52942472	.	C	T	2	0	2	0	0	2	0	0
7	52944199	.	G	A	10	5	15	0	0	15	0	0
7	52958387	.	A	T	3	2	5	0	0	5	0	0
7	52962765	.	T	C	5	0	5	0	3	8	0	0
7	54307268	.	G	C	1	4	5	0	0	5	0	0
7	54307309	.	T	A	2	2	4	0	0	4	0	0
7	54323986	.	T	C	16	0	16	0	20	36	0	0
7	54356092	.	A	T	0	1	1	0	1	2	0	0
7	54407619	.	C	T	1	2	3	0	0	3	0	0
7	54420390	.	C	T	0	1	1	0	0	1	0	0
7	54655025	.	A	T	5	6	11	0	0	11	0	0
7	54655245	.	C	T	2	3	5	0	0	5	0	0
7	55261074	.	C	T	1	1	2	0	0	2	0	0
7	55530884	.	G	C	1	2	3	0	0	4	1	0
7	55532316	.	A	G	2	7	9	0	0	9	0	0
7	55536487	.	G	A	3	2	5	0	0	5	0	0
7	55593170	.	T	C	1	0	1	0	2	3	0	0
7	55635202	.	T	C	0	1	1	0	0	1	0	0
7	55635355	.	G	A	0	1	1	0	1	2	0	0
7	55637122	.	C	A	1	2	3	0	0	3	0	0
7	55660269	.	G	A	10	14	24	0	1	25	0	0
7	55669479	.	G	A	1	0	1	0	0	1	0	0
7	55671547	.	T	C	4	7	11	0	0	11	0	0
7	55953284	.	G	A	0	2	2	0	3	5	0	0
7	55953298	.	G	C	2	3	5	0	0	5	0	0
7	56020062	.	C	T	1	1	2	0	0	2	0	0
7	56152686	.	G	C	18	7	25	0	0	25	0	0
7	56158111	.	G	A	1	3	4	0	2	6	0	0
7	56158197	.	G	A	5	13	18	0	0	18	0	0
7	56158823	.	A	G	11	5	16	0	0	16	0	0
7	56158874	.	C	T	2	2	4	0	0	4	0	0
7	56172458	.	T	C	2	3	5	0	0	5	0	0
7	56174222	.	T	C	5	1	6	0	3	9	0	0
7	56180258	.	C	T	3	2	5	0	0	5	0	0
7	56180589	.	C	A	0	3	3	0	1	4	0	0
7	56397859	.	G	A	5	8	13	0	0	13	0	0
7	56398522	.	A	T	3	2	5	0	0	5	0	0
7	56405508	.	T	C	11	9	20	0	0	20	0	0
7	56484426	.	G	A	21	15	36	0	0	36	0	0
7	56523233	.	A	G	1	1	2	0	0	2	0	0
7	56528494	.	C	T	1	5	6	0	0	6	0	0
7	56528922	.	G	A	3	0	3	0	0	3	0	0
7	56737268	.	C	G	4	0	4	0	6	10	0	0
7	56743837	.	G	C	2	1	3	0	0	3	0	0
7	56743879	.	A	G	1	1	2	0	0	2	0	0
7	56746311	.	C	T	9	8	17	0	0	17	0	0
7	56751971	.	A	G	11	15	26	0	1	27	0	0
7	56752243	.	G	A	3	1	4	0	0	4	0	0
7	56766115	.	C	T	0	6	6	0	8	14	0	0
7	56766282	.	A	C	6	0	6	0	3	9	0	0
7	56766754	.	A	T	4	2	6	0	1	7	0	0
7	56777813	.	T	C	13	0	13	0	7	20	0	0
7	56778235	.	T	A	17	14	31	0	1	32	0	0
7	56778251	.	T	C	19	12	31	0	2	33	0	0
7	56778282	.	C	T	0	14	14	0	23	37	0	0
7	56778305	.	G	A	12	20	32	0	3	35	0	0
7	56778672	.	G	T	16	15	31	0	0	31	0	0
7	56778721	.	G	T	21	11	32	0	4	36	0	0
7	56778822	.	A	T	14	14	28	0	1	29	0	0
7	56778895	.	A	G	11	12	23	0	2	25	0	0
7	56784070	.	A	T	14	4	18	0	1	19	0	0
7	56785006	.	T	C	13	13	26	0	2	28	0	0
7	56785308	.	C	T	10	9	19	0	0	19	0	0
7	56785315	.	G	A	8	8	16	0	0	16	0	0
7	56787414	.	A	T	16	13	29	0	2	31	0	0
7	56787483	.	T	A	15	15	30	0	0	30	0	0
7	56787527	.	C	T	10	12	22	0	1	23	0	0
7	57017140	.	C	T	1	3	4	0	0	4	0	0
7	57048022	.	C	T	4	0	4	0	0	4	0	0
7	57049308	.	T	C	2	2	4	0	1	5	0	0
7	57049578	.	C	T	6	2	8	0	0	8	0	0
7	57049638	.	A	G	2	5	7	0	0	7	0	0
7	57049911	.	C	T	2	2	4	0	0	4	0	0
7	57049958	.	C	T	1	2	3	0	0	3	0	0
7	57057285	.	C	T	0	1	1	0	0	1	0	0
7	57071707	.	C	T	1	3	4	0	0	4	0	0
7	57081143	.	C	T	3	3	6	0	0	6	0	0
7	57083043	.	C	T	1	3	4	0	0	4	0	0
7	57083088	.	G	A	4	4	8	0	0	8	0	0
7	57083094	.	A	G	4	0	4	0	4	8	0	0
7	57086153	.	C	T	3	5	8	0	0	8	0	0
7	57086216	.	G	A	0	7	7	0	7	14	0	0
7	57086277	.	G	A	0	7	7	0	5	12	0	0
7	57086383	.	C	A	5	8	13	0	2	15	0	0
7	57129474	.	A	G	0	1	1	0	0	1	0	0
7	57129518	.	C	T	3	3	6	0	1	7	0	0
7	57129520	.	A	T	3	4	7	0	0	7	0	0
7	57129553	.	C	A	4	3	7	0	1	8	0	0
7	57129656	.	G	A	2	3	5	0	0	5	0	0
7	57129729	.	G	T	2	5	7	0	0	7	0	0
7	57129766	.	A	T	1	7	8	0	0	8	0	0
7	57485710	.	T	C	6	6	12	0	0	12	0	0
7	57485736	.	A	G	7	5	12	0	0	12	0	0
7	57485766	.	A	G	6	10	16	0	0	16	0	0
7	57485847	.	G	A	0	1	1	0	0	1	0	0
7	57497353	.	T	C	4	7	11	0	1	12	0	0
7	57497455	.	C	G	1	2	3	0	1	4	0	0
7	57504905	.	C	G	6	8	14	0	1	15	0	0
7	57725867	.	G	A	0	2	2	0	0	2	0	0
7	57839716	.	A	C	2	1	3	0	0	3	0	0
7	57874026	.	G	A	0	1	1	0	0	1	0	0
7	57874038	.	A	C	0	1	1	0	0	1	0	0
7	57874083	.	G	A	0	1	1	0	0	1	0	0
7	57876512	.	T	C	5	5	10	0	1	11	0	0
7	57878712	.	T	C	6	9	15	0	0	15	0	0
7	57878726	.	A	T	5	7	12	0	0	12	0	0
7	57878788	.	A	C	2	3	5	0	1	6	0	0
7	57878885	.	C	T	6	3	9	0	2	11	0	0
7	57878973	.	A	T	6	4	10	0	1	11	0	0
7	57878974	.	C	T	7	3	10	0	1	11	0	0
7	57879076	.	A	G	5	0	5	0	10	15	0	0
7	57879205	.	C	T	7	3	10	0	0	10	0	0
7	57879245	.	C	T	9	5	14	0	0	14	0	0
7	57879396	.	T	A	17	16	33	0	2	35	0	0
7	57879431	.	G	T	0	13	13	0	20	33	0	0
7	57879436	.	C	A	19	12	31	0	1	32	0	0
7	57879576	.	C	A	19	15	34	0	1	35	0	0
7	57879601	.	T	C	23	5	28	0	3	31	0	0
7	57879959	.	C	A	13	6	19	0	0	19	0	0
7	57879992	.	G	A	11	13	24	0	1	25	0	0
7	57880073	.	G	C	3	3	6	0	1	7	0	0
7	57880099	.	T	C	2	3	5	0	0	5	0	0
7	57886347	.	C	A	21	20	41	0	1	42	0	0
7	57886392	.	T	A	21	18	39	0	0	39	0	0
7	57886964	.	T	G	27	26	53	0	2	55	0	0
7	57887480	.	C	T	20	20	40	0	5	46	1	0
7	57898605	.	G	A	4	9	13	0	1	14	0	0
7	57898650	.	T	C	22	15	37	0	3	40	0	0
7	57898658	.	C	G	25	20	45	0	0	45	0	0
7	57900948	.	T	A	1	4	5	0	0	5	0	0
7	57913558	.	C	A	20	17	37	0	1	38	0	0
7	57914155	.	T	G	14	21	35	0	2	37	0	0
7	57918590	.	A	G	11	10	21	0	0	21	0	0
7	57918799	.	G	A	20	28	48	0	1	49	0	0
7	57919087	.	T	G	14	25	39	0	2	41	0	0
7	57919241	.	G	A	28	11	39	0	0	39	0	0
7	57919249	.	T	C	27	1	28	0	7	35	0	0
7	57919567	.	T	C	12	12	24	0	0	24	0	0
7	57920608	.	A	T	11	3	14	0	0	14	0	0
7	57920908	.	A	G	5	7	12	0	1	13	0	0
7	57921094	.	A	G	10	21	31	0	1	32	0	0
7	57921335	.	A	G	6	7	13	0	1	15	1	0
7	57921914	.	G	A	9	11	20	0	1	21	0	0
7	57922018	.	T	G	5	4	9	0	0	9	0	0
7	57922480	.	G	A	12	9	21	0	2	23	0	0
7	57922555	.	G	T	13	5	18	0	3	21	0	0
7	57922793	.	G	T	9	5	14	0	0	14	0	0
7	57922827	.	C	T	4	7	11	0	0	11	0	0
7	57922828	.	A	G	4	7	11	0	0	11	0	0
7	57928407	.	A	T	4	4	8	0	0	8	0	0
7	57934036	.	A	T	4	5	9	0	0	9	0	0
7	57934051	.	T	C	3	5	8	0	0	8	0	0
7	57936171	.	G	A	3	1	4	0	0	4	0	0
7	57952714	.	T	C	1	1	2	0	0	2	0	0
7	57954099	.	G	A	1	0	1	0	0	1	0	0
7	57954123	.	A	C	1	0	1	0	0	1	0	0
7	57956503	.	C	T	4	3	7	0	1	8	0	0
7	57961917	.	C	A	2	1	3	0	0	3	0	0
7	57967373	.	A	G	1	2	3	0	0	3	0	0
7	57972616	.	T	C	1	0	1	0	0	1	0	0
7	57994952	.	T	A	1	1	2	0	0	2	0	0
7	58007916	.	G	T	0	1	1	0	1	2	0	0
7	58142761	.	G	C	1	4	5	0	0	5	0	0
7	58142814	.	A	T	2	6	8	0	0	8	0	0
7	58143104	.	A	G	2	6	8	0	0	8	0	0
7	58143123	.	G	C	2	8	10	0	0	10	0	0
7	58143659	.	T	C	1	0	1	0	3	4	0	0
7	58143661	.	T	C	1	3	4	0	0	4	0	0
7	58150120	.	A	T	8	5	13	0	0	13	0	0
7	58153549	.	A	G	1	3	4	0	0	4	0	0
7	58158456	.	C	T	0	3	3	0	5	8	0	0
7	58158484	.	T	C	2	3	5	0	0	5	0	0
7	58158847	.	T	C	1	0	1	0	0	1	0	0
7	58188252	.	A	G	7	6	13	0	0	13	0	0
7	58188253	.	A	C	7	6	13	0	0	13	0	0
7	58193195	.	A	G	4	2	6	0	0	6	0	0
7	58199935	.	A	G	1	1	2	0	0	2	0	0
7	58200145	.	G	A	1	1	2	0	0	2	0	0
7	58259472	.	C	T	12	10	22	0	0	22	0	0
7	58259494	.	T	A	8	9	17	0	2	19	0	0
7	58259561	.	A	G	4	10	14	0	0	14	0	0
7	58259808	.	C	T	0	3	3	0	3	6	0	0
7	58262100	.	G	A	3	8	11	0	1	12	0	0
7	58264129	.	T	C	4	8	12	0	1	13	0	0
7	58265533	.	G	A	3	0	3	0	0	3	0	0
7	58687138	.	G	A	8	10	18	0	0	18	0	0
7	58695379	.	A	C	3	9	12	0	0	12	0	0
7	58695441	.	C	A	15	17	32	0	0	32	0	0
7	58695599	.	G	T	17	8	25	0	1	26	0	0
7	58748871	.	A	C	8	12	20	0	3	23	0	0
7	58748891	.	T	C	6	9	15	0	1	16	0	0
7	58750327	.	A	C	19	25	44	0	1	45	0	0
7	58841391	.	T	C	10	0	10	0	9	19	0	0
7	58841552	.	T	G	0	2	2	0	0	2	0	0
7	58843134	.	T	C	6	3	9	0	0	9	0	0
7	59037573	.	A	C	1	4	5	0	0	5	0	0
7	59037694	.	C	A	3	2	5	0	0	5	0	0
7	59041471	.	A	G	1	3	4	0	0	4	0	0
7	59041504	.	A	G	1	2	3	0	1	4	0	0
7	59041531	.	A	G	0	1	1	0	0	1	0	0
7	59043246	.	C	A	4	4	8	0	2	10	0	0
7	59043421	.	T	C	1	0	1	0	1	2	0	0
7	59046711	.	T	A	8	4	12	0	0	12	0	0
7	59046795	.	G	A	4	3	7	0	0	7	0	0
7	59046966	.	T	A	6	5	11	0	0	11	0	0
7	59048307	.	C	T	2	12	14	0	8	22	0	0
7	59048907	.	G	A	9	1	10	0	0	10	0	0
7	59069079	.	G	A	8	7	15	0	1	16	0	0
7	59069080	.	T	G	8	7	15	0	1	16	0	0
7	59202989	.	A	T	3	8	11	0	1	12	0	0
7	59203097	.	A	G	5	7	12	0	1	13	0	0
7	59203289	.	G	A	2	2	4	0	0	4	0	0
7	59210423	.	T	A	1	2	3	0	0	3	0	0
7	59210625	.	C	T	1	0	1	0	0	1	0	0
7	59240761	.	G	A	1	2	3	0	0	3	0	0
7	59245594	.	G	T	1	5	6	0	1	7	0	0
7	59245612	.	G	T	2	6	8	0	0	8	0	0
7	59456904	.	A	C	1	1	2	0	0	2	0	0
7	59469015	.	G	A	2	2	4	0	0	4	0	0
7	59589259	.	A	G	0	2	2	0	0	2	0	0
7	59712337	.	A	T	1	2	3	0	0	3	0	0
7	60149599	.	C	T	4	1	5	0	1	6	0	0
7	60240748	.	T	C	3	3	6	0	0	6	0	0
7	60240944	.	C	T	0	1	1	0	1	2	0	0
7	60240946	.	C	A	0	2	2	0	0	2	0	0
7	60240990	.	T	G	1	3	4	0	0	4	0	0
7	60241860	.	A	G	2	3	5	0	0	5	0	0
7	60241863	.	A	G	2	3	5	0	0	5	0	0
7	60242851	.	C	A	4	4	8	0	0	8	0	0
7	60244637	.	A	G	5	7	12	0	1	13	0	0
7	60244868	.	C	T	3	2	5	0	0	5	0	0
7	60245085	.	T	A	1	2	3	0	0	3	0	0
7	60245107	.	C	G	0	2	2	0	0	2	0	0
7	60245149	.	T	A	2	3	5	0	0	5	0	0
7	60245180	.	G	T	2	4	6	0	0	6	0	0
7	60359512	.	G	A	2	2	4	0	0	4	0	0
7	60359516	.	A	C	2	2	4	0	0	4	0	0
7	60359574	.	G	A	0	4	4	0	1	5	0	0
7	60359584	.	C	T	1	3	4	0	0	4	0	0
7	60409230	.	T	C	0	6	6	0	1	7	0	0
7	60415928	.	T	C	4	9	13	0	1	14	0	0
7	60415945	.	A	T	2	9	11	0	0	11	0	0
7	60416010	.	T	C	6	12	18	0	2	20	0	0
7	60416016	.	A	G	7	11	18	0	3	21	0	0
7	60416175	.	C	T	5	11	16	0	0	16	0	0
7	60416317	.	A	G	8	0	8	0	6	14	0	0
7	60416327	.	C	T	8	9	17	0	0	17	0	0
7	60416379	.	G	A	3	14	17	0	0	17	0	0
7	60416383	.	C	T	3	14	17	0	0	17	0	0
7	60416439	.	A	G	6	9	15	0	0	15	0	0
7	60416724	.	A	G	3	10	13	0	0	13	0	0
7	60416764	.	T	G	3	6	9	0	1	10	0	0
7	60417176	.	T	A	5	3	8	0	0	8	0	0
7	60551171	.	A	C	22	11	33	0	1	34	0	0
7	60551471	.	A	G	10	11	21	0	2	23	0	0
7	60585523	.	A	G	12	0	12	0	25	37	0	0
7	60585599	.	G	A	11	14	25	0	2	27	0	0
7	60585702	.	G	A	8	7	15	0	2	17	0	0
7	60585748	.	G	T	8	12	20	0	0	20	0	0
7	60585818	.	G	C	4	12	16	0	0	16	0	0
7	60586187	.	T	C	18	15	33	0	1	34	0	0
7	60586364	.	A	C	9	5	14	0	1	15	0	0
7	60586771	.	C	T	7	6	13	0	0	13	0	0
7	60586784	.	A	T	6	9	15	0	0	15	0	0
7	60586835	.	C	T	10	8	18	0	0	18	0	0
7	60586874	.	G	A	0	13	13	0	10	23	0	0
7	60586976	.	C	T	12	15	27	0	1	28	0	0
7	60597482	.	G	A	9	16	25	0	3	28	0	0
7	60597500	.	T	G	12	17	29	0	0	29	0	0
7	60597863	.	C	T	13	24	37	0	0	37	0	0
7	60598265	.	T	A	24	18	42	0	1	43	0	0
7	61586641	.	C	G	4	6	10	0	0	10	0	0
7	61586719	.	C	T	0	7	7	0	4	11	0	0
7	61586910	.	C	T	4	6	10	0	2	12	0	0
7	61588778	.	A	G	3	2	5	0	0	5	0	0
7	61772930	.	G	T	2	3	5	0	0	5	0	0
7	61775744	.	G	A	0	2	2	0	0	2	0	0
7	61804557	.	A	T	1	4	5	0	0	6	1	0
7	61804880	.	A	T	2	5	7	0	0	7	0	0
7	61804909	.	C	A	3	4	7	0	0	7	0	0
7	61805102	.	G	A	2	3	5	0	0	5	0	0
7	61805104	.	T	A	2	3	5	0	0	5	0	0
7	61889545	.	T	G	0	0	0	0	2	2	0	0
7	61921463	.	C	T	0	1	1	0	0	1	0	0
7	61921465	.	T	A	0	1	1	0	0	1	0	0
7	61934189	.	T	A	2	1	3	0	0	3	0	0
7	61934278	.	C	T	1	2	3	0	0	3	0	0
7	61934306	.	A	G	3	0	3	0	4	7	0	0
7	61934330	.	A	G	3	0	3	0	4	7	0	0
7	61959031	.	G	A	4	1	5	0	0	5	0	0
7	61961063	.	G	A	1	0	1	0	0	1	0	0
7	61961664	.	A	G	2	2	4	0	0	4	0	0
7	61962002	.	A	G	4	3	7	0	0	7	0	0
7	61962040	.	T	C	4	8	12	0	0	12	0	0
7	61962292	.	G	T	4	2	6	0	0	6	0	0
7	61977170	.	G	C	4	8	12	0	1	13	0	0
7	61977499	.	T	C	5	13	18	0	0	18	0	0
7	61977514	.	G	A	5	12	17	0	2	19	0	0
7	61977769	.	G	A	0	2	2	0	0	2	0	0
7	61981518	.	A	G	2	3	5	0	0	5	0	0
7	62004146	.	C	T	12	12	24	0	1	25	0	0
7	62009630	.	T	A	11	3	14	0	2	16	0	0
7	62009677	.	G	A	1	12	13	0	7	20	0	0
7	62261533	.	A	T	0	4	4	0	0	4	0	0
7	62261581	.	C	T	1	0	1	0	0	1	0	0
7	64740893	.	T	C	3	0	3	0	6	9	0	0
7	64962365	.	C	A	2	3	5	0	0	5	0	0
7	64978891	.	A	C	5	5	10	0	0	10	0	0
7	64980793	.	A	G	1	0	1	0	0	1	0	0
7	64980820	.	A	G	3	3	6	0	0	6	0	0
7	64988061	.	A	G	3	4	7	0	1	8	0	0
7	64996666	.	A	G	1	1	2	0	1	3	0	0
7	65019731	.	T	C	1	2	3	0	0	3	0	0
7	65024082	.	C	T	0	1	1	0	2	3	0	0
7	65026828	.	C	T	0	3	3	0	4	7	0	0
7	65035275	.	A	G	4	8	12	0	2	14	0	0
7	65035416	.	G	T	6	3	9	0	1	10	0	0
7	65035437	.	C	T	4	5	9	0	0	9	0	0
7	65035509	.	G	A	1	2	3	0	0	3	0	0
7	65039374	.	T	A	6	7	13	0	1	14	0	0
7	65039436	.	A	C	7	0	7	0	9	16	0	0
7	65049706	.	C	T	0	3	3	0	1	5	1	0
7	65050312	.	A	T	1	1	2	0	2	4	0	0
7	65092935	.	G	A	1	3	4	0	2	6	0	0
7	65093097	.	G	A	1	7	8	0	0	8	0	0
7	65104792	.	C	T	2	2	4	0	0	4	0	0
7	65105011	.	G	C	2	2	4	0	0	4	0	0
7	65105160	.	C	A	0	4	4	0	0	4	0	0
7	65121982	.	C	T	4	3	7	0	1	8	0	0
7	65132884	.	C	T	1	1	2	0	0	2	0	0
7	65138868	.	A	G	2	2	4	0	0	4	0	0
7	65140532	.	C	A	4	2	6	0	0	6	0	0
7	65140738	.	T	A	1	1	2	0	0	2	0	0
7	65140786	.	G	A	2	2	4	0	0	4	0	0
7	65144861	.	G	T	0	0	0	0	1	1	0	0
7	65147905	.	G	A	4	2	6	0	1	7	0	0
7	65152024	.	T	C	0	1	1	0	0	1	0	0
7	65157397	.	A	C	9	7	16	0	0	16	0	0
7	65162339	.	G	A	0	6	6	0	2	8	0	0
7	65173289	.	A	T	14	13	27	0	0	27	0	0
7	65173534	.	C	T	3	11	14	0	0	14	0	0
7	65173829	.	A	T	3	3	6	0	0	6	0	0
7	65178135	.	C	T	1	5	6	0	4	10	0	0
7	65297041	.	A	T	8	3	11	0	0	11	0	0
7	65297313	.	G	T	2	3	5	0	2	7	0	0
7	65306067	.	T	C	6	5	11	0	0	11	0	0
7	65306229	.	G	A	7	4	11	0	0	11	0	0
7	65333843	.	T	C	2	3	5	0	0	5	0	0
7	65333874	.	C	T	3	3	6	0	0	6	0	0
7	65333930	.	T	A	3	2	5	0	0	5	0	0
7	65433092	.	T	C	1	3	4	0	0	4	0	0
7	65440308	.	T	A	6	3	9	0	2	11	0	0
7	65440505	.	G	A	2	2	4	0	0	4	0	0
7	65443396	.	G	A	2	1	3	0	1	4	0	0
7	65451324	.	T	A	6	5	11	0	0	11	0	0
7	65451369	.	C	T	4	7	11	0	0	11	0	0
7	65452005	.	G	A	0	1	1	0	5	6	0	0
7	65452017	.	G	A	4	1	5	0	0	5	0	0
7	65453057	.	G	A	0	4	4	0	5	9	0	0
7	65461040	.	G	A	0	14	14	0	3	17	0	0
7	65463165	.	C	A	10	9	19	0	3	22	0	0
7	65463297	.	G	T	1	13	14	0	10	24	0	0
7	65463511	.	G	A	0	14	14	0	19	33	0	0
7	65463586	.	C	T	7	12	19	0	3	22	0	0
7	65463906	.	T	C	11	5	16	0	4	20	0	0
7	65464120	.	T	G	6	6	12	0	0	12	0	0
7	65464132	.	T	G	5	0	5	0	4	9	0	0
7	65473137	.	G	T	11	17	28	0	3	32	1	0
7	65473421	.	G	C	27	28	55	0	1	56	0	0
7	65473775	.	G	T	14	32	46	0	2	48	0	0
7	65473814	.	T	C	31	12	43	0	5	48	0	0
7	65473972	.	T	C	24	15	39	0	2	41	0	0
7	65475422	.	T	G	5	6	11	0	1	12	0	0
7	65475708	.	T	G	16	12	28	0	0	28	0	0
7	65491835	.	G	A	25	23	48	0	0	48	0	0
7	65918445	.	A	G	2	2	4	0	0	4	0	0
7	65918984	.	T	G	2	2	4	0	0	4	0	0
7	65919326	.	C	A	2	3	5	0	0	5	0	0
7	65919360	.	C	G	2	3	5	0	0	5	0	0
7	65919373	.	A	C	1	2	3	0	1	4	0	0
7	65920670	.	A	G	1	0	1	0	3	4	0	0
7	65920720	.	A	G	1	0	1	0	5	6	0	0
7	65921726	.	G	T	0	2	2	0	4	6	0	0
7	65922732	.	G	C	1	3	4	0	1	5	0	0
7	65923179	.	C	T	6	2	8	0	0	8	0	0
7	65923921	.	T	C	3	7	10	0	0	10	0	0
7	65923944	.	T	G	3	4	7	0	0	7	0	0
7	65924277	.	T	C	3	2	5	0	1	6	0	0
7	65924554	.	A	G	5	2	7	0	1	8	0	0
7	65924558	.	C	T	4	2	6	0	1	7	0	0
7	65924621	.	T	C	7	1	8	0	0	8	0	0
7	65924634	.	A	G	5	0	5	0	2	7	0	0
7	65940058	.	C	A	2	2	4	0	0	4	0	0
7	65940063	.	G	A	2	1	3	0	0	3	0	0
7	66085915	.	A	C	1	2	3	0	0	3	0	0
7	66090927	.	C	T	2	2	4	0	0	4	0	0
7	66093216	.	C	T	1	1	2	0	0	2	0	0
7	66105498	.	C	T	4	7	11	0	0	11	0	0
7	66105663	.	A	G	5	0	5	0	8	13	0	0
7	66105752	.	C	T	6	4	10	0	1	11	0	0
7	66105804	.	G	A	0	8	8	0	3	11	0	0
7	66112702	.	T	C	7	8	15	0	0	15	0	0
7	66126466	.	T	C	2	3	5	0	0	5	0	0
7	66133626	.	A	T	1	3	4	0	1	5	0	0
7	66259574	.	A	T	7	6	13	0	0	13	0	0
7	66276243	.	G	A	5	11	16	0	0	16	0	0
7	66361984	.	A	G	5	7	12	0	0	12	0	0
7	66368605	.	G	C	3	0	3	0	3	6	0	0
7	67434693	.	A	C	0	2	2	0	0	2	0	0
7	67434807	.	T	C	3	4	7	0	0	7	0	0
7	67435587	.	T	C	3	2	5	0	0	5	0	0
7	67436273	.	C	T	8	9	17	0	0	17	0	0
7	67439428	.	A	C	2	5	7	0	0	7	0	0
7	67439496	.	T	A	4	7	11	0	0	11	0	0
7	67439520	.	T	A	1	2	3	0	0	3	0	0
7	67439742	.	T	C	5	6	11	0	0	11	0	0
7	67439743	.	C	T	5	6	11	0	0	11	0	0
7	67439781	.	T	C	2	1	3	0	0	3	0	0
7	67443766	.	T	C	4	3	7	0	0	7	0	0
7	67444837	.	G	A	0	1	1	0	0	1	0	0
7	67446295	.	C	T	18	12	30	0	0	30	0	0
7	67448338	.	T	C	18	16	34	0	2	36	0	0
7	67448363	.	A	T	18	14	32	0	0	32	0	0
7	67448373	.	T	A	18	13	31	0	1	32	0	0
7	67476376	.	T	C	31	34	65	0	1	66	0	0
7	67545588	.	T	C	0	1	1	0	0	1	0	0
7	67584796	.	C	T	4	2	6	0	0	6	0	0
7	67594248	.	C	T	3	3	6	0	0	6	0	0
7	67594292	.	A	T	2	3	5	0	3	8	0	0
7	67594467	.	T	C	1	3	4	0	0	4	0	0
7	67594506	.	G	A	0	2	2	0	3	5	0	0
7	67594736	.	C	G	2	5	7	0	0	7	0	0
7	67733819	.	G	A	5	4	9	0	0	9	0	0
7	67743603	.	T	A	3	3	6	0	1	7	0	0
7	67743604	.	G	T	3	3	6	0	1	7	0	0
7	67743646	.	A	G	5	1	6	0	0	6	0	0
7	67743878	.	T	C	2	5	7	0	1	8	0	0
7	67743901	.	A	G	4	4	8	0	0	8	0	0
7	67744341	.	A	G	14	5	19	0	1	20	0	0
7	67747819	.	T	C	14	6	20	0	0	20	0	0
7	67747826	.	T	G	11	4	15	0	1	16	0	0
7	67747869	.	G	C	12	4	16	0	0	16	0	0
7	67747915	.	G	A	9	5	14	0	0	14	0	0
7	67747916	.	A	T	9	4	13	0	1	14	0	0
7	67751133	.	C	T	0	2	2	0	0	2	0	0
7	67753196	.	T	C	0	1	1	0	0	1	0	0
7	67760437	.	G	C	0	1	1	0	1	2	0	0
7	67770456	.	T	C	0	1	1	0	0	1	0	0
7	67776588	.	C	T	3	3	6	0	2	8	0	0
7	67795429	.	G	A	5	4	9	0	0	9	0	0
7	67795576	.	C	T	2	2	4	0	0	4	0	0
7	67795633	.	G	A	5	3	8	0	0	8	0	0
7	67796075	.	G	T	5	3	8	1	0	9	0	0
7	67797037	.	C	G	10	7	17	0	1	18	0	0
7	67797087	.	G	T	9	5	14	0	1	15	0	0
7	67797097	.	C	T	9	3	12	0	1	13	0	0
7	67817399	.	C	T	0	2	2	0	0	2	0	0
7	67833051	.	G	A	6	8	14	0	0	14	0	0
7	67835264	.	A	G	0	1	1	0	0	1	0	0
7	67835269	.	A	C	0	1	1	0	0	1	0	0
7	67842641	.	G	T	3	5	8	0	0	8	0	0
7	67846087	.	T	C	1	0	1	0	0	1	0	0
7	67861868	.	T	G	2	3	5	0	0	5	0	0
7	67861872	.	G	C	2	0	2	0	3	5	0	0
7	67865220	.	G	C	0	1	1	0	0	1	0	0
7	67876880	.	T	A	0	2	2	0	0	2	0	0
7	67876881	.	G	A	0	2	2	0	0	2	0	0
7	67888194	.	T	C	0	1	1	0	0	1	0	0
7	67916337	.	G	A	0	1	1	0	0	1	0	0
7	68215451	.	A	T	21	19	40	0	4	44	0	0
7	68215990	.	T	G	22	14	36	0	0	36	0	0
7	68216504	.	C	A	0	11	11	0	9	20	0	0
7	68216781	.	G	C	3	5	8	0	0	8	0	0
7	68217387	.	G	A	15	12	27	0	0	27	0	0
7	68219332	.	A	G	9	13	22	0	0	22	0	0
7	68219340	.	A	T	8	11	19	0	2	21	0	0
7	68219412	.	T	A	6	8	14	0	1	15	0	0
7	68220824	.	A	C	6	5	11	0	0	11	0	0
7	68370573	.	G	T	1	2	3	0	0	3	0	0
7	68540716	.	T	A	4	5	9	0	0	9	0	0
7	68541265	.	A	G	3	4	7	0	0	7	0	0
7	68542517	.	C	T	4	3	7	0	0	7	0	0
7	68542538	.	C	T	6	3	9	0	0	9	0	0
7	69143989	.	T	C	8	6	14	0	0	14	0	0
7	69143992	.	T	C	11	0	11	0	3	14	0	0
7	69144283	.	T	C	6	3	9	0	0	9	0	0
7	69145032	.	T	C	4	4	8	0	0	8	0	0
7	69145033	.	T	C	2	6	8	0	0	8	0	0
7	69145516	.	T	C	8	4	12	0	0	12	0	0
7	69145519	.	T	C	9	3	12	0	0	12	0	0
7	69145672	.	T	C	7	0	7	0	4	11	0	0
7	69145919	.	T	C	1	4	5	0	0	5	0	0
7	69145923	.	T	C	1	3	4	0	0	4	0	0
7	69146362	.	T	C	2	3	5	0	0	5	0	0
7	69313352	.	A	C	4	0	4	0	1	5	0	0
7	69313357	.	T	G	3	0	3	0	1	4	0	0
7	69437422	.	A	C	6	5	11	0	0	11	0	0
7	69437472	.	T	C	7	6	13	0	0	13	0	0
7	69437495	.	C	A	1	2	3	0	0	3	0	0
7	69439094	.	T	A	0	2	2	0	0	2	0	0
7	69439436	.	T	C	1	0	1	0	0	1	0	0
7	69442261	.	T	G	5	2	7	0	0	7	0	0
7	69447324	.	G	A	5	4	9	0	2	11	0	0
7	69447352	.	T	C	7	6	13	0	2	15	0	0
7	69447469	.	C	G	9	4	13	0	0	13	0	0
7	69447516	.	A	G	4	2	6	0	0	6	0	0
7	69447520	.	G	A	4	2	6	0	0	6	0	0
7	69447699	.	G	T	6	2	8	0	0	8	0	0
7	69458611	.	T	C	2	2	4	0	0	4	0	0
7	69467145	.	A	G	3	3	6	0	1	7	0	0
7	69467228	.	G	A	2	0	2	0	1	3	0	0
7	69467267	.	A	G	6	5	11	0	1	12	0	0
7	69467383	.	T	G	3	0	3	0	6	9	0	0
7	69477283	.	T	G	21	22	43	0	0	44	1	0
7	69477303	.	A	G	17	0	17	0	32	49	0	0
7	69477361	.	T	C	24	30	54	0	2	56	0	0
7	69477437	.	A	G	24	30	54	0	0	54	0	0
7	69477464	.	T	C	29	28	57	0	0	57	0	0
7	69484697	.	A	G	1	0	1	0	1	2	0	0
7	69486431	.	C	A	0	1	1	0	0	1	0	0
7	69496521	.	C	A	12	21	33	0	1	34	0	0
7	69496537	.	A	T	11	20	31	0	1	32	0	0
7	69496572	.	A	G	11	11	22	0	0	22	0	0
7	69497048	.	A	T	12	17	29	0	1	30	0	0
7	69497493	.	G	T	16	19	35	0	1	36	0	0
7	69497637	.	G	A	6	9	15	0	0	15	0	0
7	69501040	.	A	G	4	7	11	0	1	12	0	0
7	69501148	.	A	G	0	1	1	0	0	1	0	0
7	69501300	.	A	G	7	4	11	0	1	12	0	0
7	69501345	.	G	T	8	14	22	0	1	23	0	0
7	69566119	.	A	G	7	6	13	0	0	13	0	0
7	69566179	.	A	T	4	4	8	0	0	8	0	0
7	69576019	.	C	A	0	3	3	0	1	4	0	0
7	69583133	.	A	T	4	3	7	0	0	7	0	0
7	69583139	.	C	T	4	3	7	0	0	7	0	0
7	69937664	.	G	A	0	1	1	0	0	1	0	0
7	69943002	.	C	T	2	2	4	0	0	4	0	0
7	69950322	.	G	A	1	5	6	0	1	7	0	0
7	69950644	.	G	T	2	3	5	0	0	5	0	0
7	69950666	.	T	C	2	2	4	0	0	4	0	0
7	69959980	.	G	A	1	3	4	0	0	4	0	0
7	71351014	.	T	C	1	6	7	0	0	7	0	0
7	73617583	.	A	G	11	2	13	0	0	13	0	0
7	73617589	.	A	G	9	3	12	0	0	12	0	0
7	73618398	.	A	G	9	3	12	0	0	12	0	0
7	73618456	.	A	G	11	0	11	0	8	19	0	0
7	73618739	.	A	G	7	5	12	0	0	12	0	0
7	73618841	.	A	G	4	6	10	0	0	10	0	0
7	73656361	.	G	A	8	3	11	0	0	11	0	0
7	73806067	.	T	A	5	0	5	0	0	5	0	0
7	73928188	.	A	G	1	3	4	0	0	4	0	0
7	73928205	.	A	G	1	3	4	0	0	4	0	0
7	74135779	.	G	T	6	9	15	0	5	20	0	0
8	6368	.	T	C	3	18	21	1	7	44	15	0
8	121205	.	A	G	4	2	6	0	0	6	0	0
8	473875	.	G	A	1	2	3	0	0	3	0	0
8	487208	.	G	A	3	1	4	0	0	4	0	0
8	489120	.	C	T	3	2	5	0	0	5	0	0
8	489135	.	C	T	3	3	6	0	0	6	0	0
8	489169	.	C	T	7	7	14	0	0	14	0	0
8	489194	.	T	A	6	6	12	0	0	12	0	0
8	532308	.	T	A	1	4	5	0	1	6	0	0
8	532895	.	T	A	3	3	6	0	0	6	0	0
8	532923	.	C	T	5	4	9	0	0	9	0	0
8	534387	.	G	C	1	1	2	0	1	3	0	0
8	534418	.	C	T	0	1	1	0	3	4	0	0
8	534513	.	A	T	3	6	9	0	1	10	0	0
8	534603	.	A	C	0	5	5	0	1	6	0	0
8	539973	.	T	G	2	0	2	0	2	4	0	0
8	539979	.	C	G	2	1	3	0	0	3	0	0
8	540214	.	G	A	0	0	0	0	2	2	0	0
8	657555	.	G	A	0	2	2	0	2	4	0	0
8	660467	.	T	C	0	1	1	0	0	1	0	0
8	927337	.	G	A	9	10	19	0	3	22	0	0
8	928341	.	G	A	8	5	13	0	0	13	0	0
8	943953	.	G	C	0	1	1	0	0	1	0	0
8	1012018	.	A	G	3	8	11	0	0	11	0	0
8	1012959	.	C	T	1	2	3	0	0	3	0	0
8	1094388	.	G	A	2	3	5	0	0	5	0	0
8	1094542	.	T	C	7	7	14	0	1	15	0	0
8	1094566	.	C	T	12	5	17	0	1	18	0	0
8	1094590	.	G	A	0	8	8	0	9	18	1	0
8	1094973	.	G	T	0	5	5	0	14	19	0	0
8	1102533	.	G	T	12	16	28	0	2	30	0	0
8	1102551	.	C	T	13	15	28	0	1	29	0	0
8	1104980	.	A	G	2	0	2	0	1	3	0	0
8	1106149	.	C	T	12	17	29	0	0	29	0	0
8	1130526	.	C	A	3	5	8	0	0	8	0	0
8	1130574	.	G	A	6	3	9	0	0	9	0	0
8	1130590	.	A	T	8	4	12	0	0	12	0	0
8	1133743	.	A	G	2	1	3	0	1	4	0	0
8	1222558	.	A	G	21	9	30	0	2	32	0	0
8	1253651	.	G	A	7	11	18	0	1	19	0	0
8	1254337	.	C	T	7	6	13	0	2	15	0	0
8	1265705	.	T	G	6	3	9	0	0	9	0	0
8	1267074	.	T	A	10	12	22	0	6	28	0	0
8	1267153	.	G	A	16	10	26	0	0	26	0	0
8	1267157	.	G	A	17	9	26	0	0	26	0	0
8	1291857	.	T	G	1	0	1	0	5	6	0	0
8	1291986	.	C	T	4	2	6	0	1	7	0	0
8	1291993	.	G	A	0	3	3	0	5	8	0	0
8	1292079	.	T	C	1	5	6	0	0	6	0	0
8	1852056	.	A	G	2	5	7	0	0	7	0	0
8	1852078	.	A	G	4	4	8	0	0	8	0	0
8	1852185	.	A	G	5	4	9	0	1	10	0	0
8	1852274	.	A	G	1	8	9	0	0	9	0	0
8	1852552	.	A	G	8	2	10	0	0	10	0	0
8	1852599	.	A	G	4	5	9	0	0	9	0	0
8	1853474	.	A	G	3	5	8	0	0	8	0	0
8	2215809	.	G	C	1	0	1	0	4	5	0	0
8	2215965	.	T	A	1	4	5	0	0	6	1	0
8	2216013	.	A	G	1	4	5	0	2	7	0	0
8	2219543	.	C	T	0	0	0	0	1	1	0	0
8	2219604	.	G	A	1	4	5	0	0	5	0	0
8	2222522	.	T	C	2	3	5	0	0	5	0	0
8	2261052	.	T	C	3	4	7	0	0	7	0	0
8	2412911	.	G	A	26	28	54	0	2	56	0	0
8	2413133	.	T	G	43	24	67	0	1	68	0	0
8	2413160	.	G	C	34	0	34	0	32	66	0	0
8	2416886	.	G	A	21	14	35	0	1	36	0	0
8	2416931	.	C	T	0	6	6	0	5	11	0	0
8	2421318	.	T	C	21	14	35	0	0	35	0	0
8	2421342	.	C	A	15	14	29	0	1	30	0	0
8	2426500	.	A	G	2	6	8	0	0	8	0	0
8	2442565	.	C	A	1	1	2	0	1	3	0	0
8	2442571	.	T	C	1	2	3	0	1	4	0	0
8	2442765	.	C	T	3	0	3	0	0	3	0	0
8	2446639	.	G	T	0	6	6	0	1	7	0	0
8	2446957	.	C	T	1	2	3	0	0	3	0	0
8	2456933	.	C	T	4	2	6	0	0	6	0	0
8	2456953	.	C	G	3	2	5	0	2	7	0	0
8	2467230	.	A	G	2	0	2	0	15	17	0	0
8	2467233	.	A	G	3	14	17	0	0	17	0	0
8	2469292	.	G	A	12	12	24	0	2	26	0	0
8	2469377	.	G	C	8	6	14	0	2	16	0	0
8	2469401	.	C	T	9	7	16	0	1	17	0	0
8	2469528	.	G	T	4	4	8	0	0	8	0	0
8	2469559	.	C	T	4	3	7	0	0	7	0	0
8	2469693	.	C	T	1	4	5	0	0	5	0	0
8	2469720	.	T	G	1	2	3	0	1	4	0	0
8	2487329	.	T	C	2	2	4	0	1	5	0	0
8	2490968	.	C	T	29	29	58	0	1	59	0	0
8	2491338	.	G	A	14	10	24	0	2	26	0	0
8	2502037	.	G	A	17	28	45	0	1	46	0	0
8	2502067	.	C	T	31	41	72	0	0	72	0	0
8	2502088	.	A	G	24	25	49	0	2	51	0	0
8	2502112	.	A	G	14	13	27	0	1	28	0	0
8	2525450	.	T	C	3	4	7	0	1	8	0	0
8	2525492	.	A	T	5	9	14	0	0	14	0	0
8	2529817	.	T	A	1	1	2	0	0	2	0	0
8	2530118	.	G	A	10	6	16	0	0	16	0	0
8	2535588	.	T	A	14	10	24	0	0	24	0	0
8	2535642	.	T	C	10	10	20	0	0	20	0	0
8	2549011	.	G	A	0	1	1	0	0	1	0	0
8	2555046	.	C	G	5	3	8	0	0	8	0	0
8	2560680	.	T	G	3	0	3	0	2	5	0	0
8	2560848	.	A	G	4	1	5	0	0	5	0	0
8	2566882	.	G	T	1	3	4	0	0	4	0	0
8	2567788	.	T	C	3	2	5	0	0	5	0	0
8	2567818	.	C	T	7	4	11	0	0	11	0	0
8	2571478	.	T	C	1	1	2	0	0	2	0	0
8	2574336	.	A	T	1	0	1	0	0	1	0	0
8	2574463	.	A	G	7	0	7	0	5	12	0	0
8	2574470	.	T	G	7	6	13	0	0	13	0	0
8	2574514	.	A	C	6	6	12	0	2	14	0	0
8	2574524	.	A	C	8	5	13	0	1	14	0	0
8	2576183	.	G	A	1	2	3	0	0	3	0	0
8	2585329	.	G	C	8	12	20	0	1	21	0	0
8	2585681	.	C	A	18	16	34	0	0	34	0	0
8	2588348	.	A	G	19	32	51	0	5	56	0	0
8	2588354	.	C	A	0	36	36	0	20	56	0	0
8	2591624	.	A	C	9	0	9	0	9	18	0	0
8	2595746	.	C	T	1	1	2	0	0	2	0	0
8	2598043	.	A	C	2	0	2	0	3	5	0	0
8	2606354	.	T	C	1	2	3	0	0	3	0	0
8	2606435	.	A	T	4	4	8	0	1	9	0	0
8	2614836	.	A	T	1	0	1	0	0	1	0	0
8	2649827	.	A	G	2	4	6	0	0	6	0	0
8	2649832	.	G	A	2	4	6	0	0	6	0	0
8	2757956	.	C	T	0	1	1	0	1	2	0	0
8	2787035	.	C	T	2	6	8	0	0	8	0	0
8	2787141	.	T	C	3	3	6	0	0	6	0	0
8	2789535	.	T	C	2	3	5	0	0	5	0	0
8	2789536	.	C	A	2	3	5	0	0	5	0	0
8	2789592	.	T	C	1	6	7	0	0	7	0	0
8	2789655	.	C	A	2	4	6	0	0	6	0	0
8	2789697	.	G	A	1	2	3	0	0	3	0	0
8	2789748	.	T	A	3	5	8	0	0	8	0	0
8	2789757	.	G	T	3	5	8	0	0	8	0	0
8	3085393	.	G	A	0	2	2	0	0	2	0	0
8	3085466	.	C	A	1	2	3	0	0	3	0	0
8	3085565	.	A	G	0	6	6	0	0	6	0	0
8	3085841	.	T	A	2	5	7	0	0	7	0	0
8	3085863	.	A	G	2	6	8	0	0	8	0	0
8	3099585	.	G	A	0	10	10	0	11	21	0	0
8	3100184	.	G	C	1	2	3	0	0	3	0	0
8	3101241	.	G	T	5	11	16	0	1	17	0	0
8	3101277	.	T	C	5	10	15	0	1	16	0	0
8	3426825	.	T	C	2	2	4	0	0	4	0	0
8	3427273	.	T	C	1	2	3	0	0	3	0	0
8	3434245	.	C	T	2	3	5	0	1	6	0	0
8	3434449	.	C	T	2	2	4	0	0	4	0	0
8	3439164	.	G	A	3	3	6	0	0	6	0	0
8	3439309	.	C	T	4	2	6	0	0	6	0	0
8	3537152	.	G	A	0	0	0	0	1	1	0	0
8	3566172	.	A	T	1	2	3	0	0	3	0	0
8	3566190	.	C	T	1	2	3	0	0	3	0	0
8	3569907	.	C	T	1	3	4	0	0	4	0	0
8	3571727	.	T	A	0	2	2	0	0	2	0	0
8	3594308	.	A	G	3	0	3	0	4	7	0	0
8	3595161	.	G	A	0	0	0	0	1	1	0	0
8	3595359	.	C	T	1	3	4	0	0	4	0	0
8	3597233	.	T	C	3	4	7	0	0	7	0	0
8	3602715	.	T	A	1	1	2	0	0	2	0	0
8	3612263	.	T	A	0	1	1	0	0	1	0	0
8	3612308	.	A	T	6	4	10	0	0	10	0	0
8	3624208	.	G	C	1	1	2	0	0	2	0	0
8	3628683	.	C	T	2	2	4	0	0	4	0	0
8	3628747	.	C	A	7	14	21	0	2	23	0	0
8	3628758	.	T	A	6	19	25	0	0	25	0	0
8	3628782	.	G	A	0	19	19	0	10	29	0	0
8	3631371	.	T	C	0	2	2	0	0	2	0	0
8	3631932	.	C	T	4	1	5	0	0	5	0	0
8	3641218	.	G	C	9	7	16	0	0	16	0	0
8	3643299	.	T	C	14	12	26	0	1	27	0	0
8	3659979	.	T	C	0	2	2	0	0	2	0	0
8	3660034	.	C	T	5	3	8	0	0	8	0	0
8	3674701	.	T	C	0	2	2	0	1	3	0	0
8	3691097	.	C	T	2	2	4	0	0	4	0	0
8	3691113	.	T	C	2	0	2	0	3	5	0	0
8	3859383	.	T	A	3	2	5	0	0	5	0	0
8	3865233	.	T	C	5	4	9	0	0	9	0	0
8	3883831	.	C	G	3	2	5	0	0	5	0	0
8	3886220	.	T	C	0	1	1	0	0	1	0	0
8	3889662	.	G	A	1	3	4	0	1	5	0	0
8	3890837	.	T	C	0	1	1	0	0	1	0	0
8	3904963	.	C	T	4	7	11	0	0	11	0	0
8	3915909	.	G	A	0	1	1	0	0	1	0	0
8	3923371	.	C	T	3	5	8	0	0	8	0	0
8	3932889	.	A	T	5	6	11	0	0	11	0	0
8	3932974	.	A	G	5	7	12	0	0	12	0	0
8	3932990	.	A	G	8	6	14	0	0	14	0	0
8	3933498	.	T	A	4	13	17	0	1	18	0	0
8	3949558	.	G	T	3	3	6	0	0	6	0	0
8	3950039	.	C	G	5	3	8	0	0	8	0	0
8	3950317	.	G	A	4	2	6	0	0	6	0	0
8	3950341	.	A	G	0	3	3	0	0	3	0	0
8	3950529	.	C	T	1	3	4	0	0	4	0	0
8	3950655	.	C	T	4	2	6	0	0	6	0	0
8	3952495	.	G	T	3	2	5	0	0	5	0	0
8	4044846	.	G	A	3	7	10	0	0	10	0	0
8	4059087	.	G	A	1	3	4	0	0	4	0	0
8	4062750	.	G	A	2	2	4	0	0	4	0	0
8	4368714	.	C	G	5	4	9	0	0	9	0	0
8	4369021	.	A	C	5	5	10	0	0	10	0	0
8	4381510	.	A	G	2	0	2	0	2	4	0	0
8	4381624	.	G	A	0	1	1	0	0	1	0	0
8	4386198	.	A	G	1	4	5	0	0	5	0	0
8	4393910	.	C	G	6	3	9	0	0	9	0	0
8	4398425	.	A	T	2	2	4	0	1	5	0	0
8	4398531	.	T	C	2	5	7	0	1	8	0	0
8	4398737	.	C	T	5	13	18	0	1	19	0	0
8	4398762	.	A	G	9	11	20	0	2	22	0	0
8	4398981	.	G	A	0	7	7	0	5	12	0	0
8	4399055	.	A	G	6	6	12	0	1	13	0	0
8	4399754	.	T	A	3	6	9	0	0	9	0	0
8	4400337	.	A	G	1	2	3	0	0	3	0	0
8	4400699	.	C	A	8	7	15	0	0	15	0	0
8	4400861	.	T	C	5	6	11	0	0	11	0	0
8	4400872	.	G	A	0	4	4	0	5	9	0	0
8	4401053	.	T	G	8	10	18	0	1	19	0	0
8	4401068	.	C	T	7	8	15	0	1	16	0	0
8	4401374	.	G	A	2	5	7	0	6	13	0	0
8	4401514	.	A	T	8	9	17	0	1	19	1	0
8	4401687	.	G	A	16	14	30	0	0	30	0	0
8	4401708	.	C	T	13	22	35	0	1	36	0	0
8	4401813	.	G	T	16	22	38	0	1	39	0	0
8	4401913	.	T	G	9	12	21	0	0	21	0	0
8	4401931	.	T	C	10	9	19	0	1	20	0	0
8	4442655	.	G	A	0	1	1	0	0	1	0	0
8	4444201	.	A	G	4	4	8	0	0	8	0	0
8	4446247	.	A	C	2	1	3	0	6	9	0	0
8	4446266	.	C	T	1	4	5	0	1	6	0	0
8	4446303	.	T	C	1	4	5	0	0	5	0	0
8	4461859	.	A	G	1	1	2	0	0	2	0	0
8	4516885	.	C	T	0	2	2	0	1	3	0	0
8	4516962	.	G	A	5	2	7	0	0	7	0	0
8	4522035	.	T	A	4	3	7	0	0	7	0	0
8	4525072	.	G	A	1	1	2	0	0	2	0	0
8	4530635	.	C	A	2	3	5	0	0	5	0	0
8	4530647	.	G	A	2	2	4	0	0	4	0	0
8	4531840	.	A	G	1	1	2	0	0	2	0	0
8	4553698	.	A	T	0	1	1	0	0	1	0	0
8	4577907	.	A	G	1	2	3	0	0	3	0	0
8	4577965	.	A	T	1	2	3	0	0	3	0	0
8	4589148	.	A	G	28	20	48	0	3	51	0	0
8	4589169	.	T	G	20	26	46	0	2	48	0	0
8	4589216	.	A	T	25	16	41	0	2	43	0	0
8	4589402	.	C	T	25	31	56	0	1	57	0	0
8	4596649	.	T	A	5	6	11	0	1	12	0	0
8	4609822	.	T	C	12	0	12	0	13	25	0	0
8	4618536	.	G	A	15	5	20	0	0	20	0	0
8	4618562	.	C	T	0	6	6	0	13	19	0	0
8	4621454	.	A	G	6	3	9	0	0	9	0	0
8	4621614	.	A	T	1	4	5	0	0	5	0	0
8	4621817	.	G	T	3	6	9	0	1	10	0	0
8	4622023	.	T	A	5	2	7	0	0	7	0	0
8	4622032	.	A	G	5	2	7	0	0	7	0	0
8	4622087	.	T	C	3	0	3	0	3	6	0	0
8	4762881	.	G	A	0	3	3	0	2	5	0	0
8	4771987	.	C	T	5	1	6	0	0	6	0	0
8	4776243	.	A	T	16	12	28	0	2	30	0	0
8	4779959	.	A	G	1	3	4	0	0	4	0	0
8	4779962	.	G	T	1	3	4	0	0	4	0	0
8	4780110	.	A	C	3	4	7	0	0	7	0	0
8	4780127	.	A	T	3	4	7	0	0	7	0	0
8	4780368	.	T	A	4	3	7	0	0	7	0	0
8	4780552	.	C	T	0	6	6	0	8	14	0	0
8	4780586	.	G	A	8	9	17	0	0	17	0	0
8	4788763	.	A	G	1	3	4	0	1	5	0	0
8	4788942	.	T	C	7	0	7	0	13	20	0	0
8	4799126	.	T	A	2	2	4	0	0	4	0	0
8	4964521	.	G	A	6	12	18	0	0	18	0	0
8	5844982	.	T	C	1	4	5	0	0	5	0	0
8	5845014	.	C	G	1	4	5	0	0	5	0	0
8	5845042	.	C	T	2	3	5	0	1	6	0	0
8	5845060	.	T	G	1	5	6	0	0	6	0	0
8	5845807	.	A	G	1	2	3	0	0	3	0	0
8	6415959	.	T	C	3	4	7	0	0	7	0	0
8	6863678	.	A	G	8	1	9	0	11	20	0	0
8	6863822	.	G	A	9	6	15	0	2	17	0	0
8	6864062	.	C	G	8	4	12	0	0	12	0	0
8	6864077	.	T	C	7	5	12	0	1	13	0	0
8	6864416	.	C	A	20	7	27	0	2	29	0	0
8	6865247	.	T	A	2	3	5	0	0	5	0	0
8	6865357	.	C	T	13	8	21	0	1	22	0	0
8	6865542	.	C	T	24	12	36	0	1	37	0	0
8	6865834	.	A	G	21	17	38	0	2	40	0	0
8	6866083	.	G	A	18	21	39	0	2	41	0	0
8	6866592	.	G	T	19	26	45	0	2	47	0	0
8	6866835	.	T	G	10	5	15	0	1	16	0	0
8	6874937	.	C	T	9	15	24	0	1	25	0	0
8	6874968	.	A	G	11	21	32	0	1	33	0	0
8	6875061	.	G	T	15	11	26	0	0	26	0	0
8	6875300	.	C	T	14	16	30	0	2	32	0	0
8	6875354	.	T	C	3	4	7	0	0	7	0	0
8	6875562	.	C	T	9	6	15	0	0	15	0	0
8	6875563	.	C	T	9	6	15	0	0	15	0	0
8	6875722	.	A	G	11	18	29	0	0	29	0	0
8	6876297	.	T	C	1	1	2	0	1	3	0	0
8	6876381	.	A	G	12	6	18	0	0	18	0	0
8	6876705	.	A	C	14	10	24	0	1	25	0	0
8	6876941	.	G	T	6	6	12	0	2	14	0	0
8	6876999	.	T	C	8	9	17	0	0	17	0	0
8	6877130	.	T	G	3	2	5	0	0	5	0	0
8	6877248	.	T	C	4	0	4	0	5	9	0	0
8	6877268	.	T	C	7	3	10	0	0	10	0	0
8	6877375	.	A	G	3	2	5	0	0	5	0	0
8	6903650	.	A	G	4	2	6	0	0	6	0	0
8	6904092	.	C	T	1	4	5	0	0	5	0	0
8	6913809	.	T	C	2	0	2	0	1	3	0	0
8	6920909	.	A	G	3	8	11	0	2	13	0	0
8	6921117	.	C	G	0	28	28	0	18	46	0	0
8	6921344	.	A	C	16	17	33	0	0	33	0	0
8	6921421	.	T	A	20	18	38	0	0	39	1	0
8	6921581	.	A	C	19	26	45	0	2	48	1	0
8	6921671	.	G	A	8	13	21	0	1	22	0	0
8	6927428	.	T	C	6	14	20	0	0	20	0	0
8	6935642	.	A	T	12	13	25	0	1	26	0	0
8	6943167	.	A	T	0	1	1	0	0	1	0	0
8	6970040	.	G	A	2	3	5	0	1	6	0	0
8	6985008	.	A	G	2	0	2	0	0	2	0	0
8	7014341	.	A	G	0	3	3	0	0	3	0	0
8	7018017	.	G	A	1	2	3	0	0	3	0	0
8	7022216	.	T	A	11	14	25	0	1	26	0	0
8	7022227	.	A	G	12	12	24	0	0	24	0	0
8	7022305	.	C	T	5	13	18	0	0	18	0	0
8	7023091	.	T	G	9	0	9	0	10	19	0	0
8	7023098	.	T	C	12	8	20	0	0	20	0	0
8	7114497	.	T	C	1	2	3	0	0	3	0	0
8	7118497	.	T	C	12	3	15	0	0	15	0	0
8	7118520	.	T	G	11	0	11	0	4	15	0	0
8	7118809	.	G	A	1	4	5	0	0	5	0	0
8	7119013	.	G	A	0	10	10	0	2	12	0	0
8	7119189	.	A	G	2	3	5	0	0	5	0	0
8	7119203	.	T	C	2	3	5	0	0	5	0	0
8	7119757	.	A	G	8	4	12	0	0	12	0	0
8	7120395	.	G	A	0	3	3	0	3	6	0	0
8	7120479	.	A	T	4	3	7	0	0	7	0	0
8	7120498	.	A	G	3	4	7	0	0	7	0	0
8	7120546	.	A	G	4	10	14	0	0	14	0	0
8	7120572	.	C	G	5	8	13	0	0	13	0	0
8	7120604	.	T	C	4	6	10	0	1	11	0	0
8	7121011	.	T	A	5	12	17	0	0	17	0	0
8	7121067	.	G	A	0	4	4	0	0	4	0	0
8	7121312	.	C	T	2	3	5	0	1	6	0	0
8	7121347	.	A	T	4	6	10	0	0	10	0	0
8	7121593	.	T	A	2	3	5	0	0	5	0	0
8	7121681	.	A	G	6	13	19	0	0	19	0	0
8	7121868	.	C	T	5	8	13	0	0	13	0	0
8	7121877	.	A	G	5	7	12	0	1	13	0	0
8	7122171	.	A	T	0	4	4	0	0	4	0	0
8	7122186	.	T	C	2	6	8	0	0	8	0	0
8	7122221	.	T	A	3	6	9	0	0	9	0	0
8	7122248	.	C	A	4	5	9	0	0	9	0	0
8	7122332	.	A	G	0	6	6	0	0	6	0	0
8	7122459	.	A	G	10	2	12	0	0	12	0	0
8	7122460	.	A	T	10	2	12	0	0	12	0	0
8	7122931	.	G	A	0	6	6	0	9	15	0	0
8	7123171	.	G	C	0	13	13	0	10	23	0	0
8	7123233	.	A	T	17	10	27	0	0	27	0	0
8	7123257	.	T	C	11	8	19	0	5	24	0	0
8	7123323	.	C	A	14	6	20	0	3	23	0	0
8	7123326	.	A	G	15	8	23	0	0	23	0	0
8	7123360	.	A	T	13	9	22	0	0	22	0	0
8	7123414	.	G	A	0	11	11	0	5	16	0	0
8	7123415	.	G	C	5	11	16	0	0	16	0	0
8	7123452	.	G	A	10	13	23	0	0	23	0	0
8	7123472	.	A	G	12	12	24	0	1	25	0	0
8	7123491	.	T	C	14	13	27	0	1	29	1	0
8	7123538	.	G	A	12	13	25	0	0	25	0	0
8	7378464	.	A	G	43	12	55	0	3	58	0	0
8	7740086	.	G	C	0	1	1	0	0	1	0	0
8	7742196	.	C	T	8	4	12	0	0	12	0	0
8	7745898	.	G	A	4	7	11	0	0	11	0	0
8	7745907	.	T	C	6	7	13	0	0	13	0	0
8	7746030	.	C	T	8	7	15	0	0	15	0	0
8	7747613	.	A	G	3	0	3	0	2	5	0	0
8	7747616	.	C	T	2	2	4	0	1	5	0	0
8	7754289	.	C	T	3	3	6	0	0	6	0	0
8	7765230	.	G	A	0	11	11	0	5	16	0	0
8	7772097	.	C	T	8	7	15	0	0	15	0	0
8	7854287	.	T	G	1	1	2	0	0	2	0	0
8	7855888	.	G	A	0	2	2	0	2	4	0	0
8	7857369	.	A	G	4	0	4	0	4	8	0	0
8	7857378	.	T	C	4	3	7	0	1	8	0	0
8	7860547	.	A	C	3	2	5	0	0	5	0	0
8	7863603	.	C	T	2	0	2	0	0	2	0	0
8	7863747	.	T	C	4	3	7	0	0	7	0	0
8	7889397	.	T	A	3	2	5	0	0	5	0	0
8	7891240	.	T	C	1	1	2	0	0	2	0	0
8	7891371	.	A	C	4	3	7	0	0	7	0	0
8	7891397	.	G	A	0	3	3	0	1	4	0	0
8	7891640	.	C	A	4	2	6	0	0	6	0	0
8	7902138	.	C	T	1	3	4	0	0	4	0	0
8	7907837	.	G	C	2	6	8	0	0	8	0	0
8	7908221	.	T	C	3	4	7	0	1	8	0	0
8	7908417	.	C	A	4	4	8	0	2	10	0	0
8	7908520	.	A	G	3	3	6	0	0	6	0	0
8	7910040	.	A	G	5	2	7	0	0	7	0	0
8	7910047	.	A	G	1	2	3	0	3	6	0	0
8	7910107	.	T	C	4	3	7	0	0	7	0	0
8	7912216	.	A	C	8	5	13	0	0	13	0	0
8	7912267	.	C	G	8	1	9	0	5	14	0	0
8	7912394	.	G	A	8	5	13	0	1	14	0	0
8	8026005	.	T	C	3	2	5	0	0	5	0	0
8	8032918	.	T	C	4	2	6	0	0	6	0	0
8	8032945	.	A	G	3	2	5	0	0	5	0	0
8	8033116	.	G	A	2	2	4	0	0	4	0	0
8	8033275	.	G	A	0	3	3	0	0	3	0	0
8	8033290	.	A	G	0	3	3	0	0	3	0	0
8	8250970	.	A	G	1	0	1	0	4	5	0	0
8	8257329	.	T	G	0	0	0	0	2	2	0	0
8	8263677	.	C	T	5	3	8	0	0	8	0	0
8	8263732	.	T	C	1	2	3	0	0	3	0	0
8	8298472	.	C	T	16	10	26	0	0	26	0	0
8	8301910	.	A	G	2	1	3	0	0	3	0	0
8	8301913	.	T	A	2	1	3	0	0	3	0	0
8	8325553	.	T	A	2	1	3	0	0	3	0	0
8	8331823	.	A	T	10	7	17	0	2	19	0	0
8	8334428	.	C	T	7	2	9	0	1	10	0	0
8	8338969	.	C	T	14	7	21	0	1	22	0	0
8	8341313	.	T	C	6	12	18	0	0	18	0	0
8	8341340	.	A	C	5	13	18	0	0	18	0	0
8	8341383	.	T	C	2	9	11	0	2	13	0	0
8	8341486	.	A	C	5	7	12	0	0	12	0	0
8	8341617	.	A	C	2	3	5	0	0	5	0	0
8	8341619	.	T	C	2	0	2	0	3	5	0	0
8	8343217	.	T	G	6	10	16	0	0	16	0	0
8	8362684	.	G	A	7	5	12	0	0	12	0	0
8	8363058	.	C	T	0	2	2	0	1	3	0	0
8	8389011	.	A	G	1	4	5	0	0	5	0	0
8	8390797	.	A	G	1	4	5	0	1	6	0	0
8	8390821	.	A	G	1	3	4	0	0	4	0	0
8	8426432	.	A	G	1	1	2	0	0	2	0	0
8	8446343	.	T	A	3	5	8	0	0	8	0	0
8	8475010	.	T	C	5	1	6	0	0	6	0	0
8	8478367	.	T	G	1	3	4	0	1	5	0	0
8	8478861	.	C	T	1	3	4	0	0	4	0	0
8	8478862	.	T	C	1	3	4	0	0	4	0	0
8	8478921	.	A	C	2	3	5	0	0	5	0	0
8	8484032	.	G	A	3	3	6	0	0	6	0	0
8	8484269	.	A	G	5	2	7	0	0	7	0	0
8	8484275	.	A	G	4	2	6	0	0	6	0	0
8	8486783	.	G	A	3	3	6	0	0	6	0	0
8	8489175	.	G	A	2	3	5	0	0	5	0	0
8	8605950	.	T	C	3	5	8	0	0	8	0	0
8	8606067	.	C	T	1	7	8	0	0	8	0	0
8	8606070	.	C	T	1	6	7	0	0	7	0	0
8	8606286	.	C	T	3	5	8	0	0	8	0	0
8	8661657	.	C	G	3	2	5	0	0	5	0	0
8	8661663	.	A	G	2	2	4	0	0	4	0	0
8	8686398	.	T	C	1	0	1	0	4	5	0	0
8	8846877	.	C	T	2	6	8	0	0	8	0	0
8	8847341	.	T	A	5	5	10	0	1	11	0	0
8	8847410	.	A	G	3	2	5	0	0	5	0	0
8	8847434	.	A	C	6	2	8	0	0	8	0	0
8	8847593	.	T	C	5	4	9	0	1	10	0	0
8	8847648	.	T	A	9	11	20	0	0	20	0	0
8	8847676	.	G	C	8	11	19	0	0	19	0	0
8	8847788	.	A	C	9	11	20	0	1	21	0	0
8	8847857	.	T	C	3	12	15	0	1	16	0	0
8	8847860	.	T	C	4	13	17	0	0	17	0	0
8	8848122	.	C	A	6	10	16	0	0	16	0	0
8	8905416	.	T	C	5	18	23	0	0	23	0	0
8	8914899	.	T	C	13	13	26	0	1	27	0	0
8	8914911	.	C	T	10	11	21	0	0	21	0	0
8	8919045	.	G	A	0	12	12	0	18	30	0	0
8	8922367	.	T	A	20	14	34	0	1	35	0	0
8	8932788	.	C	T	1	2	3	0	0	3	0	0
8	8932794	.	A	T	1	2	3	0	0	3	0	0
8	8957424	.	G	A	2	2	4	0	0	4	0	0
8	8975926	.	T	C	0	2	2	0	0	2	0	0
8	8977919	.	G	A	3	3	6	0	0	6	0	0
8	9011843	.	G	A	4	3	7	0	0	7	0	0
8	9052123	.	C	T	6	11	17	0	0	17	0	0
8	9052184	.	A	T	5	7	12	0	0	12	0	0
8	9092466	.	A	G	2	2	4	0	0	4	0	0
8	9222862	.	C	T	1	12	13	0	8	21	0	0
8	9222867	.	T	A	10	12	22	0	2	24	0	0
8	9222988	.	G	C	15	12	27	0	1	28	0	0
8	9223044	.	A	G	15	11	26	0	0	26	0	0
8	9231039	.	T	C	11	0	11	0	4	15	0	0
8	9231054	.	C	T	6	4	10	0	1	11	0	0
8	9232930	.	C	T	2	1	3	0	0	3	0	0
8	9262024	.	G	A	3	6	9	0	1	10	0	0
8	9270373	.	G	A	2	3	5	0	0	5	0	0
8	9369304	.	A	G	0	1	1	0	0	1	0	0
8	9390769	.	G	A	1	1	2	0	0	2	0	0
8	9394977	.	C	T	3	2	5	0	0	5	0	0
8	9395005	.	G	A	2	2	4	0	1	5	0	0
8	9429697	.	G	A	0	1	1	0	0	1	0	0
8	9699182	.	G	C	4	2	6	0	1	7	0	0
8	9709591	.	T	C	1	0	1	0	0	1	0	0
8	9731233	.	A	G	2	3	5	0	0	5	0	0
8	9733153	.	G	A	0	1	1	0	1	2	0	0
8	9733174	.	G	A	3	1	4	0	0	4	0	0
8	9743078	.	T	C	1	0	1	0	0	1	0	0
8	9743081	.	A	T	1	0	1	0	0	1	0	0
8	9748783	.	A	G	1	3	4	0	0	4	0	0
8	9755411	.	A	G	3	0	3	0	4	7	0	0
8	9761116	.	A	C	3	2	5	0	0	5	0	0
8	9791976	.	T	C	7	9	16	0	1	17	0	0
8	9791977	.	G	A	8	9	17	0	0	17	0	0
8	9868310	.	A	G	1	3	4	0	0	4	0	0
8	9961673	.	T	C	7	3	10	0	0	10	0	0
8	9985326	.	C	T	3	12	15	0	2	17	0	0
8	9985458	.	T	C	3	0	3	0	0	3	0	0
8	10306283	.	T	C	2	1	3	0	0	3	0	0
8	10307170	.	C	T	21	11	32	0	2	34	0	0
8	10307686	.	G	T	13	19	32	0	2	34	0	0
8	10307730	.	C	G	14	0	14	0	17	31	0	0
8	10308684	.	T	G	6	0	6	0	10	16	0	0
8	10562400	.	A	C	7	8	15	0	2	17	0	0
8	10823100	.	G	C	1	3	4	0	0	4	0	0
8	10835439	.	A	G	1	2	3	0	0	3	0	0
8	10852169	.	T	A	0	1	1	0	0	1	0	0
8	10856107	.	A	G	7	3	10	0	0	10	0	0
8	10856883	.	A	C	8	5	13	0	0	13	0	0
8	10856915	.	T	C	7	3	10	0	0	10	0	0
8	10869785	.	T	C	1	3	4	0	0	4	0	0
8	10869827	.	T	A	1	3	4	0	0	4	0	0
8	10869851	.	T	C	1	4	5	0	0	5	0	0
8	10870625	.	C	T	2	2	4	0	0	4	0	0
8	10873945	.	A	G	3	2	5	0	0	5	0	0
8	10879223	.	C	A	0	3	3	0	0	3	0	0
8	10882708	.	T	C	6	3	9	0	0	9	0	0
8	10882877	.	A	C	4	3	7	0	0	7	0	0
8	10884489	.	T	C	4	5	9	0	0	9	0	0
8	10890318	.	T	C	6	6	12	0	0	12	0	0
8	10890325	.	C	G	5	0	5	0	6	11	0	0
8	10894887	.	C	T	4	3	7	0	0	7	0	0
8	10895162	.	G	A	2	6	8	0	0	8	0	0
8	10937696	.	A	T	3	2	5	0	0	5	0	0
8	10938418	.	T	C	2	0	2	0	0	2	0	0
8	10956747	.	G	A	3	5	8	0	0	8	0	0
8	10956824	.	A	G	7	9	16	0	3	19	0	0
8	10957045	.	G	T	4	15	19	0	0	19	0	0
8	10957168	.	A	C	5	0	5	0	11	16	0	0
8	10967342	.	T	C	14	0	14	0	12	26	0	0
8	10969651	.	T	A	11	2	13	0	0	13	0	0
8	10972414	.	G	A	1	1	2	0	0	2	0	0
8	10978101	.	A	G	8	13	21	0	0	21	0	0
8	10980909	.	A	G	1	1	2	0	0	2	0	0
8	10987348	.	A	G	0	1	1	0	0	1	0	0
8	10988903	.	C	T	2	1	3	0	0	3	0	0
8	10988963	.	A	G	1	0	1	0	0	1	0	0
8	11004226	.	A	G	3	5	8	0	1	9	0	0
8	11004246	.	G	A	4	8	12	0	0	12	0	0
8	11004625	.	A	G	6	2	8	0	0	8	0	0
8	11004652	.	T	A	6	3	9	0	0	9	0	0
8	11009006	.	A	T	12	5	17	0	0	17	0	0
8	11009010	.	C	T	12	4	16	0	1	17	0	0
8	11009117	.	T	C	13	5	18	0	1	19	0	0
8	11016720	.	A	C	3	9	12	0	0	12	0	0
8	11019138	.	T	C	5	0	5	0	3	8	0	0
8	11027931	.	G	A	2	3	5	0	1	6	0	0
8	11027948	.	G	A	2	5	7	0	0	7	0	0
8	11028031	.	T	C	1	3	4	0	1	5	0	0
8	11039011	.	T	A	1	1	2	0	0	2	0	0
8	11115117	.	A	T	3	2	5	0	1	6	0	0
8	11115578	.	A	T	1	2	3	0	0	3	0	0
8	11146856	.	T	C	2	8	10	0	1	11	0	0
8	11146883	.	T	G	4	10	14	0	1	15	0	0
8	11179228	.	T	A	5	8	13	0	1	14	0	0
8	11180061	.	C	T	4	3	7	0	0	7	0	0
8	11180063	.	T	G	4	2	6	0	1	7	0	0
8	11180115	.	G	C	2	0	2	0	0	2	0	0
8	11182273	.	G	A	4	8	12	0	0	12	0	0
8	11182825	.	G	A	10	5	15	0	1	16	0	0
8	11183555	.	G	T	4	2	6	0	0	6	0	0
8	11183670	.	G	T	2	7	9	0	0	9	0	0
8	11183690	.	T	C	1	6	7	0	1	8	0	0
8	11183708	.	G	A	2	6	8	0	0	8	0	0
8	11183733	.	C	T	2	5	7	0	0	7	0	0
8	11183773	.	T	G	4	3	7	0	0	7	0	0
8	11183787	.	G	A	4	2	6	0	0	6	0	0
8	11183943	.	A	T	2	2	4	0	0	4	0	0
8	11184030	.	C	A	2	2	4	0	2	6	0	0
8	11184192	.	T	G	1	2	3	0	0	3	0	0
8	11184623	.	T	C	5	4	9	0	0	9	0	0
8	11185286	.	C	T	2	3	5	0	0	5	0	0
8	11185289	.	C	G	2	3	5	0	0	5	0	0
8	11761820	.	C	T	0	2	2	0	0	2	0	0
8	12935793	.	A	G	0	0	0	0	3	3	0	0
8	14441120	.	A	G	15	8	23	0	3	26	0	0
8	14441524	.	A	G	8	10	18	0	0	18	0	0
8	14792860	.	A	G	2	2	4	0	0	4	0	0
8	14981820	.	T	G	1	3	4	0	0	4	0	0
8	14981822	.	G	T	1	3	4	0	0	4	0	0
8	14983093	.	A	G	5	4	9	0	0	9	0	0
8	16115695	.	A	G	18	3	21	0	1	22	0	0
8	16517553	.	G	A	4	3	7	0	0	7	0	0
8	16517558	.	T	C	4	3	7	0	0	7	0	0
8	16519102	.	T	G	8	11	19	0	1	20	0	0
8	16519560	.	A	G	4	2	6	0	1	7	0	0
8	16519692	.	G	A	11	5	16	0	1	17	0	0
8	16519695	.	G	C	11	5	16	0	0	16	0	0
8	16519782	.	C	T	7	5	12	0	0	12	0	0
8	16524401	.	G	C	2	0	2	0	4	6	0	0
8	16525250	.	G	T	1	1	2	0	0	2	0	0
8	16525366	.	T	A	5	2	7	0	0	7	0	0
8	16525417	.	A	G	3	2	5	0	0	5	0	0
8	16527060	.	T	C	2	0	2	0	4	6	0	0
8	16527091	.	G	A	2	3	5	0	0	5	0	0
8	16528223	.	A	G	6	4	10	0	0	10	0	0
8	16528390	.	T	G	4	2	6	0	0	6	0	0
8	16528475	.	C	T	1	2	3	0	3	6	0	0
8	16582470	.	T	A	13	4	17	0	2	19	0	0
8	16582608	.	G	A	20	18	38	0	1	39	0	0
8	16583043	.	G	A	11	6	17	0	0	17	0	0
8	16583059	.	A	C	12	3	15	0	1	16	0	0
8	16583127	.	C	T	3	21	24	0	2	26	0	0
8	16583174	.	C	A	25	10	35	0	1	36	0	0
8	16583447	.	C	T	17	19	36	0	1	37	0	0
8	16583528	.	C	T	27	5	32	0	2	38	4	0
8	16583534	.	G	A	21	3	24	0	2	40	14	0
8	16583591	.	C	T	31	9	40	3	3	46	0	0
8	16584037	.	C	T	0	5	5	0	4	9	0	0
8	16587510	.	T	A	10	16	26	0	1	27	0	0
8	16588157	.	A	G	3	3	6	0	0	6	0	0
8	16588421	.	C	T	6	10	16	0	0	16	0	0
8	16592465	.	G	C	14	14	28	0	2	30	0	0
8	16597215	.	C	T	5	8	13	0	1	14	0	0
8	16597238	.	G	A	5	8	13	0	1	14	0	0
8	16597252	.	G	A	6	10	16	0	1	17	0	0
8	16597632	.	C	T	3	2	5	0	1	6	0	0
8	16597649	.	G	T	2	0	2	0	1	3	0	0
8	16597889	.	G	A	4	5	9	0	0	9	0	0
8	16598148	.	C	T	0	4	4	0	5	9	0	0
8	16600671	.	T	C	2	4	6	0	0	6	0	0
8	16602571	.	G	A	3	4	7	0	0	7	0	0
8	16605597	.	A	G	1	4	5	0	0	5	0	0
8	16608287	.	G	A	0	1	1	0	0	1	0	0
8	16608875	.	G	A	1	2	3	0	0	3	0	0
8	16608898	.	C	T	0	2	2	0	2	4	0	0
8	16610196	.	A	G	5	2	7	0	0	7	0	0
8	16610221	.	T	A	1	2	3	0	0	3	0	0
8	16610387	.	G	A	0	1	1	0	0	1	0	0
8	16610585	.	T	C	1	0	1	0	0	1	0	0
8	16615802	.	T	C	4	5	9	0	2	11	0	0
8	16615866	.	T	C	2	10	12	0	1	13	0	0
8	16615867	.	A	G	8	3	11	0	2	13	0	0
8	16615929	.	A	T	19	9	28	0	4	32	0	0
8	16616190	.	C	A	7	17	24	0	0	24	0	0
8	16616899	.	G	A	6	1	7	0	0	7	0	0
8	16625575	.	C	A	4	8	12	0	1	13	0	0
8	16681329	.	C	T	1	2	3	0	0	3	0	0
8	16683774	.	G	A	1	1	2	0	0	2	0	0
8	16683891	.	T	C	0	1	1	0	0	1	0	0
8	16685439	.	C	T	0	1	1	0	0	1	0	0
8	16685821	.	A	G	2	1	3	0	0	3	0	0
8	16702114	.	G	A	3	2	5	0	0	5	0	0
8	16702129	.	G	A	1	3	4	0	0	4	0	0
8	16703900	.	T	C	1	0	1	0	0	1	0	0
8	16729938	.	A	G	10	13	23	0	1	24	0	0
8	16729941	.	G	A	10	14	24	0	0	24	0	0
8	16734037	.	A	T	4	3	7	0	1	8	0	0
8	16734074	.	C	G	5	5	10	0	1	11	0	0
8	16734247	.	C	A	11	9	20	0	0	20	0	0
8	16736489	.	A	T	3	3	6	0	0	6	0	0
8	16738054	.	G	A	5	9	14	0	1	15	0	0
8	16738149	.	G	T	8	9	17	0	0	17	0	0
8	16738481	.	C	T	1	5	6	0	2	8	0	0
8	16740792	.	A	G	1	2	3	0	0	3	0	0
8	16755381	.	G	A	9	5	14	0	2	16	0	0
8	16756937	.	A	T	4	2	6	0	0	6	0	0
8	16768992	.	A	G	9	0	9	0	10	19	0	0
8	16769126	.	C	T	8	14	22	0	1	23	0	0
8	16769641	.	G	A	3	2	5	0	0	5	0	0
8	17044255	.	G	A	0	0	0	0	2	2	0	0
8	17055727	.	C	T	1	21	22	0	25	47	0	0
8	17055766	.	G	A	26	23	49	0	0	49	0	0
8	17062173	.	G	A	13	8	21	0	1	22	0	0
8	17067269	.	T	C	12	14	26	0	2	28	0	0
8	17079902	.	C	T	1	1	2	0	0	2	0	0
8	17081782	.	C	T	15	22	37	0	1	38	0	0
8	17081863	.	G	A	5	6	11	0	0	11	0	0
8	17082696	.	C	A	4	1	5	0	0	5	0	0
8	17082927	.	G	A	0	5	5	0	12	18	1	0
8	17084696	.	G	C	14	12	26	0	0	26	0	0
8	17084733	.	C	G	9	6	15	0	0	15	0	0
8	17085921	.	G	A	19	16	35	0	3	38	0	0
8	17086002	.	C	T	16	12	28	0	0	28	0	0
8	17086033	.	C	T	12	6	18	0	0	18	0	0
8	17086096	.	A	T	7	6	13	0	0	13	0	0
8	17146887	.	T	C	5	2	7	0	0	7	0	0
8	17151997	.	A	G	1	3	4	0	0	4	0	0
8	17152057	.	C	A	0	1	1	0	1	2	0	0
8	17154110	.	C	T	2	3	5	0	0	5	0	0
8	17154128	.	A	G	3	0	3	0	3	6	0	0
8	17154188	.	C	T	2	0	2	0	0	2	0	0
8	17156641	.	A	G	2	2	4	0	2	6	0	0
8	17156772	.	G	C	5	5	10	0	1	11	0	0
8	17156806	.	A	G	4	4	8	0	0	8	0	0
8	17156869	.	C	T	1	2	3	0	1	4	0	0
8	17156950	.	T	A	7	4	11	0	1	12	0	0
8	17163766	.	T	A	12	12	24	0	0	24	0	0
8	17163771	.	A	G	12	11	23	0	0	23	0	0
8	17163856	.	T	G	5	5	10	0	0	10	0	0
8	17175007	.	A	T	1	0	1	0	1	2	0	0
8	17175037	.	T	C	0	1	1	0	0	1	0	0
8	17192538	.	C	G	1	1	2	0	4	6	0	0
8	17396056	.	G	T	12	12	24	0	2	26	0	0
8	17396303	.	G	A	19	16	35	0	0	35	0	0
8	17396657	.	C	G	1	13	14	0	9	23	0	0
8	17396814	.	T	A	7	3	10	1	0	11	0	0
8	17396904	.	T	C	14	0	14	0	16	30	0	0
8	17397095	.	C	T	5	4	9	0	0	9	0	0
8	17397807	.	C	A	9	5	14	0	0	14	0	0
8	17398070	.	T	C	8	11	19	0	3	22	0	0
8	17398229	.	A	T	7	9	16	0	0	16	0	0
8	17398775	.	G	A	17	6	23	0	3	26	0	0
8	17399061	.	C	T	4	7	11	0	0	11	0	0
8	17399281	.	A	T	4	4	8	0	0	8	0	0
8	17399586	.	T	A	16	11	27	0	1	28	0	0
8	17399609	.	C	T	14	10	24	0	1	25	0	0
8	17404605	.	C	A	1	5	6	0	3	9	0	0
8	17407150	.	G	A	6	3	9	0	1	10	0	0
8	17407210	.	C	G	0	7	7	0	3	10	0	0
8	17407258	.	T	C	2	0	2	0	10	12	0	0
8	17515848	.	G	A	2	5	7	0	0	7	0	0
8	17516304	.	C	T	0	3	3	0	2	5	0	0
8	17583923	.	T	G	7	2	9	0	0	9	0	0
8	17775550	.	T	G	3	2	5	0	0	5	0	0
8	17778843	.	G	C	5	5	10	0	0	10	0	0
8	17778864	.	C	T	4	3	7	0	0	7	0	0
8	17781165	.	A	G	6	5	11	0	0	11	0	0
8	17781416	.	A	T	1	0	1	0	0	1	0	0
8	17781468	.	C	G	7	5	12	0	0	12	0	0
8	17781555	.	C	T	6	4	10	0	0	10	0	0
8	17783735	.	G	A	8	4	12	0	1	13	0	0
8	17784322	.	T	A	5	6	11	0	0	11	0	0
8	17784426	.	T	G	9	10	19	0	0	19	0	0
8	17784466	.	G	A	3	6	9	0	0	9	0	0
8	17784517	.	T	C	2	2	4	0	0	4	0	0
8	17784521	.	G	A	2	2	4	0	0	4	0	0
8	17787660	.	G	A	6	3	9	0	0	9	0	0
8	17787833	.	A	T	3	4	7	0	1	8	0	0
8	17788008	.	T	G	2	3	5	0	0	5	0	0
8	17788049	.	C	T	0	1	1	0	0	1	0	0
8	17790323	.	C	T	4	3	7	0	0	7	0	0
8	17800823	.	A	T	1	3	4	0	0	4	0	0
8	17801028	.	G	A	3	2	5	0	0	5	0	0
8	17801061	.	T	C	1	2	3	0	1	4	0	0
8	17801438	.	A	G	0	1	1	0	0	1	0	0
8	17808331	.	A	G	2	2	4	0	0	4	0	0
8	17822181	.	G	A	1	5	6	0	1	7	0	0
8	17904618	.	A	G	1	0	1	0	0	1	0	0
8	17906164	.	C	T	3	3	6	0	0	6	0	0
8	17906181	.	C	A	3	3	6	0	0	6	0	0
8	17917127	.	A	G	1	2	3	0	0	3	0	0
8	17917129	.	A	G	1	1	2	0	1	3	0	0
8	17917200	.	C	T	2	4	6	0	0	6	0	0
8	17917231	.	G	A	1	4	5	0	0	5	0	0
8	17983718	.	G	C	2	2	4	0	0	4	0	0
8	17983788	.	C	A	5	6	11	0	0	11	0	0
8	17983867	.	A	C	1	0	1	0	3	4	0	0
8	17984086	.	T	C	2	2	4	0	0	4	0	0
8	18024959	.	C	T	1	0	1	0	0	1	0	0
8	18030857	.	C	T	5	4	9	0	1	10	0	0
8	18030884	.	G	A	1	1	2	0	0	2	0	0
8	18035231	.	T	A	10	15	25	0	1	26	0	0
8	18035290	.	T	C	11	9	20	0	2	22	0	0
8	18035303	.	T	A	11	10	21	0	3	24	0	0
8	18035371	.	T	C	13	14	27	0	0	27	0	0
8	18035786	.	C	T	14	15	29	0	1	31	1	0
8	18035963	.	T	C	9	13	22	0	0	22	0	0
8	18036167	.	T	C	8	18	26	0	0	26	0	0
8	18039726	.	T	A	1	5	6	0	0	6	0	0
8	18041793	.	C	T	3	2	5	0	0	5	0	0
8	18041814	.	G	A	2	2	4	0	0	4	0	0
8	18193373	.	C	G	11	9	20	0	0	20	0	0
8	18193420	.	C	G	12	4	16	0	0	16	0	0
8	18193503	.	G	T	7	3	10	0	0	10	0	0
8	18193591	.	A	T	10	10	20	0	0	20	0	0
8	18193628	.	T	C	21	14	35	0	1	36	0	0
8	18193707	.	T	C	28	14	42	0	0	42	0	0
8	18194238	.	T	C	28	10	38	0	1	39	0	0
8	18194283	.	G	A	11	7	18	0	0	18	0	0
8	18196444	.	C	T	2	18	20	0	21	41	0	0
8	18196462	.	A	G	20	19	39	0	1	40	0	0
8	18198801	.	C	T	7	5	12	0	0	12	0	0
8	18199999	.	A	G	1	2	3	0	0	3	0	0
8	18206787	.	T	C	1	3	4	0	0	4	0	0
8	18206793	.	A	G	1	2	3	0	0	3	0	0
8	18243849	.	G	C	3	1	4	0	0	4	0	0
8	18243871	.	T	C	2	1	3	0	0	3	0	0
8	18356524	.	G	A	12	25	37	0	2	39	0	0
8	18356688	.	G	A	11	14	25	0	1	26	0	0
8	18358709	.	T	C	5	6	11	0	1	12	0	0
8	18358760	.	C	A	4	6	10	0	0	10	0	0
8	18358879	.	G	A	1	0	1	0	0	1	0	0
8	18361223	.	G	A	7	6	13	0	0	13	0	0
8	18365134	.	G	A	0	2	2	0	0	2	0	0
8	18486731	.	T	C	1	2	3	0	0	3	0	0
8	18486773	.	A	C	1	2	3	0	0	3	0	0
8	18510560	.	A	G	1	1	2	0	0	2	0	0
8	18512015	.	A	T	1	2	3	0	0	3	0	0
8	18514855	.	A	T	5	4	9	0	0	9	0	0
8	18515092	.	G	T	1	1	2	0	0	2	0	0
8	18515137	.	G	A	2	4	6	0	0	6	0	0
8	18515138	.	G	A	2	4	6	0	0	6	0	0
8	18515206	.	T	G	1	3	4	0	0	4	0	0
8	18554651	.	T	C	5	6	11	0	0	11	0	0
8	18554731	.	T	A	5	9	14	0	1	15	0	0
8	18554826	.	G	A	9	8	17	0	1	18	0	0
8	18562225	.	C	A	14	17	31	0	2	33	0	0
8	18562570	.	C	T	8	6	14	0	1	15	0	0
8	18562950	.	T	C	1	2	3	0	0	3	0	0
8	18566278	.	G	A	16	12	28	0	2	30	0	0
8	18566327	.	C	A	23	8	31	0	1	32	0	0
8	18566419	.	T	A	16	11	27	0	1	28	0	0
8	18566466	.	A	T	11	11	22	0	0	22	0	0
8	18566615	.	T	G	15	14	29	0	1	30	0	0
8	18566669	.	C	T	15	16	31	0	1	32	0	0
8	18566687	.	T	C	11	20	31	0	3	34	0	0
8	18567020	.	G	A	18	19	37	0	0	37	0	0
8	18567230	.	G	A	11	10	21	0	5	26	0	0
8	18567291	.	A	C	13	5	18	0	2	20	0	0
8	18567342	.	G	A	19	14	33	0	1	34	0	0
8	18567453	.	A	G	13	16	29	0	2	32	1	0
8	18567536	.	T	A	5	1	6	0	0	6	0	0
8	18567559	.	C	T	9	6	15	0	1	16	0	0
8	18567577	.	G	T	11	13	24	0	0	24	0	0
8	18568022	.	G	C	15	9	24	0	0	24	0	0
8	18568121	.	C	T	12	12	24	0	0	24	0	0
8	18568741	.	G	T	16	9	25	0	0	25	0	0
8	18569039	.	T	C	10	3	13	0	0	13	0	0
8	18569126	.	T	C	9	7	16	0	0	16	0	0
8	18569129	.	A	G	8	7	15	0	1	16	0	0
8	18569221	.	C	A	6	8	14	0	0	14	0	0
8	18569316	.	T	G	5	3	8	0	0	8	0	0
8	18569767	.	A	T	5	9	14	0	0	14	0	0
8	18569795	.	T	A	5	9	14	0	0	14	0	0
8	18570117	.	C	G	0	3	3	0	7	10	0	0
8	18570190	.	G	C	3	5	8	0	1	9	0	0
8	18570201	.	C	T	3	4	7	0	1	8	0	0
8	18570239	.	A	G	6	8	14	0	1	15	0	0
8	18582554	.	C	T	2	0	2	0	0	2	0	0
8	18582626	.	G	A	4	3	7	0	0	7	0	0
8	18582710	.	C	A	5	5	10	0	0	10	0	0
8	18582789	.	C	G	1	7	8	0	0	8	0	0
8	18582857	.	T	C	8	6	14	0	0	14	0	0
8	18592714	.	T	C	2	3	5	0	0	5	0	0
8	18592966	.	C	T	2	1	3	0	0	3	0	0
8	18592973	.	C	T	2	2	4	0	0	4	0	0
8	18593465	.	C	T	5	3	8	0	0	8	0	0
8	18598306	.	C	T	14	8	22	0	0	22	0	0
8	18598333	.	A	T	11	10	21	0	1	22	0	0
8	18598351	.	A	T	13	8	21	0	0	21	0	0
8	18598590	.	T	G	8	0	8	0	7	15	0	0
8	18598628	.	A	T	9	11	20	0	1	21	0	0
8	18598782	.	T	C	13	9	22	0	1	23	0	0
8	18598997	.	G	T	14	15	29	0	0	29	0	0
8	18599235	.	G	A	4	6	10	0	0	10	0	0
8	18609265	.	A	T	3	4	7	0	0	7	0	0
8	18609272	.	C	A	5	3	8	0	1	9	0	0
8	18609308	.	C	T	6	3	9	0	0	9	0	0
8	18611048	.	G	A	3	7	10	0	0	10	0	0
8	18613763	.	C	T	4	1	5	0	0	5	0	0
8	18613770	.	A	C	3	2	5	0	0	5	0	0
8	18618075	.	G	A	0	2	2	0	0	2	0	0
8	18641712	.	T	C	1	5	6	0	0	6	0	0
8	18647298	.	G	A	4	7	11	0	1	12	0	0
8	18647357	.	G	T	8	4	12	0	1	13	0	0
8	18836881	.	T	C	0	1	1	0	0	1	0	0
8	18837864	.	C	T	2	1	3	0	0	3	0	0
8	18840295	.	A	G	8	0	8	0	5	13	0	0
8	18840330	.	C	T	3	5	8	0	1	9	0	0
8	18840561	.	T	A	5	3	8	0	1	9	0	0
8	18840616	.	A	G	1	0	1	0	1	2	0	0
8	18842364	.	A	G	2	1	3	0	1	4	0	0
8	18890966	.	A	G	7	7	14	0	0	14	0	0
8	18891001	.	G	A	3	6	9	0	0	9	0	0
8	18891033	.	T	A	8	7	15	0	0	15	0	0
8	18899244	.	T	A	3	2	5	0	1	6	0	0
8	18936739	.	C	T	0	4	4	0	6	10	0	0
8	19232588	.	C	A	0	3	3	0	0	3	0	0
8	19284349	.	T	A	2	3	5	0	1	6	0	0
8	19284357	.	A	T	2	1	3	0	1	4	0	0
8	19285261	.	A	G	3	2	5	0	0	5	0	0
8	19401508	.	C	T	3	19	22	0	30	52	0	0
8	19402136	.	G	T	6	10	16	0	3	19	0	0
8	19402363	.	A	G	17	23	40	0	4	44	0	0
8	19402374	.	C	T	2	25	27	0	14	42	1	0
8	19472131	.	C	G	9	8	17	0	0	17	0	0
8	19474072	.	T	C	5	0	5	0	3	8	0	0
8	19476600	.	A	G	2	3	5	0	1	6	0	0
8	19476613	.	C	T	3	4	7	0	1	8	0	0
8	19477263	.	A	T	0	1	1	0	0	1	0	0
8	19477928	.	A	G	3	3	6	0	1	7	0	0
8	19478140	.	C	T	4	0	4	0	2	6	0	0
8	19479784	.	A	G	1	0	1	0	0	1	0	0
8	19481909	.	A	G	2	1	3	0	0	3	0	0
8	19481921	.	G	A	3	1	4	0	0	4	0	0
8	19490532	.	A	G	1	2	3	0	0	3	0	0
8	19499851	.	C	G	5	2	7	0	0	7	0	0
8	19499867	.	T	C	5	1	6	0	0	6	0	0
8	19504059	.	A	G	4	5	9	0	0	9	0	0
8	19504081	.	T	A	5	8	13	0	0	13	0	0
8	19504144	.	A	G	6	19	25	0	2	27	0	0
8	19508927	.	A	G	13	8	21	0	2	23	0	0
8	19508961	.	C	A	16	12	28	0	2	30	0	0
8	19511673	.	C	G	8	11	19	0	3	22	0	0
8	19511674	.	C	A	10	12	22	0	0	22	0	0
8	19511770	.	A	C	13	13	26	0	0	26	0	0
8	19511901	.	G	A	16	18	34	0	2	36	0	0
8	19511902	.	T	A	17	16	33	0	3	36	0	0
8	20194801	.	T	C	5	0	5	0	4	9	0	0
8	20440330	.	C	A	3	3	6	0	2	8	0	0
8	20440699	.	G	A	2	2	4	0	0	4	0	0
8	20443562	.	C	T	0	2	2	0	0	2	0	0
8	20448181	.	G	A	7	2	9	0	1	10	0	0
8	20448687	.	T	C	1	0	1	0	0	1	0	0
8	20449016	.	G	A	1	9	10	0	8	18	0	0
8	20449478	.	G	A	0	12	12	0	11	23	0	0
8	20449590	.	G	A	9	10	19	0	0	19	0	0
8	20449614	.	A	G	8	10	18	0	0	18	0	0
8	20449847	.	A	G	8	8	16	0	0	16	0	0
8	20449851	.	T	A	8	9	17	0	0	17	0	0
8	20450168	.	C	T	14	16	30	0	2	32	0	0
8	20450249	.	T	A	10	11	21	0	2	23	0	0
8	20450289	.	G	A	8	7	15	0	2	17	0	0
8	20460509	.	A	G	1	0	1	0	2	3	0	0
8	20467283	.	C	T	1	0	1	0	0	1	0	0
8	20471248	.	C	T	8	4	12	0	2	14	0	0
8	20471387	.	G	A	3	7	10	0	0	10	0	0
8	20471391	.	C	T	3	6	9	0	1	10	0	0
8	20471508	.	T	A	1	5	6	0	0	6	0	0
8	20503515	.	C	T	4	5	9	0	0	9	0	0
8	20503697	.	A	G	4	5	9	0	0	9	0	0
8	20546122	.	T	C	8	7	15	0	1	16	0	0
8	20546182	.	T	C	10	6	16	0	1	17	0	0
8	20559103	.	T	C	7	13	20	0	2	22	0	0
8	20559169	.	A	G	10	0	10	0	21	31	0	0
8	20559202	.	A	G	17	0	17	0	20	37	0	0
8	20559211	.	T	A	18	21	39	0	2	41	0	0
8	20559241	.	G	A	17	14	31	0	5	36	0	0
8	20559270	.	A	G	16	20	36	0	3	39	0	0
8	20559373	.	G	A	11	13	24	0	1	25	0	0
8	20559682	.	G	A	23	23	46	0	1	47	0	0
8	20559683	.	A	G	22	23	45	0	2	47	0	0
8	20580314	.	T	C	2	2	4	0	0	4	0	0
8	20580334	.	G	A	0	3	3	0	1	4	0	0
8	20846257	.	T	A	1	3	4	0	0	4	0	0
8	20846303	.	G	T	7	3	10	0	0	10	0	0
8	20848614	.	C	T	1	0	1	0	0	1	0	0
8	20850246	.	T	A	0	3	3	0	0	3	0	0
8	20850254	.	T	A	4	2	6	0	0	7	1	0
8	20850311	.	T	A	2	3	5	0	0	5	0	0
8	20853335	.	A	T	9	14	23	0	1	24	0	0
8	20853987	.	C	G	0	2	2	0	1	3	0	0
8	20856643	.	G	A	1	1	2	0	0	2	0	0
8	20865557	.	A	T	3	5	8	0	1	9	0	0
8	20868167	.	T	A	10	4	14	0	0	14	0	0
8	20868191	.	G	A	1	4	5	0	2	7	0	0
8	20868209	.	G	A	0	4	4	0	0	4	0	0
8	20870439	.	A	T	2	4	6	0	0	6	0	0
8	20872987	.	G	T	1	3	4	0	0	4	0	0
8	20873011	.	G	A	0	3	3	0	14	17	0	0
8	20873113	.	C	T	11	16	27	0	0	27	0	0
8	20873183	.	C	T	5	3	8	0	0	8	0	0
8	20876466	.	C	T	11	8	19	0	6	25	0	0
8	21047673	.	G	T	5	3	8	0	0	8	0	0
8	21047698	.	C	G	6	8	14	0	0	14	0	0
8	21047824	.	C	A	6	10	16	0	1	17	0	0
8	21050616	.	T	A	1	0	1	0	0	1	0	0
8	21052270	.	T	C	2	3	5	0	1	6	0	0
8	21052672	.	G	A	1	2	3	0	0	3	0	0
8	21052694	.	A	G	1	5	6	0	0	6	0	0
8	21053030	.	G	A	7	9	16	0	0	16	0	0
8	21053084	.	A	T	8	9	17	0	0	17	0	0
8	21053122	.	G	A	9	7	16	0	1	17	0	0
8	21053345	.	T	C	6	0	6	0	5	11	0	0
8	21053371	.	G	A	6	4	10	0	0	10	0	0
8	21053404	.	T	C	2	5	7	0	1	8	0	0
8	21053744	.	G	A	2	1	3	0	0	3	0	0
8	21053754	.	A	G	2	1	3	0	0	3	0	0
8	21068401	.	G	A	0	1	1	0	0	1	0	0
8	21068849	.	C	T	1	1	2	0	0	2	0	0
8	21068865	.	C	T	0	1	1	0	1	2	0	0
8	21071724	.	C	T	0	4	4	0	0	4	0	0
8	21095288	.	G	A	11	5	16	0	0	16	0	0
8	21095439	.	G	C	11	7	18	0	1	19	0	0
8	21095504	.	A	C	9	14	23	0	0	24	1	0
8	21095506	.	G	A	13	10	23	0	1	24	0	0
8	21100278	.	T	A	1	2	3	0	0	3	0	0
8	21100290	.	G	A	2	3	5	0	0	5	0	0
8	21104767	.	A	G	2	4	6	0	1	7	0	0
8	21104837	.	G	A	3	9	12	0	0	12	0	0
8	21105045	.	G	A	3	7	10	0	1	11	0	0
8	21105504	.	G	A	11	6	17	0	0	17	0	0
8	21110074	.	A	G	5	4	9	0	0	9	0	0
8	21114444	.	C	T	8	1	9	0	0	9	0	0
8	21123607	.	T	C	3	5	8	0	0	8	0	0
8	21130028	.	A	G	4	6	10	0	0	10	0	0
8	21130158	.	G	A	7	7	14	0	1	15	0	0
8	21130292	.	G	A	1	2	3	0	1	4	0	0
8	21130441	.	T	A	2	2	4	0	2	6	0	0
8	21130746	.	T	C	4	5	9	0	0	9	0	0
8	21131089	.	A	T	7	2	9	0	1	10	0	0
8	21131310	.	C	T	4	5	9	0	0	9	0	0
8	21131373	.	C	A	7	4	11	0	0	11	0	0
8	21131432	.	G	A	10	3	13	0	0	13	0	0
8	21131532	.	T	C	6	4	10	0	1	11	0	0
8	21131926	.	A	G	11	4	15	0	1	16	0	0
8	21132190	.	A	G	4	4	8	0	1	9	0	0
8	21132445	.	A	C	16	8	24	0	0	24	0	0
8	21132599	.	G	A	0	16	16	0	9	25	0	0
8	21132648	.	T	C	10	6	16	0	1	17	0	0
8	21132947	.	G	T	0	11	11	0	10	21	0	0
8	21132979	.	T	A	3	7	10	0	1	11	0	0
8	21133043	.	C	T	6	4	10	0	0	10	0	0
8	21133060	.	G	A	7	2	9	0	0	9	0	0
8	21134536	.	T	C	2	6	8	0	0	8	0	0
8	21137675	.	G	A	4	2	6	0	0	6	0	0
8	21139989	.	G	A	1	6	7	0	1	8	0	0
8	21140286	.	C	T	1	5	6	0	3	9	0	0
8	21140369	.	A	G	4	2	6	0	0	6	0	0
8	21140433	.	G	A	6	3	9	0	1	10	0	0
8	21140589	.	A	C	4	2	6	0	0	6	0	0
8	21140607	.	C	A	3	2	5	0	0	5	0	0
8	21141088	.	G	A	2	2	4	0	0	4	0	0
8	21141329	.	G	C	4	0	4	0	1	5	0	0
8	21141330	.	A	G	4	1	5	0	0	5	0	0
8	21146292	.	C	A	2	2	4	0	0	4	0	0
8	21146302	.	G	T	2	2	4	0	0	4	0	0
8	21146840	.	T	G	1	2	3	0	0	3	0	0
8	21148814	.	G	A	2	4	6	0	0	6	0	0
8	21151760	.	C	T	1	0	1	0	0	1	0	0
8	21152728	.	C	G	1	1	2	0	0	2	0	0
8	21152737	.	C	A	1	1	2	0	0	2	0	0
8	21155864	.	A	G	0	1	1	0	0	1	0	0
8	21155871	.	T	C	0	4	4	0	0	4	0	0
8	21155937	.	T	G	4	10	14	0	2	16	0	0
8	21162056	.	C	T	8	3	11	0	2	13	0	0
8	21162161	.	C	T	11	5	16	0	0	16	0	0
8	21162209	.	T	C	12	9	21	0	0	21	0	0
8	21162278	.	G	A	0	6	6	0	7	13	0	0
8	21162284	.	A	G	8	0	8	0	9	17	0	0
8	21162318	.	T	C	5	11	16	0	0	16	0	0
8	21218995	.	C	T	4	3	7	0	0	7	0	0
8	21219216	.	C	T	5	6	11	0	0	11	0	0
8	21219218	.	C	T	5	6	11	0	0	11	0	0
8	21219274	.	T	A	5	5	10	0	3	13	0	0
8	21225163	.	G	A	0	14	14	0	11	25	0	0
8	21225172	.	A	G	13	8	21	0	2	23	0	0
8	21241111	.	T	G	7	0	7	0	10	17	0	0
8	21241122	.	T	C	8	6	14	0	0	14	0	0
8	21245803	.	C	T	6	6	12	0	0	12	0	0
8	21247280	.	G	A	5	6	11	0	1	12	0	0
8	21248852	.	C	A	4	7	11	0	0	11	0	0
8	21248879	.	G	A	1	3	4	0	0	4	0	0
8	21250132	.	T	A	22	15	37	0	1	38	0	0
8	21250183	.	T	A	12	10	22	0	0	22	0	0
8	21250694	.	A	G	16	1	17	0	19	36	0	0
8	21251179	.	T	C	24	24	48	0	0	48	0	0
8	21251456	.	T	G	22	12	34	0	0	34	0	0
8	21251516	.	A	G	19	20	39	0	5	44	0	0
8	21251569	.	G	C	23	24	47	0	2	49	0	0
8	21251732	.	C	T	17	17	34	0	0	34	0	0
8	21251775	.	T	C	17	16	33	0	1	34	0	0
8	21252042	.	G	T	6	12	18	0	2	20	0	0
8	21252125	.	A	T	18	27	45	0	2	47	0	0
8	21252155	.	T	C	20	24	44	0	1	45	0	0
8	21252163	.	A	G	15	24	39	0	7	46	0	0
8	21252215	.	A	T	25	23	48	0	2	50	0	0
8	21252237	.	T	C	26	26	52	0	1	53	0	0
8	21252472	.	C	G	19	27	46	0	0	46	0	0
8	21252632	.	T	A	1	2	3	0	1	4	0	0
8	21368737	.	T	C	5	6	11	0	0	11	0	0
8	21368892	.	G	A	8	4	12	0	0	12	0	0
8	21588443	.	G	T	0	6	6	0	2	8	0	0
8	21629342	.	G	C	1	3	4	0	2	6	0	0
8	21664464	.	C	T	4	4	8	0	0	8	0	0
8	21672076	.	G	A	4	2	6	0	0	6	0	0
8	21672605	.	A	G	3	5	8	0	0	8	0	0
8	21673091	.	T	C	13	4	17	0	0	17	0	0
8	21673248	.	A	T	10	8	18	0	2	20	0	0
8	21673516	.	G	A	0	14	14	0	7	21	0	0
8	21673666	.	G	A	14	5	19	0	0	19	0	0
8	21673765	.	C	T	9	5	14	0	0	14	0	0
8	21673789	.	T	G	4	0	4	0	10	14	0	0
8	21673813	.	C	T	10	5	15	0	1	16	0	0
8	21673880	.	A	C	6	5	11	0	0	11	0	0
8	21673886	.	A	G	6	0	6	0	5	11	0	0
8	21674080	.	G	T	5	3	8	0	0	8	0	0
8	21674359	.	A	T	2	5	7	0	0	7	0	0
8	21674449	.	T	A	5	3	8	0	1	9	0	0
8	21674795	.	A	C	5	4	9	0	2	11	0	0
8	21674815	.	A	T	4	6	10	0	2	12	0	0
8	21675004	.	G	A	10	4	14	0	1	15	0	0
8	21675008	.	A	G	10	4	14	0	2	16	0	0
8	21675043	.	G	C	3	12	15	0	1	16	0	0
8	21675057	.	T	A	3	12	15	0	1	16	0	0
8	21675200	.	A	G	7	6	13	0	0	13	0	0
8	21675551	.	A	G	6	11	17	0	2	19	0	0
8	21675575	.	T	C	9	9	18	0	0	18	0	0
8	21675608	.	G	C	7	9	16	0	0	16	0	0
8	21675695	.	G	T	0	11	11	0	6	17	0	0
8	21675698	.	G	A	0	9	9	0	8	17	0	0
8	21675745	.	G	A	4	11	15	0	1	16	0	0
8	21675755	.	A	G	9	5	14	0	1	15	0	0
8	21675787	.	T	A	2	7	9	0	1	10	0	0
8	21675882	.	A	G	2	3	5	0	1	6	0	0
8	21676136	.	A	G	3	3	6	0	0	6	0	0
8	21676137	.	A	G	3	3	6	0	0	6	0	0
8	21978470	.	T	C	3	2	5	0	0	5	0	0
8	21978471	.	T	C	2	3	5	0	0	5	0	0
8	21982767	.	C	T	4	1	5	0	0	5	0	0
8	21982860	.	T	A	1	2	3	0	0	3	0	0
8	21986654	.	G	A	2	2	4	0	0	4	0	0
8	22011057	.	A	G	4	1	5	0	0	5	0	0
8	22282096	.	T	A	0	1	1	0	0	1	0	0
8	22282637	.	T	C	1	0	1	0	0	1	0	0
8	22283782	.	G	A	1	6	7	0	1	8	0	0
8	22283960	.	C	T	0	2	2	0	2	4	0	0
8	22284192	.	G	T	8	6	14	0	0	14	0	0
8	22284206	.	G	T	9	6	15	0	0	15	0	0
8	22284262	.	C	T	6	6	12	0	1	13	0	0
8	22284266	.	C	T	6	4	10	0	1	11	0	0
8	22284306	.	C	T	5	3	8	0	0	8	0	0
8	22284316	.	C	T	3	5	8	0	0	8	0	0
8	22284379	.	T	G	6	5	11	0	0	11	0	0
8	22284425	.	G	A	8	4	12	0	0	12	0	0
8	22284509	.	T	C	5	11	16	0	0	16	0	0
8	22284570	.	T	G	8	8	16	0	3	19	0	0
8	22287163	.	A	G	4	6	10	0	0	10	0	0
8	22290025	.	A	G	4	2	6	0	0	6	0	0
8	22290358	.	G	A	3	2	5	0	1	6	0	0
8	22298241	.	A	C	4	0	4	0	0	4	0	0
8	22298242	.	G	T	4	0	4	0	0	4	0	0
8	22301156	.	T	C	2	3	5	0	0	5	0	0
8	22303820	.	G	A	4	3	7	0	0	7	0	0
8	22319303	.	A	G	2	1	3	0	0	3	0	0
8	22320748	.	A	G	0	1	1	0	0	1	0	0
8	22327353	.	G	A	3	2	5	0	0	5	0	0
8	22329411	.	C	A	7	5	12	0	0	12	0	0
8	22329434	.	A	G	6	3	9	0	0	9	0	0
8	22329678	.	T	C	1	1	2	0	0	2	0	0
8	22335414	.	A	G	0	1	1	0	0	1	0	0
8	22335420	.	T	C	0	1	1	0	0	1	0	0
8	22337301	.	T	C	2	2	4	0	0	4	0	0
8	22337337	.	G	A	0	4	4	0	6	10	0	0
8	22337436	.	T	C	5	5	10	0	0	10	0	0
8	22345458	.	T	A	3	3	6	0	0	6	0	0
8	22346502	.	C	T	3	1	4	0	0	4	0	0
8	22394324	.	C	A	14	9	23	0	0	23	0	0
8	22394626	.	T	C	10	9	19	0	0	19	0	0
8	22472601	.	A	C	2	3	5	0	0	5	0	0
8	22472607	.	A	G	2	3	5	0	0	5	0	0
8	22488886	.	A	T	0	1	1	0	0	1	0	0
8	22500293	.	C	T	5	10	15	0	0	15	0	0
8	22500307	.	A	C	11	1	12	0	5	17	0	0
8	22500406	.	A	T	6	5	11	0	0	11	0	0
8	22500543	.	T	C	8	0	8	0	10	18	0	0
8	22500739	.	G	A	2	1	3	0	0	3	0	0
8	22502731	.	C	T	3	1	4	0	0	4	0	0
8	22503469	.	G	C	2	4	6	0	0	6	0	0
8	22503494	.	G	T	6	3	9	0	0	9	0	0
8	22503535	.	C	T	3	4	7	0	0	7	0	0
8	22503539	.	A	G	3	4	7	0	0	7	0	0
8	22503596	.	G	A	3	5	8	0	0	8	0	0
8	22503748	.	C	T	7	3	10	0	1	11	0	0
8	22503782	.	C	T	0	5	5	0	2	7	0	0
8	22504424	.	T	A	3	7	10	0	1	11	0	0
8	22504463	.	T	A	4	6	10	0	0	10	0	0
8	22504604	.	G	A	5	2	7	0	2	9	0	0
8	22504619	.	T	C	5	2	7	0	0	7	0	0
8	22511123	.	A	G	3	3	6	0	0	6	0	0
8	22511252	.	A	T	1	5	6	0	0	6	0	0
8	22511387	.	G	A	3	5	8	0	1	9	0	0
8	22511518	.	C	T	0	3	3	0	7	10	0	0
8	22511551	.	C	A	4	5	9	0	1	10	0	0
8	22511654	.	C	T	0	3	3	0	5	8	0	0
8	22511936	.	G	A	3	4	7	0	0	7	0	0
8	22512881	.	G	A	1	1	2	0	1	3	0	0
8	22522035	.	G	A	23	23	46	0	6	52	0	0
8	22522385	.	T	C	3	0	3	0	9	12	0	0
8	22522688	.	G	A	15	7	22	0	4	26	0	0
8	22522699	.	C	G	1	8	9	0	19	30	2	0
8	22522744	.	A	G	14	18	32	0	2	34	0	0
8	22522913	.	T	A	19	16	35	0	2	37	0	0
8	22523010	.	A	T	11	18	29	0	2	31	0	0
8	22524820	.	C	T	7	12	19	0	2	21	0	0
8	22525228	.	G	A	11	7	18	0	0	18	0	0
8	22525336	.	G	A	10	8	18	0	0	18	0	0
8	22525773	.	C	T	1	14	15	0	7	22	0	0
8	22525978	.	C	T	12	10	22	0	1	23	0	0
8	22526355	.	T	G	5	3	8	0	0	8	0	0
8	22530480	.	G	A	4	5	9	0	0	9	0	0
8	22530633	.	A	G	1	4	5	0	0	5	0	0
8	22531978	.	G	A	3	1	4	0	0	4	0	0
8	22533535	.	C	T	7	9	16	0	1	17	0	0
8	22536031	.	C	T	0	3	3	0	0	3	0	0
8	22544636	.	G	A	2	4	6	0	0	6	0	0
8	22544985	.	G	A	1	0	1	0	0	1	0	0
8	22603951	.	C	T	3	0	3	0	0	3	0	0
8	22604170	.	A	T	2	2	4	0	1	5	0	0
8	22607125	.	T	C	0	1	1	0	1	2	0	0
8	22608378	.	C	T	1	1	2	0	0	2	0	0
8	22611837	.	C	T	7	8	15	0	0	15	0	0
8	22612158	.	A	C	11	8	19	0	1	20	0	0
8	22612227	.	A	T	6	6	12	0	0	12	0	0
8	22612328	.	A	G	3	10	13	0	1	14	0	0
8	22612329	.	C	T	4	9	13	0	1	14	0	0
8	22612638	.	T	C	8	4	12	0	0	12	0	0
8	22612917	.	T	G	5	5	10	0	1	11	0	0
8	22612950	.	C	T	7	7	14	0	0	14	0	0
8	22613136	.	C	T	8	6	14	0	0	14	0	0
8	22613346	.	G	T	9	8	17	0	1	18	0	0
8	22613493	.	G	A	5	12	17	0	0	17	0	0
8	22613553	.	A	G	3	6	9	0	0	9	0	0
8	22618864	.	A	G	33	10	43	0	4	47	0	0
8	22619110	.	G	A	17	21	38	0	1	39	0	0
8	22619212	.	T	A	18	16	34	0	2	36	0	0
8	22619443	.	G	A	13	19	32	0	6	40	2	0
8	22622632	.	G	C	5	5	10	0	0	10	0	0
8	22622674	.	A	T	6	10	16	0	0	16	0	0
8	22622712	.	C	T	0	13	13	0	9	22	0	0
8	22622733	.	A	T	6	9	15	0	0	15	0	0
8	22624324	.	C	A	0	2	2	0	4	6	0	0
8	22627917	.	A	C	5	4	9	0	0	9	0	0
8	22630366	.	A	G	3	3	6	0	0	6	0	0
8	22631760	.	T	A	7	7	14	0	0	14	0	0
8	22631865	.	A	G	3	7	10	0	0	10	0	0
8	22631898	.	C	A	0	13	13	0	7	20	0	0
8	22632185	.	G	A	8	4	12	0	1	13	0	0
8	22632213	.	A	G	5	5	10	0	1	11	0	0
8	22632249	.	A	G	7	2	9	0	1	10	0	0
8	22632687	.	T	A	2	3	5	0	0	5	0	0
8	22637699	.	T	G	4	9	13	0	0	13	0	0
8	22762019	.	G	A	3	3	6	0	0	6	0	0
8	22762173	.	C	T	3	4	7	0	1	8	0	0
8	22762194	.	A	C	4	4	8	0	0	8	0	0
8	22762442	.	A	G	4	4	8	0	0	8	0	0
8	22787579	.	T	A	2	2	4	0	0	4	0	0
8	22788116	.	G	A	1	1	2	0	0	2	0	0
8	22788410	.	A	T	1	1	2	0	1	3	0	0
8	22788541	.	T	G	1	2	3	0	0	3	0	0
8	22788583	.	T	G	1	1	2	0	0	2	0	0
8	22788956	.	A	G	2	3	5	0	1	6	0	0
8	22789112	.	A	G	3	2	5	0	0	5	0	0
8	22916092	.	T	C	2	3	5	0	0	5	0	0
8	22922731	.	C	T	2	3	5	0	0	5	0	0
8	22922749	.	A	G	3	0	3	0	5	8	0	0
8	22922887	.	C	T	1	1	2	0	1	3	0	0
8	22926258	.	A	C	1	2	3	0	0	3	0	0
8	22926934	.	T	C	5	4	9	0	0	9	0	0
8	22945179	.	G	T	2	10	12	0	0	12	0	0
8	22945605	.	T	C	23	20	43	0	4	47	0	0
8	22946780	.	T	C	24	13	37	0	0	37	0	0
8	22946987	.	G	C	7	4	11	0	0	11	0	0
8	22951203	.	A	T	24	33	57	0	0	57	0	0
8	22951406	.	T	A	14	24	38	0	4	42	0	0
8	22951691	.	A	T	27	17	44	0	1	45	0	0
8	22951730	.	G	A	33	16	49	0	2	51	0	0
8	22951880	.	A	G	28	38	66	0	1	67	0	0
8	22951979	.	T	G	23	39	62	0	1	63	0	0
8	22952243	.	T	A	33	38	71	0	3	74	0	0
8	22977306	.	A	G	1	3	4	0	0	4	0	0
8	22985516	.	G	C	3	3	6	0	1	7	0	0
8	23040887	.	A	G	13	8	21	0	1	22	0	0
8	23040913	.	G	C	15	6	21	0	0	21	0	0
8	23044374	.	C	G	0	11	11	0	13	24	0	0
8	23044478	.	G	T	11	11	22	0	0	22	0	0
8	23044554	.	T	C	10	0	10	0	15	25	0	0
8	23044620	.	G	A	13	6	19	0	0	19	0	0
8	23044752	.	A	G	10	6	16	0	2	18	0	0
8	23056164	.	T	A	3	4	7	0	1	8	0	0
8	23081314	.	T	C	6	0	6	0	0	6	0	0
8	23105304	.	T	A	3	4	7	0	0	7	0	0
8	23105429	.	A	G	8	4	12	0	1	13	0	0
8	23109308	.	C	T	9	5	14	0	1	15	0	0
8	23109554	.	C	A	14	6	20	0	0	20	0	0
8	23109803	.	A	C	4	4	8	0	3	11	0	0
8	23109890	.	T	C	10	5	15	0	1	16	0	0
8	23110301	.	T	A	17	13	30	0	1	31	0	0
8	23110475	.	A	G	8	21	29	0	2	31	0	0
8	23118396	.	A	G	6	12	18	0	0	18	0	0
8	23118830	.	T	C	9	10	19	0	1	20	0	0
8	23119100	.	T	A	9	17	26	0	0	26	0	0
8	23119524	.	C	A	18	20	38	0	0	38	0	0
8	23122210	.	T	G	3	5	8	0	0	8	0	0
8	23122265	.	T	C	2	3	5	0	1	6	0	0
8	23122348	.	A	G	6	11	17	0	1	18	0	0
8	23143137	.	G	A	2	2	4	0	1	5	0	0
8	23143144	.	G	A	3	2	5	0	0	5	0	0
8	23147528	.	C	T	2	3	5	0	0	5	0	0
8	23147536	.	G	A	2	4	6	0	0	6	0	0
8	23149815	.	C	G	6	4	10	0	0	10	0	0
8	23149956	.	G	A	0	7	7	0	10	17	0	0
8	23151375	.	C	T	6	11	17	0	2	20	1	0
8	23151697	.	C	T	6	3	9	0	0	9	0	0
8	23165835	.	G	T	0	4	4	0	16	20	0	0
8	23175234	.	C	T	7	10	17	0	1	18	0	0
8	23179659	.	G	T	19	19	38	0	1	39	0	0
8	23179702	.	T	G	26	18	44	0	0	45	1	0
8	23194322	.	A	T	5	3	8	0	1	9	0	0
8	23202757	.	C	T	0	1	1	0	0	1	0	0
8	23206517	.	C	T	2	0	2	0	0	2	0	0
8	23206529	.	G	A	2	1	3	0	0	3	0	0
8	23210432	.	C	T	7	5	12	0	1	13	0	0
8	23210441	.	T	C	10	8	18	0	0	18	0	0
8	23210579	.	G	A	9	16	25	0	1	26	0	0
8	23210652	.	G	A	13	5	18	0	2	20	0	0
8	23210832	.	A	T	4	6	10	0	0	10	0	0
8	23210857	.	A	G	4	7	11	0	1	12	0	0
8	23210944	.	T	C	10	10	20	0	1	21	0	0
8	23211047	.	A	C	10	3	13	0	0	13	0	0
8	23211054	.	C	T	8	2	10	0	2	12	0	0
8	23211109	.	G	T	16	6	22	0	0	22	0	0
8	23211120	.	C	T	19	6	25	0	0	25	0	0
8	23211233	.	G	T	13	13	26	0	0	26	0	0
8	23211402	.	T	C	8	16	24	0	0	24	0	0
8	23211424	.	C	A	6	12	18	0	1	19	0	0
8	23211446	.	A	C	11	8	19	0	1	20	0	0
8	23215631	.	C	T	9	5	14	0	0	14	0	0
8	23215643	.	C	T	10	7	17	0	0	17	0	0
8	23215762	.	T	C	23	15	38	0	4	42	0	0
8	23253200	.	A	G	1	3	4	0	0	4	0	0
8	23253242	.	C	T	1	2	3	0	0	3	0	0
8	23256509	.	A	G	1	4	5	0	0	5	0	0
8	23256521	.	A	G	1	4	5	0	0	5	0	0
8	23286153	.	G	A	1	1	2	0	0	2	0	0
8	23380081	.	T	G	1	0	1	0	2	3	0	0
8	23380100	.	A	G	3	2	5	0	0	5	0	0
8	23380249	.	C	T	2	3	5	0	0	5	0	0
8	23380278	.	T	C	1	3	4	0	0	4	0	0
8	23380692	.	G	A	2	3	5	0	0	5	0	0
8	23380726	.	G	A	1	3	4	0	0	4	0	0
8	23382684	.	G	A	0	1	1	0	0	1	0	0
8	23384003	.	G	A	3	6	9	0	0	9	0	0
8	23389736	.	G	A	1	5	6	0	0	6	0	0
8	23390113	.	T	C	2	5	7	0	0	7	0	0
8	23390197	.	T	A	1	3	4	0	0	4	0	0
8	23415651	.	C	T	5	6	11	0	0	11	0	0
8	23415693	.	G	A	11	7	18	0	1	19	0	0
8	23553749	.	A	T	3	4	7	0	0	7	0	0
8	23567670	.	T	C	2	5	7	0	2	9	0	0
8	23580927	.	C	T	1	2	3	0	0	3	0	0
8	23615202	.	T	A	4	1	5	0	0	5	0	0
8	23615206	.	A	T	4	2	6	0	0	6	0	0
8	23615446	.	G	A	3	2	5	0	0	5	0	0
8	23617372	.	C	T	3	2	5	0	0	5	0	0
8	23620494	.	G	A	2	3	5	0	0	5	0	0
8	23625823	.	T	G	1	4	5	0	0	5	0	0
8	23627371	.	T	C	5	3	8	0	0	8	0	0
8	23627494	.	T	C	1	1	2	0	0	2	0	0
8	23636779	.	A	C	8	6	14	0	0	14	0	0
8	23636901	.	C	A	7	5	12	0	0	12	0	0
8	23636973	.	T	G	4	6	10	0	0	10	0	0
8	23637232	.	A	G	6	3	9	0	1	10	0	0
8	23637245	.	G	T	6	3	9	0	0	9	0	0
8	23637621	.	G	A	1	2	3	0	0	3	0	0
8	23639214	.	T	G	2	5	7	0	0	7	0	0
8	23639301	.	T	C	1	5	6	0	1	7	0	0
8	23639412	.	A	G	3	1	4	0	0	4	0	0
8	23639472	.	T	C	0	2	2	0	0	2	0	0
8	23640048	.	A	G	3	0	3	0	8	11	0	0
8	23647323	.	G	C	1	2	3	0	0	3	0	0
8	23648753	.	T	C	3	1	4	0	0	4	0	0
8	23656058	.	G	A	5	4	9	0	0	9	0	0
8	23656151	.	C	T	10	9	19	0	2	21	0	0
8	23667739	.	C	T	2	3	5	0	0	5	0	0
8	23667810	.	T	C	2	2	4	0	0	4	0	0
8	23667902	.	C	A	4	5	9	0	0	9	0	0
8	23667909	.	G	T	5	4	9	0	1	10	0	0
8	23668371	.	A	T	4	3	7	0	0	7	0	0
8	23668623	.	G	A	7	8	15	0	0	15	0	0
8	23669276	.	C	T	7	9	16	0	1	17	0	0
8	23669307	.	T	C	7	8	15	0	0	15	0	0
8	23669423	.	T	C	4	3	7	0	1	8	0	0
8	23669451	.	A	G	7	2	9	0	1	10	0	0
8	23669642	.	C	T	11	7	18	0	2	20	0	0
8	23669736	.	A	T	9	8	17	0	1	18	0	0
8	23669802	.	C	A	10	13	23	0	0	23	0	0
8	23669821	.	G	A	0	9	9	0	10	19	0	0
8	23669933	.	C	A	10	4	14	0	1	15	0	0
8	23669968	.	C	T	5	6	11	0	1	12	0	0
8	23669983	.	T	C	5	7	12	0	0	12	0	0
8	23670115	.	T	C	2	3	5	0	0	5	0	0
8	23670202	.	A	G	5	8	13	0	1	14	0	0
8	23672505	.	C	T	2	6	8	0	0	8	0	0
8	23672672	.	C	T	0	0	0	0	3	3	0	0
8	23672740	.	G	C	2	5	7	0	0	7	0	0
8	23672802	.	A	G	2	6	8	0	1	9	0	0
8	23672812	.	G	A	2	6	8	0	1	9	0	0
8	23672888	.	T	A	5	7	12	0	1	13	0	0
8	23673051	.	A	G	5	3	8	0	0	8	0	0
8	23673096	.	T	C	1	5	6	0	0	6	0	0
8	23673133	.	G	T	2	5	7	0	0	7	0	0
8	23673505	.	C	T	1	3	4	0	0	4	0	0
8	23703739	.	C	T	0	6	6	0	1	7	0	0
8	23703754	.	C	T	0	6	6	0	0	6	0	0
8	23703775	.	T	A	0	3	3	0	3	6	0	0
8	23711887	.	C	T	1	2	3	0	0	3	0	0
8	23716979	.	G	T	3	4	7	0	0	7	0	0
8	23720518	.	A	G	1	0	1	0	0	1	0	0
8	23723497	.	C	A	1	3	4	0	0	4	0	0
8	23723503	.	G	A	1	2	3	0	1	4	0	0
8	23723621	.	C	T	5	5	10	0	0	10	0	0
8	23723723	.	G	A	0	4	4	0	4	8	0	0
8	23724045	.	A	C	8	11	19	0	1	20	0	0
8	23724620	.	G	A	0	9	9	0	4	13	0	0
8	23733414	.	G	A	3	4	7	0	0	7	0	0
8	23733495	.	G	C	1	2	3	0	0	3	0	0
8	23733545	.	A	G	1	5	6	0	0	6	0	0
8	23733548	.	G	A	1	4	5	0	1	6	0	0
8	23734414	.	G	A	1	0	1	0	0	1	0	0
8	23735725	.	G	A	0	1	1	0	0	1	0	0
8	23736063	.	G	A	0	2	2	0	4	6	0	0
8	23740519	.	G	A	5	8	13	0	0	13	0	0
8	23753566	.	T	A	8	4	12	0	0	12	0	0
8	23753793	.	C	T	0	5	5	0	4	9	0	0
8	23753834	.	C	G	0	6	6	0	2	8	0	0
8	23756089	.	A	T	0	3	3	0	0	3	0	0
8	23756221	.	T	A	9	4	13	0	2	15	0	0
8	23756536	.	C	G	0	7	7	0	12	19	0	0
8	23756749	.	G	C	2	3	5	0	1	6	0	0
8	23760288	.	C	T	0	4	4	0	8	12	0	0
8	23763809	.	T	C	3	3	6	0	0	6	0	0
8	23765199	.	T	C	1	1	2	0	0	2	0	0
8	23781056	.	A	T	0	2	2	0	0	2	0	0
8	23857845	.	T	C	4	3	7	0	0	7	0	0
8	23857997	.	G	A	0	1	1	0	0	1	0	0
8	23860200	.	G	A	5	4	9	0	0	9	0	0
8	23860391	.	T	G	6	3	9	0	0	9	0	0
8	23865837	.	A	G	2	3	5	0	0	5	0	0
8	23867417	.	A	G	0	1	1	0	0	1	0	0
8	23869978	.	C	T	9	5	14	0	0	14	0	0
8	23878905	.	T	A	1	8	9	0	0	9	0	0
8	23879044	.	T	A	13	6	19	0	0	19	0	0
8	23879238	.	T	A	9	15	24	0	2	26	0	0
8	23879365	.	G	A	9	12	21	0	0	21	0	0
8	24108887	.	A	G	4	3	7	0	0	7	0	0
8	24108899	.	T	C	3	5	8	0	0	8	0	0
8	24109317	.	T	A	6	5	11	0	0	11	0	0
8	24109860	.	G	A	5	5	10	0	0	10	0	0
8	24110817	.	A	G	2	3	5	0	1	6	0	0
8	24111073	.	A	G	5	5	10	0	1	11	0	0
8	24111082	.	T	C	4	6	10	0	1	11	0	0
8	24113044	.	C	A	3	6	9	0	1	10	0	0
8	24113519	.	G	C	4	4	8	0	1	9	0	0
8	24120176	.	T	A	5	9	14	0	1	15	0	0
8	24120187	.	A	T	4	10	14	0	0	14	0	0
8	24122960	.	C	A	0	3	3	0	2	5	0	0
8	24123072	.	C	T	5	5	10	0	0	10	0	0
8	24135019	.	C	T	2	2	4	0	0	4	0	0
8	24135022	.	G	A	2	2	4	0	0	4	0	0
8	24295699	.	G	A	0	2	2	0	1	3	0	0
8	24308772	.	G	A	2	3	5	0	0	5	0	0
8	24308778	.	G	A	2	1	3	0	0	3	0	0
8	24315553	.	T	C	0	1	1	0	0	1	0	0
8	24323336	.	T	C	3	2	5	0	0	5	0	0
8	24740168	.	C	A	7	7	14	0	2	16	0	0
8	24741031	.	A	T	6	2	8	0	1	9	0	0
8	24743676	.	A	T	7	8	15	0	0	15	0	0
8	24743874	.	G	A	0	4	4	0	6	10	0	0
8	24788514	.	C	T	11	7	18	0	1	19	0	0
8	24789174	.	C	T	9	5	14	0	0	14	0	0
8	24790139	.	A	G	3	5	8	0	0	8	0	0
8	24790194	.	A	G	6	4	10	0	0	10	0	0
8	24861530	.	T	C	0	1	1	0	0	1	0	0
8	24870404	.	T	C	0	1	1	0	2	3	0	0
8	24875117	.	C	G	2	0	2	0	4	6	0	0
8	24881058	.	T	C	0	1	1	0	0	1	0	0
8	24883433	.	G	A	0	1	1	0	1	2	0	0
8	24883577	.	C	T	3	4	7	0	0	7	0	0
8	24886194	.	T	C	4	2	6	0	0	6	0	0
8	24886251	.	A	G	4	6	10	0	0	10	0	0
8	24886626	.	T	G	3	10	13	0	0	13	0	0
8	24889403	.	C	T	12	26	38	0	1	39	0	0
8	24889482	.	A	T	12	20	32	0	1	33	0	0
8	24889586	.	C	T	10	13	23	0	0	23	0	0
8	24889629	.	A	G	14	18	32	0	0	32	0	0
8	24889638	.	T	A	14	21	35	0	0	35	0	0
8	24889796	.	G	A	10	22	32	0	1	33	0	0
8	24890084	.	T	A	7	19	26	0	1	27	0	0
8	24890238	.	T	A	14	10	24	0	1	25	0	0
8	24890798	.	C	T	3	10	13	0	0	13	0	0
8	24890913	.	T	G	5	18	23	0	1	24	0	0
8	24940083	.	A	G	1	3	4	0	0	4	0	0
8	24964775	.	G	A	2	4	6	0	0	6	0	0
8	24968560	.	A	C	2	2	4	0	0	4	0	0
8	24972006	.	T	C	17	21	38	0	2	40	0	0
8	24972137	.	G	T	12	21	33	0	9	42	0	0
8	24972413	.	A	C	9	5	14	0	0	14	0	0
8	24972594	.	T	C	15	21	36	0	2	38	0	0
8	24972595	.	T	A	15	21	36	0	2	38	0	0
8	24972746	.	T	A	12	18	30	0	1	31	0	0
8	24973088	.	G	C	15	6	21	1	0	22	0	0
8	24973239	.	T	A	10	16	26	0	0	26	0	0
8	24973276	.	A	G	8	11	19	0	2	21	0	0
8	24973462	.	A	G	5	8	13	0	0	13	0	0
8	24985735	.	T	C	2	6	8	0	0	8	0	0
8	24985741	.	G	C	2	6	8	0	0	8	0	0
8	24986965	.	G	A	1	4	5	0	0	5	0	0
8	24991082	.	G	T	1	3	4	0	0	4	0	0
8	24991127	.	G	A	1	6	7	0	0	7	0	0
8	24991169	.	G	A	0	2	2	0	0	2	0	0
8	25010904	.	C	A	1	8	9	0	7	16	0	0
8	25022506	.	C	T	0	6	6	0	1	7	0	0
8	25022808	.	C	T	2	4	6	0	0	6	0	0
8	25036582	.	T	G	1	2	3	0	0	3	0	0
8	25036596	.	T	A	1	1	2	0	1	3	0	0
8	25036694	.	C	G	3	4	7	0	0	7	0	0
8	25039704	.	T	C	5	5	10	0	0	10	0	0
8	25039967	.	C	A	7	3	10	0	0	10	0	0
8	25040479	.	T	C	4	5	9	0	0	9	0	0
8	25040499	.	T	G	2	3	5	0	0	5	0	0
8	25042269	.	T	C	7	12	19	0	0	19	0	0
8	25042275	.	T	C	7	10	17	0	1	18	0	0
8	25042328	.	A	G	9	13	22	0	1	23	0	0
8	25042352	.	G	A	7	11	18	0	1	19	0	0
8	25042474	.	T	C	13	1	14	0	13	27	0	0
8	25042578	.	A	G	16	11	27	0	0	27	0	0
8	25042933	.	T	C	12	7	19	0	0	19	0	0
8	25043125	.	A	G	7	15	22	0	0	22	0	0
8	25043167	.	A	T	11	15	26	0	0	26	0	0
8	25045766	.	T	C	4	2	6	0	0	6	0	0
8	25055972	.	G	T	4	2	6	0	0	6	0	0
8	25056207	.	A	G	4	4	8	0	0	8	0	0
8	25065762	.	A	G	0	1	1	0	0	1	0	0
8	25066100	.	C	T	1	1	2	0	0	2	0	0
8	25094117	.	A	G	2	0	2	0	3	5	0	0
8	25097431	.	G	A	3	3	6	0	0	6	0	0
8	25101351	.	A	G	2	0	2	0	5	7	0	0
8	25103407	.	C	T	7	12	19	0	0	19	0	0
8	25103581	.	C	T	4	8	12	0	1	13	0	0
8	25103719	.	T	C	7	6	13	0	0	13	0	0
8	25103731	.	T	C	9	5	14	0	0	14	0	0
8	25103801	.	A	G	9	1	10	0	4	14	0	0
8	25117654	.	T	C	5	13	18	0	0	18	0	0
8	25117759	.	A	G	5	4	9	0	0	9	0	0
8	25118164	.	C	A	7	8	15	0	0	15	0	0
8	25118587	.	A	G	2	2	4	0	0	4	0	0
8	25176197	.	C	T	1	3	4	0	0	4	0	0
8	25176250	.	T	C	5	10	15	0	1	16	0	0
8	25176257	.	T	C	7	9	16	0	0	16	0	0
8	25176303	.	A	G	9	10	19	0	0	19	0	0
8	25176677	.	T	C	4	6	10	0	1	11	0	0
8	25176957	.	C	G	3	9	12	0	0	12	0	0
8	25177285	.	A	G	3	7	10	0	0	10	0	0
8	25217721	.	C	T	1	2	3	0	0	3	0	0
8	25225807	.	C	T	2	2	4	0	0	4	0	0
8	25225808	.	A	G	2	2	4	0	0	4	0	0
8	25225853	.	T	G	2	2	4	0	0	4	0	0
8	25267833	.	T	C	0	1	1	0	0	1	0	0
8	25272507	.	C	T	6	7	13	0	0	13	0	0
8	25280530	.	T	C	4	3	7	0	1	8	0	0
8	25280849	.	C	T	4	7	11	0	0	11	0	0
8	25281877	.	A	G	1	0	1	0	2	3	0	0
8	25283346	.	T	G	7	1	8	0	8	16	0	0
8	25283768	.	A	G	4	2	6	0	0	6	0	0
8	25283771	.	T	C	4	3	7	0	0	7	0	0
8	25289156	.	A	G	0	0	0	0	2	2	0	0
8	25289180	.	C	T	5	8	13	0	1	14	0	0
8	25291478	.	A	T	7	8	15	0	0	15	0	0
8	25291573	.	C	A	6	7	13	0	1	14	0	0
8	25291651	.	A	G	4	10	14	0	0	14	0	0
8	25291662	.	A	G	10	7	17	0	0	17	0	0
8	25291742	.	A	C	17	11	28	0	2	30	0	0
8	25291912	.	A	T	22	13	35	0	1	36	0	0
8	25292188	.	C	T	4	11	15	0	2	17	0	0
8	25292370	.	A	G	15	16	31	0	0	31	0	0
8	25292407	.	G	T	16	14	30	0	2	32	0	0
8	25292482	.	T	C	16	16	32	0	2	34	0	0
8	25292492	.	A	T	15	17	32	0	0	32	0	0
8	25292608	.	T	C	23	14	37	0	0	37	0	0
8	25292865	.	G	C	12	19	31	0	0	31	0	0
8	25293008	.	A	G	23	13	36	0	3	39	0	0
8	25293064	.	C	T	18	13	31	0	1	32	0	0
8	25293111	.	G	T	19	13	32	0	2	34	0	0
8	25293184	.	C	T	13	27	40	0	1	41	0	0
8	25293225	.	T	A	14	14	28	0	1	29	0	0
8	25293275	.	A	G	15	0	15	0	21	36	0	0
8	25293346	.	C	T	9	23	32	0	3	35	0	0
8	25293445	.	T	C	4	4	8	0	1	9	0	0
8	25295219	.	A	T	6	2	8	0	0	8	0	0
8	25297326	.	A	G	6	0	6	0	21	27	0	0
8	25297371	.	T	C	2	4	6	0	1	7	0	0
8	25297523	.	A	G	11	2	13	0	24	37	0	0
8	25297617	.	G	C	15	18	33	0	0	33	0	0
8	25297741	.	C	T	13	25	38	0	0	38	0	0
8	25297842	.	T	A	14	13	27	0	1	29	1	0
8	25297864	.	A	G	5	14	19	0	1	20	0	0
8	25299819	.	A	G	1	0	1	0	0	1	0	0
8	25300511	.	C	T	1	1	2	0	0	2	0	0
8	25300749	.	T	C	5	3	8	0	0	8	0	0
8	25301185	.	T	C	7	11	18	0	0	18	0	0
8	25301280	.	A	G	9	16	25	0	2	27	0	0
8	25301350	.	A	G	5	8	13	0	2	15	0	0
8	25301389	.	G	A	1	7	8	0	7	15	0	0
8	25301450	.	T	C	7	9	16	0	2	18	0	0
8	25301512	.	G	T	8	8	16	0	0	16	0	0
8	25301524	.	A	G	9	9	18	0	0	18	0	0
8	25301547	.	G	A	9	7	16	0	0	16	0	0
8	25301583	.	C	A	9	9	18	0	0	18	0	0
8	25301590	.	A	C	8	8	16	0	1	17	0	0
8	25329583	.	A	T	0	4	4	0	0	4	0	0
8	25329606	.	T	A	1	4	5	0	0	5	0	0
8	25329981	.	A	T	9	4	13	0	1	14	0	0
8	25330065	.	T	A	8	17	25	0	1	26	0	0
8	25330181	.	C	T	8	12	20	0	0	20	0	0
8	25330293	.	C	T	14	5	19	0	1	20	0	0
8	25330295	.	T	A	13	6	19	0	1	20	0	0
8	25330334	.	T	A	15	8	23	0	1	24	0	0
8	25330367	.	A	C	12	10	22	0	1	23	0	0
8	25330390	.	A	G	16	9	25	0	0	25	0	0
8	25330498	.	G	A	29	20	49	0	3	53	1	0
8	25332708	.	C	T	8	13	21	0	2	23	0	0
8	25332900	.	A	G	4	6	10	0	0	10	0	0
8	25332945	.	G	A	22	23	45	0	2	47	0	0
8	25335063	.	G	A	21	22	43	0	1	44	0	0
8	25336097	.	T	A	16	12	28	0	1	29	0	0
8	25336102	.	T	G	15	15	30	0	1	31	0	0
8	25367091	.	C	T	4	4	8	0	1	9	0	0
8	25368374	.	A	G	2	3	5	0	2	7	0	0
8	25368421	.	A	G	1	6	7	0	1	8	0	0
8	25370776	.	T	C	2	1	3	0	0	3	0	0
8	25424272	.	C	T	9	5	14	0	1	15	0	0
8	25424375	.	C	A	11	11	22	0	0	22	0	0
8	25424411	.	T	A	8	7	15	0	1	16	0	0
8	25424558	.	A	G	7	5	12	0	0	12	0	0
8	25424658	.	G	A	6	4	10	0	0	10	0	0
8	25424721	.	A	G	5	4	9	0	0	9	0	0
8	25424734	.	T	A	6	3	9	0	0	9	0	0
8	25424865	.	T	A	8	4	12	0	0	12	0	0
8	25425212	.	A	G	3	2	5	0	0	5	0	0
8	25425395	.	G	A	2	4	6	0	0	6	0	0
8	25425453	.	G	A	2	4	6	0	1	7	0	0
8	25425621	.	T	A	2	5	7	0	0	7	0	0
8	25426321	.	A	G	3	5	8	0	0	8	0	0
8	25426563	.	T	G	3	1	4	0	0	4	0	0
8	25445451	.	A	G	2	1	3	0	0	3	0	0
8	25650250	.	A	G	1	3	4	0	0	4	0	0
8	25708263	.	A	G	6	5	11	0	0	11	0	0
8	25708998	.	C	T	6	9	15	0	0	15	0	0
8	25709259	.	G	A	12	3	15	0	0	15	0	0
8	25709426	.	G	T	5	9	14	0	0	14	0	0
8	25709521	.	T	A	7	5	12	0	1	13	0	0
8	25709522	.	A	C	7	5	12	0	1	13	0	0
8	25709694	.	T	G	6	4	10	0	1	11	0	0
8	25712660	.	G	T	12	5	17	0	0	17	0	0
8	25713053	.	G	A	4	6	10	0	2	12	0	0
8	25714884	.	G	A	0	1	1	0	0	1	0	0
8	25715028	.	T	A	6	8	14	0	4	18	0	0
8	25715118	.	A	C	4	3	7	0	9	16	0	0
8	25715181	.	C	T	2	9	11	0	0	11	0	0
8	25715325	.	G	C	6	4	10	0	4	14	0	0
8	25715950	.	C	A	8	4	12	0	0	12	0	0
8	25716000	.	C	A	9	9	18	0	0	18	0	0
8	25733949	.	T	A	6	5	11	0	1	12	0	0
8	25745724	.	C	T	8	12	20	0	0	20	0	0
8	25745840	.	C	T	12	8	20	0	0	20	0	0
8	25745915	.	A	T	2	4	6	0	0	6	0	0
8	25746888	.	A	T	4	4	8	0	0	8	0	0
8	25747425	.	A	T	7	6	13	0	0	13	0	0
8	25747502	.	T	C	8	5	13	0	1	14	0	0
8	25747518	.	T	C	7	6	13	0	0	13	0	0
8	25747677	.	G	A	12	8	20	0	0	20	0	0
8	25747705	.	A	G	10	0	10	0	8	18	0	0
8	25748147	.	C	T	5	4	9	0	0	9	0	0
8	25748421	.	T	G	17	8	25	0	1	26	0	0
8	25751167	.	A	G	9	0	9	0	7	16	0	0
8	25761791	.	A	T	3	5	8	0	0	8	0	0
8	25761792	.	C	A	3	5	8	0	0	8	0	0
8	25761886	.	T	C	5	9	14	0	0	14	0	0
8	25764192	.	T	C	11	15	26	0	0	26	0	0
8	25765647	.	G	A	0	9	9	0	11	20	0	0
8	25765788	.	G	A	0	16	16	0	22	38	0	0
8	25765794	.	G	A	21	17	38	0	1	39	0	0
8	25766098	.	G	A	15	3	18	0	1	19	0	0
8	25766131	.	T	C	19	10	29	0	3	32	0	0
8	25766188	.	A	C	7	15	22	0	0	22	0	0
8	25766249	.	A	G	2	3	5	0	0	5	0	0
8	25812075	.	T	C	17	9	26	0	2	28	0	0
8	25812327	.	G	A	15	9	24	0	1	25	0	0
8	25813979	.	G	A	4	8	12	0	0	12	0	0
8	25814003	.	C	T	0	4	4	0	2	6	0	0
8	25816811	.	T	A	11	13	24	0	3	27	0	0
8	25816849	.	G	A	16	17	33	0	1	34	0	0
8	25816863	.	G	A	15	15	30	0	2	32	0	0
8	25816889	.	T	C	13	11	24	0	0	24	0	0
8	25816904	.	T	G	12	11	23	0	1	24	0	0
8	25816959	.	G	T	18	18	36	0	2	38	0	0
8	25818836	.	C	T	0	17	17	0	17	34	0	0
8	25819057	.	T	A	21	10	31	0	0	31	0	0
8	25819090	.	G	T	11	4	15	0	1	16	0	0
8	25819095	.	A	T	13	5	18	0	0	18	0	0
8	25819128	.	A	G	7	6	13	0	0	13	0	0
8	25819137	.	T	C	6	5	11	0	0	11	0	0
8	25819172	.	T	A	3	1	4	0	0	4	0	0
8	25819196	.	G	A	3	3	6	0	0	6	0	0
8	25819349	.	A	G	17	13	30	0	1	31	0	0
8	25819430	.	A	T	9	9	18	0	0	18	0	0
8	25819434	.	C	G	7	11	18	0	2	20	0	0
8	25819548	.	C	G	19	16	35	0	0	35	0	0
8	25820917	.	G	T	7	6	13	0	1	14	0	0
8	25821088	.	T	G	16	8	24	0	0	24	0	0
8	25821426	.	T	C	19	20	39	0	1	40	0	0
8	25892857	.	C	T	6	5	11	0	0	11	0	0
8	25893610	.	C	G	4	3	7	0	0	7	0	0
8	25893655	.	T	C	2	4	6	0	0	6	0	0
8	25893676	.	T	C	2	3	5	0	0	5	0	0
8	25894080	.	C	G	7	6	13	0	0	13	0	0
8	25894108	.	C	T	5	6	11	0	0	11	0	0
8	25897373	.	G	A	0	3	3	0	5	8	0	0
8	25897378	.	C	T	5	3	8	0	0	8	0	0
8	25897861	.	G	A	6	2	8	0	0	8	0	0
8	25898011	.	T	A	6	6	12	0	0	12	0	0
8	25898067	.	G	T	3	3	6	0	0	6	0	0
8	25902955	.	T	C	17	16	33	0	1	34	0	0
8	25905686	.	T	A	20	19	39	0	2	41	0	0
8	25905919	.	T	C	7	11	18	0	0	18	0	0
8	25950704	.	G	C	1	2	3	0	1	4	0	0
8	25950772	.	G	A	13	6	19	0	1	20	0	0
8	25950880	.	G	T	19	6	25	0	2	28	1	0
8	25951090	.	A	G	19	14	33	0	1	34	0	0
8	25951265	.	A	T	15	7	22	0	0	22	0	0
8	25951293	.	A	T	17	5	22	0	1	23	0	0
8	25951378	.	C	G	19	8	27	0	3	30	0	0
8	25951411	.	C	T	16	13	29	0	0	29	0	0
8	25951626	.	T	C	11	2	13	0	0	13	0	0
8	25951660	.	G	T	7	4	11	0	1	12	0	0
8	25951665	.	T	A	9	3	12	0	0	12	0	0
8	25951762	.	C	T	15	5	20	0	1	21	0	0
8	25963150	.	A	G	6	8	14	0	0	14	0	0
8	25963151	.	C	A	6	7	13	0	1	14	0	0
8	25964468	.	A	G	3	0	3	0	9	12	0	0
8	25964489	.	A	G	1	0	1	0	11	12	0	0
8	25969188	.	C	T	4	0	4	0	0	4	0	0
8	25969466	.	C	T	7	6	13	0	1	14	0	0
8	25969498	.	A	G	14	10	24	0	1	25	0	0
8	25969506	.	G	A	0	12	12	0	14	26	0	0
8	25969778	.	T	A	6	3	9	0	0	9	0	0
8	25969840	.	A	G	7	8	15	0	0	15	0	0
8	25970647	.	A	T	5	4	9	0	0	9	0	0
8	25970719	.	A	T	6	9	15	0	1	16	0	0
8	25970816	.	G	T	11	10	21	0	1	22	0	0
8	25970932	.	G	A	9	10	19	0	0	19	0	0
8	25971143	.	C	A	4	10	14	0	0	14	0	0
8	25971306	.	T	A	16	12	28	0	3	31	0	0
8	25971367	.	C	T	6	14	20	0	1	21	0	0
8	25971397	.	G	A	2	12	14	0	1	15	0	0
8	25971488	.	A	C	2	3	5	0	0	5	0	0
8	25971489	.	G	A	2	3	5	0	0	5	0	0
8	26008088	.	G	A	0	3	3	0	3	6	0	0
8	26016156	.	G	A	0	2	2	0	0	2	0	0
8	26019711	.	A	G	5	4	9	0	0	9	0	0
8	26030660	.	C	A	5	1	6	0	1	7	0	0
8	26034654	.	A	G	6	4	10	0	1	11	0	0
8	26034676	.	C	T	5	5	10	0	0	10	0	0
8	26056801	.	G	A	19	18	37	0	3	40	0	0
8	26056891	.	T	G	16	17	33	0	4	37	0	0
8	26056935	.	T	C	20	18	38	0	5	43	0	0
8	26056970	.	T	C	14	19	33	0	2	35	0	0
8	26056990	.	T	C	15	22	37	0	3	40	0	0
8	26057014	.	T	C	20	22	42	0	2	44	0	0
8	26059717	.	T	G	3	8	11	0	0	11	0	0
8	26059867	.	T	A	1	2	3	0	0	3	0	0
8	26078551	.	C	T	16	8	24	0	0	24	0	0
8	26078825	.	A	G	14	5	19	0	0	19	0	0
8	26078826	.	A	G	15	4	19	0	0	19	0	0
8	26078879	.	T	G	9	2	11	0	2	13	0	0
8	26083987	.	C	T	8	3	11	0	0	11	0	0
8	26091767	.	C	T	9	7	16	0	0	16	0	0
8	26091845	.	A	G	0	0	0	0	3	3	0	0
8	26092050	.	A	G	17	15	32	0	1	33	0	0
8	26092176	.	T	A	6	9	15	0	0	15	0	0
8	26097399	.	T	C	29	17	46	0	0	46	0	0
8	26097749	.	C	T	11	6	17	0	1	18	0	0
8	26097895	.	C	A	6	14	20	0	0	20	0	0
8	26151750	.	G	T	4	3	7	0	0	7	0	0
8	26190452	.	G	A	2	3	5	0	0	5	0	0
8	26199999	.	G	A	0	3	3	0	4	7	0	0
8	26200014	.	G	T	5	4	9	0	0	9	0	0
8	26203148	.	C	T	2	0	2	0	0	2	0	0
8	26203373	.	C	T	3	2	5	0	0	5	0	0
8	26208387	.	T	C	2	7	9	0	0	9	0	0
8	26210178	.	G	A	1	0	1	0	0	1	0	0
8	26210523	.	A	T	7	4	11	0	0	11	0	0
8	26210781	.	C	T	6	5	11	0	0	11	0	0
8	26221228	.	C	T	0	2	2	0	2	4	0	0
8	26233538	.	A	C	1	2	3	0	0	3	0	0
8	26233539	.	G	A	1	2	3	0	0	3	0	0
8	26234599	.	A	T	1	2	3	0	0	3	0	0
8	26235117	.	A	C	3	4	7	0	1	8	0	0
8	26235275	.	C	T	8	4	12	0	0	12	0	0
8	26235471	.	A	G	2	2	4	0	1	5	0	0
8	26239871	.	T	G	1	0	1	0	2	3	0	0
8	26239916	.	G	A	0	6	6	0	6	12	0	0
8	26239919	.	T	A	6	6	12	0	0	12	0	0
8	26240007	.	C	T	11	3	14	0	0	14	0	0
8	26240249	.	A	G	3	1	4	0	2	6	0	0
8	26240346	.	G	A	1	4	5	0	3	8	0	0
8	26240348	.	A	T	4	4	8	0	0	8	0	0
8	26292594	.	G	T	4	10	14	0	0	14	0	0
8	26293930	.	C	T	7	10	17	0	1	18	0	0
8	26324620	.	C	T	8	6	14	0	0	14	0	0
8	26324647	.	A	T	3	3	6	0	0	6	0	0
8	26324683	.	C	T	4	6	10	0	0	10	0	0
8	26324709	.	T	C	4	12	16	0	0	16	0	0
8	26324773	.	T	C	8	20	28	0	1	29	0	0
8	26324905	.	A	G	11	10	21	0	3	24	0	0
8	26325332	.	T	A	29	21	50	0	0	50	0	0
8	26325333	.	A	T	28	20	48	0	2	50	0	0
8	26325519	.	A	T	15	7	22	0	0	22	0	0
8	26325600	.	T	C	17	15	32	0	1	33	0	0
8	26325679	.	C	T	20	21	41	0	2	43	0	0
8	26326046	.	G	A	14	12	26	0	1	27	0	0
8	26326152	.	T	C	21	29	50	0	1	51	0	0
8	26330006	.	G	A	7	6	13	0	1	14	0	0
8	26330047	.	A	C	5	5	10	0	0	10	0	0
8	26330134	.	A	T	5	10	15	0	0	15	0	0
8	26330190	.	T	C	6	9	15	0	0	15	0	0
8	26330666	.	T	C	4	10	14	0	1	15	0	0
8	26357826	.	A	G	3	2	5	0	2	7	0	0
8	26367891	.	T	G	4	15	19	0	1	20	0	0
8	26368025	.	C	T	29	20	49	0	1	50	0	0
8	26368150	.	C	T	32	19	51	0	0	51	0	0
8	26368171	.	T	C	31	20	51	0	0	51	0	0
8	26368446	.	A	T	4	14	18	0	1	19	0	0
8	26382991	.	A	G	2	3	5	0	0	5	0	0
8	26383000	.	T	C	2	3	5	0	0	5	0	0
8	26424873	.	A	G	3	5	8	0	0	8	0	0
8	26426163	.	T	C	1	2	3	0	0	3	0	0
8	26426596	.	T	G	4	12	16	0	1	17	0	0
8	26426621	.	C	T	5	7	12	0	1	13	0	0
8	26426771	.	C	T	8	5	13	0	0	13	0	0
8	26426978	.	A	C	5	6	11	0	0	11	0	0
8	26427081	.	C	T	5	11	16	0	1	17	0	0
8	26427125	.	C	T	6	7	13	0	0	13	0	0
8	26427132	.	C	A	7	2	9	0	0	9	0	0
8	26436030	.	A	G	4	3	7	0	0	7	0	0
8	26442442	.	A	T	0	2	2	0	0	2	0	0
8	26444741	.	T	C	0	1	1	0	0	1	0	0
8	26444759	.	A	T	0	1	1	0	0	1	0	0
8	26445075	.	T	C	2	5	7	0	0	7	0	0
8	26445100	.	G	T	4	5	9	0	0	9	0	0
8	26445119	.	A	G	4	7	11	0	0	11	0	0
8	26445157	.	A	C	2	6	8	0	0	8	0	0
8	26445184	.	A	T	0	4	4	0	0	4	0	0
8	26447468	.	G	A	0	1	1	0	0	1	0	0
8	26449218	.	A	T	3	3	6	0	0	6	0	0
8	26449383	.	G	A	2	1	3	0	0	3	0	0
8	26565389	.	C	T	1	2	3	0	0	3	0	0
8	26572943	.	T	C	1	2	3	0	0	3	0	0
8	26573009	.	T	C	1	3	4	0	1	5	0	0
8	26573030	.	G	A	0	3	3	0	2	5	0	0
8	26573066	.	T	A	1	2	3	0	0	3	0	0
8	26573075	.	A	C	1	2	3	0	0	3	0	0
8	26573519	.	T	C	3	4	7	0	2	9	0	0
8	26586558	.	G	A	8	6	14	0	0	14	0	0
8	26586634	.	A	C	7	6	13	0	1	14	0	0
8	26586900	.	G	T	10	12	22	0	0	22	0	0
8	26587137	.	C	G	3	6	9	0	0	9	0	0
8	26587323	.	G	A	6	7	13	0	0	13	0	0
8	26587380	.	G	A	5	3	8	0	0	8	0	0
8	26609170	.	C	G	1	2	3	0	0	3	0	0
8	26701774	.	A	T	3	3	6	0	1	7	0	0
8	26709844	.	T	C	4	4	8	0	0	8	0	0
8	26709876	.	A	T	4	4	8	0	0	8	0	0
8	26731764	.	A	C	1	1	2	0	0	2	0	0
8	26731866	.	T	G	7	3	10	0	0	10	0	0
8	26746173	.	C	T	4	2	6	0	0	6	0	0
8	26838478	.	T	G	1	0	1	0	4	5	0	0
8	26838547	.	C	T	7	8	15	0	0	15	0	0
8	26860061	.	C	A	1	2	3	0	0	3	0	0
8	26860064	.	A	T	1	2	3	0	0	3	0	0
8	26860124	.	G	A	3	3	6	0	0	6	0	0
8	26860307	.	A	G	1	3	4	0	0	4	0	0
8	26860359	.	G	T	5	3	8	0	0	8	0	0
8	26860430	.	C	T	3	3	6	0	0	6	0	0
8	26860493	.	A	C	3	3	6	0	0	6	0	0
8	26860511	.	T	C	2	3	5	0	0	5	0	0
8	26860600	.	G	T	4	5	9	0	0	9	0	0
8	26860778	.	T	C	0	4	4	0	0	4	0	0
8	26860779	.	G	A	0	4	4	0	0	4	0	0
8	26860909	.	T	C	2	4	6	0	1	7	0	0
8	26861145	.	A	G	3	9	12	0	0	12	0	0
8	26861434	.	G	A	5	5	10	0	0	10	0	0
8	26861653	.	T	C	3	5	8	0	0	8	0	0
8	26861760	.	C	A	6	5	11	0	0	11	0	0
8	26862002	.	A	C	6	11	17	0	0	17	0	0
8	26862526	.	C	A	6	7	13	0	0	14	1	0
8	26863804	.	C	A	13	7	20	0	2	22	0	0
8	26864121	.	A	G	12	11	23	0	2	25	0	0
8	26864150	.	G	C	14	10	24	0	0	24	0	0
8	26864195	.	G	C	17	9	26	0	1	27	0	0
8	26868418	.	T	C	10	10	20	0	0	20	0	0
8	26881205	.	T	G	16	0	16	0	8	24	0	0
8	26884298	.	T	C	18	17	35	0	2	37	0	0
8	26884313	.	A	G	17	18	35	0	1	36	0	0
8	26884619	.	C	T	30	25	55	0	0	55	0	0
8	26884767	.	C	T	24	25	49	0	0	49	0	0
8	26884903	.	T	A	19	17	36	0	4	40	0	0
8	26885382	.	C	A	23	19	42	0	1	44	1	0
8	26886025	.	C	T	24	13	37	0	4	41	0	0
8	26886177	.	T	C	11	28	39	0	2	41	0	0
8	26886259	.	A	G	25	16	41	0	2	43	0	0
8	26886399	.	C	G	26	21	47	0	4	51	0	0
8	26886667	.	T	A	24	25	49	0	3	57	5	0
8	26886766	.	T	C	27	20	47	0	1	48	0	0
8	26886972	.	A	T	17	28	45	0	3	48	0	0
8	26887013	.	T	C	18	28	46	0	0	46	0	0
8	26887122	.	A	C	12	21	33	0	3	36	0	0
8	26887240	.	G	A	1	4	5	0	7	12	0	0
8	26902641	.	C	T	0	2	2	0	2	4	0	0
8	27361846	.	G	A	7	8	15	0	0	15	0	0
8	27362288	.	C	G	9	4	13	0	0	13	0	0
8	27371858	.	C	G	7	7	14	0	1	15	0	0
8	27515239	.	T	C	7	5	12	0	0	12	0	0
8	27623973	.	A	G	20	1	21	0	16	37	0	0
8	27624026	.	T	A	23	19	42	0	1	43	0	0
8	27624027	.	T	C	24	19	43	0	0	43	0	0
8	27624222	.	T	C	2	3	5	0	1	6	0	0
8	27813611	.	C	A	5	7	12	0	0	12	0	0
8	27816560	.	C	A	27	23	50	0	4	54	0	0
8	27816680	.	C	T	17	20	37	0	5	42	0	0
8	28399129	.	G	A	5	9	14	0	0	14	0	0
8	28868137	.	A	G	4	0	4	0	4	8	0	0
8	28868416	.	G	A	0	5	5	0	7	12	0	0
8	28868425	.	G	A	8	4	12	0	1	13	0	0
8	28982606	.	G	A	1	1	2	0	0	2	0	0
8	29285661	.	C	T	1	0	1	0	0	1	0	0
8	29336828	.	C	T	1	1	2	0	0	2	0	0
8	29427894	.	C	T	4	2	6	0	0	6	0	0
8	29427954	.	T	C	3	3	6	0	0	6	0	0
8	29428042	.	C	A	3	5	8	0	1	9	0	0
8	29428071	.	G	A	0	2	2	0	4	6	0	0
8	29428110	.	C	T	0	1	1	0	0	1	0	0
8	29574985	.	C	A	14	11	25	0	2	27	0	0
8	29587262	.	C	A	15	12	27	0	2	29	0	0
8	29587500	.	C	A	7	12	19	0	1	20	0	0
8	29587651	.	C	T	10	11	21	0	1	22	0	0
8	29644791	.	G	A	3	1	4	0	0	4	0	0
8	29644838	.	T	A	1	2	3	0	0	3	0	0
8	29644845	.	C	T	1	1	2	0	1	3	0	0
8	29647748	.	T	C	4	2	6	0	0	6	0	0
8	29651670	.	G	A	3	2	5	0	1	6	0	0
8	29651951	.	A	G	6	9	15	0	0	15	0	0
8	29652143	.	A	G	9	5	14	0	1	15	0	0
8	29652174	.	G	A	9	5	14	0	0	14	0	0
8	29710752	.	C	T	3	2	5	0	0	5	0	0
8	29710888	.	A	G	1	2	3	0	0	3	0	0
8	29710891	.	C	T	1	2	3	0	0	3	0	0
8	29719073	.	G	T	11	4	15	0	1	16	0	0
8	29719306	.	C	T	5	5	10	0	0	10	0	0
8	29749112	.	T	G	1	2	3	0	1	4	0	0
8	29759726	.	A	C	2	2	4	0	0	4	0	0
8	29763480	.	C	T	5	2	7	0	0	7	0	0
8	29763812	.	G	C	8	3	11	0	0	11	0	0
8	29763822	.	A	G	3	1	4	0	8	12	0	0
8	29764138	.	C	T	6	3	9	0	1	10	0	0
8	29764150	.	A	T	7	3	10	0	1	11	0	0
8	29764761	.	T	C	2	3	5	0	0	5	0	0
8	29764968	.	T	C	2	2	4	0	0	4	0	0
8	29765045	.	C	T	5	2	7	0	0	7	0	0
8	29765429	.	C	A	2	3	5	0	0	5	0	0
8	29766516	.	T	C	0	2	2	0	0	2	0	0
8	29770371	.	T	A	20	34	54	0	0	54	0	0
8	29773127	.	T	A	14	13	27	0	1	28	0	0
8	29774042	.	C	G	0	14	14	0	11	25	0	0
8	29774428	.	T	A	12	13	25	0	0	25	0	0
8	29793782	.	A	G	1	3	4	0	2	6	0	0
8	29799168	.	C	T	0	12	12	0	6	18	0	0
8	29799360	.	G	A	8	7	15	0	0	15	0	0
8	29799627	.	G	A	0	3	3	0	0	3	0	0
8	29801150	.	C	G	3	2	5	0	0	5	0	0
8	29801291	.	C	T	5	3	8	0	0	8	0	0
8	29806615	.	G	A	3	6	9	0	0	9	0	0
8	29819604	.	C	T	0	4	4	0	0	4	0	0
8	29819610	.	C	T	0	4	4	0	0	4	0	0
8	29871800	.	T	C	1	4	5	0	0	5	0	0
8	29899087	.	G	C	8	0	8	0	3	11	0	0
8	29899209	.	T	C	7	5	12	0	0	12	0	0
8	29899248	.	T	C	7	7	14	0	1	15	0	0
8	29899302	.	C	T	0	6	6	0	5	11	0	0
8	29899318	.	T	C	4	6	10	0	1	11	0	0
8	29902904	.	T	C	1	2	3	0	1	4	0	0
8	29904855	.	T	C	0	1	1	0	0	1	0	0
8	29907414	.	C	A	3	4	7	0	0	7	0	0
8	29907494	.	A	G	3	4	7	0	1	8	0	0
8	29907560	.	C	G	2	1	3	0	1	4	0	0
8	29930687	.	T	A	1	1	2	0	0	2	0	0
8	29930690	.	G	A	1	0	1	0	1	2	0	0
8	30025143	.	T	A	1	2	3	0	0	3	0	0
8	30025145	.	G	A	0	2	2	0	1	3	0	0
8	30038883	.	G	A	1	1	2	0	0	2	0	0
8	30063320	.	T	C	1	3	4	0	0	4	0	0
8	30159420	.	C	T	3	2	5	0	0	5	0	0
8	30326228	.	G	A	2	2	4	0	0	5	1	0
8	30338875	.	C	G	0	4	4	0	0	4	0	0
8	30338926	.	C	T	3	6	9	0	0	9	0	0
8	30425782	.	G	C	0	4	4	0	2	6	0	0
8	30430521	.	C	T	1	0	1	0	0	1	0	0
8	30449074	.	G	A	2	1	3	0	1	4	0	0
8	30546140	.	C	T	2	2	4	0	0	4	0	0
8	30570193	.	G	T	1	1	2	0	0	2	0	0
8	30575832	.	C	T	1	0	1	0	0	1	0	0
8	30576118	.	G	A	1	1	2	0	0	2	0	0
8	30593567	.	G	A	8	3	11	0	0	11	0	0
8	30623994	.	C	T	4	3	7	0	0	7	0	0
8	30631057	.	C	T	2	2	4	0	0	4	0	0
8	30661270	.	C	T	7	7	14	0	2	16	0	0
8	30661565	.	A	G	10	0	10	0	10	20	0	0
8	30661645	.	G	A	6	10	16	0	0	16	0	0
8	30662366	.	A	T	4	4	8	0	0	8	0	0
8	30662481	.	T	C	14	7	21	0	1	22	0	0
8	30662505	.	A	T	10	9	19	0	4	23	0	0
8	30662713	.	C	T	4	2	6	0	0	6	0	0
8	30731187	.	A	G	1	5	6	0	1	7	0	0
8	30731492	.	C	T	3	4	7	0	1	8	0	0
8	30731535	.	A	T	2	5	7	0	0	7	0	0
8	30731791	.	T	A	3	2	5	0	0	5	0	0
8	30735082	.	T	A	8	7	15	0	1	16	0	0
8	30742022	.	C	A	0	7	7	0	5	12	0	0
8	30742130	.	C	T	0	6	6	0	7	13	0	0
8	30743321	.	T	C	4	9	13	0	1	14	0	0
8	30743345	.	A	G	7	8	15	0	1	16	0	0
8	30744468	.	G	A	0	5	5	0	4	9	0	0
8	30744528	.	C	T	2	0	2	0	1	3	0	0
8	30745437	.	A	G	2	3	5	0	0	5	0	0
8	31119730	.	A	G	3	1	4	0	0	4	0	0
8	31119865	.	T	C	4	1	5	0	2	7	0	0
8	31119909	.	T	G	8	0	8	0	8	16	0	0
8	31123029	.	T	C	6	6	12	0	0	12	0	0
8	31131277	.	A	G	4	1	5	0	0	5	0	0
8	31131394	.	A	C	6	1	7	0	0	7	0	0
8	31142074	.	G	A	13	18	31	0	8	39	0	0
8	31146748	.	G	A	19	25	44	0	0	44	0	0
8	31146913	.	G	A	21	30	51	0	0	51	0	0
8	31147380	.	T	G	23	16	39	0	1	40	0	0
8	31147526	.	G	A	14	32	46	0	4	50	0	0
8	31249605	.	A	G	11	11	22	0	1	23	0	0
8	31249881	.	T	A	6	12	18	0	1	19	0	0
8	31249941	.	T	A	2	8	10	0	0	10	0	0
8	31250357	.	A	G	5	0	5	0	10	15	0	0
8	31250384	.	T	G	8	9	17	0	0	17	0	0
8	31251091	.	A	G	11	12	23	0	1	24	0	0
8	31251129	.	G	A	11	19	30	0	1	31	0	0
8	31251222	.	T	C	16	13	29	0	0	29	0	0
8	31251354	.	T	C	14	16	30	0	0	30	0	0
8	31251426	.	T	C	12	16	28	0	2	30	0	0
8	31251510	.	C	A	17	15	32	0	0	32	0	0
8	31251555	.	G	A	0	22	22	0	17	39	0	0
8	31251792	.	G	C	0	19	19	0	18	37	0	0
8	31253722	.	T	C	8	15	23	0	0	23	0	0
8	31254046	.	C	A	14	8	22	1	1	24	0	0
8	31254176	.	A	T	20	13	33	0	0	33	0	0
8	31254219	.	T	C	11	12	23	0	0	23	0	0
8	31367747	.	T	C	3	7	10	0	0	10	0	0
8	31368010	.	G	A	23	15	38	0	2	40	0	0
8	31368279	.	T	G	11	12	23	0	2	25	0	0
8	31368524	.	C	T	11	9	20	0	1	21	0	0
8	31368557	.	A	G	13	10	23	0	1	24	0	0
8	31368611	.	T	C	7	4	11	0	0	11	0	0
8	31368889	.	C	T	5	5	10	0	1	11	0	0
8	31369071	.	G	C	5	13	18	0	0	18	0	0
8	31375338	.	T	C	2	2	4	0	0	4	0	0
8	31375400	.	C	T	4	11	15	0	1	16	0	0
8	31375405	.	T	C	4	12	16	0	0	16	0	0
8	31375529	.	T	C	14	13	27	0	1	28	0	0
8	31375549	.	C	T	12	5	17	0	0	17	0	0
8	31375670	.	T	G	10	20	30	0	1	31	0	0
8	31375928	.	A	G	5	5	10	0	1	11	0	0
8	31379542	.	C	T	0	5	5	0	2	7	0	0
8	31387695	.	A	G	9	6	15	0	0	15	0	0
8	31387728	.	T	G	8	8	16	0	1	17	0	0
8	31393235	.	G	A	2	4	6	0	0	6	0	0
8	31393376	.	G	A	3	3	6	0	0	6	0	0
8	31395397	.	C	T	1	0	1	0	0	1	0	0
8	31395400	.	C	T	0	0	0	0	1	1	0	0
8	31395471	.	A	G	3	5	8	0	1	9	0	0
8	31395632	.	A	C	2	2	4	0	0	4	0	0
8	31403867	.	A	G	2	1	3	0	0	3	0	0
8	31406847	.	G	C	7	2	9	0	11	20	0	0
8	31407126	.	A	T	9	10	19	0	0	19	0	0
8	31407153	.	C	T	10	13	23	0	0	23	0	0
8	31407294	.	A	G	3	10	13	0	1	14	0	0
8	31411089	.	C	T	0	5	5	0	3	8	0	0
8	31411578	.	G	A	8	6	14	0	0	14	0	0
8	31411646	.	T	A	2	1	3	0	0	3	0	0
8	31437497	.	G	C	8	6	14	0	0	14	0	0
8	31437611	.	C	T	12	14	26	0	2	28	0	0
8	31437768	.	C	G	3	5	8	0	0	8	0	0
8	31441698	.	C	A	13	14	27	0	1	28	0	0
8	31441724	.	G	T	20	13	33	0	0	33	0	0
8	31441733	.	C	A	17	19	36	0	0	36	0	0
8	31441850	.	T	C	27	23	50	0	2	52	0	0
8	31442000	.	G	A	20	22	42	0	2	44	0	0
8	31442595	.	G	A	23	16	39	0	1	40	0	0
8	31442886	.	T	C	20	20	40	0	1	41	0	0
8	31443023	.	A	C	31	14	45	0	9	54	0	0
8	31705267	.	G	A	16	24	40	0	2	42	0	0
8	31710941	.	G	A	8	7	15	0	1	16	0	0
8	31711411	.	T	C	9	0	9	0	8	17	0	0
8	31730813	.	A	C	3	3	6	0	1	7	0	0
8	31756640	.	A	G	2	1	3	0	0	3	0	0
8	31760785	.	C	T	2	2	4	0	0	4	0	0
8	31817931	.	A	C	2	1	3	0	0	3	0	0
8	31818018	.	T	C	17	18	35	0	2	37	0	0
8	31818022	.	G	A	0	21	21	0	18	39	0	0
8	31818083	.	A	T	12	23	35	0	0	35	0	0
8	31818196	.	G	A	9	23	32	0	3	35	0	0
8	31818267	.	T	G	10	25	35	0	2	37	0	0
8	31818273	.	T	A	9	24	33	0	4	37	0	0
8	31818335	.	G	A	13	14	27	0	2	29	0	0
8	31818349	.	A	C	15	13	28	0	2	30	0	0
8	31818460	.	A	G	5	8	13	0	1	14	0	0
8	31818549	.	C	T	1	6	7	0	1	8	0	0
8	31818748	.	T	C	6	16	22	0	1	23	0	0
8	31818800	.	G	A	4	14	18	0	0	18	0	0
8	31818835	.	T	G	4	17	21	0	0	21	0	0
8	31850955	.	A	T	11	16	27	0	0	27	0	0
8	31850976	.	G	T	7	13	20	0	2	22	0	0
8	31851150	.	A	C	6	8	14	0	0	14	0	0
8	31851270	.	G	A	4	14	18	0	0	18	0	0
8	31851333	.	G	T	8	12	20	0	0	20	0	0
8	31851336	.	A	G	9	11	20	0	1	21	0	0
8	31851582	.	A	G	6	5	11	0	0	11	0	0
8	31851594	.	T	C	2	2	4	0	0	4	0	0
8	31861425	.	A	G	11	11	22	0	0	22	0	0
8	31861580	.	G	A	22	16	38	0	1	39	0	0
8	31861616	.	T	A	20	20	40	0	0	40	0	0
8	31861746	.	C	T	11	24	35	0	2	37	0	0
8	31862063	.	T	C	15	21	36	0	3	39	0	0
8	31862179	.	A	G	21	13	34	0	0	34	0	0
8	31862312	.	G	A	0	24	24	0	21	45	0	0
8	31862584	.	G	T	16	13	29	0	1	30	0	0
8	31901757	.	T	C	2	4	6	0	0	6	0	0
8	31901760	.	C	T	2	4	6	0	0	6	0	0
8	31901925	.	G	A	11	16	27	0	1	28	0	0
8	31906886	.	G	A	1	5	6	0	0	6	0	0
8	31906910	.	C	A	4	14	18	0	0	18	0	0
8	31906927	.	G	A	7	17	24	0	1	25	0	0
8	31919110	.	A	C	4	0	4	0	3	7	0	0
8	31919526	.	C	A	10	11	21	0	0	21	0	0
8	31919558	.	A	C	13	14	27	0	0	27	0	0
8	31941679	.	C	T	3	3	6	0	0	6	0	0
8	31941746	.	C	A	5	13	18	0	1	19	0	0
8	31941853	.	C	T	5	4	9	0	0	9	0	0
8	31941904	.	T	A	7	5	12	0	1	13	0	0
8	31942771	.	C	T	12	8	20	0	0	20	0	0
8	31943276	.	G	A	7	7	14	0	0	14	0	0
8	31943301	.	T	G	9	4	13	0	3	16	0	0
8	31943357	.	T	C	4	2	6	0	0	6	0	0
8	32028856	.	G	T	5	7	12	0	1	13	0	0
8	32028921	.	T	A	3	5	8	0	3	11	0	0
8	32029044	.	T	G	10	6	16	0	0	16	0	0
8	32029258	.	T	C	5	9	14	0	0	14	0	0
8	32029481	.	A	G	2	3	5	0	0	5	0	0
8	32029663	.	C	T	4	2	6	0	1	7	0	0
8	32029692	.	T	C	5	3	8	0	0	8	0	0
8	32029699	.	T	C	3	0	3	0	5	8	0	0
8	32030053	.	T	C	3	2	5	0	0	5	0	0
8	32030087	.	G	A	4	2	6	0	0	6	0	0
8	32030107	.	G	A	5	2	7	0	0	7	0	0
8	32030341	.	A	G	6	5	11	0	1	12	0	0
8	32030538	.	G	A	1	3	4	0	0	4	0	0
8	32030771	.	T	G	5	4	9	0	0	9	0	0
8	32191744	.	G	A	2	1	3	0	0	3	0	0
8	32247811	.	T	C	1	2	3	0	0	3	0	0
8	32486956	.	C	T	0	9	9	0	16	25	0	0
8	32497755	.	T	C	2	4	6	0	1	7	0	0
8	32501429	.	T	G	3	2	5	0	0	5	0	0
8	32501541	.	A	G	3	3	6	0	0	6	0	0
8	32506134	.	T	C	3	6	9	0	0	9	0	0
8	32506175	.	G	T	4	5	9	0	0	9	0	0
8	32506215	.	T	C	3	0	3	0	4	7	0	0
8	32516296	.	A	G	4	6	10	0	0	10	0	0
8	32577794	.	G	A	3	2	5	0	0	5	0	0
8	32588542	.	G	T	0	1	1	0	1	2	0	0
8	32598954	.	A	G	3	3	6	0	0	6	0	0
8	32598963	.	C	G	3	0	3	0	5	8	0	0
8	32599147	.	G	A	8	14	22	0	0	22	0	0
8	32599288	.	T	C	4	8	12	0	0	12	0	0
8	32599295	.	A	G	5	11	16	0	0	16	0	0
8	32599413	.	T	C	12	9	21	0	1	22	0	0
8	32599586	.	C	T	10	16	26	0	0	26	0	0
8	32949287	.	C	T	0	2	2	0	2	4	0	0
8	33113932	.	A	G	4	2	6	0	2	8	0	0
8	33114094	.	T	A	4	10	14	0	0	14	0	0
8	33896450	.	A	G	6	10	16	0	3	19	0	0
8	33896524	.	G	T	13	7	20	0	1	21	0	0
8	33896585	.	C	T	29	22	51	0	2	53	0	0
8	33896698	.	A	G	20	26	46	0	2	48	0	0
8	33896902	.	G	A	14	23	37	0	2	39	0	0
8	33896964	.	T	G	22	15	37	0	5	42	0	0
8	33897266	.	T	C	31	0	31	0	25	56	0	0
8	33910017	.	G	A	18	12	30	0	3	33	0	0
8	33918520	.	C	T	9	10	19	0	0	19	0	0
8	33924284	.	A	G	3	6	9	0	1	10	0	0
8	33924333	.	G	T	19	19	38	0	3	41	0	0
8	34051619	.	G	T	15	13	28	0	1	29	0	0
8	34051719	.	G	A	11	14	25	0	0	25	0	0
8	34051850	.	G	A	7	11	18	0	1	19	0	0
8	34342146	.	G	A	8	12	20	0	0	20	0	0
8	34342214	.	A	T	14	10	24	0	1	25	0	0
8	34342462	.	A	G	12	8	20	0	0	20	0	0
8	34345285	.	G	A	8	1	9	0	0	9	0	0
8	34345372	.	T	C	14	11	25	0	1	26	0	0
8	34345390	.	A	G	13	8	21	0	0	21	0	0
8	34345583	.	A	G	2	0	2	0	0	2	0	0
8	34347281	.	T	C	9	8	17	0	2	19	0	0
8	34348958	.	A	C	3	1	4	0	0	4	0	0
8	34394570	.	G	A	1	2	3	0	0	3	0	0
8	35759213	.	G	C	2	5	7	0	0	7	0	0
8	35759363	.	T	G	1	3	4	0	0	4	0	0
8	35759444	.	C	T	2	2	4	0	1	5	0	0
8	35759726	.	C	T	3	3	6	0	0	6	0	0
8	35760218	.	C	T	9	4	13	0	1	14	0	0
8	35760423	.	C	T	1	2	3	0	1	4	0	0
8	35810115	.	T	C	1	0	1	0	3	4	0	0
8	35967927	.	A	G	0	2	2	0	1	3	0	0
8	35967932	.	G	A	0	2	2	0	1	3	0	0
8	36014713	.	T	C	2	1	3	0	0	3	0	0
8	36058573	.	G	A	0	3	3	0	2	5	0	0
8	36058800	.	T	A	2	7	9	0	0	9	0	0
8	36061617	.	C	A	0	3	3	0	1	4	0	0
8	36062629	.	C	T	2	2	4	0	0	4	0	0
8	36468769	.	A	T	1	2	3	0	0	3	0	0
8	36507764	.	G	A	1	2	3	0	1	4	0	0
8	36512888	.	G	T	1	2	3	0	0	3	0	0
8	36515721	.	A	G	2	3	5	0	0	5	0	0
8	36560180	.	C	T	2	3	5	0	0	5	0	0
8	36561942	.	A	T	9	6	15	0	2	17	0	0
8	36562293	.	C	T	16	4	20	0	0	20	0	0
8	36564005	.	A	G	15	5	20	0	0	20	0	0
8	36564746	.	C	T	0	2	2	0	1	3	0	0
8	36564760	.	T	G	1	0	1	0	3	4	0	0
8	36566125	.	C	T	13	6	19	0	2	21	0	0
8	36566167	.	G	A	27	8	35	0	1	36	0	0
8	36566182	.	T	C	24	9	33	0	2	35	0	0
8	36566353	.	T	C	8	3	11	0	0	11	0	0
8	36567283	.	C	T	23	12	35	0	2	37	0	0
8	36568561	.	A	G	8	4	12	0	0	12	0	0
8	36568755	.	T	C	1	3	4	0	0	4	0	0
8	36569810	.	T	C	4	2	6	0	0	6	0	0
8	36569924	.	C	A	13	7	20	0	0	20	0	0
8	36569925	.	T	A	13	7	20	0	0	20	0	0
8	36569968	.	A	C	12	8	20	0	3	23	0	0
8	36569990	.	A	G	12	12	24	0	1	25	0	0
8	36570147	.	T	C	4	3	7	0	0	7	0	0
8	36571161	.	A	G	4	0	4	0	0	4	0	0
8	36571187	.	A	G	2	0	2	0	0	2	0	0
8	36573472	.	T	C	3	2	5	0	0	5	0	0
8	36573742	.	C	T	0	1	1	0	0	1	0	0
8	36573796	.	C	T	1	3	4	0	0	4	0	0
8	36575325	.	T	C	1	1	2	0	0	2	0	0
8	36577083	.	T	C	0	3	3	0	0	3	0	0
8	36577143	.	C	T	2	5	7	0	0	7	0	0
8	36577158	.	T	C	2	3	5	0	0	5	0	0
8	36583834	.	T	C	3	2	5	0	0	5	0	0
8	36587934	.	A	G	6	9	15	0	0	15	0	0
8	36587936	.	A	G	6	0	6	0	9	15	0	0
8	36587970	.	C	A	9	14	23	0	0	23	0	0
8	36587981	.	G	T	5	14	19	0	1	20	0	0
8	36588124	.	G	A	3	4	7	0	1	8	0	0
8	36589197	.	C	T	8	5	13	0	0	13	0	0
8	36589260	.	T	A	7	7	14	0	1	15	0	0
8	36591868	.	A	C	7	5	12	0	0	12	0	0
8	36591985	.	C	T	4	6	10	0	0	10	0	0
8	36592018	.	A	G	5	6	11	0	0	11	0	0
8	36592021	.	C	A	1	6	7	0	4	11	0	0
8	36592159	.	A	G	3	5	8	0	0	8	0	0
8	36592160	.	A	G	3	5	8	0	0	8	0	0
8	36592297	.	G	A	11	8	19	0	0	19	0	0
8	36592374	.	A	G	4	3	7	0	0	7	0	0
8	36594354	.	T	C	4	0	4	0	6	10	0	0
8	36594481	.	T	G	2	0	2	0	0	2	0	0
8	36594509	.	G	A	1	0	1	0	0	1	0	0
8	36598244	.	T	C	4	0	4	0	3	7	0	0
8	36598441	.	C	T	0	12	12	0	9	21	0	0
8	36600867	.	C	T	5	7	12	0	1	13	0	0
8	36600879	.	G	A	4	4	8	0	0	8	0	0
8	36602459	.	C	T	1	2	3	0	0	3	0	0
8	36617635	.	C	G	2	5	7	0	0	7	0	0
8	36617669	.	A	G	2	5	7	0	0	7	0	0
8	36617728	.	G	A	3	3	6	0	0	6	0	0
8	36781593	.	G	A	0	5	5	0	1	6	0	0
8	36781596	.	A	G	0	0	0	0	6	6	0	0
8	36783396	.	C	T	4	5	9	0	0	9	0	0
8	36785599	.	T	C	0	1	1	0	0	1	0	0
8	36803687	.	G	A	2	2	4	0	0	4	0	0
8	36803717	.	G	A	0	5	5	0	1	6	0	0
8	36803850	.	T	C	1	1	2	0	0	2	0	0
8	36951346	.	C	T	8	7	15	0	0	15	0	0
8	36951481	.	C	T	6	13	19	0	0	19	0	0
8	36951610	.	T	C	6	5	11	0	1	12	0	0
8	36952015	.	A	G	9	0	9	0	25	34	0	0
8	36953884	.	A	G	2	2	4	0	0	4	0	0
8	36953947	.	C	T	3	8	11	0	0	11	0	0
8	36953950	.	G	C	3	8	11	0	0	11	0	0
8	36956254	.	C	T	12	16	28	0	1	29	0	0
8	36956269	.	T	C	11	14	25	0	0	25	0	0
8	36959694	.	C	T	6	4	10	0	0	10	0	0
8	36959915	.	T	A	3	1	4	0	0	4	0	0
8	36961895	.	C	A	11	13	24	0	0	24	0	0
8	36964126	.	G	A	15	12	27	0	1	28	0	0
8	36974328	.	C	T	17	17	34	0	2	36	0	0
8	36974514	.	C	T	27	26	53	0	1	54	0	0
8	36975826	.	A	G	7	18	25	0	0	25	0	0
8	36975928	.	T	C	15	10	25	0	2	27	0	0
8	36976089	.	T	C	13	9	22	0	1	23	0	0
8	36976200	.	A	G	3	0	3	0	2	5	0	0
8	36976247	.	A	C	3	1	4	0	0	4	0	0
8	36976255	.	T	G	1	3	4	0	1	5	0	0
8	36976288	.	T	A	4	5	9	0	0	9	0	0
8	36976319	.	T	A	3	6	9	0	0	9	0	0
8	36976352	.	G	T	0	9	9	0	6	15	0	0
8	36976388	.	A	T	13	8	21	0	2	23	0	0
8	36976432	.	T	A	13	13	26	0	0	26	0	0
8	36976557	.	G	A	16	20	36	0	0	36	0	0
8	36976836	.	C	A	17	16	33	0	0	33	0	0
8	36977178	.	A	G	20	24	44	0	0	44	0	0
8	36977199	.	C	A	21	22	43	0	1	44	0	0
8	36977520	.	G	A	15	19	34	0	1	35	0	0
8	36977848	.	T	C	7	15	22	0	0	22	0	0
8	36983676	.	A	T	6	4	10	0	0	10	0	0
8	37009674	.	C	G	6	0	6	0	4	10	0	0
8	37010662	.	T	C	5	0	5	0	2	7	0	0
8	37012762	.	T	A	6	5	11	0	0	11	0	0
8	37012825	.	C	T	3	5	8	0	0	8	0	0
8	37012872	.	C	G	1	1	2	0	0	2	0	0
8	37013093	.	A	G	5	7	12	0	2	14	0	0
8	37013255	.	T	C	8	3	11	0	0	11	0	0
8	37013282	.	T	C	7	5	12	0	0	12	0	0
8	37016584	.	G	T	1	13	14	0	13	27	0	0
8	37016616	.	C	T	6	16	22	0	1	23	0	0
8	37016638	.	A	G	6	17	23	0	0	23	0	0
8	37016784	.	G	A	1	6	7	0	13	20	0	0
8	37016790	.	T	C	11	7	18	0	1	19	0	0
8	37017149	.	G	A	2	5	7	0	1	8	0	0
8	37017159	.	C	T	2	5	7	0	0	7	0	0
8	37019048	.	G	A	10	12	22	0	1	23	0	0
8	37019062	.	C	A	16	14	30	0	1	31	0	0
8	37025576	.	A	T	14	12	26	0	1	27	0	0
8	37025614	.	T	A	7	5	12	0	0	12	0	0
8	37025633	.	A	G	2	0	2	0	3	5	0	0
8	37025896	.	T	C	11	10	21	0	2	23	0	0
8	37026130	.	G	A	13	15	28	0	2	30	0	0
8	37031447	.	T	A	1	2	3	0	0	3	0	0
8	37038872	.	C	G	0	1	1	0	0	1	0	0
8	37059976	.	A	G	0	4	4	0	0	4	0	0
8	37060595	.	A	C	7	14	21	0	0	21	0	0
8	37060640	.	A	G	4	9	13	0	1	14	0	0
8	37068600	.	T	G	1	1	2	0	1	3	0	0
8	37075536	.	A	G	3	2	5	0	0	5	0	0
8	37086959	.	C	T	1	0	1	0	0	1	0	0
8	37101346	.	T	C	1	2	3	0	0	3	0	0
8	37229393	.	G	A	1	2	3	0	0	3	0	0
8	37229473	.	G	A	1	3	4	0	0	4	0	0
8	37232122	.	C	T	0	12	12	0	9	21	0	0
8	37232189	.	A	C	11	0	11	0	11	22	0	0
8	37232442	.	A	C	13	0	13	0	16	29	0	0
8	37232487	.	A	C	17	18	35	0	1	36	0	0
8	37239141	.	C	T	0	6	6	0	7	13	0	0
8	37241078	.	A	G	3	2	5	0	0	5	0	0
8	37280726	.	C	T	9	10	19	0	2	21	0	0
8	37280858	.	C	T	11	9	20	0	1	21	0	0
8	37281109	.	T	C	4	31	35	0	1	36	0	0
8	37282486	.	A	C	18	12	30	0	1	31	0	0
8	37282487	.	G	T	18	13	31	0	0	31	0	0
8	37282610	.	G	A	23	11	34	0	0	34	0	0
8	37282752	.	C	T	17	17	34	0	0	34	0	0
8	37282866	.	T	G	11	19	30	0	0	30	0	0
8	37282950	.	T	G	7	9	16	0	0	16	0	0
8	37282976	.	G	A	5	8	13	0	1	14	0	0
8	37283177	.	T	A	2	2	4	0	0	4	0	0
8	37283536	.	G	A	7	6	13	0	1	14	0	0
8	37283836	.	A	G	4	3	7	0	2	9	0	0
8	37284046	.	T	C	1	0	1	0	6	7	0	0
8	37294918	.	C	T	0	16	16	0	10	26	0	0
8	37294923	.	G	A	7	15	22	0	4	26	0	0
8	37297524	.	C	T	0	3	3	0	1	4	0	0
8	37303891	.	G	A	3	2	5	0	0	5	0	0
8	37311888	.	T	A	2	2	4	0	0	4	0	0
8	37317224	.	G	A	0	1	1	0	0	1	0	0
8	37317290	.	G	T	1	1	2	0	2	4	0	0
8	37447696	.	C	T	3	4	7	0	0	7	0	0
8	37453403	.	A	G	3	5	8	0	0	8	0	0
8	37453683	.	G	A	3	1	4	0	0	4	0	0
8	37456522	.	A	T	0	1	1	0	0	1	0	0
8	37456826	.	C	A	1	5	6	0	1	7	0	0
8	37460919	.	G	A	1	3	4	0	0	4	0	0
8	37461780	.	A	G	2	2	4	0	0	4	0	0
8	39703584	.	T	C	4	2	6	0	0	6	0	0
8	39816893	.	G	A	1	4	5	0	0	5	0	0
8	39819518	.	T	A	1	3	4	0	0	4	0	0
8	39822643	.	T	C	1	0	1	0	5	6	0	0
8	39848745	.	G	C	8	4	12	0	1	13	0	0
8	39848967	.	A	T	1	7	8	0	1	9	0	0
8	39849078	.	T	C	5	2	7	0	0	7	0	0
8	39849422	.	T	G	8	2	10	0	1	11	0	0
8	39849466	.	A	C	4	4	8	0	0	8	0	0
8	39849524	.	C	T	8	9	17	0	0	17	0	0
8	39849617	.	A	G	6	7	13	0	0	13	0	0
8	39849728	.	A	T	7	6	13	0	0	13	0	0
8	39849767	.	A	T	5	6	11	0	0	11	0	0
8	39849791	.	A	G	6	3	9	0	0	9	0	0
8	39849847	.	C	A	8	3	11	0	1	12	0	0
8	39850031	.	C	A	5	5	10	0	0	10	0	0
8	39850149	.	C	T	7	13	20	0	1	21	0	0
8	39850157	.	A	G	7	13	20	0	0	20	0	0
8	39850455	.	G	A	8	4	12	0	0	12	0	0
8	39850475	.	C	T	7	3	10	0	0	10	0	0
8	39850500	.	C	G	5	4	9	0	0	9	0	0
8	39850625	.	T	A	6	5	11	0	0	11	0	0
8	39850759	.	C	T	1	3	4	0	0	4	0	0
8	39851386	.	A	G	7	5	12	0	0	12	0	0
8	39851514	.	A	G	2	2	4	0	0	4	0	0
8	39852036	.	G	T	4	3	7	0	0	7	0	0
8	39852514	.	C	T	3	6	9	0	0	9	0	0
8	39858164	.	T	C	1	1	2	0	1	3	0	0
8	39859520	.	T	C	2	0	2	0	4	6	0	0
8	39870752	.	G	T	1	3	4	0	0	4	0	0
8	39870765	.	C	T	0	2	2	0	2	4	0	0
8	39870975	.	C	T	4	6	10	0	0	10	0	0
8	39876339	.	G	A	6	2	8	0	0	8	0	0
8	39901781	.	A	G	1	2	3	0	0	3	0	0
8	40081408	.	G	C	4	10	14	0	0	14	0	0
8	40081462	.	T	G	7	11	18	0	0	18	0	0
8	40081718	.	T	C	8	4	12	0	1	13	0	0
8	40218288	.	C	T	4	7	11	0	0	11	0	0
8	40218290	.	C	T	4	7	11	0	0	11	0	0
8	40234640	.	C	T	5	7	12	0	0	12	0	0
8	40234830	.	A	G	1	2	3	0	0	3	0	0
8	40234831	.	T	A	1	1	2	0	1	3	0	0
8	40235244	.	C	T	3	7	10	0	0	10	0	0
8	40235281	.	G	A	1	5	6	0	0	6	0	0
8	40235348	.	G	C	3	3	6	0	0	6	0	0
8	40236448	.	C	A	4	3	7	0	2	9	0	0
8	40236453	.	A	T	4	4	8	0	0	8	0	0
8	40237906	.	C	T	3	8	11	0	0	11	0	0
8	40240922	.	C	G	14	9	23	0	0	24	1	0
8	40241441	.	A	G	10	19	29	6	0	35	0	0
8	40241446	.	A	G	9	19	28	6	1	35	0	0
8	40241640	.	A	T	13	12	25	3	1	29	0	0
8	40241681	.	A	G	20	15	35	1	1	37	0	0
8	40241695	.	T	A	13	10	23	1	2	26	0	0
8	40241718	.	T	C	11	7	18	2	0	20	0	0
8	40242103	.	G	A	24	16	40	0	0	40	0	0
8	40242453	.	G	A	12	12	24	0	1	25	0	0
8	40242613	.	T	A	7	9	16	0	0	16	0	0
8	40242653	.	C	T	8	6	14	0	0	14	0	0
8	40243052	.	G	C	15	20	35	0	1	36	0	0
8	40243148	.	T	C	20	6	26	0	2	28	0	0
8	40248373	.	T	G	10	6	16	0	1	17	0	0
8	40248673	.	T	C	1	1	2	0	2	4	0	0
8	40248976	.	G	T	3	0	3	0	1	4	0	0
8	40251444	.	T	G	8	12	20	0	2	22	0	0
8	40251834	.	C	A	9	6	15	0	1	16	0	0
8	40252508	.	C	T	0	2	2	0	6	8	0	0
8	40254366	.	A	G	4	12	16	0	0	16	0	0
8	40254375	.	T	G	5	11	16	0	0	16	0	0
8	40270856	.	G	A	4	4	8	0	0	8	0	0
8	40325709	.	G	T	11	6	17	0	0	17	0	0
8	40326039	.	A	G	21	12	33	0	0	33	0	0
8	40326128	.	C	T	16	15	31	0	2	33	0	0
8	40326736	.	A	G	1	5	6	0	3	9	0	0
8	40427500	.	T	C	9	4	13	0	0	13	0	0
8	40427737	.	T	A	3	2	5	0	0	5	0	0
8	40429498	.	T	C	2	2	4	0	0	4	0	0
8	40430038	.	C	A	1	5	6	0	0	6	0	0
8	40430771	.	A	G	2	2	4	0	0	4	0	0
8	40430799	.	G	T	1	2	3	0	0	3	0	0
8	40430902	.	T	A	2	2	4	0	0	4	0	0
8	40631823	.	C	T	5	4	9	0	0	9	0	0
8	40632014	.	T	C	8	9	17	0	1	18	0	0
8	40632065	.	T	C	5	8	13	0	0	13	0	0
8	40632411	.	A	T	7	6	13	0	1	14	0	0
8	40632534	.	G	A	11	17	28	0	0	28	0	0
8	40644876	.	T	G	4	8	12	0	0	12	0	0
8	40645165	.	C	T	3	2	5	0	0	5	0	0
8	40646154	.	C	T	7	7	14	0	0	14	0	0
8	41462497	.	A	G	2	0	2	0	14	16	0	0
8	42075668	.	A	T	2	3	5	0	0	5	0	0
8	42075701	.	A	G	1	1	2	0	0	2	0	0
8	42138863	.	C	T	5	1	6	0	3	9	0	0
8	42139010	.	G	A	6	5	11	0	0	11	0	0
8	42610437	.	T	A	0	3	3	0	0	3	0	0
8	42610518	.	C	T	1	0	1	0	0	1	0	0
8	42642058	.	A	T	8	8	16	0	0	16	0	0
8	42642120	.	C	A	0	9	9	0	8	17	0	0
8	42642139	.	T	C	6	11	17	0	0	17	0	0
8	42642235	.	A	G	14	7	21	0	1	23	1	0
8	42642683	.	G	A	5	7	12	0	0	12	0	0
8	42642879	.	G	A	7	5	12	0	0	12	0	0
8	42642941	.	G	T	5	6	11	0	1	12	0	0
8	42655774	.	G	T	1	1	2	0	0	2	0	0
8	42676804	.	A	C	0	0	0	0	1	1	0	0
8	42676918	.	G	A	2	3	5	0	0	5	0	0
8	42688733	.	T	C	4	2	6	0	2	8	0	0
8	42688884	.	C	G	2	2	4	0	0	4	0	0
8	42689252	.	G	A	4	4	8	0	0	8	0	0
8	42689483	.	A	T	3	2	5	0	0	5	0	0
8	42689492	.	G	A	3	2	5	0	0	5	0	0
8	42689764	.	G	T	1	2	3	0	0	3	0	0
8	42689805	.	T	C	2	3	5	0	0	5	0	0
8	42689922	.	A	T	2	4	6	0	0	6	0	0
8	42689924	.	C	T	2	4	6	0	0	6	0	0
8	42689992	.	G	T	3	2	5	0	1	6	0	0
8	42690067	.	T	A	5	3	8	0	1	9	0	0
8	42690390	.	T	A	1	3	4	0	0	4	0	0
8	43379779	.	T	C	20	25	45	0	1	46	0	0
8	43380067	.	G	A	22	15	37	0	2	39	0	0
8	43380290	.	A	T	16	14	30	0	0	30	0	0
8	43380543	.	T	G	8	21	29	0	3	32	0	0
8	43380781	.	C	T	0	12	12	0	12	24	0	0
8	43380905	.	A	T	11	20	31	0	2	33	0	0
8	43380923	.	C	T	0	18	18	0	13	31	0	0
8	43381239	.	A	T	14	11	25	0	0	25	0	0
8	43381306	.	A	T	16	18	34	0	2	36	0	0
8	43381417	.	T	G	9	12	21	1	1	23	0	0
8	43381500	.	A	G	9	6	15	0	1	16	0	0
8	43381664	.	A	T	10	7	17	0	0	17	0	0
8	43382046	.	A	T	16	18	34	0	3	37	0	0
8	43386194	.	G	A	12	7	19	0	3	22	0	0
8	43386677	.	T	A	10	7	17	0	1	18	0	0
8	43393575	.	C	A	0	8	8	0	9	17	0	0
8	43400484	.	A	G	0	2	2	0	0	2	0	0
8	43400820	.	G	A	7	6	13	0	0	13	0	0
8	43400880	.	G	A	7	5	12	0	1	13	0	0
8	43401134	.	A	G	1	1	2	0	0	2	0	0
8	43401161	.	T	C	1	0	1	0	2	3	0	0
8	43401423	.	G	A	1	0	1	0	0	1	0	0
8	43413787	.	C	T	0	2	2	0	3	5	0	0
8	43419175	.	C	T	0	1	1	0	2	3	0	0
8	43419763	.	A	C	3	4	7	0	0	7	0	0
8	43424205	.	C	T	2	2	4	0	0	4	0	0
8	43486712	.	T	C	1	2	3	0	0	3	0	0
8	43668521	.	A	G	14	9	23	0	2	25	0	0
8	43668716	.	T	G	22	16	38	0	3	41	0	0
8	43671871	.	C	T	7	5	12	0	0	12	0	0
8	43675370	.	G	A	8	4	12	0	0	12	0	0
8	43675698	.	T	A	9	4	13	0	0	13	0	0
8	43677718	.	T	C	7	2	9	0	0	9	0	0
8	43677736	.	A	C	3	2	5	0	1	6	0	0
8	43680438	.	A	G	3	4	7	0	2	9	0	0
8	43680469	.	T	G	4	9	13	0	2	15	0	0
8	43680500	.	T	C	2	6	8	0	1	9	0	0
8	43680510	.	A	G	4	4	8	0	1	9	0	0
8	43682544	.	A	G	5	1	6	0	0	6	0	0
8	43683133	.	G	A	3	4	7	0	0	7	0	0
8	43691854	.	G	T	3	0	3	0	0	3	0	0
8	43693392	.	A	G	1	1	2	0	0	2	0	0
8	43700901	.	T	A	3	2	5	0	0	5	0	0
8	43700951	.	G	T	3	2	5	0	0	5	0	0
8	43701731	.	A	G	3	3	6	0	0	6	0	0
8	43703664	.	G	A	0	2	2	0	0	2	0	0
8	43711819	.	G	T	1	2	3	0	0	3	0	0
8	43736354	.	G	T	1	3	4	0	0	4	0	0
8	43736430	.	G	A	1	1	2	0	0	2	0	0
8	43934966	.	G	A	8	3	11	0	0	11	0	0
8	43935120	.	A	G	20	17	37	0	2	39	0	0
8	43935351	.	A	T	2	5	7	0	0	7	0	0
8	43935481	.	C	T	9	14	23	0	2	25	0	0
8	43935552	.	A	G	8	19	27	0	1	28	0	0
8	43935731	.	C	T	6	2	8	0	0	8	0	0
8	43935879	.	C	G	10	11	21	0	0	21	0	0
8	43940148	.	C	A	4	2	6	0	0	6	0	0
8	43960570	.	T	C	0	2	2	0	0	2	0	0
8	43974538	.	T	A	5	6	11	0	1	12	0	0
8	43991452	.	G	C	1	2	3	0	1	4	0	0
8	44211479	.	C	A	0	2	2	0	0	2	0	0
8	44211831	.	G	A	2	4	6	0	0	6	0	0
8	44213729	.	C	T	1	3	4	0	0	4	0	0
8	44223458	.	T	C	0	0	0	0	1	1	0	0
8	44296292	.	C	T	0	5	5	0	1	6	0	0
8	44296595	.	A	C	3	0	3	0	8	11	0	0
8	44296672	.	G	A	8	8	16	0	0	16	0	0
8	44296985	.	G	A	1	4	5	0	0	5	0	0
8	44297411	.	T	C	3	3	6	0	0	6	0	0
8	44297555	.	A	G	2	2	4	0	0	4	0	0
8	44298814	.	G	T	3	2	5	0	0	5	0	0
8	44599938	.	C	T	4	3	7	0	0	7	0	0
8	44602132	.	G	A	3	3	6	0	0	6	0	0
8	44602264	.	A	G	9	7	16	0	0	16	0	0
8	44602353	.	G	C	1	0	1	0	0	1	0	0
8	44602357	.	T	C	1	0	1	0	0	1	0	0
8	44604588	.	C	T	0	2	2	0	4	6	0	0
8	44617902	.	G	A	3	6	9	0	0	9	0	0
8	44617903	.	A	T	3	5	8	0	1	9	0	0
8	44618024	.	C	T	4	6	10	0	0	10	0	0
8	44618065	.	G	A	1	2	3	0	2	5	0	0
8	44669550	.	T	C	3	0	3	0	0	3	0	0
8	44671767	.	T	C	1	0	1	0	0	1	0	0
8	44677544	.	C	T	8	6	14	0	1	15	0	0
8	44677613	.	T	C	6	4	10	0	0	10	0	0
8	44694956	.	G	A	0	0	0	0	1	1	0	0
8	44695043	.	A	C	8	8	16	0	0	16	0	0
8	44695140	.	A	C	9	4	13	0	1	14	0	0
8	44695230	.	A	T	11	9	20	0	0	20	0	0
8	44730536	.	G	A	0	1	1	0	0	1	0	0
8	44737646	.	C	A	0	1	1	0	0	1	0	0
8	44894337	.	G	T	5	4	9	0	1	10	0	0
8	44894575	.	T	A	5	5	10	0	0	10	0	0
8	44894604	.	C	T	6	12	18	0	0	18	0	0
8	44894631	.	G	C	4	9	13	0	2	15	0	0
8	44897853	.	C	A	0	1	1	0	1	2	0	0
8	44921272	.	C	A	4	2	6	0	0	6	0	0
8	44921821	.	A	G	0	2	2	0	0	2	0	0
8	44923622	.	T	G	0	1	1	0	0	1	0	0
8	44959583	.	C	T	3	0	3	0	0	3	0	0
8	44959589	.	A	G	3	0	3	0	0	3	0	0
8	44975939	.	G	C	4	4	8	0	0	8	0	0
8	44976047	.	G	T	3	4	7	0	0	7	0	0
8	44976120	.	G	A	1	2	3	0	0	3	0	0
8	44976144	.	G	A	1	3	4	0	1	5	0	0
8	44976155	.	A	G	2	3	5	0	0	5	0	0
8	44976197	.	T	C	2	2	4	0	0	4	0	0
8	45036821	.	A	G	1	4	5	0	0	5	0	0
8	45298603	.	G	A	3	5	8	0	0	8	0	0
8	45298943	.	G	C	3	3	6	0	1	7	0	0
8	45308963	.	A	C	8	12	20	0	3	23	0	0
8	45311761	.	T	G	13	8	21	0	0	21	0	0
8	45312231	.	G	C	2	9	11	0	11	22	0	0
8	45312285	.	C	A	3	2	5	0	0	5	0	0
8	45313023	.	A	C	6	12	18	0	1	19	0	0
8	45315444	.	T	C	7	7	14	0	0	14	0	0
8	45317898	.	A	T	4	3	7	0	0	7	0	0
8	45317976	.	G	A	1	3	4	0	14	18	0	0
8	45319659	.	A	G	0	1	1	0	1	2	0	0
8	45325269	.	G	C	11	16	27	0	2	29	0	0
8	45328278	.	T	A	9	12	21	0	1	22	0	0
8	45361816	.	A	G	7	10	17	0	0	17	0	0
8	45365789	.	T	C	11	10	21	0	1	22	0	0
8	45374151	.	A	T	13	14	27	0	3	30	0	0
8	45374477	.	A	G	11	12	23	0	0	23	0	0
8	45374665	.	T	A	18	12	30	0	0	30	0	0
8	45374828	.	A	C	9	8	17	0	6	24	1	0
8	45374884	.	T	G	13	14	27	0	0	27	0	0
8	45374966	.	G	T	7	6	13	0	0	13	0	0
8	45374970	.	A	G	7	6	13	0	0	13	0	0
8	45381427	.	T	A	2	2	4	0	0	4	0	0
8	45384366	.	C	T	2	1	3	0	0	3	0	0
8	45384375	.	C	T	3	1	4	0	0	4	0	0
8	45395114	.	T	A	8	7	15	0	2	17	0	0
8	45395127	.	C	T	4	7	11	0	1	12	0	0
8	45395234	.	T	G	0	3	3	0	0	3	0	0
8	45395245	.	C	T	0	2	2	0	1	3	0	0
8	45395318	.	A	G	2	2	4	0	0	5	1	0
8	45395357	.	C	T	1	6	7	0	0	7	0	0
8	45395452	.	T	G	1	4	5	0	0	5	0	0
8	45395463	.	A	C	1	3	4	0	0	4	0	0
8	45396028	.	T	C	7	2	9	0	1	10	0	0
8	45427189	.	C	A	2	3	5	0	0	5	0	0
8	45428039	.	C	T	13	18	31	0	0	31	0	0
8	45430757	.	G	A	6	2	8	0	2	10	0	0
8	45755078	.	A	G	3	5	8	0	2	10	0	0
8	45755502	.	C	T	4	3	7	0	0	7	0	0
8	45755732	.	C	T	22	28	50	0	4	55	1	0
8	45755973	.	C	G	11	23	34	0	5	39	0	0
8	45759960	.	C	T	15	7	22	0	1	23	0	0
8	45760071	.	A	C	10	0	10	0	5	15	0	0
8	45763350	.	C	T	2	3	5	0	0	5	0	0
8	45763374	.	T	C	2	2	4	0	0	4	0	0
8	45763401	.	G	A	1	2	3	0	0	3	0	0
8	45763537	.	A	T	8	9	17	0	2	19	0	0
8	45763562	.	G	A	15	12	27	0	3	30	0	0
8	45763670	.	C	T	19	18	37	0	0	37	0	0
8	45763872	.	T	A	18	11	29	0	2	31	0	0
8	45763991	.	A	G	13	14	27	0	1	28	0	0
8	45764006	.	G	C	19	14	33	0	3	36	0	0
8	45764569	.	T	C	4	6	10	0	0	10	0	0
8	45764665	.	G	C	16	2	18	0	10	28	0	0
8	45765170	.	C	T	2	10	12	0	10	22	0	0
8	45765188	.	A	T	2	6	8	0	1	9	0	0
8	45765326	.	G	A	14	16	30	0	0	30	0	0
8	45772961	.	G	C	12	15	27	0	0	27	0	0
8	45774471	.	C	T	0	1	1	0	1	2	0	0
8	45775089	.	C	T	7	5	12	0	0	12	0	0
8	45779729	.	A	C	7	9	16	0	1	17	0	0
8	45786186	.	C	T	0	2	2	0	1	3	0	0
8	45786612	.	G	T	7	3	10	0	0	10	0	0
8	45786615	.	A	G	7	3	10	0	0	10	0	0
8	45787137	.	A	G	6	8	14	0	0	14	0	0
8	45788941	.	T	G	2	7	9	0	0	9	0	0
8	45789130	.	T	C	2	1	3	0	0	3	0	0
8	45793550	.	A	C	4	3	7	0	0	7	0	0
8	45797305	.	G	A	0	1	1	0	0	1	0	0
8	45834940	.	G	A	4	3	7	0	0	7	0	0
8	45838228	.	C	T	2	0	2	0	0	2	0	0
8	45852874	.	C	A	4	4	8	0	0	8	0	0
8	45853475	.	G	A	2	5	7	0	0	7	0	0
8	45853626	.	G	A	2	10	12	0	0	12	0	0
8	45880125	.	G	A	3	2	5	0	0	5	0	0
8	45907117	.	C	T	1	0	1	0	0	1	0	0
8	45944896	.	T	A	4	5	9	0	1	10	0	0
8	45944983	.	G	A	5	4	9	0	0	9	0	0
8	45948718	.	G	A	7	4	11	0	1	12	0	0
8	45952072	.	C	G	5	4	9	0	0	9	0	0
8	45952152	.	A	T	2	4	6	0	0	6	0	0
8	45952231	.	T	C	5	3	8	0	0	8	0	0
8	45952423	.	A	G	8	5	13	0	1	14	0	0
8	45952500	.	A	G	5	0	5	0	4	9	0	0
8	45961935	.	A	G	3	3	6	0	0	6	0	0
8	45961976	.	T	A	3	4	7	0	0	7	0	0
8	45962391	.	G	C	2	3	5	0	0	5	0	0
8	45962432	.	G	T	1	4	5	0	0	5	0	0
8	46011055	.	T	A	1	3	4	0	0	4	0	0
8	46011169	.	C	T	0	2	2	0	0	2	0	0
8	46025145	.	G	A	1	2	3	0	0	3	0	0
8	46077617	.	T	G	2	2	4	0	0	4	0	0
8	46077675	.	A	G	7	4	11	0	0	11	0	0
8	46077879	.	C	A	10	6	16	0	0	16	0	0
8	46078264	.	A	T	8	11	19	0	0	19	0	0
8	46078287	.	A	G	8	8	16	0	2	18	0	0
8	46078309	.	C	T	9	9	18	0	1	19	0	0
8	46078342	.	C	G	12	7	19	0	0	19	0	0
8	46085480	.	A	T	7	4	11	0	0	11	0	0
8	46089037	.	G	T	0	1	1	0	1	2	0	0
8	46089052	.	T	C	1	1	2	0	0	2	0	0
8	46089634	.	C	T	14	8	22	0	1	23	0	0
8	46094790	.	G	A	0	1	1	0	0	1	0	0
8	46123731	.	G	A	1	1	2	0	0	2	0	0
8	46132662	.	G	C	1	0	1	0	1	2	0	0
8	46160980	.	C	T	0	0	0	0	2	2	0	0
8	46188003	.	A	G	1	3	4	0	1	5	0	0
8	46188018	.	A	G	1	4	5	0	0	5	0	0
8	46220963	.	A	G	1	0	1	0	6	7	0	0
8	46231128	.	A	G	1	5	6	0	0	6	0	0
8	46247717	.	T	C	3	2	5	0	0	5	0	0
8	46258216	.	A	G	1	2	3	0	0	3	0	0
8	46306002	.	G	A	1	2	3	0	0	3	0	0
8	46340777	.	A	G	1	0	1	0	0	1	0	0
8	46347356	.	A	G	3	1	4	0	2	6	0	0
8	46347412	.	C	G	1	0	1	0	1	2	0	0
8	46347894	.	A	G	5	3	8	0	1	9	0	0
8	46348121	.	G	A	0	4	4	0	6	10	0	0
8	46348178	.	A	G	2	6	8	0	0	8	0	0
8	46348391	.	T	A	3	3	6	0	2	8	0	0
8	46353290	.	G	C	3	2	5	0	1	6	0	0
8	46362082	.	G	A	1	2	3	0	0	3	0	0
8	46362083	.	G	T	1	2	3	0	0	3	0	0
8	49310928	.	T	C	3	6	9	0	0	9	0	0
8	49404093	.	A	T	16	2	18	0	0	18	0	0
8	49447428	.	A	G	2	2	4	0	0	4	0	0
8	49478374	.	G	A	1	3	4	0	0	4	0	0
8	49706428	.	T	C	3	4	7	0	0	7	0	0
8	49722313	.	T	C	4	10	14	0	0	14	0	0
8	49728659	.	T	A	1	0	1	0	0	1	0	0
8	49745727	.	T	G	2	4	6	0	1	7	0	0
8	49746187	.	G	A	7	4	11	0	9	20	0	0
8	49746224	.	T	C	10	9	19	0	0	19	0	0
8	49746256	.	G	A	11	13	24	0	0	24	0	0
8	49746440	.	T	C	20	29	49	0	2	51	0	0
8	49746456	.	T	G	19	21	40	0	0	40	0	0
8	49755801	.	A	C	16	18	34	0	2	36	0	0
8	49755867	.	A	T	25	17	42	0	1	43	0	0
8	49756121	.	A	T	11	9	20	0	0	20	0	0
8	49759453	.	A	G	1	0	1	0	0	1	0	0
8	49769496	.	G	A	6	2	8	0	0	8	0	0
8	49778672	.	T	G	4	3	7	0	0	7	0	0
8	49845392	.	A	G	5	6	11	0	0	11	0	0
8	49850230	.	C	T	2	1	3	0	0	3	0	0
8	49851155	.	C	G	3	2	5	0	0	5	0	0
8	49860718	.	C	T	4	5	9	0	1	10	0	0
8	49864103	.	T	C	3	3	6	0	0	6	0	0
8	49864124	.	G	A	9	8	17	0	0	17	0	0
8	49864212	.	C	T	6	4	10	0	0	10	0	0
8	49864232	.	G	A	6	7	13	0	0	13	0	0
8	49864402	.	C	T	10	6	16	0	0	16	0	0
8	49864655	.	G	T	7	9	16	0	1	17	0	0
8	49864892	.	G	T	1	8	9	0	0	9	0	0
8	49865070	.	G	A	1	3	4	0	0	4	0	0
8	49865099	.	T	G	1	4	5	0	1	6	0	0
8	49865124	.	C	T	3	5	8	0	1	9	0	0
8	49899474	.	G	A	4	0	4	0	1	5	0	0
8	49899528	.	G	A	3	8	11	0	1	12	0	0
8	49899621	.	G	A	0	1	1	0	0	1	0	0
8	49901127	.	T	C	0	0	0	0	4	4	0	0
8	49908789	.	G	T	3	6	9	0	1	10	0	0
8	49908792	.	G	A	7	3	10	0	0	10	0	0
8	49911143	.	G	A	0	1	1	0	1	2	0	0
8	49925662	.	G	T	1	2	3	0	0	3	0	0
8	49947477	.	T	C	0	2	2	0	1	3	0	0
8	49952260	.	C	T	5	1	6	0	0	6	0	0
8	49969037	.	C	T	5	4	9	0	0	9	0	0
8	49969135	.	G	C	0	2	2	0	1	3	0	0
8	50012607	.	G	A	0	4	4	0	0	4	0	0
8	50151789	.	G	A	1	1	2	0	0	2	0	0
8	50156805	.	G	A	2	4	6	0	0	6	0	0
8	50159305	.	C	T	2	4	6	0	0	6	0	0
8	50159515	.	A	G	1	3	4	0	0	4	0	0
8	50163398	.	A	G	3	0	3	0	8	11	0	0
8	50170889	.	T	C	1	2	3	0	1	4	0	0
8	50179868	.	T	A	3	4	7	0	0	7	0	0
8	50179944	.	T	G	7	5	12	0	0	12	0	0
8	50501462	.	C	T	2	2	4	0	0	4	0	0
8	50520253	.	G	T	2	2	4	0	0	4	0	0
8	50812321	.	G	A	2	3	5	0	1	6	0	0
8	50818102	.	G	T	3	3	6	0	0	6	0	0
8	50818180	.	C	T	2	3	5	0	0	5	0	0
8	50835330	.	C	G	2	3	5	0	0	5	0	0
8	50837684	.	G	C	2	4	6	0	0	6	0	0
8	50837731	.	A	G	2	2	4	0	0	4	0	0
8	50845104	.	T	C	2	2	4	0	0	4	0	0
8	50851915	.	A	T	0	0	0	0	1	1	0	0
8	50890422	.	A	T	0	1	1	0	1	2	0	0
8	50942296	.	T	G	13	4	17	0	0	17	0	0
8	50947386	.	G	C	4	7	11	0	1	12	0	0
8	50947648	.	T	A	15	21	36	0	0	36	0	0
8	50949040	.	T	A	15	18	33	0	0	33	0	0
8	50949086	.	T	A	3	14	17	0	1	18	0	0
8	50949128	.	T	C	8	8	16	0	0	16	0	0
8	50949160	.	A	T	13	18	31	0	0	31	0	0
8	50949188	.	C	T	16	21	37	0	0	37	0	0
8	50949430	.	T	A	32	12	44	0	3	47	0	0
8	50949479	.	A	G	23	32	55	0	2	57	0	0
8	50949501	.	A	T	31	29	60	0	0	60	0	0
8	50949570	.	G	A	23	25	48	0	0	48	0	0
8	50949573	.	G	A	25	22	47	0	0	47	0	0
8	50949639	.	C	T	22	16	38	0	2	40	0	0
8	50949766	.	C	T	8	7	15	0	0	15	0	0
8	50949903	.	A	G	30	1	31	0	16	47	0	0
8	50960443	.	C	A	13	9	22	0	1	23	0	0
8	50960542	.	T	C	8	4	12	0	3	15	0	0
8	50962536	.	T	C	1	3	4	0	0	4	0	0
8	50962623	.	T	G	15	0	15	0	18	33	0	0
8	50967774	.	C	G	6	9	15	0	0	15	0	0
8	50967890	.	C	T	7	9	16	0	3	19	0	0
8	50969141	.	T	C	5	5	10	0	1	11	0	0
8	50969150	.	A	G	6	5	11	0	1	12	0	0
8	50969367	.	G	A	4	3	7	0	2	9	0	0
8	50969493	.	T	A	8	4	12	0	0	12	0	0
8	50971524	.	G	A	4	5	9	0	0	9	0	0
8	50972267	.	C	T	0	6	6	0	1	7	0	0
8	50981034	.	A	G	1	2	3	0	0	3	0	0
8	51008419	.	T	C	3	4	7	0	0	7	0	0
8	51027069	.	C	T	1	2	3	0	0	3	0	0
8	51027111	.	T	G	2	3	5	0	1	6	0	0
8	51027123	.	C	A	3	2	5	0	0	5	0	0
8	51109346	.	T	G	1	0	1	0	2	3	0	0
8	51134917	.	A	T	0	2	2	0	0	2	0	0
8	51144662	.	T	C	1	0	1	0	0	1	0	0
8	51147570	.	A	G	1	6	7	0	1	8	0	0
8	51165572	.	T	C	7	6	13	0	0	13	0	0
8	51165786	.	C	A	0	9	9	0	12	21	0	0
8	51173843	.	A	G	7	4	11	0	1	12	0	0
8	51175677	.	G	A	3	2	5	0	0	5	0	0
8	51309145	.	T	G	10	8	18	0	0	18	0	0
8	51309311	.	A	G	1	6	7	0	0	7	0	0
8	51314087	.	G	A	10	6	16	0	0	16	0	0
8	51320547	.	C	T	0	6	6	0	1	7	0	0
8	51320652	.	C	T	4	1	5	0	1	6	0	0
8	51325510	.	T	G	5	5	10	0	1	11	0	0
8	51330776	.	T	C	1	3	4	0	0	4	0	0
8	51330836	.	A	T	3	3	6	0	0	6	0	0
8	51351121	.	C	T	19	6	25	0	1	26	0	0
8	51351155	.	T	A	16	3	19	0	1	20	0	0
8	51351200	.	A	T	10	8	18	0	1	19	0	0
8	51352480	.	A	G	8	14	22	0	0	22	0	0
8	51352525	.	A	T	1	1	2	0	0	2	0	0
8	51358769	.	G	A	1	2	3	0	0	3	0	0
8	51364515	.	T	C	9	5	14	0	0	14	0	0
8	51364644	.	C	A	0	7	7	0	14	21	0	0
8	51364665	.	T	C	11	6	17	0	0	17	0	0
8	51364696	.	C	G	4	3	7	0	0	7	0	0
8	51364713	.	C	A	0	1	1	0	1	2	0	0
8	51367178	.	A	T	3	1	4	0	0	4	0	0
8	51367206	.	C	T	8	1	9	0	0	9	0	0
8	51367267	.	A	T	6	4	10	0	1	11	0	0
8	51375405	.	T	G	8	9	17	0	2	19	0	0
8	51379699	.	G	A	2	2	4	0	0	4	0	0
8	51379741	.	A	T	1	0	1	0	0	1	0	0
8	51431396	.	C	T	0	3	3	0	9	12	0	0
8	51431733	.	T	C	3	2	5	0	1	6	0	0
8	51431741	.	T	C	0	6	6	0	0	6	0	0
8	51431879	.	C	T	3	5	8	0	0	8	0	0
8	51431908	.	C	T	2	3	5	0	0	5	0	0
8	51432181	.	A	C	1	2	3	0	0	3	0	0
8	51433511	.	T	G	2	4	6	0	0	6	0	0
8	51433512	.	G	T	2	4	6	0	0	6	0	0
8	51433680	.	G	A	3	2	5	0	0	5	0	0
8	51434384	.	C	T	0	3	3	0	3	6	0	0
8	51437284	.	G	A	1	1	2	0	0	2	0	0
8	51482050	.	A	G	0	2	2	0	0	2	0	0
8	51573130	.	T	C	4	4	8	0	0	8	0	0
8	51573166	.	G	A	3	2	5	0	0	5	0	0
8	51573167	.	C	T	3	2	5	0	0	5	0	0
8	51573439	.	T	C	1	0	1	0	0	1	0	0
8	51573441	.	T	C	1	0	1	0	0	1	0	0
8	51576856	.	C	T	0	1	1	0	3	4	0	0
8	51576887	.	C	T	1	2	3	0	3	6	0	0
8	51576907	.	C	T	0	4	4	0	3	7	0	0
8	51576997	.	T	G	0	1	1	0	0	1	0	0
8	51634935	.	T	C	2	0	2	0	3	5	0	0
8	51723249	.	A	G	4	3	7	3	0	10	0	0
8	51723285	.	G	A	0	14	14	4	2	20	0	0
8	51723320	.	A	G	0	11	11	2	1	14	0	0
8	51781307	.	G	T	2	6	8	0	1	9	0	0
8	51782044	.	A	G	7	5	12	0	0	12	0	0
8	51827243	.	C	T	1	2	3	0	0	3	0	0
8	51935561	.	A	G	4	3	7	0	0	7	0	0
8	51938097	.	T	G	0	1	1	0	1	2	0	0
8	51992393	.	C	A	2	7	9	0	1	10	0	0
8	51992501	.	G	T	10	9	19	0	0	19	0	0
8	51996707	.	A	G	5	9	14	0	0	14	0	0
8	51996727	.	A	G	4	6	10	0	0	10	0	0
8	52002903	.	C	T	1	6	7	0	11	18	0	0
8	52002945	.	T	A	2	3	5	0	0	5	0	0
8	52005582	.	A	C	5	7	12	0	0	12	0	0
8	52006139	.	C	T	0	1	1	0	1	2	0	0
8	52010799	.	T	C	1	1	2	0	0	2	0	0
8	52012737	.	T	A	1	4	5	0	0	5	0	0
8	52015712	.	G	T	6	1	7	0	0	7	0	0
8	52016041	.	G	A	3	5	8	0	0	8	0	0
8	52016101	.	T	C	3	2	5	0	1	6	0	0
8	52016128	.	G	A	2	2	4	0	0	4	0	0
8	52026501	.	G	A	1	5	6	0	0	6	0	0
8	52026702	.	C	A	2	5	7	0	0	7	0	0
8	52026780	.	C	T	2	1	3	0	0	3	0	0
8	52026786	.	G	A	2	1	3	0	0	3	0	0
8	52029849	.	T	C	2	2	4	0	0	4	0	0
8	52029852	.	G	A	2	3	5	0	0	5	0	0
8	52029909	.	G	A	5	3	8	0	0	8	0	0
8	52029924	.	G	A	5	3	8	0	0	8	0	0
8	52029978	.	C	T	0	6	6	0	2	8	0	0
8	52030185	.	G	A	0	1	1	0	0	1	0	0
8	52042293	.	C	G	0	4	4	0	1	5	0	0
8	52042891	.	T	C	2	3	5	0	0	5	0	0
8	52042893	.	G	A	2	3	5	0	0	5	0	0
8	52045585	.	C	T	1	3	4	0	0	4	0	0
8	52065100	.	A	C	2	0	2	0	1	3	0	0
8	52107898	.	T	G	1	3	4	0	0	4	0	0
8	52108329	.	T	C	1	5	6	0	2	8	0	0
8	52108512	.	T	A	3	2	5	0	1	6	0	0
8	52108533	.	G	A	2	2	4	0	0	4	0	0
8	52108970	.	G	A	4	2	6	0	0	6	0	0
8	52108980	.	C	T	0	2	2	0	4	6	0	0
8	52109133	.	T	C	1	2	3	0	0	3	0	0
8	52109499	.	T	A	4	2	6	0	1	7	0	0
8	52109581	.	A	G	5	4	9	0	0	9	0	0
8	52109686	.	T	G	5	10	15	0	1	16	0	0
8	52109730	.	T	G	4	9	13	0	1	14	0	0
8	52292515	.	T	C	1	0	1	0	0	1	0	0
8	52314637	.	G	T	0	5	5	0	4	9	0	0
8	52342586	.	A	C	2	4	6	0	0	6	0	0
8	52345733	.	T	C	0	3	3	0	0	3	0	0
8	52345751	.	T	C	3	6	9	0	1	10	0	0
8	52345915	.	T	C	5	8	13	0	1	14	0	0
8	52346072	.	A	T	1	5	6	0	0	6	0	0
8	52346111	.	A	C	1	4	5	0	0	5	0	0
8	52346225	.	A	T	1	5	6	0	1	7	0	0
8	52346454	.	T	C	5	6	11	0	0	11	0	0
8	52347460	.	C	T	7	7	14	0	1	15	0	0
8	52348685	.	T	C	15	6	21	0	0	21	0	0
8	52349080	.	T	G	4	6	10	0	0	10	0	0
8	52349607	.	A	G	4	27	31	0	0	31	0	0
8	52350101	.	A	G	12	0	12	0	9	22	1	0
8	52350146	.	A	G	15	0	15	0	12	27	0	0
8	52350251	.	A	G	13	12	25	0	1	26	0	0
8	52350322	.	T	G	4	6	10	0	0	10	0	0
8	52408619	.	G	A	23	21	44	0	1	45	0	0
8	52411451	.	T	C	7	5	12	0	0	12	0	0
8	52412982	.	A	G	10	13	23	0	0	23	0	0
8	52412985	.	C	G	10	13	23	0	0	23	0	0
8	52455588	.	A	G	1	0	1	0	0	1	0	0
8	52455610	.	A	G	2	1	3	0	0	3	0	0
8	52472930	.	C	G	1	1	2	0	1	3	0	0
8	52472955	.	C	T	0	2	2	0	2	4	0	0
8	52491586	.	G	A	7	5	12	0	0	12	0	0
8	52509559	.	C	A	7	2	9	0	1	10	0	0
8	52509568	.	C	A	5	4	9	0	0	9	0	0
8	52509624	.	G	A	1	3	4	0	1	5	0	0
8	52509859	.	C	T	5	4	9	0	0	9	0	0
8	52510020	.	G	T	3	6	9	0	0	9	0	0
8	52521595	.	T	C	4	6	10	0	2	12	0	0
8	52524436	.	A	T	2	1	3	0	1	4	0	0
8	52528717	.	A	G	5	10	15	0	0	15	0	0
8	52528855	.	A	G	7	0	7	0	6	13	0	0
8	52528856	.	C	G	4	9	13	0	0	13	0	0
8	52529123	.	C	T	5	6	11	0	0	11	0	0
8	52529206	.	T	C	9	13	22	0	0	22	0	0
8	52529235	.	G	A	9	12	21	0	1	22	0	0
8	52529397	.	A	G	9	10	19	0	1	20	0	0
8	52534158	.	A	G	1	3	4	0	0	4	0	0
8	52538056	.	G	A	1	3	4	0	3	7	0	0
8	52538062	.	G	A	1	2	3	0	4	7	0	0
8	52547038	.	T	G	6	13	19	0	0	19	0	0
8	52547091	.	T	C	3	7	10	0	2	12	0	0
8	52547356	.	A	G	5	7	12	0	2	14	0	0
8	52547519	.	C	G	3	0	3	0	6	9	0	0
8	52547569	.	T	A	5	8	13	0	0	13	0	0
8	52547664	.	A	C	3	3	6	0	0	6	0	0
8	52547727	.	G	C	3	2	5	0	1	6	0	0
8	52547787	.	T	A	2	2	4	0	0	4	0	0
8	52550361	.	C	T	3	7	10	0	1	11	0	0
8	52550373	.	T	C	2	0	2	0	8	10	0	0
8	52550462	.	A	G	6	5	11	0	0	11	0	0
8	52553162	.	G	A	2	4	6	0	0	6	0	0
8	52553193	.	A	T	3	3	6	0	1	7	0	0
8	52553197	.	A	G	3	4	7	0	0	7	0	0
8	52554799	.	T	A	5	5	10	0	0	10	0	0
8	52555050	.	G	A	12	13	25	0	0	25	0	0
8	52555077	.	C	G	10	10	20	0	0	20	0	0
8	52555137	.	G	A	6	4	10	0	2	12	0	0
8	52557454	.	G	T	0	1	1	0	0	1	0	0
8	52559996	.	G	T	1	3	4	0	0	4	0	0
8	52560034	.	T	C	0	3	3	0	0	3	0	0
8	52560058	.	T	C	0	3	3	0	0	3	0	0
8	52561397	.	C	T	1	1	2	0	0	2	0	0
8	52561421	.	C	A	1	1	2	0	1	3	0	0
8	52561477	.	C	A	1	0	1	0	0	1	0	0
8	52563316	.	T	G	1	3	4	0	0	4	0	0
8	52563364	.	C	T	4	6	10	0	0	10	0	0
8	52565222	.	C	A	2	0	2	0	0	2	0	0
8	52565319	.	T	C	3	2	5	0	0	5	0	0
8	52571198	.	T	C	1	0	1	0	0	1	0	0
8	52580094	.	A	G	0	2	2	0	0	2	0	0
8	52580169	.	A	G	0	4	4	0	0	4	0	0
8	52584246	.	T	A	1	2	3	0	0	3	0	0
8	52584249	.	A	T	1	2	3	0	0	3	0	0
8	52630252	.	A	C	1	3	4	0	0	4	0	0
8	52703612	.	A	G	0	0	0	0	1	1	0	0
8	52713677	.	T	G	39	32	71	0	1	72	0	0
8	52713776	.	G	A	27	31	58	0	10	68	0	0
8	52713932	.	G	A	44	26	70	0	1	71	0	0
8	52713974	.	A	G	38	26	64	0	6	70	0	0
8	52713989	.	G	A	33	28	61	0	4	65	0	0
8	52714343	.	T	G	31	21	52	0	2	54	0	0
8	52715821	.	C	T	15	12	27	0	1	28	0	0
8	53148976	.	T	C	10	4	14	0	0	14	0	0
8	53149258	.	T	C	5	2	7	0	0	7	0	0
8	53149259	.	T	C	4	3	7	0	0	7	0	0
8	53150630	.	T	C	7	3	10	0	0	10	0	0
8	53398564	.	A	G	7	6	13	0	0	13	0	0
8	53398671	.	A	G	1	4	5	0	0	5	0	0
8	53399003	.	A	G	7	3	10	0	0	10	0	0
8	54130961	.	C	A	3	6	9	0	1	10	0	0
8	54221074	.	T	C	34	14	48	0	0	48	0	0
8	54303407	.	A	G	20	28	48	0	3	51	0	0
9	12837	.	A	G	1	2	3	0	0	3	0	0
9	14505	.	C	T	0	2	2	0	1	3	0	0
9	24528	.	C	T	12	23	35	0	3	38	0	0
9	37058	.	G	A	1	0	1	0	0	1	0	0
9	37199	.	G	A	5	5	10	0	0	10	0	0
9	37830	.	C	T	0	10	10	0	10	20	0	0
9	54479	.	C	T	8	16	24	0	1	25	0	0
9	62336	.	T	C	12	18	30	0	8	38	0	0
9	62351	.	A	G	11	18	29	0	5	34	0	0
9	62528	.	T	G	10	3	13	0	0	14	1	0
9	63313	.	G	A	7	9	16	0	0	16	0	0
9	63418	.	G	A	6	5	11	0	0	11	0	0
9	63532	.	G	A	2	1	3	0	0	3	0	0
9	63604	.	G	A	4	8	12	0	1	13	0	0
9	64739	.	C	A	0	4	4	0	7	11	0	0
9	83347	.	A	G	3	2	5	0	1	6	0	0
9	84216	.	G	A	2	3	5	0	0	5	0	0
9	84487	.	A	G	3	2	5	0	0	5	0	0
9	84617	.	A	T	2	2	4	0	0	4	0	0
9	84814	.	A	G	0	0	0	0	3	3	0	0
9	85318	.	T	C	8	4	12	0	0	12	0	0
9	85846	.	A	G	2	3	5	0	0	5	0	0
9	86089	.	A	G	0	4	4	0	2	6	0	0
9	86107	.	C	G	3	5	8	0	0	8	0	0
9	86462	.	G	T	4	3	7	0	0	7	0	0
9	86719	.	T	C	3	4	7	0	1	8	0	0
9	86767	.	T	C	3	7	10	0	1	11	0	0
9	86830	.	T	C	4	3	7	1	0	8	0	0
9	90105	.	C	A	1	3	4	0	0	4	0	0
9	90189	.	A	G	2	5	7	0	2	9	0	0
9	90507	.	G	C	0	0	0	0	2	2	0	0
9	94276	.	T	C	17	18	35	0	2	37	0	0
9	97348	.	G	A	0	1	1	0	0	1	0	0
9	98499	.	G	A	1	5	6	0	0	6	0	0
9	103432	.	T	C	4	4	8	0	1	9	0	0
9	104840	.	G	A	6	7	13	0	0	13	0	0
9	104862	.	T	G	4	4	8	0	0	8	0	0
9	105091	.	C	T	1	8	9	0	10	19	0	0
9	134835	.	C	T	0	5	5	0	1	6	0	0
9	134945	.	C	T	0	4	4	0	2	6	0	0
9	134949	.	C	T	0	5	5	0	2	7	0	0
9	135149	.	C	T	0	3	3	0	2	5	0	0
9	135151	.	G	T	1	4	5	0	0	5	0	0
9	148333	.	G	A	0	4	4	0	6	10	0	0
9	148339	.	A	G	5	4	9	0	1	10	0	0
9	149078	.	G	A	1	12	13	0	7	20	0	0
9	149215	.	C	A	17	10	27	0	0	27	0	0
9	149251	.	A	T	12	17	29	0	0	29	0	0
9	153001	.	C	T	12	8	20	0	0	20	0	0
9	168760	.	T	C	3	4	7	0	0	7	0	0
9	168848	.	T	C	7	8	15	0	1	16	0	0
9	168974	.	T	C	4	10	14	0	0	14	0	0
9	169188	.	T	C	11	4	15	0	0	15	0	0
9	169806	.	G	C	9	0	9	0	14	23	0	0
9	170845	.	G	T	6	3	9	0	1	10	0	0
9	170945	.	G	A	5	0	5	0	1	6	0	0
9	172661	.	C	T	16	8	24	0	3	27	0	0
9	180245	.	G	A	14	9	23	0	1	24	0	0
9	225362	.	T	C	7	3	10	0	1	11	0	0
9	225371	.	T	C	8	5	13	0	0	13	0	0
9	225599	.	C	T	4	1	5	0	1	6	0	0
9	225656	.	C	T	1	1	2	0	0	2	0	0
9	233295	.	A	G	5	0	5	0	6	11	0	0
9	234328	.	G	A	5	6	11	0	0	11	0	0
9	235262	.	G	T	0	4	4	0	9	13	0	0
9	235365	.	T	A	11	5	16	0	1	17	0	0
9	235567	.	C	G	4	9	13	0	1	14	0	0
9	253264	.	T	C	22	1	23	0	18	41	0	0
9	254484	.	A	G	32	30	62	0	1	63	0	0
9	257890	.	A	T	19	22	41	0	4	45	0	0
9	257926	.	G	C	16	2	18	0	7	25	0	0
9	262487	.	A	G	9	16	25	0	1	26	0	0
9	262511	.	C	T	0	23	23	0	18	41	0	0
9	266053	.	T	C	16	22	38	0	0	38	0	0
9	266227	.	T	C	26	28	54	0	2	56	0	0
9	266255	.	C	T	26	33	59	0	1	60	0	0
9	266445	.	G	C	27	28	55	0	0	55	0	0
9	266572	.	T	C	30	2	32	0	35	67	0	0
9	266721	.	A	G	19	20	39	0	2	41	0	0
9	266802	.	A	C	21	16	37	0	5	42	0	0
9	266875	.	T	C	30	12	42	0	4	46	0	0
9	266910	.	G	A	24	27	51	0	1	52	0	0
9	267081	.	A	G	31	29	60	0	2	62	0	0
9	267290	.	G	A	4	4	8	0	0	8	0	0
9	275474	.	G	A	3	1	4	0	0	4	0	0
9	276059	.	A	G	6	4	10	0	0	10	0	0
9	278150	.	A	G	11	21	32	0	0	32	0	0
9	278174	.	G	A	15	25	40	0	4	44	0	0
9	282686	.	C	T	2	2	4	0	0	4	0	0
9	282737	.	T	C	10	1	11	0	15	26	0	0
9	296052	.	G	A	15	11	26	0	0	26	0	0
9	296177	.	T	A	17	21	38	0	0	38	0	0
9	296181	.	T	C	15	0	15	0	23	38	0	0
9	297540	.	T	A	1	2	3	0	0	3	0	0
9	298715	.	C	T	0	5	5	0	1	6	0	0
9	298930	.	A	G	4	3	7	0	0	7	0	0
9	298970	.	A	G	2	5	7	0	1	8	0	0
9	299247	.	C	T	5	4	9	0	0	9	0	0
9	301535	.	A	T	2	7	9	0	0	9	0	0
9	302720	.	T	C	2	6	8	0	3	11	0	0
9	303032	.	C	G	6	4	10	0	0	10	0	0
9	303061	.	T	C	2	0	2	0	8	10	0	0
9	303070	.	T	C	5	4	9	0	1	10	0	0
9	303288	.	C	T	0	2	2	0	2	4	0	0
9	323588	.	A	G	13	7	20	0	0	20	0	0
9	323762	.	T	C	6	5	11	0	0	11	0	0
9	331870	.	T	C	1	0	1	0	0	1	0	0
9	332777	.	A	T	1	2	3	0	0	3	0	0
9	332779	.	A	T	1	2	3	0	0	3	0	0
9	335985	.	A	G	2	0	2	0	2	4	0	0
9	336776	.	G	T	0	1	1	0	0	1	0	0
9	336852	.	A	T	6	3	9	0	0	9	0	0
9	336863	.	A	G	6	0	6	0	4	10	0	0
9	340075	.	T	C	3	7	10	0	0	10	0	0
9	340076	.	A	T	3	7	10	0	0	10	0	0
9	340170	.	T	C	3	3	6	0	0	6	0	0
9	353645	.	G	C	0	2	2	0	0	2	0	0
9	354927	.	G	A	2	3	5	0	0	5	0	0
9	358679	.	C	G	0	3	3	0	12	15	0	0
9	360894	.	A	G	3	1	4	0	0	4	0	0
9	427925	.	T	C	1	2	3	0	1	4	0	0
9	429277	.	A	T	1	5	6	0	1	7	0	0
9	430071	.	T	C	4	10	14	0	1	15	0	0
9	430125	.	G	T	0	1	1	0	2	3	0	0
9	431089	.	C	T	3	3	6	0	0	6	0	0
9	431137	.	C	T	4	3	7	0	0	7	0	0
9	433764	.	C	T	1	7	8	0	1	9	0	0
9	458995	.	T	A	9	8	17	0	2	19	0	0
9	459042	.	A	T	14	7	21	0	0	21	0	0
9	459754	.	C	T	4	7	11	0	2	13	0	0
9	459755	.	T	C	4	0	4	0	9	13	0	0
9	463005	.	A	C	6	7	13	0	0	13	0	0
9	463010	.	T	C	6	0	6	0	7	13	0	0
9	525826	.	C	T	2	4	6	0	1	7	0	0
9	527507	.	T	C	1	0	1	0	0	1	0	0
9	527734	.	C	A	1	2	3	0	0	3	0	0
9	528021	.	A	G	4	2	6	0	0	6	0	0
9	528786	.	G	T	0	4	4	0	0	4	0	0
9	528905	.	T	C	5	2	7	0	0	7	0	0
9	529012	.	G	T	1	5	6	0	0	6	0	0
9	529036	.	G	A	0	4	4	0	1	5	0	0
9	529121	.	A	C	2	4	6	0	0	6	0	0
9	529147	.	C	T	3	3	6	0	0	6	0	0
9	529156	.	G	A	2	3	5	0	0	5	0	0
9	529675	.	A	G	1	1	2	0	0	2	0	0
9	529824	.	C	A	2	6	8	0	0	8	0	0
9	529849	.	G	A	0	5	5	0	5	10	0	0
9	531319	.	C	A	3	2	5	0	0	5	0	0
9	588454	.	A	G	4	12	16	0	0	16	0	0
9	588456	.	C	T	4	12	16	0	0	16	0	0
9	596596	.	G	A	5	3	8	0	0	8	0	0
9	598720	.	A	G	2	3	5	0	0	5	0	0
9	598795	.	A	G	1	4	5	0	0	5	0	0
9	598819	.	G	A	0	1	1	0	0	1	0	0
9	604848	.	A	G	2	3	5	0	1	6	0	0
9	606794	.	T	A	2	2	4	0	0	4	0	0
9	608057	.	C	T	0	1	1	0	2	3	0	0
9	701934	.	T	C	1	0	1	0	0	1	0	0
9	704662	.	T	A	6	4	10	0	0	10	0	0
9	707682	.	A	G	1	4	5	0	0	5	0	0
9	707996	.	C	T	0	14	14	0	29	43	0	0
9	708075	.	T	C	29	1	30	0	23	53	0	0
9	719729	.	G	A	2	1	3	0	0	3	0	0
9	719825	.	A	G	1	0	1	0	0	1	0	0
9	721472	.	C	T	0	2	2	0	0	2	0	0
9	721822	.	T	A	4	5	9	0	1	10	0	0
9	721829	.	A	G	5	4	9	0	0	9	0	0
9	722965	.	A	G	8	1	9	0	0	9	0	0
9	723004	.	G	A	9	4	13	0	0	13	0	0
9	724532	.	G	A	0	1	1	0	0	1	0	0
9	724616	.	G	A	4	5	9	0	0	9	0	0
9	726870	.	A	G	2	0	2	0	0	2	0	0
9	731356	.	G	A	2	3	5	0	0	5	0	0
9	732191	.	C	T	0	1	1	0	0	1	0	0
9	732218	.	G	A	0	1	1	0	0	1	0	0
9	732227	.	C	T	1	0	1	0	0	1	0	0
9	746040	.	A	G	1	2	3	0	0	3	0	0
9	751441	.	A	G	2	1	3	0	0	3	0	0
9	781869	.	T	A	1	1	2	0	0	2	0	0
9	781873	.	T	A	1	3	4	0	0	4	0	0
9	784691	.	T	C	1	2	3	0	0	3	0	0
9	784873	.	C	T	0	3	3	0	0	3	0	0
9	795984	.	T	C	1	4	5	0	0	5	0	0
9	795994	.	T	G	1	3	4	0	0	4	0	0
9	796093	.	G	A	0	2	2	0	0	2	0	0
9	881678	.	A	T	6	2	8	0	1	9	0	0
9	882143	.	T	C	17	0	17	0	6	23	0	0
9	884904	.	C	T	0	1	1	0	0	1	0	0
9	887854	.	A	G	1	0	1	0	0	1	0	0
9	889433	.	G	A	7	3	10	0	0	10	0	0
9	900550	.	A	T	4	3	7	0	0	7	0	0
9	900592	.	G	A	5	8	13	0	0	13	0	0
9	901137	.	A	G	2	2	4	0	0	4	0	0
9	902877	.	A	G	0	1	1	0	0	1	0	0
9	904118	.	A	T	6	11	17	0	1	18	0	0
9	907564	.	A	G	1	8	9	0	0	9	0	0
9	910882	.	C	T	7	6	13	0	2	15	0	0
9	913874	.	T	C	22	28	50	0	1	51	0	0
9	913882	.	C	T	22	31	53	0	0	53	0	0
9	913909	.	G	A	3	27	30	0	19	49	0	0
9	914506	.	C	A	7	2	9	0	0	9	0	0
9	914507	.	C	T	6	2	8	0	1	9	0	0
9	921767	.	A	T	3	2	5	0	0	5	0	0
9	921795	.	T	C	1	2	3	0	0	3	0	0
9	922715	.	A	G	3	3	6	0	0	6	0	0
9	963731	.	C	T	3	2	5	0	2	7	0	0
9	1133159	.	C	T	2	3	5	0	0	5	0	0
9	1368428	.	T	A	4	1	5	0	0	5	0	0
9	1371190	.	C	G	3	4	7	0	0	7	0	0
9	1371362	.	C	T	9	7	16	0	0	16	0	0
9	1371363	.	A	G	10	5	15	0	1	16	0	0
9	1373075	.	T	G	5	4	9	0	0	9	0	0
9	1373144	.	C	A	8	9	17	0	0	17	0	0
9	1376201	.	A	G	1	0	1	0	5	6	0	0
9	1463287	.	T	C	2	4	6	0	0	6	0	0
9	1469002	.	T	C	2	1	3	0	1	4	0	0
9	1477756	.	C	T	5	2	7	0	0	7	0	0
9	1574234	.	A	G	1	2	3	0	0	3	0	0
9	1576074	.	T	C	3	3	6	0	0	6	0	0
9	1577542	.	C	A	0	9	9	0	0	9	0	0
9	1579792	.	T	C	5	7	12	0	0	12	0	0
9	1643973	.	G	A	2	2	4	0	0	4	0	0
9	1644303	.	C	A	2	1	3	0	0	3	0	0
9	1644349	.	T	C	2	3	5	0	1	6	0	0
9	1644564	.	T	G	1	2	3	0	0	3	0	0
9	1680126	.	A	C	3	2	5	0	0	5	0	0
9	1680468	.	A	G	0	2	2	0	0	2	0	0
9	1680636	.	A	G	4	2	6	0	1	7	0	0
9	1680660	.	T	A	3	2	5	0	1	6	0	0
9	1680700	.	T	A	3	4	7	0	0	7	0	0
9	1682489	.	G	A	6	4	10	0	0	10	0	0
9	1682619	.	T	C	2	4	6	0	0	6	0	0
9	1682647	.	A	T	3	4	7	0	0	7	0	0
9	1682740	.	G	C	0	10	10	0	10	20	0	0
9	1693082	.	A	C	9	10	19	0	0	19	0	0
9	1693092	.	G	A	8	11	19	0	0	19	0	0
9	1693443	.	G	A	11	6	17	0	0	17	0	0
9	1693494	.	T	G	12	11	23	0	1	24	0	0
9	1693585	.	C	T	0	0	0	0	2	2	0	0
9	1937440	.	A	T	2	3	5	0	0	5	0	0
9	1938788	.	A	G	2	2	4	0	1	5	0	0
9	1948976	.	G	A	1	2	3	0	0	3	0	0
9	2003227	.	C	A	2	2	4	0	0	4	0	0
9	2005428	.	A	C	4	4	8	0	1	9	0	0
9	2045046	.	G	T	1	3	4	0	0	4	0	0
9	2045125	.	T	G	5	2	7	0	0	7	0	0
9	2045265	.	G	A	2	4	6	0	0	6	0	0
9	2334164	.	C	T	3	3	6	0	0	6	0	0
9	2336682	.	A	G	0	0	0	0	4	4	0	0
9	2337291	.	C	T	1	3	4	0	1	5	0	0
9	2340561	.	G	A	6	6	12	0	0	12	0	0
9	2340564	.	G	A	5	6	11	0	2	13	0	0
9	2340618	.	C	T	25	28	53	0	4	57	0	0
9	2340776	.	C	T	28	33	61	0	11	72	0	0
9	2341035	.	T	C	26	7	33	0	0	33	0	0
9	2341053	.	T	C	19	7	26	0	0	26	0	0
9	2347618	.	G	A	1	1	2	0	0	2	0	0
9	2351661	.	C	T	0	1	1	0	0	1	0	0
9	2351795	.	C	G	1	2	3	0	0	3	0	0
9	2365125	.	T	C	2	2	4	0	0	4	0	0
9	2421012	.	T	A	1	1	2	0	0	2	0	0
9	2423092	.	C	A	4	6	10	0	1	11	0	0
9	2423119	.	C	T	6	7	13	0	0	13	0	0
9	2452697	.	T	C	10	8	18	0	0	18	0	0
9	2483617	.	A	G	4	6	10	0	3	13	0	0
9	2483623	.	A	G	1	11	12	0	0	12	0	0
9	2483653	.	A	G	10	3	13	0	0	13	0	0
9	2510519	.	T	C	0	1	1	0	0	1	0	0
9	2555239	.	C	T	2	2	4	0	0	4	0	0
9	2555535	.	A	T	1	3	4	0	0	4	0	0
9	2555591	.	A	G	3	2	5	0	0	5	0	0
9	2555631	.	G	A	0	2	2	0	1	3	0	0
9	2555975	.	T	G	3	2	5	0	0	5	0	0
9	2556068	.	A	T	3	2	5	0	0	5	0	0
9	2556339	.	T	C	2	4	6	0	0	6	0	0
9	2556415	.	T	A	3	4	7	0	0	7	0	0
9	2556516	.	A	T	2	2	4	0	1	5	0	0
9	2558355	.	G	T	3	5	8	0	0	8	0	0
9	2558487	.	T	C	0	2	2	0	0	2	0	0
9	2558492	.	A	C	0	2	2	0	0	2	0	0
9	2558649	.	G	A	3	3	6	0	0	6	0	0
9	2559138	.	C	T	2	1	3	0	1	4	0	0
9	2559177	.	C	T	1	3	4	0	0	4	0	0
9	2559204	.	C	T	4	4	8	0	0	8	0	0
9	2559566	.	C	A	1	6	7	0	0	7	0	0
9	2559587	.	G	C	0	2	2	0	4	6	0	0
9	2559792	.	G	A	2	5	7	0	0	7	0	0
9	2559856	.	A	C	4	9	13	0	0	13	0	0
9	2561162	.	T	G	3	2	5	0	2	7	0	0
9	2561182	.	A	G	2	3	5	0	1	6	0	0
9	2561205	.	G	T	3	4	7	0	1	8	0	0
9	2561225	.	T	A	4	2	6	0	0	6	0	0
9	2561254	.	C	T	0	5	5	0	3	8	0	0
9	2561322	.	T	A	1	3	4	0	0	4	0	0
9	2561604	.	C	T	15	10	25	0	1	26	0	0
9	2561632	.	A	T	17	11	28	0	2	30	0	0
9	2564111	.	G	A	9	12	21	0	0	21	0	0
9	2564656	.	G	T	5	6	11	0	0	11	0	0
9	2564788	.	A	T	0	5	5	0	0	5	0	0
9	2564790	.	A	T	0	5	5	0	0	5	0	0
9	2568777	.	C	T	10	11	21	0	0	21	0	0
9	2569372	.	T	G	2	4	6	0	0	6	0	0
9	2572235	.	A	T	2	1	3	0	0	3	0	0
9	2572756	.	A	T	5	4	9	0	0	9	0	0
9	2572809	.	C	T	0	3	3	0	2	5	0	0
9	2576099	.	T	C	2	0	2	0	0	2	0	0
9	2586206	.	A	G	11	1	12	0	10	22	0	0
9	2586259	.	A	G	12	11	23	0	1	24	0	0
9	2592246	.	C	T	7	16	23	0	2	25	0	0
9	2592518	.	A	T	8	8	16	0	1	17	0	0
9	2592519	.	T	A	8	9	17	0	0	17	0	0
9	2592675	.	G	A	9	16	25	0	1	26	0	0
9	2592960	.	A	G	5	13	18	0	2	20	0	0
9	2592984	.	C	A	0	14	14	0	6	20	0	0
9	2593059	.	C	T	0	6	6	0	11	17	0	0
9	2593518	.	G	A	5	8	13	0	0	13	0	0
9	2593533	.	G	A	6	3	9	0	0	9	0	0
9	2897200	.	A	T	1	3	4	0	0	4	0	0
9	2949374	.	T	A	5	5	10	0	0	10	0	0
9	2954058	.	G	C	1	0	1	0	0	1	0	0
9	3149541	.	T	C	9	7	16	0	0	16	0	0
9	3149661	.	C	T	5	2	7	0	0	7	0	0
9	3228214	.	C	T	1	0	1	0	0	1	0	0
9	3231242	.	C	T	3	3	6	0	0	6	0	0
9	3231378	.	C	A	0	11	11	0	1	12	0	0
9	3231396	.	C	G	6	8	14	0	0	14	0	0
9	3231795	.	T	C	1	6	7	0	0	7	0	0
9	3231978	.	C	A	3	2	5	0	0	5	0	0
9	3232180	.	T	A	8	4	12	0	0	12	0	0
9	3232523	.	T	G	8	5	13	0	1	14	0	0
9	3232607	.	T	A	6	6	12	0	0	12	0	0
9	3232672	.	C	T	3	6	9	0	1	10	0	0
9	3232949	.	A	G	3	5	8	0	0	8	0	0
9	3286386	.	G	A	1	1	2	0	0	2	0	0
9	3313920	.	G	T	18	7	25	0	1	26	0	0
9	3388974	.	C	T	0	2	2	0	0	2	0	0
9	3389545	.	G	A	0	1	1	0	0	1	0	0
9	3389921	.	A	G	13	0	13	0	11	24	0	0
9	3390035	.	G	A	13	7	20	0	5	25	0	0
9	3397558	.	G	A	4	2	6	0	0	6	0	0
9	3397648	.	A	C	5	7	12	0	0	12	0	0
9	3398243	.	T	A	7	9	16	0	3	19	0	0
9	3398247	.	G	A	11	9	20	0	0	20	0	0
9	3398328	.	C	A	0	9	9	0	12	21	0	0
9	3398354	.	T	C	11	0	11	0	15	26	0	0
9	3400331	.	A	G	3	4	7	0	0	7	0	0
9	3400361	.	G	A	4	2	6	0	0	6	0	0
9	3429722	.	A	T	1	2	3	0	0	3	0	0
9	3429733	.	C	T	1	2	3	0	0	3	0	0
9	3463247	.	C	A	1	0	1	0	0	1	0	0
9	3471076	.	C	T	1	5	6	0	0	6	0	0
9	3471077	.	A	G	1	5	6	0	0	6	0	0
9	3477113	.	T	G	0	2	2	0	0	2	0	0
9	3480057	.	A	G	2	4	6	0	0	6	0	0
9	3480076	.	C	T	0	2	2	0	0	2	0	0
9	3483164	.	T	C	4	8	12	0	0	12	0	0
9	3485822	.	G	A	1	6	7	0	2	9	0	0
9	3485867	.	A	T	4	1	5	0	0	5	0	0
9	3485868	.	T	C	3	1	4	0	1	5	0	0
9	3486134	.	T	G	4	3	7	0	0	7	0	0
9	3486220	.	C	T	6	4	10	0	1	11	0	0
9	3486223	.	C	T	6	4	10	0	1	11	0	0
9	3509076	.	A	G	1	1	2	0	0	2	0	0
9	3509096	.	T	C	1	1	2	0	0	2	0	0
9	3534947	.	C	T	3	3	6	0	0	6	0	0
9	3534981	.	G	T	4	2	6	0	0	6	0	0
9	3534985	.	A	G	4	2	6	0	0	6	0	0
9	3569470	.	C	A	0	1	1	0	0	1	0	0
9	3605652	.	C	T	7	7	14	0	0	14	0	0
9	3605682	.	A	G	8	0	8	0	8	16	0	0
9	3608867	.	T	A	14	12	26	0	1	27	0	0
9	3621980	.	T	C	7	9	16	0	0	16	0	0
9	3627189	.	T	C	2	1	3	0	0	3	0	0
9	3635791	.	G	A	1	1	2	0	0	2	0	0
9	3646864	.	A	G	1	2	3	0	0	3	0	0
9	3653187	.	G	C	0	2	2	0	0	2	0	0
9	3666541	.	A	C	10	11	21	0	1	22	0	0
9	3666601	.	A	T	16	7	23	0	0	23	0	0
9	3666666	.	T	C	8	16	24	0	0	25	1	0
9	3666947	.	G	A	10	5	15	0	0	15	0	0
9	3666948	.	T	C	7	0	7	0	8	15	0	0
9	3667136	.	G	A	7	11	18	0	1	19	0	0
9	3667338	.	T	A	14	6	20	0	0	20	0	0
9	3667377	.	C	A	11	9	20	0	1	21	0	0
9	3667398	.	C	A	7	9	16	0	0	16	0	0
9	3667459	.	C	T	5	3	8	0	1	9	0	0
9	3667616	.	A	G	5	2	7	0	0	7	0	0
9	3759373	.	G	A	1	2	3	0	0	3	0	0
9	3900878	.	T	A	3	6	9	0	0	9	0	0
9	3901007	.	A	T	3	5	8	0	1	9	0	0
9	3901081	.	C	T	5	9	14	0	1	15	0	0
9	3901118	.	A	C	10	5	15	0	1	16	0	0
9	3901187	.	T	A	5	4	9	0	0	9	0	0
9	3905921	.	G	A	2	3	5	0	0	5	0	0
9	3907834	.	C	G	2	3	5	0	0	5	0	0
9	3912739	.	G	A	1	2	3	0	1	4	0	0
9	3928332	.	C	A	1	0	1	0	0	1	0	0
9	4032809	.	T	C	1	2	3	0	0	3	0	0
9	4267062	.	T	C	1	2	3	0	0	3	0	0
9	4267072	.	T	C	3	3	6	0	0	6	0	0
9	4267101	.	C	G	3	2	5	0	0	5	0	0
9	4277125	.	C	T	1	0	1	0	0	1	0	0
9	4282581	.	G	A	0	1	1	0	1	2	0	0
9	4323249	.	C	T	0	2	2	0	0	2	0	0
9	4328760	.	A	G	2	2	4	0	0	4	0	0
9	4332223	.	C	T	1	1	2	0	0	2	0	0
9	4336543	.	A	G	2	3	5	0	0	5	0	0
9	4336585	.	T	C	2	3	5	0	0	5	0	0
9	4344553	.	C	T	0	4	4	0	1	5	0	0
9	4541376	.	T	C	0	3	3	1	0	4	0	0
9	4721500	.	G	T	7	6	13	2	3	18	0	0
9	5041842	.	A	T	3	4	7	0	1	8	0	0
9	5345770	.	G	A	2	3	5	0	0	5	0	0
9	5345827	.	C	T	0	5	5	0	4	9	0	0
9	7042659	.	G	A	0	2	2	0	0	2	0	0
9	7092424	.	T	C	8	6	14	0	1	15	0	0
9	7092457	.	T	C	13	5	18	0	0	18	0	0
9	7094216	.	T	C	7	6	13	0	4	17	0	0
9	7094898	.	T	C	13	15	28	0	0	28	0	0
9	7228348	.	C	A	17	13	30	0	1	31	0	0
9	7228487	.	C	A	9	7	16	0	2	18	0	0
9	7228544	.	C	T	6	2	8	0	0	8	0	0
9	7228753	.	T	G	10	8	18	0	2	20	0	0
9	7228770	.	T	C	4	0	4	0	15	19	0	0
9	7228805	.	T	A	9	1	10	0	3	13	0	0
9	7229053	.	G	A	13	8	21	0	0	21	0	0
9	7229069	.	G	A	14	9	23	0	1	25	1	0
9	7229210	.	C	T	24	15	39	0	1	40	0	0
9	7229218	.	G	A	20	18	38	0	2	40	0	0
9	7229248	.	G	A	22	15	37	0	0	37	0	0
9	7229262	.	C	G	24	16	40	0	0	40	0	0
9	7229512	.	C	T	21	7	28	0	3	31	0	0
9	7234618	.	A	C	7	1	8	0	10	18	0	0
9	7234642	.	G	A	8	11	19	0	0	19	0	0
9	7238498	.	C	T	14	13	27	0	2	29	0	0
9	7238502	.	C	A	14	13	27	0	0	27	0	0
9	7241118	.	G	A	2	4	6	0	1	7	0	0
9	7241409	.	G	T	4	5	9	0	0	9	0	0
9	7241663	.	A	C	2	2	4	0	1	5	0	0
9	7242309	.	T	A	3	6	9	0	0	9	0	0
9	7242534	.	C	A	1	2	3	0	0	3	0	0
9	7245004	.	C	T	2	5	7	0	0	7	0	0
9	7245218	.	C	T	3	2	5	0	0	5	0	0
9	7245226	.	A	G	3	2	5	0	0	5	0	0
9	7245377	.	C	T	4	5	9	0	0	9	0	0
9	7245445	.	C	A	3	3	6	0	1	7	0	0
9	7245472	.	A	G	1	2	3	0	0	3	0	0
9	7245483	.	C	T	1	2	3	0	0	3	0	0
9	7245528	.	T	A	1	4	5	0	0	5	0	0
9	7245809	.	A	T	0	1	1	0	0	1	0	0
9	7245868	.	C	T	0	3	3	0	2	5	0	0
9	7249241	.	T	G	6	8	14	0	0	14	0	0
9	7249401	.	A	G	3	5	8	0	1	9	0	0
9	7275963	.	T	G	0	3	3	0	0	3	0	0
9	7276259	.	G	A	3	2	5	0	0	5	0	0
9	7282858	.	G	A	0	3	3	0	0	3	0	0
9	7410995	.	G	A	2	0	2	0	0	2	0	0
9	7499322	.	G	A	0	4	4	0	3	7	0	0
9	7516095	.	G	T	2	2	4	0	0	4	0	0
9	7548591	.	A	G	3	5	8	0	0	8	0	0
9	7548600	.	T	A	4	7	11	0	0	11	0	0
9	7570857	.	A	G	17	0	17	0	23	40	0	0
9	7570891	.	T	A	20	14	34	0	2	36	0	0
9	7574042	.	T	A	5	5	10	0	1	11	0	0
9	7574126	.	C	T	1	5	6	0	0	6	0	0
9	7574135	.	A	T	0	3	3	0	0	3	0	0
9	7575309	.	G	A	4	4	8	0	0	8	0	0
9	7575545	.	A	C	1	3	4	0	0	4	0	0
9	7578595	.	G	C	1	5	6	0	0	6	0	0
9	7604524	.	G	A	8	12	20	0	2	22	0	0
9	7612711	.	G	A	0	1	1	0	0	1	0	0
9	7612826	.	C	T	1	1	2	0	0	2	0	0
9	7618903	.	A	C	11	10	21	0	0	21	0	0
9	7618906	.	T	C	10	12	22	0	1	23	0	0
9	7635925	.	G	A	2	6	8	0	1	9	0	0
9	7655123	.	T	C	1	0	1	0	2	3	0	0
9	7655124	.	T	G	1	2	3	0	0	3	0	0
9	7671165	.	G	A	6	8	14	0	1	15	0	0
9	8114242	.	T	C	2	2	4	0	0	4	0	0
9	8120971	.	C	T	1	1	2	0	0	2	0	0
9	8121041	.	C	T	10	4	14	0	0	14	0	0
9	8121128	.	C	T	2	10	12	0	1	13	0	0
9	8121855	.	G	T	5	11	16	0	0	16	0	0
9	8121939	.	G	T	4	4	8	0	0	8	0	0
9	8122095	.	A	T	12	8	20	0	1	21	0	0
9	8429331	.	A	G	1	4	5	0	1	6	0	0
9	8429899	.	A	G	20	7	27	0	3	30	0	0
9	8430558	.	A	C	14	8	22	0	1	23	0	0
9	8430739	.	T	C	2	5	7	0	0	7	0	0
9	8430787	.	A	G	6	7	13	0	0	13	0	0
9	8430831	.	C	T	0	10	10	0	8	18	0	0
9	8431031	.	A	G	20	8	28	0	0	28	0	0
9	8431214	.	C	T	0	13	13	0	14	27	0	0
9	8431256	.	G	A	15	19	34	0	0	34	0	0
9	8431345	.	A	C	14	0	14	0	7	21	0	0
9	8431450	.	A	G	12	11	23	0	2	25	0	0
9	8431541	.	A	T	11	8	19	0	1	21	1	0
9	8431714	.	G	T	11	4	15	0	0	15	0	0
9	8431772	.	C	T	13	6	19	0	0	19	0	0
9	8431814	.	A	G	16	5	21	0	0	21	0	0
9	8431837	.	T	C	14	6	20	0	2	22	0	0
9	8431854	.	T	C	13	11	24	0	0	24	0	0
9	8431894	.	A	G	11	12	23	0	0	23	0	0
9	8431998	.	A	C	6	0	6	0	4	10	0	0
9	8432695	.	C	T	4	9	13	0	1	14	0	0
9	8432768	.	A	T	13	12	25	0	0	25	0	0
9	8432802	.	T	C	9	0	9	0	15	24	0	0
9	8432996	.	G	A	14	11	25	0	2	27	0	0
9	8433189	.	C	T	4	11	15	0	1	16	0	0
9	8450740	.	G	A	7	9	16	0	0	16	0	0
9	8450788	.	G	A	6	9	15	0	0	15	0	0
9	8451226	.	A	G	4	2	6	0	0	6	0	0
9	8451386	.	C	T	1	4	5	0	9	14	0	0
9	8451540	.	C	T	10	6	16	0	0	16	0	0
9	8452339	.	C	T	4	4	8	0	0	8	0	0
9	8452546	.	A	G	3	5	8	0	0	8	0	0
9	8452627	.	G	A	0	2	2	0	1	3	0	0
9	8452695	.	C	T	6	7	13	0	1	14	0	0
9	8452705	.	G	A	6	6	12	0	2	14	0	0
9	8453035	.	G	A	2	2	4	0	1	5	0	0
9	8887703	.	C	A	1	3	4	0	0	4	0	0
9	8888388	.	A	G	2	3	5	0	0	5	0	0
9	8898196	.	G	A	0	3	3	0	5	8	0	0
9	8898403	.	T	C	1	0	1	0	3	4	0	0
9	8898903	.	C	A	7	5	12	0	1	13	0	0
9	8899665	.	C	T	6	4	10	0	0	10	0	0
9	8899704	.	C	T	9	10	19	0	0	19	0	0
9	8914657	.	G	C	2	0	2	0	0	2	0	0
9	8923188	.	A	T	10	12	22	0	2	24	0	0
9	8929848	.	G	T	9	3	12	0	1	13	0	0
9	8929905	.	G	A	0	8	8	0	3	11	0	0
9	8964997	.	C	T	3	3	6	0	0	6	0	0
9	8965027	.	A	G	6	3	9	0	1	10	0	0
9	8967442	.	G	A	11	22	33	0	0	33	0	0
9	8967459	.	C	T	19	12	31	0	2	33	0	0
9	8971713	.	G	A	22	17	39	0	0	39	0	0
9	8971984	.	T	G	11	0	11	0	21	32	0	0
9	8971995	.	A	C	12	10	22	0	7	29	0	0
9	8972429	.	T	A	12	17	29	0	1	30	0	0
9	8973093	.	C	T	1	6	7	0	0	7	0	0
9	8973175	.	A	G	3	1	4	0	0	4	0	0
9	8973188	.	G	T	3	1	4	0	0	4	0	0
9	8973227	.	T	C	3	1	4	0	1	5	0	0
9	8973379	.	T	G	2	6	8	0	1	9	0	0
9	8973426	.	A	C	2	1	3	0	0	3	0	0
9	8973443	.	T	G	1	2	3	0	0	3	0	0
9	8973581	.	G	A	3	3	6	0	0	6	0	0
9	8973627	.	C	A	7	5	12	0	1	13	0	0
9	8973629	.	G	A	7	6	13	0	0	13	0	0
9	8974152	.	G	A	11	4	15	0	1	16	0	0
9	9112933	.	C	A	4	1	5	0	0	5	0	0
9	9113008	.	A	G	3	4	7	0	1	8	0	0
9	9116101	.	C	T	0	1	1	0	0	1	0	0
9	9116890	.	C	T	3	3	6	0	0	6	0	0
9	9118363	.	A	C	5	2	7	0	2	9	0	0
9	9118595	.	G	C	4	0	4	0	1	5	0	0
9	9118602	.	G	A	5	4	9	0	0	9	0	0
9	9118695	.	C	T	0	5	5	0	0	5	0	0
9	9118991	.	C	T	11	10	21	0	2	23	0	0
9	9118994	.	C	T	11	10	21	0	1	22	0	0
9	9119546	.	A	G	2	4	6	0	1	7	0	0
9	9119671	.	G	C	4	8	12	0	0	12	0	0
9	9119755	.	G	T	7	6	13	0	0	13	0	0
9	9119771	.	T	A	7	7	14	0	0	14	0	0
9	9119830	.	A	T	2	6	8	0	0	8	0	0
9	9119877	.	G	A	5	5	10	0	1	11	0	0
9	9119937	.	G	A	3	6	9	0	1	10	0	0
9	9119987	.	T	C	3	8	11	0	0	11	0	0
9	9120271	.	T	C	4	9	13	0	1	14	0	0
9	9120517	.	A	T	8	11	19	0	0	19	0	0
9	9120847	.	G	A	7	12	19	0	4	23	0	0
9	9121242	.	T	C	10	14	24	0	0	24	0	0
9	9121382	.	G	A	11	14	25	0	0	25	0	0
9	9183874	.	C	T	10	11	21	0	0	21	0	0
9	9183969	.	T	A	19	16	35	0	0	35	0	0
9	9184092	.	G	A	15	17	32	0	0	32	0	0
9	9184177	.	G	A	16	22	38	0	2	40	0	0
9	9184397	.	G	A	12	17	29	0	0	29	0	0
9	9184536	.	T	C	11	20	31	0	1	32	0	0
9	9184566	.	G	A	11	15	26	0	1	27	0	0
9	9184593	.	T	C	15	12	27	0	1	28	0	0
9	9193044	.	A	C	1	2	3	0	0	3	0	0
9	9195964	.	C	T	5	8	13	0	1	14	0	0
9	9198139	.	A	G	1	2	3	0	0	3	0	0
9	9198202	.	A	C	9	14	23	0	2	25	0	0
9	9198208	.	G	A	10	12	22	0	0	22	0	0
9	9206612	.	C	G	3	3	6	0	0	6	0	0
9	9208714	.	C	A	4	7	11	0	1	12	0	0
9	9208759	.	A	T	8	8	16	0	0	16	0	0
9	9225717	.	C	T	5	6	11	0	0	11	0	0
9	9238577	.	G	A	1	8	9	0	0	9	0	0
9	9238583	.	G	A	1	8	9	0	0	9	0	0
9	9322733	.	G	A	6	8	14	0	0	14	0	0
9	9322782	.	C	G	0	8	8	0	6	14	0	0
9	9322795	.	A	G	6	7	13	0	0	13	0	0
9	9327588	.	G	A	3	2	5	0	1	6	0	0
9	9327705	.	C	T	8	10	18	0	1	19	0	0
9	9342835	.	T	A	8	5	13	0	1	14	0	0
9	9342892	.	C	T	5	8	13	0	0	13	0	0
9	9342994	.	A	G	0	2	2	0	0	2	0	0
9	9345134	.	G	A	7	2	9	0	0	9	0	0
9	9578598	.	G	T	17	21	38	0	2	40	0	0
9	9578936	.	T	G	21	26	47	0	1	48	0	0
9	9579027	.	C	A	20	33	53	0	0	53	0	0
9	9579033	.	T	C	27	0	27	0	24	51	0	0
9	9579076	.	G	C	12	18	30	0	0	30	0	0
9	9579165	.	C	T	19	19	38	0	3	41	0	0
9	9579297	.	G	C	11	12	23	0	0	23	0	0
9	9580103	.	G	A	19	14	33	0	0	33	0	0
9	9592779	.	C	A	1	7	8	0	0	8	0	0
9	9671134	.	G	T	5	5	10	0	0	10	0	0
9	9671208	.	G	A	12	8	20	0	0	20	0	0
9	9736317	.	G	T	9	10	19	0	1	20	0	0
9	9736406	.	C	A	13	9	22	0	0	22	0	0
9	9736436	.	G	T	9	14	23	0	1	24	0	0
9	9736617	.	T	C	6	2	8	0	0	8	0	0
9	9736647	.	A	C	5	0	5	0	0	5	0	0
9	9736653	.	C	G	4	4	8	0	1	9	0	0
9	9736684	.	C	T	0	8	8	0	4	12	0	0
9	9736689	.	A	C	2	8	10	0	2	12	0	0
9	9736727	.	A	G	6	5	11	0	0	11	0	0
9	9736815	.	T	A	8	6	14	0	1	15	0	0
9	9736870	.	T	G	5	7	12	0	1	13	0	0
9	9736918	.	G	C	8	8	16	0	0	16	0	0
9	9737060	.	T	G	9	13	22	0	0	22	0	0
9	9737219	.	C	G	8	9	17	0	1	18	0	0
9	9737248	.	G	A	4	10	14	0	1	15	0	0
9	9737432	.	A	T	7	7	14	0	1	15	0	0
9	9737437	.	T	C	7	0	7	0	7	14	0	0
9	9738021	.	A	T	3	4	7	0	0	7	0	0
9	9738078	.	G	C	7	3	10	0	0	10	0	0
9	9738304	.	C	T	0	5	5	0	6	11	0	0
9	9738325	.	A	T	9	4	13	0	1	14	0	0
9	9738357	.	T	C	10	0	10	0	4	14	0	0
9	9738449	.	C	T	1	5	6	0	0	6	0	0
9	9738450	.	T	A	1	5	6	0	0	6	0	0
9	9738629	.	C	T	0	7	7	0	3	10	0	0
9	9738671	.	C	A	7	4	11	0	0	11	0	0
9	9738707	.	G	A	10	3	13	0	0	13	0	0
9	9738739	.	A	G	5	6	11	0	1	12	0	0
9	9738758	.	T	A	2	7	9	0	0	9	0	0
9	9738778	.	A	T	1	5	6	0	1	7	0	0
9	9739059	.	C	G	3	2	5	0	0	5	0	0
9	9743579	.	T	A	0	2	2	0	0	2	0	0
9	9937808	.	T	C	0	2	2	0	0	2	0	0
9	9941440	.	G	A	0	1	1	0	0	1	0	0
9	9941518	.	G	C	0	2	2	0	1	3	0	0
9	10014875	.	C	A	3	7	10	0	0	10	0	0
9	10043130	.	T	C	1	3	4	0	0	4	0	0
9	10043201	.	C	G	7	2	9	0	0	9	0	0
9	10043217	.	T	A	5	7	12	0	0	12	0	0
9	10043343	.	C	G	3	1	4	0	5	9	0	0
9	10051935	.	T	A	11	7	18	0	0	18	0	0
9	10138338	.	G	A	10	8	18	0	1	19	0	0
9	10138486	.	G	A	7	6	13	0	0	13	0	0
9	10153091	.	C	T	5	5	10	0	0	10	0	0
9	10153342	.	T	A	11	7	18	0	0	18	0	0
9	10153590	.	A	C	12	6	18	0	1	19	0	0
9	10153606	.	A	G	7	12	19	0	1	20	0	0
9	10153689	.	G	C	9	12	21	0	0	21	0	0
9	10153705	.	A	T	11	10	21	0	0	21	0	0
9	10154013	.	G	T	13	10	23	0	1	24	0	0
9	10154014	.	C	T	13	10	23	0	1	24	0	0
9	10154138	.	T	C	6	7	13	0	1	14	0	0
9	10154195	.	A	T	6	7	13	0	0	13	0	0
9	10154344	.	T	A	3	7	10	0	0	10	0	0
9	10154461	.	C	T	9	8	17	0	0	17	0	0
9	10156122	.	T	A	8	6	14	0	1	15	0	0
9	10156145	.	C	A	10	7	17	0	2	19	0	0
9	10157193	.	C	G	4	7	11	0	0	11	0	0
9	10157397	.	G	A	1	5	6	0	1	7	0	0
9	10175785	.	A	G	3	3	6	0	0	6	0	0
9	10175812	.	G	A	4	6	10	0	0	10	0	0
9	10183289	.	C	T	1	0	1	0	0	1	0	0
9	10195488	.	T	A	0	1	1	0	1	2	0	0
9	10199946	.	G	A	0	3	3	0	0	3	0	0
9	10199954	.	G	A	0	1	1	0	0	1	0	0
9	11532306	.	A	G	11	10	21	0	0	21	0	0
9	11532307	.	C	A	11	10	21	0	0	21	0	0
9	11532589	.	T	C	7	7	14	0	0	14	0	0
9	11532682	.	T	C	14	9	23	0	2	25	0	0
9	11532775	.	A	G	4	8	12	0	1	13	0	0
9	11532826	.	T	C	6	8	14	0	0	14	0	0
9	11906956	.	A	G	13	14	27	0	0	27	0	0
9	11907424	.	C	T	0	8	8	0	6	14	0	0
9	11907445	.	C	T	4	10	14	0	1	15	0	0
9	11907469	.	T	A	6	10	16	0	2	18	0	0
9	11907497	.	G	A	4	10	14	0	1	15	0	0
9	11907603	.	T	C	8	0	8	0	5	13	0	0
9	11908200	.	A	T	3	3	6	0	0	6	0	0
9	11908394	.	A	T	5	5	10	0	0	10	0	0
9	11908548	.	A	C	8	7	15	0	0	15	0	0
9	11908900	.	T	C	4	2	6	0	1	7	0	0
9	11909097	.	C	T	2	4	6	0	0	6	0	0
9	11909176	.	T	A	2	3	5	0	0	5	0	0
9	11909275	.	C	T	0	3	3	0	0	3	0	0
9	11909575	.	A	G	2	2	4	0	0	4	0	0
9	12263071	.	T	C	4	2	6	0	0	6	0	0
9	12263245	.	T	A	5	3	8	0	1	9	0	0
9	12265446	.	G	A	0	2	2	0	0	2	0	0
9	12667512	.	T	C	2	2	4	0	0	4	0	0
9	12667694	.	A	G	3	2	5	0	0	5	0	0
9	12667695	.	A	G	3	2	5	0	0	5	0	0
9	12669566	.	G	A	2	3	5	0	1	6	0	0
9	12864652	.	T	C	1	3	4	0	0	4	0	0
9	12866137	.	T	A	3	2	5	0	0	5	0	0
9	12868364	.	G	A	6	4	10	0	1	11	0	0
9	12868386	.	T	C	4	0	4	0	3	7	0	0
9	12871640	.	G	A	3	0	3	0	0	3	0	0
9	12874167	.	T	C	2	3	5	0	0	5	0	0
9	12874441	.	C	A	1	1	2	0	0	2	0	0
9	12883064	.	G	A	1	0	1	0	0	1	0	0
9	12944401	.	A	G	2	2	4	0	0	4	0	0
9	12944409	.	C	A	0	2	2	0	1	3	0	0
9	12944486	.	A	G	3	0	3	0	2	5	0	0
9	12944511	.	T	G	2	3	5	0	1	6	0	0
9	12944961	.	G	A	3	2	5	0	0	5	0	0
9	12944994	.	A	G	3	2	5	0	1	6	0	0
9	12945384	.	G	T	2	2	4	0	2	6	0	0
9	12945508	.	G	A	3	1	4	0	0	4	0	0
9	12945528	.	G	A	2	3	5	0	0	5	0	0
9	12945764	.	G	A	2	3	5	0	0	5	0	0
9	12946435	.	G	A	2	1	3	0	1	4	0	0
9	12946468	.	T	A	2	2	4	0	0	4	0	0
9	12946726	.	A	G	2	2	4	0	0	4	0	0
9	12946824	.	A	G	2	3	5	0	0	5	0	0
9	12947217	.	A	G	4	6	10	0	0	10	0	0
9	12947414	.	G	A	2	3	5	0	1	6	0	0
9	12947529	.	A	G	2	2	4	0	0	4	0	0
9	12947649	.	A	T	5	3	8	0	0	8	0	0
9	12947902	.	G	C	0	4	4	0	4	8	0	0
9	12948021	.	G	A	6	4	10	0	0	10	0	0
9	12948656	.	A	G	1	5	6	0	0	6	0	0
9	12948753	.	G	C	7	3	10	0	0	10	0	0
9	12948859	.	A	C	6	3	9	0	0	9	0	0
9	12951293	.	G	A	1	6	7	0	6	13	0	0
9	12953638	.	G	A	1	3	4	0	0	4	0	0
9	12953810	.	T	C	3	2	5	0	0	5	0	0
9	12960436	.	T	C	2	2	4	0	0	4	0	0
9	12960441	.	T	C	2	2	4	0	0	4	0	0
9	13106452	.	A	C	1	2	3	0	0	3	0	0
9	13106541	.	C	T	3	4	7	0	0	7	0	0
9	13106802	.	T	C	3	4	7	0	1	8	0	0
9	13107003	.	T	C	2	4	6	0	0	6	0	0
9	13107399	.	G	T	5	6	11	0	0	11	0	0
9	13107423	.	A	G	3	5	8	0	2	10	0	0
9	13107633	.	A	G	3	3	6	0	0	6	0	0
9	13110916	.	T	A	7	5	12	0	2	14	0	0
9	14003988	.	C	G	0	1	1	0	0	1	0	0
9	14023457	.	C	G	6	7	13	0	0	13	0	0
9	14023493	.	T	A	5	5	10	0	0	10	0	0
9	14023856	.	A	G	9	6	15	0	1	16	0	0
9	14027792	.	G	C	0	0	0	0	3	3	0	0
9	14027874	.	T	A	5	8	13	0	0	13	0	0
9	14027889	.	A	G	5	8	13	0	1	14	0	0
9	14028057	.	A	T	8	8	16	0	0	16	0	0
9	14028114	.	T	C	6	5	11	0	0	11	0	0
9	14037508	.	C	G	6	6	12	0	1	13	0	0
9	14037569	.	T	C	6	5	11	0	1	12	0	0
9	14038110	.	C	T	4	5	9	0	0	9	0	0
9	14038118	.	A	T	4	4	8	0	0	8	0	0
9	14038176	.	C	A	4	6	10	0	0	10	0	0
9	14038509	.	T	A	1	2	3	0	0	3	0	0
9	14040972	.	T	C	3	2	5	0	0	5	0	0
9	14112631	.	C	T	2	3	5	0	1	6	0	0
9	14112784	.	T	A	2	3	5	0	0	5	0	0
9	14136979	.	C	T	2	2	4	0	0	4	0	0
9	14195210	.	G	A	0	3	3	0	3	6	0	0
9	14195262	.	G	A	0	3	3	0	3	6	0	0
9	14196329	.	A	G	2	3	5	0	0	5	0	0
9	14196346	.	A	G	3	3	6	0	0	6	0	0
9	14196563	.	A	G	3	3	6	0	0	6	0	0
9	14196763	.	A	C	1	2	3	0	0	3	0	0
9	14196866	.	G	A	4	5	9	0	0	9	0	0
9	14196978	.	A	T	3	5	8	0	0	8	0	0
9	14197063	.	A	G	2	9	11	0	0	11	0	0
9	14367775	.	C	T	6	11	17	0	3	20	0	0
9	14367837	.	T	G	9	8	17	0	4	21	0	0
9	14367878	.	C	T	18	12	30	0	2	32	0	0
9	14368350	.	T	C	10	6	16	0	2	18	0	0
9	14368378	.	A	T	13	5	18	0	1	19	0	0
9	14368432	.	T	C	10	0	10	0	7	17	0	0
9	14368527	.	A	G	4	2	6	0	0	6	0	0
9	14368590	.	G	A	8	3	11	0	0	11	0	0
9	14368676	.	A	G	11	3	14	0	1	15	0	0
9	14368788	.	T	C	16	7	23	0	1	24	0	0
9	14368892	.	C	T	11	6	17	0	0	17	0	0
9	14368988	.	G	A	13	6	19	0	0	19	0	0
9	14369084	.	G	A	9	11	20	0	1	21	0	0
9	14369150	.	T	A	10	14	24	0	1	25	0	0
9	14381060	.	G	A	0	2	2	0	0	2	0	0
9	14381116	.	G	A	6	4	10	0	0	10	0	0
9	14381240	.	A	C	2	5	7	0	0	7	0	0
9	14411677	.	C	A	8	3	11	0	0	11	0	0
9	14433931	.	A	T	1	2	3	0	0	3	0	0
9	14442341	.	A	G	1	3	4	0	0	4	0	0
9	14443229	.	G	A	1	1	2	0	0	2	0	0
9	14446405	.	A	T	2	3	5	0	0	5	0	0
9	14469989	.	C	T	0	1	1	0	1	2	0	0
9	14469995	.	T	C	1	1	2	0	0	2	0	0
9	14504685	.	T	A	1	5	6	0	0	6	0	0
9	15363293	.	T	G	3	2	5	0	0	5	0	0
9	15363530	.	T	C	4	3	7	0	0	7	0	0
9	15363558	.	A	C	3	3	6	0	0	6	0	0
9	16127776	.	T	C	2	0	2	0	5	7	0	0
9	16128102	.	C	T	2	4	6	0	0	6	0	0
9	16132709	.	C	A	0	2	2	0	0	2	0	0
9	16241711	.	G	A	2	2	4	0	0	4	0	0
9	18005708	.	A	G	15	4	19	0	1	20	0	0
9	18005806	.	A	G	14	6	20	0	0	20	0	0
9	19406970	.	G	T	4	2	6	0	0	6	0	0
9	20174927	.	T	C	1	0	1	0	2	3	0	0
9	21404082	.	C	G	2	2	4	0	0	4	0	0
9	22797451	.	A	G	4	2	6	0	0	6	0	0
9	24189407	.	A	G	24	10	34	0	0	34	0	0
9	24190767	.	A	G	13	0	13	0	14	27	0	0
9	24190792	.	A	G	17	14	31	0	2	33	0	0
9	25837206	.	A	T	4	5	9	0	0	9	0	0
9	28341849	.	T	G	4	0	4	0	16	20	0	0
9	28818062	.	T	C	2	3	5	0	0	5	0	0
9	29636837	.	C	A	7	3	10	0	0	10	0	0
9	30106009	.	G	A	6	6	12	0	1	13	0	0
9	30106131	.	T	G	3	2	5	0	0	5	0	0
9	30236034	.	C	T	2	0	2	0	1	3	0	0
9	30780786	.	G	A	1	1	2	0	2	4	0	0
9	30780813	.	A	G	2	3	5	0	0	5	0	0
9	30783661	.	A	G	2	2	4	0	0	4	0	0
9	30783828	.	A	T	2	2	4	0	0	4	0	0
9	30800990	.	C	T	4	4	8	0	1	9	0	0
9	30806101	.	C	T	0	4	4	0	3	7	0	0
9	30806428	.	G	A	6	5	11	0	0	11	0	0
9	30806662	.	T	G	0	2	2	0	0	2	0	0
9	31042584	.	T	C	2	5	7	0	0	7	0	0
9	31062301	.	A	G	9	9	18	0	0	18	0	0
9	31214442	.	A	C	2	2	4	0	0	4	0	0
9	31239258	.	A	G	1	0	1	0	0	1	0	0
9	31248923	.	C	T	7	6	13	0	0	13	0	0
9	31258832	.	G	A	7	6	13	0	0	13	0	0
9	31268856	.	G	T	1	2	3	0	0	3	0	0
9	31274993	.	T	C	14	0	14	0	12	26	0	0
9	31276912	.	C	T	6	10	16	0	3	19	0	0
9	31286938	.	T	A	2	2	4	0	0	4	0	0
9	31510724	.	T	A	1	3	4	0	0	4	0	0
9	31518804	.	C	T	3	2	5	0	1	6	0	0
9	31524405	.	G	A	1	6	7	0	2	9	0	0
9	31524406	.	T	C	2	7	9	0	0	9	0	0
9	31586434	.	G	A	1	3	4	0	0	4	0	0
9	31595634	.	C	T	16	6	22	0	2	24	0	0
9	31604943	.	G	A	3	2	5	0	0	5	0	0
9	31606333	.	C	T	5	6	11	0	0	11	0	0
9	31612184	.	C	T	1	2	3	0	0	3	0	0
9	31617687	.	A	G	0	2	2	0	0	2	0	0
9	31619998	.	A	G	1	3	4	0	0	4	0	0
9	31639107	.	C	T	0	0	0	0	2	2	0	0
9	33411227	.	C	A	1	0	1	0	0	1	0	0
9	33411228	.	A	G	1	0	1	0	0	1	0	0
9	33861805	.	C	T	1	2	3	0	0	3	0	0
9	33861813	.	A	T	5	3	8	0	1	9	0	0
9	34112936	.	A	T	2	3	5	0	0	5	0	0
9	34112981	.	T	C	3	5	8	0	0	8	0	0
9	34113008	.	A	T	4	3	7	0	0	7	0	0
9	34113140	.	G	A	1	3	4	0	0	4	0	0
9	34116933	.	A	G	3	3	6	0	0	6	0	0
9	34117293	.	A	C	2	4	6	0	1	7	0	0
9	34117471	.	C	G	4	3	7	0	1	8	0	0
9	34120783	.	C	T	5	2	7	0	0	7	0	0
9	34154428	.	A	C	5	2	7	0	0	7	0	0
9	34154814	.	A	G	2	2	4	0	1	5	0	0
9	34161933	.	C	T	1	3	4	0	0	4	0	0
9	34162356	.	A	T	1	3	4	0	0	4	0	0
9	34174561	.	C	T	5	4	9	0	0	9	0	0
9	34174682	.	G	A	1	8	9	0	0	9	0	0
9	34179700	.	G	T	5	2	7	0	0	7	0	0
9	34189270	.	C	T	1	0	1	0	0	1	0	0
9	34189378	.	C	T	5	6	11	0	1	12	0	0
9	34189435	.	C	A	7	4	11	0	0	11	0	0
9	34189571	.	C	A	5	8	13	0	1	14	0	0
9	34191603	.	G	A	2	2	4	0	0	4	0	0
9	34200253	.	T	C	9	4	13	0	0	13	0	0
9	34204487	.	G	A	3	2	5	0	1	6	0	0
9	34204490	.	A	G	3	2	5	0	0	5	0	0
9	34218953	.	A	G	1	2	3	0	0	3	0	0
9	34225055	.	A	G	6	4	10	0	0	10	0	0
9	34225250	.	T	C	8	12	20	0	1	21	0	0
9	34225316	.	G	C	0	9	9	0	0	9	0	0
9	34226955	.	C	A	24	11	35	0	1	36	0	0
9	34226960	.	A	C	25	14	39	0	0	39	0	0
9	34227195	.	G	T	21	7	28	0	0	28	0	0
9	34238825	.	T	A	2	4	6	0	0	6	0	0
9	34239227	.	G	A	1	2	3	0	1	4	0	0
9	34242433	.	T	C	3	0	3	0	0	3	0	0
9	34242935	.	T	G	1	0	1	0	1	2	0	0
9	34242953	.	G	T	2	2	4	0	0	4	0	0
9	34243196	.	C	G	8	7	15	0	1	16	0	0
9	34243310	.	A	G	6	6	12	0	0	12	0	0
9	34243352	.	C	T	7	7	14	0	0	14	0	0
9	34243549	.	A	G	3	0	3	0	7	10	0	0
9	34243681	.	C	T	7	10	17	0	0	17	0	0
9	34243701	.	C	G	7	9	16	0	0	16	0	0
9	34243775	.	T	C	5	2	7	0	0	8	1	0
9	34246564	.	A	G	10	5	15	0	0	15	0	0
9	34246762	.	G	A	8	7	15	0	0	15	0	0
9	34247035	.	A	T	24	0	24	0	0	34	10	0
9	34247042	.	G	A	23	13	36	0	0	36	0	0
9	34247145	.	A	T	14	16	30	0	2	32	0	0
9	34247356	.	G	A	3	6	9	0	1	10	0	0
9	34251632	.	G	A	6	3	9	0	1	10	0	0
9	34251635	.	C	A	1	2	3	0	7	10	0	0
9	34251707	.	C	G	13	14	27	0	0	27	0	0
9	34254325	.	C	T	2	3	5	0	0	5	0	0
9	34254678	.	A	G	4	1	5	0	0	5	0	0
9	34254685	.	G	A	3	1	4	0	1	5	0	0
9	34254851	.	A	G	1	3	4	0	0	4	0	0
9	34254875	.	T	C	1	3	4	0	0	4	0	0
9	34256016	.	A	C	1	0	1	0	0	1	0	0
9	34257954	.	T	A	1	1	2	0	0	2	0	0
9	34258106	.	C	T	2	0	2	0	0	2	0	0
9	34258642	.	G	A	2	3	5	0	0	5	0	0
9	34259343	.	G	A	2	2	4	0	1	5	0	0
9	34259406	.	T	A	2	3	5	0	0	5	0	0
9	34259418	.	T	A	4	3	7	0	0	7	0	0
9	34274897	.	G	C	2	2	4	0	0	4	0	0
9	34277333	.	A	G	1	3	4	0	1	5	0	0
9	34277562	.	A	T	1	2	3	0	0	3	0	0
9	34334173	.	T	G	2	0	2	0	0	2	0	0
9	34335327	.	G	T	0	2	2	0	1	3	0	0
9	34335510	.	G	T	1	1	2	0	0	2	0	0
9	34343983	.	A	G	4	4	8	0	0	8	0	0
9	34346443	.	T	C	4	4	8	0	0	8	0	0
9	34351171	.	G	A	5	6	11	0	0	11	0	0
9	34351273	.	T	G	4	1	5	0	1	6	0	0
9	34351277	.	T	C	4	0	4	0	1	5	0	0
9	34351416	.	A	C	8	6	14	0	1	15	0	0
9	34351811	.	A	G	6	4	10	0	0	10	0	0
9	34351845	.	T	A	5	2	7	0	0	7	0	0
9	34351916	.	C	T	4	2	6	0	0	6	0	0
9	34380457	.	A	G	5	7	12	0	0	12	0	0
9	34382946	.	A	C	7	9	16	0	0	16	0	0
9	34382994	.	G	A	0	9	9	0	2	11	0	0
9	34383041	.	C	A	0	3	3	0	0	3	0	0
9	34385012	.	C	T	3	5	8	0	0	8	0	0
9	34385364	.	G	T	7	6	13	0	0	13	0	0
9	34385421	.	A	C	19	8	27	0	1	28	0	0
9	34388784	.	T	G	22	11	33	0	1	34	0	0
9	34388798	.	T	G	22	0	22	0	9	31	0	0
9	34388882	.	G	A	12	20	32	0	0	32	0	0
9	34389317	.	T	A	16	9	25	0	1	26	0	0
9	34389379	.	C	T	18	18	36	0	3	39	0	0
9	34389457	.	C	A	14	21	35	0	1	36	0	0
9	34389602	.	A	G	22	1	23	0	24	47	0	0
9	34389734	.	G	C	1	12	13	0	17	30	0	0
9	34401847	.	G	T	1	0	1	0	0	1	0	0
9	34405155	.	A	G	1	0	1	0	0	1	0	0
9	34407893	.	C	A	0	1	1	0	0	1	0	0
9	34412701	.	G	C	0	0	0	0	1	1	0	0
9	34415308	.	T	C	5	5	10	0	0	10	0	0
9	34419094	.	T	C	9	7	16	0	1	17	0	0
9	34423593	.	G	T	2	2	4	0	0	4	0	0
9	34425996	.	G	A	3	0	3	0	0	3	0	0
9	34427840	.	C	T	2	2	4	0	1	5	0	0
9	34427846	.	C	T	2	2	4	0	1	5	0	0
9	34438861	.	T	G	1	1	2	0	0	2	0	0
9	34451141	.	G	A	0	1	1	0	0	1	0	0
9	34451168	.	C	A	0	1	1	0	0	1	0	0
9	34452052	.	C	A	6	6	12	0	0	12	0	0
9	34452057	.	G	A	0	6	6	0	6	12	0	0
9	34461340	.	A	G	4	0	4	0	4	8	0	0
9	34466229	.	G	A	0	3	3	0	13	16	0	0
9	34470776	.	T	C	2	2	4	0	0	4	0	0
9	34472180	.	C	T	5	3	8	0	1	9	0	0
9	34474434	.	G	T	2	1	3	0	0	3	0	0
9	34474529	.	A	G	5	1	6	0	6	12	0	0
9	34484660	.	C	A	0	2	2	0	2	4	0	0
9	34484669	.	C	T	3	1	4	0	1	5	0	0
9	34484859	.	T	A	7	5	12	0	1	13	0	0
9	34484949	.	T	C	6	12	18	0	0	18	0	0
9	34484959	.	T	C	4	11	15	0	0	15	0	0
9	34484997	.	A	T	4	6	10	0	0	10	0	0
9	34485036	.	T	C	2	7	9	0	0	9	0	0
9	34485105	.	G	T	6	6	12	0	1	13	0	0
9	34485123	.	T	C	5	8	13	0	0	13	0	0
9	34485168	.	C	T	0	3	3	0	2	5	0	0
9	34488459	.	T	C	0	0	0	0	1	1	0	0
9	34490692	.	A	G	2	2	4	0	1	5	0	0
9	34647415	.	A	G	13	1	14	0	18	32	0	0
9	34647427	.	A	C	14	18	32	0	1	33	0	0
9	34866579	.	T	G	10	8	18	0	2	20	0	0
9	34866684	.	T	A	5	6	11	0	1	12	0	0
9	34866888	.	C	T	18	14	32	0	1	33	0	0
9	34867007	.	C	A	0	13	13	0	9	22	0	0
9	34867015	.	T	C	8	0	8	0	13	21	0	0
9	34869699	.	A	G	11	10	21	0	0	21	0	0
9	34869813	.	G	A	7	9	16	0	1	17	0	0
9	34869945	.	G	A	1	3	4	0	1	6	1	0
9	34877042	.	G	A	1	1	2	0	0	2	0	0
9	34877285	.	G	A	1	2	3	0	0	3	0	0
9	34877315	.	G	A	2	4	6	0	0	6	0	0
9	34878233	.	T	A	0	1	1	0	0	1	0	0
9	34903218	.	T	G	30	18	48	0	1	49	0	0
9	34906337	.	C	G	33	20	53	0	3	56	0	0
9	34912626	.	A	T	6	5	11	0	1	12	0	0
9	34912695	.	T	C	7	0	7	0	2	9	0	0
9	34912895	.	T	A	10	9	19	0	0	19	0	0
9	34920395	.	G	A	7	5	12	0	0	12	0	0
9	34922670	.	C	T	0	1	1	0	4	5	0	0
9	34922898	.	A	G	0	1	1	0	0	1	0	0
9	34938795	.	C	T	9	14	23	0	0	23	0	0
9	34939336	.	A	G	8	6	14	0	0	14	0	0
9	34939800	.	T	C	5	8	13	0	0	13	0	0
9	34967565	.	A	G	7	8	15	0	0	15	0	0
9	34967647	.	C	T	3	4	7	0	0	7	0	0
9	34967649	.	C	T	3	4	7	0	0	7	0	0
9	34967733	.	A	G	4	8	12	0	0	12	0	0
9	34967743	.	A	C	4	7	11	0	0	11	0	0
9	35014847	.	C	G	1	1	2	0	0	2	0	0
9	35022050	.	A	G	4	5	9	0	0	9	0	0
9	35024459	.	G	C	1	4	5	0	6	11	0	0
9	35025183	.	C	T	6	11	17	0	0	17	0	0
9	35025243	.	A	T	8	6	14	0	0	14	0	0
9	35026736	.	T	A	24	33	57	0	3	60	0	0
9	35026941	.	T	C	28	29	57	0	2	59	0	0
9	35027262	.	A	G	38	24	62	0	2	64	0	0
9	35027309	.	T	C	29	1	30	0	28	58	0	0
9	35027333	.	A	G	30	24	54	0	4	58	0	0
9	35027365	.	G	T	37	18	55	0	4	59	0	0
9	35027371	.	G	T	39	20	59	0	2	62	1	0
9	35027402	.	G	A	37	22	59	0	0	59	0	0
9	35027549	.	T	G	32	30	62	0	6	68	0	0
9	35027705	.	G	A	30	6	36	0	0	36	0	0
9	35028086	.	T	C	33	2	35	0	38	73	0	0
9	35028282	.	T	C	38	4	42	0	42	84	0	0
9	35030977	.	G	A	43	17	60	0	1	61	0	0
9	35032640	.	A	G	3	3	6	0	0	6	0	0
9	35032643	.	A	G	4	5	9	0	0	9	0	0
9	35033347	.	C	T	24	15	39	0	6	45	0	0
9	35039175	.	T	C	19	17	36	0	0	36	0	0
9	35048839	.	G	C	17	24	41	0	1	42	0	0
9	35048840	.	A	C	18	23	41	0	1	42	0	0
9	35170671	.	G	A	13	14	27	0	0	27	0	0
9	35176030	.	A	G	18	18	36	0	1	37	0	0
9	35228165	.	G	A	4	3	7	0	1	8	0	0
9	35254679	.	G	A	2	1	3	0	0	3	0	0
9	35266330	.	C	T	0	4	4	0	2	6	0	0
9	35296835	.	C	T	0	1	1	0	0	1	0	0
9	35836674	.	T	G	4	5	9	0	0	9	0	0
9	35836721	.	T	A	5	7	12	0	0	12	0	0
9	35837194	.	C	G	4	0	4	0	8	12	0	0
9	35838477	.	T	A	14	16	30	0	0	30	0	0
9	35840713	.	G	A	8	6	14	0	0	14	0	0
9	35840782	.	T	C	4	10	14	0	0	14	0	0
9	35840900	.	T	A	12	7	19	0	9	28	0	0
9	35841115	.	T	G	1	3	4	0	0	4	0	0
9	35841279	.	G	T	3	4	7	0	0	7	0	0
9	35841282	.	A	G	3	4	7	0	0	7	0	0
9	35841663	.	G	T	7	8	15	0	1	16	0	0
9	35841879	.	T	A	16	12	28	0	0	28	0	0
9	35841994	.	A	G	6	8	14	0	0	14	0	0
9	35842164	.	T	A	10	14	24	0	1	25	0	0
9	35842209	.	G	T	8	10	18	0	0	18	0	0
9	35862184	.	A	T	3	0	3	0	0	3	0	0
9	35862299	.	G	A	9	13	22	0	0	22	0	0
9	35863132	.	C	T	4	18	22	0	1	23	0	0
9	35863555	.	T	C	14	17	31	0	0	31	0	0
9	35863603	.	T	C	16	16	32	0	1	33	0	0
9	35863798	.	C	T	7	23	30	0	0	30	0	0
9	35863968	.	A	T	16	11	27	0	0	27	0	0
9	35864155	.	A	T	11	6	17	0	1	18	0	0
9	35864210	.	C	T	6	8	14	0	0	14	0	0
9	35864266	.	C	A	5	12	17	0	0	17	0	0
9	35864277	.	C	T	6	13	19	0	0	19	0	0
9	35864356	.	A	G	3	4	7	0	0	7	0	0
9	35864416	.	A	C	3	2	5	0	0	5	0	0
9	35864486	.	C	T	6	0	6	0	0	6	0	0
9	35864565	.	A	G	8	1	9	0	0	9	0	0
9	35864598	.	C	T	8	3	11	0	0	11	0	0
9	35865073	.	C	T	22	17	39	0	1	40	0	0
9	35865162	.	G	T	10	10	20	0	1	21	0	0
9	35865270	.	C	G	15	9	24	0	1	25	0	0
9	35872927	.	G	A	2	3	5	0	0	5	0	0
9	35872942	.	G	A	4	3	7	0	0	7	0	0
9	35872993	.	A	T	5	6	11	0	0	11	0	0
9	35873884	.	A	G	2	2	4	0	0	4	0	0
9	35901654	.	T	A	1	0	1	0	1	2	0	0
9	35907553	.	C	T	1	1	2	0	0	2	0	0
9	35910390	.	C	G	1	1	2	0	0	2	0	0
9	35910672	.	T	C	0	3	3	0	0	3	0	0
9	35912447	.	A	T	3	3	6	0	0	6	0	0
9	35912459	.	G	A	2	6	8	0	0	8	0	0
9	35912661	.	G	C	1	3	4	0	0	4	0	0
9	35915548	.	C	T	5	8	13	0	1	14	0	0
9	35915557	.	G	A	1	7	8	0	4	12	0	0
9	35916518	.	T	G	0	2	2	0	0	2	0	0
9	35916786	.	G	A	5	3	8	0	1	9	0	0
9	35922046	.	T	G	13	23	36	0	0	36	0	0
9	35922115	.	T	C	10	16	26	0	3	29	0	0
9	36610121	.	A	G	1	0	1	0	0	1	0	0
9	36610202	.	C	T	1	2	3	0	0	3	0	0
9	36613178	.	C	T	2	1	3	0	0	3	0	0
9	36656011	.	A	G	2	0	2	0	0	2	0	0
9	36659702	.	T	G	4	4	8	0	0	8	0	0
9	36896432	.	T	C	5	3	8	0	0	8	0	0
9	36896761	.	C	A	0	3	3	0	4	7	0	0
9	36896791	.	C	T	3	5	8	0	0	8	0	0
9	36898724	.	C	T	2	5	7	0	3	10	0	0
9	36899065	.	C	T	0	6	6	0	13	19	0	0
9	36972858	.	A	G	1	0	1	0	2	3	0	0
9	36973147	.	T	C	2	2	4	0	0	4	0	0
9	36973515	.	G	A	2	2	4	0	0	4	0	0
9	36973841	.	C	G	1	4	5	0	0	5	0	0
9	36974170	.	G	T	2	3	5	0	0	5	0	0
9	36974191	.	T	C	3	2	5	0	0	5	0	0
9	36974460	.	C	T	5	5	10	0	0	10	0	0
9	37296454	.	T	A	2	2	4	0	0	4	0	0
9	37341667	.	A	G	2	2	4	0	0	4	0	0
9	37354220	.	A	G	0	1	1	0	0	1	0	0
9	37390314	.	C	T	1	1	2	0	0	2	0	0
9	37416605	.	C	T	0	1	1	0	0	1	0	0
9	37416617	.	C	T	0	1	1	0	0	1	0	0
9	37451809	.	A	G	8	6	14	0	2	16	0	0
9	37452012	.	A	T	12	3	15	0	0	15	0	0
9	37452223	.	C	T	8	3	11	0	1	12	0	0
9	37452432	.	G	A	7	7	14	0	2	16	0	0
9	37452499	.	T	G	15	9	24	0	0	24	0	0
9	37452515	.	G	T	15	10	25	0	0	25	0	0
9	37452616	.	T	G	14	11	25	0	2	28	1	0
9	37452765	.	T	G	15	6	21	0	0	21	0	0
9	37452767	.	A	C	14	5	19	0	1	20	0	0
9	37452819	.	G	C	11	5	16	0	1	17	0	0
9	37452862	.	T	C	10	14	24	0	0	24	0	0
9	37452924	.	C	G	9	8	17	0	3	20	0	0
9	37492798	.	G	A	0	5	5	0	0	5	0	0
9	37492807	.	A	G	0	4	4	0	1	5	0	0
9	37850479	.	G	C	4	2	6	0	0	6	0	0
9	37850559	.	T	A	2	2	4	0	0	4	0	0
9	37850574	.	A	G	0	0	0	0	1	1	0	0
9	37853970	.	A	C	2	3	5	0	0	5	0	0
9	37856541	.	C	T	8	9	17	0	0	17	0	0
9	37856895	.	T	A	1	4	5	0	1	6	0	0
9	37859807	.	G	T	5	5	10	0	1	11	0	0
9	37859881	.	T	G	12	12	24	0	1	25	0	0
9	37860116	.	T	C	4	4	8	0	0	8	0	0
9	37860645	.	A	T	1	6	7	0	0	7	0	0
9	37860712	.	C	T	2	7	9	0	0	9	0	0
9	37861307	.	G	A	0	5	5	0	3	8	0	0
9	37861458	.	T	G	8	3	11	0	0	11	0	0
9	37861490	.	A	T	2	5	7	0	1	8	0	0
9	37861560	.	A	G	3	0	3	0	4	7	0	0
9	37861763	.	G	T	2	2	4	0	0	4	0	0
9	37861834	.	G	A	6	2	8	0	0	8	0	0
9	37861844	.	G	A	2	6	8	0	0	8	0	0
9	37862065	.	T	G	1	0	1	0	8	9	0	0
9	37862333	.	C	A	6	4	10	0	0	10	0	0
9	37862376	.	T	C	2	2	4	0	1	5	0	0
9	37941602	.	C	T	0	1	1	0	0	1	0	0
9	38021242	.	C	T	1	2	3	0	0	3	0	0
9	38021291	.	A	T	1	2	3	0	0	3	0	0
9	38030131	.	A	T	15	12	27	0	3	30	0	0
9	38030366	.	A	T	9	10	19	0	2	21	0	0
9	38030485	.	A	T	4	7	11	0	1	12	0	0
9	38030503	.	C	T	1	6	7	0	6	13	0	0
9	38030574	.	G	A	14	10	24	0	1	25	0	0
9	38033363	.	T	C	18	0	18	0	13	31	0	0
9	38033578	.	A	G	2	1	3	0	0	3	0	0
9	38042752	.	G	A	2	3	5	0	0	5	0	0
9	38043476	.	T	C	1	3	4	0	0	4	0	0
9	38057075	.	A	G	4	0	4	0	0	4	0	0
9	38059042	.	C	T	1	1	2	0	0	2	0	0
9	38061525	.	G	T	1	2	3	0	4	7	0	0
9	38061699	.	T	C	0	3	3	0	2	5	0	0
9	38061788	.	T	C	3	5	8	0	1	9	0	0
9	38063688	.	C	A	6	6	12	0	0	12	0	0
9	38063689	.	C	A	6	6	12	0	0	12	0	0
9	38064165	.	A	T	4	5	9	0	1	10	0	0
9	38064268	.	T	C	7	8	15	0	0	15	0	0
9	38064420	.	T	G	5	5	10	0	0	10	0	0
9	38064421	.	C	A	5	5	10	0	0	10	0	0
9	38064672	.	A	C	6	8	14	0	0	14	0	0
9	38129312	.	C	G	4	3	7	0	0	7	0	0
9	38140963	.	C	A	0	2	2	0	3	5	0	0
9	38142493	.	A	G	0	1	1	0	0	1	0	0
9	38161842	.	C	T	5	3	8	0	0	8	0	0
9	38161905	.	G	A	0	2	2	0	0	2	0	0
9	38161975	.	T	G	1	2	3	0	0	3	0	0
9	38167747	.	T	G	3	2	5	0	1	6	0	0
9	38167761	.	G	A	3	2	5	0	0	5	0	0
9	38238917	.	G	A	0	2	2	0	2	4	0	0
9	38251409	.	T	C	3	2	5	0	0	5	0	0
9	38269630	.	A	G	2	3	5	0	0	5	0	0
9	38273171	.	G	A	9	4	13	0	0	13	0	0
9	38273264	.	T	A	1	5	6	0	0	6	0	0
9	38277513	.	A	G	2	3	5	0	0	5	0	0
9	38278121	.	A	G	2	0	2	0	0	2	0	0
9	38278289	.	C	T	8	12	20	0	1	21	0	0
9	38278301	.	T	C	9	9	18	0	0	18	0	0
9	38278337	.	T	C	3	3	6	0	0	6	0	0
9	38283647	.	G	A	10	6	16	0	1	17	0	0
9	38283659	.	C	T	10	7	17	0	0	17	0	0
9	38284317	.	A	G	9	1	10	0	9	19	0	0
9	38285598	.	A	G	7	8	15	0	0	15	0	0
9	38286823	.	G	A	8	7	15	0	1	16	0	0
9	38290165	.	C	T	11	10	21	0	0	21	0	0
9	38290210	.	A	G	8	9	17	0	2	19	0	0
9	38290220	.	T	G	11	1	12	0	8	20	0	0
9	38290245	.	C	T	13	12	25	0	1	26	0	0
9	38290414	.	A	G	16	7	23	0	0	23	0	0
9	38290517	.	A	C	14	5	19	0	0	19	0	0
9	38290561	.	C	T	7	3	10	0	0	10	0	0
9	38290777	.	G	T	0	13	13	0	15	28	0	0
9	38290959	.	A	C	22	22	44	0	2	46	0	0
9	38291439	.	G	T	20	18	38	0	2	40	0	0
9	38291616	.	C	T	11	13	24	0	2	26	0	0
9	38291737	.	C	A	10	6	16	0	4	20	0	0
9	38315128	.	T	G	4	3	7	0	0	7	0	0
9	38316758	.	G	A	3	0	3	0	2	5	0	0
9	38316769	.	T	C	2	2	4	0	0	4	0	0
9	38348252	.	G	A	3	2	5	0	0	5	0	0
9	38351016	.	T	C	6	6	12	0	1	13	0	0
9	38353794	.	T	C	6	10	16	0	0	16	0	0
9	38354000	.	T	C	6	6	12	0	0	12	0	0
9	38354224	.	A	G	6	2	8	0	0	8	0	0
9	38354689	.	G	A	3	2	5	0	0	5	0	0
9	38359737	.	G	A	0	1	1	0	1	2	0	0
9	38360102	.	C	T	0	4	4	0	2	6	0	0
9	38362354	.	G	A	2	5	7	0	0	7	0	0
9	38362380	.	C	T	1	5	6	0	0	6	0	0
9	38366826	.	A	G	1	2	3	0	0	3	0	0
9	38368055	.	A	G	1	2	3	0	0	3	0	0
9	38372264	.	C	T	0	1	1	0	1	2	0	0
9	38376006	.	G	A	1	0	1	0	1	2	0	0
9	38376129	.	A	T	2	0	2	0	0	2	0	0
9	38377858	.	G	A	0	1	1	0	0	1	0	0
9	38385734	.	G	A	0	1	1	0	0	1	0	0
9	38386205	.	C	T	0	3	3	0	0	3	0	0
9	38386615	.	C	A	2	5	7	0	2	9	0	0
9	38388492	.	C	T	6	7	13	0	0	13	0	0
9	38388493	.	C	T	2	7	9	0	4	13	0	0
9	38388703	.	T	C	6	5	11	0	5	16	0	0
9	38389026	.	T	A	6	3	9	0	0	9	0	0
9	38389194	.	C	T	11	11	22	0	0	22	0	0
9	38389263	.	T	A	6	6	12	0	5	17	0	0
9	38389426	.	G	A	13	15	28	0	1	29	0	0
9	38389603	.	A	G	11	1	12	0	6	18	0	0
9	38389616	.	C	T	14	8	22	0	0	22	0	0
9	38389644	.	A	T	11	6	17	0	1	18	0	0
9	38389722	.	G	T	10	4	14	0	3	17	0	0
9	38389746	.	T	C	10	7	17	0	1	18	0	0
9	38389800	.	T	C	9	2	11	1	2	14	0	0
9	38389886	.	C	T	6	8	14	0	1	15	0	0
9	38391549	.	C	T	3	4	7	0	0	7	0	0
9	38400232	.	T	A	1	2	3	0	1	4	0	0
9	38400233	.	T	C	0	3	3	0	1	4	0	0
9	38405238	.	A	G	4	4	8	0	0	8	0	0
9	38405271	.	G	C	4	2	6	0	0	6	0	0
9	38418864	.	T	C	4	4	8	0	0	8	0	0
9	38425334	.	T	A	1	2	3	0	1	4	0	0
9	38429874	.	G	A	1	3	4	0	0	4	0	0
9	38456782	.	C	T	1	0	1	0	0	1	0	0
9	38470376	.	C	T	1	2	3	0	0	3	0	0
9	38475598	.	T	C	2	2	4	0	0	4	0	0
9	38476650	.	A	C	2	1	3	0	1	4	0	0
9	38478252	.	A	G	1	1	2	0	0	2	0	0
9	38478424	.	T	C	4	2	6	0	0	6	0	0
9	38478643	.	A	T	3	5	8	0	0	8	0	0
9	38479579	.	A	G	5	0	5	0	1	6	0	0
9	38481034	.	G	A	1	3	4	0	0	4	0	0
9	38502683	.	A	T	1	2	3	0	0	3	0	0
9	38550889	.	T	C	3	9	12	0	0	12	0	0
9	38550910	.	T	C	3	6	9	0	0	9	0	0
9	38600006	.	G	A	0	1	1	0	0	1	0	0
9	38603338	.	A	T	0	1	1	0	0	1	0	0
9	38620058	.	C	T	13	11	24	0	0	24	0	0
9	38620308	.	C	A	6	5	11	0	0	11	0	0
9	38620673	.	A	G	13	18	31	0	0	31	0	0
9	38629997	.	T	A	1	1	2	0	0	2	0	0
9	38635435	.	G	A	0	1	1	0	0	1	0	0
9	38636152	.	A	G	1	0	1	0	4	5	0	0
9	38636170	.	A	G	1	5	6	0	0	6	0	0
9	38636413	.	G	T	1	4	5	0	3	8	0	0
9	38636722	.	T	C	3	3	6	0	0	6	0	0
9	38636797	.	T	C	6	4	10	0	1	11	0	0
9	38637872	.	T	C	2	3	5	0	0	5	0	0
9	38637879	.	A	C	2	2	4	0	0	4	0	0
9	38638197	.	C	T	5	7	12	0	0	12	0	0
9	38638397	.	G	T	6	3	9	0	0	9	0	0
9	38638452	.	A	T	10	9	19	0	1	20	0	0
9	38638461	.	C	G	10	10	20	0	0	20	0	0
9	38638492	.	A	G	9	1	10	0	7	17	0	0
9	38638518	.	T	C	5	8	13	0	2	15	0	0
9	38638743	.	T	C	6	7	13	0	0	13	0	0
9	38638862	.	C	T	8	5	13	0	0	13	0	0
9	38638863	.	C	A	7	5	12	0	1	13	0	0
9	38638970	.	G	A	5	7	12	0	0	12	0	0
9	38639799	.	T	C	6	7	13	0	0	13	0	0
9	38639846	.	C	T	4	10	14	0	0	14	0	0
9	38639907	.	A	C	4	8	12	0	0	12	0	0
9	38639999	.	C	T	5	4	9	0	0	9	0	0
9	38640114	.	T	A	10	5	15	0	0	15	0	0
9	38640186	.	T	C	5	7	12	0	0	12	0	0
9	38640193	.	T	C	5	6	11	0	0	11	0	0
9	38640598	.	A	G	4	0	4	0	3	7	0	0
9	38640773	.	A	T	4	6	10	0	2	12	0	0
9	38641111	.	C	T	6	3	9	0	0	9	0	0
9	38641196	.	C	G	1	2	3	0	0	3	0	0
9	40928199	.	T	C	3	15	18	0	0	18	0	0
9	40928245	.	T	C	13	8	21	0	0	21	0	0
9	40928284	.	T	C	9	0	9	0	7	16	0	0
9	40928706	.	T	C	3	4	7	0	1	8	0	0
9	40928717	.	T	C	4	5	9	0	0	9	0	0
9	40930319	.	T	C	5	5	10	0	0	10	0	0
9	41479980	.	A	G	5	2	7	0	0	7	0	0
9	41680581	.	A	G	23	13	36	0	1	37	0	0
9	42125881	.	A	T	6	2	8	0	0	8	0	0
9	42360686	.	T	G	3	4	7	1	0	8	0	0
9	42360743	.	C	G	5	10	15	0	1	16	0	0
9	42360893	.	C	T	0	7	7	0	5	12	0	0
9	42360899	.	G	A	4	6	10	0	0	10	0	0
9	42372423	.	G	A	0	1	1	0	0	1	0	0
9	42421044	.	G	T	5	5	10	0	0	10	0	0
9	42644892	.	A	G	2	0	2	0	8	10	0	0
9	42649583	.	A	G	3	4	7	0	1	8	0	0
9	42649636	.	T	A	3	3	6	0	0	6	0	0
9	42649653	.	T	C	4	3	7	0	0	7	0	0
9	42649739	.	C	T	6	6	12	0	0	12	0	0
9	42649743	.	A	G	6	5	11	0	1	12	0	0
9	42649923	.	A	G	3	10	13	0	0	13	0	0
9	42653475	.	A	T	1	2	3	0	0	3	0	0
9	42653737	.	T	C	2	3	5	0	0	5	0	0
9	42657418	.	A	T	2	2	4	0	0	4	0	0
9	42658788	.	A	G	3	1	4	0	0	4	0	0
9	42658818	.	T	C	1	0	1	0	1	2	0	0
9	42730451	.	A	C	2	1	3	0	0	3	0	0
9	43082319	.	T	A	1	3	4	0	0	4	0	0
9	43082373	.	A	T	5	4	9	0	0	9	0	0
9	43082398	.	A	G	3	2	5	0	0	5	0	0
9	43082519	.	C	A	0	2	2	0	1	3	0	0
9	43085369	.	G	T	2	5	7	0	0	7	0	0
9	43085471	.	G	C	6	2	8	0	0	8	0	0
9	43085879	.	C	T	4	4	8	0	0	8	0	0
9	43088910	.	A	T	4	4	8	0	0	8	0	0
9	43113607	.	T	A	1	0	1	0	0	1	0	0
9	43150018	.	T	A	10	7	17	0	5	22	0	0
9	43150278	.	T	G	15	16	31	0	4	35	0	0
9	43150604	.	A	G	20	9	29	0	1	30	0	0
9	43150817	.	C	T	0	17	17	0	16	33	0	0
9	43153287	.	C	T	5	4	9	0	1	10	0	0
9	43154841	.	C	T	5	4	9	0	0	9	0	0
9	43202097	.	T	C	1	0	1	0	3	4	0	0
9	43243224	.	T	G	4	3	7	0	0	7	0	0
9	43261951	.	T	A	6	6	12	0	0	12	0	0
9	43375122	.	G	A	1	3	4	0	0	4	0	0
9	43552604	.	C	A	7	5	12	0	1	13	0	0
9	43552687	.	A	C	8	5	13	0	2	15	0	0
9	43553036	.	G	T	15	13	28	0	1	29	0	0
9	43559501	.	A	C	11	6	17	0	0	17	0	0
9	43612482	.	T	G	1	3	4	0	0	4	0	0
9	43617899	.	A	G	2	2	4	0	0	4	0	0
9	43617962	.	A	G	4	5	9	0	0	9	0	0
9	44080166	.	G	A	1	1	2	0	1	3	0	0
9	44080411	.	C	T	0	3	3	0	0	3	0	0
9	44094445	.	T	A	3	2	5	0	0	5	0	0
9	44097854	.	C	T	0	1	1	0	0	1	0	0
9	44109260	.	A	G	0	2	2	0	0	2	0	0
9	44109589	.	T	C	1	0	1	0	2	3	0	0
9	44109595	.	T	C	0	0	0	0	3	3	0	0
9	44249897	.	C	T	3	4	7	0	0	7	0	0
9	44292285	.	A	C	29	0	29	0	20	49	0	0
9	44292737	.	T	C	27	31	58	0	2	60	0	0
9	44292909	.	C	T	0	30	30	0	23	53	0	0
9	44293488	.	C	T	22	22	44	0	1	45	0	0
9	44294792	.	A	G	5	1	6	0	1	7	0	0
9	44400091	.	T	G	1	2	3	0	0	3	0	0
9	44400580	.	G	A	4	6	10	0	0	10	0	0
9	44411647	.	A	G	3	6	9	0	2	11	0	0
9	44411652	.	C	A	4	5	9	0	2	11	0	0
9	44411828	.	A	C	2	2	4	0	0	4	0	0
9	44419652	.	T	A	7	6	13	0	1	14	0	0
9	44419793	.	C	A	7	4	11	0	2	13	0	0
9	44420236	.	C	T	9	7	16	0	3	19	0	0
9	44469318	.	A	G	1	0	1	0	1	2	0	0
9	44486011	.	A	G	6	3	9	0	2	11	0	0
9	44488578	.	T	A	4	8	12	0	0	12	0	0
9	44488620	.	G	A	2	3	5	0	0	5	0	0
9	44489843	.	G	A	0	9	9	0	5	14	0	0
9	44489844	.	T	A	5	9	14	0	0	14	0	0
9	44498332	.	T	C	3	8	11	0	2	13	0	0
9	44509181	.	G	A	0	2	2	0	0	2	0	0
9	44511218	.	C	T	1	1	2	0	0	2	0	0
9	44515937	.	G	A	2	6	8	0	0	8	0	0
9	44526546	.	G	A	2	3	5	0	0	5	0	0
9	44641974	.	A	T	5	6	11	0	1	12	0	0
9	44642017	.	G	A	6	4	10	0	0	10	0	0
9	44838292	.	A	G	2	5	7	0	0	7	0	0
9	44961166	.	A	G	4	5	9	0	0	9	0	0
9	45504357	.	A	C	2	2	4	0	0	4	0	0
9	45523190	.	G	A	0	2	2	0	0	2	0	0
9	45541036	.	C	A	3	2	5	0	0	5	0	0
9	45541239	.	G	A	2	2	4	0	1	5	0	0
9	45551273	.	T	C	13	10	23	0	1	24	0	0
9	45552338	.	T	G	11	6	17	0	0	17	0	0
9	45552364	.	G	A	0	5	5	0	7	12	0	0
9	45552386	.	C	G	6	8	14	0	1	15	0	0
9	45552567	.	G	A	1	14	15	0	18	33	0	0
9	45552715	.	C	T	21	12	33	0	1	34	0	0
9	45552806	.	G	A	0	16	16	0	19	35	0	0
9	45552881	.	T	C	14	13	27	0	0	27	0	0
9	45552924	.	C	A	10	12	22	0	1	23	0	0
9	45552957	.	C	T	13	11	24	0	0	24	0	0
9	45623346	.	C	T	2	3	5	0	0	5	0	0
9	45623446	.	A	G	3	4	7	0	1	8	0	0
9	45633108	.	C	G	0	1	1	0	0	1	0	0
9	45666600	.	G	A	4	1	5	0	0	5	0	0
9	45667473	.	C	T	2	3	5	0	0	5	0	0
9	45884711	.	G	A	3	2	5	0	0	5	0	0
9	45884768	.	T	G	3	2	5	0	0	5	0	0
9	45968318	.	A	G	1	2	3	0	0	3	0	0
9	45975846	.	C	T	0	5	5	0	1	6	0	0
9	46029344	.	G	A	0	1	1	0	0	1	0	0
9	46525673	.	A	G	1	3	4	0	0	4	0	0
9	46656990	.	G	C	0	2	2	0	0	2	0	0
9	46667831	.	A	T	1	0	1	0	0	1	0	0
9	46672436	.	G	A	0	1	1	0	0	1	0	0
9	46678159	.	A	C	2	2	4	0	0	4	0	0
9	46678196	.	C	T	2	2	4	0	0	4	0	0
9	46678255	.	T	C	0	1	1	0	1	2	0	0
9	46678279	.	A	T	0	1	1	0	0	1	0	0
9	46683861	.	A	C	2	4	6	0	1	7	0	0
9	46684175	.	C	A	3	4	7	0	0	7	0	0
9	46684191	.	G	T	3	4	7	0	0	7	0	0
9	46684356	.	A	C	1	3	4	0	0	4	0	0
9	46692261	.	T	G	23	22	45	0	2	47	0	0
9	46745653	.	A	G	1	3	4	0	0	4	0	0
9	46799102	.	T	C	1	2	3	0	1	4	0	0
9	46799264	.	T	C	2	2	4	0	0	4	0	0
9	46799280	.	T	A	0	3	3	0	0	3	0	0
9	46821464	.	C	T	14	10	24	0	2	26	0	0
9	46821685	.	A	G	5	3	8	0	0	8	0	0
9	46821853	.	G	A	4	3	7	0	0	7	0	0
9	46821855	.	G	T	4	3	7	0	0	7	0	0
9	46821905	.	A	G	7	6	13	0	0	13	0	0
9	46821916	.	A	T	7	5	12	0	1	13	0	0
9	46822002	.	T	C	7	4	11	0	0	11	0	0
9	46822079	.	C	T	8	7	15	0	2	17	0	0
9	46822120	.	C	T	0	11	11	0	7	18	0	0
9	46822144	.	T	C	6	8	14	0	2	16	0	0
9	46822292	.	C	A	2	3	5	0	1	6	0	0
9	46823198	.	C	T	14	13	27	0	0	27	0	0
9	46823325	.	G	A	13	10	23	0	0	23	0	0
9	46823366	.	T	C	14	7	21	0	2	23	0	0
9	46823524	.	A	G	12	15	27	0	3	30	0	0
9	46824110	.	A	G	10	12	22	0	2	24	0	0
9	46824160	.	T	A	9	10	19	0	1	20	0	0
9	46825094	.	A	T	9	5	14	0	2	16	0	0
9	48054753	.	G	A	10	16	26	0	1	27	0	0
9	48060592	.	G	C	17	8	25	0	1	26	0	0
9	48076973	.	C	T	20	20	40	0	1	41	0	0
9	48123109	.	C	G	1	6	7	0	0	7	0	0
9	48123142	.	G	A	2	7	9	0	0	9	0	0
9	48127200	.	G	A	1	0	1	0	0	1	0	0
9	48128027	.	G	T	0	4	4	0	7	11	0	0
9	48131637	.	T	A	4	5	9	0	2	11	0	0
9	48131814	.	A	T	6	5	11	0	0	11	0	0
9	48131997	.	C	T	1	2	3	0	3	6	0	0
9	48132029	.	T	C	3	2	5	0	2	7	0	0
9	48132037	.	T	A	3	4	7	0	0	7	0	0
9	48132095	.	A	C	8	5	13	0	0	13	0	0
9	48132156	.	A	C	9	7	16	0	0	16	0	0
9	48132176	.	C	T	7	8	15	0	0	15	0	0
9	48132194	.	G	T	7	3	10	0	0	10	0	0
9	48132309	.	G	T	4	5	9	0	0	9	0	0
9	48132336	.	C	T	2	6	8	0	2	10	0	0
9	48132439	.	G	A	3	7	10	0	0	10	0	0
9	48132441	.	A	G	3	7	10	0	0	10	0	0
9	48132531	.	G	A	2	3	5	0	1	6	0	0
9	48132592	.	G	T	7	7	14	0	0	14	0	0
9	48133013	.	T	C	1	1	2	0	1	3	0	0
9	48133105	.	G	T	7	5	12	0	2	14	0	0
9	48133541	.	T	C	3	6	9	0	0	9	0	0
9	48133687	.	A	G	4	5	9	0	1	10	0	0
9	48133900	.	G	T	5	5	10	0	0	10	0	0
9	48134012	.	T	A	4	4	8	0	0	8	0	0
9	48134351	.	G	A	5	2	7	0	1	8	0	0
9	48134568	.	G	A	4	6	10	0	7	17	0	0
9	48134678	.	A	T	2	1	3	0	0	4	1	0
9	48178424	.	C	T	0	2	2	0	1	3	0	0
9	48179081	.	T	C	0	2	2	0	1	3	0	0
9	48189403	.	C	G	0	3	3	0	1	4	0	0
9	48189411	.	T	C	1	2	3	0	0	3	0	0
9	48197877	.	T	A	1	0	1	0	0	1	0	0
9	48201122	.	A	G	1	1	2	0	0	2	0	0
9	48201127	.	G	A	1	1	2	0	0	2	0	0
9	48227847	.	T	A	1	2	3	0	0	3	0	0
9	48228950	.	T	C	0	2	2	0	0	2	0	0
9	48229039	.	C	G	1	2	3	0	0	3	0	0
9	48229074	.	T	C	1	2	3	0	0	3	0	0
9	48230669	.	C	T	3	4	7	0	1	8	0	0
9	48230871	.	C	A	1	3	4	0	0	4	0	0
9	48255357	.	G	A	0	1	1	0	1	2	0	0
9	48264034	.	C	T	1	0	1	0	0	1	0	0
9	48266227	.	A	G	1	0	1	0	2	3	0	0
9	48266676	.	G	C	2	2	4	0	0	4	0	0
9	48284901	.	T	C	8	11	19	0	1	20	0	0
9	48284917	.	C	A	0	10	10	0	9	19	0	0
9	48284972	.	T	C	6	4	10	0	1	11	0	0
9	48285019	.	G	A	1	1	2	0	0	2	0	0
9	48286702	.	G	A	0	3	3	0	0	3	0	0
9	48287441	.	G	A	9	3	12	0	0	12	0	0
9	48289758	.	G	A	1	4	5	0	1	6	0	0
9	48289797	.	A	T	2	3	5	0	0	5	0	0
9	48289961	.	A	G	2	1	3	0	0	3	0	0
9	48289991	.	T	C	5	3	8	0	1	9	0	0
9	48296346	.	C	T	0	3	3	0	8	11	0	0
9	48387014	.	T	C	3	2	5	0	0	5	0	0
9	48390858	.	G	T	3	2	5	0	0	5	0	0
9	48397350	.	T	C	2	0	2	0	2	4	0	0
9	48653759	.	T	C	1	0	1	0	0	1	0	0
9	48665654	.	G	A	1	2	3	0	0	3	0	0
9	48669228	.	C	G	2	2	4	0	0	4	0	0
9	48670113	.	G	A	0	2	2	0	2	4	0	0
9	48670395	.	A	C	1	3	4	0	0	4	0	0
9	48670525	.	T	C	2	2	4	0	0	4	0	0
9	48671167	.	A	C	4	3	7	0	0	7	0	0
9	48706302	.	C	T	1	3	4	0	0	4	0	0
9	48706305	.	C	T	1	3	4	0	0	4	0	0
9	48721088	.	C	T	1	3	4	0	0	4	0	0
9	48721172	.	A	G	1	2	3	0	0	3	0	0
9	48870578	.	T	C	9	0	9	0	12	21	0	0
9	48870593	.	A	T	15	9	24	0	0	24	0	0
9	48870627	.	T	A	16	9	25	0	0	25	0	0
9	48870680	.	A	G	7	6	13	0	0	13	0	0
9	48871080	.	G	C	6	7	13	0	1	14	0	0
9	48871495	.	T	G	1	2	3	0	0	3	0	0
9	48871966	.	T	G	6	7	13	0	1	14	0	0
9	48871996	.	A	T	9	5	14	0	1	15	0	0
9	48872039	.	C	G	0	4	4	1	0	5	0	0
9	48872050	.	C	T	0	4	4	1	0	5	0	0
9	48872615	.	A	G	11	4	15	0	0	15	0	0
9	48872620	.	C	T	11	3	14	0	0	14	0	0
9	48872688	.	A	T	2	4	6	0	0	6	0	0
9	48872694	.	A	G	2	5	7	0	0	7	0	0
9	48872890	.	C	A	3	4	7	0	1	8	0	0
9	48872924	.	A	G	2	11	13	0	0	13	0	0
9	48872926	.	C	T	0	11	11	0	2	13	0	0
9	48873144	.	A	G	0	2	2	0	0	2	0	0
9	48873302	.	T	C	4	3	7	0	0	7	0	0
9	48873371	.	A	G	7	6	13	0	0	13	0	0
9	48873522	.	C	G	4	4	8	0	0	8	0	0
9	48873831	.	A	C	2	0	2	0	2	4	0	0
9	48874562	.	G	A	9	3	12	0	0	12	0	0
9	48874577	.	G	A	6	4	10	0	1	11	0	0
9	48875218	.	G	T	1	2	3	0	0	3	0	0
9	48875510	.	T	C	4	1	5	0	0	5	0	0
9	48875516	.	G	A	1	4	5	0	0	5	0	0
9	48875595	.	A	C	1	2	3	0	0	3	0	0
9	48875598	.	T	A	2	1	3	0	0	3	0	0
9	48875674	.	A	G	2	2	4	0	0	4	0	0
9	48875934	.	G	T	3	4	7	0	2	9	0	0
9	48875935	.	A	C	3	0	3	0	6	9	0	0
9	48876544	.	C	T	2	9	11	0	2	13	0	0
9	48876587	.	A	G	3	3	6	0	1	7	0	0
9	48937081	.	G	C	1	3	4	0	0	4	0	0
9	50195221	.	C	T	1	2	3	0	0	3	0	0
9	50196064	.	C	T	0	0	0	0	1	1	0	0
9	50755016	.	A	T	3	3	6	0	0	6	0	0
9	51302422	.	A	G	6	4	10	0	1	11	0	0
9	51345386	.	C	A	0	2	2	0	0	2	0	0
9	51430176	.	C	T	2	2	4	0	2	6	0	0
9	51430190	.	T	A	3	3	6	0	1	7	0	0
9	51430737	.	C	T	0	7	7	0	3	10	0	0
9	51430767	.	T	A	5	4	9	0	2	11	0	0
9	51430826	.	A	T	1	4	5	0	0	5	0	0
9	51430886	.	G	C	2	4	6	0	0	6	0	0
9	51431179	.	C	G	14	16	30	0	0	30	0	0
9	51431642	.	A	C	7	0	7	0	4	11	0	0
9	51431791	.	G	A	1	4	5	0	0	5	0	0
9	51431831	.	G	A	3	6	9	0	1	10	0	0
9	51431843	.	C	G	2	3	5	0	3	8	0	0
9	51432279	.	T	G	6	11	17	0	0	17	0	0
9	51432381	.	C	T	0	5	5	0	3	8	0	0
9	51433944	.	G	A	1	0	1	0	0	1	0	0
9	51791393	.	G	A	0	2	2	0	2	4	0	0
9	51804777	.	C	T	5	2	7	0	0	7	0	0
9	51996212	.	A	T	8	7	15	0	1	16	0	0
9	51996246	.	C	T	0	5	5	0	6	11	0	0
9	51996280	.	T	A	6	8	14	0	0	14	0	0
9	51996281	.	G	A	6	8	14	0	0	14	0	0
9	51996444	.	T	G	11	12	23	0	1	24	0	0
9	51996469	.	C	T	0	11	11	0	15	26	0	0
9	51996876	.	A	G	2	5	7	0	0	7	0	0
9	51997006	.	T	G	4	3	7	0	0	7	0	0
9	51997286	.	C	A	2	2	4	0	1	5	0	0
9	51998330	.	T	C	3	3	6	0	0	6	0	0
9	51998539	.	G	T	6	4	10	0	0	10	0	0
9	51998547	.	C	T	6	3	9	0	1	10	0	0
9	51998648	.	C	T	7	5	12	0	1	13	0	0
9	51998761	.	C	G	7	5	12	0	1	13	0	0
9	51998784	.	T	G	7	8	15	0	0	15	0	0
9	51998841	.	G	T	9	6	15	0	0	15	0	0
9	51998887	.	T	G	5	5	10	0	0	10	0	0
9	51999842	.	C	G	1	3	4	0	0	4	0	0
9	51999855	.	T	G	1	3	4	0	0	4	0	0
9	51999991	.	A	G	3	4	7	0	0	7	0	0
9	52000088	.	G	A	3	3	6	0	0	6	0	0
9	52000248	.	T	A	10	3	13	0	0	13	0	0
9	52000335	.	A	T	8	4	12	0	0	12	0	0
9	52000665	.	A	G	3	6	9	0	0	9	0	0
9	52000773	.	C	T	0	7	7	0	2	9	0	0
9	52001016	.	C	T	0	2	2	0	3	5	0	0
9	52001241	.	C	T	0	2	2	0	1	3	0	0
9	52003427	.	T	C	1	0	1	0	0	1	0	0
9	52378682	.	C	T	27	7	34	0	1	35	0	0
9	52378697	.	A	G	23	16	39	0	2	41	0	0
9	52378832	.	T	A	10	17	27	0	1	28	0	0
9	52416005	.	G	A	0	1	1	0	0	1	0	0
9	52433132	.	T	C	0	2	2	0	0	2	0	0
9	52433174	.	A	C	2	2	4	0	0	4	0	0
9	52435020	.	C	A	2	3	5	0	0	5	0	0
9	52435028	.	T	C	2	1	3	0	1	4	0	0
9	52435058	.	G	C	4	3	7	0	0	7	0	0
9	52435100	.	G	A	2	1	3	0	0	3	0	0
9	52435112	.	C	T	2	1	3	0	0	3	0	0
9	52487494	.	T	A	1	3	4	0	0	4	0	0
9	52487535	.	T	C	1	0	1	0	2	3	0	0
9	52489899	.	T	C	1	1	2	0	1	3	0	0
9	52490015	.	A	G	2	3	5	0	0	5	0	0
9	52490046	.	C	T	0	1	1	0	3	4	0	0
9	52490053	.	T	A	1	2	3	0	0	3	0	0
9	52492641	.	A	C	4	4	8	0	0	8	0	0
9	52492705	.	A	G	5	9	14	0	0	14	0	0
9	52493059	.	A	T	11	0	11	0	0	11	0	0
9	52493406	.	C	T	8	2	10	0	0	10	0	0
9	52532370	.	C	G	6	3	9	0	0	9	0	0
9	52539290	.	G	A	0	0	0	0	6	6	0	0
9	52539453	.	C	T	15	11	26	0	1	27	0	0
9	52539629	.	C	T	7	10	17	0	1	18	0	0
9	52564578	.	T	C	2	0	2	0	2	4	0	0
9	52564622	.	T	C	0	1	1	0	0	1	0	0
9	52572609	.	C	G	4	2	6	0	2	8	0	0
9	52574737	.	C	G	2	2	4	0	0	4	0	0
9	52595710	.	C	T	0	3	3	0	0	3	0	0
9	52608059	.	T	A	1	2	3	0	0	3	0	0
9	52609157	.	C	T	1	3	4	0	0	4	0	0
9	52629113	.	C	T	5	7	12	0	0	12	0	0
9	52629119	.	C	T	7	5	12	0	0	12	0	0
9	52629155	.	T	C	0	1	1	0	0	1	0	0
9	52631620	.	G	A	1	4	5	0	1	6	0	0
9	52633151	.	C	T	2	0	2	0	0	2	0	0
9	52642012	.	G	A	3	0	3	0	0	3	0	0
9	52645687	.	C	T	0	3	3	0	3	6	0	0
9	52651985	.	T	C	2	2	4	0	0	4	0	0
9	52652015	.	A	G	2	2	4	0	0	4	0	0
9	53276550	.	A	C	3	6	9	0	0	9	0	0
9	53276681	.	G	A	0	5	5	0	10	15	0	0
9	53276976	.	C	T	10	5	15	0	0	15	0	0
9	53276978	.	A	G	5	10	15	0	0	15	0	0
9	53277068	.	C	G	9	1	10	0	7	17	0	0
9	53277131	.	A	T	12	7	19	0	0	19	0	0
9	53277453	.	G	A	0	9	9	0	14	23	0	0
9	53277493	.	A	T	10	11	21	0	2	23	0	0
9	54711802	.	A	G	7	4	11	0	0	11	0	0
9	54763941	.	T	C	1	1	2	0	1	3	0	0
9	56225580	.	A	G	9	0	9	0	3	12	0	0
9	56225617	.	A	G	4	6	10	0	1	11	0	0
9	56225790	.	A	G	9	0	9	0	5	14	0	0
